7,100,100,1,1,0,1,0
0,133,133,1,1,0,1,0
9,142,142,1,1,0,1,0
2,158,158,22,4,18,3,2
12,166,166,8,8,0,1,0
10,186,186,9,1,8,2,1
19,202,202,83,83,0,1,0
14,221,221,8,1,7,2,1
8,284,284,13,13,0,1,0
6,294,294,26,7,19,2,1
18,320,320,38,38,0,1,0
16,344,344,58,58,0,1,0
21,365,365,3,3,0,1,0
3,391,391,2,2,0,1,0
1,403,403,47,25,22,3,2
13,419,419,56,40,16,2,1
4,422,422,33,21,12,4,3
11,458,458,48,48,0,1,0
20,460,460,6,3,3,2,1
15,463,463,35,35,0,1,0
22,476,476,58,43,15,2,1
5,492,492,83,83,0,1,0
17,496,496,31,22,9,4,3

0,150,150,87,31,56,3,2
7,153,153,49,25,24,2,1
10,170,170,21,1,20,2,1
12,215,215,21,21,0,1,0
1,231,231,36,36,0,1,0
14,246,246,45,40,5,2,1
9,247,247,28,3,25,2,1
3,260,260,58,58,0,1,0
11,277,277,9,9,0,1,0
4,355,355,3,3,0,1,0
2,384,384,2,2,0,1,0
6,388,388,28,8,20,3,2
8,397,397,16,16,0,1,0
5,460,460,13,13,0,1,0
13,497,497,19,13,6,3,2

4,140,140,5,5,0,1,0
17,169,169,28,7,21,4,3
6,192,192,40,40,0,1,0
19,241,241,8,8,0,1,0
15,255,255,49,23,26,2,1
7,310,310,62,62,0,1,0
13,333,333,4,4,0,1,0
12,338,338,73,2,71,4,3
11,352,352,89,57,32,3,2
18,364,364,40,4,36,3,2
10,369,369,39,9,30,3,2
0,386,386,24,24,0,1,0
14,392,392,9,9,0,1,0
5,393,393,58,41,17,3,2
2,395,395,12,2,10,2,1
8,415,415,26,26,0,1,0
1,428,428,10,10,0,1,0
3,446,446,10,6,4,2,1
16,476,476,5,5,0,1,0
9,491,491,51,24,27,4,3

11,149,149,8,5,3,2,1
2,169,169,5,5,0,1,0
10,186,186,2,2,0,1,0
14,198,198,92,50,42,3,2
1,234,234,17,8,9,4,3
7,253,253,21,7,14,3,2
6,287,287,1,1,0,1,0
5,331,331,85,85,0,1,0
13,380,380,58,24,34,3,2
4,396,396,28,3,25,2,1
9,437,437,18,13,5,2,1
8,441,441,77,30,47,4,3
0,484,484,212,212,0,1,0
12,490,490,16,7,9,2,1
3,498,498,66,18,48,4,3

5,111,111,16,3,13,3,2
8,144,144,3,3,0,1,0
13,144,144,24,24,0,1,0
4,153,153,39,39,0,1,0
10,174,174,2,2,0,1,0
15,202,202,2,2,0,1,0
16,239,239,21,21,0,1,0
12,247,247,2,2,0,1,0
3,264,264,1,1,0,1,0
0,279,279,12,12,0,1,0
17,286,286,122,122,0,1,0
9,297,297,3,3,0,1,0
6,304,304,50,28,22,2,1
14,384,384,13,13,0,1,0
18,423,423,81,81,0,1,0
11,479,479,37,9,28,2,1
2,491,491,94,48,46,2,1
1,492,492,5,5,0,1,0
7,498,498,79,70,9,4,3

12,105,105,8,8,0,1,0
2,127,127,11,2,9,4,3
18,142,142,3,3,0,1,0
0,143,143,1,1,0,1,0
11,149,149,4,4,0,1,0
17,153,153,59,31,28,2,1
10,157,157,70,70,0,1,0
16,169,169,2,2,0,1,0
5,183,183,24,24,0,1,0
15,242,242,6,6,0,1,0
4,301,301,17,1,16,3,2
14,344,344,10,2,8,2,1
1,346,346,31,31,0,1,0
6,417,417,29,29,0,1,0
13,447,447,2,2,0,1,0
3,468,468,27,27,0,1,0
9,480,480,171,77,94,4,3
7,492,492,5,2,3,2,1
8,497,497,68,68,0,1,0

7,110,110,1,1,0,1,0
15,174,174,48,48,0,1,0
17,175,175,16,5,11,2,1
10,176,176,20,14,6,2,1
16,179,179,18,18,0,1,0
8,218,218,108,93,15,4,3
1,281,281,18,18,0,1,0
13,312,312,3,3,0,1,0
5,322,322,2,2,0,1,0
2,355,355,12,12,0,1,0
0,370,370,28,8,20,3,2
14,373,373,15,5,10,3,2
4,446,446,10,10,0,1,0
3,449,449,35,35,0,1,0
12,454,454,97,97,0,1,0
9,463,463,19,1,18,4,3
11,470,470,108,102,6,2,1
18,473,473,16,4,12,4,3
19,477,477,7,1,6,2,1
6,488,488,32,6,26,3,2

10,120,120,12,12,0,1,0
3,197,197,50,2,48,3,2
12,234,234,19,9,10,3,2
15,257,257,82,58,24,2,1
9,270,270,14,14,0,1,0
17,280,280,15,15,0,1,0
14,304,304,15,1,14,2,1
16,321,321,33,15,18,3,2
1,338,338,105,43,62,3,2
13,377,377,8,8,0,1,0
2,404,404,16,16,0,1,0
4,414,414,79,79,0,1,0
11,427,427,102,75,27,4,3
6,428,428,2,2,0,1,0
8,435,435,35,35,0,1,0
0,444,444,12,1,11,3,2
7,454,454,10,10,0,1,0
5,479,479,35,35,0,1,0

14,132,132,9,9,0,1,0
0,156,156,2,2,0,1,0
11,168,168,7,7,0,1,0
17,203,203,71,71,0,1,0
7,236,236,49,5,44,3,2
19,249,249,39,9,30,3,2
6,262,262,5,1,4,2,1
9,265,265,5,5,0,1,0
1,266,266,59,11,48,4,3
20,272,272,19,16,3,2,1
16,274,274,20,4,16,2,1
15,322,322,70,14,56,3,2
13,358,358,7,7,0,1,0
2,368,368,8,8,0,1,0
18,396,396,20,13,7,2,1
21,409,409,4,4,0,1,0
8,423,423,14,14,0,1,0
4,429,429,43,3,40,4,3
10,446,446,73,4,69,4,3
3,451,451,41,41,0,1,0
12,481,481,25,5,20,3,2
5,484,484,8,8,0,1,0

3,101,101,1,1,0,1,0
7,110,110,5,5,0,1,0
4,120,120,45,45,0,1,0
1,140,140,96,6,90,4,3
9,177,177,10,4,6,3,2
12,218,218,3,3,0,1,0
6,315,315,39,33,6,3,2
5,339,339,22,22,0,1,0
2,364,364,7,2,5,2,1
8,398,398,66,48,18,4,3
0,457,457,131,29,102,4,3
11,458,458,17,17,0,1,0
10,466,466,66,45,21,4,3

2,127,127,1,1,0,1,0
12,133,133,29,29,0,1,0
4,144,144,47,47,0,1,0
8,157,157,8,5,3,2,1
3,170,170,3,3,0,1,0
0,209,209,4,1,3,2,1
6,221,221,20,1,19,2,1
17,254,254,24,24,0,1,0
13,263,263,7,7,0,1,0
1,267,267,3,3,0,1,0
14,276,276,39,17,22,3,2
9,317,317,58,58,0,1,0
11,371,371,30,22,8,3,2
16,374,374,84,14,70,3,2
10,379,379,39,39,0,1,0
15,419,419,2,2,0,1,0
5,434,434,59,59,0,1,0
7,436,436,69,57,12,2,1
18,461,461,57,15,42,4,3

1,112,112,13,13,0,1,0
3,155,155,28,28,0,1,0
15,196,196,25,25,0,1,0
2,204,204,5,5,0,1,0
18,227,227,20,20,0,1,0
17,237,237,17,13,4,2,1
14,238,238,27,27,0,1,0
16,252,252,30,12,18,2,1
19,269,269,26,19,7,2,1
7,273,273,32,32,0,1,0
6,274,274,4,4,0,1,0
13,287,287,68,20,48,2,1
11,309,309,27,9,18,4,3
12,326,326,35,17,18,3,2
10,356,356,35,23,12,3,2
20,382,382,23,23,0,1,0
0,453,453,24,10,14,2,1
4,456,456,31,31,0,1,0
8,458,458,64,15,49,4,3
9,463,463,41,41,0,1,0
5,472,472,7,7,0,1,0

6,119,119,16,16,0,1,0
1,162,162,11,11,0,1,0
8,172,172,42,8,34,4,3
2,172,172,1,1,0,1,0
11,184,184,28,28,0,1,0
14,187,187,3,3,0,1,0
10,253,253,50,15,35,3,2
15,291,291,32,32,0,1,0
7,320,320,137,26,111,4,3
13,326,326,3,3,0,1,0
0,352,352,24,14,10,2,1
4,353,353,2,2,0,1,0
5,374,374,76,76,0,1,0
3,436,436,39,13,26,3,2
12,438,438,23,23,0,1,0
16,455,455,61,5,56,3,2
9,474,474,47,47,0,1,0

20,100,100,9,9,0,1,0
2,104,104,4,4,0,1,0
12,121,121,6,6,0,1,0
14,158,158,6,6,0,1,0
22,195,195,15,3,12,2,1
6,204,204,4,4,0,1,0
9,215,215,2,2,0,1,0
15,217,217,30,30,0,1,0
13,229,229,7,7,0,1,0
21,269,269,5,5,0,1,0
18,290,290,68,68,0,1,0
4,317,317,71,71,0,1,0
19,319,319,41,11,30,3,2
10,327,327,49,39,10,3,2
11,393,393,19,13,6,3,2
3,421,421,68,68,0,1,0
5,437,437,19,9,10,2,1
17,456,456,69,14,55,4,3
0,464,464,48,38,10,3,2
7,466,466,51,3,48,4,3
8,479,479,4,1,3,2,1
16,484,484,71,71,0,1,0
1,488,488,2,2,0,1,0

25,115,115,11,5,6,3,2
9,146,146,24,12,12,4,3
6,156,156,4,4,0,1,0
20,175,175,9,9,0,1,0
24,198,198,78,42,36,4,3
12,219,219,2,2,0,1,0
18,219,219,28,28,0,1,0
13,233,233,8,8,0,1,0
3,284,284,8,8,0,1,0
0,284,284,13,13,0,1,0
1,293,293,39,39,0,1,0
4,297,297,33,33,0,1,0
23,304,304,16,16,0,1,0
8,309,309,1,1,0,1,0
7,321,321,1,1,0,1,0
22,333,333,4,4,0,1,0
10,354,354,83,5,78,4,3
15,356,356,23,12,11,4,3
21,363,363,38,16,22,3,2
5,371,371,18,18,0,1,0
14,384,384,8,8,0,1,0
19,402,402,35,35,0,1,0
17,404,404,37,22,15,2,1
16,432,432,25,22,3,2,1
2,434,434,2,2,0,1,0
11,450,450,5,5,0,1,0

0,117,117,5,5,0,1,0
16,120,120,32,4,28,3,2
11,163,163,16,13,3,2,1
5,195,195,18,3,15,2,1
15,201,201,2,2,0,1,0
14,232,232,20,2,18,3,2
8,238,238,22,3,19,4,3
9,246,246,28,23,5,2,1
7,247,247,25,25,0,1,0
3,250,250,74,56,18,3,2
12,283,283,42,42,0,1,0
4,345,345,33,33,0,1,0
13,362,362,56,56,0,1,0
6,415,415,11,11,0,1,0
10,436,436,21,17,4,2,1
2,447,447,134,58,76,3,2
1,489,489,23,23,0,1,0

10,101,101,17,11,6,2,1
6,114,114,17,17,0,1,0
20,115,115,3,3,0,1,0
8,168,168,3,3,0,1,0
21,170,170,13,1,12,4,3
4,173,173,2,2,0,1,0
7,203,203,26,17,9,4,3
15,231,231,56,28,28,2,1
1,238,238,23,23,0,1,0
9,242,242,3,3,0,1,0
16,246,246,23,1,22,3,2
14,276,276,32,15,17,2,1
12,300,300,5,5,0,1,0
0,303,303,11,11,0,1,0
2,309,309,21,21,0,1,0
17,318,318,22,22,0,1,0
11,351,351,76,36,40,2,1
5,368,368,21,7,14,3,2
3,381,381,9,9,0,1,0
13,390,390,49,36,13,2,1
19,412,412,16,16,0,1,0
18,418,418,96,96,0,1,0

13,121,121,1,1,0,1,0
2,130,130,37,31,6,3,2
7,153,153,16,7,9,2,1
14,197,197,46,10,36,2,1
10,262,262,6,1,5,2,1
15,279,279,2,2,0,1,0
4,333,333,16,1,15,4,3
9,337,337,19,9,10,2,1
5,344,344,49,11,38,4,3
0,345,345,21,7,14,3,2
12,346,346,14,5,9,4,3
3,359,359,24,24,0,1,0
6,401,401,59,5,54,3,2
8,426,426,45,45,0,1,0
16,438,438,115,83,32,2,1
17,446,446,16,16,0,1,0
1,479,479,20,12,8,3,2
11,495,495,169,85,84,4,3

0,112,112,3,3,0,1,0
7,117,117,15,15,0,1,0
23,132,132,8,8,0,1,0
3,136,136,7,7,0,1,0
16,143,143,5,5,0,1,0
19,147,147,39,22,17,3,2
5,201,201,10,1,9,2,1
22,218,218,2,2,0,1,0
6,219,219,11,2,9,2,1
21,265,265,8,8,0,1,0
9,284,284,27,27,0,1,0
25,291,291,6,6,0,1,0
11,301,301,9,9,0,1,0
4,351,351,35,35,0,1,0
24,360,360,8,8,0,1,0
17,363,363,81,19,62,3,2
8,371,371,41,41,0,1,0
18,401,401,22,22,0,1,0
1,403,403,9,9,0,1,0
12,407,407,13,1,12,4,3
10,429,429,22,15,7,2,1
20,439,439,146,49,97,4,3
15,450,450,14,14,0,1,0
14,451,451,2,2,0,1,0
2,487,487,28,28,0,1,0
13,496,496,62,40,22,2,1

6,133,133,4,4,0,1,0
7,152,152,6,6,0,1,0
11,172,172,18,8,10,2,1
5,209,209,3,3,0,1,0
14,239,239,44,23,21,4,3
13,246,246,24,24,0,1,0
1,250,250,142,142,0,1,0
0,259,259,59,15,44,3,2
12,302,302,9,9,0,1,0
2,354,354,27,7,20,3,2
10,377,377,145,145,0,1,0
9,397,397,34,22,12,4,3
8,417,417,25,25,0,1,0
4,452,452,32,20,12,3,2
3,458,458,20,5,15,4,3

20,139,139,45,45,0,1,0
1,187,187,11,11,0,1,0
22,189,189,16,16,0,1,0
5,191,191,4,1,3,2,1
15,203,203,1,1,0,1,0
8,213,213,16,2,14,3,2
6,233,233,3,3,0,1,0
4,252,252,16,16,0,1,0
11,256,256,56,56,0,1,0
21,280,280,63,33,30,4,3
9,306,306,1,1,0,1,0
19,326,326,36,28,8,3,2
17,337,337,56,56,0,1,0
18,382,382,11,2,9,2,1
10,387,387,63,63,0,1,0
14,402,402,16,16,0,1,0
23,415,415,24,19,5,2,1
12,445,445,37,37,0,1,0
3,452,452,15,9,6,2,1
0,464,464,21,21,0,1,0
16,465,465,8,8,0,1,0
13,475,475,48,4,44,2,1
2,477,477,38,20,18,3,2
7,484,484,2,2,0,1,0

5,108,108,33,30,3,2,1
9,177,177,21,21,0,1,0
3,185,185,44,2,42,3,2
14,216,216,5,5,0,1,0
7,295,295,30,30,0,1,0
0,327,327,23,23,0,1,0
12,357,357,12,12,0,1,0
13,360,360,29,29,0,1,0
1,380,380,14,14,0,1,0
11,381,381,152,99,53,4,3
10,389,389,10,2,8,3,2
2,445,445,34,34,0,1,0
6,447,447,91,91,0,1,0
8,477,477,16,2,14,2,1
4,500,500,137,83,54,4,3

9,122,122,3,3,0,1,0
4,127,127,10,10,0,1,0
5,170,170,63,23,40,3,2
13,174,174,1,1,0,1,0
6,213,213,50,50,0,1,0
0,249,249,5,2,3,2,1
12,253,253,20,9,11,4,3
14,310,310,43,37,6,3,2
7,327,327,98,24,74,3,2
8,338,338,23,7,16,4,3
11,381,381,60,15,45,2,1
10,395,395,7,7,0,1,0
3,399,399,51,45,6,3,2
1,404,404,47,15,32,3,2
2,417,417,120,87,33,4,3

20,134,134,27,10,17,2,1
9,198,198,10,10,0,1,0
0,205,205,13,7,6,2,1
16,226,226,28,28,0,1,0
17,228,228,14,2,12,4,3
12,241,241,11,2,9,4,3
7,250,250,52,52,0,1,0
10,285,285,5,5,0,1,0
14,285,285,25,25,0,1,0
21,287,287,17,9,8,2,1
2,296,296,6,2,4,2,1
5,317,317,70,70,0,1,0
18,346,346,64,61,3,2,1
4,348,348,38,38,0,1,0
13,362,362,15,15,0,1,0
19,369,369,45,45,0,1,0
8,404,404,19,19,0,1,0
6,408,408,12,6,6,3,2
11,454,454,1,1,0,1,0
1,473,473,84,84,0,1,0
15,491,491,66,66,0,1,0
3,492,492,5,5,0,1,0

3,126,126,3,3,0,1,0
14,135,135,4,4,0,1,0
6,142,142,1,1,0,1,0
13,142,142,5,5,0,1,0
20,151,151,12,12,0,1,0
10,156,156,5,5,0,1,0
7,158,158,12,12,0,1,0
9,176,176,16,16,0,1,0
16,186,186,5,5,0,1,0
18,201,201,21,12,9,2,1
12,218,218,38,3,35,2,1
1,231,231,1,1,0,1,0
8,260,260,3,3,0,1,0
11,299,299,69,29,40,3,2
2,340,340,2,2,0,1,0
0,400,400,48,22,26,3,2
15,431,431,187,187,0,1,0
4,458,458,25,25,0,1,0
21,471,471,24,12,12,2,1
17,482,482,23,23,0,1,0
19,484,484,105,84,21,4,3
5,487,487,83,12,71,4,3

15,109,109,1,1,0,1,0
11,112,112,14,7,7,2,1
1,134,134,3,3,0,1,0
3,146,146,7,7,0,1,0
12,180,180,5,1,4,2,1
4,182,182,4,4,0,1,0
0,200,200,1,1,0,1,0
16,204,204,76,38,38,2,1
7,236,236,55,47,8,3,2
13,304,304,18,18,0,1,0
14,305,305,27,9,18,4,3
9,334,334,30,30,0,1,0
6,377,377,130,30,100,3,2
10,385,385,78,52,26,3,2
8,392,392,19,19,0,1,0
2,442,442,81,62,19,2,1
5,466,466,67,67,0,1,0

12,102,102,1,1,0,1,0
21,109,109,3,3,0,1,0
3,115,115,5,5,0,1,0
22,126,126,22,22,0,1,0
7,165,165,27,27,0,1,0
20,178,178,15,15,0,1,0
0,181,181,13,13,0,1,0
2,183,183,5,5,0,1,0
11,227,227,2,2,0,1,0
9,230,230,8,8,0,1,0
24,255,255,34,10,24,3,2
1,305,305,4,1,3,2,1
5,305,305,61,1,60,4,3
8,312,312,3,3,0,1,0
6,320,320,21,12,9,2,1
23,334,334,15,1,14,2,1
15,353,353,5,2,3,2,1
13,376,376,23,6,17,3,2
16,379,379,43,35,8,2,1
19,404,404,100,100,0,1,0
18,406,406,76,16,60,4,3
10,421,421,56,56,0,1,0
17,434,434,1,1,0,1,0
14,438,438,33,5,28,3,2
4,467,467,32,3,29,3,2

13,109,109,2,2,0,1,0
2,122,122,74,74,0,1,0
5,127,127,28,28,0,1,0
11,157,157,19,19,0,1,0
14,175,175,19,1,18,3,2
1,186,186,7,1,6,3,2
7,204,204,14,8,6,2,1
10,212,212,33,33,0,1,0
12,259,259,28,1,27,4,3
0,306,306,8,1,7,2,1
4,336,336,22,22,0,1,0
9,365,365,86,50,36,2,1
6,416,416,21,21,0,1,0
3,420,420,20,5,15,2,1
8,428,428,64,64,0,1,0

11,114,114,21,12,9,4,3
16,117,117,12,12,0,1,0
20,147,147,2,2,0,1,0
17,163,163,37,37,0,1,0
21,180,180,32,32,0,1,0
23,185,185,19,19,0,1,0
6,211,211,16,16,0,1,0
24,217,217,4,4,0,1,0
1,237,237,71,54,17,2,1
18,242,242,5,5,0,1,0
3,247,247,3,3,0,1,0
2,257,257,7,7,0,1,0
10,322,322,16,7,9,4,3
22,335,335,41,41,0,1,0
8,346,346,22,19,3,2,1
7,347,347,16,1,15,2,1
4,368,368,4,4,0,1,0
0,374,374,5,5,0,1,0
15,380,380,6,6,0,1,0
14,381,381,9,9,0,1,0
12,396,396,6,6,0,1,0
9,449,449,6,2,4,2,1
19,454,454,75,27,48,2,1
25,472,472,79,79,0,1,0
5,475,475,22,1,21,2,1
13,481,481,2,2,0,1,0

7,121,121,4,4,0,1,0
0,156,156,2,2,0,1,0
13,161,161,4,4,0,1,0
20,169,169,22,19,3,2,1
10,207,207,17,4,13,3,2
21,208,208,10,10,0,1,0
6,253,253,15,3,12,3,2
1,264,264,14,14,0,1,0
14,278,278,10,10,0,1,0
3,312,312,2,2,0,1,0
19,325,325,88,88,0,1,0
11,414,414,30,22,8,3,2
16,414,414,136,51,85,4,3
8,416,416,16,3,13,2,1
18,447,447,1,1,0,1,0
15,455,455,77,77,0,1,0
9,460,460,8,8,0,1,0
5,463,463,23,1,22,2,1
2,465,465,86,86,0,1,0
17,485,485,2,2,0,1,0
4,489,489,16,2,14,2,1
12,490,490,176,118,58,3,2

17,108,108,11,11,0,1,0
2,114,114,3,3,0,1,0
5,128,128,3,3,0,1,0
14,132,132,1,1,0,1,0
9,138,138,22,22,0,1,0
6,139,139,17,5,12,2,1
3,172,172,9,9,0,1,0
13,202,202,6,6,0,1,0
18,215,215,44,37,7,2,1
4,231,231,18,18,0,1,0
0,251,251,12,12,0,1,0
1,334,334,98,72,26,3,2
11,340,340,59,9,50,2,1
12,341,341,49,44,5,2,1
10,370,370,20,20,0,1,0
7,387,387,17,1,16,3,2
19,443,443,43,28,15,4,3
8,453,453,46,3,43,4,3
16,494,494,16,4,12,3,2
15,494,494,112,28,84,4,3

17,103,103,8,8,0,1,0
4,117,117,9,9,0,1,0
1,154,154,1,1,0,1,0
14,162,162,32,32,0,1,0
6,187,187,18,18,0,1,0
18,213,213,4,4,0,1,0
0,264,264,33,33,0,1,0
20,267,267,34,34,0,1,0
13,268,268,1,1,0,1,0
3,274,274,22,15,7,2,1
16,276,276,30,24,6,2,1
10,285,285,1,1,0,1,0
5,299,299,18,3,15,4,3
9,319,319,3,3,0,1,0
15,321,321,14,1,13,4,3
2,372,372,70,70,0,1,0
11,384,384,37,37,0,1,0
19,388,388,115,115,0,1,0
8,405,405,78,78,0,1,0
7,432,432,28,19,9,4,3
12,472,472,71,2,69,4,3

11,102,102,14,14,0,1,0
2,151,151,37,12,25,2,1
7,169,169,12,12,0,1,0
14,215,215,58,20,38,3,2
0,223,223,13,13,0,1,0
1,228,228,47,8,39,4,3
10,267,267,19,1,18,4,3
13,297,297,29,29,0,1,0
12,299,299,56,50,6,3,2
4,360,360,48,48,0,1,0
8,368,368,13,1,12,2,1
9,376,376,56,9,47,2,1
6,401,401,1,1,0,1,0
5,408,408,94,94,0,1,0
3,477,477,61,10,51,4,3

0,114,114,1,1,0,1,0
8,125,125,5,5,0,1,0
20,147,147,14,5,9,3,2
23,157,157,18,18,0,1,0
11,181,181,33,33,0,1,0
25,195,195,3,3,0,1,0
16,198,198,29,29,0,1,0
3,206,206,13,1,12,2,1
10,209,209,6,6,0,1,0
18,233,233,7,7,0,1,0
1,262,262,27,21,6,3,2
12,271,271,14,2,12,3,2
21,303,303,20,12,8,3,2
13,305,305,1,1,0,1,0
22,315,315,64,64,0,1,0
14,338,338,2,2,0,1,0
7,350,350,30,8,22,3,2
24,353,353,67,67,0,1,0
26,364,364,21,21,0,1,0
2,375,375,8,8,0,1,0
19,404,404,99,48,51,3,2
4,437,437,28,20,8,3,2
9,456,456,8,4,4,2,1
15,460,460,2,2,0,1,0
5,466,466,1,1,0,1,0
6,470,470,26,26,0,1,0
17,500,500,59,51,8,2,1

5,107,107,1,1,0,1,0
8,143,143,1,1,0,1,0
12,156,156,9,9,0,1,0
9,202,202,4,4,0,1,0
4,202,202,32,8,24,2,1
1,216,216,59,59,0,1,0
11,234,234,3,3,0,1,0
10,255,255,13,13,0,1,0
17,265,265,122,122,0,1,0
7,268,268,52,7,45,4,3
15,278,278,36,36,0,1,0
6,282,282,11,11,0,1,0
3,295,295,22,22,0,1,0
13,310,310,2,2,0,1,0
0,369,369,27,21,6,2,1
14,389,389,10,10,0,1,0
2,412,412,71,49,22,3,2
16,422,422,110,82,28,3,2

10,100,100,14,14,0,1,0
11,114,114,18,18,0,1,0
8,134,134,38,4,34,3,2
18,141,141,15,6,9,2,1
2,149,149,5,5,0,1,0
13,160,160,11,11,0,1,0
15,168,168,8,3,5,2,1
9,169,169,2,2,0,1,0
17,171,171,11,11,0,1,0
4,215,215,21,12,9,2,1
1,280,280,20,20,0,1,0
5,301,301,63,63,0,1,0
19,320,320,49,49,0,1,0
14,327,327,41,27,14,3,2
0,380,380,29,29,0,1,0
6,399,399,29,7,22,2,1
3,420,420,3,3,0,1,0
12,422,422,11,11,0,1,0
16,433,433,120,44,76,4,3
7,477,477,3,3,0,1,0

20,101,101,11,2,9,4,3
5,106,106,1,1,0,1,0
7,134,134,6,6,0,1,0
2,167,167,10,10,0,1,0
12,175,175,5,5,0,1,0
15,201,201,41,35,6,3,2
17,220,220,17,1,16,3,2
4,248,248,1,1,0,1,0
14,248,248,74,30,44,3,2
1,276,276,7,7,0,1,0
19,304,304,23,15,8,2,1
13,373,373,3,3,0,1,0
16,401,401,21,9,12,2,1
6,415,415,74,58,16,3,2
8,422,422,33,1,32,3,2
18,434,434,71,41,30,3,2
10,459,459,46,46,0,1,0
0,472,472,69,36,33,4,3
11,476,476,136,136,0,1,0
3,482,482,4,4,0,1,0
9,487,487,30,15,15,4,3

17,101,101,16,16,0,1,0
19,111,111,20,20,0,1,0
6,112,112,6,6,0,1,0
9,115,115,6,6,0,1,0
5,149,149,12,12,0,1,0
13,169,169,2,2,0,1,0
14,171,171,9,9,0,1,0
20,177,177,9,9,0,1,0
15,220,220,42,29,13,2,1
7,230,230,41,5,36,3,2
3,232,232,9,9,0,1,0
11,243,243,37,9,28,2,1
8,245,245,13,8,5,2,1
0,249,249,6,6,0,1,0
10,259,259,8,8,0,1,0
12,279,279,12,12,0,1,0
22,292,292,57,2,55,3,2
16,295,295,12,4,8,2,1
18,352,352,34,34,0,1,0
4,354,354,25,18,7,2,1
2,447,447,3,3,0,1,0
21,481,481,26,26,0,1,0
1,487,487,102,102,0,1,0

1,101,101,4,4,0,1,0
0,135,135,18,6,12,2,1
18,135,135,1,1,0,1,0
2,140,140,4,4,0,1,0
8,144,144,3,3,0,1,0
4,165,165,8,5,3,2,1
13,166,166,17,6,11,2,1
17,184,184,6,6,0,1,0
22,215,215,7,2,5,2,1
6,223,223,11,5,6,3,2
11,231,231,8,8,0,1,0
14,238,238,22,22,0,1,0
9,243,243,12,12,0,1,0
3,275,275,35,10,25,2,1
21,307,307,35,21,14,3,2
19,326,326,110,58,52,4,3
16,341,341,9,3,6,3,2
15,370,370,37,37,0,1,0
10,387,387,55,55,0,1,0
5,426,426,1,1,0,1,0
20,443,443,121,79,42,3,2
12,467,467,65,65,0,1,0
7,500,500,44,11,33,2,1

12,173,173,4,4,0,1,0
3,181,181,19,19,0,1,0
14,192,192,4,4,0,1,0
0,198,198,34,29,5,2,1
7,252,252,47,9,38,2,1
10,252,252,56,56,0,1,0
13,302,302,22,22,0,1,0
11,306,306,45,18,27,2,1
4,311,311,81,42,39,2,1
9,344,344,67,64,3,2,1
6,362,362,36,36,0,1,0
2,369,369,103,97,6,3,2
1,370,370,22,4,18,3,2
5,437,437,11,3,8,2,1
8,453,453,66,31,35,2,1
15,461,461,1,1,0,1,0

16,105,105,25,4,21,4,3
19,158,158,25,21,4,2,1
7,162,162,12,2,10,2,1
6,198,198,6,3,3,2,1
3,215,215,5,5,0,1,0
10,254,254,25,25,0,1,0
2,274,274,3,3,0,1,0
1,301,301,1,1,0,1,0
0,312,312,62,33,29,2,1
8,313,313,36,7,29,2,1
17,369,369,63,31,32,3,2
9,370,370,3,3,0,1,0
18,383,383,7,1,6,3,2
14,396,396,34,16,18,3,2
5,409,409,127,127,0,1,0
11,434,434,9,9,0,1,0
4,460,460,60,36,24,3,2
13,462,462,72,54,18,2,1
15,475,475,7,7,0,1,0
12,495,495,74,11,63,4,3

6,128,128,1,1,0,1,0
7,138,138,3,3,0,1,0
3,150,150,2,2,0,1,0
9,161,161,16,16,0,1,0
8,165,165,41,41,0,1,0
16,197,197,33,33,0,1,0
10,220,220,14,14,0,1,0
11,289,289,109,109,0,1,0
17,294,294,17,17,0,1,0
18,322,322,8,2,6,3,2
0,332,332,16,2,14,3,2
2,341,341,11,2,9,2,1
4,364,364,3,3,0,1,0
5,390,390,108,108,0,1,0
1,408,408,100,100,0,1,0
15,410,410,21,21,0,1,0
12,421,421,49,5,44,4,3
14,459,459,42,28,14,2,1
13,500,500,33,33,0,1,0

1,100,100,22,22,0,1,0
5,119,119,4,4,0,1,0
12,120,120,21,21,0,1,0
13,125,125,18,1,17,2,1
15,126,126,5,5,0,1,0
10,145,145,20,10,10,3,2
4,179,179,6,6,0,1,0
17,214,214,3,3,0,1,0
2,244,244,50,50,0,1,0
11,252,252,42,25,17,2,1
6,255,255,8,3,5,2,1
8,310,310,25,1,24,4,3
0,312,312,20,20,0,1,0
14,321,321,23,23,0,1,0
7,366,366,112,91,21,2,1
16,379,379,4,1,3,2,1
9,397,397,107,13,94,3,2
3,489,489,14,6,8,3,2

14,133,133,12,12,0,1,0
9,152,152,7,7,0,1,0
8,173,173,4,4,0,1,0
11,222,222,74,71,3,2,1
0,223,223,5,5,0,1,0
1,228,228,5,2,3,2,1
6,250,250,37,13,24,4,3
16,382,382,22,22,0,1,0
13,383,383,40,40,0,1,0
12,390,390,45,45,0,1,0
10,398,398,23,23,0,1,0
7,410,410,27,16,11,2,1
2,418,418,1,1,0,1,0
3,445,445,117,117,0,1,0
15,456,456,86,56,30,2,1
4,488,488,93,93,0,1,0
5,494,494,142,88,54,4,3

11,102,102,8,1,7,2,1
4,147,147,18,18,0,1,0
13,155,155,20,20,0,1,0
3,171,171,19,19,0,1,0
10,220,220,18,2,16,3,2
21,241,241,1,1,0,1,0
20,241,241,36,36,0,1,0
9,244,244,20,20,0,1,0
7,259,259,2,2,0,1,0
18,274,274,32,32,0,1,0
15,286,286,48,48,0,1,0
8,329,329,30,30,0,1,0
19,343,343,13,8,5,2,1
5,350,350,19,19,0,1,0
2,360,360,13,5,8,3,2
12,375,375,16,2,14,3,2
14,407,407,152,126,26,3,2
16,425,425,4,1,3,2,1
0,441,441,14,14,0,1,0
1,476,476,49,20,29,2,1
6,483,483,77,22,55,4,3
17,498,498,13,5,8,2,1

6,137,137,4,1,3,2,1
5,151,151,1,1,0,1,0
4,176,176,3,3,0,1,0
7,185,185,6,2,4,2,1
17,223,223,35,35,0,1,0
9,258,258,37,6,31,4,3
0,270,270,34,34,0,1,0
20,276,276,13,7,6,3,2
3,285,285,7,3,4,2,1
2,286,286,39,11,28,2,1
11,289,289,36,27,9,2,1
14,296,296,116,61,55,4,3
16,342,342,19,19,0,1,0
13,396,396,11,11,0,1,0
15,418,418,35,26,9,2,1
8,425,425,112,76,36,3,2
12,450,450,18,10,8,2,1
18,453,453,43,6,37,2,1
10,471,471,32,14,18,4,3
19,486,486,54,54,0,1,0
1,500,500,15,15,0,1,0

13,116,116,16,16,0,1,0
2,136,136,2,2,0,1,0
8,160,160,20,8,12,2,1
9,173,173,50,50,0,1,0
15,220,220,45,37,8,2,1
14,220,220,17,2,15,4,3
6,224,224,67,55,12,2,1
18,249,249,19,19,0,1,0
1,263,263,1,1,0,1,0
17,273,273,11,5,6,2,1
16,308,308,3,3,0,1,0
10,332,332,44,8,36,4,3
12,360,360,112,112,0,1,0
11,361,361,12,4,8,3,2
3,372,372,59,41,18,2,1
4,406,406,30,30,0,1,0
0,408,408,13,1,12,3,2
7,456,456,1,1,0,1,0
5,476,476,1,1,0,1,0

8,110,110,15,3,12,2,1
14,189,189,18,18,0,1,0
0,208,208,21,21,0,1,0
3,241,241,27,9,18,2,1
15,305,305,13,3,10,2,1
4,334,334,110,110,0,1,0
6,360,360,76,40,36,4,3
10,371,371,75,34,41,2,1
1,377,377,44,4,40,3,2
5,389,389,1,1,0,1,0
11,396,396,93,93,0,1,0
2,420,420,54,54,0,1,0
7,451,451,24,15,9,4,3
13,462,462,79,13,66,4,3
12,473,473,17,3,14,2,1
9,479,479,21,9,12,3,2

16,130,130,7,7,0,1,0
9,162,162,4,1,3,2,1
7,178,178,44,44,0,1,0
11,271,271,22,4,18,3,2
3,284,284,36,17,19,2,1
12,293,293,32,18,14,2,1
5,294,294,59,10,49,2,1
13,339,339,44,17,27,2,1
10,340,340,101,101,0,1,0
15,350,350,4,4,0,1,0
4,356,356,39,39,0,1,0
1,437,437,11,7,4,2,1
2,445,445,31,31,0,1,0
6,472,472,32,32,0,1,0
8,485,485,88,41,47,4,3
14,487,487,66,55,11,2,1
0,488,488,77,45,32,2,1

1,103,103,12,4,8,3,2
5,126,126,7,7,0,1,0
11,194,194,1,1,0,1,0
9,198,198,1,1,0,1,0
2,210,210,11,4,7,2,1
0,264,264,105,105,0,1,0
8,264,264,18,18,0,1,0
7,294,294,6,6,0,1,0
14,300,300,43,23,20,3,2
13,303,303,8,8,0,1,0
12,390,390,24,2,22,3,2
6,391,391,249,214,35,2,1
4,407,407,3,3,0,1,0
3,411,411,153,129,24,4,3
10,413,413,21,21,0,1,0

20,106,106,5,5,0,1,0
22,150,150,12,12,0,1,0
0,156,156,1,1,0,1,0
7,191,191,10,10,0,1,0
4,199,199,9,9,0,1,0
17,216,216,8,8,0,1,0
12,217,217,8,8,0,1,0
13,219,219,4,4,0,1,0
11,228,228,18,18,0,1,0
9,252,252,38,24,14,2,1
14,259,259,2,2,0,1,0
19,263,263,13,6,7,2,1
3,318,318,37,37,0,1,0
18,334,334,16,5,11,4,3
15,338,338,74,42,32,2,1
2,344,344,87,67,20,4,3
21,357,357,29,29,0,1,0
16,363,363,163,91,72,4,3
1,374,374,14,5,9,4,3
5,424,424,5,5,0,1,0
6,431,431,58,58,0,1,0
8,436,436,13,13,0,1,0
10,489,489,15,3,12,3,2

14,118,118,8,8,0,1,0
1,130,130,4,4,0,1,0
5,156,156,83,6,77,4,3
11,169,169,19,19,0,1,0
2,207,207,1,1,0,1,0
7,217,217,33,33,0,1,0
0,267,267,28,3,25,2,1
3,268,268,31,9,22,3,2
10,311,311,2,2,0,1,0
8,396,396,34,5,29,2,1
12,411,411,97,86,11,2,1
13,424,424,65,21,44,2,1
4,439,439,94,94,0,1,0
6,489,489,76,50,26,2,1
9,495,495,20,11,9,2,1

2,128,128,4,1,3,2,1
14,146,146,3,3,0,1,0
20,150,150,17,6,11,2,1
11,155,155,7,1,6,2,1
6,167,167,14,14,0,1,0
1,178,178,6,6,0,1,0
4,200,200,22,22,0,1,0
18,224,224,33,33,0,1,0
13,229,229,26,4,22,3,2
15,236,236,33,33,0,1,0
16,241,241,39,1,38,3,2
8,245,245,6,6,0,1,0
17,275,275,5,5,0,1,0
12,286,286,21,10,11,3,2
0,286,286,51,51,0,1,0
5,377,377,18,1,17,2,1
19,395,395,91,35,56,3,2
3,432,432,50,50,0,1,0
10,437,437,8,8,0,1,0
9,442,442,93,93,0,1,0
7,477,477,50,5,45,2,1

5,129,129,97,61,36,2,1
13,136,136,3,3,0,1,0
10,137,137,6,1,5,2,1
12,165,165,63,63,0,1,0
2,177,177,14,14,0,1,0
8,240,240,5,5,0,1,0
4,261,261,14,14,0,1,0
7,299,299,2,2,0,1,0
11,319,319,40,22,18,4,3
6,368,368,4,4,0,1,0
0,369,369,3,3,0,1,0
3,465,465,1,1,0,1,0
14,467,467,18,4,14,3,2
1,483,483,46,6,40,3,2
9,486,486,65,21,44,3,2
15,497,497,119,2,117,4,3

18,109,109,5,1,4,2,1
9,109,109,39,39,0,1,0
11,119,119,2,2,0,1,0
6,131,131,5,5,0,1,0
8,232,232,48,48,0,1,0
5,292,292,9,9,0,1,0
14,305,305,64,64,0,1,0
3,311,311,27,27,0,1,0
4,336,336,23,23,0,1,0
16,354,354,153,123,30,4,3
15,367,367,18,18,0,1,0
1,370,370,1,1,0,1,0
10,382,382,32,11,21,4,3
12,386,386,35,35,0,1,0
2,391,391,29,29,0,1,0
7,433,433,29,4,25,2,1
17,461,461,21,6,15,4,3
13,464,464,21,21,0,1,0
0,481,481,34,12,22,2,1

3,108,108,6,6,0,1,0
6,121,121,6,6,0,1,0
4,123,123,14,14,0,1,0
11,152,152,2,2,0,1,0
2,188,188,6,6,0,1,0
14,190,190,8,5,3,2,1
0,207,207,30,30,0,1,0
5,209,209,106,64,42,4,3
7,210,210,5,5,0,1,0
8,220,220,30,27,3,2,1
9,255,255,24,24,0,1,0
15,278,278,60,60,0,1,0
16,283,283,15,3,12,4,3
1,340,340,25,25,0,1,0
12,356,356,95,95,0,1,0
13,356,356,37,37,0,1,0
10,452,452,40,40,0,1,0

8,104,104,7,7,0,1,0
9,174,174,16,3,13,2,1
11,176,176,3,3,0,1,0
12,200,200,19,9,10,2,1
7,206,206,15,1,14,2,1
15,242,242,101,27,74,4,3
3,245,245,6,6,0,1,0
6,252,252,16,16,0,1,0
0,269,269,65,2,63,4,3
13,271,271,17,17,0,1,0
10,285,285,28,11,17,2,1
2,296,296,6,6,0,1,0
14,296,296,31,15,16,2,1
5,333,333,159,33,126,4,3
4,336,336,54,15,39,4,3
1,401,401,6,6,0,1,0

2,127,127,27,20,7,2,1
0,161,161,59,10,49,2,1
6,190,190,12,12,0,1,0
9,190,190,7,3,4,2,1
5,207,207,1,1,0,1,0
11,231,231,29,3,26,2,1
10,241,241,6,6,0,1,0
8,260,260,23,23,0,1,0
1,315,315,85,85,0,1,0
13,338,338,20,5,15,2,1
14,393,393,72,40,32,2,1
7,405,405,118,85,33,4,3
12,411,411,61,45,16,2,1
3,426,426,12,6,6,2,1
4,489,489,59,22,37,4,3

11,107,107,22,22,0,1,0
20,127,127,20,12,8,2,1
18,131,131,7,7,0,1,0
17,137,137,6,6,0,1,0
2,146,146,1,1,0,1,0
23,158,158,34,34,0,1,0
6,183,183,13,1,12,4,3
5,184,184,1,1,0,1,0
12,207,207,48,48,0,1,0
9,229,229,1,1,0,1,0
21,238,238,3,3,0,1,0
10,240,240,1,1,0,1,0
0,249,249,35,35,0,1,0
19,277,277,76,25,51,4,3
13,286,286,11,11,0,1,0
15,332,332,18,6,12,3,2
3,336,336,7,7,0,1,0
8,362,362,23,23,0,1,0
14,390,390,26,26,0,1,0
22,404,404,42,10,32,3,2
7,456,456,13,13,0,1,0
16,488,488,50,50,0,1,0
1,490,490,1,1,0,1,0
4,498,498,55,49,6,2,1

10,112,112,26,26,0,1,0
17,119,119,17,2,15,2,1
11,149,149,1,1,0,1,0
5,161,161,7,7,0,1,0
22,191,191,47,23,24,2,1
20,198,198,4,1,3,2,1
6,205,205,12,12,0,1,0
18,210,210,2,2,0,1,0
8,214,214,11,11,0,1,0
13,220,220,12,9,3,2,1
4,241,241,1,1,0,1,0
1,301,301,18,7,11,3,2
16,316,316,19,13,6,2,1
14,323,323,57,57,0,1,0
15,331,331,1,1,0,1,0
7,346,346,34,34,0,1,0
19,355,355,114,44,70,4,3
12,383,383,32,4,28,3,2
2,398,398,25,17,8,2,1
3,425,425,21,18,3,2,1
0,446,446,27,9,18,3,2
21,446,446,17,12,5,2,1
9,455,455,63,24,39,4,3

20,108,108,10,10,0,1,0
5,112,112,6,2,4,2,1
16,128,128,4,4,0,1,0
1,133,133,11,2,9,2,1
9,153,153,10,10,0,1,0
18,174,174,3,3,0,1,0
15,176,176,74,4,70,3,2
14,180,180,12,12,0,1,0
6,254,254,74,74,0,1,0
19,293,293,2,2,0,1,0
11,316,316,16,16,0,1,0
10,323,323,24,24,0,1,0
17,340,340,24,10,14,3,2
4,369,369,1,1,0,1,0
13,370,370,88,6,82,3,2
2,371,371,30,30,0,1,0
12,383,383,28,28,0,1,0
8,450,450,8,8,0,1,0
0,475,475,53,5,48,3,2
3,489,489,68,43,25,3,2
7,496,496,15,15,0,1,0

13,103,103,26,26,0,1,0
3,108,108,17,17,0,1,0
18,177,177,13,13,0,1,0
8,196,196,27,19,8,3,2
15,233,233,1,1,0,1,0
10,245,245,29,29,0,1,0
4,253,253,75,75,0,1,0
16,255,255,12,12,0,1,0
11,268,268,16,16,0,1,0
0,270,270,28,28,0,1,0
14,275,275,5,5,0,1,0
1,290,290,2,2,0,1,0
5,294,294,2,2,0,1,0
2,358,358,12,6,6,2,1
17,425,425,186,116,70,3,2
6,443,443,12,4,8,3,2
7,457,457,29,5,24,4,3
9,473,473,79,42,37,3,2
12,485,485,7,7,0,1,0

15,107,107,3,3,0,1,0
7,133,133,2,2,0,1,0
1,144,144,1,1,0,1,0
17,168,168,7,7,0,1,0
16,204,204,33,33,0,1,0
9,205,205,17,4,13,3,2
13,229,229,6,6,0,1,0
14,256,256,64,60,4,2,1
4,286,286,1,1,0,1,0
2,288,288,1,1,0,1,0
10,297,297,64,64,0,1,0
11,313,313,48,28,20,3,2
3,352,352,9,9,0,1,0
8,365,365,183,56,127,4,3
5,387,387,10,10,0,1,0
12,387,387,23,17,6,2,1
6,479,479,86,86,0,1,0
0,499,499,120,69,51,4,3

14,109,109,7,7,0,1,0
12,111,111,1,1,0,1,0
3,118,118,1,1,0,1,0
20,124,124,2,2,0,1,0
13,155,155,1,1,0,1,0
2,156,156,1,1,0,1,0
26,165,165,29,8,21,3,2
23,171,171,12,7,5,2,1
15,183,183,1,1,0,1,0
25,192,192,7,7,0,1,0
7,193,193,9,9,0,1,0
4,195,195,11,11,0,1,0
19,215,215,4,4,0,1,0
8,282,282,38,38,0,1,0
1,293,293,29,29,0,1,0
16,310,310,25,1,24,2,1
22,322,322,47,29,18,4,3
10,326,326,14,14,0,1,0
6,353,353,2,2,0,1,0
21,357,357,5,5,0,1,0
17,360,360,77,18,59,4,3
0,377,377,5,5,0,1,0
18,389,389,178,122,56,4,3
11,394,394,37,33,4,2,1
24,411,411,33,21,12,4,3
5,448,448,35,19,16,2,1
9,460,460,16,4,12,3,2

19,123,123,5,5,0,1,0
5,128,128,5,5,0,1,0
18,159,159,5,5,0,1,0
10,168,168,17,17,0,1,0
14,181,181,4,4,0,1,0
9,183,183,4,4,0,1,0
6,222,222,18,3,15,2,1
3,223,223,2,2,0,1,0
0,260,260,53,53,0,1,0
16,266,266,8,8,0,1,0
20,268,268,3,3,0,1,0
7,287,287,97,31,66,4,3
13,288,288,115,115,0,1,0
1,324,324,8,8,0,1,0
15,376,376,49,49,0,1,0
2,391,391,25,17,8,2,1
12,395,395,41,33,8,3,2
4,421,421,11,2,9,4,3
11,458,458,24,3,21,2,1
8,474,474,19,19,0,1,0
17,482,482,122,40,82,3,2

9,121,121,1,1,0,1,0
18,125,125,7,7,0,1,0
14,129,129,4,4,0,1,0
0,170,170,7,7,0,1,0
11,217,217,1,1,0,1,0
13,243,243,33,5,28,3,2
16,259,259,90,21,69,4,3
8,262,262,8,8,0,1,0
19,273,273,6,6,0,1,0
15,290,290,8,8,0,1,0
17,296,296,23,19,4,2,1
12,296,296,20,1,19,2,1
7,339,339,48,48,0,1,0
10,339,339,95,17,78,4,3
20,360,360,95,61,34,2,1
6,384,384,16,16,0,1,0
4,387,387,6,6,0,1,0
21,434,434,25,25,0,1,0
1,459,459,7,7,0,1,0
3,465,465,31,20,11,2,1
5,491,491,114,114,0,1,0
2,499,499,29,29,0,1,0

9,164,164,30,15,15,4,3
10,164,164,41,41,0,1,0
11,178,178,29,5,24,2,1
12,188,188,1,1,0,1,0
0,192,192,1,1,0,1,0
14,216,216,14,3,11,2,1
3,231,231,36,2,34,2,1
6,258,258,61,61,0,1,0
5,292,292,77,11,66,4,3
2,340,340,53,2,51,4,3
7,356,356,17,13,4,2,1
1,381,381,21,17,4,2,1
15,393,393,9,3,6,3,2
4,423,423,55,55,0,1,0
13,424,424,9,9,0,1,0
8,450,450,117,117,0,1,0

9,118,118,15,3,12,2,1
6,187,187,6,6,0,1,0
0,233,233,9,3,6,3,2
11,238,238,9,9,0,1,0
7,245,245,5,5,0,1,0
4,251,251,14,1,13,2,1
10,251,251,9,9,0,1,0
2,261,261,1,1,0,1,0
16,290,290,58,58,0,1,0
3,348,348,85,85,0,1,0
8,415,415,4,4,0,1,0
15,421,421,126,126,0,1,0
13,422,422,67,67,0,1,0
14,435,435,44,44,0,1,0
5,438,438,43,43,0,1,0
12,456,456,17,1,16,3,2
1,478,478,243,225,18,4,3

6,170,170,43,43,0,1,0
14,188,188,34,34,0,1,0
3,210,210,1,1,0,1,0
10,230,230,40,40,0,1,0
4,246,246,23,15,8,2,1
8,283,283,33,33,0,1,0
0,288,288,97,16,81,4,3
9,295,295,18,18,0,1,0
12,307,307,26,26,0,1,0
13,318,318,10,10,0,1,0
5,325,325,109,76,33,4,3
11,373,373,31,3,28,3,2
2,435,435,29,11,18,4,3
7,469,469,15,9,6,2,1
1,499,499,82,82,0,1,0

16,107,107,8,8,0,1,0
7,112,112,5,2,3,2,1
8,124,124,25,25,0,1,0
0,131,131,1,1,0,1,0
3,139,139,18,18,0,1,0
9,155,155,15,15,0,1,0
2,168,168,1,1,0,1,0
4,173,173,6,6,0,1,0
17,228,228,3,3,0,1,0
5,237,237,32,32,0,1,0
6,263,263,40,9,31,2,1
15,302,302,67,67,0,1,0
13,328,328,11,4,7,3,2
10,345,345,18,18,0,1,0
11,404,404,97,34,63,4,3
18,438,438,34,34,0,1,0
1,453,453,89,89,0,1,0
12,456,456,41,23,18,4,3
14,469,469,97,9,88,4,3

11,129,129,3,3,0,1,0
18,136,136,32,5,27,4,3
0,156,156,28,28,0,1,0
4,158,158,9,9,0,1,0
12,162,162,10,6,4,2,1
7,173,173,6,6,0,1,0
10,181,181,5,1,4,2,1
14,197,197,3,3,0,1,0
2,219,219,2,2,0,1,0
15,257,257,15,15,0,1,0
5,260,260,5,5,0,1,0
1,303,303,114,25,89,3,2
6,329,329,79,50,29,3,2
19,340,340,13,13,0,1,0
17,340,340,56,22,34,2,1
3,350,350,8,8,0,1,0
8,375,375,1,1,0,1,0
13,405,405,146,108,38,2,1
9,444,444,14,14,0,1,0
16,472,472,27,20,7,2,1

12,114,114,14,14,0,1,0
2,115,115,11,11,0,1,0
4,117,117,21,7,14,3,2
20,162,162,28,28,0,1,0
6,162,162,3,3,0,1,0
19,180,180,1,1,0,1,0
10,189,189,28,28,0,1,0
7,246,246,8,8,0,1,0
14,323,323,49,37,12,2,1
16,323,323,24,24,0,1,0
17,324,324,74,44,30,2,1
1,381,381,11,2,9,2,1
13,392,392,62,14,48,2,1
15,428,428,2,2,0,1,0
11,429,429,25,25,0,1,0
9,437,437,79,73,6,2,1
18,453,453,49,49,0,1,0
3,454,454,68,33,35,2,1
0,456,456,17,5,12,4,3
5,476,476,3,3,0,1,0
8,476,476,31,1,30,4,3

0,135,135,2,2,0,1,0
17,144,144,7,4,3,2,1
10,170,170,8,8,0,1,0
13,177,177,24,24,0,1,0
16,178,178,12,8,4,2,1
8,206,206,32,2,30,4,3
6,206,206,8,8,0,1,0
14,231,231,16,7,9,2,1
18,244,244,17,1,16,2,1
1,249,249,22,11,11,2,1
2,262,262,1,1,0,1,0
5,271,271,5,5,0,1,0
7,298,298,4,4,0,1,0
3,310,310,79,57,22,3,2
12,338,338,7,7,0,1,0
11,364,364,14,14,0,1,0
19,402,402,140,140,0,1,0
4,408,408,85,55,30,4,3
20,437,437,60,60,0,1,0
9,475,475,57,3,54,3,2
15,482,482,59,59,0,1,0

1,136,136,4,1,3,2,1
13,150,150,20,7,13,2,1
17,199,199,6,2,4,2,1
6,204,204,18,18,0,1,0
7,253,253,20,20,0,1,0
19,278,278,3,3,0,1,0
0,278,278,20,11,9,2,1
4,306,306,81,54,27,4,3
11,323,323,19,5,14,3,2
10,369,369,1,1,0,1,0
12,370,370,44,44,0,1,0
16,380,380,79,79,0,1,0
8,386,386,39,3,36,2,1
15,424,424,97,97,0,1,0
9,426,426,15,15,0,1,0
2,443,443,15,15,0,1,0
14,447,447,14,1,13,2,1
5,470,470,50,50,0,1,0
18,471,471,91,60,31,3,2
3,484,484,91,91,0,1,0

7,117,117,5,5,0,1,0
0,128,128,25,25,0,1,0
4,135,135,18,7,11,2,1
8,138,138,19,19,0,1,0
3,151,151,17,17,0,1,0
12,175,175,3,3,0,1,0
10,197,197,6,1,5,2,1
1,241,241,99,80,19,2,1
14,298,298,118,35,83,4,3
2,303,303,33,33,0,1,0
13,309,309,3,3,0,1,0
5,314,314,13,1,12,3,2
11,321,321,27,2,25,2,1
6,405,405,69,69,0,1,0
9,435,435,59,27,32,4,3

3,136,136,8,8,0,1,0
12,181,181,25,4,21,2,1
5,219,219,19,19,0,1,0
1,225,225,1,1,0,1,0
9,245,245,13,13,0,1,0
10,284,284,129,129,0,1,0
7,292,292,35,16,19,3,2
4,298,298,10,2,8,3,2
11,309,309,4,4,0,1,0
15,336,336,10,10,0,1,0
8,348,348,28,28,0,1,0
0,376,376,91,40,51,4,3
2,425,425,96,85,11,2,1
6,472,472,165,143,22,4,3
14,492,492,13,13,0,1,0
13,495,495,50,50,0,1,0

0,108,108,8,8,0,1,0
9,131,131,2,2,0,1,0
15,144,144,16,16,0,1,0
2,147,147,17,7,10,2,1
12,234,234,57,21,36,3,2
3,237,237,38,27,11,2,1
1,249,249,1,1,0,1,0
10,250,250,75,75,0,1,0
4,271,271,8,5,3,2,1
14,313,313,5,5,0,1,0
7,348,348,73,73,0,1,0
6,417,417,113,70,43,4,3
13,424,424,51,51,0,1,0
16,440,440,40,40,0,1,0
5,484,484,67,67,0,1,0
11,485,485,48,48,0,1,0
8,497,497,9,5,4,2,1

2,121,121,7,2,5,2,1
10,126,126,11,1,10,2,1
14,139,139,13,13,0,1,0
4,154,154,22,22,0,1,0
3,187,187,22,22,0,1,0
18,195,195,8,1,7,2,1
8,196,196,3,3,0,1,0
0,196,196,13,7,6,3,2
12,209,209,3,3,0,1,0
7,210,210,15,2,13,2,1
16,257,257,17,11,6,3,2
15,292,292,25,1,24,4,3
5,319,319,44,14,30,3,2
1,371,371,2,2,0,1,0
13,374,374,28,16,12,3,2
17,388,388,42,21,21,4,3
9,422,422,102,43,59,3,2
11,423,423,189,183,6,2,1
6,491,491,71,71,0,1,0

0,106,106,9,9,0,1,0
14,112,112,4,4,0,1,0
17,127,127,3,3,0,1,0
12,128,128,7,7,0,1,0
3,153,153,7,7,0,1,0
8,170,170,1,1,0,1,0
10,170,170,21,21,0,1,0
16,171,171,9,9,0,1,0
20,197,197,36,36,0,1,0
9,258,258,22,22,0,1,0
1,283,283,10,10,0,1,0
4,293,293,12,12,0,1,0
13,330,330,121,22,99,4,3
15,335,335,4,4,0,1,0
6,345,345,18,18,0,1,0
19,350,350,19,3,16,3,2
7,374,374,7,7,0,1,0
11,380,380,12,12,0,1,0
2,389,389,153,99,54,4,3
18,395,395,90,90,0,1,0
5,479,479,15,15,0,1,0
21,486,486,33,23,10,2,1

8,116,116,20,20,0,1,0
4,177,177,13,7,6,2,1
0,243,243,51,29,22,2,1
6,279,279,72,72,0,1,0
10,305,305,42,35,7,2,1
14,309,309,29,13,16,2,1
7,335,335,65,65,0,1,0
9,363,363,1,1,0,1,0
13,365,365,19,19,0,1,0
11,373,373,11,5,6,3,2
5,384,384,59,59,0,1,0
2,406,406,56,30,26,2,1
3,429,429,127,127,0,1,0
12,437,437,31,16,15,4,3
1,453,453,59,28,31,2,1

3,111,111,8,8,0,1,0
0,123,123,14,14,0,1,0
7,126,126,3,3,0,1,0
1,153,153,25,25,0,1,0
18,175,175,9,9,0,1,0
10,185,185,43,3,40,3,2
5,195,195,27,13,14,3,2
13,210,210,5,5,0,1,0
12,221,221,12,6,6,2,1
15,283,283,7,7,0,1,0
4,314,314,31,31,0,1,0
14,331,331,4,4,0,1,0
2,346,346,5,5,0,1,0
9,349,349,48,48,0,1,0
8,364,364,69,69,0,1,0
11,396,396,65,16,49,4,3
6,410,410,20,3,17,3,2
16,454,454,58,6,52,3,2
17,457,457,149,101,48,4,3

0,100,100,15,15,0,1,0
8,101,101,4,4,0,1,0
20,104,104,19,4,15,4,3
7,144,144,7,7,0,1,0
12,156,156,15,15,0,1,0
14,160,160,7,1,6,2,1
21,197,197,19,6,13,4,3
17,223,223,40,16,24,2,1
18,238,238,24,24,0,1,0
6,300,300,19,13,6,3,2
2,328,328,21,6,15,2,1
9,334,334,25,25,0,1,0
15,348,348,7,7,0,1,0
4,358,358,25,25,0,1,0
3,364,364,89,1,88,4,3
19,368,368,67,57,10,3,2
13,389,389,78,18,60,4,3
10,391,391,20,4,16,2,1
11,429,429,14,6,8,3,2
16,444,444,7,2,5,2,1
5,458,458,6,6,0,1,0
1,494,494,28,1,27,4,3

16,135,135,33,3,30,2,1
11,136,136,1,1,0,1,0
20,142,142,4,4,0,1,0
0,172,172,53,41,12,3,2
7,183,183,11,11,0,1,0
21,184,184,5,5,0,1,0
6,194,194,14,4,10,2,1
8,238,238,29,10,19,2,1
18,239,239,9,9,0,1,0
13,279,279,29,18,11,3,2
12,298,298,1,1,0,1,0
15,398,398,155,110,45,4,3
10,406,406,17,1,16,3,2
1,407,407,49,49,0,1,0
19,408,408,62,62,0,1,0
2,421,421,16,16,0,1,0
14,423,423,1,1,0,1,0
4,429,429,16,4,12,4,3
5,434,434,22,22,0,1,0
3,455,455,49,49,0,1,0
17,461,461,17,2,15,4,3
9,485,485,16,16,0,1,0

3,125,125,18,18,0,1,0
20,162,162,16,9,7,2,1
0,190,190,2,2,0,1,0
18,200,200,33,19,14,3,2
9,203,203,28,28,0,1,0
11,209,209,1,1,0,1,0
8,212,212,17,17,0,1,0
7,224,224,20,5,15,2,1
16,273,273,1,1,0,1,0
21,300,300,1,1,0,1,0
14,317,317,83,83,0,1,0
13,329,329,48,12,36,4,3
2,345,345,38,38,0,1,0
19,365,365,35,35,0,1,0
5,366,366,2,2,0,1,0
4,380,380,19,1,18,4,3
17,383,383,43,43,0,1,0
15,403,403,51,31,20,3,2
10,407,407,40,37,3,2,1
12,422,422,37,37,0,1,0
6,436,436,36,12,24,3,2
1,487,487,49,49,0,1,0

4,107,107,47,47,0,1,0
8,128,128,5,5,0,1,0
5,136,136,2,2,0,1,0
7,201,201,5,5,0,1,0
2,212,212,6,2,4,2,1
3,239,239,48,17,31,2,1
1,243,243,8,3,5,2,1
9,299,299,34,34,0,1,0
6,360,360,21,21,0,1,0
15,380,380,30,30,0,1,0
11,387,387,29,29,0,1,0
16,412,412,24,24,0,1,0
0,415,415,21,21,0,1,0
12,428,428,4,4,0,1,0
14,436,436,130,130,0,1,0
10,436,436,159,55,104,4,3
13,442,442,31,13,18,3,2
17,476,476,4,4,0,1,0
18,491,491,23,23,0,1,0

11,121,121,21,17,4,2,1
4,131,131,4,4,0,1,0
9,131,131,32,32,0,1,0
18,140,140,7,7,0,1,0
7,155,155,21,21,0,1,0
3,171,171,2,2,0,1,0
14,175,175,8,8,0,1,0
20,176,176,7,7,0,1,0
1,183,183,16,16,0,1,0
5,198,198,7,7,0,1,0
2,206,206,2,2,0,1,0
15,212,212,5,5,0,1,0
13,224,224,37,9,28,3,2
19,228,228,43,43,0,1,0
16,247,247,20,2,18,3,2
6,273,273,5,5,0,1,0
0,334,334,32,32,0,1,0
10,418,418,16,6,10,2,1
12,426,426,112,52,60,3,2
8,443,443,54,27,27,4,3
17,489,489,80,4,76,4,3

16,129,129,22,18,4,2,1
5,141,141,41,41,0,1,0
9,145,145,2,2,0,1,0
13,171,171,4,4,0,1,0
18,204,204,1,1,0,1,0
6,249,249,29,29,0,1,0
12,256,256,81,75,6,3,2
19,258,258,31,24,7,2,1
1,260,260,36,18,18,3,2
11,314,314,23,23,0,1,0
4,319,319,6,1,5,2,1
10,338,338,4,4,0,1,0
20,355,355,24,4,20,3,2
14,385,385,21,7,14,2,1
7,407,407,2,2,0,1,0
8,414,414,17,17,0,1,0
0,414,414,44,8,36,3,2
2,417,417,74,23,51,4,3
17,418,418,16,16,0,1,0
3,433,433,4,1,3,2,1
15,493,493,112,112,0,1,0

13,107,107,3,3,0,1,0
9,124,124,18,18,0,1,0
8,132,132,23,23,0,1,0
11,149,149,4,4,0,1,0
12,167,167,35,35,0,1,0
10,234,234,9,9,0,1,0
4,237,237,1,1,0,1,0
14,252,252,44,5,39,4,3
5,255,255,29,17,12,4,3
15,273,273,53,53,0,1,0
6,275,275,45,41,4,2,1
20,279,279,6,6,0,1,0
16,287,287,1,1,0,1,0
18,305,305,57,10,47,3,2
19,316,316,63,5,58,3,2
3,350,350,27,15,12,2,1
1,354,354,40,22,18,2,1
17,390,390,1,1,0,1,0
0,395,395,36,36,0,1,0
2,419,419,22,22,0,1,0
7,420,420,1,1,0,1,0

12,104,104,1,1,0,1,0
13,139,139,8,2,6,2,1
2,185,185,5,5,0,1,0
10,232,232,61,17,44,2,1
3,244,244,1,1,0,1,0
4,268,268,1,1,0,1,0
5,276,276,117,102,15,2,1
14,279,279,109,53,56,3,2
6,376,376,13,1,12,4,3
0,381,381,89,89,0,1,0
7,403,403,12,12,0,1,0
9,410,410,33,33,0,1,0
11,421,421,59,21,38,3,2
1,430,430,133,34,99,4,3
8,461,461,9,9,0,1,0

18,104,104,23,11,12,3,2
7,109,109,7,7,0,1,0
11,111,111,41,3,38,3,2
15,131,131,20,20,0,1,0
4,176,176,6,6,0,1,0
13,203,203,12,12,0,1,0
16,214,214,34,34,0,1,0
5,216,216,27,27,0,1,0
23,221,221,2,2,0,1,0
22,229,229,21,21,0,1,0
8,236,236,1,1,0,1,0
6,237,237,4,4,0,1,0
12,249,249,5,5,0,1,0
19,249,249,21,13,8,3,2
21,295,295,26,8,18,2,1
9,299,299,13,7,6,3,2
3,340,340,12,12,0,1,0
20,351,351,1,1,0,1,0
1,353,353,22,22,0,1,0
10,360,360,10,3,7,2,1
0,401,401,29,29,0,1,0
2,433,433,20,10,10,2,1
14,445,445,9,3,6,2,1
17,486,486,101,93,8,2,1

1,124,124,2,2,0,1,0
17,137,137,23,10,13,2,1
8,152,152,7,1,6,2,1
19,162,162,20,14,6,2,1
6,179,179,31,3,28,3,2
15,232,232,12,12,0,1,0
16,240,240,30,12,18,3,2
14,285,285,51,51,0,1,0
3,300,300,43,23,20,2,1
18,320,320,28,16,12,4,3
9,324,324,9,9,0,1,0
4,330,330,3,3,0,1,0
2,358,358,109,67,42,2,1
10,375,375,54,54,0,1,0
11,421,421,94,94,0,1,0
7,429,429,7,2,5,2,1
5,447,447,37,37,0,1,0
12,451,451,12,1,11,2,1
0,459,459,17,17,0,1,0
13,491,491,15,8,7,2,1

15,127,127,1,1,0,1,0
12,131,131,28,28,0,1,0
7,181,181,56,56,0,1,0
9,190,190,17,17,0,1,0
10,191,191,10,10,0,1,0
2,232,232,21,21,0,1,0
4,236,236,18,5,13,2,1
13,268,268,11,4,7,3,2
16,300,300,15,15,0,1,0
6,314,314,58,58,0,1,0
14,317,317,81,81,0,1,0
11,322,322,63,13,50,3,2
1,329,329,9,9,0,1,0
0,335,335,54,46,8,2,1
5,391,391,45,45,0,1,0
3,434,434,17,17,0,1,0
8,437,437,52,52,0,1,0

6,136,136,14,3,11,2,1
2,170,170,2,2,0,1,0
18,190,190,44,34,10,2,1
10,206,206,44,44,0,1,0
20,235,235,37,7,30,4,3
14,235,235,35,35,0,1,0
3,259,259,23,23,0,1,0
15,269,269,21,14,7,2,1
21,278,278,41,35,6,3,2
12,279,279,9,9,0,1,0
13,303,303,7,7,0,1,0
8,334,334,1,1,0,1,0
5,361,361,1,1,0,1,0
11,368,368,18,14,4,2,1
22,382,382,20,12,8,2,1
9,395,395,74,74,0,1,0
1,414,414,73,25,48,2,1
0,423,423,13,3,10,3,2
7,431,431,15,15,0,1,0
16,434,434,65,37,28,3,2
17,461,461,23,7,16,3,2
4,476,476,21,5,16,3,2
19,483,483,1,1,0,1,0

22,104,104,5,2,3,2,1
15,119,119,4,4,0,1,0
8,143,143,2,2,0,1,0
1,160,160,1,1,0,1,0
2,167,167,1,1,0,1,0
5,206,206,17,17,0,1,0
4,214,214,9,9,0,1,0
14,235,235,49,35,14,2,1
11,240,240,4,4,0,1,0
3,257,257,17,17,0,1,0
13,269,269,9,2,7,2,1
17,275,275,11,11,0,1,0
12,296,296,23,23,0,1,0
16,317,317,63,63,0,1,0
0,321,321,10,10,0,1,0
21,371,371,15,15,0,1,0
6,385,385,52,16,36,4,3
18,409,409,90,84,6,2,1
20,461,461,120,120,0,1,0
10,481,481,4,4,0,1,0
19,482,482,69,69,0,1,0
9,493,493,90,90,0,1,0
7,493,493,46,15,31,3,2
23,493,493,18,18,0,1,0

8,100,100,2,2,0,1,0
13,112,112,1,1,0,1,0
21,121,121,5,1,4,2,1
16,136,136,11,3,8,2,1
23,144,144,1,1,0,1,0
7,162,162,6,6,0,1,0
18,165,165,48,48,0,1,0
1,183,183,8,5,3,2,1
3,222,222,31,17,14,2,1
6,233,233,21,21,0,1,0
0,254,254,8,8,0,1,0
2,261,261,73,73,0,1,0
10,286,286,30,6,24,4,3
5,319,319,5,5,0,1,0
12,343,343,3,3,0,1,0
19,345,345,33,33,0,1,0
22,359,359,76,61,15,4,3
4,360,360,18,2,16,2,1
11,360,360,11,11,0,1,0
14,417,417,58,58,0,1,0
9,475,475,1,1,0,1,0
15,483,483,54,39,15,4,3
20,495,495,66,66,0,1,0
17,498,498,23,11,12,4,3

17,133,133,9,4,5,2,1
7,164,164,1,1,0,1,0
14,198,198,50,50,0,1,0
16,213,213,13,13,0,1,0
6,227,227,15,15,0,1,0
1,251,251,36,36,0,1,0
12,298,298,26,26,0,1,0
13,299,299,69,69,0,1,0
4,311,311,10,10,0,1,0
5,316,316,25,25,0,1,0
2,323,323,59,59,0,1,0
3,368,368,73,73,0,1,0
9,414,414,38,38,0,1,0
8,430,430,15,15,0,1,0
10,463,463,28,28,0,1,0
11,465,465,26,26,0,1,0
18,477,477,2,2,0,1,0
15,492,492,101,65,36,4,3
0,497,497,83,83,0,1,0

9,121,121,7,7,0,1,0
14,141,141,6,6,0,1,0
4,147,147,28,28,0,1,0
11,150,150,10,10,0,1,0
17,174,174,12,7,5,2,1
5,183,183,1,1,0,1,0
6,194,194,18,6,12,2,1
3,209,209,6,2,4,2,1
0,216,216,33,30,3,2,1
18,283,283,83,53,30,3,2
7,287,287,1,1,0,1,0
13,299,299,4,4,0,1,0
1,307,307,53,13,40,2,1
10,309,309,17,17,0,1,0
15,331,331,80,49,31,2,1
16,355,355,74,74,0,1,0
2,380,380,55,55,0,1,0
12,384,384,18,18,0,1,0
8,423,423,13,1,12,2,1
20,459,459,39,39,0,1,0
19,463,463,7,7,0,1,0

10,102,102,2,2,0,1,0
9,130,130,1,1,0,1,0
6,133,133,12,2,10,2,1
2,142,142,49,49,0,1,0
0,179,179,1,1,0,1,0
1,226,226,46,46,0,1,0
7,231,231,35,35,0,1,0
13,277,277,20,20,0,1,0
5,281,281,95,70,25,4,3
12,308,308,19,19,0,1,0
8,398,398,31,31,0,1,0
14,423,423,116,116,0,1,0
11,444,444,119,47,72,3,2
4,456,456,13,3,10,3,2
3,461,461,37,9,28,2,1

11,114,114,7,7,0,1,0
14,124,124,16,16,0,1,0
1,173,173,17,17,0,1,0
16,216,216,7,7,0,1,0
18,219,219,12,12,0,1,0
8,235,235,14,14,0,1,0
3,286,286,48,36,12,2,1
15,338,338,100,34,66,3,2
13,341,341,89,47,42,2,1
9,345,345,17,17,0,1,0
4,355,355,23,18,5,2,1
6,388,388,31,31,0,1,0
12,409,409,34,34,0,1,0
0,419,419,15,5,10,2,1
17,436,436,38,38,0,1,0
7,438,438,96,60,36,3,2
10,443,443,6,2,4,2,1
5,444,444,3,3,0,1,0
2,491,491,108,39,69,4,3

10,107,107,1,1,0,1,0
1,114,114,1,1,0,1,0
7,121,121,7,7,0,1,0
9,150,150,8,8,0,1,0
16,151,151,59,59,0,1,0
5,169,169,2,2,0,1,0
17,173,173,9,9,0,1,0
19,185,185,16,1,15,4,3
21,203,203,17,17,0,1,0
20,243,243,59,59,0,1,0
4,245,245,16,4,12,4,3
22,249,249,18,1,17,3,2
2,252,252,30,9,21,2,1
12,261,261,21,21,0,1,0
3,267,267,18,18,0,1,0
11,320,320,93,3,90,4,3
8,331,331,20,20,0,1,0
0,344,344,9,5,4,2,1
13,365,365,22,10,12,4,3
18,382,382,9,9,0,1,0
15,413,413,27,27,0,1,0
6,415,415,4,4,0,1,0
23,456,456,18,10,8,3,2
14,475,475,7,3,4,2,1
24,499,499,13,13,0,1,0

9,105,105,24,14,10,3,2
3,147,147,32,32,0,1,0
14,157,157,1,1,0,1,0
0,206,206,25,6,19,2,1
15,213,213,6,6,0,1,0
11,214,214,29,14,15,3,2
1,239,239,36,14,22,2,1
6,294,294,5,5,0,1,0
8,306,306,65,17,48,4,3
10,312,312,85,46,39,4,3
7,349,349,22,6,16,3,2
13,368,368,20,4,16,3,2
2,396,396,42,37,5,2,1
12,454,454,14,6,8,3,2
5,484,484,1,1,0,1,0
4,497,497,193,193,0,1,0

9,104,104,21,9,12,4,3
6,117,117,1,1,0,1,0
12,118,118,3,3,0,1,0
16,134,134,15,15,0,1,0
4,149,149,1,1,0,1,0
7,151,151,26,5,21,2,1
5,183,183,10,2,8,3,2
15,190,190,24,24,0,1,0
13,199,199,38,38,0,1,0
3,224,224,16,7,9,4,3
11,250,250,14,14,0,1,0
8,257,257,4,4,0,1,0
18,257,257,11,11,0,1,0
19,279,279,8,5,3,2,1
0,302,302,86,32,54,3,2
10,348,348,2,2,0,1,0
17,370,370,28,28,0,1,0
20,390,390,154,112,42,4,3
1,428,428,52,28,24,3,2
14,433,433,13,6,7,2,1
2,476,476,1,1,0,1,0

10,119,119,3,3,0,1,0
17,129,129,2,2,0,1,0
22,155,155,68,31,37,2,1
6,176,176,3,3,0,1,0
21,180,180,5,2,3,2,1
19,181,181,12,12,0,1,0
18,181,181,44,44,0,1,0
7,194,194,3,3,0,1,0
3,240,240,30,10,20,2,1
4,281,281,15,10,5,2,1
14,294,294,10,3,7,2,1
20,321,321,39,19,20,2,1
8,338,338,13,1,12,2,1
2,344,344,1,1,0,1,0
11,352,352,35,35,0,1,0
1,358,358,45,45,0,1,0
16,370,370,15,15,0,1,0
13,374,374,18,18,0,1,0
15,412,412,13,13,0,1,0
9,428,428,22,22,0,1,0
5,453,453,43,11,32,2,1
12,457,457,72,42,30,2,1
0,474,474,70,70,0,1,0

6,109,109,11,11,0,1,0
1,115,115,58,10,48,3,2
11,122,122,21,7,14,3,2
12,129,129,32,32,0,1,0
5,143,143,1,1,0,1,0
14,144,144,23,8,15,2,1
7,201,201,6,6,0,1,0
10,210,210,27,5,22,3,2
3,223,223,1,1,0,1,0
16,282,282,68,68,0,1,0
4,302,302,10,10,0,1,0
0,333,333,43,4,39,4,3
13,345,345,10,10,0,1,0
8,378,378,30,30,0,1,0
17,434,434,3,3,0,1,0
15,444,444,2,2,0,1,0
9,470,470,32,14,18,4,3
18,475,475,13,13,0,1,0
2,491,491,22,22,0,1,0

6,110,110,1,1,0,1,0
13,150,150,14,14,0,1,0
19,158,158,8,8,0,1,0
16,194,194,11,5,6,3,2
7,212,212,6,3,3,2,1
11,213,213,70,34,36,3,2
2,219,219,15,15,0,1,0
17,282,282,26,10,16,2,1
3,305,305,2,2,0,1,0
9,310,310,16,16,0,1,0
4,337,337,157,45,112,4,3
14,375,375,31,8,23,2,1
10,380,380,48,48,0,1,0
0,391,391,1,1,0,1,0
15,393,393,69,69,0,1,0
5,395,395,70,20,50,2,1
12,401,401,19,19,0,1,0
8,422,422,25,25,0,1,0
1,428,428,3,3,0,1,0
18,499,499,47,47,0,1,0

7,154,154,3,3,0,1,0
1,161,161,5,5,0,1,0
18,161,161,4,4,0,1,0
6,219,219,3,3,0,1,0
12,267,267,11,11,0,1,0
10,313,313,205,156,49,4,3
15,314,314,16,4,12,4,3
4,323,323,48,48,0,1,0
9,333,333,11,2,9,2,1
14,348,348,64,34,30,2,1
16,359,359,1,1,0,1,0
13,364,364,11,11,0,1,0
5,424,424,21,21,0,1,0
17,430,430,8,5,3,2,1
3,433,433,234,234,0,1,0
0,438,438,6,2,4,2,1
11,440,440,4,4,0,1,0
8,445,445,15,5,10,3,2
2,468,468,56,56,0,1,0

22,114,114,8,8,0,1,0
17,136,136,43,43,0,1,0
2,141,141,10,3,7,2,1
12,168,168,2,2,0,1,0
19,169,169,3,3,0,1,0
8,171,171,14,14,0,1,0
18,185,185,20,20,0,1,0
9,204,204,8,2,6,3,2
6,219,219,4,1,3,2,1
13,242,242,1,1,0,1,0
3,250,250,27,14,13,2,1
23,255,255,12,12,0,1,0
7,267,267,30,16,14,3,2
16,268,268,38,19,19,2,1
1,270,270,1,1,0,1,0
10,334,334,37,19,18,2,1
5,337,337,57,57,0,1,0
15,348,348,17,8,9,2,1
14,348,348,13,5,8,3,2
0,363,363,24,11,13,2,1
20,375,375,98,29,69,4,3
4,390,390,36,9,27,2,1
21,446,446,4,4,0,1,0
11,470,470,35,5,30,4,3

10,123,123,15,15,0,1,0
16,143,143,11,5,6,2,1
15,174,174,42,42,0,1,0
1,194,194,9,9,0,1,0
18,196,196,7,3,4,2,1
9,197,197,61,47,14,4,3
20,205,205,10,1,9,2,1
3,222,222,2,2,0,1,0
4,224,224,24,24,0,1,0
12,232,232,11,7,4,2,1
7,255,255,4,4,0,1,0
11,257,257,3,3,0,1,0
5,272,272,3,3,0,1,0
8,296,296,67,55,12,4,3
0,346,346,15,3,12,2,1
14,384,384,22,22,0,1,0
21,434,434,43,3,40,3,2
17,439,439,83,33,50,3,2
19,471,471,93,93,0,1,0
13,482,482,33,17,16,3,2
6,482,482,1,1,0,1,0
2,490,490,25,25,0,1,0

18,105,105,16,11,5,2,1
7,115,115,7,3,4,2,1
5,119,119,15,15,0,1,0
3,124,124,9,5,4,2,1
6,155,155,5,2,3,2,1
11,158,158,22,2,20,2,1
15,167,167,7,3,4,2,1
23,195,195,4,4,0,1,0
16,203,203,8,8,0,1,0
22,236,236,26,13,13,2,1
20,244,244,26,26,0,1,0
19,253,253,87,87,0,1,0
12,291,291,34,10,24,4,3
8,304,304,7,7,0,1,0
0,323,323,5,2,3,2,1
4,372,372,61,12,49,2,1
10,392,392,10,1,9,4,3
1,396,396,24,24,0,1,0
17,428,428,40,40,0,1,0
2,449,449,41,2,39,4,3
9,482,482,12,12,0,1,0
14,482,482,9,9,0,1,0
13,485,485,14,14,0,1,0
21,489,489,56,56,0,1,0

2,150,150,6,6,0,1,0
6,160,160,6,6,0,1,0
18,180,180,20,20,0,1,0
0,182,182,20,9,11,2,1
1,189,189,30,14,16,2,1
7,216,216,4,4,0,1,0
5,233,233,56,25,31,2,1
4,234,234,15,5,10,2,1
14,265,265,43,36,7,2,1
17,285,285,99,36,63,4,3
8,286,286,2,2,0,1,0
9,297,297,77,73,4,2,1
15,350,350,58,58,0,1,0
16,360,360,16,16,0,1,0
11,364,364,5,2,3,2,1
12,440,440,2,2,0,1,0
13,472,472,12,12,0,1,0
10,481,481,68,2,66,4,3
3,498,498,33,3,30,2,1

11,118,118,4,4,0,1,0
16,134,134,5,5,0,1,0
17,175,175,29,11,18,2,1
19,199,199,64,64,0,1,0
9,229,229,16,16,0,1,0
14,247,247,12,12,0,1,0
4,295,295,40,7,33,2,1
5,295,295,58,21,37,2,1
7,303,303,12,3,9,2,1
8,313,313,45,45,0,1,0
10,314,314,18,18,0,1,0
15,331,331,59,13,46,3,2
18,338,338,17,17,0,1,0
1,339,339,3,3,0,1,0
12,353,353,50,14,36,4,3
0,400,400,11,11,0,1,0
3,413,413,16,16,0,1,0
13,424,424,18,18,0,1,0
2,427,427,91,91,0,1,0
6,482,482,34,34,0,1,0

17,110,110,1,1,0,1,0
9,147,147,3,3,0,1,0
18,154,154,40,40,0,1,0
22,159,159,2,2,0,1,0
14,163,163,28,12,16,2,1
13,169,169,2,2,0,1,0
8,214,214,1,1,0,1,0
2,219,219,20,12,8,3,2
12,220,220,10,10,0,1,0
21,237,237,20,20,0,1,0
4,239,239,17,17,0,1,0
5,272,272,15,15,0,1,0
0,276,276,20,3,17,2,1
6,319,319,10,10,0,1,0
10,329,329,59,37,22,2,1
15,331,331,102,102,0,1,0
19,359,359,15,15,0,1,0
16,367,367,9,9,0,1,0
20,398,398,69,69,0,1,0
23,414,414,43,11,32,3,2
1,416,416,12,2,10,3,2
11,435,435,2,2,0,1,0
7,442,442,37,7,30,4,3
3,492,492,63,63,0,1,0

1,134,134,3,3,0,1,0
14,142,142,46,46,0,1,0
10,162,162,4,4,0,1,0
5,201,201,11,1,10,2,1
19,214,214,17,11,6,2,1
11,250,250,55,55,0,1,0
3,258,258,9,9,0,1,0
15,269,269,20,20,0,1,0
0,292,292,66,18,48,3,2
13,309,309,1,1,0,1,0
7,335,335,13,13,0,1,0
18,340,340,8,8,0,1,0
8,363,363,125,50,75,4,3
6,402,402,12,4,8,3,2
12,409,409,80,64,16,4,3
17,409,409,33,33,0,1,0
16,439,439,11,11,0,1,0
9,446,446,22,10,12,3,2
2,470,470,16,10,6,2,1
4,479,479,69,5,64,4,3

15,106,106,11,1,10,2,1
17,154,154,1,1,0,1,0
9,210,210,1,1,0,1,0
20,210,210,26,12,14,2,1
14,233,233,13,10,3,2,1
16,233,233,16,16,0,1,0
4,234,234,24,6,18,2,1
12,235,235,7,7,0,1,0
1,284,284,2,2,0,1,0
7,316,316,1,1,0,1,0
5,335,335,16,16,0,1,0
24,351,351,1,1,0,1,0
23,379,379,24,24,0,1,0
3,392,392,41,41,0,1,0
10,402,402,60,24,36,2,1
0,403,403,16,6,10,2,1
13,411,411,10,1,9,2,1
22,411,411,50,35,15,4,3
11,412,412,1,1,0,1,0
21,426,426,121,74,47,2,1
25,443,443,50,50,0,1,0
8,444,444,83,43,40,2,1
18,452,452,105,58,47,2,1
2,453,453,2,2,0,1,0
6,463,463,32,26,6,2,1
19,490,490,31,4,27,2,1

8,113,113,9,9,0,1,0
16,141,141,9,3,6,2,1
2,143,143,20,14,6,2,1
11,184,184,1,1,0,1,0
0,215,215,9,9,0,1,0
10,217,217,5,5,0,1,0
13,219,219,3,3,0,1,0
4,234,234,15,8,7,2,1
7,251,251,40,31,9,4,3
14,270,270,37,37,0,1,0
18,282,282,14,14,0,1,0
22,359,359,61,61,0,1,0
6,367,367,16,16,0,1,0
15,386,386,43,23,20,2,1
3,389,389,37,7,30,3,2
20,413,413,5,5,0,1,0
19,414,414,1,1,0,1,0
17,433,433,59,59,0,1,0
1,443,443,8,8,0,1,0
9,468,468,120,115,5,2,1
21,472,472,159,159,0,1,0
5,485,485,15,3,12,2,1
12,485,485,16,5,11,2,1

4,118,118,1,1,0,1,0
7,126,126,6,6,0,1,0
1,135,135,1,1,0,1,0
3,146,146,12,3,9,4,3
2,154,154,69,5,64,3,2
13,191,191,24,24,0,1,0
18,219,219,40,40,0,1,0
16,246,246,28,24,4,2,1
14,255,255,42,30,12,2,1
11,262,262,23,23,0,1,0
9,342,342,20,12,8,3,2
15,343,343,20,20,0,1,0
12,350,350,71,21,50,3,2
6,363,363,20,8,12,3,2
8,400,400,45,45,0,1,0
17,462,462,9,3,6,2,1
10,478,478,28,10,18,3,2
5,492,492,1,1,0,1,0
0,500,500,90,15,75,4,3

11,135,135,12,12,0,1,0
13,143,143,15,15,0,1,0
8,148,148,6,6,0,1,0
1,160,160,34,34,0,1,0
7,165,165,7,7,0,1,0
17,185,185,28,28,0,1,0
12,187,187,17,17,0,1,0
19,210,210,7,7,0,1,0
2,210,210,4,4,0,1,0
16,250,250,27,9,18,3,2
0,275,275,15,15,0,1,0
18,305,305,32,32,0,1,0
4,357,357,13,8,5,2,1
14,384,384,129,43,86,3,2
9,390,390,62,62,0,1,0
5,410,410,1,1,0,1,0
6,421,421,73,73,0,1,0
3,422,422,62,10,52,3,2
15,433,433,2,2,0,1,0
10,442,442,50,50,0,1,0

23,114,114,16,16,0,1,0
18,142,142,37,37,0,1,0
16,175,175,34,34,0,1,0
12,179,179,7,7,0,1,0
5,185,185,28,28,0,1,0
15,187,187,10,3,7,2,1
7,238,238,7,7,0,1,0
2,239,239,21,21,0,1,0
6,244,244,1,1,0,1,0
21,254,254,54,36,18,4,3
11,258,258,52,20,32,3,2
0,259,259,47,8,39,2,1
10,283,283,3,3,0,1,0
9,287,287,35,6,29,2,1
1,321,321,25,5,20,3,2
22,332,332,23,23,0,1,0
14,351,351,18,18,0,1,0
13,393,393,1,1,0,1,0
4,401,401,3,3,0,1,0
3,405,405,11,4,7,2,1
17,407,407,13,8,5,2,1
8,441,441,4,4,0,1,0
19,487,487,1,1,0,1,0
20,499,499,27,15,12,3,2

4,118,118,1,1,0,1,0
13,185,185,18,18,0,1,0
1,193,193,2,2,0,1,0
11,196,196,5,5,0,1,0
5,198,198,15,5,10,2,1
3,204,204,20,20,0,1,0
14,240,240,2,2,0,1,0
9,243,243,7,3,4,2,1
10,249,249,38,18,20,3,2
6,294,294,9,9,0,1,0
15,321,321,100,8,92,3,2
0,334,334,89,89,0,1,0
19,339,339,114,114,0,1,0
17,348,348,21,3,18,2,1
16,357,357,26,26,0,1,0
12,418,418,9,5,4,2,1
8,432,432,24,24,0,1,0
18,438,438,40,16,24,4,3
7,447,447,41,23,18,3,2
20,478,478,9,9,0,1,0
2,484,484,78,78,0,1,0

8,102,102,5,5,0,1,0
1,142,142,1,1,0,1,0
0,169,169,9,9,0,1,0
3,178,178,10,1,9,4,3
2,179,179,22,4,18,3,2
11,179,179,8,8,0,1,0
15,190,190,22,22,0,1,0
6,200,200,63,63,0,1,0
16,210,210,34,34,0,1,0
12,242,242,64,2,62,3,2
13,336,336,3,3,0,1,0
17,341,341,57,57,0,1,0
4,358,358,53,29,24,4,3
9,371,371,4,1,3,2,1
5,393,393,4,4,0,1,0
10,460,460,49,6,43,2,1
14,476,476,66,66,0,1,0
7,476,476,118,118,0,1,0

0,160,160,11,11,0,1,0
7,195,195,3,3,0,1,0
8,206,206,5,5,0,1,0
1,243,243,35,35,0,1,0
15,244,244,39,33,6,2,1
12,247,247,6,6,0,1,0
20,256,256,2,2,0,1,0
4,282,282,13,13,0,1,0
14,306,306,8,8,0,1,0
11,333,333,30,20,10,4,3
13,353,353,77,77,0,1,0
5,365,365,27,10,17,2,1
16,402,402,57,57,0,1,0
17,431,431,22,22,0,1,0
10,456,456,26,26,0,1,0
19,472,472,132,89,43,3,2
3,475,475,50,50,0,1,0
9,476,476,11,8,3,2,1
2,488,488,162,158,4,2,1
6,489,489,10,7,3,2,1
18,498,498,54,27,27,4,3

18,127,127,22,14,8,3,2
1,155,155,23,14,9,4,3
5,156,156,8,3,5,2,1
12,160,160,4,4,0,1,0
9,168,168,10,10,0,1,0
16,176,176,4,4,0,1,0
4,182,182,13,13,0,1,0
13,187,187,69,23,46,4,3
0,205,205,24,24,0,1,0
10,215,215,4,4,0,1,0
8,238,238,31,31,0,1,0
17,281,281,25,25,0,1,0
3,327,327,29,29,0,1,0
14,349,349,50,10,40,4,3
6,353,353,58,58,0,1,0
15,367,367,43,7,36,2,1
2,393,393,43,22,21,4,3
7,433,433,28,10,18,2,1
11,451,451,28,6,22,2,1

10,113,113,7,3,4,2,1
14,129,129,7,7,0,1,0
8,133,133,11,11,0,1,0
0,185,185,11,5,6,3,2
3,283,283,67,1,66,4,3
12,316,316,79,28,51,3,2
4,344,344,41,41,0,1,0
11,347,347,45,45,0,1,0
13,364,364,29,29,0,1,0
1,378,378,67,51,16,2,1
5,385,385,99,21,78,4,3
9,397,397,36,36,0,1,0
2,412,412,62,62,0,1,0
6,442,442,58,58,0,1,0
7,476,476,62,8,54,3,2

6,137,137,36,36,0,1,0
3,147,147,21,21,0,1,0
5,175,175,32,32,0,1,0
4,180,180,14,14,0,1,0
11,209,209,3,3,0,1,0
10,261,261,2,2,0,1,0
16,262,262,61,61,0,1,0
15,275,275,24,12,12,4,3
13,283,283,33,33,0,1,0
7,306,306,22,22,0,1,0
12,317,317,9,9,0,1,0
14,320,320,55,11,44,3,2
9,394,394,51,9,42,3,2
1,397,397,14,14,0,1,0
8,411,411,90,25,65,4,3
0,441,441,41,7,34,2,1
2,468,468,63,63,0,1,0

4,103,103,3,3,0,1,0
18,125,125,14,14,0,1,0
9,132,132,13,2,11,2,1
8,163,163,19,11,8,2,1
12,186,186,32,32,0,1,0
11,194,194,1,1,0,1,0
20,207,207,14,1,13,2,1
1,232,232,20,4,16,3,2
17,235,235,50,50,0,1,0
2,256,256,32,32,0,1,0
19,268,268,27,27,0,1,0
16,277,277,6,6,0,1,0
15,279,279,73,73,0,1,0
14,318,318,15,15,0,1,0
13,323,323,5,5,0,1,0
5,330,330,36,36,0,1,0
3,379,379,21,9,12,3,2
7,400,400,15,15,0,1,0
10,401,401,2,2,0,1,0
0,419,419,89,89,0,1,0
6,472,472,57,14,43,2,1

12,114,114,5,5,0,1,0
11,130,130,4,4,0,1,0
14,158,158,12,3,9,3,2
6,191,191,26,26,0,1,0
9,220,220,28,28,0,1,0
4,286,286,23,23,0,1,0
2,304,304,13,2,11,2,1
3,306,306,84,74,10,3,2
10,311,311,27,18,9,4,3
0,316,316,37,37,0,1,0
18,318,318,98,38,60,4,3
17,330,330,11,11,0,1,0
19,343,343,29,29,0,1,0
8,353,353,6,6,0,1,0
7,375,375,22,5,17,4,3
13,397,397,13,13,0,1,0
1,408,408,1,1,0,1,0
5,417,417,25,25,0,1,0
15,453,453,78,78,0,1,0
16,458,458,106,28,78,3,2

0,101,101,4,4,0,1,0
10,133,133,2,2,0,1,0
14,152,152,18,18,0,1,0
1,155,155,43,10,33,4,3
3,177,177,8,8,0,1,0
5,255,255,92,26,66,4,3
7,257,257,45,45,0,1,0
13,264,264,14,14,0,1,0
4,266,266,17,6,11,2,1
15,292,292,13,13,0,1,0
12,326,326,55,55,0,1,0
8,330,330,7,3,4,2,1
11,333,333,61,49,12,2,1
6,353,353,25,25,0,1,0
2,416,416,60,28,32,3,2
9,461,461,112,112,0,1,0

9,159,159,1,1,0,1,0
0,167,167,24,15,9,2,1
14,173,173,50,29,21,4,3
12,198,198,14,4,10,2,1
5,209,209,33,21,12,2,1
3,273,273,14,2,12,2,1
11,277,277,29,4,25,2,1
18,293,293,16,1,15,2,1
4,294,294,17,17,0,1,0
6,308,308,7,7,0,1,0
20,323,323,44,44,0,1,0
16,339,339,16,16,0,1,0
15,349,349,25,13,12,3,2
2,375,375,2,2,0,1,0
7,375,375,10,10,0,1,0
19,416,416,81,74,7,2,1
1,419,419,32,2,30,2,1
21,445,445,27,19,8,2,1
8,447,447,21,10,11,2,1
10,452,452,104,104,0,1,0
13,472,472,67,23,44,4,3
17,483,483,9,9,0,1,0

0,123,123,23,23,0,1,0
14,163,163,16,6,10,2,1
1,202,202,3,3,0,1,0
10,209,209,6,6,0,1,0
11,227,227,36,10,26,2,1
5,260,260,4,4,0,1,0
13,265,265,16,16,0,1,0
3,269,269,25,25,0,1,0
6,333,333,90,43,47,2,1
7,343,343,52,16,36,2,1
8,354,354,7,4,3,2,1
16,359,359,205,156,49,2,1
9,368,368,16,16,0,1,0
15,382,382,1,1,0,1,0
12,404,404,5,2,3,2,1
17,419,419,15,15,0,1,0
4,441,441,101,27,74,3,2
2,462,462,10,10,0,1,0

0,121,121,7,7,0,1,0
19,128,128,20,20,0,1,0
20,145,145,15,2,13,2,1
8,176,176,6,3,3,2,1
1,182,182,1,1,0,1,0
3,228,228,46,13,33,4,3
5,231,231,31,6,25,2,1
12,260,260,28,15,13,2,1
9,261,261,10,6,4,2,1
18,262,262,64,30,34,3,2
6,297,297,1,1,0,1,0
7,324,324,22,4,18,4,3
2,325,325,35,35,0,1,0
11,343,343,29,29,0,1,0
13,354,354,45,30,15,2,1
16,374,374,72,72,0,1,0
4,383,383,21,21,0,1,0
17,422,422,5,5,0,1,0
14,428,428,17,14,3,2,1
15,431,431,13,4,9,4,3
10,446,446,94,94,0,1,0

11,138,138,9,1,8,3,2
1,168,168,65,59,6,2,1
6,177,177,1,1,0,1,0
15,233,233,25,3,22,2,1
17,238,238,8,8,0,1,0
0,238,238,1,1,0,1,0
10,241,241,30,15,15,2,1
14,245,245,46,9,37,4,3
12,246,246,11,1,10,3,2
5,257,257,10,2,8,2,1
8,301,301,34,4,30,2,1
9,308,308,36,36,0,1,0
2,342,342,14,9,5,2,1
13,345,345,21,14,7,2,1
3,373,373,136,136,0,1,0
16,447,447,126,126,0,1,0
4,463,463,15,15,0,1,0
7,464,464,7,7,0,1,0

5,160,160,9,9,0,1,0
3,165,165,48,36,12,4,3
1,183,183,15,7,8,3,2
6,233,233,32,8,24,2,1
19,238,238,37,37,0,1,0
18,245,245,10,10,0,1,0
10,256,256,2,2,0,1,0
16,299,299,7,7,0,1,0
12,301,301,17,17,0,1,0
13,315,315,46,3,43,3,2
9,328,328,17,17,0,1,0
2,381,381,19,8,11,3,2
15,394,394,128,61,67,4,3
7,402,402,24,24,0,1,0
4,436,436,36,23,13,2,1
14,440,440,83,67,16,2,1
0,441,441,26,8,18,2,1
8,457,457,57,37,20,2,1
11,457,457,15,15,0,1,0
17,465,465,19,19,0,1,0

16,101,101,13,6,7,2,1
2,102,102,2,2,0,1,0
5,104,104,12,2,10,3,2
13,115,115,14,11,3,2,1
0,126,126,10,10,0,1,0
15,153,153,4,4,0,1,0
10,154,154,22,12,10,3,2
18,173,173,59,19,40,3,2
14,227,227,8,2,6,2,1
11,245,245,6,3,3,2,1
1,249,249,28,12,16,2,1
4,269,269,1,1,0,1,0
8,302,302,19,6,13,4,3
17,318,318,67,67,0,1,0
3,337,337,16,16,0,1,0
19,388,388,24,24,0,1,0
7,467,467,45,15,30,2,1
12,468,468,35,14,21,4,3
6,470,470,14,10,4,2,1
9,496,496,144,93,51,4,3

9,102,102,48,18,30,2,1
0,159,159,10,10,0,1,0
11,195,195,9,9,0,1,0
10,218,218,10,4,6,2,1
12,240,240,58,43,15,4,3
5,290,290,9,9,0,1,0
4,303,303,2,2,0,1,0
1,324,324,31,31,0,1,0
18,346,346,34,30,4,2,1
16,381,381,68,68,0,1,0
17,385,385,71,28,43,3,2
6,391,391,27,16,11,2,1
2,397,397,14,14,0,1,0
14,415,415,18,18,0,1,0
3,418,418,39,39,0,1,0
20,456,456,101,92,9,2,1
13,456,456,12,8,4,2,1
7,456,456,17,17,0,1,0
8,479,479,4,1,3,2,1
15,486,486,6,2,4,2,1
19,492,492,4,4,0,1,0

6,106,106,13,13,0,1,0
21,109,109,11,11,0,1,0
7,129,129,5,5,0,1,0
0,144,144,10,10,0,1,0
12,150,150,4,4,0,1,0
13,169,169,1,1,0,1,0
8,170,170,3,3,0,1,0
20,207,207,7,7,0,1,0
10,243,243,9,5,4,2,1
5,250,250,66,66,0,1,0
3,255,255,23,2,21,4,3
17,273,273,19,6,13,2,1
4,308,308,28,28,0,1,0
22,345,345,45,45,0,1,0
14,350,350,5,5,0,1,0
11,391,391,26,26,0,1,0
2,397,397,19,4,15,2,1
15,418,418,16,16,0,1,0
18,450,450,10,10,0,1,0
16,454,454,38,38,0,1,0
23,458,458,70,39,31,2,1
19,463,463,102,61,41,2,1
9,471,471,4,1,3,2,1
1,472,472,29,29,0,1,0
24,493,493,101,36,65,4,3

6,130,130,33,5,28,3,2
11,152,152,12,12,0,1,0
10,161,161,6,3,3,2,1
3,187,187,8,8,0,1,0
2,217,217,20,5,15,4,3
12,291,291,70,70,0,1,0
1,321,321,8,2,6,2,1
8,336,336,29,3,26,3,2
13,343,343,94,55,39,3,2
4,351,351,49,19,30,3,2
0,371,371,90,90,0,1,0
9,371,371,9,9,0,1,0
5,402,402,84,72,12,2,1
15,411,411,3,3,0,1,0
7,428,428,22,22,0,1,0
14,492,492,102,91,11,2,1

4,129,129,2,2,0,1,0
18,134,134,23,23,0,1,0
9,139,139,1,1,0,1,0
14,161,161,46,46,0,1,0
2,169,169,17,11,6,2,1
7,170,170,24,24,0,1,0
15,172,172,15,5,10,2,1
16,189,189,33,33,0,1,0
5,209,209,11,11,0,1,0
6,211,211,69,49,20,2,1
1,213,213,5,5,0,1,0
8,223,223,1,1,0,1,0
20,234,234,19,19,0,1,0
13,236,236,11,11,0,1,0
10,251,251,29,3,26,2,1
19,259,259,4,1,3,2,1
11,260,260,28,28,0,1,0
12,357,357,6,3,3,2,1
0,373,373,21,21,0,1,0
3,385,385,19,10,9,4,3
17,448,448,63,31,32,3,2

5,117,117,9,9,0,1,0
4,119,119,1,1,0,1,0
16,149,149,3,3,0,1,0
6,189,189,27,15,12,2,1
15,190,190,14,14,0,1,0
18,228,228,9,9,0,1,0
14,245,245,17,17,0,1,0
11,286,286,37,6,31,2,1
19,319,319,26,26,0,1,0
0,352,352,48,42,6,2,1
17,357,357,19,12,7,2,1
12,358,358,61,29,32,2,1
2,386,386,78,26,52,3,2
9,400,400,6,6,0,1,0
3,412,412,76,62,14,3,2
13,464,464,178,178,0,1,0
8,471,471,15,15,0,1,0
10,476,476,11,11,0,1,0
1,482,482,86,86,0,1,0
7,493,493,1,1,0,1,0

15,116,116,27,21,6,2,1
8,125,125,1,1,0,1,0
11,134,134,36,3,33,2,1
18,179,179,14,14,0,1,0
13,187,187,3,3,0,1,0
10,190,190,1,1,0,1,0
0,201,201,6,6,0,1,0
7,209,209,20,20,0,1,0
1,228,228,13,13,0,1,0
17,268,268,3,3,0,1,0
5,269,269,20,10,10,3,2
16,292,292,34,9,25,2,1
20,294,294,58,49,9,2,1
12,304,304,49,49,0,1,0
14,308,308,21,5,16,3,2
19,338,338,84,54,30,2,1
6,342,342,23,11,12,2,1
4,438,438,9,9,0,1,0
2,449,449,4,4,0,1,0
21,484,484,23,23,0,1,0
3,485,485,40,33,7,2,1
9,494,494,60,60,0,1,0

6,114,114,8,8,0,1,0
2,137,137,3,3,0,1,0
21,137,137,5,5,0,1,0
10,162,162,3,3,0,1,0
4,170,170,11,6,5,2,1
3,176,176,2,2,0,1,0
8,196,196,16,7,9,2,1
18,231,231,3,3,0,1,0
14,232,232,38,38,0,1,0
5,247,247,11,3,8,2,1
7,255,255,63,17,46,2,1
0,282,282,32,16,16,3,2
20,316,316,49,16,33,4,3
1,332,332,1,1,0,1,0
13,333,333,13,13,0,1,0
16,343,343,12,12,0,1,0
9,365,365,7,7,0,1,0
12,407,407,2,2,0,1,0
17,408,408,89,23,66,4,3
19,424,424,66,57,9,4,3
15,480,480,96,53,43,4,3
11,495,495,149,85,64,4,3

9,107,107,1,1,0,1,0
4,145,145,2,2,0,1,0
14,153,153,35,6,29,3,2
13,201,201,57,57,0,1,0
3,257,257,65,65,0,1,0
10,262,262,3,3,0,1,0
0,297,297,6,6,0,1,0
12,327,327,13,3,10,2,1
5,355,355,183,183,0,1,0
6,387,387,73,73,0,1,0
8,401,401,89,41,48,3,2
1,418,418,53,26,27,4,3
11,439,439,4,4,0,1,0
2,490,490,36,36,0,1,0
7,498,498,11,11,0,1,0

17,120,120,55,33,22,3,2
15,127,127,1,1,0,1,0
10,132,132,1,1,0,1,0
7,139,139,7,2,5,2,1
22,155,155,3,3,0,1,0
12,230,230,36,21,15,4,3
21,255,255,23,23,0,1,0
19,263,263,19,7,12,4,3
16,267,267,12,12,0,1,0
5,288,288,3,3,0,1,0
18,305,305,7,7,0,1,0
4,344,344,66,66,0,1,0
2,358,358,14,6,8,2,1
20,362,362,17,17,0,1,0
1,367,367,3,3,0,1,0
14,407,407,106,1,105,4,3
9,417,417,13,13,0,1,0
11,428,428,27,27,0,1,0
3,431,431,59,17,42,4,3
0,440,440,18,18,0,1,0
8,469,469,8,4,4,2,1
13,483,483,88,74,14,3,2
6,487,487,32,26,6,2,1

21,119,119,3,3,0,1,0
16,125,125,12,4,8,3,2
6,128,128,20,20,0,1,0
11,151,151,33,17,16,3,2
12,232,232,1,1,0,1,0
17,270,270,14,8,6,3,2
14,271,271,65,65,0,1,0
18,294,294,13,13,0,1,0
5,298,298,22,7,15,4,3
9,301,301,24,24,0,1,0
2,304,304,50,50,0,1,0
4,319,319,5,2,3,2,1
13,333,333,32,32,0,1,0
8,377,377,22,4,18,3,2
7,417,417,20,20,0,1,0
20,434,434,89,89,0,1,0
0,461,461,1,1,0,1,0
1,464,464,6,6,0,1,0
19,477,477,39,23,16,3,2
3,484,484,57,57,0,1,0
10,500,500,26,26,0,1,0
15,500,500,88,49,39,2,1

3,125,125,20,12,8,2,1
13,139,139,12,12,0,1,0
0,204,204,26,8,18,3,2
20,217,217,86,10,76,3,2
12,230,230,4,4,0,1,0
10,241,241,27,15,12,4,3
2,265,265,1,1,0,1,0
14,278,278,83,83,0,1,0
11,291,291,19,19,0,1,0
5,296,296,2,2,0,1,0
1,302,302,12,12,0,1,0
9,320,320,17,17,0,1,0
8,338,338,45,37,8,3,2
7,378,378,1,1,0,1,0
22,380,380,3,3,0,1,0
18,418,418,84,84,0,1,0
21,424,424,3,3,0,1,0
4,447,447,60,51,9,4,3
6,452,452,27,17,10,2,1
17,464,464,16,16,0,1,0
19,477,477,5,5,0,1,0
16,482,482,8,2,6,3,2
15,498,498,20,20,0,1,0

19,100,100,13,1,12,4,3
0,100,100,3,3,0,1,0
4,128,128,16,16,0,1,0
17,134,134,11,7,4,2,1
20,168,168,10,2,8,3,2
8,177,177,1,1,0,1,0
13,206,206,19,10,9,4,3
5,223,223,4,1,3,2,1
6,247,247,51,51,0,1,0
18,262,262,28,16,12,4,3
16,269,269,77,77,0,1,0
10,353,353,19,19,0,1,0
14,383,383,22,7,15,4,3
3,393,393,53,53,0,1,0
15,404,404,76,3,73,4,3
7,437,437,55,55,0,1,0
9,455,455,60,45,15,4,3
11,465,465,42,42,0,1,0
1,477,477,27,1,26,2,1
2,479,479,11,11,0,1,0
12,489,489,12,12,0,1,0

8,105,105,7,2,5,2,1
13,110,110,25,1,24,2,1
2,125,125,11,4,7,2,1
9,142,142,29,17,12,3,2
5,145,145,7,7,0,1,0
16,155,155,3,3,0,1,0
0,159,159,12,12,0,1,0
7,204,204,24,4,20,3,2
14,214,214,21,21,0,1,0
3,214,214,9,9,0,1,0
11,250,250,18,4,14,3,2
15,348,348,48,35,13,2,1
6,359,359,40,25,15,4,3
4,360,360,65,65,0,1,0
10,414,414,22,22,0,1,0
1,468,468,34,34,0,1,0
18,477,477,36,36,0,1,0
17,490,490,79,79,0,1,0
12,491,491,81,40,41,4,3

8,105,105,9,9,0,1,0
15,112,112,1,1,0,1,0
18,126,126,39,29,10,3,2
19,162,162,22,1,21,4,3
17,169,169,14,14,0,1,0
11,191,191,13,13,0,1,0
16,191,191,8,8,0,1,0
4,193,193,1,1,0,1,0
13,203,203,26,26,0,1,0
10,211,211,5,5,0,1,0
12,267,267,29,29,0,1,0
20,270,270,21,21,0,1,0
6,291,291,15,15,0,1,0
9,322,322,39,15,24,2,1
3,347,347,9,9,0,1,0
1,367,367,20,20,0,1,0
21,385,385,38,11,27,4,3
7,393,393,48,19,29,2,1
14,432,432,63,63,0,1,0
5,461,461,82,24,58,3,2
0,466,466,28,28,0,1,0
2,486,486,48,10,38,2,1

17,134,134,10,10,0,1,0
0,134,134,4,4,0,1,0
14,135,135,5,2,3,2,1
13,186,186,9,9,0,1,0
11,195,195,3,3,0,1,0
7,206,206,15,15,0,1,0
9,257,257,45,29,16,2,1
8,284,284,8,8,0,1,0
18,297,297,26,18,8,2,1
1,301,301,26,26,0,1,0
6,305,305,24,24,0,1,0
19,310,310,8,5,3,2,1
4,350,350,20,20,0,1,0
15,376,376,66,4,62,3,2
3,377,377,72,72,0,1,0
16,422,422,104,11,93,4,3
12,451,451,77,65,12,3,2
20,455,455,71,24,47,2,1
2,457,457,1,1,0,1,0
5,472,472,5,5,0,1,0
10,497,497,127,1,126,4,3

10,102,102,41,41,0,1,0
13,105,105,3,3,0,1,0
16,109,109,9,9,0,1,0
3,139,139,7,4,3,2,1
7,145,145,13,6,7,2,1
1,149,149,9,9,0,1,0
5,177,177,19,19,0,1,0
11,208,208,19,19,0,1,0
0,212,212,4,4,0,1,0
14,217,217,15,15,0,1,0
15,237,237,10,1,9,3,2
6,250,250,107,86,21,4,3
9,273,273,69,3,66,3,2
12,279,279,9,9,0,1,0
8,329,329,7,7,0,1,0
4,358,358,67,58,9,4,3
2,397,397,15,15,0,1,0
17,442,442,15,15,0,1,0

11,111,111,28,10,18,3,2
9,217,217,25,25,0,1,0
14,223,223,5,5,0,1,0
7,255,255,25,25,0,1,0
8,299,299,67,67,0,1,0
15,313,313,17,17,0,1,0
3,340,340,34,25,9,2,1
6,357,357,15,11,4,2,1
0,374,374,19,19,0,1,0
2,383,383,50,11,39,4,3
1,389,389,190,151,39,4,3
13,425,425,3,3,0,1,0
4,433,433,10,4,6,2,1
12,476,476,107,69,38,3,2
10,482,482,13,3,10,2,1
5,485,485,81,12,69,4,3

15,106,106,9,9,0,1,0
7,118,118,1,1,0,1,0
13,128,128,14,5,9,3,2
8,139,139,5,5,0,1,0
1,152,152,15,15,0,1,0
6,153,153,5,5,0,1,0
0,154,154,28,28,0,1,0
17,172,172,30,30,0,1,0
9,181,181,14,14,0,1,0
11,191,191,28,28,0,1,0
2,231,231,31,4,27,2,1
3,233,233,35,35,0,1,0
4,307,307,109,52,57,4,3
5,369,369,2,2,0,1,0
16,380,380,17,12,5,2,1
10,381,381,25,25,0,1,0
14,442,442,39,39,0,1,0
12,476,476,110,110,0,1,0

19,130,130,12,12,0,1,0
12,141,141,18,18,0,1,0
2,171,171,12,6,6,3,2
0,192,192,9,5,4,2,1
1,229,229,5,2,3,2,1
10,287,287,4,4,0,1,0
15,292,292,11,8,3,2,1
17,306,306,17,17,0,1,0
7,322,322,19,19,0,1,0
14,325,325,49,33,16,2,1
4,363,363,58,55,3,2,1
11,386,386,24,24,0,1,0
18,409,409,119,56,63,4,3
5,423,423,22,4,18,3,2
6,444,444,54,54,0,1,0
3,446,446,21,12,9,4,3
13,449,449,68,25,43,4,3
16,459,459,44,44,0,1,0
8,479,479,86,46,40,3,2
20,487,487,8,8,0,1,0
9,493,493,82,37,45,2,1

12,103,103,16,16,0,1,0
15,108,108,15,9,6,2,1
5,147,147,3,3,0,1,0
8,154,154,4,4,0,1,0
3,194,194,3,3,0,1,0
0,220,220,20,15,5,2,1
11,233,233,28,28,0,1,0
9,236,236,24,24,0,1,0
14,282,282,6,6,0,1,0
4,285,285,132,93,39,4,3
7,333,333,114,114,0,1,0
1,343,343,82,82,0,1,0
2,351,351,57,44,13,2,1
6,396,396,4,4,0,1,0
13,457,457,43,43,0,1,0
10,464,464,10,10,0,1,0

12,132,132,14,14,0,1,0
2,135,135,2,2,0,1,0
17,150,150,11,3,8,3,2
10,217,217,26,6,20,3,2
0,240,240,31,31,0,1,0
9,251,251,1,1,0,1,0
18,278,278,26,26,0,1,0
14,278,278,35,35,0,1,0
15,282,282,7,7,0,1,0
5,285,285,48,48,0,1,0
11,316,316,16,16,0,1,0
4,318,318,8,8,0,1,0
7,363,363,45,45,0,1,0
19,378,378,6,6,0,1,0
3,432,432,58,14,44,3,2
13,462,462,89,89,0,1,0
16,467,467,157,157,0,1,0
1,467,467,21,21,0,1,0
6,484,484,61,61,0,1,0
8,491,491,55,28,27,4,3

1,122,122,17,9,8,3,2
8,146,146,21,14,7,2,1
15,148,148,15,3,12,2,1
16,157,157,53,53,0,1,0
7,205,205,28,28,0,1,0
9,242,242,21,8,13,2,1
4,271,271,28,28,0,1,0
12,281,281,13,13,0,1,0
14,284,284,13,1,12,2,1
10,297,297,30,5,25,2,1
13,299,299,5,5,0,1,0
2,305,305,30,30,0,1,0
5,393,393,71,35,36,3,2
11,436,436,62,62,0,1,0
3,459,459,40,40,0,1,0
0,460,460,69,46,23,4,3
6,497,497,52,8,44,2,1

22,101,101,7,7,0,1,0
13,126,126,17,17,0,1,0
7,126,126,1,1,0,1,0
5,135,135,5,5,0,1,0
3,149,149,17,17,0,1,0
18,188,188,45,30,15,2,1
1,210,210,24,24,0,1,0
6,213,213,20,20,0,1,0
11,214,214,27,27,0,1,0
20,227,227,15,4,11,2,1
15,237,237,43,31,12,4,3
12,243,243,15,15,0,1,0
2,276,276,10,3,7,2,1
17,291,291,9,9,0,1,0
4,293,293,29,11,18,4,3
19,335,335,18,18,0,1,0
0,355,355,20,5,15,4,3
16,357,357,72,40,32,2,1
10,361,361,9,9,0,1,0
14,377,377,52,52,0,1,0
8,383,383,13,4,9,4,3
9,446,446,28,17,11,2,1
21,460,460,19,3,16,4,3

13,133,133,1,1,0,1,0
11,175,175,7,2,5,2,1
5,251,251,63,63,0,1,0
15,265,265,28,4,24,2,1
0,310,310,12,12,0,1,0
14,322,322,13,13,0,1,0
2,349,349,167,167,0,1,0
8,351,351,79,79,0,1,0
6,355,355,5,5,0,1,0
7,400,400,52,52,0,1,0
9,408,408,14,14,0,1,0
3,416,416,9,9,0,1,0
10,416,416,166,166,0,1,0
4,466,466,49,33,16,3,2
1,471,471,43,43,0,1,0
12,494,494,17,17,0,1,0

1,105,105,1,1,0,1,0
2,110,110,13,10,3,2,1
18,112,112,9,9,0,1,0
15,133,133,19,19,0,1,0
13,151,151,2,2,0,1,0
11,178,178,1,1,0,1,0
8,207,207,29,29,0,1,0
16,236,236,42,2,40,2,1
7,264,264,17,14,3,2,1
4,282,282,27,27,0,1,0
5,307,307,26,26,0,1,0
9,323,323,17,17,0,1,0
0,343,343,87,87,0,1,0
10,357,357,20,20,0,1,0
19,370,370,26,26,0,1,0
12,372,372,93,93,0,1,0
6,388,388,19,9,10,3,2
17,403,403,87,87,0,1,0
3,430,430,33,33,0,1,0
14,478,478,31,31,0,1,0

12,103,103,2,2,0,1,0
9,119,119,1,1,0,1,0
10,157,157,7,4,3,2,1
11,161,161,13,7,6,3,2
8,197,197,1,1,0,1,0
3,218,218,21,21,0,1,0
18,223,223,9,9,0,1,0
17,295,295,10,10,0,1,0
13,298,298,32,5,27,2,1
5,299,299,38,38,0,1,0
7,301,301,14,9,5,2,1
15,320,320,8,3,5,2,1
6,343,343,44,2,42,2,1
19,365,365,22,22,0,1,0
21,390,390,37,8,29,2,1
1,395,395,62,62,0,1,0
14,404,404,163,99,64,3,2
4,416,416,27,27,0,1,0
0,430,430,92,30,62,3,2
20,436,436,60,60,0,1,0
16,454,454,49,35,14,2,1
2,457,457,4,4,0,1,0

17,119,119,19,19,0,1,0
19,128,128,20,20,0,1,0
16,136,136,25,18,7,2,1
8,156,156,10,10,0,1,0
10,165,165,8,5,3,2,1
0,167,167,2,2,0,1,0
20,187,187,6,6,0,1,0
9,190,190,1,1,0,1,0
3,197,197,1,1,0,1,0
13,212,212,18,18,0,1,0
12,249,249,20,20,0,1,0
14,254,254,1,1,0,1,0
4,274,274,14,8,6,2,1
6,299,299,21,21,0,1,0
18,333,333,29,6,23,2,1
1,348,348,1,1,0,1,0
15,409,409,6,6,0,1,0
2,412,412,94,28,66,4,3
21,421,421,125,26,99,4,3
11,422,422,32,22,10,3,2
7,460,460,4,1,3,2,1
5,480,480,167,89,78,3,2

14,116,116,17,8,9,4,3
17,159,159,49,49,0,1,0
2,169,169,13,5,8,3,2
1,170,170,22,22,0,1,0
3,185,185,5,5,0,1,0
13,199,199,3,3,0,1,0
8,223,223,42,21,21,4,3
10,244,244,55,25,30,3,2
6,261,261,6,6,0,1,0
16,302,302,9,9,0,1,0
15,313,313,40,40,0,1,0
11,345,345,12,12,0,1,0
7,351,351,36,36,0,1,0
12,356,356,16,16,0,1,0
0,381,381,1,1,0,1,0
5,398,398,97,40,57,4,3
9,430,430,36,36,0,1,0
4,450,450,93,5,88,3,2

2,122,122,3,3,0,1,0
11,143,143,2,2,0,1,0
14,155,155,30,1,29,3,2
6,199,199,8,2,6,3,2
12,201,201,26,26,0,1,0
1,207,207,40,16,24,3,2
4,306,306,15,15,0,1,0
5,330,330,37,37,0,1,0
3,372,372,58,43,15,2,1
8,377,377,117,117,0,1,0
10,381,381,102,102,0,1,0
7,384,384,9,9,0,1,0
9,388,388,6,6,0,1,0
0,419,419,39,39,0,1,0
13,469,469,41,9,32,2,1
17,474,474,49,49,0,1,0
16,486,486,73,33,40,3,2
15,491,491,26,10,16,2,1

5,105,105,3,3,0,1,0
6,105,105,8,8,0,1,0
16,113,113,33,10,23,2,1
2,121,121,45,45,0,1,0
8,156,156,1,1,0,1,0
12,159,159,6,6,0,1,0
0,181,181,33,21,12,4,3
9,198,198,52,52,0,1,0
11,218,218,17,17,0,1,0
1,254,254,34,11,23,2,1
13,261,261,9,3,6,3,2
4,337,337,1,1,0,1,0
10,351,351,78,8,70,3,2
14,441,441,38,33,5,2,1
15,466,466,1,1,0,1,0
7,475,475,52,12,40,2,1
3,497,497,48,40,8,2,1

11,169,169,27,9,18,4,3
0,219,219,81,15,66,3,2
5,246,246,40,40,0,1,0
8,262,262,17,17,0,1,0
1,285,285,42,13,29,2,1
2,289,289,44,32,12,3,2
9,311,311,3,3,0,1,0
12,331,331,14,14,0,1,0
7,395,395,23,23,0,1,0
3,398,398,132,106,26,3,2
6,445,445,38,38,0,1,0
10,453,453,165,121,44,2,1
4,479,479,32,8,24,4,3

11,105,105,14,14,0,1,0
15,142,142,27,4,23,2,1
1,146,146,24,8,16,2,1
9,150,150,2,2,0,1,0
5,167,167,18,15,3,2,1
3,179,179,44,44,0,1,0
7,211,211,20,20,0,1,0
2,220,220,35,16,19,2,1
8,220,220,23,23,0,1,0
4,234,234,14,8,6,2,1
14,260,260,10,10,0,1,0
6,291,291,66,66,0,1,0
13,300,300,25,1,24,4,3
10,334,334,118,60,58,3,2
0,338,338,13,3,10,3,2
12,362,362,3,3,0,1,0

1,101,101,1,1,0,1,0
14,123,123,2,2,0,1,0
6,125,125,2,2,0,1,0
15,125,125,8,4,4,2,1
17,146,146,17,17,0,1,0
20,166,166,4,4,0,1,0
9,166,166,17,8,9,2,1
18,206,206,7,7,0,1,0
16,212,212,32,8,24,3,2
12,217,217,13,3,10,3,2
11,245,245,4,4,0,1,0
2,299,299,20,15,5,2,1
8,304,304,3,3,0,1,0
3,304,304,6,6,0,1,0
4,309,309,15,15,0,1,0
19,374,374,24,24,0,1,0
7,396,396,97,97,0,1,0
13,405,405,200,128,72,4,3
10,437,437,49,16,33,4,3
5,471,471,148,130,18,2,1
0,472,472,19,19,0,1,0

17,111,111,2,2,0,1,0
18,116,116,15,9,6,2,1
15,121,121,11,11,0,1,0
10,136,136,15,1,14,2,1
1,138,138,1,1,0,1,0
21,225,225,31,1,30,3,2
9,230,230,47,47,0,1,0
16,255,255,60,42,18,3,2
0,258,258,5,1,4,2,1
6,308,308,4,4,0,1,0
13,312,312,45,27,18,2,1
12,323,323,26,26,0,1,0
11,335,335,42,26,16,3,2
7,336,336,5,5,0,1,0
5,339,339,35,35,0,1,0
22,346,346,13,13,0,1,0
3,346,346,3,3,0,1,0
2,346,346,2,2,0,1,0
19,381,381,3,3,0,1,0
14,435,435,98,98,0,1,0
20,454,454,61,17,44,4,3
8,468,468,18,8,10,2,1
4,488,488,61,53,8,3,2

12,109,109,23,1,22,4,3
1,113,113,10,6,4,2,1
10,160,160,1,1,0,1,0
21,161,161,32,23,9,4,3
5,163,163,3,3,0,1,0
17,190,190,45,38,7,2,1
3,199,199,1,1,0,1,0
7,204,204,10,6,4,2,1
14,208,208,12,4,8,2,1
20,304,304,13,13,0,1,0
4,311,311,39,39,0,1,0
6,323,323,1,1,0,1,0
22,328,328,15,12,3,2,1
13,366,366,60,30,30,2,1
0,381,381,4,4,0,1,0
15,407,407,50,21,29,2,1
11,450,450,14,14,0,1,0
9,471,471,19,7,12,4,3
18,473,473,41,16,25,2,1
16,482,482,81,81,0,1,0
8,488,488,79,79,0,1,0
2,491,491,43,7,36,2,1
19,497,497,28,9,19,2,1

18,144,144,7,3,4,2,1
20,169,169,2,2,0,1,0
16,177,177,20,20,0,1,0
19,198,198,2,2,0,1,0
4,211,211,13,1,12,2,1
10,216,216,40,5,35,2,1
9,236,236,1,1,0,1,0
6,243,243,16,4,12,3,2
15,248,248,8,5,3,2,1
3,256,256,9,1,8,3,2
8,268,268,43,43,0,1,0
7,309,309,46,46,0,1,0
1,339,339,34,13,21,4,3
12,349,349,5,5,0,1,0
17,361,361,130,17,113,4,3
2,373,373,57,57,0,1,0
21,386,386,9,9,0,1,0
5,434,434,10,4,6,2,1
14,452,452,166,107,59,4,3
0,471,471,16,16,0,1,0
11,477,477,8,3,5,2,1
13,479,479,25,4,21,2,1

11,134,134,4,4,0,1,0
1,138,138,2,2,0,1,0
15,143,143,39,39,0,1,0
6,151,151,18,18,0,1,0
0,163,163,19,19,0,1,0
4,185,185,8,3,5,2,1
7,203,203,21,2,19,2,1
2,215,215,16,1,15,4,3
19,242,242,1,1,0,1,0
8,247,247,19,13,6,2,1
20,268,268,2,2,0,1,0
21,269,269,59,45,14,2,1
5,272,272,61,61,0,1,0
10,272,272,24,12,12,2,1
3,282,282,6,3,3,2,1
22,285,285,39,39,0,1,0
16,367,367,27,27,0,1,0
18,389,389,24,24,0,1,0
17,404,404,14,9,5,2,1
13,458,458,11,7,4,2,1
14,472,472,93,17,76,4,3
9,476,476,20,20,0,1,0
12,498,498,11,7,4,2,1

15,107,107,30,30,0,1,0
21,143,143,6,6,0,1,0
18,157,157,49,49,0,1,0
0,194,194,9,9,0,1,0
11,206,206,9,9,0,1,0
3,224,224,4,4,0,1,0
9,236,236,29,5,24,2,1
12,244,244,31,31,0,1,0
4,250,250,35,35,0,1,0
6,251,251,33,33,0,1,0
8,256,256,5,2,3,2,1
2,270,270,26,26,0,1,0
10,285,285,33,9,24,3,2
5,292,292,31,27,4,2,1
14,302,302,31,31,0,1,0
19,303,303,1,1,0,1,0
16,368,368,56,56,0,1,0
20,368,368,7,7,0,1,0
1,385,385,9,5,4,2,1
17,428,428,10,10,0,1,0
13,430,430,39,5,34,2,1
7,476,476,6,3,3,2,1

1,102,102,8,8,0,1,0
17,116,116,9,1,8,3,2
4,141,141,15,15,0,1,0
2,166,166,20,20,0,1,0
18,168,168,4,4,0,1,0
13,179,179,16,4,12,2,1
15,182,182,2,2,0,1,0
19,262,262,53,53,0,1,0
9,266,266,11,11,0,1,0
0,281,281,26,19,7,2,1
16,340,340,117,117,0,1,0
10,374,374,20,20,0,1,0
11,399,399,86,86,0,1,0
12,403,403,7,7,0,1,0
5,414,414,50,20,30,2,1
3,424,424,36,13,23,2,1
7,452,452,48,21,27,4,3
14,453,453,16,9,7,2,1
6,479,479,1,1,0,1,0
8,486,486,94,43,51,4,3

13,116,116,15,7,8,2,1
9,125,125,4,1,3,2,1
12,150,150,31,4,27,4,3
2,165,165,5,5,0,1,0
18,178,178,37,3,34,4,3
14,226,226,5,5,0,1,0
19,229,229,57,3,54,4,3
1,241,241,106,85,21,4,3
8,252,252,5,5,0,1,0
11,254,254,8,8,0,1,0
16,303,303,12,5,7,2,1
5,339,339,34,1,33,2,1
10,352,352,3,3,0,1,0
6,355,355,17,5,12,2,1
15,404,404,21,21,0,1,0
4,424,424,2,2,0,1,0
7,431,431,4,4,0,1,0
17,441,441,39,3,36,2,1
3,459,459,42,34,8,2,1
0,462,462,101,72,29,2,1

1,114,114,1,1,0,1,0
15,119,119,14,10,4,2,1
0,161,161,13,13,0,1,0
2,193,193,6,6,0,1,0
21,196,196,19,19,0,1,0
5,201,201,28,2,26,2,1
20,211,211,24,24,0,1,0
6,223,223,25,25,0,1,0
17,228,228,6,6,0,1,0
4,271,271,12,12,0,1,0
8,284,284,18,18,0,1,0
11,307,307,2,2,0,1,0
18,318,318,154,138,16,3,2
10,332,332,52,52,0,1,0
3,333,333,13,13,0,1,0
12,336,336,44,26,18,4,3
13,351,351,52,21,31,2,1
7,383,383,5,5,0,1,0
9,414,414,11,11,0,1,0
22,458,458,5,5,0,1,0
19,462,462,52,11,41,4,3
14,482,482,24,24,0,1,0
16,491,491,2,2,0,1,0

5,106,106,3,3,0,1,0
7,153,153,24,24,0,1,0
6,183,183,1,1,0,1,0
14,200,200,29,29,0,1,0
15,211,211,113,113,0,1,0
12,223,223,1,1,0,1,0
3,252,252,47,47,0,1,0
0,270,270,8,3,5,2,1
1,276,276,3,3,0,1,0
9,310,310,14,6,8,2,1
13,338,338,23,23,0,1,0
8,391,391,59,24,35,4,3
17,398,398,26,2,24,4,3
4,412,412,90,90,0,1,0
11,432,432,12,12,0,1,0
16,450,450,13,13,0,1,0
2,459,459,98,98,0,1,0
10,475,475,46,23,23,2,1

13,104,104,9,9,0,1,0
5,105,105,10,7,3,2,1
6,119,119,5,5,0,1,0
8,164,164,11,11,0,1,0
18,241,241,6,6,0,1,0
0,245,245,7,7,0,1,0
4,259,259,27,11,16,2,1
14,297,297,13,13,0,1,0
11,310,310,13,10,3,2,1
9,348,348,1,1,0,1,0
1,372,372,77,77,0,1,0
12,374,374,41,41,0,1,0
17,386,386,126,112,14,2,1
10,394,394,68,11,57,3,2
7,412,412,157,124,33,4,3
3,425,425,27,19,8,3,2
16,468,468,67,56,11,2,1
2,476,476,5,5,0,1,0
15,499,499,32,14,18,4,3

9,100,100,3,3,0,1,0
15,116,116,5,5,0,1,0
14,238,238,65,43,22,3,2
2,241,241,123,87,36,2,1
4,253,253,35,35,0,1,0
12,275,275,19,19,0,1,0
11,307,307,27,27,0,1,0
8,330,330,67,47,20,2,1
7,357,357,7,7,0,1,0
5,380,380,18,7,11,2,1
13,391,391,96,32,64,3,2
3,422,422,53,53,0,1,0
6,447,447,20,12,8,2,1
10,461,461,22,22,0,1,0
0,463,463,61,12,49,3,2
1,489,489,1,1,0,1,0

16,101,101,3,3,0,1,0
10,102,102,3,3,0,1,0
7,119,119,10,6,4,2,1
15,123,123,9,2,7,2,1
11,179,179,1,1,0,1,0
20,203,203,18,18,0,1,0
5,211,211,5,5,0,1,0
18,246,246,62,29,33,2,1
2,281,281,53,21,32,2,1
21,290,290,65,17,48,3,2
8,294,294,12,4,8,2,1
12,304,304,1,1,0,1,0
13,315,315,56,28,28,3,2
19,346,346,12,2,10,4,3
6,350,350,35,18,17,2,1
14,378,378,32,32,0,1,0
0,416,416,1,1,0,1,0
1,420,420,1,1,0,1,0
9,464,464,116,66,50,4,3
17,467,467,23,10,13,4,3
4,472,472,91,34,57,4,3
3,489,489,39,8,31,2,1

17,112,112,9,9,0,1,0
4,131,131,3,3,0,1,0
12,164,164,39,39,0,1,0
11,169,169,12,2,10,2,1
7,187,187,28,13,15,2,1
6,197,197,40,34,6,2,1
16,210,210,39,3,36,2,1
5,214,214,22,10,12,4,3
8,233,233,17,17,0,1,0
9,252,252,4,4,0,1,0
14,256,256,18,11,7,2,1
18,274,274,7,7,0,1,0
15,294,294,56,56,0,1,0
2,311,311,5,1,4,2,1
19,312,312,84,84,0,1,0
10,377,377,12,4,8,2,1
1,380,380,1,1,0,1,0
20,403,403,11,1,10,3,2
21,433,433,14,9,5,2,1
0,438,438,23,17,6,2,1
13,478,478,65,65,0,1,0
3,487,487,12,12,0,1,0

15,140,140,5,5,0,1,0
11,158,158,3,3,0,1,0
21,177,177,26,26,0,1,0
7,197,197,1,1,0,1,0
8,197,197,1,1,0,1,0
0,210,210,11,2,9,4,3
17,226,226,36,36,0,1,0
18,241,241,58,58,0,1,0
10,251,251,43,2,41,4,3
1,253,253,65,40,25,4,3
9,265,265,1,1,0,1,0
12,283,283,22,13,9,4,3
6,292,292,23,2,21,3,2
2,349,349,4,4,0,1,0
5,376,376,32,5,27,4,3
4,395,395,11,11,0,1,0
3,396,396,57,57,0,1,0
14,427,427,35,28,7,2,1
22,427,427,66,66,0,1,0
16,439,439,17,17,0,1,0
19,467,467,7,1,6,2,1
13,469,469,29,29,0,1,0
20,477,477,69,19,50,2,1

9,120,120,9,9,0,1,0
13,176,176,6,2,4,2,1
0,180,180,10,10,0,1,0
5,238,238,6,6,0,1,0
15,247,247,23,23,0,1,0
4,260,260,25,16,9,2,1
16,262,262,127,127,0,1,0
7,268,268,31,1,30,3,2
12,275,275,32,5,27,2,1
11,309,309,2,2,0,1,0
2,311,311,16,10,6,3,2
10,335,335,34,1,33,4,3
3,339,339,136,136,0,1,0
1,356,356,50,20,30,2,1
6,435,435,51,18,33,4,3
14,440,440,6,6,0,1,0
8,462,462,44,22,22,4,3

21,112,112,8,1,7,2,1
11,136,136,4,4,0,1,0
2,148,148,5,5,0,1,0
15,178,178,2,2,0,1,0
18,183,183,19,13,6,3,2
14,205,205,87,41,46,2,1
4,224,224,36,36,0,1,0
1,246,246,11,3,8,3,2
13,249,249,40,18,22,2,1
6,275,275,1,1,0,1,0
0,279,279,38,22,16,3,2
12,287,287,21,8,13,2,1
8,287,287,34,7,27,3,2
3,309,309,15,15,0,1,0
9,349,349,3,3,0,1,0
16,367,367,31,17,14,2,1
22,398,398,56,44,12,4,3
20,402,402,4,1,3,2,1
5,404,404,19,11,8,3,2
19,427,427,72,72,0,1,0
17,460,460,1,1,0,1,0
10,478,478,54,54,0,1,0
7,483,483,11,11,0,1,0

1,113,113,20,20,0,1,0
5,142,142,1,1,0,1,0
4,175,175,30,30,0,1,0
3,199,199,74,28,46,2,1
10,205,205,3,3,0,1,0
8,210,210,115,55,60,4,3
6,228,228,18,9,9,2,1
11,233,233,27,27,0,1,0
9,261,261,2,2,0,1,0
16,283,283,8,4,4,2,1
7,293,293,34,34,0,1,0
13,351,351,86,61,25,3,2
2,370,370,29,29,0,1,0
12,421,421,6,6,0,1,0
0,442,442,1,1,0,1,0
14,485,485,10,10,0,1,0
15,492,492,12,12,0,1,0

3,123,123,2,2,0,1,0
0,185,185,2,2,0,1,0
14,192,192,33,20,13,2,1
8,241,241,19,13,6,3,2
4,243,243,40,3,37,3,2
16,245,245,3,3,0,1,0
6,306,306,9,9,0,1,0
18,318,318,72,53,19,2,1
12,336,336,79,65,14,3,2
10,376,376,34,18,16,2,1
13,391,391,20,2,18,4,3
1,393,393,1,1,0,1,0
19,398,398,15,15,0,1,0
5,418,418,41,41,0,1,0
15,430,430,72,72,0,1,0
9,443,443,38,4,34,3,2
7,451,451,157,139,18,3,2
2,475,475,36,36,0,1,0
11,492,492,52,52,0,1,0
17,496,496,4,4,0,1,0

16,111,111,13,1,12,2,1
19,131,131,12,12,0,1,0
14,143,143,62,12,50,4,3
15,151,151,26,26,0,1,0
5,170,170,1,1,0,1,0
18,170,170,13,13,0,1,0
11,210,210,29,3,26,2,1
0,224,224,8,8,0,1,0
6,227,227,15,15,0,1,0
7,234,234,6,6,0,1,0
3,239,239,12,4,8,2,1
1,261,261,7,4,3,2,1
2,294,294,10,10,0,1,0
4,343,343,26,26,0,1,0
17,350,350,30,12,18,4,3
13,367,367,1,1,0,1,0
9,393,393,40,16,24,4,3
20,394,394,11,5,6,3,2
8,428,428,166,166,0,1,0
12,461,461,10,10,0,1,0
10,470,470,25,25,0,1,0

9,187,187,1,1,0,1,0
15,192,192,8,8,0,1,0
1,205,205,40,24,16,2,1
0,232,232,14,14,0,1,0
7,240,240,15,9,6,3,2
2,260,260,37,37,0,1,0
8,265,265,4,4,0,1,0
16,286,286,119,119,0,1,0
12,293,293,40,40,0,1,0
3,343,343,93,79,14,2,1
13,344,344,48,48,0,1,0
5,379,379,17,17,0,1,0
17,430,430,4,4,0,1,0
4,431,431,1,1,0,1,0
14,441,441,32,23,9,3,2
11,472,472,83,83,0,1,0
10,479,479,10,2,8,3,2
6,496,496,103,70,33,4,3

9,109,109,5,5,0,1,0
20,138,138,2,2,0,1,0
18,154,154,52,6,46,3,2
14,159,159,15,3,12,3,2
21,162,162,3,3,0,1,0
2,167,167,7,7,0,1,0
1,187,187,23,2,21,2,1
5,205,205,32,22,10,3,2
4,208,208,5,5,0,1,0
10,228,228,10,10,0,1,0
15,232,232,6,6,0,1,0
16,235,235,25,9,16,2,1
22,240,240,54,54,0,1,0
11,284,284,56,9,47,2,1
7,293,293,47,47,0,1,0
12,302,302,14,2,12,3,2
0,354,354,30,30,0,1,0
13,366,366,2,2,0,1,0
8,381,381,8,2,6,2,1
6,403,403,4,4,0,1,0
19,406,406,41,27,14,2,1
3,421,421,17,17,0,1,0
17,447,447,43,43,0,1,0

10,115,115,24,24,0,1,0
12,122,122,1,1,0,1,0
17,221,221,17,17,0,1,0
16,256,256,46,46,0,1,0
8,268,268,29,22,7,2,1
5,269,269,40,20,20,2,1
4,278,278,1,1,0,1,0
13,296,296,59,1,58,3,2
14,313,313,13,13,0,1,0
6,314,314,8,8,0,1,0
1,384,384,25,1,24,4,3
18,389,389,78,12,66,3,2
0,421,421,153,106,47,2,1
11,422,422,33,33,0,1,0
2,423,423,44,18,26,3,2
7,431,431,51,51,0,1,0
3,450,450,26,4,22,3,2
15,455,455,14,14,0,1,0
9,475,475,3,3,0,1,0

14,148,148,1,1,0,1,0
3,151,151,1,1,0,1,0
6,158,158,10,10,0,1,0
10,158,158,33,1,32,2,1
8,192,192,12,2,10,3,2
11,250,250,94,94,0,1,0
1,263,263,21,21,0,1,0
13,263,263,14,14,0,1,0
4,269,269,5,5,0,1,0
20,272,272,14,5,9,2,1
15,303,303,3,3,0,1,0
19,311,311,100,100,0,1,0
2,322,322,28,4,24,3,2
12,324,324,15,15,0,1,0
0,328,328,1,1,0,1,0
5,388,388,8,1,7,2,1
16,401,401,47,22,25,2,1
18,404,404,134,134,0,1,0
7,419,419,19,12,7,2,1
9,437,437,14,3,11,2,1
17,495,495,35,11,24,2,1

1,121,121,1,1,0,1,0
11,123,123,5,1,4,2,1
6,148,148,2,2,0,1,0
4,158,158,11,11,0,1,0
5,172,172,27,27,0,1,0
17,206,206,60,60,0,1,0
2,223,223,2,2,0,1,0
19,224,224,10,1,9,4,3
15,245,245,17,12,5,2,1
16,300,300,52,43,9,4,3
18,308,308,70,58,12,3,2
10,331,331,12,2,10,3,2
13,332,332,47,47,0,1,0
8,396,396,6,6,0,1,0
0,398,398,83,83,0,1,0
9,419,419,30,30,0,1,0
7,445,445,9,9,0,1,0
12,461,461,9,9,0,1,0
3,495,495,194,180,14,3,2
14,500,500,4,1,3,2,1

0,105,105,12,12,0,1,0
12,109,109,8,8,0,1,0
4,131,131,26,2,24,3,2
1,145,145,2,2,0,1,0
15,157,157,12,12,0,1,0
9,158,158,16,16,0,1,0
16,179,179,32,32,0,1,0
6,180,180,37,37,0,1,0
5,204,204,41,3,38,3,2
7,254,254,23,23,0,1,0
2,293,293,16,2,14,3,2
10,319,319,49,49,0,1,0
14,336,336,1,1,0,1,0
13,352,352,57,57,0,1,0
11,446,446,111,36,75,4,3
8,481,481,7,4,3,2,1
3,495,495,62,62,0,1,0

8,113,113,22,22,0,1,0
6,179,179,21,21,0,1,0
13,195,195,8,8,0,1,0
1,248,248,20,20,0,1,0
10,289,289,7,7,0,1,0
14,294,294,25,25,0,1,0
9,301,301,7,7,0,1,0
2,309,309,64,64,0,1,0
5,324,324,1,1,0,1,0
11,372,372,81,56,25,2,1
12,385,385,45,45,0,1,0
15,386,386,87,24,63,4,3
4,406,406,72,48,24,4,3
0,434,434,94,68,26,2,1
3,478,478,97,97,0,1,0
7,492,492,43,11,32,3,2

19,102,102,1,1,0,1,0
8,136,136,22,18,4,2,1
11,179,179,8,5,3,2,1
2,180,180,13,13,0,1,0
4,193,193,19,19,0,1,0
13,198,198,51,7,44,4,3
18,233,233,14,14,0,1,0
17,267,267,42,42,0,1,0
15,269,269,72,19,53,4,3
7,272,272,5,5,0,1,0
1,280,280,5,5,0,1,0
14,281,281,23,20,3,2,1
10,292,292,41,5,36,4,3
16,364,364,38,38,0,1,0
12,371,371,15,5,10,3,2
6,405,405,54,6,48,4,3
0,439,439,25,7,18,2,1
9,468,468,110,94,16,2,1
3,476,476,28,10,18,4,3
5,494,494,5,5,0,1,0

14,138,138,5,5,0,1,0
4,187,187,8,2,6,2,1
6,232,232,16,16,0,1,0
2,243,243,47,23,24,3,2
15,243,243,31,8,23,4,3
3,244,244,136,136,0,1,0
13,244,244,57,54,3,2,1
9,289,289,15,1,14,3,2
10,300,300,23,3,20,3,2
7,330,330,91,91,0,1,0
1,339,339,10,1,9,2,1
5,421,421,15,10,5,2,1
12,423,423,38,38,0,1,0
8,451,451,7,7,0,1,0
0,453,453,34,34,0,1,0
11,497,497,55,44,11,2,1

16,123,123,26,26,0,1,0
15,144,144,35,14,21,3,2
2,182,182,12,1,11,2,1
17,232,232,11,1,10,2,1
1,294,294,91,55,36,4,3
21,309,309,32,32,0,1,0
0,315,315,11,3,8,2,1
20,327,327,53,13,40,3,2
5,343,343,6,6,0,1,0
12,349,349,23,23,0,1,0
14,356,356,13,13,0,1,0
13,392,392,17,1,16,2,1
11,400,400,28,28,0,1,0
19,440,440,15,5,10,3,2
8,468,468,27,16,11,2,1
9,472,472,34,14,20,4,3
7,480,480,12,6,6,3,2
6,481,481,10,4,6,2,1
4,492,492,29,29,0,1,0
10,494,494,80,80,0,1,0
18,498,498,65,45,20,3,2
3,499,499,21,21,0,1,0

4,110,110,12,5,7,2,1
10,118,118,6,2,4,2,1
14,191,191,45,3,42,4,3
5,196,196,82,72,10,2,1
0,199,199,40,40,0,1,0
3,253,253,27,19,8,3,2
12,268,268,5,2,3,2,1
1,278,278,37,5,32,3,2
9,317,317,42,42,0,1,0
11,348,348,92,92,0,1,0
6,374,374,58,58,0,1,0
2,388,388,13,4,9,4,3
7,404,404,5,5,0,1,0
13,406,406,24,24,0,1,0
8,420,420,38,12,26,3,2

7,120,120,9,9,0,1,0
14,130,130,21,3,18,3,2
8,147,147,2,2,0,1,0
11,150,150,1,1,0,1,0
17,164,164,23,17,6,2,1
12,177,177,47,7,40,2,1
16,193,193,18,1,17,2,1
0,237,237,2,2,0,1,0
21,275,275,31,7,24,3,2
5,305,305,6,6,0,1,0
4,308,308,37,37,0,1,0
18,361,361,20,1,19,2,1
2,365,365,61,61,0,1,0
19,383,383,48,8,40,3,2
9,414,414,1,1,0,1,0
13,415,415,65,32,33,4,3
15,416,416,58,34,24,4,3
10,422,422,38,35,3,2,1
20,426,426,16,2,14,3,2
6,472,472,10,10,0,1,0
3,477,477,63,63,0,1,0
1,492,492,40,40,0,1,0

17,102,102,11,6,5,2,1
8,110,110,10,10,0,1,0
10,124,124,11,11,0,1,0
6,139,139,3,3,0,1,0
4,172,172,34,26,8,3,2
7,237,237,2,2,0,1,0
5,254,254,25,1,24,4,3
12,268,268,21,6,15,2,1
0,294,294,6,1,5,2,1
11,318,318,12,12,0,1,0
15,325,325,20,20,0,1,0
18,332,332,51,51,0,1,0
3,337,337,65,3,62,4,3
2,359,359,12,12,0,1,0
13,405,405,148,100,48,3,2
1,410,410,19,6,13,2,1
16,412,412,73,73,0,1,0
14,424,424,2,2,0,1,0
19,458,458,14,2,12,3,2
9,470,470,95,69,26,2,1

3,132,132,19,1,18,4,3
2,145,145,5,5,0,1,0
9,157,157,70,16,54,3,2
5,170,170,12,9,3,2,1
13,182,182,8,2,6,2,1
17,237,237,39,17,22,3,2
16,288,288,4,4,0,1,0
12,300,300,60,19,41,2,1
0,316,316,26,26,0,1,0
6,357,357,47,47,0,1,0
8,383,383,146,125,21,2,1
7,388,388,33,27,6,3,2
1,406,406,16,16,0,1,0
10,420,420,18,18,0,1,0
11,443,443,8,8,0,1,0
4,466,466,15,15,0,1,0
14,469,469,7,7,0,1,0
15,484,484,37,33,4,2,1

12,102,102,7,7,0,1,0
5,135,135,2,2,0,1,0
7,143,143,1,1,0,1,0
9,156,156,1,1,0,1,0
18,229,229,38,38,0,1,0
10,237,237,27,9,18,3,2
0,245,245,2,2,0,1,0
8,253,253,1,1,0,1,0
15,254,254,21,15,6,3,2
20,265,265,8,8,0,1,0
1,270,270,59,2,57,4,3
14,297,297,46,46,0,1,0
23,304,304,19,19,0,1,0
3,311,311,25,25,0,1,0
19,326,326,7,7,0,1,0
11,339,339,2,2,0,1,0
22,345,345,58,36,22,3,2
13,357,357,14,5,9,4,3
16,371,371,72,33,39,4,3
6,418,418,84,28,56,3,2
17,418,418,79,55,24,4,3
2,475,475,5,5,0,1,0
4,488,488,33,9,24,3,2
21,493,493,50,50,0,1,0

10,107,107,2,2,0,1,0
6,108,108,3,3,0,1,0
16,117,117,22,4,18,3,2
18,136,136,27,3,24,2,1
13,139,139,13,3,10,3,2
4,168,168,15,15,0,1,0
7,183,183,41,41,0,1,0
9,187,187,5,5,0,1,0
11,216,216,47,47,0,1,0
20,253,253,24,24,0,1,0
2,271,271,23,10,13,2,1
8,279,279,43,43,0,1,0
3,291,291,3,3,0,1,0
21,358,358,25,5,20,2,1
17,359,359,18,18,0,1,0
5,365,365,31,31,0,1,0
15,377,377,82,82,0,1,0
19,390,390,35,12,23,2,1
14,406,406,9,1,8,3,2
1,410,410,5,5,0,1,0
12,414,414,13,13,0,1,0
0,422,422,8,8,0,1,0

2,111,111,9,9,0,1,0
5,113,113,31,31,0,1,0
9,130,130,10,1,9,4,3
18,135,135,2,2,0,1,0
14,139,139,26,19,7,2,1
13,153,153,6,3,3,2,1
16,160,160,1,1,0,1,0
7,208,208,2,2,0,1,0
4,213,213,25,25,0,1,0
15,248,248,61,61,0,1,0
8,261,261,11,11,0,1,0
10,290,290,9,1,8,2,1
1,301,301,8,2,6,3,2
17,345,345,9,3,6,3,2
12,354,354,122,71,51,3,2
3,356,356,81,66,15,3,2
6,404,404,8,8,0,1,0
11,441,441,58,46,12,4,3
0,473,473,62,35,27,4,3

7,110,110,39,15,24,4,3
4,118,118,3,3,0,1,0
2,123,123,2,2,0,1,0
14,123,123,29,29,0,1,0
15,127,127,35,35,0,1,0
18,128,128,3,3,0,1,0
5,132,132,1,1,0,1,0
16,173,173,3,3,0,1,0
8,184,184,3,3,0,1,0
11,203,203,25,4,21,4,3
20,206,206,63,63,0,1,0
19,209,209,4,4,0,1,0
3,230,230,3,3,0,1,0
12,235,235,9,1,8,2,1
9,238,238,26,26,0,1,0
6,240,240,4,4,0,1,0
1,264,264,51,10,41,2,1
0,292,292,33,33,0,1,0
17,298,298,17,7,10,3,2
10,431,431,5,5,0,1,0
13,472,472,25,7,18,3,2

0,103,103,24,15,9,2,1
10,116,116,1,1,0,1,0
6,117,117,5,5,0,1,0
2,178,178,7,3,4,2,1
9,196,196,74,60,14,3,2
12,274,274,4,4,0,1,0
16,285,285,40,31,9,2,1
1,296,296,35,5,30,3,2
14,302,302,12,12,0,1,0
4,354,354,48,36,12,3,2
11,406,406,74,45,29,2,1
15,413,413,42,8,34,4,3
8,429,429,54,18,36,2,1
13,436,436,12,5,7,2,1
5,446,446,40,1,39,4,3
3,470,470,134,115,19,2,1
7,482,482,28,28,0,1,0

6,102,102,10,10,0,1,0
16,125,125,18,1,17,2,1
13,153,153,3,3,0,1,0
8,178,178,4,4,0,1,0
10,210,210,2,2,0,1,0
5,216,216,5,5,0,1,0
11,245,245,30,8,22,3,2
17,249,249,23,23,0,1,0
18,282,282,8,2,6,2,1
9,311,311,62,62,0,1,0
2,317,317,48,48,0,1,0
1,334,334,17,13,4,2,1
3,352,352,62,44,18,2,1
7,361,361,1,1,0,1,0
0,413,413,41,41,0,1,0
15,421,421,137,75,62,4,3
4,452,452,80,80,0,1,0
14,454,454,13,1,12,2,1
12,494,494,120,30,90,4,3

11,148,148,19,19,0,1,0
1,150,150,8,2,6,3,2
4,155,155,26,26,0,1,0
17,208,208,7,7,0,1,0
14,211,211,53,53,0,1,0
15,249,249,27,27,0,1,0
16,262,262,38,22,16,2,1
6,264,264,38,29,9,4,3
13,267,267,66,66,0,1,0
9,296,296,3,3,0,1,0
8,301,301,72,19,53,3,2
0,310,310,16,16,0,1,0
2,314,314,23,23,0,1,0
5,338,338,47,27,20,2,1
12,410,410,13,13,0,1,0
3,451,451,54,4,50,2,1
7,470,470,7,7,0,1,0
10,492,492,29,29,0,1,0

1,109,109,3,3,0,1,0
14,110,110,7,7,0,1,0
5,159,159,36,36,0,1,0
17,179,179,8,8,0,1,0
15,196,196,13,13,0,1,0
19,222,222,40,17,23,2,1
11,234,234,35,35,0,1,0
0,237,237,23,9,14,3,2
2,252,252,13,13,0,1,0
7,274,274,1,1,0,1,0
10,297,297,16,12,4,2,1
3,313,313,26,26,0,1,0
18,357,357,104,86,18,2,1
6,388,388,65,26,39,4,3
8,401,401,23,11,12,2,1
9,413,413,28,28,0,1,0
16,423,423,24,8,16,3,2
13,457,457,44,2,42,2,1
12,479,479,7,7,0,1,0
20,481,481,19,19,0,1,0
21,489,489,90,54,36,4,3
4,499,499,1,1,0,1,0

4,104,104,1,1,0,1,0
17,122,122,19,19,0,1,0
10,216,216,4,4,0,1,0
19,216,216,15,15,0,1,0
8,230,230,2,2,0,1,0
15,272,272,14,14,0,1,0
9,297,297,1,1,0,1,0
7,306,306,8,5,3,2,1
21,322,322,20,20,0,1,0
6,333,333,2,2,0,1,0
5,339,339,3,3,0,1,0
2,341,341,16,1,15,4,3
0,346,346,48,22,26,4,3
16,361,361,25,25,0,1,0
20,370,370,26,26,0,1,0
14,394,394,11,4,7,2,1
12,408,408,10,10,0,1,0
22,420,420,119,119,0,1,0
18,442,442,6,1,5,2,1
3,452,452,82,82,0,1,0
24,472,472,48,48,0,1,0
1,476,476,155,155,0,1,0
13,481,481,17,17,0,1,0
11,489,489,43,2,41,4,3
23,496,496,92,92,0,1,0

4,167,167,41,9,32,2,1
9,170,170,1,1,0,1,0
0,185,185,10,10,0,1,0
6,215,215,22,1,21,2,1
8,233,233,27,27,0,1,0
7,266,266,84,3,81,4,3
3,275,275,73,73,0,1,0
1,379,379,137,68,69,4,3
5,396,396,20,20,0,1,0
10,412,412,9,9,0,1,0
2,436,436,34,26,8,3,2
11,437,437,105,38,67,4,3
13,473,473,4,4,0,1,0
12,492,492,75,75,0,1,0

13,100,100,1,1,0,1,0
17,121,121,2,2,0,1,0
16,124,124,51,27,24,4,3
3,177,177,3,3,0,1,0
12,178,178,21,5,16,4,3
1,219,219,34,10,24,4,3
15,221,221,38,38,0,1,0
6,262,262,1,1,0,1,0
14,276,276,17,3,14,2,1
4,280,280,7,7,0,1,0
9,285,285,25,11,14,3,2
11,285,285,7,7,0,1,0
7,290,290,26,4,22,2,1
2,322,322,20,4,16,2,1
5,325,325,20,20,0,1,0
10,353,353,44,15,29,2,1
8,445,445,221,157,64,3,2
0,473,473,43,20,23,2,1

17,133,133,5,5,0,1,0
7,149,149,39,3,36,3,2
19,153,153,54,54,0,1,0
6,160,160,6,6,0,1,0
5,170,170,4,1,3,2,1
18,183,183,2,2,0,1,0
15,254,254,32,32,0,1,0
0,255,255,18,18,0,1,0
2,303,303,17,17,0,1,0
10,305,305,58,58,0,1,0
8,311,311,2,2,0,1,0
3,347,347,6,2,4,2,1
4,359,359,21,11,10,3,2
14,366,366,71,61,10,2,1
11,370,370,40,40,0,1,0
16,400,400,26,26,0,1,0
9,404,404,28,28,0,1,0
1,406,406,86,65,21,4,3
12,424,424,19,15,4,2,1
13,455,455,34,16,18,2,1

21,100,100,5,5,0,1,0
3,137,137,10,1,9,4,3
6,147,147,6,6,0,1,0
10,159,159,57,33,24,4,3
15,174,174,12,4,8,2,1
9,184,184,4,1,3,2,1
1,243,243,23,23,0,1,0
17,243,243,29,8,21,2,1
12,252,252,18,2,16,3,2
4,280,280,38,38,0,1,0
13,302,302,60,60,0,1,0
20,306,306,106,106,0,1,0
7,313,313,2,2,0,1,0
8,318,318,44,2,42,3,2
2,358,358,8,8,0,1,0
19,365,365,20,20,0,1,0
11,403,403,8,2,6,3,2
16,436,436,34,1,33,2,1
14,447,447,32,32,0,1,0
0,453,453,1,1,0,1,0
5,458,458,8,8,0,1,0
18,464,464,13,1,12,4,3

17,117,117,16,16,0,1,0
12,122,122,21,3,18,4,3
5,233,233,30,11,19,2,1
7,238,238,30,30,0,1,0
2,239,239,33,11,22,3,2
21,278,278,5,5,0,1,0
18,286,286,28,12,16,3,2
16,307,307,7,1,6,2,1
19,309,309,52,23,29,2,1
0,319,319,3,3,0,1,0
6,344,344,12,12,0,1,0
14,348,348,113,57,56,3,2
1,366,366,26,7,19,2,1
8,369,369,22,22,0,1,0
3,377,377,22,5,17,2,1
22,389,389,2,2,0,1,0
11,394,394,44,44,0,1,0
4,402,402,9,1,8,3,2
15,426,426,60,60,0,1,0
9,441,441,15,15,0,1,0
10,442,442,4,4,0,1,0
13,477,477,12,2,10,3,2
20,490,490,47,47,0,1,0

11,117,117,2,2,0,1,0
18,136,136,10,10,0,1,0
23,164,164,14,1,13,4,3
5,205,205,4,4,0,1,0
6,207,207,26,5,21,2,1
4,207,207,1,1,0,1,0
12,210,210,40,30,10,2,1
16,225,225,12,12,0,1,0
0,240,240,4,4,0,1,0
1,241,241,10,10,0,1,0
10,252,252,30,10,20,3,2
21,254,254,27,27,0,1,0
15,269,269,9,3,6,3,2
7,287,287,8,8,0,1,0
3,296,296,18,18,0,1,0
19,299,299,7,7,0,1,0
9,301,301,4,4,0,1,0
13,336,336,40,40,0,1,0
14,350,350,16,5,11,2,1
22,374,374,24,24,0,1,0
20,376,376,50,26,24,2,1
8,377,377,58,58,0,1,0
17,391,391,75,11,64,4,3
24,394,394,113,113,0,1,0
2,488,488,6,6,0,1,0

16,102,102,2,2,0,1,0
22,117,117,5,5,0,1,0
14,122,122,35,35,0,1,0
9,152,152,30,4,26,4,3
10,162,162,3,3,0,1,0
2,178,178,8,8,0,1,0
18,191,191,23,1,22,3,2
7,220,220,23,8,15,4,3
6,232,232,16,16,0,1,0
13,248,248,18,7,11,2,1
17,275,275,64,41,23,2,1
19,295,295,43,22,21,4,3
3,309,309,19,10,9,2,1
11,310,310,58,16,42,4,3
8,319,319,16,2,14,3,2
20,324,324,26,26,0,1,0
5,335,335,5,1,4,2,1
12,335,335,5,5,0,1,0
0,342,342,1,1,0,1,0
15,394,394,16,5,11,2,1
21,451,451,25,25,0,1,0
4,454,454,12,4,8,3,2
1,488,488,66,66,0,1,0

17,148,148,23,6,17,2,1
19,173,173,23,1,22,2,1
9,182,182,1,1,0,1,0
1,184,184,7,7,0,1,0
12,194,194,10,10,0,1,0
6,194,194,7,1,6,2,1
18,197,197,10,10,0,1,0
10,200,200,35,35,0,1,0
16,210,210,45,35,10,3,2
4,223,223,22,10,12,3,2
13,273,273,58,58,0,1,0
0,309,309,3,3,0,1,0
2,309,309,10,2,8,2,1
14,355,355,11,11,0,1,0
7,366,366,175,139,36,4,3
3,367,367,32,8,24,2,1
5,396,396,3,3,0,1,0
11,423,423,49,37,12,4,3
15,450,450,24,24,0,1,0
8,464,464,15,3,12,3,2

9,125,125,3,3,0,1,0
7,140,140,1,1,0,1,0
2,200,200,11,4,7,2,1
18,201,201,9,9,0,1,0
12,201,201,2,2,0,1,0
20,262,262,25,25,0,1,0
16,285,285,17,2,15,4,3
24,287,287,38,23,15,4,3
25,341,341,11,11,0,1,0
4,349,349,1,1,0,1,0
23,357,357,38,5,33,4,3
1,368,368,20,5,15,4,3
5,374,374,13,10,3,2,1
3,376,376,35,7,28,2,1
11,378,378,53,11,42,3,2
13,384,384,48,23,25,2,1
27,401,401,37,37,0,1,0
19,421,421,9,2,7,2,1
6,424,424,2,2,0,1,0
26,437,437,26,26,0,1,0
28,439,439,44,8,36,4,3
10,458,458,29,29,0,1,0
0,465,465,31,31,0,1,0
17,469,469,7,7,0,1,0
14,471,471,2,2,0,1,0
22,485,485,137,137,0,1,0
15,487,487,64,23,41,4,3
21,488,488,54,54,0,1,0
8,499,499,22,6,16,3,2

14,139,139,2,2,0,1,0
5,146,146,15,15,0,1,0
7,157,157,3,3,0,1,0
9,209,209,12,9,3,2,1
20,216,216,15,3,12,2,1
21,230,230,14,14,0,1,0
2,241,241,57,29,28,3,2
10,277,277,25,25,0,1,0
13,314,314,10,10,0,1,0
8,328,328,10,1,9,2,1
19,332,332,84,51,33,4,3
16,333,333,29,16,13,2,1
1,334,334,52,52,0,1,0
12,337,337,60,23,37,4,3
3,384,384,5,5,0,1,0
18,402,402,34,13,21,2,1
15,432,432,135,12,123,4,3
0,434,434,5,5,0,1,0
11,437,437,34,34,0,1,0
4,474,474,1,1,0,1,0
17,496,496,48,13,35,2,1
6,500,500,13,1,12,2,1

9,103,103,3,3,0,1,0
11,156,156,19,19,0,1,0
14,171,171,17,17,0,1,0
2,194,194,47,47,0,1,0
17,235,235,43,43,0,1,0
12,236,236,30,30,0,1,0
15,261,261,12,12,0,1,0
0,290,290,35,30,5,2,1
5,291,291,59,35,24,3,2
10,325,325,28,16,12,4,3
13,344,344,21,21,0,1,0
4,348,348,1,1,0,1,0
16,358,358,27,6,21,2,1
6,359,359,17,6,11,2,1
1,413,413,110,110,0,1,0
18,432,432,95,45,50,3,2
8,438,438,3,3,0,1,0
3,459,459,31,31,0,1,0
7,478,478,11,11,0,1,0

22,115,115,30,30,0,1,0
2,128,128,6,6,0,1,0
20,132,132,58,58,0,1,0
4,166,166,1,1,0,1,0
13,202,202,25,25,0,1,0
18,228,228,2,2,0,1,0
14,239,239,5,5,0,1,0
7,248,248,2,2,0,1,0
12,266,266,2,2,0,1,0
11,312,312,18,18,0,1,0
16,331,331,10,2,8,2,1
9,343,343,42,27,15,4,3
0,361,361,40,32,8,3,2
3,370,370,55,28,27,2,1
17,374,374,1,1,0,1,0
5,375,375,5,5,0,1,0
19,398,398,9,4,5,2,1
6,402,402,32,19,13,4,3
15,404,404,92,83,9,4,3
8,415,415,16,3,13,2,1
10,431,431,61,53,8,2,1
1,439,439,42,42,0,1,0
21,467,467,3,3,0,1,0

10,109,109,1,1,0,1,0
18,117,117,6,6,0,1,0
2,127,127,7,7,0,1,0
16,138,138,2,2,0,1,0
8,139,139,2,2,0,1,0
4,180,180,13,1,12,4,3
7,184,184,21,7,14,3,2
9,184,184,22,22,0,1,0
6,256,256,37,37,0,1,0
0,257,257,5,5,0,1,0
3,301,301,50,50,0,1,0
14,312,312,39,39,0,1,0
1,320,320,26,26,0,1,0
5,323,323,67,57,10,2,1
13,336,336,12,3,9,2,1
12,351,351,38,38,0,1,0
15,356,356,111,63,48,3,2
17,376,376,18,18,0,1,0
19,484,484,105,105,0,1,0
11,485,485,52,45,7,2,1

7,113,113,1,1,0,1,0
15,151,151,19,19,0,1,0
1,179,179,3,3,0,1,0
14,231,231,4,1,3,2,1
5,246,246,30,30,0,1,0
6,252,252,24,9,15,4,3
16,281,281,14,14,0,1,0
0,297,297,39,39,0,1,0
20,302,302,82,50,32,2,1
2,309,309,34,19,15,2,1
17,319,319,5,5,0,1,0
13,334,334,11,11,0,1,0
8,338,338,6,6,0,1,0
10,343,343,38,38,0,1,0
18,343,343,91,13,78,4,3
9,364,364,75,75,0,1,0
4,370,370,6,6,0,1,0
11,372,372,52,12,40,2,1
19,400,400,45,45,0,1,0
3,456,456,12,9,3,2,1
12,463,463,57,57,0,1,0

0,121,121,16,6,10,2,1
15,141,141,18,3,15,4,3
9,165,165,12,12,0,1,0
10,222,222,5,5,0,1,0
5,242,242,38,38,0,1,0
6,257,257,2,2,0,1,0
1,270,270,53,4,49,2,1
11,278,278,29,29,0,1,0
13,286,286,79,3,76,3,2
2,289,289,21,16,5,2,1
8,298,298,3,3,0,1,0
4,335,335,71,51,20,2,1
12,337,337,107,41,66,4,3
7,360,360,42,42,0,1,0
16,374,374,17,17,0,1,0
14,377,377,18,11,7,2,1
3,430,430,46,13,33,4,3

1,106,106,13,1,12,3,2
5,111,111,1,1,0,1,0
14,116,116,13,13,0,1,0
10,140,140,1,1,0,1,0
4,142,142,4,4,0,1,0
9,162,162,7,7,0,1,0
21,169,169,41,24,17,3,2
15,205,205,13,13,0,1,0
13,206,206,14,14,0,1,0
19,212,212,4,4,0,1,0
2,221,221,5,5,0,1,0
6,252,252,11,4,7,2,1
18,261,261,11,11,0,1,0
0,270,270,11,11,0,1,0
17,293,293,59,59,0,1,0
7,308,308,41,41,0,1,0
12,410,410,117,38,79,4,3
16,411,411,95,95,0,1,0
3,424,424,21,17,4,2,1
8,447,447,15,15,0,1,0
11,475,475,87,87,0,1,0
20,476,476,21,9,12,3,2

1,104,104,33,33,0,1,0
8,154,154,5,5,0,1,0
2,175,175,103,103,0,1,0
4,185,185,21,21,0,1,0
12,214,214,8,8,0,1,0
5,243,243,5,2,3,2,1
7,266,266,39,13,26,3,2
6,360,360,108,54,54,3,2
0,367,367,16,16,0,1,0
3,367,367,19,12,7,2,1
9,415,415,13,4,9,2,1
10,428,428,90,90,0,1,0
11,464,464,58,58,0,1,0

0,150,150,9,9,0,1,0
11,179,179,3,3,0,1,0
4,193,193,2,2,0,1,0
6,203,203,42,27,15,3,2
16,212,212,37,1,36,2,1
13,228,228,28,1,27,2,1
3,248,248,11,11,0,1,0
10,262,262,20,20,0,1,0
12,267,267,6,2,4,2,1
17,275,275,26,26,0,1,0
5,290,290,18,18,0,1,0
2,330,330,25,7,18,2,1
1,356,356,80,80,0,1,0
7,382,382,79,43,36,4,3
9,412,412,110,110,0,1,0
8,454,454,50,38,12,4,3
15,475,475,100,100,0,1,0
14,490,490,16,16,0,1,0

16,121,121,21,21,0,1,0
10,122,122,28,8,20,3,2
11,135,135,3,3,0,1,0
4,159,159,24,7,17,2,1
7,168,168,3,3,0,1,0
20,174,174,3,3,0,1,0
2,177,177,15,15,0,1,0
0,198,198,1,1,0,1,0
21,202,202,27,4,23,2,1
15,237,237,27,27,0,1,0
9,240,240,24,21,3,2,1
3,314,314,3,3,0,1,0
17,330,330,75,30,45,2,1
12,341,341,6,6,0,1,0
22,345,345,16,13,3,2,1
13,376,376,45,45,0,1,0
8,388,388,7,2,5,2,1
5,397,397,50,23,27,4,3
6,418,418,1,1,0,1,0
19,424,424,18,18,0,1,0
1,426,426,42,28,14,3,2
14,429,429,57,11,46,3,2
18,429,429,57,4,53,4,3

9,102,102,6,6,0,1,0
19,114,114,12,2,10,2,1
15,123,123,14,8,6,3,2
10,156,156,11,11,0,1,0
8,167,167,21,21,0,1,0
7,175,175,21,9,12,2,1
14,182,182,16,16,0,1,0
2,184,184,5,5,0,1,0
13,200,200,11,11,0,1,0
11,219,219,5,5,0,1,0
4,223,223,11,4,7,2,1
6,235,235,7,7,0,1,0
12,252,252,6,6,0,1,0
0,259,259,1,1,0,1,0
23,293,293,5,1,4,2,1
5,302,302,15,15,0,1,0
21,329,329,10,3,7,2,1
17,336,336,24,24,0,1,0
24,341,341,32,22,10,3,2
20,399,399,83,34,49,4,3
16,416,416,133,133,0,1,0
22,438,438,1,1,0,1,0
18,454,454,78,39,39,2,1
3,487,487,48,48,0,1,0
1,500,500,32,4,28,4,3

17,103,103,3,3,0,1,0
5,112,112,4,4,0,1,0
9,113,113,30,30,0,1,0
6,134,134,21,17,4,2,1
15,146,146,6,6,0,1,0
14,150,150,35,8,27,4,3
2,158,158,6,6,0,1,0
1,200,200,48,22,26,3,2
10,200,200,11,1,10,3,2
0,214,214,43,17,26,2,1
4,233,233,9,5,4,2,1
7,334,334,9,9,0,1,0
16,389,389,16,16,0,1,0
12,421,421,5,5,0,1,0
8,429,429,21,21,0,1,0
3,433,433,93,20,73,3,2
11,481,481,168,109,59,4,3
13,484,484,1,1,0,1,0

10,104,104,4,4,0,1,0
13,109,109,32,7,25,2,1
16,134,134,1,1,0,1,0
4,135,135,1,1,0,1,0
7,265,265,6,6,0,1,0
6,298,298,27,27,0,1,0
14,303,303,3,3,0,1,0
18,311,311,61,28,33,4,3
15,317,317,106,56,50,3,2
0,328,328,11,11,0,1,0
9,333,333,67,31,36,3,2
8,339,339,39,39,0,1,0
17,401,401,27,3,24,4,3
2,404,404,1,1,0,1,0
5,437,437,24,14,10,3,2
12,454,454,26,23,3,2,1
1,471,471,165,99,66,4,3
3,482,482,59,19,40,2,1
11,499,499,11,11,0,1,0

16,136,136,10,4,6,2,1
3,156,156,82,37,45,4,3
15,156,156,3,3,0,1,0
1,165,165,1,1,0,1,0
4,200,200,5,5,0,1,0
0,202,202,12,12,0,1,0
13,262,262,37,15,22,2,1
9,274,274,9,3,6,3,2
2,280,280,41,41,0,1,0
14,291,291,31,31,0,1,0
12,328,328,4,4,0,1,0
8,329,329,98,4,94,3,2
6,333,333,36,36,0,1,0
5,355,355,34,34,0,1,0
11,367,367,75,13,62,3,2
7,380,380,13,13,0,1,0
10,441,441,58,58,0,1,0

18,161,161,8,8,0,1,0
7,168,168,17,17,0,1,0
22,187,187,30,30,0,1,0
11,223,223,32,5,27,4,3
19,228,228,51,3,48,4,3
0,247,247,6,6,0,1,0
3,247,247,7,7,0,1,0
10,264,264,1,1,0,1,0
13,265,265,12,8,4,2,1
23,269,269,25,25,0,1,0
12,290,290,1,1,0,1,0
9,298,298,47,47,0,1,0
21,338,338,52,52,0,1,0
2,354,354,4,4,0,1,0
8,402,402,20,20,0,1,0
1,403,403,9,9,0,1,0
4,403,403,30,30,0,1,0
6,409,409,74,26,48,3,2
16,419,419,14,14,0,1,0
5,436,436,53,36,17,2,1
15,472,472,45,4,41,4,3
20,480,480,77,61,16,2,1
17,496,496,25,1,24,3,2
14,500,500,17,17,0,1,0

5,100,100,4,4,0,1,0
15,117,117,5,2,3,2,1
3,132,132,10,4,6,2,1
22,135,135,5,1,4,2,1
13,164,164,2,2,0,1,0
14,180,180,2,2,0,1,0
20,203,203,69,27,42,3,2
16,215,215,12,9,3,2,1
10,215,215,9,9,0,1,0
1,220,220,6,1,5,2,1
12,234,234,6,3,3,2,1
7,241,241,7,7,0,1,0
18,271,271,5,2,3,2,1
17,317,317,22,2,20,3,2
21,353,353,74,74,0,1,0
0,358,358,68,68,0,1,0
8,377,377,4,4,0,1,0
19,417,417,97,97,0,1,0
6,420,420,12,12,0,1,0
9,435,435,73,29,44,3,2
11,436,436,80,53,27,2,1
4,473,473,57,29,28,3,2
2,488,488,24,24,0,1,0

16,111,111,5,5,0,1,0
3,130,130,24,15,9,2,1
4,165,165,10,2,8,3,2
15,183,183,12,6,6,2,1
12,184,184,47,47,0,1,0
14,198,198,30,30,0,1,0
1,203,203,6,6,0,1,0
11,217,217,2,2,0,1,0
13,224,224,7,7,0,1,0
10,233,233,11,8,3,2,1
7,250,250,7,7,0,1,0
8,268,268,31,10,21,2,1
17,281,281,1,1,0,1,0
19,310,310,6,3,3,2,1
20,322,322,143,117,26,3,2
18,323,323,2,2,0,1,0
0,330,330,122,122,0,1,0
2,363,363,7,1,6,3,2
9,372,372,9,9,0,1,0
5,484,484,47,47,0,1,0
6,487,487,8,8,0,1,0

1,132,132,14,14,0,1,0
7,158,158,1,1,0,1,0
8,164,164,6,6,0,1,0
11,228,228,1,1,0,1,0
4,251,251,33,15,18,3,2
15,269,269,57,33,24,3,2
6,287,287,100,76,24,4,3
9,312,312,61,61,0,1,0
13,316,316,12,3,9,2,1
10,333,333,29,21,8,3,2
16,344,344,109,61,48,2,1
12,365,365,17,5,12,3,2
3,368,368,27,27,0,1,0
5,466,466,36,8,28,2,1
2,485,485,38,38,0,1,0
0,491,491,90,81,9,4,3
14,499,499,39,12,27,4,3

3,138,138,1,1,0,1,0
5,143,143,25,25,0,1,0
18,153,153,3,3,0,1,0
4,155,155,10,3,7,2,1
8,161,161,5,2,3,2,1
22,208,208,17,17,0,1,0
1,228,228,12,8,4,2,1
23,275,275,78,78,0,1,0
17,280,280,55,28,27,4,3
20,296,296,74,74,0,1,0
21,297,297,13,13,0,1,0
14,302,302,22,22,0,1,0
24,307,307,4,4,0,1,0
25,328,328,21,21,0,1,0
6,335,335,15,15,0,1,0
12,347,347,9,9,0,1,0
13,349,349,9,9,0,1,0
11,385,385,107,81,26,2,1
2,414,414,4,4,0,1,0
19,419,419,26,26,0,1,0
10,431,431,28,2,26,4,3
16,434,434,18,9,9,4,3
9,436,436,5,5,0,1,0
0,462,462,23,4,19,2,1
15,467,467,11,6,5,2,1
7,484,484,11,11,0,1,0

8,115,115,20,8,12,4,3
4,127,127,8,8,0,1,0
10,139,139,1,1,0,1,0
0,152,152,29,29,0,1,0
5,222,222,7,2,5,2,1
12,230,230,5,1,4,2,1
2,235,235,42,42,0,1,0
3,245,245,3,3,0,1,0
6,259,259,27,15,12,4,3
17,274,274,39,39,0,1,0
14,299,299,36,36,0,1,0
7,305,305,26,12,14,2,1
13,319,319,21,4,17,4,3
15,346,346,59,7,52,4,3
9,350,350,32,20,12,4,3
18,381,381,21,12,9,4,3
19,396,396,43,39,4,2,1
1,405,405,17,5,12,3,2
16,435,435,129,110,19,2,1
20,439,439,13,13,0,1,0
11,471,471,10,10,0,1,0

8,103,103,15,6,9,2,1
6,107,107,8,8,0,1,0
12,185,185,11,2,9,4,3
5,197,197,7,7,0,1,0
9,208,208,5,5,0,1,0
14,219,219,19,19,0,1,0
4,222,222,2,2,0,1,0
18,232,232,18,1,17,2,1
20,234,234,44,44,0,1,0
1,239,239,19,19,0,1,0
0,255,255,1,1,0,1,0
15,266,266,65,23,42,4,3
19,288,288,14,1,13,2,1
24,301,301,11,4,7,2,1
3,305,305,5,5,0,1,0
23,335,335,48,48,0,1,0
7,343,343,1,1,0,1,0
11,384,384,5,2,3,2,1
10,427,427,38,8,30,3,2
2,453,453,49,49,0,1,0
16,454,454,60,60,0,1,0
13,470,470,4,4,0,1,0
17,475,475,1,1,0,1,0
22,484,484,80,2,78,4,3
21,494,494,111,111,0,1,0

16,100,100,3,3,0,1,0
23,116,116,28,13,15,2,1
6,130,130,7,2,5,2,1
10,157,157,3,3,0,1,0
0,158,158,1,1,0,1,0
8,171,171,5,5,0,1,0
12,199,199,19,19,0,1,0
5,222,222,12,12,0,1,0
20,248,248,14,8,6,3,2
17,257,257,62,62,0,1,0
14,258,258,14,14,0,1,0
4,272,272,8,8,0,1,0
24,284,284,12,3,9,3,2
9,291,291,1,1,0,1,0
11,315,315,16,16,0,1,0
19,320,320,39,39,0,1,0
21,327,327,13,13,0,1,0
18,337,337,10,10,0,1,0
7,379,379,11,3,8,2,1
1,410,410,19,1,18,2,1
2,412,412,62,31,31,2,1
13,450,450,15,15,0,1,0
3,474,474,7,4,3,2,1
22,478,478,102,66,36,2,1
15,488,488,162,104,58,3,2

7,101,101,7,1,6,3,2
1,107,107,17,17,0,1,0
2,144,144,4,1,3,2,1
13,181,181,26,26,0,1,0
4,203,203,10,10,0,1,0
15,307,307,87,42,45,4,3
6,320,320,92,81,11,2,1
12,332,332,5,5,0,1,0
3,347,347,40,40,0,1,0
17,351,351,128,118,10,3,2
9,378,378,31,13,18,3,2
8,383,383,8,1,7,2,1
0,383,383,66,66,0,1,0
10,391,391,24,19,5,2,1
5,450,450,45,45,0,1,0
11,462,462,13,3,10,3,2
16,470,470,2,2,0,1,0
14,492,492,15,15,0,1,0

17,118,118,6,2,4,2,1
8,140,140,6,6,0,1,0
10,153,153,1,1,0,1,0
12,153,153,40,40,0,1,0
9,168,168,4,4,0,1,0
11,175,175,22,10,12,4,3
2,197,197,10,10,0,1,0
16,201,201,56,56,0,1,0
14,224,224,1,1,0,1,0
15,248,248,5,5,0,1,0
18,259,259,37,18,19,3,2
7,273,273,144,123,21,4,3
4,294,294,1,1,0,1,0
0,295,295,12,3,9,2,1
19,299,299,11,11,0,1,0
13,313,313,5,5,0,1,0
3,330,330,9,3,6,2,1
5,361,361,23,7,16,3,2
20,371,371,79,79,0,1,0
1,419,419,15,6,9,4,3
6,469,469,27,27,0,1,0

16,109,109,1,1,0,1,0
8,115,115,8,8,0,1,0
14,153,153,7,1,6,3,2
9,154,154,29,29,0,1,0
21,192,192,47,47,0,1,0
17,221,221,4,4,0,1,0
12,279,279,1,1,0,1,0
1,284,284,17,8,9,4,3
4,307,307,9,9,0,1,0
18,329,329,49,49,0,1,0
5,334,334,66,26,40,3,2
3,345,345,4,4,0,1,0
22,356,356,74,74,0,1,0
13,357,357,31,31,0,1,0
19,362,362,29,29,0,1,0
6,367,367,11,11,0,1,0
0,375,375,10,10,0,1,0
10,379,379,7,7,0,1,0
15,383,383,19,15,4,2,1
2,390,390,21,21,0,1,0
11,430,430,50,50,0,1,0
20,448,448,93,93,0,1,0
7,462,462,51,34,17,2,1

11,100,100,23,23,0,1,0
15,162,162,48,48,0,1,0
13,168,168,23,6,17,4,3
3,177,177,45,26,19,4,3
8,181,181,24,24,0,1,0
18,188,188,22,10,12,2,1
16,248,248,8,8,0,1,0
2,253,253,31,31,0,1,0
9,288,288,1,1,0,1,0
19,289,289,21,13,8,3,2
17,310,310,12,12,0,1,0
12,320,320,3,3,0,1,0
10,320,320,20,20,0,1,0
0,321,321,5,5,0,1,0
5,326,326,6,6,0,1,0
6,341,341,24,12,12,3,2
1,371,371,12,3,9,2,1
14,401,401,38,11,27,4,3
7,432,432,87,28,59,3,2
4,457,457,40,8,32,2,1

9,104,104,11,11,0,1,0
2,126,126,1,1,0,1,0
16,134,134,15,12,3,2,1
13,136,136,14,14,0,1,0
14,146,146,1,1,0,1,0
3,223,223,33,5,28,4,3
7,239,239,6,6,0,1,0
8,243,243,27,13,14,2,1
6,246,246,43,7,36,4,3
5,259,259,44,44,0,1,0
11,282,282,9,9,0,1,0
15,305,305,80,48,32,3,2
10,308,308,29,11,18,3,2
4,324,324,26,12,14,3,2
17,339,339,60,14,46,2,1
1,357,357,13,5,8,2,1
19,386,386,58,58,0,1,0
18,433,433,5,5,0,1,0
0,456,456,8,8,0,1,0
12,471,471,63,63,0,1,0
20,478,478,29,29,0,1,0

1,104,104,17,8,9,4,3
18,114,114,2,2,0,1,0
12,118,118,2,2,0,1,0
0,137,137,7,7,0,1,0
14,180,180,2,2,0,1,0
19,182,182,11,11,0,1,0
16,191,191,38,38,0,1,0
5,208,208,22,22,0,1,0
15,244,244,5,5,0,1,0
7,291,291,8,2,6,3,2
6,293,293,4,4,0,1,0
2,304,304,26,26,0,1,0
10,333,333,62,62,0,1,0
11,346,346,6,6,0,1,0
13,359,359,62,53,9,4,3
9,378,378,63,63,0,1,0
21,383,383,35,35,0,1,0
20,411,411,23,23,0,1,0
3,467,467,5,5,0,1,0
17,476,476,184,184,0,1,0
4,484,484,76,76,0,1,0
8,497,497,1,1,0,1,0

3,115,115,1,1,0,1,0
8,129,129,1,1,0,1,0
10,134,134,4,4,0,1,0
6,147,147,2,2,0,1,0
14,163,163,2,2,0,1,0
15,250,250,63,17,46,2,1
17,277,277,17,17,0,1,0
23,295,295,4,1,3,2,1
5,318,318,43,11,32,3,2
4,365,365,33,33,0,1,0
7,368,368,1,1,0,1,0
16,369,369,4,1,3,2,1
13,379,379,41,22,19,2,1
18,399,399,7,7,0,1,0
20,405,405,62,23,39,4,3
9,411,411,92,92,0,1,0
21,444,444,43,27,16,2,1
1,463,463,16,1,15,4,3
0,472,472,43,15,28,4,3
12,473,473,51,51,0,1,0
22,486,486,59,23,36,4,3
11,489,489,50,24,26,2,1
19,499,499,142,124,18,4,3
2,500,500,17,11,6,3,2

14,100,100,12,12,0,1,0
10,142,142,14,10,4,2,1
13,147,147,13,13,0,1,0
12,160,160,40,40,0,1,0
8,168,168,4,4,0,1,0
15,172,172,15,15,0,1,0
16,179,179,17,3,14,3,2
6,180,180,5,1,4,2,1
4,194,194,23,14,9,4,3
18,198,198,15,7,8,3,2
2,236,236,13,4,9,4,3
3,267,267,19,19,0,1,0
11,293,293,76,76,0,1,0
17,299,299,2,2,0,1,0
1,328,328,78,7,71,4,3
9,330,330,28,20,8,3,2
19,362,362,15,7,8,2,1
7,403,403,11,11,0,1,0
0,428,428,92,92,0,1,0
5,444,444,18,18,0,1,0

4,101,101,6,6,0,1,0
9,156,156,35,35,0,1,0
10,176,176,20,20,0,1,0
8,183,183,3,3,0,1,0
1,215,215,17,7,10,3,2
12,233,233,61,31,30,3,2
0,290,290,12,12,0,1,0
13,309,309,35,35,0,1,0
15,337,337,5,5,0,1,0
2,376,376,226,217,9,2,1
14,383,383,6,1,5,2,1
6,425,425,9,1,8,2,1
11,426,426,101,5,96,4,3
5,428,428,38,38,0,1,0
3,448,448,49,49,0,1,0
7,476,476,9,3,6,2,1

13,113,113,11,3,8,2,1
22,191,191,14,10,4,2,1
9,215,215,14,14,0,1,0
11,216,216,3,3,0,1,0
2,227,227,5,1,4,2,1
6,244,244,13,13,0,1,0
19,256,256,30,20,10,3,2
5,273,273,7,7,0,1,0
3,297,297,45,45,0,1,0
23,319,319,3,3,0,1,0
4,353,353,25,3,22,2,1
16,370,370,32,32,0,1,0
18,377,377,152,70,82,3,2
1,381,381,43,8,35,4,3
0,401,401,6,6,0,1,0
8,403,403,30,9,21,2,1
20,403,403,26,3,23,2,1
14,410,410,5,5,0,1,0
21,411,411,39,29,10,4,3
15,438,438,10,4,6,2,1
12,442,442,24,24,0,1,0
17,447,447,63,59,4,2,1
10,475,475,77,29,48,3,2
7,489,489,34,19,15,4,3

23,109,109,13,13,0,1,0
9,124,124,3,3,0,1,0
19,134,134,25,13,12,2,1
24,137,137,9,3,6,3,2
10,147,147,20,20,0,1,0
17,149,149,16,9,7,2,1
6,169,169,25,18,7,2,1
21,230,230,12,1,11,2,1
12,282,282,26,13,13,2,1
15,302,302,23,5,18,4,3
4,311,311,24,15,9,2,1
14,331,331,22,2,20,2,1
8,332,332,5,5,0,1,0
7,340,340,12,8,4,2,1
5,343,343,8,8,0,1,0
22,355,355,63,63,0,1,0
1,364,364,3,3,0,1,0
18,374,374,11,3,8,2,1
13,377,377,10,1,9,4,3
2,401,401,47,47,0,1,0
20,422,422,104,66,38,3,2
11,443,443,12,12,0,1,0
3,452,452,42,29,13,2,1
16,460,460,17,17,0,1,0
0,485,485,17,5,12,2,1

18,108,108,14,14,0,1,0
15,110,110,23,1,22,2,1
20,111,111,12,1,11,2,1
16,133,133,8,2,6,2,1
9,137,137,5,2,3,2,1
19,144,144,4,4,0,1,0
21,168,168,3,3,0,1,0
6,198,198,8,1,7,2,1
1,204,204,54,27,27,4,3
0,216,216,43,43,0,1,0
10,235,235,30,10,20,2,1
11,244,244,12,12,0,1,0
13,262,262,7,3,4,2,1
14,298,298,28,28,0,1,0
12,314,314,22,22,0,1,0
4,329,329,3,3,0,1,0
5,331,331,12,5,7,2,1
17,345,345,17,17,0,1,0
22,381,381,127,27,100,3,2
7,382,382,9,3,6,2,1
3,392,392,3,3,0,1,0
2,475,475,50,36,14,3,2
8,482,482,2,2,0,1,0

10,106,106,6,1,5,2,1
12,171,171,24,4,20,3,2
14,176,176,4,4,0,1,0
3,187,187,3,3,0,1,0
18,222,222,57,47,10,2,1
17,275,275,16,16,0,1,0
4,281,281,49,13,36,3,2
7,282,282,19,13,6,3,2
2,285,285,54,7,47,2,1
5,286,286,8,8,0,1,0
1,304,304,15,5,10,3,2
16,314,314,29,4,25,2,1
19,335,335,72,39,33,4,3
0,339,339,10,4,6,2,1
13,396,396,8,3,5,2,1
9,405,405,47,15,32,3,2
8,452,452,49,23,26,2,1
11,476,476,5,5,0,1,0
6,482,482,82,53,29,3,2
15,495,495,98,98,0,1,0

8,107,107,7,1,6,2,1
15,119,119,37,16,21,2,1
12,121,121,5,5,0,1,0
1,160,160,3,3,0,1,0
13,200,200,65,65,0,1,0
16,274,274,15,5,10,2,1
0,286,286,25,5,20,2,1
9,309,309,6,6,0,1,0
4,328,328,29,17,12,4,3
14,358,358,45,45,0,1,0
10,363,363,13,13,0,1,0
6,389,389,61,52,9,4,3
3,413,413,25,2,23,2,1
2,443,443,3,3,0,1,0
11,479,479,18,18,0,1,0
5,483,483,114,114,0,1,0
7,484,484,168,160,8,2,1

12,102,102,11,5,6,2,1
1,106,106,9,3,6,3,2
4,110,110,1,1,0,1,0
16,112,112,43,16,27,2,1
11,140,140,18,18,0,1,0
9,142,142,12,12,0,1,0
15,153,153,3,3,0,1,0
8,241,241,20,20,0,1,0
6,305,305,19,11,8,2,1
2,342,342,102,10,92,3,2
14,375,375,21,21,0,1,0
10,410,410,29,11,18,3,2
0,411,411,96,96,0,1,0
13,418,418,41,14,27,2,1
7,423,423,113,11,102,4,3
5,432,432,12,12,0,1,0
3,441,441,8,8,0,1,0

12,123,123,6,1,5,2,1
3,144,144,17,9,8,3,2
14,148,148,27,27,0,1,0
10,154,154,12,7,5,2,1
4,190,190,8,8,0,1,0
5,192,192,4,4,0,1,0
6,201,201,54,12,42,4,3
15,216,216,14,14,0,1,0
9,290,290,4,1,3,2,1
0,303,303,44,14,30,4,3
17,322,322,39,27,12,2,1
7,324,324,56,47,9,2,1
8,327,327,45,3,42,3,2
11,418,418,46,18,28,3,2
13,453,453,38,16,22,2,1
1,465,465,1,1,0,1,0
2,473,473,38,26,12,3,2
18,490,490,132,132,0,1,0
16,491,491,34,34,0,1,0

1,108,108,19,6,13,2,1
13,110,110,9,3,6,2,1
14,122,122,35,21,14,2,1
2,151,151,1,1,0,1,0
9,160,160,12,12,0,1,0
15,201,201,14,14,0,1,0
4,240,240,25,11,14,3,2
0,265,265,5,1,4,2,1
12,270,270,6,6,0,1,0
3,306,306,4,4,0,1,0
5,312,312,38,22,16,2,1
10,341,341,113,64,49,2,1
20,343,343,18,18,0,1,0
11,346,346,26,1,25,2,1
17,370,370,68,2,66,3,2
6,384,384,20,20,0,1,0
16,394,394,70,43,27,4,3
19,403,403,30,19,11,2,1
7,456,456,5,5,0,1,0
18,457,457,32,32,0,1,0
8,479,479,8,8,0,1,0

11,102,102,1,1,0,1,0
18,112,112,23,23,0,1,0
19,125,125,29,8,21,2,1
17,145,145,3,3,0,1,0
3,184,184,28,10,18,2,1
6,190,190,37,23,14,2,1
20,196,196,20,11,9,2,1
23,204,204,10,10,0,1,0
9,205,205,14,14,0,1,0
24,211,211,5,5,0,1,0
26,234,234,8,8,0,1,0
25,241,241,16,16,0,1,0
4,287,287,35,35,0,1,0
2,302,302,1,1,0,1,0
7,306,306,12,12,0,1,0
8,310,310,15,1,14,3,2
14,371,371,15,10,5,2,1
21,374,374,34,34,0,1,0
22,377,377,82,48,34,3,2
1,394,394,33,22,11,2,1
5,437,437,16,16,0,1,0
15,455,455,5,5,0,1,0
10,456,456,18,2,16,3,2
0,458,458,9,9,0,1,0
12,464,464,10,10,0,1,0
16,481,481,31,17,14,2,1
13,483,483,14,8,6,2,1

11,118,118,1,1,0,1,0
13,137,137,9,9,0,1,0
3,139,139,26,14,12,4,3
23,148,148,44,44,0,1,0
7,169,169,8,8,0,1,0
6,198,198,36,36,0,1,0
22,199,199,8,2,6,3,2
19,213,213,97,84,13,2,1
16,213,213,4,4,0,1,0
14,250,250,12,8,4,2,1
18,262,262,5,5,0,1,0
9,262,262,12,2,10,3,2
1,269,269,9,5,4,2,1
20,270,270,12,12,0,1,0
17,281,281,4,4,0,1,0
8,363,363,21,1,20,3,2
0,375,375,21,21,0,1,0
15,381,381,47,29,18,3,2
12,397,397,1,1,0,1,0
2,405,405,13,6,7,2,1
4,409,409,48,18,30,4,3
5,432,432,43,43,0,1,0
10,441,441,8,1,7,3,2
21,462,462,2,2,0,1,0

12,118,118,41,41,0,1,0
3,154,154,4,4,0,1,0
9,163,163,26,26,0,1,0
14,215,215,1,1,0,1,0
6,226,226,53,21,32,4,3
7,231,231,18,18,0,1,0
8,245,245,1,1,0,1,0
11,268,268,86,68,18,3,2
5,308,308,4,4,0,1,0
0,312,312,112,112,0,1,0
2,314,314,29,2,27,2,1
1,361,361,1,1,0,1,0
13,379,379,31,31,0,1,0
15,412,412,6,3,3,2,1
10,458,458,2,2,0,1,0
4,483,483,132,24,108,4,3

16,105,105,3,3,0,1,0
6,113,113,20,20,0,1,0
12,120,120,10,2,8,2,1
20,129,129,10,10,0,1,0
3,140,140,1,1,0,1,0
19,175,175,50,50,0,1,0
14,180,180,3,3,0,1,0
2,207,207,8,8,0,1,0
18,250,250,76,76,0,1,0
15,250,250,9,9,0,1,0
1,255,255,5,2,3,2,1
10,308,308,77,54,23,2,1
11,313,313,12,3,9,4,3
5,352,352,56,14,42,4,3
22,377,377,37,37,0,1,0
21,385,385,67,23,44,4,3
4,410,410,7,7,0,1,0
13,425,425,13,13,0,1,0
9,462,462,25,11,14,3,2
7,488,488,2,2,0,1,0
17,490,490,3,3,0,1,0
8,498,498,7,7,0,1,0
0,500,500,54,42,12,4,3

6,101,101,27,17,10,2,1
18,123,123,4,4,0,1,0
4,130,130,9,9,0,1,0
2,138,138,12,12,0,1,0
7,158,158,22,22,0,1,0
0,177,177,9,9,0,1,0
8,181,181,1,1,0,1,0
14,189,189,13,13,0,1,0
13,203,203,17,17,0,1,0
12,207,207,3,3,0,1,0
20,213,213,8,2,6,2,1
19,243,243,124,78,46,4,3
10,270,270,45,45,0,1,0
11,290,290,10,10,0,1,0
5,295,295,1,1,0,1,0
17,343,343,27,27,0,1,0
21,370,370,8,4,4,2,1
9,382,382,32,32,0,1,0
3,395,395,3,3,0,1,0
16,412,412,4,4,0,1,0
15,485,485,84,30,54,4,3
1,490,490,35,13,22,3,2

12,111,111,27,27,0,1,0
11,120,120,1,1,0,1,0
9,155,155,1,1,0,1,0
6,159,159,13,13,0,1,0
21,169,169,24,24,0,1,0
14,170,170,7,1,6,2,1
18,176,176,33,25,8,2,1
5,209,209,26,26,0,1,0
10,222,222,21,21,0,1,0
2,245,245,27,27,0,1,0
1,258,258,30,15,15,2,1
3,286,286,34,12,22,2,1
20,323,323,41,31,10,3,2
15,333,333,43,43,0,1,0
0,350,350,11,11,0,1,0
13,363,363,5,5,0,1,0
17,371,371,23,18,5,2,1
19,383,383,102,102,0,1,0
8,393,393,20,4,16,3,2
16,444,444,21,21,0,1,0
7,471,471,2,2,0,1,0
4,478,478,8,8,0,1,0

3,100,100,21,9,12,2,1
6,102,102,4,4,0,1,0
7,121,121,1,1,0,1,0
8,125,125,11,11,0,1,0
16,179,179,27,27,0,1,0
1,216,216,40,34,6,3,2
20,217,217,4,1,3,2,1
5,221,221,21,7,14,2,1
4,281,281,22,22,0,1,0
17,303,303,13,13,0,1,0
10,309,309,28,28,0,1,0
18,351,351,62,62,0,1,0
11,382,382,25,25,0,1,0
0,399,399,33,10,23,3,2
19,404,404,71,1,70,3,2
21,409,409,119,2,117,4,3
15,427,427,16,5,11,2,1
2,438,438,24,17,7,2,1
13,440,440,27,20,7,2,1
14,450,450,26,26,0,1,0
12,465,465,1,1,0,1,0
9,471,471,1,1,0,1,0

15,142,142,9,9,0,1,0
16,187,187,88,34,54,4,3
9,199,199,2,2,0,1,0
13,207,207,15,15,0,1,0
4,231,231,21,21,0,1,0
3,235,235,5,5,0,1,0
5,243,243,19,2,17,2,1
0,243,243,10,1,9,4,3
8,267,267,18,18,0,1,0
6,287,287,121,96,25,2,1
11,302,302,9,5,4,2,1
12,302,302,10,1,9,2,1
1,337,337,20,14,6,2,1
7,361,361,68,29,39,4,3
2,370,370,37,37,0,1,0
10,389,389,53,31,22,2,1
14,436,436,61,44,17,2,1

18,100,100,10,10,0,1,0
7,123,123,7,7,0,1,0
6,151,151,11,2,9,2,1
14,181,181,30,8,22,2,1
12,204,204,65,56,9,2,1
3,213,213,9,3,6,2,1
15,218,218,8,2,6,2,1
10,250,250,7,7,0,1,0
19,298,298,4,4,0,1,0
16,298,298,13,3,10,3,2
5,320,320,14,14,0,1,0
11,323,323,27,6,21,2,1
2,335,335,68,58,10,2,1
4,368,368,1,1,0,1,0
0,377,377,4,4,0,1,0
1,378,378,72,24,48,4,3
17,399,399,7,1,6,3,2
13,408,408,99,75,24,4,3
9,425,425,117,96,21,4,3
8,461,461,36,15,21,4,3

17,107,107,19,19,0,1,0
13,131,131,44,44,0,1,0
0,145,145,4,4,0,1,0
6,150,150,18,18,0,1,0
10,156,156,11,4,7,2,1
4,178,178,28,10,18,3,2
19,248,248,48,1,47,3,2
2,254,254,8,8,0,1,0
11,256,256,1,1,0,1,0
5,264,264,41,41,0,1,0
16,273,273,57,11,46,3,2
14,287,287,5,5,0,1,0
7,293,293,18,18,0,1,0
8,328,328,18,9,9,4,3
15,359,359,1,1,0,1,0
12,361,361,3,3,0,1,0
3,366,366,58,58,0,1,0
18,429,429,35,35,0,1,0
9,471,471,16,16,0,1,0
1,476,476,63,13,50,2,1

8,105,105,4,4,0,1,0
10,114,114,34,2,32,2,1
3,124,124,9,1,8,3,2
9,125,125,2,2,0,1,0
15,173,173,15,15,0,1,0
7,180,180,5,5,0,1,0
13,184,184,40,40,0,1,0
14,206,206,2,2,0,1,0
11,290,290,42,34,8,2,1
1,342,342,68,5,63,3,2
16,386,386,38,38,0,1,0
0,401,401,4,4,0,1,0
12,408,408,43,25,18,3,2
6,412,412,154,106,48,3,2
2,413,413,66,31,35,2,1
5,484,484,62,62,0,1,0
4,492,492,15,15,0,1,0

15,174,174,12,9,3,2,1
12,187,187,17,2,15,4,3
13,194,194,1,1,0,1,0
2,227,227,1,1,0,1,0
7,228,228,53,53,0,1,0
10,228,228,30,30,0,1,0
1,229,229,31,19,12,3,2
17,236,236,17,13,4,2,1
0,253,253,4,4,0,1,0
6,272,272,19,5,14,3,2
16,303,303,50,23,27,4,3
9,314,314,12,12,0,1,0
8,324,324,15,15,0,1,0
14,343,343,31,31,0,1,0
3,348,348,6,6,0,1,0
11,384,384,30,2,28,3,2
18,390,390,123,63,60,4,3
5,393,393,123,114,9,2,1
4,398,398,51,51,0,1,0

1,102,102,10,10,0,1,0
13,104,104,5,1,4,2,1
6,117,117,5,2,3,2,1
14,151,151,3,3,0,1,0
21,168,168,33,19,14,3,2
10,181,181,4,4,0,1,0
0,199,199,9,9,0,1,0
25,256,256,8,8,0,1,0
17,263,263,83,72,11,2,1
4,281,281,28,8,20,2,1
3,285,285,2,2,0,1,0
2,287,287,41,20,21,2,1
11,288,288,24,1,23,4,3
9,300,300,12,3,9,4,3
19,327,327,51,51,0,1,0
20,355,355,10,4,6,3,2
24,372,372,54,54,0,1,0
8,395,395,28,11,17,3,2
5,412,412,7,7,0,1,0
15,427,427,24,24,0,1,0
18,430,430,15,4,11,2,1
7,433,433,4,4,0,1,0
16,471,471,43,43,0,1,0
22,482,482,35,8,27,2,1
12,494,494,53,4,49,2,1
23,494,494,17,17,0,1,0

7,118,118,2,2,0,1,0
12,125,125,8,8,0,1,0
8,142,142,20,20,0,1,0
14,145,145,17,3,14,4,3
11,148,148,4,1,3,2,1
15,152,152,34,34,0,1,0
17,165,165,8,8,0,1,0
2,170,170,5,5,0,1,0
4,211,211,35,19,16,3,2
6,290,290,34,16,18,4,3
1,316,316,1,1,0,1,0
0,342,342,13,4,9,2,1
10,345,345,113,113,0,1,0
3,417,417,176,79,97,4,3
16,425,425,9,9,0,1,0
9,426,426,79,79,0,1,0
13,451,451,2,2,0,1,0
5,463,463,33,33,0,1,0

9,108,108,6,6,0,1,0
13,123,123,7,1,6,2,1
11,141,141,4,1,3,2,1
4,144,144,6,6,0,1,0
3,147,147,6,6,0,1,0
17,169,169,41,41,0,1,0
12,197,197,49,49,0,1,0
8,204,204,31,2,29,2,1
6,223,223,4,1,3,2,1
2,236,236,21,15,6,2,1
0,236,236,1,1,0,1,0
16,240,240,30,4,26,3,2
15,318,318,63,63,0,1,0
10,331,331,59,59,0,1,0
19,334,334,9,9,0,1,0
5,336,336,29,11,18,2,1
7,364,364,72,30,42,4,3
18,393,393,16,16,0,1,0
14,410,410,23,9,14,3,2
1,438,438,60,60,0,1,0

14,114,114,14,14,0,1,0
0,206,206,43,25,18,4,3
11,219,219,33,33,0,1,0
5,229,229,37,37,0,1,0
9,235,235,74,23,51,4,3
15,250,250,21,21,0,1,0
1,254,254,39,6,33,2,1
8,326,326,9,2,7,2,1
12,329,329,64,64,0,1,0
6,363,363,1,1,0,1,0
7,371,371,19,10,9,2,1
3,410,410,7,7,0,1,0
17,424,424,54,6,48,3,2
10,424,424,53,25,28,3,2
13,446,446,3,3,0,1,0
18,448,448,15,3,12,4,3
2,456,456,8,4,4,2,1
4,466,466,22,13,9,4,3
16,486,486,86,86,0,1,0

13,134,134,2,2,0,1,0
5,155,155,10,10,0,1,0
20,167,167,27,10,17,2,1
12,183,183,17,17,0,1,0
21,210,210,11,11,0,1,0
18,242,242,13,1,12,2,1
10,244,244,3,3,0,1,0
2,284,284,57,25,32,3,2
1,287,287,3,3,0,1,0
0,291,291,22,2,20,2,1
3,302,302,4,4,0,1,0
15,303,303,5,5,0,1,0
6,315,315,20,20,0,1,0
23,336,336,1,1,0,1,0
19,337,337,99,82,17,2,1
8,337,337,2,2,0,1,0
7,338,338,45,45,0,1,0
16,424,424,69,69,0,1,0
17,429,429,80,80,0,1,0
4,434,434,53,53,0,1,0
22,435,435,13,13,0,1,0
24,438,438,29,29,0,1,0
11,470,470,24,12,12,4,3
9,473,473,42,42,0,1,0
14,485,485,18,18,0,1,0

10,100,100,8,3,5,2,1
17,101,101,19,19,0,1,0
1,121,121,23,7,16,3,2
13,139,139,16,16,0,1,0
5,198,198,18,12,6,2,1
4,206,206,16,16,0,1,0
0,236,236,14,14,0,1,0
9,253,253,43,43,0,1,0
19,293,293,8,8,0,1,0
2,300,300,27,27,0,1,0
16,328,328,127,127,0,1,0
7,342,342,21,13,8,2,1
6,381,381,1,1,0,1,0
20,386,386,11,2,9,4,3
3,406,406,67,19,48,2,1
12,435,435,31,31,0,1,0
15,450,450,63,54,9,4,3
18,463,463,20,20,0,1,0
8,468,468,1,1,0,1,0
14,471,471,10,2,8,3,2
11,479,479,6,6,0,1,0

7,106,106,10,1,9,2,1
5,131,131,7,7,0,1,0
8,140,140,8,2,6,3,2
19,145,145,46,10,36,4,3
21,148,148,6,6,0,1,0
0,165,165,1,1,0,1,0
14,221,221,55,55,0,1,0
13,245,245,40,34,6,2,1
9,260,260,27,20,7,2,1
18,290,290,7,1,6,2,1
22,293,293,9,1,8,3,2
2,319,319,2,2,0,1,0
3,374,374,49,49,0,1,0
15,379,379,39,39,0,1,0
12,398,398,6,1,5,2,1
6,409,409,30,30,0,1,0
17,420,420,29,1,28,2,1
10,426,426,34,31,3,2,1
16,434,434,78,78,0,1,0
1,465,465,7,7,0,1,0
11,484,484,40,40,0,1,0
20,489,489,1,1,0,1,0
4,495,495,59,31,28,2,1

1,103,103,8,5,3,2,1
11,124,124,33,25,8,2,1
12,134,134,8,8,0,1,0
18,138,138,30,30,0,1,0
10,143,143,24,15,9,4,3
0,159,159,5,2,3,2,1
2,160,160,1,1,0,1,0
19,165,165,19,9,10,3,2
4,167,167,24,15,9,4,3
6,194,194,20,8,12,4,3
5,199,199,15,15,0,1,0
7,201,201,4,1,3,2,1
17,212,212,32,32,0,1,0
16,274,274,22,22,0,1,0
15,289,289,22,22,0,1,0
9,334,334,30,30,0,1,0
3,346,346,53,53,0,1,0
8,374,374,51,21,30,4,3
14,418,418,13,13,0,1,0
13,490,490,10,1,9,3,2

16,103,103,10,10,0,1,0
9,111,111,1,1,0,1,0
19,128,128,10,10,0,1,0
2,172,172,13,9,4,2,1
11,193,193,1,1,0,1,0
4,204,204,17,3,14,3,2
5,215,215,13,6,7,3,2
14,254,254,2,2,0,1,0
13,254,254,66,66,0,1,0
12,289,289,61,9,52,3,2
8,347,347,24,8,16,3,2
21,353,353,82,67,15,4,3
10,373,373,14,14,0,1,0
15,376,376,27,12,15,4,3
7,376,376,13,3,10,3,2
3,404,404,4,4,0,1,0
18,413,413,57,57,0,1,0
6,424,424,84,9,75,4,3
17,462,462,19,19,0,1,0
0,471,471,71,71,0,1,0
1,481,481,27,27,0,1,0
20,500,500,46,46,0,1,0

9,118,118,34,34,0,1,0
1,123,123,17,17,0,1,0
10,133,133,5,1,4,2,1
12,176,176,34,34,0,1,0
11,195,195,2,2,0,1,0
5,215,215,38,38,0,1,0
13,223,223,6,1,5,2,1
3,230,230,10,10,0,1,0
2,252,252,52,11,41,2,1
15,266,266,28,28,0,1,0
4,387,387,14,10,4,2,1
14,426,426,4,4,0,1,0
0,433,433,116,116,0,1,0
7,448,448,132,51,81,4,3
6,449,449,59,59,0,1,0
8,469,469,23,23,0,1,0

12,195,195,3,3,0,1,0
13,205,205,101,35,66,3,2
9,263,263,42,42,0,1,0
3,270,270,52,28,24,2,1
11,275,275,20,12,8,3,2
10,291,291,15,15,0,1,0
6,292,292,24,20,4,2,1
15,297,297,6,6,0,1,0
5,300,300,23,23,0,1,0
4,343,343,87,39,48,2,1
14,347,347,2,2,0,1,0
1,412,412,82,40,42,3,2
2,461,461,19,19,0,1,0
8,473,473,44,44,0,1,0
7,479,479,51,51,0,1,0
0,484,484,75,48,27,2,1

4,175,175,54,13,41,4,3
14,214,214,71,27,44,4,3
13,237,237,5,5,0,1,0
8,310,310,33,13,20,3,2
0,311,311,2,2,0,1,0
6,330,330,9,9,0,1,0
5,351,351,47,47,0,1,0
1,384,384,150,130,20,4,3
7,394,394,9,3,6,2,1
3,404,404,23,11,12,3,2
11,410,410,21,21,0,1,0
9,432,432,91,41,50,2,1
2,434,434,45,27,18,4,3
10,446,446,71,53,18,4,3
12,451,451,37,19,18,2,1

13,122,122,12,12,0,1,0
4,165,165,3,3,0,1,0
8,211,211,51,17,34,3,2
9,221,221,1,1,0,1,0
18,242,242,13,7,6,2,1
7,279,279,49,40,9,4,3
15,292,292,1,1,0,1,0
3,294,294,1,1,0,1,0
11,307,307,30,6,24,4,3
1,308,308,25,25,0,1,0
17,338,338,24,15,9,2,1
0,361,361,96,96,0,1,0
14,366,366,111,74,37,3,2
10,394,394,26,26,0,1,0
6,410,410,4,4,0,1,0
12,429,429,7,1,6,2,1
2,439,439,26,26,0,1,0
19,444,444,33,33,0,1,0
16,450,450,132,39,93,4,3
5,450,450,34,16,18,2,1

4,132,132,12,12,0,1,0
7,143,143,45,31,14,2,1
8,154,154,29,29,0,1,0
17,156,156,7,7,0,1,0
2,202,202,12,12,0,1,0
12,212,212,25,25,0,1,0
16,235,235,2,2,0,1,0
1,242,242,1,1,0,1,0
5,257,257,18,13,5,2,1
0,310,310,27,16,11,2,1
14,340,340,81,13,68,3,2
13,364,364,32,32,0,1,0
15,364,364,17,17,0,1,0
9,369,369,95,73,22,4,3
11,412,412,79,79,0,1,0
6,417,417,62,6,56,3,2
10,418,418,9,9,0,1,0
3,422,422,17,8,9,2,1

8,124,124,7,7,0,1,0
1,126,126,1,1,0,1,0
6,166,166,15,6,9,2,1
7,168,168,50,50,0,1,0
11,199,199,18,18,0,1,0
20,201,201,5,5,0,1,0
12,205,205,21,21,0,1,0
15,226,226,40,23,17,2,1
21,227,227,39,39,0,1,0
19,238,238,7,7,0,1,0
3,246,246,1,1,0,1,0
0,259,259,5,5,0,1,0
16,288,288,116,92,24,4,3
14,334,334,6,6,0,1,0
2,334,334,29,29,0,1,0
13,376,376,34,34,0,1,0
9,387,387,38,6,32,2,1
18,414,414,32,3,29,2,1
4,451,451,19,19,0,1,0
5,462,462,27,27,0,1,0
10,477,477,23,5,18,2,1
17,485,485,12,12,0,1,0

8,122,122,41,34,7,2,1
17,165,165,10,10,0,1,0
0,179,179,1,1,0,1,0
9,183,183,10,1,9,4,3
18,288,288,42,42,0,1,0
3,288,288,24,24,0,1,0
11,297,297,12,12,0,1,0
13,298,298,48,25,23,2,1
7,312,312,1,1,0,1,0
12,355,355,56,56,0,1,0
10,380,380,46,6,40,2,1
4,399,399,36,27,9,2,1
15,409,409,94,71,23,2,1
5,437,437,67,67,0,1,0
14,444,444,22,8,14,2,1
16,460,460,21,21,0,1,0
1,469,469,90,61,29,4,3
6,472,472,2,2,0,1,0
2,498,498,41,41,0,1,0

10,102,102,34,6,28,2,1
2,122,122,4,4,0,1,0
4,146,146,16,16,0,1,0
11,196,196,2,2,0,1,0
0,201,201,38,8,30,2,1
17,213,213,16,6,10,3,2
18,232,232,33,11,22,3,2
8,238,238,19,8,11,2,1
16,257,257,77,15,62,3,2
3,261,261,4,4,0,1,0
1,348,348,21,11,10,3,2
5,385,385,1,1,0,1,0
6,392,392,2,2,0,1,0
15,408,408,3,3,0,1,0
12,440,440,34,7,27,4,3
7,446,446,149,23,126,4,3
9,462,462,80,29,51,4,3
13,475,475,28,28,0,1,0
14,488,488,6,6,0,1,0

13,133,133,10,1,9,2,1
9,137,137,32,32,0,1,0
0,143,143,36,36,0,1,0
4,192,192,67,33,34,2,1
1,200,200,26,15,11,2,1
11,240,240,12,1,11,2,1
7,296,296,34,7,27,4,3
12,296,296,53,7,46,3,2
5,371,371,23,23,0,1,0
6,371,371,29,9,20,3,2
2,389,389,103,5,98,3,2
3,393,393,3,3,0,1,0
8,395,395,79,9,70,4,3
10,407,407,8,2,6,3,2

12,118,118,14,14,0,1,0
13,160,160,16,4,12,4,3
3,176,176,18,6,12,4,3
11,191,191,23,23,0,1,0
10,240,240,57,36,21,2,1
5,319,319,73,73,0,1,0
7,322,322,42,42,0,1,0
9,323,323,46,46,0,1,0
15,331,331,6,6,0,1,0
1,349,349,1,1,0,1,0
16,356,356,7,7,0,1,0
4,356,356,38,38,0,1,0
2,395,395,58,58,0,1,0
6,413,413,14,14,0,1,0
0,451,451,112,55,57,4,3
14,479,479,27,27,0,1,0
8,493,493,99,75,24,4,3

5,145,145,16,16,0,1,0
3,160,160,18,18,0,1,0
2,195,195,20,10,10,3,2
17,224,224,6,6,0,1,0
10,257,257,33,33,0,1,0
12,290,290,7,7,0,1,0
1,296,296,11,1,10,3,2
18,299,299,52,43,9,4,3
6,311,311,41,25,16,3,2
8,313,313,11,11,0,1,0
21,314,314,104,38,66,4,3
20,325,325,85,65,20,3,2
11,336,336,16,6,10,3,2
4,338,338,12,12,0,1,0
0,342,342,26,10,16,2,1
15,391,391,9,9,0,1,0
16,408,408,7,7,0,1,0
7,410,410,41,41,0,1,0
9,419,419,26,26,0,1,0
13,449,449,43,43,0,1,0
14,466,466,12,12,0,1,0
19,495,495,29,1,28,2,1

8,104,104,1,1,0,1,0
18,135,135,1,1,0,1,0
20,138,138,39,39,0,1,0
17,158,158,4,4,0,1,0
2,169,169,1,1,0,1,0
6,198,198,7,7,0,1,0
15,237,237,26,2,24,3,2
1,265,265,49,31,18,4,3
5,282,282,46,46,0,1,0
12,292,292,1,1,0,1,0
16,323,323,80,54,26,2,1
14,323,323,19,19,0,1,0
7,330,330,3,3,0,1,0
11,339,339,20,9,11,2,1
9,350,350,18,18,0,1,0
0,362,362,114,68,46,2,1
10,363,363,39,21,18,3,2
13,368,368,16,16,0,1,0
4,413,413,4,1,3,2,1
3,427,427,21,3,18,3,2
19,448,448,66,60,6,3,2
21,483,483,45,45,0,1,0

17,157,157,17,17,0,1,0
1,168,168,4,4,0,1,0
19,192,192,22,22,0,1,0
2,200,200,21,7,14,3,2
5,217,217,29,4,25,2,1
11,250,250,29,7,22,2,1
6,253,253,24,24,0,1,0
0,259,259,21,21,0,1,0
15,282,282,10,10,0,1,0
3,292,292,25,25,0,1,0
4,324,324,68,68,0,1,0
12,328,328,18,6,12,4,3
16,330,330,36,1,35,2,1
18,368,368,93,81,12,2,1
20,375,375,17,7,10,2,1
14,410,410,22,16,6,3,2
9,416,416,8,3,5,2,1
8,420,420,28,28,0,1,0
7,440,440,12,2,10,4,3
13,459,459,112,48,64,3,2
10,470,470,18,4,14,2,1

21,104,104,15,15,0,1,0
16,138,138,2,2,0,1,0
8,143,143,5,5,0,1,0
0,143,143,19,9,10,3,2
11,144,144,24,18,6,3,2
9,148,148,1,1,0,1,0
5,153,153,12,9,3,2,1
22,177,177,51,11,40,2,1
2,198,198,19,1,18,4,3
6,241,241,21,21,0,1,0
19,273,273,65,65,0,1,0
13,286,286,15,2,13,3,2
14,292,292,4,1,3,2,1
17,300,300,36,10,26,3,2
20,321,321,12,2,10,3,2
1,327,327,38,22,16,2,1
10,336,336,8,8,0,1,0
18,339,339,18,9,9,4,3
7,344,344,51,51,0,1,0
12,404,404,1,1,0,1,0
4,413,413,11,1,10,3,2
3,443,443,13,13,0,1,0
15,496,496,57,7,50,2,1

5,156,156,1,1,0,1,0
13,170,170,6,1,5,2,1
15,182,182,6,1,5,2,1
10,196,196,38,38,0,1,0
12,227,227,24,24,0,1,0
1,298,298,53,53,0,1,0
3,306,306,3,3,0,1,0
6,320,320,40,24,16,2,1
4,328,328,27,27,0,1,0
7,377,377,156,139,17,2,1
9,384,384,40,40,0,1,0
0,398,398,16,16,0,1,0
14,409,409,41,41,0,1,0
8,412,412,113,113,0,1,0
16,415,415,9,2,7,2,1
11,452,452,66,56,10,3,2
2,476,476,69,46,23,3,2

9,110,110,9,3,6,3,2
4,152,152,41,41,0,1,0
2,170,170,5,5,0,1,0
6,182,182,59,47,12,3,2
0,192,192,4,4,0,1,0
7,209,209,20,4,16,3,2
5,241,241,22,10,12,4,3
8,293,293,1,1,0,1,0
14,293,293,19,7,12,4,3
3,297,297,12,6,6,3,2
16,297,297,25,3,22,4,3
15,328,328,116,28,88,3,2
18,352,352,99,99,0,1,0
17,384,384,12,12,0,1,0
13,386,386,11,4,7,2,1
12,387,387,3,3,0,1,0
10,426,426,9,3,6,3,2
1,435,435,21,21,0,1,0
11,460,460,65,45,20,2,1

5,108,108,3,3,0,1,0
7,140,140,27,6,21,4,3
4,155,155,4,4,0,1,0
16,159,159,45,45,0,1,0
0,202,202,9,3,6,2,1
9,240,240,56,56,0,1,0
13,245,245,6,6,0,1,0
3,249,249,36,4,32,4,3
15,257,257,2,2,0,1,0
10,257,257,23,9,14,3,2
2,298,298,15,3,12,4,3
11,346,346,84,84,0,1,0
12,366,366,1,1,0,1,0
1,394,394,45,45,0,1,0
6,411,411,17,1,16,3,2
14,444,444,27,20,7,2,1
17,451,451,104,104,0,1,0
8,470,470,60,60,0,1,0
18,482,482,34,34,0,1,0

3,134,134,25,25,0,1,0
12,158,158,1,1,0,1,0
5,197,197,3,3,0,1,0
7,252,252,49,10,39,2,1
8,313,313,39,39,0,1,0
13,326,326,13,1,12,2,1
2,334,334,4,4,0,1,0
0,338,338,62,26,36,3,2
6,374,374,21,21,0,1,0
1,375,375,53,25,28,2,1
14,387,387,118,118,0,1,0
15,402,402,5,2,3,2,1
4,415,415,37,2,35,3,2
10,441,441,165,18,147,4,3
16,465,465,1,1,0,1,0
17,473,473,9,9,0,1,0
9,477,477,89,89,0,1,0
11,494,494,34,34,0,1,0

3,118,118,29,10,19,2,1
0,119,119,22,22,0,1,0
11,132,132,20,20,0,1,0
9,134,134,17,17,0,1,0
1,149,149,2,2,0,1,0
6,170,170,46,46,0,1,0
4,172,172,26,7,19,2,1
5,180,180,1,1,0,1,0
12,264,264,39,11,28,2,1
13,282,282,71,34,37,4,3
2,287,287,22,7,15,2,1
16,297,297,7,7,0,1,0
14,311,311,4,4,0,1,0
15,318,318,28,28,0,1,0
8,359,359,68,56,12,3,2
10,363,363,8,2,6,2,1
7,495,495,26,9,17,2,1

22,143,143,19,19,0,1,0
18,169,169,22,19,3,2,1
11,188,188,60,60,0,1,0
21,201,201,16,16,0,1,0
9,204,204,10,10,0,1,0
19,205,205,30,18,12,3,2
8,253,253,1,1,0,1,0
3,269,269,18,2,16,3,2
13,271,271,12,3,9,4,3
23,292,292,24,24,0,1,0
14,305,305,1,1,0,1,0
2,312,312,1,1,0,1,0
20,316,316,17,17,0,1,0
15,320,320,41,41,0,1,0
6,336,336,26,7,19,3,2
5,343,343,8,8,0,1,0
16,369,369,64,23,41,2,1
4,375,375,31,31,0,1,0
1,382,382,19,19,0,1,0
17,396,396,36,36,0,1,0
0,411,411,12,12,0,1,0
7,449,449,30,30,0,1,0
12,455,455,39,39,0,1,0
10,460,460,44,44,0,1,0

0,123,123,1,1,0,1,0
8,127,127,4,4,0,1,0
11,130,130,6,1,5,2,1
13,133,133,15,15,0,1,0
12,148,148,9,2,7,2,1
1,174,174,66,66,0,1,0
7,179,179,6,6,0,1,0
2,187,187,10,10,0,1,0
6,218,218,9,9,0,1,0
9,230,230,4,4,0,1,0
14,266,266,58,58,0,1,0
5,275,275,11,11,0,1,0
4,279,279,16,4,12,3,2
15,342,342,122,113,9,2,1
3,479,479,203,195,8,2,1
10,488,488,69,9,60,4,3

7,105,105,2,2,0,1,0
10,183,183,41,7,34,2,1
1,185,185,6,6,0,1,0
8,243,243,25,25,0,1,0
2,260,260,18,18,0,1,0
16,281,281,26,26,0,1,0
3,289,289,10,10,0,1,0
22,292,292,16,12,4,2,1
12,348,348,33,33,0,1,0
13,358,358,78,78,0,1,0
4,359,359,7,1,6,3,2
14,374,374,9,1,8,2,1
6,404,404,10,10,0,1,0
11,409,409,14,14,0,1,0
17,412,412,21,15,6,2,1
0,415,415,27,27,0,1,0
19,418,418,10,10,0,1,0
15,422,422,39,39,0,1,0
21,422,422,44,25,19,2,1
18,442,442,105,105,0,1,0
5,457,457,1,1,0,1,0
20,464,464,156,70,86,3,2
9,468,468,28,28,0,1,0

9,109,109,9,9,0,1,0
3,163,163,16,16,0,1,0
6,170,170,42,42,0,1,0
12,171,171,15,7,8,2,1
17,173,173,23,23,0,1,0
16,179,179,18,18,0,1,0
10,195,195,6,3,3,2,1
14,228,228,16,7,9,2,1
8,238,238,38,38,0,1,0
15,327,327,4,4,0,1,0
1,329,329,13,13,0,1,0
0,362,362,15,1,14,2,1
19,392,392,36,8,28,3,2
11,406,406,12,12,0,1,0
2,433,433,16,16,0,1,0
4,450,450,9,9,0,1,0
18,451,451,51,12,39,4,3
5,462,462,30,30,0,1,0
7,467,467,84,8,76,3,2
13,468,468,175,63,112,4,3

16,105,105,1,1,0,1,0
6,136,136,10,1,9,4,3
11,138,138,20,20,0,1,0
2,152,152,4,1,3,2,1
12,179,179,32,22,10,2,1
1,202,202,54,35,19,2,1
5,231,231,9,9,0,1,0
4,262,262,12,12,0,1,0
3,282,282,56,24,32,2,1
10,316,316,78,64,14,2,1
0,337,337,53,19,34,2,1
14,341,341,58,58,0,1,0
17,359,359,32,32,0,1,0
7,371,371,52,52,0,1,0
15,413,413,25,25,0,1,0
8,438,438,23,23,0,1,0
13,465,465,7,1,6,3,2
9,491,491,47,47,0,1,0

6,122,122,5,5,0,1,0
8,163,163,7,7,0,1,0
13,169,169,1,1,0,1,0
3,177,177,9,9,0,1,0
11,177,177,32,32,0,1,0
1,196,196,2,2,0,1,0
18,201,201,35,2,33,4,3
14,221,221,25,25,0,1,0
12,254,254,11,11,0,1,0
4,265,265,8,8,0,1,0
16,273,273,31,31,0,1,0
2,283,283,27,27,0,1,0
5,305,305,32,5,27,2,1
19,314,314,32,5,27,4,3
7,342,342,10,2,8,3,2
21,350,350,19,19,0,1,0
9,351,351,2,2,0,1,0
22,356,356,53,53,0,1,0
15,364,364,21,21,0,1,0
23,380,380,13,5,8,2,1
10,393,393,61,36,25,4,3
17,398,398,4,1,3,2,1
0,409,409,14,4,10,2,1
24,461,461,117,117,0,1,0
20,488,488,59,59,0,1,0

18,120,120,2,2,0,1,0
15,147,147,41,7,34,2,1
19,159,159,5,1,4,2,1
0,168,168,8,2,6,2,1
3,203,203,6,6,0,1,0
7,236,236,7,2,5,2,1
2,245,245,9,9,0,1,0
1,246,246,7,7,0,1,0
14,262,262,13,4,9,4,3
10,299,299,59,59,0,1,0
8,299,299,4,1,3,2,1
9,347,347,29,29,0,1,0
16,360,360,22,2,20,4,3
13,368,368,52,52,0,1,0
12,383,383,109,39,70,4,3
6,420,420,27,27,0,1,0
4,427,427,137,83,54,4,3
20,472,472,43,7,36,2,1
5,472,472,33,33,0,1,0
11,484,484,39,39,0,1,0
17,485,485,35,35,0,1,0

4,144,144,2,2,0,1,0
8,165,165,1,1,0,1,0
1,210,210,12,2,10,2,1
14,212,212,10,1,9,2,1
15,250,250,25,7,18,2,1
0,264,264,8,1,7,2,1
11,318,318,19,11,8,3,2
10,324,324,39,39,0,1,0
13,327,327,55,13,42,2,1
16,341,341,36,8,28,2,1
2,348,348,107,107,0,1,0
12,399,399,55,55,0,1,0
6,407,407,135,90,45,4,3
9,409,409,48,36,12,4,3
17,427,427,66,6,60,4,3
3,439,439,33,33,0,1,0
5,445,445,37,37,0,1,0
7,470,470,47,40,7,2,1

11,111,111,1,1,0,1,0
13,139,139,8,8,0,1,0
1,144,144,4,4,0,1,0
4,150,150,30,4,26,3,2
14,152,152,51,51,0,1,0
16,184,184,21,21,0,1,0
10,201,201,1,1,0,1,0
7,207,207,4,4,0,1,0
12,211,211,17,6,11,3,2
3,290,290,21,17,4,2,1
6,309,309,9,9,0,1,0
18,321,321,3,3,0,1,0
20,331,331,62,23,39,4,3
15,334,334,25,25,0,1,0
2,334,334,4,4,0,1,0
8,340,340,17,17,0,1,0
9,390,390,74,19,55,4,3
5,412,412,70,70,0,1,0
0,454,454,102,79,23,2,1
17,459,459,43,11,32,2,1
19,467,467,28,13,15,2,1

14,105,105,10,6,4,2,1
16,129,129,10,10,0,1,0
12,140,140,40,11,29,2,1
19,156,156,10,10,0,1,0
18,159,159,4,4,0,1,0
3,179,179,10,10,0,1,0
11,183,183,7,3,4,2,1
6,203,203,4,4,0,1,0
10,249,249,5,5,0,1,0
9,273,273,7,7,0,1,0
13,374,374,18,4,14,2,1
7,381,381,84,2,82,4,3
15,405,405,124,70,54,4,3
17,442,442,37,16,21,2,1
1,444,444,2,2,0,1,0
8,452,452,101,51,50,3,2
2,457,457,86,70,16,3,2
4,467,467,32,32,0,1,0
5,480,480,8,2,6,2,1
0,483,483,76,48,28,2,1

14,112,112,18,10,8,2,1
8,114,114,9,9,0,1,0
10,121,121,25,25,0,1,0
12,180,180,4,4,0,1,0
9,249,249,24,10,14,2,1
5,253,253,93,93,0,1,0
13,257,257,66,18,48,4,3
16,283,283,9,5,4,2,1
4,288,288,73,63,10,2,1
15,317,317,58,58,0,1,0
0,324,324,18,18,0,1,0
11,369,369,28,28,0,1,0
17,374,374,8,8,0,1,0
7,376,376,9,1,8,2,1
18,381,381,24,24,0,1,0
6,406,406,1,1,0,1,0
1,413,413,35,35,0,1,0
3,462,462,6,6,0,1,0
2,477,477,13,4,9,4,3

19,119,119,1,1,0,1,0
4,126,126,3,3,0,1,0
9,141,141,1,1,0,1,0
14,155,155,6,6,0,1,0
6,188,188,11,6,5,2,1
23,196,196,19,14,5,2,1
16,196,196,19,13,6,3,2
0,228,228,46,39,7,2,1
11,244,244,4,4,0,1,0
21,257,257,4,4,0,1,0
3,341,341,23,23,0,1,0
12,343,343,10,10,0,1,0
7,347,347,33,33,0,1,0
13,362,362,10,10,0,1,0
18,375,375,2,2,0,1,0
22,376,376,130,74,56,4,3
5,417,417,83,74,9,4,3
1,432,432,29,29,0,1,0
20,449,449,20,8,12,2,1
10,458,458,47,47,0,1,0
8,459,459,11,3,8,2,1
17,461,461,95,95,0,1,0
15,470,470,92,92,0,1,0
2,483,483,21,21,0,1,0

22,103,103,22,13,9,2,1
14,124,124,10,10,0,1,0
19,124,124,2,2,0,1,0
12,132,132,6,6,0,1,0
3,148,148,11,11,0,1,0
10,159,159,2,2,0,1,0
6,206,206,4,4,0,1,0
1,210,210,10,10,0,1,0
17,223,223,15,15,0,1,0
2,227,227,22,22,0,1,0
13,241,241,37,37,0,1,0
23,263,263,10,10,0,1,0
15,268,268,11,1,10,2,1
5,289,289,8,8,0,1,0
20,292,292,40,16,24,3,2
0,342,342,66,8,58,4,3
16,352,352,42,42,0,1,0
4,354,354,18,18,0,1,0
7,397,397,16,16,0,1,0
18,415,415,134,134,0,1,0
9,435,435,13,13,0,1,0
8,462,462,42,42,0,1,0
21,467,467,32,6,26,3,2
11,482,482,21,3,18,3,2

21,105,105,1,1,0,1,0
2,114,114,7,2,5,2,1
18,126,126,1,1,0,1,0
7,139,139,2,2,0,1,0
15,149,149,24,4,20,3,2
0,151,151,9,9,0,1,0
24,160,160,6,6,0,1,0
12,165,165,1,1,0,1,0
4,166,166,1,1,0,1,0
23,168,168,10,10,0,1,0
11,172,172,6,6,0,1,0
22,189,189,44,44,0,1,0
30,214,214,13,10,3,2,1
17,221,221,6,6,0,1,0
9,240,240,43,30,13,2,1
26,242,242,21,4,17,2,1
3,266,266,6,6,0,1,0
6,306,306,7,7,0,1,0
1,315,315,12,9,3,2,1
27,315,315,62,36,26,4,3
19,337,337,13,13,0,1,0
8,338,338,41,41,0,1,0
5,360,360,13,8,5,2,1
10,382,382,21,21,0,1,0
25,405,405,27,27,0,1,0
14,412,412,4,4,0,1,0
29,447,447,56,56,0,1,0
20,453,453,26,26,0,1,0
13,469,469,5,5,0,1,0
16,488,488,14,14,0,1,0
28,488,488,72,72,0,1,0

15,100,100,12,12,0,1,0
3,101,101,7,2,5,2,1
6,108,108,3,3,0,1,0
0,112,112,7,7,0,1,0
10,112,112,24,7,17,2,1
13,114,114,3,3,0,1,0
17,140,140,6,6,0,1,0
11,151,151,5,2,3,2,1
7,219,219,6,6,0,1,0
9,224,224,6,6,0,1,0
2,260,260,59,50,9,4,3
5,268,268,39,39,0,1,0
16,296,296,1,1,0,1,0
1,307,307,105,18,87,4,3
4,343,343,1,1,0,1,0
18,420,420,5,5,0,1,0
14,434,434,168,76,92,3,2
12,468,468,89,84,5,2,1
8,468,468,33,9,24,3,2

6,102,102,5,5,0,1,0
16,103,103,8,8,0,1,0
23,124,124,5,5,0,1,0
0,148,148,1,1,0,1,0
15,158,158,7,7,0,1,0
4,167,167,1,1,0,1,0
7,212,212,4,4,0,1,0
17,225,225,28,28,0,1,0
18,228,228,18,18,0,1,0
19,242,242,52,34,18,2,1
14,245,245,23,23,0,1,0
9,252,252,8,3,5,2,1
21,257,257,30,23,7,2,1
8,269,269,3,3,0,1,0
20,288,288,45,45,0,1,0
11,308,308,45,45,0,1,0
5,365,365,62,21,41,3,2
12,401,401,12,12,0,1,0
1,402,402,100,79,21,2,1
13,413,413,32,9,23,2,1
3,424,424,4,4,0,1,0
22,429,429,71,50,21,2,1
10,433,433,30,30,0,1,0
2,434,434,15,9,6,2,1

14,100,100,6,6,0,1,0
15,112,112,3,3,0,1,0
10,122,122,8,5,3,2,1
2,197,197,24,24,0,1,0
12,210,210,44,44,0,1,0
18,231,231,7,7,0,1,0
11,231,231,36,7,29,3,2
17,274,274,39,21,18,4,3
19,277,277,36,36,0,1,0
4,299,299,128,90,38,3,2
7,311,311,5,5,0,1,0
9,340,340,11,11,0,1,0
0,343,343,4,4,0,1,0
5,349,349,1,1,0,1,0
1,391,391,31,9,22,3,2
13,410,410,36,8,28,3,2
16,441,441,80,52,28,4,3
3,494,494,98,52,46,2,1
8,495,495,9,6,3,2,1
6,498,498,13,5,8,2,1

5,116,116,1,1,0,1,0
16,150,150,9,4,5,2,1
8,165,165,9,3,6,2,1
14,170,170,8,8,0,1,0
13,187,187,31,31,0,1,0
15,211,211,25,25,0,1,0
2,220,220,42,42,0,1,0
1,256,256,34,34,0,1,0
10,290,290,33,1,32,2,1
4,305,305,3,3,0,1,0
3,313,313,70,34,36,2,1
6,323,323,91,91,0,1,0
7,348,348,10,10,0,1,0
0,381,381,48,48,0,1,0
12,421,421,106,106,0,1,0
11,445,445,44,44,0,1,0
9,483,483,50,50,0,1,0

16,102,102,5,5,0,1,0
1,107,107,5,5,0,1,0
10,136,136,7,4,3,2,1
8,145,145,15,6,9,2,1
14,156,156,2,2,0,1,0
4,178,178,9,9,0,1,0
7,216,216,10,10,0,1,0
3,217,217,3,3,0,1,0
19,218,218,16,3,13,4,3
21,249,249,19,6,13,3,2
17,270,270,19,19,0,1,0
22,276,276,33,4,29,2,1
5,286,286,18,18,0,1,0
6,303,303,8,8,0,1,0
20,314,314,56,56,0,1,0
12,348,348,8,8,0,1,0
2,352,352,15,15,0,1,0
0,401,401,14,14,0,1,0
9,412,412,15,6,9,4,3
23,418,418,14,8,6,3,2
11,419,419,10,7,3,2,1
25,422,422,12,5,7,2,1
18,449,449,72,8,64,3,2
24,467,467,129,31,98,3,2
13,491,491,57,29,28,3,2
15,500,500,134,44,90,3,2

3,124,124,1,1,0,1,0
13,132,132,1,1,0,1,0
6,156,156,2,2,0,1,0
18,179,179,26,19,7,2,1
23,181,181,3,3,0,1,0
1,183,183,21,4,17,2,1
0,207,207,21,21,0,1,0
16,235,235,10,4,6,3,2
25,254,254,22,22,0,1,0
12,255,255,4,4,0,1,0
14,280,280,7,7,0,1,0
7,297,297,33,12,21,4,3
2,320,320,30,30,0,1,0
11,346,346,10,3,7,2,1
5,368,368,3,3,0,1,0
24,380,380,1,1,0,1,0
21,381,381,19,19,0,1,0
22,382,382,181,162,19,4,3
9,407,407,15,15,0,1,0
19,410,410,12,12,0,1,0
10,419,419,53,53,0,1,0
8,420,420,6,6,0,1,0
20,425,425,21,21,0,1,0
4,453,453,98,29,69,4,3
17,469,469,77,62,15,2,1
15,483,483,18,18,0,1,0

2,100,100,15,15,0,1,0
12,107,107,6,1,5,2,1
14,157,157,31,31,0,1,0
6,201,201,18,8,10,2,1
18,216,216,3,3,0,1,0
1,218,218,9,9,0,1,0
17,266,266,10,1,9,4,3
7,275,275,2,2,0,1,0
11,379,379,9,9,0,1,0
15,379,379,57,57,0,1,0
13,388,388,88,42,46,2,1
10,411,411,1,1,0,1,0
3,426,426,30,6,24,3,2
4,434,434,3,3,0,1,0
9,458,458,34,10,24,3,2
16,476,476,111,58,53,3,2
5,481,481,134,110,24,2,1
19,489,489,38,5,33,2,1
0,491,491,134,68,66,4,3
8,498,498,4,4,0,1,0

25,101,101,26,17,9,4,3
14,133,133,10,10,0,1,0
15,140,140,2,2,0,1,0
23,147,147,27,24,3,2,1
21,183,183,14,10,4,2,1
11,184,184,5,5,0,1,0
10,195,195,1,1,0,1,0
3,238,238,9,9,0,1,0
5,244,244,9,9,0,1,0
18,247,247,20,20,0,1,0
16,271,271,7,7,0,1,0
20,302,302,36,36,0,1,0
9,303,303,11,11,0,1,0
0,333,333,2,2,0,1,0
24,347,347,18,18,0,1,0
2,392,392,28,28,0,1,0
4,407,407,36,11,25,2,1
1,419,419,20,20,0,1,0
13,427,427,78,78,0,1,0
19,428,428,82,54,28,3,2
6,444,444,25,15,10,3,2
17,448,448,68,56,12,4,3
8,458,458,32,7,25,2,1
12,470,470,19,19,0,1,0
22,478,478,8,8,0,1,0
26,487,487,17,17,0,1,0
7,491,491,14,14,0,1,0

1,134,134,1,1,0,1,0
4,147,147,17,4,13,2,1
14,167,167,4,1,3,2,1
12,167,167,24,18,6,2,1
8,190,190,35,35,0,1,0
13,217,217,48,48,0,1,0
7,219,219,76,1,75,4,3
16,246,246,24,24,0,1,0
3,248,248,49,49,0,1,0
6,313,313,59,23,36,4,3
0,356,356,10,4,6,3,2
15,361,361,51,9,42,2,1
5,377,377,1,1,0,1,0
2,389,389,44,44,0,1,0
11,390,390,5,5,0,1,0
9,402,402,3,3,0,1,0
10,403,403,77,77,0,1,0

11,134,134,16,16,0,1,0
18,135,135,20,20,0,1,0
7,136,136,11,2,9,4,3
1,162,162,7,2,5,2,1
16,164,164,10,7,3,2,1
9,165,165,14,14,0,1,0
2,174,174,1,1,0,1,0
0,187,187,21,21,0,1,0
10,200,200,35,14,21,4,3
4,209,209,1,1,0,1,0
13,212,212,4,1,3,2,1
12,228,228,99,10,89,4,3
6,235,235,7,4,3,2,1
3,265,265,21,1,20,3,2
8,277,277,36,36,0,1,0
19,309,309,12,12,0,1,0
20,324,324,31,3,28,2,1
5,362,362,51,51,0,1,0
15,449,449,62,23,39,4,3
14,459,459,20,20,0,1,0
17,481,481,20,12,8,3,2

7,128,128,1,1,0,1,0
8,146,146,20,9,11,2,1
3,153,153,16,13,3,2,1
2,172,172,32,22,10,3,2
16,186,186,14,14,0,1,0
11,212,212,12,12,0,1,0
10,229,229,51,15,36,4,3
0,243,243,7,7,0,1,0
6,255,255,19,19,0,1,0
14,287,287,15,15,0,1,0
15,318,318,98,98,0,1,0
18,324,324,5,1,4,2,1
12,338,338,44,18,26,3,2
17,372,372,32,10,22,2,1
13,410,410,30,30,0,1,0
5,422,422,52,52,0,1,0
9,428,428,51,18,33,4,3
1,443,443,15,15,0,1,0
4,450,450,84,61,23,4,3

1,102,102,2,2,0,1,0
2,140,140,3,3,0,1,0
7,151,151,4,4,0,1,0
11,155,155,1,1,0,1,0
16,157,157,50,50,0,1,0
19,167,167,7,7,0,1,0
8,184,184,62,14,48,4,3
18,209,209,8,8,0,1,0
4,260,260,4,4,0,1,0
9,265,265,36,36,0,1,0
6,265,265,15,15,0,1,0
10,298,298,10,6,4,2,1
17,375,375,3,3,0,1,0
12,380,380,72,9,63,4,3
20,381,381,135,135,0,1,0
0,397,397,100,70,30,3,2
15,436,436,22,22,0,1,0
3,441,441,5,2,3,2,1
13,458,458,6,6,0,1,0
14,459,459,2,2,0,1,0
5,464,464,42,34,8,3,2

6,126,126,2,2,0,1,0
0,163,163,23,9,14,3,2
11,192,192,10,10,0,1,0
3,199,199,57,57,0,1,0
4,212,212,29,14,15,2,1
2,232,232,2,2,0,1,0
15,243,243,78,15,63,4,3
8,319,319,39,39,0,1,0
7,320,320,14,14,0,1,0
9,336,336,29,29,0,1,0
1,348,348,75,75,0,1,0
12,350,350,118,70,48,2,1
5,388,388,76,62,14,3,2
13,411,411,13,2,11,3,2
14,450,450,8,8,0,1,0
10,470,470,2,2,0,1,0

8,163,163,11,11,0,1,0
14,209,209,15,15,0,1,0
3,226,226,21,6,15,4,3
1,229,229,4,4,0,1,0
11,252,252,142,1,141,4,3
15,266,266,4,4,0,1,0
6,270,270,5,5,0,1,0
4,288,288,19,6,13,2,1
12,357,357,11,2,9,4,3
16,379,379,27,3,24,3,2
7,398,398,12,12,0,1,0
9,411,411,16,16,0,1,0
13,431,431,55,55,0,1,0
0,445,445,40,40,0,1,0
2,458,458,179,179,0,1,0
10,472,472,16,16,0,1,0
5,487,487,144,144,0,1,0

18,106,106,23,23,0,1,0
2,113,113,6,1,5,2,1
12,125,125,10,2,8,2,1
0,212,212,2,2,0,1,0
17,229,229,49,19,30,4,3
6,231,231,17,5,12,3,2
10,286,286,51,3,48,4,3
4,286,286,23,11,12,3,2
5,292,292,21,12,9,3,2
3,326,326,70,70,0,1,0
15,337,337,46,16,30,3,2
11,348,348,5,5,0,1,0
8,356,356,51,6,45,4,3
14,376,376,15,3,12,4,3
9,440,440,41,41,0,1,0
13,464,464,27,17,10,2,1
16,466,466,35,4,31,2,1
7,481,481,93,73,20,3,2
1,492,492,33,33,0,1,0

8,103,103,17,1,16,2,1
0,129,129,12,12,0,1,0
18,133,133,17,4,13,2,1
6,161,161,4,4,0,1,0
1,165,165,15,15,0,1,0
3,185,185,14,4,10,3,2
13,185,185,11,3,8,3,2
14,248,248,2,2,0,1,0
5,259,259,71,71,0,1,0
11,285,285,15,15,0,1,0
9,299,299,9,9,0,1,0
10,307,307,22,12,10,2,1
16,309,309,14,11,3,2,1
15,315,315,2,2,0,1,0
20,322,322,25,13,12,4,3
12,327,327,6,6,0,1,0
17,383,383,161,145,16,2,1
4,417,417,18,14,4,2,1
2,479,479,19,19,0,1,0
7,483,483,20,12,8,2,1
19,489,489,127,127,0,1,0

11,113,113,3,3,0,1,0
9,127,127,14,14,0,1,0
8,138,138,39,30,9,4,3
3,238,238,43,7,36,3,2
7,246,246,3,3,0,1,0
15,264,264,12,12,0,1,0
13,297,297,50,50,0,1,0
18,345,345,2,2,0,1,0
1,356,356,13,13,0,1,0
17,375,375,17,17,0,1,0
6,376,376,8,3,5,2,1
14,384,384,75,39,36,3,2
0,404,404,71,71,0,1,0
5,408,408,17,17,0,1,0
16,414,414,17,5,12,4,3
2,443,443,22,10,12,3,2
4,469,469,45,14,31,2,1
12,479,479,211,163,48,2,1
10,485,485,23,23,0,1,0

12,106,106,3,3,0,1,0
22,109,109,4,1,3,2,1
19,130,130,12,12,0,1,0
5,136,136,15,15,0,1,0
4,164,164,6,3,3,2,1
1,168,168,9,2,7,2,1
10,173,173,6,3,3,2,1
14,182,182,8,3,5,2,1
7,201,201,1,1,0,1,0
23,216,216,2,2,0,1,0
3,232,232,30,30,0,1,0
17,240,240,37,29,8,3,2
9,249,249,17,17,0,1,0
18,265,265,1,1,0,1,0
21,313,313,8,8,0,1,0
0,331,331,14,14,0,1,0
15,353,353,184,115,69,3,2
8,378,378,67,47,20,2,1
20,396,396,6,6,0,1,0
13,405,405,24,24,0,1,0
16,420,420,69,69,0,1,0
2,465,465,39,39,0,1,0
11,470,470,9,9,0,1,0
6,498,498,56,56,0,1,0

5,121,121,5,5,0,1,0
14,174,174,30,2,28,2,1
0,202,202,18,18,0,1,0
3,217,217,51,39,12,4,3
12,218,218,37,37,0,1,0
9,244,244,19,13,6,2,1
15,253,253,75,75,0,1,0
7,255,255,52,22,30,2,1
6,258,258,1,1,0,1,0
13,263,263,2,2,0,1,0
8,265,265,21,1,20,2,1
16,266,266,37,37,0,1,0
1,318,318,106,106,0,1,0
4,369,369,32,21,11,2,1
11,428,428,28,28,0,1,0
2,428,428,4,4,0,1,0
10,456,456,4,4,0,1,0

14,109,109,6,6,0,1,0
8,132,132,22,11,11,2,1
0,143,143,17,17,0,1,0
2,152,152,13,13,0,1,0
12,185,185,2,2,0,1,0
1,188,188,15,15,0,1,0
9,188,188,2,2,0,1,0
11,204,204,11,11,0,1,0
19,226,226,10,1,9,2,1
4,229,229,11,11,0,1,0
7,240,240,1,1,0,1,0
6,261,261,35,5,30,3,2
3,266,266,28,13,15,2,1
5,267,267,26,26,0,1,0
10,313,313,27,14,13,2,1
20,347,347,47,41,6,3,2
15,359,359,88,44,44,2,1
18,401,401,77,71,6,3,2
13,402,402,10,6,4,2,1
17,426,426,107,107,0,1,0
16,432,432,3,3,0,1,0
21,458,458,25,25,0,1,0

3,101,101,15,11,4,2,1
11,199,199,27,27,0,1,0
17,206,206,44,9,35,2,1
7,210,210,1,1,0,1,0
4,220,220,26,15,11,2,1
13,236,236,3,3,0,1,0
1,245,245,63,16,47,4,3
10,276,276,74,74,0,1,0
2,291,291,9,1,8,2,1
0,322,322,20,4,16,2,1
5,327,327,6,6,0,1,0
14,346,346,5,1,4,2,1
16,376,376,26,26,0,1,0
6,390,390,89,89,0,1,0
15,392,392,76,76,0,1,0
8,404,404,47,47,0,1,0
12,430,430,13,13,0,1,0
9,463,463,8,2,6,2,1
18,479,479,37,8,29,2,1

8,106,106,19,10,9,2,1
9,109,109,4,4,0,1,0
5,145,145,27,13,14,4,3
2,146,146,26,26,0,1,0
13,161,161,6,6,0,1,0
10,164,164,1,1,0,1,0
4,191,191,5,5,0,1,0
0,198,198,1,1,0,1,0
17,236,236,83,1,82,4,3
11,240,240,3,3,0,1,0
16,286,286,13,4,9,2,1
15,295,295,8,8,0,1,0
18,325,325,5,5,0,1,0
6,345,345,11,8,3,2,1
12,399,399,192,124,68,4,3
7,400,400,68,46,22,2,1
1,439,439,28,28,0,1,0
14,479,479,21,3,18,3,2
3,488,488,64,15,49,4,3

7,149,149,11,3,8,3,2
14,171,171,13,1,12,2,1
13,183,183,33,33,0,1,0
11,214,214,30,20,10,2,1
5,228,228,14,6,8,2,1
2,253,253,18,4,14,3,2
6,278,278,44,10,34,3,2
3,279,279,37,11,26,2,1
4,290,290,17,17,0,1,0
9,350,350,16,6,10,3,2
0,359,359,100,79,21,2,1
1,369,369,62,62,0,1,0
16,375,375,130,106,24,4,3
8,383,383,9,9,0,1,0
15,395,395,42,42,0,1,0
10,448,448,25,25,0,1,0
12,480,480,18,18,0,1,0

3,173,173,79,1,78,3,2
5,179,179,3,3,0,1,0
16,185,185,28,12,16,3,2
10,213,213,31,31,0,1,0
4,258,258,32,10,22,3,2
7,313,313,42,42,0,1,0
15,384,384,30,30,0,1,0
8,387,387,48,48,0,1,0
2,387,387,17,4,13,4,3
9,397,397,99,58,41,2,1
14,404,404,11,1,10,3,2
12,429,429,30,16,14,4,3
1,430,430,21,21,0,1,0
6,436,436,45,45,0,1,0
0,492,492,37,18,19,4,3
13,496,496,43,23,20,2,1
11,498,498,40,2,38,3,2

2,110,110,24,3,21,3,2
10,122,122,28,23,5,2,1
7,123,123,1,1,0,1,0
17,151,151,19,19,0,1,0
21,167,167,9,9,0,1,0
0,168,168,3,3,0,1,0
1,184,184,28,7,21,4,3
13,228,228,22,4,18,3,2
6,230,230,1,1,0,1,0
5,269,269,2,2,0,1,0
14,287,287,87,13,74,4,3
8,324,324,12,4,8,3,2
19,344,344,18,18,0,1,0
9,381,381,44,14,30,4,3
15,394,394,74,44,30,3,2
3,396,396,1,1,0,1,0
12,444,444,21,3,18,3,2
22,445,445,5,5,0,1,0
20,451,451,16,6,10,3,2
18,471,471,75,75,0,1,0
4,478,478,5,1,4,2,1
11,488,488,27,5,22,3,2
16,491,491,41,31,10,2,1

15,133,133,22,15,7,2,1
13,164,164,16,1,15,2,1
3,170,170,22,8,14,2,1
17,180,180,5,5,0,1,0
7,269,269,19,19,0,1,0
8,288,288,37,37,0,1,0
10,307,307,16,16,0,1,0
2,315,315,51,6,45,2,1
14,373,373,37,6,31,3,2
11,375,375,40,16,24,2,1
1,377,377,15,15,0,1,0
6,386,386,17,17,0,1,0
4,403,403,148,87,61,4,3
0,406,406,24,10,14,2,1
9,424,424,54,54,0,1,0
16,432,432,83,27,56,4,3
12,435,435,67,57,10,2,1
5,469,469,1,1,0,1,0

13,108,108,4,4,0,1,0
1,121,121,16,4,12,4,3
3,159,159,22,12,10,3,2
6,180,180,54,21,33,2,1
2,213,213,37,37,0,1,0
4,285,285,18,18,0,1,0
12,303,303,5,1,4,2,1
0,308,308,84,35,49,4,3
7,348,348,48,48,0,1,0
10,354,354,71,61,10,3,2
5,384,384,85,85,0,1,0
8,408,408,2,2,0,1,0
11,417,417,127,118,9,2,1
9,443,443,6,3,3,2,1
14,482,482,2,2,0,1,0

11,132,132,27,7,20,2,1
13,146,146,4,4,0,1,0
6,153,153,7,7,0,1,0
17,153,153,35,19,16,3,2
1,174,174,6,6,0,1,0
8,188,188,6,6,0,1,0
14,211,211,8,1,7,2,1
15,225,225,24,10,14,3,2
16,225,225,24,10,14,3,2
9,228,228,28,28,0,1,0
4,333,333,15,15,0,1,0
7,372,372,202,136,66,4,3
5,421,421,34,34,0,1,0
2,475,475,8,8,0,1,0
0,476,476,78,78,0,1,0
3,491,491,19,6,13,3,2
12,495,495,69,57,12,4,3
10,497,497,27,19,8,3,2

14,130,130,12,3,9,2,1
3,132,132,12,12,0,1,0
18,139,139,10,10,0,1,0
17,180,180,36,36,0,1,0
7,231,231,1,1,0,1,0
19,269,269,44,44,0,1,0
11,303,303,26,7,19,2,1
15,314,314,25,25,0,1,0
16,318,318,19,10,9,4,3
2,328,328,43,43,0,1,0
13,360,360,2,2,0,1,0
1,382,382,36,16,20,4,3
5,408,408,42,42,0,1,0
0,415,415,137,137,0,1,0
10,430,430,13,13,0,1,0
8,436,436,50,50,0,1,0
9,438,438,18,18,0,1,0
4,440,440,18,6,12,4,3
6,482,482,10,5,5,2,1
12,488,488,126,126,0,1,0

1,117,117,2,2,0,1,0
13,120,120,8,2,6,3,2
8,139,139,22,22,0,1,0
9,147,147,3,3,0,1,0
18,166,166,11,11,0,1,0
3,170,170,8,8,0,1,0
6,197,197,4,4,0,1,0
21,208,208,43,19,24,4,3
15,209,209,15,15,0,1,0
10,243,243,2,2,0,1,0
19,269,269,7,7,0,1,0
5,277,277,6,6,0,1,0
24,285,285,13,13,0,1,0
23,291,291,15,7,8,3,2
25,292,292,75,60,15,2,1
0,304,304,9,3,6,3,2
20,329,329,3,3,0,1,0
22,347,347,49,49,0,1,0
11,356,356,18,6,12,3,2
16,364,364,13,3,10,4,3
17,368,368,78,11,67,3,2
14,384,384,32,32,0,1,0
2,400,400,12,6,6,2,1
12,421,421,9,1,8,2,1
7,430,430,115,83,32,3,2
4,441,441,23,1,22,2,1

0,102,102,29,29,0,1,0
9,111,111,44,18,26,3,2
4,121,121,9,9,0,1,0
11,136,136,3,3,0,1,0
10,168,168,7,1,6,3,2
13,203,203,10,10,0,1,0
14,211,211,2,2,0,1,0
12,263,263,8,8,0,1,0
2,286,286,35,35,0,1,0
7,310,310,6,2,4,2,1
5,332,332,57,57,0,1,0
6,362,362,34,34,0,1,0
3,402,402,82,82,0,1,0
1,438,438,63,63,0,1,0
8,449,449,161,95,66,4,3

0,124,124,25,25,0,1,0
9,126,126,15,15,0,1,0
13,134,134,12,6,6,3,2
1,137,137,13,13,0,1,0
6,158,158,24,24,0,1,0
2,172,172,1,1,0,1,0
4,175,175,3,3,0,1,0
15,199,199,45,20,25,2,1
8,206,206,23,2,21,4,3
11,229,229,41,41,0,1,0
12,230,230,1,1,0,1,0
7,248,248,26,2,24,4,3
10,273,273,4,4,0,1,0
3,344,344,130,50,80,3,2
16,368,368,61,61,0,1,0
5,428,428,21,7,14,3,2
14,454,454,51,30,21,4,3

5,112,112,12,12,0,1,0
7,153,153,13,1,12,2,1
20,153,153,9,4,5,2,1
11,170,170,4,1,3,2,1
17,178,178,2,2,0,1,0
14,188,188,10,3,7,2,1
1,230,230,1,1,0,1,0
6,260,260,11,11,0,1,0
3,264,264,2,2,0,1,0
10,339,339,29,20,9,2,1
13,341,341,59,1,58,3,2
19,363,363,45,45,0,1,0
12,364,364,9,3,6,2,1
2,373,373,35,35,0,1,0
9,392,392,123,91,32,2,1
0,417,417,32,10,22,3,2
18,425,425,171,149,22,2,1
15,433,433,7,7,0,1,0
16,450,450,72,44,28,3,2
8,465,465,61,61,0,1,0
4,500,500,15,6,9,2,1

0,100,100,7,1,6,2,1
6,150,150,26,26,0,1,0
21,155,155,30,3,27,4,3
10,158,158,2,2,0,1,0
4,163,163,8,8,0,1,0
11,204,204,45,45,0,1,0
22,208,208,31,11,20,2,1
1,231,231,13,13,0,1,0
7,238,238,32,32,0,1,0
17,247,247,1,1,0,1,0
13,261,261,4,1,3,2,1
23,267,267,28,19,9,4,3
19,294,294,52,52,0,1,0
20,307,307,23,13,10,3,2
14,329,329,29,29,0,1,0
18,340,340,39,28,11,2,1
5,344,344,21,21,0,1,0
9,347,347,3,3,0,1,0
16,348,348,48,48,0,1,0
15,395,395,24,10,14,3,2
2,421,421,25,10,15,4,3
8,434,434,1,1,0,1,0
12,491,491,18,13,5,2,1
3,493,493,6,3,3,2,1

15,101,101,5,5,0,1,0
13,128,128,13,7,6,2,1
11,178,178,37,37,0,1,0
0,210,210,44,37,7,2,1
7,211,211,25,25,0,1,0
1,239,239,1,1,0,1,0
17,261,261,32,10,22,3,2
9,269,269,5,5,0,1,0
18,318,318,11,11,0,1,0
4,337,337,64,64,0,1,0
8,349,349,33,17,16,2,1
10,401,401,4,4,0,1,0
16,423,423,110,85,25,3,2
2,425,425,3,3,0,1,0
6,433,433,80,48,32,3,2
3,435,435,6,1,5,2,1
14,447,447,53,32,21,4,3
5,462,462,75,29,46,3,2
12,462,462,57,13,44,3,2

8,105,105,33,33,0,1,0
15,139,139,3,3,0,1,0
18,143,143,7,7,0,1,0
5,178,178,7,1,6,2,1
10,209,209,10,3,7,2,1
3,218,218,31,21,10,3,2
4,268,268,1,1,0,1,0
13,278,278,20,20,0,1,0
14,279,279,13,13,0,1,0
19,324,324,39,39,0,1,0
1,331,331,23,14,9,4,3
11,336,336,34,1,33,4,3
9,342,342,67,24,43,4,3
0,370,370,60,12,48,4,3
12,446,446,136,115,21,2,1
7,454,454,2,2,0,1,0
6,475,475,1,1,0,1,0
2,475,475,10,10,0,1,0
17,475,475,113,80,33,4,3
16,478,478,31,18,13,2,1

22,104,104,3,3,0,1,0
16,109,109,2,2,0,1,0
10,134,134,31,31,0,1,0
3,190,190,5,5,0,1,0
5,203,203,15,15,0,1,0
15,233,233,5,5,0,1,0
14,234,234,7,7,0,1,0
2,244,244,3,3,0,1,0
12,252,252,5,1,4,2,1
23,269,269,33,33,0,1,0
13,276,276,30,30,0,1,0
25,287,287,32,10,22,3,2
19,302,302,24,3,21,4,3
24,312,312,86,75,11,2,1
1,328,328,20,20,0,1,0
6,347,347,102,74,28,2,1
8,362,362,10,10,0,1,0
7,428,428,7,3,4,2,1
21,432,432,68,59,9,4,3
18,436,436,46,46,0,1,0
0,444,444,6,6,0,1,0
11,446,446,15,15,0,1,0
17,446,446,57,17,40,2,1
4,482,482,5,5,0,1,0
9,500,500,2,2,0,1,0
20,500,500,3,3,0,1,0

18,104,104,3,3,0,1,0
10,109,109,4,4,0,1,0
16,113,113,3,3,0,1,0
20,125,125,1,1,0,1,0
9,137,137,14,14,0,1,0
4,193,193,1,1,0,1,0
2,207,207,2,2,0,1,0
8,220,220,1,1,0,1,0
14,226,226,47,9,38,2,1
22,238,238,2,2,0,1,0
6,245,245,18,18,0,1,0
15,259,259,66,21,45,4,3
17,262,262,11,5,6,2,1
1,285,285,5,5,0,1,0
21,303,303,114,44,70,3,2
12,333,333,14,10,4,2,1
13,344,344,13,13,0,1,0
19,345,345,28,28,0,1,0
7,394,394,3,3,0,1,0
5,447,447,132,2,130,4,3
0,472,472,36,36,0,1,0
3,475,475,20,3,17,2,1
11,481,481,121,88,33,4,3

7,138,138,19,19,0,1,0
10,228,228,27,27,0,1,0
3,258,258,61,61,0,1,0
2,260,260,71,71,0,1,0
4,264,264,61,57,4,2,1
14,283,283,1,1,0,1,0
15,289,289,10,1,9,4,3
8,324,324,118,118,0,1,0
0,326,326,11,11,0,1,0
13,359,359,45,9,36,3,2
9,380,380,44,7,37,2,1
11,381,381,1,1,0,1,0
1,446,446,46,46,0,1,0
12,476,476,56,56,0,1,0
5,483,483,12,2,10,2,1
6,497,497,49,17,32,3,2

16,114,114,22,7,15,4,3
2,116,116,10,10,0,1,0
8,148,148,2,2,0,1,0
7,149,149,8,1,7,2,1
6,178,178,32,24,8,3,2
15,181,181,39,25,14,2,1
3,235,235,17,17,0,1,0
4,245,245,81,31,50,2,1
0,292,292,34,34,0,1,0
13,293,293,9,2,7,3,2
1,312,312,15,15,0,1,0
12,375,375,19,16,3,2,1
17,381,381,65,65,0,1,0
10,415,415,37,37,0,1,0
18,450,450,70,70,0,1,0
14,474,474,15,15,0,1,0
11,478,478,35,35,0,1,0
5,482,482,24,5,19,2,1
9,491,491,25,25,0,1,0

14,107,107,11,2,9,2,1
8,125,125,2,2,0,1,0
7,128,128,26,26,0,1,0
2,177,177,18,18,0,1,0
3,178,178,15,15,0,1,0
18,193,193,31,31,0,1,0
1,199,199,12,12,0,1,0
9,209,209,42,18,24,3,2
13,230,230,13,5,8,3,2
4,263,263,6,6,0,1,0
16,285,285,20,6,14,2,1
6,297,297,1,1,0,1,0
0,348,348,86,86,0,1,0
19,367,367,18,18,0,1,0
15,379,379,142,115,27,2,1
10,393,393,1,1,0,1,0
17,401,401,10,10,0,1,0
5,432,432,16,16,0,1,0
11,463,463,10,4,6,3,2
12,484,484,55,34,21,2,1
20,495,495,33,1,32,3,2

17,119,119,13,13,0,1,0
9,127,127,8,8,0,1,0
15,164,164,19,3,16,3,2
8,165,165,7,4,3,2,1
16,195,195,6,2,4,2,1
3,222,222,1,1,0,1,0
11,229,229,6,6,0,1,0
6,250,250,71,64,7,2,1
5,251,251,2,2,0,1,0
1,267,267,20,20,0,1,0
4,280,280,20,20,0,1,0
10,295,295,31,31,0,1,0
0,317,317,69,54,15,4,3
14,321,321,74,10,64,4,3
18,368,368,28,28,0,1,0
20,411,411,15,3,12,2,1
12,422,422,126,36,90,4,3
13,432,432,32,4,28,3,2
7,459,459,24,24,0,1,0
19,463,463,24,24,0,1,0
2,470,470,24,2,22,3,2

2,116,116,47,47,0,1,0
10,154,154,21,21,0,1,0
7,174,174,21,3,18,4,3
0,234,234,3,3,0,1,0
9,238,238,21,8,13,2,1
5,300,300,14,5,9,2,1
3,305,305,50,50,0,1,0
13,319,319,110,85,25,2,1
1,345,345,143,143,0,1,0
11,395,395,27,21,6,2,1
8,446,446,55,55,0,1,0
4,459,459,2,2,0,1,0
6,471,471,10,10,0,1,0
12,480,480,32,7,25,4,3

0,140,140,3,3,0,1,0
7,212,212,13,7,6,3,2
5,218,218,41,1,40,3,2
11,226,226,19,19,0,1,0
1,244,244,3,3,0,1,0
10,258,258,2,2,0,1,0
17,294,294,9,1,8,2,1
2,358,358,6,6,0,1,0
16,360,360,35,35,0,1,0
4,376,376,107,44,63,4,3
12,394,394,170,107,63,4,3
14,412,412,5,5,0,1,0
15,434,434,73,31,42,3,2
9,448,448,30,7,23,3,2
13,463,463,48,48,0,1,0
18,476,476,36,36,0,1,0
3,477,477,31,25,6,3,2
8,479,479,30,30,0,1,0
6,484,484,107,89,18,4,3

10,106,106,2,2,0,1,0
9,111,111,11,11,0,1,0
0,119,119,3,3,0,1,0
8,128,128,1,1,0,1,0
5,160,160,5,5,0,1,0
13,239,239,59,21,38,3,2
16,253,253,31,31,0,1,0
2,266,266,1,1,0,1,0
18,279,279,11,11,0,1,0
17,280,280,82,6,76,4,3
7,297,297,105,9,96,3,2
11,297,297,5,2,3,2,1
6,312,312,29,29,0,1,0
19,318,318,23,23,0,1,0
4,353,353,11,11,0,1,0
14,383,383,61,61,0,1,0
12,398,398,18,12,6,3,2
3,453,453,114,66,48,4,3
15,464,464,8,8,0,1,0
1,469,469,43,43,0,1,0

13,134,134,8,8,0,1,0
4,137,137,9,9,0,1,0
14,154,154,5,5,0,1,0
7,193,193,2,2,0,1,0
3,215,215,20,8,12,3,2
2,231,231,12,12,0,1,0
11,237,237,26,26,0,1,0
1,247,247,7,7,0,1,0
5,247,247,18,18,0,1,0
12,253,253,29,29,0,1,0
8,259,259,28,14,14,3,2
17,263,263,16,4,12,2,1
0,284,284,38,38,0,1,0
10,295,295,92,92,0,1,0
16,298,298,7,7,0,1,0
9,380,380,134,134,0,1,0
15,417,417,109,7,102,4,3
6,479,479,41,41,0,1,0
18,492,492,22,7,15,2,1

4,129,129,6,6,0,1,0
14,182,182,23,23,0,1,0
7,219,219,56,56,0,1,0
3,295,295,99,19,80,4,3
13,302,302,13,9,4,2,1
8,360,360,18,18,0,1,0
2,372,372,76,61,15,4,3
5,388,388,63,63,0,1,0
6,388,388,66,51,15,2,1
0,418,418,25,25,0,1,0
1,418,418,81,77,4,2,1
9,443,443,93,67,26,3,2
12,445,445,16,6,10,3,2
11,450,450,45,3,42,2,1
10,471,471,10,10,0,1,0

3,104,104,8,3,5,2,1
15,104,104,14,14,0,1,0
17,109,109,36,36,0,1,0
12,115,115,17,17,0,1,0
2,123,123,4,4,0,1,0
10,132,132,1,1,0,1,0
18,135,135,2,2,0,1,0
13,135,135,1,1,0,1,0
9,151,151,9,9,0,1,0
19,219,219,31,31,0,1,0
4,226,226,4,4,0,1,0
1,229,229,9,9,0,1,0
8,238,238,21,2,19,3,2
6,241,241,47,47,0,1,0
16,261,261,25,25,0,1,0
14,294,294,17,4,13,2,1
7,373,373,1,1,0,1,0
20,386,386,54,6,48,2,1
11,396,396,54,14,40,3,2
5,409,409,51,51,0,1,0
21,418,418,7,7,0,1,0
0,491,491,33,11,22,3,2
22,491,491,47,37,10,3,2

17,116,116,4,4,0,1,0
0,139,139,4,4,0,1,0
19,155,155,20,8,12,3,2
18,269,269,7,7,0,1,0
9,283,283,26,17,9,4,3
13,348,348,6,6,0,1,0
5,354,354,54,54,0,1,0
10,355,355,14,5,9,2,1
12,358,358,122,122,0,1,0
4,360,360,3,3,0,1,0
1,363,363,46,46,0,1,0
3,376,376,24,24,0,1,0
7,376,376,9,9,0,1,0
20,400,400,18,18,0,1,0
8,457,457,9,9,0,1,0
2,457,457,103,67,36,3,2
14,488,488,106,78,28,4,3
11,488,488,9,9,0,1,0
15,496,496,80,62,18,3,2
16,498,498,21,21,0,1,0
6,499,499,101,11,90,3,2

8,117,117,15,15,0,1,0
6,138,138,8,8,0,1,0
3,195,195,134,134,0,1,0
4,215,215,16,13,3,2,1
12,259,259,72,35,37,2,1
11,261,261,48,20,28,2,1
1,304,304,3,3,0,1,0
5,311,311,28,28,0,1,0
13,313,313,24,9,15,2,1
7,338,338,26,26,0,1,0
10,350,350,2,2,0,1,0
9,372,372,44,44,0,1,0
0,402,402,18,18,0,1,0
2,432,432,80,51,29,3,2

4,104,104,3,3,0,1,0
3,109,109,12,12,0,1,0
1,121,121,9,9,0,1,0
20,157,157,1,1,0,1,0
16,161,161,13,4,9,2,1
10,187,187,3,3,0,1,0
23,210,210,13,13,0,1,0
0,229,229,1,1,0,1,0
18,236,236,24,14,10,4,3
19,244,244,60,24,36,2,1
7,271,271,26,26,0,1,0
8,293,293,17,17,0,1,0
15,301,301,107,107,0,1,0
2,316,316,11,4,7,2,1
9,372,372,68,68,0,1,0
22,398,398,4,4,0,1,0
17,405,405,53,37,16,3,2
11,430,430,33,33,0,1,0
6,432,432,42,30,12,2,1
21,432,432,9,9,0,1,0
13,434,434,40,40,0,1,0
12,473,473,7,2,5,2,1
5,480,480,29,25,4,2,1
14,489,489,27,27,0,1,0

14,125,125,3,3,0,1,0
4,126,126,18,18,0,1,0
15,180,180,19,11,8,3,2
16,182,182,27,27,0,1,0
0,189,189,25,25,0,1,0
18,202,202,17,17,0,1,0
12,245,245,18,11,7,2,1
2,276,276,17,9,8,3,2
3,294,294,20,5,15,3,2
11,301,301,10,1,9,2,1
21,313,313,25,25,0,1,0
8,319,319,34,34,0,1,0
6,330,330,18,12,6,2,1
13,369,369,63,63,0,1,0
9,374,374,34,34,0,1,0
5,394,394,1,1,0,1,0
19,441,441,121,9,112,4,3
20,466,466,33,33,0,1,0
7,468,468,48,23,25,2,1
1,476,476,48,48,0,1,0
17,476,476,31,31,0,1,0
10,490,490,16,16,0,1,0

6,146,146,27,6,21,4,3
11,195,195,31,12,19,2,1
16,216,216,37,37,0,1,0
15,222,222,23,13,10,3,2
14,225,225,9,9,0,1,0
10,241,241,55,32,23,3,2
9,282,282,8,8,0,1,0
4,290,290,6,6,0,1,0
8,296,296,1,1,0,1,0
7,299,299,103,59,44,3,2
0,324,324,25,7,18,2,1
1,355,355,69,48,21,2,1
3,361,361,24,8,16,3,2
2,370,370,2,2,0,1,0
12,411,411,51,13,38,4,3
18,422,422,12,12,0,1,0
13,472,472,51,37,14,3,2
5,489,489,37,5,32,3,2
17,490,490,28,28,0,1,0

8,118,118,1,1,0,1,0
23,133,133,2,2,0,1,0
0,139,139,6,2,4,2,1
16,198,198,21,21,0,1,0
2,199,199,2,2,0,1,0
22,211,211,32,24,8,2,1
3,213,213,1,1,0,1,0
14,215,215,52,52,0,1,0
11,283,283,9,3,6,2,1
18,289,289,19,19,0,1,0
21,296,296,7,7,0,1,0
20,298,298,54,54,0,1,0
5,300,300,21,21,0,1,0
17,301,301,15,10,5,2,1
7,309,309,16,12,4,2,1
12,334,334,14,10,4,2,1
13,399,399,6,6,0,1,0
15,408,408,17,1,16,2,1
4,430,430,7,7,0,1,0
10,432,432,27,11,16,3,2
9,434,434,7,7,0,1,0
6,455,455,31,20,11,2,1
19,461,461,176,156,20,2,1
1,466,466,150,69,81,4,3

1,105,105,3,3,0,1,0
5,107,107,1,1,0,1,0
17,111,111,2,2,0,1,0
14,111,111,1,1,0,1,0
22,127,127,4,4,0,1,0
13,145,145,12,12,0,1,0
11,153,153,16,9,7,2,1
26,159,159,21,7,14,2,1
23,171,171,2,2,0,1,0
3,182,182,1,1,0,1,0
10,204,204,17,8,9,2,1
24,221,221,70,4,66,4,3
15,238,238,30,5,25,4,3
7,243,243,21,3,18,4,3
20,247,247,59,59,0,1,0
18,267,267,1,1,0,1,0
25,288,288,38,29,9,4,3
21,290,290,42,42,0,1,0
16,293,293,42,25,17,2,1
9,298,298,17,17,0,1,0
8,328,328,28,2,26,2,1
4,351,351,21,15,6,3,2
6,362,362,16,16,0,1,0
12,381,381,15,15,0,1,0
2,460,460,8,2,6,3,2
0,490,490,2,2,0,1,0
19,498,498,5,5,0,1,0

6,127,127,22,11,11,2,1
5,130,130,33,33,0,1,0
11,138,138,18,7,11,2,1
1,191,191,22,12,10,3,2
13,214,214,11,11,0,1,0
2,228,228,25,13,12,4,3
15,243,243,22,22,0,1,0
9,348,348,4,4,0,1,0
7,355,355,106,94,12,2,1
4,359,359,80,41,39,4,3
12,365,365,2,2,0,1,0
8,385,385,26,26,0,1,0
3,397,397,5,2,3,2,1
0,422,422,49,49,0,1,0
10,435,435,21,15,6,2,1
14,465,465,145,7,138,4,3

7,115,115,13,1,12,4,3
8,152,152,26,26,0,1,0
11,154,154,4,4,0,1,0
0,195,195,75,75,0,1,0
10,198,198,9,3,6,3,2
9,255,255,9,1,8,2,1
5,280,280,82,82,0,1,0
6,314,314,4,4,0,1,0
2,353,353,22,22,0,1,0
4,372,372,63,63,0,1,0
3,385,385,62,62,0,1,0
1,407,407,226,154,72,3,2

13,122,122,4,1,3,2,1
6,124,124,7,2,5,2,1
8,142,142,9,4,5,2,1
1,247,247,24,9,15,2,1
7,247,247,50,50,0,1,0
5,263,263,65,26,39,4,3
4,299,299,17,17,0,1,0
10,391,391,29,1,28,2,1
11,391,391,107,107,0,1,0
15,397,397,2,2,0,1,0
12,400,400,22,10,12,4,3
3,416,416,26,14,12,4,3
14,416,416,93,93,0,1,0
9,421,421,38,38,0,1,0
0,439,439,27,27,0,1,0
2,485,485,205,205,0,1,0

1,117,117,14,2,12,2,1
14,144,144,33,21,12,2,1
6,150,150,2,2,0,1,0
11,170,170,18,7,11,2,1
12,188,188,25,25,0,1,0
4,209,209,1,1,0,1,0
0,251,251,53,53,0,1,0
13,261,261,5,1,4,2,1
2,370,370,51,17,34,2,1
10,370,370,9,3,6,2,1
8,383,383,18,18,0,1,0
9,404,404,36,3,33,2,1
3,414,414,206,103,103,4,3
5,425,425,13,5,8,3,2
7,453,453,163,96,67,3,2

7,106,106,2,2,0,1,0
22,112,112,3,3,0,1,0
10,117,117,8,4,4,2,1
2,152,152,10,10,0,1,0
20,218,218,11,11,0,1,0
21,249,249,19,15,4,2,1
17,253,253,5,5,0,1,0
13,263,263,23,6,17,2,1
14,269,269,57,57,0,1,0
4,287,287,12,12,0,1,0
9,298,298,24,24,0,1,0
18,306,306,15,15,0,1,0
8,309,309,1,1,0,1,0
3,312,312,15,15,0,1,0
5,314,314,1,1,0,1,0
19,324,324,155,104,51,3,2
11,339,339,29,25,4,2,1
12,407,407,15,5,10,2,1
23,414,414,7,7,0,1,0
1,417,417,80,33,47,2,1
15,424,424,113,113,0,1,0
6,439,439,11,11,0,1,0
0,451,451,15,7,8,2,1
16,482,482,18,18,0,1,0

7,126,126,6,6,0,1,0
16,134,134,27,21,6,3,2
3,181,181,16,16,0,1,0
12,185,185,27,17,10,3,2
9,198,198,9,9,0,1,0
22,219,219,8,2,6,2,1
13,235,235,10,4,6,3,2
8,241,241,27,8,19,3,2
1,246,246,8,8,0,1,0
17,276,276,39,32,7,2,1
0,303,303,60,42,18,2,1
2,326,326,13,7,6,2,1
4,355,355,11,11,0,1,0
20,356,356,19,9,10,3,2
15,360,360,69,55,14,4,3
21,369,369,67,67,0,1,0
5,422,422,5,5,0,1,0
19,422,422,39,15,24,4,3
6,425,425,1,1,0,1,0
18,441,441,35,4,31,4,3
11,442,442,43,43,0,1,0
14,448,448,16,6,10,3,2
10,478,478,51,42,9,4,3

3,102,102,5,5,0,1,0
15,127,127,4,4,0,1,0
11,127,127,2,2,0,1,0
0,131,131,17,17,0,1,0
8,140,140,28,28,0,1,0
10,145,145,22,16,6,2,1
5,152,152,7,7,0,1,0
13,166,166,27,27,0,1,0
14,167,167,4,4,0,1,0
1,183,183,4,4,0,1,0
16,196,196,5,5,0,1,0
7,340,340,146,146,0,1,0
2,359,359,50,50,0,1,0
4,388,388,43,15,28,3,2
6,412,412,31,31,0,1,0
12,447,447,82,73,9,4,3
9,494,494,115,91,24,2,1

10,113,113,4,4,0,1,0
20,118,118,5,2,3,2,1
12,143,143,2,2,0,1,0
8,178,178,13,13,0,1,0
16,183,183,11,4,7,2,1
2,186,186,12,2,10,3,2
19,195,195,45,45,0,1,0
11,204,204,10,6,4,2,1
3,223,223,4,4,0,1,0
5,228,228,15,2,13,2,1
13,235,235,48,4,44,3,2
7,240,240,44,44,0,1,0
6,306,306,4,4,0,1,0
17,348,348,5,5,0,1,0
14,401,401,36,36,0,1,0
15,402,402,6,6,0,1,0
9,404,404,79,17,62,3,2
1,460,460,8,2,6,2,1
4,461,461,48,48,0,1,0
21,466,466,14,14,0,1,0
18,478,478,161,68,93,4,3
0,482,482,83,26,57,3,2

12,116,116,23,23,0,1,0
6,125,125,15,15,0,1,0
9,128,128,23,23,0,1,0
7,144,144,2,2,0,1,0
16,187,187,3,3,0,1,0
8,204,204,29,1,28,3,2
17,224,224,3,3,0,1,0
1,247,247,11,1,10,2,1
18,326,326,23,23,0,1,0
15,328,328,90,70,20,3,2
3,335,335,13,13,0,1,0
2,349,349,5,2,3,2,1
0,364,364,17,17,0,1,0
14,381,381,3,3,0,1,0
13,386,386,58,52,6,3,2
5,414,414,79,50,29,2,1
11,419,419,32,32,0,1,0
4,435,435,94,36,58,3,2
10,471,471,99,99,0,1,0

14,128,128,16,16,0,1,0
5,167,167,8,8,0,1,0
0,171,171,16,16,0,1,0
9,179,179,11,11,0,1,0
15,188,188,26,6,20,3,2
11,191,191,8,5,3,2,1
19,207,207,28,28,0,1,0
1,257,257,6,6,0,1,0
12,258,258,31,17,14,3,2
17,269,269,7,7,0,1,0
20,285,285,10,10,0,1,0
7,287,287,32,32,0,1,0
18,292,292,7,7,0,1,0
10,301,301,1,1,0,1,0
3,311,311,11,11,0,1,0
22,314,314,5,5,0,1,0
21,338,338,97,4,93,4,3
4,395,395,28,7,21,4,3
23,399,399,98,85,13,2,1
8,413,413,5,5,0,1,0
2,422,422,10,10,0,1,0
16,431,431,46,17,29,4,3
13,449,449,88,55,33,2,1
6,463,463,18,18,0,1,0

3,103,103,2,2,0,1,0
1,129,129,6,1,5,2,1
18,139,139,14,5,9,2,1
9,184,184,58,24,34,3,2
19,186,186,44,10,34,4,3
2,197,197,6,6,0,1,0
17,207,207,97,97,0,1,0
10,249,249,14,14,0,1,0
12,259,259,9,9,0,1,0
7,287,287,2,2,0,1,0
13,289,289,12,12,0,1,0
20,301,301,6,6,0,1,0
0,326,326,24,24,0,1,0
14,418,418,15,15,0,1,0
11,432,432,56,28,28,3,2
16,456,456,30,30,0,1,0
8,464,464,35,2,33,4,3
5,466,466,38,38,0,1,0
15,471,471,9,9,0,1,0
6,487,487,43,7,36,4,3
4,499,499,39,39,0,1,0

4,103,103,9,1,8,2,1
5,106,106,2,2,0,1,0
8,131,131,21,21,0,1,0
14,135,135,9,1,8,3,2
9,150,150,15,12,3,2,1
19,180,180,19,19,0,1,0
0,185,185,27,8,19,4,3
20,186,186,8,4,4,2,1
11,190,190,25,4,21,4,3
12,229,229,14,14,0,1,0
16,230,230,59,59,0,1,0
10,260,260,13,13,0,1,0
15,272,272,15,5,10,2,1
7,306,306,4,4,0,1,0
17,308,308,52,22,30,2,1
21,309,309,3,3,0,1,0
3,309,309,6,3,3,2,1
6,313,313,4,4,0,1,0
13,351,351,46,1,45,4,3
2,393,393,16,16,0,1,0
1,403,403,65,52,13,2,1
18,412,412,75,29,46,4,3

2,103,103,7,7,0,1,0
13,113,113,2,2,0,1,0
8,122,122,4,4,0,1,0
7,176,176,11,11,0,1,0
0,191,191,5,5,0,1,0
10,197,197,89,21,68,3,2
12,211,211,19,7,12,4,3
5,238,238,5,5,0,1,0
15,245,245,2,2,0,1,0
14,388,388,5,5,0,1,0
16,389,389,28,7,21,2,1
4,395,395,81,15,66,3,2
11,441,441,131,59,72,4,3
3,458,458,123,104,19,4,3
6,474,474,45,31,14,3,2
1,484,484,125,125,0,1,0
9,492,492,18,10,8,2,1

9,154,154,4,4,0,1,0
3,170,170,11,11,0,1,0
6,190,190,6,6,0,1,0
12,202,202,19,3,16,3,2
5,203,203,9,5,4,2,1
10,221,221,1,1,0,1,0
17,245,245,44,44,0,1,0
0,261,261,20,1,19,2,1
19,263,263,27,9,18,3,2
8,273,273,28,14,14,2,1
4,289,289,77,77,0,1,0
13,309,309,45,38,7,2,1
7,312,312,22,17,5,2,1
16,325,325,22,4,18,3,2
20,328,328,28,20,8,2,1
14,330,330,61,61,0,1,0
2,331,331,56,56,0,1,0
15,370,370,20,13,7,2,1
1,398,398,11,11,0,1,0
11,417,417,10,10,0,1,0
18,485,485,83,65,18,4,3
21,500,500,10,6,4,2,1

0,189,189,4,4,0,1,0
18,209,209,7,1,6,2,1
12,225,225,7,1,6,3,2
17,232,232,4,1,3,2,1
1,244,244,6,6,0,1,0
15,253,253,79,79,0,1,0
20,261,261,59,11,48,4,3
9,290,290,29,11,18,2,1
13,305,305,53,25,28,3,2
2,306,306,10,6,4,2,1
5,307,307,23,11,12,3,2
21,313,313,40,40,0,1,0
3,323,323,6,6,0,1,0
8,339,339,42,42,0,1,0
4,357,357,117,117,0,1,0
16,365,365,7,7,0,1,0
19,377,377,30,9,21,2,1
6,378,378,16,16,0,1,0
11,412,412,13,1,12,2,1
7,422,422,31,31,0,1,0
10,438,438,43,43,0,1,0
14,490,490,11,11,0,1,0

2,109,109,22,15,7,2,1
15,123,123,20,20,0,1,0
16,179,179,8,8,0,1,0
11,207,207,20,6,14,3,2
7,235,235,35,35,0,1,0
13,262,262,63,23,40,3,2
12,267,267,22,22,0,1,0
8,270,270,5,5,0,1,0
4,272,272,12,12,0,1,0
10,307,307,14,14,0,1,0
5,307,307,46,16,30,3,2
6,341,341,55,55,0,1,0
14,347,347,74,4,70,3,2
0,353,353,77,77,0,1,0
3,403,403,10,10,0,1,0
1,445,445,23,5,18,3,2
9,451,451,54,54,0,1,0

1,116,116,2,2,0,1,0
26,136,136,27,27,0,1,0
28,166,166,11,11,0,1,0
5,167,167,1,1,0,1,0
19,168,168,12,12,0,1,0
14,183,183,31,31,0,1,0
10,195,195,9,9,0,1,0
7,206,206,6,6,0,1,0
9,207,207,47,47,0,1,0
21,209,209,13,1,12,3,2
8,211,211,2,2,0,1,0
23,217,217,2,2,0,1,0
18,252,252,13,13,0,1,0
17,266,266,1,1,0,1,0
20,275,275,121,1,120,4,3
4,308,308,3,3,0,1,0
15,313,313,2,2,0,1,0
2,349,349,9,9,0,1,0
0,360,360,23,23,0,1,0
16,365,365,22,2,20,4,3
12,374,374,6,6,0,1,0
25,388,388,14,14,0,1,0
13,398,398,9,9,0,1,0
22,410,410,29,20,9,4,3
24,420,420,28,28,0,1,0
6,479,479,18,18,0,1,0
27,480,480,34,30,4,2,1
3,487,487,62,62,0,1,0
11,500,500,1,1,0,1,0

8,112,112,4,4,0,1,0
2,126,126,1,1,0,1,0
3,137,137,22,22,0,1,0
5,188,188,41,41,0,1,0
21,244,244,60,60,0,1,0
4,280,280,6,6,0,1,0
20,281,281,45,21,24,3,2
7,313,313,35,17,18,3,2
1,330,330,1,1,0,1,0
16,340,340,71,21,50,3,2
10,354,354,3,3,0,1,0
19,354,354,21,14,7,2,1
0,381,381,15,9,6,3,2
17,388,388,66,3,63,4,3
12,418,418,56,23,33,4,3
15,441,441,31,31,0,1,0
13,476,476,5,5,0,1,0
14,481,481,22,22,0,1,0
11,482,482,52,52,0,1,0
6,489,489,7,7,0,1,0
9,489,489,68,38,30,4,3
18,491,491,20,3,17,3,2

4,182,182,5,1,4,2,1
6,186,186,8,8,0,1,0
10,217,217,5,5,0,1,0
11,221,221,35,35,0,1,0
8,247,247,21,21,0,1,0
0,253,253,60,21,39,2,1
1,257,257,77,62,15,4,3
3,264,264,17,17,0,1,0
9,315,315,18,18,0,1,0
13,329,329,27,27,0,1,0
2,371,371,78,42,36,3,2
15,381,381,91,91,0,1,0
12,382,382,126,126,0,1,0
5,415,415,51,51,0,1,0
7,433,433,14,14,0,1,0
14,446,446,6,6,0,1,0

5,101,101,5,1,4,2,1
8,101,101,13,4,9,4,3
7,120,120,1,1,0,1,0
1,150,150,15,15,0,1,0
0,180,180,21,21,0,1,0
17,186,186,2,2,0,1,0
11,202,202,5,5,0,1,0
14,209,209,8,8,0,1,0
18,237,237,13,13,0,1,0
9,240,240,12,12,0,1,0
16,242,242,49,39,10,3,2
13,248,248,15,15,0,1,0
15,251,251,10,10,0,1,0
19,252,252,1,1,0,1,0
23,255,255,6,6,0,1,0
3,267,267,20,1,19,2,1
6,315,315,1,1,0,1,0
20,322,322,102,78,24,2,1
10,340,340,23,23,0,1,0
21,365,365,97,97,0,1,0
22,370,370,48,38,10,3,2
4,383,383,66,2,64,3,2
2,394,394,16,2,14,3,2
24,424,424,5,5,0,1,0
12,431,431,11,3,8,2,1

15,103,103,5,2,3,2,1
0,104,104,14,4,10,3,2
5,129,129,24,6,18,2,1
13,175,175,46,46,0,1,0
8,187,187,4,4,0,1,0
4,188,188,7,7,0,1,0
14,191,191,43,29,14,2,1
1,221,221,51,51,0,1,0
6,254,254,20,20,0,1,0
2,303,303,45,45,0,1,0
17,365,365,12,12,0,1,0
3,372,372,1,1,0,1,0
7,373,373,60,60,0,1,0
9,445,445,66,8,58,3,2
11,448,448,30,30,0,1,0
10,453,453,54,54,0,1,0
16,458,458,14,14,0,1,0
12,499,499,37,16,21,4,3

10,102,102,3,3,0,1,0
2,103,103,14,14,0,1,0
4,127,127,14,14,0,1,0
1,142,142,10,10,0,1,0
6,170,170,12,2,10,3,2
9,271,271,20,16,4,2,1
12,337,337,43,43,0,1,0
3,343,343,13,5,8,3,2
0,376,376,244,182,62,3,2
8,396,396,85,85,0,1,0
5,403,403,89,74,15,2,1
11,445,445,40,40,0,1,0
7,449,449,6,6,0,1,0
13,493,493,86,86,0,1,0

13,121,121,51,3,48,4,3
16,134,134,1,1,0,1,0
2,166,166,12,6,6,2,1
9,175,175,8,8,0,1,0
15,188,188,45,27,18,4,3
18,239,239,7,3,4,2,1
6,283,283,13,10,3,2,1
7,285,285,12,12,0,1,0
12,314,314,4,4,0,1,0
8,344,344,45,16,29,2,1
5,344,344,15,15,0,1,0
10,355,355,20,9,11,2,1
19,369,369,6,1,5,2,1
0,378,378,16,16,0,1,0
4,393,393,14,14,0,1,0
17,412,412,31,31,0,1,0
14,429,429,49,49,0,1,0
3,485,485,132,108,24,3,2
1,497,497,106,97,9,4,3
11,498,498,49,25,24,4,3

17,100,100,10,1,9,4,3
1,109,109,2,2,0,1,0
16,163,163,7,7,0,1,0
5,166,166,9,9,0,1,0
2,190,190,1,1,0,1,0
21,227,227,34,34,0,1,0
4,233,233,26,26,0,1,0
3,242,242,5,5,0,1,0
15,254,254,30,30,0,1,0
18,255,255,77,39,38,2,1
12,280,280,7,3,4,2,1
9,288,288,39,33,6,2,1
10,303,303,64,5,59,4,3
19,304,304,58,36,22,3,2
13,336,336,7,7,0,1,0
0,352,352,3,3,0,1,0
23,359,359,1,1,0,1,0
22,367,367,27,1,26,2,1
20,387,387,18,3,15,2,1
14,393,393,70,70,0,1,0
11,400,400,29,9,20,3,2
7,430,430,26,26,0,1,0
8,451,451,6,6,0,1,0
6,485,485,32,32,0,1,0

0,102,102,4,4,0,1,0
7,120,120,5,5,0,1,0
10,124,124,11,11,0,1,0
23,183,183,3,3,0,1,0
12,188,188,5,5,0,1,0
6,273,273,40,40,0,1,0
2,283,283,14,8,6,3,2
4,287,287,53,53,0,1,0
20,299,299,7,7,0,1,0
15,309,309,43,17,26,3,2
5,323,323,3,3,0,1,0
21,344,344,19,13,6,2,1
17,365,365,11,11,0,1,0
22,387,387,92,44,48,3,2
19,404,404,12,4,8,2,1
11,409,409,25,25,0,1,0
3,415,415,4,4,0,1,0
16,421,421,128,52,76,3,2
13,422,422,13,2,11,2,1
14,430,430,59,59,0,1,0
8,440,440,11,6,5,2,1
9,449,449,27,27,0,1,0
1,474,474,43,16,27,2,1
18,476,476,85,67,18,3,2

20,128,128,31,19,12,4,3
17,140,140,10,7,3,2,1
19,151,151,24,1,23,3,2
4,165,165,1,1,0,1,0
0,186,186,6,6,0,1,0
18,195,195,8,8,0,1,0
6,212,212,6,6,0,1,0
10,226,226,7,7,0,1,0
8,242,242,21,13,8,2,1
14,247,247,23,14,9,4,3
9,255,255,39,39,0,1,0
2,263,263,60,28,32,3,2
12,274,274,2,2,0,1,0
13,284,284,38,38,0,1,0
1,310,310,4,4,0,1,0
7,348,348,3,3,0,1,0
11,350,350,133,112,21,4,3
16,364,364,76,76,0,1,0
3,366,366,6,1,5,2,1
15,411,411,23,13,10,2,1
5,490,490,9,9,0,1,0

7,107,107,8,1,7,2,1
0,108,108,5,1,4,2,1
21,132,132,9,1,8,3,2
9,160,160,5,5,0,1,0
5,211,211,14,14,0,1,0
11,218,218,37,2,35,2,1
2,257,257,17,5,12,3,2
15,265,265,22,22,0,1,0
6,266,266,2,2,0,1,0
19,278,278,4,4,0,1,0
4,297,297,13,13,0,1,0
1,303,303,30,6,24,2,1
18,303,303,23,3,20,2,1
13,311,311,24,17,7,2,1
14,317,317,18,18,0,1,0
3,345,345,63,6,57,4,3
20,354,354,68,68,0,1,0
8,404,404,21,10,11,2,1
10,426,426,14,14,0,1,0
16,472,472,2,2,0,1,0
12,487,487,63,63,0,1,0
17,489,489,216,185,31,2,1

10,111,111,5,1,4,2,1
12,125,125,11,1,10,2,1
15,187,187,10,10,0,1,0
6,189,189,7,7,0,1,0
9,219,219,22,7,15,4,3
8,233,233,5,2,3,2,1
14,242,242,17,17,0,1,0
11,246,246,31,4,27,2,1
7,258,258,34,14,20,3,2
16,272,272,24,9,15,4,3
5,277,277,14,10,4,2,1
3,301,301,87,78,9,4,3
1,332,332,40,40,0,1,0
0,344,344,11,1,10,2,1
4,360,360,34,34,0,1,0
13,362,362,29,29,0,1,0
2,408,408,35,35,0,1,0
18,427,427,88,88,0,1,0
17,468,468,67,67,0,1,0
19,480,480,77,39,38,3,2

16,147,147,12,12,0,1,0
10,151,151,17,17,0,1,0
1,169,169,8,8,0,1,0
5,193,193,4,4,0,1,0
12,213,213,38,38,0,1,0
8,237,237,19,19,0,1,0
2,286,286,8,8,0,1,0
0,288,288,27,4,23,2,1
3,299,299,38,14,24,4,3
18,323,323,47,15,32,3,2
15,344,344,10,10,0,1,0
6,368,368,1,1,0,1,0
9,403,403,236,104,132,4,3
4,417,417,1,1,0,1,0
14,417,417,73,10,63,4,3
17,444,444,33,27,6,3,2
7,483,483,7,7,0,1,0
11,489,489,66,66,0,1,0
13,496,496,44,44,0,1,0

2,106,106,7,7,0,1,0
10,129,129,7,7,0,1,0
1,136,136,6,6,0,1,0
11,152,152,7,7,0,1,0
5,158,158,49,1,48,3,2
13,168,168,22,19,3,2,1
9,175,175,9,9,0,1,0
17,232,232,8,8,0,1,0
0,243,243,20,11,9,2,1
7,244,244,6,6,0,1,0
3,248,248,30,30,0,1,0
12,276,276,3,3,0,1,0
19,321,321,23,16,7,2,1
4,322,322,13,5,8,2,1
18,324,324,1,1,0,1,0
8,326,326,13,13,0,1,0
15,382,382,138,118,20,2,1
14,454,454,65,22,43,2,1
16,463,463,99,18,81,4,3
6,483,483,82,82,0,1,0

15,102,102,1,1,0,1,0
22,113,113,14,14,0,1,0
14,178,178,1,1,0,1,0
17,212,212,34,34,0,1,0
23,236,236,28,28,0,1,0
8,238,238,12,2,10,3,2
12,240,240,3,3,0,1,0
11,244,244,1,1,0,1,0
18,244,244,20,14,6,2,1
4,260,260,8,1,7,2,1
6,265,265,13,9,4,2,1
0,293,293,2,2,0,1,0
13,325,325,20,8,12,2,1
26,334,334,45,11,34,3,2
3,354,354,18,18,0,1,0
21,361,361,16,8,8,2,1
24,362,362,135,135,0,1,0
10,390,390,46,46,0,1,0
9,398,398,4,4,0,1,0
5,446,446,4,4,0,1,0
25,450,450,37,37,0,1,0
1,451,451,51,39,12,2,1
7,460,460,6,1,5,2,1
16,467,467,54,54,0,1,0
19,473,473,21,21,0,1,0
20,480,480,6,1,5,2,1
2,481,481,87,79,8,3,2

14,125,125,11,11,0,1,0
6,129,129,1,1,0,1,0
19,160,160,28,23,5,2,1
4,165,165,21,21,0,1,0
8,168,168,2,2,0,1,0
17,194,194,5,2,3,2,1
11,217,217,26,12,14,3,2
20,220,220,6,6,0,1,0
5,235,235,18,18,0,1,0
9,237,237,1,1,0,1,0
3,247,247,2,2,0,1,0
13,261,261,52,46,6,3,2
18,279,279,10,10,0,1,0
15,307,307,34,16,18,3,2
0,327,327,14,14,0,1,0
10,350,350,112,54,58,4,3
12,353,353,78,3,75,4,3
1,386,386,27,4,23,2,1
2,454,454,78,78,0,1,0
16,461,461,62,33,29,4,3
7,470,470,19,19,0,1,0

8,117,117,8,8,0,1,0
12,149,149,20,20,0,1,0
2,207,207,33,13,20,3,2
1,208,208,32,25,7,2,1
10,208,208,69,23,46,3,2
3,287,287,2,2,0,1,0
9,299,299,26,2,24,3,2
4,314,314,9,6,3,2,1
11,315,315,15,15,0,1,0
7,329,329,32,25,7,2,1
0,340,340,30,17,13,2,1
6,408,408,77,22,55,3,2
15,409,409,12,12,0,1,0
14,420,420,80,80,0,1,0
5,442,442,123,87,36,4,3
16,455,455,28,28,0,1,0
13,475,475,32,14,18,3,2

8,117,117,17,9,8,3,2
20,123,123,11,11,0,1,0
11,145,145,32,4,28,3,2
17,228,228,10,7,3,2,1
7,237,237,25,25,0,1,0
9,240,240,1,1,0,1,0
18,261,261,8,8,0,1,0
5,265,265,3,3,0,1,0
16,337,337,22,1,21,4,3
1,347,347,19,19,0,1,0
10,383,383,32,2,30,4,3
6,385,385,37,1,36,3,2
2,391,391,37,37,0,1,0
13,400,400,2,2,0,1,0
22,402,402,26,16,10,2,1
19,413,413,18,18,0,1,0
21,435,435,20,9,11,2,1
4,450,450,17,1,16,4,3
3,459,459,7,7,0,1,0
15,460,460,84,84,0,1,0
0,464,464,1,1,0,1,0
14,467,467,213,213,0,1,0
12,475,475,59,28,31,2,1

10,104,104,10,10,0,1,0
5,107,107,12,12,0,1,0
9,145,145,8,2,6,3,2
16,152,152,3,3,0,1,0
6,182,182,41,13,28,3,2
1,186,186,24,24,0,1,0
2,213,213,20,17,3,2,1
4,237,237,58,58,0,1,0
14,275,275,45,19,26,2,1
3,283,283,8,8,0,1,0
8,334,334,15,15,0,1,0
7,335,335,49,3,46,2,1
15,366,366,53,14,39,4,3
0,377,377,8,8,0,1,0
11,398,398,68,68,0,1,0
12,450,450,100,100,0,1,0
13,472,472,47,9,38,3,2

11,130,130,27,27,0,1,0
12,131,131,7,1,6,2,1
8,148,148,7,7,0,1,0
4,198,198,30,30,0,1,0
14,255,255,27,27,0,1,0
2,256,256,25,13,12,2,1
9,281,281,1,1,0,1,0
7,315,315,48,14,34,2,1
5,323,323,17,17,0,1,0
1,346,346,156,92,64,3,2
13,359,359,31,31,0,1,0
10,387,387,91,46,45,3,2
0,414,414,27,27,0,1,0
6,420,420,39,5,34,2,1
3,439,439,40,23,17,2,1
15,471,471,61,30,31,2,1

4,112,112,24,24,0,1,0
17,117,117,7,7,0,1,0
2,138,138,6,6,0,1,0
13,143,143,3,3,0,1,0
11,152,152,3,3,0,1,0
5,171,171,2,2,0,1,0
19,198,198,17,9,8,2,1
8,202,202,6,1,5,2,1
15,206,206,6,6,0,1,0
14,244,244,3,3,0,1,0
3,296,296,15,15,0,1,0
9,338,338,39,7,32,2,1
16,347,347,45,41,4,2,1
18,366,366,10,10,0,1,0
7,392,392,160,148,12,3,2
10,394,394,2,2,0,1,0
6,400,400,19,6,13,2,1
0,430,430,16,1,15,4,3
20,464,464,154,106,48,4,3
1,489,489,8,8,0,1,0
12,489,489,1,1,0,1,0
21,490,490,156,147,9,2,1

0,104,104,5,5,0,1,0
18,126,126,8,1,7,2,1
10,131,131,1,1,0,1,0
1,223,223,14,9,5,2,1
5,228,228,32,9,23,2,1
8,238,238,7,2,5,2,1
11,257,257,15,15,0,1,0
20,269,269,21,21,0,1,0
14,278,278,97,7,90,4,3
13,280,280,17,17,0,1,0
17,282,282,27,27,0,1,0
15,284,284,10,2,8,3,2
21,322,322,36,11,25,2,1
7,345,345,3,3,0,1,0
3,366,366,4,1,3,2,1
2,387,387,39,39,0,1,0
16,396,396,35,18,17,2,1
19,406,406,55,16,39,2,1
12,453,453,131,131,0,1,0
4,459,459,57,33,24,3,2
6,475,475,1,1,0,1,0
9,493,493,58,8,50,3,2

12,100,100,12,12,0,1,0
17,104,104,19,19,0,1,0
7,105,105,11,5,6,3,2
18,127,127,6,6,0,1,0
4,142,142,1,1,0,1,0
11,144,144,16,2,14,3,2
15,147,147,28,11,17,4,3
9,214,214,69,15,54,3,2
1,321,321,2,2,0,1,0
3,329,329,115,115,0,1,0
14,347,347,52,8,44,4,3
8,356,356,28,18,10,3,2
0,365,365,21,13,8,3,2
2,404,404,3,3,0,1,0
6,431,431,1,1,0,1,0
16,443,443,26,26,0,1,0
10,452,452,12,2,10,2,1
5,462,462,31,5,26,2,1
13,477,477,64,4,60,4,3

1,115,115,1,1,0,1,0
2,131,131,36,11,25,2,1
0,143,143,21,21,0,1,0
8,176,176,10,10,0,1,0
4,178,178,11,11,0,1,0
11,180,180,15,4,11,2,1
5,193,193,10,10,0,1,0
13,229,229,15,15,0,1,0
14,238,238,122,97,25,3,2
3,336,336,18,18,0,1,0
9,336,336,15,15,0,1,0
10,336,336,25,13,12,2,1
7,397,397,18,18,0,1,0
12,405,405,17,2,15,2,1
6,451,451,182,182,0,1,0
15,490,490,45,45,0,1,0

9,101,101,2,2,0,1,0
3,126,126,1,1,0,1,0
22,135,135,5,5,0,1,0
21,146,146,18,18,0,1,0
13,153,153,14,14,0,1,0
4,171,171,22,2,20,2,1
7,172,172,7,7,0,1,0
5,199,199,16,16,0,1,0
15,224,224,4,4,0,1,0
11,231,231,22,22,0,1,0
23,236,236,2,2,0,1,0
12,244,244,1,1,0,1,0
10,249,249,36,36,0,1,0
2,272,272,49,37,12,3,2
19,275,275,131,131,0,1,0
20,291,291,23,8,15,4,3
0,372,372,3,3,0,1,0
18,375,375,55,16,39,4,3
14,416,416,13,13,0,1,0
1,434,434,35,35,0,1,0
16,454,454,13,1,12,3,2
17,479,479,49,25,24,3,2
8,483,483,19,9,10,2,1
6,491,491,24,2,22,3,2

20,123,123,60,60,0,1,0
27,123,123,9,9,0,1,0
16,130,130,13,9,4,2,1
15,133,133,11,11,0,1,0
19,170,170,7,7,0,1,0
24,194,194,2,2,0,1,0
3,195,195,1,1,0,1,0
21,209,209,5,5,0,1,0
28,238,238,1,1,0,1,0
13,240,240,40,30,10,3,2
18,249,249,4,4,0,1,0
12,273,273,1,1,0,1,0
14,286,286,6,6,0,1,0
7,297,297,7,1,6,2,1
0,314,314,9,9,0,1,0
9,320,320,71,71,0,1,0
17,321,321,5,5,0,1,0
1,341,341,16,16,0,1,0
25,348,348,53,53,0,1,0
26,385,385,15,5,10,2,1
23,394,394,53,53,0,1,0
4,397,397,14,14,0,1,0
5,404,404,15,15,0,1,0
2,411,411,1,1,0,1,0
10,417,417,6,1,5,2,1
22,447,447,42,25,17,3,2
8,465,465,5,5,0,1,0
11,497,497,5,5,0,1,0
6,499,499,61,53,8,3,2

15,103,103,21,21,0,1,0
17,106,106,4,1,3,2,1
12,144,144,1,1,0,1,0
9,167,167,8,8,0,1,0
22,178,178,2,2,0,1,0
21,194,194,86,35,51,4,3
3,233,233,18,3,15,2,1
5,237,237,7,7,0,1,0
4,251,251,22,22,0,1,0
6,276,276,13,1,12,4,3
13,289,289,8,8,0,1,0
19,320,320,1,1,0,1,0
11,322,322,32,8,24,4,3
2,367,367,7,2,5,2,1
20,373,373,26,8,18,3,2
1,374,374,16,16,0,1,0
18,408,408,27,27,0,1,0
7,429,429,5,5,0,1,0
14,456,456,83,83,0,1,0
16,456,456,1,1,0,1,0
0,477,477,81,39,42,4,3
10,485,485,53,12,41,2,1
8,500,500,112,112,0,1,0

18,113,113,3,3,0,1,0
13,125,125,37,37,0,1,0
12,130,130,3,3,0,1,0
1,165,165,32,32,0,1,0
3,214,214,32,32,0,1,0
9,220,220,14,5,9,4,3
14,270,270,17,17,0,1,0
11,281,281,12,4,8,2,1
5,306,306,69,28,41,2,1
16,310,310,14,14,0,1,0
19,322,322,1,1,0,1,0
6,326,326,9,1,8,3,2
15,341,341,21,21,0,1,0
10,354,354,22,22,0,1,0
2,358,358,25,2,23,2,1
7,361,361,5,2,3,2,1
8,371,371,35,35,0,1,0
20,380,380,97,63,34,2,1
4,398,398,8,8,0,1,0
0,453,453,17,1,16,3,2
17,466,466,114,69,45,4,3

2,117,117,8,8,0,1,0
9,140,140,8,4,4,2,1
12,150,150,18,18,0,1,0
17,170,170,5,5,0,1,0
4,179,179,2,2,0,1,0
21,204,204,24,24,0,1,0
22,213,213,29,29,0,1,0
10,224,224,29,29,0,1,0
19,228,228,45,39,6,2,1
5,235,235,9,1,8,2,1
16,288,288,32,10,22,3,2
8,303,303,37,37,0,1,0
25,323,323,1,1,0,1,0
0,323,323,11,1,10,3,2
3,346,346,10,6,4,2,1
26,349,349,49,34,15,2,1
23,357,357,127,89,38,2,1
7,402,402,4,4,0,1,0
24,404,404,8,1,7,2,1
18,415,415,13,13,0,1,0
20,418,418,4,1,3,2,1
13,458,458,48,48,0,1,0
14,467,467,13,13,0,1,0
11,481,481,19,7,12,2,1
6,487,487,27,27,0,1,0
1,494,494,1,1,0,1,0
15,496,496,7,3,4,2,1

14,102,102,24,24,0,1,0
12,114,114,1,1,0,1,0
2,142,142,13,13,0,1,0
6,178,178,12,6,6,3,2
8,186,186,20,13,7,2,1
5,202,202,10,10,0,1,0
11,202,202,19,2,17,4,3
0,277,277,54,9,45,2,1
3,282,282,127,13,114,4,3
9,285,285,11,2,9,2,1
1,374,374,76,16,60,4,3
10,378,378,4,4,0,1,0
13,428,428,99,33,66,4,3
4,465,465,7,3,4,2,1
7,500,500,114,99,15,4,3

1,123,123,5,1,4,2,1
11,136,136,24,24,0,1,0
18,145,145,21,9,12,4,3
2,161,161,14,14,0,1,0
3,170,170,3,3,0,1,0
6,201,201,23,23,0,1,0
7,212,212,31,31,0,1,0
19,217,217,25,25,0,1,0
12,230,230,4,4,0,1,0
5,268,268,2,2,0,1,0
16,300,300,22,22,0,1,0
17,358,358,44,44,0,1,0
9,388,388,75,65,10,2,1
14,398,398,29,29,0,1,0
0,424,424,18,18,0,1,0
13,429,429,113,113,0,1,0
8,433,433,15,8,7,2,1
15,443,443,13,4,9,2,1
10,450,450,24,24,0,1,0
4,464,464,123,6,117,4,3

6,115,115,15,15,0,1,0
22,135,135,5,1,4,2,1
19,136,136,1,1,0,1,0
4,144,144,7,7,0,1,0
20,176,176,20,6,14,2,1
15,193,193,4,4,0,1,0
3,206,206,14,9,5,2,1
1,254,254,10,3,7,2,1
5,262,262,50,21,29,2,1
17,275,275,96,52,44,2,1
8,376,376,36,36,0,1,0
16,380,380,27,7,20,3,2
14,385,385,99,73,26,2,1
21,390,390,27,14,13,2,1
13,398,398,9,9,0,1,0
18,403,403,36,24,12,3,2
2,417,417,48,48,0,1,0
10,436,436,11,7,4,2,1
12,439,439,40,40,0,1,0
7,454,454,30,30,0,1,0
9,464,464,31,10,21,4,3
11,486,486,17,17,0,1,0
0,494,494,3,3,0,1,0

0,114,114,3,3,0,1,0
15,134,134,1,1,0,1,0
16,139,139,1,1,0,1,0
14,141,141,18,18,0,1,0
20,147,147,9,9,0,1,0
8,214,214,8,8,0,1,0
13,247,247,2,2,0,1,0
19,282,282,9,9,0,1,0
1,284,284,8,5,3,2,1
9,294,294,15,15,0,1,0
4,336,336,10,7,3,2,1
2,364,364,32,4,28,4,3
3,370,370,51,35,16,3,2
17,371,371,170,77,93,4,3
10,379,379,33,33,0,1,0
11,385,385,33,33,0,1,0
21,401,401,54,3,51,4,3
6,421,421,16,16,0,1,0
12,422,422,18,14,4,2,1
5,462,462,25,1,24,2,1
7,469,469,139,97,42,2,1
18,470,470,85,45,40,4,3

11,123,123,9,9,0,1,0
12,133,133,5,5,0,1,0
18,136,136,11,11,0,1,0
16,143,143,16,7,9,2,1
20,149,149,13,7,6,3,2
14,213,213,44,44,0,1,0
8,214,214,20,20,0,1,0
7,223,223,1,1,0,1,0
9,235,235,3,3,0,1,0
17,243,243,4,4,0,1,0
10,253,253,9,1,8,3,2
13,341,341,17,5,12,2,1
5,355,355,74,20,54,4,3
3,389,389,46,46,0,1,0
2,391,391,23,9,14,2,1
0,415,415,57,24,33,4,3
15,427,427,58,58,0,1,0
1,436,436,36,6,30,3,2
6,448,448,77,73,4,2,1
4,480,480,2,2,0,1,0
19,484,484,139,77,62,3,2

15,133,133,24,10,14,3,2
5,134,134,8,8,0,1,0
6,136,136,27,27,0,1,0
10,160,160,49,40,9,2,1
16,196,196,6,3,3,2,1
0,313,313,34,34,0,1,0
2,321,321,74,53,21,4,3
4,322,322,1,1,0,1,0
1,339,339,4,4,0,1,0
14,372,372,42,12,30,3,2
7,401,401,136,69,67,3,2
9,407,407,1,1,0,1,0
8,420,420,7,7,0,1,0
18,430,430,23,4,19,2,1
13,437,437,29,20,9,2,1
11,459,459,49,15,34,2,1
3,477,477,15,3,12,4,3
12,491,491,36,4,32,2,1
17,496,496,44,40,4,2,1

14,113,113,2,2,0,1,0
15,113,113,12,12,0,1,0
4,127,127,1,1,0,1,0
8,206,206,10,2,8,3,2
1,219,219,26,8,18,3,2
3,223,223,3,3,0,1,0
12,292,292,1,1,0,1,0
9,293,293,5,5,0,1,0
0,338,338,23,23,0,1,0
17,343,343,13,1,12,4,3
16,350,350,138,30,108,4,3
10,366,366,23,23,0,1,0
11,410,410,127,127,0,1,0
2,432,432,199,199,0,1,0
13,451,451,33,1,32,2,1
6,473,473,53,53,0,1,0
5,473,473,47,35,12,3,2
7,487,487,36,14,22,3,2

5,110,110,22,2,20,3,2
14,158,158,9,9,0,1,0
11,162,162,4,4,0,1,0
8,174,174,1,1,0,1,0
17,179,179,22,10,12,4,3
10,218,218,5,5,0,1,0
3,276,276,11,2,9,2,1
16,300,300,15,15,0,1,0
12,313,313,46,21,25,2,1
15,314,314,89,89,0,1,0
2,356,356,2,2,0,1,0
7,357,357,7,7,0,1,0
1,364,364,46,46,0,1,0
18,385,385,83,57,26,2,1
4,404,404,85,60,25,2,1
6,453,453,148,116,32,2,1
0,463,463,6,6,0,1,0
13,473,473,43,3,40,3,2
9,485,485,26,26,0,1,0

14,142,142,1,1,0,1,0
5,197,197,35,35,0,1,0
6,213,213,8,8,0,1,0
7,216,216,6,6,0,1,0
1,220,220,23,23,0,1,0
0,242,242,17,6,11,2,1
8,267,267,46,46,0,1,0
2,319,319,17,17,0,1,0
10,350,350,100,100,0,1,0
13,350,350,52,13,39,4,3
4,399,399,94,78,16,2,1
3,449,449,163,163,0,1,0
9,452,452,60,30,30,4,3
12,453,453,52,6,46,3,2
11,480,480,39,5,34,3,2

0,121,121,19,14,5,2,1
10,122,122,1,1,0,1,0
6,130,130,1,1,0,1,0
9,163,163,3,3,0,1,0
12,169,169,55,9,46,2,1
3,180,180,35,3,32,3,2
14,194,194,7,7,0,1,0
5,197,197,46,32,14,2,1
11,209,209,19,6,13,3,2
1,260,260,6,6,0,1,0
2,302,302,15,15,0,1,0
13,338,338,51,36,15,4,3
15,351,351,11,11,0,1,0
4,365,365,55,55,0,1,0
8,417,417,2,2,0,1,0
7,477,477,88,10,78,4,3
16,495,495,176,26,150,4,3

5,132,132,20,20,0,1,0
9,133,133,9,9,0,1,0
11,149,149,4,1,3,2,1
4,156,156,5,5,0,1,0
14,160,160,17,17,0,1,0
13,161,161,4,4,0,1,0
21,186,186,47,25,22,2,1
6,232,232,13,13,0,1,0
17,239,239,6,1,5,2,1
0,267,267,102,22,80,3,2
3,269,269,1,1,0,1,0
2,296,296,4,4,0,1,0
20,313,313,7,2,5,2,1
15,318,318,1,1,0,1,0
16,331,331,161,17,144,4,3
8,351,351,21,8,13,2,1
10,364,364,13,5,8,2,1
12,375,375,34,24,10,3,2
1,398,398,3,3,0,1,0
19,403,403,7,7,0,1,0
7,431,431,32,32,0,1,0
18,488,488,38,1,37,3,2

8,121,121,3,3,0,1,0
19,124,124,10,10,0,1,0
1,143,143,20,13,7,2,1
12,146,146,33,15,18,4,3
17,147,147,22,16,6,3,2
4,170,170,35,35,0,1,0
3,176,176,10,10,0,1,0
18,184,184,42,33,9,2,1
10,225,225,1,1,0,1,0
5,231,231,2,2,0,1,0
9,232,232,22,1,21,2,1
13,289,289,11,2,9,4,3
15,300,300,26,26,0,1,0
7,318,318,24,24,0,1,0
16,336,336,15,15,0,1,0
11,341,341,42,2,40,2,1
0,373,373,144,144,0,1,0
2,380,380,2,2,0,1,0
6,425,425,1,1,0,1,0
14,492,492,21,21,0,1,0

15,134,134,4,4,0,1,0
13,172,172,18,1,17,2,1
19,192,192,27,11,16,4,3
11,210,210,40,4,36,2,1
6,214,214,44,44,0,1,0
14,224,224,27,18,9,4,3
0,231,231,18,1,17,4,3
16,256,256,9,1,8,2,1
10,278,278,36,36,0,1,0
4,329,329,35,2,33,4,3
18,377,377,78,30,48,3,2
9,385,385,39,19,20,3,2
8,398,398,9,5,4,2,1
2,421,421,29,21,8,3,2
1,421,421,6,6,0,1,0
7,427,427,7,2,5,2,1
17,439,439,50,44,6,2,1
12,467,467,38,26,12,4,3
5,471,471,105,11,94,3,2
3,475,475,17,17,0,1,0

0,100,100,3,3,0,1,0
8,105,105,20,20,0,1,0
12,133,133,1,1,0,1,0
1,151,151,6,6,0,1,0
6,173,173,1,1,0,1,0
7,189,189,5,5,0,1,0
20,203,203,36,36,0,1,0
22,205,205,22,10,12,4,3
13,226,226,8,8,0,1,0
9,260,260,1,1,0,1,0
10,262,262,3,3,0,1,0
5,270,270,31,22,9,4,3
21,286,286,32,32,0,1,0
16,299,299,60,60,0,1,0
4,324,324,86,86,0,1,0
15,350,350,65,65,0,1,0
3,368,368,56,56,0,1,0
11,406,406,44,10,34,2,1
2,410,410,4,4,0,1,0
14,431,431,15,10,5,2,1
19,454,454,68,68,0,1,0
18,477,477,2,2,0,1,0
17,500,500,22,22,0,1,0

14,112,112,3,3,0,1,0
5,161,161,8,8,0,1,0
1,188,188,7,7,0,1,0
9,190,190,27,27,0,1,0
7,204,204,5,5,0,1,0
0,209,209,32,32,0,1,0
19,213,213,22,2,20,3,2
11,214,214,15,15,0,1,0
15,218,218,32,32,0,1,0
4,239,239,9,6,3,2,1
16,239,239,53,53,0,1,0
2,255,255,1,1,0,1,0
13,309,309,16,7,9,2,1
3,345,345,6,6,0,1,0
22,372,372,31,31,0,1,0
10,390,390,61,19,42,4,3
8,408,408,61,25,36,3,2
20,409,409,37,34,3,2,1
17,412,412,65,15,50,4,3
12,426,426,29,18,11,2,1
18,456,456,58,29,29,3,2
21,468,468,29,2,27,3,2
6,495,495,20,20,0,1,0

2,151,151,20,20,0,1,0
18,205,205,14,6,8,2,1
9,245,245,3,3,0,1,0
12,252,252,8,8,0,1,0
15,257,257,12,12,0,1,0
1,259,259,22,22,0,1,0
3,316,316,51,2,49,2,1
14,328,328,34,21,13,2,1
10,344,344,71,3,68,3,2
8,347,347,76,46,30,2,1
4,360,360,6,6,0,1,0
0,382,382,73,73,0,1,0
16,392,392,10,10,0,1,0
17,409,409,70,70,0,1,0
5,448,448,14,14,0,1,0
13,453,453,112,10,102,4,3
6,462,462,63,63,0,1,0
7,490,490,8,8,0,1,0
11,500,500,59,15,44,3,2

13,108,108,12,1,11,2,1
6,124,124,12,12,0,1,0
10,136,136,39,39,0,1,0
7,148,148,32,2,30,4,3
3,149,149,19,19,0,1,0
1,152,152,9,9,0,1,0
14,178,178,2,2,0,1,0
11,252,252,7,7,0,1,0
5,256,256,6,6,0,1,0
0,267,267,1,1,0,1,0
17,272,272,3,3,0,1,0
18,308,308,20,2,18,4,3
8,311,311,9,3,6,2,1
4,341,341,10,4,6,3,2
16,363,363,78,17,61,3,2
20,373,373,46,46,0,1,0
2,383,383,16,16,0,1,0
15,407,407,8,8,0,1,0
12,419,419,84,53,31,2,1
19,423,423,108,30,78,4,3
9,495,495,29,29,0,1,0

9,126,126,14,2,12,4,3
14,137,137,1,1,0,1,0
6,137,137,2,2,0,1,0
4,158,158,29,8,21,2,1
5,170,170,13,13,0,1,0
16,174,174,23,14,9,2,1
20,181,181,3,3,0,1,0
8,198,198,2,2,0,1,0
12,202,202,14,11,3,2,1
25,207,207,4,1,3,2,1
7,225,225,1,1,0,1,0
18,232,232,14,7,7,2,1
21,263,263,24,16,8,3,2
3,279,279,22,22,0,1,0
19,305,305,8,8,0,1,0
2,324,324,37,4,33,4,3
13,335,335,9,9,0,1,0
11,346,346,1,1,0,1,0
1,346,346,26,26,0,1,0
17,357,357,75,63,12,3,2
15,376,376,2,2,0,1,0
23,409,409,175,69,106,4,3
0,425,425,38,29,9,2,1
22,440,440,48,48,0,1,0
24,450,450,27,27,0,1,0
10,475,475,1,1,0,1,0

20,104,104,7,7,0,1,0
3,107,107,13,13,0,1,0
19,126,126,6,1,5,2,1
8,177,177,9,9,0,1,0
10,180,180,12,12,0,1,0
16,241,241,2,2,0,1,0
2,270,270,11,3,8,3,2
6,271,271,29,20,9,2,1
25,273,273,102,102,0,1,0
17,285,285,31,31,0,1,0
12,287,287,5,2,3,2,1
13,290,290,16,4,12,2,1
26,304,304,16,7,9,2,1
14,316,316,6,1,5,2,1
21,325,325,4,4,0,1,0
18,337,337,41,41,0,1,0
1,362,362,21,17,4,2,1
0,383,383,6,6,0,1,0
5,398,398,52,52,0,1,0
22,425,425,21,16,5,2,1
15,452,452,17,5,12,2,1
11,480,480,14,2,12,2,1
7,482,482,22,22,0,1,0
9,483,483,32,6,26,3,2
23,485,485,41,29,12,3,2
24,495,495,101,39,62,3,2
4,496,496,12,4,8,2,1

2,100,100,4,1,3,2,1
5,101,101,1,1,0,1,0
9,134,134,7,3,4,2,1
6,174,174,5,1,4,2,1
16,204,204,66,66,0,1,0
8,212,212,4,4,0,1,0
14,219,219,17,3,14,2,1
17,251,251,15,1,14,2,1
1,259,259,3,3,0,1,0
12,268,268,21,21,0,1,0
13,280,280,15,6,9,4,3
21,303,303,37,37,0,1,0
24,312,312,11,11,0,1,0
23,320,320,4,4,0,1,0
4,331,331,49,49,0,1,0
0,345,345,18,18,0,1,0
19,366,366,34,31,3,2,1
22,393,393,68,25,43,4,3
20,400,400,55,9,46,3,2
3,418,418,9,6,3,2,1
18,440,440,27,20,7,2,1
15,463,463,58,58,0,1,0
11,469,469,49,49,0,1,0
10,475,475,65,65,0,1,0
7,498,498,21,21,0,1,0

16,129,129,3,3,0,1,0
2,132,132,1,1,0,1,0
7,134,134,32,32,0,1,0
11,183,183,10,4,6,2,1
12,221,221,3,3,0,1,0
14,253,253,36,36,0,1,0
18,301,301,11,11,0,1,0
6,303,303,6,6,0,1,0
10,338,338,59,59,0,1,0
4,348,348,1,1,0,1,0
17,374,374,49,39,10,2,1
9,381,381,20,20,0,1,0
5,386,386,9,5,4,2,1
8,409,409,65,65,0,1,0
1,412,412,36,36,0,1,0
3,434,434,41,41,0,1,0
19,461,461,19,6,13,3,2
15,463,463,151,127,24,4,3
13,467,467,114,36,78,3,2
0,489,489,69,53,16,3,2

18,103,103,3,3,0,1,0
5,106,106,3,3,0,1,0
8,112,112,6,6,0,1,0
23,125,125,14,14,0,1,0
16,141,141,2,2,0,1,0
3,152,152,1,1,0,1,0
10,222,222,1,1,0,1,0
2,273,273,44,44,0,1,0
6,299,299,20,20,0,1,0
9,311,311,6,6,0,1,0
4,311,311,13,3,10,2,1
0,328,328,43,43,0,1,0
1,331,331,37,37,0,1,0
7,342,342,5,5,0,1,0
13,365,365,21,21,0,1,0
12,388,388,47,15,32,2,1
22,396,396,50,10,40,2,1
19,410,410,31,2,29,2,1
17,418,418,104,91,13,2,1
15,441,441,59,49,10,3,2
14,449,449,51,24,27,4,3
20,458,458,34,27,7,2,1
11,477,477,33,27,6,3,2
21,500,500,104,15,89,4,3

19,162,162,45,22,23,3,2
14,166,166,23,23,0,1,0
16,174,174,39,2,37,2,1
9,174,174,9,1,8,3,2
5,189,189,10,6,4,2,1
10,219,219,5,5,0,1,0
2,227,227,11,11,0,1,0
7,231,231,26,5,21,3,2
12,241,241,10,10,0,1,0
8,257,257,33,7,26,2,1
0,259,259,3,3,0,1,0
17,272,272,2,2,0,1,0
6,287,287,21,7,14,3,2
4,310,310,44,29,15,4,3
3,315,315,76,76,0,1,0
20,335,335,11,3,8,3,2
18,353,353,22,22,0,1,0
15,360,360,44,4,40,3,2
21,364,364,17,7,10,2,1
11,398,398,17,9,8,3,2
1,463,463,16,2,14,3,2
13,480,480,48,25,23,2,1

6,127,127,5,5,0,1,0
0,131,131,21,21,0,1,0
15,140,140,45,45,0,1,0
10,161,161,24,6,18,3,2
14,171,171,21,21,0,1,0
7,231,231,37,37,0,1,0
13,291,291,9,4,5,2,1
16,295,295,18,7,11,2,1
5,303,303,57,57,0,1,0
18,319,319,41,41,0,1,0
2,359,359,22,22,0,1,0
4,394,394,7,7,0,1,0
17,413,413,24,24,0,1,0
3,415,415,7,7,0,1,0
8,450,450,80,47,33,4,3
1,462,462,53,53,0,1,0
12,473,473,22,10,12,2,1
11,474,474,46,31,15,4,3
9,492,492,32,18,14,2,1

3,125,125,3,3,0,1,0
4,139,139,53,13,40,2,1
5,145,145,13,3,10,2,1
8,183,183,15,15,0,1,0
1,191,191,12,12,0,1,0
0,198,198,91,91,0,1,0
10,232,232,6,6,0,1,0
9,252,252,33,33,0,1,0
12,263,263,8,8,0,1,0
13,300,300,2,2,0,1,0
11,351,351,124,88,36,4,3
7,434,434,40,40,0,1,0
6,445,445,94,94,0,1,0
2,470,470,37,28,9,4,3

17,151,151,24,24,0,1,0
7,152,152,1,1,0,1,0
8,170,170,9,1,8,2,1
2,225,225,1,1,0,1,0
15,231,231,8,4,4,2,1
16,233,233,4,4,0,1,0
6,264,264,28,5,23,2,1
9,283,283,39,15,24,2,1
5,292,292,32,23,9,2,1
4,297,297,16,12,4,2,1
1,315,315,75,13,62,3,2
11,339,339,106,86,20,2,1
10,369,369,36,36,0,1,0
14,403,403,19,19,0,1,0
3,434,434,66,20,46,4,3
18,444,444,6,6,0,1,0
12,470,470,131,131,0,1,0
0,497,497,69,69,0,1,0
13,499,499,25,3,22,2,1

14,140,140,1,1,0,1,0
3,154,154,12,12,0,1,0
10,158,158,17,17,0,1,0
19,180,180,2,2,0,1,0
25,225,225,36,33,3,2,1
13,245,245,1,1,0,1,0
7,251,251,9,1,8,3,2
17,280,280,4,1,3,2,1
2,291,291,16,1,15,4,3
12,296,296,9,9,0,1,0
1,306,306,5,1,4,2,1
24,319,319,75,57,18,3,2
21,335,335,115,75,40,3,2
18,352,352,6,6,0,1,0
5,360,360,2,2,0,1,0
9,368,368,14,14,0,1,0
4,375,375,62,32,30,3,2
15,387,387,27,27,0,1,0
11,420,420,40,7,33,2,1
6,421,421,21,17,4,2,1
8,441,441,72,9,63,4,3
16,444,444,33,33,0,1,0
0,452,452,2,2,0,1,0
22,494,494,58,58,0,1,0
23,494,494,30,30,0,1,0
20,499,499,26,26,0,1,0

4,126,126,44,44,0,1,0
2,145,145,12,12,0,1,0
17,180,180,9,9,0,1,0
5,201,201,29,22,7,2,1
11,241,241,8,8,0,1,0
12,276,276,23,16,7,2,1
9,296,296,8,1,7,2,1
6,305,305,10,10,0,1,0
7,306,306,9,9,0,1,0
14,319,319,76,38,38,3,2
16,326,326,79,79,0,1,0
8,328,328,4,4,0,1,0
18,343,343,61,16,45,4,3
0,367,367,22,12,10,3,2
13,371,371,44,3,41,2,1
3,408,408,7,4,3,2,1
15,424,424,3,3,0,1,0
10,447,447,27,19,8,2,1
1,481,481,119,27,92,3,2

18,108,108,6,6,0,1,0
17,146,146,23,3,20,3,2
7,150,150,4,1,3,2,1
13,153,153,11,11,0,1,0
3,166,166,1,1,0,1,0
23,195,195,69,30,39,4,3
2,218,218,9,9,0,1,0
27,236,236,8,3,5,2,1
11,239,239,8,4,4,2,1
16,254,254,51,51,0,1,0
6,277,277,21,21,0,1,0
12,278,278,1,1,0,1,0
21,289,289,27,17,10,2,1
15,289,289,9,5,4,2,1
1,300,300,17,17,0,1,0
22,329,329,94,8,86,4,3
9,333,333,17,17,0,1,0
4,346,346,11,2,9,2,1
14,355,355,2,2,0,1,0
24,391,391,45,5,40,3,2
20,392,392,24,24,0,1,0
0,407,407,2,2,0,1,0
25,409,409,6,6,0,1,0
8,438,438,9,9,0,1,0
26,441,441,15,15,0,1,0
19,466,466,10,4,6,2,1
10,488,488,49,39,10,2,1
5,489,489,16,16,0,1,0

14,108,108,2,2,0,1,0
6,150,150,54,39,15,2,1
9,153,153,23,23,0,1,0
1,167,167,7,7,0,1,0
12,194,194,6,6,0,1,0
0,200,200,32,32,0,1,0
7,241,241,2,2,0,1,0
5,276,276,43,43,0,1,0
4,285,285,16,16,0,1,0
13,296,296,7,4,3,2,1
2,341,341,5,5,0,1,0
3,348,348,199,95,104,4,3
10,354,354,37,37,0,1,0
8,372,372,98,93,5,2,1
11,389,389,22,22,0,1,0

11,144,144,39,39,0,1,0
12,145,145,1,1,0,1,0
16,148,148,56,35,21,4,3
18,154,154,14,7,7,2,1
3,162,162,8,8,0,1,0
8,191,191,4,4,0,1,0
0,231,231,6,6,0,1,0
2,239,239,1,1,0,1,0
13,246,246,23,23,0,1,0
1,251,251,59,28,31,2,1
5,281,281,1,1,0,1,0
17,299,299,50,6,44,2,1
15,317,317,2,2,0,1,0
14,318,318,9,2,7,2,1
20,326,326,13,10,3,2,1
21,352,352,63,3,60,4,3
19,383,383,12,8,4,2,1
6,398,398,102,48,54,4,3
10,464,464,1,1,0,1,0
7,479,479,1,1,0,1,0
4,485,485,53,53,0,1,0
9,500,500,10,1,9,3,2

11,111,111,8,8,0,1,0
16,112,112,9,9,0,1,0
10,159,159,21,6,15,2,1
7,178,178,3,3,0,1,0
5,179,179,8,8,0,1,0
15,257,257,11,4,7,2,1
6,275,275,23,23,0,1,0
14,302,302,13,5,8,3,2
12,311,311,84,4,80,4,3
13,325,325,23,9,14,3,2
2,330,330,23,7,16,2,1
0,351,351,91,91,0,1,0
8,374,374,34,4,30,2,1
3,405,405,66,31,35,3,2
1,409,409,112,112,0,1,0
4,445,445,40,40,0,1,0
9,469,469,100,74,26,4,3

9,101,101,1,1,0,1,0
15,137,137,20,20,0,1,0
20,147,147,9,9,0,1,0
19,155,155,49,17,32,2,1
7,161,161,1,1,0,1,0
12,227,227,4,4,0,1,0
14,252,252,63,19,44,2,1
16,259,259,10,10,0,1,0
10,261,261,30,30,0,1,0
2,269,269,8,8,0,1,0
6,269,269,1,1,0,1,0
8,273,273,13,7,6,3,2
1,293,293,173,59,114,4,3
4,304,304,4,4,0,1,0
17,334,334,4,1,3,2,1
11,349,349,3,3,0,1,0
18,358,358,20,6,14,2,1
13,376,376,47,17,30,2,1
3,404,404,36,36,0,1,0
0,421,421,28,28,0,1,0
5,465,465,10,5,5,2,1

0,120,120,5,5,0,1,0
3,155,155,4,4,0,1,0
16,174,174,4,4,0,1,0
15,218,218,36,14,22,3,2
8,224,224,5,5,0,1,0
6,232,232,52,40,12,2,1
2,241,241,38,11,27,4,3
7,310,310,15,11,4,2,1
1,343,343,32,19,13,2,1
5,356,356,62,16,46,2,1
13,375,375,53,13,40,3,2
12,402,402,94,30,64,3,2
14,433,433,1,1,0,1,0
11,473,473,167,127,40,3,2
9,474,474,6,6,0,1,0
10,476,476,30,30,0,1,0
4,500,500,118,82,36,4,3

7,113,113,21,15,6,2,1
16,135,135,3,3,0,1,0
8,147,147,4,4,0,1,0
19,167,167,10,10,0,1,0
15,175,175,48,48,0,1,0
1,267,267,17,17,0,1,0
13,281,281,33,21,12,4,3
9,342,342,2,2,0,1,0
10,351,351,15,7,8,2,1
12,358,358,54,40,14,2,1
17,368,368,19,19,0,1,0
18,393,393,53,40,13,2,1
14,400,400,33,33,0,1,0
11,405,405,50,50,0,1,0
5,409,409,7,7,0,1,0
0,416,416,5,5,0,1,0
6,429,429,7,4,3,2,1
4,431,431,258,258,0,1,0
3,444,444,13,3,10,2,1
2,471,471,1,1,0,1,0

23,102,102,12,3,9,2,1
14,114,114,7,1,6,2,1
19,129,129,2,2,0,1,0
11,130,130,4,4,0,1,0
10,139,139,2,2,0,1,0
17,145,145,22,22,0,1,0
8,195,195,3,3,0,1,0
25,213,213,17,12,5,2,1
13,253,253,5,5,0,1,0
9,260,260,16,6,10,3,2
3,264,264,18,18,0,1,0
0,273,273,1,1,0,1,0
20,327,327,67,67,0,1,0
1,332,332,13,5,8,3,2
5,351,351,8,8,0,1,0
12,360,360,23,5,18,4,3
22,362,362,14,14,0,1,0
16,391,391,14,8,6,2,1
18,416,416,49,37,12,2,1
21,420,420,51,18,33,2,1
2,424,424,14,14,0,1,0
6,431,431,47,47,0,1,0
24,434,434,74,14,60,4,3
7,461,461,17,7,10,3,2
4,464,464,134,134,0,1,0
15,492,492,47,40,7,2,1

16,182,182,22,5,17,2,1
15,189,189,4,1,3,2,1
8,226,226,9,9,0,1,0
7,255,255,4,4,0,1,0
3,265,265,11,5,6,2,1
14,266,266,172,163,9,4,3
5,280,280,49,49,0,1,0
10,284,284,15,7,8,2,1
1,338,338,31,31,0,1,0
12,343,343,3,3,0,1,0
6,385,385,57,57,0,1,0
0,448,448,147,127,20,2,1
11,451,451,2,2,0,1,0
2,460,460,22,22,0,1,0
4,467,467,72,66,6,3,2
13,474,474,48,48,0,1,0
9,484,484,7,7,0,1,0

4,113,113,6,6,0,1,0
10,117,117,10,10,0,1,0
24,158,158,18,13,5,2,1
22,158,158,7,7,0,1,0
2,195,195,20,20,0,1,0
14,222,222,7,3,4,2,1
23,235,235,24,24,0,1,0
21,267,267,12,12,0,1,0
7,305,305,67,67,0,1,0
12,316,316,45,45,0,1,0
18,317,317,30,30,0,1,0
6,334,334,6,2,4,2,1
13,343,343,9,9,0,1,0
8,343,343,16,16,0,1,0
15,355,355,42,42,0,1,0
1,355,355,2,2,0,1,0
9,368,368,10,1,9,4,3
0,371,371,12,9,3,2,1
17,384,384,72,21,51,4,3
20,426,426,100,100,0,1,0
5,440,440,2,2,0,1,0
3,455,455,29,29,0,1,0
11,461,461,11,5,6,2,1
16,463,463,21,3,18,3,2
19,493,493,76,76,0,1,0

14,121,121,14,14,0,1,0
10,123,123,10,10,0,1,0
9,123,123,23,23,0,1,0
4,130,130,26,26,0,1,0
12,146,146,16,6,10,2,1
17,147,147,8,8,0,1,0
2,179,179,5,5,0,1,0
5,193,193,13,1,12,3,2
18,211,211,46,46,0,1,0
19,251,251,9,9,0,1,0
16,258,258,7,7,0,1,0
11,309,309,116,116,0,1,0
1,313,313,70,17,53,4,3
7,325,325,11,1,10,3,2
13,350,350,17,8,9,4,3
3,411,411,9,9,0,1,0
6,425,425,16,2,14,2,1
15,435,435,16,4,12,3,2
8,449,449,28,28,0,1,0
0,491,491,29,29,0,1,0

16,156,156,6,6,0,1,0
17,162,162,19,19,0,1,0
13,201,201,18,2,16,3,2
8,202,202,10,1,9,4,3
0,236,236,33,18,15,2,1
18,243,243,2,2,0,1,0
15,247,247,102,58,44,4,3
9,267,267,29,29,0,1,0
19,277,277,46,46,0,1,0
1,304,304,15,15,0,1,0
3,318,318,10,10,0,1,0
10,321,321,25,13,12,4,3
7,363,363,29,8,21,4,3
2,398,398,18,18,0,1,0
14,427,427,7,3,4,2,1
12,447,447,64,64,0,1,0
20,460,460,12,12,0,1,0
11,460,460,120,102,18,3,2
6,460,460,47,25,22,3,2
4,470,470,10,5,5,2,1
5,478,478,17,3,14,3,2

1,100,100,1,1,0,1,0
12,150,150,8,8,0,1,0
6,155,155,6,6,0,1,0
10,156,156,3,3,0,1,0
15,166,166,2,2,0,1,0
2,178,178,10,10,0,1,0
9,182,182,11,11,0,1,0
18,221,221,48,48,0,1,0
3,231,231,58,52,6,2,1
11,231,231,6,3,3,2,1
16,269,269,50,50,0,1,0
14,272,272,38,29,9,4,3
0,291,291,6,6,0,1,0
5,294,294,39,33,6,3,2
8,446,446,41,20,21,3,2
17,452,452,118,1,117,4,3
4,474,474,19,9,10,2,1
7,488,488,148,106,42,4,3
13,499,499,52,31,21,4,3

8,135,135,6,6,0,1,0
18,162,162,15,15,0,1,0
17,191,191,36,18,18,4,3
16,201,201,53,15,38,2,1
10,223,223,21,9,12,4,3
2,233,233,25,11,14,3,2
19,251,251,25,2,23,3,2
9,312,312,2,2,0,1,0
11,324,324,30,30,0,1,0
5,348,348,103,21,82,3,2
12,353,353,30,1,29,2,1
3,363,363,1,1,0,1,0
0,363,363,32,32,0,1,0
1,365,365,34,34,0,1,0
15,378,378,29,29,0,1,0
6,379,379,51,51,0,1,0
4,400,400,30,23,7,2,1
13,483,483,10,5,5,2,1
7,490,490,29,9,20,3,2
14,499,499,47,11,36,4,3

2,120,120,30,11,19,2,1
12,188,188,4,1,3,2,1
5,206,206,18,10,8,2,1
10,208,208,18,12,6,3,2
11,214,214,17,17,0,1,0
4,277,277,3,3,0,1,0
9,292,292,2,2,0,1,0
0,313,313,23,23,0,1,0
7,326,326,29,29,0,1,0
3,348,348,173,107,66,4,3
1,378,378,68,10,58,3,2
6,410,410,182,59,123,4,3
8,422,422,81,81,0,1,0

13,113,113,14,14,0,1,0
1,117,117,4,4,0,1,0
8,118,118,25,12,13,2,1
2,124,124,1,1,0,1,0
22,169,169,8,8,0,1,0
16,247,247,22,1,21,4,3
15,253,253,76,42,34,3,2
7,283,283,13,13,0,1,0
21,288,288,1,1,0,1,0
18,307,307,35,6,29,2,1
17,309,309,98,98,0,1,0
11,314,314,12,1,11,2,1
6,335,335,1,1,0,1,0
0,350,350,28,4,24,2,1
12,372,372,57,57,0,1,0
5,384,384,15,15,0,1,0
14,401,401,7,2,5,2,1
19,422,422,2,2,0,1,0
10,459,459,1,1,0,1,0
20,483,483,59,52,7,2,1
3,484,484,60,27,33,4,3
9,486,486,41,41,0,1,0
4,497,497,29,21,8,2,1

7,130,130,48,33,15,3,2
10,133,133,7,7,0,1,0
1,193,193,2,2,0,1,0
20,195,195,7,3,4,2,1
3,222,222,5,5,0,1,0
2,249,249,6,1,5,2,1
13,250,250,79,79,0,1,0
19,259,259,44,19,25,2,1
12,260,260,8,8,0,1,0
5,263,263,33,33,0,1,0
6,282,282,44,44,0,1,0
9,309,309,14,4,10,2,1
17,320,320,15,5,10,2,1
18,343,343,88,88,0,1,0
4,348,348,12,4,8,3,2
8,360,360,17,1,16,2,1
14,420,420,5,2,3,2,1
11,421,421,22,11,11,4,3
15,434,434,37,37,0,1,0
16,443,443,27,27,0,1,0
0,447,447,27,1,26,3,2

11,110,110,1,1,0,1,0
2,115,115,1,1,0,1,0
25,117,117,26,26,0,1,0
0,118,118,21,21,0,1,0
24,125,125,18,18,0,1,0
22,177,177,41,41,0,1,0
21,197,197,24,24,0,1,0
23,215,215,7,4,3,2,1
1,277,277,7,7,0,1,0
18,282,282,26,16,10,2,1
12,295,295,13,5,8,3,2
8,300,300,8,8,0,1,0
15,303,303,8,5,3,2,1
9,314,314,11,11,0,1,0
4,317,317,13,1,12,4,3
16,323,323,24,24,0,1,0
6,358,358,22,10,12,2,1
13,373,373,8,2,6,3,2
3,375,375,11,11,0,1,0
17,380,380,13,13,0,1,0
20,383,383,41,17,24,4,3
7,385,385,127,82,45,4,3
19,395,395,14,2,12,2,1
5,411,411,14,14,0,1,0
14,413,413,17,17,0,1,0
10,453,453,7,7,0,1,0

9,111,111,1,1,0,1,0
17,146,146,50,50,0,1,0
16,174,174,1,1,0,1,0
1,176,176,48,48,0,1,0
20,215,215,2,2,0,1,0
18,226,226,68,68,0,1,0
7,227,227,9,9,0,1,0
0,264,264,5,5,0,1,0
19,276,276,31,22,9,2,1
11,277,277,2,2,0,1,0
4,282,282,4,4,0,1,0
3,292,292,21,3,18,3,2
6,305,305,77,77,0,1,0
12,383,383,22,1,21,2,1
2,396,396,14,1,13,2,1
15,422,422,7,7,0,1,0
10,429,429,22,22,0,1,0
13,430,430,27,8,19,2,1
21,438,438,5,2,3,2,1
14,444,444,69,35,34,2,1
8,471,471,33,33,0,1,0
5,479,479,49,49,0,1,0

6,134,134,16,16,0,1,0
0,190,190,46,46,0,1,0
2,200,200,45,3,42,2,1
12,205,205,63,22,41,2,1
11,244,244,2,2,0,1,0
15,258,258,49,43,6,2,1
5,260,260,8,4,4,2,1
14,283,283,9,9,0,1,0
9,292,292,1,1,0,1,0
10,297,297,13,9,4,2,1
4,404,404,9,4,5,2,1
8,409,409,31,31,0,1,0
7,419,419,19,15,4,2,1
3,435,435,80,30,50,3,2
17,439,439,156,156,0,1,0
13,465,465,16,8,8,2,1
16,479,479,20,20,0,1,0
1,482,482,27,14,13,2,1

12,123,123,1,1,0,1,0
6,128,128,7,7,0,1,0
11,158,158,18,8,10,2,1
10,174,174,2,2,0,1,0
0,179,179,1,1,0,1,0
13,201,201,10,2,8,2,1
9,204,204,17,17,0,1,0
20,216,216,43,1,42,3,2
19,225,225,62,41,21,2,1
1,312,312,8,2,6,2,1
2,318,318,4,4,0,1,0
18,336,336,28,28,0,1,0
17,349,349,15,6,9,2,1
3,366,366,37,29,8,2,1
4,366,366,70,4,66,4,3
23,373,373,24,24,0,1,0
21,385,385,7,3,4,2,1
5,395,395,9,1,8,2,1
15,421,421,6,6,0,1,0
24,422,422,92,32,60,4,3
25,423,423,20,5,15,2,1
22,433,433,30,10,20,2,1
14,445,445,14,5,9,4,3
8,465,465,65,65,0,1,0
16,478,478,14,8,6,3,2
7,488,488,52,52,0,1,0

16,112,112,30,6,24,3,2
5,113,113,6,6,0,1,0
10,127,127,12,12,0,1,0
12,145,145,25,25,0,1,0
1,162,162,12,12,0,1,0
17,235,235,9,9,0,1,0
2,260,260,23,23,0,1,0
18,261,261,1,1,0,1,0
7,263,263,6,3,3,2,1
0,264,264,14,14,0,1,0
11,282,282,38,38,0,1,0
4,315,315,3,3,0,1,0
3,334,334,35,35,0,1,0
13,335,335,14,14,0,1,0
8,347,347,37,37,0,1,0
15,415,415,91,91,0,1,0
19,418,418,44,41,3,2,1
14,434,434,15,15,0,1,0
6,451,451,79,79,0,1,0
9,466,466,103,33,70,4,3

10,174,174,15,15,0,1,0
7,188,188,22,22,0,1,0
3,202,202,6,6,0,1,0
0,210,210,14,11,3,2,1
2,222,222,6,6,0,1,0
14,222,222,1,1,0,1,0
1,260,260,24,10,14,3,2
5,275,275,93,41,52,3,2
8,283,283,30,30,0,1,0
19,298,298,33,15,18,3,2
13,334,334,116,80,36,4,3
17,340,340,6,6,0,1,0
15,347,347,7,7,0,1,0
11,382,382,79,79,0,1,0
12,398,398,12,12,0,1,0
18,398,398,15,1,14,3,2
16,437,437,105,105,0,1,0
9,455,455,8,8,0,1,0
4,483,483,31,10,21,2,1
6,486,486,27,27,0,1,0

18,111,111,8,8,0,1,0
8,136,136,15,15,0,1,0
3,143,143,31,7,24,3,2
15,163,163,15,3,12,4,3
13,205,205,25,25,0,1,0
16,224,224,34,34,0,1,0
14,242,242,59,1,58,3,2
11,245,245,3,3,0,1,0
4,267,267,2,2,0,1,0
10,308,308,23,23,0,1,0
0,332,332,117,79,38,3,2
12,402,402,17,17,0,1,0
7,412,412,2,2,0,1,0
5,429,429,69,69,0,1,0
9,432,432,13,13,0,1,0
17,478,478,99,64,35,2,1
2,479,479,20,4,16,2,1
6,482,482,19,9,10,2,1
1,492,492,18,18,0,1,0

17,108,108,23,5,18,4,3
8,110,110,12,12,0,1,0
18,119,119,15,15,0,1,0
11,123,123,10,10,0,1,0
13,142,142,6,6,0,1,0
10,148,148,57,57,0,1,0
1,149,149,1,1,0,1,0
19,151,151,6,6,0,1,0
6,206,206,23,23,0,1,0
2,246,246,15,8,7,2,1
21,276,276,88,42,46,3,2
16,282,282,52,52,0,1,0
4,307,307,4,4,0,1,0
5,363,363,16,7,9,2,1
14,368,368,15,15,0,1,0
3,383,383,17,9,8,3,2
9,448,448,7,7,0,1,0
20,458,458,6,2,4,2,1
15,479,479,16,7,9,2,1
12,491,491,10,1,9,4,3
0,495,495,4,1,3,2,1
7,495,495,50,42,8,2,1

18,142,142,9,9,0,1,0
7,155,155,7,1,6,2,1
15,163,163,18,9,9,2,1
6,179,179,30,12,18,2,1
8,185,185,11,2,9,4,3
5,206,206,19,19,0,1,0
4,237,237,57,57,0,1,0
10,242,242,33,33,0,1,0
14,289,289,30,30,0,1,0
1,339,339,6,6,0,1,0
12,364,364,26,20,6,3,2
3,395,395,22,10,12,2,1
13,403,403,107,72,35,2,1
11,408,408,76,49,27,2,1
17,436,436,33,6,27,4,3
19,461,461,46,46,0,1,0
16,476,476,17,6,11,2,1
2,484,484,66,10,56,3,2
0,488,488,3,3,0,1,0
9,492,492,22,1,21,2,1

12,116,116,1,1,0,1,0
17,116,116,23,8,15,2,1
16,117,117,6,6,0,1,0
4,134,134,1,1,0,1,0
11,154,154,6,6,0,1,0
13,181,181,14,14,0,1,0
3,206,206,20,20,0,1,0
5,222,222,12,12,0,1,0
0,278,278,2,2,0,1,0
18,330,330,71,2,69,4,3
6,343,343,2,2,0,1,0
7,346,346,34,14,20,2,1
14,348,348,29,11,18,2,1
8,362,362,119,61,58,4,3
2,402,402,142,142,0,1,0
9,408,408,19,7,12,3,2
15,415,415,8,8,0,1,0
1,473,473,1,1,0,1,0
10,480,480,157,73,84,4,3

18,156,156,39,39,0,1,0
17,158,158,16,16,0,1,0
13,172,172,28,28,0,1,0
1,188,188,22,22,0,1,0
7,199,199,30,17,13,2,1
3,209,209,34,29,5,2,1
14,211,211,2,2,0,1,0
4,220,220,11,11,0,1,0
2,271,271,89,62,27,4,3
6,294,294,16,3,13,2,1
15,299,299,12,12,0,1,0
9,329,329,4,4,0,1,0
11,369,369,63,9,54,4,3
8,377,377,9,5,4,2,1
16,384,384,74,29,45,4,3
12,418,418,25,25,0,1,0
5,419,419,12,4,8,3,2
0,492,492,36,5,31,2,1
10,499,499,15,15,0,1,0

10,111,111,31,7,24,4,3
19,131,131,21,21,0,1,0
4,147,147,3,3,0,1,0
12,156,156,22,22,0,1,0
3,203,203,17,17,0,1,0
1,224,224,18,18,0,1,0
8,273,273,13,13,0,1,0
17,275,275,5,2,3,2,1
5,281,281,5,5,0,1,0
14,312,312,96,26,70,4,3
18,351,351,35,11,24,2,1
13,396,396,36,36,0,1,0
0,400,400,8,8,0,1,0
16,422,422,63,21,42,2,1
15,428,428,14,8,6,2,1
7,434,434,136,43,93,4,3
2,449,449,22,22,0,1,0
6,458,458,9,9,0,1,0
11,478,478,9,9,0,1,0
9,497,497,35,5,30,2,1

14,114,114,12,12,0,1,0
4,125,125,1,1,0,1,0
21,130,130,3,3,0,1,0
10,134,134,2,2,0,1,0
9,162,162,1,1,0,1,0
18,215,215,2,2,0,1,0
13,234,234,25,25,0,1,0
5,263,263,1,1,0,1,0
16,272,272,11,5,6,2,1
20,287,287,50,50,0,1,0
2,291,291,13,2,11,4,3
0,301,301,54,54,0,1,0
17,334,334,12,12,0,1,0
7,336,336,30,25,5,2,1
12,349,349,6,6,0,1,0
3,355,355,70,70,0,1,0
1,362,362,1,1,0,1,0
11,408,408,34,34,0,1,0
19,428,428,35,14,21,4,3
15,431,431,188,103,85,4,3
8,463,463,163,123,40,3,2
6,497,497,2,2,0,1,0

14,117,117,6,6,0,1,0
5,131,131,8,8,0,1,0
10,138,138,11,11,0,1,0
11,153,153,46,46,0,1,0
0,160,160,13,6,7,2,1
15,182,182,19,9,10,3,2
9,183,183,50,50,0,1,0
1,208,208,26,9,17,2,1
6,231,231,1,1,0,1,0
7,256,256,13,13,0,1,0
4,295,295,44,5,39,2,1
3,305,305,14,14,0,1,0
12,311,311,15,15,0,1,0
16,341,341,8,8,0,1,0
8,352,352,47,19,28,3,2
13,363,363,2,2,0,1,0
2,399,399,194,76,118,4,3

0,172,172,1,1,0,1,0
5,172,172,6,6,0,1,0
7,204,204,9,1,8,3,2
4,224,224,15,15,0,1,0
13,238,238,36,36,0,1,0
9,274,274,19,14,5,2,1
16,287,287,43,23,20,2,1
19,290,290,10,2,8,3,2
14,317,317,1,1,0,1,0
2,323,323,2,2,0,1,0
6,323,323,71,31,40,3,2
15,324,324,36,6,30,3,2
18,347,347,47,47,0,1,0
1,348,348,56,40,16,2,1
12,357,357,69,31,38,3,2
8,358,358,112,112,0,1,0
3,416,416,18,18,0,1,0
17,448,448,90,78,12,2,1
10,468,468,17,9,8,3,2
11,493,493,17,14,3,2,1

4,103,103,1,1,0,1,0
17,113,113,53,53,0,1,0
14,138,138,5,5,0,1,0
2,163,163,1,1,0,1,0
8,185,185,2,2,0,1,0
9,212,212,4,4,0,1,0
11,223,223,33,33,0,1,0
0,265,265,79,16,63,4,3
18,298,298,19,19,0,1,0
22,314,314,17,17,0,1,0
13,340,340,35,21,14,3,2
10,343,343,44,11,33,4,3
7,363,363,30,17,13,4,3
1,375,375,8,8,0,1,0
5,401,401,23,23,0,1,0
15,401,401,90,28,62,3,2
16,416,416,24,24,0,1,0
21,438,438,2,2,0,1,0
19,452,452,31,31,0,1,0
12,453,453,12,9,3,2,1
6,458,458,9,2,7,2,1
3,473,473,34,34,0,1,0
20,498,498,22,22,0,1,0

8,120,120,8,3,5,2,1
3,147,147,2,2,0,1,0
0,152,152,14,2,12,3,2
5,161,161,60,60,0,1,0
2,180,180,83,71,12,3,2
4,212,212,10,10,0,1,0
15,243,243,13,13,0,1,0
6,259,259,3,3,0,1,0
9,303,303,18,18,0,1,0
10,314,314,51,51,0,1,0
1,319,319,1,1,0,1,0
14,330,330,14,2,12,4,3
7,339,339,61,61,0,1,0
13,352,352,68,18,50,3,2
12,367,367,80,38,42,4,3
11,468,468,17,17,0,1,0

8,173,173,1,1,0,1,0
6,174,174,7,7,0,1,0
10,188,188,2,2,0,1,0
0,193,193,1,1,0,1,0
7,207,207,27,27,0,1,0
18,216,216,62,22,40,3,2
11,224,224,26,26,0,1,0
16,228,228,7,1,6,3,2
17,261,261,34,34,0,1,0
9,265,265,5,5,0,1,0
13,265,265,1,1,0,1,0
12,287,287,16,13,3,2,1
21,328,328,30,18,12,4,3
20,337,337,65,35,30,2,1
19,347,347,10,10,0,1,0
23,355,355,17,3,14,3,2
5,371,371,36,13,23,2,1
14,375,375,6,6,0,1,0
22,383,383,71,71,0,1,0
4,408,408,32,32,0,1,0
1,411,411,37,19,18,3,2
2,436,436,38,10,28,3,2
3,490,490,120,104,16,3,2
15,499,499,11,11,0,1,0

14,156,156,28,4,24,3,2
4,174,174,9,9,0,1,0
13,174,174,7,7,0,1,0
5,193,193,8,8,0,1,0
10,249,249,20,20,0,1,0
7,275,275,59,59,0,1,0
8,298,298,25,11,14,4,3
11,318,318,2,2,0,1,0
1,345,345,64,8,56,3,2
0,373,373,34,34,0,1,0
6,400,400,37,11,26,2,1
2,422,422,127,109,18,3,2
12,455,455,84,50,34,2,1
3,479,479,158,56,102,4,3
9,491,491,63,29,34,3,2

11,113,113,8,8,0,1,0
6,141,141,1,1,0,1,0
0,144,144,14,4,10,3,2
16,149,149,13,13,0,1,0
18,163,163,33,33,0,1,0
20,196,196,41,6,35,2,1
14,208,208,25,25,0,1,0
19,221,221,6,6,0,1,0
15,233,233,15,15,0,1,0
10,242,242,9,2,7,2,1
12,288,288,47,26,21,2,1
5,295,295,19,1,18,2,1
7,319,319,13,10,3,2,1
17,329,329,40,40,0,1,0
21,337,337,27,27,0,1,0
1,340,340,43,43,0,1,0
9,364,364,6,6,0,1,0
13,366,366,40,26,14,2,1
4,386,386,100,34,66,4,3
8,417,417,22,22,0,1,0
2,471,471,4,4,0,1,0
3,498,498,28,24,4,2,1

5,105,105,2,2,0,1,0
16,112,112,1,1,0,1,0
11,131,131,23,23,0,1,0
14,133,133,1,1,0,1,0
6,134,134,5,5,0,1,0
10,208,208,2,2,0,1,0
1,223,223,25,3,22,3,2
8,240,240,29,13,16,2,1
18,283,283,9,1,8,3,2
13,289,289,8,4,4,2,1
7,298,298,4,1,3,2,1
2,325,325,60,60,0,1,0
3,350,350,72,72,0,1,0
15,379,379,121,121,0,1,0
4,380,380,52,52,0,1,0
12,408,408,106,106,0,1,0
0,440,440,51,51,0,1,0
19,452,452,7,3,4,2,1
17,481,481,83,83,0,1,0
9,485,485,23,7,16,2,1

14,105,105,25,25,0,1,0
9,118,118,10,10,0,1,0
10,126,126,1,1,0,1,0
1,174,174,2,2,0,1,0
5,201,201,3,3,0,1,0
18,248,248,48,48,0,1,0
8,264,264,2,2,0,1,0
0,284,284,25,25,0,1,0
23,309,309,105,105,0,1,0
13,311,311,9,1,8,2,1
22,315,315,36,36,0,1,0
20,334,334,6,3,3,2,1
24,337,337,15,1,14,3,2
11,348,348,6,6,0,1,0
19,349,349,45,5,40,3,2
7,349,349,15,15,0,1,0
17,379,379,48,48,0,1,0
12,392,392,19,19,0,1,0
4,396,396,7,2,5,2,1
6,407,407,65,65,0,1,0
21,416,416,17,17,0,1,0
16,418,418,9,9,0,1,0
26,420,420,12,12,0,1,0
15,443,443,3,3,0,1,0
25,487,487,51,51,0,1,0
2,488,488,20,20,0,1,0
3,492,492,18,18,0,1,0

12,105,105,1,1,0,1,0
2,110,110,2,2,0,1,0
6,128,128,4,1,3,2,1
8,130,130,23,7,16,2,1
23,130,130,12,9,3,2,1
7,145,145,1,1,0,1,0
21,165,165,17,17,0,1,0
1,175,175,10,6,4,2,1
15,191,191,17,8,9,4,3
16,245,245,42,42,0,1,0
24,251,251,10,10,0,1,0
19,251,251,44,44,0,1,0
5,266,266,1,1,0,1,0
4,284,284,1,1,0,1,0
25,286,286,89,59,30,3,2
0,293,293,4,4,0,1,0
13,340,340,26,26,0,1,0
14,343,343,11,6,5,2,1
10,344,344,57,15,42,3,2
3,390,390,39,39,0,1,0
20,394,394,20,20,0,1,0
17,408,408,15,15,0,1,0
18,411,411,25,25,0,1,0
22,428,428,63,63,0,1,0
9,452,452,20,20,0,1,0
11,491,491,1,1,0,1,0

9,146,146,39,25,14,3,2
2,175,175,52,52,0,1,0
6,214,214,6,6,0,1,0
11,222,222,16,16,0,1,0
5,263,263,8,2,6,3,2
0,278,278,6,6,0,1,0
12,296,296,59,19,40,2,1
3,348,348,63,42,21,2,1
10,361,361,39,26,13,2,1
4,366,366,80,80,0,1,0
8,394,394,57,12,45,2,1
13,398,398,59,59,0,1,0
7,419,419,8,8,0,1,0
1,499,499,141,141,0,1,0

23,106,106,3,3,0,1,0
15,117,117,1,1,0,1,0
17,128,128,2,2,0,1,0
7,134,134,1,1,0,1,0
9,140,140,13,13,0,1,0
12,176,176,5,5,0,1,0
10,176,176,1,1,0,1,0
21,180,180,12,12,0,1,0
1,184,184,9,5,4,2,1
6,208,208,40,12,28,2,1
26,218,218,15,6,9,3,2
8,220,220,6,1,5,2,1
25,230,230,45,45,0,1,0
0,236,236,13,1,12,2,1
18,260,260,36,36,0,1,0
13,268,268,1,1,0,1,0
28,279,279,6,6,0,1,0
27,303,303,21,21,0,1,0
11,317,317,35,5,30,2,1
4,331,331,2,2,0,1,0
2,400,400,22,22,0,1,0
5,424,424,24,9,15,4,3
19,436,436,30,14,16,3,2
20,445,445,135,106,29,3,2
14,459,459,9,9,0,1,0
24,488,488,44,44,0,1,0
16,495,495,3,3,0,1,0
3,499,499,27,9,18,3,2
22,500,500,89,42,47,2,1

18,123,123,1,1,0,1,0
3,171,171,41,19,22,3,2
10,184,184,42,15,27,4,3
2,204,204,29,29,0,1,0
14,228,228,11,11,0,1,0
5,233,233,2,2,0,1,0
16,280,280,16,16,0,1,0
11,283,283,37,37,0,1,0
17,294,294,19,19,0,1,0
1,316,316,12,12,0,1,0
8,332,332,49,49,0,1,0
9,353,353,3,3,0,1,0
15,355,355,49,4,45,4,3
13,400,400,128,122,6,2,1
0,401,401,2,2,0,1,0
12,408,408,100,29,71,4,3
6,416,416,8,8,0,1,0
7,420,420,10,10,0,1,0
19,433,433,1,1,0,1,0
4,442,442,62,32,30,3,2

8,111,111,32,27,5,2,1
13,122,122,16,16,0,1,0
11,163,163,18,15,3,2,1
7,212,212,15,9,6,3,2
2,222,222,91,44,47,4,3
4,240,240,10,10,0,1,0
0,250,250,5,5,0,1,0
14,306,306,44,44,0,1,0
15,309,309,11,11,0,1,0
3,341,341,22,22,0,1,0
10,389,389,19,19,0,1,0
5,411,411,59,59,0,1,0
1,419,419,7,7,0,1,0
9,428,428,33,6,27,2,1
12,450,450,51,51,0,1,0
6,456,456,139,4,135,4,3

5,104,104,5,5,0,1,0
10,110,110,19,6,13,2,1
6,121,121,3,3,0,1,0
2,130,130,47,47,0,1,0
19,133,133,20,20,0,1,0
18,156,156,10,10,0,1,0
0,169,169,1,1,0,1,0
11,188,188,59,59,0,1,0
3,226,226,11,11,0,1,0
12,244,244,21,3,18,3,2
9,297,297,14,6,8,3,2
17,305,305,48,42,6,2,1
14,309,309,9,1,8,3,2
7,317,317,42,1,41,2,1
8,346,346,1,1,0,1,0
4,365,365,21,3,18,2,1
13,417,417,8,5,3,2,1
15,447,447,56,56,0,1,0
16,456,456,35,35,0,1,0
1,463,463,48,36,12,2,1

14,113,113,44,18,26,3,2
8,127,127,4,4,0,1,0
4,155,155,33,3,30,2,1
18,160,160,10,10,0,1,0
10,178,178,23,5,18,3,2
2,184,184,23,23,0,1,0
17,206,206,10,10,0,1,0
15,213,213,5,5,0,1,0
6,215,215,31,18,13,2,1
11,221,221,6,6,0,1,0
16,240,240,24,9,15,4,3
0,242,242,19,19,0,1,0
1,279,279,14,9,5,2,1
7,284,284,23,23,0,1,0
19,322,322,2,2,0,1,0
13,367,367,24,24,0,1,0
5,373,373,24,24,0,1,0
9,385,385,8,2,6,2,1
3,402,402,26,2,24,3,2
12,418,418,123,51,72,3,2

4,136,136,7,7,0,1,0
2,152,152,18,18,0,1,0
12,162,162,9,9,0,1,0
9,175,175,1,1,0,1,0
3,226,226,26,26,0,1,0
6,234,234,26,5,21,4,3
11,256,256,14,14,0,1,0
15,318,318,47,3,44,3,2
14,326,326,32,13,19,2,1
10,339,339,16,16,0,1,0
7,340,340,1,1,0,1,0
8,350,350,48,16,32,3,2
1,354,354,136,40,96,3,2
13,387,387,126,78,48,3,2
18,416,416,105,96,9,4,3
17,434,434,6,6,0,1,0
5,452,452,30,30,0,1,0
16,467,467,8,8,0,1,0
0,491,491,5,5,0,1,0

10,143,143,28,28,0,1,0
7,215,215,15,15,0,1,0
8,221,221,10,4,6,2,1
12,246,246,34,16,18,4,3
6,256,256,10,10,0,1,0
3,260,260,153,137,16,3,2
0,272,272,22,3,19,2,1
1,332,332,12,6,6,3,2
2,335,335,68,68,0,1,0
13,344,344,52,40,12,4,3
9,352,352,15,15,0,1,0
5,362,362,61,52,9,4,3
11,388,388,64,64,0,1,0
4,398,398,37,37,0,1,0

11,110,110,12,12,0,1,0
19,116,116,57,49,8,2,1
8,120,120,19,3,16,2,1
9,197,197,12,12,0,1,0
12,200,200,19,7,12,3,2
18,205,205,9,3,6,2,1
7,214,214,16,10,6,2,1
0,222,222,10,6,4,2,1
2,224,224,18,12,6,2,1
15,243,243,1,1,0,1,0
14,286,286,16,16,0,1,0
5,287,287,28,10,18,4,3
4,335,335,22,22,0,1,0
10,337,337,79,79,0,1,0
16,352,352,24,24,0,1,0
3,357,357,28,22,6,2,1
17,380,380,11,8,3,2,1
6,387,387,22,22,0,1,0
13,439,439,54,4,50,2,1
1,471,471,23,10,13,2,1

0,103,103,7,7,0,1,0
10,137,137,1,1,0,1,0
3,144,144,31,17,14,2,1
12,172,172,47,47,0,1,0
2,185,185,2,2,0,1,0
13,209,209,11,2,9,2,1
18,224,224,19,3,16,3,2
6,238,238,3,3,0,1,0
14,272,272,31,23,8,2,1
19,304,304,3,3,0,1,0
8,335,335,5,5,0,1,0
11,356,356,86,44,42,3,2
15,362,362,62,25,37,2,1
20,364,364,49,4,45,2,1
5,374,374,13,1,12,4,3
7,378,378,11,11,0,1,0
16,408,408,50,36,14,2,1
1,419,419,28,15,13,2,1
17,435,435,22,11,11,2,1
4,455,455,109,109,0,1,0
9,500,500,31,25,6,2,1

22,129,129,12,12,0,1,0
8,134,134,7,4,3,2,1
6,146,146,4,4,0,1,0
3,165,165,39,6,33,2,1
5,182,182,11,6,5,2,1
12,184,184,6,6,0,1,0
10,193,193,12,12,0,1,0
11,209,209,9,3,6,2,1
7,288,288,38,1,37,3,2
4,312,312,8,4,4,2,1
15,321,321,58,58,0,1,0
2,323,323,8,8,0,1,0
13,326,326,1,1,0,1,0
9,340,340,1,1,0,1,0
16,356,356,54,54,0,1,0
14,382,382,7,7,0,1,0
17,383,383,27,27,0,1,0
0,394,394,72,72,0,1,0
18,397,397,8,4,4,2,1
1,409,409,48,3,45,3,2
21,434,434,56,26,30,3,2
19,436,436,48,48,0,1,0
20,455,455,109,7,102,4,3

5,107,107,10,10,0,1,0
17,110,110,10,10,0,1,0
12,131,131,9,9,0,1,0
11,145,145,32,14,18,4,3
4,161,161,1,1,0,1,0
10,208,208,11,3,8,2,1
9,311,311,38,16,22,3,2
6,315,315,8,8,0,1,0
16,377,377,20,10,10,3,2
3,383,383,150,138,12,3,2
1,397,397,66,20,46,3,2
14,401,401,75,75,0,1,0
15,445,445,52,48,4,2,1
13,455,455,47,47,0,1,0
2,469,469,50,5,45,2,1
7,476,476,18,18,0,1,0
8,488,488,82,82,0,1,0
0,489,489,3,3,0,1,0

11,137,137,37,4,33,4,3
2,171,171,2,2,0,1,0
7,199,199,5,2,3,2,1
8,211,211,16,8,8,3,2
6,223,223,15,12,3,2,1
14,226,226,10,10,0,1,0
10,260,260,15,15,0,1,0
18,268,268,3,3,0,1,0
16,281,281,1,1,0,1,0
3,283,283,43,5,38,3,2
13,287,287,16,16,0,1,0
1,356,356,4,4,0,1,0
4,359,359,1,1,0,1,0
15,425,425,58,34,24,2,1
5,449,449,86,86,0,1,0
12,452,452,197,88,109,4,3
17,456,456,3,3,0,1,0
9,458,458,48,42,6,3,2
0,468,468,168,122,46,3,2

16,102,102,12,6,6,2,1
17,110,110,27,27,0,1,0
20,117,117,13,8,5,2,1
1,128,128,17,3,14,3,2
12,154,154,10,2,8,2,1
10,156,156,3,3,0,1,0
2,188,188,47,47,0,1,0
21,191,191,39,17,22,2,1
3,212,212,16,16,0,1,0
4,246,246,1,1,0,1,0
15,255,255,18,18,0,1,0
8,279,279,53,53,0,1,0
9,288,288,2,2,0,1,0
14,330,330,20,2,18,2,1
19,337,337,43,23,20,3,2
11,337,337,15,15,0,1,0
5,376,376,21,21,0,1,0
6,387,387,7,7,0,1,0
0,405,405,33,33,0,1,0
22,418,418,12,12,0,1,0
18,439,439,28,10,18,2,1
7,444,444,11,11,0,1,0
13,500,500,16,16,0,1,0

6,108,108,4,4,0,1,0
16,131,131,6,6,0,1,0
2,145,145,11,1,10,3,2
7,171,171,17,5,12,4,3
3,174,174,11,11,0,1,0
13,181,181,20,2,18,4,3
15,181,181,12,3,9,2,1
0,183,183,9,9,0,1,0
9,185,185,3,3,0,1,0
11,245,245,29,29,0,1,0
8,277,277,11,11,0,1,0
4,329,329,61,61,0,1,0
10,384,384,85,30,55,3,2
12,399,399,108,108,0,1,0
14,415,415,50,4,46,2,1
5,437,437,203,203,0,1,0
1,454,454,12,12,0,1,0

4,107,107,1,1,0,1,0
6,113,113,4,4,0,1,0
15,119,119,21,21,0,1,0
5,124,124,2,2,0,1,0
18,154,154,18,18,0,1,0
3,167,167,11,11,0,1,0
9,190,190,59,59,0,1,0
1,240,240,18,6,12,3,2
13,245,245,44,26,18,4,3
8,273,273,41,41,0,1,0
12,326,326,26,8,18,4,3
0,355,355,33,6,27,2,1
10,355,355,33,9,24,3,2
16,365,365,1,1,0,1,0
2,389,389,66,45,21,4,3
11,405,405,123,123,0,1,0
14,415,415,13,13,0,1,0
17,458,458,19,19,0,1,0
7,474,474,36,36,0,1,0

14,100,100,5,5,0,1,0
22,120,120,4,4,0,1,0
18,121,121,18,18,0,1,0
5,131,131,4,4,0,1,0
1,150,150,1,1,0,1,0
15,182,182,23,14,9,4,3
21,209,209,29,29,0,1,0
4,229,229,5,5,0,1,0
10,233,233,51,9,42,4,3
0,284,284,3,3,0,1,0
23,286,286,78,41,37,2,1
16,299,299,5,5,0,1,0
24,299,299,33,16,17,2,1
7,310,310,3,3,0,1,0
9,334,334,1,1,0,1,0
12,336,336,35,35,0,1,0
2,337,337,12,12,0,1,0
26,347,347,5,5,0,1,0
11,352,352,25,13,12,4,3
13,366,366,17,3,14,3,2
25,375,375,77,58,19,2,1
20,383,383,31,31,0,1,0
19,395,395,4,4,0,1,0
8,409,409,53,34,19,4,3
17,464,464,7,7,0,1,0
3,469,469,1,1,0,1,0
6,476,476,49,15,34,3,2

3,105,105,13,7,6,2,1
13,112,112,2,2,0,1,0
6,214,214,51,10,41,2,1
19,221,221,4,4,0,1,0
1,266,266,22,22,0,1,0
9,281,281,3,3,0,1,0
10,287,287,21,21,0,1,0
11,295,295,66,36,30,2,1
18,306,306,9,9,0,1,0
16,317,317,45,26,19,2,1
0,328,328,3,3,0,1,0
14,334,334,65,65,0,1,0
8,353,353,14,6,8,3,2
17,369,369,55,55,0,1,0
12,395,395,90,20,70,3,2
5,443,443,39,39,0,1,0
15,445,445,4,4,0,1,0
7,462,462,75,71,4,2,1
2,466,466,18,4,14,2,1
4,469,469,63,63,0,1,0

14,142,142,12,12,0,1,0
8,186,186,6,6,0,1,0
12,217,217,23,23,0,1,0
3,222,222,36,9,27,4,3
17,271,271,11,11,0,1,0
7,300,300,82,33,49,2,1
0,302,302,15,15,0,1,0
11,302,302,7,7,0,1,0
2,334,334,1,1,0,1,0
4,348,348,34,34,0,1,0
18,349,349,79,7,72,3,2
19,357,357,73,36,37,2,1
16,366,366,29,19,10,2,1
6,420,420,39,39,0,1,0
15,437,437,63,45,18,3,2
10,438,438,52,6,46,3,2
13,451,451,50,50,0,1,0
1,478,478,48,33,15,2,1
9,488,488,25,25,0,1,0
5,499,499,10,10,0,1,0

1,151,151,4,4,0,1,0
9,207,207,31,4,27,2,1
3,251,251,49,5,44,3,2
5,260,260,2,2,0,1,0
7,295,295,3,3,0,1,0
10,304,304,99,15,84,3,2
11,320,320,33,12,21,4,3
12,339,339,55,55,0,1,0
2,414,414,71,42,29,2,1
0,430,430,262,247,15,4,3
8,442,442,8,2,6,3,2
6,486,486,17,17,0,1,0
4,489,489,101,55,46,2,1

17,206,206,16,16,0,1,0
20,213,213,23,12,11,2,1
15,221,221,7,7,0,1,0
6,247,247,57,57,0,1,0
14,267,267,8,1,7,3,2
16,269,269,41,24,17,2,1
0,270,270,5,5,0,1,0
1,283,283,28,24,4,2,1
7,310,310,1,1,0,1,0
2,316,316,17,1,16,3,2
3,334,334,65,53,12,4,3
10,344,344,44,44,0,1,0
18,346,346,69,40,29,2,1
8,365,365,2,2,0,1,0
13,366,366,82,77,5,2,1
5,375,375,26,14,12,4,3
9,387,387,14,11,3,2,1
4,395,395,15,15,0,1,0
19,395,395,54,54,0,1,0
11,409,409,51,51,0,1,0
12,434,434,26,26,0,1,0

2,101,101,13,13,0,1,0
7,110,110,11,5,6,3,2
20,114,114,5,1,4,2,1
3,128,128,15,15,0,1,0
14,135,135,10,10,0,1,0
5,154,154,6,3,3,2,1
15,206,206,4,4,0,1,0
13,288,288,76,76,0,1,0
18,292,292,57,36,21,4,3
11,295,295,4,4,0,1,0
6,313,313,50,50,0,1,0
1,331,331,18,8,10,4,3
8,342,342,20,20,0,1,0
9,342,342,47,17,30,2,1
19,405,405,42,42,0,1,0
4,406,406,6,6,0,1,0
12,414,414,34,34,0,1,0
17,436,436,71,27,44,3,2
16,452,452,36,14,22,4,3
21,473,473,34,34,0,1,0
10,473,473,43,43,0,1,0
0,490,490,2,2,0,1,0

0,166,166,5,5,0,1,0
15,187,187,36,18,18,2,1
13,187,187,7,7,0,1,0
11,244,244,44,30,14,3,2
10,247,247,15,15,0,1,0
16,251,251,34,34,0,1,0
7,287,287,1,1,0,1,0
14,318,318,24,4,20,2,1
2,344,344,32,18,14,2,1
9,363,363,65,43,22,3,2
3,373,373,166,107,59,4,3
12,387,387,17,17,0,1,0
5,408,408,42,33,9,2,1
6,410,410,43,43,0,1,0
8,415,415,46,13,33,2,1
17,448,448,50,50,0,1,0
4,453,453,15,15,0,1,0
1,489,489,38,25,13,2,1

3,134,134,22,22,0,1,0
8,142,142,2,2,0,1,0
9,165,165,5,5,0,1,0
1,180,180,1,1,0,1,0
10,180,180,22,7,15,2,1
6,194,194,2,2,0,1,0
5,265,265,11,3,8,2,1
0,281,281,82,36,46,2,1
2,290,290,70,58,12,2,1
7,305,305,9,9,0,1,0
11,348,348,29,29,0,1,0
13,402,402,106,106,0,1,0
15,402,402,14,14,0,1,0
4,421,421,104,104,0,1,0
14,424,424,17,17,0,1,0
12,435,435,176,63,113,4,3

0,116,116,10,10,0,1,0
14,122,122,1,1,0,1,0
22,133,133,3,3,0,1,0
5,141,141,11,11,0,1,0
23,153,153,32,32,0,1,0
16,177,177,9,9,0,1,0
26,190,190,5,2,3,2,1
25,228,228,40,40,0,1,0
19,232,232,23,23,0,1,0
11,242,242,4,4,0,1,0
13,247,247,25,9,16,2,1
9,251,251,28,15,13,2,1
4,271,271,8,8,0,1,0
24,289,289,13,1,12,4,3
3,291,291,11,8,3,2,1
7,306,306,35,20,15,4,3
18,314,314,8,8,0,1,0
6,319,319,55,55,0,1,0
10,319,319,4,1,3,2,1
15,321,321,5,5,0,1,0
8,332,332,32,32,0,1,0
12,369,369,2,2,0,1,0
27,375,375,62,62,0,1,0
21,389,389,27,2,25,2,1
1,393,393,6,1,5,2,1
20,442,442,93,35,58,4,3
17,483,483,11,11,0,1,0
2,484,484,1,1,0,1,0

8,114,114,5,5,0,1,0
19,157,157,8,8,0,1,0
15,165,165,23,11,12,3,2
2,174,174,22,22,0,1,0
14,216,216,29,1,28,2,1
5,258,258,21,5,16,2,1
16,286,286,14,14,0,1,0
18,290,290,52,52,0,1,0
12,295,295,47,24,23,2,1
11,304,304,11,11,0,1,0
10,309,309,47,47,0,1,0
7,315,315,21,21,0,1,0
3,342,342,108,78,30,2,1
9,357,357,7,4,3,2,1
6,372,372,9,9,0,1,0
17,383,383,94,94,0,1,0
13,414,414,7,7,0,1,0
4,447,447,10,10,0,1,0
1,454,454,40,19,21,4,3
0,496,496,30,30,0,1,0

7,102,102,10,10,0,1,0
4,112,112,22,7,15,2,1
1,117,117,8,3,5,2,1
0,118,118,16,16,0,1,0
14,243,243,25,25,0,1,0
13,284,284,7,2,5,2,1
3,310,310,22,22,0,1,0
9,310,310,65,65,0,1,0
8,320,320,33,33,0,1,0
11,324,324,21,21,0,1,0
5,367,367,104,104,0,1,0
12,386,386,6,2,4,2,1
15,394,394,24,24,0,1,0
6,447,447,66,39,27,4,3
2,465,465,46,46,0,1,0
10,478,478,161,89,72,4,3

5,123,123,25,8,17,4,3
19,126,126,6,3,3,2,1
13,128,128,7,7,0,1,0
10,135,135,13,10,3,2,1
7,156,156,3,3,0,1,0
8,160,160,6,6,0,1,0
0,161,161,11,2,9,4,3
2,194,194,63,15,48,3,2
12,231,231,6,6,0,1,0
1,258,258,16,1,15,4,3
14,281,281,43,43,0,1,0
18,287,287,42,11,31,2,1
16,303,303,43,8,35,2,1
9,308,308,3,3,0,1,0
6,322,322,18,18,0,1,0
11,330,330,9,9,0,1,0
20,443,443,145,31,114,4,3
17,444,444,6,6,0,1,0
15,447,447,45,45,0,1,0
3,450,450,6,1,5,2,1
4,457,457,38,12,26,3,2

16,110,110,7,7,0,1,0
9,116,116,3,3,0,1,0
0,135,135,19,19,0,1,0
14,195,195,34,4,30,2,1
15,206,206,15,15,0,1,0
1,264,264,33,33,0,1,0
10,276,276,1,1,0,1,0
19,304,304,5,5,0,1,0
5,310,310,2,2,0,1,0
12,312,312,2,2,0,1,0
7,324,324,35,3,32,3,2
20,356,356,25,25,0,1,0
18,403,403,21,11,10,2,1
6,416,416,74,68,6,3,2
13,437,437,208,112,96,3,2
3,448,448,54,54,0,1,0
2,467,467,12,12,0,1,0
8,471,471,56,56,0,1,0
4,479,479,33,7,26,3,2
17,485,485,41,15,26,2,1
11,492,492,39,39,0,1,0

3,102,102,1,1,0,1,0
20,107,107,13,13,0,1,0
10,228,228,6,6,0,1,0
19,238,238,71,53,18,3,2
21,246,246,27,17,10,3,2
1,246,246,5,5,0,1,0
12,278,278,13,13,0,1,0
2,286,286,19,19,0,1,0
4,305,305,24,6,18,2,1
13,323,323,13,5,8,3,2
14,341,341,19,4,15,4,3
8,342,342,45,45,0,1,0
15,358,358,77,77,0,1,0
5,370,370,27,14,13,2,1
6,372,372,13,4,9,4,3
11,404,404,29,29,0,1,0
9,429,429,147,102,45,2,1
17,444,444,27,9,18,4,3
7,460,460,17,17,0,1,0
16,471,471,40,40,0,1,0
18,484,484,18,18,0,1,0
0,486,486,30,27,3,2,1

13,112,112,2,2,0,1,0
11,143,143,47,4,43,3,2
0,147,147,19,1,18,3,2
2,151,151,19,9,10,2,1
16,151,151,28,6,22,2,1
3,188,188,10,10,0,1,0
7,220,220,5,5,0,1,0
4,223,223,53,53,0,1,0
15,243,243,48,48,0,1,0
8,271,271,53,15,38,4,3
17,282,282,12,12,0,1,0
10,297,297,10,5,5,2,1
14,299,299,28,10,18,3,2
18,300,300,5,5,0,1,0
12,314,314,35,1,34,3,2
6,443,443,3,3,0,1,0
1,457,457,6,6,0,1,0
5,480,480,70,70,0,1,0
9,492,492,35,8,27,2,1

16,155,155,6,6,0,1,0
12,169,169,1,1,0,1,0
19,191,191,8,8,0,1,0
17,193,193,50,14,36,4,3
11,197,197,13,3,10,4,3
9,240,240,8,1,7,2,1
1,274,274,12,12,0,1,0
6,284,284,30,30,0,1,0
2,285,285,14,7,7,3,2
15,321,321,14,8,6,2,1
18,325,325,10,2,8,2,1
0,329,329,35,35,0,1,0
3,330,330,5,5,0,1,0
14,366,366,14,8,6,2,1
22,374,374,147,79,68,4,3
7,378,378,32,20,12,2,1
10,386,386,39,3,36,3,2
13,400,400,50,50,0,1,0
20,427,427,19,19,0,1,0
4,439,439,34,9,25,2,1
5,444,444,80,80,0,1,0
21,444,444,58,40,18,3,2
8,478,478,4,4,0,1,0

5,146,146,2,2,0,1,0
9,155,155,16,2,14,4,3
13,161,161,3,3,0,1,0
10,169,169,3,3,0,1,0
23,170,170,20,11,9,4,3
3,174,174,27,27,0,1,0
16,206,206,28,6,22,3,2
12,212,212,19,19,0,1,0
24,217,217,1,1,0,1,0
0,236,236,3,3,0,1,0
17,242,242,1,1,0,1,0
22,253,253,25,25,0,1,0
21,269,269,35,35,0,1,0
2,270,270,12,12,0,1,0
6,287,287,22,13,9,2,1
1,291,291,23,9,14,2,1
15,312,312,26,26,0,1,0
19,342,342,43,28,15,4,3
20,388,388,29,29,0,1,0
18,391,391,127,111,16,2,1
11,406,406,16,10,6,2,1
8,410,410,36,30,6,3,2
14,436,436,20,11,9,2,1
4,444,444,54,13,41,2,1
7,486,486,6,6,0,1,0

6,106,106,11,11,0,1,0
12,118,118,4,4,0,1,0
17,146,146,17,9,8,3,2
0,165,165,36,36,0,1,0
13,169,169,14,14,0,1,0
19,200,200,13,13,0,1,0
5,312,312,12,3,9,4,3
11,318,318,50,30,20,2,1
7,357,357,3,3,0,1,0
4,386,386,52,52,0,1,0
14,407,407,50,50,0,1,0
8,408,408,66,54,12,4,3
2,408,408,21,13,8,3,2
9,412,412,30,3,27,4,3
1,418,418,64,64,0,1,0
10,430,430,20,7,13,4,3
15,439,439,101,85,16,4,3
18,452,452,59,59,0,1,0
3,461,461,5,5,0,1,0
16,476,476,39,9,30,3,2

14,118,118,21,21,0,1,0
11,119,119,16,5,11,2,1
5,129,129,1,1,0,1,0
12,139,139,8,8,0,1,0
19,184,184,43,14,29,3,2
0,221,221,15,15,0,1,0
6,240,240,10,6,4,2,1
15,249,249,8,2,6,3,2
1,256,256,36,36,0,1,0
16,263,263,24,5,19,2,1
18,263,263,14,14,0,1,0
8,276,276,3,3,0,1,0
9,292,292,1,1,0,1,0
20,313,313,67,39,28,3,2
3,354,354,7,2,5,2,1
7,393,393,107,86,21,4,3
17,414,414,40,40,0,1,0
2,471,471,42,2,40,2,1
4,472,472,87,87,0,1,0
10,473,473,17,3,14,2,1
13,494,494,30,30,0,1,0

3,101,101,6,3,3,2,1
5,127,127,1,1,0,1,0
10,129,129,4,4,0,1,0
4,143,143,74,64,10,3,2
11,173,173,45,7,38,4,3
0,185,185,6,6,0,1,0
2,186,186,58,30,28,2,1
8,188,188,35,35,0,1,0
13,196,196,39,39,0,1,0
6,292,292,21,21,0,1,0
15,293,293,13,1,12,4,3
14,335,335,14,6,8,3,2
9,421,421,25,4,21,4,3
7,426,426,46,5,41,2,1
12,469,469,43,15,28,3,2
1,496,496,1,1,0,1,0

8,128,128,2,2,0,1,0
5,137,137,8,8,0,1,0
14,158,158,4,4,0,1,0
0,173,173,6,6,0,1,0
20,181,181,18,18,0,1,0
19,197,197,10,1,9,4,3
9,246,246,83,83,0,1,0
7,268,268,17,17,0,1,0
1,278,278,7,1,6,2,1
17,299,299,42,42,0,1,0
11,311,311,20,20,0,1,0
18,353,353,142,112,30,4,3
15,364,364,16,16,0,1,0
2,370,370,5,5,0,1,0
13,373,373,8,4,4,2,1
12,397,397,4,4,0,1,0
10,402,402,67,67,0,1,0
21,421,421,31,4,27,3,2
3,437,437,24,11,13,2,1
4,460,460,36,36,0,1,0
16,478,478,69,69,0,1,0
6,484,484,28,4,24,3,2
22,487,487,16,6,10,3,2

13,129,129,10,10,0,1,0
0,132,132,14,14,0,1,0
4,147,147,17,3,14,3,2
11,160,160,1,1,0,1,0
18,194,194,44,20,24,3,2
9,203,203,5,1,4,2,1
10,208,208,38,38,0,1,0
8,279,279,59,47,12,4,3
3,288,288,14,14,0,1,0
14,306,306,11,11,0,1,0
15,316,316,47,47,0,1,0
5,337,337,37,15,22,3,2
16,342,342,111,6,105,4,3
2,354,354,20,20,0,1,0
20,368,368,4,4,0,1,0
17,400,400,22,7,15,2,1
19,452,452,59,59,0,1,0
7,465,465,1,1,0,1,0
6,465,465,37,37,0,1,0
12,470,470,1,1,0,1,0
1,493,493,28,17,11,2,1

8,119,119,14,2,12,4,3
15,120,120,11,11,0,1,0
5,134,134,2,2,0,1,0
4,140,140,2,2,0,1,0
18,145,145,56,11,45,4,3
16,181,181,3,3,0,1,0
2,186,186,7,7,0,1,0
3,199,199,5,5,0,1,0
7,254,254,14,14,0,1,0
1,262,262,22,13,9,4,3
11,281,281,61,19,42,4,3
13,330,330,31,19,12,2,1
10,355,355,18,18,0,1,0
14,357,357,42,42,0,1,0
20,384,384,6,6,0,1,0
17,406,406,73,31,42,2,1
19,415,415,13,10,3,2,1
6,459,459,115,115,0,1,0
21,461,461,39,39,0,1,0
9,473,473,45,19,26,2,1
12,488,488,9,3,6,2,1
0,492,492,10,10,0,1,0

11,127,127,7,7,0,1,0
7,176,176,7,2,5,2,1
5,194,194,16,2,14,2,1
10,202,202,1,1,0,1,0
2,207,207,1,1,0,1,0
19,227,227,3,3,0,1,0
20,252,252,81,5,76,3,2
4,253,253,25,8,17,2,1
17,264,264,30,1,29,4,3
18,275,275,9,9,0,1,0
0,319,319,15,15,0,1,0
16,331,331,38,7,31,2,1
12,337,337,41,41,0,1,0
1,349,349,50,14,36,3,2
15,362,362,90,78,12,4,3
14,396,396,2,2,0,1,0
13,418,418,18,1,17,3,2
8,435,435,57,57,0,1,0
3,436,436,38,38,0,1,0
6,442,442,12,2,10,3,2
9,477,477,133,28,105,4,3

5,120,120,10,10,0,1,0
11,152,152,42,42,0,1,0
9,179,179,1,1,0,1,0
2,183,183,43,18,25,2,1
10,254,254,3,3,0,1,0
3,265,265,7,1,6,3,2
4,273,273,29,29,0,1,0
6,281,281,28,23,5,2,1
0,294,294,65,53,12,2,1
1,306,306,70,38,32,2,1
12,330,330,21,21,0,1,0
13,346,346,85,56,29,2,1
14,422,422,28,28,0,1,0
8,466,466,14,14,0,1,0
7,477,477,146,35,111,4,3
15,499,499,6,6,0,1,0

16,100,100,8,8,0,1,0
6,132,132,17,5,12,4,3
13,137,137,8,8,0,1,0
15,149,149,12,4,8,2,1
5,169,169,13,1,12,3,2
12,210,210,38,38,0,1,0
9,263,263,7,7,0,1,0
7,287,287,53,7,46,2,1
0,297,297,32,16,16,3,2
2,329,329,7,7,0,1,0
3,344,344,7,7,0,1,0
10,364,364,116,52,64,3,2
1,410,410,143,35,108,4,3
8,439,439,31,31,0,1,0
14,473,473,102,15,87,4,3
4,483,483,20,20,0,1,0
11,485,485,25,25,0,1,0
17,491,491,3,3,0,1,0

3,116,116,2,2,0,1,0
17,137,137,11,3,8,3,2
14,182,182,2,2,0,1,0
10,189,189,4,4,0,1,0
1,199,199,47,26,21,2,1
2,223,223,32,32,0,1,0
19,229,229,64,22,42,2,1
12,236,236,2,2,0,1,0
15,251,251,62,62,0,1,0
18,303,303,4,4,0,1,0
0,307,307,7,7,0,1,0
13,324,324,7,7,0,1,0
16,334,334,108,53,55,3,2
11,422,422,15,2,13,4,3
8,425,425,52,30,22,2,1
6,456,456,8,8,0,1,0
4,460,460,16,8,8,2,1
9,465,465,40,40,0,1,0
5,481,481,17,14,3,2,1
7,486,486,128,83,45,2,1

14,132,132,11,11,0,1,0
9,145,145,43,7,36,3,2
11,159,159,12,12,0,1,0
6,164,164,8,1,7,2,1
10,243,243,10,10,0,1,0
2,245,245,31,22,9,4,3
4,261,261,46,46,0,1,0
15,261,261,67,31,36,3,2
5,272,272,85,53,32,3,2
0,324,324,30,30,0,1,0
7,339,339,10,4,6,3,2
13,345,345,3,3,0,1,0
12,347,347,3,3,0,1,0
16,349,349,38,38,0,1,0
1,358,358,9,9,0,1,0
3,384,384,73,73,0,1,0
8,393,393,55,55,0,1,0

17,127,127,6,1,5,2,1
7,136,136,14,6,8,3,2
2,176,176,9,9,0,1,0
15,245,245,41,32,9,4,3
14,277,277,5,5,0,1,0
4,286,286,28,8,20,2,1
16,289,289,1,1,0,1,0
5,315,315,43,23,20,2,1
13,323,323,4,4,0,1,0
1,336,336,8,8,0,1,0
11,348,348,161,153,8,3,2
9,353,353,82,55,27,2,1
3,363,363,1,1,0,1,0
18,387,387,35,22,13,2,1
6,393,393,30,30,0,1,0
10,417,417,53,16,37,2,1
12,427,427,37,37,0,1,0
0,460,460,95,37,58,3,2
8,469,469,34,20,14,3,2

10,121,121,5,5,0,1,0
8,147,147,37,1,36,4,3
13,164,164,18,6,12,4,3
1,186,186,16,16,0,1,0
6,289,289,5,5,0,1,0
9,290,290,4,4,0,1,0
14,313,313,114,25,89,4,3
5,322,322,43,21,22,2,1
7,380,380,68,68,0,1,0
2,393,393,32,16,16,3,2
4,397,397,19,19,0,1,0
16,415,415,59,53,6,3,2
0,424,424,18,18,0,1,0
12,426,426,6,3,3,2,1
15,438,438,59,51,8,2,1
11,447,447,78,42,36,4,3
3,492,492,81,81,0,1,0
17,495,495,9,6,3,2,1

0,112,112,86,66,20,3,2
4,116,116,1,1,0,1,0
9,182,182,27,15,12,3,2
5,202,202,27,27,0,1,0
1,228,228,18,18,0,1,0
11,354,354,9,5,4,2,1
12,399,399,40,10,30,3,2
7,412,412,96,22,74,3,2
13,420,420,40,40,0,1,0
8,426,426,57,57,0,1,0
3,427,427,19,6,13,2,1
2,485,485,49,36,13,2,1
6,495,495,4,1,3,2,1
10,500,500,70,28,42,3,2

1,168,168,20,6,14,2,1
5,189,189,17,1,16,3,2
8,203,203,1,1,0,1,0
10,223,223,66,66,0,1,0
13,263,263,60,60,0,1,0
14,263,263,8,2,6,3,2
7,279,279,17,7,10,3,2
3,293,293,34,34,0,1,0
2,357,357,80,80,0,1,0
11,367,367,29,29,0,1,0
0,397,397,25,7,18,2,1
4,399,399,155,23,132,4,3
6,415,415,36,1,35,2,1
9,423,423,76,76,0,1,0
12,482,482,26,26,0,1,0

0,137,137,1,1,0,1,0
5,137,137,5,5,0,1,0
16,189,189,10,10,0,1,0
19,190,190,14,14,0,1,0
15,191,191,6,6,0,1,0
14,227,227,112,31,81,4,3
13,230,230,40,14,26,3,2
4,278,278,12,3,9,4,3
18,298,298,26,23,3,2,1
6,328,328,17,9,8,2,1
12,329,329,10,10,0,1,0
2,330,330,32,32,0,1,0
7,347,347,5,2,3,2,1
8,387,387,30,2,28,3,2
11,394,394,28,2,26,2,1
20,396,396,27,13,14,3,2
10,405,405,11,11,0,1,0
9,414,414,118,118,0,1,0
3,416,416,32,32,0,1,0
17,434,434,2,2,0,1,0
1,453,453,97,86,11,2,1

18,109,109,19,19,0,1,0
15,121,121,37,37,0,1,0
4,156,156,1,1,0,1,0
11,159,159,21,4,17,3,2
13,163,163,2,2,0,1,0
9,202,202,3,3,0,1,0
14,212,212,4,4,0,1,0
8,248,248,26,14,12,4,3
10,255,255,4,4,0,1,0
6,258,258,29,19,10,3,2
5,269,269,39,23,16,3,2
20,283,283,48,48,0,1,0
17,313,313,3,3,0,1,0
19,353,353,17,11,6,2,1
2,359,359,43,20,23,4,3
1,365,365,2,2,0,1,0
21,390,390,102,90,12,2,1
3,426,426,1,1,0,1,0
12,432,432,55,5,50,2,1
16,455,455,12,12,0,1,0
7,455,455,55,55,0,1,0
0,481,481,45,35,10,2,1

13,125,125,22,8,14,3,2
11,159,159,16,16,0,1,0
4,204,204,11,11,0,1,0
2,238,238,40,21,19,2,1
7,247,247,15,15,0,1,0
14,255,255,4,4,0,1,0
3,294,294,57,27,30,3,2
9,315,315,43,25,18,4,3
1,328,328,46,46,0,1,0
6,328,328,20,20,0,1,0
16,333,333,26,18,8,2,1
15,359,359,98,46,52,3,2
0,361,361,9,6,3,2,1
5,396,396,73,73,0,1,0
8,434,434,50,50,0,1,0
12,434,434,37,15,22,3,2
17,497,497,36,36,0,1,0
10,499,499,41,41,0,1,0

4,114,114,12,12,0,1,0
8,123,123,1,1,0,1,0
9,173,173,14,2,12,2,1
17,183,183,73,34,39,2,1
0,208,208,4,4,0,1,0
15,218,218,21,21,0,1,0
11,226,226,33,33,0,1,0
13,245,245,4,4,0,1,0
5,248,248,5,5,0,1,0
3,275,275,4,1,3,2,1
1,288,288,1,1,0,1,0
2,294,294,56,31,25,2,1
19,297,297,8,8,0,1,0
12,306,306,13,13,0,1,0
10,344,344,79,79,0,1,0
6,384,384,110,110,0,1,0
18,464,464,106,106,0,1,0
7,471,471,21,21,0,1,0
16,488,488,19,14,5,2,1
14,495,495,12,12,0,1,0

11,147,147,16,16,0,1,0
4,179,179,35,15,20,3,2
7,181,181,19,19,0,1,0
17,189,189,11,7,4,2,1
3,193,193,3,3,0,1,0
0,223,223,1,1,0,1,0
9,234,234,56,11,45,2,1
18,240,240,19,1,18,4,3
19,254,254,24,24,0,1,0
16,294,294,17,2,15,2,1
2,294,294,13,13,0,1,0
6,311,311,25,25,0,1,0
1,329,329,13,1,12,2,1
10,339,339,40,6,34,2,1
14,355,355,101,27,74,3,2
12,378,378,54,46,8,2,1
15,432,432,20,20,0,1,0
5,433,433,4,1,3,2,1
13,462,462,41,8,33,2,1
20,465,465,77,77,0,1,0
8,477,477,20,20,0,1,0

3,101,101,2,2,0,1,0
10,110,110,4,4,0,1,0
7,148,148,12,12,0,1,0
4,151,151,25,25,0,1,0
16,162,162,17,3,14,2,1
17,166,166,19,19,0,1,0
1,172,172,11,11,0,1,0
22,177,177,13,13,0,1,0
8,197,197,3,3,0,1,0
15,214,214,18,1,17,2,1
13,245,245,3,3,0,1,0
23,251,251,60,60,0,1,0
9,267,267,8,8,0,1,0
5,296,296,41,28,13,2,1
20,339,339,7,7,0,1,0
11,340,340,71,23,48,4,3
19,352,352,28,28,0,1,0
21,390,390,19,19,0,1,0
12,399,399,11,11,0,1,0
14,423,423,38,9,29,2,1
18,434,434,111,91,20,3,2
2,456,456,16,5,11,4,3
6,474,474,21,1,20,2,1
0,498,498,16,10,6,3,2

17,101,101,14,14,0,1,0
15,120,120,14,10,4,2,1
5,132,132,6,6,0,1,0
20,164,164,9,9,0,1,0
3,166,166,14,14,0,1,0
14,178,178,6,6,0,1,0
12,184,184,3,3,0,1,0
7,188,188,6,6,0,1,0
2,188,188,12,12,0,1,0
10,242,242,20,10,10,2,1
8,251,251,1,1,0,1,0
11,275,275,6,6,0,1,0
1,303,303,99,99,0,1,0
19,312,312,18,15,3,2,1
6,367,367,65,65,0,1,0
13,414,414,34,12,22,2,1
18,451,451,65,47,18,3,2
21,451,451,122,122,0,1,0
16,452,452,56,30,26,3,2
9,465,465,13,4,9,4,3
4,478,478,18,18,0,1,0
0,497,497,40,40,0,1,0

6,102,102,27,27,0,1,0
7,102,102,8,5,3,2,1
12,116,116,27,13,14,3,2
0,152,152,15,3,12,4,3
3,174,174,15,11,4,2,1
1,233,233,15,15,0,1,0
4,248,248,66,66,0,1,0
11,248,248,13,3,10,2,1
14,335,335,20,11,9,4,3
5,362,362,42,2,40,3,2
13,389,389,93,89,4,2,1
15,395,395,5,5,0,1,0
2,417,417,11,3,8,2,1
8,434,434,9,6,3,2,1
10,435,435,37,37,0,1,0
9,470,470,131,73,58,3,2
16,499,499,19,3,16,3,2

16,118,118,23,5,18,4,3
3,187,187,1,1,0,1,0
1,208,208,10,7,3,2,1
17,210,210,62,62,0,1,0
13,223,223,17,5,12,4,3
4,245,245,84,84,0,1,0
10,256,256,8,8,0,1,0
5,276,276,30,2,28,3,2
7,300,300,3,3,0,1,0
0,303,303,46,16,30,3,2
11,314,314,56,29,27,4,3
9,326,326,40,40,0,1,0
14,334,334,15,15,0,1,0
6,352,352,36,11,25,2,1
12,370,370,6,6,0,1,0
8,390,390,56,43,13,2,1
15,391,391,22,9,13,4,3
2,460,460,41,20,21,4,3

2,112,112,8,8,0,1,0
16,129,129,11,11,0,1,0
6,145,145,28,8,20,3,2
14,145,145,17,17,0,1,0
4,173,173,7,1,6,3,2
12,202,202,17,2,15,4,3
5,205,205,10,10,0,1,0
19,218,218,32,32,0,1,0
7,277,277,40,15,25,2,1
17,292,292,18,4,14,2,1
0,358,358,13,13,0,1,0
11,402,402,103,103,0,1,0
3,426,426,54,34,20,3,2
1,429,429,8,8,0,1,0
8,434,434,95,95,0,1,0
9,437,437,13,6,7,2,1
10,439,439,32,14,18,4,3
13,480,480,4,4,0,1,0
18,484,484,102,87,15,4,3
15,490,490,24,24,0,1,0

1,111,111,4,1,3,2,1
11,181,181,11,11,0,1,0
13,221,221,1,1,0,1,0
2,234,234,8,2,6,3,2
3,237,237,12,12,0,1,0
8,242,242,34,34,0,1,0
15,259,259,19,7,12,4,3
12,279,279,12,12,0,1,0
20,285,285,43,43,0,1,0
10,287,287,12,6,6,3,2
17,300,300,66,6,60,4,3
14,308,308,28,10,18,3,2
7,316,316,49,17,32,3,2
16,343,343,83,83,0,1,0
9,347,347,52,21,31,2,1
18,355,355,48,15,33,4,3
4,358,358,96,96,0,1,0
0,401,401,1,1,0,1,0
19,451,451,24,6,18,4,3
6,458,458,16,3,13,2,1
5,461,461,12,4,8,3,2

0,155,155,12,12,0,1,0
14,177,177,1,1,0,1,0
11,192,192,55,2,53,4,3
5,196,196,11,11,0,1,0
16,209,209,16,16,0,1,0
13,213,213,15,15,0,1,0
9,243,243,22,13,9,2,1
12,248,248,41,13,28,2,1
8,255,255,19,1,18,4,3
1,263,263,1,1,0,1,0
10,275,275,33,33,0,1,0
15,297,297,42,42,0,1,0
17,306,306,18,1,17,2,1
2,343,343,97,14,83,4,3
7,346,346,39,24,15,2,1
3,379,379,8,8,0,1,0
4,414,414,127,127,0,1,0
6,453,453,31,31,0,1,0

11,135,135,9,9,0,1,0
20,143,143,15,6,9,2,1
18,154,154,15,15,0,1,0
14,169,169,34,34,0,1,0
1,202,202,1,1,0,1,0
2,206,206,5,5,0,1,0
6,228,228,37,13,24,4,3
9,235,235,3,3,0,1,0
3,239,239,13,5,8,3,2
8,242,242,21,21,0,1,0
19,242,242,5,5,0,1,0
4,259,259,22,22,0,1,0
16,301,301,6,6,0,1,0
7,330,330,12,12,0,1,0
12,335,335,10,1,9,2,1
10,364,364,29,29,0,1,0
15,384,384,98,25,73,4,3
13,386,386,2,2,0,1,0
0,426,426,42,42,0,1,0
21,443,443,15,15,0,1,0
17,456,456,118,29,89,4,3
22,483,483,13,4,9,4,3
5,493,493,126,114,12,2,1

1,173,173,35,10,25,2,1
2,229,229,4,1,3,2,1
13,248,248,57,20,37,4,3
11,249,249,12,12,0,1,0
14,282,282,85,53,32,2,1
15,306,306,19,19,0,1,0
18,310,310,11,4,7,2,1
16,341,341,8,1,7,2,1
8,354,354,31,31,0,1,0
5,360,360,29,29,0,1,0
3,376,376,16,6,10,2,1
4,384,384,71,30,41,2,1
17,385,385,81,81,0,1,0
6,397,397,53,53,0,1,0
7,447,447,12,12,0,1,0
9,449,449,3,3,0,1,0
12,459,459,20,20,0,1,0
19,480,480,28,10,18,3,2
10,496,496,53,23,30,4,3
0,497,497,56,49,7,2,1

5,106,106,7,7,0,1,0
15,136,136,10,6,4,2,1
17,185,185,5,2,3,2,1
0,222,222,36,9,27,4,3
16,232,232,72,29,43,2,1
13,236,236,24,9,15,2,1
3,239,239,28,28,0,1,0
1,254,254,50,27,23,2,1
7,293,293,16,16,0,1,0
11,308,308,55,35,20,3,2
6,310,310,10,10,0,1,0
8,326,326,91,41,50,2,1
9,362,362,32,3,29,2,1
2,374,374,22,22,0,1,0
10,412,412,32,32,0,1,0
14,418,418,58,58,0,1,0
4,423,423,14,14,0,1,0
12,482,482,10,10,0,1,0

17,100,100,9,4,5,2,1
4,102,102,6,2,4,2,1
15,141,141,1,1,0,1,0
3,156,156,19,16,3,2,1
8,181,181,15,6,9,3,2
2,196,196,2,2,0,1,0
9,196,196,14,14,0,1,0
12,198,198,34,21,13,2,1
13,235,235,89,12,77,3,2
14,251,251,5,5,0,1,0
18,304,304,44,23,21,4,3
5,318,318,110,106,4,2,1
7,325,325,4,4,0,1,0
0,349,349,59,14,45,4,3
16,358,358,21,5,16,3,2
10,430,430,24,24,0,1,0
6,459,459,39,1,38,3,2
1,479,479,21,16,5,2,1
11,500,500,42,42,0,1,0

18,144,144,3,3,0,1,0
4,154,154,8,3,5,2,1
8,156,156,9,6,3,2,1
9,159,159,21,21,0,1,0
11,194,194,12,4,8,2,1
3,195,195,64,64,0,1,0
1,265,265,6,6,0,1,0
10,272,272,38,24,14,2,1
5,287,287,37,11,26,3,2
7,291,291,20,11,9,4,3
13,292,292,23,23,0,1,0
0,315,315,36,9,27,2,1
14,326,326,76,76,0,1,0
16,344,344,26,26,0,1,0
6,359,359,18,8,10,3,2
17,359,359,7,7,0,1,0
2,364,364,17,7,10,2,1
12,380,380,118,118,0,1,0
15,463,463,36,36,0,1,0

14,105,105,4,1,3,2,1
13,141,141,24,8,16,4,3
12,157,157,1,1,0,1,0
6,174,174,3,3,0,1,0
8,193,193,15,7,8,3,2
17,205,205,38,38,0,1,0
18,265,265,81,81,0,1,0
10,266,266,1,1,0,1,0
0,282,282,2,2,0,1,0
2,290,290,4,4,0,1,0
11,300,300,1,1,0,1,0
4,340,340,8,8,0,1,0
9,365,365,12,12,0,1,0
3,408,408,252,252,0,1,0
7,408,408,30,19,11,2,1
19,412,412,13,13,0,1,0
20,420,420,64,25,39,2,1
16,429,429,43,43,0,1,0
1,454,454,1,1,0,1,0
15,463,463,19,9,10,3,2
5,465,465,60,27,33,4,3

11,111,111,1,1,0,1,0
15,176,176,5,5,0,1,0
1,183,183,5,5,0,1,0
9,189,189,8,8,0,1,0
13,207,207,35,12,23,2,1
17,240,240,2,2,0,1,0
14,285,285,114,85,29,2,1
16,313,313,4,4,0,1,0
12,319,319,24,2,22,2,1
5,325,325,4,4,0,1,0
8,338,338,29,29,0,1,0
6,346,346,62,15,47,2,1
7,349,349,15,3,12,3,2
19,353,353,16,7,9,2,1
2,394,394,10,3,7,2,1
3,438,438,120,120,0,1,0
18,453,453,121,121,0,1,0
0,458,458,11,2,9,4,3
4,481,481,116,97,19,2,1
10,496,496,23,8,15,2,1

14,137,137,12,12,0,1,0
1,143,143,1,1,0,1,0
10,172,172,24,1,23,3,2
13,190,190,3,3,0,1,0
5,198,198,1,1,0,1,0
7,211,211,20,4,16,3,2
6,246,246,16,16,0,1,0
16,312,312,122,34,88,3,2
8,341,341,19,4,15,2,1
12,378,378,61,13,48,2,1
11,384,384,3,3,0,1,0
2,411,411,126,87,39,2,1
3,430,430,68,68,0,1,0
9,448,448,66,66,0,1,0
4,469,469,100,100,0,1,0
0,486,486,73,73,0,1,0
15,500,500,4,1,3,2,1

8,114,114,3,3,0,1,0
11,142,142,8,3,5,2,1
18,148,148,31,31,0,1,0
4,152,152,5,5,0,1,0
16,156,156,27,27,0,1,0
2,175,175,26,3,23,3,2
13,200,200,20,9,11,2,1
19,223,223,16,16,0,1,0
17,251,251,76,12,64,3,2
14,255,255,21,21,0,1,0
12,268,268,106,12,94,3,2
15,281,281,11,2,9,4,3
5,318,318,17,7,10,3,2
7,327,327,29,16,13,4,3
21,333,333,11,3,8,3,2
0,401,401,18,18,0,1,0
10,405,405,7,7,0,1,0
3,420,420,3,3,0,1,0
6,448,448,2,2,0,1,0
9,486,486,58,37,21,4,3
20,487,487,1,1,0,1,0
1,488,488,3,3,0,1,0

6,100,100,2,2,0,1,0
7,118,118,18,10,8,3,2
14,145,145,17,17,0,1,0
2,149,149,15,3,12,3,2
10,157,157,13,4,9,2,1
13,167,167,35,35,0,1,0
1,196,196,104,104,0,1,0
11,196,196,8,8,0,1,0
4,270,270,10,10,0,1,0
3,337,337,18,9,9,2,1
12,364,364,42,13,29,2,1
9,380,380,60,60,0,1,0
5,407,407,22,10,12,3,2
8,415,415,58,58,0,1,0
0,417,417,94,94,0,1,0

14,138,138,16,16,0,1,0
6,228,228,31,22,9,4,3
11,297,297,13,13,0,1,0
10,299,299,9,1,8,2,1
7,322,322,50,42,8,2,1
3,333,333,48,48,0,1,0
2,342,342,51,51,0,1,0
1,360,360,106,38,68,4,3
13,365,365,18,4,14,3,2
8,366,366,5,5,0,1,0
9,383,383,66,11,55,4,3
4,391,391,14,4,10,2,1
12,394,394,121,121,0,1,0
5,432,432,35,4,31,2,1
15,464,464,61,7,54,3,2
0,483,483,79,79,0,1,0

17,143,143,21,21,0,1,0
10,166,166,70,14,56,3,2
2,171,171,1,1,0,1,0
1,209,209,14,1,13,2,1
3,221,221,12,12,0,1,0
19,258,258,3,3,0,1,0
15,275,275,9,9,0,1,0
12,281,281,12,2,10,2,1
16,288,288,133,95,38,4,3
14,289,289,4,4,0,1,0
7,303,303,106,1,105,4,3
13,347,347,34,34,0,1,0
9,374,374,2,2,0,1,0
18,404,404,49,49,0,1,0
0,406,406,1,1,0,1,0
8,406,406,17,8,9,4,3
11,427,427,36,36,0,1,0
4,440,440,10,10,0,1,0
6,445,445,10,3,7,2,1
5,472,472,4,4,0,1,0

17,102,102,11,11,0,1,0
20,127,127,4,4,0,1,0
15,139,139,7,7,0,1,0
22,141,141,30,23,7,2,1
12,144,144,22,1,21,4,3
11,148,148,15,15,0,1,0
1,157,157,17,5,12,4,3
14,178,178,22,22,0,1,0
16,220,220,3,3,0,1,0
10,240,240,30,24,6,2,1
2,250,250,20,20,0,1,0
7,294,294,24,12,12,2,1
8,330,330,27,18,9,4,3
3,346,346,3,3,0,1,0
5,368,368,16,16,0,1,0
6,383,383,6,6,0,1,0
4,398,398,6,3,3,2,1
9,412,412,1,1,0,1,0
19,418,418,1,1,0,1,0
0,422,422,13,5,8,2,1
21,485,485,47,35,12,2,1
18,493,493,189,189,0,1,0
13,499,499,77,77,0,1,0

10,119,119,14,2,12,4,3
11,143,143,16,16,0,1,0
8,150,150,12,12,0,1,0
20,152,152,6,3,3,2,1
3,156,156,16,16,0,1,0
13,186,186,46,35,11,2,1
18,249,249,46,23,23,2,1
7,252,252,10,7,3,2,1
21,300,300,82,61,21,2,1
15,306,306,35,5,30,3,2
16,359,359,19,13,6,3,2
1,385,385,6,6,0,1,0
2,396,396,31,22,9,2,1
17,400,400,4,4,0,1,0
12,401,401,8,8,0,1,0
6,423,423,62,62,0,1,0
19,434,434,26,26,0,1,0
0,435,435,31,1,30,3,2
9,445,445,30,30,0,1,0
14,485,485,16,16,0,1,0
5,486,486,1,1,0,1,0
4,495,495,73,73,0,1,0

2,141,141,7,1,6,2,1
18,151,151,7,7,0,1,0
11,173,173,12,12,0,1,0
16,179,179,20,20,0,1,0
8,213,213,20,20,0,1,0
17,237,237,20,8,12,2,1
4,241,241,41,41,0,1,0
0,254,254,57,57,0,1,0
7,260,260,43,43,0,1,0
12,307,307,59,59,0,1,0
5,325,325,1,1,0,1,0
13,331,331,20,17,3,2,1
3,332,332,69,46,23,2,1
6,402,402,2,2,0,1,0
10,426,426,139,139,0,1,0
1,437,437,33,7,26,2,1
14,448,448,35,35,0,1,0
9,475,475,3,3,0,1,0
15,498,498,22,22,0,1,0

15,105,105,1,1,0,1,0
9,110,110,12,4,8,3,2
1,116,116,1,1,0,1,0
6,122,122,16,8,8,2,1
12,132,132,1,1,0,1,0
18,169,169,29,29,0,1,0
3,185,185,11,2,9,4,3
7,194,194,28,28,0,1,0
13,212,212,2,2,0,1,0
2,222,222,23,5,18,4,3
17,223,223,11,11,0,1,0
11,246,246,27,2,25,2,1
0,265,265,24,24,0,1,0
19,268,268,22,13,9,2,1
4,313,313,26,26,0,1,0
10,349,349,14,14,0,1,0
5,354,354,32,22,10,2,1
14,368,368,32,11,21,4,3
16,380,380,52,52,0,1,0
20,471,471,216,216,0,1,0
8,486,486,15,15,0,1,0

8,101,101,2,2,0,1,0
4,114,114,1,1,0,1,0
9,201,201,6,6,0,1,0
3,226,226,95,40,55,4,3
6,278,278,30,16,14,3,2
11,286,286,3,3,0,1,0
10,297,297,60,60,0,1,0
16,362,362,191,179,12,4,3
5,379,379,110,57,53,3,2
1,391,391,10,3,7,2,1
12,395,395,10,10,0,1,0
15,416,416,30,15,15,2,1
7,455,455,27,27,0,1,0
0,464,464,37,37,0,1,0
14,471,471,49,31,18,3,2
2,481,481,4,1,3,2,1
13,498,498,11,6,5,2,1

20,112,112,50,18,32,3,2
17,144,144,15,12,3,2,1
5,177,177,10,2,8,3,2
14,188,188,14,5,9,2,1
13,210,210,2,2,0,1,0
1,243,243,33,33,0,1,0
7,293,293,3,3,0,1,0
10,297,297,58,32,26,3,2
3,318,318,23,20,3,2,1
6,323,323,32,16,16,2,1
0,325,325,1,1,0,1,0
4,330,330,25,25,0,1,0
16,334,334,40,10,30,3,2
15,372,372,26,11,15,4,3
11,379,379,55,55,0,1,0
12,385,385,11,7,4,2,1
19,387,387,3,3,0,1,0
9,405,405,7,7,0,1,0
2,429,429,57,35,22,3,2
18,468,468,72,72,0,1,0
8,500,500,29,29,0,1,0

18,101,101,7,7,0,1,0
11,188,188,13,6,7,2,1
4,190,190,10,10,0,1,0
2,196,196,34,34,0,1,0
17,259,259,47,35,12,4,3
19,272,272,89,18,71,4,3
0,282,282,3,3,0,1,0
16,289,289,9,9,0,1,0
3,324,324,10,10,0,1,0
14,335,335,7,1,6,3,2
20,335,335,38,2,36,2,1
8,335,335,37,20,17,2,1
1,385,385,19,19,0,1,0
9,402,402,22,22,0,1,0
7,441,441,32,32,0,1,0
13,460,460,22,8,14,3,2
5,461,461,37,10,27,2,1
12,465,465,30,15,15,4,3
21,494,494,71,53,18,2,1
15,495,495,41,41,0,1,0
10,497,497,63,63,0,1,0
6,497,497,52,52,0,1,0

10,112,112,46,28,18,4,3
15,138,138,13,9,4,2,1
11,138,138,9,5,4,2,1
2,165,165,23,23,0,1,0
3,179,179,71,71,0,1,0
16,210,210,43,43,0,1,0
8,265,265,10,10,0,1,0
7,268,268,11,6,5,2,1
5,286,286,61,61,0,1,0
6,306,306,16,4,12,3,2
14,314,314,7,2,5,2,1
4,365,365,12,12,0,1,0
9,379,379,37,28,9,2,1
0,383,383,28,28,0,1,0
1,401,401,6,6,0,1,0
17,403,403,13,13,0,1,0
12,410,410,2,2,0,1,0
13,500,500,44,44,0,1,0

3,126,126,11,2,9,2,1
18,148,148,5,1,4,2,1
20,180,180,22,22,0,1,0
0,191,191,2,2,0,1,0
14,209,209,39,11,28,2,1
6,215,215,2,2,0,1,0
12,246,246,3,3,0,1,0
17,276,276,51,25,26,2,1
2,291,291,24,24,0,1,0
22,323,323,18,18,0,1,0
5,328,328,27,3,24,4,3
7,340,340,57,57,0,1,0
16,355,355,16,4,12,2,1
15,363,363,3,3,0,1,0
9,364,364,99,99,0,1,0
8,364,364,14,14,0,1,0
13,384,384,7,7,0,1,0
10,386,386,41,41,0,1,0
19,419,419,124,90,34,2,1
4,427,427,26,4,22,2,1
21,450,450,40,31,9,2,1
1,479,479,14,14,0,1,0
11,489,489,12,3,9,2,1

8,143,143,10,10,0,1,0
9,147,147,17,7,10,2,1
2,166,166,11,1,10,3,2
14,180,180,70,70,0,1,0
16,189,189,6,6,0,1,0
18,244,244,13,13,0,1,0
1,288,288,53,7,46,3,2
4,301,301,14,6,8,3,2
11,324,324,25,15,10,2,1
6,341,341,4,4,0,1,0
7,360,360,66,58,8,3,2
17,368,368,37,37,0,1,0
0,399,399,50,50,0,1,0
19,423,423,9,9,0,1,0
10,436,436,40,34,6,3,2
12,444,444,51,51,0,1,0
3,448,448,7,2,5,2,1
5,452,452,41,41,0,1,0
13,460,460,12,5,7,2,1
15,478,478,97,60,37,3,2

20,116,116,1,1,0,1,0
12,120,120,3,3,0,1,0
14,146,146,7,1,6,2,1
16,152,152,25,25,0,1,0
5,154,154,3,3,0,1,0
1,167,167,3,3,0,1,0
18,180,180,18,18,0,1,0
11,182,182,8,8,0,1,0
7,184,184,11,11,0,1,0
0,196,196,12,6,6,2,1
8,209,209,7,7,0,1,0
6,238,238,3,3,0,1,0
15,319,319,19,19,0,1,0
21,331,331,24,24,0,1,0
24,332,332,19,7,12,4,3
10,342,342,49,7,42,2,1
2,343,343,10,4,6,2,1
13,344,344,20,20,0,1,0
4,388,388,60,27,33,2,1
17,396,396,10,7,3,2,1
9,411,411,8,8,0,1,0
19,435,435,52,3,49,4,3
23,447,447,53,53,0,1,0
22,487,487,4,4,0,1,0
3,493,493,26,26,0,1,0
25,493,493,245,245,0,1,0

4,112,112,2,2,0,1,0
14,120,120,1,1,0,1,0
15,123,123,41,25,16,2,1
20,133,133,13,13,0,1,0
16,168,168,49,4,45,2,1
7,173,173,11,7,4,2,1
17,189,189,13,6,7,2,1
10,203,203,19,19,0,1,0
3,217,217,10,2,8,3,2
0,223,223,59,59,0,1,0
6,252,252,4,1,3,2,1
19,281,281,4,4,0,1,0
18,294,294,3,3,0,1,0
1,295,295,9,9,0,1,0
13,334,334,67,33,34,4,3
11,336,336,23,23,0,1,0
9,337,337,28,4,24,3,2
8,423,423,19,19,0,1,0
12,430,430,1,1,0,1,0
5,447,447,52,9,43,4,3
2,494,494,78,78,0,1,0

10,102,102,5,5,0,1,0
0,116,116,12,12,0,1,0
2,151,151,7,1,6,2,1
5,193,193,79,79,0,1,0
9,225,225,3,3,0,1,0
4,236,236,1,1,0,1,0
11,325,325,53,53,0,1,0
12,344,344,36,1,35,2,1
3,347,347,29,5,24,4,3
14,379,379,16,16,0,1,0
8,394,394,99,48,51,4,3
1,401,401,142,100,42,3,2
13,415,415,89,21,68,4,3
6,458,458,70,10,60,3,2
7,495,495,11,11,0,1,0

8,174,174,37,37,0,1,0
13,184,184,25,12,13,2,1
5,210,210,20,8,12,3,2
11,211,211,11,1,10,2,1
3,258,258,7,1,6,2,1
18,275,275,6,6,0,1,0
14,277,277,37,37,0,1,0
0,291,291,51,25,26,3,2
20,293,293,51,51,0,1,0
7,300,300,12,12,0,1,0
21,306,306,81,45,36,3,2
2,390,390,19,1,18,2,1
9,422,422,8,1,7,2,1
16,425,425,65,65,0,1,0
4,429,429,34,34,0,1,0
12,435,435,10,10,0,1,0
10,445,445,80,34,46,3,2
17,447,447,23,5,18,4,3
19,447,447,17,17,0,1,0
6,450,450,20,1,19,2,1
1,474,474,2,2,0,1,0
15,497,497,20,20,0,1,0

0,111,111,8,8,0,1,0
5,130,130,1,1,0,1,0
18,144,144,17,9,8,2,1
15,193,193,62,23,39,2,1
11,220,220,101,44,57,3,2
4,238,238,9,9,0,1,0
3,302,302,11,1,10,2,1
14,302,302,41,41,0,1,0
2,323,323,15,15,0,1,0
6,342,342,26,4,22,3,2
10,348,348,9,9,0,1,0
1,349,349,30,18,12,3,2
20,368,368,53,32,21,4,3
16,377,377,6,3,3,2,1
17,389,389,24,24,0,1,0
9,420,420,4,4,0,1,0
13,439,439,50,13,37,2,1
8,455,455,62,26,36,3,2
7,460,460,5,5,0,1,0
12,466,466,32,32,0,1,0
19,492,492,16,1,15,4,3

6,112,112,1,1,0,1,0
1,114,114,11,4,7,3,2
7,121,121,17,17,0,1,0
14,157,157,26,1,25,3,2
15,175,175,5,5,0,1,0
5,186,186,23,23,0,1,0
18,200,200,11,3,8,3,2
12,235,235,23,23,0,1,0
13,264,264,84,79,5,2,1
16,268,268,38,15,23,4,3
2,295,295,15,15,0,1,0
4,311,311,72,33,39,4,3
0,315,315,9,9,0,1,0
17,363,363,44,44,0,1,0
8,379,379,46,46,0,1,0
11,421,421,10,4,6,2,1
3,441,441,6,6,0,1,0
9,491,491,91,75,16,3,2
10,494,494,30,30,0,1,0

6,100,100,16,16,0,1,0
23,118,118,24,13,11,2,1
22,120,120,2,2,0,1,0
1,123,123,2,2,0,1,0
4,131,131,20,13,7,2,1
12,132,132,4,4,0,1,0
7,137,137,17,17,0,1,0
18,148,148,2,2,0,1,0
19,151,151,19,19,0,1,0
5,152,152,2,2,0,1,0
8,189,189,9,9,0,1,0
9,212,212,4,4,0,1,0
14,248,248,37,37,0,1,0
21,288,288,13,13,0,1,0
13,311,311,3,3,0,1,0
11,326,326,27,12,15,4,3
0,331,331,34,15,19,2,1
10,338,338,22,7,15,4,3
3,370,370,3,3,0,1,0
2,386,386,9,9,0,1,0
16,408,408,97,21,76,3,2
20,409,409,11,1,10,2,1
17,489,489,128,26,102,4,3
15,492,492,45,6,39,2,1

9,116,116,1,1,0,1,0
7,117,117,2,2,0,1,0
21,129,129,10,4,6,2,1
19,153,153,11,11,0,1,0
2,171,171,3,3,0,1,0
5,205,205,2,2,0,1,0
15,207,207,39,32,7,2,1
1,225,225,7,1,6,2,1
25,236,236,11,11,0,1,0
17,237,237,22,4,18,3,2
0,267,267,3,3,0,1,0
24,295,295,32,32,0,1,0
3,303,303,13,13,0,1,0
11,314,314,27,15,12,3,2
8,336,336,3,3,0,1,0
23,359,359,18,9,9,4,3
18,361,361,104,104,0,1,0
14,370,370,89,33,56,3,2
16,402,402,25,25,0,1,0
6,406,406,14,3,11,2,1
22,406,406,34,34,0,1,0
10,410,410,15,15,0,1,0
4,444,444,42,20,22,3,2
12,468,468,18,18,0,1,0
20,469,469,93,93,0,1,0
13,479,479,35,35,0,1,0

5,124,124,1,1,0,1,0
10,126,126,11,2,9,4,3
8,130,130,32,12,20,2,1
3,154,154,1,1,0,1,0
7,156,156,46,46,0,1,0
9,159,159,19,1,18,4,3
0,159,159,5,5,0,1,0
15,171,171,40,40,0,1,0
16,210,210,16,16,0,1,0
17,256,256,44,44,0,1,0
2,299,299,5,5,0,1,0
6,303,303,62,62,0,1,0
4,313,313,49,49,0,1,0
1,339,339,14,14,0,1,0
13,351,351,46,46,0,1,0
12,354,354,18,18,0,1,0
11,388,388,42,42,0,1,0
14,392,392,15,3,12,3,2

9,104,104,4,4,0,1,0
7,123,123,2,2,0,1,0
15,136,136,2,2,0,1,0
14,157,157,50,50,0,1,0
13,165,165,25,25,0,1,0
4,169,169,16,2,14,4,3
17,175,175,19,9,10,3,2
3,190,190,3,3,0,1,0
2,225,225,9,1,8,3,2
10,231,231,9,3,6,3,2
5,232,232,1,1,0,1,0
11,282,282,54,54,0,1,0
18,283,283,30,16,14,2,1
16,290,290,1,1,0,1,0
19,292,292,9,3,6,2,1
6,324,324,5,5,0,1,0
0,389,389,1,1,0,1,0
12,413,413,35,35,0,1,0
1,422,422,103,67,36,4,3
20,458,458,93,93,0,1,0
8,459,459,137,106,31,2,1

7,101,101,29,2,27,4,3
3,131,131,1,1,0,1,0
10,141,141,22,4,18,3,2
0,204,204,17,17,0,1,0
17,232,232,3,3,0,1,0
19,236,236,81,81,0,1,0
4,241,241,15,7,8,3,2
6,246,246,14,14,0,1,0
15,254,254,15,9,6,2,1
14,264,264,3,3,0,1,0
11,298,298,56,56,0,1,0
5,305,305,5,2,3,2,1
2,309,309,11,11,0,1,0
12,318,318,36,36,0,1,0
13,365,365,62,62,0,1,0
18,369,369,7,7,0,1,0
20,384,384,98,78,20,3,2
1,390,390,11,2,9,4,3
8,434,434,11,4,7,2,1
9,456,456,25,25,0,1,0
16,491,491,17,5,12,2,1

7,122,122,26,20,6,3,2
13,127,127,3,3,0,1,0
14,151,151,16,16,0,1,0
2,159,159,28,28,0,1,0
8,162,162,1,1,0,1,0
4,175,175,8,1,7,2,1
12,195,195,126,126,0,1,0
16,225,225,7,7,0,1,0
10,242,242,8,8,0,1,0
0,255,255,1,1,0,1,0
3,277,277,4,4,0,1,0
11,282,282,10,10,0,1,0
9,283,283,32,23,9,4,3
6,385,385,73,73,0,1,0
5,408,408,101,52,49,2,1
1,462,462,53,1,52,3,2
15,477,477,12,4,8,2,1

14,114,114,1,1,0,1,0
6,145,145,6,6,0,1,0
17,152,152,37,37,0,1,0
8,153,153,10,10,0,1,0
18,160,160,25,25,0,1,0
13,160,160,22,22,0,1,0
12,197,197,13,10,3,2,1
15,238,238,59,32,27,4,3
2,266,266,3,3,0,1,0
4,269,269,18,18,0,1,0
10,287,287,88,88,0,1,0
1,325,325,24,24,0,1,0
9,325,325,27,27,0,1,0
11,362,362,54,54,0,1,0
19,432,432,1,1,0,1,0
7,443,443,71,71,0,1,0
3,455,455,44,44,0,1,0
5,469,469,5,5,0,1,0
0,488,488,42,21,21,4,3
16,500,500,5,5,0,1,0

5,104,104,3,3,0,1,0
6,106,106,5,5,0,1,0
9,118,118,19,3,16,2,1
10,146,146,4,4,0,1,0
0,158,158,10,10,0,1,0
8,160,160,13,13,0,1,0
14,174,174,18,18,0,1,0
15,186,186,3,3,0,1,0
12,239,239,1,1,0,1,0
1,277,277,17,17,0,1,0
7,281,281,5,5,0,1,0
13,288,288,66,66,0,1,0
11,331,331,9,2,7,2,1
4,332,332,42,42,0,1,0
16,351,351,121,118,3,2,1
2,382,382,22,7,15,4,3
19,421,421,73,29,44,2,1
3,431,431,130,31,99,4,3
20,435,435,2,2,0,1,0
18,450,450,63,63,0,1,0
17,481,481,2,2,0,1,0

19,107,107,11,11,0,1,0
4,127,127,5,5,0,1,0
13,141,141,13,2,11,2,1
10,143,143,4,4,0,1,0
7,147,147,6,6,0,1,0
12,178,178,14,14,0,1,0
17,199,199,55,15,40,3,2
2,216,216,1,1,0,1,0
0,303,303,12,7,5,2,1
20,319,319,78,30,48,4,3
8,326,326,46,6,40,2,1
5,333,333,1,1,0,1,0
16,336,336,37,37,0,1,0
21,347,347,5,5,0,1,0
14,349,349,15,3,12,2,1
11,364,364,39,23,16,2,1
9,380,380,14,14,0,1,0
6,441,441,9,6,3,2,1
3,453,453,88,6,82,3,2
15,460,460,73,22,51,4,3
1,468,468,83,83,0,1,0
22,477,477,11,11,0,1,0
18,484,484,20,20,0,1,0

1,131,131,28,4,24,2,1
9,138,138,13,10,3,2,1
6,143,143,9,9,0,1,0
8,144,144,18,3,15,4,3
0,147,147,7,7,0,1,0
16,148,148,2,2,0,1,0
18,258,258,32,14,18,4,3
10,266,266,4,4,0,1,0
5,285,285,11,2,9,2,1
19,291,291,88,88,0,1,0
15,299,299,12,1,11,2,1
2,323,323,62,62,0,1,0
7,343,343,19,10,9,4,3
4,346,346,3,3,0,1,0
13,401,401,68,68,0,1,0
3,422,422,62,62,0,1,0
11,437,437,77,13,64,3,2
12,443,443,36,36,0,1,0
14,449,449,39,39,0,1,0
17,451,451,8,8,0,1,0

10,114,114,57,57,0,1,0
8,120,120,4,4,0,1,0
3,134,134,11,11,0,1,0
13,144,144,3,3,0,1,0
7,232,232,19,19,0,1,0
9,277,277,3,3,0,1,0
11,283,283,67,8,59,3,2
0,289,289,17,7,10,3,2
15,294,294,11,6,5,2,1
12,325,325,19,6,13,2,1
6,349,349,34,10,24,4,3
14,386,386,16,16,0,1,0
1,391,391,51,51,0,1,0
2,412,412,33,15,18,4,3
5,417,417,198,108,90,4,3
4,471,471,36,12,24,4,3

9,111,111,1,1,0,1,0
14,134,134,8,2,6,3,2
2,142,142,24,6,18,2,1
0,187,187,35,35,0,1,0
13,214,214,26,26,0,1,0
10,219,219,23,20,3,2,1
4,229,229,48,1,47,2,1
8,232,232,1,1,0,1,0
12,252,252,97,97,0,1,0
6,320,320,16,16,0,1,0
7,392,392,70,53,17,2,1
1,450,450,17,17,0,1,0
3,468,468,121,55,66,4,3
11,484,484,55,34,21,4,3
5,498,498,69,21,48,4,3

17,146,146,1,1,0,1,0
14,151,151,34,34,0,1,0
18,157,157,3,3,0,1,0
4,179,179,26,19,7,2,1
12,201,201,14,14,0,1,0
2,223,223,23,23,0,1,0
13,274,274,10,10,0,1,0
0,281,281,43,4,39,4,3
5,282,282,35,35,0,1,0
16,282,282,72,13,59,3,2
6,293,293,36,12,24,3,2
9,316,316,25,25,0,1,0
7,333,333,9,4,5,2,1
3,343,343,25,25,0,1,0
10,347,347,49,49,0,1,0
1,353,353,11,11,0,1,0
15,359,359,128,128,0,1,0
8,390,390,1,1,0,1,0
19,426,426,10,10,0,1,0
11,496,496,13,1,12,4,3

9,100,100,9,9,0,1,0
14,115,115,8,8,0,1,0
19,118,118,10,10,0,1,0
18,124,124,16,16,0,1,0
3,172,172,32,8,24,2,1
5,174,174,1,1,0,1,0
11,208,208,2,2,0,1,0
23,233,233,8,8,0,1,0
17,251,251,13,2,11,2,1
22,280,280,56,56,0,1,0
13,294,294,22,22,0,1,0
6,305,305,3,3,0,1,0
12,311,311,2,2,0,1,0
21,336,336,73,73,0,1,0
7,350,350,18,18,0,1,0
4,352,352,25,7,18,2,1
10,363,363,24,24,0,1,0
20,369,369,28,28,0,1,0
0,376,376,19,1,18,2,1
8,376,376,19,9,10,3,2
1,445,445,52,52,0,1,0
15,452,452,53,17,36,4,3
16,457,457,48,48,0,1,0
2,469,469,69,69,0,1,0

3,109,109,17,17,0,1,0
11,111,111,26,6,20,2,1
8,126,126,1,1,0,1,0
4,149,149,12,12,0,1,0
17,160,160,1,1,0,1,0
2,200,200,8,8,0,1,0
0,246,246,4,1,3,2,1
9,265,265,3,3,0,1,0
13,266,266,49,36,13,2,1
7,307,307,8,5,3,2,1
16,331,331,76,10,66,4,3
14,346,346,10,10,0,1,0
12,389,389,5,2,3,2,1
1,399,399,8,8,0,1,0
15,400,400,93,75,18,4,3
10,403,403,34,34,0,1,0
5,436,436,228,158,70,3,2
6,467,467,61,61,0,1,0

7,116,116,11,5,6,2,1
0,141,141,16,10,6,3,2
18,149,149,6,3,3,2,1
11,154,154,18,18,0,1,0
10,163,163,4,4,0,1,0
9,171,171,20,8,12,4,3
6,175,175,1,1,0,1,0
12,179,179,9,5,4,2,1
13,197,197,14,14,0,1,0
4,239,239,10,10,0,1,0
16,247,247,14,3,11,2,1
21,266,266,9,9,0,1,0
1,272,272,5,5,0,1,0
14,294,294,76,8,68,4,3
8,307,307,85,85,0,1,0
15,322,322,1,1,0,1,0
5,333,333,5,5,0,1,0
19,378,378,87,43,44,3,2
20,389,389,86,43,43,2,1
3,411,411,26,26,0,1,0
17,450,450,46,46,0,1,0
2,475,475,32,32,0,1,0

1,112,112,1,1,0,1,0
14,129,129,22,22,0,1,0
18,133,133,62,15,47,2,1
17,145,145,19,19,0,1,0
3,166,166,3,3,0,1,0
9,200,200,30,30,0,1,0
19,207,207,9,3,6,2,1
6,217,217,28,3,25,2,1
16,245,245,19,19,0,1,0
8,280,280,43,43,0,1,0
11,308,308,26,8,18,3,2
13,323,323,9,3,6,3,2
5,362,362,66,28,38,3,2
12,395,395,9,9,0,1,0
0,395,395,4,4,0,1,0
15,403,403,2,2,0,1,0
10,409,409,49,49,0,1,0
7,436,436,27,5,22,4,3
2,450,450,56,56,0,1,0
4,461,461,20,15,5,2,1

18,105,105,7,7,0,1,0
6,118,118,7,7,0,1,0
15,147,147,18,6,12,4,3
17,167,167,17,17,0,1,0
12,183,183,1,1,0,1,0
0,200,200,3,3,0,1,0
11,243,243,21,7,14,2,1
8,251,251,24,24,0,1,0
9,253,253,21,6,15,2,1
14,255,255,116,116,0,1,0
10,258,258,8,8,0,1,0
5,330,330,15,15,0,1,0
3,341,341,124,55,69,4,3
16,346,346,3,3,0,1,0
7,364,364,32,32,0,1,0
13,395,395,55,12,43,3,2
2,422,422,25,11,14,2,1
4,441,441,25,25,0,1,0
1,491,491,67,59,8,2,1

5,123,123,22,1,21,4,3
10,127,127,17,17,0,1,0
4,135,135,3,3,0,1,0
13,138,138,29,29,0,1,0
2,177,177,1,1,0,1,0
15,215,215,46,46,0,1,0
16,218,218,6,6,0,1,0
12,265,265,32,16,16,3,2
3,338,338,59,1,58,4,3
9,352,352,28,28,0,1,0
7,370,370,98,83,15,4,3
1,370,370,94,55,39,2,1
8,405,405,23,23,0,1,0
11,443,443,57,57,0,1,0
0,461,461,27,3,24,3,2
6,484,484,20,11,9,4,3
14,484,484,22,6,16,2,1

0,110,110,7,7,0,1,0
13,130,130,3,3,0,1,0
6,153,153,3,3,0,1,0
1,176,176,9,9,0,1,0
16,218,218,9,9,0,1,0
15,225,225,44,44,0,1,0
18,262,262,6,2,4,2,1
2,314,314,31,24,7,2,1
11,314,314,7,7,0,1,0
19,322,322,82,82,0,1,0
17,325,325,20,11,9,2,1
5,352,352,8,8,0,1,0
12,374,374,79,63,16,2,1
9,375,375,89,31,58,3,2
7,393,393,48,27,21,2,1
4,399,399,1,1,0,1,0
14,426,426,78,25,53,4,3
3,440,440,60,33,27,2,1
8,491,491,30,30,0,1,0
10,498,498,92,92,0,1,0

11,111,111,5,2,3,2,1
8,114,114,3,3,0,1,0
16,127,127,11,3,8,2,1
0,138,138,38,35,3,2,1
5,190,190,6,6,0,1,0
17,218,218,47,47,0,1,0
3,239,239,26,11,15,2,1
1,274,274,50,50,0,1,0
18,351,351,50,31,19,2,1
15,357,357,19,19,0,1,0
10,364,364,12,12,0,1,0
2,376,376,24,11,13,2,1
7,396,396,1,1,0,1,0
14,409,409,8,8,0,1,0
9,416,416,9,6,3,2,1
4,418,418,2,2,0,1,0
6,425,425,107,81,26,2,1
19,426,426,25,25,0,1,0
13,433,433,73,73,0,1,0
12,446,446,101,37,64,3,2

7,104,104,20,6,14,3,2
11,107,107,4,4,0,1,0
10,121,121,13,13,0,1,0
13,140,140,26,11,15,4,3
15,251,251,1,1,0,1,0
16,258,258,46,46,0,1,0
4,267,267,21,21,0,1,0
18,284,284,40,30,10,2,1
8,301,301,31,31,0,1,0
14,307,307,23,23,0,1,0
12,330,330,47,47,0,1,0
9,349,349,39,21,18,2,1
2,351,351,105,49,56,3,2
5,371,371,14,5,9,4,3
0,376,376,20,20,0,1,0
3,400,400,28,4,24,3,2
6,412,412,16,16,0,1,0
17,442,442,67,67,0,1,0
1,451,451,7,7,0,1,0

5,136,136,22,9,13,4,3
14,144,144,3,3,0,1,0
16,148,148,35,35,0,1,0
7,153,153,3,3,0,1,0
15,189,189,50,50,0,1,0
2,211,211,24,24,0,1,0
9,280,280,16,16,0,1,0
18,289,289,13,13,0,1,0
20,303,303,32,32,0,1,0
4,305,305,7,7,0,1,0
1,315,315,43,18,25,2,1
12,324,324,14,14,0,1,0
17,368,368,20,20,0,1,0
10,380,380,20,8,12,3,2
6,387,387,4,1,3,2,1
13,395,395,8,8,0,1,0
8,420,420,57,15,42,4,3
19,442,442,97,90,7,2,1
3,448,448,77,77,0,1,0
0,484,484,33,7,26,2,1
11,499,499,25,25,0,1,0

7,149,149,36,26,10,2,1
18,161,161,15,3,12,2,1
0,189,189,15,3,12,4,3
4,190,190,5,5,0,1,0
8,214,214,27,27,0,1,0
3,242,242,17,7,10,2,1
6,260,260,20,20,0,1,0
16,277,277,7,7,0,1,0
2,287,287,6,6,0,1,0
1,290,290,9,9,0,1,0
15,293,293,11,11,0,1,0
17,295,295,152,84,68,3,2
9,317,317,22,22,0,1,0
10,352,352,77,29,48,2,1
13,363,363,16,16,0,1,0
5,379,379,15,1,14,3,2
14,456,456,12,12,0,1,0
11,464,464,12,12,0,1,0
12,465,465,104,104,0,1,0
19,477,477,11,11,0,1,0

7,146,146,29,4,25,2,1
3,171,171,6,6,0,1,0
2,193,193,16,16,0,1,0
8,199,199,26,11,15,2,1
15,212,212,39,4,35,2,1
5,224,224,55,27,28,3,2
1,242,242,43,24,19,2,1
10,253,253,6,6,0,1,0
12,300,300,10,10,0,1,0
0,329,329,7,7,0,1,0
13,356,356,67,67,0,1,0
9,362,362,64,60,4,2,1
14,384,384,10,2,8,2,1
6,398,398,171,163,8,2,1
11,412,412,22,22,0,1,0
4,428,428,4,1,3,2,1

11,104,104,12,12,0,1,0
13,168,168,6,2,4,2,1
20,169,169,13,2,11,2,1
1,198,198,44,5,39,2,1
19,210,210,12,3,9,4,3
5,212,212,2,2,0,1,0
16,265,265,20,9,11,2,1
12,275,275,1,1,0,1,0
7,277,277,33,33,0,1,0
17,278,278,30,1,29,2,1
9,304,304,9,9,0,1,0
18,338,338,104,75,29,3,2
3,339,339,16,5,11,2,1
14,342,342,36,6,30,4,3
6,384,384,11,8,3,2,1
0,394,394,26,26,0,1,0
15,396,396,60,60,0,1,0
21,407,407,41,41,0,1,0
2,411,411,2,2,0,1,0
8,424,424,15,15,0,1,0
10,483,483,13,2,11,4,3
4,484,484,142,109,33,4,3

19,112,112,16,3,13,2,1
1,114,114,21,21,0,1,0
11,124,124,3,3,0,1,0
2,135,135,11,6,5,2,1
7,135,135,16,1,15,4,3
13,170,170,2,2,0,1,0
0,193,193,16,16,0,1,0
3,204,204,2,2,0,1,0
9,237,237,3,3,0,1,0
14,253,253,46,46,0,1,0
5,255,255,3,3,0,1,0
10,266,266,7,1,6,3,2
16,283,283,87,19,68,3,2
18,334,334,12,3,9,2,1
6,357,357,16,16,0,1,0
15,362,362,1,1,0,1,0
8,364,364,8,8,0,1,0
17,475,475,35,11,24,2,1
4,481,481,196,102,94,3,2
12,483,483,116,18,98,3,2

10,104,104,6,3,3,2,1
15,108,108,14,14,0,1,0
16,114,114,13,7,6,3,2
18,121,121,28,28,0,1,0
12,156,156,12,12,0,1,0
9,166,166,1,1,0,1,0
1,190,190,23,23,0,1,0
3,216,216,2,2,0,1,0
20,221,221,15,15,0,1,0
0,242,242,15,12,3,2,1
4,293,293,22,18,4,2,1
11,294,294,99,55,44,2,1
2,312,312,16,16,0,1,0
14,351,351,18,1,17,2,1
7,367,367,37,29,8,3,2
19,388,388,31,31,0,1,0
5,406,406,12,12,0,1,0
13,433,433,76,22,54,3,2
17,446,446,46,46,0,1,0
8,447,447,48,14,34,3,2
6,479,479,22,7,15,3,2

14,102,102,12,12,0,1,0
10,106,106,2,2,0,1,0
11,114,114,3,3,0,1,0
8,164,164,4,4,0,1,0
12,194,194,10,1,9,4,3
3,199,199,42,10,32,3,2
0,237,237,24,11,13,2,1
5,238,238,11,11,0,1,0
16,267,267,57,9,48,4,3
9,308,308,41,41,0,1,0
18,309,309,54,6,48,3,2
13,379,379,59,18,41,2,1
2,410,410,150,102,48,4,3
1,410,410,5,5,0,1,0
17,421,421,1,1,0,1,0
15,446,446,120,120,0,1,0
7,449,449,42,42,0,1,0
6,465,465,5,5,0,1,0
4,484,484,2,2,0,1,0

5,128,128,3,3,0,1,0
13,139,139,14,14,0,1,0
2,142,142,1,1,0,1,0
21,159,159,46,19,27,4,3
22,163,163,2,2,0,1,0
12,197,197,5,5,0,1,0
1,215,215,3,3,0,1,0
4,217,217,73,73,0,1,0
17,223,223,31,22,9,4,3
11,229,229,6,6,0,1,0
10,290,290,8,3,5,2,1
9,366,366,17,17,0,1,0
18,392,392,26,26,0,1,0
14,394,394,31,31,0,1,0
7,395,395,21,21,0,1,0
15,410,410,1,1,0,1,0
16,421,421,143,143,0,1,0
0,431,431,85,85,0,1,0
20,431,431,22,14,8,3,2
3,441,441,39,39,0,1,0
19,487,487,20,2,18,4,3
8,497,497,17,3,14,3,2
6,498,498,11,11,0,1,0

0,120,120,2,2,0,1,0
14,162,162,26,26,0,1,0
10,163,163,2,2,0,1,0
20,171,171,37,13,24,2,1
16,191,191,17,17,0,1,0
4,275,275,1,1,0,1,0
7,304,304,5,5,0,1,0
13,329,329,12,12,0,1,0
6,338,338,6,6,0,1,0
11,343,343,28,28,0,1,0
15,362,362,90,6,84,4,3
19,364,364,2,2,0,1,0
22,386,386,22,1,21,2,1
1,390,390,4,4,0,1,0
2,408,408,5,5,0,1,0
9,414,414,29,15,14,2,1
12,427,427,35,26,9,2,1
5,439,439,70,43,27,4,3
21,452,452,12,6,6,3,2
18,467,467,58,39,19,2,1
3,491,491,11,5,6,2,1
8,498,498,229,229,0,1,0
17,498,498,46,37,9,2,1

15,110,110,6,3,3,2,1
0,135,135,4,4,0,1,0
22,165,165,17,6,11,2,1
12,190,190,3,3,0,1,0
8,211,211,1,1,0,1,0
17,216,216,59,33,26,3,2
3,224,224,20,17,3,2,1
1,248,248,36,36,0,1,0
7,272,272,9,1,8,3,2
10,283,283,35,2,33,4,3
6,295,295,11,11,0,1,0
21,309,309,9,9,0,1,0
23,318,318,28,8,20,3,2
11,324,324,41,28,13,2,1
5,342,342,42,42,0,1,0
2,373,373,1,1,0,1,0
4,386,386,5,5,0,1,0
25,407,407,15,15,0,1,0
13,407,407,26,26,0,1,0
16,431,431,15,15,0,1,0
19,433,433,52,33,19,2,1
9,436,436,29,11,18,4,3
20,455,455,94,94,0,1,0
18,467,467,36,36,0,1,0
14,474,474,18,18,0,1,0
24,497,497,41,13,28,3,2

0,164,164,8,8,0,1,0
8,203,203,36,6,30,4,3
11,227,227,6,6,0,1,0
9,239,239,3,3,0,1,0
6,307,307,37,37,0,1,0
10,314,314,103,103,0,1,0
3,327,327,53,53,0,1,0
16,332,332,69,45,24,3,2
12,333,333,61,10,51,3,2
13,347,347,1,1,0,1,0
1,379,379,12,8,4,2,1
2,381,381,64,12,52,3,2
7,417,417,17,1,16,3,2
17,437,437,49,4,45,4,3
5,459,459,81,81,0,1,0
14,464,464,35,35,0,1,0
4,480,480,38,38,0,1,0
15,481,481,32,32,0,1,0

18,111,111,3,3,0,1,0
0,147,147,47,25,22,2,1
13,177,177,58,19,39,2,1
10,188,188,3,3,0,1,0
14,205,205,73,73,0,1,0
16,219,219,44,16,28,2,1
9,223,223,19,2,17,2,1
17,230,230,14,14,0,1,0
15,247,247,2,2,0,1,0
6,262,262,34,4,30,3,2
5,266,266,30,30,0,1,0
4,332,332,1,1,0,1,0
3,352,352,25,25,0,1,0
2,439,439,44,44,0,1,0
11,441,441,1,1,0,1,0
1,454,454,24,24,0,1,0
12,455,455,10,10,0,1,0
7,482,482,9,6,3,2,1
8,492,492,53,35,18,4,3

9,106,106,7,7,0,1,0
19,119,119,9,9,0,1,0
12,122,122,2,2,0,1,0
6,126,126,1,1,0,1,0
13,163,163,6,6,0,1,0
8,194,194,27,20,7,2,1
14,199,199,21,7,14,3,2
7,215,215,5,2,3,2,1
10,218,218,7,7,0,1,0
3,284,284,34,3,31,2,1
1,284,284,8,1,7,2,1
11,294,294,79,42,37,2,1
15,300,300,37,37,0,1,0
4,307,307,6,6,0,1,0
16,322,322,63,20,43,2,1
2,379,379,1,1,0,1,0
5,401,401,15,15,0,1,0
18,413,413,4,4,0,1,0
17,476,476,93,53,40,4,3
0,481,481,253,201,52,3,2

18,127,127,44,31,13,2,1
6,137,137,16,16,0,1,0
8,144,144,9,9,0,1,0
5,188,188,11,3,8,3,2
15,227,227,7,7,0,1,0
10,285,285,6,6,0,1,0
9,287,287,15,15,0,1,0
17,299,299,53,53,0,1,0
7,302,302,19,7,12,4,3
16,308,308,25,13,12,3,2
1,348,348,40,40,0,1,0
14,350,350,101,21,80,3,2
19,366,366,2,2,0,1,0
12,369,369,6,1,5,2,1
2,424,424,11,11,0,1,0
3,435,435,123,123,0,1,0
11,441,441,7,7,0,1,0
13,448,448,21,21,0,1,0
0,454,454,59,17,42,4,3
4,469,469,34,34,0,1,0

13,124,124,64,64,0,1,0
7,208,208,20,20,0,1,0
16,215,215,13,13,0,1,0
8,227,227,16,1,15,3,2
15,247,247,4,4,0,1,0
12,280,280,1,1,0,1,0
10,305,305,42,42,0,1,0
6,327,327,16,10,6,2,1
9,333,333,30,30,0,1,0
17,342,342,28,28,0,1,0
2,351,351,74,2,72,4,3
11,385,385,41,41,0,1,0
0,412,412,48,48,0,1,0
3,430,430,27,27,0,1,0
5,435,435,102,32,70,4,3
14,443,443,1,1,0,1,0
1,473,473,33,33,0,1,0
4,498,498,45,35,10,3,2

8,108,108,2,2,0,1,0
16,142,142,24,12,12,3,2
2,169,169,7,7,0,1,0
6,171,171,7,7,0,1,0
17,179,179,14,14,0,1,0
19,188,188,10,4,6,2,1
1,190,190,15,15,0,1,0
7,209,209,1,1,0,1,0
0,216,216,89,53,36,2,1
12,235,235,22,15,7,2,1
18,238,238,71,48,23,3,2
15,251,251,30,16,14,4,3
13,265,265,20,20,0,1,0
11,397,397,36,18,18,2,1
10,424,424,82,19,63,4,3
3,450,450,1,1,0,1,0
4,468,468,1,1,0,1,0
14,471,471,20,20,0,1,0
5,483,483,63,63,0,1,0
9,489,489,37,37,0,1,0

11,103,103,1,1,0,1,0
9,145,145,7,7,0,1,0
8,149,149,17,17,0,1,0
7,157,157,8,8,0,1,0
3,219,219,30,15,15,2,1
16,243,243,9,9,0,1,0
2,245,245,11,1,10,3,2
17,291,291,49,49,0,1,0
6,313,313,28,28,0,1,0
1,327,327,26,15,11,2,1
4,344,344,43,15,28,2,1
15,349,349,121,77,44,2,1
13,374,374,29,29,0,1,0
10,395,395,82,82,0,1,0
0,416,416,32,10,22,3,2
14,453,453,39,10,29,2,1
5,465,465,134,134,0,1,0
12,483,483,18,18,0,1,0

11,104,104,1,1,0,1,0
1,108,108,5,5,0,1,0
12,146,146,1,1,0,1,0
8,177,177,11,11,0,1,0
16,203,203,30,30,0,1,0
4,207,207,23,23,0,1,0
13,207,207,28,28,0,1,0
2,244,244,93,51,42,3,2
6,254,254,19,19,0,1,0
5,276,276,47,47,0,1,0
0,281,281,5,5,0,1,0
10,289,289,5,5,0,1,0
7,291,291,25,1,24,4,3
14,292,292,17,17,0,1,0
17,300,300,86,86,0,1,0
3,312,312,16,16,0,1,0
9,319,319,99,1,98,3,2
15,386,386,19,19,0,1,0

6,100,100,8,8,0,1,0
13,103,103,13,13,0,1,0
17,146,146,2,2,0,1,0
11,154,154,15,15,0,1,0
14,165,165,29,29,0,1,0
10,210,210,21,21,0,1,0
15,217,217,36,36,0,1,0
12,230,230,12,12,0,1,0
8,233,233,42,7,35,2,1
9,260,260,8,3,5,2,1
5,261,261,71,23,48,3,2
0,265,265,4,4,0,1,0
1,270,270,38,38,0,1,0
3,321,321,4,4,0,1,0
4,322,322,43,43,0,1,0
2,341,341,5,5,0,1,0
16,361,361,102,82,20,4,3
7,423,423,52,30,22,2,1
18,432,432,5,5,0,1,0

15,142,142,29,6,23,2,1
14,170,170,23,23,0,1,0
6,174,174,45,45,0,1,0
11,231,231,25,25,0,1,0
0,252,252,35,11,24,2,1
2,263,263,7,7,0,1,0
12,298,298,13,1,12,2,1
4,319,319,107,73,34,2,1
13,331,331,32,16,16,3,2
7,349,349,73,73,0,1,0
8,366,366,8,4,4,2,1
1,391,391,53,53,0,1,0
9,392,392,71,11,60,4,3
5,408,408,16,16,0,1,0
3,452,452,31,31,0,1,0
10,469,469,9,9,0,1,0

5,114,114,2,2,0,1,0
11,137,137,3,3,0,1,0
13,147,147,31,5,26,4,3
8,148,148,4,1,3,2,1
0,151,151,78,30,48,3,2
2,172,172,21,12,9,2,1
12,199,199,44,11,33,4,3
6,200,200,21,21,0,1,0
7,205,205,25,10,15,4,3
4,274,274,33,9,24,2,1
1,409,409,89,89,0,1,0
10,416,416,20,20,0,1,0
9,457,457,117,24,93,4,3
3,496,496,13,5,8,2,1

28,133,133,29,1,28,2,1
23,133,133,8,8,0,1,0
13,137,137,2,2,0,1,0
21,142,142,10,2,8,2,1
1,147,147,4,4,0,1,0
27,148,148,10,10,0,1,0
6,170,170,4,4,0,1,0
15,180,180,2,2,0,1,0
19,184,184,1,1,0,1,0
7,209,209,26,26,0,1,0
11,260,260,12,8,4,2,1
16,270,270,1,1,0,1,0
3,322,322,72,72,0,1,0
14,335,335,14,5,9,2,1
2,348,348,25,25,0,1,0
26,377,377,92,92,0,1,0
22,379,379,36,36,0,1,0
29,386,386,30,11,19,2,1
8,388,388,16,1,15,2,1
12,396,396,3,3,0,1,0
20,398,398,15,15,0,1,0
4,423,423,11,2,9,4,3
17,428,428,23,7,16,2,1
18,432,432,19,4,15,4,3
5,448,448,15,2,13,2,1
9,483,483,11,11,0,1,0
25,485,485,15,15,0,1,0
10,492,492,49,41,8,2,1
24,496,496,80,80,0,1,0
0,498,498,21,21,0,1,0

6,117,117,18,2,16,3,2
14,132,132,15,3,12,4,3
1,139,139,16,2,14,3,2
18,140,140,3,3,0,1,0
7,141,141,2,2,0,1,0
21,163,163,6,6,0,1,0
11,217,217,4,4,0,1,0
10,227,227,7,7,0,1,0
4,229,229,30,30,0,1,0
15,248,248,19,12,7,2,1
19,254,254,91,12,79,3,2
16,263,263,3,3,0,1,0
22,265,265,39,39,0,1,0
17,267,267,29,16,13,2,1
9,270,270,4,1,3,2,1
13,295,295,21,13,8,2,1
12,374,374,12,6,6,3,2
3,391,391,1,1,0,1,0
20,392,392,60,60,0,1,0
2,409,409,4,4,0,1,0
0,447,447,69,69,0,1,0
5,456,456,73,73,0,1,0
8,467,467,43,3,40,3,2

1,114,114,16,3,13,2,1
9,136,136,22,22,0,1,0
8,173,173,13,1,12,3,2
20,177,177,5,2,3,2,1
6,193,193,10,10,0,1,0
21,219,219,26,26,0,1,0
19,219,219,40,40,0,1,0
10,250,250,16,9,7,2,1
18,262,262,9,1,8,3,2
15,291,291,29,29,0,1,0
3,304,304,11,1,10,3,2
7,327,327,10,10,0,1,0
13,347,347,48,45,3,2,1
2,375,375,6,1,5,2,1
17,379,379,64,64,0,1,0
22,401,401,35,35,0,1,0
14,404,404,25,12,13,2,1
4,405,405,36,36,0,1,0
16,415,415,98,98,0,1,0
0,421,421,39,39,0,1,0
11,454,454,2,2,0,1,0
5,461,461,22,22,0,1,0
12,476,476,26,14,12,3,2

4,110,110,2,2,0,1,0
15,155,155,13,13,0,1,0
17,159,159,20,20,0,1,0
20,164,164,10,10,0,1,0
5,171,171,22,22,0,1,0
10,188,188,1,1,0,1,0
0,189,189,13,1,12,4,3
9,192,192,23,11,12,4,3
7,227,227,1,1,0,1,0
21,272,272,22,13,9,4,3
3,274,274,7,2,5,2,1
14,274,274,9,9,0,1,0
6,299,299,34,34,0,1,0
8,300,300,25,25,0,1,0
16,361,361,165,24,141,4,3
12,364,364,135,41,94,3,2
1,402,402,13,7,6,2,1
13,409,409,35,35,0,1,0
18,460,460,21,21,0,1,0
19,471,471,24,24,0,1,0
2,483,483,1,1,0,1,0
11,500,500,14,14,0,1,0

0,140,140,10,10,0,1,0
17,174,174,8,8,0,1,0
6,179,179,23,3,20,2,1
13,179,179,8,8,0,1,0
5,181,181,29,13,16,2,1
2,183,183,19,3,16,4,3
15,215,215,58,58,0,1,0
4,223,223,8,8,0,1,0
16,224,224,4,4,0,1,0
10,239,239,20,8,12,4,3
8,275,275,1,1,0,1,0
11,282,282,39,39,0,1,0
1,353,353,62,62,0,1,0
7,355,355,43,43,0,1,0
9,366,366,45,5,40,4,3
12,386,386,61,1,60,3,2
14,396,396,93,75,18,2,1
18,407,407,12,12,0,1,0
3,481,481,37,5,32,3,2

16,120,120,12,4,8,2,1
10,153,153,11,11,0,1,0
6,158,158,1,1,0,1,0
11,185,185,3,3,0,1,0
9,188,188,44,1,43,2,1
2,204,204,107,21,86,3,2
0,222,222,1,1,0,1,0
13,247,247,2,2,0,1,0
3,302,302,7,7,0,1,0
5,354,354,51,51,0,1,0
17,362,362,114,6,108,4,3
8,369,369,18,8,10,2,1
14,394,394,85,85,0,1,0
12,399,399,16,7,9,4,3
1,410,410,8,8,0,1,0
15,441,441,7,4,3,2,1
4,471,471,107,84,23,2,1
7,489,489,1,1,0,1,0

4,104,104,11,1,10,3,2
8,105,105,6,1,5,2,1
9,116,116,17,9,8,3,2
6,124,124,3,3,0,1,0
7,162,162,3,3,0,1,0
10,191,191,4,4,0,1,0
17,213,213,8,8,0,1,0
11,228,228,1,1,0,1,0
18,240,240,72,10,62,3,2
5,257,257,7,7,0,1,0
12,267,267,10,10,0,1,0
13,272,272,15,3,12,4,3
3,305,305,52,26,26,4,3
14,324,324,15,1,14,3,2
0,340,340,111,111,0,1,0
19,399,399,66,66,0,1,0
16,415,415,24,24,0,1,0
1,437,437,10,10,0,1,0
15,437,437,48,48,0,1,0
20,471,471,96,82,14,3,2
2,477,477,38,38,0,1,0

16,100,100,3,3,0,1,0
12,100,100,2,2,0,1,0
20,152,152,18,4,14,3,2
6,216,216,5,5,0,1,0
13,222,222,6,1,5,2,1
5,226,226,61,61,0,1,0
3,240,240,24,3,21,4,3
2,255,255,20,20,0,1,0
14,275,275,108,87,21,2,1
4,278,278,11,3,8,2,1
21,288,288,9,9,0,1,0
17,290,290,18,14,4,2,1
18,307,307,29,29,0,1,0
8,312,312,31,31,0,1,0
15,340,340,5,5,0,1,0
1,354,354,56,56,0,1,0
11,382,382,26,11,15,2,1
9,385,385,7,7,0,1,0
19,395,395,99,19,80,4,3
0,422,422,21,21,0,1,0
10,432,432,2,2,0,1,0
7,461,461,33,33,0,1,0

13,101,101,17,7,10,2,1
17,157,157,3,3,0,1,0
11,165,165,17,17,0,1,0
15,207,207,11,3,8,2,1
4,211,211,1,1,0,1,0
16,227,227,19,19,0,1,0
14,247,247,40,1,39,2,1
12,247,247,17,4,13,2,1
2,269,269,66,14,52,3,2
7,285,285,7,7,0,1,0
6,303,303,37,37,0,1,0
1,308,308,12,12,0,1,0
3,313,313,30,30,0,1,0
10,400,400,146,146,0,1,0
0,472,472,132,123,9,2,1
9,476,476,1,1,0,1,0
8,486,486,6,3,3,2,1
5,494,494,88,27,61,3,2

16,141,141,26,2,24,3,2
4,145,145,13,13,0,1,0
19,172,172,21,21,0,1,0
15,204,204,5,5,0,1,0
2,211,211,27,2,25,3,2
0,218,218,25,25,0,1,0
6,248,248,23,9,14,2,1
14,313,313,3,3,0,1,0
8,322,322,39,39,0,1,0
3,354,354,36,17,19,2,1
12,369,369,100,51,49,2,1
1,371,371,14,14,0,1,0
7,375,375,34,34,0,1,0
5,405,405,4,1,3,2,1
10,415,415,3,3,0,1,0
9,431,431,90,26,64,4,3
11,456,456,10,10,0,1,0
17,479,479,24,3,21,4,3
13,482,482,31,31,0,1,0
18,484,484,128,53,75,4,3

12,147,147,13,13,0,1,0
6,170,170,32,32,0,1,0
11,213,213,11,11,0,1,0
3,220,220,78,78,0,1,0
5,228,228,40,40,0,1,0
0,234,234,2,2,0,1,0
9,254,254,44,44,0,1,0
14,293,293,18,18,0,1,0
8,313,313,40,40,0,1,0
10,316,316,21,4,17,2,1
4,375,375,9,9,0,1,0
7,393,393,77,77,0,1,0
13,393,393,26,10,16,2,1
2,424,424,171,171,0,1,0
1,452,452,17,17,0,1,0

3,103,103,9,9,0,1,0
16,109,109,15,3,12,4,3
8,115,115,24,18,6,3,2
0,120,120,2,2,0,1,0
7,135,135,11,11,0,1,0
18,144,144,77,20,57,4,3
17,164,164,3,3,0,1,0
14,166,166,12,12,0,1,0
1,187,187,17,17,0,1,0
10,230,230,1,1,0,1,0
21,257,257,8,8,0,1,0
19,264,264,17,7,10,2,1
20,317,317,11,5,6,2,1
9,342,342,12,3,9,2,1
5,356,356,55,10,45,4,3
13,368,368,39,39,0,1,0
4,412,412,13,3,10,2,1
6,413,413,1,1,0,1,0
15,430,430,11,11,0,1,0
2,442,442,28,28,0,1,0
11,446,446,91,62,29,4,3
12,480,480,10,10,0,1,0

4,102,102,11,5,6,2,1
17,139,139,19,7,12,3,2
6,148,148,12,12,0,1,0
7,152,152,12,2,10,3,2
20,158,158,5,5,0,1,0
3,183,183,1,1,0,1,0
1,195,195,12,12,0,1,0
11,202,202,13,13,0,1,0
15,210,210,28,4,24,4,3
12,221,221,60,53,7,2,1
9,275,275,1,1,0,1,0
14,319,319,24,24,0,1,0
0,323,323,65,65,0,1,0
10,331,331,51,39,12,4,3
5,366,366,73,37,36,2,1
18,436,436,13,13,0,1,0
8,444,444,19,1,18,2,1
2,450,450,1,1,0,1,0
16,471,471,94,83,11,2,1
19,488,488,25,25,0,1,0
13,496,496,43,28,15,2,1

12,101,101,2,2,0,1,0
9,150,150,12,3,9,4,3
7,172,172,52,52,0,1,0
16,187,187,9,4,5,2,1
4,233,233,9,6,3,2,1
18,259,259,9,3,6,2,1
11,264,264,27,14,13,2,1
10,274,274,116,74,42,3,2
0,289,289,3,3,0,1,0
13,302,302,20,20,0,1,0
14,308,308,27,27,0,1,0
5,348,348,46,16,30,3,2
2,372,372,67,64,3,2,1
15,381,381,60,60,0,1,0
8,385,385,14,14,0,1,0
3,398,398,13,10,3,2,1
1,408,408,2,2,0,1,0
17,471,471,35,13,22,2,1
6,482,482,90,41,49,3,2

8,143,143,17,17,0,1,0
7,153,153,20,20,0,1,0
4,169,169,10,10,0,1,0
9,188,188,6,6,0,1,0
3,218,218,61,61,0,1,0
11,231,231,5,1,4,2,1
13,236,236,2,2,0,1,0
19,276,276,75,18,57,4,3
20,288,288,13,13,0,1,0
10,305,305,6,2,4,2,1
18,337,337,45,36,9,4,3
2,347,347,31,31,0,1,0
16,349,349,10,6,4,2,1
6,421,421,37,13,24,4,3
17,442,442,42,4,38,4,3
1,450,450,5,5,0,1,0
0,453,453,55,55,0,1,0
5,455,455,14,8,6,3,2
14,463,463,125,125,0,1,0
12,470,470,11,3,8,2,1
15,490,490,68,68,0,1,0

7,100,100,11,7,4,2,1
10,127,127,16,6,10,3,2
4,204,204,4,4,0,1,0
2,213,213,14,14,0,1,0
8,217,217,8,8,0,1,0
14,245,245,13,13,0,1,0
16,262,262,9,9,0,1,0
15,330,330,30,30,0,1,0
11,340,340,44,9,35,2,1
5,367,367,108,21,87,4,3
1,368,368,62,32,30,4,3
13,369,369,95,57,38,2,1
9,371,371,4,1,3,2,1
6,374,374,74,33,41,2,1
0,416,416,37,9,28,3,2
17,438,438,45,11,34,2,1
12,443,443,95,33,62,3,2
3,465,465,10,10,0,1,0

25,108,108,23,2,21,2,1
16,144,144,31,31,0,1,0
20,153,153,2,2,0,1,0
2,164,164,15,15,0,1,0
24,172,172,5,5,0,1,0
18,179,179,50,50,0,1,0
3,188,188,11,5,6,3,2
22,205,205,1,1,0,1,0
21,207,207,9,1,8,3,2
23,246,246,86,86,0,1,0
14,265,265,19,19,0,1,0
1,270,270,12,12,0,1,0
6,297,297,1,1,0,1,0
26,297,297,15,15,0,1,0
15,298,298,4,4,0,1,0
0,319,319,5,2,3,2,1
8,334,334,18,18,0,1,0
10,335,335,25,9,16,2,1
17,341,341,13,10,3,2,1
11,371,371,11,11,0,1,0
4,379,379,42,26,16,2,1
9,393,393,7,7,0,1,0
12,419,419,34,26,8,2,1
19,440,440,16,2,14,3,2
5,452,452,30,16,14,2,1
7,483,483,3,3,0,1,0
13,499,499,4,1,3,2,1

6,115,115,47,6,41,2,1
14,120,120,9,9,0,1,0
18,168,168,8,8,0,1,0
16,183,183,18,2,16,2,1
10,201,201,10,10,0,1,0
20,234,234,6,6,0,1,0
17,279,279,22,22,0,1,0
9,290,290,2,2,0,1,0
11,292,292,9,5,4,2,1
3,316,316,2,2,0,1,0
13,332,332,106,28,78,4,3
15,334,334,98,66,32,3,2
5,336,336,11,11,0,1,0
8,351,351,73,38,35,4,3
4,371,371,7,1,6,3,2
2,403,403,61,61,0,1,0
0,404,404,5,2,3,2,1
7,431,431,13,13,0,1,0
19,441,441,15,15,0,1,0
12,456,456,23,23,0,1,0
1,479,479,22,22,0,1,0

6,126,126,1,1,0,1,0
20,128,128,15,15,0,1,0
9,155,155,8,8,0,1,0
13,169,169,40,40,0,1,0
10,170,170,10,5,5,2,1
16,194,194,11,8,3,2,1
22,228,228,65,49,16,3,2
11,240,240,25,25,0,1,0
15,247,247,14,14,0,1,0
3,263,263,48,30,18,3,2
2,264,264,6,6,0,1,0
7,284,284,27,27,0,1,0
14,285,285,14,14,0,1,0
18,288,288,11,11,0,1,0
21,301,301,102,102,0,1,0
1,311,311,5,5,0,1,0
17,326,326,11,8,3,2,1
19,367,367,15,15,0,1,0
12,393,393,1,1,0,1,0
8,427,427,24,4,20,2,1
0,469,469,74,1,73,4,3
4,469,469,1,1,0,1,0
5,488,488,4,4,0,1,0

1,110,110,1,1,0,1,0
2,136,136,10,10,0,1,0
22,146,146,20,20,0,1,0
0,149,149,1,1,0,1,0
4,195,195,1,1,0,1,0
10,198,198,18,18,0,1,0
13,204,204,3,3,0,1,0
5,252,252,26,22,4,2,1
8,255,255,23,23,0,1,0
9,263,263,16,3,13,2,1
20,264,264,5,5,0,1,0
15,279,279,11,11,0,1,0
12,285,285,4,4,0,1,0
14,299,299,57,45,12,2,1
16,323,323,4,1,3,2,1
24,329,329,13,5,8,3,2
21,357,357,7,7,0,1,0
18,365,365,204,62,142,4,3
23,412,412,23,23,0,1,0
11,419,419,1,1,0,1,0
19,430,430,63,7,56,3,2
7,464,464,12,4,8,3,2
6,465,465,53,53,0,1,0
17,481,481,12,12,0,1,0
3,493,493,79,47,32,3,2

10,122,122,44,44,0,1,0
19,154,154,2,2,0,1,0
16,154,154,21,6,15,2,1
4,165,165,8,4,4,2,1
6,177,177,1,1,0,1,0
12,208,208,59,49,10,2,1
13,216,216,16,8,8,3,2
8,242,242,17,17,0,1,0
11,256,256,9,9,0,1,0
3,271,271,25,9,16,3,2
18,275,275,33,33,0,1,0
17,353,353,41,36,5,2,1
1,357,357,52,11,41,4,3
7,378,378,2,2,0,1,0
5,416,416,71,71,0,1,0
14,448,448,56,56,0,1,0
2,459,459,1,1,0,1,0
0,475,475,25,25,0,1,0
15,480,480,54,36,18,2,1
9,481,481,25,25,0,1,0

14,108,108,3,3,0,1,0
12,122,122,5,5,0,1,0
13,152,152,20,20,0,1,0
17,166,166,45,45,0,1,0
21,173,173,39,39,0,1,0
19,191,191,16,10,6,3,2
5,214,214,1,1,0,1,0
10,222,222,21,13,8,2,1
11,226,226,5,5,0,1,0
15,252,252,5,5,0,1,0
8,261,261,11,2,9,2,1
6,262,262,22,9,13,2,1
16,290,290,6,6,0,1,0
0,312,312,10,10,0,1,0
1,329,329,1,1,0,1,0
2,335,335,33,33,0,1,0
9,420,420,59,21,38,3,2
7,429,429,121,47,74,3,2
20,446,446,75,75,0,1,0
3,457,457,66,66,0,1,0
4,460,460,7,4,3,2,1
18,472,472,34,34,0,1,0

0,157,157,11,11,0,1,0
5,162,162,10,10,0,1,0
3,164,164,1,1,0,1,0
7,183,183,91,91,0,1,0
11,203,203,3,3,0,1,0
4,216,216,27,11,16,2,1
17,220,220,19,19,0,1,0
12,228,228,18,8,10,3,2
19,261,261,31,1,30,4,3
14,266,266,11,2,9,2,1
10,271,271,8,5,3,2,1
2,287,287,39,11,28,3,2
16,332,332,7,7,0,1,0
6,345,345,5,5,0,1,0
15,364,364,200,200,0,1,0
9,365,365,3,3,0,1,0
18,422,422,13,1,12,2,1
13,478,478,36,16,20,3,2
8,484,484,16,16,0,1,0
1,493,493,10,4,6,2,1

11,127,127,3,3,0,1,0
7,131,131,2,2,0,1,0
10,198,198,51,25,26,3,2
1,241,241,14,2,12,3,2
0,252,252,148,64,84,4,3
6,332,332,24,14,10,2,1
8,353,353,81,12,69,4,3
5,386,386,54,54,0,1,0
9,391,391,29,29,0,1,0
2,419,419,149,50,99,4,3
3,438,438,80,10,70,3,2
4,477,477,13,13,0,1,0

13,122,122,15,3,12,3,2
3,147,147,14,14,0,1,0
4,153,153,31,31,0,1,0
12,204,204,13,9,4,2,1
1,212,212,26,2,24,3,2
14,244,244,19,13,6,2,1
15,314,314,30,30,0,1,0
16,331,331,16,12,4,2,1
9,341,341,1,1,0,1,0
7,342,342,63,63,0,1,0
5,424,424,56,56,0,1,0
8,425,425,27,27,0,1,0
11,442,442,230,136,94,3,2
6,475,475,74,53,21,4,3
0,477,477,26,26,0,1,0
10,498,498,12,12,0,1,0
2,498,498,27,10,17,2,1

16,107,107,12,12,0,1,0
5,143,143,7,7,0,1,0
3,194,194,17,4,13,2,1
13,216,216,36,36,0,1,0
14,217,217,3,3,0,1,0
10,222,222,85,13,72,3,2
17,248,248,21,21,0,1,0
12,262,262,17,17,0,1,0
1,302,302,1,1,0,1,0
9,324,324,40,7,33,2,1
4,329,329,5,2,3,2,1
15,333,333,68,30,38,4,3
11,372,372,15,15,0,1,0
8,382,382,13,13,0,1,0
19,402,402,40,40,0,1,0
2,414,414,17,17,0,1,0
18,441,441,101,56,45,2,1
0,445,445,42,42,0,1,0
6,491,491,22,1,21,2,1
7,497,497,62,48,14,3,2

10,137,137,9,2,7,2,1
24,153,153,8,8,0,1,0
16,173,173,4,4,0,1,0
1,193,193,2,2,0,1,0
15,196,196,1,1,0,1,0
11,225,225,22,13,9,2,1
17,243,243,41,28,13,2,1
2,264,264,43,43,0,1,0
4,270,270,1,1,0,1,0
9,271,271,76,1,75,4,3
6,284,284,7,1,6,2,1
18,284,284,58,58,0,1,0
19,300,300,54,12,42,3,2
20,302,302,20,20,0,1,0
7,321,321,7,7,0,1,0
13,377,377,15,10,5,2,1
14,383,383,35,31,4,2,1
8,402,402,52,52,0,1,0
22,436,436,87,40,47,4,3
23,439,439,5,5,0,1,0
5,451,451,15,15,0,1,0
21,459,459,18,6,12,2,1
25,469,469,46,46,0,1,0
12,477,477,5,5,0,1,0
3,479,479,1,1,0,1,0
0,494,494,1,1,0,1,0

15,124,124,2,2,0,1,0
12,173,173,2,2,0,1,0
0,178,178,12,1,11,3,2
19,215,215,51,39,12,4,3
7,244,244,28,28,0,1,0
14,248,248,23,23,0,1,0
8,266,266,9,9,0,1,0
20,266,266,80,44,36,4,3
13,303,303,72,72,0,1,0
17,304,304,17,11,6,3,2
16,372,372,15,15,0,1,0
4,373,373,42,11,31,2,1
3,382,382,3,3,0,1,0
18,398,398,8,3,5,2,1
1,403,403,7,7,0,1,0
5,403,403,23,6,17,3,2
10,410,410,17,2,15,4,3
11,430,430,38,26,12,4,3
2,463,463,17,17,0,1,0
9,470,470,148,114,34,4,3
6,490,490,49,36,13,2,1
21,499,499,8,8,0,1,0

1,141,141,1,1,0,1,0
18,190,190,20,20,0,1,0
12,213,213,7,3,4,2,1
9,221,221,12,8,4,2,1
14,222,222,26,26,0,1,0
13,228,228,13,1,12,2,1
15,236,236,16,16,0,1,0
21,238,238,18,2,16,3,2
5,275,275,62,34,28,2,1
4,280,280,74,56,18,2,1
19,284,284,12,12,0,1,0
2,290,290,56,45,11,2,1
10,301,301,1,1,0,1,0
6,327,327,2,2,0,1,0
7,341,341,11,11,0,1,0
22,356,356,67,34,33,4,3
0,381,381,13,13,0,1,0
11,382,382,2,2,0,1,0
3,411,411,17,17,0,1,0
20,421,421,61,13,48,4,3
8,424,424,19,4,15,4,3
17,425,425,101,91,10,3,2
16,430,430,17,6,11,2,1

8,106,106,5,5,0,1,0
13,164,164,5,5,0,1,0
7,185,185,6,1,5,2,1
0,197,197,73,63,10,3,2
1,202,202,10,10,0,1,0
3,227,227,17,17,0,1,0
14,229,229,14,11,3,2,1
17,275,275,66,42,24,3,2
12,319,319,5,5,0,1,0
9,325,325,8,8,0,1,0
16,326,326,82,31,51,4,3
6,379,379,101,52,49,3,2
11,387,387,18,7,11,4,3
5,424,424,39,39,0,1,0
15,424,424,76,68,8,3,2
10,436,436,71,71,0,1,0
2,472,472,14,8,6,2,1
4,483,483,19,14,5,2,1

6,101,101,5,5,0,1,0
16,117,117,5,1,4,2,1
2,133,133,10,10,0,1,0
17,136,136,18,11,7,2,1
4,142,142,59,59,0,1,0
11,153,153,31,31,0,1,0
9,220,220,2,2,0,1,0
15,222,222,19,19,0,1,0
5,308,308,14,14,0,1,0
7,330,330,31,9,22,3,2
12,345,345,10,3,7,2,1
8,378,378,5,2,3,2,1
10,380,380,6,6,0,1,0
1,399,399,57,9,48,3,2
13,406,406,150,150,0,1,0
3,419,419,57,57,0,1,0
14,435,435,55,55,0,1,0
0,457,457,14,3,11,2,1

11,105,105,5,5,0,1,0
17,113,113,7,7,0,1,0
8,116,116,16,16,0,1,0
3,141,141,2,2,0,1,0
15,176,176,13,13,0,1,0
0,190,190,21,1,20,3,2
18,196,196,80,68,12,3,2
14,213,213,12,12,0,1,0
10,264,264,27,2,25,2,1
16,290,290,9,9,0,1,0
7,292,292,19,4,15,2,1
12,337,337,35,8,27,4,3
13,368,368,52,22,30,4,3
5,373,373,17,17,0,1,0
2,383,383,31,31,0,1,0
1,383,383,65,53,12,2,1
4,392,392,46,28,18,3,2
6,405,405,60,60,0,1,0
9,420,420,47,47,0,1,0

4,126,126,4,1,3,2,1
23,189,189,11,1,10,2,1
26,205,205,29,22,7,2,1
9,207,207,4,4,0,1,0
0,227,227,7,3,4,2,1
2,239,239,11,4,7,2,1
19,239,239,12,12,0,1,0
24,243,243,67,16,51,4,3
14,255,255,7,7,0,1,0
21,262,262,36,36,0,1,0
3,275,275,18,18,0,1,0
17,286,286,6,6,0,1,0
6,292,292,26,26,0,1,0
13,334,334,1,1,0,1,0
5,339,339,28,4,24,2,1
20,343,343,30,4,26,2,1
12,345,345,16,9,7,2,1
7,363,363,13,13,0,1,0
1,363,363,21,16,5,2,1
25,379,379,36,36,0,1,0
11,380,380,87,25,62,4,3
10,384,384,15,6,9,3,2
18,419,419,37,37,0,1,0
22,425,425,35,35,0,1,0
16,427,427,60,21,39,3,2
8,463,463,7,7,0,1,0
15,494,494,10,10,0,1,0

15,111,111,6,1,5,2,1
1,127,127,4,4,0,1,0
20,132,132,1,1,0,1,0
2,133,133,16,16,0,1,0
7,141,141,12,12,0,1,0
9,147,147,14,14,0,1,0
19,157,157,1,1,0,1,0
16,158,158,37,37,0,1,0
10,177,177,10,3,7,2,1
11,199,199,24,24,0,1,0
18,203,203,12,12,0,1,0
5,231,231,48,48,0,1,0
6,241,241,3,3,0,1,0
22,254,254,57,18,39,4,3
13,272,272,8,1,7,2,1
0,327,327,4,4,0,1,0
14,337,337,8,8,0,1,0
21,343,343,86,22,64,3,2
8,351,351,16,16,0,1,0
3,401,401,11,2,9,2,1
17,449,449,72,72,0,1,0
12,451,451,24,4,20,2,1
4,456,456,48,9,39,2,1

22,102,102,8,8,0,1,0
20,107,107,9,9,0,1,0
24,112,112,11,11,0,1,0
21,117,117,15,15,0,1,0
8,128,128,6,6,0,1,0
11,167,167,1,1,0,1,0
14,184,184,12,12,0,1,0
19,190,190,2,2,0,1,0
9,210,210,1,1,0,1,0
10,231,231,12,7,5,2,1
6,243,243,14,11,3,2,1
13,247,247,1,1,0,1,0
18,271,271,25,25,0,1,0
3,272,272,44,14,30,3,2
17,276,276,69,40,29,2,1
7,297,297,63,63,0,1,0
1,344,344,36,29,7,2,1
23,380,380,79,55,24,2,1
4,383,383,1,1,0,1,0
2,404,404,62,7,55,4,3
16,420,420,36,7,29,4,3
5,439,439,3,3,0,1,0
0,454,454,1,1,0,1,0
15,469,469,16,16,0,1,0
12,500,500,43,43,0,1,0

5,114,114,30,14,16,2,1
0,120,120,14,14,0,1,0
18,124,124,17,17,0,1,0
12,163,163,22,4,18,2,1
15,191,191,12,2,10,2,1
11,193,193,32,3,29,3,2
2,202,202,6,6,0,1,0
9,228,228,1,1,0,1,0
4,234,234,51,27,24,2,1
6,260,260,51,27,24,2,1
13,268,268,68,36,32,2,1
8,317,317,29,29,0,1,0
16,317,317,17,7,10,3,2
3,356,356,1,1,0,1,0
14,376,376,41,41,0,1,0
10,469,469,8,8,0,1,0
7,472,472,3,3,0,1,0
17,472,472,41,35,6,2,1
1,500,500,37,30,7,2,1

8,106,106,1,1,0,1,0
6,118,118,3,3,0,1,0
7,119,119,44,15,29,2,1
2,168,168,3,3,0,1,0
10,187,187,79,67,12,2,1
1,192,192,22,7,15,2,1
4,202,202,10,10,0,1,0
11,208,208,9,1,8,3,2
9,210,210,32,32,0,1,0
15,236,236,1,1,0,1,0
0,249,249,4,4,0,1,0
17,276,276,40,40,0,1,0
5,308,308,51,51,0,1,0
13,331,331,49,49,0,1,0
18,359,359,4,4,0,1,0
14,382,382,32,11,21,2,1
16,436,436,42,4,38,2,1
3,452,452,37,37,0,1,0
12,457,457,28,22,6,3,2

10,107,107,3,3,0,1,0
5,120,120,16,16,0,1,0
11,173,173,4,1,3,2,1
9,175,175,42,42,0,1,0
12,196,196,3,3,0,1,0
1,204,204,23,8,15,4,3
8,253,253,8,8,0,1,0
15,255,255,6,6,0,1,0
17,260,260,4,4,0,1,0
14,260,260,9,9,0,1,0
3,298,298,21,21,0,1,0
7,315,315,2,2,0,1,0
21,319,319,40,40,0,1,0
22,330,330,137,132,5,2,1
6,336,336,54,54,0,1,0
13,364,364,22,5,17,2,1
20,369,369,33,22,11,2,1
4,401,401,1,1,0,1,0
19,434,434,52,47,5,2,1
16,436,436,19,19,0,1,0
0,462,462,50,50,0,1,0
2,490,490,4,4,0,1,0
18,499,499,76,48,28,3,2

17,148,148,41,7,34,2,1
1,251,251,8,8,0,1,0
14,251,251,10,10,0,1,0
2,266,266,12,12,0,1,0
12,274,274,8,5,3,2,1
3,292,292,7,4,3,2,1
7,298,298,16,6,10,3,2
9,301,301,3,3,0,1,0
13,316,316,27,27,0,1,0
15,325,325,11,11,0,1,0
4,332,332,5,5,0,1,0
11,339,339,45,45,0,1,0
10,341,341,69,40,29,2,1
16,347,347,105,29,76,3,2
0,398,398,16,16,0,1,0
18,399,399,10,10,0,1,0
8,436,436,136,32,104,4,3
19,469,469,44,20,24,2,1
6,473,473,18,4,14,3,2
5,496,496,114,12,102,4,3

14,125,125,5,5,0,1,0
17,133,133,6,6,0,1,0
3,151,151,39,27,12,2,1
16,161,161,13,13,0,1,0
1,181,181,6,1,5,2,1
5,220,220,22,10,12,2,1
0,229,229,15,15,0,1,0
18,233,233,17,17,0,1,0
10,244,244,42,3,39,4,3
15,268,268,12,8,4,2,1
4,272,272,34,34,0,1,0
11,354,354,46,46,0,1,0
6,406,406,29,24,5,2,1
7,411,411,37,3,34,3,2
9,412,412,65,24,41,2,1
8,421,421,29,29,0,1,0
13,434,434,14,6,8,2,1
12,446,446,181,115,66,4,3
2,473,473,15,1,14,2,1

9,148,148,1,1,0,1,0
10,153,153,2,2,0,1,0
7,166,166,35,11,24,3,2
21,189,189,51,51,0,1,0
1,220,220,25,25,0,1,0
4,228,228,26,26,0,1,0
19,237,237,40,40,0,1,0
3,239,239,19,19,0,1,0
5,243,243,55,43,12,2,1
6,287,287,13,13,0,1,0
14,304,304,4,1,3,2,1
18,305,305,9,6,3,2,1
17,311,311,32,32,0,1,0
15,343,343,15,15,0,1,0
13,344,344,26,26,0,1,0
2,361,361,17,17,0,1,0
11,371,371,27,27,0,1,0
0,414,414,20,4,16,3,2
8,437,437,1,1,0,1,0
12,479,479,10,10,0,1,0
16,486,486,11,11,0,1,0
20,497,497,145,94,51,3,2

13,116,116,10,10,0,1,0
18,120,120,5,1,4,2,1
16,135,135,1,1,0,1,0
22,138,138,33,33,0,1,0
6,149,149,23,17,6,3,2
0,150,150,8,2,6,3,2
15,161,161,13,13,0,1,0
23,166,166,4,4,0,1,0
19,182,182,32,29,3,2,1
20,187,187,58,58,0,1,0
12,203,203,6,6,0,1,0
3,212,212,33,33,0,1,0
4,231,231,3,3,0,1,0
21,240,240,7,7,0,1,0
9,259,259,1,1,0,1,0
17,275,275,32,32,0,1,0
1,289,289,44,36,8,2,1
11,316,316,9,9,0,1,0
8,332,332,5,5,0,1,0
5,340,340,34,34,0,1,0
7,447,447,16,16,0,1,0
10,455,455,7,7,0,1,0
14,456,456,13,7,6,3,2
2,476,476,62,62,0,1,0

9,105,105,1,1,0,1,0
4,106,106,10,10,0,1,0
2,114,114,9,9,0,1,0
0,118,118,8,8,0,1,0
18,160,160,19,1,18,2,1
20,167,167,15,15,0,1,0
19,186,186,6,2,4,2,1
11,200,200,3,3,0,1,0
5,233,233,46,46,0,1,0
7,249,249,7,4,3,2,1
16,262,262,31,31,0,1,0
6,275,275,18,12,6,3,2
13,308,308,26,26,0,1,0
10,357,357,42,42,0,1,0
8,402,402,18,18,0,1,0
21,441,441,13,4,9,2,1
17,450,450,83,83,0,1,0
3,453,453,59,59,0,1,0
12,453,453,30,30,0,1,0
1,469,469,1,1,0,1,0
22,481,481,137,87,50,2,1
14,483,483,55,44,11,2,1
15,493,493,22,22,0,1,0

10,124,124,9,6,3,2,1
0,138,138,10,10,0,1,0
1,142,142,1,1,0,1,0
8,215,215,33,33,0,1,0
11,222,222,16,12,4,2,1
16,225,225,14,2,12,2,1
20,251,251,17,17,0,1,0
23,262,262,81,51,30,4,3
4,287,287,38,38,0,1,0
13,298,298,21,13,8,3,2
5,304,304,5,5,0,1,0
9,334,334,25,8,17,2,1
21,336,336,8,2,6,2,1
3,362,362,2,2,0,1,0
14,362,362,29,6,23,2,1
2,373,373,2,2,0,1,0
22,383,383,27,27,0,1,0
19,391,391,6,6,0,1,0
6,407,407,7,7,0,1,0
7,435,435,38,38,0,1,0
18,456,456,145,136,9,4,3
12,473,473,63,5,58,3,2
15,479,479,20,17,3,2,1
17,500,500,55,29,26,3,2

8,103,103,8,8,0,1,0
4,105,105,6,6,0,1,0
19,130,130,4,4,0,1,0
9,152,152,26,3,23,3,2
13,160,160,41,41,0,1,0
2,166,166,1,1,0,1,0
11,171,171,2,2,0,1,0
5,182,182,31,9,22,3,2
18,190,190,12,3,9,2,1
17,192,192,47,26,21,4,3
6,257,257,53,5,48,3,2
20,300,300,29,9,20,3,2
1,301,301,22,22,0,1,0
10,342,342,37,15,22,2,1
14,359,359,9,6,3,2,1
7,382,382,34,34,0,1,0
0,388,388,1,1,0,1,0
3,398,398,11,11,0,1,0
16,430,430,92,6,86,3,2
15,464,464,10,10,0,1,0
12,491,491,30,30,0,1,0

1,178,178,9,9,0,1,0
13,179,179,5,5,0,1,0
7,186,186,3,3,0,1,0
15,200,200,16,16,0,1,0
16,213,213,51,51,0,1,0
3,285,285,56,44,12,4,3
14,292,292,17,17,0,1,0
6,303,303,10,3,7,2,1
5,315,315,9,3,6,2,1
19,317,317,15,15,0,1,0
0,321,321,8,8,0,1,0
11,381,381,41,41,0,1,0
20,383,383,125,125,0,1,0
18,398,398,8,8,0,1,0
8,414,414,4,4,0,1,0
12,429,429,69,24,45,4,3
4,434,434,57,27,30,4,3
10,464,464,97,32,65,4,3
21,469,469,85,7,78,4,3
2,472,472,15,3,12,3,2
17,479,479,16,7,9,4,3
9,485,485,1,1,0,1,0

13,143,143,2,2,0,1,0
12,150,150,14,14,0,1,0
4,173,173,13,13,0,1,0
3,211,211,95,11,84,3,2
2,213,213,4,4,0,1,0
11,236,236,32,12,20,3,2
9,255,255,1,1,0,1,0
1,311,311,142,73,69,4,3
7,348,348,77,57,20,3,2
5,405,405,148,148,0,1,0
10,441,441,3,3,0,1,0
0,446,446,1,1,0,1,0
8,448,448,6,6,0,1,0
6,486,486,77,44,33,2,1

20,104,104,11,11,0,1,0
15,105,105,3,3,0,1,0
17,108,108,15,1,14,2,1
3,126,126,10,10,0,1,0
1,127,127,11,8,3,2,1
12,137,137,8,8,0,1,0
22,158,158,1,1,0,1,0
6,198,198,1,1,0,1,0
27,213,213,32,32,0,1,0
7,222,222,9,2,7,2,1
24,228,228,4,4,0,1,0
18,257,257,21,1,20,2,1
0,290,290,1,1,0,1,0
19,292,292,1,1,0,1,0
10,298,298,1,1,0,1,0
11,305,305,11,4,7,2,1
13,325,325,1,1,0,1,0
5,343,343,39,39,0,1,0
2,348,348,31,7,24,3,2
14,369,369,40,24,16,3,2
16,386,386,1,1,0,1,0
26,406,406,152,138,14,4,3
8,421,421,10,1,9,2,1
25,440,440,77,41,36,4,3
4,445,445,7,1,6,3,2
9,468,468,39,39,0,1,0
21,476,476,8,8,0,1,0
23,498,498,84,76,8,2,1

16,102,102,28,4,24,3,2
7,115,115,1,1,0,1,0
6,115,115,3,3,0,1,0
5,144,144,24,6,18,3,2
14,146,146,27,9,18,2,1
9,166,166,15,15,0,1,0
19,226,226,25,25,0,1,0
4,234,234,5,5,0,1,0
13,244,244,4,4,0,1,0
3,250,250,21,21,0,1,0
12,271,271,50,50,0,1,0
1,303,303,14,14,0,1,0
18,348,348,3,3,0,1,0
10,351,351,10,10,0,1,0
15,372,372,50,20,30,3,2
20,381,381,12,1,11,2,1
11,436,436,9,9,0,1,0
0,444,444,50,36,14,3,2
21,461,461,94,94,0,1,0
2,472,472,70,46,24,4,3
8,477,477,30,6,24,2,1
17,497,497,29,26,3,2,1

15,110,110,5,1,4,2,1
14,111,111,1,1,0,1,0
10,163,163,1,1,0,1,0
4,165,165,1,1,0,1,0
7,165,165,2,2,0,1,0
0,192,192,11,3,8,3,2
1,193,193,2,2,0,1,0
5,225,225,38,24,14,3,2
3,235,235,10,10,0,1,0
18,243,243,2,2,0,1,0
8,288,288,32,23,9,4,3
6,314,314,41,31,10,3,2
2,320,320,126,55,71,4,3
12,344,344,1,1,0,1,0
17,350,350,13,13,0,1,0
19,409,409,28,4,24,3,2
11,417,417,85,85,0,1,0
13,437,437,248,248,0,1,0
9,441,441,27,27,0,1,0
16,476,476,33,13,20,2,1

2,131,131,1,1,0,1,0
11,134,134,2,2,0,1,0
12,170,170,1,1,0,1,0
5,203,203,27,27,0,1,0
1,222,222,26,26,0,1,0
10,230,230,11,11,0,1,0
3,234,234,40,40,0,1,0
16,290,290,134,134,0,1,0
0,339,339,82,34,48,3,2
15,344,344,12,9,3,2,1
7,346,346,63,63,0,1,0
6,346,346,9,1,8,2,1
9,354,354,21,21,0,1,0
4,385,385,47,47,0,1,0
13,403,403,90,90,0,1,0
8,415,415,52,52,0,1,0
14,457,457,18,18,0,1,0

10,108,108,1,1,0,1,0
21,137,137,3,3,0,1,0
20,140,140,44,44,0,1,0
13,157,157,2,2,0,1,0
3,171,171,1,1,0,1,0
17,187,187,12,2,10,3,2
1,204,204,2,2,0,1,0
8,216,216,6,6,0,1,0
11,221,221,6,2,4,2,1
18,225,225,34,12,22,2,1
14,251,251,32,23,9,4,3
4,290,290,67,25,42,2,1
12,346,346,55,37,18,4,3
5,356,356,22,22,0,1,0
15,360,360,17,9,8,3,2
16,396,396,31,31,0,1,0
7,416,416,61,41,20,3,2
2,448,448,30,12,18,4,3
6,455,455,61,61,0,1,0
0,493,493,3,3,0,1,0
9,498,498,58,58,0,1,0
19,500,500,98,44,54,4,3

16,167,167,39,6,33,4,3
8,173,173,45,45,0,1,0
15,177,177,9,1,8,3,2
1,186,186,20,5,15,3,2
6,186,186,19,19,0,1,0
2,197,197,26,4,22,2,1
7,263,263,20,20,0,1,0
5,278,278,20,4,16,2,1
17,281,281,12,12,0,1,0
10,289,289,6,6,0,1,0
3,295,295,23,15,8,3,2
12,320,320,27,5,22,2,1
4,357,357,16,16,0,1,0
0,384,384,51,43,8,2,1
14,398,398,64,34,30,3,2
11,418,418,84,84,0,1,0
9,437,437,72,38,34,4,3
13,491,491,27,3,24,3,2

18,100,100,14,2,12,4,3
4,120,120,1,1,0,1,0
21,129,129,14,14,0,1,0
14,137,137,1,1,0,1,0
12,145,145,12,12,0,1,0
20,150,150,21,21,0,1,0
2,152,152,5,1,4,2,1
13,181,181,26,4,22,2,1
8,195,195,10,10,0,1,0
6,205,205,35,19,16,2,1
3,217,217,7,7,0,1,0
26,228,228,29,16,13,2,1
22,230,230,10,3,7,2,1
23,258,258,41,31,10,2,1
25,262,262,30,16,14,4,3
10,280,280,23,5,18,2,1
15,280,280,1,1,0,1,0
9,289,289,7,1,6,2,1
7,308,308,2,2,0,1,0
5,318,318,1,1,0,1,0
19,349,349,22,14,8,3,2
11,383,383,37,29,8,3,2
17,406,406,22,22,0,1,0
0,426,426,38,5,33,2,1
16,481,481,3,3,0,1,0
24,493,493,64,40,24,4,3
1,498,498,53,44,9,4,3

11,125,125,13,13,0,1,0
1,134,134,48,42,6,2,1
9,141,141,1,1,0,1,0
3,145,145,3,3,0,1,0
15,155,155,27,27,0,1,0
18,163,163,9,9,0,1,0
14,180,180,6,3,3,2,1
6,197,197,36,36,0,1,0
8,229,229,4,4,0,1,0
5,231,231,18,4,14,2,1
2,295,295,38,13,25,2,1
12,302,302,63,63,0,1,0
19,310,310,28,28,0,1,0
7,337,337,18,18,0,1,0
0,400,400,19,11,8,2,1
13,402,402,6,6,0,1,0
16,424,424,106,106,0,1,0
17,447,447,37,19,18,2,1
4,453,453,33,33,0,1,0
10,498,498,17,17,0,1,0

2,138,138,6,6,0,1,0
0,146,146,1,1,0,1,0
16,152,152,6,6,0,1,0
5,199,199,11,11,0,1,0
13,205,205,9,9,0,1,0
7,260,260,44,8,36,2,1
12,273,273,16,11,5,2,1
14,284,284,89,3,86,3,2
19,332,332,27,7,20,3,2
15,360,360,37,37,0,1,0
11,386,386,15,15,0,1,0
17,392,392,24,24,0,1,0
10,393,393,1,1,0,1,0
20,397,397,96,46,50,4,3
1,412,412,69,69,0,1,0
9,414,414,26,26,0,1,0
3,432,432,34,34,0,1,0
6,438,438,90,90,0,1,0
18,473,473,38,5,33,4,3
4,477,477,45,6,39,2,1
8,496,496,38,38,0,1,0

13,108,108,16,16,0,1,0
10,119,119,3,3,0,1,0
6,127,127,15,15,0,1,0
0,150,150,23,14,9,2,1
20,153,153,21,3,18,3,2
9,246,246,6,3,3,2,1
7,247,247,25,22,3,2,1
2,259,259,17,3,14,3,2
21,265,265,30,30,0,1,0
4,279,279,12,12,0,1,0
11,297,297,25,25,0,1,0
12,319,319,6,6,0,1,0
8,331,331,21,21,0,1,0
15,338,338,40,20,20,2,1
18,339,339,38,10,28,2,1
5,346,346,6,6,0,1,0
16,363,363,76,76,0,1,0
3,375,375,78,12,66,3,2
1,404,404,32,18,14,2,1
17,407,407,1,1,0,1,0
14,467,467,31,31,0,1,0
19,477,477,55,55,0,1,0

1,104,104,84,84,0,1,0
6,120,120,5,2,3,2,1
12,155,155,22,5,17,2,1
5,196,196,25,25,0,1,0
11,201,201,14,7,7,2,1
2,257,257,33,33,0,1,0
13,267,267,18,9,9,4,3
9,284,284,3,3,0,1,0
8,309,309,63,19,44,2,1
0,313,313,1,1,0,1,0
7,341,341,21,7,14,3,2
10,373,373,111,9,102,4,3
4,434,434,12,2,10,2,1
3,460,460,16,2,14,2,1

13,108,108,18,3,15,2,1
4,134,134,27,27,0,1,0
7,151,151,1,1,0,1,0
9,154,154,25,1,24,3,2
12,191,191,85,46,39,2,1
3,247,247,4,4,0,1,0
11,254,254,23,17,6,3,2
14,278,278,5,5,0,1,0
8,299,299,23,23,0,1,0
18,306,306,25,1,24,4,3
1,331,331,45,28,17,2,1
2,349,349,21,21,0,1,0
5,351,351,80,41,39,4,3
0,373,373,5,5,0,1,0
10,400,400,38,20,18,2,1
17,432,432,12,12,0,1,0
6,442,442,44,44,0,1,0
16,451,451,34,7,27,4,3
15,480,480,9,9,0,1,0

5,126,126,29,5,24,2,1
3,133,133,34,19,15,4,3
13,133,133,29,5,24,2,1
9,153,153,1,1,0,1,0
6,166,166,5,1,4,2,1
4,196,196,1,1,0,1,0
0,204,204,31,16,15,2,1
10,206,206,86,74,12,3,2
11,223,223,8,2,6,3,2
1,376,376,12,9,3,2,1
12,420,420,28,3,25,2,1
14,430,430,30,30,0,1,0
7,431,431,38,25,13,4,3
8,454,454,36,28,8,3,2
2,478,478,159,71,88,4,3

11,146,146,37,31,6,2,1
4,147,147,34,34,0,1,0
14,162,162,50,50,0,1,0
15,177,177,25,17,8,2,1
1,206,206,15,4,11,2,1
8,211,211,10,10,0,1,0
17,212,212,12,12,0,1,0
5,214,214,2,2,0,1,0
0,250,250,23,23,0,1,0
7,276,276,57,57,0,1,0
12,293,293,5,5,0,1,0
2,298,298,9,9,0,1,0
9,319,319,21,21,0,1,0
13,322,322,26,16,10,2,1
3,366,366,12,3,9,4,3
16,418,418,19,1,18,3,2
10,459,459,23,23,0,1,0
6,489,489,137,137,0,1,0

16,101,101,8,8,0,1,0
3,103,103,17,6,11,2,1
8,125,125,4,4,0,1,0
12,134,134,10,1,9,4,3
14,141,141,9,2,7,2,1
6,149,149,13,13,0,1,0
7,161,161,7,7,0,1,0
5,165,165,9,9,0,1,0
17,167,167,3,3,0,1,0
9,183,183,33,17,16,4,3
13,208,208,10,10,0,1,0
1,214,214,62,62,0,1,0
4,218,218,19,10,9,4,3
11,280,280,79,43,36,3,2
2,292,292,15,15,0,1,0
0,300,300,3,3,0,1,0
10,319,319,2,2,0,1,0
15,346,346,136,92,44,4,3
18,443,443,25,9,16,2,1

15,108,108,7,3,4,2,1
13,109,109,1,1,0,1,0
3,111,111,1,1,0,1,0
23,145,145,16,10,6,2,1
7,180,180,1,1,0,1,0
17,195,195,25,13,12,2,1
19,217,217,48,38,10,3,2
8,228,228,2,2,0,1,0
2,243,243,41,41,0,1,0
6,257,257,18,18,0,1,0
16,284,284,29,19,10,2,1
18,323,323,10,6,4,2,1
1,324,324,9,9,0,1,0
12,327,327,1,1,0,1,0
9,355,355,12,12,0,1,0
0,387,387,102,21,81,4,3
14,389,389,28,20,8,3,2
20,395,395,24,24,0,1,0
5,412,412,60,26,34,3,2
11,426,426,71,21,50,2,1
4,445,445,7,7,0,1,0
21,451,451,48,35,13,2,1
10,455,455,1,1,0,1,0
22,496,496,94,69,25,2,1

0,133,133,1,1,0,1,0
10,152,152,22,22,0,1,0
2,157,157,41,8,33,2,1
9,195,195,3,3,0,1,0
4,202,202,67,37,30,3,2
7,217,217,46,46,0,1,0
11,228,228,58,20,38,4,3
14,257,257,31,22,9,2,1
1,336,336,60,11,49,3,2
8,349,349,34,8,26,3,2
12,379,379,52,52,0,1,0
5,408,408,23,9,14,3,2
3,427,427,71,24,47,2,1
13,440,440,9,9,0,1,0
6,457,457,8,8,0,1,0

10,104,104,16,6,10,2,1
6,152,152,27,15,12,4,3
17,160,160,31,31,0,1,0
14,160,160,33,2,31,2,1
15,186,186,2,2,0,1,0
5,188,188,4,4,0,1,0
8,189,189,32,32,0,1,0
11,190,190,30,4,26,3,2
4,226,226,20,20,0,1,0
0,266,266,16,16,0,1,0
16,336,336,3,3,0,1,0
9,342,342,76,52,24,2,1
3,393,393,22,22,0,1,0
2,409,409,27,5,22,2,1
1,414,414,73,7,66,3,2
12,414,414,9,9,0,1,0
13,436,436,21,21,0,1,0
7,439,439,83,83,0,1,0

0,107,107,8,2,6,2,1
5,114,114,14,14,0,1,0
12,116,116,15,12,3,2,1
16,118,118,3,3,0,1,0
17,122,122,1,1,0,1,0
8,149,149,9,9,0,1,0
19,152,152,44,44,0,1,0
9,163,163,1,1,0,1,0
3,177,177,9,6,3,2,1
10,184,184,8,8,0,1,0
15,188,188,26,21,5,2,1
11,216,216,22,22,0,1,0
14,313,313,33,8,25,4,3
4,318,318,19,1,18,4,3
18,362,362,56,10,46,3,2
13,396,396,51,5,46,3,2
1,411,411,39,5,34,3,2
7,417,417,46,31,15,4,3
20,433,433,20,2,18,4,3
6,492,492,59,59,0,1,0
2,497,497,79,79,0,1,0

24,107,107,2,2,0,1,0
12,155,155,13,13,0,1,0
3,160,160,4,1,3,2,1
21,188,188,52,52,0,1,0
5,192,192,1,1,0,1,0
1,205,205,1,1,0,1,0
20,243,243,35,19,16,2,1
6,254,254,40,10,30,2,1
17,260,260,19,16,3,2,1
10,261,261,29,29,0,1,0
13,267,267,29,6,23,2,1
23,296,296,26,19,7,2,1
4,302,302,13,13,0,1,0
15,338,338,7,7,0,1,0
0,360,360,32,2,30,2,1
9,361,361,1,1,0,1,0
18,363,363,48,48,0,1,0
16,418,418,80,42,38,2,1
11,431,431,14,3,11,2,1
14,432,432,56,56,0,1,0
7,440,440,27,27,0,1,0
8,452,452,15,15,0,1,0
19,475,475,34,16,18,2,1
2,476,476,45,32,13,2,1
22,489,489,12,12,0,1,0

6,118,118,8,4,4,2,1
8,163,163,23,23,0,1,0
1,207,207,1,1,0,1,0
12,219,219,34,34,0,1,0
19,222,222,21,21,0,1,0
5,227,227,9,9,0,1,0
15,263,263,43,14,29,2,1
2,300,300,35,35,0,1,0
13,331,331,1,1,0,1,0
4,344,344,17,17,0,1,0
16,356,356,5,5,0,1,0
17,360,360,11,11,0,1,0
14,370,370,117,51,66,3,2
11,370,370,14,14,0,1,0
10,387,387,11,3,8,3,2
7,396,396,79,79,0,1,0
0,414,414,15,15,0,1,0
18,425,425,74,24,50,3,2
3,450,450,68,68,0,1,0
20,455,455,27,12,15,2,1
9,485,485,62,62,0,1,0

10,145,145,9,9,0,1,0
2,147,147,47,7,40,2,1
12,152,152,5,5,0,1,0
15,173,173,27,27,0,1,0
4,218,218,76,24,52,3,2
1,219,219,19,10,9,4,3
0,271,271,1,1,0,1,0
11,292,292,3,3,0,1,0
3,326,326,27,27,0,1,0
9,329,329,103,103,0,1,0
6,360,360,40,31,9,4,3
14,375,375,109,12,97,4,3
5,402,402,20,8,12,3,2
8,413,413,8,8,0,1,0
13,460,460,18,18,0,1,0
7,486,486,50,50,0,1,0

21,108,108,1,1,0,1,0
6,160,160,42,16,26,3,2
11,182,182,15,15,0,1,0
15,200,200,23,23,0,1,0
10,216,216,27,27,0,1,0
18,252,252,15,15,0,1,0
12,278,278,3,3,0,1,0
13,284,284,32,32,0,1,0
3,297,297,63,63,0,1,0
2,302,302,20,20,0,1,0
8,317,317,9,1,8,3,2
9,320,320,3,3,0,1,0
1,326,326,5,5,0,1,0
20,327,327,115,92,23,2,1
4,346,346,10,4,6,2,1
5,347,347,4,4,0,1,0
17,352,352,28,11,17,4,3
7,398,398,37,7,30,2,1
14,406,406,61,61,0,1,0
0,416,416,23,5,18,4,3
19,426,426,31,31,0,1,0
16,427,427,32,32,0,1,0

19,102,102,11,11,0,1,0
21,113,113,3,3,0,1,0
2,139,139,3,3,0,1,0
7,208,208,3,3,0,1,0
13,216,216,8,8,0,1,0
20,221,221,44,44,0,1,0
17,221,221,30,30,0,1,0
22,238,238,25,2,23,4,3
6,299,299,70,38,32,4,3
24,302,302,24,13,11,2,1
1,309,309,8,3,5,2,1
4,352,352,5,5,0,1,0
10,356,356,29,17,12,2,1
14,357,357,19,13,6,2,1
12,371,371,52,52,0,1,0
11,416,416,37,3,34,3,2
3,424,424,26,26,0,1,0
9,427,427,7,7,0,1,0
5,435,435,64,49,15,4,3
23,435,435,69,3,66,4,3
8,437,437,2,2,0,1,0
16,459,459,28,28,0,1,0
0,467,467,7,7,0,1,0
15,474,474,22,22,0,1,0
18,474,474,72,72,0,1,0

15,113,113,12,3,9,4,3
14,173,173,48,48,0,1,0
3,184,184,47,47,0,1,0
6,219,219,22,22,0,1,0
7,226,226,2,2,0,1,0
12,227,227,4,4,0,1,0
10,229,229,9,6,3,2,1
8,267,267,10,10,0,1,0
2,313,313,13,13,0,1,0
5,338,338,17,8,9,4,3
4,366,366,11,11,0,1,0
11,372,372,72,28,44,2,1
0,380,380,109,15,94,3,2
9,384,384,12,12,0,1,0
16,406,406,83,44,39,2,1
13,483,483,54,4,50,4,3
1,485,485,110,110,0,1,0

3,112,112,24,24,0,1,0
17,115,115,18,1,17,2,1
0,130,130,3,3,0,1,0
16,144,144,2,2,0,1,0
15,153,153,38,38,0,1,0
14,175,175,12,12,0,1,0
5,204,204,1,1,0,1,0
13,212,212,3,3,0,1,0
6,243,243,33,33,0,1,0
7,261,261,36,36,0,1,0
19,308,308,79,20,59,3,2
12,348,348,35,25,10,2,1
10,383,383,53,53,0,1,0
8,384,384,24,2,22,2,1
2,406,406,27,3,24,2,1
18,413,413,51,51,0,1,0
1,452,452,6,6,0,1,0
11,458,458,16,7,9,2,1
9,467,467,91,75,16,3,2
4,497,497,5,5,0,1,0

6,112,112,8,8,0,1,0
7,147,147,40,40,0,1,0
1,176,176,57,57,0,1,0
5,197,197,57,45,12,4,3
0,261,261,107,6,101,4,3
9,283,283,36,36,0,1,0
3,298,298,64,64,0,1,0
4,321,321,13,9,4,2,1
2,369,369,20,4,16,3,2
8,370,370,23,23,0,1,0
11,402,402,24,8,16,3,2
12,410,410,2,2,0,1,0
10,485,485,42,9,33,4,3

6,116,116,10,10,0,1,0
13,121,121,1,1,0,1,0
0,151,151,1,1,0,1,0
15,193,193,8,8,0,1,0
9,202,202,58,58,0,1,0
4,205,205,5,2,3,2,1
8,207,207,4,4,0,1,0
10,229,229,9,9,0,1,0
5,239,239,5,5,0,1,0
1,261,261,16,16,0,1,0
11,312,312,76,34,42,3,2
16,312,312,15,15,0,1,0
21,325,325,40,40,0,1,0
20,328,328,48,38,10,3,2
14,330,330,22,16,6,2,1
17,342,342,91,91,0,1,0
19,346,346,51,9,42,4,3
7,369,369,23,7,16,2,1
23,386,386,40,14,26,2,1
22,396,396,31,31,0,1,0
24,408,408,35,1,34,3,2
18,414,414,6,6,0,1,0
2,415,415,6,6,0,1,0
3,419,419,3,3,0,1,0
12,425,425,6,6,0,1,0

22,103,103,1,1,0,1,0
5,113,113,5,1,4,2,1
20,119,119,18,18,0,1,0
4,130,130,7,7,0,1,0
0,135,135,1,1,0,1,0
21,142,142,5,5,0,1,0
19,161,161,24,24,0,1,0
7,161,161,25,1,24,2,1
1,172,172,2,2,0,1,0
6,178,178,3,3,0,1,0
2,219,219,2,2,0,1,0
16,220,220,9,9,0,1,0
14,222,222,49,1,48,2,1
18,246,246,38,38,0,1,0
11,252,252,7,7,0,1,0
3,254,254,20,4,16,2,1
17,302,302,38,17,21,3,2
8,341,341,23,2,21,2,1
9,372,372,5,2,3,2,1
10,406,406,37,37,0,1,0
23,411,411,132,51,81,4,3
15,433,433,14,14,0,1,0
13,456,456,14,4,10,2,1
12,485,485,84,45,39,2,1

11,111,111,8,8,0,1,0
20,124,124,8,8,0,1,0
14,131,131,9,9,0,1,0
16,140,140,24,24,0,1,0
13,142,142,11,11,0,1,0
10,157,157,6,6,0,1,0
15,199,199,24,19,5,2,1
9,210,210,5,5,0,1,0
18,210,210,21,1,20,3,2
5,230,230,7,7,0,1,0
7,231,231,1,1,0,1,0
3,232,232,2,2,0,1,0
4,240,240,21,12,9,4,3
17,252,252,45,3,42,4,3
2,281,281,9,9,0,1,0
21,319,319,22,22,0,1,0
12,332,332,32,4,28,2,1
0,384,384,146,146,0,1,0
6,404,404,29,14,15,4,3
19,410,410,71,5,66,3,2
1,431,431,11,11,0,1,0
8,436,436,57,3,54,3,2

4,132,132,12,6,6,2,1
17,146,146,8,8,0,1,0
18,147,147,50,24,26,2,1
14,165,165,19,19,0,1,0
3,208,208,1,1,0,1,0
5,265,265,28,19,9,2,1
19,278,278,10,10,0,1,0
16,282,282,37,37,0,1,0
13,326,326,41,10,31,2,1
7,354,354,16,16,0,1,0
1,384,384,45,35,10,2,1
6,387,387,34,2,32,3,2
12,419,419,24,12,12,4,3
8,444,444,35,35,0,1,0
2,460,460,2,2,0,1,0
11,466,466,23,18,5,2,1
15,466,466,50,2,48,2,1
0,472,472,93,43,50,4,3
9,472,472,61,34,27,3,2
10,477,477,67,67,0,1,0

10,108,108,11,11,0,1,0
15,142,142,13,5,8,2,1
13,173,173,18,18,0,1,0
3,216,216,2,2,0,1,0
12,225,225,16,16,0,1,0
6,255,255,26,26,0,1,0
16,275,275,52,52,0,1,0
4,286,286,16,10,6,2,1
14,290,290,18,18,0,1,0
0,324,324,49,49,0,1,0
1,388,388,10,2,8,2,1
7,431,431,49,15,34,3,2
17,436,436,18,18,0,1,0
11,458,458,14,4,10,3,2
5,466,466,158,158,0,1,0
9,474,474,158,42,116,4,3
8,492,492,49,49,0,1,0
2,499,499,52,52,0,1,0

15,101,101,25,19,6,2,1
9,129,129,3,3,0,1,0
17,145,145,6,6,0,1,0
6,150,150,5,2,3,2,1
16,159,159,16,10,6,3,2
4,186,186,13,13,0,1,0
13,189,189,3,3,0,1,0
0,223,223,11,11,0,1,0
12,235,235,2,2,0,1,0
19,249,249,43,43,0,1,0
7,292,292,7,2,5,2,1
21,294,294,56,39,17,2,1
14,304,304,31,31,0,1,0
3,311,311,20,20,0,1,0
5,318,318,99,81,18,2,1
18,351,351,15,15,0,1,0
10,368,368,29,5,24,3,2
1,383,383,15,6,9,2,1
20,438,438,49,49,0,1,0
11,451,451,78,41,37,3,2
2,455,455,48,30,18,3,2
8,463,463,10,1,9,2,1

3,109,109,8,8,0,1,0
11,143,143,1,1,0,1,0
14,190,190,33,33,0,1,0
15,216,216,35,35,0,1,0
13,217,217,60,60,0,1,0
6,229,229,87,31,56,3,2
7,258,258,10,10,0,1,0
10,258,258,21,21,0,1,0
16,278,278,16,16,0,1,0
12,284,284,12,4,8,3,2
2,288,288,30,30,0,1,0
4,326,326,67,67,0,1,0
5,356,356,68,19,49,2,1
8,365,365,53,53,0,1,0
0,374,374,3,3,0,1,0
1,420,420,1,1,0,1,0
9,492,492,39,6,33,4,3

2,125,125,7,7,0,1,0
8,127,127,4,1,3,2,1
13,129,129,48,48,0,1,0
4,131,131,33,4,29,2,1
16,136,136,3,3,0,1,0
0,167,167,6,6,0,1,0
14,185,185,3,3,0,1,0
1,253,253,37,37,0,1,0
3,256,256,1,1,0,1,0
9,297,297,23,14,9,2,1
17,326,326,52,52,0,1,0
6,387,387,86,86,0,1,0
19,394,394,8,3,5,2,1
18,399,399,11,11,0,1,0
10,411,411,11,11,0,1,0
7,424,424,20,20,0,1,0
12,428,428,92,92,0,1,0
15,442,442,75,75,0,1,0
11,468,468,7,7,0,1,0
5,484,484,50,50,0,1,0

9,108,108,15,15,0,1,0
13,117,117,10,10,0,1,0
18,150,150,12,12,0,1,0
14,181,181,20,20,0,1,0
10,215,215,18,4,14,2,1
11,233,233,25,25,0,1,0
16,278,278,21,21,0,1,0
6,287,287,58,58,0,1,0
5,288,288,43,40,3,2,1
1,290,290,90,90,0,1,0
3,322,322,1,1,0,1,0
15,371,371,47,47,0,1,0
7,380,380,1,1,0,1,0
2,416,416,7,7,0,1,0
0,429,429,8,1,7,2,1
8,437,437,48,43,5,2,1
12,478,478,35,35,0,1,0
17,484,484,133,133,0,1,0
4,487,487,24,4,20,2,1

1,107,107,4,4,0,1,0
8,146,146,1,1,0,1,0
7,167,167,1,1,0,1,0
9,171,171,58,58,0,1,0
0,179,179,31,31,0,1,0
11,183,183,2,2,0,1,0
15,246,246,22,22,0,1,0
2,247,247,112,84,28,2,1
13,303,303,3,3,0,1,0
14,348,348,8,8,0,1,0
17,350,350,6,2,4,2,1
5,362,362,1,1,0,1,0
12,450,450,107,107,0,1,0
3,464,464,41,41,0,1,0
4,470,470,84,75,9,2,1
10,477,477,73,23,50,2,1
16,477,477,67,67,0,1,0
6,488,488,28,28,0,1,0

4,100,100,12,12,0,1,0
7,106,106,1,1,0,1,0
18,112,112,6,2,4,2,1
20,117,117,18,12,6,2,1
16,127,127,11,5,6,2,1
3,146,146,48,48,0,1,0
10,151,151,15,1,14,3,2
6,182,182,1,1,0,1,0
5,201,201,5,5,0,1,0
8,221,221,11,8,3,2,1
1,251,251,7,3,4,2,1
12,254,254,7,7,0,1,0
17,269,269,34,34,0,1,0
15,292,292,28,28,0,1,0
19,335,335,4,4,0,1,0
9,353,353,53,53,0,1,0
14,354,354,125,36,89,4,3
0,409,409,5,5,0,1,0
2,436,436,45,45,0,1,0
13,449,449,49,34,15,2,1
21,452,452,14,14,0,1,0
11,495,495,21,5,16,2,1

5,117,117,18,18,0,1,0
4,123,123,19,19,0,1,0
6,256,256,8,8,0,1,0
0,266,266,47,47,0,1,0
15,281,281,43,43,0,1,0
7,296,296,34,14,20,3,2
8,302,302,98,32,66,4,3
11,338,338,12,9,3,2,1
10,345,345,11,11,0,1,0
14,350,350,16,6,10,2,1
16,356,356,2,2,0,1,0
12,368,368,25,25,0,1,0
9,407,407,140,49,91,4,3
13,421,421,2,2,0,1,0
2,434,434,54,14,40,3,2
1,439,439,3,3,0,1,0
3,491,491,118,42,76,4,3

9,104,104,30,24,6,3,2
15,123,123,20,6,14,2,1
6,156,156,6,6,0,1,0
4,166,166,4,4,0,1,0
11,167,167,3,3,0,1,0
8,170,170,11,11,0,1,0
18,186,186,22,22,0,1,0
19,213,213,1,1,0,1,0
7,229,229,26,18,8,3,2
16,231,231,40,40,0,1,0
13,259,259,11,5,6,3,2
3,259,259,15,15,0,1,0
2,307,307,1,1,0,1,0
12,327,327,60,37,23,2,1
17,369,369,61,14,47,3,2
10,373,373,63,63,0,1,0
5,382,382,19,10,9,4,3
0,387,387,54,54,0,1,0
14,417,417,64,64,0,1,0
1,424,424,22,10,12,3,2

3,156,156,6,2,4,2,1
8,211,211,7,7,0,1,0
16,222,222,58,58,0,1,0
15,227,227,5,5,0,1,0
0,247,247,6,6,0,1,0
2,249,249,26,22,4,2,1
12,257,257,1,1,0,1,0
20,261,261,20,20,0,1,0
18,274,274,4,4,0,1,0
13,307,307,25,5,20,3,2
24,315,315,11,11,0,1,0
10,327,327,29,3,26,2,1
5,343,343,36,36,0,1,0
14,350,350,12,12,0,1,0
23,350,350,10,10,0,1,0
22,367,367,84,30,54,3,2
7,386,386,73,40,33,4,3
19,420,420,4,4,0,1,0
21,425,425,138,81,57,4,3
1,442,442,21,21,0,1,0
4,446,446,58,58,0,1,0
11,456,456,25,19,6,2,1
6,459,459,18,6,12,3,2
17,472,472,18,18,0,1,0
9,482,482,3,3,0,1,0

8,101,101,1,1,0,1,0
16,132,132,46,46,0,1,0
7,144,144,3,3,0,1,0
3,152,152,3,3,0,1,0
24,155,155,4,4,0,1,0
10,179,179,1,1,0,1,0
11,198,198,6,3,3,2,1
1,201,201,18,6,12,4,3
4,208,208,27,18,9,2,1
13,213,213,26,11,15,4,3
21,223,223,9,9,0,1,0
22,224,224,35,35,0,1,0
6,237,237,1,1,0,1,0
17,257,257,12,3,9,4,3
12,317,317,14,14,0,1,0
20,325,325,19,19,0,1,0
5,344,344,16,3,13,2,1
2,353,353,40,40,0,1,0
15,358,358,29,24,5,2,1
19,452,452,13,13,0,1,0
14,460,460,11,11,0,1,0
9,470,470,104,42,62,3,2
18,473,473,5,5,0,1,0
23,483,483,146,139,7,2,1
0,500,500,20,20,0,1,0

14,144,144,4,4,0,1,0
11,145,145,1,1,0,1,0
8,164,164,29,5,24,4,3
10,210,210,56,7,49,4,3
3,227,227,11,7,4,2,1
6,247,247,17,17,0,1,0
1,254,254,48,18,30,4,3
5,277,277,74,34,40,3,2
7,279,279,70,52,18,4,3
0,287,287,14,14,0,1,0
15,313,313,28,28,0,1,0
13,320,320,10,10,0,1,0
2,349,349,30,9,21,2,1
9,369,369,63,60,3,2,1
12,428,428,1,1,0,1,0
4,479,479,141,125,16,3,2

15,107,107,1,1,0,1,0
21,123,123,3,3,0,1,0
10,156,156,3,3,0,1,0
8,162,162,1,1,0,1,0
11,189,189,4,4,0,1,0
9,203,203,1,1,0,1,0
20,203,203,23,23,0,1,0
2,222,222,3,3,0,1,0
22,261,261,10,7,3,2,1
3,272,272,31,22,9,2,1
16,276,276,55,55,0,1,0
7,301,301,2,2,0,1,0
4,303,303,51,39,12,4,3
12,309,309,23,17,6,3,2
19,324,324,20,20,0,1,0
5,408,408,40,40,0,1,0
18,417,417,46,25,21,4,3
0,424,424,9,9,0,1,0
1,437,437,39,33,6,3,2
14,440,440,191,125,66,4,3
17,454,454,14,14,0,1,0
6,478,478,134,134,0,1,0
13,489,489,41,41,0,1,0

5,100,100,10,2,8,2,1
14,101,101,8,8,0,1,0
6,140,140,2,2,0,1,0
4,212,212,53,23,30,4,3
13,217,217,80,21,59,4,3
9,230,230,46,46,0,1,0
12,231,231,9,9,0,1,0
0,288,288,13,2,11,2,1
8,317,317,16,16,0,1,0
3,330,330,70,56,14,3,2
7,375,375,26,3,23,2,1
11,412,412,42,5,37,4,3
1,461,461,124,85,39,2,1
2,464,464,61,61,0,1,0
10,466,466,49,49,0,1,0

7,107,107,11,2,9,3,2
16,115,115,25,25,0,1,0
1,163,163,13,13,0,1,0
15,199,199,11,2,9,4,3
6,217,217,22,22,0,1,0
11,265,265,41,41,0,1,0
9,304,304,34,19,15,4,3
8,313,313,25,16,9,2,1
10,356,356,51,51,0,1,0
2,369,369,76,22,54,4,3
14,398,398,45,45,0,1,0
0,410,410,25,25,0,1,0
13,426,426,29,29,0,1,0
12,427,427,34,13,21,4,3
4,457,457,14,14,0,1,0
3,461,461,27,11,16,2,1
5,483,483,178,115,63,4,3

22,133,133,19,19,0,1,0
16,137,137,8,8,0,1,0
14,146,146,13,1,12,3,2
23,148,148,7,2,5,2,1
10,169,169,5,5,0,1,0
1,180,180,11,11,0,1,0
17,186,186,28,28,0,1,0
2,198,198,14,14,0,1,0
8,199,199,9,9,0,1,0
11,216,216,10,10,0,1,0
12,289,289,45,6,39,4,3
19,299,299,86,41,45,2,1
24,313,313,57,9,48,2,1
21,315,315,2,2,0,1,0
7,317,317,8,8,0,1,0
0,340,340,6,3,3,2,1
9,357,357,72,72,0,1,0
18,373,373,11,3,8,2,1
20,380,380,46,2,44,3,2
3,398,398,4,4,0,1,0
5,431,431,22,19,3,2,1
6,440,440,33,5,28,4,3
4,441,441,8,4,4,2,1
15,458,458,3,3,0,1,0
13,471,471,46,1,45,4,3

10,119,119,22,12,10,2,1
2,139,139,28,28,0,1,0
5,180,180,17,17,0,1,0
16,202,202,46,34,12,2,1
6,217,217,32,32,0,1,0
0,226,226,4,1,3,2,1
7,265,265,61,61,0,1,0
14,277,277,9,3,6,3,2
8,283,283,45,9,36,3,2
17,299,299,48,48,0,1,0
15,324,324,12,12,0,1,0
4,368,368,30,6,24,2,1
1,371,371,20,4,16,3,2
9,375,375,17,17,0,1,0
12,437,437,96,44,52,3,2
13,478,478,32,5,27,2,1
3,487,487,8,8,0,1,0
11,491,491,20,16,4,2,1

16,100,100,25,22,3,2,1
0,134,134,22,22,0,1,0
5,138,138,2,2,0,1,0
9,142,142,1,1,0,1,0
13,147,147,8,8,0,1,0
8,161,161,27,5,22,3,2
19,187,187,52,52,0,1,0
2,203,203,25,25,0,1,0
4,255,255,29,29,0,1,0
15,317,317,17,17,0,1,0
1,348,348,29,16,13,2,1
6,384,384,3,3,0,1,0
7,389,389,57,7,50,2,1
18,401,401,70,64,6,3,2
11,410,410,27,2,25,2,1
10,428,428,42,42,0,1,0
3,438,438,33,12,21,2,1
17,466,466,19,19,0,1,0
14,471,471,29,14,15,4,3
12,487,487,16,4,12,2,1

10,156,156,17,8,9,4,3
5,179,179,44,44,0,1,0
2,180,180,21,6,15,3,2
12,182,182,13,6,7,2,1
8,199,199,16,3,13,2,1
7,205,205,5,5,0,1,0
18,219,219,37,5,32,2,1
14,227,227,5,5,0,1,0
3,241,241,17,17,0,1,0
16,338,338,29,25,4,2,1
13,345,345,44,6,38,2,1
0,352,352,35,13,22,2,1
11,356,356,51,30,21,2,1
9,395,395,23,7,16,2,1
6,420,420,14,14,0,1,0
1,438,438,12,2,10,2,1
15,477,477,56,19,37,2,1
17,495,495,86,86,0,1,0
4,496,496,122,122,0,1,0

11,126,126,3,3,0,1,0
1,130,130,9,3,6,2,1
3,201,201,32,32,0,1,0
20,213,213,1,1,0,1,0
5,214,214,5,2,3,2,1
14,220,220,38,38,0,1,0
7,276,276,101,71,30,2,1
19,290,290,19,19,0,1,0
4,325,325,25,15,10,3,2
6,364,364,35,12,23,2,1
9,368,368,7,1,6,2,1
17,377,377,36,15,21,2,1
12,396,396,4,4,0,1,0
18,401,401,96,82,14,3,2
10,411,411,2,2,0,1,0
2,417,417,28,1,27,4,3
8,437,437,39,39,0,1,0
13,446,446,67,25,42,4,3
0,451,451,3,3,0,1,0
15,476,476,64,25,39,2,1
16,493,493,72,44,28,3,2

18,118,118,3,3,0,1,0
15,125,125,35,35,0,1,0
16,156,156,4,4,0,1,0
6,163,163,1,1,0,1,0
2,169,169,24,24,0,1,0
7,188,188,64,64,0,1,0
4,197,197,17,17,0,1,0
8,212,212,8,8,0,1,0
12,220,220,71,71,0,1,0
3,231,231,5,5,0,1,0
13,233,233,2,2,0,1,0
0,260,260,5,5,0,1,0
11,293,293,17,17,0,1,0
1,373,373,24,14,10,2,1
14,404,404,37,37,0,1,0
9,421,421,95,23,72,4,3
5,452,452,26,15,11,2,1
10,464,464,87,87,0,1,0
17,464,464,13,13,0,1,0

7,107,107,6,6,0,1,0
6,117,117,3,3,0,1,0
14,140,140,14,14,0,1,0
13,162,162,34,34,0,1,0
15,175,175,4,4,0,1,0
5,186,186,9,9,0,1,0
0,247,247,32,15,17,4,3
16,275,275,1,1,0,1,0
10,291,291,1,1,0,1,0
9,318,318,6,6,0,1,0
3,333,333,24,24,0,1,0
11,341,341,59,59,0,1,0
4,365,365,68,58,10,3,2
2,372,372,146,35,111,4,3
8,414,414,41,18,23,2,1
1,444,444,42,42,0,1,0
12,472,472,181,55,126,4,3

7,151,151,39,39,0,1,0
16,163,163,22,22,0,1,0
4,168,168,15,3,12,3,2
10,184,184,13,13,0,1,0
18,186,186,15,15,0,1,0
3,187,187,10,5,5,2,1
5,212,212,14,14,0,1,0
13,217,217,2,2,0,1,0
2,305,305,21,3,18,3,2
15,307,307,153,153,0,1,0
17,337,337,51,51,0,1,0
12,380,380,14,14,0,1,0
19,383,383,17,5,12,2,1
6,384,384,28,1,27,2,1
1,411,411,13,13,0,1,0
9,437,437,89,89,0,1,0
14,443,443,8,5,3,2,1
11,463,463,20,20,0,1,0
0,486,486,2,2,0,1,0
8,493,493,40,40,0,1,0

8,100,100,4,1,3,2,1
16,108,108,6,3,3,2,1
11,109,109,14,2,12,3,2
7,126,126,5,5,0,1,0
5,141,141,31,3,28,4,3
14,143,143,32,5,27,2,1
15,178,178,7,2,5,2,1
13,178,178,6,6,0,1,0
12,201,201,4,4,0,1,0
4,255,255,3,3,0,1,0
1,310,310,1,1,0,1,0
6,317,317,53,1,52,3,2
10,322,322,90,58,32,2,1
9,324,324,26,26,0,1,0
3,339,339,27,27,0,1,0
17,401,401,65,47,18,2,1
0,467,467,109,7,102,4,3
2,498,498,105,3,102,4,3

13,110,110,5,5,0,1,0
9,111,111,1,1,0,1,0
8,150,150,7,1,6,2,1
2,207,207,34,19,15,2,1
7,234,234,46,46,0,1,0
10,284,284,46,10,36,3,2
6,318,318,46,46,0,1,0
3,323,323,41,41,0,1,0
14,401,401,22,10,12,2,1
11,403,403,76,56,20,2,1
12,403,403,71,71,0,1,0
4,415,415,50,19,31,2,1
5,425,425,79,13,66,4,3
0,460,460,171,125,46,3,2
1,464,464,15,2,13,2,1

21,145,145,2,2,0,1,0
23,158,158,6,6,0,1,0
12,165,165,10,10,0,1,0
10,201,201,34,34,0,1,0
24,205,205,1,1,0,1,0
6,233,233,12,1,11,2,1
11,267,267,39,24,15,4,3
4,276,276,17,17,0,1,0
3,287,287,21,3,18,2,1
0,317,317,1,1,0,1,0
9,326,326,2,2,0,1,0
14,340,340,23,23,0,1,0
1,363,363,28,28,0,1,0
22,363,363,40,40,0,1,0
7,371,371,22,22,0,1,0
13,376,376,19,4,15,2,1
17,397,397,73,23,50,3,2
20,416,416,57,57,0,1,0
5,421,421,14,14,0,1,0
8,421,421,39,39,0,1,0
2,427,427,11,11,0,1,0
15,458,458,11,4,7,2,1
19,474,474,153,121,32,2,1
16,477,477,36,18,18,2,1
18,482,482,62,62,0,1,0

14,102,102,11,5,6,2,1
0,113,113,11,3,8,3,2
18,123,123,2,2,0,1,0
8,203,203,1,1,0,1,0
9,209,209,2,2,0,1,0
4,219,219,47,47,0,1,0
5,243,243,15,15,0,1,0
13,249,249,13,5,8,3,2
1,254,254,7,4,3,2,1
15,310,310,46,46,0,1,0
10,319,319,20,6,14,3,2
3,344,344,46,30,16,2,1
6,397,397,108,59,49,2,1
2,398,398,3,3,0,1,0
16,398,398,18,18,0,1,0
17,412,412,89,19,70,4,3
11,444,444,68,68,0,1,0
7,475,475,83,58,25,3,2
12,496,496,103,103,0,1,0

15,133,133,16,16,0,1,0
2,134,134,9,9,0,1,0
12,134,134,3,3,0,1,0
3,137,137,23,23,0,1,0
18,141,141,11,6,5,2,1
7,146,146,13,1,12,2,1
13,161,161,22,22,0,1,0
8,180,180,34,34,0,1,0
6,197,197,6,6,0,1,0
0,241,241,2,2,0,1,0
16,271,271,11,11,0,1,0
19,311,311,9,1,8,3,2
9,341,341,68,30,38,3,2
1,352,352,12,5,7,2,1
14,356,356,121,101,20,3,2
4,357,357,34,11,23,2,1
5,410,410,6,6,0,1,0
17,451,451,110,78,32,4,3
11,466,466,2,2,0,1,0
10,477,477,51,13,38,2,1

8,143,143,17,17,0,1,0
17,237,237,34,28,6,3,2
6,255,255,11,6,5,2,1
18,275,275,23,23,0,1,0
12,278,278,27,27,0,1,0
13,279,279,75,75,0,1,0
1,280,280,95,95,0,1,0
4,325,325,14,14,0,1,0
10,330,330,57,57,0,1,0
11,335,335,1,1,0,1,0
5,344,344,70,70,0,1,0
0,380,380,2,2,0,1,0
7,413,413,57,29,28,2,1
16,413,413,20,12,8,3,2
14,445,445,49,29,20,2,1
2,455,455,20,3,17,4,3
3,468,468,5,5,0,1,0
9,474,474,26,13,13,4,3
15,483,483,42,8,34,3,2

6,136,136,48,3,45,2,1
15,137,137,39,39,0,1,0
3,177,177,11,2,9,2,1
9,197,197,34,3,31,2,1
4,208,208,7,7,0,1,0
14,218,218,16,16,0,1,0
12,231,231,16,16,0,1,0
0,243,243,2,2,0,1,0
13,261,261,67,50,17,2,1
1,265,265,2,2,0,1,0
2,281,281,30,14,16,3,2
18,325,325,31,16,15,2,1
8,328,328,44,7,37,3,2
17,333,333,18,18,0,1,0
5,354,354,11,6,5,2,1
10,368,368,36,14,22,3,2
11,390,390,27,27,0,1,0
7,427,427,39,12,27,4,3
16,488,488,5,5,0,1,0

6,110,110,1,1,0,1,0
8,115,115,23,23,0,1,0
0,128,128,11,2,9,2,1
13,149,149,47,43,4,2,1
5,151,151,1,1,0,1,0
15,166,166,12,9,3,2,1
2,264,264,45,45,0,1,0
9,265,265,7,7,0,1,0
16,297,297,15,9,6,3,2
3,311,311,4,4,0,1,0
12,342,342,125,125,0,1,0
10,369,369,16,9,7,2,1
7,378,378,91,91,0,1,0
14,405,405,41,41,0,1,0
1,408,408,73,42,31,2,1
11,417,417,1,1,0,1,0
17,429,429,16,2,14,2,1
4,473,473,47,16,31,4,3

13,103,103,14,14,0,1,0
14,117,117,34,34,0,1,0
8,123,123,21,15,6,2,1
17,125,125,4,4,0,1,0
15,141,141,4,4,0,1,0
9,165,165,22,22,0,1,0
4,211,211,3,3,0,1,0
18,212,212,69,33,36,4,3
16,269,269,2,2,0,1,0
2,285,285,59,59,0,1,0
1,299,299,33,33,0,1,0
0,328,328,40,28,12,4,3
12,334,334,6,6,0,1,0
5,343,343,3,3,0,1,0
3,374,374,38,38,0,1,0
10,431,431,37,5,32,3,2
7,451,451,49,11,38,4,3
6,452,452,13,1,12,2,1
11,488,488,49,43,6,2,1

7,129,129,13,13,0,1,0
2,149,149,25,15,10,3,2
9,198,198,53,53,0,1,0
5,207,207,29,13,16,2,1
8,207,207,51,51,0,1,0
11,222,222,25,25,0,1,0
6,228,228,5,5,0,1,0
10,280,280,28,22,6,3,2
0,302,302,176,47,129,4,3
4,315,315,55,5,50,3,2
12,382,382,9,9,0,1,0
1,414,414,8,8,0,1,0
13,475,475,1,1,0,1,0
3,497,497,28,28,0,1,0

16,121,121,20,1,19,2,1
1,135,135,9,9,0,1,0
6,137,137,17,3,14,2,1
14,138,138,4,1,3,2,1
18,165,165,4,4,0,1,0
13,170,170,23,23,0,1,0
2,204,204,1,1,0,1,0
9,213,213,29,29,0,1,0
4,218,218,11,5,6,3,2
11,324,324,6,6,0,1,0
12,324,324,142,136,6,3,2
3,348,348,56,56,0,1,0
7,388,388,3,3,0,1,0
15,399,399,8,8,0,1,0
17,409,409,77,25,52,3,2
10,411,411,3,3,0,1,0
8,445,445,59,38,21,2,1
5,478,478,105,27,78,3,2
0,485,485,47,47,0,1,0

10,104,104,5,5,0,1,0
7,109,109,3,3,0,1,0
11,117,117,2,2,0,1,0
2,134,134,1,1,0,1,0
9,137,137,10,10,0,1,0
15,214,214,43,43,0,1,0
6,218,218,59,59,0,1,0
8,223,223,95,28,67,3,2
1,253,253,3,3,0,1,0
13,345,345,18,18,0,1,0
4,365,365,17,10,7,2,1
5,370,370,21,21,0,1,0
12,402,402,66,21,45,4,3
3,453,453,23,23,0,1,0
14,484,484,5,5,0,1,0
0,500,500,279,238,41,2,1

0,100,100,20,4,16,2,1
8,123,123,5,5,0,1,0
16,128,128,23,23,0,1,0
18,171,171,13,4,9,2,1
11,181,181,33,33,0,1,0
5,193,193,26,2,24,2,1
4,193,193,10,10,0,1,0
2,204,204,8,8,0,1,0
14,254,254,39,25,14,2,1
6,296,296,12,12,0,1,0
9,308,308,28,19,9,4,3
12,314,314,40,40,0,1,0
13,321,321,36,12,24,3,2
10,326,326,70,10,60,4,3
15,336,336,16,2,14,3,2
7,382,382,28,2,26,3,2
1,406,406,18,4,14,2,1
3,427,427,30,7,23,2,1
19,439,439,1,1,0,1,0
17,469,469,66,38,28,4,3

9,117,117,17,2,15,2,1
6,135,135,2,2,0,1,0
4,158,158,1,1,0,1,0
13,180,180,23,4,19,4,3
10,182,182,6,6,0,1,0
5,183,183,1,1,0,1,0
22,200,200,20,16,4,2,1
7,202,202,5,5,0,1,0
14,219,219,28,28,0,1,0
18,228,228,65,59,6,3,2
21,229,229,8,8,0,1,0
2,240,240,12,4,8,2,1
8,267,267,13,13,0,1,0
0,277,277,11,3,8,3,2
16,323,323,23,23,0,1,0
1,332,332,28,28,0,1,0
20,360,360,61,3,58,3,2
3,388,388,17,1,16,2,1
11,455,455,50,13,37,2,1
19,469,469,58,29,29,2,1
15,473,473,3,3,0,1,0
17,473,473,49,2,47,3,2
12,493,493,132,43,89,4,3

11,105,105,20,12,8,2,1
5,125,125,5,5,0,1,0
13,140,140,11,11,0,1,0
1,147,147,56,47,9,2,1
0,178,178,3,3,0,1,0
3,183,183,1,1,0,1,0
2,191,191,39,39,0,1,0
7,225,225,21,21,0,1,0
14,239,239,45,19,26,3,2
12,270,270,23,4,19,2,1
10,304,304,19,19,0,1,0
6,409,409,115,115,0,1,0
8,473,473,88,48,40,2,1
4,479,479,35,2,33,2,1
15,481,481,1,1,0,1,0
9,492,492,67,67,0,1,0

14,114,114,4,4,0,1,0
2,127,127,19,19,0,1,0
6,140,140,6,6,0,1,0
8,179,179,12,6,6,2,1
18,188,188,3,3,0,1,0
12,198,198,48,48,0,1,0
0,213,213,12,12,0,1,0
20,251,251,21,21,0,1,0
7,263,263,19,19,0,1,0
13,288,288,46,46,0,1,0
9,296,296,32,12,20,4,3
4,327,327,15,15,0,1,0
5,360,360,21,21,0,1,0
19,369,369,30,30,0,1,0
16,413,413,83,21,62,3,2
1,425,425,44,11,33,4,3
11,425,425,18,10,8,2,1
3,469,469,65,65,0,1,0
10,491,491,57,27,30,2,1
15,492,492,40,7,33,4,3
17,500,500,58,43,15,2,1

6,111,111,11,11,0,1,0
12,130,130,7,7,0,1,0
14,147,147,1,1,0,1,0
3,153,153,7,3,4,2,1
20,159,159,26,26,0,1,0
2,187,187,9,9,0,1,0
1,251,251,13,13,0,1,0
9,256,256,21,21,0,1,0
4,261,261,39,27,12,4,3
13,289,289,3,3,0,1,0
7,292,292,9,4,5,2,1
0,327,327,17,1,16,3,2
19,336,336,38,5,33,4,3
11,357,357,91,91,0,1,0
18,367,367,131,99,32,2,1
5,379,379,9,9,0,1,0
8,385,385,8,8,0,1,0
10,401,401,32,32,0,1,0
21,441,441,45,30,15,3,2
22,451,451,19,19,0,1,0
15,457,457,5,5,0,1,0
16,462,462,52,17,35,4,3
17,478,478,53,28,25,2,1

19,116,116,1,1,0,1,0
9,118,118,7,7,0,1,0
12,129,129,10,10,0,1,0
11,157,157,4,4,0,1,0
21,167,167,14,14,0,1,0
8,183,183,31,4,27,4,3
22,204,204,34,27,7,2,1
10,204,204,9,5,4,2,1
4,218,218,13,13,0,1,0
2,222,222,6,6,0,1,0
20,236,236,10,10,0,1,0
7,238,238,1,1,0,1,0
16,266,266,37,28,9,4,3
15,313,313,8,8,0,1,0
1,332,332,20,5,15,4,3
13,340,340,16,16,0,1,0
3,352,352,56,23,33,4,3
6,379,379,40,12,28,3,2
17,391,391,178,144,34,3,2
5,395,395,38,38,0,1,0
0,427,427,29,29,0,1,0
14,429,429,3,3,0,1,0
18,481,481,44,33,11,2,1

7,105,105,8,8,0,1,0
16,119,119,6,1,5,2,1
14,127,127,4,4,0,1,0
2,196,196,5,5,0,1,0
15,217,217,22,18,4,2,1
5,243,243,71,7,64,3,2
0,258,258,59,44,15,2,1
4,272,272,70,70,0,1,0
9,318,318,87,87,0,1,0
12,323,323,41,27,14,2,1
3,355,355,16,5,11,2,1
11,368,368,81,18,63,4,3
1,389,389,4,4,0,1,0
8,397,397,45,19,26,3,2
13,434,434,39,39,0,1,0
6,449,449,30,30,0,1,0
10,482,482,7,7,0,1,0

12,113,113,3,3,0,1,0
8,162,162,2,2,0,1,0
9,165,165,7,1,6,3,2
16,198,198,24,24,0,1,0
3,203,203,31,31,0,1,0
13,233,233,52,52,0,1,0
10,255,255,40,8,32,2,1
4,256,256,26,26,0,1,0
6,312,312,56,56,0,1,0
2,329,329,22,3,19,4,3
18,388,388,44,29,15,2,1
1,396,396,11,11,0,1,0
7,397,397,1,1,0,1,0
19,449,449,109,29,80,3,2
15,452,452,25,21,4,2,1
11,453,453,28,28,0,1,0
20,456,456,56,24,32,2,1
0,460,460,51,11,40,4,3
17,473,473,8,1,7,2,1
5,483,483,41,41,0,1,0
14,499,499,48,19,29,2,1

12,104,104,5,5,0,1,0
21,117,117,2,2,0,1,0
10,124,124,11,3,8,2,1
25,133,133,11,11,0,1,0
17,139,139,7,4,3,2,1
2,141,141,1,1,0,1,0
9,172,172,1,1,0,1,0
18,184,184,3,3,0,1,0
28,202,202,11,11,0,1,0
22,206,206,47,47,0,1,0
23,235,235,7,7,0,1,0
26,240,240,1,1,0,1,0
1,245,245,1,1,0,1,0
13,255,255,1,1,0,1,0
0,267,267,4,4,0,1,0
27,290,290,4,4,0,1,0
20,301,301,26,2,24,2,1
8,366,366,18,18,0,1,0
15,366,366,21,6,15,4,3
24,376,376,42,42,0,1,0
7,382,382,15,15,0,1,0
6,399,399,1,1,0,1,0
3,424,424,22,22,0,1,0
4,428,428,11,11,0,1,0
5,438,438,17,1,16,3,2
16,442,442,144,63,81,4,3
19,447,447,13,13,0,1,0
29,449,449,208,139,69,3,2
14,462,462,1,1,0,1,0
30,488,488,15,15,0,1,0
11,490,490,20,6,14,2,1

10,102,102,2,2,0,1,0
21,124,124,12,2,10,2,1
8,162,162,17,17,0,1,0
22,181,181,42,28,14,3,2
3,210,210,25,21,4,2,1
11,210,210,13,13,0,1,0
14,224,224,6,6,0,1,0
0,225,225,1,1,0,1,0
13,248,248,54,16,38,2,1
19,249,249,25,25,0,1,0
9,335,335,91,22,69,4,3
7,353,353,10,6,4,2,1
5,371,371,12,12,0,1,0
1,373,373,27,1,26,3,2
4,379,379,10,6,4,2,1
12,389,389,1,1,0,1,0
17,389,389,8,8,0,1,0
16,410,410,52,5,47,2,1
15,411,411,49,30,19,2,1
2,422,422,8,8,0,1,0
6,432,432,10,10,0,1,0
18,471,471,24,4,20,3,2
20,486,486,118,118,0,1,0

2,107,107,8,5,3,2,1
11,174,174,15,15,0,1,0
20,174,174,14,14,0,1,0
8,186,186,9,9,0,1,0
12,195,195,9,3,6,3,2
17,196,196,4,1,3,2,1
0,212,212,1,1,0,1,0
15,236,236,7,1,6,3,2
14,244,244,5,5,0,1,0
3,293,293,29,29,0,1,0
19,359,359,18,5,13,3,2
9,369,369,85,14,71,4,3
10,372,372,11,11,0,1,0
18,400,400,13,13,0,1,0
6,406,406,71,30,41,2,1
13,419,419,40,4,36,3,2
5,439,439,10,10,0,1,0
4,444,444,14,14,0,1,0
7,445,445,53,53,0,1,0
16,475,475,303,293,10,2,1
1,479,479,39,5,34,3,2

7,102,102,6,6,0,1,0
8,129,129,11,11,0,1,0
13,135,135,22,22,0,1,0
9,254,254,38,5,33,3,2
16,262,262,36,36,0,1,0
2,294,294,144,12,132,4,3
4,316,316,1,1,0,1,0
0,342,342,11,4,7,2,1
11,343,343,5,5,0,1,0
3,354,354,12,12,0,1,0
1,390,390,50,46,4,2,1
5,393,393,8,8,0,1,0
14,407,407,116,113,3,2,1
15,423,423,14,14,0,1,0
10,437,437,21,21,0,1,0
12,443,443,42,42,0,1,0
6,476,476,112,112,0,1,0

13,115,115,9,9,0,1,0
5,118,118,4,4,0,1,0
3,162,162,15,8,7,2,1
8,199,199,50,50,0,1,0
0,219,219,36,10,26,4,3
14,269,269,1,1,0,1,0
20,282,282,58,25,33,4,3
18,308,308,100,100,0,1,0
9,316,316,7,3,4,2,1
17,321,321,66,66,0,1,0
11,369,369,15,4,11,2,1
15,393,393,22,22,0,1,0
1,421,421,24,11,13,2,1
4,422,422,54,54,0,1,0
12,428,428,35,35,0,1,0
19,438,438,11,3,8,2,1
7,441,441,49,49,0,1,0
16,448,448,16,4,12,3,2
10,474,474,25,15,10,3,2
2,477,477,1,1,0,1,0
6,497,497,22,5,17,2,1

1,108,108,9,1,8,3,2
3,132,132,19,19,0,1,0
10,191,191,4,4,0,1,0
9,204,204,27,14,13,2,1
8,220,220,46,5,41,2,1
5,244,244,10,10,0,1,0
0,292,292,43,25,18,2,1
11,301,301,29,26,3,2,1
13,308,308,16,2,14,2,1
6,417,417,62,40,22,3,2
14,445,445,38,38,0,1,0
12,455,455,48,48,0,1,0
4,456,456,197,159,38,3,2
15,470,470,18,2,16,4,3
7,474,474,130,110,20,3,2
2,486,486,3,3,0,1,0

7,100,100,4,4,0,1,0
14,115,115,10,4,6,2,1
20,161,161,14,14,0,1,0
6,162,162,7,1,6,2,1
16,173,173,38,35,3,2,1
18,175,175,6,6,0,1,0
2,201,201,3,3,0,1,0
4,202,202,16,16,0,1,0
19,248,248,8,8,0,1,0
5,275,275,27,22,5,2,1
12,283,283,6,1,5,2,1
0,318,318,23,15,8,3,2
9,324,324,41,14,27,2,1
17,341,341,13,2,11,2,1
3,367,367,8,8,0,1,0
13,368,368,46,46,0,1,0
11,371,371,22,6,16,3,2
1,422,422,102,59,43,2,1
10,446,446,84,84,0,1,0
15,459,459,172,172,0,1,0
8,461,461,7,3,4,2,1

22,115,115,42,3,39,2,1
6,143,143,5,5,0,1,0
10,165,165,3,3,0,1,0
23,174,174,8,8,0,1,0
5,212,212,4,1,3,2,1
4,213,213,20,16,4,2,1
13,256,256,30,15,15,2,1
2,279,279,21,21,0,1,0
14,289,289,5,1,4,2,1
1,293,293,4,4,0,1,0
17,295,295,57,40,17,2,1
18,307,307,5,1,4,2,1
16,322,322,41,5,36,2,1
15,328,328,42,32,10,2,1
0,333,333,13,13,0,1,0
19,336,336,31,4,27,4,3
11,342,342,60,28,32,2,1
3,384,384,36,36,0,1,0
7,384,384,29,26,3,2,1
8,396,396,64,64,0,1,0
9,438,438,22,22,0,1,0
20,451,451,22,22,0,1,0
12,478,478,8,8,0,1,0
21,498,498,1,1,0,1,0

11,133,133,25,19,6,3,2
0,145,145,55,55,0,1,0
8,179,179,6,6,0,1,0
17,184,184,51,51,0,1,0
10,190,190,26,11,15,2,1
1,236,236,25,25,0,1,0
2,254,254,4,4,0,1,0
4,279,279,1,1,0,1,0
16,298,298,8,8,0,1,0
9,351,351,53,53,0,1,0
12,351,351,36,30,6,2,1
3,353,353,13,2,11,2,1
14,401,401,10,10,0,1,0
15,438,438,48,1,47,2,1
7,465,465,90,90,0,1,0
6,475,475,4,4,0,1,0
5,500,500,113,44,69,4,3
13,500,500,2,2,0,1,0

12,152,152,14,7,7,2,1
4,163,163,30,30,0,1,0
2,164,164,8,8,0,1,0
0,167,167,15,1,14,2,1
23,169,169,14,14,0,1,0
11,173,173,2,2,0,1,0
19,175,175,23,3,20,2,1
6,196,196,1,1,0,1,0
7,230,230,54,30,24,4,3
1,232,232,12,12,0,1,0
18,240,240,11,2,9,4,3
5,250,250,5,5,0,1,0
16,301,301,72,72,0,1,0
3,309,309,23,5,18,4,3
9,312,312,6,6,0,1,0
15,313,313,17,17,0,1,0
21,344,344,6,1,5,2,1
22,353,353,19,9,10,3,2
20,365,365,60,60,0,1,0
8,377,377,36,13,23,2,1
13,425,425,8,8,0,1,0
14,436,436,10,10,0,1,0
10,437,437,14,4,10,3,2
17,472,472,109,109,0,1,0

9,117,117,3,3,0,1,0
19,122,122,9,9,0,1,0
10,124,124,9,9,0,1,0
0,152,152,34,20,14,2,1
11,160,160,4,4,0,1,0
16,164,164,4,4,0,1,0
15,182,182,21,5,16,3,2
12,187,187,11,7,4,2,1
17,215,215,69,29,40,3,2
7,216,216,16,16,0,1,0
3,218,218,21,9,12,3,2
6,240,240,1,1,0,1,0
1,255,255,5,5,0,1,0
13,282,282,21,1,20,3,2
18,298,298,41,5,36,3,2
5,370,370,62,62,0,1,0
14,376,376,74,28,46,2,1
2,404,404,102,60,42,3,2
8,428,428,22,10,12,4,3
4,474,474,9,3,6,2,1

15,112,112,10,10,0,1,0
14,117,117,6,1,5,2,1
13,134,134,31,7,24,4,3
12,141,141,30,30,0,1,0
4,197,197,23,23,0,1,0
8,211,211,10,2,8,3,2
10,229,229,39,39,0,1,0
5,237,237,3,3,0,1,0
1,241,241,11,5,6,3,2
11,244,244,24,10,14,3,2
7,263,263,26,8,18,4,3
0,268,268,7,7,0,1,0
9,270,270,11,3,8,3,2
19,308,308,26,14,12,2,1
3,338,338,51,51,0,1,0
18,372,372,12,12,0,1,0
16,411,411,18,18,0,1,0
17,414,414,77,10,67,4,3
6,420,420,117,67,50,3,2
2,466,466,7,7,0,1,0

8,100,100,4,1,3,2,1
15,110,110,14,14,0,1,0
7,130,130,8,1,7,2,1
4,133,133,5,2,3,2,1
12,143,143,31,31,0,1,0
17,144,144,51,51,0,1,0
18,145,145,12,5,7,3,2
10,165,165,13,13,0,1,0
20,168,168,2,2,0,1,0
23,202,202,4,4,0,1,0
3,214,214,5,5,0,1,0
21,218,218,9,6,3,2,1
11,231,231,21,9,12,4,3
1,258,258,15,1,14,3,2
6,278,278,9,3,6,3,2
19,351,351,64,7,57,4,3
16,358,358,30,13,17,2,1
22,362,362,47,47,0,1,0
13,413,413,9,9,0,1,0
14,460,460,10,5,5,2,1
5,468,468,87,87,0,1,0
0,485,485,17,17,0,1,0
9,485,485,14,8,6,3,2
2,499,499,34,34,0,1,0

6,102,102,6,1,5,2,1
12,130,130,11,4,7,2,1
0,149,149,9,5,4,2,1
4,168,168,25,8,17,2,1
11,193,193,22,4,18,3,2
19,202,202,19,9,10,2,1
8,254,254,2,2,0,1,0
9,268,268,71,71,0,1,0
3,321,321,21,21,0,1,0
7,340,340,46,16,30,2,1
10,351,351,14,1,13,2,1
14,359,359,115,19,96,4,3
2,376,376,15,15,0,1,0
15,391,391,54,16,38,2,1
18,396,396,34,34,0,1,0
5,397,397,2,2,0,1,0
13,404,404,11,11,0,1,0
1,420,420,74,2,72,4,3
16,436,436,4,4,0,1,0
17,481,481,68,68,0,1,0

8,120,120,3,3,0,1,0
6,167,167,45,24,21,4,3
4,174,174,9,2,7,2,1
20,180,180,11,11,0,1,0
11,182,182,24,14,10,2,1
3,193,193,16,16,0,1,0
16,216,216,13,6,7,2,1
0,239,239,4,4,0,1,0
18,250,250,59,45,14,3,2
15,301,301,8,1,7,2,1
19,318,318,82,15,67,4,3
17,326,326,16,16,0,1,0
12,333,333,37,37,0,1,0
21,345,345,10,4,6,3,2
9,350,350,43,5,38,3,2
5,382,382,25,25,0,1,0
10,445,445,36,36,0,1,0
2,458,458,4,4,0,1,0
13,464,464,14,1,13,2,1
7,468,468,5,5,0,1,0
14,469,469,124,92,32,2,1
1,480,480,11,11,0,1,0

7,116,116,4,4,0,1,0
2,136,136,21,21,0,1,0
14,201,201,25,17,8,2,1
3,204,204,11,6,5,2,1
9,213,213,71,24,47,4,3
5,277,277,51,51,0,1,0
8,285,285,4,4,0,1,0
15,287,287,5,5,0,1,0
13,299,299,12,6,6,2,1
1,340,340,62,18,44,3,2
16,354,354,17,17,0,1,0
11,409,409,78,64,14,3,2
17,441,441,6,6,0,1,0
4,469,469,41,41,0,1,0
6,470,470,40,37,3,2,1
10,479,479,22,22,0,1,0
12,492,492,100,100,0,1,0
0,498,498,102,102,0,1,0

16,105,105,6,6,0,1,0
19,122,122,14,4,10,2,1
0,127,127,8,8,0,1,0
12,138,138,6,6,0,1,0
14,154,154,14,14,0,1,0
11,155,155,2,2,0,1,0
4,156,156,14,14,0,1,0
20,173,173,16,16,0,1,0
2,177,177,7,7,0,1,0
6,218,218,18,18,0,1,0
7,296,296,14,14,0,1,0
8,304,304,80,52,28,2,1
10,322,322,50,50,0,1,0
15,331,331,18,18,0,1,0
9,337,337,23,10,13,2,1
1,378,378,15,10,5,2,1
13,387,387,1,1,0,1,0
17,413,413,26,8,18,3,2
5,444,444,35,35,0,1,0
18,470,470,235,235,0,1,0
3,491,491,32,32,0,1,0

14,106,106,2,2,0,1,0
1,129,129,7,1,6,2,1
8,175,175,2,2,0,1,0
6,177,177,7,7,0,1,0
4,203,203,17,17,0,1,0
22,228,228,20,6,14,3,2
15,230,230,9,9,0,1,0
2,242,242,2,2,0,1,0
17,243,243,42,42,0,1,0
13,248,248,26,26,0,1,0
10,295,295,58,58,0,1,0
9,299,299,3,3,0,1,0
0,305,305,60,20,40,4,3
20,337,337,8,8,0,1,0
18,373,373,11,7,4,2,1
23,418,418,13,5,8,2,1
21,422,422,140,86,54,3,2
16,423,423,72,34,38,2,1
12,425,425,28,18,10,3,2
3,444,444,25,25,0,1,0
11,448,448,40,6,34,2,1
19,452,452,59,14,45,4,3
7,465,465,2,2,0,1,0
5,473,473,32,32,0,1,0

16,147,147,19,12,7,2,1
24,192,192,11,2,9,2,1
7,200,200,31,8,23,4,3
13,216,216,6,6,0,1,0
9,223,223,8,8,0,1,0
21,265,265,4,1,3,2,1
0,268,268,56,56,0,1,0
3,274,274,8,2,6,3,2
15,322,322,1,1,0,1,0
8,355,355,2,2,0,1,0
2,364,364,37,1,36,4,3
14,382,382,14,6,8,2,1
22,386,386,115,87,28,3,2
17,394,394,42,42,0,1,0
19,403,403,3,3,0,1,0
1,416,416,35,25,10,2,1
12,435,435,40,24,16,4,3
10,461,461,43,43,0,1,0
11,471,471,23,1,22,2,1
5,473,473,11,4,7,2,1
20,475,475,142,72,70,4,3
23,477,477,18,5,13,2,1
6,491,491,14,14,0,1,0
4,494,494,14,9,5,2,1
18,496,496,34,29,5,2,1

15,103,103,7,1,6,3,2
12,109,109,6,6,0,1,0
14,139,139,8,8,0,1,0
4,155,155,7,7,0,1,0
10,167,167,4,1,3,2,1
6,172,172,27,27,0,1,0
1,216,216,32,32,0,1,0
11,225,225,12,12,0,1,0
19,261,261,42,9,33,2,1
8,273,273,10,6,4,2,1
5,286,286,16,16,0,1,0
9,309,309,20,7,13,2,1
13,313,313,10,10,0,1,0
17,314,314,82,35,47,2,1
20,319,319,60,24,36,2,1
7,335,335,5,5,0,1,0
0,343,343,5,5,0,1,0
3,349,349,125,110,15,4,3
16,405,405,72,36,36,4,3
2,420,420,12,12,0,1,0
18,425,425,12,3,9,4,3

7,115,115,3,3,0,1,0
15,128,128,40,19,21,2,1
2,150,150,30,9,21,2,1
20,180,180,23,1,22,4,3
6,189,189,7,7,0,1,0
10,191,191,11,4,7,3,2
12,248,248,6,1,5,2,1
8,253,253,25,25,0,1,0
0,255,255,72,52,20,3,2
17,259,259,76,76,0,1,0
16,284,284,10,10,0,1,0
19,288,288,6,6,0,1,0
1,301,301,20,13,7,2,1
14,336,336,22,22,0,1,0
18,347,347,25,25,0,1,0
9,348,348,27,27,0,1,0
22,355,355,3,3,0,1,0
11,365,365,3,3,0,1,0
21,410,410,34,22,12,2,1
4,428,428,5,5,0,1,0
13,450,450,6,6,0,1,0
3,474,474,1,1,0,1,0
5,490,490,47,23,24,4,3

19,106,106,9,5,4,2,1
6,109,109,7,7,0,1,0
5,124,124,11,8,3,2,1
13,129,129,6,6,0,1,0
14,138,138,42,42,0,1,0
9,166,166,9,9,0,1,0
21,196,196,6,6,0,1,0
2,237,237,5,1,4,2,1
7,251,251,42,12,30,4,3
3,272,272,9,3,6,3,2
11,285,285,1,1,0,1,0
1,286,286,22,9,13,2,1
10,307,307,47,47,0,1,0
4,337,337,10,2,8,3,2
22,356,356,32,32,0,1,0
0,361,361,53,53,0,1,0
16,366,366,8,2,6,2,1
17,387,387,19,1,18,3,2
20,389,389,40,7,33,4,3
18,422,422,106,22,84,4,3
15,427,427,34,16,18,2,1
8,444,444,30,30,0,1,0
12,464,464,25,20,5,2,1

1,170,170,8,8,0,1,0
14,221,221,5,5,0,1,0
3,231,231,56,22,34,3,2
9,247,247,2,2,0,1,0
8,262,262,30,30,0,1,0
4,270,270,18,18,0,1,0
15,288,288,31,31,0,1,0
16,337,337,27,27,0,1,0
0,359,359,55,15,40,2,1
5,365,365,10,10,0,1,0
2,373,373,46,4,42,3,2
11,393,393,17,11,6,3,2
17,425,425,5,5,0,1,0
10,432,432,98,67,31,2,1
12,467,467,92,88,4,2,1
6,489,489,48,29,19,3,2
13,496,496,157,133,24,3,2
7,498,498,65,65,0,1,0

3,103,103,19,19,0,1,0
11,129,129,14,14,0,1,0
20,144,144,28,8,20,3,2
7,150,150,1,1,0,1,0
19,155,155,10,10,0,1,0
1,191,191,1,1,0,1,0
13,215,215,19,7,12,4,3
10,222,222,1,1,0,1,0
12,239,239,3,3,0,1,0
15,281,281,18,2,16,2,1
5,286,286,4,4,0,1,0
21,292,292,2,2,0,1,0
8,302,302,49,2,47,2,1
6,316,316,56,8,48,2,1
22,322,322,57,57,0,1,0
14,398,398,59,15,44,3,2
2,411,411,51,51,0,1,0
17,441,441,50,13,37,4,3
18,453,453,37,21,16,3,2
0,472,472,38,38,0,1,0
9,478,478,3,3,0,1,0
16,482,482,78,78,0,1,0
4,483,483,14,14,0,1,0

10,108,108,20,20,0,1,0
14,133,133,22,6,16,3,2
13,147,147,10,10,0,1,0
11,220,220,34,22,12,4,3
7,222,222,5,5,0,1,0
8,311,311,92,92,0,1,0
3,359,359,112,53,59,4,3
12,392,392,15,1,14,3,2
4,394,394,49,49,0,1,0
9,395,395,56,36,20,3,2
1,406,406,39,1,38,2,1
2,407,407,30,30,0,1,0
0,428,428,18,18,0,1,0
15,430,430,67,67,0,1,0
16,442,442,25,9,16,3,2
17,451,451,23,23,0,1,0
5,471,471,14,14,0,1,0
6,488,488,3,3,0,1,0

12,122,122,6,6,0,1,0
6,123,123,41,9,32,2,1
16,178,178,14,4,10,3,2
10,244,244,16,16,0,1,0
3,250,250,29,29,0,1,0
15,270,270,59,59,0,1,0
1,270,270,26,26,0,1,0
4,271,271,1,1,0,1,0
2,294,294,8,8,0,1,0
8,325,325,67,67,0,1,0
5,362,362,55,55,0,1,0
7,391,391,21,3,18,3,2
9,404,404,69,69,0,1,0
11,454,454,75,41,34,3,2
14,462,462,19,2,17,2,1
13,484,484,10,10,0,1,0
0,485,485,106,57,49,2,1

10,111,111,26,12,14,3,2
9,153,153,21,8,13,2,1
4,159,159,16,16,0,1,0
1,184,184,40,12,28,2,1
8,197,197,1,1,0,1,0
15,229,229,4,4,0,1,0
2,258,258,7,7,0,1,0
17,258,258,15,6,9,2,1
0,303,303,16,6,10,3,2
6,311,311,39,13,26,4,3
14,328,328,15,2,13,2,1
13,337,337,14,14,0,1,0
11,358,358,83,83,0,1,0
16,363,363,89,89,0,1,0
7,382,382,78,78,0,1,0
12,413,413,2,2,0,1,0
3,469,469,111,11,100,3,2
5,473,473,16,16,0,1,0

13,159,159,2,2,0,1,0
15,160,160,55,35,20,3,2
6,180,180,5,5,0,1,0
18,182,182,7,7,0,1,0
5,185,185,5,5,0,1,0
10,188,188,47,19,28,3,2
2,191,191,4,4,0,1,0
0,198,198,2,2,0,1,0
22,200,200,11,1,10,3,2
17,209,209,5,5,0,1,0
19,218,218,7,7,0,1,0
12,225,225,17,7,10,3,2
3,245,245,50,41,9,4,3
14,257,257,4,4,0,1,0
8,295,295,1,1,0,1,0
4,307,307,11,8,3,2,1
9,322,322,31,14,17,2,1
1,333,333,10,5,5,2,1
16,351,351,28,16,12,2,1
20,373,373,83,83,0,1,0
11,429,429,83,67,16,3,2
7,447,447,6,6,0,1,0
21,467,467,98,56,42,4,3

16,112,112,7,1,6,3,2
13,134,134,7,7,0,1,0
11,134,134,32,7,25,2,1
5,140,140,10,5,5,2,1
2,147,147,9,5,4,2,1
18,159,159,2,2,0,1,0
1,164,164,20,20,0,1,0
3,175,175,41,35,6,2,1
10,237,237,5,2,3,2,1
7,242,242,7,7,0,1,0
8,272,272,62,16,46,3,2
19,303,303,18,15,3,2,1
14,336,336,9,9,0,1,0
6,354,354,2,2,0,1,0
15,356,356,154,82,72,3,2
12,375,375,6,6,0,1,0
4,423,423,37,25,12,2,1
0,432,432,2,2,0,1,0
17,465,465,57,20,37,2,1
9,496,496,69,69,0,1,0

4,132,132,19,19,0,1,0
23,150,150,13,13,0,1,0
1,154,154,23,23,0,1,0
20,161,161,17,17,0,1,0
17,177,177,4,4,0,1,0
16,199,199,17,2,15,2,1
11,200,200,20,6,14,2,1
18,203,203,61,15,46,4,3
10,212,212,5,5,0,1,0
24,237,237,21,21,0,1,0
3,244,244,7,2,5,2,1
0,248,248,1,1,0,1,0
15,282,282,18,18,0,1,0
6,316,316,10,10,0,1,0
22,328,328,75,13,62,3,2
8,345,345,3,3,0,1,0
12,346,346,9,9,0,1,0
2,368,368,6,3,3,2,1
5,369,369,62,40,22,2,1
7,424,424,2,2,0,1,0
21,447,447,32,20,12,3,2
19,451,451,15,2,13,2,1
13,472,472,17,1,16,2,1
9,488,488,7,7,0,1,0
14,499,499,91,59,32,2,1

17,108,108,20,5,15,2,1
15,114,114,19,1,18,4,3
18,118,118,1,1,0,1,0
6,124,124,18,4,14,3,2
5,163,163,1,1,0,1,0
1,217,217,10,10,0,1,0
2,244,244,4,4,0,1,0
13,245,245,38,38,0,1,0
10,296,296,50,38,12,4,3
9,311,311,42,42,0,1,0
0,323,323,62,62,0,1,0
14,327,327,24,8,16,3,2
11,357,357,67,67,0,1,0
16,378,378,21,21,0,1,0
12,399,399,12,12,0,1,0
3,444,444,73,73,0,1,0
7,455,455,84,54,30,4,3
8,485,485,40,16,24,4,3
4,486,486,15,15,0,1,0

9,126,126,3,3,0,1,0
23,131,131,16,16,0,1,0
2,132,132,27,20,7,2,1
1,134,134,9,9,0,1,0
24,141,141,6,6,0,1,0
3,162,162,3,3,0,1,0
7,191,191,14,2,12,3,2
17,199,199,51,51,0,1,0
14,261,261,34,19,15,2,1
5,278,278,10,10,0,1,0
10,278,278,26,26,0,1,0
8,318,318,6,6,0,1,0
6,320,320,1,1,0,1,0
20,336,336,41,36,5,2,1
16,340,340,30,12,18,2,1
22,357,357,19,19,0,1,0
4,363,363,4,4,0,1,0
13,396,396,16,16,0,1,0
0,409,409,52,5,47,3,2
15,413,413,38,2,36,4,3
12,418,418,2,2,0,1,0
19,420,420,38,38,0,1,0
11,421,421,24,6,18,2,1
18,437,437,95,20,75,4,3
21,460,460,12,12,0,1,0

21,106,106,27,27,0,1,0
14,107,107,2,2,0,1,0
3,108,108,1,1,0,1,0
22,108,108,1,1,0,1,0
18,134,134,2,2,0,1,0
8,137,137,8,3,5,2,1
0,171,171,8,8,0,1,0
13,187,187,8,8,0,1,0
23,188,188,34,34,0,1,0
11,230,230,4,4,0,1,0
4,237,237,23,23,0,1,0
1,242,242,47,10,37,3,2
6,256,256,11,11,0,1,0
19,282,282,57,34,23,2,1
9,283,283,17,3,14,3,2
17,292,292,11,11,0,1,0
7,298,298,9,4,5,2,1
25,311,311,29,3,26,3,2
26,312,312,1,1,0,1,0
5,382,382,6,1,5,2,1
12,384,384,69,12,57,4,3
20,397,397,11,11,0,1,0
16,407,407,32,32,0,1,0
24,425,425,100,100,0,1,0
15,428,428,11,11,0,1,0
10,434,434,1,1,0,1,0
2,464,464,21,21,0,1,0

18,102,102,8,8,0,1,0
9,104,104,14,2,12,3,2
12,119,119,8,8,0,1,0
0,121,121,1,1,0,1,0
20,141,141,46,46,0,1,0
14,189,189,2,2,0,1,0
3,191,191,8,8,0,1,0
5,194,194,11,11,0,1,0
15,194,194,1,1,0,1,0
10,241,241,2,2,0,1,0
19,246,246,61,61,0,1,0
8,257,257,49,49,0,1,0
17,290,290,16,2,14,3,2
11,302,302,16,9,7,2,1
21,304,304,3,3,0,1,0
22,312,312,73,11,62,3,2
2,317,317,1,1,0,1,0
16,323,323,15,15,0,1,0
23,350,350,5,5,0,1,0
4,353,353,13,13,0,1,0
13,397,397,9,9,0,1,0
6,403,403,38,21,17,2,1
1,405,405,106,58,48,3,2
7,449,449,6,6,0,1,0

11,132,132,2,2,0,1,0
6,146,146,6,1,5,2,1
3,226,226,46,46,0,1,0
9,238,238,5,2,3,2,1
14,254,254,39,39,0,1,0
13,259,259,25,3,22,3,2
5,264,264,43,31,12,4,3
4,325,325,48,48,0,1,0
10,354,354,7,4,3,2,1
0,361,361,14,14,0,1,0
12,361,361,90,90,0,1,0
7,373,373,99,40,59,3,2
2,405,405,17,17,0,1,0
8,434,434,66,66,0,1,0
1,476,476,193,55,138,4,3

5,121,121,18,6,12,2,1
3,128,128,6,6,0,1,0
15,128,128,27,27,0,1,0
12,128,128,3,3,0,1,0
18,140,140,26,3,23,3,2
14,144,144,4,4,0,1,0
16,159,159,1,1,0,1,0
10,164,164,55,55,0,1,0
19,193,193,44,22,22,2,1
9,235,235,20,20,0,1,0
17,257,257,40,13,27,3,2
13,269,269,40,40,0,1,0
6,273,273,2,2,0,1,0
2,297,297,3,3,0,1,0
1,300,300,21,21,0,1,0
8,317,317,6,2,4,2,1
0,371,371,46,26,20,3,2
11,381,381,14,14,0,1,0
4,386,386,34,13,21,4,3
7,438,438,29,29,0,1,0

7,104,104,28,16,12,2,1
15,112,112,13,5,8,3,2
13,129,129,2,2,0,1,0
1,145,145,26,4,22,2,1
8,192,192,9,9,0,1,0
2,236,236,7,7,0,1,0
10,286,286,58,13,45,4,3
9,322,322,35,18,17,2,1
3,331,331,67,67,0,1,0
14,354,354,53,40,13,2,1
6,402,402,59,59,0,1,0
11,403,403,37,10,27,2,1
5,422,422,136,38,98,4,3
4,426,426,24,24,0,1,0
12,470,470,13,13,0,1,0
0,487,487,31,31,0,1,0

20,117,117,24,6,18,2,1
1,129,129,1,1,0,1,0
4,161,161,1,1,0,1,0
21,200,200,5,5,0,1,0
9,203,203,16,2,14,3,2
14,206,206,20,8,12,4,3
17,234,234,75,75,0,1,0
18,249,249,23,15,8,2,1
12,304,304,4,1,3,2,1
22,321,321,6,6,0,1,0
0,326,326,7,7,0,1,0
15,345,345,13,8,5,2,1
11,359,359,31,31,0,1,0
16,377,377,7,7,0,1,0
2,378,378,186,63,123,4,3
8,382,382,3,3,0,1,0
7,387,387,11,2,9,4,3
19,405,405,78,38,40,2,1
13,421,421,22,22,0,1,0
10,464,464,8,8,0,1,0
5,466,466,19,7,12,4,3
6,469,469,23,23,0,1,0
3,486,486,48,48,0,1,0

19,117,117,11,1,10,2,1
13,143,143,2,2,0,1,0
0,148,148,1,1,0,1,0
12,174,174,16,6,10,2,1
21,181,181,7,7,0,1,0
17,192,192,10,10,0,1,0
20,193,193,19,9,10,2,1
2,206,206,1,1,0,1,0
18,230,230,20,20,0,1,0
14,241,241,1,1,0,1,0
11,247,247,2,2,0,1,0
24,265,265,5,5,0,1,0
23,267,267,84,48,36,4,3
15,288,288,53,53,0,1,0
7,294,294,12,12,0,1,0
10,296,296,6,6,0,1,0
22,309,309,75,75,0,1,0
4,390,390,82,5,77,3,2
16,413,413,31,31,0,1,0
9,421,421,47,11,36,3,2
1,435,435,13,7,6,2,1
3,438,438,45,45,0,1,0
6,443,443,9,9,0,1,0
5,468,468,57,57,0,1,0
8,480,480,14,14,0,1,0

13,119,119,2,2,0,1,0
18,242,242,10,10,0,1,0
21,258,258,16,4,12,3,2
17,278,278,25,25,0,1,0
4,293,293,71,1,70,3,2
8,306,306,1,1,0,1,0
6,309,309,18,7,11,2,1
9,336,336,15,15,0,1,0
12,345,345,47,47,0,1,0
14,375,375,117,86,31,2,1
19,375,375,115,18,97,4,3
20,386,386,24,24,0,1,0
0,388,388,25,25,0,1,0
15,394,394,5,5,0,1,0
16,410,410,47,47,0,1,0
10,411,411,37,25,12,4,3
11,422,422,24,24,0,1,0
5,443,443,8,4,4,2,1
3,448,448,22,7,15,4,3
1,451,451,18,4,14,3,2
7,463,463,63,54,9,4,3
2,496,496,31,31,0,1,0

17,160,160,50,50,0,1,0
2,204,204,8,8,0,1,0
15,209,209,20,6,14,3,2
13,228,228,6,6,0,1,0
9,248,248,31,31,0,1,0
16,249,249,25,13,12,2,1
6,253,253,35,35,0,1,0
8,266,266,18,18,0,1,0
14,299,299,65,32,33,2,1
11,333,333,13,7,6,2,1
10,380,380,21,2,19,3,2
7,407,407,50,50,0,1,0
4,433,433,26,26,0,1,0
1,434,434,3,3,0,1,0
3,440,440,76,76,0,1,0
5,442,442,37,37,0,1,0
0,479,479,149,98,51,3,2
12,485,485,23,23,0,1,0

4,125,125,2,2,0,1,0
18,153,153,28,28,0,1,0
0,155,155,15,6,9,2,1
21,180,180,19,1,18,2,1
17,185,185,48,21,27,2,1
2,203,203,22,3,19,2,1
20,207,207,33,9,24,2,1
7,220,220,31,31,0,1,0
22,230,230,29,29,0,1,0
3,268,268,19,1,18,3,2
14,280,280,4,1,3,2,1
5,313,313,11,11,0,1,0
9,320,320,6,3,3,2,1
11,370,370,3,3,0,1,0
12,381,381,21,21,0,1,0
10,416,416,108,108,0,1,0
15,418,418,24,24,0,1,0
1,447,447,30,20,10,2,1
8,455,455,21,9,12,3,2
6,476,476,26,18,8,3,2
16,476,476,42,18,24,3,2
13,489,489,11,11,0,1,0
19,498,498,15,15,0,1,0

15,113,113,9,9,0,1,0
5,117,117,18,18,0,1,0
4,120,120,3,3,0,1,0
12,195,195,1,1,0,1,0
8,199,199,6,2,4,2,1
0,270,270,33,3,30,4,3
3,283,283,5,1,4,2,1
13,300,300,20,11,9,4,3
2,309,309,84,73,11,2,1
1,318,318,56,56,0,1,0
11,348,348,144,144,0,1,0
14,386,386,61,3,58,4,3
7,414,414,12,3,9,2,1
9,453,453,102,82,20,2,1
6,477,477,112,6,106,4,3
10,483,483,2,2,0,1,0

11,111,111,15,15,0,1,0
17,125,125,12,8,4,2,1
4,134,134,9,9,0,1,0
1,155,155,2,2,0,1,0
18,158,158,48,8,40,3,2
9,167,167,6,6,0,1,0
15,191,191,3,3,0,1,0
0,199,199,39,26,13,2,1
3,200,200,5,5,0,1,0
5,207,207,7,1,6,2,1
2,228,228,8,4,4,2,1
20,241,241,10,10,0,1,0
7,247,247,2,2,0,1,0
10,248,248,21,21,0,1,0
12,301,301,7,2,5,2,1
6,304,304,94,52,42,3,2
19,306,306,69,18,51,4,3
14,384,384,52,18,34,2,1
13,452,452,24,2,22,2,1
16,461,461,58,50,8,2,1
8,489,489,30,4,26,3,2

17,175,175,18,18,0,1,0
2,195,195,1,1,0,1,0
7,222,222,18,6,12,4,3
1,246,246,8,8,0,1,0
3,253,253,28,28,0,1,0
14,254,254,61,61,0,1,0
9,268,268,8,8,0,1,0
11,269,269,10,4,6,2,1
18,307,307,70,70,0,1,0
12,347,347,52,33,19,2,1
15,351,351,45,9,36,2,1
5,357,357,19,6,13,2,1
4,367,367,12,12,0,1,0
10,424,424,6,6,0,1,0
6,443,443,36,27,9,2,1
13,484,484,38,38,0,1,0
8,486,486,127,63,64,3,2
0,494,494,155,23,132,4,3
16,495,495,19,19,0,1,0

19,117,117,8,1,7,2,1
2,145,145,10,4,6,3,2
10,148,148,1,1,0,1,0
14,202,202,5,5,0,1,0
4,247,247,1,1,0,1,0
12,251,251,18,18,0,1,0
13,275,275,9,9,0,1,0
3,300,300,8,8,0,1,0
8,339,339,43,6,37,4,3
9,364,364,9,6,3,2,1
15,398,398,146,146,0,1,0
1,415,415,17,17,0,1,0
18,420,420,107,107,0,1,0
11,449,449,29,29,0,1,0
20,450,450,2,2,0,1,0
17,454,454,17,17,0,1,0
5,459,459,27,15,12,4,3
0,460,460,47,39,8,2,1
7,479,479,125,125,0,1,0
16,487,487,75,70,5,2,1
6,497,497,107,62,45,4,3

10,110,110,7,4,3,2,1
8,159,159,9,9,0,1,0
6,236,236,73,73,0,1,0
7,251,251,39,9,30,4,3
1,280,280,22,22,0,1,0
14,340,340,3,3,0,1,0
11,364,364,12,12,0,1,0
4,365,365,39,21,18,4,3
12,365,365,10,10,0,1,0
9,386,386,140,140,0,1,0
0,417,417,232,232,0,1,0
3,417,417,33,33,0,1,0
5,442,442,37,7,30,3,2
13,469,469,3,3,0,1,0
2,488,488,47,47,0,1,0

5,152,152,26,26,0,1,0
0,167,167,39,18,21,2,1
16,205,205,47,27,20,3,2
3,248,248,24,6,18,2,1
9,277,277,54,54,0,1,0
15,305,305,8,8,0,1,0
6,321,321,28,28,0,1,0
12,337,337,62,36,26,3,2
14,343,343,5,5,0,1,0
8,350,350,39,39,0,1,0
13,377,377,3,3,0,1,0
1,396,396,2,2,0,1,0
17,411,411,47,47,0,1,0
18,427,427,119,95,24,3,2
2,430,430,22,4,18,4,3
7,435,435,4,4,0,1,0
10,468,468,49,49,0,1,0
11,488,488,26,26,0,1,0
4,491,491,20,11,9,4,3

2,115,115,13,13,0,1,0
15,143,143,13,7,6,3,2
11,243,243,32,3,29,2,1
0,244,244,13,5,8,2,1
3,264,264,113,5,108,4,3
8,268,268,9,9,0,1,0
10,290,290,16,16,0,1,0
14,308,308,55,55,0,1,0
5,331,331,13,1,12,2,1
4,341,341,8,3,5,2,1
7,354,354,100,60,40,3,2
9,375,375,77,77,0,1,0
12,385,385,55,55,0,1,0
13,403,403,15,15,0,1,0
16,423,423,25,25,0,1,0
1,467,467,10,10,0,1,0
17,482,482,54,54,0,1,0
6,499,499,4,4,0,1,0

7,129,129,21,3,18,2,1
9,132,132,24,24,0,1,0
1,156,156,1,1,0,1,0
10,158,158,4,4,0,1,0
12,169,169,2,2,0,1,0
11,198,198,74,49,25,2,1
5,206,206,16,4,12,3,2
14,229,229,10,10,0,1,0
8,240,240,9,9,0,1,0
6,244,244,22,22,0,1,0
2,272,272,24,24,0,1,0
15,286,286,2,2,0,1,0
0,290,290,91,91,0,1,0
3,342,342,47,42,5,2,1
4,357,357,32,15,17,4,3
16,359,359,43,43,0,1,0
13,365,365,11,11,0,1,0
17,470,470,105,105,0,1,0

17,131,131,6,6,0,1,0
16,132,132,24,18,6,2,1
9,146,146,14,14,0,1,0
6,150,150,3,3,0,1,0
4,163,163,1,1,0,1,0
12,180,180,2,2,0,1,0
1,234,234,30,30,0,1,0
15,255,255,1,1,0,1,0
5,264,264,20,2,18,2,1
10,312,312,126,126,0,1,0
11,347,347,10,5,5,2,1
18,373,373,90,90,0,1,0
7,384,384,10,10,0,1,0
13,387,387,35,35,0,1,0
3,419,419,68,38,30,3,2
14,436,436,3,3,0,1,0
2,449,449,67,67,0,1,0
8,481,481,8,1,7,2,1
0,500,500,163,108,55,3,2

13,130,130,40,40,0,1,0
7,214,214,14,5,9,2,1
18,214,214,1,1,0,1,0
1,222,222,36,36,0,1,0
2,257,257,41,36,5,2,1
4,259,259,3,3,0,1,0
14,269,269,22,22,0,1,0
16,298,298,31,31,0,1,0
5,327,327,33,33,0,1,0
15,343,343,3,3,0,1,0
8,352,352,40,40,0,1,0
0,359,359,2,2,0,1,0
6,359,359,25,25,0,1,0
17,365,365,28,28,0,1,0
19,368,368,80,37,43,2,1
3,390,390,85,23,62,3,2
9,405,405,33,33,0,1,0
12,408,408,85,19,66,4,3
10,435,435,6,3,3,2,1
11,437,437,3,3,0,1,0

13,101,101,18,18,0,1,0
8,104,104,4,4,0,1,0
14,162,162,14,14,0,1,0
1,191,191,29,29,0,1,0
3,191,191,48,3,45,2,1
9,236,236,33,12,21,2,1
12,305,305,27,27,0,1,0
2,347,347,134,90,44,2,1
4,377,377,9,1,8,3,2
7,379,379,29,29,0,1,0
0,386,386,18,18,0,1,0
5,410,410,58,36,22,2,1
6,431,431,34,24,10,3,2
10,445,445,49,29,20,3,2
11,497,497,111,63,48,4,3

6,105,105,4,4,0,1,0
8,130,130,9,1,8,3,2
4,134,134,22,6,16,3,2
13,175,175,55,25,30,3,2
14,178,178,22,22,0,1,0
7,233,233,52,52,0,1,0
1,271,271,48,8,40,2,1
2,273,273,3,3,0,1,0
9,275,275,35,35,0,1,0
10,309,309,3,3,0,1,0
5,315,315,44,2,42,2,1
12,326,326,16,1,15,4,3
17,367,367,19,7,12,4,3
16,372,372,109,61,48,4,3
0,377,377,21,1,20,2,1
15,383,383,7,7,0,1,0
11,481,481,13,13,0,1,0
3,490,490,62,14,48,2,1

4,116,116,8,8,0,1,0
0,121,121,1,1,0,1,0
9,132,132,11,4,7,2,1
26,155,155,13,13,0,1,0
12,174,174,13,13,0,1,0
5,174,174,1,1,0,1,0
2,180,180,18,18,0,1,0
8,188,188,1,1,0,1,0
14,233,233,8,8,0,1,0
17,234,234,19,19,0,1,0
24,236,236,7,7,0,1,0
16,242,242,17,2,15,2,1
18,245,245,33,7,26,3,2
11,256,256,28,28,0,1,0
10,278,278,11,4,7,2,1
19,305,305,14,14,0,1,0
6,318,318,37,31,6,3,2
21,348,348,81,17,64,3,2
13,360,360,13,13,0,1,0
3,375,375,40,40,0,1,0
15,377,377,1,1,0,1,0
20,393,393,25,17,8,2,1
1,410,410,9,9,0,1,0
7,413,413,15,6,9,2,1
22,429,429,72,22,50,3,2
23,441,441,42,15,27,2,1
25,457,457,74,74,0,1,0

0,112,112,10,1,9,2,1
17,159,159,16,9,7,2,1
12,165,165,57,19,38,3,2
3,197,197,14,6,8,2,1
11,197,197,14,9,5,2,1
13,238,238,7,7,0,1,0
9,258,258,11,11,0,1,0
14,275,275,26,18,8,3,2
6,333,333,99,99,0,1,0
8,354,354,1,1,0,1,0
15,374,374,32,11,21,4,3
18,389,389,28,9,19,4,3
10,406,406,21,21,0,1,0
7,413,413,23,23,0,1,0
16,417,417,70,70,0,1,0
1,421,421,23,1,22,2,1
5,467,467,8,8,0,1,0
2,467,467,162,93,69,4,3
4,470,470,12,12,0,1,0

13,156,156,5,5,0,1,0
15,161,161,5,1,4,2,1
3,162,162,11,2,9,2,1
7,180,180,5,5,0,1,0
12,254,254,17,7,10,3,2
14,259,259,6,6,0,1,0
1,272,272,27,27,0,1,0
0,283,283,11,6,5,2,1
18,290,290,149,85,64,3,2
4,303,303,23,1,22,2,1
9,358,358,7,7,0,1,0
2,372,372,21,7,14,3,2
16,373,373,74,16,58,3,2
10,416,416,3,3,0,1,0
11,426,426,25,25,0,1,0
6,429,429,19,4,15,2,1
17,435,435,38,13,25,4,3
5,461,461,33,33,0,1,0
8,477,477,239,239,0,1,0

5,105,105,8,8,0,1,0
6,132,132,1,1,0,1,0
2,154,154,34,34,0,1,0
10,166,166,14,2,12,2,1
15,258,258,49,23,26,2,1
9,265,265,61,41,20,3,2
11,306,306,33,33,0,1,0
3,311,311,26,26,0,1,0
13,312,312,61,41,20,3,2
16,323,323,33,15,18,3,2
8,326,326,40,32,8,3,2
12,369,369,14,14,0,1,0
17,402,402,1,1,0,1,0
7,423,423,114,114,0,1,0
0,445,445,18,18,0,1,0
14,456,456,30,30,0,1,0
1,458,458,81,81,0,1,0
4,465,465,2,2,0,1,0

10,125,125,39,18,21,4,3
14,156,156,5,5,0,1,0
13,177,177,1,1,0,1,0
0,185,185,8,8,0,1,0
1,218,218,2,2,0,1,0
6,228,228,48,17,31,2,1
7,266,266,1,1,0,1,0
16,291,291,10,10,0,1,0
3,299,299,86,38,48,4,3
15,323,323,52,17,35,2,1
18,339,339,11,11,0,1,0
12,347,347,8,8,0,1,0
17,399,399,28,28,0,1,0
2,417,417,16,16,0,1,0
11,420,420,146,119,27,4,3
9,422,422,124,124,0,1,0
4,442,442,1,1,0,1,0
5,452,452,39,13,26,4,3
8,480,480,12,12,0,1,0

0,101,101,15,12,3,2,1
5,101,101,11,11,0,1,0
20,110,110,12,12,0,1,0
12,119,119,7,7,0,1,0
2,119,119,13,3,10,2,1
4,154,154,7,7,0,1,0
17,155,155,10,1,9,4,3
6,190,190,2,2,0,1,0
3,232,232,3,3,0,1,0
7,235,235,24,24,0,1,0
1,294,294,40,7,33,4,3
13,317,317,6,6,0,1,0
10,354,354,8,8,0,1,0
19,376,376,75,44,31,3,2
16,399,399,88,6,82,4,3
9,410,410,57,38,19,2,1
18,413,413,20,10,10,3,2
15,445,445,60,11,49,4,3
11,446,446,34,26,8,3,2
8,464,464,42,42,0,1,0
14,498,498,78,11,67,3,2

23,101,101,35,5,30,3,2
18,167,167,2,2,0,1,0
2,168,168,20,20,0,1,0
20,196,196,11,11,0,1,0
3,206,206,2,2,0,1,0
16,256,256,5,5,0,1,0
22,317,317,8,8,0,1,0
6,351,351,69,33,36,3,2
9,363,363,53,35,18,4,3
13,363,363,4,1,3,2,1
4,371,371,15,15,0,1,0
15,372,372,7,4,3,2,1
10,377,377,6,6,0,1,0
17,411,411,109,94,15,4,3
1,411,411,2,2,0,1,0
19,422,422,91,33,58,3,2
11,427,427,28,28,0,1,0
7,428,428,31,3,28,2,1
5,434,434,25,8,17,3,2
0,437,437,3,3,0,1,0
12,458,458,6,6,0,1,0
8,470,470,108,15,93,4,3
21,482,482,30,5,25,2,1
14,494,494,6,6,0,1,0

18,103,103,8,4,4,2,1
19,121,121,10,3,7,2,1
22,132,132,25,1,24,3,2
1,154,154,1,1,0,1,0
23,156,156,37,37,0,1,0
10,159,159,16,16,0,1,0
8,165,165,6,6,0,1,0
17,172,172,31,15,16,2,1
20,185,185,15,15,0,1,0
6,214,214,17,4,13,2,1
7,219,219,6,6,0,1,0
4,223,223,11,5,6,2,1
12,233,233,31,31,0,1,0
9,240,240,17,6,11,4,3
14,247,247,33,33,0,1,0
2,255,255,1,1,0,1,0
21,256,256,4,4,0,1,0
13,292,292,1,1,0,1,0
24,294,294,45,45,0,1,0
16,324,324,2,2,0,1,0
0,377,377,18,14,4,2,1
15,390,390,16,16,0,1,0
5,448,448,52,22,30,3,2
11,473,473,24,24,0,1,0
3,477,477,48,48,0,1,0

14,104,104,22,7,15,4,3
2,118,118,4,4,0,1,0
8,168,168,1,1,0,1,0
3,185,185,5,5,0,1,0
18,242,242,38,38,0,1,0
1,255,255,17,1,16,2,1
6,272,272,20,3,17,4,3
0,334,334,15,15,0,1,0
11,336,336,11,1,10,2,1
9,345,345,7,1,6,2,1
13,401,401,32,32,0,1,0
17,409,409,47,47,0,1,0
12,418,418,146,146,0,1,0
19,450,450,3,3,0,1,0
15,460,460,14,10,4,2,1
5,463,463,20,20,0,1,0
4,483,483,108,24,84,4,3
7,491,491,98,98,0,1,0
10,494,494,130,74,56,3,2
16,496,496,17,17,0,1,0

23,119,119,11,3,8,2,1
1,144,144,4,4,0,1,0
9,146,146,3,3,0,1,0
5,172,172,8,8,0,1,0
14,178,178,34,34,0,1,0
25,189,189,5,5,0,1,0
24,212,212,3,3,0,1,0
7,229,229,1,1,0,1,0
12,272,272,18,18,0,1,0
17,272,272,37,37,0,1,0
18,277,277,24,24,0,1,0
22,278,278,13,3,10,3,2
20,280,280,14,9,5,2,1
16,289,289,3,3,0,1,0
26,293,293,120,33,87,4,3
2,310,310,9,9,0,1,0
10,340,340,8,8,0,1,0
13,346,346,5,2,3,2,1
21,361,361,32,32,0,1,0
4,370,370,24,4,20,4,3
6,399,399,17,1,16,3,2
15,405,405,19,19,0,1,0
0,420,420,24,24,0,1,0
3,428,428,45,45,0,1,0
8,451,451,38,38,0,1,0
19,479,479,94,4,90,4,3
11,488,488,15,3,12,2,1

12,160,160,37,37,0,1,0
4,197,197,27,27,0,1,0
18,205,205,1,1,0,1,0
14,208,208,12,12,0,1,0
10,226,226,1,1,0,1,0
8,227,227,4,1,3,2,1
0,239,239,18,18,0,1,0
11,251,251,29,29,0,1,0
17,254,254,37,31,6,2,1
16,265,265,10,10,0,1,0
13,271,271,45,24,21,2,1
5,283,283,77,68,9,4,3
2,303,303,11,11,0,1,0
15,363,363,94,1,93,4,3
9,389,389,5,5,0,1,0
6,407,407,52,52,0,1,0
7,450,450,41,41,0,1,0
1,462,462,53,53,0,1,0
3,485,485,56,56,0,1,0

1,108,108,39,27,12,2,1
12,147,147,12,12,0,1,0
20,152,152,3,3,0,1,0
14,152,152,68,68,0,1,0
0,157,157,19,1,18,4,3
16,161,161,10,10,0,1,0
21,220,220,45,28,17,3,2
7,277,277,6,6,0,1,0
2,283,283,13,13,0,1,0
9,288,288,1,1,0,1,0
3,316,316,32,21,11,2,1
18,321,321,4,4,0,1,0
19,351,351,1,1,0,1,0
11,354,354,2,2,0,1,0
6,362,362,26,11,15,2,1
8,373,373,1,1,0,1,0
15,386,386,64,28,36,3,2
13,404,404,21,7,14,2,1
10,442,442,16,16,0,1,0
17,484,484,28,4,24,4,3
5,487,487,24,9,15,4,3
4,495,495,49,49,0,1,0

2,107,107,15,11,4,2,1
11,108,108,6,2,4,2,1
0,122,122,5,5,0,1,0
18,128,128,1,1,0,1,0
14,135,135,10,10,0,1,0
1,145,145,7,1,6,2,1
6,155,155,2,2,0,1,0
20,183,183,20,8,12,2,1
12,199,199,1,1,0,1,0
23,242,242,72,14,58,3,2
16,280,280,14,14,0,1,0
17,284,284,4,4,0,1,0
7,299,299,23,14,9,4,3
22,302,302,1,1,0,1,0
10,325,325,6,6,0,1,0
5,340,340,3,3,0,1,0
8,419,419,2,2,0,1,0
24,426,426,31,31,0,1,0
13,432,432,39,39,0,1,0
21,437,437,64,64,0,1,0
3,437,437,49,49,0,1,0
9,447,447,53,53,0,1,0
15,448,448,84,6,78,3,2
4,453,453,3,3,0,1,0
19,457,457,144,140,4,2,1

10,136,136,8,1,7,2,1
4,153,153,6,6,0,1,0
0,178,178,11,4,7,2,1
1,201,201,2,2,0,1,0
17,218,218,22,2,20,4,3
13,223,223,1,1,0,1,0
25,232,232,80,62,18,4,3
24,240,240,12,12,0,1,0
11,244,244,29,26,3,2,1
15,252,252,10,7,3,2,1
21,265,265,11,5,6,3,2
2,274,274,12,2,10,2,1
16,294,294,11,11,0,1,0
5,295,295,10,10,0,1,0
12,299,299,20,16,4,2,1
18,331,331,46,4,42,4,3
23,345,345,8,8,0,1,0
3,346,346,58,58,0,1,0
6,356,356,31,31,0,1,0
14,389,389,2,2,0,1,0
9,389,389,4,4,0,1,0
22,421,421,15,15,0,1,0
19,435,435,68,68,0,1,0
20,444,444,54,54,0,1,0
26,477,477,50,50,0,1,0
8,489,489,37,25,12,2,1
7,495,495,20,20,0,1,0

7,101,101,3,3,0,1,0
19,104,104,16,16,0,1,0
15,109,109,4,1,3,2,1
5,116,116,1,1,0,1,0
23,122,122,6,6,0,1,0
16,214,214,8,8,0,1,0
18,219,219,22,22,0,1,0
1,224,224,1,1,0,1,0
9,230,230,26,26,0,1,0
6,263,263,9,9,0,1,0
24,270,270,65,65,0,1,0
8,282,282,4,4,0,1,0
3,292,292,9,3,6,3,2
2,297,297,14,9,5,2,1
4,366,366,11,11,0,1,0
10,371,371,63,63,0,1,0
17,384,384,34,4,30,4,3
0,412,412,6,2,4,2,1
12,423,423,2,2,0,1,0
21,439,439,9,9,0,1,0
14,446,446,69,37,32,2,1
22,447,447,16,16,0,1,0
13,470,470,106,91,15,4,3
25,470,470,117,82,35,2,1
20,480,480,39,15,24,4,3
11,497,497,23,23,0,1,0

3,143,143,1,1,0,1,0
12,157,157,3,3,0,1,0
15,164,164,36,36,0,1,0
20,188,188,5,5,0,1,0
22,190,190,12,12,0,1,0
8,199,199,9,9,0,1,0
1,239,239,1,1,0,1,0
6,276,276,14,8,6,2,1
23,278,278,11,6,5,2,1
14,298,298,1,1,0,1,0
5,299,299,67,21,46,2,1
7,304,304,2,2,0,1,0
18,304,304,48,48,0,1,0
2,306,306,24,20,4,2,1
9,323,323,23,23,0,1,0
4,341,341,8,2,6,3,2
0,384,384,47,47,0,1,0
24,406,406,36,20,16,3,2
19,422,422,52,18,34,3,2
10,432,432,1,1,0,1,0
13,433,433,1,1,0,1,0
17,435,435,152,152,0,1,0
21,446,446,60,42,18,2,1
16,459,459,16,16,0,1,0
11,493,493,61,61,0,1,0

7,101,101,17,5,12,4,3
11,129,129,5,5,0,1,0
12,131,131,14,7,7,3,2
10,139,139,4,4,0,1,0
8,156,156,2,2,0,1,0
6,200,200,5,1,4,2,1
14,242,242,79,66,13,2,1
5,247,247,53,40,13,4,3
15,259,259,9,9,0,1,0
0,262,262,41,8,33,4,3
4,279,279,25,3,22,2,1
1,295,295,4,4,0,1,0
9,295,295,60,12,48,4,3
17,318,318,32,4,28,2,1
13,334,334,20,2,18,3,2
19,354,354,104,104,0,1,0
3,367,367,32,14,18,2,1
2,373,373,2,2,0,1,0
16,383,383,6,6,0,1,0
18,499,499,24,19,5,2,1

10,136,136,11,1,10,3,2
11,166,166,28,28,0,1,0
16,186,186,45,28,17,3,2
7,191,191,10,10,0,1,0
9,208,208,15,12,3,2,1
0,216,216,12,3,9,2,1
2,241,241,37,13,24,3,2
12,266,266,22,22,0,1,0
1,297,297,14,14,0,1,0
3,299,299,28,28,0,1,0
14,312,312,13,13,0,1,0
15,354,354,70,70,0,1,0
6,414,414,77,77,0,1,0
17,414,414,30,30,0,1,0
4,424,424,142,88,54,4,3
5,469,469,35,35,0,1,0
8,474,474,2,2,0,1,0
13,499,499,30,9,21,4,3

13,122,122,11,7,4,2,1
5,161,161,30,5,25,2,1
3,174,174,1,1,0,1,0
0,178,178,1,1,0,1,0
17,202,202,48,48,0,1,0
4,217,217,15,15,0,1,0
11,230,230,18,6,12,2,1
1,246,246,51,27,24,4,3
16,264,264,44,8,36,3,2
15,313,313,20,8,12,4,3
12,355,355,4,4,0,1,0
2,390,390,26,26,0,1,0
14,393,393,32,32,0,1,0
6,409,409,30,21,9,2,1
7,419,419,110,110,0,1,0
8,428,428,53,35,18,2,1
10,473,473,53,20,33,4,3
9,487,487,86,18,68,3,2

6,102,102,1,1,0,1,0
9,124,124,24,6,18,4,3
4,127,127,8,2,6,2,1
15,170,170,6,6,0,1,0
17,209,209,7,7,0,1,0
20,211,211,9,1,8,2,1
12,228,228,48,17,31,2,1
14,230,230,1,1,0,1,0
19,274,274,103,66,37,2,1
8,279,279,6,6,0,1,0
1,282,282,34,12,22,3,2
18,305,305,56,56,0,1,0
10,307,307,8,1,7,2,1
7,309,309,20,20,0,1,0
16,345,345,30,15,15,4,3
11,381,381,19,4,15,4,3
0,390,390,14,14,0,1,0
13,439,439,21,7,14,2,1
5,444,444,26,26,0,1,0
2,465,465,65,35,30,3,2
3,475,475,104,32,72,4,3

11,118,118,9,9,0,1,0
6,144,144,2,2,0,1,0
4,162,162,10,3,7,2,1
13,163,163,9,9,0,1,0
0,168,168,3,3,0,1,0
18,192,192,20,20,0,1,0
19,285,285,14,14,0,1,0
7,297,297,97,9,88,3,2
5,305,305,6,6,0,1,0
3,328,328,56,26,30,2,1
14,365,365,150,87,63,4,3
17,372,372,44,6,38,3,2
15,383,383,27,27,0,1,0
12,400,400,20,20,0,1,0
9,403,403,7,1,6,2,1
16,421,421,36,9,27,2,1
8,444,444,12,2,10,2,1
2,470,470,95,25,70,3,2
10,489,489,55,23,32,3,2
1,497,497,16,16,0,1,0

11,132,132,8,2,6,3,2
4,138,138,2,2,0,1,0
1,203,203,17,17,0,1,0
12,205,205,24,24,0,1,0
17,205,205,4,1,3,2,1
14,207,207,48,48,0,1,0
6,214,214,15,15,0,1,0
13,229,229,15,6,9,4,3
20,243,243,16,16,0,1,0
7,274,274,40,32,8,2,1
21,277,277,103,103,0,1,0
5,293,293,3,3,0,1,0
19,305,305,8,4,4,2,1
0,324,324,34,34,0,1,0
18,335,335,2,2,0,1,0
2,337,337,45,16,29,4,3
9,368,368,12,12,0,1,0
3,380,380,17,17,0,1,0
15,392,392,83,11,72,4,3
10,453,453,52,24,28,3,2
16,477,477,10,10,0,1,0
8,482,482,33,9,24,3,2

7,109,109,58,58,0,1,0
9,110,110,25,25,0,1,0
2,166,166,14,1,13,2,1
4,170,170,32,12,20,2,1
11,198,198,48,48,0,1,0
13,205,205,21,13,8,2,1
10,206,206,48,30,18,2,1
16,210,210,12,12,0,1,0
6,246,246,6,6,0,1,0
1,261,261,5,2,3,2,1
14,261,261,7,7,0,1,0
12,319,319,4,4,0,1,0
5,326,326,17,17,0,1,0
15,348,348,16,16,0,1,0
8,350,350,26,7,19,2,1
3,358,358,26,26,0,1,0
0,412,412,14,14,0,1,0

0,101,101,6,6,0,1,0
20,115,115,31,19,12,2,1
5,138,138,6,6,0,1,0
10,168,168,22,22,0,1,0
2,221,221,6,6,0,1,0
13,241,241,7,7,0,1,0
14,246,246,66,31,35,2,1
12,260,260,31,14,17,2,1
3,264,264,82,82,0,1,0
19,267,267,11,11,0,1,0
4,268,268,7,7,0,1,0
17,278,278,22,10,12,3,2
16,301,301,41,5,36,3,2
15,321,321,16,16,0,1,0
6,353,353,41,41,0,1,0
8,366,366,1,1,0,1,0
9,400,400,11,5,6,2,1
7,429,429,66,66,0,1,0
18,429,429,11,11,0,1,0
11,457,457,40,4,36,2,1
1,480,480,7,4,3,2,1

6,119,119,1,1,0,1,0
9,140,140,17,17,0,1,0
4,143,143,3,3,0,1,0
0,174,174,44,14,30,3,2
1,223,223,12,12,0,1,0
10,234,234,47,21,26,3,2
3,255,255,7,7,0,1,0
14,271,271,31,31,0,1,0
2,290,290,36,36,0,1,0
16,348,348,58,58,0,1,0
13,355,355,36,26,10,2,1
11,390,390,47,13,34,3,2
5,391,391,27,27,0,1,0
15,397,397,27,27,0,1,0
18,422,422,70,52,18,2,1
12,423,423,29,29,0,1,0
7,452,452,20,20,0,1,0
8,484,484,136,10,126,4,3
17,484,484,3,3,0,1,0

20,102,102,38,7,31,2,1
10,110,110,22,22,0,1,0
9,116,116,5,5,0,1,0
3,121,121,5,5,0,1,0
5,177,177,1,1,0,1,0
16,230,230,23,23,0,1,0
6,279,279,36,36,0,1,0
8,299,299,13,13,0,1,0
0,318,318,27,27,0,1,0
4,328,328,15,2,13,4,3
17,332,332,23,23,0,1,0
13,366,366,37,37,0,1,0
11,373,373,13,7,6,2,1
15,383,383,22,10,12,2,1
12,384,384,9,9,0,1,0
2,386,386,39,22,17,2,1
14,390,390,31,19,12,3,2
18,455,455,43,9,34,2,1
1,480,480,52,19,33,4,3
7,482,482,79,79,0,1,0
19,498,498,58,58,0,1,0

12,120,120,16,4,12,3,2
8,124,124,14,9,5,2,1
5,124,124,18,7,11,2,1
7,154,154,2,2,0,1,0
2,184,184,6,6,0,1,0
3,208,208,50,8,42,2,1
9,252,252,37,37,0,1,0
13,262,262,15,2,13,2,1
17,269,269,28,1,27,4,3
0,284,284,1,1,0,1,0
11,327,327,3,3,0,1,0
4,333,333,7,7,0,1,0
1,359,359,81,81,0,1,0
6,362,362,75,30,45,4,3
16,386,386,125,125,0,1,0
15,405,405,71,29,42,4,3
10,422,422,13,1,12,4,3
14,500,500,20,1,19,2,1

14,127,127,3,3,0,1,0
13,140,140,6,6,0,1,0
16,220,220,1,1,0,1,0
17,259,259,73,73,0,1,0
15,263,263,16,5,11,4,3
11,265,265,39,13,26,3,2
10,268,268,20,20,0,1,0
1,278,278,19,16,3,2,1
12,302,302,5,5,0,1,0
3,302,302,1,1,0,1,0
7,326,326,57,40,17,2,1
2,334,334,55,55,0,1,0
8,391,391,59,49,10,3,2
4,393,393,32,32,0,1,0
5,416,416,69,49,20,2,1
6,453,453,76,48,28,2,1
9,470,470,174,130,44,3,2
0,479,479,11,11,0,1,0

12,140,140,1,1,0,1,0
15,142,142,8,8,0,1,0
8,145,145,30,30,0,1,0
2,164,164,45,45,0,1,0
19,174,174,51,51,0,1,0
3,206,206,6,6,0,1,0
10,260,260,24,19,5,2,1
14,269,269,48,45,3,2,1
4,363,363,4,1,3,2,1
5,365,365,28,15,13,2,1
13,369,369,95,87,8,3,2
18,371,371,2,2,0,1,0
1,376,376,34,7,27,4,3
9,401,401,9,4,5,2,1
0,405,405,31,1,30,4,3
17,428,428,86,81,5,2,1
6,448,448,35,11,24,4,3
11,470,470,7,3,4,2,1
7,475,475,20,20,0,1,0
16,483,483,4,4,0,1,0

18,132,132,2,2,0,1,0
9,181,181,6,6,0,1,0
0,195,195,29,17,12,3,2
8,255,255,81,69,12,4,3
1,283,283,2,2,0,1,0
2,286,286,3,3,0,1,0
7,305,305,4,4,0,1,0
11,318,318,51,33,18,4,3
5,346,346,54,7,47,2,1
3,363,363,10,10,0,1,0
15,365,365,7,1,6,3,2
17,373,373,9,9,0,1,0
6,388,388,46,46,0,1,0
16,402,402,108,69,39,2,1
14,420,420,91,83,8,2,1
4,426,426,72,29,43,3,2
13,436,436,58,55,3,2,1
12,451,451,58,35,23,4,3
10,481,481,24,24,0,1,0

27,124,124,3,3,0,1,0
18,145,145,1,1,0,1,0
0,152,152,11,8,3,2,1
26,197,197,9,5,4,2,1
24,205,205,95,46,49,2,1
12,220,220,19,19,0,1,0
23,241,241,29,13,16,3,2
7,256,256,32,32,0,1,0
6,260,260,38,20,18,4,3
1,272,272,5,5,0,1,0
2,278,278,12,12,0,1,0
21,289,289,17,3,14,3,2
16,296,296,1,1,0,1,0
3,300,300,5,2,3,2,1
4,313,313,70,47,23,2,1
5,333,333,8,2,6,3,2
8,336,336,8,8,0,1,0
11,396,396,5,5,0,1,0
10,407,407,22,10,12,4,3
15,414,414,13,13,0,1,0
22,424,424,6,6,0,1,0
13,429,429,4,4,0,1,0
14,444,444,42,42,0,1,0
9,454,454,5,5,0,1,0
17,454,454,1,1,0,1,0
25,460,460,66,42,24,2,1
20,476,476,35,5,30,4,3
19,485,485,37,6,31,2,1

10,131,131,16,5,11,2,1
23,147,147,9,4,5,2,1
21,172,172,3,3,0,1,0
4,179,179,1,1,0,1,0
12,180,180,11,2,9,4,3
22,180,180,15,10,5,2,1
17,182,182,18,18,0,1,0
16,220,220,9,9,0,1,0
9,236,236,9,9,0,1,0
0,240,240,22,22,0,1,0
3,244,244,1,1,0,1,0
24,258,258,60,19,41,4,3
18,259,259,15,9,6,2,1
2,259,259,23,23,0,1,0
25,264,264,41,7,34,3,2
15,272,272,23,14,9,4,3
20,278,278,21,21,0,1,0
11,306,306,15,15,0,1,0
8,314,314,4,4,0,1,0
19,328,328,78,78,0,1,0
14,342,342,22,7,15,4,3
7,345,345,12,5,7,2,1
6,394,394,5,2,3,2,1
5,451,451,53,53,0,1,0
1,459,459,3,3,0,1,0
13,494,494,83,33,50,3,2

2,106,106,14,14,0,1,0
9,114,114,4,4,0,1,0
6,136,136,1,1,0,1,0
5,139,139,60,60,0,1,0
14,172,172,20,20,0,1,0
13,174,174,14,14,0,1,0
3,176,176,11,6,5,2,1
11,202,202,9,9,0,1,0
12,254,254,2,2,0,1,0
15,258,258,68,47,21,4,3
8,261,261,52,4,48,4,3
7,300,300,7,7,0,1,0
0,402,402,22,22,0,1,0
1,406,406,16,16,0,1,0
16,422,422,104,104,0,1,0
10,432,432,13,1,12,2,1
4,457,457,115,115,0,1,0

12,175,175,7,7,0,1,0
2,202,202,14,14,0,1,0
15,211,211,10,10,0,1,0
0,218,218,26,26,0,1,0
9,227,227,4,4,0,1,0
16,275,275,6,1,5,2,1
11,293,293,48,48,0,1,0
6,326,326,8,8,0,1,0
1,333,333,70,70,0,1,0
5,385,385,88,88,0,1,0
13,391,391,17,4,13,3,2
14,392,392,99,99,0,1,0
17,399,399,30,30,0,1,0
3,417,417,84,84,0,1,0
10,421,421,147,75,72,3,2
4,425,425,8,8,0,1,0
7,478,478,43,43,0,1,0
8,488,488,19,19,0,1,0

11,123,123,5,1,4,2,1
7,132,132,7,7,0,1,0
10,180,180,25,19,6,2,1
2,187,187,7,7,0,1,0
14,191,191,32,10,22,2,1
16,219,219,23,23,0,1,0
15,228,228,29,29,0,1,0
4,280,280,11,11,0,1,0
8,289,289,9,9,0,1,0
20,353,353,3,3,0,1,0
5,362,362,31,15,16,3,2
3,372,372,23,5,18,3,2
18,374,374,18,3,15,2,1
17,401,401,103,57,46,2,1
0,408,408,44,9,35,2,1
6,417,417,86,10,76,3,2
13,433,433,35,8,27,2,1
19,445,445,27,3,24,3,2
12,461,461,74,65,9,4,3
9,479,479,92,36,56,3,2
1,486,486,4,4,0,1,0

8,166,166,16,6,10,2,1
14,171,171,10,6,4,2,1
11,188,188,33,9,24,3,2
15,272,272,2,2,0,1,0
0,296,296,65,65,0,1,0
4,297,297,34,34,0,1,0
13,313,313,12,1,11,3,2
18,319,319,5,5,0,1,0
12,325,325,5,5,0,1,0
9,328,328,6,2,4,2,1
16,341,341,70,70,0,1,0
2,348,348,29,3,26,2,1
6,352,352,75,75,0,1,0
17,396,396,129,129,0,1,0
7,425,425,8,8,0,1,0
10,442,442,49,49,0,1,0
19,458,458,81,75,6,3,2
5,480,480,20,20,0,1,0
3,498,498,21,9,12,3,2
1,500,500,21,21,0,1,0

8,103,103,23,6,17,2,1
6,140,140,4,4,0,1,0
14,177,177,2,2,0,1,0
2,179,179,1,1,0,1,0
16,187,187,31,31,0,1,0
15,189,189,26,26,0,1,0
0,230,230,46,46,0,1,0
12,242,242,107,107,0,1,0
10,298,298,112,112,0,1,0
9,309,309,16,8,8,3,2
7,312,312,9,9,0,1,0
1,342,342,2,2,0,1,0
3,383,383,15,5,10,3,2
5,393,393,8,2,6,3,2
13,410,410,4,4,0,1,0
17,435,435,48,17,31,2,1
18,441,441,9,9,0,1,0
11,459,459,6,6,0,1,0
4,474,474,10,3,7,2,1
19,500,500,56,26,30,4,3

7,111,111,10,6,4,2,1
9,118,118,1,1,0,1,0
12,170,170,37,16,21,4,3
16,173,173,10,2,8,2,1
15,209,209,28,28,0,1,0
13,227,227,6,6,0,1,0
10,229,229,57,22,35,2,1
5,261,261,11,11,0,1,0
8,287,287,18,4,14,3,2
3,295,295,17,9,8,3,2
17,358,358,5,1,4,2,1
2,418,418,39,8,31,2,1
0,445,445,6,6,0,1,0
14,455,455,114,14,100,4,3
4,467,467,131,46,85,4,3
6,468,468,160,70,90,4,3
11,489,489,32,32,0,1,0
1,493,493,10,2,8,2,1

1,107,107,19,9,10,2,1
16,119,119,22,22,0,1,0
3,130,130,9,1,8,2,1
13,152,152,20,20,0,1,0
4,167,167,40,1,39,4,3
14,175,175,52,18,34,2,1
12,269,269,4,1,3,2,1
9,312,312,41,19,22,3,2
5,336,336,50,45,5,2,1
2,367,367,3,3,0,1,0
10,374,374,42,42,0,1,0
15,389,389,2,2,0,1,0
8,404,404,36,33,3,2,1
0,448,448,84,80,4,2,1
6,452,452,27,18,9,3,2
11,454,454,24,24,0,1,0
7,493,493,54,19,35,2,1

15,106,106,12,6,6,2,1
2,149,149,52,52,0,1,0
7,156,156,4,4,0,1,0
4,185,185,9,1,8,2,1
1,209,209,21,6,15,4,3
11,212,212,2,2,0,1,0
10,234,234,1,1,0,1,0
3,273,273,3,3,0,1,0
8,283,283,5,5,0,1,0
17,286,286,33,33,0,1,0
12,306,306,8,1,7,2,1
0,325,325,19,19,0,1,0
14,340,340,4,4,0,1,0
5,356,356,1,1,0,1,0
9,370,370,95,3,92,4,3
13,376,376,31,17,14,3,2
19,385,385,76,40,36,2,1
18,389,389,63,63,0,1,0
6,407,407,4,4,0,1,0
16,429,429,56,30,26,4,3
20,440,440,46,36,10,2,1
22,443,443,42,36,6,3,2
21,457,457,39,11,28,3,2

8,101,101,1,1,0,1,0
2,194,194,30,2,28,2,1
1,200,200,1,1,0,1,0
6,225,225,13,1,12,4,3
10,273,273,19,19,0,1,0
20,278,278,11,11,0,1,0
17,278,278,51,51,0,1,0
18,327,327,63,47,16,2,1
15,337,337,17,7,10,2,1
16,344,344,112,97,15,4,3
13,352,352,40,40,0,1,0
3,355,355,82,64,18,4,3
5,365,365,28,28,0,1,0
9,399,399,9,2,7,2,1
11,407,407,27,27,0,1,0
4,424,424,34,16,18,4,3
19,436,436,24,24,0,1,0
7,438,438,54,54,0,1,0
12,484,484,11,11,0,1,0
0,494,494,51,40,11,2,1
14,496,496,15,15,0,1,0

0,117,117,8,3,5,2,1
2,133,133,30,30,0,1,0
15,134,134,11,11,0,1,0
9,135,135,2,2,0,1,0
13,163,163,6,6,0,1,0
1,189,189,26,26,0,1,0
14,229,229,41,13,28,2,1
10,236,236,59,59,0,1,0
7,246,246,23,23,0,1,0
3,277,277,6,1,5,2,1
4,282,282,66,66,0,1,0
6,336,336,45,20,25,2,1
12,336,336,58,22,36,3,2
8,373,373,21,21,0,1,0
5,378,378,68,68,0,1,0
11,489,489,70,43,27,4,3

8,106,106,6,6,0,1,0
18,127,127,2,2,0,1,0
10,143,143,8,1,7,2,1
0,148,148,6,6,0,1,0
9,157,157,1,1,0,1,0
16,177,177,32,7,25,2,1
4,210,210,45,17,28,3,2
14,243,243,11,11,0,1,0
15,256,256,3,3,0,1,0
13,262,262,10,10,0,1,0
17,266,266,131,83,48,4,3
3,276,276,7,7,0,1,0
11,291,291,10,10,0,1,0
6,307,307,43,23,20,3,2
19,312,312,25,25,0,1,0
5,364,364,27,27,0,1,0
7,386,386,102,78,24,4,3
2,422,422,23,23,0,1,0
1,424,424,30,30,0,1,0
12,478,478,60,21,39,4,3

2,135,135,4,1,3,2,1
7,148,148,1,1,0,1,0
6,179,179,1,1,0,1,0
10,207,207,42,42,0,1,0
8,224,224,4,1,3,2,1
13,260,260,19,19,0,1,0
16,262,262,43,30,13,2,1
1,263,263,5,5,0,1,0
14,310,310,33,33,0,1,0
4,312,312,121,121,0,1,0
17,361,361,63,11,52,3,2
11,378,378,9,4,5,2,1
21,382,382,4,4,0,1,0
3,396,396,1,1,0,1,0
20,401,401,130,130,0,1,0
9,415,415,27,27,0,1,0
19,439,439,11,2,9,4,3
18,447,447,36,36,0,1,0
12,451,451,56,14,42,3,2
0,456,456,46,46,0,1,0
15,489,489,27,27,0,1,0
5,494,494,8,8,0,1,0

4,101,101,18,18,0,1,0
12,110,110,7,7,0,1,0
6,112,112,4,4,0,1,0
9,115,115,7,1,6,2,1
16,132,132,12,7,5,2,1
3,140,140,1,1,0,1,0
19,153,153,2,2,0,1,0
17,172,172,45,45,0,1,0
21,196,196,30,30,0,1,0
11,216,216,31,31,0,1,0
18,217,217,13,13,0,1,0
0,264,264,13,13,0,1,0
2,289,289,52,52,0,1,0
8,304,304,13,2,11,4,3
14,327,327,17,11,6,2,1
13,332,332,32,32,0,1,0
15,337,337,15,15,0,1,0
20,363,363,91,91,0,1,0
1,374,374,35,35,0,1,0
7,445,445,8,3,5,2,1
10,477,477,25,19,6,2,1
5,487,487,38,38,0,1,0

9,117,117,1,1,0,1,0
6,119,119,8,3,5,2,1
5,146,146,1,1,0,1,0
16,172,172,54,54,0,1,0
15,195,195,41,18,23,2,1
14,216,216,21,13,8,3,2
1,274,274,1,1,0,1,0
17,282,282,17,17,0,1,0
12,318,318,17,8,9,4,3
3,342,342,64,19,45,4,3
7,356,356,10,10,0,1,0
4,365,365,27,27,0,1,0
13,394,394,15,15,0,1,0
10,402,402,14,2,12,3,2
8,405,405,4,1,3,2,1
2,434,434,120,83,37,4,3
11,444,444,87,57,30,4,3
0,450,450,157,157,0,1,0

12,118,118,16,1,15,4,3
5,145,145,38,38,0,1,0
1,157,157,1,1,0,1,0
11,177,177,6,1,5,2,1
18,183,183,23,23,0,1,0
19,210,210,60,1,59,4,3
14,212,212,18,18,0,1,0
2,218,218,16,16,0,1,0
8,267,267,21,3,18,3,2
15,305,305,31,7,24,4,3
13,316,316,40,16,24,2,1
6,371,371,63,63,0,1,0
9,397,397,24,24,0,1,0
4,408,408,28,4,24,3,2
16,425,425,26,26,0,1,0
17,447,447,28,28,0,1,0
7,449,449,23,23,0,1,0
3,453,453,30,30,0,1,0
10,453,453,36,8,28,3,2
0,489,489,41,41,0,1,0

9,101,101,5,5,0,1,0
18,107,107,9,3,6,2,1
22,132,132,5,5,0,1,0
16,142,142,3,3,0,1,0
12,149,149,8,1,7,2,1
21,176,176,3,3,0,1,0
7,194,194,44,44,0,1,0
17,195,195,31,31,0,1,0
10,208,208,3,3,0,1,0
19,211,211,41,41,0,1,0
4,225,225,14,14,0,1,0
20,252,252,16,4,12,3,2
15,260,260,69,20,49,2,1
23,288,288,53,24,29,2,1
13,348,348,1,1,0,1,0
3,394,394,63,63,0,1,0
11,414,414,13,13,0,1,0
0,414,414,26,26,0,1,0
1,424,424,22,22,0,1,0
6,442,442,8,4,4,2,1
14,451,451,72,72,0,1,0
2,454,454,1,1,0,1,0
5,470,470,42,42,0,1,0
8,500,500,8,3,5,2,1

3,100,100,1,1,0,1,0
8,103,103,17,17,0,1,0
0,114,114,1,1,0,1,0
14,130,130,26,26,0,1,0
22,136,136,38,30,8,2,1
1,172,172,3,3,0,1,0
21,196,196,6,3,3,2,1
20,204,204,32,32,0,1,0
4,206,206,4,4,0,1,0
11,209,209,40,4,36,4,3
13,228,228,10,1,9,2,1
16,301,301,51,51,0,1,0
19,327,327,2,2,0,1,0
15,328,328,51,51,0,1,0
18,354,354,3,3,0,1,0
9,407,407,83,83,0,1,0
10,419,419,5,5,0,1,0
17,420,420,4,4,0,1,0
6,424,424,21,21,0,1,0
5,429,429,6,6,0,1,0
12,473,473,65,40,25,2,1
2,488,488,1,1,0,1,0
7,493,493,62,50,12,4,3

9,112,112,5,5,0,1,0
8,129,129,1,1,0,1,0
22,133,133,1,1,0,1,0
5,134,134,1,1,0,1,0
13,177,177,24,6,18,4,3
2,221,221,25,25,0,1,0
7,249,249,1,1,0,1,0
15,298,298,33,33,0,1,0
6,312,312,6,6,0,1,0
11,318,318,3,3,0,1,0
14,319,319,38,38,0,1,0
12,331,331,69,54,15,4,3
10,347,347,3,3,0,1,0
1,364,364,37,37,0,1,0
3,378,378,26,26,0,1,0
19,380,380,38,38,0,1,0
18,390,390,38,14,24,4,3
4,393,393,100,100,0,1,0
21,413,413,62,62,0,1,0
20,426,426,2,2,0,1,0
0,427,427,8,8,0,1,0
16,495,495,31,31,0,1,0
17,496,496,181,165,16,3,2

2,120,120,6,6,0,1,0
3,123,123,28,6,22,3,2
0,133,133,47,35,12,2,1
10,213,213,17,4,13,2,1
11,269,269,45,45,0,1,0
14,270,270,16,16,0,1,0
7,276,276,5,5,0,1,0
5,278,278,29,29,0,1,0
13,281,281,40,40,0,1,0
8,310,310,41,41,0,1,0
6,317,317,14,2,12,4,3
1,341,341,45,45,0,1,0
4,408,408,55,55,0,1,0
12,411,411,50,34,16,3,2
9,490,490,124,55,69,4,3

3,107,107,1,1,0,1,0
8,116,116,8,8,0,1,0
18,154,154,39,10,29,2,1
15,172,172,24,24,0,1,0
4,184,184,1,1,0,1,0
5,216,216,20,10,10,2,1
7,242,242,13,5,8,2,1
0,261,261,52,52,0,1,0
17,287,287,28,1,27,2,1
21,313,313,23,23,0,1,0
2,335,335,36,12,24,3,2
12,395,395,29,29,0,1,0
9,396,396,8,5,3,2,1
19,418,418,38,20,18,4,3
6,422,422,26,5,21,4,3
1,427,427,109,10,99,4,3
16,427,427,37,37,0,1,0
20,429,429,54,11,43,2,1
11,443,443,2,2,0,1,0
13,463,463,9,9,0,1,0
10,493,493,24,24,0,1,0
14,497,497,65,31,34,2,1

4,108,108,1,1,0,1,0
17,140,140,24,24,0,1,0
7,160,160,5,5,0,1,0
8,160,160,4,4,0,1,0
14,173,173,10,1,9,4,3
16,185,185,77,77,0,1,0
12,208,208,16,16,0,1,0
13,240,240,2,2,0,1,0
10,242,242,44,13,31,4,3
11,252,252,56,56,0,1,0
0,283,283,3,3,0,1,0
5,293,293,38,38,0,1,0
6,341,341,10,10,0,1,0
9,383,383,25,25,0,1,0
1,417,417,29,7,22,2,1
15,418,418,36,36,0,1,0
3,436,436,10,10,0,1,0
20,458,458,85,41,44,2,1
18,461,461,9,1,8,3,2
21,464,464,24,4,20,2,1
19,483,483,8,2,6,2,1
2,484,484,63,34,29,2,1

21,127,127,1,1,0,1,0
0,130,130,7,4,3,2,1
13,194,194,4,4,0,1,0
2,204,204,10,10,0,1,0
12,223,223,30,12,18,4,3
22,240,240,44,44,0,1,0
19,243,243,18,8,10,2,1
8,278,278,10,10,0,1,0
24,279,279,26,8,18,4,3
17,280,280,8,8,0,1,0
10,282,282,11,11,0,1,0
5,305,305,14,6,8,3,2
20,343,343,37,4,33,2,1
23,360,360,27,1,26,2,1
9,371,371,27,12,15,4,3
3,382,382,15,15,0,1,0
15,389,389,19,19,0,1,0
26,400,400,144,130,14,3,2
11,401,401,1,1,0,1,0
14,403,403,12,12,0,1,0
6,405,405,20,20,0,1,0
4,406,406,36,36,0,1,0
1,429,429,46,46,0,1,0
7,431,431,25,7,18,3,2
16,433,433,42,42,0,1,0
18,445,445,27,27,0,1,0
25,477,477,27,27,0,1,0

17,105,105,1,1,0,1,0
2,117,117,10,10,0,1,0
18,135,135,6,6,0,1,0
26,144,144,30,6,24,4,3
28,146,146,1,1,0,1,0
7,161,161,1,1,0,1,0
5,172,172,18,18,0,1,0
22,186,186,8,8,0,1,0
11,200,200,2,2,0,1,0
1,303,303,15,3,12,3,2
15,303,303,8,8,0,1,0
0,311,311,1,1,0,1,0
10,319,319,46,46,0,1,0
24,320,320,1,1,0,1,0
14,345,345,39,29,10,2,1
4,353,353,5,5,0,1,0
25,354,354,184,40,144,4,3
3,387,387,23,8,15,2,1
9,419,419,13,13,0,1,0
21,425,425,16,16,0,1,0
6,427,427,35,35,0,1,0
27,442,442,28,28,0,1,0
12,446,446,28,13,15,4,3
8,450,450,29,12,17,2,1
23,465,465,50,50,0,1,0
16,466,466,20,6,14,3,2
19,475,475,16,16,0,1,0
20,494,494,16,1,15,4,3
13,499,499,7,7,0,1,0

0,103,103,4,4,0,1,0
10,162,162,37,19,18,3,2
12,163,163,4,4,0,1,0
6,182,182,64,64,0,1,0
14,221,221,90,90,0,1,0
15,228,228,8,8,0,1,0
11,242,242,7,7,0,1,0
17,260,260,2,2,0,1,0
3,294,294,10,10,0,1,0
9,310,310,37,8,29,2,1
5,317,317,59,19,40,2,1
8,350,350,51,7,44,2,1
7,366,366,65,37,28,3,2
13,368,368,26,26,0,1,0
1,371,371,6,6,0,1,0
16,406,406,42,19,23,2,1
4,409,409,1,1,0,1,0
2,436,436,21,21,0,1,0

10,142,142,44,44,0,1,0
11,155,155,3,3,0,1,0
13,164,164,17,4,13,2,1
1,177,177,1,1,0,1,0
2,206,206,9,3,6,3,2
8,213,213,34,7,27,2,1
14,221,221,2,2,0,1,0
7,284,284,25,7,18,3,2
15,296,296,36,36,0,1,0
5,365,365,54,28,26,2,1
12,430,430,59,59,0,1,0
6,434,434,2,2,0,1,0
0,444,444,260,245,15,2,1
3,457,457,24,24,0,1,0
9,477,477,33,11,22,2,1
4,489,489,79,15,64,4,3

9,128,128,4,1,3,2,1
10,206,206,34,34,0,1,0
1,207,207,29,17,12,4,3
18,212,212,1,1,0,1,0
8,242,242,21,9,12,4,3
14,269,269,12,5,7,2,1
7,312,312,15,15,0,1,0
11,315,315,120,120,0,1,0
12,336,336,7,7,0,1,0
13,345,345,12,9,3,2,1
15,352,352,61,61,0,1,0
17,354,354,34,34,0,1,0
3,372,372,77,13,64,4,3
5,378,378,4,1,3,2,1
2,379,379,17,3,14,2,1
16,413,413,67,67,0,1,0
6,421,421,44,44,0,1,0
4,454,454,65,41,24,2,1
19,470,470,46,12,34,3,2
0,488,488,10,10,0,1,0

12,102,102,2,2,0,1,0
5,103,103,2,2,0,1,0
26,182,182,8,8,0,1,0
21,207,207,57,57,0,1,0
3,219,219,26,26,0,1,0
18,219,219,38,30,8,3,2
14,229,229,3,3,0,1,0
13,230,230,5,2,3,2,1
2,265,265,19,19,0,1,0
17,267,267,26,14,12,3,2
0,269,269,29,29,0,1,0
1,318,318,7,7,0,1,0
11,319,319,9,9,0,1,0
10,327,327,16,16,0,1,0
23,336,336,23,14,9,2,1
8,352,352,9,9,0,1,0
15,356,356,14,5,9,2,1
9,359,359,65,65,0,1,0
25,359,359,32,32,0,1,0
19,380,380,9,2,7,2,1
6,381,381,10,10,0,1,0
22,395,395,81,81,0,1,0
4,403,403,3,3,0,1,0
16,441,441,36,21,15,4,3
20,448,448,18,18,0,1,0
7,479,479,35,5,30,2,1
24,479,479,45,45,0,1,0

15,127,127,6,6,0,1,0
23,134,134,1,1,0,1,0
6,135,135,4,4,0,1,0
16,175,175,11,11,0,1,0
0,193,193,6,6,0,1,0
18,201,201,20,20,0,1,0
3,202,202,7,7,0,1,0
5,205,205,32,32,0,1,0
7,211,211,27,22,5,2,1
20,239,239,94,89,5,2,1
10,247,247,19,5,14,2,1
19,281,281,24,12,12,4,3
9,298,298,9,1,8,3,2
11,332,332,10,10,0,1,0
2,400,400,3,3,0,1,0
8,403,403,31,3,28,4,3
14,443,443,45,45,0,1,0
4,446,446,12,1,11,2,1
22,458,458,61,25,36,2,1
12,472,472,100,38,62,3,2
1,474,474,18,10,8,3,2
13,475,475,10,1,9,4,3
21,494,494,59,32,27,3,2
17,496,496,37,7,30,4,3

5,144,144,37,25,12,2,1
1,152,152,18,18,0,1,0
11,165,165,20,1,19,2,1
10,238,238,48,15,33,4,3
6,252,252,53,53,0,1,0
4,266,266,1,1,0,1,0
7,321,321,51,36,15,4,3
12,345,345,24,16,8,3,2
13,362,362,32,9,23,2,1
9,398,398,12,12,0,1,0
2,405,405,63,36,27,4,3
8,415,415,46,32,14,3,2
0,423,423,118,22,96,4,3
14,433,433,11,11,0,1,0
3,473,473,90,60,30,3,2

3,107,107,1,1,0,1,0
11,110,110,11,2,9,2,1
2,119,119,2,2,0,1,0
15,123,123,2,2,0,1,0
10,139,139,7,7,0,1,0
8,142,142,10,10,0,1,0
14,144,144,10,10,0,1,0
13,148,148,34,4,30,2,1
12,149,149,2,2,0,1,0
16,159,159,58,58,0,1,0
22,168,168,13,13,0,1,0
0,200,200,17,17,0,1,0
19,216,216,15,15,0,1,0
7,233,233,10,10,0,1,0
5,309,309,21,21,0,1,0
9,322,322,2,2,0,1,0
18,335,335,59,55,4,2,1
1,362,362,19,19,0,1,0
21,367,367,49,49,0,1,0
17,413,413,13,13,0,1,0
6,415,415,86,86,0,1,0
4,444,444,22,22,0,1,0
20,463,463,39,17,22,3,2

3,100,100,11,11,0,1,0
7,120,120,5,5,0,1,0
15,174,174,35,35,0,1,0
1,184,184,4,4,0,1,0
6,232,232,9,5,4,2,1
4,238,238,100,36,64,3,2
11,265,265,6,6,0,1,0
16,270,270,77,37,40,2,1
5,281,281,10,7,3,2,1
18,281,281,34,28,6,2,1
0,289,289,14,3,11,2,1
9,363,363,10,2,8,3,2
17,364,364,55,55,0,1,0
10,371,371,21,21,0,1,0
12,385,385,60,4,56,3,2
13,406,406,10,4,6,2,1
14,413,413,15,15,0,1,0
20,456,456,9,9,0,1,0
8,457,457,54,15,39,4,3
19,469,469,9,2,7,2,1
2,491,491,30,10,20,3,2

6,101,101,9,2,7,2,1
5,119,119,17,17,0,1,0
9,150,150,18,18,0,1,0
7,167,167,12,12,0,1,0
4,186,186,18,2,16,3,2
13,186,186,41,32,9,2,1
0,213,213,26,26,0,1,0
8,239,239,22,2,20,2,1
1,321,321,4,4,0,1,0
10,330,330,65,9,56,3,2
12,359,359,16,16,0,1,0
3,428,428,144,144,0,1,0
11,470,470,21,21,0,1,0
2,494,494,216,216,0,1,0

5,105,105,6,6,0,1,0
13,120,120,20,7,13,2,1
8,122,122,1,1,0,1,0
6,158,158,12,12,0,1,0
11,232,232,7,7,0,1,0
18,276,276,18,18,0,1,0
17,286,286,55,10,45,2,1
4,298,298,24,9,15,4,3
0,321,321,126,18,108,4,3
9,323,323,18,6,12,4,3
12,324,324,16,7,9,2,1
15,335,335,45,45,0,1,0
19,342,342,27,15,12,2,1
10,353,353,5,5,0,1,0
3,392,392,30,30,0,1,0
16,414,414,50,50,0,1,0
7,453,453,23,13,10,3,2
14,454,454,61,61,0,1,0
20,474,474,36,4,32,2,1
1,478,478,33,33,0,1,0
2,483,483,45,45,0,1,0

15,114,114,16,16,0,1,0
0,195,195,7,7,0,1,0
6,209,209,108,99,9,4,3
7,245,245,36,36,0,1,0
12,271,271,53,23,30,3,2
13,271,271,32,32,0,1,0
2,324,324,25,25,0,1,0
1,346,346,25,25,0,1,0
8,358,358,37,37,0,1,0
4,368,368,22,22,0,1,0
3,373,373,34,34,0,1,0
5,408,408,60,60,0,1,0
14,415,415,32,32,0,1,0
10,417,417,10,6,4,2,1
9,428,428,66,66,0,1,0
11,498,498,27,9,18,3,2

7,103,103,2,2,0,1,0
3,116,116,21,21,0,1,0
14,126,126,31,19,12,4,3
10,132,132,14,10,4,2,1
18,138,138,16,6,10,2,1
11,142,142,5,5,0,1,0
6,167,167,50,14,36,2,1
15,211,211,9,9,0,1,0
17,218,218,3,3,0,1,0
2,240,240,19,9,10,3,2
9,250,250,13,4,9,2,1
16,274,274,32,32,0,1,0
8,284,284,2,2,0,1,0
5,310,310,77,9,68,3,2
12,327,327,115,75,40,3,2
1,363,363,27,27,0,1,0
0,388,388,8,2,6,3,2
13,416,416,1,1,0,1,0
4,427,427,9,4,5,2,1

10,126,126,5,5,0,1,0
1,136,136,49,49,0,1,0
12,152,152,5,1,4,2,1
4,161,161,7,7,0,1,0
9,186,186,18,8,10,3,2
8,203,203,35,35,0,1,0
2,290,290,1,1,0,1,0
5,292,292,9,5,4,2,1
0,359,359,111,81,30,4,3
7,365,365,19,9,10,3,2
14,371,371,87,75,12,4,3
15,387,387,9,4,5,2,1
13,403,403,75,51,24,4,3
6,420,420,8,5,3,2,1
3,464,464,109,10,99,4,3
11,484,484,85,85,0,1,0

10,152,152,1,1,0,1,0
5,163,163,17,17,0,1,0
12,170,170,62,62,0,1,0
3,188,188,52,43,9,4,3
11,200,200,22,22,0,1,0
16,259,259,13,13,0,1,0
1,264,264,1,1,0,1,0
7,272,272,34,25,9,4,3
2,279,279,4,4,0,1,0
4,282,282,14,14,0,1,0
18,335,335,72,72,0,1,0
14,392,392,5,5,0,1,0
13,398,398,10,10,0,1,0
17,408,408,59,9,50,3,2
15,410,410,37,5,32,2,1
6,452,452,19,19,0,1,0
0,453,453,89,50,39,3,2
9,478,478,56,10,46,2,1
8,481,481,35,1,34,2,1

4,142,142,17,17,0,1,0
15,189,189,15,1,14,2,1
13,192,192,16,2,14,3,2
11,212,212,13,1,12,4,3
3,222,222,17,7,10,3,2
8,246,246,48,31,17,3,2
17,291,291,14,14,0,1,0
0,341,341,16,5,11,2,1
10,365,365,42,42,0,1,0
6,372,372,84,30,54,4,3
12,406,406,40,35,5,2,1
7,417,417,31,6,25,2,1
2,418,418,58,22,36,4,3
14,419,419,53,17,36,3,2
16,451,451,136,49,87,4,3
9,452,452,47,19,28,3,2
1,468,468,57,14,43,3,2
5,469,469,1,1,0,1,0

11,135,135,43,7,36,4,3
3,160,160,61,61,0,1,0
1,170,170,6,3,3,2,1
9,175,175,30,30,0,1,0
7,245,245,23,23,0,1,0
4,304,304,38,38,0,1,0
6,352,352,27,11,16,2,1
14,352,352,20,20,0,1,0
15,353,353,32,9,23,2,1
16,381,381,25,9,16,3,2
17,400,400,37,7,30,4,3
12,408,408,28,4,24,4,3
8,429,429,24,24,0,1,0
13,435,435,5,1,4,2,1
10,452,452,66,54,12,4,3
0,453,453,32,5,27,4,3
2,461,461,64,2,62,3,2
5,467,467,11,7,4,2,1

9,101,101,10,10,0,1,0
2,107,107,14,14,0,1,0
4,113,113,10,7,3,2,1
13,152,152,1,1,0,1,0
7,176,176,9,9,0,1,0
5,198,198,7,2,5,2,1
10,207,207,58,15,43,2,1
12,209,209,62,62,0,1,0
6,222,222,64,64,0,1,0
8,307,307,8,8,0,1,0
0,359,359,81,21,60,4,3
3,409,409,85,59,26,3,2
14,446,446,80,80,0,1,0
11,468,468,3,3,0,1,0
15,483,483,37,19,18,2,1
1,495,495,12,12,0,1,0

2,125,125,7,2,5,2,1
5,133,133,15,15,0,1,0
14,138,138,9,9,0,1,0
21,143,143,3,3,0,1,0
7,158,158,1,1,0,1,0
8,162,162,2,2,0,1,0
22,170,170,1,1,0,1,0
16,198,198,34,22,12,4,3
12,201,201,75,45,30,3,2
13,202,202,11,3,8,2,1
4,224,224,3,3,0,1,0
23,250,250,35,1,34,3,2
18,260,260,71,58,13,4,3
6,273,273,1,1,0,1,0
10,275,275,58,58,0,1,0
3,279,279,1,1,0,1,0
20,313,313,16,16,0,1,0
11,320,320,9,9,0,1,0
9,365,365,3,3,0,1,0
0,390,390,1,1,0,1,0
1,398,398,6,6,0,1,0
24,452,452,126,126,0,1,0
17,455,455,24,2,22,3,2
19,487,487,14,14,0,1,0
15,498,498,18,5,13,2,1

16,104,104,14,4,10,3,2
9,104,104,16,16,0,1,0
3,151,151,1,1,0,1,0
6,160,160,11,5,6,3,2
5,312,312,40,40,0,1,0
8,337,337,47,14,33,2,1
11,337,337,65,7,58,3,2
15,342,342,20,1,19,4,3
12,368,368,9,1,8,3,2
0,369,369,17,6,11,2,1
1,401,401,44,8,36,3,2
10,411,411,134,104,30,4,3
17,419,419,2,2,0,1,0
7,425,425,84,46,38,3,2
18,439,439,75,63,12,2,1
2,445,445,50,8,42,4,3
14,456,456,13,1,12,3,2
13,475,475,36,36,0,1,0
4,491,491,20,14,6,3,2

15,100,100,5,5,0,1,0
5,118,118,1,1,0,1,0
17,193,193,51,25,26,2,1
0,258,258,17,17,0,1,0
10,266,266,29,29,0,1,0
6,266,266,28,15,13,2,1
12,275,275,22,22,0,1,0
8,283,283,41,41,0,1,0
3,293,293,18,7,11,2,1
1,332,332,36,18,18,2,1
11,337,337,35,13,22,3,2
4,397,397,156,96,60,3,2
14,400,400,4,4,0,1,0
16,424,424,74,74,0,1,0
7,439,439,36,14,22,3,2
2,453,453,14,14,0,1,0
13,463,463,18,4,14,3,2
9,468,468,89,89,0,1,0

3,108,108,2,2,0,1,0
5,112,112,21,7,14,3,2
7,121,121,5,2,3,2,1
9,142,142,6,6,0,1,0
19,173,173,44,38,6,3,2
12,174,174,23,23,0,1,0
15,198,198,30,30,0,1,0
1,244,244,1,1,0,1,0
6,259,259,33,1,32,2,1
13,312,312,2,2,0,1,0
10,315,315,8,5,3,2,1
16,324,324,37,2,35,2,1
0,334,334,27,12,15,2,1
4,348,348,92,70,22,4,3
11,363,363,109,109,0,1,0
17,372,372,8,8,0,1,0
18,378,378,13,13,0,1,0
8,412,412,71,71,0,1,0
14,417,417,2,2,0,1,0
2,421,421,16,16,0,1,0

17,106,106,8,8,0,1,0
12,181,181,3,3,0,1,0
2,183,183,18,12,6,2,1
16,196,196,12,12,0,1,0
15,245,245,71,13,58,3,2
23,261,261,6,3,3,2,1
10,283,283,25,15,10,3,2
9,290,290,15,8,7,2,1
8,308,308,4,4,0,1,0
4,309,309,22,10,12,3,2
7,369,369,26,26,0,1,0
1,382,382,10,10,0,1,0
3,403,403,8,8,0,1,0
21,425,425,55,55,0,1,0
14,431,431,16,16,0,1,0
5,435,435,75,75,0,1,0
19,441,441,92,39,53,4,3
6,453,453,67,67,0,1,0
0,460,460,40,40,0,1,0
20,469,469,7,7,0,1,0
22,469,469,89,89,0,1,0
11,485,485,1,1,0,1,0
13,485,485,48,48,0,1,0
18,488,488,11,4,7,2,1

1,107,107,21,3,18,3,2
10,124,124,5,5,0,1,0
5,215,215,22,22,0,1,0
12,227,227,10,6,4,2,1
18,254,254,15,15,0,1,0
2,281,281,1,1,0,1,0
11,297,297,7,7,0,1,0
3,337,337,35,35,0,1,0
0,364,364,17,17,0,1,0
6,378,378,10,10,0,1,0
8,385,385,63,39,24,4,3
17,403,403,21,21,0,1,0
9,457,457,21,21,0,1,0
13,461,461,66,48,18,4,3
15,470,470,143,1,142,4,3
4,476,476,56,56,0,1,0
7,476,476,93,81,12,2,1
16,481,481,70,4,66,4,3
14,498,498,103,103,0,1,0

4,129,129,4,4,0,1,0
18,188,188,32,32,0,1,0
11,192,192,5,5,0,1,0
9,198,198,53,12,41,4,3
2,205,205,2,2,0,1,0
16,244,244,2,2,0,1,0
3,278,278,47,47,0,1,0
10,284,284,85,10,75,4,3
12,291,291,75,75,0,1,0
7,318,318,55,30,25,2,1
6,352,352,61,61,0,1,0
13,356,356,13,1,12,4,3
1,359,359,1,1,0,1,0
14,361,361,18,1,17,2,1
8,363,363,41,41,0,1,0
0,364,364,18,18,0,1,0
5,412,412,6,6,0,1,0
17,450,450,54,24,30,2,1
15,458,458,20,20,0,1,0

17,163,163,32,19,13,4,3
8,163,163,7,7,0,1,0
15,214,214,16,16,0,1,0
19,223,223,27,27,0,1,0
14,265,265,44,16,28,3,2
10,287,287,2,2,0,1,0
18,300,300,40,12,28,3,2
0,334,334,5,1,4,2,1
13,345,345,15,15,0,1,0
4,371,371,56,56,0,1,0
3,384,384,18,18,0,1,0
5,403,403,77,32,45,4,3
2,405,405,207,207,0,1,0
7,426,426,1,1,0,1,0
6,434,434,6,6,0,1,0
12,434,434,13,2,11,3,2
1,443,443,6,6,0,1,0
9,450,450,3,3,0,1,0
16,466,466,95,89,6,2,1
11,472,472,22,22,0,1,0

10,111,111,4,4,0,1,0
5,124,124,9,5,4,2,1
7,146,146,34,34,0,1,0
9,158,158,5,1,4,2,1
11,172,172,4,4,0,1,0
4,184,184,26,26,0,1,0
6,193,193,20,12,8,2,1
8,198,198,30,4,26,2,1
17,226,226,52,24,28,2,1
12,237,237,10,1,9,4,3
0,321,321,12,4,8,2,1
2,324,324,22,8,14,2,1
13,337,337,46,1,45,4,3
3,402,402,30,30,0,1,0
18,411,411,80,20,60,3,2
16,424,424,8,8,0,1,0
15,457,457,35,35,0,1,0
14,475,475,123,2,121,4,3
1,481,481,44,44,0,1,0

15,103,103,22,5,17,2,1
14,106,106,22,22,0,1,0
9,106,106,13,13,0,1,0
10,108,108,16,16,0,1,0
3,151,151,9,9,0,1,0
1,197,197,22,10,12,4,3
13,310,310,20,20,0,1,0
8,346,346,48,27,21,2,1
12,370,370,27,16,11,2,1
16,371,371,24,24,0,1,0
4,406,406,129,109,20,4,3
6,441,441,109,109,0,1,0
2,444,444,18,18,0,1,0
0,445,445,3,3,0,1,0
5,474,474,47,47,0,1,0
7,485,485,57,29,28,2,1
11,489,489,1,1,0,1,0

10,125,125,14,8,6,3,2
8,144,144,18,9,9,4,3
16,156,156,8,1,7,2,1
5,173,173,29,29,0,1,0
3,179,179,10,6,4,2,1
13,199,199,22,22,0,1,0
0,248,248,21,21,0,1,0
1,253,253,4,4,0,1,0
18,260,260,106,35,71,4,3
2,264,264,23,5,18,3,2
11,266,266,1,1,0,1,0
17,318,318,28,28,0,1,0
4,352,352,19,19,0,1,0
9,364,364,9,9,0,1,0
19,394,394,46,46,0,1,0
7,396,396,14,5,9,3,2
14,438,438,64,64,0,1,0
15,457,457,34,5,29,2,1
6,457,457,112,49,63,4,3
12,496,496,8,8,0,1,0

2,126,126,11,8,3,2,1
6,143,143,14,14,0,1,0
26,172,172,8,3,5,2,1
21,195,195,12,3,9,4,3
12,200,200,2,2,0,1,0
20,209,209,23,23,0,1,0
7,235,235,1,1,0,1,0
5,258,258,2,2,0,1,0
15,264,264,9,9,0,1,0
23,269,269,17,17,0,1,0
17,280,280,2,2,0,1,0
9,315,315,2,2,0,1,0
1,337,337,66,19,47,2,1
27,340,340,41,31,10,3,2
4,343,343,12,1,11,3,2
19,372,372,5,1,4,2,1
10,374,374,25,10,15,4,3
3,381,381,7,7,0,1,0
8,417,417,20,20,0,1,0
14,420,420,18,5,13,2,1
16,439,439,9,6,3,2,1
18,471,471,32,18,14,4,3
25,481,481,143,125,18,3,2
22,482,482,48,38,10,2,1
0,489,489,33,33,0,1,0
13,498,498,29,12,17,2,1
11,500,500,63,52,11,2,1
24,500,500,102,6,96,3,2

13,131,131,20,2,18,2,1
11,156,156,4,1,3,2,1
2,168,168,27,27,0,1,0
4,172,172,13,1,12,2,1
14,214,214,7,7,0,1,0
1,235,235,16,10,6,2,1
3,260,260,1,1,0,1,0
9,285,285,98,98,0,1,0
10,353,353,60,60,0,1,0
12,386,386,13,3,10,2,1
6,389,389,7,1,6,2,1
17,437,437,39,11,28,3,2
0,452,452,58,58,0,1,0
15,485,485,65,35,30,3,2
16,485,485,16,5,11,2,1
5,491,491,25,25,0,1,0
7,495,495,218,218,0,1,0
8,499,499,28,1,27,2,1

18,116,116,9,2,7,2,1
9,162,162,5,1,4,2,1
4,170,170,37,20,17,2,1
17,170,170,5,5,0,1,0
15,171,171,10,2,8,2,1
12,177,177,20,20,0,1,0
6,187,187,51,29,22,2,1
5,218,218,5,5,0,1,0
14,236,236,13,13,0,1,0
1,244,244,4,1,3,2,1
0,250,250,38,26,12,3,2
10,310,310,17,9,8,2,1
7,336,336,25,10,15,2,1
16,359,359,5,5,0,1,0
13,369,369,52,52,0,1,0
19,376,376,134,106,28,2,1
8,395,395,5,5,0,1,0
2,439,439,29,16,13,2,1
3,467,467,38,20,18,4,3
11,474,474,84,84,0,1,0

3,108,108,7,7,0,1,0
6,117,117,1,1,0,1,0
19,143,143,15,15,0,1,0
21,147,147,11,11,0,1,0
9,155,155,2,2,0,1,0
15,163,163,32,32,0,1,0
16,181,181,12,12,0,1,0
18,183,183,14,14,0,1,0
14,188,188,10,10,0,1,0
2,252,252,23,23,0,1,0
20,256,256,9,5,4,2,1
12,266,266,20,20,0,1,0
11,270,270,28,28,0,1,0
1,285,285,2,2,0,1,0
7,289,289,28,28,0,1,0
8,304,304,21,21,0,1,0
23,305,305,28,28,0,1,0
10,311,311,2,2,0,1,0
0,335,335,30,2,28,3,2
13,339,339,42,15,27,2,1
22,377,377,97,43,54,3,2
5,379,379,71,23,48,4,3
4,420,420,6,1,5,2,1
17,463,463,57,3,54,4,3

6,117,117,7,2,5,2,1
10,144,144,2,2,0,1,0
12,148,148,1,1,0,1,0
18,176,176,50,50,0,1,0
15,189,189,14,14,0,1,0
11,194,194,9,9,0,1,0
3,242,242,2,2,0,1,0
17,251,251,12,12,0,1,0
16,252,252,13,13,0,1,0
1,267,267,72,72,0,1,0
4,278,278,34,34,0,1,0
14,282,282,68,68,0,1,0
9,329,329,35,35,0,1,0
8,353,353,29,29,0,1,0
0,399,399,17,17,0,1,0
13,405,405,76,57,19,2,1
5,415,415,25,25,0,1,0
2,453,453,64,64,0,1,0
19,455,455,36,36,0,1,0
7,499,499,48,17,31,2,1

5,100,100,4,4,0,1,0
9,157,157,16,9,7,2,1
15,169,169,3,3,0,1,0
22,173,173,37,37,0,1,0
20,174,174,16,4,12,4,3
17,178,178,12,12,0,1,0
14,182,182,4,4,0,1,0
23,188,188,2,2,0,1,0
6,209,209,6,3,3,2,1
2,218,218,1,1,0,1,0
24,251,251,60,60,0,1,0
12,257,257,10,10,0,1,0
10,268,268,32,14,18,2,1
19,275,275,25,25,0,1,0
1,284,284,33,33,0,1,0
4,285,285,38,13,25,2,1
0,306,306,26,19,7,2,1
16,337,337,4,4,0,1,0
7,348,348,15,15,0,1,0
3,366,366,26,26,0,1,0
8,383,383,34,3,31,2,1
13,398,398,28,28,0,1,0
18,430,430,19,15,4,2,1
11,442,442,9,1,8,3,2
21,463,463,116,30,86,4,3

7,112,112,3,3,0,1,0
10,150,150,2,2,0,1,0
9,151,151,28,28,0,1,0
14,174,174,23,17,6,2,1
0,178,178,7,4,3,2,1
1,178,178,39,15,24,3,2
3,196,196,1,1,0,1,0
6,258,258,8,8,0,1,0
4,285,285,15,15,0,1,0
12,287,287,1,1,0,1,0
16,296,296,33,33,0,1,0
8,323,323,5,5,0,1,0
18,336,336,94,8,86,4,3
17,353,353,23,14,9,4,3
13,377,377,5,5,0,1,0
5,416,416,13,13,0,1,0
2,447,447,177,63,114,4,3
15,498,498,153,126,27,4,3
11,499,499,41,41,0,1,0

17,126,126,6,3,3,2,1
3,180,180,2,2,0,1,0
12,230,230,61,33,28,2,1
11,237,237,27,19,8,3,2
1,246,246,44,4,40,3,2
18,251,251,7,1,6,2,1
10,253,253,28,28,0,1,0
5,299,299,60,60,0,1,0
2,303,303,60,60,0,1,0
0,305,305,24,24,0,1,0
8,310,310,19,2,17,2,1
13,310,310,100,100,0,1,0
15,350,350,11,11,0,1,0
14,357,357,2,2,0,1,0
16,371,371,69,69,0,1,0
6,394,394,5,5,0,1,0
7,412,412,15,15,0,1,0
9,415,415,38,3,35,3,2
4,434,434,9,9,0,1,0
19,455,455,6,2,4,2,1

6,101,101,9,9,0,1,0
7,109,109,6,6,0,1,0
2,132,132,49,49,0,1,0
21,182,182,20,14,6,2,1
14,185,185,29,4,25,2,1
3,189,189,1,1,0,1,0
11,197,197,8,8,0,1,0
17,226,226,9,6,3,2,1
12,229,229,2,2,0,1,0
19,231,231,11,11,0,1,0
10,284,284,4,4,0,1,0
18,298,298,75,75,0,1,0
4,330,330,1,1,0,1,0
22,338,338,62,48,14,3,2
8,383,383,1,1,0,1,0
1,384,384,52,24,28,2,1
16,392,392,49,49,0,1,0
15,418,418,29,8,21,4,3
0,427,427,53,3,50,3,2
20,443,443,16,7,9,4,3
9,471,471,10,6,4,2,1
5,474,474,53,53,0,1,0
13,498,498,9,9,0,1,0

8,105,105,8,8,0,1,0
1,139,139,11,1,10,4,3
16,139,139,47,24,23,2,1
3,194,194,53,29,24,4,3
13,251,251,7,7,0,1,0
6,252,252,42,34,8,2,1
12,256,256,35,35,0,1,0
11,280,280,8,8,0,1,0
2,281,281,3,3,0,1,0
10,312,312,21,21,0,1,0
4,328,328,76,30,46,2,1
14,385,385,43,24,19,4,3
17,409,409,73,73,0,1,0
15,444,444,47,20,27,2,1
0,451,451,38,38,0,1,0
5,459,459,26,26,0,1,0
7,495,495,12,2,10,3,2
9,500,500,12,12,0,1,0

22,102,102,6,6,0,1,0
13,146,146,3,3,0,1,0
5,147,147,1,1,0,1,0
16,177,177,6,6,0,1,0
15,184,184,8,3,5,2,1
18,184,184,11,11,0,1,0
24,190,190,8,8,0,1,0
0,199,199,3,3,0,1,0
20,201,201,12,12,0,1,0
25,232,232,75,37,38,2,1
2,286,286,16,16,0,1,0
4,292,292,39,39,0,1,0
3,303,303,15,7,8,3,2
9,332,332,101,50,51,4,3
7,336,336,16,16,0,1,0
23,345,345,42,42,0,1,0
6,346,346,2,2,0,1,0
8,358,358,13,13,0,1,0
19,367,367,42,42,0,1,0
10,401,401,4,1,3,2,1
21,441,441,4,4,0,1,0
17,454,454,105,72,33,4,3
1,464,464,39,15,24,3,2
11,469,469,9,6,3,2,1
12,476,476,61,61,0,1,0
14,489,489,3,3,0,1,0

14,115,115,11,11,0,1,0
24,116,116,8,4,4,2,1
10,123,123,1,1,0,1,0
15,143,143,1,1,0,1,0
20,161,161,34,34,0,1,0
6,225,225,57,57,0,1,0
13,234,234,1,1,0,1,0
3,248,248,18,18,0,1,0
11,266,266,16,8,8,3,2
0,273,273,8,8,0,1,0
22,273,273,55,10,45,4,3
5,288,288,11,11,0,1,0
18,311,311,12,12,0,1,0
17,320,320,12,12,0,1,0
19,351,351,31,5,26,3,2
16,362,362,44,44,0,1,0
8,366,366,42,42,0,1,0
7,366,366,20,6,14,3,2
23,382,382,76,65,11,2,1
21,393,393,19,19,0,1,0
1,421,421,27,9,18,2,1
2,429,429,9,3,6,2,1
9,433,433,65,52,13,2,1
4,451,451,1,1,0,1,0
12,466,466,12,3,9,4,3

16,118,118,23,1,22,3,2
18,129,129,9,4,5,2,1
14,153,153,4,4,0,1,0
3,173,173,1,1,0,1,0
7,212,212,38,29,9,2,1
9,214,214,12,8,4,2,1
2,217,217,10,2,8,2,1
5,237,237,16,16,0,1,0
17,270,270,2,2,0,1,0
4,277,277,9,9,0,1,0
6,285,285,48,14,34,2,1
1,304,304,2,2,0,1,0
12,333,333,13,3,10,2,1
8,338,338,141,33,108,4,3
19,360,360,14,4,10,2,1
10,383,383,7,7,0,1,0
13,402,402,197,142,55,4,3
0,406,406,1,1,0,1,0
15,428,428,19,5,14,2,1
11,468,468,53,44,9,2,1

4,116,116,15,15,0,1,0
18,131,131,14,14,0,1,0
6,132,132,8,8,0,1,0
0,136,136,5,5,0,1,0
3,218,218,1,1,0,1,0
16,233,233,29,9,20,3,2
1,243,243,73,43,30,3,2
15,286,286,20,12,8,2,1
8,291,291,11,3,8,3,2
13,303,303,23,15,8,3,2
19,356,356,20,13,7,2,1
12,358,358,6,3,3,2,1
14,363,363,116,17,99,4,3
5,386,386,38,2,36,2,1
7,442,442,104,104,0,1,0
10,450,450,12,12,0,1,0
11,451,451,49,38,11,2,1
9,452,452,29,3,26,3,2
17,495,495,66,66,0,1,0
2,500,500,4,1,3,2,1

17,123,123,13,13,0,1,0
8,124,124,3,3,0,1,0
11,143,143,8,8,0,1,0
7,149,149,5,1,4,2,1
12,152,152,19,1,18,3,2
0,156,156,14,2,12,3,2
5,288,288,8,3,5,2,1
16,299,299,44,44,0,1,0
18,364,364,16,16,0,1,0
14,364,364,72,72,0,1,0
19,414,414,30,30,0,1,0
1,437,437,5,5,0,1,0
3,444,444,86,41,45,4,3
4,456,456,56,40,16,3,2
10,457,457,144,129,15,2,1
9,466,466,28,28,0,1,0
2,477,477,21,11,10,3,2
6,486,486,38,14,24,2,1
15,491,491,21,8,13,2,1
13,500,500,114,92,22,2,1

22,103,103,2,2,0,1,0
1,112,112,13,10,3,2,1
21,135,135,11,7,4,2,1
9,179,179,27,13,14,2,1
12,184,184,3,3,0,1,0
0,187,187,4,4,0,1,0
10,190,190,9,9,0,1,0
11,216,216,1,1,0,1,0
15,223,223,14,14,0,1,0
14,235,235,10,5,5,2,1
4,274,274,4,1,3,2,1
6,279,279,13,13,0,1,0
18,322,322,27,27,0,1,0
20,339,339,77,50,27,4,3
5,349,349,6,6,0,1,0
2,355,355,18,18,0,1,0
16,392,392,81,29,52,4,3
8,405,405,32,32,0,1,0
24,417,417,27,1,26,3,2
17,426,426,121,121,0,1,0
23,447,447,3,3,0,1,0
7,454,454,89,69,20,3,2
19,460,460,23,23,0,1,0
13,466,466,49,15,34,4,3
3,478,478,15,15,0,1,0

9,114,114,1,1,0,1,0
14,145,145,25,25,0,1,0
7,157,157,28,10,18,3,2
2,169,169,6,6,0,1,0
3,190,190,1,1,0,1,0
0,197,197,5,5,0,1,0
10,267,267,9,9,0,1,0
12,267,267,75,57,18,2,1
1,275,275,42,2,40,2,1
20,298,298,15,2,13,2,1
15,327,327,12,12,0,1,0
4,336,336,11,5,6,2,1
13,341,341,62,62,0,1,0
16,346,346,51,51,0,1,0
18,391,391,31,16,15,4,3
17,428,428,26,26,0,1,0
6,458,458,59,59,0,1,0
8,459,459,127,80,47,2,1
19,465,465,3,3,0,1,0
11,474,474,10,10,0,1,0
5,487,487,50,50,0,1,0

19,142,142,22,1,21,2,1
21,149,149,18,18,0,1,0
10,157,157,9,1,8,3,2
11,168,168,17,12,5,2,1
3,188,188,14,2,12,3,2
15,192,192,16,4,12,4,3
17,236,236,24,24,0,1,0
0,237,237,47,8,39,3,2
2,252,252,10,3,7,2,1
6,258,258,4,4,0,1,0
5,271,271,15,3,12,3,2
12,277,277,24,24,0,1,0
14,279,279,39,39,0,1,0
4,299,299,6,6,0,1,0
7,314,314,25,25,0,1,0
9,348,348,47,47,0,1,0
16,374,374,96,51,45,3,2
13,376,376,31,31,0,1,0
20,390,390,20,20,0,1,0
1,426,426,18,18,0,1,0
18,478,478,12,12,0,1,0
8,479,479,47,25,22,3,2

13,102,102,8,8,0,1,0
4,123,123,1,1,0,1,0
17,150,150,3,3,0,1,0
19,164,164,14,14,0,1,0
9,165,165,19,7,12,2,1
6,169,169,25,25,0,1,0
11,188,188,1,1,0,1,0
7,228,228,20,15,5,2,1
3,232,232,24,2,22,2,1
20,305,305,59,5,54,3,2
5,311,311,16,6,10,2,1
10,321,321,2,2,0,1,0
12,323,323,18,18,0,1,0
15,323,323,73,73,0,1,0
0,345,345,1,1,0,1,0
8,351,351,23,23,0,1,0
22,361,361,6,6,0,1,0
18,371,371,146,133,13,2,1
16,376,376,6,6,0,1,0
14,416,416,76,42,34,3,2
23,430,430,20,20,0,1,0
21,479,479,8,8,0,1,0
2,497,497,7,7,0,1,0
1,498,498,38,5,33,2,1

4,119,119,42,6,36,3,2
18,132,132,3,3,0,1,0
0,136,136,20,6,14,3,2
1,144,144,2,2,0,1,0
13,152,152,4,4,0,1,0
3,153,153,17,17,0,1,0
16,156,156,51,51,0,1,0
9,270,270,6,2,4,2,1
17,299,299,16,16,0,1,0
10,310,310,48,48,0,1,0
7,316,316,15,15,0,1,0
12,324,324,10,1,9,2,1
5,354,354,45,45,0,1,0
6,399,399,1,1,0,1,0
11,399,399,67,67,0,1,0
14,425,425,94,94,0,1,0
15,433,433,4,4,0,1,0
2,488,488,37,25,12,2,1
8,496,496,50,11,39,3,2

10,105,105,22,22,0,1,0
9,163,163,4,1,3,2,1
22,165,165,17,5,12,3,2
1,200,200,1,1,0,1,0
17,230,230,26,26,0,1,0
4,242,242,14,5,9,4,3
3,249,249,49,49,0,1,0
21,280,280,8,8,0,1,0
7,301,301,16,13,3,2,1
5,301,301,46,31,15,2,1
8,303,303,3,3,0,1,0
12,324,324,24,24,0,1,0
11,325,325,17,17,0,1,0
0,345,345,8,2,6,2,1
14,358,358,23,5,18,2,1
19,367,367,10,10,0,1,0
13,402,402,10,2,8,3,2
2,416,416,11,11,0,1,0
18,424,424,22,18,4,2,1
20,434,434,30,30,0,1,0
6,437,437,40,40,0,1,0
16,447,447,99,19,80,3,2
15,469,469,156,60,96,3,2

21,102,102,19,19,0,1,0
7,130,130,8,8,0,1,0
11,141,141,1,1,0,1,0
8,159,159,1,1,0,1,0
0,181,181,6,6,0,1,0
14,182,182,5,5,0,1,0
13,193,193,44,44,0,1,0
3,223,223,36,6,30,3,2
20,236,236,44,44,0,1,0
9,271,271,28,25,3,2,1
15,288,288,104,104,0,1,0
6,304,304,24,24,0,1,0
16,305,305,4,4,0,1,0
5,309,309,3,3,0,1,0
1,375,375,28,7,21,2,1
4,380,380,9,9,0,1,0
2,398,398,63,63,0,1,0
12,412,412,7,7,0,1,0
18,456,456,45,21,24,2,1
19,466,466,40,4,36,2,1
17,468,468,4,4,0,1,0
10,484,484,19,11,8,3,2
22,489,489,26,26,0,1,0

13,100,100,9,9,0,1,0
10,118,118,6,6,0,1,0
15,183,183,15,15,0,1,0
7,189,189,13,3,10,2,1
5,255,255,75,20,55,4,3
1,256,256,15,15,0,1,0
11,258,258,16,16,0,1,0
3,345,345,137,68,69,4,3
8,359,359,90,20,70,3,2
9,359,359,11,1,10,2,1
12,360,360,92,23,69,4,3
14,388,388,53,53,0,1,0
4,430,430,46,46,0,1,0
6,432,432,53,15,38,3,2
0,445,445,1,1,0,1,0
2,491,491,10,10,0,1,0

20,104,104,3,3,0,1,0
21,140,140,24,24,0,1,0
1,154,154,1,1,0,1,0
11,179,179,36,2,34,3,2
18,190,190,20,20,0,1,0
9,191,191,7,7,0,1,0
15,203,203,33,27,6,2,1
14,253,253,42,42,0,1,0
16,268,268,6,6,0,1,0
12,297,297,3,3,0,1,0
7,304,304,3,3,0,1,0
13,316,316,11,11,0,1,0
5,323,323,5,5,0,1,0
22,335,335,3,3,0,1,0
19,342,342,90,11,79,3,2
6,346,346,28,4,24,4,3
0,364,364,58,58,0,1,0
8,365,365,70,70,0,1,0
4,369,369,39,27,12,2,1
2,401,401,16,5,11,2,1
17,436,436,40,13,27,2,1
10,441,441,13,13,0,1,0
3,464,464,37,37,0,1,0

16,102,102,26,26,0,1,0
12,154,154,7,1,6,2,1
17,160,160,15,15,0,1,0
4,196,196,34,16,18,2,1
0,197,197,27,27,0,1,0
2,199,199,10,10,0,1,0
11,233,233,43,43,0,1,0
13,257,257,46,13,33,4,3
18,273,273,29,23,6,2,1
6,297,297,33,11,22,3,2
3,303,303,13,13,0,1,0
15,343,343,39,12,27,4,3
5,375,375,55,55,0,1,0
10,376,376,1,1,0,1,0
1,400,400,94,94,0,1,0
8,406,406,7,3,4,2,1
9,410,410,18,18,0,1,0
14,471,471,19,1,18,2,1
7,482,482,21,1,20,3,2

6,121,121,62,62,0,1,0
2,246,246,7,2,5,2,1
11,311,311,23,2,21,2,1
4,314,314,27,1,26,2,1
9,324,324,6,1,5,2,1
3,340,340,20,20,0,1,0
0,350,350,8,8,0,1,0
13,353,353,8,8,0,1,0
12,362,362,1,1,0,1,0
14,411,411,232,183,49,2,1
5,446,446,130,1,129,4,3
7,453,453,6,6,0,1,0
10,465,465,83,55,28,3,2
15,474,474,17,2,15,2,1
1,483,483,1,1,0,1,0
8,490,490,50,37,13,2,1

17,108,108,27,6,21,2,1
2,108,108,5,5,0,1,0
19,116,116,6,6,0,1,0
5,133,133,27,5,22,3,2
20,152,152,19,1,18,3,2
12,163,163,21,21,0,1,0
24,173,173,2,2,0,1,0
14,183,183,10,3,7,2,1
15,214,214,16,16,0,1,0
23,233,233,38,3,35,2,1
13,234,234,2,2,0,1,0
25,241,241,6,6,0,1,0
3,255,255,4,4,0,1,0
21,255,255,24,18,6,3,2
9,256,256,11,11,0,1,0
11,279,279,34,34,0,1,0
7,281,281,18,6,12,3,2
0,300,300,13,13,0,1,0
18,310,310,83,54,29,2,1
22,315,315,12,12,0,1,0
4,339,339,18,14,4,2,1
1,372,372,12,12,0,1,0
6,394,394,4,4,0,1,0
16,413,413,34,26,8,2,1
8,441,441,8,8,0,1,0
10,484,484,1,1,0,1,0

5,101,101,1,1,0,1,0
2,104,104,27,27,0,1,0
3,120,120,21,1,20,4,3
6,139,139,22,22,0,1,0
12,141,141,1,1,0,1,0
8,160,160,20,20,0,1,0
15,171,171,2,2,0,1,0
7,184,184,27,10,17,2,1
14,213,213,20,5,15,4,3
16,242,242,11,11,0,1,0
0,243,243,40,40,0,1,0
9,246,246,22,22,0,1,0
1,268,268,8,2,6,3,2
4,268,268,16,5,11,2,1
10,348,348,85,85,0,1,0
11,455,455,116,53,63,4,3
13,480,480,72,72,0,1,0

7,104,104,2,2,0,1,0
2,171,171,48,28,20,2,1
10,183,183,34,34,0,1,0
17,191,191,39,39,0,1,0
16,236,236,9,9,0,1,0
13,267,267,22,12,10,3,2
11,296,296,5,5,0,1,0
0,297,297,23,9,14,2,1
5,329,329,49,49,0,1,0
15,337,337,9,4,5,2,1
6,361,361,49,49,0,1,0
1,367,367,7,7,0,1,0
8,370,370,18,10,8,3,2
12,377,377,43,37,6,3,2
3,380,380,16,4,12,2,1
4,393,393,90,60,30,4,3
9,443,443,97,78,19,2,1
14,492,492,64,64,0,1,0

5,116,116,16,16,0,1,0
15,116,116,7,7,0,1,0
7,119,119,13,7,6,2,1
1,146,146,13,13,0,1,0
2,173,173,38,38,0,1,0
0,211,211,47,47,0,1,0
6,217,217,19,19,0,1,0
4,231,231,6,6,0,1,0
12,233,233,18,18,0,1,0
3,245,245,17,17,0,1,0
9,260,260,42,42,0,1,0
16,365,365,46,46,0,1,0
13,370,370,47,29,18,3,2
14,408,408,90,90,0,1,0
11,413,413,6,3,3,2,1
17,424,424,64,64,0,1,0
10,481,481,38,26,12,4,3
8,497,497,20,20,0,1,0

8,114,114,19,3,16,2,1
10,138,138,19,19,0,1,0
15,148,148,23,23,0,1,0
6,166,166,4,1,3,2,1
12,194,194,37,37,0,1,0
16,209,209,1,1,0,1,0
0,225,225,35,35,0,1,0
1,251,251,5,1,4,2,1
4,270,270,79,45,34,3,2
3,284,284,23,11,12,2,1
9,303,303,9,9,0,1,0
7,378,378,34,31,3,2,1
5,391,391,14,14,0,1,0
17,396,396,102,102,0,1,0
2,405,405,56,21,35,4,3
11,445,445,74,74,0,1,0
13,456,456,20,20,0,1,0
14,458,458,14,14,0,1,0

3,120,120,3,3,0,1,0
17,122,122,3,3,0,1,0
8,124,124,21,21,0,1,0
7,129,129,30,30,0,1,0
4,170,170,3,3,0,1,0
2,212,212,12,12,0,1,0
16,216,216,10,1,9,2,1
18,221,221,53,8,45,4,3
14,222,222,10,10,0,1,0
9,243,243,61,37,24,4,3
19,253,253,56,56,0,1,0
0,267,267,5,5,0,1,0
11,271,271,55,55,0,1,0
5,282,282,5,2,3,2,1
15,291,291,47,47,0,1,0
12,329,329,22,22,0,1,0
1,392,392,6,2,4,2,1
6,412,412,43,25,18,2,1
13,450,450,9,9,0,1,0
10,465,465,43,23,20,2,1

2,155,155,2,2,0,1,0
20,160,160,6,2,4,2,1
23,164,164,7,2,5,2,1
5,240,240,7,1,6,3,2
13,241,241,19,9,10,2,1
4,278,278,21,2,19,2,1
15,285,285,100,73,27,4,3
6,292,292,37,37,0,1,0
21,298,298,27,27,0,1,0
7,310,310,23,2,21,4,3
19,342,342,22,14,8,2,1
1,361,361,30,8,22,2,1
17,388,388,13,13,0,1,0
11,395,395,16,13,3,2,1
3,399,399,53,30,23,2,1
18,407,407,65,65,0,1,0
14,409,409,12,5,7,2,1
8,416,416,11,11,0,1,0
9,432,432,40,18,22,3,2
12,434,434,29,24,5,2,1
10,467,467,52,52,0,1,0
16,469,469,53,45,8,3,2
22,488,488,62,62,0,1,0
0,490,490,10,10,0,1,0

19,104,104,39,39,0,1,0
11,108,108,7,7,0,1,0
24,123,123,5,5,0,1,0
3,125,125,6,3,3,2,1
13,145,145,9,6,3,2,1
22,163,163,2,2,0,1,0
23,167,167,1,1,0,1,0
0,194,194,2,2,0,1,0
9,211,211,3,3,0,1,0
5,229,229,7,7,0,1,0
21,234,234,17,2,15,2,1
4,249,249,9,1,8,3,2
2,252,252,9,9,0,1,0
6,304,304,2,2,0,1,0
7,345,345,36,9,27,4,3
17,350,350,52,52,0,1,0
25,382,382,50,50,0,1,0
14,399,399,39,39,0,1,0
20,438,438,70,70,0,1,0
1,440,440,24,7,17,3,2
10,443,443,24,6,18,3,2
16,447,447,1,1,0,1,0
8,457,457,65,17,48,4,3
12,459,459,77,35,42,2,1
15,460,460,32,32,0,1,0
18,462,462,35,1,34,3,2

14,103,103,14,1,13,2,1
11,113,113,1,1,0,1,0
6,146,146,5,2,3,2,1
8,163,163,11,11,0,1,0
20,212,212,65,30,35,2,1
12,215,215,22,22,0,1,0
17,224,224,30,12,18,4,3
10,232,232,44,11,33,2,1
0,238,238,45,37,8,2,1
2,243,243,1,1,0,1,0
5,245,245,5,5,0,1,0
16,263,263,1,1,0,1,0
4,284,284,7,7,0,1,0
13,284,284,40,13,27,2,1
22,288,288,10,10,0,1,0
18,291,291,6,6,0,1,0
15,318,318,36,3,33,2,1
7,327,327,2,2,0,1,0
1,375,375,1,1,0,1,0
21,425,425,92,92,0,1,0
3,456,456,21,21,0,1,0
23,462,462,18,18,0,1,0
9,479,479,15,15,0,1,0
19,498,498,75,57,18,4,3

1,111,111,9,1,8,2,1
17,182,182,85,54,31,3,2
15,252,252,5,2,3,2,1
11,258,258,41,17,24,4,3
5,262,262,24,12,12,4,3
6,274,274,120,39,81,4,3
7,302,302,8,1,7,2,1
10,303,303,1,1,0,1,0
8,329,329,6,2,4,2,1
18,345,345,17,7,10,3,2
12,370,370,26,14,12,4,3
19,377,377,17,17,0,1,0
9,383,383,19,19,0,1,0
2,394,394,29,20,9,2,1
3,400,400,11,11,0,1,0
0,439,439,53,36,17,3,2
14,468,468,74,22,52,3,2
13,481,481,10,4,6,3,2
4,487,487,35,7,28,3,2
16,488,488,9,9,0,1,0

4,126,126,4,4,0,1,0
17,126,126,20,20,0,1,0
9,134,134,5,5,0,1,0
10,158,158,5,5,0,1,0
21,164,164,12,12,0,1,0
3,170,170,4,4,0,1,0
0,187,187,24,14,10,3,2
7,238,238,5,1,4,2,1
14,262,262,84,22,62,4,3
15,283,283,44,44,0,1,0
18,322,322,37,37,0,1,0
13,324,324,12,12,0,1,0
5,335,335,37,37,0,1,0
1,342,342,1,1,0,1,0
16,353,353,6,6,0,1,0
12,414,414,16,16,0,1,0
6,429,429,20,3,17,4,3
22,431,431,22,10,12,4,3
8,437,437,3,3,0,1,0
20,437,437,125,113,12,3,2
19,446,446,62,62,0,1,0
11,459,459,41,41,0,1,0
23,477,477,12,12,0,1,0
2,494,494,38,38,0,1,0

2,233,233,1,1,0,1,0
7,247,247,54,30,24,3,2
4,249,249,15,3,12,4,3
3,256,256,94,40,54,4,3
6,283,283,2,2,0,1,0
11,303,303,42,42,0,1,0
12,349,349,75,51,24,3,2
10,363,363,28,22,6,2,1
0,366,366,130,92,38,3,2
8,466,466,26,26,0,1,0
9,496,496,54,54,0,1,0
1,497,497,137,137,0,1,0
5,500,500,67,47,20,4,3

7,122,122,1,1,0,1,0
14,131,131,2,2,0,1,0
8,140,140,16,2,14,4,3
9,189,189,109,62,47,2,1
5,193,193,11,5,6,3,2
13,252,252,7,4,3,2,1
16,272,272,21,7,14,3,2
3,310,310,105,34,71,4,3
6,312,312,6,6,0,1,0
11,319,319,17,17,0,1,0
2,324,324,8,8,0,1,0
0,334,334,20,20,0,1,0
1,381,381,116,105,11,4,3
15,413,413,29,29,0,1,0
4,419,419,79,79,0,1,0
10,428,428,3,3,0,1,0
12,497,497,38,38,0,1,0

20,126,126,3,3,0,1,0
15,127,127,29,17,12,4,3
12,147,147,1,1,0,1,0
6,149,149,1,1,0,1,0
11,210,210,8,8,0,1,0
1,217,217,14,14,0,1,0
8,224,224,4,4,0,1,0
13,230,230,25,25,0,1,0
17,238,238,2,2,0,1,0
22,254,254,4,4,0,1,0
3,283,283,31,17,14,2,1
18,289,289,2,2,0,1,0
10,293,293,39,39,0,1,0
9,325,325,3,3,0,1,0
5,354,354,1,1,0,1,0
7,372,372,49,49,0,1,0
21,383,383,7,2,5,2,1
16,409,409,173,83,90,4,3
0,433,433,3,3,0,1,0
4,438,438,100,2,98,3,2
14,454,454,120,120,0,1,0
19,479,479,13,7,6,2,1
2,487,487,67,9,58,3,2

4,124,124,43,35,8,3,2
6,154,154,21,21,0,1,0
0,172,172,9,9,0,1,0
9,202,202,3,3,0,1,0
8,238,238,14,8,6,3,2
13,251,251,63,9,54,4,3
3,297,297,75,75,0,1,0
7,306,306,5,5,0,1,0
11,321,321,37,37,0,1,0
14,327,327,69,33,36,3,2
12,335,335,47,47,0,1,0
10,351,351,57,57,0,1,0
1,429,429,58,31,27,2,1
5,440,440,27,1,26,3,2
15,488,488,22,22,0,1,0
2,489,489,8,8,0,1,0

11,164,164,13,13,0,1,0
4,179,179,35,35,0,1,0
6,198,198,34,34,0,1,0
1,206,206,41,41,0,1,0
14,263,263,19,19,0,1,0
8,274,274,77,8,69,4,3
9,282,282,3,3,0,1,0
10,295,295,2,2,0,1,0
16,355,355,95,77,18,3,2
3,382,382,3,3,0,1,0
15,442,442,27,27,0,1,0
7,458,458,13,13,0,1,0
5,464,464,125,55,70,3,2
13,473,473,72,10,62,3,2
12,482,482,39,39,0,1,0
2,485,485,48,20,28,3,2
0,489,489,15,15,0,1,0

6,101,101,13,13,0,1,0
20,105,105,17,5,12,3,2
9,117,117,1,1,0,1,0
11,127,127,2,2,0,1,0
21,142,142,2,2,0,1,0
0,164,164,34,11,23,4,3
18,166,166,50,50,0,1,0
15,172,172,11,11,0,1,0
10,189,189,2,2,0,1,0
17,214,214,22,22,0,1,0
13,216,216,2,2,0,1,0
14,217,217,19,14,5,2,1
5,258,258,7,7,0,1,0
4,280,280,15,5,10,3,2
7,341,341,51,51,0,1,0
16,390,390,66,24,42,3,2
8,395,395,44,14,30,2,1
1,396,396,8,8,0,1,0
2,411,411,24,6,18,2,1
3,420,420,19,19,0,1,0
12,435,435,72,72,0,1,0
19,451,451,56,56,0,1,0

2,133,133,8,1,7,2,1
5,149,149,1,1,0,1,0
3,163,163,47,11,36,4,3
18,231,231,17,17,0,1,0
15,283,283,1,1,0,1,0
7,289,289,57,8,49,4,3
16,341,341,113,91,22,3,2
6,344,344,75,27,48,4,3
8,352,352,15,15,0,1,0
12,401,401,86,67,19,2,1
9,406,406,10,10,0,1,0
14,420,420,14,14,0,1,0
10,422,422,46,18,28,2,1
11,439,439,19,15,4,2,1
1,448,448,34,5,29,2,1
4,461,461,18,1,17,2,1
0,465,465,23,23,0,1,0
17,472,472,49,7,42,3,2
13,488,488,47,47,0,1,0

2,118,118,15,8,7,2,1
10,148,148,13,13,0,1,0
13,157,157,9,9,0,1,0
15,192,192,10,5,5,2,1
1,209,209,3,3,0,1,0
16,236,236,8,8,0,1,0
7,237,237,38,26,12,3,2
14,238,238,5,1,4,2,1
5,280,280,79,79,0,1,0
17,294,294,46,33,13,2,1
18,327,327,53,53,0,1,0
6,344,344,18,12,6,2,1
4,344,344,42,42,0,1,0
0,346,346,16,16,0,1,0
8,399,399,40,24,16,2,1
3,401,401,18,10,8,3,2
12,452,452,76,48,28,3,2
9,462,462,24,14,10,2,1
11,474,474,133,39,94,3,2

4,124,124,1,1,0,1,0
15,137,137,5,5,0,1,0
9,148,148,2,2,0,1,0
10,152,152,13,2,11,2,1
0,166,166,45,45,0,1,0
19,201,201,8,8,0,1,0
1,218,218,11,11,0,1,0
12,219,219,14,2,12,2,1
3,222,222,1,1,0,1,0
2,226,226,19,4,15,2,1
5,265,265,62,38,24,4,3
7,277,277,18,6,12,4,3
18,338,338,6,6,0,1,0
6,364,364,28,7,21,2,1
20,372,372,45,45,0,1,0
16,428,428,32,32,0,1,0
8,454,454,14,2,12,2,1
14,477,477,97,97,0,1,0
13,480,480,189,189,0,1,0
17,488,488,30,15,15,4,3
11,500,500,39,1,38,4,3

3,115,115,14,4,10,3,2
13,147,147,1,1,0,1,0
2,160,160,14,14,0,1,0
6,162,162,16,16,0,1,0
7,187,187,4,4,0,1,0
9,200,200,74,74,0,1,0
14,207,207,23,20,3,2,1
11,265,265,20,20,0,1,0
10,279,279,73,73,0,1,0
0,324,324,183,114,69,4,3
1,358,358,26,6,20,3,2
8,462,462,14,14,0,1,0
12,470,470,22,22,0,1,0
4,474,474,55,55,0,1,0
5,485,485,19,4,15,4,3

9,128,128,14,14,0,1,0
0,145,145,1,1,0,1,0
3,165,165,3,3,0,1,0
8,197,197,20,20,0,1,0
16,202,202,18,18,0,1,0
7,212,212,40,7,33,2,1
1,223,223,31,10,21,2,1
6,278,278,21,1,20,2,1
15,285,285,3,3,0,1,0
12,289,289,38,38,0,1,0
14,307,307,23,8,15,3,2
17,333,333,76,20,56,3,2
10,336,336,39,4,35,2,1
13,351,351,66,66,0,1,0
5,366,366,12,12,0,1,0
4,409,409,52,29,23,2,1
2,419,419,131,88,43,2,1
11,493,493,33,11,22,2,1

6,107,107,22,14,8,3,2
12,133,133,22,4,18,3,2
9,157,157,3,3,0,1,0
3,163,163,19,5,14,3,2
8,163,163,31,13,18,3,2
0,167,167,11,11,0,1,0
5,172,172,3,3,0,1,0
1,176,176,57,57,0,1,0
4,180,180,20,20,0,1,0
13,285,285,16,16,0,1,0
11,313,313,49,16,33,2,1
2,337,337,12,12,0,1,0
15,360,360,87,87,0,1,0
14,361,361,39,20,19,2,1
7,386,386,48,11,37,2,1
16,386,386,9,9,0,1,0
10,390,390,23,23,0,1,0

14,115,115,25,13,12,4,3
1,138,138,24,21,3,2,1
7,149,149,5,2,3,2,1
17,181,181,15,4,11,2,1
2,228,228,11,11,0,1,0
20,237,237,17,3,14,2,1
10,253,253,13,13,0,1,0
0,266,266,11,11,0,1,0
6,297,297,2,2,0,1,0
18,340,340,2,2,0,1,0
15,345,345,3,3,0,1,0
8,359,359,66,66,0,1,0
11,363,363,2,2,0,1,0
4,389,389,48,48,0,1,0
13,406,406,56,56,0,1,0
3,409,409,71,71,0,1,0
19,431,431,19,8,11,4,3
16,435,435,169,63,106,4,3
9,467,467,27,27,0,1,0
12,475,475,18,8,10,3,2
5,485,485,31,31,0,1,0
21,485,485,30,30,0,1,0

4,107,107,1,1,0,1,0
2,110,110,7,7,0,1,0
10,123,123,4,4,0,1,0
0,173,173,10,6,4,2,1
1,180,180,24,24,0,1,0
5,192,192,9,4,5,2,1
3,246,246,18,4,14,2,1
13,247,247,17,4,13,2,1
9,279,279,12,12,0,1,0
17,296,296,3,3,0,1,0
20,314,314,43,30,13,2,1
8,314,314,6,6,0,1,0
19,322,322,6,6,0,1,0
6,370,370,146,146,0,1,0
15,390,390,93,37,56,3,2
11,423,423,16,16,0,1,0
12,431,431,6,6,0,1,0
18,433,433,9,9,0,1,0
7,445,445,40,40,0,1,0
14,460,460,163,163,0,1,0
16,491,491,73,36,37,4,3

3,190,190,30,13,17,2,1
11,194,194,5,5,0,1,0
2,219,219,7,7,0,1,0
4,260,260,2,2,0,1,0
8,279,279,68,41,27,4,3
5,292,292,117,37,80,3,2
9,298,298,34,34,0,1,0
12,315,315,6,2,4,2,1
15,363,363,36,36,0,1,0
1,384,384,50,50,0,1,0
10,391,391,20,13,7,2,1
13,398,398,137,137,0,1,0
6,400,400,68,68,0,1,0
0,419,419,43,29,14,3,2
14,459,459,5,1,4,2,1
7,468,468,49,20,29,2,1

0,109,109,15,11,4,2,1
14,114,114,25,6,19,2,1
4,126,126,8,1,7,2,1
20,132,132,1,1,0,1,0
13,142,142,11,11,0,1,0
17,156,156,51,15,36,4,3
9,160,160,1,1,0,1,0
3,202,202,40,40,0,1,0
2,204,204,4,4,0,1,0
7,220,220,13,1,12,4,3
8,237,237,85,58,27,2,1
19,287,287,14,14,0,1,0
15,299,299,13,13,0,1,0
10,328,328,17,7,10,2,1
6,330,330,11,2,9,4,3
11,365,365,8,8,0,1,0
5,418,418,9,9,0,1,0
16,446,446,37,25,12,2,1
12,479,479,28,4,24,4,3
1,480,480,15,15,0,1,0
18,498,498,77,77,0,1,0

21,103,103,4,4,0,1,0
0,125,125,5,5,0,1,0
18,133,133,1,1,0,1,0
4,167,167,11,11,0,1,0
15,167,167,70,70,0,1,0
9,178,178,3,3,0,1,0
1,192,192,29,11,18,2,1
2,211,211,56,56,0,1,0
11,214,214,26,26,0,1,0
6,232,232,9,9,0,1,0
5,249,249,43,43,0,1,0
16,262,262,46,46,0,1,0
10,286,286,5,2,3,2,1
17,291,291,6,6,0,1,0
12,350,350,5,5,0,1,0
14,370,370,23,23,0,1,0
7,393,393,26,26,0,1,0
20,455,455,1,1,0,1,0
19,456,456,24,24,0,1,0
3,478,478,1,1,0,1,0
13,481,481,118,106,12,3,2
8,491,491,15,4,11,2,1

21,133,133,20,20,0,1,0
13,137,137,16,10,6,3,2
11,165,165,9,9,0,1,0
5,173,173,33,11,22,2,1
9,192,192,20,12,8,2,1
1,204,204,11,11,0,1,0
19,209,209,53,8,45,2,1
20,224,224,6,2,4,2,1
17,239,239,34,34,0,1,0
4,242,242,10,10,0,1,0
2,243,243,1,1,0,1,0
8,271,271,37,22,15,2,1
0,286,286,43,19,24,3,2
18,336,336,58,22,36,4,3
3,349,349,6,1,5,2,1
14,353,353,38,12,26,3,2
15,356,356,6,6,0,1,0
12,376,376,64,64,0,1,0
7,390,390,21,3,18,2,1
16,391,391,13,7,6,3,2
6,438,438,10,10,0,1,0
10,458,458,1,1,0,1,0

3,120,120,19,19,0,1,0
17,141,141,51,51,0,1,0
19,149,149,36,30,6,3,2
4,164,164,13,13,0,1,0
5,167,167,9,6,3,2,1
23,171,171,12,12,0,1,0
7,182,182,14,14,0,1,0
1,216,216,15,15,0,1,0
12,218,218,5,5,0,1,0
6,228,228,33,14,19,2,1
15,257,257,20,20,0,1,0
11,295,295,13,13,0,1,0
2,316,316,11,7,4,2,1
18,320,320,60,60,0,1,0
16,362,362,13,13,0,1,0
22,388,388,8,8,0,1,0
8,426,426,1,1,0,1,0
13,433,433,50,50,0,1,0
9,437,437,13,13,0,1,0
14,458,458,13,13,0,1,0
0,464,464,36,36,0,1,0
20,464,464,3,3,0,1,0
10,466,466,29,26,3,2,1
21,481,481,12,5,7,3,2

16,118,118,9,9,0,1,0
12,125,125,17,3,14,3,2
15,142,142,24,4,20,3,2
18,193,193,28,13,15,4,3
5,198,198,3,3,0,1,0
0,212,212,50,23,27,4,3
2,232,232,48,23,25,2,1
10,237,237,20,15,5,2,1
6,238,238,6,6,0,1,0
20,248,248,42,15,27,2,1
19,260,260,16,5,11,2,1
1,270,270,26,26,0,1,0
14,307,307,35,35,0,1,0
8,357,357,8,8,0,1,0
3,401,401,71,71,0,1,0
11,424,424,18,18,0,1,0
7,433,433,5,5,0,1,0
17,477,477,17,17,0,1,0
4,489,489,17,1,16,3,2
13,498,498,54,42,12,4,3
9,500,500,25,1,24,4,3

9,136,136,20,20,0,1,0
14,147,147,67,37,30,2,1
11,152,152,22,11,11,2,1
13,162,162,13,13,0,1,0
19,168,168,1,1,0,1,0
0,185,185,10,10,0,1,0
3,193,193,10,10,0,1,0
20,203,203,27,27,0,1,0
18,219,219,37,19,18,4,3
21,222,222,20,2,18,2,1
8,229,229,36,10,26,2,1
16,251,251,6,6,0,1,0
7,257,257,5,5,0,1,0
1,269,269,9,3,6,2,1
5,282,282,7,7,0,1,0
10,307,307,5,5,0,1,0
15,328,328,7,7,0,1,0
2,366,366,20,20,0,1,0
4,376,376,51,1,50,3,2
17,382,382,16,11,5,2,1
12,449,449,65,65,0,1,0
6,473,473,8,8,0,1,0

6,102,102,1,1,0,1,0
13,118,118,10,2,8,2,1
12,130,130,27,27,0,1,0
8,192,192,65,65,0,1,0
17,223,223,48,48,0,1,0
15,247,247,15,15,0,1,0
9,248,248,1,1,0,1,0
20,250,250,17,17,0,1,0
1,259,259,21,21,0,1,0
4,275,275,54,54,0,1,0
16,313,313,65,31,34,3,2
11,327,327,3,3,0,1,0
2,329,329,30,10,20,2,1
19,378,378,42,7,35,2,1
5,385,385,8,8,0,1,0
10,414,414,13,13,0,1,0
7,440,440,48,8,40,2,1
0,464,464,8,8,0,1,0
3,479,479,45,27,18,3,2
14,480,480,2,2,0,1,0
18,487,487,27,27,0,1,0

14,106,106,15,15,0,1,0
27,139,139,7,7,0,1,0
18,153,153,5,5,0,1,0
26,161,161,40,9,31,3,2
24,179,179,13,13,0,1,0
21,181,181,16,16,0,1,0
6,197,197,18,12,6,2,1
20,235,235,4,4,0,1,0
11,238,238,14,6,8,3,2
23,238,238,7,7,0,1,0
9,250,250,12,6,6,3,2
15,262,262,5,5,0,1,0
22,265,265,15,6,9,2,1
4,270,270,3,3,0,1,0
2,275,275,1,1,0,1,0
5,312,312,19,3,16,2,1
0,313,313,38,3,35,2,1
12,319,319,10,10,0,1,0
17,320,320,11,2,9,2,1
25,335,335,153,78,75,4,3
7,383,383,4,4,0,1,0
1,408,408,41,35,6,2,1
3,416,416,1,1,0,1,0
10,432,432,12,8,4,2,1
13,465,465,7,7,0,1,0
16,472,472,69,49,20,2,1
8,478,478,23,6,17,2,1
19,481,481,4,1,3,2,1

9,111,111,1,1,0,1,0
0,143,143,9,9,0,1,0
11,148,148,3,3,0,1,0
18,164,164,9,3,6,3,2
19,211,211,42,42,0,1,0
15,230,230,52,4,48,4,3
17,238,238,10,3,7,2,1
13,245,245,32,32,0,1,0
12,304,304,95,3,92,3,2
5,313,313,1,1,0,1,0
10,327,327,22,2,20,2,1
14,329,329,8,2,6,3,2
6,337,337,38,22,16,2,1
7,361,361,124,83,41,2,1
4,378,378,62,62,0,1,0
16,397,397,2,2,0,1,0
2,406,406,9,9,0,1,0
8,442,442,53,28,25,2,1
1,452,452,37,37,0,1,0
3,495,495,8,8,0,1,0

14,142,142,7,7,0,1,0
12,148,148,49,49,0,1,0
9,160,160,3,3,0,1,0
19,177,177,23,12,11,2,1
8,249,249,8,8,0,1,0
11,286,286,21,21,0,1,0
7,288,288,25,25,0,1,0
4,323,323,13,3,10,2,1
15,335,335,4,4,0,1,0
5,338,338,62,41,21,2,1
16,375,375,31,6,25,2,1
10,400,400,33,33,0,1,0
13,402,402,118,61,57,3,2
3,404,404,5,5,0,1,0
6,443,443,91,91,0,1,0
17,444,444,13,13,0,1,0
0,454,454,78,30,48,4,3
2,462,462,36,13,23,3,2
1,493,493,44,41,3,2,1
18,496,496,10,10,0,1,0

4,110,110,10,10,0,1,0
9,110,110,9,9,0,1,0
19,111,111,6,6,0,1,0
8,157,157,1,1,0,1,0
3,158,158,21,21,0,1,0
17,163,163,16,16,0,1,0
5,188,188,14,14,0,1,0
14,191,191,22,13,9,4,3
20,217,217,29,29,0,1,0
13,264,264,6,2,4,2,1
18,277,277,16,16,0,1,0
11,298,298,1,1,0,1,0
0,311,311,58,14,44,2,1
16,325,325,23,23,0,1,0
10,331,331,1,1,0,1,0
1,338,338,50,50,0,1,0
2,340,340,60,20,40,3,2
7,351,351,19,4,15,2,1
12,364,364,2,2,0,1,0
15,416,416,118,70,48,4,3
6,432,432,16,16,0,1,0
21,489,489,91,2,89,4,3

18,101,101,12,2,10,2,1
10,147,147,3,3,0,1,0
12,203,203,3,3,0,1,0
3,230,230,3,3,0,1,0
1,241,241,58,58,0,1,0
15,267,267,55,47,8,3,2
2,293,293,19,5,14,3,2
17,328,328,19,11,8,3,2
8,356,356,39,18,21,4,3
16,360,360,66,6,60,4,3
9,381,381,75,75,0,1,0
7,384,384,6,1,5,2,1
5,392,392,48,48,0,1,0
6,397,397,37,37,0,1,0
4,425,425,35,8,27,2,1
13,438,438,48,39,9,4,3
0,441,441,20,20,0,1,0
19,461,461,69,51,18,4,3
11,495,495,27,9,18,3,2
14,496,496,60,60,0,1,0

13,124,124,8,4,4,2,1
2,161,161,5,5,0,1,0
0,167,167,19,10,9,4,3
12,169,169,38,8,30,4,3
18,200,200,37,37,0,1,0
14,241,241,7,7,0,1,0
1,266,266,70,70,0,1,0
8,278,278,42,42,0,1,0
4,278,278,2,2,0,1,0
9,280,280,52,30,22,3,2
16,286,286,12,12,0,1,0
6,289,289,8,8,0,1,0
17,290,290,28,1,27,4,3
19,299,299,49,38,11,2,1
3,380,380,10,3,7,2,1
10,381,381,1,1,0,1,0
15,431,431,31,31,0,1,0
5,443,443,12,12,0,1,0
7,476,476,8,2,6,2,1
11,476,476,71,57,14,2,1
20,478,478,66,20,46,2,1

17,120,120,9,9,0,1,0
6,122,122,5,5,0,1,0
8,135,135,1,1,0,1,0
9,137,137,14,11,3,2,1
15,146,146,2,2,0,1,0
5,176,176,11,11,0,1,0
19,177,177,35,35,0,1,0
13,179,179,5,5,0,1,0
14,187,187,4,4,0,1,0
18,190,190,19,7,12,4,3
21,232,232,71,56,15,4,3
7,260,260,21,3,18,3,2
22,275,275,41,6,35,3,2
3,317,317,39,8,31,2,1
10,335,335,35,35,0,1,0
11,356,356,4,4,0,1,0
4,371,371,24,10,14,3,2
16,380,380,20,20,0,1,0
1,431,431,31,4,27,2,1
12,453,453,71,71,0,1,0
2,462,462,1,1,0,1,0
20,469,469,50,22,28,3,2
0,477,477,69,5,64,3,2

16,104,104,12,12,0,1,0
9,172,172,6,6,0,1,0
8,225,225,96,78,18,3,2
4,225,225,45,40,5,2,1
12,231,231,14,14,0,1,0
1,268,268,64,64,0,1,0
14,293,293,7,7,0,1,0
11,318,318,3,3,0,1,0
2,334,334,13,13,0,1,0
10,339,339,62,44,18,2,1
13,357,357,46,2,44,3,2
3,377,377,46,1,45,2,1
6,405,405,54,54,0,1,0
15,413,413,18,18,0,1,0
5,420,420,38,38,0,1,0
7,423,423,47,28,19,2,1
0,436,436,29,5,24,3,2

14,120,120,16,16,0,1,0
17,142,142,1,1,0,1,0
9,181,181,3,3,0,1,0
7,191,191,14,14,0,1,0
11,223,223,30,30,0,1,0
10,230,230,62,50,12,2,1
1,275,275,56,47,9,4,3
4,313,313,30,30,0,1,0
0,318,318,46,46,0,1,0
12,411,411,12,3,9,2,1
5,416,416,25,22,3,2,1
8,447,447,86,86,0,1,0
3,457,457,33,33,0,1,0
16,460,460,36,10,26,3,2
15,480,480,81,81,0,1,0
2,491,491,63,22,41,3,2
13,498,498,89,89,0,1,0
6,500,500,15,11,4,2,1

8,112,112,15,15,0,1,0
0,172,172,43,43,0,1,0
9,212,212,2,2,0,1,0
12,216,216,9,9,0,1,0
10,229,229,23,23,0,1,0
3,272,272,64,16,48,2,1
6,285,285,84,24,60,3,2
7,294,294,26,5,21,4,3
14,316,316,88,62,26,2,1
11,328,328,2,2,0,1,0
13,374,374,27,27,0,1,0
2,433,433,1,1,0,1,0
5,436,436,51,51,0,1,0
4,443,443,102,102,0,1,0
1,476,476,79,61,18,4,3

8,148,148,4,4,0,1,0
21,150,150,18,18,0,1,0
18,155,155,29,29,0,1,0
7,176,176,1,1,0,1,0
11,201,201,34,34,0,1,0
10,216,216,11,11,0,1,0
3,216,216,6,6,0,1,0
2,225,225,1,1,0,1,0
14,241,241,16,16,0,1,0
16,241,241,20,9,11,2,1
4,270,270,11,6,5,2,1
9,272,272,15,11,4,2,1
20,280,280,1,1,0,1,0
13,292,292,31,31,0,1,0
5,349,349,15,15,0,1,0
19,390,390,81,24,57,3,2
12,395,395,39,39,0,1,0
6,399,399,45,10,35,2,1
1,400,400,143,130,13,2,1
0,439,439,4,1,3,2,1
15,496,496,78,32,46,2,1
17,499,499,46,26,20,2,1

10,103,103,4,4,0,1,0
6,104,104,30,6,24,3,2
8,122,122,5,5,0,1,0
4,130,130,26,10,16,2,1
15,146,146,12,1,11,2,1
5,163,163,20,17,3,2,1
14,164,164,47,2,45,2,1
9,170,170,4,4,0,1,0
3,171,171,30,30,0,1,0
16,209,209,2,2,0,1,0
2,242,242,4,4,0,1,0
17,310,310,5,5,0,1,0
1,325,325,22,22,0,1,0
7,404,404,15,15,0,1,0
13,437,437,71,47,24,3,2
18,440,440,59,59,0,1,0
0,445,445,14,14,0,1,0
12,453,453,101,40,61,3,2
11,458,458,26,11,15,4,3

10,110,110,3,3,0,1,0
1,127,127,2,2,0,1,0
16,140,140,27,15,12,4,3
15,163,163,16,16,0,1,0
3,170,170,1,1,0,1,0
5,187,187,2,2,0,1,0
20,211,211,28,11,17,2,1
23,215,215,43,16,27,4,3
22,228,228,37,37,0,1,0
8,230,230,12,12,0,1,0
7,244,244,3,3,0,1,0
13,253,253,25,25,0,1,0
19,269,269,12,6,6,2,1
14,271,271,36,36,0,1,0
4,286,286,36,36,0,1,0
17,317,317,37,37,0,1,0
11,322,322,26,2,24,4,3
12,349,349,9,1,8,3,2
6,356,356,1,1,0,1,0
21,411,411,2,2,0,1,0
2,435,435,26,4,22,2,1
18,469,469,30,30,0,1,0
0,492,492,53,53,0,1,0
9,494,494,120,58,62,4,3

17,153,153,11,5,6,2,1
7,172,172,24,24,0,1,0
1,211,211,19,19,0,1,0
3,222,222,45,45,0,1,0
5,227,227,15,15,0,1,0
6,239,239,19,11,8,2,1
11,276,276,24,24,0,1,0
14,291,291,12,7,5,2,1
12,297,297,21,21,0,1,0
9,378,378,2,2,0,1,0
15,401,401,20,4,16,2,1
13,414,414,28,13,15,4,3
8,421,421,16,16,0,1,0
16,453,453,175,105,70,3,2
4,457,457,23,23,0,1,0
10,462,462,110,14,96,3,2
0,493,493,78,78,0,1,0
2,495,495,87,26,61,4,3

20,113,113,12,12,0,1,0
19,141,141,12,12,0,1,0
5,141,141,3,3,0,1,0
15,146,146,9,9,0,1,0
13,151,151,1,1,0,1,0
0,160,160,15,3,12,2,1
18,162,162,2,2,0,1,0
12,239,239,6,6,0,1,0
6,245,245,17,17,0,1,0
21,245,245,58,58,0,1,0
23,246,246,5,5,0,1,0
24,259,259,12,12,0,1,0
14,269,269,11,1,10,4,3
8,278,278,40,33,7,2,1
25,305,305,91,37,54,3,2
7,310,310,16,16,0,1,0
9,315,315,4,4,0,1,0
3,331,331,16,16,0,1,0
4,354,354,44,17,27,4,3
16,354,354,1,1,0,1,0
11,378,378,22,22,0,1,0
1,379,379,27,19,8,2,1
22,422,422,82,41,41,2,1
17,423,423,40,40,0,1,0
2,457,457,5,2,3,2,1
26,485,485,11,11,0,1,0
10,494,494,32,12,20,3,2

15,189,189,7,1,6,2,1
13,200,200,3,3,0,1,0
19,217,217,20,1,19,2,1
8,227,227,4,4,0,1,0
1,234,234,2,2,0,1,0
5,236,236,3,3,0,1,0
7,254,254,20,12,8,2,1
6,267,267,11,6,5,2,1
14,271,271,4,4,0,1,0
0,283,283,34,34,0,1,0
17,297,297,21,17,4,2,1
12,304,304,13,13,0,1,0
18,305,305,46,18,28,2,1
9,317,317,53,53,0,1,0
2,340,340,39,31,8,2,1
3,340,340,52,6,46,3,2
16,412,412,170,122,48,2,1
10,424,424,84,84,0,1,0
4,439,439,39,19,20,3,2
11,496,496,89,89,0,1,0

10,101,101,12,12,0,1,0
2,172,172,2,2,0,1,0
9,173,173,22,14,8,3,2
7,182,182,18,15,3,2,1
15,182,182,9,9,0,1,0
4,191,191,69,27,42,4,3
3,212,212,31,31,0,1,0
13,261,261,1,1,0,1,0
0,292,292,7,7,0,1,0
14,292,292,2,2,0,1,0
11,317,317,27,7,20,3,2
8,364,364,145,145,0,1,0
5,374,374,88,76,12,4,3
6,463,463,11,3,8,3,2
12,486,486,63,63,0,1,0
1,495,495,99,26,73,4,3

5,122,122,14,6,8,3,2
3,133,133,7,7,0,1,0
17,144,144,4,4,0,1,0
9,155,155,22,13,9,2,1
10,156,156,23,12,11,2,1
7,174,174,13,1,12,4,3
2,186,186,29,16,13,2,1
15,186,186,5,5,0,1,0
11,197,197,80,59,21,2,1
1,211,211,8,8,0,1,0
6,214,214,18,18,0,1,0
12,250,250,6,6,0,1,0
4,289,289,28,28,0,1,0
13,303,303,65,24,41,3,2
14,396,396,10,10,0,1,0
0,443,443,13,13,0,1,0
8,476,476,169,169,0,1,0
16,500,500,2,2,0,1,0

15,111,111,21,7,14,3,2
9,112,112,25,25,0,1,0
0,120,120,14,14,0,1,0
5,154,154,15,15,0,1,0
17,154,154,32,23,9,2,1
14,197,197,15,15,0,1,0
16,253,253,41,41,0,1,0
3,278,278,10,10,0,1,0
8,344,344,34,34,0,1,0
13,356,356,1,1,0,1,0
4,369,369,3,3,0,1,0
2,433,433,70,28,42,4,3
10,458,458,34,17,17,2,1
11,472,472,83,83,0,1,0
1,478,478,54,54,0,1,0
18,485,485,54,54,0,1,0
6,486,486,62,62,0,1,0
7,494,494,10,10,0,1,0
12,498,498,7,7,0,1,0

11,160,160,9,9,0,1,0
18,181,181,1,1,0,1,0
12,187,187,2,2,0,1,0
3,189,189,21,11,10,3,2
7,191,191,22,22,0,1,0
10,203,203,20,20,0,1,0
2,227,227,28,28,0,1,0
0,250,250,16,8,8,3,2
17,261,261,1,1,0,1,0
6,268,268,5,5,0,1,0
14,306,306,61,18,43,2,1
9,342,342,15,15,0,1,0
13,349,349,81,81,0,1,0
19,384,384,23,23,0,1,0
4,404,404,107,7,100,4,3
1,428,428,22,22,0,1,0
16,446,446,177,111,66,4,3
15,472,472,23,23,0,1,0
5,476,476,18,18,0,1,0
8,491,491,37,25,12,4,3

13,132,132,13,2,11,4,3
16,137,137,26,4,22,2,1
4,142,142,4,4,0,1,0
8,149,149,6,6,0,1,0
5,174,174,1,1,0,1,0
6,199,199,6,6,0,1,0
12,213,213,4,1,3,2,1
19,252,252,1,1,0,1,0
17,257,257,21,21,0,1,0
9,268,268,1,1,0,1,0
18,271,271,11,11,0,1,0
3,302,302,72,8,64,3,2
2,316,316,1,1,0,1,0
14,357,357,100,90,10,3,2
7,361,361,5,2,3,2,1
10,376,376,40,40,0,1,0
1,404,404,23,8,15,4,3
15,427,427,86,86,0,1,0
0,458,458,78,78,0,1,0
11,466,466,142,142,0,1,0
20,470,470,49,49,0,1,0

10,118,118,9,9,0,1,0
12,125,125,5,5,0,1,0
11,153,153,16,5,11,2,1
18,174,174,17,17,0,1,0
15,180,180,14,14,0,1,0
14,187,187,5,5,0,1,0
6,275,275,10,10,0,1,0
16,286,286,68,56,12,4,3
13,293,293,93,93,0,1,0
17,296,296,13,8,5,2,1
5,297,297,23,23,0,1,0
7,306,306,6,6,0,1,0
0,345,345,4,4,0,1,0
2,377,377,8,3,5,2,1
1,411,411,24,24,0,1,0
3,427,427,130,61,69,4,3
4,467,467,119,77,42,2,1
8,469,469,75,32,43,2,1
9,488,488,28,28,0,1,0

9,123,123,27,27,0,1,0
14,131,131,5,1,4,2,1
5,154,154,22,22,0,1,0
6,165,165,1,1,0,1,0
2,186,186,31,13,18,4,3
11,199,199,1,1,0,1,0
8,202,202,20,3,17,2,1
12,258,258,10,10,0,1,0
15,263,263,42,42,0,1,0
0,291,291,53,39,14,3,2
4,297,297,41,41,0,1,0
1,302,302,38,23,15,4,3
7,339,339,6,3,3,2,1
10,391,391,65,65,0,1,0
13,464,464,8,8,0,1,0
16,487,487,75,75,0,1,0
17,493,493,112,112,0,1,0
3,494,494,62,30,32,3,2

9,131,131,11,8,3,2,1
12,157,157,50,19,31,2,1
2,160,160,45,33,12,3,2
0,172,172,79,79,0,1,0
1,207,207,10,7,3,2,1
5,207,207,1,1,0,1,0
14,246,246,55,55,0,1,0
6,260,260,8,5,3,2,1
10,305,305,7,7,0,1,0
4,306,306,52,32,20,2,1
8,337,337,10,10,0,1,0
13,346,346,29,19,10,3,2
11,361,361,9,9,0,1,0
15,366,366,46,9,37,2,1
7,399,399,40,12,28,3,2
3,456,456,4,4,0,1,0

0,126,126,3,3,0,1,0
5,132,132,2,2,0,1,0
16,138,138,33,33,0,1,0
19,183,183,24,15,9,3,2
12,193,193,8,2,6,3,2
7,246,246,1,1,0,1,0
4,250,250,45,7,38,2,1
9,268,268,4,4,0,1,0
3,278,278,9,3,6,2,1
14,337,337,74,29,45,4,3
13,356,356,19,6,13,2,1
6,369,369,42,33,9,4,3
1,376,376,32,32,0,1,0
8,392,392,34,34,0,1,0
18,407,407,2,2,0,1,0
15,415,415,4,4,0,1,0
20,424,424,39,39,0,1,0
11,425,425,111,95,16,3,2
10,456,456,26,26,0,1,0
2,484,484,61,38,23,2,1
17,490,490,111,6,105,4,3

8,116,116,9,6,3,2,1
1,118,118,1,1,0,1,0
10,120,120,6,3,3,2,1
17,125,125,26,1,25,2,1
5,132,132,58,58,0,1,0
15,149,149,5,5,0,1,0
16,190,190,11,7,4,2,1
14,289,289,21,11,10,3,2
7,344,344,8,8,0,1,0
12,345,345,19,12,7,2,1
13,358,358,4,4,0,1,0
9,364,364,105,105,0,1,0
11,375,375,94,94,0,1,0
2,390,390,59,37,22,3,2
6,464,464,45,3,42,4,3
3,481,481,56,56,0,1,0
4,484,484,13,5,8,3,2
0,499,499,31,31,0,1,0

3,135,135,4,4,0,1,0
20,154,154,11,2,9,2,1
1,162,162,1,1,0,1,0
21,177,177,4,4,0,1,0
13,186,186,6,6,0,1,0
18,188,188,35,11,24,4,3
19,203,203,28,28,0,1,0
14,223,223,11,3,8,3,2
0,282,282,37,37,0,1,0
10,289,289,6,2,4,2,1
2,314,314,11,4,7,2,1
12,316,316,16,7,9,2,1
4,319,319,21,12,9,2,1
7,351,351,61,61,0,1,0
6,352,352,1,1,0,1,0
16,361,361,39,31,8,2,1
8,371,371,82,20,62,3,2
22,379,379,33,33,0,1,0
11,431,431,48,48,0,1,0
5,440,440,24,24,0,1,0
9,450,450,30,4,26,3,2
17,460,460,100,54,46,4,3
15,482,482,67,60,7,2,1

4,145,145,14,14,0,1,0
7,173,173,4,4,0,1,0
19,187,187,32,32,0,1,0
9,210,210,33,33,0,1,0
5,225,225,20,17,3,2,1
10,229,229,38,38,0,1,0
14,232,232,4,4,0,1,0
8,235,235,4,4,0,1,0
3,311,311,52,18,34,2,1
0,318,318,55,55,0,1,0
11,354,354,4,4,0,1,0
6,355,355,1,1,0,1,0
2,359,359,26,26,0,1,0
18,359,359,26,2,24,2,1
12,376,376,47,47,0,1,0
17,380,380,23,23,0,1,0
15,390,390,132,54,78,4,3
16,427,427,31,9,22,2,1
1,438,438,16,16,0,1,0
13,443,443,67,17,50,3,2

16,128,128,59,17,42,3,2
17,138,138,15,4,11,2,1
5,172,172,3,3,0,1,0
2,236,236,15,15,0,1,0
1,241,241,20,20,0,1,0
8,287,287,95,74,21,2,1
11,300,300,6,6,0,1,0
15,336,336,11,1,10,2,1
12,343,343,15,15,0,1,0
13,363,363,40,40,0,1,0
6,393,393,2,2,0,1,0
10,410,410,12,12,0,1,0
0,411,411,36,3,33,2,1
14,415,415,14,3,11,2,1
7,417,417,12,12,0,1,0
3,453,453,1,1,0,1,0
18,463,463,83,14,69,4,3
4,470,470,92,36,56,3,2
9,498,498,93,39,54,4,3

13,128,128,4,4,0,1,0
9,139,139,5,5,0,1,0
10,145,145,10,2,8,2,1
0,163,163,49,49,0,1,0
8,168,168,6,6,0,1,0
14,176,176,15,3,12,3,2
11,193,193,108,74,34,2,1
12,213,213,26,26,0,1,0
2,226,226,60,11,49,2,1
3,277,277,36,36,0,1,0
4,309,309,22,16,6,3,2
5,312,312,54,22,32,2,1
6,317,317,1,1,0,1,0
7,477,477,38,9,29,2,1
1,480,480,29,29,0,1,0

3,158,158,10,2,8,3,2
12,171,171,45,5,40,3,2
2,176,176,2,2,0,1,0
18,199,199,11,3,8,3,2
10,230,230,63,63,0,1,0
11,281,281,7,7,0,1,0
4,302,302,50,50,0,1,0
0,328,328,45,45,0,1,0
6,369,369,40,23,17,2,1
13,379,379,12,12,0,1,0
15,409,409,77,23,54,3,2
1,414,414,39,20,19,2,1
8,420,420,53,45,8,2,1
9,422,422,47,47,0,1,0
17,423,423,9,2,7,2,1
7,433,433,40,19,21,2,1
16,438,438,17,17,0,1,0
14,449,449,54,34,20,3,2
5,497,497,45,7,38,2,1

16,114,114,2,2,0,1,0
2,118,118,10,10,0,1,0
18,135,135,31,31,0,1,0
14,154,154,8,3,5,2,1
20,159,159,30,30,0,1,0
7,195,195,2,2,0,1,0
0,237,237,1,1,0,1,0
9,252,252,48,48,0,1,0
11,256,256,73,73,0,1,0
1,257,257,31,31,0,1,0
5,315,315,9,9,0,1,0
6,366,366,24,24,0,1,0
8,383,383,29,29,0,1,0
3,386,386,24,6,18,2,1
13,394,394,17,7,10,3,2
19,407,407,43,43,0,1,0
12,411,411,116,108,8,2,1
4,440,440,25,11,14,2,1
10,457,457,8,8,0,1,0
17,459,459,1,1,0,1,0
15,481,481,53,7,46,2,1

1,166,166,51,51,0,1,0
6,172,172,11,11,0,1,0
3,175,175,13,1,12,3,2
11,176,176,2,2,0,1,0
10,227,227,27,27,0,1,0
5,232,232,52,43,9,2,1
0,264,264,139,139,0,1,0
4,296,296,67,54,13,2,1
2,310,310,29,29,0,1,0
7,377,377,1,1,0,1,0
9,416,416,100,100,0,1,0
12,417,417,37,37,0,1,0
8,429,429,17,17,0,1,0

15,105,105,15,9,6,2,1
0,148,148,3,3,0,1,0
11,188,188,13,4,9,4,3
2,214,214,17,17,0,1,0
12,225,225,16,16,0,1,0
5,227,227,12,12,0,1,0
14,227,227,56,56,0,1,0
8,242,242,27,9,18,4,3
13,285,285,19,19,0,1,0
10,289,289,7,7,0,1,0
1,368,368,108,99,9,2,1
17,376,376,16,16,0,1,0
18,395,395,48,48,0,1,0
19,422,422,10,10,0,1,0
9,436,436,40,18,22,2,1
3,437,437,39,39,0,1,0
7,440,440,29,17,12,4,3
6,442,442,7,1,6,2,1
4,461,461,73,31,42,4,3
16,489,489,112,44,68,3,2

21,102,102,25,4,21,2,1
4,103,103,14,2,12,4,3
14,154,154,7,7,0,1,0
19,170,170,17,17,0,1,0
5,174,174,1,1,0,1,0
17,221,221,105,97,8,3,2
8,231,231,42,7,35,2,1
13,243,243,4,4,0,1,0
10,282,282,21,21,0,1,0
2,286,286,1,1,0,1,0
1,286,286,19,19,0,1,0
20,327,327,5,5,0,1,0
3,338,338,14,2,12,2,1
11,339,339,45,25,20,3,2
16,361,361,4,4,0,1,0
9,372,372,18,18,0,1,0
6,401,401,52,19,33,2,1
18,408,408,34,14,20,3,2
12,425,425,37,37,0,1,0
15,437,437,14,14,0,1,0
0,469,469,7,7,0,1,0
7,486,486,38,12,26,3,2

15,119,119,17,17,0,1,0
8,129,129,13,13,0,1,0
2,144,144,17,17,0,1,0
25,153,153,3,3,0,1,0
5,189,189,27,3,24,3,2
22,198,198,27,9,18,2,1
24,228,228,56,49,7,2,1
17,233,233,22,22,0,1,0
21,234,234,9,2,7,2,1
12,238,238,6,6,0,1,0
18,266,266,2,2,0,1,0
3,272,272,6,6,0,1,0
10,280,280,10,10,0,1,0
23,302,302,15,15,0,1,0
19,305,305,3,3,0,1,0
11,335,335,15,1,14,3,2
1,342,342,16,16,0,1,0
9,359,359,18,18,0,1,0
6,394,394,9,9,0,1,0
0,410,410,6,3,3,2,1
4,412,412,15,15,0,1,0
20,444,444,186,186,0,1,0
14,445,445,33,15,18,3,2
16,468,468,9,5,4,2,1
13,494,494,18,10,8,3,2
7,500,500,34,10,24,3,2

2,108,108,9,9,0,1,0
6,192,192,14,14,0,1,0
14,215,215,53,32,21,2,1
15,251,251,49,9,40,3,2
1,273,273,34,34,0,1,0
11,282,282,36,36,0,1,0
9,297,297,6,2,4,2,1
4,313,313,10,1,9,4,3
0,334,334,3,3,0,1,0
8,391,391,63,1,62,4,3
5,411,411,113,113,0,1,0
7,416,416,115,43,72,4,3
13,418,418,11,11,0,1,0
10,419,419,28,28,0,1,0
16,421,421,41,9,32,3,2
12,439,439,31,6,25,2,1
3,483,483,62,62,0,1,0

7,104,104,30,30,0,1,0
5,119,119,20,20,0,1,0
1,189,189,31,7,24,2,1
12,215,215,41,41,0,1,0
8,236,236,5,1,4,2,1
3,241,241,23,23,0,1,0
17,284,284,44,23,21,2,1
14,308,308,43,43,0,1,0
16,348,348,26,18,8,3,2
4,383,383,20,20,0,1,0
11,404,404,28,9,19,2,1
6,408,408,46,19,27,4,3
0,412,412,20,20,0,1,0
9,417,417,52,52,0,1,0
2,420,420,21,1,20,3,2
10,424,424,90,69,21,4,3
15,480,480,16,16,0,1,0
13,481,481,7,3,4,2,1

8,106,106,1,1,0,1,0
2,138,138,14,5,9,4,3
16,232,232,69,69,0,1,0
14,252,252,7,7,0,1,0
21,259,259,10,10,0,1,0
5,289,289,25,25,0,1,0
11,289,289,12,12,0,1,0
18,307,307,74,4,70,3,2
4,335,335,6,6,0,1,0
3,336,336,20,15,5,2,1
6,357,357,44,20,24,2,1
0,404,404,33,2,31,2,1
13,417,417,4,4,0,1,0
19,421,421,80,54,26,2,1
1,438,438,17,4,13,2,1
20,445,445,14,14,0,1,0
7,454,454,17,17,0,1,0
10,464,464,20,3,17,2,1
12,465,465,19,19,0,1,0
9,486,486,155,126,29,2,1
17,487,487,24,5,19,2,1
15,488,488,63,35,28,2,1

17,117,117,8,8,0,1,0
2,148,148,5,5,0,1,0
22,213,213,17,17,0,1,0
10,218,218,1,1,0,1,0
1,228,228,17,17,0,1,0
21,231,231,24,24,0,1,0
19,233,233,23,23,0,1,0
18,237,237,44,13,31,2,1
3,247,247,38,6,32,2,1
14,268,268,73,26,47,2,1
20,276,276,53,53,0,1,0
12,280,280,9,9,0,1,0
6,287,287,35,35,0,1,0
0,327,327,36,27,9,2,1
15,334,334,2,2,0,1,0
9,344,344,33,4,29,2,1
8,344,344,6,6,0,1,0
4,349,349,4,4,0,1,0
13,357,357,40,4,36,2,1
7,361,361,66,66,0,1,0
11,397,397,14,14,0,1,0
5,479,479,7,7,0,1,0
16,498,498,4,4,0,1,0

9,107,107,6,6,0,1,0
7,108,108,2,2,0,1,0
14,126,126,40,40,0,1,0
2,128,128,28,28,0,1,0
17,135,135,16,3,13,2,1
12,149,149,15,1,14,4,3
10,183,183,2,2,0,1,0
5,207,207,12,3,9,4,3
0,214,214,6,6,0,1,0
11,260,260,11,11,0,1,0
16,263,263,22,22,0,1,0
6,269,269,38,33,5,2,1
15,294,294,16,16,0,1,0
1,350,350,135,28,107,4,3
4,398,398,28,28,0,1,0
3,405,405,18,4,14,3,2
13,449,449,107,21,86,4,3
8,480,480,17,12,5,2,1

6,101,101,8,8,0,1,0
12,103,103,10,7,3,2,1
2,109,109,24,24,0,1,0
14,140,140,8,2,6,2,1
5,141,141,18,18,0,1,0
10,163,163,3,3,0,1,0
4,164,164,19,19,0,1,0
13,185,185,24,11,13,4,3
7,206,206,29,3,26,2,1
17,225,225,10,10,0,1,0
18,226,226,44,44,0,1,0
16,229,229,4,4,0,1,0
19,286,286,42,42,0,1,0
15,329,329,49,49,0,1,0
8,334,334,62,62,0,1,0
0,334,334,1,1,0,1,0
1,400,400,17,17,0,1,0
3,464,464,27,13,14,3,2
11,466,466,83,32,51,4,3
9,469,469,6,6,0,1,0

9,106,106,2,2,0,1,0
6,141,141,5,5,0,1,0
19,153,153,2,2,0,1,0
10,186,186,15,15,0,1,0
20,188,188,34,34,0,1,0
7,188,188,9,9,0,1,0
16,252,252,1,1,0,1,0
12,258,258,1,1,0,1,0
2,258,258,11,1,10,3,2
17,261,261,80,80,0,1,0
18,277,277,96,50,46,3,2
0,280,280,25,5,20,4,3
4,314,314,14,14,0,1,0
15,331,331,12,7,5,2,1
13,350,350,29,29,0,1,0
1,359,359,15,15,0,1,0
11,369,369,34,13,21,4,3
8,432,432,28,8,20,3,2
5,484,484,68,27,41,4,3
3,497,497,151,105,46,4,3
14,498,498,20,7,13,3,2

5,119,119,1,1,0,1,0
13,135,135,23,1,22,4,3
21,144,144,7,7,0,1,0
11,149,149,5,5,0,1,0
8,183,183,12,12,0,1,0
1,189,189,21,18,3,2,1
10,199,199,2,2,0,1,0
12,281,281,12,12,0,1,0
3,311,311,111,64,47,2,1
20,320,320,37,37,0,1,0
7,322,322,4,4,0,1,0
16,323,323,10,10,0,1,0
14,410,410,99,99,0,1,0
19,420,420,29,9,20,2,1
9,427,427,22,22,0,1,0
17,433,433,112,112,0,1,0
4,435,435,35,35,0,1,0
6,448,448,34,10,24,2,1
15,459,459,34,1,33,2,1
0,466,466,14,7,7,2,1
18,486,486,1,1,0,1,0
2,491,491,60,44,16,2,1

10,109,109,1,1,0,1,0
11,132,132,27,27,0,1,0
20,213,213,17,17,0,1,0
18,222,222,20,4,16,3,2
12,222,222,3,3,0,1,0
3,232,232,32,32,0,1,0
8,299,299,8,8,0,1,0
9,313,313,64,64,0,1,0
15,341,341,77,77,0,1,0
7,355,355,17,5,12,2,1
17,356,356,17,8,9,4,3
13,372,372,2,2,0,1,0
4,375,375,1,1,0,1,0
5,424,424,32,32,0,1,0
2,440,440,3,3,0,1,0
6,462,462,14,14,0,1,0
19,471,471,56,23,33,4,3
14,474,474,96,96,0,1,0
0,490,490,123,123,0,1,0
1,491,491,4,1,3,2,1
16,498,498,114,114,0,1,0

8,113,113,1,1,0,1,0
15,128,128,1,1,0,1,0
10,145,145,10,7,3,2,1
4,146,146,33,10,23,2,1
16,165,165,9,1,8,2,1
17,174,174,12,1,11,4,3
6,178,178,1,1,0,1,0
13,183,183,1,1,0,1,0
14,184,184,27,27,0,1,0
22,212,212,4,4,0,1,0
7,215,215,33,33,0,1,0
12,242,242,15,4,11,2,1
19,277,277,55,52,3,2,1
5,293,293,3,3,0,1,0
2,327,327,7,1,6,2,1
3,342,342,19,19,0,1,0
11,342,342,1,1,0,1,0
1,390,390,1,1,0,1,0
21,410,410,69,69,0,1,0
20,411,411,117,96,21,4,3
23,430,430,51,51,0,1,0
18,472,472,50,50,0,1,0
0,475,475,24,5,19,2,1
9,478,478,88,88,0,1,0

14,106,106,13,1,12,4,3
2,111,111,1,1,0,1,0
6,118,118,1,1,0,1,0
13,131,131,1,1,0,1,0
1,144,144,7,7,0,1,0
11,197,197,26,26,0,1,0
3,227,227,9,3,6,3,2
7,280,280,4,4,0,1,0
8,306,306,15,15,0,1,0
15,374,374,183,183,0,1,0
16,406,406,23,23,0,1,0
5,407,407,134,134,0,1,0
10,411,411,52,52,0,1,0
0,425,425,63,20,43,3,2
12,463,463,4,4,0,1,0
9,476,476,11,11,0,1,0
4,478,478,193,178,15,2,1

25,101,101,53,53,0,1,0
5,103,103,3,3,0,1,0
10,106,106,4,4,0,1,0
27,106,106,7,7,0,1,0
9,125,125,2,2,0,1,0
3,133,133,6,6,0,1,0
28,135,135,4,4,0,1,0
30,152,152,12,12,0,1,0
16,164,164,3,3,0,1,0
4,172,172,6,1,5,2,1
11,187,187,1,1,0,1,0
23,191,191,32,15,17,2,1
12,198,198,17,17,0,1,0
2,215,215,7,7,0,1,0
0,247,247,8,5,3,2,1
6,258,258,13,13,0,1,0
1,258,258,8,8,0,1,0
15,264,264,34,19,15,2,1
7,283,283,11,2,9,2,1
13,302,302,14,1,13,2,1
18,310,310,16,1,15,2,1
14,326,326,3,3,0,1,0
20,347,347,51,11,40,3,2
19,357,357,14,11,3,2,1
22,375,375,2,2,0,1,0
21,378,378,40,40,0,1,0
26,382,382,23,4,19,3,2
24,383,383,21,21,0,1,0
29,417,417,18,18,0,1,0
8,454,454,3,3,0,1,0
17,463,463,4,4,0,1,0

0,100,100,5,5,0,1,0
9,127,127,7,7,0,1,0
12,132,132,1,1,0,1,0
5,134,134,5,5,0,1,0
11,152,152,35,30,5,2,1
6,257,257,1,1,0,1,0
7,261,261,10,10,0,1,0
15,268,268,62,62,0,1,0
14,268,268,10,10,0,1,0
16,289,289,8,8,0,1,0
3,310,310,9,9,0,1,0
19,354,354,8,8,0,1,0
2,372,372,30,12,18,2,1
20,384,384,10,5,5,2,1
13,394,394,26,26,0,1,0
8,397,397,44,44,0,1,0
4,403,403,28,28,0,1,0
10,406,406,64,30,34,2,1
1,433,433,61,23,38,3,2
17,460,460,73,73,0,1,0
18,476,476,208,76,132,4,3

16,105,105,4,4,0,1,0
19,136,136,8,8,0,1,0
0,179,179,20,20,0,1,0
11,185,185,11,11,0,1,0
8,202,202,65,41,24,4,3
6,211,211,21,10,11,2,1
3,213,213,37,3,34,2,1
2,223,223,2,2,0,1,0
10,258,258,9,6,3,2,1
12,300,300,9,9,0,1,0
18,300,300,8,3,5,2,1
17,330,330,34,34,0,1,0
14,331,331,11,4,7,2,1
4,342,342,9,3,6,2,1
15,400,400,115,115,0,1,0
7,408,408,19,19,0,1,0
9,412,412,4,4,0,1,0
5,414,414,9,2,7,2,1
13,448,448,119,101,18,3,2
1,451,451,41,20,21,4,3
20,455,455,81,39,42,2,1

8,141,141,3,3,0,1,0
1,146,146,25,25,0,1,0
2,165,165,20,16,4,2,1
10,181,181,3,3,0,1,0
16,182,182,5,2,3,2,1
13,185,185,18,18,0,1,0
23,238,238,11,7,4,2,1
19,243,243,4,4,0,1,0
18,249,249,47,47,0,1,0
5,261,261,7,7,0,1,0
21,274,274,112,88,24,3,2
24,279,279,7,7,0,1,0
4,297,297,36,1,35,2,1
25,298,298,19,19,0,1,0
12,301,301,6,6,0,1,0
20,304,304,29,29,0,1,0
9,314,314,25,25,0,1,0
22,325,325,38,23,15,2,1
0,326,326,27,6,21,4,3
17,330,330,17,5,12,2,1
14,420,420,25,15,10,2,1
3,443,443,1,1,0,1,0
7,449,449,13,13,0,1,0
11,463,463,33,2,31,4,3
15,482,482,16,16,0,1,0
6,490,490,10,7,3,2,1

1,137,137,1,1,0,1,0
15,144,144,5,2,3,2,1
18,165,165,62,62,0,1,0
9,188,188,4,4,0,1,0
6,215,215,51,19,32,3,2
12,221,221,1,1,0,1,0
14,239,239,24,4,20,3,2
17,272,272,7,1,6,3,2
2,274,274,11,1,10,2,1
11,297,297,24,24,0,1,0
10,334,334,29,5,24,4,3
5,385,385,26,26,0,1,0
3,392,392,80,80,0,1,0
16,427,427,69,29,40,2,1
7,444,444,1,1,0,1,0
13,462,462,66,17,49,2,1
8,467,467,6,6,0,1,0
0,492,492,180,72,108,4,3
4,493,493,23,12,11,2,1

0,110,110,8,8,0,1,0
4,118,118,5,1,4,2,1
6,155,155,7,7,0,1,0
1,162,162,8,8,0,1,0
22,164,164,8,8,0,1,0
14,178,178,29,6,23,2,1
16,244,244,2,2,0,1,0
8,253,253,9,9,0,1,0
11,262,262,81,81,0,1,0
19,266,266,19,7,12,4,3
3,270,270,17,17,0,1,0
5,273,273,22,16,6,2,1
15,279,279,38,14,24,3,2
9,283,283,17,10,7,2,1
12,326,326,5,5,0,1,0
17,338,338,70,28,42,2,1
7,354,354,29,29,0,1,0
20,355,355,31,13,18,3,2
10,363,363,18,14,4,2,1
18,368,368,25,25,0,1,0
13,404,404,7,2,5,2,1
21,479,479,110,91,19,2,1
2,480,480,38,38,0,1,0

9,122,122,25,25,0,1,0
2,124,124,2,2,0,1,0
11,141,141,9,3,6,3,2
6,214,214,4,4,0,1,0
4,222,222,45,17,28,3,2
7,227,227,73,73,0,1,0
5,266,266,67,67,0,1,0
3,278,278,101,7,94,4,3
15,314,314,36,12,24,4,3
1,344,344,16,16,0,1,0
8,349,349,5,5,0,1,0
13,382,382,30,6,24,3,2
0,386,386,39,27,12,3,2
10,395,395,30,12,18,4,3
12,424,424,30,9,21,4,3
14,484,484,35,24,11,2,1

12,115,115,32,9,23,2,1
16,129,129,15,6,9,4,3
14,139,139,1,1,0,1,0
5,146,146,7,7,0,1,0
0,153,153,11,5,6,3,2
9,156,156,3,3,0,1,0
7,186,186,42,9,33,4,3
8,223,223,9,4,5,2,1
10,261,261,35,15,20,2,1
4,318,318,17,10,7,2,1
13,327,327,64,38,26,4,3
3,336,336,133,103,30,4,3
6,378,378,29,23,6,2,1
1,380,380,38,11,27,2,1
11,413,413,89,45,44,2,1
15,420,420,4,4,0,1,0
2,480,480,15,15,0,1,0

18,110,110,6,6,0,1,0
15,114,114,8,2,6,2,1
9,117,117,5,5,0,1,0
8,122,122,4,4,0,1,0
17,130,130,25,10,15,4,3
6,151,151,18,6,12,4,3
1,186,186,22,3,19,2,1
16,240,240,16,3,13,3,2
12,245,245,36,9,27,2,1
11,246,246,55,55,0,1,0
10,248,248,6,6,0,1,0
14,267,267,33,33,0,1,0
5,269,269,2,2,0,1,0
7,277,277,35,35,0,1,0
13,347,347,29,29,0,1,0
0,385,385,30,30,0,1,0
3,435,435,65,50,15,2,1
19,436,436,31,21,10,3,2
4,445,445,19,19,0,1,0
2,497,497,129,53,76,3,2

1,109,109,24,8,16,3,2
7,114,114,26,5,21,4,3
12,114,114,8,8,0,1,0
9,135,135,1,1,0,1,0
15,147,147,13,4,9,4,3
2,158,158,4,4,0,1,0
8,160,160,1,1,0,1,0
14,227,227,12,4,8,2,1
4,234,234,40,26,14,2,1
11,246,246,49,19,30,4,3
6,279,279,35,35,0,1,0
0,310,310,18,18,0,1,0
3,378,378,94,26,68,3,2
13,389,389,12,12,0,1,0
10,424,424,145,127,18,4,3
5,469,469,71,48,23,2,1

15,169,169,19,7,12,2,1
3,201,201,10,7,3,2,1
7,205,205,4,4,0,1,0
17,218,218,27,27,0,1,0
4,221,221,18,18,0,1,0
5,236,236,14,14,0,1,0
20,241,241,37,10,27,4,3
12,251,251,3,3,0,1,0
9,261,261,20,20,0,1,0
19,305,305,89,59,30,4,3
13,311,311,25,25,0,1,0
11,352,352,8,2,6,2,1
16,362,362,47,13,34,3,2
10,379,379,63,21,42,4,3
14,407,407,30,30,0,1,0
2,458,458,105,26,79,3,2
0,463,463,5,5,0,1,0
6,473,473,104,104,0,1,0
8,482,482,2,2,0,1,0
1,485,485,30,6,24,4,3
18,489,489,18,2,16,3,2

2,102,102,10,10,0,1,0
20,117,117,3,3,0,1,0
10,123,123,15,5,10,3,2
11,134,134,14,7,7,2,1
12,164,164,1,1,0,1,0
15,176,176,30,30,0,1,0
13,239,239,11,11,0,1,0
6,284,284,10,10,0,1,0
3,308,308,5,2,3,2,1
21,318,318,65,65,0,1,0
17,329,329,19,9,10,3,2
19,356,356,68,38,30,3,2
0,361,361,22,22,0,1,0
7,370,370,26,14,12,4,3
4,374,374,112,112,0,1,0
5,418,418,11,11,0,1,0
9,451,451,43,43,0,1,0
18,478,478,10,7,3,2,1
1,490,490,19,19,0,1,0
14,490,490,68,68,0,1,0
8,493,493,15,15,0,1,0
16,495,495,79,17,62,3,2

14,110,110,8,8,0,1,0
9,121,121,34,13,21,2,1
10,144,144,20,7,13,2,1
15,163,163,20,20,0,1,0
5,167,167,3,3,0,1,0
8,185,185,11,5,6,3,2
16,238,238,10,3,7,2,1
17,264,264,12,12,0,1,0
7,275,275,5,1,4,2,1
6,301,301,14,1,13,2,1
4,350,350,119,29,90,3,2
12,361,361,56,51,5,2,1
0,365,365,132,30,102,4,3
1,370,370,22,8,14,3,2
2,426,426,30,30,0,1,0
11,480,480,64,4,60,4,3
3,482,482,14,6,8,3,2
13,484,484,16,4,12,3,2

7,108,108,1,1,0,1,0
12,127,127,8,8,0,1,0
8,147,147,2,2,0,1,0
9,166,166,13,2,11,2,1
3,177,177,17,17,0,1,0
15,184,184,20,20,0,1,0
11,232,232,17,17,0,1,0
14,277,277,8,3,5,2,1
1,305,305,93,93,0,1,0
13,311,311,17,17,0,1,0
2,365,365,89,16,73,3,2
6,388,388,11,4,7,2,1
5,416,416,83,83,0,1,0
10,416,416,245,161,84,4,3
4,424,424,54,19,35,2,1
0,462,462,1,1,0,1,0

13,125,125,10,10,0,1,0
1,141,141,27,13,14,2,1
16,141,141,2,2,0,1,0
14,147,147,2,2,0,1,0
11,149,149,35,30,5,2,1
7,181,181,6,6,0,1,0
10,198,198,3,3,0,1,0
3,254,254,5,5,0,1,0
5,270,270,19,19,0,1,0
4,275,275,10,10,0,1,0
0,308,308,68,47,21,4,3
15,333,333,63,25,38,3,2
2,363,363,13,13,0,1,0
18,366,366,78,28,50,3,2
12,385,385,69,59,10,2,1
8,397,397,58,15,43,4,3
9,407,407,53,53,0,1,0
6,444,444,52,52,0,1,0
17,461,461,34,10,24,4,3

7,220,220,144,144,0,1,0
5,225,225,22,22,0,1,0
4,248,248,34,12,22,4,3
3,268,268,82,55,27,2,1
2,281,281,50,2,48,3,2
11,306,306,5,5,0,1,0
6,356,356,11,11,0,1,0
1,387,387,147,135,12,3,2
9,398,398,3,3,0,1,0
8,449,449,11,8,3,2,1
0,470,470,1,1,0,1,0
12,482,482,44,1,43,2,1
13,491,491,12,12,0,1,0
10,497,497,31,31,0,1,0

18,106,106,5,5,0,1,0
6,109,109,1,1,0,1,0
5,126,126,1,1,0,1,0
22,167,167,8,8,0,1,0
21,175,175,30,30,0,1,0
10,188,188,10,10,0,1,0
19,219,219,36,17,19,2,1
4,256,256,39,1,38,2,1
24,260,260,23,23,0,1,0
16,269,269,27,4,23,2,1
7,269,269,1,1,0,1,0
11,277,277,6,6,0,1,0
1,291,291,1,1,0,1,0
14,313,313,5,5,0,1,0
8,327,327,4,4,0,1,0
3,350,350,29,18,11,2,1
25,380,380,2,2,0,1,0
20,388,388,116,26,90,4,3
17,411,411,81,18,63,4,3
15,414,414,3,3,0,1,0
2,428,428,15,15,0,1,0
23,445,445,1,1,0,1,0
0,460,460,28,28,0,1,0
13,469,469,49,27,22,3,2
12,472,472,148,85,63,4,3
9,496,496,9,9,0,1,0

12,122,122,38,38,0,1,0
5,157,157,14,8,6,3,2
15,164,164,4,4,0,1,0
10,164,164,11,5,6,2,1
9,190,190,8,8,0,1,0
17,203,203,20,5,15,4,3
4,239,239,116,32,84,4,3
8,258,258,5,5,0,1,0
2,285,285,19,19,0,1,0
6,289,289,1,1,0,1,0
13,313,313,68,19,49,2,1
7,328,328,33,33,0,1,0
16,335,335,47,47,0,1,0
14,343,343,16,16,0,1,0
0,396,396,38,38,0,1,0
1,403,403,29,29,0,1,0
11,425,425,30,30,0,1,0
3,473,473,32,32,0,1,0

13,137,137,16,16,0,1,0
11,142,142,23,23,0,1,0
1,147,147,33,23,10,3,2
15,156,156,25,25,0,1,0
9,181,181,5,2,3,2,1
0,209,209,7,7,0,1,0
5,275,275,42,24,18,3,2
10,275,275,21,16,5,2,1
16,312,312,121,51,70,4,3
3,316,316,5,2,3,2,1
2,335,335,4,1,3,2,1
8,335,335,4,4,0,1,0
4,362,362,2,2,0,1,0
12,377,377,24,24,0,1,0
17,379,379,4,4,0,1,0
18,434,434,7,7,0,1,0
6,450,450,37,37,0,1,0
14,455,455,13,13,0,1,0
7,495,495,216,169,47,2,1

11,103,103,13,3,10,2,1
4,126,126,30,30,0,1,0
18,138,138,10,10,0,1,0
10,174,174,4,4,0,1,0
15,236,236,47,4,43,2,1
17,238,238,60,60,0,1,0
12,313,313,8,8,0,1,0
14,329,329,21,21,0,1,0
1,335,335,126,73,53,4,3
8,365,365,2,2,0,1,0
3,384,384,1,1,0,1,0
2,400,400,1,1,0,1,0
0,410,410,83,63,20,3,2
16,437,437,105,81,24,2,1
7,448,448,1,1,0,1,0
5,469,469,5,2,3,2,1
9,480,480,30,30,0,1,0
6,490,490,48,36,12,4,3
13,499,499,7,7,0,1,0

11,164,164,36,21,15,4,3
1,199,199,9,9,0,1,0
8,228,228,2,2,0,1,0
13,237,237,26,11,15,2,1
5,238,238,58,58,0,1,0
6,255,255,11,11,0,1,0
0,270,270,16,1,15,4,3
14,279,279,36,36,0,1,0
4,299,299,68,6,62,3,2
3,333,333,1,1,0,1,0
9,339,339,30,3,27,4,3
12,362,362,14,6,8,2,1
2,388,388,165,85,80,3,2
7,462,462,22,22,0,1,0
10,490,490,162,97,65,3,2

11,128,128,18,18,0,1,0
17,143,143,25,25,0,1,0
20,160,160,35,11,24,2,1
19,162,162,10,10,0,1,0
15,168,168,14,14,0,1,0
13,186,186,6,6,0,1,0
8,188,188,3,3,0,1,0
5,194,194,27,27,0,1,0
2,256,256,9,2,7,2,1
0,283,283,34,34,0,1,0
10,286,286,56,5,51,4,3
4,299,299,21,12,9,4,3
3,341,341,37,37,0,1,0
14,359,359,54,31,23,2,1
18,373,373,42,42,0,1,0
9,375,375,20,7,13,2,1
16,401,401,46,46,0,1,0
12,439,439,28,28,0,1,0
7,455,455,7,7,0,1,0
6,475,475,3,3,0,1,0
1,490,490,49,20,29,2,1

6,122,122,2,2,0,1,0
21,128,128,7,7,0,1,0
2,142,142,21,21,0,1,0
13,146,146,5,1,4,2,1
0,185,185,6,1,5,2,1
20,187,187,16,2,14,3,2
10,188,188,1,1,0,1,0
16,228,228,3,3,0,1,0
14,230,230,13,7,6,3,2
15,231,231,16,8,8,2,1
4,315,315,13,13,0,1,0
17,317,317,72,34,38,2,1
19,319,319,17,17,0,1,0
1,322,322,23,14,9,2,1
9,331,331,29,29,0,1,0
5,333,333,41,19,22,2,1
7,355,355,58,58,0,1,0
8,409,409,6,3,3,2,1
18,409,409,175,89,86,4,3
12,436,436,23,7,16,3,2
3,454,454,40,17,23,2,1
11,482,482,76,76,0,1,0

6,108,108,6,6,0,1,0
8,124,124,1,1,0,1,0
10,124,124,1,1,0,1,0
0,133,133,7,1,6,3,2
15,157,157,26,26,0,1,0
13,197,197,1,1,0,1,0
4,224,224,8,8,0,1,0
3,240,240,12,3,9,2,1
11,250,250,11,11,0,1,0
9,264,264,38,14,24,4,3
24,276,276,8,8,0,1,0
22,277,277,35,35,0,1,0
19,283,283,12,3,9,4,3
1,289,289,18,18,0,1,0
20,291,291,39,19,20,3,2
21,299,299,4,4,0,1,0
2,328,328,12,12,0,1,0
7,363,363,26,26,0,1,0
17,374,374,15,15,0,1,0
16,395,395,38,2,36,2,1
12,398,398,45,45,0,1,0
18,438,438,161,161,0,1,0
5,453,453,47,33,14,3,2
14,462,462,23,23,0,1,0
23,494,494,80,39,41,4,3

5,118,118,5,5,0,1,0
12,138,138,13,13,0,1,0
3,139,139,28,4,24,3,2
0,144,144,31,27,4,2,1
2,198,198,4,4,0,1,0
6,219,219,11,11,0,1,0
13,222,222,1,1,0,1,0
16,247,247,5,5,0,1,0
10,271,271,24,8,16,3,2
8,328,328,9,9,0,1,0
14,372,372,148,31,117,4,3
1,375,375,88,88,0,1,0
15,383,383,12,12,0,1,0
9,437,437,78,55,23,2,1
4,452,452,33,3,30,4,3
11,453,453,5,1,4,2,1
17,471,471,90,22,68,4,3
7,473,473,65,14,51,4,3

15,113,113,10,10,0,1,0
5,119,119,5,1,4,2,1
2,133,133,41,7,34,2,1
19,134,134,8,8,0,1,0
20,146,146,31,11,20,3,2
7,233,233,7,7,0,1,0
14,268,268,29,17,12,2,1
1,271,271,25,7,18,4,3
0,273,273,7,7,0,1,0
13,279,279,16,16,0,1,0
10,284,284,25,25,0,1,0
17,293,293,1,1,0,1,0
16,298,298,70,70,0,1,0
18,301,301,52,44,8,3,2
3,309,309,14,14,0,1,0
9,320,320,26,13,13,2,1
4,325,325,1,1,0,1,0
11,351,351,73,73,0,1,0
12,422,422,33,26,7,2,1
8,432,432,17,17,0,1,0
6,456,456,18,18,0,1,0

0,156,156,51,51,0,1,0
6,216,216,18,18,0,1,0
16,231,231,21,21,0,1,0
17,234,234,46,46,0,1,0
2,238,238,23,2,21,4,3
11,288,288,4,4,0,1,0
10,291,291,5,5,0,1,0
5,293,293,22,22,0,1,0
14,299,299,8,8,0,1,0
12,301,301,86,24,62,3,2
4,318,318,9,9,0,1,0
7,318,318,9,9,0,1,0
9,320,320,68,18,50,3,2
18,328,328,57,22,35,2,1
8,362,362,22,2,20,2,1
3,381,381,1,1,0,1,0
13,383,383,27,27,0,1,0
15,427,427,61,61,0,1,0
1,432,432,37,19,18,3,2

3,104,104,1,1,0,1,0
4,115,115,14,2,12,2,1
6,132,132,1,1,0,1,0
10,132,132,6,6,0,1,0
7,168,168,30,4,26,4,3
1,191,191,37,8,29,2,1
5,193,193,50,2,48,4,3
9,206,206,23,14,9,4,3
12,213,213,12,4,8,3,2
19,233,233,9,2,7,2,1
15,259,259,70,70,0,1,0
8,297,297,4,1,3,2,1
18,323,323,48,13,35,2,1
2,363,363,22,22,0,1,0
14,366,366,54,19,35,2,1
17,390,390,16,16,0,1,0
16,394,394,15,5,10,3,2
11,401,401,100,100,0,1,0
0,436,436,2,2,0,1,0
13,442,442,11,2,9,4,3

20,111,111,8,8,0,1,0
19,130,130,10,10,0,1,0
10,154,154,5,5,0,1,0
15,155,155,21,1,20,2,1
21,199,199,16,16,0,1,0
5,203,203,39,39,0,1,0
9,209,209,40,40,0,1,0
13,221,221,3,3,0,1,0
22,224,224,74,26,48,4,3
16,226,226,11,1,10,4,3
4,226,226,1,1,0,1,0
8,240,240,1,1,0,1,0
11,241,241,15,15,0,1,0
2,262,262,6,6,0,1,0
1,281,281,23,1,22,3,2
3,284,284,1,1,0,1,0
17,312,312,40,40,0,1,0
0,355,355,22,22,0,1,0
18,425,425,4,4,0,1,0
12,462,462,2,2,0,1,0
7,465,465,32,3,29,2,1
14,469,469,64,64,0,1,0
6,495,495,127,82,45,4,3

7,106,106,4,1,3,2,1
2,146,146,15,15,0,1,0
0,214,214,39,39,0,1,0
15,239,239,25,17,8,2,1
14,246,246,12,3,9,4,3
11,263,263,9,9,0,1,0
3,275,275,10,6,4,2,1
10,327,327,55,55,0,1,0
8,337,337,98,75,23,2,1
5,342,342,93,18,75,4,3
1,343,343,10,3,7,2,1
9,350,350,13,13,0,1,0
12,353,353,52,52,0,1,0
4,378,378,60,24,36,4,3
13,415,415,63,63,0,1,0
6,429,429,94,85,9,2,1

4,104,104,14,14,0,1,0
12,110,110,12,12,0,1,0
2,139,139,1,1,0,1,0
6,198,198,18,18,0,1,0
11,244,244,7,7,0,1,0
0,245,245,44,8,36,3,2
7,268,268,15,15,0,1,0
5,291,291,55,55,0,1,0
17,324,324,13,13,0,1,0
10,356,356,21,21,0,1,0
1,366,366,54,54,0,1,0
16,368,368,132,54,78,3,2
14,373,373,50,25,25,2,1
15,380,380,8,8,0,1,0
18,410,410,78,18,60,3,2
3,430,430,21,5,16,2,1
8,464,464,35,5,30,2,1
9,478,478,34,34,0,1,0
13,497,497,35,35,0,1,0

3,111,111,1,1,0,1,0
2,137,137,19,19,0,1,0
6,143,143,32,4,28,2,1
5,151,151,12,3,9,4,3
7,157,157,10,10,0,1,0
4,173,173,1,1,0,1,0
10,186,186,21,13,8,2,1
16,201,201,2,2,0,1,0
13,227,227,56,56,0,1,0
9,258,258,4,4,0,1,0
19,263,263,68,21,47,4,3
17,329,329,10,10,0,1,0
12,415,415,10,3,7,2,1
1,430,430,23,1,22,3,2
0,432,432,5,2,3,2,1
14,432,432,101,89,12,2,1
18,433,433,48,48,0,1,0
8,436,436,110,74,36,2,1
11,442,442,15,1,14,3,2
15,478,478,21,21,0,1,0
20,493,493,28,28,0,1,0

14,127,127,1,1,0,1,0
3,155,155,13,9,4,2,1
9,221,221,47,12,35,2,1
4,237,237,26,26,0,1,0
12,312,312,12,8,4,2,1
11,318,318,32,32,0,1,0
2,319,319,34,34,0,1,0
0,331,331,1,1,0,1,0
6,366,366,2,2,0,1,0
13,414,414,42,42,0,1,0
10,419,419,123,105,18,4,3
5,454,454,249,213,36,3,2
7,467,467,7,4,3,2,1
8,472,472,115,55,60,4,3
1,497,497,74,50,24,4,3

7,124,124,46,46,0,1,0
15,133,133,11,11,0,1,0
2,139,139,6,6,0,1,0
16,171,171,53,53,0,1,0
13,185,185,12,12,0,1,0
3,189,189,13,13,0,1,0
17,218,218,44,44,0,1,0
5,221,221,67,58,9,4,3
12,237,237,45,45,0,1,0
10,247,247,12,12,0,1,0
11,269,269,16,2,14,3,2
8,347,347,2,2,0,1,0
0,380,380,16,16,0,1,0
9,403,403,5,2,3,2,1
6,410,410,16,16,0,1,0
4,432,432,6,6,0,1,0
1,445,445,51,30,21,4,3
14,459,459,21,13,8,2,1

10,222,222,1,1,0,1,0
0,225,225,80,30,50,3,2
3,226,226,1,1,0,1,0
16,269,269,124,55,69,4,3
17,292,292,28,8,20,3,2
13,322,322,8,8,0,1,0
12,347,347,67,67,0,1,0
15,364,364,9,9,0,1,0
2,373,373,66,66,0,1,0
8,403,403,26,7,19,2,1
4,406,406,58,22,36,4,3
9,417,417,82,46,36,4,3
6,418,418,1,1,0,1,0
5,445,445,87,9,78,4,3
11,446,446,1,1,0,1,0
7,451,451,23,23,0,1,0
14,457,457,5,5,0,1,0
1,495,495,4,4,0,1,0

16,110,110,4,4,0,1,0
3,123,123,4,1,3,2,1
7,143,143,15,3,12,4,3
0,148,148,1,1,0,1,0
12,228,228,73,73,0,1,0
6,241,241,34,19,15,4,3
11,249,249,4,4,0,1,0
1,289,289,83,19,64,3,2
10,293,293,82,16,66,4,3
14,318,318,14,14,0,1,0
13,340,340,1,1,0,1,0
8,355,355,70,70,0,1,0
2,358,358,51,51,0,1,0
9,379,379,42,42,0,1,0
4,406,406,4,4,0,1,0
15,414,414,2,2,0,1,0
5,423,423,117,79,38,2,1

3,156,156,57,9,48,4,3
9,162,162,6,6,0,1,0
14,183,183,7,7,0,1,0
2,244,244,17,17,0,1,0
13,269,269,41,22,19,2,1
16,276,276,24,24,0,1,0
11,282,282,16,9,7,2,1
15,288,288,10,7,3,2,1
7,309,309,1,1,0,1,0
4,348,348,4,1,3,2,1
8,362,362,74,47,27,2,1
5,409,409,2,2,0,1,0
6,416,416,36,31,5,2,1
10,419,419,100,38,62,3,2
0,452,452,101,101,0,1,0
12,453,453,160,55,105,4,3
1,488,488,16,13,3,2,1
17,495,495,11,2,9,3,2

2,118,118,11,11,0,1,0
20,125,125,5,5,0,1,0
1,141,141,13,4,9,2,1
12,146,146,60,60,0,1,0
14,177,177,3,3,0,1,0
16,211,211,5,5,0,1,0
3,232,232,7,7,0,1,0
17,235,235,29,29,0,1,0
5,258,258,21,1,20,2,1
10,268,268,32,32,0,1,0
9,279,279,37,37,0,1,0
0,280,280,18,3,15,4,3
7,285,285,39,13,26,2,1
11,297,297,67,67,0,1,0
13,314,314,38,16,22,2,1
19,330,330,4,1,3,2,1
15,391,391,64,28,36,3,2
18,397,397,44,1,43,4,3
6,400,400,2,2,0,1,0
8,438,438,6,1,5,2,1
4,454,454,3,3,0,1,0

6,111,111,3,3,0,1,0
15,140,140,34,19,15,2,1
1,177,177,7,7,0,1,0
7,219,219,19,2,17,2,1
12,229,229,38,38,0,1,0
3,255,255,71,37,34,4,3
4,263,263,95,95,0,1,0
8,265,265,5,5,0,1,0
9,300,300,15,15,0,1,0
0,308,308,1,1,0,1,0
10,311,311,22,22,0,1,0
2,349,349,3,3,0,1,0
13,410,410,42,12,30,2,1
11,413,413,13,13,0,1,0
14,445,445,110,20,90,4,3
5,470,470,134,72,62,4,3

2,106,106,9,9,0,1,0
6,106,106,8,8,0,1,0
13,121,121,20,20,0,1,0
12,130,130,22,22,0,1,0
1,191,191,39,25,14,3,2
9,199,199,20,10,10,2,1
3,250,250,48,48,0,1,0
7,253,253,38,16,22,3,2
0,264,264,35,20,15,2,1
8,266,266,4,4,0,1,0
14,284,284,39,39,0,1,0
11,339,339,40,40,0,1,0
10,370,370,34,34,0,1,0
4,425,425,98,74,24,4,3
5,459,459,72,72,0,1,0

23,109,109,23,23,0,1,0
18,116,116,2,2,0,1,0
13,143,143,1,1,0,1,0
11,145,145,1,1,0,1,0
15,147,147,3,3,0,1,0
12,181,181,5,5,0,1,0
8,190,190,50,2,48,2,1
14,201,201,15,15,0,1,0
3,227,227,3,3,0,1,0
10,255,255,32,32,0,1,0
16,294,294,96,58,38,2,1
6,307,307,6,6,0,1,0
20,314,314,21,21,0,1,0
7,331,331,4,4,0,1,0
5,338,338,11,11,0,1,0
2,347,347,4,4,0,1,0
0,348,348,25,25,0,1,0
1,367,367,18,5,13,2,1
9,370,370,81,61,20,2,1
17,382,382,72,4,68,3,2
19,400,400,3,3,0,1,0
22,403,403,73,73,0,1,0
4,447,447,30,30,0,1,0
21,449,449,1,1,0,1,0

21,130,130,5,5,0,1,0
13,139,139,31,5,26,3,2
11,152,152,2,2,0,1,0
9,152,152,15,15,0,1,0
8,165,165,2,2,0,1,0
6,166,166,4,1,3,2,1
23,180,180,2,2,0,1,0
7,188,188,5,5,0,1,0
19,189,189,5,5,0,1,0
16,220,220,2,2,0,1,0
5,232,232,10,10,0,1,0
15,251,251,1,1,0,1,0
22,255,255,39,26,13,2,1
25,265,265,92,76,16,3,2
1,288,288,24,4,20,2,1
17,294,294,17,1,16,3,2
24,297,297,96,57,39,4,3
14,328,328,27,27,0,1,0
10,356,356,10,10,0,1,0
27,363,363,8,8,0,1,0
0,375,375,6,6,0,1,0
18,400,400,5,1,4,2,1
3,407,407,1,1,0,1,0
12,414,414,44,44,0,1,0
2,429,429,30,20,10,2,1
4,436,436,39,39,0,1,0
20,444,444,2,2,0,1,0
26,461,461,46,46,0,1,0

11,125,125,11,1,10,3,2
10,157,157,22,22,0,1,0
2,158,158,11,11,0,1,0
6,160,160,1,1,0,1,0
13,206,206,3,3,0,1,0
18,220,220,2,2,0,1,0
5,255,255,11,11,0,1,0
12,257,257,35,22,13,2,1
17,277,277,20,20,0,1,0
0,350,350,59,8,51,4,3
1,352,352,15,15,0,1,0
9,411,411,55,8,47,4,3
8,414,414,23,18,5,2,1
4,419,419,29,29,0,1,0
3,428,428,156,134,22,2,1
14,489,489,165,27,138,4,3
7,490,490,23,9,14,3,2
16,491,491,36,24,12,4,3
15,500,500,71,33,38,4,3

5,102,102,24,24,0,1,0
10,112,112,12,5,7,2,1
6,120,120,1,1,0,1,0
4,131,131,1,1,0,1,0
8,159,159,5,2,3,2,1
15,175,175,33,33,0,1,0
7,191,191,27,18,9,2,1
9,210,210,23,23,0,1,0
12,261,261,3,3,0,1,0
0,263,263,48,48,0,1,0
3,276,276,40,21,19,2,1
2,306,306,22,22,0,1,0
16,406,406,34,28,6,2,1
13,443,443,88,16,72,3,2
18,444,444,2,2,0,1,0
11,458,458,48,10,38,2,1
17,472,472,81,32,49,2,1
1,478,478,34,26,8,3,2
14,495,495,74,74,0,1,0

3,120,120,9,9,0,1,0
16,177,177,20,20,0,1,0
8,193,193,42,42,0,1,0
11,193,193,20,20,0,1,0
2,200,200,3,3,0,1,0
4,218,218,8,3,5,2,1
7,239,239,2,2,0,1,0
1,295,295,27,27,0,1,0
12,300,300,3,3,0,1,0
15,313,313,22,22,0,1,0
5,342,342,12,5,7,2,1
14,354,354,47,17,30,4,3
17,360,360,8,8,0,1,0
19,367,367,51,23,28,2,1
6,369,369,25,22,3,2,1
18,387,387,31,1,30,4,3
13,433,433,71,71,0,1,0
9,476,476,94,94,0,1,0
10,484,484,23,23,0,1,0
0,485,485,53,53,0,1,0
20,500,500,140,75,65,4,3

1,120,120,1,1,0,1,0
6,130,130,17,17,0,1,0
8,169,169,7,3,4,2,1
11,204,204,12,3,9,2,1
0,211,211,14,14,0,1,0
14,214,214,20,14,6,2,1
13,263,263,70,70,0,1,0
17,283,283,27,27,0,1,0
16,324,324,51,51,0,1,0
4,331,331,29,6,23,2,1
3,379,379,163,55,108,4,3
2,395,395,46,35,11,2,1
5,414,414,49,49,0,1,0
12,423,423,91,91,0,1,0
15,431,431,19,10,9,2,1
7,444,444,1,1,0,1,0
9,461,461,11,3,8,2,1
10,464,464,28,8,20,4,3

6,110,110,9,9,0,1,0
2,145,145,22,1,21,4,3
9,147,147,20,15,5,2,1
12,152,152,12,12,0,1,0
0,158,158,15,15,0,1,0
10,196,196,45,27,18,3,2
19,210,210,2,2,0,1,0
7,218,218,5,5,0,1,0
4,243,243,14,11,3,2,1
15,251,251,79,79,0,1,0
11,254,254,12,4,8,2,1
16,258,258,2,2,0,1,0
17,283,283,113,101,12,3,2
1,284,284,16,16,0,1,0
14,295,295,15,11,4,2,1
20,308,308,22,22,0,1,0
18,309,309,13,4,9,4,3
5,367,367,16,16,0,1,0
8,406,406,25,25,0,1,0
13,424,424,17,17,0,1,0
3,430,430,8,4,4,2,1

22,104,104,63,24,39,4,3
1,106,106,9,9,0,1,0
16,124,124,2,2,0,1,0
10,154,154,11,11,0,1,0
23,158,158,1,1,0,1,0
8,182,182,20,3,17,2,1
18,185,185,28,23,5,2,1
17,195,195,6,6,0,1,0
3,220,220,1,1,0,1,0
2,229,229,18,18,0,1,0
0,231,231,43,43,0,1,0
7,251,251,6,6,0,1,0
6,297,297,1,1,0,1,0
5,298,298,14,3,11,2,1
12,382,382,59,7,52,3,2
20,395,395,34,10,24,3,2
13,410,410,33,33,0,1,0
9,410,410,2,2,0,1,0
15,411,411,6,3,3,2,1
14,448,448,33,4,29,2,1
11,452,452,17,17,0,1,0
4,458,458,18,3,15,2,1
19,461,461,23,23,0,1,0
21,473,473,27,5,22,3,2

4,120,120,28,28,0,1,0
7,128,128,1,1,0,1,0
11,150,150,8,8,0,1,0
15,166,166,61,61,0,1,0
17,170,170,6,6,0,1,0
18,178,178,11,3,8,3,2
9,183,183,52,52,0,1,0
14,185,185,7,7,0,1,0
0,190,190,4,4,0,1,0
3,195,195,1,1,0,1,0
5,312,312,8,8,0,1,0
10,326,326,15,15,0,1,0
8,330,330,24,8,16,2,1
16,340,340,17,17,0,1,0
1,353,353,69,59,10,2,1
19,376,376,75,67,8,3,2
13,403,403,80,80,0,1,0
6,436,436,33,24,9,4,3
2,474,474,17,17,0,1,0
12,493,493,9,9,0,1,0

6,124,124,3,3,0,1,0
7,131,131,2,2,0,1,0
10,136,136,22,22,0,1,0
4,175,175,3,3,0,1,0
11,185,185,1,1,0,1,0
16,185,185,10,2,8,2,1
3,242,242,52,52,0,1,0
9,243,243,8,3,5,2,1
2,259,259,42,42,0,1,0
1,268,268,8,5,3,2,1
17,291,291,48,41,7,2,1
5,296,296,92,4,88,3,2
14,300,300,33,33,0,1,0
18,307,307,75,51,24,2,1
0,383,383,5,5,0,1,0
8,383,383,5,1,4,2,1
15,424,424,4,4,0,1,0
12,451,451,10,10,0,1,0
13,460,460,118,100,18,4,3
20,494,494,20,14,6,3,2
19,498,498,56,56,0,1,0

1,117,117,18,18,0,1,0
4,131,131,40,8,32,2,1
10,196,196,1,1,0,1,0
6,250,250,31,13,18,4,3
5,264,264,58,9,49,2,1
2,280,280,10,1,9,2,1
0,294,294,59,59,0,1,0
13,297,297,6,6,0,1,0
3,307,307,95,44,51,4,3
11,318,318,52,27,25,2,1
12,337,337,13,5,8,2,1
8,346,346,60,28,32,3,2
7,403,403,57,15,42,4,3
9,404,404,54,42,12,4,3

8,162,162,30,30,0,1,0
11,175,175,10,10,0,1,0
4,189,189,41,15,26,3,2
5,198,198,11,2,9,3,2
6,230,230,20,20,0,1,0
7,231,231,5,5,0,1,0
1,241,241,17,12,5,2,1
18,264,264,72,66,6,3,2
16,322,322,17,17,0,1,0
13,340,340,28,28,0,1,0
10,340,340,25,25,0,1,0
15,350,350,44,44,0,1,0
17,377,377,42,42,0,1,0
9,385,385,19,11,8,3,2
12,387,387,5,5,0,1,0
0,416,416,51,51,0,1,0
2,460,460,1,1,0,1,0
19,463,463,109,7,102,4,3
3,468,468,55,48,7,2,1
14,495,495,34,34,0,1,0

2,185,185,8,8,0,1,0
1,216,216,75,33,42,4,3
10,228,228,9,9,0,1,0
16,264,264,74,74,0,1,0
7,277,277,10,10,0,1,0
6,280,280,27,27,0,1,0
3,286,286,70,70,0,1,0
5,337,337,21,9,12,4,3
15,364,364,28,28,0,1,0
4,376,376,21,6,15,2,1
11,385,385,15,15,0,1,0
0,398,398,46,4,42,3,2
13,414,414,8,8,0,1,0
8,434,434,8,2,6,2,1
12,456,456,86,5,81,4,3
14,473,473,70,13,57,4,3
9,496,496,100,76,24,4,3

11,102,102,17,17,0,1,0
6,150,150,1,1,0,1,0
10,166,166,34,2,32,2,1
4,173,173,48,13,35,2,1
2,182,182,58,58,0,1,0
8,189,189,12,12,0,1,0
3,243,243,9,9,0,1,0
16,271,271,22,22,0,1,0
15,273,273,9,9,0,1,0
14,282,282,40,22,18,3,2
13,304,304,44,7,37,2,1
7,321,321,4,4,0,1,0
5,348,348,37,29,8,2,1
0,352,352,61,27,34,4,3
1,392,392,2,2,0,1,0
9,436,436,14,6,8,3,2
12,464,464,76,52,24,4,3
17,477,477,26,26,0,1,0

12,142,142,6,6,0,1,0
13,145,145,7,7,0,1,0
3,156,156,3,3,0,1,0
0,161,161,11,11,0,1,0
27,196,196,52,49,3,2,1
9,206,206,26,26,0,1,0
24,209,209,20,1,19,2,1
14,210,210,1,1,0,1,0
6,212,212,35,15,20,3,2
5,217,217,5,1,4,2,1
26,274,274,2,2,0,1,0
10,277,277,22,8,14,2,1
19,286,286,7,7,0,1,0
18,325,325,13,13,0,1,0
2,336,336,41,10,31,2,1
7,342,342,1,1,0,1,0
23,347,347,34,34,0,1,0
8,365,365,1,1,0,1,0
4,367,367,2,2,0,1,0
17,382,382,17,17,0,1,0
20,391,391,8,3,5,2,1
1,414,414,12,12,0,1,0
25,430,430,26,6,20,2,1
21,431,431,128,128,0,1,0
22,470,470,68,68,0,1,0
15,480,480,17,17,0,1,0
16,483,483,43,34,9,2,1
11,492,492,27,27,0,1,0

2,156,156,7,3,4,2,1
7,173,173,12,4,8,3,2
5,174,174,31,16,15,4,3
11,174,174,16,4,12,4,3
14,200,200,13,13,0,1,0
0,202,202,78,26,52,3,2
10,203,203,13,2,11,2,1
8,237,237,17,17,0,1,0
9,272,272,40,40,0,1,0
1,277,277,80,80,0,1,0
12,316,316,93,16,77,4,3
3,363,363,1,1,0,1,0
6,376,376,78,6,72,4,3
13,449,449,3,3,0,1,0
4,489,489,50,40,10,2,1

14,142,142,1,1,0,1,0
23,212,212,18,18,0,1,0
1,219,219,13,13,0,1,0
9,230,230,7,7,0,1,0
12,259,259,8,8,0,1,0
17,305,305,46,46,0,1,0
11,310,310,6,6,0,1,0
16,312,312,10,10,0,1,0
8,359,359,10,10,0,1,0
20,361,361,93,36,57,4,3
5,381,381,65,65,0,1,0
22,383,383,20,20,0,1,0
21,385,385,1,1,0,1,0
24,390,390,21,21,0,1,0
19,391,391,37,3,34,3,2
13,391,391,36,36,0,1,0
10,401,401,2,2,0,1,0
7,418,418,50,21,29,3,2
18,441,441,125,107,18,2,1
4,442,442,63,63,0,1,0
15,447,447,25,25,0,1,0
3,448,448,39,12,27,4,3
2,470,470,29,3,26,3,2
0,485,485,43,2,41,2,1
6,493,493,1,1,0,1,0

17,100,100,5,5,0,1,0
24,117,117,12,12,0,1,0
9,142,142,3,3,0,1,0
5,144,144,6,6,0,1,0
23,158,158,39,29,10,3,2
8,173,173,42,20,22,3,2
10,186,186,8,1,7,2,1
7,195,195,10,10,0,1,0
6,206,206,1,1,0,1,0
18,285,285,41,41,0,1,0
4,287,287,47,47,0,1,0
1,302,302,9,9,0,1,0
15,305,305,12,12,0,1,0
0,306,306,3,3,0,1,0
21,313,313,2,2,0,1,0
19,364,364,5,5,0,1,0
11,377,377,17,11,6,2,1
12,378,378,44,44,0,1,0
3,387,387,38,27,11,2,1
22,399,399,5,5,0,1,0
14,437,437,3,3,0,1,0
16,468,468,113,105,8,2,1
13,480,480,24,24,0,1,0
20,496,496,100,31,69,4,3
2,500,500,19,19,0,1,0

11,105,105,2,2,0,1,0
18,135,135,34,13,21,3,2
4,165,165,39,39,0,1,0
17,169,169,17,14,3,2,1
2,201,201,2,2,0,1,0
14,237,237,23,2,21,2,1
1,289,289,4,4,0,1,0
0,292,292,28,28,0,1,0
9,334,334,40,8,32,3,2
13,352,352,1,1,0,1,0
10,365,365,23,23,0,1,0
12,382,382,3,3,0,1,0
15,394,394,30,30,0,1,0
19,400,400,126,107,19,2,1
6,403,403,6,2,4,2,1
8,468,468,12,12,0,1,0
7,468,468,94,94,0,1,0
16,483,483,71,33,38,2,1
3,493,493,39,3,36,2,1
5,496,496,71,71,0,1,0

18,105,105,4,4,0,1,0
16,129,129,2,2,0,1,0
4,129,129,17,3,14,2,1
2,135,135,11,11,0,1,0
13,157,157,3,3,0,1,0
1,170,170,28,28,0,1,0
8,192,192,2,2,0,1,0
7,196,196,9,9,0,1,0
0,197,197,16,5,11,2,1
15,197,197,23,10,13,2,1
5,250,250,47,20,27,2,1
3,269,269,36,14,22,3,2
17,296,296,67,67,0,1,0
11,315,315,87,69,18,2,1
6,319,319,19,19,0,1,0
14,364,364,92,60,32,2,1
19,365,365,24,24,0,1,0
9,391,391,12,12,0,1,0
10,489,489,36,36,0,1,0
12,500,500,2,2,0,1,0

3,138,138,43,28,15,4,3
12,146,146,4,4,0,1,0
2,186,186,6,6,0,1,0
16,190,190,16,16,0,1,0
9,203,203,3,3,0,1,0
7,206,206,42,20,22,3,2
6,233,233,15,15,0,1,0
13,250,250,18,18,0,1,0
5,265,265,6,2,4,2,1
17,284,284,51,11,40,3,2
15,299,299,10,3,7,2,1
20,301,301,9,9,0,1,0
23,320,320,170,39,131,4,3
11,341,341,16,16,0,1,0
1,393,393,5,5,0,1,0
8,398,398,1,1,0,1,0
10,430,430,20,10,10,3,2
4,438,438,31,31,0,1,0
14,453,453,13,2,11,2,1
22,454,454,2,2,0,1,0
18,461,461,24,24,0,1,0
0,465,465,20,20,0,1,0
19,478,478,42,42,0,1,0
21,484,484,5,5,0,1,0

10,117,117,4,4,0,1,0
3,124,124,1,1,0,1,0
7,124,124,9,1,8,2,1
16,127,127,11,5,6,2,1
12,140,140,18,9,9,4,3
8,167,167,14,14,0,1,0
4,184,184,20,20,0,1,0
2,260,260,11,11,0,1,0
13,274,274,15,15,0,1,0
5,292,292,11,11,0,1,0
15,301,301,3,3,0,1,0
9,324,324,4,4,0,1,0
11,332,332,97,97,0,1,0
17,344,344,78,78,0,1,0
18,390,390,10,10,0,1,0
6,399,399,107,78,29,2,1
0,402,402,4,4,0,1,0
19,444,444,41,41,0,1,0
1,450,450,14,10,4,2,1
20,475,475,48,10,38,3,2
14,480,480,141,102,39,4,3

1,102,102,10,10,0,1,0
17,128,128,12,12,0,1,0
12,135,135,6,6,0,1,0
16,141,141,5,5,0,1,0
21,151,151,6,6,0,1,0
11,189,189,11,11,0,1,0
18,197,197,22,22,0,1,0
2,212,212,4,4,0,1,0
3,214,214,10,10,0,1,0
8,228,228,4,4,0,1,0
22,247,247,125,37,88,4,3
9,251,251,16,3,13,2,1
23,260,260,19,19,0,1,0
7,287,287,3,3,0,1,0
14,294,294,9,4,5,2,1
15,323,323,43,43,0,1,0
0,330,330,9,9,0,1,0
4,332,332,13,13,0,1,0
10,352,352,146,2,144,4,3
20,370,370,1,1,0,1,0
19,373,373,11,3,8,2,1
5,450,450,8,8,0,1,0
13,477,477,25,3,22,2,1
6,500,500,31,14,17,2,1

12,108,108,3,3,0,1,0
5,127,127,7,7,0,1,0
0,141,141,46,34,12,3,2
2,156,156,20,20,0,1,0
11,156,156,3,3,0,1,0
13,167,167,5,5,0,1,0
20,171,171,7,1,6,3,2
18,216,216,31,16,15,4,3
6,281,281,10,2,8,2,1
1,320,320,10,10,0,1,0
8,358,358,5,2,3,2,1
9,373,373,73,39,34,2,1
10,393,393,41,41,0,1,0
16,399,399,5,5,0,1,0
4,410,410,11,11,0,1,0
14,411,411,69,20,49,2,1
7,422,422,10,10,0,1,0
15,426,426,17,9,8,3,2
17,431,431,111,24,87,4,3
19,432,432,128,32,96,4,3
3,448,448,18,12,6,3,2

8,133,133,29,29,0,1,0
6,139,139,10,10,0,1,0
10,139,139,16,8,8,2,1
12,155,155,18,18,0,1,0
3,158,158,3,3,0,1,0
5,194,194,50,50,0,1,0
14,215,215,40,40,0,1,0
1,233,233,97,67,30,2,1
9,255,255,15,1,14,2,1
0,280,280,35,35,0,1,0
11,314,314,6,1,5,2,1
4,335,335,16,1,15,2,1
7,341,341,32,32,0,1,0
13,371,371,49,28,21,4,3
15,430,430,33,23,10,2,1
2,477,477,33,16,17,2,1

0,138,138,54,3,51,4,3
8,155,155,11,11,0,1,0
16,172,172,7,7,0,1,0
13,173,173,18,18,0,1,0
14,183,183,29,12,17,2,1
1,240,240,47,8,39,3,2
5,289,289,35,8,27,2,1
12,320,320,34,21,13,2,1
17,322,322,65,65,0,1,0
9,322,322,21,13,8,3,2
18,325,325,48,36,12,4,3
10,380,380,35,13,22,2,1
15,414,414,55,39,16,2,1
4,426,426,2,2,0,1,0
7,427,427,35,35,0,1,0
2,451,451,1,1,0,1,0
3,459,459,17,17,0,1,0
6,465,465,15,15,0,1,0
11,483,483,15,15,0,1,0

1,117,117,16,16,0,1,0
9,167,167,1,1,0,1,0
3,188,188,5,5,0,1,0
11,198,198,5,2,3,2,1
14,201,201,38,12,26,3,2
2,207,207,22,22,0,1,0
13,251,251,8,8,0,1,0
5,255,255,53,53,0,1,0
6,255,255,49,49,0,1,0
10,264,264,30,15,15,2,1
4,358,358,49,35,14,2,1
15,360,360,133,94,39,4,3
8,423,423,109,61,48,2,1
0,432,432,84,51,33,2,1
7,456,456,9,6,3,2,1
12,488,488,4,4,0,1,0

12,108,108,14,4,10,2,1
10,136,136,10,10,0,1,0
19,146,146,29,17,12,4,3
14,156,156,6,6,0,1,0
15,161,161,6,6,0,1,0
2,166,166,2,2,0,1,0
7,197,197,2,2,0,1,0
8,223,223,22,10,12,2,1
20,223,223,14,1,13,2,1
6,240,240,1,1,0,1,0
4,241,241,43,43,0,1,0
18,241,241,58,58,0,1,0
5,248,248,22,22,0,1,0
22,270,270,5,5,0,1,0
3,273,273,11,11,0,1,0
16,290,290,34,34,0,1,0
21,299,299,14,1,13,3,2
0,314,314,17,8,9,4,3
11,340,340,51,7,44,3,2
13,358,358,4,4,0,1,0
9,365,365,12,12,0,1,0
17,375,375,21,16,5,2,1
23,448,448,106,87,19,3,2
1,463,463,36,29,7,2,1

19,101,101,2,2,0,1,0
2,105,105,8,8,0,1,0
8,117,117,37,37,0,1,0
0,122,122,2,2,0,1,0
1,163,163,22,4,18,2,1
10,179,179,8,8,0,1,0
11,192,192,21,6,15,4,3
7,219,219,3,3,0,1,0
16,232,232,25,13,12,3,2
3,238,238,26,4,22,3,2
13,316,316,58,40,18,4,3
15,329,329,3,3,0,1,0
17,334,334,5,5,0,1,0
9,339,339,4,4,0,1,0
14,350,350,101,89,12,3,2
18,376,376,30,9,21,4,3
12,418,418,81,81,0,1,0
4,443,443,1,1,0,1,0
6,449,449,92,92,0,1,0
5,483,483,34,34,0,1,0

18,137,137,3,3,0,1,0
7,212,212,14,14,0,1,0
13,231,231,27,27,0,1,0
2,233,233,10,1,9,4,3
11,246,246,10,10,0,1,0
3,252,252,2,2,0,1,0
14,284,284,74,22,52,3,2
17,293,293,28,9,19,3,2
5,322,322,67,33,34,3,2
12,325,325,17,2,15,2,1
0,346,346,73,73,0,1,0
15,358,358,83,83,0,1,0
6,369,369,2,2,0,1,0
10,371,371,16,16,0,1,0
4,445,445,35,35,0,1,0
16,466,466,70,70,0,1,0
1,488,488,16,16,0,1,0
9,493,493,136,56,80,4,3
8,498,498,36,27,9,2,1

2,104,104,8,8,0,1,0
3,106,106,3,3,0,1,0
21,143,143,38,16,22,2,1
23,158,158,3,3,0,1,0
12,233,233,11,3,8,3,2
14,244,244,2,2,0,1,0
20,261,261,6,6,0,1,0
17,324,324,146,146,0,1,0
4,342,342,2,2,0,1,0
10,342,342,48,48,0,1,0
5,343,343,41,41,0,1,0
6,349,349,15,1,14,2,1
15,350,350,42,42,0,1,0
11,357,357,7,7,0,1,0
24,379,379,15,15,0,1,0
9,392,392,4,1,3,2,1
18,394,394,22,6,16,2,1
22,395,395,9,5,4,2,1
19,406,406,2,2,0,1,0
1,428,428,85,85,0,1,0
16,462,462,65,65,0,1,0
13,465,465,51,26,25,2,1
0,467,467,6,6,0,1,0
7,468,468,11,1,10,3,2
8,481,481,18,10,8,3,2

16,116,116,15,5,10,3,2
17,138,138,53,39,14,2,1
14,148,148,27,17,10,2,1
12,160,160,2,2,0,1,0
10,193,193,13,13,0,1,0
6,217,217,3,3,0,1,0
18,252,252,4,4,0,1,0
1,265,265,108,81,27,4,3
20,284,284,44,44,0,1,0
11,298,298,4,4,0,1,0
0,311,311,29,29,0,1,0
19,332,332,25,25,0,1,0
13,337,337,22,22,0,1,0
15,346,346,1,1,0,1,0
2,357,357,1,1,0,1,0
5,363,363,1,1,0,1,0
7,403,403,7,7,0,1,0
8,434,434,13,13,0,1,0
9,444,444,19,10,9,4,3
4,458,458,140,140,0,1,0
3,466,466,2,2,0,1,0

11,101,101,2,2,0,1,0
10,103,103,2,2,0,1,0
23,130,130,3,3,0,1,0
16,182,182,3,3,0,1,0
12,191,191,2,2,0,1,0
7,202,202,5,5,0,1,0
2,221,221,3,3,0,1,0
22,223,223,45,39,6,2,1
4,225,225,31,31,0,1,0
6,239,239,6,6,0,1,0
25,254,254,20,1,19,4,3
18,273,273,13,13,0,1,0
20,277,277,46,28,18,4,3
24,294,294,28,28,0,1,0
19,296,296,16,16,0,1,0
3,304,304,4,4,0,1,0
9,314,314,2,2,0,1,0
0,318,318,29,5,24,4,3
21,326,326,32,8,24,4,3
1,375,375,17,17,0,1,0
5,396,396,74,74,0,1,0
17,457,457,114,74,40,2,1
15,465,465,27,27,0,1,0
13,472,472,74,74,0,1,0
14,476,476,21,21,0,1,0
8,481,481,64,64,0,1,0

8,106,106,3,3,0,1,0
9,113,113,20,8,12,2,1
15,116,116,18,5,13,2,1
7,119,119,18,4,14,3,2
0,125,125,22,22,0,1,0
1,180,180,2,2,0,1,0
10,193,193,8,8,0,1,0
5,216,216,35,15,20,4,3
4,227,227,4,4,0,1,0
18,235,235,64,64,0,1,0
14,258,258,27,23,4,2,1
21,286,286,30,14,16,2,1
16,288,288,68,62,6,3,2
17,323,323,3,3,0,1,0
11,323,323,8,8,0,1,0
13,326,326,1,1,0,1,0
19,336,336,36,29,7,2,1
3,375,375,47,47,0,1,0
6,423,423,16,4,12,3,2
20,433,433,8,8,0,1,0
2,443,443,16,16,0,1,0
12,492,492,6,6,0,1,0

6,118,118,6,1,5,2,1
16,148,148,8,8,0,1,0
5,209,209,1,1,0,1,0
12,214,214,56,26,30,4,3
7,215,215,9,5,4,2,1
9,222,222,22,2,20,2,1
14,232,232,1,1,0,1,0
15,240,240,50,36,14,2,1
11,248,248,23,23,0,1,0
8,304,304,2,2,0,1,0
10,330,330,20,5,15,2,1
4,348,348,18,14,4,2,1
2,361,361,210,210,0,1,0
1,413,413,2,2,0,1,0
13,417,417,97,27,70,4,3
0,447,447,96,96,0,1,0
3,492,492,25,13,12,4,3

5,143,143,12,8,4,2,1
12,157,157,9,9,0,1,0
14,177,177,14,4,10,2,1
8,191,191,2,2,0,1,0
16,206,206,40,17,23,4,3
1,240,240,8,8,0,1,0
9,287,287,48,24,24,3,2
15,289,289,27,27,0,1,0
20,291,291,70,57,13,2,1
17,294,294,1,1,0,1,0
19,337,337,13,10,3,2,1
21,343,343,41,41,0,1,0
13,346,346,79,51,28,2,1
4,368,368,35,7,28,3,2
0,384,384,7,7,0,1,0
2,396,396,56,56,0,1,0
18,419,419,9,9,0,1,0
11,424,424,26,8,18,4,3
6,433,433,13,13,0,1,0
7,460,460,39,36,3,2,1
3,471,471,6,6,0,1,0
10,499,499,105,105,0,1,0

8,101,101,43,15,28,3,2
1,109,109,16,11,5,2,1
9,115,115,1,1,0,1,0
6,181,181,3,3,0,1,0
10,193,193,3,3,0,1,0
0,249,249,17,2,15,4,3
12,266,266,4,4,0,1,0
7,267,267,7,3,4,2,1
13,268,268,63,19,44,3,2
11,286,286,18,18,0,1,0
5,288,288,40,30,10,3,2
2,371,371,114,114,0,1,0
14,396,396,85,64,21,4,3
4,415,415,78,78,0,1,0
3,429,429,65,13,52,3,2

14,124,124,19,19,0,1,0
8,124,124,1,1,0,1,0
18,129,129,12,4,8,3,2
5,132,132,35,23,12,3,2
16,151,151,20,20,0,1,0
4,175,175,2,2,0,1,0
17,181,181,9,9,0,1,0
10,198,198,19,19,0,1,0
9,223,223,11,11,0,1,0
1,299,299,20,9,11,2,1
12,306,306,4,4,0,1,0
11,315,315,15,5,10,2,1
2,343,343,16,16,0,1,0
0,366,366,4,1,3,2,1
19,393,393,5,5,0,1,0
6,406,406,36,16,20,3,2
15,459,459,7,7,0,1,0
7,461,461,68,68,0,1,0
3,472,472,99,52,47,4,3
13,482,482,242,242,0,1,0

6,108,108,17,6,11,4,3
13,119,119,27,18,9,2,1
0,132,132,37,37,0,1,0
8,170,170,2,2,0,1,0
12,176,176,17,9,8,2,1
2,252,252,5,5,0,1,0
5,254,254,41,5,36,4,3
3,293,293,31,31,0,1,0
4,295,295,79,35,44,3,2
1,303,303,50,50,0,1,0
7,346,346,8,8,0,1,0
14,384,384,16,4,12,3,2
11,403,403,65,20,45,4,3
9,445,445,110,110,0,1,0
10,476,476,28,28,0,1,0

8,103,103,3,3,0,1,0
14,111,111,58,58,0,1,0
12,126,126,3,3,0,1,0
6,149,149,55,5,50,3,2
5,182,182,27,13,14,3,2
10,213,213,5,5,0,1,0
9,225,225,33,33,0,1,0
2,247,247,11,11,0,1,0
13,257,257,1,1,0,1,0
17,294,294,6,6,0,1,0
15,294,294,33,33,0,1,0
7,308,308,19,7,12,3,2
16,312,312,28,4,24,3,2
11,378,378,73,55,18,2,1
4,389,389,23,23,0,1,0
18,392,392,14,14,0,1,0
3,428,428,31,19,12,3,2
1,464,464,16,16,0,1,0
0,487,487,18,18,0,1,0

13,100,100,14,14,0,1,0
7,155,155,7,2,5,2,1
18,179,179,9,9,0,1,0
12,204,204,23,7,16,4,3
14,215,215,15,9,6,3,2
3,229,229,36,22,14,3,2
17,230,230,12,7,5,2,1
2,254,254,9,9,0,1,0
16,361,361,106,106,0,1,0
10,368,368,6,6,0,1,0
6,382,382,22,4,18,3,2
0,391,391,30,30,0,1,0
9,407,407,1,1,0,1,0
19,435,435,45,6,39,2,1
4,450,450,204,204,0,1,0
5,453,453,11,2,9,2,1
11,461,461,59,59,0,1,0
1,465,465,31,31,0,1,0
8,471,471,31,13,18,4,3
15,488,488,33,27,6,3,2

11,136,136,15,6,9,4,3
12,141,141,23,4,19,3,2
15,145,145,28,28,0,1,0
9,179,179,15,4,11,2,1
14,189,189,39,39,0,1,0
6,206,206,13,13,0,1,0
5,214,214,13,3,10,2,1
2,226,226,5,5,0,1,0
7,232,232,5,5,0,1,0
0,359,359,156,138,18,2,1
10,384,384,62,33,29,2,1
3,428,428,62,62,0,1,0
1,431,431,19,19,0,1,0
4,464,464,107,68,39,2,1
8,489,489,1,1,0,1,0
13,497,497,36,36,0,1,0

14,112,112,20,20,0,1,0
11,115,115,5,1,4,2,1
5,115,115,4,4,0,1,0
4,151,151,27,17,10,2,1
9,193,193,18,6,12,2,1
6,223,223,35,35,0,1,0
8,288,288,57,45,12,4,3
7,292,292,29,13,16,2,1
1,345,345,59,59,0,1,0
12,354,354,6,6,0,1,0
0,355,355,25,1,24,3,2
2,372,372,91,91,0,1,0
10,390,390,13,10,3,2,1
16,401,401,37,37,0,1,0
15,418,418,63,44,19,2,1
3,446,446,20,20,0,1,0
13,467,467,100,37,63,4,3

16,103,103,2,2,0,1,0
1,106,106,6,6,0,1,0
13,108,108,17,7,10,2,1
18,126,126,14,7,7,2,1
17,203,203,13,1,12,2,1
20,206,206,83,62,21,2,1
14,213,213,37,37,0,1,0
9,217,217,6,6,0,1,0
19,221,221,10,1,9,2,1
15,237,237,3,3,0,1,0
21,283,283,12,2,10,4,3
11,284,284,12,5,7,2,1
8,291,291,2,2,0,1,0
12,333,333,15,15,0,1,0
3,372,372,27,27,0,1,0
5,375,375,27,27,0,1,0
4,390,390,62,31,31,2,1
10,432,432,77,21,56,4,3
0,461,461,103,103,0,1,0
6,467,467,23,2,21,4,3
7,473,473,4,4,0,1,0
2,485,485,29,26,3,2,1

2,122,122,28,15,13,2,1
4,138,138,3,3,0,1,0
15,160,160,11,11,0,1,0
7,168,168,8,8,0,1,0
12,172,172,30,8,22,3,2
13,201,201,20,3,17,2,1
17,211,211,6,6,0,1,0
0,218,218,6,6,0,1,0
5,230,230,1,1,0,1,0
14,236,236,15,15,0,1,0
18,267,267,88,24,64,3,2
11,285,285,48,22,26,2,1
9,370,370,39,34,5,2,1
1,402,402,4,4,0,1,0
16,420,420,18,18,0,1,0
10,426,426,15,15,0,1,0
6,452,452,31,19,12,3,2
3,466,466,9,9,0,1,0
8,498,498,233,110,123,4,3

21,107,107,17,17,0,1,0
7,140,140,9,3,6,2,1
1,161,161,16,1,15,3,2
2,167,167,1,1,0,1,0
13,174,174,18,18,0,1,0
15,185,185,10,10,0,1,0
20,186,186,51,51,0,1,0
11,199,199,3,3,0,1,0
3,201,201,31,4,27,3,2
8,226,226,5,5,0,1,0
4,256,256,12,6,6,2,1
14,260,260,5,5,0,1,0
18,267,267,13,13,0,1,0
12,278,278,1,1,0,1,0
6,320,320,47,14,33,2,1
10,401,401,46,4,42,3,2
9,415,415,28,28,0,1,0
16,417,417,65,58,7,2,1
19,417,417,9,2,7,2,1
23,418,418,46,46,0,1,0
5,427,427,8,8,0,1,0
0,462,462,56,56,0,1,0
17,465,465,25,25,0,1,0
22,467,467,66,12,54,4,3

18,122,122,26,26,0,1,0
2,123,123,22,22,0,1,0
5,133,133,1,1,0,1,0
1,141,141,20,20,0,1,0
12,143,143,2,2,0,1,0
3,160,160,9,3,6,3,2
16,213,213,2,2,0,1,0
13,254,254,46,16,30,2,1
14,254,254,57,27,30,2,1
15,278,278,15,15,0,1,0
7,324,324,39,39,0,1,0
0,330,330,11,5,6,3,2
9,331,331,57,57,0,1,0
8,338,338,14,14,0,1,0
6,347,347,35,31,4,2,1
11,393,393,31,6,25,2,1
4,406,406,61,61,0,1,0
17,408,408,20,20,0,1,0
10,417,417,79,79,0,1,0

15,117,117,11,11,0,1,0
7,137,137,6,6,0,1,0
9,196,196,4,4,0,1,0
3,243,243,14,14,0,1,0
8,289,289,15,3,12,2,1
4,303,303,108,40,68,4,3
12,306,306,69,30,39,4,3
6,310,310,22,12,10,2,1
14,315,315,11,11,0,1,0
1,317,317,3,3,0,1,0
5,365,365,6,6,0,1,0
0,385,385,150,102,48,4,3
13,389,389,59,23,36,2,1
2,440,440,44,2,42,3,2
10,488,488,186,160,26,4,3
11,488,488,6,6,0,1,0

8,156,156,5,5,0,1,0
7,181,181,13,13,0,1,0
6,213,213,49,31,18,4,3
13,215,215,10,10,0,1,0
0,216,216,25,25,0,1,0
12,238,238,6,6,0,1,0
5,239,239,77,52,25,2,1
14,249,249,17,3,14,2,1
10,283,283,47,47,0,1,0
4,284,284,24,24,0,1,0
11,313,313,3,3,0,1,0
9,337,337,124,124,0,1,0
2,414,414,92,92,0,1,0
1,458,458,33,13,20,2,1
3,465,465,86,30,56,3,2

1,107,107,24,18,6,2,1
10,118,118,13,13,0,1,0
0,176,176,19,3,16,2,1
16,192,192,84,64,20,2,1
5,227,227,34,34,0,1,0
4,239,239,21,5,16,2,1
7,292,292,14,1,13,2,1
8,295,295,4,4,0,1,0
11,299,299,19,4,15,4,3
9,316,316,7,7,0,1,0
17,338,338,3,3,0,1,0
14,345,345,37,37,0,1,0
12,361,361,2,2,0,1,0
2,377,377,6,2,4,2,1
3,421,421,42,14,28,3,2
6,465,465,118,115,3,2,1
15,473,473,18,6,12,2,1
13,488,488,108,108,0,1,0

3,103,103,16,16,0,1,0
13,109,109,3,3,0,1,0
21,129,129,13,13,0,1,0
9,151,151,14,14,0,1,0
12,152,152,21,9,12,2,1
6,153,153,8,8,0,1,0
5,154,154,1,1,0,1,0
18,158,158,51,17,34,3,2
4,162,162,22,22,0,1,0
17,191,191,8,2,6,2,1
19,201,201,3,3,0,1,0
14,237,237,1,1,0,1,0
0,267,267,5,5,0,1,0
10,293,293,21,21,0,1,0
7,317,317,55,55,0,1,0
11,413,413,13,13,0,1,0
16,422,422,20,20,0,1,0
8,425,425,20,20,0,1,0
1,457,457,25,7,18,3,2
20,471,471,205,172,33,4,3
15,479,479,12,12,0,1,0
2,483,483,11,7,4,2,1

13,128,128,5,5,0,1,0
17,135,135,81,81,0,1,0
11,142,142,2,2,0,1,0
14,154,154,2,2,0,1,0
8,199,199,11,11,0,1,0
1,260,260,94,35,59,4,3
6,269,269,2,2,0,1,0
19,308,308,30,30,0,1,0
18,325,325,4,4,0,1,0
16,342,342,46,22,24,4,3
7,383,383,5,5,0,1,0
3,386,386,26,8,18,2,1
15,392,392,9,9,0,1,0
4,412,412,18,18,0,1,0
9,419,419,26,26,0,1,0
12,446,446,40,12,28,2,1
10,460,460,34,12,22,3,2
5,464,464,4,4,0,1,0
2,481,481,39,39,0,1,0
0,493,493,112,112,0,1,0

12,123,123,5,1,4,2,1
0,161,161,5,1,4,2,1
6,187,187,4,4,0,1,0
8,188,188,15,15,0,1,0
16,190,190,22,2,20,2,1
3,192,192,67,67,0,1,0
14,195,195,31,25,6,2,1
11,198,198,43,43,0,1,0
10,235,235,2,2,0,1,0
15,278,278,24,24,0,1,0
5,326,326,68,20,48,2,1
4,345,345,5,5,0,1,0
13,375,375,56,21,35,3,2
7,391,391,4,4,0,1,0
1,409,409,99,99,0,1,0
9,477,477,77,33,44,3,2
2,485,485,61,50,11,2,1

2,103,103,9,9,0,1,0
10,118,118,20,20,0,1,0
14,121,121,10,1,9,2,1
15,137,137,24,2,22,2,1
21,161,161,7,7,0,1,0
9,166,166,10,2,8,3,2
20,170,170,10,1,9,4,3
23,172,172,8,8,0,1,0
18,178,178,3,3,0,1,0
7,216,216,42,42,0,1,0
12,242,242,10,10,0,1,0
5,261,261,1,1,0,1,0
13,263,263,7,7,0,1,0
6,275,275,18,18,0,1,0
19,282,282,37,22,15,4,3
3,285,285,3,3,0,1,0
0,319,319,18,18,0,1,0
1,338,338,55,28,27,2,1
4,346,346,7,7,0,1,0
16,353,353,76,76,0,1,0
17,409,409,3,3,0,1,0
22,440,440,142,82,60,3,2
8,454,454,8,3,5,2,1
11,477,477,2,2,0,1,0

13,120,120,30,30,0,1,0
6,125,125,39,13,26,3,2
5,141,141,9,9,0,1,0
10,174,174,46,46,0,1,0
18,175,175,19,19,0,1,0
16,199,199,8,8,0,1,0
0,200,200,6,3,3,2,1
2,223,223,20,20,0,1,0
14,253,253,12,1,11,4,3
17,270,270,5,5,0,1,0
4,319,319,30,2,28,3,2
11,321,321,18,6,12,3,2
8,326,326,58,49,9,4,3
1,362,362,6,6,0,1,0
15,376,376,44,15,29,2,1
9,377,377,38,26,12,2,1
7,408,408,43,43,0,1,0
12,475,475,61,61,0,1,0
3,489,489,6,6,0,1,0

16,112,112,24,16,8,2,1
2,112,112,35,26,9,4,3
6,136,136,20,16,4,2,1
17,138,138,17,7,10,2,1
11,189,189,33,10,23,2,1
8,198,198,23,23,0,1,0
10,236,236,17,2,15,2,1
5,238,238,1,1,0,1,0
4,254,254,9,4,5,2,1
14,257,257,5,5,0,1,0
12,260,260,13,3,10,3,2
7,276,276,40,40,0,1,0
0,297,297,33,15,18,3,2
13,326,326,31,31,0,1,0
9,340,340,34,34,0,1,0
15,381,381,69,15,54,3,2
3,394,394,36,3,33,2,1
1,457,457,18,6,12,3,2

21,106,106,5,2,3,2,1
11,138,138,1,1,0,1,0
20,152,152,30,3,27,3,2
17,168,168,13,13,0,1,0
6,176,176,11,3,8,3,2
1,186,186,12,2,10,3,2
10,186,186,51,8,43,4,3
4,224,224,1,1,0,1,0
13,230,230,14,6,8,3,2
3,255,255,28,28,0,1,0
5,257,257,3,3,0,1,0
14,263,263,31,31,0,1,0
0,330,330,53,11,42,4,3
9,345,345,35,35,0,1,0
8,357,357,1,1,0,1,0
7,373,373,17,2,15,3,2
22,375,375,53,53,0,1,0
16,377,377,54,54,0,1,0
12,383,383,33,3,30,4,3
15,390,390,89,35,54,3,2
19,399,399,24,9,15,4,3
18,430,430,4,1,3,2,1
2,492,492,6,6,0,1,0

2,142,142,7,1,6,3,2
13,146,146,22,7,15,2,1
17,154,154,35,35,0,1,0
7,163,163,33,33,0,1,0
5,187,187,21,11,10,2,1
9,214,214,4,4,0,1,0
8,231,231,16,1,15,2,1
15,251,251,13,7,6,3,2
3,267,267,35,13,22,2,1
0,274,274,13,13,0,1,0
16,281,281,12,12,0,1,0
6,288,288,89,2,87,4,3
14,288,288,48,30,18,3,2
1,312,312,21,14,7,2,1
11,372,372,16,16,0,1,0
12,385,385,62,62,0,1,0
4,415,415,5,5,0,1,0
10,458,458,71,71,0,1,0

18,105,105,14,14,0,1,0
21,125,125,3,3,0,1,0
0,137,137,7,3,4,2,1
10,139,139,1,1,0,1,0
1,144,144,24,2,22,3,2
14,145,145,27,27,0,1,0
3,157,157,22,5,17,2,1
13,158,158,27,27,0,1,0
7,159,159,7,7,0,1,0
12,173,173,14,6,8,2,1
6,225,225,10,10,0,1,0
2,228,228,31,31,0,1,0
11,298,298,3,3,0,1,0
22,317,317,46,46,0,1,0
4,323,323,27,19,8,3,2
20,329,329,26,18,8,2,1
17,336,336,46,33,13,2,1
16,372,372,72,50,22,2,1
15,386,386,25,13,12,3,2
9,393,393,18,6,12,4,3
19,399,399,25,6,19,2,1
5,405,405,2,2,0,1,0
8,412,412,7,7,0,1,0

8,112,112,3,3,0,1,0
14,129,129,4,4,0,1,0
9,135,135,17,5,12,4,3
16,144,144,30,6,24,4,3
0,157,157,7,7,0,1,0
4,191,191,21,5,16,3,2
7,195,195,13,4,9,4,3
18,213,213,28,4,24,4,3
13,229,229,22,22,0,1,0
11,271,271,45,45,0,1,0
10,279,279,7,1,6,2,1
19,297,297,10,10,0,1,0
5,331,331,6,2,4,2,1
12,337,337,48,48,0,1,0
6,374,374,18,6,12,4,3
15,393,393,7,1,6,2,1
17,403,403,79,63,16,3,2
3,407,407,78,53,25,2,1
2,415,415,137,92,45,4,3
1,433,433,6,2,4,2,1

7,110,110,15,15,0,1,0
2,112,112,4,4,0,1,0
16,122,122,24,11,13,2,1
4,132,132,3,3,0,1,0
3,199,199,7,1,6,2,1
0,217,217,10,4,6,2,1
15,227,227,5,5,0,1,0
18,227,227,23,23,0,1,0
24,239,239,2,2,0,1,0
8,260,260,31,31,0,1,0
10,275,275,1,1,0,1,0
12,277,277,20,20,0,1,0
5,292,292,3,3,0,1,0
20,357,357,50,34,16,2,1
22,357,357,22,22,0,1,0
1,370,370,44,44,0,1,0
6,374,374,47,47,0,1,0
11,381,381,32,5,27,4,3
19,395,395,18,18,0,1,0
9,402,402,1,1,0,1,0
14,412,412,19,19,0,1,0
17,414,414,46,31,15,4,3
13,448,448,54,23,31,2,1
23,453,453,109,35,74,4,3
21,498,498,54,54,0,1,0

14,123,123,8,1,7,2,1
8,126,126,22,22,0,1,0
1,138,138,33,14,19,2,1
12,161,161,21,16,5,2,1
0,189,189,15,15,0,1,0
3,224,224,52,52,0,1,0
6,249,249,57,16,41,2,1
7,288,288,33,6,27,2,1
11,342,342,1,1,0,1,0
4,375,375,2,2,0,1,0
10,390,390,18,2,16,4,3
9,413,413,77,9,68,4,3
5,441,441,69,26,43,2,1
13,451,451,30,27,3,2,1
2,499,499,144,144,0,1,0

3,128,128,1,1,0,1,0
0,130,130,25,25,0,1,0
13,211,211,6,6,0,1,0
2,237,237,1,1,0,1,0
10,248,248,2,2,0,1,0
4,257,257,9,9,0,1,0
12,281,281,46,14,32,2,1
16,295,295,5,5,0,1,0
9,307,307,19,19,0,1,0
20,324,324,18,13,5,2,1
14,372,372,14,14,0,1,0
19,387,387,65,65,0,1,0
11,394,394,87,15,72,3,2
17,402,402,38,38,0,1,0
8,416,416,30,1,29,2,1
15,422,422,187,151,36,4,3
18,444,444,2,2,0,1,0
1,448,448,73,66,7,2,1
5,466,466,21,21,0,1,0
6,480,480,64,19,45,4,3
7,495,495,29,29,0,1,0

11,102,102,10,10,0,1,0
0,131,131,7,4,3,2,1
21,151,151,13,5,8,2,1
20,168,168,19,19,0,1,0
14,186,186,17,17,0,1,0
10,288,288,14,14,0,1,0
7,303,303,1,1,0,1,0
9,309,309,11,6,5,2,1
3,329,329,78,68,10,2,1
15,332,332,62,34,28,2,1
17,333,333,10,10,0,1,0
1,334,334,4,4,0,1,0
4,356,356,46,33,13,2,1
18,364,364,75,75,0,1,0
5,371,371,44,44,0,1,0
8,390,390,56,56,0,1,0
19,404,404,11,11,0,1,0
12,409,409,7,7,0,1,0
16,416,416,63,43,20,2,1
6,425,425,44,44,0,1,0
13,426,426,51,51,0,1,0
2,450,450,1,1,0,1,0

10,110,110,5,5,0,1,0
9,138,138,1,1,0,1,0
24,159,159,29,29,0,1,0
13,160,160,13,3,10,2,1
6,188,188,2,2,0,1,0
18,197,197,51,5,46,2,1
7,213,213,17,3,14,3,2
5,247,247,34,7,27,2,1
12,258,258,44,27,17,2,1
4,259,259,2,2,0,1,0
22,264,264,14,7,7,2,1
15,265,265,28,6,22,2,1
16,275,275,38,15,23,2,1
19,286,286,53,53,0,1,0
23,289,289,5,5,0,1,0
20,310,310,25,25,0,1,0
17,320,320,6,6,0,1,0
8,357,357,1,1,0,1,0
0,372,372,45,4,41,2,1
2,403,403,24,4,20,2,1
1,405,405,4,4,0,1,0
3,429,429,48,12,36,4,3
11,433,433,15,15,0,1,0
21,490,490,41,41,0,1,0
14,497,497,8,8,0,1,0

15,102,102,26,26,0,1,0
2,118,118,24,9,15,2,1
8,119,119,13,13,0,1,0
4,159,159,9,9,0,1,0
13,180,180,13,13,0,1,0
6,181,181,1,1,0,1,0
1,183,183,20,20,0,1,0
5,198,198,10,4,6,2,1
3,212,212,8,8,0,1,0
11,257,257,40,2,38,3,2
10,258,258,10,10,0,1,0
18,313,313,33,33,0,1,0
9,319,319,58,14,44,3,2
14,339,339,6,6,0,1,0
0,341,341,7,7,0,1,0
12,396,396,43,43,0,1,0
7,400,400,76,76,0,1,0
19,405,405,32,32,0,1,0
16,425,425,85,10,75,4,3
17,488,488,9,9,0,1,0

18,144,144,3,3,0,1,0
6,152,152,16,16,0,1,0
17,157,157,62,62,0,1,0
7,171,171,17,17,0,1,0
13,178,178,31,31,0,1,0
8,181,181,1,1,0,1,0
5,186,186,33,33,0,1,0
0,200,200,4,1,3,2,1
10,203,203,47,47,0,1,0
15,268,268,45,37,8,2,1
11,270,270,3,3,0,1,0
19,311,311,2,2,0,1,0
1,327,327,22,22,0,1,0
2,345,345,13,1,12,4,3
9,356,356,28,28,0,1,0
12,386,386,19,8,11,2,1
14,407,407,41,41,0,1,0
4,416,416,27,13,14,2,1
3,438,438,51,51,0,1,0
16,478,478,46,33,13,2,1

4,114,114,13,13,0,1,0
2,124,124,5,2,3,2,1
3,124,124,12,12,0,1,0
13,131,131,3,3,0,1,0
6,142,142,15,3,12,2,1
9,165,165,2,2,0,1,0
5,227,227,27,17,10,3,2
20,231,231,1,1,0,1,0
12,317,317,126,14,112,4,3
18,342,342,8,4,4,2,1
8,348,348,30,30,0,1,0
7,366,366,70,18,52,3,2
1,370,370,8,4,4,2,1
0,382,382,35,21,14,3,2
17,397,397,16,12,4,2,1
11,403,403,42,42,0,1,0
19,406,406,89,9,80,4,3
15,443,443,113,45,68,3,2
14,446,446,2,2,0,1,0
16,463,463,19,19,0,1,0
10,488,488,9,3,6,3,2

4,209,209,21,21,0,1,0
10,219,219,10,10,0,1,0
2,269,269,99,99,0,1,0
3,279,279,39,36,3,2,1
7,298,298,35,21,14,2,1
9,318,318,103,52,51,4,3
0,342,342,206,200,6,3,2
11,367,367,1,1,0,1,0
8,386,386,20,17,3,2,1
6,417,417,32,32,0,1,0
5,462,462,73,16,57,3,2
1,463,463,15,3,12,4,3

11,104,104,23,6,17,2,1
13,142,142,2,2,0,1,0
10,143,143,4,4,0,1,0
0,155,155,3,3,0,1,0
4,176,176,20,6,14,3,2
14,198,198,5,5,0,1,0
2,219,219,9,4,5,2,1
16,224,224,35,20,15,4,3
1,246,246,14,14,0,1,0
15,305,305,50,17,33,2,1
8,326,326,46,10,36,3,2
7,336,336,125,77,48,4,3
3,390,390,72,10,62,4,3
17,395,395,24,24,0,1,0
5,424,424,20,20,0,1,0
9,445,445,102,68,34,2,1
6,464,464,12,12,0,1,0
12,475,475,59,23,36,2,1

4,121,121,9,9,0,1,0
10,132,132,2,2,0,1,0
0,138,138,1,1,0,1,0
13,160,160,9,9,0,1,0
12,161,161,63,63,0,1,0
14,165,165,4,4,0,1,0
5,166,166,24,24,0,1,0
6,181,181,42,36,6,3,2
16,186,186,13,13,0,1,0
9,267,267,57,13,44,2,1
2,313,313,53,53,0,1,0
1,378,378,12,3,9,4,3
15,383,383,2,2,0,1,0
7,404,404,75,75,0,1,0
11,427,427,19,19,0,1,0
8,461,461,93,84,9,4,3
3,470,470,73,56,17,2,1

11,138,138,3,3,0,1,0
12,159,159,8,8,0,1,0
4,196,196,51,30,21,2,1
17,220,220,93,90,3,2,1
1,234,234,6,6,0,1,0
0,243,243,11,11,0,1,0
7,268,268,2,2,0,1,0
5,274,274,36,8,28,2,1
3,277,277,19,19,0,1,0
13,289,289,11,11,0,1,0
10,291,291,13,13,0,1,0
15,302,302,44,44,0,1,0
6,356,356,13,13,0,1,0
18,394,394,70,70,0,1,0
16,397,397,8,8,0,1,0
9,412,412,70,10,60,4,3
8,457,457,58,58,0,1,0
14,469,469,45,18,27,4,3
2,487,487,63,50,13,2,1

11,105,105,10,10,0,1,0
8,152,152,16,16,0,1,0
14,216,216,8,8,0,1,0
10,222,222,20,20,0,1,0
5,226,226,69,69,0,1,0
1,245,245,9,3,6,3,2
0,260,260,30,12,18,2,1
15,263,263,3,3,0,1,0
6,283,283,1,1,0,1,0
12,286,286,76,50,26,3,2
16,341,341,47,39,8,2,1
4,343,343,2,2,0,1,0
7,375,375,9,4,5,2,1
9,388,388,4,4,0,1,0
3,442,442,177,120,57,4,3
17,448,448,30,30,0,1,0
13,459,459,140,103,37,2,1
2,473,473,3,3,0,1,0

21,106,106,28,1,27,2,1
0,118,118,8,8,0,1,0
22,129,129,5,5,0,1,0
4,132,132,21,21,0,1,0
2,170,170,2,2,0,1,0
17,176,176,5,5,0,1,0
16,193,193,5,5,0,1,0
10,198,198,4,4,0,1,0
8,204,204,20,12,8,2,1
6,227,227,15,2,13,4,3
5,240,240,3,3,0,1,0
7,274,274,7,7,0,1,0
20,294,294,67,67,0,1,0
15,305,305,35,12,23,2,1
14,316,316,7,7,0,1,0
11,323,323,2,2,0,1,0
13,325,325,30,30,0,1,0
12,333,333,44,44,0,1,0
18,355,355,47,47,0,1,0
19,369,369,54,54,0,1,0
23,381,381,16,16,0,1,0
9,418,418,21,13,8,3,2
1,418,418,23,1,22,2,1
3,453,453,83,63,20,2,1

15,107,107,7,7,0,1,0
5,131,131,8,8,0,1,0
2,132,132,27,12,15,3,2
17,140,140,39,19,20,3,2
6,141,141,12,4,8,2,1
21,142,142,2,2,0,1,0
9,163,163,37,29,8,3,2
7,200,200,20,11,9,4,3
10,203,203,2,2,0,1,0
0,222,222,11,3,8,3,2
14,225,225,1,1,0,1,0
11,239,239,4,4,0,1,0
4,287,287,3,3,0,1,0
16,297,297,1,1,0,1,0
13,373,373,138,128,10,3,2
12,398,398,38,38,0,1,0
3,406,406,2,2,0,1,0
20,417,417,48,33,15,4,3
8,438,438,19,19,0,1,0
1,445,445,41,41,0,1,0
19,457,457,56,56,0,1,0
18,476,476,17,17,0,1,0

16,112,112,1,1,0,1,0
5,118,118,8,8,0,1,0
21,126,126,36,9,27,2,1
14,146,146,10,10,0,1,0
2,147,147,25,25,0,1,0
20,171,171,1,1,0,1,0
1,202,202,7,3,4,2,1
15,207,207,5,2,3,2,1
7,212,212,9,9,0,1,0
17,245,245,7,4,3,2,1
19,249,249,34,34,0,1,0
11,271,271,2,2,0,1,0
6,291,291,2,2,0,1,0
18,298,298,39,1,38,3,2
9,321,321,5,5,0,1,0
10,334,334,4,4,0,1,0
8,386,386,55,7,48,4,3
22,388,388,96,26,70,3,2
13,403,403,35,35,0,1,0
4,420,420,11,2,9,2,1
12,427,427,24,2,22,2,1
3,431,431,25,25,0,1,0
0,492,492,102,102,0,1,0
23,498,498,77,77,0,1,0

0,108,108,5,5,0,1,0
3,123,123,2,2,0,1,0
9,152,152,1,1,0,1,0
1,157,157,5,5,0,1,0
7,198,198,14,14,0,1,0
13,210,210,10,10,0,1,0
14,217,217,39,9,30,2,1
8,221,221,22,22,0,1,0
12,226,226,6,6,0,1,0
10,251,251,31,5,26,2,1
4,306,306,66,66,0,1,0
15,339,339,13,6,7,2,1
20,371,371,158,145,13,2,1
6,392,392,13,13,0,1,0
16,437,437,17,17,0,1,0
18,461,461,53,5,48,4,3
17,463,463,28,3,25,2,1
11,477,477,113,113,0,1,0
19,483,483,38,38,0,1,0
5,487,487,51,37,14,3,2
2,490,490,8,8,0,1,0

11,161,161,27,27,0,1,0
7,171,171,3,3,0,1,0
8,192,192,9,4,5,2,1
1,235,235,52,29,23,2,1
14,263,263,18,3,15,4,3
3,265,265,35,35,0,1,0
9,282,282,61,61,0,1,0
13,337,337,21,21,0,1,0
2,341,341,102,72,30,4,3
0,362,362,53,18,35,2,1
10,363,363,33,29,4,2,1
4,370,370,31,5,26,2,1
12,400,400,108,108,0,1,0
6,406,406,5,5,0,1,0
15,427,427,34,34,0,1,0
5,498,498,53,20,33,2,1

17,101,101,17,5,12,2,1
4,141,141,34,34,0,1,0
11,170,170,14,8,6,3,2
10,172,172,12,6,6,2,1
21,175,175,42,42,0,1,0
14,193,193,46,24,22,3,2
1,207,207,8,8,0,1,0
8,218,218,1,1,0,1,0
15,222,222,22,22,0,1,0
12,235,235,9,9,0,1,0
16,243,243,30,9,21,4,3
0,263,263,13,13,0,1,0
5,273,273,2,2,0,1,0
3,279,279,49,49,0,1,0
2,284,284,34,34,0,1,0
20,357,357,3,3,0,1,0
6,368,368,30,11,19,2,1
9,388,388,34,34,0,1,0
13,433,433,28,16,12,2,1
18,465,465,22,22,0,1,0
19,494,494,15,15,0,1,0
7,499,499,2,2,0,1,0

6,105,105,7,7,0,1,0
1,156,156,14,6,8,3,2
9,157,157,5,5,0,1,0
10,192,192,11,5,6,2,1
18,204,204,7,7,0,1,0
5,211,211,94,94,0,1,0
8,238,238,20,20,0,1,0
2,278,278,7,7,0,1,0
13,302,302,33,21,12,3,2
14,323,323,43,4,39,4,3
11,351,351,56,7,49,3,2
7,352,352,59,59,0,1,0
3,378,378,7,7,0,1,0
15,397,397,3,3,0,1,0
12,424,424,129,61,68,3,2
0,439,439,3,3,0,1,0
4,463,463,32,8,24,4,3
16,483,483,39,20,19,2,1
17,488,488,62,46,16,3,2

2,107,107,1,1,0,1,0
9,157,157,6,6,0,1,0
6,167,167,18,18,0,1,0
7,169,169,13,13,0,1,0
17,183,183,6,3,3,2,1
16,185,185,40,13,27,2,1
4,210,210,9,9,0,1,0
14,258,258,13,1,12,3,2
15,263,263,25,25,0,1,0
19,320,320,18,7,11,2,1
12,337,337,10,2,8,2,1
18,344,344,18,18,0,1,0
8,355,355,71,71,0,1,0
1,357,357,8,8,0,1,0
20,368,368,27,27,0,1,0
10,373,373,3,3,0,1,0
13,391,391,160,37,123,4,3
11,462,462,88,6,82,3,2
0,464,464,23,15,8,3,2
3,473,473,77,77,0,1,0
5,500,500,46,32,14,2,1

14,113,113,6,6,0,1,0
18,121,121,11,11,0,1,0
11,124,124,2,2,0,1,0
15,138,138,2,2,0,1,0
24,160,160,6,6,0,1,0
22,168,168,1,1,0,1,0
8,192,192,14,14,0,1,0
26,212,212,12,2,10,3,2
0,219,219,2,2,0,1,0
6,224,224,15,15,0,1,0
19,225,225,6,2,4,2,1
4,232,232,50,24,26,2,1
23,241,241,54,54,0,1,0
20,247,247,94,21,73,3,2
2,292,292,7,1,6,3,2
17,317,317,11,11,0,1,0
9,388,388,5,2,3,2,1
16,399,399,26,26,0,1,0
7,409,409,9,3,6,2,1
25,419,419,20,14,6,2,1
12,423,423,6,1,5,2,1
13,427,427,16,16,0,1,0
3,442,442,20,20,0,1,0
5,446,446,129,45,84,4,3
10,450,450,2,2,0,1,0
21,466,466,71,35,36,4,3
1,494,494,2,2,0,1,0

11,162,162,32,3,29,2,1
14,171,171,2,2,0,1,0
0,195,195,63,29,34,3,2
6,201,201,5,2,3,2,1
5,205,205,7,7,0,1,0
2,216,216,55,55,0,1,0
13,308,308,32,16,16,2,1
9,314,314,91,91,0,1,0
15,333,333,75,15,60,4,3
12,351,351,5,2,3,2,1
16,393,393,7,7,0,1,0
7,418,418,4,4,0,1,0
3,444,444,55,36,19,2,1
10,454,454,31,31,0,1,0
4,460,460,58,58,0,1,0
8,467,467,42,42,0,1,0
1,479,479,50,8,42,4,3

6,129,129,12,4,8,2,1
16,139,139,5,5,0,1,0
0,147,147,19,5,14,2,1
3,159,159,21,21,0,1,0
2,167,167,13,13,0,1,0
15,203,203,32,16,16,2,1
10,214,214,3,3,0,1,0
4,217,217,39,39,0,1,0
8,231,231,32,11,21,2,1
1,238,238,31,31,0,1,0
12,265,265,47,3,44,3,2
7,286,286,18,3,15,2,1
14,286,286,11,3,8,3,2
13,298,298,32,32,0,1,0
9,317,317,39,27,12,3,2
11,355,355,121,121,0,1,0
17,397,397,10,7,3,2,1
5,422,422,24,24,0,1,0

10,100,100,26,20,6,3,2
20,115,115,14,5,9,4,3
0,134,134,15,15,0,1,0
19,135,135,4,4,0,1,0
2,145,145,26,26,0,1,0
18,156,156,24,1,23,2,1
3,168,168,2,2,0,1,0
12,184,184,7,1,6,3,2
11,199,199,14,5,9,2,1
13,259,259,17,3,14,3,2
4,265,265,5,5,0,1,0
14,271,271,19,19,0,1,0
15,283,283,3,3,0,1,0
16,285,285,52,52,0,1,0
17,326,326,113,23,90,4,3
7,340,340,3,3,0,1,0
1,349,349,2,2,0,1,0
6,374,374,19,19,0,1,0
8,433,433,35,35,0,1,0
21,450,450,19,19,0,1,0
9,450,450,44,18,26,2,1
5,468,468,31,31,0,1,0

11,105,105,2,2,0,1,0
13,110,110,2,2,0,1,0
2,161,161,22,22,0,1,0
16,161,161,8,2,6,3,2
14,162,162,17,17,0,1,0
1,195,195,1,1,0,1,0
17,209,209,25,7,18,3,2
6,226,226,6,1,5,2,1
4,229,229,25,17,8,3,2
3,242,242,8,8,0,1,0
15,334,334,42,25,17,2,1
10,338,338,80,29,51,4,3
19,345,345,33,28,5,2,1
12,378,378,34,20,14,2,1
18,401,401,162,162,0,1,0
7,417,417,60,6,54,3,2
8,426,426,13,2,11,3,2
5,431,431,59,37,22,3,2
9,435,435,18,18,0,1,0
0,462,462,47,5,42,4,3

11,105,105,22,8,14,2,1
9,105,105,19,19,0,1,0
4,123,123,1,1,0,1,0
1,150,150,29,7,22,2,1
18,184,184,53,26,27,4,3
6,198,198,9,6,3,2,1
0,211,211,31,31,0,1,0
7,230,230,23,23,0,1,0
17,260,260,1,1,0,1,0
3,262,262,25,25,0,1,0
16,291,291,6,6,0,1,0
2,297,297,32,29,3,2,1
13,342,342,107,76,31,2,1
5,362,362,33,23,10,3,2
12,371,371,13,2,11,2,1
15,382,382,10,10,0,1,0
14,437,437,34,12,22,4,3
8,450,450,18,18,0,1,0
10,486,486,23,5,18,4,3

1,146,146,16,16,0,1,0
0,173,173,13,6,7,2,1
7,244,244,32,32,0,1,0
15,265,265,42,42,0,1,0
8,283,283,16,12,4,2,1
5,298,298,30,30,0,1,0
18,304,304,23,23,0,1,0
17,326,326,31,31,0,1,0
13,327,327,112,112,0,1,0
2,343,343,32,32,0,1,0
9,351,351,7,2,5,2,1
16,360,360,1,1,0,1,0
11,448,448,69,69,0,1,0
14,471,471,18,4,14,3,2
3,478,478,20,2,18,2,1
4,481,481,97,88,9,4,3
10,485,485,41,41,0,1,0
6,486,486,83,41,42,4,3
12,490,490,31,31,0,1,0

3,122,122,10,10,0,1,0
2,142,142,22,22,0,1,0
14,151,151,10,10,0,1,0
11,191,191,14,14,0,1,0
13,192,192,32,32,0,1,0
17,220,220,92,54,38,4,3
4,238,238,42,9,33,2,1
1,256,256,41,41,0,1,0
9,269,269,48,48,0,1,0
18,274,274,32,32,0,1,0
7,306,306,6,2,4,2,1
8,332,332,13,13,0,1,0
12,371,371,35,35,0,1,0
5,383,383,21,21,0,1,0
10,400,400,8,8,0,1,0
15,419,419,13,13,0,1,0
16,427,427,14,14,0,1,0
6,448,448,41,41,0,1,0
0,454,454,20,20,0,1,0

7,105,105,1,1,0,1,0
18,111,111,5,5,0,1,0
24,147,147,17,3,14,3,2
2,150,150,1,1,0,1,0
9,154,154,5,5,0,1,0
21,160,160,24,24,0,1,0
5,164,164,9,9,0,1,0
6,185,185,42,42,0,1,0
1,187,187,4,4,0,1,0
0,191,191,9,9,0,1,0
14,197,197,5,5,0,1,0
3,204,204,5,1,4,2,1
17,211,211,1,1,0,1,0
19,219,219,1,1,0,1,0
13,222,222,25,9,16,2,1
20,268,268,23,13,10,3,2
23,269,269,27,18,9,4,3
10,308,308,72,24,48,2,1
8,317,317,7,1,6,2,1
25,337,337,62,2,60,4,3
22,337,337,49,49,0,1,0
11,342,342,5,5,0,1,0
16,358,358,3,3,0,1,0
26,385,385,76,76,0,1,0
15,472,472,30,30,0,1,0
4,483,483,18,8,10,2,1
12,484,484,27,7,20,2,1

17,116,116,8,8,0,1,0
12,119,119,16,16,0,1,0
9,156,156,24,2,22,3,2
7,157,157,26,26,0,1,0
4,178,178,1,1,0,1,0
11,197,197,15,2,13,2,1
2,203,203,8,8,0,1,0
13,218,218,9,9,0,1,0
15,270,270,9,9,0,1,0
8,275,275,70,70,0,1,0
0,308,308,1,1,0,1,0
6,326,326,61,49,12,3,2
10,339,339,119,65,54,4,3
16,339,339,47,47,0,1,0
3,341,341,36,36,0,1,0
1,342,342,24,6,18,3,2
14,344,344,5,1,4,2,1
5,438,438,75,27,48,4,3

3,122,122,26,26,0,1,0
10,135,135,14,5,9,2,1
21,141,141,2,2,0,1,0
14,169,169,67,67,0,1,0
4,190,190,8,8,0,1,0
19,193,193,39,39,0,1,0
0,215,215,5,5,0,1,0
17,217,217,6,6,0,1,0
12,219,219,4,4,0,1,0
1,229,229,1,1,0,1,0
18,232,232,18,18,0,1,0
13,277,277,17,1,16,2,1
16,282,282,20,5,15,2,1
5,286,286,1,1,0,1,0
9,297,297,18,13,5,2,1
7,337,337,72,68,4,2,1
15,348,348,4,4,0,1,0
20,354,354,56,56,0,1,0
8,400,400,107,84,23,2,1
11,433,433,5,5,0,1,0
2,439,439,14,14,0,1,0
6,487,487,4,4,0,1,0

0,114,114,7,2,5,2,1
3,117,117,8,8,0,1,0
11,137,137,12,6,6,3,2
12,173,173,1,1,0,1,0
4,205,205,15,15,0,1,0
10,224,224,41,25,16,3,2
15,237,237,5,5,0,1,0
17,241,241,64,18,46,2,1
14,248,248,9,2,7,2,1
2,266,266,16,16,0,1,0
8,283,283,14,14,0,1,0
5,318,318,28,9,19,3,2
18,334,334,40,40,0,1,0
7,393,393,39,39,0,1,0
13,404,404,31,31,0,1,0
1,413,413,61,5,56,4,3
9,429,429,55,55,0,1,0
6,435,435,98,14,84,4,3
16,497,497,107,107,0,1,0

11,116,116,3,3,0,1,0
1,143,143,20,4,16,3,2
14,152,152,14,14,0,1,0
12,167,167,2,2,0,1,0
16,181,181,4,4,0,1,0
3,206,206,18,2,16,4,3
9,228,228,26,19,7,2,1
10,237,237,1,1,0,1,0
5,248,248,5,5,0,1,0
15,274,274,19,7,12,4,3
13,335,335,193,137,56,4,3
17,372,372,39,18,21,4,3
7,383,383,4,4,0,1,0
4,395,395,21,9,12,2,1
8,415,415,176,176,0,1,0
2,449,449,21,21,0,1,0
0,476,476,103,56,47,4,3
6,498,498,1,1,0,1,0

3,107,107,8,8,0,1,0
2,195,195,34,34,0,1,0
6,196,196,1,1,0,1,0
13,198,198,25,25,0,1,0
7,202,202,3,3,0,1,0
4,223,223,63,63,0,1,0
5,236,236,5,5,0,1,0
0,264,264,50,50,0,1,0
1,311,311,25,25,0,1,0
10,419,419,17,17,0,1,0
12,431,431,90,45,45,2,1
8,434,434,69,39,30,3,2
16,442,442,36,36,0,1,0
9,446,446,86,86,0,1,0
17,447,447,127,127,0,1,0
11,462,462,3,3,0,1,0
14,483,483,5,5,0,1,0
15,494,494,31,31,0,1,0

15,125,125,2,2,0,1,0
0,130,130,6,6,0,1,0
17,140,140,24,1,23,2,1
8,158,158,2,2,0,1,0
12,173,173,50,6,44,2,1
3,208,208,38,8,30,4,3
13,215,215,25,13,12,4,3
2,216,216,20,11,9,2,1
6,241,241,13,13,0,1,0
11,254,254,23,13,10,3,2
1,255,255,83,83,0,1,0
9,281,281,70,43,27,2,1
14,290,290,2,2,0,1,0
4,419,419,5,5,0,1,0
5,424,424,26,2,24,3,2
16,450,450,15,4,11,2,1
10,456,456,21,9,12,2,1
7,485,485,105,78,27,4,3

13,152,152,11,11,0,1,0
6,172,172,30,8,22,2,1
3,183,183,1,1,0,1,0
14,201,201,1,1,0,1,0
10,231,231,38,38,0,1,0
15,312,312,4,4,0,1,0
12,317,317,16,16,0,1,0
11,328,328,142,56,86,4,3
0,399,399,102,102,0,1,0
4,416,416,15,12,3,2,1
1,418,418,70,49,21,4,3
9,421,421,41,10,31,4,3
8,426,426,67,67,0,1,0
5,445,445,51,30,21,2,1
7,452,452,11,2,9,4,3
2,489,489,121,53,68,4,3

12,111,111,28,13,15,4,3
8,117,117,4,4,0,1,0
14,150,150,5,5,0,1,0
17,156,156,2,2,0,1,0
11,177,177,34,34,0,1,0
19,216,216,29,29,0,1,0
15,245,245,8,2,6,2,1
9,256,256,6,6,0,1,0
4,264,264,5,5,0,1,0
6,271,271,9,5,4,2,1
0,298,298,3,3,0,1,0
2,317,317,84,84,0,1,0
16,318,318,27,27,0,1,0
3,325,325,16,16,0,1,0
10,331,331,52,31,21,4,3
1,337,337,21,8,13,2,1
13,427,427,51,51,0,1,0
20,434,434,109,100,9,4,3
5,445,445,10,2,8,3,2
18,453,453,46,46,0,1,0
7,467,467,64,19,45,4,3

8,105,105,4,4,0,1,0
20,147,147,12,6,6,2,1
14,186,186,5,5,0,1,0
22,186,186,4,4,0,1,0
17,188,188,1,1,0,1,0
10,206,206,14,14,0,1,0
5,234,234,3,3,0,1,0
24,280,280,25,25,0,1,0
15,284,284,2,2,0,1,0
6,296,296,28,28,0,1,0
23,298,298,99,16,83,4,3
0,309,309,27,27,0,1,0
9,319,319,3,3,0,1,0
16,361,361,10,10,0,1,0
2,388,388,21,1,20,3,2
13,402,402,42,1,41,2,1
3,403,403,70,70,0,1,0
4,404,404,34,34,0,1,0
18,408,408,60,60,0,1,0
12,429,429,4,4,0,1,0
19,437,437,127,81,46,2,1
21,445,445,11,11,0,1,0
11,468,468,32,32,0,1,0
1,471,471,66,58,8,2,1
7,500,500,12,6,6,3,2

6,100,100,10,5,5,2,1
22,132,132,46,46,0,1,0
23,143,143,5,5,0,1,0
12,165,165,9,9,0,1,0
14,168,168,11,11,0,1,0
4,178,178,15,15,0,1,0
7,180,180,8,4,4,2,1
21,199,199,6,6,0,1,0
8,201,201,6,6,0,1,0
2,215,215,7,7,0,1,0
11,237,237,9,9,0,1,0
16,242,242,4,4,0,1,0
17,254,254,50,50,0,1,0
20,280,280,18,6,12,4,3
9,292,292,1,1,0,1,0
10,306,306,23,5,18,4,3
13,326,326,15,11,4,2,1
19,338,338,40,40,0,1,0
18,398,398,65,15,50,3,2
1,405,405,45,45,0,1,0
5,407,407,47,38,9,2,1
15,439,439,20,11,9,4,3
3,466,466,53,46,7,2,1
0,498,498,44,44,0,1,0

12,155,155,20,10,10,3,2
15,177,177,6,6,0,1,0
8,203,203,18,18,0,1,0
2,227,227,45,45,0,1,0
5,243,243,32,32,0,1,0
6,250,250,1,1,0,1,0
10,263,263,48,48,0,1,0
0,283,283,8,8,0,1,0
11,291,291,11,11,0,1,0
3,346,346,19,15,4,2,1
14,356,356,101,101,0,1,0
1,368,368,33,26,7,2,1
13,376,376,28,20,8,2,1
16,384,384,99,99,0,1,0
4,418,418,30,25,5,2,1
17,445,445,1,1,0,1,0
7,464,464,63,63,0,1,0
18,473,473,8,8,0,1,0
9,500,500,99,87,12,2,1

20,101,101,16,16,0,1,0
16,142,142,4,4,0,1,0
8,161,161,18,7,11,2,1
19,194,194,52,52,0,1,0
5,196,196,30,17,13,2,1
7,203,203,29,9,20,3,2
3,211,211,3,3,0,1,0
14,234,234,39,39,0,1,0
11,244,244,7,7,0,1,0
15,259,259,9,9,0,1,0
18,262,262,48,48,0,1,0
17,298,298,10,10,0,1,0
10,301,301,22,22,0,1,0
13,308,308,2,2,0,1,0
21,313,313,2,2,0,1,0
22,364,364,94,64,30,2,1
1,377,377,28,28,0,1,0
0,414,414,10,1,9,2,1
12,417,417,14,14,0,1,0
23,449,449,20,8,12,4,3
9,453,453,2,2,0,1,0
2,456,456,1,1,0,1,0
4,483,483,46,46,0,1,0
6,500,500,36,36,0,1,0

8,145,145,9,9,0,1,0
3,162,162,36,10,26,3,2
5,233,233,12,4,8,2,1
1,274,274,191,121,70,3,2
4,312,312,49,31,18,3,2
10,360,360,144,106,38,3,2
7,382,382,4,4,0,1,0
0,393,393,15,3,12,3,2
12,426,426,57,25,32,2,1
6,475,475,20,14,6,3,2
9,477,477,71,43,28,3,2
11,478,478,3,3,0,1,0
2,500,500,22,11,11,2,1

13,135,135,17,17,0,1,0
0,139,139,2,2,0,1,0
17,231,231,41,3,38,2,1
7,279,279,45,45,0,1,0
11,285,285,51,9,42,3,2
12,322,322,34,2,32,3,2
9,346,346,15,15,0,1,0
8,355,355,37,37,0,1,0
15,384,384,40,40,0,1,0
14,395,395,76,76,0,1,0
5,406,406,42,24,18,3,2
10,408,408,24,24,0,1,0
6,415,415,16,4,12,3,2
1,419,419,44,44,0,1,0
19,433,433,8,5,3,2,1
16,439,439,39,29,10,2,1
20,450,450,33,6,27,4,3
4,452,452,9,9,0,1,0
18,461,461,61,36,25,3,2
3,472,472,14,7,7,2,1
2,474,474,68,68,0,1,0

3,114,114,16,9,7,2,1
4,136,136,10,10,0,1,0
19,173,173,4,4,0,1,0
2,180,180,1,1,0,1,0
7,183,183,4,4,0,1,0
17,197,197,13,13,0,1,0
12,229,229,40,30,10,2,1
0,243,243,72,72,0,1,0
16,249,249,6,6,0,1,0
18,289,289,3,3,0,1,0
9,300,300,15,8,7,2,1
10,305,305,2,2,0,1,0
13,312,312,15,15,0,1,0
15,351,351,94,49,45,2,1
11,355,355,16,16,0,1,0
6,425,425,68,41,27,3,2
1,438,438,4,4,0,1,0
8,471,471,101,101,0,1,0
14,480,480,173,84,89,4,3
5,498,498,12,2,10,2,1

12,105,105,27,27,0,1,0
3,123,123,67,61,6,3,2
13,165,165,9,9,0,1,0
15,241,241,20,20,0,1,0
14,245,245,15,3,12,4,3
2,247,247,32,32,0,1,0
0,254,254,29,6,23,4,3
4,262,262,28,17,11,2,1
9,319,319,48,48,0,1,0
10,337,337,35,1,34,2,1
1,346,346,5,5,0,1,0
11,367,367,9,1,8,2,1
8,474,474,6,1,5,2,1
6,486,486,1,1,0,1,0
7,486,486,132,12,120,4,3
5,491,491,44,44,0,1,0

7,105,105,32,32,0,1,0
5,159,159,9,4,5,2,1
14,169,169,47,29,18,2,1
16,189,189,34,12,22,2,1
8,191,191,4,4,0,1,0
3,211,211,44,44,0,1,0
12,240,240,19,19,0,1,0
10,248,248,11,11,0,1,0
15,260,260,31,31,0,1,0
9,264,264,42,26,16,2,1
4,267,267,15,11,4,2,1
2,385,385,99,77,22,2,1
6,403,403,5,5,0,1,0
11,413,413,11,5,6,3,2
13,444,444,53,53,0,1,0
1,448,448,12,3,9,4,3
0,491,491,41,41,0,1,0

18,104,104,2,2,0,1,0
16,148,148,1,1,0,1,0
13,150,150,47,11,36,4,3
5,158,158,1,1,0,1,0
22,166,166,49,49,0,1,0
9,168,168,1,1,0,1,0
1,172,172,12,2,10,3,2
21,182,182,27,27,0,1,0
3,188,188,2,2,0,1,0
20,192,192,34,34,0,1,0
19,227,227,47,13,34,2,1
7,257,257,1,1,0,1,0
10,269,269,12,12,0,1,0
11,304,304,5,2,3,2,1
6,328,328,17,17,0,1,0
14,401,401,1,1,0,1,0
2,410,410,31,20,11,2,1
15,418,418,63,15,48,4,3
12,438,438,8,2,6,2,1
8,442,442,11,8,3,2,1
0,452,452,129,108,21,2,1
17,452,452,9,2,7,2,1
4,477,477,36,18,18,3,2

9,155,155,28,2,26,3,2
5,231,231,28,20,8,3,2
13,252,252,49,41,8,3,2
15,300,300,10,10,0,1,0
3,350,350,38,38,0,1,0
14,358,358,87,45,42,2,1
10,387,387,63,63,0,1,0
11,391,391,46,31,15,4,3
6,400,400,167,119,48,3,2
1,417,417,83,38,45,2,1
4,423,423,21,21,0,1,0
7,427,427,28,16,12,3,2
8,431,431,3,3,0,1,0
0,453,453,27,11,16,3,2
2,463,463,21,5,16,3,2
12,500,500,3,3,0,1,0

6,121,121,3,3,0,1,0
18,122,122,2,2,0,1,0
5,126,126,2,2,0,1,0
12,130,130,9,1,8,2,1
9,136,136,11,3,8,2,1
1,194,194,17,17,0,1,0
10,260,260,30,30,0,1,0
13,268,268,129,66,63,4,3
19,295,295,19,3,16,4,3
11,307,307,36,9,27,2,1
15,323,323,9,3,6,2,1
4,337,337,59,41,18,3,2
2,337,337,8,8,0,1,0
17,353,353,46,46,0,1,0
0,360,360,29,5,24,3,2
7,366,366,14,10,4,2,1
14,381,381,6,2,4,2,1
16,453,453,42,42,0,1,0
8,469,469,107,96,11,2,1
3,475,475,63,63,0,1,0

0,113,113,6,6,0,1,0
4,123,123,7,7,0,1,0
14,134,134,8,8,0,1,0
10,145,145,13,13,0,1,0
16,175,175,3,3,0,1,0
7,185,185,5,5,0,1,0
18,201,201,50,41,9,2,1
17,226,226,78,37,41,2,1
6,243,243,2,2,0,1,0
12,272,272,9,9,0,1,0
9,285,285,76,76,0,1,0
2,305,305,15,15,0,1,0
5,328,328,16,16,0,1,0
13,383,383,12,12,0,1,0
1,392,392,12,12,0,1,0
15,418,418,21,11,10,3,2
19,437,437,28,24,4,2,1
11,437,437,72,72,0,1,0
8,459,459,142,142,0,1,0
3,464,464,30,12,18,2,1

0,132,132,6,6,0,1,0
21,136,136,16,2,14,2,1
3,149,149,26,26,0,1,0
11,150,150,5,5,0,1,0
20,170,170,34,34,0,1,0
2,190,190,10,2,8,3,2
15,234,234,4,4,0,1,0
5,276,276,41,41,0,1,0
13,293,293,27,4,23,2,1
6,299,299,15,15,0,1,0
10,326,326,10,10,0,1,0
19,326,326,15,3,12,4,3
1,331,331,13,9,4,2,1
17,339,339,109,109,0,1,0
12,344,344,4,1,3,2,1
4,354,354,19,7,12,2,1
18,368,368,36,36,0,1,0
14,383,383,13,13,0,1,0
8,385,385,17,12,5,2,1
7,444,444,13,13,0,1,0
9,449,449,129,129,0,1,0
16,485,485,44,44,0,1,0

1,100,100,3,3,0,1,0
13,137,137,34,34,0,1,0
8,191,191,25,25,0,1,0
2,219,219,14,14,0,1,0
16,222,222,4,1,3,2,1
15,237,237,3,3,0,1,0
12,237,237,15,15,0,1,0
4,240,240,21,3,18,3,2
0,268,268,23,16,7,2,1
7,270,270,19,19,0,1,0
18,339,339,77,48,29,2,1
17,378,378,40,29,11,2,1
10,379,379,22,22,0,1,0
3,384,384,23,2,21,2,1
11,424,424,88,88,0,1,0
5,430,430,46,46,0,1,0
6,439,439,153,117,36,2,1
14,470,470,35,35,0,1,0
9,495,495,8,8,0,1,0

15,183,183,8,1,7,2,1
7,200,200,29,29,0,1,0
13,209,209,2,2,0,1,0
5,214,214,15,15,0,1,0
11,258,258,14,14,0,1,0
10,263,263,31,20,11,2,1
1,309,309,102,41,61,4,3
3,336,336,35,35,0,1,0
12,340,340,58,19,39,2,1
0,354,354,9,9,0,1,0
4,398,398,130,48,82,3,2
8,413,413,18,8,10,2,1
14,436,436,16,2,14,2,1
2,458,458,35,5,30,2,1
6,477,477,33,33,0,1,0
9,488,488,193,110,83,4,3

7,119,119,5,5,0,1,0
18,140,140,50,50,0,1,0
16,168,168,14,14,0,1,0
11,182,182,3,3,0,1,0
4,210,210,19,1,18,3,2
2,217,217,21,16,5,2,1
20,228,228,42,8,34,3,2
3,238,238,9,4,5,2,1
1,270,270,2,2,0,1,0
17,273,273,21,21,0,1,0
12,289,289,33,12,21,2,1
15,290,290,3,3,0,1,0
19,305,305,8,5,3,2,1
8,327,327,24,17,7,2,1
21,328,328,63,63,0,1,0
9,354,354,46,37,9,2,1
10,363,363,39,39,0,1,0
13,386,386,25,17,8,2,1
0,404,404,17,7,10,3,2
6,412,412,90,90,0,1,0
14,438,438,12,6,6,3,2
5,439,439,11,2,9,2,1

5,113,113,8,8,0,1,0
6,145,145,11,4,7,2,1
2,154,154,3,3,0,1,0
10,181,181,53,8,45,2,1
0,193,193,17,2,15,2,1
17,225,225,59,3,56,3,2
14,249,249,14,14,0,1,0
9,284,284,96,93,3,2,1
12,291,291,31,8,23,2,1
3,301,301,3,3,0,1,0
8,333,333,47,47,0,1,0
16,350,350,8,8,0,1,0
7,372,372,28,1,27,3,2
18,412,412,50,12,38,2,1
15,439,439,16,16,0,1,0
13,458,458,9,2,7,2,1
11,460,460,45,45,0,1,0
4,477,477,30,30,0,1,0
1,483,483,58,54,4,2,1

1,136,136,5,5,0,1,0
17,138,138,22,22,0,1,0
11,172,172,9,9,0,1,0
6,188,188,29,29,0,1,0
4,211,211,62,11,51,4,3
16,265,265,15,11,4,2,1
9,277,277,13,3,10,3,2
8,301,301,29,29,0,1,0
19,302,302,75,15,60,4,3
14,302,302,20,2,18,4,3
3,305,305,54,54,0,1,0
12,317,317,7,7,0,1,0
5,366,366,12,12,0,1,0
18,374,374,93,33,60,4,3
13,382,382,11,2,9,2,1
0,394,394,13,5,8,2,1
7,396,396,31,3,28,2,1
10,477,477,16,16,0,1,0
15,486,486,66,66,0,1,0
2,496,496,9,9,0,1,0

8,102,102,20,1,19,4,3
9,112,112,19,19,0,1,0
13,141,141,4,4,0,1,0
7,173,173,59,21,38,2,1
5,223,223,38,38,0,1,0
1,227,227,1,1,0,1,0
11,263,263,7,7,0,1,0
2,304,304,13,13,0,1,0
12,326,326,22,22,0,1,0
6,424,424,92,44,48,4,3
3,432,432,3,3,0,1,0
16,437,437,169,98,71,4,3
10,443,443,1,1,0,1,0
15,460,460,38,4,34,2,1
4,472,472,78,38,40,3,2
14,475,475,27,6,21,4,3
0,499,499,28,28,0,1,0

12,126,126,6,1,5,2,1
19,130,130,21,21,0,1,0
17,139,139,4,4,0,1,0
5,150,150,4,4,0,1,0
4,278,278,18,18,0,1,0
3,336,336,1,1,0,1,0
7,342,342,14,14,0,1,0
11,352,352,68,5,63,4,3
0,379,379,1,1,0,1,0
13,411,411,58,13,45,4,3
6,415,415,35,7,28,3,2
15,421,421,35,20,15,2,1
16,428,428,70,10,60,4,3
2,429,429,24,2,22,3,2
8,434,434,5,5,0,1,0
1,447,447,179,179,0,1,0
10,458,458,41,26,15,2,1
9,459,459,102,18,84,3,2
18,464,464,8,8,0,1,0
14,470,470,86,86,0,1,0

8,122,122,10,3,7,2,1
22,136,136,30,12,18,3,2
17,151,151,10,10,0,1,0
18,154,154,6,6,0,1,0
20,155,155,7,1,6,2,1
15,155,155,7,1,6,3,2
0,180,180,18,3,15,2,1
6,213,213,6,6,0,1,0
16,222,222,1,1,0,1,0
14,238,238,26,26,0,1,0
2,347,347,3,3,0,1,0
12,356,356,12,12,0,1,0
1,365,365,73,73,0,1,0
19,382,382,95,95,0,1,0
13,390,390,30,16,14,4,3
21,390,390,95,95,0,1,0
7,398,398,21,8,13,2,1
5,408,408,50,50,0,1,0
11,414,414,2,2,0,1,0
4,423,423,20,10,10,2,1
3,428,428,26,8,18,2,1
10,436,436,41,36,5,2,1
9,451,451,40,2,38,2,1

2,103,103,1,1,0,1,0
13,136,136,36,27,9,4,3
9,143,143,1,1,0,1,0
0,154,154,1,1,0,1,0
4,182,182,13,4,9,4,3
5,206,206,2,2,0,1,0
11,281,281,23,10,13,2,1
19,284,284,51,51,0,1,0
18,302,302,2,2,0,1,0
10,316,316,37,37,0,1,0
16,324,324,58,6,52,4,3
1,331,331,3,3,0,1,0
20,335,335,61,61,0,1,0
15,353,353,3,3,0,1,0
3,361,361,66,45,21,4,3
7,366,366,6,6,0,1,0
14,390,390,48,38,10,3,2
6,422,422,82,82,0,1,0
8,453,453,134,74,60,4,3
17,463,463,21,1,20,2,1
12,468,468,10,1,9,2,1

10,124,124,3,3,0,1,0
16,130,130,10,3,7,2,1
1,131,131,13,13,0,1,0
8,164,164,36,36,0,1,0
12,180,180,3,3,0,1,0
13,196,196,11,11,0,1,0
0,216,216,9,9,0,1,0
11,235,235,3,3,0,1,0
2,251,251,36,5,31,2,1
4,259,259,13,1,12,2,1
17,262,262,96,96,0,1,0
15,265,265,8,3,5,2,1
9,293,293,7,7,0,1,0
6,339,339,43,43,0,1,0
3,351,351,70,70,0,1,0
18,365,365,94,94,0,1,0
7,403,403,30,30,0,1,0
5,456,456,10,10,0,1,0
14,485,485,92,68,24,2,1

6,181,181,1,1,0,1,0
2,187,187,44,39,5,2,1
8,189,189,5,5,0,1,0
1,214,214,87,27,60,3,2
12,218,218,15,3,12,2,1
16,237,237,1,1,0,1,0
13,249,249,37,6,31,4,3
3,312,312,44,5,39,4,3
4,313,313,4,4,0,1,0
10,346,346,121,121,0,1,0
9,369,369,3,3,0,1,0
11,386,386,64,16,48,3,2
5,393,393,40,14,26,3,2
0,396,396,5,2,3,2,1
7,421,421,25,1,24,4,3
15,446,446,9,6,3,2,1
17,470,470,24,24,0,1,0
14,481,481,95,25,70,3,2

11,101,101,11,11,0,1,0
2,116,116,7,7,0,1,0
16,157,157,9,6,3,2,1
23,162,162,10,1,9,4,3
7,176,176,7,7,0,1,0
14,210,210,6,6,0,1,0
21,214,214,1,1,0,1,0
6,240,240,54,54,0,1,0
15,258,258,29,29,0,1,0
18,299,299,127,81,46,3,2
1,300,300,16,16,0,1,0
19,305,305,11,11,0,1,0
4,306,306,1,1,0,1,0
22,326,326,43,43,0,1,0
13,333,333,30,30,0,1,0
20,336,336,37,13,24,3,2
5,343,343,10,4,6,2,1
8,353,353,8,8,0,1,0
0,365,365,38,38,0,1,0
9,373,373,11,1,10,3,2
12,444,444,49,49,0,1,0
3,450,450,14,9,5,2,1
17,472,472,36,5,31,2,1
10,484,484,32,12,20,4,3

17,100,100,13,13,0,1,0
13,107,107,5,5,0,1,0
4,130,130,9,3,6,2,1
12,132,132,25,4,21,4,3
2,138,138,4,4,0,1,0
6,150,150,20,20,0,1,0
15,171,171,9,3,6,2,1
7,197,197,46,15,31,2,1
8,210,210,35,35,0,1,0
10,248,248,13,13,0,1,0
14,252,252,43,43,0,1,0
1,296,296,13,13,0,1,0
11,319,319,46,39,7,2,1
5,349,349,92,2,90,3,2
16,351,351,68,23,45,3,2
9,362,362,17,17,0,1,0
3,395,395,8,8,0,1,0
0,403,403,18,6,12,2,1

4,190,190,69,19,50,3,2
1,194,194,21,21,0,1,0
0,204,204,2,2,0,1,0
11,234,234,13,13,0,1,0
3,240,240,65,65,0,1,0
8,257,257,19,19,0,1,0
5,300,300,4,4,0,1,0
13,307,307,8,5,3,2,1
9,319,319,16,16,0,1,0
6,322,322,19,19,0,1,0
7,354,354,195,195,0,1,0
12,373,373,23,4,19,2,1
10,406,406,49,20,29,2,1
2,441,441,111,12,99,4,3

8,105,105,23,1,22,3,2
17,113,113,5,5,0,1,0
21,118,118,20,3,17,4,3
9,131,131,2,2,0,1,0
15,154,154,14,14,0,1,0
4,171,171,11,6,5,2,1
22,176,176,1,1,0,1,0
6,197,197,1,1,0,1,0
16,213,213,27,12,15,4,3
19,215,215,1,1,0,1,0
1,251,251,34,15,19,2,1
3,254,254,14,9,5,2,1
2,260,260,8,5,3,2,1
12,274,274,3,3,0,1,0
7,321,321,47,42,5,2,1
13,330,330,8,8,0,1,0
0,360,360,35,9,26,2,1
5,409,409,16,6,10,3,2
10,422,422,19,19,0,1,0
18,437,437,140,43,97,4,3
24,437,437,62,62,0,1,0
23,447,447,14,14,0,1,0
11,486,486,6,1,5,2,1
14,490,490,6,2,4,2,1
20,496,496,87,87,0,1,0

3,105,105,21,21,0,1,0
1,124,124,4,4,0,1,0
4,138,138,13,1,12,3,2
15,144,144,9,5,4,2,1
13,159,159,42,32,10,3,2
7,180,180,16,16,0,1,0
8,186,186,1,1,0,1,0
12,198,198,68,29,39,2,1
6,200,200,34,34,0,1,0
2,219,219,30,4,26,2,1
11,231,231,13,13,0,1,0
5,237,237,15,15,0,1,0
0,318,318,38,2,36,4,3
16,405,405,15,15,0,1,0
10,407,407,22,10,12,2,1
18,426,426,21,21,0,1,0
9,470,470,43,13,30,4,3
14,478,478,53,53,0,1,0
17,497,497,20,20,0,1,0

7,103,103,3,3,0,1,0
8,108,108,24,24,0,1,0
18,121,121,30,10,20,2,1
11,175,175,9,1,8,3,2
1,208,208,18,18,0,1,0
12,245,245,1,1,0,1,0
20,245,245,55,18,37,2,1
14,247,247,4,4,0,1,0
17,274,274,26,8,18,2,1
3,277,277,64,41,23,2,1
13,279,279,13,2,11,2,1
21,289,289,7,7,0,1,0
10,300,300,8,4,4,2,1
0,302,302,55,50,5,2,1
2,313,313,4,4,0,1,0
9,327,327,6,3,3,2,1
4,339,339,1,1,0,1,0
15,342,342,12,12,0,1,0
5,387,387,18,10,8,3,2
22,423,423,8,8,0,1,0
23,454,454,107,71,36,2,1
19,469,469,26,26,0,1,0
6,482,482,12,12,0,1,0
16,489,489,38,20,18,2,1

16,104,104,6,6,0,1,0
8,108,108,13,13,0,1,0
0,122,122,1,1,0,1,0
12,140,140,15,15,0,1,0
13,147,147,24,24,0,1,0
15,155,155,34,1,33,4,3
14,155,155,12,5,7,2,1
6,175,175,3,3,0,1,0
19,175,175,11,4,7,2,1
11,186,186,2,2,0,1,0
7,208,208,5,5,0,1,0
9,222,222,13,4,9,4,3
2,231,231,17,3,14,3,2
4,240,240,32,22,10,3,2
20,316,316,2,2,0,1,0
18,338,338,11,4,7,2,1
3,361,361,55,9,46,4,3
5,377,377,2,2,0,1,0
1,466,466,9,2,7,2,1
17,469,469,145,98,47,2,1
10,474,474,179,179,0,1,0

19,103,103,4,1,3,2,1
18,107,107,37,7,30,4,3
15,124,124,15,9,6,2,1
4,178,178,1,1,0,1,0
3,223,223,38,38,0,1,0
2,233,233,17,2,15,4,3
16,276,276,19,7,12,2,1
21,278,278,5,5,0,1,0
14,294,294,52,14,38,3,2
12,330,330,7,7,0,1,0
10,343,343,40,40,0,1,0
7,345,345,13,7,6,3,2
11,361,361,18,18,0,1,0
1,374,374,47,4,43,3,2
22,408,408,75,75,0,1,0
13,421,421,12,12,0,1,0
20,426,426,16,1,15,2,1
5,435,435,18,8,10,3,2
17,445,445,17,7,10,2,1
0,445,445,7,7,0,1,0
8,450,450,21,5,16,3,2
6,461,461,66,66,0,1,0
9,479,479,60,60,0,1,0

14,137,137,19,9,10,4,3
1,138,138,1,1,0,1,0
8,171,171,8,1,7,2,1
7,182,182,17,17,0,1,0
6,186,186,51,51,0,1,0
10,210,210,20,20,0,1,0
0,260,260,59,59,0,1,0
11,260,260,1,1,0,1,0
3,271,271,53,53,0,1,0
5,287,287,32,12,20,3,2
16,309,309,39,21,18,3,2
9,330,330,24,24,0,1,0
4,350,350,3,3,0,1,0
2,377,377,15,3,12,2,1
15,391,391,126,63,63,4,3
13,407,407,39,39,0,1,0
17,440,440,12,2,10,2,1
12,456,456,61,18,43,2,1

12,148,148,2,2,0,1,0
0,168,168,13,13,0,1,0
5,172,172,24,24,0,1,0
10,245,245,15,2,13,4,3
9,258,258,55,11,44,2,1
4,287,287,121,73,48,3,2
7,287,287,56,56,0,1,0
13,310,310,44,21,23,2,1
1,375,375,106,74,32,2,1
6,380,380,25,25,0,1,0
2,408,408,32,32,0,1,0
11,408,408,20,3,17,2,1
3,409,409,1,1,0,1,0
8,450,450,4,4,0,1,0
14,494,494,128,113,15,4,3

4,115,115,6,3,3,2,1
9,116,116,1,1,0,1,0
17,201,201,8,8,0,1,0
8,209,209,26,26,0,1,0
7,260,260,7,7,0,1,0
14,266,266,96,1,95,4,3
15,330,330,27,3,24,2,1
3,353,353,16,16,0,1,0
12,366,366,39,39,0,1,0
16,368,368,15,15,0,1,0
10,376,376,6,6,0,1,0
11,387,387,8,1,7,2,1
19,392,392,73,4,69,4,3
20,404,404,3,3,0,1,0
2,413,413,65,65,0,1,0
0,439,439,60,29,31,2,1
1,442,442,29,6,23,2,1
5,446,446,14,1,13,4,3
18,450,450,47,26,21,2,1
6,460,460,145,88,57,4,3
13,489,489,43,25,18,2,1

17,119,119,11,11,0,1,0
14,132,132,9,3,6,3,2
12,165,165,19,4,15,2,1
21,176,176,24,6,18,3,2
10,209,209,20,8,12,2,1
2,231,231,5,5,0,1,0
18,234,234,64,64,0,1,0
7,254,254,2,2,0,1,0
3,271,271,9,1,8,3,2
1,297,297,24,9,15,2,1
15,340,340,18,6,12,3,2
8,375,375,4,4,0,1,0
6,405,405,24,6,18,2,1
16,408,408,1,1,0,1,0
13,429,429,111,111,0,1,0
11,438,438,14,4,10,2,1
19,438,438,30,30,0,1,0
5,446,446,50,50,0,1,0
9,448,448,9,3,6,2,1
4,469,469,109,109,0,1,0
20,471,471,32,32,0,1,0
0,483,483,88,81,7,2,1

13,100,100,5,5,0,1,0
10,119,119,10,4,6,2,1
15,122,122,4,4,0,1,0
16,125,125,26,9,17,2,1
8,175,175,6,2,4,2,1
0,176,176,8,8,0,1,0
18,210,210,31,8,23,4,3
3,215,215,9,9,0,1,0
19,221,221,37,37,0,1,0
5,247,247,13,13,0,1,0
2,277,277,76,39,37,3,2
7,291,291,19,19,0,1,0
11,320,320,35,22,13,2,1
1,341,341,4,4,0,1,0
6,353,353,73,11,62,3,2
9,405,405,24,24,0,1,0
17,431,431,11,11,0,1,0
12,474,474,50,50,0,1,0
14,486,486,84,19,65,4,3
4,492,492,63,63,0,1,0

10,130,130,4,4,0,1,0
11,182,182,23,11,12,4,3
8,204,204,2,2,0,1,0
0,222,222,3,3,0,1,0
2,241,241,17,7,10,3,2
3,251,251,2,2,0,1,0
4,257,257,1,1,0,1,0
7,290,290,80,80,0,1,0
9,294,294,12,12,0,1,0
12,343,343,53,53,0,1,0
14,349,349,95,77,18,2,1
1,403,403,142,142,0,1,0
15,450,450,13,13,0,1,0
13,458,458,32,10,22,3,2
5,471,471,183,136,47,2,1
6,488,488,80,14,66,4,3

1,123,123,1,1,0,1,0
3,138,138,34,34,0,1,0
2,172,172,34,34,0,1,0
6,173,173,2,2,0,1,0
14,234,234,31,31,0,1,0
4,237,237,7,7,0,1,0
16,239,239,22,1,21,2,1
7,285,285,79,79,0,1,0
0,326,326,74,6,68,3,2
5,333,333,1,1,0,1,0
15,334,334,17,5,12,3,2
9,385,385,43,8,35,2,1
12,391,391,81,29,52,3,2
8,454,454,16,16,0,1,0
10,455,455,71,71,0,1,0
13,459,459,42,42,0,1,0
11,489,489,67,67,0,1,0

18,144,144,2,2,0,1,0
8,201,201,48,48,0,1,0
10,211,211,8,8,0,1,0
12,240,240,33,33,0,1,0
7,243,243,10,4,6,3,2
14,260,260,32,5,27,2,1
9,268,268,17,5,12,3,2
13,281,281,25,25,0,1,0
11,293,293,14,14,0,1,0
20,341,341,45,45,0,1,0
2,360,360,45,45,0,1,0
0,360,360,38,38,0,1,0
17,370,370,63,63,0,1,0
16,384,384,14,1,13,2,1
6,402,402,1,1,0,1,0
1,422,422,8,8,0,1,0
19,452,452,129,27,102,4,3
15,455,455,13,13,0,1,0
5,457,457,101,70,31,2,1
4,488,488,36,36,0,1,0
3,499,499,13,13,0,1,0

9,106,106,11,11,0,1,0
0,116,116,6,6,0,1,0
3,150,150,17,17,0,1,0
1,186,186,18,18,0,1,0
8,187,187,27,27,0,1,0
12,188,188,10,1,9,4,3
14,231,231,14,9,5,2,1
10,283,283,71,71,0,1,0
18,296,296,23,4,19,2,1
15,365,365,20,20,0,1,0
2,370,370,25,19,6,2,1
16,375,375,34,34,0,1,0
7,398,398,114,114,0,1,0
6,423,423,20,20,0,1,0
5,442,442,25,5,20,3,2
17,447,447,25,25,0,1,0
13,460,460,49,20,29,4,3
11,489,489,129,129,0,1,0
4,495,495,20,9,11,2,1

7,114,114,1,1,0,1,0
17,161,161,2,2,0,1,0
21,169,169,9,2,7,2,1
5,218,218,5,5,0,1,0
4,221,221,1,1,0,1,0
11,229,229,49,49,0,1,0
1,258,258,25,25,0,1,0
15,274,274,7,7,0,1,0
10,275,275,30,30,0,1,0
0,285,285,15,7,8,2,1
9,294,294,14,4,10,2,1
6,301,301,4,4,0,1,0
22,307,307,12,12,0,1,0
20,316,316,19,19,0,1,0
3,328,328,7,1,6,3,2
2,334,334,2,2,0,1,0
13,354,354,44,44,0,1,0
16,377,377,81,66,15,4,3
14,378,378,7,7,0,1,0
8,381,381,86,42,44,4,3
19,382,382,23,13,10,2,1
18,396,396,95,95,0,1,0
23,428,428,131,35,96,4,3
12,434,434,16,2,14,2,1

9,154,154,7,7,0,1,0
1,165,165,10,4,6,2,1
5,215,215,28,7,21,4,3
11,225,225,16,16,0,1,0
7,248,248,4,4,0,1,0
8,265,265,110,63,47,2,1
12,294,294,20,20,0,1,0
3,323,323,150,105,45,4,3
4,332,332,14,4,10,2,1
0,417,417,70,2,68,3,2
6,488,488,105,58,47,4,3
10,491,491,5,5,0,1,0
2,496,496,153,78,75,4,3

8,123,123,23,23,0,1,0
1,141,141,46,15,31,2,1
9,185,185,24,24,0,1,0
14,222,222,34,34,0,1,0
5,234,234,10,10,0,1,0
0,245,245,16,16,0,1,0
10,247,247,50,10,40,3,2
13,273,273,8,2,6,2,1
11,287,287,20,2,18,2,1
2,294,294,54,21,33,3,2
4,312,312,46,46,0,1,0
12,328,328,4,1,3,2,1
6,397,397,14,7,7,2,1
7,398,398,33,33,0,1,0
15,414,414,62,11,51,4,3
3,451,451,90,54,36,2,1

6,106,106,5,1,4,2,1
18,107,107,6,6,0,1,0
7,119,119,34,11,23,2,1
16,263,263,32,26,6,3,2
1,266,266,1,1,0,1,0
15,278,278,31,10,21,2,1
4,279,279,45,45,0,1,0
11,280,280,155,12,143,4,3
3,293,293,10,10,0,1,0
9,298,298,62,62,0,1,0
10,298,298,10,10,0,1,0
13,299,299,13,13,0,1,0
12,318,318,4,4,0,1,0
5,364,364,51,7,44,3,2
0,451,451,11,11,0,1,0
2,453,453,9,5,4,2,1
8,455,455,35,35,0,1,0
17,474,474,13,13,0,1,0
14,486,486,30,30,0,1,0

18,116,116,3,3,0,1,0
6,164,164,12,6,6,2,1
12,169,169,2,2,0,1,0
0,187,187,27,27,0,1,0
16,197,197,9,3,6,2,1
3,203,203,22,13,9,4,3
11,214,214,2,2,0,1,0
4,247,247,1,1,0,1,0
7,249,249,24,5,19,4,3
13,275,275,13,13,0,1,0
8,285,285,58,38,20,2,1
20,287,287,77,77,0,1,0
5,315,315,4,4,0,1,0
2,328,328,14,14,0,1,0
10,334,334,7,7,0,1,0
1,335,335,59,50,9,4,3
17,373,373,178,158,20,2,1
9,395,395,44,44,0,1,0
15,409,409,51,51,0,1,0
14,429,429,5,5,0,1,0
19,490,490,4,4,0,1,0

4,113,113,6,6,0,1,0
16,118,118,5,5,0,1,0
19,127,127,3,3,0,1,0
23,142,142,4,4,0,1,0
11,154,154,11,2,9,2,1
18,163,163,9,9,0,1,0
0,189,189,41,41,0,1,0
8,212,212,4,1,3,2,1
20,253,253,7,7,0,1,0
24,281,281,73,57,16,3,2
7,293,293,3,3,0,1,0
1,314,314,12,2,10,3,2
17,320,320,20,8,12,2,1
21,343,343,35,6,29,2,1
2,358,358,19,1,18,2,1
5,379,379,7,7,0,1,0
22,399,399,79,16,63,4,3
9,411,411,15,5,10,3,2
3,414,414,13,13,0,1,0
6,434,434,40,12,28,3,2
14,444,444,44,44,0,1,0
12,448,448,31,31,0,1,0
13,458,458,20,5,15,4,3
10,479,479,31,31,0,1,0
25,480,480,125,125,0,1,0
15,500,500,21,13,8,2,1

7,106,106,18,18,0,1,0
8,106,106,17,5,12,3,2
12,163,163,2,2,0,1,0
9,182,182,3,3,0,1,0
6,194,194,33,33,0,1,0
11,199,199,21,21,0,1,0
10,208,208,35,27,8,2,1
4,268,268,45,45,0,1,0
3,323,323,1,1,0,1,0
5,413,413,81,81,0,1,0
1,421,421,46,46,0,1,0
2,451,451,287,287,0,1,0
13,480,480,11,11,0,1,0
0,487,487,42,42,0,1,0

12,103,103,2,2,0,1,0
17,121,121,3,3,0,1,0
7,136,136,1,1,0,1,0
2,156,156,44,44,0,1,0
3,167,167,1,1,0,1,0
6,195,195,13,5,8,2,1
11,199,199,12,12,0,1,0
13,225,225,1,1,0,1,0
19,283,283,37,6,31,2,1
10,311,311,29,29,0,1,0
4,315,315,13,1,12,2,1
5,315,315,10,10,0,1,0
18,317,317,1,1,0,1,0
20,334,334,52,52,0,1,0
15,344,344,5,5,0,1,0
8,350,350,30,14,16,4,3
1,366,366,38,38,0,1,0
22,374,374,74,2,72,4,3
16,409,409,2,2,0,1,0
14,434,434,12,7,5,2,1
23,461,461,63,63,0,1,0
24,462,462,160,116,44,3,2
9,478,478,53,53,0,1,0
0,488,488,22,1,21,4,3
21,498,498,5,1,4,2,1

10,131,131,2,2,0,1,0
14,188,188,26,19,7,2,1
8,192,192,88,77,11,2,1
6,198,198,2,2,0,1,0
1,222,222,59,3,56,3,2
7,240,240,15,15,0,1,0
11,250,250,5,5,0,1,0
12,252,252,6,6,0,1,0
0,253,253,36,27,9,2,1
15,267,267,26,4,22,3,2
4,268,268,27,2,25,3,2
9,288,288,40,40,0,1,0
16,294,294,6,6,0,1,0
13,305,305,34,34,0,1,0
2,365,365,58,16,42,2,1
5,413,413,76,76,0,1,0
3,435,435,33,30,3,2,1

16,113,113,41,13,28,4,3
8,114,114,15,15,0,1,0
3,114,114,10,10,0,1,0
13,176,176,6,6,0,1,0
19,243,243,11,11,0,1,0
15,267,267,74,44,30,4,3
1,310,310,10,1,9,4,3
10,319,319,7,3,4,2,1
0,331,331,8,8,0,1,0
11,334,334,25,1,24,3,2
5,371,371,20,20,0,1,0
14,380,380,39,39,0,1,0
2,387,387,20,12,8,2,1
18,388,388,19,4,15,2,1
9,396,396,84,78,6,2,1
7,419,419,90,63,27,2,1
6,424,424,55,55,0,1,0
4,451,451,19,1,18,2,1
12,486,486,25,25,0,1,0
17,497,497,11,5,6,3,2

12,104,104,1,1,0,1,0
0,123,123,1,1,0,1,0
2,153,153,14,4,10,3,2
7,156,156,21,5,16,3,2
10,160,160,41,41,0,1,0
3,161,161,6,3,3,2,1
16,205,205,55,55,0,1,0
17,216,216,77,65,12,4,3
8,223,223,12,12,0,1,0
18,234,234,23,23,0,1,0
9,237,237,46,1,45,4,3
19,239,239,10,4,6,2,1
13,242,242,32,32,0,1,0
4,267,267,9,9,0,1,0
11,319,319,29,29,0,1,0
5,358,358,24,9,15,4,3
20,375,375,25,25,0,1,0
15,376,376,17,17,0,1,0
14,415,415,1,1,0,1,0
1,452,452,7,7,0,1,0
6,455,455,9,9,0,1,0

11,108,108,2,2,0,1,0
17,112,112,16,11,5,2,1
14,189,189,1,1,0,1,0
8,194,194,2,2,0,1,0
9,234,234,20,20,0,1,0
0,285,285,99,45,54,3,2
4,298,298,44,19,25,4,3
10,310,310,35,35,0,1,0
12,332,332,219,166,53,4,3
3,357,357,24,12,12,2,1
2,367,367,38,21,17,3,2
7,372,372,1,1,0,1,0
6,379,379,37,1,36,3,2
5,387,387,30,14,16,2,1
1,408,408,25,25,0,1,0
18,409,409,22,22,0,1,0
16,440,440,4,4,0,1,0
15,474,474,2,2,0,1,0
13,493,493,4,1,3,2,1

12,117,117,4,4,0,1,0
17,122,122,7,7,0,1,0
13,161,161,34,14,20,2,1
15,191,191,29,29,0,1,0
7,199,199,32,11,21,3,2
2,204,204,5,5,0,1,0
3,241,241,1,1,0,1,0
8,260,260,49,6,43,2,1
14,284,284,65,18,47,2,1
9,285,285,39,31,8,2,1
1,287,287,73,73,0,1,0
4,322,322,6,3,3,2,1
6,375,375,30,8,22,2,1
0,429,429,89,8,81,4,3
5,431,431,28,8,20,2,1
10,438,438,30,30,0,1,0
16,475,475,8,8,0,1,0
11,493,493,59,59,0,1,0

24,114,114,33,4,29,2,1
21,127,127,18,18,0,1,0
18,157,157,19,5,14,2,1
5,164,164,1,1,0,1,0
1,171,171,14,5,9,2,1
9,183,183,5,5,0,1,0
0,208,208,4,4,0,1,0
15,209,209,2,2,0,1,0
7,216,216,27,15,12,2,1
26,237,237,21,11,10,2,1
8,238,238,5,5,0,1,0
13,238,238,34,34,0,1,0
19,264,264,18,18,0,1,0
20,297,297,10,10,0,1,0
10,303,303,16,10,6,3,2
17,324,324,22,22,0,1,0
22,324,324,47,22,25,2,1
3,330,330,10,1,9,4,3
14,337,337,5,2,3,2,1
16,352,352,19,19,0,1,0
12,405,405,12,12,0,1,0
23,439,439,19,1,18,4,3
2,447,447,82,58,24,4,3
11,451,451,13,3,10,2,1
4,470,470,30,4,26,2,1
25,473,473,39,39,0,1,0
6,479,479,21,21,0,1,0

8,145,145,6,6,0,1,0
12,147,147,8,2,6,3,2
1,153,153,56,16,40,2,1
3,195,195,7,7,0,1,0
15,200,200,24,24,0,1,0
2,222,222,7,7,0,1,0
6,266,266,1,1,0,1,0
4,273,273,7,7,0,1,0
10,281,281,70,32,38,3,2
9,298,298,54,37,17,2,1
13,328,328,75,13,62,4,3
17,352,352,6,6,0,1,0
14,362,362,5,5,0,1,0
7,377,377,98,29,69,4,3
0,382,382,18,10,8,2,1
16,397,397,75,11,64,3,2
5,399,399,3,3,0,1,0
11,429,429,45,29,16,2,1
18,495,495,20,2,18,2,1

1,105,105,1,1,0,1,0
6,106,106,4,4,0,1,0
16,117,117,8,8,0,1,0
10,127,127,35,1,34,3,2
14,177,177,39,11,28,3,2
18,185,185,71,53,18,4,3
3,209,209,4,4,0,1,0
8,211,211,5,1,4,2,1
19,238,238,6,6,0,1,0
11,246,246,9,9,0,1,0
9,276,276,52,52,0,1,0
0,290,290,7,3,4,2,1
4,324,324,12,5,7,2,1
2,325,325,63,31,32,3,2
7,326,326,19,2,17,2,1
20,363,363,28,28,0,1,0
15,427,427,58,31,27,4,3
13,427,427,15,15,0,1,0
17,430,430,26,26,0,1,0
5,433,433,43,43,0,1,0
12,442,442,2,2,0,1,0

5,142,142,62,62,0,1,0
7,145,145,15,15,0,1,0
12,212,212,46,46,0,1,0
2,224,224,25,25,0,1,0
1,230,230,22,22,0,1,0
13,257,257,8,4,4,2,1
8,283,283,73,47,26,3,2
14,322,322,16,16,0,1,0
15,354,354,33,8,25,3,2
3,364,364,30,30,0,1,0
9,370,370,42,42,0,1,0
10,393,393,19,10,9,2,1
0,424,424,36,29,7,2,1
4,438,438,41,15,26,2,1
6,454,454,44,34,10,2,1
11,494,494,49,27,22,3,2

20,105,105,14,1,13,2,1
17,123,123,10,10,0,1,0
18,163,163,18,12,6,3,2
4,183,183,15,5,10,2,1
1,205,205,24,24,0,1,0
3,243,243,27,12,15,4,3
23,244,244,25,25,0,1,0
6,255,255,18,7,11,2,1
22,261,261,14,14,0,1,0
11,271,271,20,20,0,1,0
13,290,290,9,9,0,1,0
15,333,333,20,20,0,1,0
12,341,341,37,12,25,4,3
2,392,392,17,2,15,4,3
16,392,392,4,4,0,1,0
7,403,403,55,31,24,2,1
9,418,418,1,1,0,1,0
5,420,420,2,2,0,1,0
19,437,437,161,117,44,2,1
0,442,442,44,10,34,3,2
21,460,460,48,2,46,3,2
10,483,483,8,8,0,1,0
8,494,494,48,31,17,2,1
14,494,494,3,3,0,1,0

4,131,131,3,3,0,1,0
1,176,176,12,12,0,1,0
9,179,179,21,1,20,3,2
13,190,190,3,3,0,1,0
15,192,192,18,18,0,1,0
14,207,207,113,98,15,4,3
11,230,230,17,17,0,1,0
10,239,239,15,15,0,1,0
7,241,241,19,10,9,2,1
2,251,251,42,42,0,1,0
6,281,281,64,64,0,1,0
3,336,336,83,64,19,2,1
0,350,350,60,6,54,4,3
5,396,396,38,16,22,2,1
12,397,397,4,1,3,2,1
8,494,494,9,5,4,2,1

6,143,143,12,6,6,3,2
8,152,152,6,6,0,1,0
11,152,152,10,10,0,1,0
7,170,170,12,4,8,2,1
13,207,207,9,9,0,1,0
4,245,245,83,13,70,3,2
14,252,252,143,130,13,2,1
3,282,282,30,30,0,1,0
5,305,305,43,43,0,1,0
10,308,308,15,1,14,3,2
9,321,321,19,19,0,1,0
12,343,343,5,2,3,2,1
0,368,368,13,1,12,2,1
16,412,412,45,45,0,1,0
18,426,426,7,1,6,3,2
19,433,433,56,50,6,3,2
2,440,440,2,2,0,1,0
17,444,444,3,3,0,1,0
15,468,468,31,31,0,1,0
1,496,496,37,7,30,3,2

10,108,108,1,1,0,1,0
2,113,113,16,16,0,1,0
6,161,161,6,3,3,2,1
3,165,165,38,14,24,2,1
14,195,195,47,47,0,1,0
15,203,203,45,21,24,2,1
4,204,204,3,3,0,1,0
1,261,261,25,25,0,1,0
8,287,287,11,11,0,1,0
7,291,291,61,61,0,1,0
16,334,334,8,2,6,3,2
0,338,338,40,40,0,1,0
5,366,366,43,43,0,1,0
11,416,416,143,80,63,4,3
17,441,441,10,2,8,2,1
12,473,473,8,8,0,1,0
9,492,492,12,9,3,2,1
13,498,498,60,60,0,1,0

15,101,101,3,3,0,1,0
13,118,118,5,5,0,1,0
1,138,138,1,1,0,1,0
3,151,151,9,9,0,1,0
5,174,174,35,9,26,2,1
7,178,178,5,5,0,1,0
11,240,240,1,1,0,1,0
19,257,257,7,7,0,1,0
12,277,277,42,42,0,1,0
9,288,288,11,1,10,3,2
0,299,299,53,13,40,2,1
16,312,312,89,89,0,1,0
6,326,326,19,19,0,1,0
17,334,334,23,4,19,2,1
20,351,351,13,2,11,3,2
8,382,382,16,9,7,2,1
4,407,407,88,70,18,3,2
18,452,452,94,20,74,3,2
2,457,457,57,57,0,1,0
14,460,460,79,13,66,3,2
10,484,484,22,16,6,2,1

7,118,118,2,2,0,1,0
4,135,135,2,2,0,1,0
17,153,153,29,29,0,1,0
0,184,184,12,1,11,4,3
19,190,190,9,9,0,1,0
12,196,196,31,31,0,1,0
5,256,256,57,57,0,1,0
3,263,263,22,22,0,1,0
21,276,276,47,47,0,1,0
1,293,293,17,2,15,3,2
11,305,305,52,52,0,1,0
6,309,309,3,3,0,1,0
20,311,311,53,53,0,1,0
9,315,315,7,1,6,3,2
10,326,326,16,16,0,1,0
15,397,397,6,6,0,1,0
18,443,443,35,22,13,2,1
16,458,458,130,87,43,4,3
2,477,477,30,30,0,1,0
8,482,482,32,32,0,1,0
13,493,493,2,2,0,1,0
14,495,495,27,13,14,2,1

17,107,107,9,9,0,1,0
13,108,108,5,1,4,2,1
9,132,132,13,13,0,1,0
12,161,161,13,6,7,2,1
7,173,173,14,14,0,1,0
6,201,201,15,15,0,1,0
14,222,222,32,19,13,2,1
19,224,224,3,3,0,1,0
11,243,243,40,40,0,1,0
8,268,268,41,5,36,2,1
5,280,280,4,4,0,1,0
0,344,344,35,6,29,4,3
18,355,355,55,29,26,2,1
10,374,374,12,12,0,1,0
16,408,408,112,112,0,1,0
20,413,413,16,16,0,1,0
3,438,438,36,4,32,3,2
4,457,457,60,60,0,1,0
2,472,472,20,20,0,1,0
15,480,480,88,34,54,4,3
1,483,483,12,12,0,1,0

8,102,102,1,1,0,1,0
18,162,162,10,4,6,2,1
6,167,167,33,23,10,3,2
1,180,180,13,1,12,2,1
15,183,183,33,33,0,1,0
3,184,184,3,3,0,1,0
16,184,184,20,20,0,1,0
17,189,189,16,13,3,2,1
22,234,234,11,5,6,2,1
10,263,263,47,31,16,3,2
2,279,279,15,2,13,2,1
7,285,285,33,33,0,1,0
12,294,294,1,1,0,1,0
9,295,295,3,3,0,1,0
21,299,299,14,14,0,1,0
14,315,315,3,3,0,1,0
20,359,359,146,146,0,1,0
19,368,368,26,17,9,4,3
4,373,373,39,39,0,1,0
5,397,397,46,46,0,1,0
0,398,398,15,15,0,1,0
13,447,447,16,16,0,1,0
11,488,488,24,24,0,1,0

12,129,129,66,66,0,1,0
4,130,130,5,5,0,1,0
18,141,141,9,3,6,3,2
11,141,141,33,2,31,4,3
16,214,214,13,13,0,1,0
15,276,276,21,5,16,2,1
7,287,287,14,4,10,3,2
13,315,315,5,1,4,2,1
17,356,356,5,5,0,1,0
3,363,363,4,1,3,2,1
14,366,366,15,15,0,1,0
1,375,375,7,7,0,1,0
5,382,382,18,15,3,2,1
8,407,407,28,28,0,1,0
0,425,425,45,45,0,1,0
9,435,435,51,44,7,2,1
2,457,457,19,19,0,1,0
6,473,473,238,144,94,3,2
10,483,483,3,3,0,1,0

12,112,112,22,22,0,1,0
15,115,115,18,3,15,2,1
10,119,119,8,8,0,1,0
5,170,170,2,2,0,1,0
2,191,191,6,6,0,1,0
6,210,210,42,33,9,2,1
13,230,230,33,33,0,1,0
16,235,235,12,12,0,1,0
0,304,304,63,19,44,4,3
1,305,305,41,29,12,3,2
3,343,343,15,7,8,3,2
14,354,354,59,33,26,2,1
8,369,369,89,83,6,3,2
7,373,373,40,40,0,1,0
11,453,453,27,27,0,1,0
4,456,456,11,5,6,3,2
9,472,472,29,14,15,4,3
17,483,483,57,42,15,4,3

19,126,126,21,14,7,2,1
10,160,160,5,5,0,1,0
20,162,162,2,2,0,1,0
13,163,163,10,10,0,1,0
0,231,231,21,21,0,1,0
8,274,274,12,9,3,2,1
1,277,277,7,3,4,2,1
7,280,280,12,12,0,1,0
5,314,314,59,41,18,4,3
2,316,316,48,2,46,4,3
16,318,318,41,36,5,2,1
15,326,326,21,12,9,2,1
9,331,331,5,5,0,1,0
3,333,333,12,12,0,1,0
23,335,335,23,23,0,1,0
4,359,359,36,10,26,3,2
21,369,369,23,23,0,1,0
24,382,382,51,51,0,1,0
14,384,384,2,2,0,1,0
11,387,387,27,5,22,3,2
17,434,434,79,25,54,4,3
6,439,439,8,8,0,1,0
12,448,448,25,22,3,2,1
18,484,484,106,106,0,1,0
22,486,486,18,18,0,1,0

6,101,101,15,6,9,4,3
15,108,108,2,2,0,1,0
7,149,149,4,1,3,2,1
4,151,151,20,9,11,2,1
14,172,172,17,5,12,2,1
3,188,188,18,14,4,2,1
5,188,188,72,26,46,3,2
16,214,214,17,11,6,3,2
2,222,222,20,20,0,1,0
13,225,225,7,7,0,1,0
8,245,245,37,37,0,1,0
1,264,264,23,11,12,2,1
12,271,271,24,8,16,2,1
0,273,273,10,6,4,2,1
11,305,305,117,79,38,3,2
9,314,314,43,11,32,3,2
10,391,391,12,12,0,1,0

20,173,173,8,4,4,2,1
21,207,207,13,7,6,3,2
18,237,237,4,1,3,2,1
19,246,246,25,25,0,1,0
16,262,262,24,12,12,3,2
10,278,278,71,23,48,3,2
11,280,280,1,1,0,1,0
2,293,293,51,9,42,2,1
1,296,296,6,1,5,2,1
15,340,340,25,19,6,2,1
6,354,354,16,2,14,2,1
14,375,375,37,37,0,1,0
22,390,390,168,168,0,1,0
0,398,398,1,1,0,1,0
9,408,408,12,12,0,1,0
4,414,414,17,14,3,2,1
8,417,417,7,7,0,1,0
12,422,422,26,26,0,1,0
7,452,452,29,24,5,2,1
17,478,478,45,30,15,2,1
13,491,491,7,7,0,1,0
3,495,495,90,40,50,2,1
5,499,499,45,45,0,1,0

23,108,108,20,20,0,1,0
18,118,118,8,2,6,2,1
14,129,129,5,5,0,1,0
11,196,196,1,1,0,1,0
8,197,197,5,5,0,1,0
20,202,202,7,7,0,1,0
10,213,213,16,8,8,3,2
15,239,239,32,32,0,1,0
19,258,258,52,52,0,1,0
1,290,290,6,6,0,1,0
21,300,300,23,23,0,1,0
0,322,322,5,5,0,1,0
13,343,343,50,50,0,1,0
5,345,345,42,42,0,1,0
6,351,351,1,1,0,1,0
22,363,363,88,46,42,2,1
7,418,418,33,33,0,1,0
12,426,426,12,5,7,2,1
3,440,440,17,7,10,2,1
17,446,446,17,7,10,3,2
4,450,450,92,17,75,4,3
16,453,453,11,11,0,1,0
9,467,467,11,11,0,1,0
24,470,470,67,43,24,3,2
2,481,481,20,20,0,1,0

15,118,118,29,3,26,2,1
13,138,138,21,13,8,2,1
19,157,157,24,9,15,4,3
0,182,182,1,1,0,1,0
2,189,189,2,2,0,1,0
1,192,192,2,2,0,1,0
6,196,196,1,1,0,1,0
4,260,260,17,17,0,1,0
16,260,260,2,2,0,1,0
17,266,266,36,36,0,1,0
7,285,285,56,41,15,2,1
14,305,305,6,6,0,1,0
18,319,319,49,49,0,1,0
5,325,325,41,41,0,1,0
11,388,388,2,2,0,1,0
9,428,428,133,100,33,4,3
8,467,467,8,8,0,1,0
3,470,470,96,96,0,1,0
12,472,472,70,31,39,3,2
10,484,484,24,3,21,2,1

17,101,101,10,2,8,3,2
3,108,108,32,32,0,1,0
15,114,114,4,4,0,1,0
0,153,153,1,1,0,1,0
16,162,162,2,2,0,1,0
6,169,169,21,6,15,4,3
2,214,214,75,33,42,3,2
5,221,221,20,6,14,3,2
9,233,233,50,50,0,1,0
4,234,234,1,1,0,1,0
13,253,253,5,5,0,1,0
7,294,294,6,6,0,1,0
8,296,296,7,2,5,2,1
12,359,359,50,50,0,1,0
1,419,419,36,36,0,1,0
10,453,453,145,101,44,3,2
11,453,453,44,35,9,4,3
14,455,455,37,37,0,1,0

19,102,102,16,6,10,3,2
17,103,103,3,3,0,1,0
21,107,107,23,5,18,2,1
10,111,111,16,16,0,1,0
2,124,124,4,1,3,2,1
8,149,149,2,2,0,1,0
3,185,185,24,24,0,1,0
20,223,223,4,4,0,1,0
5,230,230,5,5,0,1,0
0,236,236,15,15,0,1,0
15,240,240,3,3,0,1,0
11,270,270,37,28,9,4,3
22,271,271,21,21,0,1,0
9,326,326,78,78,0,1,0
6,352,352,10,10,0,1,0
12,385,385,27,1,26,2,1
7,385,385,15,15,0,1,0
13,402,402,21,11,10,2,1
4,447,447,8,8,0,1,0
14,452,452,64,49,15,2,1
16,465,465,132,132,0,1,0
18,480,480,42,42,0,1,0
1,484,484,6,6,0,1,0

21,104,104,24,24,0,1,0
24,106,106,3,3,0,1,0
25,113,113,1,1,0,1,0
11,117,117,1,1,0,1,0
1,151,151,9,9,0,1,0
23,171,171,45,45,0,1,0
3,180,180,3,3,0,1,0
10,188,188,8,1,7,2,1
7,196,196,5,5,0,1,0
16,221,221,11,11,0,1,0
22,241,241,18,18,0,1,0
18,255,255,1,1,0,1,0
15,266,266,2,2,0,1,0
2,274,274,6,3,3,2,1
12,275,275,1,1,0,1,0
19,276,276,4,4,0,1,0
6,284,284,31,1,30,4,3
4,285,285,17,17,0,1,0
5,370,370,25,4,21,2,1
14,378,378,31,5,26,2,1
8,408,408,23,23,0,1,0
17,411,411,16,1,15,3,2
13,453,453,28,28,0,1,0
0,476,476,116,2,114,4,3
20,492,492,94,94,0,1,0
27,492,492,16,16,0,1,0
26,498,498,90,90,0,1,0
9,499,499,22,18,4,2,1

3,103,103,11,2,9,2,1
11,108,108,8,4,4,2,1
17,135,135,9,9,0,1,0
6,138,138,7,7,0,1,0
0,167,167,10,1,9,4,3
19,173,173,31,31,0,1,0
16,175,175,19,19,0,1,0
9,176,176,22,22,0,1,0
20,192,192,34,34,0,1,0
7,200,200,17,17,0,1,0
5,205,205,19,9,10,3,2
15,207,207,21,21,0,1,0
4,211,211,12,2,10,2,1
14,217,217,5,2,3,2,1
13,248,248,19,7,12,3,2
8,260,260,26,26,0,1,0
10,289,289,3,3,0,1,0
2,294,294,70,26,44,3,2
18,307,307,48,37,11,2,1
12,370,370,49,28,21,2,1
1,483,483,3,3,0,1,0

9,108,108,4,4,0,1,0
6,130,130,1,1,0,1,0
12,139,139,5,5,0,1,0
27,149,149,16,2,14,3,2
26,191,191,24,12,12,2,1
16,245,245,3,3,0,1,0
25,284,284,15,15,0,1,0
7,294,294,74,22,52,3,2
21,298,298,56,17,39,4,3
19,306,306,49,19,30,2,1
0,317,317,1,1,0,1,0
5,320,320,55,3,52,3,2
13,327,327,2,2,0,1,0
8,334,334,17,17,0,1,0
18,336,336,1,1,0,1,0
28,348,348,35,35,0,1,0
20,352,352,12,12,0,1,0
4,352,352,12,3,9,4,3
10,372,372,4,4,0,1,0
17,379,379,2,2,0,1,0
14,379,379,12,5,7,2,1
1,385,385,3,3,0,1,0
24,397,397,122,122,0,1,0
15,418,418,38,38,0,1,0
2,435,435,5,5,0,1,0
23,454,454,27,27,0,1,0
11,489,489,27,27,0,1,0
22,489,489,20,6,14,3,2
3,494,494,7,7,0,1,0

13,106,106,2,2,0,1,0
3,129,129,11,5,6,2,1
10,164,164,15,2,13,3,2
0,173,173,24,24,0,1,0
16,173,173,30,30,0,1,0
17,192,192,2,2,0,1,0
8,206,206,8,8,0,1,0
15,227,227,86,86,0,1,0
1,319,319,34,34,0,1,0
18,321,321,32,6,26,2,1
14,321,321,39,23,16,3,2
7,364,364,12,12,0,1,0
6,386,386,60,60,0,1,0
9,407,407,36,36,0,1,0
2,411,411,1,1,0,1,0
11,469,469,27,9,18,4,3
5,486,486,18,18,0,1,0
4,490,490,155,26,129,4,3
12,495,495,30,24,6,2,1

0,109,109,2,2,0,1,0
1,113,113,4,4,0,1,0
22,152,152,21,21,0,1,0
15,166,166,5,5,0,1,0
21,174,174,18,18,0,1,0
2,180,180,16,7,9,2,1
10,199,199,8,8,0,1,0
9,204,204,9,9,0,1,0
6,211,211,2,2,0,1,0
16,248,248,46,46,0,1,0
14,261,261,10,2,8,2,1
3,286,286,38,9,29,2,1
17,296,296,20,15,5,2,1
5,306,306,8,8,0,1,0
12,341,341,3,3,0,1,0
4,346,346,34,34,0,1,0
19,350,350,32,32,0,1,0
20,396,396,8,2,6,2,1
8,424,424,70,40,30,4,3
7,425,425,123,63,60,3,2
11,448,448,15,15,0,1,0
13,471,471,5,1,4,2,1
18,495,495,171,171,0,1,0

14,108,108,3,3,0,1,0
5,114,114,1,1,0,1,0
19,143,143,7,7,0,1,0
12,165,165,21,3,18,4,3
21,173,173,4,4,0,1,0
3,186,186,4,4,0,1,0
16,190,190,42,3,39,3,2
18,196,196,32,17,15,2,1
13,199,199,65,56,9,4,3
20,251,251,48,48,0,1,0
1,329,329,3,3,0,1,0
8,334,334,8,1,7,2,1
7,374,374,22,22,0,1,0
9,381,381,13,3,10,2,1
0,389,389,9,3,6,3,2
15,398,398,1,1,0,1,0
10,402,402,108,75,33,2,1
17,415,415,9,3,6,2,1
11,460,460,42,32,10,2,1
4,477,477,118,64,54,4,3
6,496,496,44,1,43,3,2
2,497,497,1,1,0,1,0

12,154,154,35,2,33,4,3
20,197,197,38,20,18,3,2
10,202,202,23,23,0,1,0
16,202,202,29,29,0,1,0
19,225,225,16,16,0,1,0
11,241,241,11,11,0,1,0
13,256,256,6,6,0,1,0
9,256,256,2,2,0,1,0
8,297,297,38,38,0,1,0
0,332,332,56,56,0,1,0
6,332,332,38,38,0,1,0
3,358,358,27,27,0,1,0
1,361,361,5,5,0,1,0
5,367,367,43,19,24,3,2
17,369,369,33,15,18,4,3
14,372,372,25,7,18,2,1
18,379,379,70,28,42,2,1
4,391,391,25,25,0,1,0
2,441,441,22,22,0,1,0
15,444,444,9,3,6,2,1
7,482,482,49,33,16,2,1

5,114,114,27,18,9,4,3
0,117,117,15,4,11,2,1
12,140,140,4,4,0,1,0
16,143,143,57,24,33,2,1
1,150,150,5,5,0,1,0
2,156,156,1,1,0,1,0
19,156,156,4,4,0,1,0
17,208,208,27,6,21,2,1
22,219,219,4,4,0,1,0
21,221,221,8,8,0,1,0
13,245,245,4,4,0,1,0
11,312,312,14,11,3,2,1
3,320,320,13,3,10,3,2
9,322,322,7,7,0,1,0
4,339,339,4,1,3,2,1
15,341,341,7,1,6,3,2
7,355,355,33,33,0,1,0
23,365,365,61,61,0,1,0
10,379,379,19,5,14,2,1
20,386,386,47,26,21,4,3
6,398,398,8,8,0,1,0
8,448,448,69,69,0,1,0
18,452,452,45,30,15,2,1
14,470,470,54,54,0,1,0

2,102,102,6,3,3,2,1
9,133,133,1,1,0,1,0
7,142,142,17,8,9,4,3
20,146,146,16,7,9,4,3
3,159,159,1,1,0,1,0
13,164,164,3,3,0,1,0
5,172,172,33,33,0,1,0
19,181,181,9,9,0,1,0
6,206,206,1,1,0,1,0
0,238,238,33,33,0,1,0
1,275,275,33,3,30,4,3
15,284,284,8,8,0,1,0
4,304,304,83,83,0,1,0
16,330,330,23,5,18,2,1
18,355,355,10,2,8,3,2
12,386,386,67,67,0,1,0
17,390,390,158,31,127,4,3
10,401,401,9,9,0,1,0
8,412,412,14,9,5,2,1
11,430,430,10,10,0,1,0
14,487,487,67,58,9,4,3

17,102,102,2,2,0,1,0
14,113,113,5,1,4,2,1
15,132,132,17,17,0,1,0
2,136,136,3,3,0,1,0
4,139,139,13,13,0,1,0
0,182,182,5,5,0,1,0
3,212,212,48,48,0,1,0
1,221,221,11,3,8,3,2
7,230,230,43,43,0,1,0
12,239,239,37,26,11,2,1
10,255,255,1,1,0,1,0
13,260,260,80,44,36,3,2
8,317,317,7,4,3,2,1
16,346,346,50,14,36,4,3
18,349,349,27,27,0,1,0
5,376,376,18,11,7,2,1
19,406,406,26,16,10,3,2
6,407,407,2,2,0,1,0
9,430,430,41,19,22,3,2
11,436,436,30,2,28,3,2
20,437,437,63,48,15,4,3
21,474,474,45,21,24,4,3

21,110,110,2,2,0,1,0
1,111,111,9,9,0,1,0
7,143,143,1,1,0,1,0
9,155,155,25,25,0,1,0
23,159,159,3,3,0,1,0
18,172,172,55,55,0,1,0
17,189,189,6,6,0,1,0
3,207,207,13,1,12,4,3
16,283,283,16,16,0,1,0
6,307,307,33,33,0,1,0
15,330,330,14,10,4,2,1
8,360,360,27,27,0,1,0
22,361,361,16,16,0,1,0
11,376,376,23,14,9,2,1
13,385,385,1,1,0,1,0
0,397,397,37,1,36,4,3
20,424,424,198,177,21,4,3
2,442,442,71,32,39,4,3
19,447,447,9,9,0,1,0
14,455,455,29,29,0,1,0
12,455,455,9,9,0,1,0
10,466,466,12,8,4,2,1
4,471,471,23,23,0,1,0
5,492,492,15,15,0,1,0

21,114,114,29,29,0,1,0
9,140,140,6,6,0,1,0
15,159,159,2,2,0,1,0
11,198,198,1,1,0,1,0
10,272,272,8,1,7,2,1
2,300,300,17,1,16,2,1
17,318,318,5,5,0,1,0
0,325,325,9,4,5,2,1
4,357,357,49,3,46,3,2
5,358,358,25,13,12,4,3
13,367,367,34,34,0,1,0
20,380,380,43,32,11,2,1
3,384,384,88,14,74,3,2
6,386,386,4,1,3,2,1
16,396,396,27,27,0,1,0
19,401,401,110,95,15,2,1
1,434,434,33,29,4,2,1
8,479,479,29,29,0,1,0
18,484,484,56,56,0,1,0
7,487,487,61,61,0,1,0
12,490,490,64,64,0,1,0
14,496,496,36,17,19,2,1

4,112,112,7,7,0,1,0
1,134,134,68,55,13,2,1
12,165,165,3,3,0,1,0
14,170,170,69,62,7,2,1
8,212,212,88,88,0,1,0
5,311,311,19,12,7,3,2
3,342,342,48,32,16,3,2
0,384,384,24,24,0,1,0
2,384,384,29,29,0,1,0
6,384,384,35,23,12,2,1
15,385,385,13,13,0,1,0
13,419,419,36,36,0,1,0
11,440,440,9,9,0,1,0
9,462,462,8,8,0,1,0
7,471,471,5,5,0,1,0
10,496,496,4,4,0,1,0

14,145,145,3,3,0,1,0
5,203,203,46,7,39,4,3
8,221,221,13,13,0,1,0
17,229,229,8,3,5,2,1
2,242,242,66,1,65,4,3
16,279,279,27,1,26,2,1
3,323,323,4,4,0,1,0
12,353,353,65,23,42,3,2
4,385,385,5,2,3,2,1
6,392,392,109,51,58,4,3
1,394,394,46,46,0,1,0
15,397,397,21,21,0,1,0
10,432,432,33,13,20,2,1
7,441,441,1,1,0,1,0
13,442,442,83,83,0,1,0
0,445,445,9,9,0,1,0
9,468,468,145,135,10,2,1
11,493,493,23,11,12,2,1

5,143,143,19,8,11,3,2
9,159,159,24,24,0,1,0
4,171,171,72,72,0,1,0
7,180,180,20,20,0,1,0
10,212,212,20,20,0,1,0
13,220,220,6,6,0,1,0
12,230,230,8,8,0,1,0
3,234,234,29,29,0,1,0
1,236,236,29,23,6,3,2
11,245,245,20,15,5,2,1
8,254,254,69,69,0,1,0
0,363,363,72,72,0,1,0
6,416,416,49,43,6,3,2
2,475,475,65,45,20,3,2

8,105,105,1,1,0,1,0
1,115,115,13,13,0,1,0
17,132,132,1,1,0,1,0
13,145,145,3,3,0,1,0
4,149,149,20,6,14,2,1
7,183,183,13,13,0,1,0
10,185,185,61,11,50,3,2
12,219,219,11,11,0,1,0
9,226,226,51,24,27,4,3
6,241,241,7,7,0,1,0
16,261,261,25,16,9,2,1
3,352,352,12,12,0,1,0
14,361,361,12,12,0,1,0
0,372,372,46,46,0,1,0
11,388,388,69,51,18,4,3
18,399,399,50,38,12,2,1
15,400,400,69,60,9,4,3
2,419,419,66,66,0,1,0
5,447,447,46,46,0,1,0

17,100,100,16,2,14,2,1
1,139,139,10,10,0,1,0
9,146,146,6,6,0,1,0
0,148,148,9,9,0,1,0
10,159,159,6,3,3,2,1
19,185,185,31,19,12,4,3
15,256,256,23,23,0,1,0
16,264,264,3,3,0,1,0
20,280,280,53,53,0,1,0
14,284,284,26,1,25,2,1
4,319,319,28,1,27,4,3
5,338,338,115,33,82,3,2
8,342,342,2,2,0,1,0
13,390,390,61,61,0,1,0
18,397,397,46,15,31,2,1
6,414,414,59,5,54,4,3
11,415,415,17,11,6,2,1
2,430,430,1,1,0,1,0
7,438,438,33,33,0,1,0
12,453,453,18,3,15,2,1
3,462,462,44,44,0,1,0

10,111,111,5,2,3,2,1
3,139,139,6,6,0,1,0
14,166,166,80,80,0,1,0
13,182,182,14,14,0,1,0
5,192,192,34,18,16,2,1
0,259,259,44,23,21,4,3
6,270,270,14,14,0,1,0
7,289,289,21,21,0,1,0
2,315,315,5,5,0,1,0
9,317,317,37,37,0,1,0
15,319,319,6,6,0,1,0
4,359,359,12,12,0,1,0
1,367,367,104,104,0,1,0
17,389,389,4,1,3,2,1
18,402,402,27,27,0,1,0
8,440,440,17,17,0,1,0
12,468,468,15,3,12,3,2
11,468,468,122,51,71,4,3
16,483,483,12,12,0,1,0

11,101,101,1,1,0,1,0
12,110,110,7,7,0,1,0
17,110,110,5,1,4,2,1
14,206,206,37,37,0,1,0
1,249,249,24,15,9,4,3
20,251,251,25,25,0,1,0
13,264,264,1,1,0,1,0
4,293,293,63,63,0,1,0
6,330,330,2,2,0,1,0
16,331,331,29,26,3,2,1
3,338,338,21,12,9,2,1
0,340,340,5,5,0,1,0
15,340,340,159,159,0,1,0
2,353,353,11,2,9,2,1
19,358,358,4,4,0,1,0
5,376,376,71,41,30,4,3
21,387,387,7,7,0,1,0
7,402,402,12,5,7,2,1
18,461,461,50,50,0,1,0
9,499,499,28,10,18,4,3
10,500,500,75,75,0,1,0
8,500,500,41,41,0,1,0

4,107,107,10,10,0,1,0
15,125,125,43,43,0,1,0
11,136,136,16,13,3,2,1
2,138,138,5,5,0,1,0
9,142,142,1,1,0,1,0
12,168,168,32,32,0,1,0
6,177,177,9,9,0,1,0
17,194,194,7,7,0,1,0
19,203,203,20,20,0,1,0
18,224,224,1,1,0,1,0
10,237,237,45,45,0,1,0
14,266,266,35,35,0,1,0
3,283,283,35,7,28,3,2
1,283,283,5,5,0,1,0
13,289,289,20,20,0,1,0
0,296,296,20,11,9,4,3
8,299,299,27,27,0,1,0
5,323,323,62,62,0,1,0
16,410,410,13,9,4,2,1
7,466,466,63,63,0,1,0

0,118,118,1,1,0,1,0
4,126,126,1,1,0,1,0
8,145,145,6,6,0,1,0
7,177,177,11,2,9,2,1
14,181,181,33,33,0,1,0
21,191,191,2,2,0,1,0
2,191,191,1,1,0,1,0
13,199,199,27,27,0,1,0
9,203,203,8,8,0,1,0
11,206,206,23,23,0,1,0
1,243,243,26,7,19,2,1
10,249,249,2,2,0,1,0
17,258,258,81,63,18,3,2
5,261,261,109,22,87,4,3
12,277,277,25,16,9,2,1
16,287,287,48,27,21,2,1
15,353,353,6,6,0,1,0
20,360,360,30,30,0,1,0
3,394,394,2,2,0,1,0
6,395,395,38,38,0,1,0
19,468,468,8,5,3,2,1
18,481,481,44,44,0,1,0

3,112,112,1,1,0,1,0
20,114,114,20,10,10,3,2
5,118,118,9,5,4,2,1
17,118,118,32,14,18,3,2
8,122,122,3,3,0,1,0
24,143,143,19,4,15,2,1
0,195,195,6,6,0,1,0
4,214,214,34,10,24,2,1
11,241,241,7,7,0,1,0
7,263,263,6,6,0,1,0
2,293,293,38,22,16,3,2
22,295,295,40,33,7,2,1
10,318,318,17,17,0,1,0
14,335,335,5,5,0,1,0
23,352,352,23,23,0,1,0
15,376,376,25,25,0,1,0
12,403,403,23,23,0,1,0
18,413,413,5,5,0,1,0
9,416,416,66,4,62,4,3
13,458,458,3,3,0,1,0
1,476,476,73,43,30,2,1
6,476,476,5,5,0,1,0
16,479,479,10,3,7,2,1
21,479,479,51,51,0,1,0
19,483,483,47,5,42,4,3

11,102,102,37,6,31,4,3
16,123,123,4,4,0,1,0
13,132,132,13,13,0,1,0
12,142,142,22,22,0,1,0
18,166,166,5,5,0,1,0
14,171,171,18,18,0,1,0
15,186,186,24,24,0,1,0
8,197,197,6,6,0,1,0
3,252,252,20,20,0,1,0
9,281,281,42,20,22,3,2
17,284,284,20,9,11,2,1
4,299,299,110,98,12,3,2
19,305,305,13,13,0,1,0
6,307,307,2,2,0,1,0
0,312,312,6,6,0,1,0
1,376,376,45,8,37,3,2
2,389,389,3,3,0,1,0
5,404,404,22,10,12,2,1
7,461,461,13,3,10,3,2
10,490,490,68,48,20,2,1

2,136,136,26,26,0,1,0
21,168,168,17,3,14,2,1
7,178,178,11,6,5,2,1
9,206,206,2,2,0,1,0
0,220,220,20,20,0,1,0
15,226,226,16,16,0,1,0
3,242,242,28,22,6,3,2
10,251,251,24,6,18,4,3
22,264,264,9,2,7,2,1
11,265,265,20,2,18,2,1
18,283,283,36,36,0,1,0
1,312,312,26,26,0,1,0
16,319,319,20,11,9,2,1
6,322,322,3,3,0,1,0
13,346,346,2,2,0,1,0
14,367,367,11,11,0,1,0
12,414,414,90,90,0,1,0
5,433,433,3,3,0,1,0
8,444,444,12,12,0,1,0
20,464,464,23,11,12,4,3
17,488,488,138,123,15,4,3
19,488,488,126,126,0,1,0
4,491,491,6,1,5,2,1

10,108,108,2,2,0,1,0
14,118,118,36,2,34,2,1
15,135,135,44,44,0,1,0
8,147,147,11,11,0,1,0
0,153,153,2,2,0,1,0
6,158,158,39,33,6,2,1
17,160,160,17,11,6,2,1
7,186,186,16,16,0,1,0
11,289,289,41,41,0,1,0
5,298,298,11,7,4,2,1
1,329,329,62,62,0,1,0
2,342,342,99,43,56,3,2
4,352,352,21,3,18,4,3
13,402,402,6,2,4,2,1
9,407,407,1,1,0,1,0
12,426,426,14,2,12,4,3
18,430,430,7,7,0,1,0
16,472,472,26,26,0,1,0
3,479,479,2,2,0,1,0

0,126,126,22,1,21,3,2
10,157,157,2,2,0,1,0
8,169,169,6,6,0,1,0
11,204,204,63,55,8,2,1
17,209,209,2,2,0,1,0
2,211,211,10,5,5,2,1
1,223,223,23,23,0,1,0
16,226,226,26,26,0,1,0
6,249,249,10,7,3,2,1
9,267,267,58,17,41,2,1
5,290,290,7,1,6,2,1
14,335,335,47,47,0,1,0
18,342,342,53,53,0,1,0
3,374,374,60,60,0,1,0
19,396,396,23,23,0,1,0
4,465,465,67,67,0,1,0
7,483,483,22,22,0,1,0
13,486,486,88,76,12,4,3
12,497,497,2,2,0,1,0
15,499,499,20,12,8,3,2

11,124,124,19,19,0,1,0
2,181,181,6,6,0,1,0
8,198,198,7,7,0,1,0
9,211,211,4,4,0,1,0
10,215,215,5,5,0,1,0
12,224,224,48,48,0,1,0
5,230,230,3,3,0,1,0
13,250,250,27,18,9,4,3
6,289,289,87,87,0,1,0
1,302,302,46,34,12,3,2
4,355,355,4,4,0,1,0
0,417,417,132,63,69,3,2
7,423,423,68,63,5,2,1
3,442,442,216,198,18,4,3

22,111,111,7,1,6,3,2
4,113,113,1,1,0,1,0
10,124,124,8,8,0,1,0
24,145,145,20,3,17,2,1
5,150,150,4,1,3,2,1
16,177,177,1,1,0,1,0
1,179,179,27,27,0,1,0
21,189,189,54,23,31,4,3
19,225,225,43,10,33,4,3
2,269,269,1,1,0,1,0
12,270,270,1,1,0,1,0
3,280,280,8,2,6,2,1
13,289,289,13,13,0,1,0
15,299,299,54,54,0,1,0
0,317,317,14,14,0,1,0
23,327,327,48,18,30,2,1
11,347,347,26,20,6,3,2
14,363,363,57,57,0,1,0
6,391,391,22,7,15,4,3
9,414,414,20,20,0,1,0
8,421,421,45,45,0,1,0
7,449,449,1,1,0,1,0
20,459,459,28,9,19,2,1
18,470,470,15,3,12,2,1
17,495,495,47,47,0,1,0

12,106,106,6,3,3,2,1
17,107,107,7,7,0,1,0
15,120,120,48,48,0,1,0
11,152,152,8,2,6,2,1
2,173,173,11,11,0,1,0
7,185,185,9,9,0,1,0
10,213,213,3,3,0,1,0
13,267,267,50,50,0,1,0
9,288,288,77,77,0,1,0
3,298,298,58,22,36,3,2
16,310,310,21,21,0,1,0
0,345,345,50,50,0,1,0
4,350,350,22,5,17,2,1
8,352,352,5,1,4,2,1
14,374,374,37,37,0,1,0
6,443,443,7,7,0,1,0
18,458,458,37,37,0,1,0
5,483,483,46,16,30,3,2
1,485,485,46,19,27,2,1

0,104,104,3,3,0,1,0
13,116,116,10,1,9,4,3
19,120,120,38,38,0,1,0
24,125,125,3,3,0,1,0
14,139,139,20,8,12,4,3
16,159,159,41,41,0,1,0
21,163,163,6,6,0,1,0
7,167,167,1,1,0,1,0
22,171,171,11,11,0,1,0
8,190,190,1,1,0,1,0
17,217,217,34,1,33,4,3
18,244,244,2,2,0,1,0
6,256,256,33,33,0,1,0
5,258,258,6,6,0,1,0
23,265,265,25,25,0,1,0
9,268,268,2,2,0,1,0
12,287,287,15,2,13,2,1
2,342,342,4,4,0,1,0
11,343,343,1,1,0,1,0
15,407,407,7,7,0,1,0
1,460,460,65,41,24,3,2
20,466,466,28,28,0,1,0
3,471,471,73,73,0,1,0
4,480,480,76,76,0,1,0
10,487,487,16,16,0,1,0

13,100,100,3,3,0,1,0
4,152,152,10,1,9,2,1
14,153,153,32,14,18,2,1
9,155,155,16,16,0,1,0
7,164,164,9,5,4,2,1
12,167,167,47,47,0,1,0
6,233,233,43,43,0,1,0
0,254,254,54,4,50,2,1
3,275,275,7,4,3,2,1
15,275,275,4,4,0,1,0
5,367,367,51,42,9,4,3
1,405,405,71,53,18,4,3
8,420,420,44,39,5,2,1
11,437,437,55,55,0,1,0
2,445,445,89,55,34,2,1
10,460,460,45,45,0,1,0

21,122,122,10,1,9,2,1
14,125,125,16,16,0,1,0
19,132,132,25,7,18,2,1
13,149,149,34,6,28,2,1
12,160,160,14,14,0,1,0
17,160,160,16,1,15,4,3
11,163,163,7,7,0,1,0
7,167,167,8,5,3,2,1
10,168,168,12,6,6,3,2
3,187,187,1,1,0,1,0
0,212,212,3,3,0,1,0
5,214,214,23,14,9,2,1
1,220,220,32,10,22,3,2
8,255,255,7,7,0,1,0
16,258,258,11,11,0,1,0
2,324,324,104,46,58,4,3
6,357,357,7,7,0,1,0
4,363,363,21,21,0,1,0
18,377,377,7,3,4,2,1
15,378,378,51,51,0,1,0
9,405,405,23,11,12,3,2
20,431,431,40,40,0,1,0

11,157,157,13,13,0,1,0
1,174,174,36,14,22,2,1
2,210,210,4,4,0,1,0
16,249,249,47,47,0,1,0
10,253,253,45,16,29,4,3
15,277,277,16,1,15,4,3
17,285,285,48,48,0,1,0
13,298,298,41,41,0,1,0
8,314,314,67,56,11,2,1
4,323,323,29,29,0,1,0
9,326,326,19,19,0,1,0
7,349,349,43,43,0,1,0
5,356,356,60,51,9,4,3
12,361,361,18,18,0,1,0
14,367,367,37,19,18,4,3
6,484,484,9,9,0,1,0
0,495,495,1,1,0,1,0
3,498,498,80,32,48,2,1

14,163,163,21,21,0,1,0
12,177,177,8,3,5,2,1
5,225,225,16,1,15,4,3
3,253,253,44,9,35,2,1
18,258,258,18,18,0,1,0
11,266,266,22,22,0,1,0
0,282,282,28,4,24,3,2
4,288,288,24,3,21,4,3
1,289,289,11,11,0,1,0
8,305,305,71,63,8,3,2
17,320,320,102,52,50,3,2
9,328,328,3,3,0,1,0
21,332,332,72,72,0,1,0
15,360,360,17,13,4,2,1
6,362,362,15,15,0,1,0
10,374,374,25,1,24,4,3
16,379,379,17,2,15,4,3
2,379,379,18,18,0,1,0
7,409,409,5,5,0,1,0
19,411,411,25,25,0,1,0
20,434,434,54,54,0,1,0
13,486,486,2,2,0,1,0

13,103,103,10,10,0,1,0
6,131,131,9,9,0,1,0
0,136,136,8,8,0,1,0
1,161,161,7,3,4,2,1
15,162,162,18,6,12,3,2
19,169,169,21,21,0,1,0
3,174,174,14,3,11,2,1
7,175,175,21,12,9,4,3
12,214,214,18,18,0,1,0
5,256,256,23,11,12,4,3
2,265,265,29,12,17,2,1
22,271,271,16,9,7,3,2
16,294,294,1,1,0,1,0
17,336,336,51,2,49,3,2
14,369,369,5,5,0,1,0
11,384,384,35,35,0,1,0
20,393,393,3,3,0,1,0
4,399,399,40,19,21,4,3
10,430,430,11,11,0,1,0
9,435,435,12,12,0,1,0
18,479,479,101,85,16,3,2
21,480,480,161,95,66,3,2
8,483,483,2,2,0,1,0

7,124,124,7,2,5,2,1
9,132,132,9,1,8,3,2
12,169,169,42,10,32,3,2
0,220,220,6,3,3,2,1
2,220,220,110,25,85,4,3
14,226,226,9,5,4,2,1
3,257,257,51,26,25,2,1
13,280,280,39,39,0,1,0
5,293,293,28,9,19,2,1
8,306,306,20,20,0,1,0
11,349,349,31,28,3,2,1
4,365,365,15,10,5,2,1
1,368,368,22,22,0,1,0
15,388,388,81,21,60,3,2
10,469,469,45,24,21,4,3
6,492,492,39,29,10,2,1

1,100,100,28,7,21,2,1
20,104,104,6,6,0,1,0
14,106,106,6,6,0,1,0
22,113,113,22,14,8,3,2
18,151,151,12,12,0,1,0
5,172,172,5,5,0,1,0
21,178,178,35,13,22,3,2
9,179,179,11,11,0,1,0
10,194,194,5,5,0,1,0
6,212,212,3,3,0,1,0
19,249,249,20,20,0,1,0
16,268,268,39,33,6,2,1
13,285,285,1,1,0,1,0
0,300,300,6,6,0,1,0
8,300,300,23,23,0,1,0
23,314,314,36,32,4,2,1
2,315,315,30,30,0,1,0
12,347,347,66,66,0,1,0
3,392,392,18,9,9,2,1
11,404,404,29,13,16,3,2
7,475,475,7,3,4,2,1
15,480,480,38,38,0,1,0
4,487,487,10,1,9,4,3
17,495,495,39,39,0,1,0

7,110,110,15,15,0,1,0
5,151,151,22,2,20,3,2
17,164,164,19,6,13,2,1
4,186,186,21,9,12,4,3
15,188,188,6,6,0,1,0
3,217,217,11,11,0,1,0
14,223,223,94,49,45,2,1
1,226,226,1,1,0,1,0
16,260,260,8,8,0,1,0
6,283,283,7,4,3,2,1
10,284,284,3,3,0,1,0
9,306,306,21,21,0,1,0
18,356,356,43,36,7,2,1
13,379,379,32,32,0,1,0
11,427,427,83,83,0,1,0
12,441,441,3,3,0,1,0
0,450,450,37,37,0,1,0
8,460,460,92,36,56,3,2
2,472,472,83,53,30,4,3

16,111,111,9,4,5,2,1
6,142,142,21,21,0,1,0
8,149,149,28,28,0,1,0
3,153,153,9,9,0,1,0
13,161,161,27,27,0,1,0
2,186,186,14,2,12,3,2
5,218,218,6,6,0,1,0
9,253,253,85,61,24,4,3
12,266,266,4,4,0,1,0
14,271,271,5,5,0,1,0
0,290,290,3,3,0,1,0
15,329,329,29,29,0,1,0
11,336,336,9,4,5,2,1
4,348,348,36,36,0,1,0
1,416,416,107,62,45,2,1
7,430,430,57,18,39,4,3
17,446,446,12,12,0,1,0
10,455,455,118,118,0,1,0

16,100,100,7,7,0,1,0
8,119,119,17,1,16,3,2
14,127,127,5,5,0,1,0
9,143,143,4,4,0,1,0
1,144,144,4,4,0,1,0
6,182,182,19,7,12,2,1
10,198,198,6,6,0,1,0
15,208,208,42,42,0,1,0
17,236,236,5,5,0,1,0
21,250,250,6,6,0,1,0
11,250,250,4,4,0,1,0
4,292,292,15,5,10,3,2
20,301,301,29,7,22,3,2
13,343,343,16,8,8,3,2
5,350,350,60,60,0,1,0
12,370,370,30,30,0,1,0
18,411,411,39,5,34,2,1
22,414,414,142,112,30,3,2
0,428,428,33,1,32,4,3
19,459,459,58,31,27,4,3
7,459,459,56,56,0,1,0
2,467,467,13,13,0,1,0
3,482,482,36,29,7,2,1

17,100,100,13,2,11,3,2
10,106,106,16,16,0,1,0
5,164,164,16,16,0,1,0
21,164,164,28,8,20,3,2
6,203,203,60,51,9,4,3
22,223,223,13,13,0,1,0
16,228,228,77,77,0,1,0
20,267,267,26,4,22,3,2
1,294,294,10,1,9,4,3
11,322,322,18,18,0,1,0
14,347,347,9,9,0,1,0
15,407,407,55,55,0,1,0
18,412,412,8,8,0,1,0
2,414,414,31,21,10,2,1
13,416,416,10,6,4,2,1
12,427,427,7,7,0,1,0
9,427,427,17,1,16,2,1
8,446,446,18,18,0,1,0
7,474,474,29,29,0,1,0
3,474,474,14,14,0,1,0
4,479,479,16,16,0,1,0
19,479,479,19,19,0,1,0
0,482,482,23,23,0,1,0

13,105,105,27,27,0,1,0
19,129,129,19,1,18,4,3
6,152,152,4,4,0,1,0
10,170,170,30,4,26,2,1
5,200,200,47,47,0,1,0
20,201,201,2,2,0,1,0
18,203,203,12,1,11,2,1
8,216,216,2,2,0,1,0
3,217,217,29,29,0,1,0
1,221,221,12,8,4,2,1
15,242,242,11,1,10,3,2
0,257,257,7,7,0,1,0
17,289,289,11,11,0,1,0
16,372,372,135,135,0,1,0
9,384,384,23,10,13,2,1
11,417,417,49,22,27,4,3
14,419,419,32,32,0,1,0
2,421,421,23,13,10,2,1
7,430,430,5,1,4,2,1
12,460,460,10,10,0,1,0
4,467,467,45,45,0,1,0

4,140,140,8,8,0,1,0
20,143,143,18,11,7,2,1
3,173,173,6,6,0,1,0
0,200,200,3,3,0,1,0
18,203,203,51,51,0,1,0
16,209,209,25,25,0,1,0
19,241,241,11,3,8,2,1
5,243,243,75,75,0,1,0
17,269,269,5,5,0,1,0
8,273,273,9,9,0,1,0
2,287,287,4,4,0,1,0
9,290,290,6,1,5,2,1
7,332,332,8,8,0,1,0
14,344,344,33,33,0,1,0
12,374,374,126,62,64,4,3
11,426,426,5,1,4,2,1
13,440,440,2,2,0,1,0
6,456,456,142,105,37,2,1
1,462,462,53,23,30,2,1
15,476,476,10,5,5,2,1
10,477,477,27,6,21,4,3

23,106,106,25,25,0,1,0
10,119,119,8,8,0,1,0
1,136,136,21,21,0,1,0
14,140,140,6,6,0,1,0
21,145,145,6,6,0,1,0
16,168,168,5,1,4,2,1
2,169,169,3,3,0,1,0
24,187,187,10,10,0,1,0
11,191,191,3,3,0,1,0
5,194,194,17,5,12,3,2
22,236,236,53,14,39,2,1
19,254,254,19,19,0,1,0
18,271,271,31,31,0,1,0
8,322,322,24,10,14,3,2
6,345,345,16,6,10,3,2
13,355,355,71,19,52,3,2
9,357,357,23,5,18,3,2
15,358,358,4,1,3,2,1
0,391,391,10,10,0,1,0
12,395,395,18,4,14,2,1
3,411,411,19,19,0,1,0
4,414,414,40,12,28,3,2
7,460,460,2,2,0,1,0
17,473,473,52,24,28,2,1
20,493,493,69,44,25,2,1

17,165,165,35,35,0,1,0
14,195,195,7,3,4,2,1
8,218,218,3,3,0,1,0
6,226,226,5,5,0,1,0
15,273,273,108,108,0,1,0
10,276,276,3,3,0,1,0
1,303,303,3,3,0,1,0
9,325,325,14,14,0,1,0
5,376,376,30,30,0,1,0
12,405,405,3,3,0,1,0
11,407,407,68,68,0,1,0
3,432,432,16,16,0,1,0
0,435,435,4,4,0,1,0
18,440,440,15,12,3,2,1
16,455,455,73,39,34,3,2
4,472,472,182,144,38,4,3
13,479,479,1,1,0,1,0
2,487,487,50,50,0,1,0
19,489,489,2,2,0,1,0
7,493,493,142,34,108,4,3

0,100,100,10,7,3,2,1
4,106,106,6,1,5,2,1
6,118,118,32,32,0,1,0
1,121,121,26,8,18,2,1
5,143,143,7,7,0,1,0
3,273,273,34,34,0,1,0
11,279,279,45,3,42,2,1
10,290,290,75,75,0,1,0
8,304,304,22,17,5,2,1
9,309,309,17,17,0,1,0
7,324,324,16,16,0,1,0
12,331,331,1,1,0,1,0
13,369,369,59,14,45,4,3
16,370,370,20,20,0,1,0
14,446,446,34,14,20,3,2
15,464,464,53,53,0,1,0
17,464,464,61,61,0,1,0
2,479,479,31,31,0,1,0

7,108,108,14,14,0,1,0
10,124,124,9,9,0,1,0
3,169,169,16,16,0,1,0
6,192,192,34,13,21,2,1
16,218,218,65,65,0,1,0
18,223,223,2,2,0,1,0
8,245,245,29,29,0,1,0
9,250,250,7,7,0,1,0
1,255,255,19,19,0,1,0
21,279,279,19,5,14,3,2
20,305,305,68,41,27,4,3
4,316,316,8,8,0,1,0
2,323,323,16,5,11,2,1
14,353,353,56,2,54,3,2
13,368,368,12,12,0,1,0
12,377,377,25,10,15,4,3
5,398,398,25,12,13,2,1
15,409,409,26,26,0,1,0
19,413,413,16,6,10,2,1
11,418,418,39,30,9,2,1
17,421,421,52,4,48,4,3
0,470,470,4,4,0,1,0

16,108,108,3,3,0,1,0
11,140,140,14,14,0,1,0
2,146,146,10,10,0,1,0
12,158,158,24,16,8,2,1
1,226,226,2,2,0,1,0
7,251,251,18,18,0,1,0
3,255,255,21,21,0,1,0
15,274,274,19,19,0,1,0
5,321,321,86,86,0,1,0
14,360,360,67,48,19,2,1
10,377,377,13,13,0,1,0
8,387,387,6,6,0,1,0
19,397,397,7,7,0,1,0
0,426,426,47,7,40,3,2
13,434,434,17,5,12,2,1
9,440,440,13,3,10,2,1
17,457,457,82,48,34,3,2
4,471,471,6,3,3,2,1
6,481,481,144,78,66,4,3
18,488,488,120,120,0,1,0

15,107,107,8,1,7,2,1
18,108,108,7,7,0,1,0
1,151,151,5,5,0,1,0
3,167,167,3,3,0,1,0
6,202,202,17,17,0,1,0
7,205,205,7,2,5,2,1
19,222,222,11,3,8,3,2
4,279,279,106,13,93,3,2
16,311,311,18,6,12,3,2
11,333,333,184,65,119,4,3
17,345,345,5,1,4,2,1
0,365,365,12,12,0,1,0
8,378,378,6,6,0,1,0
2,378,378,18,10,8,3,2
13,409,409,59,59,0,1,0
5,443,443,41,41,0,1,0
9,462,462,93,93,0,1,0
10,467,467,29,3,26,3,2
12,471,471,1,1,0,1,0
14,498,498,32,16,16,2,1

7,109,109,15,15,0,1,0
10,119,119,3,3,0,1,0
3,121,121,23,12,11,2,1
13,134,134,2,2,0,1,0
12,142,142,6,6,0,1,0
1,154,154,30,4,26,3,2
14,165,165,28,11,17,2,1
8,236,236,8,8,0,1,0
9,281,281,61,37,24,3,2
6,323,323,76,39,37,4,3
0,364,364,38,28,10,2,1
4,391,391,96,2,94,4,3
15,432,432,61,27,34,2,1
11,436,436,104,86,18,2,1
2,460,460,12,1,11,4,3
5,492,492,2,2,0,1,0

2,118,118,22,22,0,1,0
7,118,118,26,1,25,2,1
12,143,143,9,3,6,2,1
14,200,200,1,1,0,1,0
1,217,217,9,9,0,1,0
10,225,225,41,41,0,1,0
5,230,230,72,52,20,3,2
6,256,256,8,8,0,1,0
8,256,256,21,21,0,1,0
4,277,277,4,4,0,1,0
11,367,367,15,15,0,1,0
13,368,368,48,48,0,1,0
3,455,455,66,29,37,2,1
9,492,492,134,56,78,3,2
0,500,500,150,120,30,3,2

17,104,104,7,1,6,3,2
8,106,106,5,5,0,1,0
5,128,128,1,1,0,1,0
9,131,131,15,15,0,1,0
11,176,176,57,57,0,1,0
18,180,180,13,1,12,4,3
12,181,181,20,5,15,4,3
15,200,200,6,6,0,1,0
16,222,222,6,6,0,1,0
4,233,233,5,5,0,1,0
3,305,305,9,2,7,2,1
7,308,308,63,63,0,1,0
2,316,316,106,106,0,1,0
13,367,367,35,7,28,2,1
1,374,374,31,31,0,1,0
0,396,396,23,1,22,3,2
10,402,402,30,3,27,4,3
6,421,421,43,22,21,2,1
14,434,434,99,58,41,2,1

19,100,100,22,16,6,3,2
17,136,136,10,10,0,1,0
6,180,180,4,4,0,1,0
13,199,199,40,25,15,2,1
3,204,204,7,1,6,3,2
9,213,213,13,4,9,4,3
15,233,233,52,52,0,1,0
18,235,235,1,1,0,1,0
4,252,252,31,31,0,1,0
21,255,255,32,32,0,1,0
20,301,301,14,14,0,1,0
0,329,329,22,4,18,3,2
2,346,346,30,4,26,3,2
10,361,361,13,8,5,2,1
8,367,367,15,15,0,1,0
14,376,376,87,77,10,3,2
22,380,380,8,8,0,1,0
5,381,381,21,1,20,3,2
12,413,413,20,20,0,1,0
16,428,428,34,4,30,2,1
7,436,436,50,50,0,1,0
1,445,445,37,27,10,3,2
11,484,484,13,13,0,1,0

6,145,145,40,22,18,2,1
8,147,147,3,3,0,1,0
3,155,155,1,1,0,1,0
17,184,184,10,4,6,2,1
11,188,188,45,27,18,3,2
16,193,193,13,2,11,2,1
15,207,207,29,11,18,2,1
13,290,290,26,26,0,1,0
14,312,312,77,41,36,3,2
0,325,325,38,38,0,1,0
10,341,341,1,1,0,1,0
1,348,348,21,21,0,1,0
5,352,352,24,24,0,1,0
19,359,359,47,33,14,2,1
12,371,371,6,6,0,1,0
2,395,395,15,3,12,2,1
7,396,396,3,3,0,1,0
4,404,404,96,96,0,1,0
18,444,444,12,8,4,2,1
9,452,452,76,76,0,1,0

12,116,116,4,4,0,1,0
2,136,136,2,2,0,1,0
3,148,148,21,16,5,2,1
0,162,162,10,10,0,1,0
22,186,186,4,4,0,1,0
10,189,189,13,6,7,2,1
17,200,200,1,1,0,1,0
19,249,249,15,5,10,2,1
4,276,276,6,6,0,1,0
6,294,294,12,9,3,2,1
18,301,301,1,1,0,1,0
16,311,311,14,14,0,1,0
7,321,321,11,11,0,1,0
20,329,329,211,168,43,2,1
15,330,330,4,4,0,1,0
14,340,340,3,3,0,1,0
21,352,352,79,42,37,3,2
1,422,422,21,21,0,1,0
5,430,430,70,32,38,3,2
11,454,454,13,13,0,1,0
8,461,461,75,66,9,4,3
9,472,472,9,4,5,2,1
13,494,494,79,79,0,1,0

1,100,100,7,1,6,3,2
11,136,136,22,22,0,1,0
17,150,150,9,9,0,1,0
14,170,170,19,8,11,2,1
5,177,177,21,18,3,2,1
6,228,228,13,13,0,1,0
7,233,233,10,10,0,1,0
21,238,238,16,16,0,1,0
13,295,295,43,43,0,1,0
12,309,309,13,13,0,1,0
0,323,323,54,54,0,1,0
18,354,354,3,3,0,1,0
10,366,366,14,14,0,1,0
16,413,413,174,96,78,4,3
3,428,428,64,42,22,2,1
9,439,439,41,41,0,1,0
20,449,449,26,1,25,4,3
2,462,462,6,6,0,1,0
4,480,480,4,4,0,1,0
15,486,486,50,31,19,2,1
19,487,487,22,22,0,1,0
8,498,498,19,3,16,3,2

15,118,118,11,11,0,1,0
12,122,122,3,3,0,1,0
1,132,132,21,1,20,2,1
0,147,147,6,6,0,1,0
14,149,149,1,1,0,1,0
6,151,151,52,13,39,4,3
4,153,153,1,1,0,1,0
5,200,200,30,30,0,1,0
9,264,264,6,6,0,1,0
7,292,292,7,7,0,1,0
11,296,296,55,55,0,1,0
10,342,342,25,25,0,1,0
16,345,345,33,4,29,2,1
13,345,345,19,7,12,3,2
8,364,364,36,36,0,1,0
19,368,368,3,3,0,1,0
2,388,388,28,21,7,2,1
18,393,393,32,32,0,1,0
3,402,402,4,1,3,2,1
17,419,419,199,166,33,4,3

7,110,110,1,1,0,1,0
16,114,114,10,1,9,2,1
8,119,119,4,4,0,1,0
19,142,142,3,3,0,1,0
13,153,153,49,49,0,1,0
2,158,158,1,1,0,1,0
20,179,179,37,37,0,1,0
3,192,192,6,6,0,1,0
21,206,206,19,19,0,1,0
14,235,235,3,3,0,1,0
18,246,246,25,25,0,1,0
10,285,285,6,6,0,1,0
9,324,324,3,3,0,1,0
1,375,375,212,212,0,1,0
0,401,401,55,38,17,2,1
15,426,426,57,57,0,1,0
6,430,430,16,16,0,1,0
17,434,434,18,18,0,1,0
12,439,439,17,17,0,1,0
5,444,444,24,24,0,1,0
11,456,456,9,9,0,1,0
4,472,472,18,10,8,2,1

14,131,131,43,25,18,2,1
2,139,139,9,9,0,1,0
6,189,189,13,13,0,1,0
17,213,213,3,3,0,1,0
3,221,221,55,55,0,1,0
1,237,237,17,17,0,1,0
8,278,278,60,36,24,4,3
18,285,285,30,30,0,1,0
4,306,306,21,21,0,1,0
16,336,336,29,19,10,2,1
11,361,361,14,6,8,3,2
5,366,366,14,14,0,1,0
0,406,406,39,39,0,1,0
9,408,408,26,2,24,2,1
15,408,408,51,51,0,1,0
10,414,414,85,53,32,2,1
7,438,438,28,28,0,1,0
13,467,467,30,30,0,1,0
12,494,494,23,23,0,1,0

2,103,103,4,4,0,1,0
9,131,131,58,58,0,1,0
10,148,148,17,2,15,3,2
14,153,153,28,28,0,1,0
3,183,183,1,1,0,1,0
17,185,185,7,3,4,2,1
6,212,212,3,3,0,1,0
12,258,258,34,34,0,1,0
1,305,305,33,33,0,1,0
4,362,362,38,38,0,1,0
15,369,369,39,31,8,3,2
13,371,371,50,50,0,1,0
8,376,376,46,46,0,1,0
5,393,393,16,4,12,2,1
7,442,442,5,5,0,1,0
11,454,454,30,24,6,3,2
0,466,466,53,11,42,4,3
18,476,476,93,11,82,4,3
16,487,487,23,1,22,2,1

10,116,116,17,17,0,1,0
6,176,176,12,12,0,1,0
3,188,188,3,3,0,1,0
2,190,190,35,35,0,1,0
14,244,244,1,1,0,1,0
11,269,269,47,17,30,3,2
12,324,324,8,8,0,1,0
1,333,333,66,15,51,4,3
13,338,338,5,5,0,1,0
8,350,350,93,41,52,4,3
5,373,373,14,14,0,1,0
9,375,375,52,15,37,3,2
4,480,480,154,46,108,4,3
7,485,485,89,83,6,3,2
0,496,496,121,121,0,1,0

7,102,102,3,3,0,1,0
13,118,118,3,3,0,1,0
0,136,136,19,3,16,3,2
11,150,150,10,2,8,3,2
9,194,194,14,14,0,1,0
8,194,194,3,3,0,1,0
23,226,226,13,13,0,1,0
25,240,240,19,19,0,1,0
18,257,257,31,31,0,1,0
16,287,287,3,3,0,1,0
17,308,308,15,15,0,1,0
19,322,322,16,16,0,1,0
12,329,329,21,21,0,1,0
5,344,344,22,22,0,1,0
10,361,361,13,7,6,3,2
26,365,365,34,31,3,2,1
3,408,408,6,6,0,1,0
1,412,412,2,2,0,1,0
21,421,421,106,44,62,3,2
6,426,426,101,11,90,4,3
24,427,427,150,71,79,4,3
14,440,440,20,20,0,1,0
15,447,447,45,45,0,1,0
22,457,457,2,2,0,1,0
2,465,465,3,3,0,1,0
20,489,489,2,2,0,1,0
4,491,491,10,10,0,1,0

10,114,114,1,1,0,1,0
9,130,130,5,5,0,1,0
16,133,133,1,1,0,1,0
13,146,146,21,7,14,3,2
3,149,149,15,3,12,3,2
14,214,214,30,6,24,4,3
5,242,242,7,4,3,2,1
4,265,265,19,4,15,4,3
6,303,303,26,17,9,4,3
12,316,316,39,3,36,3,2
7,317,317,91,83,8,2,1
15,400,400,92,28,64,3,2
2,428,428,32,32,0,1,0
0,439,439,72,27,45,2,1
11,445,445,141,8,133,4,3
8,451,451,21,9,12,4,3
17,480,480,6,6,0,1,0
1,491,491,69,69,0,1,0

14,117,117,4,4,0,1,0
17,124,124,43,18,25,2,1
20,140,140,48,48,0,1,0
3,159,159,15,5,10,2,1
2,200,200,1,1,0,1,0
19,209,209,18,18,0,1,0
16,226,226,8,1,7,2,1
0,286,286,2,2,0,1,0
1,319,319,4,4,0,1,0
4,327,327,20,1,19,3,2
13,328,328,15,11,4,2,1
21,346,346,1,1,0,1,0
7,364,364,1,1,0,1,0
15,378,378,31,31,0,1,0
9,386,386,25,25,0,1,0
12,388,388,107,107,0,1,0
23,399,399,5,5,0,1,0
11,417,417,32,11,21,2,1
10,418,418,5,1,4,2,1
8,430,430,43,43,0,1,0
6,441,441,71,26,45,2,1
22,441,441,24,7,17,2,1
5,474,474,25,6,19,2,1
18,492,492,24,24,0,1,0

15,100,100,2,2,0,1,0
16,113,113,9,9,0,1,0
5,134,134,21,5,16,2,1
1,141,141,15,4,11,2,1
9,145,145,8,2,6,3,2
14,153,153,39,39,0,1,0
12,175,175,18,4,14,2,1
2,202,202,20,20,0,1,0
3,207,207,9,6,3,2,1
7,278,278,30,8,22,2,1
4,343,343,58,58,0,1,0
13,368,368,24,24,0,1,0
0,389,389,4,4,0,1,0
10,426,426,19,19,0,1,0
8,437,437,11,11,0,1,0
6,483,483,137,137,0,1,0
17,497,497,138,18,120,4,3
11,498,498,60,46,14,3,2

14,107,107,1,1,0,1,0
0,113,113,24,24,0,1,0
2,142,142,37,37,0,1,0
16,169,169,32,32,0,1,0
5,175,175,2,2,0,1,0
13,197,197,30,30,0,1,0
7,218,218,3,3,0,1,0
17,232,232,10,2,8,2,1
9,234,234,12,12,0,1,0
1,292,292,88,24,64,3,2
15,352,352,87,87,0,1,0
11,359,359,106,106,0,1,0
4,368,368,42,17,25,2,1
6,422,422,13,1,12,4,3
12,428,428,9,3,6,2,1
10,473,473,8,1,7,2,1
3,486,486,1,1,0,1,0
8,489,489,27,18,9,4,3

3,132,132,11,11,0,1,0
15,149,149,26,26,0,1,0
12,150,150,22,19,3,2,1
4,170,170,2,2,0,1,0
17,173,173,19,3,16,2,1
14,199,199,25,25,0,1,0
20,209,209,19,19,0,1,0
2,222,222,2,2,0,1,0
21,255,255,8,8,0,1,0
13,268,268,17,9,8,3,2
18,271,271,49,44,5,2,1
19,273,273,3,3,0,1,0
8,295,295,51,38,13,2,1
16,316,316,74,53,21,2,1
0,342,342,4,4,0,1,0
1,351,351,87,69,18,3,2
9,357,357,5,5,0,1,0
5,370,370,18,12,6,3,2
10,395,395,23,23,0,1,0
6,407,407,11,11,0,1,0
11,422,422,62,2,60,3,2
7,480,480,13,13,0,1,0

24,103,103,4,4,0,1,0
3,106,106,7,7,0,1,0
2,111,111,7,7,0,1,0
9,132,132,3,3,0,1,0
14,181,181,7,7,0,1,0
15,184,184,52,28,24,3,2
5,192,192,19,5,14,3,2
10,194,194,8,4,4,2,1
4,194,194,14,14,0,1,0
12,234,234,10,5,5,2,1
1,241,241,15,15,0,1,0
19,241,241,82,82,0,1,0
0,251,251,3,3,0,1,0
16,268,268,51,13,38,2,1
18,270,270,1,1,0,1,0
8,302,302,10,10,0,1,0
6,329,329,13,8,5,2,1
17,336,336,28,28,0,1,0
22,353,353,40,14,26,2,1
11,365,365,26,26,0,1,0
23,397,397,7,1,6,3,2
21,412,412,5,1,4,2,1
7,438,438,13,13,0,1,0
20,481,481,105,105,0,1,0
13,485,485,13,4,9,4,3

9,117,117,16,16,0,1,0
10,121,121,6,6,0,1,0
16,134,134,1,1,0,1,0
11,140,140,25,25,0,1,0
7,144,144,53,43,10,3,2
1,182,182,7,7,0,1,0
3,205,205,34,34,0,1,0
0,255,255,16,7,9,2,1
2,257,257,36,11,25,2,1
14,257,257,89,55,34,3,2
8,317,317,14,8,6,3,2
15,367,367,5,2,3,2,1
5,381,381,13,13,0,1,0
12,414,414,20,12,8,2,1
6,433,433,48,2,46,4,3
4,444,444,37,5,32,2,1
13,500,500,99,71,28,2,1

19,115,115,1,1,0,1,0
22,131,131,27,27,0,1,0
21,136,136,8,8,0,1,0
11,163,163,5,5,0,1,0
14,177,177,1,1,0,1,0
7,178,178,1,1,0,1,0
13,192,192,1,1,0,1,0
18,196,196,88,56,32,3,2
16,199,199,20,5,15,2,1
24,221,221,4,4,0,1,0
1,237,237,46,46,0,1,0
4,242,242,4,1,3,2,1
3,256,256,9,9,0,1,0
12,272,272,8,4,4,2,1
6,316,316,4,4,0,1,0
5,328,328,7,7,0,1,0
17,329,329,37,14,23,3,2
8,334,334,18,18,0,1,0
20,350,350,5,5,0,1,0
23,350,350,20,20,0,1,0
0,356,356,11,5,6,3,2
9,394,394,156,105,51,4,3
2,411,411,4,1,3,2,1
15,433,433,20,20,0,1,0
10,449,449,49,49,0,1,0

10,109,109,14,3,11,2,1
7,123,123,20,20,0,1,0
3,217,217,7,7,0,1,0
21,265,265,73,46,27,2,1
18,279,279,114,72,42,4,3
12,280,280,4,4,0,1,0
20,281,281,12,3,9,2,1
0,281,281,4,4,0,1,0
13,301,301,16,5,11,2,1
4,301,301,91,23,68,4,3
19,314,314,14,3,11,2,1
5,328,328,1,1,0,1,0
11,329,329,32,32,0,1,0
14,345,345,4,4,0,1,0
9,400,400,10,10,0,1,0
16,426,426,24,12,12,2,1
15,432,432,6,6,0,1,0
6,437,437,2,2,0,1,0
8,455,455,80,71,9,2,1
1,457,457,10,7,3,2,1
2,477,477,9,9,0,1,0
17,484,484,50,16,34,4,3

9,104,104,1,1,0,1,0
12,113,113,6,6,0,1,0
15,152,152,13,3,10,2,1
2,167,167,12,12,0,1,0
18,180,180,42,34,8,3,2
17,212,212,46,4,42,4,3
11,262,262,41,41,0,1,0
14,263,263,35,35,0,1,0
10,298,298,10,10,0,1,0
13,300,300,3,3,0,1,0
3,301,301,16,16,0,1,0
4,309,309,6,6,0,1,0
8,319,319,31,21,10,3,2
7,399,399,40,40,0,1,0
1,405,405,88,88,0,1,0
16,415,415,41,41,0,1,0
5,423,423,4,4,0,1,0
0,427,427,30,5,25,4,3
6,435,435,154,154,0,1,0

3,136,136,7,7,0,1,0
11,137,137,32,11,21,4,3
8,195,195,3,3,0,1,0
4,238,238,9,9,0,1,0
13,243,243,13,3,10,4,3
16,299,299,35,35,0,1,0
9,314,314,43,23,20,3,2
14,332,332,19,19,0,1,0
12,344,344,43,43,0,1,0
2,372,372,2,2,0,1,0
15,374,374,23,15,8,3,2
1,399,399,52,52,0,1,0
10,411,411,50,14,36,3,2
5,412,412,32,23,9,2,1
7,412,412,8,8,0,1,0
20,417,417,22,22,0,1,0
19,456,456,60,31,29,2,1
0,466,466,62,62,0,1,0
18,472,472,1,1,0,1,0
6,499,499,22,2,20,3,2
17,499,499,206,56,150,4,3

11,115,115,7,1,6,2,1
1,132,132,1,1,0,1,0
10,158,158,13,13,0,1,0
16,177,177,2,2,0,1,0
13,181,181,4,1,3,2,1
5,199,199,13,3,10,3,2
14,201,201,50,27,23,2,1
15,331,331,36,36,0,1,0
4,351,351,17,8,9,2,1
17,371,371,27,5,22,3,2
18,372,372,37,2,35,3,2
3,380,380,19,6,13,2,1
0,415,415,136,39,97,4,3
12,424,424,132,111,21,3,2
8,433,433,11,11,0,1,0
7,468,468,152,137,15,4,3
6,468,468,21,13,8,3,2
2,472,472,49,49,0,1,0
9,493,493,2,2,0,1,0

6,105,105,4,4,0,1,0
5,111,111,4,4,0,1,0
9,113,113,1,1,0,1,0
20,118,118,3,3,0,1,0
4,154,154,25,3,22,3,2
15,203,203,46,46,0,1,0
2,238,238,30,30,0,1,0
8,260,260,13,3,10,2,1
22,267,267,5,5,0,1,0
14,269,269,25,25,0,1,0
12,269,269,29,29,0,1,0
7,282,282,4,4,0,1,0
21,295,295,41,41,0,1,0
3,301,301,8,8,0,1,0
16,349,349,21,21,0,1,0
13,356,356,5,2,3,2,1
0,421,421,23,16,7,2,1
17,441,441,87,42,45,2,1
19,441,441,39,39,0,1,0
18,442,442,74,45,29,2,1
1,462,462,80,73,7,2,1
11,474,474,10,10,0,1,0
10,478,478,81,81,0,1,0

8,117,117,5,2,3,2,1
10,127,127,45,45,0,1,0
2,197,197,42,42,0,1,0
5,201,201,1,1,0,1,0
12,202,202,27,27,0,1,0
14,212,212,28,1,27,2,1
6,215,215,1,1,0,1,0
3,230,230,23,23,0,1,0
11,259,259,51,51,0,1,0
0,277,277,37,22,15,2,1
15,296,296,15,15,0,1,0
7,341,341,11,11,0,1,0
4,343,343,82,14,68,3,2
13,357,357,24,24,0,1,0
1,362,362,111,61,50,2,1
9,459,459,2,2,0,1,0

13,154,154,17,17,0,1,0
6,199,199,9,9,0,1,0
5,249,249,67,40,27,2,1
7,261,261,42,9,33,2,1
0,268,268,7,3,4,2,1
8,284,284,19,19,0,1,0
12,293,293,15,4,11,2,1
3,355,355,61,61,0,1,0
2,356,356,71,45,26,2,1
4,360,360,18,18,0,1,0
9,365,365,1,1,0,1,0
11,380,380,102,60,42,4,3
1,399,399,221,184,37,3,2
10,470,470,21,21,0,1,0

19,139,139,7,7,0,1,0
5,154,154,10,10,0,1,0
8,204,204,3,3,0,1,0
10,214,214,16,3,13,2,1
18,227,227,10,2,8,3,2
6,278,278,21,21,0,1,0
3,288,288,16,16,0,1,0
7,292,292,98,98,0,1,0
4,296,296,23,23,0,1,0
11,314,314,43,1,42,3,2
0,335,335,48,48,0,1,0
2,343,343,20,6,14,2,1
1,344,344,5,5,0,1,0
16,377,377,25,14,11,2,1
12,387,387,49,11,38,3,2
17,437,437,53,8,45,4,3
9,445,445,38,33,5,2,1
14,458,458,136,30,106,4,3
15,483,483,21,21,0,1,0
13,484,484,61,61,0,1,0

22,108,108,4,4,0,1,0
1,116,116,1,1,0,1,0
5,131,131,1,1,0,1,0
6,141,141,16,16,0,1,0
19,143,143,15,15,0,1,0
12,148,148,15,15,0,1,0
15,182,182,8,8,0,1,0
14,186,186,14,14,0,1,0
9,206,206,4,4,0,1,0
10,281,281,55,8,47,2,1
4,292,292,29,25,4,2,1
8,296,296,7,1,6,3,2
2,323,323,36,36,0,1,0
24,330,330,87,52,35,2,1
7,330,330,9,9,0,1,0
17,336,336,18,18,0,1,0
0,336,336,22,12,10,3,2
3,339,339,9,9,0,1,0
23,344,344,84,2,82,3,2
18,358,358,21,21,0,1,0
21,367,367,29,13,16,3,2
11,470,470,9,9,0,1,0
13,487,487,32,4,28,3,2
16,490,490,70,70,0,1,0
20,493,493,16,5,11,2,1

14,113,113,17,1,16,2,1
1,121,121,3,3,0,1,0
2,145,145,4,1,3,2,1
0,158,158,5,5,0,1,0
17,166,166,48,48,0,1,0
8,179,179,20,20,0,1,0
20,189,189,4,4,0,1,0
11,223,223,4,1,3,2,1
12,326,326,154,154,0,1,0
6,362,362,11,11,0,1,0
5,388,388,49,7,42,4,3
19,417,417,34,11,23,3,2
10,418,418,23,6,17,3,2
15,420,420,32,32,0,1,0
13,424,424,23,18,5,2,1
4,446,446,5,5,0,1,0
9,465,465,2,2,0,1,0
16,468,468,7,7,0,1,0
3,471,471,37,37,0,1,0
21,475,475,126,86,40,4,3
7,488,488,4,1,3,2,1
18,496,496,32,32,0,1,0

0,106,106,2,2,0,1,0
7,132,132,11,11,0,1,0
2,136,136,14,14,0,1,0
4,163,163,2,2,0,1,0
11,182,182,19,19,0,1,0
5,184,184,17,5,12,4,3
3,227,227,21,21,0,1,0
21,269,269,46,8,38,2,1
9,271,271,19,10,9,4,3
8,272,272,44,7,37,2,1
19,282,282,86,10,76,3,2
17,283,283,83,41,42,4,3
15,293,293,8,8,0,1,0
13,350,350,11,5,6,2,1
10,401,401,23,23,0,1,0
1,402,402,24,7,17,2,1
20,408,408,8,8,0,1,0
14,412,412,3,3,0,1,0
16,412,412,25,18,7,2,1
12,472,472,43,4,39,4,3
18,474,474,44,44,0,1,0
6,477,477,26,14,12,2,1

16,102,102,11,4,7,2,1
13,115,115,27,27,0,1,0
12,119,119,14,5,9,4,3
9,136,136,10,2,8,3,2
6,220,220,7,7,0,1,0
15,221,221,5,5,0,1,0
8,228,228,22,22,0,1,0
1,248,248,73,67,6,3,2
4,283,283,19,9,10,3,2
0,302,302,33,33,0,1,0
3,307,307,58,22,36,2,1
2,314,314,14,14,0,1,0
17,342,342,16,16,0,1,0
5,362,362,60,60,0,1,0
10,435,435,35,35,0,1,0
11,447,447,126,32,94,3,2
14,456,456,24,12,12,3,2
7,491,491,2,2,0,1,0

13,111,111,9,9,0,1,0
14,116,116,1,1,0,1,0
15,144,144,23,23,0,1,0
2,178,178,7,7,0,1,0
17,206,206,10,7,3,2,1
3,207,207,11,5,6,2,1
6,212,212,15,15,0,1,0
5,225,225,84,84,0,1,0
7,228,228,1,1,0,1,0
19,242,242,78,78,0,1,0
1,275,275,11,11,0,1,0
10,289,289,25,25,0,1,0
18,290,290,15,7,8,3,2
12,386,386,12,12,0,1,0
9,387,387,2,2,0,1,0
11,395,395,5,2,3,2,1
0,422,422,1,1,0,1,0
16,425,425,131,47,84,4,3
8,439,439,90,16,74,3,2
4,487,487,60,17,43,2,1

10,107,107,3,3,0,1,0
13,115,115,4,4,0,1,0
15,123,123,2,2,0,1,0
11,132,132,24,2,22,2,1
6,161,161,10,10,0,1,0
2,162,162,14,14,0,1,0
8,176,176,4,4,0,1,0
16,225,225,107,57,50,3,2
14,242,242,20,4,16,3,2
9,259,259,47,47,0,1,0
3,290,290,105,9,96,4,3
7,319,319,47,21,26,3,2
12,348,348,1,1,0,1,0
0,365,365,1,1,0,1,0
1,398,398,20,20,0,1,0
4,424,424,59,42,17,2,1
5,449,449,68,68,0,1,0

16,124,124,19,19,0,1,0
9,139,139,31,31,0,1,0
11,146,146,15,15,0,1,0
17,157,157,6,2,4,2,1
14,180,180,18,18,0,1,0
19,216,216,26,26,0,1,0
4,239,239,13,13,0,1,0
18,241,241,24,15,9,4,3
15,257,257,35,35,0,1,0
3,277,277,66,18,48,4,3
5,280,280,3,3,0,1,0
13,302,302,2,2,0,1,0
1,312,312,22,1,21,3,2
7,348,348,16,16,0,1,0
0,364,364,24,7,17,2,1
2,412,412,68,41,27,4,3
10,428,428,18,18,0,1,0
8,430,430,9,5,4,2,1
12,478,478,127,4,123,4,3
6,489,489,32,11,21,2,1

16,148,148,27,18,9,4,3
14,156,156,25,14,11,2,1
2,159,159,1,1,0,1,0
17,177,177,1,1,0,1,0
13,177,177,26,8,18,4,3
12,187,187,15,15,0,1,0
6,208,208,32,32,0,1,0
15,210,210,31,31,0,1,0
9,222,222,1,1,0,1,0
10,237,237,35,25,10,2,1
20,274,274,44,44,0,1,0
18,281,281,33,33,0,1,0
4,296,296,11,11,0,1,0
5,298,298,33,13,20,2,1
7,322,322,32,32,0,1,0
1,338,338,1,1,0,1,0
0,388,388,15,15,0,1,0
3,397,397,122,86,36,4,3
19,437,437,7,2,5,2,1
11,458,458,24,24,0,1,0
8,469,469,19,19,0,1,0

5,133,133,30,30,0,1,0
0,146,146,2,2,0,1,0
11,161,161,15,15,0,1,0
14,179,179,15,5,10,3,2
7,185,185,31,31,0,1,0
18,186,186,26,17,9,2,1
17,186,186,42,3,39,2,1
8,196,196,12,12,0,1,0
4,257,257,13,1,12,2,1
21,273,273,7,4,3,2,1
1,295,295,7,7,0,1,0
9,317,317,11,1,10,2,1
3,333,333,1,1,0,1,0
15,363,363,119,119,0,1,0
22,399,399,6,1,5,2,1
16,400,400,61,61,0,1,0
10,403,403,77,77,0,1,0
13,420,420,45,30,15,4,3
2,428,428,4,4,0,1,0
19,429,429,14,14,0,1,0
6,430,430,8,8,0,1,0
12,442,442,1,1,0,1,0
20,454,454,5,1,4,2,1

10,133,133,16,16,0,1,0
12,151,151,12,8,4,2,1
7,197,197,9,9,0,1,0
4,240,240,40,40,0,1,0
16,250,250,11,11,0,1,0
0,252,252,7,7,0,1,0
2,265,265,8,8,0,1,0
5,276,276,8,1,7,2,1
3,339,339,6,2,4,2,1
9,354,354,15,2,13,2,1
6,388,388,169,122,47,3,2
8,433,433,40,40,0,1,0
1,446,446,70,46,24,4,3
14,470,470,40,40,0,1,0
15,481,481,73,43,30,3,2
17,485,485,68,68,0,1,0
13,489,489,158,101,57,4,3
11,498,498,15,1,14,2,1

5,112,112,31,1,30,4,3
0,184,184,26,2,24,4,3
13,205,205,2,2,0,1,0
17,227,227,50,50,0,1,0
9,273,273,29,29,0,1,0
3,281,281,8,4,4,2,1
1,286,286,38,32,6,3,2
7,296,296,2,2,0,1,0
12,313,313,11,11,0,1,0
14,316,316,45,17,28,3,2
15,319,319,7,7,0,1,0
8,330,330,60,4,56,3,2
6,355,355,73,41,32,2,1
16,397,397,24,24,0,1,0
11,405,405,83,83,0,1,0
2,451,451,9,9,0,1,0
10,484,484,103,103,0,1,0
4,488,488,4,4,0,1,0

7,113,113,4,4,0,1,0
9,118,118,10,1,9,4,3
6,133,133,17,17,0,1,0
15,151,151,12,5,7,2,1
3,174,174,35,28,7,2,1
1,187,187,24,12,12,4,3
16,187,187,7,7,0,1,0
10,213,213,35,2,33,4,3
13,291,291,34,7,27,4,3
4,318,318,26,2,24,4,3
12,328,328,42,42,0,1,0
14,368,368,76,76,0,1,0
11,377,377,17,17,0,1,0
5,378,378,70,70,0,1,0
8,386,386,30,30,0,1,0
2,422,422,6,6,0,1,0
17,474,474,77,77,0,1,0
0,488,488,73,25,48,2,1

7,100,100,12,3,9,2,1
17,126,126,17,14,3,2,1
15,126,126,5,5,0,1,0
12,138,138,23,23,0,1,0
11,152,152,1,1,0,1,0
4,172,172,20,7,13,2,1
6,202,202,16,4,12,3,2
8,205,205,12,12,0,1,0
2,232,232,2,2,0,1,0
19,239,239,16,16,0,1,0
14,247,247,19,19,0,1,0
5,261,261,9,9,0,1,0
18,273,273,82,82,0,1,0
1,292,292,17,8,9,4,3
16,305,305,65,18,47,2,1
9,350,350,48,48,0,1,0
3,353,353,68,14,54,3,2
13,399,399,8,8,0,1,0
0,470,470,59,59,0,1,0
10,484,484,34,1,33,2,1

6,105,105,12,2,10,2,1
15,120,120,8,4,4,2,1
3,136,136,57,57,0,1,0
2,141,141,6,6,0,1,0
20,147,147,15,8,7,2,1
7,175,175,2,2,0,1,0
16,201,201,18,18,0,1,0
10,236,236,11,1,10,2,1
9,255,255,1,1,0,1,0
12,265,265,1,1,0,1,0
23,269,269,17,8,9,2,1
24,290,290,25,9,16,3,2
18,310,310,16,4,12,2,1
8,327,327,6,6,0,1,0
22,344,344,1,1,0,1,0
4,362,362,6,6,0,1,0
14,385,385,1,1,0,1,0
21,406,406,90,90,0,1,0
0,430,430,35,35,0,1,0
1,444,444,21,10,11,2,1
19,447,447,167,72,95,4,3
17,453,453,9,9,0,1,0
5,459,459,38,3,35,2,1
11,470,470,6,6,0,1,0
13,485,485,16,16,0,1,0

1,167,167,1,1,0,1,0
3,176,176,20,20,0,1,0
10,187,187,1,1,0,1,0
13,187,187,41,3,38,3,2
9,194,194,15,15,0,1,0
0,195,195,7,1,6,3,2
5,202,202,4,4,0,1,0
19,228,228,36,25,11,2,1
17,244,244,21,21,0,1,0
11,281,281,1,1,0,1,0
4,301,301,58,58,0,1,0
14,303,303,5,5,0,1,0
20,308,308,43,11,32,3,2
12,335,335,25,11,14,3,2
8,400,400,123,59,64,3,2
21,415,415,38,18,20,2,1
7,416,416,46,46,0,1,0
16,444,444,10,4,6,2,1
18,447,447,1,1,0,1,0
6,469,469,13,13,0,1,0
2,469,469,12,12,0,1,0
15,473,473,132,124,8,2,1

16,139,139,15,1,14,2,1
6,228,228,33,13,20,3,2
8,237,237,21,21,0,1,0
1,240,240,10,5,5,2,1
15,249,249,20,15,5,2,1
7,275,275,21,21,0,1,0
4,305,305,112,85,27,4,3
3,309,309,24,21,3,2,1
2,365,365,100,74,26,2,1
13,387,387,48,21,27,4,3
14,399,399,127,7,120,4,3
11,403,403,2,2,0,1,0
5,415,415,2,2,0,1,0
0,416,416,6,6,0,1,0
10,417,417,46,41,5,2,1
12,424,424,64,22,42,3,2
9,480,480,16,4,12,3,2

5,125,125,1,1,0,1,0
3,179,179,73,73,0,1,0
4,197,197,14,14,0,1,0
9,265,265,19,7,12,4,3
2,284,284,25,14,11,2,1
12,312,312,54,54,0,1,0
11,364,364,139,114,25,2,1
13,399,399,27,20,7,2,1
8,432,432,19,19,0,1,0
0,437,437,57,49,8,2,1
7,445,445,44,12,32,3,2
1,448,448,136,52,84,3,2
10,461,461,50,8,42,4,3
6,469,469,28,20,8,3,2

3,113,113,1,1,0,1,0
15,114,114,1,1,0,1,0
12,162,162,7,7,0,1,0
16,175,175,15,15,0,1,0
6,176,176,9,9,0,1,0
8,186,186,28,7,21,2,1
17,192,192,28,28,0,1,0
0,194,194,28,6,22,3,2
10,204,204,21,21,0,1,0
9,223,223,36,36,0,1,0
14,232,232,17,17,0,1,0
2,274,274,2,2,0,1,0
13,301,301,2,2,0,1,0
11,323,323,7,7,0,1,0
1,327,327,15,10,5,2,1
4,334,334,3,3,0,1,0
18,403,403,214,202,12,4,3
7,420,420,90,5,85,4,3
5,469,469,99,99,0,1,0

0,110,110,11,3,8,2,1
2,117,117,12,2,10,2,1
24,118,118,14,14,0,1,0
15,129,129,3,3,0,1,0
25,133,133,23,3,20,3,2
22,142,142,8,8,0,1,0
10,142,142,2,2,0,1,0
20,149,149,12,12,0,1,0
26,155,155,16,16,0,1,0
13,173,173,5,5,0,1,0
18,189,189,2,2,0,1,0
19,196,196,4,4,0,1,0
16,201,201,6,6,0,1,0
3,206,206,5,5,0,1,0
5,210,210,6,3,3,2,1
4,225,225,3,3,0,1,0
17,254,254,1,1,0,1,0
9,255,255,14,14,0,1,0
1,265,265,22,22,0,1,0
11,287,287,10,10,0,1,0
7,288,288,7,7,0,1,0
21,356,356,47,38,9,4,3
28,356,356,22,22,0,1,0
6,363,363,17,2,15,2,1
27,382,382,48,32,16,3,2
14,392,392,13,5,8,3,2
12,396,396,59,59,0,1,0
23,418,418,4,4,0,1,0
8,421,421,42,3,39,4,3
29,439,439,106,44,62,3,2

15,100,100,6,1,5,2,1
2,142,142,1,1,0,1,0
21,147,147,7,1,6,3,2
11,159,159,27,6,21,2,1
9,162,162,15,3,12,4,3
3,189,189,14,14,0,1,0
8,189,189,4,4,0,1,0
16,194,194,27,17,10,3,2
0,202,202,10,10,0,1,0
12,204,204,68,42,26,3,2
23,259,259,25,7,18,4,3
13,269,269,18,18,0,1,0
22,275,275,75,21,54,4,3
17,312,312,94,91,3,2,1
14,313,313,5,2,3,2,1
7,320,320,7,7,0,1,0
19,366,366,15,15,0,1,0
4,367,367,28,28,0,1,0
10,393,393,6,6,0,1,0
6,402,402,21,21,0,1,0
20,466,466,24,24,0,1,0
5,473,473,1,1,0,1,0
18,480,480,5,5,0,1,0
1,500,500,1,1,0,1,0

22,121,121,20,20,0,1,0
12,127,127,2,2,0,1,0
13,132,132,5,5,0,1,0
20,148,148,16,13,3,2,1
5,167,167,15,15,0,1,0
8,192,192,2,2,0,1,0
21,207,207,51,34,17,2,1
4,225,225,49,49,0,1,0
16,226,226,11,11,0,1,0
19,235,235,45,45,0,1,0
11,239,239,33,9,24,4,3
14,251,251,2,2,0,1,0
23,273,273,3,3,0,1,0
17,274,274,27,17,10,3,2
0,293,293,12,3,9,2,1
3,298,298,16,4,12,4,3
7,320,320,7,2,5,2,1
15,324,324,1,1,0,1,0
6,388,388,18,8,10,3,2
1,403,403,17,17,0,1,0
9,416,416,8,8,0,1,0
10,430,430,58,58,0,1,0
18,464,464,67,67,0,1,0
2,469,469,58,42,16,4,3

2,116,116,20,20,0,1,0
11,136,136,8,8,0,1,0
15,151,151,28,2,26,3,2
0,152,152,1,1,0,1,0
1,164,164,19,13,6,3,2
3,213,213,48,48,0,1,0
12,233,233,45,17,28,2,1
20,269,269,20,20,0,1,0
19,311,311,99,99,0,1,0
7,317,317,48,33,15,4,3
13,353,353,16,5,11,2,1
14,355,355,21,4,17,4,3
18,358,358,11,5,6,2,1
16,367,367,12,12,0,1,0
17,383,383,29,9,20,2,1
5,415,415,35,25,10,2,1
10,416,416,34,34,0,1,0
4,427,427,7,4,3,2,1
8,445,445,4,4,0,1,0
6,464,464,32,17,15,2,1
9,481,481,6,6,0,1,0

21,104,104,6,6,0,1,0
8,138,138,4,1,3,2,1
9,158,158,1,1,0,1,0
22,165,165,14,14,0,1,0
2,176,176,3,3,0,1,0
7,182,182,17,17,0,1,0
18,221,221,29,1,28,3,2
1,241,241,12,12,0,1,0
10,243,243,26,17,9,2,1
0,266,266,52,52,0,1,0
19,293,293,26,2,24,3,2
14,326,326,15,5,10,2,1
3,340,340,8,8,0,1,0
12,341,341,8,8,0,1,0
6,343,343,20,20,0,1,0
4,354,354,18,2,16,2,1
16,379,379,49,26,23,2,1
15,397,397,71,18,53,3,2
5,421,421,120,77,43,4,3
13,423,423,6,6,0,1,0
23,435,435,119,119,0,1,0
17,465,465,19,6,13,2,1
20,468,468,15,15,0,1,0
11,481,481,1,1,0,1,0

15,117,117,9,1,8,3,2
3,121,121,1,1,0,1,0
0,145,145,31,31,0,1,0
8,196,196,21,12,9,2,1
19,197,197,17,17,0,1,0
17,215,215,8,8,0,1,0
12,222,222,5,5,0,1,0
13,224,224,23,23,0,1,0
5,240,240,29,19,10,2,1
7,292,292,26,26,0,1,0
10,294,294,110,21,89,4,3
14,305,305,54,38,16,2,1
9,315,315,1,1,0,1,0
18,358,358,8,8,0,1,0
2,369,369,10,1,9,4,3
16,401,401,179,164,15,2,1
1,416,416,8,8,0,1,0
20,434,434,22,19,3,2,1
4,488,488,15,7,8,2,1
11,491,491,3,3,0,1,0
6,498,498,1,1,0,1,0

18,124,124,12,2,10,3,2
3,136,136,8,8,0,1,0
8,155,155,31,31,0,1,0
14,168,168,7,2,5,2,1
9,175,175,8,2,6,2,1
15,178,178,21,21,0,1,0
17,207,207,12,12,0,1,0
19,214,214,14,14,0,1,0
11,245,245,53,37,16,3,2
0,260,260,16,16,0,1,0
4,302,302,12,12,0,1,0
20,303,303,63,63,0,1,0
6,343,343,6,6,0,1,0
2,354,354,37,19,18,2,1
5,392,392,13,5,8,3,2
1,421,421,10,10,0,1,0
13,424,424,39,9,30,4,3
12,477,477,159,77,82,3,2
16,479,479,1,1,0,1,0
10,483,483,42,42,0,1,0
7,488,488,55,55,0,1,0

18,109,109,18,10,8,2,1
0,127,127,5,1,4,2,1
5,155,155,12,3,9,2,1
10,166,166,1,1,0,1,0
23,172,172,51,43,8,3,2
4,174,174,2,2,0,1,0
20,200,200,24,4,20,2,1
1,212,212,21,21,0,1,0
12,239,239,8,8,0,1,0
3,241,241,14,14,0,1,0
16,246,246,8,8,0,1,0
19,258,258,10,10,0,1,0
6,268,268,6,6,0,1,0
21,275,275,2,2,0,1,0
15,275,275,2,2,0,1,0
17,315,315,22,18,4,2,1
11,338,338,1,1,0,1,0
9,341,341,17,5,12,2,1
13,350,350,5,1,4,2,1
2,364,364,62,62,0,1,0
14,364,364,91,44,47,4,3
24,374,374,57,25,32,2,1
7,418,418,56,56,0,1,0
22,446,446,62,62,0,1,0
8,484,484,13,5,8,3,2

16,113,113,15,15,0,1,0
20,135,135,14,14,0,1,0
15,149,149,19,2,17,2,1
17,153,153,69,46,23,2,1
6,158,158,16,16,0,1,0
19,163,163,5,5,0,1,0
18,167,167,1,1,0,1,0
0,189,189,12,1,11,2,1
13,241,241,20,7,13,2,1
3,250,250,23,23,0,1,0
12,275,275,12,12,0,1,0
5,288,288,25,25,0,1,0
11,295,295,44,44,0,1,0
7,313,313,45,9,36,3,2
8,324,324,54,6,48,3,2
10,351,351,14,14,0,1,0
14,430,430,21,21,0,1,0
1,439,439,16,16,0,1,0
2,445,445,22,7,15,4,3
9,481,481,7,2,5,2,1
4,486,486,29,1,28,3,2

22,136,136,59,59,0,1,0
17,159,159,4,4,0,1,0
9,180,180,1,1,0,1,0
6,196,196,1,1,0,1,0
14,198,198,26,2,24,3,2
4,217,217,5,1,4,2,1
10,261,261,5,5,0,1,0
1,300,300,12,12,0,1,0
15,301,301,13,13,0,1,0
5,310,310,1,1,0,1,0
0,312,312,83,19,64,3,2
2,316,316,44,44,0,1,0
20,316,316,11,11,0,1,0
11,353,353,5,5,0,1,0
3,369,369,3,3,0,1,0
7,387,387,75,75,0,1,0
21,398,398,90,90,0,1,0
16,405,405,27,27,0,1,0
19,413,413,15,15,0,1,0
12,416,416,9,9,0,1,0
13,419,419,58,30,28,2,1
8,479,479,59,59,0,1,0
18,486,486,11,11,0,1,0

2,106,106,4,1,3,2,1
15,118,118,9,3,6,3,2
0,138,138,4,4,0,1,0
7,139,139,1,1,0,1,0
18,179,179,21,4,17,2,1
14,182,182,5,2,3,2,1
16,219,219,44,44,0,1,0
19,228,228,64,44,20,3,2
8,231,231,47,47,0,1,0
13,244,244,5,5,0,1,0
6,252,252,22,22,0,1,0
11,260,260,16,16,0,1,0
17,280,280,4,4,0,1,0
10,290,290,7,7,0,1,0
23,301,301,12,5,7,2,1
5,316,316,20,20,0,1,0
12,326,326,19,19,0,1,0
1,356,356,3,3,0,1,0
21,401,401,53,18,35,2,1
9,405,405,59,13,46,4,3
4,446,446,35,10,25,2,1
3,459,459,69,69,0,1,0
20,467,467,54,54,0,1,0
22,474,474,18,12,6,3,2

16,122,122,4,4,0,1,0
5,142,142,15,15,0,1,0
18,152,152,2,2,0,1,0
4,161,161,6,6,0,1,0
13,186,186,25,13,12,3,2
2,192,192,5,5,0,1,0
0,197,197,22,5,17,2,1
11,203,203,9,9,0,1,0
12,225,225,66,66,0,1,0
3,253,253,14,14,0,1,0
7,264,264,67,67,0,1,0
14,283,283,24,1,23,2,1
15,294,294,11,11,0,1,0
17,341,341,18,18,0,1,0
1,395,395,29,15,14,3,2
8,410,410,43,20,23,2,1
9,433,433,29,12,17,2,1
10,452,452,151,151,0,1,0
6,500,500,83,47,36,3,2

4,101,101,1,1,0,1,0
2,106,106,1,1,0,1,0
1,118,118,6,6,0,1,0
6,129,129,9,9,0,1,0
12,136,136,23,15,8,3,2
17,142,142,8,8,0,1,0
5,170,170,16,9,7,2,1
15,182,182,43,43,0,1,0
14,211,211,54,50,4,2,1
21,250,250,3,3,0,1,0
13,254,254,9,9,0,1,0
7,284,284,41,6,35,2,1
11,319,319,76,36,40,2,1
3,344,344,16,16,0,1,0
8,347,347,25,25,0,1,0
0,358,358,16,16,0,1,0
10,368,368,1,1,0,1,0
9,370,370,20,20,0,1,0
16,373,373,66,66,0,1,0
19,376,376,66,28,38,3,2
20,455,455,27,6,21,4,3
18,471,471,6,6,0,1,0

14,105,105,8,8,0,1,0
5,163,163,33,13,20,2,1
10,230,230,61,61,0,1,0
2,233,233,38,38,0,1,0
12,295,295,4,1,3,2,1
11,329,329,16,2,14,2,1
0,330,330,14,14,0,1,0
15,337,337,7,7,0,1,0
7,351,351,63,63,0,1,0
13,351,351,115,115,0,1,0
4,368,368,11,11,0,1,0
8,371,371,17,17,0,1,0
1,373,373,1,1,0,1,0
9,438,438,19,4,15,4,3
3,451,451,36,12,24,4,3
6,484,484,233,178,55,4,3

5,101,101,26,1,25,2,1
7,107,107,7,7,0,1,0
15,110,110,6,6,0,1,0
1,114,114,27,19,8,2,1
12,150,150,1,1,0,1,0
2,166,166,1,1,0,1,0
3,172,172,21,21,0,1,0
16,201,201,41,5,36,4,3
11,211,211,67,8,59,4,3
14,224,224,11,4,7,2,1
13,239,239,17,17,0,1,0
0,301,301,63,63,0,1,0
8,347,347,55,6,49,2,1
4,365,365,15,9,6,2,1
10,416,416,48,32,16,2,1
9,462,462,23,3,20,3,2
6,469,469,30,18,12,2,1

1,113,113,11,11,0,1,0
15,191,191,39,39,0,1,0
13,249,249,8,5,3,2,1
10,293,293,28,23,5,2,1
5,324,324,16,16,0,1,0
2,338,338,25,9,16,2,1
4,350,350,147,24,123,4,3
14,354,354,7,4,3,2,1
9,362,362,42,4,38,3,2
3,393,393,31,31,0,1,0
7,426,426,19,5,14,2,1
8,444,444,72,65,7,2,1
11,466,466,129,129,0,1,0
6,489,489,116,104,12,4,3
12,491,491,28,28,0,1,0
0,495,495,22,7,15,3,2

13,116,116,18,4,14,3,2
4,143,143,4,4,0,1,0
14,144,144,2,2,0,1,0
23,145,145,29,29,0,1,0
0,154,154,14,2,12,2,1
1,181,181,12,12,0,1,0
6,195,195,14,14,0,1,0
3,196,196,12,12,0,1,0
7,198,198,22,22,0,1,0
8,200,200,2,2,0,1,0
21,212,212,21,5,16,3,2
20,239,239,9,6,3,2,1
15,250,250,17,2,15,4,3
9,263,263,25,25,0,1,0
12,291,291,1,1,0,1,0
5,294,294,17,1,16,3,2
2,330,330,25,25,0,1,0
19,354,354,55,42,13,2,1
11,378,378,33,9,24,4,3
18,379,379,37,7,30,3,2
17,389,389,13,2,11,2,1
16,450,450,90,6,84,4,3
22,453,453,48,22,26,3,2
10,467,467,2,2,0,1,0
24,469,469,42,18,24,3,2

6,101,101,30,30,0,1,0
3,125,125,11,4,7,2,1
4,144,144,3,3,0,1,0
1,158,158,5,5,0,1,0
8,168,168,4,4,0,1,0
11,178,178,2,2,0,1,0
13,204,204,22,6,16,3,2
7,231,231,3,3,0,1,0
14,270,270,24,24,0,1,0
2,289,289,87,62,25,4,3
15,290,290,20,5,15,4,3
16,354,354,48,48,0,1,0
17,372,372,46,31,15,2,1
9,391,391,41,41,0,1,0
10,394,394,75,36,39,2,1
0,397,397,19,6,13,2,1
5,407,407,73,73,0,1,0
12,491,491,91,91,0,1,0

3,112,112,4,4,0,1,0
5,112,112,7,7,0,1,0
21,129,129,3,3,0,1,0
10,140,140,4,4,0,1,0
9,151,151,3,3,0,1,0
7,154,154,6,6,0,1,0
17,207,207,69,29,40,2,1
12,211,211,1,1,0,1,0
1,212,212,1,1,0,1,0
19,219,219,6,6,0,1,0
18,226,226,12,2,10,3,2
11,289,289,6,6,0,1,0
13,351,351,29,20,9,4,3
15,353,353,30,24,6,3,2
0,360,360,12,12,0,1,0
8,360,360,56,8,48,4,3
2,367,367,1,1,0,1,0
4,376,376,186,99,87,4,3
22,383,383,20,20,0,1,0
6,399,399,7,4,3,2,1
14,403,403,58,24,34,2,1
16,410,410,19,19,0,1,0
20,478,478,122,4,118,4,3

8,113,113,18,18,0,1,0
13,145,145,32,8,24,2,1
19,188,188,5,5,0,1,0
18,213,213,18,18,0,1,0
1,215,215,6,6,0,1,0
16,234,234,17,4,13,2,1
2,240,240,16,16,0,1,0
17,242,242,22,22,0,1,0
0,274,274,25,25,0,1,0
15,296,296,31,31,0,1,0
14,306,306,5,1,4,2,1
4,342,342,9,9,0,1,0
10,399,399,6,6,0,1,0
6,409,409,26,19,7,2,1
11,409,409,54,54,0,1,0
5,434,434,126,126,0,1,0
7,437,437,1,1,0,1,0
3,441,441,48,48,0,1,0
12,449,449,122,116,6,3,2
9,460,460,69,3,66,4,3

3,103,103,1,1,0,1,0
12,138,138,26,26,0,1,0
8,154,154,7,2,5,2,1
14,154,154,2,2,0,1,0
18,183,183,39,39,0,1,0
2,319,319,21,21,0,1,0
4,330,330,116,36,80,4,3
9,373,373,1,1,0,1,0
10,383,383,33,33,0,1,0
16,383,383,20,20,0,1,0
0,388,388,41,15,26,4,3
17,402,402,65,22,43,2,1
6,406,406,34,34,0,1,0
7,414,414,34,17,17,2,1
15,441,441,86,63,23,3,2
13,444,444,12,12,0,1,0
11,461,461,60,25,35,2,1
1,484,484,27,27,0,1,0
5,486,486,55,55,0,1,0
19,500,500,18,6,12,2,1

1,113,113,10,5,5,2,1
15,117,117,4,4,0,1,0
19,124,124,10,5,5,2,1
18,139,139,9,3,6,3,2
10,140,140,9,9,0,1,0
2,163,163,1,1,0,1,0
12,167,167,47,47,0,1,0
0,173,173,9,9,0,1,0
6,187,187,6,6,0,1,0
4,205,205,1,1,0,1,0
13,264,264,31,22,9,2,1
7,282,282,3,3,0,1,0
9,285,285,26,8,18,3,2
16,352,352,11,1,10,2,1
3,360,360,135,135,0,1,0
5,392,392,37,37,0,1,0
14,399,399,114,30,84,4,3
8,407,407,74,74,0,1,0
11,416,416,40,40,0,1,0
17,437,437,13,13,0,1,0

22,116,116,2,2,0,1,0
19,155,155,57,57,0,1,0
20,188,188,2,2,0,1,0
3,193,193,3,3,0,1,0
1,211,211,3,3,0,1,0
21,211,211,4,4,0,1,0
0,217,217,9,5,4,2,1
6,231,231,34,22,12,2,1
10,231,231,28,23,5,2,1
7,256,256,3,3,0,1,0
4,266,266,2,2,0,1,0
8,268,268,21,6,15,4,3
16,270,270,29,7,22,3,2
14,275,275,4,4,0,1,0
13,275,275,71,62,9,4,3
2,288,288,50,17,33,3,2
12,292,292,6,6,0,1,0
18,328,328,107,93,14,3,2
15,426,426,36,36,0,1,0
9,441,441,18,8,10,3,2
17,443,443,34,11,23,2,1
11,481,481,20,1,19,2,1
5,484,484,14,14,0,1,0

2,122,122,10,10,0,1,0
15,131,131,15,12,3,2,1
8,135,135,5,2,3,2,1
16,172,172,30,18,12,3,2
11,208,208,59,59,0,1,0
3,240,240,24,24,0,1,0
14,256,256,34,34,0,1,0
13,270,270,10,10,0,1,0
1,295,295,25,18,7,2,1
9,309,309,38,38,0,1,0
12,328,328,33,33,0,1,0
0,344,344,54,54,0,1,0
5,367,367,40,40,0,1,0
6,399,399,150,128,22,3,2
7,446,446,39,29,10,4,3
10,491,491,10,2,8,3,2
4,500,500,3,3,0,1,0

9,109,109,7,7,0,1,0
20,121,121,27,27,0,1,0
14,141,141,7,7,0,1,0
10,148,148,11,3,8,3,2
15,152,152,10,2,8,2,1
23,155,155,16,8,8,2,1
2,157,157,5,5,0,1,0
0,161,161,3,3,0,1,0
1,194,194,9,4,5,2,1
7,197,197,28,3,25,2,1
22,224,224,17,2,15,4,3
19,249,249,11,11,0,1,0
4,336,336,8,3,5,2,1
11,352,352,20,20,0,1,0
21,370,370,134,102,32,3,2
17,383,383,42,42,0,1,0
3,393,393,27,12,15,4,3
5,408,408,30,30,0,1,0
13,426,426,39,39,0,1,0
6,442,442,19,10,9,3,2
8,444,444,95,89,6,3,2
16,459,459,8,2,6,3,2
18,459,459,9,9,0,1,0
12,490,490,2,2,0,1,0

11,100,100,14,2,12,3,2
4,145,145,36,20,16,3,2
7,151,151,8,8,0,1,0
14,154,154,12,12,0,1,0
9,195,195,10,2,8,3,2
1,282,282,87,87,0,1,0
0,283,283,30,15,15,4,3
5,289,289,7,7,0,1,0
10,292,292,17,17,0,1,0
6,297,297,24,24,0,1,0
12,310,310,17,17,0,1,0
3,395,395,119,119,0,1,0
13,405,405,102,102,0,1,0
2,475,475,6,6,0,1,0
8,476,476,119,89,30,4,3

5,109,109,11,2,9,2,1
14,136,136,25,5,20,2,1
11,203,203,14,8,6,2,1
9,239,239,24,9,15,4,3
6,240,240,12,3,9,2,1
2,244,244,161,161,0,1,0
7,253,253,2,2,0,1,0
3,254,254,10,10,0,1,0
8,301,301,13,13,0,1,0
1,341,341,1,1,0,1,0
0,348,348,38,22,16,2,1
4,375,375,33,5,28,4,3
10,424,424,3,3,0,1,0
12,441,441,71,45,26,3,2
13,494,494,199,156,43,2,1

17,104,104,30,12,18,3,2
21,142,142,9,5,4,2,1
2,151,151,6,6,0,1,0
8,154,154,22,22,0,1,0
11,160,160,8,8,0,1,0
19,169,169,31,21,10,2,1
1,210,210,17,17,0,1,0
14,238,238,26,26,0,1,0
16,288,288,103,103,0,1,0
0,320,320,16,16,0,1,0
22,360,360,11,2,9,2,1
13,363,363,10,2,8,3,2
20,365,365,11,11,0,1,0
10,370,370,10,1,9,4,3
15,381,381,17,17,0,1,0
6,384,384,18,18,0,1,0
9,388,388,71,71,0,1,0
4,391,391,7,7,0,1,0
5,395,395,2,2,0,1,0
7,396,396,10,2,8,3,2
12,407,407,36,36,0,1,0
18,427,427,2,2,0,1,0
23,440,440,5,5,0,1,0
3,492,492,53,53,0,1,0

11,131,131,15,15,0,1,0
9,155,155,3,3,0,1,0
1,173,173,7,1,6,3,2
6,188,188,8,8,0,1,0
13,192,192,50,50,0,1,0
17,215,215,11,11,0,1,0
15,232,232,8,5,3,2,1
16,258,258,13,13,0,1,0
10,260,260,9,3,6,3,2
4,263,263,32,2,30,4,3
5,276,276,54,42,12,3,2
12,279,279,7,7,0,1,0
7,280,280,64,33,31,2,1
0,303,303,33,33,0,1,0
14,396,396,133,60,73,4,3
19,425,425,3,3,0,1,0
3,435,435,48,10,38,3,2
8,443,443,16,16,0,1,0
2,443,443,29,23,6,3,2
18,471,471,65,20,45,4,3

2,104,104,1,1,0,1,0
8,143,143,37,37,0,1,0
12,146,146,41,10,31,2,1
20,164,164,38,22,16,3,2
18,173,173,9,1,8,2,1
4,178,178,34,34,0,1,0
15,202,202,10,1,9,2,1
3,204,204,3,3,0,1,0
9,206,206,8,8,0,1,0
0,207,207,6,6,0,1,0
16,216,216,6,6,0,1,0
11,258,258,37,37,0,1,0
10,271,271,14,4,10,3,2
13,309,309,1,1,0,1,0
1,335,335,34,34,0,1,0
6,351,351,45,22,23,2,1
7,359,359,7,4,3,2,1
17,364,364,61,61,0,1,0
14,374,374,32,32,0,1,0
5,423,423,6,2,4,2,1
19,478,478,55,1,54,4,3

13,110,110,3,3,0,1,0
3,131,131,2,2,0,1,0
2,148,148,4,4,0,1,0
8,149,149,7,1,6,2,1
5,155,155,6,6,0,1,0
18,173,173,46,46,0,1,0
19,178,178,50,28,22,3,2
4,198,198,10,10,0,1,0
12,208,208,25,25,0,1,0
21,219,219,22,15,7,2,1
26,237,237,23,2,21,4,3
15,287,287,2,2,0,1,0
22,290,290,14,2,12,4,3
9,340,340,11,11,0,1,0
7,387,387,1,1,0,1,0
6,387,387,16,16,0,1,0
24,397,397,33,9,24,2,1
14,415,415,20,6,14,3,2
1,417,417,2,2,0,1,0
25,421,421,5,5,0,1,0
0,446,446,50,50,0,1,0
16,464,464,1,1,0,1,0
23,465,465,25,25,0,1,0
10,471,471,33,33,0,1,0
11,477,477,39,39,0,1,0
20,488,488,154,28,126,4,3
17,493,493,5,2,3,2,1
27,499,499,10,10,0,1,0

11,115,115,21,21,0,1,0
5,135,135,10,10,0,1,0
2,137,137,8,8,0,1,0
4,155,155,31,19,12,3,2
1,174,174,7,7,0,1,0
0,178,178,23,1,22,4,3
15,255,255,79,10,69,3,2
7,256,256,9,1,8,3,2
19,291,291,15,15,0,1,0
13,337,337,60,60,0,1,0
17,343,343,40,26,14,2,1
12,366,366,4,4,0,1,0
18,372,372,14,14,0,1,0
3,394,394,15,15,0,1,0
6,400,400,18,18,0,1,0
14,403,403,44,44,0,1,0
8,410,410,64,19,45,4,3
16,436,436,6,6,0,1,0
9,443,443,30,3,27,4,3
10,497,497,78,46,32,2,1

5,120,120,6,6,0,1,0
10,155,155,17,17,0,1,0
3,165,165,13,13,0,1,0
12,169,169,27,13,14,3,2
19,173,173,1,1,0,1,0
15,187,187,10,10,0,1,0
20,204,204,44,12,32,2,1
13,220,220,23,6,17,2,1
6,222,222,35,35,0,1,0
2,241,241,7,7,0,1,0
11,242,242,4,4,0,1,0
0,251,251,23,23,0,1,0
18,278,278,32,32,0,1,0
21,284,284,51,51,0,1,0
8,294,294,4,4,0,1,0
14,299,299,6,3,3,2,1
17,341,341,72,72,0,1,0
1,351,351,72,72,0,1,0
4,364,364,14,14,0,1,0
9,394,394,1,1,0,1,0
16,413,413,45,45,0,1,0
7,456,456,23,5,18,4,3

14,102,102,3,3,0,1,0
16,120,120,22,9,13,2,1
7,146,146,31,31,0,1,0
20,157,157,2,2,0,1,0
3,158,158,3,3,0,1,0
17,164,164,22,1,21,4,3
1,192,192,8,1,7,2,1
11,280,280,18,6,12,4,3
4,288,288,10,1,9,2,1
10,291,291,12,12,0,1,0
18,306,306,75,53,22,4,3
8,317,317,64,46,18,4,3
5,336,336,40,40,0,1,0
9,339,339,3,3,0,1,0
6,351,351,22,22,0,1,0
13,364,364,13,4,9,2,1
0,398,398,48,18,30,4,3
15,427,427,106,52,54,4,3
19,447,447,56,13,43,4,3
2,470,470,35,35,0,1,0
12,494,494,2,2,0,1,0

11,122,122,4,4,0,1,0
16,131,131,7,7,0,1,0
20,137,137,19,19,0,1,0
26,141,141,16,3,13,3,2
18,181,181,61,61,0,1,0
12,204,204,1,1,0,1,0
17,211,211,27,9,18,3,2
0,221,221,15,2,13,2,1
5,222,222,26,26,0,1,0
21,222,222,19,19,0,1,0
6,228,228,20,20,0,1,0
7,264,264,8,8,0,1,0
25,280,280,11,11,0,1,0
23,291,291,8,8,0,1,0
8,304,304,1,1,0,1,0
1,321,321,14,4,10,2,1
3,331,331,7,7,0,1,0
2,341,341,44,44,0,1,0
13,356,356,59,16,43,2,1
19,358,358,4,1,3,2,1
14,380,380,2,2,0,1,0
24,395,395,105,13,92,3,2
9,407,407,10,10,0,1,0
10,419,419,7,7,0,1,0
15,436,436,4,4,0,1,0
4,437,437,26,8,18,3,2
22,441,441,2,2,0,1,0

9,110,110,8,4,4,2,1
11,121,121,12,12,0,1,0
7,133,133,7,7,0,1,0
15,137,137,44,44,0,1,0
10,168,168,1,1,0,1,0
3,209,209,45,45,0,1,0
17,243,243,7,7,0,1,0
4,246,246,35,35,0,1,0
8,273,273,1,1,0,1,0
2,287,287,40,40,0,1,0
13,305,305,30,30,0,1,0
20,321,321,15,15,0,1,0
14,324,324,7,7,0,1,0
12,375,375,77,40,37,2,1
5,395,395,49,33,16,3,2
18,433,433,35,12,23,4,3
1,439,439,12,1,11,2,1
6,443,443,36,12,24,3,2
16,458,458,65,65,0,1,0
19,467,467,33,33,0,1,0
0,476,476,19,19,0,1,0

2,101,101,20,20,0,1,0
20,102,102,3,3,0,1,0
4,111,111,1,1,0,1,0
3,125,125,13,4,9,2,1
16,145,145,13,13,0,1,0
12,200,200,17,6,11,4,3
9,204,204,6,6,0,1,0
17,222,222,75,75,0,1,0
8,242,242,21,3,18,4,3
1,333,333,41,33,8,2,1
18,343,343,6,6,0,1,0
11,347,347,34,34,0,1,0
6,380,380,45,45,0,1,0
19,400,400,20,3,17,2,1
0,405,405,38,38,0,1,0
14,431,431,20,4,16,3,2
13,435,435,110,110,0,1,0
7,436,436,14,14,0,1,0
10,458,458,1,1,0,1,0
15,479,479,55,14,41,3,2
5,494,494,52,52,0,1,0

1,144,144,13,13,0,1,0
16,162,162,24,24,0,1,0
9,190,190,12,12,0,1,0
17,191,191,12,12,0,1,0
0,196,196,42,42,0,1,0
18,205,205,47,11,36,4,3
5,213,213,13,5,8,2,1
14,216,216,10,4,6,3,2
3,227,227,2,2,0,1,0
15,227,227,9,9,0,1,0
19,235,235,4,1,3,2,1
13,242,242,55,20,35,2,1
12,284,284,3,3,0,1,0
7,303,303,1,1,0,1,0
8,322,322,6,2,4,2,1
11,337,337,80,68,12,4,3
4,384,384,117,117,0,1,0
6,403,403,10,10,0,1,0
10,449,449,13,13,0,1,0
2,450,450,82,82,0,1,0

10,125,125,6,2,4,2,1
9,165,165,6,6,0,1,0
11,173,173,18,18,0,1,0
17,180,180,23,17,6,3,2
1,184,184,11,11,0,1,0
7,193,193,14,14,0,1,0
6,199,199,4,4,0,1,0
15,206,206,30,18,12,3,2
4,217,217,81,81,0,1,0
18,234,234,46,37,9,2,1
8,241,241,1,1,0,1,0
12,242,242,74,74,0,1,0
13,267,267,14,6,8,2,1
3,270,270,21,9,12,4,3
2,293,293,24,17,7,2,1
5,369,369,33,33,0,1,0
0,371,371,53,6,47,3,2
19,426,426,29,29,0,1,0
14,429,429,3,3,0,1,0
16,492,492,4,1,3,2,1

10,110,110,4,4,0,1,0
9,121,121,8,3,5,2,1
5,135,135,6,6,0,1,0
3,144,144,3,3,0,1,0
13,160,160,15,15,0,1,0
1,184,184,29,29,0,1,0
8,198,198,4,4,0,1,0
2,219,219,60,25,35,3,2
14,296,296,32,32,0,1,0
15,298,298,86,48,38,4,3
0,364,364,17,17,0,1,0
4,367,367,68,62,6,2,1
6,420,420,102,53,49,4,3
16,447,447,17,6,11,2,1
7,450,450,13,9,4,2,1
12,467,467,134,51,83,4,3
11,484,484,42,42,0,1,0

14,104,104,5,5,0,1,0
11,129,129,10,10,0,1,0
1,159,159,9,2,7,2,1
2,162,162,35,35,0,1,0
16,176,176,31,31,0,1,0
6,212,212,30,24,6,2,1
5,246,246,2,2,0,1,0
10,257,257,38,38,0,1,0
9,320,320,8,8,0,1,0
15,328,328,6,6,0,1,0
8,362,362,104,104,0,1,0
7,381,381,119,14,105,4,3
13,399,399,85,36,49,2,1
4,447,447,73,73,0,1,0
12,467,467,11,7,4,2,1
0,470,470,29,11,18,3,2
3,474,474,20,11,9,2,1

11,121,121,8,8,0,1,0
6,156,156,6,6,0,1,0
1,174,174,12,12,0,1,0
5,180,180,40,40,0,1,0
7,196,196,27,27,0,1,0
15,250,250,12,12,0,1,0
12,252,252,27,27,0,1,0
10,263,263,92,92,0,1,0
9,305,305,25,5,20,4,3
4,321,321,33,33,0,1,0
13,325,325,19,4,15,4,3
0,329,329,81,64,17,2,1
8,337,337,53,53,0,1,0
14,343,343,1,1,0,1,0
2,374,374,40,40,0,1,0
3,397,397,32,22,10,3,2
16,415,415,59,59,0,1,0

4,109,109,21,21,0,1,0
2,112,112,4,1,3,2,1
9,125,125,38,38,0,1,0
15,133,133,3,3,0,1,0
16,157,157,14,8,6,2,1
12,212,212,13,13,0,1,0
0,221,221,37,22,15,2,1
6,240,240,26,26,0,1,0
13,249,249,69,15,54,3,2
5,269,269,29,29,0,1,0
11,306,306,12,12,0,1,0
14,351,351,2,2,0,1,0
1,378,378,37,37,0,1,0
7,432,432,113,86,27,4,3
8,442,442,37,37,0,1,0
10,459,459,60,60,0,1,0
3,472,472,14,14,0,1,0

11,119,119,3,3,0,1,0
14,123,123,3,3,0,1,0
15,127,127,2,2,0,1,0
4,137,137,3,3,0,1,0
23,170,170,34,34,0,1,0
1,191,191,8,8,0,1,0
22,196,196,52,29,23,2,1
13,199,199,2,2,0,1,0
16,200,200,35,8,27,2,1
12,204,204,1,1,0,1,0
9,243,243,9,9,0,1,0
6,245,245,10,10,0,1,0
20,274,274,2,2,0,1,0
10,278,278,7,1,6,3,2
7,279,279,40,40,0,1,0
5,313,313,9,4,5,2,1
3,318,318,71,35,36,2,1
0,363,363,18,4,14,3,2
17,387,387,22,1,21,4,3
18,403,403,5,1,4,2,1
21,464,464,30,16,14,2,1
8,479,479,151,37,114,4,3
2,482,482,7,1,6,3,2
19,484,484,106,106,0,1,0

12,124,124,34,3,31,2,1
15,127,127,10,1,9,2,1
4,152,152,7,7,0,1,0
8,202,202,33,17,16,3,2
2,272,272,31,12,19,2,1
16,279,279,4,4,0,1,0
13,354,354,13,13,0,1,0
11,359,359,86,32,54,4,3
14,411,411,3,3,0,1,0
1,438,438,36,32,4,2,1
10,441,441,57,57,0,1,0
9,447,447,45,36,9,4,3
5,457,457,8,2,6,2,1
0,466,466,4,4,0,1,0
6,478,478,169,46,123,4,3
3,479,479,45,1,44,3,2
17,487,487,67,5,62,4,3
7,491,491,61,42,19,2,1

0,132,132,1,1,0,1,0
10,140,140,30,14,16,2,1
8,145,145,3,3,0,1,0
21,158,158,33,33,0,1,0
22,170,170,2,2,0,1,0
19,208,208,11,11,0,1,0
7,219,219,2,2,0,1,0
17,221,221,22,13,9,4,3
18,221,221,4,4,0,1,0
23,231,231,43,2,41,2,1
12,268,268,18,9,9,4,3
16,274,274,37,30,7,2,1
4,278,278,1,1,0,1,0
2,284,284,29,29,0,1,0
3,295,295,50,38,12,2,1
14,303,303,1,1,0,1,0
11,324,324,23,2,21,2,1
1,326,326,1,1,0,1,0
13,328,328,14,3,11,2,1
20,341,341,5,1,4,2,1
9,346,346,9,9,0,1,0
24,350,350,103,99,4,2,1
6,379,379,24,2,22,2,1
5,402,402,46,46,0,1,0
15,471,471,39,39,0,1,0

11,101,101,17,5,12,2,1
19,126,126,32,32,0,1,0
9,139,139,6,6,0,1,0
20,171,171,20,20,0,1,0
6,183,183,9,1,8,2,1
16,221,221,16,4,12,3,2
2,263,263,9,3,6,2,1
15,266,266,21,21,0,1,0
1,275,275,12,12,0,1,0
12,295,295,21,21,0,1,0
22,327,327,19,19,0,1,0
13,328,328,1,1,0,1,0
27,354,354,6,1,5,2,1
8,362,362,1,1,0,1,0
0,362,362,21,21,0,1,0
23,364,364,55,10,45,2,1
25,367,367,48,29,19,2,1
18,377,377,36,26,10,2,1
21,384,384,37,37,0,1,0
7,398,398,14,14,0,1,0
5,418,418,15,15,0,1,0
10,419,419,11,8,3,2,1
4,433,433,17,17,0,1,0
14,453,453,1,1,0,1,0
3,481,481,23,23,0,1,0
26,484,484,87,5,82,3,2
17,488,488,46,11,35,2,1
24,496,496,4,4,0,1,0

10,101,101,4,4,0,1,0
5,109,109,8,8,0,1,0
7,109,109,1,1,0,1,0
14,198,198,103,28,75,4,3
16,206,206,5,5,0,1,0
20,220,220,3,3,0,1,0
1,227,227,9,9,0,1,0
15,256,256,8,4,4,2,1
0,276,276,21,21,0,1,0
2,278,278,2,2,0,1,0
8,295,295,27,27,0,1,0
19,310,310,20,3,17,2,1
6,316,316,7,7,0,1,0
9,335,335,108,108,0,1,0
12,357,357,62,20,42,2,1
18,415,415,38,38,0,1,0
11,446,446,26,14,12,4,3
3,452,452,56,4,52,3,2
17,455,455,11,5,6,2,1
4,496,496,68,68,0,1,0
13,497,497,34,34,0,1,0

15,108,108,25,2,23,2,1
6,123,123,13,13,0,1,0
7,182,182,2,2,0,1,0
3,230,230,4,1,3,2,1
10,270,270,16,16,0,1,0
18,273,273,38,38,0,1,0
12,300,300,7,7,0,1,0
11,303,303,2,2,0,1,0
16,325,325,13,5,8,2,1
14,325,325,87,30,57,4,3
0,329,329,29,29,0,1,0
4,358,358,94,94,0,1,0
13,359,359,38,38,0,1,0
8,405,405,68,68,0,1,0
17,430,430,63,51,12,4,3
9,432,432,58,58,0,1,0
1,477,477,59,59,0,1,0
5,480,480,35,35,0,1,0
2,481,481,9,9,0,1,0

9,154,154,9,4,5,2,1
8,161,161,4,4,0,1,0
7,188,188,121,1,120,4,3
0,198,198,27,6,21,4,3
13,226,226,27,27,0,1,0
6,230,230,4,4,0,1,0
10,256,256,95,5,90,3,2
4,257,257,18,18,0,1,0
1,263,263,7,7,0,1,0
16,272,272,21,21,0,1,0
17,272,272,33,19,14,2,1
12,279,279,24,6,18,2,1
5,287,287,16,11,5,2,1
11,335,335,41,31,10,3,2
3,381,381,9,9,0,1,0
15,453,453,11,11,0,1,0
14,465,465,18,18,0,1,0
2,471,471,1,1,0,1,0

12,100,100,34,34,0,1,0
14,125,125,4,4,0,1,0
1,126,126,40,40,0,1,0
9,209,209,1,1,0,1,0
4,247,247,36,36,0,1,0
3,264,264,48,17,31,2,1
13,293,293,93,66,27,4,3
0,301,301,42,6,36,2,1
11,320,320,1,1,0,1,0
6,332,332,25,16,9,4,3
10,351,351,10,2,8,2,1
5,366,366,1,1,0,1,0
8,447,447,65,27,38,3,2
7,472,472,24,24,0,1,0
15,482,482,45,18,27,4,3
2,484,484,67,40,27,2,1

22,106,106,2,2,0,1,0
7,128,128,1,1,0,1,0
21,148,148,3,3,0,1,0
19,149,149,19,7,12,2,1
18,155,155,9,9,0,1,0
5,184,184,10,1,9,4,3
6,194,194,2,2,0,1,0
8,210,210,7,2,5,2,1
3,223,223,16,16,0,1,0
12,237,237,10,5,5,2,1
16,242,242,31,31,0,1,0
4,325,325,62,43,19,3,2
20,328,328,40,34,6,2,1
15,343,343,15,15,0,1,0
17,345,345,132,132,0,1,0
13,355,355,24,24,0,1,0
0,363,363,50,50,0,1,0
23,367,367,58,9,49,2,1
1,396,396,29,24,5,2,1
24,407,407,4,4,0,1,0
11,418,418,37,37,0,1,0
10,426,426,1,1,0,1,0
14,440,440,27,27,0,1,0
2,470,470,40,40,0,1,0
9,491,491,16,4,12,4,3

0,138,138,1,1,0,1,0
22,141,141,14,8,6,3,2
17,147,147,20,20,0,1,0
6,159,159,7,3,4,2,1
16,207,207,45,37,8,2,1
21,265,265,29,29,0,1,0
13,298,298,5,5,0,1,0
14,302,302,29,29,0,1,0
3,320,320,36,36,0,1,0
18,321,321,6,6,0,1,0
20,327,327,42,23,19,2,1
7,349,349,7,2,5,2,1
8,360,360,38,38,0,1,0
2,377,377,2,2,0,1,0
9,384,384,11,11,0,1,0
10,409,409,44,44,0,1,0
15,416,416,47,25,22,2,1
1,433,433,50,50,0,1,0
12,479,479,1,1,0,1,0
19,481,481,46,23,23,2,1
11,483,483,20,20,0,1,0
5,493,493,42,22,20,3,2
4,495,495,153,137,16,2,1

16,108,108,2,2,0,1,0
1,121,121,44,44,0,1,0
2,158,158,34,24,10,3,2
11,175,175,21,9,12,2,1
5,180,180,1,1,0,1,0
8,196,196,32,4,28,4,3
13,207,207,19,19,0,1,0
7,213,213,23,23,0,1,0
6,229,229,1,1,0,1,0
15,293,293,121,80,41,2,1
3,296,296,24,6,18,2,1
10,300,300,23,23,0,1,0
9,381,381,58,58,0,1,0
14,435,435,50,50,0,1,0
17,467,467,13,6,7,2,1
12,475,475,2,2,0,1,0
4,478,478,12,2,10,2,1
0,479,479,17,17,0,1,0

0,134,134,4,4,0,1,0
21,136,136,4,4,0,1,0
8,160,160,44,44,0,1,0
10,172,172,9,3,6,3,2
1,177,177,1,1,0,1,0
9,177,177,3,3,0,1,0
6,194,194,1,1,0,1,0
22,208,208,83,49,34,2,1
12,240,240,3,3,0,1,0
16,244,244,20,11,9,4,3
11,261,261,1,1,0,1,0
23,292,292,23,23,0,1,0
18,295,295,14,4,10,2,1
2,299,299,17,17,0,1,0
17,319,319,21,21,0,1,0
19,319,319,1,1,0,1,0
7,322,322,57,15,42,4,3
13,332,332,26,8,18,3,2
20,335,335,18,18,0,1,0
5,347,347,27,15,12,3,2
4,398,398,25,25,0,1,0
15,414,414,105,105,0,1,0
3,432,432,22,5,17,2,1
14,445,445,43,43,0,1,0

16,118,118,1,1,0,1,0
15,125,125,2,2,0,1,0
9,125,125,3,3,0,1,0
8,135,135,18,18,0,1,0
0,167,167,2,2,0,1,0
20,167,167,2,2,0,1,0
5,224,224,24,6,18,2,1
4,280,280,5,5,0,1,0
7,297,297,27,27,0,1,0
17,308,308,56,56,0,1,0
3,317,317,69,69,0,1,0
19,333,333,87,51,36,4,3
14,333,333,34,34,0,1,0
11,346,346,36,36,0,1,0
2,347,347,1,1,0,1,0
13,350,350,86,86,0,1,0
10,351,351,10,10,0,1,0
21,363,363,51,51,0,1,0
18,406,406,20,20,0,1,0
6,438,438,48,48,0,1,0
12,478,478,21,21,0,1,0
1,497,497,54,24,30,3,2

14,142,142,3,3,0,1,0
6,233,233,10,10,0,1,0
11,242,242,10,10,0,1,0
4,245,245,4,4,0,1,0
16,273,273,35,35,0,1,0
12,278,278,55,55,0,1,0
2,283,283,30,14,16,2,1
9,297,297,27,13,14,2,1
0,319,319,22,1,21,4,3
13,326,326,101,93,8,3,2
10,431,431,29,19,10,3,2
8,452,452,16,16,0,1,0
5,459,459,34,24,10,2,1
1,459,459,11,11,0,1,0
3,463,463,266,248,18,3,2
15,463,463,57,35,22,3,2
7,467,467,44,2,42,3,2

9,120,120,19,19,0,1,0
15,143,143,19,7,12,4,3
12,158,158,32,16,16,3,2
10,170,170,16,10,6,2,1
8,179,179,15,15,0,1,0
11,200,200,14,5,9,4,3
7,219,219,4,1,3,2,1
13,237,237,5,5,0,1,0
2,241,241,89,63,26,3,2
3,261,261,15,15,0,1,0
14,309,309,76,76,0,1,0
6,390,390,37,37,0,1,0
1,420,420,13,13,0,1,0
0,468,468,109,109,0,1,0
4,486,486,62,4,58,3,2
5,492,492,43,25,18,4,3

4,111,111,8,1,7,2,1
12,151,151,10,10,0,1,0
2,201,201,1,1,0,1,0
11,254,254,1,1,0,1,0
0,258,258,14,9,5,2,1
5,289,289,71,55,16,2,1
1,307,307,36,36,0,1,0
10,316,316,16,16,0,1,0
6,319,319,110,110,0,1,0
9,355,355,20,20,0,1,0
7,362,362,38,34,4,2,1
13,372,372,50,22,28,2,1
8,396,396,124,31,93,4,3
3,416,416,68,4,64,3,2
15,445,445,29,29,0,1,0
14,482,482,107,88,19,2,1

20,167,167,20,8,12,3,2
19,180,180,36,36,0,1,0
8,191,191,10,10,0,1,0
4,191,191,5,2,3,2,1
9,219,219,19,19,0,1,0
1,274,274,11,5,6,3,2
11,309,309,5,5,0,1,0
14,334,334,32,32,0,1,0
2,351,351,18,12,6,2,1
5,351,351,22,22,0,1,0
12,366,366,17,9,8,3,2
13,372,372,22,22,0,1,0
18,380,380,7,7,0,1,0
3,388,388,99,27,72,4,3
10,390,390,20,6,14,2,1
15,399,399,120,24,96,4,3
6,436,436,49,49,0,1,0
16,458,458,53,14,39,4,3
7,471,471,47,47,0,1,0
0,473,473,47,13,34,3,2
21,485,485,19,7,12,4,3
17,488,488,29,29,0,1,0

18,119,119,7,1,6,3,2
15,150,150,14,14,0,1,0
13,156,156,3,3,0,1,0
4,192,192,46,46,0,1,0
10,198,198,17,17,0,1,0
0,204,204,11,11,0,1,0
11,205,205,6,6,0,1,0
2,209,209,54,54,0,1,0
12,263,263,21,9,12,4,3
6,279,279,20,20,0,1,0
5,286,286,1,1,0,1,0
17,343,343,11,11,0,1,0
14,372,372,217,82,135,4,3
7,398,398,7,2,5,2,1
19,402,402,1,1,0,1,0
9,403,403,90,70,20,3,2
16,405,405,50,6,44,2,1
8,415,415,11,11,0,1,0
3,448,448,1,1,0,1,0
1,476,476,9,9,0,1,0

17,116,116,3,3,0,1,0
10,116,116,15,2,13,2,1
14,122,122,4,4,0,1,0
1,195,195,11,11,0,1,0
9,196,196,19,19,0,1,0
20,198,198,22,18,4,2,1
16,200,200,9,6,3,2,1
0,219,219,24,5,19,2,1
8,260,260,8,8,0,1,0
11,273,273,19,8,11,2,1
13,280,280,39,39,0,1,0
19,317,317,27,27,0,1,0
3,343,343,85,85,0,1,0
22,360,360,77,77,0,1,0
12,363,363,3,3,0,1,0
6,395,395,11,11,0,1,0
21,400,400,92,24,68,3,2
15,407,407,75,51,24,4,3
18,422,422,40,40,0,1,0
5,459,459,3,3,0,1,0
7,464,464,6,6,0,1,0
4,482,482,25,2,23,2,1
2,494,494,7,7,0,1,0

1,118,118,6,6,0,1,0
11,119,119,5,5,0,1,0
19,125,125,9,2,7,2,1
13,159,159,67,67,0,1,0
18,178,178,2,2,0,1,0
15,190,190,38,38,0,1,0
3,214,214,7,3,4,2,1
9,228,228,34,34,0,1,0
5,257,257,1,1,0,1,0
14,272,272,13,13,0,1,0
10,275,275,3,3,0,1,0
0,282,282,24,24,0,1,0
16,313,313,19,16,3,2,1
8,332,332,50,30,20,3,2
12,339,339,15,15,0,1,0
20,359,359,9,1,8,3,2
4,374,374,58,58,0,1,0
7,394,394,8,5,3,2,1
17,400,400,55,51,4,2,1
6,468,468,71,71,0,1,0
2,489,489,73,59,14,3,2

12,134,134,11,11,0,1,0
3,136,136,7,7,0,1,0
8,148,148,8,8,0,1,0
13,158,158,5,5,0,1,0
1,165,165,4,1,3,2,1
15,172,172,2,2,0,1,0
5,187,187,40,8,32,3,2
9,206,206,3,3,0,1,0
11,207,207,33,33,0,1,0
7,245,245,28,7,21,2,1
17,255,255,4,4,0,1,0
4,262,262,43,43,0,1,0
2,288,288,10,3,7,2,1
14,311,311,45,19,26,3,2
0,400,400,110,110,0,1,0
6,467,467,35,35,0,1,0
10,468,468,240,151,89,4,3
16,474,474,18,13,5,2,1

1,106,106,7,7,0,1,0
16,132,132,26,9,17,2,1
3,176,176,28,6,22,3,2
0,183,183,9,2,7,2,1
8,192,192,2,2,0,1,0
11,200,200,10,10,0,1,0
2,208,208,2,2,0,1,0
4,216,216,8,8,0,1,0
13,238,238,31,31,0,1,0
5,254,254,74,55,19,2,1
14,260,260,53,53,0,1,0
9,338,338,9,3,6,3,2
6,346,346,21,21,0,1,0
18,348,348,93,73,20,3,2
7,377,377,48,48,0,1,0
12,408,408,7,4,3,2,1
17,439,439,41,1,40,3,2
19,470,470,21,21,0,1,0
10,475,475,78,45,33,4,3
15,494,494,5,5,0,1,0

11,105,105,15,15,0,1,0
17,120,120,31,31,0,1,0
8,128,128,6,6,0,1,0
13,131,131,4,4,0,1,0
3,139,139,5,5,0,1,0
21,210,210,28,12,16,3,2
4,217,217,41,41,0,1,0
23,234,234,48,48,0,1,0
9,236,236,1,1,0,1,0
12,253,253,9,6,3,2,1
15,260,260,8,8,0,1,0
14,264,264,4,1,3,2,1
5,271,271,48,22,26,3,2
6,273,273,35,5,30,3,2
0,285,285,5,5,0,1,0
7,288,288,2,2,0,1,0
10,305,305,4,4,0,1,0
16,353,353,113,52,61,4,3
19,370,370,9,9,0,1,0
2,384,384,3,3,0,1,0
20,403,403,12,12,0,1,0
18,460,460,3,3,0,1,0
1,471,471,71,29,42,2,1
22,478,478,3,3,0,1,0

18,107,107,2,2,0,1,0
15,117,117,16,7,9,2,1
5,122,122,8,8,0,1,0
13,129,129,7,7,0,1,0
4,139,139,2,2,0,1,0
7,151,151,7,2,5,2,1
19,155,155,11,11,0,1,0
11,224,224,20,20,0,1,0
0,232,232,21,6,15,2,1
17,255,255,25,25,0,1,0
8,284,284,3,3,0,1,0
12,303,303,17,17,0,1,0
3,331,331,57,57,0,1,0
16,332,332,11,3,8,2,1
14,373,373,176,128,48,4,3
2,392,392,136,76,60,4,3
1,418,418,22,9,13,2,1
9,429,429,12,7,5,2,1
6,438,438,9,4,5,2,1
10,491,491,75,75,0,1,0

3,101,101,21,3,18,3,2
8,103,103,1,1,0,1,0
17,118,118,8,8,0,1,0
5,128,128,5,5,0,1,0
16,168,168,51,51,0,1,0
6,170,170,22,22,0,1,0
15,194,194,46,46,0,1,0
7,212,212,18,2,16,2,1
0,214,214,8,8,0,1,0
2,223,223,11,6,5,2,1
21,236,236,1,1,0,1,0
10,236,236,39,6,33,2,1
4,259,259,1,1,0,1,0
9,261,261,1,1,0,1,0
19,287,287,38,38,0,1,0
12,353,353,24,16,8,3,2
13,355,355,1,1,0,1,0
22,368,368,10,10,0,1,0
1,404,404,2,2,0,1,0
11,418,418,81,81,0,1,0
20,445,445,59,59,0,1,0
18,470,470,22,22,0,1,0
14,475,475,33,6,27,2,1

19,140,140,43,32,11,2,1
6,149,149,6,6,0,1,0
11,167,167,20,10,10,3,2
3,172,172,15,7,8,3,2
2,175,175,25,5,20,3,2
1,184,184,21,12,9,4,3
16,204,204,3,3,0,1,0
7,217,217,12,12,0,1,0
13,254,254,36,27,9,2,1
12,269,269,1,1,0,1,0
20,272,272,21,21,0,1,0
10,276,276,14,14,0,1,0
9,279,279,39,36,3,2,1
18,322,322,1,1,0,1,0
15,338,338,9,9,0,1,0
8,386,386,8,8,0,1,0
4,436,436,5,5,0,1,0
14,439,439,140,39,101,4,3
5,463,463,95,95,0,1,0
17,472,472,60,45,15,2,1
0,489,489,7,7,0,1,0

11,103,103,8,8,0,1,0
21,119,119,4,4,0,1,0
19,132,132,3,3,0,1,0
18,160,160,31,31,0,1,0
10,221,221,23,23,0,1,0
16,222,222,18,8,10,3,2
7,230,230,8,8,0,1,0
0,241,241,36,27,9,2,1
15,252,252,36,36,0,1,0
9,299,299,4,4,0,1,0
12,313,313,11,11,0,1,0
2,333,333,47,33,14,2,1
3,343,343,41,41,0,1,0
8,367,367,12,7,5,2,1
17,371,371,58,58,0,1,0
5,372,372,55,28,27,2,1
20,382,382,60,60,0,1,0
6,399,399,23,18,5,2,1
13,460,460,2,2,0,1,0
4,469,469,6,3,3,2,1
14,498,498,110,88,22,2,1
1,500,500,37,37,0,1,0

2,105,105,9,9,0,1,0
14,106,106,11,1,10,3,2
8,161,161,22,22,0,1,0
16,250,250,113,113,0,1,0
7,256,256,90,76,14,2,1
4,258,258,15,6,9,4,3
3,259,259,17,2,15,2,1
0,284,284,33,17,16,3,2
5,350,350,55,55,0,1,0
9,396,396,28,16,12,4,3
15,407,407,44,24,20,2,1
6,418,418,8,4,4,2,1
13,422,422,1,1,0,1,0
11,441,441,5,5,0,1,0
12,442,442,32,24,8,3,2
10,472,472,30,3,27,2,1
1,495,495,73,73,0,1,0

3,100,100,22,22,0,1,0
15,103,103,9,9,0,1,0
5,105,105,1,1,0,1,0
7,166,166,6,6,0,1,0
11,212,212,19,19,0,1,0
8,220,220,15,3,12,4,3
2,242,242,8,8,0,1,0
17,276,276,28,13,15,4,3
0,338,338,13,13,0,1,0
14,346,346,31,1,30,2,1
9,355,355,5,5,0,1,0
10,384,384,2,2,0,1,0
19,412,412,106,47,59,4,3
13,413,413,6,1,5,2,1
18,413,413,74,74,0,1,0
16,464,464,72,18,54,3,2
1,473,473,32,26,6,2,1
6,477,477,163,163,0,1,0
12,485,485,21,4,17,2,1
4,499,499,84,70,14,3,2

6,114,114,12,12,0,1,0
1,121,121,17,5,12,2,1
3,133,133,36,18,18,3,2
13,168,168,6,6,0,1,0
0,174,174,1,1,0,1,0
5,179,179,53,53,0,1,0
10,209,209,2,2,0,1,0
11,230,230,30,26,4,2,1
9,313,313,13,7,6,3,2
4,335,335,47,15,32,2,1
14,335,335,31,4,27,2,1
2,340,340,50,50,0,1,0
7,354,354,116,116,0,1,0
12,402,402,34,18,16,3,2
8,493,493,95,29,66,3,2

10,108,108,1,1,0,1,0
9,173,173,18,18,0,1,0
8,186,186,1,1,0,1,0
12,195,195,59,56,3,2,1
0,226,226,136,136,0,1,0
3,261,261,14,11,3,2,1
7,289,289,1,1,0,1,0
6,299,299,8,4,4,2,1
5,330,330,103,7,96,3,2
11,370,370,15,15,0,1,0
2,377,377,42,42,0,1,0
13,392,392,82,16,66,4,3
4,471,471,62,62,0,1,0
1,498,498,51,31,20,2,1

8,117,117,13,8,5,2,1
11,133,133,16,7,9,2,1
18,189,189,6,6,0,1,0
14,192,192,86,26,60,3,2
1,200,200,16,16,0,1,0
17,227,227,75,27,48,4,3
4,235,235,36,24,12,4,3
12,248,248,3,3,0,1,0
7,277,277,8,1,7,2,1
16,300,300,10,10,0,1,0
3,342,342,12,12,0,1,0
2,350,350,51,18,33,2,1
13,368,368,4,4,0,1,0
5,402,402,20,2,18,2,1
15,414,414,8,4,4,2,1
9,446,446,38,38,0,1,0
6,456,456,141,141,0,1,0
0,494,494,1,1,0,1,0
10,495,495,6,6,0,1,0

8,139,139,9,9,0,1,0
17,159,159,29,16,13,2,1
10,164,164,23,8,15,2,1
9,223,223,7,2,5,2,1
16,264,264,36,36,0,1,0
1,315,315,10,10,0,1,0
7,332,332,8,1,7,3,2
14,338,338,4,4,0,1,0
4,347,347,41,41,0,1,0
18,353,353,36,10,26,3,2
6,370,370,19,19,0,1,0
0,393,393,170,146,24,4,3
2,399,399,48,16,32,4,3
3,401,401,1,1,0,1,0
5,436,436,55,22,33,4,3
11,443,443,18,18,0,1,0
12,452,452,63,59,4,2,1
13,483,483,25,25,0,1,0
15,486,486,103,103,0,1,0

8,113,113,22,22,0,1,0
14,132,132,6,6,0,1,0
1,138,138,1,1,0,1,0
16,145,145,18,11,7,2,1
15,155,155,24,18,6,2,1
10,181,181,14,14,0,1,0
2,202,202,27,27,0,1,0
0,236,236,101,71,30,3,2
7,253,253,26,26,0,1,0
6,296,296,11,11,0,1,0
13,329,329,35,23,12,2,1
3,348,348,45,45,0,1,0
9,354,354,51,5,46,3,2
5,373,373,1,1,0,1,0
4,462,462,75,41,34,2,1
11,486,486,50,50,0,1,0
12,488,488,38,38,0,1,0

1,166,166,10,1,9,2,1
5,166,166,32,7,25,4,3
9,192,192,17,11,6,3,2
0,195,195,16,4,12,3,2
4,229,229,1,1,0,1,0
11,232,232,77,46,31,2,1
7,238,238,46,46,0,1,0
12,309,309,9,3,6,2,1
10,336,336,6,6,0,1,0
13,359,359,83,83,0,1,0
6,379,379,21,3,18,4,3
15,384,384,9,9,0,1,0
14,406,406,26,26,0,1,0
2,417,417,244,119,125,4,3
8,443,443,16,16,0,1,0
3,452,452,10,10,0,1,0

0,104,104,16,9,7,2,1
13,114,114,13,8,5,2,1
4,136,136,2,2,0,1,0
19,145,145,1,1,0,1,0
18,147,147,1,1,0,1,0
5,202,202,16,16,0,1,0
9,236,236,19,19,0,1,0
15,250,250,15,15,0,1,0
16,254,254,7,4,3,2,1
14,259,259,80,56,24,4,3
12,308,308,125,41,84,4,3
6,314,314,2,2,0,1,0
1,366,366,12,6,6,3,2
8,400,400,6,6,0,1,0
20,404,404,26,26,0,1,0
10,425,425,56,26,30,3,2
2,431,431,2,2,0,1,0
3,444,444,4,4,0,1,0
21,460,460,13,13,0,1,0
11,477,477,24,24,0,1,0
7,478,478,8,8,0,1,0
17,480,480,194,187,7,2,1

7,111,111,20,2,18,3,2
1,112,112,13,13,0,1,0
4,115,115,22,22,0,1,0
5,117,117,13,13,0,1,0
17,135,135,5,5,0,1,0
3,147,147,5,1,4,2,1
9,148,148,29,29,0,1,0
15,178,178,8,8,0,1,0
10,180,180,12,12,0,1,0
14,334,334,40,40,0,1,0
2,395,395,14,14,0,1,0
11,410,410,61,61,0,1,0
0,421,421,14,14,0,1,0
16,421,421,29,11,18,4,3
12,440,440,8,4,4,2,1
8,481,481,35,14,21,4,3
13,487,487,153,153,0,1,0
6,499,499,113,15,98,3,2

11,100,100,12,2,10,2,1
9,109,109,9,5,4,2,1
0,122,122,8,8,0,1,0
12,144,144,4,4,0,1,0
10,179,179,2,2,0,1,0
19,181,181,75,75,0,1,0
14,225,225,11,11,0,1,0
5,233,233,33,24,9,2,1
17,245,245,14,7,7,2,1
1,263,263,22,22,0,1,0
4,277,277,24,3,21,4,3
6,305,305,1,1,0,1,0
7,332,332,15,15,0,1,0
2,341,341,48,22,26,2,1
8,391,391,27,24,3,2,1
21,395,395,11,11,0,1,0
15,402,402,22,5,17,4,3
3,402,402,52,25,27,4,3
18,429,429,101,101,0,1,0
20,447,447,57,10,47,2,1
16,467,467,15,15,0,1,0
13,488,488,7,2,5,2,1

1,112,112,5,1,4,2,1
3,155,155,16,16,0,1,0
14,186,186,12,12,0,1,0
5,188,188,21,21,0,1,0
15,206,206,38,38,0,1,0
7,227,227,4,4,0,1,0
16,227,227,8,8,0,1,0
0,237,237,1,1,0,1,0
6,311,311,55,55,0,1,0
10,313,313,13,13,0,1,0
13,326,326,16,4,12,4,3
17,328,328,34,24,10,2,1
4,352,352,31,31,0,1,0
11,367,367,26,26,0,1,0
18,370,370,124,124,0,1,0
2,392,392,32,23,9,4,3
8,393,393,69,69,0,1,0
12,416,416,57,9,48,4,3
9,499,499,99,27,72,3,2

8,102,102,6,6,0,1,0
4,116,116,26,26,0,1,0
3,126,126,4,4,0,1,0
10,170,170,69,51,18,4,3
9,243,243,24,24,0,1,0
15,256,256,39,29,10,3,2
7,270,270,27,14,13,2,1
6,308,308,26,3,23,2,1
13,352,352,12,12,0,1,0
0,385,385,31,31,0,1,0
12,408,408,9,9,0,1,0
1,411,411,40,17,23,2,1
14,422,422,25,25,0,1,0
5,461,461,75,51,24,4,3
16,464,464,34,10,24,4,3
11,479,479,55,13,42,2,1
2,481,481,107,16,91,4,3

17,100,100,32,32,0,1,0
5,130,130,6,2,4,2,1
4,143,143,15,15,0,1,0
2,154,154,15,15,0,1,0
11,155,155,5,1,4,2,1
10,177,177,3,3,0,1,0
13,184,184,14,14,0,1,0
21,226,226,48,48,0,1,0
12,243,243,95,33,62,4,3
20,280,280,6,6,0,1,0
16,291,291,6,6,0,1,0
14,329,329,2,2,0,1,0
19,336,336,2,2,0,1,0
1,339,339,9,9,0,1,0
15,380,380,12,2,10,3,2
6,397,397,6,6,0,1,0
8,409,409,1,1,0,1,0
0,409,409,12,7,5,2,1
3,411,411,44,26,18,2,1
23,424,424,46,8,38,2,1
22,434,434,50,38,12,3,2
18,440,440,6,3,3,2,1
9,465,465,1,1,0,1,0
7,477,477,8,1,7,2,1
24,488,488,95,95,0,1,0

18,101,101,11,2,9,4,3
14,148,148,25,19,6,2,1
16,156,156,27,27,0,1,0
6,167,167,33,33,0,1,0
4,185,185,9,1,8,2,1
1,225,225,16,16,0,1,0
15,270,270,25,19,6,2,1
10,315,315,32,14,18,3,2
8,343,343,46,6,40,2,1
7,355,355,2,2,0,1,0
13,358,358,30,30,0,1,0
0,374,374,21,7,14,4,3
2,401,401,32,19,13,2,1
9,412,412,1,1,0,1,0
5,413,413,28,14,14,3,2
11,430,430,24,24,0,1,0
21,442,442,63,63,0,1,0
17,450,450,74,4,70,3,2
20,455,455,39,39,0,1,0
12,465,465,58,47,11,2,1
19,491,491,4,4,0,1,0
3,497,497,28,12,16,4,3

14,130,130,16,16,0,1,0
0,197,197,59,59,0,1,0
10,216,216,26,18,8,2,1
13,241,241,47,47,0,1,0
1,242,242,1,1,0,1,0
15,253,253,1,1,0,1,0
7,255,255,21,6,15,4,3
6,263,263,34,34,0,1,0
8,286,286,22,6,16,2,1
9,286,286,58,58,0,1,0
16,338,338,22,22,0,1,0
12,366,366,77,14,63,4,3
5,379,379,57,7,50,3,2
11,430,430,9,9,0,1,0
3,457,457,50,12,38,2,1
2,472,472,90,60,30,2,1
4,494,494,18,10,8,3,2

15,140,140,32,32,0,1,0
12,181,181,23,23,0,1,0
3,194,194,13,4,9,2,1
13,215,215,6,6,0,1,0
9,216,216,63,59,4,2,1
10,228,228,15,3,12,4,3
11,240,240,38,20,18,3,2
16,253,253,29,29,0,1,0
5,263,263,20,20,0,1,0
8,265,265,15,3,12,2,1
0,305,305,46,18,28,2,1
14,313,313,39,39,0,1,0
2,335,335,15,8,7,2,1
1,375,375,1,1,0,1,0
17,382,382,16,16,0,1,0
4,395,395,67,33,34,3,2
7,434,434,30,3,27,4,3
18,454,454,60,60,0,1,0
6,491,491,37,37,0,1,0

6,125,125,1,1,0,1,0
7,141,141,8,2,6,2,1
15,158,158,21,13,8,3,2
0,166,166,28,7,21,4,3
11,213,213,17,17,0,1,0
8,236,236,7,7,0,1,0
4,256,256,28,16,12,4,3
18,258,258,50,50,0,1,0
2,270,270,20,20,0,1,0
16,285,285,8,2,6,2,1
1,289,289,26,26,0,1,0
12,299,299,60,60,0,1,0
13,329,329,27,27,0,1,0
14,368,368,61,15,46,2,1
9,399,399,19,19,0,1,0
3,443,443,76,76,0,1,0
17,458,458,21,21,0,1,0
5,470,470,116,116,0,1,0
10,485,485,44,7,37,2,1

20,166,166,4,4,0,1,0
17,185,185,20,20,0,1,0
12,190,190,21,18,3,2,1
2,195,195,21,21,0,1,0
5,215,215,11,6,5,2,1
13,216,216,19,19,0,1,0
7,237,237,36,36,0,1,0
6,263,263,54,17,37,3,2
0,320,320,27,21,6,2,1
14,364,364,10,4,6,3,2
8,371,371,35,35,0,1,0
3,382,382,8,4,4,2,1
15,382,382,17,5,12,2,1
21,405,405,19,1,18,4,3
1,427,427,5,5,0,1,0
18,428,428,79,67,12,4,3
10,447,447,43,43,0,1,0
4,448,448,24,15,9,4,3
19,449,449,107,88,19,2,1
9,466,466,6,3,3,2,1
11,487,487,1,1,0,1,0
16,497,497,128,106,22,3,2

16,100,100,16,6,10,3,2
14,111,111,41,5,36,2,1
9,131,131,9,1,8,3,2
13,137,137,7,7,0,1,0
3,159,159,3,3,0,1,0
17,184,184,8,8,0,1,0
4,186,186,48,30,18,2,1
20,200,200,40,9,31,2,1
7,221,221,19,19,0,1,0
12,224,224,5,5,0,1,0
0,253,253,40,1,39,2,1
2,268,268,48,28,20,2,1
6,294,294,16,11,5,2,1
18,326,326,6,6,0,1,0
19,329,329,17,17,0,1,0
5,360,360,14,3,11,2,1
8,379,379,11,3,8,2,1
11,402,402,12,1,11,4,3
1,420,420,7,2,5,2,1
21,462,462,26,17,9,2,1
10,473,473,19,11,8,2,1
15,491,491,31,31,0,1,0

9,109,109,2,2,0,1,0
18,111,111,9,9,0,1,0
11,180,180,5,5,0,1,0
2,187,187,5,5,0,1,0
13,216,216,8,2,6,2,1
8,242,242,14,14,0,1,0
21,252,252,42,42,0,1,0
19,264,264,12,12,0,1,0
1,287,287,21,21,0,1,0
17,289,289,25,1,24,3,2
16,289,289,45,45,0,1,0
22,305,305,41,41,0,1,0
20,368,368,63,63,0,1,0
10,371,371,74,32,42,4,3
15,372,372,5,5,0,1,0
4,387,387,102,30,72,4,3
3,391,391,29,1,28,3,2
5,393,393,12,4,8,3,2
6,420,420,13,7,6,3,2
14,473,473,76,9,67,4,3
12,475,475,34,12,22,3,2
7,490,490,33,24,9,4,3
0,494,494,11,1,10,3,2

10,117,117,6,2,4,2,1
8,155,155,8,8,0,1,0
13,165,165,2,2,0,1,0
14,188,188,45,45,0,1,0
6,215,215,24,10,14,2,1
7,239,239,66,46,20,3,2
3,244,244,3,3,0,1,0
11,253,253,11,11,0,1,0
1,256,256,75,45,30,4,3
12,281,281,22,7,15,2,1
9,289,289,137,77,60,4,3
16,378,378,9,9,0,1,0
2,382,382,56,56,0,1,0
15,399,399,16,16,0,1,0
4,424,424,42,39,3,2,1
0,449,449,1,1,0,1,0
5,465,465,29,29,0,1,0

9,141,141,8,8,0,1,0
4,156,156,15,15,0,1,0
8,168,168,22,22,0,1,0
13,169,169,3,3,0,1,0
21,175,175,12,3,9,2,1
23,198,198,20,2,18,3,2
10,209,209,1,1,0,1,0
15,215,215,5,5,0,1,0
22,221,221,11,1,10,2,1
0,262,262,3,3,0,1,0
2,284,284,3,3,0,1,0
5,288,288,11,11,0,1,0
18,313,313,31,31,0,1,0
16,332,332,5,5,0,1,0
17,344,344,22,14,8,2,1
7,347,347,33,15,18,4,3
1,348,348,39,4,35,2,1
20,354,354,11,1,10,2,1
11,381,381,24,18,6,3,2
12,395,395,7,7,0,1,0
14,410,410,86,20,66,3,2
6,419,419,50,38,12,4,3
3,422,422,7,7,0,1,0
19,466,466,262,164,98,4,3

14,107,107,4,4,0,1,0
10,114,114,6,6,0,1,0
6,134,134,25,1,24,4,3
11,142,142,23,13,10,2,1
16,166,166,33,33,0,1,0
12,201,201,40,34,6,2,1
2,261,261,35,35,0,1,0
9,277,277,27,15,12,2,1
3,279,279,10,1,9,4,3
7,279,279,36,12,24,3,2
17,286,286,30,30,0,1,0
0,339,339,16,16,0,1,0
8,343,343,60,4,56,3,2
5,374,374,43,8,35,2,1
13,377,377,30,30,0,1,0
15,393,393,34,2,32,3,2
4,423,423,26,10,16,3,2
1,442,442,52,30,22,2,1

12,107,107,25,11,14,3,2
14,113,113,2,2,0,1,0
3,119,119,10,3,7,2,1
6,194,194,13,1,12,3,2
10,220,220,44,38,6,3,2
0,258,258,158,113,45,4,3
5,268,268,10,2,8,2,1
2,275,275,34,25,9,2,1
1,276,276,19,19,0,1,0
4,280,280,3,3,0,1,0
15,310,310,66,14,52,3,2
11,350,350,24,4,20,2,1
9,406,406,65,65,0,1,0
8,445,445,20,8,12,4,3
7,462,462,36,7,29,2,1
13,469,469,3,3,0,1,0

9,109,109,3,3,0,1,0
5,121,121,16,16,0,1,0
1,170,170,2,2,0,1,0
20,183,183,18,18,0,1,0
10,189,189,22,3,19,2,1
22,201,201,13,7,6,3,2
15,212,212,17,17,0,1,0
17,218,218,20,20,0,1,0
21,241,241,28,16,12,2,1
16,251,251,56,56,0,1,0
8,252,252,7,3,4,2,1
12,274,274,5,5,0,1,0
7,295,295,17,17,0,1,0
6,339,339,52,52,0,1,0
4,340,340,33,33,0,1,0
0,357,357,6,6,0,1,0
11,362,362,46,46,0,1,0
13,373,373,72,72,0,1,0
14,380,380,35,35,0,1,0
18,429,429,43,15,28,3,2
3,444,444,1,1,0,1,0
2,460,460,9,9,0,1,0
19,495,495,73,73,0,1,0

6,109,109,19,6,13,2,1
5,115,115,22,22,0,1,0
9,143,143,5,5,0,1,0
2,169,169,50,50,0,1,0
4,171,171,4,4,0,1,0
7,184,184,6,2,4,2,1
13,240,240,16,10,6,2,1
3,242,242,7,7,0,1,0
10,244,244,30,4,26,2,1
8,328,328,62,62,0,1,0
14,331,331,56,56,0,1,0
0,342,342,23,1,22,3,2
12,475,475,30,21,9,4,3
1,487,487,194,66,128,4,3
11,492,492,79,79,0,1,0

0,123,123,10,10,0,1,0
19,129,129,21,6,15,4,3
7,157,157,20,2,18,3,2
13,183,183,4,1,3,2,1
10,188,188,1,1,0,1,0
20,192,192,5,5,0,1,0
5,197,197,23,23,0,1,0
2,200,200,2,2,0,1,0
8,207,207,1,1,0,1,0
4,227,227,2,2,0,1,0
17,239,239,11,11,0,1,0
21,241,241,69,69,0,1,0
11,309,309,29,29,0,1,0
16,325,325,23,23,0,1,0
15,327,327,22,22,0,1,0
12,329,329,82,82,0,1,0
14,341,341,102,8,94,3,2
9,381,381,40,40,0,1,0
6,383,383,1,1,0,1,0
22,409,409,17,1,16,3,2
1,417,417,64,16,48,2,1
18,426,426,9,3,6,2,1
3,451,451,11,11,0,1,0

15,107,107,2,2,0,1,0
3,145,145,8,4,4,2,1
7,150,150,19,1,18,3,2
13,183,183,58,24,34,2,1
6,187,187,2,2,0,1,0
11,197,197,30,30,0,1,0
17,221,221,13,1,12,4,3
18,227,227,4,4,0,1,0
14,227,227,9,1,8,3,2
10,234,234,15,3,12,3,2
5,271,271,26,26,0,1,0
16,289,289,42,42,0,1,0
19,328,328,21,21,0,1,0
0,347,347,38,12,26,3,2
12,396,396,81,61,20,2,1
9,423,423,85,1,84,4,3
8,428,428,65,41,24,2,1
1,460,460,36,27,9,2,1
2,463,463,13,13,0,1,0
4,478,478,38,12,26,3,2

11,102,102,9,1,8,2,1
17,120,120,19,15,4,2,1
2,140,140,1,1,0,1,0
0,149,149,43,43,0,1,0
6,158,158,20,20,0,1,0
8,177,177,2,2,0,1,0
19,180,180,9,9,0,1,0
15,198,198,6,6,0,1,0
18,200,200,37,16,21,2,1
13,210,210,3,3,0,1,0
20,210,210,35,35,0,1,0
22,249,249,6,3,3,2,1
21,259,259,37,24,13,4,3
9,270,270,20,20,0,1,0
3,297,297,46,46,0,1,0
14,310,310,24,21,3,2,1
7,344,344,16,16,0,1,0
23,345,345,1,1,0,1,0
10,401,401,4,4,0,1,0
12,436,436,31,10,21,4,3
5,448,448,1,1,0,1,0
1,456,456,9,9,0,1,0
4,485,485,4,4,0,1,0
16,491,491,129,117,12,3,2

4,101,101,8,8,0,1,0
2,104,104,13,4,9,4,3
14,104,104,32,32,0,1,0
13,113,113,12,12,0,1,0
8,119,119,47,47,0,1,0
16,184,184,11,11,0,1,0
9,233,233,20,20,0,1,0
3,237,237,2,2,0,1,0
7,262,262,23,23,0,1,0
15,265,265,48,48,0,1,0
0,273,273,21,21,0,1,0
1,279,279,36,36,0,1,0
12,286,286,44,44,0,1,0
6,336,336,22,22,0,1,0
5,356,356,13,4,9,2,1
17,356,356,22,19,3,2,1
11,359,359,15,15,0,1,0
10,403,403,8,8,0,1,0

3,144,144,12,12,0,1,0
5,148,148,4,1,3,2,1
9,153,153,1,1,0,1,0
11,162,162,18,12,6,3,2
19,172,172,3,3,0,1,0
7,241,241,63,63,0,1,0
8,280,280,10,10,0,1,0
14,296,296,42,26,16,2,1
0,312,312,27,27,0,1,0
15,340,340,97,22,75,4,3
10,345,345,74,32,42,3,2
13,394,394,47,9,38,2,1
18,405,405,74,74,0,1,0
2,407,407,51,51,0,1,0
16,413,413,39,9,30,4,3
6,423,423,22,2,20,3,2
4,443,443,33,11,22,3,2
12,470,470,22,17,5,2,1
1,480,480,17,17,0,1,0
17,488,488,9,9,0,1,0

3,121,121,4,4,0,1,0
5,140,140,1,1,0,1,0
2,149,149,2,2,0,1,0
0,170,170,73,43,30,2,1
12,269,269,52,29,23,2,1
1,287,287,1,1,0,1,0
7,315,315,36,36,0,1,0
14,332,332,9,1,8,2,1
9,361,361,69,69,0,1,0
13,380,380,16,16,0,1,0
4,386,386,92,2,90,4,3
6,413,413,67,34,33,4,3
8,414,414,22,22,0,1,0
15,453,453,151,86,65,4,3
11,464,464,6,6,0,1,0
16,476,476,29,7,22,2,1
10,477,477,46,20,26,3,2

9,128,128,7,7,0,1,0
3,184,184,31,15,16,2,1
12,189,189,43,43,0,1,0
1,196,196,23,8,15,2,1
18,204,204,2,2,0,1,0
2,219,219,2,2,0,1,0
6,240,240,79,79,0,1,0
19,248,248,4,4,0,1,0
7,257,257,30,30,0,1,0
15,275,275,52,52,0,1,0
4,324,324,1,1,0,1,0
13,329,329,40,16,24,3,2
8,360,360,16,13,3,2,1
0,373,373,23,23,0,1,0
11,376,376,53,53,0,1,0
14,386,386,30,30,0,1,0
16,388,388,40,20,20,4,3
17,412,412,52,52,0,1,0
10,421,421,12,5,7,2,1
5,454,454,31,19,12,3,2

5,108,108,17,5,12,2,1
14,127,127,2,2,0,1,0
16,136,136,23,3,20,2,1
10,138,138,14,9,5,2,1
11,208,208,31,28,3,2,1
6,256,256,26,26,0,1,0
13,279,279,53,26,27,4,3
8,336,336,41,41,0,1,0
2,350,350,3,3,0,1,0
12,371,371,16,3,13,2,1
7,379,379,25,13,12,4,3
1,387,387,33,17,16,3,2
9,405,405,115,90,25,4,3
4,407,407,32,29,3,2,1
17,431,431,9,6,3,2,1
3,477,477,144,144,0,1,0
15,487,487,22,17,5,2,1
0,496,496,40,6,34,2,1

1,107,107,43,28,15,4,3
3,124,124,17,17,0,1,0
11,167,167,2,2,0,1,0
0,172,172,7,7,0,1,0
5,177,177,7,3,4,2,1
6,188,188,7,7,0,1,0
16,198,198,20,11,9,2,1
8,294,294,18,18,0,1,0
10,305,305,10,10,0,1,0
19,329,329,43,9,34,3,2
9,343,343,64,14,50,3,2
17,350,350,33,33,0,1,0
4,389,389,7,7,0,1,0
2,398,398,1,1,0,1,0
7,415,415,18,18,0,1,0
18,420,420,32,16,16,2,1
15,427,427,235,199,36,4,3
12,455,455,4,4,0,1,0
14,464,464,7,7,0,1,0
13,472,472,11,6,5,2,1

9,180,180,15,15,0,1,0
4,185,185,19,19,0,1,0
13,192,192,17,17,0,1,0
20,222,222,67,19,48,4,3
2,234,234,13,3,10,3,2
1,270,270,30,30,0,1,0
10,274,274,1,1,0,1,0
8,298,298,5,5,0,1,0
18,310,310,31,19,12,2,1
12,314,314,12,9,3,2,1
3,334,334,46,26,20,2,1
6,336,336,24,2,22,2,1
0,365,365,1,1,0,1,0
11,379,379,59,39,20,2,1
7,382,382,67,35,32,2,1
17,401,401,22,22,0,1,0
16,413,413,62,62,0,1,0
21,433,433,19,19,0,1,0
14,443,443,14,5,9,3,2
5,461,461,22,22,0,1,0
19,478,478,67,67,0,1,0
15,494,494,49,49,0,1,0

18,111,111,9,3,6,3,2
16,117,117,16,8,8,3,2
15,142,142,21,21,0,1,0
14,150,150,14,14,0,1,0
12,167,167,15,5,10,3,2
4,201,201,1,1,0,1,0
1,206,206,40,19,21,4,3
20,213,213,10,3,7,2,1
8,216,216,27,3,24,4,3
2,221,221,60,60,0,1,0
19,287,287,17,17,0,1,0
0,350,350,36,5,31,2,1
7,362,362,37,37,0,1,0
3,374,374,4,1,3,2,1
11,376,376,6,6,0,1,0
6,421,421,10,10,0,1,0
5,441,441,6,6,0,1,0
9,458,458,48,4,44,2,1
10,460,460,15,11,4,2,1
17,478,478,60,28,32,3,2
13,490,490,117,55,62,4,3

3,100,100,4,4,0,1,0
18,141,141,11,11,0,1,0
17,144,144,26,26,0,1,0
14,152,152,22,2,20,3,2
13,160,160,6,6,0,1,0
1,182,182,21,21,0,1,0
8,215,215,8,5,3,2,1
12,218,218,70,70,0,1,0
2,218,218,16,16,0,1,0
15,230,230,3,3,0,1,0
4,251,251,111,84,27,2,1
10,255,255,14,6,8,2,1
6,289,289,7,7,0,1,0
0,321,321,9,2,7,2,1
16,327,327,37,1,36,4,3
9,346,346,46,46,0,1,0
11,392,392,28,28,0,1,0
7,409,409,24,24,0,1,0
5,475,475,24,3,21,4,3

7,161,161,22,22,0,1,0
10,161,161,19,19,0,1,0
16,171,171,3,3,0,1,0
14,177,177,10,5,5,2,1
8,189,189,6,2,4,2,1
13,213,213,4,4,0,1,0
1,223,223,11,5,6,3,2
11,262,262,90,30,60,3,2
0,349,349,70,42,28,2,1
4,364,364,12,12,0,1,0
5,382,382,98,44,54,3,2
6,429,429,7,7,0,1,0
12,433,433,61,43,18,4,3
2,449,449,105,66,39,2,1
3,457,457,34,34,0,1,0
15,463,463,38,23,15,4,3
9,498,498,103,31,72,4,3

23,127,127,4,4,0,1,0
16,146,146,18,18,0,1,0
12,157,157,6,6,0,1,0
19,170,170,4,4,0,1,0
17,209,209,6,6,0,1,0
7,234,234,5,5,0,1,0
13,234,234,26,26,0,1,0
6,242,242,16,16,0,1,0
14,265,265,7,7,0,1,0
5,267,267,11,11,0,1,0
10,284,284,2,2,0,1,0
22,315,315,127,127,0,1,0
1,327,327,26,26,0,1,0
4,328,328,19,19,0,1,0
3,346,346,4,4,0,1,0
15,346,346,83,64,19,3,2
20,362,362,3,3,0,1,0
2,363,363,7,2,5,2,1
21,389,389,27,14,13,2,1
9,434,434,24,12,12,2,1
18,443,443,110,110,0,1,0
24,452,452,38,38,0,1,0
0,470,470,64,56,8,3,2
8,492,492,34,34,0,1,0
11,495,495,11,11,0,1,0

10,114,114,23,19,4,2,1
4,132,132,26,6,20,4,3
18,166,166,4,4,0,1,0
12,176,176,41,14,27,4,3
1,184,184,1,1,0,1,0
2,216,216,2,2,0,1,0
9,224,224,4,4,0,1,0
7,234,234,47,47,0,1,0
17,279,279,13,6,7,2,1
0,292,292,27,27,0,1,0
3,342,342,11,3,8,2,1
13,344,344,112,63,49,2,1
14,380,380,6,3,3,2,1
19,419,419,33,3,30,4,3
8,422,422,59,56,3,2,1
11,438,438,9,9,0,1,0
16,464,464,27,9,18,2,1
6,482,482,4,4,0,1,0
5,487,487,50,50,0,1,0
15,492,492,105,105,0,1,0

12,141,141,1,1,0,1,0
11,183,183,3,3,0,1,0
9,186,186,11,11,0,1,0
15,200,200,21,4,17,2,1
16,225,225,40,40,0,1,0
5,237,237,53,53,0,1,0
13,259,259,10,10,0,1,0
1,267,267,1,1,0,1,0
0,361,361,24,24,0,1,0
3,361,361,33,33,0,1,0
6,375,375,36,36,0,1,0
14,381,381,41,19,22,2,1
2,387,387,64,8,56,3,2
17,405,405,98,98,0,1,0
7,419,419,9,3,6,2,1
4,441,441,63,26,37,2,1
10,447,447,121,101,20,2,1
8,480,480,91,84,7,2,1

1,108,108,2,2,0,1,0
13,127,127,3,3,0,1,0
14,127,127,8,8,0,1,0
6,132,132,6,6,0,1,0
4,162,162,3,3,0,1,0
12,167,167,6,2,4,2,1
7,168,168,33,24,9,4,3
18,184,184,14,14,0,1,0
17,185,185,2,2,0,1,0
3,198,198,5,5,0,1,0
24,232,232,16,3,13,2,1
15,255,255,12,12,0,1,0
0,266,266,12,12,0,1,0
8,288,288,1,1,0,1,0
11,291,291,17,17,0,1,0
21,310,310,3,3,0,1,0
2,324,324,76,22,54,3,2
23,332,332,9,9,0,1,0
9,397,397,1,1,0,1,0
5,408,408,51,51,0,1,0
10,414,414,24,4,20,3,2
20,450,450,93,93,0,1,0
19,462,462,74,29,45,4,3
16,470,470,173,173,0,1,0
22,470,470,42,1,41,4,3

8,110,110,11,11,0,1,0
7,113,113,14,2,12,4,3
6,115,115,16,4,12,4,3
16,147,147,4,4,0,1,0
17,151,151,39,39,0,1,0
1,197,197,9,1,8,2,1
11,210,210,22,22,0,1,0
15,234,234,11,3,8,3,2
5,259,259,40,10,30,4,3
10,277,277,117,117,0,1,0
4,285,285,47,36,11,2,1
0,295,295,63,63,0,1,0
2,298,298,11,11,0,1,0
12,305,305,8,8,0,1,0
3,311,311,9,9,0,1,0
13,405,405,6,6,0,1,0
9,407,407,8,8,0,1,0
14,431,431,43,15,28,4,3

9,121,121,11,11,0,1,0
20,124,124,8,8,0,1,0
11,129,129,18,2,16,4,3
6,130,130,9,4,5,2,1
7,179,179,1,1,0,1,0
14,199,199,73,41,32,2,1
1,240,240,16,16,0,1,0
18,299,299,16,7,9,2,1
4,301,301,26,26,0,1,0
8,303,303,65,25,40,3,2
12,314,314,76,4,72,4,3
15,327,327,24,2,22,2,1
5,341,341,4,4,0,1,0
10,359,359,30,30,0,1,0
0,380,380,62,48,14,2,1
13,391,391,4,1,3,2,1
16,409,409,9,9,0,1,0
3,414,414,20,20,0,1,0
17,439,439,31,31,0,1,0
19,470,470,53,32,21,4,3
2,495,495,11,11,0,1,0

10,110,110,1,1,0,1,0
5,129,129,10,1,9,2,1
8,130,130,20,12,8,2,1
7,135,135,6,3,3,2,1
12,141,141,39,39,0,1,0
1,147,147,1,1,0,1,0
2,164,164,70,56,14,4,3
15,196,196,16,8,8,2,1
14,303,303,10,10,0,1,0
6,328,328,23,11,12,4,3
11,380,380,14,14,0,1,0
0,381,381,33,33,0,1,0
4,415,415,43,13,30,3,2
13,439,439,32,32,0,1,0
3,453,453,104,14,90,3,2
9,492,492,153,93,60,3,2

15,178,178,56,51,5,2,1
3,198,198,1,1,0,1,0
17,199,199,18,18,0,1,0
11,200,200,4,4,0,1,0
1,206,206,69,20,49,2,1
5,208,208,2,2,0,1,0
13,215,215,34,13,21,4,3
12,221,221,12,12,0,1,0
4,238,238,2,2,0,1,0
8,266,266,14,14,0,1,0
9,290,290,1,1,0,1,0
7,292,292,61,15,46,2,1
16,295,295,45,45,0,1,0
0,407,407,37,5,32,2,1
6,426,426,68,48,20,2,1
10,430,430,51,7,44,3,2
14,468,468,52,52,0,1,0
2,479,479,64,27,37,2,1

4,117,117,5,5,0,1,0
10,168,168,5,5,0,1,0
1,223,223,23,23,0,1,0
14,226,226,23,2,21,2,1
17,249,249,3,3,0,1,0
8,251,251,66,66,0,1,0
12,264,264,29,29,0,1,0
9,347,347,3,3,0,1,0
3,351,351,6,2,4,2,1
15,371,371,183,183,0,1,0
7,386,386,10,1,9,3,2
11,396,396,13,1,12,2,1
18,432,432,3,3,0,1,0
13,444,444,80,23,57,4,3
16,446,446,23,13,10,3,2
5,446,446,111,111,0,1,0
6,447,447,24,2,22,3,2
0,460,460,106,106,0,1,0
2,487,487,4,4,0,1,0

4,105,105,7,4,3,2,1
7,123,123,9,9,0,1,0
10,133,133,8,3,5,2,1
12,140,140,13,13,0,1,0
13,185,185,34,34,0,1,0
0,212,212,25,13,12,3,2
5,306,306,55,55,0,1,0
9,307,307,70,70,0,1,0
2,318,318,168,168,0,1,0
8,338,338,17,17,0,1,0
11,348,348,53,11,42,3,2
6,375,375,63,45,18,4,3
14,383,383,4,4,0,1,0
3,440,440,11,11,0,1,0
1,465,465,39,22,17,2,1

2,100,100,12,12,0,1,0
9,169,169,10,6,4,2,1
8,185,185,9,9,0,1,0
20,235,235,8,4,4,2,1
0,249,249,67,49,18,2,1
18,249,249,22,22,0,1,0
7,270,270,10,10,0,1,0
14,288,288,7,7,0,1,0
17,302,302,21,4,17,2,1
15,326,326,14,2,12,4,3
23,329,329,24,8,16,2,1
13,338,338,1,1,0,1,0
5,373,373,5,5,0,1,0
16,381,381,55,46,9,4,3
19,381,381,60,15,45,2,1
1,384,384,29,29,0,1,0
11,403,403,45,45,0,1,0
12,429,429,36,36,0,1,0
22,429,429,2,2,0,1,0
10,433,433,34,34,0,1,0
3,468,468,1,1,0,1,0
21,469,469,187,95,92,3,2
4,489,489,16,7,9,4,3
6,498,498,21,21,0,1,0

7,175,175,4,4,0,1,0
1,188,188,12,5,7,2,1
10,189,189,9,9,0,1,0
0,230,230,17,11,6,2,1
2,297,297,150,137,13,2,1
4,299,299,6,6,0,1,0
9,338,338,14,4,10,3,2
8,372,372,28,28,0,1,0
5,397,397,232,232,0,1,0
11,433,433,66,58,8,3,2
12,439,439,1,1,0,1,0
3,479,479,172,100,72,4,3
6,487,487,32,22,10,3,2

12,102,102,6,6,0,1,0
18,128,128,10,2,8,3,2
23,134,134,8,8,0,1,0
11,142,142,27,2,25,2,1
16,150,150,10,2,8,2,1
0,185,185,4,4,0,1,0
15,235,235,22,22,0,1,0
24,241,241,16,16,0,1,0
7,282,282,4,1,3,2,1
21,287,287,36,36,0,1,0
2,314,314,3,3,0,1,0
8,323,323,10,10,0,1,0
4,335,335,31,4,27,4,3
6,345,345,3,3,0,1,0
1,360,360,3,3,0,1,0
19,374,374,14,14,0,1,0
5,388,388,1,1,0,1,0
13,393,393,39,39,0,1,0
22,403,403,51,26,25,2,1
3,404,404,58,29,29,2,1
14,428,428,10,10,0,1,0
9,463,463,92,83,9,2,1
17,473,473,125,82,43,2,1
20,481,481,89,17,72,4,3
10,489,489,4,4,0,1,0

1,111,111,7,7,0,1,0
10,132,132,12,3,9,2,1
4,175,175,4,4,0,1,0
8,195,195,2,2,0,1,0
12,207,207,12,12,0,1,0
5,211,211,17,7,10,3,2
7,212,212,33,33,0,1,0
14,226,226,57,57,0,1,0
15,283,283,16,9,7,2,1
3,293,293,71,21,50,2,1
18,314,314,82,43,39,4,3
13,351,351,2,2,0,1,0
6,388,388,96,96,0,1,0
11,396,396,69,69,0,1,0
9,430,430,36,28,8,3,2
16,436,436,7,4,3,2,1
19,447,447,37,17,20,3,2
17,451,451,47,8,39,2,1
2,475,475,1,1,0,1,0
0,483,483,3,3,0,1,0

0,105,105,8,8,0,1,0
10,181,181,8,2,6,2,1
6,209,209,78,78,0,1,0
5,233,233,73,20,53,4,3
9,264,264,28,1,27,4,3
14,269,269,10,6,4,2,1
12,290,290,6,6,0,1,0
8,291,291,28,28,0,1,0
7,318,318,111,111,0,1,0
15,333,333,93,81,12,3,2
3,335,335,12,5,7,2,1
4,386,386,6,6,0,1,0
13,402,402,26,2,24,4,3
1,419,419,75,75,0,1,0
2,452,452,5,5,0,1,0
11,495,495,7,1,6,3,2

8,113,113,5,5,0,1,0
4,118,118,15,15,0,1,0
2,137,137,7,7,0,1,0
23,145,145,3,3,0,1,0
13,149,149,3,3,0,1,0
21,151,151,15,15,0,1,0
0,158,158,2,2,0,1,0
14,191,191,3,3,0,1,0
16,204,204,26,26,0,1,0
20,212,212,17,17,0,1,0
19,220,220,12,12,0,1,0
12,222,222,3,3,0,1,0
11,268,268,22,22,0,1,0
15,287,287,14,14,0,1,0
25,338,338,59,5,54,3,2
10,343,343,12,12,0,1,0
7,353,353,10,1,9,4,3
22,360,360,77,8,69,3,2
6,367,367,41,26,15,4,3
18,390,390,29,15,14,2,1
9,391,391,74,74,0,1,0
17,406,406,120,120,0,1,0
5,476,476,9,9,0,1,0
24,478,478,2,2,0,1,0
3,479,479,29,29,0,1,0
1,496,496,8,8,0,1,0

12,108,108,1,1,0,1,0
1,111,111,1,1,0,1,0
0,124,124,5,5,0,1,0
10,125,125,5,5,0,1,0
9,143,143,1,1,0,1,0
14,152,152,54,54,0,1,0
5,158,158,14,14,0,1,0
4,203,203,23,20,3,2,1
13,258,258,4,4,0,1,0
11,294,294,59,59,0,1,0
17,359,359,25,25,0,1,0
6,369,369,144,122,22,3,2
3,373,373,41,41,0,1,0
2,390,390,17,13,4,2,1
16,411,411,90,5,85,3,2
15,429,429,48,16,32,2,1
7,441,441,1,1,0,1,0
8,496,496,101,101,0,1,0

14,114,114,2,2,0,1,0
2,123,123,4,4,0,1,0
21,126,126,1,1,0,1,0
6,136,136,15,15,0,1,0
8,190,190,30,30,0,1,0
11,223,223,15,4,11,4,3
10,230,230,1,1,0,1,0
17,232,232,17,14,3,2,1
16,238,238,102,65,37,2,1
7,244,244,1,1,0,1,0
0,248,248,29,29,0,1,0
4,258,258,25,25,0,1,0
1,268,268,4,4,0,1,0
13,268,268,40,8,32,2,1
9,297,297,21,9,12,3,2
23,316,316,50,50,0,1,0
12,320,320,19,19,0,1,0
5,320,320,6,6,0,1,0
3,352,352,28,13,15,4,3
18,357,357,35,35,0,1,0
15,359,359,28,5,23,2,1
22,373,373,17,17,0,1,0
20,440,440,48,48,0,1,0
19,459,459,9,1,8,2,1

15,104,104,17,17,0,1,0
7,153,153,16,16,0,1,0
13,161,161,14,3,11,2,1
3,190,190,19,1,18,4,3
17,192,192,1,1,0,1,0
0,206,206,24,24,0,1,0
2,223,223,6,6,0,1,0
11,239,239,38,38,0,1,0
4,256,256,21,7,14,2,1
6,274,274,9,9,0,1,0
10,301,301,85,27,58,3,2
8,428,428,92,65,27,4,3
5,430,430,38,27,11,2,1
9,430,430,32,32,0,1,0
12,430,430,20,20,0,1,0
1,463,463,109,82,27,2,1
14,467,467,45,45,0,1,0
16,477,477,48,2,46,4,3

7,124,124,12,3,9,4,3
13,153,153,15,15,0,1,0
14,173,173,15,1,14,3,2
17,187,187,4,4,0,1,0
16,197,197,47,21,26,2,1
4,221,221,45,45,0,1,0
2,227,227,33,15,18,2,1
11,309,309,24,24,0,1,0
0,322,322,29,29,0,1,0
18,324,324,43,11,32,2,1
1,325,325,19,13,6,3,2
9,334,334,81,26,55,3,2
3,335,335,5,5,0,1,0
8,338,338,3,3,0,1,0
5,372,372,24,7,17,4,3
6,382,382,29,29,0,1,0
12,408,408,8,4,4,2,1
10,423,423,5,5,0,1,0
15,441,441,146,146,0,1,0

4,103,103,2,2,0,1,0
12,128,128,16,16,0,1,0
2,145,145,5,2,3,2,1
6,150,150,16,16,0,1,0
8,189,189,5,1,4,2,1
1,189,189,95,95,0,1,0
0,228,228,17,17,0,1,0
3,236,236,17,10,7,2,1
7,247,247,47,8,39,2,1
5,334,334,1,1,0,1,0
16,342,342,52,52,0,1,0
9,367,367,51,19,32,2,1
14,376,376,81,70,11,2,1
15,414,414,14,4,10,3,2
10,420,420,96,57,39,4,3
13,450,450,12,8,4,2,1
11,495,495,37,25,12,4,3

16,122,122,10,3,7,2,1
6,123,123,44,2,42,4,3
0,142,142,20,20,0,1,0
17,146,146,26,26,0,1,0
3,173,173,1,1,0,1,0
13,195,195,7,7,0,1,0
1,197,197,4,4,0,1,0
2,229,229,5,5,0,1,0
12,233,233,2,2,0,1,0
11,251,251,24,6,18,2,1
10,269,269,86,40,46,3,2
18,296,296,22,22,0,1,0
8,306,306,37,32,5,2,1
14,313,313,14,14,0,1,0
7,320,320,57,57,0,1,0
15,324,324,58,58,0,1,0
9,417,417,20,20,0,1,0
5,421,421,36,36,0,1,0
4,446,446,10,10,0,1,0

3,128,128,6,6,0,1,0
16,149,149,7,7,0,1,0
15,175,175,26,26,0,1,0
7,188,188,17,17,0,1,0
13,273,273,19,8,11,2,1
14,274,274,22,16,6,3,2
5,274,274,112,112,0,1,0
10,309,309,64,22,42,3,2
4,313,313,39,39,0,1,0
1,336,336,19,3,16,3,2
9,430,430,68,2,66,4,3
2,435,435,92,79,13,2,1
6,446,446,13,13,0,1,0
12,458,458,22,17,5,2,1
11,460,460,72,51,21,2,1
8,490,490,50,50,0,1,0
0,493,493,16,16,0,1,0

16,101,101,12,2,10,2,1
14,107,107,2,2,0,1,0
13,123,123,7,7,0,1,0
15,135,135,9,9,0,1,0
3,160,160,15,3,12,3,2
0,161,161,7,7,0,1,0
18,178,178,70,50,20,3,2
4,186,186,2,2,0,1,0
8,214,214,14,14,0,1,0
6,240,240,36,36,0,1,0
2,279,279,18,6,12,4,3
12,287,287,9,9,0,1,0
11,337,337,12,5,7,2,1
1,341,341,71,4,67,3,2
20,394,394,36,12,24,2,1
19,399,399,64,64,0,1,0
9,401,401,17,17,0,1,0
7,412,412,39,3,36,4,3
10,421,421,57,57,0,1,0
5,487,487,28,14,14,2,1
17,490,490,42,42,0,1,0

2,109,109,1,1,0,1,0
5,128,128,5,5,0,1,0
4,201,201,6,6,0,1,0
7,203,203,125,89,36,3,2
13,213,213,43,37,6,3,2
10,270,270,98,16,82,3,2
11,297,297,1,1,0,1,0
12,327,327,18,15,3,2,1
15,367,367,25,22,3,2,1
6,387,387,23,23,0,1,0
0,394,394,11,11,0,1,0
8,408,408,28,28,0,1,0
14,422,422,79,51,28,2,1
16,427,427,16,16,0,1,0
1,448,448,12,12,0,1,0
17,462,462,37,11,26,4,3
3,473,473,59,59,0,1,0
9,500,500,8,8,0,1,0

0,141,141,2,2,0,1,0
9,142,142,47,5,42,3,2
5,166,166,22,22,0,1,0
11,167,167,21,21,0,1,0
1,175,175,44,1,43,2,1
13,212,212,11,11,0,1,0
3,231,231,7,7,0,1,0
2,241,241,35,26,9,3,2
16,254,254,3,3,0,1,0
15,258,258,23,23,0,1,0
14,290,290,22,1,21,2,1
8,350,350,75,75,0,1,0
10,376,376,10,1,9,2,1
4,403,403,15,15,0,1,0
7,473,473,167,120,47,4,3
12,474,474,45,17,28,2,1
6,480,480,18,18,0,1,0

6,116,116,11,3,8,2,1
8,126,126,7,7,0,1,0
15,126,126,5,2,3,2,1
7,160,160,1,1,0,1,0
14,160,160,1,1,0,1,0
2,165,165,57,57,0,1,0
1,189,189,5,5,0,1,0
12,195,195,1,1,0,1,0
4,235,235,3,3,0,1,0
13,240,240,59,59,0,1,0
17,262,262,14,8,6,3,2
5,321,321,40,2,38,2,1
0,360,360,110,47,63,4,3
11,417,417,24,24,0,1,0
10,426,426,123,85,38,2,1
9,449,449,26,15,11,2,1
16,462,462,122,83,39,3,2
3,473,473,14,14,0,1,0

5,107,107,25,3,22,3,2
7,109,109,5,5,0,1,0
12,119,119,4,1,3,2,1
9,183,183,3,3,0,1,0
6,209,209,6,6,0,1,0
17,253,253,4,4,0,1,0
3,305,305,72,58,14,2,1
10,326,326,9,9,0,1,0
4,336,336,14,2,12,4,3
15,351,351,18,18,0,1,0
11,358,358,103,103,0,1,0
1,361,361,44,10,34,2,1
0,380,380,9,9,0,1,0
14,387,387,32,11,21,2,1
13,402,402,138,88,50,3,2
16,447,447,71,71,0,1,0
2,453,453,57,57,0,1,0
8,495,495,71,39,32,3,2

19,104,104,4,4,0,1,0
21,113,113,22,22,0,1,0
1,117,117,3,3,0,1,0
0,133,133,6,6,0,1,0
13,141,141,6,6,0,1,0
23,148,148,2,2,0,1,0
3,151,151,1,1,0,1,0
14,166,166,4,1,3,2,1
10,170,170,11,11,0,1,0
11,171,171,9,6,3,2,1
24,171,171,22,22,0,1,0
8,193,193,27,27,0,1,0
2,255,255,42,42,0,1,0
16,333,333,18,9,9,4,3
7,334,334,23,20,3,2,1
15,360,360,10,3,7,2,1
22,378,378,188,89,99,4,3
20,387,387,6,6,0,1,0
18,403,403,38,38,0,1,0
25,417,417,15,9,6,2,1
12,448,448,1,1,0,1,0
17,462,462,3,3,0,1,0
5,463,463,48,17,31,2,1
9,469,469,74,32,42,2,1
6,483,483,3,3,0,1,0
4,486,486,7,7,0,1,0

18,119,119,52,10,42,3,2
2,158,158,11,11,0,1,0
7,160,160,24,6,18,2,1
16,191,191,8,2,6,2,1
17,206,206,18,8,10,3,2
13,211,211,30,23,7,2,1
9,240,240,36,36,0,1,0
0,244,244,9,1,8,3,2
15,289,289,15,15,0,1,0
6,311,311,46,46,0,1,0
1,342,342,32,26,6,3,2
11,354,354,20,20,0,1,0
10,378,378,34,34,0,1,0
5,420,420,29,29,0,1,0
8,421,421,16,16,0,1,0
3,432,432,20,20,0,1,0
4,433,433,87,87,0,1,0
14,485,485,7,7,0,1,0
12,488,488,45,27,18,4,3

11,102,102,49,49,0,1,0
0,114,114,32,23,9,4,3
12,123,123,6,3,3,2,1
17,128,128,6,1,5,2,1
7,163,163,3,3,0,1,0
2,164,164,6,6,0,1,0
8,170,170,69,69,0,1,0
13,194,194,11,11,0,1,0
14,217,217,8,4,4,2,1
10,283,283,11,1,10,2,1
9,284,284,24,24,0,1,0
6,314,314,1,1,0,1,0
3,322,322,5,5,0,1,0
1,332,332,4,4,0,1,0
4,383,383,20,20,0,1,0
18,387,387,78,62,16,3,2
16,392,392,43,43,0,1,0
5,483,483,44,44,0,1,0
15,494,494,2,2,0,1,0

8,122,122,59,39,20,3,2
16,125,125,27,2,25,2,1
12,132,132,8,1,7,2,1
3,138,138,1,1,0,1,0
18,147,147,27,1,26,2,1
17,227,227,15,15,0,1,0
1,229,229,21,21,0,1,0
0,282,282,14,9,5,2,1
9,292,292,30,30,0,1,0
10,354,354,85,85,0,1,0
14,354,354,23,23,0,1,0
11,356,356,6,6,0,1,0
5,396,396,55,19,36,4,3
7,397,397,1,1,0,1,0
6,402,402,9,9,0,1,0
13,426,426,25,25,0,1,0
15,426,426,44,44,0,1,0
2,454,454,35,35,0,1,0
4,498,498,13,3,10,2,1

21,111,111,8,8,0,1,0
20,143,143,33,7,26,2,1
23,185,185,30,30,0,1,0
1,190,190,1,1,0,1,0
5,194,194,2,2,0,1,0
9,200,200,10,10,0,1,0
14,211,211,15,15,0,1,0
10,211,211,3,3,0,1,0
12,238,238,22,22,0,1,0
25,251,251,19,7,12,3,2
6,253,253,7,7,0,1,0
11,274,274,2,2,0,1,0
0,299,299,45,27,18,4,3
18,328,328,15,15,0,1,0
13,347,347,8,2,6,3,2
4,352,352,8,2,6,3,2
2,353,353,14,14,0,1,0
16,362,362,86,23,63,4,3
24,405,405,27,27,0,1,0
19,422,422,13,3,10,2,1
8,427,427,3,3,0,1,0
15,443,443,29,16,13,2,1
22,445,445,110,110,0,1,0
7,459,459,54,54,0,1,0
3,461,461,28,28,0,1,0
17,479,479,43,19,24,3,2

16,124,124,8,8,0,1,0
17,173,173,25,25,0,1,0
0,204,204,1,1,0,1,0
4,213,213,6,6,0,1,0
19,256,256,24,24,0,1,0
6,293,293,15,5,10,2,1
13,311,311,50,50,0,1,0
1,322,322,2,2,0,1,0
18,328,328,24,14,10,3,2
3,330,330,40,40,0,1,0
9,360,360,80,80,0,1,0
5,362,362,31,13,18,4,3
2,389,389,7,1,6,2,1
10,390,390,102,45,57,4,3
7,390,390,28,2,26,2,1
15,402,402,86,52,34,2,1
14,440,440,53,53,0,1,0
12,441,441,2,2,0,1,0
8,448,448,34,14,20,2,1
20,468,468,64,64,0,1,0
11,493,493,27,27,0,1,0

14,104,104,4,4,0,1,0
9,120,120,3,3,0,1,0
19,124,124,14,6,8,2,1
16,138,138,1,1,0,1,0
6,168,168,49,17,32,3,2
1,185,185,22,22,0,1,0
22,206,206,2,2,0,1,0
3,256,256,17,1,16,2,1
15,256,256,3,3,0,1,0
4,259,259,12,12,0,1,0
11,271,271,21,21,0,1,0
12,289,289,55,55,0,1,0
20,309,309,37,3,34,4,3
17,316,316,1,1,0,1,0
24,347,347,36,36,0,1,0
10,363,363,7,7,0,1,0
18,365,365,14,11,3,2,1
21,420,420,38,38,0,1,0
7,428,428,2,2,0,1,0
13,437,437,15,15,0,1,0
5,440,440,7,7,0,1,0
23,477,477,254,254,0,1,0
2,478,478,1,1,0,1,0
0,483,483,10,3,7,2,1
8,498,498,19,19,0,1,0

5,101,101,4,4,0,1,0
26,112,112,20,8,12,3,2
15,116,116,5,5,0,1,0
2,169,169,7,7,0,1,0
0,180,180,5,5,0,1,0
8,184,184,3,3,0,1,0
22,184,184,24,24,0,1,0
7,194,194,2,2,0,1,0
11,196,196,7,1,6,3,2
19,198,198,9,9,0,1,0
14,209,209,21,5,16,3,2
23,220,220,30,30,0,1,0
1,225,225,19,19,0,1,0
6,234,234,1,1,0,1,0
21,234,234,6,1,5,2,1
24,244,244,113,5,108,4,3
16,256,256,14,5,9,2,1
9,257,257,18,3,15,2,1
13,284,284,1,1,0,1,0
12,296,296,28,4,24,2,1
20,352,352,1,1,0,1,0
10,363,363,14,14,0,1,0
27,378,378,1,1,0,1,0
17,385,385,62,62,0,1,0
4,393,393,11,11,0,1,0
3,397,397,35,9,26,4,3
25,436,436,14,14,0,1,0
28,449,449,21,13,8,3,2
18,474,474,8,4,4,2,1

10,108,108,3,3,0,1,0
7,118,118,3,3,0,1,0
8,131,131,10,4,6,2,1
13,133,133,7,7,0,1,0
12,133,133,11,2,9,3,2
5,142,142,1,1,0,1,0
6,184,184,16,6,10,2,1
1,248,248,37,11,26,2,1
19,289,289,47,11,36,4,3
15,294,294,49,49,0,1,0
18,297,297,118,1,117,4,3
0,320,320,103,75,28,3,2
3,361,361,33,33,0,1,0
16,366,366,5,5,0,1,0
9,379,379,12,12,0,1,0
4,390,390,3,3,0,1,0
11,466,466,11,3,8,2,1
14,483,483,54,8,46,4,3
17,498,498,4,4,0,1,0
2,499,499,88,58,30,3,2

13,101,101,24,1,23,2,1
9,113,113,26,26,0,1,0
11,126,126,42,42,0,1,0
4,153,153,1,1,0,1,0
3,167,167,12,4,8,3,2
18,192,192,6,3,3,2,1
2,204,204,21,7,14,3,2
16,225,225,7,7,0,1,0
17,244,244,10,7,3,2,1
10,299,299,42,42,0,1,0
14,307,307,25,15,10,2,1
6,369,369,2,2,0,1,0
8,373,373,33,33,0,1,0
0,384,384,67,67,0,1,0
5,411,411,49,49,0,1,0
12,425,425,48,10,38,2,1
7,469,469,5,5,0,1,0
19,474,474,40,40,0,1,0
15,490,490,35,26,9,4,3
1,490,490,25,25,0,1,0

9,108,108,2,2,0,1,0
0,132,132,24,24,0,1,0
8,157,157,8,8,0,1,0
10,158,158,2,2,0,1,0
13,174,174,31,31,0,1,0
16,189,189,15,15,0,1,0
15,264,264,2,2,0,1,0
2,270,270,22,22,0,1,0
1,301,301,18,18,0,1,0
12,307,307,21,21,0,1,0
5,308,308,49,21,28,2,1
14,335,335,60,60,0,1,0
18,347,347,5,5,0,1,0
3,390,390,43,1,42,3,2
7,409,409,57,34,23,2,1
6,432,432,81,71,10,3,2
17,441,441,163,142,21,2,1
11,458,458,50,50,0,1,0
4,482,482,9,9,0,1,0

20,116,116,11,3,8,3,2
5,117,117,5,5,0,1,0
9,119,119,13,5,8,3,2
17,123,123,11,11,0,1,0
0,126,126,23,23,0,1,0
2,150,150,19,1,18,2,1
14,181,181,3,3,0,1,0
15,181,181,3,3,0,1,0
22,200,200,5,5,0,1,0
18,207,207,32,4,28,2,1
13,236,236,12,9,3,2,1
21,286,286,72,72,0,1,0
6,296,296,2,2,0,1,0
23,315,315,25,25,0,1,0
12,368,368,2,2,0,1,0
7,387,387,2,2,0,1,0
3,391,391,10,10,0,1,0
1,412,412,13,8,5,2,1
16,430,430,7,1,6,3,2
4,434,434,96,96,0,1,0
10,442,442,21,21,0,1,0
8,456,456,54,15,39,4,3
11,457,457,6,6,0,1,0
19,493,493,143,71,72,3,2

4,113,113,1,1,0,1,0
7,117,117,30,21,9,3,2
8,121,121,15,15,0,1,0
17,146,146,10,10,0,1,0
11,264,264,2,2,0,1,0
1,270,270,7,2,5,2,1
12,286,286,89,89,0,1,0
3,296,296,75,13,62,3,2
13,368,368,36,36,0,1,0
2,369,369,36,36,0,1,0
6,438,438,32,32,0,1,0
5,443,443,12,12,0,1,0
16,455,455,41,11,30,3,2
9,462,462,89,71,18,4,3
15,483,483,44,44,0,1,0
14,488,488,71,71,0,1,0
10,497,497,5,5,0,1,0
0,500,500,70,29,41,4,3

9,117,117,7,1,6,2,1
22,119,119,2,2,0,1,0
14,153,153,1,1,0,1,0
15,206,206,1,1,0,1,0
24,208,208,21,21,0,1,0
0,231,231,24,24,0,1,0
25,244,244,30,6,24,2,1
7,246,246,31,3,28,2,1
21,247,247,2,2,0,1,0
13,254,254,25,21,4,2,1
3,267,267,2,2,0,1,0
18,282,282,13,13,0,1,0
8,285,285,3,3,0,1,0
16,304,304,39,3,36,3,2
1,315,315,3,3,0,1,0
23,353,353,143,143,0,1,0
11,364,364,79,79,0,1,0
6,370,370,1,1,0,1,0
4,392,392,41,41,0,1,0
2,394,394,11,11,0,1,0
10,395,395,16,6,10,3,2
12,412,412,19,19,0,1,0
17,427,427,58,46,12,3,2
20,427,427,16,10,6,2,1
5,455,455,3,3,0,1,0
19,482,482,71,71,0,1,0

9,114,114,16,9,7,2,1
16,153,153,15,15,0,1,0
15,200,200,12,12,0,1,0
10,231,231,13,9,4,2,1
4,248,248,5,5,0,1,0
2,284,284,28,28,0,1,0
6,295,295,1,1,0,1,0
11,313,313,61,46,15,4,3
0,325,325,47,9,38,3,2
1,335,335,26,12,14,2,1
13,349,349,37,37,0,1,0
14,381,381,39,3,36,4,3
3,383,383,194,194,0,1,0
8,437,437,64,45,19,2,1
5,479,479,67,19,48,4,3
12,482,482,54,54,0,1,0
7,488,488,5,5,0,1,0

5,158,158,3,3,0,1,0
19,162,162,25,11,14,3,2
17,163,163,3,3,0,1,0
26,166,166,29,5,24,2,1
25,183,183,2,2,0,1,0
8,184,184,3,3,0,1,0
27,196,196,30,12,18,2,1
6,203,203,4,4,0,1,0
7,227,227,2,2,0,1,0
13,233,233,6,6,0,1,0
1,244,244,13,13,0,1,0
2,249,249,108,78,30,3,2
15,260,260,3,3,0,1,0
9,261,261,3,3,0,1,0
21,262,262,26,26,0,1,0
14,262,262,26,18,8,2,1
10,289,289,3,3,0,1,0
24,308,308,23,23,0,1,0
4,309,309,1,1,0,1,0
12,324,324,6,3,3,2,1
22,329,329,72,4,68,3,2
0,350,350,75,21,54,4,3
23,351,351,18,9,9,2,1
16,380,380,6,6,0,1,0
3,380,380,2,2,0,1,0
20,462,462,37,37,0,1,0
11,472,472,7,7,0,1,0
18,475,475,1,1,0,1,0

0,121,121,28,1,27,4,3
2,129,129,2,2,0,1,0
5,150,150,7,3,4,2,1
12,206,206,1,1,0,1,0
3,207,207,26,26,0,1,0
7,208,208,8,3,5,2,1
8,208,208,8,8,0,1,0
18,211,211,41,41,0,1,0
1,255,255,10,4,6,3,2
16,273,273,30,30,0,1,0
10,321,321,109,109,0,1,0
19,344,344,1,1,0,1,0
14,353,353,29,18,11,2,1
6,361,361,16,16,0,1,0
11,362,362,6,6,0,1,0
4,380,380,10,10,0,1,0
15,436,436,112,14,98,3,2
9,441,441,25,25,0,1,0
13,452,452,94,42,52,3,2
17,459,459,64,64,0,1,0

20,133,133,1,1,0,1,0
15,166,166,40,4,36,3,2
2,182,182,8,8,0,1,0
14,185,185,4,4,0,1,0
7,193,193,6,1,5,2,1
6,204,204,3,3,0,1,0
0,235,235,32,14,18,3,2
1,241,241,58,23,35,2,1
8,267,267,43,43,0,1,0
13,270,270,17,5,12,3,2
12,276,276,40,18,22,4,3
3,277,277,17,7,10,3,2
4,298,298,37,10,27,4,3
5,336,336,10,10,0,1,0
9,346,346,8,8,0,1,0
18,379,379,31,31,0,1,0
17,398,398,18,4,14,3,2
16,413,413,136,78,58,3,2
10,451,451,5,5,0,1,0
11,468,468,58,19,39,4,3
19,472,472,38,38,0,1,0

7,104,104,12,2,10,3,2
6,114,114,7,7,0,1,0
10,127,127,11,11,0,1,0
2,172,172,33,33,0,1,0
11,222,222,23,1,22,2,1
1,223,223,18,18,0,1,0
3,225,225,10,7,3,2,1
13,229,229,18,18,0,1,0
12,272,272,49,1,48,4,3
14,312,312,51,51,0,1,0
9,316,316,58,58,0,1,0
8,363,363,17,8,9,4,3
0,421,421,36,9,27,2,1
5,450,450,95,23,72,4,3
4,463,463,179,179,0,1,0

5,127,127,12,12,0,1,0
12,127,127,24,24,0,1,0
11,131,131,14,9,5,2,1
15,181,181,2,2,0,1,0
8,213,213,14,14,0,1,0
7,220,220,14,14,0,1,0
14,224,224,23,14,9,2,1
2,239,239,33,33,0,1,0
13,269,269,5,1,4,2,1
9,323,323,19,19,0,1,0
4,335,335,65,65,0,1,0
3,392,392,7,7,0,1,0
0,410,410,64,55,9,4,3
1,451,451,170,134,36,3,2
10,458,458,182,106,76,3,2
6,474,474,11,5,6,2,1

4,119,119,5,1,4,2,1
7,134,134,8,2,6,3,2
11,148,148,15,15,0,1,0
16,151,151,27,27,0,1,0
9,173,173,5,5,0,1,0
3,187,187,23,13,10,3,2
8,208,208,44,44,0,1,0
17,243,243,17,17,0,1,0
2,250,250,3,3,0,1,0
5,273,273,33,2,31,2,1
14,310,310,46,28,18,3,2
13,377,377,34,34,0,1,0
15,392,392,60,60,0,1,0
1,398,398,51,51,0,1,0
10,401,401,39,17,22,3,2
6,436,436,37,34,3,2,1
12,484,484,70,30,40,3,2
0,485,485,107,32,75,4,3

15,101,101,4,1,3,2,1
13,131,131,2,2,0,1,0
20,136,136,1,1,0,1,0
12,137,137,14,14,0,1,0
14,157,157,10,2,8,2,1
1,162,162,2,2,0,1,0
24,163,163,1,1,0,1,0
8,169,169,9,9,0,1,0
16,195,195,29,29,0,1,0
10,213,213,51,51,0,1,0
3,249,249,5,5,0,1,0
17,251,251,99,99,0,1,0
7,258,258,38,38,0,1,0
18,278,278,56,27,29,3,2
6,287,287,27,27,0,1,0
9,318,318,12,12,0,1,0
2,346,346,3,3,0,1,0
5,348,348,5,1,4,2,1
4,352,352,39,12,27,2,1
22,359,359,27,27,0,1,0
23,374,374,20,20,0,1,0
0,393,393,7,7,0,1,0
19,414,414,38,38,0,1,0
21,422,422,19,19,0,1,0
11,445,445,11,4,7,2,1

18,113,113,3,3,0,1,0
8,131,131,23,10,13,2,1
12,133,133,3,3,0,1,0
5,151,151,2,2,0,1,0
19,177,177,19,9,10,3,2
11,186,186,7,7,0,1,0
3,215,215,71,71,0,1,0
17,226,226,137,97,40,3,2
7,245,245,11,1,10,3,2
15,260,260,15,3,12,4,3
13,269,269,11,11,0,1,0
9,320,320,54,17,37,4,3
4,339,339,11,11,0,1,0
6,342,342,3,3,0,1,0
14,353,353,36,6,30,3,2
2,404,404,13,13,0,1,0
10,427,427,5,5,0,1,0
16,435,435,11,11,0,1,0
0,472,472,23,15,8,2,1
1,493,493,66,66,0,1,0

20,200,200,2,2,0,1,0
18,215,215,23,23,0,1,0
3,222,222,37,37,0,1,0
1,230,230,8,2,6,3,2
14,283,283,18,18,0,1,0
12,321,321,49,49,0,1,0
2,333,333,12,1,11,3,2
4,348,348,29,15,14,2,1
8,348,348,12,12,0,1,0
19,350,350,163,103,60,3,2
10,350,350,61,61,0,1,0
11,373,373,42,42,0,1,0
9,407,407,21,3,18,3,2
0,421,421,77,77,0,1,0
15,425,425,23,7,16,3,2
5,427,427,16,1,15,4,3
17,438,438,50,50,0,1,0
7,445,445,10,2,8,3,2
6,471,471,31,28,3,2,1
13,485,485,4,4,0,1,0
16,497,497,17,3,14,2,1

0,115,115,1,1,0,1,0
6,120,120,15,15,0,1,0
7,136,136,3,3,0,1,0
8,149,149,7,7,0,1,0
13,160,160,2,2,0,1,0
11,168,168,58,58,0,1,0
14,175,175,4,1,3,2,1
16,181,181,4,4,0,1,0
12,216,216,11,7,4,2,1
15,225,225,5,5,0,1,0
9,258,258,92,92,0,1,0
10,345,345,51,51,0,1,0
2,361,361,18,18,0,1,0
3,366,366,74,74,0,1,0
1,458,458,40,10,30,4,3
5,479,479,96,39,57,4,3
4,496,496,153,72,81,4,3

16,130,130,28,4,24,3,2
9,131,131,15,15,0,1,0
2,146,146,18,18,0,1,0
0,166,166,16,10,6,3,2
14,178,178,12,3,9,2,1
15,204,204,6,1,5,2,1
4,211,211,1,1,0,1,0
8,218,218,8,3,5,2,1
5,226,226,4,4,0,1,0
1,302,302,8,5,3,2,1
3,348,348,125,26,99,4,3
10,390,390,78,78,0,1,0
13,398,398,48,9,39,4,3
12,429,429,38,38,0,1,0
6,442,442,31,9,22,2,1
11,443,443,64,64,0,1,0
7,457,457,139,10,129,4,3

0,107,107,16,16,0,1,0
7,152,152,21,1,20,2,1
18,160,160,61,41,20,2,1
16,163,163,5,5,0,1,0
1,173,173,1,1,0,1,0
12,194,194,20,20,0,1,0
10,219,219,14,14,0,1,0
5,226,226,4,4,0,1,0
3,234,234,3,3,0,1,0
17,239,239,14,6,8,2,1
6,261,261,19,5,14,3,2
8,279,279,37,37,0,1,0
13,296,296,18,4,14,2,1
14,328,328,8,8,0,1,0
4,365,365,145,117,28,2,1
15,367,367,47,47,0,1,0
11,380,380,63,45,18,4,3
2,382,382,27,7,20,3,2
9,470,470,2,2,0,1,0

10,152,152,49,22,27,2,1
13,153,153,46,8,38,2,1
16,164,164,3,3,0,1,0
8,200,200,9,9,0,1,0
19,214,214,8,8,0,1,0
11,226,226,6,6,0,1,0
0,248,248,17,6,11,2,1
15,261,261,24,24,0,1,0
6,295,295,25,25,0,1,0
9,307,307,39,2,37,4,3
14,348,348,112,112,0,1,0
2,351,351,11,11,0,1,0
3,358,358,49,4,45,4,3
12,371,371,18,1,17,4,3
5,400,400,2,2,0,1,0
4,436,436,6,6,0,1,0
17,443,443,41,6,35,2,1
1,445,445,41,17,24,3,2
18,471,471,40,33,7,2,1
7,490,490,39,35,4,2,1

4,103,103,8,8,0,1,0
3,117,117,8,8,0,1,0
8,176,176,27,15,12,3,2
1,181,181,1,1,0,1,0
17,185,185,2,2,0,1,0
9,212,212,34,13,21,4,3
14,216,216,2,2,0,1,0
15,275,275,49,46,3,2,1
7,283,283,37,37,0,1,0
2,355,355,18,18,0,1,0
5,359,359,86,86,0,1,0
12,373,373,75,20,55,3,2
18,388,388,19,19,0,1,0
0,402,402,20,20,0,1,0
11,448,448,114,114,0,1,0
13,451,451,62,62,0,1,0
6,471,471,31,2,29,4,3
10,488,488,7,4,3,2,1
16,494,494,76,22,54,4,3

7,127,127,1,1,0,1,0
3,177,177,11,11,0,1,0
0,187,187,118,22,96,4,3
2,257,257,8,8,0,1,0
5,268,268,23,23,0,1,0
8,276,276,27,6,21,4,3
17,278,278,33,33,0,1,0
1,302,302,1,1,0,1,0
4,304,304,1,1,0,1,0
14,371,371,76,43,33,4,3
16,396,396,50,21,29,4,3
13,412,412,28,28,0,1,0
9,419,419,22,22,0,1,0
12,420,420,14,14,0,1,0
15,467,467,33,4,29,2,1
18,468,468,117,80,37,2,1
11,468,468,30,15,15,2,1
6,469,469,11,11,0,1,0
10,478,478,1,1,0,1,0
19,496,496,38,26,12,2,1

11,143,143,12,12,0,1,0
2,186,186,8,8,0,1,0
14,203,203,75,75,0,1,0
1,222,222,35,35,0,1,0
0,240,240,28,20,8,2,1
12,273,273,1,1,0,1,0
17,287,287,62,17,45,4,3
15,287,287,16,16,0,1,0
5,312,312,116,57,59,4,3
6,320,320,1,1,0,1,0
16,351,351,13,13,0,1,0
13,353,353,16,4,12,3,2
8,370,370,12,2,10,3,2
7,385,385,28,28,0,1,0
18,389,389,10,4,6,3,2
10,421,421,25,25,0,1,0
9,447,447,16,16,0,1,0
3,449,449,27,12,15,4,3
19,473,473,85,4,81,4,3
4,480,480,23,5,18,2,1

4,108,108,4,4,0,1,0
6,119,119,1,1,0,1,0
9,134,134,16,8,8,2,1
5,147,147,2,2,0,1,0
16,171,171,46,10,36,3,2
3,179,179,21,21,0,1,0
2,206,206,56,56,0,1,0
14,254,254,10,10,0,1,0
12,264,264,30,30,0,1,0
18,273,273,39,29,10,3,2
7,281,281,48,48,0,1,0
11,350,350,4,4,0,1,0
8,351,351,52,52,0,1,0
17,383,383,93,59,34,2,1
0,397,397,13,5,8,3,2
10,403,403,12,5,7,2,1
13,464,464,40,4,36,2,1
19,477,477,22,3,19,2,1
1,486,486,25,25,0,1,0
15,491,491,31,16,15,4,3

21,101,101,1,1,0,1,0
19,120,120,6,6,0,1,0
18,127,127,25,15,10,2,1
3,167,167,1,1,0,1,0
5,203,203,18,18,0,1,0
13,212,212,20,20,0,1,0
9,240,240,35,1,34,2,1
4,248,248,1,1,0,1,0
6,253,253,61,61,0,1,0
8,266,266,10,6,4,2,1
1,287,287,2,2,0,1,0
20,297,297,114,114,0,1,0
16,301,301,10,2,8,2,1
22,335,335,51,51,0,1,0
14,338,338,59,59,0,1,0
0,341,341,39,35,4,2,1
7,342,342,9,9,0,1,0
11,347,347,31,19,12,2,1
12,349,349,16,8,8,2,1
10,392,392,3,3,0,1,0
15,418,418,1,1,0,1,0
2,446,446,42,42,0,1,0
17,446,446,11,1,10,2,1

8,170,170,21,11,10,3,2
4,219,219,1,1,0,1,0
1,237,237,78,67,11,2,1
7,246,246,122,122,0,1,0
5,276,276,13,1,12,4,3
11,289,289,52,52,0,1,0
6,297,297,3,3,0,1,0
0,322,322,23,23,0,1,0
2,327,327,162,81,81,4,3
15,359,359,1,1,0,1,0
3,390,390,17,6,11,2,1
10,398,398,2,2,0,1,0
13,439,439,3,3,0,1,0
14,470,470,43,43,0,1,0
9,485,485,50,50,0,1,0
12,490,490,2,2,0,1,0

12,181,181,4,4,0,1,0
14,195,195,3,3,0,1,0
5,232,232,24,24,0,1,0
10,234,234,28,28,0,1,0
1,266,266,22,15,7,2,1
9,267,267,15,15,0,1,0
2,285,285,84,18,66,4,3
4,314,314,30,18,12,4,3
11,324,324,32,12,20,2,1
0,356,356,104,104,0,1,0
8,392,392,19,1,18,2,1
3,394,394,30,30,0,1,0
13,432,432,119,86,33,4,3
6,436,436,24,24,0,1,0
15,440,440,129,111,18,3,2
16,448,448,37,37,0,1,0
7,475,475,1,1,0,1,0

9,107,107,12,2,10,3,2
8,116,116,11,5,6,3,2
4,160,160,3,3,0,1,0
14,203,203,14,14,0,1,0
11,204,204,23,23,0,1,0
10,283,283,17,3,14,3,2
2,347,347,127,127,0,1,0
1,392,392,10,10,0,1,0
0,394,394,19,19,0,1,0
6,425,425,49,19,30,3,2
3,425,425,3,3,0,1,0
5,433,433,153,153,0,1,0
13,446,446,62,32,30,3,2
15,476,476,1,1,0,1,0
12,477,477,39,39,0,1,0
7,487,487,33,27,6,3,2
16,489,489,168,139,29,2,1

11,102,102,3,3,0,1,0
14,126,126,7,7,0,1,0
8,133,133,1,1,0,1,0
20,149,149,10,4,6,3,2
9,153,153,3,3,0,1,0
18,159,159,4,4,0,1,0
6,188,188,6,6,0,1,0
19,208,208,14,14,0,1,0
13,226,226,18,18,0,1,0
7,251,251,2,2,0,1,0
0,259,259,24,24,0,1,0
16,266,266,1,1,0,1,0
4,295,295,2,2,0,1,0
5,302,302,25,25,0,1,0
1,339,339,118,90,28,3,2
21,419,419,132,87,45,2,1
17,421,421,102,24,78,4,3
2,426,426,61,61,0,1,0
3,469,469,53,25,28,3,2
15,470,470,77,7,70,4,3
10,482,482,8,4,4,2,1
12,485,485,49,25,24,3,2

5,105,105,21,21,0,1,0
2,151,151,8,4,4,2,1
11,175,175,16,1,15,2,1
13,176,176,14,14,0,1,0
17,217,217,17,17,0,1,0
8,233,233,11,2,9,4,3
9,235,235,38,12,26,3,2
3,240,240,12,12,0,1,0
14,258,258,68,16,52,3,2
0,281,281,10,2,8,3,2
1,318,318,55,3,52,3,2
4,318,318,18,18,0,1,0
12,325,325,2,2,0,1,0
6,331,331,63,9,54,4,3
19,374,374,18,18,0,1,0
10,374,374,4,1,3,2,1
16,378,378,63,1,62,3,2
7,449,449,11,11,0,1,0
15,467,467,18,4,14,2,1
18,472,472,114,102,12,4,3

19,119,119,7,2,5,2,1
10,127,127,14,6,8,2,1
14,134,134,10,10,0,1,0
5,160,160,7,2,5,2,1
0,166,166,1,1,0,1,0
4,168,168,37,37,0,1,0
15,244,244,59,59,0,1,0
16,252,252,35,15,20,3,2
18,254,254,15,11,4,2,1
1,264,264,19,1,18,3,2
7,286,286,35,35,0,1,0
6,294,294,11,11,0,1,0
9,317,317,16,10,6,2,1
8,319,319,14,14,0,1,0
17,325,325,60,49,11,2,1
20,342,342,20,20,0,1,0
2,440,440,68,20,48,4,3
11,449,449,41,41,0,1,0
3,453,453,22,22,0,1,0
13,469,469,56,4,52,3,2
12,481,481,39,39,0,1,0

10,108,108,13,13,0,1,0
14,114,114,3,3,0,1,0
0,123,123,26,26,0,1,0
15,199,199,50,50,0,1,0
12,209,209,62,35,27,4,3
16,218,218,26,3,23,2,1
13,224,224,7,1,6,2,1
2,229,229,17,5,12,3,2
3,306,306,59,20,39,4,3
11,314,314,28,4,24,4,3
1,345,345,6,6,0,1,0
4,393,393,1,1,0,1,0
8,414,414,24,24,0,1,0
9,426,426,13,13,0,1,0
5,462,462,34,22,12,3,2
7,481,481,152,152,0,1,0
6,491,491,56,56,0,1,0

11,158,158,26,23,3,2,1
17,191,191,38,28,10,2,1
6,194,194,8,8,0,1,0
9,217,217,45,45,0,1,0
3,234,234,1,1,0,1,0
5,280,280,18,12,6,3,2
13,293,293,2,2,0,1,0
2,296,296,112,18,94,3,2
16,296,296,55,55,0,1,0
15,303,303,12,12,0,1,0
4,304,304,42,10,32,3,2
7,367,367,20,20,0,1,0
8,369,369,16,1,15,4,3
0,381,381,24,24,0,1,0
1,394,394,3,3,0,1,0
18,398,398,48,48,0,1,0
10,401,401,7,1,6,2,1
12,480,480,73,59,14,3,2
14,493,493,62,62,0,1,0

5,102,102,4,4,0,1,0
12,129,129,15,4,11,2,1
13,160,160,18,7,11,2,1
4,175,175,1,1,0,1,0
2,178,178,2,2,0,1,0
16,201,201,39,39,0,1,0
19,209,209,40,24,16,2,1
8,215,215,12,12,0,1,0
1,216,216,1,1,0,1,0
22,224,224,44,25,19,2,1
23,243,243,28,28,0,1,0
11,251,251,1,1,0,1,0
3,254,254,77,77,0,1,0
18,257,257,7,3,4,2,1
0,276,276,9,9,0,1,0
14,349,349,20,20,0,1,0
6,371,371,46,22,24,3,2
7,379,379,1,1,0,1,0
21,390,390,90,44,46,2,1
24,410,410,7,2,5,2,1
9,432,432,13,13,0,1,0
15,441,441,41,41,0,1,0
10,447,447,4,1,3,2,1
17,450,450,1,1,0,1,0
20,460,460,21,13,8,2,1

3,124,124,10,10,0,1,0
0,151,151,1,1,0,1,0
15,167,167,3,3,0,1,0
2,169,169,17,1,16,2,1
4,172,172,17,17,0,1,0
1,175,175,1,1,0,1,0
9,182,182,19,19,0,1,0
12,194,194,1,1,0,1,0
8,204,204,9,9,0,1,0
25,204,204,11,3,8,3,2
7,221,221,13,4,9,4,3
23,244,244,47,17,30,4,3
27,249,249,23,13,10,2,1
21,269,269,35,35,0,1,0
20,288,288,2,2,0,1,0
22,299,299,46,11,35,2,1
19,305,305,65,35,30,4,3
24,332,332,37,37,0,1,0
26,346,346,22,11,11,2,1
10,360,360,1,1,0,1,0
11,389,389,11,5,6,2,1
6,391,391,7,4,3,2,1
18,392,392,28,12,16,3,2
17,411,411,35,35,0,1,0
14,413,413,1,1,0,1,0
5,416,416,14,6,8,3,2
16,426,426,15,15,0,1,0
13,440,440,89,7,82,4,3

7,136,136,37,37,0,1,0
15,147,147,2,2,0,1,0
1,213,213,14,14,0,1,0
9,233,233,43,19,24,2,1
17,265,265,51,51,0,1,0
4,289,289,10,3,7,2,1
11,327,327,8,1,7,2,1
5,328,328,39,15,24,2,1
6,339,339,20,9,11,2,1
16,342,342,71,71,0,1,0
13,347,347,2,2,0,1,0
10,371,371,10,10,0,1,0
12,373,373,6,6,0,1,0
19,386,386,69,69,0,1,0
3,431,431,18,18,0,1,0
8,433,433,4,4,0,1,0
18,449,449,19,5,14,3,2
14,473,473,157,79,78,3,2
0,490,490,30,9,21,4,3
2,500,500,64,64,0,1,0

7,102,102,4,1,3,2,1
17,115,115,2,2,0,1,0
0,117,117,9,6,3,2,1
10,177,177,9,3,6,3,2
8,179,179,12,2,10,3,2
2,189,189,6,6,0,1,0
13,219,219,2,2,0,1,0
19,228,228,36,3,33,4,3
1,242,242,2,2,0,1,0
15,242,242,25,25,0,1,0
5,252,252,17,17,0,1,0
20,265,265,18,2,16,3,2
16,270,270,28,16,12,2,1
6,354,354,1,1,0,1,0
18,360,360,4,1,3,2,1
21,363,363,42,36,6,2,1
11,378,378,43,43,0,1,0
22,456,456,108,93,15,4,3
12,471,471,55,55,0,1,0
4,478,478,175,104,71,4,3
3,485,485,1,1,0,1,0
14,489,489,100,89,11,2,1
9,489,489,24,6,18,2,1

15,126,126,23,23,0,1,0
0,140,140,40,40,0,1,0
19,149,149,11,2,9,2,1
20,150,150,35,35,0,1,0
8,164,164,7,7,0,1,0
5,213,213,6,6,0,1,0
16,297,297,3,3,0,1,0
11,306,306,25,25,0,1,0
7,323,323,59,30,29,2,1
4,323,323,11,11,0,1,0
3,330,330,12,12,0,1,0
6,345,345,11,5,6,2,1
13,360,360,1,1,0,1,0
18,369,369,20,16,4,2,1
9,403,403,14,1,13,3,2
17,418,418,101,101,0,1,0
10,420,420,11,3,8,3,2
14,425,425,47,14,33,4,3
1,446,446,86,5,81,4,3
12,455,455,52,10,42,4,3
2,470,470,11,1,10,3,2

14,109,109,7,7,0,1,0
21,111,111,16,16,0,1,0
20,112,112,6,2,4,2,1
11,121,121,16,6,10,3,2
3,146,146,6,2,4,2,1
4,153,153,5,5,0,1,0
15,214,214,50,50,0,1,0
22,218,218,10,7,3,2,1
8,234,234,6,6,0,1,0
1,257,257,4,4,0,1,0
0,317,317,11,11,0,1,0
5,319,319,20,20,0,1,0
16,335,335,29,11,18,3,2
19,348,348,34,23,11,2,1
9,365,365,57,57,0,1,0
17,388,388,48,48,0,1,0
7,430,430,18,18,0,1,0
10,436,436,19,10,9,2,1
6,457,457,64,64,0,1,0
18,458,458,59,41,18,3,2
13,461,461,77,23,54,3,2
23,464,464,52,19,33,2,1
12,477,477,10,10,0,1,0
2,491,491,11,11,0,1,0

14,116,116,12,12,0,1,0
7,124,124,9,5,4,2,1
6,133,133,23,23,0,1,0
4,134,134,14,14,0,1,0
9,134,134,10,5,5,2,1
16,202,202,45,26,19,2,1
17,217,217,14,14,0,1,0
15,222,222,10,3,7,2,1
3,247,247,20,20,0,1,0
1,280,280,3,3,0,1,0
12,313,313,15,15,0,1,0
19,314,314,38,38,0,1,0
18,318,318,8,2,6,3,2
5,331,331,16,16,0,1,0
11,335,335,44,17,27,2,1
10,339,339,51,51,0,1,0
8,376,376,33,33,0,1,0
0,379,379,20,10,10,3,2
2,385,385,56,56,0,1,0
13,470,470,119,119,0,1,0

6,209,209,40,9,31,4,3
10,271,271,10,10,0,1,0
7,276,276,7,7,0,1,0
0,293,293,38,38,0,1,0
11,293,293,8,8,0,1,0
4,295,295,7,7,0,1,0
3,318,318,41,16,25,2,1
13,329,329,18,3,15,2,1
14,376,376,38,38,0,1,0
12,402,402,11,1,10,3,2
17,424,424,222,133,89,4,3
8,425,425,81,72,9,4,3
1,427,427,60,60,0,1,0
16,427,427,41,1,40,3,2
15,438,438,33,33,0,1,0
9,452,452,30,3,27,2,1
2,483,483,13,4,9,2,1
5,485,485,70,51,19,2,1

15,136,136,27,4,23,3,2
9,149,149,9,9,0,1,0
7,160,160,10,10,0,1,0
17,192,192,38,22,16,3,2
0,215,215,1,1,0,1,0
1,311,311,48,24,24,4,3
8,315,315,34,19,15,2,1
6,319,319,14,14,0,1,0
10,322,322,77,77,0,1,0
11,330,330,14,14,0,1,0
12,370,370,14,14,0,1,0
16,405,405,87,69,18,2,1
14,451,451,1,1,0,1,0
13,453,453,11,11,0,1,0
5,454,454,22,22,0,1,0
3,467,467,152,148,4,2,1
2,469,469,87,51,36,3,2
4,488,488,33,8,25,2,1

8,124,124,39,18,21,2,1
13,153,153,8,5,3,2,1
11,195,195,4,4,0,1,0
17,200,200,41,41,0,1,0
5,214,214,12,12,0,1,0
10,219,219,3,3,0,1,0
7,220,220,2,2,0,1,0
14,229,229,69,69,0,1,0
12,254,254,77,53,24,4,3
1,273,273,49,1,48,4,3
2,275,275,58,28,30,3,2
0,299,299,23,2,21,4,3
15,318,318,12,12,0,1,0
4,340,340,37,4,33,2,1
16,377,377,23,23,0,1,0
6,382,382,11,11,0,1,0
3,389,389,8,8,0,1,0
9,489,489,11,3,8,3,2

11,100,100,27,27,0,1,0
1,127,127,8,8,0,1,0
21,127,127,1,1,0,1,0
20,151,151,3,3,0,1,0
16,173,173,14,14,0,1,0
2,178,178,6,6,0,1,0
8,180,180,29,29,0,1,0
6,204,204,5,5,0,1,0
15,206,206,47,41,6,3,2
9,226,226,21,21,0,1,0
5,248,248,3,3,0,1,0
4,252,252,1,1,0,1,0
0,258,258,26,26,0,1,0
17,287,287,3,3,0,1,0
18,357,357,28,28,0,1,0
19,411,411,153,123,30,4,3
13,424,424,37,32,5,2,1
12,440,440,29,29,0,1,0
14,440,440,60,40,20,3,2
7,468,468,3,3,0,1,0
3,479,479,62,41,21,3,2
10,480,480,18,9,9,3,2

3,105,105,6,6,0,1,0
11,121,121,18,8,10,3,2
0,169,169,7,7,0,1,0
4,180,180,7,7,0,1,0
1,187,187,13,1,12,4,3
12,233,233,21,21,0,1,0
2,239,239,1,1,0,1,0
8,245,245,29,26,3,2,1
10,270,270,18,18,0,1,0
16,295,295,15,7,8,2,1
9,311,311,26,6,20,2,1
15,335,335,58,58,0,1,0
6,339,339,7,7,0,1,0
19,340,340,8,8,0,1,0
5,377,377,9,9,0,1,0
17,379,379,4,4,0,1,0
18,400,400,95,19,76,3,2
13,468,468,150,150,0,1,0
14,470,470,44,36,8,3,2
20,482,482,7,2,5,2,1
7,486,486,161,61,100,3,2

14,112,112,4,1,3,2,1
10,119,119,1,1,0,1,0
0,145,145,19,9,10,2,1
18,189,189,12,12,0,1,0
20,203,203,4,4,0,1,0
3,243,243,4,4,0,1,0
19,249,249,44,44,0,1,0
16,252,252,144,144,0,1,0
6,276,276,11,11,0,1,0
9,303,303,77,77,0,1,0
4,345,345,27,2,25,2,1
1,377,377,11,1,10,3,2
2,400,400,23,23,0,1,0
17,412,412,19,2,17,4,3
5,437,437,103,103,0,1,0
8,443,443,23,12,11,2,1
15,452,452,29,17,12,3,2
12,462,462,1,1,0,1,0
13,462,462,15,15,0,1,0
7,465,465,35,9,26,2,1
11,498,498,12,5,7,2,1

15,118,118,18,1,17,2,1
4,153,153,40,18,22,3,2
7,176,176,18,9,9,2,1
12,183,183,5,1,4,2,1
0,197,197,45,45,0,1,0
8,233,233,6,6,0,1,0
5,258,258,67,60,7,2,1
14,276,276,96,66,30,3,2
10,283,283,43,10,33,4,3
9,305,305,27,27,0,1,0
6,359,359,6,6,0,1,0
11,403,403,31,31,0,1,0
3,433,433,53,53,0,1,0
13,434,434,20,4,16,2,1
1,442,442,23,4,19,2,1
2,493,493,30,11,19,3,2

7,146,146,15,15,0,1,0
3,150,150,21,21,0,1,0
15,165,165,10,4,6,3,2
0,170,170,11,11,0,1,0
6,221,221,42,42,0,1,0
11,225,225,18,3,15,4,3
8,252,252,29,29,0,1,0
1,282,282,95,95,0,1,0
4,295,295,19,19,0,1,0
10,330,330,18,18,0,1,0
2,339,339,27,15,12,2,1
5,378,378,47,47,0,1,0
14,407,407,38,38,0,1,0
9,444,444,2,2,0,1,0
13,451,451,9,9,0,1,0
12,458,458,223,107,116,4,3

11,127,127,10,10,0,1,0
9,142,142,18,11,7,3,2
10,145,145,14,14,0,1,0
19,163,163,13,13,0,1,0
15,218,218,16,8,8,3,2
13,225,225,3,3,0,1,0
12,230,230,56,8,48,4,3
18,237,237,10,7,3,2,1
17,240,240,8,8,0,1,0
4,245,245,47,17,30,3,2
14,294,294,96,96,0,1,0
5,336,336,2,2,0,1,0
16,355,355,46,26,20,3,2
6,375,375,1,1,0,1,0
0,380,380,32,1,31,2,1
2,385,385,26,26,0,1,0
7,401,401,45,11,34,3,2
3,402,402,30,3,27,4,3
8,415,415,16,16,0,1,0
1,446,446,91,45,46,2,1

16,127,127,14,1,13,2,1
12,142,142,5,5,0,1,0
0,179,179,20,20,0,1,0
7,190,190,3,3,0,1,0
10,197,197,2,2,0,1,0
19,202,202,11,11,0,1,0
3,242,242,140,107,33,2,1
2,248,248,19,7,12,4,3
15,264,264,38,11,27,2,1
14,298,298,83,83,0,1,0
8,312,312,3,3,0,1,0
1,323,323,3,3,0,1,0
11,355,355,18,10,8,3,2
4,365,365,3,3,0,1,0
17,372,372,36,6,30,3,2
13,399,399,56,56,0,1,0
5,419,419,5,5,0,1,0
18,446,446,47,22,25,2,1
6,448,448,52,52,0,1,0
9,463,463,26,2,24,4,3

3,134,134,29,8,21,2,1
10,149,149,5,2,3,2,1
11,149,149,7,7,0,1,0
15,185,185,8,8,0,1,0
16,188,188,93,93,0,1,0
20,206,206,13,1,12,2,1
9,225,225,6,1,5,2,1
19,226,226,14,14,0,1,0
6,247,247,7,2,5,2,1
0,255,255,19,4,15,4,3
13,256,256,2,2,0,1,0
17,302,302,9,9,0,1,0
5,307,307,10,10,0,1,0
7,312,312,23,3,20,2,1
12,317,317,38,38,0,1,0
8,356,356,91,91,0,1,0
21,357,357,2,2,0,1,0
4,385,385,20,20,0,1,0
1,400,400,8,8,0,1,0
14,413,413,100,64,36,4,3
18,447,447,33,33,0,1,0
2,475,475,10,10,0,1,0

7,101,101,28,8,20,2,1
17,114,114,15,15,0,1,0
6,118,118,12,12,0,1,0
11,134,134,17,2,15,4,3
9,138,138,8,8,0,1,0
0,140,140,3,3,0,1,0
15,145,145,37,15,22,2,1
13,212,212,1,1,0,1,0
2,216,216,1,1,0,1,0
12,236,236,11,8,3,2,1
4,275,275,10,10,0,1,0
14,282,282,33,2,31,4,3
10,287,287,5,5,0,1,0
1,314,314,18,9,9,4,3
16,315,315,83,34,49,2,1
5,419,419,43,7,36,2,1
8,464,464,165,84,81,4,3
3,499,499,22,22,0,1,0

12,104,104,59,59,0,1,0
4,120,120,6,6,0,1,0
0,152,152,4,4,0,1,0
5,160,160,8,1,7,2,1
18,167,167,7,7,0,1,0
17,177,177,3,3,0,1,0
16,218,218,3,3,0,1,0
10,242,242,2,2,0,1,0
14,263,263,45,5,40,2,1
3,302,302,41,35,6,3,2
7,322,322,18,18,0,1,0
6,325,325,28,28,0,1,0
11,339,339,57,32,25,2,1
8,355,355,10,10,0,1,0
9,378,378,79,69,10,2,1
2,387,387,101,47,54,4,3
13,414,414,3,3,0,1,0
1,457,457,45,45,0,1,0
15,464,464,13,13,0,1,0

10,109,109,4,4,0,1,0
13,150,150,1,1,0,1,0
15,181,181,24,3,21,2,1
1,208,208,3,3,0,1,0
6,214,214,41,31,10,2,1
8,241,241,17,17,0,1,0
17,241,241,18,12,6,2,1
7,244,244,10,10,0,1,0
12,263,263,26,26,0,1,0
16,278,278,4,1,3,2,1
3,315,315,10,6,4,2,1
19,322,322,38,38,0,1,0
0,333,333,87,87,0,1,0
9,343,343,55,55,0,1,0
2,359,359,9,1,8,3,2
11,374,374,65,61,4,2,1
4,420,420,65,65,0,1,0
18,431,431,97,94,3,2,1
5,464,464,8,8,0,1,0
14,470,470,83,83,0,1,0

15,102,102,9,1,8,3,2
13,139,139,17,17,0,1,0
11,176,176,7,7,0,1,0
1,195,195,1,1,0,1,0
0,213,213,13,5,8,3,2
14,258,258,88,59,29,4,3
10,274,274,4,4,0,1,0
4,287,287,37,10,27,4,3
8,290,290,62,30,32,3,2
12,305,305,3,3,0,1,0
3,320,320,34,34,0,1,0
2,322,322,41,41,0,1,0
6,347,347,158,158,0,1,0
5,369,369,43,43,0,1,0
7,420,420,35,28,7,2,1
9,454,454,51,51,0,1,0

2,108,108,17,17,0,1,0
6,123,123,2,2,0,1,0
10,135,135,9,9,0,1,0
12,153,153,4,4,0,1,0
13,163,163,35,35,0,1,0
5,170,170,16,16,0,1,0
11,185,185,28,28,0,1,0
15,189,189,7,7,0,1,0
1,238,238,4,1,3,2,1
9,257,257,3,3,0,1,0
4,269,269,47,23,24,2,1
18,279,279,33,33,0,1,0
14,301,301,100,67,33,4,3
16,322,322,22,22,0,1,0
8,343,343,31,8,23,2,1
17,372,372,3,3,0,1,0
3,382,382,30,18,12,4,3
0,388,388,54,6,48,2,1
7,425,425,95,74,21,2,1

13,119,119,9,1,8,2,1
18,131,131,42,20,22,4,3
6,133,133,1,1,0,1,0
15,135,135,16,1,15,4,3
4,163,163,10,10,0,1,0
7,192,192,2,2,0,1,0
2,223,223,11,11,0,1,0
12,245,245,28,28,0,1,0
10,256,256,12,9,3,2,1
19,285,285,21,21,0,1,0
11,291,291,37,1,36,4,3
5,336,336,99,65,34,3,2
17,389,389,6,6,0,1,0
14,398,398,26,26,0,1,0
16,402,402,44,10,34,3,2
9,433,433,8,8,0,1,0
3,475,475,51,7,44,3,2
1,475,475,143,112,31,4,3
8,477,477,24,6,18,3,2
0,492,492,26,6,20,3,2

2,106,106,9,9,0,1,0
13,133,133,1,1,0,1,0
14,252,252,17,17,0,1,0
5,258,258,74,4,70,3,2
11,258,258,28,19,9,2,1
12,269,269,10,10,0,1,0
1,271,271,47,20,27,2,1
3,271,271,15,3,12,2,1
6,271,271,2,2,0,1,0
4,274,274,93,19,74,4,3
8,345,345,32,32,0,1,0
9,349,349,195,175,20,3,2
15,389,389,32,20,12,3,2
10,429,429,20,20,0,1,0
0,468,468,26,26,0,1,0
7,470,470,8,2,6,2,1

14,114,114,3,3,0,1,0
11,117,117,2,2,0,1,0
13,166,166,6,6,0,1,0
22,182,182,53,53,0,1,0
5,189,189,30,11,19,2,1
3,217,217,18,3,15,2,1
16,223,223,5,5,0,1,0
19,239,239,6,2,4,2,1
10,243,243,52,25,27,4,3
20,243,243,122,122,0,1,0
2,246,246,4,4,0,1,0
18,253,253,12,3,9,2,1
0,270,270,13,13,0,1,0
15,272,272,19,9,10,3,2
8,285,285,14,9,5,2,1
1,307,307,59,39,20,2,1
17,335,335,10,10,0,1,0
9,388,388,44,35,9,4,3
4,396,396,3,3,0,1,0
7,417,417,7,4,3,2,1
6,456,456,1,1,0,1,0
21,487,487,2,2,0,1,0
12,498,498,23,23,0,1,0

22,107,107,5,5,0,1,0
3,149,149,8,4,4,2,1
20,175,175,23,5,18,3,2
21,191,191,16,1,15,4,3
16,193,193,1,1,0,1,0
6,196,196,51,51,0,1,0
14,199,199,1,1,0,1,0
11,199,199,27,10,17,3,2
23,200,200,39,6,33,2,1
12,213,213,1,1,0,1,0
24,279,279,20,20,0,1,0
5,289,289,21,21,0,1,0
25,303,303,70,22,48,4,3
1,368,368,2,2,0,1,0
18,378,378,5,5,0,1,0
4,401,401,65,27,38,3,2
10,402,402,19,19,0,1,0
7,420,420,3,3,0,1,0
9,425,425,29,29,0,1,0
8,450,450,20,11,9,4,3
0,451,451,25,8,17,2,1
19,455,455,20,1,19,2,1
2,461,461,1,1,0,1,0
13,482,482,35,28,7,2,1
15,488,488,1,1,0,1,0
17,500,500,99,99,0,1,0

18,133,133,2,2,0,1,0
6,151,151,21,2,19,2,1
0,154,154,25,25,0,1,0
15,173,173,3,3,0,1,0
2,204,204,6,1,5,2,1
16,212,212,9,9,0,1,0
17,214,214,51,51,0,1,0
20,232,232,4,1,3,2,1
5,267,267,42,2,40,2,1
13,268,268,83,31,52,3,2
4,288,288,10,10,0,1,0
11,313,313,5,5,0,1,0
14,363,363,21,1,20,3,2
19,382,382,26,26,0,1,0
21,388,388,102,102,0,1,0
7,396,396,27,15,12,4,3
10,400,400,14,14,0,1,0
8,421,421,50,30,20,3,2
9,425,425,40,40,0,1,0
12,434,434,20,20,0,1,0
1,434,434,1,1,0,1,0
3,499,499,49,10,39,4,3

13,119,119,9,9,0,1,0
22,151,151,38,13,25,2,1
14,152,152,4,4,0,1,0
20,153,153,18,18,0,1,0
15,167,167,1,1,0,1,0
18,168,168,13,3,10,3,2
3,188,188,22,22,0,1,0
7,203,203,7,7,0,1,0
5,238,238,2,2,0,1,0
6,256,256,20,20,0,1,0
19,272,272,2,2,0,1,0
25,275,275,14,14,0,1,0
23,302,302,33,11,22,2,1
4,303,303,19,5,14,3,2
10,334,334,10,1,9,4,3
0,350,350,1,1,0,1,0
21,352,352,57,5,52,4,3
2,368,368,10,10,0,1,0
16,369,369,23,5,18,4,3
12,373,373,16,16,0,1,0
11,378,378,8,8,0,1,0
1,379,379,10,10,0,1,0
17,398,398,38,38,0,1,0
8,404,404,41,17,24,2,1
24,415,415,62,14,48,3,2
9,478,478,133,92,41,2,1

3,111,111,23,23,0,1,0
5,147,147,23,16,7,2,1
13,162,162,7,7,0,1,0
6,172,172,13,4,9,4,3
10,193,193,40,12,28,3,2
2,199,199,4,4,0,1,0
0,206,206,8,8,0,1,0
9,286,286,65,20,45,4,3
17,310,310,33,24,9,4,3
7,320,320,51,51,0,1,0
8,331,331,62,62,0,1,0
14,338,338,13,13,0,1,0
1,355,355,1,1,0,1,0
12,364,364,8,8,0,1,0
11,368,368,55,37,18,4,3
16,396,396,61,27,34,2,1
4,414,414,64,57,7,2,1
15,445,445,27,27,0,1,0

0,120,120,8,8,0,1,0
12,127,127,21,21,0,1,0
1,174,174,37,37,0,1,0
3,199,199,35,11,24,4,3
15,254,254,53,30,23,2,1
13,282,282,11,11,0,1,0
9,296,296,42,42,0,1,0
10,329,329,1,1,0,1,0
6,350,350,28,16,12,3,2
8,355,355,63,63,0,1,0
4,366,366,82,82,0,1,0
5,390,390,63,63,0,1,0
16,413,413,90,16,74,3,2
11,441,441,3,3,0,1,0
7,470,470,31,19,12,2,1
2,470,470,7,2,5,2,1
14,481,481,27,27,0,1,0

10,114,114,5,5,0,1,0
9,144,144,13,13,0,1,0
12,153,153,2,2,0,1,0
16,154,154,5,5,0,1,0
13,178,178,14,5,9,2,1
22,182,182,19,7,12,3,2
18,225,225,10,10,0,1,0
5,226,226,2,2,0,1,0
7,226,226,11,11,0,1,0
4,259,259,11,11,0,1,0
19,261,261,29,29,0,1,0
23,268,268,123,63,60,4,3
21,278,278,51,11,40,3,2
2,279,279,19,14,5,2,1
6,283,283,58,58,0,1,0
3,301,301,1,1,0,1,0
8,307,307,9,9,0,1,0
14,324,324,14,14,0,1,0
11,399,399,47,47,0,1,0
20,422,422,7,4,3,2,1
1,445,445,69,69,0,1,0
17,497,497,16,7,9,4,3
0,498,498,27,27,0,1,0
15,500,500,17,17,0,1,0

15,109,109,2,2,0,1,0
1,122,122,14,6,8,3,2
0,136,136,26,16,10,3,2
11,140,140,37,37,0,1,0
13,188,188,12,12,0,1,0
9,193,193,11,3,8,2,1
12,193,193,4,4,0,1,0
5,195,195,11,5,6,2,1
8,197,197,2,2,0,1,0
17,256,256,16,8,8,2,1
10,270,270,5,2,3,2,1
4,276,276,9,3,6,3,2
3,288,288,2,2,0,1,0
19,352,352,14,14,0,1,0
14,373,373,9,9,0,1,0
18,425,425,165,165,0,1,0
6,435,435,128,128,0,1,0
16,459,459,63,1,62,3,2
7,462,462,54,54,0,1,0
2,489,489,50,18,32,3,2

14,104,104,13,13,0,1,0
6,169,169,24,12,12,3,2
8,180,180,9,9,0,1,0
7,182,182,1,1,0,1,0
4,203,203,8,5,3,2,1
1,224,224,19,12,7,2,1
12,233,233,69,15,54,4,3
13,233,233,2,2,0,1,0
2,238,238,94,16,78,3,2
10,250,250,39,39,0,1,0
16,272,272,35,20,15,4,3
5,286,286,41,33,8,2,1
17,302,302,42,18,24,3,2
11,359,359,2,2,0,1,0
9,369,369,4,4,0,1,0
3,376,376,48,16,32,3,2
15,380,380,56,47,9,2,1
0,439,439,1,1,0,1,0
18,470,470,6,6,0,1,0

16,129,129,16,8,8,3,2
3,158,158,16,16,0,1,0
12,165,165,3,3,0,1,0
11,168,168,23,23,0,1,0
15,171,171,4,4,0,1,0
8,252,252,1,1,0,1,0
18,324,324,3,3,0,1,0
2,337,337,7,7,0,1,0
9,341,341,8,8,0,1,0
14,342,342,14,6,8,3,2
5,345,345,71,67,4,2,1
13,345,345,42,18,24,4,3
17,379,379,90,90,0,1,0
7,388,388,14,14,0,1,0
6,412,412,1,1,0,1,0
0,438,438,86,47,39,4,3
4,442,442,88,88,0,1,0
19,481,481,149,149,0,1,0
10,485,485,4,4,0,1,0
1,492,492,100,18,82,3,2

21,109,109,12,12,0,1,0
3,155,155,3,3,0,1,0
8,191,191,4,4,0,1,0
18,197,197,30,30,0,1,0
11,202,202,2,2,0,1,0
0,234,234,30,30,0,1,0
14,243,243,43,7,36,3,2
5,250,250,3,3,0,1,0
10,251,251,35,9,26,2,1
16,262,262,4,1,3,2,1
13,263,263,9,9,0,1,0
20,266,266,22,22,0,1,0
12,292,292,8,4,4,2,1
9,301,301,65,65,0,1,0
17,316,316,135,95,40,3,2
23,369,369,2,2,0,1,0
6,371,371,4,4,0,1,0
19,401,401,64,64,0,1,0
22,404,404,21,5,16,2,1
1,415,415,29,29,0,1,0
4,420,420,33,33,0,1,0
15,446,446,4,4,0,1,0
2,446,446,14,14,0,1,0
7,487,487,13,13,0,1,0

0,100,100,2,2,0,1,0
22,113,113,13,13,0,1,0
5,154,154,10,10,0,1,0
20,166,166,12,4,8,3,2
21,171,171,26,26,0,1,0
12,204,204,2,2,0,1,0
8,219,219,21,21,0,1,0
24,243,243,6,6,0,1,0
6,245,245,7,7,0,1,0
13,265,265,8,8,0,1,0
15,308,308,33,33,0,1,0
16,316,316,39,16,23,2,1
19,329,329,24,9,15,4,3
4,347,347,47,47,0,1,0
17,349,349,28,11,17,2,1
10,371,371,66,23,43,2,1
9,375,375,2,2,0,1,0
11,400,400,7,7,0,1,0
1,402,402,5,5,0,1,0
18,404,404,39,18,21,4,3
14,414,414,93,71,22,3,2
3,433,433,1,1,0,1,0
2,440,440,1,1,0,1,0
7,494,494,33,33,0,1,0
23,499,499,139,78,61,4,3

12,114,114,13,9,4,2,1
5,139,139,14,14,0,1,0
1,146,146,5,5,0,1,0
14,156,156,11,3,8,2,1
0,162,162,7,7,0,1,0
10,164,164,35,6,29,3,2
15,185,185,16,16,0,1,0
4,186,186,20,20,0,1,0
3,201,201,59,7,52,3,2
7,205,205,6,3,3,2,1
2,253,253,58,52,6,2,1
13,299,299,23,13,10,3,2
11,300,300,20,20,0,1,0
6,398,398,77,39,38,3,2
9,449,449,45,35,10,3,2
8,475,475,125,102,23,2,1

