24,101,101,3,3,0,1,0
27,102,102,1,1,0,1,0
17,109,109,1,1,0,1,0
5,115,115,18,18,0,1,0
40,124,124,19,5,14,2,1
3,128,128,2,2,0,1,0
38,143,143,47,32,15,4,3
41,144,144,6,3,3,2,1
20,155,155,5,5,0,1,0
6,162,162,4,4,0,1,0
21,163,163,36,15,21,4,3
33,171,171,17,8,9,4,3
9,185,185,1,1,0,1,0
23,189,189,3,3,0,1,0
12,196,196,1,1,0,1,0
25,198,198,39,32,7,2,1
29,198,198,40,40,0,1,0
1,204,204,14,8,6,3,2
30,206,206,45,1,44,4,3
18,218,218,43,43,0,1,0
32,229,229,30,30,0,1,0
2,246,246,41,4,37,2,1
26,250,250,30,13,17,2,1
4,274,274,21,1,20,2,1
7,287,287,44,20,24,3,2
31,313,313,30,30,0,1,0
19,323,323,53,14,39,4,3
22,341,341,9,9,0,1,0
10,350,350,45,17,28,2,1
15,360,360,114,33,81,4,3
0,393,393,21,21,0,1,0
36,397,397,20,20,0,1,0
14,406,406,1,1,0,1,0
8,422,422,20,8,12,3,2
35,438,438,22,10,12,3,2
13,457,457,29,29,0,1,0
16,459,459,3,3,0,1,0
39,465,465,24,24,0,1,0
34,476,476,7,1,6,2,1
37,478,478,94,6,88,3,2
28,491,491,11,11,0,1,0
11,494,494,45,17,28,2,1

22,109,109,1,1,0,1,0
19,138,138,14,14,0,1,0
33,140,140,56,49,7,2,1
20,152,152,13,3,10,3,2
30,157,157,22,22,0,1,0
43,171,171,7,7,0,1,0
1,171,171,19,19,0,1,0
7,174,174,1,1,0,1,0
11,191,191,44,6,38,3,2
39,211,211,28,28,0,1,0
21,212,212,9,9,0,1,0
41,220,220,33,14,19,4,3
42,241,241,1,1,0,1,0
16,247,247,10,6,4,2,1
36,247,247,92,80,12,3,2
18,256,256,23,23,0,1,0
34,258,258,7,7,0,1,0
26,280,280,4,4,0,1,0
8,292,292,36,36,0,1,0
17,299,299,25,25,0,1,0
28,314,314,10,4,6,2,1
0,320,320,20,2,18,2,1
15,323,323,9,9,0,1,0
37,327,327,52,52,0,1,0
40,377,377,2,2,0,1,0
25,382,382,1,1,0,1,0
38,387,387,21,21,0,1,0
29,391,391,24,16,8,2,1
2,399,399,7,7,0,1,0
10,400,400,111,111,0,1,0
32,403,403,102,16,86,3,2
12,407,407,33,33,0,1,0
35,410,410,29,3,26,2,1
27,416,416,27,27,0,1,0
31,417,417,20,20,0,1,0
5,418,418,124,91,33,2,1
4,427,427,68,32,36,4,3
13,439,439,7,7,0,1,0
9,455,455,20,20,0,1,0
23,475,475,10,10,0,1,0
14,488,488,15,7,8,3,2
24,490,490,3,3,0,1,0
6,492,492,18,18,0,1,0
3,499,499,4,1,3,2,1

29,109,109,15,15,0,1,0
16,110,110,5,5,0,1,0
28,121,121,10,10,0,1,0
37,125,125,8,4,4,2,1
15,146,146,6,6,0,1,0
31,154,154,34,34,0,1,0
2,164,164,5,5,0,1,0
30,177,177,11,3,8,3,2
14,178,178,62,62,0,1,0
3,191,191,2,2,0,1,0
38,199,199,54,21,33,3,2
8,206,206,28,28,0,1,0
22,214,214,49,49,0,1,0
36,222,222,8,8,0,1,0
1,234,234,63,51,12,2,1
7,253,253,1,1,0,1,0
35,293,293,3,3,0,1,0
0,304,304,2,2,0,1,0
18,318,318,10,5,5,2,1
32,332,332,20,20,0,1,0
13,336,336,45,36,9,4,3
25,344,344,4,4,0,1,0
19,345,345,11,11,0,1,0
5,356,356,44,44,0,1,0
33,358,358,3,3,0,1,0
4,359,359,34,8,26,2,1
9,374,374,21,21,0,1,0
27,394,394,62,54,8,3,2
24,396,396,61,25,36,4,3
11,416,416,21,3,18,2,1
26,445,445,81,74,7,2,1
21,452,452,7,7,0,1,0
6,462,462,14,2,12,4,3
20,473,473,20,20,0,1,0
10,476,476,196,130,66,3,2
12,477,477,9,9,0,1,0
17,482,482,76,62,14,2,1
23,491,491,100,12,88,3,2
34,500,500,33,5,28,4,3

8,125,125,16,1,15,4,3
26,131,131,30,18,12,2,1
27,133,133,1,1,0,1,0
14,141,141,9,9,0,1,0
12,142,142,6,6,0,1,0
30,149,149,46,35,11,2,1
16,152,152,5,5,0,1,0
9,153,153,6,6,0,1,0
1,165,165,14,14,0,1,0
13,165,165,11,11,0,1,0
23,172,172,42,2,40,3,2
42,189,189,12,12,0,1,0
21,209,209,1,1,0,1,0
5,218,218,11,6,5,2,1
15,226,226,22,4,18,2,1
36,234,234,55,28,27,2,1
32,253,253,6,6,0,1,0
43,297,297,40,31,9,2,1
10,303,303,70,20,50,2,1
11,313,313,29,29,0,1,0
20,322,322,58,58,0,1,0
0,336,336,20,5,15,4,3
22,340,340,1,1,0,1,0
35,340,340,32,15,17,2,1
37,342,342,71,71,0,1,0
38,350,350,19,19,0,1,0
24,368,368,37,34,3,2,1
3,370,370,2,2,0,1,0
2,384,384,33,33,0,1,0
44,391,391,12,3,9,2,1
41,407,407,19,3,16,3,2
25,412,412,37,37,0,1,0
31,418,418,16,1,15,4,3
6,425,425,6,3,3,2,1
7,439,439,17,3,14,3,2
40,452,452,74,33,41,4,3
33,460,460,14,4,10,2,1
28,468,468,85,85,0,1,0
18,469,469,22,22,0,1,0
34,480,480,38,38,0,1,0
39,480,480,1,1,0,1,0
17,486,486,108,57,51,4,3
4,488,488,31,31,0,1,0
19,494,494,1,1,0,1,0
29,495,495,7,7,0,1,0

10,131,131,36,14,22,4,3
1,135,135,5,5,0,1,0
9,148,148,1,1,0,1,0
24,157,157,41,41,0,1,0
19,174,174,15,2,13,4,3
26,176,176,30,30,0,1,0
5,186,186,28,20,8,3,2
38,193,193,26,26,0,1,0
3,197,197,1,1,0,1,0
8,204,204,2,2,0,1,0
15,207,207,6,6,0,1,0
22,215,215,9,4,5,2,1
17,228,228,20,2,18,2,1
32,230,230,30,9,21,4,3
23,246,246,21,7,14,3,2
16,256,256,32,32,0,1,0
7,259,259,35,26,9,4,3
37,262,262,1,1,0,1,0
21,265,265,17,17,0,1,0
36,266,266,59,8,51,4,3
34,279,279,29,29,0,1,0
11,289,289,54,54,0,1,0
14,310,310,65,21,44,2,1
4,314,314,32,18,14,2,1
33,316,316,52,52,0,1,0
29,319,319,2,2,0,1,0
28,334,334,15,15,0,1,0
31,335,335,12,4,8,2,1
6,336,336,17,7,10,3,2
18,348,348,9,9,0,1,0
30,409,409,65,2,63,4,3
13,421,421,51,51,0,1,0
2,422,422,84,11,73,3,2
27,437,437,24,24,0,1,0
20,443,443,99,99,0,1,0
0,446,446,44,41,3,2,1
35,462,462,5,5,0,1,0
25,470,470,17,17,0,1,0
12,472,472,69,41,28,2,1

19,115,115,7,7,0,1,0
13,121,121,1,1,0,1,0
33,130,130,37,29,8,2,1
39,132,132,11,8,3,2,1
16,143,143,50,14,36,4,3
15,146,146,5,5,0,1,0
12,149,149,6,6,0,1,0
26,151,151,12,12,0,1,0
29,161,161,19,7,12,2,1
24,169,169,16,16,0,1,0
10,183,183,16,5,11,2,1
32,183,183,4,4,0,1,0
2,187,187,3,3,0,1,0
18,191,191,16,1,15,2,1
9,219,219,32,25,7,2,1
11,229,229,43,4,39,4,3
34,233,233,10,10,0,1,0
5,238,238,37,37,0,1,0
20,256,256,26,26,0,1,0
6,258,258,1,1,0,1,0
3,276,276,31,1,30,3,2
27,294,294,6,6,0,1,0
40,306,306,69,46,23,2,1
36,319,319,13,9,4,2,1
4,330,330,56,56,0,1,0
17,350,350,66,10,56,4,3
38,356,356,32,8,24,3,2
23,360,360,1,1,0,1,0
7,364,364,8,8,0,1,0
25,370,370,33,21,12,3,2
1,376,376,2,2,0,1,0
31,387,387,4,1,3,2,1
30,390,390,134,86,48,2,1
28,406,406,9,9,0,1,0
37,412,412,4,4,0,1,0
8,428,428,43,17,26,2,1
21,435,435,30,30,0,1,0
22,438,438,149,50,99,4,3
0,444,444,30,8,22,2,1
14,473,473,29,29,0,1,0
35,499,499,23,23,0,1,0

30,100,100,28,28,0,1,0
22,101,101,4,4,0,1,0
11,107,107,23,1,22,3,2
13,107,107,24,14,10,2,1
33,150,150,7,7,0,1,0
12,157,157,13,7,6,3,2
5,158,158,1,1,0,1,0
9,163,163,9,4,5,2,1
8,171,171,30,30,0,1,0
10,178,178,67,67,0,1,0
39,193,193,3,3,0,1,0
17,204,204,22,8,14,2,1
28,219,219,1,1,0,1,0
2,220,220,18,18,0,1,0
4,222,222,5,5,0,1,0
7,230,230,1,1,0,1,0
24,249,249,43,43,0,1,0
29,274,274,1,1,0,1,0
14,306,306,89,59,30,3,2
25,310,310,17,17,0,1,0
21,319,319,14,14,0,1,0
20,326,326,12,12,0,1,0
3,341,341,13,13,0,1,0
34,343,343,14,2,12,2,1
19,355,355,1,1,0,1,0
15,380,380,68,68,0,1,0
32,383,383,9,1,8,2,1
36,385,385,84,78,6,2,1
27,388,388,34,6,28,3,2
35,395,395,37,22,15,4,3
26,409,409,34,13,21,2,1
38,438,438,231,150,81,4,3
31,441,441,1,1,0,1,0
16,443,443,31,8,23,2,1
6,455,455,11,11,0,1,0
18,460,460,4,4,0,1,0
1,481,481,16,16,0,1,0
37,487,487,39,39,0,1,0
23,490,490,92,92,0,1,0
0,491,491,1,1,0,1,0

18,128,128,6,3,3,2,1
35,129,129,20,20,0,1,0
21,140,140,6,6,0,1,0
25,145,145,13,3,10,2,1
19,153,153,10,10,0,1,0
23,161,161,11,11,0,1,0
32,171,171,3,3,0,1,0
24,176,176,27,18,9,2,1
20,185,185,31,31,0,1,0
9,196,196,2,2,0,1,0
4,198,198,15,2,13,2,1
2,213,213,23,2,21,2,1
7,216,216,8,8,0,1,0
11,220,220,14,14,0,1,0
29,231,231,37,37,0,1,0
34,232,232,13,13,0,1,0
33,250,250,18,18,0,1,0
12,293,293,10,3,7,2,1
15,294,294,20,20,0,1,0
22,295,295,7,1,6,2,1
26,304,304,6,2,4,2,1
27,305,305,31,5,26,4,3
38,312,312,41,41,0,1,0
17,319,319,56,2,54,4,3
8,345,345,20,20,0,1,0
0,361,361,35,35,0,1,0
6,367,367,97,97,0,1,0
40,375,375,22,10,12,2,1
5,377,377,11,1,10,3,2
10,378,378,33,23,10,3,2
1,380,380,39,23,16,2,1
30,386,386,5,5,0,1,0
39,415,415,121,22,99,4,3
31,418,418,20,20,0,1,0
36,425,425,80,80,0,1,0
16,436,436,168,60,108,4,3
3,460,460,28,8,20,3,2
14,465,465,5,5,0,1,0
28,471,471,112,91,21,4,3
13,499,499,28,16,12,2,1
37,500,500,53,19,34,3,2

0,106,106,9,9,0,1,0
17,108,108,2,2,0,1,0
15,108,108,6,6,0,1,0
3,138,138,22,12,10,3,2
37,139,139,5,1,4,2,1
27,152,152,10,1,9,4,3
29,160,160,12,12,0,1,0
8,170,170,25,1,24,2,1
10,175,175,1,1,0,1,0
13,178,178,36,36,0,1,0
44,190,190,14,3,11,2,1
5,191,191,28,28,0,1,0
28,199,199,12,3,9,4,3
40,201,201,66,40,26,2,1
43,210,210,24,15,9,4,3
21,226,226,10,10,0,1,0
18,231,231,6,6,0,1,0
36,241,241,71,71,0,1,0
25,245,245,16,16,0,1,0
30,252,252,77,33,44,2,1
12,259,259,33,33,0,1,0
45,261,261,2,2,0,1,0
4,267,267,11,5,6,2,1
11,270,270,3,3,0,1,0
33,282,282,9,1,8,3,2
24,313,313,2,2,0,1,0
35,322,322,26,26,0,1,0
2,339,339,4,4,0,1,0
26,349,349,2,2,0,1,0
34,358,358,33,33,0,1,0
7,358,358,62,57,5,2,1
14,367,367,4,1,3,2,1
41,370,370,32,11,21,4,3
32,422,422,72,15,57,4,3
6,431,431,42,42,0,1,0
16,445,445,46,46,0,1,0
9,448,448,12,3,9,2,1
1,454,454,36,36,0,1,0
20,465,465,19,10,9,2,1
42,465,465,28,13,15,2,1
22,465,465,92,92,0,1,0
39,467,467,5,5,0,1,0
23,470,470,14,14,0,1,0
19,477,477,42,42,0,1,0
31,483,483,16,8,8,3,2
38,484,484,50,43,7,2,1

19,101,101,11,11,0,1,0
32,101,101,11,11,0,1,0
28,110,110,13,13,0,1,0
34,133,133,13,13,0,1,0
37,136,136,12,12,0,1,0
15,144,144,37,11,26,3,2
36,145,145,64,12,52,3,2
23,161,161,1,1,0,1,0
4,166,166,1,1,0,1,0
7,167,167,13,1,12,4,3
8,186,186,1,1,0,1,0
9,199,199,42,42,0,1,0
14,205,205,14,14,0,1,0
0,206,206,40,5,35,3,2
1,219,219,13,13,0,1,0
33,235,235,75,15,60,4,3
5,256,256,40,40,0,1,0
20,256,256,1,1,0,1,0
16,258,258,1,1,0,1,0
27,264,264,39,31,8,3,2
12,269,269,42,42,0,1,0
17,288,288,17,17,0,1,0
18,306,306,22,22,0,1,0
22,337,337,17,17,0,1,0
26,356,356,4,4,0,1,0
35,357,357,9,5,4,2,1
21,364,364,13,4,9,4,3
24,366,366,12,5,7,2,1
31,372,372,16,16,0,1,0
6,374,374,67,39,28,3,2
11,393,393,49,49,0,1,0
30,415,415,59,59,0,1,0
3,432,432,141,141,0,1,0
29,437,437,77,77,0,1,0
25,444,444,4,4,0,1,0
10,457,457,1,1,0,1,0
2,462,462,5,5,0,1,0
13,497,497,52,52,0,1,0

35,101,101,19,19,0,1,0
22,116,116,2,2,0,1,0
13,118,118,1,1,0,1,0
43,121,121,12,9,3,2,1
45,123,123,3,3,0,1,0
37,141,141,4,4,0,1,0
32,148,148,48,48,0,1,0
24,151,151,16,8,8,2,1
44,159,159,29,4,25,2,1
1,164,164,10,10,0,1,0
34,170,170,13,13,0,1,0
0,185,185,10,4,6,3,2
28,194,194,9,9,0,1,0
33,198,198,1,1,0,1,0
25,215,215,24,24,0,1,0
20,216,216,41,4,37,2,1
8,228,228,30,16,14,3,2
14,242,242,8,3,5,2,1
46,242,242,23,23,0,1,0
39,261,261,87,75,12,2,1
10,266,266,6,6,0,1,0
42,268,268,17,9,8,3,2
29,268,268,4,4,0,1,0
15,276,276,7,7,0,1,0
5,295,295,1,1,0,1,0
47,309,309,34,11,23,3,2
18,314,314,5,1,4,2,1
38,324,324,7,7,0,1,0
9,334,334,1,1,0,1,0
26,335,335,8,8,0,1,0
12,361,361,25,5,20,2,1
19,378,378,9,3,6,2,1
23,388,388,13,7,6,2,1
16,398,398,156,59,97,4,3
11,403,403,5,1,4,2,1
7,406,406,1,1,0,1,0
17,408,408,18,18,0,1,0
41,411,411,55,55,0,1,0
48,411,411,14,2,12,2,1
2,419,419,20,10,10,2,1
4,428,428,103,25,78,4,3
27,428,428,3,3,0,1,0
3,433,433,25,10,15,4,3
36,444,444,15,5,10,3,2
30,449,449,36,36,0,1,0
40,452,452,21,21,0,1,0
31,455,455,31,31,0,1,0
6,458,458,25,4,21,2,1
49,461,461,44,8,36,3,2
21,484,484,72,72,0,1,0

18,106,106,14,6,8,2,1
7,110,110,15,15,0,1,0
30,114,114,3,3,0,1,0
25,126,126,10,1,9,4,3
1,141,141,37,37,0,1,0
21,154,154,11,11,0,1,0
3,170,170,6,6,0,1,0
13,177,177,9,9,0,1,0
41,183,183,19,16,3,2,1
14,184,184,5,2,3,2,1
10,184,184,4,4,0,1,0
39,187,187,18,18,0,1,0
12,194,194,4,1,3,2,1
35,196,196,24,24,0,1,0
2,203,203,15,2,13,2,1
34,215,215,43,43,0,1,0
15,221,221,18,18,0,1,0
31,245,245,29,16,13,2,1
20,246,246,22,22,0,1,0
37,254,254,10,10,0,1,0
11,264,264,54,16,38,2,1
9,266,266,1,1,0,1,0
28,285,285,45,45,0,1,0
5,300,300,11,4,7,2,1
38,303,303,7,7,0,1,0
27,306,306,9,4,5,2,1
17,311,311,26,18,8,3,2
6,320,320,4,4,0,1,0
4,363,363,94,14,80,3,2
0,389,389,16,12,4,2,1
32,395,395,42,42,0,1,0
24,396,396,46,10,36,3,2
8,414,414,52,52,0,1,0
19,416,416,34,34,0,1,0
42,440,440,27,14,13,2,1
40,441,441,45,45,0,1,0
22,453,453,66,66,0,1,0
33,455,455,93,29,64,4,3
16,466,466,2,2,0,1,0
29,473,473,22,22,0,1,0
36,477,477,52,11,41,2,1
23,478,478,74,74,0,1,0
26,484,484,64,24,40,2,1

24,101,101,5,1,4,2,1
47,109,109,10,10,0,1,0
30,115,115,3,3,0,1,0
34,118,118,1,1,0,1,0
22,119,119,1,1,0,1,0
21,135,135,2,2,0,1,0
5,165,165,85,37,48,2,1
14,165,165,3,3,0,1,0
0,166,166,6,2,4,2,1
42,178,178,2,2,0,1,0
45,183,183,23,5,18,4,3
23,189,189,1,1,0,1,0
1,210,210,1,1,0,1,0
48,236,236,27,27,0,1,0
15,245,245,20,4,16,3,2
36,246,246,74,30,44,2,1
33,251,251,16,4,12,2,1
35,262,262,35,5,30,3,2
9,268,268,23,23,0,1,0
40,275,275,71,11,60,4,3
41,289,289,1,1,0,1,0
10,302,302,8,8,0,1,0
7,303,303,31,7,24,3,2
3,303,303,30,30,0,1,0
31,305,305,22,4,18,3,2
6,308,308,22,22,0,1,0
38,324,324,45,29,16,2,1
44,325,325,28,13,15,2,1
20,344,344,27,13,14,3,2
39,347,347,31,31,0,1,0
26,348,348,5,5,0,1,0
12,348,348,10,2,8,2,1
28,350,350,24,24,0,1,0
25,350,350,23,23,0,1,0
29,356,356,1,1,0,1,0
37,365,365,23,1,22,3,2
46,369,369,22,7,15,3,2
17,373,373,22,22,0,1,0
43,392,392,44,15,29,2,1
19,394,394,6,2,4,2,1
8,398,398,4,4,0,1,0
11,410,410,57,57,0,1,0
27,426,426,6,6,0,1,0
18,437,437,112,10,102,4,3
32,439,439,128,108,20,2,1
4,454,454,8,8,0,1,0
13,480,480,21,7,14,2,1
2,481,481,19,19,0,1,0
16,492,492,16,2,14,3,2

35,126,126,2,2,0,1,0
11,127,127,2,2,0,1,0
41,129,129,1,1,0,1,0
19,132,132,8,8,0,1,0
4,140,140,17,13,4,2,1
29,140,140,2,2,0,1,0
34,141,141,25,1,24,3,2
40,154,154,9,2,7,2,1
7,155,155,8,8,0,1,0
44,171,171,42,42,0,1,0
17,186,186,3,3,0,1,0
9,189,189,19,7,12,3,2
5,194,194,25,25,0,1,0
10,203,203,10,1,9,4,3
26,208,208,17,3,14,2,1
15,209,209,21,8,13,2,1
39,214,214,15,15,0,1,0
30,231,231,34,25,9,4,3
23,231,231,40,34,6,3,2
13,237,237,106,97,9,2,1
28,279,279,66,24,42,4,3
25,282,282,69,17,52,3,2
37,292,292,10,10,0,1,0
36,305,305,20,9,11,2,1
27,305,305,64,28,36,3,2
20,313,313,20,8,12,3,2
38,331,331,32,5,27,4,3
42,337,337,16,3,13,4,3
3,345,345,21,21,0,1,0
12,346,346,45,45,0,1,0
1,357,357,46,46,0,1,0
6,367,367,10,7,3,2,1
14,390,390,6,6,0,1,0
33,395,395,34,34,0,1,0
22,401,401,27,12,15,2,1
32,406,406,6,6,0,1,0
2,410,410,19,11,8,2,1
24,410,410,27,15,12,3,2
8,438,438,13,13,0,1,0
18,442,442,3,3,0,1,0
43,452,452,35,35,0,1,0
0,460,460,16,1,15,2,1
16,463,463,8,4,4,2,1
21,475,475,20,4,16,3,2
31,476,476,55,13,42,2,1

30,114,114,1,1,0,1,0
19,130,130,17,6,11,2,1
10,132,132,18,18,0,1,0
11,206,206,39,39,0,1,0
32,217,217,28,28,0,1,0
15,228,228,16,16,0,1,0
17,237,237,15,15,0,1,0
4,240,240,82,82,0,1,0
7,247,247,10,10,0,1,0
8,259,259,6,1,5,2,1
2,260,260,88,88,0,1,0
34,266,266,2,2,0,1,0
26,267,267,19,19,0,1,0
22,273,273,32,32,0,1,0
31,287,287,16,16,0,1,0
23,291,291,62,11,51,4,3
20,293,293,40,30,10,2,1
29,299,299,107,53,54,4,3
28,305,305,1,1,0,1,0
18,312,312,15,15,0,1,0
24,315,315,87,2,85,4,3
1,323,323,129,61,68,3,2
14,357,357,26,2,24,3,2
12,400,400,7,7,0,1,0
16,406,406,37,37,0,1,0
27,409,409,8,2,6,3,2
33,418,418,73,73,0,1,0
0,421,421,38,32,6,2,1
25,455,455,22,22,0,1,0
21,456,456,7,7,0,1,0
3,465,465,75,19,56,3,2
9,470,470,4,1,3,2,1
13,471,471,53,21,32,3,2
6,479,479,1,1,0,1,0
5,494,494,33,33,0,1,0

10,102,102,23,9,14,3,2
19,113,113,10,10,0,1,0
26,119,119,10,4,6,3,2
28,121,121,3,3,0,1,0
31,126,126,17,7,10,2,1
7,131,131,3,3,0,1,0
5,140,140,2,2,0,1,0
16,150,150,2,2,0,1,0
35,156,156,1,1,0,1,0
4,159,159,40,40,0,1,0
0,173,173,23,23,0,1,0
12,185,185,13,7,6,2,1
30,185,185,1,1,0,1,0
6,186,186,10,10,0,1,0
29,196,196,12,12,0,1,0
9,202,202,14,14,0,1,0
25,217,217,61,61,0,1,0
36,225,225,57,57,0,1,0
33,258,258,89,19,70,4,3
24,276,276,54,54,0,1,0
13,297,297,42,42,0,1,0
11,305,305,17,8,9,2,1
17,306,306,16,1,15,4,3
20,331,331,64,10,54,4,3
2,344,344,44,44,0,1,0
14,350,350,83,83,0,1,0
21,362,362,38,38,0,1,0
34,367,367,1,1,0,1,0
15,373,373,20,11,9,4,3
3,385,385,26,26,0,1,0
22,398,398,30,30,0,1,0
23,420,420,18,18,0,1,0
8,423,423,100,8,92,3,2
27,430,430,14,9,5,2,1
1,481,481,111,87,24,2,1
32,483,483,3,3,0,1,0
18,488,488,29,9,20,2,1

11,116,116,28,28,0,1,0
4,120,120,15,15,0,1,0
24,120,120,4,4,0,1,0
28,133,133,4,4,0,1,0
1,158,158,19,6,13,2,1
34,178,178,2,2,0,1,0
15,196,196,3,3,0,1,0
5,218,218,30,6,24,3,2
20,224,224,4,4,0,1,0
12,228,228,9,9,0,1,0
14,230,230,44,17,27,4,3
26,241,241,31,31,0,1,0
17,269,269,51,51,0,1,0
6,279,279,31,17,14,2,1
13,282,282,89,11,78,3,2
23,290,290,89,3,86,4,3
21,292,292,15,15,0,1,0
22,302,302,92,73,19,4,3
25,302,302,90,90,0,1,0
27,307,307,20,4,16,3,2
30,319,319,33,15,18,3,2
16,331,331,73,73,0,1,0
9,347,347,65,65,0,1,0
8,350,350,44,26,18,4,3
29,359,359,47,47,0,1,0
10,359,359,21,15,6,2,1
31,367,367,10,10,0,1,0
7,374,374,8,4,4,2,1
19,377,377,33,33,0,1,0
32,420,420,2,2,0,1,0
33,422,422,4,4,0,1,0
2,444,444,91,52,39,2,1
3,448,448,2,2,0,1,0
0,471,471,56,56,0,1,0
18,488,488,1,1,0,1,0

10,100,100,1,1,0,1,0
16,101,101,1,1,0,1,0
23,114,114,17,17,0,1,0
21,150,150,55,41,14,2,1
22,155,155,13,13,0,1,0
14,165,165,12,6,6,3,2
0,186,186,53,53,0,1,0
20,192,192,7,7,0,1,0
32,193,193,10,4,6,2,1
7,201,201,43,29,14,3,2
6,234,234,11,2,9,3,2
26,254,254,9,9,0,1,0
9,269,269,33,17,16,3,2
30,279,279,30,9,21,4,3
17,282,282,29,29,0,1,0
15,293,293,2,2,0,1,0
12,301,301,4,4,0,1,0
5,340,340,3,3,0,1,0
11,348,348,35,7,28,3,2
4,351,351,1,1,0,1,0
33,356,356,1,1,0,1,0
28,358,358,93,93,0,1,0
29,360,360,58,58,0,1,0
34,363,363,20,9,11,2,1
18,368,368,38,38,0,1,0
24,392,392,88,70,18,4,3
13,400,400,306,306,0,1,0
31,407,407,25,25,0,1,0
19,410,410,33,18,15,4,3
1,424,424,16,16,0,1,0
27,424,424,39,5,34,3,2
3,449,449,42,42,0,1,0
8,468,468,52,52,0,1,0
25,480,480,24,2,22,2,1
2,496,496,58,58,0,1,0

14,118,118,5,5,0,1,0
18,121,121,11,11,0,1,0
28,122,122,19,19,0,1,0
39,137,137,2,2,0,1,0
11,142,142,1,1,0,1,0
32,143,143,44,4,40,3,2
24,148,148,14,3,11,2,1
36,162,162,12,12,0,1,0
12,174,174,34,34,0,1,0
16,193,193,17,17,0,1,0
31,196,196,3,3,0,1,0
22,208,208,11,11,0,1,0
17,213,213,19,19,0,1,0
41,258,258,29,9,20,3,2
6,263,263,46,10,36,3,2
27,267,267,14,5,9,4,3
37,270,270,35,35,0,1,0
13,273,273,11,11,0,1,0
9,281,281,73,73,0,1,0
10,286,286,11,11,0,1,0
21,296,296,8,2,6,3,2
2,303,303,33,33,0,1,0
38,312,312,54,54,0,1,0
20,312,312,36,2,34,4,3
30,328,328,80,80,0,1,0
5,338,338,2,2,0,1,0
26,341,341,25,12,13,2,1
40,354,354,34,34,0,1,0
29,355,355,61,52,9,4,3
35,392,392,32,17,15,2,1
7,409,409,10,10,0,1,0
19,411,411,74,14,60,3,2
4,411,411,15,15,0,1,0
0,423,423,41,4,37,4,3
34,425,425,13,1,12,4,3
33,430,430,4,4,0,1,0
1,450,450,7,7,0,1,0
23,452,452,39,14,25,4,3
3,454,454,51,19,32,4,3
15,471,471,33,21,12,4,3
8,475,475,87,50,37,2,1
25,494,494,34,34,0,1,0

15,105,105,1,1,0,1,0
24,129,129,2,2,0,1,0
3,157,157,1,1,0,1,0
10,158,158,6,6,0,1,0
11,161,161,2,2,0,1,0
14,183,183,46,46,0,1,0
2,195,195,11,1,10,3,2
37,203,203,28,22,6,3,2
21,209,209,1,1,0,1,0
17,209,209,18,18,0,1,0
42,213,213,10,10,0,1,0
31,216,216,58,53,5,2,1
40,241,241,38,38,0,1,0
8,245,245,11,11,0,1,0
7,246,246,3,3,0,1,0
36,251,251,15,15,0,1,0
6,252,252,3,3,0,1,0
12,270,270,9,9,0,1,0
20,270,270,27,12,15,2,1
23,285,285,45,27,18,4,3
16,292,292,11,11,0,1,0
29,294,294,28,28,0,1,0
1,301,301,23,23,0,1,0
39,307,307,2,2,0,1,0
26,308,308,25,25,0,1,0
9,315,315,117,68,49,2,1
30,326,326,49,49,0,1,0
32,333,333,18,8,10,2,1
41,353,353,75,75,0,1,0
34,360,360,62,62,0,1,0
27,391,391,10,10,0,1,0
4,391,391,171,98,73,4,3
18,394,394,12,12,0,1,0
33,400,400,79,59,20,2,1
5,417,417,25,18,7,2,1
13,431,431,1,1,0,1,0
28,440,440,25,22,3,2,1
22,448,448,7,7,0,1,0
0,448,448,34,34,0,1,0
19,457,457,104,104,0,1,0
38,485,485,7,7,0,1,0
35,493,493,51,33,18,4,3
25,499,499,13,1,12,3,2

7,102,102,12,1,11,2,1
6,106,106,1,1,0,1,0
37,108,108,18,18,0,1,0
31,114,114,13,13,0,1,0
40,122,122,4,4,0,1,0
0,126,126,8,4,4,2,1
29,136,136,36,36,0,1,0
2,142,142,14,2,12,3,2
33,171,171,18,18,0,1,0
3,196,196,7,7,0,1,0
20,197,197,17,5,12,4,3
34,212,212,27,27,0,1,0
19,239,239,61,15,46,2,1
32,240,240,2,2,0,1,0
24,242,242,5,1,4,2,1
8,244,244,94,94,0,1,0
23,254,254,22,7,15,4,3
35,264,264,13,3,10,3,2
16,270,270,25,2,23,2,1
15,272,272,5,5,0,1,0
1,272,272,13,7,6,2,1
30,284,284,6,6,0,1,0
21,289,289,20,20,0,1,0
4,289,289,9,9,0,1,0
14,305,305,27,3,24,2,1
18,321,321,62,62,0,1,0
12,355,355,32,6,26,3,2
5,355,355,15,2,13,2,1
39,367,367,49,11,38,2,1
22,389,389,76,34,42,2,1
25,391,391,2,2,0,1,0
17,407,407,39,39,0,1,0
13,410,410,20,20,0,1,0
36,424,424,103,47,56,3,2
26,433,433,103,92,11,2,1
38,439,439,10,10,0,1,0
11,456,456,24,9,15,4,3
9,474,474,29,29,0,1,0
27,476,476,5,1,4,2,1
28,488,488,63,35,28,2,1
10,500,500,43,43,0,1,0

11,121,121,7,3,4,2,1
14,123,123,4,1,3,2,1
26,130,130,8,8,0,1,0
4,130,130,3,3,0,1,0
7,141,141,1,1,0,1,0
41,182,182,44,3,41,2,1
39,182,182,6,6,0,1,0
1,189,189,1,1,0,1,0
18,192,192,1,1,0,1,0
17,198,198,16,9,7,2,1
20,209,209,9,1,8,2,1
21,218,218,3,3,0,1,0
24,219,219,62,44,18,4,3
27,228,228,67,67,0,1,0
32,231,231,11,11,0,1,0
23,241,241,2,2,0,1,0
2,283,283,74,74,0,1,0
40,285,285,4,4,0,1,0
3,293,293,5,1,4,2,1
8,302,302,12,12,0,1,0
13,314,314,109,109,0,1,0
34,329,329,6,1,5,2,1
29,331,331,31,23,8,3,2
12,340,340,11,3,8,2,1
9,345,345,18,2,16,3,2
38,355,355,24,24,0,1,0
30,374,374,1,1,0,1,0
37,376,376,34,30,4,2,1
31,377,377,27,7,20,4,3
22,381,381,112,112,0,1,0
5,387,387,32,32,0,1,0
19,391,391,25,18,7,2,1
33,409,409,29,29,0,1,0
25,418,418,13,3,10,2,1
28,421,421,14,2,12,4,3
10,425,425,214,214,0,1,0
16,448,448,92,62,30,3,2
6,449,449,3,3,0,1,0
0,454,454,15,15,0,1,0
36,466,466,98,32,66,3,2
35,470,470,28,14,14,3,2
15,490,490,44,35,9,2,1

26,127,127,14,14,0,1,0
35,141,141,21,21,0,1,0
3,143,143,2,2,0,1,0
8,152,152,4,4,0,1,0
5,156,156,44,44,0,1,0
39,166,166,3,3,0,1,0
18,167,167,9,9,0,1,0
16,176,176,11,11,0,1,0
19,187,187,17,17,0,1,0
30,195,195,3,3,0,1,0
23,199,199,50,50,0,1,0
17,208,208,32,11,21,2,1
24,208,208,46,9,37,2,1
13,213,213,10,2,8,2,1
33,217,217,34,34,0,1,0
22,240,240,107,79,28,3,2
11,242,242,21,7,14,3,2
36,243,243,9,9,0,1,0
29,259,259,14,2,12,4,3
0,270,270,21,15,6,2,1
20,272,272,15,15,0,1,0
38,273,273,42,42,0,1,0
15,280,280,23,23,0,1,0
12,289,289,17,17,0,1,0
27,296,296,12,5,7,2,1
25,324,324,1,1,0,1,0
6,339,339,56,56,0,1,0
9,347,347,17,5,12,2,1
31,350,350,18,18,0,1,0
7,360,360,49,21,28,4,3
1,367,367,74,74,0,1,0
34,386,386,15,3,12,2,1
4,397,397,2,2,0,1,0
28,399,399,37,10,27,2,1
2,421,421,18,18,0,1,0
37,426,426,17,13,4,2,1
32,442,442,43,43,0,1,0
21,473,473,6,6,0,1,0
14,480,480,14,5,9,4,3
10,498,498,168,148,20,2,1

29,100,100,11,11,0,1,0
36,107,107,9,9,0,1,0
23,122,122,2,2,0,1,0
27,122,122,24,24,0,1,0
38,131,131,2,2,0,1,0
16,136,136,7,7,0,1,0
2,152,152,6,6,0,1,0
20,161,161,22,22,0,1,0
8,165,165,27,9,18,3,2
1,167,167,8,2,6,3,2
10,169,169,5,1,4,2,1
22,198,198,9,5,4,2,1
32,198,198,29,12,17,2,1
12,201,201,12,12,0,1,0
37,210,210,9,9,0,1,0
44,212,212,9,9,0,1,0
19,213,213,16,16,0,1,0
5,238,238,9,2,7,2,1
7,244,244,16,12,4,2,1
45,249,249,7,7,0,1,0
15,272,272,6,6,0,1,0
34,282,282,18,10,8,3,2
39,289,289,39,9,30,2,1
35,292,292,46,46,0,1,0
0,294,294,1,1,0,1,0
11,349,349,18,18,0,1,0
18,352,352,8,2,6,3,2
41,352,352,98,14,84,3,2
24,368,368,41,41,0,1,0
43,370,370,46,1,45,4,3
40,386,386,1,1,0,1,0
31,392,392,67,67,0,1,0
14,405,405,13,4,9,4,3
9,406,406,18,4,14,2,1
42,419,419,50,2,48,3,2
25,420,420,5,5,0,1,0
21,425,425,2,2,0,1,0
4,430,430,155,146,9,2,1
17,443,443,15,15,0,1,0
30,447,447,52,42,10,3,2
6,449,449,96,96,0,1,0
13,460,460,35,14,21,4,3
28,464,464,18,6,12,3,2
26,477,477,2,2,0,1,0
33,480,480,81,50,31,2,1
3,486,486,119,83,36,2,1

10,105,105,9,9,0,1,0
30,109,109,7,7,0,1,0
17,110,110,12,6,6,2,1
16,134,134,26,26,0,1,0
12,135,135,32,4,28,3,2
3,149,149,47,33,14,3,2
33,151,151,19,19,0,1,0
25,167,167,12,4,8,2,1
35,174,174,9,9,0,1,0
2,177,177,5,5,0,1,0
23,186,186,6,6,0,1,0
1,196,196,5,5,0,1,0
37,198,198,21,5,16,3,2
6,209,209,4,4,0,1,0
13,215,215,46,46,0,1,0
9,223,223,12,12,0,1,0
15,225,225,3,3,0,1,0
26,242,242,5,5,0,1,0
19,243,243,122,103,19,2,1
29,244,244,1,1,0,1,0
31,273,273,70,7,63,4,3
21,276,276,9,4,5,2,1
11,285,285,29,29,0,1,0
22,318,318,76,2,74,3,2
34,326,326,20,15,5,2,1
7,335,335,36,28,8,3,2
24,341,341,14,3,11,2,1
36,348,348,13,5,8,3,2
4,352,352,36,27,9,4,3
0,353,353,38,11,27,2,1
28,362,362,11,2,9,4,3
27,383,383,99,54,45,4,3
18,387,387,10,10,0,1,0
20,405,405,6,6,0,1,0
8,412,412,2,2,0,1,0
5,442,442,33,15,18,3,2
14,465,465,100,54,46,2,1
32,482,482,29,29,0,1,0

7,114,114,10,10,0,1,0
21,123,123,4,4,0,1,0
30,125,125,24,24,0,1,0
5,132,132,14,14,0,1,0
0,133,133,38,38,0,1,0
16,142,142,54,54,0,1,0
19,146,146,6,6,0,1,0
22,159,159,12,12,0,1,0
8,166,166,21,17,4,2,1
10,168,168,18,18,0,1,0
18,183,183,18,18,0,1,0
1,189,189,19,19,0,1,0
11,197,197,31,31,0,1,0
9,214,214,114,114,0,1,0
4,215,215,4,4,0,1,0
17,243,243,5,1,4,2,1
29,328,328,19,10,9,2,1
2,353,353,21,21,0,1,0
26,389,389,54,24,30,3,2
23,399,399,25,25,0,1,0
28,413,413,79,79,0,1,0
12,417,417,82,34,48,3,2
27,429,429,21,6,15,4,3
24,433,433,2,2,0,1,0
13,449,449,50,8,42,4,3
25,449,449,7,1,6,3,2
15,457,457,20,20,0,1,0
20,458,458,48,28,20,2,1
14,462,462,49,49,0,1,0
3,481,481,127,127,0,1,0
6,493,493,76,46,30,4,3
31,496,496,64,30,34,3,2

6,119,119,20,20,0,1,0
44,130,130,2,2,0,1,0
22,149,149,16,16,0,1,0
20,150,150,1,1,0,1,0
42,153,153,17,17,0,1,0
39,160,160,35,1,34,2,1
9,164,164,12,12,0,1,0
31,170,170,3,3,0,1,0
43,180,180,3,3,0,1,0
38,209,209,4,1,3,2,1
15,213,213,21,21,0,1,0
8,218,218,26,26,0,1,0
2,246,246,11,11,0,1,0
14,252,252,23,23,0,1,0
21,275,275,50,50,0,1,0
32,275,275,56,56,0,1,0
26,295,295,12,3,9,4,3
12,310,310,33,12,21,4,3
41,312,312,26,11,15,2,1
11,314,314,4,4,0,1,0
7,327,327,14,14,0,1,0
35,337,337,21,21,0,1,0
24,338,338,56,35,21,4,3
25,345,345,98,22,76,3,2
40,347,347,18,18,0,1,0
10,348,348,67,67,0,1,0
5,349,349,8,5,3,2,1
1,352,352,21,6,15,2,1
23,352,352,13,10,3,2,1
19,353,353,35,20,15,4,3
17,356,356,23,23,0,1,0
27,356,356,4,4,0,1,0
4,370,370,34,17,17,2,1
18,375,375,36,27,9,4,3
33,384,384,69,69,0,1,0
3,408,408,12,12,0,1,0
37,423,423,12,12,0,1,0
16,429,429,15,10,5,2,1
36,431,431,60,18,42,3,2
0,435,435,22,22,0,1,0
28,444,444,128,84,44,2,1
30,450,450,103,13,90,4,3
34,452,452,5,5,0,1,0
29,469,469,11,5,6,2,1
13,470,470,2,2,0,1,0

12,100,100,4,4,0,1,0
32,119,119,7,7,0,1,0
28,120,120,11,5,6,2,1
5,121,121,48,48,0,1,0
34,126,126,11,5,6,2,1
38,133,133,16,16,0,1,0
1,142,142,14,14,0,1,0
27,153,153,21,6,15,2,1
33,155,155,79,7,72,4,3
26,171,171,18,1,17,2,1
19,182,182,15,15,0,1,0
16,184,184,3,3,0,1,0
22,185,185,33,33,0,1,0
25,187,187,6,1,5,2,1
4,190,190,20,6,14,3,2
31,200,200,16,16,0,1,0
20,207,207,5,5,0,1,0
35,216,216,8,8,0,1,0
39,222,222,2,2,0,1,0
11,232,232,1,1,0,1,0
13,238,238,1,1,0,1,0
2,238,238,10,3,7,2,1
21,241,241,11,11,0,1,0
14,261,261,23,19,4,2,1
36,273,273,9,9,0,1,0
23,296,296,50,50,0,1,0
17,299,299,45,12,33,2,1
10,324,324,6,6,0,1,0
24,340,340,78,3,75,4,3
29,375,375,21,4,17,2,1
18,375,375,89,72,17,2,1
6,389,389,70,44,26,3,2
30,423,423,12,2,10,3,2
7,437,437,38,32,6,3,2
37,439,439,11,1,10,3,2
3,446,446,8,2,6,2,1
15,448,448,47,14,33,2,1
8,458,458,64,64,0,1,0
0,462,462,1,1,0,1,0
9,468,468,77,47,30,4,3
40,476,476,4,4,0,1,0

35,133,133,3,3,0,1,0
7,134,134,4,1,3,2,1
36,150,150,25,25,0,1,0
40,159,159,23,3,20,3,2
2,177,177,46,22,24,2,1
28,177,177,1,1,0,1,0
8,220,220,18,4,14,2,1
11,222,222,7,4,3,2,1
21,229,229,13,13,0,1,0
13,235,235,14,14,0,1,0
1,240,240,69,69,0,1,0
26,240,240,3,3,0,1,0
29,242,242,11,11,0,1,0
27,247,247,5,5,0,1,0
39,250,250,73,15,58,3,2
34,274,274,77,43,34,2,1
23,289,289,11,11,0,1,0
14,294,294,10,10,0,1,0
31,294,294,9,9,0,1,0
25,296,296,6,6,0,1,0
33,298,298,28,28,0,1,0
24,315,315,20,7,13,2,1
37,324,324,18,3,15,4,3
19,342,342,146,113,33,2,1
16,345,345,2,2,0,1,0
9,345,345,51,51,0,1,0
32,356,356,32,32,0,1,0
15,367,367,11,11,0,1,0
18,372,372,24,12,12,4,3
0,399,399,4,1,3,2,1
3,406,406,70,37,33,2,1
5,410,410,27,27,0,1,0
17,417,417,12,12,0,1,0
20,420,420,52,52,0,1,0
12,427,427,2,2,0,1,0
30,429,429,37,11,26,2,1
22,458,458,222,114,108,4,3
4,466,466,3,3,0,1,0
6,483,483,12,12,0,1,0
38,486,486,32,18,14,3,2
41,493,493,13,8,5,2,1
10,495,495,25,25,0,1,0

36,105,105,4,4,0,1,0
8,120,120,4,1,3,2,1
34,124,124,13,13,0,1,0
2,129,129,13,4,9,2,1
14,133,133,57,57,0,1,0
33,142,142,18,5,13,2,1
13,145,145,31,1,30,3,2
20,158,158,14,4,10,3,2
5,169,169,1,1,0,1,0
15,181,181,4,4,0,1,0
11,183,183,4,1,3,2,1
19,217,217,6,6,0,1,0
4,219,219,12,1,11,3,2
6,231,231,1,1,0,1,0
27,234,234,54,38,16,3,2
16,243,243,80,32,48,2,1
0,245,245,1,1,0,1,0
26,251,251,3,3,0,1,0
12,264,264,5,5,0,1,0
22,286,286,38,38,0,1,0
17,293,293,31,31,0,1,0
7,302,302,1,1,0,1,0
9,303,303,44,44,0,1,0
31,319,319,50,14,36,2,1
32,331,331,113,101,12,3,2
23,346,346,45,18,27,4,3
35,358,358,12,2,10,2,1
10,393,393,123,80,43,2,1
21,393,393,16,10,6,2,1
18,403,403,41,5,36,4,3
24,428,428,52,52,0,1,0
1,438,438,91,17,74,4,3
3,441,441,42,42,0,1,0
25,461,461,10,10,0,1,0
29,471,471,38,38,0,1,0
28,472,472,3,3,0,1,0
30,487,487,68,68,0,1,0

15,149,149,28,5,23,2,1
28,154,154,8,2,6,3,2
2,166,166,2,2,0,1,0
12,186,186,36,24,12,3,2
14,189,189,47,14,33,2,1
21,204,204,17,5,12,2,1
7,209,209,20,20,0,1,0
25,215,215,20,3,17,2,1
29,243,243,1,1,0,1,0
26,270,270,23,8,15,2,1
31,281,281,28,10,18,2,1
30,282,282,20,20,0,1,0
5,298,298,51,30,21,4,3
3,316,316,5,5,0,1,0
22,337,337,131,131,0,1,0
13,339,339,28,6,22,2,1
6,358,358,50,15,35,4,3
20,361,361,54,14,40,2,1
19,364,364,34,25,9,2,1
10,422,422,89,89,0,1,0
9,426,426,60,60,0,1,0
16,437,437,27,27,0,1,0
24,459,459,7,7,0,1,0
4,473,473,154,116,38,2,1
27,473,473,3,3,0,1,0
23,475,475,3,3,0,1,0
18,476,476,52,52,0,1,0
8,486,486,108,88,20,3,2
17,489,489,1,1,0,1,0
1,492,492,16,3,13,2,1
0,494,494,14,4,10,3,2
11,498,498,302,291,11,4,3

6,100,100,9,9,0,1,0
43,109,109,18,10,8,3,2
22,115,115,16,2,14,3,2
38,125,125,53,29,24,3,2
41,128,128,11,3,8,3,2
44,130,130,7,7,0,1,0
16,130,130,26,18,8,2,1
8,172,172,1,1,0,1,0
25,172,172,15,15,0,1,0
0,189,189,1,1,0,1,0
24,191,191,5,2,3,2,1
29,199,199,1,1,0,1,0
42,209,209,15,15,0,1,0
23,229,229,10,4,6,2,1
28,230,230,46,36,10,2,1
11,239,239,9,9,0,1,0
33,239,239,3,3,0,1,0
13,262,262,2,2,0,1,0
36,280,280,19,19,0,1,0
21,286,286,11,8,3,2,1
20,304,304,37,1,36,2,1
32,306,306,12,12,0,1,0
27,325,325,30,5,25,2,1
15,346,346,35,3,32,3,2
30,358,358,50,50,0,1,0
45,362,362,2,2,0,1,0
9,378,378,38,6,32,2,1
7,379,379,20,20,0,1,0
1,381,381,45,10,35,2,1
37,381,381,60,6,54,4,3
12,391,391,1,1,0,1,0
3,398,398,36,36,0,1,0
31,399,399,13,1,12,3,2
14,404,404,120,90,30,2,1
10,414,414,14,2,12,4,3
17,427,427,23,1,22,2,1
35,434,434,6,6,0,1,0
39,442,442,5,5,0,1,0
18,452,452,54,54,0,1,0
4,452,452,13,4,9,2,1
2,457,457,45,45,0,1,0
5,462,462,3,3,0,1,0
34,466,466,196,196,0,1,0
26,477,477,8,1,7,2,1
40,490,490,17,7,10,3,2
19,499,499,48,48,0,1,0

14,100,100,3,3,0,1,0
36,104,104,9,9,0,1,0
20,149,149,24,21,3,2,1
29,163,163,36,36,0,1,0
28,167,167,4,4,0,1,0
23,167,167,22,22,0,1,0
35,171,171,21,1,20,3,2
4,188,188,40,40,0,1,0
7,196,196,8,8,0,1,0
16,198,198,7,7,0,1,0
25,213,213,26,1,25,2,1
22,221,221,1,1,0,1,0
0,222,222,66,6,60,4,3
9,230,230,33,33,0,1,0
12,231,231,46,46,0,1,0
15,236,236,73,55,18,4,3
1,239,239,11,4,7,2,1
18,241,241,46,2,44,4,3
32,241,241,23,23,0,1,0
27,246,246,38,12,26,2,1
11,280,280,5,5,0,1,0
8,289,289,17,17,0,1,0
3,293,293,15,6,9,4,3
34,298,298,13,13,0,1,0
17,305,305,50,29,21,4,3
6,308,308,88,14,74,4,3
19,313,313,4,4,0,1,0
31,316,316,23,20,3,2,1
26,325,325,35,35,0,1,0
24,344,344,7,7,0,1,0
33,350,350,63,9,54,3,2
13,378,378,6,6,0,1,0
21,385,385,40,40,0,1,0
30,400,400,7,1,6,3,2
2,447,447,59,15,44,3,2
10,451,451,30,30,0,1,0
5,480,480,30,12,18,4,3

42,109,109,6,2,4,2,1
11,113,113,6,6,0,1,0
36,114,114,7,3,4,2,1
37,146,146,65,65,0,1,0
9,151,151,4,4,0,1,0
24,154,154,20,11,9,4,3
1,157,157,7,1,6,2,1
23,161,161,11,3,8,3,2
13,176,176,6,6,0,1,0
10,189,189,6,6,0,1,0
20,210,210,1,1,0,1,0
6,211,211,35,20,15,2,1
41,215,215,21,2,19,2,1
26,218,218,40,16,24,2,1
0,228,228,2,2,0,1,0
33,241,241,34,4,30,4,3
27,255,255,4,4,0,1,0
16,258,258,37,37,0,1,0
38,266,266,72,39,33,4,3
15,276,276,8,3,5,2,1
31,289,289,11,1,10,2,1
39,290,290,45,45,0,1,0
18,316,316,46,46,0,1,0
40,331,331,54,10,44,2,1
32,337,337,17,8,9,4,3
44,339,339,41,41,0,1,0
17,340,340,72,72,0,1,0
28,356,356,23,19,4,2,1
12,363,363,40,1,39,4,3
14,373,373,1,1,0,1,0
21,378,378,17,17,0,1,0
5,382,382,36,10,26,2,1
29,386,386,4,4,0,1,0
19,412,412,47,19,28,2,1
3,417,417,8,8,0,1,0
25,425,425,21,5,16,3,2
8,437,437,42,16,26,3,2
2,437,437,55,1,54,3,2
22,458,458,71,2,69,4,3
30,473,473,16,16,0,1,0
7,476,476,20,20,0,1,0
4,479,479,48,11,37,2,1
34,484,484,9,1,8,3,2
35,488,488,31,31,0,1,0
43,499,499,3,3,0,1,0

5,121,121,7,7,0,1,0
1,131,131,30,25,5,2,1
34,142,142,2,2,0,1,0
26,145,145,8,8,0,1,0
23,149,149,33,1,32,3,2
33,181,181,8,8,0,1,0
36,182,182,51,39,12,3,2
16,184,184,1,1,0,1,0
27,194,194,42,42,0,1,0
37,206,206,11,11,0,1,0
24,212,212,13,13,0,1,0
6,236,236,73,53,20,2,1
32,240,240,8,3,5,2,1
11,245,245,37,16,21,4,3
31,252,252,62,23,39,4,3
2,262,262,2,2,0,1,0
15,263,263,36,36,0,1,0
28,267,267,69,69,0,1,0
39,276,276,33,33,0,1,0
3,281,281,32,32,0,1,0
7,285,285,41,41,0,1,0
20,305,305,2,2,0,1,0
13,306,306,28,28,0,1,0
4,310,310,8,8,0,1,0
12,313,313,38,38,0,1,0
10,334,334,35,35,0,1,0
14,366,366,2,2,0,1,0
35,372,372,7,1,6,2,1
17,376,376,1,1,0,1,0
0,378,378,18,18,0,1,0
22,385,385,77,11,66,3,2
21,397,397,8,8,0,1,0
25,411,411,49,49,0,1,0
8,414,414,14,14,0,1,0
18,415,415,83,2,81,4,3
29,420,420,7,7,0,1,0
9,421,421,43,43,0,1,0
38,477,477,7,3,4,2,1
30,487,487,23,23,0,1,0
19,492,492,55,33,22,2,1

27,101,101,15,7,8,2,1
11,116,116,8,3,5,2,1
12,129,129,16,16,0,1,0
31,130,130,43,15,28,3,2
9,140,140,19,12,7,2,1
22,151,151,8,8,0,1,0
25,152,152,19,19,0,1,0
35,160,160,3,3,0,1,0
13,163,163,21,13,8,3,2
10,178,178,16,16,0,1,0
3,184,184,24,24,0,1,0
32,202,202,29,15,14,2,1
23,215,215,35,20,15,2,1
21,222,222,2,2,0,1,0
24,226,226,19,3,16,2,1
20,230,230,6,6,0,1,0
17,248,248,33,33,0,1,0
1,254,254,54,54,0,1,0
7,278,278,13,13,0,1,0
34,293,293,7,7,0,1,0
14,299,299,42,42,0,1,0
16,323,323,157,97,60,4,3
26,350,350,10,10,0,1,0
18,359,359,15,4,11,2,1
4,377,377,81,21,60,4,3
0,379,379,17,5,12,2,1
19,382,382,8,8,0,1,0
29,383,383,21,14,7,2,1
30,388,388,17,17,0,1,0
2,395,395,82,77,5,2,1
28,426,426,35,29,6,2,1
5,438,438,73,73,0,1,0
33,466,466,14,1,13,2,1
6,475,475,89,8,81,4,3
8,478,478,30,20,10,3,2
15,495,495,19,19,0,1,0

34,112,112,19,19,0,1,0
9,113,113,6,6,0,1,0
13,114,114,1,1,0,1,0
31,123,123,1,1,0,1,0
23,134,134,22,22,0,1,0
3,136,136,3,3,0,1,0
38,147,147,3,3,0,1,0
1,155,155,14,14,0,1,0
2,162,162,1,1,0,1,0
18,200,200,39,3,36,3,2
40,225,225,7,4,3,2,1
16,227,227,3,3,0,1,0
39,246,246,16,16,0,1,0
32,248,248,146,128,18,4,3
15,250,250,23,9,14,3,2
4,252,252,2,2,0,1,0
21,272,272,45,14,31,2,1
30,275,275,3,3,0,1,0
37,279,279,51,13,38,3,2
11,295,295,84,60,24,2,1
26,300,300,21,21,0,1,0
0,302,302,6,6,0,1,0
14,308,308,58,58,0,1,0
28,317,317,19,19,0,1,0
10,320,320,14,14,0,1,0
33,335,335,14,14,0,1,0
36,376,376,1,1,0,1,0
19,377,377,30,30,0,1,0
5,383,383,37,7,30,3,2
27,385,385,6,6,0,1,0
20,392,392,49,49,0,1,0
17,399,399,16,9,7,2,1
22,404,404,2,2,0,1,0
8,409,409,67,67,0,1,0
29,411,411,44,44,0,1,0
7,416,416,70,18,52,4,3
25,416,416,40,21,19,2,1
6,419,419,69,35,34,3,2
24,427,427,50,50,0,1,0
12,434,434,60,42,18,3,2
35,481,481,56,56,0,1,0

4,102,102,11,11,0,1,0
22,103,103,41,38,3,2,1
28,104,104,19,19,0,1,0
9,106,106,6,6,0,1,0
19,110,110,12,3,9,4,3
3,111,111,7,7,0,1,0
17,113,113,10,10,0,1,0
16,115,115,5,5,0,1,0
27,129,129,18,4,14,2,1
33,145,145,6,6,0,1,0
34,159,159,1,1,0,1,0
11,161,161,10,2,8,3,2
30,173,173,24,24,0,1,0
0,177,177,21,7,14,3,2
10,211,211,24,21,3,2,1
26,215,215,12,12,0,1,0
29,216,216,15,15,0,1,0
12,251,251,68,68,0,1,0
21,265,265,37,37,0,1,0
24,270,270,11,2,9,2,1
8,314,314,26,21,5,2,1
13,340,340,15,3,12,3,2
18,357,357,4,4,0,1,0
15,365,365,25,25,0,1,0
7,369,369,25,1,24,4,3
35,379,379,46,34,12,2,1
32,385,385,4,4,0,1,0
20,398,398,50,50,0,1,0
2,405,405,6,6,0,1,0
1,416,416,214,160,54,4,3
25,423,423,15,15,0,1,0
6,446,446,38,32,6,2,1
5,462,462,105,72,33,2,1
23,468,468,97,97,0,1,0
14,482,482,29,5,24,3,2
31,494,494,17,17,0,1,0
36,497,497,46,46,0,1,0

36,106,106,17,17,0,1,0
14,126,126,8,5,3,2,1
6,135,135,15,7,8,3,2
26,137,137,4,4,0,1,0
9,153,153,15,15,0,1,0
34,168,168,14,14,0,1,0
17,173,173,4,4,0,1,0
29,179,179,17,2,15,2,1
25,184,184,8,8,0,1,0
20,192,192,20,15,5,2,1
5,215,215,30,9,21,4,3
33,218,218,10,10,0,1,0
39,226,226,4,4,0,1,0
4,245,245,14,2,12,4,3
30,248,248,2,2,0,1,0
27,268,268,43,43,0,1,0
2,274,274,51,30,21,2,1
40,289,289,2,2,0,1,0
10,291,291,29,29,0,1,0
16,291,291,61,61,0,1,0
3,305,305,4,4,0,1,0
28,317,317,18,14,4,2,1
7,318,318,13,5,8,3,2
24,319,319,100,100,0,1,0
1,331,331,118,100,18,3,2
21,339,339,25,25,0,1,0
37,339,339,18,6,12,3,2
12,371,371,54,18,36,4,3
15,397,397,28,28,0,1,0
0,410,410,79,34,45,3,2
32,414,414,147,143,4,2,1
11,421,421,15,15,0,1,0
19,431,431,10,10,0,1,0
38,450,450,19,19,0,1,0
22,451,451,25,25,0,1,0
13,464,464,3,3,0,1,0
35,477,477,1,1,0,1,0
23,477,477,62,62,0,1,0
8,479,479,12,9,3,2,1
18,483,483,1,1,0,1,0
31,484,484,144,6,138,4,3

13,103,103,2,2,0,1,0
21,124,124,14,5,9,2,1
18,127,127,32,19,13,2,1
5,133,133,21,21,0,1,0
25,149,149,7,7,0,1,0
11,155,155,28,28,0,1,0
9,159,159,7,7,0,1,0
27,168,168,14,14,0,1,0
39,196,196,55,17,38,3,2
33,203,203,1,1,0,1,0
22,233,233,17,12,5,2,1
19,246,246,20,20,0,1,0
29,251,251,7,7,0,1,0
17,255,255,119,29,90,4,3
32,258,258,17,17,0,1,0
14,261,261,5,2,3,2,1
23,283,283,14,4,10,2,1
35,285,285,4,4,0,1,0
0,288,288,17,17,0,1,0
16,315,315,17,17,0,1,0
15,315,315,13,1,12,3,2
1,330,330,10,4,6,2,1
31,330,330,27,27,0,1,0
30,342,342,6,2,4,2,1
2,364,364,53,53,0,1,0
24,378,378,145,145,0,1,0
20,403,403,30,18,12,4,3
8,403,403,40,40,0,1,0
37,425,425,37,37,0,1,0
36,425,425,28,28,0,1,0
6,425,425,12,12,0,1,0
3,426,426,83,83,0,1,0
12,429,429,4,4,0,1,0
28,439,439,171,139,32,2,1
7,443,443,19,8,11,2,1
34,461,461,17,17,0,1,0
10,479,479,12,12,0,1,0
38,481,481,56,47,9,2,1
26,485,485,15,5,10,3,2
4,489,489,26,6,20,2,1

33,122,122,4,4,0,1,0
23,123,123,13,13,0,1,0
9,130,130,7,7,0,1,0
29,131,131,7,7,0,1,0
15,151,151,2,2,0,1,0
32,153,153,14,14,0,1,0
37,166,166,20,7,13,4,3
40,169,169,6,1,5,2,1
11,177,177,18,3,15,4,3
2,183,183,25,25,0,1,0
6,184,184,58,20,38,3,2
35,184,184,8,8,0,1,0
22,185,185,37,15,22,3,2
42,201,201,65,65,0,1,0
26,203,203,3,3,0,1,0
27,223,223,20,20,0,1,0
8,229,229,4,1,3,2,1
24,235,235,32,32,0,1,0
17,256,256,24,24,0,1,0
25,261,261,45,23,22,2,1
28,267,267,38,38,0,1,0
14,288,288,4,4,0,1,0
39,299,299,5,2,3,2,1
31,310,310,60,13,47,4,3
3,324,324,32,10,22,2,1
12,333,333,46,10,36,3,2
10,338,338,9,3,6,2,1
43,348,348,56,52,4,2,1
7,364,364,11,11,0,1,0
5,385,385,12,12,0,1,0
16,393,393,3,3,0,1,0
0,393,393,41,41,0,1,0
36,397,397,24,24,0,1,0
13,404,404,51,51,0,1,0
1,419,419,27,27,0,1,0
21,424,424,7,7,0,1,0
34,432,432,1,1,0,1,0
18,435,435,14,2,12,3,2
38,459,459,59,3,56,3,2
30,470,470,65,62,3,2,1
20,470,470,63,50,13,2,1
4,472,472,10,10,0,1,0
19,479,479,59,16,43,2,1
41,493,493,44,44,0,1,0

12,107,107,29,7,22,2,1
36,108,108,11,2,9,4,3
21,122,122,1,1,0,1,0
10,128,128,12,6,6,3,2
13,155,155,19,2,17,2,1
0,167,167,8,4,4,2,1
30,175,175,13,1,12,3,2
32,177,177,35,35,0,1,0
4,207,207,12,1,11,2,1
20,210,210,33,18,15,2,1
23,213,213,3,3,0,1,0
24,222,222,29,11,18,2,1
37,224,224,25,25,0,1,0
9,242,242,13,13,0,1,0
29,252,252,21,21,0,1,0
22,263,263,46,10,36,3,2
33,271,271,10,10,0,1,0
11,272,272,63,63,0,1,0
7,286,286,13,13,0,1,0
26,289,289,4,1,3,2,1
28,307,307,10,10,0,1,0
1,309,309,60,48,12,2,1
2,317,317,13,3,10,3,2
31,324,324,21,21,0,1,0
6,351,351,22,22,0,1,0
34,355,355,29,29,0,1,0
35,356,356,62,25,37,2,1
14,388,388,8,8,0,1,0
5,398,398,18,18,0,1,0
16,399,399,5,5,0,1,0
19,412,412,20,20,0,1,0
3,416,416,50,50,0,1,0
25,430,430,147,27,120,4,3
15,456,456,22,4,18,2,1
27,473,473,25,10,15,2,1
8,489,489,114,114,0,1,0
17,493,493,147,147,0,1,0
18,497,497,72,52,20,2,1

10,108,108,7,7,0,1,0
9,114,114,22,2,20,2,1
40,116,116,13,13,0,1,0
0,166,166,3,3,0,1,0
11,167,167,3,3,0,1,0
43,192,192,10,10,0,1,0
32,194,194,27,27,0,1,0
14,198,198,13,13,0,1,0
39,199,199,101,101,0,1,0
21,207,207,10,10,0,1,0
6,218,218,9,2,7,3,2
31,221,221,15,15,0,1,0
41,229,229,14,14,0,1,0
26,230,230,30,30,0,1,0
22,231,231,4,4,0,1,0
30,245,245,6,6,0,1,0
13,247,247,1,1,0,1,0
4,250,250,41,11,30,2,1
8,253,253,5,5,0,1,0
33,268,268,5,5,0,1,0
25,277,277,29,8,21,4,3
2,294,294,23,23,0,1,0
36,305,305,23,13,10,2,1
37,333,333,30,13,17,4,3
17,346,346,152,134,18,3,2
23,371,371,40,25,15,4,3
28,390,390,52,52,0,1,0
35,394,394,35,21,14,3,2
18,402,402,73,61,12,3,2
20,405,405,21,21,0,1,0
3,410,410,19,19,0,1,0
24,411,411,39,39,0,1,0
38,412,412,9,1,8,2,1
7,413,413,14,14,0,1,0
27,425,425,81,77,4,2,1
12,435,435,18,18,0,1,0
19,441,441,63,16,47,4,3
5,457,457,7,7,0,1,0
1,469,469,49,49,0,1,0
16,469,469,27,10,17,2,1
15,470,470,22,22,0,1,0
42,475,475,3,3,0,1,0
29,497,497,54,15,39,4,3
34,499,499,5,5,0,1,0

12,104,104,8,8,0,1,0
35,118,118,24,24,0,1,0
20,141,141,4,4,0,1,0
25,151,151,5,5,0,1,0
40,160,160,31,31,0,1,0
19,169,169,3,3,0,1,0
18,175,175,2,2,0,1,0
30,175,175,12,12,0,1,0
10,190,190,9,6,3,2,1
27,196,196,18,6,12,3,2
2,207,207,8,3,5,2,1
24,220,220,1,1,0,1,0
13,224,224,12,12,0,1,0
28,259,259,20,9,11,2,1
45,261,261,15,15,0,1,0
29,261,261,5,5,0,1,0
8,289,289,73,65,8,2,1
26,289,289,72,51,21,2,1
3,290,290,9,9,0,1,0
41,304,304,85,31,54,3,2
34,306,306,38,38,0,1,0
7,314,314,71,14,57,4,3
39,314,314,29,23,6,3,2
46,331,331,12,12,0,1,0
37,332,332,30,30,0,1,0
11,341,341,16,8,8,3,2
22,345,345,1,1,0,1,0
5,357,357,62,62,0,1,0
32,361,361,35,5,30,4,3
21,370,370,11,5,6,2,1
16,372,372,1,1,0,1,0
14,382,382,36,12,24,2,1
6,387,387,12,12,0,1,0
9,387,387,98,80,18,3,2
17,387,387,21,21,0,1,0
43,392,392,26,26,0,1,0
1,398,398,19,19,0,1,0
42,419,419,51,5,46,3,2
44,426,426,34,34,0,1,0
23,430,430,33,33,0,1,0
36,453,453,38,38,0,1,0
33,467,467,36,36,0,1,0
15,467,467,11,3,8,2,1
4,473,473,15,15,0,1,0
31,482,482,11,5,6,3,2
0,498,498,32,10,22,2,1
38,500,500,75,75,0,1,0

23,100,100,4,4,0,1,0
6,103,103,7,7,0,1,0
9,109,109,27,27,0,1,0
2,129,129,43,43,0,1,0
33,143,143,11,11,0,1,0
21,143,143,16,16,0,1,0
1,158,158,6,6,0,1,0
29,169,169,4,4,0,1,0
18,178,178,17,17,0,1,0
22,186,186,46,2,44,4,3
27,192,192,10,1,9,4,3
8,224,224,58,39,19,2,1
11,256,256,40,28,12,3,2
26,257,257,9,9,0,1,0
30,269,269,30,3,27,4,3
3,286,286,21,21,0,1,0
32,290,290,34,5,29,2,1
16,294,294,42,23,19,2,1
28,303,303,4,4,0,1,0
5,316,316,142,94,48,4,3
19,331,331,54,32,22,2,1
14,341,341,16,16,0,1,0
4,347,347,29,12,17,2,1
12,349,349,2,2,0,1,0
20,365,365,19,19,0,1,0
10,373,373,20,20,0,1,0
15,387,387,98,80,18,4,3
0,391,391,2,2,0,1,0
17,393,393,67,39,28,2,1
24,433,433,2,2,0,1,0
25,444,444,16,16,0,1,0
7,470,470,46,34,12,2,1
31,481,481,122,122,0,1,0
13,483,483,63,63,0,1,0

7,102,102,21,11,10,2,1
6,112,112,15,15,0,1,0
5,134,134,10,1,9,4,3
19,140,140,13,5,8,3,2
42,141,141,40,40,0,1,0
16,159,159,4,4,0,1,0
35,159,159,32,32,0,1,0
28,164,164,4,4,0,1,0
0,170,170,24,24,0,1,0
27,179,179,27,9,18,2,1
26,196,196,1,1,0,1,0
32,197,197,19,19,0,1,0
15,201,201,35,20,15,4,3
1,212,212,2,2,0,1,0
23,224,224,2,2,0,1,0
29,234,234,20,11,9,2,1
39,239,239,1,1,0,1,0
14,261,261,36,36,0,1,0
21,269,269,21,21,0,1,0
33,274,274,22,22,0,1,0
18,287,287,7,7,0,1,0
17,295,295,14,14,0,1,0
3,297,297,1,1,0,1,0
38,316,316,23,23,0,1,0
30,329,329,16,16,0,1,0
4,331,331,16,16,0,1,0
43,333,333,27,20,7,2,1
9,334,334,32,32,0,1,0
8,346,346,4,4,0,1,0
2,347,347,13,1,12,2,1
31,370,370,160,144,16,4,3
11,372,372,6,2,4,2,1
10,379,379,132,126,6,2,1
36,401,401,16,6,10,3,2
37,411,411,9,1,8,2,1
20,426,426,27,18,9,4,3
41,431,431,9,9,0,1,0
22,436,436,9,9,0,1,0
24,436,436,2,2,0,1,0
34,441,441,88,76,12,4,3
25,441,441,7,7,0,1,0
12,445,445,32,32,0,1,0
13,480,480,64,64,0,1,0
40,490,490,82,82,0,1,0

39,102,102,12,12,0,1,0
5,107,107,18,18,0,1,0
25,131,131,13,13,0,1,0
15,132,132,6,6,0,1,0
18,138,138,29,3,26,4,3
34,141,141,30,19,11,2,1
7,141,141,29,29,0,1,0
26,144,144,1,1,0,1,0
0,146,146,2,2,0,1,0
40,148,148,21,13,8,3,2
29,169,169,21,21,0,1,0
20,177,177,3,3,0,1,0
41,184,184,19,19,0,1,0
43,202,202,6,2,4,2,1
36,202,202,14,14,0,1,0
37,225,225,4,4,0,1,0
13,261,261,36,15,21,4,3
14,269,269,7,7,0,1,0
33,271,271,7,7,0,1,0
2,273,273,1,1,0,1,0
30,277,277,54,54,0,1,0
35,287,287,16,10,6,3,2
17,294,294,14,14,0,1,0
19,300,300,12,12,0,1,0
44,315,315,1,1,0,1,0
24,317,317,14,4,10,2,1
1,324,324,56,19,37,2,1
31,331,331,25,25,0,1,0
11,355,355,123,86,37,2,1
9,356,356,9,5,4,2,1
8,382,382,1,1,0,1,0
28,384,384,95,75,20,4,3
4,390,390,35,35,0,1,0
16,400,400,19,19,0,1,0
32,407,407,123,52,71,3,2
3,415,415,4,4,0,1,0
23,446,446,1,1,0,1,0
12,455,455,19,1,18,3,2
42,465,465,43,7,36,4,3
22,475,475,33,9,24,3,2
10,479,479,34,34,0,1,0
21,481,481,41,22,19,2,1
6,483,483,38,4,34,3,2
27,492,492,38,38,0,1,0
38,497,497,29,29,0,1,0

18,107,107,8,8,0,1,0
24,109,109,2,2,0,1,0
4,115,115,1,1,0,1,0
25,117,117,3,3,0,1,0
11,122,122,19,19,0,1,0
43,138,138,16,16,0,1,0
37,156,156,49,49,0,1,0
36,161,161,21,6,15,4,3
10,167,167,35,35,0,1,0
22,184,184,4,1,3,2,1
14,189,189,4,4,0,1,0
41,199,199,1,1,0,1,0
23,201,201,1,1,0,1,0
34,207,207,46,46,0,1,0
28,215,215,23,23,0,1,0
13,218,218,1,1,0,1,0
40,222,222,17,1,16,2,1
42,250,250,7,2,5,2,1
26,255,255,21,21,0,1,0
33,264,264,4,4,0,1,0
27,266,266,44,29,15,2,1
5,270,270,6,1,5,2,1
1,299,299,97,97,0,1,0
19,318,318,50,30,20,2,1
16,321,321,6,6,0,1,0
20,326,326,41,41,0,1,0
2,331,331,25,25,0,1,0
15,336,336,4,4,0,1,0
35,366,366,37,29,8,2,1
31,371,371,24,4,20,3,2
9,374,374,18,18,0,1,0
32,376,376,39,39,0,1,0
39,378,378,12,12,0,1,0
12,387,387,3,3,0,1,0
8,390,390,24,6,18,3,2
0,409,409,97,85,12,3,2
3,416,416,32,10,22,3,2
38,439,439,8,1,7,2,1
30,441,441,75,20,55,4,3
7,448,448,47,47,0,1,0
21,450,450,45,45,0,1,0
17,455,455,3,3,0,1,0
6,455,455,55,55,0,1,0
29,499,499,124,124,0,1,0

2,127,127,11,11,0,1,0
36,144,144,19,19,0,1,0
20,148,148,6,6,0,1,0
41,154,154,20,20,0,1,0
1,169,169,24,13,11,2,1
7,214,214,22,22,0,1,0
3,220,220,23,11,12,2,1
18,220,220,10,10,0,1,0
8,223,223,1,1,0,1,0
25,229,229,4,4,0,1,0
19,244,244,82,57,25,2,1
38,247,247,4,4,0,1,0
16,257,257,4,1,3,2,1
40,263,263,6,6,0,1,0
15,271,271,16,16,0,1,0
42,275,275,33,33,0,1,0
6,284,284,1,1,0,1,0
12,304,304,9,1,8,3,2
22,305,305,34,34,0,1,0
39,310,310,19,19,0,1,0
9,318,318,81,33,48,3,2
17,325,325,12,12,0,1,0
11,333,333,105,78,27,4,3
0,337,337,13,13,0,1,0
26,342,342,40,40,0,1,0
23,355,355,9,9,0,1,0
21,358,358,5,5,0,1,0
32,360,360,15,15,0,1,0
27,363,363,10,2,8,3,2
31,372,372,50,50,0,1,0
34,406,406,82,82,0,1,0
33,410,410,38,5,33,3,2
28,419,419,40,40,0,1,0
35,438,438,70,61,9,4,3
24,448,448,119,119,0,1,0
4,449,449,20,20,0,1,0
29,451,451,99,89,10,2,1
30,456,456,33,7,26,3,2
10,464,464,33,33,0,1,0
14,473,473,10,10,0,1,0
37,484,484,39,1,38,3,2
5,490,490,57,57,0,1,0
13,493,493,3,3,0,1,0

10,107,107,4,4,0,1,0
0,118,118,15,4,11,2,1
21,139,139,41,41,0,1,0
1,162,162,19,19,0,1,0
34,164,164,15,2,13,2,1
13,165,165,23,10,13,4,3
18,171,171,29,19,10,2,1
31,183,183,22,22,0,1,0
7,187,187,1,1,0,1,0
25,194,194,46,46,0,1,0
35,266,266,2,2,0,1,0
33,267,267,10,4,6,2,1
30,277,277,34,34,0,1,0
27,290,290,6,6,0,1,0
38,297,297,35,35,0,1,0
26,301,301,63,63,0,1,0
40,302,302,3,3,0,1,0
20,315,315,6,6,0,1,0
37,332,332,4,4,0,1,0
16,337,337,30,12,18,3,2
28,338,338,22,22,0,1,0
4,349,349,21,21,0,1,0
8,352,352,9,4,5,2,1
41,365,365,10,4,6,2,1
12,373,373,1,1,0,1,0
6,380,380,17,3,14,3,2
11,381,381,14,3,11,2,1
3,390,390,74,59,15,4,3
22,392,392,15,15,0,1,0
24,394,394,84,41,43,2,1
9,394,394,31,23,8,3,2
14,397,397,46,46,0,1,0
36,412,412,11,8,3,2,1
39,424,424,57,57,0,1,0
32,424,424,13,9,4,2,1
5,463,463,37,4,33,4,3
23,466,466,90,30,60,4,3
15,471,471,5,1,4,2,1
19,473,473,62,2,60,4,3
29,473,473,146,50,96,4,3
2,473,473,29,4,25,2,1
17,485,485,80,80,0,1,0

9,125,125,35,35,0,1,0
1,132,132,4,4,0,1,0
29,138,138,24,4,20,3,2
20,141,141,23,2,21,4,3
33,173,173,6,6,0,1,0
0,188,188,4,1,3,2,1
2,196,196,25,25,0,1,0
8,199,199,5,5,0,1,0
24,206,206,4,4,0,1,0
28,211,211,12,12,0,1,0
25,218,218,39,39,0,1,0
26,238,238,20,2,18,3,2
18,243,243,16,16,0,1,0
7,243,243,19,5,14,3,2
5,257,257,47,14,33,2,1
31,260,260,1,1,0,1,0
4,265,265,1,1,0,1,0
36,267,267,34,28,6,3,2
15,270,270,84,65,19,2,1
12,274,274,39,39,0,1,0
27,288,288,24,24,0,1,0
37,291,291,75,22,53,3,2
11,300,300,68,68,0,1,0
6,301,301,38,38,0,1,0
21,307,307,67,15,52,3,2
32,315,315,17,8,9,2,1
16,319,319,13,1,12,2,1
10,328,328,46,46,0,1,0
14,345,345,13,13,0,1,0
30,346,346,5,5,0,1,0
34,348,348,18,12,6,3,2
13,351,351,38,38,0,1,0
35,383,383,2,2,0,1,0
19,408,408,49,12,37,2,1
22,409,409,98,86,12,4,3
17,427,427,34,34,0,1,0
23,446,446,41,5,36,2,1
3,486,486,19,10,9,2,1

27,115,115,1,1,0,1,0
6,154,154,5,5,0,1,0
7,166,166,4,4,0,1,0
22,177,177,24,19,5,2,1
3,186,186,2,2,0,1,0
25,211,211,9,9,0,1,0
15,213,213,20,2,18,3,2
20,236,236,10,2,8,2,1
33,255,255,47,47,0,1,0
31,260,260,7,1,6,3,2
18,275,275,32,32,0,1,0
10,277,277,11,2,9,2,1
21,279,279,91,91,0,1,0
28,281,281,1,1,0,1,0
8,290,290,3,3,0,1,0
24,291,291,132,132,0,1,0
16,292,292,11,11,0,1,0
32,299,299,6,1,5,2,1
34,308,308,62,31,31,2,1
4,331,331,19,19,0,1,0
12,342,342,193,115,78,3,2
29,344,344,38,26,12,2,1
23,346,346,28,10,18,3,2
14,360,360,10,10,0,1,0
30,394,394,18,18,0,1,0
2,395,395,56,50,6,2,1
0,398,398,94,94,0,1,0
1,405,405,48,9,39,2,1
9,410,410,9,2,7,2,1
19,415,415,11,11,0,1,0
5,420,420,3,3,0,1,0
35,440,440,63,21,42,4,3
11,454,454,115,94,21,4,3
38,454,454,3,3,0,1,0
17,462,462,85,45,40,2,1
36,474,474,60,34,26,2,1
26,481,481,17,7,10,3,2
13,484,484,12,12,0,1,0
37,486,486,10,10,0,1,0

23,114,114,6,6,0,1,0
11,121,121,33,1,32,2,1
18,135,135,14,4,10,2,1
12,183,183,66,44,22,2,1
7,202,202,18,18,0,1,0
27,209,209,32,14,18,2,1
26,235,235,37,3,34,3,2
21,238,238,13,1,12,4,3
30,240,240,24,24,0,1,0
14,240,240,41,41,0,1,0
1,246,246,94,78,16,3,2
17,257,257,2,2,0,1,0
0,262,262,22,8,14,2,1
13,279,279,13,13,0,1,0
10,282,282,5,5,0,1,0
29,283,283,11,11,0,1,0
32,284,284,52,34,18,4,3
19,290,290,8,8,0,1,0
9,307,307,43,43,0,1,0
33,337,337,9,9,0,1,0
6,348,348,5,5,0,1,0
20,351,351,14,14,0,1,0
25,351,351,43,43,0,1,0
5,364,364,35,26,9,2,1
15,381,381,31,17,14,3,2
8,400,400,80,11,69,4,3
22,412,412,47,17,30,3,2
24,422,422,73,73,0,1,0
28,438,438,45,25,20,3,2
2,469,469,40,25,15,2,1
16,484,484,91,91,0,1,0
31,487,487,67,10,57,4,3
3,489,489,25,25,0,1,0
4,496,496,81,19,62,3,2

35,101,101,18,4,14,3,2
10,112,112,8,2,6,2,1
29,139,139,4,4,0,1,0
37,156,156,31,31,0,1,0
45,158,158,25,4,21,2,1
17,174,174,26,6,20,2,1
46,174,174,1,1,0,1,0
33,200,200,18,18,0,1,0
7,209,209,31,31,0,1,0
8,215,215,7,7,0,1,0
31,217,217,18,18,0,1,0
44,223,223,3,3,0,1,0
25,226,226,15,10,5,2,1
2,226,226,18,18,0,1,0
27,229,229,8,8,0,1,0
36,237,237,72,10,62,3,2
40,242,242,4,4,0,1,0
6,243,243,15,3,12,2,1
4,256,256,1,1,0,1,0
11,263,263,30,12,18,4,3
21,273,273,2,2,0,1,0
42,282,282,127,112,15,2,1
22,298,298,45,45,0,1,0
3,313,313,23,9,14,2,1
1,335,335,5,5,0,1,0
23,343,343,64,64,0,1,0
20,348,348,24,9,15,4,3
13,355,355,13,13,0,1,0
38,362,362,18,9,9,2,1
9,365,365,20,20,0,1,0
32,385,385,24,8,16,2,1
34,398,398,11,11,0,1,0
39,422,422,14,14,0,1,0
16,428,428,11,4,7,2,1
30,429,429,19,4,15,4,3
19,433,433,22,22,0,1,0
24,443,443,9,9,0,1,0
5,449,449,78,60,18,3,2
28,465,465,28,2,26,3,2
15,473,473,55,16,39,4,3
14,473,473,29,5,24,2,1
18,476,476,1,1,0,1,0
26,479,479,30,2,28,2,1
43,482,482,95,3,92,3,2
0,493,493,54,25,29,2,1
12,496,496,28,4,24,2,1
41,499,499,5,5,0,1,0

34,109,109,43,43,0,1,0
12,110,110,3,3,0,1,0
25,134,134,23,23,0,1,0
38,136,136,35,11,24,3,2
31,144,144,21,21,0,1,0
2,147,147,17,3,14,2,1
41,148,148,19,10,9,4,3
24,156,156,4,4,0,1,0
7,157,157,35,5,30,3,2
0,162,162,1,1,0,1,0
8,181,181,14,2,12,2,1
10,194,194,31,31,0,1,0
23,197,197,4,4,0,1,0
39,203,203,11,11,0,1,0
20,207,207,14,14,0,1,0
14,225,225,2,2,0,1,0
33,225,225,1,1,0,1,0
3,233,233,16,11,5,2,1
11,244,244,13,5,8,2,1
22,247,247,14,14,0,1,0
9,250,250,55,55,0,1,0
28,253,253,39,17,22,2,1
35,277,277,2,2,0,1,0
29,293,293,50,50,0,1,0
4,294,294,14,14,0,1,0
6,310,310,6,6,0,1,0
13,334,334,43,43,0,1,0
17,343,343,6,3,3,2,1
19,354,354,20,20,0,1,0
40,362,362,64,50,14,3,2
1,364,364,60,60,0,1,0
15,365,365,35,35,0,1,0
21,381,381,15,3,12,3,2
27,395,395,45,45,0,1,0
5,399,399,94,35,59,3,2
32,406,406,8,2,6,2,1
18,412,412,45,45,0,1,0
30,417,417,23,3,20,3,2
16,419,419,25,2,23,2,1
26,472,472,32,32,0,1,0
36,479,479,12,4,8,2,1
37,497,497,1,1,0,1,0

39,119,119,1,1,0,1,0
27,119,119,2,2,0,1,0
3,150,150,7,3,4,2,1
8,151,151,25,25,0,1,0
28,160,160,5,5,0,1,0
23,172,172,11,2,9,2,1
40,177,177,1,1,0,1,0
45,184,184,53,53,0,1,0
29,191,191,18,18,0,1,0
13,194,194,4,1,3,2,1
10,200,200,10,10,0,1,0
36,217,217,34,8,26,2,1
4,226,226,18,12,6,3,2
18,240,240,11,11,0,1,0
52,261,261,56,20,36,4,3
38,269,269,21,21,0,1,0
19,272,272,12,5,7,2,1
24,273,273,13,2,11,4,3
14,291,291,12,12,0,1,0
31,296,296,58,26,32,2,1
47,297,297,147,147,0,1,0
42,297,297,33,18,15,2,1
9,302,302,18,18,0,1,0
43,306,306,1,1,0,1,0
20,309,309,3,3,0,1,0
50,315,315,20,20,0,1,0
22,316,316,8,8,0,1,0
7,337,337,25,25,0,1,0
25,341,341,32,32,0,1,0
44,341,341,11,8,3,2,1
16,346,346,7,7,0,1,0
51,356,356,11,6,5,2,1
1,358,358,7,4,3,2,1
35,363,363,125,9,116,4,3
49,373,373,3,3,0,1,0
41,373,373,8,3,5,2,1
37,393,393,3,3,0,1,0
17,395,395,26,26,0,1,0
46,407,407,49,15,34,2,1
26,410,410,9,3,6,3,2
48,413,413,9,2,7,2,1
15,418,418,10,2,8,3,2
2,426,426,12,12,0,1,0
6,433,433,66,52,14,3,2
21,439,439,28,28,0,1,0
5,440,440,47,20,27,2,1
34,452,452,1,1,0,1,0
30,456,456,10,4,6,3,2
11,483,483,20,10,10,2,1
33,485,485,10,2,8,2,1
12,487,487,55,28,27,4,3
32,489,489,22,22,0,1,0
0,489,489,35,19,16,3,2

17,104,104,8,8,0,1,0
14,115,115,19,19,0,1,0
11,117,117,6,6,0,1,0
19,124,124,11,7,4,2,1
25,128,128,6,3,3,2,1
21,150,150,28,28,0,1,0
27,157,157,18,9,9,2,1
5,158,158,1,1,0,1,0
20,159,159,16,13,3,2,1
8,173,173,19,19,0,1,0
12,177,177,3,3,0,1,0
32,190,190,11,11,0,1,0
18,205,205,14,14,0,1,0
2,225,225,26,26,0,1,0
10,241,241,24,18,6,2,1
31,242,242,30,30,0,1,0
6,256,256,10,5,5,2,1
13,271,271,110,14,96,4,3
1,273,273,27,27,0,1,0
4,290,290,1,1,0,1,0
22,336,336,3,3,0,1,0
36,353,353,69,33,36,3,2
3,369,369,13,13,0,1,0
35,390,390,18,1,17,2,1
16,399,399,104,104,0,1,0
28,401,401,64,10,54,3,2
30,407,407,27,27,0,1,0
23,410,410,158,135,23,4,3
0,428,428,2,2,0,1,0
7,430,430,141,27,114,4,3
15,451,451,49,8,41,2,1
29,473,473,32,32,0,1,0
26,475,475,28,28,0,1,0
34,480,480,29,9,20,2,1
33,481,481,59,15,44,3,2
24,482,482,2,2,0,1,0
9,496,496,75,75,0,1,0

28,105,105,3,3,0,1,0
33,108,108,16,11,5,2,1
25,118,118,1,1,0,1,0
32,128,128,2,2,0,1,0
15,142,142,5,5,0,1,0
6,164,164,1,1,0,1,0
20,164,164,22,22,0,1,0
36,169,169,29,29,0,1,0
2,172,172,10,10,0,1,0
18,173,173,46,18,28,3,2
17,193,193,15,1,14,2,1
35,235,235,7,7,0,1,0
22,236,236,73,32,41,2,1
10,245,245,19,15,4,2,1
9,263,263,7,7,0,1,0
7,267,267,159,103,56,3,2
1,272,272,6,6,0,1,0
21,287,287,33,4,29,2,1
30,305,305,33,33,0,1,0
23,325,325,61,61,0,1,0
27,330,330,19,7,12,2,1
5,334,334,8,2,6,2,1
38,337,337,58,20,38,3,2
4,337,337,57,14,43,2,1
13,399,399,33,14,19,2,1
31,402,402,10,3,7,2,1
16,408,408,28,6,22,4,3
37,412,412,7,7,0,1,0
34,413,413,25,25,0,1,0
0,422,422,16,16,0,1,0
8,452,452,59,59,0,1,0
29,461,461,64,34,30,3,2
3,463,463,11,11,0,1,0
26,466,466,32,10,22,3,2
19,469,469,40,40,0,1,0
14,479,479,8,3,5,2,1
24,491,491,81,81,0,1,0
12,492,492,118,67,51,4,3
11,494,494,22,1,21,2,1

25,108,108,2,2,0,1,0
0,110,110,7,7,0,1,0
37,119,119,21,11,10,3,2
33,120,120,4,1,3,2,1
22,127,127,5,5,0,1,0
4,157,157,19,19,0,1,0
8,167,167,2,2,0,1,0
14,175,175,1,1,0,1,0
2,176,176,38,6,32,2,1
30,180,180,2,2,0,1,0
23,196,196,4,4,0,1,0
16,197,197,8,4,4,2,1
19,199,199,1,1,0,1,0
24,203,203,38,27,11,2,1
5,220,220,1,1,0,1,0
18,224,224,6,6,0,1,0
31,237,237,3,3,0,1,0
26,237,237,2,2,0,1,0
7,257,257,47,20,27,2,1
34,261,261,32,7,25,3,2
29,263,263,24,16,8,3,2
13,270,270,13,2,11,2,1
11,273,273,47,47,0,1,0
3,308,308,61,61,0,1,0
36,334,334,127,94,33,3,2
15,359,359,127,59,68,3,2
6,378,378,5,5,0,1,0
12,404,404,46,46,0,1,0
27,407,407,111,54,57,4,3
32,423,423,147,36,111,4,3
21,434,434,5,5,0,1,0
10,442,442,76,52,24,4,3
1,442,442,43,43,0,1,0
9,450,450,7,7,0,1,0
35,454,454,8,8,0,1,0
20,463,463,26,26,0,1,0
28,478,478,91,91,0,1,0
38,482,482,16,8,8,3,2
17,490,490,71,57,14,4,3

9,102,102,14,2,12,3,2
0,107,107,1,1,0,1,0
12,128,128,28,28,0,1,0
27,138,138,3,3,0,1,0
13,142,142,30,22,8,3,2
20,145,145,18,18,0,1,0
23,177,177,38,38,0,1,0
19,177,177,6,6,0,1,0
14,191,191,54,9,45,4,3
16,209,209,7,2,5,2,1
34,214,214,5,5,0,1,0
32,218,218,61,8,53,4,3
21,222,222,93,93,0,1,0
25,238,238,48,4,44,2,1
5,244,244,29,29,0,1,0
24,247,247,8,8,0,1,0
3,259,259,9,1,8,3,2
1,283,283,18,7,11,3,2
33,290,290,12,12,0,1,0
6,293,293,46,46,0,1,0
31,307,307,104,104,0,1,0
15,324,324,11,11,0,1,0
4,335,335,5,5,0,1,0
29,337,337,1,1,0,1,0
2,347,347,63,63,0,1,0
7,355,355,1,1,0,1,0
10,362,362,186,120,66,4,3
28,363,363,8,5,3,2,1
26,391,391,8,4,4,2,1
17,402,402,40,40,0,1,0
30,410,410,26,26,0,1,0
11,413,413,10,4,6,3,2
18,418,418,3,3,0,1,0
22,425,425,13,2,11,2,1
8,497,497,15,12,3,2,1

29,117,117,5,5,0,1,0
28,145,145,1,1,0,1,0
11,151,151,1,1,0,1,0
47,162,162,1,1,0,1,0
37,171,171,21,21,0,1,0
50,197,197,27,3,24,2,1
36,221,221,3,3,0,1,0
14,223,223,9,9,0,1,0
6,223,223,14,9,5,2,1
1,227,227,5,2,3,2,1
13,229,229,34,10,24,2,1
48,229,229,31,10,21,2,1
39,229,229,73,73,0,1,0
27,232,232,11,11,0,1,0
44,246,246,1,1,0,1,0
12,262,262,11,1,10,2,1
40,269,269,75,75,0,1,0
5,276,276,18,7,11,2,1
42,284,284,15,15,0,1,0
33,293,293,70,70,0,1,0
43,300,300,5,5,0,1,0
9,313,313,8,8,0,1,0
20,314,314,3,3,0,1,0
24,350,350,84,63,21,4,3
17,352,352,27,27,0,1,0
7,357,357,52,52,0,1,0
35,362,362,53,53,0,1,0
31,368,368,38,9,29,2,1
49,370,370,3,3,0,1,0
32,372,372,30,2,28,3,2
19,387,387,6,6,0,1,0
41,394,394,31,22,9,4,3
3,416,416,27,27,0,1,0
30,426,426,4,4,0,1,0
38,429,429,67,58,9,2,1
34,430,430,21,21,0,1,0
21,433,433,48,14,34,3,2
18,434,434,12,5,7,2,1
0,436,436,46,3,43,2,1
4,446,446,6,6,0,1,0
16,454,454,75,64,11,2,1
25,455,455,2,2,0,1,0
22,465,465,10,10,0,1,0
15,467,467,4,4,0,1,0
46,471,471,23,23,0,1,0
26,473,473,12,8,4,2,1
10,474,474,70,60,10,2,1
8,480,480,19,19,0,1,0
45,487,487,23,11,12,4,3
2,487,487,122,122,0,1,0
23,495,495,5,5,0,1,0

14,102,102,37,21,16,2,1
27,114,114,40,40,0,1,0
0,124,124,1,1,0,1,0
44,164,164,23,2,21,2,1
34,164,164,27,27,0,1,0
36,168,168,36,1,35,2,1
30,189,189,1,1,0,1,0
42,190,190,30,8,22,3,2
13,193,193,51,51,0,1,0
35,221,221,10,4,6,2,1
41,229,229,30,30,0,1,0
17,245,245,35,32,3,2,1
22,247,247,25,25,0,1,0
29,250,250,3,3,0,1,0
31,258,258,15,15,0,1,0
3,265,265,8,8,0,1,0
25,271,271,61,61,0,1,0
20,272,272,3,3,0,1,0
33,286,286,21,21,0,1,0
24,297,297,3,3,0,1,0
40,308,308,24,9,15,4,3
5,327,327,28,28,0,1,0
26,328,328,13,5,8,2,1
8,340,340,64,23,41,2,1
1,359,359,22,4,18,2,1
21,370,370,8,8,0,1,0
6,394,394,1,1,0,1,0
4,401,401,8,4,4,2,1
15,401,401,29,29,0,1,0
23,402,402,6,6,0,1,0
37,405,405,12,4,8,2,1
12,407,407,34,34,0,1,0
7,415,415,46,5,41,2,1
43,426,426,14,5,9,4,3
10,435,435,61,31,30,4,3
2,436,436,44,7,37,2,1
19,441,441,22,22,0,1,0
28,445,445,1,1,0,1,0
39,473,473,11,11,0,1,0
32,474,474,64,37,27,4,3
38,483,483,56,56,0,1,0
9,487,487,14,14,0,1,0
11,498,498,1,1,0,1,0
18,498,498,4,4,0,1,0
16,499,499,40,8,32,3,2

2,112,112,22,22,0,1,0
6,115,115,1,1,0,1,0
34,117,117,10,1,9,4,3
27,118,118,3,3,0,1,0
19,123,123,35,35,0,1,0
35,166,166,21,5,16,3,2
29,170,170,12,12,0,1,0
15,189,189,30,30,0,1,0
14,192,192,44,44,0,1,0
18,195,195,18,4,14,4,3
20,210,210,14,14,0,1,0
9,210,210,9,9,0,1,0
26,213,213,43,43,0,1,0
8,217,217,19,19,0,1,0
12,222,222,20,20,0,1,0
16,223,223,5,2,3,2,1
0,253,253,1,1,0,1,0
3,273,273,83,32,51,4,3
4,300,300,28,28,0,1,0
11,304,304,28,7,21,2,1
24,305,305,25,25,0,1,0
13,311,311,27,27,0,1,0
28,319,319,28,28,0,1,0
25,325,325,4,4,0,1,0
22,330,330,12,12,0,1,0
30,331,331,51,51,0,1,0
32,336,336,7,7,0,1,0
10,339,339,20,2,18,4,3
7,352,352,15,15,0,1,0
31,369,369,48,28,20,2,1
33,379,379,6,2,4,2,1
1,380,380,118,92,26,3,2
17,387,387,13,13,0,1,0
36,389,389,38,38,0,1,0
5,390,390,67,67,0,1,0
23,455,455,92,92,0,1,0
21,484,484,105,39,66,4,3

5,101,101,18,10,8,2,1
15,139,139,26,26,0,1,0
13,164,164,15,9,6,3,2
30,172,172,2,2,0,1,0
18,173,173,9,1,8,3,2
19,198,198,1,1,0,1,0
27,214,214,24,24,0,1,0
4,241,241,29,29,0,1,0
17,245,245,20,20,0,1,0
23,261,261,39,39,0,1,0
29,264,264,15,15,0,1,0
20,280,280,2,2,0,1,0
22,291,291,7,7,0,1,0
8,299,299,54,54,0,1,0
34,306,306,58,7,51,4,3
32,328,328,31,10,21,4,3
14,329,329,1,1,0,1,0
3,332,332,72,40,32,3,2
9,335,335,62,62,0,1,0
11,338,338,47,4,43,4,3
2,340,340,17,17,0,1,0
28,348,348,69,45,24,4,3
35,382,382,68,34,34,3,2
21,403,403,94,74,20,3,2
33,403,403,26,16,10,2,1
6,407,407,90,45,45,4,3
0,414,414,19,19,0,1,0
16,432,432,24,24,0,1,0
24,445,445,112,16,96,3,2
1,455,455,5,5,0,1,0
31,459,459,37,10,27,2,1
12,464,464,11,3,8,2,1
10,468,468,162,92,70,3,2
25,479,479,56,56,0,1,0
7,487,487,1,1,0,1,0
26,491,491,34,34,0,1,0

3,107,107,19,19,0,1,0
30,110,110,7,1,6,3,2
20,128,128,15,1,14,2,1
31,135,135,15,15,0,1,0
26,144,144,21,10,11,2,1
0,146,146,1,1,0,1,0
37,149,149,28,10,18,2,1
36,154,154,17,2,15,4,3
42,165,165,13,1,12,3,2
40,179,179,36,11,25,3,2
43,185,185,3,3,0,1,0
27,190,190,14,14,0,1,0
35,197,197,15,15,0,1,0
32,199,199,51,6,45,4,3
5,210,210,16,16,0,1,0
14,232,232,42,42,0,1,0
23,237,237,7,7,0,1,0
4,238,238,1,1,0,1,0
11,283,283,4,4,0,1,0
25,289,289,6,6,0,1,0
38,290,290,31,3,28,3,2
12,293,293,18,12,6,2,1
39,298,298,6,2,4,2,1
1,306,306,4,4,0,1,0
6,313,313,27,12,15,4,3
16,324,324,5,5,0,1,0
15,325,325,52,52,0,1,0
21,327,327,37,37,0,1,0
24,353,353,21,12,9,4,3
10,368,368,13,13,0,1,0
33,379,379,13,13,0,1,0
2,382,382,23,6,17,2,1
17,391,391,181,181,0,1,0
28,406,406,61,41,20,2,1
7,407,407,22,11,11,2,1
34,441,441,32,32,0,1,0
22,444,444,5,5,0,1,0
29,446,446,95,81,14,3,2
41,457,457,25,25,0,1,0
19,464,464,30,30,0,1,0
13,466,466,51,51,0,1,0
8,469,469,30,10,20,2,1
9,491,491,39,39,0,1,0
18,494,494,2,2,0,1,0

23,101,101,6,6,0,1,0
10,139,139,11,11,0,1,0
20,149,149,7,3,4,2,1
18,156,156,15,4,11,2,1
12,157,157,9,9,0,1,0
9,160,160,53,15,38,2,1
25,167,167,12,12,0,1,0
6,168,168,30,30,0,1,0
17,171,171,26,13,13,2,1
31,173,173,14,2,12,4,3
16,185,185,9,4,5,2,1
13,186,186,26,6,20,2,1
4,199,199,12,12,0,1,0
24,218,218,2,2,0,1,0
1,257,257,25,16,9,4,3
19,267,267,10,6,4,2,1
5,271,271,30,30,0,1,0
21,279,279,6,6,0,1,0
30,289,289,72,72,0,1,0
29,289,289,60,60,0,1,0
33,291,291,3,3,0,1,0
32,321,321,38,2,36,3,2
2,324,324,102,68,34,2,1
28,336,336,57,41,16,4,3
11,336,336,7,7,0,1,0
14,359,359,14,14,0,1,0
22,364,364,58,58,0,1,0
3,366,366,16,8,8,2,1
26,382,382,123,85,38,2,1
8,400,400,3,3,0,1,0
7,400,400,93,64,29,2,1
27,417,417,1,1,0,1,0
0,440,440,144,87,57,4,3
15,496,496,73,73,0,1,0

18,105,105,1,1,0,1,0
42,106,106,3,3,0,1,0
37,111,111,5,5,0,1,0
17,129,129,30,30,0,1,0
9,140,140,8,8,0,1,0
16,148,148,8,2,6,2,1
2,177,177,23,23,0,1,0
36,181,181,7,7,0,1,0
12,198,198,1,1,0,1,0
23,201,201,20,20,0,1,0
20,209,209,15,12,3,2,1
35,216,216,21,10,11,2,1
34,258,258,7,1,6,2,1
40,263,263,129,79,50,3,2
0,264,264,35,35,0,1,0
33,265,265,23,6,17,2,1
32,274,274,1,1,0,1,0
31,282,282,15,2,13,4,3
38,286,286,68,68,0,1,0
28,296,296,22,22,0,1,0
41,297,297,6,3,3,2,1
1,301,301,20,20,0,1,0
15,302,302,8,8,0,1,0
14,304,304,30,30,0,1,0
13,315,315,17,7,10,3,2
7,331,331,53,53,0,1,0
21,337,337,13,3,10,3,2
24,344,344,1,1,0,1,0
22,357,357,47,2,45,4,3
26,369,369,21,3,18,3,2
19,381,381,13,6,7,2,1
11,387,387,1,1,0,1,0
3,405,405,29,29,0,1,0
8,422,422,14,14,0,1,0
25,424,424,66,66,0,1,0
39,426,426,48,48,0,1,0
10,431,431,7,3,4,2,1
30,431,431,84,84,0,1,0
29,451,451,75,75,0,1,0
5,453,453,28,28,0,1,0
4,453,453,7,2,5,2,1
27,486,486,23,14,9,2,1
6,490,490,244,244,0,1,0

9,111,111,5,5,0,1,0
1,129,129,15,15,0,1,0
31,158,158,31,19,12,4,3
22,172,172,9,9,0,1,0
36,175,175,12,12,0,1,0
26,179,179,4,4,0,1,0
28,182,182,8,5,3,2,1
41,188,188,18,18,0,1,0
14,189,189,1,1,0,1,0
21,199,199,1,1,0,1,0
38,207,207,4,1,3,2,1
2,208,208,26,15,11,2,1
13,228,228,1,1,0,1,0
6,233,233,25,25,0,1,0
35,251,251,2,2,0,1,0
32,255,255,47,47,0,1,0
42,262,262,15,15,0,1,0
12,267,267,1,1,0,1,0
39,274,274,67,34,33,2,1
34,278,278,47,27,20,2,1
8,281,281,24,15,9,2,1
10,285,285,63,28,35,4,3
0,290,290,51,27,24,3,2
29,300,300,38,38,0,1,0
46,312,312,1,1,0,1,0
3,324,324,9,3,6,3,2
25,326,326,14,14,0,1,0
33,331,331,18,18,0,1,0
45,337,337,27,1,26,3,2
11,361,361,6,6,0,1,0
20,378,378,11,11,0,1,0
24,386,386,27,22,5,2,1
4,397,397,88,28,60,3,2
15,406,406,87,87,0,1,0
40,429,429,91,91,0,1,0
16,430,430,21,13,8,3,2
27,432,432,114,1,113,4,3
30,439,439,36,14,22,3,2
37,440,440,4,4,0,1,0
18,450,450,30,30,0,1,0
44,465,465,37,37,0,1,0
7,466,466,42,14,28,2,1
23,467,467,12,12,0,1,0
19,477,477,49,19,30,2,1
43,480,480,17,17,0,1,0
17,489,489,38,38,0,1,0
5,496,496,1,1,0,1,0

29,112,112,27,5,22,3,2
16,113,113,3,3,0,1,0
19,113,113,12,12,0,1,0
8,133,133,1,1,0,1,0
5,138,138,26,10,16,2,1
28,145,145,14,14,0,1,0
2,148,148,2,2,0,1,0
0,155,155,6,6,0,1,0
25,163,163,14,14,0,1,0
11,165,165,26,9,17,2,1
15,180,180,23,23,0,1,0
27,190,190,2,2,0,1,0
36,217,217,13,4,9,4,3
7,221,221,87,11,76,3,2
10,241,241,10,2,8,2,1
21,263,263,26,26,0,1,0
24,290,290,116,116,0,1,0
9,299,299,1,1,0,1,0
32,300,300,10,10,0,1,0
26,306,306,7,7,0,1,0
20,310,310,111,111,0,1,0
4,313,313,33,33,0,1,0
30,319,319,9,9,0,1,0
31,321,321,13,1,12,4,3
33,325,325,17,2,15,4,3
17,342,342,1,1,0,1,0
3,354,354,18,10,8,3,2
13,356,356,11,11,0,1,0
34,361,361,15,9,6,2,1
38,384,384,9,9,0,1,0
1,404,404,87,87,0,1,0
14,426,426,136,40,96,4,3
37,435,435,41,41,0,1,0
12,439,439,31,31,0,1,0
23,451,451,12,12,0,1,0
6,455,455,79,79,0,1,0
22,487,487,82,82,0,1,0
18,491,491,16,16,0,1,0
35,492,492,29,7,22,3,2

25,104,104,1,1,0,1,0
21,121,121,6,6,0,1,0
29,124,124,59,59,0,1,0
12,134,134,22,10,12,3,2
0,142,142,1,1,0,1,0
30,155,155,44,44,0,1,0
2,180,180,21,21,0,1,0
24,192,192,1,1,0,1,0
5,202,202,42,30,12,3,2
7,204,204,16,6,10,2,1
11,214,214,48,38,10,2,1
31,233,233,22,22,0,1,0
27,250,250,11,11,0,1,0
15,253,253,1,1,0,1,0
10,262,262,58,58,0,1,0
8,280,280,11,5,6,2,1
19,287,287,1,1,0,1,0
22,304,304,42,2,40,2,1
6,333,333,60,27,33,2,1
28,354,354,3,3,0,1,0
20,360,360,9,9,0,1,0
33,366,366,6,1,5,2,1
23,368,368,9,9,0,1,0
16,369,369,13,5,8,3,2
3,373,373,37,37,0,1,0
34,392,392,21,5,16,2,1
14,400,400,103,21,82,3,2
32,409,409,85,33,52,3,2
4,410,410,31,31,0,1,0
18,431,431,24,4,20,3,2
1,431,431,63,33,30,4,3
9,450,450,28,28,0,1,0
35,450,450,1,1,0,1,0
13,465,465,55,55,0,1,0
26,468,468,158,51,107,4,3
17,476,476,85,12,73,3,2

28,100,100,4,4,0,1,0
27,105,105,11,2,9,2,1
26,120,120,8,8,0,1,0
29,135,135,35,35,0,1,0
14,152,152,11,8,3,2,1
9,154,154,38,11,27,4,3
3,159,159,12,12,0,1,0
4,162,162,4,1,3,2,1
19,162,162,2,2,0,1,0
22,171,171,6,6,0,1,0
15,173,173,24,9,15,4,3
34,175,175,15,15,0,1,0
23,182,182,6,3,3,2,1
24,193,193,13,4,9,4,3
30,196,196,18,6,12,4,3
12,225,225,27,7,20,3,2
33,226,226,33,33,0,1,0
6,283,283,79,69,10,2,1
20,288,288,6,6,0,1,0
8,317,317,121,121,0,1,0
18,323,323,33,9,24,3,2
11,340,340,54,4,50,3,2
21,341,341,73,73,0,1,0
7,341,341,48,48,0,1,0
1,351,351,36,36,0,1,0
25,361,361,86,60,26,3,2
31,382,382,65,26,39,3,2
32,391,391,20,4,16,3,2
16,393,393,28,28,0,1,0
17,397,397,40,40,0,1,0
5,403,403,37,37,0,1,0
2,406,406,79,16,63,3,2
10,449,449,11,7,4,2,1
13,471,471,17,17,0,1,0
0,472,472,27,27,0,1,0

16,100,100,1,1,0,1,0
20,107,107,7,4,3,2,1
11,113,113,6,6,0,1,0
21,114,114,8,1,7,2,1
15,128,128,15,10,5,2,1
3,130,130,38,38,0,1,0
27,132,132,1,1,0,1,0
12,133,133,7,2,5,2,1
1,154,154,4,1,3,2,1
36,203,203,5,1,4,2,1
26,207,207,20,1,19,4,3
19,220,220,73,7,66,3,2
25,240,240,16,4,12,3,2
9,243,243,11,7,4,2,1
8,256,256,2,2,0,1,0
22,256,256,3,3,0,1,0
14,282,282,34,4,30,3,2
35,285,285,8,5,3,2,1
34,301,301,6,6,0,1,0
24,311,311,91,91,0,1,0
5,311,311,94,47,47,3,2
28,325,325,1,1,0,1,0
33,326,326,48,7,41,2,1
37,330,330,115,115,0,1,0
31,348,348,3,3,0,1,0
17,354,354,20,6,14,2,1
32,359,359,33,20,13,2,1
30,361,361,88,88,0,1,0
39,394,394,13,5,8,3,2
6,395,395,29,11,18,2,1
0,398,398,17,11,6,2,1
23,399,399,3,3,0,1,0
29,407,407,60,60,0,1,0
4,426,426,28,10,18,2,1
38,430,430,40,40,0,1,0
40,434,434,126,126,0,1,0
13,434,434,35,1,34,3,2
18,439,439,30,4,26,2,1
7,457,457,13,3,10,3,2
10,465,465,8,5,3,2,1
2,471,471,70,44,26,3,2

27,109,109,44,21,23,3,2
12,110,110,3,3,0,1,0
34,126,126,8,8,0,1,0
9,133,133,10,4,6,3,2
28,142,142,6,6,0,1,0
16,158,158,25,25,0,1,0
23,169,169,10,10,0,1,0
4,174,174,10,10,0,1,0
35,178,178,5,5,0,1,0
22,191,191,3,3,0,1,0
33,208,208,9,3,6,3,2
31,236,236,9,9,0,1,0
5,246,246,61,61,0,1,0
1,256,256,4,1,3,2,1
2,259,259,36,36,0,1,0
10,267,267,2,2,0,1,0
24,276,276,24,24,0,1,0
0,282,282,6,6,0,1,0
30,282,282,33,33,0,1,0
39,313,313,60,60,0,1,0
15,318,318,27,8,19,2,1
25,338,338,11,2,9,2,1
3,345,345,46,24,22,3,2
8,355,355,12,12,0,1,0
29,356,356,1,1,0,1,0
26,363,363,30,30,0,1,0
38,372,372,72,58,14,3,2
11,378,378,2,2,0,1,0
21,387,387,9,9,0,1,0
19,390,390,24,2,22,2,1
6,406,406,159,100,59,4,3
32,414,414,104,104,0,1,0
36,415,415,29,22,7,2,1
40,416,416,36,36,0,1,0
7,429,429,14,3,11,2,1
18,438,438,39,39,0,1,0
17,438,438,54,11,43,2,1
41,447,447,22,1,21,3,2
37,454,454,1,1,0,1,0
42,464,464,90,15,75,4,3
20,468,468,53,24,29,2,1
13,478,478,46,23,23,2,1
14,497,497,25,25,0,1,0

23,101,101,5,5,0,1,0
25,123,123,6,1,5,2,1
13,145,145,1,1,0,1,0
19,170,170,30,30,0,1,0
36,174,174,1,1,0,1,0
8,177,177,11,11,0,1,0
30,177,177,47,29,18,3,2
16,188,188,8,8,0,1,0
34,188,188,35,5,30,2,1
21,189,189,43,43,0,1,0
28,204,204,40,40,0,1,0
12,220,220,1,1,0,1,0
41,254,254,53,53,0,1,0
18,254,254,7,7,0,1,0
37,255,255,27,4,23,4,3
5,272,272,50,1,49,2,1
22,286,286,7,7,0,1,0
35,287,287,23,11,12,4,3
29,289,289,6,2,4,2,1
42,293,293,6,1,5,2,1
32,303,303,72,52,20,3,2
2,310,310,13,13,0,1,0
27,322,322,17,3,14,2,1
11,323,323,46,19,27,4,3
1,326,326,75,46,29,2,1
17,327,327,13,13,0,1,0
20,329,329,11,11,0,1,0
44,333,333,22,13,9,4,3
39,339,339,7,7,0,1,0
43,339,339,8,8,0,1,0
7,387,387,48,23,25,2,1
9,387,387,9,9,0,1,0
26,395,395,21,12,9,4,3
6,402,402,4,4,0,1,0
0,420,420,4,4,0,1,0
31,422,422,10,10,0,1,0
24,425,425,55,52,3,2,1
40,426,426,62,20,42,4,3
14,436,436,2,2,0,1,0
3,448,448,46,8,38,3,2
47,451,451,27,27,0,1,0
10,459,459,6,6,0,1,0
4,466,466,46,23,23,2,1
15,473,473,18,18,0,1,0
45,473,473,4,4,0,1,0
33,476,476,5,5,0,1,0
38,485,485,38,23,15,3,2
46,493,493,137,53,84,4,3

7,103,103,8,8,0,1,0
29,121,121,2,2,0,1,0
21,127,127,12,12,0,1,0
23,138,138,27,27,0,1,0
5,140,140,16,16,0,1,0
26,173,173,6,6,0,1,0
20,198,198,88,45,43,4,3
19,214,214,13,9,4,2,1
22,221,221,16,16,0,1,0
4,237,237,23,17,6,2,1
33,238,238,9,9,0,1,0
28,242,242,33,16,17,2,1
0,248,248,21,21,0,1,0
13,255,255,122,69,53,3,2
10,260,260,65,65,0,1,0
31,266,266,20,20,0,1,0
16,268,268,37,37,0,1,0
1,301,301,12,12,0,1,0
12,350,350,5,1,4,2,1
14,358,358,88,58,30,2,1
25,359,359,9,9,0,1,0
30,360,360,1,1,0,1,0
24,370,370,11,11,0,1,0
3,372,372,65,43,22,3,2
2,372,372,75,34,41,2,1
18,380,380,34,1,33,2,1
11,385,385,7,3,4,2,1
8,396,396,3,3,0,1,0
27,399,399,3,3,0,1,0
15,438,438,71,11,60,3,2
17,458,458,68,39,29,2,1
9,466,466,16,16,0,1,0
32,470,470,11,5,6,2,1
6,486,486,199,199,0,1,0

28,102,102,4,4,0,1,0
32,123,123,3,3,0,1,0
3,154,154,27,7,20,2,1
16,164,164,10,10,0,1,0
14,165,165,19,19,0,1,0
7,166,166,23,5,18,4,3
25,168,168,3,3,0,1,0
33,173,173,49,31,18,3,2
6,195,195,11,4,7,2,1
20,208,208,5,5,0,1,0
38,223,223,21,21,0,1,0
29,224,224,67,47,20,3,2
9,238,238,24,24,0,1,0
35,248,248,12,5,7,2,1
15,262,262,67,55,12,3,2
4,278,278,4,1,3,2,1
31,280,280,3,3,0,1,0
21,307,307,14,14,0,1,0
37,322,322,4,1,3,2,1
5,324,324,9,9,0,1,0
34,329,329,10,4,6,2,1
27,331,331,153,83,70,3,2
8,332,332,3,3,0,1,0
30,335,335,9,9,0,1,0
0,336,336,10,10,0,1,0
17,341,341,57,39,18,3,2
11,346,346,81,9,72,4,3
22,352,352,94,94,0,1,0
18,358,358,10,10,0,1,0
12,367,367,15,8,7,2,1
13,384,384,77,29,48,3,2
26,385,385,2,2,0,1,0
19,393,393,18,14,4,2,1
2,398,398,74,14,60,4,3
24,401,401,1,1,0,1,0
1,441,441,29,14,15,4,3
36,444,444,2,2,0,1,0
23,466,466,137,41,96,4,3
10,479,479,45,8,37,2,1

9,105,105,8,8,0,1,0
39,113,113,3,3,0,1,0
6,130,130,37,26,11,2,1
19,132,132,23,23,0,1,0
7,145,145,1,1,0,1,0
16,153,153,39,3,36,2,1
1,185,185,1,1,0,1,0
17,200,200,6,3,3,2,1
34,205,205,7,7,0,1,0
21,214,214,31,10,21,2,1
37,217,217,16,10,6,2,1
0,248,248,15,3,12,3,2
15,251,251,16,2,14,3,2
26,262,262,68,23,45,2,1
31,263,263,41,7,34,4,3
22,281,281,9,1,8,2,1
10,284,284,23,15,8,2,1
11,313,313,28,28,0,1,0
12,318,318,19,19,0,1,0
8,324,324,24,24,0,1,0
24,351,351,71,7,64,3,2
2,355,355,17,17,0,1,0
20,356,356,81,1,80,3,2
36,357,357,17,2,15,4,3
3,375,375,16,16,0,1,0
29,378,378,2,2,0,1,0
4,383,383,28,6,22,3,2
25,387,387,32,32,0,1,0
27,400,400,133,7,126,4,3
14,401,401,45,45,0,1,0
5,403,403,29,29,0,1,0
40,416,416,3,3,0,1,0
28,418,418,77,30,47,2,1
35,437,437,46,46,0,1,0
13,438,438,1,1,0,1,0
18,443,443,72,72,0,1,0
33,476,476,43,43,0,1,0
30,478,478,20,20,0,1,0
23,480,480,52,37,15,2,1
38,482,482,14,1,13,2,1
32,485,485,33,17,16,3,2

5,101,101,1,1,0,1,0
22,107,107,12,12,0,1,0
31,111,111,9,9,0,1,0
14,124,124,2,2,0,1,0
16,128,128,28,1,27,3,2
37,139,139,2,2,0,1,0
6,145,145,2,2,0,1,0
29,161,161,23,3,20,3,2
27,173,173,14,14,0,1,0
23,174,174,12,12,0,1,0
36,192,192,11,1,10,3,2
38,194,194,1,1,0,1,0
33,197,197,9,1,8,2,1
10,246,246,17,7,10,2,1
41,246,246,20,2,18,3,2
40,250,250,93,43,50,3,2
18,264,264,20,20,0,1,0
34,273,273,19,11,8,3,2
8,288,288,38,22,16,4,3
2,294,294,16,16,0,1,0
28,295,295,27,27,0,1,0
4,298,298,1,1,0,1,0
1,315,315,29,4,25,3,2
42,320,320,11,6,5,2,1
39,330,330,29,29,0,1,0
32,336,336,40,40,0,1,0
13,354,354,1,1,0,1,0
21,375,375,21,21,0,1,0
26,389,389,21,21,0,1,0
15,391,391,1,1,0,1,0
24,416,416,103,103,0,1,0
30,424,424,2,2,0,1,0
20,424,424,15,4,11,4,3
0,429,429,3,3,0,1,0
7,429,429,200,151,49,2,1
35,435,435,173,77,96,3,2
17,435,435,73,34,39,4,3
11,439,439,39,8,31,2,1
9,451,451,52,7,45,2,1
12,463,463,29,13,16,3,2
19,471,471,41,31,10,2,1
3,474,474,22,14,8,2,1
25,494,494,15,8,7,2,1
43,494,494,9,1,8,2,1

8,114,114,12,7,5,2,1
42,140,140,3,3,0,1,0
40,142,142,1,1,0,1,0
28,153,153,6,6,0,1,0
15,155,155,16,8,8,2,1
29,167,167,1,1,0,1,0
25,181,181,19,19,0,1,0
26,190,190,28,12,16,3,2
18,209,209,69,69,0,1,0
33,224,224,5,5,0,1,0
24,226,226,11,11,0,1,0
41,231,231,17,13,4,2,1
17,234,234,26,5,21,4,3
12,242,242,3,3,0,1,0
27,244,244,29,14,15,2,1
6,249,249,20,16,4,2,1
32,252,252,80,80,0,1,0
35,267,267,44,28,16,2,1
30,271,271,42,42,0,1,0
16,274,274,37,37,0,1,0
39,277,277,119,75,44,3,2
1,280,280,82,42,40,4,3
11,284,284,11,1,10,2,1
34,285,285,13,1,12,4,3
23,292,292,15,15,0,1,0
31,303,303,13,5,8,3,2
36,319,319,25,25,0,1,0
19,321,321,72,31,41,3,2
13,321,321,2,2,0,1,0
21,322,322,30,30,0,1,0
2,371,371,28,7,21,4,3
20,375,375,30,30,0,1,0
38,378,378,20,20,0,1,0
10,397,397,29,29,0,1,0
37,408,408,49,49,0,1,0
14,415,415,18,18,0,1,0
0,419,419,1,1,0,1,0
7,422,422,5,1,4,2,1
5,462,462,3,3,0,1,0
22,467,467,29,4,25,2,1
4,482,482,23,6,17,3,2
3,492,492,28,28,0,1,0
9,500,500,4,4,0,1,0

3,109,109,13,13,0,1,0
6,116,116,8,1,7,2,1
39,117,117,23,23,0,1,0
14,148,148,12,9,3,2,1
31,148,148,22,22,0,1,0
10,150,150,11,11,0,1,0
30,157,157,19,10,9,4,3
21,166,166,11,5,6,2,1
8,197,197,21,21,0,1,0
26,219,219,9,1,8,3,2
16,220,220,1,1,0,1,0
9,222,222,25,7,18,2,1
28,236,236,14,5,9,2,1
27,247,247,9,9,0,1,0
0,267,267,33,3,30,4,3
18,268,268,7,1,6,2,1
25,287,287,6,6,0,1,0
20,290,290,20,20,0,1,0
22,297,297,14,14,0,1,0
13,298,298,10,10,0,1,0
36,301,301,21,21,0,1,0
45,311,311,16,16,0,1,0
35,313,313,83,53,30,2,1
19,317,317,1,1,0,1,0
1,321,321,16,16,0,1,0
11,333,333,2,2,0,1,0
12,340,340,25,25,0,1,0
40,364,364,59,43,16,3,2
4,367,367,18,9,9,2,1
34,367,367,41,9,32,3,2
43,371,371,67,67,0,1,0
38,377,377,30,17,13,2,1
37,377,377,13,13,0,1,0
17,388,388,16,7,9,4,3
23,397,397,16,12,4,2,1
44,399,399,54,24,30,3,2
42,400,400,3,3,0,1,0
32,401,401,11,11,0,1,0
29,406,406,100,64,36,2,1
5,410,410,53,53,0,1,0
41,410,410,2,2,0,1,0
46,446,446,15,15,0,1,0
7,469,469,29,29,0,1,0
2,481,481,45,45,0,1,0
24,497,497,123,96,27,4,3
33,499,499,32,9,23,2,1
15,499,499,106,76,30,4,3

19,101,101,4,4,0,1,0
14,106,106,5,5,0,1,0
38,133,133,15,15,0,1,0
4,144,144,1,1,0,1,0
31,150,150,34,34,0,1,0
28,212,212,36,10,26,3,2
40,224,224,4,4,0,1,0
16,237,237,14,2,12,2,1
17,240,240,24,19,5,2,1
27,249,249,56,56,0,1,0
35,254,254,3,3,0,1,0
30,256,256,19,19,0,1,0
11,257,257,24,24,0,1,0
15,264,264,8,8,0,1,0
5,265,265,48,48,0,1,0
12,268,268,6,6,0,1,0
3,276,276,81,81,0,1,0
33,284,284,71,71,0,1,0
8,288,288,22,19,3,2,1
41,296,296,17,17,0,1,0
18,307,307,11,3,8,2,1
32,313,313,37,7,30,4,3
37,314,314,15,1,14,3,2
7,315,315,66,14,52,3,2
10,318,318,20,20,0,1,0
23,319,319,5,5,0,1,0
25,320,320,37,37,0,1,0
13,330,330,67,67,0,1,0
39,361,361,11,2,9,2,1
9,366,366,78,54,24,3,2
6,376,376,27,4,23,3,2
36,377,377,9,9,0,1,0
0,395,395,18,14,4,2,1
2,400,400,2,2,0,1,0
26,401,401,35,19,16,2,1
29,419,419,26,2,24,4,3
21,434,434,83,83,0,1,0
22,444,444,9,9,0,1,0
1,446,446,5,5,0,1,0
20,449,449,1,1,0,1,0
24,452,452,49,4,45,4,3
34,489,489,127,9,118,4,3

32,104,104,22,22,0,1,0
18,118,118,8,8,0,1,0
5,132,132,18,4,14,3,2
10,133,133,9,9,0,1,0
2,140,140,4,1,3,2,1
19,148,148,21,21,0,1,0
23,150,150,12,3,9,2,1
12,155,155,7,7,0,1,0
38,174,174,8,8,0,1,0
14,180,180,23,23,0,1,0
34,191,191,25,12,13,2,1
42,194,194,2,2,0,1,0
27,199,199,27,9,18,3,2
13,202,202,1,1,0,1,0
15,203,203,12,12,0,1,0
11,205,205,16,16,0,1,0
0,222,222,1,1,0,1,0
28,243,243,49,24,25,2,1
39,253,253,44,44,0,1,0
40,256,256,18,11,7,2,1
3,259,259,20,20,0,1,0
43,278,278,28,28,0,1,0
25,293,293,9,1,8,2,1
21,323,323,40,12,28,3,2
20,327,327,26,26,0,1,0
7,336,336,29,3,26,4,3
17,341,341,46,25,21,2,1
44,355,355,34,34,0,1,0
6,355,355,63,28,35,2,1
1,365,365,3,3,0,1,0
8,382,382,21,15,6,2,1
22,402,402,2,2,0,1,0
36,416,416,14,8,6,3,2
16,435,435,74,61,13,2,1
24,438,438,12,6,6,3,2
26,450,450,54,54,0,1,0
33,458,458,27,15,12,4,3
29,458,458,32,32,0,1,0
9,468,468,99,69,30,2,1
30,471,471,99,99,0,1,0
41,476,476,49,16,33,2,1
35,493,493,35,35,0,1,0
31,494,494,23,11,12,3,2
37,497,497,58,26,32,2,1
4,499,499,1,1,0,1,0

12,107,107,5,5,0,1,0
6,154,154,7,7,0,1,0
34,160,160,24,15,9,2,1
31,179,179,7,1,6,3,2
23,193,193,56,14,42,4,3
13,197,197,33,24,9,2,1
24,204,204,5,5,0,1,0
39,214,214,38,38,0,1,0
1,216,216,32,32,0,1,0
42,216,216,4,4,0,1,0
18,221,221,2,2,0,1,0
19,224,224,6,6,0,1,0
8,231,231,23,23,0,1,0
43,240,240,40,40,0,1,0
9,248,248,9,2,7,2,1
4,253,253,22,16,6,2,1
38,258,258,12,12,0,1,0
22,261,261,27,20,7,2,1
28,270,270,85,54,31,2,1
25,280,280,1,1,0,1,0
45,284,284,80,43,37,2,1
32,303,303,2,2,0,1,0
10,308,308,5,5,0,1,0
2,322,322,7,7,0,1,0
3,327,327,1,1,0,1,0
17,327,327,26,4,22,2,1
5,335,335,55,34,21,4,3
0,338,338,2,2,0,1,0
44,351,351,22,22,0,1,0
26,371,371,35,4,31,2,1
36,372,372,99,76,23,4,3
33,376,376,47,1,46,2,1
40,384,384,27,27,0,1,0
11,398,398,55,6,49,2,1
30,403,403,9,9,0,1,0
41,433,433,1,1,0,1,0
46,435,435,6,6,0,1,0
21,440,440,14,14,0,1,0
20,445,445,1,1,0,1,0
15,448,448,5,5,0,1,0
35,460,460,50,7,43,2,1
29,463,463,3,3,0,1,0
14,478,478,118,118,0,1,0
27,481,481,55,7,48,2,1
16,484,484,24,24,0,1,0
7,486,486,23,23,0,1,0
37,489,489,16,16,0,1,0

3,132,132,10,3,7,2,1
36,152,152,48,39,9,4,3
27,153,153,13,13,0,1,0
25,156,156,4,4,0,1,0
8,157,157,15,1,14,3,2
39,165,165,10,10,0,1,0
20,187,187,30,2,28,3,2
33,199,199,1,1,0,1,0
1,200,200,16,10,6,2,1
24,212,212,26,26,0,1,0
19,217,217,11,11,0,1,0
14,219,219,7,7,0,1,0
34,227,227,29,29,0,1,0
9,252,252,20,20,0,1,0
6,253,253,22,11,11,2,1
22,259,259,36,30,6,2,1
2,291,291,20,20,0,1,0
0,300,300,49,49,0,1,0
5,332,332,5,1,4,2,1
29,349,349,17,17,0,1,0
13,350,350,33,33,0,1,0
12,352,352,7,3,4,2,1
15,366,366,44,35,9,4,3
16,369,369,33,33,0,1,0
7,388,388,1,1,0,1,0
17,390,390,4,4,0,1,0
4,417,417,20,8,12,4,3
35,427,427,64,8,56,3,2
10,428,428,167,56,111,4,3
37,430,430,4,4,0,1,0
38,431,431,25,16,9,4,3
32,438,438,22,13,9,4,3
26,444,444,127,127,0,1,0
31,444,444,1,1,0,1,0
28,445,445,16,8,8,2,1
21,445,445,19,19,0,1,0
23,455,455,65,35,30,2,1
18,462,462,144,37,107,4,3
11,474,474,79,36,43,2,1
30,492,492,85,3,82,3,2

21,138,138,31,31,0,1,0
9,140,140,1,1,0,1,0
22,143,143,19,5,14,4,3
16,149,149,16,16,0,1,0
27,153,153,20,17,3,2,1
32,188,188,14,14,0,1,0
18,192,192,5,5,0,1,0
31,217,217,68,68,0,1,0
4,226,226,60,4,56,3,2
1,227,227,17,5,12,2,1
13,229,229,36,36,0,1,0
12,255,255,26,14,12,4,3
30,258,258,60,12,48,2,1
26,263,263,7,2,5,2,1
7,287,287,14,14,0,1,0
11,289,289,19,11,8,3,2
34,291,291,9,3,6,2,1
25,299,299,6,6,0,1,0
8,322,322,67,11,56,3,2
17,338,338,36,36,0,1,0
20,343,343,41,3,38,3,2
33,377,377,12,12,0,1,0
15,383,383,218,218,0,1,0
2,385,385,105,91,14,2,1
35,386,386,11,11,0,1,0
0,408,408,13,2,11,2,1
24,409,409,20,6,14,3,2
6,418,418,27,8,19,4,3
10,419,419,11,11,0,1,0
29,422,422,36,7,29,2,1
5,432,432,11,8,3,2,1
19,437,437,88,88,0,1,0
3,441,441,12,12,0,1,0
28,444,444,3,3,0,1,0
23,468,468,46,46,0,1,0
14,478,478,26,6,20,3,2

30,131,131,12,12,0,1,0
19,131,131,12,1,11,2,1
33,141,141,4,4,0,1,0
4,170,170,12,12,0,1,0
24,182,182,38,38,0,1,0
16,187,187,14,10,4,2,1
9,187,187,32,2,30,4,3
14,189,189,19,9,10,3,2
20,199,199,48,2,46,3,2
3,205,205,37,5,32,4,3
31,208,208,1,1,0,1,0
6,237,237,12,12,0,1,0
35,240,240,6,6,0,1,0
15,260,260,11,11,0,1,0
25,263,263,23,17,6,2,1
13,271,271,55,10,45,4,3
1,276,276,5,5,0,1,0
21,278,278,87,56,31,2,1
23,279,279,70,40,30,4,3
0,282,282,122,26,96,3,2
27,291,291,27,8,19,3,2
17,294,294,49,49,0,1,0
36,315,315,4,4,0,1,0
28,347,347,28,28,0,1,0
29,348,348,5,2,3,2,1
10,350,350,60,60,0,1,0
12,358,358,50,26,24,3,2
18,364,364,13,13,0,1,0
26,365,365,45,45,0,1,0
32,365,365,4,4,0,1,0
5,379,379,37,15,22,3,2
2,386,386,11,11,0,1,0
8,387,387,19,19,0,1,0
7,412,412,63,63,0,1,0
34,466,466,1,1,0,1,0
11,480,480,10,10,0,1,0
22,482,482,80,41,39,4,3

32,107,107,4,4,0,1,0
33,126,126,18,4,14,3,2
1,137,137,26,26,0,1,0
34,138,138,1,1,0,1,0
27,161,161,8,3,5,2,1
12,180,180,77,68,9,3,2
13,183,183,8,8,0,1,0
25,200,200,25,15,10,2,1
14,216,216,8,8,0,1,0
28,217,217,101,13,88,3,2
9,224,224,19,7,12,3,2
8,253,253,42,2,40,2,1
22,254,254,20,20,0,1,0
37,260,260,16,2,14,3,2
19,284,284,51,39,12,2,1
0,287,287,61,51,10,2,1
15,289,289,4,4,0,1,0
35,313,313,13,1,12,2,1
7,315,315,44,44,0,1,0
24,326,326,13,13,0,1,0
17,334,334,48,48,0,1,0
2,347,347,41,41,0,1,0
4,360,360,10,2,8,3,2
6,369,369,14,5,9,4,3
16,370,370,69,69,0,1,0
20,380,380,12,12,0,1,0
3,396,396,20,20,0,1,0
29,399,399,30,30,0,1,0
30,402,402,69,31,38,2,1
10,423,423,33,27,6,2,1
36,437,437,3,3,0,1,0
21,442,442,78,78,0,1,0
31,466,466,4,1,3,2,1
18,481,481,141,45,96,4,3
5,487,487,3,3,0,1,0
23,493,493,24,13,11,2,1
11,493,493,18,18,0,1,0
26,498,498,3,3,0,1,0

16,100,100,18,10,8,2,1
9,102,102,16,16,0,1,0
23,125,125,11,5,6,2,1
14,135,135,30,18,12,3,2
28,137,137,28,28,0,1,0
22,147,147,4,1,3,2,1
24,150,150,5,1,4,2,1
20,151,151,1,1,0,1,0
31,164,164,4,4,0,1,0
2,164,164,15,12,3,2,1
34,189,189,13,13,0,1,0
26,195,195,30,30,0,1,0
19,210,210,3,3,0,1,0
17,212,212,1,1,0,1,0
30,224,224,81,17,64,4,3
7,264,264,11,1,10,2,1
33,269,269,9,4,5,2,1
41,279,279,13,10,3,2,1
32,294,294,32,32,0,1,0
25,298,298,81,81,0,1,0
3,316,316,13,7,6,3,2
15,322,322,1,1,0,1,0
40,331,331,3,3,0,1,0
6,339,339,33,33,0,1,0
35,351,351,49,49,0,1,0
29,365,365,4,1,3,2,1
10,388,388,119,119,0,1,0
37,398,398,66,19,47,2,1
8,409,409,9,5,4,2,1
39,419,419,100,100,0,1,0
18,420,420,3,3,0,1,0
4,424,424,28,28,0,1,0
11,427,427,44,24,20,3,2
36,430,430,8,3,5,2,1
12,434,434,4,4,0,1,0
5,439,439,7,7,0,1,0
21,445,445,189,148,41,2,1
13,450,450,11,1,10,2,1
1,466,466,36,36,0,1,0
0,482,482,41,3,38,2,1
38,490,490,1,1,0,1,0
27,497,497,20,20,0,1,0

22,103,103,10,10,0,1,0
34,106,106,1,1,0,1,0
15,124,124,12,3,9,4,3
42,127,127,56,36,20,2,1
40,147,147,8,8,0,1,0
30,180,180,20,20,0,1,0
8,190,190,32,11,21,4,3
10,196,196,39,39,0,1,0
36,205,205,10,2,8,2,1
38,208,208,2,2,0,1,0
26,227,227,58,17,41,3,2
2,229,229,1,1,0,1,0
29,238,238,27,13,14,3,2
28,241,241,8,8,0,1,0
11,247,247,9,4,5,2,1
31,269,269,29,25,4,2,1
16,294,294,9,1,8,3,2
7,303,303,3,3,0,1,0
24,305,305,63,50,13,2,1
0,316,316,20,12,8,2,1
39,317,317,11,11,0,1,0
25,336,336,8,2,6,3,2
33,336,336,18,18,0,1,0
35,337,337,24,4,20,4,3
5,337,337,2,2,0,1,0
17,338,338,2,2,0,1,0
27,344,344,84,54,30,3,2
3,354,354,6,6,0,1,0
37,359,359,6,6,0,1,0
20,366,366,98,62,36,3,2
41,378,378,14,14,0,1,0
14,383,383,25,25,0,1,0
21,387,387,24,17,7,2,1
1,388,388,50,6,44,3,2
12,403,403,127,127,0,1,0
43,405,405,19,19,0,1,0
13,410,410,60,12,48,2,1
19,433,433,18,18,0,1,0
18,443,443,11,11,0,1,0
9,453,453,7,7,0,1,0
4,472,472,23,23,0,1,0
32,475,475,57,20,37,4,3
23,488,488,46,6,40,2,1
6,500,500,28,28,0,1,0

34,119,119,1,1,0,1,0
42,121,121,11,5,6,3,2
30,150,150,74,48,26,3,2
10,156,156,1,1,0,1,0
22,164,164,9,2,7,2,1
23,168,168,63,63,0,1,0
33,177,177,10,10,0,1,0
18,178,178,45,40,5,2,1
27,179,179,31,31,0,1,0
47,186,186,1,1,0,1,0
0,207,207,2,2,0,1,0
19,214,214,6,3,3,2,1
36,244,244,34,13,21,4,3
7,244,244,8,8,0,1,0
45,244,244,14,11,3,2,1
39,256,256,7,7,0,1,0
32,263,263,14,11,3,2,1
37,267,267,10,3,7,3,2
21,268,268,51,35,16,3,2
35,269,269,20,20,0,1,0
17,269,269,22,10,12,3,2
46,273,273,17,17,0,1,0
41,273,273,127,123,4,2,1
9,281,281,20,20,0,1,0
12,314,314,20,20,0,1,0
40,315,315,2,2,0,1,0
25,319,319,24,12,12,4,3
29,328,328,31,12,19,3,2
1,341,341,20,20,0,1,0
16,343,343,20,2,18,3,2
13,347,347,15,1,14,2,1
4,376,376,37,27,10,2,1
28,381,381,30,2,28,3,2
11,388,388,11,11,0,1,0
6,404,404,21,2,19,2,1
5,408,408,5,5,0,1,0
8,410,410,17,17,0,1,0
38,411,411,20,20,0,1,0
3,415,415,11,11,0,1,0
2,422,422,12,4,8,2,1
44,432,432,65,65,0,1,0
24,439,439,13,13,0,1,0
14,440,440,18,7,11,2,1
20,442,442,21,7,14,2,1
31,448,448,13,4,9,4,3
26,455,455,8,8,0,1,0
43,471,471,31,31,0,1,0
15,497,497,2,2,0,1,0

5,100,100,39,27,12,4,3
20,103,103,8,4,4,2,1
17,110,110,2,2,0,1,0
35,116,116,24,24,0,1,0
22,118,118,3,3,0,1,0
24,120,120,9,6,3,2,1
21,139,139,58,32,26,3,2
1,149,149,18,18,0,1,0
10,151,151,17,9,8,3,2
18,169,169,12,3,9,4,3
13,180,180,11,11,0,1,0
2,195,195,1,1,0,1,0
16,203,203,43,4,39,4,3
39,217,217,10,10,0,1,0
26,230,230,16,16,0,1,0
3,233,233,7,7,0,1,0
12,234,234,1,1,0,1,0
9,254,254,41,17,24,2,1
30,274,274,45,45,0,1,0
25,279,279,11,11,0,1,0
7,282,282,11,1,10,3,2
34,284,284,5,5,0,1,0
36,292,292,31,17,14,3,2
14,294,294,35,35,0,1,0
38,307,307,16,3,13,2,1
4,312,312,82,82,0,1,0
27,313,313,26,26,0,1,0
29,327,327,42,42,0,1,0
31,336,336,30,22,8,3,2
11,339,339,1,1,0,1,0
28,343,343,35,35,0,1,0
19,374,374,3,3,0,1,0
23,390,390,49,22,27,4,3
8,392,392,81,18,63,4,3
6,409,409,16,16,0,1,0
37,441,441,33,9,24,4,3
33,466,466,38,8,30,2,1
32,469,469,34,34,0,1,0
15,490,490,18,6,12,4,3
0,493,493,49,3,46,3,2

6,113,113,15,15,0,1,0
12,125,125,29,29,0,1,0
8,145,145,7,7,0,1,0
28,146,146,2,2,0,1,0
5,146,146,1,1,0,1,0
7,158,158,29,6,23,3,2
1,205,205,13,7,6,3,2
18,209,209,31,19,12,3,2
11,210,210,20,3,17,3,2
27,217,217,63,63,0,1,0
38,227,227,19,1,18,2,1
10,239,239,13,10,3,2,1
13,248,248,29,26,3,2,1
4,249,249,4,4,0,1,0
19,252,252,33,33,0,1,0
24,256,256,6,3,3,2,1
37,278,278,82,82,0,1,0
0,284,284,39,39,0,1,0
26,292,292,13,13,0,1,0
22,298,298,12,12,0,1,0
14,306,306,12,12,0,1,0
29,323,323,13,13,0,1,0
35,334,334,25,11,14,3,2
31,338,338,7,3,4,2,1
21,340,340,33,10,23,2,1
39,341,341,3,3,0,1,0
23,346,346,17,17,0,1,0
32,352,352,99,99,0,1,0
3,356,356,2,2,0,1,0
30,360,360,7,7,0,1,0
36,367,367,39,15,24,4,3
2,387,387,38,6,32,2,1
34,415,415,95,25,70,3,2
15,425,425,26,11,15,4,3
20,428,428,46,19,27,4,3
17,429,429,5,2,3,2,1
16,450,450,75,39,36,3,2
25,454,454,52,52,0,1,0
9,489,489,124,71,53,3,2
33,499,499,43,3,40,2,1

11,135,135,18,18,0,1,0
35,154,154,11,11,0,1,0
37,155,155,3,3,0,1,0
38,156,156,11,11,0,1,0
3,161,161,3,3,0,1,0
22,202,202,35,27,8,2,1
27,204,204,18,18,0,1,0
36,206,206,30,2,28,2,1
5,233,233,27,27,0,1,0
0,238,238,3,3,0,1,0
10,241,241,31,31,0,1,0
8,248,248,34,12,22,4,3
19,250,250,25,7,18,2,1
15,252,252,82,46,36,2,1
16,270,270,1,1,0,1,0
1,278,278,5,5,0,1,0
9,280,280,16,5,11,2,1
24,307,307,10,7,3,2,1
4,319,319,10,10,0,1,0
6,341,341,9,9,0,1,0
13,345,345,6,2,4,2,1
12,353,353,53,53,0,1,0
34,355,355,10,2,8,3,2
39,357,357,26,5,21,4,3
26,358,358,13,13,0,1,0
17,360,360,1,1,0,1,0
2,362,362,99,99,0,1,0
32,369,369,19,19,0,1,0
25,384,384,57,57,0,1,0
33,388,388,56,56,0,1,0
23,395,395,48,48,0,1,0
29,396,396,25,1,24,2,1
30,411,411,92,52,40,3,2
31,452,452,100,100,0,1,0
20,455,455,99,55,44,4,3
21,474,474,43,43,0,1,0
28,475,475,6,3,3,2,1
18,478,478,137,105,32,3,2
7,487,487,26,26,0,1,0
14,497,497,54,18,36,3,2

35,103,103,3,3,0,1,0
19,106,106,4,1,3,2,1
13,114,114,8,3,5,2,1
31,116,116,7,7,0,1,0
0,120,120,20,16,4,2,1
26,126,126,1,1,0,1,0
23,135,135,8,8,0,1,0
27,156,156,18,3,15,4,3
38,159,159,4,4,0,1,0
18,193,193,35,32,3,2,1
25,211,211,25,10,15,4,3
14,214,214,1,1,0,1,0
2,215,215,10,6,4,2,1
7,217,217,39,15,24,2,1
42,219,219,10,1,9,4,3
17,225,225,21,21,0,1,0
15,237,237,3,3,0,1,0
21,239,239,4,4,0,1,0
9,260,260,62,41,21,3,2
5,266,266,16,1,15,4,3
28,294,294,80,46,34,3,2
3,310,310,24,15,9,2,1
29,319,319,15,3,12,4,3
36,352,352,172,128,44,3,2
40,354,354,23,23,0,1,0
33,364,364,27,27,0,1,0
30,370,370,29,3,26,4,3
16,373,373,12,1,11,2,1
6,374,374,108,35,73,4,3
37,392,392,9,5,4,2,1
4,401,401,36,36,0,1,0
20,405,405,15,15,0,1,0
12,409,409,66,44,22,2,1
41,412,412,4,4,0,1,0
39,419,419,188,133,55,3,2
32,437,437,5,5,0,1,0
8,437,437,26,26,0,1,0
34,446,446,25,25,0,1,0
1,455,455,7,7,0,1,0
10,461,461,13,7,6,3,2
11,483,483,16,16,0,1,0
24,487,487,1,1,0,1,0
22,496,496,35,35,0,1,0

16,114,114,4,4,0,1,0
42,114,114,15,15,0,1,0
20,120,120,2,2,0,1,0
10,126,126,16,16,0,1,0
7,132,132,29,29,0,1,0
19,164,164,20,20,0,1,0
43,175,175,48,40,8,2,1
18,185,185,8,8,0,1,0
30,186,186,9,9,0,1,0
26,188,188,27,24,3,2,1
36,208,208,36,36,0,1,0
11,214,214,1,1,0,1,0
25,225,225,24,6,18,3,2
27,235,235,3,3,0,1,0
0,248,248,18,2,16,3,2
33,260,260,22,22,0,1,0
35,263,263,3,3,0,1,0
6,266,266,2,2,0,1,0
17,284,284,18,6,12,4,3
23,286,286,12,12,0,1,0
41,291,291,28,20,8,2,1
39,295,295,3,3,0,1,0
8,296,296,21,21,0,1,0
38,313,313,5,5,0,1,0
31,315,315,13,13,0,1,0
32,321,321,20,8,12,4,3
1,329,329,14,14,0,1,0
14,330,330,9,1,8,2,1
34,358,358,24,15,9,2,1
2,373,373,7,7,0,1,0
45,382,382,47,13,34,3,2
21,384,384,21,6,15,2,1
3,386,386,34,1,33,2,1
22,392,392,63,63,0,1,0
40,393,393,129,86,43,2,1
12,394,394,67,26,41,4,3
46,396,396,16,6,10,3,2
24,407,407,37,28,9,4,3
13,426,426,29,8,21,2,1
37,427,427,25,25,0,1,0
5,451,451,57,19,38,2,1
29,454,454,105,6,99,4,3
47,461,461,15,15,0,1,0
44,464,464,3,3,0,1,0
4,476,476,8,8,0,1,0
15,482,482,21,1,20,2,1
28,489,489,97,34,63,4,3
9,489,489,3,3,0,1,0

14,115,115,36,27,9,2,1
6,116,116,5,5,0,1,0
1,128,128,6,6,0,1,0
27,135,135,10,10,0,1,0
15,137,137,5,5,0,1,0
23,189,189,23,23,0,1,0
9,193,193,3,3,0,1,0
29,216,216,11,11,0,1,0
2,226,226,18,18,0,1,0
0,228,228,11,11,0,1,0
19,235,235,36,36,0,1,0
34,250,250,18,18,0,1,0
36,258,258,12,12,0,1,0
12,272,272,15,15,0,1,0
22,300,300,18,18,0,1,0
31,312,312,156,123,33,3,2
18,322,322,89,5,84,3,2
17,323,323,7,7,0,1,0
32,326,326,27,11,16,3,2
7,328,328,5,1,4,2,1
35,346,346,25,25,0,1,0
5,360,360,19,1,18,3,2
8,370,370,13,1,12,2,1
10,381,381,72,32,40,2,1
4,397,397,22,22,0,1,0
28,412,412,32,32,0,1,0
39,447,447,31,31,0,1,0
21,453,453,41,41,0,1,0
33,454,454,8,8,0,1,0
37,456,456,17,8,9,2,1
30,469,469,99,99,0,1,0
16,470,470,41,1,40,3,2
3,473,473,68,68,0,1,0
26,476,476,18,3,15,4,3
38,483,483,43,43,0,1,0
25,492,492,1,1,0,1,0
13,497,497,61,61,0,1,0
11,499,499,106,29,77,4,3
24,500,500,94,58,36,4,3
20,500,500,63,39,24,2,1

40,103,103,18,1,17,2,1
22,117,117,13,1,12,3,2
15,128,128,29,29,0,1,0
38,131,131,18,18,0,1,0
3,138,138,21,21,0,1,0
17,138,138,12,12,0,1,0
23,138,138,11,5,6,2,1
20,181,181,2,2,0,1,0
19,182,182,4,4,0,1,0
1,184,184,18,18,0,1,0
33,196,196,1,1,0,1,0
34,199,199,2,2,0,1,0
41,205,205,40,40,0,1,0
25,208,208,29,14,15,4,3
36,219,219,65,8,57,4,3
12,224,224,75,75,0,1,0
10,258,258,1,1,0,1,0
26,260,260,2,2,0,1,0
28,262,262,1,1,0,1,0
39,267,267,8,2,6,2,1
16,271,271,1,1,0,1,0
6,275,275,16,11,5,2,1
30,291,291,5,5,0,1,0
13,302,302,39,3,36,2,1
37,307,307,2,2,0,1,0
31,314,314,21,21,0,1,0
4,317,317,50,50,0,1,0
18,331,331,7,7,0,1,0
5,340,340,1,1,0,1,0
21,355,355,10,10,0,1,0
24,370,370,43,31,12,3,2
8,370,370,37,37,0,1,0
27,383,383,3,3,0,1,0
9,383,383,45,45,0,1,0
29,388,388,87,87,0,1,0
2,391,391,14,6,8,3,2
32,401,401,94,14,80,4,3
11,407,407,43,43,0,1,0
35,447,447,76,76,0,1,0
0,448,448,84,20,64,3,2
14,454,454,48,48,0,1,0
7,500,500,6,6,0,1,0

30,114,114,20,20,0,1,0
27,158,158,7,7,0,1,0
16,161,161,33,33,0,1,0
18,180,180,2,2,0,1,0
0,182,182,22,22,0,1,0
14,197,197,1,1,0,1,0
13,214,214,44,29,15,2,1
1,215,215,47,47,0,1,0
9,230,230,36,7,29,3,2
5,241,241,26,20,6,3,2
25,249,249,27,5,22,2,1
24,261,261,27,27,0,1,0
19,285,285,16,16,0,1,0
22,296,296,26,11,15,4,3
33,303,303,78,78,0,1,0
32,304,304,37,7,30,3,2
10,305,305,39,16,23,4,3
26,321,321,8,3,5,2,1
7,325,325,7,7,0,1,0
17,327,327,2,2,0,1,0
2,332,332,16,10,6,3,2
35,336,336,44,16,28,3,2
21,337,337,2,2,0,1,0
20,337,337,76,20,56,3,2
6,338,338,5,5,0,1,0
8,369,369,24,19,5,2,1
28,380,380,57,44,13,2,1
29,391,391,79,61,18,4,3
4,407,407,42,28,14,2,1
11,418,418,15,7,8,3,2
34,436,436,3,3,0,1,0
15,441,441,88,51,37,2,1
31,441,441,43,43,0,1,0
23,444,444,9,9,0,1,0
3,451,451,220,220,0,1,0
12,495,495,41,41,0,1,0

37,109,109,18,4,14,3,2
16,129,129,39,16,23,2,1
20,137,137,5,5,0,1,0
2,141,141,9,2,7,2,1
31,158,158,65,65,0,1,0
15,171,171,6,6,0,1,0
3,172,172,26,14,12,2,1
24,186,186,32,32,0,1,0
27,196,196,5,5,0,1,0
12,216,216,72,72,0,1,0
35,227,227,9,9,0,1,0
21,235,235,63,63,0,1,0
13,235,235,25,5,20,2,1
19,238,238,36,36,0,1,0
9,240,240,22,4,18,3,2
29,259,259,25,25,0,1,0
5,261,261,20,20,0,1,0
30,265,265,31,31,0,1,0
17,277,277,20,20,0,1,0
6,284,284,20,20,0,1,0
23,287,287,5,5,0,1,0
1,289,289,4,4,0,1,0
14,292,292,8,8,0,1,0
25,306,306,3,3,0,1,0
18,316,316,32,22,10,2,1
11,335,335,20,2,18,4,3
0,356,356,16,16,0,1,0
34,359,359,80,80,0,1,0
4,365,365,43,33,10,3,2
22,399,399,17,17,0,1,0
10,399,399,114,69,45,4,3
28,413,413,19,19,0,1,0
32,414,414,18,18,0,1,0
36,416,416,29,29,0,1,0
8,433,433,61,52,9,4,3
33,451,451,3,3,0,1,0
7,467,467,4,4,0,1,0
26,477,477,1,1,0,1,0

38,114,114,14,5,9,4,3
35,120,120,9,9,0,1,0
15,132,132,2,2,0,1,0
31,138,138,4,4,0,1,0
36,149,149,8,8,0,1,0
18,151,151,19,19,0,1,0
24,157,157,15,15,0,1,0
14,163,163,2,2,0,1,0
37,167,167,2,2,0,1,0
16,180,180,2,2,0,1,0
23,211,211,1,1,0,1,0
17,221,221,9,9,0,1,0
27,222,222,18,18,0,1,0
7,223,223,13,13,0,1,0
9,228,228,3,3,0,1,0
20,240,240,46,46,0,1,0
30,243,243,22,22,0,1,0
34,260,260,7,4,3,2,1
4,276,276,25,14,11,2,1
33,301,301,16,16,0,1,0
19,314,314,84,78,6,3,2
3,315,315,20,20,0,1,0
5,318,318,9,9,0,1,0
25,318,318,2,2,0,1,0
41,327,327,39,12,27,2,1
29,330,330,69,57,12,4,3
12,331,331,31,13,18,2,1
11,336,336,27,19,8,2,1
28,350,350,33,30,3,2,1
1,351,351,12,6,6,3,2
0,353,353,7,7,0,1,0
22,385,385,74,47,27,4,3
10,397,397,25,3,22,2,1
40,400,400,76,76,0,1,0
32,406,406,71,71,0,1,0
43,418,418,63,32,31,2,1
13,420,420,50,42,8,3,2
39,422,422,35,15,20,2,1
6,424,424,15,15,0,1,0
44,450,450,132,3,129,4,3
42,467,467,54,14,40,2,1
2,479,479,36,3,33,2,1
26,487,487,31,31,0,1,0
8,489,489,109,109,0,1,0
21,496,496,25,8,17,2,1

22,108,108,19,11,8,2,1
7,115,115,15,15,0,1,0
30,120,120,8,8,0,1,0
24,136,136,32,32,0,1,0
27,146,146,15,5,10,3,2
29,150,150,25,25,0,1,0
19,175,175,14,2,12,4,3
25,187,187,16,2,14,4,3
16,190,190,25,25,0,1,0
3,215,215,21,11,10,2,1
18,215,215,27,27,0,1,0
17,219,219,42,27,15,3,2
15,231,231,2,2,0,1,0
2,251,251,16,16,0,1,0
20,296,296,17,17,0,1,0
28,304,304,3,3,0,1,0
26,307,307,3,3,0,1,0
4,311,311,73,23,50,3,2
11,315,315,34,34,0,1,0
32,318,318,5,2,3,2,1
10,320,320,59,42,17,2,1
33,334,334,35,14,21,4,3
1,350,350,30,30,0,1,0
23,377,377,149,149,0,1,0
0,386,386,103,40,63,4,3
6,388,388,2,2,0,1,0
5,396,396,57,33,24,3,2
13,403,403,21,21,0,1,0
12,404,404,37,37,0,1,0
31,413,413,2,2,0,1,0
9,451,451,41,7,34,3,2
8,461,461,206,190,16,2,1
14,469,469,33,33,0,1,0
21,470,470,3,3,0,1,0

0,121,121,9,5,4,2,1
17,123,123,12,12,0,1,0
27,126,126,8,2,6,3,2
33,160,160,13,3,10,2,1
9,161,161,21,2,19,2,1
29,166,166,12,12,0,1,0
26,180,180,29,17,12,2,1
24,221,221,17,5,12,4,3
37,242,242,5,5,0,1,0
28,248,248,22,22,0,1,0
32,260,260,45,45,0,1,0
3,262,262,5,2,3,2,1
20,266,266,5,2,3,2,1
34,269,269,49,7,42,4,3
41,269,269,16,16,0,1,0
22,269,269,3,3,0,1,0
19,272,272,71,17,54,4,3
25,274,274,26,26,0,1,0
36,278,278,137,55,82,3,2
6,299,299,76,2,74,3,2
21,322,322,33,33,0,1,0
8,329,329,42,23,19,2,1
13,332,332,10,4,6,3,2
23,335,335,32,9,23,2,1
7,349,349,11,3,8,3,2
40,349,349,13,13,0,1,0
15,357,357,22,10,12,4,3
18,388,388,28,18,10,3,2
30,388,388,32,32,0,1,0
10,391,391,72,31,41,2,1
38,392,392,49,21,28,3,2
1,411,411,28,28,0,1,0
16,417,417,108,108,0,1,0
4,420,420,50,19,31,3,2
42,428,428,11,6,5,2,1
35,430,430,21,7,14,2,1
39,438,438,19,19,0,1,0
12,449,449,3,3,0,1,0
2,458,458,2,2,0,1,0
11,477,477,27,21,6,2,1
5,485,485,3,3,0,1,0
14,488,488,3,3,0,1,0
31,493,493,6,6,0,1,0

9,105,105,3,3,0,1,0
0,150,150,11,11,0,1,0
14,151,151,4,4,0,1,0
7,160,160,14,14,0,1,0
21,162,162,7,7,0,1,0
3,175,175,52,52,0,1,0
24,201,201,20,12,8,3,2
12,225,225,2,2,0,1,0
11,228,228,29,19,10,3,2
31,239,239,10,2,8,3,2
22,239,239,12,12,0,1,0
13,280,280,6,3,3,2,1
29,291,291,74,37,37,3,2
6,302,302,63,63,0,1,0
18,309,309,24,4,20,2,1
30,314,314,52,52,0,1,0
2,339,339,4,4,0,1,0
10,340,340,81,69,12,4,3
8,368,368,114,51,63,4,3
27,369,369,23,14,9,2,1
16,371,371,26,26,0,1,0
26,392,392,31,31,0,1,0
4,399,399,23,7,16,2,1
25,404,404,139,139,0,1,0
5,414,414,171,149,22,2,1
23,438,438,18,18,0,1,0
19,445,445,23,23,0,1,0
17,445,445,40,40,0,1,0
20,462,462,10,6,4,2,1
15,474,474,184,175,9,4,3
28,482,482,48,5,43,4,3
1,487,487,72,44,28,3,2

37,105,105,3,3,0,1,0
18,107,107,13,1,12,2,1
4,113,113,1,1,0,1,0
26,117,117,6,1,5,2,1
2,120,120,14,14,0,1,0
34,130,130,16,1,15,2,1
19,131,131,7,7,0,1,0
21,140,140,1,1,0,1,0
11,149,149,20,10,10,3,2
17,158,158,43,12,31,2,1
1,166,166,28,18,10,3,2
35,170,170,14,4,10,2,1
28,178,178,4,1,3,2,1
29,203,203,5,5,0,1,0
10,249,249,23,23,0,1,0
14,252,252,47,47,0,1,0
32,252,252,25,18,7,2,1
7,259,259,26,4,22,3,2
13,266,266,4,4,0,1,0
24,273,273,43,11,32,3,2
16,287,287,19,2,17,4,3
8,298,298,11,11,0,1,0
6,299,299,13,13,0,1,0
9,343,343,50,14,36,2,1
22,356,356,31,17,14,2,1
20,360,360,59,40,19,2,1
25,361,361,233,186,47,4,3
5,365,365,64,64,0,1,0
3,366,366,9,9,0,1,0
31,394,394,34,34,0,1,0
30,396,396,19,8,11,2,1
15,398,398,76,7,69,4,3
33,410,410,8,8,0,1,0
23,426,426,50,14,36,4,3
12,458,458,9,9,0,1,0
0,468,468,96,96,0,1,0
36,473,473,37,7,30,4,3
27,491,491,12,12,0,1,0

16,100,100,1,1,0,1,0
8,109,109,1,1,0,1,0
39,121,121,5,1,4,2,1
3,134,134,2,2,0,1,0
38,153,153,3,3,0,1,0
24,154,154,9,4,5,2,1
33,160,160,2,2,0,1,0
6,162,162,5,5,0,1,0
27,162,162,65,32,33,4,3
0,163,163,1,1,0,1,0
9,167,167,7,7,0,1,0
32,183,183,3,3,0,1,0
1,221,221,42,42,0,1,0
13,221,221,53,37,16,2,1
25,231,231,20,20,0,1,0
31,242,242,9,9,0,1,0
17,242,242,59,59,0,1,0
28,248,248,3,3,0,1,0
14,264,264,4,4,0,1,0
40,290,290,84,2,82,3,2
37,291,291,37,37,0,1,0
26,295,295,12,12,0,1,0
11,308,308,68,68,0,1,0
12,316,316,86,9,77,4,3
10,321,321,23,23,0,1,0
20,326,326,13,2,11,2,1
23,342,342,28,15,13,2,1
29,361,361,16,16,0,1,0
22,369,369,13,13,0,1,0
2,375,375,2,2,0,1,0
19,377,377,13,13,0,1,0
15,385,385,13,13,0,1,0
35,390,390,55,21,34,2,1
30,399,399,103,1,102,4,3
42,438,438,16,2,14,3,2
7,441,441,20,20,0,1,0
4,442,442,33,33,0,1,0
18,447,447,66,66,0,1,0
5,452,452,20,20,0,1,0
34,458,458,74,74,0,1,0
36,466,466,81,4,77,3,2
21,467,467,81,81,0,1,0
41,496,496,3,3,0,1,0

28,122,122,18,18,0,1,0
1,142,142,25,10,15,4,3
24,166,166,1,1,0,1,0
30,168,168,25,2,23,2,1
7,178,178,29,29,0,1,0
17,185,185,15,15,0,1,0
31,203,203,22,4,18,4,3
13,227,227,36,36,0,1,0
3,242,242,24,24,0,1,0
12,242,242,30,30,0,1,0
27,246,246,27,9,18,4,3
23,246,246,11,11,0,1,0
5,249,249,14,14,0,1,0
15,282,282,49,49,0,1,0
29,288,288,8,8,0,1,0
10,309,309,103,16,87,4,3
14,316,316,6,6,0,1,0
20,325,325,18,18,0,1,0
4,342,342,6,6,0,1,0
2,361,361,9,3,6,3,2
9,376,376,60,60,0,1,0
21,377,377,9,3,6,2,1
0,381,381,211,181,30,4,3
18,399,399,55,55,0,1,0
8,434,434,2,2,0,1,0
26,441,441,82,82,0,1,0
16,455,455,15,15,0,1,0
22,456,456,125,87,38,2,1
19,472,472,11,3,8,2,1
11,479,479,101,101,0,1,0
6,486,486,98,60,38,3,2
25,491,491,78,48,30,4,3

36,134,134,15,6,9,4,3
1,148,148,20,2,18,4,3
22,150,150,6,6,0,1,0
17,161,161,15,9,6,3,2
14,169,169,7,1,6,2,1
21,177,177,27,27,0,1,0
9,179,179,41,31,10,2,1
12,189,189,1,1,0,1,0
35,213,213,22,7,15,4,3
3,238,238,10,10,0,1,0
11,251,251,25,25,0,1,0
7,263,263,6,6,0,1,0
34,265,265,24,8,16,2,1
30,265,265,33,33,0,1,0
32,270,270,16,16,0,1,0
23,273,273,5,5,0,1,0
13,286,286,3,3,0,1,0
15,286,286,36,36,0,1,0
5,309,309,8,4,4,2,1
28,318,318,62,8,54,3,2
19,346,346,11,11,0,1,0
8,353,353,11,11,0,1,0
2,365,365,9,9,0,1,0
31,368,368,60,60,0,1,0
26,373,373,32,32,0,1,0
6,389,389,107,59,48,2,1
16,391,391,122,56,66,3,2
18,394,394,41,31,10,2,1
24,407,407,97,97,0,1,0
29,417,417,14,14,0,1,0
20,425,425,53,27,26,2,1
25,430,430,73,73,0,1,0
10,448,448,79,53,26,2,1
37,449,449,7,7,0,1,0
33,464,464,30,30,0,1,0
0,465,465,88,83,5,2,1
27,481,481,57,17,40,4,3
4,485,485,79,3,76,3,2

9,108,108,2,2,0,1,0
10,133,133,14,14,0,1,0
19,147,147,1,1,0,1,0
36,149,149,10,10,0,1,0
16,154,154,1,1,0,1,0
42,165,165,11,8,3,2,1
33,196,196,5,5,0,1,0
14,196,196,11,11,0,1,0
29,200,200,15,3,12,3,2
27,224,224,34,21,13,2,1
6,231,231,17,17,0,1,0
37,237,237,48,12,36,4,3
25,240,240,18,18,0,1,0
22,256,256,21,17,4,2,1
20,257,257,1,1,0,1,0
1,269,269,39,39,0,1,0
43,276,276,11,5,6,3,2
44,277,277,7,7,0,1,0
2,281,281,2,2,0,1,0
39,300,300,39,39,0,1,0
32,320,320,62,5,57,4,3
24,331,331,10,10,0,1,0
45,338,338,96,44,52,4,3
5,343,343,2,2,0,1,0
15,347,347,3,3,0,1,0
4,355,355,28,28,0,1,0
41,365,365,1,1,0,1,0
40,369,369,6,6,0,1,0
23,374,374,16,16,0,1,0
7,381,381,1,1,0,1,0
31,386,386,118,118,0,1,0
34,387,387,19,19,0,1,0
35,404,404,56,56,0,1,0
38,409,409,72,48,24,4,3
46,413,413,3,3,0,1,0
11,415,415,67,57,10,3,2
17,425,425,58,44,14,2,1
28,426,426,24,24,0,1,0
12,438,438,22,22,0,1,0
26,449,449,69,51,18,4,3
30,451,451,6,6,0,1,0
0,453,453,1,1,0,1,0
3,459,459,93,5,88,3,2
8,466,466,99,15,84,4,3
13,491,491,118,7,111,4,3
18,495,495,37,22,15,4,3
21,499,499,9,9,0,1,0

35,132,132,9,9,0,1,0
26,137,137,21,21,0,1,0
7,147,147,38,18,20,3,2
23,148,148,3,3,0,1,0
25,155,155,19,19,0,1,0
24,157,157,7,7,0,1,0
38,170,170,31,31,0,1,0
15,173,173,42,15,27,2,1
17,184,184,2,2,0,1,0
29,185,185,2,2,0,1,0
11,190,190,15,7,8,3,2
13,202,202,5,5,0,1,0
1,207,207,6,3,3,2,1
6,210,210,41,25,16,2,1
0,221,221,83,83,0,1,0
19,222,222,38,38,0,1,0
32,263,263,17,17,0,1,0
28,266,266,3,3,0,1,0
34,302,302,1,1,0,1,0
21,305,305,54,54,0,1,0
31,311,311,8,4,4,2,1
39,313,313,38,20,18,2,1
27,315,315,10,1,9,3,2
4,327,327,14,11,3,2,1
3,329,329,28,28,0,1,0
20,348,348,54,48,6,3,2
8,364,364,29,29,0,1,0
18,371,371,9,4,5,2,1
10,376,376,1,1,0,1,0
37,379,379,114,114,0,1,0
33,380,380,95,3,92,3,2
16,390,390,21,21,0,1,0
22,396,396,73,25,48,3,2
2,397,397,2,2,0,1,0
36,414,414,23,2,21,4,3
12,424,424,68,21,47,4,3
9,445,445,15,15,0,1,0
14,482,482,30,30,0,1,0
30,485,485,31,21,10,3,2
5,496,496,32,8,24,4,3

6,102,102,1,1,0,1,0
21,105,105,11,2,9,4,3
30,107,107,9,3,6,2,1
0,152,152,7,7,0,1,0
36,152,152,12,3,9,4,3
27,166,166,27,21,6,3,2
34,175,175,10,10,0,1,0
4,195,195,21,21,0,1,0
29,200,200,9,5,4,2,1
8,201,201,6,6,0,1,0
25,203,203,16,1,15,4,3
15,228,228,25,1,24,3,2
32,235,235,1,1,0,1,0
28,265,265,25,25,0,1,0
23,272,272,6,6,0,1,0
26,278,278,9,9,0,1,0
5,299,299,19,19,0,1,0
7,308,308,20,8,12,4,3
19,308,308,38,2,36,4,3
14,309,309,20,8,12,3,2
18,312,312,10,10,0,1,0
22,332,332,6,6,0,1,0
16,338,338,101,101,0,1,0
10,342,342,45,15,30,4,3
38,354,354,67,36,31,2,1
39,359,359,71,71,0,1,0
11,362,362,6,6,0,1,0
13,372,372,128,78,50,3,2
9,384,384,1,1,0,1,0
20,398,398,48,48,0,1,0
12,399,399,81,47,34,3,2
3,404,404,10,10,0,1,0
31,412,412,24,24,0,1,0
37,432,432,92,68,24,3,2
17,440,440,3,3,0,1,0
24,444,444,37,37,0,1,0
2,458,458,85,85,0,1,0
33,468,468,175,126,49,3,2
35,491,491,9,9,0,1,0
1,498,498,67,30,37,4,3

12,111,111,7,7,0,1,0
34,121,121,4,4,0,1,0
3,126,126,4,4,0,1,0
4,138,138,1,1,0,1,0
19,173,173,42,15,27,4,3
30,175,175,22,19,3,2,1
14,180,180,13,3,10,3,2
28,183,183,4,1,3,2,1
26,201,201,11,4,7,2,1
38,202,202,84,30,54,4,3
21,215,215,5,5,0,1,0
36,251,251,1,1,0,1,0
2,253,253,10,10,0,1,0
31,272,272,6,6,0,1,0
6,272,272,25,1,24,3,2
13,298,298,1,1,0,1,0
16,299,299,74,6,68,3,2
22,313,313,17,17,0,1,0
9,324,324,4,4,0,1,0
18,325,325,8,3,5,2,1
24,332,332,32,32,0,1,0
37,338,338,18,3,15,4,3
27,343,343,138,111,27,4,3
0,345,345,56,56,0,1,0
29,360,360,9,5,4,2,1
23,368,368,39,29,10,3,2
10,387,387,126,108,18,4,3
7,388,388,51,51,0,1,0
11,393,393,9,6,3,2,1
5,394,394,10,10,0,1,0
15,402,402,19,1,18,2,1
33,410,410,88,72,16,2,1
32,425,425,1,1,0,1,0
17,445,445,113,29,84,3,2
8,456,456,10,10,0,1,0
1,488,488,86,37,49,2,1
25,493,493,29,3,26,3,2
39,499,499,36,30,6,2,1
35,499,499,38,21,17,2,1
20,499,499,86,86,0,1,0

11,106,106,1,1,0,1,0
5,152,152,11,2,9,4,3
39,160,160,19,14,5,2,1
37,164,164,6,3,3,2,1
30,174,174,11,11,0,1,0
16,184,184,11,11,0,1,0
12,191,191,12,2,10,2,1
14,202,202,17,17,0,1,0
18,215,215,6,1,5,2,1
13,227,227,6,6,0,1,0
17,236,236,30,30,0,1,0
8,239,239,22,5,17,2,1
23,240,240,22,22,0,1,0
25,270,270,17,17,0,1,0
24,271,271,28,28,0,1,0
29,297,297,8,3,5,2,1
22,298,298,8,8,0,1,0
7,300,300,9,9,0,1,0
4,312,312,125,113,12,4,3
20,314,314,74,2,72,3,2
21,334,334,89,80,9,2,1
28,335,335,84,84,0,1,0
33,367,367,20,5,15,3,2
36,370,370,21,5,16,3,2
19,392,392,42,17,25,2,1
15,396,396,17,17,0,1,0
34,407,407,57,45,12,2,1
32,413,413,58,29,29,2,1
2,416,416,157,59,98,3,2
27,439,439,10,4,6,3,2
31,440,440,1,1,0,1,0
9,444,444,28,14,14,2,1
26,446,446,21,10,11,2,1
38,446,446,9,9,0,1,0
3,447,447,10,2,8,3,2
1,455,455,55,5,50,2,1
6,464,464,109,109,0,1,0
10,479,479,18,9,9,2,1
35,487,487,129,79,50,4,3
0,495,495,1,1,0,1,0

28,109,109,22,14,8,3,2
24,111,111,5,5,0,1,0
40,120,120,6,3,3,2,1
7,132,132,9,3,6,2,1
6,132,132,7,2,5,2,1
0,140,140,13,13,0,1,0
38,142,142,16,16,0,1,0
23,152,152,3,3,0,1,0
39,154,154,17,17,0,1,0
36,162,162,36,36,0,1,0
19,176,176,6,2,4,2,1
9,214,214,19,4,15,2,1
4,221,221,9,5,4,2,1
29,224,224,33,33,0,1,0
13,226,226,25,25,0,1,0
17,265,265,21,21,0,1,0
20,273,273,68,17,51,3,2
41,274,274,16,16,0,1,0
30,280,280,5,5,0,1,0
15,301,301,32,3,29,2,1
1,314,314,2,2,0,1,0
3,335,335,25,25,0,1,0
31,339,339,6,6,0,1,0
27,351,351,62,62,0,1,0
32,359,359,17,17,0,1,0
16,360,360,8,8,0,1,0
11,362,362,87,87,0,1,0
35,362,362,6,6,0,1,0
10,370,370,24,6,18,4,3
5,379,379,40,40,0,1,0
2,385,385,32,32,0,1,0
26,426,426,220,142,78,4,3
25,433,433,15,15,0,1,0
18,447,447,6,6,0,1,0
37,452,452,11,3,8,3,2
8,454,454,98,33,65,3,2
22,470,470,36,6,30,3,2
12,472,472,68,68,0,1,0
21,482,482,12,3,9,2,1
34,489,489,59,59,0,1,0
33,493,493,9,9,0,1,0
14,494,494,41,41,0,1,0

5,113,113,6,6,0,1,0
27,123,123,3,3,0,1,0
11,127,127,3,3,0,1,0
4,140,140,9,9,0,1,0
34,146,146,1,1,0,1,0
16,149,149,9,9,0,1,0
7,158,158,10,10,0,1,0
15,162,162,15,6,9,2,1
20,172,172,118,92,26,2,1
30,211,211,20,5,15,4,3
39,214,214,12,12,0,1,0
21,226,226,3,3,0,1,0
1,228,228,4,4,0,1,0
12,240,240,17,13,4,2,1
24,263,263,40,40,0,1,0
33,270,270,61,19,42,4,3
23,270,270,11,7,4,2,1
3,279,279,40,6,34,3,2
14,280,280,10,10,0,1,0
0,282,282,59,59,0,1,0
31,303,303,19,3,16,2,1
32,304,304,24,14,10,2,1
25,315,315,58,25,33,2,1
8,325,325,57,57,0,1,0
13,348,348,1,1,0,1,0
28,354,354,15,2,13,2,1
40,366,366,93,93,0,1,0
2,372,372,1,1,0,1,0
38,373,373,17,7,10,2,1
17,381,381,5,5,0,1,0
26,385,385,48,48,0,1,0
18,388,388,39,23,16,3,2
37,390,390,72,44,28,3,2
19,392,392,13,13,0,1,0
10,414,414,30,8,22,3,2
35,419,419,145,83,62,3,2
29,422,422,21,6,15,2,1
6,431,431,16,16,0,1,0
9,459,459,22,22,0,1,0
22,472,472,15,8,7,2,1
36,479,479,10,1,9,4,3

20,100,100,1,1,0,1,0
34,103,103,11,1,10,3,2
36,104,104,1,1,0,1,0
32,105,105,8,8,0,1,0
24,112,112,9,9,0,1,0
37,129,129,7,1,6,2,1
40,129,129,4,4,0,1,0
18,130,130,7,7,0,1,0
23,132,132,10,10,0,1,0
9,144,144,59,43,16,2,1
12,156,156,9,1,8,3,2
16,157,157,35,35,0,1,0
11,159,159,23,6,17,2,1
39,190,190,6,6,0,1,0
30,212,212,71,41,30,4,3
33,213,213,6,6,0,1,0
15,246,246,15,15,0,1,0
38,277,277,47,26,21,4,3
0,287,287,14,8,6,2,1
21,289,289,23,15,8,3,2
17,301,301,1,1,0,1,0
13,304,304,13,9,4,2,1
31,320,320,1,1,0,1,0
25,324,324,2,2,0,1,0
8,328,328,5,5,0,1,0
5,333,333,61,38,23,2,1
22,343,343,54,54,0,1,0
4,343,343,5,5,0,1,0
10,347,347,9,3,6,3,2
6,357,357,40,40,0,1,0
2,369,369,28,16,12,4,3
28,378,378,22,22,0,1,0
41,394,394,151,101,50,2,1
29,409,409,13,13,0,1,0
3,422,422,69,30,39,4,3
35,432,432,28,28,0,1,0
1,443,443,25,13,12,3,2
19,447,447,43,43,0,1,0
7,447,447,42,42,0,1,0
14,471,471,14,14,0,1,0
27,473,473,50,3,47,2,1
26,496,496,119,68,51,4,3

19,117,117,7,3,4,2,1
28,148,148,5,2,3,2,1
33,170,170,30,30,0,1,0
39,172,172,11,2,9,4,3
8,181,181,15,15,0,1,0
9,194,194,30,30,0,1,0
24,194,194,8,8,0,1,0
0,196,196,1,1,0,1,0
41,221,221,54,36,18,4,3
27,222,222,3,3,0,1,0
21,241,241,37,16,21,4,3
20,252,252,8,8,0,1,0
30,266,266,17,5,12,4,3
29,272,272,73,43,30,4,3
25,276,276,2,2,0,1,0
36,283,283,1,1,0,1,0
38,288,288,4,4,0,1,0
6,295,295,25,25,0,1,0
3,300,300,17,17,0,1,0
37,304,304,11,11,0,1,0
26,307,307,112,13,99,4,3
7,309,309,13,7,6,3,2
22,315,315,23,23,0,1,0
40,322,322,18,2,16,3,2
12,328,328,32,16,16,3,2
17,335,335,26,26,0,1,0
18,337,337,78,78,0,1,0
11,352,352,26,10,16,3,2
4,359,359,12,2,10,2,1
31,372,372,39,39,0,1,0
2,374,374,27,13,14,3,2
5,384,384,172,172,0,1,0
32,390,390,65,53,12,4,3
10,404,404,10,4,6,2,1
13,425,425,10,10,0,1,0
1,426,426,2,2,0,1,0
42,430,430,62,62,0,1,0
16,447,447,16,16,0,1,0
35,473,473,35,21,14,3,2
23,474,474,10,10,0,1,0
14,478,478,50,50,0,1,0
15,485,485,15,9,6,2,1
34,500,500,73,25,48,3,2

31,119,119,11,2,9,2,1
9,126,126,41,41,0,1,0
2,221,221,53,53,0,1,0
20,227,227,30,30,0,1,0
19,237,237,24,9,15,2,1
5,238,238,9,1,8,2,1
16,249,249,6,2,4,2,1
14,260,260,3,3,0,1,0
22,276,276,2,2,0,1,0
24,278,278,32,32,0,1,0
28,288,288,15,15,0,1,0
13,290,290,3,3,0,1,0
11,300,300,165,157,8,2,1
27,327,327,53,53,0,1,0
3,328,328,1,1,0,1,0
15,331,331,95,95,0,1,0
32,347,347,96,53,43,3,2
26,348,348,48,8,40,4,3
18,354,354,54,54,0,1,0
12,356,356,55,31,24,4,3
21,391,391,52,28,24,3,2
0,393,393,28,16,12,3,2
8,402,402,4,4,0,1,0
25,409,409,76,65,11,2,1
30,414,414,35,35,0,1,0
7,418,418,8,2,6,2,1
10,440,440,185,70,115,4,3
23,445,445,5,5,0,1,0
6,447,447,7,7,0,1,0
17,451,451,4,4,0,1,0
1,465,465,26,26,0,1,0
4,473,473,47,35,12,3,2
29,477,477,25,17,8,2,1

23,120,120,9,9,0,1,0
41,142,142,38,38,0,1,0
21,157,157,4,4,0,1,0
34,162,162,12,3,9,2,1
3,164,164,3,3,0,1,0
2,165,165,47,47,0,1,0
4,167,167,1,1,0,1,0
1,189,189,3,3,0,1,0
30,191,191,22,22,0,1,0
25,203,203,14,4,10,2,1
29,222,222,17,17,0,1,0
16,235,235,21,21,0,1,0
15,243,243,1,1,0,1,0
17,251,251,23,10,13,2,1
18,268,268,11,11,0,1,0
37,270,270,1,1,0,1,0
8,286,286,28,18,10,3,2
5,290,290,7,7,0,1,0
0,300,300,12,12,0,1,0
7,315,315,28,8,20,3,2
26,334,334,4,4,0,1,0
38,339,339,21,4,17,4,3
14,355,355,10,10,0,1,0
28,355,355,34,13,21,2,1
20,363,363,29,12,17,2,1
6,374,374,63,52,11,2,1
24,377,377,22,1,21,3,2
42,382,382,42,12,30,3,2
32,383,383,42,42,0,1,0
33,396,396,8,8,0,1,0
39,396,396,63,17,46,4,3
27,403,403,168,168,0,1,0
40,407,407,19,19,0,1,0
35,412,412,14,14,0,1,0
12,417,417,106,22,84,3,2
19,435,435,47,13,34,4,3
11,448,448,47,47,0,1,0
36,455,455,66,26,40,3,2
22,464,464,2,2,0,1,0
9,482,482,61,13,48,4,3
31,484,484,42,42,0,1,0
13,487,487,25,8,17,2,1
10,495,495,123,36,87,4,3

30,105,105,4,4,0,1,0
39,133,133,7,7,0,1,0
24,157,157,5,5,0,1,0
27,161,161,3,3,0,1,0
21,174,174,24,2,22,3,2
23,175,175,16,16,0,1,0
4,181,181,31,11,20,2,1
3,191,191,72,72,0,1,0
32,209,209,13,13,0,1,0
33,222,222,1,1,0,1,0
14,230,230,32,17,15,2,1
18,246,246,36,36,0,1,0
28,252,252,96,96,0,1,0
38,265,265,34,34,0,1,0
20,265,265,6,6,0,1,0
19,268,268,27,27,0,1,0
10,269,269,14,10,4,2,1
11,269,269,58,9,49,4,3
29,273,273,11,11,0,1,0
0,292,292,26,26,0,1,0
36,292,292,80,80,0,1,0
1,296,296,6,3,3,2,1
22,299,299,22,3,19,2,1
13,304,304,28,28,0,1,0
34,315,315,8,8,0,1,0
17,325,325,40,40,0,1,0
8,353,353,13,13,0,1,0
26,368,368,20,3,17,3,2
25,405,405,42,42,0,1,0
9,414,414,16,16,0,1,0
5,418,418,1,1,0,1,0
7,428,428,16,11,5,2,1
16,432,432,57,23,34,3,2
2,451,451,10,10,0,1,0
15,457,457,12,1,11,2,1
31,462,462,11,2,9,4,3
37,466,466,177,108,69,4,3
35,468,468,41,11,30,2,1
6,469,469,53,49,4,2,1
12,497,497,33,33,0,1,0

16,102,102,1,1,0,1,0
33,129,129,6,6,0,1,0
18,152,152,3,3,0,1,0
35,161,161,13,6,7,2,1
42,162,162,8,1,7,2,1
28,166,166,31,31,0,1,0
6,170,170,2,2,0,1,0
20,183,183,31,12,19,2,1
4,186,186,37,2,35,2,1
25,188,188,17,17,0,1,0
45,192,192,44,44,0,1,0
43,201,201,27,27,0,1,0
9,209,209,4,1,3,2,1
5,215,215,63,63,0,1,0
7,219,219,7,1,6,2,1
26,220,220,9,9,0,1,0
27,223,223,16,16,0,1,0
8,228,228,16,16,0,1,0
3,251,251,4,4,0,1,0
34,255,255,15,15,0,1,0
47,324,324,38,38,0,1,0
30,338,338,1,1,0,1,0
39,339,339,33,33,0,1,0
29,348,348,15,15,0,1,0
11,355,355,30,30,0,1,0
21,362,362,4,4,0,1,0
12,367,367,34,15,19,2,1
23,368,368,3,3,0,1,0
14,376,376,18,2,16,2,1
31,379,379,3,3,0,1,0
37,383,383,43,17,26,2,1
0,384,384,37,37,0,1,0
40,390,390,4,4,0,1,0
15,393,393,5,5,0,1,0
38,394,394,96,36,60,4,3
24,405,405,5,5,0,1,0
13,428,428,36,36,0,1,0
46,439,439,25,25,0,1,0
17,440,440,39,27,12,3,2
10,444,444,3,3,0,1,0
22,452,452,55,23,32,3,2
36,455,455,59,59,0,1,0
32,463,463,75,35,40,3,2
44,467,467,9,3,6,3,2
19,483,483,9,9,0,1,0
41,486,486,120,120,0,1,0
1,497,497,52,34,18,2,1
2,497,497,84,52,32,2,1

27,112,112,3,3,0,1,0
30,118,118,3,3,0,1,0
28,120,120,1,1,0,1,0
5,131,131,19,19,0,1,0
21,143,143,12,1,11,2,1
37,144,144,7,4,3,2,1
11,148,148,17,7,10,3,2
23,187,187,1,1,0,1,0
4,188,188,13,13,0,1,0
19,196,196,13,1,12,4,3
9,212,212,4,4,0,1,0
18,229,229,15,10,5,2,1
14,262,262,21,8,13,2,1
22,268,268,51,18,33,2,1
24,278,278,90,24,66,3,2
6,283,283,18,18,0,1,0
15,294,294,34,34,0,1,0
36,305,305,21,21,0,1,0
3,308,308,88,88,0,1,0
20,313,313,87,55,32,4,3
29,325,325,9,9,0,1,0
40,326,326,33,33,0,1,0
12,330,330,13,7,6,2,1
17,330,330,18,3,15,2,1
2,366,366,33,6,27,2,1
38,372,372,18,18,0,1,0
32,377,377,1,1,0,1,0
31,379,379,103,83,20,3,2
8,383,383,31,31,0,1,0
1,385,385,15,15,0,1,0
35,392,392,69,60,9,4,3
13,396,396,21,1,20,2,1
7,403,403,33,15,18,2,1
26,420,420,53,21,32,2,1
34,470,470,43,43,0,1,0
39,470,470,74,68,6,2,1
25,478,478,8,4,4,2,1
33,479,479,118,59,59,4,3
10,483,483,20,20,0,1,0
0,492,492,53,24,29,3,2
16,497,497,55,55,0,1,0

2,111,111,4,4,0,1,0
19,130,130,27,16,11,4,3
8,137,137,9,9,0,1,0
12,141,141,42,38,4,2,1
32,150,150,7,4,3,2,1
23,151,151,1,1,0,1,0
34,156,156,6,6,0,1,0
15,159,159,4,4,0,1,0
7,187,187,8,8,0,1,0
11,197,197,25,8,17,2,1
10,200,200,30,16,14,3,2
6,208,208,67,32,35,2,1
5,211,211,4,4,0,1,0
36,224,224,29,29,0,1,0
28,224,224,16,9,7,2,1
16,246,246,9,9,0,1,0
4,247,247,62,55,7,2,1
22,254,254,128,53,75,4,3
18,257,257,16,9,7,2,1
37,268,268,5,5,0,1,0
20,268,268,24,16,8,3,2
21,271,271,13,2,11,2,1
9,276,276,41,41,0,1,0
30,288,288,17,5,12,3,2
33,301,301,15,15,0,1,0
3,319,319,71,35,36,4,3
17,325,325,48,19,29,2,1
0,334,334,9,6,3,2,1
25,389,389,15,15,0,1,0
1,396,396,26,10,16,2,1
27,421,421,2,2,0,1,0
31,431,431,61,41,20,2,1
26,447,447,26,8,18,2,1
24,449,449,65,20,45,2,1
35,453,453,73,73,0,1,0
29,481,481,76,76,0,1,0
14,485,485,1,1,0,1,0
13,493,493,8,8,0,1,0

23,103,103,4,4,0,1,0
0,151,151,46,14,32,3,2
16,153,153,4,4,0,1,0
26,174,174,25,22,3,2,1
11,179,179,24,11,13,4,3
33,180,180,26,14,12,4,3
29,183,183,14,8,6,2,1
34,194,194,10,4,6,3,2
6,198,198,76,76,0,1,0
12,199,199,44,30,14,3,2
24,200,200,6,3,3,2,1
17,205,205,45,9,36,4,3
20,224,224,52,52,0,1,0
25,237,237,14,14,0,1,0
28,256,256,68,8,60,3,2
15,260,260,14,2,12,4,3
5,263,263,24,24,0,1,0
14,263,263,1,1,0,1,0
19,298,298,24,3,21,3,2
1,323,323,41,41,0,1,0
31,323,323,4,4,0,1,0
30,341,341,76,76,0,1,0
9,348,348,29,23,6,3,2
22,352,352,57,57,0,1,0
18,353,353,31,13,18,3,2
8,357,357,30,30,0,1,0
10,358,358,60,60,0,1,0
3,370,370,70,8,62,3,2
21,371,371,2,2,0,1,0
7,377,377,14,7,7,2,1
35,383,383,17,17,0,1,0
32,399,399,6,6,0,1,0
4,412,412,23,1,22,2,1
27,419,419,27,27,0,1,0
13,447,447,16,1,15,2,1
2,454,454,3,3,0,1,0
36,489,489,40,40,0,1,0

17,105,105,2,2,0,1,0
5,123,123,2,2,0,1,0
8,126,126,18,8,10,3,2
26,129,129,6,6,0,1,0
40,139,139,3,3,0,1,0
21,143,143,6,6,0,1,0
18,148,148,4,1,3,2,1
1,159,159,20,20,0,1,0
9,161,161,1,1,0,1,0
13,170,170,12,12,0,1,0
12,192,192,12,12,0,1,0
0,207,207,53,24,29,2,1
2,209,209,27,27,0,1,0
35,211,211,32,32,0,1,0
15,264,264,125,8,117,4,3
7,269,269,15,9,6,2,1
6,294,294,16,10,6,2,1
34,295,295,42,42,0,1,0
29,295,295,4,4,0,1,0
11,296,296,6,6,0,1,0
20,300,300,20,12,8,3,2
31,302,302,12,3,9,2,1
19,312,312,3,3,0,1,0
32,326,326,120,39,81,4,3
30,333,333,17,2,15,4,3
39,336,336,11,4,7,3,2
37,346,346,37,37,0,1,0
38,347,347,31,7,24,2,1
33,358,358,12,3,9,4,3
24,361,361,27,3,24,2,1
14,369,369,4,4,0,1,0
23,369,369,3,3,0,1,0
10,388,388,14,14,0,1,0
22,392,392,69,3,66,4,3
36,412,412,99,99,0,1,0
16,425,425,111,104,7,2,1
4,430,430,1,1,0,1,0
28,431,431,53,53,0,1,0
25,457,457,36,12,24,4,3
3,463,463,72,2,70,4,3
27,490,490,92,92,0,1,0

12,103,103,16,16,0,1,0
35,110,110,5,2,3,2,1
17,114,114,3,3,0,1,0
8,120,120,2,2,0,1,0
13,172,172,3,3,0,1,0
24,174,174,2,2,0,1,0
30,177,177,27,1,26,2,1
3,187,187,41,41,0,1,0
22,190,190,5,5,0,1,0
28,198,198,24,24,0,1,0
33,199,199,18,18,0,1,0
21,204,204,66,2,64,3,2
23,212,212,10,1,9,2,1
0,235,235,20,6,14,2,1
32,259,259,77,3,74,3,2
31,270,270,5,5,0,1,0
14,279,279,107,107,0,1,0
18,291,291,66,66,0,1,0
25,294,294,20,4,16,2,1
1,311,311,7,7,0,1,0
7,334,334,3,3,0,1,0
15,334,334,6,6,0,1,0
11,343,343,12,12,0,1,0
37,356,356,17,4,13,4,3
9,366,366,10,10,0,1,0
20,375,375,2,2,0,1,0
27,391,391,47,47,0,1,0
10,418,418,56,16,40,3,2
29,424,424,16,16,0,1,0
5,436,436,90,45,45,4,3
4,442,442,17,17,0,1,0
34,446,446,80,34,46,2,1
16,449,449,139,139,0,1,0
19,450,450,5,5,0,1,0
36,455,455,116,116,0,1,0
2,459,459,15,15,0,1,0
26,464,464,36,26,10,2,1
38,475,475,50,2,48,4,3
6,486,486,19,6,13,3,2

26,103,103,6,1,5,2,1
36,106,106,8,8,0,1,0
7,116,116,1,1,0,1,0
44,118,118,53,2,51,4,3
41,129,129,27,5,22,3,2
37,133,133,4,1,3,2,1
3,135,135,24,1,23,2,1
35,137,137,19,19,0,1,0
21,142,142,1,1,0,1,0
28,155,155,6,2,4,2,1
17,158,158,1,1,0,1,0
42,160,160,17,12,5,2,1
9,169,169,56,56,0,1,0
34,174,174,7,7,0,1,0
32,181,181,10,5,5,2,1
0,182,182,2,2,0,1,0
11,183,183,16,16,0,1,0
33,195,195,49,16,33,4,3
15,200,200,35,35,0,1,0
16,218,218,2,2,0,1,0
13,221,221,1,1,0,1,0
38,238,238,26,26,0,1,0
39,254,254,1,1,0,1,0
22,259,259,7,4,3,2,1
30,261,261,3,3,0,1,0
1,276,276,18,12,6,2,1
12,290,290,56,32,24,4,3
45,294,294,5,5,0,1,0
18,296,296,6,6,0,1,0
31,314,314,16,16,0,1,0
8,335,335,16,10,6,2,1
25,354,354,34,2,32,3,2
27,357,357,30,30,0,1,0
40,364,364,33,9,24,4,3
19,371,371,97,97,0,1,0
5,378,378,38,8,30,3,2
43,381,381,60,60,0,1,0
4,386,386,13,13,0,1,0
29,389,389,27,27,0,1,0
23,424,424,12,4,8,3,2
20,461,461,1,1,0,1,0
14,479,479,70,27,43,2,1
6,485,485,6,2,4,2,1
2,490,490,41,5,36,4,3
24,490,490,9,9,0,1,0
10,493,493,23,23,0,1,0

33,102,102,12,3,9,4,3
15,133,133,1,1,0,1,0
17,138,138,12,12,0,1,0
35,138,138,15,9,6,3,2
1,138,138,5,5,0,1,0
34,145,145,5,5,0,1,0
9,149,149,1,1,0,1,0
42,179,179,32,16,16,2,1
18,188,188,5,5,0,1,0
6,194,194,2,2,0,1,0
14,198,198,13,13,0,1,0
26,201,201,29,29,0,1,0
28,204,204,13,4,9,4,3
13,208,208,18,18,0,1,0
22,217,217,13,13,0,1,0
23,224,224,26,26,0,1,0
30,226,226,2,2,0,1,0
38,229,229,38,38,0,1,0
20,231,231,51,51,0,1,0
19,252,252,14,14,0,1,0
10,276,276,18,18,0,1,0
25,280,280,16,11,5,2,1
8,304,304,11,11,0,1,0
32,304,304,51,51,0,1,0
29,305,305,46,30,16,2,1
40,311,311,7,3,4,2,1
21,316,316,29,11,18,2,1
36,338,338,58,58,0,1,0
39,351,351,2,2,0,1,0
41,378,378,57,57,0,1,0
3,379,379,72,72,0,1,0
5,379,379,14,14,0,1,0
31,381,381,41,41,0,1,0
24,406,406,62,47,15,2,1
37,418,418,5,5,0,1,0
16,433,433,25,25,0,1,0
12,439,439,9,9,0,1,0
0,442,442,3,3,0,1,0
2,447,447,72,8,64,3,2
11,448,448,77,44,33,2,1
27,453,453,73,73,0,1,0
7,458,458,38,38,0,1,0
43,472,472,31,31,0,1,0
4,481,481,146,136,10,2,1

16,107,107,1,1,0,1,0
7,112,112,3,3,0,1,0
14,113,113,7,7,0,1,0
11,117,117,8,4,4,2,1
3,125,125,20,20,0,1,0
35,135,135,1,1,0,1,0
13,142,142,9,4,5,2,1
34,154,154,12,4,8,2,1
12,161,161,48,32,16,2,1
21,165,165,2,2,0,1,0
2,167,167,5,5,0,1,0
36,175,175,18,8,10,2,1
18,177,177,1,1,0,1,0
22,197,197,23,23,0,1,0
40,204,204,62,37,25,2,1
31,207,207,24,24,0,1,0
37,208,208,16,16,0,1,0
17,221,221,2,2,0,1,0
26,230,230,4,4,0,1,0
6,231,231,13,8,5,2,1
5,259,259,62,6,56,3,2
1,260,260,2,2,0,1,0
27,282,282,5,5,0,1,0
25,325,325,76,55,21,4,3
33,339,339,9,4,5,2,1
8,340,340,21,21,0,1,0
30,350,350,6,6,0,1,0
0,353,353,9,6,3,2,1
4,376,376,68,17,51,4,3
19,392,392,14,14,0,1,0
32,402,402,52,4,48,3,2
24,411,411,59,9,50,2,1
20,411,411,22,22,0,1,0
39,413,413,70,70,0,1,0
23,414,414,101,101,0,1,0
28,420,420,52,2,50,2,1
38,423,423,13,13,0,1,0
15,424,424,8,3,5,2,1
10,451,451,151,151,0,1,0
29,496,496,39,39,0,1,0
9,500,500,127,13,114,4,3

7,119,119,9,9,0,1,0
33,119,119,11,11,0,1,0
30,123,123,10,3,7,2,1
0,127,127,9,3,6,3,2
27,130,130,49,49,0,1,0
39,131,131,6,6,0,1,0
19,135,135,1,1,0,1,0
35,144,144,11,8,3,2,1
34,151,151,8,8,0,1,0
26,170,170,28,28,0,1,0
5,184,184,1,1,0,1,0
37,196,196,21,21,0,1,0
38,230,230,12,12,0,1,0
8,234,234,7,7,0,1,0
28,235,235,12,12,0,1,0
24,242,242,105,51,54,3,2
14,249,249,16,5,11,2,1
6,251,251,5,5,0,1,0
2,258,258,27,21,6,2,1
21,282,282,3,3,0,1,0
20,293,293,11,5,6,3,2
11,300,300,39,39,0,1,0
18,320,320,14,7,7,2,1
1,321,321,103,59,44,3,2
3,327,327,3,3,0,1,0
17,342,342,53,3,50,4,3
31,367,367,1,1,0,1,0
40,373,373,40,40,0,1,0
16,392,392,25,25,0,1,0
36,413,413,47,47,0,1,0
10,418,418,175,75,100,4,3
29,429,429,51,45,6,3,2
25,455,455,6,6,0,1,0
4,455,455,62,26,36,4,3
12,458,458,27,27,0,1,0
13,462,462,54,25,29,2,1
32,465,465,4,1,3,2,1
15,471,471,42,29,13,2,1
22,480,480,17,5,12,2,1
23,482,482,45,45,0,1,0
9,493,493,22,22,0,1,0

0,107,107,1,1,0,1,0
34,130,130,7,3,4,2,1
29,156,156,36,36,0,1,0
36,168,168,15,11,4,2,1
13,179,179,2,2,0,1,0
10,218,218,1,1,0,1,0
26,235,235,52,52,0,1,0
24,237,237,29,24,5,2,1
38,240,240,67,67,0,1,0
16,241,241,33,33,0,1,0
40,250,250,12,6,6,2,1
12,254,254,5,5,0,1,0
17,257,257,16,16,0,1,0
11,258,258,24,24,0,1,0
7,280,280,5,5,0,1,0
35,283,283,26,14,12,3,2
2,291,291,31,8,23,2,1
32,294,294,27,13,14,2,1
41,299,299,11,11,0,1,0
39,303,303,68,53,15,4,3
6,307,307,46,19,27,2,1
15,314,314,51,21,30,3,2
9,325,325,5,5,0,1,0
30,325,325,2,2,0,1,0
23,340,340,44,13,31,2,1
21,347,347,37,5,32,3,2
22,364,364,18,18,0,1,0
1,366,366,67,43,24,3,2
25,368,368,21,4,17,2,1
27,369,369,39,27,12,4,3
14,382,382,6,6,0,1,0
37,383,383,16,5,11,2,1
31,397,397,44,16,28,3,2
18,401,401,29,29,0,1,0
28,406,406,14,8,6,2,1
19,409,409,154,112,42,4,3
5,429,429,63,36,27,2,1
8,440,440,1,1,0,1,0
20,450,450,17,17,0,1,0
33,494,494,8,8,0,1,0
3,498,498,66,57,9,4,3
4,500,500,70,70,0,1,0

17,123,123,2,2,0,1,0
23,127,127,11,8,3,2,1
15,130,130,9,9,0,1,0
26,140,140,36,36,0,1,0
1,147,147,14,14,0,1,0
29,148,148,15,12,3,2,1
21,152,152,57,57,0,1,0
30,171,171,13,4,9,2,1
18,174,174,13,13,0,1,0
24,179,179,20,20,0,1,0
32,189,189,3,3,0,1,0
8,190,190,26,18,8,2,1
7,194,194,35,35,0,1,0
31,195,195,23,23,0,1,0
0,204,204,174,174,0,1,0
13,206,206,1,1,0,1,0
34,215,215,3,3,0,1,0
35,257,257,33,33,0,1,0
16,258,258,1,1,0,1,0
4,268,268,17,9,8,3,2
19,283,283,19,5,14,3,2
25,283,283,36,21,15,2,1
11,290,290,51,51,0,1,0
2,294,294,23,23,0,1,0
9,301,301,29,2,27,2,1
5,306,306,25,15,10,2,1
14,325,325,1,1,0,1,0
33,333,333,13,1,12,2,1
36,407,407,83,65,18,3,2
3,412,412,13,13,0,1,0
12,424,424,30,1,29,2,1
6,426,426,13,2,11,2,1
37,450,450,30,20,10,3,2
22,462,462,19,19,0,1,0
28,466,466,1,1,0,1,0
27,484,484,53,53,0,1,0
10,492,492,7,1,6,2,1
20,497,497,19,5,14,3,2

23,120,120,32,24,8,3,2
5,121,121,4,4,0,1,0
27,141,141,13,13,0,1,0
37,142,142,8,4,4,2,1
29,157,157,57,29,28,3,2
11,184,184,24,9,15,4,3
1,197,197,1,1,0,1,0
26,205,205,28,28,0,1,0
3,213,213,8,2,6,2,1
34,216,216,35,20,15,2,1
4,223,223,15,15,0,1,0
13,236,236,51,51,0,1,0
20,240,240,19,7,12,2,1
33,246,246,19,2,17,2,1
2,248,248,17,8,9,2,1
35,260,260,48,10,38,3,2
10,263,263,24,24,0,1,0
36,263,263,16,16,0,1,0
14,264,264,36,6,30,4,3
24,278,278,54,6,48,3,2
42,287,287,9,9,0,1,0
12,288,288,1,1,0,1,0
7,289,289,11,1,10,3,2
40,302,302,7,4,3,2,1
8,303,303,13,3,10,3,2
28,306,306,3,3,0,1,0
6,323,323,149,35,114,4,3
39,331,331,16,6,10,2,1
32,345,345,3,3,0,1,0
38,347,347,11,11,0,1,0
17,367,367,2,2,0,1,0
19,372,372,63,63,0,1,0
21,397,397,48,48,0,1,0
31,411,411,29,1,28,2,1
18,421,421,16,16,0,1,0
16,431,431,1,1,0,1,0
9,433,433,9,5,4,2,1
15,435,435,25,2,23,2,1
0,466,466,10,6,4,2,1
22,469,469,73,31,42,3,2
30,478,478,38,21,17,2,1
41,491,491,23,23,0,1,0
25,495,495,55,55,0,1,0

15,113,113,17,1,16,3,2
30,113,113,17,17,0,1,0
0,119,119,8,2,6,2,1
31,133,133,26,1,25,2,1
21,135,135,13,5,8,2,1
17,136,136,1,1,0,1,0
28,141,141,7,7,0,1,0
4,159,159,26,26,0,1,0
33,167,167,25,18,7,2,1
32,182,182,11,2,9,2,1
27,184,184,25,17,8,3,2
10,192,192,15,6,9,2,1
24,198,198,8,8,0,1,0
39,223,223,19,1,18,2,1
34,253,253,45,20,25,2,1
6,262,262,53,24,29,2,1
26,269,269,1,1,0,1,0
16,278,278,1,1,0,1,0
9,286,286,5,5,0,1,0
22,301,301,52,52,0,1,0
36,313,313,10,10,0,1,0
35,318,318,66,66,0,1,0
11,340,340,58,43,15,4,3
7,343,343,17,17,0,1,0
19,351,351,19,1,18,4,3
37,356,356,6,6,0,1,0
5,358,358,11,7,4,2,1
41,372,372,13,3,10,3,2
2,385,385,55,55,0,1,0
8,385,385,1,1,0,1,0
40,398,398,24,24,0,1,0
29,406,406,63,39,24,4,3
20,408,408,5,5,0,1,0
13,437,437,52,52,0,1,0
25,439,439,12,5,7,2,1
12,463,463,12,4,8,2,1
23,465,465,43,29,14,2,1
14,465,465,122,62,60,4,3
1,468,468,20,20,0,1,0
38,470,470,91,91,0,1,0
3,477,477,85,28,57,4,3
18,496,496,61,37,24,4,3

9,120,120,20,11,9,4,3
34,138,138,10,3,7,3,2
31,144,144,20,7,13,2,1
35,144,144,10,3,7,2,1
23,148,148,22,22,0,1,0
27,156,156,8,8,0,1,0
21,157,157,28,28,0,1,0
32,160,160,6,6,0,1,0
0,166,166,16,16,0,1,0
18,170,170,75,75,0,1,0
28,173,173,32,32,0,1,0
12,181,181,24,24,0,1,0
2,201,201,43,8,35,3,2
29,206,206,12,1,11,3,2
1,214,214,36,36,0,1,0
19,218,218,1,1,0,1,0
15,251,251,1,1,0,1,0
14,275,275,23,2,21,4,3
13,282,282,55,21,34,2,1
24,312,312,9,4,5,2,1
22,326,326,3,3,0,1,0
16,347,347,31,31,0,1,0
11,355,355,79,79,0,1,0
26,358,358,42,10,32,3,2
3,363,363,21,21,0,1,0
17,373,373,22,10,12,4,3
7,383,383,19,19,0,1,0
25,396,396,43,3,40,2,1
30,425,425,11,1,10,2,1
33,433,433,77,77,0,1,0
4,435,435,13,13,0,1,0
8,437,437,30,7,23,2,1
20,471,471,21,21,0,1,0
5,476,476,98,58,40,2,1
6,478,478,7,7,0,1,0
10,495,495,145,98,47,4,3

35,106,106,3,3,0,1,0
41,126,126,23,23,0,1,0
19,132,132,36,36,0,1,0
4,136,136,9,5,4,2,1
3,138,138,25,25,0,1,0
1,141,141,24,3,21,2,1
23,158,158,20,10,10,3,2
40,162,162,16,2,14,2,1
21,163,163,18,7,11,2,1
12,190,190,41,41,0,1,0
15,194,194,7,7,0,1,0
30,201,201,5,5,0,1,0
5,202,202,6,6,0,1,0
11,214,214,5,5,0,1,0
31,249,249,6,1,5,2,1
29,261,261,17,8,9,2,1
27,261,261,2,2,0,1,0
20,262,262,3,3,0,1,0
2,267,267,1,1,0,1,0
37,293,293,34,34,0,1,0
28,294,294,41,41,0,1,0
26,318,318,16,11,5,2,1
17,332,332,57,29,28,3,2
34,338,338,53,23,30,2,1
9,357,357,84,30,54,3,2
13,377,377,23,23,0,1,0
39,391,391,22,1,21,4,3
7,399,399,24,17,7,2,1
24,402,402,15,15,0,1,0
36,413,413,65,65,0,1,0
8,418,418,12,6,6,3,2
10,424,424,55,13,42,2,1
38,434,434,25,11,14,2,1
14,434,434,18,8,10,3,2
16,445,445,51,51,0,1,0
18,461,461,2,2,0,1,0
25,473,473,157,127,30,3,2
33,480,480,4,4,0,1,0
22,482,482,44,44,0,1,0
6,483,483,1,1,0,1,0
0,491,491,15,6,9,4,3
32,494,494,140,83,57,4,3

37,103,103,12,1,11,2,1
10,117,117,22,22,0,1,0
25,119,119,1,1,0,1,0
17,129,129,29,7,22,3,2
12,130,130,22,22,0,1,0
6,159,159,21,21,0,1,0
23,171,171,62,62,0,1,0
27,175,175,31,23,8,2,1
4,185,185,38,38,0,1,0
3,187,187,29,29,0,1,0
1,198,198,4,1,3,2,1
26,228,228,44,44,0,1,0
16,232,232,41,37,4,2,1
33,235,235,19,19,0,1,0
14,275,275,15,15,0,1,0
29,279,279,3,3,0,1,0
0,282,282,21,9,12,2,1
20,284,284,97,3,94,4,3
34,310,310,10,10,0,1,0
5,311,311,2,2,0,1,0
22,316,316,53,53,0,1,0
15,325,325,4,4,0,1,0
38,327,327,5,1,4,2,1
18,328,328,87,48,39,4,3
35,334,334,2,2,0,1,0
8,334,334,1,1,0,1,0
36,363,363,18,8,10,2,1
39,370,370,24,24,0,1,0
21,372,372,39,21,18,2,1
32,378,378,16,1,15,4,3
24,379,379,23,23,0,1,0
13,392,392,26,18,8,2,1
11,393,393,22,17,5,2,1
28,432,432,8,8,0,1,0
7,447,447,28,28,0,1,0
19,465,465,11,11,0,1,0
30,467,467,59,41,18,2,1
9,472,472,15,15,0,1,0
31,481,481,29,2,27,4,3
2,497,497,36,12,24,2,1

33,109,109,2,2,0,1,0
20,130,130,12,1,11,2,1
23,132,132,13,9,4,2,1
37,137,137,26,21,5,2,1
19,140,140,2,2,0,1,0
14,140,140,57,57,0,1,0
18,143,143,19,11,8,3,2
29,148,148,12,9,3,2,1
3,155,155,2,2,0,1,0
35,160,160,1,1,0,1,0
9,166,166,6,6,0,1,0
13,175,175,17,1,16,2,1
11,180,180,1,1,0,1,0
1,190,190,5,1,4,2,1
17,205,205,9,9,0,1,0
28,235,235,14,14,0,1,0
34,238,238,3,3,0,1,0
16,244,244,6,2,4,2,1
32,253,253,25,25,0,1,0
7,262,262,14,14,0,1,0
6,276,276,33,33,0,1,0
12,295,295,73,25,48,4,3
21,316,316,7,1,6,2,1
8,326,326,23,16,7,2,1
40,337,337,28,28,0,1,0
2,340,340,54,54,0,1,0
26,396,396,50,21,29,2,1
25,409,409,12,6,6,3,2
31,427,427,48,8,40,2,1
4,431,431,10,10,0,1,0
0,450,450,86,65,21,4,3
5,453,453,50,50,0,1,0
10,457,457,59,59,0,1,0
15,476,476,2,2,0,1,0
24,482,482,6,1,5,2,1
27,483,483,27,10,17,3,2
36,491,491,42,42,0,1,0
30,495,495,309,173,136,4,3
38,495,495,15,3,12,4,3
39,498,498,82,26,56,4,3
22,500,500,60,60,0,1,0

13,108,108,3,3,0,1,0
12,125,125,22,12,10,3,2
35,133,133,16,16,0,1,0
20,137,137,1,1,0,1,0
3,148,148,11,11,0,1,0
21,161,161,22,1,21,3,2
7,200,200,3,3,0,1,0
4,213,213,33,29,4,2,1
31,229,229,9,9,0,1,0
34,233,233,16,16,0,1,0
33,241,241,5,5,0,1,0
37,243,243,8,8,0,1,0
6,243,243,15,15,0,1,0
11,249,249,7,7,0,1,0
17,253,253,33,27,6,3,2
19,253,253,34,34,0,1,0
8,254,254,34,7,27,2,1
14,259,259,12,12,0,1,0
22,271,271,4,4,0,1,0
27,283,283,22,10,12,3,2
25,287,287,84,70,14,2,1
39,301,301,11,5,6,3,2
28,315,315,39,27,12,3,2
15,320,320,16,3,13,2,1
29,323,323,167,57,110,4,3
32,342,342,1,1,0,1,0
36,345,345,1,1,0,1,0
38,352,352,18,18,0,1,0
26,368,368,32,32,0,1,0
0,381,381,47,5,42,4,3
1,399,399,86,44,42,4,3
16,426,426,102,102,0,1,0
5,427,427,1,1,0,1,0
24,452,452,19,19,0,1,0
9,454,454,29,5,24,4,3
2,458,458,2,2,0,1,0
40,464,464,14,14,0,1,0
23,464,464,141,126,15,4,3
18,484,484,20,4,16,2,1
10,484,484,133,133,0,1,0
30,491,491,20,20,0,1,0

27,115,115,9,6,3,2,1
12,119,119,4,4,0,1,0
2,121,121,6,6,0,1,0
1,124,124,3,3,0,1,0
4,129,129,8,2,6,3,2
14,136,136,21,3,18,3,2
31,148,148,27,27,0,1,0
5,152,152,18,18,0,1,0
3,153,153,1,1,0,1,0
11,166,166,12,12,0,1,0
21,174,174,8,8,0,1,0
24,187,187,14,7,7,2,1
32,191,191,43,19,24,2,1
28,206,206,1,1,0,1,0
22,217,217,10,10,0,1,0
43,217,217,11,8,3,2,1
46,224,224,9,9,0,1,0
20,229,229,2,2,0,1,0
16,229,229,2,2,0,1,0
40,240,240,15,3,12,3,2
26,254,254,16,4,12,2,1
13,258,258,11,11,0,1,0
35,264,264,1,1,0,1,0
44,268,268,22,22,0,1,0
7,273,273,15,15,0,1,0
41,275,275,52,52,0,1,0
36,286,286,23,23,0,1,0
29,295,295,40,40,0,1,0
25,326,326,39,39,0,1,0
34,332,332,21,17,4,2,1
38,333,333,17,17,0,1,0
33,333,333,99,61,38,2,1
10,334,334,129,54,75,3,2
42,340,340,6,6,0,1,0
9,343,343,2,2,0,1,0
23,356,356,76,37,39,2,1
19,356,356,59,7,52,4,3
6,401,401,14,4,10,3,2
15,414,414,18,18,0,1,0
37,419,419,8,8,0,1,0
30,429,429,57,57,0,1,0
17,437,437,6,6,0,1,0
8,450,450,26,5,21,3,2
0,463,463,42,12,30,4,3
39,477,477,65,28,37,4,3
45,479,479,86,25,61,4,3
18,499,499,2,2,0,1,0

3,111,111,1,1,0,1,0
27,116,116,1,1,0,1,0
41,122,122,9,3,6,2,1
0,133,133,13,3,10,3,2
34,143,143,6,6,0,1,0
22,172,172,10,5,5,2,1
11,179,179,12,12,0,1,0
20,183,183,6,6,0,1,0
9,202,202,1,1,0,1,0
25,216,216,8,3,5,2,1
2,240,240,38,20,18,3,2
4,252,252,42,22,20,3,2
43,278,278,21,21,0,1,0
8,286,286,28,21,7,2,1
32,287,287,17,2,15,4,3
6,293,293,29,29,0,1,0
26,302,302,7,3,4,2,1
14,308,308,18,18,0,1,0
21,309,309,28,13,15,4,3
31,322,322,6,6,0,1,0
18,330,330,7,7,0,1,0
35,333,333,84,84,0,1,0
5,338,338,8,5,3,2,1
29,341,341,7,3,4,2,1
16,345,345,1,1,0,1,0
13,351,351,31,10,21,2,1
37,352,352,47,47,0,1,0
42,355,355,57,39,18,3,2
1,355,355,42,20,22,4,3
40,359,359,49,19,30,3,2
23,362,362,145,145,0,1,0
7,380,380,2,2,0,1,0
17,391,391,2,2,0,1,0
39,395,395,25,9,16,2,1
33,406,406,41,29,12,4,3
12,423,423,2,2,0,1,0
15,435,435,5,5,0,1,0
38,440,440,54,3,51,4,3
19,448,448,143,46,97,4,3
30,450,450,95,57,38,3,2
10,463,463,28,28,0,1,0
36,467,467,53,53,0,1,0
28,480,480,81,64,17,2,1
24,500,500,110,89,21,4,3

12,101,101,25,5,20,3,2
26,124,124,15,9,6,2,1
29,137,137,25,16,9,2,1
1,150,150,20,20,0,1,0
21,167,167,72,72,0,1,0
24,170,170,10,10,0,1,0
34,172,172,6,2,4,2,1
36,193,193,2,2,0,1,0
33,207,207,12,3,9,2,1
3,209,209,14,6,8,2,1
28,211,211,15,15,0,1,0
35,228,228,6,6,0,1,0
37,244,244,26,26,0,1,0
11,249,249,24,12,12,2,1
22,258,258,35,35,0,1,0
8,266,266,25,6,19,2,1
14,271,271,8,8,0,1,0
25,298,298,39,1,38,2,1
23,306,306,37,37,0,1,0
32,310,310,23,23,0,1,0
6,314,314,86,32,54,4,3
10,338,338,33,25,8,3,2
31,340,340,31,21,10,2,1
18,341,341,23,23,0,1,0
4,341,341,30,8,22,4,3
17,370,370,43,31,12,4,3
2,396,396,46,22,24,4,3
19,399,399,75,75,0,1,0
30,400,400,44,44,0,1,0
20,401,401,4,4,0,1,0
15,416,416,16,16,0,1,0
5,430,430,46,46,0,1,0
27,432,432,2,2,0,1,0
7,440,440,97,53,44,3,2
0,480,480,16,8,8,3,2
13,488,488,104,104,0,1,0
16,489,489,11,8,3,2,1
9,489,489,3,3,0,1,0

23,102,102,8,8,0,1,0
19,137,137,33,33,0,1,0
24,143,143,17,3,14,2,1
17,148,148,13,10,3,2,1
10,184,184,3,3,0,1,0
42,188,188,2,2,0,1,0
4,190,190,1,1,0,1,0
0,206,206,16,16,0,1,0
28,218,218,2,2,0,1,0
33,228,228,10,2,8,2,1
14,241,241,3,3,0,1,0
12,274,274,51,51,0,1,0
13,300,300,21,21,0,1,0
31,319,319,22,22,0,1,0
32,320,320,72,3,69,4,3
34,324,324,43,43,0,1,0
35,326,326,5,5,0,1,0
11,333,333,1,1,0,1,0
25,336,336,1,1,0,1,0
15,341,341,26,26,0,1,0
1,349,349,31,25,6,2,1
30,353,353,24,24,0,1,0
43,366,366,41,41,0,1,0
7,367,367,46,32,14,3,2
29,385,385,40,28,12,4,3
26,391,391,62,11,51,4,3
39,394,394,113,55,58,4,3
40,396,396,111,24,87,4,3
9,398,398,19,4,15,3,2
22,406,406,16,6,10,3,2
41,412,412,1,1,0,1,0
18,413,413,31,31,0,1,0
37,415,415,6,6,0,1,0
21,439,439,15,15,0,1,0
16,441,441,19,9,10,2,1
5,442,442,76,76,0,1,0
27,442,442,78,24,54,3,2
2,445,445,77,46,31,2,1
8,461,461,41,41,0,1,0
38,471,471,18,10,8,2,1
6,485,485,22,12,10,3,2
36,494,494,81,48,33,4,3
20,497,497,41,2,39,4,3
3,500,500,69,24,45,2,1

27,101,101,10,2,8,3,2
28,128,128,2,2,0,1,0
34,167,167,19,13,6,2,1
20,168,168,6,6,0,1,0
8,178,178,18,15,3,2,1
16,199,199,13,13,0,1,0
24,215,215,10,5,5,2,1
18,216,216,17,17,0,1,0
2,226,226,27,7,20,2,1
1,232,232,20,20,0,1,0
19,233,233,8,8,0,1,0
25,251,251,130,97,33,2,1
22,263,263,31,23,8,2,1
33,275,275,64,64,0,1,0
21,278,278,8,8,0,1,0
3,285,285,11,11,0,1,0
14,298,298,49,15,34,2,1
13,303,303,23,1,22,3,2
5,308,308,72,72,0,1,0
15,311,311,5,5,0,1,0
4,333,333,111,111,0,1,0
32,340,340,26,11,15,2,1
37,346,346,11,11,0,1,0
11,362,362,19,19,0,1,0
12,368,368,1,1,0,1,0
6,368,368,7,2,5,2,1
26,377,377,49,25,24,2,1
7,398,398,45,45,0,1,0
10,404,404,1,1,0,1,0
17,407,407,3,3,0,1,0
36,410,410,8,8,0,1,0
9,417,417,18,18,0,1,0
30,451,451,22,22,0,1,0
0,473,473,249,187,62,3,2
23,475,475,130,64,66,3,2
31,479,479,31,13,18,2,1
29,480,480,30,30,0,1,0
35,484,484,4,4,0,1,0

7,127,127,8,5,3,2,1
39,129,129,11,4,7,2,1
11,133,133,6,3,3,2,1
0,134,134,1,1,0,1,0
28,141,141,12,6,6,2,1
38,145,145,18,18,0,1,0
22,146,146,8,8,0,1,0
18,168,168,5,5,0,1,0
3,175,175,46,46,0,1,0
35,175,175,19,10,9,2,1
37,182,182,5,5,0,1,0
5,230,230,5,5,0,1,0
12,237,237,24,24,0,1,0
27,246,246,67,37,30,3,2
29,248,248,2,2,0,1,0
33,252,252,35,35,0,1,0
36,272,272,4,4,0,1,0
13,281,281,14,2,12,4,3
4,281,281,33,27,6,2,1
10,283,283,26,26,0,1,0
2,294,294,26,26,0,1,0
1,306,306,5,5,0,1,0
32,318,318,22,22,0,1,0
23,335,335,21,21,0,1,0
20,337,337,22,7,15,4,3
6,342,342,41,20,21,2,1
16,349,349,147,147,0,1,0
25,351,351,3,3,0,1,0
19,357,357,1,1,0,1,0
30,364,364,94,94,0,1,0
8,384,384,93,93,0,1,0
14,394,394,51,51,0,1,0
31,412,412,60,11,49,2,1
24,419,419,6,1,5,2,1
15,427,427,1,1,0,1,0
26,429,429,99,7,92,3,2
21,441,441,22,22,0,1,0
34,448,448,8,8,0,1,0
17,489,489,31,22,9,2,1
9,492,492,5,5,0,1,0
40,496,496,15,6,9,4,3
41,497,497,142,100,42,4,3

19,102,102,1,1,0,1,0
4,117,117,9,9,0,1,0
11,135,135,28,5,23,2,1
31,144,144,1,1,0,1,0
25,151,151,95,45,50,2,1
13,174,174,41,41,0,1,0
7,186,186,8,8,0,1,0
28,187,187,6,6,0,1,0
16,204,204,29,5,24,3,2
10,205,205,13,5,8,3,2
34,222,222,25,14,11,2,1
12,222,222,17,17,0,1,0
2,226,226,15,6,9,2,1
33,236,236,25,25,0,1,0
38,248,248,37,15,22,3,2
27,267,267,3,3,0,1,0
5,273,273,1,1,0,1,0
30,279,279,10,4,6,2,1
3,282,282,7,7,0,1,0
37,315,315,3,3,0,1,0
8,322,322,52,52,0,1,0
18,329,329,7,7,0,1,0
23,331,331,92,92,0,1,0
6,334,334,8,8,0,1,0
36,372,372,7,2,5,2,1
32,372,372,124,124,0,1,0
22,376,376,3,3,0,1,0
1,393,393,53,53,0,1,0
26,404,404,21,11,10,3,2
21,410,410,53,1,52,3,2
20,415,415,17,17,0,1,0
0,422,422,116,116,0,1,0
29,432,432,11,11,0,1,0
15,437,437,17,17,0,1,0
24,440,440,22,4,18,3,2
9,484,484,114,21,93,4,3
14,490,490,18,8,10,3,2
35,495,495,1,1,0,1,0
17,500,500,67,34,33,2,1

28,101,101,28,19,9,4,3
5,112,112,4,4,0,1,0
18,142,142,49,49,0,1,0
17,147,147,10,10,0,1,0
29,153,153,16,16,0,1,0
19,158,158,14,14,0,1,0
27,176,176,11,6,5,2,1
32,192,192,1,1,0,1,0
33,192,192,7,7,0,1,0
37,199,199,8,8,0,1,0
21,201,201,41,17,24,3,2
30,217,217,6,6,0,1,0
9,238,238,7,1,6,3,2
7,245,245,37,28,9,4,3
25,252,252,34,34,0,1,0
22,263,263,59,59,0,1,0
4,274,274,1,1,0,1,0
15,286,286,32,11,21,3,2
2,287,287,14,14,0,1,0
8,298,298,36,21,15,2,1
24,305,305,16,6,10,2,1
10,314,314,16,16,0,1,0
6,322,322,83,44,39,3,2
34,337,337,3,3,0,1,0
31,344,344,21,4,17,4,3
12,352,352,4,4,0,1,0
35,360,360,52,52,0,1,0
3,360,360,32,3,29,2,1
39,387,387,19,7,12,4,3
36,389,389,57,57,0,1,0
13,404,404,32,32,0,1,0
14,415,415,56,14,42,4,3
0,424,424,38,38,0,1,0
38,437,437,24,24,0,1,0
11,450,450,18,18,0,1,0
26,453,453,7,7,0,1,0
23,469,469,120,120,0,1,0
1,474,474,74,74,0,1,0
20,476,476,61,61,0,1,0
16,489,489,46,22,24,3,2

9,101,101,13,2,11,2,1
17,101,101,3,3,0,1,0
39,106,106,7,7,0,1,0
15,133,133,8,8,0,1,0
2,148,148,14,14,0,1,0
16,150,150,9,9,0,1,0
33,161,161,7,1,6,2,1
1,163,163,58,58,0,1,0
0,167,167,12,12,0,1,0
32,177,177,27,6,21,2,1
37,182,182,2,2,0,1,0
19,197,197,7,7,0,1,0
6,201,201,29,23,6,2,1
31,213,213,16,16,0,1,0
3,216,216,27,18,9,4,3
8,221,221,14,2,12,4,3
24,239,239,3,3,0,1,0
29,244,244,45,21,24,2,1
34,250,250,9,6,3,2,1
14,255,255,2,2,0,1,0
27,264,264,105,87,18,3,2
38,265,265,14,1,13,2,1
7,280,280,5,5,0,1,0
35,283,283,25,6,19,2,1
41,286,286,1,1,0,1,0
22,291,291,31,31,0,1,0
20,300,300,11,5,6,3,2
4,307,307,89,36,53,3,2
30,318,318,27,27,0,1,0
23,323,323,40,40,0,1,0
21,344,344,44,28,16,2,1
26,368,368,7,1,6,2,1
28,386,386,79,43,36,2,1
11,398,398,23,13,10,3,2
40,423,423,10,10,0,1,0
36,424,424,134,68,66,4,3
5,427,427,17,17,0,1,0
25,432,432,18,3,15,2,1
10,449,449,1,1,0,1,0
13,450,450,12,12,0,1,0
12,473,473,15,15,0,1,0
18,479,479,93,93,0,1,0

7,101,101,2,2,0,1,0
20,102,102,14,14,0,1,0
14,108,108,57,6,51,4,3
9,140,140,1,1,0,1,0
16,144,144,1,1,0,1,0
28,153,153,21,2,19,2,1
21,158,158,12,12,0,1,0
35,179,179,29,29,0,1,0
38,199,199,15,15,0,1,0
23,202,202,12,3,9,3,2
12,203,203,23,23,0,1,0
37,207,207,31,28,3,2,1
13,213,213,1,1,0,1,0
36,222,222,1,1,0,1,0
34,253,253,6,6,0,1,0
30,254,254,2,2,0,1,0
0,269,269,12,12,0,1,0
3,273,273,17,17,0,1,0
8,277,277,27,23,4,2,1
26,286,286,6,3,3,2,1
17,286,286,22,22,0,1,0
24,299,299,8,8,0,1,0
33,352,352,109,109,0,1,0
10,356,356,106,78,28,3,2
25,372,372,14,14,0,1,0
1,379,379,26,26,0,1,0
6,383,383,88,18,70,3,2
15,383,383,17,17,0,1,0
19,392,392,39,39,0,1,0
2,394,394,7,7,0,1,0
29,405,405,42,42,0,1,0
32,414,414,46,46,0,1,0
11,420,420,7,7,0,1,0
22,432,432,16,7,9,4,3
4,438,438,60,60,0,1,0
27,444,444,131,131,0,1,0
31,458,458,74,5,69,4,3
5,463,463,26,26,0,1,0
18,493,493,85,37,48,4,3

20,134,134,2,2,0,1,0
38,142,142,45,45,0,1,0
40,145,145,18,14,4,2,1
35,162,162,18,18,0,1,0
30,167,167,16,7,9,4,3
10,171,171,4,4,0,1,0
8,177,177,3,3,0,1,0
42,188,188,7,7,0,1,0
27,190,190,12,2,10,3,2
0,201,201,86,2,84,4,3
22,203,203,11,11,0,1,0
2,204,204,20,20,0,1,0
34,205,205,2,2,0,1,0
28,217,217,24,10,14,3,2
5,224,224,48,48,0,1,0
32,225,225,54,42,12,4,3
37,227,227,9,3,6,2,1
21,228,228,18,14,4,2,1
6,228,228,1,1,0,1,0
18,240,240,3,3,0,1,0
23,248,248,39,26,13,2,1
33,252,252,9,9,0,1,0
16,262,262,7,7,0,1,0
4,271,271,12,2,10,3,2
17,291,291,23,23,0,1,0
13,299,299,26,21,5,2,1
26,299,299,46,46,0,1,0
3,323,323,46,38,8,3,2
12,330,330,9,9,0,1,0
19,334,334,3,3,0,1,0
31,335,335,50,50,0,1,0
7,337,337,7,7,0,1,0
15,339,339,70,59,11,2,1
25,372,372,62,19,43,2,1
1,378,378,47,47,0,1,0
9,395,395,49,49,0,1,0
39,419,419,24,24,0,1,0
14,470,470,1,1,0,1,0
41,475,475,25,25,0,1,0
29,480,480,23,23,0,1,0
11,481,481,78,39,39,4,3
24,486,486,2,2,0,1,0
36,494,494,34,34,0,1,0

8,104,104,12,3,9,4,3
30,118,118,10,10,0,1,0
16,126,126,6,3,3,2,1
0,131,131,9,9,0,1,0
11,153,153,14,6,8,3,2
7,155,155,32,26,6,3,2
20,158,158,16,6,10,2,1
6,184,184,47,18,29,4,3
22,184,184,68,44,24,4,3
23,189,189,6,6,0,1,0
2,235,235,6,6,0,1,0
32,246,246,51,32,19,2,1
17,261,261,10,10,0,1,0
5,268,268,49,49,0,1,0
27,269,269,14,14,0,1,0
25,272,272,33,6,27,2,1
33,297,297,42,18,24,3,2
3,299,299,42,42,0,1,0
14,316,316,37,37,0,1,0
12,330,330,1,1,0,1,0
4,351,351,76,58,18,2,1
1,352,352,57,33,24,4,3
34,363,363,42,21,21,4,3
13,363,363,30,15,15,4,3
36,369,369,24,24,0,1,0
19,386,386,46,24,22,2,1
28,388,388,72,31,41,2,1
18,389,389,34,21,13,2,1
15,409,409,14,14,0,1,0
31,409,409,22,22,0,1,0
37,410,410,52,52,0,1,0
35,441,441,13,5,8,3,2
21,445,445,23,23,0,1,0
29,469,469,9,3,6,3,2
26,478,478,32,32,0,1,0
24,487,487,4,4,0,1,0
10,487,487,87,11,76,3,2
9,493,493,18,18,0,1,0

4,107,107,3,3,0,1,0
24,109,109,9,1,8,2,1
14,109,109,1,1,0,1,0
31,130,130,1,1,0,1,0
2,142,142,7,7,0,1,0
27,150,150,2,2,0,1,0
6,153,153,6,6,0,1,0
11,157,157,4,4,0,1,0
42,162,162,12,12,0,1,0
12,165,165,35,21,14,2,1
5,165,165,7,4,3,2,1
18,205,205,3,3,0,1,0
44,217,217,15,1,14,3,2
21,222,222,1,1,0,1,0
8,223,223,43,43,0,1,0
33,245,245,40,40,0,1,0
43,257,257,20,20,0,1,0
16,274,274,14,14,0,1,0
22,274,274,77,30,47,2,1
36,275,275,82,32,50,3,2
35,287,287,1,1,0,1,0
7,293,293,8,8,0,1,0
34,301,301,12,12,0,1,0
20,305,305,41,41,0,1,0
19,312,312,30,3,27,3,2
23,318,318,51,51,0,1,0
17,326,326,9,2,7,2,1
25,353,353,32,32,0,1,0
15,356,356,60,12,48,3,2
10,364,364,12,6,6,3,2
9,403,403,28,28,0,1,0
29,407,407,28,28,0,1,0
26,411,411,52,6,46,2,1
37,412,412,28,28,0,1,0
13,417,417,26,26,0,1,0
32,433,433,29,29,0,1,0
3,449,449,28,28,0,1,0
40,458,458,70,4,66,3,2
41,464,464,30,20,10,2,1
38,466,466,10,2,8,3,2
39,466,466,96,81,15,4,3
30,468,468,120,81,39,4,3
1,479,479,20,8,12,4,3
0,481,481,41,2,39,4,3
28,495,495,82,28,54,4,3

6,108,108,24,17,7,2,1
36,155,155,3,3,0,1,0
21,155,155,1,1,0,1,0
20,156,156,22,22,0,1,0
10,167,167,4,4,0,1,0
26,180,180,21,21,0,1,0
34,183,183,13,13,0,1,0
31,191,191,15,15,0,1,0
5,192,192,3,3,0,1,0
38,209,209,56,56,0,1,0
19,213,213,26,20,6,3,2
1,240,240,37,21,16,3,2
14,249,249,1,1,0,1,0
8,266,266,36,2,34,3,2
39,269,269,30,3,27,4,3
35,274,274,52,52,0,1,0
7,298,298,47,23,24,4,3
23,319,319,3,3,0,1,0
13,324,324,84,17,67,4,3
27,344,344,24,11,13,2,1
24,346,346,28,28,0,1,0
11,351,351,27,27,0,1,0
29,355,355,10,10,0,1,0
25,366,366,35,35,0,1,0
22,368,368,58,23,35,2,1
9,368,368,10,10,0,1,0
17,373,373,1,1,0,1,0
3,378,378,36,16,20,3,2
28,380,380,3,3,0,1,0
4,385,385,1,1,0,1,0
15,386,386,75,3,72,4,3
18,389,389,18,14,4,2,1
16,413,413,23,20,3,2,1
32,413,413,115,111,4,2,1
2,430,430,47,47,0,1,0
30,436,436,15,4,11,2,1
37,453,453,122,66,56,4,3
33,455,455,1,1,0,1,0
0,457,457,123,95,28,3,2
12,489,489,14,2,12,3,2

5,102,102,9,9,0,1,0
13,104,104,1,1,0,1,0
17,128,128,2,2,0,1,0
23,131,131,17,17,0,1,0
28,159,159,21,21,0,1,0
6,178,178,37,4,33,2,1
16,185,185,1,1,0,1,0
8,205,205,7,7,0,1,0
22,210,210,1,1,0,1,0
34,213,213,24,3,21,4,3
30,239,239,14,5,9,4,3
12,254,254,33,11,22,2,1
4,266,266,97,65,32,2,1
11,283,283,16,1,15,4,3
32,289,289,36,10,26,2,1
37,290,290,16,16,0,1,0
10,296,296,24,11,13,2,1
24,304,304,71,71,0,1,0
36,310,310,13,13,0,1,0
25,313,313,14,6,8,2,1
21,317,317,38,38,0,1,0
7,332,332,120,6,114,4,3
35,346,346,44,44,0,1,0
20,347,347,98,80,18,4,3
27,353,353,6,2,4,2,1
2,366,366,11,6,5,2,1
31,376,376,12,12,0,1,0
1,382,382,19,2,17,2,1
26,386,386,58,43,15,2,1
18,386,386,47,14,33,3,2
33,387,387,82,82,0,1,0
15,407,407,17,5,12,2,1
3,421,421,8,1,7,2,1
39,433,433,49,49,0,1,0
9,450,450,1,1,0,1,0
38,450,450,10,10,0,1,0
29,470,470,9,9,0,1,0
0,471,471,7,7,0,1,0
14,488,488,88,25,63,4,3
19,492,492,92,10,82,3,2

49,119,119,1,1,0,1,0
24,128,128,5,5,0,1,0
13,145,145,1,1,0,1,0
17,147,147,1,1,0,1,0
3,147,147,5,5,0,1,0
10,152,152,1,1,0,1,0
48,158,158,1,1,0,1,0
11,161,161,6,6,0,1,0
8,162,162,17,3,14,2,1
18,201,201,6,6,0,1,0
0,207,207,2,2,0,1,0
19,237,237,6,6,0,1,0
22,246,246,27,27,0,1,0
44,250,250,70,30,40,3,2
1,252,252,1,1,0,1,0
6,265,265,1,1,0,1,0
36,271,271,37,37,0,1,0
35,272,272,11,11,0,1,0
28,280,280,31,26,5,2,1
15,291,291,41,14,27,2,1
16,306,306,1,1,0,1,0
32,310,310,20,20,0,1,0
39,340,340,16,11,5,2,1
25,342,342,4,1,3,2,1
43,344,344,20,3,17,2,1
34,350,350,67,32,35,2,1
29,357,357,4,4,0,1,0
30,362,362,49,4,45,4,3
47,366,366,70,70,0,1,0
26,382,382,22,1,21,2,1
20,395,395,6,6,0,1,0
37,397,397,38,12,26,3,2
7,398,398,101,61,40,2,1
4,409,409,200,141,59,3,2
31,426,426,27,9,18,4,3
21,426,426,26,5,21,2,1
2,427,427,32,32,0,1,0
42,442,442,24,24,0,1,0
12,443,443,31,31,0,1,0
23,457,457,4,4,0,1,0
45,459,459,2,2,0,1,0
41,471,471,50,50,0,1,0
40,472,472,8,8,0,1,0
33,474,474,158,40,118,4,3
46,484,484,76,22,54,4,3
38,485,485,20,2,18,2,1
5,488,488,14,2,12,3,2
27,490,490,32,5,27,4,3
9,498,498,24,24,0,1,0
14,500,500,67,67,0,1,0

30,112,112,20,20,0,1,0
21,124,124,13,4,9,3,2
10,132,132,63,26,37,2,1
3,141,141,4,4,0,1,0
27,168,168,20,14,6,2,1
0,187,187,22,14,8,3,2
19,191,191,60,32,28,4,3
32,216,216,3,3,0,1,0
9,218,218,5,5,0,1,0
28,225,225,10,10,0,1,0
4,231,231,23,3,20,3,2
8,231,231,18,12,6,2,1
16,249,249,7,7,0,1,0
34,261,261,4,4,0,1,0
11,270,270,6,6,0,1,0
18,287,287,40,25,15,2,1
15,314,314,73,7,66,3,2
5,328,328,140,128,12,3,2
24,347,347,27,27,0,1,0
29,358,358,23,14,9,2,1
20,370,370,21,5,16,3,2
23,390,390,8,8,0,1,0
6,396,396,17,4,13,2,1
14,398,398,47,5,42,4,3
7,402,402,16,7,9,4,3
1,405,405,50,50,0,1,0
31,419,419,44,44,0,1,0
13,420,420,34,34,0,1,0
26,454,454,16,1,15,2,1
2,463,463,134,108,26,3,2
33,464,464,81,76,5,2,1
25,487,487,119,87,32,2,1
22,487,487,24,8,16,2,1
12,488,488,16,16,0,1,0
17,498,498,12,12,0,1,0

15,121,121,8,8,0,1,0
31,132,132,19,11,8,3,2
1,151,151,12,3,9,2,1
7,161,161,23,23,0,1,0
33,180,180,3,3,0,1,0
24,184,184,42,42,0,1,0
10,196,196,1,1,0,1,0
18,205,205,9,6,3,2,1
9,206,206,12,1,11,2,1
26,207,207,30,30,0,1,0
11,214,214,35,8,27,2,1
21,223,223,14,4,10,3,2
6,240,240,18,18,0,1,0
34,253,253,83,23,60,4,3
5,260,260,25,13,12,3,2
0,262,262,40,40,0,1,0
30,279,279,2,2,0,1,0
4,289,289,10,1,9,4,3
14,290,290,34,34,0,1,0
17,299,299,4,4,0,1,0
8,302,302,120,69,51,3,2
22,304,304,14,8,6,2,1
12,310,310,110,82,28,2,1
23,315,315,19,19,0,1,0
28,325,325,24,24,0,1,0
25,340,340,23,9,14,2,1
2,366,366,17,7,10,2,1
13,386,386,93,93,0,1,0
19,389,389,25,25,0,1,0
27,391,391,1,1,0,1,0
16,395,395,244,127,117,4,3
20,427,427,14,14,0,1,0
32,456,456,13,4,9,2,1
3,466,466,17,17,0,1,0
29,485,485,1,1,0,1,0

15,101,101,2,2,0,1,0
21,105,105,17,7,10,2,1
33,108,108,36,3,33,4,3
41,124,124,1,1,0,1,0
19,130,130,38,38,0,1,0
12,134,134,14,14,0,1,0
5,139,139,18,18,0,1,0
25,142,142,11,11,0,1,0
43,143,143,1,1,0,1,0
13,163,163,1,1,0,1,0
34,166,166,15,15,0,1,0
23,186,186,1,1,0,1,0
9,198,198,7,7,0,1,0
3,205,205,33,24,9,4,3
14,221,221,8,2,6,3,2
24,227,227,39,8,31,2,1
10,230,230,6,1,5,2,1
4,230,230,27,9,18,3,2
18,239,239,13,13,0,1,0
39,258,258,4,1,3,2,1
20,262,262,26,26,0,1,0
26,277,277,7,4,3,2,1
29,294,294,44,8,36,4,3
7,297,297,8,8,0,1,0
11,299,299,36,36,0,1,0
16,304,304,9,9,0,1,0
38,315,315,7,1,6,3,2
6,325,325,4,4,0,1,0
0,325,325,58,58,0,1,0
1,328,328,6,6,0,1,0
27,341,341,19,19,0,1,0
22,351,351,8,8,0,1,0
17,351,351,5,5,0,1,0
31,353,353,21,21,0,1,0
2,365,365,40,40,0,1,0
35,371,371,19,1,18,2,1
40,388,388,73,55,18,2,1
28,405,405,15,15,0,1,0
32,427,427,102,102,0,1,0
42,435,435,51,51,0,1,0
30,436,436,9,9,0,1,0
37,447,447,26,26,0,1,0
36,487,487,150,150,0,1,0
8,490,490,108,27,81,4,3

8,113,113,4,1,3,2,1
13,131,131,2,2,0,1,0
2,146,146,7,7,0,1,0
1,147,147,1,1,0,1,0
14,149,149,6,3,3,2,1
38,149,149,11,4,7,3,2
7,157,157,1,1,0,1,0
28,163,163,6,6,0,1,0
0,169,169,2,2,0,1,0
32,190,190,21,1,20,3,2
17,194,194,6,6,0,1,0
26,195,195,18,6,12,3,2
40,199,199,16,1,15,4,3
9,238,238,21,15,6,2,1
30,245,245,35,35,0,1,0
12,264,264,88,88,0,1,0
21,271,271,2,2,0,1,0
11,278,278,49,23,26,2,1
33,278,278,43,43,0,1,0
20,281,281,30,30,0,1,0
10,298,298,84,84,0,1,0
3,311,311,42,33,9,2,1
39,316,316,22,4,18,4,3
31,318,318,174,90,84,4,3
34,326,326,10,4,6,3,2
36,349,349,44,44,0,1,0
4,356,356,11,3,8,3,2
19,358,358,74,26,48,2,1
18,374,374,64,64,0,1,0
22,394,394,11,11,0,1,0
25,397,397,3,3,0,1,0
16,401,401,2,2,0,1,0
41,416,416,89,77,12,2,1
6,422,422,94,88,6,2,1
23,423,423,12,8,4,2,1
29,439,439,26,12,14,3,2
5,442,442,8,8,0,1,0
37,451,451,51,15,36,2,1
15,451,451,11,4,7,2,1
35,463,463,25,25,0,1,0
27,465,465,10,5,5,2,1
24,479,479,26,26,0,1,0

14,105,105,10,10,0,1,0
4,109,109,18,18,0,1,0
10,121,121,32,32,0,1,0
17,128,128,7,7,0,1,0
16,130,130,17,12,5,2,1
11,132,132,1,1,0,1,0
2,141,141,64,41,23,2,1
9,150,150,2,2,0,1,0
15,152,152,34,34,0,1,0
28,153,153,4,4,0,1,0
1,192,192,14,14,0,1,0
25,219,219,6,6,0,1,0
20,219,219,6,6,0,1,0
32,223,223,95,41,54,4,3
13,240,240,114,84,30,3,2
27,280,280,33,12,21,4,3
26,292,292,30,6,24,4,3
19,312,312,2,2,0,1,0
5,313,313,7,7,0,1,0
12,317,317,1,1,0,1,0
3,331,331,70,37,33,4,3
24,340,340,4,4,0,1,0
22,343,343,17,10,7,2,1
34,360,360,56,56,0,1,0
18,373,373,16,4,12,4,3
6,375,375,3,3,0,1,0
29,392,392,27,2,25,2,1
23,394,394,11,11,0,1,0
31,406,406,24,21,3,2,1
30,433,433,40,40,0,1,0
0,437,437,37,37,0,1,0
21,478,478,56,56,0,1,0
33,478,478,128,98,30,4,3
8,479,479,1,1,0,1,0
7,485,485,59,17,42,4,3

34,108,108,2,2,0,1,0
5,111,111,16,8,8,2,1
11,136,136,11,2,9,4,3
28,137,137,34,34,0,1,0
32,140,140,9,9,0,1,0
29,141,141,13,13,0,1,0
1,145,145,18,1,17,2,1
30,162,162,10,10,0,1,0
24,184,184,73,73,0,1,0
31,187,187,4,4,0,1,0
25,191,191,1,1,0,1,0
10,220,220,17,17,0,1,0
17,220,220,13,13,0,1,0
39,221,221,47,26,21,2,1
23,233,233,2,2,0,1,0
9,253,253,31,31,0,1,0
14,265,265,61,52,9,4,3
20,267,267,26,4,22,3,2
13,284,284,35,19,16,3,2
7,287,287,6,6,0,1,0
37,289,289,4,4,0,1,0
12,294,294,15,15,0,1,0
27,307,307,26,26,0,1,0
8,307,307,21,21,0,1,0
38,312,312,20,20,0,1,0
0,348,348,63,36,27,2,1
33,348,348,12,2,10,3,2
36,352,352,7,7,0,1,0
6,368,368,21,21,0,1,0
22,369,369,48,48,0,1,0
26,408,408,128,128,0,1,0
19,412,412,59,59,0,1,0
21,412,412,32,32,0,1,0
4,426,426,27,27,0,1,0
3,438,438,35,35,0,1,0
16,441,441,70,38,32,3,2
35,450,450,39,39,0,1,0
2,457,457,8,4,4,2,1
18,474,474,14,10,4,2,1
15,491,491,83,35,48,3,2

8,111,111,6,6,0,1,0
37,114,114,7,2,5,2,1
26,120,120,1,1,0,1,0
15,154,154,50,19,31,2,1
39,161,161,15,15,0,1,0
28,191,191,7,7,0,1,0
4,196,196,7,1,6,3,2
34,206,206,12,12,0,1,0
27,220,220,48,5,43,4,3
2,224,224,46,46,0,1,0
21,234,234,70,61,9,4,3
29,238,238,3,3,0,1,0
0,238,238,15,15,0,1,0
9,242,242,5,5,0,1,0
11,242,242,14,4,10,2,1
23,252,252,75,75,0,1,0
25,261,261,9,9,0,1,0
36,272,272,10,10,0,1,0
31,276,276,3,3,0,1,0
38,277,277,21,21,0,1,0
3,289,289,27,27,0,1,0
32,309,309,60,45,15,4,3
1,328,328,8,8,0,1,0
19,328,328,98,98,0,1,0
10,340,340,15,15,0,1,0
18,358,358,28,28,0,1,0
20,370,370,68,25,43,2,1
17,392,392,14,14,0,1,0
24,404,404,54,24,30,4,3
12,419,419,47,47,0,1,0
22,423,423,21,17,4,2,1
7,444,444,20,20,0,1,0
13,450,450,14,10,4,2,1
5,468,468,59,59,0,1,0
30,475,475,2,2,0,1,0
6,476,476,38,6,32,3,2
33,477,477,85,57,28,4,3
16,477,477,2,2,0,1,0
14,482,482,129,60,69,4,3
35,486,486,26,26,0,1,0

25,116,116,12,5,7,2,1
6,129,129,43,43,0,1,0
5,144,144,14,14,0,1,0
39,152,152,4,4,0,1,0
16,166,166,9,9,0,1,0
19,193,193,1,1,0,1,0
40,197,197,98,82,16,3,2
3,212,212,50,50,0,1,0
26,220,220,3,3,0,1,0
43,238,238,6,6,0,1,0
15,241,241,27,15,12,3,2
11,250,250,14,14,0,1,0
13,259,259,18,18,0,1,0
42,265,265,51,36,15,4,3
33,277,277,35,9,26,3,2
7,284,284,59,40,19,2,1
12,285,285,17,4,13,2,1
34,308,308,22,22,0,1,0
2,309,309,13,13,0,1,0
29,313,313,17,2,15,4,3
20,320,320,34,34,0,1,0
18,326,326,71,71,0,1,0
36,330,330,8,8,0,1,0
28,332,332,11,2,9,2,1
4,336,336,20,9,11,2,1
0,354,354,5,2,3,2,1
38,357,357,1,1,0,1,0
24,364,364,16,2,14,2,1
27,379,379,44,44,0,1,0
9,405,405,3,3,0,1,0
10,409,409,14,14,0,1,0
31,410,410,110,110,0,1,0
17,415,415,4,4,0,1,0
41,435,435,61,61,0,1,0
21,442,442,4,4,0,1,0
30,453,453,40,18,22,3,2
1,461,461,51,6,45,2,1
35,465,465,16,2,14,3,2
8,469,469,28,28,0,1,0
23,475,475,46,25,21,2,1
37,489,489,35,26,9,4,3
22,490,490,1,1,0,1,0
32,491,491,51,38,13,2,1
14,495,495,1,1,0,1,0

15,120,120,1,1,0,1,0
0,124,124,2,2,0,1,0
19,141,141,14,7,7,2,1
20,155,155,25,25,0,1,0
4,168,168,58,41,17,2,1
33,177,177,22,8,14,2,1
9,192,192,11,2,9,4,3
25,194,194,5,5,0,1,0
21,221,221,4,4,0,1,0
29,250,250,6,6,0,1,0
6,258,258,67,10,57,4,3
10,268,268,38,30,8,2,1
5,287,287,191,165,26,3,2
2,293,293,21,21,0,1,0
1,298,298,5,5,0,1,0
30,305,305,33,24,9,2,1
17,337,337,80,26,54,4,3
27,339,339,36,29,7,2,1
18,344,344,68,2,66,3,2
11,374,374,4,4,0,1,0
12,374,374,43,43,0,1,0
7,380,380,44,44,0,1,0
31,388,388,163,64,99,4,3
3,389,389,29,21,8,3,2
24,391,391,3,3,0,1,0
8,392,392,15,10,5,2,1
22,412,412,3,3,0,1,0
28,413,413,74,74,0,1,0
23,423,423,18,3,15,4,3
13,425,425,31,31,0,1,0
32,442,442,49,39,10,2,1
26,469,469,4,4,0,1,0
16,475,475,9,9,0,1,0
14,496,496,65,65,0,1,0

2,104,104,1,1,0,1,0
10,127,127,5,5,0,1,0
12,135,135,11,2,9,4,3
32,145,145,6,6,0,1,0
6,151,151,35,3,32,2,1
29,167,167,9,9,0,1,0
27,173,173,25,1,24,2,1
14,186,186,26,26,0,1,0
22,203,203,3,3,0,1,0
40,214,214,2,2,0,1,0
17,225,225,11,11,0,1,0
16,231,231,34,10,24,3,2
11,233,233,4,4,0,1,0
25,236,236,4,4,0,1,0
18,241,241,26,18,8,2,1
13,257,257,1,1,0,1,0
37,257,257,46,46,0,1,0
35,260,260,6,6,0,1,0
36,292,292,15,15,0,1,0
9,300,300,4,4,0,1,0
4,306,306,25,25,0,1,0
26,314,314,50,50,0,1,0
33,315,315,16,16,0,1,0
24,315,315,25,25,0,1,0
5,347,347,75,30,45,4,3
19,354,354,56,5,51,3,2
39,357,357,78,16,62,3,2
42,360,360,36,36,0,1,0
34,370,370,7,2,5,2,1
0,370,370,1,1,0,1,0
23,370,370,47,12,35,3,2
31,384,384,10,10,0,1,0
3,387,387,20,20,0,1,0
8,404,404,40,28,12,3,2
1,406,406,2,2,0,1,0
20,418,418,74,74,0,1,0
28,430,430,35,35,0,1,0
30,437,437,173,96,77,3,2
15,445,445,46,4,42,4,3
7,451,451,18,18,0,1,0
43,452,452,8,8,0,1,0
21,453,453,38,38,0,1,0
38,457,457,4,4,0,1,0
41,500,500,182,140,42,2,1

30,123,123,13,13,0,1,0
29,129,129,19,16,3,2,1
34,149,149,3,3,0,1,0
13,153,153,17,13,4,2,1
12,160,160,1,1,0,1,0
22,175,175,39,30,9,4,3
18,179,179,29,29,0,1,0
23,187,187,43,10,33,2,1
4,190,190,32,8,24,4,3
11,190,190,27,3,24,3,2
9,211,211,6,6,0,1,0
21,228,228,14,5,9,4,3
32,244,244,49,49,0,1,0
33,247,247,8,8,0,1,0
20,248,248,39,6,33,4,3
1,256,256,57,6,51,4,3
31,259,259,42,42,0,1,0
17,269,269,93,37,56,3,2
5,272,272,32,32,0,1,0
28,315,315,13,13,0,1,0
24,326,326,17,17,0,1,0
3,340,340,37,3,34,4,3
10,356,356,105,87,18,4,3
36,377,377,41,38,3,2,1
14,394,394,15,15,0,1,0
15,395,395,4,4,0,1,0
16,397,397,2,2,0,1,0
27,415,415,3,3,0,1,0
37,423,423,9,3,6,3,2
19,435,435,58,58,0,1,0
35,440,440,45,45,0,1,0
6,446,446,23,14,9,4,3
26,453,453,13,4,9,2,1
2,456,456,81,78,3,2,1
8,462,462,2,2,0,1,0
0,465,465,26,14,12,4,3
25,496,496,15,15,0,1,0
7,499,499,56,8,48,4,3

22,106,106,6,6,0,1,0
11,160,160,18,7,11,2,1
35,206,206,13,3,10,2,1
39,210,210,3,3,0,1,0
24,242,242,35,27,8,2,1
16,260,260,35,35,0,1,0
6,272,272,43,20,23,2,1
28,281,281,21,15,6,3,2
13,284,284,4,4,0,1,0
3,286,286,6,6,0,1,0
10,292,292,9,9,0,1,0
25,294,294,7,7,0,1,0
17,302,302,44,17,27,4,3
21,312,312,59,19,40,3,2
1,318,318,72,41,31,2,1
26,336,336,7,7,0,1,0
18,337,337,18,9,9,2,1
33,340,340,32,24,8,3,2
23,340,340,3,3,0,1,0
31,349,349,13,13,0,1,0
0,366,366,5,5,0,1,0
32,371,371,160,93,67,4,3
4,375,375,67,31,36,3,2
20,379,379,71,56,15,4,3
14,379,379,11,11,0,1,0
9,383,383,39,39,0,1,0
27,383,383,1,1,0,1,0
30,388,388,64,64,0,1,0
40,395,395,4,4,0,1,0
15,412,412,10,4,6,2,1
2,421,421,31,31,0,1,0
34,423,423,174,174,0,1,0
5,424,424,75,17,58,3,2
19,442,442,2,2,0,1,0
38,442,442,8,8,0,1,0
7,476,476,92,80,12,2,1
36,484,484,38,2,36,2,1
37,486,486,39,39,0,1,0
8,487,487,50,50,0,1,0
12,493,493,9,9,0,1,0
29,496,496,58,58,0,1,0

30,105,105,10,10,0,1,0
35,109,109,1,1,0,1,0
41,131,131,19,14,5,2,1
18,144,144,2,2,0,1,0
10,150,150,13,6,7,2,1
23,154,154,1,1,0,1,0
3,167,167,8,8,0,1,0
21,180,180,3,3,0,1,0
38,181,181,6,6,0,1,0
12,220,220,4,4,0,1,0
25,229,229,5,5,0,1,0
27,235,235,7,7,0,1,0
34,237,237,108,108,0,1,0
13,256,256,7,7,0,1,0
37,256,256,31,31,0,1,0
2,277,277,4,4,0,1,0
32,285,285,79,79,0,1,0
36,289,289,17,17,0,1,0
5,293,293,12,2,10,2,1
4,309,309,1,1,0,1,0
7,310,310,59,30,29,4,3
0,320,320,32,24,8,3,2
20,339,339,40,40,0,1,0
31,347,347,28,12,16,4,3
24,352,352,7,7,0,1,0
9,365,365,29,14,15,4,3
14,383,383,36,1,35,2,1
1,384,384,11,11,0,1,0
16,404,404,53,12,41,2,1
11,440,440,76,28,48,4,3
19,449,449,256,248,8,3,2
22,451,451,98,98,0,1,0
8,456,456,5,5,0,1,0
28,464,464,71,13,58,4,3
29,476,476,3,3,0,1,0
26,481,481,4,4,0,1,0
40,488,488,42,42,0,1,0
15,488,488,44,44,0,1,0
33,491,491,92,92,0,1,0
17,491,491,49,49,0,1,0
6,494,494,24,5,19,2,1
39,499,499,12,2,10,2,1

31,103,103,3,3,0,1,0
15,106,106,2,2,0,1,0
25,113,113,21,21,0,1,0
17,140,140,13,6,7,2,1
12,148,148,28,5,23,2,1
36,174,174,59,59,0,1,0
18,175,175,10,10,0,1,0
6,175,175,62,62,0,1,0
4,211,211,38,38,0,1,0
28,213,213,21,21,0,1,0
30,216,216,5,5,0,1,0
20,231,231,5,5,0,1,0
24,235,235,43,19,24,2,1
19,236,236,1,1,0,1,0
5,246,246,40,40,0,1,0
29,253,253,23,3,20,3,2
35,261,261,3,3,0,1,0
34,265,265,46,5,41,2,1
16,276,276,14,14,0,1,0
9,284,284,15,6,9,4,3
33,294,294,109,96,13,3,2
23,325,325,18,18,0,1,0
14,331,331,16,6,10,2,1
21,345,345,8,8,0,1,0
2,350,350,13,1,12,3,2
27,355,355,42,42,0,1,0
13,359,359,8,3,5,2,1
8,382,382,64,64,0,1,0
32,389,389,14,5,9,4,3
22,393,393,20,20,0,1,0
37,393,393,31,31,0,1,0
26,419,419,36,9,27,3,2
0,434,434,20,20,0,1,0
11,455,455,12,12,0,1,0
38,465,465,31,3,28,2,1
3,469,469,170,110,60,4,3
7,485,485,10,10,0,1,0
10,490,490,18,5,13,2,1
1,495,495,37,37,0,1,0

24,106,106,19,9,10,2,1
9,107,107,4,4,0,1,0
1,142,142,4,4,0,1,0
3,180,180,37,27,10,2,1
14,180,180,6,6,0,1,0
36,189,189,6,3,3,2,1
37,193,193,32,32,0,1,0
16,211,211,11,11,0,1,0
32,213,213,5,5,0,1,0
26,218,218,5,5,0,1,0
22,226,226,1,1,0,1,0
8,251,251,3,3,0,1,0
29,256,256,59,37,22,3,2
13,263,263,1,1,0,1,0
35,265,265,5,5,0,1,0
34,274,274,83,62,21,2,1
11,276,276,20,20,0,1,0
33,281,281,18,5,13,2,1
4,290,290,85,10,75,4,3
25,303,303,2,2,0,1,0
12,307,307,97,24,73,3,2
20,314,314,52,42,10,3,2
5,321,321,26,17,9,4,3
21,322,322,40,40,0,1,0
28,325,325,9,2,7,2,1
7,333,333,170,120,50,2,1
10,334,334,4,1,3,2,1
19,336,336,8,3,5,2,1
18,377,377,17,17,0,1,0
27,384,384,54,54,0,1,0
15,386,386,9,9,0,1,0
0,398,398,49,21,28,2,1
2,401,401,18,13,5,2,1
6,459,459,44,10,34,2,1
23,465,465,20,14,6,2,1
17,476,476,5,5,0,1,0
30,478,478,156,113,43,2,1
38,479,479,49,49,0,1,0
31,496,496,15,12,3,2,1

24,106,106,9,9,0,1,0
17,109,109,9,9,0,1,0
7,129,129,3,3,0,1,0
8,149,149,11,3,8,2,1
42,159,159,5,5,0,1,0
12,181,181,1,1,0,1,0
30,182,182,21,21,0,1,0
41,193,193,2,2,0,1,0
18,197,197,12,12,0,1,0
11,197,197,1,1,0,1,0
32,202,202,1,1,0,1,0
16,210,210,21,9,12,3,2
14,213,213,34,34,0,1,0
1,224,224,23,1,22,3,2
2,224,224,1,1,0,1,0
19,240,240,19,19,0,1,0
39,242,242,3,3,0,1,0
37,251,251,16,16,0,1,0
21,271,271,26,26,0,1,0
25,274,274,55,29,26,3,2
34,282,282,121,121,0,1,0
29,287,287,34,9,25,2,1
35,290,290,58,22,36,2,1
20,290,290,54,22,32,2,1
6,291,291,22,22,0,1,0
27,293,293,23,13,10,2,1
10,314,314,10,10,0,1,0
40,329,329,47,47,0,1,0
5,334,334,68,14,54,4,3
9,341,341,78,78,0,1,0
36,352,352,3,3,0,1,0
33,355,355,22,4,18,3,2
15,374,374,78,33,45,4,3
13,382,382,4,4,0,1,0
31,389,389,29,3,26,3,2
38,406,406,28,1,27,2,1
22,409,409,55,55,0,1,0
28,429,429,10,10,0,1,0
26,430,430,53,53,0,1,0
0,468,468,10,10,0,1,0
23,474,474,92,43,49,4,3
4,475,475,50,44,6,2,1
3,481,481,1,1,0,1,0

34,101,101,7,7,0,1,0
2,106,106,4,4,0,1,0
27,124,124,2,2,0,1,0
9,125,125,53,7,46,3,2
15,136,136,14,14,0,1,0
14,158,158,2,2,0,1,0
13,178,178,55,55,0,1,0
11,180,180,10,1,9,2,1
20,188,188,17,7,10,2,1
12,201,201,5,5,0,1,0
16,232,232,43,43,0,1,0
25,232,232,46,4,42,4,3
19,241,241,30,30,0,1,0
24,249,249,30,30,0,1,0
31,252,252,18,12,6,3,2
26,277,277,20,20,0,1,0
23,282,282,1,1,0,1,0
29,296,296,10,10,0,1,0
6,307,307,1,1,0,1,0
35,307,307,23,3,20,2,1
37,321,321,136,103,33,2,1
7,337,337,39,39,0,1,0
21,344,344,47,47,0,1,0
33,346,346,5,5,0,1,0
28,356,356,39,34,5,2,1
36,358,358,8,2,6,2,1
18,367,367,33,9,24,2,1
5,373,373,58,58,0,1,0
32,383,383,39,39,0,1,0
17,388,388,36,36,0,1,0
30,394,394,43,43,0,1,0
8,406,406,7,7,0,1,0
1,415,415,6,6,0,1,0
10,424,424,6,6,0,1,0
3,429,429,159,85,74,3,2
4,466,466,12,12,0,1,0
22,472,472,74,74,0,1,0
0,487,487,19,5,14,2,1

4,116,116,19,5,14,3,2
26,123,123,11,5,6,2,1
27,128,128,29,11,18,4,3
21,135,135,24,14,10,2,1
20,140,140,5,2,3,2,1
40,143,143,20,20,0,1,0
7,144,144,30,21,9,2,1
0,166,166,21,21,0,1,0
15,170,170,10,4,6,2,1
9,172,172,7,1,6,3,2
11,203,203,15,15,0,1,0
2,210,210,11,11,0,1,0
38,211,211,1,1,0,1,0
30,233,233,6,6,0,1,0
37,239,239,25,3,22,3,2
23,242,242,2,2,0,1,0
35,244,244,5,2,3,2,1
19,247,247,43,5,38,2,1
36,268,268,11,11,0,1,0
32,273,273,18,18,0,1,0
17,295,295,40,25,15,2,1
22,303,303,55,55,0,1,0
16,311,311,53,53,0,1,0
28,311,311,14,2,12,3,2
25,319,319,118,81,37,2,1
29,323,323,40,40,0,1,0
13,337,337,17,17,0,1,0
39,339,339,51,32,19,2,1
8,340,340,67,67,0,1,0
33,340,340,56,56,0,1,0
5,345,345,8,8,0,1,0
12,362,362,41,41,0,1,0
10,372,372,45,45,0,1,0
24,388,388,4,1,3,2,1
1,398,398,39,30,9,4,3
3,414,414,11,11,0,1,0
18,453,453,7,2,5,2,1
31,456,456,5,5,0,1,0
6,465,465,40,40,0,1,0
14,467,467,15,3,12,3,2
34,494,494,41,41,0,1,0

21,101,101,8,2,6,3,2
9,113,113,31,6,25,2,1
25,126,126,17,10,7,2,1
11,144,144,6,6,0,1,0
30,173,173,43,19,24,2,1
13,197,197,11,11,0,1,0
23,216,216,14,9,5,2,1
22,235,235,16,16,0,1,0
26,243,243,73,46,27,4,3
2,261,261,17,17,0,1,0
24,265,265,17,1,16,2,1
12,270,270,19,9,10,2,1
7,271,271,56,56,0,1,0
8,276,276,82,45,37,2,1
6,288,288,87,87,0,1,0
14,304,304,22,22,0,1,0
19,312,312,28,28,0,1,0
5,336,336,54,54,0,1,0
3,346,346,91,4,87,4,3
16,349,349,15,15,0,1,0
10,350,350,14,14,0,1,0
27,371,371,20,16,4,2,1
0,380,380,110,53,57,4,3
18,392,392,2,2,0,1,0
20,395,395,13,4,9,4,3
15,408,408,81,81,0,1,0
17,435,435,14,1,13,3,2
29,474,474,48,10,38,3,2
1,476,476,45,45,0,1,0
4,481,481,4,1,3,2,1
28,495,495,143,143,0,1,0

33,103,103,19,13,6,3,2
42,111,111,23,1,22,2,1
44,127,127,6,6,0,1,0
31,129,129,9,9,0,1,0
16,134,134,3,3,0,1,0
19,143,143,1,1,0,1,0
10,159,159,23,15,8,2,1
39,168,168,49,3,46,2,1
7,172,172,3,3,0,1,0
40,179,179,15,4,11,2,1
13,184,184,56,21,35,2,1
23,185,185,19,13,6,2,1
28,190,190,2,2,0,1,0
11,193,193,4,1,3,2,1
5,215,215,27,3,24,2,1
32,223,223,6,3,3,2,1
38,226,226,6,6,0,1,0
14,246,246,35,35,0,1,0
24,285,285,41,41,0,1,0
30,290,290,22,10,12,2,1
41,299,299,72,72,0,1,0
21,301,301,21,5,16,2,1
45,306,306,3,3,0,1,0
17,312,312,41,9,32,2,1
18,328,328,75,24,51,4,3
22,328,328,11,5,6,3,2
34,363,363,20,12,8,3,2
6,367,367,34,4,30,3,2
0,378,378,3,3,0,1,0
29,385,385,4,4,0,1,0
3,386,386,7,2,5,2,1
26,386,386,108,91,17,2,1
35,399,399,12,12,0,1,0
12,400,400,1,1,0,1,0
8,401,401,6,1,5,2,1
2,409,409,70,70,0,1,0
36,414,414,68,53,15,2,1
27,420,420,69,57,12,3,2
37,425,425,10,10,0,1,0
1,427,427,1,1,0,1,0
4,433,433,33,8,25,2,1
43,451,451,17,4,13,2,1
20,455,455,9,9,0,1,0
25,461,461,4,4,0,1,0
15,467,467,8,8,0,1,0
9,485,485,37,37,0,1,0

21,113,113,4,4,0,1,0
18,115,115,5,1,4,2,1
42,125,125,11,11,0,1,0
24,159,159,2,2,0,1,0
2,175,175,4,4,0,1,0
28,184,184,1,1,0,1,0
5,185,185,16,16,0,1,0
27,190,190,1,1,0,1,0
22,192,192,47,47,0,1,0
16,197,197,5,5,0,1,0
20,231,231,19,6,13,2,1
41,241,241,40,1,39,4,3
29,253,253,25,7,18,4,3
23,253,253,14,14,0,1,0
14,282,282,13,1,12,3,2
34,283,283,4,4,0,1,0
19,287,287,5,5,0,1,0
25,302,302,33,15,18,3,2
1,303,303,28,28,0,1,0
38,306,306,49,11,38,3,2
32,307,307,42,16,26,2,1
31,311,311,63,63,0,1,0
4,312,312,60,60,0,1,0
35,314,314,137,96,41,2,1
40,322,322,2,2,0,1,0
17,325,325,29,9,20,4,3
11,329,329,29,29,0,1,0
9,332,332,54,24,30,3,2
15,333,333,8,1,7,2,1
8,345,345,5,5,0,1,0
37,350,350,28,28,0,1,0
30,379,379,42,33,9,2,1
12,381,381,44,44,0,1,0
36,382,382,5,5,0,1,0
33,383,383,21,21,0,1,0
10,409,409,39,6,33,4,3
13,421,421,39,39,0,1,0
6,424,424,43,43,0,1,0
3,429,429,25,11,14,4,3
26,433,433,14,14,0,1,0
7,441,441,44,23,21,2,1
43,485,485,48,48,0,1,0
0,488,488,57,57,0,1,0
39,493,493,108,59,49,3,2

19,103,103,19,4,15,4,3
11,110,110,2,2,0,1,0
15,146,146,8,8,0,1,0
20,155,155,10,10,0,1,0
14,158,158,18,18,0,1,0
5,179,179,11,6,5,2,1
12,185,185,10,5,5,2,1
33,192,192,2,2,0,1,0
7,201,201,32,32,0,1,0
30,206,206,67,67,0,1,0
36,221,221,32,22,10,2,1
4,233,233,34,13,21,4,3
27,233,233,6,1,5,2,1
26,238,238,15,15,0,1,0
8,247,247,10,3,7,2,1
16,268,268,28,16,12,4,3
17,270,270,1,1,0,1,0
22,271,271,13,13,0,1,0
25,292,292,4,4,0,1,0
34,293,293,24,24,0,1,0
6,294,294,10,10,0,1,0
0,303,303,18,18,0,1,0
39,309,309,36,36,0,1,0
31,332,332,56,16,40,3,2
9,347,347,77,47,30,2,1
3,351,351,18,4,14,3,2
24,353,353,8,5,3,2,1
28,356,356,47,47,0,1,0
37,390,390,30,30,0,1,0
29,400,400,46,29,17,4,3
1,402,402,34,13,21,4,3
18,411,411,7,1,6,3,2
35,412,412,72,59,13,2,1
32,425,425,48,44,4,2,1
23,455,455,40,13,27,4,3
38,464,464,72,72,0,1,0
21,488,488,47,47,0,1,0
2,493,493,52,52,0,1,0
13,493,493,48,6,42,3,2
10,497,497,195,157,38,3,2

40,103,103,5,5,0,1,0
42,108,108,10,2,8,2,1
25,117,117,11,11,0,1,0
15,123,123,3,3,0,1,0
44,134,134,17,8,9,4,3
19,137,137,7,4,3,2,1
14,140,140,9,9,0,1,0
11,151,151,21,21,0,1,0
41,151,151,26,26,0,1,0
29,152,152,7,7,0,1,0
27,171,171,22,17,5,2,1
23,175,175,11,11,0,1,0
1,186,186,16,16,0,1,0
32,190,190,15,15,0,1,0
35,190,190,9,9,0,1,0
34,207,207,4,4,0,1,0
5,207,207,24,24,0,1,0
21,210,210,37,37,0,1,0
36,212,212,13,2,11,3,2
31,214,214,46,25,21,3,2
10,214,214,1,1,0,1,0
8,217,217,3,3,0,1,0
18,242,242,1,1,0,1,0
30,242,242,22,16,6,2,1
16,261,261,2,2,0,1,0
20,273,273,5,5,0,1,0
33,282,282,132,74,58,4,3
17,286,286,6,6,0,1,0
38,287,287,13,13,0,1,0
9,289,289,57,57,0,1,0
45,290,290,27,15,12,3,2
4,310,310,16,16,0,1,0
24,314,314,9,1,8,3,2
28,324,324,21,21,0,1,0
6,356,356,20,20,0,1,0
39,368,368,56,43,13,3,2
37,382,382,4,4,0,1,0
12,414,414,91,91,0,1,0
43,419,419,39,39,0,1,0
7,426,426,57,57,0,1,0
3,428,428,25,25,0,1,0
13,434,434,35,10,25,3,2
26,446,446,2,2,0,1,0
22,464,464,7,7,0,1,0
2,479,479,58,58,0,1,0
0,483,483,76,76,0,1,0

0,145,145,25,7,18,3,2
37,149,149,2,2,0,1,0
36,151,151,4,1,3,2,1
11,166,166,1,1,0,1,0
9,169,169,1,1,0,1,0
12,223,223,15,15,0,1,0
16,230,230,9,9,0,1,0
27,233,233,2,2,0,1,0
13,243,243,134,16,118,4,3
17,256,256,72,46,26,4,3
19,256,256,52,19,33,2,1
31,263,263,1,1,0,1,0
20,278,278,55,55,0,1,0
5,283,283,7,7,0,1,0
25,287,287,45,45,0,1,0
34,296,296,43,15,28,4,3
28,299,299,64,7,57,4,3
14,303,303,45,45,0,1,0
30,314,314,4,4,0,1,0
4,331,331,12,12,0,1,0
1,332,332,3,3,0,1,0
3,353,353,119,30,89,4,3
18,358,358,24,16,8,3,2
32,359,359,3,3,0,1,0
10,379,379,1,1,0,1,0
21,385,385,65,17,48,2,1
7,402,402,6,6,0,1,0
24,405,405,18,18,0,1,0
22,407,407,6,6,0,1,0
15,408,408,1,1,0,1,0
29,420,420,62,62,0,1,0
33,420,420,90,27,63,4,3
2,450,450,18,18,0,1,0
8,472,472,17,17,0,1,0
23,482,482,28,28,0,1,0
6,491,491,112,24,88,4,3
35,492,492,15,15,0,1,0
26,498,498,147,123,24,2,1

26,120,120,17,17,0,1,0
6,123,123,5,5,0,1,0
0,123,123,9,2,7,2,1
13,124,124,38,38,0,1,0
30,126,126,7,7,0,1,0
33,127,127,1,1,0,1,0
32,154,154,77,29,48,4,3
9,159,159,16,16,0,1,0
29,165,165,48,48,0,1,0
3,166,166,21,9,12,4,3
5,175,175,26,26,0,1,0
12,184,184,3,3,0,1,0
27,196,196,2,2,0,1,0
23,206,206,3,3,0,1,0
19,230,230,20,20,0,1,0
22,236,236,4,4,0,1,0
18,245,245,27,12,15,4,3
4,299,299,25,25,0,1,0
20,303,303,21,9,12,3,2
11,317,317,25,1,24,3,2
25,327,327,8,8,0,1,0
1,338,338,92,92,0,1,0
8,346,346,98,50,48,2,1
15,350,350,59,54,5,2,1
31,361,361,32,20,12,4,3
7,373,373,34,34,0,1,0
34,381,381,30,30,0,1,0
14,391,391,61,52,9,4,3
17,400,400,2,2,0,1,0
2,413,413,8,8,0,1,0
10,415,415,85,31,54,3,2
24,433,433,28,28,0,1,0
28,453,453,16,16,0,1,0
16,469,469,23,9,14,3,2
21,496,496,115,29,86,4,3

2,107,107,5,5,0,1,0
5,115,115,3,3,0,1,0
43,125,125,1,1,0,1,0
27,127,127,11,11,0,1,0
38,136,136,18,18,0,1,0
28,145,145,36,11,25,4,3
13,154,154,12,12,0,1,0
18,156,156,30,3,27,4,3
30,179,179,18,18,0,1,0
34,194,194,1,1,0,1,0
19,201,201,17,17,0,1,0
32,212,212,5,5,0,1,0
7,223,223,7,7,0,1,0
41,248,248,41,41,0,1,0
17,249,249,14,14,0,1,0
14,255,255,94,28,66,4,3
0,260,260,23,23,0,1,0
11,261,261,11,5,6,3,2
40,276,276,41,41,0,1,0
31,283,283,64,19,45,3,2
36,314,314,42,8,34,3,2
33,318,318,26,26,0,1,0
1,323,323,26,26,0,1,0
20,327,327,8,5,3,2,1
4,330,330,4,4,0,1,0
16,337,337,39,39,0,1,0
3,337,337,5,5,0,1,0
21,354,354,11,11,0,1,0
25,359,359,17,5,12,3,2
44,369,369,2,2,0,1,0
23,381,381,45,7,38,3,2
24,386,386,57,38,19,2,1
15,407,407,32,32,0,1,0
29,408,408,69,15,54,4,3
37,410,410,50,50,0,1,0
26,411,411,17,17,0,1,0
10,412,412,33,1,32,3,2
12,422,422,36,3,33,2,1
6,439,439,58,29,29,2,1
22,458,458,1,1,0,1,0
39,471,471,77,77,0,1,0
42,474,474,28,28,0,1,0
8,476,476,1,1,0,1,0
35,498,498,33,33,0,1,0
9,499,499,31,31,0,1,0

32,104,104,8,4,4,2,1
33,108,108,7,7,0,1,0
20,131,131,8,8,0,1,0
36,150,150,34,6,28,3,2
14,159,159,17,17,0,1,0
28,172,172,3,3,0,1,0
15,183,183,10,1,9,4,3
12,187,187,5,5,0,1,0
7,206,206,42,42,0,1,0
39,209,209,81,40,41,2,1
0,214,214,42,42,0,1,0
9,219,219,8,8,0,1,0
10,221,221,19,19,0,1,0
24,228,228,11,11,0,1,0
34,229,229,35,35,0,1,0
13,230,230,9,9,0,1,0
23,236,236,18,6,12,4,3
26,244,244,4,4,0,1,0
16,254,254,26,4,22,3,2
38,261,261,18,18,0,1,0
30,263,263,103,74,29,2,1
4,285,285,1,1,0,1,0
17,290,290,42,28,14,3,2
1,305,305,24,24,0,1,0
37,307,307,22,22,0,1,0
11,307,307,51,34,17,2,1
25,350,350,5,5,0,1,0
18,375,375,1,1,0,1,0
31,378,378,32,32,0,1,0
35,379,379,25,7,18,3,2
3,381,381,65,50,15,4,3
19,425,425,81,1,80,4,3
21,425,425,35,17,18,3,2
27,427,427,32,32,0,1,0
22,451,451,22,4,18,4,3
5,453,453,13,5,8,3,2
29,466,466,6,1,5,2,1
8,467,467,128,58,70,3,2
2,474,474,39,28,11,2,1
6,477,477,3,3,0,1,0

30,106,106,14,14,0,1,0
10,129,129,4,1,3,2,1
39,133,133,4,1,3,2,1
15,136,136,1,1,0,1,0
2,165,165,20,20,0,1,0
32,166,166,12,12,0,1,0
27,176,176,19,19,0,1,0
13,179,179,2,2,0,1,0
29,180,180,16,16,0,1,0
28,182,182,6,6,0,1,0
22,196,196,11,8,3,2,1
20,205,205,5,2,3,2,1
36,234,234,10,10,0,1,0
17,237,237,46,10,36,2,1
35,242,242,15,6,9,4,3
16,248,248,1,1,0,1,0
12,260,260,23,23,0,1,0
9,274,274,18,18,0,1,0
19,276,276,134,134,0,1,0
34,292,292,51,21,30,4,3
40,297,297,74,35,39,4,3
3,299,299,12,9,3,2,1
24,317,317,38,4,34,2,1
33,317,317,40,6,34,3,2
18,332,332,6,3,3,2,1
1,337,337,4,4,0,1,0
26,346,346,76,34,42,4,3
4,348,348,9,5,4,2,1
23,353,353,2,2,0,1,0
6,357,357,43,43,0,1,0
7,359,359,104,70,34,2,1
14,366,366,24,24,0,1,0
5,380,380,2,2,0,1,0
38,395,395,44,44,0,1,0
21,399,399,19,19,0,1,0
8,399,399,43,28,15,2,1
0,406,406,43,17,26,3,2
31,479,479,47,47,0,1,0
37,485,485,66,66,0,1,0
25,489,489,65,15,50,3,2
11,490,490,88,60,28,4,3

8,107,107,18,18,0,1,0
38,110,110,5,5,0,1,0
4,114,114,7,7,0,1,0
36,117,117,34,34,0,1,0
41,119,119,10,10,0,1,0
35,139,139,12,5,7,2,1
21,182,182,2,2,0,1,0
2,186,186,38,38,0,1,0
3,196,196,5,5,0,1,0
24,221,221,12,12,0,1,0
22,224,224,10,10,0,1,0
32,224,224,18,18,0,1,0
19,249,249,14,14,0,1,0
15,259,259,10,10,0,1,0
37,266,266,3,3,0,1,0
26,269,269,89,44,45,4,3
12,278,278,1,1,0,1,0
1,290,290,1,1,0,1,0
5,298,298,74,74,0,1,0
42,300,300,17,17,0,1,0
25,340,340,47,20,27,4,3
40,341,341,46,46,0,1,0
18,358,358,51,51,0,1,0
28,369,369,31,12,19,3,2
10,379,379,93,93,0,1,0
29,384,384,3,3,0,1,0
11,390,390,71,71,0,1,0
31,407,407,38,18,20,3,2
16,415,415,5,5,0,1,0
13,416,416,13,13,0,1,0
34,424,424,23,23,0,1,0
23,426,426,28,19,9,4,3
30,430,430,67,47,20,2,1
14,441,441,18,9,9,4,3
39,453,453,23,8,15,3,2
27,454,454,2,2,0,1,0
9,458,458,1,1,0,1,0
6,472,472,81,47,34,3,2
7,478,478,1,1,0,1,0
17,480,480,12,2,10,3,2
20,482,482,87,87,0,1,0
0,483,483,49,49,0,1,0
33,487,487,104,69,35,2,1

38,137,137,12,12,0,1,0
0,160,160,19,5,14,2,1
28,161,161,7,7,0,1,0
13,199,199,12,3,9,3,2
24,200,200,52,27,25,2,1
35,212,212,5,5,0,1,0
31,213,213,11,11,0,1,0
32,234,234,51,5,46,3,2
21,234,234,22,10,12,2,1
22,238,238,9,9,0,1,0
29,255,255,51,51,0,1,0
11,257,257,22,5,17,2,1
25,267,267,11,5,6,3,2
4,270,270,1,1,0,1,0
26,271,271,18,18,0,1,0
12,272,272,1,1,0,1,0
34,290,290,3,3,0,1,0
30,297,297,17,17,0,1,0
10,298,298,60,60,0,1,0
2,310,310,115,104,11,2,1
17,317,317,17,17,0,1,0
19,320,320,25,15,10,3,2
15,321,321,6,6,0,1,0
16,324,324,10,10,0,1,0
18,344,344,2,2,0,1,0
27,355,355,11,2,9,4,3
9,378,378,16,7,9,2,1
23,379,379,57,30,27,2,1
20,401,401,15,4,11,2,1
14,418,418,31,31,0,1,0
33,424,424,157,157,0,1,0
36,430,430,18,18,0,1,0
1,433,433,120,48,72,4,3
3,443,443,26,8,18,3,2
5,454,454,93,93,0,1,0
37,455,455,62,62,0,1,0
6,470,470,124,124,0,1,0
8,485,485,1,1,0,1,0
7,497,497,62,58,4,2,1

22,108,108,15,3,12,3,2
0,117,117,2,2,0,1,0
29,120,120,14,5,9,2,1
15,123,123,13,4,9,2,1
17,127,127,21,1,20,2,1
2,132,132,32,6,26,3,2
31,144,144,3,3,0,1,0
21,146,146,9,9,0,1,0
35,152,152,11,11,0,1,0
7,158,158,11,11,0,1,0
11,159,159,21,21,0,1,0
3,169,169,13,13,0,1,0
26,177,177,2,2,0,1,0
28,187,187,29,29,0,1,0
5,189,189,6,6,0,1,0
25,194,194,35,35,0,1,0
32,228,228,2,2,0,1,0
12,245,245,37,37,0,1,0
24,256,256,25,25,0,1,0
6,260,260,1,1,0,1,0
13,265,265,41,14,27,2,1
1,272,272,70,40,30,3,2
19,276,276,5,1,4,2,1
27,279,279,45,30,15,2,1
16,309,309,21,21,0,1,0
4,323,323,46,20,26,2,1
10,352,352,66,66,0,1,0
34,389,389,5,5,0,1,0
30,413,413,25,25,0,1,0
18,420,420,36,22,14,2,1
20,424,424,114,52,62,3,2
23,426,426,61,61,0,1,0
14,441,441,6,1,5,2,1
9,465,465,46,46,0,1,0
33,475,475,91,91,0,1,0
8,493,493,156,134,22,3,2

0,128,128,4,4,0,1,0
12,128,128,16,13,3,2,1
13,130,130,5,5,0,1,0
26,193,193,4,1,3,2,1
29,224,224,25,25,0,1,0
10,227,227,3,3,0,1,0
35,232,232,80,80,0,1,0
24,233,233,19,4,15,4,3
14,243,243,1,1,0,1,0
3,258,258,15,4,11,2,1
22,268,268,24,24,0,1,0
6,286,286,14,2,12,4,3
36,300,300,92,6,86,3,2
5,333,333,64,64,0,1,0
9,345,345,145,145,0,1,0
34,345,345,17,17,0,1,0
23,346,346,34,18,16,2,1
21,347,347,1,1,0,1,0
8,359,359,19,19,0,1,0
11,363,363,47,5,42,2,1
32,364,364,9,9,0,1,0
37,375,375,7,7,0,1,0
18,386,386,52,35,17,2,1
7,396,396,10,10,0,1,0
39,404,404,23,23,0,1,0
20,407,407,60,60,0,1,0
17,408,408,31,31,0,1,0
30,409,409,8,2,6,2,1
1,413,413,74,16,58,3,2
2,417,417,56,6,50,3,2
31,419,419,29,23,6,3,2
25,424,424,55,3,52,3,2
38,428,428,123,123,0,1,0
15,435,435,20,20,0,1,0
33,436,436,1,1,0,1,0
4,453,453,71,71,0,1,0
27,458,458,40,40,0,1,0
19,467,467,31,10,21,4,3
28,470,470,38,38,0,1,0
16,488,488,33,9,24,2,1

22,114,114,3,3,0,1,0
18,115,115,24,24,0,1,0
16,145,145,12,12,0,1,0
23,156,156,5,5,0,1,0
13,168,168,50,50,0,1,0
9,174,174,30,30,0,1,0
5,175,175,3,3,0,1,0
15,175,175,1,1,0,1,0
26,188,188,8,8,0,1,0
2,193,193,4,4,0,1,0
3,194,194,12,12,0,1,0
34,211,211,14,14,0,1,0
0,217,217,57,57,0,1,0
21,263,263,30,30,0,1,0
33,263,263,17,17,0,1,0
36,265,265,1,1,0,1,0
11,270,270,54,54,0,1,0
29,287,287,31,31,0,1,0
4,303,303,4,4,0,1,0
17,304,304,29,29,0,1,0
20,308,308,40,25,15,4,3
30,319,319,32,32,0,1,0
25,357,357,35,35,0,1,0
6,372,372,30,30,0,1,0
12,376,376,39,39,0,1,0
14,376,376,5,5,0,1,0
10,378,378,7,1,6,3,2
35,387,387,83,83,0,1,0
7,387,387,17,17,0,1,0
8,405,405,203,109,94,3,2
27,410,410,7,7,0,1,0
31,418,418,35,35,0,1,0
24,450,450,65,14,51,4,3
32,467,467,25,13,12,3,2
19,467,467,181,124,57,4,3
28,470,470,27,5,22,2,1
1,486,486,53,17,36,2,1

15,101,101,5,5,0,1,0
6,125,125,1,1,0,1,0
5,127,127,1,1,0,1,0
36,134,134,19,5,14,2,1
23,141,141,9,9,0,1,0
33,143,143,8,8,0,1,0
24,152,152,3,3,0,1,0
29,156,156,33,33,0,1,0
10,163,163,18,3,15,4,3
42,175,175,8,1,7,2,1
25,193,193,9,9,0,1,0
19,204,204,24,3,21,2,1
26,209,209,14,14,0,1,0
40,216,216,16,16,0,1,0
18,219,219,9,1,8,3,2
22,246,246,6,1,5,2,1
34,274,274,59,35,24,3,2
46,279,279,35,29,6,2,1
2,282,282,10,10,0,1,0
38,289,289,4,4,0,1,0
16,290,290,5,5,0,1,0
12,297,297,2,2,0,1,0
31,309,309,71,71,0,1,0
7,333,333,1,1,0,1,0
41,340,340,93,9,84,4,3
44,358,358,4,4,0,1,0
43,363,363,12,12,0,1,0
39,372,372,88,88,0,1,0
21,377,377,30,12,18,2,1
3,379,379,48,8,40,3,2
27,393,393,38,34,4,2,1
45,397,397,7,3,4,2,1
8,399,399,73,25,48,3,2
28,415,415,19,19,0,1,0
0,424,424,54,26,28,3,2
35,439,439,73,73,0,1,0
37,441,441,5,5,0,1,0
20,453,453,137,77,60,3,2
14,465,465,109,40,69,4,3
1,468,468,9,4,5,2,1
4,472,472,81,81,0,1,0
17,473,473,47,47,0,1,0
32,479,479,4,4,0,1,0
9,484,484,1,1,0,1,0
30,494,494,12,12,0,1,0
11,499,499,12,1,11,2,1
13,499,499,6,6,0,1,0

2,100,100,19,8,11,2,1
26,102,102,21,12,9,4,3
6,107,107,6,3,3,2,1
41,124,124,19,1,18,3,2
3,128,128,8,2,6,3,2
5,157,157,2,2,0,1,0
30,157,157,23,4,19,2,1
18,159,159,11,11,0,1,0
38,173,173,25,4,21,2,1
17,190,190,44,26,18,3,2
39,209,209,27,27,0,1,0
13,220,220,48,48,0,1,0
0,237,237,2,2,0,1,0
11,241,241,18,18,0,1,0
9,249,249,16,10,6,2,1
44,255,255,3,3,0,1,0
37,256,256,1,1,0,1,0
16,259,259,39,21,18,3,2
24,263,263,6,6,0,1,0
14,264,264,24,21,3,2,1
1,268,268,3,3,0,1,0
8,291,291,3,3,0,1,0
15,295,295,3,3,0,1,0
32,299,299,43,43,0,1,0
28,305,305,28,28,0,1,0
19,312,312,7,2,5,2,1
43,316,316,52,52,0,1,0
31,323,323,11,2,9,4,3
35,330,330,23,23,0,1,0
12,331,331,8,8,0,1,0
27,332,332,28,8,20,2,1
20,354,354,106,64,42,4,3
34,389,389,19,11,8,3,2
40,391,391,124,1,123,4,3
22,395,395,11,11,0,1,0
36,396,396,50,36,14,2,1
42,403,403,6,6,0,1,0
10,405,405,17,17,0,1,0
21,416,416,19,19,0,1,0
33,425,425,19,19,0,1,0
23,431,431,35,2,33,4,3
25,446,446,38,24,14,3,2
7,448,448,69,69,0,1,0
29,462,462,5,5,0,1,0
4,468,468,10,6,4,2,1

0,100,100,7,1,6,3,2
16,101,101,16,16,0,1,0
28,109,109,17,9,8,2,1
33,114,114,7,7,0,1,0
34,117,117,14,14,0,1,0
8,131,131,22,22,0,1,0
36,133,133,18,8,10,3,2
29,137,137,12,12,0,1,0
40,145,145,43,7,36,3,2
23,170,170,62,62,0,1,0
13,173,173,7,7,0,1,0
39,174,174,6,6,0,1,0
2,175,175,4,1,3,2,1
7,186,186,34,34,0,1,0
15,198,198,23,1,22,3,2
27,200,200,10,10,0,1,0
11,214,214,15,3,12,3,2
4,262,262,58,16,42,3,2
35,263,263,10,10,0,1,0
1,266,266,34,8,26,2,1
31,296,296,1,1,0,1,0
6,307,307,10,10,0,1,0
14,343,343,18,18,0,1,0
17,347,347,24,24,0,1,0
19,359,359,30,11,19,2,1
20,380,380,1,1,0,1,0
32,381,381,48,6,42,4,3
22,398,398,35,13,22,2,1
3,414,414,24,24,0,1,0
9,426,426,13,8,5,2,1
24,444,444,29,29,0,1,0
18,455,455,11,11,0,1,0
30,455,455,43,16,27,4,3
26,461,461,28,12,16,3,2
25,467,467,30,30,0,1,0
12,477,477,128,32,96,4,3
21,488,488,1,1,0,1,0
37,489,489,13,4,9,4,3
38,491,491,84,84,0,1,0
10,492,492,49,4,45,2,1
5,495,495,51,51,0,1,0

11,116,116,28,2,26,3,2
32,135,135,12,12,0,1,0
24,137,137,8,8,0,1,0
12,139,139,25,11,14,2,1
17,145,145,11,1,10,2,1
20,146,146,14,11,3,2,1
19,168,168,1,1,0,1,0
34,172,172,1,1,0,1,0
10,175,175,16,4,12,4,3
13,184,184,43,16,27,3,2
21,190,190,9,6,3,2,1
3,199,199,12,12,0,1,0
16,202,202,16,16,0,1,0
7,214,214,5,5,0,1,0
5,216,216,40,40,0,1,0
29,220,220,18,18,0,1,0
0,229,229,7,3,4,2,1
14,232,232,30,16,14,2,1
28,246,246,65,2,63,4,3
2,247,247,33,13,20,2,1
8,254,254,8,8,0,1,0
18,292,292,36,36,0,1,0
1,393,393,83,78,5,2,1
26,396,396,114,114,0,1,0
33,396,396,2,2,0,1,0
31,401,401,104,56,48,4,3
9,416,416,20,20,0,1,0
23,426,426,58,46,12,3,2
6,429,429,8,1,7,2,1
25,438,438,18,18,0,1,0
30,459,459,11,11,0,1,0
22,468,468,52,18,34,2,1
27,489,489,79,79,0,1,0
15,490,490,45,3,42,4,3
4,500,500,191,157,34,2,1

40,105,105,1,1,0,1,0
29,120,120,5,1,4,2,1
4,123,123,7,7,0,1,0
30,124,124,15,15,0,1,0
2,135,135,16,16,0,1,0
18,137,137,9,9,0,1,0
32,139,139,55,22,33,2,1
41,141,141,9,9,0,1,0
34,149,149,4,4,0,1,0
9,167,167,40,40,0,1,0
23,178,178,14,4,10,2,1
31,178,178,11,11,0,1,0
5,193,193,16,8,8,2,1
16,195,195,5,5,0,1,0
45,209,209,19,19,0,1,0
36,222,222,3,3,0,1,0
37,244,244,16,1,15,2,1
11,257,257,8,3,5,2,1
3,267,267,2,2,0,1,0
6,270,270,45,45,0,1,0
8,298,298,11,5,6,2,1
7,298,298,57,48,9,4,3
15,302,302,9,9,0,1,0
39,306,306,48,48,0,1,0
25,313,313,33,33,0,1,0
19,313,313,6,6,0,1,0
14,322,322,10,5,5,2,1
38,342,342,17,5,12,3,2
42,345,345,37,37,0,1,0
1,363,363,46,34,12,2,1
24,367,367,23,3,20,3,2
33,372,372,66,66,0,1,0
44,380,380,27,27,0,1,0
26,383,383,15,2,13,2,1
12,384,384,54,3,51,4,3
13,404,404,10,10,0,1,0
0,407,407,73,73,0,1,0
10,407,407,6,2,4,2,1
17,411,411,9,9,0,1,0
21,450,450,41,41,0,1,0
22,452,452,6,6,0,1,0
27,452,452,57,38,19,2,1
43,456,456,159,59,100,4,3
20,468,468,18,8,10,2,1
28,471,471,4,4,0,1,0
35,475,475,32,32,0,1,0

5,120,120,10,10,0,1,0
21,124,124,4,4,0,1,0
28,128,128,8,8,0,1,0
23,134,134,5,5,0,1,0
0,136,136,12,7,5,2,1
10,151,151,43,6,37,3,2
15,153,153,15,3,12,4,3
16,177,177,3,3,0,1,0
27,190,190,16,16,0,1,0
18,203,203,6,6,0,1,0
3,213,213,6,6,0,1,0
22,217,217,71,71,0,1,0
19,221,221,2,2,0,1,0
14,222,222,32,11,21,4,3
12,222,222,81,14,67,4,3
13,230,230,17,1,16,2,1
2,255,255,27,27,0,1,0
1,262,262,31,3,28,3,2
11,265,265,86,86,0,1,0
29,266,266,6,6,0,1,0
24,283,283,6,6,0,1,0
20,288,288,31,25,6,3,2
25,337,337,40,40,0,1,0
26,370,370,176,86,90,4,3
33,392,392,8,8,0,1,0
4,411,411,5,5,0,1,0
30,417,417,28,19,9,4,3
31,426,426,9,9,0,1,0
9,440,440,13,13,0,1,0
8,445,445,128,41,87,4,3
6,479,479,8,8,0,1,0
17,483,483,142,142,0,1,0
32,494,494,26,26,0,1,0
7,497,497,91,40,51,4,3

13,101,101,13,13,0,1,0
34,103,103,18,15,3,2,1
5,123,123,38,12,26,3,2
22,145,145,12,12,0,1,0
28,168,168,14,14,0,1,0
7,172,172,1,1,0,1,0
19,181,181,4,4,0,1,0
1,191,191,11,11,0,1,0
3,194,194,6,3,3,2,1
29,202,202,31,31,0,1,0
32,234,234,4,4,0,1,0
30,247,247,18,12,6,3,2
12,249,249,64,64,0,1,0
4,256,256,19,19,0,1,0
15,258,258,20,8,12,2,1
20,274,274,32,10,22,2,1
17,302,302,62,62,0,1,0
8,316,316,4,4,0,1,0
31,332,332,6,6,0,1,0
33,345,345,73,11,62,3,2
25,346,346,70,21,49,2,1
26,366,366,55,37,18,3,2
0,372,372,16,1,15,2,1
6,380,380,135,126,9,4,3
18,388,388,14,14,0,1,0
11,402,402,12,12,0,1,0
21,421,421,47,7,40,3,2
9,441,441,85,55,30,4,3
14,449,449,99,64,35,3,2
10,451,451,37,37,0,1,0
27,456,456,28,28,0,1,0
2,457,457,92,92,0,1,0
24,469,469,79,9,70,3,2
16,490,490,23,17,6,3,2
23,492,492,13,1,12,4,3

0,118,118,4,4,0,1,0
19,135,135,1,1,0,1,0
42,152,152,26,6,20,2,1
45,154,154,18,8,10,2,1
1,170,170,5,5,0,1,0
37,171,171,10,1,9,4,3
35,171,171,2,2,0,1,0
5,183,183,42,42,0,1,0
30,201,201,15,15,0,1,0
29,207,207,2,2,0,1,0
31,221,221,39,39,0,1,0
36,235,235,46,43,3,2,1
41,241,241,3,3,0,1,0
47,241,241,21,12,9,4,3
10,242,242,4,4,0,1,0
12,252,252,20,20,0,1,0
9,262,262,6,1,5,2,1
25,276,276,32,32,0,1,0
28,278,278,8,8,0,1,0
4,280,280,28,28,0,1,0
8,306,306,6,6,0,1,0
43,307,307,43,43,0,1,0
7,319,319,28,28,0,1,0
16,365,365,27,27,0,1,0
26,370,370,69,5,64,3,2
46,374,374,18,12,6,2,1
20,386,386,97,1,96,3,2
2,399,399,19,1,18,3,2
6,402,402,1,1,0,1,0
23,408,408,66,66,0,1,0
17,408,408,5,5,0,1,0
22,411,411,78,78,0,1,0
18,417,417,4,1,3,2,1
14,422,422,31,7,24,3,2
3,429,429,19,4,15,4,3
24,456,456,27,4,23,2,1
38,457,457,34,16,18,4,3
11,460,460,15,3,12,4,3
34,464,464,85,52,33,4,3
33,464,464,15,15,0,1,0
15,469,469,10,10,0,1,0
27,472,472,12,12,0,1,0
44,473,473,127,61,66,4,3
40,475,475,33,5,28,3,2
32,481,481,17,17,0,1,0
21,489,489,11,11,0,1,0
39,490,490,118,107,11,2,1
13,497,497,22,22,0,1,0

18,103,103,4,4,0,1,0
32,109,109,20,5,15,4,3
19,116,116,8,8,0,1,0
35,117,117,2,2,0,1,0
31,124,124,27,9,18,3,2
4,129,129,11,11,0,1,0
24,143,143,2,2,0,1,0
29,153,153,5,2,3,2,1
9,197,197,11,11,0,1,0
14,213,213,11,2,9,2,1
1,214,214,53,3,50,3,2
33,222,222,15,15,0,1,0
3,240,240,11,11,0,1,0
16,249,249,9,4,5,2,1
22,259,259,22,2,20,3,2
40,261,261,31,1,30,3,2
11,267,267,20,20,0,1,0
20,268,268,7,4,3,2,1
15,279,279,47,47,0,1,0
34,280,280,28,28,0,1,0
41,281,281,8,8,0,1,0
17,287,287,24,24,0,1,0
39,305,305,14,14,0,1,0
36,320,320,55,37,18,3,2
25,331,331,27,11,16,2,1
38,331,331,21,21,0,1,0
8,359,359,26,26,0,1,0
2,365,365,116,116,0,1,0
5,370,370,31,31,0,1,0
30,371,371,17,5,12,2,1
7,377,377,20,20,0,1,0
26,408,408,27,13,14,2,1
28,418,418,162,19,143,4,3
6,428,428,6,6,0,1,0
23,434,434,3,3,0,1,0
10,444,444,34,13,21,4,3
0,448,448,66,10,56,4,3
21,450,450,59,59,0,1,0
27,459,459,4,1,3,2,1
13,469,469,20,20,0,1,0
37,491,491,148,109,39,3,2
12,500,500,40,16,24,4,3

26,124,124,20,20,0,1,0
16,133,133,9,4,5,2,1
15,143,143,22,22,0,1,0
22,144,144,37,37,0,1,0
14,160,160,10,10,0,1,0
11,198,198,14,14,0,1,0
13,225,225,26,26,0,1,0
12,239,239,116,12,104,4,3
29,265,265,21,21,0,1,0
8,267,267,39,39,0,1,0
9,278,278,9,9,0,1,0
6,280,280,1,1,0,1,0
27,285,285,73,73,0,1,0
17,287,287,42,6,36,3,2
25,296,296,89,13,76,3,2
0,337,337,7,7,0,1,0
30,337,337,41,16,25,2,1
2,364,364,188,124,64,3,2
1,376,376,40,5,35,2,1
7,380,380,22,8,14,3,2
21,381,381,13,13,0,1,0
24,387,387,13,13,0,1,0
19,399,399,2,2,0,1,0
32,416,416,2,2,0,1,0
10,426,426,115,101,14,2,1
28,428,428,8,8,0,1,0
3,434,434,57,34,23,3,2
5,435,435,50,38,12,3,2
4,437,437,20,20,0,1,0
20,451,451,6,6,0,1,0
23,454,454,25,25,0,1,0
18,462,462,49,49,0,1,0
31,476,476,21,21,0,1,0

14,117,117,12,3,9,4,3
24,130,130,2,2,0,1,0
28,131,131,8,8,0,1,0
35,133,133,6,6,0,1,0
27,135,135,4,4,0,1,0
23,137,137,6,6,0,1,0
4,153,153,6,3,3,2,1
39,156,156,8,8,0,1,0
43,174,174,11,7,4,2,1
25,181,181,4,4,0,1,0
12,186,186,2,2,0,1,0
13,188,188,5,5,0,1,0
45,200,200,4,1,3,2,1
7,206,206,26,5,21,4,3
11,219,219,3,3,0,1,0
15,234,234,58,58,0,1,0
8,252,252,13,1,12,4,3
40,272,272,61,61,0,1,0
6,272,272,7,7,0,1,0
0,272,272,53,33,20,2,1
30,283,283,14,14,0,1,0
22,290,290,1,1,0,1,0
32,292,292,36,36,0,1,0
26,299,299,14,7,7,2,1
34,301,301,14,5,9,2,1
38,306,306,7,4,3,2,1
19,309,309,2,2,0,1,0
18,324,324,108,108,0,1,0
16,326,326,32,23,9,4,3
9,326,326,22,22,0,1,0
3,338,338,1,1,0,1,0
41,345,345,119,5,114,4,3
33,348,348,69,69,0,1,0
42,348,348,56,56,0,1,0
29,350,350,6,1,5,2,1
31,352,352,63,12,51,4,3
17,369,369,1,1,0,1,0
20,387,387,58,10,48,4,3
21,396,396,62,14,48,2,1
2,402,402,13,1,12,3,2
1,408,408,39,39,0,1,0
37,416,416,113,71,42,2,1
5,420,420,6,6,0,1,0
10,424,424,51,1,50,2,1
36,465,465,40,40,0,1,0
44,467,467,1,1,0,1,0

40,101,101,6,6,0,1,0
33,109,109,6,1,5,2,1
36,113,113,15,8,7,2,1
31,120,120,13,4,9,2,1
20,148,148,12,12,0,1,0
13,161,161,21,21,0,1,0
19,165,165,2,2,0,1,0
12,167,167,5,1,4,2,1
17,173,173,5,5,0,1,0
5,178,178,2,2,0,1,0
18,179,179,29,29,0,1,0
8,183,183,3,3,0,1,0
1,206,206,8,8,0,1,0
27,211,211,1,1,0,1,0
44,221,221,84,84,0,1,0
10,250,250,4,1,3,2,1
37,256,256,14,14,0,1,0
39,257,257,29,7,22,2,1
24,258,258,3,3,0,1,0
25,270,270,5,5,0,1,0
29,270,270,38,24,14,3,2
48,281,281,41,41,0,1,0
47,283,283,7,7,0,1,0
42,285,285,42,42,0,1,0
6,291,291,19,2,17,4,3
14,299,299,7,7,0,1,0
41,315,315,43,8,35,2,1
9,320,320,74,74,0,1,0
4,349,349,66,14,52,3,2
34,354,354,32,32,0,1,0
32,356,356,52,52,0,1,0
30,363,363,15,15,0,1,0
28,370,370,26,26,0,1,0
45,397,397,7,7,0,1,0
3,407,407,58,58,0,1,0
35,426,426,34,19,15,2,1
26,429,429,11,11,0,1,0
43,431,431,51,19,32,3,2
7,444,444,69,34,35,4,3
38,446,446,13,5,8,3,2
15,463,463,59,59,0,1,0
46,463,463,11,1,10,3,2
21,465,465,23,23,0,1,0
11,479,479,31,31,0,1,0
2,487,487,6,3,3,2,1
23,490,490,43,43,0,1,0
22,493,493,7,3,4,2,1
0,493,493,38,8,30,4,3
16,497,497,51,43,8,2,1

24,111,111,6,6,0,1,0
36,130,130,2,2,0,1,0
38,132,132,20,7,13,4,3
19,137,137,4,4,0,1,0
22,138,138,4,1,3,2,1
20,150,150,3,3,0,1,0
1,157,157,10,10,0,1,0
27,165,165,23,17,6,3,2
39,166,166,26,8,18,2,1
53,168,168,5,5,0,1,0
11,175,175,1,1,0,1,0
3,185,185,8,1,7,2,1
32,193,193,25,25,0,1,0
6,212,212,11,11,0,1,0
31,213,213,10,1,9,4,3
43,230,230,49,49,0,1,0
50,232,232,40,40,0,1,0
34,233,233,34,34,0,1,0
13,235,235,11,2,9,4,3
8,242,242,11,3,8,3,2
49,247,247,56,56,0,1,0
21,252,252,29,29,0,1,0
2,256,256,12,3,9,2,1
23,262,262,2,2,0,1,0
4,262,262,5,5,0,1,0
44,265,265,2,2,0,1,0
29,269,269,22,22,0,1,0
46,297,297,47,47,0,1,0
52,313,313,15,15,0,1,0
5,317,317,18,18,0,1,0
51,323,323,35,35,0,1,0
28,335,335,12,4,8,3,2
25,341,341,12,5,7,2,1
48,361,361,4,1,3,2,1
33,366,366,10,6,4,2,1
26,373,373,12,12,0,1,0
14,386,386,1,1,0,1,0
40,389,389,22,22,0,1,0
10,395,395,3,3,0,1,0
30,401,401,18,18,0,1,0
9,412,412,38,38,0,1,0
41,413,413,76,76,0,1,0
35,415,415,35,21,14,3,2
0,428,428,6,6,0,1,0
7,440,440,119,60,59,3,2
12,456,456,15,9,6,3,2
37,463,463,7,2,5,2,1
47,465,465,1,1,0,1,0
16,467,467,50,33,17,2,1
18,472,472,8,1,7,2,1
15,483,483,12,12,0,1,0
42,484,484,27,13,14,2,1
45,498,498,100,83,17,2,1
17,500,500,112,112,0,1,0

37,126,126,4,4,0,1,0
42,135,135,8,8,0,1,0
0,138,138,18,6,12,4,3
21,154,154,18,10,8,2,1
30,162,162,26,6,20,3,2
3,184,184,12,12,0,1,0
27,192,192,10,10,0,1,0
22,193,193,24,17,7,2,1
15,202,202,24,24,0,1,0
31,205,205,9,9,0,1,0
17,224,224,19,19,0,1,0
24,235,235,77,37,40,2,1
11,239,239,8,8,0,1,0
19,239,239,11,11,0,1,0
16,256,256,7,7,0,1,0
36,267,267,19,19,0,1,0
18,279,279,1,1,0,1,0
26,281,281,13,13,0,1,0
41,285,285,90,81,9,2,1
25,304,304,4,4,0,1,0
1,324,324,34,19,15,2,1
12,325,325,20,20,0,1,0
2,332,332,36,24,12,3,2
23,338,338,52,52,0,1,0
6,340,340,25,22,3,2,1
9,343,343,55,23,32,3,2
32,347,347,3,3,0,1,0
10,349,349,10,2,8,3,2
20,358,358,1,1,0,1,0
39,368,368,33,33,0,1,0
34,381,381,9,9,0,1,0
40,381,381,85,85,0,1,0
14,383,383,87,18,69,4,3
13,406,406,8,8,0,1,0
33,407,407,7,7,0,1,0
7,418,418,9,9,0,1,0
29,424,424,55,9,46,2,1
5,426,426,17,6,11,2,1
8,431,431,13,13,0,1,0
35,443,443,1,1,0,1,0
4,450,450,167,62,105,4,3
38,462,462,29,29,0,1,0
28,485,485,100,68,32,2,1

6,107,107,5,1,4,2,1
14,111,111,20,2,18,4,3
25,120,120,20,20,0,1,0
23,171,171,14,4,10,2,1
7,174,174,23,11,12,2,1
0,183,183,80,80,0,1,0
20,199,199,10,10,0,1,0
24,210,210,8,1,7,2,1
26,215,215,20,8,12,3,2
30,217,217,20,13,7,2,1
16,254,254,6,6,0,1,0
3,265,265,6,6,0,1,0
5,275,275,37,37,0,1,0
9,276,276,18,9,9,2,1
32,282,282,14,14,0,1,0
8,310,310,15,15,0,1,0
4,313,313,27,27,0,1,0
12,324,324,4,4,0,1,0
21,331,331,23,23,0,1,0
33,341,341,8,8,0,1,0
2,373,373,1,1,0,1,0
13,379,379,22,22,0,1,0
34,382,382,69,5,64,3,2
28,388,388,84,75,9,2,1
22,391,391,11,11,0,1,0
37,395,395,36,36,0,1,0
27,399,399,58,23,35,2,1
1,427,427,13,9,4,2,1
35,429,429,164,128,36,2,1
18,447,447,64,64,0,1,0
10,450,450,85,77,8,2,1
19,452,452,4,1,3,2,1
15,458,458,3,3,0,1,0
31,472,472,2,2,0,1,0
29,479,479,77,77,0,1,0
36,479,479,3,3,0,1,0
17,482,482,60,60,0,1,0
11,499,499,200,116,84,4,3

19,109,109,9,9,0,1,0
9,123,123,34,16,18,2,1
18,131,131,1,1,0,1,0
1,133,133,5,2,3,2,1
0,136,136,2,2,0,1,0
12,145,145,9,9,0,1,0
32,152,152,16,9,7,2,1
38,153,153,4,1,3,2,1
27,157,157,7,7,0,1,0
37,167,167,10,10,0,1,0
24,196,196,5,5,0,1,0
10,202,202,30,30,0,1,0
25,202,202,54,30,24,4,3
11,208,208,14,14,0,1,0
22,216,216,4,1,3,2,1
21,216,216,7,2,5,2,1
5,223,223,2,2,0,1,0
29,230,230,29,29,0,1,0
30,231,231,34,24,10,3,2
26,236,236,31,31,0,1,0
33,239,239,8,3,5,2,1
36,241,241,120,45,75,4,3
6,272,272,28,28,0,1,0
31,291,291,12,12,0,1,0
16,292,292,61,45,16,3,2
23,294,294,36,2,34,3,2
28,295,295,9,9,0,1,0
14,302,302,13,1,12,3,2
35,337,337,77,21,56,3,2
20,340,340,8,1,7,2,1
8,341,341,121,121,0,1,0
34,366,366,1,1,0,1,0
4,366,366,32,18,14,2,1
17,398,398,58,13,45,4,3
15,405,405,15,3,12,4,3
13,406,406,31,31,0,1,0
3,417,417,34,26,8,2,1
7,421,421,41,41,0,1,0
2,445,445,66,44,22,3,2

16,101,101,31,10,21,4,3
14,101,101,1,1,0,1,0
32,104,104,5,2,3,2,1
25,135,135,5,5,0,1,0
9,142,142,66,32,34,2,1
30,147,147,3,3,0,1,0
22,148,148,11,1,10,3,2
29,152,152,19,9,10,3,2
19,174,174,11,11,0,1,0
6,177,177,9,9,0,1,0
21,184,184,22,4,18,4,3
35,187,187,26,26,0,1,0
15,198,198,6,6,0,1,0
17,227,227,27,27,0,1,0
26,243,243,9,2,7,2,1
18,255,255,50,6,44,3,2
3,279,279,40,40,0,1,0
23,296,296,17,17,0,1,0
11,304,304,52,52,0,1,0
24,319,319,3,3,0,1,0
36,324,324,80,38,42,4,3
2,343,343,1,1,0,1,0
4,370,370,9,2,7,2,1
27,376,376,24,24,0,1,0
5,388,388,44,44,0,1,0
34,395,395,63,63,0,1,0
13,408,408,1,1,0,1,0
28,408,408,30,13,17,2,1
1,412,412,28,7,21,2,1
31,423,423,1,1,0,1,0
20,424,424,81,19,62,3,2
10,435,435,77,61,16,3,2
33,450,450,118,118,0,1,0
7,451,451,13,3,10,3,2
12,456,456,73,73,0,1,0
8,498,498,94,80,14,2,1
0,500,500,32,9,23,2,1

5,110,110,1,1,0,1,0
14,128,128,1,1,0,1,0
11,148,148,7,7,0,1,0
26,155,155,5,2,3,2,1
21,156,156,6,6,0,1,0
3,176,176,14,4,10,2,1
25,178,178,9,9,0,1,0
27,179,179,5,5,0,1,0
29,187,187,61,61,0,1,0
18,212,212,27,11,16,2,1
28,245,245,4,4,0,1,0
32,255,255,15,3,12,4,3
17,260,260,43,43,0,1,0
16,271,271,39,39,0,1,0
13,283,283,141,141,0,1,0
12,295,295,87,87,0,1,0
8,307,307,115,19,96,3,2
30,326,326,17,9,8,2,1
31,332,332,8,8,0,1,0
0,335,335,2,2,0,1,0
23,339,339,41,41,0,1,0
7,342,342,21,6,15,4,3
2,349,349,10,10,0,1,0
15,368,368,47,44,3,2,1
20,371,371,73,32,41,3,2
10,382,382,57,57,0,1,0
6,387,387,8,5,3,2,1
33,413,413,1,1,0,1,0
34,426,426,137,137,0,1,0
4,432,432,88,58,30,4,3
9,441,441,33,33,0,1,0
22,442,442,52,14,38,4,3
1,450,450,65,34,31,2,1
19,459,459,4,1,3,2,1
24,491,491,42,12,30,2,1

40,101,101,27,27,0,1,0
5,105,105,15,3,12,2,1
30,117,117,5,5,0,1,0
28,119,119,8,4,4,2,1
32,122,122,25,25,0,1,0
20,145,145,21,21,0,1,0
6,147,147,11,11,0,1,0
19,161,161,9,9,0,1,0
15,161,161,1,1,0,1,0
23,163,163,8,8,0,1,0
7,165,165,43,43,0,1,0
3,171,171,6,6,0,1,0
43,183,183,5,5,0,1,0
31,196,196,1,1,0,1,0
27,211,211,57,57,0,1,0
1,215,215,22,22,0,1,0
12,221,221,1,1,0,1,0
37,230,230,29,26,3,2,1
16,238,238,19,19,0,1,0
25,240,240,19,19,0,1,0
8,243,243,11,11,0,1,0
17,289,289,36,3,33,2,1
39,303,303,42,42,0,1,0
35,308,308,28,28,0,1,0
14,316,316,62,15,47,2,1
33,325,325,47,34,13,2,1
9,330,330,4,4,0,1,0
38,332,332,5,5,0,1,0
24,341,341,10,10,0,1,0
4,347,347,1,1,0,1,0
18,369,369,34,20,14,2,1
26,370,370,86,58,28,2,1
42,371,371,2,2,0,1,0
10,392,392,20,16,4,2,1
0,398,398,14,14,0,1,0
41,426,426,5,5,0,1,0
29,429,429,64,23,41,2,1
11,441,441,41,13,28,2,1
22,442,442,29,16,13,2,1
2,443,443,88,24,64,3,2
21,462,462,17,17,0,1,0
34,466,466,15,1,14,3,2
13,487,487,46,25,21,4,3
36,498,498,50,41,9,4,3

38,111,111,18,11,7,2,1
3,114,114,1,1,0,1,0
11,117,117,5,5,0,1,0
12,130,130,35,35,0,1,0
19,139,139,27,27,0,1,0
15,145,145,34,4,30,2,1
16,152,152,13,1,12,4,3
26,156,156,20,20,0,1,0
7,184,184,10,10,0,1,0
35,189,189,15,15,0,1,0
23,192,192,24,20,4,2,1
17,205,205,27,13,14,3,2
18,212,212,9,1,8,2,1
21,218,218,53,53,0,1,0
30,230,230,25,25,0,1,0
2,233,233,23,23,0,1,0
1,238,238,6,2,4,2,1
27,249,249,23,23,0,1,0
5,253,253,27,27,0,1,0
14,285,285,4,4,0,1,0
13,291,291,39,39,0,1,0
20,301,301,32,29,3,2,1
40,308,308,53,50,3,2,1
22,310,310,40,40,0,1,0
32,311,311,35,35,0,1,0
31,341,341,19,19,0,1,0
0,356,356,44,44,0,1,0
34,389,389,23,23,0,1,0
39,393,393,10,10,0,1,0
25,401,401,48,5,43,2,1
33,403,403,36,36,0,1,0
6,413,413,53,53,0,1,0
8,418,418,27,27,0,1,0
10,440,440,39,15,24,3,2
24,444,444,19,3,16,3,2
9,446,446,17,9,8,3,2
28,453,453,4,4,0,1,0
29,456,456,115,115,0,1,0
4,471,471,5,5,0,1,0
36,477,477,1,1,0,1,0
37,487,487,12,12,0,1,0

2,121,121,23,23,0,1,0
22,139,139,13,1,12,3,2
14,153,153,1,1,0,1,0
29,155,155,7,7,0,1,0
16,171,171,1,1,0,1,0
31,178,178,2,2,0,1,0
27,181,181,36,10,26,3,2
6,182,182,43,43,0,1,0
11,194,194,8,8,0,1,0
4,204,204,45,24,21,4,3
32,209,209,21,21,0,1,0
30,219,219,16,11,5,2,1
25,221,221,10,10,0,1,0
18,223,223,62,50,12,4,3
13,224,224,2,2,0,1,0
3,225,225,6,6,0,1,0
21,234,234,1,1,0,1,0
12,243,243,6,6,0,1,0
9,262,262,6,6,0,1,0
19,272,272,4,4,0,1,0
36,297,297,11,3,8,3,2
1,305,305,81,50,31,2,1
24,336,336,26,26,0,1,0
33,378,378,57,9,48,4,3
20,393,393,58,17,41,4,3
34,395,395,204,180,24,4,3
23,404,404,24,24,0,1,0
28,404,404,11,11,0,1,0
15,407,407,31,31,0,1,0
26,411,411,23,5,18,4,3
7,446,446,227,126,101,4,3
8,454,454,1,1,0,1,0
5,463,463,126,126,0,1,0
0,467,467,25,25,0,1,0
35,469,469,24,24,0,1,0
10,475,475,18,15,3,2,1
17,481,481,22,10,12,4,3

8,118,118,28,23,5,2,1
25,120,120,34,34,0,1,0
22,129,129,9,3,6,2,1
34,131,131,1,1,0,1,0
23,134,134,30,17,13,2,1
24,141,141,30,9,21,2,1
6,153,153,4,1,3,2,1
33,155,155,37,34,3,2,1
9,170,170,32,14,18,2,1
4,181,181,26,3,23,3,2
17,190,190,4,4,0,1,0
26,194,194,1,1,0,1,0
7,235,235,39,23,16,3,2
12,262,262,1,1,0,1,0
2,265,265,5,2,3,2,1
11,273,273,21,21,0,1,0
18,276,276,21,21,0,1,0
1,304,304,8,8,0,1,0
3,304,304,10,10,0,1,0
16,319,319,1,1,0,1,0
0,342,342,93,42,51,4,3
5,366,366,179,161,18,2,1
19,367,367,124,48,76,3,2
29,372,372,1,1,0,1,0
28,379,379,8,4,4,2,1
31,381,381,21,21,0,1,0
30,382,382,5,1,4,2,1
21,391,391,18,8,10,2,1
32,441,441,59,21,38,2,1
27,443,443,8,8,0,1,0
14,448,448,53,10,43,4,3
13,474,474,84,59,25,2,1
20,485,485,128,5,123,4,3
10,494,494,12,3,9,2,1
15,497,497,3,3,0,1,0

31,112,112,17,9,8,2,1
30,121,121,8,8,0,1,0
11,126,126,10,4,6,3,2
1,166,166,1,1,0,1,0
9,168,168,1,1,0,1,0
19,185,185,13,13,0,1,0
29,192,192,62,62,0,1,0
21,203,203,17,7,10,2,1
34,219,219,12,5,7,2,1
17,229,229,5,5,0,1,0
15,232,232,44,44,0,1,0
3,236,236,42,15,27,4,3
12,237,237,1,1,0,1,0
23,271,271,42,30,12,4,3
18,298,298,14,14,0,1,0
16,300,300,37,37,0,1,0
32,323,323,13,10,3,2,1
13,328,328,81,81,0,1,0
26,344,344,6,6,0,1,0
20,351,351,9,9,0,1,0
6,359,359,14,5,9,3,2
2,360,360,18,6,12,4,3
25,365,365,101,37,64,3,2
10,391,391,82,46,36,4,3
14,404,404,157,157,0,1,0
5,418,418,10,10,0,1,0
27,420,420,6,3,3,2,1
8,424,424,41,32,9,2,1
33,428,428,16,3,13,2,1
0,450,450,56,19,37,4,3
22,470,470,62,26,36,3,2
28,487,487,43,10,33,2,1
7,494,494,114,114,0,1,0
24,495,495,58,9,49,2,1
4,499,499,159,144,15,4,3

32,101,101,10,1,9,2,1
0,104,104,3,3,0,1,0
31,107,107,12,1,11,2,1
42,145,145,13,4,9,4,3
8,149,149,5,5,0,1,0
17,176,176,4,1,3,2,1
19,193,193,2,2,0,1,0
18,203,203,16,16,0,1,0
38,205,205,19,19,0,1,0
6,206,206,17,17,0,1,0
22,207,207,35,35,0,1,0
24,221,221,15,15,0,1,0
11,223,223,34,2,32,2,1
35,228,228,12,12,0,1,0
3,236,236,4,4,0,1,0
14,243,243,63,63,0,1,0
26,256,256,11,2,9,2,1
5,259,259,15,6,9,2,1
15,267,267,15,15,0,1,0
29,267,267,42,20,22,2,1
25,270,270,3,3,0,1,0
7,286,286,33,33,0,1,0
30,288,288,65,65,0,1,0
40,289,289,53,53,0,1,0
43,290,290,30,30,0,1,0
20,300,300,17,1,16,2,1
21,302,302,25,10,15,2,1
1,326,326,7,1,6,2,1
13,333,333,25,13,12,4,3
39,352,352,3,3,0,1,0
41,354,354,23,23,0,1,0
10,365,365,45,30,15,2,1
34,378,378,16,1,15,3,2
16,396,396,16,16,0,1,0
37,426,426,96,34,62,4,3
33,428,428,19,1,18,4,3
36,428,428,31,6,25,2,1
12,437,437,70,37,33,4,3
28,445,445,143,132,11,2,1
2,450,450,41,41,0,1,0
27,479,479,16,16,0,1,0
23,486,486,111,96,15,4,3
4,497,497,6,2,4,2,1
9,500,500,13,1,12,3,2

16,107,107,16,16,0,1,0
12,113,113,26,11,15,2,1
22,124,124,6,6,0,1,0
7,126,126,2,2,0,1,0
8,128,128,28,28,0,1,0
29,143,143,4,4,0,1,0
17,161,161,43,38,5,2,1
31,173,173,15,15,0,1,0
19,176,176,25,7,18,3,2
4,185,185,22,22,0,1,0
30,190,190,23,23,0,1,0
32,194,194,15,15,0,1,0
9,199,199,20,20,0,1,0
26,203,203,19,19,0,1,0
0,223,223,8,8,0,1,0
14,251,251,5,1,4,2,1
28,264,264,40,40,0,1,0
20,273,273,39,39,0,1,0
2,294,294,91,71,20,2,1
18,294,294,24,6,18,4,3
15,301,301,39,39,0,1,0
24,308,308,3,3,0,1,0
23,329,329,116,72,44,3,2
21,337,337,25,25,0,1,0
25,363,363,7,1,6,3,2
10,372,372,35,35,0,1,0
27,392,392,15,15,0,1,0
13,437,437,3,3,0,1,0
5,444,444,63,58,5,2,1
6,474,474,66,66,0,1,0
11,495,495,152,140,12,3,2
3,496,496,27,12,15,4,3
1,500,500,121,79,42,2,1

4,119,119,5,1,4,2,1
37,121,121,43,12,31,2,1
19,125,125,1,1,0,1,0
24,162,162,41,25,16,3,2
30,165,165,3,3,0,1,0
18,174,174,1,1,0,1,0
7,181,181,3,3,0,1,0
27,197,197,9,9,0,1,0
2,210,210,5,2,3,2,1
25,229,229,37,7,30,2,1
15,231,231,32,32,0,1,0
8,236,236,11,2,9,4,3
34,245,245,7,7,0,1,0
12,259,259,49,49,0,1,0
11,261,261,21,21,0,1,0
13,284,284,1,1,0,1,0
46,297,297,17,17,0,1,0
45,301,301,7,1,6,3,2
36,307,307,3,3,0,1,0
28,317,317,3,3,0,1,0
20,320,320,10,10,0,1,0
32,323,323,84,84,0,1,0
0,324,324,23,23,0,1,0
9,325,325,24,24,0,1,0
43,326,326,3,3,0,1,0
14,329,329,17,2,15,2,1
6,352,352,29,7,22,2,1
47,366,366,22,10,12,2,1
40,368,368,60,21,39,2,1
10,392,392,33,16,17,2,1
23,393,393,59,59,0,1,0
44,394,394,22,12,10,2,1
1,402,402,13,5,8,2,1
31,410,410,30,3,27,4,3
41,411,411,23,23,0,1,0
3,416,416,62,28,34,3,2
22,432,432,16,7,9,2,1
38,434,434,53,45,8,2,1
39,439,439,109,87,22,2,1
21,450,450,15,4,11,2,1
42,450,450,17,10,7,2,1
35,463,463,71,71,0,1,0
33,479,479,61,10,51,4,3
17,482,482,3,3,0,1,0
26,485,485,7,1,6,2,1
16,494,494,21,21,0,1,0
29,499,499,84,84,0,1,0
5,500,500,65,65,0,1,0

1,106,106,8,8,0,1,0
19,113,113,3,3,0,1,0
33,114,114,5,2,3,2,1
7,115,115,1,1,0,1,0
12,122,122,27,27,0,1,0
22,132,132,5,2,3,2,1
14,141,141,5,5,0,1,0
28,151,151,8,8,0,1,0
8,154,154,21,21,0,1,0
18,160,160,1,1,0,1,0
27,166,166,21,7,14,2,1
4,166,166,20,8,12,3,2
15,169,169,8,8,0,1,0
6,191,191,36,36,0,1,0
9,214,214,46,36,10,2,1
0,232,232,11,3,8,2,1
40,240,240,40,10,30,3,2
32,251,251,8,8,0,1,0
5,257,257,6,6,0,1,0
24,264,264,55,55,0,1,0
37,281,281,24,11,13,2,1
13,293,293,37,37,0,1,0
30,326,326,78,15,63,3,2
31,327,327,1,1,0,1,0
16,327,327,2,2,0,1,0
10,334,334,57,14,43,2,1
36,366,366,2,2,0,1,0
11,369,369,34,34,0,1,0
17,375,375,53,22,31,2,1
20,383,383,13,13,0,1,0
25,389,389,5,5,0,1,0
35,391,391,32,32,0,1,0
2,394,394,28,18,10,3,2
21,410,410,56,56,0,1,0
39,418,418,47,39,8,2,1
38,466,466,76,63,13,2,1
26,476,476,58,50,8,3,2
29,485,485,23,2,21,4,3
23,486,486,24,2,22,4,3
34,487,487,154,154,0,1,0
3,492,492,102,2,100,3,2

4,124,124,31,11,20,2,1
30,140,140,9,9,0,1,0
7,154,154,10,10,0,1,0
32,156,156,20,1,19,2,1
8,183,183,5,5,0,1,0
21,196,196,76,76,0,1,0
25,197,197,13,13,0,1,0
9,201,201,1,1,0,1,0
13,201,201,63,63,0,1,0
24,209,209,8,8,0,1,0
12,222,222,15,15,0,1,0
1,223,223,10,1,9,4,3
31,235,235,99,87,12,3,2
17,236,236,20,10,10,2,1
18,236,236,4,1,3,2,1
16,237,237,32,32,0,1,0
19,240,240,10,2,8,2,1
14,269,269,17,8,9,4,3
3,271,271,42,5,37,2,1
26,285,285,5,5,0,1,0
5,296,296,50,50,0,1,0
6,297,297,52,4,48,4,3
20,317,317,13,8,5,2,1
15,319,319,4,4,0,1,0
0,324,324,96,47,49,2,1
2,364,364,10,10,0,1,0
22,372,372,13,13,0,1,0
28,377,377,22,22,0,1,0
10,433,433,157,113,44,2,1
29,449,449,32,14,18,2,1
27,465,465,5,1,4,2,1
11,481,481,171,171,0,1,0
23,483,483,19,19,0,1,0

15,101,101,1,1,0,1,0
37,112,112,18,6,12,3,2
34,121,121,1,1,0,1,0
31,142,142,7,7,0,1,0
2,145,145,6,3,3,2,1
1,151,151,1,1,0,1,0
22,155,155,12,12,0,1,0
33,170,170,12,12,0,1,0
23,172,172,7,7,0,1,0
16,180,180,1,1,0,1,0
29,184,184,66,66,0,1,0
5,197,197,9,9,0,1,0
8,202,202,21,6,15,4,3
18,202,202,10,10,0,1,0
21,218,218,15,15,0,1,0
14,224,224,5,5,0,1,0
40,225,225,4,4,0,1,0
12,232,232,18,4,14,2,1
32,238,238,12,3,9,4,3
19,239,239,114,104,10,2,1
17,242,242,16,11,5,2,1
38,265,265,94,13,81,4,3
4,266,266,104,74,30,2,1
25,267,267,59,59,0,1,0
0,283,283,65,42,23,3,2
9,290,290,12,6,6,3,2
26,294,294,11,11,0,1,0
20,298,298,14,8,6,3,2
30,307,307,20,2,18,3,2
36,319,319,44,44,0,1,0
3,321,321,9,4,5,2,1
6,345,345,25,1,24,3,2
39,399,399,48,3,45,4,3
10,405,405,1,1,0,1,0
13,407,407,20,20,0,1,0
11,409,409,29,29,0,1,0
42,418,418,23,23,0,1,0
41,445,445,46,26,20,2,1
24,449,449,27,10,17,2,1
35,454,454,2,2,0,1,0
27,471,471,42,42,0,1,0
28,494,494,19,15,4,2,1
7,495,495,9,6,3,2,1

12,103,103,5,5,0,1,0
24,107,107,1,1,0,1,0
34,108,108,23,23,0,1,0
10,115,115,2,2,0,1,0
28,138,138,5,5,0,1,0
22,173,173,1,1,0,1,0
40,194,194,53,28,25,2,1
41,198,198,4,4,0,1,0
25,206,206,9,9,0,1,0
1,208,208,12,12,0,1,0
8,210,210,5,5,0,1,0
26,216,216,42,12,30,4,3
16,222,222,10,10,0,1,0
13,228,228,33,6,27,4,3
15,230,230,4,1,3,2,1
31,230,230,81,37,44,3,2
11,240,240,31,17,14,3,2
35,266,266,68,68,0,1,0
14,279,279,5,5,0,1,0
30,281,281,2,2,0,1,0
36,311,311,7,7,0,1,0
38,326,326,83,83,0,1,0
18,350,350,29,11,18,3,2
0,351,351,55,34,21,4,3
20,368,368,73,73,0,1,0
33,406,406,24,10,14,2,1
9,408,408,45,45,0,1,0
7,420,420,30,30,0,1,0
5,425,425,25,7,18,4,3
6,440,440,18,18,0,1,0
42,443,443,21,6,15,2,1
4,443,443,64,20,44,3,2
37,461,461,5,5,0,1,0
21,464,464,23,23,0,1,0
29,466,466,88,88,0,1,0
2,468,468,17,17,0,1,0
32,474,474,2,2,0,1,0
27,479,479,11,11,0,1,0
3,488,488,2,2,0,1,0
23,489,489,5,5,0,1,0
19,493,493,44,32,12,2,1
17,495,495,225,199,26,2,1
39,497,497,10,10,0,1,0

34,103,103,4,1,3,2,1
15,105,105,5,5,0,1,0
27,112,112,12,12,0,1,0
7,130,130,2,2,0,1,0
1,141,141,1,1,0,1,0
39,145,145,22,22,0,1,0
16,147,147,14,1,13,2,1
38,147,147,2,2,0,1,0
37,175,175,12,4,8,3,2
40,178,178,55,55,0,1,0
12,197,197,39,34,5,2,1
13,229,229,47,43,4,2,1
30,230,230,16,16,0,1,0
5,252,252,14,5,9,2,1
35,257,257,1,1,0,1,0
18,262,262,14,14,0,1,0
11,267,267,20,20,0,1,0
20,282,282,21,21,0,1,0
26,282,282,5,1,4,2,1
2,284,284,46,46,0,1,0
23,294,294,20,14,6,2,1
36,307,307,93,93,0,1,0
24,310,310,53,26,27,4,3
22,315,315,7,4,3,2,1
33,338,338,52,46,6,2,1
3,341,341,12,12,0,1,0
4,345,345,71,71,0,1,0
17,346,346,69,69,0,1,0
0,376,376,28,4,24,3,2
10,381,381,28,28,0,1,0
29,389,389,17,3,14,4,3
21,405,405,102,17,85,4,3
14,412,412,24,9,15,4,3
31,417,417,36,27,9,2,1
32,427,427,54,54,0,1,0
25,456,456,8,8,0,1,0
9,456,456,101,66,35,4,3
19,471,471,31,31,0,1,0
8,472,472,35,35,0,1,0
28,483,483,14,2,12,2,1
6,489,489,3,3,0,1,0

30,104,104,2,2,0,1,0
36,118,118,29,5,24,2,1
27,123,123,23,4,19,3,2
4,131,131,21,21,0,1,0
18,136,136,31,31,0,1,0
37,145,145,10,1,9,4,3
34,146,146,5,2,3,2,1
12,146,146,25,7,18,3,2
28,146,146,10,10,0,1,0
0,152,152,5,5,0,1,0
24,185,185,10,10,0,1,0
5,206,206,16,12,4,2,1
20,206,206,18,18,0,1,0
29,218,218,17,6,11,2,1
22,221,221,41,5,36,3,2
10,229,229,1,1,0,1,0
15,286,286,60,60,0,1,0
19,291,291,16,12,4,2,1
40,300,300,31,21,10,3,2
1,314,314,36,24,12,3,2
2,323,323,49,26,23,3,2
25,330,330,17,8,9,4,3
33,335,335,34,34,0,1,0
32,339,339,30,10,20,3,2
9,342,342,30,12,18,3,2
8,363,363,74,8,66,3,2
21,367,367,44,5,39,4,3
35,394,394,29,12,17,2,1
14,399,399,8,8,0,1,0
23,404,404,17,17,0,1,0
11,406,406,70,29,41,2,1
13,411,411,27,27,0,1,0
26,414,414,5,2,3,2,1
16,415,415,19,4,15,4,3
7,418,418,12,12,0,1,0
38,440,440,116,116,0,1,0
17,472,472,24,16,8,3,2
6,478,478,1,1,0,1,0
31,485,485,13,3,10,2,1
3,492,492,15,12,3,2,1
39,498,498,105,73,32,2,1

2,103,103,1,1,0,1,0
35,110,110,4,1,3,2,1
34,114,114,8,5,3,2,1
41,115,115,14,14,0,1,0
0,118,118,28,10,18,4,3
33,125,125,14,14,0,1,0
32,132,132,26,26,0,1,0
16,135,135,5,1,4,2,1
43,147,147,4,4,0,1,0
1,152,152,45,21,24,2,1
36,170,170,6,6,0,1,0
29,173,173,20,20,0,1,0
7,180,180,10,10,0,1,0
31,180,180,45,45,0,1,0
4,181,181,3,3,0,1,0
8,187,187,4,4,0,1,0
22,193,193,15,8,7,2,1
17,193,193,25,25,0,1,0
5,211,211,13,10,3,2,1
10,226,226,20,9,11,2,1
13,242,242,10,6,4,2,1
42,244,244,23,23,0,1,0
12,247,247,45,35,10,3,2
30,257,257,20,14,6,2,1
20,260,260,5,1,4,2,1
21,263,263,5,2,3,2,1
3,290,290,36,15,21,3,2
15,295,295,1,1,0,1,0
18,298,298,8,8,0,1,0
14,312,312,30,30,0,1,0
24,314,314,58,38,20,3,2
27,315,315,71,55,16,3,2
38,326,326,3,3,0,1,0
11,328,328,1,1,0,1,0
26,331,331,17,6,11,2,1
23,357,357,43,23,20,2,1
19,381,381,110,74,36,3,2
39,390,390,5,5,0,1,0
37,414,414,9,2,7,2,1
28,438,438,5,5,0,1,0
6,448,448,9,3,6,2,1
25,454,454,92,62,30,4,3
40,495,495,99,55,44,3,2
9,495,495,13,8,5,2,1

4,105,105,4,4,0,1,0
0,125,125,15,15,0,1,0
5,141,141,22,19,3,2,1
7,144,144,4,4,0,1,0
28,151,151,37,37,0,1,0
39,155,155,7,7,0,1,0
8,163,163,9,9,0,1,0
35,164,164,21,15,6,2,1
24,170,170,20,20,0,1,0
16,175,175,8,8,0,1,0
20,180,180,13,13,0,1,0
22,183,183,2,2,0,1,0
14,187,187,4,1,3,2,1
36,188,188,15,2,13,2,1
2,206,206,66,66,0,1,0
21,242,242,16,16,0,1,0
10,245,245,38,38,0,1,0
44,249,249,19,16,3,2,1
33,258,258,1,1,0,1,0
43,269,269,52,52,0,1,0
9,296,296,32,32,0,1,0
12,299,299,8,3,5,2,1
27,301,301,24,24,0,1,0
42,308,308,11,5,6,3,2
31,320,320,24,24,0,1,0
41,326,326,39,3,36,4,3
6,341,341,5,5,0,1,0
19,344,344,8,8,0,1,0
30,345,345,45,45,0,1,0
18,365,365,28,8,20,2,1
13,379,379,13,3,10,2,1
40,380,380,96,78,18,4,3
1,395,395,111,21,90,3,2
25,400,400,20,20,0,1,0
26,400,400,11,11,0,1,0
29,411,411,11,11,0,1,0
32,421,421,43,24,19,2,1
38,428,428,28,7,21,2,1
37,430,430,50,50,0,1,0
15,439,439,21,21,0,1,0
23,448,448,7,7,0,1,0
34,451,451,84,28,56,3,2
11,455,455,47,2,45,2,1
17,470,470,22,22,0,1,0
3,488,488,8,8,0,1,0

17,108,108,17,17,0,1,0
32,123,123,10,10,0,1,0
34,129,129,9,9,0,1,0
13,142,142,14,2,12,4,3
10,163,163,31,21,10,3,2
7,181,181,5,1,4,2,1
35,186,186,8,8,0,1,0
28,188,188,18,4,14,3,2
14,195,195,29,4,25,4,3
30,205,205,105,41,64,3,2
5,214,214,10,10,0,1,0
38,221,221,1,1,0,1,0
9,242,242,28,16,12,4,3
6,242,242,54,54,0,1,0
18,243,243,30,30,0,1,0
31,247,247,26,1,25,2,1
27,250,250,11,1,10,3,2
1,260,260,1,1,0,1,0
12,281,281,52,46,6,2,1
23,289,289,56,56,0,1,0
20,290,290,16,1,15,4,3
26,295,295,21,21,0,1,0
11,317,317,12,4,8,2,1
2,318,318,5,5,0,1,0
40,323,323,3,3,0,1,0
3,343,343,12,12,0,1,0
21,346,346,33,33,0,1,0
22,352,352,1,1,0,1,0
19,357,357,1,1,0,1,0
29,365,365,16,3,13,2,1
15,365,365,22,9,13,3,2
8,381,381,52,52,0,1,0
33,393,393,45,33,12,2,1
36,395,395,106,70,36,3,2
0,416,416,43,11,32,3,2
37,416,416,26,26,0,1,0
39,418,418,44,44,0,1,0
24,432,432,41,41,0,1,0
16,445,445,65,23,42,4,3
25,459,459,13,4,9,2,1
4,459,459,41,41,0,1,0

18,114,114,1,1,0,1,0
5,122,122,8,5,3,2,1
27,127,127,7,7,0,1,0
31,131,131,15,15,0,1,0
0,146,146,10,4,6,2,1
8,155,155,1,1,0,1,0
33,155,155,23,23,0,1,0
4,160,160,18,18,0,1,0
21,168,168,29,29,0,1,0
24,181,181,19,1,18,2,1
42,193,193,41,11,30,3,2
38,208,208,28,16,12,3,2
26,212,212,10,10,0,1,0
45,214,214,48,48,0,1,0
9,219,219,18,18,0,1,0
44,237,237,26,11,15,2,1
30,241,241,5,5,0,1,0
25,250,250,42,42,0,1,0
13,254,254,6,3,3,2,1
19,288,288,8,2,6,2,1
36,291,291,22,22,0,1,0
1,310,310,34,34,0,1,0
6,311,311,3,3,0,1,0
2,312,312,53,33,20,3,2
16,317,317,21,21,0,1,0
39,318,318,5,5,0,1,0
22,330,330,10,10,0,1,0
17,333,333,26,1,25,2,1
41,334,334,8,2,6,3,2
10,343,343,6,1,5,2,1
15,346,346,19,19,0,1,0
23,349,349,18,9,9,2,1
20,359,359,23,5,18,4,3
29,374,374,35,32,3,2,1
12,375,375,48,48,0,1,0
28,389,389,26,3,23,2,1
46,391,391,41,14,27,2,1
32,406,406,74,62,12,4,3
11,407,407,53,16,37,3,2
14,409,409,35,8,27,2,1
35,434,434,12,12,0,1,0
43,438,438,9,6,3,2,1
3,448,448,1,1,0,1,0
37,471,471,23,16,7,2,1
34,477,477,19,19,0,1,0
47,482,482,151,151,0,1,0
7,487,487,29,29,0,1,0
40,499,499,28,14,14,3,2

9,100,100,5,5,0,1,0
3,108,108,6,2,4,2,1
35,125,125,11,11,0,1,0
15,138,138,12,7,5,2,1
18,148,148,5,5,0,1,0
19,163,163,7,7,0,1,0
29,168,168,9,3,6,2,1
33,173,173,4,4,0,1,0
23,190,190,54,54,0,1,0
41,199,199,9,9,0,1,0
36,219,219,23,1,22,3,2
20,224,224,4,4,0,1,0
8,229,229,59,59,0,1,0
26,232,232,12,3,9,4,3
39,235,235,4,4,0,1,0
6,248,248,5,1,4,2,1
31,253,253,79,1,78,3,2
25,256,256,4,4,0,1,0
10,279,279,7,1,6,3,2
2,287,287,35,1,34,3,2
27,306,306,3,3,0,1,0
40,309,309,19,19,0,1,0
4,318,318,83,83,0,1,0
28,336,336,1,1,0,1,0
24,345,345,30,27,3,2,1
0,360,360,38,12,26,3,2
21,371,371,109,45,64,3,2
1,387,387,11,5,6,3,2
5,388,388,23,23,0,1,0
14,401,401,40,40,0,1,0
30,421,421,79,79,0,1,0
17,422,422,34,22,12,4,3
12,425,425,75,65,10,2,1
38,428,428,81,55,26,2,1
11,431,431,19,1,18,3,2
7,454,454,1,1,0,1,0
16,456,456,12,12,0,1,0
34,465,465,36,36,0,1,0
22,471,471,88,24,64,3,2
13,483,483,54,41,13,2,1
37,486,486,78,44,34,2,1
32,494,494,35,1,34,2,1

19,104,104,4,4,0,1,0
16,106,106,22,22,0,1,0
7,106,106,3,3,0,1,0
27,114,114,16,8,8,2,1
22,128,128,24,24,0,1,0
0,147,147,4,4,0,1,0
11,152,152,13,13,0,1,0
38,158,158,27,15,12,2,1
42,165,165,26,26,0,1,0
6,171,171,3,3,0,1,0
20,196,196,14,5,9,4,3
26,197,197,7,1,6,2,1
13,201,201,1,1,0,1,0
40,201,201,14,1,13,2,1
28,225,225,3,3,0,1,0
41,230,230,5,2,3,2,1
32,245,245,1,1,0,1,0
18,246,246,20,10,10,3,2
43,252,252,15,2,13,2,1
35,254,254,54,54,0,1,0
15,262,262,1,1,0,1,0
10,270,270,14,14,0,1,0
2,274,274,15,15,0,1,0
9,276,276,6,6,0,1,0
33,294,294,48,48,0,1,0
23,305,305,65,65,0,1,0
12,315,315,54,54,0,1,0
4,329,329,7,7,0,1,0
17,333,333,38,38,0,1,0
37,357,357,26,14,12,2,1
25,363,363,5,5,0,1,0
30,381,381,10,7,3,2,1
31,384,384,7,7,0,1,0
39,400,400,20,6,14,3,2
21,406,406,20,20,0,1,0
24,407,407,109,109,0,1,0
44,416,416,71,71,0,1,0
1,423,423,11,8,3,2,1
14,432,432,26,13,13,2,1
36,440,440,64,10,54,4,3
5,456,456,17,17,0,1,0
3,465,465,39,10,29,4,3
8,468,468,35,14,21,2,1
29,470,470,40,32,8,3,2
34,488,488,194,166,28,2,1

27,109,109,1,1,0,1,0
18,117,117,1,1,0,1,0
20,128,128,24,24,0,1,0
19,133,133,4,4,0,1,0
24,140,140,23,23,0,1,0
29,148,148,33,9,24,3,2
13,152,152,5,2,3,2,1
17,166,166,7,7,0,1,0
31,191,191,6,6,0,1,0
1,193,193,3,3,0,1,0
32,196,196,15,15,0,1,0
8,201,201,41,19,22,3,2
15,217,217,15,15,0,1,0
30,246,246,29,29,0,1,0
4,252,252,7,7,0,1,0
7,257,257,47,34,13,3,2
28,283,283,13,2,11,2,1
16,296,296,9,6,3,2,1
35,314,314,30,30,0,1,0
12,321,321,3,3,0,1,0
10,328,328,145,13,132,4,3
23,335,335,47,47,0,1,0
3,337,337,30,30,0,1,0
33,346,346,2,2,0,1,0
2,349,349,100,11,89,4,3
0,350,350,61,45,16,3,2
37,391,391,12,12,0,1,0
21,406,406,72,63,9,2,1
14,425,425,91,7,84,4,3
9,425,425,8,2,6,3,2
22,438,438,65,3,62,3,2
11,442,442,10,10,0,1,0
36,443,443,28,3,25,2,1
26,446,446,48,42,6,3,2
38,446,446,48,4,44,2,1
6,461,461,55,40,15,4,3
34,476,476,100,100,0,1,0
25,487,487,35,17,18,2,1
5,493,493,7,1,6,3,2

32,104,104,6,3,3,2,1
46,105,105,1,1,0,1,0
27,106,106,2,2,0,1,0
25,106,106,14,2,12,2,1
44,110,110,12,12,0,1,0
13,111,111,9,9,0,1,0
40,115,115,20,10,10,4,3
28,129,129,4,4,0,1,0
11,157,157,7,7,0,1,0
17,162,162,2,2,0,1,0
9,165,165,11,11,0,1,0
41,169,169,34,34,0,1,0
38,173,173,25,25,0,1,0
0,176,176,17,5,12,3,2
42,194,194,3,3,0,1,0
6,206,206,20,20,0,1,0
47,208,208,34,6,28,2,1
8,228,228,3,3,0,1,0
7,230,230,7,7,0,1,0
10,243,243,40,16,24,3,2
5,249,249,5,2,3,2,1
36,256,256,24,6,18,3,2
19,258,258,3,3,0,1,0
12,258,258,17,3,14,2,1
33,265,265,40,40,0,1,0
14,282,282,22,4,18,3,2
26,292,292,10,10,0,1,0
31,299,299,16,16,0,1,0
1,304,304,2,2,0,1,0
24,306,306,1,1,0,1,0
43,314,314,3,3,0,1,0
39,322,322,41,12,29,3,2
18,334,334,151,110,41,3,2
20,338,338,10,10,0,1,0
4,343,343,48,33,15,4,3
34,347,347,27,17,10,3,2
30,355,355,11,11,0,1,0
21,362,362,24,6,18,2,1
29,370,370,125,71,54,4,3
22,414,414,32,32,0,1,0
45,416,416,54,54,0,1,0
23,430,430,4,4,0,1,0
3,453,453,1,1,0,1,0
16,455,455,32,32,0,1,0
15,460,460,31,31,0,1,0
35,484,484,29,17,12,2,1
2,497,497,57,57,0,1,0
37,500,500,35,35,0,1,0

21,101,101,16,16,0,1,0
14,103,103,22,22,0,1,0
10,116,116,23,1,22,3,2
26,126,126,13,5,8,2,1
27,139,139,1,1,0,1,0
9,155,155,75,75,0,1,0
11,207,207,7,1,6,3,2
28,225,225,18,18,0,1,0
25,236,236,22,22,0,1,0
34,238,238,21,21,0,1,0
32,246,246,5,5,0,1,0
2,251,251,16,16,0,1,0
31,252,252,23,9,14,3,2
12,252,252,34,4,30,2,1
15,258,258,1,1,0,1,0
22,300,300,10,1,9,4,3
8,336,336,36,36,0,1,0
6,341,341,9,9,0,1,0
20,360,360,84,45,39,4,3
16,372,372,40,19,21,2,1
29,379,379,5,5,0,1,0
4,379,379,20,11,9,2,1
1,382,382,56,56,0,1,0
33,395,395,25,13,12,4,3
5,402,402,13,13,0,1,0
18,405,405,65,65,0,1,0
13,411,411,8,8,0,1,0
7,420,420,164,117,47,2,1
19,420,420,40,40,0,1,0
0,429,429,20,4,16,2,1
23,456,456,69,69,0,1,0
17,465,465,5,2,3,2,1
30,478,478,213,75,138,4,3
24,489,489,34,34,0,1,0
3,496,496,25,25,0,1,0

30,104,104,21,6,15,4,3
15,108,108,18,18,0,1,0
5,115,115,16,16,0,1,0
11,135,135,1,1,0,1,0
2,144,144,10,10,0,1,0
9,157,157,27,27,0,1,0
16,160,160,6,6,0,1,0
22,173,173,13,3,10,3,2
0,177,177,14,14,0,1,0
28,193,193,3,3,0,1,0
20,221,221,4,4,0,1,0
17,231,231,28,28,0,1,0
8,238,238,41,41,0,1,0
10,261,261,7,3,4,2,1
18,276,276,10,10,0,1,0
7,285,285,29,29,0,1,0
33,297,297,45,13,32,3,2
41,302,302,17,6,11,3,2
27,303,303,8,8,0,1,0
25,306,306,62,12,50,2,1
38,318,318,7,1,6,3,2
24,319,319,2,2,0,1,0
42,333,333,135,45,90,3,2
21,345,345,77,64,13,2,1
37,355,355,57,57,0,1,0
6,357,357,31,31,0,1,0
13,388,388,14,11,3,2,1
32,398,398,52,5,47,2,1
14,401,401,4,4,0,1,0
31,403,403,32,2,30,4,3
3,406,406,60,60,0,1,0
34,408,408,12,8,4,2,1
4,428,428,6,6,0,1,0
39,440,440,23,11,12,3,2
12,447,447,31,7,24,4,3
1,449,449,76,76,0,1,0
35,453,453,44,44,0,1,0
29,456,456,48,48,0,1,0
26,471,471,21,21,0,1,0
19,478,478,10,10,0,1,0
40,488,488,70,20,50,2,1
23,491,491,4,4,0,1,0
36,492,492,50,50,0,1,0

12,115,115,6,6,0,1,0
3,141,141,2,2,0,1,0
10,147,147,5,5,0,1,0
35,163,163,31,31,0,1,0
24,169,169,35,21,14,2,1
16,189,189,13,13,0,1,0
8,193,193,8,8,0,1,0
25,194,194,15,15,0,1,0
1,197,197,58,7,51,4,3
27,200,200,6,6,0,1,0
17,203,203,4,4,0,1,0
14,228,228,11,11,0,1,0
39,232,232,8,8,0,1,0
30,232,232,5,5,0,1,0
6,236,236,24,17,7,2,1
15,247,247,3,3,0,1,0
9,277,277,6,6,0,1,0
5,287,287,18,18,0,1,0
0,308,308,64,64,0,1,0
41,312,312,114,99,15,4,3
19,313,313,25,21,4,2,1
23,324,324,18,3,15,2,1
18,337,337,29,26,3,2,1
2,339,339,18,9,9,4,3
34,343,343,16,7,9,4,3
11,363,363,45,30,15,4,3
22,365,365,73,24,49,2,1
33,405,405,34,34,0,1,0
13,413,413,46,20,26,3,2
7,429,429,81,81,0,1,0
38,438,438,7,7,0,1,0
4,442,442,155,109,46,4,3
31,442,442,44,35,9,4,3
20,445,445,8,8,0,1,0
29,449,449,18,18,0,1,0
28,449,449,29,29,0,1,0
21,449,449,5,5,0,1,0
40,455,455,51,51,0,1,0
36,458,458,11,11,0,1,0
26,461,461,53,11,42,3,2
32,464,464,59,55,4,2,1
37,491,491,60,60,0,1,0

30,103,103,2,2,0,1,0
18,104,104,5,5,0,1,0
39,106,106,4,4,0,1,0
40,125,125,3,3,0,1,0
17,126,126,8,8,0,1,0
33,142,142,17,17,0,1,0
23,145,145,39,31,8,2,1
6,150,150,10,5,5,2,1
15,164,164,13,13,0,1,0
41,173,173,4,4,0,1,0
19,173,173,24,24,0,1,0
13,186,186,20,13,7,2,1
35,190,190,16,16,0,1,0
2,198,198,3,3,0,1,0
8,213,213,1,1,0,1,0
3,241,241,35,21,14,2,1
32,246,246,1,1,0,1,0
34,257,257,39,39,0,1,0
28,258,258,31,12,19,4,3
37,274,274,26,26,0,1,0
29,279,279,19,19,0,1,0
25,283,283,10,10,0,1,0
22,296,296,12,5,7,2,1
12,306,306,2,2,0,1,0
26,345,345,145,85,60,4,3
0,347,347,17,3,14,2,1
5,350,350,78,78,0,1,0
38,367,367,72,72,0,1,0
36,369,369,16,1,15,4,3
4,392,392,44,44,0,1,0
14,394,394,6,3,3,2,1
20,402,402,25,11,14,2,1
9,412,412,1,1,0,1,0
10,424,424,148,122,26,3,2
27,428,428,61,61,0,1,0
1,429,429,41,41,0,1,0
31,434,434,19,19,0,1,0
21,446,446,36,15,21,2,1
7,454,454,21,21,0,1,0
11,485,485,60,60,0,1,0
24,487,487,55,32,23,4,3
16,496,496,83,62,21,2,1

20,107,107,16,1,15,4,3
17,121,121,21,15,6,3,2
35,143,143,2,2,0,1,0
12,146,146,2,2,0,1,0
5,147,147,1,1,0,1,0
27,159,159,7,7,0,1,0
15,163,163,15,15,0,1,0
31,165,165,32,8,24,3,2
41,167,167,37,15,22,2,1
14,172,172,29,8,21,2,1
40,204,204,47,5,42,3,2
29,212,212,8,8,0,1,0
26,235,235,3,3,0,1,0
1,288,288,57,54,3,2,1
25,292,292,4,1,3,2,1
36,296,296,25,25,0,1,0
28,300,300,43,24,19,2,1
24,302,302,43,43,0,1,0
18,303,303,1,1,0,1,0
23,311,311,21,21,0,1,0
32,318,318,35,35,0,1,0
21,318,318,22,22,0,1,0
0,322,322,9,9,0,1,0
39,354,354,3,3,0,1,0
10,359,359,78,48,30,4,3
11,363,363,1,1,0,1,0
34,365,365,6,6,0,1,0
4,374,374,7,7,0,1,0
33,375,375,49,15,34,2,1
6,379,379,49,39,10,2,1
2,394,394,7,7,0,1,0
7,418,418,41,10,31,3,2
13,424,424,26,11,15,4,3
42,433,433,45,23,22,3,2
43,442,442,207,187,20,2,1
19,448,448,26,18,8,2,1
22,459,459,3,3,0,1,0
38,472,472,5,5,0,1,0
3,475,475,11,1,10,3,2
8,486,486,8,8,0,1,0
9,486,486,84,44,40,2,1
37,494,494,24,24,0,1,0
30,496,496,4,4,0,1,0
16,500,500,104,104,0,1,0

5,114,114,8,3,5,2,1
16,122,122,23,23,0,1,0
23,148,148,6,6,0,1,0
21,152,152,10,2,8,3,2
35,154,154,7,7,0,1,0
15,168,168,11,11,0,1,0
20,169,169,12,6,6,3,2
28,174,174,43,21,22,2,1
19,177,177,9,9,0,1,0
25,178,178,16,16,0,1,0
32,203,203,5,5,0,1,0
26,205,205,19,19,0,1,0
17,210,210,19,1,18,4,3
37,220,220,34,4,30,3,2
13,222,222,11,11,0,1,0
3,241,241,20,5,15,2,1
29,255,255,39,39,0,1,0
7,265,265,20,5,15,2,1
14,294,294,35,26,9,4,3
34,295,295,16,16,0,1,0
38,298,298,53,21,32,4,3
27,332,332,11,11,0,1,0
11,337,337,18,18,0,1,0
1,347,347,30,30,0,1,0
4,362,362,67,67,0,1,0
10,364,364,60,15,45,4,3
6,366,366,95,60,35,2,1
0,381,381,64,54,10,3,2
18,386,386,15,15,0,1,0
8,387,387,7,7,0,1,0
33,391,391,44,1,43,2,1
30,397,397,69,20,49,2,1
36,403,403,74,74,0,1,0
9,428,428,62,62,0,1,0
12,439,439,34,27,7,2,1
24,440,440,39,24,15,4,3
2,445,445,28,5,23,2,1
31,455,455,79,79,0,1,0
22,472,472,4,4,0,1,0

2,115,115,2,2,0,1,0
20,125,125,5,5,0,1,0
41,126,126,11,11,0,1,0
43,128,128,12,1,11,4,3
27,139,139,23,23,0,1,0
12,142,142,2,2,0,1,0
23,145,145,8,8,0,1,0
28,147,147,11,11,0,1,0
3,154,154,13,10,3,2,1
25,156,156,31,21,10,3,2
39,156,156,51,24,27,2,1
36,163,163,12,8,4,2,1
1,168,168,16,16,0,1,0
32,206,206,67,67,0,1,0
9,213,213,31,16,15,4,3
34,216,216,4,1,3,2,1
13,221,221,1,1,0,1,0
40,227,227,9,4,5,2,1
22,231,231,6,6,0,1,0
29,249,249,3,3,0,1,0
18,289,289,11,1,10,3,2
8,309,309,40,31,9,2,1
42,310,310,57,46,11,2,1
30,320,320,6,6,0,1,0
31,322,322,1,1,0,1,0
44,325,325,6,6,0,1,0
33,342,342,82,9,73,4,3
15,355,355,25,25,0,1,0
21,356,356,23,23,0,1,0
14,357,357,12,3,9,4,3
17,359,359,86,18,68,4,3
16,365,365,17,9,8,3,2
10,371,371,31,22,9,4,3
37,399,399,14,14,0,1,0
5,408,408,22,22,0,1,0
4,413,413,73,73,0,1,0
6,423,423,96,96,0,1,0
24,429,429,14,8,6,2,1
7,430,430,7,7,0,1,0
19,430,430,74,74,0,1,0
35,439,439,1,1,0,1,0
11,463,463,1,1,0,1,0
26,473,473,44,26,18,2,1
38,480,480,23,23,0,1,0
0,497,497,66,66,0,1,0

30,104,104,12,2,10,3,2
7,111,111,37,22,15,4,3
25,132,132,8,8,0,1,0
24,139,139,22,18,4,2,1
1,145,145,14,10,4,2,1
21,159,159,15,15,0,1,0
19,167,167,29,21,8,3,2
17,172,172,4,4,0,1,0
3,178,178,7,7,0,1,0
33,206,206,1,1,0,1,0
38,227,227,60,26,34,3,2
9,229,229,44,44,0,1,0
6,240,240,1,1,0,1,0
4,247,247,23,23,0,1,0
36,248,248,13,13,0,1,0
27,253,253,7,7,0,1,0
32,259,259,3,3,0,1,0
16,288,288,17,17,0,1,0
31,298,298,20,10,10,2,1
18,303,303,82,71,11,2,1
13,304,304,47,31,16,2,1
15,317,317,4,4,0,1,0
10,319,319,14,14,0,1,0
34,321,321,81,5,76,3,2
12,356,356,13,13,0,1,0
0,358,358,14,4,10,2,1
37,365,365,23,23,0,1,0
5,371,371,12,12,0,1,0
14,374,374,33,33,0,1,0
35,392,392,21,21,0,1,0
26,392,392,63,11,52,3,2
23,395,395,16,1,15,2,1
2,399,399,34,34,0,1,0
28,403,403,47,19,28,4,3
11,453,453,39,39,0,1,0
29,469,469,112,62,50,2,1
39,475,475,84,84,0,1,0
22,475,475,18,5,13,2,1
8,486,486,69,52,17,3,2
20,488,488,18,18,0,1,0

37,115,115,12,12,0,1,0
4,117,117,31,11,20,4,3
11,136,136,33,33,0,1,0
17,139,139,24,19,5,2,1
13,151,151,5,5,0,1,0
2,158,158,19,19,0,1,0
26,170,170,42,42,0,1,0
32,176,176,13,3,10,2,1
6,194,194,16,16,0,1,0
8,197,197,9,9,0,1,0
7,199,199,11,11,0,1,0
19,202,202,21,21,0,1,0
20,206,206,28,28,0,1,0
31,215,215,40,40,0,1,0
15,217,217,42,8,34,3,2
10,219,219,15,15,0,1,0
27,253,253,15,15,0,1,0
5,293,293,2,2,0,1,0
30,305,305,7,7,0,1,0
36,306,306,30,19,11,2,1
22,312,312,29,14,15,4,3
29,314,314,27,6,21,4,3
14,324,324,76,17,59,4,3
23,330,330,18,18,0,1,0
12,337,337,38,27,11,2,1
21,374,374,10,10,0,1,0
33,376,376,57,37,20,4,3
16,377,377,44,34,10,3,2
0,380,380,2,2,0,1,0
3,393,393,73,17,56,3,2
25,410,410,64,23,41,2,1
18,413,413,44,18,26,2,1
28,414,414,11,5,6,2,1
24,416,416,64,16,48,4,3
35,417,417,27,9,18,2,1
9,419,419,12,12,0,1,0
1,421,421,13,1,12,2,1
34,459,459,41,41,0,1,0

21,103,103,1,1,0,1,0
15,111,111,11,3,8,3,2
38,118,118,20,2,18,3,2
14,118,118,4,4,0,1,0
28,119,119,10,4,6,3,2
41,120,120,8,8,0,1,0
4,143,143,25,19,6,2,1
1,145,145,9,9,0,1,0
13,165,165,27,9,18,4,3
34,166,166,22,5,17,3,2
2,169,169,6,6,0,1,0
6,170,170,8,8,0,1,0
19,179,179,5,5,0,1,0
33,179,179,4,4,0,1,0
29,181,181,1,1,0,1,0
20,200,200,10,10,0,1,0
32,202,202,38,38,0,1,0
12,204,204,26,26,0,1,0
25,235,235,1,1,0,1,0
5,245,245,7,7,0,1,0
26,264,264,24,9,15,4,3
10,271,271,14,1,13,3,2
24,272,272,39,39,0,1,0
39,273,273,31,31,0,1,0
22,288,288,15,2,13,2,1
17,318,318,33,18,15,2,1
31,318,318,30,30,0,1,0
30,328,328,163,19,144,4,3
27,331,331,5,5,0,1,0
37,355,355,17,17,0,1,0
35,357,357,25,25,0,1,0
40,362,362,1,1,0,1,0
42,371,371,6,6,0,1,0
0,376,376,24,9,15,4,3
9,379,379,60,33,27,4,3
23,392,392,91,79,12,4,3
18,409,409,51,51,0,1,0
36,412,412,97,4,93,4,3
43,427,427,18,6,12,4,3
3,429,429,14,5,9,4,3
11,438,438,17,17,0,1,0
7,446,446,41,8,33,4,3
16,461,461,72,63,9,2,1
8,476,476,17,13,4,2,1

8,110,110,29,29,0,1,0
4,114,114,7,4,3,2,1
31,116,116,18,18,0,1,0
34,117,117,15,4,11,4,3
16,121,121,1,1,0,1,0
21,138,138,1,1,0,1,0
25,140,140,14,14,0,1,0
27,150,150,19,11,8,2,1
41,155,155,2,2,0,1,0
20,156,156,10,1,9,4,3
29,158,158,18,8,10,3,2
14,159,159,3,3,0,1,0
18,169,169,33,4,29,4,3
10,178,178,1,1,0,1,0
22,190,190,27,3,24,2,1
43,193,193,4,4,0,1,0
2,193,193,13,13,0,1,0
32,238,238,25,25,0,1,0
38,245,245,35,35,0,1,0
37,247,247,1,1,0,1,0
1,252,252,1,1,0,1,0
28,294,294,12,2,10,3,2
33,315,315,71,43,28,4,3
19,335,335,65,21,44,3,2
26,338,338,32,9,23,2,1
35,340,340,31,16,15,4,3
30,349,349,18,18,0,1,0
6,361,361,1,1,0,1,0
11,362,362,17,17,0,1,0
42,364,364,35,16,19,2,1
24,369,369,148,66,82,4,3
15,373,373,17,17,0,1,0
12,377,377,94,76,18,4,3
39,400,400,10,1,9,4,3
5,403,403,87,87,0,1,0
13,407,407,27,9,18,4,3
7,420,420,42,30,12,3,2
0,420,420,4,4,0,1,0
36,438,438,26,5,21,2,1
17,449,449,2,2,0,1,0
3,452,452,2,2,0,1,0
40,460,460,21,10,11,2,1
9,467,467,6,6,0,1,0
23,486,486,103,103,0,1,0

10,100,100,33,13,20,3,2
26,113,113,4,4,0,1,0
18,117,117,11,7,4,2,1
4,124,124,26,6,20,3,2
33,147,147,6,6,0,1,0
29,154,154,16,16,0,1,0
11,155,155,8,8,0,1,0
23,190,190,4,1,3,2,1
1,193,193,7,7,0,1,0
12,209,209,1,1,0,1,0
13,220,220,6,6,0,1,0
30,222,222,12,12,0,1,0
22,244,244,9,9,0,1,0
19,258,258,21,21,0,1,0
5,261,261,1,1,0,1,0
0,265,265,33,33,0,1,0
15,299,299,15,4,11,2,1
16,300,300,20,20,0,1,0
6,312,312,29,7,22,2,1
32,320,320,43,32,11,2,1
7,328,328,66,66,0,1,0
25,328,328,24,24,0,1,0
9,354,354,7,7,0,1,0
28,357,357,27,21,6,3,2
14,358,358,160,160,0,1,0
2,362,362,143,113,30,4,3
3,364,364,12,12,0,1,0
17,382,382,21,21,0,1,0
31,393,393,5,5,0,1,0
27,441,441,22,6,16,3,2
24,446,446,62,40,22,2,1
20,459,459,265,181,84,4,3
8,460,460,11,11,0,1,0
21,471,471,46,32,14,3,2
34,499,499,118,18,100,3,2

1,102,102,13,13,0,1,0
16,109,109,9,9,0,1,0
41,116,116,10,1,9,4,3
18,132,132,9,9,0,1,0
6,142,142,9,9,0,1,0
40,162,162,8,3,5,2,1
3,180,180,13,8,5,2,1
25,188,188,47,21,26,3,2
23,193,193,5,5,0,1,0
22,193,193,24,24,0,1,0
28,193,193,1,1,0,1,0
35,199,199,20,20,0,1,0
8,209,209,3,3,0,1,0
9,210,210,32,32,0,1,0
34,211,211,5,5,0,1,0
14,214,214,1,1,0,1,0
12,246,246,3,3,0,1,0
27,264,264,8,8,0,1,0
44,274,274,11,11,0,1,0
13,282,282,2,2,0,1,0
2,284,284,20,20,0,1,0
0,287,287,83,17,66,3,2
43,297,297,3,3,0,1,0
15,308,308,19,19,0,1,0
20,315,315,3,3,0,1,0
4,327,327,68,68,0,1,0
38,328,328,17,17,0,1,0
39,330,330,85,14,71,4,3
29,342,342,30,24,6,3,2
31,343,343,52,22,30,4,3
5,349,349,17,17,0,1,0
32,353,353,58,58,0,1,0
17,355,355,3,3,0,1,0
19,361,361,45,4,41,2,1
47,362,362,7,7,0,1,0
26,364,364,1,1,0,1,0
37,373,373,86,86,0,1,0
30,388,388,19,12,7,2,1
33,390,390,42,16,26,3,2
11,420,420,19,14,5,2,1
42,421,421,60,60,0,1,0
45,444,444,116,95,21,4,3
21,447,447,1,1,0,1,0
46,447,447,87,61,26,2,1
7,482,482,28,28,0,1,0
24,490,490,9,9,0,1,0
10,494,494,9,3,6,3,2
36,498,498,4,4,0,1,0

38,110,110,17,17,0,1,0
2,113,113,4,1,3,2,1
11,118,118,6,3,3,2,1
12,123,123,11,11,0,1,0
8,127,127,13,13,0,1,0
41,128,128,17,17,0,1,0
10,131,131,43,5,38,3,2
15,149,149,22,22,0,1,0
46,154,154,57,15,42,4,3
1,165,165,3,3,0,1,0
32,191,191,22,22,0,1,0
5,198,198,18,15,3,2,1
34,212,212,3,3,0,1,0
43,224,224,7,7,0,1,0
25,225,225,8,8,0,1,0
31,236,236,5,5,0,1,0
20,260,260,26,26,0,1,0
22,266,266,15,15,0,1,0
29,267,267,23,23,0,1,0
0,274,274,25,4,21,2,1
26,299,299,25,25,0,1,0
21,309,309,8,8,0,1,0
24,317,317,31,20,11,4,3
33,319,319,15,6,9,4,3
13,324,324,17,17,0,1,0
18,332,332,23,23,0,1,0
30,337,337,28,28,0,1,0
16,347,347,22,22,0,1,0
23,352,352,4,1,3,2,1
19,360,360,4,4,0,1,0
4,360,360,1,1,0,1,0
3,362,362,18,18,0,1,0
9,368,368,44,24,20,4,3
17,368,368,1,1,0,1,0
35,373,373,52,52,0,1,0
27,373,373,7,7,0,1,0
28,374,374,46,46,0,1,0
7,414,414,10,4,6,2,1
45,429,429,46,46,0,1,0
42,433,433,51,51,0,1,0
44,439,439,57,57,0,1,0
36,442,442,66,66,0,1,0
37,461,461,45,8,37,2,1
14,461,461,69,7,62,3,2
39,469,469,38,38,0,1,0
6,470,470,43,25,18,2,1
40,497,497,7,7,0,1,0

38,120,120,5,5,0,1,0
41,131,131,13,13,0,1,0
6,134,134,2,2,0,1,0
17,143,143,31,10,21,4,3
37,147,147,8,8,0,1,0
7,151,151,21,11,10,2,1
26,154,154,1,1,0,1,0
11,180,180,14,2,12,4,3
29,205,205,3,3,0,1,0
10,213,213,1,1,0,1,0
12,235,235,17,14,3,2,1
14,242,242,14,14,0,1,0
2,242,242,11,2,9,2,1
30,249,249,3,3,0,1,0
24,255,255,71,63,8,3,2
28,269,269,14,4,10,3,2
16,271,271,6,1,5,2,1
21,279,279,16,13,3,2,1
1,285,285,4,4,0,1,0
35,295,295,30,18,12,3,2
8,296,296,37,37,0,1,0
39,297,297,65,3,62,4,3
20,306,306,30,6,24,2,1
34,336,336,73,55,18,4,3
32,367,367,41,41,0,1,0
13,370,370,32,4,28,3,2
31,371,371,9,4,5,2,1
5,378,378,119,48,71,4,3
18,387,387,39,13,26,2,1
4,410,410,28,28,0,1,0
23,421,421,53,53,0,1,0
0,425,425,126,105,21,4,3
36,432,432,74,11,63,4,3
25,436,436,3,3,0,1,0
27,438,438,2,2,0,1,0
22,438,438,65,5,60,3,2
33,454,454,52,8,44,3,2
40,456,456,108,108,0,1,0
19,463,463,18,6,12,4,3
15,463,463,30,6,24,3,2
3,473,473,39,30,9,4,3
9,483,483,1,1,0,1,0

1,127,127,1,1,0,1,0
5,163,163,9,9,0,1,0
32,164,164,2,2,0,1,0
38,171,171,89,89,0,1,0
39,176,176,29,29,0,1,0
4,194,194,7,7,0,1,0
6,200,200,28,11,17,2,1
40,200,200,20,4,16,2,1
25,222,222,3,3,0,1,0
14,223,223,47,47,0,1,0
44,230,230,20,9,11,2,1
19,234,234,18,18,0,1,0
3,236,236,7,7,0,1,0
17,238,238,11,11,0,1,0
2,242,242,57,30,27,4,3
24,250,250,26,4,22,2,1
43,260,260,41,5,36,4,3
23,266,266,22,4,18,3,2
21,266,266,30,30,0,1,0
30,266,266,7,7,0,1,0
27,285,285,2,2,0,1,0
13,293,293,36,23,13,2,1
36,299,299,20,20,0,1,0
33,332,332,2,2,0,1,0
41,346,346,28,19,9,4,3
12,353,353,52,52,0,1,0
15,358,358,57,10,47,4,3
11,361,361,9,9,0,1,0
10,361,361,3,3,0,1,0
18,362,362,20,8,12,4,3
26,381,381,82,49,33,2,1
31,397,397,27,27,0,1,0
28,399,399,46,46,0,1,0
7,412,412,16,16,0,1,0
37,418,418,1,1,0,1,0
20,419,419,29,29,0,1,0
22,422,422,8,8,0,1,0
35,432,432,27,15,12,3,2
16,442,442,59,47,12,2,1
42,446,446,8,4,4,2,1
34,452,452,91,91,0,1,0
0,455,455,1,1,0,1,0
29,456,456,33,6,27,2,1
8,457,457,21,10,11,2,1
9,457,457,11,11,0,1,0
45,474,474,23,23,0,1,0

11,100,100,1,1,0,1,0
40,108,108,32,32,0,1,0
9,123,123,1,1,0,1,0
5,128,128,4,4,0,1,0
2,141,141,2,2,0,1,0
18,160,160,2,2,0,1,0
34,166,166,45,45,0,1,0
42,170,170,1,1,0,1,0
22,174,174,1,1,0,1,0
8,176,176,3,3,0,1,0
26,177,177,9,2,7,2,1
19,180,180,1,1,0,1,0
15,199,199,22,22,0,1,0
36,203,203,8,8,0,1,0
35,209,209,6,6,0,1,0
0,215,215,2,2,0,1,0
27,217,217,35,7,28,3,2
21,237,237,7,7,0,1,0
10,273,273,151,103,48,4,3
14,279,279,53,17,36,3,2
1,293,293,10,10,0,1,0
43,293,293,5,5,0,1,0
20,305,305,8,8,0,1,0
6,320,320,47,47,0,1,0
24,321,321,8,8,0,1,0
31,333,333,97,13,84,4,3
44,343,343,2,2,0,1,0
30,348,348,65,65,0,1,0
3,382,382,74,74,0,1,0
16,392,392,13,5,8,3,2
25,403,403,22,22,0,1,0
4,406,406,38,38,0,1,0
29,416,416,28,28,0,1,0
28,431,431,38,38,0,1,0
7,437,437,67,67,0,1,0
37,439,439,27,13,14,2,1
12,441,441,53,53,0,1,0
41,457,457,18,18,0,1,0
23,476,476,13,6,7,2,1
32,477,477,60,8,52,3,2
17,481,481,39,39,0,1,0
13,481,481,33,33,0,1,0
39,489,489,77,77,0,1,0
38,493,493,7,7,0,1,0
33,493,493,38,26,12,3,2

26,105,105,1,1,0,1,0
12,116,116,8,8,0,1,0
25,117,117,1,1,0,1,0
10,134,134,10,10,0,1,0
36,150,150,12,4,8,2,1
7,163,163,3,3,0,1,0
18,168,168,2,2,0,1,0
0,186,186,67,45,22,2,1
28,196,196,18,4,14,2,1
23,208,208,1,1,0,1,0
35,212,212,10,4,6,2,1
20,221,221,70,54,16,3,2
37,244,244,27,13,14,3,2
13,251,251,41,41,0,1,0
9,254,254,65,65,0,1,0
33,257,257,29,3,26,3,2
24,258,258,3,3,0,1,0
27,275,275,14,11,3,2,1
31,296,296,3,3,0,1,0
3,309,309,21,21,0,1,0
15,319,319,16,16,0,1,0
21,323,323,80,80,0,1,0
4,329,329,53,45,8,3,2
34,330,330,33,33,0,1,0
11,347,347,33,28,5,2,1
8,351,351,25,7,18,4,3
30,386,386,65,65,0,1,0
6,387,387,47,47,0,1,0
2,395,395,46,46,0,1,0
32,395,395,75,6,69,4,3
5,415,415,4,4,0,1,0
14,418,418,11,2,9,4,3
19,419,419,122,95,27,4,3
29,444,444,20,8,12,4,3
22,448,448,62,62,0,1,0
1,463,463,39,39,0,1,0
16,487,487,116,61,55,4,3
17,500,500,9,1,8,3,2

38,111,111,1,1,0,1,0
16,139,139,21,13,8,3,2
15,143,143,4,4,0,1,0
32,146,146,26,5,21,4,3
23,160,160,7,7,0,1,0
36,161,161,12,12,0,1,0
0,165,165,3,3,0,1,0
18,198,198,4,4,0,1,0
34,202,202,22,22,0,1,0
28,207,207,37,15,22,2,1
11,236,236,15,7,8,2,1
31,242,242,4,4,0,1,0
25,254,254,13,7,6,2,1
22,257,257,1,1,0,1,0
27,260,260,4,4,0,1,0
19,276,276,27,23,4,2,1
21,283,283,6,6,0,1,0
13,284,284,35,5,30,3,2
5,292,292,7,4,3,2,1
1,307,307,75,75,0,1,0
4,309,309,54,54,0,1,0
29,325,325,39,39,0,1,0
26,329,329,47,8,39,4,3
20,349,349,85,25,60,4,3
17,362,362,51,33,18,4,3
7,379,379,13,1,12,3,2
3,391,391,135,68,67,4,3
35,394,394,63,6,57,4,3
30,422,422,10,7,3,2,1
8,442,442,28,28,0,1,0
24,448,448,56,56,0,1,0
33,452,452,36,32,4,2,1
37,468,468,160,138,22,4,3
14,471,471,70,70,0,1,0
10,489,489,4,4,0,1,0
9,490,490,33,6,27,4,3
12,498,498,76,27,49,2,1
2,499,499,27,27,0,1,0
6,500,500,71,24,47,4,3

3,106,106,28,28,0,1,0
7,113,113,12,12,0,1,0
23,123,123,7,2,5,2,1
2,133,133,8,2,6,2,1
13,136,136,17,17,0,1,0
32,145,145,2,2,0,1,0
15,167,167,15,3,12,2,1
33,176,176,6,6,0,1,0
24,180,180,10,10,0,1,0
17,194,194,17,17,0,1,0
0,198,198,5,1,4,2,1
28,202,202,22,13,9,4,3
20,204,204,1,1,0,1,0
30,207,207,2,2,0,1,0
34,209,209,13,13,0,1,0
4,222,222,18,18,0,1,0
29,256,256,141,131,10,2,1
22,278,278,12,12,0,1,0
14,322,322,10,10,0,1,0
25,323,323,81,81,0,1,0
8,327,327,132,52,80,3,2
12,330,330,85,85,0,1,0
21,335,335,3,3,0,1,0
6,344,344,26,26,0,1,0
18,357,357,11,6,5,2,1
27,363,363,52,52,0,1,0
1,378,378,68,49,19,2,1
5,383,383,59,59,0,1,0
26,391,391,15,5,10,3,2
19,391,391,65,65,0,1,0
31,417,417,59,35,24,3,2
9,439,439,29,29,0,1,0
10,449,449,61,61,0,1,0
16,459,459,64,64,0,1,0
11,476,476,17,17,0,1,0

14,101,101,39,39,0,1,0
31,102,102,5,5,0,1,0
37,113,113,5,5,0,1,0
32,143,143,38,28,10,2,1
18,143,143,39,3,36,2,1
12,155,155,1,1,0,1,0
3,159,159,6,6,0,1,0
33,162,162,12,12,0,1,0
11,164,164,33,23,10,2,1
28,177,177,12,6,6,3,2
36,203,203,5,5,0,1,0
1,204,204,83,83,0,1,0
5,219,219,5,5,0,1,0
7,224,224,60,16,44,3,2
21,225,225,2,2,0,1,0
19,242,242,15,3,12,3,2
6,257,257,13,5,8,3,2
25,264,264,23,1,22,3,2
20,281,281,5,5,0,1,0
16,310,310,10,7,3,2,1
29,323,323,126,94,32,2,1
24,325,325,17,12,5,2,1
9,328,328,12,12,0,1,0
13,328,328,73,39,34,3,2
22,330,330,35,1,34,2,1
26,331,331,5,5,0,1,0
10,351,351,16,2,14,2,1
0,360,360,1,1,0,1,0
34,364,364,29,29,0,1,0
4,367,367,20,20,0,1,0
30,386,386,50,50,0,1,0
35,408,408,11,5,6,2,1
23,424,424,8,8,0,1,0
15,429,429,46,46,0,1,0
27,438,438,112,54,58,3,2
8,441,441,5,5,0,1,0
2,459,459,15,9,6,2,1
17,484,484,37,9,28,2,1

24,138,138,21,21,0,1,0
6,139,139,15,1,14,3,2
22,143,143,9,9,0,1,0
9,154,154,12,2,10,2,1
25,160,160,5,5,0,1,0
19,162,162,13,13,0,1,0
29,168,168,26,4,22,2,1
34,184,184,4,4,0,1,0
3,201,201,54,4,50,3,2
4,204,204,15,6,9,4,3
30,215,215,2,2,0,1,0
8,219,219,12,12,0,1,0
27,257,257,24,15,9,4,3
21,266,266,88,88,0,1,0
28,274,274,66,37,29,4,3
14,277,277,106,106,0,1,0
1,277,277,2,2,0,1,0
12,280,280,6,6,0,1,0
33,283,283,16,2,14,3,2
32,289,289,51,51,0,1,0
17,311,311,34,34,0,1,0
35,317,317,8,8,0,1,0
26,326,326,49,49,0,1,0
36,333,333,5,1,4,2,1
5,337,337,5,2,3,2,1
16,401,401,1,1,0,1,0
20,404,404,89,75,14,3,2
38,407,407,8,3,5,2,1
0,417,417,32,2,30,3,2
7,435,435,1,1,0,1,0
2,439,439,32,14,18,2,1
23,448,448,52,52,0,1,0
37,461,461,9,3,6,2,1
13,472,472,23,23,0,1,0
15,475,475,4,1,3,2,1
10,480,480,26,26,0,1,0
11,488,488,203,127,76,4,3
18,489,489,98,98,0,1,0
31,490,490,29,29,0,1,0

26,109,109,18,4,14,2,1
22,126,126,8,8,0,1,0
39,128,128,27,27,0,1,0
31,131,131,7,1,6,3,2
36,131,131,9,2,7,2,1
2,173,173,29,19,10,2,1
19,179,179,6,2,4,2,1
16,188,188,5,5,0,1,0
37,188,188,2,2,0,1,0
21,193,193,7,7,0,1,0
27,195,195,22,22,0,1,0
40,207,207,4,1,3,2,1
18,227,227,24,15,9,2,1
33,234,234,38,38,0,1,0
10,262,262,10,10,0,1,0
5,267,267,55,55,0,1,0
30,274,274,23,13,10,3,2
24,283,283,16,16,0,1,0
11,307,307,10,10,0,1,0
7,307,307,10,7,3,2,1
23,316,316,14,14,0,1,0
20,336,336,24,2,22,2,1
3,336,336,45,15,30,4,3
1,363,363,16,2,14,3,2
35,367,367,46,46,0,1,0
4,375,375,9,9,0,1,0
14,384,384,6,6,0,1,0
34,385,385,86,86,0,1,0
13,401,401,121,121,0,1,0
12,402,402,20,11,9,4,3
38,406,406,47,47,0,1,0
41,409,409,8,8,0,1,0
17,416,416,16,1,15,2,1
25,417,417,46,16,30,3,2
28,435,435,136,53,83,4,3
15,456,456,137,137,0,1,0
32,465,465,23,16,7,2,1
0,477,477,19,19,0,1,0
8,486,486,68,42,26,4,3
9,487,487,58,58,0,1,0
6,490,490,23,23,0,1,0
29,500,500,24,24,0,1,0

40,103,103,5,5,0,1,0
30,109,109,15,3,12,2,1
35,157,157,2,2,0,1,0
32,157,157,15,15,0,1,0
13,170,170,5,5,0,1,0
14,176,176,5,5,0,1,0
33,191,191,1,1,0,1,0
15,197,197,24,3,21,4,3
1,202,202,12,8,4,2,1
11,243,243,10,7,3,2,1
29,249,249,4,4,0,1,0
38,274,274,69,37,32,2,1
16,278,278,1,1,0,1,0
12,286,286,21,21,0,1,0
34,304,304,6,6,0,1,0
8,305,305,8,8,0,1,0
20,309,309,14,14,0,1,0
7,313,313,6,6,0,1,0
27,315,315,66,66,0,1,0
4,316,316,5,5,0,1,0
21,331,331,37,25,12,4,3
41,335,335,23,1,22,4,3
9,343,343,89,89,0,1,0
19,349,349,12,12,0,1,0
26,367,367,102,102,0,1,0
0,368,368,11,11,0,1,0
31,371,371,33,33,0,1,0
37,378,378,19,19,0,1,0
24,385,385,63,21,42,4,3
3,401,401,48,48,0,1,0
43,409,409,1,1,0,1,0
18,412,412,54,54,0,1,0
36,414,414,19,12,7,2,1
42,433,433,114,44,70,3,2
22,436,436,39,39,0,1,0
17,452,452,1,1,0,1,0
39,456,456,26,10,16,2,1
5,467,467,155,123,32,3,2
23,481,481,22,22,0,1,0
28,482,482,44,44,0,1,0
10,483,483,57,57,0,1,0
2,493,493,17,5,12,2,1
6,495,495,113,83,30,3,2
25,497,497,69,29,40,2,1

15,103,103,10,1,9,2,1
25,111,111,22,22,0,1,0
5,117,117,15,12,3,2,1
19,121,121,27,27,0,1,0
29,132,132,34,34,0,1,0
34,139,139,15,15,0,1,0
33,143,143,2,2,0,1,0
8,162,162,3,3,0,1,0
7,162,162,32,8,24,4,3
28,174,174,31,4,27,2,1
37,177,177,9,9,0,1,0
35,197,197,5,5,0,1,0
14,219,219,24,2,22,2,1
2,225,225,10,10,0,1,0
21,230,230,7,3,4,2,1
13,238,238,1,1,0,1,0
18,240,240,3,3,0,1,0
36,259,259,58,58,0,1,0
17,270,270,34,34,0,1,0
24,275,275,23,23,0,1,0
3,304,304,1,1,0,1,0
22,305,305,20,12,8,2,1
0,319,319,16,4,12,3,2
39,322,322,19,19,0,1,0
23,330,330,30,30,0,1,0
10,347,347,24,24,0,1,0
16,372,372,48,48,0,1,0
6,374,374,15,15,0,1,0
4,383,383,8,8,0,1,0
40,414,414,14,14,0,1,0
12,418,418,61,45,16,2,1
20,419,419,32,9,23,2,1
32,420,420,33,24,9,4,3
11,435,435,32,19,13,2,1
30,462,462,72,22,50,3,2
9,463,463,191,183,8,2,1
26,484,484,37,37,0,1,0
27,487,487,6,3,3,2,1
31,488,488,102,6,96,4,3
1,489,489,9,3,6,3,2
38,490,490,41,41,0,1,0

25,104,104,4,4,0,1,0
3,136,136,21,8,13,2,1
27,157,157,18,18,0,1,0
23,159,159,28,6,22,2,1
24,183,183,12,12,0,1,0
16,184,184,16,16,0,1,0
37,197,197,15,15,0,1,0
12,203,203,8,8,0,1,0
29,207,207,6,6,0,1,0
2,208,208,5,5,0,1,0
9,230,230,42,28,14,4,3
5,235,235,3,3,0,1,0
1,240,240,12,12,0,1,0
30,240,240,2,2,0,1,0
11,265,265,14,2,12,3,2
18,276,276,1,1,0,1,0
14,280,280,27,6,21,2,1
38,283,283,49,49,0,1,0
19,286,286,21,21,0,1,0
21,286,286,23,15,8,3,2
43,297,297,55,55,0,1,0
40,307,307,11,11,0,1,0
44,310,310,30,1,29,2,1
0,321,321,9,6,3,2,1
42,323,323,43,43,0,1,0
22,355,355,3,3,0,1,0
34,369,369,15,15,0,1,0
36,394,394,32,10,22,2,1
13,400,400,78,78,0,1,0
26,401,401,63,63,0,1,0
32,405,405,78,34,44,3,2
15,424,424,2,2,0,1,0
8,425,425,101,101,0,1,0
33,446,446,97,76,21,2,1
39,447,447,14,14,0,1,0
35,453,453,96,42,54,4,3
6,455,455,33,33,0,1,0
17,456,456,10,2,8,2,1
10,460,460,75,1,74,4,3
7,461,461,1,1,0,1,0
28,473,473,38,26,12,4,3
20,476,476,81,81,0,1,0
31,488,488,24,13,11,2,1
41,492,492,41,11,30,2,1
4,498,498,1,1,0,1,0

40,119,119,7,7,0,1,0
30,119,119,5,5,0,1,0
28,121,121,1,1,0,1,0
15,137,137,94,94,0,1,0
18,141,141,23,23,0,1,0
2,146,146,1,1,0,1,0
22,157,157,1,1,0,1,0
7,160,160,4,4,0,1,0
1,167,167,21,10,11,2,1
21,171,171,6,6,0,1,0
10,180,180,6,1,5,2,1
20,223,223,9,4,5,2,1
24,224,224,10,10,0,1,0
41,227,227,2,2,0,1,0
39,239,239,38,13,25,2,1
36,245,245,29,29,0,1,0
26,251,251,12,3,9,4,3
14,261,261,4,4,0,1,0
42,273,273,13,13,0,1,0
16,276,276,7,7,0,1,0
17,295,295,8,2,6,2,1
4,302,302,1,1,0,1,0
25,325,325,84,76,8,3,2
3,358,358,108,30,78,3,2
11,370,370,15,5,10,3,2
37,383,383,110,74,36,3,2
0,384,384,11,3,8,2,1
5,386,386,5,5,0,1,0
33,389,389,119,101,18,4,3
29,403,403,82,50,32,3,2
19,407,407,72,42,30,4,3
23,410,410,21,7,14,2,1
35,417,417,39,39,0,1,0
32,421,421,23,23,0,1,0
9,423,423,17,1,16,3,2
13,425,425,11,4,7,2,1
27,435,435,25,25,0,1,0
6,469,469,32,32,0,1,0
38,479,479,76,76,0,1,0
12,483,483,3,3,0,1,0
8,486,486,52,52,0,1,0
34,487,487,5,5,0,1,0
31,495,495,9,1,8,3,2

37,104,104,2,2,0,1,0
10,106,106,3,3,0,1,0
13,132,132,7,7,0,1,0
36,135,135,3,3,0,1,0
21,148,148,6,2,4,2,1
2,168,168,7,7,0,1,0
3,178,178,26,26,0,1,0
18,187,187,1,1,0,1,0
14,192,192,22,22,0,1,0
39,225,225,15,15,0,1,0
0,270,270,1,1,0,1,0
19,277,277,1,1,0,1,0
15,282,282,1,1,0,1,0
5,282,282,117,53,64,4,3
29,285,285,49,49,0,1,0
32,291,291,37,9,28,3,2
6,302,302,5,2,3,2,1
23,314,314,41,5,36,4,3
33,318,318,10,10,0,1,0
34,323,323,1,1,0,1,0
31,344,344,18,3,15,2,1
35,375,375,23,23,0,1,0
38,381,381,30,30,0,1,0
22,384,384,29,29,0,1,0
25,389,389,24,14,10,2,1
17,393,393,105,33,72,3,2
30,399,399,94,94,0,1,0
9,400,400,11,11,0,1,0
11,406,406,26,8,18,2,1
1,408,408,189,189,0,1,0
24,415,415,6,6,0,1,0
28,417,417,148,148,0,1,0
16,424,424,2,2,0,1,0
40,444,444,156,156,0,1,0
12,452,452,28,28,0,1,0
26,456,456,41,41,0,1,0
4,463,463,15,15,0,1,0
20,473,473,9,9,0,1,0
8,478,478,95,11,84,3,2
27,485,485,22,22,0,1,0
7,490,490,15,15,0,1,0

12,105,105,26,19,7,2,1
30,141,141,7,7,0,1,0
19,143,143,26,11,15,2,1
41,145,145,14,3,11,2,1
16,148,148,26,26,0,1,0
36,149,149,14,6,8,3,2
35,155,155,7,7,0,1,0
45,170,170,2,2,0,1,0
26,188,188,39,10,29,2,1
22,211,211,6,6,0,1,0
27,222,222,15,1,14,2,1
37,247,247,21,10,11,2,1
21,266,266,4,4,0,1,0
7,274,274,4,4,0,1,0
25,284,284,14,4,10,2,1
28,288,288,19,4,15,2,1
32,300,300,30,30,0,1,0
18,302,302,30,4,26,2,1
6,307,307,2,2,0,1,0
31,328,328,1,1,0,1,0
10,346,346,16,2,14,3,2
2,355,355,1,1,0,1,0
9,359,359,7,7,0,1,0
46,360,360,5,5,0,1,0
34,372,372,39,1,38,3,2
29,387,387,60,60,0,1,0
42,397,397,77,77,0,1,0
33,399,399,12,12,0,1,0
4,404,404,34,30,4,2,1
0,411,411,3,3,0,1,0
3,411,411,16,4,12,3,2
39,413,413,96,50,46,2,1
44,425,425,134,106,28,2,1
24,425,425,35,4,31,4,3
11,427,427,37,3,34,2,1
1,443,443,2,2,0,1,0
8,443,443,37,15,22,2,1
5,454,454,20,16,4,2,1
13,454,454,10,10,0,1,0
17,455,455,83,33,50,3,2
15,458,458,31,31,0,1,0
14,464,464,4,4,0,1,0
43,469,469,38,38,0,1,0
40,473,473,110,74,36,3,2
23,475,475,41,41,0,1,0
47,486,486,25,25,0,1,0
38,488,488,36,36,0,1,0
20,496,496,20,20,0,1,0

20,113,113,4,4,0,1,0
26,116,116,5,5,0,1,0
18,118,118,19,19,0,1,0
12,134,134,31,25,6,2,1
35,137,137,10,10,0,1,0
16,148,148,2,2,0,1,0
28,151,151,18,10,8,3,2
6,151,151,29,13,16,2,1
13,162,162,1,1,0,1,0
8,176,176,13,13,0,1,0
29,177,177,48,10,38,2,1
22,234,234,12,9,3,2,1
36,241,241,28,20,8,2,1
30,247,247,26,26,0,1,0
32,251,251,26,26,0,1,0
14,256,256,21,14,7,2,1
25,265,265,71,61,10,3,2
4,292,292,7,4,3,2,1
1,316,316,20,12,8,2,1
19,324,324,3,3,0,1,0
27,329,329,68,35,33,3,2
15,329,329,10,10,0,1,0
38,339,339,10,10,0,1,0
34,362,362,29,29,0,1,0
23,365,365,14,2,12,3,2
2,380,380,176,112,64,3,2
33,389,389,33,23,10,2,1
21,406,406,34,34,0,1,0
39,412,412,62,38,24,2,1
7,414,414,10,10,0,1,0
17,421,421,10,10,0,1,0
9,425,425,40,40,0,1,0
0,452,452,15,15,0,1,0
10,452,452,27,19,8,3,2
31,457,457,30,30,0,1,0
3,468,468,13,4,9,2,1
24,469,469,47,47,0,1,0
11,482,482,154,154,0,1,0
5,486,486,33,33,0,1,0
37,493,493,9,1,8,3,2

5,103,103,3,3,0,1,0
8,112,112,15,15,0,1,0
18,136,136,2,2,0,1,0
1,151,151,37,10,27,4,3
21,186,186,7,7,0,1,0
0,186,186,6,6,0,1,0
15,193,193,1,1,0,1,0
17,209,209,1,1,0,1,0
6,223,223,11,8,3,2,1
3,248,248,76,61,15,2,1
19,248,248,19,15,4,2,1
26,262,262,29,29,0,1,0
27,268,268,5,5,0,1,0
31,285,285,15,15,0,1,0
25,309,309,45,45,0,1,0
7,309,309,31,31,0,1,0
23,351,351,27,27,0,1,0
29,359,359,53,23,30,3,2
12,369,369,4,4,0,1,0
10,369,369,54,15,39,4,3
24,376,376,77,3,74,3,2
28,382,382,43,43,0,1,0
35,396,396,35,12,23,2,1
14,407,407,4,4,0,1,0
22,416,416,29,25,4,2,1
13,423,423,251,241,10,2,1
9,435,435,11,2,9,2,1
4,449,449,45,45,0,1,0
30,449,449,9,9,0,1,0
32,455,455,107,107,0,1,0
16,466,466,134,11,123,4,3
2,466,466,8,2,6,3,2
33,471,471,101,101,0,1,0
11,478,478,94,94,0,1,0
34,479,479,41,41,0,1,0
20,489,489,17,11,6,3,2

35,104,104,11,11,0,1,0
5,111,111,12,2,10,2,1
6,117,117,16,11,5,2,1
22,158,158,25,25,0,1,0
19,158,158,6,1,5,2,1
15,173,173,14,14,0,1,0
8,179,179,21,21,0,1,0
18,184,184,1,1,0,1,0
12,198,198,21,21,0,1,0
10,207,207,19,13,6,2,1
17,212,212,15,15,0,1,0
37,218,218,6,6,0,1,0
16,226,226,21,7,14,3,2
1,236,236,2,2,0,1,0
24,238,238,58,1,57,3,2
25,256,256,22,12,10,2,1
4,260,260,38,23,15,4,3
39,269,269,56,56,0,1,0
7,270,270,1,1,0,1,0
31,281,281,49,49,0,1,0
27,321,321,3,3,0,1,0
23,323,323,12,4,8,3,2
14,333,333,79,79,0,1,0
3,343,343,32,12,20,3,2
32,365,365,39,19,20,4,3
11,366,366,24,24,0,1,0
21,377,377,38,2,36,4,3
20,391,391,4,4,0,1,0
36,391,391,96,96,0,1,0
26,409,409,28,20,8,3,2
33,418,418,85,25,60,4,3
29,427,427,29,29,0,1,0
38,429,429,9,9,0,1,0
0,433,433,21,12,9,4,3
28,447,447,34,34,0,1,0
2,454,454,48,29,19,2,1
9,464,464,53,53,0,1,0
30,473,473,35,22,13,2,1
13,477,477,157,121,36,2,1
34,493,493,5,5,0,1,0

7,110,110,10,10,0,1,0
25,136,136,37,16,21,2,1
28,141,141,10,5,5,2,1
9,144,144,14,14,0,1,0
21,145,145,10,2,8,3,2
31,148,148,31,31,0,1,0
14,158,158,24,4,20,2,1
19,162,162,23,3,20,3,2
40,168,168,10,10,0,1,0
39,173,173,4,4,0,1,0
10,181,181,15,5,10,3,2
20,182,182,9,9,0,1,0
18,213,213,1,1,0,1,0
38,237,237,11,11,0,1,0
5,245,245,33,33,0,1,0
15,263,263,1,1,0,1,0
23,276,276,36,27,9,2,1
27,281,281,37,37,0,1,0
0,302,302,7,4,3,2,1
13,304,304,41,41,0,1,0
22,333,333,5,5,0,1,0
36,354,354,90,90,0,1,0
35,354,354,6,6,0,1,0
30,358,358,11,1,10,2,1
12,363,363,14,14,0,1,0
32,370,370,34,2,32,2,1
34,382,382,79,38,41,2,1
6,382,382,2,2,0,1,0
29,393,393,8,8,0,1,0
33,394,394,81,81,0,1,0
2,399,399,41,41,0,1,0
8,406,406,38,38,0,1,0
11,413,413,162,104,58,3,2
24,439,439,13,1,12,4,3
4,462,462,10,10,0,1,0
26,469,469,31,9,22,3,2
1,472,472,46,15,31,2,1
41,474,474,7,1,6,2,1
3,482,482,19,1,18,2,1
16,487,487,9,9,0,1,0
37,491,491,74,74,0,1,0
17,496,496,104,35,69,4,3

21,102,102,1,1,0,1,0
39,120,120,4,4,0,1,0
10,133,133,10,7,3,2,1
34,136,136,4,4,0,1,0
24,143,143,6,6,0,1,0
23,145,145,10,10,0,1,0
27,147,147,16,7,9,4,3
0,151,151,14,14,0,1,0
12,152,152,1,1,0,1,0
17,158,158,8,5,3,2,1
2,160,160,55,55,0,1,0
3,169,169,1,1,0,1,0
6,173,173,7,1,6,2,1
9,186,186,9,1,8,2,1
18,189,189,3,3,0,1,0
29,190,190,45,13,32,3,2
5,244,244,73,73,0,1,0
31,251,251,30,12,18,2,1
37,260,260,1,1,0,1,0
14,294,294,9,2,7,2,1
19,311,311,27,18,9,2,1
16,315,315,23,23,0,1,0
11,328,328,13,1,12,2,1
20,339,339,28,28,0,1,0
8,345,345,24,18,6,2,1
1,350,350,23,5,18,2,1
38,359,359,14,14,0,1,0
41,361,361,37,28,9,4,3
33,378,378,137,137,0,1,0
28,387,387,4,4,0,1,0
26,389,389,49,49,0,1,0
36,392,392,77,13,64,3,2
22,400,400,14,14,0,1,0
35,412,412,3,3,0,1,0
32,423,423,5,2,3,2,1
7,430,430,136,70,66,4,3
15,435,435,15,15,0,1,0
40,475,475,161,139,22,2,1
30,489,489,53,53,0,1,0
13,489,489,99,92,7,2,1
25,493,493,32,14,18,4,3
4,500,500,6,6,0,1,0

16,108,108,32,32,0,1,0
5,109,109,1,1,0,1,0
12,121,121,3,3,0,1,0
19,132,132,10,10,0,1,0
9,155,155,1,1,0,1,0
0,161,161,14,14,0,1,0
37,163,163,25,25,0,1,0
27,171,171,1,1,0,1,0
6,172,172,12,12,0,1,0
35,174,174,19,3,16,3,2
33,183,183,1,1,0,1,0
30,191,191,3,3,0,1,0
47,204,204,39,19,20,3,2
46,229,229,15,15,0,1,0
40,240,240,25,14,11,2,1
15,246,246,1,1,0,1,0
34,251,251,11,11,0,1,0
48,253,253,2,2,0,1,0
29,258,258,55,10,45,4,3
25,263,263,2,2,0,1,0
44,279,279,16,10,6,2,1
32,283,283,20,2,18,2,1
28,290,290,21,21,0,1,0
41,300,300,26,2,24,2,1
1,329,329,27,5,22,3,2
24,339,339,4,4,0,1,0
20,340,340,3,3,0,1,0
43,350,350,80,80,0,1,0
26,353,353,1,1,0,1,0
11,364,364,12,12,0,1,0
3,372,372,4,4,0,1,0
23,395,395,151,151,0,1,0
4,400,400,21,21,0,1,0
17,403,403,9,6,3,2,1
18,403,403,18,14,4,2,1
22,408,408,11,11,0,1,0
42,413,413,117,117,0,1,0
10,416,416,76,7,69,4,3
45,429,429,20,20,0,1,0
38,430,430,100,8,92,3,2
39,436,436,24,12,12,2,1
21,447,447,67,40,27,4,3
36,449,449,25,25,0,1,0
2,469,469,25,25,0,1,0
7,481,481,62,62,0,1,0
14,492,492,70,31,39,4,3
8,492,492,2,2,0,1,0
31,494,494,5,2,3,2,1
13,499,499,1,1,0,1,0

36,107,107,1,1,0,1,0
16,107,107,4,4,0,1,0
23,125,125,3,3,0,1,0
37,129,129,6,1,5,2,1
12,142,142,2,2,0,1,0
28,143,143,38,38,0,1,0
2,149,149,44,44,0,1,0
31,164,164,19,19,0,1,0
26,181,181,15,5,10,2,1
9,185,185,52,52,0,1,0
5,187,187,26,4,22,3,2
6,187,187,5,5,0,1,0
0,199,199,17,17,0,1,0
17,217,217,24,24,0,1,0
29,221,221,76,76,0,1,0
14,243,243,30,30,0,1,0
10,246,246,7,4,3,2,1
15,264,264,56,48,8,3,2
24,277,277,97,22,75,4,3
11,297,297,1,1,0,1,0
21,317,317,24,4,20,3,2
30,337,337,20,20,0,1,0
33,348,348,20,20,0,1,0
4,350,350,22,13,9,4,3
35,359,359,21,21,0,1,0
3,372,372,105,22,83,4,3
19,382,382,2,2,0,1,0
20,390,390,10,10,0,1,0
25,393,393,18,6,12,3,2
34,395,395,51,18,33,2,1
1,395,395,11,11,0,1,0
32,410,410,12,2,10,3,2
18,413,413,67,40,27,4,3
13,429,429,15,5,10,3,2
7,437,437,65,1,64,3,2
8,440,440,38,30,8,3,2
22,456,456,31,28,3,2,1
27,468,468,45,45,0,1,0

32,105,105,3,3,0,1,0
19,110,110,37,37,0,1,0
8,125,125,22,2,20,3,2
24,126,126,6,6,0,1,0
10,137,137,34,2,32,2,1
0,166,166,36,36,0,1,0
31,184,184,6,6,0,1,0
33,187,187,6,6,0,1,0
4,194,194,25,25,0,1,0
30,224,224,8,8,0,1,0
1,253,253,14,14,0,1,0
12,263,263,3,3,0,1,0
6,285,285,84,73,11,2,1
9,288,288,2,2,0,1,0
17,298,298,28,28,0,1,0
16,307,307,5,5,0,1,0
26,342,342,11,11,0,1,0
15,352,352,45,15,30,2,1
22,382,382,46,6,40,4,3
5,405,405,16,16,0,1,0
28,422,422,41,36,5,2,1
29,440,440,28,10,18,4,3
18,454,454,20,14,6,3,2
13,471,471,10,10,0,1,0
20,471,471,1,1,0,1,0
14,473,473,147,147,0,1,0
2,474,474,164,164,0,1,0
21,477,477,174,57,117,4,3
27,480,480,40,40,0,1,0
11,480,480,53,19,34,3,2
3,485,485,11,11,0,1,0
25,486,486,80,43,37,2,1
7,497,497,161,86,75,4,3
23,499,499,2,2,0,1,0

2,102,102,1,1,0,1,0
5,119,119,22,22,0,1,0
16,151,151,14,14,0,1,0
27,152,152,25,9,16,2,1
20,159,159,26,26,0,1,0
8,172,172,24,5,19,2,1
6,178,178,70,53,17,2,1
29,191,191,26,19,7,2,1
37,196,196,20,6,14,3,2
21,234,234,6,6,0,1,0
9,243,243,5,5,0,1,0
26,256,256,92,92,0,1,0
19,256,256,24,24,0,1,0
28,257,257,3,3,0,1,0
7,275,275,22,22,0,1,0
11,275,275,16,9,7,2,1
13,279,279,7,2,5,2,1
15,284,284,62,62,0,1,0
4,287,287,2,2,0,1,0
1,290,290,25,25,0,1,0
33,315,315,30,30,0,1,0
22,317,317,84,84,0,1,0
0,321,321,17,4,13,2,1
12,333,333,15,15,0,1,0
32,336,336,9,1,8,2,1
23,352,352,28,14,14,3,2
18,373,373,75,24,51,4,3
14,387,387,8,8,0,1,0
31,394,394,14,14,0,1,0
34,395,395,1,1,0,1,0
17,400,400,9,9,0,1,0
24,402,402,10,1,9,4,3
35,426,426,1,1,0,1,0
3,439,439,90,90,0,1,0
10,462,462,157,148,9,4,3
30,464,464,19,19,0,1,0
25,465,465,35,22,13,2,1
36,466,466,64,33,31,2,1

1,123,123,16,4,12,4,3
10,126,126,18,6,12,3,2
25,132,132,4,4,0,1,0
40,140,140,3,3,0,1,0
22,144,144,12,7,5,2,1
36,154,154,45,45,0,1,0
11,172,172,14,2,12,3,2
29,174,174,8,8,0,1,0
9,176,176,2,2,0,1,0
0,180,180,8,8,0,1,0
14,196,196,11,5,6,2,1
19,198,198,6,3,3,2,1
16,204,204,5,5,0,1,0
15,205,205,20,6,14,3,2
17,214,214,1,1,0,1,0
3,245,245,14,14,0,1,0
2,252,252,89,6,83,4,3
7,253,253,2,2,0,1,0
34,300,300,14,14,0,1,0
30,300,300,23,4,19,2,1
20,306,306,40,13,27,4,3
35,320,320,150,39,111,4,3
4,330,330,71,71,0,1,0
28,335,335,2,2,0,1,0
8,349,349,19,19,0,1,0
27,351,351,7,7,0,1,0
32,410,410,13,3,10,2,1
18,417,417,22,15,7,2,1
21,418,418,17,17,0,1,0
24,420,420,40,40,0,1,0
37,421,421,5,5,0,1,0
39,425,425,45,45,0,1,0
13,438,438,39,39,0,1,0
12,441,441,14,6,8,2,1
23,451,451,11,11,0,1,0
33,459,459,5,2,3,2,1
31,464,464,163,136,27,4,3
6,465,465,20,20,0,1,0
5,466,466,160,84,76,3,2
26,467,467,70,70,0,1,0
38,492,492,60,50,10,3,2

25,121,121,2,2,0,1,0
12,137,137,7,2,5,2,1
27,147,147,2,2,0,1,0
6,178,178,5,2,3,2,1
15,189,189,10,10,0,1,0
22,193,193,14,14,0,1,0
32,211,211,4,1,3,2,1
26,220,220,12,12,0,1,0
39,221,221,5,5,0,1,0
16,226,226,27,27,0,1,0
18,235,235,64,64,0,1,0
17,236,236,1,1,0,1,0
35,237,237,12,3,9,2,1
11,238,238,1,1,0,1,0
10,240,240,1,1,0,1,0
7,240,240,60,30,30,2,1
0,241,241,18,9,9,2,1
8,250,250,1,1,0,1,0
37,256,256,5,5,0,1,0
36,264,264,6,6,0,1,0
23,268,268,9,9,0,1,0
14,276,276,9,4,5,2,1
31,279,279,197,104,93,4,3
24,284,284,6,6,0,1,0
34,300,300,17,17,0,1,0
5,304,304,26,2,24,4,3
33,311,311,117,81,36,4,3
4,333,333,93,93,0,1,0
43,345,345,3,3,0,1,0
21,359,359,100,86,14,2,1
42,371,371,29,8,21,2,1
30,420,420,98,53,45,4,3
1,428,428,11,11,0,1,0
9,431,431,5,5,0,1,0
13,436,436,14,8,6,2,1
3,442,442,3,3,0,1,0
40,443,443,35,3,32,2,1
28,445,445,8,8,0,1,0
41,452,452,5,5,0,1,0
29,456,456,16,16,0,1,0
44,468,468,77,57,20,3,2
38,472,472,24,24,0,1,0
2,474,474,19,19,0,1,0
19,484,484,35,35,0,1,0
20,489,489,70,4,66,4,3

4,105,105,1,1,0,1,0
36,111,111,23,23,0,1,0
29,113,113,4,1,3,2,1
34,149,149,24,24,0,1,0
6,171,171,10,5,5,2,1
23,185,185,3,3,0,1,0
21,197,197,2,2,0,1,0
38,199,199,20,15,5,2,1
19,208,208,21,21,0,1,0
22,269,269,35,35,0,1,0
11,276,276,29,29,0,1,0
7,283,283,1,1,0,1,0
17,283,283,6,2,4,2,1
24,285,285,12,2,10,2,1
12,298,298,13,4,9,2,1
1,313,313,36,2,34,2,1
15,320,320,38,30,8,3,2
39,322,322,29,17,12,4,3
33,334,334,7,7,0,1,0
26,343,343,48,48,0,1,0
10,344,344,32,1,31,2,1
3,347,347,36,12,24,3,2
27,361,361,29,13,16,2,1
5,365,365,85,22,63,4,3
14,367,367,15,3,12,2,1
32,370,370,86,41,45,4,3
20,391,391,37,37,0,1,0
28,393,393,158,44,114,4,3
8,401,401,8,8,0,1,0
25,423,423,15,15,0,1,0
30,432,432,3,3,0,1,0
31,442,442,85,70,15,4,3
18,455,455,87,87,0,1,0
9,463,463,32,32,0,1,0
13,470,470,138,119,19,2,1
37,472,472,14,14,0,1,0
35,478,478,2,2,0,1,0
16,478,478,33,33,0,1,0
0,481,481,100,59,41,2,1
2,489,489,51,37,14,2,1

28,104,104,26,10,16,2,1
20,118,118,13,13,0,1,0
22,130,130,18,18,0,1,0
30,143,143,4,4,0,1,0
0,170,170,1,1,0,1,0
18,172,172,3,3,0,1,0
27,177,177,19,7,12,4,3
35,181,181,13,13,0,1,0
6,194,194,41,41,0,1,0
24,196,196,4,4,0,1,0
7,207,207,36,36,0,1,0
10,236,236,7,1,6,3,2
40,252,252,29,11,18,4,3
23,255,255,22,22,0,1,0
17,257,257,75,75,0,1,0
4,265,265,22,22,0,1,0
32,278,278,9,9,0,1,0
16,279,279,1,1,0,1,0
21,280,280,67,9,58,3,2
8,286,286,48,43,5,2,1
13,293,293,52,52,0,1,0
29,298,298,17,1,16,2,1
1,300,300,31,31,0,1,0
26,315,315,15,5,10,3,2
3,320,320,22,2,20,2,1
15,320,320,12,12,0,1,0
11,345,345,19,19,0,1,0
33,347,347,13,9,4,2,1
39,373,373,26,26,0,1,0
41,373,373,11,11,0,1,0
19,375,375,10,6,4,2,1
12,382,382,20,6,14,2,1
36,383,383,63,19,44,3,2
38,391,391,41,41,0,1,0
9,412,412,6,6,0,1,0
31,414,414,36,16,20,3,2
5,421,421,22,22,0,1,0
34,425,425,88,28,60,3,2
25,427,427,111,111,0,1,0
14,451,451,1,1,0,1,0
37,459,459,59,16,43,2,1
2,487,487,37,37,0,1,0

28,106,106,2,2,0,1,0
20,127,127,10,1,9,4,3
16,151,151,1,1,0,1,0
14,156,156,8,2,6,3,2
30,174,174,33,33,0,1,0
13,179,179,26,4,22,2,1
11,179,179,16,8,8,3,2
18,190,190,17,17,0,1,0
21,194,194,3,3,0,1,0
9,213,213,47,38,9,4,3
0,215,215,50,4,46,3,2
7,228,228,16,6,10,3,2
37,248,248,36,36,0,1,0
1,249,249,2,2,0,1,0
29,255,255,67,67,0,1,0
3,256,256,53,38,15,2,1
15,275,275,15,15,0,1,0
36,275,275,3,3,0,1,0
41,277,277,2,2,0,1,0
26,278,278,159,114,45,4,3
33,321,321,5,5,0,1,0
12,327,327,14,8,6,2,1
31,327,327,16,16,0,1,0
22,372,372,27,27,0,1,0
32,372,372,81,81,0,1,0
8,385,385,52,5,47,2,1
19,388,388,49,11,38,4,3
4,390,390,35,35,0,1,0
38,393,393,43,1,42,4,3
5,394,394,52,52,0,1,0
17,396,396,63,45,18,3,2
10,403,403,1,1,0,1,0
39,422,422,32,32,0,1,0
6,424,424,14,5,9,2,1
23,431,431,15,15,0,1,0
2,435,435,6,6,0,1,0
35,444,444,14,14,0,1,0
24,460,460,8,3,5,2,1
40,466,466,12,6,6,3,2
25,483,483,22,2,20,2,1
34,492,492,1,1,0,1,0
27,499,499,62,62,0,1,0

26,132,132,4,4,0,1,0
21,156,156,25,25,0,1,0
13,166,166,22,6,16,3,2
3,172,172,3,3,0,1,0
5,172,172,4,4,0,1,0
38,175,175,13,9,4,2,1
41,178,178,25,16,9,4,3
7,200,200,3,3,0,1,0
16,208,208,15,7,8,3,2
27,214,214,2,2,0,1,0
33,250,250,21,1,20,3,2
35,257,257,16,16,0,1,0
42,264,264,12,3,9,4,3
40,277,277,21,18,3,2,1
17,287,287,67,1,66,3,2
11,291,291,3,3,0,1,0
32,300,300,11,11,0,1,0
2,302,302,3,3,0,1,0
25,309,309,21,21,0,1,0
20,316,316,8,8,0,1,0
8,320,320,8,8,0,1,0
29,322,322,51,51,0,1,0
14,322,322,26,5,21,2,1
34,326,326,26,12,14,2,1
9,337,337,18,1,17,2,1
10,338,338,113,5,108,4,3
28,348,348,37,15,22,3,2
18,357,357,14,14,0,1,0
1,368,368,109,7,102,4,3
30,369,369,14,3,11,2,1
6,377,377,38,38,0,1,0
39,403,403,60,60,0,1,0
0,404,404,27,27,0,1,0
23,434,434,121,7,114,4,3
37,434,434,39,4,35,3,2
31,441,441,84,40,44,3,2
22,449,449,37,37,0,1,0
4,449,449,9,2,7,2,1
24,458,458,127,76,51,4,3
12,460,460,48,28,20,2,1
36,476,476,19,8,11,2,1
19,483,483,23,6,17,2,1
15,500,500,25,25,0,1,0

33,103,103,52,23,29,2,1
35,109,109,7,7,0,1,0
21,109,109,20,2,18,3,2
3,112,112,1,1,0,1,0
12,113,113,1,1,0,1,0
36,114,114,10,4,6,3,2
11,118,118,8,8,0,1,0
9,123,123,17,2,15,2,1
23,124,124,2,2,0,1,0
30,127,127,6,2,4,2,1
29,144,144,10,10,0,1,0
20,146,146,35,24,11,2,1
24,151,151,6,6,0,1,0
34,179,179,25,25,0,1,0
4,189,189,1,1,0,1,0
8,190,190,39,13,26,2,1
22,221,221,1,1,0,1,0
15,228,228,33,3,30,2,1
32,228,228,4,1,3,2,1
26,270,270,11,11,0,1,0
27,280,280,16,4,12,3,2
17,298,298,12,12,0,1,0
18,305,305,16,16,0,1,0
1,329,329,38,8,30,3,2
25,333,333,99,99,0,1,0
14,365,365,4,1,3,2,1
2,404,404,33,5,28,2,1
19,416,416,13,13,0,1,0
10,423,423,46,46,0,1,0
6,427,427,21,21,0,1,0
13,439,439,11,11,0,1,0
5,439,439,71,59,12,3,2
28,451,451,39,24,15,4,3
0,452,452,171,140,31,2,1
7,490,490,36,15,21,4,3
16,490,490,204,165,39,4,3
31,495,495,18,18,0,1,0

37,108,108,19,19,0,1,0
15,118,118,2,2,0,1,0
0,155,155,26,16,10,2,1
25,164,164,28,5,23,2,1
10,168,168,4,4,0,1,0
8,170,170,25,4,21,2,1
24,174,174,27,20,7,2,1
20,178,178,8,8,0,1,0
32,187,187,3,3,0,1,0
6,188,188,15,15,0,1,0
23,210,210,5,1,4,2,1
2,217,217,68,68,0,1,0
16,218,218,19,19,0,1,0
31,222,222,27,1,26,3,2
4,246,246,18,18,0,1,0
9,254,254,105,17,88,4,3
30,280,280,1,1,0,1,0
1,312,312,25,25,0,1,0
18,314,314,5,5,0,1,0
19,326,326,10,4,6,2,1
33,328,328,15,15,0,1,0
35,332,332,41,4,37,2,1
21,336,336,10,10,0,1,0
39,339,339,13,13,0,1,0
28,340,340,5,5,0,1,0
22,345,345,48,48,0,1,0
14,375,375,76,22,54,4,3
36,377,377,4,1,3,2,1
11,386,386,23,14,9,4,3
7,394,394,9,1,8,2,1
5,398,398,4,1,3,2,1
12,403,403,3,3,0,1,0
29,416,416,138,102,36,4,3
17,423,423,1,1,0,1,0
27,454,454,131,131,0,1,0
3,455,455,97,97,0,1,0
26,467,467,32,32,0,1,0
38,478,478,28,14,14,2,1
13,480,480,17,17,0,1,0
34,487,487,82,16,66,4,3

9,102,102,16,16,0,1,0
18,107,107,9,9,0,1,0
12,120,120,1,1,0,1,0
1,122,122,33,33,0,1,0
8,131,131,7,7,0,1,0
41,141,141,18,18,0,1,0
13,147,147,6,6,0,1,0
20,159,159,23,23,0,1,0
32,161,161,14,1,13,3,2
10,189,189,7,7,0,1,0
34,192,192,37,37,0,1,0
38,196,196,1,1,0,1,0
25,215,215,14,14,0,1,0
7,233,233,11,7,4,2,1
37,247,247,47,20,27,4,3
22,253,253,1,1,0,1,0
33,264,264,22,1,21,4,3
3,266,266,11,11,0,1,0
6,266,266,57,57,0,1,0
21,274,274,6,2,4,2,1
31,274,274,27,4,23,3,2
29,282,282,16,16,0,1,0
42,285,285,5,5,0,1,0
16,300,300,30,30,0,1,0
35,328,328,35,17,18,4,3
23,332,332,2,2,0,1,0
15,362,362,13,13,0,1,0
30,374,374,40,1,39,3,2
11,375,375,89,9,80,3,2
24,395,395,57,57,0,1,0
2,406,406,30,30,0,1,0
0,410,410,2,2,0,1,0
5,420,420,39,39,0,1,0
26,431,431,69,20,49,3,2
28,435,435,135,67,68,4,3
14,439,439,22,22,0,1,0
4,443,443,41,5,36,2,1
36,444,444,8,8,0,1,0
19,445,445,62,62,0,1,0
17,478,478,25,25,0,1,0
40,479,479,87,18,69,4,3
27,482,482,12,12,0,1,0
39,490,490,31,10,21,4,3

12,107,107,39,25,14,2,1
37,118,118,12,12,0,1,0
35,126,126,4,4,0,1,0
15,132,132,43,29,14,2,1
33,136,136,15,1,14,2,1
2,137,137,1,1,0,1,0
39,143,143,33,33,0,1,0
16,148,148,8,8,0,1,0
1,162,162,5,5,0,1,0
24,169,169,4,4,0,1,0
13,190,190,2,2,0,1,0
17,196,196,1,1,0,1,0
21,206,206,18,18,0,1,0
20,209,209,7,7,0,1,0
38,223,223,44,27,17,2,1
14,235,235,30,30,0,1,0
25,244,244,14,8,6,2,1
32,255,255,9,9,0,1,0
0,277,277,1,1,0,1,0
29,278,278,26,26,0,1,0
19,294,294,34,8,26,2,1
3,297,297,31,16,15,3,2
23,313,313,11,11,0,1,0
8,318,318,36,36,0,1,0
31,330,330,56,56,0,1,0
11,345,345,64,19,45,2,1
34,366,366,12,2,10,2,1
18,385,385,53,37,16,2,1
28,405,405,81,18,63,4,3
30,421,421,50,14,36,4,3
27,422,422,29,1,28,3,2
22,423,423,76,72,4,2,1
36,426,426,21,21,0,1,0
7,427,427,106,106,0,1,0
26,433,433,85,85,0,1,0
4,455,455,7,7,0,1,0
9,459,459,11,6,5,2,1
6,460,460,31,31,0,1,0
10,466,466,15,15,0,1,0
5,476,476,13,13,0,1,0

4,100,100,1,1,0,1,0
35,110,110,2,2,0,1,0
11,112,112,4,4,0,1,0
24,128,128,15,15,0,1,0
5,161,161,6,6,0,1,0
6,178,178,3,3,0,1,0
33,191,191,18,3,15,4,3
1,195,195,15,15,0,1,0
19,197,197,51,27,24,4,3
27,207,207,1,1,0,1,0
36,213,213,30,30,0,1,0
32,247,247,47,22,25,2,1
29,251,251,27,3,24,2,1
12,256,256,45,3,42,3,2
37,281,281,5,5,0,1,0
3,287,287,108,51,57,4,3
10,298,298,2,2,0,1,0
23,298,298,13,1,12,3,2
34,303,303,1,1,0,1,0
17,321,321,8,8,0,1,0
14,333,333,5,1,4,2,1
38,348,348,34,19,15,2,1
22,363,363,126,91,35,4,3
9,364,364,94,94,0,1,0
28,369,369,113,70,43,2,1
13,381,381,45,3,42,3,2
16,393,393,11,2,9,4,3
21,394,394,22,22,0,1,0
30,404,404,6,3,3,2,1
15,405,405,32,10,22,2,1
20,412,412,23,23,0,1,0
0,426,426,128,92,36,4,3
2,432,432,12,7,5,2,1
8,433,433,46,38,8,3,2
7,448,448,40,3,37,3,2
18,451,451,99,19,80,4,3
26,459,459,28,22,6,2,1
25,475,475,20,20,0,1,0
31,494,494,31,31,0,1,0

37,118,118,30,10,20,3,2
30,131,131,24,24,0,1,0
23,141,141,10,2,8,3,2
10,147,147,19,19,0,1,0
41,153,153,2,2,0,1,0
21,154,154,4,4,0,1,0
35,155,155,7,7,0,1,0
16,162,162,17,11,6,3,2
4,181,181,2,2,0,1,0
38,189,189,59,28,31,2,1
24,190,190,23,23,0,1,0
8,211,211,2,2,0,1,0
39,213,213,31,11,20,3,2
29,216,216,4,1,3,2,1
31,222,222,34,34,0,1,0
13,225,225,25,7,18,3,2
6,226,226,6,1,5,2,1
0,227,227,1,1,0,1,0
17,235,235,5,5,0,1,0
1,258,258,61,23,38,3,2
33,262,262,29,29,0,1,0
2,271,271,39,39,0,1,0
22,273,273,18,4,14,3,2
36,273,273,11,1,10,3,2
27,310,310,14,4,10,2,1
34,319,319,24,8,16,3,2
5,353,353,28,6,22,2,1
42,379,379,6,6,0,1,0
32,381,381,48,27,21,4,3
28,391,391,69,36,33,4,3
3,399,399,102,90,12,4,3
9,404,404,41,41,0,1,0
11,418,418,6,6,0,1,0
25,429,429,3,3,0,1,0
14,438,438,40,40,0,1,0
18,442,442,36,36,0,1,0
40,444,444,41,15,26,2,1
15,446,446,100,10,90,4,3
7,451,451,7,4,3,2,1
20,459,459,10,10,0,1,0
26,467,467,20,20,0,1,0
12,470,470,12,12,0,1,0
19,499,499,100,72,28,4,3

16,102,102,4,4,0,1,0
35,108,108,21,21,0,1,0
12,145,145,58,58,0,1,0
22,148,148,25,25,0,1,0
23,151,151,12,5,7,2,1
38,153,153,10,10,0,1,0
42,161,161,16,16,0,1,0
25,173,173,11,5,6,2,1
4,187,187,14,4,10,3,2
6,229,229,25,25,0,1,0
5,233,233,6,6,0,1,0
7,244,244,35,2,33,4,3
24,258,258,16,16,0,1,0
17,277,277,10,10,0,1,0
10,290,290,1,1,0,1,0
34,299,299,1,1,0,1,0
14,302,302,32,32,0,1,0
1,304,304,76,68,8,2,1
21,308,308,1,1,0,1,0
9,309,309,4,1,3,2,1
36,310,310,36,36,0,1,0
32,321,321,3,3,0,1,0
29,330,330,38,17,21,2,1
39,332,332,57,19,38,3,2
15,346,346,29,29,0,1,0
19,356,356,2,2,0,1,0
2,371,371,90,45,45,4,3
3,381,381,26,12,14,2,1
41,397,397,56,33,23,2,1
30,413,413,21,21,0,1,0
27,420,420,68,68,0,1,0
26,422,422,83,44,39,4,3
11,430,430,4,4,0,1,0
8,438,438,19,7,12,3,2
18,438,438,9,3,6,3,2
37,443,443,97,3,94,3,2
40,449,449,11,1,10,4,3
33,472,472,9,9,0,1,0
13,474,474,51,41,10,3,2
28,480,480,90,90,0,1,0
20,486,486,16,1,15,4,3
0,488,488,9,6,3,2,1
31,495,495,28,7,21,2,1

43,102,102,24,6,18,4,3
7,115,115,3,3,0,1,0
24,115,115,10,10,0,1,0
4,120,120,8,8,0,1,0
13,126,126,1,1,0,1,0
41,146,146,1,1,0,1,0
19,149,149,1,1,0,1,0
3,152,152,6,6,0,1,0
16,156,156,12,1,11,2,1
22,191,191,5,2,3,2,1
30,198,198,29,29,0,1,0
42,205,205,24,24,0,1,0
31,206,206,18,3,15,4,3
40,214,214,4,4,0,1,0
26,217,217,12,2,10,2,1
21,229,229,24,24,0,1,0
35,231,231,22,22,0,1,0
18,242,242,2,2,0,1,0
29,246,246,16,7,9,2,1
34,249,249,30,30,0,1,0
9,253,253,44,44,0,1,0
0,260,260,40,14,26,2,1
2,260,260,29,29,0,1,0
25,281,281,4,4,0,1,0
27,308,308,1,1,0,1,0
33,316,316,69,45,24,2,1
5,320,320,52,52,0,1,0
12,327,327,10,1,9,2,1
36,334,334,3,3,0,1,0
20,335,335,11,1,10,2,1
8,336,336,9,3,6,3,2
15,342,342,113,113,0,1,0
37,381,381,33,33,0,1,0
23,398,398,35,35,0,1,0
10,416,416,75,75,0,1,0
14,426,426,3,3,0,1,0
6,429,429,29,2,27,2,1
32,436,436,239,167,72,3,2
39,447,447,14,14,0,1,0
38,454,454,12,12,0,1,0
17,460,460,55,38,17,3,2
28,491,491,36,36,0,1,0
1,493,493,59,21,38,2,1
11,497,497,17,8,9,4,3

17,116,116,19,19,0,1,0
6,119,119,8,8,0,1,0
35,131,131,14,14,0,1,0
3,133,133,9,4,5,2,1
18,141,141,14,4,10,2,1
28,145,145,22,22,0,1,0
21,152,152,11,11,0,1,0
41,154,154,3,3,0,1,0
40,157,157,17,17,0,1,0
15,159,159,1,1,0,1,0
11,190,190,10,6,4,2,1
24,195,195,6,1,5,2,1
16,201,201,78,13,65,4,3
39,207,207,14,2,12,2,1
42,221,221,11,2,9,4,3
7,224,224,6,6,0,1,0
29,225,225,81,45,36,4,3
34,245,245,30,9,21,4,3
32,257,257,1,1,0,1,0
0,275,275,22,9,13,2,1
1,293,293,33,33,0,1,0
27,318,318,24,24,0,1,0
13,335,335,28,28,0,1,0
31,345,345,30,3,27,2,1
33,346,346,2,2,0,1,0
38,355,355,23,15,8,2,1
22,355,355,33,33,0,1,0
9,361,361,53,3,50,3,2
5,368,368,15,7,8,3,2
37,377,377,68,25,43,2,1
20,385,385,23,16,7,2,1
8,393,393,60,60,0,1,0
26,393,393,19,3,16,3,2
14,409,409,30,30,0,1,0
4,411,411,19,6,13,2,1
2,413,413,17,17,0,1,0
25,429,429,28,28,0,1,0
19,438,438,28,4,24,2,1
12,450,450,13,9,4,2,1
10,451,451,16,4,12,4,3
36,454,454,17,8,9,4,3
30,466,466,91,40,51,4,3
23,479,479,126,87,39,4,3

27,107,107,19,19,0,1,0
12,121,121,15,15,0,1,0
11,126,126,4,4,0,1,0
19,127,127,6,6,0,1,0
6,130,130,4,4,0,1,0
21,130,130,10,6,4,2,1
17,162,162,13,5,8,2,1
15,162,162,14,6,8,2,1
18,165,165,1,1,0,1,0
25,169,169,17,17,0,1,0
4,179,179,5,5,0,1,0
13,189,189,4,1,3,2,1
10,197,197,26,26,0,1,0
34,206,206,4,4,0,1,0
23,212,212,20,20,0,1,0
30,213,213,15,15,0,1,0
22,235,235,19,19,0,1,0
8,244,244,18,18,0,1,0
32,246,246,13,1,12,3,2
1,275,275,92,10,82,4,3
24,289,289,4,4,0,1,0
2,307,307,17,17,0,1,0
7,317,317,79,73,6,3,2
9,319,319,96,63,33,4,3
31,342,342,44,44,0,1,0
14,387,387,116,18,98,3,2
29,397,397,67,67,0,1,0
0,414,414,17,17,0,1,0
26,425,425,106,16,90,4,3
16,435,435,184,164,20,2,1
3,439,439,19,4,15,2,1
28,446,446,18,6,12,4,3
5,476,476,112,37,75,3,2
20,497,497,19,9,10,3,2
33,497,497,44,44,0,1,0

38,101,101,4,4,0,1,0
21,106,106,1,1,0,1,0
19,119,119,27,27,0,1,0
18,140,140,4,4,0,1,0
14,160,160,13,13,0,1,0
28,161,161,13,13,0,1,0
5,161,161,10,3,7,2,1
1,161,161,11,11,0,1,0
24,168,168,22,22,0,1,0
15,170,170,7,2,5,2,1
0,179,179,16,6,10,3,2
23,183,183,4,4,0,1,0
37,184,184,16,16,0,1,0
9,194,194,7,7,0,1,0
6,204,204,6,1,5,2,1
35,207,207,6,1,5,2,1
27,219,219,29,4,25,3,2
22,225,225,49,41,8,2,1
25,272,272,1,1,0,1,0
29,275,275,48,48,0,1,0
31,325,325,55,55,0,1,0
3,349,349,32,22,10,3,2
12,353,353,11,6,5,2,1
10,382,382,65,65,0,1,0
11,397,397,30,30,0,1,0
39,398,398,49,7,42,2,1
17,398,398,32,9,23,2,1
32,407,407,65,65,0,1,0
30,423,423,48,12,36,4,3
2,423,423,57,24,33,2,1
8,429,429,63,21,42,4,3
33,432,432,42,3,39,2,1
34,432,432,46,46,0,1,0
7,440,440,70,70,0,1,0
4,446,446,82,82,0,1,0
20,452,452,104,92,12,4,3
36,462,462,17,17,0,1,0
26,473,473,37,3,34,3,2
16,474,474,26,18,8,3,2
13,482,482,101,101,0,1,0

32,104,104,4,4,0,1,0
30,112,112,1,1,0,1,0
17,126,126,1,1,0,1,0
1,133,133,7,7,0,1,0
25,137,137,29,17,12,2,1
39,139,139,20,20,0,1,0
23,144,144,6,6,0,1,0
34,151,151,17,17,0,1,0
4,170,170,29,29,0,1,0
24,176,176,26,8,18,2,1
7,191,191,15,7,8,2,1
15,195,195,22,16,6,2,1
11,218,218,20,12,8,2,1
42,222,222,14,6,8,3,2
8,235,235,21,1,20,3,2
6,251,251,23,23,0,1,0
10,268,268,10,2,8,3,2
41,272,272,72,9,63,4,3
19,286,286,26,5,21,2,1
16,286,286,1,1,0,1,0
29,290,290,3,3,0,1,0
20,291,291,30,4,26,2,1
31,292,292,5,5,0,1,0
40,295,295,106,98,8,3,2
22,299,299,15,15,0,1,0
12,302,302,86,44,42,3,2
35,308,308,66,66,0,1,0
28,315,315,11,2,9,2,1
14,322,322,17,3,14,3,2
5,337,337,78,78,0,1,0
26,345,345,7,3,4,2,1
27,387,387,29,12,17,2,1
38,395,395,31,31,0,1,0
0,407,407,30,30,0,1,0
2,413,413,33,19,14,2,1
37,414,414,10,10,0,1,0
18,429,429,5,5,0,1,0
3,439,439,31,4,27,2,1
33,442,442,28,14,14,3,2
9,456,456,70,55,15,4,3
13,478,478,26,10,16,2,1
21,483,483,4,4,0,1,0
36,483,483,54,15,39,4,3

19,103,103,4,1,3,2,1
3,104,104,4,4,0,1,0
5,112,112,13,13,0,1,0
21,120,120,1,1,0,1,0
26,127,127,4,4,0,1,0
38,131,131,11,11,0,1,0
18,168,168,41,14,27,4,3
12,171,171,11,5,6,3,2
34,200,200,3,3,0,1,0
31,205,205,45,21,24,3,2
0,215,215,83,34,49,4,3
6,221,221,5,5,0,1,0
35,239,239,11,11,0,1,0
28,245,245,59,59,0,1,0
16,259,259,29,1,28,3,2
27,260,260,33,4,29,2,1
23,265,265,27,27,0,1,0
15,273,273,10,1,9,2,1
39,274,274,12,1,11,2,1
8,297,297,36,36,0,1,0
25,299,299,15,10,5,2,1
14,303,303,30,30,0,1,0
2,320,320,9,3,6,2,1
37,331,331,42,42,0,1,0
40,341,341,28,28,0,1,0
30,357,357,10,10,0,1,0
41,358,358,43,9,34,2,1
33,365,365,64,43,21,2,1
1,387,387,17,17,0,1,0
29,389,389,21,4,17,2,1
32,392,392,39,18,21,2,1
4,394,394,85,7,78,4,3
13,402,402,80,29,51,4,3
17,404,404,2,2,0,1,0
20,437,437,16,16,0,1,0
24,461,461,20,11,9,2,1
10,468,468,8,8,0,1,0
11,470,470,32,32,0,1,0
22,474,474,153,117,36,4,3
7,486,486,27,27,0,1,0
36,489,489,8,8,0,1,0
9,492,492,23,23,0,1,0

18,102,102,8,8,0,1,0
37,117,117,3,3,0,1,0
17,123,123,9,1,8,2,1
13,125,125,5,5,0,1,0
20,130,130,22,22,0,1,0
44,141,141,4,4,0,1,0
4,148,148,23,23,0,1,0
40,152,152,34,34,0,1,0
10,153,153,6,6,0,1,0
39,159,159,5,1,4,2,1
23,177,177,1,1,0,1,0
15,181,181,5,5,0,1,0
36,182,182,11,11,0,1,0
19,193,193,36,27,9,4,3
6,194,194,14,14,0,1,0
45,211,211,17,17,0,1,0
27,214,214,49,49,0,1,0
32,217,217,1,1,0,1,0
38,227,227,19,19,0,1,0
31,238,238,52,52,0,1,0
29,238,238,36,26,10,2,1
3,269,269,70,55,15,4,3
34,279,279,16,16,0,1,0
22,300,300,8,8,0,1,0
5,309,309,7,7,0,1,0
8,315,315,35,12,23,2,1
25,332,332,3,3,0,1,0
9,346,346,25,25,0,1,0
0,360,360,16,16,0,1,0
7,379,379,47,47,0,1,0
1,383,383,24,24,0,1,0
11,399,399,24,10,14,2,1
43,406,406,14,3,11,2,1
28,408,408,17,7,10,2,1
42,416,416,27,27,0,1,0
12,418,418,60,51,9,4,3
26,432,432,57,57,0,1,0
21,435,435,21,1,20,3,2
16,441,441,18,18,0,1,0
30,443,443,47,24,23,2,1
35,453,453,132,41,91,3,2
33,454,454,20,1,19,4,3
2,454,454,15,6,9,2,1
24,465,465,42,1,41,3,2
14,477,477,3,3,0,1,0
41,480,480,60,44,16,3,2

5,103,103,5,5,0,1,0
21,104,104,30,5,25,2,1
38,119,119,2,2,0,1,0
36,127,127,15,15,0,1,0
35,137,137,22,22,0,1,0
10,150,150,37,6,31,4,3
19,157,157,8,1,7,2,1
37,172,172,18,18,0,1,0
9,194,194,16,16,0,1,0
22,214,214,62,24,38,2,1
14,229,229,14,14,0,1,0
15,242,242,16,6,10,3,2
40,243,243,10,10,0,1,0
34,244,244,13,1,12,3,2
18,250,250,76,76,0,1,0
20,270,270,40,8,32,2,1
24,273,273,27,27,0,1,0
4,288,288,33,33,0,1,0
32,313,313,14,14,0,1,0
8,327,327,2,2,0,1,0
7,329,329,43,43,0,1,0
6,333,333,31,31,0,1,0
31,338,338,2,2,0,1,0
12,339,339,19,19,0,1,0
28,340,340,58,58,0,1,0
33,368,368,42,42,0,1,0
29,391,391,1,1,0,1,0
0,400,400,24,24,0,1,0
27,402,402,15,3,12,4,3
39,411,411,114,48,66,4,3
1,414,414,30,30,0,1,0
2,420,420,77,41,36,4,3
25,424,424,77,77,0,1,0
30,429,429,3,3,0,1,0
11,436,436,48,48,0,1,0
13,446,446,53,53,0,1,0
26,457,457,14,14,0,1,0
17,461,461,1,1,0,1,0
23,469,469,1,1,0,1,0
3,470,470,2,2,0,1,0
16,478,478,21,9,12,2,1

17,104,104,21,21,0,1,0
36,113,113,13,13,0,1,0
22,122,122,4,4,0,1,0
15,126,126,9,9,0,1,0
18,167,167,3,3,0,1,0
10,170,170,25,25,0,1,0
23,176,176,31,31,0,1,0
16,178,178,23,23,0,1,0
13,179,179,6,6,0,1,0
30,181,181,6,6,0,1,0
12,199,199,44,44,0,1,0
20,223,223,10,6,4,2,1
35,231,231,8,4,4,2,1
4,238,238,22,22,0,1,0
28,240,240,18,18,0,1,0
29,267,267,27,27,0,1,0
14,302,302,23,23,0,1,0
38,305,305,10,10,0,1,0
34,317,317,42,42,0,1,0
31,324,324,1,1,0,1,0
25,330,330,11,11,0,1,0
32,331,331,136,136,0,1,0
2,332,332,19,19,0,1,0
5,341,341,1,1,0,1,0
33,346,346,30,30,0,1,0
6,353,353,25,25,0,1,0
26,355,355,81,81,0,1,0
9,358,358,32,32,0,1,0
3,366,366,108,46,62,4,3
37,369,369,45,13,32,3,2
8,378,378,15,9,6,3,2
19,403,403,4,1,3,2,1
11,415,415,48,40,8,3,2
7,419,419,74,74,0,1,0
24,423,423,2,2,0,1,0
21,433,433,28,19,9,4,3
27,441,441,130,108,22,2,1
1,448,448,31,31,0,1,0
0,472,472,46,46,0,1,0

43,101,101,2,2,0,1,0
39,116,116,15,15,0,1,0
4,122,122,15,1,14,3,2
38,132,132,13,13,0,1,0
25,133,133,4,4,0,1,0
2,142,142,1,1,0,1,0
16,143,143,1,1,0,1,0
33,155,155,32,32,0,1,0
23,161,161,29,23,6,3,2
9,179,179,16,16,0,1,0
37,190,190,26,10,16,3,2
22,191,191,3,3,0,1,0
35,195,195,31,1,30,4,3
28,212,212,62,62,0,1,0
7,217,217,7,3,4,2,1
27,224,224,48,25,23,2,1
11,226,226,11,11,0,1,0
3,231,231,12,2,10,2,1
12,233,233,41,3,38,2,1
15,234,234,33,33,0,1,0
40,265,265,3,3,0,1,0
31,322,322,13,13,0,1,0
24,326,326,44,18,26,3,2
36,347,347,14,14,0,1,0
8,358,358,34,7,27,4,3
29,366,366,8,1,7,2,1
41,369,369,29,12,17,2,1
26,372,372,18,8,10,3,2
13,399,399,6,2,4,2,1
14,420,420,2,2,0,1,0
17,425,425,26,13,13,2,1
34,426,426,10,1,9,4,3
30,428,428,80,23,57,4,3
21,430,430,2,2,0,1,0
18,436,436,24,2,22,3,2
5,445,445,139,139,0,1,0
19,452,452,31,31,0,1,0
0,455,455,66,66,0,1,0
32,462,462,68,68,0,1,0
42,464,464,8,8,0,1,0
1,465,465,52,45,7,2,1
10,468,468,96,68,28,3,2
6,493,493,7,1,6,3,2
20,494,494,19,9,10,3,2

27,111,111,13,10,3,2,1
20,113,113,14,5,9,2,1
5,117,117,10,10,0,1,0
32,120,120,16,3,13,2,1
16,123,123,7,7,0,1,0
25,123,123,5,5,0,1,0
14,128,128,1,1,0,1,0
22,129,129,13,13,0,1,0
11,140,140,8,1,7,2,1
10,143,143,11,11,0,1,0
6,145,145,19,11,8,2,1
15,157,157,5,5,0,1,0
21,162,162,30,8,22,3,2
26,171,171,1,1,0,1,0
30,187,187,18,18,0,1,0
33,198,198,8,8,0,1,0
8,206,206,27,27,0,1,0
4,207,207,4,4,0,1,0
19,268,268,4,4,0,1,0
24,276,276,11,2,9,2,1
12,276,276,12,3,9,2,1
28,279,279,9,9,0,1,0
23,287,287,14,14,0,1,0
9,293,293,15,15,0,1,0
18,308,308,46,34,12,3,2
13,320,320,149,125,24,4,3
34,358,358,119,119,0,1,0
31,359,359,31,27,4,2,1
36,360,360,51,43,8,3,2
0,365,365,24,24,0,1,0
35,371,371,2,2,0,1,0
3,387,387,45,4,41,4,3
29,407,407,81,81,0,1,0
2,426,426,27,27,0,1,0
1,437,437,41,41,0,1,0
17,464,464,73,1,72,4,3
7,471,471,237,168,69,4,3

35,102,102,17,4,13,2,1
23,102,102,8,8,0,1,0
7,111,111,2,2,0,1,0
5,122,122,7,7,0,1,0
20,124,124,28,28,0,1,0
44,141,141,40,40,0,1,0
24,149,149,13,13,0,1,0
4,153,153,57,57,0,1,0
3,155,155,2,2,0,1,0
31,159,159,1,1,0,1,0
27,161,161,26,3,23,2,1
22,167,167,5,5,0,1,0
13,169,169,2,2,0,1,0
39,171,171,3,3,0,1,0
40,175,175,60,24,36,3,2
36,186,186,28,28,0,1,0
11,193,193,34,16,18,2,1
1,195,195,3,3,0,1,0
2,199,199,1,1,0,1,0
38,203,203,2,2,0,1,0
32,212,212,2,2,0,1,0
18,214,214,25,12,13,2,1
28,235,235,36,28,8,3,2
19,262,262,3,3,0,1,0
30,270,270,8,8,0,1,0
25,299,299,12,9,3,2,1
17,333,333,7,7,0,1,0
41,335,335,5,5,0,1,0
34,339,339,34,34,0,1,0
6,346,346,5,5,0,1,0
8,368,368,93,37,56,3,2
12,375,375,56,56,0,1,0
33,405,405,10,10,0,1,0
26,409,409,27,27,0,1,0
16,412,412,76,33,43,2,1
0,415,415,2,2,0,1,0
37,420,420,19,7,12,4,3
29,429,429,141,123,18,3,2
9,431,431,37,37,0,1,0
14,436,436,6,6,0,1,0
10,443,443,23,10,13,3,2
42,449,449,20,4,16,3,2
21,456,456,1,1,0,1,0
15,482,482,1,1,0,1,0
43,498,498,26,26,0,1,0

27,103,103,7,7,0,1,0
24,107,107,9,9,0,1,0
0,108,108,5,5,0,1,0
34,115,115,17,17,0,1,0
11,122,122,11,5,6,3,2
32,122,122,48,9,39,4,3
2,129,129,14,14,0,1,0
29,143,143,3,3,0,1,0
18,145,145,5,5,0,1,0
9,151,151,22,22,0,1,0
1,161,161,12,12,0,1,0
20,174,174,15,15,0,1,0
14,189,189,10,10,0,1,0
28,190,190,15,15,0,1,0
22,206,206,6,6,0,1,0
10,220,220,7,7,0,1,0
6,246,246,54,54,0,1,0
33,250,250,2,2,0,1,0
37,260,260,64,16,48,4,3
12,266,266,20,20,0,1,0
16,291,291,12,12,0,1,0
5,302,302,81,23,58,3,2
36,305,305,7,2,5,2,1
35,341,341,2,2,0,1,0
7,354,354,7,7,0,1,0
26,363,363,47,47,0,1,0
19,366,366,112,65,47,2,1
8,374,374,62,14,48,4,3
15,375,375,1,1,0,1,0
13,429,429,49,1,48,2,1
23,439,439,7,7,0,1,0
39,439,439,89,85,4,2,1
21,443,443,10,10,0,1,0
38,446,446,137,137,0,1,0
31,453,453,13,13,0,1,0
25,470,470,22,22,0,1,0
17,481,481,54,5,49,2,1
3,490,490,33,33,0,1,0
4,493,493,12,12,0,1,0
30,499,499,55,55,0,1,0

28,102,102,8,8,0,1,0
43,103,103,16,4,12,3,2
19,117,117,2,2,0,1,0
24,117,117,1,1,0,1,0
6,125,125,1,1,0,1,0
30,125,125,33,3,30,2,1
47,128,128,12,12,0,1,0
18,130,130,2,2,0,1,0
15,143,143,9,3,6,2,1
37,162,162,25,25,0,1,0
23,165,165,66,66,0,1,0
0,175,175,12,3,9,3,2
32,214,214,25,16,9,4,3
39,215,215,1,1,0,1,0
34,224,224,11,11,0,1,0
10,230,230,55,55,0,1,0
45,256,256,21,21,0,1,0
38,260,260,44,44,0,1,0
8,265,265,5,5,0,1,0
17,277,277,1,1,0,1,0
44,280,280,15,9,6,3,2
46,286,286,87,73,14,3,2
16,289,289,1,1,0,1,0
14,292,292,43,19,24,3,2
29,293,293,35,8,27,4,3
41,301,301,4,4,0,1,0
31,318,318,17,17,0,1,0
26,330,330,65,35,30,3,2
21,359,359,1,1,0,1,0
3,381,381,47,19,28,3,2
4,391,391,35,35,0,1,0
11,393,393,15,15,0,1,0
36,398,398,59,59,0,1,0
40,409,409,44,44,0,1,0
12,410,410,16,8,8,2,1
35,411,411,15,15,0,1,0
2,436,436,4,4,0,1,0
20,455,455,36,4,32,2,1
22,458,458,65,20,45,2,1
7,465,465,18,18,0,1,0
27,467,467,18,6,12,3,2
42,472,472,9,2,7,2,1
9,472,472,22,1,21,4,3
25,473,473,14,14,0,1,0
1,479,479,10,10,0,1,0
33,489,489,13,13,0,1,0
5,490,490,16,16,0,1,0
13,500,500,41,41,0,1,0

5,102,102,5,5,0,1,0
35,119,119,1,1,0,1,0
16,128,128,24,24,0,1,0
14,143,143,6,2,4,2,1
0,196,196,10,10,0,1,0
21,198,198,12,12,0,1,0
31,200,200,11,2,9,4,3
3,201,201,24,24,0,1,0
25,202,202,6,6,0,1,0
36,205,205,15,15,0,1,0
13,206,206,15,11,4,2,1
32,219,219,2,2,0,1,0
19,220,220,47,47,0,1,0
33,224,224,4,4,0,1,0
8,226,226,43,5,38,3,2
12,229,229,45,15,30,3,2
10,230,230,6,6,0,1,0
20,262,262,25,25,0,1,0
15,263,263,14,14,0,1,0
29,281,281,80,80,0,1,0
30,287,287,61,61,0,1,0
1,292,292,20,20,0,1,0
38,324,324,2,2,0,1,0
7,341,341,12,12,0,1,0
18,347,347,40,19,21,4,3
34,361,361,107,107,0,1,0
37,362,362,129,129,0,1,0
6,364,364,137,137,0,1,0
4,368,368,5,5,0,1,0
22,374,374,31,23,8,3,2
27,387,387,13,10,3,2,1
17,393,393,109,109,0,1,0
26,401,401,3,3,0,1,0
24,409,409,5,5,0,1,0
23,440,440,76,50,26,3,2
2,456,456,3,3,0,1,0
9,456,456,50,50,0,1,0
28,498,498,4,4,0,1,0
11,498,498,6,6,0,1,0

2,135,135,18,8,10,3,2
17,151,151,8,8,0,1,0
30,157,157,6,6,0,1,0
3,159,159,25,25,0,1,0
15,167,167,46,46,0,1,0
0,185,185,12,12,0,1,0
8,199,199,2,2,0,1,0
18,209,209,4,4,0,1,0
21,217,217,1,1,0,1,0
23,223,223,3,3,0,1,0
32,249,249,63,53,10,2,1
19,259,259,1,1,0,1,0
10,265,265,2,2,0,1,0
11,288,288,36,36,0,1,0
35,296,296,62,62,0,1,0
14,302,302,59,59,0,1,0
36,308,308,54,18,36,4,3
13,327,327,8,8,0,1,0
12,331,331,62,14,48,2,1
26,335,335,11,11,0,1,0
27,369,369,22,22,0,1,0
34,377,377,82,82,0,1,0
20,396,396,7,7,0,1,0
7,408,408,13,4,9,4,3
31,413,413,28,28,0,1,0
25,419,419,27,27,0,1,0
9,426,426,6,2,4,2,1
28,427,427,7,1,6,2,1
1,448,448,42,26,16,3,2
16,448,448,25,7,18,2,1
24,457,457,19,19,0,1,0
33,458,458,188,170,18,3,2
4,469,469,31,31,0,1,0
22,478,478,125,2,123,4,3
6,484,484,191,191,0,1,0
5,490,490,81,49,32,2,1
29,493,493,37,17,20,3,2

20,117,117,18,18,0,1,0
36,122,122,13,13,0,1,0
33,149,149,1,1,0,1,0
17,149,149,1,1,0,1,0
10,155,155,9,9,0,1,0
16,159,159,30,30,0,1,0
19,160,160,22,22,0,1,0
41,171,171,8,8,0,1,0
27,178,178,1,1,0,1,0
5,207,207,25,25,0,1,0
8,219,219,5,5,0,1,0
37,243,243,5,2,3,2,1
35,250,250,38,38,0,1,0
4,252,252,25,11,14,2,1
22,266,266,2,2,0,1,0
11,266,266,4,4,0,1,0
9,272,272,40,40,0,1,0
18,272,272,46,46,0,1,0
30,302,302,79,22,57,4,3
6,322,322,28,28,0,1,0
39,326,326,16,1,15,4,3
0,331,331,3,3,0,1,0
14,338,338,71,46,25,2,1
26,356,356,141,27,114,4,3
3,357,357,39,27,12,4,3
1,360,360,26,26,0,1,0
42,361,361,30,30,0,1,0
31,367,367,20,20,0,1,0
32,373,373,36,36,0,1,0
24,376,376,52,32,20,3,2
29,386,386,13,7,6,3,2
13,399,399,49,49,0,1,0
7,400,400,29,29,0,1,0
25,402,402,16,16,0,1,0
2,409,409,51,51,0,1,0
38,447,447,14,1,13,2,1
23,452,452,78,18,60,4,3
34,461,461,40,13,27,4,3
28,465,465,79,10,69,4,3
15,466,466,18,18,0,1,0
40,468,468,39,39,0,1,0
21,480,480,7,7,0,1,0
12,489,489,7,7,0,1,0

10,104,104,1,1,0,1,0
34,117,117,4,4,0,1,0
8,123,123,20,20,0,1,0
22,137,137,9,9,0,1,0
3,152,152,1,1,0,1,0
26,164,164,27,27,0,1,0
4,175,175,30,2,28,2,1
18,185,185,3,3,0,1,0
36,211,211,89,80,9,4,3
28,226,226,21,1,20,2,1
40,229,229,24,6,18,4,3
33,235,235,20,20,0,1,0
41,235,235,30,18,12,3,2
17,251,251,69,38,31,2,1
2,265,265,14,8,6,3,2
11,270,270,15,3,12,4,3
15,273,273,22,22,0,1,0
6,276,276,20,20,0,1,0
23,281,281,12,6,6,2,1
7,281,281,1,1,0,1,0
25,282,282,48,9,39,2,1
32,285,285,58,19,39,4,3
29,288,288,33,5,28,3,2
5,297,297,78,78,0,1,0
0,308,308,16,6,10,3,2
37,344,344,51,51,0,1,0
20,347,347,28,19,9,2,1
24,347,347,19,7,12,3,2
1,356,356,12,2,10,3,2
27,359,359,18,10,8,2,1
19,380,380,30,2,28,3,2
13,399,399,37,37,0,1,0
21,403,403,56,56,0,1,0
9,407,407,10,1,9,3,2
14,407,407,3,3,0,1,0
30,416,416,20,7,13,2,1
12,425,425,24,6,18,3,2
16,427,427,114,66,48,4,3
39,431,431,2,2,0,1,0
31,441,441,5,5,0,1,0
35,465,465,1,1,0,1,0
38,488,488,40,18,22,2,1

37,108,108,5,5,0,1,0
25,116,116,13,13,0,1,0
31,118,118,7,7,0,1,0
1,122,122,4,4,0,1,0
29,129,129,2,2,0,1,0
4,140,140,10,10,0,1,0
10,146,146,21,17,4,2,1
9,151,151,17,17,0,1,0
33,153,153,3,3,0,1,0
35,175,175,4,4,0,1,0
21,184,184,18,12,6,3,2
24,186,186,1,1,0,1,0
13,200,200,36,21,15,4,3
0,200,200,8,3,5,2,1
22,215,215,18,18,0,1,0
11,218,218,27,27,0,1,0
17,223,223,30,11,19,4,3
28,226,226,13,13,0,1,0
7,272,272,5,2,3,2,1
30,280,280,163,107,56,3,2
38,288,288,99,12,87,3,2
16,292,292,13,13,0,1,0
12,298,298,24,24,0,1,0
34,306,306,27,27,0,1,0
32,310,310,32,22,10,2,1
36,320,320,40,40,0,1,0
18,326,326,51,6,45,2,1
5,340,340,105,13,92,3,2
6,346,346,36,12,24,3,2
19,360,360,3,3,0,1,0
2,404,404,74,74,0,1,0
27,417,417,8,2,6,2,1
3,449,449,16,16,0,1,0
23,450,450,13,1,12,4,3
26,470,470,72,44,28,2,1
14,471,471,38,22,16,3,2
15,478,478,30,30,0,1,0
20,488,488,37,29,8,2,1
8,499,499,43,15,28,3,2

10,102,102,8,4,4,2,1
31,109,109,13,13,0,1,0
26,115,115,23,23,0,1,0
36,138,138,3,3,0,1,0
35,147,147,13,13,0,1,0
6,161,161,1,1,0,1,0
7,166,166,25,25,0,1,0
14,171,171,75,75,0,1,0
17,177,177,8,8,0,1,0
15,181,181,18,6,12,4,3
11,191,191,35,27,8,3,2
29,197,197,24,24,0,1,0
38,225,225,2,2,0,1,0
2,243,243,5,5,0,1,0
37,246,246,13,13,0,1,0
22,264,264,62,28,34,2,1
32,269,269,2,2,0,1,0
21,294,294,113,91,22,2,1
5,295,295,16,16,0,1,0
30,296,296,42,42,0,1,0
9,301,301,19,13,6,2,1
28,305,305,10,10,0,1,0
23,305,305,46,23,23,2,1
25,320,320,9,9,0,1,0
27,322,322,5,5,0,1,0
4,328,328,11,11,0,1,0
13,333,333,4,4,0,1,0
3,337,337,46,25,21,4,3
34,340,340,35,26,9,2,1
18,351,351,7,4,3,2,1
19,353,353,51,51,0,1,0
8,366,366,5,1,4,2,1
0,376,376,27,1,26,2,1
33,406,406,52,14,38,3,2
24,409,409,18,18,0,1,0
20,425,425,14,2,12,2,1
16,431,431,116,66,50,2,1
1,453,453,13,13,0,1,0
39,479,479,62,62,0,1,0
12,490,490,65,45,20,3,2

24,100,100,9,5,4,2,1
6,110,110,10,6,4,2,1
33,118,118,30,30,0,1,0
19,134,134,1,1,0,1,0
5,142,142,2,2,0,1,0
37,146,146,14,14,0,1,0
2,170,170,21,7,14,3,2
23,179,179,36,12,24,3,2
10,190,190,53,32,21,4,3
13,200,200,8,8,0,1,0
42,201,201,2,2,0,1,0
41,203,203,16,8,8,3,2
32,208,208,8,2,6,2,1
20,214,214,17,17,0,1,0
40,220,220,4,4,0,1,0
25,227,227,4,1,3,2,1
4,233,233,20,20,0,1,0
17,250,250,3,3,0,1,0
18,289,289,15,15,0,1,0
31,301,301,41,41,0,1,0
27,307,307,23,17,6,3,2
38,308,308,80,56,24,3,2
3,319,319,14,2,12,3,2
11,325,325,58,58,0,1,0
12,331,331,13,13,0,1,0
30,334,334,39,39,0,1,0
35,335,335,27,3,24,4,3
0,366,366,69,69,0,1,0
29,367,367,31,31,0,1,0
16,368,368,61,48,13,2,1
21,370,370,3,3,0,1,0
39,394,394,2,2,0,1,0
28,424,424,47,47,0,1,0
15,430,430,33,9,24,2,1
9,430,430,40,3,37,2,1
34,443,443,44,30,14,2,1
22,452,452,34,16,18,4,3
36,455,455,77,35,42,3,2
14,467,467,13,13,0,1,0
26,468,468,48,33,15,2,1
7,495,495,22,22,0,1,0
8,498,498,68,52,16,2,1
1,500,500,70,32,38,3,2

39,122,122,9,9,0,1,0
31,125,125,11,11,0,1,0
17,129,129,39,39,0,1,0
13,143,143,19,19,0,1,0
23,147,147,34,34,0,1,0
21,152,152,7,7,0,1,0
8,154,154,28,28,0,1,0
36,165,165,10,10,0,1,0
4,173,173,25,13,12,2,1
7,174,174,12,12,0,1,0
33,174,174,10,10,0,1,0
28,191,191,6,6,0,1,0
5,192,192,8,8,0,1,0
12,200,200,8,5,3,2,1
42,215,215,37,14,23,2,1
37,225,225,14,4,10,2,1
9,225,225,17,1,16,2,1
41,227,227,5,5,0,1,0
0,230,230,5,5,0,1,0
1,234,234,18,18,0,1,0
29,239,239,6,6,0,1,0
24,251,251,2,2,0,1,0
22,255,255,4,1,3,2,1
26,261,261,105,57,48,4,3
34,280,280,61,14,47,2,1
16,286,286,2,2,0,1,0
27,286,286,53,53,0,1,0
10,300,300,64,10,54,3,2
25,328,328,1,1,0,1,0
15,329,329,29,29,0,1,0
43,373,373,31,31,0,1,0
35,379,379,10,10,0,1,0
2,383,383,14,1,13,2,1
11,386,386,32,2,30,2,1
6,405,405,1,1,0,1,0
30,407,407,16,16,0,1,0
18,410,410,23,23,0,1,0
14,418,418,22,22,0,1,0
38,425,425,39,28,11,2,1
40,438,438,140,112,28,2,1
32,466,466,38,38,0,1,0
20,484,484,1,1,0,1,0
3,486,486,1,1,0,1,0
19,500,500,42,42,0,1,0

31,106,106,7,7,0,1,0
13,127,127,46,46,0,1,0
18,151,151,49,1,48,4,3
23,152,152,8,8,0,1,0
4,155,155,34,34,0,1,0
27,160,160,22,22,0,1,0
33,183,183,39,39,0,1,0
30,194,194,3,3,0,1,0
3,210,210,1,1,0,1,0
24,227,227,39,15,24,3,2
36,237,237,9,1,8,2,1
16,240,240,11,11,0,1,0
32,240,240,35,23,12,2,1
0,253,253,5,5,0,1,0
28,260,260,10,6,4,2,1
37,290,290,10,6,4,2,1
8,311,311,1,1,0,1,0
15,323,323,12,6,6,3,2
35,335,335,25,25,0,1,0
20,335,335,31,19,12,3,2
5,337,337,29,29,0,1,0
9,352,352,11,5,6,3,2
22,355,355,60,60,0,1,0
34,358,358,9,9,0,1,0
1,366,366,10,4,6,3,2
19,382,382,1,1,0,1,0
26,382,382,86,60,26,3,2
21,384,384,3,3,0,1,0
17,386,386,5,5,0,1,0
11,391,391,207,186,21,4,3
2,404,404,28,7,21,4,3
25,424,424,11,11,0,1,0
10,429,429,45,41,4,2,1
12,436,436,111,79,32,2,1
14,450,450,38,17,21,4,3
29,469,469,88,88,0,1,0
7,485,485,14,8,6,2,1
6,489,489,39,13,26,3,2

13,101,101,3,3,0,1,0
17,104,104,15,1,14,2,1
19,114,114,8,8,0,1,0
18,121,121,36,6,30,4,3
1,148,148,1,1,0,1,0
22,150,150,8,8,0,1,0
36,170,170,7,7,0,1,0
12,189,189,13,7,6,3,2
5,198,198,86,25,61,4,3
20,202,202,41,22,19,2,1
23,216,216,23,23,0,1,0
31,217,217,33,25,8,2,1
37,226,226,6,6,0,1,0
28,287,287,18,18,0,1,0
8,295,295,60,31,29,4,3
33,302,302,95,19,76,3,2
10,302,302,35,14,21,4,3
4,303,303,4,1,3,2,1
3,328,328,11,3,8,3,2
6,329,329,51,51,0,1,0
21,340,340,67,67,0,1,0
16,340,340,41,18,23,2,1
35,355,355,15,2,13,3,2
34,361,361,4,4,0,1,0
7,389,389,1,1,0,1,0
11,394,394,47,47,0,1,0
26,406,406,74,74,0,1,0
9,430,430,59,59,0,1,0
14,432,432,66,66,0,1,0
0,433,433,39,39,0,1,0
2,442,442,24,24,0,1,0
29,448,448,10,10,0,1,0
30,456,456,12,9,3,2,1
15,468,468,59,33,26,3,2
25,475,475,52,18,34,4,3
27,484,484,24,24,0,1,0
32,493,493,2,2,0,1,0
24,496,496,30,30,0,1,0

25,111,111,1,1,0,1,0
17,112,112,1,1,0,1,0
21,120,120,43,7,36,3,2
3,120,120,9,2,7,2,1
40,138,138,18,18,0,1,0
4,144,144,8,8,0,1,0
2,147,147,12,12,0,1,0
7,150,150,1,1,0,1,0
16,158,158,12,12,0,1,0
35,166,166,9,9,0,1,0
37,198,198,16,7,9,2,1
9,216,216,7,7,0,1,0
29,242,242,2,2,0,1,0
34,250,250,9,9,0,1,0
31,252,252,8,8,0,1,0
26,266,266,106,34,72,4,3
20,267,267,13,13,0,1,0
12,273,273,96,96,0,1,0
27,280,280,11,11,0,1,0
14,300,300,94,49,45,4,3
10,301,301,39,33,6,2,1
28,305,305,33,33,0,1,0
32,323,323,11,5,6,2,1
6,332,332,2,2,0,1,0
5,340,340,68,68,0,1,0
1,356,356,39,30,9,4,3
19,358,358,14,11,3,2,1
24,367,367,105,30,75,4,3
36,371,371,17,3,14,2,1
18,373,373,20,20,0,1,0
8,383,383,80,65,15,4,3
22,400,400,42,42,0,1,0
0,408,408,11,11,0,1,0
11,422,422,60,60,0,1,0
30,426,426,5,5,0,1,0
33,429,429,3,3,0,1,0
15,448,448,1,1,0,1,0
23,478,478,43,43,0,1,0
38,481,481,18,18,0,1,0
13,484,484,16,4,12,4,3
39,497,497,88,88,0,1,0

6,111,111,3,3,0,1,0
29,122,122,7,7,0,1,0
2,126,126,89,89,0,1,0
14,132,132,8,8,0,1,0
25,144,144,4,4,0,1,0
35,150,150,19,19,0,1,0
34,160,160,25,25,0,1,0
3,168,168,37,37,0,1,0
15,185,185,7,7,0,1,0
4,188,188,14,14,0,1,0
17,197,197,25,21,4,2,1
5,218,218,1,1,0,1,0
21,220,220,2,2,0,1,0
19,283,283,3,3,0,1,0
32,297,297,20,14,6,3,2
11,299,299,1,1,0,1,0
0,300,300,1,1,0,1,0
27,311,311,53,18,35,2,1
30,337,337,81,81,0,1,0
26,354,354,6,6,0,1,0
10,356,356,44,24,20,2,1
8,377,377,45,3,42,4,3
12,383,383,8,8,0,1,0
7,403,403,136,128,8,2,1
31,409,409,35,3,32,2,1
9,412,412,26,14,12,2,1
1,422,422,6,6,0,1,0
20,431,431,17,3,14,2,1
23,434,434,31,31,0,1,0
13,441,441,82,82,0,1,0
24,455,455,83,14,69,4,3
16,466,466,74,58,16,2,1
33,477,477,29,1,28,3,2
18,480,480,56,2,54,4,3
22,492,492,138,80,58,4,3
28,494,494,17,17,0,1,0

9,128,128,1,1,0,1,0
14,134,134,13,13,0,1,0
11,137,137,7,7,0,1,0
36,172,172,14,14,0,1,0
39,173,173,84,37,47,2,1
2,177,177,16,16,0,1,0
40,208,208,42,42,0,1,0
38,225,225,5,5,0,1,0
6,230,230,6,1,5,2,1
41,234,234,19,19,0,1,0
28,244,244,7,2,5,2,1
12,251,251,14,1,13,2,1
24,270,270,11,2,9,2,1
25,273,273,17,17,0,1,0
31,274,274,3,3,0,1,0
49,278,278,25,17,8,2,1
44,284,284,36,36,0,1,0
7,285,285,14,1,13,2,1
35,292,292,51,51,0,1,0
48,300,300,1,1,0,1,0
19,303,303,31,4,27,4,3
0,309,309,10,10,0,1,0
22,318,318,1,1,0,1,0
4,318,318,8,8,0,1,0
45,338,338,8,5,3,2,1
42,340,340,25,25,0,1,0
16,342,342,4,1,3,2,1
13,343,343,12,5,7,2,1
8,353,353,63,63,0,1,0
33,355,355,63,47,16,2,1
21,356,356,12,8,4,2,1
15,357,357,1,1,0,1,0
17,372,372,6,3,3,2,1
30,379,379,20,3,17,4,3
34,391,391,57,40,17,2,1
23,392,392,4,4,0,1,0
27,411,411,14,1,13,2,1
32,411,411,42,4,38,3,2
20,423,423,43,43,0,1,0
3,430,430,72,2,70,3,2
5,439,439,17,17,0,1,0
46,440,440,1,1,0,1,0
37,449,449,8,1,7,2,1
10,451,451,32,32,0,1,0
29,463,463,116,77,39,4,3
50,477,477,5,5,0,1,0
43,486,486,15,15,0,1,0
1,486,486,42,42,0,1,0
18,486,486,85,85,0,1,0
47,492,492,86,43,43,2,1
26,493,493,32,32,0,1,0

29,103,103,8,8,0,1,0
14,104,104,3,3,0,1,0
30,114,114,13,1,12,4,3
10,114,114,1,1,0,1,0
19,127,127,21,21,0,1,0
15,128,128,18,8,10,2,1
21,133,133,7,7,0,1,0
11,143,143,11,11,0,1,0
1,157,157,27,17,10,3,2
41,160,160,29,1,28,2,1
9,166,166,14,8,6,3,2
36,168,168,2,2,0,1,0
18,192,192,17,9,8,3,2
4,199,199,12,12,0,1,0
37,252,252,12,12,0,1,0
33,259,259,40,40,0,1,0
6,263,263,28,13,15,4,3
5,275,275,34,34,0,1,0
17,277,277,8,8,0,1,0
38,279,279,17,17,0,1,0
3,282,282,30,18,12,3,2
2,283,283,12,12,0,1,0
25,296,296,9,3,6,3,2
22,301,301,35,8,27,2,1
26,313,313,10,4,6,3,2
0,341,341,47,47,0,1,0
8,359,359,27,6,21,4,3
24,363,363,7,4,3,2,1
34,363,363,13,7,6,3,2
13,364,364,56,56,0,1,0
28,379,379,16,16,0,1,0
12,392,392,66,66,0,1,0
40,394,394,1,1,0,1,0
35,405,405,56,32,24,3,2
23,418,418,192,192,0,1,0
16,449,449,24,6,18,4,3
27,463,463,58,52,6,3,2
32,469,469,138,78,60,3,2
39,473,473,25,3,22,2,1
31,477,477,20,2,18,3,2
20,489,489,4,4,0,1,0
7,497,497,61,61,0,1,0

13,106,106,1,1,0,1,0
37,118,118,23,19,4,2,1
42,121,121,29,29,0,1,0
22,123,123,9,9,0,1,0
39,130,130,23,14,9,4,3
31,164,164,44,15,29,3,2
6,178,178,15,15,0,1,0
0,182,182,28,28,0,1,0
15,197,197,6,2,4,2,1
18,200,200,13,3,10,2,1
34,206,206,8,8,0,1,0
17,218,218,4,1,3,2,1
1,220,220,7,7,0,1,0
21,222,222,2,2,0,1,0
8,225,225,2,2,0,1,0
29,243,243,3,3,0,1,0
23,247,247,32,32,0,1,0
40,250,250,13,2,11,3,2
45,254,254,17,17,0,1,0
30,256,256,23,23,0,1,0
5,261,261,1,1,0,1,0
25,263,263,58,38,20,2,1
46,275,275,12,12,0,1,0
19,279,279,3,3,0,1,0
7,295,295,31,31,0,1,0
41,300,300,21,13,8,2,1
27,306,306,29,17,12,2,1
3,307,307,89,89,0,1,0
32,307,307,37,37,0,1,0
20,313,313,11,11,0,1,0
16,339,339,19,1,18,4,3
33,342,342,46,46,0,1,0
35,345,345,8,8,0,1,0
26,359,359,48,24,24,2,1
9,360,360,12,5,7,2,1
10,366,366,2,2,0,1,0
43,367,367,36,36,0,1,0
4,383,383,27,23,4,2,1
44,388,388,43,43,0,1,0
28,389,389,27,12,15,4,3
24,406,406,78,28,50,2,1
2,443,443,43,14,29,2,1
14,445,445,6,6,0,1,0
12,453,453,12,12,0,1,0
11,463,463,44,28,16,2,1
38,481,481,22,3,19,4,3
36,494,494,46,30,16,2,1

12,114,114,37,2,35,4,3
14,126,126,15,15,0,1,0
33,149,149,53,23,30,3,2
0,150,150,42,42,0,1,0
34,155,155,8,8,0,1,0
22,188,188,37,37,0,1,0
18,203,203,24,16,8,3,2
19,222,222,2,2,0,1,0
15,224,224,1,1,0,1,0
16,224,224,24,24,0,1,0
9,230,230,10,10,0,1,0
7,239,239,45,45,0,1,0
6,241,241,42,42,0,1,0
35,264,264,19,3,16,3,2
25,264,264,47,4,43,2,1
28,268,268,31,31,0,1,0
27,268,268,17,17,0,1,0
11,275,275,19,19,0,1,0
29,281,281,14,14,0,1,0
32,290,290,46,28,18,4,3
3,295,295,46,43,3,2,1
13,296,296,51,15,36,4,3
30,302,302,4,4,0,1,0
24,303,303,46,12,34,3,2
20,311,311,40,40,0,1,0
26,328,328,48,20,28,2,1
1,380,380,2,2,0,1,0
2,436,436,69,69,0,1,0
17,440,440,35,13,22,2,1
31,448,448,3,3,0,1,0
8,451,451,9,9,0,1,0
4,454,454,72,60,12,4,3
21,467,467,7,7,0,1,0
23,469,469,14,10,4,2,1
10,478,478,24,24,0,1,0
5,493,493,39,7,32,3,2

2,101,101,33,33,0,1,0
5,107,107,24,24,0,1,0
6,112,112,27,17,10,2,1
21,113,113,31,5,26,2,1
11,115,115,31,4,27,4,3
9,118,118,41,35,6,3,2
20,123,123,2,2,0,1,0
13,125,125,11,11,0,1,0
27,210,210,10,10,0,1,0
30,220,220,34,34,0,1,0
18,236,236,7,7,0,1,0
28,266,266,5,5,0,1,0
24,268,268,21,21,0,1,0
15,272,272,69,69,0,1,0
14,286,286,51,15,36,3,2
7,335,335,24,24,0,1,0
26,338,338,25,25,0,1,0
0,344,344,23,23,0,1,0
19,361,361,5,1,4,2,1
22,373,373,6,3,3,2,1
17,378,378,102,25,77,3,2
10,403,403,110,102,8,3,2
25,435,435,16,13,3,2,1
16,441,441,16,4,12,2,1
29,449,449,27,13,14,2,1
1,458,458,34,1,33,4,3
8,463,463,134,62,72,3,2
4,466,466,30,9,21,4,3
3,480,480,11,3,8,2,1
23,498,498,36,36,0,1,0
12,498,498,26,26,0,1,0

42,101,101,10,7,3,2,1
14,102,102,2,2,0,1,0
21,120,120,6,1,5,2,1
29,125,125,7,7,0,1,0
24,125,125,1,1,0,1,0
36,158,158,26,15,11,2,1
34,159,159,1,1,0,1,0
19,160,160,61,61,0,1,0
0,171,171,12,12,0,1,0
15,172,172,1,1,0,1,0
22,184,184,10,10,0,1,0
40,201,201,8,8,0,1,0
13,202,202,11,6,5,2,1
26,205,205,1,1,0,1,0
38,208,208,14,14,0,1,0
4,214,214,6,2,4,2,1
33,218,218,6,6,0,1,0
20,220,220,9,9,0,1,0
37,224,224,18,18,0,1,0
31,236,236,54,6,48,4,3
43,248,248,15,8,7,2,1
27,268,268,8,8,0,1,0
48,276,276,9,9,0,1,0
41,280,280,5,5,0,1,0
8,294,294,19,2,17,2,1
16,320,320,2,2,0,1,0
10,320,320,2,2,0,1,0
32,322,322,25,25,0,1,0
30,325,325,14,5,9,4,3
5,343,343,34,34,0,1,0
2,344,344,94,70,24,4,3
47,344,344,3,3,0,1,0
3,345,345,43,43,0,1,0
12,348,348,21,21,0,1,0
11,351,351,55,55,0,1,0
1,378,378,20,20,0,1,0
23,383,383,1,1,0,1,0
9,391,391,1,1,0,1,0
35,396,396,64,64,0,1,0
6,398,398,42,3,39,2,1
44,409,409,30,30,0,1,0
46,417,417,86,10,76,4,3
7,437,437,3,3,0,1,0
28,448,448,8,8,0,1,0
17,462,462,17,9,8,2,1
49,463,463,205,119,86,4,3
39,465,465,40,4,36,2,1
45,466,466,53,13,40,3,2
25,479,479,19,4,15,4,3
18,485,485,72,25,47,2,1

32,104,104,5,5,0,1,0
12,109,109,21,3,18,4,3
11,119,119,4,4,0,1,0
13,120,120,29,8,21,4,3
38,120,120,8,8,0,1,0
28,135,135,6,6,0,1,0
10,141,141,2,2,0,1,0
37,144,144,3,3,0,1,0
19,157,157,8,8,0,1,0
5,159,159,5,5,0,1,0
25,175,175,32,23,9,2,1
14,180,180,15,15,0,1,0
40,180,180,8,8,0,1,0
2,194,194,5,5,0,1,0
33,218,218,50,50,0,1,0
42,221,221,17,5,12,3,2
4,227,227,3,3,0,1,0
31,235,235,6,6,0,1,0
34,240,240,50,21,29,2,1
7,269,269,63,54,9,4,3
29,275,275,2,2,0,1,0
6,279,279,1,1,0,1,0
36,283,283,23,2,21,4,3
43,291,291,94,72,22,3,2
27,291,291,7,4,3,2,1
22,292,292,15,3,12,4,3
3,297,297,18,18,0,1,0
1,310,310,13,3,10,2,1
41,313,313,23,8,15,4,3
24,321,321,45,27,18,4,3
0,341,341,3,3,0,1,0
17,358,358,57,35,22,2,1
30,388,388,23,9,14,3,2
35,408,408,40,12,28,4,3
26,412,412,66,28,38,3,2
15,416,416,20,6,14,2,1
23,434,434,4,4,0,1,0
16,438,438,77,77,0,1,0
18,439,439,5,5,0,1,0
9,470,470,80,80,0,1,0
20,473,473,24,24,0,1,0
21,483,483,130,25,105,4,3
8,487,487,10,10,0,1,0
39,495,495,65,10,55,4,3

1,116,116,48,48,0,1,0
17,140,140,17,7,10,4,3
14,155,155,68,48,20,2,1
7,156,156,1,1,0,1,0
12,156,156,16,4,12,2,1
4,185,185,1,1,0,1,0
5,185,185,1,1,0,1,0
27,196,196,15,1,14,4,3
11,207,207,10,10,0,1,0
33,209,209,48,30,18,2,1
35,230,230,12,12,0,1,0
9,230,230,35,35,0,1,0
22,241,241,87,79,8,2,1
23,250,250,81,60,21,4,3
6,262,262,3,3,0,1,0
31,294,294,23,23,0,1,0
3,306,306,22,3,19,2,1
15,311,311,33,13,20,2,1
16,325,325,5,1,4,2,1
26,327,327,6,2,4,2,1
13,327,327,21,5,16,2,1
28,334,334,34,34,0,1,0
32,341,341,31,19,12,4,3
18,345,345,16,6,10,3,2
8,347,347,43,15,28,3,2
30,367,367,67,19,48,4,3
21,371,371,37,12,25,2,1
25,389,389,12,8,4,2,1
34,390,390,37,25,12,4,3
29,417,417,12,4,8,2,1
24,440,440,7,7,0,1,0
2,445,445,88,70,18,3,2
0,465,465,77,35,42,2,1
19,474,474,16,1,15,4,3
10,479,479,42,42,0,1,0
20,486,486,14,14,0,1,0

40,134,134,20,20,0,1,0
17,139,139,16,6,10,2,1
24,144,144,1,1,0,1,0
22,153,153,1,1,0,1,0
29,156,156,4,1,3,2,1
4,158,158,1,1,0,1,0
30,166,166,90,21,69,3,2
13,170,170,38,38,0,1,0
44,213,213,59,59,0,1,0
45,227,227,15,3,12,2,1
33,227,227,3,3,0,1,0
18,230,230,53,8,45,2,1
31,244,244,18,18,0,1,0
20,254,254,8,8,0,1,0
3,258,258,19,3,16,2,1
1,259,259,12,12,0,1,0
25,273,273,4,4,0,1,0
39,279,279,46,46,0,1,0
42,280,280,37,37,0,1,0
6,284,284,19,1,18,2,1
12,289,289,5,5,0,1,0
2,337,337,28,11,17,2,1
10,339,339,24,24,0,1,0
19,347,347,11,5,6,3,2
32,352,352,1,1,0,1,0
23,355,355,12,8,4,2,1
8,358,358,23,18,5,2,1
0,363,363,25,25,0,1,0
7,365,365,3,3,0,1,0
34,370,370,46,4,42,4,3
9,371,371,55,22,33,4,3
35,375,375,4,1,3,2,1
11,376,376,36,16,20,3,2
36,380,380,51,22,29,2,1
16,384,384,71,71,0,1,0
21,388,388,1,1,0,1,0
26,395,395,91,5,86,3,2
43,398,398,3,3,0,1,0
37,406,406,3,3,0,1,0
28,418,418,3,3,0,1,0
41,450,450,9,9,0,1,0
14,456,456,41,41,0,1,0
27,473,473,21,3,18,2,1
38,478,478,4,4,0,1,0
5,480,480,132,19,113,4,3
15,491,491,2,2,0,1,0

27,106,106,30,5,25,2,1
16,117,117,6,6,0,1,0
11,140,140,31,31,0,1,0
14,168,168,14,2,12,2,1
30,179,179,42,42,0,1,0
0,223,223,17,3,14,3,2
17,225,225,37,37,0,1,0
19,233,233,48,3,45,2,1
15,250,250,32,32,0,1,0
24,253,253,1,1,0,1,0
2,279,279,25,5,20,3,2
3,291,291,4,4,0,1,0
9,300,300,30,30,0,1,0
6,308,308,2,2,0,1,0
31,308,308,38,2,36,3,2
13,314,314,78,78,0,1,0
29,316,316,110,3,107,4,3
23,327,327,18,18,0,1,0
10,333,333,10,10,0,1,0
4,341,341,88,88,0,1,0
26,356,356,25,25,0,1,0
22,365,365,10,3,7,2,1
32,376,376,5,5,0,1,0
5,397,397,11,11,0,1,0
28,404,404,28,28,0,1,0
8,428,428,150,81,69,4,3
21,437,437,6,6,0,1,0
18,448,448,26,8,18,4,3
33,456,456,31,31,0,1,0
20,470,470,1,1,0,1,0
12,481,481,7,3,4,2,1
1,482,482,182,86,96,3,2
25,483,483,21,21,0,1,0
7,495,495,92,62,30,4,3

20,100,100,8,8,0,1,0
39,114,114,1,1,0,1,0
9,151,151,53,53,0,1,0
27,153,153,5,5,0,1,0
22,162,162,19,19,0,1,0
32,163,163,6,3,3,2,1
11,177,177,6,6,0,1,0
15,192,192,6,6,0,1,0
29,197,197,9,9,0,1,0
17,201,201,11,11,0,1,0
28,207,207,4,1,3,2,1
35,219,219,3,3,0,1,0
25,222,222,13,13,0,1,0
12,237,237,21,21,0,1,0
30,242,242,50,50,0,1,0
5,251,251,27,3,24,4,3
6,292,292,11,11,0,1,0
4,307,307,10,10,0,1,0
1,316,316,62,18,44,3,2
13,320,320,28,22,6,3,2
18,337,337,36,36,0,1,0
0,339,339,14,14,0,1,0
10,344,344,58,58,0,1,0
3,353,353,14,8,6,3,2
38,353,353,10,5,5,2,1
21,355,355,39,27,12,4,3
34,376,376,26,26,0,1,0
31,378,378,89,20,69,4,3
24,381,381,35,26,9,4,3
23,386,386,37,13,24,2,1
14,389,389,7,7,0,1,0
33,418,418,52,52,0,1,0
36,419,419,5,5,0,1,0
2,442,442,83,55,28,3,2
8,454,454,2,2,0,1,0
16,467,467,4,4,0,1,0
37,468,468,186,180,6,3,2
19,472,472,83,83,0,1,0
7,475,475,109,56,53,4,3
26,491,491,125,31,94,3,2

39,106,106,24,24,0,1,0
41,108,108,23,2,21,4,3
18,114,114,6,6,0,1,0
9,116,116,7,7,0,1,0
37,118,118,1,1,0,1,0
29,119,119,17,17,0,1,0
5,122,122,6,3,3,2,1
33,124,124,2,2,0,1,0
27,124,124,24,13,11,2,1
14,134,134,3,3,0,1,0
12,149,149,20,20,0,1,0
31,149,149,14,14,0,1,0
16,162,162,8,8,0,1,0
2,177,177,22,22,0,1,0
38,192,192,41,7,34,3,2
40,193,193,7,1,6,2,1
17,203,203,4,4,0,1,0
10,213,213,39,39,0,1,0
0,219,219,8,8,0,1,0
43,221,221,21,11,10,2,1
25,226,226,2,2,0,1,0
26,244,244,1,1,0,1,0
23,287,287,3,3,0,1,0
20,299,299,11,11,0,1,0
13,306,306,12,12,0,1,0
35,307,307,3,3,0,1,0
8,320,320,1,1,0,1,0
4,324,324,12,1,11,2,1
30,365,365,26,26,0,1,0
24,391,391,11,2,9,2,1
21,406,406,19,19,0,1,0
3,408,408,6,6,0,1,0
42,410,410,6,6,0,1,0
28,413,413,5,2,3,2,1
11,431,431,205,170,35,2,1
19,435,435,35,8,27,4,3
34,440,440,147,129,18,4,3
32,442,442,52,21,31,2,1
7,444,444,80,25,55,3,2
22,458,458,43,33,10,3,2
15,461,461,1,1,0,1,0
6,461,461,44,1,43,3,2
36,462,462,42,7,35,2,1
44,472,472,68,26,42,4,3
1,491,491,61,8,53,4,3

26,147,147,11,1,10,3,2
11,150,150,21,21,0,1,0
33,153,153,1,1,0,1,0
2,158,158,3,3,0,1,0
32,163,163,5,1,4,2,1
8,175,175,6,6,0,1,0
21,191,191,64,51,13,2,1
29,227,227,18,3,15,2,1
9,230,230,36,36,0,1,0
30,233,233,17,17,0,1,0
25,248,248,15,15,0,1,0
20,253,253,3,3,0,1,0
28,262,262,105,25,80,3,2
34,283,283,46,46,0,1,0
22,287,287,58,58,0,1,0
15,316,316,1,1,0,1,0
10,317,317,21,21,0,1,0
16,317,317,1,1,0,1,0
13,338,338,99,13,86,3,2
24,352,352,8,4,4,2,1
35,362,362,18,15,3,2,1
4,367,367,24,13,11,2,1
3,370,370,37,23,14,3,2
5,384,384,17,17,0,1,0
6,399,399,96,1,95,4,3
7,405,405,125,96,29,2,1
0,411,411,173,173,0,1,0
19,415,415,41,41,0,1,0
18,421,421,6,6,0,1,0
27,425,425,13,1,12,3,2
23,445,445,45,41,4,2,1
17,456,456,39,39,0,1,0
1,456,456,6,2,4,2,1
31,458,458,85,85,0,1,0
12,492,492,5,5,0,1,0
14,496,496,43,43,0,1,0

1,101,101,1,1,0,1,0
14,111,111,19,19,0,1,0
5,115,115,59,59,0,1,0
15,116,116,1,1,0,1,0
8,133,133,1,1,0,1,0
17,146,146,43,18,25,4,3
27,151,151,1,1,0,1,0
12,160,160,6,2,4,2,1
20,161,161,13,9,4,2,1
19,175,175,6,6,0,1,0
32,195,195,29,29,0,1,0
18,205,205,30,30,0,1,0
25,217,217,16,16,0,1,0
29,220,220,8,8,0,1,0
36,222,222,50,44,6,3,2
0,229,229,12,12,0,1,0
30,230,230,3,3,0,1,0
13,266,266,10,10,0,1,0
33,277,277,36,36,0,1,0
23,279,279,29,29,0,1,0
37,309,309,22,1,21,2,1
7,310,310,36,36,0,1,0
21,310,310,40,9,31,4,3
31,339,339,18,3,15,2,1
34,361,361,158,112,46,4,3
10,364,364,51,1,50,4,3
9,365,365,36,36,0,1,0
26,366,366,13,13,0,1,0
16,372,372,12,12,0,1,0
35,393,393,73,61,12,2,1
22,407,407,6,6,0,1,0
11,413,413,25,25,0,1,0
28,426,426,41,41,0,1,0
3,430,430,41,20,21,4,3
2,437,437,20,20,0,1,0
4,438,438,109,30,79,3,2
6,447,447,14,14,0,1,0
24,454,454,13,13,0,1,0

18,103,103,7,7,0,1,0
4,105,105,4,4,0,1,0
42,108,108,23,1,22,2,1
30,109,109,23,5,18,2,1
17,124,124,14,4,10,3,2
27,127,127,37,7,30,4,3
6,132,132,6,6,0,1,0
32,146,146,58,35,23,2,1
37,147,147,6,6,0,1,0
46,154,154,5,1,4,2,1
38,157,157,21,15,6,2,1
12,158,158,11,3,8,2,1
28,186,186,9,1,8,2,1
19,190,190,5,5,0,1,0
3,192,192,22,22,0,1,0
2,194,194,4,4,0,1,0
8,198,198,31,22,9,2,1
26,206,206,4,4,0,1,0
34,244,244,12,12,0,1,0
31,245,245,3,3,0,1,0
23,245,245,44,44,0,1,0
13,247,247,5,5,0,1,0
24,252,252,1,1,0,1,0
15,254,254,79,79,0,1,0
36,268,268,27,9,18,2,1
10,269,269,34,34,0,1,0
43,274,274,35,2,33,4,3
11,274,274,38,9,29,3,2
16,283,283,20,8,12,2,1
21,303,303,1,1,0,1,0
45,305,305,9,3,6,3,2
20,317,317,19,19,0,1,0
35,317,317,22,22,0,1,0
41,320,320,24,24,0,1,0
0,328,328,2,2,0,1,0
5,407,407,1,1,0,1,0
7,411,411,60,44,16,3,2
1,421,421,1,1,0,1,0
33,437,437,52,4,48,4,3
25,441,441,76,22,54,4,3
39,446,446,18,18,0,1,0
14,456,456,29,29,0,1,0
9,463,463,1,1,0,1,0
29,463,463,3,3,0,1,0
44,474,474,7,7,0,1,0
22,480,480,10,1,9,4,3
40,496,496,16,16,0,1,0

34,114,114,1,1,0,1,0
36,119,119,14,14,0,1,0
41,120,120,27,27,0,1,0
0,122,122,1,1,0,1,0
11,144,144,12,3,9,4,3
16,149,149,8,8,0,1,0
33,150,150,6,1,5,2,1
35,151,151,10,4,6,3,2
18,169,169,2,2,0,1,0
22,186,186,15,9,6,3,2
27,200,200,32,4,28,2,1
10,214,214,7,3,4,2,1
4,231,231,8,8,0,1,0
38,237,237,63,27,36,4,3
40,241,241,19,19,0,1,0
43,250,250,2,2,0,1,0
19,264,264,5,2,3,2,1
17,267,267,15,15,0,1,0
3,270,270,1,1,0,1,0
9,293,293,10,1,9,2,1
29,306,306,13,13,0,1,0
37,312,312,12,9,3,2,1
26,317,317,5,5,0,1,0
44,322,322,70,4,66,3,2
23,323,323,12,4,8,3,2
42,342,342,24,10,14,2,1
30,344,344,121,39,82,3,2
12,369,369,131,107,24,4,3
24,374,374,12,12,0,1,0
32,388,388,36,36,0,1,0
8,389,389,6,6,0,1,0
1,401,401,22,4,18,2,1
39,403,403,46,22,24,2,1
5,420,420,137,84,53,4,3
31,422,422,1,1,0,1,0
2,435,435,5,5,0,1,0
45,445,445,1,1,0,1,0
28,450,450,53,53,0,1,0
20,456,456,48,42,6,2,1
14,458,458,1,1,0,1,0
15,475,475,61,61,0,1,0
25,478,478,29,29,0,1,0
13,490,490,90,48,42,4,3
21,491,491,1,1,0,1,0
6,494,494,8,4,4,2,1
7,498,498,126,95,31,2,1

24,115,115,25,25,0,1,0
33,124,124,9,9,0,1,0
16,140,140,25,13,12,2,1
21,151,151,33,33,0,1,0
28,151,151,10,10,0,1,0
20,183,183,21,10,11,2,1
2,192,192,1,1,0,1,0
31,195,195,23,13,10,3,2
25,195,195,1,1,0,1,0
23,206,206,3,3,0,1,0
10,212,212,11,5,6,2,1
27,214,214,5,5,0,1,0
36,214,214,6,2,4,2,1
29,234,234,11,11,0,1,0
6,251,251,10,10,0,1,0
35,252,252,35,4,31,4,3
26,260,260,35,1,34,2,1
3,264,264,33,11,22,2,1
43,273,273,25,12,13,2,1
17,277,277,29,11,18,4,3
11,277,277,4,4,0,1,0
32,280,280,98,68,30,4,3
12,289,289,8,8,0,1,0
34,296,296,28,3,25,2,1
0,332,332,2,2,0,1,0
19,335,335,66,66,0,1,0
30,339,339,34,34,0,1,0
37,361,361,18,6,12,3,2
13,373,373,29,1,28,3,2
22,389,389,8,3,5,2,1
42,397,397,1,1,0,1,0
40,403,403,95,50,45,3,2
15,407,407,6,2,4,2,1
39,430,430,39,39,0,1,0
8,431,431,10,7,3,2,1
41,431,431,75,75,0,1,0
38,436,436,1,1,0,1,0
7,452,452,24,1,23,2,1
4,452,452,26,26,0,1,0
18,454,454,101,101,0,1,0
9,455,455,2,2,0,1,0
5,474,474,31,31,0,1,0
1,479,479,166,166,0,1,0
14,483,483,10,1,9,2,1

39,100,100,32,10,22,2,1
37,107,107,8,8,0,1,0
24,111,111,10,1,9,2,1
0,116,116,3,3,0,1,0
16,131,131,3,3,0,1,0
7,147,147,11,11,0,1,0
6,151,151,27,19,8,3,2
29,154,154,6,6,0,1,0
8,178,178,42,42,0,1,0
1,200,200,44,44,0,1,0
28,201,201,15,3,12,3,2
21,215,215,59,5,54,3,2
33,221,221,16,7,9,4,3
35,238,238,10,4,6,3,2
3,240,240,22,16,6,2,1
18,241,241,1,1,0,1,0
38,255,255,5,5,0,1,0
15,260,260,37,37,0,1,0
31,264,264,7,7,0,1,0
9,276,276,34,34,0,1,0
32,276,276,37,37,0,1,0
23,284,284,17,1,16,3,2
34,287,287,16,16,0,1,0
14,292,292,12,12,0,1,0
20,298,298,5,2,3,2,1
26,323,323,65,34,31,2,1
2,327,327,4,4,0,1,0
10,338,338,55,34,21,4,3
36,349,349,18,18,0,1,0
30,353,353,45,33,12,3,2
5,360,360,38,14,24,3,2
4,370,370,20,20,0,1,0
13,377,377,45,45,0,1,0
12,378,378,9,4,5,2,1
27,390,390,24,3,21,2,1
19,436,436,16,7,9,4,3
22,447,447,50,50,0,1,0
25,462,462,83,71,12,4,3
17,464,464,22,14,8,2,1
11,464,464,129,59,70,3,2

25,100,100,24,15,9,2,1
11,100,100,4,4,0,1,0
8,100,100,9,2,7,2,1
1,105,105,1,1,0,1,0
29,123,123,9,9,0,1,0
22,123,123,4,4,0,1,0
20,124,124,2,2,0,1,0
30,140,140,10,10,0,1,0
34,162,162,17,17,0,1,0
6,183,183,3,3,0,1,0
7,206,206,10,10,0,1,0
13,209,209,55,16,39,4,3
19,218,218,34,9,25,2,1
0,228,228,17,17,0,1,0
18,231,231,12,12,0,1,0
5,242,242,24,24,0,1,0
28,243,243,80,80,0,1,0
31,251,251,38,38,0,1,0
16,259,259,19,1,18,4,3
35,260,260,21,21,0,1,0
9,271,271,64,58,6,2,1
33,281,281,14,14,0,1,0
26,297,297,69,69,0,1,0
4,328,328,135,91,44,2,1
23,344,344,22,7,15,4,3
12,346,346,28,28,0,1,0
24,353,353,70,32,38,4,3
3,371,371,4,4,0,1,0
17,391,391,31,21,10,2,1
10,427,427,34,34,0,1,0
2,431,431,79,25,54,3,2
14,431,431,47,47,0,1,0
27,432,432,3,3,0,1,0
21,437,437,6,3,3,2,1
32,446,446,13,1,12,3,2
15,466,466,116,53,63,4,3

40,118,118,14,2,12,2,1
29,127,127,45,28,17,2,1
14,131,131,2,2,0,1,0
30,152,152,16,16,0,1,0
4,154,154,12,4,8,2,1
32,154,154,5,5,0,1,0
25,165,165,15,15,0,1,0
5,173,173,4,4,0,1,0
19,174,174,6,1,5,2,1
0,176,176,19,19,0,1,0
12,183,183,9,9,0,1,0
43,196,196,21,4,17,3,2
3,203,203,22,22,0,1,0
20,206,206,13,13,0,1,0
38,219,219,6,6,0,1,0
36,234,234,2,2,0,1,0
21,238,238,28,16,12,3,2
39,243,243,25,7,18,3,2
18,243,243,18,18,0,1,0
1,245,245,4,4,0,1,0
7,248,248,20,20,0,1,0
26,256,256,22,22,0,1,0
10,262,262,2,2,0,1,0
16,266,266,9,9,0,1,0
34,275,275,2,2,0,1,0
41,277,277,16,16,0,1,0
27,285,285,13,13,0,1,0
2,304,304,67,67,0,1,0
42,307,307,29,29,0,1,0
8,308,308,21,6,15,4,3
15,320,320,72,23,49,2,1
9,321,321,28,25,3,2,1
28,324,324,6,2,4,2,1
31,331,331,41,3,38,2,1
35,350,350,15,15,0,1,0
6,369,369,45,37,8,3,2
11,380,380,63,63,0,1,0
17,422,422,1,1,0,1,0
13,423,423,21,3,18,4,3
23,428,428,86,81,5,2,1
24,453,453,167,54,113,4,3
37,465,465,108,9,99,4,3
33,476,476,7,7,0,1,0
22,499,499,25,2,23,2,1

10,105,105,38,38,0,1,0
15,112,112,2,2,0,1,0
17,123,123,9,1,8,2,1
22,132,132,2,2,0,1,0
0,138,138,32,32,0,1,0
25,143,143,10,5,5,2,1
4,144,144,15,5,10,2,1
23,151,151,38,38,0,1,0
8,163,163,23,2,21,2,1
14,176,176,36,36,0,1,0
13,179,179,49,1,48,4,3
12,208,208,8,8,0,1,0
3,218,218,11,4,7,2,1
6,232,232,1,1,0,1,0
20,274,274,41,41,0,1,0
9,274,274,38,38,0,1,0
29,300,300,5,1,4,2,1
18,301,301,10,10,0,1,0
5,309,309,23,11,12,3,2
2,313,313,23,3,20,2,1
11,333,333,153,72,81,4,3
27,347,347,2,2,0,1,0
26,351,351,4,4,0,1,0
24,409,409,1,1,0,1,0
31,451,451,151,151,0,1,0
21,453,453,104,95,9,4,3
7,458,458,165,165,0,1,0
28,470,470,80,80,0,1,0
1,470,470,1,1,0,1,0
19,475,475,23,23,0,1,0
16,486,486,42,14,28,2,1
30,490,490,9,9,0,1,0

30,100,100,11,1,10,3,2
25,124,124,5,1,4,2,1
15,125,125,8,8,0,1,0
33,135,135,18,18,0,1,0
10,139,139,5,2,3,2,1
1,145,145,1,1,0,1,0
40,146,146,24,24,0,1,0
0,148,148,4,4,0,1,0
22,182,182,28,10,18,3,2
43,209,209,3,3,0,1,0
19,214,214,16,7,9,4,3
36,215,215,7,7,0,1,0
42,237,237,2,2,0,1,0
31,243,243,17,17,0,1,0
14,244,244,35,35,0,1,0
34,257,257,37,22,15,4,3
28,260,260,2,2,0,1,0
6,266,266,14,14,0,1,0
16,269,269,39,6,33,4,3
3,274,274,12,12,0,1,0
38,281,281,36,3,33,2,1
2,304,304,52,41,11,2,1
12,317,317,10,10,0,1,0
26,319,319,22,22,0,1,0
18,345,345,129,39,90,4,3
39,345,345,32,14,18,4,3
32,347,347,161,161,0,1,0
4,366,366,1,1,0,1,0
29,385,385,72,72,0,1,0
24,396,396,85,2,83,4,3
23,402,402,48,5,43,2,1
7,405,405,86,20,66,4,3
27,411,411,6,6,0,1,0
9,433,433,8,8,0,1,0
35,437,437,18,18,0,1,0
13,441,441,16,16,0,1,0
21,446,446,24,24,0,1,0
17,457,457,20,20,0,1,0
5,460,460,53,53,0,1,0
41,462,462,27,15,12,4,3
20,484,484,7,7,0,1,0
8,486,486,13,3,10,3,2
37,493,493,25,3,22,2,1
11,499,499,17,3,14,2,1

33,100,100,4,4,0,1,0
19,111,111,1,1,0,1,0
6,123,123,7,7,0,1,0
4,131,131,9,2,7,2,1
10,131,131,1,1,0,1,0
14,143,143,2,2,0,1,0
29,144,144,17,17,0,1,0
42,145,145,1,1,0,1,0
38,149,149,10,1,9,2,1
16,153,153,12,12,0,1,0
43,168,168,11,4,7,2,1
11,178,178,1,1,0,1,0
23,186,186,1,1,0,1,0
26,216,216,41,41,0,1,0
44,219,219,65,65,0,1,0
12,235,235,5,2,3,2,1
9,242,242,27,4,23,4,3
45,242,242,14,14,0,1,0
1,252,252,58,16,42,2,1
22,263,263,14,8,6,3,2
21,284,284,1,1,0,1,0
28,298,298,21,4,17,2,1
3,302,302,6,6,0,1,0
13,302,302,31,27,4,2,1
2,313,313,75,30,45,4,3
24,315,315,15,3,12,3,2
5,321,321,4,1,3,2,1
36,325,325,116,22,94,3,2
41,334,334,5,2,3,2,1
39,338,338,25,25,0,1,0
20,342,342,74,74,0,1,0
0,343,343,4,4,0,1,0
8,355,355,38,4,34,3,2
46,368,368,21,8,13,2,1
32,378,378,52,24,28,3,2
40,390,390,81,45,36,4,3
25,397,397,70,70,0,1,0
7,398,398,62,44,18,2,1
35,405,405,41,36,5,2,1
18,408,408,3,3,0,1,0
17,440,440,21,21,0,1,0
15,441,441,1,1,0,1,0
30,466,466,17,2,15,2,1
27,467,467,32,32,0,1,0
37,470,470,19,19,0,1,0
31,482,482,22,22,0,1,0
34,498,498,90,90,0,1,0

7,120,120,4,4,0,1,0
26,122,122,4,4,0,1,0
11,128,128,7,7,0,1,0
2,138,138,31,31,0,1,0
15,144,144,57,57,0,1,0
4,150,150,8,8,0,1,0
3,152,152,32,32,0,1,0
36,168,168,11,11,0,1,0
8,188,188,7,7,0,1,0
31,203,203,3,3,0,1,0
32,205,205,13,13,0,1,0
12,212,212,11,5,6,2,1
27,217,217,5,5,0,1,0
30,229,229,20,20,0,1,0
17,244,244,70,22,48,3,2
24,247,247,38,14,24,2,1
22,250,250,80,29,51,4,3
6,250,250,60,11,49,2,1
10,273,273,14,1,13,2,1
5,287,287,20,20,0,1,0
25,312,312,36,23,13,2,1
34,329,329,26,5,21,2,1
14,351,351,45,14,31,3,2
28,351,351,32,8,24,3,2
13,364,364,42,22,20,3,2
18,368,368,38,6,32,3,2
33,385,385,62,62,0,1,0
1,406,406,73,48,25,4,3
0,419,419,43,43,0,1,0
16,420,420,15,15,0,1,0
35,425,425,18,5,13,2,1
9,429,429,7,7,0,1,0
19,432,432,25,14,11,2,1
23,440,440,17,14,3,2,1
29,460,460,21,21,0,1,0
20,473,473,22,13,9,2,1
21,496,496,104,78,26,2,1

0,101,101,6,3,3,2,1
2,109,109,1,1,0,1,0
26,110,110,8,8,0,1,0
46,110,110,2,2,0,1,0
3,116,116,27,27,0,1,0
15,123,123,14,14,0,1,0
16,125,125,2,2,0,1,0
11,132,132,9,9,0,1,0
6,141,141,5,1,4,2,1
33,143,143,9,3,6,2,1
31,146,146,7,1,6,3,2
39,204,204,17,1,16,2,1
45,205,205,25,25,0,1,0
18,210,210,6,3,3,2,1
43,213,213,17,17,0,1,0
10,221,221,2,2,0,1,0
7,226,226,16,16,0,1,0
44,255,255,42,42,0,1,0
17,270,270,9,4,5,2,1
9,277,277,1,1,0,1,0
1,287,287,18,18,0,1,0
8,288,288,72,72,0,1,0
27,291,291,9,9,0,1,0
5,318,318,44,5,39,2,1
12,326,326,44,20,24,4,3
29,326,326,1,1,0,1,0
34,330,330,87,87,0,1,0
24,355,355,16,16,0,1,0
40,356,356,65,49,16,3,2
38,384,384,155,145,10,3,2
32,385,385,9,4,5,2,1
13,392,392,13,6,7,2,1
22,397,397,42,8,34,2,1
37,403,403,15,10,5,2,1
30,406,406,43,43,0,1,0
35,412,412,40,40,0,1,0
21,426,426,19,19,0,1,0
25,437,437,19,19,0,1,0
36,454,454,6,6,0,1,0
23,454,454,1,1,0,1,0
41,461,461,24,24,0,1,0
28,472,472,81,61,20,2,1
14,472,472,67,31,36,2,1
20,479,479,8,8,0,1,0
19,479,479,36,36,0,1,0
4,483,483,77,5,72,4,3
42,498,498,42,42,0,1,0

31,100,100,4,4,0,1,0
4,108,108,12,1,11,2,1
7,109,109,21,21,0,1,0
41,113,113,24,24,0,1,0
18,114,114,14,14,0,1,0
38,133,133,11,7,4,2,1
24,144,144,2,2,0,1,0
15,145,145,1,1,0,1,0
16,157,157,5,5,0,1,0
12,158,158,2,2,0,1,0
32,166,166,7,7,0,1,0
5,168,168,6,3,3,2,1
21,183,183,6,1,5,2,1
27,197,197,3,3,0,1,0
40,214,214,34,34,0,1,0
8,222,222,2,2,0,1,0
0,223,223,10,1,9,2,1
14,254,254,85,85,0,1,0
39,263,263,3,3,0,1,0
13,297,297,100,30,70,3,2
1,298,298,42,42,0,1,0
42,309,309,26,20,6,3,2
35,323,323,31,31,0,1,0
3,333,333,7,1,6,2,1
37,351,351,175,82,93,4,3
29,359,359,109,109,0,1,0
11,368,368,43,8,35,2,1
22,376,376,7,2,5,2,1
44,383,383,25,25,0,1,0
20,387,387,20,20,0,1,0
43,402,402,17,7,10,2,1
6,414,414,18,3,15,4,3
17,417,417,24,24,0,1,0
45,422,422,26,6,20,3,2
33,436,436,54,15,39,4,3
26,447,447,2,2,0,1,0
2,449,449,1,1,0,1,0
28,454,454,54,9,45,4,3
19,456,456,4,4,0,1,0
25,460,460,2,2,0,1,0
9,470,470,77,77,0,1,0
23,474,474,1,1,0,1,0
34,475,475,18,18,0,1,0
30,484,484,6,6,0,1,0
36,486,486,16,16,0,1,0
10,491,491,41,41,0,1,0

17,111,111,6,6,0,1,0
34,155,155,10,10,0,1,0
27,155,155,6,6,0,1,0
37,161,161,15,15,0,1,0
11,163,163,16,16,0,1,0
0,170,170,20,11,9,2,1
3,184,184,22,22,0,1,0
26,199,199,10,4,6,2,1
29,203,203,6,6,0,1,0
25,203,203,31,31,0,1,0
19,246,246,22,22,0,1,0
28,249,249,58,42,16,2,1
36,271,271,33,33,0,1,0
33,273,273,26,26,0,1,0
2,275,275,10,10,0,1,0
18,301,301,31,11,20,3,2
20,303,303,2,2,0,1,0
31,305,305,36,36,0,1,0
21,309,309,6,1,5,2,1
4,312,312,26,26,0,1,0
22,321,321,9,9,0,1,0
15,325,325,28,6,22,3,2
10,325,325,32,32,0,1,0
1,336,336,17,17,0,1,0
9,342,342,47,31,16,3,2
5,349,349,22,22,0,1,0
12,353,353,15,15,0,1,0
38,358,358,125,125,0,1,0
32,363,363,38,8,30,2,1
13,367,367,33,7,26,3,2
7,389,389,22,1,21,4,3
42,396,396,19,9,10,3,2
16,416,416,165,132,33,3,2
23,417,417,35,35,0,1,0
39,418,418,26,6,20,3,2
35,437,437,117,112,5,2,1
14,440,440,17,17,0,1,0
40,461,461,13,5,8,2,1
6,483,483,70,70,0,1,0
41,485,485,10,2,8,3,2
24,488,488,21,21,0,1,0
30,490,490,15,3,12,4,3
8,496,496,20,6,14,3,2

2,101,101,11,11,0,1,0
10,101,101,4,4,0,1,0
9,111,111,17,11,6,3,2
13,114,114,20,14,6,3,2
6,116,116,1,1,0,1,0
7,149,149,2,2,0,1,0
23,170,170,3,3,0,1,0
22,179,179,17,17,0,1,0
36,195,195,29,14,15,4,3
33,198,198,48,48,0,1,0
5,208,208,74,74,0,1,0
31,212,212,21,6,15,3,2
25,221,221,111,111,0,1,0
34,237,237,15,6,9,2,1
21,241,241,16,8,8,2,1
27,259,259,27,27,0,1,0
4,271,271,14,14,0,1,0
15,281,281,77,19,58,3,2
28,328,328,28,20,8,3,2
20,340,340,72,53,19,2,1
17,349,349,23,23,0,1,0
11,350,350,27,27,0,1,0
14,355,355,16,1,15,4,3
35,356,356,7,7,0,1,0
37,360,360,52,11,41,4,3
8,374,374,9,9,0,1,0
0,404,404,16,3,13,3,2
18,407,407,8,4,4,2,1
3,408,408,138,38,100,3,2
1,412,412,25,25,0,1,0
19,434,434,10,10,0,1,0
29,447,447,30,30,0,1,0
24,467,467,32,32,0,1,0
26,477,477,3,3,0,1,0
32,477,477,6,6,0,1,0
12,477,477,31,31,0,1,0
16,491,491,51,9,42,4,3
30,496,496,16,8,8,3,2

17,104,104,8,8,0,1,0
6,113,113,12,12,0,1,0
8,118,118,8,5,3,2,1
13,126,126,39,14,25,2,1
1,161,161,67,67,0,1,0
2,162,162,1,1,0,1,0
18,164,164,4,1,3,2,1
24,193,193,25,25,0,1,0
16,205,205,65,65,0,1,0
20,236,236,18,7,11,2,1
7,240,240,3,3,0,1,0
0,290,290,28,8,20,3,2
31,300,300,48,18,30,4,3
27,303,303,65,18,47,2,1
29,307,307,14,14,0,1,0
3,311,311,24,3,21,4,3
23,314,314,2,2,0,1,0
35,325,325,20,9,11,2,1
34,327,327,17,17,0,1,0
26,335,335,35,6,29,2,1
15,339,339,20,3,17,2,1
12,346,346,74,74,0,1,0
10,354,354,4,4,0,1,0
28,362,362,52,52,0,1,0
22,363,363,84,84,0,1,0
11,367,367,75,39,36,3,2
30,400,400,58,17,41,2,1
19,415,415,13,1,12,4,3
4,422,422,24,24,0,1,0
33,436,436,60,29,31,4,3
32,445,445,19,5,14,2,1
9,460,460,6,6,0,1,0
25,473,473,23,23,0,1,0
36,474,474,16,7,9,4,3
21,484,484,128,64,64,3,2
5,490,490,16,1,15,2,1
14,491,491,2,2,0,1,0

16,104,104,6,6,0,1,0
11,111,111,3,3,0,1,0
2,128,128,15,15,0,1,0
17,134,134,5,5,0,1,0
33,146,146,3,3,0,1,0
4,172,172,5,5,0,1,0
27,173,173,24,24,0,1,0
30,174,174,7,3,4,2,1
19,195,195,23,23,0,1,0
1,197,197,12,1,11,2,1
10,202,202,27,1,26,3,2
31,210,210,12,12,0,1,0
14,215,215,12,8,4,2,1
28,228,228,18,3,15,4,3
3,232,232,38,21,17,2,1
35,237,237,17,17,0,1,0
15,249,249,86,86,0,1,0
26,265,265,70,70,0,1,0
22,269,269,9,6,3,2,1
41,274,274,2,2,0,1,0
29,275,275,41,41,0,1,0
32,276,276,10,10,0,1,0
23,282,282,30,6,24,2,1
37,283,283,19,19,0,1,0
21,289,289,35,16,19,2,1
9,292,292,45,15,30,3,2
18,314,314,25,16,9,2,1
20,316,316,1,1,0,1,0
5,324,324,35,31,4,2,1
12,332,332,5,5,0,1,0
43,348,348,24,24,0,1,0
34,349,349,3,3,0,1,0
24,371,371,44,29,15,4,3
36,395,395,49,49,0,1,0
39,406,406,61,49,12,4,3
8,425,425,43,5,38,3,2
40,428,428,187,64,123,4,3
13,434,434,16,16,0,1,0
25,436,436,22,4,18,2,1
0,439,439,10,2,8,3,2
42,457,457,24,12,12,3,2
7,469,469,25,5,20,3,2
38,486,486,43,43,0,1,0
6,493,493,10,10,0,1,0

9,115,115,22,2,20,3,2
28,117,117,1,1,0,1,0
3,128,128,1,1,0,1,0
10,130,130,1,1,0,1,0
32,134,134,11,3,8,3,2
14,136,136,2,2,0,1,0
8,148,148,58,43,15,4,3
2,162,162,27,27,0,1,0
31,165,165,23,1,22,2,1
19,168,168,3,3,0,1,0
0,195,195,1,1,0,1,0
25,211,211,2,2,0,1,0
30,227,227,11,11,0,1,0
15,240,240,51,51,0,1,0
20,241,241,21,21,0,1,0
29,249,249,23,23,0,1,0
22,259,259,7,3,4,2,1
27,281,281,82,4,78,4,3
23,294,294,34,4,30,2,1
17,320,320,52,7,45,2,1
7,323,323,85,85,0,1,0
33,324,324,36,24,12,4,3
12,341,341,74,12,62,3,2
11,359,359,38,14,24,2,1
4,363,363,29,29,0,1,0
18,377,377,3,3,0,1,0
16,397,397,5,5,0,1,0
5,397,397,46,46,0,1,0
21,420,420,41,41,0,1,0
1,423,423,158,158,0,1,0
13,431,431,29,17,12,4,3
6,445,445,4,4,0,1,0
26,454,454,144,12,132,4,3
24,480,480,90,90,0,1,0

25,111,111,8,8,0,1,0
24,112,112,5,5,0,1,0
42,132,132,2,2,0,1,0
36,135,135,18,18,0,1,0
13,155,155,11,11,0,1,0
23,159,159,24,6,18,3,2
31,161,161,2,2,0,1,0
41,166,166,10,10,0,1,0
33,172,172,16,6,10,3,2
21,179,179,7,1,6,3,2
17,179,179,17,17,0,1,0
7,187,187,47,47,0,1,0
19,191,191,12,12,0,1,0
29,210,210,43,43,0,1,0
16,221,221,17,8,9,4,3
5,228,228,2,2,0,1,0
39,230,230,48,48,0,1,0
8,231,231,38,38,0,1,0
28,240,240,11,11,0,1,0
38,257,257,8,2,6,3,2
1,260,260,9,9,0,1,0
11,266,266,1,1,0,1,0
35,296,296,17,9,8,3,2
26,297,297,18,18,0,1,0
12,303,303,14,14,0,1,0
6,310,310,10,10,0,1,0
14,316,316,13,13,0,1,0
27,317,317,43,43,0,1,0
34,317,317,6,6,0,1,0
0,335,335,1,1,0,1,0
20,337,337,58,58,0,1,0
10,352,352,66,66,0,1,0
22,364,364,51,51,0,1,0
3,375,375,49,10,39,4,3
15,377,377,54,54,0,1,0
18,382,382,2,2,0,1,0
37,395,395,35,35,0,1,0
30,395,395,147,67,80,4,3
2,400,400,26,5,21,2,1
32,410,410,58,47,11,2,1
4,434,434,22,22,0,1,0
9,473,473,84,4,80,3,2
40,486,486,51,51,0,1,0

28,122,122,5,5,0,1,0
42,124,124,22,22,0,1,0
44,140,140,7,7,0,1,0
16,155,155,6,6,0,1,0
6,156,156,11,11,0,1,0
29,157,157,24,16,8,3,2
38,158,158,16,16,0,1,0
30,158,158,13,2,11,2,1
34,168,168,64,64,0,1,0
14,169,169,32,32,0,1,0
8,170,170,5,5,0,1,0
2,196,196,4,4,0,1,0
17,199,199,23,23,0,1,0
32,229,229,1,1,0,1,0
35,236,236,29,29,0,1,0
3,245,245,9,9,0,1,0
4,254,254,15,9,6,2,1
11,278,278,21,15,6,2,1
0,278,278,47,47,0,1,0
20,284,284,7,7,0,1,0
10,313,313,25,25,0,1,0
37,315,315,21,17,4,2,1
12,326,326,1,1,0,1,0
39,333,333,63,37,26,2,1
23,333,333,6,6,0,1,0
36,342,342,57,33,24,4,3
27,343,343,6,6,0,1,0
45,347,347,26,26,0,1,0
18,354,354,12,2,10,3,2
15,357,357,56,56,0,1,0
25,360,360,31,31,0,1,0
5,367,367,1,1,0,1,0
26,367,367,5,5,0,1,0
43,375,375,1,1,0,1,0
24,392,392,69,39,30,2,1
7,398,398,71,71,0,1,0
21,418,418,17,12,5,2,1
1,431,431,22,22,0,1,0
9,434,434,70,70,0,1,0
41,440,440,28,28,0,1,0
19,446,446,35,17,18,4,3
33,450,450,32,32,0,1,0
46,455,455,52,52,0,1,0
22,467,467,35,35,0,1,0
31,477,477,16,7,9,4,3
40,487,487,59,59,0,1,0
13,488,488,9,9,0,1,0

28,107,107,4,4,0,1,0
40,119,119,9,2,7,2,1
39,160,160,16,16,0,1,0
5,162,162,9,9,0,1,0
29,163,163,13,8,5,2,1
15,168,168,7,7,0,1,0
21,169,169,6,6,0,1,0
19,177,177,39,39,0,1,0
10,177,177,48,48,0,1,0
26,184,184,3,3,0,1,0
38,194,194,79,29,50,2,1
11,195,195,13,2,11,3,2
35,206,206,9,9,0,1,0
33,210,210,2,2,0,1,0
31,242,242,23,7,16,2,1
36,244,244,4,4,0,1,0
25,255,255,33,9,24,4,3
34,265,265,6,6,0,1,0
13,278,278,24,24,0,1,0
37,286,286,43,43,0,1,0
3,300,300,5,5,0,1,0
30,306,306,17,14,3,2,1
8,315,315,43,43,0,1,0
22,315,315,58,58,0,1,0
12,339,339,38,24,14,2,1
2,339,339,22,22,0,1,0
1,341,341,15,15,0,1,0
9,350,350,19,4,15,2,1
23,361,361,16,11,5,2,1
32,367,367,5,2,3,2,1
43,371,371,57,57,0,1,0
27,372,372,43,43,0,1,0
7,386,386,12,12,0,1,0
14,389,389,26,26,0,1,0
20,392,392,26,23,3,2,1
24,395,395,3,3,0,1,0
6,401,401,1,1,0,1,0
16,415,415,2,2,0,1,0
0,426,426,45,45,0,1,0
41,449,449,82,35,47,2,1
18,461,461,67,67,0,1,0
4,467,467,39,39,0,1,0
17,473,473,25,25,0,1,0
42,475,475,88,88,0,1,0
44,497,497,80,37,43,4,3

21,132,132,5,5,0,1,0
19,148,148,27,22,5,2,1
10,160,160,40,30,10,3,2
12,161,161,19,11,8,3,2
18,178,178,16,11,5,2,1
0,190,190,22,15,7,2,1
5,195,195,25,25,0,1,0
16,212,212,5,5,0,1,0
33,220,220,9,9,0,1,0
4,245,245,1,1,0,1,0
28,248,248,16,16,0,1,0
9,249,249,29,29,0,1,0
11,251,251,32,32,0,1,0
15,261,261,19,7,12,2,1
27,262,262,8,2,6,2,1
7,269,269,16,10,6,3,2
2,272,272,33,23,10,3,2
34,283,283,12,1,11,2,1
36,287,287,114,80,34,3,2
38,295,295,74,74,0,1,0
14,300,300,25,25,0,1,0
6,307,307,7,7,0,1,0
23,311,311,28,28,0,1,0
1,334,334,25,16,9,4,3
13,338,338,24,16,8,2,1
30,348,348,23,14,9,2,1
32,349,349,73,73,0,1,0
22,370,370,65,46,19,2,1
20,372,372,22,8,14,3,2
24,374,374,15,15,0,1,0
8,380,380,87,82,5,2,1
25,383,383,61,16,45,2,1
3,391,391,102,39,63,3,2
26,411,411,14,14,0,1,0
31,483,483,43,43,0,1,0
29,489,489,15,1,14,3,2
37,490,490,7,7,0,1,0
35,492,492,7,7,0,1,0
17,498,498,16,6,10,2,1

18,100,100,3,3,0,1,0
27,112,112,18,18,0,1,0
36,134,134,1,1,0,1,0
44,135,135,7,4,3,2,1
40,137,137,3,3,0,1,0
25,144,144,1,1,0,1,0
22,147,147,2,2,0,1,0
35,176,176,34,13,21,4,3
28,181,181,14,7,7,2,1
15,190,190,1,1,0,1,0
14,197,197,29,19,10,3,2
17,206,206,46,46,0,1,0
1,213,213,21,21,0,1,0
16,215,215,4,4,0,1,0
45,219,219,26,20,6,3,2
42,233,233,47,31,16,2,1
43,233,233,40,17,23,3,2
24,253,253,1,1,0,1,0
30,264,264,19,15,4,2,1
8,279,279,27,15,12,4,3
26,280,280,15,15,0,1,0
46,294,294,8,8,0,1,0
5,298,298,8,2,6,2,1
31,312,312,92,24,68,4,3
2,321,321,18,9,9,4,3
6,322,322,20,20,0,1,0
7,326,326,59,59,0,1,0
4,338,338,62,24,38,3,2
38,341,341,5,5,0,1,0
3,342,342,1,1,0,1,0
37,343,343,21,21,0,1,0
33,377,377,5,5,0,1,0
23,378,378,33,33,0,1,0
19,382,382,96,23,73,4,3
0,406,406,72,47,25,2,1
20,409,409,41,9,32,2,1
11,428,428,17,3,14,2,1
13,435,435,10,10,0,1,0
41,445,445,3,3,0,1,0
39,445,445,1,1,0,1,0
12,450,450,1,1,0,1,0
9,462,462,18,10,8,2,1
21,471,471,7,7,0,1,0
34,472,472,77,77,0,1,0
10,484,484,27,27,0,1,0
32,494,494,179,131,48,2,1
29,496,496,7,1,6,3,2

8,114,114,1,1,0,1,0
0,125,125,10,10,0,1,0
25,136,136,1,1,0,1,0
22,141,141,9,9,0,1,0
11,141,141,11,2,9,4,3
9,144,144,1,1,0,1,0
1,149,149,83,83,0,1,0
13,151,151,2,2,0,1,0
24,164,164,11,11,0,1,0
15,167,167,43,13,30,4,3
27,185,185,10,10,0,1,0
6,193,193,12,12,0,1,0
34,193,193,31,31,0,1,0
16,198,198,1,1,0,1,0
12,199,199,5,5,0,1,0
31,211,211,20,20,0,1,0
10,221,221,62,62,0,1,0
5,231,231,30,30,0,1,0
3,275,275,28,6,22,3,2
17,290,290,6,2,4,2,1
32,310,310,17,17,0,1,0
29,318,318,82,21,61,4,3
36,321,321,17,17,0,1,0
23,329,329,142,112,30,4,3
20,356,356,1,1,0,1,0
2,360,360,25,25,0,1,0
30,367,367,1,1,0,1,0
21,381,381,61,21,40,2,1
7,382,382,20,20,0,1,0
37,391,391,61,61,0,1,0
4,400,400,12,12,0,1,0
18,414,414,7,3,4,2,1
14,419,419,93,93,0,1,0
33,424,424,17,17,0,1,0
19,455,455,43,8,35,4,3
35,473,473,71,71,0,1,0
26,480,480,81,27,54,4,3
28,485,485,1,1,0,1,0

37,119,119,14,6,8,2,1
30,135,135,8,8,0,1,0
26,143,143,23,23,0,1,0
27,145,145,1,1,0,1,0
29,170,170,10,4,6,3,2
0,206,206,15,1,14,2,1
20,216,216,54,54,0,1,0
13,217,217,12,12,0,1,0
25,224,224,32,32,0,1,0
16,239,239,1,1,0,1,0
22,241,241,23,23,0,1,0
28,244,244,5,2,3,2,1
33,246,246,6,6,0,1,0
15,264,264,18,18,0,1,0
17,272,272,10,10,0,1,0
7,278,278,33,33,0,1,0
1,291,291,27,3,24,3,2
35,294,294,43,19,24,4,3
34,301,301,13,13,0,1,0
4,308,308,53,41,12,3,2
21,333,333,47,17,30,3,2
2,334,334,43,43,0,1,0
31,345,345,17,3,14,3,2
6,355,355,9,2,7,2,1
36,355,355,74,74,0,1,0
19,378,378,38,3,35,4,3
12,378,378,38,15,23,2,1
8,380,380,12,12,0,1,0
5,381,381,58,6,52,3,2
10,386,386,25,25,0,1,0
32,393,393,10,10,0,1,0
18,419,419,17,17,0,1,0
24,438,438,88,7,81,4,3
9,441,441,4,4,0,1,0
11,467,467,205,154,51,4,3
23,472,472,74,74,0,1,0
14,476,476,49,28,21,2,1
3,483,483,157,127,30,4,3

23,124,124,4,4,0,1,0
31,127,127,3,3,0,1,0
24,128,128,35,4,31,2,1
26,130,130,2,2,0,1,0
38,138,138,4,1,3,2,1
2,139,139,15,15,0,1,0
25,140,140,1,1,0,1,0
35,142,142,1,1,0,1,0
12,143,143,15,3,12,3,2
30,150,150,8,1,7,2,1
4,158,158,1,1,0,1,0
9,159,159,20,20,0,1,0
15,184,184,7,4,3,2,1
46,188,188,13,13,0,1,0
43,189,189,61,48,13,2,1
16,190,190,5,5,0,1,0
42,193,193,60,23,37,3,2
27,194,194,8,8,0,1,0
21,213,213,11,11,0,1,0
47,214,214,22,22,0,1,0
41,216,216,15,2,13,2,1
19,217,217,18,2,16,2,1
36,220,220,65,65,0,1,0
39,255,255,30,1,29,2,1
45,269,269,29,29,0,1,0
37,273,273,22,9,13,2,1
40,274,274,20,20,0,1,0
8,277,277,8,8,0,1,0
48,288,288,3,3,0,1,0
11,298,298,10,1,9,4,3
22,302,302,5,1,4,2,1
18,326,326,64,64,0,1,0
6,330,330,37,7,30,4,3
20,339,339,1,1,0,1,0
32,353,353,8,8,0,1,0
44,361,361,8,8,0,1,0
10,367,367,68,28,40,2,1
17,372,372,51,23,28,2,1
33,391,391,4,1,3,2,1
14,391,391,8,3,5,2,1
29,392,392,91,15,76,4,3
7,409,409,47,47,0,1,0
3,420,420,7,7,0,1,0
0,428,428,26,26,0,1,0
34,458,458,37,37,0,1,0
28,468,468,25,5,20,3,2
13,483,483,22,22,0,1,0
5,484,484,19,5,14,2,1
1,489,489,12,12,0,1,0

16,106,106,3,3,0,1,0
27,112,112,1,1,0,1,0
34,131,131,8,8,0,1,0
17,175,175,11,7,4,2,1
0,185,185,25,25,0,1,0
11,187,187,80,8,72,4,3
32,210,210,30,26,4,2,1
3,222,222,20,20,0,1,0
6,229,229,9,9,0,1,0
24,271,271,18,13,5,2,1
15,286,286,12,7,5,2,1
25,290,290,28,28,0,1,0
8,292,292,19,8,11,2,1
20,304,304,44,32,12,4,3
35,310,310,1,1,0,1,0
5,314,314,73,18,55,3,2
21,322,322,5,5,0,1,0
1,324,324,8,8,0,1,0
10,327,327,90,27,63,4,3
30,333,333,90,66,24,4,3
23,340,340,89,89,0,1,0
2,341,341,17,17,0,1,0
4,349,349,68,7,61,3,2
26,351,351,33,3,30,2,1
19,382,382,64,64,0,1,0
18,391,391,34,34,0,1,0
33,404,404,25,10,15,2,1
12,404,404,27,27,0,1,0
13,405,405,65,19,46,4,3
14,407,407,54,54,0,1,0
28,425,425,165,65,100,3,2
9,428,428,14,10,4,2,1
22,475,475,4,4,0,1,0
7,477,477,16,9,7,2,1
29,484,484,16,16,0,1,0
31,489,489,17,17,0,1,0

33,110,110,50,29,21,2,1
4,121,121,11,11,0,1,0
29,122,122,17,17,0,1,0
19,124,124,3,3,0,1,0
11,130,130,16,4,12,4,3
22,130,130,19,19,0,1,0
9,140,140,8,1,7,2,1
31,149,149,2,2,0,1,0
37,151,151,25,10,15,2,1
0,155,155,1,1,0,1,0
27,163,163,16,2,14,2,1
3,166,166,20,20,0,1,0
36,178,178,1,1,0,1,0
14,188,188,68,68,0,1,0
26,195,195,15,6,9,2,1
39,196,196,9,9,0,1,0
8,210,210,2,2,0,1,0
32,213,213,6,6,0,1,0
23,214,214,12,9,3,2,1
34,226,226,1,1,0,1,0
28,227,227,43,43,0,1,0
18,227,227,16,16,0,1,0
10,240,240,34,4,30,3,2
25,265,265,19,19,0,1,0
6,278,278,22,22,0,1,0
2,282,282,37,37,0,1,0
35,297,297,111,102,9,4,3
41,328,328,18,18,0,1,0
42,333,333,18,18,0,1,0
15,338,338,15,7,8,3,2
13,339,339,49,49,0,1,0
12,342,342,47,33,14,2,1
16,343,343,21,3,18,4,3
17,369,369,23,7,16,2,1
40,379,379,21,21,0,1,0
38,392,392,37,28,9,4,3
20,394,394,20,20,0,1,0
1,403,403,13,13,0,1,0
24,413,413,4,4,0,1,0
7,415,415,17,5,12,2,1
21,427,427,2,2,0,1,0
43,438,438,3,3,0,1,0
5,448,448,2,2,0,1,0
30,454,454,43,35,8,3,2

1,109,109,9,9,0,1,0
32,130,130,2,2,0,1,0
40,157,157,7,7,0,1,0
24,184,184,22,2,20,3,2
10,194,194,33,17,16,3,2
15,199,199,1,1,0,1,0
20,212,212,39,39,0,1,0
36,213,213,28,28,0,1,0
0,220,220,27,27,0,1,0
29,224,224,13,13,0,1,0
9,234,234,18,18,0,1,0
3,240,240,50,5,45,2,1
39,246,246,48,48,0,1,0
2,249,249,7,3,4,2,1
13,252,252,16,16,0,1,0
33,253,253,11,3,8,2,1
45,262,262,21,12,9,2,1
19,267,267,3,3,0,1,0
43,268,268,26,14,12,4,3
42,272,272,47,47,0,1,0
38,276,276,20,20,0,1,0
26,279,279,56,22,34,3,2
4,288,288,11,11,0,1,0
23,292,292,25,25,0,1,0
30,297,297,38,38,0,1,0
12,303,303,10,10,0,1,0
18,320,320,1,1,0,1,0
8,324,324,29,29,0,1,0
6,334,334,41,32,9,4,3
17,335,335,14,14,0,1,0
35,336,336,12,12,0,1,0
37,347,347,38,38,0,1,0
5,417,417,2,2,0,1,0
44,421,421,88,88,0,1,0
21,425,425,40,40,0,1,0
41,426,426,35,14,21,4,3
34,430,430,29,29,0,1,0
25,435,435,9,9,0,1,0
14,441,441,40,8,32,3,2
7,442,442,9,2,7,2,1
27,444,444,71,17,54,4,3
31,456,456,63,31,32,3,2
11,465,465,106,15,91,4,3
22,469,469,19,19,0,1,0
16,484,484,8,8,0,1,0
28,489,489,1,1,0,1,0

6,129,129,4,4,0,1,0
26,156,156,14,2,12,4,3
43,158,158,14,14,0,1,0
38,162,162,18,18,0,1,0
23,170,170,1,1,0,1,0
14,187,187,21,21,0,1,0
0,190,190,12,12,0,1,0
19,195,195,29,29,0,1,0
17,199,199,26,15,11,2,1
5,213,213,26,11,15,2,1
13,224,224,1,1,0,1,0
18,259,259,10,1,9,2,1
15,267,267,8,5,3,2,1
25,272,272,14,14,0,1,0
20,276,276,7,3,4,2,1
40,283,283,18,18,0,1,0
27,296,296,32,32,0,1,0
30,297,297,10,7,3,2,1
42,298,298,35,35,0,1,0
41,301,301,107,87,20,2,1
28,311,311,68,68,0,1,0
16,333,333,1,1,0,1,0
36,344,344,1,1,0,1,0
39,344,344,79,79,0,1,0
21,349,349,83,83,0,1,0
11,374,374,6,6,0,1,0
1,378,378,12,12,0,1,0
2,386,386,55,8,47,4,3
29,393,393,39,39,0,1,0
24,398,398,11,11,0,1,0
34,409,409,12,12,0,1,0
33,410,410,3,3,0,1,0
37,416,416,26,26,0,1,0
7,421,421,134,89,45,4,3
32,441,441,78,18,60,3,2
35,442,442,38,17,21,2,1
9,452,452,27,27,0,1,0
44,453,453,39,25,14,2,1
22,458,458,44,44,0,1,0
3,461,461,1,1,0,1,0
8,485,485,40,4,36,3,2
4,489,489,94,63,31,3,2
31,492,492,7,7,0,1,0
12,498,498,38,38,0,1,0
10,500,500,1,1,0,1,0

26,104,104,20,8,12,4,3
13,114,114,1,1,0,1,0
16,121,121,6,3,3,2,1
38,124,124,7,1,6,2,1
36,130,130,1,1,0,1,0
5,142,142,20,20,0,1,0
14,149,149,1,1,0,1,0
25,157,157,13,13,0,1,0
22,185,185,5,2,3,2,1
24,186,186,35,15,20,3,2
31,190,190,1,1,0,1,0
33,191,191,6,6,0,1,0
35,197,197,4,4,0,1,0
3,209,209,17,17,0,1,0
9,215,215,24,24,0,1,0
40,229,229,3,3,0,1,0
39,237,237,18,18,0,1,0
28,248,248,13,13,0,1,0
12,255,255,7,2,5,2,1
7,273,273,2,2,0,1,0
0,300,300,29,4,25,2,1
37,314,314,116,41,75,4,3
34,319,319,35,27,8,2,1
4,332,332,23,23,0,1,0
30,334,334,109,25,84,3,2
23,337,337,19,19,0,1,0
10,346,346,89,89,0,1,0
15,358,358,42,42,0,1,0
20,372,372,12,7,5,2,1
6,375,375,12,9,3,2,1
27,378,378,25,11,14,3,2
17,425,425,94,94,0,1,0
11,429,429,27,27,0,1,0
29,434,434,77,2,75,4,3
2,457,457,8,8,0,1,0
18,463,463,84,26,58,3,2
8,472,472,9,4,5,2,1
1,478,478,29,13,16,3,2
41,483,483,36,36,0,1,0
32,488,488,59,59,0,1,0
21,493,493,35,17,18,3,2
19,497,497,163,163,0,1,0

7,103,103,1,1,0,1,0
20,109,109,39,39,0,1,0
31,133,133,2,2,0,1,0
12,137,137,7,1,6,3,2
13,142,142,31,7,24,4,3
2,151,151,36,36,0,1,0
34,153,153,13,1,12,2,1
37,158,158,10,3,7,2,1
23,169,169,41,26,15,4,3
27,176,176,3,3,0,1,0
19,177,177,56,44,12,4,3
35,187,187,1,1,0,1,0
24,210,210,13,1,12,4,3
30,212,212,37,1,36,3,2
21,218,218,26,26,0,1,0
17,235,235,12,12,0,1,0
15,240,240,10,3,7,3,2
25,247,247,8,1,7,2,1
4,248,248,49,49,0,1,0
33,252,252,18,5,13,2,1
22,262,262,10,10,0,1,0
10,265,265,103,103,0,1,0
6,267,267,22,22,0,1,0
0,277,277,17,7,10,2,1
8,299,299,4,4,0,1,0
26,318,318,55,27,28,2,1
18,326,326,40,13,27,4,3
38,333,333,21,21,0,1,0
36,346,346,20,10,10,3,2
3,358,358,45,14,31,2,1
32,410,410,32,11,21,4,3
28,438,438,2,2,0,1,0
1,442,442,46,18,28,2,1
11,449,449,78,8,70,4,3
29,455,455,34,14,20,3,2
5,455,455,2,2,0,1,0
14,469,469,25,12,13,2,1
9,478,478,6,1,5,2,1
16,479,479,24,24,0,1,0

14,125,125,1,1,0,1,0
17,137,137,3,3,0,1,0
32,139,139,3,3,0,1,0
15,148,148,28,13,15,4,3
34,149,149,23,23,0,1,0
1,160,160,5,5,0,1,0
0,166,166,41,41,0,1,0
10,187,187,10,6,4,2,1
2,196,196,12,3,9,2,1
20,202,202,31,3,28,3,2
27,206,206,3,3,0,1,0
31,213,213,5,2,3,2,1
22,218,218,23,23,0,1,0
19,222,222,7,7,0,1,0
9,230,230,10,10,0,1,0
8,241,241,26,26,0,1,0
12,257,257,81,81,0,1,0
23,269,269,59,59,0,1,0
26,280,280,10,3,7,2,1
4,291,291,20,20,0,1,0
13,297,297,67,57,10,2,1
36,301,301,43,21,22,3,2
29,306,306,41,41,0,1,0
18,307,307,57,33,24,2,1
33,313,313,51,40,11,2,1
25,338,338,52,19,33,4,3
11,349,349,84,69,15,2,1
35,363,363,56,56,0,1,0
5,376,376,2,2,0,1,0
7,379,379,51,47,4,2,1
24,395,395,57,57,0,1,0
21,404,404,5,5,0,1,0
16,411,411,66,66,0,1,0
30,411,411,12,12,0,1,0
6,417,417,37,21,16,2,1
28,458,458,37,8,29,2,1
3,465,465,1,1,0,1,0
37,493,493,38,4,34,3,2

6,107,107,11,11,0,1,0
25,111,111,43,25,18,2,1
5,117,117,27,7,20,3,2
3,122,122,1,1,0,1,0
1,130,130,57,57,0,1,0
2,149,149,2,2,0,1,0
37,173,173,46,46,0,1,0
4,193,193,16,13,3,2,1
21,194,194,25,2,23,2,1
22,204,204,6,6,0,1,0
14,205,205,3,3,0,1,0
7,232,232,29,29,0,1,0
29,259,259,3,3,0,1,0
20,268,268,46,46,0,1,0
38,269,269,3,3,0,1,0
31,269,269,41,31,10,2,1
40,272,272,8,8,0,1,0
10,289,289,1,1,0,1,0
15,294,294,42,42,0,1,0
32,301,301,33,18,15,2,1
18,317,317,38,38,0,1,0
34,318,318,25,25,0,1,0
11,332,332,24,20,4,2,1
16,367,367,20,20,0,1,0
36,371,371,7,1,6,2,1
0,382,382,19,13,6,2,1
13,386,386,45,29,16,3,2
19,392,392,18,14,4,2,1
26,401,401,6,2,4,2,1
27,417,417,26,26,0,1,0
30,420,420,10,7,3,2,1
8,445,445,21,21,0,1,0
39,450,450,86,17,69,4,3
17,455,455,19,19,0,1,0
23,464,464,33,10,23,2,1
33,467,467,134,119,15,4,3
28,474,474,33,8,25,2,1
35,475,475,10,4,6,3,2
12,478,478,43,11,32,4,3
24,481,481,34,6,28,4,3
9,493,493,14,14,0,1,0

17,103,103,4,1,3,2,1
27,103,103,3,3,0,1,0
7,115,115,10,10,0,1,0
24,121,121,5,5,0,1,0
22,126,126,24,24,0,1,0
33,140,140,9,1,8,3,2
12,141,141,1,1,0,1,0
42,142,142,55,36,19,2,1
38,143,143,8,2,6,3,2
13,178,178,5,5,0,1,0
29,191,191,4,4,0,1,0
16,197,197,27,27,0,1,0
28,207,207,13,10,3,2,1
21,213,213,1,1,0,1,0
11,216,216,18,18,0,1,0
10,216,216,6,6,0,1,0
1,217,217,3,3,0,1,0
8,223,223,24,18,6,2,1
5,231,231,25,4,21,3,2
19,252,252,4,4,0,1,0
0,254,254,18,9,9,4,3
25,256,256,42,15,27,2,1
32,272,272,6,3,3,2,1
31,275,275,2,2,0,1,0
14,276,276,1,1,0,1,0
34,285,285,7,7,0,1,0
15,291,291,20,20,0,1,0
4,297,297,28,28,0,1,0
9,308,308,105,105,0,1,0
41,316,316,9,2,7,2,1
30,316,316,15,12,3,2,1
20,316,316,55,40,15,2,1
36,322,322,18,4,14,3,2
43,323,323,8,8,0,1,0
18,336,336,4,4,0,1,0
3,341,341,56,14,42,2,1
23,354,354,6,3,3,2,1
37,384,384,108,3,105,4,3
35,425,425,116,17,99,4,3
39,425,425,55,15,40,3,2
26,435,435,115,57,58,4,3
2,468,468,15,15,0,1,0
40,478,478,30,30,0,1,0
6,480,480,84,64,20,2,1

8,110,110,1,1,0,1,0
21,112,112,2,2,0,1,0
24,120,120,1,1,0,1,0
10,129,129,19,19,0,1,0
28,138,138,9,3,6,2,1
3,159,159,20,20,0,1,0
19,159,159,9,9,0,1,0
11,176,176,19,11,8,2,1
25,189,189,39,26,13,2,1
27,192,192,2,2,0,1,0
5,192,192,33,23,10,3,2
15,236,236,29,21,8,2,1
22,237,237,8,8,0,1,0
12,244,244,8,8,0,1,0
26,265,265,18,18,0,1,0
6,266,266,28,28,0,1,0
16,268,268,37,1,36,4,3
17,268,268,29,29,0,1,0
36,270,270,11,11,0,1,0
35,289,289,155,85,70,4,3
34,305,305,24,24,0,1,0
4,320,320,15,15,0,1,0
13,329,329,21,21,0,1,0
31,330,330,22,12,10,3,2
30,349,349,44,17,27,2,1
33,361,361,12,7,5,2,1
32,370,370,19,19,0,1,0
14,388,388,82,71,11,2,1
18,397,397,32,32,0,1,0
23,399,399,48,32,16,2,1
2,412,412,39,39,0,1,0
1,415,415,4,4,0,1,0
20,424,424,76,22,54,3,2
9,443,443,50,50,0,1,0
29,455,455,71,65,6,3,2
0,464,464,12,5,7,2,1
7,466,466,221,176,45,4,3

25,115,115,12,12,0,1,0
0,119,119,1,1,0,1,0
26,121,121,14,14,0,1,0
19,126,126,4,1,3,2,1
10,128,128,4,4,0,1,0
33,141,141,14,14,0,1,0
38,142,142,11,11,0,1,0
6,144,144,1,1,0,1,0
27,149,149,18,8,10,2,1
23,158,158,3,3,0,1,0
32,183,183,11,11,0,1,0
36,187,187,21,13,8,2,1
18,198,198,11,11,0,1,0
12,202,202,41,41,0,1,0
9,216,216,33,33,0,1,0
21,236,236,36,18,18,3,2
17,236,236,7,7,0,1,0
14,247,247,20,20,0,1,0
11,247,247,8,8,0,1,0
31,248,248,87,87,0,1,0
15,259,259,53,53,0,1,0
30,292,292,70,28,42,2,1
40,302,302,42,3,39,2,1
5,308,308,59,30,29,2,1
16,325,325,34,9,25,2,1
29,326,326,6,6,0,1,0
8,330,330,25,25,0,1,0
20,364,364,1,1,0,1,0
3,368,368,36,15,21,4,3
1,382,382,8,8,0,1,0
13,383,383,68,12,56,3,2
7,391,391,81,36,45,2,1
4,401,401,16,16,0,1,0
2,429,429,40,40,0,1,0
35,437,437,27,27,0,1,0
28,439,439,48,12,36,3,2
34,440,440,20,20,0,1,0
22,441,441,62,2,60,3,2
24,444,444,11,11,0,1,0
39,452,452,14,14,0,1,0
41,458,458,27,27,0,1,0
37,476,476,52,44,8,2,1

6,100,100,9,9,0,1,0
17,105,105,4,1,3,2,1
23,117,117,22,6,16,2,1
0,118,118,1,1,0,1,0
9,129,129,18,9,9,4,3
3,151,151,3,3,0,1,0
5,162,162,5,1,4,2,1
24,183,183,14,14,0,1,0
18,189,189,6,6,0,1,0
40,190,190,21,21,0,1,0
46,191,191,10,4,6,3,2
28,200,200,31,13,18,3,2
32,201,201,57,39,18,4,3
22,202,202,3,3,0,1,0
44,217,217,1,1,0,1,0
15,222,222,8,2,6,3,2
20,229,229,7,7,0,1,0
25,233,233,47,47,0,1,0
19,237,237,2,2,0,1,0
35,243,243,55,7,48,4,3
14,247,247,9,9,0,1,0
2,256,256,4,4,0,1,0
42,278,278,4,4,0,1,0
33,278,278,51,51,0,1,0
13,291,291,8,3,5,2,1
37,294,294,26,18,8,2,1
16,296,296,50,50,0,1,0
8,299,299,19,9,10,2,1
45,305,305,62,11,51,4,3
47,309,309,29,29,0,1,0
48,347,347,36,36,0,1,0
21,363,363,1,1,0,1,0
36,368,368,11,2,9,4,3
12,372,372,3,3,0,1,0
38,372,372,74,8,66,4,3
29,376,376,22,22,0,1,0
4,380,380,28,14,14,3,2
34,385,385,35,5,30,4,3
26,402,402,92,44,48,2,1
43,426,426,10,5,5,2,1
39,434,434,29,11,18,2,1
1,435,435,15,15,0,1,0
41,444,444,44,44,0,1,0
27,454,454,1,1,0,1,0
30,463,463,3,3,0,1,0
10,471,471,84,52,32,3,2
31,478,478,46,46,0,1,0
11,479,479,42,10,32,3,2
7,490,490,2,2,0,1,0

21,109,109,14,14,0,1,0
4,119,119,1,1,0,1,0
23,122,122,6,6,0,1,0
1,136,136,5,1,4,2,1
32,159,159,16,16,0,1,0
25,170,170,44,44,0,1,0
19,171,171,25,25,0,1,0
13,171,171,16,16,0,1,0
16,176,176,3,3,0,1,0
22,180,180,5,5,0,1,0
17,182,182,61,61,0,1,0
12,184,184,16,16,0,1,0
7,186,186,137,12,125,4,3
27,215,215,8,2,6,3,2
3,225,225,4,4,0,1,0
28,248,248,7,7,0,1,0
9,281,281,41,15,26,2,1
30,282,282,72,72,0,1,0
11,306,306,38,26,12,2,1
18,315,315,26,26,0,1,0
5,336,336,29,29,0,1,0
26,353,353,64,53,11,2,1
20,362,362,6,6,0,1,0
6,387,387,125,87,38,3,2
24,388,388,12,12,0,1,0
2,401,401,96,69,27,4,3
0,406,406,44,44,0,1,0
8,455,455,5,1,4,2,1
10,458,458,35,15,20,3,2
29,475,475,22,7,15,2,1
14,475,475,62,48,14,3,2
31,493,493,3,3,0,1,0
15,494,494,32,32,0,1,0

32,116,116,4,4,0,1,0
30,132,132,17,4,13,2,1
29,137,137,9,9,0,1,0
8,142,142,11,3,8,2,1
27,158,158,2,2,0,1,0
23,167,167,38,6,32,4,3
5,178,178,36,6,30,4,3
6,178,178,15,3,12,3,2
22,184,184,5,1,4,2,1
9,205,205,59,29,30,2,1
34,213,213,64,64,0,1,0
28,230,230,10,10,0,1,0
1,238,238,6,6,0,1,0
13,248,248,10,10,0,1,0
12,256,256,16,3,13,3,2
20,258,258,14,4,10,3,2
15,263,263,36,36,0,1,0
17,281,281,48,14,34,2,1
26,282,282,15,15,0,1,0
16,285,285,2,2,0,1,0
25,285,285,42,6,36,3,2
18,287,287,12,12,0,1,0
19,287,287,7,1,6,2,1
4,304,304,135,37,98,4,3
14,341,341,45,45,0,1,0
31,372,372,51,29,22,3,2
0,405,405,16,2,14,2,1
33,428,428,158,80,78,4,3
3,438,438,99,99,0,1,0
24,441,441,23,6,17,2,1
7,449,449,111,27,84,4,3
10,454,454,28,4,24,4,3
2,472,472,31,21,10,2,1
21,484,484,7,7,0,1,0
11,494,494,2,2,0,1,0

31,100,100,8,8,0,1,0
38,111,111,13,13,0,1,0
0,115,115,2,2,0,1,0
10,121,121,2,2,0,1,0
5,145,145,15,4,11,2,1
14,151,151,9,9,0,1,0
22,157,157,11,11,0,1,0
39,162,162,5,5,0,1,0
2,183,183,7,7,0,1,0
30,185,185,4,4,0,1,0
35,193,193,15,15,0,1,0
26,194,194,32,32,0,1,0
25,204,204,34,34,0,1,0
41,211,211,10,7,3,2,1
34,218,218,2,2,0,1,0
3,232,232,37,37,0,1,0
12,249,249,3,3,0,1,0
16,257,257,40,40,0,1,0
17,257,257,7,7,0,1,0
6,260,260,12,1,11,2,1
43,261,261,33,6,27,4,3
1,264,264,24,24,0,1,0
37,267,267,98,98,0,1,0
42,287,287,3,3,0,1,0
29,322,322,24,24,0,1,0
8,335,335,67,67,0,1,0
32,361,361,35,35,0,1,0
9,386,386,6,6,0,1,0
27,386,386,54,12,42,3,2
23,386,386,21,21,0,1,0
33,391,391,33,26,7,2,1
18,395,395,114,95,19,2,1
19,398,398,13,13,0,1,0
13,398,398,22,12,10,3,2
36,433,433,80,52,28,2,1
28,447,447,27,4,23,2,1
4,455,455,38,38,0,1,0
7,456,456,21,13,8,3,2
11,465,465,38,38,0,1,0
15,466,466,1,1,0,1,0
21,472,472,69,14,55,4,3
20,481,481,62,12,50,2,1
40,491,491,27,3,24,3,2
24,496,496,34,34,0,1,0
44,498,498,69,1,68,3,2

24,109,109,58,58,0,1,0
33,131,131,13,2,11,2,1
3,153,153,10,10,0,1,0
26,154,154,2,2,0,1,0
10,161,161,10,10,0,1,0
15,162,162,1,1,0,1,0
4,174,174,1,1,0,1,0
16,176,176,67,40,27,2,1
20,183,183,53,45,8,3,2
28,192,192,12,9,3,2,1
22,208,208,35,17,18,3,2
12,214,214,11,4,7,3,2
23,238,238,13,3,10,3,2
9,250,250,14,10,4,2,1
17,258,258,6,6,0,1,0
7,264,264,19,4,15,2,1
36,265,265,35,22,13,2,1
27,272,272,11,11,0,1,0
30,309,309,2,2,0,1,0
8,328,328,3,3,0,1,0
5,343,343,47,29,18,4,3
2,355,355,23,14,9,2,1
0,357,357,167,44,123,4,3
32,370,370,39,7,32,3,2
34,373,373,31,31,0,1,0
14,391,391,75,75,0,1,0
13,393,393,15,15,0,1,0
11,395,395,82,18,64,3,2
21,396,396,1,1,0,1,0
19,415,415,6,6,0,1,0
18,426,426,46,3,43,2,1
1,435,435,27,3,24,4,3
6,444,444,55,17,38,2,1
29,445,445,26,26,0,1,0
25,462,462,36,36,0,1,0
31,465,465,44,44,0,1,0
35,470,470,32,32,0,1,0

33,107,107,4,4,0,1,0
35,109,109,1,1,0,1,0
7,112,112,2,2,0,1,0
30,117,117,8,8,0,1,0
2,140,140,1,1,0,1,0
20,154,154,39,39,0,1,0
10,178,178,3,3,0,1,0
15,178,178,23,14,9,2,1
14,197,197,23,6,17,2,1
32,201,201,17,5,12,3,2
23,211,211,9,9,0,1,0
17,237,237,18,9,9,2,1
11,245,245,2,2,0,1,0
6,254,254,19,19,0,1,0
40,263,263,14,7,7,2,1
18,273,273,19,10,9,3,2
25,293,293,100,19,81,4,3
38,307,307,28,28,0,1,0
29,308,308,17,17,0,1,0
39,314,314,31,21,10,2,1
8,317,317,110,53,57,4,3
31,331,331,22,22,0,1,0
28,333,333,35,35,0,1,0
24,333,333,36,36,0,1,0
5,345,345,9,6,3,2,1
21,348,348,60,60,0,1,0
13,349,349,9,9,0,1,0
41,361,361,64,64,0,1,0
1,363,363,40,40,0,1,0
26,376,376,81,81,0,1,0
27,377,377,44,6,38,2,1
4,427,427,49,21,28,2,1
0,427,427,63,63,0,1,0
12,428,428,27,13,14,3,2
3,432,432,13,13,0,1,0
37,439,439,8,2,6,3,2
16,442,442,1,1,0,1,0
19,455,455,1,1,0,1,0
9,465,465,89,89,0,1,0
36,483,483,86,6,80,3,2
22,488,488,14,14,0,1,0
34,492,492,66,66,0,1,0

8,112,112,30,16,14,3,2
30,131,131,5,5,0,1,0
12,170,170,19,19,0,1,0
36,172,172,15,15,0,1,0
2,188,188,1,1,0,1,0
18,218,218,7,7,0,1,0
11,219,219,6,6,0,1,0
19,232,232,27,11,16,3,2
3,234,234,57,57,0,1,0
21,252,252,34,34,0,1,0
32,266,266,50,15,35,2,1
15,283,283,166,134,32,2,1
7,286,286,39,24,15,2,1
4,294,294,43,43,0,1,0
23,299,299,41,41,0,1,0
24,303,303,4,4,0,1,0
14,317,317,6,6,0,1,0
31,334,334,20,2,18,4,3
20,339,339,32,5,27,2,1
35,353,353,105,44,61,4,3
5,354,354,17,17,0,1,0
27,370,370,44,44,0,1,0
28,373,373,5,5,0,1,0
34,384,384,52,52,0,1,0
17,408,408,6,6,0,1,0
10,411,411,7,1,6,2,1
25,411,411,69,69,0,1,0
0,421,421,28,10,18,2,1
33,430,430,24,4,20,3,2
13,456,456,33,33,0,1,0
26,457,457,40,40,0,1,0
1,462,462,6,2,4,2,1
6,466,466,4,4,0,1,0
9,482,482,95,69,26,3,2
22,489,489,109,40,69,4,3
29,499,499,11,11,0,1,0
16,499,499,17,2,15,4,3

29,110,110,24,8,16,3,2
6,132,132,19,4,15,2,1
32,137,137,2,2,0,1,0
2,144,144,2,2,0,1,0
1,145,145,17,11,6,2,1
13,151,151,16,7,9,4,3
18,153,153,9,1,8,3,2
25,159,159,25,25,0,1,0
10,161,161,6,2,4,2,1
5,180,180,10,10,0,1,0
3,182,182,3,3,0,1,0
35,182,182,1,1,0,1,0
24,182,182,12,12,0,1,0
12,222,222,5,1,4,2,1
27,245,245,3,3,0,1,0
41,251,251,39,39,0,1,0
17,259,259,46,30,16,3,2
38,269,269,15,7,8,3,2
22,270,270,109,81,28,4,3
8,285,285,46,46,0,1,0
43,293,293,6,6,0,1,0
14,294,294,25,12,13,2,1
37,325,325,18,4,14,2,1
0,345,345,25,13,12,4,3
23,365,365,16,1,15,3,2
28,367,367,157,157,0,1,0
42,370,370,19,19,0,1,0
39,371,371,74,65,9,2,1
15,381,381,56,56,0,1,0
31,390,390,6,6,0,1,0
30,394,394,34,34,0,1,0
26,395,395,37,17,20,3,2
9,397,397,16,5,11,2,1
34,401,401,56,56,0,1,0
16,407,407,20,12,8,2,1
7,420,420,10,5,5,2,1
33,427,427,49,49,0,1,0
11,430,430,53,53,0,1,0
20,440,440,32,32,0,1,0
21,451,451,2,2,0,1,0
4,457,457,2,2,0,1,0
36,469,469,5,5,0,1,0
40,488,488,62,24,38,2,1
19,490,490,10,10,0,1,0

22,103,103,2,2,0,1,0
29,134,134,15,15,0,1,0
31,138,138,3,3,0,1,0
6,168,168,5,5,0,1,0
23,169,169,4,4,0,1,0
11,174,174,21,15,6,3,2
17,182,182,20,20,0,1,0
12,192,192,3,3,0,1,0
32,197,197,35,35,0,1,0
1,204,204,14,2,12,2,1
19,211,211,52,52,0,1,0
28,212,212,68,5,63,3,2
5,216,216,10,10,0,1,0
15,223,223,10,10,0,1,0
10,224,224,4,4,0,1,0
2,229,229,4,4,0,1,0
34,230,230,13,13,0,1,0
4,230,230,44,44,0,1,0
18,256,256,2,2,0,1,0
26,270,270,41,29,12,2,1
30,270,270,10,10,0,1,0
20,279,279,22,22,0,1,0
3,286,286,126,126,0,1,0
36,287,287,21,21,0,1,0
16,292,292,44,39,5,2,1
35,330,330,22,13,9,4,3
14,347,347,12,2,10,2,1
9,357,357,17,10,7,2,1
24,361,361,89,89,0,1,0
33,371,371,32,8,24,3,2
21,375,375,8,8,0,1,0
37,385,385,62,62,0,1,0
7,392,392,147,47,100,3,2
25,420,420,12,12,0,1,0
0,433,433,3,3,0,1,0
27,463,463,50,15,35,2,1
13,464,464,30,30,0,1,0
8,465,465,102,102,0,1,0

39,108,108,19,10,9,2,1
35,117,117,18,18,0,1,0
1,150,150,11,5,6,3,2
34,171,171,61,61,0,1,0
2,174,174,23,10,13,4,3
37,185,185,7,7,0,1,0
12,189,189,1,1,0,1,0
3,202,202,10,2,8,3,2
19,217,217,1,1,0,1,0
8,223,223,73,73,0,1,0
10,234,234,3,3,0,1,0
17,237,237,16,3,13,2,1
23,255,255,53,53,0,1,0
16,258,258,10,4,6,3,2
33,283,283,7,7,0,1,0
31,285,285,50,50,0,1,0
27,285,285,2,2,0,1,0
40,316,316,34,22,12,4,3
6,316,316,46,39,7,2,1
15,319,319,56,36,20,2,1
7,323,323,33,33,0,1,0
21,333,333,17,17,0,1,0
38,340,340,37,1,36,4,3
28,353,353,19,19,0,1,0
30,360,360,25,5,20,3,2
26,370,370,54,54,0,1,0
29,373,373,53,5,48,4,3
24,373,373,26,6,20,4,3
20,385,385,30,2,28,2,1
4,397,397,182,134,48,2,1
36,403,403,13,7,6,2,1
9,413,413,14,14,0,1,0
25,416,416,1,1,0,1,0
22,417,417,39,30,9,4,3
32,421,421,12,12,0,1,0
11,425,425,18,18,0,1,0
14,426,426,32,8,24,3,2
0,441,441,20,20,0,1,0
5,444,444,13,13,0,1,0
18,444,444,11,11,0,1,0
13,448,448,36,2,34,3,2

40,113,113,3,3,0,1,0
10,137,137,5,5,0,1,0
16,148,148,3,3,0,1,0
44,152,152,69,55,14,2,1
15,157,157,6,3,3,2,1
34,169,169,3,3,0,1,0
17,176,176,15,3,12,3,2
0,191,191,2,2,0,1,0
45,193,193,9,9,0,1,0
31,197,197,10,2,8,2,1
23,202,202,4,4,0,1,0
1,208,208,38,38,0,1,0
24,225,225,37,37,0,1,0
6,238,238,31,10,21,3,2
9,242,242,2,2,0,1,0
14,257,257,5,2,3,2,1
22,260,260,28,10,18,4,3
38,261,261,114,102,12,4,3
42,263,263,31,16,15,2,1
28,263,263,25,13,12,2,1
12,268,268,8,3,5,2,1
13,273,273,25,25,0,1,0
29,280,280,26,14,12,2,1
21,282,282,13,2,11,2,1
11,304,304,9,3,6,3,2
26,304,304,8,8,0,1,0
39,344,344,35,35,0,1,0
3,346,346,14,14,0,1,0
19,353,353,55,42,13,2,1
41,355,355,8,8,0,1,0
7,367,367,55,55,0,1,0
36,367,367,54,54,0,1,0
20,372,372,55,39,16,2,1
27,374,374,7,2,5,2,1
18,374,374,29,6,23,2,1
33,379,379,29,29,0,1,0
30,392,392,24,24,0,1,0
8,416,416,15,3,12,3,2
35,437,437,11,11,0,1,0
37,443,443,88,28,60,3,2
5,462,462,29,29,0,1,0
2,468,468,87,87,0,1,0
46,480,480,2,2,0,1,0
32,481,481,6,6,0,1,0
25,481,481,36,27,9,2,1
4,481,481,12,12,0,1,0
43,484,484,9,9,0,1,0

11,100,100,4,4,0,1,0
36,110,110,2,2,0,1,0
15,117,117,7,7,0,1,0
20,147,147,10,3,7,2,1
19,152,152,21,21,0,1,0
3,164,164,67,18,49,2,1
6,178,178,14,14,0,1,0
10,204,204,29,23,6,3,2
14,206,206,4,4,0,1,0
8,215,215,8,8,0,1,0
38,243,243,39,20,19,2,1
7,260,260,7,7,0,1,0
42,264,264,11,5,6,3,2
37,271,271,27,6,21,2,1
25,272,272,72,72,0,1,0
34,279,279,22,22,0,1,0
43,287,287,6,2,4,2,1
24,295,295,9,2,7,2,1
1,302,302,24,12,12,3,2
17,305,305,27,9,18,2,1
0,311,311,12,2,10,2,1
27,315,315,56,56,0,1,0
12,333,333,8,8,0,1,0
30,335,335,12,1,11,2,1
13,336,336,13,1,12,4,3
41,336,336,3,3,0,1,0
21,344,344,15,15,0,1,0
40,349,349,20,2,18,3,2
28,349,349,63,63,0,1,0
16,360,360,45,19,26,3,2
33,362,362,167,167,0,1,0
29,364,364,42,42,0,1,0
4,371,371,1,1,0,1,0
26,379,379,24,12,12,3,2
44,387,387,11,8,3,2,1
31,395,395,44,44,0,1,0
2,413,413,1,1,0,1,0
9,416,416,23,23,0,1,0
35,419,419,11,11,0,1,0
32,453,453,34,34,0,1,0
18,468,468,122,46,76,4,3
39,472,472,5,5,0,1,0
23,479,479,6,6,0,1,0
5,486,486,1,1,0,1,0
22,487,487,87,87,0,1,0

32,105,105,4,4,0,1,0
6,109,109,4,4,0,1,0
17,119,119,8,2,6,3,2
12,120,120,6,6,0,1,0
1,129,129,2,2,0,1,0
28,146,146,25,25,0,1,0
11,159,159,7,7,0,1,0
35,159,159,4,4,0,1,0
36,173,173,24,24,0,1,0
9,183,183,20,20,0,1,0
5,186,186,3,3,0,1,0
3,196,196,26,26,0,1,0
21,200,200,11,3,8,2,1
15,241,241,50,23,27,2,1
2,250,250,35,23,12,2,1
13,255,255,7,7,0,1,0
27,262,262,13,3,10,3,2
18,265,265,15,15,0,1,0
19,272,272,19,2,17,2,1
4,291,291,29,29,0,1,0
31,300,300,156,130,26,4,3
38,303,303,2,2,0,1,0
0,319,319,78,12,66,3,2
34,324,324,85,85,0,1,0
24,330,330,5,5,0,1,0
16,333,333,54,54,0,1,0
7,333,333,5,5,0,1,0
22,349,349,1,1,0,1,0
14,356,356,92,65,27,4,3
33,363,363,60,2,58,4,3
20,372,372,21,21,0,1,0
37,389,389,9,9,0,1,0
29,391,391,76,42,34,3,2
26,401,401,19,19,0,1,0
10,407,407,42,42,0,1,0
23,412,412,42,15,27,4,3
30,448,448,10,10,0,1,0
8,456,456,99,99,0,1,0
25,478,478,36,24,12,4,3

13,114,114,5,2,3,2,1
36,115,115,13,13,0,1,0
23,133,133,17,12,5,2,1
14,138,138,2,2,0,1,0
7,142,142,21,21,0,1,0
27,145,145,1,1,0,1,0
21,148,148,7,3,4,2,1
25,155,155,10,10,0,1,0
17,158,158,2,2,0,1,0
39,177,177,14,9,5,2,1
20,193,193,34,34,0,1,0
33,196,196,6,6,0,1,0
1,207,207,9,1,8,2,1
2,214,214,15,7,8,3,2
29,214,214,106,51,55,4,3
5,227,227,56,8,48,2,1
11,244,244,22,9,13,2,1
8,263,263,1,1,0,1,0
0,265,265,3,3,0,1,0
24,277,277,11,11,0,1,0
19,296,296,2,2,0,1,0
18,301,301,119,109,10,3,2
35,315,315,18,18,0,1,0
26,335,335,33,33,0,1,0
4,341,341,72,63,9,4,3
10,365,365,16,16,0,1,0
30,376,376,17,17,0,1,0
28,377,377,28,4,24,4,3
32,382,382,20,20,0,1,0
15,386,386,74,22,52,3,2
16,397,397,45,45,0,1,0
37,407,407,28,6,22,4,3
6,412,412,1,1,0,1,0
34,426,426,117,117,0,1,0
3,432,432,6,6,0,1,0
22,435,435,56,41,15,4,3
9,444,444,54,38,16,3,2
31,474,474,3,3,0,1,0
12,476,476,103,93,10,3,2
38,489,489,32,32,0,1,0

20,100,100,1,1,0,1,0
45,100,100,3,3,0,1,0
44,104,104,8,8,0,1,0
33,113,113,1,1,0,1,0
13,121,121,1,1,0,1,0
25,128,128,1,1,0,1,0
5,131,131,2,2,0,1,0
38,133,133,5,5,0,1,0
4,138,138,13,13,0,1,0
12,144,144,13,13,0,1,0
35,150,150,6,6,0,1,0
46,156,156,69,13,56,3,2
52,178,178,2,2,0,1,0
14,181,181,1,1,0,1,0
42,192,192,1,1,0,1,0
23,204,204,11,7,4,2,1
26,205,205,36,36,0,1,0
31,226,226,4,4,0,1,0
40,229,229,37,3,34,3,2
50,235,235,3,3,0,1,0
32,245,245,7,7,0,1,0
41,245,245,9,9,0,1,0
0,251,251,28,1,27,2,1
27,270,270,21,21,0,1,0
19,276,276,14,14,0,1,0
53,279,279,113,70,43,4,3
36,283,283,46,20,26,3,2
54,285,285,7,1,6,2,1
8,290,290,61,57,4,2,1
3,302,302,1,1,0,1,0
47,304,304,25,4,21,4,3
1,311,311,17,4,13,2,1
34,332,332,1,1,0,1,0
55,337,337,6,6,0,1,0
18,345,345,2,2,0,1,0
29,359,359,9,9,0,1,0
28,362,362,28,21,7,2,1
21,372,372,11,2,9,2,1
51,379,379,9,9,0,1,0
39,389,389,12,12,0,1,0
10,393,393,38,6,32,3,2
9,397,397,37,1,36,2,1
11,402,402,99,24,75,4,3
30,411,411,13,6,7,2,1
48,412,412,46,24,22,3,2
2,414,414,7,7,0,1,0
43,415,415,3,3,0,1,0
17,441,441,21,21,0,1,0
49,453,453,118,79,39,4,3
24,454,454,1,1,0,1,0
6,456,456,62,19,43,2,1
7,461,461,10,10,0,1,0
22,473,473,5,1,4,2,1
16,476,476,17,17,0,1,0
15,482,482,28,17,11,2,1
37,485,485,50,27,23,2,1

26,107,107,13,4,9,4,3
27,107,107,31,16,15,4,3
3,131,131,3,3,0,1,0
44,138,138,5,5,0,1,0
19,140,140,5,5,0,1,0
13,144,144,12,12,0,1,0
0,156,156,14,14,0,1,0
25,158,158,4,4,0,1,0
42,165,165,1,1,0,1,0
5,177,177,29,24,5,2,1
31,192,192,7,7,0,1,0
1,201,201,1,1,0,1,0
24,203,203,12,6,6,2,1
40,214,214,7,7,0,1,0
7,218,218,12,12,0,1,0
34,220,220,34,16,18,4,3
43,240,240,13,7,6,2,1
38,240,240,46,46,0,1,0
30,248,248,49,11,38,2,1
20,264,264,26,2,24,4,3
37,265,265,52,4,48,2,1
22,277,277,60,18,42,4,3
17,287,287,23,23,0,1,0
23,288,288,31,14,17,2,1
35,304,304,83,33,50,3,2
9,308,308,23,13,10,2,1
14,320,320,2,2,0,1,0
2,329,329,10,10,0,1,0
15,331,331,14,14,0,1,0
4,342,342,5,5,0,1,0
6,353,353,22,10,12,4,3
12,367,367,9,9,0,1,0
18,370,370,5,5,0,1,0
33,374,374,2,2,0,1,0
16,375,375,89,19,70,3,2
39,376,376,54,54,0,1,0
41,387,387,22,22,0,1,0
8,401,401,6,6,0,1,0
32,406,406,6,6,0,1,0
36,413,413,11,6,5,2,1
28,415,415,9,4,5,2,1
29,423,423,67,39,28,2,1
10,443,443,2,2,0,1,0
11,484,484,175,75,100,3,2
21,500,500,50,5,45,4,3

25,117,117,3,3,0,1,0
12,128,128,5,5,0,1,0
1,148,148,25,25,0,1,0
29,179,179,59,29,30,4,3
7,181,181,68,68,0,1,0
20,236,236,53,53,0,1,0
4,247,247,40,28,12,2,1
6,248,248,36,4,32,4,3
30,248,248,55,35,20,3,2
22,248,248,30,5,25,2,1
17,282,282,26,14,12,2,1
15,292,292,38,11,27,4,3
8,294,294,45,45,0,1,0
34,298,298,58,49,9,4,3
27,302,302,10,5,5,2,1
13,314,314,7,4,3,2,1
32,321,321,13,1,12,3,2
11,325,325,27,11,16,3,2
28,341,341,54,12,42,2,1
26,364,364,55,11,44,2,1
2,398,398,39,39,0,1,0
24,399,399,4,1,3,2,1
5,415,415,141,27,114,4,3
18,417,417,1,1,0,1,0
19,428,428,14,14,0,1,0
23,429,429,19,19,0,1,0
31,430,430,53,40,13,2,1
10,440,440,7,3,4,2,1
14,446,446,83,13,70,3,2
16,458,458,10,10,0,1,0
33,477,477,20,20,0,1,0
21,493,493,16,4,12,4,3
9,495,495,43,18,25,2,1
0,498,498,39,39,0,1,0
3,499,499,23,23,0,1,0

8,108,108,2,2,0,1,0
23,114,114,27,27,0,1,0
35,115,115,4,4,0,1,0
33,132,132,6,6,0,1,0
30,132,132,10,2,8,2,1
36,150,150,9,9,0,1,0
2,163,163,5,5,0,1,0
28,165,165,3,3,0,1,0
9,166,166,10,1,9,4,3
5,188,188,13,13,0,1,0
29,197,197,4,1,3,2,1
20,198,198,11,11,0,1,0
13,207,207,30,30,0,1,0
15,218,218,28,28,0,1,0
11,221,221,13,13,0,1,0
31,230,230,69,2,67,4,3
37,237,237,43,43,0,1,0
12,239,239,7,7,0,1,0
32,265,265,30,2,28,4,3
7,272,272,86,53,33,4,3
10,297,297,8,2,6,3,2
0,315,315,41,8,33,4,3
22,344,344,34,31,3,2,1
6,352,352,9,9,0,1,0
25,355,355,8,8,0,1,0
4,356,356,34,34,0,1,0
34,381,381,105,39,66,4,3
27,390,390,19,15,4,2,1
1,394,394,42,8,34,3,2
26,414,414,94,94,0,1,0
24,424,424,36,36,0,1,0
14,433,433,32,25,7,2,1
16,442,442,35,35,0,1,0
19,454,454,32,32,0,1,0
38,459,459,11,11,0,1,0
3,462,462,28,25,3,2,1
17,466,466,104,74,30,4,3
18,476,476,154,154,0,1,0
21,484,484,25,13,12,3,2

19,120,120,9,1,8,3,2
15,127,127,1,1,0,1,0
33,127,127,9,1,8,3,2
36,130,130,22,3,19,2,1
35,133,133,6,6,0,1,0
14,135,135,18,4,14,2,1
46,137,137,42,6,36,4,3
47,139,139,9,9,0,1,0
44,142,142,2,2,0,1,0
30,144,144,17,1,16,3,2
37,151,151,6,6,0,1,0
40,161,161,29,29,0,1,0
2,166,166,15,3,12,3,2
1,172,172,6,1,5,2,1
4,178,178,6,6,0,1,0
13,197,197,1,1,0,1,0
3,208,208,9,9,0,1,0
26,229,229,18,2,16,3,2
7,230,230,21,21,0,1,0
8,242,242,15,6,9,2,1
23,247,247,20,2,18,2,1
11,248,248,25,12,13,2,1
10,279,279,32,14,18,4,3
17,280,280,15,15,0,1,0
6,284,284,2,2,0,1,0
22,289,289,4,1,3,2,1
52,298,298,23,23,0,1,0
21,303,303,8,5,3,2,1
43,307,307,21,15,6,2,1
38,307,307,4,4,0,1,0
18,314,314,26,1,25,2,1
48,322,322,72,22,50,2,1
51,333,333,2,2,0,1,0
16,345,345,30,19,11,2,1
28,380,380,9,4,5,2,1
29,383,383,24,24,0,1,0
0,387,387,8,8,0,1,0
25,393,393,6,6,0,1,0
12,394,394,33,24,9,2,1
50,400,400,150,29,121,4,3
32,406,406,3,3,0,1,0
39,408,408,14,14,0,1,0
45,411,411,39,39,0,1,0
9,430,430,10,2,8,3,2
34,436,436,16,16,0,1,0
41,441,441,17,17,0,1,0
27,467,467,11,2,9,2,1
49,469,469,59,21,38,3,2
24,471,471,30,30,0,1,0
31,472,472,19,2,17,2,1
20,479,479,6,6,0,1,0
5,484,484,137,47,90,3,2
42,488,488,30,14,16,2,1

15,123,123,2,2,0,1,0
21,135,135,6,1,5,2,1
37,159,159,15,15,0,1,0
18,176,176,10,1,9,4,3
12,176,176,9,9,0,1,0
30,177,177,74,10,64,3,2
8,182,182,27,27,0,1,0
10,219,219,36,5,31,2,1
39,228,228,10,4,6,3,2
20,230,230,7,3,4,2,1
28,231,231,28,28,0,1,0
31,243,243,8,8,0,1,0
32,260,260,49,25,24,4,3
1,297,297,21,21,0,1,0
9,297,297,2,2,0,1,0
6,300,300,27,1,26,3,2
29,300,300,110,110,0,1,0
22,307,307,1,1,0,1,0
14,312,312,209,209,0,1,0
16,346,346,11,2,9,2,1
11,354,354,6,2,4,2,1
4,359,359,2,2,0,1,0
5,362,362,14,2,12,3,2
23,366,366,16,16,0,1,0
17,370,370,77,35,42,4,3
2,371,371,23,23,0,1,0
24,376,376,13,13,0,1,0
36,380,380,85,75,10,3,2
13,389,389,8,8,0,1,0
35,393,393,5,5,0,1,0
27,400,400,26,12,14,3,2
0,417,417,1,1,0,1,0
3,428,428,53,53,0,1,0
25,429,429,49,49,0,1,0
34,433,433,11,3,8,2,1
38,444,444,6,6,0,1,0
19,448,448,93,43,50,3,2
7,468,468,4,4,0,1,0
26,475,475,59,43,16,3,2
33,480,480,15,15,0,1,0

27,118,118,21,21,0,1,0
21,124,124,3,3,0,1,0
18,125,125,16,16,0,1,0
2,129,129,34,25,9,4,3
3,131,131,1,1,0,1,0
26,140,140,2,2,0,1,0
28,141,141,14,14,0,1,0
22,145,145,16,9,7,2,1
30,149,149,38,16,22,3,2
39,150,150,26,26,0,1,0
25,160,160,26,26,0,1,0
17,170,170,5,5,0,1,0
6,199,199,12,9,3,2,1
37,230,230,5,5,0,1,0
24,238,238,9,9,0,1,0
13,242,242,6,6,0,1,0
7,264,264,28,12,16,2,1
38,268,268,12,8,4,2,1
29,275,275,51,3,48,3,2
1,280,280,16,2,14,3,2
20,284,284,18,18,0,1,0
34,290,290,30,22,8,3,2
5,303,303,17,13,4,2,1
23,304,304,19,19,0,1,0
10,336,336,1,1,0,1,0
12,358,358,30,30,0,1,0
31,359,359,4,4,0,1,0
4,360,360,5,5,0,1,0
35,377,377,4,4,0,1,0
8,391,391,83,15,68,4,3
32,413,413,15,15,0,1,0
15,413,413,68,68,0,1,0
14,420,420,13,13,0,1,0
33,441,441,137,29,108,4,3
16,461,461,50,24,26,3,2
36,463,463,65,26,39,2,1
9,479,479,53,27,26,3,2
11,480,480,148,148,0,1,0
0,480,480,25,2,23,2,1
19,495,495,89,56,33,4,3

2,121,121,27,27,0,1,0
4,125,125,22,2,20,2,1
13,156,156,4,4,0,1,0
36,166,166,4,4,0,1,0
1,174,174,10,6,4,2,1
28,182,182,42,24,18,4,3
30,184,184,39,39,0,1,0
11,186,186,9,3,6,2,1
6,196,196,16,16,0,1,0
12,206,206,4,4,0,1,0
17,230,230,3,3,0,1,0
24,232,232,41,41,0,1,0
20,236,236,38,38,0,1,0
8,237,237,10,1,9,4,3
16,244,244,8,8,0,1,0
26,250,250,10,10,0,1,0
29,251,251,34,34,0,1,0
3,261,261,1,1,0,1,0
32,270,270,24,24,0,1,0
19,274,274,7,3,4,2,1
40,291,291,26,8,18,4,3
9,305,305,58,36,22,2,1
42,310,310,35,3,32,2,1
41,313,313,2,2,0,1,0
31,324,324,53,53,0,1,0
35,337,337,3,3,0,1,0
34,341,341,19,7,12,3,2
39,348,348,11,11,0,1,0
15,365,365,2,2,0,1,0
18,370,370,70,67,3,2,1
21,371,371,19,7,12,3,2
14,375,375,62,31,31,2,1
23,401,401,16,3,13,4,3
7,406,406,2,2,0,1,0
25,408,408,103,28,75,4,3
37,415,415,3,3,0,1,0
10,421,421,123,21,102,4,3
33,442,442,100,22,78,3,2
0,445,445,31,31,0,1,0
5,461,461,25,8,17,3,2
38,491,491,5,5,0,1,0
27,493,493,63,18,45,3,2
22,494,494,34,8,26,2,1

39,108,108,21,21,0,1,0
30,114,114,4,4,0,1,0
7,128,128,1,1,0,1,0
18,136,136,2,2,0,1,0
27,136,136,18,18,0,1,0
0,137,137,11,11,0,1,0
24,149,149,16,11,5,2,1
42,151,151,9,9,0,1,0
43,193,193,1,1,0,1,0
3,197,197,18,12,6,2,1
32,207,207,33,33,0,1,0
19,209,209,10,10,0,1,0
41,213,213,2,2,0,1,0
28,222,222,28,28,0,1,0
14,235,235,36,36,0,1,0
31,252,252,17,17,0,1,0
4,253,253,35,5,30,3,2
5,263,263,16,3,13,4,3
40,266,266,12,12,0,1,0
11,268,268,19,19,0,1,0
9,269,269,5,5,0,1,0
12,269,269,55,41,14,3,2
6,283,283,14,8,6,2,1
2,284,284,3,3,0,1,0
34,289,289,35,9,26,3,2
16,291,291,13,13,0,1,0
44,292,292,50,50,0,1,0
23,319,319,42,16,26,4,3
15,327,327,11,11,0,1,0
38,343,343,28,22,6,3,2
37,350,350,23,11,12,4,3
10,355,355,89,32,57,4,3
25,374,374,204,156,48,3,2
20,378,378,65,37,28,3,2
36,381,381,13,13,0,1,0
35,384,384,8,1,7,2,1
33,386,386,20,20,0,1,0
21,394,394,9,9,0,1,0
26,411,411,43,43,0,1,0
1,439,439,7,7,0,1,0
17,481,481,94,94,0,1,0
8,487,487,18,18,0,1,0
13,493,493,6,6,0,1,0
22,495,495,16,16,0,1,0
29,500,500,11,11,0,1,0

24,106,106,2,2,0,1,0
30,119,119,2,2,0,1,0
16,145,145,4,4,0,1,0
10,176,176,46,46,0,1,0
14,177,177,5,5,0,1,0
7,179,179,21,8,13,2,1
20,184,184,11,4,7,2,1
32,198,198,16,16,0,1,0
13,206,206,23,2,21,2,1
33,206,206,23,19,4,2,1
34,208,208,4,4,0,1,0
5,227,227,8,8,0,1,0
12,230,230,2,2,0,1,0
1,253,253,3,3,0,1,0
8,256,256,37,15,22,2,1
9,259,259,9,9,0,1,0
40,278,278,30,30,0,1,0
26,293,293,106,38,68,3,2
18,298,298,34,34,0,1,0
25,303,303,22,22,0,1,0
22,342,342,23,23,0,1,0
21,343,343,38,38,0,1,0
15,349,349,126,9,117,4,3
31,357,357,4,4,0,1,0
19,361,361,4,4,0,1,0
27,362,362,75,62,13,2,1
6,365,365,52,33,19,4,3
2,392,392,57,17,40,2,1
35,398,398,75,13,62,3,2
37,402,402,12,12,0,1,0
11,410,410,8,2,6,2,1
3,418,418,42,42,0,1,0
36,434,434,21,21,0,1,0
28,435,435,27,20,7,2,1
38,441,441,183,121,62,3,2
17,447,447,62,62,0,1,0
0,453,453,18,18,0,1,0
23,456,456,44,31,13,2,1
4,459,459,42,4,38,3,2
39,467,467,2,2,0,1,0
29,495,495,1,1,0,1,0

32,126,126,24,14,10,3,2
7,140,140,8,8,0,1,0
9,143,143,37,10,27,2,1
16,147,147,15,15,0,1,0
26,150,150,4,4,0,1,0
4,157,157,37,37,0,1,0
15,159,159,6,6,0,1,0
23,167,167,2,2,0,1,0
2,174,174,3,3,0,1,0
0,178,178,11,11,0,1,0
17,188,188,5,5,0,1,0
27,199,199,13,13,0,1,0
25,204,204,14,4,10,4,3
5,228,228,18,18,0,1,0
8,241,241,52,22,30,4,3
33,243,243,23,23,0,1,0
30,266,266,11,1,10,3,2
28,266,266,22,22,0,1,0
31,267,267,7,1,6,2,1
19,270,270,10,4,6,3,2
34,275,275,12,7,5,2,1
14,289,289,3,3,0,1,0
6,295,295,44,44,0,1,0
21,335,335,36,36,0,1,0
13,342,342,29,29,0,1,0
29,349,349,76,76,0,1,0
22,352,352,45,26,19,2,1
11,354,354,102,59,43,4,3
36,362,362,167,137,30,3,2
24,373,373,18,12,6,2,1
1,380,380,84,30,54,4,3
37,389,389,57,57,0,1,0
18,390,390,35,35,0,1,0
12,422,422,25,25,0,1,0
3,435,435,32,20,12,4,3
20,452,452,35,35,0,1,0
10,456,456,11,7,4,2,1
35,463,463,28,28,0,1,0

3,103,103,1,1,0,1,0
38,109,109,16,4,12,4,3
41,112,112,2,2,0,1,0
21,118,118,1,1,0,1,0
10,119,119,6,6,0,1,0
22,170,170,13,3,10,3,2
42,175,175,36,32,4,2,1
6,188,188,4,4,0,1,0
30,197,197,10,10,0,1,0
28,197,197,4,4,0,1,0
1,218,218,9,9,0,1,0
31,218,218,36,10,26,2,1
14,234,234,14,14,0,1,0
27,234,234,56,12,44,3,2
8,237,237,21,21,0,1,0
15,243,243,61,31,30,2,1
25,260,260,11,11,0,1,0
36,260,260,30,12,18,2,1
32,265,265,15,15,0,1,0
39,270,270,18,8,10,2,1
12,276,276,69,27,42,4,3
17,279,279,6,2,4,2,1
34,313,313,7,7,0,1,0
26,315,315,53,53,0,1,0
20,318,318,11,11,0,1,0
19,321,321,17,17,0,1,0
16,324,324,64,26,38,2,1
13,332,332,23,12,11,3,2
37,339,339,20,20,0,1,0
35,351,351,22,22,0,1,0
5,367,367,1,1,0,1,0
23,397,397,11,7,4,2,1
18,400,400,170,95,75,4,3
4,403,403,56,56,0,1,0
2,403,403,9,9,0,1,0
9,410,410,45,45,0,1,0
24,426,426,14,4,10,2,1
0,428,428,8,1,7,3,2
40,429,429,169,89,80,3,2
29,431,431,37,7,30,2,1
7,453,453,22,7,15,3,2
11,476,476,1,1,0,1,0
33,477,477,27,27,0,1,0

2,113,113,8,1,7,2,1
5,115,115,9,9,0,1,0
15,122,122,2,2,0,1,0
21,123,123,2,2,0,1,0
7,144,144,7,4,3,2,1
12,149,149,1,1,0,1,0
22,165,165,4,4,0,1,0
34,165,165,15,10,5,2,1
52,175,175,4,4,0,1,0
37,178,178,8,8,0,1,0
14,187,187,1,1,0,1,0
41,219,219,48,48,0,1,0
24,219,219,4,4,0,1,0
25,226,226,8,8,0,1,0
40,237,237,13,13,0,1,0
1,239,239,29,29,0,1,0
33,243,243,48,40,8,2,1
50,246,246,32,10,22,2,1
29,258,258,12,4,8,3,2
31,258,258,1,1,0,1,0
30,259,259,12,1,11,3,2
6,270,270,1,1,0,1,0
35,279,279,11,11,0,1,0
9,287,287,1,1,0,1,0
45,292,292,109,109,0,1,0
38,297,297,24,12,12,2,1
28,304,304,1,1,0,1,0
51,308,308,2,2,0,1,0
11,336,336,3,3,0,1,0
44,340,340,7,3,4,2,1
16,363,363,44,44,0,1,0
19,367,367,20,2,18,3,2
23,376,376,15,15,0,1,0
0,380,380,41,15,26,2,1
42,387,387,31,31,0,1,0
27,400,400,95,68,27,4,3
49,406,406,66,12,54,4,3
18,407,407,26,3,23,2,1
13,414,414,47,17,30,3,2
26,418,418,19,19,0,1,0
32,424,424,99,36,63,4,3
17,425,425,33,33,0,1,0
10,443,443,2,2,0,1,0
4,443,443,22,22,0,1,0
43,444,444,30,30,0,1,0
39,446,446,57,57,0,1,0
8,455,455,1,1,0,1,0
46,456,456,53,53,0,1,0
47,456,456,23,4,19,2,1
3,456,456,84,84,0,1,0
36,459,459,33,33,0,1,0
48,469,469,37,37,0,1,0
20,493,493,53,5,48,3,2

37,102,102,4,4,0,1,0
17,111,111,15,15,0,1,0
43,123,123,24,16,8,3,2
4,126,126,6,6,0,1,0
18,136,136,3,3,0,1,0
25,137,137,1,1,0,1,0
8,144,144,4,4,0,1,0
14,148,148,5,5,0,1,0
29,160,160,1,1,0,1,0
22,179,179,17,14,3,2,1
44,180,180,18,12,6,3,2
35,194,194,15,15,0,1,0
31,198,198,11,8,3,2,1
40,208,208,3,3,0,1,0
21,213,213,6,6,0,1,0
27,234,234,12,12,0,1,0
28,241,241,9,1,8,2,1
38,242,242,37,37,0,1,0
33,250,250,8,8,0,1,0
9,267,267,8,4,4,2,1
19,270,270,68,47,21,2,1
24,275,275,33,24,9,4,3
5,281,281,7,7,0,1,0
12,285,285,6,2,4,2,1
47,288,288,15,2,13,2,1
46,291,291,14,14,0,1,0
34,322,322,9,9,0,1,0
23,332,332,9,9,0,1,0
15,337,337,1,1,0,1,0
2,341,341,5,5,0,1,0
41,344,344,52,52,0,1,0
10,357,357,54,54,0,1,0
49,359,359,62,26,36,3,2
6,382,382,9,9,0,1,0
32,384,384,55,36,19,2,1
0,399,399,56,56,0,1,0
3,399,399,74,30,44,2,1
20,400,400,14,14,0,1,0
48,409,409,9,9,0,1,0
16,415,415,4,1,3,2,1
26,420,420,3,3,0,1,0
7,435,435,18,4,14,3,2
45,441,441,133,133,0,1,0
30,442,442,26,26,0,1,0
13,459,459,40,40,0,1,0
11,465,465,2,2,0,1,0
39,470,470,76,76,0,1,0
50,470,470,35,20,15,4,3
1,482,482,132,73,59,4,3
36,492,492,104,104,0,1,0
42,495,495,3,3,0,1,0

25,100,100,1,1,0,1,0
21,122,122,26,26,0,1,0
29,125,125,31,31,0,1,0
4,134,134,5,2,3,2,1
11,138,138,26,26,0,1,0
23,143,143,11,11,0,1,0
2,167,167,13,1,12,3,2
1,174,174,7,3,4,2,1
18,175,175,3,3,0,1,0
28,198,198,10,10,0,1,0
22,199,199,17,12,5,2,1
27,202,202,34,22,12,2,1
32,204,204,4,4,0,1,0
6,205,205,17,1,16,2,1
3,217,217,9,3,6,3,2
15,225,225,5,5,0,1,0
40,230,230,27,3,24,4,3
17,252,252,9,9,0,1,0
41,258,258,5,5,0,1,0
9,266,266,7,1,6,3,2
37,269,269,18,15,3,2,1
42,282,282,94,94,0,1,0
19,288,288,59,59,0,1,0
8,289,289,33,33,0,1,0
30,292,292,26,23,3,2,1
36,312,312,21,3,18,4,3
13,332,332,23,18,5,2,1
5,345,345,27,3,24,2,1
12,353,353,64,31,33,2,1
16,364,364,10,10,0,1,0
24,366,366,7,4,3,2,1
39,379,379,82,33,49,4,3
33,379,379,34,34,0,1,0
14,382,382,49,49,0,1,0
7,385,385,15,10,5,2,1
43,427,427,9,9,0,1,0
10,432,432,23,15,8,3,2
38,435,435,35,35,0,1,0
20,436,436,25,9,16,3,2
31,442,442,3,3,0,1,0
26,456,456,124,49,75,4,3
35,458,458,2,2,0,1,0
0,485,485,51,12,39,4,3
34,486,486,66,24,42,4,3

22,114,114,25,2,23,3,2
17,117,117,17,17,0,1,0
13,120,120,3,3,0,1,0
34,130,130,3,3,0,1,0
16,133,133,4,4,0,1,0
24,189,189,9,4,5,2,1
7,195,195,7,7,0,1,0
10,202,202,13,13,0,1,0
0,204,204,7,7,0,1,0
29,215,215,14,8,6,3,2
33,224,224,37,37,0,1,0
15,242,242,56,56,0,1,0
39,250,250,36,24,12,2,1
3,251,251,11,3,8,2,1
40,260,260,13,9,4,2,1
8,268,268,21,15,6,2,1
4,272,272,60,60,0,1,0
36,277,277,40,40,0,1,0
28,278,278,39,5,34,2,1
5,283,283,17,17,0,1,0
1,292,292,32,32,0,1,0
21,314,314,47,5,42,3,2
14,325,325,65,20,45,4,3
27,326,326,9,9,0,1,0
23,339,339,9,9,0,1,0
35,361,361,13,8,5,2,1
19,380,380,12,12,0,1,0
18,395,395,3,3,0,1,0
12,397,397,13,13,0,1,0
20,401,401,43,1,42,4,3
25,422,422,13,13,0,1,0
2,428,428,39,39,0,1,0
6,429,429,21,7,14,2,1
31,438,438,33,33,0,1,0
11,441,441,167,131,36,3,2
30,442,442,206,143,63,4,3
26,470,470,44,44,0,1,0
9,470,470,12,12,0,1,0
32,472,472,23,8,15,4,3
37,487,487,7,7,0,1,0
38,494,494,37,12,25,2,1

29,118,118,14,14,0,1,0
36,124,124,5,2,3,2,1
23,125,125,14,5,9,2,1
22,129,129,19,5,14,3,2
30,130,130,1,1,0,1,0
3,138,138,16,16,0,1,0
4,140,140,10,3,7,2,1
14,151,151,1,1,0,1,0
9,154,154,3,3,0,1,0
26,161,161,5,1,4,2,1
27,168,168,28,13,15,4,3
19,176,176,4,4,0,1,0
32,180,180,2,2,0,1,0
17,187,187,7,7,0,1,0
24,215,215,58,58,0,1,0
18,233,233,4,4,0,1,0
12,234,234,27,3,24,2,1
5,249,249,100,100,0,1,0
33,298,298,15,15,0,1,0
20,317,317,46,18,28,2,1
0,319,319,11,2,9,2,1
10,330,330,18,18,0,1,0
1,331,331,11,3,8,3,2
34,338,338,40,16,24,4,3
35,350,350,12,2,10,2,1
28,355,355,34,26,8,3,2
16,357,357,3,3,0,1,0
15,383,383,73,73,0,1,0
6,391,391,7,7,0,1,0
7,422,422,249,229,20,3,2
25,422,422,36,36,0,1,0
11,425,425,36,36,0,1,0
13,435,435,75,27,48,4,3
2,460,460,12,12,0,1,0
21,466,466,192,192,0,1,0
8,491,491,10,10,0,1,0
37,491,491,10,3,7,2,1
31,492,492,67,11,56,3,2

20,113,113,13,13,0,1,0
31,115,115,11,11,0,1,0
14,154,154,10,2,8,3,2
25,155,155,9,9,0,1,0
34,163,163,33,33,0,1,0
36,178,178,1,1,0,1,0
37,190,190,16,6,10,3,2
28,214,214,5,2,3,2,1
9,223,223,1,1,0,1,0
35,237,237,1,1,0,1,0
11,245,245,41,19,22,3,2
10,247,247,8,8,0,1,0
39,254,254,39,29,10,3,2
19,277,277,26,3,23,2,1
18,287,287,22,8,14,3,2
1,290,290,1,1,0,1,0
0,304,304,1,1,0,1,0
8,310,310,40,40,0,1,0
5,320,320,3,3,0,1,0
13,338,338,4,4,0,1,0
6,346,346,142,109,33,2,1
30,359,359,112,29,83,4,3
23,359,359,43,43,0,1,0
12,363,363,19,10,9,4,3
32,378,378,98,66,32,3,2
17,385,385,44,26,18,4,3
15,394,394,50,50,0,1,0
2,420,420,95,29,66,4,3
40,436,436,12,12,0,1,0
38,442,442,57,37,20,2,1
33,443,443,98,84,14,3,2
27,444,444,4,1,3,2,1
7,452,452,41,41,0,1,0
4,459,459,10,7,3,2,1
41,464,464,2,2,0,1,0
16,467,467,74,44,30,2,1
29,478,478,56,44,12,4,3
3,489,489,29,29,0,1,0
24,492,492,60,6,54,4,3
21,492,492,14,14,0,1,0
22,496,496,5,2,3,2,1
26,498,498,37,37,0,1,0

26,111,111,13,3,10,3,2
29,118,118,4,4,0,1,0
11,118,118,27,17,10,2,1
15,129,129,25,6,19,2,1
9,150,150,3,3,0,1,0
32,178,178,63,31,32,3,2
13,200,200,1,1,0,1,0
3,203,203,61,15,46,3,2
18,218,218,20,20,0,1,0
36,220,220,8,2,6,3,2
7,234,234,24,24,0,1,0
34,247,247,48,48,0,1,0
0,259,259,22,6,16,3,2
21,266,266,32,26,6,3,2
4,272,272,25,25,0,1,0
14,274,274,16,16,0,1,0
5,278,278,12,7,5,2,1
22,279,279,15,15,0,1,0
28,287,287,17,17,0,1,0
20,294,294,15,6,9,2,1
16,308,308,68,29,39,3,2
23,315,315,15,15,0,1,0
24,326,326,34,34,0,1,0
35,359,359,35,35,0,1,0
2,367,367,3,3,0,1,0
10,371,371,34,18,16,3,2
17,393,393,7,7,0,1,0
19,421,421,59,51,8,3,2
33,427,427,79,36,43,2,1
30,440,440,7,7,0,1,0
6,444,444,55,55,0,1,0
8,457,457,29,1,28,3,2
1,458,458,64,19,45,3,2
31,462,462,2,2,0,1,0
12,463,463,104,14,90,4,3
27,471,471,25,1,24,4,3
25,484,484,129,123,6,3,2

2,124,124,11,2,9,3,2
36,127,127,3,3,0,1,0
19,131,131,3,3,0,1,0
7,134,134,2,2,0,1,0
3,141,141,1,1,0,1,0
9,167,167,4,1,3,2,1
11,171,171,171,171,0,1,0
20,181,181,21,7,14,3,2
30,194,194,58,22,36,3,2
29,206,206,20,20,0,1,0
10,230,230,2,2,0,1,0
8,232,232,1,1,0,1,0
21,244,244,48,26,22,2,1
12,244,244,26,26,0,1,0
33,247,247,6,6,0,1,0
0,255,255,20,5,15,4,3
37,269,269,82,39,43,2,1
32,273,273,31,31,0,1,0
1,277,277,7,7,0,1,0
28,294,294,6,6,0,1,0
4,306,306,5,5,0,1,0
25,310,310,58,29,29,4,3
35,321,321,6,1,5,2,1
34,350,350,23,8,15,2,1
26,353,353,26,26,0,1,0
27,358,358,50,50,0,1,0
22,368,368,5,2,3,2,1
23,380,380,21,21,0,1,0
18,390,390,66,48,18,3,2
14,402,402,87,87,0,1,0
13,406,406,31,22,9,2,1
17,418,418,3,3,0,1,0
31,432,432,35,35,0,1,0
16,436,436,121,79,42,4,3
5,438,438,3,3,0,1,0
6,449,449,11,11,0,1,0
15,478,478,9,3,6,2,1
24,491,491,3,3,0,1,0

23,104,104,28,28,0,1,0
18,118,118,1,1,0,1,0
4,129,129,1,1,0,1,0
31,132,132,13,13,0,1,0
6,135,135,5,5,0,1,0
5,155,155,21,21,0,1,0
33,165,165,6,6,0,1,0
2,169,169,22,22,0,1,0
7,183,183,4,4,0,1,0
38,185,185,10,2,8,3,2
8,186,186,14,14,0,1,0
12,187,187,29,29,0,1,0
16,195,195,9,9,0,1,0
20,204,204,4,4,0,1,0
13,209,209,11,3,8,2,1
19,219,219,25,25,0,1,0
39,249,249,30,24,6,3,2
10,251,251,14,14,0,1,0
0,295,295,10,10,0,1,0
28,317,317,34,34,0,1,0
26,320,320,82,52,30,3,2
37,322,322,64,43,21,4,3
3,341,341,48,48,0,1,0
32,342,342,7,3,4,2,1
30,354,354,17,2,15,2,1
34,374,374,35,1,34,2,1
1,375,375,13,7,6,2,1
15,377,377,127,127,0,1,0
40,382,382,12,12,0,1,0
35,398,398,15,15,0,1,0
29,399,399,22,22,0,1,0
14,408,408,36,27,9,4,3
24,409,409,36,3,33,4,3
9,418,418,12,3,9,3,2
21,426,426,13,13,0,1,0
36,428,428,124,59,65,4,3
22,429,429,52,21,31,2,1
25,431,431,30,30,0,1,0
17,437,437,146,119,27,4,3
11,465,465,68,25,43,2,1
27,479,479,3,3,0,1,0

17,101,101,14,4,10,2,1
40,103,103,13,13,0,1,0
6,111,111,9,2,7,2,1
31,116,116,8,2,6,2,1
13,136,136,8,8,0,1,0
21,144,144,4,4,0,1,0
0,148,148,13,7,6,2,1
8,153,153,14,5,9,4,3
26,159,159,7,7,0,1,0
10,161,161,8,8,0,1,0
29,162,162,10,6,4,2,1
27,196,196,44,15,29,2,1
16,205,205,53,1,52,3,2
20,230,230,38,38,0,1,0
34,237,237,35,35,0,1,0
3,260,260,15,15,0,1,0
39,269,269,2,2,0,1,0
18,276,276,1,1,0,1,0
38,286,286,33,28,5,2,1
25,291,291,11,11,0,1,0
15,297,297,8,8,0,1,0
28,304,304,8,2,6,3,2
36,310,310,48,39,9,2,1
30,320,320,15,7,8,3,2
35,333,333,87,57,30,4,3
19,336,336,56,8,48,3,2
2,350,350,27,9,18,2,1
24,378,378,36,36,0,1,0
7,390,390,4,4,0,1,0
32,394,394,54,54,0,1,0
22,396,396,33,22,11,2,1
1,397,397,58,58,0,1,0
37,405,405,16,8,8,3,2
12,405,405,20,20,0,1,0
5,425,425,119,35,84,4,3
33,427,427,66,39,27,4,3
23,442,442,19,4,15,4,3
4,467,467,44,30,14,2,1
11,471,471,30,30,0,1,0
14,485,485,22,22,0,1,0
9,486,486,13,13,0,1,0
41,490,490,82,73,9,4,3

37,128,128,3,3,0,1,0
20,128,128,20,2,18,4,3
30,132,132,23,23,0,1,0
35,144,144,4,4,0,1,0
15,183,183,1,1,0,1,0
26,201,201,3,3,0,1,0
23,218,218,6,6,0,1,0
24,219,219,3,3,0,1,0
4,235,235,12,12,0,1,0
21,242,242,17,12,5,2,1
32,281,281,51,51,0,1,0
16,288,288,46,16,30,4,3
28,297,297,111,29,82,4,3
11,303,303,164,152,12,2,1
29,305,305,26,9,17,2,1
7,309,309,20,11,9,2,1
33,318,318,65,39,26,3,2
1,319,319,25,25,0,1,0
2,326,326,73,73,0,1,0
31,337,337,41,11,30,3,2
5,345,345,12,12,0,1,0
17,353,353,15,15,0,1,0
3,359,359,32,17,15,4,3
10,380,380,2,2,0,1,0
38,381,381,21,21,0,1,0
14,387,387,47,47,0,1,0
6,401,401,31,10,21,4,3
9,403,403,4,4,0,1,0
34,414,414,6,6,0,1,0
18,423,423,8,2,6,2,1
12,426,426,77,35,42,2,1
27,428,428,25,25,0,1,0
0,434,434,17,17,0,1,0
22,451,451,141,51,90,4,3
25,453,453,26,19,7,2,1
19,454,454,18,10,8,3,2
8,461,461,54,14,40,2,1
36,464,464,14,14,0,1,0
13,481,481,68,68,0,1,0

0,111,111,20,20,0,1,0
30,117,117,4,4,0,1,0
22,125,125,11,11,0,1,0
28,139,139,31,31,0,1,0
17,141,141,50,20,30,3,2
35,151,151,8,8,0,1,0
8,152,152,10,1,9,2,1
26,157,157,11,11,0,1,0
20,170,170,26,9,17,4,3
12,175,175,25,18,7,2,1
25,177,177,2,2,0,1,0
1,181,181,17,17,0,1,0
24,216,216,17,3,14,3,2
10,230,230,19,19,0,1,0
2,264,264,12,12,0,1,0
39,265,265,6,6,0,1,0
3,274,274,55,35,20,2,1
5,279,279,38,38,0,1,0
27,282,282,80,31,49,2,1
31,285,285,27,27,0,1,0
4,296,296,1,1,0,1,0
34,297,297,16,10,6,2,1
7,305,305,53,53,0,1,0
21,306,306,85,27,58,4,3
16,306,306,11,11,0,1,0
38,331,331,43,43,0,1,0
32,337,337,12,12,0,1,0
14,339,339,32,32,0,1,0
6,347,347,2,2,0,1,0
18,361,361,1,1,0,1,0
19,362,362,6,6,0,1,0
11,362,362,34,24,10,3,2
29,416,416,45,15,30,2,1
37,418,418,64,64,0,1,0
36,419,419,33,6,27,4,3
33,430,430,14,14,0,1,0
15,460,460,33,2,31,2,1
23,477,477,23,4,19,3,2
13,480,480,14,14,0,1,0
9,487,487,83,9,74,3,2

29,104,104,2,2,0,1,0
7,105,105,14,14,0,1,0
1,111,111,3,3,0,1,0
0,113,113,9,1,8,3,2
38,115,115,6,6,0,1,0
27,119,119,2,2,0,1,0
11,121,121,7,2,5,2,1
32,134,134,19,13,6,2,1
21,144,144,12,12,0,1,0
26,157,157,22,22,0,1,0
20,167,167,12,8,4,2,1
4,179,179,2,2,0,1,0
24,186,186,11,5,6,3,2
9,197,197,4,4,0,1,0
15,204,204,1,1,0,1,0
23,204,204,33,18,15,2,1
2,210,210,2,2,0,1,0
37,235,235,6,6,0,1,0
3,245,245,8,3,5,2,1
25,248,248,8,8,0,1,0
5,266,266,11,1,10,3,2
31,287,287,9,9,0,1,0
6,305,305,13,13,0,1,0
8,312,312,5,5,0,1,0
19,312,312,59,59,0,1,0
36,312,312,12,12,0,1,0
33,329,329,97,97,0,1,0
34,365,365,60,10,50,3,2
30,377,377,37,23,14,3,2
28,380,380,17,17,0,1,0
18,416,416,74,74,0,1,0
17,416,416,15,1,14,3,2
10,434,434,237,237,0,1,0
35,436,436,54,21,33,4,3
16,445,445,18,7,11,2,1
12,447,447,51,19,32,3,2
13,467,467,13,13,0,1,0
22,474,474,128,58,70,3,2
14,495,495,288,180,108,4,3

35,120,120,2,2,0,1,0
29,121,121,2,2,0,1,0
10,160,160,24,7,17,2,1
34,165,165,22,10,12,4,3
1,178,178,33,33,0,1,0
31,179,179,19,3,16,2,1
18,182,182,1,1,0,1,0
14,194,194,31,10,21,4,3
39,211,211,33,3,30,3,2
11,218,218,1,1,0,1,0
28,223,223,17,17,0,1,0
30,234,234,28,10,18,4,3
26,235,235,60,3,57,4,3
8,239,239,16,16,0,1,0
5,243,243,21,3,18,4,3
27,246,246,68,68,0,1,0
38,255,255,22,22,0,1,0
4,258,258,42,42,0,1,0
17,261,261,19,7,12,3,2
37,266,266,43,3,40,2,1
0,275,275,52,4,48,3,2
22,280,280,10,2,8,3,2
19,288,288,26,26,0,1,0
25,296,296,20,20,0,1,0
7,302,302,59,53,6,3,2
9,312,312,14,7,7,2,1
32,325,325,49,17,32,3,2
33,354,354,22,22,0,1,0
2,363,363,49,49,0,1,0
24,369,369,24,24,0,1,0
23,382,382,18,18,0,1,0
36,403,403,22,22,0,1,0
6,406,406,1,1,0,1,0
20,424,424,2,2,0,1,0
16,443,443,14,7,7,2,1
12,460,460,53,5,48,3,2
21,464,464,69,64,5,2,1
15,483,483,35,2,33,4,3
3,493,493,26,26,0,1,0
13,496,496,88,82,6,2,1

4,100,100,5,2,3,2,1
2,104,104,1,1,0,1,0
14,127,127,1,1,0,1,0
34,153,153,4,1,3,2,1
3,157,157,27,6,21,4,3
32,165,165,17,17,0,1,0
8,188,188,3,3,0,1,0
7,194,194,29,29,0,1,0
18,199,199,5,2,3,2,1
31,199,199,6,6,0,1,0
15,200,200,20,8,12,4,3
6,205,205,13,13,0,1,0
29,211,211,3,3,0,1,0
39,228,228,5,5,0,1,0
35,231,231,10,10,0,1,0
38,232,232,14,2,12,4,3
19,238,238,97,71,26,3,2
36,240,240,30,30,0,1,0
26,244,244,47,7,40,3,2
23,246,246,4,4,0,1,0
17,259,259,34,5,29,2,1
22,264,264,12,6,6,3,2
9,283,283,34,34,0,1,0
37,296,296,1,1,0,1,0
0,300,300,17,17,0,1,0
20,304,304,40,40,0,1,0
24,338,338,148,148,0,1,0
13,367,367,16,16,0,1,0
16,369,369,4,1,3,2,1
40,371,371,63,35,28,2,1
30,410,410,30,30,0,1,0
28,413,413,9,1,8,3,2
25,416,416,6,3,3,2,1
5,420,420,51,7,44,4,3
1,425,425,36,10,26,4,3
42,430,430,88,21,67,4,3
33,436,436,111,25,86,3,2
27,441,441,15,4,11,2,1
12,454,454,11,1,10,2,1
11,455,455,22,4,18,3,2
21,469,469,77,65,12,2,1
41,484,484,94,94,0,1,0
10,492,492,10,10,0,1,0

21,103,103,7,7,0,1,0
24,106,106,5,5,0,1,0
22,106,106,1,1,0,1,0
16,107,107,5,5,0,1,0
6,115,115,3,3,0,1,0
11,125,125,8,2,6,3,2
3,135,135,21,13,8,2,1
43,139,139,10,10,0,1,0
12,140,140,1,1,0,1,0
7,143,143,4,4,0,1,0
9,144,144,2,2,0,1,0
39,153,153,7,3,4,2,1
28,165,165,14,14,0,1,0
47,173,173,34,27,7,2,1
48,181,181,39,39,0,1,0
26,197,197,38,18,20,2,1
23,211,211,20,20,0,1,0
33,266,266,6,3,3,2,1
17,275,275,25,15,10,2,1
14,276,276,21,12,9,2,1
10,278,278,6,6,0,1,0
4,284,284,33,33,0,1,0
29,287,287,22,16,6,3,2
2,290,290,61,61,0,1,0
19,299,299,1,1,0,1,0
42,303,303,34,28,6,3,2
36,318,318,34,28,6,2,1
25,323,323,9,3,6,2,1
35,324,324,4,4,0,1,0
45,336,336,3,3,0,1,0
15,347,347,30,2,28,2,1
18,351,351,28,28,0,1,0
44,356,356,50,13,37,3,2
8,357,357,4,1,3,2,1
51,366,366,147,59,88,3,2
0,398,398,36,36,0,1,0
40,402,402,1,1,0,1,0
20,405,405,4,4,0,1,0
13,410,410,11,11,0,1,0
50,417,417,17,17,0,1,0
34,420,420,75,62,13,2,1
1,442,442,35,14,21,4,3
37,451,451,27,15,12,2,1
46,462,462,32,20,12,4,3
31,469,469,57,39,18,3,2
32,470,470,85,13,72,3,2
41,481,481,3,3,0,1,0
49,481,481,17,2,15,2,1
27,484,484,10,4,6,2,1
30,493,493,2,2,0,1,0
5,499,499,5,5,0,1,0
38,499,499,61,31,30,4,3

12,101,101,4,4,0,1,0
40,106,106,6,6,0,1,0
33,107,107,2,2,0,1,0
18,119,119,8,4,4,2,1
34,135,135,44,44,0,1,0
22,141,141,23,23,0,1,0
38,146,146,11,1,10,2,1
14,150,150,2,2,0,1,0
5,152,152,8,8,0,1,0
37,189,189,2,2,0,1,0
15,195,195,14,5,9,2,1
13,204,204,1,1,0,1,0
25,206,206,17,11,6,2,1
4,207,207,22,6,16,3,2
24,212,212,23,4,19,3,2
39,222,222,6,1,5,2,1
27,228,228,54,54,0,1,0
35,229,229,18,18,0,1,0
31,234,234,35,26,9,2,1
28,239,239,12,12,0,1,0
36,263,263,32,22,10,2,1
11,296,296,45,45,0,1,0
23,300,300,53,22,31,2,1
32,309,309,28,8,20,2,1
41,310,310,3,3,0,1,0
9,311,311,21,4,17,3,2
26,321,321,29,29,0,1,0
1,327,327,8,3,5,2,1
17,329,329,1,1,0,1,0
3,341,341,26,14,12,4,3
21,351,351,1,1,0,1,0
8,363,363,80,70,10,2,1
29,373,373,19,1,18,3,2
2,378,378,25,3,22,4,3
16,382,382,47,47,0,1,0
42,387,387,85,85,0,1,0
10,394,394,41,41,0,1,0
7,395,395,35,27,8,2,1
30,413,413,23,23,0,1,0
19,483,483,34,20,14,2,1
0,486,486,128,128,0,1,0
6,488,488,35,1,34,3,2
20,494,494,76,2,74,3,2

26,102,102,7,7,0,1,0
9,103,103,20,20,0,1,0
21,113,113,4,1,3,2,1
24,135,135,7,1,6,3,2
2,156,156,1,1,0,1,0
20,169,169,48,36,12,4,3
17,178,178,9,1,8,2,1
6,197,197,64,64,0,1,0
10,204,204,40,8,32,3,2
13,214,214,20,20,0,1,0
30,243,243,15,15,0,1,0
8,243,243,5,5,0,1,0
28,243,243,5,5,0,1,0
5,259,259,27,5,22,2,1
16,264,264,1,1,0,1,0
0,264,264,1,1,0,1,0
11,276,276,1,1,0,1,0
22,290,290,23,23,0,1,0
31,294,294,2,2,0,1,0
25,302,302,88,88,0,1,0
33,307,307,50,32,18,2,1
27,334,334,10,10,0,1,0
18,343,343,7,4,3,2,1
7,345,345,69,69,0,1,0
12,347,347,16,16,0,1,0
34,362,362,2,2,0,1,0
15,364,364,151,78,73,4,3
29,369,369,41,41,0,1,0
32,380,380,62,26,36,3,2
35,383,383,29,29,0,1,0
1,385,385,18,18,0,1,0
19,405,405,170,67,103,4,3
4,414,414,76,39,37,2,1
23,439,439,46,46,0,1,0
3,485,485,59,35,24,2,1
14,498,498,21,21,0,1,0

34,109,109,14,14,0,1,0
17,121,121,18,6,12,4,3
20,126,126,1,1,0,1,0
38,134,134,4,4,0,1,0
26,134,134,40,4,36,3,2
3,150,150,5,5,0,1,0
15,159,159,3,3,0,1,0
12,161,161,18,6,12,2,1
31,166,166,17,17,0,1,0
10,168,168,3,3,0,1,0
8,168,168,22,12,10,2,1
22,193,193,20,20,0,1,0
33,202,202,7,3,4,2,1
1,211,211,5,5,0,1,0
18,247,247,60,60,0,1,0
5,253,253,1,1,0,1,0
35,254,254,37,13,24,3,2
19,255,255,54,54,0,1,0
4,256,256,5,5,0,1,0
0,262,262,12,12,0,1,0
25,263,263,12,12,0,1,0
39,267,267,16,6,10,3,2
9,280,280,21,16,5,2,1
21,286,286,54,54,0,1,0
30,290,290,21,5,16,4,3
6,295,295,9,6,3,2,1
37,311,311,37,28,9,2,1
23,331,331,19,1,18,3,2
2,331,331,1,1,0,1,0
29,348,348,18,9,9,2,1
14,368,368,191,101,90,3,2
7,386,386,1,1,0,1,0
11,388,388,26,3,23,3,2
27,434,434,176,158,18,4,3
16,443,443,118,21,97,4,3
36,455,455,23,23,0,1,0
24,457,457,13,2,11,2,1
28,459,459,28,28,0,1,0
32,471,471,25,7,18,3,2
13,490,490,14,14,0,1,0

22,106,106,4,4,0,1,0
7,128,128,36,36,0,1,0
26,131,131,20,8,12,4,3
10,158,158,2,2,0,1,0
16,159,159,8,8,0,1,0
30,172,172,1,1,0,1,0
13,178,178,5,5,0,1,0
9,193,193,5,5,0,1,0
31,204,204,3,3,0,1,0
35,206,206,108,84,24,3,2
27,206,206,17,13,4,2,1
34,223,223,51,37,14,3,2
21,229,229,5,5,0,1,0
39,243,243,2,2,0,1,0
24,249,249,30,30,0,1,0
20,257,257,25,25,0,1,0
6,265,265,10,10,0,1,0
32,270,270,13,3,10,3,2
23,306,306,15,6,9,2,1
14,307,307,33,33,0,1,0
1,316,316,98,85,13,2,1
36,321,321,7,7,0,1,0
5,369,369,66,66,0,1,0
17,370,370,75,75,0,1,0
12,374,374,42,42,0,1,0
8,398,398,13,13,0,1,0
33,404,404,51,23,28,3,2
37,404,404,36,36,0,1,0
3,408,408,8,8,0,1,0
11,410,410,12,7,5,2,1
0,411,411,17,17,0,1,0
4,412,412,17,9,8,3,2
25,414,414,69,37,32,3,2
19,416,416,6,6,0,1,0
18,425,425,2,2,0,1,0
15,456,456,133,133,0,1,0
38,472,472,87,79,8,2,1
2,474,474,85,85,0,1,0
28,480,480,24,11,13,2,1
29,485,485,6,6,0,1,0

11,106,106,14,14,0,1,0
30,114,114,6,6,0,1,0
13,121,121,8,8,0,1,0
21,139,139,10,10,0,1,0
29,155,155,32,18,14,3,2
0,166,166,19,19,0,1,0
16,167,167,2,2,0,1,0
14,176,176,3,3,0,1,0
3,185,185,11,6,5,2,1
8,196,196,42,42,0,1,0
9,199,199,24,2,22,3,2
35,219,219,34,14,20,2,1
2,225,225,43,1,42,3,2
33,226,226,15,15,0,1,0
39,238,238,13,5,8,3,2
31,244,244,2,2,0,1,0
23,258,258,21,7,14,3,2
6,270,270,3,3,0,1,0
32,286,286,54,5,49,3,2
19,300,300,30,10,20,3,2
4,304,304,23,23,0,1,0
26,307,307,5,1,4,2,1
15,313,313,48,48,0,1,0
20,333,333,27,27,0,1,0
27,335,335,28,16,12,3,2
7,340,340,30,4,26,3,2
25,342,342,14,14,0,1,0
28,343,343,37,25,12,2,1
22,375,375,49,36,13,2,1
5,378,378,15,15,0,1,0
10,394,394,61,55,6,3,2
34,397,397,13,13,0,1,0
17,400,400,21,5,16,3,2
36,401,401,45,45,0,1,0
38,405,405,21,21,0,1,0
24,433,433,154,146,8,3,2
12,442,442,40,40,0,1,0
1,453,453,30,30,0,1,0
37,463,463,63,53,10,2,1
18,473,473,115,115,0,1,0

23,117,117,23,23,0,1,0
28,118,118,2,2,0,1,0
21,125,125,6,6,0,1,0
12,144,144,6,6,0,1,0
3,147,147,6,6,0,1,0
2,148,148,24,16,8,2,1
5,152,152,5,2,3,2,1
10,161,161,14,14,0,1,0
29,161,161,7,7,0,1,0
13,170,170,6,6,0,1,0
31,180,180,1,1,0,1,0
37,193,193,47,17,30,2,1
25,207,207,20,20,0,1,0
35,218,218,7,7,0,1,0
20,223,223,19,12,7,2,1
17,229,229,11,1,10,3,2
7,251,251,4,4,0,1,0
22,259,259,27,27,0,1,0
38,269,269,15,15,0,1,0
15,294,294,36,16,20,3,2
33,294,294,55,32,23,3,2
18,297,297,40,40,0,1,0
14,301,301,16,16,0,1,0
24,309,309,1,1,0,1,0
4,318,318,107,24,83,4,3
9,318,318,7,7,0,1,0
27,324,324,14,14,0,1,0
0,325,325,88,67,21,2,1
6,372,372,7,1,6,2,1
34,375,375,22,22,0,1,0
1,383,383,15,1,14,2,1
32,386,386,30,11,19,2,1
11,427,427,89,70,19,2,1
26,435,435,58,26,32,2,1
36,439,439,73,30,43,2,1
30,448,448,190,190,0,1,0
8,449,449,95,63,32,2,1
16,478,478,58,58,0,1,0
19,496,496,18,3,15,4,3

23,112,112,3,3,0,1,0
13,133,133,7,4,3,2,1
20,133,133,9,9,0,1,0
40,134,134,3,3,0,1,0
32,134,134,14,5,9,4,3
43,145,145,1,1,0,1,0
37,152,152,34,2,32,3,2
39,154,154,32,32,0,1,0
16,162,162,21,5,16,3,2
6,176,176,6,6,0,1,0
31,183,183,2,2,0,1,0
9,204,204,9,9,0,1,0
24,208,208,8,8,0,1,0
44,213,213,35,35,0,1,0
2,220,220,57,18,39,4,3
7,222,222,3,3,0,1,0
14,232,232,3,3,0,1,0
5,233,233,17,5,12,4,3
3,243,243,17,17,0,1,0
25,244,244,69,22,47,2,1
0,257,257,15,3,12,4,3
15,262,262,55,55,0,1,0
4,286,286,22,4,18,4,3
22,291,291,19,7,12,4,3
28,297,297,15,15,0,1,0
12,302,302,13,13,0,1,0
27,302,302,51,19,32,3,2
21,307,307,47,37,10,2,1
1,312,312,14,14,0,1,0
38,315,315,3,3,0,1,0
29,316,316,78,36,42,3,2
33,326,326,22,10,12,3,2
34,350,350,57,49,8,3,2
26,361,361,18,10,8,2,1
41,370,370,15,6,9,4,3
17,395,395,3,3,0,1,0
19,399,399,20,6,14,2,1
18,427,427,55,55,0,1,0
11,429,429,53,4,49,2,1
35,430,430,67,67,0,1,0
36,432,432,2,2,0,1,0
8,452,452,33,8,25,2,1
10,487,487,70,24,46,2,1
42,489,489,19,12,7,2,1
30,498,498,11,6,5,2,1

31,112,112,5,5,0,1,0
38,122,122,2,2,0,1,0
32,143,143,18,18,0,1,0
23,148,148,4,4,0,1,0
40,154,154,45,45,0,1,0
27,163,163,20,20,0,1,0
4,164,164,14,14,0,1,0
11,190,190,8,8,0,1,0
30,211,211,26,26,0,1,0
21,214,214,47,47,0,1,0
14,217,217,54,54,0,1,0
5,225,225,1,1,0,1,0
0,253,253,1,1,0,1,0
6,253,253,10,10,0,1,0
19,260,260,40,10,30,2,1
28,267,267,13,13,0,1,0
25,270,270,25,25,0,1,0
17,271,271,21,5,16,3,2
24,274,274,42,26,16,3,2
26,287,287,16,1,15,2,1
3,292,292,15,15,0,1,0
16,299,299,57,1,56,3,2
10,313,313,9,9,0,1,0
39,319,319,82,82,0,1,0
13,323,323,20,20,0,1,0
29,325,325,42,42,0,1,0
12,329,329,62,35,27,2,1
34,335,335,41,21,20,3,2
1,337,337,47,47,0,1,0
33,346,346,8,3,5,2,1
15,353,353,22,2,20,2,1
2,374,374,72,72,0,1,0
18,390,390,26,16,10,3,2
36,409,409,25,19,6,3,2
22,431,431,2,2,0,1,0
9,443,443,7,4,3,2,1
8,445,445,47,13,34,2,1
7,451,451,72,72,0,1,0
20,452,452,37,2,35,3,2
37,468,468,40,16,24,3,2
35,480,480,17,10,7,2,1

39,165,165,1,1,0,1,0
13,167,167,28,28,0,1,0
20,169,169,24,24,0,1,0
31,176,176,15,15,0,1,0
7,182,182,26,20,6,2,1
18,195,195,38,38,0,1,0
16,213,213,8,2,6,3,2
28,221,221,16,16,0,1,0
19,228,228,18,18,0,1,0
35,229,229,9,9,0,1,0
4,239,239,18,18,0,1,0
12,247,247,25,11,14,2,1
6,257,257,4,1,3,2,1
37,271,271,28,28,0,1,0
40,277,277,44,38,6,3,2
33,283,283,8,8,0,1,0
3,286,286,15,15,0,1,0
41,296,296,35,35,0,1,0
5,297,297,33,33,0,1,0
32,310,310,28,28,0,1,0
27,321,321,42,3,39,4,3
1,322,322,26,26,0,1,0
21,331,331,30,30,0,1,0
30,358,358,33,33,0,1,0
10,362,362,17,3,14,3,2
2,372,372,119,14,105,4,3
11,372,372,46,6,40,3,2
36,374,374,72,33,39,4,3
9,381,381,14,14,0,1,0
25,381,381,10,1,9,4,3
29,395,395,79,79,0,1,0
42,399,399,56,56,0,1,0
23,402,402,27,3,24,4,3
0,410,410,10,10,0,1,0
8,412,412,21,12,9,4,3
24,424,424,93,51,42,4,3
38,425,425,61,28,33,3,2
15,451,451,10,10,0,1,0
34,454,454,50,50,0,1,0
14,470,470,20,20,0,1,0
22,490,490,5,5,0,1,0
17,493,493,16,1,15,2,1
26,499,499,6,6,0,1,0

10,100,100,7,7,0,1,0
31,103,103,8,8,0,1,0
0,127,127,7,7,0,1,0
19,137,137,14,14,0,1,0
21,171,171,9,9,0,1,0
12,182,182,25,2,23,4,3
27,200,200,16,7,9,4,3
23,201,201,7,7,0,1,0
22,218,218,47,25,22,3,2
36,227,227,4,1,3,2,1
33,229,229,21,21,0,1,0
38,229,229,34,10,24,3,2
2,236,236,32,5,27,4,3
7,237,237,14,14,0,1,0
28,242,242,9,9,0,1,0
26,263,263,19,19,0,1,0
20,277,277,5,5,0,1,0
8,284,284,1,1,0,1,0
14,300,300,25,9,16,2,1
37,312,312,36,7,29,4,3
39,323,323,48,48,0,1,0
4,354,354,4,4,0,1,0
30,357,357,7,2,5,2,1
15,364,364,89,89,0,1,0
13,370,370,10,2,8,3,2
34,374,374,67,67,0,1,0
32,409,409,152,66,86,4,3
17,421,421,140,140,0,1,0
24,428,428,57,57,0,1,0
3,435,435,13,5,8,2,1
1,437,437,2,2,0,1,0
9,437,437,68,68,0,1,0
5,447,447,57,25,32,3,2
11,454,454,59,38,21,4,3
29,463,463,17,17,0,1,0
6,483,483,18,8,10,2,1
18,484,484,83,39,44,3,2
25,486,486,6,2,4,2,1
16,493,493,44,44,0,1,0
35,499,499,84,25,59,4,3

6,103,103,5,5,0,1,0
30,122,122,5,5,0,1,0
17,132,132,30,26,4,2,1
27,133,133,15,15,0,1,0
9,155,155,1,1,0,1,0
34,180,180,52,2,50,3,2
22,189,189,7,7,0,1,0
28,215,215,7,7,0,1,0
36,221,221,6,6,0,1,0
29,231,231,11,8,3,2,1
14,250,250,26,26,0,1,0
4,257,257,1,1,0,1,0
33,271,271,21,21,0,1,0
20,276,276,19,2,17,2,1
25,286,286,1,1,0,1,0
13,290,290,1,1,0,1,0
3,294,294,61,19,42,4,3
19,296,296,4,4,0,1,0
12,302,302,18,4,14,2,1
24,304,304,54,54,0,1,0
15,313,313,22,1,21,2,1
0,315,315,54,27,27,4,3
8,320,320,23,23,0,1,0
23,332,332,44,14,30,2,1
37,351,351,67,12,55,3,2
32,360,360,9,9,0,1,0
7,374,374,7,7,0,1,0
40,377,377,13,13,0,1,0
1,398,398,121,71,50,2,1
5,406,406,20,2,18,4,3
16,407,407,61,39,22,2,1
26,419,419,2,2,0,1,0
31,440,440,115,86,29,2,1
11,443,443,36,36,0,1,0
2,452,452,40,7,33,2,1
35,454,454,43,43,0,1,0
38,456,456,41,5,36,3,2
39,460,460,157,157,0,1,0
18,470,470,85,65,20,3,2
10,481,481,35,35,0,1,0
21,499,499,4,4,0,1,0

29,102,102,1,1,0,1,0
11,155,155,6,6,0,1,0
27,163,163,1,1,0,1,0
4,168,168,29,29,0,1,0
43,211,211,10,10,0,1,0
22,214,214,5,5,0,1,0
39,215,215,17,17,0,1,0
2,224,224,23,23,0,1,0
25,231,231,12,12,0,1,0
42,235,235,6,6,0,1,0
5,238,238,12,9,3,2,1
14,241,241,9,9,0,1,0
37,246,246,12,12,0,1,0
6,264,264,1,1,0,1,0
0,264,264,46,46,0,1,0
7,300,300,55,24,31,2,1
28,302,302,72,24,48,3,2
21,310,310,19,4,15,4,3
32,312,312,2,2,0,1,0
40,314,314,21,21,0,1,0
13,315,315,12,12,0,1,0
41,329,329,4,4,0,1,0
20,331,331,4,4,0,1,0
3,333,333,21,21,0,1,0
19,338,338,6,1,5,2,1
34,342,342,176,176,0,1,0
18,344,344,35,7,28,3,2
1,348,348,27,24,3,2,1
10,383,383,24,14,10,3,2
23,385,385,75,47,28,2,1
36,422,422,45,45,0,1,0
30,424,424,107,58,49,3,2
15,426,426,88,12,76,3,2
38,438,438,62,46,16,2,1
17,444,444,36,5,31,2,1
8,446,446,92,8,84,3,2
35,449,449,9,1,8,3,2
16,454,454,25,25,0,1,0
31,460,460,140,96,44,3,2
33,474,474,21,12,9,2,1
12,478,478,14,14,0,1,0
24,478,478,23,13,10,2,1
26,484,484,4,4,0,1,0
9,492,492,4,4,0,1,0

21,105,105,1,1,0,1,0
5,107,107,11,3,8,3,2
7,126,126,9,9,0,1,0
36,129,129,1,1,0,1,0
27,142,142,20,20,0,1,0
12,145,145,18,18,0,1,0
4,153,153,2,2,0,1,0
11,170,170,8,8,0,1,0
18,175,175,26,26,0,1,0
39,185,185,10,5,5,2,1
1,187,187,21,12,9,2,1
25,240,240,4,4,0,1,0
38,261,261,3,3,0,1,0
13,266,266,38,38,0,1,0
9,272,272,14,3,11,2,1
29,289,289,58,58,0,1,0
8,289,289,68,19,49,2,1
6,290,290,17,8,9,4,3
31,302,302,50,50,0,1,0
37,310,310,45,45,0,1,0
32,310,310,34,34,0,1,0
17,315,315,2,2,0,1,0
3,322,322,55,1,54,4,3
2,326,326,27,12,15,2,1
35,333,333,98,98,0,1,0
28,344,344,57,9,48,3,2
10,351,351,15,4,11,2,1
19,354,354,75,39,36,3,2
33,361,361,21,21,0,1,0
30,365,365,8,8,0,1,0
14,375,375,76,41,35,2,1
34,376,376,25,25,0,1,0
40,398,398,59,18,41,2,1
26,408,408,131,4,127,4,3
16,410,410,4,4,0,1,0
22,422,422,5,1,4,2,1
15,446,446,1,1,0,1,0
0,447,447,7,7,0,1,0
23,481,481,7,7,0,1,0
24,490,490,37,4,33,2,1
20,500,500,74,41,33,2,1

9,104,104,15,6,9,2,1
13,108,108,30,30,0,1,0
18,132,132,15,15,0,1,0
4,137,137,61,34,27,4,3
5,143,143,48,48,0,1,0
24,148,148,33,33,0,1,0
11,175,175,14,6,8,2,1
20,184,184,8,8,0,1,0
30,187,187,15,15,0,1,0
15,191,191,20,20,0,1,0
10,204,204,1,1,0,1,0
29,204,204,9,9,0,1,0
26,221,221,43,43,0,1,0
22,221,221,16,16,0,1,0
27,257,257,23,23,0,1,0
14,261,261,7,7,0,1,0
3,277,277,4,1,3,2,1
17,284,284,7,7,0,1,0
19,288,288,15,15,0,1,0
0,290,290,141,137,4,2,1
6,291,291,3,3,0,1,0
16,309,309,14,14,0,1,0
31,348,348,37,26,11,2,1
12,354,354,1,1,0,1,0
8,355,355,3,3,0,1,0
2,373,373,30,30,0,1,0
1,378,378,38,8,30,4,3
25,391,391,64,25,39,4,3
28,412,412,43,43,0,1,0
32,419,419,65,38,27,2,1
23,430,430,118,76,42,4,3
21,452,452,1,1,0,1,0
7,459,459,7,1,6,2,1
33,491,491,62,62,0,1,0

14,104,104,13,13,0,1,0
8,124,124,9,9,0,1,0
36,134,134,17,2,15,2,1
23,153,153,7,7,0,1,0
25,156,156,13,13,0,1,0
6,164,164,10,2,8,3,2
0,166,166,10,10,0,1,0
11,167,167,1,1,0,1,0
26,192,192,6,3,3,2,1
17,206,206,27,27,0,1,0
31,233,233,2,2,0,1,0
15,251,251,10,5,5,2,1
33,252,252,68,47,21,2,1
41,270,270,24,14,10,2,1
7,275,275,7,7,0,1,0
5,276,276,18,18,0,1,0
4,286,286,43,19,24,2,1
12,287,287,41,32,9,4,3
18,291,291,39,39,0,1,0
29,302,302,28,28,0,1,0
9,304,304,23,9,14,4,3
10,304,304,76,16,60,3,2
24,309,309,48,32,16,2,1
2,319,319,8,8,0,1,0
3,338,338,1,1,0,1,0
34,356,356,25,9,16,3,2
21,368,368,12,12,0,1,0
13,381,381,16,16,0,1,0
39,419,419,75,63,12,2,1
40,420,420,27,27,0,1,0
32,421,421,64,64,0,1,0
37,422,422,54,54,0,1,0
28,439,439,24,15,9,4,3
19,441,441,39,39,0,1,0
42,452,452,53,53,0,1,0
35,453,453,108,63,45,4,3
27,468,468,11,11,0,1,0
16,470,470,8,2,6,2,1
1,473,473,121,87,34,3,2
30,480,480,20,6,14,3,2
22,487,487,85,33,52,3,2
38,490,490,32,32,0,1,0
20,492,492,11,11,0,1,0

2,100,100,7,7,0,1,0
23,120,120,28,13,15,4,3
0,140,140,6,6,0,1,0
35,155,155,40,40,0,1,0
36,197,197,53,53,0,1,0
11,201,201,21,21,0,1,0
25,203,203,7,3,4,2,1
42,203,203,7,7,0,1,0
30,207,207,3,3,0,1,0
20,213,213,18,18,0,1,0
37,223,223,40,19,21,4,3
19,230,230,10,10,0,1,0
39,247,247,60,60,0,1,0
29,250,250,19,11,8,3,2
12,257,257,41,41,0,1,0
13,261,261,4,4,0,1,0
7,265,265,44,36,8,3,2
33,290,290,5,5,0,1,0
43,292,292,61,61,0,1,0
5,304,304,16,16,0,1,0
31,332,332,18,9,9,4,3
9,332,332,10,10,0,1,0
16,337,337,82,82,0,1,0
8,344,344,118,103,15,2,1
10,349,349,13,9,4,2,1
21,366,366,26,12,14,2,1
28,373,373,15,15,0,1,0
1,387,387,1,1,0,1,0
22,390,390,11,11,0,1,0
40,399,399,23,9,14,3,2
14,399,399,3,3,0,1,0
27,416,416,15,15,0,1,0
26,423,423,10,6,4,2,1
4,423,423,13,2,11,3,2
15,424,424,18,18,0,1,0
24,425,425,21,9,12,3,2
34,428,428,6,6,0,1,0
18,431,431,27,27,0,1,0
32,437,437,88,88,0,1,0
38,440,440,70,6,64,3,2
6,440,440,18,18,0,1,0
17,452,452,1,1,0,1,0
41,469,469,29,29,0,1,0
3,500,500,45,45,0,1,0

21,122,122,14,14,0,1,0
2,126,126,7,7,0,1,0
9,149,149,6,6,0,1,0
3,152,152,1,1,0,1,0
25,153,153,11,11,0,1,0
34,154,154,41,41,0,1,0
0,169,169,21,21,0,1,0
7,174,174,2,2,0,1,0
39,187,187,36,36,0,1,0
24,192,192,1,1,0,1,0
13,202,202,1,1,0,1,0
23,220,220,12,12,0,1,0
26,224,224,49,49,0,1,0
30,226,226,37,1,36,4,3
42,237,237,43,43,0,1,0
4,238,238,37,37,0,1,0
6,247,247,19,9,10,3,2
43,248,248,11,2,9,2,1
14,252,252,3,3,0,1,0
41,263,263,61,57,4,2,1
32,270,270,3,3,0,1,0
27,272,272,3,3,0,1,0
37,278,278,16,16,0,1,0
1,290,290,9,9,0,1,0
22,294,294,5,2,3,2,1
33,296,296,13,1,12,3,2
18,307,307,10,10,0,1,0
12,313,313,81,19,62,3,2
16,315,315,27,13,14,4,3
5,322,322,17,9,8,2,1
20,345,345,12,12,0,1,0
29,346,346,9,1,8,3,2
15,352,352,39,5,34,2,1
11,365,365,5,5,0,1,0
19,366,366,37,15,22,3,2
46,368,368,33,16,17,2,1
8,375,375,13,13,0,1,0
38,384,384,45,45,0,1,0
28,402,402,20,20,0,1,0
35,405,405,9,2,7,2,1
17,410,410,58,58,0,1,0
36,414,414,24,3,21,4,3
40,432,432,54,54,0,1,0
44,443,443,82,43,39,4,3
10,479,479,65,36,29,2,1
45,482,482,55,55,0,1,0
31,484,484,22,22,0,1,0

41,101,101,3,3,0,1,0
8,103,103,1,1,0,1,0
5,112,112,24,24,0,1,0
37,133,133,11,4,7,2,1
17,139,139,1,1,0,1,0
24,146,146,4,4,0,1,0
11,146,146,39,39,0,1,0
31,156,156,9,3,6,2,1
3,164,164,1,1,0,1,0
14,164,164,12,12,0,1,0
25,184,184,1,1,0,1,0
16,186,186,4,4,0,1,0
35,191,191,27,8,19,2,1
7,215,215,4,1,3,2,1
32,221,221,25,7,18,3,2
18,224,224,53,53,0,1,0
13,245,245,46,46,0,1,0
19,245,245,42,42,0,1,0
33,245,245,30,20,10,2,1
1,252,252,15,12,3,2,1
29,259,259,28,8,20,3,2
36,263,263,19,2,17,4,3
21,269,269,11,11,0,1,0
27,271,271,36,36,0,1,0
9,293,293,42,36,6,3,2
6,310,310,1,1,0,1,0
30,312,312,50,26,24,4,3
2,315,315,15,12,3,2,1
42,317,317,48,36,12,2,1
22,318,318,6,6,0,1,0
44,321,321,16,16,0,1,0
43,324,324,32,21,11,2,1
26,334,334,48,48,0,1,0
12,384,384,11,11,0,1,0
23,384,384,19,19,0,1,0
10,410,410,45,9,36,4,3
0,418,418,1,1,0,1,0
38,421,421,131,124,7,2,1
34,440,440,30,30,0,1,0
4,440,440,23,23,0,1,0
15,454,454,33,9,24,4,3
39,462,462,53,53,0,1,0
20,478,478,63,36,27,2,1
40,486,486,33,7,26,2,1
28,500,500,3,3,0,1,0

29,131,131,23,2,21,2,1
13,138,138,27,18,9,4,3
9,142,142,4,4,0,1,0
1,147,147,32,32,0,1,0
39,152,152,24,24,0,1,0
5,160,160,14,14,0,1,0
12,174,174,8,8,0,1,0
10,189,189,3,3,0,1,0
25,191,191,13,13,0,1,0
8,195,195,2,2,0,1,0
3,199,199,13,13,0,1,0
24,199,199,17,17,0,1,0
41,201,201,10,10,0,1,0
20,211,211,12,12,0,1,0
34,224,224,14,14,0,1,0
30,233,233,40,34,6,3,2
27,234,234,19,14,5,2,1
33,263,263,1,1,0,1,0
46,281,281,40,40,0,1,0
18,287,287,5,5,0,1,0
45,297,297,11,11,0,1,0
40,299,299,91,41,50,2,1
7,301,301,5,1,4,2,1
35,302,302,25,8,17,2,1
44,335,335,46,46,0,1,0
4,339,339,32,1,31,2,1
32,352,352,42,7,35,2,1
38,363,363,21,21,0,1,0
43,369,369,24,24,0,1,0
0,372,372,4,1,3,2,1
37,399,399,40,4,36,4,3
23,401,401,15,7,8,3,2
22,404,404,59,32,27,4,3
14,411,411,64,19,45,4,3
31,413,413,18,6,12,4,3
47,415,415,2,2,0,1,0
16,428,428,14,14,0,1,0
36,429,429,43,43,0,1,0
2,432,432,26,26,0,1,0
19,447,447,109,61,48,4,3
28,455,455,66,53,13,2,1
6,459,459,14,14,0,1,0
11,461,461,19,19,0,1,0
26,473,473,14,4,10,2,1
17,485,485,47,47,0,1,0
42,486,486,38,38,0,1,0
15,488,488,8,2,6,2,1
21,498,498,7,1,6,2,1

38,109,109,8,2,6,2,1
10,110,110,32,1,31,2,1
1,121,121,5,5,0,1,0
19,125,125,6,6,0,1,0
14,126,126,10,2,8,3,2
24,128,128,2,2,0,1,0
17,131,131,12,12,0,1,0
22,145,145,29,29,0,1,0
32,153,153,11,6,5,2,1
30,154,154,8,4,4,2,1
11,161,161,5,5,0,1,0
43,172,172,90,90,0,1,0
0,180,180,3,3,0,1,0
20,209,209,19,10,9,4,3
41,210,210,10,4,6,3,2
29,234,234,18,2,16,3,2
15,245,245,5,5,0,1,0
35,247,247,4,1,3,2,1
34,254,254,2,2,0,1,0
16,254,254,1,1,0,1,0
5,269,269,34,28,6,3,2
6,270,270,27,9,18,2,1
12,277,277,3,3,0,1,0
8,278,278,23,23,0,1,0
13,283,283,11,11,0,1,0
23,290,290,20,14,6,3,2
9,305,305,24,20,4,2,1
21,320,320,13,13,0,1,0
42,334,334,11,3,8,3,2
40,340,340,11,11,0,1,0
3,367,367,12,8,4,2,1
25,369,369,25,25,0,1,0
4,376,376,1,1,0,1,0
26,380,380,90,64,26,4,3
47,388,388,9,9,0,1,0
39,390,390,71,29,42,4,3
18,395,395,24,3,21,4,3
7,410,410,2,2,0,1,0
31,416,416,11,11,0,1,0
44,416,416,28,28,0,1,0
36,425,425,39,19,20,2,1
2,426,426,36,11,25,4,3
33,431,431,240,130,110,4,3
46,431,431,5,5,0,1,0
28,436,436,7,7,0,1,0
45,443,443,3,3,0,1,0
27,446,446,15,12,3,2,1
37,468,468,56,56,0,1,0

1,107,107,76,76,0,1,0
23,118,118,7,2,5,2,1
15,137,137,23,23,0,1,0
11,151,151,2,2,0,1,0
14,176,176,28,28,0,1,0
26,206,206,14,14,0,1,0
31,207,207,53,53,0,1,0
22,208,208,8,8,0,1,0
3,213,213,8,8,0,1,0
10,230,230,1,1,0,1,0
21,232,232,40,40,0,1,0
17,237,237,8,3,5,2,1
16,254,254,48,48,0,1,0
5,276,276,20,20,0,1,0
24,294,294,102,102,0,1,0
28,306,306,27,27,0,1,0
30,320,320,4,4,0,1,0
12,322,322,64,42,22,2,1
8,349,349,38,10,28,2,1
19,393,393,47,27,20,3,2
9,399,399,71,26,45,4,3
18,451,451,28,28,0,1,0
29,457,457,7,7,0,1,0
7,459,459,98,98,0,1,0
20,467,467,19,10,9,4,3
6,475,475,3,3,0,1,0
32,478,478,50,50,0,1,0
25,483,483,26,21,5,2,1
0,490,490,76,31,45,2,1
27,491,491,17,2,15,3,2
33,494,494,9,9,0,1,0
2,496,496,15,15,0,1,0
13,497,497,85,48,37,2,1
4,497,497,50,4,46,3,2

25,112,112,2,2,0,1,0
15,114,114,39,5,34,2,1
34,161,161,8,8,0,1,0
5,178,178,5,5,0,1,0
28,179,179,8,8,0,1,0
7,195,195,31,12,19,3,2
21,200,200,16,16,0,1,0
22,202,202,2,2,0,1,0
3,206,206,16,2,14,2,1
13,210,210,21,4,17,2,1
6,214,214,14,14,0,1,0
11,217,217,45,8,37,2,1
12,219,219,17,17,0,1,0
18,243,243,70,19,51,4,3
26,273,273,1,1,0,1,0
23,297,297,52,52,0,1,0
17,308,308,1,1,0,1,0
9,328,328,17,7,10,3,2
35,329,329,7,7,0,1,0
2,329,329,14,10,4,2,1
0,339,339,6,6,0,1,0
16,346,346,2,2,0,1,0
24,360,360,134,134,0,1,0
19,364,364,60,60,0,1,0
4,366,366,74,52,22,3,2
27,372,372,47,5,42,4,3
10,374,374,56,56,0,1,0
20,392,392,25,25,0,1,0
30,397,397,29,10,19,2,1
33,399,399,18,18,0,1,0
8,419,419,32,32,0,1,0
32,432,432,116,95,21,2,1
1,440,440,117,7,110,4,3
31,461,461,15,15,0,1,0
14,479,479,69,69,0,1,0
29,497,497,95,95,0,1,0

20,109,109,1,1,0,1,0
11,110,110,5,2,3,2,1
0,112,112,1,1,0,1,0
1,112,112,7,7,0,1,0
9,128,128,5,5,0,1,0
18,138,138,4,4,0,1,0
15,141,141,18,6,12,4,3
28,173,173,90,12,78,4,3
13,181,181,1,1,0,1,0
3,184,184,39,39,0,1,0
14,187,187,1,1,0,1,0
25,188,188,2,2,0,1,0
17,216,216,9,9,0,1,0
31,217,217,29,21,8,3,2
12,236,236,144,94,50,3,2
24,247,247,13,13,0,1,0
6,282,282,96,6,90,4,3
7,318,318,30,30,0,1,0
10,335,335,8,8,0,1,0
32,366,366,30,30,0,1,0
27,372,372,80,54,26,4,3
21,377,377,4,4,0,1,0
30,394,394,38,38,0,1,0
26,398,398,62,62,0,1,0
5,399,399,34,10,24,3,2
22,414,414,9,9,0,1,0
4,419,419,42,3,39,4,3
23,426,426,7,7,0,1,0
29,431,431,127,107,20,2,1
2,451,451,151,102,49,2,1
19,457,457,97,85,12,2,1
16,458,458,1,1,0,1,0
8,479,479,21,11,10,3,2

9,101,101,3,3,0,1,0
0,129,129,27,5,22,3,2
18,152,152,3,3,0,1,0
31,165,165,31,1,30,2,1
28,172,172,7,4,3,2,1
21,180,180,30,12,18,3,2
23,186,186,17,17,0,1,0
17,188,188,30,4,26,3,2
36,193,193,13,1,12,4,3
35,206,206,59,45,14,2,1
29,227,227,47,47,0,1,0
13,235,235,27,27,0,1,0
3,243,243,114,30,84,4,3
8,254,254,2,2,0,1,0
34,267,267,7,2,5,2,1
5,270,270,18,3,15,2,1
16,280,280,74,65,9,4,3
2,288,288,21,21,0,1,0
11,301,301,10,10,0,1,0
6,311,311,4,4,0,1,0
15,327,327,9,1,8,3,2
22,331,331,12,7,5,2,1
7,341,341,9,9,0,1,0
19,343,343,36,16,20,2,1
4,351,351,118,118,0,1,0
20,352,352,50,50,0,1,0
26,354,354,3,3,0,1,0
25,364,364,4,4,0,1,0
14,380,380,3,3,0,1,0
30,421,421,4,4,0,1,0
32,426,426,65,14,51,4,3
24,435,435,1,1,0,1,0
27,442,442,33,33,0,1,0
10,451,451,42,42,0,1,0
1,452,452,102,8,94,3,2
12,491,491,2,2,0,1,0
33,495,495,119,119,0,1,0

16,112,112,2,2,0,1,0
2,117,117,17,17,0,1,0
5,120,120,1,1,0,1,0
19,134,134,20,20,0,1,0
1,135,135,13,13,0,1,0
38,137,137,3,3,0,1,0
7,144,144,1,1,0,1,0
26,145,145,39,39,0,1,0
34,146,146,14,14,0,1,0
3,156,156,13,13,0,1,0
15,163,163,7,3,4,2,1
4,165,165,8,8,0,1,0
14,169,169,1,1,0,1,0
31,179,179,11,11,0,1,0
20,192,192,22,22,0,1,0
39,193,193,3,3,0,1,0
32,219,219,1,1,0,1,0
12,229,229,1,1,0,1,0
18,270,270,77,44,33,4,3
29,285,285,87,87,0,1,0
21,285,285,6,6,0,1,0
11,287,287,4,1,3,2,1
8,292,292,30,30,0,1,0
33,303,303,10,10,0,1,0
0,306,306,120,112,8,3,2
6,312,312,22,8,14,2,1
40,317,317,57,57,0,1,0
10,317,317,5,5,0,1,0
25,335,335,27,12,15,4,3
35,350,350,15,15,0,1,0
28,364,364,31,15,16,3,2
37,367,367,2,2,0,1,0
9,369,369,15,15,0,1,0
22,399,399,79,69,10,2,1
27,432,432,84,56,28,3,2
36,433,433,13,3,10,2,1
30,455,455,70,55,15,2,1
23,465,465,99,7,92,3,2
13,478,478,72,42,30,2,1
24,493,493,14,14,0,1,0
17,499,499,104,37,67,4,3

27,101,101,28,2,26,2,1
28,105,105,5,5,0,1,0
19,107,107,3,3,0,1,0
31,142,142,13,13,0,1,0
0,148,148,4,4,0,1,0
4,163,163,11,2,9,2,1
18,176,176,8,8,0,1,0
15,183,183,4,4,0,1,0
26,183,183,30,20,10,2,1
1,196,196,14,14,0,1,0
39,199,199,15,1,14,2,1
40,203,203,26,26,0,1,0
36,212,212,30,14,16,2,1
23,232,232,39,39,0,1,0
14,233,233,29,29,0,1,0
25,238,238,11,11,0,1,0
3,245,245,5,5,0,1,0
12,261,261,10,10,0,1,0
7,266,266,6,6,0,1,0
11,290,290,55,55,0,1,0
33,300,300,27,27,0,1,0
24,300,300,1,1,0,1,0
8,304,304,12,12,0,1,0
32,314,314,21,6,15,4,3
10,316,316,7,7,0,1,0
30,318,318,9,9,0,1,0
21,345,345,4,1,3,2,1
20,363,363,52,52,0,1,0
29,380,380,30,30,0,1,0
5,380,380,16,5,11,2,1
34,396,396,98,1,97,4,3
9,401,401,105,105,0,1,0
35,408,408,16,16,0,1,0
2,422,422,170,161,9,4,3
22,437,437,7,3,4,2,1
17,448,448,88,8,80,3,2
13,462,462,55,3,52,3,2
38,470,470,116,59,57,4,3
6,474,474,33,28,5,2,1
37,479,479,34,6,28,2,1
16,484,484,23,6,17,4,3

2,100,100,22,6,16,4,3
15,107,107,4,4,0,1,0
17,113,113,1,1,0,1,0
35,113,113,1,1,0,1,0
0,118,118,13,13,0,1,0
36,130,130,12,12,0,1,0
24,183,183,10,10,0,1,0
22,200,200,34,34,0,1,0
11,203,203,3,3,0,1,0
16,213,213,1,1,0,1,0
7,229,229,76,76,0,1,0
6,230,230,5,5,0,1,0
29,233,233,38,3,35,3,2
37,237,237,26,26,0,1,0
30,247,247,132,132,0,1,0
3,262,262,77,39,38,4,3
33,272,272,5,5,0,1,0
21,276,276,11,11,0,1,0
34,276,276,26,19,7,2,1
12,276,276,50,12,38,3,2
38,340,340,29,29,0,1,0
31,345,345,13,13,0,1,0
28,350,350,18,8,10,3,2
10,358,358,9,3,6,2,1
26,362,362,14,14,0,1,0
25,366,366,27,12,15,2,1
1,378,378,36,36,0,1,0
5,402,402,3,3,0,1,0
27,411,411,9,9,0,1,0
20,426,426,18,18,0,1,0
4,442,442,26,10,16,2,1
14,446,446,20,1,19,4,3
9,452,452,170,170,0,1,0
23,453,453,20,20,0,1,0
18,457,457,17,9,8,3,2
13,474,474,29,2,27,2,1
8,480,480,34,34,0,1,0
19,491,491,75,43,32,2,1
32,495,495,97,15,82,3,2

35,100,100,3,3,0,1,0
4,103,103,15,7,8,2,1
16,111,111,1,1,0,1,0
1,112,112,2,2,0,1,0
23,112,112,7,4,3,2,1
12,118,118,9,1,8,3,2
18,137,137,3,3,0,1,0
21,161,161,17,2,15,2,1
40,178,178,8,5,3,2,1
10,185,185,38,38,0,1,0
15,187,187,1,1,0,1,0
29,202,202,17,9,8,3,2
20,207,207,37,6,31,2,1
37,228,228,10,10,0,1,0
38,252,252,50,50,0,1,0
26,262,262,62,45,17,2,1
33,281,281,9,9,0,1,0
3,291,291,112,74,38,2,1
8,304,304,4,4,0,1,0
17,313,313,25,25,0,1,0
36,317,317,27,27,0,1,0
30,324,324,120,120,0,1,0
2,331,331,31,10,21,4,3
27,338,338,10,10,0,1,0
11,347,347,3,3,0,1,0
41,349,349,17,1,16,2,1
0,361,361,30,27,3,2,1
19,363,363,38,38,0,1,0
7,376,376,46,29,17,2,1
32,390,390,10,10,0,1,0
14,421,421,6,6,0,1,0
39,421,421,9,2,7,2,1
34,424,424,10,10,0,1,0
6,427,427,34,2,32,3,2
42,431,431,13,1,12,3,2
25,448,448,50,50,0,1,0
13,457,457,46,26,20,2,1
31,467,467,58,8,50,3,2
22,469,469,37,37,0,1,0
28,474,474,110,68,42,2,1
5,476,476,33,33,0,1,0
9,492,492,1,1,0,1,0
24,500,500,106,19,87,4,3

17,108,108,3,3,0,1,0
33,116,116,20,10,10,2,1
0,130,130,5,5,0,1,0
30,173,173,15,1,14,3,2
19,177,177,69,63,6,2,1
20,186,186,9,9,0,1,0
9,189,189,1,1,0,1,0
6,212,212,61,24,37,4,3
5,231,231,40,12,28,2,1
37,243,243,13,13,0,1,0
21,252,252,25,8,17,2,1
32,267,267,82,27,55,3,2
7,272,272,37,5,32,2,1
10,272,272,16,6,10,2,1
1,278,278,13,13,0,1,0
4,291,291,23,4,19,4,3
35,305,305,39,39,0,1,0
15,324,324,6,6,0,1,0
29,328,328,72,72,0,1,0
16,332,332,31,23,8,3,2
28,337,337,72,67,5,2,1
8,350,350,22,22,0,1,0
31,372,372,13,7,6,2,1
22,388,388,14,14,0,1,0
11,392,392,61,25,36,2,1
13,400,400,63,25,38,3,2
24,401,401,14,6,8,3,2
34,408,408,29,2,27,2,1
23,412,412,3,3,0,1,0
2,432,432,26,10,16,3,2
25,438,438,35,35,0,1,0
38,443,443,69,30,39,3,2
27,462,462,48,14,34,3,2
14,475,475,36,33,3,2,1
36,475,475,35,5,30,3,2
26,479,479,13,4,9,2,1
18,485,485,34,34,0,1,0
12,488,488,28,28,0,1,0
39,492,492,42,10,32,3,2
3,495,495,5,2,3,2,1

5,101,101,3,3,0,1,0
2,109,109,4,1,3,2,1
8,164,164,25,1,24,4,3
38,168,168,10,10,0,1,0
13,187,187,2,2,0,1,0
39,209,209,14,14,0,1,0
40,215,215,47,10,37,2,1
9,219,219,14,5,9,4,3
1,225,225,4,4,0,1,0
31,245,245,8,8,0,1,0
14,260,260,132,27,105,4,3
34,261,261,17,7,10,2,1
37,278,278,21,18,3,2,1
42,280,280,18,5,13,2,1
25,285,285,27,2,25,2,1
27,291,291,2,2,0,1,0
29,293,293,84,56,28,3,2
36,309,309,44,44,0,1,0
21,311,311,9,9,0,1,0
35,312,312,17,2,15,4,3
15,313,313,3,3,0,1,0
33,327,327,16,16,0,1,0
11,344,344,30,30,0,1,0
23,353,353,55,29,26,2,1
26,358,358,24,24,0,1,0
19,362,362,9,1,8,3,2
20,364,364,8,8,0,1,0
3,374,374,21,7,14,3,2
6,383,383,11,11,0,1,0
4,386,386,2,2,0,1,0
18,399,399,9,3,6,3,2
28,433,433,5,5,0,1,0
7,453,453,29,7,22,3,2
24,460,460,37,37,0,1,0
12,463,463,25,25,0,1,0
0,465,465,133,43,90,4,3
16,468,468,68,41,27,2,1
32,472,472,165,102,63,4,3
17,479,479,42,42,0,1,0
22,485,485,101,64,37,2,1
10,489,489,25,9,16,3,2
41,489,489,56,56,0,1,0
30,492,492,17,17,0,1,0

25,100,100,21,21,0,1,0
32,101,101,2,2,0,1,0
8,115,115,17,17,0,1,0
4,136,136,6,3,3,2,1
10,139,139,1,1,0,1,0
14,143,143,3,3,0,1,0
12,150,150,11,2,9,4,3
17,155,155,12,6,6,2,1
30,168,168,22,22,0,1,0
26,175,175,8,8,0,1,0
28,178,178,5,1,4,2,1
21,195,195,14,4,10,3,2
18,197,197,6,6,0,1,0
33,243,243,24,9,15,2,1
6,266,266,28,3,25,3,2
2,273,273,26,17,9,2,1
20,296,296,106,57,49,4,3
13,298,298,159,70,89,4,3
5,314,314,4,4,0,1,0
3,318,318,49,49,0,1,0
1,329,329,72,30,42,2,1
15,355,355,17,17,0,1,0
31,356,356,16,16,0,1,0
22,360,360,6,6,0,1,0
27,372,372,39,5,34,2,1
0,373,373,42,19,23,2,1
11,394,394,123,83,40,3,2
7,394,394,37,19,18,3,2
29,421,421,1,1,0,1,0
24,439,439,104,104,0,1,0
23,443,443,55,28,27,4,3
19,463,463,4,4,0,1,0
9,480,480,43,31,12,4,3
16,490,490,182,182,0,1,0

30,100,100,23,23,0,1,0
42,107,107,8,8,0,1,0
33,109,109,4,1,3,2,1
14,126,126,10,3,7,2,1
6,127,127,1,1,0,1,0
25,163,163,20,20,0,1,0
38,187,187,4,4,0,1,0
31,192,192,14,14,0,1,0
3,197,197,1,1,0,1,0
44,198,198,19,3,16,4,3
26,207,207,8,8,0,1,0
10,210,210,6,3,3,2,1
22,219,219,40,3,37,2,1
23,250,250,9,9,0,1,0
7,253,253,1,1,0,1,0
13,258,258,20,11,9,2,1
20,260,260,38,38,0,1,0
43,262,262,22,22,0,1,0
34,263,263,113,32,81,4,3
40,313,313,2,2,0,1,0
21,321,321,7,7,0,1,0
32,324,324,15,15,0,1,0
15,325,325,23,13,10,2,1
28,328,328,6,6,0,1,0
1,331,331,9,9,0,1,0
11,335,335,4,4,0,1,0
19,340,340,46,3,43,2,1
9,349,349,49,49,0,1,0
39,349,349,12,12,0,1,0
29,365,365,84,43,41,4,3
27,367,367,14,1,13,2,1
17,370,370,50,50,0,1,0
37,371,371,53,38,15,2,1
12,373,373,39,39,0,1,0
36,376,376,26,16,10,3,2
35,416,416,15,3,12,3,2
24,423,423,10,1,9,2,1
18,432,432,120,32,88,3,2
41,432,432,89,12,77,3,2
0,436,436,86,86,0,1,0
2,453,453,22,22,0,1,0
16,455,455,11,5,6,3,2
4,477,477,21,13,8,3,2
8,489,489,28,28,0,1,0
5,495,495,56,20,36,2,1

24,100,100,4,4,0,1,0
30,109,109,11,11,0,1,0
29,131,131,4,1,3,2,1
23,134,134,13,5,8,2,1
28,136,136,3,3,0,1,0
7,143,143,32,32,0,1,0
10,158,158,19,19,0,1,0
33,170,170,12,12,0,1,0
25,214,214,17,17,0,1,0
1,238,238,2,2,0,1,0
0,244,244,15,15,0,1,0
22,257,257,52,4,48,4,3
12,273,273,7,7,0,1,0
17,281,281,10,1,9,4,3
26,286,286,24,4,20,3,2
11,311,311,3,3,0,1,0
16,316,316,20,20,0,1,0
14,322,322,15,10,5,2,1
20,337,337,27,3,24,4,3
18,340,340,59,59,0,1,0
2,347,347,11,11,0,1,0
32,349,349,10,10,0,1,0
13,363,363,84,84,0,1,0
27,412,412,81,45,36,3,2
3,421,421,76,76,0,1,0
9,435,435,84,84,0,1,0
19,456,456,81,81,0,1,0
6,457,457,23,10,13,4,3
8,463,463,385,376,9,4,3
21,466,466,107,107,0,1,0
4,471,471,11,7,4,2,1
15,472,472,80,20,60,4,3
5,484,484,5,5,0,1,0
31,492,492,62,62,0,1,0

11,101,101,1,1,0,1,0
19,127,127,2,2,0,1,0
17,135,135,3,3,0,1,0
12,140,140,26,3,23,2,1
28,143,143,28,2,26,3,2
23,146,146,1,1,0,1,0
45,152,152,3,3,0,1,0
0,153,153,16,1,15,4,3
39,154,154,6,6,0,1,0
32,156,156,62,50,12,3,2
42,185,185,50,45,5,2,1
1,188,188,12,12,0,1,0
35,202,202,7,7,0,1,0
29,204,204,5,1,4,2,1
25,205,205,51,51,0,1,0
7,207,207,18,5,13,2,1
9,215,215,13,13,0,1,0
43,216,216,28,28,0,1,0
13,220,220,17,17,0,1,0
26,238,238,3,3,0,1,0
16,245,245,5,5,0,1,0
41,276,276,31,31,0,1,0
37,297,297,10,10,0,1,0
6,301,301,3,3,0,1,0
22,304,304,19,4,15,4,3
44,308,308,11,8,3,2,1
20,322,322,16,16,0,1,0
2,327,327,1,1,0,1,0
24,328,328,9,9,0,1,0
46,334,334,99,99,0,1,0
8,346,346,23,23,0,1,0
33,348,348,14,14,0,1,0
21,348,348,86,86,0,1,0
36,349,349,1,1,0,1,0
30,355,355,70,8,62,4,3
18,360,360,3,3,0,1,0
31,366,366,14,14,0,1,0
4,377,377,37,37,0,1,0
14,380,380,45,35,10,3,2
5,384,384,28,28,0,1,0
27,409,409,32,6,26,2,1
10,412,412,113,92,21,2,1
15,414,414,3,3,0,1,0
40,423,423,14,3,11,4,3
34,460,460,16,8,8,3,2
38,486,486,11,11,0,1,0
3,488,488,20,7,13,2,1

35,125,125,11,1,10,2,1
30,135,135,15,5,10,2,1
24,148,148,14,4,10,3,2
22,153,153,11,2,9,2,1
10,158,158,12,3,9,2,1
7,174,174,4,4,0,1,0
29,178,178,23,7,16,2,1
13,192,192,24,24,0,1,0
38,198,198,8,1,7,2,1
3,205,205,27,27,0,1,0
23,225,225,3,3,0,1,0
33,227,227,13,1,12,4,3
2,241,241,68,68,0,1,0
11,246,246,42,42,0,1,0
14,253,253,3,3,0,1,0
26,262,262,2,2,0,1,0
31,270,270,65,24,41,4,3
28,273,273,24,24,0,1,0
27,274,274,17,17,0,1,0
16,274,274,184,184,0,1,0
6,279,279,6,6,0,1,0
21,281,281,40,40,0,1,0
32,290,290,132,48,84,4,3
5,296,296,1,1,0,1,0
9,321,321,36,36,0,1,0
4,323,323,25,25,0,1,0
34,326,326,75,27,48,3,2
12,340,340,21,14,7,2,1
8,382,382,24,18,6,3,2
25,384,384,3,3,0,1,0
15,394,394,4,4,0,1,0
19,405,405,35,35,0,1,0
1,415,415,36,17,19,2,1
0,420,420,3,3,0,1,0
37,420,420,11,11,0,1,0
17,431,431,4,4,0,1,0
18,433,433,25,25,0,1,0
20,438,438,35,35,0,1,0
36,443,443,6,6,0,1,0

27,107,107,19,19,0,1,0
16,117,117,3,3,0,1,0
35,118,118,2,2,0,1,0
3,122,122,36,25,11,2,1
25,134,134,18,8,10,3,2
29,138,138,1,1,0,1,0
20,143,143,4,1,3,2,1
19,145,145,38,19,19,2,1
14,194,194,13,3,10,3,2
0,213,213,6,6,0,1,0
1,217,217,66,24,42,4,3
24,219,219,10,3,7,2,1
13,223,223,29,21,8,2,1
7,224,224,18,6,12,3,2
15,235,235,32,32,0,1,0
22,241,241,2,2,0,1,0
8,241,241,30,30,0,1,0
26,271,271,15,8,7,2,1
34,271,271,27,27,0,1,0
28,291,291,16,16,0,1,0
21,302,302,46,46,0,1,0
4,327,327,8,8,0,1,0
31,355,355,52,24,28,3,2
2,362,362,104,104,0,1,0
23,405,405,101,9,92,3,2
17,419,419,98,98,0,1,0
33,421,421,15,15,0,1,0
10,421,421,10,1,9,2,1
9,425,425,48,28,20,2,1
30,426,426,29,13,16,2,1
18,426,426,55,15,40,4,3
32,435,435,50,28,22,3,2
6,460,460,40,16,24,4,3
11,481,481,8,5,3,2,1
5,487,487,125,125,0,1,0
12,489,489,13,3,10,3,2

8,100,100,4,4,0,1,0
20,108,108,23,3,20,3,2
36,120,120,8,8,0,1,0
2,128,128,4,4,0,1,0
3,138,138,9,9,0,1,0
16,142,142,15,15,0,1,0
27,174,174,11,11,0,1,0
9,177,177,21,15,6,3,2
29,177,177,14,2,12,2,1
18,187,187,66,66,0,1,0
34,200,200,2,2,0,1,0
0,205,205,25,10,15,2,1
26,239,239,4,4,0,1,0
22,240,240,81,2,79,4,3
28,255,255,58,58,0,1,0
4,265,265,38,38,0,1,0
12,269,269,5,5,0,1,0
33,270,270,1,1,0,1,0
37,275,275,39,39,0,1,0
31,286,286,15,6,9,3,2
23,324,324,35,14,21,4,3
19,327,327,8,8,0,1,0
6,346,346,124,89,35,2,1
35,347,347,98,80,18,3,2
14,354,354,40,16,24,3,2
24,364,364,12,12,0,1,0
13,369,369,6,6,0,1,0
32,376,376,77,77,0,1,0
7,377,377,17,17,0,1,0
25,381,381,2,2,0,1,0
10,385,385,34,14,20,2,1
15,435,435,19,12,7,2,1
1,449,449,6,6,0,1,0
11,452,452,40,10,30,3,2
30,468,468,50,20,30,4,3
21,487,487,14,5,9,2,1
38,489,489,14,14,0,1,0
5,495,495,54,54,0,1,0
17,498,498,64,64,0,1,0

4,114,114,19,19,0,1,0
1,115,115,1,1,0,1,0
12,119,119,4,4,0,1,0
10,141,141,32,4,28,3,2
40,155,155,18,18,0,1,0
33,156,156,30,30,0,1,0
30,160,160,10,10,0,1,0
41,162,162,4,4,0,1,0
37,163,163,35,35,0,1,0
35,164,164,34,34,0,1,0
14,175,175,6,1,5,2,1
31,180,180,10,1,9,4,3
21,185,185,5,2,3,2,1
13,186,186,46,23,23,2,1
17,188,188,15,15,0,1,0
9,191,191,8,8,0,1,0
8,204,204,46,38,8,3,2
2,207,207,15,15,0,1,0
3,220,220,17,5,12,4,3
38,228,228,16,4,12,4,3
25,264,264,81,81,0,1,0
26,285,285,61,34,27,4,3
0,294,294,2,2,0,1,0
19,319,319,15,6,9,4,3
11,322,322,3,3,0,1,0
24,327,327,6,2,4,2,1
36,341,341,2,2,0,1,0
28,360,360,10,1,9,4,3
18,370,370,4,1,3,2,1
5,386,386,73,40,33,2,1
22,388,388,1,1,0,1,0
6,392,392,50,50,0,1,0
34,401,401,2,2,0,1,0
27,406,406,92,92,0,1,0
32,408,408,34,34,0,1,0
29,434,434,74,16,58,4,3
23,437,437,6,6,0,1,0
39,455,455,13,13,0,1,0
16,463,463,5,5,0,1,0
15,471,471,62,62,0,1,0
7,481,481,39,18,21,2,1
20,496,496,73,73,0,1,0

23,100,100,12,9,3,2,1
12,106,106,11,11,0,1,0
0,109,109,2,2,0,1,0
19,135,135,22,1,21,4,3
39,140,140,4,4,0,1,0
5,142,142,16,8,8,3,2
41,149,149,66,48,18,3,2
26,155,155,32,28,4,2,1
37,163,163,5,5,0,1,0
25,164,164,4,4,0,1,0
40,164,164,9,2,7,3,2
4,191,191,11,11,0,1,0
18,215,215,1,1,0,1,0
3,217,217,12,6,6,2,1
14,219,219,1,1,0,1,0
9,232,232,1,1,0,1,0
10,250,250,7,4,3,2,1
32,252,252,17,11,6,3,2
33,263,263,2,2,0,1,0
13,273,273,5,5,0,1,0
36,293,293,2,2,0,1,0
29,310,310,40,40,0,1,0
30,326,326,24,4,20,2,1
27,335,335,30,30,0,1,0
1,341,341,3,3,0,1,0
2,346,346,63,42,21,4,3
7,357,357,81,21,60,4,3
11,360,360,57,39,18,4,3
42,362,362,16,2,14,2,1
16,382,382,21,1,20,2,1
28,414,414,12,7,5,2,1
6,437,437,62,34,28,3,2
22,437,437,134,134,0,1,0
8,445,445,6,6,0,1,0
20,448,448,3,3,0,1,0
38,450,450,3,3,0,1,0
24,456,456,73,55,18,3,2
17,463,463,87,65,22,3,2
15,471,471,45,27,18,4,3
35,476,476,160,24,136,4,3
34,478,478,40,40,0,1,0
31,480,480,49,49,0,1,0
21,493,493,23,8,15,4,3

13,109,109,4,4,0,1,0
5,111,111,1,1,0,1,0
18,116,116,14,14,0,1,0
26,145,145,17,9,8,3,2
8,157,157,23,18,5,2,1
4,170,170,1,1,0,1,0
12,173,173,3,3,0,1,0
27,188,188,80,15,65,3,2
38,189,189,1,1,0,1,0
20,210,210,4,4,0,1,0
41,211,211,2,2,0,1,0
19,219,219,7,7,0,1,0
0,221,221,12,4,8,3,2
29,226,226,41,15,26,2,1
33,241,241,11,1,10,3,2
2,246,246,4,4,0,1,0
14,261,261,8,3,5,2,1
6,264,264,57,17,40,2,1
11,266,266,78,78,0,1,0
39,271,271,25,25,0,1,0
7,272,272,25,25,0,1,0
21,296,296,29,29,0,1,0
31,330,330,5,1,4,2,1
30,337,337,66,35,31,2,1
22,344,344,35,35,0,1,0
10,346,346,67,67,0,1,0
25,353,353,23,13,10,3,2
42,377,377,3,3,0,1,0
24,382,382,15,15,0,1,0
28,384,384,24,24,0,1,0
3,388,388,57,15,42,2,1
1,428,428,1,1,0,1,0
37,428,428,47,11,36,3,2
16,430,430,22,22,0,1,0
17,442,442,74,48,26,3,2
9,445,445,64,34,30,3,2
32,447,447,79,49,30,3,2
15,450,450,3,3,0,1,0
34,470,470,35,21,14,3,2
23,472,472,16,16,0,1,0
35,475,475,42,42,0,1,0
36,477,477,30,30,0,1,0
40,479,479,109,17,92,3,2

11,152,152,7,7,0,1,0
25,152,152,5,5,0,1,0
21,154,154,21,21,0,1,0
34,164,164,4,4,0,1,0
0,177,177,12,2,10,2,1
7,197,197,2,2,0,1,0
6,199,199,6,1,5,2,1
27,209,209,10,10,0,1,0
22,215,215,11,3,8,3,2
26,218,218,15,15,0,1,0
13,223,223,79,57,22,2,1
12,226,226,1,1,0,1,0
30,229,229,12,12,0,1,0
4,236,236,2,2,0,1,0
33,238,238,39,39,0,1,0
31,238,238,10,10,0,1,0
9,265,265,32,7,25,2,1
40,270,270,57,33,24,4,3
17,278,278,9,9,0,1,0
20,286,286,54,30,24,2,1
18,290,290,10,1,9,3,2
29,291,291,10,2,8,3,2
24,306,306,82,20,62,3,2
23,311,311,24,14,10,3,2
28,323,323,103,33,70,3,2
19,332,332,121,121,0,1,0
1,338,338,33,33,0,1,0
32,368,368,35,35,0,1,0
10,387,387,53,8,45,2,1
15,394,394,16,8,8,3,2
3,406,406,13,13,0,1,0
35,416,416,67,37,30,4,3
14,424,424,51,51,0,1,0
36,428,428,29,23,6,2,1
8,431,431,56,56,0,1,0
39,431,431,15,8,7,2,1
38,434,434,58,18,40,3,2
5,475,475,75,32,43,2,1
16,479,479,10,1,9,4,3
2,482,482,1,1,0,1,0
37,482,482,8,8,0,1,0

5,104,104,1,1,0,1,0
7,112,112,4,4,0,1,0
28,126,126,13,13,0,1,0
18,139,139,43,43,0,1,0
35,150,150,1,1,0,1,0
33,153,153,26,26,0,1,0
26,164,164,30,10,20,2,1
32,171,171,11,2,9,2,1
19,175,175,10,10,0,1,0
24,187,187,8,8,0,1,0
4,194,194,19,19,0,1,0
25,210,210,29,21,8,3,2
29,236,236,29,29,0,1,0
16,240,240,15,3,12,3,2
31,240,240,33,33,0,1,0
12,241,241,1,1,0,1,0
37,247,247,9,4,5,2,1
22,250,250,4,4,0,1,0
15,256,256,6,6,0,1,0
36,256,256,150,150,0,1,0
21,259,259,9,9,0,1,0
20,273,273,5,5,0,1,0
0,309,309,25,17,8,2,1
13,324,324,133,103,30,2,1
1,328,328,41,41,0,1,0
6,337,337,74,74,0,1,0
23,349,349,58,58,0,1,0
38,379,379,9,6,3,2,1
10,404,404,21,21,0,1,0
2,421,421,64,12,52,3,2
9,435,435,7,7,0,1,0
11,436,436,8,8,0,1,0
3,446,446,40,13,27,4,3
27,451,451,54,15,39,2,1
30,457,457,5,5,0,1,0
14,464,464,124,4,120,4,3
34,483,483,3,3,0,1,0
17,488,488,15,15,0,1,0
8,488,488,1,1,0,1,0

30,101,101,46,8,38,3,2
32,108,108,1,1,0,1,0
29,125,125,4,1,3,2,1
13,127,127,8,2,6,2,1
10,128,128,4,4,0,1,0
26,156,156,61,13,48,4,3
14,159,159,8,8,0,1,0
4,160,160,28,6,22,4,3
22,190,190,48,6,42,4,3
21,192,192,24,24,0,1,0
7,211,211,3,3,0,1,0
17,219,219,10,10,0,1,0
19,239,239,21,21,0,1,0
6,241,241,40,40,0,1,0
8,264,264,108,108,0,1,0
25,275,275,32,32,0,1,0
33,291,291,18,2,16,3,2
27,292,292,10,10,0,1,0
0,303,303,11,1,10,2,1
3,319,319,55,55,0,1,0
23,321,321,1,1,0,1,0
28,339,339,26,26,0,1,0
5,359,359,73,4,69,4,3
24,375,375,2,2,0,1,0
20,375,375,21,21,0,1,0
9,384,384,87,29,58,3,2
18,417,417,16,16,0,1,0
12,418,418,50,41,9,2,1
15,419,419,2,2,0,1,0
1,425,425,45,45,0,1,0
11,428,428,26,26,0,1,0
2,445,445,99,99,0,1,0
31,459,459,36,21,15,2,1
16,473,473,56,32,24,4,3

0,112,112,12,7,5,2,1
15,118,118,12,12,0,1,0
33,147,147,6,6,0,1,0
9,148,148,5,5,0,1,0
16,159,159,5,2,3,2,1
32,163,163,23,19,4,2,1
28,164,164,8,8,0,1,0
13,169,169,1,1,0,1,0
36,184,184,81,81,0,1,0
30,209,209,34,4,30,4,3
12,215,215,39,39,0,1,0
29,221,221,5,5,0,1,0
20,242,242,11,8,3,2,1
3,256,256,73,73,0,1,0
23,267,267,23,23,0,1,0
10,278,278,39,39,0,1,0
17,281,281,37,37,0,1,0
26,289,289,5,1,4,2,1
6,290,290,41,12,29,2,1
37,297,297,82,82,0,1,0
24,328,328,61,14,47,2,1
11,331,331,23,23,0,1,0
7,331,331,7,7,0,1,0
22,349,349,72,18,54,4,3
34,357,357,3,3,0,1,0
35,363,363,8,8,0,1,0
5,382,382,22,3,19,2,1
1,403,403,64,10,54,3,2
2,404,404,28,28,0,1,0
18,406,406,25,25,0,1,0
38,407,407,39,3,36,4,3
14,420,420,27,27,0,1,0
27,421,421,5,5,0,1,0
4,423,423,80,50,30,2,1
21,425,425,1,1,0,1,0
25,447,447,66,66,0,1,0
39,457,457,32,32,0,1,0
19,490,490,56,56,0,1,0
31,491,491,2,2,0,1,0
8,500,500,18,18,0,1,0

12,109,109,19,11,8,3,2
14,113,113,1,1,0,1,0
4,116,116,6,6,0,1,0
27,124,124,14,6,8,3,2
29,141,141,14,14,0,1,0
18,161,161,25,13,12,4,3
6,165,165,1,1,0,1,0
21,177,177,41,41,0,1,0
34,178,178,4,1,3,2,1
30,197,197,7,7,0,1,0
24,200,200,54,21,33,4,3
38,207,207,13,2,11,3,2
35,225,225,8,1,7,2,1
0,227,227,38,15,23,2,1
37,230,230,18,2,16,3,2
19,232,232,33,5,28,3,2
1,248,248,5,5,0,1,0
17,260,260,13,2,11,2,1
5,269,269,16,2,14,2,1
8,271,271,2,2,0,1,0
28,274,274,75,37,38,2,1
2,304,304,109,109,0,1,0
39,313,313,48,48,0,1,0
31,351,351,7,7,0,1,0
16,361,361,18,6,12,3,2
3,362,362,167,91,76,4,3
33,392,392,71,71,0,1,0
25,393,393,17,11,6,2,1
13,393,393,1,1,0,1,0
22,399,399,23,13,10,3,2
23,434,434,43,27,16,2,1
32,443,443,36,36,0,1,0
15,449,449,24,21,3,2,1
36,460,460,8,2,6,2,1
20,469,469,52,52,0,1,0
9,473,473,13,7,6,2,1
7,481,481,38,38,0,1,0
11,493,493,59,59,0,1,0
10,493,493,4,4,0,1,0
26,497,497,26,26,0,1,0

33,100,100,26,7,19,4,3
43,120,120,17,17,0,1,0
20,121,121,16,16,0,1,0
16,131,131,12,3,9,2,1
7,135,135,9,1,8,3,2
40,148,148,16,16,0,1,0
23,155,155,14,14,0,1,0
24,168,168,3,3,0,1,0
37,180,180,2,2,0,1,0
15,180,180,33,33,0,1,0
17,187,187,11,11,0,1,0
13,198,198,4,1,3,2,1
29,204,204,5,1,4,2,1
8,206,206,9,9,0,1,0
0,212,212,17,17,0,1,0
35,215,215,27,23,4,2,1
38,219,219,5,5,0,1,0
36,238,238,3,3,0,1,0
18,266,266,47,15,32,4,3
34,266,266,26,15,11,2,1
26,277,277,10,2,8,2,1
32,282,282,22,22,0,1,0
2,283,283,14,14,0,1,0
11,288,288,76,76,0,1,0
41,294,294,7,1,6,3,2
30,300,300,33,17,16,3,2
42,321,321,56,56,0,1,0
1,323,323,27,27,0,1,0
10,335,335,7,2,5,2,1
27,336,336,58,39,19,2,1
21,340,340,4,4,0,1,0
22,348,348,75,75,0,1,0
31,368,368,44,44,0,1,0
3,377,377,4,4,0,1,0
12,379,379,52,52,0,1,0
5,391,391,28,6,22,2,1
25,408,408,79,56,23,4,3
14,409,409,7,7,0,1,0
39,450,450,100,38,62,3,2
4,452,452,19,11,8,2,1
6,460,460,6,3,3,2,1
28,472,472,36,10,26,3,2
19,488,488,19,19,0,1,0
9,495,495,43,26,17,2,1

4,106,106,57,57,0,1,0
9,116,116,19,11,8,3,2
25,118,118,11,11,0,1,0
18,120,120,2,2,0,1,0
1,125,125,33,33,0,1,0
33,127,127,21,21,0,1,0
8,183,183,5,2,3,2,1
31,183,183,28,17,11,2,1
13,209,209,21,6,15,4,3
15,212,212,15,15,0,1,0
23,214,214,9,9,0,1,0
3,225,225,24,24,0,1,0
0,243,243,39,35,4,2,1
19,269,269,39,8,31,3,2
16,300,300,61,16,45,4,3
28,304,304,7,7,0,1,0
22,309,309,75,49,26,2,1
2,327,327,67,6,61,3,2
30,329,329,14,14,0,1,0
29,330,330,7,7,0,1,0
12,361,361,1,1,0,1,0
7,374,374,92,14,78,4,3
26,378,378,5,5,0,1,0
6,402,402,16,10,6,2,1
14,404,404,33,15,18,2,1
21,424,424,170,62,108,4,3
17,427,427,22,22,0,1,0
27,436,436,53,11,42,4,3
11,437,437,10,10,0,1,0
10,444,444,53,8,45,4,3
24,448,448,22,10,12,3,2
20,455,455,11,11,0,1,0
32,459,459,37,37,0,1,0
5,495,495,2,2,0,1,0

24,101,101,20,12,8,2,1
22,102,102,3,3,0,1,0
11,103,103,12,9,3,2,1
23,106,106,3,3,0,1,0
9,110,110,10,4,6,2,1
43,122,122,17,17,0,1,0
40,127,127,9,3,6,3,2
34,131,131,1,1,0,1,0
27,143,143,3,3,0,1,0
44,144,144,5,5,0,1,0
26,144,144,2,2,0,1,0
4,146,146,8,8,0,1,0
31,157,157,54,54,0,1,0
45,185,185,23,5,18,4,3
25,196,196,22,22,0,1,0
30,198,198,2,2,0,1,0
41,216,216,30,2,28,2,1
28,219,219,27,20,7,2,1
20,227,227,5,1,4,2,1
15,229,229,1,1,0,1,0
32,232,232,1,1,0,1,0
1,236,236,16,6,10,3,2
42,245,245,59,50,9,2,1
8,258,258,21,21,0,1,0
19,263,263,3,3,0,1,0
29,273,273,66,66,0,1,0
14,275,275,7,7,0,1,0
3,286,286,18,13,5,2,1
12,309,309,5,2,3,2,1
13,322,322,152,101,51,4,3
21,324,324,4,4,0,1,0
7,331,331,10,10,0,1,0
2,333,333,26,3,23,2,1
18,365,365,7,7,0,1,0
36,400,400,98,74,24,3,2
39,403,403,9,9,0,1,0
0,424,424,33,11,22,3,2
37,432,432,14,6,8,2,1
5,449,449,13,5,8,3,2
10,449,449,3,3,0,1,0
16,453,453,130,67,63,4,3
33,455,455,59,12,47,2,1
38,462,462,11,11,0,1,0
17,476,476,15,15,0,1,0
6,490,490,17,7,10,2,1
35,497,497,40,40,0,1,0

19,105,105,2,2,0,1,0
29,105,105,20,20,0,1,0
8,125,125,29,29,0,1,0
21,137,137,9,5,4,2,1
20,137,137,11,11,0,1,0
1,157,157,5,5,0,1,0
6,190,190,16,8,8,2,1
22,200,200,24,24,0,1,0
0,201,201,13,13,0,1,0
27,203,203,17,6,11,2,1
31,226,226,101,15,86,3,2
9,229,229,39,7,32,3,2
23,234,234,22,22,0,1,0
3,235,235,68,53,15,4,3
30,243,243,42,36,6,3,2
16,260,260,19,2,17,2,1
11,268,268,18,7,11,2,1
13,294,294,39,9,30,3,2
25,295,295,8,8,0,1,0
4,308,308,106,106,0,1,0
28,314,314,9,9,0,1,0
12,327,327,17,11,6,3,2
10,332,332,14,3,11,2,1
2,339,339,9,1,8,2,1
5,402,402,231,206,25,2,1
18,405,405,78,78,0,1,0
7,434,434,10,1,9,4,3
17,446,446,1,1,0,1,0
14,450,450,42,42,0,1,0
24,458,458,37,37,0,1,0
26,461,461,23,4,19,2,1
32,479,479,28,28,0,1,0
15,487,487,12,6,6,3,2

5,100,100,12,2,10,2,1
37,104,104,10,10,0,1,0
28,106,106,16,16,0,1,0
40,113,113,2,2,0,1,0
7,135,135,3,3,0,1,0
16,145,145,1,1,0,1,0
35,154,154,3,3,0,1,0
36,187,187,28,28,0,1,0
6,192,192,21,21,0,1,0
8,208,208,4,1,3,2,1
1,214,214,7,3,4,2,1
14,214,214,11,1,10,4,3
3,223,223,1,1,0,1,0
39,224,224,23,2,21,4,3
12,232,232,66,51,15,4,3
17,236,236,1,1,0,1,0
33,259,259,2,2,0,1,0
31,259,259,28,28,0,1,0
11,279,279,38,11,27,2,1
41,282,282,5,5,0,1,0
24,294,294,77,77,0,1,0
15,299,299,22,22,0,1,0
22,318,318,61,61,0,1,0
19,320,320,22,6,16,2,1
25,336,336,3,3,0,1,0
20,340,340,27,23,4,2,1
30,350,350,8,1,7,2,1
32,360,360,69,69,0,1,0
26,394,394,80,80,0,1,0
13,395,395,187,187,0,1,0
2,397,397,43,7,36,3,2
21,397,397,6,6,0,1,0
34,408,408,11,5,6,2,1
0,420,420,61,61,0,1,0
29,427,427,103,103,0,1,0
4,428,428,3,3,0,1,0
38,434,434,68,68,0,1,0
10,443,443,26,4,22,3,2
18,445,445,66,66,0,1,0
9,456,456,15,15,0,1,0
27,465,465,14,14,0,1,0
23,481,481,19,11,8,2,1

34,103,103,6,6,0,1,0
42,131,131,8,1,7,2,1
31,139,139,27,1,26,3,2
28,139,139,18,4,14,2,1
33,139,139,10,10,0,1,0
4,162,162,23,23,0,1,0
8,176,176,25,9,16,2,1
11,181,181,8,8,0,1,0
7,183,183,6,6,0,1,0
6,186,186,6,3,3,2,1
14,194,194,35,35,0,1,0
26,211,211,32,32,0,1,0
18,234,234,1,1,0,1,0
9,237,237,3,3,0,1,0
37,243,243,26,26,0,1,0
30,249,249,1,1,0,1,0
23,251,251,21,3,18,3,2
21,267,267,5,1,4,2,1
0,271,271,12,12,0,1,0
32,275,275,19,19,0,1,0
1,276,276,48,40,8,3,2
39,277,277,80,44,36,4,3
24,279,279,11,11,0,1,0
36,286,286,18,1,17,4,3
15,308,308,4,4,0,1,0
27,308,308,7,4,3,2,1
5,316,316,22,22,0,1,0
19,323,323,52,52,0,1,0
20,328,328,53,53,0,1,0
16,342,342,2,2,0,1,0
10,369,369,12,3,9,4,3
3,373,373,123,79,44,3,2
29,373,373,1,1,0,1,0
25,385,385,45,36,9,4,3
41,395,395,52,38,14,2,1
35,408,408,107,107,0,1,0
17,416,416,77,5,72,3,2
38,419,419,58,2,56,3,2
2,426,426,1,1,0,1,0
12,448,448,19,10,9,4,3
13,467,467,58,58,0,1,0
22,479,479,22,10,12,4,3
40,487,487,17,17,0,1,0

4,112,112,24,24,0,1,0
40,144,144,35,35,0,1,0
28,154,154,5,5,0,1,0
12,155,155,4,4,0,1,0
9,169,169,22,14,8,2,1
29,192,192,8,8,0,1,0
24,195,195,13,13,0,1,0
38,200,200,45,37,8,2,1
17,214,214,25,7,18,3,2
0,227,227,4,4,0,1,0
31,234,234,16,16,0,1,0
23,240,240,48,5,43,4,3
2,256,256,3,3,0,1,0
36,273,273,5,5,0,1,0
37,280,280,3,3,0,1,0
32,289,289,5,2,3,2,1
8,299,299,27,19,8,2,1
18,301,301,108,100,8,2,1
15,303,303,1,1,0,1,0
20,315,315,5,5,0,1,0
34,318,318,40,40,0,1,0
1,320,320,43,27,16,3,2
11,328,328,2,2,0,1,0
3,329,329,5,5,0,1,0
5,332,332,65,17,48,3,2
6,338,338,71,71,0,1,0
39,338,338,104,104,0,1,0
22,343,343,8,2,6,3,2
10,344,344,37,7,30,4,3
16,348,348,9,5,4,2,1
14,354,354,20,8,12,3,2
27,366,366,10,10,0,1,0
30,381,381,87,13,74,4,3
19,432,432,7,1,6,2,1
26,437,437,69,69,0,1,0
35,455,455,2,2,0,1,0
33,462,462,33,33,0,1,0
21,464,464,54,6,48,2,1
7,467,467,45,31,14,3,2
13,481,481,74,30,44,3,2
25,487,487,26,5,21,4,3

38,123,123,3,3,0,1,0
31,124,124,18,18,0,1,0
37,133,133,48,48,0,1,0
14,151,151,3,3,0,1,0
26,152,152,4,4,0,1,0
5,170,170,5,5,0,1,0
4,174,174,17,17,0,1,0
15,179,179,12,9,3,2,1
36,182,182,26,26,0,1,0
30,199,199,7,7,0,1,0
8,200,200,33,33,0,1,0
12,201,201,49,49,0,1,0
19,206,206,56,56,0,1,0
0,215,215,25,14,11,2,1
17,220,220,21,21,0,1,0
25,231,231,60,60,0,1,0
21,244,244,16,16,0,1,0
13,274,274,36,36,0,1,0
29,276,276,1,1,0,1,0
23,297,297,14,5,9,4,3
22,299,299,63,56,7,2,1
9,303,303,9,9,0,1,0
2,306,306,11,11,0,1,0
28,327,327,17,9,8,3,2
1,353,353,38,5,33,4,3
18,368,368,93,82,11,2,1
20,383,383,15,15,0,1,0
35,392,392,34,34,0,1,0
27,395,395,19,3,16,2,1
10,400,400,8,8,0,1,0
33,401,401,10,2,8,2,1
6,435,435,23,23,0,1,0
34,442,442,46,18,28,2,1
3,454,454,162,15,147,4,3
11,472,472,61,61,0,1,0
32,474,474,32,32,0,1,0
24,479,479,6,6,0,1,0
16,482,482,14,3,11,2,1
7,499,499,11,6,5,2,1

7,140,140,14,14,0,1,0
10,141,141,7,1,6,3,2
25,150,150,17,17,0,1,0
1,165,165,18,3,15,4,3
13,172,172,15,3,12,3,2
36,178,178,34,21,13,2,1
26,209,209,7,7,0,1,0
2,212,212,45,45,0,1,0
30,216,216,6,1,5,2,1
19,218,218,9,9,0,1,0
14,221,221,21,9,12,3,2
18,231,231,1,1,0,1,0
4,239,239,4,1,3,2,1
20,242,242,11,5,6,3,2
29,248,248,3,3,0,1,0
22,254,254,14,14,0,1,0
27,273,273,4,1,3,2,1
8,298,298,46,46,0,1,0
6,310,310,29,6,23,2,1
35,326,326,20,20,0,1,0
15,329,329,14,3,11,4,3
17,339,339,10,10,0,1,0
28,339,339,107,54,53,4,3
33,344,344,11,11,0,1,0
31,350,350,31,10,21,2,1
5,363,363,24,3,21,4,3
11,373,373,139,139,0,1,0
37,382,382,41,16,25,4,3
12,394,394,146,132,14,3,2
16,395,395,3,3,0,1,0
34,398,398,61,61,0,1,0
24,411,411,88,36,52,3,2
9,420,420,13,5,8,2,1
21,429,429,33,1,32,2,1
32,430,430,73,28,45,2,1
3,459,459,21,9,12,2,1
23,472,472,59,9,50,3,2
0,480,480,55,11,44,3,2
38,482,482,76,32,44,2,1

4,127,127,16,16,0,1,0
12,129,129,1,1,0,1,0
24,143,143,16,10,6,3,2
17,149,149,32,27,5,2,1
34,169,169,7,7,0,1,0
20,169,169,48,9,39,4,3
15,201,201,4,4,0,1,0
29,205,205,36,36,0,1,0
0,205,205,2,2,0,1,0
32,228,228,28,28,0,1,0
16,232,232,7,7,0,1,0
2,244,244,2,2,0,1,0
6,245,245,80,80,0,1,0
11,262,262,141,121,20,2,1
5,269,269,10,7,3,2,1
13,280,280,4,4,0,1,0
3,308,308,20,20,0,1,0
27,309,309,1,1,0,1,0
10,319,319,162,111,51,4,3
22,330,330,4,4,0,1,0
30,345,345,16,16,0,1,0
21,358,358,23,23,0,1,0
28,360,360,1,1,0,1,0
25,379,379,114,114,0,1,0
26,393,393,23,17,6,2,1
14,395,395,13,5,8,3,2
23,398,398,38,24,14,3,2
31,421,421,40,40,0,1,0
33,421,421,63,36,27,4,3
1,426,426,49,11,38,2,1
8,429,429,75,9,66,4,3
7,430,430,5,5,0,1,0
19,431,431,38,2,36,4,3
9,465,465,12,12,0,1,0
18,500,500,62,9,53,3,2

19,110,110,21,7,14,2,1
22,124,124,8,2,6,2,1
7,125,125,1,1,0,1,0
36,133,133,2,2,0,1,0
43,147,147,7,7,0,1,0
39,199,199,81,49,32,2,1
23,201,201,24,6,18,4,3
18,203,203,2,2,0,1,0
0,214,214,3,3,0,1,0
27,222,222,16,10,6,2,1
15,227,227,5,1,4,2,1
35,233,233,3,3,0,1,0
13,274,274,33,23,10,2,1
11,274,274,103,19,84,4,3
2,276,276,6,3,3,2,1
37,280,280,7,4,3,2,1
31,283,283,59,45,14,3,2
38,285,285,73,52,21,4,3
4,315,315,46,46,0,1,0
5,328,328,37,37,0,1,0
21,331,331,10,4,6,3,2
17,332,332,6,6,0,1,0
40,333,333,15,1,14,2,1
8,333,333,43,34,9,4,3
14,343,343,7,7,0,1,0
16,358,358,31,31,0,1,0
41,359,359,4,4,0,1,0
24,361,361,45,34,11,2,1
1,362,362,64,20,44,4,3
10,365,365,10,5,5,2,1
42,379,379,64,45,19,2,1
33,384,384,3,3,0,1,0
12,389,389,15,6,9,3,2
6,390,390,56,31,25,2,1
3,414,414,12,12,0,1,0
26,427,427,50,22,28,3,2
34,444,444,47,47,0,1,0
9,454,454,1,1,0,1,0
32,457,457,4,1,3,2,1
25,468,468,12,6,6,3,2
30,476,476,13,13,0,1,0
20,483,483,47,29,18,3,2
28,488,488,17,8,9,4,3
29,490,490,148,105,43,2,1

22,117,117,1,1,0,1,0
26,118,118,15,15,0,1,0
6,132,132,1,1,0,1,0
13,139,139,52,52,0,1,0
14,157,157,6,6,0,1,0
32,162,162,1,1,0,1,0
10,195,195,27,9,18,3,2
41,202,202,30,30,0,1,0
12,207,207,20,20,0,1,0
31,228,228,19,19,0,1,0
19,233,233,4,1,3,2,1
29,236,236,58,37,21,4,3
20,236,236,31,31,0,1,0
40,245,245,20,20,0,1,0
33,255,255,11,6,5,2,1
9,255,255,11,4,7,2,1
36,258,258,26,26,0,1,0
25,292,292,34,34,0,1,0
24,298,298,11,11,0,1,0
35,298,298,20,3,17,3,2
4,310,310,46,46,0,1,0
23,319,319,22,8,14,3,2
21,334,334,21,21,0,1,0
11,336,336,34,34,0,1,0
7,339,339,52,37,15,2,1
30,346,346,77,68,9,4,3
5,362,362,26,26,0,1,0
8,383,383,18,18,0,1,0
18,390,390,17,2,15,4,3
0,409,409,77,77,0,1,0
3,411,411,17,2,15,4,3
16,414,414,16,16,0,1,0
17,426,426,36,20,16,3,2
42,435,435,20,2,18,2,1
15,447,447,29,11,18,2,1
1,453,453,33,33,0,1,0
28,462,462,27,27,0,1,0
27,472,472,11,3,8,2,1
38,472,472,77,61,16,2,1
34,475,475,92,92,0,1,0
39,486,486,101,101,0,1,0
37,489,489,1,1,0,1,0
2,497,497,13,1,12,4,3

5,103,103,2,2,0,1,0
0,111,111,16,16,0,1,0
32,121,121,94,94,0,1,0
26,130,130,12,12,0,1,0
6,150,150,11,3,8,2,1
40,153,153,55,55,0,1,0
16,153,153,8,5,3,2,1
22,156,156,16,4,12,2,1
1,160,160,13,13,0,1,0
14,160,160,1,1,0,1,0
17,169,169,46,25,21,4,3
18,175,175,5,5,0,1,0
7,177,177,14,5,9,4,3
29,189,189,2,2,0,1,0
25,196,196,4,1,3,2,1
3,200,200,19,19,0,1,0
8,209,209,3,3,0,1,0
9,214,214,14,7,7,2,1
15,217,217,1,1,0,1,0
11,245,245,16,8,8,3,2
21,249,249,48,48,0,1,0
10,257,257,7,7,0,1,0
33,259,259,9,9,0,1,0
27,307,307,23,1,22,3,2
36,308,308,9,9,0,1,0
30,313,313,8,8,0,1,0
39,316,316,10,10,0,1,0
28,323,323,2,2,0,1,0
20,326,326,17,2,15,2,1
2,354,354,58,34,24,4,3
23,368,368,16,16,0,1,0
19,383,383,9,6,3,2,1
13,392,392,37,37,0,1,0
12,401,401,85,32,53,4,3
35,405,405,5,5,0,1,0
38,424,424,4,4,0,1,0
37,429,429,72,29,43,2,1
24,447,447,42,10,32,3,2
41,452,452,2,2,0,1,0
34,475,475,21,21,0,1,0
4,487,487,114,102,12,2,1
31,496,496,43,43,0,1,0

19,110,110,7,4,3,2,1
11,113,113,5,2,3,2,1
40,140,140,26,21,5,2,1
26,154,154,5,2,3,2,1
25,168,168,16,7,9,4,3
24,169,169,11,11,0,1,0
10,179,179,1,1,0,1,0
4,190,190,11,1,10,3,2
27,193,193,9,2,7,2,1
6,206,206,4,4,0,1,0
37,221,221,21,21,0,1,0
38,225,225,11,1,10,3,2
8,227,227,78,8,70,3,2
34,233,233,77,77,0,1,0
20,242,242,37,29,8,2,1
30,266,266,9,9,0,1,0
14,270,270,46,46,0,1,0
41,271,271,7,7,0,1,0
33,286,286,8,8,0,1,0
18,290,290,48,12,36,4,3
7,290,290,17,1,16,2,1
22,292,292,51,14,37,2,1
16,298,298,54,7,47,2,1
36,299,299,62,62,0,1,0
1,303,303,19,9,10,3,2
29,308,308,6,6,0,1,0
3,310,310,39,17,22,3,2
31,317,317,86,86,0,1,0
13,330,330,5,2,3,2,1
32,338,338,14,14,0,1,0
9,355,355,10,10,0,1,0
17,362,362,16,1,15,4,3
39,385,385,48,34,14,3,2
15,386,386,20,20,0,1,0
5,390,390,67,2,65,4,3
28,393,393,75,21,54,4,3
0,401,401,35,5,30,3,2
35,431,431,4,4,0,1,0
21,433,433,18,18,0,1,0
23,460,460,7,7,0,1,0
2,460,460,36,36,0,1,0
12,467,467,15,15,0,1,0

21,113,113,10,4,6,3,2
18,123,123,2,2,0,1,0
6,142,142,1,1,0,1,0
27,154,154,3,3,0,1,0
7,174,174,3,3,0,1,0
3,176,176,18,18,0,1,0
12,195,195,2,2,0,1,0
2,200,200,1,1,0,1,0
30,214,214,1,1,0,1,0
28,222,222,17,17,0,1,0
11,232,232,5,2,3,2,1
19,249,249,91,73,18,4,3
35,254,254,6,6,0,1,0
14,261,261,156,140,16,2,1
9,263,263,91,79,12,4,3
13,282,282,8,8,0,1,0
29,295,295,109,65,44,3,2
24,306,306,11,11,0,1,0
10,314,314,15,15,0,1,0
16,317,317,1,1,0,1,0
1,324,324,29,4,25,2,1
37,325,325,25,25,0,1,0
31,326,326,30,30,0,1,0
23,329,329,7,3,4,2,1
32,332,332,19,6,13,2,1
22,362,362,2,2,0,1,0
25,373,373,171,64,107,4,3
5,399,399,30,30,0,1,0
26,400,400,9,6,3,2,1
4,457,457,77,11,66,3,2
33,467,467,48,12,36,3,2
0,467,467,113,113,0,1,0
8,469,469,41,1,40,3,2
34,470,470,5,5,0,1,0
17,481,481,17,17,0,1,0
36,488,488,7,2,5,2,1
15,489,489,57,57,0,1,0
20,497,497,86,86,0,1,0

39,117,117,14,14,0,1,0
19,118,118,34,4,30,2,1
8,124,124,1,1,0,1,0
15,127,127,1,1,0,1,0
0,129,129,16,8,8,2,1
5,132,132,21,3,18,4,3
37,140,140,23,23,0,1,0
9,151,151,24,24,0,1,0
7,153,153,32,32,0,1,0
2,159,159,9,9,0,1,0
17,188,188,9,9,0,1,0
33,195,195,4,4,0,1,0
27,210,210,39,6,33,4,3
12,213,213,1,1,0,1,0
23,213,213,21,6,15,4,3
14,218,218,7,7,0,1,0
31,224,224,29,20,9,2,1
34,232,232,12,12,0,1,0
32,235,235,44,44,0,1,0
35,239,239,16,16,0,1,0
3,239,239,19,10,9,4,3
18,292,292,13,13,0,1,0
25,325,325,26,26,0,1,0
6,328,328,167,60,107,4,3
4,333,333,22,4,18,3,2
20,352,352,12,1,11,2,1
30,362,362,51,51,0,1,0
40,378,378,28,28,0,1,0
1,387,387,26,2,24,3,2
38,399,399,94,67,27,3,2
21,403,403,19,19,0,1,0
16,407,407,4,4,0,1,0
13,414,414,4,1,3,2,1
29,416,416,33,4,29,2,1
28,442,442,28,7,21,3,2
24,447,447,64,45,19,2,1
26,478,478,11,11,0,1,0
11,487,487,27,9,18,2,1
22,497,497,56,14,42,4,3
10,498,498,14,14,0,1,0
36,500,500,7,4,3,2,1

30,101,101,3,3,0,1,0
6,111,111,33,9,24,3,2
26,166,166,6,6,0,1,0
37,175,175,4,1,3,2,1
8,177,177,40,8,32,3,2
33,179,179,34,34,0,1,0
28,191,191,10,1,9,2,1
9,208,208,20,1,19,2,1
23,215,215,47,47,0,1,0
13,219,219,45,45,0,1,0
20,244,244,51,15,36,3,2
12,269,269,7,7,0,1,0
25,271,271,42,42,0,1,0
35,277,277,30,30,0,1,0
16,279,279,3,3,0,1,0
31,293,293,1,1,0,1,0
14,300,300,22,22,0,1,0
36,313,313,14,14,0,1,0
3,313,313,102,51,51,4,3
29,330,330,22,4,18,3,2
38,338,338,32,1,31,4,3
0,352,352,18,8,10,2,1
18,364,364,16,10,6,2,1
10,366,366,22,3,19,4,3
1,369,369,1,1,0,1,0
19,379,379,3,3,0,1,0
7,387,387,38,9,29,2,1
4,397,397,84,65,19,2,1
5,403,403,34,34,0,1,0
27,407,407,33,33,0,1,0
21,410,410,28,4,24,4,3
24,419,419,155,155,0,1,0
2,426,426,9,3,6,3,2
17,443,443,48,43,5,2,1
15,446,446,6,6,0,1,0
22,469,469,87,87,0,1,0
11,476,476,21,21,0,1,0
32,480,480,30,30,0,1,0
34,490,490,14,3,11,2,1

4,120,120,4,4,0,1,0
30,121,121,6,1,5,2,1
27,122,122,19,1,18,3,2
31,131,131,34,34,0,1,0
1,149,149,34,14,20,2,1
11,155,155,1,1,0,1,0
20,159,159,12,12,0,1,0
12,176,176,20,12,8,2,1
29,181,181,4,4,0,1,0
6,189,189,17,17,0,1,0
35,191,191,5,5,0,1,0
10,195,195,15,15,0,1,0
15,202,202,21,6,15,3,2
5,209,209,44,20,24,2,1
7,214,214,33,21,12,2,1
25,224,224,2,2,0,1,0
3,234,234,43,19,24,4,3
13,241,241,49,49,0,1,0
18,246,246,10,10,0,1,0
14,277,277,22,22,0,1,0
39,277,277,41,41,0,1,0
33,283,283,15,7,8,3,2
38,284,284,63,63,0,1,0
22,348,348,1,1,0,1,0
16,391,391,55,55,0,1,0
36,397,397,38,2,36,4,3
37,399,399,115,48,67,3,2
21,427,427,16,16,0,1,0
17,435,435,31,9,22,3,2
19,445,445,20,20,0,1,0
28,445,445,127,96,31,2,1
34,454,454,51,40,11,2,1
32,461,461,10,1,9,2,1
23,462,462,25,6,19,4,3
9,463,463,31,31,0,1,0
24,464,464,46,46,0,1,0
26,475,475,9,9,0,1,0
2,484,484,9,9,0,1,0
0,495,495,31,31,0,1,0
8,498,498,36,27,9,4,3

29,101,101,4,4,0,1,0
5,110,110,13,13,0,1,0
37,121,121,8,3,5,2,1
34,121,121,3,3,0,1,0
24,125,125,2,2,0,1,0
41,132,132,1,1,0,1,0
35,136,136,2,2,0,1,0
27,160,160,51,18,33,4,3
8,164,164,25,25,0,1,0
18,183,183,1,1,0,1,0
11,189,189,23,23,0,1,0
15,223,223,44,8,36,2,1
1,247,247,22,2,20,3,2
13,258,258,40,19,21,4,3
10,263,263,30,6,24,2,1
12,286,286,25,4,21,2,1
22,292,292,15,15,0,1,0
3,299,299,54,8,46,4,3
40,315,315,66,66,0,1,0
30,317,317,28,28,0,1,0
23,318,318,18,3,15,4,3
0,327,327,7,7,0,1,0
17,339,339,23,14,9,2,1
9,343,343,22,12,10,3,2
7,355,355,74,52,22,3,2
21,361,361,4,1,3,2,1
32,365,365,50,50,0,1,0
38,370,370,35,1,34,3,2
16,385,385,1,1,0,1,0
36,391,391,80,48,32,3,2
6,392,392,42,9,33,2,1
14,400,400,8,2,6,2,1
31,402,402,15,7,8,2,1
42,405,405,3,3,0,1,0
26,439,439,72,72,0,1,0
25,442,442,98,98,0,1,0
19,452,452,27,27,0,1,0
28,457,457,86,22,64,4,3
2,460,460,3,3,0,1,0
39,472,472,38,22,16,2,1
4,476,476,55,55,0,1,0
20,491,491,22,22,0,1,0
33,493,493,27,27,0,1,0

5,108,108,13,5,8,2,1
43,109,109,1,1,0,1,0
34,115,115,15,3,12,2,1
37,137,137,6,6,0,1,0
22,150,150,35,35,0,1,0
15,150,150,2,2,0,1,0
36,159,159,2,2,0,1,0
7,164,164,5,5,0,1,0
25,175,175,14,14,0,1,0
6,202,202,12,12,0,1,0
1,202,202,1,1,0,1,0
9,214,214,2,2,0,1,0
16,216,216,14,5,9,3,2
24,223,223,1,1,0,1,0
0,227,227,4,1,3,2,1
12,233,233,1,1,0,1,0
27,233,233,109,82,27,2,1
40,257,257,49,49,0,1,0
38,281,281,12,8,4,2,1
17,285,285,1,1,0,1,0
31,297,297,23,15,8,2,1
14,297,297,1,1,0,1,0
28,303,303,26,4,22,3,2
11,310,310,30,30,0,1,0
26,311,311,42,18,24,3,2
23,320,320,30,30,0,1,0
41,329,329,26,2,24,3,2
29,333,333,38,38,0,1,0
35,335,335,88,16,72,4,3
2,346,346,21,21,0,1,0
33,350,350,45,2,43,2,1
32,351,351,15,15,0,1,0
42,355,355,9,9,0,1,0
21,363,363,24,24,0,1,0
3,368,368,10,7,3,2,1
13,381,381,225,84,141,4,3
8,392,392,10,10,0,1,0
39,416,416,9,9,0,1,0
18,430,430,36,36,0,1,0
19,442,442,11,11,0,1,0
30,460,460,42,42,0,1,0
4,466,466,62,26,36,3,2
10,483,483,57,9,48,4,3
20,487,487,56,56,0,1,0

21,108,108,4,1,3,2,1
18,133,133,5,5,0,1,0
30,145,145,2,2,0,1,0
15,146,146,22,4,18,3,2
17,155,155,3,3,0,1,0
25,186,186,2,2,0,1,0
29,211,211,24,24,0,1,0
13,214,214,6,2,4,2,1
9,233,233,7,7,0,1,0
3,239,239,40,6,34,2,1
27,253,253,99,99,0,1,0
11,269,269,187,69,118,4,3
22,286,286,3,3,0,1,0
33,312,312,85,60,25,2,1
6,315,315,8,8,0,1,0
16,315,315,53,53,0,1,0
0,329,329,36,36,0,1,0
5,337,337,4,4,0,1,0
32,378,378,6,6,0,1,0
4,382,382,21,21,0,1,0
28,389,389,95,95,0,1,0
2,400,400,3,3,0,1,0
14,406,406,33,10,23,2,1
19,417,417,3,3,0,1,0
26,424,424,83,43,40,3,2
1,426,426,13,13,0,1,0
12,432,432,204,204,0,1,0
20,446,446,14,9,5,2,1
23,461,461,51,12,39,2,1
8,467,467,20,20,0,1,0
24,483,483,33,21,12,4,3
31,495,495,30,10,20,3,2
10,498,498,19,19,0,1,0
7,500,500,145,94,51,4,3

18,103,103,1,1,0,1,0
36,106,106,9,9,0,1,0
19,119,119,33,33,0,1,0
22,135,135,25,1,24,4,3
26,138,138,6,6,0,1,0
13,187,187,3,3,0,1,0
33,209,209,21,10,11,2,1
23,211,211,18,12,6,2,1
30,214,214,49,49,0,1,0
1,222,222,47,3,44,2,1
10,227,227,6,6,0,1,0
20,229,229,26,4,22,2,1
27,241,241,33,6,27,4,3
15,255,255,19,5,14,2,1
31,272,272,1,1,0,1,0
11,277,277,9,1,8,2,1
4,282,282,45,14,31,2,1
28,294,294,40,25,15,2,1
21,295,295,19,13,6,3,2
32,296,296,14,1,13,2,1
29,298,298,15,15,0,1,0
6,310,310,18,18,0,1,0
3,311,311,1,1,0,1,0
8,329,329,57,1,56,4,3
2,339,339,7,7,0,1,0
34,340,340,10,10,0,1,0
17,349,349,117,75,42,4,3
25,350,350,24,24,0,1,0
7,377,377,12,7,5,2,1
35,383,383,7,7,0,1,0
24,389,389,6,3,3,2,1
5,438,438,10,10,0,1,0
0,449,449,161,140,21,2,1
14,456,456,26,17,9,2,1
9,458,458,187,175,12,4,3
16,460,460,156,156,0,1,0
12,482,482,4,4,0,1,0

15,105,105,1,1,0,1,0
24,110,110,15,4,11,2,1
21,121,121,1,1,0,1,0
16,129,129,8,4,4,2,1
27,139,139,16,16,0,1,0
37,151,151,5,5,0,1,0
35,165,165,30,1,29,3,2
39,173,173,67,67,0,1,0
7,174,174,23,23,0,1,0
5,178,178,36,6,30,4,3
9,186,186,14,14,0,1,0
25,188,188,10,3,7,2,1
10,201,201,7,1,6,2,1
8,209,209,13,4,9,4,3
0,230,230,25,25,0,1,0
18,240,240,25,15,10,3,2
19,240,240,31,17,14,3,2
36,241,241,4,4,0,1,0
11,247,247,12,12,0,1,0
12,248,248,53,53,0,1,0
29,253,253,40,1,39,2,1
3,258,258,1,1,0,1,0
20,283,283,1,1,0,1,0
14,287,287,32,32,0,1,0
26,328,328,2,2,0,1,0
4,349,349,73,73,0,1,0
34,352,352,2,2,0,1,0
38,388,388,10,10,0,1,0
23,396,396,65,65,0,1,0
1,414,414,27,27,0,1,0
13,431,431,11,2,9,2,1
6,431,431,111,45,66,4,3
22,434,434,16,5,11,2,1
2,439,439,15,15,0,1,0
32,463,463,133,56,77,4,3
17,469,469,52,52,0,1,0
28,472,472,27,1,26,2,1
31,487,487,61,61,0,1,0
33,493,493,87,5,82,4,3
30,496,496,27,19,8,2,1

35,101,101,23,23,0,1,0
28,104,104,5,5,0,1,0
1,111,111,1,1,0,1,0
15,116,116,56,56,0,1,0
12,156,156,6,6,0,1,0
21,162,162,5,5,0,1,0
6,166,166,9,6,3,2,1
32,193,193,5,5,0,1,0
0,208,208,1,1,0,1,0
10,224,224,2,2,0,1,0
5,228,228,58,58,0,1,0
36,229,229,30,30,0,1,0
34,238,238,17,1,16,2,1
18,276,276,92,92,0,1,0
2,283,283,52,31,21,4,3
27,296,296,18,2,16,2,1
16,316,316,14,7,7,2,1
17,331,331,49,19,30,2,1
9,332,332,47,47,0,1,0
26,346,346,57,23,34,2,1
8,347,347,18,18,0,1,0
19,351,351,58,46,12,2,1
22,362,362,13,8,5,2,1
33,364,364,36,36,0,1,0
7,365,365,53,37,16,2,1
25,375,375,16,16,0,1,0
30,378,378,25,25,0,1,0
23,384,384,12,9,3,2,1
3,406,406,3,3,0,1,0
20,427,427,70,33,37,3,2
11,444,444,112,9,103,4,3
13,444,444,26,20,6,2,1
31,445,445,66,51,15,4,3
14,451,451,63,6,57,4,3
4,454,454,57,57,0,1,0
29,458,458,14,4,10,2,1
24,481,481,9,4,5,2,1

17,113,113,7,4,3,2,1
13,122,122,1,1,0,1,0
4,136,136,7,1,6,3,2
34,138,138,13,9,4,2,1
2,139,139,4,4,0,1,0
18,156,156,12,12,0,1,0
9,158,158,10,2,8,3,2
39,158,158,9,9,0,1,0
6,166,166,17,2,15,4,3
12,174,174,1,1,0,1,0
14,180,180,8,4,4,2,1
25,191,191,11,11,0,1,0
37,203,203,17,2,15,4,3
29,208,208,8,8,0,1,0
3,209,209,1,1,0,1,0
16,232,232,77,77,0,1,0
40,244,244,52,52,0,1,0
22,249,249,20,20,0,1,0
26,258,258,48,48,0,1,0
31,271,271,7,7,0,1,0
44,273,273,14,14,0,1,0
10,288,288,11,11,0,1,0
43,290,290,35,17,18,3,2
21,297,297,4,1,3,2,1
47,319,319,49,16,33,4,3
33,328,328,4,1,3,2,1
15,343,343,18,10,8,3,2
36,344,344,13,13,0,1,0
45,357,357,16,2,14,2,1
23,375,375,42,42,0,1,0
8,395,395,1,1,0,1,0
35,396,396,36,36,0,1,0
11,399,399,4,1,3,2,1
42,408,408,38,38,0,1,0
20,412,412,47,14,33,2,1
5,414,414,7,2,5,2,1
0,419,419,11,5,6,2,1
1,419,419,46,46,0,1,0
27,428,428,68,30,38,4,3
46,432,432,77,49,28,2,1
28,435,435,20,10,10,3,2
24,446,446,6,6,0,1,0
19,455,455,24,24,0,1,0
7,471,471,83,44,39,2,1
41,474,474,65,45,20,2,1
30,480,480,66,46,20,2,1
32,487,487,122,49,73,4,3
38,500,500,84,27,57,3,2

39,109,109,4,1,3,2,1
4,112,112,8,8,0,1,0
42,119,119,2,2,0,1,0
2,122,122,10,10,0,1,0
35,123,123,2,2,0,1,0
34,142,142,18,2,16,2,1
14,145,145,7,7,0,1,0
10,155,155,6,6,0,1,0
37,159,159,1,1,0,1,0
43,176,176,45,24,21,4,3
9,185,185,17,17,0,1,0
1,197,197,1,1,0,1,0
26,203,203,4,4,0,1,0
6,203,203,17,6,11,2,1
21,217,217,7,7,0,1,0
31,219,219,26,16,10,2,1
28,225,225,18,18,0,1,0
27,229,229,1,1,0,1,0
23,231,231,22,12,10,3,2
15,241,241,30,22,8,2,1
0,243,243,11,1,10,2,1
5,249,249,52,52,0,1,0
8,265,265,8,3,5,2,1
25,289,289,40,40,0,1,0
29,296,296,27,27,0,1,0
33,305,305,7,7,0,1,0
40,309,309,24,24,0,1,0
24,311,311,21,2,19,2,1
3,319,319,20,20,0,1,0
41,324,324,30,3,27,2,1
44,329,329,82,69,13,2,1
32,329,329,65,26,39,4,3
12,332,332,38,30,8,2,1
36,379,379,53,53,0,1,0
18,383,383,64,1,63,4,3
16,406,406,72,72,0,1,0
19,414,414,20,20,0,1,0
30,416,416,143,140,3,2,1
17,418,418,10,1,9,2,1
22,432,432,35,35,0,1,0
38,456,456,4,1,3,2,1
13,457,457,7,7,0,1,0
20,465,465,19,9,10,3,2
11,469,469,50,50,0,1,0
7,487,487,67,67,0,1,0

38,104,104,2,2,0,1,0
36,105,105,24,24,0,1,0
34,128,128,16,16,0,1,0
0,134,134,8,8,0,1,0
6,178,178,5,5,0,1,0
9,203,203,26,26,0,1,0
37,208,208,9,1,8,3,2
20,229,229,2,2,0,1,0
35,233,233,28,7,21,2,1
7,245,245,19,19,0,1,0
31,251,251,22,7,15,2,1
40,265,265,6,6,0,1,0
41,269,269,22,22,0,1,0
3,272,272,33,33,0,1,0
8,273,273,12,8,4,2,1
18,273,273,18,10,8,2,1
26,295,295,1,1,0,1,0
30,302,302,31,14,17,2,1
27,333,333,20,20,0,1,0
32,334,334,68,38,30,4,3
21,339,339,43,31,12,3,2
13,345,345,71,51,20,4,3
28,366,366,9,9,0,1,0
33,382,382,26,2,24,3,2
15,383,383,47,14,33,4,3
2,388,388,76,36,40,2,1
16,391,391,41,3,38,2,1
22,398,398,6,6,0,1,0
24,403,403,95,7,88,3,2
1,417,417,3,3,0,1,0
39,419,419,137,137,0,1,0
19,430,430,56,56,0,1,0
14,435,435,13,13,0,1,0
11,443,443,36,36,0,1,0
23,446,446,36,10,26,2,1
25,455,455,41,31,10,2,1
42,456,456,43,43,0,1,0
10,456,456,116,13,103,4,3
12,472,472,5,2,3,2,1
29,478,478,7,7,0,1,0
17,478,478,3,3,0,1,0
4,480,480,2,2,0,1,0
5,483,483,84,34,50,2,1

35,108,108,4,4,0,1,0
0,110,110,7,1,6,3,2
23,141,141,9,9,0,1,0
10,153,153,6,6,0,1,0
13,156,156,9,4,5,2,1
32,173,173,26,26,0,1,0
3,188,188,13,13,0,1,0
37,204,204,4,1,3,2,1
9,210,210,8,8,0,1,0
11,227,227,29,20,9,4,3
26,227,227,12,12,0,1,0
33,245,245,18,9,9,3,2
12,250,250,5,5,0,1,0
5,271,271,34,4,30,3,2
38,281,281,14,4,10,3,2
30,293,293,31,12,19,3,2
7,295,295,135,135,0,1,0
17,295,295,54,54,0,1,0
14,324,324,4,4,0,1,0
29,355,355,50,30,20,3,2
27,369,369,116,74,42,4,3
6,383,383,53,53,0,1,0
20,388,388,40,40,0,1,0
19,390,390,1,1,0,1,0
22,400,400,4,4,0,1,0
28,406,406,11,3,8,3,2
34,407,407,21,21,0,1,0
25,412,412,19,19,0,1,0
16,416,416,84,29,55,4,3
15,417,417,5,5,0,1,0
36,436,436,68,68,0,1,0
24,443,443,10,4,6,2,1
21,444,444,51,9,42,3,2
31,447,447,218,218,0,1,0
4,457,457,49,49,0,1,0
39,467,467,7,3,4,2,1
8,473,473,9,9,0,1,0
1,485,485,62,16,46,2,1
18,493,493,37,37,0,1,0
2,500,500,62,62,0,1,0

9,115,115,1,1,0,1,0
17,119,119,1,1,0,1,0
20,122,122,13,1,12,4,3
12,141,141,12,3,9,4,3
3,157,157,7,7,0,1,0
16,157,157,18,18,0,1,0
0,158,158,1,1,0,1,0
31,167,167,23,15,8,2,1
7,173,173,111,27,84,4,3
18,194,194,6,2,4,2,1
29,201,201,1,1,0,1,0
13,216,216,16,4,12,4,3
2,253,253,159,159,0,1,0
14,253,253,28,17,11,4,3
11,259,259,22,22,0,1,0
26,277,277,66,22,44,3,2
23,290,290,3,3,0,1,0
22,305,305,51,51,0,1,0
8,311,311,51,51,0,1,0
30,313,313,5,5,0,1,0
1,333,333,13,5,8,3,2
28,351,351,97,73,24,4,3
19,352,352,45,45,0,1,0
24,362,362,39,8,31,2,1
10,380,380,32,26,6,2,1
32,388,388,79,31,48,4,3
15,401,401,40,3,37,2,1
25,403,403,6,6,0,1,0
5,457,457,35,7,28,3,2
21,484,484,2,2,0,1,0
33,486,486,91,38,53,3,2
6,488,488,12,12,0,1,0
27,497,497,34,13,21,2,1
4,499,499,19,19,0,1,0

7,128,128,6,6,0,1,0
32,139,139,11,11,0,1,0
34,147,147,11,11,0,1,0
25,162,162,3,3,0,1,0
3,164,164,72,37,35,2,1
29,192,192,38,30,8,2,1
4,198,198,1,1,0,1,0
19,204,204,42,42,0,1,0
14,210,210,1,1,0,1,0
38,229,229,12,12,0,1,0
28,236,236,9,9,0,1,0
39,242,242,58,8,50,4,3
27,248,248,20,20,0,1,0
36,260,260,74,47,27,4,3
13,263,263,34,1,33,4,3
26,265,265,28,1,27,4,3
18,275,275,7,1,6,3,2
22,288,288,45,45,0,1,0
10,292,292,13,13,0,1,0
37,296,296,16,5,11,2,1
15,300,300,27,27,0,1,0
24,320,320,9,3,6,3,2
0,344,344,1,1,0,1,0
35,357,357,27,27,0,1,0
20,366,366,42,42,0,1,0
5,380,380,18,18,0,1,0
12,391,391,13,13,0,1,0
33,394,394,46,46,0,1,0
16,417,417,9,9,0,1,0
11,441,441,33,1,32,2,1
30,443,443,65,65,0,1,0
23,448,448,117,80,37,4,3
40,454,454,4,1,3,2,1
2,464,464,19,19,0,1,0
21,468,468,30,5,25,2,1
6,473,473,60,60,0,1,0
41,479,479,5,5,0,1,0
9,481,481,25,25,0,1,0
8,488,488,55,46,9,2,1
31,493,493,9,6,3,2,1
1,494,494,142,114,28,2,1
17,496,496,16,4,12,4,3

12,103,103,11,11,0,1,0
36,104,104,7,7,0,1,0
15,117,117,30,30,0,1,0
41,132,132,2,2,0,1,0
6,134,134,1,1,0,1,0
1,141,141,4,4,0,1,0
31,149,149,6,6,0,1,0
22,152,152,33,28,5,2,1
35,155,155,1,1,0,1,0
37,157,157,65,65,0,1,0
42,183,183,8,8,0,1,0
19,185,185,17,17,0,1,0
8,199,199,26,14,12,2,1
20,199,199,20,20,0,1,0
2,205,205,16,6,10,3,2
25,206,206,1,1,0,1,0
21,207,207,16,16,0,1,0
5,216,216,17,17,0,1,0
14,231,231,11,11,0,1,0
45,236,236,1,1,0,1,0
11,246,246,1,1,0,1,0
33,249,249,29,21,8,2,1
44,264,264,11,11,0,1,0
48,270,270,18,18,0,1,0
17,270,270,7,7,0,1,0
47,305,305,12,12,0,1,0
29,318,318,3,3,0,1,0
18,333,333,9,9,0,1,0
49,347,347,27,11,16,4,3
4,362,362,20,20,0,1,0
32,380,380,41,41,0,1,0
30,386,386,9,9,0,1,0
16,407,407,46,46,0,1,0
27,413,413,65,65,0,1,0
23,431,431,14,14,0,1,0
38,432,432,113,23,90,3,2
13,438,438,5,5,0,1,0
28,444,444,22,22,0,1,0
3,450,450,28,3,25,2,1
24,452,452,14,10,4,2,1
39,454,454,43,43,0,1,0
26,456,456,4,4,0,1,0
9,460,460,16,2,14,2,1
40,463,463,19,19,0,1,0
10,469,469,2,2,0,1,0
34,489,489,239,211,28,2,1
43,490,490,46,19,27,3,2
0,491,491,34,34,0,1,0
46,492,492,3,3,0,1,0
7,498,498,40,40,0,1,0

15,112,112,3,3,0,1,0
8,113,113,15,15,0,1,0
27,114,114,10,10,0,1,0
5,114,114,14,14,0,1,0
0,157,157,34,25,9,2,1
13,157,157,28,28,0,1,0
11,162,162,15,15,0,1,0
33,164,164,23,12,11,2,1
25,166,166,23,23,0,1,0
26,170,170,8,8,0,1,0
3,191,191,2,2,0,1,0
31,191,191,13,13,0,1,0
9,192,192,5,5,0,1,0
37,193,193,38,38,0,1,0
40,219,219,13,5,8,2,1
6,228,228,23,23,0,1,0
41,263,263,21,21,0,1,0
29,293,293,15,15,0,1,0
7,299,299,104,104,0,1,0
4,307,307,21,11,10,3,2
16,312,312,25,6,19,4,3
21,317,317,20,1,19,4,3
2,318,318,18,18,0,1,0
17,318,318,1,1,0,1,0
35,318,318,21,21,0,1,0
39,324,324,24,24,0,1,0
23,328,328,11,11,0,1,0
14,340,340,9,9,0,1,0
24,349,349,40,4,36,2,1
34,364,364,88,64,24,4,3
22,365,365,25,25,0,1,0
10,376,376,25,13,12,2,1
18,377,377,16,7,9,4,3
32,428,428,32,15,17,2,1
38,432,432,26,8,18,4,3
30,434,434,3,3,0,1,0
12,444,444,2,2,0,1,0
36,444,444,145,145,0,1,0
20,453,453,51,51,0,1,0
19,467,467,17,14,3,2,1
42,496,496,42,42,0,1,0
28,499,499,45,45,0,1,0
1,499,499,58,43,15,2,1

14,101,101,25,4,21,2,1
23,106,106,16,16,0,1,0
29,107,107,2,2,0,1,0
10,108,108,10,4,6,3,2
15,115,115,18,4,14,2,1
31,116,116,13,5,8,2,1
4,157,157,15,15,0,1,0
25,170,170,61,13,48,2,1
30,185,185,8,8,0,1,0
13,229,229,22,22,0,1,0
0,234,234,11,11,0,1,0
32,243,243,52,14,38,2,1
34,267,267,15,4,11,2,1
5,304,304,14,11,3,2,1
26,311,311,34,12,22,2,1
8,322,322,15,3,12,3,2
24,344,344,13,13,0,1,0
21,346,346,112,109,3,2,1
28,352,352,11,7,4,2,1
17,363,363,6,6,0,1,0
18,370,370,42,24,18,4,3
7,375,375,4,4,0,1,0
33,394,394,45,45,0,1,0
6,397,397,70,70,0,1,0
16,404,404,20,16,4,2,1
35,424,424,51,51,0,1,0
20,432,432,21,8,13,2,1
9,444,444,147,89,58,3,2
3,452,452,30,30,0,1,0
22,461,461,26,26,0,1,0
11,463,463,198,198,0,1,0
1,464,464,29,4,25,2,1
27,491,491,15,2,13,2,1
19,499,499,18,8,10,3,2
12,500,500,21,11,10,3,2
2,500,500,29,17,12,2,1

43,101,101,24,9,15,2,1
29,102,102,21,21,0,1,0
28,107,107,5,5,0,1,0
32,123,123,3,3,0,1,0
9,124,124,1,1,0,1,0
27,138,138,15,12,3,2,1
35,140,140,24,24,0,1,0
20,145,145,15,15,0,1,0
38,149,149,29,17,12,3,2
41,160,160,22,22,0,1,0
33,166,166,2,2,0,1,0
14,168,168,1,1,0,1,0
22,171,171,11,11,0,1,0
25,176,176,15,2,13,2,1
31,187,187,10,10,0,1,0
17,198,198,12,12,0,1,0
7,220,220,7,7,0,1,0
44,229,229,15,3,12,2,1
3,229,229,64,31,33,4,3
12,232,232,44,44,0,1,0
34,256,256,19,19,0,1,0
6,276,276,1,1,0,1,0
1,280,280,23,23,0,1,0
40,284,284,12,12,0,1,0
26,290,290,1,1,0,1,0
4,291,291,53,53,0,1,0
45,302,302,5,5,0,1,0
37,324,324,12,12,0,1,0
0,372,372,19,19,0,1,0
16,382,382,61,20,41,4,3
30,384,384,47,3,44,2,1
15,394,394,5,5,0,1,0
2,405,405,34,34,0,1,0
23,412,412,19,19,0,1,0
13,425,425,24,24,0,1,0
36,427,427,59,59,0,1,0
11,433,433,30,22,8,3,2
39,446,446,130,111,19,2,1
10,455,455,35,21,14,2,1
5,456,456,14,14,0,1,0
24,462,462,12,12,0,1,0
19,463,463,33,18,15,2,1
21,469,469,45,3,42,3,2
18,472,472,33,18,15,4,3
42,482,482,32,32,0,1,0
8,495,495,29,3,26,3,2

0,114,114,3,3,0,1,0
14,117,117,1,1,0,1,0
37,119,119,8,2,6,2,1
31,125,125,54,54,0,1,0
20,146,146,16,8,8,3,2
12,156,156,6,6,0,1,0
29,156,156,9,9,0,1,0
34,160,160,33,18,15,2,1
17,170,170,1,1,0,1,0
13,181,181,12,6,6,3,2
22,183,183,6,2,4,2,1
40,199,199,1,1,0,1,0
41,203,203,13,13,0,1,0
11,209,209,12,3,9,3,2
18,211,211,4,1,3,2,1
2,221,221,3,3,0,1,0
6,226,226,12,12,0,1,0
39,229,229,4,4,0,1,0
23,249,249,13,13,0,1,0
27,250,250,5,1,4,2,1
10,260,260,73,73,0,1,0
16,271,271,1,1,0,1,0
33,283,283,38,38,0,1,0
19,301,301,25,25,0,1,0
8,312,312,44,6,38,3,2
15,328,328,58,52,6,2,1
38,351,351,7,2,5,2,1
21,352,352,32,11,21,2,1
25,370,370,4,4,0,1,0
9,382,382,40,40,0,1,0
35,392,392,12,12,0,1,0
4,393,393,68,35,33,4,3
36,410,410,6,6,0,1,0
28,413,413,29,20,9,4,3
1,418,418,9,9,0,1,0
5,436,436,106,61,45,4,3
30,440,440,32,32,0,1,0
3,442,442,100,22,78,3,2
7,469,469,28,16,12,4,3
32,478,478,54,33,21,4,3
26,486,486,111,81,30,4,3
24,488,488,192,174,18,3,2

22,107,107,1,1,0,1,0
41,109,109,34,2,32,3,2
18,113,113,1,1,0,1,0
17,124,124,3,3,0,1,0
15,129,129,12,12,0,1,0
19,133,133,2,2,0,1,0
36,144,144,6,1,5,2,1
2,168,168,29,29,0,1,0
20,171,171,3,3,0,1,0
25,174,174,20,6,14,3,2
9,177,177,31,31,0,1,0
26,180,180,29,15,14,2,1
28,189,189,11,11,0,1,0
42,200,200,29,29,0,1,0
34,211,211,50,50,0,1,0
6,223,223,14,14,0,1,0
0,237,237,2,2,0,1,0
30,240,240,2,2,0,1,0
4,253,253,3,3,0,1,0
33,256,256,59,16,43,4,3
37,258,258,53,41,12,3,2
11,263,263,14,14,0,1,0
16,289,289,28,15,13,2,1
29,290,290,21,5,16,4,3
14,299,299,1,1,0,1,0
40,320,320,2,2,0,1,0
13,338,338,15,15,0,1,0
39,343,343,2,2,0,1,0
10,350,350,43,43,0,1,0
27,356,356,6,6,0,1,0
44,369,369,23,23,0,1,0
21,371,371,77,77,0,1,0
12,376,376,10,10,0,1,0
31,394,394,30,30,0,1,0
46,397,397,134,55,79,4,3
7,409,409,20,20,0,1,0
5,425,425,28,4,24,4,3
8,427,427,68,68,0,1,0
23,434,434,7,7,0,1,0
38,435,435,16,16,0,1,0
43,446,446,23,15,8,3,2
1,447,447,36,5,31,2,1
24,448,448,35,35,0,1,0
45,450,450,7,2,5,2,1
3,464,464,57,57,0,1,0
35,489,489,20,20,0,1,0
32,500,500,34,34,0,1,0

0,111,111,26,26,0,1,0
14,112,112,10,10,0,1,0
22,156,156,8,1,7,2,1
30,159,159,6,6,0,1,0
16,167,167,36,36,0,1,0
33,167,167,15,10,5,2,1
27,169,169,37,37,0,1,0
28,175,175,7,7,0,1,0
21,195,195,4,4,0,1,0
1,196,196,4,4,0,1,0
10,196,196,44,15,29,2,1
20,241,241,5,5,0,1,0
11,251,251,29,29,0,1,0
25,269,269,12,12,0,1,0
32,278,278,17,17,0,1,0
17,278,278,140,68,72,4,3
31,279,279,47,21,26,4,3
24,279,279,2,2,0,1,0
3,287,287,8,8,0,1,0
2,293,293,1,1,0,1,0
8,301,301,120,120,0,1,0
9,316,316,27,27,0,1,0
35,324,324,9,1,8,2,1
13,354,354,6,1,5,2,1
4,359,359,35,2,33,2,1
26,382,382,2,2,0,1,0
19,384,384,13,13,0,1,0
12,385,385,4,4,0,1,0
23,423,423,4,4,0,1,0
15,459,459,51,39,12,2,1
29,469,469,71,35,36,4,3
6,486,486,13,6,7,2,1
34,494,494,112,35,77,4,3
5,495,495,17,17,0,1,0
18,496,496,49,49,0,1,0
7,499,499,252,178,74,3,2

21,114,114,18,6,12,2,1
32,131,131,6,6,0,1,0
29,155,155,4,4,0,1,0
12,159,159,4,1,3,2,1
17,166,166,7,7,0,1,0
36,171,171,12,12,0,1,0
33,181,181,22,3,19,2,1
25,206,206,28,2,26,2,1
19,210,210,15,15,0,1,0
22,247,247,88,12,76,4,3
11,250,250,13,13,0,1,0
3,275,275,47,20,27,4,3
7,276,276,2,2,0,1,0
8,321,321,5,5,0,1,0
31,325,325,64,64,0,1,0
38,333,333,26,17,9,4,3
35,343,343,7,7,0,1,0
39,345,345,54,45,9,4,3
18,347,347,24,2,22,2,1
24,351,351,15,9,6,2,1
30,369,369,8,8,0,1,0
20,378,378,16,16,0,1,0
15,379,379,23,23,0,1,0
26,388,388,17,11,6,3,2
2,412,412,138,126,12,4,3
6,412,412,1,1,0,1,0
34,417,417,4,4,0,1,0
1,417,417,87,6,81,4,3
0,438,438,13,2,11,2,1
16,449,449,64,17,47,2,1
13,451,451,119,119,0,1,0
28,465,465,16,10,6,3,2
14,469,469,95,11,84,3,2
23,469,469,67,9,58,3,2
9,470,470,37,37,0,1,0
5,479,479,49,10,39,4,3
4,481,481,52,2,50,3,2
37,495,495,53,53,0,1,0
10,496,496,8,8,0,1,0
27,499,499,116,116,0,1,0

13,100,100,10,5,5,2,1
5,109,109,9,4,5,2,1
28,121,121,20,20,0,1,0
39,127,127,16,8,8,3,2
31,135,135,15,12,3,2,1
45,135,135,10,1,9,2,1
15,143,143,12,3,9,4,3
12,160,160,3,3,0,1,0
9,161,161,3,3,0,1,0
14,173,173,5,5,0,1,0
44,176,176,21,3,18,4,3
18,179,179,5,5,0,1,0
22,180,180,19,19,0,1,0
36,187,187,6,6,0,1,0
43,189,189,10,10,0,1,0
35,200,200,11,11,0,1,0
50,213,213,17,2,15,2,1
21,218,218,10,2,8,2,1
7,236,236,11,2,9,2,1
47,241,241,4,1,3,2,1
23,246,246,1,1,0,1,0
41,259,259,23,5,18,4,3
25,274,274,13,13,0,1,0
49,281,281,36,36,0,1,0
46,285,285,4,4,0,1,0
20,307,307,11,11,0,1,0
29,315,315,45,45,0,1,0
48,318,318,31,31,0,1,0
32,322,322,34,10,24,4,3
1,325,325,1,1,0,1,0
10,333,333,10,1,9,2,1
6,350,350,46,6,40,2,1
38,353,353,45,23,22,3,2
40,358,358,17,11,6,2,1
26,395,395,6,6,0,1,0
34,399,399,17,11,6,2,1
2,403,403,19,19,0,1,0
16,404,404,11,11,0,1,0
19,410,410,4,1,3,2,1
37,414,414,58,58,0,1,0
3,425,425,17,17,0,1,0
30,431,431,30,30,0,1,0
4,433,433,28,7,21,2,1
42,435,435,132,132,0,1,0
27,442,442,36,2,34,3,2
17,447,447,35,16,19,4,3
24,452,452,30,10,20,4,3
0,453,453,152,152,0,1,0
11,470,470,2,2,0,1,0
33,490,490,141,141,0,1,0
8,496,496,21,21,0,1,0

25,114,114,13,13,0,1,0
11,130,130,6,6,0,1,0
32,142,142,18,18,0,1,0
21,165,165,28,8,20,2,1
9,178,178,12,12,0,1,0
26,182,182,26,11,15,2,1
38,199,199,11,11,0,1,0
1,205,205,26,26,0,1,0
24,226,226,1,1,0,1,0
30,227,227,13,5,8,2,1
3,231,231,1,1,0,1,0
14,234,234,39,39,0,1,0
4,238,238,22,7,15,4,3
0,239,239,23,23,0,1,0
7,244,244,38,38,0,1,0
39,248,248,23,20,3,2,1
19,250,250,16,16,0,1,0
29,255,255,26,12,14,2,1
12,266,266,6,6,0,1,0
35,269,269,53,43,10,2,1
8,271,271,2,2,0,1,0
28,273,273,36,32,4,2,1
10,308,308,49,49,0,1,0
27,319,319,36,21,15,2,1
6,326,326,11,11,0,1,0
20,336,336,44,26,18,4,3
2,341,341,144,110,34,3,2
23,360,360,23,23,0,1,0
16,367,367,15,15,0,1,0
36,367,367,25,25,0,1,0
5,389,389,17,17,0,1,0
31,420,420,1,1,0,1,0
37,428,428,70,16,54,3,2
13,436,436,56,56,0,1,0
17,439,439,17,17,0,1,0
18,447,447,32,32,0,1,0
34,454,454,5,1,4,2,1
15,461,461,99,71,28,4,3
22,478,478,50,50,0,1,0
33,484,484,89,89,0,1,0

30,115,115,27,27,0,1,0
10,118,118,30,6,24,4,3
7,128,128,29,29,0,1,0
25,138,138,13,13,0,1,0
17,177,177,12,4,8,3,2
26,178,178,11,11,0,1,0
16,190,190,49,21,28,3,2
0,192,192,15,1,14,3,2
29,194,194,25,10,15,4,3
3,200,200,5,5,0,1,0
27,202,202,121,121,0,1,0
37,210,210,40,40,0,1,0
2,219,219,6,6,0,1,0
4,228,228,55,55,0,1,0
12,239,239,11,6,5,2,1
8,260,260,3,3,0,1,0
34,270,270,1,1,0,1,0
36,279,279,1,1,0,1,0
28,279,279,16,16,0,1,0
21,291,291,2,2,0,1,0
18,317,317,24,17,7,2,1
23,321,321,20,12,8,3,2
31,322,322,38,38,0,1,0
9,324,324,8,8,0,1,0
15,338,338,34,34,0,1,0
14,345,345,42,42,0,1,0
5,352,352,97,77,20,2,1
32,356,356,3,3,0,1,0
35,366,366,6,6,0,1,0
33,369,369,1,1,0,1,0
11,382,382,26,6,20,2,1
24,402,402,9,9,0,1,0
1,417,417,34,18,16,3,2
19,422,422,55,14,41,2,1
22,458,458,46,4,42,2,1
20,476,476,56,22,34,3,2
13,490,490,4,4,0,1,0
6,490,490,42,24,18,4,3

41,119,119,34,34,0,1,0
27,119,119,4,1,3,2,1
42,135,135,12,12,0,1,0
48,141,141,13,7,6,3,2
4,148,148,4,4,0,1,0
8,153,153,12,12,0,1,0
24,180,180,6,6,0,1,0
40,182,182,27,5,22,2,1
1,188,188,19,19,0,1,0
17,203,203,2,2,0,1,0
38,203,203,4,4,0,1,0
34,205,205,67,67,0,1,0
13,206,206,35,5,30,4,3
2,212,212,29,13,16,2,1
12,216,216,1,1,0,1,0
9,254,254,5,2,3,2,1
28,277,277,27,27,0,1,0
32,281,281,19,19,0,1,0
26,283,283,16,16,0,1,0
6,283,283,10,10,0,1,0
25,307,307,6,6,0,1,0
21,313,313,6,6,0,1,0
20,315,315,7,7,0,1,0
19,329,329,17,17,0,1,0
11,330,330,7,3,4,2,1
47,331,331,37,23,14,3,2
3,338,338,10,4,6,2,1
14,340,340,20,8,12,3,2
35,342,342,32,5,27,3,2
46,345,345,38,12,26,2,1
45,350,350,31,31,0,1,0
30,358,358,46,13,33,4,3
37,365,365,36,36,0,1,0
16,369,369,76,76,0,1,0
22,374,374,133,94,39,3,2
33,374,374,19,19,0,1,0
44,389,389,42,25,17,2,1
10,391,391,5,5,0,1,0
7,397,397,12,7,5,2,1
43,397,397,43,3,40,4,3
31,397,397,9,3,6,3,2
15,398,398,17,17,0,1,0
18,413,413,4,4,0,1,0
39,425,425,24,24,0,1,0
23,438,438,58,21,37,2,1
29,440,440,11,2,9,2,1
0,456,456,52,52,0,1,0
5,467,467,33,1,32,2,1
36,500,500,4,4,0,1,0

14,101,101,10,10,0,1,0
35,107,107,1,1,0,1,0
31,107,107,30,30,0,1,0
11,124,124,6,6,0,1,0
20,133,133,1,1,0,1,0
22,133,133,55,27,28,2,1
25,153,153,6,6,0,1,0
28,159,159,4,4,0,1,0
41,209,209,76,37,39,4,3
19,241,241,16,16,0,1,0
21,243,243,12,12,0,1,0
8,244,244,2,2,0,1,0
18,248,248,47,47,0,1,0
34,252,252,6,1,5,2,1
5,254,254,19,19,0,1,0
16,254,254,4,4,0,1,0
1,257,257,16,3,13,2,1
3,275,275,2,2,0,1,0
2,278,278,48,26,22,4,3
29,281,281,41,41,0,1,0
9,307,307,81,81,0,1,0
33,308,308,16,16,0,1,0
0,318,318,1,1,0,1,0
30,321,321,4,4,0,1,0
10,326,326,18,15,3,2,1
39,335,335,14,14,0,1,0
4,348,348,3,3,0,1,0
40,363,363,22,22,0,1,0
13,379,379,7,4,3,2,1
24,387,387,26,11,15,4,3
26,387,387,18,8,10,2,1
38,398,398,17,9,8,2,1
23,410,410,4,4,0,1,0
15,418,418,153,75,78,3,2
17,420,420,23,23,0,1,0
27,421,421,81,81,0,1,0
37,452,452,53,37,16,2,1
32,454,454,6,6,0,1,0
12,459,459,77,77,0,1,0
6,459,459,35,23,12,3,2
36,472,472,37,3,34,2,1
7,498,498,93,58,35,2,1

2,119,119,2,2,0,1,0
33,136,136,5,5,0,1,0
36,140,140,3,3,0,1,0
34,154,154,13,13,0,1,0
17,162,162,8,2,6,2,1
7,172,172,10,6,4,2,1
5,179,179,17,1,16,3,2
29,179,179,14,11,3,2,1
11,191,191,10,1,9,2,1
25,198,198,16,16,0,1,0
41,198,198,3,3,0,1,0
21,224,224,4,4,0,1,0
26,226,226,11,11,0,1,0
28,232,232,7,4,3,2,1
8,242,242,26,26,0,1,0
42,246,246,19,7,12,3,2
24,263,263,59,59,0,1,0
20,275,275,9,9,0,1,0
16,276,276,4,4,0,1,0
3,280,280,24,6,18,2,1
1,280,280,12,12,0,1,0
37,283,283,88,88,0,1,0
14,294,294,45,12,33,4,3
4,298,298,73,13,60,4,3
0,301,301,20,20,0,1,0
40,307,307,64,8,56,3,2
35,317,317,8,8,0,1,0
38,321,321,37,37,0,1,0
23,332,332,5,5,0,1,0
39,334,334,37,37,0,1,0
19,337,337,136,31,105,4,3
43,339,339,4,4,0,1,0
18,350,350,45,45,0,1,0
6,357,357,3,3,0,1,0
27,378,378,10,4,6,3,2
22,394,394,61,51,10,3,2
10,414,414,14,11,3,2,1
12,414,414,32,2,30,4,3
9,444,444,19,12,7,2,1
31,457,457,159,117,42,4,3
15,461,461,4,4,0,1,0
13,464,464,42,4,38,2,1
30,466,466,3,3,0,1,0
32,486,486,87,63,24,4,3

3,107,107,18,18,0,1,0
24,109,109,3,3,0,1,0
7,143,143,1,1,0,1,0
26,155,155,6,6,0,1,0
8,168,168,5,5,0,1,0
13,195,195,5,5,0,1,0
29,196,196,29,29,0,1,0
30,198,198,37,37,0,1,0
12,199,199,36,36,0,1,0
39,211,211,74,74,0,1,0
42,212,212,2,2,0,1,0
9,219,219,1,1,0,1,0
36,220,220,20,20,0,1,0
10,224,224,1,1,0,1,0
38,243,243,14,6,8,3,2
15,270,270,28,24,4,2,1
23,271,271,16,16,0,1,0
22,278,278,5,5,0,1,0
19,294,294,16,3,13,2,1
41,316,316,23,23,0,1,0
31,343,343,67,67,0,1,0
14,344,344,44,44,0,1,0
27,351,351,23,23,0,1,0
2,355,355,67,28,39,2,1
25,360,360,82,48,34,3,2
17,368,368,36,18,18,4,3
21,373,373,13,1,12,3,2
4,391,391,27,27,0,1,0
20,405,405,2,2,0,1,0
32,406,406,12,5,7,2,1
40,406,406,75,40,35,3,2
1,409,409,16,16,0,1,0
5,418,418,95,59,36,3,2
28,419,419,7,7,0,1,0
18,420,420,26,26,0,1,0
37,426,426,6,6,0,1,0
6,456,456,102,18,84,4,3
0,460,460,34,34,0,1,0
33,466,466,86,6,80,3,2
34,468,468,15,1,14,3,2
11,468,468,17,17,0,1,0
16,482,482,105,11,94,3,2
35,494,494,25,13,12,4,3

28,107,107,7,2,5,2,1
16,115,115,12,5,7,2,1
35,140,140,8,1,7,2,1
14,151,151,19,4,15,2,1
21,162,162,2,2,0,1,0
34,172,172,4,4,0,1,0
25,172,172,11,11,0,1,0
18,179,179,8,1,7,3,2
30,180,180,58,12,46,3,2
22,189,189,36,19,17,2,1
26,198,198,8,8,0,1,0
0,218,218,57,57,0,1,0
4,222,222,11,4,7,2,1
31,230,230,5,1,4,2,1
11,258,258,22,4,18,4,3
7,274,274,7,1,6,3,2
6,285,285,104,65,39,4,3
1,290,290,32,17,15,2,1
10,295,295,23,6,17,2,1
24,327,327,136,56,80,4,3
20,328,328,34,34,0,1,0
3,336,336,4,4,0,1,0
2,354,354,17,17,0,1,0
5,369,369,4,4,0,1,0
9,370,370,24,24,0,1,0
8,376,376,27,27,0,1,0
19,377,377,3,3,0,1,0
17,384,384,3,3,0,1,0
12,387,387,35,23,12,3,2
27,392,392,8,8,0,1,0
15,410,410,125,14,111,4,3
29,428,428,56,47,9,4,3
13,441,441,131,51,80,4,3
23,469,469,50,10,40,3,2
33,481,481,100,41,59,4,3
32,495,495,51,2,49,2,1

1,107,107,3,3,0,1,0
5,114,114,3,3,0,1,0
34,129,129,3,3,0,1,0
24,142,142,35,26,9,4,3
31,167,167,8,2,6,2,1
28,183,183,11,1,10,2,1
32,184,184,2,2,0,1,0
13,197,197,17,2,15,2,1
36,201,201,19,19,0,1,0
22,208,208,8,8,0,1,0
30,208,208,12,2,10,2,1
18,252,252,79,79,0,1,0
7,262,262,14,14,0,1,0
29,262,262,10,10,0,1,0
25,266,266,106,24,82,3,2
26,279,279,20,13,7,2,1
9,282,282,25,1,24,2,1
33,291,291,7,7,0,1,0
11,292,292,1,1,0,1,0
4,311,311,4,1,3,2,1
23,335,335,16,16,0,1,0
0,343,343,61,61,0,1,0
2,344,344,46,8,38,3,2
8,352,352,34,34,0,1,0
15,365,365,92,92,0,1,0
17,376,376,5,5,0,1,0
37,380,380,35,35,0,1,0
10,382,382,18,18,0,1,0
14,407,407,69,69,0,1,0
20,412,412,44,14,30,3,2
19,437,437,5,5,0,1,0
27,444,444,93,67,26,3,2
21,458,458,57,3,54,3,2
35,460,460,11,2,9,2,1
3,471,471,92,58,34,3,2
16,475,475,44,44,0,1,0
12,477,477,156,156,0,1,0
6,484,484,96,22,74,3,2

11,113,113,4,4,0,1,0
7,116,116,6,6,0,1,0
42,121,121,1,1,0,1,0
33,126,126,12,12,0,1,0
9,141,141,11,11,0,1,0
31,153,153,15,12,3,2,1
25,175,175,5,5,0,1,0
15,178,178,1,1,0,1,0
30,188,188,7,7,0,1,0
34,212,212,15,8,7,2,1
27,228,228,3,3,0,1,0
1,228,228,35,5,30,3,2
23,232,232,59,59,0,1,0
5,233,233,38,38,0,1,0
14,237,237,20,9,11,2,1
35,245,245,21,21,0,1,0
3,261,261,10,1,9,4,3
2,263,263,23,3,20,2,1
22,267,267,40,4,36,4,3
12,299,299,6,6,0,1,0
4,303,303,11,7,4,2,1
40,304,304,46,10,36,4,3
29,331,331,69,69,0,1,0
39,334,334,10,10,0,1,0
43,336,336,85,40,45,4,3
37,338,338,30,30,0,1,0
16,340,340,14,2,12,3,2
6,347,347,24,20,4,2,1
13,350,350,6,6,0,1,0
32,356,356,41,11,30,3,2
8,365,365,6,6,0,1,0
36,370,370,7,7,0,1,0
26,377,377,146,38,108,4,3
28,388,388,75,75,0,1,0
10,415,415,29,21,8,3,2
18,426,426,50,4,46,3,2
17,439,439,36,12,24,2,1
24,441,441,5,5,0,1,0
0,456,456,24,24,0,1,0
38,470,470,13,13,0,1,0
41,480,480,56,24,32,2,1
21,481,481,111,78,33,4,3
20,485,485,54,54,0,1,0
19,486,486,18,18,0,1,0

24,101,101,12,12,0,1,0
4,150,150,2,2,0,1,0
25,152,152,10,10,0,1,0
6,152,152,19,19,0,1,0
31,162,162,7,7,0,1,0
20,177,177,7,1,6,3,2
7,181,181,7,7,0,1,0
12,185,185,1,1,0,1,0
2,185,185,7,7,0,1,0
10,206,206,13,13,0,1,0
9,218,218,76,33,43,2,1
0,221,221,37,25,12,4,3
22,224,224,27,27,0,1,0
35,265,265,55,50,5,2,1
14,267,267,5,5,0,1,0
1,274,274,89,89,0,1,0
19,283,283,12,12,0,1,0
28,284,284,28,28,0,1,0
15,288,288,94,79,15,4,3
3,293,293,2,2,0,1,0
33,296,296,31,31,0,1,0
17,305,305,3,3,0,1,0
26,316,316,102,60,42,3,2
11,325,325,16,1,15,4,3
13,342,342,75,75,0,1,0
37,349,349,2,2,0,1,0
23,360,360,21,9,12,3,2
32,380,380,15,15,0,1,0
5,384,384,24,24,0,1,0
16,398,398,26,2,24,2,1
29,407,407,18,18,0,1,0
21,410,410,2,2,0,1,0
36,411,411,77,54,23,2,1
27,412,412,2,2,0,1,0
8,413,413,32,24,8,3,2
18,449,449,19,19,0,1,0
34,460,460,175,129,46,2,1
30,472,472,21,21,0,1,0
38,498,498,50,20,30,4,3

28,113,113,1,1,0,1,0
17,120,120,1,1,0,1,0
43,124,124,1,1,0,1,0
25,129,129,10,10,0,1,0
26,132,132,41,41,0,1,0
9,134,134,17,4,13,2,1
6,138,138,4,4,0,1,0
15,138,138,7,7,0,1,0
23,140,140,9,9,0,1,0
2,154,154,5,5,0,1,0
8,157,157,8,8,0,1,0
41,162,162,5,5,0,1,0
21,168,168,24,4,20,2,1
10,171,171,39,19,20,3,2
45,183,183,12,6,6,2,1
7,183,183,4,4,0,1,0
37,205,205,1,1,0,1,0
35,211,211,38,12,26,2,1
24,224,224,51,33,18,4,3
12,248,248,16,16,0,1,0
38,259,259,17,17,0,1,0
29,262,262,3,3,0,1,0
32,270,270,21,7,14,2,1
1,284,284,29,17,12,4,3
14,287,287,21,9,12,4,3
16,296,296,28,16,12,4,3
22,302,302,42,26,16,3,2
27,302,302,28,8,20,3,2
34,310,310,22,15,7,2,1
11,312,312,28,16,12,4,3
30,329,329,29,2,27,2,1
3,337,337,45,45,0,1,0
20,344,344,1,1,0,1,0
33,346,346,9,4,5,2,1
18,349,349,4,4,0,1,0
36,352,352,107,107,0,1,0
44,354,354,24,18,6,3,2
0,383,383,29,26,3,2,1
4,391,391,11,11,0,1,0
42,397,397,36,36,0,1,0
40,411,411,88,42,46,3,2
13,415,415,16,16,0,1,0
19,438,438,34,34,0,1,0
39,441,441,54,10,44,3,2
31,472,472,96,42,54,4,3
5,484,484,4,4,0,1,0

25,133,133,12,6,6,3,2
17,139,139,6,6,0,1,0
1,140,140,1,1,0,1,0
8,144,144,10,10,0,1,0
5,167,167,23,3,20,3,2
34,177,177,24,12,12,2,1
12,198,198,54,27,27,2,1
26,219,219,22,22,0,1,0
27,230,230,61,61,0,1,0
14,233,233,5,2,3,2,1
2,235,235,7,1,6,3,2
29,237,237,5,5,0,1,0
38,253,253,21,9,12,3,2
21,263,263,62,62,0,1,0
18,267,267,21,13,8,3,2
7,282,282,24,24,0,1,0
31,295,295,21,21,0,1,0
22,299,299,26,10,16,3,2
10,322,322,69,27,42,4,3
15,333,333,98,23,75,4,3
23,348,348,13,8,5,2,1
36,356,356,45,11,34,2,1
3,368,368,38,2,36,2,1
0,382,382,20,20,0,1,0
20,387,387,33,33,0,1,0
16,393,393,37,8,29,2,1
9,397,397,26,26,0,1,0
19,415,415,38,38,0,1,0
37,444,444,27,4,23,2,1
24,452,452,34,34,0,1,0
13,457,457,34,1,33,2,1
30,465,465,40,16,24,3,2
32,465,465,32,32,0,1,0
33,468,468,58,58,0,1,0
39,470,470,22,8,14,2,1
11,471,471,64,17,47,2,1
28,476,476,6,6,0,1,0
6,489,489,10,2,8,2,1
35,493,493,108,70,38,3,2
4,496,496,54,1,53,4,3

13,104,104,16,16,0,1,0
12,114,114,5,1,4,2,1
8,137,137,1,1,0,1,0
32,145,145,35,3,32,2,1
23,149,149,18,18,0,1,0
18,149,149,30,11,19,2,1
33,154,154,4,4,0,1,0
5,155,155,5,5,0,1,0
38,164,164,11,1,10,3,2
6,170,170,24,16,8,3,2
11,172,172,14,14,0,1,0
35,172,172,2,2,0,1,0
43,173,173,15,15,0,1,0
26,178,178,5,1,4,2,1
41,193,193,19,8,11,2,1
24,199,199,5,1,4,2,1
20,200,200,14,7,7,2,1
46,215,215,14,14,0,1,0
25,235,235,32,32,0,1,0
9,256,256,4,1,3,2,1
0,259,259,2,2,0,1,0
40,261,261,11,5,6,2,1
7,268,268,21,10,11,2,1
3,270,270,31,12,19,2,1
30,289,289,82,74,8,3,2
28,292,292,23,7,16,3,2
16,297,297,11,11,0,1,0
22,318,318,15,15,0,1,0
19,337,337,54,54,0,1,0
27,353,353,7,7,0,1,0
21,365,365,8,8,0,1,0
34,374,374,28,15,13,2,1
4,401,401,24,2,22,3,2
42,411,411,37,28,9,2,1
17,413,413,23,11,12,2,1
37,419,419,55,44,11,2,1
14,422,422,28,28,0,1,0
45,423,423,8,8,0,1,0
31,425,425,2,2,0,1,0
29,427,427,11,4,7,2,1
47,427,427,25,19,6,2,1
36,441,441,68,24,44,4,3
39,442,442,139,62,77,3,2
2,448,448,15,1,14,3,2
10,467,467,30,30,0,1,0
44,470,470,33,33,0,1,0
15,487,487,3,3,0,1,0
1,496,496,46,9,37,2,1
48,498,498,86,50,36,3,2

27,100,100,4,4,0,1,0
7,127,127,33,33,0,1,0
6,128,128,36,36,0,1,0
14,164,164,26,8,18,2,1
36,175,175,18,18,0,1,0
10,181,181,18,18,0,1,0
40,191,191,20,2,18,2,1
24,192,192,32,2,30,3,2
19,201,201,13,13,0,1,0
26,201,201,6,6,0,1,0
35,204,204,31,31,0,1,0
25,224,224,7,1,6,3,2
41,232,232,35,25,10,3,2
2,237,237,9,6,3,2,1
20,243,243,14,14,0,1,0
8,243,243,1,1,0,1,0
12,259,259,2,2,0,1,0
22,261,261,54,54,0,1,0
39,282,282,20,5,15,2,1
18,287,287,12,2,10,2,1
11,288,288,6,6,0,1,0
4,314,314,74,48,26,2,1
1,328,328,6,3,3,2,1
15,334,334,44,30,14,3,2
9,335,335,7,7,0,1,0
33,338,338,32,18,14,3,2
29,343,343,21,17,4,2,1
37,358,358,48,7,41,2,1
3,359,359,2,2,0,1,0
13,381,381,17,17,0,1,0
31,383,383,43,43,0,1,0
17,392,392,22,22,0,1,0
30,395,395,17,5,12,3,2
5,403,403,44,44,0,1,0
38,424,424,22,9,13,4,3
16,427,427,58,17,41,4,3
28,430,430,6,6,0,1,0
23,432,432,11,11,0,1,0
34,439,439,25,25,0,1,0
32,467,467,186,173,13,2,1
21,483,483,96,18,78,3,2
0,485,485,5,5,0,1,0

21,111,111,16,7,9,2,1
14,130,130,8,4,4,2,1
29,135,135,10,10,0,1,0
2,145,145,1,1,0,1,0
17,146,146,28,28,0,1,0
27,154,154,4,1,3,2,1
23,167,167,6,6,0,1,0
34,177,177,10,3,7,2,1
12,179,179,13,1,12,4,3
22,185,185,14,2,12,3,2
10,193,193,3,3,0,1,0
25,197,197,9,9,0,1,0
28,209,209,36,21,15,2,1
30,228,228,77,33,44,3,2
24,241,241,5,5,0,1,0
19,243,243,10,10,0,1,0
35,252,252,3,3,0,1,0
1,259,259,48,27,21,4,3
13,268,268,17,6,11,3,2
36,276,276,76,40,36,3,2
37,288,288,80,41,39,4,3
7,305,305,52,52,0,1,0
6,314,314,138,121,17,2,1
11,317,317,32,32,0,1,0
4,319,319,42,42,0,1,0
39,334,334,3,3,0,1,0
15,335,335,36,36,0,1,0
3,350,350,25,25,0,1,0
5,352,352,20,20,0,1,0
18,358,358,46,42,4,2,1
31,378,378,31,31,0,1,0
16,386,386,16,16,0,1,0
32,406,406,21,12,9,4,3
0,411,411,32,14,18,4,3
26,417,417,5,5,0,1,0
8,426,426,1,1,0,1,0
9,456,456,17,17,0,1,0
20,459,459,54,12,42,3,2
38,470,470,102,12,90,4,3
33,483,483,4,4,0,1,0

35,104,104,31,11,20,3,2
3,112,112,3,3,0,1,0
2,116,116,22,22,0,1,0
14,124,124,8,8,0,1,0
33,127,127,11,11,0,1,0
36,132,132,15,7,8,2,1
4,163,163,24,5,19,3,2
24,163,163,9,2,7,2,1
10,169,169,10,10,0,1,0
5,175,175,53,53,0,1,0
27,197,197,6,1,5,2,1
21,223,223,6,6,0,1,0
12,228,228,31,31,0,1,0
26,235,235,11,5,6,3,2
0,259,259,31,31,0,1,0
9,267,267,23,23,0,1,0
37,274,274,11,11,0,1,0
7,274,274,19,19,0,1,0
17,279,279,4,1,3,2,1
6,305,305,16,16,0,1,0
8,319,319,25,25,0,1,0
25,341,341,43,6,37,4,3
19,344,344,71,71,0,1,0
20,379,379,11,11,0,1,0
15,387,387,15,3,12,2,1
16,406,406,1,1,0,1,0
30,406,406,36,14,22,2,1
13,409,409,57,54,3,2,1
34,409,409,28,28,0,1,0
22,420,420,101,101,0,1,0
29,426,426,18,18,0,1,0
28,441,441,41,32,9,4,3
32,445,445,5,5,0,1,0
18,472,472,14,14,0,1,0
11,482,482,181,163,18,2,1
1,494,494,49,49,0,1,0
31,498,498,163,104,59,3,2
23,498,498,42,42,0,1,0

6,115,115,3,3,0,1,0
20,130,130,1,1,0,1,0
4,136,136,24,18,6,2,1
2,142,142,11,11,0,1,0
5,148,148,79,79,0,1,0
39,149,149,35,35,0,1,0
33,179,179,52,5,47,2,1
1,192,192,20,20,0,1,0
14,193,193,23,23,0,1,0
34,195,195,12,2,10,3,2
8,197,197,13,13,0,1,0
23,199,199,7,7,0,1,0
29,205,205,20,2,18,2,1
28,205,205,33,33,0,1,0
32,220,220,34,4,30,3,2
13,222,222,1,1,0,1,0
7,225,225,21,21,0,1,0
22,243,243,18,18,0,1,0
37,246,246,6,2,4,2,1
12,251,251,26,26,0,1,0
36,278,278,23,11,12,3,2
11,295,295,32,32,0,1,0
30,296,296,23,1,22,4,3
0,313,313,18,3,15,4,3
35,327,327,7,1,6,3,2
17,332,332,22,22,0,1,0
21,333,333,8,8,0,1,0
15,357,357,4,4,0,1,0
25,363,363,59,33,26,3,2
9,369,369,5,5,0,1,0
31,383,383,31,17,14,3,2
40,397,397,55,21,34,2,1
19,398,398,14,4,10,2,1
10,416,416,44,44,0,1,0
24,427,427,89,77,12,4,3
38,429,429,25,15,10,2,1
16,448,448,7,7,0,1,0
18,476,476,40,30,10,3,2
26,490,490,23,7,16,3,2
27,495,495,3,3,0,1,0
3,496,496,98,37,61,4,3

0,108,108,4,1,3,2,1
8,119,119,37,9,28,3,2
30,125,125,44,25,19,2,1
4,133,133,21,21,0,1,0
6,137,137,10,3,7,2,1
27,152,152,10,10,0,1,0
35,155,155,25,18,7,2,1
34,181,181,12,9,3,2,1
28,189,189,7,3,4,2,1
31,199,199,1,1,0,1,0
19,201,201,19,2,17,2,1
24,225,225,7,7,0,1,0
7,230,230,42,3,39,2,1
14,244,244,11,11,0,1,0
18,255,255,4,4,0,1,0
9,257,257,14,2,12,4,3
21,259,259,86,21,65,4,3
22,261,261,29,2,27,4,3
11,279,279,14,14,0,1,0
20,296,296,72,41,31,2,1
13,296,296,50,50,0,1,0
26,298,298,46,15,31,3,2
3,324,324,34,12,22,2,1
36,357,357,13,3,10,2,1
25,361,361,10,10,0,1,0
5,368,368,32,22,10,3,2
10,401,401,24,24,0,1,0
15,403,403,14,14,0,1,0
16,404,404,84,43,41,2,1
23,404,404,2,2,0,1,0
1,418,418,20,20,0,1,0
33,425,425,99,60,39,4,3
17,427,427,34,8,26,2,1
12,430,430,90,90,0,1,0
37,433,433,9,9,0,1,0
2,461,461,41,41,0,1,0
32,481,481,7,7,0,1,0
29,492,492,16,16,0,1,0

36,107,107,33,1,32,2,1
15,108,108,13,13,0,1,0
4,131,131,22,8,14,3,2
19,151,151,55,7,48,4,3
34,155,155,7,2,5,2,1
37,158,158,20,20,0,1,0
11,164,164,12,4,8,2,1
32,171,171,1,1,0,1,0
33,174,174,8,8,0,1,0
26,192,192,23,20,3,2,1
0,199,199,16,16,0,1,0
24,216,216,35,27,8,3,2
2,237,237,18,18,0,1,0
9,254,254,24,24,0,1,0
18,259,259,35,35,0,1,0
3,285,285,65,27,38,3,2
6,308,308,29,29,0,1,0
23,319,319,107,107,0,1,0
20,336,336,6,6,0,1,0
21,347,347,41,41,0,1,0
27,350,350,50,50,0,1,0
17,368,368,31,1,30,3,2
1,370,370,29,29,0,1,0
12,383,383,5,5,0,1,0
5,389,389,3,3,0,1,0
22,393,393,60,60,0,1,0
35,398,398,2,2,0,1,0
30,398,398,86,25,61,3,2
7,403,403,14,5,9,4,3
29,414,414,11,11,0,1,0
14,422,422,12,12,0,1,0
39,434,434,4,4,0,1,0
25,435,435,28,13,15,4,3
10,435,435,44,38,6,3,2
38,438,438,51,51,0,1,0
16,442,442,7,7,0,1,0
31,461,461,7,7,0,1,0
28,476,476,1,1,0,1,0
8,480,480,53,53,0,1,0
13,482,482,45,45,0,1,0

6,116,116,4,1,3,2,1
36,142,142,5,5,0,1,0
25,150,150,7,7,0,1,0
3,165,165,12,5,7,3,2
17,167,167,8,8,0,1,0
35,170,170,6,1,5,2,1
5,173,173,32,20,12,2,1
8,198,198,27,5,22,2,1
12,202,202,12,12,0,1,0
7,205,205,7,7,0,1,0
33,209,209,34,34,0,1,0
30,224,224,62,62,0,1,0
1,229,229,25,25,0,1,0
14,256,256,74,62,12,3,2
19,270,270,4,4,0,1,0
26,271,271,14,5,9,4,3
18,272,272,64,64,0,1,0
0,273,273,1,1,0,1,0
32,273,273,41,8,33,3,2
10,282,282,13,13,0,1,0
2,325,325,51,51,0,1,0
9,328,328,17,17,0,1,0
16,329,329,49,49,0,1,0
31,329,329,61,61,0,1,0
11,339,339,66,66,0,1,0
28,346,346,84,48,36,4,3
4,349,349,26,26,0,1,0
29,351,351,41,2,39,3,2
20,353,353,14,5,9,3,2
13,359,359,1,1,0,1,0
38,391,391,32,22,10,3,2
37,393,393,35,15,20,2,1
34,404,404,35,26,9,4,3
24,406,406,31,31,0,1,0
22,407,407,28,8,20,3,2
23,421,421,38,38,0,1,0
15,477,477,56,34,22,3,2
21,489,489,37,11,26,3,2
27,499,499,55,18,37,2,1

16,104,104,27,27,0,1,0
2,109,109,13,13,0,1,0
44,114,114,3,3,0,1,0
29,119,119,2,2,0,1,0
8,124,124,11,4,7,3,2
6,127,127,1,1,0,1,0
37,132,132,14,2,12,4,3
9,134,134,1,1,0,1,0
18,137,137,11,2,9,2,1
32,139,139,4,1,3,2,1
26,146,146,5,1,4,2,1
25,170,170,13,13,0,1,0
14,182,182,2,2,0,1,0
10,190,190,9,9,0,1,0
13,191,191,10,10,0,1,0
24,195,195,24,21,3,2,1
12,203,203,3,3,0,1,0
5,211,211,41,17,24,3,2
22,227,227,9,9,0,1,0
23,240,240,4,4,0,1,0
28,243,243,3,3,0,1,0
45,250,250,46,25,21,2,1
33,260,260,56,12,44,2,1
1,266,266,10,7,3,2,1
35,268,268,19,4,15,3,2
34,272,272,33,33,0,1,0
21,300,300,25,25,0,1,0
43,307,307,24,24,0,1,0
15,319,319,15,15,0,1,0
42,323,323,78,78,0,1,0
0,333,333,1,1,0,1,0
31,347,347,2,2,0,1,0
36,361,361,10,10,0,1,0
3,364,364,1,1,0,1,0
38,373,373,67,67,0,1,0
19,377,377,49,49,0,1,0
7,387,387,7,7,0,1,0
39,398,398,24,24,0,1,0
41,414,414,63,48,15,4,3
27,422,422,165,165,0,1,0
11,425,425,13,13,0,1,0
17,426,426,36,36,0,1,0
4,445,445,17,8,9,2,1
20,460,460,163,146,17,2,1
40,467,467,36,36,0,1,0
30,472,472,3,3,0,1,0
46,489,489,19,3,16,2,1

5,107,107,7,2,5,2,1
23,109,109,3,3,0,1,0
36,115,115,4,4,0,1,0
38,115,115,21,3,18,3,2
30,122,122,24,24,0,1,0
41,130,130,9,4,5,2,1
19,139,139,20,6,14,3,2
27,171,171,23,14,9,2,1
2,181,181,8,8,0,1,0
16,188,188,10,10,0,1,0
40,213,213,24,24,0,1,0
29,216,216,16,16,0,1,0
22,217,217,15,15,0,1,0
32,223,223,10,1,9,2,1
8,226,226,25,1,24,2,1
13,296,296,20,20,0,1,0
25,296,296,42,15,27,4,3
3,318,318,14,14,0,1,0
20,326,326,2,2,0,1,0
17,329,329,8,8,0,1,0
37,332,332,58,58,0,1,0
7,338,338,20,20,0,1,0
0,352,352,71,71,0,1,0
31,367,367,5,5,0,1,0
15,378,378,1,1,0,1,0
4,384,384,51,26,25,2,1
34,391,391,49,49,0,1,0
33,400,400,43,17,26,3,2
24,416,416,1,1,0,1,0
1,419,419,118,118,0,1,0
26,426,426,76,76,0,1,0
28,443,443,5,5,0,1,0
12,445,445,93,24,69,4,3
21,446,446,14,14,0,1,0
14,453,453,15,3,12,2,1
9,458,458,47,37,10,3,2
6,458,458,112,4,108,4,3
35,477,477,94,94,0,1,0
39,478,478,66,18,48,4,3
18,493,493,8,2,6,3,2
10,495,495,1,1,0,1,0
11,496,496,62,8,54,4,3

18,132,132,2,2,0,1,0
12,132,132,14,14,0,1,0
30,164,164,6,6,0,1,0
4,171,171,3,3,0,1,0
29,175,175,17,17,0,1,0
0,212,212,20,2,18,3,2
15,221,221,1,1,0,1,0
40,241,241,19,3,16,2,1
39,244,244,27,27,0,1,0
28,246,246,7,7,0,1,0
33,249,249,23,14,9,4,3
10,252,252,34,34,0,1,0
17,252,252,38,38,0,1,0
19,261,261,1,1,0,1,0
32,264,264,30,6,24,2,1
8,281,281,3,3,0,1,0
6,283,283,21,21,0,1,0
23,295,295,2,2,0,1,0
13,301,301,17,5,12,3,2
41,303,303,27,27,0,1,0
21,304,304,24,24,0,1,0
22,306,306,17,8,9,4,3
42,327,327,7,7,0,1,0
2,328,328,68,54,14,3,2
9,340,340,58,58,0,1,0
37,342,342,21,5,16,3,2
26,346,346,17,17,0,1,0
5,385,385,20,3,17,2,1
35,390,390,28,28,0,1,0
25,398,398,22,22,0,1,0
1,400,400,12,6,6,3,2
27,416,416,77,38,39,4,3
34,424,424,96,24,72,4,3
24,428,428,34,24,10,3,2
43,453,453,137,125,12,4,3
16,456,456,91,31,60,3,2
11,463,463,152,58,94,4,3
20,465,465,10,1,9,2,1
3,468,468,43,25,18,3,2
38,473,473,56,25,31,2,1
36,484,484,81,54,27,4,3
31,486,486,20,20,0,1,0
14,486,486,32,24,8,2,1
7,496,496,12,12,0,1,0

21,102,102,17,17,0,1,0
20,117,117,4,4,0,1,0
7,117,117,4,4,0,1,0
40,121,121,14,14,0,1,0
10,126,126,2,2,0,1,0
23,129,129,21,21,0,1,0
22,132,132,3,3,0,1,0
26,134,134,4,4,0,1,0
18,135,135,11,5,6,2,1
33,161,161,19,19,0,1,0
25,164,164,35,4,31,3,2
19,165,165,5,2,3,2,1
35,179,179,2,2,0,1,0
32,225,225,39,39,0,1,0
42,227,227,48,13,35,2,1
4,231,231,24,2,22,3,2
31,232,232,2,2,0,1,0
27,256,256,66,39,27,4,3
14,258,258,31,7,24,3,2
39,269,269,7,7,0,1,0
29,272,272,5,5,0,1,0
11,279,279,19,19,0,1,0
24,301,301,25,10,15,4,3
41,320,320,23,23,0,1,0
43,330,330,39,39,0,1,0
8,334,334,2,2,0,1,0
16,334,334,78,78,0,1,0
37,343,343,19,19,0,1,0
5,348,348,47,47,0,1,0
6,349,349,4,4,0,1,0
34,370,370,65,65,0,1,0
3,379,379,37,28,9,2,1
2,382,382,94,5,89,4,3
36,403,403,2,2,0,1,0
38,415,415,56,56,0,1,0
9,426,426,34,34,0,1,0
13,437,437,38,20,18,2,1
12,439,439,41,7,34,3,2
0,449,449,25,11,14,3,2
30,462,462,70,60,10,3,2
1,463,463,23,23,0,1,0
17,476,476,22,22,0,1,0
15,492,492,10,1,9,2,1
28,494,494,32,23,9,2,1

17,100,100,13,13,0,1,0
33,119,119,6,3,3,2,1
10,130,130,16,7,9,2,1
29,130,130,4,4,0,1,0
30,166,166,19,12,7,2,1
2,188,188,40,40,0,1,0
0,191,191,3,3,0,1,0
27,199,199,25,3,22,3,2
9,213,213,22,22,0,1,0
26,215,215,18,18,0,1,0
7,228,228,11,11,0,1,0
4,232,232,30,4,26,2,1
23,255,255,74,74,0,1,0
19,259,259,4,4,0,1,0
5,275,275,51,14,37,3,2
25,279,279,26,26,0,1,0
11,304,304,4,1,3,2,1
20,305,305,5,2,3,2,1
35,306,306,2,2,0,1,0
34,320,320,13,13,0,1,0
1,331,331,86,36,50,3,2
6,350,350,62,40,22,3,2
16,359,359,126,33,93,4,3
14,393,393,10,10,0,1,0
24,395,395,11,5,6,2,1
3,397,397,118,115,3,2,1
28,438,438,36,36,0,1,0
12,441,441,44,8,36,4,3
8,443,443,81,81,0,1,0
18,450,450,23,23,0,1,0
15,452,452,44,44,0,1,0
13,461,461,14,2,12,4,3
21,471,471,10,10,0,1,0
32,481,481,204,96,108,4,3
22,481,481,2,2,0,1,0
31,482,482,43,43,0,1,0

15,117,117,7,1,6,2,1
18,120,120,40,40,0,1,0
28,135,135,1,1,0,1,0
25,154,154,18,18,0,1,0
12,165,165,21,7,14,3,2
13,187,187,42,42,0,1,0
27,193,193,6,6,0,1,0
32,199,199,5,5,0,1,0
30,236,236,8,8,0,1,0
33,275,275,6,6,0,1,0
35,281,281,67,67,0,1,0
0,283,283,17,17,0,1,0
34,287,287,14,14,0,1,0
7,287,287,7,1,6,3,2
8,295,295,29,29,0,1,0
11,308,308,65,26,39,2,1
23,317,317,106,46,60,3,2
26,323,323,8,8,0,1,0
9,330,330,28,19,9,2,1
31,333,333,41,41,0,1,0
4,335,335,42,1,41,2,1
14,348,348,21,21,0,1,0
24,381,381,17,10,7,2,1
19,385,385,75,60,15,2,1
3,394,394,181,181,0,1,0
21,399,399,27,27,0,1,0
10,406,406,1,1,0,1,0
20,421,421,79,79,0,1,0
1,422,422,47,38,9,4,3
5,423,423,26,26,0,1,0
6,430,430,22,1,21,3,2
22,431,431,2,2,0,1,0
16,432,432,18,8,10,2,1
17,453,453,12,3,9,4,3
29,489,489,61,45,16,3,2
2,490,490,118,7,111,4,3

25,107,107,16,16,0,1,0
19,113,113,11,11,0,1,0
6,137,137,5,5,0,1,0
17,143,143,21,5,16,3,2
29,161,161,36,36,0,1,0
15,186,186,11,11,0,1,0
18,189,189,2,2,0,1,0
27,194,194,1,1,0,1,0
9,202,202,2,2,0,1,0
2,208,208,115,43,72,4,3
5,210,210,31,5,26,2,1
12,229,229,31,9,22,3,2
31,246,246,16,1,15,2,1
30,276,276,39,39,0,1,0
3,287,287,12,12,0,1,0
4,290,290,27,1,26,2,1
24,292,292,44,5,39,4,3
1,315,315,31,1,30,4,3
0,322,322,6,6,0,1,0
21,379,379,47,23,24,2,1
32,383,383,35,35,0,1,0
34,387,387,49,49,0,1,0
20,413,413,21,21,0,1,0
7,421,421,38,38,0,1,0
14,434,434,57,32,25,2,1
33,447,447,15,15,0,1,0
23,447,447,45,45,0,1,0
11,455,455,81,60,21,2,1
26,457,457,83,83,0,1,0
8,469,469,194,194,0,1,0
22,470,470,92,74,18,4,3
13,477,477,10,4,6,3,2
28,487,487,36,36,0,1,0
10,489,489,16,16,0,1,0
16,499,499,7,7,0,1,0

8,109,109,3,3,0,1,0
12,149,149,13,3,10,2,1
28,163,163,5,5,0,1,0
39,167,167,25,25,0,1,0
16,173,173,17,17,0,1,0
17,188,188,4,4,0,1,0
11,201,201,45,23,22,3,2
29,209,209,7,7,0,1,0
26,251,251,10,10,0,1,0
3,252,252,37,37,0,1,0
37,261,261,2,2,0,1,0
5,283,283,17,8,9,4,3
33,284,284,9,1,8,2,1
34,285,285,2,2,0,1,0
31,285,285,10,10,0,1,0
13,301,301,4,4,0,1,0
6,302,302,13,13,0,1,0
36,304,304,21,3,18,2,1
20,313,313,38,11,27,4,3
18,315,315,7,7,0,1,0
0,326,326,15,15,0,1,0
30,335,335,26,26,0,1,0
2,340,340,10,10,0,1,0
15,372,372,38,14,24,4,3
19,381,381,23,15,8,3,2
7,381,381,257,116,141,4,3
9,385,385,67,13,54,3,2
35,389,389,12,6,6,3,2
25,400,400,84,84,0,1,0
38,402,402,5,5,0,1,0
27,420,420,40,40,0,1,0
21,422,422,6,1,5,2,1
23,423,423,212,141,71,4,3
32,428,428,28,28,0,1,0
4,436,436,63,63,0,1,0
14,436,436,1,1,0,1,0
24,469,469,121,88,33,2,1
1,478,478,11,11,0,1,0
22,487,487,121,64,57,3,2
10,490,490,1,1,0,1,0

18,113,113,37,25,12,2,1
0,121,121,27,15,12,2,1
34,147,147,4,1,3,2,1
23,149,149,44,31,13,4,3
31,152,152,4,4,0,1,0
29,156,156,34,34,0,1,0
40,157,157,17,1,16,2,1
5,186,186,3,3,0,1,0
12,205,205,27,15,12,3,2
9,211,211,10,10,0,1,0
26,227,227,19,5,14,3,2
20,235,235,16,16,0,1,0
27,246,246,29,29,0,1,0
24,248,248,88,55,33,3,2
3,269,269,24,16,8,3,2
35,275,275,15,5,10,2,1
32,287,287,4,4,0,1,0
2,326,326,11,11,0,1,0
8,329,329,6,6,0,1,0
39,338,338,53,53,0,1,0
15,342,342,58,2,56,3,2
13,375,375,12,12,0,1,0
21,383,383,22,22,0,1,0
22,420,420,58,28,30,2,1
16,438,438,32,32,0,1,0
11,439,439,14,14,0,1,0
38,440,440,28,28,0,1,0
19,445,445,15,6,9,2,1
37,448,448,28,28,0,1,0
1,457,457,33,25,8,2,1
17,460,460,6,6,0,1,0
33,460,460,5,1,4,2,1
4,461,461,151,151,0,1,0
7,461,461,7,1,6,3,2
25,471,471,13,1,12,4,3
14,476,476,7,3,4,2,1
10,481,481,83,83,0,1,0
6,482,482,45,45,0,1,0
28,486,486,48,48,0,1,0
30,486,486,38,38,0,1,0
36,490,490,20,15,5,2,1

14,108,108,15,15,0,1,0
11,117,117,1,1,0,1,0
2,119,119,19,19,0,1,0
22,127,127,14,14,0,1,0
35,147,147,31,15,16,3,2
25,157,157,27,27,0,1,0
29,166,166,7,7,0,1,0
32,181,181,13,13,0,1,0
10,182,182,10,10,0,1,0
16,185,185,2,2,0,1,0
12,214,214,30,10,20,3,2
8,233,233,11,11,0,1,0
13,238,238,3,3,0,1,0
3,247,247,43,13,30,3,2
31,261,261,7,7,0,1,0
34,263,263,26,26,0,1,0
24,265,265,17,8,9,2,1
17,274,274,2,2,0,1,0
6,281,281,25,11,14,2,1
36,287,287,14,14,0,1,0
0,292,292,22,22,0,1,0
39,294,294,37,5,32,3,2
21,305,305,23,11,12,4,3
23,316,316,21,9,12,4,3
37,327,327,92,73,19,2,1
33,336,336,22,7,15,4,3
19,341,341,11,6,5,2,1
4,343,343,30,30,0,1,0
28,358,358,81,81,0,1,0
38,364,364,30,30,0,1,0
20,375,375,3,3,0,1,0
7,379,379,207,207,0,1,0
5,385,385,9,9,0,1,0
15,401,401,56,32,24,2,1
9,409,409,16,6,10,2,1
18,412,412,47,47,0,1,0
27,440,440,4,4,0,1,0
30,441,441,28,28,0,1,0
1,448,448,42,4,38,4,3
40,454,454,22,4,18,4,3
26,464,464,70,42,28,3,2

3,101,101,2,2,0,1,0
17,127,127,10,7,3,2,1
0,141,141,52,52,0,1,0
14,153,153,18,2,16,3,2
29,155,155,18,9,9,2,1
5,161,161,18,18,0,1,0
21,168,168,19,19,0,1,0
23,180,180,18,18,0,1,0
15,199,199,38,12,26,3,2
27,205,205,17,2,15,2,1
18,206,206,30,30,0,1,0
9,216,216,17,17,0,1,0
6,218,218,7,1,6,2,1
22,221,221,26,26,0,1,0
11,226,226,23,23,0,1,0
25,228,228,18,18,0,1,0
4,287,287,127,28,99,4,3
24,290,290,2,2,0,1,0
10,314,314,4,4,0,1,0
28,325,325,13,7,6,3,2
2,340,340,20,20,0,1,0
1,358,358,32,13,19,2,1
26,389,389,31,31,0,1,0
20,390,390,54,54,0,1,0
16,395,395,25,25,0,1,0
30,429,429,55,49,6,3,2
12,439,439,35,35,0,1,0
7,463,463,331,331,0,1,0
19,468,468,67,67,0,1,0
8,468,468,34,7,27,3,2
13,470,470,58,58,0,1,0

33,100,100,5,5,0,1,0
26,102,102,11,11,0,1,0
15,104,104,3,3,0,1,0
37,105,105,14,2,12,3,2
27,108,108,17,6,11,2,1
25,113,113,9,9,0,1,0
13,116,116,4,4,0,1,0
24,132,132,2,2,0,1,0
10,139,139,8,1,7,2,1
12,156,156,23,7,16,2,1
9,167,167,46,46,0,1,0
2,179,179,15,6,9,4,3
5,202,202,18,18,0,1,0
7,206,206,18,13,5,2,1
21,215,215,3,3,0,1,0
23,219,219,2,2,0,1,0
18,248,248,11,11,0,1,0
8,257,257,9,3,6,3,2
17,261,261,66,4,62,4,3
22,267,267,9,9,0,1,0
30,273,273,28,28,0,1,0
35,279,279,63,63,0,1,0
32,287,287,22,22,0,1,0
42,289,289,7,1,6,3,2
39,291,291,25,5,20,3,2
34,302,302,5,5,0,1,0
1,332,332,2,2,0,1,0
0,348,348,27,27,0,1,0
38,353,353,64,64,0,1,0
14,366,366,33,33,0,1,0
36,392,392,55,45,10,3,2
40,393,393,52,8,44,3,2
11,398,398,44,8,36,2,1
31,402,402,4,4,0,1,0
19,407,407,19,7,12,4,3
29,425,425,108,100,8,3,2
3,429,429,14,5,9,2,1
41,447,447,90,42,48,4,3
4,465,465,2,2,0,1,0
20,469,469,121,25,96,4,3
16,484,484,32,32,0,1,0
28,495,495,20,20,0,1,0
6,499,499,62,38,24,4,3

29,104,104,3,3,0,1,0
30,112,112,8,3,5,2,1
11,122,122,10,7,3,2,1
17,136,136,30,1,29,2,1
16,142,142,21,21,0,1,0
8,182,182,13,13,0,1,0
13,199,199,3,3,0,1,0
23,201,201,37,4,33,4,3
20,218,218,4,1,3,2,1
25,222,222,41,41,0,1,0
5,230,230,39,33,6,2,1
2,234,234,25,19,6,3,2
34,236,236,14,14,0,1,0
39,237,237,18,18,0,1,0
36,243,243,8,8,0,1,0
9,250,250,28,28,0,1,0
12,257,257,7,7,0,1,0
21,258,258,13,3,10,2,1
31,260,260,9,9,0,1,0
18,276,276,5,2,3,2,1
26,282,282,39,39,0,1,0
0,290,290,38,28,10,2,1
35,293,293,48,34,14,2,1
28,294,294,5,5,0,1,0
42,295,295,54,54,0,1,0
4,299,299,6,3,3,2,1
1,306,306,4,4,0,1,0
7,337,337,35,17,18,3,2
40,349,349,23,9,14,3,2
27,353,353,21,21,0,1,0
15,354,354,46,46,0,1,0
22,357,357,1,1,0,1,0
19,357,357,7,7,0,1,0
32,397,397,30,30,0,1,0
43,399,399,57,57,0,1,0
38,408,408,130,81,49,4,3
3,416,416,6,6,0,1,0
37,422,422,23,11,12,4,3
41,453,453,54,36,18,3,2
6,454,454,45,30,15,4,3
10,488,488,21,21,0,1,0
14,494,494,101,51,50,3,2
33,498,498,39,25,14,2,1
24,500,500,64,52,12,4,3

28,100,100,3,3,0,1,0
25,125,125,4,1,3,2,1
15,126,126,9,9,0,1,0
8,142,142,13,4,9,2,1
10,151,151,15,15,0,1,0
6,165,165,1,1,0,1,0
23,186,186,2,2,0,1,0
35,207,207,33,33,0,1,0
19,229,229,32,32,0,1,0
36,230,230,55,7,48,4,3
4,271,271,1,1,0,1,0
34,278,278,5,5,0,1,0
26,280,280,20,4,16,2,1
30,289,289,24,24,0,1,0
18,335,335,20,20,0,1,0
9,353,353,4,4,0,1,0
14,360,360,5,5,0,1,0
32,363,363,16,7,9,2,1
27,370,370,5,1,4,2,1
3,373,373,4,4,0,1,0
17,376,376,56,56,0,1,0
33,378,378,70,40,30,3,2
12,383,383,67,37,30,4,3
24,387,387,90,79,11,2,1
20,389,389,63,63,0,1,0
1,393,393,13,13,0,1,0
31,400,400,6,6,0,1,0
21,406,406,40,19,21,3,2
38,409,409,32,32,0,1,0
37,409,409,60,12,48,4,3
7,417,417,24,9,15,4,3
2,430,430,174,133,41,4,3
22,432,432,98,52,46,4,3
13,450,450,26,21,5,2,1
0,453,453,121,89,32,2,1
5,454,454,113,65,48,3,2
29,459,459,22,22,0,1,0
11,465,465,17,10,7,2,1
16,488,488,100,62,38,3,2

38,103,103,2,2,0,1,0
11,111,111,1,1,0,1,0
5,120,120,69,46,23,3,2
32,166,166,7,4,3,2,1
1,169,169,7,7,0,1,0
10,172,172,40,40,0,1,0
35,178,178,2,2,0,1,0
13,182,182,7,7,0,1,0
23,190,190,28,4,24,4,3
7,194,194,12,12,0,1,0
21,194,194,4,4,0,1,0
25,198,198,30,30,0,1,0
29,200,200,14,10,4,2,1
37,202,202,26,6,20,2,1
9,203,203,30,8,22,3,2
3,212,212,1,1,0,1,0
26,213,213,1,1,0,1,0
34,233,233,5,1,4,2,1
20,242,242,22,22,0,1,0
14,256,256,2,2,0,1,0
6,258,258,15,15,0,1,0
18,263,263,7,1,6,2,1
4,306,306,14,2,12,2,1
22,312,312,45,45,0,1,0
15,321,321,6,3,3,2,1
27,336,336,71,5,66,4,3
19,350,350,10,10,0,1,0
16,356,356,7,7,0,1,0
17,359,359,63,63,0,1,0
24,379,379,53,53,0,1,0
40,411,411,88,88,0,1,0
28,413,413,5,5,0,1,0
12,414,414,63,63,0,1,0
39,419,419,185,185,0,1,0
30,420,420,10,10,0,1,0
0,428,428,92,92,0,1,0
8,430,430,3,3,0,1,0
2,454,454,20,10,10,3,2
31,461,461,40,8,32,2,1
36,466,466,56,22,34,3,2
33,468,468,10,6,4,2,1

7,104,104,5,1,4,2,1
21,108,108,13,13,0,1,0
28,110,110,2,2,0,1,0
31,115,115,4,4,0,1,0
1,122,122,15,6,9,4,3
25,123,123,2,2,0,1,0
29,145,145,28,28,0,1,0
22,156,156,17,8,9,4,3
20,188,188,18,18,0,1,0
36,193,193,12,4,8,3,2
11,213,213,23,23,0,1,0
30,215,215,8,8,0,1,0
2,217,217,4,4,0,1,0
12,236,236,70,70,0,1,0
13,241,241,24,10,14,3,2
27,255,255,2,2,0,1,0
26,268,268,13,1,12,4,3
8,274,274,17,17,0,1,0
24,280,280,51,51,0,1,0
14,287,287,48,19,29,2,1
17,293,293,9,1,8,3,2
23,295,295,99,65,34,2,1
0,312,312,40,40,0,1,0
4,312,312,10,2,8,2,1
34,318,318,52,52,0,1,0
10,319,319,22,17,5,2,1
6,351,351,24,2,22,3,2
19,384,384,28,28,0,1,0
3,392,392,6,6,0,1,0
9,408,408,166,122,44,3,2
35,415,415,11,2,9,4,3
37,427,427,45,27,18,2,1
16,431,431,55,55,0,1,0
18,453,453,9,9,0,1,0
15,463,463,27,27,0,1,0
5,464,464,57,36,21,4,3
38,488,488,28,3,25,2,1
33,492,492,103,103,0,1,0
32,496,496,75,39,36,4,3

22,102,102,4,4,0,1,0
35,126,126,11,11,0,1,0
20,146,146,3,3,0,1,0
2,150,150,18,6,12,4,3
15,155,155,15,4,11,2,1
19,167,167,39,39,0,1,0
9,181,181,26,26,0,1,0
36,188,188,53,15,38,3,2
14,188,188,1,1,0,1,0
3,200,200,50,50,0,1,0
11,209,209,1,1,0,1,0
30,252,252,19,15,4,2,1
23,262,262,14,3,11,2,1
7,270,270,1,1,0,1,0
10,270,270,45,10,35,4,3
37,277,277,16,16,0,1,0
17,277,277,26,6,20,3,2
5,294,294,33,3,30,4,3
12,305,305,11,6,5,2,1
4,310,310,23,17,6,2,1
21,341,341,74,74,0,1,0
31,357,357,73,73,0,1,0
24,369,369,13,4,9,4,3
8,375,375,34,2,32,2,1
29,401,401,23,17,6,2,1
6,414,414,60,39,21,4,3
25,418,418,32,6,26,3,2
32,419,419,6,6,0,1,0
26,420,420,35,17,18,4,3
16,422,422,3,3,0,1,0
0,433,433,19,19,0,1,0
13,437,437,18,18,0,1,0
38,437,437,18,18,0,1,0
34,454,454,10,1,9,4,3
18,459,459,217,131,86,3,2
33,462,462,21,9,12,2,1
28,463,463,127,98,29,2,1
1,474,474,44,4,40,2,1
27,493,493,52,52,0,1,0

11,109,109,19,19,0,1,0
7,113,113,11,11,0,1,0
26,120,120,12,12,0,1,0
13,123,123,43,43,0,1,0
10,128,128,47,8,39,2,1
1,162,162,6,6,0,1,0
15,178,178,28,28,0,1,0
28,190,190,37,37,0,1,0
5,197,197,69,69,0,1,0
27,216,216,56,13,43,2,1
14,216,216,1,1,0,1,0
0,217,217,4,4,0,1,0
20,219,219,60,60,0,1,0
9,239,239,23,23,0,1,0
16,250,250,32,5,27,2,1
4,267,267,20,11,9,4,3
32,276,276,50,18,32,3,2
17,306,306,23,23,0,1,0
19,321,321,20,1,19,4,3
21,321,321,54,54,0,1,0
33,325,325,39,25,14,2,1
22,333,333,3,3,0,1,0
29,359,359,3,3,0,1,0
3,367,367,6,6,0,1,0
6,402,402,19,19,0,1,0
30,414,414,47,35,12,4,3
2,429,429,70,47,23,2,1
31,429,429,44,1,43,4,3
18,431,431,1,1,0,1,0
24,432,432,13,13,0,1,0
12,440,440,74,32,42,4,3
25,463,463,17,17,0,1,0
8,474,474,19,19,0,1,0
23,495,495,4,4,0,1,0

24,105,105,11,11,0,1,0
14,106,106,2,2,0,1,0
22,109,109,4,4,0,1,0
1,112,112,10,10,0,1,0
3,134,134,15,3,12,4,3
9,136,136,4,4,0,1,0
21,139,139,8,8,0,1,0
33,147,147,17,17,0,1,0
16,147,147,1,1,0,1,0
25,151,151,8,8,0,1,0
20,153,153,38,11,27,4,3
18,155,155,1,1,0,1,0
4,159,159,6,6,0,1,0
17,160,160,7,7,0,1,0
40,188,188,5,5,0,1,0
8,190,190,4,4,0,1,0
42,194,194,7,7,0,1,0
10,204,204,46,18,28,2,1
41,205,205,23,23,0,1,0
11,237,237,25,25,0,1,0
28,239,239,16,16,0,1,0
12,255,255,13,13,0,1,0
13,266,266,3,3,0,1,0
52,267,267,9,9,0,1,0
36,280,280,12,6,6,2,1
2,283,283,1,1,0,1,0
44,289,289,2,2,0,1,0
50,298,298,10,3,7,2,1
7,305,305,38,14,24,3,2
5,332,332,24,10,14,3,2
26,334,334,25,18,7,2,1
19,336,336,26,15,11,3,2
6,339,339,11,5,6,3,2
35,358,358,59,59,0,1,0
32,366,366,2,2,0,1,0
39,367,367,9,9,0,1,0
45,367,367,23,6,17,2,1
37,389,389,45,45,0,1,0
38,395,395,16,16,0,1,0
23,400,400,39,39,0,1,0
47,416,416,19,19,0,1,0
30,420,420,9,4,5,2,1
15,426,426,22,22,0,1,0
27,427,427,1,1,0,1,0
34,433,433,62,62,0,1,0
31,435,435,6,6,0,1,0
49,442,442,72,27,45,4,3
48,453,453,96,14,82,3,2
51,468,468,254,201,53,4,3
0,480,480,22,22,0,1,0
43,482,482,7,4,3,2,1
29,487,487,26,26,0,1,0
46,488,488,46,28,18,3,2

36,112,112,3,3,0,1,0
35,130,130,29,4,25,2,1
9,131,131,6,6,0,1,0
19,153,153,14,14,0,1,0
18,172,172,15,15,0,1,0
39,178,178,9,9,0,1,0
14,180,180,1,1,0,1,0
30,189,189,23,14,9,4,3
23,198,198,18,18,0,1,0
7,199,199,12,12,0,1,0
5,209,209,3,3,0,1,0
6,212,212,59,17,42,2,1
11,216,216,2,2,0,1,0
10,230,230,17,17,0,1,0
0,254,254,45,45,0,1,0
27,263,263,11,11,0,1,0
15,264,264,13,13,0,1,0
17,265,265,20,20,0,1,0
1,272,272,4,4,0,1,0
42,273,273,2,2,0,1,0
34,289,289,22,22,0,1,0
12,297,297,34,28,6,2,1
24,299,299,8,2,6,3,2
37,314,314,6,6,0,1,0
32,318,318,26,26,0,1,0
38,320,320,139,40,99,4,3
2,331,331,32,15,17,2,1
33,345,345,60,40,20,3,2
25,353,353,13,13,0,1,0
22,362,362,6,6,0,1,0
16,374,374,17,17,0,1,0
8,375,375,22,1,21,4,3
13,395,395,57,10,47,2,1
29,397,397,24,6,18,2,1
3,414,414,3,3,0,1,0
41,425,425,41,41,0,1,0
26,443,443,5,5,0,1,0
28,447,447,57,22,35,3,2
21,448,448,89,42,47,2,1
31,459,459,73,73,0,1,0
40,482,482,85,1,84,3,2
4,491,491,52,52,0,1,0
20,494,494,114,114,0,1,0

41,100,100,1,1,0,1,0
25,107,107,32,8,24,2,1
31,108,108,15,15,0,1,0
13,108,108,1,1,0,1,0
15,137,137,1,1,0,1,0
34,148,148,11,4,7,2,1
18,149,149,10,6,4,2,1
42,151,151,20,14,6,3,2
14,158,158,62,62,0,1,0
17,172,172,7,7,0,1,0
27,177,177,10,1,9,4,3
3,179,179,4,1,3,2,1
4,187,187,4,4,0,1,0
46,194,194,52,28,24,2,1
47,195,195,15,9,6,2,1
30,215,215,26,26,0,1,0
26,217,217,7,7,0,1,0
21,219,219,31,13,18,2,1
49,223,223,2,2,0,1,0
1,229,229,17,17,0,1,0
50,231,231,23,15,8,2,1
19,236,236,11,11,0,1,0
12,248,248,1,1,0,1,0
36,255,255,13,4,9,2,1
10,258,258,5,5,0,1,0
28,258,258,29,29,0,1,0
38,274,274,58,46,12,4,3
29,280,280,23,23,0,1,0
6,285,285,12,6,6,3,2
40,290,290,4,4,0,1,0
11,292,292,2,2,0,1,0
48,296,296,14,6,8,3,2
32,298,298,70,2,68,4,3
23,310,310,12,3,9,4,3
7,313,313,37,27,10,3,2
5,357,357,6,2,4,2,1
16,362,362,13,6,7,2,1
43,371,371,10,1,9,2,1
44,380,380,118,40,78,3,2
20,394,394,1,1,0,1,0
33,409,409,3,3,0,1,0
8,426,426,25,25,0,1,0
37,434,434,39,8,31,4,3
2,436,436,22,18,4,2,1
35,445,445,41,41,0,1,0
0,450,450,1,1,0,1,0
9,452,452,2,2,0,1,0
45,463,463,45,45,0,1,0
24,471,471,1,1,0,1,0
22,477,477,35,35,0,1,0
39,488,488,26,26,0,1,0

30,107,107,8,8,0,1,0
20,122,122,5,5,0,1,0
23,127,127,44,5,39,4,3
9,136,136,35,24,11,3,2
15,178,178,16,4,12,4,3
8,178,178,8,4,4,2,1
33,190,190,37,37,0,1,0
13,205,205,66,66,0,1,0
6,206,206,1,1,0,1,0
12,211,211,7,7,0,1,0
31,215,215,12,2,10,2,1
11,228,228,45,19,26,2,1
29,246,246,18,18,0,1,0
16,269,269,13,13,0,1,0
26,271,271,26,12,14,3,2
19,275,275,10,6,4,2,1
24,307,307,1,1,0,1,0
27,312,312,29,29,0,1,0
14,319,319,27,27,0,1,0
28,331,331,22,22,0,1,0
35,338,338,5,5,0,1,0
3,350,350,47,31,16,2,1
1,352,352,6,6,0,1,0
21,353,353,9,9,0,1,0
2,353,353,81,33,48,4,3
34,353,353,33,33,0,1,0
5,379,379,12,12,0,1,0
22,381,381,36,18,18,3,2
10,402,402,30,16,14,2,1
17,433,433,19,19,0,1,0
7,438,438,30,30,0,1,0
25,442,442,156,15,141,4,3
4,465,465,137,107,30,3,2
18,472,472,64,30,34,2,1
0,473,473,33,1,32,3,2
32,482,482,35,5,30,4,3
36,488,488,61,61,0,1,0

19,102,102,2,2,0,1,0
34,104,104,1,1,0,1,0
21,110,110,7,7,0,1,0
39,117,117,7,7,0,1,0
31,133,133,26,14,12,2,1
14,139,139,11,11,0,1,0
3,144,144,3,3,0,1,0
4,151,151,14,4,10,4,3
30,154,154,16,12,4,2,1
38,162,162,13,6,7,2,1
24,167,167,5,5,0,1,0
7,195,195,11,5,6,2,1
8,196,196,89,11,78,4,3
12,198,198,28,4,24,4,3
6,200,200,32,32,0,1,0
29,201,201,25,25,0,1,0
23,249,249,59,53,6,3,2
16,253,253,14,14,0,1,0
25,253,253,50,34,16,3,2
32,270,270,36,36,0,1,0
33,278,278,8,3,5,2,1
37,278,278,32,8,24,2,1
17,289,289,8,8,0,1,0
22,309,309,3,3,0,1,0
11,316,316,1,1,0,1,0
18,323,323,41,41,0,1,0
26,339,339,10,5,5,2,1
5,340,340,28,12,16,2,1
10,340,340,3,3,0,1,0
2,341,341,7,7,0,1,0
9,358,358,34,34,0,1,0
28,370,370,119,92,27,2,1
20,382,382,40,10,30,2,1
1,385,385,164,128,36,2,1
13,386,386,6,1,5,2,1
0,428,428,5,5,0,1,0
27,442,442,67,67,0,1,0
35,452,452,1,1,0,1,0
36,453,453,27,27,0,1,0
15,480,480,51,41,10,3,2

20,101,101,3,3,0,1,0
22,117,117,23,23,0,1,0
39,124,124,19,19,0,1,0
14,125,125,10,6,4,2,1
12,126,126,6,6,0,1,0
38,134,134,12,7,5,2,1
29,134,134,27,3,24,3,2
9,139,139,12,5,7,3,2
10,146,146,2,2,0,1,0
16,150,150,1,1,0,1,0
30,150,150,10,10,0,1,0
17,160,160,3,3,0,1,0
3,163,163,43,15,28,3,2
18,175,175,10,10,0,1,0
0,193,193,29,29,0,1,0
34,194,194,11,2,9,2,1
13,204,204,17,17,0,1,0
25,224,224,9,9,0,1,0
36,242,242,9,9,0,1,0
8,251,251,98,23,75,4,3
23,287,287,12,12,0,1,0
37,312,312,8,4,4,2,1
28,326,326,71,71,0,1,0
5,336,336,42,42,0,1,0
7,347,347,4,1,3,2,1
31,350,350,49,49,0,1,0
6,377,377,55,12,43,2,1
11,378,378,80,80,0,1,0
40,386,386,15,15,0,1,0
2,394,394,1,1,0,1,0
21,396,396,9,3,6,3,2
32,416,416,28,28,0,1,0
27,430,430,35,19,16,3,2
4,430,430,29,26,3,2,1
19,451,451,48,48,0,1,0
33,452,452,27,17,10,3,2
1,461,461,43,4,39,4,3
24,474,474,105,21,84,3,2
26,477,477,45,45,0,1,0
35,485,485,95,5,90,3,2
15,495,495,8,2,6,3,2

4,100,100,7,7,0,1,0
36,105,105,21,21,0,1,0
34,106,106,14,1,13,4,3
7,130,130,36,12,24,2,1
19,133,133,9,9,0,1,0
28,147,147,17,17,0,1,0
27,178,178,22,3,19,3,2
21,198,198,12,7,5,2,1
24,231,231,5,5,0,1,0
29,232,232,71,28,43,2,1
33,238,238,1,1,0,1,0
10,244,244,21,21,0,1,0
13,251,251,1,1,0,1,0
30,252,252,72,4,68,4,3
12,272,272,20,11,9,2,1
14,274,274,19,7,12,4,3
17,280,280,4,4,0,1,0
25,287,287,18,4,14,3,2
11,290,290,37,37,0,1,0
37,309,309,5,5,0,1,0
9,343,343,50,2,48,4,3
15,343,343,19,19,0,1,0
26,346,346,6,6,0,1,0
32,351,351,1,1,0,1,0
3,351,351,5,5,0,1,0
18,357,357,17,17,0,1,0
40,367,367,8,1,7,2,1
1,371,371,22,10,12,2,1
16,376,376,51,51,0,1,0
35,380,380,24,2,22,2,1
6,382,382,81,81,0,1,0
22,392,392,152,152,0,1,0
0,406,406,73,73,0,1,0
8,423,423,8,8,0,1,0
39,453,453,66,41,25,2,1
5,457,457,145,110,35,2,1
38,470,470,3,3,0,1,0
23,474,474,30,26,4,2,1
20,474,474,5,5,0,1,0
31,488,488,4,4,0,1,0
2,496,496,8,8,0,1,0

9,108,108,6,6,0,1,0
19,143,143,8,8,0,1,0
7,145,145,14,14,0,1,0
14,154,154,11,11,0,1,0
22,203,203,5,5,0,1,0
26,207,207,14,14,0,1,0
21,213,213,17,3,14,2,1
18,221,221,30,30,0,1,0
27,240,240,6,1,5,2,1
10,245,245,9,1,8,3,2
30,253,253,23,17,6,2,1
33,258,258,31,10,21,4,3
31,259,259,168,48,120,4,3
32,293,293,56,31,25,2,1
11,321,321,11,3,8,2,1
3,329,329,102,42,60,4,3
0,340,340,77,77,0,1,0
25,360,360,6,6,0,1,0
2,364,364,62,62,0,1,0
4,382,382,3,3,0,1,0
35,383,383,2,2,0,1,0
1,384,384,60,60,0,1,0
6,387,387,17,3,14,3,2
23,391,391,43,8,35,2,1
36,413,413,29,10,19,2,1
5,416,416,88,22,66,4,3
12,436,436,114,73,41,4,3
8,444,444,47,47,0,1,0
15,458,458,25,15,10,3,2
24,460,460,1,1,0,1,0
16,471,471,3,3,0,1,0
28,474,474,66,32,34,3,2
20,479,479,7,7,0,1,0
29,481,481,48,39,9,2,1
17,484,484,42,30,12,3,2
34,497,497,25,25,0,1,0
13,499,499,76,53,23,2,1

5,114,114,2,2,0,1,0
3,125,125,3,3,0,1,0
27,129,129,14,14,0,1,0
25,142,142,24,9,15,2,1
6,150,150,15,7,8,2,1
18,167,167,17,3,14,2,1
15,173,173,110,49,61,3,2
22,181,181,10,4,6,3,2
20,186,186,1,1,0,1,0
34,187,187,3,3,0,1,0
33,195,195,13,13,0,1,0
4,201,201,1,1,0,1,0
35,208,208,4,4,0,1,0
12,232,232,20,20,0,1,0
30,240,240,2,2,0,1,0
7,248,248,51,31,20,3,2
0,258,258,70,70,0,1,0
2,261,261,23,23,0,1,0
11,265,265,18,18,0,1,0
16,270,270,14,2,12,3,2
36,279,279,50,6,44,2,1
17,279,279,22,7,15,4,3
28,287,287,63,24,39,4,3
26,298,298,21,11,10,2,1
8,325,325,2,2,0,1,0
32,351,351,67,67,0,1,0
38,356,356,85,63,22,2,1
14,374,374,10,3,7,2,1
21,390,390,4,4,0,1,0
19,392,392,36,36,0,1,0
10,397,397,29,29,0,1,0
9,431,431,26,4,22,2,1
1,434,434,1,1,0,1,0
31,476,476,78,78,0,1,0
13,477,477,49,8,41,2,1
29,478,478,41,41,0,1,0
23,481,481,63,50,13,2,1
37,489,489,21,6,15,4,3
24,498,498,83,83,0,1,0

21,102,102,7,7,0,1,0
35,115,115,8,1,7,2,1
30,124,124,18,18,0,1,0
8,139,139,32,2,30,4,3
0,142,142,18,18,0,1,0
10,143,143,20,4,16,3,2
31,157,157,27,5,22,2,1
19,165,165,1,1,0,1,0
9,197,197,21,1,20,3,2
11,198,198,10,10,0,1,0
4,199,199,5,5,0,1,0
23,209,209,40,29,11,2,1
32,209,209,17,17,0,1,0
34,219,219,43,43,0,1,0
1,234,234,15,1,14,3,2
40,240,240,11,8,3,2,1
18,253,253,1,1,0,1,0
39,257,257,11,11,0,1,0
33,261,261,17,17,0,1,0
6,262,262,10,2,8,3,2
25,263,263,19,19,0,1,0
22,273,273,12,2,10,3,2
26,277,277,10,10,0,1,0
17,293,293,24,6,18,4,3
14,300,300,1,1,0,1,0
28,303,303,103,80,23,4,3
5,315,315,76,37,39,4,3
13,318,318,23,23,0,1,0
42,322,322,4,4,0,1,0
12,326,326,3,3,0,1,0
24,326,326,9,9,0,1,0
38,347,347,14,4,10,3,2
44,354,354,11,6,5,2,1
15,372,372,80,8,72,4,3
2,374,374,1,1,0,1,0
16,382,382,6,6,0,1,0
27,400,400,6,6,0,1,0
3,408,408,20,20,0,1,0
20,411,411,51,21,30,3,2
29,421,421,41,32,9,2,1
43,424,424,147,85,62,3,2
36,430,430,2,2,0,1,0
41,458,458,99,99,0,1,0
37,470,470,8,3,5,2,1
7,483,483,31,18,13,2,1

13,104,104,3,3,0,1,0
26,122,122,29,20,9,4,3
31,139,139,3,3,0,1,0
2,143,143,2,2,0,1,0
20,165,165,16,16,0,1,0
35,166,166,31,31,0,1,0
11,174,174,11,11,0,1,0
8,178,178,9,6,3,2,1
34,182,182,2,2,0,1,0
15,189,189,26,26,0,1,0
25,195,195,10,10,0,1,0
23,197,197,4,4,0,1,0
3,201,201,21,21,0,1,0
28,213,213,4,4,0,1,0
10,218,218,52,48,4,2,1
24,231,231,6,3,3,2,1
21,240,240,18,18,0,1,0
1,246,246,55,43,12,4,3
22,247,247,19,19,0,1,0
27,255,255,10,1,9,4,3
0,257,257,47,17,30,3,2
16,263,263,23,23,0,1,0
6,273,273,3,3,0,1,0
7,278,278,71,53,18,3,2
19,287,287,108,108,0,1,0
29,305,305,22,22,0,1,0
32,311,311,32,4,28,2,1
12,311,311,36,4,32,2,1
5,314,314,38,38,0,1,0
4,319,319,19,7,12,3,2
14,365,365,8,8,0,1,0
33,408,408,14,14,0,1,0
18,412,412,73,73,0,1,0
9,473,473,177,177,0,1,0
17,481,481,5,5,0,1,0
30,493,493,163,79,84,4,3

11,114,114,7,1,6,2,1
9,147,147,43,22,21,2,1
6,151,151,17,7,10,3,2
7,156,156,84,15,69,4,3
25,156,156,8,8,0,1,0
24,170,170,1,1,0,1,0
22,196,196,44,44,0,1,0
4,197,197,25,25,0,1,0
3,222,222,11,11,0,1,0
17,246,246,6,6,0,1,0
8,251,251,17,2,15,4,3
13,255,255,57,48,9,4,3
14,257,257,18,18,0,1,0
23,259,259,58,15,43,2,1
19,277,277,3,3,0,1,0
15,301,301,39,3,36,3,2
16,303,303,4,1,3,2,1
27,305,305,66,23,43,2,1
26,318,318,95,95,0,1,0
2,366,366,39,39,0,1,0
5,378,378,198,198,0,1,0
10,391,391,102,102,0,1,0
21,423,423,14,6,8,3,2
0,434,434,19,16,3,2,1
12,450,450,19,9,10,2,1
1,471,471,66,66,0,1,0
18,477,477,26,4,22,2,1
20,478,478,16,16,0,1,0
29,485,485,9,9,0,1,0
28,494,494,21,11,10,2,1

28,105,105,3,3,0,1,0
25,116,116,10,10,0,1,0
13,146,146,19,19,0,1,0
3,147,147,9,9,0,1,0
26,147,147,6,6,0,1,0
19,150,150,5,2,3,2,1
16,162,162,8,8,0,1,0
10,169,169,14,3,11,2,1
11,180,180,25,18,7,2,1
29,182,182,31,31,0,1,0
14,198,198,13,4,9,4,3
23,209,209,6,6,0,1,0
4,215,215,132,57,75,4,3
24,226,226,15,6,9,2,1
1,263,263,4,4,0,1,0
9,274,274,26,11,15,4,3
18,277,277,4,1,3,2,1
15,277,277,11,2,9,4,3
5,283,283,22,22,0,1,0
7,299,299,6,6,0,1,0
22,309,309,67,67,0,1,0
8,318,318,47,41,6,3,2
30,356,356,19,19,0,1,0
17,362,362,38,38,0,1,0
12,362,362,14,14,0,1,0
0,407,407,17,17,0,1,0
27,415,415,33,7,26,2,1
21,420,420,171,135,36,3,2
20,431,431,22,10,12,4,3
31,463,463,155,135,20,3,2
6,465,465,109,95,14,2,1
2,488,488,230,204,26,2,1

29,105,105,10,10,0,1,0
33,111,111,2,2,0,1,0
27,113,113,11,1,10,3,2
12,115,115,3,3,0,1,0
5,126,126,22,3,19,2,1
11,133,133,22,5,17,2,1
3,138,138,2,2,0,1,0
9,144,144,40,40,0,1,0
7,167,167,17,1,16,3,2
38,174,174,4,4,0,1,0
4,176,176,3,3,0,1,0
8,180,180,1,1,0,1,0
32,187,187,28,5,23,4,3
36,203,203,11,4,7,3,2
13,212,212,29,29,0,1,0
34,216,216,31,5,26,3,2
1,220,220,16,1,15,4,3
14,224,224,17,4,13,2,1
6,228,228,7,7,0,1,0
31,236,236,35,35,0,1,0
26,237,237,39,10,29,2,1
23,257,257,59,59,0,1,0
21,258,258,28,28,0,1,0
24,260,260,2,2,0,1,0
16,268,268,12,4,8,3,2
28,287,287,33,21,12,3,2
20,306,306,4,4,0,1,0
15,313,313,93,15,78,3,2
39,318,318,24,24,0,1,0
0,321,321,51,51,0,1,0
22,327,327,6,6,0,1,0
25,339,339,13,13,0,1,0
35,345,345,77,77,0,1,0
30,356,356,77,35,42,3,2
17,376,376,13,5,8,2,1
18,410,410,5,5,0,1,0
10,428,428,44,44,0,1,0
2,439,439,84,15,69,4,3
37,451,451,52,52,0,1,0
19,467,467,28,10,18,4,3

29,108,108,27,13,14,2,1
0,114,114,35,35,0,1,0
24,116,116,4,4,0,1,0
23,136,136,1,1,0,1,0
1,137,137,10,10,0,1,0
21,143,143,11,7,4,2,1
15,143,143,9,9,0,1,0
13,151,151,4,4,0,1,0
11,151,151,6,6,0,1,0
36,153,153,13,13,0,1,0
5,158,158,1,1,0,1,0
31,168,168,3,3,0,1,0
46,183,183,15,11,4,2,1
7,183,183,40,29,11,2,1
2,184,184,24,19,5,2,1
45,190,190,21,4,17,2,1
9,190,190,7,4,3,2,1
43,192,192,8,8,0,1,0
6,209,209,2,2,0,1,0
44,237,237,2,2,0,1,0
38,244,244,1,1,0,1,0
19,256,256,52,52,0,1,0
33,258,258,55,55,0,1,0
41,258,258,12,12,0,1,0
32,261,261,4,4,0,1,0
14,277,277,30,3,27,2,1
27,282,282,99,99,0,1,0
25,315,315,31,21,10,3,2
26,317,317,47,47,0,1,0
42,319,319,38,38,0,1,0
16,320,320,1,1,0,1,0
4,328,328,18,4,14,3,2
18,338,338,72,51,21,2,1
37,339,339,22,8,14,3,2
17,341,341,5,5,0,1,0
3,348,348,18,3,15,2,1
10,356,356,5,5,0,1,0
20,395,395,1,1,0,1,0
22,399,399,1,1,0,1,0
40,401,401,54,27,27,2,1
12,414,414,10,10,0,1,0
39,461,461,108,62,46,2,1
8,464,464,15,11,4,2,1
34,469,469,63,63,0,1,0
35,485,485,5,5,0,1,0
28,487,487,9,6,3,2,1
30,497,497,52,52,0,1,0

1,103,103,4,4,0,1,0
3,108,108,7,2,5,2,1
10,108,108,6,6,0,1,0
9,112,112,5,5,0,1,0
28,112,112,3,3,0,1,0
41,124,124,1,1,0,1,0
22,134,134,1,1,0,1,0
2,143,143,5,5,0,1,0
16,162,162,1,1,0,1,0
0,174,174,19,19,0,1,0
29,177,177,59,59,0,1,0
19,179,179,21,6,15,4,3
12,179,179,5,5,0,1,0
14,181,181,1,1,0,1,0
39,187,187,9,9,0,1,0
35,193,193,9,4,5,2,1
17,210,210,12,12,0,1,0
20,234,234,20,2,18,3,2
42,254,254,7,3,4,2,1
15,265,265,3,3,0,1,0
36,266,266,41,20,21,2,1
26,286,286,4,4,0,1,0
27,290,290,51,42,9,4,3
23,292,292,14,2,12,3,2
24,294,294,7,4,3,2,1
25,299,299,26,26,0,1,0
6,307,307,5,5,0,1,0
4,328,328,18,11,7,2,1
21,355,355,59,16,43,2,1
44,367,367,31,31,0,1,0
37,377,377,70,55,15,4,3
31,380,380,59,14,45,2,1
7,388,388,106,40,66,3,2
30,393,393,4,4,0,1,0
18,398,398,58,12,46,2,1
8,398,398,9,1,8,2,1
43,432,432,108,108,0,1,0
32,439,439,63,5,58,3,2
5,443,443,57,57,0,1,0
38,446,446,1,1,0,1,0
13,448,448,84,59,25,4,3
40,459,459,9,1,8,3,2
34,460,460,29,29,0,1,0
11,461,461,124,24,100,3,2
33,463,463,96,60,36,4,3

15,106,106,20,6,14,2,1
23,112,112,10,2,8,3,2
42,144,144,9,1,8,3,2
33,152,152,25,25,0,1,0
46,166,166,6,6,0,1,0
17,182,182,4,4,0,1,0
5,186,186,9,9,0,1,0
32,208,208,3,3,0,1,0
18,209,209,19,13,6,3,2
38,213,213,1,1,0,1,0
4,214,214,19,19,0,1,0
43,215,215,7,7,0,1,0
1,217,217,6,6,0,1,0
0,221,221,49,49,0,1,0
7,225,225,10,10,0,1,0
40,230,230,33,33,0,1,0
10,238,238,12,12,0,1,0
41,246,246,18,18,0,1,0
22,247,247,48,44,4,2,1
19,248,248,12,12,0,1,0
36,252,252,40,6,34,3,2
26,267,267,18,6,12,2,1
35,269,269,12,2,10,3,2
39,271,271,165,120,45,2,1
37,339,339,5,5,0,1,0
6,353,353,42,42,0,1,0
27,366,366,3,3,0,1,0
28,382,382,74,57,17,2,1
12,383,383,8,8,0,1,0
20,385,385,21,12,9,2,1
13,395,395,7,7,0,1,0
14,397,397,1,1,0,1,0
29,399,399,40,40,0,1,0
30,406,406,8,1,7,2,1
24,406,406,3,3,0,1,0
45,411,411,15,15,0,1,0
21,413,413,60,60,0,1,0
16,417,417,11,11,0,1,0
31,421,421,33,6,27,4,3
3,428,428,19,19,0,1,0
44,465,465,91,74,17,2,1
2,470,470,1,1,0,1,0
25,477,477,41,5,36,4,3
11,477,477,32,13,19,2,1
8,478,478,62,38,24,3,2
34,484,484,21,9,12,3,2
9,491,491,47,47,0,1,0

11,128,128,1,1,0,1,0
8,133,133,1,1,0,1,0
6,134,134,48,15,33,4,3
4,139,139,25,25,0,1,0
30,155,155,15,15,0,1,0
25,159,159,4,1,3,2,1
32,173,173,6,6,0,1,0
22,189,189,1,1,0,1,0
12,219,219,20,20,0,1,0
34,244,244,5,5,0,1,0
14,245,245,3,3,0,1,0
15,246,246,7,7,0,1,0
5,254,254,18,18,0,1,0
2,256,256,58,58,0,1,0
20,261,261,5,1,4,2,1
23,269,269,22,9,13,2,1
9,274,274,21,5,16,3,2
10,277,277,17,17,0,1,0
1,333,333,2,2,0,1,0
16,347,347,26,4,22,3,2
36,355,355,116,86,30,4,3
7,365,365,34,12,22,3,2
13,368,368,12,12,0,1,0
26,380,380,57,57,0,1,0
28,380,380,40,31,9,4,3
0,383,383,108,108,0,1,0
27,396,396,56,34,22,3,2
3,402,402,106,106,0,1,0
21,409,409,27,23,4,2,1
17,414,414,37,9,28,2,1
35,430,430,131,116,15,4,3
18,432,432,17,7,10,3,2
31,445,445,36,36,0,1,0
19,463,463,43,43,0,1,0
33,472,472,119,81,38,3,2
24,490,490,18,8,10,2,1
29,491,491,55,55,0,1,0
37,495,495,2,2,0,1,0
38,500,500,37,37,0,1,0

4,100,100,5,2,3,2,1
7,133,133,2,2,0,1,0
10,135,135,5,5,0,1,0
22,175,175,11,11,0,1,0
20,178,178,35,2,33,4,3
24,189,189,2,2,0,1,0
31,199,199,5,1,4,2,1
23,208,208,57,57,0,1,0
34,210,210,31,25,6,3,2
14,260,260,45,36,9,4,3
30,264,264,5,5,0,1,0
25,284,284,17,17,0,1,0
32,293,293,35,8,27,4,3
13,301,301,76,11,65,4,3
27,316,316,16,6,10,3,2
28,323,323,83,15,68,3,2
3,323,323,111,36,75,4,3
15,354,354,5,5,0,1,0
1,356,356,78,50,28,3,2
11,358,358,10,10,0,1,0
17,359,359,27,3,24,4,3
18,360,360,14,14,0,1,0
8,366,366,53,17,36,2,1
16,392,392,7,1,6,2,1
9,421,421,84,84,0,1,0
33,422,422,58,15,43,2,1
0,424,424,74,50,24,2,1
2,426,426,2,2,0,1,0
29,446,446,119,73,46,3,2
6,454,454,36,18,18,4,3
26,455,455,49,25,24,4,3
21,459,459,2,2,0,1,0
19,471,471,70,70,0,1,0
12,478,478,8,8,0,1,0
5,495,495,131,131,0,1,0

12,108,108,12,12,0,1,0
19,118,118,1,1,0,1,0
38,123,123,11,11,0,1,0
33,124,124,21,21,0,1,0
1,128,128,1,1,0,1,0
28,129,129,19,19,0,1,0
4,130,130,9,9,0,1,0
30,133,133,27,27,0,1,0
2,137,137,24,24,0,1,0
44,138,138,8,8,0,1,0
21,155,155,4,4,0,1,0
20,168,168,13,13,0,1,0
18,170,170,1,1,0,1,0
8,177,177,10,10,0,1,0
24,185,185,5,1,4,2,1
11,186,186,14,14,0,1,0
5,193,193,8,8,0,1,0
17,233,233,34,18,16,2,1
0,239,239,3,3,0,1,0
3,255,255,9,9,0,1,0
15,258,258,78,78,0,1,0
31,264,264,9,9,0,1,0
35,272,272,31,31,0,1,0
26,280,280,1,1,0,1,0
46,282,282,11,5,6,3,2
16,296,296,10,4,6,2,1
22,302,302,7,7,0,1,0
32,312,312,26,3,23,2,1
42,315,315,4,1,3,2,1
41,319,319,101,17,84,3,2
10,320,320,11,4,7,2,1
13,325,325,39,39,0,1,0
29,339,339,41,29,12,3,2
37,344,344,29,29,0,1,0
40,374,374,10,7,3,2,1
7,386,386,62,17,45,4,3
27,388,388,12,2,10,3,2
9,394,394,77,16,61,3,2
36,396,396,73,7,66,4,3
14,416,416,2,2,0,1,0
25,423,423,23,23,0,1,0
23,448,448,74,23,51,4,3
43,459,459,36,36,0,1,0
45,472,472,46,46,0,1,0
6,481,481,14,3,11,3,2
39,490,490,67,41,26,2,1
34,496,496,9,5,4,2,1

8,105,105,2,2,0,1,0
29,124,124,13,1,12,2,1
5,126,126,15,15,0,1,0
23,132,132,10,10,0,1,0
21,138,138,10,10,0,1,0
30,171,171,14,14,0,1,0
10,180,180,7,4,3,2,1
18,184,184,4,4,0,1,0
16,221,221,5,5,0,1,0
32,229,229,18,18,0,1,0
26,245,245,6,6,0,1,0
1,256,256,11,11,0,1,0
0,262,262,1,1,0,1,0
14,268,268,40,16,24,3,2
3,269,269,25,25,0,1,0
25,291,291,7,1,6,2,1
31,293,293,66,60,6,2,1
6,299,299,18,15,3,2,1
20,306,306,28,7,21,2,1
7,320,320,105,17,88,3,2
24,326,326,26,26,0,1,0
27,341,341,27,27,0,1,0
33,354,354,75,31,44,3,2
19,368,368,61,40,21,2,1
22,368,368,3,3,0,1,0
2,382,382,218,218,0,1,0
9,400,400,41,7,34,3,2
11,401,401,35,35,0,1,0
13,404,404,1,1,0,1,0
15,423,423,62,6,56,3,2
12,427,427,31,31,0,1,0
28,450,450,68,31,37,2,1
17,469,469,19,19,0,1,0
4,479,479,150,78,72,4,3
34,485,485,161,161,0,1,0

13,114,114,1,1,0,1,0
8,124,124,1,1,0,1,0
5,132,132,7,7,0,1,0
36,137,137,32,32,0,1,0
40,137,137,1,1,0,1,0
17,152,152,12,12,0,1,0
39,168,168,5,5,0,1,0
18,180,180,18,5,13,2,1
2,188,188,2,2,0,1,0
26,194,194,3,3,0,1,0
20,199,199,3,3,0,1,0
6,230,230,65,38,27,2,1
21,243,243,25,25,0,1,0
14,253,253,33,4,29,2,1
34,259,259,16,12,4,2,1
29,260,260,1,1,0,1,0
10,295,295,15,5,10,2,1
19,302,302,25,19,6,3,2
11,314,314,4,4,0,1,0
41,322,322,64,64,0,1,0
15,324,324,73,45,28,2,1
32,324,324,42,22,20,3,2
3,331,331,50,50,0,1,0
23,345,345,11,7,4,2,1
31,349,349,33,33,0,1,0
16,350,350,23,1,22,3,2
37,359,359,67,67,0,1,0
33,362,362,13,13,0,1,0
12,366,366,5,5,0,1,0
43,378,378,60,30,30,4,3
35,390,390,112,112,0,1,0
28,394,394,34,22,12,2,1
30,403,403,18,6,12,4,3
22,409,409,55,22,33,4,3
1,423,423,20,20,0,1,0
24,426,426,38,38,0,1,0
4,444,444,1,1,0,1,0
0,446,446,137,99,38,2,1
25,449,449,123,68,55,4,3
27,453,453,15,15,0,1,0
9,456,456,21,18,3,2,1
7,464,464,18,18,0,1,0
38,476,476,26,26,0,1,0
42,486,486,6,1,5,2,1

25,107,107,3,3,0,1,0
8,109,109,1,1,0,1,0
18,122,122,11,11,0,1,0
15,126,126,2,2,0,1,0
2,138,138,16,7,9,2,1
10,140,140,1,1,0,1,0
16,142,142,10,10,0,1,0
31,142,142,5,5,0,1,0
37,145,145,19,19,0,1,0
27,151,151,20,5,15,4,3
6,176,176,10,10,0,1,0
4,181,181,3,3,0,1,0
20,198,198,18,7,11,2,1
38,204,204,22,10,12,4,3
11,205,205,10,10,0,1,0
21,210,210,14,6,8,2,1
14,217,217,14,14,0,1,0
34,221,221,16,2,14,3,2
23,237,237,4,4,0,1,0
26,258,258,58,58,0,1,0
13,262,262,30,13,17,4,3
43,275,275,31,31,0,1,0
28,281,281,40,24,16,3,2
12,285,285,12,12,0,1,0
30,300,300,19,8,11,2,1
29,307,307,38,16,22,4,3
32,307,307,13,13,0,1,0
7,308,308,27,5,22,2,1
44,353,353,9,2,7,2,1
46,354,354,167,149,18,3,2
39,363,363,58,19,39,4,3
9,371,371,47,23,24,2,1
5,374,374,51,51,0,1,0
3,379,379,64,18,46,3,2
22,387,387,1,1,0,1,0
42,391,391,35,29,6,3,2
0,399,399,43,7,36,3,2
33,399,399,36,23,13,2,1
40,401,401,37,10,27,4,3
19,402,402,1,1,0,1,0
41,404,404,21,21,0,1,0
24,409,409,24,20,4,2,1
1,447,447,29,29,0,1,0
47,448,448,40,14,26,2,1
45,474,474,47,47,0,1,0
36,479,479,6,6,0,1,0
17,489,489,17,17,0,1,0
35,493,493,10,10,0,1,0

17,101,101,16,13,3,2,1
5,109,109,23,2,21,2,1
0,109,109,8,4,4,2,1
9,143,143,4,4,0,1,0
23,148,148,39,39,0,1,0
20,201,201,23,1,22,3,2
36,205,205,37,3,34,2,1
2,209,209,17,5,12,3,2
25,215,215,14,5,9,4,3
21,227,227,2,2,0,1,0
35,231,231,46,4,42,3,2
38,235,235,21,21,0,1,0
3,253,253,11,11,0,1,0
16,254,254,21,21,0,1,0
13,268,268,33,33,0,1,0
26,268,268,31,25,6,2,1
39,273,273,25,25,0,1,0
11,275,275,9,9,0,1,0
24,276,276,56,33,23,2,1
4,315,315,18,9,9,3,2
18,318,318,45,45,0,1,0
7,318,318,10,6,4,2,1
27,319,319,60,11,49,2,1
19,358,358,48,41,7,2,1
33,360,360,63,23,40,2,1
15,361,361,56,41,15,4,3
37,387,387,7,7,0,1,0
34,397,397,14,10,4,2,1
29,421,421,6,6,0,1,0
31,423,423,33,33,0,1,0
8,424,424,2,2,0,1,0
40,433,433,3,3,0,1,0
12,437,437,17,17,0,1,0
1,439,439,70,70,0,1,0
6,453,453,79,79,0,1,0
32,459,459,7,7,0,1,0
41,474,474,41,3,38,3,2
10,475,475,54,18,36,3,2
30,479,479,21,9,12,2,1
28,481,481,26,14,12,4,3
22,484,484,53,45,8,3,2
14,495,495,16,16,0,1,0

4,104,104,3,3,0,1,0
13,119,119,3,3,0,1,0
36,139,139,9,9,0,1,0
11,156,156,4,4,0,1,0
12,161,161,4,4,0,1,0
5,170,170,2,2,0,1,0
38,179,179,21,21,0,1,0
31,205,205,10,10,0,1,0
21,210,210,8,8,0,1,0
24,211,211,6,1,5,2,1
22,218,218,6,6,0,1,0
20,218,218,12,12,0,1,0
7,230,230,20,20,0,1,0
16,230,230,36,24,12,3,2
26,259,259,38,38,0,1,0
34,265,265,27,15,12,4,3
3,275,275,31,1,30,4,3
40,282,282,40,14,26,3,2
19,285,285,1,1,0,1,0
9,296,296,10,1,9,2,1
2,300,300,24,3,21,2,1
33,302,302,57,13,44,2,1
18,303,303,26,7,19,3,2
8,310,310,17,6,11,2,1
27,324,324,10,10,0,1,0
30,342,342,3,3,0,1,0
35,371,371,57,13,44,2,1
32,377,377,110,32,78,4,3
1,396,396,54,6,48,2,1
29,405,405,39,39,0,1,0
37,408,408,107,12,95,4,3
23,415,415,4,4,0,1,0
10,419,419,29,2,27,2,1
15,433,433,1,1,0,1,0
6,440,440,109,109,0,1,0
28,451,451,2,2,0,1,0
14,459,459,20,6,14,3,2
25,461,461,73,59,14,2,1
0,477,477,64,64,0,1,0
39,485,485,54,54,0,1,0
17,488,488,284,246,38,2,1

35,100,100,13,13,0,1,0
34,113,113,9,1,8,3,2
14,138,138,21,4,17,2,1
31,150,150,4,4,0,1,0
33,162,162,11,11,0,1,0
9,168,168,84,23,61,4,3
4,169,169,28,16,12,4,3
23,169,169,34,16,18,4,3
24,179,179,35,35,0,1,0
5,187,187,5,5,0,1,0
1,192,192,4,1,3,2,1
11,215,215,6,2,4,2,1
21,240,240,34,34,0,1,0
6,248,248,51,35,16,2,1
29,256,256,7,4,3,2,1
7,259,259,3,3,0,1,0
30,269,269,4,4,0,1,0
22,273,273,30,30,0,1,0
18,292,292,19,5,14,3,2
17,304,304,4,4,0,1,0
25,308,308,35,35,0,1,0
27,325,325,107,107,0,1,0
2,327,327,80,80,0,1,0
15,351,351,47,31,16,3,2
3,374,374,17,17,0,1,0
16,376,376,16,5,11,2,1
26,378,378,4,4,0,1,0
0,382,382,5,5,0,1,0
8,407,407,30,30,0,1,0
10,409,409,41,25,16,2,1
28,424,424,31,31,0,1,0
12,438,438,2,2,0,1,0
36,455,455,72,72,0,1,0
32,463,463,78,69,9,2,1
20,494,494,19,19,0,1,0
13,496,496,115,10,105,4,3
19,496,496,40,40,0,1,0

9,107,107,7,7,0,1,0
13,109,109,2,2,0,1,0
38,122,122,16,16,0,1,0
34,131,131,13,13,0,1,0
25,153,153,23,1,22,3,2
18,154,154,29,8,21,2,1
37,160,160,9,9,0,1,0
31,163,163,4,4,0,1,0
39,164,164,15,15,0,1,0
14,177,177,22,22,0,1,0
6,179,179,5,1,4,2,1
4,185,185,47,47,0,1,0
0,201,201,2,2,0,1,0
26,215,215,5,1,4,2,1
35,228,228,16,7,9,4,3
11,229,229,10,10,0,1,0
42,231,231,10,10,0,1,0
8,255,255,59,43,16,2,1
30,259,259,7,4,3,2,1
20,267,267,4,1,3,2,1
15,271,271,11,11,0,1,0
32,289,289,13,13,0,1,0
36,303,303,1,1,0,1,0
24,311,311,69,39,30,2,1
16,315,315,51,51,0,1,0
5,316,316,15,9,6,3,2
10,322,322,7,2,5,2,1
27,335,335,59,1,58,3,2
2,335,335,21,13,8,2,1
12,349,349,9,3,6,2,1
7,372,372,29,29,0,1,0
1,386,386,13,4,9,2,1
21,397,397,37,21,16,3,2
33,402,402,38,38,0,1,0
3,407,407,50,17,33,2,1
29,442,442,6,6,0,1,0
23,442,442,43,43,0,1,0
40,442,442,104,80,24,4,3
41,455,455,158,135,23,2,1
22,456,456,89,14,75,4,3
19,469,469,60,28,32,2,1
17,489,489,6,6,0,1,0
28,490,490,43,1,42,3,2

21,103,103,1,1,0,1,0
2,110,110,12,12,0,1,0
16,130,130,8,8,0,1,0
0,132,132,1,1,0,1,0
23,143,143,4,4,0,1,0
24,145,145,9,1,8,3,2
29,150,150,44,11,33,2,1
10,154,154,11,6,5,2,1
5,159,159,1,1,0,1,0
37,172,172,20,6,14,2,1
13,172,172,8,8,0,1,0
6,175,175,1,1,0,1,0
38,178,178,11,11,0,1,0
8,188,188,45,45,0,1,0
1,200,200,54,54,0,1,0
31,204,204,23,3,20,2,1
35,219,219,89,44,45,3,2
7,227,227,1,1,0,1,0
33,249,249,19,19,0,1,0
26,253,253,14,14,0,1,0
14,262,262,43,19,24,3,2
32,264,264,53,3,50,2,1
22,271,271,8,8,0,1,0
20,277,277,5,5,0,1,0
17,282,282,16,7,9,4,3
36,316,316,12,9,3,2,1
15,318,318,38,5,33,4,3
9,322,322,18,18,0,1,0
42,329,329,8,2,6,3,2
25,343,343,79,58,21,2,1
4,347,347,33,1,32,3,2
39,356,356,9,9,0,1,0
11,359,359,138,103,35,2,1
27,373,373,43,29,14,3,2
41,442,442,30,30,0,1,0
30,450,450,5,5,0,1,0
28,458,458,48,48,0,1,0
19,459,459,18,3,15,4,3
40,476,476,2,2,0,1,0
18,480,480,41,18,23,2,1
34,492,492,5,5,0,1,0
12,495,495,21,9,12,3,2
3,498,498,39,39,0,1,0

41,101,101,1,1,0,1,0
4,102,102,4,4,0,1,0
36,102,102,5,5,0,1,0
2,115,115,8,8,0,1,0
37,125,125,22,22,0,1,0
26,141,141,34,19,15,4,3
18,151,151,20,20,0,1,0
11,155,155,33,25,8,3,2
9,159,159,11,11,0,1,0
3,166,166,16,3,13,2,1
30,189,189,7,3,4,2,1
27,209,209,23,1,22,3,2
22,211,211,16,4,12,4,3
38,219,219,28,28,0,1,0
0,224,224,3,3,0,1,0
6,231,231,97,97,0,1,0
31,258,258,22,6,16,3,2
1,267,267,16,6,10,2,1
10,271,271,4,4,0,1,0
20,273,273,14,14,0,1,0
40,306,306,6,6,0,1,0
28,311,311,96,78,18,4,3
39,318,318,53,14,39,4,3
13,321,321,22,10,12,3,2
21,330,330,44,44,0,1,0
32,343,343,53,53,0,1,0
19,353,353,30,24,6,3,2
14,380,380,34,24,10,3,2
15,385,385,34,14,20,3,2
25,392,392,29,29,0,1,0
33,397,397,27,2,25,3,2
35,404,404,22,22,0,1,0
8,409,409,31,31,0,1,0
23,418,418,9,9,0,1,0
42,422,422,32,3,29,4,3
5,428,428,8,5,3,2,1
24,435,435,22,22,0,1,0
34,436,436,72,72,0,1,0
12,436,436,28,28,0,1,0
29,470,470,14,14,0,1,0
17,489,489,1,1,0,1,0
7,490,490,1,1,0,1,0
16,492,492,59,41,18,4,3

22,139,139,37,18,19,4,3
18,153,153,9,9,0,1,0
16,168,168,57,6,51,3,2
21,183,183,2,2,0,1,0
13,215,215,17,17,0,1,0
2,225,225,9,1,8,3,2
10,230,230,24,12,12,3,2
32,239,239,23,23,0,1,0
1,239,239,6,2,4,2,1
11,249,249,19,19,0,1,0
30,265,265,65,53,12,4,3
36,271,271,41,41,0,1,0
5,272,272,46,46,0,1,0
4,278,278,24,24,0,1,0
20,278,278,55,55,0,1,0
31,294,294,44,21,23,3,2
6,302,302,9,1,8,3,2
8,305,305,6,6,0,1,0
29,314,314,23,14,9,2,1
26,314,314,11,11,0,1,0
24,356,356,1,1,0,1,0
15,365,365,62,16,46,3,2
23,368,368,19,19,0,1,0
35,369,369,6,6,0,1,0
3,379,379,42,10,32,3,2
0,381,381,62,41,21,2,1
27,389,389,20,14,6,2,1
7,397,397,46,19,27,2,1
25,399,399,10,5,5,2,1
14,408,408,63,6,57,4,3
19,414,414,120,120,0,1,0
33,421,421,10,10,0,1,0
9,425,425,10,10,0,1,0
28,427,427,69,69,0,1,0
17,443,443,14,14,0,1,0
12,460,460,136,106,30,3,2
34,481,481,42,42,0,1,0

21,102,102,6,6,0,1,0
32,103,103,4,4,0,1,0
7,105,105,22,12,10,3,2
23,110,110,8,8,0,1,0
36,125,125,5,5,0,1,0
20,146,146,2,2,0,1,0
35,167,167,13,4,9,2,1
18,175,175,2,2,0,1,0
29,197,197,9,9,0,1,0
6,199,199,46,46,0,1,0
28,207,207,10,10,0,1,0
33,219,219,97,97,0,1,0
24,226,226,21,4,17,4,3
27,227,227,63,63,0,1,0
1,243,243,90,38,52,3,2
9,263,263,1,1,0,1,0
13,285,285,21,21,0,1,0
0,285,285,7,4,3,2,1
26,287,287,10,10,0,1,0
8,292,292,5,5,0,1,0
14,313,313,3,3,0,1,0
5,320,320,51,51,0,1,0
22,336,336,77,29,48,3,2
3,365,365,21,17,4,2,1
4,369,369,6,6,0,1,0
25,383,383,49,22,27,4,3
31,391,391,69,69,0,1,0
15,401,401,42,42,0,1,0
34,422,422,8,1,7,2,1
16,427,427,58,7,51,4,3
19,444,444,17,8,9,4,3
17,447,447,2,2,0,1,0
10,480,480,51,51,0,1,0
30,484,484,97,8,89,4,3
11,485,485,3,3,0,1,0
2,493,493,55,55,0,1,0
12,499,499,181,181,0,1,0

19,101,101,8,8,0,1,0
29,119,119,12,12,0,1,0
25,119,119,5,5,0,1,0
9,127,127,3,3,0,1,0
2,131,131,17,17,0,1,0
31,131,131,16,16,0,1,0
16,133,133,1,1,0,1,0
4,141,141,35,2,33,2,1
20,162,162,4,4,0,1,0
27,163,163,12,12,0,1,0
10,171,171,24,24,0,1,0
34,252,252,3,3,0,1,0
14,255,255,25,25,0,1,0
35,267,267,53,5,48,2,1
37,273,273,9,6,3,2,1
18,273,273,13,5,8,3,2
15,276,276,6,6,0,1,0
26,283,283,12,12,0,1,0
3,284,284,9,3,6,2,1
7,285,285,7,4,3,2,1
32,285,285,76,64,12,3,2
24,312,312,47,5,42,3,2
13,322,322,39,7,32,3,2
28,353,353,28,28,0,1,0
5,353,353,51,51,0,1,0
36,361,361,65,65,0,1,0
12,382,382,113,70,43,3,2
6,387,387,15,2,13,3,2
30,419,419,26,11,15,4,3
17,443,443,82,44,38,2,1
8,445,445,29,29,0,1,0
22,448,448,71,71,0,1,0
23,474,474,2,2,0,1,0
0,477,477,12,12,0,1,0
1,484,484,84,84,0,1,0
33,485,485,8,8,0,1,0
21,486,486,166,88,78,3,2
11,499,499,113,82,31,4,3

27,106,106,35,9,26,2,1
37,108,108,2,2,0,1,0
38,118,118,12,12,0,1,0
30,153,153,9,9,0,1,0
14,157,157,2,2,0,1,0
35,163,163,5,2,3,2,1
41,168,168,5,5,0,1,0
19,170,170,24,24,0,1,0
9,178,178,18,18,0,1,0
36,200,200,2,2,0,1,0
2,205,205,1,1,0,1,0
39,216,216,45,45,0,1,0
40,219,219,9,9,0,1,0
4,232,232,46,46,0,1,0
28,251,251,41,41,0,1,0
24,256,256,64,64,0,1,0
6,260,260,1,1,0,1,0
31,274,274,14,6,8,2,1
5,304,304,21,21,0,1,0
33,326,326,21,21,0,1,0
8,326,326,6,3,3,2,1
1,328,328,59,11,48,3,2
25,331,331,5,5,0,1,0
26,363,363,4,4,0,1,0
18,370,370,11,11,0,1,0
23,377,377,89,9,80,4,3
32,378,378,15,15,0,1,0
3,381,381,31,31,0,1,0
16,384,384,34,23,11,2,1
17,424,424,23,11,12,4,3
21,427,427,24,24,0,1,0
7,436,436,217,153,64,3,2
0,440,440,41,16,25,2,1
11,447,447,29,29,0,1,0
12,447,447,13,13,0,1,0
13,458,458,30,30,0,1,0
29,460,460,57,57,0,1,0
22,463,463,114,80,34,3,2
20,474,474,54,54,0,1,0
15,487,487,22,22,0,1,0
10,489,489,25,25,0,1,0
34,493,493,7,7,0,1,0

21,103,103,6,6,0,1,0
15,106,106,5,1,4,2,1
29,117,117,20,20,0,1,0
35,123,123,1,1,0,1,0
26,124,124,2,2,0,1,0
24,126,126,25,10,15,3,2
0,133,133,1,1,0,1,0
34,137,137,18,18,0,1,0
11,138,138,28,28,0,1,0
38,140,140,65,65,0,1,0
13,153,153,2,2,0,1,0
10,156,156,15,12,3,2,1
5,163,163,6,6,0,1,0
7,173,173,22,16,6,3,2
33,177,177,25,25,0,1,0
14,186,186,35,35,0,1,0
25,190,190,15,15,0,1,0
18,200,200,11,11,0,1,0
31,208,208,2,2,0,1,0
3,210,210,6,6,0,1,0
20,213,213,14,14,0,1,0
8,236,236,20,7,13,2,1
40,251,251,19,10,9,2,1
9,265,265,51,51,0,1,0
4,288,288,28,13,15,2,1
32,289,289,34,34,0,1,0
1,295,295,31,31,0,1,0
30,302,302,41,9,32,3,2
36,305,305,55,41,14,2,1
28,319,319,27,27,0,1,0
22,330,330,16,2,14,3,2
17,337,337,37,28,9,4,3
2,339,339,29,14,15,2,1
39,367,367,12,12,0,1,0
12,379,379,43,21,22,3,2
23,452,452,29,29,0,1,0
16,464,464,62,24,38,3,2
37,480,480,16,16,0,1,0
27,487,487,8,3,5,2,1
6,492,492,68,19,49,3,2
19,494,494,36,28,8,3,2

40,111,111,68,41,27,4,3
27,127,127,3,3,0,1,0
15,142,142,7,7,0,1,0
5,143,143,1,1,0,1,0
39,146,146,12,6,6,3,2
36,150,150,8,8,0,1,0
25,165,165,15,1,14,2,1
18,179,179,2,2,0,1,0
12,179,179,23,23,0,1,0
22,180,180,14,14,0,1,0
10,180,180,20,9,11,2,1
8,183,183,8,8,0,1,0
4,191,191,6,6,0,1,0
30,204,204,1,1,0,1,0
38,208,208,40,40,0,1,0
14,238,238,6,6,0,1,0
26,241,241,17,5,12,3,2
19,246,246,15,9,6,3,2
20,264,264,3,3,0,1,0
31,265,265,10,7,3,2,1
9,266,266,34,21,13,2,1
37,280,280,1,1,0,1,0
17,281,281,112,112,0,1,0
23,293,293,42,28,14,2,1
7,309,309,4,4,0,1,0
32,312,312,101,21,80,3,2
11,313,313,14,3,11,2,1
1,315,315,3,3,0,1,0
29,332,332,38,4,34,3,2
3,337,337,6,6,0,1,0
13,356,356,12,12,0,1,0
0,364,364,18,18,0,1,0
33,376,376,13,5,8,3,2
16,377,377,85,85,0,1,0
24,402,402,5,5,0,1,0
2,412,412,53,53,0,1,0
6,421,421,67,46,21,2,1
35,421,421,25,16,9,2,1
34,444,444,3,3,0,1,0
21,449,449,141,141,0,1,0
41,473,473,38,29,9,4,3
28,476,476,8,1,7,2,1

34,111,111,6,6,0,1,0
20,121,121,11,11,0,1,0
37,130,130,12,12,0,1,0
7,134,134,61,61,0,1,0
23,135,135,4,4,0,1,0
15,140,140,1,1,0,1,0
27,140,140,5,5,0,1,0
18,145,145,5,5,0,1,0
33,146,146,1,1,0,1,0
29,147,147,19,5,14,2,1
24,151,151,16,16,0,1,0
10,166,166,5,5,0,1,0
1,173,173,18,18,0,1,0
13,179,179,28,1,27,2,1
31,180,180,36,15,21,4,3
26,215,215,39,39,0,1,0
2,220,220,15,10,5,2,1
6,248,248,32,32,0,1,0
3,265,265,21,21,0,1,0
9,274,274,4,1,3,2,1
22,279,279,13,13,0,1,0
40,280,280,5,5,0,1,0
8,288,288,23,23,0,1,0
35,303,303,81,81,0,1,0
32,303,303,49,49,0,1,0
12,309,309,15,9,6,3,2
30,313,313,56,36,20,2,1
36,328,328,12,7,5,2,1
0,351,351,72,38,34,4,3
4,353,353,15,10,5,2,1
25,372,372,21,21,0,1,0
14,388,388,20,20,0,1,0
11,415,415,23,8,15,3,2
16,425,425,45,35,10,2,1
38,436,436,34,30,4,2,1
21,450,450,101,57,44,2,1
28,462,462,47,13,34,3,2
19,465,465,110,80,30,2,1
5,475,475,1,1,0,1,0
39,481,481,22,22,0,1,0
17,481,481,2,2,0,1,0

15,112,112,3,3,0,1,0
9,153,153,3,3,0,1,0
10,157,157,59,25,34,2,1
20,204,204,28,28,0,1,0
29,223,223,2,2,0,1,0
27,238,238,2,2,0,1,0
21,255,255,14,10,4,2,1
26,260,260,56,13,43,2,1
24,277,277,41,25,16,2,1
12,305,305,2,2,0,1,0
5,314,314,30,30,0,1,0
18,319,319,71,53,18,2,1
19,321,321,43,43,0,1,0
13,334,334,13,7,6,3,2
14,342,342,25,1,24,4,3
23,373,373,4,4,0,1,0
11,379,379,133,85,48,3,2
6,381,381,32,14,18,3,2
4,390,390,45,45,0,1,0
28,393,393,44,44,0,1,0
22,396,396,113,33,80,4,3
2,401,401,61,61,0,1,0
1,411,411,119,119,0,1,0
7,412,412,146,101,45,4,3
3,429,429,11,2,9,2,1
17,430,430,26,26,0,1,0
30,433,433,55,55,0,1,0
8,451,451,28,28,0,1,0
31,460,460,26,26,0,1,0
25,463,463,2,2,0,1,0
32,469,469,59,59,0,1,0
0,477,477,34,34,0,1,0
16,499,499,93,66,27,2,1

2,103,103,15,15,0,1,0
35,115,115,15,15,0,1,0
30,133,133,11,3,8,2,1
19,143,143,21,12,9,2,1
6,149,149,28,1,27,2,1
0,166,166,33,33,0,1,0
29,175,175,9,9,0,1,0
24,176,176,4,4,0,1,0
3,181,181,12,12,0,1,0
5,196,196,55,28,27,4,3
34,206,206,5,5,0,1,0
17,215,215,1,1,0,1,0
7,217,217,37,28,9,2,1
27,254,254,42,42,0,1,0
15,276,276,43,7,36,3,2
12,281,281,26,8,18,4,3
16,296,296,3,3,0,1,0
11,317,317,21,15,6,3,2
8,319,319,6,6,0,1,0
36,326,326,20,20,0,1,0
14,327,327,35,13,22,4,3
18,335,335,96,43,53,4,3
13,338,338,35,1,34,3,2
21,347,347,6,6,0,1,0
33,357,357,5,5,0,1,0
37,358,358,21,13,8,3,2
25,369,369,17,17,0,1,0
32,380,380,18,18,0,1,0
4,392,392,32,32,0,1,0
26,400,400,22,22,0,1,0
20,400,400,38,38,0,1,0
9,416,416,90,51,39,4,3
1,424,424,9,3,6,3,2
23,427,427,252,123,129,4,3
22,435,435,34,34,0,1,0
10,445,445,34,34,0,1,0
31,446,446,1,1,0,1,0
28,447,447,30,30,0,1,0

30,101,101,8,8,0,1,0
8,112,112,29,2,27,2,1
38,112,112,13,2,11,2,1
11,115,115,17,7,10,2,1
17,125,125,23,11,12,4,3
33,155,155,4,1,3,2,1
28,169,169,30,30,0,1,0
20,171,171,16,11,5,2,1
40,181,181,10,10,0,1,0
21,189,189,4,4,0,1,0
2,195,195,3,3,0,1,0
27,205,205,14,4,10,2,1
10,217,217,3,3,0,1,0
3,225,225,30,30,0,1,0
22,233,233,4,1,3,2,1
36,235,235,25,25,0,1,0
25,243,243,44,29,15,2,1
15,262,262,1,1,0,1,0
26,265,265,19,10,9,4,3
37,293,293,33,9,24,3,2
5,294,294,22,13,9,4,3
9,296,296,11,11,0,1,0
23,316,316,54,54,0,1,0
1,319,319,40,16,24,2,1
7,337,337,86,11,75,4,3
32,343,343,41,27,14,3,2
39,344,344,10,3,7,3,2
24,345,345,110,82,28,3,2
29,350,350,6,6,0,1,0
14,351,351,60,60,0,1,0
35,369,369,60,26,34,3,2
13,401,401,20,7,13,2,1
34,424,424,17,7,10,2,1
19,435,435,12,8,4,2,1
6,440,440,7,7,0,1,0
18,459,459,94,94,0,1,0
0,460,460,3,3,0,1,0
31,474,474,79,61,18,3,2
4,476,476,15,15,0,1,0
16,494,494,44,10,34,3,2
12,494,494,30,12,18,4,3

25,112,112,4,4,0,1,0
3,152,152,63,25,38,3,2
22,165,165,15,3,12,2,1
38,179,179,28,4,24,2,1
1,180,180,2,2,0,1,0
8,181,181,4,4,0,1,0
31,184,184,12,1,11,2,1
29,184,184,5,5,0,1,0
34,215,215,23,8,15,4,3
6,220,220,7,7,0,1,0
2,223,223,8,8,0,1,0
37,226,226,18,10,8,3,2
20,239,239,37,37,0,1,0
32,245,245,29,29,0,1,0
27,249,249,38,38,0,1,0
18,250,250,22,4,18,2,1
28,276,276,25,4,21,3,2
19,297,297,18,18,0,1,0
35,305,305,52,52,0,1,0
11,310,310,38,8,30,3,2
12,319,319,8,8,0,1,0
24,338,338,5,2,3,2,1
21,340,340,23,23,0,1,0
16,352,352,78,29,49,2,1
26,355,355,24,3,21,4,3
13,358,358,11,11,0,1,0
4,367,367,29,21,8,2,1
30,383,383,8,8,0,1,0
33,385,385,165,165,0,1,0
14,403,403,89,31,58,4,3
7,404,404,15,15,0,1,0
15,421,421,4,4,0,1,0
5,432,432,32,32,0,1,0
10,435,435,98,84,14,2,1
23,444,444,13,7,6,2,1
36,447,447,46,6,40,3,2
17,458,458,40,25,15,2,1
0,468,468,46,46,0,1,0
9,481,481,81,13,68,3,2

17,102,102,22,22,0,1,0
23,104,104,25,1,24,4,3
18,105,105,2,2,0,1,0
25,115,115,21,21,0,1,0
24,117,117,29,29,0,1,0
6,128,128,58,58,0,1,0
29,146,146,7,7,0,1,0
0,155,155,17,17,0,1,0
14,161,161,6,6,0,1,0
1,167,167,20,14,6,2,1
5,168,168,3,3,0,1,0
15,186,186,25,8,17,3,2
7,195,195,8,8,0,1,0
30,247,247,16,16,0,1,0
21,263,263,3,3,0,1,0
9,282,282,124,124,0,1,0
13,310,310,19,19,0,1,0
4,311,311,21,3,18,3,2
26,315,315,30,30,0,1,0
3,320,320,48,48,0,1,0
19,339,339,10,10,0,1,0
22,344,344,47,47,0,1,0
31,361,361,26,26,0,1,0
16,392,392,32,13,19,2,1
20,396,396,25,25,0,1,0
27,434,434,13,1,12,4,3
10,451,451,72,28,44,3,2
8,466,466,182,68,114,4,3
12,467,467,127,127,0,1,0
2,468,468,18,18,0,1,0
28,484,484,7,7,0,1,0
11,494,494,7,7,0,1,0

36,112,112,7,7,0,1,0
13,116,116,14,2,12,2,1
31,117,117,9,9,0,1,0
27,131,131,3,3,0,1,0
21,179,179,1,1,0,1,0
2,210,210,1,1,0,1,0
5,240,240,59,5,54,4,3
17,246,246,21,21,0,1,0
14,246,246,2,2,0,1,0
18,249,249,10,10,0,1,0
38,251,251,17,10,7,2,1
25,253,253,89,33,56,3,2
6,256,256,97,58,39,4,3
29,265,265,14,14,0,1,0
33,269,269,76,76,0,1,0
20,270,270,81,81,0,1,0
7,271,271,25,11,14,3,2
10,272,272,5,5,0,1,0
34,276,276,9,9,0,1,0
4,281,281,36,2,34,2,1
11,287,287,44,18,26,3,2
0,298,298,12,3,9,2,1
1,334,334,16,13,3,2,1
30,372,372,75,15,60,3,2
9,375,375,22,22,0,1,0
35,391,391,74,65,9,4,3
16,404,404,6,6,0,1,0
22,407,407,11,11,0,1,0
3,410,410,109,109,0,1,0
15,411,411,22,10,12,3,2
8,416,416,36,31,5,2,1
37,423,423,55,55,0,1,0
12,424,424,67,59,8,2,1
23,448,448,2,2,0,1,0
26,461,461,7,1,6,2,1
19,472,472,1,1,0,1,0
32,478,478,48,48,0,1,0
24,485,485,20,20,0,1,0
28,495,495,32,23,9,2,1

39,111,111,11,11,0,1,0
5,120,120,1,1,0,1,0
30,129,129,4,4,0,1,0
11,145,145,30,20,10,2,1
24,157,157,26,15,11,2,1
1,175,175,1,1,0,1,0
20,181,181,11,8,3,2,1
4,183,183,45,45,0,1,0
2,186,186,2,2,0,1,0
21,191,191,20,20,0,1,0
7,194,194,4,1,3,2,1
33,226,226,3,3,0,1,0
25,229,229,7,1,6,3,2
31,231,231,9,9,0,1,0
6,236,236,8,8,0,1,0
13,252,252,85,85,0,1,0
12,271,271,8,1,7,2,1
14,281,281,12,12,0,1,0
8,287,287,10,10,0,1,0
22,307,307,20,20,0,1,0
28,316,316,25,25,0,1,0
34,319,319,139,43,96,3,2
38,322,322,4,4,0,1,0
3,330,330,4,1,3,2,1
36,338,338,33,23,10,3,2
16,354,354,31,4,27,4,3
29,376,376,4,4,0,1,0
19,382,382,5,1,4,2,1
23,385,385,52,44,8,2,1
18,385,385,39,39,0,1,0
15,422,422,109,109,0,1,0
17,424,424,57,57,0,1,0
26,435,435,23,23,0,1,0
40,441,441,144,31,113,4,3
0,446,446,42,42,0,1,0
9,452,452,49,49,0,1,0
37,476,476,20,2,18,4,3
32,478,478,9,2,7,2,1
10,481,481,76,76,0,1,0
27,488,488,50,5,45,2,1
35,500,500,87,7,80,3,2

11,110,110,23,6,17,2,1
5,119,119,10,2,8,3,2
33,131,131,11,1,10,3,2
9,131,131,1,1,0,1,0
28,165,165,9,1,8,2,1
29,165,165,27,27,0,1,0
36,185,185,6,6,0,1,0
24,185,185,26,14,12,3,2
8,195,195,36,8,28,2,1
16,197,197,23,23,0,1,0
30,200,200,8,8,0,1,0
19,207,207,11,11,0,1,0
32,214,214,1,1,0,1,0
38,216,216,18,10,8,3,2
18,257,257,33,33,0,1,0
42,259,259,21,7,14,2,1
31,270,270,103,22,81,4,3
0,291,291,10,10,0,1,0
4,295,295,2,2,0,1,0
2,296,296,19,12,7,3,2
46,300,300,144,60,84,3,2
37,301,301,58,20,38,3,2
1,309,309,4,1,3,2,1
35,318,318,46,2,44,2,1
25,327,327,41,26,15,2,1
21,329,329,23,9,14,3,2
17,338,338,39,20,19,2,1
26,349,349,2,2,0,1,0
3,354,354,32,32,0,1,0
10,363,363,13,3,10,2,1
43,367,367,12,12,0,1,0
34,379,379,58,49,9,2,1
22,387,387,8,2,6,3,2
7,408,408,20,20,0,1,0
23,409,409,33,33,0,1,0
6,410,410,64,33,31,2,1
27,413,413,11,11,0,1,0
44,426,426,1,1,0,1,0
20,426,426,24,24,0,1,0
40,430,430,14,14,0,1,0
13,437,437,21,6,15,2,1
12,444,444,1,1,0,1,0
15,457,457,11,11,0,1,0
14,471,471,37,37,0,1,0
45,479,479,2,2,0,1,0
41,492,492,16,3,13,2,1
39,498,498,6,6,0,1,0

33,102,102,29,23,6,3,2
36,114,114,2,2,0,1,0
23,114,114,8,2,6,3,2
16,128,128,20,7,13,2,1
12,129,129,1,1,0,1,0
39,151,151,41,41,0,1,0
4,154,154,10,4,6,2,1
19,161,161,39,1,38,2,1
24,166,166,4,1,3,2,1
21,167,167,13,13,0,1,0
26,168,168,9,9,0,1,0
3,172,172,3,3,0,1,0
22,174,174,46,46,0,1,0
29,178,178,14,6,8,2,1
25,190,190,14,14,0,1,0
1,209,209,7,7,0,1,0
8,213,213,1,1,0,1,0
28,231,231,4,4,0,1,0
18,250,250,33,33,0,1,0
31,252,252,11,11,0,1,0
6,266,266,6,6,0,1,0
32,337,337,10,7,3,2,1
11,342,342,34,34,0,1,0
14,354,354,131,131,0,1,0
9,360,360,2,2,0,1,0
7,363,363,76,76,0,1,0
27,369,369,11,11,0,1,0
38,377,377,45,45,0,1,0
35,380,380,175,175,0,1,0
10,389,389,1,1,0,1,0
0,393,393,17,17,0,1,0
15,395,395,3,3,0,1,0
20,416,416,11,1,10,3,2
5,431,431,21,9,12,3,2
37,441,441,14,14,0,1,0
34,469,469,30,3,27,4,3
2,471,471,29,23,6,3,2
13,474,474,151,19,132,4,3
17,490,490,77,77,0,1,0
30,500,500,5,5,0,1,0

15,109,109,4,4,0,1,0
26,112,112,8,8,0,1,0
20,127,127,26,26,0,1,0
43,138,138,13,13,0,1,0
40,141,141,15,6,9,2,1
32,142,142,67,57,10,2,1
36,150,150,2,2,0,1,0
42,153,153,24,12,12,4,3
22,158,158,15,8,7,2,1
16,200,200,5,5,0,1,0
29,202,202,36,19,17,2,1
7,203,203,12,12,0,1,0
23,206,206,29,12,17,4,3
18,206,206,6,6,0,1,0
8,208,208,1,1,0,1,0
1,220,220,14,1,13,2,1
0,222,222,7,1,6,3,2
3,229,229,1,1,0,1,0
24,244,244,42,42,0,1,0
25,245,245,18,4,14,3,2
34,263,263,46,46,0,1,0
28,269,269,3,3,0,1,0
33,270,270,12,6,6,3,2
35,276,276,7,7,0,1,0
13,284,284,4,1,3,2,1
5,295,295,23,23,0,1,0
9,304,304,14,14,0,1,0
27,311,311,34,31,3,2,1
2,315,315,50,50,0,1,0
11,320,320,20,6,14,2,1
4,334,334,67,58,9,2,1
14,335,335,28,25,3,2,1
10,340,340,36,36,0,1,0
41,385,385,12,6,6,3,2
19,395,395,30,12,18,2,1
37,399,399,1,1,0,1,0
21,416,416,52,13,39,4,3
17,424,424,54,27,27,2,1
30,438,438,68,59,9,2,1
12,457,457,66,66,0,1,0
6,464,464,39,17,22,3,2
31,472,472,11,1,10,3,2
38,478,478,48,48,0,1,0
39,484,484,15,15,0,1,0

36,139,139,4,4,0,1,0
23,143,143,4,4,0,1,0
27,159,159,9,9,0,1,0
31,162,162,23,23,0,1,0
30,194,194,11,7,4,2,1
29,198,198,6,6,0,1,0
17,200,200,23,23,0,1,0
32,207,207,12,12,0,1,0
39,237,237,35,30,5,2,1
2,260,260,14,4,10,3,2
40,273,273,5,5,0,1,0
4,274,274,35,19,16,2,1
19,280,280,1,1,0,1,0
15,281,281,115,115,0,1,0
10,282,282,45,4,41,4,3
5,290,290,41,25,16,3,2
6,304,304,30,30,0,1,0
34,322,322,53,33,20,3,2
38,324,324,17,7,10,3,2
25,338,338,88,53,35,2,1
20,352,352,26,26,0,1,0
21,369,369,143,102,41,2,1
26,371,371,44,44,0,1,0
1,376,376,4,4,0,1,0
11,386,386,65,57,8,3,2
28,387,387,62,62,0,1,0
7,391,391,29,14,15,2,1
9,406,406,1,1,0,1,0
22,409,409,55,55,0,1,0
3,419,419,44,16,28,3,2
24,420,420,42,42,0,1,0
8,425,425,12,12,0,1,0
18,430,430,10,1,9,2,1
0,431,431,16,12,4,2,1
37,437,437,1,1,0,1,0
33,447,447,30,6,24,2,1
35,461,461,11,11,0,1,0
12,463,463,98,35,63,4,3
13,467,467,20,10,10,3,2
14,487,487,24,24,0,1,0
16,497,497,33,33,0,1,0

33,100,100,19,19,0,1,0
3,102,102,14,2,12,2,1
37,103,103,22,4,18,2,1
31,112,112,3,3,0,1,0
6,123,123,1,1,0,1,0
24,128,128,7,7,0,1,0
19,153,153,1,1,0,1,0
13,171,171,4,4,0,1,0
17,181,181,35,35,0,1,0
10,186,186,1,1,0,1,0
36,194,194,4,4,0,1,0
30,211,211,28,28,0,1,0
32,217,217,14,4,10,3,2
15,247,247,10,6,4,2,1
9,273,273,41,41,0,1,0
29,298,298,24,24,0,1,0
4,303,303,21,3,18,3,2
16,312,312,4,4,0,1,0
11,315,315,9,9,0,1,0
14,346,346,26,14,12,2,1
7,359,359,125,125,0,1,0
35,359,359,3,3,0,1,0
27,382,382,60,33,27,4,3
34,383,383,160,160,0,1,0
26,397,397,30,30,0,1,0
2,397,397,9,9,0,1,0
12,403,403,15,4,11,2,1
28,409,409,5,5,0,1,0
23,420,420,100,60,40,2,1
20,424,424,18,18,0,1,0
22,430,430,31,31,0,1,0
18,433,433,53,53,0,1,0
21,439,439,15,15,0,1,0
0,460,460,147,147,0,1,0
8,468,468,42,42,0,1,0
25,473,473,39,9,30,4,3
1,491,491,193,193,0,1,0
5,500,500,24,24,0,1,0

3,102,102,6,6,0,1,0
14,104,104,8,8,0,1,0
5,108,108,17,17,0,1,0
9,116,116,10,10,0,1,0
19,118,118,14,14,0,1,0
10,144,144,25,19,6,2,1
0,149,149,2,2,0,1,0
34,154,154,29,23,6,2,1
20,156,156,6,1,5,2,1
21,197,197,8,8,0,1,0
23,206,206,28,8,20,2,1
13,206,206,11,11,0,1,0
37,230,230,28,28,0,1,0
12,246,246,23,15,8,3,2
35,249,249,56,56,0,1,0
8,252,252,14,3,11,2,1
38,261,261,16,16,0,1,0
29,263,263,32,16,16,3,2
6,287,287,4,4,0,1,0
33,302,302,81,51,30,4,3
2,335,335,39,39,0,1,0
11,351,351,1,1,0,1,0
15,371,371,10,10,0,1,0
26,389,389,25,11,14,2,1
16,400,400,65,65,0,1,0
4,407,407,10,10,0,1,0
7,408,408,231,187,44,3,2
25,426,426,3,3,0,1,0
39,430,430,35,35,0,1,0
27,436,436,16,6,10,2,1
31,440,440,96,96,0,1,0
17,445,445,10,5,5,2,1
36,452,452,42,29,13,2,1
28,461,461,4,4,0,1,0
22,463,463,51,51,0,1,0
18,465,465,83,23,60,3,2
24,480,480,47,47,0,1,0
1,481,481,2,2,0,1,0
32,491,491,20,5,15,4,3
30,495,495,37,32,5,2,1

1,104,104,6,2,4,2,1
7,107,107,33,14,19,2,1
14,114,114,29,7,22,2,1
10,115,115,1,1,0,1,0
24,127,127,13,4,9,4,3
9,147,147,20,20,0,1,0
27,169,169,18,4,14,3,2
30,203,203,8,2,6,3,2
22,215,215,25,25,0,1,0
31,220,220,18,18,0,1,0
15,233,233,14,14,0,1,0
6,239,239,6,6,0,1,0
33,245,245,6,6,0,1,0
17,269,269,9,5,4,2,1
23,276,276,38,38,0,1,0
29,286,286,18,18,0,1,0
8,291,291,40,40,0,1,0
16,299,299,7,7,0,1,0
2,306,306,82,56,26,2,1
28,314,314,54,3,51,4,3
26,322,322,90,90,0,1,0
12,322,322,17,17,0,1,0
21,323,323,10,10,0,1,0
18,327,327,26,26,0,1,0
4,346,346,73,25,48,2,1
32,366,366,4,1,3,2,1
11,391,391,51,51,0,1,0
19,410,410,148,70,78,4,3
20,431,431,20,11,9,4,3
3,459,459,113,8,105,4,3
13,461,461,75,19,56,3,2
25,463,463,8,8,0,1,0
5,466,466,104,104,0,1,0
0,477,477,16,16,0,1,0

35,106,106,3,3,0,1,0
0,131,131,6,3,3,2,1
28,137,137,5,1,4,2,1
7,137,137,39,39,0,1,0
30,149,149,4,1,3,2,1
2,157,157,33,33,0,1,0
16,190,190,8,8,0,1,0
33,197,197,2,2,0,1,0
18,227,227,56,23,33,4,3
17,236,236,23,23,0,1,0
1,238,238,8,2,6,3,2
32,242,242,26,15,11,2,1
23,249,249,22,1,21,4,3
24,251,251,13,13,0,1,0
5,253,253,51,38,13,2,1
34,270,270,48,48,0,1,0
11,277,277,4,4,0,1,0
13,302,302,65,65,0,1,0
25,321,321,5,5,0,1,0
15,336,336,96,57,39,2,1
8,344,344,6,6,0,1,0
26,351,351,22,3,19,2,1
4,360,360,51,36,15,2,1
9,373,373,91,25,66,4,3
22,395,395,141,30,111,4,3
3,399,399,19,19,0,1,0
14,409,409,77,77,0,1,0
12,410,410,7,4,3,2,1
20,443,443,4,4,0,1,0
29,469,469,22,6,16,3,2
6,474,474,2,2,0,1,0
31,477,477,12,12,0,1,0
27,482,482,184,147,37,4,3
10,489,489,24,24,0,1,0
19,495,495,98,41,57,4,3
21,500,500,15,4,11,2,1

9,100,100,24,24,0,1,0
31,109,109,1,1,0,1,0
0,117,117,12,12,0,1,0
30,126,126,9,9,0,1,0
25,150,150,21,12,9,4,3
40,156,156,1,1,0,1,0
17,164,164,7,1,6,3,2
33,171,171,43,43,0,1,0
22,172,172,3,3,0,1,0
37,187,187,8,3,5,2,1
13,190,190,3,3,0,1,0
43,196,196,5,5,0,1,0
11,218,218,7,4,3,2,1
26,223,223,4,4,0,1,0
20,223,223,24,24,0,1,0
15,262,262,23,9,14,3,2
38,263,263,45,45,0,1,0
16,267,267,4,4,0,1,0
4,272,272,51,39,12,4,3
19,278,278,16,10,6,2,1
42,285,285,66,29,37,2,1
5,301,301,12,12,0,1,0
8,310,310,24,24,0,1,0
35,319,319,11,11,0,1,0
7,336,336,7,7,0,1,0
24,337,337,7,2,5,2,1
1,340,340,35,35,0,1,0
29,341,341,11,2,9,4,3
27,347,347,10,6,4,2,1
39,356,356,72,25,47,2,1
36,380,380,102,74,28,2,1
3,387,387,48,22,26,3,2
34,395,395,4,4,0,1,0
45,404,404,9,9,0,1,0
6,411,411,1,1,0,1,0
18,413,413,53,8,45,2,1
21,414,414,121,76,45,2,1
12,423,423,12,12,0,1,0
47,424,424,23,23,0,1,0
41,429,429,33,8,25,2,1
44,430,430,77,49,28,3,2
46,440,440,1,1,0,1,0
2,440,440,3,3,0,1,0
10,461,461,21,15,6,2,1
32,481,481,147,92,55,4,3
28,488,488,22,5,17,3,2
14,494,494,6,6,0,1,0
23,498,498,4,4,0,1,0

5,108,108,3,3,0,1,0
10,121,121,56,56,0,1,0
21,126,126,4,4,0,1,0
22,126,126,30,2,28,2,1
38,153,153,6,6,0,1,0
6,166,166,4,4,0,1,0
27,175,175,40,3,37,4,3
13,178,178,20,3,17,2,1
28,179,179,16,16,0,1,0
31,186,186,1,1,0,1,0
14,187,187,1,1,0,1,0
35,196,196,10,10,0,1,0
3,233,233,6,6,0,1,0
4,241,241,39,39,0,1,0
1,250,250,34,34,0,1,0
23,252,252,9,1,8,3,2
34,262,262,46,36,10,3,2
29,265,265,39,21,18,4,3
0,288,288,6,6,0,1,0
36,303,303,1,1,0,1,0
32,307,307,93,93,0,1,0
26,318,318,12,3,9,4,3
19,342,342,39,39,0,1,0
2,348,348,4,1,3,2,1
7,352,352,26,15,11,2,1
30,353,353,31,31,0,1,0
9,371,371,66,26,40,3,2
18,374,374,7,1,6,2,1
25,379,379,1,1,0,1,0
20,396,396,11,4,7,2,1
33,403,403,40,28,12,3,2
37,404,404,123,25,98,3,2
12,409,409,6,1,5,2,1
17,426,426,143,89,54,4,3
16,463,463,77,77,0,1,0
15,471,471,41,1,40,2,1
24,471,471,8,8,0,1,0
11,485,485,33,33,0,1,0
8,495,495,35,35,0,1,0

16,109,109,5,1,4,2,1
8,117,117,16,5,11,3,2
0,134,134,6,3,3,2,1
29,136,136,2,2,0,1,0
37,142,142,6,6,0,1,0
40,156,156,3,3,0,1,0
35,167,167,6,6,0,1,0
30,190,190,13,13,0,1,0
17,194,194,43,6,37,2,1
20,205,205,4,4,0,1,0
12,231,231,66,33,33,4,3
39,231,231,42,42,0,1,0
34,237,237,35,35,0,1,0
21,240,240,14,14,0,1,0
38,244,244,4,4,0,1,0
24,246,246,64,55,9,2,1
25,251,251,94,30,64,3,2
7,253,253,8,8,0,1,0
33,283,283,25,6,19,2,1
4,285,285,14,2,12,2,1
31,317,317,2,2,0,1,0
2,323,323,4,4,0,1,0
23,338,338,28,24,4,2,1
14,351,351,66,66,0,1,0
13,369,369,49,49,0,1,0
26,370,370,29,6,23,2,1
11,371,371,38,38,0,1,0
19,371,371,4,4,0,1,0
22,384,384,103,103,0,1,0
3,386,386,47,20,27,4,3
5,417,417,44,44,0,1,0
9,426,426,63,63,0,1,0
18,434,434,1,1,0,1,0
28,435,435,2,2,0,1,0
15,455,455,66,66,0,1,0
6,457,457,22,4,18,2,1
1,460,460,19,19,0,1,0
27,462,462,34,34,0,1,0
32,467,467,50,50,0,1,0
10,496,496,53,53,0,1,0
36,496,496,58,15,43,2,1

35,127,127,13,13,0,1,0
41,133,133,24,24,0,1,0
38,137,137,6,1,5,2,1
9,142,142,1,1,0,1,0
16,143,143,19,19,0,1,0
7,153,153,21,21,0,1,0
0,164,164,6,6,0,1,0
17,175,175,10,10,0,1,0
31,215,215,13,1,12,2,1
18,251,251,1,1,0,1,0
5,251,251,6,6,0,1,0
4,258,258,9,9,0,1,0
36,266,266,9,9,0,1,0
32,266,266,4,4,0,1,0
42,271,271,102,102,0,1,0
6,282,282,5,5,0,1,0
11,294,294,85,60,25,3,2
20,304,304,1,1,0,1,0
3,314,314,53,53,0,1,0
21,317,317,53,11,42,2,1
37,320,320,49,6,43,2,1
13,335,335,6,6,0,1,0
24,337,337,31,17,14,2,1
30,338,338,6,6,0,1,0
39,341,341,2,2,0,1,0
15,355,355,55,28,27,4,3
2,356,356,36,11,25,4,3
14,365,365,3,3,0,1,0
12,393,393,11,11,0,1,0
1,397,397,13,2,11,2,1
8,403,403,19,19,0,1,0
28,404,404,59,59,0,1,0
29,410,410,44,44,0,1,0
25,411,411,25,19,6,2,1
10,417,417,114,21,93,4,3
33,423,423,5,1,4,2,1
22,439,439,66,66,0,1,0
34,453,453,35,35,0,1,0
27,454,454,29,29,0,1,0
26,458,458,162,138,24,3,2
40,461,461,54,54,0,1,0
19,472,472,30,30,0,1,0
43,479,479,8,2,6,3,2
23,487,487,21,7,14,3,2

20,114,114,30,30,0,1,0
13,116,116,4,4,0,1,0
32,127,127,17,17,0,1,0
19,128,128,4,4,0,1,0
17,137,137,1,1,0,1,0
15,140,140,69,37,32,3,2
0,140,140,7,7,0,1,0
16,146,146,9,9,0,1,0
29,149,149,1,1,0,1,0
12,155,155,4,4,0,1,0
18,163,163,11,1,10,3,2
4,172,172,39,30,9,2,1
2,180,180,13,13,0,1,0
37,184,184,15,15,0,1,0
39,221,221,5,5,0,1,0
21,221,221,2,2,0,1,0
35,232,232,21,12,9,4,3
27,240,240,8,8,0,1,0
26,271,271,3,3,0,1,0
42,279,279,39,39,0,1,0
36,295,295,27,10,17,2,1
31,297,297,24,6,18,4,3
25,297,297,30,24,6,3,2
33,298,298,29,29,0,1,0
6,315,315,28,28,0,1,0
41,334,334,3,3,0,1,0
3,350,350,5,2,3,2,1
24,358,358,8,3,5,2,1
10,373,373,32,15,17,2,1
14,374,374,7,3,4,2,1
38,391,391,62,44,18,3,2
22,401,401,16,5,11,2,1
8,426,426,16,16,0,1,0
40,436,436,129,129,0,1,0
11,438,438,39,17,22,3,2
5,439,439,20,16,4,2,1
30,443,443,7,7,0,1,0
23,457,457,241,165,76,3,2
7,458,458,20,20,0,1,0
28,475,475,48,35,13,2,1
9,488,488,27,22,5,2,1
34,490,490,3,3,0,1,0
1,498,498,70,6,64,4,3

28,101,101,2,2,0,1,0
1,123,123,32,32,0,1,0
2,132,132,8,8,0,1,0
7,135,135,4,4,0,1,0
3,140,140,42,42,0,1,0
24,160,160,6,6,0,1,0
38,204,204,4,4,0,1,0
21,206,206,35,35,0,1,0
35,216,216,15,2,13,2,1
27,241,241,30,10,20,2,1
10,244,244,2,2,0,1,0
9,271,271,55,55,0,1,0
29,277,277,46,46,0,1,0
8,281,281,9,9,0,1,0
23,286,286,39,9,30,2,1
12,288,288,68,35,33,2,1
26,292,292,5,5,0,1,0
30,306,306,11,11,0,1,0
0,316,316,53,26,27,4,3
11,321,321,9,9,0,1,0
32,324,324,2,2,0,1,0
37,331,331,130,42,88,4,3
20,340,340,88,34,54,3,2
18,341,341,1,1,0,1,0
4,373,373,13,13,0,1,0
36,375,375,57,1,56,4,3
14,383,383,27,11,16,3,2
17,396,396,78,78,0,1,0
15,398,398,27,7,20,3,2
19,401,401,7,7,0,1,0
25,403,403,21,3,18,4,3
6,424,424,18,18,0,1,0
31,436,436,10,10,0,1,0
16,476,476,16,4,12,4,3
33,481,481,130,14,116,4,3
34,481,481,35,18,17,2,1
13,493,493,42,20,22,2,1
5,495,495,70,61,9,4,3
22,496,496,2,2,0,1,0

29,102,102,4,4,0,1,0
8,121,121,11,11,0,1,0
24,146,146,24,7,17,2,1
0,146,146,3,3,0,1,0
31,183,183,44,44,0,1,0
2,195,195,3,3,0,1,0
30,198,198,47,47,0,1,0
21,226,226,41,9,32,2,1
4,231,231,6,2,4,2,1
27,258,258,10,10,0,1,0
25,259,259,13,13,0,1,0
12,280,280,47,1,46,3,2
7,293,293,69,32,37,2,1
36,301,301,21,21,0,1,0
11,304,304,7,7,0,1,0
23,319,319,68,12,56,3,2
9,322,322,33,33,0,1,0
35,325,325,4,4,0,1,0
18,327,327,12,12,0,1,0
34,328,328,24,14,10,2,1
6,332,332,40,22,18,2,1
20,339,339,9,1,8,3,2
15,361,361,25,25,0,1,0
1,374,374,90,25,65,4,3
26,385,385,1,1,0,1,0
22,392,392,57,57,0,1,0
28,404,404,56,8,48,3,2
17,407,407,76,76,0,1,0
14,424,424,28,28,0,1,0
19,427,427,19,14,5,2,1
33,439,439,26,18,8,2,1
10,459,459,9,9,0,1,0
3,461,461,47,47,0,1,0
13,480,480,94,6,88,3,2
5,481,481,96,57,39,4,3
16,487,487,149,135,14,3,2
32,497,497,37,37,0,1,0

12,120,120,1,1,0,1,0
31,128,128,9,9,0,1,0
17,130,130,19,19,0,1,0
13,164,164,11,11,0,1,0
10,167,167,3,3,0,1,0
39,167,167,11,11,0,1,0
40,169,169,27,7,20,4,3
0,179,179,3,3,0,1,0
8,185,185,25,1,24,4,3
28,201,201,30,30,0,1,0
4,208,208,25,11,14,2,1
30,214,214,24,6,18,4,3
38,217,217,30,30,0,1,0
22,217,217,2,2,0,1,0
32,218,218,13,13,0,1,0
36,234,234,43,7,36,2,1
18,239,239,15,8,7,2,1
41,242,242,15,7,8,3,2
11,244,244,40,40,0,1,0
15,251,251,13,13,0,1,0
20,272,272,34,1,33,4,3
25,276,276,29,29,0,1,0
33,276,276,2,2,0,1,0
1,300,300,35,24,11,2,1
9,301,301,66,62,4,2,1
29,305,305,8,8,0,1,0
24,306,306,18,18,0,1,0
7,307,307,15,6,9,3,2
6,337,337,48,8,40,3,2
27,344,344,64,39,25,2,1
26,360,360,69,3,66,4,3
23,367,367,21,2,19,4,3
19,383,383,8,3,5,2,1
3,387,387,4,4,0,1,0
34,402,402,38,29,9,2,1
14,413,413,19,19,0,1,0
37,416,416,105,105,0,1,0
21,422,422,80,76,4,2,1
5,429,429,46,11,35,2,1
16,445,445,65,65,0,1,0
35,452,452,19,16,3,2,1
2,492,492,19,19,0,1,0

0,120,120,3,3,0,1,0
35,124,124,2,2,0,1,0
40,128,128,4,4,0,1,0
3,128,128,11,11,0,1,0
19,131,131,1,1,0,1,0
39,133,133,20,20,0,1,0
10,146,146,29,3,26,2,1
27,154,154,23,19,4,2,1
5,155,155,2,2,0,1,0
36,176,176,33,33,0,1,0
26,189,189,4,4,0,1,0
9,191,191,41,41,0,1,0
13,193,193,11,11,0,1,0
20,211,211,1,1,0,1,0
17,224,224,4,4,0,1,0
31,225,225,31,31,0,1,0
30,226,226,34,34,0,1,0
41,227,227,22,4,18,2,1
34,230,230,27,27,0,1,0
24,242,242,20,1,19,2,1
28,247,247,27,3,24,4,3
29,250,250,5,2,3,2,1
11,266,266,36,36,0,1,0
14,267,267,5,5,0,1,0
7,269,269,60,42,18,4,3
16,287,287,2,2,0,1,0
18,300,300,51,33,18,4,3
12,309,309,14,14,0,1,0
44,329,329,37,37,0,1,0
42,330,330,46,38,8,3,2
23,333,333,25,9,16,4,3
6,335,335,13,6,7,2,1
25,339,339,15,3,12,3,2
22,349,349,9,2,7,2,1
15,352,352,119,74,45,2,1
43,356,356,76,76,0,1,0
21,364,364,1,1,0,1,0
32,385,385,3,3,0,1,0
38,400,400,38,17,21,4,3
37,403,403,70,70,0,1,0
1,407,407,8,2,6,3,2
33,426,426,28,22,6,3,2
8,461,461,32,20,12,2,1
2,472,472,19,4,15,4,3
4,500,500,42,42,0,1,0

20,102,102,4,1,3,2,1
25,106,106,13,13,0,1,0
33,112,112,14,14,0,1,0
29,118,118,1,1,0,1,0
41,124,124,10,10,0,1,0
26,124,124,24,24,0,1,0
6,127,127,5,5,0,1,0
10,131,131,1,1,0,1,0
27,131,131,34,25,9,4,3
8,143,143,1,1,0,1,0
28,161,161,10,10,0,1,0
43,185,185,48,42,6,2,1
38,191,191,16,16,0,1,0
9,224,224,46,28,18,2,1
32,237,237,31,31,0,1,0
11,241,241,7,7,0,1,0
1,242,242,75,75,0,1,0
37,243,243,22,13,9,2,1
18,252,252,10,10,0,1,0
2,265,265,62,55,7,2,1
13,267,267,14,9,5,2,1
42,272,272,27,6,21,4,3
21,319,319,31,4,27,4,3
23,327,327,50,4,46,2,1
31,333,333,1,1,0,1,0
0,365,365,42,42,0,1,0
7,375,375,44,9,35,2,1
19,378,378,3,3,0,1,0
30,379,379,19,19,0,1,0
34,386,386,8,5,3,2,1
24,396,396,1,1,0,1,0
35,408,408,51,51,0,1,0
36,422,422,17,17,0,1,0
17,423,423,10,10,0,1,0
39,429,429,32,32,0,1,0
15,429,429,2,2,0,1,0
40,435,435,93,93,0,1,0
4,450,450,1,1,0,1,0
3,451,451,58,58,0,1,0
22,456,456,15,15,0,1,0
14,467,467,6,6,0,1,0
12,470,470,55,55,0,1,0
16,480,480,37,8,29,3,2
5,486,486,72,72,0,1,0

30,104,104,5,5,0,1,0
28,105,105,12,9,3,2,1
3,116,116,3,3,0,1,0
18,116,116,30,30,0,1,0
10,148,148,53,8,45,4,3
6,153,153,12,12,0,1,0
34,162,162,14,14,0,1,0
2,181,181,19,19,0,1,0
32,208,208,22,3,19,2,1
27,217,217,6,6,0,1,0
20,251,251,27,22,5,2,1
26,265,265,24,24,0,1,0
25,277,277,4,4,0,1,0
12,296,296,167,167,0,1,0
22,300,300,14,4,10,3,2
23,307,307,54,54,0,1,0
15,309,309,4,4,0,1,0
8,310,310,9,9,0,1,0
17,316,316,63,45,18,2,1
0,338,338,17,17,0,1,0
13,344,344,89,63,26,2,1
16,347,347,6,6,0,1,0
24,362,362,9,1,8,2,1
29,371,371,2,2,0,1,0
11,375,375,14,14,0,1,0
14,386,386,25,4,21,3,2
33,395,395,122,55,67,4,3
1,400,400,31,31,0,1,0
7,405,405,72,54,18,4,3
9,428,428,64,64,0,1,0
4,430,430,1,1,0,1,0
21,446,446,167,99,68,4,3
5,450,450,10,10,0,1,0
31,474,474,1,1,0,1,0
19,490,490,13,7,6,3,2

27,101,101,11,11,0,1,0
13,124,124,3,3,0,1,0
37,131,131,27,9,18,2,1
9,134,134,19,19,0,1,0
12,146,146,16,10,6,2,1
38,154,154,5,5,0,1,0
35,162,162,12,12,0,1,0
31,165,165,67,45,22,2,1
20,172,172,9,5,4,2,1
32,186,186,21,21,0,1,0
11,187,187,8,8,0,1,0
36,203,203,11,11,0,1,0
17,228,228,16,2,14,2,1
7,256,256,13,13,0,1,0
10,258,258,4,4,0,1,0
3,267,267,136,136,0,1,0
6,272,272,4,1,3,2,1
22,272,272,4,4,0,1,0
33,277,277,2,2,0,1,0
18,277,277,4,1,3,2,1
15,286,286,13,1,12,3,2
25,300,300,20,20,0,1,0
34,301,301,82,66,16,3,2
16,325,325,6,6,0,1,0
29,325,325,22,22,0,1,0
28,326,326,24,17,7,2,1
0,334,334,31,10,21,4,3
21,353,353,89,72,17,2,1
8,373,373,32,22,10,3,2
30,377,377,13,7,6,2,1
19,402,402,11,11,0,1,0
14,409,409,12,12,0,1,0
1,417,417,24,24,0,1,0
2,426,426,91,91,0,1,0
23,427,427,24,24,0,1,0
26,468,468,40,40,0,1,0
4,479,479,187,143,44,3,2
5,482,482,37,27,10,3,2
24,499,499,21,11,10,2,1

5,107,107,29,29,0,1,0
22,131,131,27,23,4,2,1
32,133,133,5,5,0,1,0
3,142,142,1,1,0,1,0
33,148,148,19,9,10,3,2
16,162,162,31,22,9,2,1
21,184,184,15,11,4,2,1
1,186,186,8,8,0,1,0
4,195,195,15,6,9,2,1
7,206,206,35,5,30,2,1
34,219,219,9,1,8,2,1
15,219,219,8,8,0,1,0
8,240,240,27,27,0,1,0
27,253,253,8,4,4,2,1
20,264,264,21,15,6,2,1
36,270,270,8,4,4,2,1
40,279,279,57,11,46,4,3
6,279,279,56,56,0,1,0
28,291,291,27,9,18,3,2
37,302,302,7,4,3,2,1
0,305,305,30,22,8,3,2
35,305,305,131,86,45,4,3
13,318,318,17,1,16,2,1
26,323,323,85,37,48,3,2
19,328,328,18,15,3,2,1
17,342,342,13,13,0,1,0
25,343,343,3,3,0,1,0
12,343,343,13,3,10,4,3
9,349,349,53,53,0,1,0
31,374,374,1,1,0,1,0
18,404,404,32,32,0,1,0
30,407,407,32,10,22,3,2
2,413,413,28,28,0,1,0
29,417,417,16,5,11,2,1
39,434,434,55,19,36,4,3
23,470,470,11,8,3,2,1
38,479,479,82,44,38,3,2
11,479,479,28,28,0,1,0
24,495,495,13,5,8,2,1
10,496,496,43,16,27,2,1
14,500,500,43,5,38,3,2

41,104,104,44,44,0,1,0
25,110,110,35,35,0,1,0
15,116,116,61,61,0,1,0
9,117,117,31,31,0,1,0
11,131,131,9,9,0,1,0
29,134,134,18,10,8,3,2
18,138,138,3,3,0,1,0
12,152,152,5,5,0,1,0
2,162,162,2,2,0,1,0
35,166,166,6,6,0,1,0
20,220,220,1,1,0,1,0
37,221,221,13,13,0,1,0
13,229,229,5,5,0,1,0
19,236,236,26,26,0,1,0
33,237,237,3,3,0,1,0
42,241,241,37,17,20,3,2
14,245,245,37,37,0,1,0
6,249,249,3,3,0,1,0
4,258,258,2,2,0,1,0
27,258,258,6,6,0,1,0
5,275,275,39,39,0,1,0
38,284,284,6,3,3,2,1
40,293,293,13,13,0,1,0
8,298,298,51,51,0,1,0
7,304,304,10,10,0,1,0
24,306,306,13,13,0,1,0
34,309,309,19,19,0,1,0
17,323,323,44,2,42,3,2
23,326,326,30,7,23,2,1
21,329,329,2,2,0,1,0
31,372,372,24,24,0,1,0
32,374,374,28,28,0,1,0
0,401,401,3,3,0,1,0
16,423,423,28,28,0,1,0
22,432,432,29,5,24,3,2
36,438,438,35,35,0,1,0
39,439,439,92,16,76,3,2
28,443,443,23,2,21,4,3
1,447,447,1,1,0,1,0
26,448,448,16,5,11,2,1
10,463,463,21,17,4,2,1
30,476,476,51,5,46,2,1
3,487,487,44,3,41,2,1

34,115,115,17,17,0,1,0
9,122,122,10,3,7,2,1
15,133,133,38,38,0,1,0
14,148,148,18,4,14,3,2
8,155,155,15,15,0,1,0
29,159,159,11,5,6,2,1
0,176,176,5,5,0,1,0
36,201,201,22,22,0,1,0
2,203,203,35,12,23,2,1
24,209,209,8,8,0,1,0
1,219,219,38,38,0,1,0
30,229,229,22,6,16,3,2
31,252,252,13,13,0,1,0
28,260,260,1,1,0,1,0
27,261,261,38,38,0,1,0
33,263,263,30,5,25,2,1
19,274,274,60,8,52,3,2
20,281,281,42,13,29,4,3
17,304,304,24,24,0,1,0
10,314,314,41,13,28,3,2
5,325,325,15,15,0,1,0
26,342,342,25,17,8,3,2
22,343,343,34,19,15,4,3
32,343,343,8,8,0,1,0
13,352,352,61,18,43,2,1
18,379,379,14,5,9,4,3
21,389,389,95,28,67,4,3
25,390,390,83,70,13,2,1
23,404,404,29,11,18,2,1
7,405,405,28,28,0,1,0
12,410,410,60,60,0,1,0
11,411,411,44,44,0,1,0
35,435,435,29,29,0,1,0
3,454,454,48,36,12,2,1
4,459,459,9,2,7,2,1
16,466,466,39,39,0,1,0
6,494,494,79,28,51,4,3

33,103,103,9,1,8,3,2
2,111,111,35,5,30,4,3
10,119,119,14,14,0,1,0
4,122,122,5,5,0,1,0
19,124,124,3,3,0,1,0
15,125,125,3,3,0,1,0
22,136,136,21,21,0,1,0
11,144,144,10,10,0,1,0
38,166,166,10,2,8,2,1
28,182,182,2,2,0,1,0
34,233,233,11,1,10,2,1
17,237,237,30,30,0,1,0
13,258,258,2,2,0,1,0
18,261,261,16,3,13,4,3
30,277,277,40,12,28,3,2
14,283,283,8,8,0,1,0
6,286,286,15,15,0,1,0
25,299,299,84,28,56,4,3
23,299,299,18,14,4,2,1
3,314,314,16,16,0,1,0
16,314,314,8,8,0,1,0
24,320,320,27,27,0,1,0
29,337,337,102,6,96,3,2
7,341,341,8,8,0,1,0
8,355,355,11,11,0,1,0
1,367,367,67,67,0,1,0
32,388,388,5,5,0,1,0
37,388,388,24,24,0,1,0
9,407,407,9,5,4,2,1
26,434,434,15,15,0,1,0
12,437,437,28,28,0,1,0
31,440,440,129,90,39,4,3
36,445,445,41,41,0,1,0
27,455,455,34,23,11,2,1
21,455,455,6,6,0,1,0
0,473,473,220,154,66,4,3
35,477,477,56,23,33,2,1
20,486,486,43,43,0,1,0
5,487,487,142,142,0,1,0

33,108,108,19,19,0,1,0
8,118,118,17,17,0,1,0
35,119,119,5,1,4,2,1
20,125,125,13,3,10,2,1
19,136,136,18,8,10,3,2
22,144,144,5,5,0,1,0
5,160,160,12,4,8,2,1
31,160,160,14,4,10,2,1
40,167,167,8,8,0,1,0
18,173,173,17,17,0,1,0
15,176,176,1,1,0,1,0
12,196,196,19,19,0,1,0
0,200,200,81,61,20,2,1
28,200,200,48,48,0,1,0
27,210,210,17,2,15,2,1
16,224,224,9,9,0,1,0
17,230,230,1,1,0,1,0
14,245,245,8,8,0,1,0
29,250,250,17,17,0,1,0
7,254,254,34,34,0,1,0
24,256,256,14,14,0,1,0
9,275,275,39,39,0,1,0
38,286,286,6,6,0,1,0
4,309,309,25,3,22,2,1
2,336,336,65,29,36,4,3
25,353,353,35,21,14,3,2
13,375,375,1,1,0,1,0
32,378,378,100,26,74,3,2
11,398,398,21,16,5,2,1
30,407,407,3,3,0,1,0
23,410,410,7,7,0,1,0
37,410,410,91,69,22,2,1
3,430,430,20,20,0,1,0
6,438,438,12,4,8,3,2
26,444,444,18,18,0,1,0
34,458,458,37,37,0,1,0
39,475,475,91,91,0,1,0
36,476,476,71,31,40,3,2
21,477,477,13,1,12,3,2
1,482,482,31,31,0,1,0
10,491,491,45,45,0,1,0
41,500,500,56,2,54,3,2

13,114,114,15,3,12,3,2
34,120,120,9,9,0,1,0
3,140,140,21,21,0,1,0
11,143,143,26,26,0,1,0
32,166,166,10,1,9,2,1
16,182,182,43,17,26,2,1
26,212,212,1,1,0,1,0
15,214,214,7,7,0,1,0
0,222,222,18,2,16,3,2
20,237,237,18,18,0,1,0
4,252,252,45,7,38,3,2
5,252,252,15,15,0,1,0
2,259,259,36,36,0,1,0
9,271,271,1,1,0,1,0
31,292,292,4,4,0,1,0
10,310,310,92,92,0,1,0
12,311,311,28,12,16,3,2
25,326,326,38,38,0,1,0
1,333,333,13,5,8,2,1
8,347,347,51,51,0,1,0
6,351,351,94,94,0,1,0
29,355,355,92,92,0,1,0
21,357,357,30,30,0,1,0
18,364,364,93,36,57,4,3
33,368,368,32,6,26,3,2
14,373,373,67,67,0,1,0
27,389,389,30,30,0,1,0
23,403,403,41,8,33,2,1
22,408,408,52,31,21,4,3
35,430,430,17,5,12,3,2
7,432,432,11,11,0,1,0
30,478,478,68,68,0,1,0
28,482,482,52,20,32,4,3
17,482,482,77,29,48,2,1
19,490,490,1,1,0,1,0
24,491,491,4,4,0,1,0

24,108,108,19,19,0,1,0
2,109,109,23,11,12,3,2
31,146,146,33,12,21,2,1
10,149,149,1,1,0,1,0
34,150,150,23,23,0,1,0
22,151,151,7,7,0,1,0
33,153,153,6,6,0,1,0
41,154,154,1,1,0,1,0
0,164,164,10,10,0,1,0
3,190,190,7,7,0,1,0
45,196,196,7,1,6,2,1
37,209,209,5,5,0,1,0
36,237,237,68,16,52,3,2
42,253,253,61,49,12,3,2
38,261,261,11,11,0,1,0
7,265,265,5,5,0,1,0
17,265,265,2,2,0,1,0
26,272,272,37,37,0,1,0
27,278,278,38,38,0,1,0
30,294,294,18,18,0,1,0
6,298,298,2,2,0,1,0
14,306,306,26,10,16,3,2
15,311,311,21,21,0,1,0
35,315,315,51,10,41,2,1
4,348,348,47,47,0,1,0
23,353,353,8,8,0,1,0
9,367,367,16,6,10,2,1
19,368,368,19,1,18,2,1
16,369,369,94,64,30,4,3
12,387,387,29,11,18,2,1
25,390,390,4,4,0,1,0
20,400,400,4,4,0,1,0
32,400,400,4,1,3,2,1
28,400,400,15,10,5,2,1
40,427,427,50,30,20,2,1
5,430,430,99,99,0,1,0
21,431,431,53,53,0,1,0
39,436,436,2,2,0,1,0
18,457,457,52,52,0,1,0
8,457,457,49,27,22,3,2
13,474,474,21,21,0,1,0
1,474,474,10,2,8,3,2
43,485,485,4,4,0,1,0
44,493,493,127,127,0,1,0
29,496,496,28,28,0,1,0
11,500,500,18,3,15,4,3

25,108,108,18,2,16,2,1
28,115,115,4,4,0,1,0
2,120,120,3,3,0,1,0
37,133,133,23,5,18,2,1
11,144,144,79,54,25,2,1
4,164,164,27,27,0,1,0
33,181,181,40,1,39,2,1
35,182,182,7,7,0,1,0
7,183,183,3,3,0,1,0
31,203,203,2,2,0,1,0
16,220,220,3,3,0,1,0
9,231,231,33,13,20,3,2
30,234,234,18,12,6,3,2
36,245,245,30,30,0,1,0
34,247,247,17,5,12,2,1
13,261,261,32,32,0,1,0
21,264,264,17,17,0,1,0
20,266,266,14,14,0,1,0
32,279,279,32,15,17,2,1
3,300,300,1,1,0,1,0
0,303,303,14,14,0,1,0
19,304,304,72,72,0,1,0
29,314,314,42,42,0,1,0
15,332,332,23,1,22,3,2
6,374,374,32,7,25,2,1
18,379,379,16,16,0,1,0
24,380,380,1,1,0,1,0
14,390,390,17,17,0,1,0
8,402,402,40,9,31,4,3
17,404,404,3,3,0,1,0
12,411,411,6,3,3,2,1
1,419,419,168,135,33,3,2
26,424,424,53,53,0,1,0
10,434,434,37,33,4,2,1
5,449,449,31,31,0,1,0
23,463,463,14,14,0,1,0
38,473,473,40,40,0,1,0
22,476,476,31,31,0,1,0
27,481,481,109,27,82,4,3

0,121,121,7,7,0,1,0
30,125,125,7,7,0,1,0
40,131,131,9,1,8,2,1
32,134,134,5,5,0,1,0
33,153,153,5,5,0,1,0
4,170,170,1,1,0,1,0
12,179,179,1,1,0,1,0
28,183,183,27,27,0,1,0
34,198,198,15,5,10,4,3
7,200,200,3,3,0,1,0
18,207,207,44,44,0,1,0
21,211,211,13,13,0,1,0
25,235,235,14,14,0,1,0
8,241,241,3,3,0,1,0
37,248,248,19,1,18,3,2
38,262,262,23,5,18,3,2
6,268,268,37,37,0,1,0
24,281,281,12,12,0,1,0
9,293,293,38,38,0,1,0
11,300,300,45,45,0,1,0
2,303,303,35,35,0,1,0
13,336,336,14,3,11,2,1
23,340,340,19,1,18,2,1
35,345,345,3,3,0,1,0
3,345,345,5,5,0,1,0
17,346,346,31,31,0,1,0
29,372,372,8,8,0,1,0
16,378,378,53,37,16,2,1
36,381,381,12,3,9,4,3
20,387,387,8,8,0,1,0
19,399,399,49,49,0,1,0
10,402,402,141,21,120,4,3
22,410,410,23,23,0,1,0
27,423,423,7,1,6,3,2
39,423,423,279,279,0,1,0
26,426,426,87,87,0,1,0
41,433,433,86,32,54,4,3
5,437,437,4,1,3,2,1
14,455,455,54,54,0,1,0
15,462,462,14,14,0,1,0
1,485,485,77,77,0,1,0
31,499,499,50,50,0,1,0

33,100,100,22,18,4,2,1
1,103,103,1,1,0,1,0
29,117,117,9,1,8,3,2
4,118,118,8,8,0,1,0
9,145,145,9,9,0,1,0
32,158,158,24,15,9,2,1
7,161,161,31,31,0,1,0
18,163,163,23,2,21,2,1
16,188,188,21,21,0,1,0
36,190,190,26,9,17,2,1
8,199,199,5,5,0,1,0
5,203,203,5,2,3,2,1
28,208,208,8,3,5,2,1
41,228,228,6,1,5,2,1
34,234,234,12,3,9,4,3
15,240,240,39,7,32,3,2
6,241,241,79,43,36,4,3
40,250,250,15,1,14,2,1
25,253,253,58,58,0,1,0
20,255,255,12,5,7,2,1
17,258,258,3,3,0,1,0
10,259,259,6,6,0,1,0
27,264,264,1,1,0,1,0
26,271,271,19,19,0,1,0
11,291,291,23,7,16,3,2
0,295,295,23,3,20,3,2
31,325,325,20,20,0,1,0
2,333,333,5,5,0,1,0
22,335,335,29,1,28,2,1
35,340,340,24,11,13,4,3
30,359,359,71,71,0,1,0
14,379,379,20,20,0,1,0
37,388,388,18,4,14,3,2
21,404,404,15,15,0,1,0
23,410,410,51,51,0,1,0
39,410,410,79,34,45,4,3
38,427,427,62,32,30,4,3
19,438,438,126,30,96,3,2
3,467,467,101,83,18,4,3
12,484,484,10,2,8,3,2
24,491,491,25,25,0,1,0
13,495,495,4,1,3,2,1

2,103,103,4,4,0,1,0
15,105,105,18,9,9,2,1
40,105,105,17,1,16,3,2
36,110,110,1,1,0,1,0
6,127,127,10,10,0,1,0
10,157,157,21,5,16,3,2
8,172,172,1,1,0,1,0
37,193,193,19,7,12,4,3
9,196,196,1,1,0,1,0
38,206,206,22,22,0,1,0
23,213,213,25,11,14,2,1
34,223,223,1,1,0,1,0
24,225,225,8,8,0,1,0
26,231,231,27,12,15,4,3
29,244,244,6,6,0,1,0
31,273,273,35,4,31,2,1
19,275,275,57,57,0,1,0
32,292,292,27,12,15,4,3
1,310,310,14,6,8,3,2
28,332,332,35,18,17,2,1
33,342,342,28,15,13,2,1
18,344,344,9,9,0,1,0
17,353,353,68,7,61,4,3
5,354,354,15,10,5,2,1
39,377,377,76,10,66,3,2
22,381,381,6,6,0,1,0
11,386,386,51,18,33,2,1
3,391,391,54,11,43,3,2
25,398,398,89,89,0,1,0
20,403,403,146,129,17,2,1
0,413,413,14,2,12,3,2
35,416,416,20,4,16,3,2
16,422,422,71,23,48,2,1
7,441,441,59,44,15,4,3
27,442,442,9,9,0,1,0
14,447,447,26,6,20,3,2
30,451,451,45,14,31,2,1
12,454,454,8,2,6,3,2
13,463,463,1,1,0,1,0
4,477,477,4,4,0,1,0
21,478,478,168,108,60,4,3

36,101,101,2,2,0,1,0
37,105,105,2,2,0,1,0
35,109,109,4,4,0,1,0
14,121,121,27,3,24,4,3
9,126,126,6,1,5,2,1
10,127,127,32,32,0,1,0
0,142,142,11,11,0,1,0
1,171,171,18,10,8,2,1
30,189,189,22,22,0,1,0
7,204,204,22,22,0,1,0
15,208,208,41,41,0,1,0
18,214,214,12,12,0,1,0
2,216,216,1,1,0,1,0
29,246,246,8,8,0,1,0
25,246,246,31,26,5,2,1
28,264,264,27,27,0,1,0
3,265,265,19,19,0,1,0
23,278,278,22,1,21,2,1
19,301,301,1,1,0,1,0
4,305,305,25,25,0,1,0
34,307,307,51,6,45,4,3
12,318,318,11,2,9,4,3
39,331,331,86,38,48,3,2
22,342,342,39,39,0,1,0
5,352,352,40,5,35,2,1
27,368,368,105,66,39,2,1
32,374,374,36,36,0,1,0
20,378,378,33,18,15,2,1
24,392,392,34,26,8,2,1
16,412,412,9,9,0,1,0
38,420,420,12,12,0,1,0
17,430,430,4,1,3,2,1
40,432,432,66,6,60,4,3
13,437,437,41,33,8,3,2
31,446,446,28,28,0,1,0
6,449,449,32,22,10,3,2
26,458,458,54,10,44,3,2
21,468,468,7,7,0,1,0
8,473,473,75,27,48,4,3
11,496,496,91,91,0,1,0
33,498,498,57,10,47,2,1

10,117,117,2,2,0,1,0
33,131,131,14,14,0,1,0
40,149,149,8,8,0,1,0
32,151,151,15,8,7,3,2
25,157,157,6,2,4,2,1
20,162,162,9,1,8,3,2
28,177,177,44,44,0,1,0
13,181,181,1,1,0,1,0
31,193,193,13,13,0,1,0
15,209,209,5,1,4,2,1
26,211,211,2,2,0,1,0
23,234,234,25,21,4,2,1
5,238,238,16,7,9,2,1
30,238,238,39,39,0,1,0
37,242,242,10,4,6,2,1
35,248,248,2,2,0,1,0
6,248,248,1,1,0,1,0
4,259,259,16,16,0,1,0
12,283,283,43,15,28,3,2
38,300,300,31,31,0,1,0
7,320,320,8,8,0,1,0
36,328,328,69,69,0,1,0
2,343,343,16,3,13,2,1
29,346,346,98,79,19,2,1
1,370,370,62,34,28,4,3
16,390,390,37,7,30,2,1
3,391,391,20,2,18,3,2
0,392,392,12,2,10,3,2
9,398,398,24,24,0,1,0
18,400,400,38,7,31,2,1
27,402,402,8,1,7,2,1
24,403,403,72,28,44,2,1
17,410,410,83,83,0,1,0
21,415,415,57,57,0,1,0
34,417,417,11,2,9,4,3
8,420,420,248,245,3,2,1
19,425,425,20,20,0,1,0
39,433,433,6,6,0,1,0
11,454,454,1,1,0,1,0
22,473,473,56,56,0,1,0
14,485,485,98,17,81,4,3

5,127,127,1,1,0,1,0
2,129,129,4,4,0,1,0
11,130,130,27,15,12,4,3
30,142,142,12,12,0,1,0
37,146,146,37,37,0,1,0
19,156,156,24,24,0,1,0
41,173,173,7,7,0,1,0
9,179,179,12,12,0,1,0
21,185,185,8,8,0,1,0
25,194,194,28,28,0,1,0
40,203,203,1,1,0,1,0
10,210,210,2,2,0,1,0
3,215,215,22,6,16,3,2
18,243,243,11,7,4,2,1
7,245,245,61,61,0,1,0
24,261,261,4,4,0,1,0
39,271,271,6,6,0,1,0
0,271,271,55,55,0,1,0
1,271,271,1,1,0,1,0
32,281,281,68,68,0,1,0
12,299,299,51,3,48,4,3
17,328,328,21,21,0,1,0
15,334,334,16,16,0,1,0
16,336,336,16,16,0,1,0
36,353,353,7,3,4,2,1
8,363,363,48,2,46,2,1
6,366,366,17,11,6,3,2
33,367,367,171,171,0,1,0
13,373,373,17,17,0,1,0
28,388,388,8,2,6,3,2
14,399,399,1,1,0,1,0
4,426,426,27,12,15,2,1
34,438,438,19,19,0,1,0
27,441,441,66,27,39,4,3
23,446,446,19,15,4,2,1
20,450,450,35,15,20,2,1
42,456,456,74,50,24,4,3
35,458,458,20,5,15,2,1
29,459,459,3,3,0,1,0
26,471,471,1,1,0,1,0
31,482,482,75,45,30,4,3
22,482,482,87,61,26,4,3
38,487,487,56,32,24,3,2

26,106,106,2,2,0,1,0
22,113,113,5,5,0,1,0
32,122,122,38,20,18,4,3
31,127,127,5,5,0,1,0
1,129,129,21,3,18,2,1
36,130,130,4,4,0,1,0
13,143,143,4,4,0,1,0
40,144,144,10,10,0,1,0
37,151,151,10,4,6,3,2
6,158,158,4,4,0,1,0
9,176,176,1,1,0,1,0
34,188,188,22,10,12,2,1
30,207,207,30,30,0,1,0
21,209,209,6,6,0,1,0
38,215,215,16,16,0,1,0
35,234,234,7,7,0,1,0
39,243,243,32,32,0,1,0
7,251,251,21,11,10,2,1
0,252,252,8,8,0,1,0
18,264,264,3,3,0,1,0
2,273,273,23,10,13,2,1
33,274,274,6,2,4,2,1
17,280,280,22,7,15,4,3
19,282,282,17,5,12,4,3
15,307,307,48,48,0,1,0
4,310,310,1,1,0,1,0
28,322,322,103,23,80,3,2
23,328,328,18,18,0,1,0
29,339,339,6,6,0,1,0
12,341,341,12,12,0,1,0
41,343,343,5,5,0,1,0
25,346,346,25,25,0,1,0
42,354,354,51,3,48,2,1
11,355,355,8,8,0,1,0
44,401,401,92,92,0,1,0
20,407,407,65,65,0,1,0
16,412,412,49,49,0,1,0
8,424,424,6,6,0,1,0
24,435,435,153,55,98,3,2
27,441,441,39,25,14,3,2
45,449,449,38,5,33,4,3
14,449,449,23,6,17,2,1
5,460,460,78,2,76,3,2
3,462,462,60,10,50,2,1
43,468,468,43,43,0,1,0
10,498,498,9,9,0,1,0

8,109,109,34,18,16,2,1
18,110,110,5,1,4,2,1
5,112,112,1,1,0,1,0
11,114,114,29,29,0,1,0
24,120,120,8,8,0,1,0
4,122,122,1,1,0,1,0
1,125,125,13,13,0,1,0
23,138,138,10,10,0,1,0
7,155,155,1,1,0,1,0
25,162,162,6,6,0,1,0
12,168,168,35,35,0,1,0
29,189,189,63,63,0,1,0
27,189,189,36,32,4,2,1
15,195,195,22,22,0,1,0
31,207,207,45,37,8,3,2
19,208,208,18,4,14,2,1
9,245,245,61,61,0,1,0
20,252,252,38,4,34,3,2
28,257,257,3,3,0,1,0
35,277,277,1,1,0,1,0
16,284,284,8,2,6,2,1
3,292,292,6,1,5,2,1
17,302,302,16,6,10,3,2
30,303,303,5,5,0,1,0
2,313,313,21,21,0,1,0
33,334,334,30,30,0,1,0
36,352,352,8,8,0,1,0
34,360,360,16,13,3,2,1
26,371,371,55,1,54,3,2
13,420,420,16,16,0,1,0
6,421,421,1,1,0,1,0
32,426,426,125,27,98,3,2
0,428,428,96,96,0,1,0
22,446,446,41,21,20,2,1
21,459,459,32,32,0,1,0
10,498,498,5,5,0,1,0
14,500,500,174,140,34,2,1

42,102,102,8,8,0,1,0
29,153,153,5,1,4,2,1
17,155,155,9,9,0,1,0
9,161,161,10,10,0,1,0
18,173,173,7,4,3,2,1
3,181,181,12,12,0,1,0
21,183,183,4,4,0,1,0
35,187,187,21,21,0,1,0
26,188,188,45,45,0,1,0
39,188,188,15,10,5,2,1
37,189,189,5,2,3,2,1
24,194,194,18,18,0,1,0
12,196,196,11,11,0,1,0
11,198,198,11,5,6,2,1
33,208,208,74,74,0,1,0
41,213,213,3,3,0,1,0
16,224,224,1,1,0,1,0
40,238,238,46,28,18,3,2
27,240,240,6,6,0,1,0
36,265,265,18,11,7,2,1
23,270,270,9,1,8,3,2
31,270,270,50,50,0,1,0
28,273,273,1,1,0,1,0
22,306,306,11,11,0,1,0
10,312,312,38,38,0,1,0
32,325,325,16,2,14,4,3
7,326,326,56,40,16,2,1
43,348,348,4,4,0,1,0
25,351,351,80,47,33,2,1
34,358,358,25,7,18,4,3
5,362,362,29,5,24,4,3
30,372,372,21,21,0,1,0
19,392,392,97,89,8,3,2
4,393,393,33,3,30,4,3
2,394,394,10,10,0,1,0
44,404,404,55,7,48,3,2
6,409,409,144,75,69,4,3
14,444,444,35,16,19,2,1
20,447,447,35,16,19,2,1
13,447,447,18,18,0,1,0
0,452,452,22,22,0,1,0
38,459,459,37,37,0,1,0
8,464,464,1,1,0,1,0
1,480,480,23,8,15,4,3
15,487,487,46,14,32,3,2

34,112,112,11,1,10,2,1
0,115,115,9,9,0,1,0
30,132,132,13,2,11,2,1
13,136,136,2,2,0,1,0
26,162,162,54,6,48,4,3
6,169,169,4,4,0,1,0
3,171,171,10,10,0,1,0
12,174,174,36,11,25,2,1
5,185,185,14,8,6,3,2
17,199,199,53,26,27,4,3
38,225,225,19,3,16,3,2
1,227,227,19,19,0,1,0
35,237,237,6,2,4,2,1
20,259,259,7,7,0,1,0
36,278,278,9,9,0,1,0
32,296,296,32,32,0,1,0
22,309,309,48,30,18,3,2
33,317,317,40,40,0,1,0
9,324,324,2,2,0,1,0
15,331,331,48,41,7,2,1
24,334,334,41,41,0,1,0
8,359,359,9,3,6,3,2
37,364,364,9,9,0,1,0
14,372,372,119,97,22,3,2
23,389,389,7,1,6,2,1
18,398,398,39,3,36,2,1
25,413,413,12,4,8,2,1
28,420,420,97,97,0,1,0
11,436,436,63,63,0,1,0
31,440,440,91,27,64,3,2
10,441,441,65,2,63,4,3
2,444,444,11,3,8,3,2
16,445,445,108,108,0,1,0
21,453,453,31,31,0,1,0
4,455,455,10,4,6,3,2
19,465,465,66,66,0,1,0
29,466,466,37,37,0,1,0
27,491,491,14,14,0,1,0
7,491,491,9,1,8,2,1

24,109,109,4,4,0,1,0
17,123,123,1,1,0,1,0
43,133,133,19,1,18,2,1
14,146,146,8,8,0,1,0
11,176,176,6,3,3,2,1
23,187,187,6,6,0,1,0
4,188,188,23,5,18,4,3
39,196,196,6,6,0,1,0
15,208,208,26,26,0,1,0
41,221,221,30,30,0,1,0
5,227,227,7,7,0,1,0
42,227,227,12,12,0,1,0
32,228,228,6,6,0,1,0
16,237,237,34,18,16,3,2
2,247,247,1,1,0,1,0
8,265,265,7,1,6,3,2
38,265,265,36,36,0,1,0
33,265,265,44,8,36,2,1
22,266,266,25,20,5,2,1
27,272,272,8,8,0,1,0
34,302,302,15,5,10,3,2
3,317,317,8,8,0,1,0
10,325,325,57,57,0,1,0
28,335,335,5,5,0,1,0
29,335,335,149,26,123,4,3
1,348,348,14,14,0,1,0
20,359,359,7,1,6,3,2
21,361,361,150,108,42,3,2
31,389,389,40,40,0,1,0
25,394,394,39,39,0,1,0
35,400,400,35,11,24,3,2
26,401,401,75,17,58,3,2
12,404,404,29,29,0,1,0
36,410,410,53,14,39,2,1
9,415,415,48,6,42,4,3
6,424,424,4,4,0,1,0
40,427,427,32,14,18,2,1
19,435,435,11,11,0,1,0
30,445,445,22,22,0,1,0
7,448,448,48,48,0,1,0
18,471,471,81,75,6,2,1
13,476,476,52,52,0,1,0
37,479,479,22,22,0,1,0
0,495,495,20,5,15,4,3

12,104,104,10,10,0,1,0
29,111,111,4,4,0,1,0
34,123,123,8,5,3,2,1
14,160,160,14,2,12,4,3
21,169,169,39,39,0,1,0
35,176,176,30,30,0,1,0
5,178,178,3,3,0,1,0
10,186,186,78,22,56,4,3
1,188,188,4,4,0,1,0
33,198,198,59,17,42,4,3
32,200,200,24,9,15,4,3
15,215,215,45,14,31,3,2
9,223,223,17,11,6,2,1
20,231,231,30,30,0,1,0
17,259,259,7,7,0,1,0
27,264,264,3,3,0,1,0
8,269,269,40,40,0,1,0
4,270,270,35,3,32,2,1
26,299,299,2,2,0,1,0
13,301,301,48,48,0,1,0
16,332,332,20,20,0,1,0
23,360,360,15,10,5,2,1
0,366,366,22,22,0,1,0
3,367,367,41,41,0,1,0
6,381,381,57,57,0,1,0
2,391,391,2,2,0,1,0
31,394,394,25,15,10,2,1
22,408,408,27,8,19,2,1
30,416,416,81,13,68,3,2
24,426,426,50,11,39,4,3
19,427,427,70,50,20,2,1
11,427,427,100,36,64,3,2
36,439,439,23,23,0,1,0
7,439,439,7,3,4,2,1
28,457,457,18,1,17,2,1
25,476,476,8,1,7,2,1
18,497,497,96,6,90,3,2

3,116,116,7,1,6,2,1
15,117,117,7,7,0,1,0
18,139,139,4,4,0,1,0
1,149,149,22,22,0,1,0
32,196,196,67,60,7,2,1
20,198,198,7,7,0,1,0
0,199,199,34,19,15,2,1
35,208,208,17,3,14,3,2
23,215,215,6,6,0,1,0
34,221,221,3,3,0,1,0
40,222,222,26,11,15,2,1
31,225,225,9,3,6,3,2
2,241,241,14,14,0,1,0
22,251,251,44,44,0,1,0
13,257,257,12,4,8,3,2
9,274,274,15,1,14,3,2
24,284,284,14,2,12,4,3
12,297,297,5,5,0,1,0
4,303,303,17,5,12,4,3
28,320,320,29,29,0,1,0
7,325,325,23,23,0,1,0
5,341,341,22,1,21,2,1
30,354,354,10,2,8,3,2
38,365,365,10,10,0,1,0
14,369,369,10,5,5,2,1
17,374,374,117,117,0,1,0
19,375,375,36,36,0,1,0
29,385,385,2,2,0,1,0
26,386,386,47,36,11,2,1
39,401,401,53,3,50,2,1
44,405,405,51,51,0,1,0
21,411,411,28,28,0,1,0
43,438,438,27,7,20,2,1
33,441,441,42,42,0,1,0
11,445,445,51,51,0,1,0
6,449,449,51,18,33,4,3
42,451,451,82,42,40,3,2
8,461,461,11,5,6,2,1
27,466,466,136,109,27,2,1
16,469,469,31,13,18,3,2
41,469,469,69,23,46,3,2
37,470,470,53,6,47,2,1
25,479,479,4,4,0,1,0
10,483,483,28,28,0,1,0
36,484,484,5,5,0,1,0

36,101,101,6,6,0,1,0
6,107,107,38,38,0,1,0
31,155,155,2,2,0,1,0
12,156,156,48,48,0,1,0
35,161,161,24,24,0,1,0
17,166,166,2,2,0,1,0
26,167,167,52,52,0,1,0
9,170,170,6,2,4,2,1
25,181,181,14,14,0,1,0
37,191,191,47,9,38,3,2
29,212,212,1,1,0,1,0
30,218,218,15,11,4,2,1
33,221,221,4,4,0,1,0
19,227,227,6,2,4,2,1
11,234,234,17,17,0,1,0
34,238,238,3,3,0,1,0
3,249,249,5,5,0,1,0
15,250,250,3,3,0,1,0
38,255,255,23,20,3,2,1
21,263,263,33,33,0,1,0
14,273,273,17,7,10,2,1
32,275,275,27,12,15,2,1
5,279,279,1,1,0,1,0
13,294,294,1,1,0,1,0
0,314,314,23,11,12,2,1
1,321,321,17,17,0,1,0
20,356,356,33,18,15,4,3
18,360,360,163,126,37,4,3
8,361,361,38,20,18,4,3
10,381,381,60,40,20,2,1
28,385,385,58,51,7,2,1
16,386,386,7,3,4,2,1
22,387,387,31,13,18,4,3
7,422,422,67,67,0,1,0
2,436,436,14,14,0,1,0
24,441,441,110,42,68,3,2
4,442,442,30,30,0,1,0
27,466,466,57,13,44,3,2
23,466,466,19,11,8,3,2

13,103,103,12,12,0,1,0
24,110,110,9,9,0,1,0
31,139,139,39,29,10,3,2
25,180,180,11,11,0,1,0
32,182,182,38,38,0,1,0
15,185,185,20,12,8,3,2
9,219,219,29,29,0,1,0
23,225,225,13,1,12,2,1
28,232,232,15,15,0,1,0
22,252,252,34,34,0,1,0
17,258,258,13,13,0,1,0
6,287,287,8,8,0,1,0
0,298,298,91,91,0,1,0
26,301,301,65,65,0,1,0
14,322,322,22,13,9,2,1
29,330,330,6,6,0,1,0
18,345,345,25,14,11,3,2
12,357,357,100,2,98,3,2
21,388,388,16,16,0,1,0
19,399,399,4,4,0,1,0
8,405,405,71,7,64,4,3
4,407,407,54,54,0,1,0
7,438,438,15,15,0,1,0
5,443,443,58,37,21,2,1
1,445,445,88,76,12,2,1
30,451,451,17,17,0,1,0
2,454,454,46,46,0,1,0
10,469,469,2,2,0,1,0
16,474,474,36,4,32,2,1
11,481,481,78,78,0,1,0
3,481,481,152,81,71,4,3
27,497,497,153,9,144,4,3
20,498,498,19,19,0,1,0

24,100,100,6,3,3,2,1
29,101,101,1,1,0,1,0
0,137,137,1,1,0,1,0
30,138,138,6,6,0,1,0
5,150,150,11,5,6,2,1
31,150,150,20,8,12,3,2
17,160,160,17,17,0,1,0
16,168,168,15,3,12,4,3
27,171,171,3,3,0,1,0
25,173,173,29,13,16,3,2
19,186,186,26,6,20,2,1
38,200,200,1,1,0,1,0
33,200,200,14,14,0,1,0
9,204,204,9,9,0,1,0
20,228,228,12,6,6,2,1
7,229,229,11,2,9,2,1
14,235,235,12,12,0,1,0
1,258,258,15,15,0,1,0
18,277,277,42,42,0,1,0
6,295,295,67,19,48,4,3
34,303,303,8,5,3,2,1
35,304,304,18,1,17,2,1
26,315,315,11,4,7,2,1
2,315,315,26,14,12,4,3
36,323,323,22,22,0,1,0
4,332,332,34,34,0,1,0
13,334,334,27,17,10,2,1
39,364,364,145,139,6,2,1
11,370,370,13,13,0,1,0
12,406,406,72,72,0,1,0
15,436,436,35,35,0,1,0
10,443,443,74,49,25,3,2
32,447,447,37,37,0,1,0
28,459,459,102,18,84,3,2
8,470,470,31,21,10,3,2
21,473,473,79,79,0,1,0
22,480,480,170,152,18,3,2
3,492,492,106,106,0,1,0
37,496,496,24,24,0,1,0
23,498,498,19,19,0,1,0

20,112,112,14,14,0,1,0
30,128,128,8,2,6,2,1
33,140,140,3,3,0,1,0
28,146,146,33,33,0,1,0
2,164,164,4,4,0,1,0
37,166,166,5,5,0,1,0
36,172,172,1,1,0,1,0
32,176,176,2,2,0,1,0
14,182,182,5,1,4,2,1
35,185,185,17,17,0,1,0
15,194,194,5,5,0,1,0
16,200,200,3,3,0,1,0
24,201,201,2,2,0,1,0
4,209,209,17,17,0,1,0
13,211,211,30,30,0,1,0
31,217,217,11,11,0,1,0
26,224,224,2,2,0,1,0
8,228,228,104,104,0,1,0
5,236,236,59,17,42,2,1
9,240,240,48,48,0,1,0
3,279,279,28,11,17,2,1
25,280,280,80,29,51,4,3
34,284,284,3,3,0,1,0
11,297,297,18,18,0,1,0
22,298,298,123,105,18,3,2
38,332,332,95,95,0,1,0
21,353,353,33,26,7,2,1
1,355,355,34,34,0,1,0
18,365,365,5,5,0,1,0
29,377,377,37,10,27,4,3
7,404,404,30,30,0,1,0
23,423,423,10,10,0,1,0
6,424,424,48,39,9,2,1
19,442,442,73,10,63,3,2
10,453,453,9,9,0,1,0
27,456,456,18,18,0,1,0
17,479,479,30,22,8,3,2
0,487,487,32,32,0,1,0
12,497,497,86,44,42,2,1

14,103,103,8,8,0,1,0
4,104,104,12,12,0,1,0
9,108,108,1,1,0,1,0
1,110,110,3,3,0,1,0
25,112,112,7,7,0,1,0
5,117,117,27,1,26,2,1
36,119,119,62,42,20,2,1
15,134,134,9,3,6,2,1
30,135,135,12,12,0,1,0
21,141,141,11,11,0,1,0
26,161,161,8,1,7,2,1
18,190,190,2,2,0,1,0
8,198,198,30,20,10,3,2
37,202,202,45,41,4,2,1
11,204,204,25,12,13,2,1
27,227,227,10,10,0,1,0
0,247,247,64,64,0,1,0
39,267,267,41,5,36,3,2
29,276,276,31,31,0,1,0
32,277,277,42,42,0,1,0
12,278,278,20,20,0,1,0
31,280,280,8,4,4,2,1
33,292,292,5,5,0,1,0
19,316,316,39,9,30,3,2
2,316,316,54,13,41,2,1
17,323,323,10,10,0,1,0
22,329,329,46,46,0,1,0
24,344,344,5,5,0,1,0
3,367,367,22,4,18,3,2
7,374,374,66,66,0,1,0
28,379,379,26,26,0,1,0
13,390,390,61,61,0,1,0
20,405,405,3,3,0,1,0
38,409,409,22,22,0,1,0
6,434,434,37,37,0,1,0
23,444,444,37,27,10,2,1
34,445,445,38,38,0,1,0
10,457,457,21,12,9,4,3
16,487,487,4,4,0,1,0
35,490,490,29,29,0,1,0

1,122,122,20,20,0,1,0
31,138,138,23,12,11,2,1
14,139,139,2,2,0,1,0
10,143,143,18,18,0,1,0
4,145,145,21,6,15,4,3
26,157,157,5,5,0,1,0
21,170,170,4,1,3,2,1
16,172,172,35,35,0,1,0
34,176,176,5,5,0,1,0
11,179,179,10,10,0,1,0
37,189,189,3,3,0,1,0
7,203,203,4,4,0,1,0
35,245,245,38,20,18,4,3
13,258,258,4,1,3,2,1
41,259,259,4,4,0,1,0
39,293,293,35,7,28,4,3
28,310,310,2,2,0,1,0
20,316,316,21,21,0,1,0
3,321,321,60,45,15,4,3
8,323,323,21,21,0,1,0
9,332,332,2,2,0,1,0
2,341,341,17,8,9,4,3
12,342,342,50,28,22,2,1
32,346,346,42,1,41,3,2
6,354,354,5,2,3,2,1
30,357,357,52,52,0,1,0
33,375,375,3,3,0,1,0
15,376,376,40,40,0,1,0
22,379,379,24,7,17,2,1
19,380,380,41,41,0,1,0
42,383,383,8,8,0,1,0
29,383,383,17,12,5,2,1
40,399,399,7,7,0,1,0
17,399,399,2,2,0,1,0
27,412,412,42,42,0,1,0
24,415,415,93,79,14,2,1
25,417,417,87,87,0,1,0
23,423,423,12,2,10,3,2
36,487,487,5,5,0,1,0
38,494,494,278,185,93,4,3
5,497,497,96,84,12,2,1
18,499,499,98,29,69,4,3
0,499,499,14,4,10,3,2

4,101,101,3,3,0,1,0
3,105,105,2,2,0,1,0
21,112,112,1,1,0,1,0
35,117,117,16,5,11,2,1
19,118,118,4,1,3,2,1
45,120,120,23,13,10,2,1
43,145,145,10,10,0,1,0
39,148,148,9,9,0,1,0
23,155,155,1,1,0,1,0
16,164,164,12,2,10,3,2
31,165,165,4,4,0,1,0
48,169,169,6,1,5,2,1
8,171,171,2,2,0,1,0
50,173,173,13,2,11,2,1
32,178,178,13,13,0,1,0
37,179,179,51,8,43,2,1
54,185,185,21,21,0,1,0
36,195,195,5,5,0,1,0
22,202,202,3,3,0,1,0
47,226,226,26,6,20,3,2
24,231,231,46,22,24,4,3
51,238,238,5,5,0,1,0
46,239,239,4,1,3,2,1
14,242,242,20,20,0,1,0
10,258,258,4,4,0,1,0
44,265,265,109,89,20,4,3
53,270,270,16,1,15,3,2
5,272,272,30,30,0,1,0
42,279,279,35,35,0,1,0
49,305,305,4,4,0,1,0
6,306,306,1,1,0,1,0
7,310,310,6,2,4,2,1
30,312,312,13,7,6,3,2
15,316,316,21,21,0,1,0
38,326,326,5,5,0,1,0
20,328,328,44,44,0,1,0
0,335,335,14,14,0,1,0
18,346,346,37,37,0,1,0
27,350,350,34,6,28,3,2
33,382,382,6,6,0,1,0
40,398,398,34,34,0,1,0
9,404,404,12,7,5,2,1
12,409,409,23,3,20,2,1
29,411,411,60,60,0,1,0
2,423,423,16,16,0,1,0
52,433,433,23,5,18,4,3
1,443,443,26,8,18,4,3
34,447,447,28,13,15,3,2
13,449,449,2,2,0,1,0
25,480,480,39,39,0,1,0
41,482,482,62,5,57,4,3
17,488,488,80,72,8,2,1
26,491,491,4,4,0,1,0
11,491,491,38,38,0,1,0
28,497,497,23,11,12,4,3

34,101,101,8,8,0,1,0
21,114,114,1,1,0,1,0
7,127,127,12,12,0,1,0
28,161,161,3,3,0,1,0
20,165,165,8,8,0,1,0
33,167,167,72,38,34,2,1
10,179,179,32,19,13,2,1
6,192,192,32,32,0,1,0
3,208,208,26,10,16,2,1
30,226,226,90,8,82,4,3
25,226,226,14,5,9,4,3
2,244,244,12,4,8,2,1
16,245,245,7,7,0,1,0
4,262,262,22,4,18,3,2
22,271,271,34,10,24,3,2
29,275,275,43,1,42,2,1
15,287,287,71,31,40,2,1
27,296,296,12,12,0,1,0
9,299,299,117,64,53,4,3
19,309,309,21,5,16,3,2
13,314,314,74,74,0,1,0
8,316,316,6,6,0,1,0
17,319,319,4,4,0,1,0
0,333,333,18,18,0,1,0
35,386,386,61,13,48,2,1
32,391,391,7,7,0,1,0
18,395,395,80,40,40,3,2
11,410,410,33,13,20,2,1
14,427,427,46,4,42,2,1
31,429,429,20,6,14,3,2
23,436,436,18,5,13,4,3
12,441,441,10,10,0,1,0
1,464,464,39,28,11,2,1
24,472,472,35,35,0,1,0
26,483,483,10,10,0,1,0
5,493,493,30,30,0,1,0

34,105,105,4,4,0,1,0
21,111,111,20,20,0,1,0
33,114,114,27,18,9,2,1
5,115,115,8,4,4,2,1
35,137,137,4,1,3,2,1
11,150,150,24,24,0,1,0
8,177,177,18,18,0,1,0
16,193,193,9,2,7,2,1
13,223,223,14,14,0,1,0
12,226,226,6,2,4,2,1
20,235,235,118,16,102,4,3
0,236,236,12,12,0,1,0
30,259,259,7,7,0,1,0
23,279,279,38,38,0,1,0
10,300,300,47,29,18,2,1
17,313,313,167,158,9,4,3
22,313,313,11,8,3,2,1
31,314,314,42,42,0,1,0
28,315,315,6,1,5,2,1
38,323,323,11,3,8,3,2
15,325,325,20,20,0,1,0
36,326,326,30,10,20,2,1
32,352,352,128,39,89,4,3
9,360,360,14,14,0,1,0
18,362,362,9,9,0,1,0
25,366,366,4,4,0,1,0
29,371,371,28,21,7,2,1
24,378,378,2,2,0,1,0
6,399,399,8,8,0,1,0
7,415,415,11,11,0,1,0
27,419,419,1,1,0,1,0
1,420,420,9,9,0,1,0
2,422,422,6,1,5,2,1
3,427,427,113,40,73,4,3
4,441,441,3,3,0,1,0
37,456,456,3,3,0,1,0
19,477,477,23,20,3,2,1
14,482,482,128,61,67,3,2
39,484,484,7,1,6,3,2
26,496,496,48,45,3,2,1

43,141,141,8,1,7,2,1
2,145,145,9,6,3,2,1
41,145,145,19,19,0,1,0
18,154,154,5,5,0,1,0
13,158,158,41,11,30,2,1
26,162,162,34,34,0,1,0
3,167,167,21,21,0,1,0
17,178,178,1,1,0,1,0
20,178,178,8,4,4,2,1
0,185,185,9,9,0,1,0
23,187,187,8,8,0,1,0
42,193,193,21,21,0,1,0
8,210,210,1,1,0,1,0
32,211,211,5,5,0,1,0
4,215,215,14,14,0,1,0
7,229,229,12,12,0,1,0
6,235,235,53,53,0,1,0
12,235,235,9,1,8,3,2
29,240,240,2,2,0,1,0
34,249,249,17,17,0,1,0
11,259,259,66,66,0,1,0
24,273,273,53,5,48,4,3
5,273,273,38,15,23,3,2
31,276,276,116,50,66,4,3
16,319,319,41,41,0,1,0
1,322,322,21,16,5,2,1
33,327,327,29,17,12,4,3
15,358,358,3,3,0,1,0
37,377,377,28,28,0,1,0
10,383,383,1,1,0,1,0
21,390,390,23,17,6,3,2
28,391,391,21,9,12,3,2
19,395,395,19,19,0,1,0
27,402,402,45,26,19,2,1
14,407,407,8,8,0,1,0
35,415,415,47,31,16,2,1
38,418,418,14,14,0,1,0
36,427,427,37,37,0,1,0
39,428,428,5,1,4,2,1
30,460,460,29,14,15,4,3
9,471,471,13,2,11,2,1
25,476,476,40,29,11,2,1
40,485,485,44,26,18,4,3
22,499,499,121,48,73,3,2

9,100,100,15,15,0,1,0
35,104,104,4,4,0,1,0
15,123,123,54,26,28,2,1
0,127,127,54,47,7,2,1
11,133,133,12,12,0,1,0
13,134,134,13,13,0,1,0
16,164,164,9,9,0,1,0
21,173,173,24,24,0,1,0
14,182,182,9,9,0,1,0
33,184,184,54,54,0,1,0
22,188,188,29,29,0,1,0
10,188,188,32,22,10,3,2
18,189,189,17,17,0,1,0
12,226,226,2,2,0,1,0
1,236,236,1,1,0,1,0
7,244,244,52,52,0,1,0
17,244,244,41,41,0,1,0
25,281,281,69,69,0,1,0
29,312,312,15,15,0,1,0
30,313,313,23,9,14,3,2
20,316,316,30,24,6,3,2
28,327,327,5,1,4,2,1
31,340,340,2,2,0,1,0
34,371,371,19,19,0,1,0
8,371,371,13,2,11,2,1
6,376,376,1,1,0,1,0
32,384,384,14,2,12,4,3
19,392,392,20,8,12,4,3
3,409,409,41,23,18,3,2
26,416,416,142,61,81,4,3
24,428,428,2,2,0,1,0
2,437,437,73,65,8,2,1
5,441,441,22,22,0,1,0
4,442,442,1,1,0,1,0
23,463,463,10,10,0,1,0
27,483,483,53,44,9,2,1

10,102,102,1,1,0,1,0
32,140,140,47,20,27,2,1
6,157,157,29,4,25,3,2
11,164,164,1,1,0,1,0
8,177,177,7,1,6,2,1
22,180,180,25,15,10,2,1
30,183,183,7,7,0,1,0
31,189,189,16,16,0,1,0
3,189,189,88,88,0,1,0
17,205,205,12,12,0,1,0
5,212,212,17,17,0,1,0
28,217,217,28,5,23,4,3
7,221,221,43,23,20,3,2
16,250,250,17,17,0,1,0
35,263,263,2,2,0,1,0
36,276,276,51,27,24,2,1
9,331,331,26,26,0,1,0
27,335,335,23,5,18,4,3
13,353,353,4,4,0,1,0
14,353,353,27,27,0,1,0
29,362,362,1,1,0,1,0
4,369,369,48,48,0,1,0
38,371,371,11,11,0,1,0
21,371,371,3,3,0,1,0
19,375,375,18,4,14,3,2
34,376,376,12,7,5,2,1
2,381,381,61,22,39,4,3
24,386,386,1,1,0,1,0
0,397,397,28,28,0,1,0
15,400,400,33,11,22,3,2
23,408,408,25,25,0,1,0
25,408,408,46,46,0,1,0
1,421,421,14,11,3,2,1
37,429,429,77,77,0,1,0
12,439,439,61,7,54,4,3
33,465,465,32,32,0,1,0
20,472,472,52,52,0,1,0
26,488,488,191,107,84,4,3
18,499,499,56,49,7,2,1

14,113,113,8,8,0,1,0
13,115,115,45,45,0,1,0
20,118,118,2,2,0,1,0
0,124,124,3,3,0,1,0
8,133,133,14,14,0,1,0
17,167,167,14,4,10,3,2
31,170,170,4,4,0,1,0
15,180,180,8,8,0,1,0
26,188,188,58,30,28,4,3
35,192,192,62,10,52,3,2
30,197,197,14,14,0,1,0
33,220,220,46,20,26,2,1
11,223,223,22,22,0,1,0
24,233,233,12,12,0,1,0
36,247,247,13,4,9,4,3
4,250,250,18,18,0,1,0
22,278,278,46,46,0,1,0
6,280,280,16,16,0,1,0
12,281,281,25,16,9,4,3
5,282,282,59,59,0,1,0
16,288,288,41,6,35,2,1
19,295,295,33,33,0,1,0
18,308,308,18,6,12,4,3
28,308,308,4,4,0,1,0
2,316,316,165,53,112,4,3
9,325,325,1,1,0,1,0
32,338,338,9,9,0,1,0
25,341,341,63,63,0,1,0
27,370,370,11,8,3,2,1
23,420,420,26,8,18,4,3
3,423,423,30,7,23,2,1
29,426,426,60,17,43,3,2
1,433,433,24,24,0,1,0
34,436,436,23,23,0,1,0
21,478,478,25,3,22,3,2
10,489,489,20,20,0,1,0
7,496,496,3,3,0,1,0

34,109,109,9,3,6,2,1
3,124,124,14,3,11,4,3
23,138,138,4,4,0,1,0
32,140,140,6,6,0,1,0
21,143,143,28,28,0,1,0
7,160,160,3,3,0,1,0
0,169,169,3,3,0,1,0
14,176,176,44,44,0,1,0
11,187,187,19,19,0,1,0
31,190,190,21,21,0,1,0
2,191,191,1,1,0,1,0
44,197,197,47,12,35,2,1
39,218,218,14,2,12,3,2
16,241,241,16,6,10,3,2
28,243,243,1,1,0,1,0
35,247,247,43,1,42,2,1
5,250,250,20,20,0,1,0
36,254,254,18,3,15,4,3
25,262,262,52,31,21,2,1
20,265,265,44,44,0,1,0
15,267,267,14,14,0,1,0
13,286,286,48,48,0,1,0
24,295,295,28,28,0,1,0
41,300,300,4,4,0,1,0
33,317,317,37,37,0,1,0
19,321,321,36,36,0,1,0
10,323,323,32,32,0,1,0
12,344,344,27,27,0,1,0
38,366,366,3,3,0,1,0
8,371,371,14,14,0,1,0
4,388,388,60,7,53,3,2
1,405,405,19,19,0,1,0
6,420,420,12,4,8,3,2
26,425,425,115,115,0,1,0
17,432,432,4,4,0,1,0
18,433,433,1,1,0,1,0
22,437,437,10,7,3,2,1
40,440,440,10,10,0,1,0
42,440,440,61,61,0,1,0
37,457,457,72,72,0,1,0
27,460,460,84,61,23,2,1
30,461,461,11,11,0,1,0
29,471,471,26,26,0,1,0
43,475,475,27,12,15,2,1
9,483,483,24,14,10,3,2

15,105,105,4,4,0,1,0
29,115,115,3,3,0,1,0
2,118,118,5,2,3,2,1
1,125,125,6,6,0,1,0
20,140,140,10,10,0,1,0
40,145,145,22,2,20,3,2
5,147,147,22,22,0,1,0
4,149,149,8,2,6,2,1
17,168,168,1,1,0,1,0
35,175,175,43,43,0,1,0
9,195,195,14,14,0,1,0
12,203,203,10,7,3,2,1
32,206,206,4,1,3,2,1
22,244,244,22,3,19,2,1
30,288,288,12,1,11,2,1
18,301,301,22,22,0,1,0
16,311,311,72,68,4,2,1
11,321,321,58,43,15,4,3
42,327,327,15,1,14,3,2
26,330,330,6,6,0,1,0
6,334,334,30,30,0,1,0
31,350,350,18,18,0,1,0
39,352,352,28,28,0,1,0
0,363,363,7,7,0,1,0
3,373,373,46,46,0,1,0
36,385,385,59,59,0,1,0
34,386,386,7,7,0,1,0
28,388,388,3,3,0,1,0
33,398,398,3,3,0,1,0
13,402,402,44,19,25,2,1
10,410,410,43,43,0,1,0
19,414,414,76,14,62,3,2
7,420,420,60,60,0,1,0
41,422,422,39,9,30,4,3
21,423,423,17,17,0,1,0
38,423,423,15,15,0,1,0
23,433,433,1,1,0,1,0
25,452,452,15,15,0,1,0
43,458,458,47,41,6,3,2
24,465,465,117,117,0,1,0
27,472,472,104,50,54,4,3
37,478,478,207,171,36,2,1
8,499,499,12,12,0,1,0
14,500,500,28,28,0,1,0

8,111,111,9,9,0,1,0
36,120,120,6,2,4,2,1
21,129,129,29,29,0,1,0
15,171,171,14,10,4,2,1
38,179,179,23,12,11,2,1
6,185,185,70,33,37,2,1
5,194,194,18,18,0,1,0
2,202,202,9,9,0,1,0
22,203,203,16,16,0,1,0
10,210,210,20,6,14,2,1
3,220,220,32,32,0,1,0
19,222,222,19,19,0,1,0
23,223,223,6,6,0,1,0
20,224,224,22,5,17,4,3
4,231,231,26,1,25,4,3
18,249,249,1,1,0,1,0
9,250,250,24,12,12,2,1
17,264,264,13,10,3,2,1
26,273,273,15,9,6,3,2
27,288,288,61,18,43,2,1
39,317,317,39,39,0,1,0
35,324,324,26,15,11,2,1
32,328,328,52,52,0,1,0
31,333,333,4,1,3,2,1
34,351,351,57,24,33,4,3
13,360,360,1,1,0,1,0
29,380,380,31,18,13,2,1
30,392,392,26,26,0,1,0
11,419,419,39,39,0,1,0
14,427,427,35,35,0,1,0
1,442,442,30,30,0,1,0
7,442,442,60,38,22,3,2
0,451,451,87,23,64,4,3
24,453,453,17,12,5,2,1
37,467,467,24,17,7,2,1
28,469,469,1,1,0,1,0
16,474,474,24,4,20,2,1
33,485,485,31,31,0,1,0
25,487,487,156,156,0,1,0
12,498,498,56,56,0,1,0

10,126,126,24,4,20,3,2
16,137,137,20,20,0,1,0
13,140,140,19,2,17,3,2
29,180,180,21,21,0,1,0
11,187,187,7,7,0,1,0
30,187,187,2,2,0,1,0
0,189,189,1,1,0,1,0
27,213,213,2,2,0,1,0
1,217,217,53,53,0,1,0
23,236,236,4,4,0,1,0
25,240,240,11,2,9,4,3
19,258,258,34,34,0,1,0
8,266,266,118,83,35,2,1
22,276,276,39,16,23,2,1
7,294,294,42,42,0,1,0
3,312,312,36,6,30,2,1
21,313,313,35,30,5,2,1
31,338,338,1,1,0,1,0
12,391,391,7,7,0,1,0
18,398,398,40,40,0,1,0
20,417,417,47,9,38,2,1
28,420,420,22,14,8,2,1
5,421,421,42,42,0,1,0
4,435,435,43,43,0,1,0
24,438,438,60,60,0,1,0
9,438,438,105,62,43,2,1
17,445,445,131,24,107,4,3
2,447,447,55,3,52,3,2
26,456,456,20,7,13,2,1
14,463,463,172,143,29,2,1
6,492,492,129,21,108,4,3
15,493,493,17,1,16,2,1

19,106,106,33,9,24,3,2
7,108,108,11,11,0,1,0
34,110,110,3,3,0,1,0
6,110,110,1,1,0,1,0
37,129,129,13,6,7,2,1
27,131,131,1,1,0,1,0
9,132,132,14,14,0,1,0
33,141,141,19,4,15,4,3
28,151,151,13,13,0,1,0
42,165,165,18,18,0,1,0
36,167,167,7,7,0,1,0
22,184,184,12,3,9,4,3
30,188,188,23,23,0,1,0
3,205,205,10,10,0,1,0
2,220,220,2,2,0,1,0
41,229,229,15,11,4,2,1
35,237,237,12,12,0,1,0
8,251,251,8,8,0,1,0
38,256,256,76,76,0,1,0
18,259,259,6,6,0,1,0
17,268,268,8,8,0,1,0
31,270,270,26,15,11,2,1
11,273,273,15,6,9,4,3
21,284,284,31,16,15,2,1
32,295,295,38,29,9,4,3
39,306,306,72,20,52,3,2
26,308,308,23,23,0,1,0
24,312,312,21,21,0,1,0
0,323,323,23,23,0,1,0
29,328,328,61,61,0,1,0
1,330,330,27,27,0,1,0
12,338,338,11,3,8,3,2
4,350,350,67,58,9,4,3
25,373,373,4,4,0,1,0
13,374,374,62,62,0,1,0
40,383,383,53,38,15,4,3
23,409,409,29,29,0,1,0
20,414,414,30,2,28,2,1
16,418,418,31,31,0,1,0
14,466,466,108,76,32,3,2
10,482,482,44,15,29,2,1
5,494,494,37,10,27,2,1
15,500,500,7,2,5,2,1

25,123,123,5,5,0,1,0
30,126,126,2,2,0,1,0
9,130,130,3,3,0,1,0
0,132,132,52,36,16,3,2
11,151,151,2,2,0,1,0
14,154,154,29,29,0,1,0
19,175,175,39,39,0,1,0
32,177,177,1,1,0,1,0
10,190,190,30,30,0,1,0
18,197,197,6,6,0,1,0
34,200,200,1,1,0,1,0
2,201,201,19,8,11,2,1
31,203,203,14,14,0,1,0
23,218,218,50,50,0,1,0
24,248,248,32,5,27,2,1
16,268,268,104,62,42,2,1
21,287,287,16,16,0,1,0
35,288,288,9,3,6,2,1
33,296,296,13,13,0,1,0
17,298,298,23,23,0,1,0
22,320,320,97,97,0,1,0
6,335,335,11,1,10,2,1
12,346,346,40,22,18,2,1
20,356,356,24,24,0,1,0
3,368,368,48,11,37,4,3
4,368,368,1,1,0,1,0
27,369,369,37,37,0,1,0
13,369,369,52,52,0,1,0
15,373,373,9,9,0,1,0
26,376,376,96,96,0,1,0
1,403,403,1,1,0,1,0
28,406,406,22,11,11,2,1
8,412,412,10,10,0,1,0
29,421,421,64,4,60,3,2
5,464,464,76,76,0,1,0
36,479,479,75,33,42,2,1
37,480,480,34,1,33,4,3
7,482,482,14,14,0,1,0

8,100,100,22,6,16,3,2
43,114,114,1,1,0,1,0
1,125,125,4,4,0,1,0
39,168,168,24,24,0,1,0
30,168,168,24,7,17,2,1
19,176,176,26,6,20,2,1
45,181,181,32,17,15,2,1
38,184,184,1,1,0,1,0
26,191,191,5,5,0,1,0
20,206,206,6,6,0,1,0
4,210,210,1,1,0,1,0
32,228,228,41,10,31,4,3
27,230,230,8,3,5,2,1
7,232,232,10,10,0,1,0
44,235,235,10,6,4,2,1
22,267,267,9,4,5,2,1
40,277,277,2,2,0,1,0
36,277,277,79,58,21,2,1
25,283,283,5,5,0,1,0
35,301,301,5,5,0,1,0
14,305,305,2,2,0,1,0
28,314,314,73,27,46,3,2
6,321,321,3,3,0,1,0
11,323,323,10,3,7,2,1
5,327,327,52,9,43,3,2
13,327,327,1,1,0,1,0
24,344,344,1,1,0,1,0
29,349,349,70,70,0,1,0
15,359,359,63,63,0,1,0
33,361,361,44,44,0,1,0
42,363,363,76,52,24,3,2
31,369,369,27,27,0,1,0
0,382,382,22,22,0,1,0
12,387,387,68,62,6,3,2
17,393,393,7,7,0,1,0
23,404,404,148,34,114,4,3
9,417,417,20,6,14,2,1
16,426,426,26,18,8,2,1
41,428,428,33,33,0,1,0
34,429,429,16,16,0,1,0
18,443,443,42,42,0,1,0
2,467,467,82,82,0,1,0
10,468,468,1,1,0,1,0
37,470,470,13,13,0,1,0
3,486,486,2,2,0,1,0
21,495,495,42,15,27,2,1

43,130,130,4,4,0,1,0
21,143,143,7,7,0,1,0
8,153,153,12,2,10,2,1
4,162,162,59,43,16,3,2
22,162,162,4,4,0,1,0
17,163,163,1,1,0,1,0
10,165,165,13,3,10,3,2
14,169,169,6,1,5,2,1
37,171,171,3,3,0,1,0
40,172,172,7,7,0,1,0
9,175,175,6,6,0,1,0
0,181,181,2,2,0,1,0
3,186,186,5,1,4,2,1
32,205,205,35,1,34,2,1
30,205,205,28,28,0,1,0
23,220,220,15,5,10,3,2
24,227,227,3,3,0,1,0
29,231,231,67,61,6,2,1
28,234,234,54,30,24,2,1
25,244,244,3,3,0,1,0
38,257,257,27,15,12,4,3
31,284,284,20,20,0,1,0
27,291,291,8,3,5,2,1
41,296,296,10,10,0,1,0
33,313,313,11,1,10,3,2
7,315,315,20,20,0,1,0
26,326,326,50,5,45,4,3
36,330,330,53,22,31,2,1
20,349,349,6,6,0,1,0
12,362,362,62,36,26,2,1
19,384,384,61,61,0,1,0
11,410,410,4,4,0,1,0
15,424,424,68,27,41,2,1
2,428,428,24,19,5,2,1
13,443,443,19,13,6,3,2
5,445,445,28,28,0,1,0
34,448,448,68,4,64,3,2
1,449,449,45,45,0,1,0
16,458,458,11,7,4,2,1
6,464,464,9,1,8,3,2
42,475,475,30,30,0,1,0
35,485,485,107,60,47,2,1
18,493,493,166,166,0,1,0
39,499,499,36,31,5,2,1

2,102,102,1,1,0,1,0
0,106,106,10,10,0,1,0
48,117,117,9,9,0,1,0
29,118,118,40,40,0,1,0
30,121,121,13,1,12,2,1
44,127,127,8,8,0,1,0
36,139,139,2,2,0,1,0
1,141,141,7,7,0,1,0
11,148,148,2,2,0,1,0
19,149,149,19,5,14,3,2
45,174,174,42,6,36,4,3
25,175,175,3,3,0,1,0
49,180,180,16,16,0,1,0
37,186,186,14,7,7,2,1
31,202,202,35,15,20,3,2
13,229,229,1,1,0,1,0
4,239,239,52,1,51,4,3
8,247,247,6,6,0,1,0
21,251,251,12,5,7,2,1
15,256,256,3,3,0,1,0
47,263,263,21,17,4,2,1
26,266,266,1,1,0,1,0
34,280,280,28,5,23,2,1
43,281,281,3,3,0,1,0
6,287,287,21,21,0,1,0
12,295,295,27,1,26,3,2
28,300,300,32,24,8,3,2
27,337,337,36,36,0,1,0
35,337,337,135,95,40,2,1
22,343,343,13,4,9,4,3
20,345,345,2,2,0,1,0
38,371,371,25,6,19,2,1
14,386,386,7,7,0,1,0
40,389,389,2,2,0,1,0
41,399,399,4,4,0,1,0
7,399,399,5,5,0,1,0
33,408,408,16,6,10,3,2
5,412,412,26,10,16,2,1
10,416,416,46,46,0,1,0
3,417,417,20,1,19,2,1
24,419,419,43,20,23,2,1
46,422,422,40,10,30,4,3
39,438,438,48,38,10,3,2
17,446,446,39,30,9,4,3
42,450,450,78,30,48,4,3
16,454,454,5,5,0,1,0
9,462,462,20,20,0,1,0
18,471,471,56,20,36,4,3
23,485,485,4,4,0,1,0
32,493,493,58,23,35,4,3

32,117,117,11,11,0,1,0
37,124,124,6,6,0,1,0
21,132,132,17,7,10,2,1
9,143,143,11,2,9,4,3
26,163,163,1,1,0,1,0
39,171,171,51,51,0,1,0
20,204,204,12,12,0,1,0
13,205,205,5,5,0,1,0
0,220,220,52,52,0,1,0
1,223,223,22,22,0,1,0
16,225,225,12,3,9,4,3
15,238,238,33,33,0,1,0
2,252,252,8,8,0,1,0
38,259,259,23,8,15,2,1
23,264,264,14,14,0,1,0
28,270,270,23,23,0,1,0
8,281,281,18,18,0,1,0
30,284,284,58,50,8,2,1
31,297,297,27,27,0,1,0
19,321,321,2,2,0,1,0
35,343,343,34,10,24,3,2
12,343,343,66,66,0,1,0
34,360,360,11,8,3,2,1
3,372,372,11,11,0,1,0
24,378,378,134,108,26,2,1
33,378,378,16,9,7,2,1
29,385,385,17,17,0,1,0
17,392,392,6,6,0,1,0
22,393,393,92,92,0,1,0
25,394,394,6,6,0,1,0
18,413,413,8,2,6,2,1
7,415,415,32,1,31,2,1
5,420,420,31,31,0,1,0
40,421,421,44,32,12,2,1
4,443,443,33,33,0,1,0
14,450,450,81,2,79,4,3
36,464,464,6,6,0,1,0
10,469,469,77,40,37,2,1
27,478,478,4,4,0,1,0
6,482,482,184,98,86,3,2
11,492,492,2,2,0,1,0

26,110,110,1,1,0,1,0
19,115,115,32,10,22,2,1
7,126,126,27,27,0,1,0
14,129,129,23,10,13,2,1
16,137,137,1,1,0,1,0
12,152,152,10,2,8,3,2
23,152,152,4,4,0,1,0
21,167,167,37,7,30,2,1
33,202,202,33,14,19,2,1
2,207,207,3,3,0,1,0
17,213,213,1,1,0,1,0
18,246,246,5,1,4,2,1
5,252,252,104,94,10,2,1
3,256,256,30,30,0,1,0
22,265,265,18,18,0,1,0
27,285,285,71,28,43,2,1
1,290,290,5,2,3,2,1
32,310,310,32,2,30,4,3
4,319,319,26,12,14,3,2
24,334,334,34,8,26,2,1
15,353,353,19,19,0,1,0
20,383,383,47,2,45,4,3
28,386,386,26,3,23,2,1
9,390,390,109,91,18,3,2
0,394,394,85,45,40,2,1
13,401,401,116,40,76,3,2
34,406,406,54,54,0,1,0
6,413,413,32,14,18,2,1
31,428,428,2,2,0,1,0
10,432,432,10,2,8,3,2
29,457,457,133,127,6,2,1
25,459,459,29,29,0,1,0
8,459,459,6,3,3,2,1
11,490,490,3,3,0,1,0
30,497,497,29,29,0,1,0

3,121,121,4,4,0,1,0
32,152,152,3,3,0,1,0
23,165,165,41,41,0,1,0
22,173,173,17,5,12,2,1
18,180,180,8,8,0,1,0
17,180,180,34,4,30,4,3
12,186,186,70,70,0,1,0
7,191,191,1,1,0,1,0
28,194,194,5,1,4,2,1
1,196,196,12,12,0,1,0
29,203,203,17,17,0,1,0
6,212,212,34,34,0,1,0
14,213,213,17,9,8,2,1
24,215,215,10,10,0,1,0
11,217,217,23,23,0,1,0
13,248,248,14,7,7,2,1
19,253,253,23,23,0,1,0
0,258,258,136,76,60,4,3
8,277,277,22,22,0,1,0
34,294,294,108,108,0,1,0
10,295,295,47,4,43,2,1
31,297,297,2,2,0,1,0
9,302,302,52,28,24,3,2
35,306,306,43,43,0,1,0
16,310,310,47,38,9,4,3
2,336,336,20,4,16,3,2
4,357,357,30,30,0,1,0
27,389,389,6,6,0,1,0
30,422,422,60,11,49,2,1
21,432,432,43,16,27,4,3
20,437,437,22,22,0,1,0
5,461,461,1,1,0,1,0
25,468,468,41,41,0,1,0
26,476,476,49,17,32,2,1
15,487,487,19,7,12,2,1
33,494,494,14,14,0,1,0

21,107,107,45,7,38,2,1
31,115,115,6,3,3,2,1
2,120,120,6,6,0,1,0
43,131,131,4,4,0,1,0
23,132,132,3,3,0,1,0
30,148,148,3,3,0,1,0
1,153,153,3,3,0,1,0
42,155,155,30,30,0,1,0
8,158,158,11,11,0,1,0
12,164,164,1,1,0,1,0
16,164,164,15,15,0,1,0
35,178,178,3,3,0,1,0
44,184,184,41,41,0,1,0
10,187,187,15,3,12,2,1
17,187,187,19,8,11,2,1
29,200,200,4,4,0,1,0
34,228,228,43,30,13,2,1
38,263,263,21,21,0,1,0
7,265,265,20,11,9,4,3
41,281,281,44,29,15,4,3
11,296,296,1,1,0,1,0
32,299,299,32,16,16,3,2
28,315,315,64,64,0,1,0
39,328,328,6,6,0,1,0
37,331,331,37,25,12,4,3
26,348,348,34,12,22,2,1
24,352,352,43,43,0,1,0
27,362,362,37,37,0,1,0
18,362,362,31,3,28,2,1
33,370,370,37,37,0,1,0
20,372,372,9,9,0,1,0
36,378,378,19,19,0,1,0
4,378,378,4,4,0,1,0
5,405,405,36,10,26,3,2
0,406,406,10,10,0,1,0
25,420,420,109,109,0,1,0
9,432,432,37,26,11,2,1
40,436,436,3,3,0,1,0
6,440,440,70,58,12,4,3
15,457,457,20,5,15,2,1
22,480,480,30,30,0,1,0
14,480,480,114,114,0,1,0
19,482,482,15,15,0,1,0
13,489,489,23,23,0,1,0
3,493,493,19,19,0,1,0

29,113,113,6,6,0,1,0
13,118,118,2,2,0,1,0
24,139,139,19,19,0,1,0
10,150,150,29,1,28,2,1
1,156,156,68,68,0,1,0
18,164,164,20,17,3,2,1
16,179,179,7,7,0,1,0
27,179,179,17,11,6,3,2
19,188,188,9,2,7,3,2
0,188,188,30,30,0,1,0
32,194,194,7,7,0,1,0
38,202,202,19,19,0,1,0
20,206,206,93,90,3,2,1
9,207,207,4,1,3,2,1
5,212,212,19,19,0,1,0
37,225,225,26,8,18,2,1
2,226,226,2,2,0,1,0
15,229,229,1,1,0,1,0
36,241,241,8,3,5,2,1
7,264,264,7,1,6,2,1
33,268,268,36,20,16,3,2
11,268,268,17,6,11,2,1
6,297,297,77,55,22,2,1
30,298,298,33,33,0,1,0
12,310,310,35,35,0,1,0
28,320,320,31,31,0,1,0
31,322,322,26,14,12,2,1
8,340,340,14,8,6,2,1
21,355,355,1,1,0,1,0
35,360,360,54,50,4,2,1
25,368,368,4,1,3,2,1
23,383,383,23,23,0,1,0
3,409,409,82,82,0,1,0
4,417,417,16,16,0,1,0
39,419,419,20,1,19,2,1
17,436,436,41,19,22,2,1
14,439,439,13,13,0,1,0
34,453,453,31,6,25,2,1
22,471,471,30,30,0,1,0
26,476,476,87,87,0,1,0

18,100,100,16,16,0,1,0
24,101,101,8,8,0,1,0
34,105,105,2,2,0,1,0
1,116,116,23,7,16,4,3
13,121,121,6,3,3,2,1
7,122,122,1,1,0,1,0
14,151,151,1,1,0,1,0
21,159,159,1,1,0,1,0
36,159,159,25,25,0,1,0
33,159,159,5,2,3,2,1
35,170,170,22,22,0,1,0
37,191,191,4,1,3,2,1
0,191,191,37,9,28,3,2
16,193,193,3,3,0,1,0
15,202,202,17,3,14,3,2
40,220,220,54,54,0,1,0
19,222,222,49,5,44,3,2
25,249,249,36,13,23,3,2
28,249,249,6,6,0,1,0
29,259,259,15,6,9,2,1
46,263,263,21,5,16,2,1
23,265,265,14,2,12,4,3
39,274,274,2,2,0,1,0
32,280,280,30,30,0,1,0
9,287,287,12,12,0,1,0
20,289,289,28,4,24,4,3
8,298,298,5,5,0,1,0
11,303,303,14,14,0,1,0
17,309,309,40,3,37,4,3
27,309,309,22,7,15,4,3
10,312,312,21,21,0,1,0
26,332,332,38,16,22,2,1
44,346,346,31,31,0,1,0
38,351,351,48,48,0,1,0
30,353,353,31,2,29,2,1
42,362,362,75,75,0,1,0
43,366,366,50,12,38,2,1
4,399,399,10,10,0,1,0
31,404,404,4,4,0,1,0
5,422,422,44,30,14,3,2
6,444,444,9,9,0,1,0
45,450,450,95,95,0,1,0
2,462,462,1,1,0,1,0
41,493,493,99,57,42,3,2
3,494,494,9,1,8,2,1
22,500,500,33,33,0,1,0
12,500,500,16,16,0,1,0

23,107,107,6,6,0,1,0
35,108,108,30,30,0,1,0
13,113,113,12,12,0,1,0
6,117,117,25,25,0,1,0
33,125,125,49,49,0,1,0
20,145,145,11,11,0,1,0
41,159,159,2,2,0,1,0
14,170,170,2,2,0,1,0
29,175,175,9,1,8,2,1
18,192,192,14,3,11,2,1
36,216,216,21,10,11,2,1
4,233,233,1,1,0,1,0
2,252,252,11,3,8,3,2
22,256,256,30,30,0,1,0
9,261,261,6,6,0,1,0
39,266,266,11,11,0,1,0
28,280,280,12,6,6,2,1
32,281,281,20,20,0,1,0
8,298,298,51,12,39,3,2
25,303,303,14,14,0,1,0
16,306,306,14,1,13,3,2
11,317,317,25,1,24,4,3
40,330,330,27,9,18,4,3
0,331,331,1,1,0,1,0
34,336,336,6,2,4,2,1
21,351,351,2,2,0,1,0
37,353,353,8,8,0,1,0
27,353,353,7,4,3,2,1
12,396,396,82,40,42,4,3
7,397,397,47,47,0,1,0
31,402,402,1,1,0,1,0
30,405,405,41,17,24,4,3
3,415,415,71,57,14,2,1
1,435,435,31,31,0,1,0
17,440,440,126,110,16,3,2
15,441,441,26,26,0,1,0
10,442,442,30,5,25,2,1
5,471,471,12,9,3,2,1
24,472,472,127,127,0,1,0
38,476,476,43,27,16,3,2
26,483,483,116,80,36,4,3
19,483,483,67,33,34,2,1

25,117,117,11,11,0,1,0
8,117,117,3,3,0,1,0
38,126,126,2,2,0,1,0
29,160,160,1,1,0,1,0
32,176,176,43,24,19,2,1
47,182,182,6,3,3,2,1
13,190,190,47,38,9,4,3
39,194,194,7,7,0,1,0
43,197,197,8,8,0,1,0
15,215,215,39,39,0,1,0
21,216,216,8,2,6,2,1
5,235,235,5,5,0,1,0
12,236,236,36,3,33,2,1
26,240,240,7,7,0,1,0
33,240,240,33,33,0,1,0
6,254,254,2,2,0,1,0
11,258,258,9,9,0,1,0
17,266,266,5,5,0,1,0
7,278,278,7,2,5,2,1
46,301,301,7,7,0,1,0
14,309,309,2,2,0,1,0
37,314,314,9,9,0,1,0
40,317,317,58,58,0,1,0
10,328,328,26,26,0,1,0
30,334,334,29,29,0,1,0
18,344,344,32,32,0,1,0
3,350,350,10,10,0,1,0
1,356,356,5,5,0,1,0
22,360,360,15,15,0,1,0
20,365,365,36,26,10,2,1
44,372,372,16,16,0,1,0
28,372,372,30,30,0,1,0
34,382,382,65,14,51,4,3
49,406,406,51,22,29,2,1
24,417,417,20,4,16,3,2
16,418,418,30,30,0,1,0
45,420,420,39,9,30,4,3
2,421,421,42,42,0,1,0
48,422,422,61,36,25,4,3
42,428,428,42,42,0,1,0
0,430,430,3,3,0,1,0
23,438,438,1,1,0,1,0
35,439,439,167,123,44,2,1
9,440,440,26,13,13,3,2
31,489,489,7,7,0,1,0
27,492,492,29,29,0,1,0
19,494,494,127,98,29,2,1
36,497,497,44,12,32,2,1
4,497,497,36,36,0,1,0
41,499,499,19,2,17,2,1

29,105,105,28,28,0,1,0
8,129,129,2,2,0,1,0
46,135,135,5,5,0,1,0
3,136,136,1,1,0,1,0
31,144,144,8,8,0,1,0
23,149,149,4,4,0,1,0
21,162,162,5,5,0,1,0
41,167,167,16,16,0,1,0
0,168,168,1,1,0,1,0
12,174,174,33,12,21,4,3
47,195,195,35,35,0,1,0
18,197,197,1,1,0,1,0
13,199,199,10,10,0,1,0
25,200,200,11,11,0,1,0
7,219,219,19,13,6,2,1
6,231,231,37,23,14,2,1
11,259,259,9,4,5,2,1
22,267,267,87,43,44,2,1
10,288,288,28,5,23,2,1
45,289,289,30,30,0,1,0
19,299,299,11,11,0,1,0
20,303,303,29,4,25,2,1
24,305,305,8,8,0,1,0
28,321,321,10,10,0,1,0
16,333,333,30,12,18,3,2
38,344,344,22,22,0,1,0
1,344,344,11,11,0,1,0
14,348,348,8,8,0,1,0
33,356,356,110,75,35,2,1
2,357,357,11,2,9,2,1
39,360,360,4,4,0,1,0
42,367,367,1,1,0,1,0
40,368,368,16,4,12,3,2
5,379,379,65,65,0,1,0
26,383,383,1,1,0,1,0
32,386,386,6,6,0,1,0
9,396,396,13,13,0,1,0
17,406,406,40,17,23,3,2
43,409,409,59,59,0,1,0
30,411,411,38,30,8,3,2
37,420,420,5,1,4,2,1
27,443,443,16,3,13,2,1
44,447,447,20,20,0,1,0
4,451,451,38,32,6,2,1
36,456,456,206,206,0,1,0
15,467,467,70,70,0,1,0
35,477,477,12,12,0,1,0
34,491,491,22,22,0,1,0

36,101,101,12,12,0,1,0
21,125,125,5,5,0,1,0
34,144,144,1,1,0,1,0
0,161,161,2,2,0,1,0
35,163,163,19,13,6,2,1
9,165,165,2,2,0,1,0
8,190,190,1,1,0,1,0
18,191,191,5,5,0,1,0
20,205,205,66,66,0,1,0
1,211,211,12,12,0,1,0
31,224,224,12,12,0,1,0
13,243,243,30,2,28,2,1
12,244,244,5,1,4,2,1
10,253,253,35,35,0,1,0
27,255,255,6,3,3,2,1
25,256,256,102,102,0,1,0
24,256,256,5,5,0,1,0
32,261,261,48,48,0,1,0
14,262,262,55,55,0,1,0
29,270,270,3,3,0,1,0
6,284,284,46,8,38,4,3
16,295,295,35,24,11,2,1
37,297,297,11,11,0,1,0
7,364,364,53,13,40,2,1
33,371,371,37,37,0,1,0
22,372,372,64,64,0,1,0
26,378,378,13,10,3,2,1
38,383,383,22,5,17,3,2
11,389,389,104,64,40,3,2
30,401,401,51,51,0,1,0
23,421,421,1,1,0,1,0
15,428,428,71,21,50,2,1
39,439,439,34,34,0,1,0
4,448,448,28,5,23,2,1
5,465,465,29,7,22,2,1
17,469,469,1,1,0,1,0
2,473,473,19,19,0,1,0
19,479,479,22,16,6,3,2
3,484,484,157,136,21,4,3
28,493,493,69,39,30,4,3

30,104,104,6,2,4,2,1
24,105,105,12,12,0,1,0
10,112,112,11,11,0,1,0
29,138,138,31,31,0,1,0
20,143,143,28,28,0,1,0
9,146,146,16,6,10,4,3
31,153,153,1,1,0,1,0
27,160,160,5,1,4,2,1
37,167,167,1,1,0,1,0
2,174,174,27,3,24,2,1
19,179,179,11,2,9,4,3
16,185,185,1,1,0,1,0
0,194,194,14,14,0,1,0
13,195,195,50,50,0,1,0
15,205,205,19,11,8,2,1
32,207,207,37,6,31,2,1
25,220,220,62,34,28,2,1
23,231,231,21,13,8,2,1
17,239,239,5,5,0,1,0
36,240,240,19,19,0,1,0
21,248,248,4,4,0,1,0
34,269,269,38,38,0,1,0
7,279,279,23,23,0,1,0
28,279,279,21,3,18,3,2
22,294,294,46,46,0,1,0
4,333,333,40,26,14,3,2
8,362,362,87,28,59,4,3
12,379,379,41,1,40,3,2
35,379,379,6,6,0,1,0
33,383,383,76,28,48,4,3
6,390,390,23,13,10,3,2
11,392,392,21,21,0,1,0
5,410,410,132,132,0,1,0
1,431,431,41,15,26,3,2
18,434,434,50,4,46,2,1
26,451,451,1,1,0,1,0
3,473,473,22,22,0,1,0
14,475,475,30,30,0,1,0

30,102,102,2,2,0,1,0
40,104,104,10,10,0,1,0
0,111,111,10,6,4,2,1
9,115,115,1,1,0,1,0
19,123,123,23,23,0,1,0
24,128,128,5,5,0,1,0
21,130,130,5,5,0,1,0
22,159,159,4,4,0,1,0
43,166,166,7,7,0,1,0
33,173,173,5,5,0,1,0
4,185,185,30,30,0,1,0
31,186,186,5,2,3,2,1
27,211,211,45,45,0,1,0
7,236,236,26,26,0,1,0
14,239,239,16,16,0,1,0
5,240,240,1,1,0,1,0
11,245,245,3,3,0,1,0
18,251,251,1,1,0,1,0
32,252,252,46,18,28,3,2
20,265,265,68,38,30,4,3
16,267,267,4,4,0,1,0
35,285,285,18,18,0,1,0
1,289,289,15,15,0,1,0
13,289,289,39,39,0,1,0
38,292,292,30,21,9,4,3
28,298,298,108,108,0,1,0
36,303,303,37,37,0,1,0
10,309,309,28,16,12,4,3
15,348,348,74,30,44,3,2
29,349,349,72,8,64,4,3
3,359,359,26,26,0,1,0
42,366,366,14,2,12,3,2
23,366,366,6,6,0,1,0
25,382,382,5,2,3,2,1
34,384,384,25,13,12,3,2
2,399,399,92,78,14,2,1
8,408,408,42,27,15,4,3
26,411,411,75,54,21,4,3
37,460,460,88,88,0,1,0
41,466,466,18,9,9,2,1
39,469,469,5,5,0,1,0
17,474,474,3,3,0,1,0
12,493,493,48,48,0,1,0
6,500,500,2,2,0,1,0

24,104,104,10,10,0,1,0
29,148,148,1,1,0,1,0
1,152,152,11,3,8,3,2
20,159,159,8,8,0,1,0
34,170,170,9,1,8,3,2
4,170,170,7,7,0,1,0
27,177,177,1,1,0,1,0
26,194,194,30,30,0,1,0
33,208,208,4,1,3,2,1
9,252,252,20,2,18,4,3
31,273,273,61,47,14,3,2
15,282,282,36,36,0,1,0
13,290,290,66,66,0,1,0
23,303,303,72,25,47,2,1
0,323,323,24,24,0,1,0
19,324,324,6,2,4,2,1
25,340,340,7,4,3,2,1
6,354,354,60,60,0,1,0
7,354,354,140,140,0,1,0
12,356,356,1,1,0,1,0
5,360,360,49,49,0,1,0
35,380,380,22,17,5,2,1
10,394,394,55,55,0,1,0
2,411,411,56,7,49,2,1
36,418,418,23,2,21,3,2
22,429,429,31,15,16,2,1
16,440,440,38,38,0,1,0
18,450,450,72,72,0,1,0
8,450,450,55,55,0,1,0
30,460,460,47,9,38,3,2
32,468,468,171,171,0,1,0
11,479,479,17,13,4,2,1
3,486,486,22,1,21,2,1
14,487,487,53,53,0,1,0
21,488,488,151,151,0,1,0
17,492,492,11,1,10,3,2
28,497,497,8,8,0,1,0

6,125,125,2,2,0,1,0
11,131,131,17,2,15,2,1
34,134,134,19,7,12,2,1
28,140,140,35,29,6,3,2
32,142,142,16,2,14,2,1
8,199,199,11,11,0,1,0
31,204,204,21,9,12,4,3
27,220,220,1,1,0,1,0
25,223,223,21,3,18,4,3
33,228,228,1,1,0,1,0
22,231,231,24,3,21,4,3
30,253,253,75,23,52,4,3
21,254,254,52,52,0,1,0
16,261,261,8,2,6,2,1
5,269,269,34,14,20,3,2
0,283,283,1,1,0,1,0
20,285,285,12,4,8,2,1
13,290,290,3,3,0,1,0
23,291,291,57,20,37,4,3
18,296,296,19,19,0,1,0
24,298,298,36,36,0,1,0
10,299,299,7,1,6,2,1
9,318,318,15,15,0,1,0
19,340,340,38,28,10,3,2
4,341,341,66,66,0,1,0
12,372,372,8,8,0,1,0
29,378,378,29,29,0,1,0
17,396,396,9,6,3,2,1
7,398,398,95,4,91,4,3
26,417,417,8,8,0,1,0
1,420,420,63,1,62,3,2
15,426,426,19,19,0,1,0
3,449,449,39,39,0,1,0
2,490,490,310,270,40,3,2
14,499,499,133,76,57,4,3

22,102,102,2,2,0,1,0
5,114,114,2,2,0,1,0
0,132,132,12,12,0,1,0
17,142,142,2,2,0,1,0
15,153,153,3,3,0,1,0
14,155,155,4,4,0,1,0
10,166,166,9,1,8,2,1
23,171,171,3,3,0,1,0
36,181,181,9,1,8,3,2
6,182,182,19,19,0,1,0
18,189,189,67,67,0,1,0
42,192,192,5,5,0,1,0
41,195,195,110,65,45,4,3
16,196,196,50,50,0,1,0
34,200,200,2,2,0,1,0
26,203,203,10,4,6,3,2
9,207,207,9,9,0,1,0
37,208,208,25,25,0,1,0
39,221,221,13,1,12,4,3
30,224,224,25,25,0,1,0
19,234,234,25,7,18,4,3
3,255,255,1,1,0,1,0
21,259,259,30,25,5,2,1
1,259,259,5,2,3,2,1
29,261,261,8,8,0,1,0
27,295,295,3,3,0,1,0
13,320,320,12,12,0,1,0
24,334,334,72,40,32,3,2
25,343,343,34,8,26,3,2
8,347,347,30,30,0,1,0
31,349,349,2,2,0,1,0
12,354,354,50,14,36,4,3
38,356,356,97,97,0,1,0
2,364,364,65,65,0,1,0
40,371,371,4,1,3,2,1
4,376,376,5,5,0,1,0
32,414,414,20,8,12,4,3
11,420,420,57,57,0,1,0
35,431,431,9,9,0,1,0
28,455,455,9,6,3,2,1
33,483,483,142,25,117,4,3
20,491,491,11,11,0,1,0
7,494,494,69,9,60,3,2

17,124,124,1,1,0,1,0
29,135,135,25,25,0,1,0
23,146,146,13,7,6,2,1
28,158,158,5,5,0,1,0
20,163,163,5,5,0,1,0
15,168,168,12,12,0,1,0
16,173,173,1,1,0,1,0
13,179,179,1,1,0,1,0
37,187,187,8,8,0,1,0
4,209,209,9,9,0,1,0
3,225,225,17,14,3,2,1
25,247,247,60,18,42,4,3
10,249,249,45,21,24,3,2
11,252,252,49,22,27,2,1
8,254,254,5,2,3,2,1
34,265,265,14,14,0,1,0
31,272,272,89,21,68,3,2
24,275,275,8,4,4,2,1
0,295,295,14,5,9,4,3
5,298,298,108,102,6,2,1
7,301,301,27,18,9,4,3
22,305,305,39,39,0,1,0
39,309,309,62,62,0,1,0
18,322,322,60,60,0,1,0
9,346,346,65,3,62,3,2
2,350,350,35,25,10,3,2
38,358,358,23,11,12,2,1
35,363,363,15,15,0,1,0
21,370,370,99,99,0,1,0
32,379,379,5,5,0,1,0
12,384,384,22,22,0,1,0
6,415,415,50,42,8,2,1
14,426,426,74,57,17,2,1
1,429,429,12,12,0,1,0
26,443,443,73,73,0,1,0
33,464,464,23,5,18,2,1
36,472,472,3,3,0,1,0
19,482,482,21,3,18,4,3
30,483,483,5,5,0,1,0
27,483,483,28,13,15,2,1

15,106,106,3,3,0,1,0
25,126,126,24,9,15,2,1
0,126,126,2,2,0,1,0
3,156,156,34,34,0,1,0
5,165,165,25,25,0,1,0
20,184,184,11,11,0,1,0
8,212,212,51,51,0,1,0
23,243,243,9,9,0,1,0
18,243,243,38,26,12,3,2
1,251,251,50,50,0,1,0
6,252,252,15,1,14,2,1
16,258,258,8,8,0,1,0
30,265,265,19,4,15,2,1
13,283,283,25,25,0,1,0
12,302,302,94,45,49,2,1
11,308,308,116,116,0,1,0
4,338,338,75,75,0,1,0
14,341,341,5,1,4,2,1
24,341,341,34,34,0,1,0
7,368,368,74,48,26,3,2
28,384,384,4,1,3,2,1
10,391,391,74,74,0,1,0
21,392,392,10,4,6,3,2
9,396,396,35,35,0,1,0
22,410,410,176,116,60,4,3
2,412,412,16,16,0,1,0
27,430,430,54,54,0,1,0
19,432,432,3,3,0,1,0
29,447,447,76,76,0,1,0
31,450,450,42,3,39,3,2
17,480,480,7,7,0,1,0
26,488,488,33,33,0,1,0

25,100,100,6,3,3,2,1
36,112,112,21,15,6,2,1
13,121,121,1,1,0,1,0
16,124,124,5,5,0,1,0
18,131,131,36,14,22,3,2
40,133,133,9,9,0,1,0
31,151,151,29,29,0,1,0
30,164,164,26,8,18,4,3
34,174,174,56,50,6,3,2
11,178,178,10,2,8,2,1
6,185,185,34,34,0,1,0
32,194,194,6,6,0,1,0
5,202,202,27,16,11,2,1
10,214,214,2,2,0,1,0
35,217,217,13,13,0,1,0
39,248,248,22,22,0,1,0
38,252,252,80,67,13,2,1
1,258,258,8,8,0,1,0
22,276,276,8,2,6,2,1
37,282,282,7,7,0,1,0
23,283,283,12,12,0,1,0
17,295,295,25,25,0,1,0
28,299,299,6,6,0,1,0
27,310,310,22,22,0,1,0
15,316,316,33,17,16,4,3
4,338,338,19,6,13,2,1
7,343,343,87,87,0,1,0
21,346,346,28,28,0,1,0
12,358,358,24,4,20,3,2
24,378,378,25,25,0,1,0
8,379,379,4,4,0,1,0
0,381,381,63,15,48,4,3
33,406,406,18,1,17,4,3
14,412,412,77,77,0,1,0
29,415,415,54,8,46,3,2
3,433,433,45,31,14,3,2
19,439,439,20,20,0,1,0
9,439,439,13,6,7,2,1
20,465,465,13,13,0,1,0
26,478,478,27,6,21,2,1
2,488,488,62,50,12,4,3

7,101,101,11,1,10,2,1
33,107,107,6,6,0,1,0
0,114,114,16,2,14,3,2
18,115,115,6,6,0,1,0
19,125,125,20,14,6,3,2
36,126,126,73,73,0,1,0
37,132,132,10,1,9,2,1
34,137,137,25,25,0,1,0
12,148,148,18,18,0,1,0
6,173,173,1,1,0,1,0
11,173,173,11,11,0,1,0
43,186,186,2,2,0,1,0
27,201,201,29,14,15,4,3
45,208,208,16,7,9,4,3
28,209,209,14,6,8,3,2
30,212,212,13,5,8,3,2
3,217,217,10,10,0,1,0
23,236,236,72,72,0,1,0
32,244,244,27,27,0,1,0
10,254,254,8,4,4,2,1
41,264,264,62,62,0,1,0
22,265,265,24,24,0,1,0
24,294,294,13,1,12,3,2
9,323,323,31,5,26,3,2
4,339,339,11,11,0,1,0
20,347,347,73,7,66,4,3
29,356,356,16,7,9,4,3
38,370,370,6,6,0,1,0
40,378,378,12,2,10,2,1
42,382,382,13,1,12,2,1
35,395,395,17,17,0,1,0
1,396,396,2,2,0,1,0
8,410,410,15,15,0,1,0
31,420,420,73,41,32,4,3
21,427,427,8,8,0,1,0
5,438,438,23,13,10,3,2
17,443,443,1,1,0,1,0
16,450,450,113,113,0,1,0
2,456,456,3,3,0,1,0
15,457,457,15,15,0,1,0
39,459,459,8,4,4,2,1
25,473,473,4,1,3,2,1
14,477,477,7,7,0,1,0
13,478,478,30,30,0,1,0
44,488,488,6,6,0,1,0
26,498,498,32,14,18,4,3

8,100,100,4,4,0,1,0
5,111,111,1,1,0,1,0
13,116,116,8,2,6,2,1
11,124,124,1,1,0,1,0
43,129,129,30,4,26,3,2
1,131,131,19,19,0,1,0
38,132,132,1,1,0,1,0
6,140,140,27,7,20,3,2
19,144,144,18,6,12,3,2
46,144,144,18,18,0,1,0
30,151,151,27,15,12,2,1
35,163,163,5,2,3,2,1
33,166,166,31,2,29,3,2
15,173,173,8,5,3,2,1
40,200,200,6,6,0,1,0
26,200,200,39,6,33,4,3
7,202,202,1,1,0,1,0
10,203,203,13,6,7,2,1
31,205,205,21,21,0,1,0
44,220,220,2,2,0,1,0
41,222,222,36,3,33,2,1
39,266,266,30,13,17,2,1
23,266,266,12,12,0,1,0
9,276,276,5,5,0,1,0
12,289,289,16,7,9,4,3
14,307,307,3,3,0,1,0
4,321,321,37,1,36,2,1
25,324,324,1,1,0,1,0
34,341,341,27,1,26,3,2
42,345,345,12,12,0,1,0
36,378,378,94,6,88,3,2
24,379,379,29,1,28,3,2
27,384,384,4,4,0,1,0
18,404,404,37,31,6,3,2
28,408,408,30,1,29,2,1
16,421,421,39,39,0,1,0
2,429,429,3,3,0,1,0
21,434,434,8,8,0,1,0
0,438,438,34,24,10,2,1
17,445,445,79,69,10,2,1
22,448,448,75,24,51,3,2
29,454,454,24,15,9,4,3
20,455,455,32,32,0,1,0
37,467,467,138,30,108,4,3
32,476,476,11,4,7,2,1
47,478,478,16,16,0,1,0
45,482,482,13,1,12,3,2
3,484,484,32,4,28,2,1

33,101,101,1,1,0,1,0
0,117,117,6,6,0,1,0
29,117,117,7,4,3,2,1
38,118,118,9,9,0,1,0
35,119,119,3,3,0,1,0
4,140,140,17,17,0,1,0
9,147,147,6,3,3,2,1
13,148,148,10,10,0,1,0
26,165,165,40,40,0,1,0
34,171,171,52,28,24,3,2
21,199,199,14,14,0,1,0
10,210,210,20,12,8,3,2
5,216,216,1,1,0,1,0
27,218,218,4,4,0,1,0
40,219,219,15,15,0,1,0
25,220,220,40,25,15,2,1
19,229,229,86,44,42,3,2
37,230,230,34,8,26,2,1
36,242,242,12,12,0,1,0
7,265,265,28,28,0,1,0
3,265,265,12,12,0,1,0
20,276,276,3,3,0,1,0
16,289,289,33,2,31,2,1
39,292,292,17,17,0,1,0
17,294,294,44,44,0,1,0
32,312,312,4,4,0,1,0
14,316,316,11,3,8,2,1
8,321,321,29,29,0,1,0
15,331,331,30,17,13,2,1
30,334,334,63,49,14,3,2
23,353,353,71,13,58,3,2
28,361,361,49,49,0,1,0
22,382,382,2,2,0,1,0
2,391,391,35,17,18,3,2
1,402,402,31,18,13,2,1
11,410,410,59,24,35,2,1
31,426,426,4,4,0,1,0
18,430,430,14,14,0,1,0
6,462,462,15,15,0,1,0
12,487,487,112,77,35,2,1
24,492,492,89,89,0,1,0

17,105,105,10,1,9,2,1
18,106,106,2,2,0,1,0
13,122,122,9,1,8,3,2
32,126,126,5,5,0,1,0
19,127,127,6,6,0,1,0
4,148,148,33,15,18,2,1
9,151,151,15,6,9,2,1
27,159,159,41,41,0,1,0
38,173,173,27,27,0,1,0
40,192,192,39,25,14,2,1
1,196,196,31,19,12,3,2
31,230,230,16,16,0,1,0
30,235,235,6,6,0,1,0
0,239,239,46,30,16,3,2
22,244,244,1,1,0,1,0
16,253,253,1,1,0,1,0
28,257,257,5,5,0,1,0
21,267,267,35,35,0,1,0
5,280,280,6,6,0,1,0
8,283,283,4,4,0,1,0
34,286,286,52,52,0,1,0
15,300,300,15,15,0,1,0
12,308,308,1,1,0,1,0
2,309,309,55,6,49,3,2
26,321,321,8,4,4,2,1
36,341,341,35,26,9,4,3
23,355,355,13,13,0,1,0
42,357,357,35,7,28,3,2
7,358,358,27,27,0,1,0
25,361,361,5,5,0,1,0
33,381,381,30,15,15,4,3
35,388,388,30,14,16,2,1
11,406,406,73,73,0,1,0
14,406,406,8,8,0,1,0
24,417,417,59,59,0,1,0
6,426,426,40,9,31,2,1
10,426,426,35,29,6,3,2
39,441,441,53,53,0,1,0
20,448,448,56,56,0,1,0
3,467,467,35,29,6,3,2
43,468,468,70,12,58,3,2
37,470,470,29,29,0,1,0
41,482,482,81,27,54,4,3
29,499,499,23,7,16,3,2

30,113,113,12,12,0,1,0
3,120,120,3,3,0,1,0
18,131,131,32,14,18,2,1
22,167,167,25,25,0,1,0
32,170,170,5,5,0,1,0
8,187,187,3,3,0,1,0
10,191,191,5,5,0,1,0
17,195,195,38,30,8,3,2
35,200,200,20,20,0,1,0
23,208,208,14,14,0,1,0
21,212,212,29,29,0,1,0
9,219,219,13,4,9,4,3
5,229,229,10,10,0,1,0
16,273,273,61,61,0,1,0
4,274,274,13,13,0,1,0
33,277,277,131,22,109,4,3
2,289,289,38,30,8,2,1
13,293,293,54,44,10,2,1
1,306,306,10,10,0,1,0
28,312,312,5,5,0,1,0
38,319,319,30,30,0,1,0
27,328,328,1,1,0,1,0
31,331,331,95,95,0,1,0
36,345,345,2,2,0,1,0
29,376,376,12,6,6,2,1
34,410,410,100,10,90,3,2
11,415,415,35,7,28,2,1
39,421,421,59,36,23,2,1
20,428,428,8,8,0,1,0
15,429,429,33,9,24,4,3
12,430,430,106,70,36,2,1
19,442,442,12,6,6,2,1
25,446,446,1,1,0,1,0
7,447,447,61,46,15,4,3
6,448,448,16,2,14,2,1
14,466,466,61,61,0,1,0
37,474,474,43,43,0,1,0
26,479,479,5,5,0,1,0
0,483,483,17,17,0,1,0
24,496,496,14,5,9,4,3

38,100,100,1,1,0,1,0
9,105,105,30,2,28,4,3
36,123,123,1,1,0,1,0
5,146,146,24,24,0,1,0
34,169,169,25,13,12,4,3
40,177,177,7,7,0,1,0
29,181,181,1,1,0,1,0
14,185,185,14,14,0,1,0
31,201,201,3,3,0,1,0
6,204,204,5,5,0,1,0
10,211,211,10,2,8,2,1
30,220,220,72,72,0,1,0
16,230,230,2,2,0,1,0
28,244,244,4,4,0,1,0
41,248,248,2,2,0,1,0
24,268,268,17,17,0,1,0
20,275,275,41,20,21,2,1
15,279,279,5,5,0,1,0
32,283,283,9,9,0,1,0
1,308,308,56,22,34,3,2
25,314,314,129,129,0,1,0
23,323,323,119,2,117,4,3
18,341,341,9,9,0,1,0
42,346,346,26,17,9,4,3
11,346,346,1,1,0,1,0
4,361,361,64,42,22,2,1
0,377,377,73,21,52,3,2
17,386,386,4,1,3,2,1
8,398,398,87,87,0,1,0
7,412,412,4,4,0,1,0
13,423,423,15,3,12,4,3
26,430,430,19,19,0,1,0
21,445,445,7,7,0,1,0
39,450,450,25,25,0,1,0
2,455,455,20,14,6,3,2
27,459,459,63,63,0,1,0
3,460,460,81,81,0,1,0
22,462,462,25,13,12,4,3
37,478,478,14,8,6,2,1
33,482,482,21,21,0,1,0
12,482,482,13,3,10,2,1
19,485,485,27,7,20,3,2
35,486,486,101,92,9,4,3

37,116,116,9,1,8,3,2
24,122,122,5,5,0,1,0
19,136,136,12,4,8,2,1
12,140,140,23,23,0,1,0
23,140,140,12,5,7,2,1
14,166,166,10,10,0,1,0
7,191,191,87,29,58,3,2
5,194,194,37,22,15,2,1
6,207,207,1,1,0,1,0
17,225,225,6,6,0,1,0
3,229,229,18,4,14,2,1
20,231,231,11,6,5,2,1
4,237,237,13,13,0,1,0
28,260,260,47,23,24,3,2
34,267,267,33,33,0,1,0
2,268,268,8,2,6,3,2
1,270,270,5,5,0,1,0
26,276,276,7,7,0,1,0
25,287,287,4,1,3,2,1
0,300,300,33,12,21,2,1
33,309,309,3,3,0,1,0
31,322,322,81,2,79,4,3
21,325,325,55,45,10,2,1
27,347,347,107,68,39,4,3
30,353,353,2,2,0,1,0
8,367,367,70,16,54,3,2
32,379,379,29,29,0,1,0
22,401,401,122,32,90,4,3
9,402,402,47,2,45,4,3
13,404,404,59,17,42,3,2
16,405,405,21,3,18,4,3
18,445,445,50,38,12,4,3
29,450,450,60,60,0,1,0
10,452,452,30,30,0,1,0
11,456,456,6,3,3,2,1
35,462,462,13,7,6,2,1
15,465,465,51,51,0,1,0
38,485,485,1,1,0,1,0
36,486,486,33,5,28,4,3

22,100,100,16,11,5,2,1
0,112,112,4,4,0,1,0
1,137,137,1,1,0,1,0
25,139,139,2,2,0,1,0
6,156,156,8,8,0,1,0
11,162,162,19,5,14,3,2
39,165,165,4,4,0,1,0
24,197,197,33,13,20,2,1
28,206,206,38,20,18,4,3
26,222,222,19,4,15,4,3
42,250,250,12,12,0,1,0
23,260,260,13,7,6,3,2
19,260,260,4,1,3,2,1
21,276,276,24,24,0,1,0
2,281,281,10,5,5,2,1
7,285,285,60,19,41,3,2
32,286,286,36,36,0,1,0
30,289,289,31,31,0,1,0
17,295,295,9,2,7,2,1
29,306,306,48,48,0,1,0
20,308,308,18,18,0,1,0
5,315,315,13,13,0,1,0
40,326,326,63,63,0,1,0
16,331,331,17,13,4,2,1
33,341,341,45,3,42,4,3
34,343,343,13,9,4,2,1
36,359,359,2,2,0,1,0
14,360,360,46,46,0,1,0
37,361,361,10,10,0,1,0
18,370,370,48,33,15,2,1
13,370,370,5,1,4,2,1
12,371,371,22,22,0,1,0
9,379,379,113,103,10,3,2
38,402,402,12,3,9,4,3
35,418,418,51,51,0,1,0
27,444,444,142,22,120,4,3
41,450,450,30,3,27,4,3
3,464,464,84,66,18,4,3
4,466,466,17,4,13,2,1
31,475,475,63,54,9,2,1
10,477,477,14,1,13,3,2
15,486,486,8,8,0,1,0
8,491,491,104,44,60,3,2

26,103,103,1,1,0,1,0
29,140,140,5,5,0,1,0
14,156,156,36,18,18,4,3
23,156,156,2,2,0,1,0
12,162,162,16,16,0,1,0
6,168,168,57,46,11,2,1
9,217,217,25,5,20,2,1
25,223,223,6,6,0,1,0
32,240,240,9,9,0,1,0
18,242,242,2,2,0,1,0
20,250,250,53,53,0,1,0
30,252,252,4,4,0,1,0
16,255,255,96,96,0,1,0
19,269,269,38,38,0,1,0
31,277,277,14,14,0,1,0
13,312,312,11,11,0,1,0
17,316,316,74,44,30,4,3
1,317,317,10,10,0,1,0
8,320,320,80,80,0,1,0
11,322,322,31,31,0,1,0
2,328,328,50,50,0,1,0
22,340,340,33,33,0,1,0
33,341,341,11,11,0,1,0
15,341,341,67,67,0,1,0
5,356,356,19,19,0,1,0
21,366,366,8,8,0,1,0
10,371,371,40,40,0,1,0
0,379,379,231,209,22,2,1
4,399,399,9,5,4,2,1
24,410,410,59,11,48,3,2
27,424,424,48,48,0,1,0
3,456,456,23,12,11,2,1
7,470,470,18,4,14,2,1
28,485,485,23,23,0,1,0

2,133,133,23,23,0,1,0
4,136,136,8,8,0,1,0
8,140,140,11,3,8,3,2
28,172,172,14,14,0,1,0
5,174,174,36,36,0,1,0
35,177,177,2,2,0,1,0
12,196,196,1,1,0,1,0
24,197,197,4,4,0,1,0
21,199,199,19,4,15,2,1
19,202,202,36,20,16,3,2
26,210,210,11,6,5,2,1
32,210,210,1,1,0,1,0
30,218,218,15,4,11,2,1
15,225,225,10,10,0,1,0
34,229,229,14,4,10,3,2
17,252,252,40,40,0,1,0
31,260,260,4,4,0,1,0
23,271,271,87,87,0,1,0
0,326,326,4,1,3,2,1
11,327,327,24,15,9,2,1
1,341,341,87,36,51,4,3
16,347,347,15,15,0,1,0
36,363,363,78,51,27,2,1
9,378,378,3,3,0,1,0
3,383,383,11,11,0,1,0
7,392,392,63,63,0,1,0
20,395,395,30,30,0,1,0
25,403,403,73,73,0,1,0
22,408,408,23,5,18,4,3
33,418,418,6,2,4,2,1
13,424,424,82,38,44,2,1
14,452,452,64,64,0,1,0
27,456,456,188,168,20,3,2
37,458,458,10,10,0,1,0
10,461,461,72,66,6,2,1
6,469,469,96,80,16,2,1
29,482,482,12,12,0,1,0
18,491,491,63,63,0,1,0

44,119,119,8,8,0,1,0
20,126,126,13,13,0,1,0
42,129,129,1,1,0,1,0
14,134,134,19,1,18,2,1
35,136,136,5,2,3,2,1
32,139,139,23,11,12,4,3
27,141,141,6,3,3,2,1
37,154,154,15,15,0,1,0
11,156,156,14,14,0,1,0
7,181,181,3,3,0,1,0
26,186,186,5,5,0,1,0
31,207,207,5,2,3,2,1
24,208,208,39,30,9,4,3
0,213,213,7,7,0,1,0
40,222,222,13,3,10,3,2
34,238,238,2,2,0,1,0
28,238,238,9,9,0,1,0
21,254,254,13,13,0,1,0
5,275,275,18,4,14,2,1
15,276,276,8,8,0,1,0
36,281,281,26,26,0,1,0
1,282,282,23,6,17,2,1
12,285,285,8,8,0,1,0
9,286,286,6,2,4,2,1
23,288,288,76,76,0,1,0
18,317,317,18,10,8,2,1
10,325,325,53,8,45,2,1
13,326,326,61,27,34,3,2
8,332,332,32,32,0,1,0
30,350,350,7,1,6,2,1
3,357,357,16,16,0,1,0
16,360,360,3,3,0,1,0
22,363,363,23,1,22,3,2
4,387,387,32,20,12,4,3
41,390,390,36,36,0,1,0
17,392,392,14,3,11,2,1
2,407,407,11,3,8,2,1
6,437,437,5,5,0,1,0
25,449,449,36,11,25,2,1
29,449,449,141,36,105,4,3
39,461,461,68,68,0,1,0
33,462,462,179,155,24,2,1
38,471,471,93,27,66,3,2
43,489,489,72,72,0,1,0
19,493,493,57,57,0,1,0

27,105,105,28,1,27,2,1
28,125,125,10,10,0,1,0
37,143,143,30,30,0,1,0
12,144,144,8,8,0,1,0
26,199,199,5,5,0,1,0
22,208,208,3,3,0,1,0
6,238,238,1,1,0,1,0
9,245,245,11,11,0,1,0
18,246,246,23,15,8,3,2
33,250,250,11,2,9,2,1
13,268,268,42,22,20,3,2
30,270,270,7,1,6,2,1
8,289,289,32,20,12,3,2
29,311,311,10,10,0,1,0
36,318,318,21,3,18,2,1
2,326,326,30,30,0,1,0
25,326,326,11,11,0,1,0
23,341,341,72,72,0,1,0
10,348,348,15,15,0,1,0
16,361,361,8,4,4,2,1
19,386,386,19,19,0,1,0
3,386,386,63,30,33,4,3
15,390,390,43,43,0,1,0
7,419,419,24,24,0,1,0
11,420,420,34,34,0,1,0
0,421,421,6,6,0,1,0
1,443,443,18,18,0,1,0
31,454,454,87,54,33,4,3
32,456,456,35,5,30,3,2
14,458,458,30,9,21,2,1
5,467,467,147,100,47,2,1
20,467,467,43,9,34,2,1
34,469,469,1,1,0,1,0
35,479,479,189,180,9,4,3
4,487,487,208,208,0,1,0
17,489,489,97,13,84,3,2
24,493,493,17,17,0,1,0
21,493,493,47,47,0,1,0

22,118,118,26,26,0,1,0
34,120,120,33,33,0,1,0
19,121,121,10,10,0,1,0
43,143,143,5,5,0,1,0
13,144,144,12,6,6,2,1
29,147,147,4,4,0,1,0
23,152,152,10,2,8,3,2
4,172,172,1,1,0,1,0
40,188,188,17,17,0,1,0
28,196,196,37,37,0,1,0
8,198,198,26,26,0,1,0
41,200,200,12,3,9,4,3
15,209,209,37,21,16,2,1
30,215,215,7,7,0,1,0
18,217,217,16,16,0,1,0
10,221,221,5,1,4,2,1
11,244,244,3,3,0,1,0
12,251,251,4,4,0,1,0
24,254,254,6,2,4,2,1
16,260,260,1,1,0,1,0
5,269,269,24,24,0,1,0
32,270,270,74,74,0,1,0
0,281,281,11,5,6,3,2
27,282,282,36,17,19,2,1
3,283,283,9,1,8,3,2
39,288,288,31,31,0,1,0
14,291,291,4,4,0,1,0
42,295,295,24,24,0,1,0
37,310,310,55,28,27,4,3
20,321,321,65,50,15,4,3
6,329,329,36,4,32,2,1
38,331,331,29,29,0,1,0
7,345,345,15,6,9,3,2
21,365,365,8,8,0,1,0
1,372,372,93,54,39,4,3
33,375,375,7,7,0,1,0
17,377,377,35,35,0,1,0
2,398,398,1,1,0,1,0
26,402,402,6,1,5,2,1
36,406,406,8,8,0,1,0
35,415,415,112,79,33,4,3
9,436,436,93,93,0,1,0
25,438,438,25,6,19,2,1
31,461,461,32,2,30,2,1

26,109,109,11,2,9,3,2
14,117,117,2,2,0,1,0
24,118,118,16,16,0,1,0
8,125,125,8,8,0,1,0
5,144,144,3,3,0,1,0
36,149,149,4,4,0,1,0
21,161,161,23,23,0,1,0
9,162,162,6,6,0,1,0
0,174,174,31,18,13,2,1
11,175,175,4,4,0,1,0
4,181,181,5,5,0,1,0
18,186,186,13,5,8,3,2
32,192,192,5,5,0,1,0
25,192,192,4,4,0,1,0
20,201,201,26,26,0,1,0
7,228,228,6,6,0,1,0
17,234,234,3,3,0,1,0
38,236,236,90,67,23,2,1
10,241,241,71,53,18,3,2
34,243,243,18,18,0,1,0
33,245,245,35,35,0,1,0
29,251,251,19,7,12,4,3
15,262,262,2,2,0,1,0
16,281,281,5,5,0,1,0
6,292,292,85,63,22,2,1
30,305,305,12,6,6,3,2
3,313,313,10,3,7,2,1
12,327,327,172,172,0,1,0
19,334,334,114,34,80,4,3
27,339,339,33,16,17,2,1
31,339,339,16,16,0,1,0
1,352,352,69,20,49,4,3
23,391,391,2,2,0,1,0
2,445,445,10,4,6,2,1
22,456,456,48,4,44,3,2
35,459,459,32,8,24,3,2
13,478,478,66,37,29,4,3
28,485,485,2,2,0,1,0
37,490,490,41,19,22,3,2

17,116,116,24,24,0,1,0
32,117,117,1,1,0,1,0
7,125,125,38,38,0,1,0
6,145,145,7,2,5,2,1
10,145,145,4,4,0,1,0
24,149,149,20,12,8,3,2
11,162,162,39,9,30,2,1
25,163,163,61,61,0,1,0
15,184,184,42,24,18,4,3
5,186,186,7,7,0,1,0
29,203,203,4,4,0,1,0
13,217,217,9,3,6,2,1
26,219,219,74,16,58,3,2
31,233,233,2,2,0,1,0
28,243,243,5,1,4,2,1
18,264,264,13,13,0,1,0
35,273,273,48,48,0,1,0
36,274,274,47,32,15,4,3
19,279,279,4,4,0,1,0
3,281,281,51,18,33,4,3
12,293,293,10,10,0,1,0
34,295,295,7,1,6,3,2
0,306,306,4,4,0,1,0
14,316,316,3,3,0,1,0
23,343,343,18,18,0,1,0
33,346,346,25,3,22,3,2
9,370,370,23,6,17,2,1
1,383,383,100,88,12,4,3
8,387,387,4,4,0,1,0
2,425,425,34,3,31,3,2
27,432,432,17,17,0,1,0
20,453,453,34,9,25,2,1
30,456,456,1,1,0,1,0
21,464,464,51,27,24,3,2
16,475,475,24,24,0,1,0
4,481,481,178,74,104,4,3
22,485,485,70,34,36,4,3

29,102,102,21,21,0,1,0
32,110,110,15,4,11,2,1
33,115,115,2,2,0,1,0
39,121,121,24,10,14,2,1
15,122,122,1,1,0,1,0
27,142,142,18,2,16,2,1
7,161,161,3,3,0,1,0
30,172,172,12,9,3,2,1
1,199,199,20,4,16,2,1
22,213,213,8,8,0,1,0
40,219,219,39,39,0,1,0
37,226,226,44,44,0,1,0
11,231,231,8,8,0,1,0
9,243,243,45,45,0,1,0
25,263,263,24,24,0,1,0
21,266,266,17,17,0,1,0
5,267,267,20,20,0,1,0
12,274,274,3,3,0,1,0
8,276,276,2,2,0,1,0
28,281,281,36,15,21,2,1
34,281,281,5,5,0,1,0
4,292,292,48,48,0,1,0
24,302,302,10,10,0,1,0
26,307,307,66,66,0,1,0
23,319,319,4,4,0,1,0
35,324,324,38,38,0,1,0
3,329,329,27,27,0,1,0
20,351,351,104,104,0,1,0
42,355,355,35,26,9,2,1
41,363,363,32,5,27,2,1
19,365,365,33,33,0,1,0
14,373,373,76,43,33,2,1
0,377,377,27,8,19,2,1
17,381,381,6,3,3,2,1
43,382,382,1,1,0,1,0
31,387,387,44,44,0,1,0
16,396,396,39,21,18,4,3
6,418,418,10,2,8,3,2
18,428,428,18,7,11,3,2
10,430,430,70,38,32,4,3
36,441,441,8,2,6,3,2
38,448,448,1,1,0,1,0
2,479,479,91,81,10,3,2
13,488,488,3,3,0,1,0

9,105,105,2,2,0,1,0
22,127,127,13,13,0,1,0
35,133,133,2,2,0,1,0
4,135,135,9,9,0,1,0
14,135,135,7,7,0,1,0
27,152,152,3,3,0,1,0
23,177,177,18,18,0,1,0
10,196,196,33,17,16,3,2
17,223,223,85,34,51,4,3
36,226,226,9,9,0,1,0
28,233,233,10,10,0,1,0
20,239,239,36,18,18,3,2
5,250,250,1,1,0,1,0
33,256,256,8,1,7,2,1
40,258,258,65,65,0,1,0
13,263,263,2,2,0,1,0
2,272,272,1,1,0,1,0
37,274,274,1,1,0,1,0
26,282,282,15,12,3,2,1
16,285,285,5,5,0,1,0
31,304,304,15,6,9,2,1
21,308,308,8,8,0,1,0
3,333,333,40,40,0,1,0
19,334,334,2,2,0,1,0
15,355,355,14,14,0,1,0
11,358,358,1,1,0,1,0
39,360,360,39,39,0,1,0
24,378,378,91,73,18,3,2
32,389,389,70,20,50,2,1
1,405,405,51,25,26,3,2
29,415,415,31,16,15,4,3
8,418,418,7,7,0,1,0
30,422,422,97,73,24,3,2
6,422,422,68,39,29,4,3
34,425,425,72,21,51,4,3
7,427,427,59,12,47,2,1
18,433,433,12,6,6,3,2
12,438,438,159,68,91,4,3
38,445,445,117,76,41,2,1
41,453,453,20,20,0,1,0
0,454,454,47,34,13,2,1
25,481,481,11,11,0,1,0

21,110,110,2,2,0,1,0
20,113,113,9,9,0,1,0
2,122,122,6,6,0,1,0
4,130,130,9,9,0,1,0
32,134,134,3,3,0,1,0
27,136,136,3,3,0,1,0
17,137,137,12,12,0,1,0
30,143,143,57,57,0,1,0
16,163,163,1,1,0,1,0
18,164,164,4,4,0,1,0
5,180,180,24,12,12,3,2
10,197,197,9,9,0,1,0
12,256,256,23,9,14,3,2
9,256,256,37,37,0,1,0
25,262,262,64,34,30,3,2
26,264,264,29,7,22,4,3
37,265,265,13,13,0,1,0
19,290,290,78,78,0,1,0
0,319,319,118,22,96,3,2
39,321,321,8,8,0,1,0
33,347,347,5,5,0,1,0
29,351,351,42,42,0,1,0
13,362,362,8,8,0,1,0
24,375,375,15,15,0,1,0
6,376,376,12,3,9,2,1
23,388,388,43,43,0,1,0
34,388,388,9,9,0,1,0
3,410,410,6,1,5,2,1
7,415,415,26,4,22,3,2
28,417,417,118,118,0,1,0
22,420,420,47,47,0,1,0
14,421,421,160,35,125,4,3
8,430,430,6,6,0,1,0
31,443,443,37,37,0,1,0
38,476,476,86,60,26,2,1
1,480,480,52,6,46,2,1
11,494,494,16,7,9,4,3
36,496,496,50,50,0,1,0
35,497,497,1,1,0,1,0
15,498,498,23,7,16,2,1

38,110,110,4,4,0,1,0
15,113,113,1,1,0,1,0
4,119,119,9,9,0,1,0
8,141,141,15,15,0,1,0
36,150,150,21,21,0,1,0
33,154,154,8,8,0,1,0
26,156,156,16,16,0,1,0
11,161,161,6,6,0,1,0
6,165,165,22,1,21,4,3
31,177,177,6,6,0,1,0
24,192,192,13,7,6,3,2
12,216,216,23,9,14,3,2
21,223,223,19,19,0,1,0
0,246,246,32,20,12,3,2
18,259,259,43,27,16,2,1
2,268,268,16,3,13,2,1
39,269,269,7,7,0,1,0
25,277,277,53,25,28,3,2
30,293,293,3,3,0,1,0
32,297,297,128,83,45,4,3
1,321,321,43,5,38,2,1
35,335,335,81,81,0,1,0
40,343,343,12,6,6,2,1
22,350,350,15,15,0,1,0
19,350,350,93,69,24,4,3
27,369,369,32,14,18,4,3
23,370,370,53,29,24,4,3
16,402,402,33,15,18,2,1
34,424,424,34,2,32,4,3
13,430,430,45,45,0,1,0
29,439,439,50,50,0,1,0
9,441,441,17,17,0,1,0
37,450,450,23,23,0,1,0
5,451,451,109,43,66,4,3
14,456,456,48,48,0,1,0
7,462,462,17,6,11,3,2
10,465,465,15,15,0,1,0
20,465,465,40,8,32,3,2
17,468,468,6,6,0,1,0
3,478,478,18,4,14,2,1
28,491,491,35,35,0,1,0

16,107,107,5,1,4,2,1
43,113,113,34,18,16,2,1
27,113,113,10,10,0,1,0
0,127,127,8,8,0,1,0
12,134,134,8,4,4,2,1
5,158,158,19,19,0,1,0
23,173,173,1,1,0,1,0
42,175,175,2,2,0,1,0
9,182,182,17,8,9,2,1
40,182,182,15,15,0,1,0
18,194,194,21,21,0,1,0
10,200,200,7,7,0,1,0
32,201,201,40,1,39,2,1
8,215,215,4,4,0,1,0
7,221,221,6,6,0,1,0
36,229,229,16,16,0,1,0
2,232,232,3,3,0,1,0
38,238,238,25,25,0,1,0
1,246,246,7,7,0,1,0
30,248,248,30,12,18,4,3
41,251,251,9,9,0,1,0
19,268,268,10,2,8,3,2
34,274,274,1,1,0,1,0
6,283,283,7,7,0,1,0
13,284,284,28,28,0,1,0
28,293,293,31,31,0,1,0
17,298,298,55,55,0,1,0
11,314,314,85,4,81,4,3
21,335,335,2,2,0,1,0
15,343,343,6,6,0,1,0
29,352,352,3,3,0,1,0
35,355,355,84,31,53,4,3
3,364,364,25,6,19,2,1
20,395,395,27,27,0,1,0
37,400,400,82,82,0,1,0
39,401,401,42,24,18,2,1
25,413,413,23,12,11,2,1
22,421,421,81,81,0,1,0
33,427,427,53,10,43,3,2
31,441,441,16,16,0,1,0
24,453,453,56,56,0,1,0
14,471,471,164,71,93,4,3
4,480,480,32,18,14,2,1
26,489,489,11,11,0,1,0

11,100,100,19,19,0,1,0
29,108,108,2,2,0,1,0
34,113,113,5,5,0,1,0
33,125,125,5,2,3,2,1
22,128,128,3,3,0,1,0
9,141,141,20,20,0,1,0
24,161,161,8,1,7,2,1
7,164,164,15,9,6,2,1
19,165,165,21,5,16,2,1
8,167,167,3,3,0,1,0
31,168,168,25,5,20,4,3
21,175,175,1,1,0,1,0
30,194,194,5,5,0,1,0
12,206,206,13,7,6,2,1
32,228,228,8,8,0,1,0
3,228,228,51,51,0,1,0
4,228,228,30,21,9,2,1
5,229,229,41,41,0,1,0
27,232,232,7,7,0,1,0
26,250,250,5,5,0,1,0
35,294,294,21,21,0,1,0
16,316,316,3,3,0,1,0
17,325,325,34,34,0,1,0
37,349,349,75,41,34,2,1
2,352,352,29,29,0,1,0
20,357,357,35,26,9,2,1
15,367,367,59,59,0,1,0
0,375,375,69,69,0,1,0
18,376,376,188,83,105,4,3
25,387,387,84,45,39,2,1
1,399,399,69,9,60,4,3
6,413,413,22,22,0,1,0
36,427,427,87,3,84,3,2
23,432,432,14,14,0,1,0
10,455,455,9,9,0,1,0
28,457,457,70,15,55,4,3
14,486,486,71,71,0,1,0
13,490,490,15,15,0,1,0

22,109,109,3,3,0,1,0
14,111,111,1,1,0,1,0
20,134,134,41,41,0,1,0
28,147,147,1,1,0,1,0
39,150,150,27,11,16,2,1
11,179,179,1,1,0,1,0
10,206,206,6,6,0,1,0
27,227,227,1,1,0,1,0
5,230,230,31,4,27,4,3
18,253,253,6,6,0,1,0
8,261,261,42,42,0,1,0
32,274,274,28,28,0,1,0
42,283,283,17,1,16,2,1
31,311,311,1,1,0,1,0
15,312,312,56,35,21,2,1
7,313,313,48,48,0,1,0
2,313,313,4,1,3,2,1
0,318,318,10,10,0,1,0
24,318,318,8,8,0,1,0
4,324,324,29,26,3,2,1
34,330,330,44,44,0,1,0
26,374,374,20,6,14,3,2
9,389,389,9,9,0,1,0
1,392,392,16,8,8,3,2
25,400,400,9,2,7,2,1
33,406,406,86,86,0,1,0
12,411,411,47,47,0,1,0
35,411,411,19,19,0,1,0
29,418,418,48,4,44,2,1
23,427,427,48,29,19,2,1
40,427,427,67,39,28,2,1
36,437,437,34,25,9,4,3
41,454,454,38,19,19,2,1
19,461,461,14,14,0,1,0
37,467,467,100,100,0,1,0
6,469,469,73,16,57,4,3
38,471,471,115,115,0,1,0
17,471,471,16,16,0,1,0
16,479,479,19,19,0,1,0
21,481,481,165,153,12,2,1
3,495,495,23,23,0,1,0
13,498,498,9,9,0,1,0
30,499,499,88,30,58,4,3

15,103,103,58,58,0,1,0
4,109,109,22,22,0,1,0
21,119,119,10,3,7,2,1
2,124,124,13,13,0,1,0
8,128,128,8,5,3,2,1
30,128,128,5,5,0,1,0
10,132,132,26,26,0,1,0
14,148,148,18,6,12,4,3
0,149,149,1,1,0,1,0
32,168,168,17,17,0,1,0
13,187,187,6,6,0,1,0
6,209,209,4,4,0,1,0
18,215,215,2,2,0,1,0
17,217,217,8,8,0,1,0
20,223,223,7,7,0,1,0
23,227,227,8,8,0,1,0
12,228,228,7,4,3,2,1
11,231,231,77,39,38,3,2
24,249,249,9,9,0,1,0
3,255,255,5,5,0,1,0
5,288,288,23,23,0,1,0
16,289,289,3,3,0,1,0
7,321,321,5,5,0,1,0
19,323,323,5,1,4,2,1
34,357,357,26,13,13,2,1
36,362,362,83,23,60,4,3
28,375,375,14,14,0,1,0
9,377,377,15,15,0,1,0
27,392,392,78,68,10,3,2
26,401,401,5,1,4,2,1
33,401,401,30,30,0,1,0
22,408,408,68,68,0,1,0
35,439,439,107,71,36,2,1
25,444,444,2,2,0,1,0
29,477,477,41,41,0,1,0
31,478,478,130,127,3,2,1
1,487,487,63,41,22,2,1
37,494,494,143,47,96,4,3

26,107,107,2,2,0,1,0
34,113,113,9,1,8,3,2
18,121,121,9,3,6,3,2
42,127,127,11,4,7,2,1
36,128,128,19,19,0,1,0
19,134,134,33,9,24,3,2
44,134,134,2,2,0,1,0
8,145,145,10,10,0,1,0
39,146,146,3,3,0,1,0
11,160,160,8,8,0,1,0
4,173,173,3,3,0,1,0
37,177,177,29,1,28,3,2
9,179,179,14,14,0,1,0
23,185,185,1,1,0,1,0
12,191,191,6,3,3,2,1
13,195,195,19,1,18,4,3
33,207,207,4,4,0,1,0
1,226,226,4,4,0,1,0
40,231,231,36,22,14,2,1
7,267,267,5,5,0,1,0
29,274,274,22,22,0,1,0
6,275,275,5,5,0,1,0
32,277,277,32,5,27,2,1
21,280,280,78,78,0,1,0
15,313,313,28,28,0,1,0
35,317,317,2,2,0,1,0
5,319,319,18,3,15,4,3
0,335,335,23,23,0,1,0
22,338,338,63,63,0,1,0
24,346,346,23,16,7,2,1
30,346,346,146,146,0,1,0
41,365,365,30,30,0,1,0
2,366,366,11,2,9,2,1
14,379,379,9,9,0,1,0
38,386,386,139,1,138,4,3
17,390,390,1,1,0,1,0
43,395,395,3,3,0,1,0
28,404,404,11,5,6,3,2
45,411,411,36,36,0,1,0
16,413,413,76,76,0,1,0
31,419,419,38,2,36,4,3
3,419,419,60,60,0,1,0
25,420,420,33,33,0,1,0
10,449,449,11,11,0,1,0
20,472,472,21,21,0,1,0
27,497,497,26,26,0,1,0

14,104,104,8,1,7,2,1
29,105,105,8,4,4,2,1
32,107,107,4,1,3,2,1
35,113,113,5,5,0,1,0
30,120,120,16,16,0,1,0
39,128,128,5,5,0,1,0
40,132,132,19,7,12,3,2
18,137,137,26,26,0,1,0
7,161,161,1,1,0,1,0
38,164,164,2,2,0,1,0
23,172,172,34,34,0,1,0
0,187,187,40,40,0,1,0
4,202,202,1,1,0,1,0
33,221,221,37,25,12,2,1
2,231,231,45,16,29,4,3
24,242,242,9,9,0,1,0
11,256,256,2,2,0,1,0
27,257,257,7,7,0,1,0
12,259,259,25,1,24,2,1
25,261,261,33,18,15,4,3
13,279,279,37,32,5,2,1
34,286,286,19,1,18,4,3
16,298,298,35,8,27,2,1
26,300,300,88,40,48,4,3
9,334,334,32,32,0,1,0
15,366,366,33,33,0,1,0
5,374,374,48,48,0,1,0
21,377,377,50,28,22,2,1
28,405,405,26,10,16,3,2
37,410,410,9,9,0,1,0
20,416,416,3,3,0,1,0
1,429,429,2,2,0,1,0
22,429,429,116,22,94,3,2
31,436,436,59,54,5,2,1
3,437,437,74,74,0,1,0
17,442,442,58,58,0,1,0
19,449,449,27,27,0,1,0
6,464,464,32,32,0,1,0
10,482,482,27,9,18,4,3
36,490,490,13,13,0,1,0
8,499,499,74,74,0,1,0

27,110,110,1,1,0,1,0
36,120,120,4,4,0,1,0
48,130,130,15,7,8,3,2
12,164,164,6,6,0,1,0
31,164,164,5,5,0,1,0
28,189,189,5,5,0,1,0
2,193,193,32,32,0,1,0
39,195,195,10,2,8,3,2
9,216,216,10,4,6,2,1
16,222,222,12,12,0,1,0
22,224,224,4,4,0,1,0
35,265,265,48,18,30,2,1
5,275,275,7,1,6,3,2
10,283,283,5,1,4,2,1
40,292,292,11,11,0,1,0
49,300,300,57,48,9,4,3
20,306,306,34,34,0,1,0
18,314,314,11,1,10,3,2
29,315,315,4,1,3,2,1
45,321,321,4,4,0,1,0
46,323,323,30,30,0,1,0
0,333,333,2,2,0,1,0
19,335,335,1,1,0,1,0
24,335,335,18,8,10,2,1
25,337,337,7,7,0,1,0
21,355,355,32,10,22,3,2
26,361,361,2,2,0,1,0
43,365,365,4,4,0,1,0
13,373,373,75,42,33,4,3
32,386,386,38,20,18,4,3
33,386,386,6,6,0,1,0
7,387,387,74,61,13,2,1
38,392,392,45,21,24,2,1
14,395,395,61,61,0,1,0
6,397,397,102,102,0,1,0
41,401,401,85,12,73,3,2
34,409,409,148,148,0,1,0
44,412,412,82,82,0,1,0
23,425,425,37,37,0,1,0
11,425,425,42,25,17,2,1
37,427,427,34,34,0,1,0
3,432,432,15,8,7,2,1
17,439,439,3,3,0,1,0
15,443,443,2,2,0,1,0
1,445,445,51,51,0,1,0
50,445,445,65,65,0,1,0
47,453,453,2,2,0,1,0
30,457,457,33,11,22,4,3
8,457,457,7,7,0,1,0
42,465,465,21,21,0,1,0
4,487,487,13,1,12,4,3

11,110,110,8,2,6,3,2
28,141,141,13,13,0,1,0
13,143,143,12,12,0,1,0
35,168,168,26,26,0,1,0
27,170,170,70,1,69,4,3
31,194,194,43,43,0,1,0
9,206,206,22,22,0,1,0
5,208,208,31,12,19,2,1
29,226,226,28,11,17,2,1
23,251,251,26,26,0,1,0
4,253,253,41,41,0,1,0
26,254,254,22,22,0,1,0
22,255,255,51,39,12,4,3
18,255,255,3,3,0,1,0
19,278,278,4,4,0,1,0
30,287,287,16,16,0,1,0
25,294,294,5,5,0,1,0
24,296,296,4,4,0,1,0
10,298,298,49,29,20,2,1
36,313,313,21,1,20,3,2
12,317,317,45,45,0,1,0
8,324,324,19,13,6,2,1
20,333,333,6,6,0,1,0
2,351,351,94,12,82,4,3
14,351,351,1,1,0,1,0
17,372,372,73,49,24,4,3
32,404,404,106,25,81,4,3
7,411,411,41,41,0,1,0
16,423,423,33,33,0,1,0
37,452,452,19,19,0,1,0
33,452,452,20,8,12,3,2
21,456,456,20,7,13,2,1
1,466,466,35,35,0,1,0
34,473,473,27,11,16,2,1
15,479,479,8,8,0,1,0
6,490,490,47,47,0,1,0
0,493,493,65,39,26,2,1
3,497,497,48,16,32,2,1

7,115,115,4,4,0,1,0
13,118,118,13,13,0,1,0
35,123,123,36,15,21,3,2
15,152,152,23,18,5,2,1
36,163,163,11,11,0,1,0
37,181,181,13,13,0,1,0
8,187,187,16,16,0,1,0
29,220,220,11,3,8,3,2
10,224,224,73,73,0,1,0
25,225,225,35,18,17,3,2
27,229,229,6,6,0,1,0
3,253,253,20,5,15,2,1
14,259,259,2,2,0,1,0
5,259,259,9,9,0,1,0
1,271,271,17,10,7,2,1
30,275,275,23,11,12,4,3
0,278,278,47,47,0,1,0
20,296,296,64,43,21,3,2
39,310,310,58,37,21,4,3
22,319,319,1,1,0,1,0
4,324,324,23,23,0,1,0
23,329,329,3,3,0,1,0
19,350,350,43,43,0,1,0
17,353,353,40,32,8,3,2
11,365,365,4,4,0,1,0
26,373,373,175,28,147,4,3
33,379,379,33,19,14,3,2
12,397,397,38,38,0,1,0
24,412,412,22,14,8,3,2
9,415,415,6,6,0,1,0
2,437,437,31,1,30,3,2
18,444,444,83,83,0,1,0
38,456,456,8,8,0,1,0
6,463,463,110,110,0,1,0
28,471,471,12,1,11,2,1
21,474,474,35,35,0,1,0
34,479,479,53,53,0,1,0
16,484,484,8,8,0,1,0
32,485,485,12,12,0,1,0
31,488,488,5,5,0,1,0

2,104,104,19,1,18,3,2
22,108,108,1,1,0,1,0
26,109,109,1,1,0,1,0
41,133,133,1,1,0,1,0
37,136,136,16,16,0,1,0
9,140,140,7,7,0,1,0
7,147,147,5,2,3,2,1
44,153,153,22,12,10,3,2
11,167,167,9,9,0,1,0
21,203,203,13,13,0,1,0
17,215,215,1,1,0,1,0
5,227,227,23,2,21,2,1
3,248,248,9,9,0,1,0
36,257,257,9,9,0,1,0
38,266,266,24,15,9,2,1
35,268,268,97,60,37,2,1
32,270,270,13,13,0,1,0
46,283,283,24,24,0,1,0
15,295,295,20,20,0,1,0
0,303,303,10,10,0,1,0
10,309,309,18,18,0,1,0
12,310,310,37,37,0,1,0
13,318,318,10,4,6,3,2
23,328,328,4,4,0,1,0
31,330,330,6,6,0,1,0
43,331,331,24,24,0,1,0
16,333,333,6,6,0,1,0
14,338,338,59,55,4,2,1
29,356,356,1,1,0,1,0
4,358,358,99,9,90,3,2
8,364,364,24,11,13,3,2
34,365,365,4,4,0,1,0
42,365,365,80,69,11,2,1
40,371,371,42,42,0,1,0
1,378,378,33,33,0,1,0
27,408,408,58,58,0,1,0
33,411,411,89,35,54,3,2
6,440,440,7,7,0,1,0
45,440,440,47,33,14,3,2
39,449,449,77,77,0,1,0
30,453,453,9,4,5,2,1
25,456,456,40,8,32,2,1
24,461,461,33,15,18,4,3
19,469,469,48,48,0,1,0
18,476,476,87,69,18,2,1
20,491,491,29,29,0,1,0
28,497,497,24,24,0,1,0

31,116,116,10,10,0,1,0
12,121,121,3,3,0,1,0
4,122,122,3,3,0,1,0
32,158,158,43,18,25,2,1
5,162,162,118,118,0,1,0
29,168,168,2,2,0,1,0
19,170,170,4,1,3,2,1
34,174,174,28,28,0,1,0
17,174,174,27,27,0,1,0
35,202,202,1,1,0,1,0
6,228,228,1,1,0,1,0
14,249,249,1,1,0,1,0
24,271,271,19,19,0,1,0
1,272,272,3,3,0,1,0
38,284,284,79,52,27,4,3
9,291,291,13,13,0,1,0
16,300,300,4,4,0,1,0
36,306,306,1,1,0,1,0
22,315,315,43,13,30,4,3
15,320,320,49,49,0,1,0
10,326,326,25,14,11,2,1
33,330,330,10,4,6,3,2
27,330,330,10,1,9,4,3
7,355,355,1,1,0,1,0
2,358,358,88,88,0,1,0
23,361,361,11,3,8,2,1
11,367,367,133,94,39,4,3
18,391,391,4,4,0,1,0
25,397,397,211,142,69,4,3
26,408,408,37,37,0,1,0
28,423,423,3,3,0,1,0
8,425,425,15,5,10,2,1
3,442,442,1,1,0,1,0
30,448,448,11,11,0,1,0
0,448,448,35,20,15,4,3
21,457,457,79,79,0,1,0
20,457,457,20,20,0,1,0
37,461,461,9,1,8,2,1
13,499,499,12,12,0,1,0

28,108,108,17,17,0,1,0
27,114,114,8,5,3,2,1
15,114,114,2,2,0,1,0
18,132,132,6,6,0,1,0
26,138,138,20,8,12,2,1
19,142,142,6,1,5,2,1
30,148,148,32,8,24,3,2
17,164,164,6,2,4,2,1
29,167,167,5,5,0,1,0
25,176,176,4,4,0,1,0
3,195,195,1,1,0,1,0
1,242,242,25,4,21,2,1
0,243,243,64,64,0,1,0
21,248,248,1,1,0,1,0
31,252,252,23,9,14,2,1
9,259,259,3,3,0,1,0
22,264,264,50,7,43,2,1
5,284,284,95,86,9,4,3
40,285,285,58,58,0,1,0
11,291,291,110,110,0,1,0
13,301,301,9,1,8,2,1
12,306,306,17,17,0,1,0
39,321,321,3,3,0,1,0
2,329,329,24,24,0,1,0
23,333,333,16,16,0,1,0
16,336,336,12,2,10,4,3
32,348,348,68,16,52,3,2
6,410,410,59,9,50,4,3
35,414,414,30,30,0,1,0
4,429,429,41,14,27,2,1
14,432,432,17,17,0,1,0
7,438,438,20,6,14,3,2
8,439,439,52,16,36,2,1
20,443,443,43,10,33,2,1
37,455,455,19,19,0,1,0
34,465,465,25,25,0,1,0
10,476,476,14,14,0,1,0
24,480,480,31,31,0,1,0
38,483,483,46,34,12,2,1
33,484,484,29,29,0,1,0
36,499,499,133,133,0,1,0

26,110,110,33,33,0,1,0
5,117,117,7,7,0,1,0
19,122,122,9,9,0,1,0
33,125,125,14,9,5,2,1
11,131,131,1,1,0,1,0
31,135,135,9,9,0,1,0
10,140,140,41,10,31,2,1
35,163,163,18,3,15,4,3
25,167,167,15,9,6,3,2
12,174,174,1,1,0,1,0
0,178,178,5,2,3,2,1
32,189,189,8,1,7,2,1
3,212,212,46,46,0,1,0
39,256,256,7,7,0,1,0
30,256,256,13,1,12,4,3
1,257,257,20,7,13,3,2
38,266,266,3,3,0,1,0
15,269,269,13,2,11,2,1
20,273,273,54,30,24,3,2
36,279,279,5,5,0,1,0
2,298,298,5,5,0,1,0
4,299,299,62,62,0,1,0
29,307,307,20,6,14,3,2
24,315,315,120,74,46,2,1
16,354,354,37,3,34,2,1
9,363,363,23,4,19,2,1
18,372,372,63,6,57,4,3
27,382,382,25,25,0,1,0
8,402,402,3,3,0,1,0
6,406,406,35,35,0,1,0
17,408,408,101,89,12,3,2
37,410,410,1,1,0,1,0
22,427,427,17,17,0,1,0
14,463,463,106,72,34,4,3
21,467,467,14,5,9,4,3
23,470,470,83,22,61,4,3
34,477,477,73,31,42,2,1
13,486,486,1,1,0,1,0
7,487,487,28,18,10,2,1
28,495,495,53,17,36,2,1

3,112,112,3,3,0,1,0
7,113,113,6,6,0,1,0
14,115,115,2,2,0,1,0
40,120,120,16,16,0,1,0
10,131,131,3,3,0,1,0
0,142,142,6,6,0,1,0
35,144,144,13,13,0,1,0
18,150,150,3,3,0,1,0
16,155,155,4,4,0,1,0
39,181,181,14,14,0,1,0
8,190,190,34,34,0,1,0
9,204,204,35,1,34,3,2
22,206,206,1,1,0,1,0
4,225,225,49,49,0,1,0
12,229,229,31,31,0,1,0
20,243,243,40,23,17,2,1
29,270,270,12,3,9,4,3
28,285,285,14,2,12,2,1
25,295,295,8,1,7,2,1
15,301,301,8,8,0,1,0
1,304,304,1,1,0,1,0
21,315,315,11,11,0,1,0
30,317,317,5,5,0,1,0
36,322,322,21,12,9,2,1
24,324,324,72,3,69,4,3
38,355,355,27,27,0,1,0
5,364,364,38,29,9,4,3
42,368,368,35,35,0,1,0
33,372,372,23,14,9,4,3
41,382,382,12,8,4,2,1
32,382,382,253,217,36,4,3
11,391,391,6,6,0,1,0
2,404,404,14,14,0,1,0
43,430,430,23,2,21,2,1
6,438,438,39,3,36,4,3
23,442,442,58,16,42,3,2
31,447,447,27,11,16,2,1
34,455,455,19,7,12,2,1
27,463,463,44,2,42,2,1
19,466,466,7,7,0,1,0
26,469,469,20,15,5,2,1
37,481,481,44,44,0,1,0
13,483,483,29,15,14,2,1
17,494,494,200,125,75,3,2

15,112,112,27,1,26,3,2
29,132,132,9,3,6,3,2
30,134,134,2,2,0,1,0
7,137,137,24,24,0,1,0
6,151,151,41,41,0,1,0
1,160,160,4,4,0,1,0
26,168,168,18,18,0,1,0
3,177,177,51,12,39,3,2
13,179,179,10,1,9,4,3
20,193,193,16,16,0,1,0
21,210,210,11,4,7,2,1
33,214,214,11,11,0,1,0
18,214,214,11,11,0,1,0
0,251,251,9,9,0,1,0
19,256,256,28,12,16,3,2
24,266,266,4,1,3,2,1
28,273,273,112,34,78,3,2
22,285,285,28,6,22,3,2
34,304,304,6,6,0,1,0
16,315,315,29,7,22,3,2
4,318,318,39,1,38,2,1
12,322,322,41,11,30,2,1
27,337,337,46,46,0,1,0
5,337,337,41,41,0,1,0
9,350,350,13,13,0,1,0
10,351,351,3,3,0,1,0
14,365,365,46,34,12,4,3
11,372,372,38,22,16,2,1
8,376,376,139,12,127,4,3
23,402,402,51,7,44,3,2
32,403,403,53,53,0,1,0
31,413,413,11,11,0,1,0
17,426,426,49,49,0,1,0
25,429,429,43,43,0,1,0
2,473,473,64,64,0,1,0

14,112,112,4,4,0,1,0
27,114,114,7,7,0,1,0
23,123,123,5,5,0,1,0
34,126,126,2,2,0,1,0
0,142,142,9,6,3,2,1
35,142,142,1,1,0,1,0
7,145,145,5,5,0,1,0
26,152,152,24,24,0,1,0
15,165,165,1,1,0,1,0
13,167,167,8,8,0,1,0
5,169,169,16,16,0,1,0
9,187,187,60,60,0,1,0
6,203,203,5,1,4,2,1
8,208,208,4,4,0,1,0
10,241,241,54,18,36,2,1
29,275,275,16,16,0,1,0
16,280,280,1,1,0,1,0
33,289,289,75,75,0,1,0
37,322,322,38,38,0,1,0
22,323,323,37,37,0,1,0
30,324,324,4,4,0,1,0
19,326,326,77,77,0,1,0
28,352,352,104,29,75,4,3
25,371,371,22,2,20,4,3
2,377,377,11,11,0,1,0
24,390,390,66,36,30,2,1
4,406,406,51,51,0,1,0
1,414,414,75,75,0,1,0
32,415,415,67,67,0,1,0
12,417,417,48,24,24,4,3
38,420,420,4,4,0,1,0
17,427,427,14,14,0,1,0
3,427,427,16,11,5,2,1
21,436,436,15,15,0,1,0
11,439,439,23,23,0,1,0
18,440,440,139,121,18,4,3
36,442,442,62,55,7,2,1
31,456,456,19,19,0,1,0
39,466,466,127,93,34,3,2
20,481,481,5,5,0,1,0

13,110,110,1,1,0,1,0
0,111,111,10,10,0,1,0
19,118,118,2,2,0,1,0
23,120,120,31,31,0,1,0
21,137,137,10,4,6,3,2
17,142,142,11,3,8,2,1
20,160,160,13,7,6,3,2
1,181,181,13,6,7,2,1
30,184,184,2,2,0,1,0
31,185,185,13,13,0,1,0
24,185,185,6,6,0,1,0
4,186,186,10,1,9,4,3
15,213,213,4,4,0,1,0
28,215,215,13,13,0,1,0
27,224,224,103,103,0,1,0
18,235,235,46,4,42,2,1
8,245,245,18,18,0,1,0
2,248,248,217,139,78,4,3
12,251,251,33,6,27,4,3
26,253,253,27,6,21,2,1
9,260,260,10,4,6,3,2
32,300,300,23,23,0,1,0
25,302,302,68,68,0,1,0
5,325,325,2,2,0,1,0
11,333,333,73,3,70,3,2
22,352,352,10,10,0,1,0
7,384,384,4,1,3,2,1
14,385,385,32,13,19,2,1
29,388,388,3,3,0,1,0
6,403,403,78,78,0,1,0
16,428,428,30,30,0,1,0
33,461,461,10,10,0,1,0
3,471,471,63,12,51,4,3
34,481,481,78,55,23,2,1
10,499,499,6,6,0,1,0

27,108,108,23,6,17,3,2
10,122,122,19,1,18,4,3
15,138,138,17,17,0,1,0
29,147,147,39,19,20,3,2
24,158,158,3,3,0,1,0
30,167,167,6,2,4,2,1
0,172,172,73,5,68,3,2
5,180,180,6,2,4,2,1
4,185,185,14,14,0,1,0
35,186,186,25,25,0,1,0
14,198,198,8,8,0,1,0
23,199,199,6,1,5,2,1
19,211,211,3,3,0,1,0
36,219,219,27,7,20,2,1
21,229,229,36,36,0,1,0
16,233,233,50,22,28,2,1
31,253,253,5,5,0,1,0
1,259,259,95,45,50,2,1
33,260,260,58,5,53,4,3
6,261,261,6,6,0,1,0
7,264,264,1,1,0,1,0
2,292,292,23,12,11,2,1
34,292,292,24,3,21,3,2
32,293,293,15,15,0,1,0
11,295,295,2,2,0,1,0
17,299,299,33,1,32,3,2
20,313,313,52,52,0,1,0
25,313,313,22,6,16,3,2
13,335,335,20,20,0,1,0
37,338,338,39,39,0,1,0
9,345,345,41,41,0,1,0
26,361,361,56,56,0,1,0
3,364,364,7,7,0,1,0
18,384,384,6,6,0,1,0
22,400,400,36,4,32,4,3
8,445,445,37,37,0,1,0
28,458,458,27,27,0,1,0
12,474,474,31,31,0,1,0

29,104,104,10,10,0,1,0
26,112,112,13,13,0,1,0
11,120,120,10,1,9,2,1
32,133,133,1,1,0,1,0
20,140,140,23,5,18,2,1
1,167,167,21,21,0,1,0
13,182,182,7,7,0,1,0
35,183,183,5,2,3,2,1
30,185,185,4,4,0,1,0
36,186,186,14,4,10,3,2
18,197,197,37,37,0,1,0
4,213,213,5,5,0,1,0
5,223,223,4,4,0,1,0
22,228,228,44,20,24,2,1
41,237,237,54,9,45,4,3
37,255,255,44,44,0,1,0
17,259,259,3,3,0,1,0
8,280,280,24,12,12,4,3
0,297,297,15,15,0,1,0
34,301,301,73,60,13,2,1
28,309,309,21,9,12,3,2
12,316,316,6,6,0,1,0
7,324,324,8,3,5,2,1
19,328,328,34,34,0,1,0
42,334,334,35,35,0,1,0
25,338,338,75,15,60,3,2
38,339,339,4,4,0,1,0
31,342,342,94,94,0,1,0
15,358,358,18,10,8,3,2
6,361,361,15,15,0,1,0
3,385,385,24,9,15,2,1
27,393,393,2,2,0,1,0
23,396,396,5,5,0,1,0
24,397,397,3,3,0,1,0
33,423,423,59,59,0,1,0
9,424,424,49,7,42,3,2
14,454,454,1,1,0,1,0
16,461,461,25,13,12,2,1
39,464,464,68,57,11,4,3
10,469,469,80,8,72,4,3
2,480,480,123,89,34,3,2
40,486,486,33,3,30,3,2
21,497,497,59,9,50,2,1

40,101,101,14,14,0,1,0
29,114,114,14,10,4,2,1
17,137,137,4,4,0,1,0
36,142,142,4,4,0,1,0
1,145,145,10,1,9,2,1
5,147,147,13,13,0,1,0
13,154,154,20,5,15,2,1
4,155,155,14,5,9,4,3
10,158,158,22,2,20,2,1
15,160,160,17,12,5,2,1
37,160,160,5,5,0,1,0
2,168,168,9,3,6,3,2
0,173,173,5,5,0,1,0
45,185,185,26,1,25,2,1
21,191,191,17,11,6,2,1
27,194,194,5,5,0,1,0
3,206,206,14,14,0,1,0
12,211,211,3,3,0,1,0
41,218,218,44,44,0,1,0
38,229,229,13,1,12,4,3
8,260,260,21,21,0,1,0
14,261,261,10,10,0,1,0
44,270,270,45,25,20,3,2
16,271,271,24,12,12,2,1
32,282,282,13,4,9,4,3
42,284,284,29,1,28,2,1
18,285,285,19,9,10,3,2
11,286,286,2,2,0,1,0
7,293,293,6,6,0,1,0
23,311,311,64,64,0,1,0
28,336,336,49,49,0,1,0
35,345,345,28,3,25,2,1
26,357,357,14,14,0,1,0
19,387,387,2,2,0,1,0
24,389,389,24,24,0,1,0
9,394,394,3,3,0,1,0
20,404,404,31,13,18,3,2
33,406,406,12,12,0,1,0
6,409,409,90,6,84,4,3
31,417,417,84,26,58,3,2
30,420,420,23,3,20,3,2
34,431,431,53,53,0,1,0
22,470,470,76,76,0,1,0
25,492,492,27,12,15,4,3
43,493,493,122,122,0,1,0
39,495,495,32,32,0,1,0

17,106,106,13,8,5,2,1
44,128,128,20,9,11,2,1
24,144,144,19,4,15,4,3
12,149,149,39,39,0,1,0
25,153,153,20,20,0,1,0
41,155,155,65,17,48,4,3
20,160,160,36,12,24,4,3
4,171,171,6,6,0,1,0
13,180,180,61,61,0,1,0
33,181,181,35,3,32,3,2
35,185,185,32,17,15,2,1
43,188,188,25,2,23,2,1
7,204,204,6,6,0,1,0
0,215,215,10,10,0,1,0
3,215,215,35,35,0,1,0
8,216,216,5,5,0,1,0
21,229,229,2,2,0,1,0
38,241,241,1,1,0,1,0
9,244,244,10,10,0,1,0
15,255,255,27,27,0,1,0
28,256,256,6,6,0,1,0
32,257,257,14,14,0,1,0
29,274,274,13,13,0,1,0
19,282,282,4,4,0,1,0
39,282,282,9,2,7,2,1
1,286,286,1,1,0,1,0
6,293,293,28,7,21,4,3
40,308,308,2,2,0,1,0
5,317,317,1,1,0,1,0
16,337,337,8,8,0,1,0
11,347,347,4,1,3,2,1
14,357,357,12,5,7,2,1
30,384,384,16,16,0,1,0
10,386,386,15,15,0,1,0
37,388,388,48,48,0,1,0
31,410,410,2,2,0,1,0
2,419,419,17,6,11,2,1
23,421,421,18,6,12,3,2
34,433,433,96,16,80,4,3
42,436,436,38,14,24,2,1
36,446,446,10,6,4,2,1
27,455,455,68,68,0,1,0
22,462,462,54,54,0,1,0
26,476,476,7,7,0,1,0
18,491,491,24,24,0,1,0

33,101,101,2,2,0,1,0
23,105,105,12,12,0,1,0
18,118,118,10,5,5,2,1
1,152,152,20,7,13,2,1
9,162,162,17,17,0,1,0
21,201,201,12,12,0,1,0
32,204,204,13,3,10,2,1
6,220,220,46,8,38,3,2
29,224,224,8,8,0,1,0
30,228,228,20,20,0,1,0
2,231,231,11,6,5,2,1
7,234,234,56,12,44,3,2
5,249,249,3,3,0,1,0
28,258,258,29,4,25,3,2
12,258,258,16,16,0,1,0
13,259,259,8,8,0,1,0
10,259,259,6,6,0,1,0
25,260,260,27,14,13,2,1
19,271,271,18,2,16,3,2
14,273,273,204,83,121,4,3
4,281,281,33,9,24,4,3
16,307,307,24,24,0,1,0
34,324,324,32,32,0,1,0
20,329,329,57,57,0,1,0
17,344,344,30,30,0,1,0
24,356,356,90,53,37,2,1
35,358,358,28,7,21,4,3
3,359,359,22,22,0,1,0
0,361,361,5,5,0,1,0
8,381,381,30,30,0,1,0
15,406,406,2,2,0,1,0
11,435,435,51,31,20,2,1
22,437,437,27,27,0,1,0
26,472,472,108,63,45,3,2
31,478,478,42,42,0,1,0
27,490,490,76,76,0,1,0

3,152,152,2,2,0,1,0
32,163,163,3,3,0,1,0
37,183,183,28,28,0,1,0
25,184,184,35,35,0,1,0
36,189,189,87,27,60,4,3
10,193,193,27,27,0,1,0
22,240,240,6,6,0,1,0
38,249,249,7,7,0,1,0
27,263,263,30,11,19,2,1
20,264,264,24,10,14,3,2
35,267,267,51,35,16,3,2
24,267,267,1,1,0,1,0
13,269,269,44,44,0,1,0
21,290,290,2,2,0,1,0
41,312,312,56,56,0,1,0
40,314,314,4,4,0,1,0
30,329,329,56,13,43,2,1
0,338,338,3,3,0,1,0
23,340,340,8,8,0,1,0
2,344,344,17,4,13,2,1
31,344,344,37,12,25,2,1
5,349,349,45,45,0,1,0
14,350,350,18,8,10,2,1
39,371,371,39,39,0,1,0
11,377,377,58,13,45,2,1
29,397,397,10,10,0,1,0
8,399,399,118,118,0,1,0
1,400,400,40,13,27,2,1
33,401,401,12,12,0,1,0
34,414,414,27,9,18,3,2
15,418,418,83,22,61,4,3
9,419,419,33,33,0,1,0
17,423,423,13,4,9,4,3
28,426,426,5,5,0,1,0
16,431,431,9,9,0,1,0
18,435,435,9,9,0,1,0
26,436,436,57,48,9,4,3
19,453,453,78,78,0,1,0
7,456,456,13,13,0,1,0
4,465,465,1,1,0,1,0
12,475,475,75,51,24,4,3
6,492,492,44,44,0,1,0

31,101,101,18,7,11,2,1
19,102,102,35,35,0,1,0
26,114,114,30,1,29,2,1
5,120,120,3,3,0,1,0
38,126,126,6,6,0,1,0
15,127,127,1,1,0,1,0
22,145,145,17,11,6,3,2
20,149,149,2,2,0,1,0
18,155,155,25,10,15,2,1
11,157,157,9,4,5,2,1
36,157,157,2,2,0,1,0
0,170,170,43,14,29,2,1
33,172,172,6,6,0,1,0
23,185,185,1,1,0,1,0
32,186,186,12,12,0,1,0
12,189,189,8,2,6,3,2
8,192,192,12,12,0,1,0
30,225,225,37,37,0,1,0
14,231,231,20,4,16,2,1
27,262,262,6,6,0,1,0
25,281,281,3,3,0,1,0
17,302,302,1,1,0,1,0
2,308,308,1,1,0,1,0
24,331,331,26,9,17,2,1
35,333,333,42,1,41,2,1
34,333,333,27,27,0,1,0
16,343,343,40,14,26,2,1
37,354,354,17,17,0,1,0
42,364,364,50,40,10,3,2
40,364,364,158,154,4,2,1
3,374,374,57,57,0,1,0
44,375,375,13,3,10,3,2
9,376,376,44,20,24,4,3
13,385,385,2,2,0,1,0
10,387,387,40,2,38,3,2
21,397,397,24,24,0,1,0
4,409,409,1,1,0,1,0
41,414,414,9,1,8,2,1
1,418,418,7,3,4,2,1
45,420,420,19,19,0,1,0
28,446,446,81,81,0,1,0
29,450,450,27,27,0,1,0
39,467,467,29,29,0,1,0
43,490,490,15,6,9,2,1
7,490,490,63,4,59,4,3
6,498,498,14,14,0,1,0

4,113,113,10,10,0,1,0
7,113,113,2,2,0,1,0
30,127,127,4,4,0,1,0
38,127,127,13,13,0,1,0
26,130,130,4,4,0,1,0
22,136,136,8,8,0,1,0
17,139,139,4,4,0,1,0
28,142,142,6,3,3,2,1
41,152,152,22,4,18,3,2
21,162,162,1,1,0,1,0
18,184,184,3,3,0,1,0
12,196,196,1,1,0,1,0
35,198,198,33,26,7,2,1
29,199,199,33,33,0,1,0
16,221,221,79,22,57,4,3
3,246,246,20,3,17,4,3
34,257,257,2,2,0,1,0
24,261,261,25,10,15,4,3
15,261,261,43,16,27,2,1
5,280,280,1,1,0,1,0
14,284,284,14,5,9,4,3
8,294,294,9,1,8,2,1
25,303,303,127,66,61,3,2
36,317,317,9,9,0,1,0
6,329,329,48,48,0,1,0
31,330,330,27,27,0,1,0
0,345,345,38,38,0,1,0
2,363,363,7,7,0,1,0
11,363,363,89,89,0,1,0
39,363,363,61,61,0,1,0
20,378,378,32,14,18,3,2
9,381,381,108,105,3,2,1
19,384,384,62,29,33,2,1
23,408,408,1,1,0,1,0
32,408,408,55,25,30,3,2
40,418,418,23,23,0,1,0
10,435,435,9,5,4,2,1
27,435,435,65,53,12,4,3
42,448,448,40,40,0,1,0
13,452,452,1,1,0,1,0
33,473,473,8,1,7,2,1
37,479,479,50,50,0,1,0
1,486,486,11,8,3,2,1

23,105,105,16,16,0,1,0
33,105,105,4,4,0,1,0
5,118,118,11,1,10,2,1
36,137,137,2,2,0,1,0
17,185,185,30,30,0,1,0
8,191,191,41,41,0,1,0
12,205,205,45,31,14,3,2
2,208,208,36,16,20,2,1
37,219,219,10,10,0,1,0
26,233,233,27,27,0,1,0
32,239,239,15,3,12,2,1
21,246,246,11,11,0,1,0
31,265,265,63,36,27,4,3
35,290,290,23,19,4,2,1
28,297,297,23,1,22,3,2
38,309,309,29,29,0,1,0
7,321,321,6,6,0,1,0
11,321,321,1,1,0,1,0
0,323,323,8,8,0,1,0
18,324,324,37,28,9,4,3
19,326,326,3,3,0,1,0
14,334,334,12,12,0,1,0
27,338,338,2,2,0,1,0
10,354,354,32,1,31,4,3
16,355,355,9,4,5,2,1
3,360,360,42,42,0,1,0
6,381,381,4,1,3,2,1
30,381,381,35,35,0,1,0
15,400,400,43,43,0,1,0
24,412,412,11,11,0,1,0
9,415,415,125,118,7,2,1
22,419,419,9,9,0,1,0
20,420,420,127,80,47,3,2
13,451,451,1,1,0,1,0
4,456,456,45,2,43,4,3
25,466,466,99,61,38,2,1
1,466,466,89,32,57,4,3
34,467,467,56,2,54,3,2
29,480,480,137,61,76,3,2

20,112,112,1,1,0,1,0
42,139,139,1,1,0,1,0
9,141,141,8,8,0,1,0
5,153,153,5,5,0,1,0
28,167,167,50,36,14,3,2
25,171,171,14,6,8,2,1
7,173,173,2,2,0,1,0
17,182,182,19,19,0,1,0
29,183,183,15,6,9,4,3
36,193,193,2,2,0,1,0
24,196,196,20,20,0,1,0
12,217,217,2,2,0,1,0
2,218,218,15,6,9,2,1
11,223,223,26,16,10,2,1
1,226,226,25,25,0,1,0
40,234,234,9,9,0,1,0
8,235,235,33,6,27,2,1
34,235,235,64,64,0,1,0
35,237,237,6,6,0,1,0
6,245,245,98,98,0,1,0
33,253,253,43,30,13,2,1
3,262,262,66,37,29,2,1
21,270,270,17,1,16,3,2
10,271,271,14,14,0,1,0
22,273,273,63,19,44,3,2
16,303,303,3,3,0,1,0
26,315,315,43,43,0,1,0
4,354,354,1,1,0,1,0
19,359,359,37,37,0,1,0
18,360,360,1,1,0,1,0
27,362,362,42,3,39,2,1
41,370,370,31,31,0,1,0
15,384,384,29,10,19,2,1
13,394,394,8,3,5,2,1
31,404,404,16,4,12,2,1
39,410,410,22,2,20,2,1
37,425,425,39,17,22,3,2
30,431,431,60,45,15,2,1
0,432,432,13,3,10,3,2
14,448,448,45,23,22,2,1
32,458,458,24,24,0,1,0
23,458,458,109,109,0,1,0
38,470,470,3,3,0,1,0

8,108,108,8,8,0,1,0
17,113,113,2,2,0,1,0
16,116,116,3,3,0,1,0
6,120,120,36,36,0,1,0
9,128,128,4,4,0,1,0
27,145,145,1,1,0,1,0
4,148,148,22,14,8,2,1
28,165,165,88,58,30,4,3
5,167,167,43,24,19,2,1
23,168,168,28,28,0,1,0
2,183,183,1,1,0,1,0
25,239,239,1,1,0,1,0
7,242,242,133,85,48,4,3
21,272,272,9,1,8,2,1
26,276,276,50,44,6,3,2
19,285,285,61,53,8,2,1
1,322,322,49,27,22,3,2
29,368,368,7,7,0,1,0
12,370,370,2,2,0,1,0
11,390,390,21,21,0,1,0
3,408,408,156,156,0,1,0
0,409,409,41,41,0,1,0
18,410,410,22,4,18,4,3
13,413,413,38,24,14,2,1
22,415,415,4,4,0,1,0
20,417,417,1,1,0,1,0
15,429,429,162,132,30,3,2
10,463,463,17,17,0,1,0
14,470,470,84,32,52,3,2
24,478,478,10,10,0,1,0

16,107,107,5,5,0,1,0
10,109,109,2,2,0,1,0
6,112,112,33,33,0,1,0
17,114,114,1,1,0,1,0
33,114,114,23,14,9,2,1
11,115,115,1,1,0,1,0
14,115,115,11,11,0,1,0
25,125,125,1,1,0,1,0
8,132,132,22,22,0,1,0
36,134,134,7,2,5,2,1
24,137,137,6,1,5,2,1
42,147,147,45,39,6,3,2
18,154,154,20,10,10,3,2
4,170,170,15,6,9,4,3
20,175,175,11,11,0,1,0
30,182,182,4,4,0,1,0
32,183,183,10,1,9,2,1
15,204,204,8,8,0,1,0
29,207,207,11,3,8,3,2
37,234,234,22,22,0,1,0
21,235,235,19,7,12,4,3
3,238,238,28,15,13,2,1
0,245,245,55,55,0,1,0
5,253,253,20,12,8,3,2
19,264,264,22,5,17,2,1
12,289,289,8,2,6,3,2
23,293,293,8,8,0,1,0
38,302,302,59,47,12,3,2
28,310,310,18,6,12,4,3
27,317,317,10,3,7,2,1
43,379,379,36,20,16,3,2
39,386,386,8,8,0,1,0
2,387,387,8,8,0,1,0
26,419,419,1,1,0,1,0
13,445,445,2,2,0,1,0
7,447,447,15,15,0,1,0
40,450,450,18,11,7,2,1
1,463,463,3,3,0,1,0
31,466,466,26,8,18,2,1
9,471,471,146,146,0,1,0
35,475,475,102,102,0,1,0
41,485,485,78,51,27,2,1
22,490,490,13,1,12,4,3
34,495,495,163,156,7,2,1

33,119,119,22,7,15,4,3
13,126,126,8,8,0,1,0
29,141,141,1,1,0,1,0
36,142,142,3,3,0,1,0
22,147,147,19,19,0,1,0
39,163,163,6,2,4,2,1
34,163,163,10,4,6,3,2
10,167,167,19,19,0,1,0
18,176,176,7,4,3,2,1
5,195,195,17,1,16,3,2
15,198,198,1,1,0,1,0
12,211,211,16,16,0,1,0
9,219,219,53,53,0,1,0
26,227,227,29,29,0,1,0
21,231,231,3,3,0,1,0
0,234,234,28,28,0,1,0
28,236,236,41,41,0,1,0
32,279,279,16,4,12,2,1
6,320,320,40,40,0,1,0
4,322,322,18,5,13,2,1
35,323,323,3,3,0,1,0
16,325,325,46,46,0,1,0
14,326,326,46,46,0,1,0
30,377,377,4,1,3,2,1
37,387,387,12,12,0,1,0
11,389,389,19,13,6,3,2
3,396,396,61,61,0,1,0
8,398,398,94,40,54,3,2
38,419,419,123,59,64,3,2
19,430,430,20,14,6,2,1
1,444,444,12,2,10,3,2
17,455,455,47,47,0,1,0
23,467,467,21,15,6,2,1
31,472,472,172,138,34,3,2
25,476,476,2,2,0,1,0
27,476,476,16,16,0,1,0
7,479,479,37,37,0,1,0
24,492,492,176,104,72,3,2
2,495,495,48,22,26,2,1
20,496,496,36,36,0,1,0

22,106,106,28,10,18,2,1
30,156,156,30,10,20,3,2
3,164,164,13,2,11,2,1
8,166,166,4,4,0,1,0
13,179,179,33,33,0,1,0
32,182,182,13,1,12,3,2
38,191,191,11,11,0,1,0
12,201,201,4,4,0,1,0
6,215,215,54,31,23,2,1
27,216,216,2,2,0,1,0
15,246,246,46,46,0,1,0
36,247,247,9,9,0,1,0
19,261,261,1,1,0,1,0
20,261,261,33,33,0,1,0
35,269,269,5,2,3,2,1
5,271,271,10,10,0,1,0
37,271,271,41,20,21,4,3
33,286,286,14,14,0,1,0
4,291,291,26,1,25,2,1
28,303,303,10,10,0,1,0
0,304,304,1,1,0,1,0
25,306,306,46,46,0,1,0
11,324,324,37,1,36,3,2
2,339,339,27,27,0,1,0
21,351,351,5,5,0,1,0
40,363,363,7,7,0,1,0
9,376,376,22,22,0,1,0
16,383,383,57,57,0,1,0
18,390,390,41,1,40,3,2
10,398,398,25,15,10,2,1
39,422,422,85,85,0,1,0
29,423,423,42,10,32,2,1
1,434,434,14,4,10,2,1
26,446,446,35,3,32,4,3
31,448,448,17,11,6,2,1
41,451,451,63,28,35,2,1
34,452,452,39,39,0,1,0
24,457,457,113,49,64,3,2
42,474,474,6,6,0,1,0
23,474,474,161,102,59,4,3
7,481,481,27,27,0,1,0
14,492,492,21,16,5,2,1
17,497,497,10,5,5,2,1

34,124,124,18,5,13,2,1
38,130,130,4,4,0,1,0
1,137,137,6,6,0,1,0
45,145,145,20,8,12,2,1
15,150,150,2,2,0,1,0
7,154,154,7,1,6,3,2
13,160,160,8,8,0,1,0
10,169,169,1,1,0,1,0
4,175,175,4,1,3,2,1
31,175,175,38,5,33,4,3
18,180,180,38,5,33,4,3
48,182,182,9,9,0,1,0
36,212,212,23,13,10,2,1
33,221,221,25,25,0,1,0
40,240,240,6,6,0,1,0
21,246,246,14,8,6,2,1
22,251,251,3,3,0,1,0
44,264,264,33,33,0,1,0
27,269,269,1,1,0,1,0
0,294,294,4,4,0,1,0
14,296,296,39,5,34,3,2
16,298,298,5,5,0,1,0
6,306,306,25,25,0,1,0
35,307,307,78,3,75,4,3
29,316,316,4,4,0,1,0
5,323,323,34,34,0,1,0
26,330,330,8,8,0,1,0
28,343,343,1,1,0,1,0
3,346,346,35,26,9,4,3
46,366,366,79,79,0,1,0
12,367,367,3,3,0,1,0
43,373,373,2,2,0,1,0
9,391,391,22,22,0,1,0
39,399,399,1,1,0,1,0
17,403,403,76,66,10,2,1
25,406,406,61,51,10,2,1
41,410,410,41,41,0,1,0
30,414,414,89,38,51,4,3
8,420,420,11,11,0,1,0
37,427,427,27,18,9,4,3
42,440,440,23,15,8,2,1
23,454,454,46,11,35,2,1
20,458,458,63,63,0,1,0
19,463,463,23,5,18,4,3
24,487,487,43,1,42,2,1
11,492,492,74,32,42,2,1
2,496,496,51,51,0,1,0
47,496,496,29,29,0,1,0
32,500,500,51,12,39,2,1

12,107,107,3,3,0,1,0
31,118,118,3,3,0,1,0
38,124,124,19,5,14,2,1
36,129,129,4,4,0,1,0
10,141,141,1,1,0,1,0
7,142,142,14,14,0,1,0
21,145,145,54,4,50,3,2
28,147,147,1,1,0,1,0
19,160,160,36,36,0,1,0
25,171,171,21,9,12,2,1
16,176,176,6,6,0,1,0
4,211,211,18,18,0,1,0
3,223,223,3,3,0,1,0
23,246,246,4,1,3,2,1
34,248,248,22,14,8,2,1
5,273,273,22,22,0,1,0
37,298,298,32,29,3,2,1
2,303,303,29,29,0,1,0
40,337,337,2,2,0,1,0
11,344,344,40,20,20,3,2
15,348,348,62,62,0,1,0
33,348,348,13,9,4,2,1
30,352,352,20,11,9,2,1
20,365,365,19,9,10,2,1
18,366,366,50,50,0,1,0
0,375,375,86,86,0,1,0
6,375,375,2,2,0,1,0
32,379,379,1,1,0,1,0
29,388,388,28,4,24,3,2
1,395,395,13,13,0,1,0
17,401,401,16,16,0,1,0
35,419,419,26,2,24,3,2
9,422,422,1,1,0,1,0
26,429,429,128,58,70,3,2
14,429,429,43,22,21,4,3
13,447,447,63,35,28,2,1
8,449,449,135,66,69,3,2
27,459,459,150,77,73,4,3
39,466,466,5,5,0,1,0
22,474,474,60,60,0,1,0
24,495,495,59,47,12,2,1

37,103,103,2,2,0,1,0
29,107,107,8,8,0,1,0
7,128,128,29,2,27,2,1
36,131,131,17,17,0,1,0
16,133,133,2,2,0,1,0
39,159,159,16,16,0,1,0
13,168,168,4,4,0,1,0
14,186,186,15,3,12,2,1
31,188,188,7,7,0,1,0
28,195,195,9,9,0,1,0
17,215,215,43,29,14,2,1
33,216,216,19,19,0,1,0
38,217,217,24,2,22,3,2
4,226,226,8,8,0,1,0
2,243,243,53,53,0,1,0
3,246,246,46,46,0,1,0
15,248,248,3,3,0,1,0
40,250,250,70,5,65,3,2
11,265,265,13,3,10,3,2
23,275,275,25,25,0,1,0
25,295,295,5,5,0,1,0
9,303,303,15,12,3,2,1
20,303,303,26,26,0,1,0
1,316,316,25,3,22,3,2
10,320,320,9,3,6,2,1
35,322,322,10,10,0,1,0
5,325,325,15,15,0,1,0
27,330,330,19,19,0,1,0
19,337,337,103,78,25,2,1
30,372,372,9,1,8,2,1
22,379,379,69,69,0,1,0
8,382,382,23,23,0,1,0
32,397,397,59,59,0,1,0
0,397,397,12,3,9,4,3
18,401,401,30,18,12,4,3
12,417,417,22,22,0,1,0
21,426,426,70,29,41,3,2
26,431,431,41,41,0,1,0
34,438,438,6,6,0,1,0
6,446,446,63,63,0,1,0
24,499,499,162,132,30,3,2

30,103,103,22,6,16,2,1
42,110,110,21,21,0,1,0
25,124,124,6,6,0,1,0
1,126,126,11,2,9,2,1
19,138,138,1,1,0,1,0
17,144,144,13,1,12,4,3
26,148,148,4,4,0,1,0
13,148,148,3,3,0,1,0
0,162,162,3,3,0,1,0
24,175,175,1,1,0,1,0
5,183,183,21,4,17,2,1
33,191,191,15,3,12,2,1
27,236,236,1,1,0,1,0
48,240,240,37,19,18,4,3
8,245,245,10,10,0,1,0
12,245,245,1,1,0,1,0
28,250,250,46,46,0,1,0
21,255,255,4,4,0,1,0
23,256,256,20,20,0,1,0
14,260,260,2,2,0,1,0
34,269,269,41,23,18,4,3
18,278,278,10,10,0,1,0
38,279,279,5,5,0,1,0
35,294,294,2,2,0,1,0
3,305,305,51,51,0,1,0
22,320,320,5,5,0,1,0
47,320,320,7,1,6,2,1
31,338,338,45,25,20,2,1
10,341,341,8,8,0,1,0
29,352,352,3,3,0,1,0
37,357,357,18,3,15,2,1
36,361,361,10,10,0,1,0
7,370,370,55,55,0,1,0
40,372,372,98,98,0,1,0
9,396,396,69,27,42,2,1
45,398,398,9,9,0,1,0
6,399,399,41,41,0,1,0
20,405,405,26,16,10,3,2
16,428,428,31,31,0,1,0
32,438,438,7,1,6,2,1
44,442,442,201,138,63,4,3
46,444,444,40,20,20,3,2
2,445,445,13,13,0,1,0
15,447,447,93,49,44,4,3
39,447,447,36,36,0,1,0
4,470,470,6,6,0,1,0
11,478,478,93,45,48,4,3
41,483,483,25,4,21,4,3
43,486,486,1,1,0,1,0

31,109,109,13,3,10,2,1
33,119,119,3,3,0,1,0
7,124,124,17,3,14,3,2
32,124,124,13,1,12,3,2
16,143,143,15,15,0,1,0
8,146,146,40,40,0,1,0
3,177,177,35,35,0,1,0
0,213,213,40,40,0,1,0
9,214,214,42,42,0,1,0
17,218,218,2,2,0,1,0
25,221,221,100,12,88,4,3
30,234,234,42,42,0,1,0
11,262,262,5,5,0,1,0
21,264,264,37,37,0,1,0
22,273,273,43,43,0,1,0
2,281,281,69,12,57,4,3
10,306,306,49,49,0,1,0
13,317,317,88,10,78,4,3
5,339,339,42,4,38,3,2
19,345,345,60,55,5,2,1
28,347,347,6,6,0,1,0
14,352,352,19,19,0,1,0
27,356,356,1,1,0,1,0
6,359,359,17,17,0,1,0
29,368,368,26,16,10,3,2
24,393,393,2,2,0,1,0
1,404,404,1,1,0,1,0
23,419,419,17,17,0,1,0
12,424,424,40,40,0,1,0
20,425,425,20,20,0,1,0
26,436,436,20,20,0,1,0
18,459,459,15,15,0,1,0
4,465,465,18,18,0,1,0
15,486,486,123,117,6,2,1

23,100,100,14,14,0,1,0
41,104,104,7,7,0,1,0
55,121,121,6,6,0,1,0
48,125,125,14,7,7,2,1
2,131,131,1,1,0,1,0
35,151,151,6,6,0,1,0
13,158,158,8,8,0,1,0
20,164,164,13,13,0,1,0
53,180,180,18,8,10,3,2
42,180,180,11,2,9,4,3
46,182,182,28,17,11,2,1
25,183,183,4,4,0,1,0
50,183,183,1,1,0,1,0
4,194,194,8,8,0,1,0
54,196,196,22,8,14,2,1
19,200,200,13,13,0,1,0
30,212,212,41,41,0,1,0
27,213,213,18,11,7,2,1
28,216,216,5,5,0,1,0
17,227,227,5,5,0,1,0
43,228,228,25,7,18,3,2
26,231,231,6,6,0,1,0
9,241,241,28,28,0,1,0
1,241,241,20,20,0,1,0
36,242,242,4,4,0,1,0
24,264,264,57,15,42,4,3
39,265,265,16,16,0,1,0
32,269,269,5,5,0,1,0
52,279,279,10,10,0,1,0
38,305,305,32,20,12,4,3
45,305,305,58,58,0,1,0
29,309,309,21,9,12,4,3
44,318,318,18,12,6,3,2
15,325,325,8,8,0,1,0
37,328,328,68,40,28,2,1
49,351,351,80,65,15,4,3
34,361,361,13,13,0,1,0
7,372,372,8,2,6,2,1
3,380,380,43,28,15,4,3
12,401,401,8,8,0,1,0
16,404,404,17,17,0,1,0
40,414,414,46,13,33,4,3
11,419,419,2,2,0,1,0
6,425,425,11,4,7,2,1
21,431,431,14,14,0,1,0
31,432,432,6,6,0,1,0
18,433,433,21,21,0,1,0
14,435,435,71,71,0,1,0
5,439,439,19,2,17,2,1
0,445,445,7,4,3,2,1
33,448,448,8,8,0,1,0
8,479,479,12,3,9,2,1
10,480,480,28,5,23,4,3
22,483,483,1,1,0,1,0
51,497,497,80,80,0,1,0
47,500,500,51,9,42,3,2

1,111,111,14,5,9,4,3
30,118,118,1,1,0,1,0
11,133,133,31,14,17,2,1
28,149,149,50,50,0,1,0
15,163,163,43,7,36,2,1
27,177,177,33,33,0,1,0
10,179,179,29,9,20,3,2
17,191,191,5,5,0,1,0
9,209,209,13,13,0,1,0
23,241,241,41,23,18,3,2
21,243,243,17,11,6,3,2
38,244,244,36,36,0,1,0
3,244,244,1,1,0,1,0
24,257,257,2,2,0,1,0
29,262,262,30,30,0,1,0
12,268,268,4,1,3,2,1
7,272,272,3,3,0,1,0
32,276,276,1,1,0,1,0
6,280,280,16,4,12,2,1
31,296,296,1,1,0,1,0
14,307,307,3,3,0,1,0
37,341,341,6,6,0,1,0
4,344,344,16,1,15,4,3
36,346,346,159,159,0,1,0
0,359,359,27,27,0,1,0
33,369,369,49,49,0,1,0
8,370,370,4,4,0,1,0
26,388,388,13,13,0,1,0
25,399,399,18,18,0,1,0
5,400,400,75,63,12,4,3
19,410,410,31,31,0,1,0
34,411,411,16,16,0,1,0
35,435,435,5,5,0,1,0
22,438,438,68,42,26,2,1
18,438,438,29,1,28,3,2
20,457,457,11,2,9,4,3
2,476,476,130,94,36,3,2
13,494,494,76,76,0,1,0
16,496,496,108,51,57,4,3

32,103,103,24,15,9,2,1
5,118,118,5,2,3,2,1
31,125,125,9,9,0,1,0
24,129,129,6,6,0,1,0
46,133,133,64,64,0,1,0
25,146,146,1,1,0,1,0
35,149,149,13,2,11,2,1
28,198,198,16,16,0,1,0
23,233,233,10,10,0,1,0
47,236,236,2,2,0,1,0
10,239,239,65,19,46,3,2
3,249,249,14,14,0,1,0
29,252,252,3,3,0,1,0
11,259,259,17,17,0,1,0
12,260,260,23,23,0,1,0
40,265,265,32,6,26,2,1
30,266,266,6,1,5,2,1
36,270,270,20,3,17,2,1
1,281,281,72,54,18,3,2
4,288,288,4,4,0,1,0
14,288,288,4,4,0,1,0
22,320,320,103,22,81,4,3
7,334,334,24,24,0,1,0
13,336,336,11,11,0,1,0
21,341,341,4,4,0,1,0
2,343,343,9,6,3,2,1
17,345,345,9,9,0,1,0
45,350,350,23,23,0,1,0
41,351,351,9,9,0,1,0
43,359,359,3,3,0,1,0
0,375,375,10,10,0,1,0
19,380,380,13,4,9,4,3
33,384,384,18,4,14,4,3
38,385,385,63,63,0,1,0
20,387,387,19,19,0,1,0
39,388,388,71,10,61,3,2
18,407,407,9,3,6,2,1
16,410,410,19,19,0,1,0
37,428,428,12,2,10,3,2
44,440,440,2,2,0,1,0
8,440,440,25,25,0,1,0
27,441,441,73,58,15,2,1
26,454,454,2,2,0,1,0
15,461,461,6,6,0,1,0
48,471,471,33,33,0,1,0
34,472,472,57,36,21,4,3
9,474,474,46,3,43,2,1
6,478,478,6,1,5,2,1
42,482,482,102,75,27,4,3

22,102,102,6,2,4,2,1
21,113,113,11,11,0,1,0
7,141,141,1,1,0,1,0
1,173,173,18,2,16,3,2
6,179,179,18,15,3,2,1
32,194,194,30,4,26,3,2
15,197,197,27,27,0,1,0
10,208,208,59,59,0,1,0
16,213,213,64,64,0,1,0
11,222,222,15,15,0,1,0
19,232,232,23,2,21,2,1
27,236,236,85,85,0,1,0
30,266,266,46,26,20,2,1
2,274,274,46,11,35,2,1
3,294,294,79,79,0,1,0
20,297,297,11,11,0,1,0
18,303,303,13,13,0,1,0
29,306,306,18,18,0,1,0
28,317,317,14,2,12,3,2
23,340,340,20,4,16,2,1
34,343,343,13,13,0,1,0
5,363,363,94,94,0,1,0
33,368,368,59,7,52,3,2
35,369,369,24,24,0,1,0
25,378,378,13,13,0,1,0
26,389,389,62,57,5,2,1
13,390,390,6,6,0,1,0
31,401,401,46,46,0,1,0
9,403,403,40,40,0,1,0
36,406,406,11,11,0,1,0
4,448,448,7,7,0,1,0
14,459,459,30,30,0,1,0
24,477,477,36,36,0,1,0
8,482,482,4,4,0,1,0
12,485,485,24,9,15,4,3
17,486,486,89,31,58,3,2
0,493,493,27,27,0,1,0

44,100,100,17,8,9,2,1
7,107,107,3,3,0,1,0
40,107,107,15,11,4,2,1
38,113,113,21,18,3,2,1
27,119,119,5,1,4,2,1
21,124,124,1,1,0,1,0
12,134,134,54,34,20,3,2
16,149,149,12,12,0,1,0
23,162,162,1,1,0,1,0
33,164,164,5,1,4,2,1
48,172,172,18,18,0,1,0
25,177,177,2,2,0,1,0
17,187,187,35,3,32,2,1
13,193,193,49,49,0,1,0
14,218,218,9,1,8,2,1
47,220,220,20,20,0,1,0
9,221,221,33,33,0,1,0
28,224,224,3,3,0,1,0
42,238,238,7,1,6,3,2
11,248,248,9,1,8,2,1
8,257,257,6,6,0,1,0
26,263,263,1,1,0,1,0
1,265,265,13,1,12,3,2
31,267,267,7,7,0,1,0
3,275,275,27,5,22,2,1
10,293,293,1,1,0,1,0
2,295,295,1,1,0,1,0
36,297,297,14,14,0,1,0
19,305,305,1,1,0,1,0
22,321,321,31,31,0,1,0
30,322,322,15,15,0,1,0
6,323,323,36,9,27,4,3
4,326,326,17,12,5,2,1
0,354,354,25,25,0,1,0
29,357,357,29,29,0,1,0
24,382,382,31,31,0,1,0
20,392,392,21,3,18,4,3
5,392,392,11,11,0,1,0
35,398,398,5,5,0,1,0
45,398,398,78,78,0,1,0
39,409,409,69,32,37,4,3
41,410,410,74,74,0,1,0
15,427,427,22,22,0,1,0
18,431,431,6,6,0,1,0
34,443,443,8,3,5,2,1
32,445,445,20,20,0,1,0
43,453,453,191,155,36,4,3
46,475,475,3,3,0,1,0
37,493,493,15,5,10,3,2

35,112,112,8,8,0,1,0
3,134,134,15,15,0,1,0
39,139,139,20,20,0,1,0
19,167,167,2,2,0,1,0
9,171,171,31,17,14,2,1
20,180,180,33,13,20,3,2
1,203,203,27,21,6,3,2
11,206,206,25,25,0,1,0
14,220,220,27,27,0,1,0
36,239,239,9,1,8,2,1
10,255,255,66,36,30,4,3
12,261,261,26,4,22,3,2
38,284,284,9,6,3,2,1
29,286,286,54,54,0,1,0
27,287,287,10,4,6,2,1
16,291,291,17,17,0,1,0
25,292,292,20,20,0,1,0
24,293,293,27,3,24,4,3
40,297,297,14,9,5,2,1
15,301,301,21,13,8,3,2
34,312,312,38,38,0,1,0
37,313,313,91,91,0,1,0
33,347,347,22,22,0,1,0
6,347,347,6,6,0,1,0
17,356,356,7,7,0,1,0
0,356,356,15,15,0,1,0
41,358,358,125,57,68,3,2
13,363,363,71,14,57,3,2
7,372,372,14,14,0,1,0
30,393,393,4,4,0,1,0
23,399,399,4,4,0,1,0
28,407,407,33,6,27,2,1
5,412,412,17,6,11,3,2
2,416,416,22,22,0,1,0
18,429,429,50,50,0,1,0
21,437,437,1,1,0,1,0
31,444,444,22,13,9,2,1
32,444,444,4,1,3,2,1
8,444,444,23,23,0,1,0
4,449,449,32,32,0,1,0
22,475,475,159,93,66,4,3
26,498,498,2,2,0,1,0

10,120,120,58,7,51,4,3
13,125,125,10,10,0,1,0
26,137,137,6,1,5,2,1
5,155,155,1,1,0,1,0
14,180,180,1,1,0,1,0
11,197,197,7,7,0,1,0
8,202,202,100,100,0,1,0
23,214,214,3,3,0,1,0
4,233,233,4,4,0,1,0
1,276,276,1,1,0,1,0
25,283,283,36,20,16,2,1
28,299,299,12,12,0,1,0
19,306,306,27,27,0,1,0
15,344,344,94,50,44,2,1
16,347,347,65,65,0,1,0
6,349,349,146,119,27,2,1
30,360,360,41,30,11,2,1
12,360,360,2,2,0,1,0
0,361,361,26,14,12,4,3
21,372,372,19,19,0,1,0
34,387,387,14,7,7,2,1
20,394,394,73,51,22,2,1
17,396,396,3,3,0,1,0
31,397,397,12,4,8,2,1
22,400,400,5,2,3,2,1
32,413,413,193,65,128,4,3
2,424,424,94,87,7,2,1
7,429,429,9,6,3,2,1
33,443,443,25,4,21,2,1
9,444,444,43,27,16,2,1
24,453,453,34,34,0,1,0
29,453,453,22,22,0,1,0
27,466,466,43,7,36,4,3
3,485,485,19,4,15,4,3
18,490,490,38,2,36,3,2

46,105,105,4,4,0,1,0
40,106,106,12,12,0,1,0
2,110,110,16,3,13,2,1
29,116,116,3,3,0,1,0
11,129,129,1,1,0,1,0
35,130,130,8,4,4,2,1
22,147,147,2,2,0,1,0
0,150,150,20,2,18,4,3
45,152,152,31,6,25,2,1
12,157,157,1,1,0,1,0
6,161,161,7,1,6,3,2
10,169,169,20,16,4,2,1
43,170,170,21,12,9,2,1
16,185,185,20,4,16,2,1
30,188,188,70,49,21,4,3
37,207,207,67,67,0,1,0
32,210,210,11,11,0,1,0
33,214,214,34,34,0,1,0
9,237,237,35,35,0,1,0
26,264,264,3,3,0,1,0
44,266,266,16,16,0,1,0
17,276,276,1,1,0,1,0
36,283,283,6,6,0,1,0
18,291,291,5,5,0,1,0
20,295,295,62,62,0,1,0
8,307,307,10,10,0,1,0
31,315,315,8,2,6,2,1
48,318,318,32,4,28,2,1
13,320,320,6,3,3,2,1
19,324,324,12,9,3,2,1
24,347,347,10,7,3,2,1
21,359,359,59,16,43,2,1
14,377,377,57,57,0,1,0
41,382,382,22,22,0,1,0
42,399,399,10,10,0,1,0
15,400,400,19,19,0,1,0
47,406,406,4,4,0,1,0
7,410,410,7,7,0,1,0
4,412,412,22,22,0,1,0
25,415,415,12,12,0,1,0
27,424,424,16,16,0,1,0
23,428,428,32,12,20,2,1
5,433,433,71,25,46,2,1
3,443,443,25,13,12,2,1
34,447,447,70,5,65,4,3
28,455,455,44,44,0,1,0
1,458,458,12,12,0,1,0
39,459,459,35,35,0,1,0
38,488,488,22,22,0,1,0

3,113,113,11,4,7,2,1
15,115,115,8,8,0,1,0
16,124,124,11,11,0,1,0
6,135,135,23,11,12,4,3
23,137,137,11,11,0,1,0
33,150,150,3,3,0,1,0
27,162,162,19,19,0,1,0
35,166,166,1,1,0,1,0
41,169,169,1,1,0,1,0
0,172,172,7,2,5,2,1
11,172,172,22,22,0,1,0
38,187,187,7,7,0,1,0
20,189,189,7,7,0,1,0
22,190,190,29,3,26,4,3
25,203,203,8,8,0,1,0
5,211,211,26,4,22,2,1
37,246,246,5,5,0,1,0
30,255,255,35,9,26,2,1
19,257,257,14,14,0,1,0
14,266,266,68,51,17,2,1
34,269,269,64,17,47,2,1
36,300,300,22,4,18,3,2
18,320,320,27,27,0,1,0
9,324,324,23,23,0,1,0
28,334,334,27,27,0,1,0
24,335,335,23,3,20,2,1
21,342,342,16,4,12,4,3
1,358,358,25,17,8,3,2
39,362,362,149,118,31,2,1
7,380,380,12,3,9,3,2
2,384,384,57,16,41,4,3
31,394,394,77,44,33,2,1
32,397,397,37,12,25,2,1
8,399,399,10,4,6,3,2
17,413,413,8,5,3,2,1
10,434,434,1,1,0,1,0
4,437,437,138,122,16,3,2
29,438,438,16,4,12,2,1
12,450,450,29,29,0,1,0
13,460,460,26,12,14,2,1
26,467,467,83,57,26,2,1
40,485,485,26,26,0,1,0

19,111,111,21,6,15,2,1
3,112,112,5,5,0,1,0
6,119,119,10,10,0,1,0
13,126,126,5,5,0,1,0
25,131,131,4,4,0,1,0
16,142,142,12,12,0,1,0
11,143,143,21,21,0,1,0
29,151,151,46,2,44,3,2
32,171,171,30,30,0,1,0
1,197,197,9,9,0,1,0
17,217,217,9,9,0,1,0
10,228,228,12,4,8,2,1
21,232,232,70,1,69,4,3
8,233,233,28,4,24,4,3
15,244,244,8,2,6,2,1
27,258,258,30,30,0,1,0
23,258,258,17,2,15,2,1
4,259,259,32,32,0,1,0
26,264,264,11,11,0,1,0
5,269,269,92,76,16,3,2
2,305,305,51,15,36,4,3
0,320,320,18,1,17,2,1
30,353,353,53,53,0,1,0
33,360,360,4,4,0,1,0
31,361,361,34,34,0,1,0
12,373,373,24,1,23,2,1
24,377,377,12,12,0,1,0
18,380,380,2,2,0,1,0
34,383,383,20,20,0,1,0
20,397,397,5,5,0,1,0
28,414,414,50,50,0,1,0
35,416,416,34,7,27,3,2
9,443,443,106,53,53,4,3
14,458,458,175,124,51,3,2
7,462,462,28,6,22,2,1
22,498,498,71,35,36,4,3

26,110,110,13,1,12,2,1
3,118,118,1,1,0,1,0
28,129,129,7,7,0,1,0
30,144,144,5,5,0,1,0
12,148,148,14,14,0,1,0
1,149,149,3,3,0,1,0
2,155,155,27,15,12,4,3
18,190,190,6,2,4,2,1
0,201,201,48,21,27,4,3
27,204,204,20,4,16,3,2
13,205,205,42,18,24,2,1
15,225,225,6,6,0,1,0
7,230,230,4,4,0,1,0
22,236,236,1,1,0,1,0
11,246,246,165,141,24,2,1
23,248,248,27,27,0,1,0
8,277,277,35,2,33,4,3
19,280,280,69,40,29,2,1
14,303,303,33,33,0,1,0
29,329,329,13,13,0,1,0
4,341,341,25,25,0,1,0
21,374,374,84,84,0,1,0
5,378,378,88,24,64,3,2
31,388,388,60,20,40,3,2
10,421,421,10,4,6,3,2
24,437,437,1,1,0,1,0
17,437,437,1,1,0,1,0
20,455,455,47,5,42,2,1
16,460,460,9,2,7,2,1
25,463,463,165,129,36,4,3
6,466,466,84,38,46,4,3
9,468,468,111,79,32,4,3

12,107,107,6,6,0,1,0
19,118,118,10,6,4,2,1
1,126,126,8,2,6,2,1
36,136,136,6,2,4,2,1
33,139,139,10,7,3,2,1
39,184,184,46,25,21,4,3
14,203,203,8,8,0,1,0
42,219,219,6,3,3,2,1
29,224,224,113,102,11,2,1
4,240,240,7,7,0,1,0
27,248,248,25,3,22,2,1
21,252,252,36,36,0,1,0
5,258,258,8,8,0,1,0
23,263,263,43,43,0,1,0
26,264,264,57,57,0,1,0
20,277,277,14,14,0,1,0
13,286,286,2,2,0,1,0
32,308,308,2,2,0,1,0
2,327,327,10,10,0,1,0
6,331,331,26,26,0,1,0
0,338,338,16,12,4,2,1
35,340,340,31,31,0,1,0
37,342,342,4,4,0,1,0
38,344,344,2,2,0,1,0
31,362,362,2,2,0,1,0
9,364,364,38,38,0,1,0
10,371,371,97,97,0,1,0
8,373,373,21,21,0,1,0
15,384,384,115,25,90,4,3
17,395,395,85,44,41,2,1
34,395,395,6,3,3,2,1
24,402,402,19,19,0,1,0
25,415,415,2,2,0,1,0
11,419,419,2,2,0,1,0
7,431,431,24,11,13,2,1
30,442,442,5,5,0,1,0
16,443,443,81,26,55,4,3
22,443,443,14,1,13,3,2
3,450,450,20,1,19,3,2
41,460,460,6,6,0,1,0
28,465,465,124,86,38,3,2
18,488,488,41,41,0,1,0
40,490,490,83,23,60,3,2

36,116,116,5,5,0,1,0
24,126,126,22,17,5,2,1
20,132,132,1,1,0,1,0
6,135,135,3,3,0,1,0
4,152,152,56,5,51,4,3
3,162,162,8,8,0,1,0
18,171,171,20,9,11,2,1
8,178,178,10,10,0,1,0
33,194,194,13,9,4,2,1
30,222,222,35,35,0,1,0
15,226,226,6,6,0,1,0
41,241,241,1,1,0,1,0
40,251,251,14,14,0,1,0
16,260,260,27,12,15,4,3
9,264,264,3,3,0,1,0
7,268,268,33,33,0,1,0
42,269,269,54,54,0,1,0
27,291,291,10,6,4,2,1
39,304,304,48,29,19,2,1
11,313,313,48,9,39,2,1
1,315,315,29,26,3,2,1
0,337,337,8,8,0,1,0
35,347,347,17,14,3,2,1
28,352,352,35,35,0,1,0
13,357,357,1,1,0,1,0
19,369,369,17,17,0,1,0
23,391,391,38,38,0,1,0
12,398,398,18,18,0,1,0
14,400,400,42,12,30,4,3
32,406,406,5,5,0,1,0
38,415,415,19,19,0,1,0
43,430,430,21,15,6,3,2
37,446,446,67,67,0,1,0
25,446,446,63,63,0,1,0
17,447,447,4,4,0,1,0
26,456,456,11,4,7,2,1
10,460,460,24,18,6,2,1
2,464,464,36,21,15,2,1
31,468,468,162,107,55,4,3
29,469,469,30,4,26,3,2
22,474,474,88,88,0,1,0
5,476,476,13,5,8,3,2
21,482,482,96,60,36,4,3
34,491,491,79,79,0,1,0

3,103,103,2,2,0,1,0
4,129,129,5,5,0,1,0
20,150,150,14,1,13,2,1
29,152,152,5,1,4,2,1
22,157,157,1,1,0,1,0
34,159,159,43,23,20,3,2
24,174,174,70,49,21,4,3
12,175,175,14,14,0,1,0
25,179,179,6,6,0,1,0
32,184,184,10,6,4,2,1
21,190,190,4,4,0,1,0
27,198,198,1,1,0,1,0
23,200,200,10,1,9,4,3
14,213,213,36,8,28,3,2
26,256,256,8,8,0,1,0
30,264,264,20,5,15,2,1
15,281,281,2,2,0,1,0
33,305,305,95,95,0,1,0
6,305,305,5,5,0,1,0
5,310,310,28,19,9,4,3
7,311,311,18,18,0,1,0
37,322,322,6,6,0,1,0
36,330,330,9,9,0,1,0
28,341,341,35,13,22,2,1
8,349,349,95,55,40,4,3
35,351,351,73,40,33,2,1
31,370,370,8,5,3,2,1
9,392,392,48,48,0,1,0
11,411,411,18,3,15,2,1
10,427,427,67,67,0,1,0
1,440,440,141,81,60,4,3
19,453,453,65,25,40,4,3
16,461,461,42,42,0,1,0
2,475,475,53,32,21,4,3
13,479,479,86,79,7,2,1
0,480,480,39,15,24,3,2
17,484,484,69,69,0,1,0
18,494,494,66,40,26,2,1

42,104,104,34,9,25,2,1
27,109,109,4,4,0,1,0
6,142,142,13,5,8,3,2
38,150,150,8,8,0,1,0
16,180,180,38,11,27,2,1
32,180,180,8,8,0,1,0
37,192,192,19,19,0,1,0
7,202,202,1,1,0,1,0
33,214,214,40,16,24,4,3
17,217,217,5,5,0,1,0
28,250,250,5,5,0,1,0
4,252,252,5,5,0,1,0
25,264,264,7,7,0,1,0
12,265,265,42,42,0,1,0
26,265,265,12,4,8,3,2
13,269,269,19,19,0,1,0
10,275,275,7,7,0,1,0
14,306,306,44,18,26,3,2
41,308,308,11,11,0,1,0
36,316,316,136,120,16,3,2
39,330,330,12,12,0,1,0
20,348,348,41,41,0,1,0
22,352,352,2,2,0,1,0
34,356,356,62,20,42,4,3
18,358,358,24,24,0,1,0
15,366,366,37,33,4,2,1
40,394,394,1,1,0,1,0
24,395,395,65,43,22,3,2
21,404,404,124,124,0,1,0
19,413,413,44,20,24,2,1
11,432,432,50,13,37,2,1
5,446,446,26,8,18,3,2
35,448,448,62,34,28,3,2
23,453,453,21,12,9,4,3
2,457,457,4,4,0,1,0
1,459,459,23,23,0,1,0
0,462,462,52,4,48,2,1
9,464,464,14,14,0,1,0
8,474,474,31,17,14,2,1
29,475,475,3,3,0,1,0
3,476,476,50,12,38,2,1
30,493,493,53,53,0,1,0
31,496,496,32,32,0,1,0

16,126,126,10,10,0,1,0
31,128,128,28,28,0,1,0
32,128,128,8,5,3,2,1
33,134,134,4,4,0,1,0
3,141,141,26,8,18,4,3
6,142,142,14,14,0,1,0
19,155,155,1,1,0,1,0
14,156,156,15,12,3,2,1
7,185,185,8,8,0,1,0
27,192,192,16,16,0,1,0
17,206,206,28,28,0,1,0
1,206,206,1,1,0,1,0
9,207,207,34,11,23,2,1
29,211,211,32,32,0,1,0
15,218,218,38,38,0,1,0
21,242,242,12,6,6,2,1
10,262,262,16,16,0,1,0
26,265,265,83,83,0,1,0
12,270,270,56,7,49,2,1
13,274,274,23,23,0,1,0
30,286,286,12,12,0,1,0
5,300,300,27,27,0,1,0
2,304,304,20,14,6,2,1
0,309,309,24,24,0,1,0
18,337,337,21,15,6,2,1
28,338,338,25,9,16,3,2
4,346,346,53,1,52,3,2
8,359,359,97,7,90,3,2
34,366,366,4,4,0,1,0
24,378,378,64,64,0,1,0
22,412,412,2,2,0,1,0
20,414,414,100,100,0,1,0
23,416,416,94,55,39,2,1
35,462,462,6,6,0,1,0
11,475,475,108,89,19,2,1
25,488,488,28,25,3,2,1

31,108,108,25,3,22,3,2
1,112,112,3,3,0,1,0
33,115,115,8,8,0,1,0
26,130,130,15,15,0,1,0
18,131,131,9,9,0,1,0
15,146,146,8,5,3,2,1
47,148,148,11,5,6,2,1
40,171,171,28,28,0,1,0
10,180,180,19,19,0,1,0
38,191,191,16,16,0,1,0
21,204,204,15,15,0,1,0
42,208,208,1,1,0,1,0
11,221,221,5,5,0,1,0
44,230,230,15,5,10,3,2
45,248,248,35,35,0,1,0
0,249,249,11,11,0,1,0
14,260,260,20,20,0,1,0
22,263,263,1,1,0,1,0
4,264,264,32,4,28,3,2
20,265,265,7,2,5,2,1
29,279,279,55,55,0,1,0
32,296,296,4,4,0,1,0
8,303,303,7,7,0,1,0
25,305,305,27,27,0,1,0
24,309,309,25,25,0,1,0
43,313,313,26,26,0,1,0
5,330,330,65,65,0,1,0
30,341,341,10,10,0,1,0
39,345,345,13,13,0,1,0
46,347,347,56,18,38,3,2
37,353,353,67,67,0,1,0
2,363,363,102,62,40,3,2
28,376,376,95,41,54,3,2
6,397,397,4,1,3,2,1
41,417,417,9,9,0,1,0
27,424,424,56,56,0,1,0
36,424,424,27,15,12,3,2
9,442,442,2,2,0,1,0
19,444,444,24,24,0,1,0
7,454,454,31,5,26,3,2
12,456,456,6,6,0,1,0
35,457,457,4,4,0,1,0
17,457,457,50,46,4,2,1
13,462,462,26,26,0,1,0
3,467,467,8,1,7,2,1
34,471,471,68,12,56,3,2
23,474,474,57,57,0,1,0
16,475,475,3,3,0,1,0

16,113,113,16,8,8,2,1
20,124,124,6,6,0,1,0
21,126,126,4,1,3,2,1
41,131,131,9,9,0,1,0
7,135,135,11,11,0,1,0
44,137,137,4,4,0,1,0
29,145,145,9,2,7,2,1
22,161,161,12,8,4,2,1
11,165,165,19,19,0,1,0
37,167,167,36,36,0,1,0
33,169,169,1,1,0,1,0
27,172,172,15,8,7,2,1
28,185,185,12,9,3,2,1
12,191,191,12,12,0,1,0
40,195,195,13,13,0,1,0
30,197,197,30,2,28,3,2
42,212,212,5,5,0,1,0
18,228,228,7,7,0,1,0
19,229,229,8,8,0,1,0
43,268,268,6,6,0,1,0
26,273,273,5,5,0,1,0
13,278,278,24,24,0,1,0
36,279,279,55,55,0,1,0
17,280,280,72,72,0,1,0
10,283,283,36,36,0,1,0
15,292,292,6,1,5,2,1
23,303,303,4,4,0,1,0
35,313,313,9,9,0,1,0
39,315,315,20,8,12,3,2
24,318,318,30,30,0,1,0
8,320,320,10,10,0,1,0
14,321,321,10,10,0,1,0
3,342,342,13,2,11,2,1
9,359,359,71,41,30,3,2
1,374,374,39,11,28,3,2
4,381,381,15,15,0,1,0
31,404,404,70,70,0,1,0
6,419,419,16,16,0,1,0
0,421,421,40,25,15,2,1
38,456,456,37,37,0,1,0
32,463,463,28,28,0,1,0
2,481,481,54,2,52,3,2
5,484,484,46,26,20,3,2
34,495,495,65,65,0,1,0
25,498,498,241,241,0,1,0

49,101,101,2,2,0,1,0
24,116,116,17,17,0,1,0
0,135,135,4,4,0,1,0
18,146,146,2,2,0,1,0
19,158,158,24,12,12,3,2
16,159,159,21,21,0,1,0
22,161,161,6,6,0,1,0
8,176,176,5,5,0,1,0
39,195,195,10,10,0,1,0
41,213,213,47,1,46,3,2
46,215,215,4,4,0,1,0
10,216,216,11,11,0,1,0
9,223,223,8,8,0,1,0
29,243,243,17,17,0,1,0
48,251,251,32,23,9,2,1
12,259,259,12,12,0,1,0
43,261,261,29,22,7,2,1
35,261,261,14,14,0,1,0
7,264,264,7,1,6,2,1
6,266,266,3,3,0,1,0
37,266,266,11,11,0,1,0
20,269,269,34,18,16,2,1
17,284,284,16,16,0,1,0
44,305,305,34,34,0,1,0
3,306,306,5,5,0,1,0
14,308,308,31,3,28,3,2
2,316,316,4,4,0,1,0
27,327,327,42,42,0,1,0
26,351,351,38,38,0,1,0
33,358,358,25,9,16,3,2
32,359,359,83,38,45,4,3
5,360,360,1,1,0,1,0
34,363,363,20,20,0,1,0
47,370,370,25,25,0,1,0
13,372,372,2,2,0,1,0
28,384,384,26,11,15,2,1
36,387,387,19,3,16,2,1
4,394,394,68,38,30,2,1
1,399,399,49,49,0,1,0
38,407,407,73,73,0,1,0
30,410,410,47,47,0,1,0
15,411,411,10,10,0,1,0
31,428,428,35,6,29,2,1
45,444,444,132,132,0,1,0
11,456,456,56,56,0,1,0
21,457,457,3,3,0,1,0
40,469,469,36,23,13,2,1
23,481,481,37,37,0,1,0
25,485,485,35,35,0,1,0
42,494,494,25,7,18,3,2

38,114,114,33,9,24,4,3
34,125,125,11,11,0,1,0
36,128,128,8,8,0,1,0
0,133,133,11,4,7,2,1
37,135,135,10,7,3,2,1
2,148,148,1,1,0,1,0
8,159,159,10,10,0,1,0
33,198,198,28,28,0,1,0
32,251,251,8,8,0,1,0
14,256,256,17,8,9,2,1
13,259,259,3,3,0,1,0
29,263,263,117,81,36,4,3
21,265,265,13,4,9,2,1
5,283,283,35,35,0,1,0
25,284,284,22,11,11,3,2
17,293,293,33,13,20,2,1
22,299,299,18,18,0,1,0
6,318,318,2,2,0,1,0
16,319,319,40,10,30,4,3
20,332,332,62,62,0,1,0
15,348,348,25,25,0,1,0
27,356,356,10,10,0,1,0
7,364,364,36,36,0,1,0
23,367,367,25,22,3,2,1
12,383,383,15,15,0,1,0
26,385,385,14,14,0,1,0
28,389,389,86,32,54,4,3
18,389,389,6,6,0,1,0
30,390,390,33,33,0,1,0
4,390,390,6,6,0,1,0
35,393,393,16,16,0,1,0
10,393,393,4,4,0,1,0
1,395,395,181,151,30,2,1
24,407,407,1,1,0,1,0
39,412,412,4,4,0,1,0
3,430,430,144,98,46,3,2
19,451,451,44,44,0,1,0
31,459,459,17,4,13,2,1
9,472,472,105,26,79,3,2
11,477,477,19,19,0,1,0

25,122,122,17,17,0,1,0
8,122,122,5,5,0,1,0
24,144,144,17,17,0,1,0
2,186,186,39,6,33,4,3
29,211,211,13,13,0,1,0
28,213,213,17,17,0,1,0
21,228,228,2,2,0,1,0
9,243,243,15,15,0,1,0
7,246,246,40,40,0,1,0
6,254,254,82,71,11,2,1
4,258,258,66,40,26,3,2
33,258,258,51,51,0,1,0
20,258,258,49,8,41,2,1
16,261,261,4,4,0,1,0
11,267,267,11,11,0,1,0
31,271,271,6,6,0,1,0
19,274,274,20,3,17,2,1
17,286,286,63,63,0,1,0
35,291,291,6,2,4,2,1
15,301,301,1,1,0,1,0
12,318,318,27,27,0,1,0
1,319,319,108,46,62,4,3
23,319,319,45,17,28,2,1
5,328,328,42,42,0,1,0
34,359,359,53,18,35,2,1
26,360,360,82,82,0,1,0
18,368,368,17,9,8,3,2
10,369,369,23,23,0,1,0
14,389,389,32,16,16,3,2
36,390,390,6,6,0,1,0
32,417,417,9,9,0,1,0
3,423,423,3,3,0,1,0
22,439,439,28,28,0,1,0
13,449,449,64,38,26,3,2
30,456,456,37,37,0,1,0
27,457,457,74,74,0,1,0
0,457,457,20,20,0,1,0

33,101,101,1,1,0,1,0
6,104,104,5,5,0,1,0
10,112,112,1,1,0,1,0
24,123,123,14,14,0,1,0
32,123,123,5,5,0,1,0
29,131,131,2,2,0,1,0
27,145,145,3,3,0,1,0
38,152,152,10,1,9,2,1
41,175,175,23,23,0,1,0
43,176,176,53,15,38,3,2
40,186,186,1,1,0,1,0
4,192,192,81,5,76,4,3
34,193,193,1,1,0,1,0
18,195,195,4,4,0,1,0
30,210,210,2,2,0,1,0
22,211,211,14,14,0,1,0
20,233,233,1,1,0,1,0
14,248,248,22,22,0,1,0
37,253,253,48,38,10,3,2
3,267,267,45,45,0,1,0
35,276,276,61,61,0,1,0
15,286,286,6,1,5,2,1
0,303,303,24,24,0,1,0
13,303,303,20,16,4,2,1
45,310,310,90,90,0,1,0
11,324,324,1,1,0,1,0
46,336,336,3,3,0,1,0
8,336,336,4,4,0,1,0
17,349,349,55,55,0,1,0
39,353,353,20,20,0,1,0
31,373,373,86,50,36,4,3
25,378,378,97,41,56,3,2
44,381,381,41,41,0,1,0
23,386,386,11,1,10,2,1
7,387,387,11,11,0,1,0
12,400,400,2,2,0,1,0
47,400,400,25,3,22,2,1
42,401,401,37,21,16,2,1
28,405,405,68,50,18,2,1
9,435,435,27,24,3,2,1
5,435,435,3,3,0,1,0
1,438,438,30,3,27,4,3
2,439,439,19,19,0,1,0
16,470,470,7,7,0,1,0
19,470,470,46,46,0,1,0
21,473,473,13,2,11,4,3
36,484,484,13,13,0,1,0
26,498,498,33,24,9,4,3

26,111,111,26,2,24,3,2
5,111,111,25,11,14,3,2
9,115,115,33,33,0,1,0
16,117,117,2,2,0,1,0
18,126,126,7,7,0,1,0
14,168,168,7,7,0,1,0
11,172,172,13,7,6,3,2
13,187,187,10,10,0,1,0
6,199,199,35,23,12,4,3
23,201,201,1,1,0,1,0
1,222,222,2,2,0,1,0
12,226,226,6,6,0,1,0
17,239,239,51,51,0,1,0
3,245,245,1,1,0,1,0
29,250,250,9,9,0,1,0
25,255,255,44,6,38,3,2
24,260,260,97,35,62,3,2
27,286,286,14,2,12,4,3
8,291,291,144,71,73,4,3
19,342,342,19,7,12,3,2
4,355,355,146,146,0,1,0
21,357,357,25,25,0,1,0
15,358,358,23,23,0,1,0
10,361,361,1,1,0,1,0
7,365,365,34,18,16,2,1
22,405,405,121,121,0,1,0
0,414,414,17,17,0,1,0
2,428,428,112,79,33,4,3
20,478,478,3,3,0,1,0
28,494,494,94,79,15,4,3

6,105,105,1,1,0,1,0
3,116,116,10,10,0,1,0
17,128,128,10,10,0,1,0
9,146,146,3,3,0,1,0
13,150,150,34,21,13,2,1
32,152,152,4,4,0,1,0
12,163,163,2,2,0,1,0
1,164,164,8,8,0,1,0
40,175,175,13,13,0,1,0
30,188,188,29,8,21,2,1
38,189,189,30,30,0,1,0
16,240,240,50,50,0,1,0
21,280,280,13,13,0,1,0
5,286,286,18,18,0,1,0
43,290,290,36,16,20,2,1
34,295,295,10,10,0,1,0
11,296,296,15,15,0,1,0
41,301,301,2,2,0,1,0
4,331,331,45,10,35,2,1
2,343,343,1,1,0,1,0
7,348,348,22,8,14,3,2
35,360,360,21,14,7,2,1
0,362,362,118,60,58,4,3
15,366,366,29,23,6,3,2
24,370,370,28,14,14,3,2
8,372,372,77,36,41,2,1
22,379,379,28,5,23,2,1
23,381,381,17,17,0,1,0
28,382,382,34,34,0,1,0
26,385,385,152,32,120,4,3
36,387,387,40,40,0,1,0
31,406,406,24,11,13,2,1
42,427,427,86,77,9,2,1
29,433,433,21,2,19,2,1
20,433,433,16,16,0,1,0
37,443,443,72,72,0,1,0
27,444,444,42,42,0,1,0
10,446,446,3,3,0,1,0
19,461,461,40,13,27,2,1
25,470,470,65,53,12,3,2
33,472,472,5,1,4,2,1
39,488,488,11,11,0,1,0
14,492,492,3,3,0,1,0
18,497,497,40,15,25,2,1

33,130,130,20,20,0,1,0
7,131,131,27,3,24,3,2
35,135,135,1,1,0,1,0
11,144,144,10,2,8,3,2
14,148,148,3,3,0,1,0
34,148,148,12,12,0,1,0
10,156,156,38,38,0,1,0
19,161,161,32,29,3,2,1
8,169,169,1,1,0,1,0
27,170,170,5,5,0,1,0
24,173,173,27,27,0,1,0
2,185,185,1,1,0,1,0
17,191,191,16,8,8,3,2
0,193,193,1,1,0,1,0
25,209,209,10,6,4,2,1
26,245,245,15,10,5,2,1
18,266,266,2,2,0,1,0
32,278,278,45,15,30,4,3
23,283,283,4,4,0,1,0
6,298,298,2,2,0,1,0
22,299,299,4,4,0,1,0
15,300,300,17,8,9,4,3
5,305,305,104,22,82,4,3
9,334,334,26,1,25,2,1
12,336,336,74,74,0,1,0
30,346,346,27,9,18,2,1
29,355,355,26,26,0,1,0
1,358,358,82,49,33,4,3
13,425,425,164,164,0,1,0
16,434,434,48,12,36,4,3
21,437,437,51,51,0,1,0
3,439,439,17,17,0,1,0
20,440,440,15,15,0,1,0
31,442,442,267,267,0,1,0
28,483,483,1,1,0,1,0
4,500,500,45,45,0,1,0

4,105,105,3,3,0,1,0
32,113,113,12,12,0,1,0
31,135,135,30,30,0,1,0
15,145,145,43,31,12,4,3
9,147,147,2,2,0,1,0
5,153,153,71,62,9,4,3
26,159,159,13,1,12,3,2
23,160,160,12,2,10,3,2
11,173,173,1,1,0,1,0
17,183,183,4,4,0,1,0
20,201,201,5,1,4,2,1
14,214,214,48,48,0,1,0
19,232,232,6,6,0,1,0
7,238,238,4,1,3,2,1
2,252,252,10,10,0,1,0
18,277,277,6,6,0,1,0
16,285,285,70,54,16,4,3
12,310,310,17,17,0,1,0
33,313,313,16,7,9,4,3
29,320,320,96,8,88,4,3
34,324,324,3,3,0,1,0
1,336,336,71,17,54,4,3
25,359,359,6,3,3,2,1
8,369,369,61,41,20,3,2
22,376,376,58,58,0,1,0
21,387,387,3,3,0,1,0
27,404,404,40,24,16,4,3
10,423,423,27,27,0,1,0
30,424,424,45,19,26,2,1
13,431,431,46,11,35,4,3
3,440,440,101,53,48,4,3
6,441,441,91,91,0,1,0
0,442,442,76,76,0,1,0
24,456,456,18,18,0,1,0
28,479,479,65,29,36,3,2

38,126,126,41,41,0,1,0
13,130,130,2,2,0,1,0
17,130,130,2,2,0,1,0
35,134,134,20,20,0,1,0
40,141,141,2,2,0,1,0
25,144,144,5,5,0,1,0
41,148,148,8,2,6,3,2
29,178,178,12,8,4,2,1
30,180,180,54,54,0,1,0
6,184,184,4,4,0,1,0
22,186,186,60,37,23,2,1
34,197,197,10,5,5,2,1
27,198,198,8,5,3,2,1
0,214,214,7,7,0,1,0
28,215,215,33,33,0,1,0
16,231,231,51,15,36,4,3
15,234,234,32,32,0,1,0
8,245,245,44,44,0,1,0
33,256,256,2,2,0,1,0
21,257,257,4,1,3,2,1
2,257,257,2,2,0,1,0
18,272,272,10,10,0,1,0
5,274,274,46,46,0,1,0
24,274,274,34,34,0,1,0
39,309,309,165,87,78,3,2
36,322,322,1,1,0,1,0
12,346,346,22,1,21,2,1
19,349,349,19,19,0,1,0
23,358,358,5,2,3,2,1
9,359,359,78,51,27,4,3
7,360,360,6,6,0,1,0
11,363,363,17,17,0,1,0
26,380,380,16,16,0,1,0
32,386,386,3,3,0,1,0
14,388,388,3,3,0,1,0
3,415,415,6,6,0,1,0
43,422,422,23,13,10,2,1
1,424,424,3,3,0,1,0
4,439,439,16,7,9,4,3
10,445,445,76,24,52,3,2
37,456,456,8,8,0,1,0
42,462,462,16,10,6,2,1
31,480,480,14,14,0,1,0
20,483,483,87,11,76,3,2

25,103,103,1,1,0,1,0
12,117,117,21,5,16,2,1
35,134,134,6,1,5,2,1
13,147,147,1,1,0,1,0
26,149,149,1,1,0,1,0
24,174,174,12,3,9,4,3
14,180,180,46,28,18,4,3
28,191,191,69,12,57,4,3
3,194,194,14,1,13,4,3
17,202,202,8,3,5,2,1
7,206,206,2,2,0,1,0
19,209,209,4,4,0,1,0
10,215,215,17,17,0,1,0
22,227,227,47,47,0,1,0
5,241,241,42,42,0,1,0
16,241,241,3,3,0,1,0
11,251,251,103,10,93,4,3
8,252,252,13,1,12,4,3
29,269,269,58,58,0,1,0
34,270,270,30,30,0,1,0
4,289,289,40,40,0,1,0
18,306,306,13,3,10,3,2
23,347,347,76,64,12,2,1
9,347,347,34,34,0,1,0
32,369,369,1,1,0,1,0
33,406,406,43,43,0,1,0
6,416,416,30,30,0,1,0
0,416,416,53,45,8,2,1
20,417,417,30,20,10,3,2
21,421,421,15,11,4,2,1
36,427,427,19,19,0,1,0
1,437,437,6,6,0,1,0
15,437,437,78,78,0,1,0
30,443,443,63,43,20,2,1
27,466,466,48,12,36,2,1
31,477,477,88,88,0,1,0
2,485,485,59,25,34,3,2

34,111,111,16,12,4,2,1
5,126,126,1,1,0,1,0
12,133,133,4,4,0,1,0
25,147,147,64,20,44,2,1
32,153,153,13,13,0,1,0
22,156,156,1,1,0,1,0
28,160,160,25,10,15,2,1
21,161,161,45,45,0,1,0
36,169,169,31,31,0,1,0
9,171,171,18,18,0,1,0
6,175,175,3,3,0,1,0
41,185,185,13,13,0,1,0
0,186,186,1,1,0,1,0
31,188,188,1,1,0,1,0
43,194,194,31,31,0,1,0
1,206,206,8,8,0,1,0
29,210,210,19,19,0,1,0
40,211,211,34,1,33,4,3
38,216,216,4,4,0,1,0
10,228,228,21,6,15,2,1
19,237,237,26,26,0,1,0
26,257,257,8,8,0,1,0
33,268,268,30,18,12,3,2
13,278,278,12,12,0,1,0
24,280,280,21,11,10,2,1
4,284,284,7,7,0,1,0
14,297,297,32,4,28,2,1
11,297,297,89,77,12,4,3
39,311,311,9,1,8,3,2
35,311,311,69,58,11,2,1
37,328,328,6,6,0,1,0
17,340,340,16,16,0,1,0
20,347,347,20,20,0,1,0
23,347,347,30,30,0,1,0
42,371,371,6,6,0,1,0
3,377,377,39,39,0,1,0
16,384,384,11,11,0,1,0
2,404,404,80,59,21,3,2
30,408,408,10,10,0,1,0
7,417,417,68,46,22,3,2
18,440,440,6,1,5,2,1
8,457,457,18,18,0,1,0
15,470,470,45,45,0,1,0
27,486,486,8,8,0,1,0

17,100,100,18,4,14,2,1
10,117,117,30,30,0,1,0
4,118,118,14,14,0,1,0
21,126,126,17,17,0,1,0
16,128,128,12,12,0,1,0
34,146,146,15,12,3,2,1
9,164,164,9,4,5,2,1
3,169,169,11,11,0,1,0
33,176,176,8,3,5,2,1
1,189,189,3,3,0,1,0
31,199,199,15,1,14,3,2
35,201,201,28,28,0,1,0
12,206,206,28,28,0,1,0
11,210,210,39,39,0,1,0
20,234,234,51,23,28,2,1
13,238,238,25,4,21,2,1
27,264,264,22,22,0,1,0
15,268,268,6,6,0,1,0
6,286,286,25,25,0,1,0
5,290,290,23,2,21,2,1
32,301,301,63,63,0,1,0
14,305,305,33,33,0,1,0
26,321,321,17,17,0,1,0
28,330,330,4,4,0,1,0
8,337,337,31,3,28,3,2
38,371,371,16,6,10,2,1
30,374,374,3,3,0,1,0
2,382,382,50,50,0,1,0
23,399,399,15,15,0,1,0
37,401,401,104,104,0,1,0
7,404,404,64,34,30,2,1
18,412,412,4,4,0,1,0
25,432,432,43,18,25,4,3
0,435,435,44,44,0,1,0
24,459,459,48,9,39,4,3
19,462,462,63,28,35,2,1
29,464,464,40,40,0,1,0
36,483,483,5,5,0,1,0
22,499,499,90,90,0,1,0

9,104,104,1,1,0,1,0
21,116,116,33,1,32,2,1
30,120,120,10,10,0,1,0
27,131,131,1,1,0,1,0
25,143,143,5,5,0,1,0
6,144,144,4,4,0,1,0
8,146,146,9,4,5,2,1
22,147,147,15,15,0,1,0
34,149,149,4,4,0,1,0
33,149,149,10,1,9,4,3
0,158,158,7,2,5,2,1
4,171,171,42,42,0,1,0
19,175,175,10,6,4,2,1
12,175,175,4,4,0,1,0
2,181,181,1,1,0,1,0
5,186,186,132,30,102,4,3
23,196,196,4,4,0,1,0
13,214,214,50,47,3,2,1
15,226,226,31,20,11,2,1
35,231,231,5,5,0,1,0
16,233,233,19,13,6,2,1
36,253,253,33,33,0,1,0
31,261,261,42,42,0,1,0
20,266,266,18,3,15,2,1
3,282,282,24,4,20,3,2
37,286,286,78,55,23,2,1
17,299,299,21,11,10,2,1
29,310,310,27,3,24,3,2
28,339,339,14,14,0,1,0
18,341,341,43,43,0,1,0
10,344,344,32,32,0,1,0
24,378,378,5,5,0,1,0
26,381,381,147,147,0,1,0
7,451,451,27,27,0,1,0
32,454,454,24,15,9,4,3
14,476,476,1,1,0,1,0
1,496,496,2,2,0,1,0
11,496,496,54,26,28,2,1

20,119,119,16,16,0,1,0
45,121,121,6,6,0,1,0
15,141,141,9,9,0,1,0
25,144,144,6,3,3,2,1
38,183,183,20,20,0,1,0
21,184,184,5,5,0,1,0
36,195,195,6,1,5,2,1
35,195,195,10,10,0,1,0
32,195,195,4,4,0,1,0
13,202,202,20,20,0,1,0
5,208,208,1,1,0,1,0
17,213,213,2,2,0,1,0
33,221,221,38,38,0,1,0
16,244,244,50,50,0,1,0
7,263,263,12,2,10,2,1
9,272,272,4,4,0,1,0
24,276,276,30,30,0,1,0
31,290,290,15,15,0,1,0
10,300,300,9,9,0,1,0
0,310,310,7,7,0,1,0
37,313,313,122,122,0,1,0
11,317,317,74,74,0,1,0
42,337,337,22,4,18,4,3
40,339,339,5,5,0,1,0
1,350,350,60,50,10,3,2
8,353,353,1,1,0,1,0
14,357,357,98,98,0,1,0
39,358,358,11,2,9,2,1
12,359,359,1,1,0,1,0
34,363,363,39,39,0,1,0
41,375,375,4,4,0,1,0
30,383,383,31,10,21,2,1
22,407,407,29,5,24,3,2
6,411,411,29,20,9,4,3
19,412,412,22,18,4,2,1
2,416,416,77,65,12,4,3
3,432,432,5,5,0,1,0
44,433,433,87,73,14,2,1
4,442,442,3,3,0,1,0
18,452,452,16,1,15,4,3
43,459,459,24,9,15,2,1
23,460,460,35,20,15,4,3
28,474,474,180,180,0,1,0
27,477,477,27,4,23,4,3
29,478,478,49,49,0,1,0
26,490,490,26,26,0,1,0

5,106,106,22,22,0,1,0
1,111,111,16,16,0,1,0
32,112,112,25,25,0,1,0
24,117,117,19,8,11,2,1
3,133,133,5,5,0,1,0
11,147,147,8,3,5,2,1
10,164,164,20,20,0,1,0
6,164,164,57,57,0,1,0
13,167,167,1,1,0,1,0
12,173,173,14,2,12,2,1
39,175,175,2,2,0,1,0
18,186,186,2,2,0,1,0
28,195,195,33,33,0,1,0
8,199,199,44,44,0,1,0
22,201,201,19,1,18,2,1
36,211,211,15,15,0,1,0
21,220,220,1,1,0,1,0
26,241,241,4,4,0,1,0
38,252,252,5,5,0,1,0
2,258,258,5,5,0,1,0
34,301,301,1,1,0,1,0
30,308,308,13,13,0,1,0
0,346,346,13,13,0,1,0
33,346,346,158,41,117,4,3
19,349,349,23,23,0,1,0
29,352,352,35,6,29,4,3
31,361,361,16,16,0,1,0
35,364,364,25,25,0,1,0
27,371,371,115,70,45,4,3
9,388,388,9,9,0,1,0
4,395,395,33,21,12,4,3
25,398,398,3,3,0,1,0
16,415,415,89,89,0,1,0
20,427,427,83,73,10,3,2
37,456,456,21,21,0,1,0
17,482,482,98,12,86,3,2
15,484,484,31,4,27,2,1
14,486,486,5,5,0,1,0
7,488,488,23,23,0,1,0
23,497,497,1,1,0,1,0

25,107,107,17,5,12,2,1
34,109,109,4,4,0,1,0
16,110,110,17,17,0,1,0
23,125,125,8,8,0,1,0
33,140,140,5,5,0,1,0
8,148,148,13,6,7,2,1
41,150,150,16,4,12,3,2
7,165,165,12,12,0,1,0
24,173,173,1,1,0,1,0
1,185,185,7,7,0,1,0
14,186,186,8,8,0,1,0
18,191,191,5,5,0,1,0
28,197,197,24,3,21,2,1
20,212,212,2,2,0,1,0
10,255,255,60,60,0,1,0
37,260,260,29,11,18,4,3
17,269,269,7,7,0,1,0
22,271,271,57,46,11,2,1
0,281,281,50,50,0,1,0
29,286,286,46,22,24,3,2
26,293,293,48,32,16,2,1
6,294,294,2,2,0,1,0
3,307,307,23,11,12,4,3
35,316,316,13,7,6,3,2
32,322,322,102,84,18,2,1
15,326,326,12,12,0,1,0
19,327,327,62,62,0,1,0
42,347,347,14,14,0,1,0
9,374,374,47,47,0,1,0
40,394,394,41,14,27,4,3
27,397,397,3,3,0,1,0
36,413,413,11,1,10,3,2
30,414,414,132,132,0,1,0
2,428,428,53,39,14,3,2
5,430,430,8,8,0,1,0
31,433,433,1,1,0,1,0
4,443,443,44,44,0,1,0
11,446,446,2,2,0,1,0
39,448,448,30,30,0,1,0
13,474,474,99,71,28,4,3
38,480,480,71,16,55,4,3
21,483,483,4,4,0,1,0
12,486,486,12,12,0,1,0

28,106,106,5,5,0,1,0
4,107,107,18,18,0,1,0
5,125,125,7,7,0,1,0
18,159,159,13,13,0,1,0
36,159,159,15,15,0,1,0
7,172,172,1,1,0,1,0
47,184,184,4,4,0,1,0
2,196,196,1,1,0,1,0
41,198,198,41,41,0,1,0
42,200,200,6,3,3,2,1
39,206,206,50,50,0,1,0
19,213,213,35,35,0,1,0
20,226,226,8,8,0,1,0
34,226,226,2,2,0,1,0
37,228,228,19,19,0,1,0
16,229,229,14,8,6,3,2
40,230,230,8,1,7,2,1
22,231,231,12,12,0,1,0
1,245,245,14,14,0,1,0
0,246,246,54,54,0,1,0
26,254,254,7,7,0,1,0
21,276,276,12,2,10,3,2
3,290,290,10,10,0,1,0
6,296,296,61,61,0,1,0
38,297,297,36,14,22,3,2
14,299,299,3,3,0,1,0
8,316,316,1,1,0,1,0
31,317,317,17,17,0,1,0
25,329,329,33,33,0,1,0
17,329,329,61,25,36,2,1
29,339,339,26,26,0,1,0
35,349,349,53,41,12,4,3
32,361,361,54,23,31,3,2
27,371,371,19,14,5,2,1
12,384,384,12,12,0,1,0
45,393,393,37,23,14,2,1
9,404,404,48,23,25,2,1
13,407,407,16,1,15,2,1
44,416,416,52,31,21,2,1
46,416,416,15,3,12,4,3
23,418,418,1,1,0,1,0
43,425,425,106,90,16,2,1
15,429,429,31,5,26,3,2
11,430,430,27,27,0,1,0
10,431,431,8,3,5,2,1
33,456,456,67,67,0,1,0
30,465,465,29,17,12,4,3
24,486,486,43,43,0,1,0

25,104,104,5,5,0,1,0
44,106,106,12,12,0,1,0
6,126,126,14,9,5,2,1
33,134,134,9,4,5,2,1
34,147,147,10,4,6,2,1
29,167,167,39,39,0,1,0
41,168,168,37,37,0,1,0
21,171,171,12,12,0,1,0
32,186,186,22,6,16,2,1
13,200,200,4,4,0,1,0
16,216,216,12,12,0,1,0
43,232,232,23,11,12,2,1
28,235,235,13,10,3,2,1
31,249,249,72,72,0,1,0
3,255,255,38,29,9,4,3
40,268,268,51,51,0,1,0
36,269,269,35,35,0,1,0
9,278,278,4,4,0,1,0
14,283,283,39,39,0,1,0
19,284,284,14,14,0,1,0
45,293,293,18,2,16,4,3
5,309,309,6,6,0,1,0
12,315,315,14,3,11,2,1
11,318,318,17,3,14,2,1
7,328,328,41,14,27,4,3
20,341,341,6,6,0,1,0
2,360,360,16,4,12,4,3
39,361,361,33,18,15,4,3
37,361,361,16,16,0,1,0
1,369,369,16,4,12,2,1
23,369,369,25,4,21,4,3
24,377,377,11,2,9,4,3
15,384,384,11,11,0,1,0
26,392,392,17,3,14,3,2
0,397,397,97,97,0,1,0
30,403,403,3,3,0,1,0
27,411,411,32,14,18,2,1
35,411,411,5,5,0,1,0
38,413,413,6,6,0,1,0
42,426,426,52,34,18,3,2
46,428,428,11,2,9,2,1
8,438,438,1,1,0,1,0
18,442,442,27,12,15,2,1
4,449,449,85,79,6,2,1
10,450,450,43,43,0,1,0
22,451,451,91,91,0,1,0
17,481,481,17,12,5,2,1

38,104,104,6,6,0,1,0
30,107,107,12,12,0,1,0
31,107,107,25,16,9,4,3
7,109,109,9,9,0,1,0
19,114,114,10,10,0,1,0
6,120,120,31,31,0,1,0
20,123,123,18,18,0,1,0
17,170,170,14,14,0,1,0
35,177,177,13,13,0,1,0
22,184,184,3,3,0,1,0
24,186,186,3,3,0,1,0
12,213,213,10,10,0,1,0
4,217,217,35,35,0,1,0
18,222,222,2,2,0,1,0
23,228,228,44,38,6,3,2
32,232,232,39,11,28,3,2
2,236,236,34,9,25,2,1
15,237,237,15,15,0,1,0
0,240,240,13,7,6,2,1
11,274,274,20,8,12,3,2
5,285,285,31,31,0,1,0
8,340,340,10,10,0,1,0
40,348,348,26,26,0,1,0
26,350,350,7,2,5,2,1
16,353,353,5,5,0,1,0
29,364,364,11,2,9,4,3
21,364,364,4,1,3,2,1
36,379,379,33,33,0,1,0
33,389,389,70,70,0,1,0
39,391,391,113,2,111,4,3
10,392,392,56,56,0,1,0
34,407,407,46,25,21,4,3
28,423,423,61,61,0,1,0
27,429,429,5,5,0,1,0
37,430,430,45,45,0,1,0
25,435,435,49,49,0,1,0
1,435,435,64,64,0,1,0
3,439,439,66,66,0,1,0
13,472,472,21,21,0,1,0
9,480,480,23,8,15,4,3
14,481,481,54,33,21,4,3

14,121,121,1,1,0,1,0
19,125,125,20,13,7,2,1
2,128,128,19,4,15,4,3
23,131,131,1,1,0,1,0
17,135,135,27,15,12,4,3
35,135,135,5,5,0,1,0
5,141,141,38,5,33,2,1
32,152,152,26,26,0,1,0
21,187,187,19,19,0,1,0
16,207,207,34,34,0,1,0
12,224,224,12,12,0,1,0
34,229,229,8,8,0,1,0
33,230,230,128,116,12,4,3
18,235,235,17,17,0,1,0
11,239,239,28,28,0,1,0
27,241,241,60,52,8,3,2
29,252,252,43,43,0,1,0
10,271,271,30,30,0,1,0
13,326,326,29,7,22,2,1
25,337,337,60,21,39,4,3
22,340,340,2,2,0,1,0
0,343,343,66,20,46,2,1
24,346,346,13,4,9,2,1
1,353,353,35,35,0,1,0
28,364,364,11,11,0,1,0
15,365,365,1,1,0,1,0
3,371,371,25,14,11,4,3
26,385,385,1,1,0,1,0
37,411,411,10,4,6,3,2
6,412,412,12,6,6,3,2
4,426,426,11,4,7,2,1
8,431,431,26,15,11,2,1
36,431,431,26,12,14,3,2
9,438,438,124,7,117,4,3
20,462,462,29,29,0,1,0
7,463,463,38,38,0,1,0
30,489,489,13,2,11,2,1
31,499,499,27,27,0,1,0

25,106,106,18,10,8,3,2
1,111,111,15,3,12,3,2
23,125,125,1,1,0,1,0
26,126,126,11,2,9,4,3
32,133,133,33,21,12,2,1
15,134,134,6,6,0,1,0
5,149,149,89,19,70,3,2
36,180,180,26,26,0,1,0
9,196,196,1,1,0,1,0
21,211,211,31,31,0,1,0
18,216,216,22,1,21,4,3
3,217,217,3,3,0,1,0
8,220,220,9,9,0,1,0
14,228,228,23,13,10,3,2
7,242,242,19,1,18,3,2
27,247,247,28,3,25,3,2
30,249,249,24,12,12,2,1
34,252,252,6,2,4,2,1
2,256,256,28,28,0,1,0
33,276,276,23,8,15,2,1
13,278,278,1,1,0,1,0
19,278,278,5,5,0,1,0
24,301,301,28,28,0,1,0
28,325,325,112,73,39,2,1
12,330,330,9,9,0,1,0
31,332,332,60,60,0,1,0
0,342,342,71,33,38,4,3
10,360,360,61,13,48,4,3
29,371,371,13,13,0,1,0
22,376,376,2,2,0,1,0
17,400,400,52,28,24,4,3
4,405,405,85,85,0,1,0
11,410,410,19,19,0,1,0
16,412,412,28,28,0,1,0
6,417,417,60,60,0,1,0
20,424,424,6,6,0,1,0
35,483,483,1,1,0,1,0

32,105,105,13,13,0,1,0
21,130,130,7,7,0,1,0
30,135,135,1,1,0,1,0
15,138,138,1,1,0,1,0
19,141,141,31,10,21,2,1
23,144,144,20,20,0,1,0
5,147,147,27,27,0,1,0
26,168,168,2,2,0,1,0
2,194,194,17,17,0,1,0
10,225,225,5,5,0,1,0
16,226,226,15,2,13,4,3
24,246,246,25,25,0,1,0
13,250,250,73,55,18,4,3
22,258,258,26,12,14,3,2
25,264,264,38,17,21,4,3
28,269,269,53,32,21,4,3
20,309,309,93,75,18,2,1
9,310,310,38,5,33,4,3
6,313,313,48,42,6,3,2
8,335,335,132,97,35,4,3
3,349,349,10,10,0,1,0
17,355,355,28,28,0,1,0
0,370,370,94,94,0,1,0
1,377,377,50,36,14,2,1
14,385,385,24,24,0,1,0
11,416,416,14,14,0,1,0
31,427,427,20,1,19,2,1
27,430,430,3,3,0,1,0
18,445,445,104,104,0,1,0
33,448,448,10,10,0,1,0
4,470,470,32,32,0,1,0
29,476,476,61,44,17,4,3
7,477,477,17,7,10,2,1
12,479,479,92,26,66,3,2

0,105,105,17,5,12,2,1
9,105,105,17,7,10,3,2
28,113,113,4,1,3,2,1
17,129,129,31,31,0,1,0
4,162,162,67,67,0,1,0
15,173,173,8,8,0,1,0
25,176,176,24,8,16,3,2
12,185,185,7,1,6,2,1
33,191,191,41,41,0,1,0
27,228,228,56,53,3,2,1
1,229,229,9,9,0,1,0
2,230,230,40,40,0,1,0
20,239,239,6,3,3,2,1
13,247,247,17,17,0,1,0
18,267,267,10,1,9,4,3
24,290,290,14,14,0,1,0
3,300,300,46,46,0,1,0
30,305,305,70,49,21,4,3
23,310,310,19,19,0,1,0
34,318,318,43,43,0,1,0
22,319,319,8,2,6,2,1
16,335,335,31,22,9,2,1
32,347,347,1,1,0,1,0
8,351,351,77,77,0,1,0
31,374,374,23,15,8,3,2
14,376,376,27,27,0,1,0
21,417,417,134,62,72,4,3
10,419,419,5,5,0,1,0
26,430,430,17,14,3,2,1
7,456,456,32,32,0,1,0
11,461,461,16,16,0,1,0
6,478,478,2,2,0,1,0
29,484,484,10,3,7,2,1
19,489,489,11,11,0,1,0
5,493,493,186,119,67,4,3

27,123,123,3,3,0,1,0
2,131,131,9,9,0,1,0
25,134,134,4,4,0,1,0
13,146,146,6,6,0,1,0
7,147,147,32,32,0,1,0
11,147,147,6,6,0,1,0
16,153,153,1,1,0,1,0
6,172,172,8,2,6,2,1
30,175,175,6,2,4,2,1
4,184,184,8,8,0,1,0
3,201,201,124,115,9,2,1
23,207,207,102,22,80,4,3
10,216,216,9,6,3,2,1
18,218,218,30,30,0,1,0
34,249,249,25,25,0,1,0
22,275,275,37,37,0,1,0
21,302,302,24,24,0,1,0
12,317,317,62,62,0,1,0
20,344,344,52,16,36,3,2
1,350,350,47,22,25,2,1
14,365,365,40,40,0,1,0
9,386,386,41,9,32,3,2
19,408,408,3,3,0,1,0
24,413,413,62,38,24,3,2
31,424,424,8,5,3,2,1
0,437,437,44,44,0,1,0
17,442,442,79,79,0,1,0
8,454,454,32,32,0,1,0
15,458,458,14,14,0,1,0
28,481,481,30,30,0,1,0
5,481,481,80,80,0,1,0
29,485,485,11,7,4,2,1
32,492,492,6,6,0,1,0
33,493,493,58,4,54,4,3
26,499,499,124,111,13,2,1

7,111,111,3,3,0,1,0
28,121,121,3,3,0,1,0
23,127,127,34,34,0,1,0
18,147,147,10,10,0,1,0
3,177,177,17,17,0,1,0
1,182,182,47,47,0,1,0
16,197,197,75,45,30,4,3
32,206,206,43,43,0,1,0
30,213,213,15,1,14,3,2
4,213,213,26,20,6,3,2
13,215,215,10,10,0,1,0
17,220,220,40,40,0,1,0
0,225,225,25,7,18,3,2
2,233,233,28,28,0,1,0
19,242,242,5,1,4,2,1
10,246,246,12,4,8,3,2
34,249,249,7,7,0,1,0
26,258,258,1,1,0,1,0
35,269,269,6,6,0,1,0
9,274,274,19,19,0,1,0
20,279,279,15,6,9,4,3
31,283,283,31,31,0,1,0
24,292,292,22,10,12,3,2
5,295,295,2,2,0,1,0
33,298,298,21,11,10,3,2
14,312,312,30,24,6,3,2
25,322,322,58,58,0,1,0
27,356,356,69,14,55,4,3
11,384,384,12,12,0,1,0
22,387,387,87,49,38,3,2
15,414,414,160,150,10,2,1
36,422,422,36,11,25,2,1
21,423,423,16,16,0,1,0
29,427,427,48,14,34,2,1
6,432,432,50,24,26,2,1
8,454,454,31,31,0,1,0
12,471,471,9,2,7,2,1

17,103,103,23,23,0,1,0
22,108,108,1,1,0,1,0
10,122,122,8,8,0,1,0
1,124,124,29,29,0,1,0
30,153,153,35,35,0,1,0
35,168,168,2,2,0,1,0
7,175,175,8,8,0,1,0
20,177,177,12,12,0,1,0
19,182,182,10,3,7,2,1
6,201,201,21,21,0,1,0
3,201,201,6,6,0,1,0
9,207,207,10,4,6,2,1
27,237,237,69,69,0,1,0
21,239,239,29,29,0,1,0
36,254,254,66,66,0,1,0
29,270,270,17,5,12,4,3
12,287,287,13,13,0,1,0
31,294,294,4,4,0,1,0
2,296,296,6,6,0,1,0
5,319,319,1,1,0,1,0
15,334,334,9,2,7,3,2
11,365,365,42,2,40,3,2
28,376,376,22,22,0,1,0
16,396,396,225,225,0,1,0
25,397,397,14,1,13,4,3
13,415,415,38,38,0,1,0
33,440,440,64,64,0,1,0
26,441,441,87,87,0,1,0
32,443,443,22,4,18,3,2
18,447,447,31,4,27,4,3
24,457,457,4,4,0,1,0
4,457,457,191,107,84,4,3
23,464,464,11,11,0,1,0
14,473,473,18,18,0,1,0
8,478,478,19,15,4,2,1
0,481,481,52,22,30,4,3
34,484,484,52,1,51,4,3

7,105,105,13,3,10,2,1
24,111,111,26,26,0,1,0
18,117,117,13,13,0,1,0
33,118,118,22,7,15,2,1
31,119,119,6,6,0,1,0
32,153,153,17,17,0,1,0
10,180,180,14,14,0,1,0
8,190,190,11,11,0,1,0
6,192,192,21,21,0,1,0
14,203,203,37,37,0,1,0
3,241,241,11,11,0,1,0
17,262,262,4,4,0,1,0
22,264,264,20,20,0,1,0
9,268,268,101,101,0,1,0
11,272,272,87,41,46,4,3
21,276,276,13,13,0,1,0
16,276,276,3,3,0,1,0
1,293,293,4,4,0,1,0
4,294,294,12,6,6,2,1
25,315,315,2,2,0,1,0
27,316,316,30,26,4,2,1
26,319,319,86,14,72,4,3
20,321,321,47,47,0,1,0
2,321,321,5,5,0,1,0
28,333,333,41,41,0,1,0
30,340,340,9,1,8,2,1
12,346,346,75,2,73,4,3
15,381,381,21,21,0,1,0
5,398,398,118,24,94,3,2
29,415,415,70,22,48,3,2
19,434,434,11,8,3,2,1
13,453,453,134,122,12,4,3
0,472,472,5,1,4,2,1
23,479,479,48,48,0,1,0

10,104,104,5,5,0,1,0
16,114,114,24,8,16,2,1
0,126,126,19,19,0,1,0
24,146,146,28,28,0,1,0
7,155,155,13,13,0,1,0
15,182,182,7,7,0,1,0
2,195,195,3,3,0,1,0
14,197,197,89,89,0,1,0
6,202,202,55,43,12,2,1
22,219,219,23,4,19,2,1
18,232,232,32,2,30,4,3
13,257,257,34,34,0,1,0
20,285,285,8,8,0,1,0
26,304,304,12,12,0,1,0
8,313,313,51,51,0,1,0
11,313,313,33,33,0,1,0
9,323,323,30,18,12,3,2
23,352,352,34,34,0,1,0
27,369,369,39,13,26,4,3
25,370,370,10,4,6,3,2
29,371,371,35,10,25,2,1
28,380,380,13,13,0,1,0
1,386,386,200,187,13,2,1
21,401,401,33,25,8,2,1
19,413,413,21,12,9,4,3
12,416,416,12,6,6,2,1
4,419,419,110,110,0,1,0
17,460,460,15,1,14,2,1
3,462,462,28,19,9,2,1
5,469,469,179,179,0,1,0

9,117,117,28,28,0,1,0
15,144,144,15,15,0,1,0
34,146,146,9,9,0,1,0
30,169,169,3,3,0,1,0
12,179,179,5,5,0,1,0
25,183,183,5,5,0,1,0
33,184,184,7,1,6,2,1
2,193,193,1,1,0,1,0
48,197,197,13,3,10,2,1
21,199,199,26,8,18,2,1
40,206,206,46,46,0,1,0
3,220,220,25,9,16,3,2
47,221,221,24,12,12,4,3
29,222,222,41,20,21,4,3
6,226,226,25,1,24,3,2
17,231,231,3,3,0,1,0
27,237,237,18,18,0,1,0
28,241,241,7,7,0,1,0
23,257,257,59,59,0,1,0
46,270,270,16,1,15,2,1
45,276,276,7,3,4,2,1
26,281,281,7,7,0,1,0
1,305,305,8,8,0,1,0
20,309,309,7,1,6,3,2
41,316,316,19,19,0,1,0
22,326,326,82,82,0,1,0
35,328,328,1,1,0,1,0
13,347,347,21,21,0,1,0
4,354,354,44,18,26,2,1
0,357,357,28,2,26,3,2
44,374,374,7,7,0,1,0
16,386,386,3,3,0,1,0
36,389,389,34,34,0,1,0
24,392,392,1,1,0,1,0
5,410,410,19,1,18,3,2
11,415,415,7,7,0,1,0
39,425,425,40,40,0,1,0
43,430,430,29,29,0,1,0
8,433,433,4,4,0,1,0
42,436,436,154,146,8,3,2
19,438,438,25,9,16,2,1
37,442,442,13,13,0,1,0
38,446,446,220,199,21,4,3
10,450,450,56,16,40,4,3
32,463,463,15,2,13,2,1
7,466,466,6,6,0,1,0
18,469,469,1,1,0,1,0
14,494,494,13,6,7,2,1
31,498,498,3,3,0,1,0

7,105,105,38,38,0,1,0
22,108,108,35,9,26,3,2
35,141,141,11,11,0,1,0
24,161,161,9,9,0,1,0
21,161,161,10,1,9,2,1
33,172,172,22,22,0,1,0
4,173,173,28,16,12,4,3
14,181,181,9,9,0,1,0
10,189,189,25,25,0,1,0
0,191,191,13,13,0,1,0
11,205,205,12,3,9,4,3
40,207,207,9,9,0,1,0
39,237,237,1,1,0,1,0
6,242,242,1,1,0,1,0
12,245,245,7,3,4,2,1
16,248,248,59,59,0,1,0
30,259,259,16,16,0,1,0
28,260,260,39,11,28,2,1
20,261,261,35,35,0,1,0
31,264,264,3,3,0,1,0
38,278,278,108,108,0,1,0
1,286,286,1,1,0,1,0
34,292,292,15,15,0,1,0
2,293,293,52,40,12,4,3
5,293,293,23,9,14,2,1
13,297,297,2,2,0,1,0
26,327,327,77,45,32,2,1
3,333,333,12,8,4,2,1
9,349,349,31,2,29,2,1
29,363,363,61,39,22,2,1
8,401,401,15,15,0,1,0
27,405,405,25,25,0,1,0
19,408,408,37,11,26,3,2
32,410,410,22,22,0,1,0
18,412,412,10,10,0,1,0
23,421,421,6,6,0,1,0
25,450,450,53,41,12,4,3
15,456,456,98,57,41,2,1
36,470,470,3,3,0,1,0
37,484,484,9,5,4,2,1
17,500,500,3,3,0,1,0

22,105,105,1,1,0,1,0
14,117,117,1,1,0,1,0
10,128,128,6,6,0,1,0
26,135,135,10,10,0,1,0
1,143,143,1,1,0,1,0
23,143,143,9,9,0,1,0
9,150,150,1,1,0,1,0
31,161,161,1,1,0,1,0
29,166,166,3,3,0,1,0
4,175,175,7,1,6,3,2
12,185,185,9,1,8,2,1
36,192,192,82,46,36,4,3
8,192,192,1,1,0,1,0
45,204,204,60,60,0,1,0
52,209,209,40,20,20,3,2
47,220,220,44,44,0,1,0
24,231,231,3,3,0,1,0
17,240,240,16,7,9,4,3
48,242,242,36,26,10,3,2
35,247,247,7,7,0,1,0
54,247,247,8,8,0,1,0
50,247,247,11,11,0,1,0
33,249,249,27,21,6,2,1
18,271,271,9,2,7,2,1
0,286,286,1,1,0,1,0
55,288,288,22,12,10,3,2
7,289,289,12,12,0,1,0
51,291,291,8,5,3,2,1
5,296,296,20,20,0,1,0
43,300,300,21,21,0,1,0
11,316,316,1,1,0,1,0
40,326,326,43,43,0,1,0
16,328,328,34,20,14,2,1
38,344,344,18,4,14,2,1
39,344,344,5,5,0,1,0
32,350,350,77,61,16,3,2
37,351,351,6,6,0,1,0
21,384,384,38,38,0,1,0
25,391,391,11,1,10,2,1
19,394,394,30,30,0,1,0
53,395,395,22,5,17,2,1
42,400,400,26,2,24,2,1
49,419,419,39,11,28,2,1
44,421,421,11,2,9,4,3
6,425,425,60,60,0,1,0
20,438,438,16,10,6,3,2
2,439,439,16,16,0,1,0
34,461,461,36,7,29,2,1
28,465,465,15,15,0,1,0
30,466,466,14,2,12,2,1
3,474,474,6,6,0,1,0
46,476,476,30,3,27,4,3
41,480,480,6,6,0,1,0
13,492,492,27,5,22,4,3
27,494,494,43,31,12,4,3
15,498,498,133,61,72,4,3

9,130,130,23,23,0,1,0
2,151,151,11,6,5,2,1
20,197,197,79,72,7,2,1
22,202,202,23,23,0,1,0
30,204,204,12,12,0,1,0
15,206,206,68,56,12,4,3
18,210,210,28,16,12,3,2
4,216,216,57,27,30,3,2
24,251,251,8,8,0,1,0
31,269,269,42,42,0,1,0
28,272,272,13,13,0,1,0
32,288,288,25,6,19,2,1
14,291,291,14,14,0,1,0
10,293,293,1,1,0,1,0
26,324,324,1,1,0,1,0
33,335,335,26,26,0,1,0
27,343,343,14,14,0,1,0
12,344,344,2,2,0,1,0
35,353,353,22,2,20,2,1
7,354,354,108,35,73,4,3
5,355,355,1,1,0,1,0
16,373,373,14,7,7,2,1
21,380,380,28,2,26,2,1
34,388,388,54,39,15,4,3
11,400,400,37,16,21,2,1
23,402,402,45,4,41,2,1
8,410,410,42,36,6,2,1
6,413,413,56,23,33,4,3
17,414,414,66,66,0,1,0
0,421,421,42,42,0,1,0
13,439,439,31,25,6,2,1
3,452,452,40,19,21,4,3
25,457,457,37,28,9,4,3
19,466,466,1,1,0,1,0
1,493,493,100,4,96,3,2
29,493,493,104,2,102,4,3

11,105,105,19,5,14,2,1
32,113,113,16,16,0,1,0
31,129,129,35,27,8,3,2
33,146,146,11,6,5,2,1
20,152,152,4,4,0,1,0
16,153,153,10,4,6,3,2
8,161,161,7,7,0,1,0
9,165,165,6,6,0,1,0
27,198,198,24,3,21,4,3
21,198,198,3,3,0,1,0
12,204,204,14,14,0,1,0
36,212,212,50,42,8,2,1
15,282,282,14,9,5,2,1
19,286,286,15,15,0,1,0
23,292,292,4,4,0,1,0
1,293,293,16,16,0,1,0
34,294,294,34,26,8,2,1
18,297,297,25,13,12,2,1
24,308,308,55,55,0,1,0
10,318,318,22,22,0,1,0
25,324,324,13,3,10,3,2
7,329,329,58,8,50,3,2
22,331,331,97,97,0,1,0
5,331,331,30,12,18,2,1
30,345,345,5,5,0,1,0
35,364,364,82,75,7,2,1
28,367,367,20,20,0,1,0
2,392,392,41,28,13,2,1
26,395,395,18,18,0,1,0
4,410,410,120,6,114,4,3
0,420,420,17,5,12,2,1
3,435,435,11,11,0,1,0
13,450,450,12,4,8,3,2
6,453,453,97,46,51,4,3
17,485,485,5,5,0,1,0
14,490,490,228,173,55,3,2
29,500,500,19,3,16,4,3

11,115,115,2,2,0,1,0
41,116,116,17,9,8,3,2
29,126,126,32,4,28,3,2
44,126,126,13,5,8,3,2
20,128,128,6,6,0,1,0
4,144,144,1,1,0,1,0
25,151,151,12,12,0,1,0
40,155,155,33,33,0,1,0
6,164,164,4,1,3,2,1
12,166,166,3,3,0,1,0
38,171,171,7,7,0,1,0
16,190,190,6,6,0,1,0
3,200,200,7,3,4,2,1
26,203,203,1,1,0,1,0
27,205,205,7,7,0,1,0
22,205,205,14,14,0,1,0
2,217,217,8,8,0,1,0
31,227,227,48,48,0,1,0
43,263,263,32,32,0,1,0
32,263,263,75,34,41,4,3
8,314,314,44,44,0,1,0
34,319,319,10,3,7,2,1
15,321,321,1,1,0,1,0
9,327,327,76,66,10,3,2
13,334,334,7,7,0,1,0
42,337,337,26,14,12,4,3
37,344,344,39,5,34,3,2
28,377,377,22,2,20,2,1
33,378,378,34,34,0,1,0
30,379,379,8,8,0,1,0
18,380,380,5,5,0,1,0
23,391,391,150,130,20,2,1
1,401,401,33,16,17,3,2
10,426,426,16,16,0,1,0
7,429,429,84,55,29,2,1
21,430,430,57,57,0,1,0
0,431,431,5,5,0,1,0
24,435,435,7,7,0,1,0
19,435,435,113,77,36,4,3
39,448,448,30,30,0,1,0
35,459,459,16,16,0,1,0
5,465,465,4,4,0,1,0
14,470,470,19,8,11,2,1
36,477,477,30,30,0,1,0
17,488,488,67,67,0,1,0

17,111,111,15,7,8,2,1
31,116,116,29,29,0,1,0
15,119,119,14,14,0,1,0
1,125,125,5,5,0,1,0
10,135,135,19,19,0,1,0
32,145,145,20,2,18,4,3
36,149,149,56,30,26,4,3
18,149,149,23,1,22,2,1
22,151,151,1,1,0,1,0
19,158,158,29,14,15,4,3
33,167,167,6,2,4,2,1
11,186,186,7,7,0,1,0
29,207,207,5,5,0,1,0
7,216,216,15,1,14,3,2
2,217,217,16,4,12,3,2
4,232,232,33,33,0,1,0
21,260,260,68,56,12,2,1
24,262,262,4,4,0,1,0
26,279,279,6,1,5,2,1
6,287,287,31,20,11,2,1
0,289,289,27,19,8,3,2
14,292,292,42,5,37,2,1
27,307,307,29,7,22,3,2
35,309,309,14,14,0,1,0
20,311,311,26,8,18,3,2
30,315,315,29,29,0,1,0
5,317,317,36,14,22,3,2
23,324,324,22,10,12,4,3
8,375,375,39,39,0,1,0
9,388,388,95,67,28,3,2
25,432,432,17,17,0,1,0
28,436,436,15,6,9,2,1
13,452,452,8,8,0,1,0
37,456,456,19,19,0,1,0
12,457,457,62,62,0,1,0
34,477,477,41,41,0,1,0
16,482,482,27,27,0,1,0
3,495,495,116,68,48,4,3

14,100,100,15,15,0,1,0
28,108,108,2,2,0,1,0
7,113,113,16,16,0,1,0
34,117,117,7,7,0,1,0
19,146,146,2,2,0,1,0
22,150,150,1,1,0,1,0
18,150,150,1,1,0,1,0
13,164,164,1,1,0,1,0
39,165,165,1,1,0,1,0
40,168,168,18,18,0,1,0
30,184,184,37,15,22,3,2
42,199,199,7,7,0,1,0
23,230,230,8,8,0,1,0
4,232,232,5,2,3,2,1
37,237,237,27,27,0,1,0
10,238,238,1,1,0,1,0
15,241,241,7,7,0,1,0
48,244,244,9,9,0,1,0
31,253,253,12,2,10,2,1
6,254,254,21,9,12,4,3
27,266,266,3,3,0,1,0
35,278,278,23,23,0,1,0
0,284,284,21,21,0,1,0
41,289,289,85,85,0,1,0
43,292,292,82,13,69,4,3
12,301,301,25,22,3,2,1
3,304,304,39,8,31,3,2
29,307,307,12,1,11,2,1
47,310,310,13,3,10,2,1
17,321,321,14,14,0,1,0
46,335,335,33,12,21,4,3
21,342,342,12,12,0,1,0
1,348,348,14,4,10,3,2
32,352,352,34,15,19,2,1
45,356,356,36,36,0,1,0
38,356,356,6,6,0,1,0
36,365,365,56,56,0,1,0
26,365,365,28,28,0,1,0
24,374,374,22,12,10,3,2
8,385,385,73,73,0,1,0
44,413,413,64,36,28,2,1
16,437,437,83,11,72,3,2
20,446,446,10,2,8,3,2
11,455,455,33,5,28,3,2
9,466,466,137,90,47,2,1
33,473,473,37,37,0,1,0
2,477,477,11,5,6,2,1
5,481,481,8,8,0,1,0
25,496,496,66,63,3,2,1

26,106,106,3,3,0,1,0
6,121,121,8,3,5,2,1
25,126,126,3,3,0,1,0
34,150,150,3,3,0,1,0
35,152,152,1,1,0,1,0
51,160,160,4,4,0,1,0
13,162,162,2,2,0,1,0
7,171,171,5,5,0,1,0
14,172,172,31,31,0,1,0
1,173,173,2,2,0,1,0
44,173,173,12,12,0,1,0
33,177,177,7,2,5,2,1
37,178,178,100,76,24,4,3
0,181,181,3,3,0,1,0
9,182,182,16,1,15,2,1
21,187,187,11,11,0,1,0
48,200,200,19,19,0,1,0
46,200,200,9,1,8,2,1
16,224,224,1,1,0,1,0
19,227,227,49,49,0,1,0
40,232,232,22,22,0,1,0
43,234,234,22,22,0,1,0
38,245,245,29,26,3,2,1
39,274,274,81,65,16,3,2
22,296,296,3,3,0,1,0
32,322,322,5,5,0,1,0
24,323,323,31,31,0,1,0
11,339,339,1,1,0,1,0
5,340,340,3,3,0,1,0
10,354,354,17,7,10,3,2
41,360,360,3,3,0,1,0
27,362,362,38,38,0,1,0
31,368,368,6,6,0,1,0
45,379,379,17,17,0,1,0
50,385,385,11,11,0,1,0
12,400,400,12,12,0,1,0
17,407,407,35,11,24,3,2
8,420,420,4,4,0,1,0
2,424,424,84,13,71,4,3
30,428,428,29,1,28,3,2
42,447,447,12,2,10,3,2
23,448,448,7,7,0,1,0
15,456,456,2,2,0,1,0
3,467,467,31,11,20,2,1
4,471,471,48,48,0,1,0
18,472,472,17,17,0,1,0
29,475,475,42,4,38,3,2
28,489,489,42,42,0,1,0
20,490,490,93,81,12,3,2
47,490,490,44,44,0,1,0
36,492,492,143,143,0,1,0
49,499,499,37,19,18,3,2

29,112,112,13,13,0,1,0
9,132,132,6,2,4,2,1
21,139,139,17,12,5,2,1
27,139,139,11,11,0,1,0
3,151,151,27,27,0,1,0
0,178,178,5,5,0,1,0
17,182,182,16,4,12,4,3
7,193,193,46,46,0,1,0
15,197,197,27,27,0,1,0
35,244,244,25,3,22,2,1
32,256,256,40,12,28,2,1
8,262,262,15,12,3,2,1
1,293,293,54,36,18,2,1
23,294,294,34,34,0,1,0
13,302,302,3,3,0,1,0
19,315,315,3,3,0,1,0
2,318,318,51,22,29,2,1
11,344,344,33,33,0,1,0
22,350,350,64,10,54,4,3
31,361,361,30,17,13,2,1
30,363,363,75,75,0,1,0
5,376,376,6,2,4,2,1
25,376,376,49,34,15,4,3
6,379,379,102,65,37,2,1
10,383,383,65,39,26,3,2
24,390,390,17,17,0,1,0
36,411,411,13,6,7,2,1
33,413,413,14,2,12,3,2
12,422,422,67,9,58,4,3
16,439,439,60,60,0,1,0
28,447,447,42,42,0,1,0
18,457,457,107,107,0,1,0
34,462,462,29,2,27,2,1
4,474,474,43,31,12,4,3
20,494,494,59,27,32,3,2
26,499,499,12,12,0,1,0
14,500,500,12,7,5,2,1

37,103,103,21,21,0,1,0
34,110,110,5,5,0,1,0
23,122,122,4,1,3,2,1
16,141,141,24,18,6,2,1
29,152,152,30,12,18,2,1
14,162,162,3,3,0,1,0
22,164,164,13,3,10,3,2
9,183,183,1,1,0,1,0
1,191,191,1,1,0,1,0
17,197,197,1,1,0,1,0
41,212,212,60,38,22,3,2
26,217,217,1,1,0,1,0
21,229,229,4,4,0,1,0
6,240,240,52,24,28,3,2
18,240,240,7,2,5,2,1
19,242,242,72,72,0,1,0
40,278,278,49,27,22,2,1
13,289,289,12,6,6,2,1
2,290,290,16,1,15,4,3
3,293,293,6,6,0,1,0
30,302,302,7,7,0,1,0
12,329,329,34,34,0,1,0
42,356,356,4,4,0,1,0
31,357,357,79,79,0,1,0
5,360,360,51,51,0,1,0
28,362,362,10,7,3,2,1
11,373,373,12,12,0,1,0
10,379,379,52,41,11,2,1
15,397,397,46,13,33,4,3
27,415,415,53,26,27,2,1
36,416,416,4,4,0,1,0
39,426,426,54,54,0,1,0
24,431,431,53,26,27,2,1
7,435,435,26,20,6,3,2
38,461,461,8,8,0,1,0
32,466,466,35,35,0,1,0
20,466,466,20,9,11,2,1
33,468,468,2,2,0,1,0
25,468,468,134,101,33,4,3
4,484,484,87,54,33,4,3
35,488,488,24,2,22,3,2
8,490,490,1,1,0,1,0
0,493,493,112,112,0,1,0

34,102,102,2,2,0,1,0
7,125,125,6,6,0,1,0
35,129,129,3,3,0,1,0
42,153,153,24,1,23,2,1
26,161,161,65,9,56,3,2
17,164,164,11,11,0,1,0
38,174,174,6,6,0,1,0
32,175,175,30,4,26,2,1
33,190,190,17,17,0,1,0
29,199,199,1,1,0,1,0
5,201,201,9,1,8,3,2
43,202,202,3,3,0,1,0
0,211,211,2,2,0,1,0
19,217,217,33,4,29,2,1
1,218,218,71,71,0,1,0
2,218,218,21,5,16,3,2
36,224,224,7,1,6,3,2
6,226,226,6,6,0,1,0
18,246,246,11,11,0,1,0
40,276,276,43,9,34,4,3
25,277,277,30,30,0,1,0
14,278,278,12,12,0,1,0
13,295,295,25,25,0,1,0
11,297,297,4,4,0,1,0
27,300,300,10,10,0,1,0
3,313,313,65,65,0,1,0
41,317,317,80,44,36,3,2
9,335,335,15,15,0,1,0
23,341,341,16,7,9,4,3
12,345,345,8,2,6,3,2
8,355,355,36,36,0,1,0
20,359,359,111,111,0,1,0
24,367,367,14,14,0,1,0
30,372,372,56,17,39,3,2
37,373,373,92,41,51,4,3
22,398,398,4,4,0,1,0
21,399,399,28,22,6,3,2
15,404,404,11,5,6,2,1
39,418,418,7,4,3,2,1
28,434,434,7,7,0,1,0
4,439,439,3,3,0,1,0
10,448,448,13,10,3,2,1
16,452,452,77,21,56,4,3
31,480,480,38,31,7,2,1

31,109,109,1,1,0,1,0
19,117,117,2,2,0,1,0
25,131,131,10,1,9,4,3
34,147,147,60,60,0,1,0
13,153,153,9,9,0,1,0
15,162,162,12,4,8,2,1
14,189,189,1,1,0,1,0
21,193,193,16,16,0,1,0
8,210,210,8,8,0,1,0
1,236,236,18,18,0,1,0
4,239,239,52,52,0,1,0
33,247,247,14,11,3,2,1
35,251,251,35,35,0,1,0
26,253,253,24,6,18,3,2
7,257,257,22,22,0,1,0
17,276,276,33,24,9,2,1
32,281,281,48,48,0,1,0
3,292,292,7,1,6,3,2
24,324,324,44,2,42,4,3
5,329,329,72,8,64,3,2
9,350,350,16,16,0,1,0
30,351,351,32,6,26,3,2
0,354,354,28,2,26,3,2
23,373,373,12,12,0,1,0
10,375,375,76,25,51,4,3
6,381,381,52,8,44,2,1
27,383,383,69,69,0,1,0
28,403,403,68,18,50,3,2
2,406,406,68,68,0,1,0
20,420,420,51,51,0,1,0
29,437,437,10,10,0,1,0
12,449,449,30,15,15,4,3
16,467,467,13,6,7,2,1
11,481,481,244,184,60,4,3
18,483,483,9,2,7,2,1
22,486,486,28,10,18,4,3

17,103,103,3,3,0,1,0
10,103,103,1,1,0,1,0
8,107,107,18,11,7,2,1
18,126,126,7,7,0,1,0
49,131,131,35,35,0,1,0
39,147,147,2,2,0,1,0
42,158,158,35,3,32,3,2
43,176,176,11,11,0,1,0
0,186,186,1,1,0,1,0
48,192,192,30,16,14,3,2
34,196,196,44,4,40,4,3
9,207,207,10,10,0,1,0
19,212,212,9,2,7,2,1
44,255,255,20,20,0,1,0
35,271,271,3,3,0,1,0
33,273,273,34,6,28,2,1
20,280,280,9,3,6,3,2
36,286,286,11,1,10,2,1
32,288,288,12,12,0,1,0
3,298,298,13,13,0,1,0
7,299,299,14,6,8,2,1
40,302,302,57,3,54,3,2
38,315,315,81,81,0,1,0
1,317,317,6,6,0,1,0
31,334,334,23,16,7,2,1
27,335,335,1,1,0,1,0
28,341,341,3,3,0,1,0
46,354,354,9,9,0,1,0
21,359,359,28,28,0,1,0
30,366,366,3,3,0,1,0
23,374,374,12,7,5,2,1
12,385,385,8,8,0,1,0
47,388,388,4,4,0,1,0
11,390,390,35,35,0,1,0
29,407,407,1,1,0,1,0
26,414,414,15,15,0,1,0
41,417,417,13,13,0,1,0
5,418,418,77,77,0,1,0
37,419,419,32,32,0,1,0
45,424,424,59,37,22,2,1
16,433,433,38,27,11,2,1
13,446,446,17,5,12,4,3
22,450,450,1,1,0,1,0
24,454,454,1,1,0,1,0
6,463,463,121,121,0,1,0
14,465,465,112,112,0,1,0
2,467,467,6,6,0,1,0
4,468,468,90,27,63,4,3
15,473,473,5,2,3,2,1
25,485,485,96,96,0,1,0

1,136,136,67,17,50,2,1
27,142,142,13,2,11,2,1
26,149,149,4,1,3,2,1
19,152,152,5,5,0,1,0
18,179,179,41,17,24,4,3
17,180,180,7,1,6,2,1
2,182,182,1,1,0,1,0
8,191,191,2,2,0,1,0
16,196,196,1,1,0,1,0
3,211,211,8,8,0,1,0
14,232,232,5,5,0,1,0
11,299,299,18,18,0,1,0
32,303,303,13,5,8,3,2
23,311,311,13,13,0,1,0
28,312,312,23,13,10,2,1
9,316,316,18,1,17,2,1
30,322,322,57,57,0,1,0
31,334,334,4,4,0,1,0
5,378,378,15,15,0,1,0
33,383,383,22,22,0,1,0
13,387,387,129,129,0,1,0
0,392,392,79,10,69,4,3
37,401,401,11,11,0,1,0
36,401,401,57,57,0,1,0
24,408,408,165,165,0,1,0
15,426,426,110,110,0,1,0
7,428,428,12,12,0,1,0
21,429,429,3,3,0,1,0
29,434,434,87,87,0,1,0
6,439,439,11,11,0,1,0
12,440,440,30,30,0,1,0
20,443,443,52,52,0,1,0
10,468,468,11,2,9,4,3
35,470,470,83,80,3,2,1
39,472,472,65,65,0,1,0
34,479,479,7,7,0,1,0
38,484,484,90,90,0,1,0
22,489,489,19,19,0,1,0
25,496,496,25,1,24,2,1
4,496,496,17,1,16,4,3

37,115,115,1,1,0,1,0
33,118,118,9,3,6,2,1
26,134,134,16,13,3,2,1
15,139,139,2,2,0,1,0
6,143,143,8,8,0,1,0
9,164,164,31,18,13,2,1
10,171,171,9,3,6,2,1
19,181,181,7,7,0,1,0
27,189,189,6,6,0,1,0
14,195,195,19,19,0,1,0
34,198,198,16,16,0,1,0
28,218,218,15,15,0,1,0
4,233,233,30,30,0,1,0
18,238,238,1,1,0,1,0
36,261,261,12,12,0,1,0
23,263,263,4,4,0,1,0
12,268,268,44,22,22,3,2
2,269,269,35,23,12,3,2
16,277,277,7,7,0,1,0
20,279,279,65,33,32,3,2
5,279,279,22,16,6,3,2
30,290,290,41,31,10,2,1
35,291,291,39,39,0,1,0
25,322,322,175,73,102,4,3
22,330,330,28,12,16,3,2
0,342,342,23,23,0,1,0
3,344,344,38,38,0,1,0
32,361,361,72,72,0,1,0
40,367,367,18,9,9,2,1
8,401,401,115,76,39,4,3
21,444,444,11,1,10,2,1
38,452,452,26,8,18,3,2
24,463,463,77,27,50,2,1
17,466,466,39,20,19,3,2
11,467,467,29,29,0,1,0
29,473,473,37,26,11,2,1
13,475,475,13,13,0,1,0
31,479,479,48,5,43,2,1
39,483,483,8,8,0,1,0
7,490,490,25,25,0,1,0
1,498,498,51,13,38,4,3

2,101,101,13,13,0,1,0
41,105,105,23,23,0,1,0
36,105,105,3,3,0,1,0
38,109,109,7,1,6,3,2
1,113,113,4,4,0,1,0
6,116,116,3,3,0,1,0
28,122,122,7,7,0,1,0
43,128,128,10,1,9,4,3
22,141,141,3,3,0,1,0
31,141,141,17,17,0,1,0
21,147,147,6,3,3,2,1
30,152,152,15,3,12,3,2
12,159,159,15,9,6,3,2
5,159,159,47,27,20,2,1
9,169,169,22,6,16,3,2
46,172,172,6,3,3,2,1
14,184,184,14,8,6,3,2
13,189,189,63,63,0,1,0
10,210,210,31,31,0,1,0
23,212,212,5,5,0,1,0
27,214,214,2,2,0,1,0
40,235,235,30,30,0,1,0
8,243,243,9,3,6,2,1
44,253,253,21,9,12,2,1
19,259,259,1,1,0,1,0
35,265,265,2,2,0,1,0
39,272,272,110,32,78,4,3
34,282,282,80,80,0,1,0
17,303,303,3,3,0,1,0
33,330,330,63,19,44,4,3
3,348,348,23,14,9,2,1
15,352,352,24,24,0,1,0
37,354,354,35,30,5,2,1
20,355,355,54,36,18,4,3
32,357,357,38,38,0,1,0
11,359,359,12,12,0,1,0
24,370,370,1,1,0,1,0
0,400,400,1,1,0,1,0
29,423,423,2,2,0,1,0
25,425,425,28,28,0,1,0
4,428,428,13,13,0,1,0
16,435,435,55,55,0,1,0
18,462,462,11,2,9,2,1
7,475,475,8,8,0,1,0
42,476,476,13,13,0,1,0
26,477,477,4,4,0,1,0
45,492,492,1,1,0,1,0

5,100,100,1,1,0,1,0
7,111,111,2,2,0,1,0
32,115,115,10,10,0,1,0
25,138,138,10,10,0,1,0
14,141,141,1,1,0,1,0
0,144,144,20,20,0,1,0
20,144,144,19,6,13,2,1
24,149,149,27,27,0,1,0
3,150,150,9,9,0,1,0
9,157,157,5,5,0,1,0
27,171,171,16,11,5,2,1
17,206,206,4,4,0,1,0
11,208,208,16,16,0,1,0
45,214,214,6,3,3,2,1
42,217,217,20,8,12,2,1
43,217,217,75,12,63,4,3
4,218,218,4,4,0,1,0
19,220,220,3,3,0,1,0
29,242,242,7,7,0,1,0
10,242,242,31,7,24,3,2
44,250,250,17,9,8,2,1
2,251,251,41,8,33,2,1
12,262,262,40,40,0,1,0
13,288,288,13,13,0,1,0
36,298,298,48,48,0,1,0
40,299,299,4,4,0,1,0
47,303,303,56,16,40,3,2
6,311,311,1,1,0,1,0
1,312,312,12,12,0,1,0
15,322,322,20,5,15,2,1
41,324,324,24,2,22,2,1
21,358,358,37,1,36,3,2
48,359,359,55,33,22,3,2
35,389,389,3,3,0,1,0
34,390,390,10,4,6,2,1
39,412,412,8,4,4,2,1
38,413,413,8,8,0,1,0
8,415,415,44,44,0,1,0
16,418,418,20,20,0,1,0
23,434,434,4,1,3,2,1
33,441,441,67,49,18,4,3
22,443,443,42,28,14,2,1
37,451,451,107,19,88,3,2
30,455,455,86,86,0,1,0
26,455,455,50,34,16,2,1
46,455,455,69,43,26,2,1
18,473,473,17,17,0,1,0
31,474,474,1,1,0,1,0
28,484,484,13,8,5,2,1

27,117,117,7,7,0,1,0
16,123,123,1,1,0,1,0
18,137,137,32,8,24,4,3
22,166,166,78,24,54,3,2
9,176,176,13,10,3,2,1
12,191,191,6,6,0,1,0
24,196,196,13,13,0,1,0
33,197,197,28,23,5,2,1
23,199,199,30,30,0,1,0
0,211,211,49,9,40,3,2
19,223,223,7,7,0,1,0
13,230,230,1,1,0,1,0
38,238,238,20,4,16,3,2
1,253,253,74,62,12,3,2
11,257,257,21,21,0,1,0
5,267,267,15,3,12,3,2
3,273,273,7,7,0,1,0
35,287,287,17,8,9,4,3
14,298,298,2,2,0,1,0
28,305,305,18,18,0,1,0
25,311,311,53,12,41,2,1
30,320,320,23,14,9,2,1
21,321,321,3,3,0,1,0
10,328,328,6,6,0,1,0
37,331,331,13,13,0,1,0
6,349,349,34,34,0,1,0
17,357,357,141,87,54,3,2
8,371,371,67,61,6,2,1
34,374,374,69,69,0,1,0
29,376,376,4,4,0,1,0
15,395,395,89,89,0,1,0
26,400,400,23,23,0,1,0
20,400,400,22,22,0,1,0
31,406,406,4,4,0,1,0
36,442,442,33,33,0,1,0
7,446,446,1,1,0,1,0
32,455,455,112,43,69,4,3
2,476,476,1,1,0,1,0
4,499,499,17,17,0,1,0

7,103,103,5,5,0,1,0
22,104,104,9,3,6,2,1
21,127,127,12,2,10,3,2
33,128,128,10,4,6,2,1
20,160,160,44,8,36,2,1
28,174,174,9,9,0,1,0
24,198,198,4,4,0,1,0
19,203,203,19,19,0,1,0
0,215,215,6,6,0,1,0
3,228,228,17,17,0,1,0
30,237,237,38,38,0,1,0
6,237,237,38,38,0,1,0
4,238,238,47,20,27,4,3
31,260,260,14,14,0,1,0
18,265,265,11,11,0,1,0
13,277,277,21,8,13,2,1
17,278,278,58,58,0,1,0
12,283,283,4,4,0,1,0
14,289,289,43,13,30,4,3
27,310,310,3,3,0,1,0
15,319,319,49,34,15,4,3
9,346,346,109,109,0,1,0
29,391,391,16,16,0,1,0
10,392,392,19,9,10,3,2
26,411,411,115,20,95,4,3
5,422,422,14,14,0,1,0
23,425,425,8,8,0,1,0
32,426,426,78,34,44,4,3
8,452,452,60,12,48,4,3
11,455,455,90,6,84,4,3
34,456,456,46,14,32,3,2
2,469,469,203,203,0,1,0
1,472,472,44,20,24,4,3
25,477,477,19,19,0,1,0
16,495,495,31,31,0,1,0

28,104,104,4,4,0,1,0
25,144,144,48,8,40,3,2
40,167,167,17,17,0,1,0
26,168,168,3,3,0,1,0
42,171,171,3,3,0,1,0
1,180,180,35,35,0,1,0
19,197,197,1,1,0,1,0
10,198,198,6,6,0,1,0
2,203,203,1,1,0,1,0
15,205,205,3,3,0,1,0
8,212,212,1,1,0,1,0
35,212,212,30,16,14,2,1
22,213,213,5,5,0,1,0
16,224,224,25,7,18,4,3
34,230,230,49,41,8,2,1
24,238,238,23,23,0,1,0
4,241,241,64,64,0,1,0
3,246,246,23,23,0,1,0
12,247,247,6,6,0,1,0
20,249,249,33,24,9,4,3
30,249,249,4,4,0,1,0
33,272,272,27,27,0,1,0
44,282,282,20,20,0,1,0
5,299,299,13,13,0,1,0
37,300,300,53,53,0,1,0
21,302,302,81,19,62,4,3
0,302,302,11,11,0,1,0
29,311,311,9,3,6,2,1
39,317,317,23,23,0,1,0
38,317,317,29,29,0,1,0
27,318,318,21,21,0,1,0
23,321,321,35,35,0,1,0
18,328,328,55,43,12,3,2
31,332,332,54,54,0,1,0
13,345,345,4,4,0,1,0
6,351,351,38,2,36,2,1
14,368,368,46,46,0,1,0
9,372,372,1,1,0,1,0
36,376,376,125,125,0,1,0
41,379,379,15,4,11,3,2
17,416,416,2,2,0,1,0
43,437,437,7,1,6,3,2
11,463,463,55,19,36,2,1
7,467,467,3,3,0,1,0
32,475,475,2,2,0,1,0

5,103,103,2,2,0,1,0
41,106,106,14,5,9,4,3
0,109,109,10,2,8,2,1
6,113,113,2,2,0,1,0
4,116,116,11,11,0,1,0
46,125,125,18,8,10,2,1
30,129,129,31,31,0,1,0
42,131,131,17,3,14,3,2
7,161,161,6,6,0,1,0
9,176,176,18,2,16,2,1
16,177,177,2,2,0,1,0
26,178,178,14,2,12,4,3
8,179,179,7,7,0,1,0
20,191,191,7,7,0,1,0
31,198,198,11,11,0,1,0
2,219,219,9,4,5,2,1
37,232,232,3,3,0,1,0
10,233,233,9,4,5,2,1
21,238,238,9,9,0,1,0
1,238,238,59,59,0,1,0
34,240,240,63,63,0,1,0
18,242,242,28,28,0,1,0
17,250,250,22,1,21,2,1
40,262,262,2,2,0,1,0
38,264,264,26,4,22,3,2
25,266,266,2,2,0,1,0
14,270,270,1,1,0,1,0
12,271,271,3,3,0,1,0
3,276,276,17,17,0,1,0
19,307,307,4,4,0,1,0
35,309,309,24,7,17,2,1
13,324,324,6,6,0,1,0
28,354,354,4,4,0,1,0
45,371,371,59,10,49,2,1
36,385,385,18,8,10,2,1
27,388,388,23,23,0,1,0
43,393,393,8,8,0,1,0
15,408,408,107,79,28,3,2
11,419,419,102,88,14,2,1
29,421,421,29,29,0,1,0
24,424,424,64,37,27,4,3
32,461,461,12,9,3,2,1
44,486,486,23,5,18,2,1
39,489,489,27,17,10,2,1
33,494,494,192,113,79,4,3
22,494,494,43,43,0,1,0
23,500,500,22,15,7,2,1

0,103,103,1,1,0,1,0
27,108,108,7,7,0,1,0
33,111,111,3,3,0,1,0
5,114,114,1,1,0,1,0
3,128,128,26,26,0,1,0
17,133,133,14,14,0,1,0
6,137,137,10,10,0,1,0
30,144,144,2,2,0,1,0
9,148,148,1,1,0,1,0
34,157,157,8,8,0,1,0
11,161,161,17,4,13,4,3
46,162,162,40,40,0,1,0
41,175,175,15,8,7,2,1
44,193,193,7,7,0,1,0
45,195,195,5,5,0,1,0
47,213,213,5,1,4,2,1
32,222,222,26,8,18,2,1
31,224,224,90,2,88,3,2
37,229,229,36,36,0,1,0
7,239,239,18,9,9,2,1
19,241,241,7,7,0,1,0
29,243,243,57,57,0,1,0
23,244,244,28,5,23,2,1
38,250,250,29,3,26,2,1
16,264,264,18,11,7,2,1
49,266,266,44,44,0,1,0
14,270,270,4,4,0,1,0
8,271,271,10,10,0,1,0
4,273,273,26,11,15,4,3
15,274,274,7,2,5,2,1
24,280,280,9,9,0,1,0
42,284,284,49,37,12,2,1
1,294,294,8,1,7,2,1
40,305,305,18,18,0,1,0
18,313,313,4,4,0,1,0
26,315,315,1,1,0,1,0
39,317,317,16,13,3,2,1
2,320,320,10,10,0,1,0
20,328,328,10,10,0,1,0
43,332,332,7,7,0,1,0
21,337,337,34,12,22,2,1
28,346,346,35,35,0,1,0
12,389,389,61,46,15,2,1
36,397,397,86,59,27,2,1
22,427,427,6,6,0,1,0
10,446,446,19,19,0,1,0
35,449,449,8,8,0,1,0
25,490,490,45,45,0,1,0
13,491,491,43,43,0,1,0
48,495,495,15,15,0,1,0

11,100,100,9,9,0,1,0
21,111,111,6,6,0,1,0
32,128,128,5,5,0,1,0
39,149,149,4,4,0,1,0
2,152,152,6,1,5,2,1
37,152,152,2,2,0,1,0
24,161,161,23,8,15,4,3
41,162,162,9,9,0,1,0
17,190,190,1,1,0,1,0
26,202,202,39,39,0,1,0
27,206,206,88,47,41,2,1
40,207,207,13,3,10,2,1
7,213,213,1,1,0,1,0
22,219,219,18,5,13,2,1
28,232,232,14,5,9,4,3
20,243,243,26,14,12,3,2
29,254,254,13,13,0,1,0
18,257,257,6,6,0,1,0
25,267,267,14,3,11,2,1
30,284,284,25,7,18,4,3
36,287,287,3,3,0,1,0
9,296,296,47,11,36,3,2
31,304,304,18,3,15,4,3
8,306,306,68,68,0,1,0
16,307,307,1,1,0,1,0
13,315,315,67,11,56,3,2
12,319,319,22,8,14,3,2
4,324,324,23,13,10,2,1
5,327,327,55,34,21,2,1
10,330,330,37,37,0,1,0
0,346,346,12,5,7,2,1
23,350,350,3,3,0,1,0
33,357,357,112,103,9,4,3
38,366,366,28,28,0,1,0
15,372,372,41,41,0,1,0
19,373,373,15,15,0,1,0
34,406,406,80,45,35,2,1
1,418,418,131,131,0,1,0
35,422,422,33,33,0,1,0
3,434,434,52,52,0,1,0
6,468,468,3,3,0,1,0
14,489,489,18,18,0,1,0

2,112,112,13,13,0,1,0
24,116,116,19,15,4,2,1
7,124,124,1,1,0,1,0
32,132,132,14,14,0,1,0
28,133,133,18,11,7,2,1
25,142,142,6,6,0,1,0
1,149,149,25,25,0,1,0
44,156,156,2,2,0,1,0
0,170,170,27,20,7,2,1
12,173,173,46,46,0,1,0
29,190,190,12,3,9,4,3
46,195,195,50,9,41,2,1
17,204,204,10,10,0,1,0
20,211,211,2,2,0,1,0
50,212,212,19,4,15,4,3
30,220,220,3,3,0,1,0
36,223,223,27,27,0,1,0
31,225,225,1,1,0,1,0
47,231,231,30,30,0,1,0
8,236,236,8,8,0,1,0
45,242,242,19,19,0,1,0
33,250,250,46,28,18,4,3
15,263,263,30,30,0,1,0
35,270,270,79,79,0,1,0
6,291,291,11,5,6,2,1
37,308,308,37,1,36,4,3
3,312,312,6,6,0,1,0
27,325,325,4,4,0,1,0
4,340,340,5,5,0,1,0
22,342,342,11,11,0,1,0
16,345,345,11,11,0,1,0
40,356,356,22,22,0,1,0
34,364,364,7,7,0,1,0
23,365,365,10,2,8,3,2
13,368,368,11,1,10,2,1
18,370,370,31,31,0,1,0
10,379,379,17,7,10,3,2
48,383,383,56,56,0,1,0
21,417,417,46,3,43,2,1
14,420,420,24,24,0,1,0
9,435,435,14,14,0,1,0
41,439,439,45,4,41,4,3
38,441,441,14,8,6,3,2
43,441,441,62,62,0,1,0
26,448,448,8,8,0,1,0
5,449,449,26,17,9,4,3
39,455,455,22,22,0,1,0
49,455,455,27,9,18,2,1
11,465,465,1,1,0,1,0
19,483,483,23,23,0,1,0
42,489,489,13,13,0,1,0

30,138,138,27,4,23,2,1
11,141,141,9,1,8,2,1
4,148,148,33,2,31,3,2
21,162,162,6,3,3,2,1
9,171,171,17,7,10,2,1
12,186,186,27,27,0,1,0
15,215,215,5,1,4,2,1
32,215,215,65,65,0,1,0
14,229,229,9,3,6,3,2
22,261,261,18,5,13,4,3
25,281,281,12,9,3,2,1
19,283,283,2,2,0,1,0
28,297,297,26,8,18,2,1
13,297,297,1,1,0,1,0
8,302,302,79,79,0,1,0
10,307,307,16,16,0,1,0
1,314,314,32,12,20,4,3
35,353,353,7,7,0,1,0
26,353,353,35,35,0,1,0
7,354,354,27,27,0,1,0
34,366,366,78,51,27,4,3
3,370,370,6,2,4,2,1
17,386,386,62,22,40,2,1
24,394,394,27,22,5,2,1
27,398,398,9,9,0,1,0
29,422,422,33,15,18,3,2
31,431,431,54,54,0,1,0
6,435,435,192,171,21,2,1
20,436,436,46,46,0,1,0
33,440,440,43,43,0,1,0
5,445,445,103,103,0,1,0
23,449,449,10,10,0,1,0
2,456,456,8,8,0,1,0
0,459,459,94,94,0,1,0
18,461,461,129,60,69,4,3
16,467,467,2,2,0,1,0

36,106,106,14,14,0,1,0
10,141,141,10,10,0,1,0
7,172,172,1,1,0,1,0
28,175,175,1,1,0,1,0
34,184,184,61,15,46,3,2
14,185,185,32,18,14,2,1
23,196,196,7,7,0,1,0
24,228,228,2,2,0,1,0
32,246,246,126,84,42,2,1
26,250,250,4,4,0,1,0
18,253,253,22,6,16,3,2
5,265,265,9,3,6,2,1
25,273,273,7,4,3,2,1
22,286,286,30,7,23,2,1
1,293,293,14,14,0,1,0
17,298,298,34,34,0,1,0
35,309,309,10,3,7,2,1
13,337,337,141,141,0,1,0
30,341,341,23,23,0,1,0
4,355,355,88,34,54,4,3
27,371,371,38,34,4,2,1
2,376,376,130,130,0,1,0
11,398,398,89,89,0,1,0
19,415,415,13,13,0,1,0
20,421,421,48,28,20,2,1
6,424,424,21,21,0,1,0
21,431,431,3,3,0,1,0
29,435,435,49,4,45,2,1
0,441,441,31,31,0,1,0
31,446,446,74,14,60,4,3
33,446,446,11,6,5,2,1
12,467,467,69,45,24,3,2
15,483,483,13,13,0,1,0
16,486,486,28,28,0,1,0
3,486,486,4,4,0,1,0
9,490,490,25,25,0,1,0
8,498,498,11,11,0,1,0

30,106,106,11,6,5,2,1
10,117,117,1,1,0,1,0
23,117,117,15,5,10,2,1
35,124,124,8,8,0,1,0
29,132,132,3,3,0,1,0
16,133,133,3,3,0,1,0
22,148,148,21,3,18,4,3
36,151,151,1,1,0,1,0
38,157,157,5,5,0,1,0
21,157,157,6,2,4,2,1
1,158,158,10,1,9,2,1
7,172,172,12,6,6,3,2
11,185,185,36,11,25,2,1
24,206,206,16,3,13,2,1
32,207,207,21,21,0,1,0
34,218,218,12,6,6,2,1
26,220,220,36,9,27,4,3
37,223,223,41,17,24,3,2
25,235,235,14,5,9,4,3
12,248,248,1,1,0,1,0
33,265,265,24,17,7,2,1
20,285,285,123,49,74,3,2
0,301,301,93,93,0,1,0
5,307,307,6,6,0,1,0
8,315,315,42,33,9,2,1
28,320,320,17,9,8,3,2
31,334,334,52,14,38,2,1
13,351,351,67,25,42,4,3
19,357,357,43,15,28,2,1
9,376,376,1,1,0,1,0
6,379,379,42,15,27,2,1
2,399,399,11,11,0,1,0
15,401,401,2,2,0,1,0
17,422,422,24,18,6,3,2
27,453,453,14,14,0,1,0
3,470,470,248,236,12,4,3
14,486,486,55,55,0,1,0
18,492,492,3,3,0,1,0
4,494,494,67,67,0,1,0

7,113,113,24,24,0,1,0
9,117,117,4,4,0,1,0
18,124,124,14,6,8,3,2
6,125,125,7,7,0,1,0
14,125,125,3,3,0,1,0
16,144,144,15,1,14,3,2
4,147,147,4,4,0,1,0
39,150,150,22,22,0,1,0
20,153,153,56,21,35,2,1
40,164,164,31,13,18,2,1
23,164,164,1,1,0,1,0
5,172,172,15,15,0,1,0
33,176,176,5,5,0,1,0
27,180,180,21,21,0,1,0
25,188,188,21,21,0,1,0
41,190,190,9,9,0,1,0
36,192,192,26,8,18,4,3
22,192,192,2,2,0,1,0
29,193,193,17,17,0,1,0
38,201,201,8,8,0,1,0
15,215,215,43,43,0,1,0
32,218,218,1,1,0,1,0
13,224,224,3,3,0,1,0
12,234,234,7,2,5,2,1
34,242,242,6,2,4,2,1
2,253,253,18,18,0,1,0
10,254,254,11,7,4,2,1
21,262,262,34,34,0,1,0
8,274,274,31,31,0,1,0
31,279,279,37,37,0,1,0
30,282,282,28,4,24,4,3
24,300,300,19,19,0,1,0
35,314,314,144,135,9,2,1
19,344,344,19,19,0,1,0
3,372,372,4,4,0,1,0
37,392,392,42,42,0,1,0
17,411,411,20,20,0,1,0
26,418,418,2,2,0,1,0
0,434,434,88,88,0,1,0
28,441,441,104,59,45,2,1
11,453,453,11,11,0,1,0
1,489,489,17,17,0,1,0

23,139,139,11,11,0,1,0
24,147,147,28,28,0,1,0
17,154,154,9,9,0,1,0
4,181,181,16,16,0,1,0
0,183,183,26,26,0,1,0
7,185,185,48,31,17,2,1
19,236,236,56,56,0,1,0
2,248,248,93,93,0,1,0
14,253,253,34,24,10,4,3
22,259,259,28,15,13,2,1
13,262,262,36,36,0,1,0
6,271,271,22,22,0,1,0
5,274,274,69,69,0,1,0
20,283,283,68,10,58,4,3
10,305,305,11,8,3,2,1
27,310,310,2,2,0,1,0
25,342,342,9,3,6,2,1
18,348,348,17,17,0,1,0
1,357,357,99,63,36,2,1
9,374,374,46,5,41,4,3
16,415,415,5,5,0,1,0
15,416,416,45,13,32,2,1
12,418,418,7,7,0,1,0
29,434,434,129,129,0,1,0
21,444,444,22,22,0,1,0
26,480,480,18,18,0,1,0
28,488,488,17,3,14,3,2
30,493,493,77,45,32,3,2
3,496,496,170,115,55,3,2
8,498,498,13,13,0,1,0
11,499,499,31,31,0,1,0

18,118,118,2,2,0,1,0
16,143,143,27,5,22,3,2
32,154,154,13,13,0,1,0
26,171,171,28,12,16,2,1
11,172,172,3,3,0,1,0
27,182,182,7,1,6,3,2
21,189,189,23,23,0,1,0
24,203,203,11,11,0,1,0
36,217,217,66,15,51,4,3
23,217,217,9,2,7,2,1
1,218,218,18,18,0,1,0
14,227,227,30,8,22,3,2
4,234,234,13,13,0,1,0
28,237,237,3,3,0,1,0
22,246,246,8,5,3,2,1
7,247,247,41,41,0,1,0
17,255,255,8,8,0,1,0
35,282,282,31,17,14,3,2
12,287,287,98,98,0,1,0
8,301,301,1,1,0,1,0
25,304,304,2,2,0,1,0
31,305,305,37,17,20,4,3
3,315,315,58,58,0,1,0
29,326,326,49,1,48,3,2
13,335,335,44,2,42,4,3
2,336,336,35,1,34,3,2
5,340,340,23,23,0,1,0
34,350,350,28,28,0,1,0
0,360,360,50,50,0,1,0
15,361,361,45,45,0,1,0
9,371,371,23,14,9,4,3
33,385,385,5,5,0,1,0
19,426,426,86,86,0,1,0
6,429,429,67,67,0,1,0
10,436,436,21,21,0,1,0
30,455,455,47,27,20,3,2
20,462,462,162,153,9,2,1

19,126,126,7,7,0,1,0
27,126,126,1,1,0,1,0
2,145,145,48,1,47,2,1
14,145,145,13,7,6,3,2
28,156,156,20,2,18,2,1
15,162,162,28,19,9,4,3
3,185,185,36,36,0,1,0
26,187,187,32,32,0,1,0
13,206,206,53,53,0,1,0
6,211,211,19,10,9,4,3
24,235,235,75,75,0,1,0
5,241,241,1,1,0,1,0
25,246,246,16,5,11,2,1
23,260,260,63,63,0,1,0
7,267,267,10,1,9,4,3
16,274,274,23,16,7,2,1
30,279,279,9,1,8,3,2
31,297,297,6,3,3,2,1
8,309,309,19,7,12,2,1
17,314,314,49,12,37,3,2
4,324,324,139,8,131,4,3
12,366,366,33,33,0,1,0
20,371,371,2,2,0,1,0
18,395,395,19,1,18,4,3
11,397,397,36,36,0,1,0
22,399,399,1,1,0,1,0
9,416,416,95,95,0,1,0
29,427,427,11,4,7,2,1
32,435,435,64,64,0,1,0
10,454,454,103,5,98,4,3
21,480,480,11,11,0,1,0
0,487,487,20,20,0,1,0
1,496,496,88,88,0,1,0

41,105,105,17,17,0,1,0
5,106,106,3,3,0,1,0
27,114,114,6,6,0,1,0
38,114,114,19,13,6,2,1
12,119,119,34,8,26,3,2
4,129,129,12,12,0,1,0
40,138,138,4,4,0,1,0
7,157,157,13,2,11,2,1
19,175,175,15,15,0,1,0
36,179,179,2,2,0,1,0
22,187,187,76,43,33,4,3
39,205,205,47,4,43,2,1
31,213,213,1,1,0,1,0
20,217,217,9,9,0,1,0
9,218,218,46,34,12,4,3
37,229,229,35,35,0,1,0
21,232,232,37,3,34,3,2
35,234,234,21,21,0,1,0
17,249,249,30,12,18,3,2
8,273,273,1,1,0,1,0
10,290,290,13,8,5,2,1
25,299,299,24,12,12,4,3
0,326,326,7,7,0,1,0
23,334,334,3,3,0,1,0
11,342,342,54,54,0,1,0
34,364,364,4,4,0,1,0
29,369,369,40,33,7,2,1
3,384,384,37,34,3,2,1
18,393,393,31,25,6,3,2
16,400,400,1,1,0,1,0
6,419,419,45,45,0,1,0
1,421,421,8,5,3,2,1
28,421,421,140,140,0,1,0
13,422,422,10,10,0,1,0
15,427,427,3,3,0,1,0
30,428,428,15,4,11,2,1
14,436,436,144,144,0,1,0
33,474,474,4,4,0,1,0
24,478,478,15,15,0,1,0
2,480,480,1,1,0,1,0
26,491,491,48,48,0,1,0
32,494,494,15,7,8,2,1

21,102,102,2,2,0,1,0
16,109,109,15,15,0,1,0
32,115,115,15,15,0,1,0
31,130,130,50,14,36,4,3
43,144,144,12,12,0,1,0
8,153,153,2,2,0,1,0
10,159,159,1,1,0,1,0
20,177,177,12,8,4,2,1
14,188,188,21,21,0,1,0
24,189,189,31,6,25,3,2
40,195,195,8,2,6,3,2
22,217,217,5,5,0,1,0
9,234,234,1,1,0,1,0
41,245,245,28,28,0,1,0
0,247,247,13,4,9,2,1
44,256,256,7,2,5,2,1
18,257,257,7,1,6,2,1
37,257,257,4,4,0,1,0
28,283,283,21,21,0,1,0
19,289,289,3,3,0,1,0
35,291,291,27,27,0,1,0
7,294,294,20,4,16,3,2
1,303,303,119,5,114,4,3
39,303,303,56,14,42,2,1
34,305,305,20,20,0,1,0
27,307,307,53,3,50,2,1
23,308,308,11,5,6,3,2
4,311,311,8,5,3,2,1
26,315,315,14,14,0,1,0
3,318,318,43,9,34,3,2
12,334,334,30,30,0,1,0
30,344,344,33,30,3,2,1
13,345,345,36,36,0,1,0
38,356,356,32,32,0,1,0
5,367,367,104,22,82,3,2
25,371,371,17,9,8,2,1
2,378,378,48,28,20,2,1
17,418,418,27,27,0,1,0
29,419,419,50,31,19,2,1
33,420,420,10,10,0,1,0
36,430,430,29,5,24,3,2
15,435,435,13,3,10,3,2
11,462,462,2,2,0,1,0
42,468,468,79,43,36,2,1
6,496,496,1,1,0,1,0

15,117,117,7,7,0,1,0
27,120,120,24,19,5,2,1
7,126,126,2,2,0,1,0
23,129,129,4,4,0,1,0
14,157,157,1,1,0,1,0
25,159,159,3,3,0,1,0
1,160,160,10,10,0,1,0
39,163,163,6,6,0,1,0
31,172,172,1,1,0,1,0
24,174,174,27,12,15,2,1
10,175,175,37,19,18,2,1
9,188,188,35,35,0,1,0
28,191,191,4,4,0,1,0
12,199,199,13,13,0,1,0
3,203,203,1,1,0,1,0
26,212,212,2,2,0,1,0
40,221,221,10,10,0,1,0
19,262,262,8,8,0,1,0
2,265,265,2,2,0,1,0
42,267,267,55,27,28,2,1
6,282,282,5,2,3,2,1
18,286,286,5,2,3,2,1
17,315,315,14,14,0,1,0
37,317,317,159,89,70,3,2
35,327,327,3,3,0,1,0
4,328,328,68,6,62,4,3
22,335,335,35,35,0,1,0
32,344,344,4,4,0,1,0
11,353,353,63,63,0,1,0
20,354,354,12,1,11,2,1
29,362,362,40,40,0,1,0
38,363,363,81,27,54,3,2
0,380,380,106,64,42,2,1
8,389,389,30,26,4,2,1
33,410,410,48,20,28,2,1
16,415,415,40,34,6,2,1
30,428,428,22,10,12,4,3
21,430,430,68,68,0,1,0
34,432,432,7,1,6,2,1
41,454,454,71,7,64,4,3
36,471,471,49,27,22,2,1
13,471,471,56,36,20,3,2
5,474,474,8,8,0,1,0

17,148,148,30,30,0,1,0
20,150,150,12,12,0,1,0
30,152,152,22,22,0,1,0
5,152,152,2,2,0,1,0
39,152,152,3,3,0,1,0
21,170,170,5,2,3,2,1
26,180,180,18,18,0,1,0
6,182,182,11,11,0,1,0
13,199,199,14,14,0,1,0
37,204,204,55,45,10,3,2
9,213,213,53,53,0,1,0
14,225,225,6,6,0,1,0
0,228,228,8,8,0,1,0
24,255,255,98,26,72,4,3
32,261,261,6,6,0,1,0
34,264,264,19,19,0,1,0
15,279,279,51,5,46,2,1
28,291,291,22,16,6,3,2
1,314,314,14,2,12,2,1
35,319,319,2,2,0,1,0
7,344,344,40,12,28,3,2
38,349,349,5,5,0,1,0
8,349,349,35,35,0,1,0
18,359,359,36,36,0,1,0
31,360,360,4,4,0,1,0
10,361,361,48,36,12,2,1
29,371,371,25,25,0,1,0
23,376,376,2,2,0,1,0
16,387,387,28,28,0,1,0
2,396,396,5,5,0,1,0
33,401,401,124,110,14,3,2
22,403,403,65,41,24,3,2
27,418,418,36,6,30,4,3
4,441,441,103,52,51,3,2
12,447,447,1,1,0,1,0
19,450,450,93,93,0,1,0
36,454,454,77,47,30,2,1
11,472,472,31,13,18,4,3
3,483,483,35,27,8,3,2
25,500,500,1,1,0,1,0

3,103,103,2,2,0,1,0
36,107,107,10,10,0,1,0
37,133,133,3,3,0,1,0
14,141,141,17,14,3,2,1
40,147,147,3,3,0,1,0
11,167,167,1,1,0,1,0
18,168,168,6,6,0,1,0
19,170,170,23,5,18,3,2
10,174,174,25,4,21,2,1
17,176,176,20,3,17,2,1
21,180,180,32,32,0,1,0
26,197,197,7,7,0,1,0
22,204,204,12,12,0,1,0
30,207,207,42,9,33,4,3
31,226,226,14,14,0,1,0
16,230,230,21,21,0,1,0
2,234,234,15,1,14,4,3
20,237,237,12,12,0,1,0
27,237,237,68,23,45,4,3
15,240,240,13,13,0,1,0
4,243,243,47,23,24,2,1
24,244,244,19,9,10,3,2
41,258,258,35,21,14,2,1
0,259,259,25,25,0,1,0
12,300,300,2,2,0,1,0
34,308,308,1,1,0,1,0
25,309,309,17,17,0,1,0
9,320,320,8,4,4,2,1
23,338,338,32,4,28,3,2
1,339,339,18,13,5,2,1
28,356,356,70,36,34,2,1
35,364,364,101,29,72,4,3
32,366,366,45,45,0,1,0
29,376,376,36,1,35,2,1
6,384,384,43,32,11,2,1
8,392,392,61,61,0,1,0
13,395,395,102,81,21,4,3
33,438,438,5,5,0,1,0
42,478,478,41,41,0,1,0
38,484,484,13,3,10,2,1
7,488,488,2,2,0,1,0
39,495,495,67,43,24,2,1
5,496,496,13,8,5,2,1

7,107,107,15,15,0,1,0
23,109,109,2,2,0,1,0
16,110,110,1,1,0,1,0
19,121,121,17,17,0,1,0
3,124,124,13,8,5,2,1
37,135,135,7,7,0,1,0
42,148,148,1,1,0,1,0
11,156,156,16,16,0,1,0
29,165,165,12,2,10,2,1
0,209,209,37,37,0,1,0
15,217,217,8,2,6,2,1
38,223,223,12,12,0,1,0
1,227,227,18,18,0,1,0
33,275,275,9,9,0,1,0
35,276,276,20,13,7,2,1
28,279,279,19,19,0,1,0
14,281,281,10,10,0,1,0
34,286,286,47,31,16,2,1
41,305,305,99,54,45,4,3
31,308,308,4,4,0,1,0
22,318,318,109,58,51,3,2
12,326,326,65,65,0,1,0
32,329,329,4,4,0,1,0
20,335,335,1,1,0,1,0
8,367,367,53,53,0,1,0
40,368,368,61,53,8,2,1
5,375,375,29,12,17,2,1
9,377,377,1,1,0,1,0
17,394,394,29,29,0,1,0
26,400,400,34,34,0,1,0
36,426,426,123,123,0,1,0
30,428,428,2,2,0,1,0
6,431,431,9,9,0,1,0
39,435,435,56,40,16,2,1
13,436,436,1,1,0,1,0
10,442,442,2,2,0,1,0
18,459,459,6,6,0,1,0
27,472,472,65,65,0,1,0
2,481,481,60,50,10,2,1
25,482,482,12,7,5,2,1
24,482,482,150,150,0,1,0
21,482,482,21,21,0,1,0
4,492,492,61,9,52,3,2

33,101,101,3,3,0,1,0
36,114,114,16,16,0,1,0
26,122,122,2,2,0,1,0
28,131,131,2,2,0,1,0
37,136,136,4,4,0,1,0
9,150,150,23,15,8,3,2
13,159,159,4,4,0,1,0
35,168,168,5,5,0,1,0
22,171,171,53,53,0,1,0
30,172,172,36,36,0,1,0
12,215,215,9,9,0,1,0
23,229,229,37,37,0,1,0
2,236,236,20,6,14,2,1
0,246,246,10,10,0,1,0
20,246,246,16,16,0,1,0
27,257,257,36,16,20,2,1
18,264,264,54,42,12,3,2
1,271,271,8,8,0,1,0
14,308,308,10,3,7,2,1
19,342,342,10,10,0,1,0
25,343,343,4,4,0,1,0
11,353,353,4,4,0,1,0
16,357,357,19,19,0,1,0
21,363,363,51,51,0,1,0
24,366,366,20,20,0,1,0
34,368,368,16,16,0,1,0
38,381,381,44,6,38,3,2
32,403,403,64,28,36,4,3
31,411,411,26,4,22,2,1
5,411,411,39,5,34,2,1
15,420,420,65,65,0,1,0
3,441,441,52,52,0,1,0
10,447,447,60,50,10,3,2
6,447,447,117,117,0,1,0
39,452,452,16,16,0,1,0
8,454,454,68,22,46,3,2
29,460,460,128,83,45,2,1
17,469,469,42,27,15,4,3
7,469,469,72,22,50,3,2
4,471,471,35,2,33,4,3
40,489,489,24,24,0,1,0

6,105,105,24,9,15,2,1
33,116,116,6,6,0,1,0
12,118,118,1,1,0,1,0
5,124,124,8,8,0,1,0
32,127,127,25,8,17,2,1
18,132,132,12,12,0,1,0
30,169,169,8,8,0,1,0
7,171,171,30,3,27,4,3
31,177,177,21,12,9,4,3
3,184,184,6,6,0,1,0
17,192,192,1,1,0,1,0
36,198,198,18,9,9,4,3
38,244,244,8,8,0,1,0
10,245,245,12,4,8,3,2
27,247,247,45,45,0,1,0
1,269,269,63,23,40,2,1
9,271,271,9,5,4,2,1
13,294,294,17,17,0,1,0
34,297,297,62,5,57,3,2
29,315,315,17,17,0,1,0
35,321,321,89,4,85,4,3
14,328,328,57,57,0,1,0
16,333,333,67,67,0,1,0
25,337,337,7,2,5,2,1
37,339,339,9,3,6,3,2
20,345,345,16,3,13,2,1
2,356,356,6,6,0,1,0
22,371,371,14,4,10,3,2
24,377,377,19,4,15,2,1
21,383,383,23,23,0,1,0
11,387,387,124,124,0,1,0
15,403,403,102,21,81,4,3
0,416,416,11,11,0,1,0
28,421,421,184,184,0,1,0
23,430,430,4,4,0,1,0
8,449,449,1,1,0,1,0
26,452,452,25,25,0,1,0
4,452,452,13,13,0,1,0
19,454,454,19,5,14,3,2

35,106,106,9,9,0,1,0
13,114,114,3,3,0,1,0
17,122,122,1,1,0,1,0
2,136,136,22,22,0,1,0
14,139,139,4,4,0,1,0
10,146,146,28,22,6,3,2
41,147,147,3,3,0,1,0
9,160,160,2,2,0,1,0
0,167,167,39,14,25,2,1
42,173,173,1,1,0,1,0
28,176,176,20,20,0,1,0
37,179,179,52,19,33,4,3
11,194,194,20,20,0,1,0
39,198,198,16,6,10,2,1
33,211,211,39,39,0,1,0
40,213,213,29,29,0,1,0
3,242,242,18,18,0,1,0
15,263,263,1,1,0,1,0
12,267,267,47,7,40,3,2
8,284,284,39,39,0,1,0
30,293,293,28,15,13,2,1
31,293,293,39,9,30,2,1
38,299,299,10,4,6,2,1
4,303,303,1,1,0,1,0
16,304,304,16,4,12,2,1
34,305,305,9,9,0,1,0
19,314,314,1,1,0,1,0
26,315,315,7,7,0,1,0
29,331,331,12,2,10,3,2
22,333,333,37,37,0,1,0
21,348,348,63,63,0,1,0
1,355,355,60,60,0,1,0
36,357,357,36,36,0,1,0
7,369,369,31,31,0,1,0
32,380,380,57,57,0,1,0
6,400,400,17,17,0,1,0
24,402,402,16,7,9,2,1
23,403,403,98,82,16,2,1
25,405,405,53,11,42,2,1
20,407,407,36,25,11,2,1
27,419,419,45,17,28,4,3
18,439,439,14,11,3,2,1
5,498,498,38,38,0,1,0

26,103,103,2,2,0,1,0
34,106,106,2,2,0,1,0
33,107,107,10,10,0,1,0
9,109,109,1,1,0,1,0
4,112,112,7,3,4,2,1
15,114,114,27,27,0,1,0
10,123,123,6,6,0,1,0
21,149,149,1,1,0,1,0
11,152,152,6,6,0,1,0
19,156,156,30,2,28,3,2
0,205,205,1,1,0,1,0
32,206,206,7,7,0,1,0
7,215,215,3,3,0,1,0
2,219,219,43,9,34,3,2
39,227,227,21,15,6,2,1
1,243,243,1,1,0,1,0
22,245,245,4,1,3,2,1
27,258,258,42,42,0,1,0
43,258,258,13,3,10,2,1
5,262,262,8,8,0,1,0
42,285,285,10,10,0,1,0
13,295,295,15,15,0,1,0
23,298,298,67,67,0,1,0
36,298,298,4,4,0,1,0
40,302,302,4,4,0,1,0
3,310,310,28,20,8,3,2
20,320,320,1,1,0,1,0
17,328,328,115,115,0,1,0
37,333,333,48,48,0,1,0
41,343,343,85,10,75,4,3
25,360,360,54,54,0,1,0
28,362,362,32,4,28,2,1
24,364,364,116,71,45,2,1
6,366,366,16,16,0,1,0
29,397,397,61,29,32,2,1
38,416,416,2,2,0,1,0
12,416,416,90,52,38,3,2
30,418,418,13,3,10,3,2
14,426,426,29,21,8,2,1
8,438,438,31,31,0,1,0
31,475,475,138,125,13,2,1
18,489,489,8,2,6,3,2
16,496,496,2,2,0,1,0
35,497,497,41,25,16,3,2

12,113,113,8,8,0,1,0
30,119,119,3,3,0,1,0
15,141,141,6,6,0,1,0
33,157,157,19,1,18,3,2
22,158,158,15,15,0,1,0
34,174,174,6,6,0,1,0
38,185,185,52,31,21,2,1
27,200,200,4,4,0,1,0
29,206,206,6,1,5,2,1
26,212,212,43,36,7,2,1
7,214,214,9,1,8,3,2
21,216,216,25,25,0,1,0
0,223,223,9,2,7,2,1
39,229,229,20,20,0,1,0
43,238,238,79,20,59,3,2
40,249,249,2,2,0,1,0
10,256,256,2,2,0,1,0
2,269,269,31,1,30,3,2
1,285,285,30,30,0,1,0
4,307,307,30,17,13,2,1
36,314,314,32,2,30,2,1
6,316,316,26,26,0,1,0
42,324,324,81,64,17,2,1
16,333,333,19,19,0,1,0
5,340,340,1,1,0,1,0
8,346,346,58,31,27,3,2
41,354,354,8,8,0,1,0
14,360,360,21,8,13,4,3
9,362,362,2,2,0,1,0
28,376,376,14,1,13,2,1
20,384,384,32,32,0,1,0
13,395,395,67,67,0,1,0
25,404,404,14,14,0,1,0
3,409,409,36,36,0,1,0
35,422,422,80,80,0,1,0
11,444,444,16,16,0,1,0
23,458,458,64,7,57,3,2
19,462,462,2,2,0,1,0
37,472,472,69,69,0,1,0
18,474,474,43,16,27,4,3
32,477,477,11,7,4,2,1
17,485,485,137,62,75,4,3
31,488,488,36,36,0,1,0
24,490,490,9,9,0,1,0

1,101,101,2,2,0,1,0
5,101,101,2,2,0,1,0
2,104,104,10,10,0,1,0
6,109,109,45,27,18,4,3
26,109,109,11,6,5,2,1
25,115,115,18,2,16,3,2
28,123,123,9,9,0,1,0
7,126,126,3,3,0,1,0
27,130,130,9,9,0,1,0
18,134,134,19,19,0,1,0
8,153,153,19,5,14,2,1
0,179,179,16,16,0,1,0
16,198,198,19,19,0,1,0
10,217,217,56,15,41,4,3
24,221,221,16,9,7,2,1
32,260,260,21,21,0,1,0
12,267,267,18,5,13,2,1
3,280,280,13,6,7,2,1
33,286,286,28,28,0,1,0
22,287,287,2,2,0,1,0
20,292,292,36,16,20,2,1
4,303,303,45,45,0,1,0
29,337,337,45,8,37,2,1
17,381,381,66,9,57,4,3
21,386,386,13,1,12,2,1
34,395,395,104,104,0,1,0
9,405,405,51,33,18,3,2
14,414,414,114,114,0,1,0
23,450,450,19,6,13,2,1
19,452,452,123,123,0,1,0
30,458,458,15,15,0,1,0
13,465,465,48,1,47,2,1
11,465,465,88,10,78,3,2
15,486,486,6,2,4,2,1
31,490,490,33,33,0,1,0

16,100,100,4,4,0,1,0
21,102,102,21,3,18,4,3
11,119,119,8,8,0,1,0
17,122,122,2,2,0,1,0
18,126,126,5,1,4,2,1
32,130,130,2,2,0,1,0
8,136,136,21,21,0,1,0
40,137,137,10,1,9,4,3
4,156,156,9,1,8,2,1
36,159,159,17,2,15,4,3
27,180,180,6,6,0,1,0
5,180,180,1,1,0,1,0
37,253,253,24,24,0,1,0
26,254,254,4,4,0,1,0
29,277,277,25,7,18,3,2
39,278,278,49,49,0,1,0
12,284,284,15,7,8,3,2
9,290,290,51,51,0,1,0
3,304,304,7,7,0,1,0
7,318,318,4,4,0,1,0
13,323,323,15,15,0,1,0
20,329,329,19,12,7,2,1
2,333,333,19,19,0,1,0
14,366,366,44,44,0,1,0
24,369,369,63,3,60,3,2
10,371,371,23,23,0,1,0
1,378,378,9,1,8,3,2
41,384,384,45,45,0,1,0
28,386,386,42,2,40,3,2
34,389,389,48,48,0,1,0
31,397,397,54,54,0,1,0
6,399,399,32,9,23,2,1
23,406,406,39,39,0,1,0
22,434,434,13,13,0,1,0
19,435,435,143,143,0,1,0
38,445,445,29,4,25,2,1
30,456,456,51,51,0,1,0
25,458,458,30,30,0,1,0
15,462,462,127,127,0,1,0
33,463,463,101,50,51,4,3
0,492,492,51,26,25,2,1
35,499,499,94,8,86,3,2

33,100,100,6,6,0,1,0
12,100,100,22,4,18,4,3
36,106,106,16,4,12,2,1
6,110,110,5,5,0,1,0
19,113,113,12,12,0,1,0
2,122,122,4,4,0,1,0
3,123,123,11,11,0,1,0
29,125,125,9,9,0,1,0
11,130,130,21,18,3,2,1
39,137,137,14,14,0,1,0
35,149,149,6,6,0,1,0
30,156,156,36,8,28,2,1
1,158,158,7,7,0,1,0
7,181,181,50,10,40,3,2
18,187,187,6,6,0,1,0
34,189,189,1,1,0,1,0
8,227,227,6,6,0,1,0
23,232,232,40,8,32,3,2
10,242,242,3,3,0,1,0
5,254,254,38,30,8,3,2
28,266,266,14,6,8,2,1
0,273,273,76,40,36,3,2
14,276,276,6,6,0,1,0
16,289,289,35,19,16,2,1
25,295,295,60,36,24,4,3
24,324,324,7,7,0,1,0
17,345,345,103,103,0,1,0
22,347,347,39,6,33,4,3
4,349,349,10,10,0,1,0
27,352,352,55,55,0,1,0
38,361,361,101,64,37,2,1
31,371,371,6,1,5,2,1
26,380,380,26,8,18,4,3
37,392,392,41,17,24,2,1
15,419,419,2,2,0,1,0
32,423,423,24,24,0,1,0
13,432,432,21,4,17,2,1
20,442,442,33,18,15,4,3
9,446,446,1,1,0,1,0
21,459,459,29,29,0,1,0

10,111,111,5,5,0,1,0
4,136,136,25,25,0,1,0
34,150,150,50,30,20,3,2
32,182,182,28,28,0,1,0
9,183,183,40,40,0,1,0
28,195,195,11,11,0,1,0
36,213,213,29,29,0,1,0
29,213,213,24,9,15,2,1
26,224,224,37,13,24,4,3
31,225,225,44,39,5,2,1
30,239,239,29,5,24,2,1
17,241,241,5,2,3,2,1
16,273,273,10,5,5,2,1
0,277,277,3,3,0,1,0
11,295,295,9,9,0,1,0
8,302,302,5,5,0,1,0
21,314,314,6,1,5,2,1
38,319,319,16,16,0,1,0
12,323,323,51,51,0,1,0
37,340,340,33,33,0,1,0
19,342,342,76,7,69,4,3
14,362,362,45,1,44,3,2
6,365,365,71,15,56,3,2
25,367,367,26,26,0,1,0
33,398,398,75,48,27,4,3
20,410,410,28,28,0,1,0
5,415,415,76,76,0,1,0
35,418,418,41,41,0,1,0
13,419,419,7,7,0,1,0
22,422,422,13,5,8,3,2
3,436,436,1,1,0,1,0
1,440,440,10,7,3,2,1
2,443,443,11,3,8,2,1
39,448,448,29,3,26,3,2
7,448,448,92,69,23,2,1
23,451,451,1,1,0,1,0
24,457,457,3,3,0,1,0
27,466,466,35,7,28,2,1
18,472,472,76,57,19,2,1
15,477,477,26,26,0,1,0
40,478,478,25,9,16,3,2

1,103,103,27,27,0,1,0
2,106,106,16,16,0,1,0
33,122,122,13,6,7,2,1
16,144,144,13,13,0,1,0
40,150,150,24,1,23,2,1
10,152,152,2,2,0,1,0
31,157,157,1,1,0,1,0
0,160,160,16,16,0,1,0
25,163,163,11,11,0,1,0
18,167,167,24,1,23,2,1
11,170,170,10,10,0,1,0
30,177,177,28,28,0,1,0
23,191,191,14,1,13,2,1
14,203,203,6,6,0,1,0
28,219,219,17,17,0,1,0
4,234,234,24,6,18,2,1
38,237,237,20,11,9,4,3
32,250,250,15,15,0,1,0
3,255,255,27,24,3,2,1
22,255,255,4,4,0,1,0
17,289,289,22,11,11,4,3
13,308,308,40,25,15,4,3
19,341,341,8,8,0,1,0
36,347,347,32,32,0,1,0
39,355,355,89,89,0,1,0
9,359,359,123,123,0,1,0
20,372,372,17,17,0,1,0
37,379,379,32,32,0,1,0
8,382,382,59,59,0,1,0
34,387,387,17,6,11,2,1
12,397,397,38,38,0,1,0
26,400,400,2,2,0,1,0
6,401,401,12,12,0,1,0
21,405,405,109,109,0,1,0
7,412,412,1,1,0,1,0
24,414,414,66,29,37,2,1
27,423,423,36,2,34,3,2
5,433,433,14,14,0,1,0
15,483,483,6,3,3,2,1
29,489,489,53,53,0,1,0
35,495,495,69,21,48,4,3

9,131,131,2,2,0,1,0
6,159,159,56,6,50,3,2
11,161,161,7,7,0,1,0
0,175,175,29,29,0,1,0
17,179,179,20,5,15,2,1
15,203,203,20,2,18,4,3
2,207,207,3,3,0,1,0
24,231,231,15,15,0,1,0
25,233,233,27,4,23,4,3
22,237,237,25,7,18,2,1
8,252,252,110,89,21,4,3
18,257,257,16,16,0,1,0
12,265,265,9,9,0,1,0
28,299,299,17,17,0,1,0
23,303,303,10,1,9,4,3
16,308,308,58,58,0,1,0
10,326,326,28,28,0,1,0
19,354,354,53,53,0,1,0
1,367,367,28,4,24,4,3
29,379,379,55,55,0,1,0
13,395,395,63,12,51,4,3
4,414,414,6,6,0,1,0
14,419,419,115,115,0,1,0
7,421,421,179,179,0,1,0
3,422,422,151,136,15,4,3
21,423,423,21,21,0,1,0
20,432,432,70,70,0,1,0
26,439,439,12,12,0,1,0
27,440,440,29,26,3,2,1
5,476,476,68,38,30,3,2

25,105,105,1,1,0,1,0
32,126,126,15,3,12,4,3
5,128,128,58,58,0,1,0
14,140,140,4,4,0,1,0
18,142,142,19,19,0,1,0
21,143,143,20,20,0,1,0
3,148,148,24,24,0,1,0
11,151,151,19,19,0,1,0
9,164,164,5,5,0,1,0
27,189,189,14,14,0,1,0
33,194,194,20,5,15,2,1
4,206,206,57,32,25,2,1
10,212,212,1,1,0,1,0
29,228,228,14,14,0,1,0
17,246,246,27,27,0,1,0
31,257,257,6,2,4,2,1
1,261,261,50,50,0,1,0
6,265,265,42,15,27,2,1
19,297,297,31,31,0,1,0
24,325,325,22,4,18,4,3
20,349,349,141,39,102,4,3
8,356,356,51,51,0,1,0
12,356,356,24,8,16,2,1
7,367,367,16,16,0,1,0
13,370,370,10,2,8,2,1
16,371,371,78,72,6,2,1
15,394,394,1,1,0,1,0
2,396,396,53,50,3,2,1
22,404,404,11,3,8,3,2
23,422,422,82,46,36,2,1
30,438,438,1,1,0,1,0
26,443,443,29,9,20,3,2
28,451,451,70,39,31,4,3
0,495,495,91,49,42,4,3

16,111,111,10,1,9,4,3
17,121,121,3,3,0,1,0
24,126,126,34,34,0,1,0
26,128,128,7,7,0,1,0
35,156,156,3,3,0,1,0
36,164,164,6,6,0,1,0
33,165,165,13,5,8,3,2
5,174,174,25,25,0,1,0
20,183,183,1,1,0,1,0
10,199,199,2,2,0,1,0
2,212,212,22,13,9,4,3
34,217,217,6,6,0,1,0
12,228,228,12,1,11,4,3
38,238,238,7,7,0,1,0
18,242,242,7,1,6,3,2
9,244,244,8,8,0,1,0
21,259,259,43,43,0,1,0
13,259,259,32,32,0,1,0
15,260,260,7,4,3,2,1
11,271,271,30,30,0,1,0
39,273,273,22,8,14,3,2
3,286,286,88,88,0,1,0
0,295,295,66,51,15,4,3
28,302,302,1,1,0,1,0
14,313,313,22,22,0,1,0
4,322,322,2,2,0,1,0
27,323,323,27,5,22,3,2
31,324,324,24,24,0,1,0
25,334,334,26,5,21,4,3
30,371,371,170,170,0,1,0
7,372,372,63,55,8,3,2
23,374,374,16,16,0,1,0
19,380,380,30,8,22,3,2
32,387,387,19,19,0,1,0
29,412,412,95,29,66,4,3
1,419,419,135,29,106,4,3
22,443,443,49,49,0,1,0
37,445,445,66,66,0,1,0
8,480,480,1,1,0,1,0
6,499,499,36,36,0,1,0

38,106,106,8,8,0,1,0
18,109,109,8,8,0,1,0
10,123,123,2,2,0,1,0
33,159,159,14,14,0,1,0
15,162,162,1,1,0,1,0
25,169,169,34,2,32,2,1
0,171,171,7,1,6,3,2
26,172,172,9,5,4,2,1
9,177,177,5,5,0,1,0
5,198,198,1,1,0,1,0
7,201,201,17,6,11,2,1
39,213,213,27,27,0,1,0
37,216,216,14,9,5,2,1
27,223,223,17,12,5,2,1
29,231,231,9,6,3,2,1
20,265,265,28,28,0,1,0
13,269,269,24,10,14,2,1
34,291,291,1,1,0,1,0
22,294,294,32,8,24,2,1
36,295,295,1,1,0,1,0
8,306,306,2,2,0,1,0
23,328,328,56,20,36,3,2
14,338,338,164,112,52,3,2
35,355,355,12,4,8,3,2
32,356,356,15,3,12,2,1
6,367,367,13,5,8,3,2
4,380,380,32,32,0,1,0
2,391,391,95,45,50,3,2
30,393,393,144,117,27,2,1
28,409,409,11,5,6,3,2
11,412,412,16,12,4,2,1
1,412,412,49,41,8,3,2
19,436,436,12,4,8,2,1
12,439,439,120,120,0,1,0
16,446,446,23,23,0,1,0
31,459,459,99,62,37,4,3
3,466,466,89,89,0,1,0
21,479,479,81,81,0,1,0
24,484,484,33,20,13,2,1
17,487,487,50,50,0,1,0

27,110,110,6,1,5,2,1
28,118,118,2,2,0,1,0
21,118,118,12,12,0,1,0
20,146,146,2,2,0,1,0
23,147,147,3,3,0,1,0
24,155,155,19,19,0,1,0
48,157,157,2,2,0,1,0
33,170,170,8,4,4,2,1
46,177,177,1,1,0,1,0
37,188,188,1,1,0,1,0
11,189,189,23,7,16,4,3
35,199,199,25,18,7,2,1
30,199,199,27,1,26,3,2
34,208,208,52,52,0,1,0
6,228,228,23,11,12,3,2
2,230,230,5,5,0,1,0
9,233,233,47,47,0,1,0
32,244,244,50,50,0,1,0
31,248,248,43,5,38,3,2
26,250,250,36,4,32,4,3
17,258,258,3,3,0,1,0
12,267,267,15,3,12,4,3
1,273,273,5,5,0,1,0
13,311,311,6,6,0,1,0
47,316,316,69,1,68,3,2
18,320,320,6,1,5,2,1
22,326,326,13,5,8,2,1
5,333,333,22,22,0,1,0
39,333,333,13,13,0,1,0
3,338,338,19,19,0,1,0
40,349,349,11,11,0,1,0
45,356,356,1,1,0,1,0
36,363,363,58,58,0,1,0
43,364,364,7,7,0,1,0
42,369,369,43,43,0,1,0
41,370,370,82,46,36,4,3
4,390,390,4,4,0,1,0
38,394,394,1,1,0,1,0
8,398,398,18,18,0,1,0
16,399,399,71,71,0,1,0
44,431,431,108,108,0,1,0
25,435,435,30,30,0,1,0
0,435,435,1,1,0,1,0
29,436,436,8,8,0,1,0
15,442,442,56,38,18,4,3
14,459,459,25,1,24,2,1
19,460,460,78,34,44,2,1
7,466,466,49,49,0,1,0
10,486,486,20,20,0,1,0

9,100,100,13,9,4,2,1
41,103,103,12,12,0,1,0
4,104,104,11,3,8,3,2
25,115,115,4,1,3,2,1
35,127,127,21,21,0,1,0
21,129,129,11,11,0,1,0
16,135,135,17,6,11,2,1
20,137,137,7,7,0,1,0
38,147,147,3,3,0,1,0
23,170,170,24,24,0,1,0
7,188,188,28,28,0,1,0
34,199,199,3,3,0,1,0
14,209,209,8,2,6,3,2
26,209,209,64,64,0,1,0
2,222,222,27,8,19,4,3
15,226,226,26,26,0,1,0
5,231,231,22,22,0,1,0
39,246,246,11,5,6,3,2
28,249,249,31,20,11,2,1
11,259,259,18,8,10,3,2
3,262,262,32,22,10,3,2
40,272,272,43,43,0,1,0
0,283,283,32,32,0,1,0
8,301,301,2,2,0,1,0
31,329,329,10,10,0,1,0
12,351,351,10,10,0,1,0
29,357,357,75,75,0,1,0
17,364,364,13,7,6,3,2
37,365,365,47,47,0,1,0
19,390,390,12,12,0,1,0
42,404,404,20,20,0,1,0
18,414,414,62,62,0,1,0
6,431,431,12,12,0,1,0
32,440,440,33,33,0,1,0
10,440,440,37,37,0,1,0
1,442,442,56,19,37,2,1
24,443,443,75,15,60,4,3
33,450,450,65,65,0,1,0
36,462,462,11,11,0,1,0
22,465,465,21,1,20,3,2
30,474,474,5,5,0,1,0
27,482,482,35,8,27,2,1
13,489,489,70,58,12,4,3

4,103,103,19,10,9,2,1
37,104,104,7,7,0,1,0
15,106,106,2,2,0,1,0
12,111,111,2,2,0,1,0
23,114,114,25,5,20,2,1
1,138,138,12,3,9,2,1
8,138,138,20,20,0,1,0
25,180,180,2,2,0,1,0
11,212,212,49,24,25,2,1
27,217,217,4,4,0,1,0
36,238,238,19,15,4,2,1
31,272,272,1,1,0,1,0
10,276,276,9,9,0,1,0
20,279,279,1,1,0,1,0
24,293,293,1,1,0,1,0
39,294,294,14,2,12,2,1
21,295,295,22,22,0,1,0
30,296,296,48,17,31,2,1
22,299,299,46,30,16,2,1
17,300,300,48,7,41,2,1
35,307,307,69,69,0,1,0
6,311,311,89,52,37,2,1
19,331,331,43,43,0,1,0
7,356,356,23,23,0,1,0
14,362,362,28,28,0,1,0
28,363,363,98,98,0,1,0
29,366,366,52,35,17,2,1
13,381,381,6,2,4,2,1
18,387,387,4,4,0,1,0
26,400,400,55,48,7,2,1
38,401,401,17,17,0,1,0
3,406,406,96,96,0,1,0
33,427,427,34,34,0,1,0
2,428,428,41,17,24,3,2
34,442,442,122,83,39,4,3
9,448,448,14,14,0,1,0
5,469,469,21,21,0,1,0
0,483,483,62,62,0,1,0
16,485,485,2,2,0,1,0
32,485,485,11,5,6,3,2

6,101,101,1,1,0,1,0
38,108,108,33,33,0,1,0
17,124,124,20,5,15,2,1
19,152,152,15,3,12,4,3
7,154,154,32,22,10,3,2
27,154,154,23,7,16,2,1
34,166,166,2,2,0,1,0
20,176,176,16,5,11,2,1
23,192,192,12,3,9,4,3
30,197,197,16,7,9,2,1
0,203,203,2,2,0,1,0
15,217,217,1,1,0,1,0
28,221,221,24,24,0,1,0
8,225,225,33,5,28,3,2
26,237,237,4,4,0,1,0
39,244,244,20,20,0,1,0
4,256,256,10,5,5,2,1
1,274,274,37,37,0,1,0
16,279,279,9,9,0,1,0
10,282,282,147,120,27,2,1
2,286,286,11,4,7,2,1
36,306,306,7,7,0,1,0
32,320,320,54,54,0,1,0
35,321,321,11,11,0,1,0
33,333,333,91,53,38,2,1
9,347,347,5,5,0,1,0
18,351,351,1,1,0,1,0
25,352,352,35,7,28,3,2
31,352,352,39,2,37,4,3
29,355,355,25,25,0,1,0
22,364,364,59,6,53,3,2
37,425,425,1,1,0,1,0
12,428,428,55,29,26,3,2
21,437,437,6,6,0,1,0
14,442,442,3,3,0,1,0
24,448,448,76,76,0,1,0
3,457,457,21,15,6,3,2
5,464,464,31,31,0,1,0
11,476,476,5,5,0,1,0
13,498,498,160,61,99,4,3

12,105,105,2,2,0,1,0
1,107,107,20,8,12,2,1
22,119,119,4,4,0,1,0
5,170,170,92,50,42,3,2
8,182,182,5,5,0,1,0
19,189,189,26,2,24,4,3
3,211,211,183,126,57,3,2
25,219,219,8,8,0,1,0
6,237,237,45,45,0,1,0
17,278,278,6,6,0,1,0
9,283,283,44,25,19,2,1
0,287,287,40,40,0,1,0
14,314,314,68,68,0,1,0
16,328,328,50,2,48,4,3
20,374,374,11,11,0,1,0
26,390,390,102,102,0,1,0
11,403,403,34,19,15,4,3
15,404,404,60,60,0,1,0
2,415,415,13,13,0,1,0
18,430,430,39,39,0,1,0
10,431,431,12,3,9,4,3
4,433,433,11,11,0,1,0
24,449,449,33,24,9,4,3
21,453,453,186,96,90,3,2
27,458,458,9,9,0,1,0
23,484,484,22,22,0,1,0
13,498,498,17,3,14,4,3
7,500,500,10,10,0,1,0

9,107,107,18,18,0,1,0
15,122,122,25,25,0,1,0
26,138,138,22,4,18,2,1
8,153,153,3,3,0,1,0
30,166,166,9,3,6,3,2
20,178,178,7,7,0,1,0
2,182,182,38,17,21,4,3
4,183,183,6,6,0,1,0
6,191,191,18,15,3,2,1
22,196,196,41,41,0,1,0
19,202,202,8,8,0,1,0
29,208,208,11,11,0,1,0
13,214,214,161,161,0,1,0
16,226,226,32,32,0,1,0
28,228,228,14,2,12,3,2
5,241,241,5,5,0,1,0
1,247,247,15,5,10,2,1
32,253,253,9,9,0,1,0
21,291,291,103,11,92,4,3
24,311,311,2,2,0,1,0
17,323,323,3,3,0,1,0
31,328,328,63,63,0,1,0
12,331,331,28,1,27,3,2
7,335,335,46,1,45,4,3
23,359,359,28,28,0,1,0
27,376,376,130,86,44,3,2
0,393,393,39,39,0,1,0
11,394,394,11,11,0,1,0
18,405,405,4,4,0,1,0
14,425,425,9,9,0,1,0
25,457,457,7,7,0,1,0
33,463,463,1,1,0,1,0
34,476,476,13,13,0,1,0
3,488,488,108,102,6,2,1
10,500,500,26,26,0,1,0

18,120,120,36,32,4,2,1
29,127,127,11,11,0,1,0
25,162,162,7,7,0,1,0
4,179,179,22,14,8,3,2
8,192,192,2,2,0,1,0
5,193,193,35,35,0,1,0
11,208,208,34,34,0,1,0
34,219,219,1,1,0,1,0
16,222,222,48,20,28,4,3
12,227,227,7,2,5,2,1
21,247,247,9,3,6,3,2
20,254,254,18,18,0,1,0
17,257,257,5,2,3,2,1
14,260,260,19,2,17,2,1
15,279,279,11,11,0,1,0
1,296,296,10,10,0,1,0
6,341,341,7,7,0,1,0
23,348,348,54,46,8,2,1
35,348,348,82,82,0,1,0
0,350,350,55,35,20,2,1
3,362,362,25,10,15,4,3
32,367,367,108,30,78,4,3
28,376,376,49,49,0,1,0
2,385,385,53,53,0,1,0
9,396,396,6,6,0,1,0
30,397,397,32,8,24,3,2
36,398,398,11,8,3,2,1
31,399,399,22,2,20,3,2
19,409,409,54,54,0,1,0
37,413,413,25,6,19,2,1
13,439,439,69,19,50,2,1
26,452,452,29,2,27,4,3
38,460,460,7,7,0,1,0
27,461,461,111,27,84,4,3
33,464,464,46,46,0,1,0
24,469,469,15,1,14,3,2
7,474,474,38,38,0,1,0
39,490,490,34,4,30,3,2
10,496,496,21,21,0,1,0
22,497,497,115,115,0,1,0

16,111,111,1,1,0,1,0
28,120,120,14,4,10,2,1
14,140,140,1,1,0,1,0
4,157,157,31,31,0,1,0
20,159,159,15,1,14,4,3
8,165,165,2,2,0,1,0
31,166,166,63,24,39,4,3
41,169,169,13,5,8,2,1
1,169,169,12,12,0,1,0
35,182,182,4,4,0,1,0
19,185,185,1,1,0,1,0
5,189,189,3,3,0,1,0
24,195,195,31,7,24,3,2
22,198,198,4,1,3,2,1
6,217,217,18,9,9,2,1
0,226,226,8,1,7,2,1
40,242,242,3,3,0,1,0
9,247,247,37,37,0,1,0
25,249,249,14,9,5,2,1
12,262,262,34,34,0,1,0
27,265,265,33,33,0,1,0
18,269,269,9,9,0,1,0
23,272,272,10,2,8,3,2
36,297,297,24,3,21,2,1
37,334,334,71,6,65,3,2
38,363,363,82,53,29,3,2
17,366,366,37,37,0,1,0
3,373,373,41,9,32,2,1
32,380,380,9,2,7,2,1
13,384,384,79,13,66,4,3
7,386,386,32,32,0,1,0
33,392,392,31,31,0,1,0
21,411,411,20,20,0,1,0
11,412,412,19,7,12,3,2
29,420,420,6,6,0,1,0
2,427,427,218,218,0,1,0
30,438,438,18,9,9,4,3
26,442,442,36,36,0,1,0
15,478,478,9,9,0,1,0
39,488,488,88,31,57,3,2
10,497,497,17,17,0,1,0
34,498,498,48,41,7,2,1

27,100,100,7,3,4,2,1
25,103,103,10,2,8,3,2
17,113,113,5,5,0,1,0
22,118,118,23,23,0,1,0
28,122,122,8,8,0,1,0
23,123,123,24,15,9,2,1
11,141,141,4,4,0,1,0
15,153,153,19,19,0,1,0
2,155,155,21,3,18,3,2
7,156,156,15,15,0,1,0
35,177,177,4,4,0,1,0
26,256,256,29,19,10,2,1
10,258,258,12,3,9,2,1
19,261,261,83,83,0,1,0
16,269,269,27,10,17,2,1
37,274,274,10,4,6,2,1
31,279,279,44,18,26,3,2
8,297,297,9,9,0,1,0
38,298,298,61,21,40,2,1
24,314,314,28,20,8,2,1
21,328,328,8,8,0,1,0
6,337,337,62,62,0,1,0
12,344,344,101,67,34,2,1
36,355,355,11,2,9,4,3
32,362,362,28,28,0,1,0
29,365,365,42,8,34,3,2
14,366,366,113,113,0,1,0
34,371,371,52,52,0,1,0
9,388,388,10,5,5,2,1
30,394,394,14,14,0,1,0
5,409,409,54,54,0,1,0
13,412,412,39,12,27,2,1
33,445,445,20,20,0,1,0
0,448,448,113,67,46,2,1
4,457,457,2,2,0,1,0
3,463,463,14,10,4,2,1
20,468,468,1,1,0,1,0
1,483,483,11,11,0,1,0
18,500,500,23,23,0,1,0

26,108,108,6,6,0,1,0
21,110,110,2,2,0,1,0
15,117,117,1,1,0,1,0
31,123,123,1,1,0,1,0
24,129,129,4,1,3,2,1
12,133,133,17,3,14,3,2
30,160,160,20,20,0,1,0
19,181,181,48,48,0,1,0
27,200,200,22,11,11,2,1
3,207,207,61,1,60,3,2
11,230,230,36,36,0,1,0
20,243,243,27,16,11,4,3
14,255,255,4,4,0,1,0
9,258,258,2,2,0,1,0
16,271,271,26,1,25,2,1
32,276,276,40,40,0,1,0
6,302,302,34,34,0,1,0
5,312,312,154,91,63,4,3
29,315,315,146,146,0,1,0
7,326,326,23,23,0,1,0
18,334,334,4,4,0,1,0
17,334,334,9,9,0,1,0
28,337,337,17,13,4,2,1
2,337,337,85,45,40,3,2
8,344,344,47,47,0,1,0
1,352,352,15,5,10,2,1
4,354,354,9,1,8,2,1
13,392,392,27,16,11,2,1
36,396,396,59,24,35,2,1
0,429,429,36,36,0,1,0
35,429,429,40,6,34,2,1
25,431,431,7,7,0,1,0
33,448,448,14,14,0,1,0
10,449,449,3,3,0,1,0
34,450,450,48,48,0,1,0
23,451,451,87,60,27,4,3
22,491,491,20,4,16,4,3

5,107,107,1,1,0,1,0
22,117,117,1,1,0,1,0
10,123,123,5,5,0,1,0
32,130,130,13,13,0,1,0
31,136,136,1,1,0,1,0
26,143,143,16,16,0,1,0
12,145,145,30,4,26,3,2
27,166,166,77,77,0,1,0
18,178,178,18,18,0,1,0
15,196,196,2,2,0,1,0
20,200,200,21,7,14,3,2
3,232,232,50,20,30,4,3
21,232,232,29,9,20,3,2
23,233,233,2,2,0,1,0
16,235,235,9,1,8,3,2
33,243,243,62,62,0,1,0
8,244,244,6,6,0,1,0
24,250,250,12,12,0,1,0
1,254,254,1,1,0,1,0
0,269,269,17,17,0,1,0
38,273,273,13,13,0,1,0
37,293,293,6,6,0,1,0
29,298,298,33,3,30,3,2
25,301,301,87,76,11,4,3
19,310,310,21,1,20,3,2
13,324,324,6,6,0,1,0
30,356,356,2,2,0,1,0
7,377,377,2,2,0,1,0
14,380,380,48,2,46,3,2
36,382,382,30,30,0,1,0
4,412,412,70,70,0,1,0
35,413,413,56,36,20,2,1
6,442,442,28,15,13,2,1
2,452,452,97,97,0,1,0
9,462,462,204,139,65,4,3
17,468,468,65,65,0,1,0
28,471,471,18,18,0,1,0
34,478,478,7,7,0,1,0
11,479,479,54,9,45,4,3

21,111,111,4,1,3,2,1
34,122,122,10,2,8,3,2
23,126,126,42,38,4,2,1
28,128,128,19,7,12,2,1
31,132,132,9,4,5,2,1
39,135,135,21,21,0,1,0
17,144,144,28,12,16,2,1
4,145,145,1,1,0,1,0
13,151,151,29,29,0,1,0
0,157,157,76,13,63,3,2
20,160,160,2,2,0,1,0
27,173,173,3,3,0,1,0
1,186,186,10,10,0,1,0
5,199,199,3,3,0,1,0
15,250,250,15,15,0,1,0
32,258,258,18,18,0,1,0
22,260,260,39,39,0,1,0
24,290,290,15,15,0,1,0
18,291,291,26,17,9,4,3
36,295,295,7,1,6,2,1
38,313,313,6,6,0,1,0
7,330,330,23,23,0,1,0
3,336,336,11,2,9,2,1
29,338,338,45,23,22,2,1
40,344,344,6,6,0,1,0
10,346,346,3,3,0,1,0
35,346,346,41,32,9,4,3
11,349,349,30,24,6,2,1
26,353,353,86,33,53,4,3
2,361,361,19,19,0,1,0
12,370,370,88,75,13,2,1
41,374,374,106,25,81,4,3
42,399,399,21,21,0,1,0
33,409,409,29,13,16,3,2
19,431,431,8,4,4,2,1
25,448,448,5,5,0,1,0
9,458,458,2,2,0,1,0
30,460,460,36,24,12,4,3
16,466,466,1,1,0,1,0
8,472,472,34,16,18,2,1
14,475,475,52,52,0,1,0
37,489,489,34,6,28,3,2
6,493,493,6,6,0,1,0

22,104,104,11,11,0,1,0
28,106,106,3,3,0,1,0
6,111,111,3,3,0,1,0
34,117,117,1,1,0,1,0
27,124,124,20,20,0,1,0
11,129,129,22,22,0,1,0
31,129,129,25,25,0,1,0
20,147,147,34,14,20,4,3
15,214,214,7,1,6,3,2
14,232,232,3,3,0,1,0
35,232,232,13,1,12,3,2
13,264,264,58,13,45,4,3
7,276,276,3,3,0,1,0
19,278,278,48,48,0,1,0
3,284,284,26,26,0,1,0
16,288,288,4,4,0,1,0
17,301,301,17,17,0,1,0
23,301,301,59,59,0,1,0
21,313,313,15,15,0,1,0
24,320,320,6,6,0,1,0
26,338,338,2,2,0,1,0
5,341,341,4,4,0,1,0
1,343,343,23,19,4,2,1
37,371,371,10,4,6,3,2
0,384,384,82,82,0,1,0
38,390,390,5,5,0,1,0
8,393,393,15,7,8,2,1
32,408,408,139,4,135,4,3
33,418,418,25,16,9,4,3
29,421,421,92,65,27,2,1
30,421,421,50,50,0,1,0
12,427,427,56,10,46,3,2
4,450,450,23,23,0,1,0
18,451,451,100,78,22,4,3
36,452,452,17,17,0,1,0
2,460,460,86,47,39,4,3
10,461,461,141,78,63,4,3
25,499,499,4,4,0,1,0
9,500,500,69,43,26,3,2

1,111,111,14,8,6,3,2
8,117,117,8,5,3,2,1
14,121,121,22,15,7,2,1
18,149,149,5,5,0,1,0
27,153,153,5,5,0,1,0
19,157,157,20,10,10,2,1
22,158,158,1,1,0,1,0
12,161,161,33,17,16,2,1
7,167,167,19,19,0,1,0
38,178,178,2,2,0,1,0
43,216,216,11,11,0,1,0
17,222,222,31,19,12,4,3
5,243,243,10,10,0,1,0
13,243,243,1,1,0,1,0
0,250,250,2,2,0,1,0
42,263,263,36,36,0,1,0
41,266,266,38,38,0,1,0
26,267,267,13,13,0,1,0
16,275,275,11,11,0,1,0
33,280,280,58,10,48,4,3
36,290,290,98,16,82,3,2
28,290,290,17,11,6,2,1
25,309,309,10,10,0,1,0
31,312,312,12,12,0,1,0
24,315,315,27,24,3,2,1
37,325,325,57,57,0,1,0
35,336,336,43,27,16,2,1
15,338,338,6,6,0,1,0
39,341,341,1,1,0,1,0
23,341,341,8,2,6,3,2
29,343,343,1,1,0,1,0
2,357,357,33,33,0,1,0
46,358,358,19,10,9,4,3
3,358,358,14,14,0,1,0
47,360,360,51,51,0,1,0
6,394,394,10,3,7,2,1
4,394,394,30,18,12,4,3
30,408,408,19,5,14,2,1
44,417,417,32,32,0,1,0
10,424,424,67,67,0,1,0
20,425,425,47,17,30,2,1
32,441,441,19,3,16,2,1
9,449,449,2,2,0,1,0
21,451,451,63,63,0,1,0
11,475,475,9,9,0,1,0
45,486,486,25,11,14,3,2
40,493,493,141,103,38,2,1
34,496,496,22,22,0,1,0

27,124,124,4,4,0,1,0
6,126,126,21,3,18,3,2
22,134,134,14,8,6,2,1
28,141,141,2,2,0,1,0
36,143,143,23,14,9,4,3
4,164,164,5,5,0,1,0
11,171,171,9,3,6,2,1
17,173,173,46,46,0,1,0
5,180,180,1,1,0,1,0
26,182,182,19,5,14,3,2
34,197,197,11,5,6,3,2
21,200,200,4,4,0,1,0
25,208,208,60,28,32,3,2
3,220,220,6,2,4,2,1
9,239,239,44,4,40,3,2
14,244,244,22,16,6,2,1
2,251,251,44,28,16,3,2
0,257,257,15,15,0,1,0
19,263,263,70,54,16,2,1
1,276,276,106,106,0,1,0
16,282,282,3,3,0,1,0
37,310,310,22,12,10,3,2
31,339,339,61,5,56,4,3
29,349,349,10,2,8,3,2
7,350,350,42,42,0,1,0
8,387,387,17,17,0,1,0
32,393,393,25,15,10,2,1
20,393,393,22,4,18,2,1
24,397,397,77,77,0,1,0
35,412,412,10,1,9,4,3
30,417,417,10,10,0,1,0
10,439,439,9,2,7,2,1
15,441,441,1,1,0,1,0
23,448,448,21,17,4,2,1
33,451,451,44,44,0,1,0
13,455,455,56,56,0,1,0
12,476,476,116,94,22,4,3
18,489,489,108,48,60,3,2

13,102,102,3,3,0,1,0
26,106,106,22,7,15,2,1
9,116,116,9,1,8,2,1
21,119,119,5,5,0,1,0
24,126,126,15,12,3,2,1
19,132,132,24,24,0,1,0
3,135,135,22,22,0,1,0
17,149,149,17,17,0,1,0
12,161,161,13,5,8,3,2
28,181,181,25,25,0,1,0
37,184,184,37,10,27,2,1
6,199,199,16,16,0,1,0
20,216,216,14,4,10,3,2
23,238,238,8,8,0,1,0
36,262,262,4,4,0,1,0
30,263,263,7,7,0,1,0
18,271,271,42,42,0,1,0
35,272,272,14,14,0,1,0
33,281,281,21,21,0,1,0
8,283,283,23,8,15,4,3
15,291,291,54,30,24,4,3
32,310,310,42,8,34,4,3
7,312,312,26,2,24,2,1
16,315,315,41,10,31,2,1
22,326,326,12,12,0,1,0
27,331,331,1,1,0,1,0
25,333,333,48,30,18,3,2
38,343,343,100,100,0,1,0
5,351,351,3,3,0,1,0
14,364,364,17,3,14,2,1
4,374,374,55,55,0,1,0
34,375,375,27,3,24,3,2
31,383,383,100,100,0,1,0
10,385,385,28,28,0,1,0
1,412,412,67,67,0,1,0
0,427,427,46,30,16,2,1
29,443,443,10,10,0,1,0
39,452,452,48,24,24,3,2
11,455,455,11,11,0,1,0
2,488,488,34,34,0,1,0

13,110,110,8,8,0,1,0
2,111,111,19,19,0,1,0
32,113,113,23,23,0,1,0
10,119,119,40,40,0,1,0
9,120,120,18,6,12,4,3
34,176,176,9,9,0,1,0
31,187,187,68,38,30,2,1
33,189,189,21,21,0,1,0
5,195,195,4,4,0,1,0
27,200,200,20,2,18,2,1
8,204,204,43,30,13,2,1
30,216,216,22,22,0,1,0
21,218,218,2,2,0,1,0
28,221,221,2,2,0,1,0
7,270,270,1,1,0,1,0
22,274,274,26,15,11,2,1
15,285,285,3,3,0,1,0
0,285,285,117,117,0,1,0
25,287,287,6,6,0,1,0
16,292,292,27,21,6,2,1
3,293,293,11,7,4,2,1
20,295,295,3,3,0,1,0
12,299,299,31,11,20,4,3
18,308,308,38,29,9,2,1
11,319,319,27,27,0,1,0
23,342,342,4,4,0,1,0
26,370,370,92,14,78,3,2
1,383,383,9,3,6,2,1
24,388,388,44,44,0,1,0
19,390,390,96,96,0,1,0
14,408,408,56,56,0,1,0
6,427,427,93,6,87,4,3
17,449,449,41,9,32,3,2
29,453,453,19,19,0,1,0
4,498,498,10,10,0,1,0

0,109,109,5,5,0,1,0
2,116,116,5,2,3,2,1
25,122,122,23,23,0,1,0
34,131,131,3,3,0,1,0
37,133,133,46,46,0,1,0
5,150,150,2,2,0,1,0
31,151,151,4,4,0,1,0
35,153,153,30,17,13,2,1
7,165,165,1,1,0,1,0
27,168,168,10,10,0,1,0
17,174,174,19,5,14,3,2
20,176,176,13,7,6,3,2
28,216,216,24,13,11,2,1
15,220,220,26,4,22,3,2
40,224,224,22,14,8,2,1
19,236,236,4,4,0,1,0
39,239,239,2,2,0,1,0
16,245,245,5,5,0,1,0
29,254,254,38,38,0,1,0
3,256,256,52,52,0,1,0
41,273,273,5,5,0,1,0
38,274,274,42,1,41,4,3
23,278,278,13,13,0,1,0
8,284,284,18,12,6,2,1
21,300,300,11,11,0,1,0
26,301,301,49,31,18,4,3
42,304,304,30,6,24,3,2
33,306,306,5,5,0,1,0
12,313,313,10,2,8,2,1
13,336,336,51,51,0,1,0
24,342,342,39,33,6,3,2
4,351,351,22,22,0,1,0
1,362,362,17,17,0,1,0
6,363,363,165,165,0,1,0
22,384,384,10,10,0,1,0
30,390,390,27,27,0,1,0
36,394,394,41,41,0,1,0
18,415,415,2,2,0,1,0
32,418,418,23,23,0,1,0
11,427,427,59,40,19,2,1
14,438,438,45,45,0,1,0
9,459,459,35,26,9,2,1
10,491,491,76,76,0,1,0

31,111,111,6,6,0,1,0
32,117,117,12,7,5,2,1
39,121,121,3,3,0,1,0
49,123,123,6,2,4,2,1
9,135,135,2,2,0,1,0
26,136,136,11,4,7,2,1
35,137,137,25,25,0,1,0
4,144,144,11,11,0,1,0
38,146,146,11,11,0,1,0
8,161,161,36,36,0,1,0
46,166,166,15,2,13,3,2
15,167,167,2,2,0,1,0
50,183,183,23,12,11,2,1
45,184,184,9,9,0,1,0
41,190,190,87,87,0,1,0
27,195,195,1,1,0,1,0
25,211,211,1,1,0,1,0
5,214,214,4,4,0,1,0
11,215,215,27,27,0,1,0
18,220,220,1,1,0,1,0
13,221,221,54,54,0,1,0
36,229,229,10,10,0,1,0
22,233,233,5,5,0,1,0
47,257,257,13,4,9,4,3
28,272,272,4,4,0,1,0
34,274,274,21,7,14,2,1
10,275,275,1,1,0,1,0
42,276,276,49,49,0,1,0
33,278,278,26,5,21,4,3
17,281,281,8,8,0,1,0
44,298,298,7,7,0,1,0
2,301,301,80,80,0,1,0
48,305,305,52,52,0,1,0
19,323,323,30,4,26,2,1
3,346,346,33,7,26,3,2
30,374,374,22,17,5,2,1
37,394,394,6,6,0,1,0
7,399,399,22,22,0,1,0
29,401,401,10,1,9,2,1
20,403,403,24,8,16,2,1
14,414,414,56,56,0,1,0
12,417,417,14,14,0,1,0
23,422,422,4,4,0,1,0
16,426,426,11,11,0,1,0
40,446,446,55,55,0,1,0
21,453,453,65,5,60,3,2
0,455,455,12,12,0,1,0
6,476,476,9,9,0,1,0
24,485,485,26,6,20,3,2
43,492,492,34,2,32,4,3
1,492,492,12,2,10,2,1

12,101,101,6,6,0,1,0
11,114,114,3,3,0,1,0
8,119,119,12,12,0,1,0
35,120,120,10,10,0,1,0
31,128,128,14,14,0,1,0
30,177,177,23,23,0,1,0
3,180,180,16,16,0,1,0
40,183,183,6,6,0,1,0
6,242,242,9,9,0,1,0
1,252,252,26,26,0,1,0
27,255,255,43,43,0,1,0
13,257,257,4,4,0,1,0
21,266,266,5,2,3,2,1
5,268,268,1,1,0,1,0
10,270,270,27,27,0,1,0
39,277,277,51,33,18,3,2
41,291,291,36,27,9,2,1
19,294,294,10,3,7,2,1
36,300,300,19,9,10,2,1
17,318,318,1,1,0,1,0
34,319,319,50,29,21,4,3
23,321,321,39,10,29,2,1
16,343,343,8,8,0,1,0
14,346,346,57,57,0,1,0
33,346,346,59,59,0,1,0
22,357,357,38,14,24,4,3
32,376,376,2,2,0,1,0
25,377,377,74,51,23,4,3
7,377,377,32,26,6,3,2
38,395,395,64,49,15,3,2
15,412,412,16,16,0,1,0
0,413,413,84,64,20,2,1
18,419,419,14,9,5,2,1
37,435,435,24,24,0,1,0
28,439,439,12,2,10,2,1
29,447,447,12,12,0,1,0
26,455,455,4,4,0,1,0
4,458,458,167,53,114,4,3
24,461,461,45,45,0,1,0
9,493,493,17,17,0,1,0
2,494,494,76,70,6,2,1
20,495,495,153,141,12,3,2

22,115,115,2,2,0,1,0
1,128,128,1,1,0,1,0
12,143,143,11,11,0,1,0
17,148,148,5,2,3,2,1
25,154,154,16,9,7,2,1
38,164,164,25,25,0,1,0
47,175,175,2,2,0,1,0
33,186,186,3,3,0,1,0
35,188,188,95,17,78,4,3
5,194,194,1,1,0,1,0
6,194,194,4,4,0,1,0
41,198,198,6,3,3,2,1
8,203,203,10,10,0,1,0
24,214,214,2,2,0,1,0
4,228,228,2,2,0,1,0
2,260,260,42,2,40,2,1
11,262,262,6,6,0,1,0
27,265,265,40,40,0,1,0
40,267,267,59,21,38,3,2
32,278,278,22,22,0,1,0
23,289,289,21,21,0,1,0
7,304,304,80,65,15,4,3
39,310,310,57,57,0,1,0
9,318,318,36,36,0,1,0
3,337,337,38,38,0,1,0
46,361,361,9,9,0,1,0
0,368,368,13,7,6,2,1
44,375,375,50,50,0,1,0
36,377,377,56,56,0,1,0
14,384,384,9,3,6,2,1
42,385,385,5,5,0,1,0
29,387,387,12,3,9,2,1
26,389,389,4,4,0,1,0
28,389,389,8,1,7,2,1
18,395,395,3,3,0,1,0
31,396,396,3,3,0,1,0
19,407,407,5,5,0,1,0
10,407,407,62,62,0,1,0
21,408,408,19,9,10,2,1
37,414,414,31,31,0,1,0
15,434,434,5,2,3,2,1
43,446,446,14,7,7,3,2
30,453,453,92,43,49,2,1
13,458,458,15,7,8,2,1
45,474,474,29,29,0,1,0
20,476,476,57,22,35,2,1
34,482,482,39,9,30,2,1
16,495,495,159,96,63,4,3

18,105,105,14,14,0,1,0
13,121,121,3,3,0,1,0
30,126,126,24,24,0,1,0
29,147,147,4,4,0,1,0
22,151,151,8,4,4,2,1
11,155,155,40,40,0,1,0
40,174,174,47,47,0,1,0
4,181,181,6,6,0,1,0
26,185,185,1,1,0,1,0
36,191,191,32,20,12,4,3
20,195,195,6,6,0,1,0
9,197,197,29,29,0,1,0
19,205,205,2,2,0,1,0
34,209,209,16,16,0,1,0
32,211,211,3,3,0,1,0
27,216,216,9,9,0,1,0
1,249,249,56,56,0,1,0
5,254,254,101,85,16,2,1
12,260,260,28,28,0,1,0
31,267,267,16,16,0,1,0
25,293,293,13,13,0,1,0
0,304,304,17,17,0,1,0
38,314,314,14,14,0,1,0
14,314,314,67,23,44,3,2
21,315,315,43,11,32,3,2
7,357,357,19,9,10,2,1
35,364,364,2,2,0,1,0
3,384,384,17,5,12,3,2
37,385,385,37,37,0,1,0
24,385,385,15,4,11,2,1
16,401,401,4,4,0,1,0
15,404,404,23,7,16,2,1
6,413,413,45,23,22,3,2
10,418,418,19,19,0,1,0
33,425,425,79,56,23,2,1
2,429,429,6,6,0,1,0
17,431,431,7,7,0,1,0
39,445,445,58,58,0,1,0
28,457,457,205,105,100,4,3
8,479,479,7,7,0,1,0
23,487,487,12,12,0,1,0

32,116,116,3,3,0,1,0
13,133,133,42,35,7,2,1
36,139,139,18,18,0,1,0
33,142,142,52,52,0,1,0
5,168,168,18,3,15,4,3
12,173,173,13,3,10,2,1
8,175,175,24,24,0,1,0
31,187,187,28,24,4,2,1
0,194,194,2,2,0,1,0
28,195,195,1,1,0,1,0
24,212,212,1,1,0,1,0
14,230,230,17,12,5,2,1
15,242,242,47,47,0,1,0
20,242,242,53,38,15,2,1
1,251,251,13,4,9,4,3
9,268,268,38,3,35,2,1
19,275,275,8,8,0,1,0
23,277,277,43,34,9,4,3
29,286,286,5,5,0,1,0
18,304,304,23,23,0,1,0
25,319,319,36,28,8,2,1
10,339,339,67,52,15,2,1
11,345,345,11,8,3,2,1
4,361,361,27,10,17,3,2
35,382,382,47,47,0,1,0
6,395,395,12,2,10,3,2
17,402,402,2,2,0,1,0
30,412,412,5,2,3,2,1
22,424,424,47,47,0,1,0
21,435,435,10,2,8,3,2
26,437,437,77,68,9,4,3
3,447,447,59,59,0,1,0
2,451,451,53,53,0,1,0
7,455,455,116,39,77,4,3
37,460,460,55,55,0,1,0
16,473,473,24,24,0,1,0
27,474,474,76,76,0,1,0
34,495,495,8,8,0,1,0

5,134,134,4,4,0,1,0
24,151,151,34,9,25,2,1
17,156,156,34,34,0,1,0
13,159,159,1,1,0,1,0
38,162,162,42,32,10,3,2
14,163,163,9,9,0,1,0
34,180,180,9,9,0,1,0
33,186,186,11,1,10,2,1
4,191,191,1,1,0,1,0
8,193,193,12,12,0,1,0
12,196,196,25,25,0,1,0
32,213,213,3,3,0,1,0
9,228,228,8,8,0,1,0
0,233,233,64,38,26,2,1
27,236,236,34,34,0,1,0
19,243,243,27,8,19,2,1
20,250,250,3,3,0,1,0
6,264,264,42,42,0,1,0
31,270,270,36,36,0,1,0
30,278,278,38,6,32,3,2
36,278,278,48,48,0,1,0
29,298,298,2,2,0,1,0
23,305,305,29,29,0,1,0
28,341,341,21,21,0,1,0
37,347,347,26,26,0,1,0
21,362,362,1,1,0,1,0
39,365,365,169,138,31,4,3
7,371,371,11,11,0,1,0
25,380,380,11,11,0,1,0
1,388,388,57,57,0,1,0
2,399,399,39,6,33,2,1
15,400,400,42,12,30,4,3
18,416,416,99,50,49,4,3
35,422,422,4,1,3,2,1
10,429,429,49,49,0,1,0
16,434,434,32,14,18,3,2
26,458,458,7,1,6,2,1
3,470,470,2,2,0,1,0
11,475,475,52,52,0,1,0
22,482,482,33,33,0,1,0

2,105,105,1,1,0,1,0
11,111,111,2,2,0,1,0
26,113,113,3,3,0,1,0
28,116,116,2,2,0,1,0
5,117,117,2,2,0,1,0
19,148,148,58,16,42,4,3
40,168,168,15,2,13,2,1
36,178,178,8,4,4,2,1
35,179,179,46,46,0,1,0
45,180,180,7,7,0,1,0
10,199,199,19,19,0,1,0
24,216,216,6,6,0,1,0
42,220,220,12,12,0,1,0
23,223,223,15,2,13,4,3
9,241,241,9,9,0,1,0
44,246,246,18,2,16,3,2
41,263,263,22,1,21,4,3
16,269,269,22,4,18,4,3
34,271,271,17,4,13,2,1
15,281,281,37,37,0,1,0
20,286,286,2,2,0,1,0
32,297,297,33,28,5,2,1
14,305,305,60,60,0,1,0
31,324,324,5,5,0,1,0
33,333,333,20,5,15,2,1
18,341,341,5,1,4,2,1
27,348,348,19,4,15,2,1
0,349,349,3,3,0,1,0
3,364,364,35,35,0,1,0
37,364,364,39,9,30,3,2
8,379,379,10,10,0,1,0
13,387,387,8,2,6,2,1
21,389,389,5,5,0,1,0
29,400,400,187,187,0,1,0
43,401,401,100,100,0,1,0
17,413,413,1,1,0,1,0
6,415,415,19,19,0,1,0
7,430,430,13,13,0,1,0
39,435,435,47,32,15,4,3
22,448,448,10,10,0,1,0
38,466,466,44,15,29,4,3
25,469,469,25,12,13,2,1
12,482,482,137,40,97,4,3
1,483,483,66,22,44,2,1
4,485,485,80,62,18,2,1
30,497,497,11,4,7,2,1

2,107,107,14,14,0,1,0
22,118,118,2,2,0,1,0
31,127,127,15,9,6,3,2
38,129,129,7,7,0,1,0
39,132,132,42,42,0,1,0
21,141,141,15,15,0,1,0
28,146,146,3,3,0,1,0
0,153,153,39,39,0,1,0
24,155,155,12,12,0,1,0
36,179,179,20,10,10,3,2
3,201,201,1,1,0,1,0
30,206,206,33,33,0,1,0
23,211,211,59,14,45,2,1
6,212,212,3,3,0,1,0
40,213,213,30,20,10,2,1
34,232,232,22,22,0,1,0
16,236,236,18,18,0,1,0
10,239,239,8,8,0,1,0
32,249,249,57,5,52,3,2
11,283,283,65,65,0,1,0
14,293,293,25,25,0,1,0
12,293,293,3,3,0,1,0
20,296,296,11,11,0,1,0
33,299,299,3,3,0,1,0
26,303,303,8,8,0,1,0
7,328,328,23,4,19,2,1
17,341,341,19,3,16,3,2
9,390,390,10,2,8,2,1
37,404,404,10,10,0,1,0
25,410,410,3,3,0,1,0
27,414,414,9,4,5,2,1
19,417,417,66,20,46,2,1
18,434,434,15,15,0,1,0
8,439,439,17,5,12,2,1
1,445,445,9,2,7,2,1
5,447,447,1,1,0,1,0
35,471,471,7,1,6,2,1
4,471,471,50,50,0,1,0
13,490,490,224,224,0,1,0
29,494,494,105,105,0,1,0
15,500,500,78,4,74,3,2

33,118,118,27,27,0,1,0
6,122,122,37,37,0,1,0
36,134,134,2,2,0,1,0
26,161,161,3,3,0,1,0
29,181,181,23,3,20,3,2
21,182,182,18,4,14,3,2
5,190,190,6,6,0,1,0
1,199,199,30,30,0,1,0
7,201,201,18,18,0,1,0
0,205,205,63,53,10,3,2
19,214,214,12,2,10,3,2
17,231,231,2,2,0,1,0
34,240,240,114,22,92,4,3
30,257,257,3,3,0,1,0
4,271,271,18,1,17,2,1
20,302,302,8,2,6,3,2
16,309,309,49,49,0,1,0
38,310,310,17,17,0,1,0
37,310,310,14,10,4,2,1
14,320,320,4,4,0,1,0
23,323,323,13,13,0,1,0
35,337,337,119,75,44,2,1
24,341,341,40,40,0,1,0
22,357,357,11,2,9,2,1
28,361,361,32,2,30,2,1
10,382,382,5,5,0,1,0
11,382,382,48,48,0,1,0
31,399,399,7,7,0,1,0
12,406,406,67,29,38,2,1
27,420,420,70,70,0,1,0
13,423,423,35,35,0,1,0
15,424,424,69,69,0,1,0
2,448,448,43,10,33,4,3
3,451,451,13,2,11,3,2
9,453,453,76,27,49,2,1
25,484,484,19,19,0,1,0
32,485,485,18,18,0,1,0
18,487,487,9,9,0,1,0
8,496,496,6,1,5,2,1

6,103,103,3,3,0,1,0
14,108,108,4,4,0,1,0
8,111,111,8,4,4,2,1
28,115,115,30,10,20,3,2
30,115,115,6,6,0,1,0
26,121,121,4,4,0,1,0
36,128,128,17,17,0,1,0
2,135,135,29,17,12,4,3
16,136,136,19,7,12,4,3
34,159,159,21,21,0,1,0
4,162,162,2,2,0,1,0
23,166,166,3,3,0,1,0
12,197,197,4,4,0,1,0
15,204,204,22,22,0,1,0
20,204,204,35,16,19,2,1
33,245,245,20,5,15,2,1
31,272,272,9,2,7,2,1
35,273,273,23,23,0,1,0
13,299,299,155,122,33,4,3
24,301,301,13,13,0,1,0
3,319,319,39,39,0,1,0
7,320,320,25,9,16,2,1
25,329,329,39,9,30,3,2
17,345,345,3,3,0,1,0
5,379,379,76,69,7,2,1
10,382,382,16,16,0,1,0
11,383,383,39,39,0,1,0
22,387,387,25,25,0,1,0
21,395,395,38,12,26,4,3
37,395,395,42,2,40,4,3
0,401,401,20,20,0,1,0
29,412,412,114,108,6,3,2
27,428,428,35,4,31,2,1
19,458,458,70,70,0,1,0
1,461,461,1,1,0,1,0
18,467,467,12,6,6,2,1
9,474,474,116,56,60,3,2
32,487,487,44,4,40,4,3

43,116,116,8,8,0,1,0
2,141,141,5,5,0,1,0
39,149,149,54,54,0,1,0
12,161,161,2,2,0,1,0
8,187,187,14,14,0,1,0
40,210,210,19,19,0,1,0
30,216,216,34,9,25,2,1
37,236,236,19,19,0,1,0
27,243,243,18,3,15,4,3
28,246,246,17,8,9,2,1
11,253,253,18,18,0,1,0
10,263,263,14,14,0,1,0
1,269,269,3,3,0,1,0
9,276,276,23,15,8,3,2
35,278,278,46,14,32,2,1
17,283,283,1,1,0,1,0
18,283,283,42,42,0,1,0
26,307,307,48,4,44,3,2
7,311,311,13,13,0,1,0
14,314,314,25,25,0,1,0
24,314,314,8,8,0,1,0
20,316,316,18,2,16,3,2
41,336,336,38,38,0,1,0
22,346,346,121,39,82,3,2
32,365,365,36,33,3,2,1
42,368,368,40,40,0,1,0
29,372,372,26,1,25,4,3
4,387,387,5,5,0,1,0
0,389,389,4,4,0,1,0
6,399,399,39,39,0,1,0
3,408,408,72,72,0,1,0
33,418,418,68,23,45,3,2
13,419,419,3,3,0,1,0
5,428,428,41,25,16,2,1
21,432,432,6,6,0,1,0
15,438,438,74,56,18,3,2
16,443,443,65,31,34,2,1
38,453,453,10,10,0,1,0
31,460,460,24,16,8,3,2
25,465,465,39,16,23,2,1
34,472,472,21,21,0,1,0
23,486,486,87,43,44,3,2
19,490,490,35,35,0,1,0
36,492,492,21,21,0,1,0

3,103,103,5,5,0,1,0
4,117,117,12,3,9,2,1
2,149,149,2,2,0,1,0
1,173,173,1,1,0,1,0
6,173,173,17,17,0,1,0
34,181,181,17,17,0,1,0
39,182,182,2,2,0,1,0
24,186,186,12,12,0,1,0
18,188,188,27,27,0,1,0
5,201,201,10,10,0,1,0
36,201,201,4,4,0,1,0
20,206,206,16,16,0,1,0
21,211,211,1,1,0,1,0
15,223,223,9,1,8,3,2
19,224,224,5,2,3,2,1
11,227,227,11,11,0,1,0
27,232,232,45,21,24,3,2
29,240,240,31,31,0,1,0
26,243,243,16,9,7,2,1
17,250,250,42,42,0,1,0
33,250,250,31,31,0,1,0
43,256,256,37,37,0,1,0
28,272,272,51,51,0,1,0
14,276,276,48,15,33,4,3
30,284,284,9,9,0,1,0
12,288,288,21,9,12,2,1
37,294,294,9,3,6,2,1
35,312,312,70,70,0,1,0
32,317,317,22,22,0,1,0
10,327,327,1,1,0,1,0
31,334,334,74,53,21,2,1
22,343,343,42,14,28,3,2
0,350,350,41,20,21,4,3
40,352,352,12,2,10,3,2
38,354,354,12,12,0,1,0
9,358,358,13,13,0,1,0
25,375,375,5,5,0,1,0
42,401,401,71,46,25,2,1
8,402,402,136,7,129,4,3
23,414,414,11,11,0,1,0
7,422,422,41,18,23,4,3
16,480,480,87,87,0,1,0
13,487,487,4,4,0,1,0
41,488,488,84,44,40,2,1

19,107,107,1,1,0,1,0
7,129,129,15,15,0,1,0
2,146,146,12,12,0,1,0
5,157,157,19,19,0,1,0
40,159,159,7,7,0,1,0
18,164,164,7,7,0,1,0
21,169,169,17,17,0,1,0
28,171,171,9,9,0,1,0
46,174,174,17,17,0,1,0
6,178,178,3,3,0,1,0
3,189,189,2,2,0,1,0
20,194,194,7,7,0,1,0
16,201,201,27,27,0,1,0
43,206,206,11,11,0,1,0
47,209,209,18,9,9,2,1
8,210,210,1,1,0,1,0
37,230,230,18,18,0,1,0
0,231,231,27,18,9,2,1
39,232,232,2,2,0,1,0
12,242,242,2,2,0,1,0
15,260,260,26,26,0,1,0
29,262,262,5,1,4,2,1
11,264,264,63,63,0,1,0
27,272,272,30,30,0,1,0
14,285,285,8,3,5,2,1
33,288,288,7,7,0,1,0
26,313,313,7,7,0,1,0
1,315,315,15,6,9,4,3
4,315,315,11,11,0,1,0
23,317,317,32,32,0,1,0
32,323,323,63,15,48,2,1
17,334,334,22,7,15,2,1
9,356,356,23,13,10,2,1
34,358,358,73,33,40,2,1
45,364,364,28,19,9,4,3
35,369,369,73,73,0,1,0
41,373,373,12,12,0,1,0
24,377,377,3,3,0,1,0
13,396,396,27,18,9,4,3
10,398,398,77,77,0,1,0
36,400,400,23,3,20,2,1
48,408,408,33,9,24,4,3
38,423,423,42,42,0,1,0
44,476,476,39,39,0,1,0
42,478,478,246,246,0,1,0
25,484,484,8,2,6,3,2
30,493,493,22,22,0,1,0
31,498,498,16,16,0,1,0
22,500,500,25,5,20,3,2

3,124,124,1,1,0,1,0
4,144,144,12,6,6,3,2
13,150,150,35,27,8,3,2
34,151,151,9,9,0,1,0
30,156,156,17,1,16,3,2
20,171,171,12,7,5,2,1
14,174,174,21,21,0,1,0
9,175,175,31,28,3,2,1
35,179,179,52,8,44,3,2
26,185,185,9,9,0,1,0
28,217,217,75,9,66,4,3
36,231,231,19,7,12,2,1
21,233,233,26,16,10,2,1
5,236,236,73,28,45,2,1
12,238,238,5,2,3,2,1
32,309,309,25,13,12,3,2
16,318,318,19,6,13,2,1
15,324,324,32,2,30,2,1
31,326,326,2,2,0,1,0
25,337,337,114,89,25,2,1
33,337,337,51,51,0,1,0
24,353,353,7,7,0,1,0
22,356,356,20,20,0,1,0
29,365,365,10,1,9,4,3
8,386,386,1,1,0,1,0
7,393,393,23,13,10,2,1
23,395,395,2,2,0,1,0
11,400,400,45,23,22,3,2
2,400,400,42,31,11,3,2
1,401,401,60,50,10,3,2
19,402,402,11,11,0,1,0
18,410,410,3,3,0,1,0
17,441,441,15,15,0,1,0
6,456,456,144,135,9,4,3
27,471,471,82,7,75,4,3
10,479,479,28,2,26,2,1
0,498,498,44,34,10,2,1

24,106,106,27,21,6,3,2
37,125,125,5,5,0,1,0
15,139,139,10,1,9,3,2
40,157,157,12,12,0,1,0
23,174,174,17,17,0,1,0
17,183,183,1,1,0,1,0
1,193,193,13,13,0,1,0
16,201,201,8,4,4,2,1
30,211,211,17,17,0,1,0
5,224,224,9,9,0,1,0
22,228,228,3,3,0,1,0
29,238,238,11,2,9,2,1
18,251,251,50,50,0,1,0
26,260,260,11,11,0,1,0
9,266,266,20,5,15,3,2
11,284,284,5,5,0,1,0
6,288,288,45,45,0,1,0
38,293,293,48,48,0,1,0
0,313,313,88,44,44,4,3
39,323,323,28,28,0,1,0
20,331,331,65,3,62,3,2
32,337,337,11,6,5,2,1
13,338,338,37,37,0,1,0
31,354,354,65,3,62,3,2
33,373,373,51,51,0,1,0
3,373,373,15,15,0,1,0
10,390,390,1,1,0,1,0
19,403,403,98,14,84,4,3
25,418,418,78,78,0,1,0
36,429,429,23,23,0,1,0
35,464,464,49,5,44,2,1
27,467,467,71,71,0,1,0
12,472,472,32,4,28,3,2
34,474,474,96,58,38,3,2
14,474,474,72,72,0,1,0
21,476,476,14,2,12,3,2
2,476,476,19,2,17,2,1
28,481,481,26,8,18,4,3
7,496,496,17,7,10,2,1
8,499,499,1,1,0,1,0
4,500,500,80,80,0,1,0

21,107,107,17,12,5,2,1
33,111,111,29,1,28,2,1
26,137,137,5,5,0,1,0
39,139,139,30,6,24,3,2
4,156,156,5,5,0,1,0
35,174,174,17,17,0,1,0
13,177,177,5,5,0,1,0
20,181,181,8,8,0,1,0
15,182,182,165,165,0,1,0
30,188,188,34,12,22,4,3
9,207,207,7,1,6,3,2
38,234,234,19,7,12,4,3
3,270,270,73,73,0,1,0
27,279,279,72,27,45,4,3
18,289,289,22,22,0,1,0
10,293,293,18,18,0,1,0
7,297,297,9,9,0,1,0
14,297,297,37,17,20,3,2
1,309,309,7,7,0,1,0
36,347,347,1,1,0,1,0
37,352,352,18,18,0,1,0
17,352,352,26,20,6,3,2
16,354,354,1,1,0,1,0
6,361,361,37,4,33,2,1
28,362,362,84,84,0,1,0
2,385,385,6,6,0,1,0
24,385,385,4,4,0,1,0
31,385,385,29,29,0,1,0
11,387,387,20,8,12,2,1
25,402,402,10,10,0,1,0
32,415,415,27,27,0,1,0
5,415,415,1,1,0,1,0
12,418,418,24,24,0,1,0
8,418,418,1,1,0,1,0
29,436,436,17,17,0,1,0
0,442,442,41,41,0,1,0
34,443,443,51,15,36,4,3
23,445,445,3,3,0,1,0
22,447,447,39,9,30,3,2
19,465,465,6,6,0,1,0

36,104,104,10,10,0,1,0
18,104,104,1,1,0,1,0
4,107,107,1,1,0,1,0
6,125,125,21,21,0,1,0
30,125,125,1,1,0,1,0
40,134,134,31,15,16,3,2
39,158,158,36,36,0,1,0
20,163,163,17,17,0,1,0
37,197,197,2,2,0,1,0
14,201,201,12,12,0,1,0
33,212,212,43,6,37,2,1
22,247,247,3,3,0,1,0
16,257,257,3,3,0,1,0
3,261,261,16,16,0,1,0
29,265,265,72,72,0,1,0
1,273,273,39,6,33,2,1
2,283,283,12,5,7,2,1
12,291,291,51,51,0,1,0
28,292,292,13,13,0,1,0
9,292,292,12,4,8,3,2
15,295,295,2,2,0,1,0
32,302,302,24,24,0,1,0
26,306,306,38,1,37,2,1
17,306,306,7,7,0,1,0
31,315,315,13,2,11,2,1
5,338,338,92,66,26,4,3
34,341,341,33,6,27,2,1
7,344,344,30,30,0,1,0
35,378,378,5,5,0,1,0
25,390,390,51,33,18,4,3
10,403,403,65,32,33,2,1
38,409,409,91,25,66,3,2
23,417,417,15,4,11,4,3
27,433,433,28,28,0,1,0
11,448,448,1,1,0,1,0
13,466,466,3,3,0,1,0
19,484,484,38,14,24,3,2
21,486,486,30,30,0,1,0
8,488,488,253,253,0,1,0
24,489,489,34,34,0,1,0
0,498,498,10,5,5,2,1

5,107,107,15,15,0,1,0
39,114,114,9,9,0,1,0
36,126,126,2,2,0,1,0
27,138,138,1,1,0,1,0
12,142,142,1,1,0,1,0
28,142,142,19,19,0,1,0
41,146,146,2,2,0,1,0
19,162,162,22,22,0,1,0
26,167,167,9,3,6,2,1
6,172,172,1,1,0,1,0
47,173,173,5,2,3,2,1
46,188,188,1,1,0,1,0
52,196,196,61,61,0,1,0
37,200,200,1,1,0,1,0
33,205,205,1,1,0,1,0
45,208,208,130,28,102,4,3
30,210,210,10,10,0,1,0
43,216,216,9,9,0,1,0
14,217,217,8,8,0,1,0
3,221,221,4,4,0,1,0
1,225,225,1,1,0,1,0
22,255,255,16,16,0,1,0
31,259,259,5,5,0,1,0
48,275,275,59,54,5,2,1
51,281,281,8,8,0,1,0
38,284,284,93,45,48,4,3
9,295,295,61,61,0,1,0
24,327,327,31,31,0,1,0
4,332,332,3,3,0,1,0
17,333,333,5,2,3,2,1
44,336,336,4,4,0,1,0
18,343,343,8,1,7,2,1
7,346,346,8,2,6,2,1
32,353,353,34,34,0,1,0
20,355,355,10,3,7,2,1
42,355,355,3,3,0,1,0
35,389,389,13,1,12,3,2
25,403,403,31,31,0,1,0
40,411,411,23,14,9,2,1
8,419,419,10,1,9,4,3
29,424,424,2,2,0,1,0
11,446,446,8,8,0,1,0
2,451,451,34,34,0,1,0
13,456,456,12,12,0,1,0
23,468,468,31,13,18,2,1
0,468,468,60,60,0,1,0
21,473,473,40,12,28,3,2
10,477,477,33,33,0,1,0
49,478,478,9,2,7,2,1
50,484,484,57,57,0,1,0
15,485,485,102,58,44,3,2
16,488,488,24,15,9,4,3
34,494,494,47,17,30,4,3

32,104,104,16,16,0,1,0
37,133,133,11,11,0,1,0
7,155,155,19,19,0,1,0
19,156,156,4,4,0,1,0
18,168,168,7,2,5,2,1
5,185,185,3,3,0,1,0
39,188,188,10,10,0,1,0
35,196,196,34,26,8,3,2
8,197,197,29,29,0,1,0
25,219,219,42,42,0,1,0
28,234,234,15,10,5,2,1
4,253,253,20,20,0,1,0
21,271,271,36,3,33,2,1
11,273,273,33,12,21,4,3
2,286,286,82,28,54,4,3
36,296,296,6,6,0,1,0
33,307,307,15,5,10,2,1
12,309,309,24,24,0,1,0
9,312,312,67,67,0,1,0
26,319,319,10,10,0,1,0
1,332,332,74,59,15,4,3
14,341,341,21,8,13,4,3
38,347,347,2,2,0,1,0
29,374,374,8,5,3,2,1
27,374,374,22,4,18,4,3
20,377,377,13,4,9,4,3
3,379,379,42,24,18,4,3
16,383,383,28,28,0,1,0
30,391,391,38,38,0,1,0
22,396,396,151,49,102,4,3
24,420,420,137,137,0,1,0
17,428,428,8,8,0,1,0
10,447,447,53,33,20,2,1
34,450,450,23,5,18,2,1
13,455,455,51,51,0,1,0
0,455,455,43,43,0,1,0
31,479,479,39,39,0,1,0
23,490,490,15,9,6,2,1
6,494,494,1,1,0,1,0
15,495,495,28,18,10,2,1

39,106,106,8,8,0,1,0
36,115,115,9,9,0,1,0
19,120,120,9,9,0,1,0
6,120,120,10,10,0,1,0
29,130,130,1,1,0,1,0
38,130,130,10,10,0,1,0
2,136,136,13,1,12,2,1
32,141,141,14,8,6,2,1
22,144,144,3,3,0,1,0
16,168,168,7,1,6,3,2
9,171,171,5,5,0,1,0
30,209,209,16,16,0,1,0
33,222,222,2,2,0,1,0
8,241,241,48,28,20,3,2
21,248,248,2,2,0,1,0
5,250,250,5,5,0,1,0
3,254,254,1,1,0,1,0
7,254,254,4,4,0,1,0
11,264,264,17,3,14,2,1
40,265,265,42,18,24,3,2
18,274,274,23,23,0,1,0
35,284,284,26,12,14,3,2
14,295,295,10,10,0,1,0
25,319,319,11,7,4,2,1
34,328,328,6,6,0,1,0
37,332,332,53,53,0,1,0
41,345,345,124,22,102,4,3
10,352,352,16,16,0,1,0
24,353,353,95,95,0,1,0
12,366,366,69,24,45,4,3
31,372,372,65,65,0,1,0
13,383,383,147,66,81,4,3
27,384,384,3,3,0,1,0
15,389,389,9,4,5,2,1
1,413,413,29,29,0,1,0
0,416,416,5,2,3,2,1
20,448,448,3,3,0,1,0
28,457,457,16,1,15,4,3
23,468,468,110,110,0,1,0
4,495,495,17,17,0,1,0
17,496,496,240,154,86,4,3
26,499,499,28,10,18,4,3

20,116,116,7,1,6,3,2
7,129,129,39,3,36,3,2
26,131,131,17,11,6,3,2
8,136,136,18,18,0,1,0
22,139,139,9,9,0,1,0
25,170,170,6,1,5,2,1
5,183,183,41,21,20,3,2
3,197,197,42,42,0,1,0
29,203,203,27,3,24,3,2
17,232,232,32,13,19,2,1
11,249,249,13,13,0,1,0
24,250,250,10,4,6,2,1
0,254,254,48,17,31,4,3
15,269,269,38,6,32,3,2
10,296,296,35,35,0,1,0
23,300,300,5,1,4,2,1
19,315,315,25,2,23,3,2
1,323,323,32,32,0,1,0
2,338,338,156,147,9,4,3
14,343,343,2,2,0,1,0
6,348,348,82,8,74,3,2
28,354,354,74,74,0,1,0
27,380,380,30,30,0,1,0
16,388,388,83,83,0,1,0
30,400,400,62,35,27,2,1
12,416,416,2,2,0,1,0
4,449,449,5,5,0,1,0
18,455,455,59,15,44,2,1
13,461,461,43,43,0,1,0
21,470,470,120,120,0,1,0
9,484,484,7,7,0,1,0

2,103,103,15,7,8,3,2
33,108,108,13,10,3,2,1
3,120,120,2,2,0,1,0
19,143,143,21,15,6,2,1
4,149,149,36,6,30,2,1
46,160,160,4,4,0,1,0
12,162,162,14,14,0,1,0
30,193,193,24,6,18,3,2
18,195,195,3,3,0,1,0
11,198,198,2,2,0,1,0
28,203,203,90,31,59,4,3
40,204,204,14,14,0,1,0
26,209,209,11,2,9,2,1
34,228,228,7,1,6,2,1
13,229,229,2,2,0,1,0
43,230,230,28,24,4,2,1
25,234,234,14,4,10,3,2
22,235,235,9,3,6,3,2
38,262,262,18,18,0,1,0
5,269,269,14,2,12,4,3
32,297,297,5,2,3,2,1
27,303,303,26,7,19,2,1
35,318,318,18,18,0,1,0
29,332,332,38,38,0,1,0
24,348,348,38,38,0,1,0
39,351,351,58,21,37,2,1
44,353,353,3,3,0,1,0
8,365,365,14,14,0,1,0
1,366,366,69,6,63,4,3
14,367,367,1,1,0,1,0
0,369,369,6,6,0,1,0
9,375,375,57,3,54,3,2
42,379,379,2,2,0,1,0
37,387,387,14,2,12,4,3
23,391,391,52,12,40,3,2
36,392,392,72,20,52,4,3
21,394,394,1,1,0,1,0
7,399,399,6,6,0,1,0
17,404,404,4,4,0,1,0
15,411,411,60,60,0,1,0
31,441,441,6,6,0,1,0
10,449,449,25,25,0,1,0
45,460,460,37,18,19,2,1
6,465,465,12,4,8,2,1
41,482,482,133,133,0,1,0
20,488,488,3,3,0,1,0
16,489,489,110,44,66,3,2

3,101,101,17,17,0,1,0
22,110,110,7,7,0,1,0
13,125,125,5,1,4,2,1
6,146,146,15,15,0,1,0
32,165,165,8,8,0,1,0
12,176,176,1,1,0,1,0
14,178,178,27,10,17,2,1
28,184,184,28,19,9,3,2
2,206,206,1,1,0,1,0
20,224,224,50,50,0,1,0
38,233,233,60,50,10,3,2
1,260,260,49,49,0,1,0
16,262,262,49,25,24,2,1
11,264,264,1,1,0,1,0
29,274,274,15,15,0,1,0
26,274,274,26,15,11,3,2
23,290,290,48,20,28,3,2
19,295,295,76,56,20,3,2
25,301,301,4,4,0,1,0
18,302,302,8,1,7,2,1
24,303,303,4,4,0,1,0
21,306,306,45,45,0,1,0
39,323,323,71,71,0,1,0
15,330,330,2,2,0,1,0
30,340,340,48,38,10,2,1
27,341,341,3,3,0,1,0
35,374,374,55,27,28,3,2
7,377,377,1,1,0,1,0
9,393,393,1,1,0,1,0
37,398,398,32,3,29,2,1
40,404,404,7,1,6,2,1
36,406,406,38,38,0,1,0
31,409,409,36,10,26,3,2
4,434,434,29,29,0,1,0
0,439,439,34,20,14,2,1
10,450,450,42,27,15,2,1
34,459,459,20,20,0,1,0
41,467,467,156,54,102,4,3
33,478,478,2,2,0,1,0
8,487,487,19,6,13,2,1
5,495,495,97,97,0,1,0
17,497,497,5,5,0,1,0

4,117,117,12,12,0,1,0
13,125,125,8,8,0,1,0
17,126,126,6,6,0,1,0
6,127,127,1,1,0,1,0
20,134,134,36,9,27,4,3
23,140,140,7,7,0,1,0
8,151,151,15,7,8,2,1
38,161,161,21,15,6,3,2
36,161,161,6,2,4,2,1
3,163,163,54,42,12,4,3
25,172,172,18,9,9,2,1
33,176,176,21,9,12,3,2
32,182,182,8,8,0,1,0
37,202,202,3,3,0,1,0
35,212,212,22,22,0,1,0
31,212,212,20,20,0,1,0
28,235,235,48,30,18,3,2
34,242,242,17,1,16,2,1
11,252,252,21,21,0,1,0
21,282,282,32,11,21,4,3
27,289,289,7,4,3,2,1
12,291,291,17,17,0,1,0
26,294,294,20,7,13,2,1
30,296,296,4,4,0,1,0
24,313,313,8,4,4,2,1
19,352,352,123,123,0,1,0
1,355,355,52,8,44,2,1
0,358,358,45,11,34,3,2
29,364,364,12,12,0,1,0
15,377,377,77,77,0,1,0
18,377,377,11,11,0,1,0
22,385,385,70,47,23,2,1
7,394,394,2,2,0,1,0
2,397,397,36,10,26,3,2
16,442,442,119,44,75,4,3
14,454,454,100,28,72,4,3
5,464,464,23,23,0,1,0
9,472,472,22,22,0,1,0
10,472,472,9,1,8,3,2

21,108,108,8,8,0,1,0
13,126,126,19,3,16,3,2
18,131,131,64,64,0,1,0
26,155,155,5,5,0,1,0
6,181,181,24,1,23,2,1
25,181,181,8,5,3,2,1
28,213,213,41,41,0,1,0
30,234,234,18,11,7,2,1
19,236,236,22,12,10,2,1
4,253,253,36,1,35,2,1
32,267,267,8,1,7,2,1
10,270,270,96,96,0,1,0
0,277,277,46,46,0,1,0
33,278,278,14,14,0,1,0
2,285,285,1,1,0,1,0
11,288,288,1,1,0,1,0
16,295,295,4,4,0,1,0
7,307,307,24,24,0,1,0
17,311,311,96,69,27,2,1
27,329,329,3,3,0,1,0
8,379,379,11,6,5,2,1
31,400,400,32,32,0,1,0
29,425,425,38,38,0,1,0
23,427,427,16,12,4,2,1
22,431,431,20,4,16,2,1
15,440,440,26,19,7,2,1
12,441,441,195,180,15,4,3
5,450,450,5,1,4,2,1
1,453,453,101,101,0,1,0
24,463,463,41,34,7,2,1
3,469,469,5,5,0,1,0
20,472,472,19,19,0,1,0
14,481,481,89,47,42,3,2
9,486,486,124,10,114,4,3

8,100,100,22,22,0,1,0
0,104,104,2,2,0,1,0
12,105,105,22,10,12,2,1
23,106,106,10,10,0,1,0
33,108,108,13,13,0,1,0
6,111,111,14,5,9,4,3
4,117,117,1,1,0,1,0
29,123,123,7,7,0,1,0
32,142,142,23,12,11,2,1
15,144,144,6,6,0,1,0
28,160,160,5,5,0,1,0
3,218,218,27,20,7,2,1
2,234,234,92,46,46,4,3
22,237,237,13,5,8,3,2
19,265,265,21,2,19,2,1
7,265,265,6,2,4,2,1
25,272,272,21,18,3,2,1
18,277,277,23,23,0,1,0
26,285,285,34,34,0,1,0
13,292,292,35,22,13,2,1
30,302,302,92,11,81,3,2
10,325,325,4,1,3,2,1
5,328,328,28,28,0,1,0
11,329,329,61,61,0,1,0
20,340,340,17,17,0,1,0
34,359,359,96,96,0,1,0
9,400,400,133,37,96,3,2
1,400,400,4,4,0,1,0
24,401,401,1,1,0,1,0
16,405,405,1,1,0,1,0
27,443,443,17,14,3,2,1
21,451,451,94,47,47,2,1
17,457,457,23,23,0,1,0
31,459,459,90,24,66,4,3
14,498,498,66,66,0,1,0

31,113,113,16,1,15,2,1
4,118,118,1,1,0,1,0
19,138,138,26,26,0,1,0
8,151,151,32,6,26,2,1
33,151,151,5,5,0,1,0
32,156,156,25,5,20,2,1
15,182,182,1,1,0,1,0
1,184,184,4,4,0,1,0
25,230,230,25,4,21,4,3
29,239,239,33,33,0,1,0
24,241,241,12,12,0,1,0
34,244,244,22,22,0,1,0
10,250,250,12,6,6,2,1
18,256,256,9,1,8,2,1
6,261,261,28,28,0,1,0
27,279,279,17,6,11,3,2
16,301,301,5,5,0,1,0
17,331,331,46,20,26,2,1
22,337,337,62,32,30,4,3
12,357,357,60,33,27,4,3
23,378,378,33,26,7,2,1
9,378,378,2,2,0,1,0
26,386,386,7,7,0,1,0
2,393,393,53,53,0,1,0
28,408,408,185,129,56,4,3
5,434,434,158,65,93,4,3
30,447,447,6,6,0,1,0
13,456,456,6,6,0,1,0
14,462,462,10,3,7,2,1
0,472,472,34,34,0,1,0
7,477,477,183,183,0,1,0
11,480,480,76,4,72,4,3
35,488,488,32,6,26,2,1
3,493,493,137,92,45,4,3
21,494,494,27,11,16,3,2
20,498,498,2,2,0,1,0

2,101,101,5,5,0,1,0
42,101,101,26,26,0,1,0
19,110,110,4,4,0,1,0
22,116,116,17,9,8,2,1
43,119,119,55,11,44,4,3
25,129,129,20,20,0,1,0
17,131,131,15,1,14,3,2
27,136,136,9,1,8,2,1
4,142,142,5,5,0,1,0
6,146,146,5,2,3,2,1
13,146,146,2,2,0,1,0
24,149,149,9,2,7,3,2
8,150,150,7,7,0,1,0
30,150,150,3,3,0,1,0
33,169,169,24,24,0,1,0
38,172,172,4,4,0,1,0
31,192,192,2,2,0,1,0
40,197,197,10,10,0,1,0
5,201,201,3,3,0,1,0
11,203,203,1,1,0,1,0
23,205,205,8,8,0,1,0
16,219,219,19,8,11,2,1
32,234,234,5,5,0,1,0
18,237,237,25,21,4,2,1
29,252,252,15,15,0,1,0
9,262,262,11,4,7,2,1
3,292,292,62,2,60,4,3
36,298,298,17,17,0,1,0
35,299,299,19,19,0,1,0
26,308,308,26,6,20,2,1
0,312,312,9,9,0,1,0
20,328,328,73,23,50,4,3
39,336,336,70,16,54,4,3
41,348,348,42,3,39,2,1
21,357,357,43,43,0,1,0
44,362,362,2,2,0,1,0
14,376,376,10,10,0,1,0
10,381,381,81,15,66,4,3
12,407,407,3,3,0,1,0
28,441,441,50,44,6,3,2
7,445,445,61,61,0,1,0
15,445,445,63,63,0,1,0
34,458,458,1,1,0,1,0
1,479,479,30,19,11,2,1
37,499,499,62,11,51,4,3

21,120,120,3,3,0,1,0
33,149,149,21,21,0,1,0
16,150,150,17,17,0,1,0
25,153,153,16,16,0,1,0
13,153,153,20,20,0,1,0
0,162,162,34,34,0,1,0
27,168,168,9,9,0,1,0
6,178,178,9,3,6,2,1
37,191,191,4,4,0,1,0
2,197,197,34,34,0,1,0
32,206,206,31,25,6,3,2
19,225,225,2,2,0,1,0
1,243,243,66,32,34,2,1
31,244,244,32,6,26,2,1
17,246,246,7,7,0,1,0
18,253,253,26,26,0,1,0
20,264,264,2,2,0,1,0
26,264,264,23,16,7,3,2
14,270,270,54,54,0,1,0
40,281,281,11,11,0,1,0
28,290,290,8,8,0,1,0
38,293,293,8,8,0,1,0
23,298,298,49,19,30,4,3
11,306,306,22,14,8,3,2
8,308,308,29,29,0,1,0
39,316,316,69,61,8,2,1
24,322,322,3,3,0,1,0
36,326,326,1,1,0,1,0
15,333,333,77,32,45,4,3
22,336,336,3,3,0,1,0
35,351,351,27,21,6,3,2
9,351,351,11,3,8,2,1
5,358,358,9,6,3,2,1
3,368,368,47,47,0,1,0
7,383,383,23,4,19,2,1
30,394,394,75,36,39,4,3
4,414,414,11,11,0,1,0
29,431,431,75,63,12,4,3
10,447,447,1,1,0,1,0
41,474,474,93,84,9,4,3
34,475,475,100,25,75,4,3
12,486,486,6,6,0,1,0

3,103,103,10,3,7,2,1
20,127,127,23,23,0,1,0
11,156,156,1,1,0,1,0
19,159,159,21,6,15,4,3
8,160,160,24,24,0,1,0
31,164,164,16,16,0,1,0
42,177,177,5,5,0,1,0
14,187,187,37,37,0,1,0
25,195,195,56,36,20,2,1
32,196,196,19,19,0,1,0
29,202,202,19,5,14,2,1
21,220,220,24,24,0,1,0
22,221,221,36,13,23,2,1
9,223,223,11,11,0,1,0
2,235,235,2,2,0,1,0
18,244,244,5,1,4,2,1
38,246,246,20,8,12,4,3
34,246,246,14,11,3,2,1
41,249,249,30,30,0,1,0
1,250,250,2,2,0,1,0
23,254,254,41,11,30,3,2
36,258,258,14,14,0,1,0
40,260,260,72,27,45,3,2
35,265,265,4,4,0,1,0
10,291,291,15,4,11,2,1
24,316,316,11,8,3,2,1
33,340,340,1,1,0,1,0
27,358,358,40,40,0,1,0
16,383,383,14,8,6,2,1
6,386,386,26,26,0,1,0
7,399,399,42,10,32,3,2
4,402,402,20,10,10,2,1
37,405,405,56,24,32,3,2
30,417,417,73,46,27,2,1
13,422,422,40,40,0,1,0
12,423,423,12,7,5,2,1
0,430,430,167,140,27,4,3
26,448,448,85,85,0,1,0
15,451,451,3,3,0,1,0
39,452,452,5,5,0,1,0
28,471,471,2,2,0,1,0
5,479,479,13,2,11,3,2
17,484,484,11,11,0,1,0

17,105,105,10,10,0,1,0
25,108,108,18,18,0,1,0
24,118,118,3,3,0,1,0
20,130,130,4,4,0,1,0
0,134,134,47,47,0,1,0
21,134,134,17,14,3,2,1
12,135,135,2,2,0,1,0
39,174,174,1,1,0,1,0
10,174,174,5,5,0,1,0
27,189,189,27,27,0,1,0
35,191,191,18,18,0,1,0
36,192,192,1,1,0,1,0
37,233,233,34,34,0,1,0
33,245,245,36,36,0,1,0
2,246,246,60,42,18,4,3
5,250,250,25,11,14,2,1
15,254,254,42,20,22,2,1
16,265,265,28,16,12,4,3
8,266,266,32,11,21,4,3
13,284,284,38,14,24,2,1
4,286,286,70,32,38,3,2
28,293,293,3,3,0,1,0
9,302,302,6,6,0,1,0
38,317,317,78,2,76,3,2
22,324,324,3,3,0,1,0
1,331,331,8,8,0,1,0
29,333,333,60,60,0,1,0
30,346,346,136,97,39,4,3
7,361,361,21,1,20,2,1
32,369,369,40,40,0,1,0
23,371,371,21,2,19,2,1
18,411,411,2,2,0,1,0
3,413,413,35,35,0,1,0
19,420,420,2,2,0,1,0
34,438,438,40,40,0,1,0
6,441,441,68,56,12,4,3
11,454,454,18,18,0,1,0
31,466,466,2,2,0,1,0
14,477,477,4,1,3,2,1
26,497,497,30,3,27,2,1

34,102,102,21,21,0,1,0
13,106,106,11,11,0,1,0
37,119,119,4,4,0,1,0
12,121,121,22,8,14,3,2
31,121,121,30,21,9,2,1
24,140,140,18,18,0,1,0
38,142,142,3,3,0,1,0
35,159,159,5,2,3,2,1
36,170,170,1,1,0,1,0
25,173,173,33,33,0,1,0
5,178,178,9,1,8,3,2
11,183,183,27,27,0,1,0
20,193,193,16,2,14,2,1
10,204,204,1,1,0,1,0
26,223,223,10,1,9,2,1
3,255,255,13,1,12,4,3
23,256,256,18,2,16,2,1
19,259,259,19,7,12,2,1
1,268,268,24,24,0,1,0
22,270,270,115,97,18,4,3
2,275,275,40,40,0,1,0
7,301,301,5,1,4,2,1
14,302,302,56,56,0,1,0
15,306,306,4,4,0,1,0
21,311,311,20,6,14,2,1
16,318,318,15,15,0,1,0
33,327,327,28,28,0,1,0
27,334,334,61,5,56,4,3
32,338,338,40,22,18,3,2
40,346,346,9,9,0,1,0
6,347,347,30,13,17,2,1
0,375,375,60,60,0,1,0
29,427,427,24,15,9,4,3
9,429,429,53,53,0,1,0
18,445,445,65,13,52,3,2
28,453,453,20,20,0,1,0
8,464,464,38,38,0,1,0
39,477,477,10,10,0,1,0
4,485,485,12,12,0,1,0
30,488,488,16,9,7,2,1
17,493,493,91,52,39,4,3

17,100,100,7,7,0,1,0
19,111,111,21,1,20,2,1
34,112,112,1,1,0,1,0
21,122,122,5,1,4,2,1
14,123,123,1,1,0,1,0
11,138,138,1,1,0,1,0
18,144,144,21,21,0,1,0
3,168,168,9,9,0,1,0
29,168,168,28,28,0,1,0
9,171,171,3,3,0,1,0
8,180,180,1,1,0,1,0
40,188,188,6,3,3,2,1
24,210,210,10,10,0,1,0
6,214,214,47,47,0,1,0
1,217,217,2,2,0,1,0
35,219,219,38,14,24,4,3
10,220,220,10,10,0,1,0
13,226,226,2,2,0,1,0
36,241,241,26,20,6,3,2
43,241,241,8,3,5,2,1
45,242,242,37,37,0,1,0
20,244,244,26,2,24,3,2
26,250,250,5,2,3,2,1
2,280,280,16,16,0,1,0
32,296,296,87,6,81,3,2
41,296,296,72,72,0,1,0
25,313,313,17,17,0,1,0
22,320,320,35,25,10,2,1
33,338,338,14,14,0,1,0
37,348,348,11,11,0,1,0
5,355,355,84,23,61,3,2
31,356,356,7,7,0,1,0
28,359,359,5,2,3,2,1
15,407,407,27,1,26,3,2
42,411,411,107,29,78,4,3
4,424,424,82,5,77,4,3
23,429,429,26,26,0,1,0
39,431,431,7,7,0,1,0
46,442,442,42,42,0,1,0
44,445,445,30,30,0,1,0
16,447,447,7,7,0,1,0
7,454,454,1,1,0,1,0
38,461,461,93,41,52,4,3
27,465,465,7,7,0,1,0
12,477,477,26,18,8,3,2
0,486,486,77,53,24,3,2
30,487,487,27,15,12,4,3

26,111,111,3,3,0,1,0
36,111,111,3,3,0,1,0
38,115,115,21,21,0,1,0
10,127,127,10,10,0,1,0
27,130,130,5,5,0,1,0
13,138,138,6,6,0,1,0
20,138,138,1,1,0,1,0
25,143,143,7,1,6,3,2
17,148,148,1,1,0,1,0
33,168,168,30,30,0,1,0
2,173,173,16,16,0,1,0
0,179,179,9,1,8,3,2
11,197,197,2,2,0,1,0
34,209,209,10,10,0,1,0
5,232,232,7,7,0,1,0
15,236,236,28,8,20,2,1
3,240,240,114,26,88,3,2
32,253,253,18,3,15,4,3
23,259,259,5,1,4,2,1
18,280,280,38,38,0,1,0
19,280,280,33,33,0,1,0
6,296,296,67,30,37,2,1
30,298,298,3,3,0,1,0
28,299,299,131,92,39,4,3
14,310,310,28,1,27,4,3
8,328,328,14,2,12,3,2
29,330,330,1,1,0,1,0
31,368,368,11,5,6,2,1
37,370,370,2,2,0,1,0
7,380,380,79,79,0,1,0
24,385,385,22,22,0,1,0
21,385,385,80,80,0,1,0
12,391,391,19,5,14,3,2
1,422,422,117,85,32,4,3
4,428,428,7,3,4,2,1
9,430,430,1,1,0,1,0
35,432,432,92,50,42,4,3
16,471,471,23,8,15,4,3
22,480,480,151,139,12,3,2

26,100,100,4,4,0,1,0
16,100,100,10,2,8,3,2
30,101,101,35,23,12,3,2
19,104,104,15,15,0,1,0
8,126,126,11,11,0,1,0
34,126,126,6,6,0,1,0
27,134,134,10,10,0,1,0
15,138,138,9,9,0,1,0
6,164,164,7,7,0,1,0
17,203,203,9,9,0,1,0
33,215,215,1,1,0,1,0
29,218,218,55,4,51,4,3
9,241,241,56,56,0,1,0
21,270,270,36,36,0,1,0
10,285,285,49,29,20,2,1
20,293,293,14,14,0,1,0
28,298,298,20,16,4,2,1
4,302,302,74,74,0,1,0
5,310,310,18,1,17,2,1
0,312,312,57,15,42,2,1
32,350,350,49,49,0,1,0
18,361,361,32,32,0,1,0
22,363,363,12,2,10,2,1
35,379,379,78,78,0,1,0
1,385,385,10,10,0,1,0
23,397,397,7,7,0,1,0
3,404,404,42,42,0,1,0
25,421,421,12,12,0,1,0
11,438,438,138,138,0,1,0
12,442,442,12,12,0,1,0
31,445,445,31,1,30,3,2
7,459,459,11,1,10,3,2
24,460,460,74,74,0,1,0
2,475,475,1,1,0,1,0
13,483,483,99,33,66,3,2
14,499,499,108,45,63,4,3

36,101,101,5,5,0,1,0
16,103,103,53,53,0,1,0
14,106,106,5,2,3,2,1
0,110,110,1,1,0,1,0
32,119,119,54,5,49,2,1
12,123,123,6,6,0,1,0
11,130,130,4,4,0,1,0
10,168,168,1,1,0,1,0
34,172,172,8,8,0,1,0
1,176,176,11,11,0,1,0
21,190,190,18,10,8,3,2
8,199,199,6,6,0,1,0
28,201,201,4,4,0,1,0
27,220,220,4,4,0,1,0
7,230,230,10,2,8,3,2
2,230,230,22,22,0,1,0
3,231,231,3,3,0,1,0
38,235,235,1,1,0,1,0
17,248,248,1,1,0,1,0
15,254,254,5,2,3,2,1
18,274,274,8,8,0,1,0
13,292,292,1,1,0,1,0
44,292,292,9,9,0,1,0
29,294,294,9,9,0,1,0
39,311,311,72,22,50,2,1
24,314,314,22,2,20,3,2
41,326,326,109,109,0,1,0
4,326,326,65,65,0,1,0
42,330,330,5,5,0,1,0
26,361,361,47,47,0,1,0
35,386,386,3,3,0,1,0
5,387,387,18,18,0,1,0
37,389,389,9,9,0,1,0
19,392,392,44,44,0,1,0
30,401,401,19,19,0,1,0
40,425,425,61,61,0,1,0
9,428,428,27,2,25,2,1
31,443,443,37,16,21,4,3
6,445,445,10,10,0,1,0
25,464,464,71,71,0,1,0
43,467,467,51,15,36,3,2
33,473,473,47,47,0,1,0
23,485,485,115,12,103,4,3
20,489,489,52,52,0,1,0
22,495,495,45,27,18,4,3

2,116,116,10,6,4,2,1
27,131,131,15,8,7,2,1
19,143,143,34,34,0,1,0
33,155,155,1,1,0,1,0
6,175,175,45,45,0,1,0
35,187,187,9,9,0,1,0
8,188,188,2,2,0,1,0
12,189,189,45,30,15,2,1
18,198,198,2,2,0,1,0
3,216,216,9,9,0,1,0
24,219,219,45,27,18,2,1
32,223,223,2,2,0,1,0
16,226,226,4,4,0,1,0
36,230,230,22,5,17,2,1
5,242,242,24,24,0,1,0
7,246,246,86,52,34,4,3
21,251,251,20,20,0,1,0
29,311,311,45,45,0,1,0
0,313,313,4,1,3,2,1
15,314,314,19,16,3,2,1
11,323,323,9,9,0,1,0
13,323,323,56,56,0,1,0
38,335,335,35,4,31,2,1
30,341,341,62,62,0,1,0
26,343,343,47,47,0,1,0
1,349,349,72,22,50,2,1
34,364,364,22,22,0,1,0
14,387,387,7,7,0,1,0
23,388,388,17,5,12,3,2
20,395,395,43,43,0,1,0
37,395,395,72,72,0,1,0
22,408,408,48,7,41,2,1
31,418,418,1,1,0,1,0
25,435,435,17,7,10,2,1
17,452,452,71,44,27,4,3
28,462,462,55,55,0,1,0
9,479,479,76,46,30,3,2
10,481,481,20,11,9,2,1
4,496,496,19,6,13,2,1

4,102,102,6,1,5,2,1
27,107,107,4,4,0,1,0
10,110,110,2,2,0,1,0
18,150,150,15,15,0,1,0
22,161,161,1,1,0,1,0
1,178,178,14,3,11,2,1
34,196,196,10,2,8,2,1
2,226,226,10,1,9,2,1
11,236,236,6,6,0,1,0
17,246,246,13,13,0,1,0
9,250,250,12,6,6,2,1
8,252,252,11,11,0,1,0
12,258,258,48,10,38,2,1
26,274,274,72,72,0,1,0
25,279,279,31,31,0,1,0
5,302,302,32,32,0,1,0
37,302,302,41,1,40,2,1
21,305,305,40,40,0,1,0
14,306,306,58,46,12,3,2
3,307,307,22,19,3,2,1
28,323,323,103,29,74,3,2
29,339,339,17,2,15,2,1
35,340,340,53,53,0,1,0
19,369,369,44,5,39,4,3
7,400,400,17,2,15,2,1
16,403,403,22,8,14,2,1
31,407,407,25,25,0,1,0
0,408,408,36,16,20,2,1
46,410,410,5,5,0,1,0
44,413,413,75,75,0,1,0
33,417,417,38,38,0,1,0
23,422,422,7,7,0,1,0
30,425,425,42,19,23,2,1
32,427,427,32,23,9,4,3
38,427,427,77,33,44,3,2
13,428,428,8,1,7,2,1
36,437,437,63,49,14,3,2
42,440,440,7,7,0,1,0
24,444,444,14,8,6,3,2
20,444,444,4,4,0,1,0
39,448,448,41,41,0,1,0
45,448,448,54,1,53,4,3
15,449,449,1,1,0,1,0
40,452,452,14,2,12,3,2
6,468,468,40,40,0,1,0
41,472,472,66,66,0,1,0
43,478,478,16,10,6,3,2

27,104,104,6,3,3,2,1
28,108,108,29,29,0,1,0
19,129,129,1,1,0,1,0
24,130,130,13,1,12,3,2
21,139,139,21,6,15,2,1
11,141,141,16,11,5,2,1
2,151,151,7,4,3,2,1
25,167,167,8,5,3,2,1
34,171,171,11,11,0,1,0
44,175,175,4,4,0,1,0
13,189,189,8,8,0,1,0
15,200,200,15,2,13,2,1
12,203,203,19,19,0,1,0
26,217,217,23,2,21,2,1
30,220,220,12,12,0,1,0
29,223,223,8,2,6,3,2
18,237,237,4,4,0,1,0
43,237,237,23,23,0,1,0
0,259,259,6,6,0,1,0
40,260,260,16,10,6,2,1
4,279,279,15,15,0,1,0
10,285,285,40,40,0,1,0
23,296,296,27,27,0,1,0
32,296,296,22,17,5,2,1
14,316,316,44,12,32,2,1
41,317,317,28,28,0,1,0
3,319,319,11,1,10,3,2
5,337,337,28,28,0,1,0
42,343,343,26,3,23,4,3
39,343,343,16,6,10,2,1
9,377,377,17,5,12,2,1
35,388,388,52,52,0,1,0
16,395,395,6,6,0,1,0
6,399,399,46,37,9,4,3
17,404,404,39,39,0,1,0
37,405,405,57,11,46,3,2
1,411,411,17,17,0,1,0
33,415,415,25,2,23,2,1
22,425,425,46,33,13,2,1
7,437,437,65,65,0,1,0
36,442,442,68,47,21,2,1
31,448,448,84,6,78,4,3
20,449,449,46,46,0,1,0
8,451,451,53,53,0,1,0
38,496,496,131,131,0,1,0

17,105,105,2,2,0,1,0
30,119,119,13,13,0,1,0
21,129,129,56,56,0,1,0
11,129,129,28,3,25,2,1
15,142,142,5,2,3,2,1
28,147,147,33,9,24,2,1
10,151,151,20,4,16,2,1
14,156,156,5,5,0,1,0
16,158,158,8,8,0,1,0
23,163,163,8,3,5,2,1
0,164,164,36,6,30,4,3
25,182,182,31,6,25,2,1
2,183,183,12,6,6,3,2
7,187,187,22,22,0,1,0
19,194,194,22,6,16,4,3
20,212,212,5,5,0,1,0
8,218,218,5,5,0,1,0
29,229,229,10,6,4,2,1
31,230,230,27,21,6,2,1
24,235,235,6,6,0,1,0
35,235,235,9,1,8,2,1
4,239,239,14,14,0,1,0
3,243,243,53,13,40,3,2
34,249,249,11,11,0,1,0
9,261,261,76,4,72,3,2
6,276,276,21,21,0,1,0
18,279,279,18,3,15,4,3
37,317,317,9,9,0,1,0
32,343,343,84,84,0,1,0
38,348,348,22,7,15,4,3
22,357,357,35,7,28,3,2
26,365,365,25,25,0,1,0
33,391,391,38,16,22,3,2
12,442,442,32,32,0,1,0
13,463,463,21,16,5,2,1
5,471,471,10,1,9,2,1
27,474,474,4,4,0,1,0
39,475,475,15,15,0,1,0
36,488,488,56,28,28,2,1
1,490,490,63,21,42,3,2

11,103,103,1,1,0,1,0
15,109,109,6,6,0,1,0
20,117,117,15,15,0,1,0
19,139,139,10,1,9,4,3
40,140,140,7,1,6,3,2
39,142,142,15,15,0,1,0
38,144,144,31,31,0,1,0
41,156,156,34,27,7,2,1
18,220,220,1,1,0,1,0
32,229,229,8,8,0,1,0
9,230,230,7,7,0,1,0
25,235,235,2,2,0,1,0
28,241,241,10,1,9,4,3
16,242,242,3,3,0,1,0
8,243,243,71,71,0,1,0
36,256,256,5,5,0,1,0
30,267,267,2,2,0,1,0
2,267,267,29,29,0,1,0
7,275,275,59,59,0,1,0
27,299,299,21,3,18,2,1
12,302,302,1,1,0,1,0
35,325,325,73,17,56,3,2
34,334,334,86,86,0,1,0
14,335,335,3,3,0,1,0
13,351,351,12,12,0,1,0
31,361,361,1,1,0,1,0
3,362,362,13,3,10,2,1
24,370,370,39,4,35,2,1
1,372,372,82,82,0,1,0
37,389,389,11,11,0,1,0
42,416,416,142,132,10,2,1
17,418,418,61,37,24,4,3
23,426,426,47,37,10,3,2
4,432,432,72,72,0,1,0
5,463,463,51,2,49,4,3
6,475,475,25,16,9,2,1
0,478,478,15,4,11,2,1
33,482,482,60,60,0,1,0
29,483,483,25,1,24,3,2
21,484,484,77,29,48,4,3
26,496,496,7,7,0,1,0
22,498,498,51,41,10,3,2
10,500,500,1,1,0,1,0

10,100,100,2,2,0,1,0
9,103,103,1,1,0,1,0
45,116,116,3,3,0,1,0
20,117,117,15,15,0,1,0
40,128,128,15,3,12,3,2
23,128,128,3,3,0,1,0
27,139,139,8,2,6,3,2
25,142,142,8,8,0,1,0
16,147,147,32,32,0,1,0
0,149,149,19,19,0,1,0
1,166,166,7,7,0,1,0
28,168,168,11,11,0,1,0
7,184,184,1,1,0,1,0
15,187,187,38,38,0,1,0
34,193,193,25,18,7,2,1
12,194,194,16,16,0,1,0
38,196,196,11,11,0,1,0
35,211,211,4,4,0,1,0
43,217,217,30,30,0,1,0
39,219,219,23,23,0,1,0
24,234,234,6,6,0,1,0
29,249,249,44,44,0,1,0
14,279,279,11,11,0,1,0
32,279,279,79,79,0,1,0
2,280,280,6,6,0,1,0
13,294,294,31,21,10,3,2
48,297,297,3,3,0,1,0
42,307,307,73,73,0,1,0
8,314,314,8,8,0,1,0
46,314,314,32,12,20,3,2
19,317,317,15,5,10,2,1
18,320,320,6,6,0,1,0
47,334,334,10,10,0,1,0
11,339,339,14,1,13,2,1
41,345,345,23,23,0,1,0
22,362,362,27,21,6,2,1
3,384,384,13,13,0,1,0
5,394,394,29,29,0,1,0
26,400,400,22,1,21,2,1
37,403,403,63,25,38,4,3
44,421,421,4,4,0,1,0
30,430,430,2,2,0,1,0
21,432,432,4,4,0,1,0
4,462,462,111,24,87,4,3
6,464,464,5,5,0,1,0
31,464,464,65,65,0,1,0
36,467,467,6,6,0,1,0
33,478,478,105,105,0,1,0
17,487,487,68,18,50,3,2

15,109,109,30,30,0,1,0
4,113,113,7,1,6,3,2
5,132,132,17,13,4,2,1
8,137,137,6,6,0,1,0
38,141,141,4,4,0,1,0
2,154,154,16,16,0,1,0
7,162,162,13,5,8,2,1
10,163,163,24,24,0,1,0
32,176,176,2,2,0,1,0
13,192,192,1,1,0,1,0
14,196,196,34,15,19,2,1
11,197,197,9,3,6,3,2
6,201,201,66,59,7,2,1
20,230,230,33,33,0,1,0
33,242,242,18,18,0,1,0
34,247,247,10,10,0,1,0
12,250,250,76,22,54,4,3
3,254,254,1,1,0,1,0
24,268,268,30,30,0,1,0
28,270,270,9,9,0,1,0
17,348,348,9,9,0,1,0
25,349,349,13,4,9,2,1
36,353,353,101,101,0,1,0
21,353,353,40,40,0,1,0
23,360,360,15,15,0,1,0
9,387,387,57,6,51,3,2
30,390,390,125,42,83,4,3
0,392,392,15,15,0,1,0
22,399,399,7,7,0,1,0
35,407,407,7,7,0,1,0
37,408,408,4,4,0,1,0
19,457,457,65,65,0,1,0
16,460,460,1,1,0,1,0
18,462,462,3,3,0,1,0
27,465,465,66,28,38,3,2
31,465,465,208,121,87,4,3
29,469,469,1,1,0,1,0
1,484,484,38,14,24,2,1
26,494,494,6,1,5,2,1

28,103,103,1,1,0,1,0
18,116,116,7,2,5,2,1
17,128,128,2,2,0,1,0
34,143,143,3,3,0,1,0
24,147,147,25,11,14,3,2
23,150,150,4,4,0,1,0
29,157,157,12,12,0,1,0
10,175,175,5,5,0,1,0
0,176,176,1,1,0,1,0
11,212,212,5,5,0,1,0
5,216,216,13,4,9,2,1
42,225,225,14,3,11,2,1
45,236,236,1,1,0,1,0
3,256,256,22,22,0,1,0
46,260,260,26,20,6,2,1
40,281,281,23,23,0,1,0
39,290,290,12,9,3,2,1
8,292,292,12,12,0,1,0
37,301,301,22,6,16,3,2
44,306,306,60,42,18,3,2
21,306,306,24,17,7,2,1
41,308,308,64,52,12,4,3
6,314,314,21,6,15,4,3
2,315,315,13,1,12,3,2
13,328,328,74,23,51,3,2
9,331,331,5,5,0,1,0
12,337,337,2,2,0,1,0
7,341,341,22,2,20,3,2
43,359,359,53,41,12,2,1
47,362,362,14,10,4,2,1
20,366,366,16,3,13,2,1
33,375,375,8,8,0,1,0
16,378,378,20,20,0,1,0
14,379,379,18,13,5,2,1
4,379,379,16,6,10,2,1
27,383,383,66,66,0,1,0
25,387,387,11,11,0,1,0
35,395,395,79,28,51,4,3
38,412,412,41,32,9,4,3
36,416,416,44,44,0,1,0
1,431,431,14,14,0,1,0
26,437,437,54,5,49,2,1
32,449,449,114,114,0,1,0
22,462,462,75,75,0,1,0
15,474,474,85,80,5,2,1
30,488,488,54,12,42,4,3
19,493,493,50,50,0,1,0
31,500,500,94,94,0,1,0

24,108,108,17,17,0,1,0
7,112,112,3,3,0,1,0
4,113,113,18,8,10,3,2
30,114,114,18,13,5,2,1
21,129,129,14,9,5,2,1
27,138,138,2,2,0,1,0
3,146,146,9,9,0,1,0
20,149,149,11,11,0,1,0
32,159,159,4,4,0,1,0
1,167,167,4,4,0,1,0
5,186,186,1,1,0,1,0
36,207,207,47,6,41,2,1
33,231,231,24,12,12,4,3
0,241,241,14,3,11,2,1
37,243,243,29,8,21,2,1
11,254,254,113,80,33,2,1
39,258,258,39,25,14,3,2
35,271,271,22,22,0,1,0
16,294,294,46,28,18,3,2
15,307,307,17,17,0,1,0
19,307,307,7,2,5,2,1
12,308,308,1,1,0,1,0
10,322,322,73,31,42,3,2
17,333,333,62,17,45,4,3
41,334,334,19,19,0,1,0
13,344,344,56,56,0,1,0
18,345,345,44,44,0,1,0
8,359,359,14,6,8,2,1
2,360,360,2,2,0,1,0
6,361,361,11,2,9,4,3
23,370,370,20,20,0,1,0
29,392,392,19,19,0,1,0
14,397,397,9,9,0,1,0
25,421,421,63,18,45,4,3
38,453,453,15,2,13,2,1
28,456,456,3,3,0,1,0
34,463,463,17,13,4,2,1
9,465,465,3,3,0,1,0
31,466,466,131,31,100,3,2
40,477,477,34,16,18,2,1
22,482,482,102,61,41,2,1
26,490,490,24,24,0,1,0

35,100,100,10,10,0,1,0
34,101,101,8,2,6,2,1
0,105,105,1,1,0,1,0
12,110,110,23,23,0,1,0
10,114,114,2,2,0,1,0
18,120,120,4,4,0,1,0
29,138,138,56,28,28,4,3
4,175,175,23,23,0,1,0
16,182,182,1,1,0,1,0
17,194,194,6,6,0,1,0
33,197,197,42,2,40,4,3
20,206,206,15,3,12,3,2
3,210,210,8,8,0,1,0
14,233,233,146,141,5,2,1
36,254,254,31,23,8,2,1
30,260,260,42,34,8,3,2
7,274,274,20,13,7,2,1
32,280,280,12,2,10,3,2
6,287,287,18,18,0,1,0
15,293,293,29,29,0,1,0
5,308,308,52,25,27,4,3
9,315,315,7,7,0,1,0
2,318,318,21,3,18,4,3
24,321,321,30,4,26,2,1
26,324,324,69,19,50,4,3
31,341,341,17,17,0,1,0
21,365,365,28,28,0,1,0
23,378,378,1,1,0,1,0
37,394,394,19,19,0,1,0
27,412,412,80,21,59,3,2
19,415,415,6,2,4,2,1
1,419,419,58,58,0,1,0
8,421,421,31,31,0,1,0
11,439,439,38,38,0,1,0
13,439,439,62,10,52,3,2
22,460,460,26,26,0,1,0
25,484,484,29,29,0,1,0
28,498,498,4,4,0,1,0

12,122,122,3,3,0,1,0
13,123,123,6,6,0,1,0
26,124,124,3,3,0,1,0
30,131,131,44,14,30,2,1
5,132,132,10,3,7,2,1
18,136,136,5,5,0,1,0
2,156,156,27,18,9,4,3
14,160,160,5,1,4,2,1
29,182,182,20,2,18,4,3
8,186,186,22,22,0,1,0
32,191,191,4,4,0,1,0
24,210,210,14,4,10,3,2
7,212,212,40,40,0,1,0
11,221,221,1,1,0,1,0
28,240,240,33,14,19,2,1
6,243,243,35,35,0,1,0
37,246,246,12,12,0,1,0
34,254,254,37,31,6,2,1
9,261,261,6,2,4,2,1
15,261,261,84,84,0,1,0
19,269,269,13,1,12,2,1
22,293,293,11,11,0,1,0
16,294,294,81,57,24,2,1
3,304,304,63,12,51,3,2
1,336,336,3,3,0,1,0
25,337,337,19,19,0,1,0
0,343,343,2,2,0,1,0
17,354,354,22,22,0,1,0
35,355,355,69,69,0,1,0
23,361,361,172,139,33,2,1
36,368,368,32,32,0,1,0
20,380,380,19,19,0,1,0
4,392,392,94,94,0,1,0
33,414,414,44,44,0,1,0
21,415,415,2,2,0,1,0
27,452,452,8,2,6,3,2
38,459,459,27,27,0,1,0
31,466,466,6,6,0,1,0
10,490,490,8,2,6,3,2

17,110,110,8,5,3,2,1
9,117,117,25,1,24,3,2
48,120,120,13,13,0,1,0
7,134,134,17,17,0,1,0
44,135,135,15,15,0,1,0
32,142,142,6,2,4,2,1
22,151,151,5,5,0,1,0
26,152,152,22,15,7,2,1
34,159,159,8,8,0,1,0
47,163,163,3,3,0,1,0
19,178,178,52,4,48,2,1
28,189,189,12,12,0,1,0
45,249,249,52,40,12,2,1
29,258,258,42,42,0,1,0
0,260,260,8,1,7,2,1
20,266,266,3,3,0,1,0
5,268,268,50,50,0,1,0
40,273,273,28,10,18,3,2
6,277,277,2,2,0,1,0
42,280,280,7,3,4,2,1
18,281,281,14,14,0,1,0
27,283,283,3,3,0,1,0
25,312,312,1,1,0,1,0
41,313,313,6,3,3,2,1
31,319,319,32,32,0,1,0
46,321,321,71,21,50,2,1
14,326,326,2,2,0,1,0
24,327,327,1,1,0,1,0
10,332,332,1,1,0,1,0
11,332,332,23,2,21,2,1
3,336,336,10,7,3,2,1
43,340,340,92,65,27,2,1
30,346,346,62,26,36,4,3
15,353,353,29,29,0,1,0
33,354,354,67,61,6,2,1
13,375,375,24,24,0,1,0
16,387,387,39,39,0,1,0
1,390,390,9,9,0,1,0
35,395,395,10,10,0,1,0
21,398,398,43,34,9,4,3
38,419,419,16,4,12,2,1
12,423,423,62,62,0,1,0
2,431,431,21,18,3,2,1
36,437,437,17,3,14,2,1
4,442,442,20,20,0,1,0
39,457,457,33,33,0,1,0
37,481,481,26,21,5,2,1
23,493,493,1,1,0,1,0
8,495,495,11,11,0,1,0

28,103,103,15,15,0,1,0
21,111,111,27,27,0,1,0
33,128,128,36,36,0,1,0
11,133,133,1,1,0,1,0
13,143,143,15,9,6,3,2
19,150,150,11,7,4,2,1
16,153,153,2,2,0,1,0
2,179,179,17,17,0,1,0
14,188,188,27,27,0,1,0
15,189,189,3,3,0,1,0
10,190,190,13,13,0,1,0
25,203,203,17,17,0,1,0
12,215,215,18,9,9,4,3
39,222,222,5,5,0,1,0
26,234,234,21,15,6,2,1
18,237,237,3,3,0,1,0
29,248,248,3,3,0,1,0
41,256,256,31,31,0,1,0
23,285,285,30,4,26,2,1
1,293,293,3,3,0,1,0
36,307,307,47,35,12,2,1
6,308,308,40,8,32,3,2
40,322,322,36,36,0,1,0
37,333,333,36,13,23,2,1
8,335,335,27,3,24,3,2
4,337,337,1,1,0,1,0
32,341,341,8,4,4,2,1
3,348,348,15,4,11,2,1
38,353,353,76,2,74,3,2
5,370,370,78,69,9,2,1
22,380,380,2,2,0,1,0
17,386,386,32,32,0,1,0
7,399,399,136,67,69,4,3
30,400,400,5,5,0,1,0
27,400,400,18,18,0,1,0
20,419,419,51,36,15,2,1
34,421,421,94,94,0,1,0
35,423,423,39,12,27,4,3
31,448,448,20,20,0,1,0
0,453,453,17,4,13,2,1
24,487,487,66,11,55,3,2
9,487,487,39,7,32,2,1

22,104,104,15,15,0,1,0
6,120,120,2,2,0,1,0
27,124,124,6,6,0,1,0
21,153,153,4,4,0,1,0
13,160,160,13,13,0,1,0
10,162,162,6,6,0,1,0
8,186,186,17,17,0,1,0
17,225,225,5,5,0,1,0
37,235,235,14,6,8,3,2
16,240,240,38,8,30,3,2
18,255,255,12,6,6,3,2
28,271,271,2,2,0,1,0
14,275,275,126,126,0,1,0
5,290,290,29,29,0,1,0
31,296,296,5,5,0,1,0
26,309,309,12,6,6,2,1
25,313,313,22,7,15,4,3
39,319,319,65,55,10,3,2
9,325,325,35,35,0,1,0
24,330,330,20,20,0,1,0
15,330,330,34,16,18,3,2
19,338,338,9,5,4,2,1
35,339,339,58,58,0,1,0
7,344,344,3,3,0,1,0
32,350,350,19,13,6,2,1
40,353,353,68,8,60,3,2
34,365,365,72,72,0,1,0
23,394,394,61,61,0,1,0
12,396,396,9,9,0,1,0
30,399,399,100,76,24,2,1
33,399,399,15,7,8,2,1
29,399,399,44,29,15,3,2
38,429,429,62,4,58,3,2
0,430,430,66,66,0,1,0
2,437,437,87,48,39,4,3
11,440,440,52,52,0,1,0
4,445,445,4,4,0,1,0
3,451,451,3,3,0,1,0
20,466,466,36,36,0,1,0
1,467,467,73,31,42,3,2
36,500,500,25,16,9,4,3

10,102,102,14,14,0,1,0
5,103,103,8,8,0,1,0
37,126,126,7,3,4,2,1
14,126,126,7,7,0,1,0
15,134,134,41,5,36,4,3
4,134,134,3,3,0,1,0
35,143,143,6,2,4,2,1
30,156,156,56,56,0,1,0
12,158,158,49,49,0,1,0
39,167,167,6,6,0,1,0
32,169,169,12,6,6,3,2
24,172,172,28,2,26,3,2
7,204,204,44,2,42,2,1
38,217,217,45,45,0,1,0
17,234,234,32,6,26,2,1
25,247,247,1,1,0,1,0
21,262,262,8,8,0,1,0
13,266,266,21,7,14,3,2
34,273,273,55,28,27,2,1
1,274,274,14,14,0,1,0
0,276,276,5,5,0,1,0
18,285,285,5,5,0,1,0
36,288,288,11,11,0,1,0
20,289,289,5,5,0,1,0
26,291,291,58,58,0,1,0
9,305,305,51,47,4,2,1
22,337,337,84,58,26,2,1
16,340,340,41,41,0,1,0
2,341,341,13,4,9,4,3
23,356,356,59,59,0,1,0
28,369,369,4,4,0,1,0
11,372,372,2,2,0,1,0
6,396,396,4,1,3,2,1
19,408,408,12,12,0,1,0
33,442,442,2,2,0,1,0
27,442,442,45,7,38,3,2
8,452,452,5,5,0,1,0
3,465,465,89,70,19,2,1
29,481,481,28,13,15,2,1
31,500,500,12,4,8,2,1

3,107,107,2,2,0,1,0
31,132,132,4,4,0,1,0
17,136,136,2,2,0,1,0
6,163,163,21,21,0,1,0
19,196,196,46,7,39,3,2
0,198,198,1,1,0,1,0
35,224,224,7,7,0,1,0
30,238,238,7,7,0,1,0
22,248,248,8,8,0,1,0
9,255,255,4,4,0,1,0
28,273,273,43,43,0,1,0
10,280,280,8,8,0,1,0
1,285,285,37,9,28,3,2
11,286,286,82,82,0,1,0
25,292,292,58,26,32,2,1
39,315,315,2,2,0,1,0
37,315,315,26,26,0,1,0
33,324,324,15,15,0,1,0
40,325,325,15,5,10,3,2
23,329,329,9,4,5,2,1
24,339,339,15,15,0,1,0
38,349,349,27,9,18,3,2
34,355,355,64,3,61,3,2
5,360,360,50,17,33,4,3
4,365,365,40,4,36,4,3
18,378,378,2,2,0,1,0
32,381,381,58,58,0,1,0
27,385,385,111,87,24,4,3
8,385,385,32,8,24,4,3
7,391,391,34,34,0,1,0
36,396,396,1,1,0,1,0
13,398,398,31,31,0,1,0
15,400,400,61,22,39,2,1
2,401,401,57,30,27,4,3
12,413,413,56,56,0,1,0
14,423,423,52,7,45,4,3
20,432,432,17,4,13,4,3
26,436,436,230,210,20,3,2
21,459,459,11,11,0,1,0
16,460,460,20,5,15,2,1
29,494,494,21,7,14,2,1

2,122,122,1,1,0,1,0
3,128,128,18,3,15,4,3
9,140,140,1,1,0,1,0
19,143,143,2,2,0,1,0
37,144,144,12,12,0,1,0
5,151,151,30,6,24,4,3
25,151,151,1,1,0,1,0
45,176,176,34,20,14,3,2
36,176,176,31,25,6,3,2
41,176,176,16,16,0,1,0
23,177,177,10,10,0,1,0
35,182,182,5,2,3,2,1
31,205,205,8,2,6,2,1
34,209,209,14,14,0,1,0
40,233,233,60,16,44,3,2
47,244,244,3,3,0,1,0
0,246,246,15,6,9,4,3
13,258,258,16,4,12,4,3
11,267,267,1,1,0,1,0
18,269,269,6,6,0,1,0
6,273,273,5,5,0,1,0
44,281,281,22,22,0,1,0
10,288,288,17,4,13,2,1
17,292,292,6,6,0,1,0
28,297,297,36,14,22,3,2
15,301,301,24,24,0,1,0
29,305,305,39,6,33,4,3
46,308,308,8,8,0,1,0
12,313,313,62,38,24,2,1
43,320,320,6,3,3,2,1
39,326,326,17,14,3,2,1
22,342,342,12,12,0,1,0
16,343,343,20,9,11,2,1
24,348,348,34,13,21,2,1
26,349,349,52,9,43,3,2
8,349,349,4,4,0,1,0
42,358,358,10,1,9,2,1
30,390,390,59,59,0,1,0
32,395,395,91,91,0,1,0
4,413,413,17,2,15,4,3
38,456,456,11,3,8,3,2
27,459,459,3,3,0,1,0
48,464,464,105,90,15,2,1
49,464,464,21,21,0,1,0
20,464,464,65,53,12,3,2
1,478,478,38,38,0,1,0
14,481,481,19,19,0,1,0
7,487,487,53,7,46,3,2
21,488,488,14,14,0,1,0
33,493,493,101,9,92,3,2

9,100,100,9,1,8,2,1
1,126,126,7,7,0,1,0
8,135,135,9,3,6,3,2
37,139,139,8,8,0,1,0
46,140,140,2,2,0,1,0
47,151,151,41,41,0,1,0
45,155,155,2,2,0,1,0
16,157,157,7,4,3,2,1
22,173,173,1,1,0,1,0
2,175,175,4,1,3,2,1
12,177,177,23,20,3,2,1
52,185,185,20,20,0,1,0
36,186,186,16,16,0,1,0
44,202,202,20,12,8,3,2
42,212,212,20,20,0,1,0
51,218,218,35,13,22,2,1
27,219,219,60,24,36,3,2
49,221,221,19,19,0,1,0
23,237,237,28,15,13,4,3
25,243,243,13,13,0,1,0
30,247,247,1,1,0,1,0
7,249,249,3,3,0,1,0
18,250,250,45,23,22,3,2
14,251,251,1,1,0,1,0
20,254,254,13,13,0,1,0
24,255,255,8,8,0,1,0
38,256,256,15,15,0,1,0
4,256,256,39,39,0,1,0
15,268,268,5,2,3,2,1
10,274,274,9,9,0,1,0
0,285,285,12,12,0,1,0
19,296,296,35,30,5,2,1
29,303,303,15,15,0,1,0
13,309,309,14,6,8,2,1
35,318,318,19,4,15,4,3
6,324,324,4,4,0,1,0
28,351,351,5,5,0,1,0
34,352,352,39,39,0,1,0
11,374,374,9,1,8,2,1
17,376,376,38,6,32,3,2
3,376,376,6,6,0,1,0
50,424,424,14,14,0,1,0
32,431,431,66,66,0,1,0
33,445,445,37,22,15,4,3
40,448,448,51,24,27,2,1
31,454,454,13,13,0,1,0
39,456,456,126,21,105,4,3
5,463,463,4,4,0,1,0
43,483,483,59,59,0,1,0
48,484,484,10,10,0,1,0
41,489,489,80,80,0,1,0
26,499,499,6,6,0,1,0
21,500,500,14,5,9,4,3

6,120,120,4,4,0,1,0
8,134,134,83,83,0,1,0
35,141,141,11,5,6,2,1
9,141,141,6,6,0,1,0
5,146,146,15,1,14,3,2
22,147,147,14,3,11,2,1
18,161,161,7,2,5,2,1
19,202,202,10,1,9,2,1
27,212,212,8,8,0,1,0
23,218,218,34,34,0,1,0
31,222,222,21,9,12,3,2
33,223,223,49,49,0,1,0
34,227,227,9,9,0,1,0
30,244,244,57,14,43,4,3
24,245,245,27,5,22,2,1
12,254,254,75,43,32,3,2
29,259,259,25,1,24,4,3
7,273,273,63,13,50,4,3
15,287,287,31,16,15,2,1
11,290,290,14,5,9,4,3
21,312,312,35,35,0,1,0
25,321,321,68,68,0,1,0
1,323,323,34,34,0,1,0
16,365,365,68,32,36,4,3
14,382,382,1,1,0,1,0
17,388,388,11,2,9,2,1
20,400,400,46,46,0,1,0
26,406,406,28,28,0,1,0
36,420,420,8,2,6,3,2
2,423,423,42,42,0,1,0
10,439,439,2,2,0,1,0
0,459,459,25,25,0,1,0
28,469,469,83,11,72,3,2
13,472,472,24,24,0,1,0
3,483,483,6,6,0,1,0
4,492,492,2,2,0,1,0
32,499,499,23,1,22,3,2

2,120,120,1,1,0,1,0
31,121,121,32,32,0,1,0
25,132,132,21,21,0,1,0
40,153,153,19,19,0,1,0
36,163,163,14,14,0,1,0
20,172,172,5,5,0,1,0
12,176,176,2,2,0,1,0
41,178,178,18,11,7,2,1
15,195,195,1,1,0,1,0
29,200,200,34,10,24,4,3
17,207,207,19,19,0,1,0
39,208,208,2,2,0,1,0
7,215,215,57,41,16,3,2
5,217,217,1,1,0,1,0
42,221,221,6,2,4,2,1
6,226,226,15,15,0,1,0
43,239,239,37,26,11,2,1
10,244,244,19,8,11,2,1
1,252,252,35,35,0,1,0
16,258,258,12,12,0,1,0
33,266,266,49,49,0,1,0
23,270,270,10,10,0,1,0
44,271,271,12,12,0,1,0
28,280,280,16,16,0,1,0
26,286,286,72,4,68,3,2
21,286,286,14,6,8,3,2
34,290,290,24,24,0,1,0
35,300,300,13,4,9,4,3
24,334,334,12,12,0,1,0
8,348,348,4,4,0,1,0
13,348,348,6,6,0,1,0
22,376,376,10,10,0,1,0
32,391,391,52,52,0,1,0
3,392,392,4,1,3,2,1
27,419,419,18,4,14,2,1
18,422,422,17,17,0,1,0
46,434,434,126,126,0,1,0
45,440,440,11,3,8,2,1
11,447,447,132,132,0,1,0
19,452,452,37,37,0,1,0
0,468,468,48,17,31,2,1
4,474,474,2,2,0,1,0
9,474,474,42,42,0,1,0
30,478,478,21,21,0,1,0
14,479,479,21,21,0,1,0
37,481,481,45,45,0,1,0
38,491,491,31,31,0,1,0

17,126,126,9,1,8,2,1
21,129,129,5,5,0,1,0
13,134,134,4,4,0,1,0
7,151,151,18,18,0,1,0
25,153,153,12,12,0,1,0
27,158,158,8,8,0,1,0
26,161,161,10,10,0,1,0
3,202,202,10,10,0,1,0
31,203,203,50,50,0,1,0
19,212,212,61,53,8,3,2
30,218,218,13,13,0,1,0
34,237,237,32,32,0,1,0
12,239,239,22,9,13,4,3
28,240,240,61,22,39,4,3
33,258,258,50,20,30,3,2
6,267,267,167,152,15,4,3
9,269,269,26,4,22,3,2
15,272,272,12,6,6,3,2
1,276,276,13,7,6,2,1
16,286,286,4,4,0,1,0
29,309,309,12,6,6,2,1
14,326,326,25,19,6,3,2
32,340,340,4,4,0,1,0
11,346,346,38,38,0,1,0
8,350,350,31,31,0,1,0
23,375,375,37,37,0,1,0
18,381,381,49,49,0,1,0
4,387,387,51,51,0,1,0
10,387,387,18,18,0,1,0
20,402,402,6,6,0,1,0
37,406,406,34,4,30,3,2
35,415,415,21,7,14,3,2
36,452,452,76,23,53,3,2
2,456,456,22,22,0,1,0
22,465,465,42,42,0,1,0
5,470,470,83,58,25,3,2
38,471,471,31,31,0,1,0
0,474,474,3,3,0,1,0
24,484,484,3,3,0,1,0

12,101,101,1,1,0,1,0
1,109,109,13,13,0,1,0
19,115,115,1,1,0,1,0
44,124,124,2,2,0,1,0
39,128,128,12,12,0,1,0
40,129,129,24,24,0,1,0
32,129,129,1,1,0,1,0
2,132,132,3,3,0,1,0
0,139,139,1,1,0,1,0
36,143,143,10,10,0,1,0
11,148,148,8,8,0,1,0
17,172,172,21,3,18,3,2
41,172,172,14,14,0,1,0
10,179,179,8,2,6,3,2
43,190,190,31,31,0,1,0
4,206,206,2,2,0,1,0
9,217,217,4,4,0,1,0
8,220,220,1,1,0,1,0
15,220,220,32,32,0,1,0
29,233,233,6,6,0,1,0
42,234,234,7,7,0,1,0
22,240,240,21,3,18,3,2
25,242,242,42,29,13,2,1
33,251,251,11,11,0,1,0
46,266,266,95,16,79,3,2
21,276,276,27,27,0,1,0
37,281,281,13,10,3,2,1
35,287,287,1,1,0,1,0
34,288,288,77,39,38,3,2
45,305,305,78,31,47,2,1
31,336,336,38,38,0,1,0
38,338,338,56,48,8,3,2
27,343,343,13,7,6,2,1
20,346,346,5,5,0,1,0
14,347,347,34,34,0,1,0
5,355,355,74,56,18,3,2
24,356,356,24,24,0,1,0
16,360,360,44,32,12,2,1
3,372,372,17,3,14,3,2
18,375,375,138,131,7,2,1
30,384,384,26,8,18,2,1
13,412,412,43,38,5,2,1
26,421,421,4,4,0,1,0
7,438,438,14,14,0,1,0
6,464,464,1,1,0,1,0
28,465,465,7,4,3,2,1
23,494,494,2,2,0,1,0

20,114,114,30,30,0,1,0
22,131,131,9,9,0,1,0
16,131,131,12,12,0,1,0
25,148,148,38,23,15,2,1
35,156,156,3,3,0,1,0
13,167,167,5,5,0,1,0
11,175,175,58,40,18,4,3
30,175,175,8,8,0,1,0
19,198,198,32,32,0,1,0
29,198,198,18,18,0,1,0
36,207,207,13,4,9,4,3
4,225,225,12,2,10,2,1
28,271,271,2,2,0,1,0
15,289,289,80,38,42,4,3
21,289,289,22,14,8,2,1
2,290,290,8,4,4,2,1
17,312,312,59,29,30,2,1
27,316,316,13,13,0,1,0
32,323,323,10,10,0,1,0
5,332,332,12,12,0,1,0
10,332,332,10,2,8,2,1
3,332,332,4,4,0,1,0
26,350,350,75,75,0,1,0
14,368,368,80,80,0,1,0
23,378,378,80,66,14,2,1
9,382,382,50,50,0,1,0
33,400,400,6,6,0,1,0
7,403,403,33,33,0,1,0
12,412,412,44,14,30,4,3
37,415,415,15,15,0,1,0
1,430,430,97,40,57,4,3
8,441,441,39,8,31,2,1
0,451,451,24,24,0,1,0
24,458,458,75,15,60,3,2
34,472,472,37,1,36,3,2
31,481,481,37,4,33,2,1
6,485,485,9,9,0,1,0
18,492,492,62,23,39,2,1

35,107,107,9,9,0,1,0
26,114,114,1,1,0,1,0
42,115,115,6,6,0,1,0
19,143,143,1,1,0,1,0
11,143,143,1,1,0,1,0
10,145,145,2,2,0,1,0
5,147,147,45,42,3,2,1
3,150,150,15,15,0,1,0
31,162,162,29,29,0,1,0
25,171,171,34,20,14,2,1
36,173,173,19,19,0,1,0
1,177,177,12,12,0,1,0
44,181,181,64,30,34,2,1
47,186,186,18,4,14,3,2
12,186,186,10,10,0,1,0
2,189,189,4,4,0,1,0
18,223,223,29,29,0,1,0
32,230,230,19,19,0,1,0
22,231,231,22,10,12,4,3
29,253,253,7,7,0,1,0
28,255,255,19,3,16,2,1
4,258,258,33,7,26,3,2
34,262,262,35,2,33,4,3
33,263,263,61,61,0,1,0
45,274,274,7,4,3,2,1
21,286,286,23,14,9,4,3
40,299,299,36,18,18,3,2
8,303,303,36,36,0,1,0
38,303,303,29,6,23,3,2
13,304,304,13,3,10,3,2
7,313,313,31,1,30,2,1
30,314,314,14,7,7,2,1
37,325,325,39,29,10,3,2
41,330,330,36,3,33,4,3
23,357,357,2,2,0,1,0
17,368,368,26,26,0,1,0
6,371,371,13,13,0,1,0
39,387,387,30,18,12,4,3
20,391,391,4,4,0,1,0
15,397,397,42,42,0,1,0
43,441,441,6,1,5,2,1
14,443,443,27,8,19,2,1
27,444,444,20,20,0,1,0
16,460,460,57,7,50,4,3
9,467,467,4,4,0,1,0
46,489,489,10,10,0,1,0
0,492,492,16,16,0,1,0
24,498,498,12,12,0,1,0

8,107,107,24,3,21,2,1
5,113,113,21,6,15,2,1
12,127,127,45,5,40,3,2
29,130,130,3,3,0,1,0
25,161,161,36,6,30,4,3
22,163,163,2,2,0,1,0
15,179,179,21,5,16,3,2
26,187,187,6,6,0,1,0
30,195,195,32,32,0,1,0
4,197,197,16,16,0,1,0
20,206,206,1,1,0,1,0
33,206,206,34,11,23,4,3
11,206,206,2,2,0,1,0
39,221,221,20,11,9,2,1
27,262,262,57,57,0,1,0
31,269,269,10,10,0,1,0
37,271,271,21,21,0,1,0
24,278,278,34,34,0,1,0
7,284,284,11,11,0,1,0
17,301,301,2,2,0,1,0
40,326,326,22,14,8,2,1
34,343,343,24,24,0,1,0
38,375,375,76,67,9,4,3
35,386,386,2,2,0,1,0
14,408,408,31,12,19,3,2
13,409,409,13,3,10,2,1
19,419,419,34,30,4,2,1
16,436,436,65,14,51,4,3
36,438,438,26,5,21,3,2
6,439,439,21,5,16,3,2
23,446,446,28,12,16,4,3
3,447,447,11,11,0,1,0
0,452,452,50,50,0,1,0
32,456,456,8,8,0,1,0
10,469,469,28,23,5,2,1
28,479,479,110,104,6,3,2
2,481,481,100,38,62,3,2
18,482,482,1,1,0,1,0
1,491,491,14,5,9,4,3
21,495,495,76,46,30,2,1
9,498,498,80,80,0,1,0

42,101,101,6,3,3,2,1
13,113,113,8,8,0,1,0
14,127,127,33,21,12,4,3
28,131,131,7,7,0,1,0
46,141,141,18,18,0,1,0
20,152,152,4,4,0,1,0
36,156,156,20,13,7,2,1
11,161,161,30,18,12,4,3
31,167,167,29,29,0,1,0
32,171,171,5,5,0,1,0
5,179,179,7,1,6,3,2
23,201,201,9,9,0,1,0
1,204,204,14,14,0,1,0
48,207,207,11,11,0,1,0
21,214,214,22,8,14,2,1
37,223,223,29,29,0,1,0
27,227,227,18,9,9,2,1
10,230,230,6,6,0,1,0
35,245,245,16,9,7,2,1
2,251,251,17,17,0,1,0
7,280,280,20,20,0,1,0
38,281,281,9,9,0,1,0
9,283,283,6,6,0,1,0
26,287,287,22,5,17,2,1
12,312,312,32,32,0,1,0
0,328,328,30,10,20,2,1
47,329,329,11,5,6,3,2
4,355,355,18,18,0,1,0
17,355,355,2,2,0,1,0
8,357,357,17,1,16,3,2
39,362,362,79,79,0,1,0
16,363,363,3,3,0,1,0
19,372,372,42,42,0,1,0
45,378,378,1,1,0,1,0
15,381,381,45,3,42,2,1
29,386,386,20,14,6,2,1
30,412,412,201,201,0,1,0
22,421,421,33,33,0,1,0
43,427,427,3,3,0,1,0
6,430,430,14,14,0,1,0
41,431,431,26,26,0,1,0
18,433,433,20,5,15,4,3
24,453,453,20,20,0,1,0
40,455,455,20,20,0,1,0
33,460,460,75,75,0,1,0
44,465,465,42,32,10,3,2
34,473,473,43,35,8,2,1
25,485,485,30,12,18,2,1
3,497,497,5,5,0,1,0

13,116,116,6,6,0,1,0
2,120,120,13,1,12,2,1
29,132,132,1,1,0,1,0
23,134,134,21,21,0,1,0
31,137,137,16,6,10,3,2
33,142,142,25,3,22,2,1
8,150,150,19,14,5,2,1
14,170,170,15,10,5,2,1
10,173,173,31,31,0,1,0
17,208,208,10,10,0,1,0
32,214,214,25,25,0,1,0
20,217,217,83,26,57,4,3
3,228,228,26,26,0,1,0
24,241,241,47,30,17,2,1
19,285,285,5,5,0,1,0
9,302,302,1,1,0,1,0
11,303,303,46,41,5,2,1
27,311,311,4,4,0,1,0
5,314,314,93,75,18,4,3
21,320,320,4,4,0,1,0
12,323,323,50,50,0,1,0
26,325,325,4,4,0,1,0
28,334,334,20,14,6,2,1
6,339,339,66,66,0,1,0
4,367,367,30,9,21,4,3
30,370,370,34,34,0,1,0
15,439,439,19,19,0,1,0
1,446,446,88,84,4,2,1
16,458,458,53,53,0,1,0
0,462,462,108,77,31,2,1
22,466,466,144,135,9,4,3
7,478,478,52,7,45,4,3
25,487,487,23,15,8,2,1
18,500,500,16,4,12,3,2

37,104,104,8,8,0,1,0
5,110,110,13,3,10,2,1
30,111,111,23,7,16,3,2
41,115,115,5,5,0,1,0
10,130,130,2,2,0,1,0
7,141,141,7,2,5,2,1
19,143,143,5,5,0,1,0
3,148,148,1,1,0,1,0
44,162,162,22,22,0,1,0
23,169,169,15,4,11,2,1
38,171,171,1,1,0,1,0
9,172,172,26,26,0,1,0
4,173,173,20,10,10,3,2
15,190,190,34,19,15,2,1
35,192,192,40,40,0,1,0
31,195,195,3,3,0,1,0
21,208,208,32,32,0,1,0
29,219,219,7,7,0,1,0
8,220,220,11,11,0,1,0
45,231,231,45,45,0,1,0
11,237,237,62,37,25,2,1
18,260,260,13,13,0,1,0
2,262,262,44,18,26,2,1
24,277,277,14,14,0,1,0
42,278,278,13,13,0,1,0
26,282,282,11,11,0,1,0
28,290,290,106,106,0,1,0
22,293,293,52,34,18,2,1
17,303,303,3,3,0,1,0
20,313,313,10,4,6,2,1
12,346,346,11,11,0,1,0
13,348,348,4,4,0,1,0
25,365,365,43,43,0,1,0
36,375,375,14,14,0,1,0
27,385,385,4,4,0,1,0
43,387,387,19,19,0,1,0
0,398,398,2,2,0,1,0
39,408,408,9,9,0,1,0
33,438,438,42,42,0,1,0
1,442,442,4,4,0,1,0
14,443,443,11,6,5,2,1
40,454,454,82,20,62,4,3
6,465,465,22,15,7,2,1
46,467,467,14,2,12,2,1
34,479,479,116,70,46,4,3
32,499,499,21,2,19,2,1
16,500,500,2,2,0,1,0

9,102,102,12,6,6,2,1
31,109,109,2,2,0,1,0
14,111,111,4,1,3,2,1
2,112,112,25,25,0,1,0
11,125,125,15,15,0,1,0
1,135,135,1,1,0,1,0
24,136,136,6,6,0,1,0
29,142,142,29,29,0,1,0
23,154,154,23,2,21,3,2
17,165,165,30,4,26,3,2
37,166,166,2,2,0,1,0
26,179,179,35,5,30,3,2
27,194,194,11,2,9,2,1
22,199,199,21,21,0,1,0
19,217,217,36,11,25,2,1
6,223,223,26,26,0,1,0
25,254,254,84,84,0,1,0
20,277,277,3,3,0,1,0
5,286,286,15,15,0,1,0
0,297,297,1,1,0,1,0
8,311,311,1,1,0,1,0
4,313,313,32,32,0,1,0
35,317,317,48,48,0,1,0
13,323,323,99,45,54,4,3
3,336,336,13,13,0,1,0
30,359,359,25,21,4,2,1
28,361,361,58,15,43,2,1
16,367,367,35,30,5,2,1
36,369,369,2,2,0,1,0
32,386,386,10,10,0,1,0
33,393,393,11,1,10,3,2
38,393,393,81,27,54,4,3
12,414,414,28,7,21,2,1
7,428,428,9,2,7,2,1
21,453,453,87,75,12,4,3
18,453,453,94,64,30,2,1
39,466,466,26,26,0,1,0
10,484,484,18,18,0,1,0
34,489,489,13,7,6,3,2
15,494,494,49,23,26,4,3

31,107,107,16,1,15,4,3
18,109,109,1,1,0,1,0
20,113,113,3,3,0,1,0
5,115,115,2,2,0,1,0
41,119,119,32,32,0,1,0
0,151,151,7,7,0,1,0
8,152,152,26,10,16,3,2
25,168,168,4,4,0,1,0
9,170,170,4,4,0,1,0
12,178,178,18,9,9,2,1
6,179,179,22,16,6,2,1
24,180,180,10,10,0,1,0
19,199,199,1,1,0,1,0
30,200,200,7,3,4,2,1
38,207,207,20,20,0,1,0
29,209,209,6,2,4,2,1
15,219,219,84,42,42,4,3
42,240,240,8,8,0,1,0
3,240,240,17,14,3,2,1
27,255,255,12,7,5,2,1
10,260,260,1,1,0,1,0
26,280,280,52,52,0,1,0
28,309,309,24,3,21,3,2
7,321,321,11,11,0,1,0
35,324,324,95,2,93,4,3
22,327,327,7,4,3,2,1
17,335,335,85,60,25,2,1
16,336,336,24,24,0,1,0
40,339,339,24,24,0,1,0
11,341,341,14,5,9,2,1
13,368,368,60,60,0,1,0
37,382,382,26,26,0,1,0
23,386,386,40,32,8,3,2
36,397,397,18,18,0,1,0
1,400,400,49,23,26,2,1
4,409,409,28,8,20,4,3
21,413,413,55,1,54,3,2
39,436,436,42,9,33,3,2
34,444,444,98,5,93,4,3
33,445,445,31,21,10,2,1
14,458,458,12,2,10,2,1
32,467,467,33,33,0,1,0
2,472,472,40,35,5,2,1

19,117,117,2,2,0,1,0
29,127,127,12,12,0,1,0
18,141,141,4,4,0,1,0
9,142,142,13,9,4,2,1
4,158,158,10,10,0,1,0
25,161,161,30,30,0,1,0
30,166,166,26,6,20,2,1
11,168,168,68,10,58,4,3
23,171,171,19,19,0,1,0
24,179,179,17,8,9,2,1
31,182,182,1,1,0,1,0
33,183,183,1,1,0,1,0
12,192,192,37,5,32,3,2
0,193,193,5,5,0,1,0
20,194,194,5,5,0,1,0
22,195,195,5,5,0,1,0
3,199,199,57,27,30,4,3
13,212,212,37,37,0,1,0
35,218,218,14,14,0,1,0
7,227,227,23,23,0,1,0
27,237,237,11,11,0,1,0
32,238,238,52,10,42,3,2
5,257,257,38,38,0,1,0
1,276,276,3,3,0,1,0
34,295,295,15,15,0,1,0
6,302,302,1,1,0,1,0
26,304,304,83,83,0,1,0
37,309,309,78,51,27,4,3
21,343,343,32,21,11,2,1
28,343,343,49,11,38,3,2
36,344,344,56,56,0,1,0
16,344,344,4,4,0,1,0
14,345,345,6,6,0,1,0
2,384,384,58,58,0,1,0
10,393,393,38,34,4,2,1
17,471,471,72,45,27,4,3
8,492,492,33,5,28,2,1
15,494,494,1,1,0,1,0

14,101,101,6,6,0,1,0
35,105,105,8,8,0,1,0
47,118,118,10,10,0,1,0
10,119,119,12,7,5,2,1
2,140,140,2,2,0,1,0
22,142,142,6,6,0,1,0
46,153,153,2,2,0,1,0
41,163,163,11,2,9,4,3
26,169,169,9,1,8,3,2
5,170,170,3,3,0,1,0
33,172,172,15,15,0,1,0
18,179,179,25,22,3,2,1
32,181,181,59,1,58,3,2
12,184,184,45,3,42,4,3
27,200,200,24,24,0,1,0
9,207,207,3,3,0,1,0
1,215,215,13,1,12,4,3
11,228,228,6,3,3,2,1
34,229,229,4,1,3,2,1
19,240,240,9,9,0,1,0
36,243,243,36,36,0,1,0
6,248,248,16,16,0,1,0
7,251,251,4,4,0,1,0
0,253,253,13,13,0,1,0
15,272,272,6,6,0,1,0
17,279,279,5,2,3,2,1
37,293,293,11,11,0,1,0
39,295,295,19,19,0,1,0
25,297,297,1,1,0,1,0
3,307,307,23,23,0,1,0
45,311,311,39,26,13,2,1
44,312,312,46,46,0,1,0
30,335,335,5,1,4,2,1
43,347,347,8,4,4,2,1
42,347,347,209,65,144,4,3
23,371,371,25,25,0,1,0
29,374,374,15,15,0,1,0
40,383,383,5,2,3,2,1
13,387,387,21,3,18,4,3
31,397,397,23,13,10,3,2
38,413,413,13,9,4,2,1
4,442,442,18,18,0,1,0
16,445,445,8,8,0,1,0
20,458,458,140,140,0,1,0
24,462,462,105,105,0,1,0
28,469,469,31,10,21,4,3
8,488,488,22,6,16,3,2
21,490,490,30,13,17,2,1

36,109,109,4,4,0,1,0
22,117,117,6,6,0,1,0
3,138,138,12,12,0,1,0
25,150,150,2,2,0,1,0
23,156,156,6,3,3,2,1
30,182,182,12,3,9,2,1
1,187,187,7,7,0,1,0
24,188,188,7,7,0,1,0
17,189,189,3,3,0,1,0
19,190,190,44,11,33,4,3
16,193,193,6,6,0,1,0
7,213,213,73,9,64,3,2
34,222,222,24,24,0,1,0
10,224,224,11,11,0,1,0
12,233,233,21,13,8,2,1
33,248,248,19,7,12,3,2
2,249,249,10,10,0,1,0
6,253,253,4,4,0,1,0
5,261,261,27,7,20,3,2
31,273,273,7,1,6,3,2
9,277,277,3,3,0,1,0
14,282,282,114,24,90,4,3
26,284,284,14,14,0,1,0
13,288,288,3,3,0,1,0
4,300,300,9,9,0,1,0
37,322,322,84,30,54,3,2
35,324,324,52,7,45,4,3
8,353,353,63,42,21,4,3
0,358,358,39,39,0,1,0
20,368,368,26,17,9,4,3
28,382,382,68,5,63,4,3
32,387,387,54,25,29,2,1
38,397,397,23,17,6,3,2
18,407,407,125,125,0,1,0
21,420,420,46,31,15,2,1
29,424,424,61,37,24,3,2
15,457,457,13,13,0,1,0
11,477,477,53,15,38,2,1
27,487,487,92,74,18,4,3

18,108,108,13,1,12,2,1
39,122,122,15,12,3,2,1
28,126,126,46,29,17,2,1
42,127,127,10,6,4,2,1
31,128,128,2,2,0,1,0
16,153,153,8,3,5,2,1
1,155,155,10,1,9,4,3
15,155,155,17,17,0,1,0
9,157,157,1,1,0,1,0
35,165,165,36,36,0,1,0
30,180,180,26,14,12,4,3
27,182,182,22,22,0,1,0
20,192,192,7,7,0,1,0
34,204,204,11,1,10,3,2
32,222,222,4,4,0,1,0
25,229,229,85,85,0,1,0
37,233,233,10,1,9,4,3
12,240,240,29,29,0,1,0
2,245,245,10,7,3,2,1
0,249,249,16,16,0,1,0
14,256,256,35,5,30,4,3
33,263,263,4,1,3,2,1
38,278,278,8,2,6,2,1
5,279,279,44,11,33,2,1
6,281,281,52,52,0,1,0
17,285,285,5,5,0,1,0
3,311,311,36,1,35,2,1
21,312,312,27,10,17,3,2
4,319,319,9,9,0,1,0
36,323,323,7,7,0,1,0
8,325,325,27,27,0,1,0
41,348,348,41,13,28,2,1
29,351,351,42,10,32,3,2
10,352,352,36,16,20,3,2
23,354,354,4,4,0,1,0
26,375,375,3,3,0,1,0
19,403,403,60,6,54,4,3
11,420,420,1,1,0,1,0
13,445,445,69,42,27,2,1
22,472,472,67,67,0,1,0
40,473,473,9,9,0,1,0
7,479,479,12,12,0,1,0
24,494,494,72,57,15,4,3

10,110,110,8,8,0,1,0
20,115,115,4,1,3,2,1
5,115,115,27,15,12,2,1
22,137,137,26,26,0,1,0
2,139,139,6,6,0,1,0
21,143,143,8,3,5,2,1
6,144,144,2,2,0,1,0
13,146,146,37,11,26,2,1
23,158,158,7,2,5,2,1
3,181,181,15,10,5,2,1
38,195,195,11,11,0,1,0
35,200,200,71,59,12,2,1
27,201,201,6,6,0,1,0
32,210,210,11,11,0,1,0
24,215,215,6,6,0,1,0
29,237,237,20,3,17,2,1
12,243,243,9,9,0,1,0
28,248,248,92,86,6,2,1
37,262,262,63,63,0,1,0
40,266,266,33,2,31,2,1
8,269,269,30,30,0,1,0
14,271,271,1,1,0,1,0
39,279,279,41,10,31,2,1
33,280,280,7,2,5,2,1
30,288,288,24,24,0,1,0
34,307,307,13,13,0,1,0
4,380,380,23,5,18,4,3
16,387,387,54,54,0,1,0
17,399,399,38,2,36,2,1
7,403,403,24,24,0,1,0
0,410,410,96,66,30,3,2
18,417,417,15,8,7,2,1
25,428,428,1,1,0,1,0
26,434,434,21,5,16,4,3
11,443,443,42,10,32,2,1
19,446,446,2,2,0,1,0
9,453,453,57,9,48,2,1
31,456,456,5,2,3,2,1
15,477,477,34,34,0,1,0
1,492,492,94,94,0,1,0
36,492,492,27,27,0,1,0

0,104,104,3,3,0,1,0
21,111,111,4,4,0,1,0
3,117,117,2,2,0,1,0
6,134,134,34,22,12,2,1
14,140,140,10,2,8,3,2
37,145,145,19,19,0,1,0
22,150,150,4,4,0,1,0
24,156,156,23,15,8,3,2
4,190,190,31,31,0,1,0
25,191,191,44,44,0,1,0
12,195,195,14,8,6,2,1
33,196,196,2,2,0,1,0
13,201,201,14,14,0,1,0
23,206,206,9,9,0,1,0
16,207,207,28,18,10,3,2
11,213,213,47,7,40,2,1
19,220,220,20,10,10,3,2
36,229,229,53,3,50,4,3
10,237,237,36,36,0,1,0
5,260,260,103,22,81,4,3
28,272,272,1,1,0,1,0
30,278,278,1,1,0,1,0
31,286,286,91,63,28,2,1
27,289,289,12,4,8,3,2
34,309,309,104,104,0,1,0
7,314,314,6,6,0,1,0
15,322,322,33,22,11,2,1
20,328,328,16,16,0,1,0
32,339,339,19,14,5,2,1
29,348,348,12,12,0,1,0
8,353,353,25,17,8,2,1
18,400,400,26,14,12,2,1
2,404,404,7,7,0,1,0
35,406,406,1,1,0,1,0
9,414,414,34,34,0,1,0
26,416,416,75,69,6,2,1
17,418,418,42,30,12,2,1
1,432,432,13,13,0,1,0

29,106,106,17,17,0,1,0
2,106,106,41,19,22,2,1
22,119,119,3,3,0,1,0
31,125,125,13,13,0,1,0
17,194,194,50,31,19,2,1
18,199,199,7,2,5,2,1
3,209,209,12,12,0,1,0
11,214,214,3,3,0,1,0
27,217,217,27,1,26,3,2
19,226,226,9,9,0,1,0
28,229,229,30,30,0,1,0
26,229,229,43,8,35,2,1
4,238,238,40,40,0,1,0
14,243,243,55,44,11,2,1
0,274,274,10,10,0,1,0
24,276,276,5,5,0,1,0
13,280,280,5,2,3,2,1
32,283,283,52,52,0,1,0
25,290,290,2,2,0,1,0
33,300,300,38,16,22,2,1
8,305,305,6,6,0,1,0
16,308,308,6,6,0,1,0
35,308,308,31,31,0,1,0
21,317,317,100,100,0,1,0
15,331,331,28,6,22,4,3
23,374,374,23,23,0,1,0
1,383,383,84,16,68,3,2
6,392,392,47,41,6,3,2
12,402,402,21,15,6,3,2
34,416,416,25,1,24,4,3
30,421,421,24,8,16,2,1
20,427,427,12,3,9,4,3
5,433,433,50,2,48,2,1
7,435,435,50,16,34,2,1
9,483,483,130,91,39,2,1
10,485,485,48,48,0,1,0

34,108,108,1,1,0,1,0
33,112,112,9,9,0,1,0
9,113,113,2,2,0,1,0
30,115,115,11,11,0,1,0
10,118,118,9,4,5,2,1
24,128,128,22,22,0,1,0
19,159,159,50,50,0,1,0
28,167,167,7,7,0,1,0
35,193,193,41,33,8,3,2
32,194,194,31,31,0,1,0
3,203,203,2,2,0,1,0
1,235,235,36,21,15,4,3
17,243,243,28,28,0,1,0
7,246,246,49,10,39,4,3
16,249,249,26,26,0,1,0
37,251,251,9,1,8,2,1
18,264,264,31,31,0,1,0
15,269,269,48,16,32,3,2
6,273,273,92,92,0,1,0
23,280,280,29,15,14,2,1
31,291,291,35,35,0,1,0
2,327,327,5,2,3,2,1
11,334,334,48,17,31,2,1
5,364,364,6,2,4,2,1
36,371,371,11,11,0,1,0
20,377,377,3,3,0,1,0
29,396,396,28,22,6,2,1
25,396,396,10,5,5,2,1
21,397,397,16,16,0,1,0
26,430,430,3,3,0,1,0
22,432,432,119,99,20,3,2
12,433,433,139,66,73,4,3
13,440,440,1,1,0,1,0
14,441,441,36,36,0,1,0
0,469,469,7,3,4,2,1
4,475,475,65,47,18,3,2
8,478,478,37,27,10,2,1
27,495,495,65,13,52,4,3

35,113,113,3,3,0,1,0
23,118,118,16,16,0,1,0
33,169,169,2,2,0,1,0
32,179,179,9,9,0,1,0
16,183,183,36,36,0,1,0
17,192,192,11,5,6,3,2
7,202,202,38,23,15,4,3
22,202,202,1,1,0,1,0
12,217,217,25,25,0,1,0
25,219,219,34,1,33,2,1
31,220,220,9,9,0,1,0
19,221,221,67,3,64,3,2
6,248,248,9,9,0,1,0
30,253,253,3,3,0,1,0
3,264,264,3,3,0,1,0
21,266,266,10,10,0,1,0
1,267,267,32,32,0,1,0
20,268,268,53,53,0,1,0
26,272,272,18,4,14,3,2
36,273,273,2,2,0,1,0
8,276,276,31,31,0,1,0
29,302,302,62,4,58,4,3
11,321,321,103,103,0,1,0
4,327,327,55,25,30,3,2
34,343,343,68,68,0,1,0
14,347,347,32,14,18,3,2
28,380,380,17,6,11,4,3
27,416,416,126,76,50,4,3
15,430,430,81,81,0,1,0
0,433,433,6,2,4,2,1
9,448,448,96,96,0,1,0
10,451,451,12,12,0,1,0
5,455,455,50,30,20,2,1
13,458,458,30,30,0,1,0
2,460,460,11,3,8,3,2
24,492,492,29,13,16,3,2
18,498,498,66,66,0,1,0

39,105,105,11,11,0,1,0
19,130,130,26,26,0,1,0
10,132,132,14,14,0,1,0
17,134,134,15,15,0,1,0
40,144,144,7,7,0,1,0
6,146,146,1,1,0,1,0
1,151,151,35,35,0,1,0
38,178,178,3,3,0,1,0
33,184,184,27,27,0,1,0
3,185,185,39,39,0,1,0
34,199,199,25,19,6,2,1
5,216,216,19,1,18,4,3
25,245,245,20,20,0,1,0
9,251,251,89,89,0,1,0
7,253,253,3,3,0,1,0
26,274,274,76,34,42,4,3
20,277,277,15,15,0,1,0
11,291,291,37,37,0,1,0
4,292,292,5,1,4,2,1
13,298,298,36,36,0,1,0
28,300,300,20,20,0,1,0
41,309,309,113,113,0,1,0
14,309,309,7,7,0,1,0
29,322,322,21,21,0,1,0
12,329,329,29,7,22,3,2
27,337,337,18,18,0,1,0
36,342,342,52,52,0,1,0
30,376,376,40,14,26,3,2
16,391,391,42,42,0,1,0
31,402,402,25,9,16,3,2
21,411,411,9,6,3,2,1
22,412,412,40,16,24,4,3
32,418,418,4,4,0,1,0
0,419,419,8,3,5,2,1
24,422,422,13,9,4,2,1
18,423,423,10,4,6,3,2
35,430,430,37,25,12,2,1
8,435,435,32,17,15,4,3
2,438,438,1,1,0,1,0
23,470,470,39,39,0,1,0
37,487,487,30,30,0,1,0
15,489,489,1,1,0,1,0

16,103,103,15,8,7,2,1
20,104,104,6,6,0,1,0
3,120,120,22,4,18,2,1
6,148,148,20,2,18,2,1
13,160,160,2,2,0,1,0
22,160,160,13,13,0,1,0
15,160,160,12,6,6,3,2
37,172,172,14,14,0,1,0
27,199,199,42,20,22,4,3
9,203,203,23,11,12,3,2
0,229,229,9,2,7,2,1
30,259,259,66,55,11,2,1
34,271,271,16,16,0,1,0
18,273,273,41,41,0,1,0
33,282,282,47,5,42,3,2
2,288,288,1,1,0,1,0
8,308,308,18,1,17,2,1
31,312,312,30,30,0,1,0
19,318,318,87,16,71,4,3
23,321,321,139,106,33,4,3
24,334,334,23,1,22,3,2
1,355,355,17,8,9,2,1
39,385,385,15,15,0,1,0
28,385,385,4,4,0,1,0
36,392,392,56,4,52,4,3
4,401,401,55,51,4,2,1
29,413,413,25,10,15,2,1
10,414,414,116,42,74,4,3
32,416,416,8,3,5,2,1
7,424,424,1,1,0,1,0
26,424,424,3,3,0,1,0
12,437,437,25,8,17,2,1
21,439,439,85,17,68,3,2
25,440,440,8,8,0,1,0
17,463,463,71,71,0,1,0
14,474,474,17,8,9,4,3
5,485,485,35,35,0,1,0
11,489,489,13,1,12,4,3
35,496,496,4,4,0,1,0
38,499,499,15,15,0,1,0

26,112,112,12,12,0,1,0
20,115,115,16,7,9,2,1
24,131,131,3,3,0,1,0
5,134,134,7,7,0,1,0
25,135,135,1,1,0,1,0
8,141,141,6,6,0,1,0
9,142,142,1,1,0,1,0
7,160,160,18,3,15,4,3
3,189,189,3,3,0,1,0
42,193,193,24,20,4,2,1
21,204,204,1,1,0,1,0
4,222,222,23,23,0,1,0
30,242,242,21,21,0,1,0
38,249,249,19,7,12,4,3
22,250,250,9,3,6,2,1
0,259,259,4,4,0,1,0
33,263,263,16,16,0,1,0
35,283,283,1,1,0,1,0
43,291,291,24,21,3,2,1
23,294,294,33,3,30,2,1
34,297,297,16,16,0,1,0
39,301,301,32,32,0,1,0
1,308,308,67,33,34,2,1
17,316,316,16,11,5,2,1
27,317,317,18,18,0,1,0
29,329,329,39,39,0,1,0
28,339,339,51,22,29,2,1
46,342,342,114,114,0,1,0
18,350,350,39,11,28,3,2
44,360,360,28,28,0,1,0
41,362,362,49,49,0,1,0
10,375,375,19,2,17,2,1
31,401,401,82,82,0,1,0
36,409,409,64,36,28,3,2
13,416,416,134,69,65,4,3
11,425,425,5,5,0,1,0
6,427,427,13,13,0,1,0
40,434,434,52,4,48,3,2
15,442,442,14,4,10,2,1
47,445,445,33,33,0,1,0
2,445,445,11,11,0,1,0
45,446,446,9,9,0,1,0
32,450,450,9,9,0,1,0
14,452,452,60,23,37,2,1
12,458,458,5,2,3,2,1
19,470,470,19,10,9,4,3
37,477,477,14,6,8,2,1
16,481,481,63,33,30,4,3

21,102,102,3,3,0,1,0
25,114,114,6,1,5,2,1
29,124,124,13,13,0,1,0
40,154,154,2,2,0,1,0
30,155,155,10,3,7,2,1
24,161,161,47,8,39,2,1
4,175,175,5,5,0,1,0
19,187,187,18,14,4,2,1
1,191,191,6,6,0,1,0
34,200,200,71,21,50,4,3
2,204,204,17,11,6,3,2
14,207,207,7,7,0,1,0
42,207,207,2,2,0,1,0
16,214,214,18,18,0,1,0
37,220,220,9,3,6,2,1
35,226,226,49,49,0,1,0
0,231,231,8,5,3,2,1
9,288,288,44,8,36,4,3
3,291,291,31,31,0,1,0
15,293,293,4,4,0,1,0
7,304,304,26,19,7,2,1
28,307,307,38,38,0,1,0
38,313,313,20,4,16,4,3
36,316,316,2,2,0,1,0
6,332,332,19,11,8,2,1
41,335,335,6,6,0,1,0
10,350,350,19,4,15,3,2
27,356,356,7,1,6,2,1
22,356,356,122,122,0,1,0
31,366,366,61,39,22,2,1
20,371,371,111,74,37,2,1
12,385,385,60,27,33,2,1
8,385,385,2,2,0,1,0
13,391,391,13,13,0,1,0
33,403,403,12,12,0,1,0
39,407,407,20,20,0,1,0
18,431,431,9,9,0,1,0
23,435,435,99,42,57,4,3
5,435,435,42,42,0,1,0
11,443,443,65,65,0,1,0
32,454,454,27,15,12,3,2
17,456,456,4,4,0,1,0
26,485,485,64,52,12,2,1

1,102,102,9,9,0,1,0
4,115,115,33,33,0,1,0
12,117,117,1,1,0,1,0
6,124,124,1,1,0,1,0
17,129,129,19,19,0,1,0
23,137,137,8,8,0,1,0
20,162,162,14,8,6,2,1
25,165,165,74,74,0,1,0
11,167,167,41,20,21,2,1
0,170,170,3,3,0,1,0
18,182,182,18,18,0,1,0
33,194,194,4,4,0,1,0
7,208,208,65,65,0,1,0
9,210,210,33,19,14,2,1
19,211,211,9,9,0,1,0
22,220,220,74,32,42,2,1
21,227,227,12,12,0,1,0
27,228,228,63,63,0,1,0
2,232,232,65,16,49,2,1
31,243,243,22,6,16,3,2
29,259,259,3,3,0,1,0
24,299,299,9,9,0,1,0
34,325,325,16,1,15,4,3
13,326,326,27,27,0,1,0
14,344,344,49,49,0,1,0
30,360,360,2,2,0,1,0
35,375,375,13,13,0,1,0
28,386,386,6,6,0,1,0
5,416,416,11,5,6,3,2
32,445,445,9,9,0,1,0
16,453,453,18,18,0,1,0
15,459,459,13,13,0,1,0
10,482,482,11,3,8,3,2
26,492,492,89,89,0,1,0
8,499,499,6,1,5,2,1
3,499,499,140,69,71,3,2

24,101,101,7,7,0,1,0
0,127,127,10,1,9,4,3
9,132,132,24,24,0,1,0
35,133,133,30,14,16,3,2
39,134,134,2,2,0,1,0
14,136,136,21,13,8,2,1
31,136,136,14,10,4,2,1
16,142,142,8,8,0,1,0
6,142,142,1,1,0,1,0
26,169,169,13,13,0,1,0
1,199,199,5,1,4,2,1
10,208,208,4,4,0,1,0
5,223,223,18,2,16,2,1
37,234,234,117,103,14,3,2
28,235,235,41,3,38,2,1
12,236,236,10,1,9,4,3
27,236,236,5,1,4,2,1
33,240,240,19,19,0,1,0
36,249,249,1,1,0,1,0
11,256,256,17,17,0,1,0
13,280,280,18,18,0,1,0
2,281,281,65,17,48,4,3
25,311,311,21,4,17,2,1
30,338,338,106,17,89,4,3
29,339,339,34,20,14,2,1
17,341,341,15,6,9,2,1
15,356,356,37,37,0,1,0
18,380,380,84,17,67,4,3
41,392,392,9,6,3,2,1
32,410,410,31,13,18,4,3
38,411,411,3,3,0,1,0
7,415,415,3,3,0,1,0
4,428,428,28,3,25,2,1
3,436,436,65,5,60,4,3
22,446,446,18,1,17,2,1
21,455,455,20,5,15,4,3
19,465,465,31,31,0,1,0
23,466,466,14,14,0,1,0
20,474,474,91,17,74,3,2
34,477,477,31,3,28,3,2
40,481,481,27,27,0,1,0
8,494,494,49,44,5,2,1

24,103,103,7,7,0,1,0
5,108,108,7,4,3,2,1
25,115,115,5,5,0,1,0
17,126,126,17,7,10,2,1
10,134,134,43,25,18,3,2
13,142,142,28,7,21,4,3
36,142,142,16,10,6,3,2
1,151,151,2,2,0,1,0
29,152,152,10,10,0,1,0
8,176,176,2,2,0,1,0
16,178,178,18,18,0,1,0
20,192,192,48,48,0,1,0
21,197,197,12,12,0,1,0
3,201,201,9,9,0,1,0
9,206,206,1,1,0,1,0
4,208,208,13,1,12,4,3
40,211,211,1,1,0,1,0
38,244,244,12,4,8,2,1
34,257,257,39,10,29,2,1
26,265,265,80,65,15,4,3
19,274,274,24,24,0,1,0
27,274,274,63,63,0,1,0
35,274,274,2,2,0,1,0
37,287,287,9,2,7,2,1
30,321,321,14,2,12,4,3
28,326,326,32,18,14,3,2
2,345,345,24,11,13,2,1
18,348,348,12,12,0,1,0
6,360,360,45,15,30,4,3
12,370,370,14,14,0,1,0
11,379,379,16,5,11,4,3
23,380,380,6,3,3,2,1
0,402,402,1,1,0,1,0
39,413,413,30,25,5,2,1
14,415,415,30,15,15,4,3
32,429,429,110,61,49,4,3
22,429,429,25,25,0,1,0
33,450,450,168,126,42,4,3
31,478,478,1,1,0,1,0
15,500,500,3,3,0,1,0
7,500,500,161,122,39,2,1

5,100,100,2,2,0,1,0
26,105,105,8,2,6,3,2
14,112,112,12,4,8,2,1
32,114,114,11,11,0,1,0
36,126,126,3,3,0,1,0
35,150,150,12,5,7,2,1
37,152,152,8,2,6,3,2
27,160,160,6,6,0,1,0
30,179,179,7,1,6,3,2
15,186,186,31,1,30,3,2
7,210,210,11,11,0,1,0
1,233,233,5,5,0,1,0
11,240,240,68,34,34,2,1
22,242,242,40,2,38,2,1
12,250,250,22,16,6,3,2
18,253,253,15,15,0,1,0
16,272,272,6,6,0,1,0
24,284,284,9,6,3,2,1
42,286,286,11,11,0,1,0
6,292,292,47,47,0,1,0
2,305,305,33,1,32,2,1
9,306,306,22,19,3,2,1
34,316,316,14,6,8,2,1
0,328,328,14,1,13,4,3
41,332,332,65,16,49,2,1
17,334,334,1,1,0,1,0
40,351,351,82,40,42,2,1
13,365,365,28,1,27,2,1
21,373,373,14,11,3,2,1
33,381,381,33,33,0,1,0
4,389,389,26,23,3,2,1
10,400,400,54,54,0,1,0
43,410,410,100,63,37,2,1
19,421,421,16,8,8,3,2
25,422,422,31,31,0,1,0
28,434,434,93,40,53,4,3
31,445,445,23,17,6,3,2
29,449,449,49,39,10,2,1
39,454,454,134,70,64,4,3
3,475,475,67,22,45,4,3
38,480,480,8,3,5,2,1
20,480,480,3,3,0,1,0
8,491,491,4,1,3,2,1
23,496,496,59,59,0,1,0

5,100,100,16,16,0,1,0
1,109,109,1,1,0,1,0
43,109,109,3,3,0,1,0
2,115,115,1,1,0,1,0
37,126,126,18,6,12,2,1
46,131,131,38,38,0,1,0
39,135,135,12,12,0,1,0
8,137,137,4,4,0,1,0
35,144,144,2,2,0,1,0
21,147,147,1,1,0,1,0
50,148,148,14,14,0,1,0
29,157,157,17,8,9,2,1
36,158,158,21,12,9,4,3
34,159,159,7,7,0,1,0
10,168,168,7,7,0,1,0
11,170,170,17,17,0,1,0
44,175,175,3,3,0,1,0
23,179,179,31,23,8,3,2
19,191,191,14,14,0,1,0
9,192,192,11,11,0,1,0
4,201,201,1,1,0,1,0
31,213,213,30,30,0,1,0
42,217,217,15,3,12,2,1
27,237,237,28,1,27,4,3
3,241,241,10,10,0,1,0
16,254,254,18,18,0,1,0
28,255,255,2,2,0,1,0
30,264,264,3,3,0,1,0
38,264,264,7,2,5,2,1
40,288,288,59,5,54,4,3
47,289,289,18,18,0,1,0
20,290,290,12,9,3,2,1
22,293,293,30,30,0,1,0
6,296,296,20,20,0,1,0
32,297,297,69,15,54,3,2
13,308,308,1,1,0,1,0
26,311,311,26,26,0,1,0
48,324,324,8,8,0,1,0
45,327,327,53,22,31,2,1
17,330,330,30,27,3,2,1
33,336,336,68,38,30,4,3
0,369,369,8,5,3,2,1
14,372,372,15,2,13,2,1
18,382,382,58,58,0,1,0
41,409,409,5,5,0,1,0
24,413,413,52,8,44,3,2
7,416,416,18,11,7,2,1
12,421,421,25,25,0,1,0
25,439,439,34,34,0,1,0
15,449,449,32,32,0,1,0
49,492,492,30,27,3,2,1

7,111,111,1,1,0,1,0
25,114,114,1,1,0,1,0
5,116,116,7,1,6,2,1
14,120,120,13,13,0,1,0
22,130,130,3,3,0,1,0
31,141,141,5,5,0,1,0
48,146,146,5,5,0,1,0
51,147,147,10,10,0,1,0
26,149,149,1,1,0,1,0
2,160,160,2,2,0,1,0
45,162,162,20,9,11,3,2
9,167,167,1,1,0,1,0
32,168,168,50,8,42,4,3
50,169,169,7,2,5,2,1
17,174,174,7,7,0,1,0
4,178,178,1,1,0,1,0
24,194,194,4,4,0,1,0
16,201,201,9,9,0,1,0
46,232,232,9,1,8,3,2
13,235,235,6,1,5,2,1
6,238,238,9,4,5,2,1
21,253,253,29,29,0,1,0
38,258,258,7,7,0,1,0
44,266,266,17,6,11,2,1
30,268,268,9,9,0,1,0
1,270,270,22,22,0,1,0
28,277,277,44,44,0,1,0
18,282,282,48,48,0,1,0
40,290,290,11,5,6,3,2
0,292,292,15,15,0,1,0
33,294,294,21,1,20,3,2
8,304,304,4,4,0,1,0
11,308,308,94,94,0,1,0
12,315,315,27,18,9,4,3
36,322,322,21,7,14,2,1
23,324,324,56,56,0,1,0
15,344,344,17,17,0,1,0
47,347,347,3,3,0,1,0
19,385,385,6,6,0,1,0
27,405,405,49,49,0,1,0
49,407,407,107,9,98,3,2
3,411,411,37,23,14,2,1
29,434,434,13,7,6,3,2
43,450,450,9,9,0,1,0
20,456,456,22,14,8,2,1
35,462,462,11,11,0,1,0
42,467,467,59,59,0,1,0
39,469,469,193,58,135,4,3
34,476,476,72,72,0,1,0
41,476,476,56,20,36,2,1
37,478,478,19,19,0,1,0
10,488,488,8,4,4,2,1

15,102,102,4,4,0,1,0
12,102,102,20,20,0,1,0
28,152,152,24,24,0,1,0
3,157,157,39,36,3,2,1
42,176,176,14,14,0,1,0
22,185,185,31,31,0,1,0
14,188,188,1,1,0,1,0
39,192,192,23,23,0,1,0
38,192,192,2,2,0,1,0
26,192,192,8,1,7,2,1
18,200,200,5,2,3,2,1
32,224,224,19,10,9,4,3
19,252,252,29,29,0,1,0
2,257,257,24,18,6,2,1
13,272,272,3,3,0,1,0
36,273,273,27,27,0,1,0
33,273,273,119,43,76,3,2
37,276,276,43,40,3,2,1
23,288,288,35,14,21,3,2
34,296,296,31,6,25,4,3
40,301,301,23,8,15,2,1
20,313,313,11,11,0,1,0
6,328,328,8,8,0,1,0
8,328,328,18,18,0,1,0
11,346,346,3,3,0,1,0
1,353,353,7,4,3,2,1
24,355,355,85,31,54,4,3
31,365,365,13,13,0,1,0
0,369,369,5,5,0,1,0
35,371,371,13,4,9,2,1
41,376,376,28,28,0,1,0
29,381,381,15,15,0,1,0
16,396,396,2,2,0,1,0
17,398,398,35,11,24,3,2
5,419,419,8,2,6,3,2
25,421,421,26,26,0,1,0
21,428,428,109,88,21,4,3
30,436,436,15,15,0,1,0
4,459,459,97,97,0,1,0
10,464,464,68,45,23,2,1
27,486,486,13,1,12,4,3
7,488,488,34,34,0,1,0
9,498,498,74,18,56,3,2

37,102,102,2,2,0,1,0
25,105,105,1,1,0,1,0
30,126,126,5,5,0,1,0
10,141,141,3,3,0,1,0
27,143,143,8,3,5,2,1
2,198,198,1,1,0,1,0
24,207,207,58,58,0,1,0
23,208,208,21,21,0,1,0
14,218,218,22,7,15,2,1
33,232,232,36,12,24,3,2
0,240,240,12,12,0,1,0
9,259,259,36,3,33,4,3
8,268,268,10,10,0,1,0
22,271,271,46,46,0,1,0
28,271,271,54,14,40,2,1
12,276,276,66,9,57,3,2
34,283,283,11,1,10,3,2
31,285,285,35,3,32,2,1
1,298,298,3,3,0,1,0
38,298,298,49,10,39,2,1
3,303,303,34,34,0,1,0
26,308,308,5,5,0,1,0
7,316,316,2,2,0,1,0
21,329,329,13,9,4,2,1
17,334,334,42,16,26,2,1
11,335,335,29,19,10,2,1
29,359,359,74,50,24,3,2
19,364,364,32,32,0,1,0
13,371,371,68,3,65,4,3
16,372,372,104,54,50,4,3
35,385,385,29,13,16,3,2
4,396,396,72,50,22,2,1
20,397,397,11,5,6,3,2
6,412,412,10,10,0,1,0
18,412,412,6,1,5,2,1
32,416,416,85,35,50,2,1
36,416,416,11,4,7,2,1
15,448,448,52,52,0,1,0
5,461,461,123,123,0,1,0

41,107,107,20,20,0,1,0
38,132,132,4,1,3,2,1
22,165,165,4,4,0,1,0
21,165,165,29,23,6,2,1
15,175,175,11,11,0,1,0
12,177,177,6,6,0,1,0
17,188,188,8,8,0,1,0
30,204,204,4,4,0,1,0
33,206,206,18,2,16,2,1
20,234,234,23,1,22,2,1
29,246,246,24,9,15,2,1
14,249,249,105,105,0,1,0
23,252,252,30,12,18,3,2
37,253,253,17,17,0,1,0
34,255,255,6,1,5,2,1
32,277,277,7,7,0,1,0
18,282,282,13,7,6,2,1
25,283,283,27,27,0,1,0
7,292,292,5,1,4,2,1
24,299,299,51,51,0,1,0
4,308,308,28,5,23,4,3
16,334,334,34,34,0,1,0
3,334,334,20,4,16,2,1
40,350,350,23,23,0,1,0
8,354,354,9,3,6,3,2
36,363,363,83,83,0,1,0
11,363,363,1,1,0,1,0
6,367,367,1,1,0,1,0
2,368,368,115,115,0,1,0
27,373,373,8,8,0,1,0
1,376,376,6,6,0,1,0
28,382,382,86,86,0,1,0
35,382,382,13,13,0,1,0
39,387,387,18,18,0,1,0
10,396,396,94,67,27,2,1
0,411,411,36,29,7,2,1
26,413,413,92,24,68,3,2
13,427,427,1,1,0,1,0
9,436,436,8,1,7,2,1
5,438,438,54,31,23,2,1
19,443,443,1,1,0,1,0
42,485,485,126,16,110,4,3
31,490,490,2,2,0,1,0

11,104,104,16,7,9,2,1
19,142,142,11,2,9,2,1
31,153,153,20,11,9,2,1
12,156,156,37,37,0,1,0
21,164,164,15,3,12,4,3
25,176,176,6,6,0,1,0
27,187,187,10,4,6,2,1
9,198,198,34,25,9,2,1
32,202,202,6,6,0,1,0
1,210,210,3,3,0,1,0
17,236,236,34,34,0,1,0
6,237,237,11,11,0,1,0
34,239,239,47,39,8,3,2
20,242,242,26,26,0,1,0
26,254,254,63,63,0,1,0
15,261,261,20,20,0,1,0
10,281,281,127,127,0,1,0
14,300,300,25,25,0,1,0
5,309,309,1,1,0,1,0
13,344,344,26,21,5,2,1
8,361,361,73,73,0,1,0
36,364,364,11,11,0,1,0
0,365,365,43,43,0,1,0
2,366,366,84,84,0,1,0
23,374,374,30,30,0,1,0
3,377,377,10,10,0,1,0
18,395,395,34,34,0,1,0
29,412,412,129,97,32,2,1
22,418,418,29,29,0,1,0
35,419,419,59,1,58,3,2
33,424,424,5,5,0,1,0
24,425,425,21,1,20,2,1
28,472,472,57,6,51,4,3
7,472,472,23,20,3,2,1
4,476,476,3,3,0,1,0
16,493,493,27,27,0,1,0
30,494,494,11,4,7,2,1

24,104,104,4,4,0,1,0
22,109,109,20,20,0,1,0
16,110,110,10,10,0,1,0
4,114,114,2,2,0,1,0
17,119,119,14,10,4,2,1
19,127,127,15,1,14,3,2
37,139,139,27,27,0,1,0
0,156,156,9,9,0,1,0
33,159,159,25,3,22,2,1
21,180,180,9,9,0,1,0
14,194,194,12,2,10,2,1
13,209,209,20,7,13,4,3
39,217,217,8,8,0,1,0
15,229,229,18,18,0,1,0
23,242,242,10,2,8,3,2
38,274,274,25,2,23,2,1
28,279,279,23,23,0,1,0
1,294,294,45,45,0,1,0
30,295,295,58,58,0,1,0
5,318,318,61,24,37,2,1
35,324,324,5,5,0,1,0
2,330,330,24,14,10,2,1
20,335,335,11,11,0,1,0
34,352,352,70,64,6,2,1
27,358,358,56,56,0,1,0
18,362,362,17,17,0,1,0
25,372,372,61,61,0,1,0
9,388,388,6,2,4,2,1
41,400,400,25,25,0,1,0
43,407,407,67,7,60,3,2
42,415,415,2,2,0,1,0
29,420,420,35,16,19,2,1
3,422,422,1,1,0,1,0
31,423,423,31,31,0,1,0
26,438,438,13,13,0,1,0
11,451,451,25,25,0,1,0
12,457,457,83,40,43,3,2
40,458,458,90,57,33,2,1
8,465,465,62,28,34,2,1
6,467,467,11,4,7,2,1
36,468,468,33,33,0,1,0
7,473,473,17,7,10,3,2
10,478,478,69,34,35,2,1
32,497,497,9,9,0,1,0

14,100,100,2,2,0,1,0
6,114,114,1,1,0,1,0
12,122,122,5,5,0,1,0
23,126,126,8,3,5,2,1
27,129,129,18,18,0,1,0
37,130,130,3,3,0,1,0
20,138,138,1,1,0,1,0
35,140,140,46,46,0,1,0
45,146,146,4,1,3,2,1
44,152,152,12,3,9,4,3
42,158,158,1,1,0,1,0
2,175,175,2,2,0,1,0
48,179,179,8,8,0,1,0
13,204,204,5,5,0,1,0
3,205,205,5,1,4,2,1
26,220,220,3,3,0,1,0
16,229,229,54,16,38,4,3
32,239,239,4,1,3,2,1
28,250,250,20,8,12,2,1
5,264,264,22,16,6,2,1
11,265,265,7,7,0,1,0
38,277,277,48,15,33,4,3
24,282,282,50,28,22,2,1
19,283,283,29,2,27,4,3
40,292,292,18,15,3,2,1
8,300,300,19,13,6,2,1
9,303,303,13,13,0,1,0
1,343,343,59,25,34,4,3
30,349,349,14,1,13,3,2
25,354,354,9,9,0,1,0
18,368,368,34,34,0,1,0
31,372,372,28,4,24,4,3
0,372,372,7,1,6,3,2
10,384,384,52,44,8,3,2
33,393,393,11,11,0,1,0
36,398,398,80,40,40,2,1
43,398,398,29,29,0,1,0
17,410,410,34,3,31,2,1
15,413,413,13,1,12,3,2
4,419,419,87,41,46,3,2
21,427,427,25,7,18,4,3
22,452,452,1,1,0,1,0
41,454,454,92,80,12,4,3
7,460,460,5,2,3,2,1
34,478,478,35,1,34,2,1
29,483,483,154,82,72,3,2
47,484,484,20,20,0,1,0
39,491,491,81,65,16,3,2
46,498,498,30,30,0,1,0

11,108,108,26,17,9,2,1
36,117,117,1,1,0,1,0
28,121,121,63,49,14,3,2
32,123,123,16,4,12,3,2
37,146,146,9,5,4,2,1
26,153,153,2,2,0,1,0
6,154,154,22,3,19,4,3
24,155,155,13,13,0,1,0
15,161,161,23,13,10,3,2
19,181,181,6,6,0,1,0
27,182,182,1,1,0,1,0
34,185,185,3,3,0,1,0
33,210,210,19,10,9,4,3
31,211,211,24,24,0,1,0
18,218,218,29,2,27,4,3
25,227,227,13,13,0,1,0
17,228,228,59,23,36,4,3
29,250,250,30,18,12,3,2
2,260,260,17,17,0,1,0
30,272,272,8,8,0,1,0
1,273,273,5,5,0,1,0
22,276,276,19,9,10,2,1
9,297,297,40,40,0,1,0
20,300,300,78,50,28,3,2
21,303,303,24,12,12,4,3
0,320,320,2,2,0,1,0
14,325,325,69,18,51,4,3
7,330,330,4,4,0,1,0
13,351,351,56,46,10,2,1
12,360,360,17,5,12,3,2
8,366,366,42,6,36,4,3
10,372,372,39,4,35,3,2
23,397,397,53,44,9,2,1
35,427,427,38,38,0,1,0
16,448,448,30,30,0,1,0
4,464,464,65,11,54,4,3
3,484,484,2,2,0,1,0
5,489,489,63,7,56,3,2

20,105,105,6,6,0,1,0
4,111,111,34,11,23,2,1
12,112,112,6,6,0,1,0
6,112,112,1,1,0,1,0
36,131,131,38,30,8,3,2
37,137,137,9,3,6,3,2
19,138,138,12,12,0,1,0
10,152,152,14,14,0,1,0
0,154,154,36,27,9,2,1
2,155,155,5,2,3,2,1
21,175,175,11,8,3,2,1
3,192,192,42,42,0,1,0
13,195,195,2,2,0,1,0
17,210,210,5,2,3,2,1
18,217,217,13,10,3,2,1
25,218,218,34,34,0,1,0
22,231,231,75,54,21,4,3
31,240,240,19,19,0,1,0
30,245,245,22,4,18,3,2
35,250,250,1,1,0,1,0
15,251,251,23,23,0,1,0
9,253,253,17,17,0,1,0
5,345,345,55,55,0,1,0
24,350,350,116,46,70,3,2
32,356,356,30,30,0,1,0
27,363,363,3,3,0,1,0
34,367,367,51,51,0,1,0
29,378,378,26,26,0,1,0
28,381,381,30,2,28,4,3
33,396,396,16,2,14,3,2
11,402,402,93,93,0,1,0
26,415,415,13,1,12,3,2
8,442,442,11,11,0,1,0
7,445,445,72,26,46,2,1
16,453,453,32,7,25,4,3
14,474,474,40,40,0,1,0
38,477,477,6,6,0,1,0
1,484,484,35,13,22,2,1
23,488,488,16,16,0,1,0

20,101,101,28,28,0,1,0
7,102,102,1,1,0,1,0
18,116,116,79,34,45,2,1
5,129,129,26,26,0,1,0
4,131,131,1,1,0,1,0
6,138,138,22,22,0,1,0
37,144,144,6,2,4,2,1
0,146,146,15,15,0,1,0
28,148,148,15,15,0,1,0
3,162,162,1,1,0,1,0
9,163,163,8,8,0,1,0
19,167,167,40,13,27,2,1
35,167,167,11,11,0,1,0
29,175,175,4,4,0,1,0
26,175,175,15,4,11,3,2
30,186,186,5,2,3,2,1
21,218,218,30,30,0,1,0
13,234,234,34,13,21,4,3
12,235,235,6,6,0,1,0
27,248,248,14,14,0,1,0
14,250,250,4,4,0,1,0
33,258,258,18,5,13,3,2
1,269,269,38,30,8,2,1
23,272,272,24,15,9,4,3
17,287,287,23,3,20,3,2
34,297,297,9,9,0,1,0
31,313,313,26,11,15,4,3
32,315,315,13,13,0,1,0
10,335,335,48,48,0,1,0
25,343,343,43,43,0,1,0
16,353,353,1,1,0,1,0
38,381,381,42,27,15,4,3
11,397,397,19,12,7,2,1
36,416,416,21,11,10,3,2
2,419,419,71,71,0,1,0
15,423,423,1,1,0,1,0
24,454,454,70,40,30,4,3
22,490,490,112,78,34,4,3
8,500,500,6,6,0,1,0

4,101,101,7,7,0,1,0
16,111,111,15,15,0,1,0
20,119,119,33,33,0,1,0
15,125,125,24,5,19,2,1
13,126,126,9,9,0,1,0
26,133,133,5,5,0,1,0
8,141,141,7,1,6,2,1
27,152,152,40,8,32,3,2
2,160,160,3,3,0,1,0
23,162,162,1,1,0,1,0
33,188,188,18,18,0,1,0
6,222,222,11,2,9,2,1
22,236,236,10,10,0,1,0
19,268,268,31,5,26,3,2
32,271,271,58,58,0,1,0
0,272,272,6,6,0,1,0
30,274,274,43,43,0,1,0
10,334,334,49,25,24,4,3
9,335,335,86,62,24,3,2
11,343,343,39,39,0,1,0
17,344,344,9,9,0,1,0
24,355,355,40,25,15,4,3
7,359,359,7,7,0,1,0
29,364,364,14,11,3,2,1
28,370,370,29,29,0,1,0
3,396,396,15,15,0,1,0
31,396,396,15,15,0,1,0
21,398,398,54,54,0,1,0
39,399,399,25,25,0,1,0
12,406,406,65,55,10,3,2
37,411,411,67,67,0,1,0
14,439,439,8,8,0,1,0
18,440,440,28,28,0,1,0
1,446,446,51,51,0,1,0
25,473,473,9,9,0,1,0
34,473,473,19,16,3,2,1
35,475,475,44,6,38,3,2
40,478,478,95,9,86,4,3
38,483,483,12,12,0,1,0
36,491,491,104,104,0,1,0
5,496,496,22,22,0,1,0

35,141,141,2,2,0,1,0
16,172,172,5,2,3,2,1
11,205,205,40,23,17,2,1
4,209,209,27,13,14,2,1
17,210,210,17,17,0,1,0
8,231,231,5,5,0,1,0
1,252,252,2,2,0,1,0
20,266,266,30,30,0,1,0
23,271,271,4,4,0,1,0
18,271,271,6,6,0,1,0
0,286,286,106,11,95,4,3
33,292,292,101,19,82,4,3
12,298,298,8,8,0,1,0
29,298,298,1,1,0,1,0
25,307,307,35,8,27,3,2
2,308,308,3,3,0,1,0
22,329,329,17,17,0,1,0
6,329,329,96,52,44,3,2
10,337,337,71,19,52,3,2
31,338,338,56,56,0,1,0
9,341,341,6,1,5,2,1
15,358,358,27,13,14,3,2
27,363,363,9,3,6,3,2
7,373,373,21,21,0,1,0
28,382,382,33,33,0,1,0
24,391,391,12,2,10,3,2
13,395,395,145,145,0,1,0
30,406,406,66,32,34,3,2
32,409,409,8,8,0,1,0
26,413,413,99,8,91,4,3
3,424,424,26,16,10,3,2
5,432,432,64,47,17,2,1
19,445,445,113,61,52,3,2
14,449,449,5,5,0,1,0
34,466,466,9,9,0,1,0
21,491,491,121,74,47,4,3

47,101,101,1,1,0,1,0
46,103,103,9,9,0,1,0
37,104,104,17,1,16,4,3
0,116,116,12,6,6,3,2
39,125,125,4,4,0,1,0
27,132,132,7,1,6,2,1
24,135,135,18,1,17,2,1
9,148,148,31,31,0,1,0
10,153,153,1,1,0,1,0
28,154,154,22,22,0,1,0
19,161,161,9,9,0,1,0
30,177,177,27,27,0,1,0
29,184,184,6,3,3,2,1
45,186,186,16,16,0,1,0
34,196,196,20,1,19,2,1
44,213,213,29,22,7,2,1
41,218,218,58,15,43,2,1
16,231,231,9,9,0,1,0
7,240,240,1,1,0,1,0
12,256,256,3,3,0,1,0
22,275,275,15,1,14,3,2
32,277,277,32,4,28,2,1
42,288,288,28,23,5,2,1
18,289,289,66,45,21,2,1
8,291,291,32,32,0,1,0
17,294,294,16,8,8,2,1
14,296,296,16,4,12,4,3
26,306,306,23,23,0,1,0
11,307,307,6,6,0,1,0
31,308,308,10,10,0,1,0
1,328,328,8,1,7,2,1
5,339,339,17,17,0,1,0
38,357,357,44,44,0,1,0
20,358,358,1,1,0,1,0
15,363,363,8,4,4,2,1
25,367,367,44,2,42,3,2
2,371,371,13,9,4,2,1
21,371,371,60,3,57,4,3
36,376,376,67,35,32,2,1
33,384,384,63,63,0,1,0
35,402,402,7,7,0,1,0
3,411,411,22,22,0,1,0
13,421,421,1,1,0,1,0
4,428,428,16,16,0,1,0
23,431,431,114,18,96,3,2
43,433,433,15,9,6,3,2
40,436,436,33,6,27,3,2
6,452,452,9,9,0,1,0

27,100,100,3,3,0,1,0
11,107,107,2,2,0,1,0
9,123,123,14,5,9,2,1
36,139,139,12,8,4,2,1
29,146,146,10,10,0,1,0
33,155,155,22,8,14,3,2
1,163,163,8,8,0,1,0
3,166,166,16,9,7,2,1
24,167,167,22,4,18,4,3
26,180,180,14,14,0,1,0
23,191,191,27,3,24,3,2
20,195,195,7,7,0,1,0
2,210,210,5,5,0,1,0
6,218,218,35,17,18,2,1
28,242,242,22,14,8,2,1
32,244,244,8,8,0,1,0
4,249,249,97,78,19,2,1
19,257,257,36,36,0,1,0
13,284,284,5,5,0,1,0
12,288,288,79,79,0,1,0
37,294,294,17,17,0,1,0
0,296,296,32,32,0,1,0
8,299,299,2,2,0,1,0
14,312,312,7,1,6,2,1
10,325,325,60,60,0,1,0
22,327,327,17,1,16,2,1
31,337,337,96,50,46,3,2
15,339,339,3,3,0,1,0
34,355,355,40,40,0,1,0
21,361,361,45,45,0,1,0
5,396,396,125,98,27,4,3
17,408,408,18,2,16,3,2
16,409,409,40,40,0,1,0
7,442,442,31,31,0,1,0
35,467,467,45,45,0,1,0
30,469,469,24,24,0,1,0
25,487,487,37,37,0,1,0
18,487,487,105,63,42,3,2

36,126,126,6,6,0,1,0
25,136,136,2,2,0,1,0
18,137,137,17,2,15,2,1
20,138,138,7,7,0,1,0
7,152,152,15,5,10,3,2
26,158,158,14,14,0,1,0
31,171,171,11,11,0,1,0
0,179,179,33,33,0,1,0
10,190,190,5,2,3,2,1
21,194,194,80,9,71,4,3
27,197,197,10,5,5,2,1
3,200,200,11,11,0,1,0
8,210,210,59,11,48,2,1
15,212,212,14,14,0,1,0
19,219,219,4,4,0,1,0
23,245,245,20,20,0,1,0
13,249,249,39,39,0,1,0
29,251,251,17,17,0,1,0
37,281,281,64,64,0,1,0
9,295,295,20,5,15,4,3
30,295,295,1,1,0,1,0
24,312,312,91,34,57,4,3
5,320,320,107,38,69,4,3
6,335,335,20,20,0,1,0
34,366,366,22,14,8,3,2
1,376,376,6,6,0,1,0
32,387,387,19,19,0,1,0
11,390,390,49,49,0,1,0
2,414,414,18,18,0,1,0
33,447,447,8,8,0,1,0
14,449,449,2,2,0,1,0
17,453,453,13,4,9,2,1
22,455,455,28,7,21,2,1
28,462,462,42,1,41,2,1
4,467,467,28,19,9,2,1
16,470,470,71,1,70,4,3
12,480,480,116,11,105,4,3
35,493,493,103,94,9,2,1

17,127,127,87,45,42,2,1
0,148,148,44,18,26,2,1
31,151,151,29,12,17,2,1
7,156,156,1,1,0,1,0
28,158,158,1,1,0,1,0
13,194,194,69,15,54,4,3
30,217,217,6,3,3,2,1
27,225,225,12,1,11,2,1
24,229,229,5,5,0,1,0
6,233,233,56,56,0,1,0
25,251,251,1,1,0,1,0
20,264,264,5,5,0,1,0
14,293,293,17,12,5,2,1
4,294,294,51,51,0,1,0
10,297,297,4,4,0,1,0
26,299,299,73,73,0,1,0
16,299,299,5,5,0,1,0
21,303,303,31,4,27,4,3
22,312,312,66,39,27,4,3
3,332,332,20,4,16,3,2
33,342,342,65,39,26,3,2
29,350,350,12,1,11,2,1
19,378,378,38,38,0,1,0
11,395,395,19,15,4,2,1
15,398,398,26,26,0,1,0
8,399,399,72,72,0,1,0
18,399,399,4,1,3,2,1
12,403,403,73,45,28,4,3
32,421,421,4,4,0,1,0
2,427,427,44,44,0,1,0
5,438,438,83,23,60,4,3
23,445,445,7,7,0,1,0
1,469,469,16,16,0,1,0
34,473,473,15,15,0,1,0
9,496,496,30,1,29,3,2

21,107,107,10,10,0,1,0
42,116,116,15,15,0,1,0
9,119,119,1,1,0,1,0
31,124,124,4,1,3,2,1
3,137,137,4,4,0,1,0
44,164,164,6,6,0,1,0
41,181,181,4,4,0,1,0
38,188,188,58,4,54,4,3
37,191,191,30,18,12,2,1
16,195,195,33,20,13,2,1
27,202,202,23,2,21,4,3
43,211,211,9,6,3,2,1
46,212,212,8,8,0,1,0
33,218,218,3,3,0,1,0
11,220,220,8,8,0,1,0
18,225,225,4,4,0,1,0
2,238,238,24,8,16,3,2
13,250,250,14,11,3,2,1
32,253,253,51,51,0,1,0
1,257,257,1,1,0,1,0
29,263,263,42,42,0,1,0
10,267,267,4,4,0,1,0
28,270,270,8,5,3,2,1
8,284,284,32,32,0,1,0
30,299,299,4,4,0,1,0
0,304,304,9,9,0,1,0
40,306,306,13,13,0,1,0
6,310,310,23,5,18,4,3
15,311,311,8,2,6,2,1
14,313,313,36,15,21,4,3
26,315,315,5,1,4,2,1
12,315,315,81,5,76,3,2
5,335,335,5,5,0,1,0
34,361,361,201,201,0,1,0
25,385,385,33,8,25,2,1
39,395,395,25,5,20,4,3
19,396,396,16,16,0,1,0
45,404,404,6,6,0,1,0
17,447,447,1,1,0,1,0
7,448,448,55,11,44,3,2
4,451,451,130,80,50,2,1
23,469,469,14,14,0,1,0
22,474,474,18,14,4,2,1
35,479,479,23,7,16,3,2
36,488,488,12,6,6,3,2
24,496,496,8,2,6,2,1
20,500,500,102,2,100,4,3

32,139,139,13,10,3,2,1
10,144,144,45,20,25,2,1
38,146,146,23,11,12,3,2
28,147,147,18,13,5,2,1
23,160,160,8,8,0,1,0
13,173,173,1,1,0,1,0
19,178,178,12,12,0,1,0
35,203,203,3,3,0,1,0
11,206,206,64,45,19,2,1
16,207,207,12,7,5,2,1
27,212,212,12,12,0,1,0
29,215,215,10,7,3,2,1
5,225,225,18,6,12,4,3
7,233,233,21,9,12,2,1
25,234,234,95,51,44,2,1
15,236,236,33,18,15,4,3
36,242,242,59,59,0,1,0
18,253,253,7,7,0,1,0
37,263,263,22,22,0,1,0
4,298,298,1,1,0,1,0
8,302,302,52,52,0,1,0
2,306,306,34,34,0,1,0
12,321,321,59,59,0,1,0
31,327,327,21,21,0,1,0
6,346,346,12,12,0,1,0
34,349,349,48,28,20,3,2
26,360,360,23,11,12,4,3
3,375,375,54,54,0,1,0
30,391,391,13,13,0,1,0
24,425,425,82,4,78,4,3
1,438,438,18,4,14,2,1
17,441,441,50,4,46,2,1
14,475,475,51,41,10,2,1
22,476,476,27,16,11,2,1
21,476,476,39,19,20,2,1
0,478,478,5,5,0,1,0
33,483,483,10,2,8,3,2
20,498,498,26,9,17,2,1
9,500,500,28,2,26,3,2

22,102,102,4,4,0,1,0
38,111,111,45,45,0,1,0
26,141,141,17,17,0,1,0
23,164,164,21,21,0,1,0
4,183,183,19,13,6,3,2
10,193,193,13,13,0,1,0
29,196,196,23,23,0,1,0
16,209,209,7,7,0,1,0
39,210,210,44,19,25,2,1
8,231,231,66,66,0,1,0
15,232,232,48,25,23,2,1
30,233,233,7,7,0,1,0
28,247,247,36,16,20,2,1
6,249,249,7,2,5,2,1
20,253,253,2,2,0,1,0
2,259,259,16,16,0,1,0
34,261,261,12,7,5,2,1
12,283,283,24,6,18,4,3
35,285,285,5,5,0,1,0
31,286,286,11,1,10,2,1
19,296,296,7,4,3,2,1
9,297,297,25,25,0,1,0
37,297,297,29,29,0,1,0
11,298,298,35,35,0,1,0
36,311,311,51,9,42,4,3
27,322,322,9,9,0,1,0
7,330,330,67,51,16,3,2
13,343,343,4,4,0,1,0
0,347,347,33,17,16,3,2
25,357,357,7,7,0,1,0
24,372,372,33,9,24,4,3
40,390,390,61,18,43,2,1
32,455,455,26,26,0,1,0
3,460,460,36,14,22,2,1
21,461,461,50,50,0,1,0
14,473,473,68,18,50,3,2
17,475,475,4,4,0,1,0
33,477,477,11,1,10,3,2
5,486,486,17,2,15,4,3
18,491,491,97,97,0,1,0
1,494,494,61,25,36,4,3

11,114,114,10,4,6,3,2
27,116,116,28,10,18,4,3
36,134,134,3,3,0,1,0
4,137,137,2,2,0,1,0
32,137,137,10,3,7,2,1
31,145,145,18,11,7,2,1
13,153,153,25,25,0,1,0
1,156,156,83,83,0,1,0
29,163,163,3,3,0,1,0
22,186,186,18,18,0,1,0
33,213,213,24,24,0,1,0
20,218,218,37,9,28,3,2
16,228,228,4,4,0,1,0
25,228,228,15,9,6,2,1
17,233,233,41,41,0,1,0
18,234,234,70,62,8,2,1
9,244,244,25,25,0,1,0
7,253,253,11,7,4,2,1
14,274,274,2,2,0,1,0
3,276,276,47,47,0,1,0
5,287,287,47,47,0,1,0
19,289,289,15,15,0,1,0
0,300,300,18,12,6,3,2
2,300,300,26,26,0,1,0
8,307,307,11,4,7,2,1
21,308,308,13,1,12,2,1
10,310,310,12,8,4,2,1
30,315,315,4,4,0,1,0
6,369,369,67,67,0,1,0
24,378,378,43,22,21,2,1
15,425,425,79,79,0,1,0
35,440,440,20,20,0,1,0
12,443,443,50,50,0,1,0
23,444,444,103,103,0,1,0
34,444,444,5,5,0,1,0
26,473,473,19,19,0,1,0
28,500,500,44,44,0,1,0

40,113,113,11,2,9,4,3
9,116,116,33,33,0,1,0
23,135,135,13,13,0,1,0
36,165,165,16,1,15,3,2
37,172,172,31,31,0,1,0
11,173,173,13,5,8,2,1
8,181,181,1,1,0,1,0
24,208,208,20,3,17,2,1
15,221,221,53,53,0,1,0
7,238,238,6,3,3,2,1
0,258,258,20,10,10,3,2
28,260,260,20,20,0,1,0
29,270,270,42,18,24,2,1
5,276,276,30,21,9,4,3
4,280,280,18,15,3,2,1
21,297,297,12,8,4,2,1
13,298,298,20,12,8,3,2
16,305,305,13,1,12,3,2
32,312,312,27,19,8,3,2
34,324,324,69,57,12,4,3
41,338,338,33,12,21,4,3
12,345,345,44,44,0,1,0
27,361,361,19,11,8,3,2
18,365,365,99,99,0,1,0
22,383,383,81,57,24,4,3
6,383,383,1,1,0,1,0
31,385,385,52,52,0,1,0
20,418,418,3,3,0,1,0
26,430,430,51,14,37,4,3
17,434,434,47,5,42,4,3
19,437,437,2,2,0,1,0
10,438,438,6,3,3,2,1
35,441,441,8,1,7,2,1
38,443,443,48,48,0,1,0
30,452,452,40,1,39,4,3
3,459,459,3,3,0,1,0
1,461,461,126,81,45,4,3
39,478,478,28,28,0,1,0
2,480,480,61,30,31,2,1
14,483,483,14,14,0,1,0
33,488,488,3,3,0,1,0
25,497,497,21,15,6,3,2

4,101,101,1,1,0,1,0
1,102,102,24,21,3,2,1
24,129,129,12,12,0,1,0
19,136,136,4,4,0,1,0
7,163,163,1,1,0,1,0
12,171,171,32,14,18,3,2
9,180,180,29,17,12,3,2
11,207,207,35,35,0,1,0
28,210,210,29,3,26,3,2
10,218,218,31,1,30,2,1
26,224,224,77,38,39,4,3
34,246,246,42,4,38,2,1
14,285,285,63,63,0,1,0
23,289,289,59,59,0,1,0
33,292,292,7,2,5,2,1
31,302,302,17,5,12,4,3
18,307,307,28,28,0,1,0
15,307,307,59,10,49,2,1
2,323,323,30,21,9,4,3
0,351,351,1,1,0,1,0
21,355,355,19,19,0,1,0
5,358,358,1,1,0,1,0
27,368,368,17,5,12,2,1
30,375,375,4,4,0,1,0
29,385,385,1,1,0,1,0
32,398,398,34,22,12,4,3
13,405,405,134,125,9,4,3
20,411,411,87,49,38,2,1
6,436,436,92,16,76,3,2
22,445,445,21,6,15,4,3
3,448,448,90,38,52,4,3
16,449,449,69,21,48,3,2
17,452,452,11,11,0,1,0
25,457,457,24,24,0,1,0
8,484,484,13,6,7,2,1

33,102,102,11,11,0,1,0
15,108,108,17,17,0,1,0
11,109,109,1,1,0,1,0
35,113,113,18,18,0,1,0
7,126,126,24,24,0,1,0
27,132,132,58,32,26,4,3
5,134,134,14,6,8,2,1
31,169,169,19,19,0,1,0
2,171,171,18,18,0,1,0
10,180,180,2,2,0,1,0
9,199,199,43,43,0,1,0
17,201,201,6,6,0,1,0
14,218,218,14,7,7,2,1
19,234,234,4,1,3,2,1
34,236,236,18,2,16,4,3
23,248,248,34,26,8,2,1
13,250,250,36,26,10,2,1
26,266,266,6,6,0,1,0
18,290,290,11,11,0,1,0
28,303,303,13,13,0,1,0
25,330,330,17,13,4,2,1
3,330,330,5,5,0,1,0
1,332,332,126,88,38,4,3
16,340,340,41,41,0,1,0
21,347,347,5,5,0,1,0
30,353,353,67,45,22,3,2
22,363,363,10,10,0,1,0
0,365,365,5,2,3,2,1
24,369,369,7,4,3,2,1
6,370,370,25,13,12,2,1
29,371,371,15,15,0,1,0
12,385,385,67,16,51,4,3
8,396,396,95,51,44,3,2
32,421,421,112,112,0,1,0
20,423,423,58,7,51,4,3
4,458,458,50,50,0,1,0

14,104,104,16,16,0,1,0
19,106,106,5,5,0,1,0
23,111,111,2,2,0,1,0
17,125,125,3,3,0,1,0
31,170,170,9,9,0,1,0
1,181,181,1,1,0,1,0
27,181,181,11,11,0,1,0
18,186,186,16,16,0,1,0
8,203,203,16,8,8,2,1
22,207,207,31,31,0,1,0
29,219,219,14,14,0,1,0
35,235,235,20,9,11,4,3
6,259,259,87,87,0,1,0
28,270,270,20,1,19,2,1
20,293,293,3,3,0,1,0
30,303,303,6,1,5,2,1
34,309,309,4,1,3,2,1
33,323,323,60,51,9,2,1
32,325,325,16,16,0,1,0
4,346,346,19,1,18,4,3
10,365,365,50,50,0,1,0
5,388,388,42,12,30,2,1
16,389,389,137,111,26,3,2
21,395,395,12,12,0,1,0
7,397,397,2,2,0,1,0
12,409,409,3,3,0,1,0
3,422,422,8,8,0,1,0
25,424,424,239,239,0,1,0
9,435,435,170,112,58,3,2
26,437,437,50,21,29,2,1
13,452,452,45,24,21,4,3
24,472,472,26,11,15,2,1
0,477,477,67,32,35,2,1
2,482,482,36,21,15,2,1
15,487,487,106,95,11,2,1
11,496,496,85,58,27,4,3

31,106,106,11,11,0,1,0
37,134,134,7,7,0,1,0
23,153,153,23,17,6,2,1
25,153,153,1,1,0,1,0
29,169,169,15,3,12,2,1
20,169,169,5,5,0,1,0
17,174,174,25,25,0,1,0
9,175,175,6,6,0,1,0
12,188,188,31,13,18,4,3
1,197,197,2,2,0,1,0
0,198,198,10,10,0,1,0
13,206,206,7,4,3,2,1
30,211,211,29,11,18,4,3
36,224,224,6,2,4,2,1
38,227,227,16,16,0,1,0
4,227,227,8,8,0,1,0
3,234,234,21,18,3,2,1
2,243,243,28,2,26,3,2
7,246,246,5,5,0,1,0
19,252,252,22,16,6,3,2
5,265,265,35,5,30,3,2
39,282,282,67,67,0,1,0
6,313,313,1,1,0,1,0
35,326,326,32,10,22,3,2
26,327,327,68,33,35,4,3
34,348,348,80,73,7,2,1
15,379,379,68,68,0,1,0
11,401,401,1,1,0,1,0
24,412,412,63,21,42,2,1
27,427,427,39,24,15,3,2
32,443,443,71,29,42,3,2
33,443,443,4,4,0,1,0
22,448,448,10,7,3,2,1
8,476,476,1,1,0,1,0
21,478,478,11,11,0,1,0
10,479,479,46,8,38,3,2
14,486,486,159,84,75,4,3
16,489,489,182,103,79,4,3
18,492,492,51,2,49,3,2
28,497,497,70,70,0,1,0

11,103,103,4,4,0,1,0
33,105,105,8,3,5,2,1
0,118,118,20,2,18,4,3
16,131,131,19,5,14,3,2
27,152,152,7,2,5,2,1
31,154,154,20,20,0,1,0
3,163,163,15,5,10,3,2
7,175,175,1,1,0,1,0
28,179,179,5,5,0,1,0
18,183,183,44,44,0,1,0
5,186,186,11,11,0,1,0
22,213,213,1,1,0,1,0
1,224,224,35,29,6,3,2
10,234,234,52,36,16,3,2
13,263,263,10,2,8,2,1
15,285,285,12,12,0,1,0
34,290,290,8,8,0,1,0
26,294,294,28,28,0,1,0
24,329,329,28,5,23,2,1
32,381,381,16,1,15,4,3
20,400,400,60,37,23,2,1
29,404,404,59,23,36,4,3
30,407,407,15,5,10,2,1
14,408,408,23,23,0,1,0
19,423,423,19,19,0,1,0
8,426,426,53,31,22,3,2
21,427,427,19,13,6,2,1
12,436,436,64,8,56,4,3
4,445,445,233,185,48,3,2
25,457,457,73,73,0,1,0
23,473,473,201,201,0,1,0
6,474,474,52,52,0,1,0
2,475,475,71,29,42,4,3
17,489,489,31,7,24,3,2
9,491,491,54,34,20,3,2

27,101,101,47,14,33,2,1
20,106,106,7,7,0,1,0
42,116,116,26,18,8,2,1
31,118,118,5,1,4,2,1
2,119,119,26,16,10,2,1
14,127,127,7,7,0,1,0
43,144,144,5,1,4,2,1
17,144,144,2,2,0,1,0
1,146,146,5,5,0,1,0
18,155,155,19,9,10,3,2
16,192,192,1,1,0,1,0
13,194,194,7,7,0,1,0
7,205,205,25,4,21,2,1
34,246,246,7,1,6,3,2
40,271,271,28,14,14,2,1
0,288,288,18,9,9,2,1
9,294,294,78,60,18,2,1
24,294,294,9,9,0,1,0
8,296,296,6,6,0,1,0
3,312,312,19,19,0,1,0
5,325,325,27,2,25,4,3
30,328,328,37,17,20,2,1
35,329,329,54,36,18,3,2
29,340,340,10,5,5,2,1
41,343,343,16,16,0,1,0
39,349,349,12,12,0,1,0
11,356,356,4,4,0,1,0
4,356,356,11,6,5,2,1
36,360,360,26,8,18,3,2
15,372,372,20,9,11,2,1
38,379,379,15,15,0,1,0
22,387,387,7,7,0,1,0
6,389,389,18,18,0,1,0
19,396,396,47,47,0,1,0
28,431,431,106,106,0,1,0
25,434,434,6,6,0,1,0
10,439,439,75,75,0,1,0
21,440,440,121,58,63,4,3
32,443,443,15,8,7,2,1
12,443,443,7,7,0,1,0
33,448,448,83,21,62,4,3
26,467,467,38,21,17,2,1
37,484,484,27,2,25,2,1
23,489,489,46,32,14,2,1

29,110,110,30,30,0,1,0
19,122,122,12,12,0,1,0
2,152,152,16,1,15,2,1
33,163,163,1,1,0,1,0
36,166,166,38,29,9,4,3
30,166,166,13,13,0,1,0
32,175,175,20,20,0,1,0
20,209,209,1,1,0,1,0
6,210,210,40,40,0,1,0
14,227,227,62,62,0,1,0
18,229,229,8,4,4,2,1
10,244,244,1,1,0,1,0
15,247,247,20,3,17,2,1
12,250,250,30,30,0,1,0
24,252,252,95,37,58,3,2
41,263,263,6,6,0,1,0
27,265,265,3,3,0,1,0
35,271,271,5,5,0,1,0
40,274,274,14,3,11,2,1
5,275,275,1,1,0,1,0
13,275,275,27,27,0,1,0
11,288,288,44,44,0,1,0
31,318,318,3,3,0,1,0
16,321,321,1,1,0,1,0
8,325,325,23,23,0,1,0
0,327,327,33,23,10,2,1
26,329,329,20,20,0,1,0
25,332,332,2,2,0,1,0
38,333,333,38,4,34,2,1
1,354,354,4,4,0,1,0
22,364,364,31,16,15,2,1
37,380,380,44,44,0,1,0
9,390,390,64,64,0,1,0
17,392,392,1,1,0,1,0
28,426,426,84,60,24,4,3
23,430,430,20,11,9,2,1
39,442,442,47,47,0,1,0
34,471,471,57,22,35,4,3
4,481,481,79,79,0,1,0
7,484,484,90,27,63,4,3
3,488,488,24,24,0,1,0
21,498,498,41,41,0,1,0

22,111,111,6,3,3,2,1
8,128,128,8,8,0,1,0
14,130,130,39,19,20,2,1
1,130,130,4,4,0,1,0
31,132,132,20,8,12,3,2
16,133,133,6,3,3,2,1
33,138,138,6,6,0,1,0
20,145,145,5,5,0,1,0
12,169,169,4,4,0,1,0
30,180,180,6,6,0,1,0
23,224,224,18,18,0,1,0
34,233,233,2,2,0,1,0
25,241,241,9,9,0,1,0
37,243,243,54,6,48,2,1
21,250,250,26,26,0,1,0
19,259,259,39,7,32,3,2
29,263,263,25,25,0,1,0
5,279,279,1,1,0,1,0
17,294,294,6,3,3,2,1
39,295,295,43,22,21,2,1
18,304,304,8,2,6,3,2
40,309,309,56,30,26,3,2
11,316,316,28,28,0,1,0
0,324,324,2,2,0,1,0
24,343,343,58,58,0,1,0
35,344,344,38,38,0,1,0
38,348,348,49,13,36,4,3
13,349,349,8,2,6,3,2
28,354,354,25,11,14,3,2
15,376,376,78,64,14,4,3
4,406,406,102,102,0,1,0
32,414,414,59,59,0,1,0
7,435,435,24,14,10,3,2
36,444,444,54,45,9,4,3
3,450,450,78,36,42,2,1
2,450,450,135,120,15,4,3
9,458,458,47,11,36,4,3
6,466,466,7,1,6,3,2
10,469,469,38,14,24,4,3
27,479,479,57,19,38,3,2
26,496,496,4,1,3,2,1

24,101,101,7,4,3,2,1
30,103,103,15,15,0,1,0
27,107,107,14,14,0,1,0
6,108,108,32,4,28,3,2
4,116,116,4,4,0,1,0
45,132,132,3,3,0,1,0
11,146,146,28,13,15,2,1
8,152,152,4,4,0,1,0
16,162,162,10,1,9,4,3
9,165,165,4,4,0,1,0
29,168,168,24,3,21,2,1
32,177,177,16,10,6,2,1
17,186,186,11,1,10,2,1
42,188,188,23,5,18,4,3
13,197,197,37,37,0,1,0
43,211,211,17,17,0,1,0
23,225,225,1,1,0,1,0
35,229,229,30,3,27,2,1
34,246,246,32,14,18,4,3
0,248,248,10,4,6,2,1
12,257,257,36,36,0,1,0
5,266,266,1,1,0,1,0
2,273,273,27,23,4,2,1
10,274,274,32,14,18,3,2
25,291,291,40,30,10,3,2
36,301,301,2,2,0,1,0
1,308,308,17,9,8,2,1
14,315,315,21,9,12,3,2
7,325,325,25,5,20,2,1
22,331,331,3,3,0,1,0
19,334,334,11,11,0,1,0
40,377,377,11,3,8,2,1
33,380,380,20,1,19,2,1
20,394,394,3,3,0,1,0
41,395,395,66,66,0,1,0
15,401,401,22,22,0,1,0
18,417,417,23,23,0,1,0
28,436,436,73,31,42,3,2
21,455,455,12,12,0,1,0
39,465,465,84,84,0,1,0
31,469,469,38,38,0,1,0
37,475,475,45,45,0,1,0
26,480,480,56,18,38,2,1
38,481,481,1,1,0,1,0
3,492,492,61,4,57,4,3
44,498,498,75,75,0,1,0

30,129,129,5,1,4,2,1
12,129,129,1,1,0,1,0
13,129,129,19,1,18,4,3
4,135,135,11,11,0,1,0
40,137,137,12,5,7,2,1
6,148,148,8,8,0,1,0
35,161,161,10,10,0,1,0
17,172,172,10,10,0,1,0
26,173,173,15,7,8,3,2
23,189,189,86,11,75,4,3
1,189,189,3,3,0,1,0
2,194,194,1,1,0,1,0
5,197,197,35,13,22,2,1
39,201,201,4,4,0,1,0
16,219,219,56,56,0,1,0
29,219,219,1,1,0,1,0
14,226,226,1,1,0,1,0
20,268,268,34,34,0,1,0
41,269,269,22,2,20,3,2
27,284,284,49,49,0,1,0
38,286,286,9,3,6,3,2
36,312,312,13,1,12,2,1
18,313,313,9,6,3,2,1
10,321,321,9,9,0,1,0
22,340,340,10,10,0,1,0
7,344,344,23,23,0,1,0
8,355,355,29,29,0,1,0
25,359,359,30,30,0,1,0
0,361,361,14,7,7,2,1
21,366,366,10,7,3,2,1
37,367,367,39,39,0,1,0
24,378,378,61,21,40,2,1
32,384,384,38,38,0,1,0
3,407,407,13,13,0,1,0
15,410,410,16,16,0,1,0
19,443,443,97,97,0,1,0
33,452,452,82,56,26,2,1
28,452,452,1,1,0,1,0
9,461,461,125,74,51,4,3
34,471,471,47,4,43,3,2
11,480,480,113,109,4,2,1
31,487,487,91,50,41,2,1

0,120,120,32,32,0,1,0
23,131,131,24,21,3,2,1
20,141,141,22,4,18,2,1
36,141,141,14,2,12,3,2
13,191,191,106,106,0,1,0
4,203,203,1,1,0,1,0
10,207,207,6,6,0,1,0
26,222,222,20,3,17,2,1
19,233,233,24,24,0,1,0
30,239,239,48,21,27,4,3
29,250,250,1,1,0,1,0
27,255,255,31,2,29,2,1
12,262,262,14,14,0,1,0
5,268,268,38,38,0,1,0
17,275,275,16,16,0,1,0
7,280,280,13,13,0,1,0
15,293,293,6,6,0,1,0
25,297,297,67,55,12,4,3
34,308,308,8,8,0,1,0
6,322,322,43,22,21,4,3
24,325,325,11,11,0,1,0
32,331,331,16,16,0,1,0
1,336,336,133,79,54,4,3
14,341,341,20,3,17,3,2
33,342,342,26,3,23,2,1
8,351,351,13,5,8,2,1
21,353,353,15,5,10,3,2
2,360,360,13,13,0,1,0
31,379,379,59,59,0,1,0
16,421,421,11,2,9,4,3
35,423,423,25,1,24,3,2
28,437,437,46,18,28,2,1
22,437,437,2,2,0,1,0
3,441,441,38,38,0,1,0
18,460,460,111,39,72,4,3
9,482,482,37,13,24,4,3
11,487,487,16,8,8,3,2

39,113,113,10,10,0,1,0
1,143,143,1,1,0,1,0
5,157,157,6,2,4,2,1
14,172,172,28,28,0,1,0
13,181,181,11,11,0,1,0
42,183,183,55,55,0,1,0
2,194,194,16,16,0,1,0
23,202,202,15,12,3,2,1
38,207,207,6,6,0,1,0
0,221,221,30,18,12,4,3
32,222,222,9,9,0,1,0
12,244,244,18,18,0,1,0
3,251,251,7,1,6,3,2
27,254,254,56,56,0,1,0
40,257,257,22,22,0,1,0
16,258,258,15,5,10,2,1
31,264,264,22,13,9,4,3
8,282,282,50,50,0,1,0
41,282,282,7,7,0,1,0
34,284,284,1,1,0,1,0
10,314,314,51,51,0,1,0
18,315,315,14,9,5,2,1
35,318,318,1,1,0,1,0
28,331,331,74,74,0,1,0
29,334,334,17,5,12,3,2
33,357,357,22,8,14,2,1
15,359,359,20,2,18,3,2
20,379,379,20,10,10,3,2
19,386,386,23,2,21,4,3
21,401,401,56,25,31,2,1
6,407,407,13,1,12,3,2
25,414,414,18,18,0,1,0
9,415,415,62,62,0,1,0
26,422,422,50,39,11,2,1
7,422,422,25,9,16,3,2
24,424,424,22,2,20,2,1
11,429,429,110,5,105,4,3
43,431,431,157,67,90,3,2
4,436,436,3,3,0,1,0
30,465,465,41,9,32,3,2
36,481,481,17,17,0,1,0
22,487,487,37,16,21,4,3
37,492,492,56,46,10,2,1
17,496,496,4,1,3,2,1

5,103,103,16,10,6,2,1
38,105,105,11,11,0,1,0
29,117,117,1,1,0,1,0
28,145,145,15,15,0,1,0
35,146,146,11,11,0,1,0
45,155,155,2,2,0,1,0
34,159,159,13,3,10,3,2
6,161,161,9,9,0,1,0
24,191,191,4,4,0,1,0
10,196,196,8,4,4,2,1
46,211,211,24,24,0,1,0
1,231,231,22,22,0,1,0
25,234,234,29,29,0,1,0
37,247,247,18,6,12,3,2
8,250,250,50,50,0,1,0
13,263,263,5,5,0,1,0
44,275,275,2,2,0,1,0
18,292,292,3,3,0,1,0
31,297,297,13,13,0,1,0
26,318,318,17,17,0,1,0
36,323,323,105,73,32,3,2
32,342,342,47,47,0,1,0
41,342,342,39,13,26,4,3
19,347,347,57,7,50,2,1
0,352,352,13,1,12,3,2
4,356,356,55,55,0,1,0
7,357,357,45,45,0,1,0
23,387,387,9,3,6,3,2
14,389,389,52,8,44,3,2
39,389,389,21,21,0,1,0
43,389,389,76,1,75,4,3
20,390,390,26,26,0,1,0
40,409,409,131,35,96,4,3
16,423,423,45,15,30,2,1
21,430,430,23,23,0,1,0
42,430,430,46,15,31,2,1
3,440,440,8,8,0,1,0
12,453,453,10,10,0,1,0
11,455,455,22,17,5,2,1
2,461,461,8,8,0,1,0
9,464,464,40,31,9,2,1
27,471,471,13,13,0,1,0
30,472,472,54,54,0,1,0
17,474,474,6,6,0,1,0
15,479,479,20,20,0,1,0
33,492,492,7,7,0,1,0
22,496,496,57,26,31,2,1

38,100,100,20,20,0,1,0
8,101,101,3,3,0,1,0
6,130,130,32,8,24,2,1
39,131,131,13,7,6,2,1
48,133,133,28,28,0,1,0
23,136,136,14,14,0,1,0
17,148,148,14,14,0,1,0
34,172,172,12,12,0,1,0
1,179,179,17,17,0,1,0
40,187,187,8,8,0,1,0
25,199,199,2,2,0,1,0
10,211,211,10,10,0,1,0
16,214,214,9,9,0,1,0
9,231,231,11,4,7,2,1
7,235,235,38,38,0,1,0
33,238,238,76,76,0,1,0
27,269,269,1,1,0,1,0
5,272,272,39,24,15,2,1
4,281,281,40,5,35,2,1
20,285,285,8,8,0,1,0
42,287,287,56,56,0,1,0
29,291,291,19,4,15,4,3
30,294,294,24,4,20,4,3
12,305,305,16,6,10,3,2
35,341,341,4,4,0,1,0
44,344,344,11,11,0,1,0
31,350,350,33,1,32,3,2
14,352,352,13,8,5,2,1
13,352,352,4,4,0,1,0
47,354,354,18,15,3,2,1
18,361,361,43,15,28,2,1
21,374,374,20,20,0,1,0
22,376,376,85,57,28,3,2
11,387,387,15,15,0,1,0
0,395,395,10,10,0,1,0
32,407,407,12,12,0,1,0
26,415,415,19,19,0,1,0
28,415,415,7,1,6,2,1
2,434,434,1,1,0,1,0
46,442,442,21,7,14,2,1
24,447,447,5,5,0,1,0
36,466,466,104,104,0,1,0
43,472,472,9,9,0,1,0
15,473,473,23,23,0,1,0
3,474,474,23,15,8,3,2
45,475,475,51,40,11,2,1
19,477,477,33,33,0,1,0
37,488,488,37,37,0,1,0
41,494,494,33,5,28,2,1

6,109,109,3,3,0,1,0
11,110,110,6,6,0,1,0
33,119,119,15,5,10,3,2
37,120,120,25,25,0,1,0
9,129,129,14,14,0,1,0
17,129,129,2,2,0,1,0
40,140,140,12,12,0,1,0
28,149,149,19,8,11,2,1
19,159,159,4,4,0,1,0
22,163,163,24,9,15,4,3
0,165,165,1,1,0,1,0
7,173,173,1,1,0,1,0
16,175,175,5,5,0,1,0
32,180,180,7,7,0,1,0
21,196,196,14,4,10,2,1
25,206,206,9,9,0,1,0
30,211,211,6,6,0,1,0
4,229,229,18,18,0,1,0
8,232,232,11,11,0,1,0
44,251,251,20,20,0,1,0
23,258,258,16,8,8,2,1
27,288,288,34,34,0,1,0
34,292,292,27,27,0,1,0
29,296,296,23,23,0,1,0
42,300,300,56,56,0,1,0
39,300,300,39,29,10,2,1
18,307,307,90,90,0,1,0
31,318,318,29,16,13,2,1
10,326,326,3,3,0,1,0
38,329,329,91,91,0,1,0
15,354,354,9,3,6,2,1
13,366,366,11,11,0,1,0
14,375,375,1,1,0,1,0
2,402,402,33,21,12,3,2
20,420,420,27,27,0,1,0
5,425,425,135,135,0,1,0
26,433,433,37,37,0,1,0
46,435,435,51,51,0,1,0
36,443,443,8,8,0,1,0
3,445,445,87,23,64,3,2
47,455,455,33,33,0,1,0
24,461,461,4,4,0,1,0
41,477,477,7,7,0,1,0
43,479,479,74,45,29,3,2
45,480,480,8,8,0,1,0
1,488,488,9,9,0,1,0
35,492,492,46,28,18,3,2
12,496,496,15,5,10,2,1

18,101,101,11,8,3,2,1
40,103,103,9,9,0,1,0
36,109,109,7,7,0,1,0
19,120,120,1,1,0,1,0
10,120,120,1,1,0,1,0
7,128,128,5,1,4,2,1
5,135,135,26,15,11,3,2
9,138,138,1,1,0,1,0
1,156,156,2,2,0,1,0
22,160,160,15,15,0,1,0
21,168,168,11,11,0,1,0
25,172,172,10,1,9,2,1
2,192,192,28,28,0,1,0
11,208,208,5,5,0,1,0
15,212,212,71,71,0,1,0
20,237,237,30,30,0,1,0
32,239,239,9,1,8,2,1
39,250,250,4,4,0,1,0
16,261,261,4,1,3,2,1
6,268,268,1,1,0,1,0
14,273,273,3,3,0,1,0
29,281,281,14,14,0,1,0
33,282,282,9,5,4,2,1
38,288,288,59,18,41,3,2
17,306,306,27,27,0,1,0
31,312,312,53,3,50,2,1
28,326,326,37,21,16,3,2
13,336,336,110,41,69,4,3
8,343,343,29,29,0,1,0
12,352,352,9,9,0,1,0
27,373,373,32,32,0,1,0
35,388,388,3,3,0,1,0
26,393,393,28,13,15,4,3
4,422,422,45,5,40,2,1
23,429,429,283,230,53,4,3
30,430,430,24,24,0,1,0
41,440,440,23,2,21,3,2
24,444,444,45,45,0,1,0
0,464,464,27,27,0,1,0
37,469,469,6,2,4,2,1
34,473,473,29,12,17,2,1
3,488,488,103,73,30,3,2

11,116,116,7,2,5,2,1
3,124,124,16,1,15,4,3
12,134,134,5,5,0,1,0
43,136,136,1,1,0,1,0
33,140,140,24,17,7,2,1
47,141,141,1,1,0,1,0
9,145,145,11,11,0,1,0
6,154,154,17,4,13,2,1
45,155,155,39,39,0,1,0
38,173,173,16,4,12,3,2
1,176,176,42,42,0,1,0
4,183,183,15,15,0,1,0
0,193,193,1,1,0,1,0
30,195,195,26,14,12,3,2
35,210,210,5,5,0,1,0
2,220,220,7,4,3,2,1
48,222,222,80,60,20,2,1
36,231,231,56,23,33,4,3
31,231,231,36,26,10,3,2
5,247,247,1,1,0,1,0
37,249,249,19,19,0,1,0
7,256,256,1,1,0,1,0
17,259,259,8,8,0,1,0
22,283,283,4,4,0,1,0
29,286,286,1,1,0,1,0
27,303,303,11,11,0,1,0
21,309,309,53,15,38,2,1
39,316,316,28,28,0,1,0
13,318,318,6,6,0,1,0
40,325,325,11,2,9,4,3
41,338,338,63,52,11,2,1
15,341,341,36,36,0,1,0
18,351,351,4,1,3,2,1
28,351,351,11,8,3,2,1
32,362,362,30,30,0,1,0
44,363,363,2,2,0,1,0
24,381,381,2,2,0,1,0
26,402,402,47,32,15,4,3
14,414,414,46,12,34,2,1
46,414,414,24,10,14,4,3
19,416,416,1,1,0,1,0
34,432,432,13,1,12,2,1
42,436,436,15,15,0,1,0
10,456,456,32,32,0,1,0
23,471,471,125,125,0,1,0
25,472,472,40,40,0,1,0
20,484,484,21,2,19,4,3
8,488,488,27,19,8,3,2
16,491,491,23,23,0,1,0

14,102,102,2,2,0,1,0
24,103,103,6,3,3,2,1
22,120,120,13,5,8,3,2
30,125,125,1,1,0,1,0
34,130,130,9,9,0,1,0
6,132,132,11,11,0,1,0
15,157,157,11,3,8,3,2
11,167,167,34,34,0,1,0
16,173,173,19,19,0,1,0
29,174,174,52,16,36,3,2
39,184,184,1,1,0,1,0
32,197,197,3,3,0,1,0
7,199,199,2,2,0,1,0
18,224,224,12,12,0,1,0
33,229,229,21,9,12,2,1
4,245,245,9,9,0,1,0
23,250,250,46,28,18,4,3
31,275,275,21,21,0,1,0
13,285,285,2,2,0,1,0
12,294,294,9,1,8,2,1
10,309,309,27,27,0,1,0
38,332,332,55,55,0,1,0
9,334,334,125,125,0,1,0
1,363,363,69,7,62,3,2
20,365,365,27,3,24,2,1
26,367,367,10,2,8,2,1
0,369,369,34,10,24,2,1
2,369,369,83,26,57,4,3
3,369,369,55,55,0,1,0
21,405,405,6,6,0,1,0
28,407,407,65,65,0,1,0
17,421,421,39,4,35,2,1
27,448,448,74,45,29,2,1
37,457,457,62,43,19,2,1
36,471,471,69,25,44,2,1
5,474,474,18,18,0,1,0
35,476,476,45,29,16,2,1
19,481,481,1,1,0,1,0
8,488,488,26,2,24,3,2
25,491,491,39,8,31,2,1
40,498,498,72,22,50,2,1

18,101,101,1,1,0,1,0
26,112,112,10,10,0,1,0
22,112,112,30,30,0,1,0
5,120,120,11,11,0,1,0
19,134,134,4,4,0,1,0
13,138,138,17,17,0,1,0
29,156,156,17,3,14,2,1
27,172,172,9,9,0,1,0
10,172,172,55,55,0,1,0
1,195,195,9,9,0,1,0
7,207,207,23,23,0,1,0
11,217,217,9,1,8,3,2
36,225,225,1,1,0,1,0
4,233,233,11,3,8,3,2
21,267,267,18,18,0,1,0
20,270,270,73,73,0,1,0
2,271,271,38,38,0,1,0
0,275,275,11,11,0,1,0
32,311,311,5,2,3,2,1
23,314,314,65,65,0,1,0
24,318,318,11,1,10,3,2
30,323,323,32,32,0,1,0
31,326,326,10,10,0,1,0
16,366,366,77,77,0,1,0
12,372,372,31,16,15,2,1
15,381,381,65,65,0,1,0
3,391,391,10,10,0,1,0
35,393,393,112,69,43,4,3
37,430,430,20,20,0,1,0
34,432,432,61,61,0,1,0
6,455,455,163,141,22,2,1
14,455,455,10,10,0,1,0
33,456,456,59,59,0,1,0
28,463,463,47,12,35,2,1
8,476,476,10,1,9,3,2
25,485,485,18,11,7,2,1
17,485,485,33,6,27,4,3
9,495,495,40,13,27,2,1

44,111,111,25,25,0,1,0
1,118,118,5,5,0,1,0
10,129,129,14,14,0,1,0
25,131,131,8,8,0,1,0
16,137,137,1,1,0,1,0
6,138,138,16,16,0,1,0
39,154,154,19,15,4,2,1
43,161,161,26,8,18,3,2
29,168,168,34,14,20,2,1
33,177,177,21,2,19,4,3
21,180,180,16,16,0,1,0
3,185,185,24,1,23,2,1
38,210,210,10,1,9,2,1
4,212,212,3,3,0,1,0
23,227,227,48,48,0,1,0
2,231,231,6,6,0,1,0
37,242,242,25,25,0,1,0
30,252,252,22,22,0,1,0
35,254,254,3,3,0,1,0
0,260,260,12,12,0,1,0
27,278,278,8,2,6,2,1
11,284,284,22,22,0,1,0
18,296,296,7,1,6,2,1
42,301,301,13,1,12,2,1
15,332,332,34,34,0,1,0
36,334,334,48,48,0,1,0
32,335,335,52,11,41,3,2
24,342,342,41,41,0,1,0
34,355,355,23,23,0,1,0
12,378,378,29,29,0,1,0
9,390,390,7,7,0,1,0
5,411,411,41,41,0,1,0
8,428,428,10,10,0,1,0
20,431,431,49,49,0,1,0
14,436,436,82,36,46,2,1
17,455,455,36,36,0,1,0
22,459,459,4,4,0,1,0
13,464,464,15,7,8,3,2
40,472,472,42,42,0,1,0
19,478,478,74,26,48,2,1
26,479,479,32,32,0,1,0
41,480,480,93,56,37,2,1
7,489,489,45,45,0,1,0
31,493,493,21,21,0,1,0
28,498,498,40,4,36,2,1

6,103,103,14,2,12,3,2
30,106,106,7,4,3,2,1
17,118,118,33,18,15,2,1
32,142,142,36,36,0,1,0
25,161,161,10,6,4,2,1
37,172,172,1,1,0,1,0
36,186,186,24,24,0,1,0
19,189,189,20,14,6,2,1
34,201,201,35,35,0,1,0
22,203,203,12,4,8,3,2
35,212,212,6,2,4,2,1
4,219,219,28,28,0,1,0
14,221,221,73,58,15,4,3
20,238,238,6,3,3,2,1
23,239,239,5,2,3,2,1
1,252,252,16,16,0,1,0
12,253,253,15,15,0,1,0
8,266,266,63,34,29,2,1
3,278,278,41,41,0,1,0
10,285,285,7,7,0,1,0
27,294,294,11,11,0,1,0
9,300,300,26,26,0,1,0
21,301,301,7,7,0,1,0
16,356,356,3,3,0,1,0
18,358,358,77,25,52,3,2
13,359,359,7,7,0,1,0
33,382,382,15,15,0,1,0
26,383,383,27,8,19,2,1
29,385,385,11,11,0,1,0
31,392,392,52,52,0,1,0
2,401,401,25,25,0,1,0
15,417,417,85,71,14,3,2
5,424,424,14,14,0,1,0
7,443,443,17,17,0,1,0
28,456,456,79,15,64,3,2
24,457,457,180,126,54,4,3
0,489,489,39,39,0,1,0
11,498,498,33,1,32,4,3

37,100,100,55,55,0,1,0
30,103,103,11,11,0,1,0
5,107,107,4,1,3,2,1
32,111,111,27,27,0,1,0
42,139,139,20,1,19,2,1
41,146,146,18,18,0,1,0
10,149,149,1,1,0,1,0
19,164,164,8,1,7,2,1
18,166,166,35,2,33,3,2
6,167,167,4,1,3,2,1
40,178,178,6,3,3,2,1
14,188,188,8,8,0,1,0
34,213,213,12,9,3,2,1
11,216,216,3,3,0,1,0
33,217,217,10,5,5,2,1
9,225,225,23,23,0,1,0
39,241,241,2,2,0,1,0
43,253,253,10,10,0,1,0
0,253,253,5,5,0,1,0
2,258,258,17,8,9,2,1
29,258,258,13,1,12,2,1
35,261,261,21,21,0,1,0
20,262,262,17,17,0,1,0
1,282,282,20,20,0,1,0
22,282,282,1,1,0,1,0
3,294,294,36,36,0,1,0
4,319,319,27,1,26,2,1
8,333,333,61,24,37,2,1
13,336,336,78,78,0,1,0
12,339,339,14,14,0,1,0
15,352,352,78,78,0,1,0
24,372,372,71,11,60,4,3
31,377,377,3,3,0,1,0
21,380,380,83,2,81,4,3
28,393,393,28,12,16,2,1
36,412,412,82,82,0,1,0
38,414,414,2,2,0,1,0
23,426,426,8,8,0,1,0
17,432,432,67,63,4,2,1
26,436,436,8,8,0,1,0
16,437,437,4,4,0,1,0
25,440,440,23,5,18,4,3
7,462,462,1,1,0,1,0
27,496,496,9,9,0,1,0

14,100,100,1,1,0,1,0
23,103,103,10,4,6,3,2
28,116,116,9,4,5,2,1
30,121,121,2,2,0,1,0
15,130,130,5,5,0,1,0
8,142,142,23,7,16,2,1
16,174,174,32,32,0,1,0
3,181,181,15,15,0,1,0
12,186,186,31,17,14,2,1
24,189,189,16,16,0,1,0
6,191,191,61,61,0,1,0
10,227,227,30,30,0,1,0
37,233,233,33,33,0,1,0
17,233,233,25,25,0,1,0
21,257,257,47,11,36,3,2
9,264,264,1,1,0,1,0
35,266,266,102,57,45,4,3
18,273,273,50,50,0,1,0
26,280,280,20,8,12,3,2
25,283,283,25,25,0,1,0
27,301,301,8,8,0,1,0
19,304,304,32,3,29,2,1
22,310,310,75,51,24,4,3
33,332,332,5,5,0,1,0
34,334,334,50,23,27,4,3
11,341,341,45,45,0,1,0
2,354,354,17,17,0,1,0
4,360,360,57,23,34,2,1
7,385,385,3,3,0,1,0
0,400,400,27,27,0,1,0
13,428,428,63,40,23,2,1
36,434,434,5,5,0,1,0
32,437,437,39,14,25,2,1
31,446,446,24,6,18,4,3
20,446,446,9,3,6,2,1
29,486,486,6,6,0,1,0
1,487,487,75,18,57,4,3
5,494,494,39,39,0,1,0

16,100,100,10,1,9,4,3
23,117,117,9,6,3,2,1
11,117,117,2,2,0,1,0
25,119,119,11,11,0,1,0
34,121,121,1,1,0,1,0
2,127,127,6,6,0,1,0
24,134,134,11,1,10,3,2
17,134,134,19,2,17,4,3
14,197,197,32,32,0,1,0
5,230,230,7,7,0,1,0
19,235,235,26,5,21,4,3
36,249,249,2,2,0,1,0
8,250,250,13,13,0,1,0
41,279,279,20,10,10,3,2
15,282,282,1,1,0,1,0
9,304,304,15,15,0,1,0
7,305,305,49,25,24,3,2
26,307,307,12,8,4,2,1
10,319,319,49,49,0,1,0
42,336,336,37,37,0,1,0
28,347,347,11,11,0,1,0
33,348,348,27,3,24,3,2
43,353,353,75,39,36,3,2
13,355,355,17,17,0,1,0
4,358,358,23,23,0,1,0
40,361,361,18,10,8,3,2
6,377,377,1,1,0,1,0
27,378,378,48,48,0,1,0
22,378,378,14,14,0,1,0
20,390,390,75,75,0,1,0
0,395,395,27,27,0,1,0
21,396,396,22,22,0,1,0
39,406,406,7,7,0,1,0
18,411,411,53,21,32,2,1
38,416,416,43,43,0,1,0
29,430,430,83,17,66,4,3
1,446,446,79,79,0,1,0
3,454,454,45,45,0,1,0
31,491,491,116,116,0,1,0
32,491,491,29,3,26,2,1
35,491,491,99,46,53,3,2
30,494,494,29,13,16,3,2
37,495,495,128,128,0,1,0
12,496,496,12,3,9,4,3

14,120,120,1,1,0,1,0
3,146,146,81,16,65,4,3
7,148,148,6,3,3,2,1
19,167,167,32,32,0,1,0
1,171,171,11,11,0,1,0
15,172,172,11,3,8,3,2
33,173,173,34,34,0,1,0
20,176,176,16,12,4,2,1
30,187,187,8,2,6,2,1
25,200,200,33,33,0,1,0
18,200,200,15,10,5,2,1
16,202,202,17,7,10,3,2
31,208,208,21,6,15,4,3
22,209,209,6,6,0,1,0
23,216,216,1,1,0,1,0
5,218,218,12,9,3,2,1
32,223,223,2,2,0,1,0
12,229,229,1,1,0,1,0
29,248,248,45,45,0,1,0
37,257,257,38,38,0,1,0
26,270,270,39,9,30,3,2
9,272,272,29,25,4,2,1
10,276,276,58,58,0,1,0
0,284,284,25,22,3,2,1
21,301,301,34,34,0,1,0
2,336,336,57,9,48,4,3
11,339,339,20,2,18,4,3
13,385,385,30,2,28,3,2
8,397,397,122,1,121,4,3
34,410,410,27,9,18,4,3
6,432,432,20,20,0,1,0
36,447,447,55,22,33,2,1
24,448,448,82,30,52,4,3
17,453,453,16,16,0,1,0
27,456,456,6,1,5,2,1
35,460,460,69,29,40,3,2
4,464,464,12,2,10,3,2
28,473,473,4,1,3,2,1

14,102,102,4,1,3,2,1
3,109,109,4,1,3,2,1
10,123,123,5,5,0,1,0
28,124,124,2,2,0,1,0
33,135,135,1,1,0,1,0
26,136,136,11,11,0,1,0
18,145,145,24,3,21,4,3
16,164,164,14,11,3,2,1
31,176,176,1,1,0,1,0
34,181,181,6,6,0,1,0
9,202,202,4,1,3,2,1
38,210,210,24,24,0,1,0
22,211,211,18,18,0,1,0
21,212,212,65,21,44,3,2
24,216,216,55,23,32,3,2
30,226,226,61,28,33,2,1
23,234,234,25,19,6,2,1
7,252,252,6,6,0,1,0
13,284,284,43,43,0,1,0
17,293,293,41,27,14,3,2
29,337,337,63,63,0,1,0
1,346,346,7,7,0,1,0
2,350,350,46,46,0,1,0
12,384,384,66,41,25,2,1
35,398,398,114,102,12,3,2
19,413,413,1,1,0,1,0
5,413,413,24,2,22,2,1
32,415,415,14,2,12,4,3
8,420,420,28,28,0,1,0
6,420,420,25,25,0,1,0
15,427,427,1,1,0,1,0
37,429,429,17,5,12,2,1
20,439,439,7,1,6,2,1
4,444,444,94,13,81,4,3
25,462,462,8,2,6,3,2
0,464,464,262,181,81,4,3
27,466,466,77,77,0,1,0
11,500,500,8,5,3,2,1
36,500,500,2,2,0,1,0

1,145,145,1,1,0,1,0
10,147,147,1,1,0,1,0
27,190,190,4,4,0,1,0
35,211,211,9,9,0,1,0
15,214,214,97,58,39,4,3
4,216,216,30,1,29,2,1
25,217,217,17,8,9,2,1
14,230,230,4,4,0,1,0
8,234,234,1,1,0,1,0
20,238,238,3,3,0,1,0
28,242,242,1,1,0,1,0
29,272,272,6,6,0,1,0
24,273,273,75,29,46,3,2
17,296,296,6,6,0,1,0
19,298,298,22,13,9,2,1
6,298,298,6,6,0,1,0
9,299,299,6,6,0,1,0
13,303,303,22,22,0,1,0
26,320,320,86,86,0,1,0
22,333,333,1,1,0,1,0
30,354,354,53,53,0,1,0
0,359,359,62,62,0,1,0
18,365,365,67,67,0,1,0
23,370,370,25,1,24,4,3
3,382,382,118,55,63,4,3
12,383,383,11,11,0,1,0
5,403,403,12,12,0,1,0
31,409,409,18,9,9,4,3
36,417,417,17,17,0,1,0
2,420,420,64,64,0,1,0
16,442,442,1,1,0,1,0
11,449,449,31,31,0,1,0
21,462,462,25,25,0,1,0
32,464,464,173,173,0,1,0
7,475,475,227,172,55,3,2
33,479,479,38,21,17,3,2
37,484,484,33,19,14,2,1
34,486,486,87,87,0,1,0

35,102,102,2,2,0,1,0
14,106,106,14,1,13,2,1
15,106,106,5,5,0,1,0
27,107,107,38,38,0,1,0
31,134,134,6,6,0,1,0
19,135,135,26,3,23,2,1
20,197,197,38,38,0,1,0
5,201,201,17,5,12,3,2
18,213,213,24,4,20,2,1
9,220,220,129,129,0,1,0
29,235,235,19,19,0,1,0
33,272,272,16,7,9,2,1
36,282,282,15,15,0,1,0
32,286,286,5,5,0,1,0
37,288,288,41,41,0,1,0
8,291,291,14,14,0,1,0
12,292,292,17,17,0,1,0
10,304,304,8,8,0,1,0
6,306,306,54,31,23,2,1
11,316,316,22,22,0,1,0
2,323,323,62,8,54,3,2
17,343,343,47,17,30,4,3
3,346,346,1,1,0,1,0
34,347,347,21,3,18,2,1
24,353,353,6,2,4,2,1
0,356,356,29,4,25,2,1
26,363,363,12,4,8,2,1
23,365,365,21,21,0,1,0
25,390,390,65,65,0,1,0
28,393,393,18,6,12,2,1
13,398,398,40,40,0,1,0
22,411,411,15,5,10,2,1
21,440,440,50,50,0,1,0
16,453,453,86,86,0,1,0
7,461,461,27,7,20,2,1
4,474,474,4,4,0,1,0
30,485,485,117,117,0,1,0
1,493,493,1,1,0,1,0

42,109,109,8,8,0,1,0
9,114,114,9,9,0,1,0
21,114,114,5,5,0,1,0
4,129,129,4,4,0,1,0
35,135,135,5,5,0,1,0
10,138,138,30,4,26,3,2
15,139,139,24,24,0,1,0
43,142,142,10,4,6,3,2
37,156,156,27,9,18,4,3
6,167,167,2,2,0,1,0
29,168,168,14,6,8,3,2
22,204,204,29,29,0,1,0
44,209,209,39,39,0,1,0
40,216,216,14,14,0,1,0
25,221,221,53,53,0,1,0
28,236,236,13,13,0,1,0
31,240,240,17,3,14,2,1
7,242,242,1,1,0,1,0
24,256,256,22,2,20,2,1
23,259,259,14,4,10,3,2
20,264,264,4,4,0,1,0
26,265,265,48,48,0,1,0
19,270,270,92,92,0,1,0
12,274,274,39,15,24,4,3
34,284,284,10,10,0,1,0
41,285,285,7,7,0,1,0
17,294,294,25,10,15,4,3
8,302,302,29,11,18,3,2
1,310,310,19,19,0,1,0
38,312,312,20,14,6,2,1
16,318,318,5,1,4,2,1
14,330,330,11,11,0,1,0
11,343,343,21,21,0,1,0
39,348,348,55,55,0,1,0
13,386,386,10,10,0,1,0
33,400,400,45,9,36,4,3
0,424,424,30,22,8,2,1
27,428,428,28,13,15,3,2
18,436,436,36,9,27,3,2
2,456,456,7,7,0,1,0
5,460,460,8,1,7,2,1
3,469,469,45,45,0,1,0
32,470,470,1,1,0,1,0
30,471,471,89,16,73,4,3
36,476,476,71,35,36,4,3

24,124,124,23,8,15,4,3
26,126,126,22,7,15,4,3
13,133,133,6,6,0,1,0
19,144,144,6,6,0,1,0
21,150,150,13,13,0,1,0
34,153,153,41,41,0,1,0
30,160,160,1,1,0,1,0
25,170,170,19,19,0,1,0
0,171,171,4,4,0,1,0
29,171,171,13,13,0,1,0
14,193,193,49,49,0,1,0
31,203,203,26,4,22,2,1
20,205,205,17,17,0,1,0
22,227,227,24,24,0,1,0
36,237,237,5,2,3,2,1
8,246,246,13,1,12,3,2
33,264,264,8,8,0,1,0
27,266,266,10,10,0,1,0
35,274,274,3,3,0,1,0
6,291,291,37,37,0,1,0
32,316,316,124,70,54,3,2
1,327,327,128,83,45,4,3
4,329,329,74,42,32,3,2
12,334,334,9,2,7,2,1
11,334,334,11,11,0,1,0
7,346,346,5,1,4,2,1
17,390,390,31,31,0,1,0
3,394,394,29,4,25,2,1
15,411,411,7,7,0,1,0
18,411,411,60,36,24,3,2
10,420,420,118,36,82,4,3
28,431,431,15,15,0,1,0
16,432,432,8,4,4,2,1
2,448,448,87,35,52,4,3
23,451,451,13,13,0,1,0
5,477,477,58,58,0,1,0
9,480,480,49,7,42,2,1

17,133,133,10,4,6,2,1
15,137,137,4,4,0,1,0
10,140,140,21,4,17,2,1
35,145,145,51,2,49,2,1
30,151,151,24,16,8,2,1
4,157,157,6,6,0,1,0
5,164,164,21,21,0,1,0
22,168,168,15,15,0,1,0
18,173,173,4,1,3,2,1
28,175,175,10,10,0,1,0
20,176,176,21,21,0,1,0
34,180,180,16,16,0,1,0
1,190,190,61,20,41,2,1
33,247,247,41,38,3,2,1
24,250,250,35,5,30,2,1
0,287,287,7,7,0,1,0
9,292,292,17,17,0,1,0
12,310,310,53,15,38,4,3
26,320,320,11,4,7,2,1
27,341,341,47,47,0,1,0
6,342,342,72,4,68,3,2
19,351,351,12,3,9,2,1
2,366,366,109,3,106,4,3
29,375,375,8,8,0,1,0
13,382,382,26,26,0,1,0
21,400,400,3,3,0,1,0
11,402,402,23,23,0,1,0
23,406,406,51,51,0,1,0
8,408,408,80,54,26,4,3
16,425,425,4,4,0,1,0
14,426,426,38,38,0,1,0
7,439,439,62,15,47,4,3
25,460,460,35,16,19,2,1
32,465,465,100,100,0,1,0
3,476,476,12,12,0,1,0
31,485,485,55,55,0,1,0

30,104,104,6,6,0,1,0
9,105,105,4,4,0,1,0
17,111,111,9,9,0,1,0
29,116,116,1,1,0,1,0
37,122,122,1,1,0,1,0
7,159,159,2,2,0,1,0
28,166,166,56,24,32,2,1
22,178,178,12,6,6,2,1
4,194,194,5,5,0,1,0
0,203,203,21,21,0,1,0
23,203,203,20,20,0,1,0
1,216,216,18,18,0,1,0
19,226,226,33,33,0,1,0
27,232,232,8,8,0,1,0
34,240,240,36,36,0,1,0
26,240,240,15,1,14,3,2
15,248,248,22,22,0,1,0
10,262,262,47,47,0,1,0
6,274,274,16,16,0,1,0
32,280,280,12,12,0,1,0
5,291,291,1,1,0,1,0
16,298,298,54,12,42,3,2
39,299,299,25,25,0,1,0
25,318,318,52,2,50,3,2
24,339,339,41,41,0,1,0
12,347,347,14,14,0,1,0
13,368,368,16,4,12,3,2
38,375,375,116,116,0,1,0
20,395,395,22,22,0,1,0
11,402,402,115,115,0,1,0
36,413,413,60,42,18,3,2
18,414,414,29,29,0,1,0
8,426,426,8,8,0,1,0
3,427,427,124,37,87,4,3
2,433,433,21,1,20,2,1
35,433,433,107,23,84,3,2
31,434,434,7,3,4,2,1
33,463,463,1,1,0,1,0
14,468,468,95,90,5,2,1
21,481,481,15,15,0,1,0

21,101,101,24,10,14,2,1
32,115,115,5,5,0,1,0
28,131,131,5,2,3,2,1
14,134,134,1,1,0,1,0
0,134,134,16,16,0,1,0
7,140,140,22,22,0,1,0
20,157,157,65,21,44,2,1
1,175,175,1,1,0,1,0
5,182,182,19,19,0,1,0
26,186,186,4,4,0,1,0
6,191,191,61,4,57,4,3
8,193,193,24,24,0,1,0
22,208,208,6,3,3,2,1
4,211,211,25,22,3,2,1
9,212,212,23,1,22,3,2
29,224,224,18,3,15,4,3
10,258,258,26,26,0,1,0
2,269,269,21,21,0,1,0
33,272,272,1,1,0,1,0
13,272,272,22,22,0,1,0
17,282,282,25,7,18,4,3
16,282,282,3,3,0,1,0
30,314,314,34,34,0,1,0
25,321,321,13,13,0,1,0
23,336,336,50,50,0,1,0
15,339,339,105,105,0,1,0
11,342,342,38,38,0,1,0
24,376,376,25,25,0,1,0
19,382,382,41,2,39,4,3
31,393,393,5,1,4,2,1
3,395,395,17,11,6,2,1
12,434,434,229,112,117,4,3
27,486,486,6,6,0,1,0
18,490,490,118,86,32,2,1
34,498,498,18,8,10,3,2

18,101,101,6,6,0,1,0
35,116,116,13,10,3,2,1
26,118,118,38,38,0,1,0
0,155,155,5,5,0,1,0
24,155,155,7,2,5,2,1
36,157,157,7,3,4,2,1
12,160,160,13,8,5,2,1
1,181,181,12,12,0,1,0
7,186,186,1,1,0,1,0
16,191,191,7,7,0,1,0
6,193,193,20,20,0,1,0
3,207,207,52,24,28,3,2
14,219,219,2,2,0,1,0
29,220,220,11,11,0,1,0
11,225,225,76,62,14,2,1
32,232,232,20,20,0,1,0
15,234,234,12,4,8,2,1
19,236,236,5,2,3,2,1
31,245,245,41,4,37,2,1
17,256,256,82,52,30,3,2
37,304,304,10,10,0,1,0
8,323,323,78,78,0,1,0
33,325,325,37,1,36,4,3
22,326,326,43,24,19,2,1
27,335,335,24,16,8,3,2
30,361,361,14,14,0,1,0
10,361,361,12,2,10,3,2
34,370,370,86,80,6,2,1
13,381,381,91,91,0,1,0
20,381,381,17,7,10,3,2
4,392,392,25,19,6,2,1
9,419,419,9,3,6,2,1
25,421,421,43,43,0,1,0
2,440,440,44,31,13,3,2
23,453,453,33,2,31,2,1
28,457,457,21,3,18,4,3
5,492,492,3,3,0,1,0
21,493,493,122,122,0,1,0

16,104,104,3,3,0,1,0
35,110,110,5,5,0,1,0
5,117,117,1,1,0,1,0
8,139,139,15,15,0,1,0
11,143,143,11,5,6,3,2
19,170,170,21,21,0,1,0
24,171,171,11,3,8,3,2
33,201,201,10,10,0,1,0
6,210,210,77,61,16,2,1
25,244,244,41,41,0,1,0
31,245,245,1,1,0,1,0
29,265,265,53,53,0,1,0
23,275,275,77,77,0,1,0
28,297,297,50,18,32,2,1
34,303,303,9,9,0,1,0
13,303,303,3,3,0,1,0
32,308,308,57,57,0,1,0
17,324,324,11,11,0,1,0
9,344,344,19,2,17,4,3
7,345,345,21,21,0,1,0
10,345,345,61,2,59,4,3
21,346,346,57,39,18,3,2
22,351,351,4,4,0,1,0
20,360,360,24,2,22,2,1
4,366,366,68,20,48,4,3
36,368,368,32,14,18,4,3
2,387,387,1,1,0,1,0
27,389,389,10,1,9,4,3
1,391,391,60,27,33,4,3
3,397,397,37,17,20,3,2
0,406,406,1,1,0,1,0
14,413,413,67,15,52,3,2
18,430,430,96,96,0,1,0
12,438,438,203,203,0,1,0
30,441,441,41,32,9,4,3
15,490,490,23,6,17,2,1
26,494,494,7,7,0,1,0

4,103,103,9,9,0,1,0
19,119,119,8,8,0,1,0
33,124,124,11,11,0,1,0
2,126,126,16,2,14,3,2
15,128,128,2,2,0,1,0
31,195,195,6,6,0,1,0
28,226,226,21,8,13,2,1
8,235,235,32,32,0,1,0
21,239,239,10,10,0,1,0
16,240,240,23,1,22,3,2
27,246,246,7,1,6,2,1
23,255,255,46,46,0,1,0
7,263,263,32,32,0,1,0
6,265,265,84,36,48,4,3
17,265,265,8,8,0,1,0
11,296,296,6,6,0,1,0
3,304,304,5,5,0,1,0
25,317,317,5,5,0,1,0
9,326,326,3,3,0,1,0
14,327,327,79,33,46,3,2
18,327,327,23,1,22,3,2
26,378,378,3,3,0,1,0
34,382,382,25,3,22,4,3
10,416,416,47,47,0,1,0
24,419,419,77,77,0,1,0
29,419,419,61,61,0,1,0
36,432,432,8,1,7,2,1
35,435,435,38,38,0,1,0
12,444,444,52,5,47,2,1
1,456,456,65,65,0,1,0
32,458,458,197,107,90,3,2
5,461,461,50,3,47,2,1
30,476,476,110,76,34,3,2
13,478,478,135,126,9,4,3
20,492,492,85,13,72,4,3
0,497,497,26,26,0,1,0
22,499,499,27,27,0,1,0

12,108,108,6,2,4,2,1
5,128,128,6,6,0,1,0
17,130,130,11,11,0,1,0
18,132,132,1,1,0,1,0
34,133,133,1,1,0,1,0
10,154,154,17,17,0,1,0
20,168,168,1,1,0,1,0
13,189,189,86,6,80,3,2
16,197,197,17,8,9,4,3
26,203,203,37,37,0,1,0
19,204,204,22,22,0,1,0
3,232,232,70,70,0,1,0
31,238,238,7,7,0,1,0
9,243,243,55,55,0,1,0
29,251,251,5,5,0,1,0
33,252,252,4,4,0,1,0
6,253,253,9,9,0,1,0
4,267,267,4,4,0,1,0
1,268,268,1,1,0,1,0
35,294,294,16,1,15,2,1
24,310,310,25,9,16,3,2
23,320,320,5,5,0,1,0
11,336,336,64,22,42,3,2
15,339,339,14,5,9,4,3
2,355,355,2,2,0,1,0
30,356,356,2,2,0,1,0
32,362,362,23,10,13,2,1
7,365,365,2,2,0,1,0
14,387,387,1,1,0,1,0
36,404,404,25,25,0,1,0
27,405,405,56,56,0,1,0
8,407,407,48,13,35,2,1
39,422,422,100,79,21,2,1
22,422,422,52,18,34,3,2
25,422,422,140,50,90,4,3
0,430,430,45,17,28,3,2
28,461,461,139,70,69,4,3
21,461,461,34,6,28,3,2
38,473,473,30,30,0,1,0
37,476,476,103,23,80,4,3

25,109,109,16,16,0,1,0
10,116,116,8,8,0,1,0
19,123,123,14,7,7,2,1
38,150,150,11,11,0,1,0
27,163,163,3,3,0,1,0
14,171,171,73,63,10,2,1
28,185,185,10,10,0,1,0
9,193,193,12,12,0,1,0
33,200,200,22,6,16,2,1
31,214,214,1,1,0,1,0
23,214,214,7,7,0,1,0
39,218,218,29,20,9,4,3
20,234,234,10,10,0,1,0
16,249,249,5,5,0,1,0
30,260,260,30,2,28,2,1
7,270,270,50,30,20,2,1
6,276,276,11,11,0,1,0
32,287,287,16,8,8,3,2
0,297,297,43,35,8,2,1
8,303,303,3,3,0,1,0
13,312,312,15,1,14,3,2
11,321,321,7,7,0,1,0
29,337,337,53,53,0,1,0
18,339,339,49,8,41,2,1
4,352,352,25,3,22,3,2
36,364,364,41,8,33,4,3
17,368,368,6,6,0,1,0
3,369,369,59,59,0,1,0
34,371,371,1,1,0,1,0
15,396,396,115,25,90,4,3
22,397,397,3,3,0,1,0
40,400,400,96,78,18,3,2
37,404,404,6,6,0,1,0
21,438,438,148,128,20,2,1
35,448,448,52,11,41,3,2
12,461,461,45,45,0,1,0
5,467,467,2,2,0,1,0
1,472,472,12,3,9,4,3
24,492,492,143,132,11,2,1
26,497,497,7,4,3,2,1
2,498,498,5,2,3,2,1

3,106,106,44,25,19,2,1
30,107,107,5,2,3,2,1
11,127,127,5,5,0,1,0
23,131,131,6,6,0,1,0
18,145,145,49,5,44,3,2
4,150,150,4,1,3,2,1
15,151,151,1,1,0,1,0
28,162,162,18,18,0,1,0
1,169,169,27,27,0,1,0
8,175,175,12,12,0,1,0
12,178,178,10,10,0,1,0
25,180,180,9,3,6,2,1
2,182,182,45,17,28,2,1
35,200,200,6,1,5,2,1
21,214,214,11,11,0,1,0
31,272,272,67,55,12,3,2
14,273,273,1,1,0,1,0
19,281,281,6,6,0,1,0
5,289,289,24,24,0,1,0
20,294,294,10,10,0,1,0
24,295,295,40,31,9,4,3
33,302,302,66,45,21,4,3
6,324,324,2,2,0,1,0
7,326,326,30,3,27,2,1
22,336,336,1,1,0,1,0
10,345,345,103,66,37,2,1
13,349,349,54,39,15,2,1
16,353,353,33,24,9,4,3
29,440,440,9,4,5,2,1
32,442,442,21,5,16,3,2
26,455,455,179,59,120,4,3
9,470,470,159,159,0,1,0
0,472,472,5,5,0,1,0
34,475,475,52,12,40,4,3
17,496,496,6,6,0,1,0
27,498,498,16,6,10,3,2

48,107,107,4,4,0,1,0
46,109,109,3,3,0,1,0
24,110,110,15,15,0,1,0
2,118,118,6,6,0,1,0
9,125,125,14,14,0,1,0
12,127,127,5,5,0,1,0
49,133,133,1,1,0,1,0
34,136,136,1,1,0,1,0
1,139,139,12,12,0,1,0
8,156,156,5,1,4,2,1
28,163,163,6,6,0,1,0
33,179,179,27,4,23,3,2
36,188,188,1,1,0,1,0
50,201,201,69,63,6,3,2
10,205,205,23,11,12,2,1
16,212,212,1,1,0,1,0
4,214,214,1,1,0,1,0
40,220,220,13,13,0,1,0
5,244,244,2,2,0,1,0
39,255,255,2,2,0,1,0
42,257,257,27,3,24,3,2
14,260,260,35,35,0,1,0
44,286,286,54,54,0,1,0
19,306,306,17,17,0,1,0
32,308,308,33,12,21,2,1
38,314,314,145,145,0,1,0
37,318,318,36,12,24,2,1
43,323,323,48,48,0,1,0
31,332,332,7,7,0,1,0
18,335,335,23,14,9,4,3
15,359,359,25,25,0,1,0
35,360,360,6,6,0,1,0
47,361,361,47,47,0,1,0
27,363,363,7,3,4,2,1
25,365,365,25,4,21,4,3
21,368,368,8,8,0,1,0
6,371,371,47,5,42,4,3
7,372,372,25,25,0,1,0
11,383,383,1,1,0,1,0
29,393,393,2,2,0,1,0
30,403,403,2,2,0,1,0
13,419,419,29,29,0,1,0
0,419,419,27,6,21,2,1
20,422,422,5,5,0,1,0
22,427,427,6,6,0,1,0
26,435,435,49,25,24,2,1
23,444,444,35,35,0,1,0
3,477,477,155,109,46,2,1
41,484,484,51,4,47,2,1
17,485,485,28,14,14,2,1
45,489,489,3,3,0,1,0

19,103,103,1,1,0,1,0
32,113,113,4,4,0,1,0
2,115,115,7,7,0,1,0
20,121,121,52,52,0,1,0
13,127,127,19,19,0,1,0
34,138,138,9,9,0,1,0
42,148,148,1,1,0,1,0
46,151,151,17,5,12,3,2
25,153,153,4,1,3,2,1
35,166,166,1,1,0,1,0
12,176,176,7,2,5,2,1
33,187,187,62,16,46,2,1
8,195,195,9,1,8,3,2
5,223,223,2,2,0,1,0
29,254,254,27,15,12,2,1
1,270,270,13,1,12,3,2
7,278,278,22,10,12,4,3
24,285,285,27,12,15,4,3
37,287,287,19,1,18,3,2
16,292,292,7,7,0,1,0
40,326,326,62,2,60,3,2
3,330,330,1,1,0,1,0
44,341,341,8,2,6,3,2
38,344,344,40,13,27,4,3
18,353,353,46,46,0,1,0
14,356,356,23,23,0,1,0
23,358,358,7,2,5,2,1
31,363,363,22,22,0,1,0
26,379,379,3,3,0,1,0
0,382,382,5,5,0,1,0
30,385,385,95,68,27,2,1
39,393,393,6,6,0,1,0
45,394,394,47,47,0,1,0
17,395,395,36,36,0,1,0
43,396,396,20,20,0,1,0
9,397,397,17,17,0,1,0
15,403,403,8,8,0,1,0
10,405,405,91,71,20,3,2
27,421,421,13,13,0,1,0
36,436,436,5,5,0,1,0
41,449,449,28,28,0,1,0
4,458,458,81,36,45,2,1
6,474,474,1,1,0,1,0
21,475,475,4,4,0,1,0
28,478,478,185,164,21,4,3
22,480,480,32,12,20,3,2
11,481,481,54,54,0,1,0

16,101,101,6,6,0,1,0
29,103,103,38,17,21,2,1
5,111,111,7,7,0,1,0
1,146,146,37,13,24,4,3
32,162,162,10,10,0,1,0
27,170,170,74,74,0,1,0
21,192,192,4,4,0,1,0
3,211,211,41,41,0,1,0
0,234,234,28,28,0,1,0
22,239,239,12,12,0,1,0
34,279,279,44,7,37,2,1
12,291,291,31,31,0,1,0
7,298,298,26,26,0,1,0
15,300,300,14,3,11,2,1
4,310,310,37,31,6,3,2
8,319,319,31,31,0,1,0
23,323,323,9,9,0,1,0
33,338,338,29,29,0,1,0
24,349,349,13,7,6,2,1
35,367,367,18,18,0,1,0
28,376,376,17,8,9,4,3
10,377,377,10,7,3,2,1
30,396,396,48,48,0,1,0
31,408,408,40,16,24,2,1
26,415,415,18,18,0,1,0
13,418,418,55,55,0,1,0
2,427,427,182,102,80,4,3
11,435,435,49,28,21,4,3
14,440,440,80,80,0,1,0
18,445,445,7,7,0,1,0
20,460,460,2,2,0,1,0
17,472,472,36,32,4,2,1
9,477,477,8,8,0,1,0
25,479,479,130,47,83,4,3
19,481,481,5,5,0,1,0
6,481,481,9,9,0,1,0

10,113,113,8,8,0,1,0
27,122,122,2,2,0,1,0
16,152,152,1,1,0,1,0
33,162,162,33,33,0,1,0
19,165,165,47,39,8,3,2
26,167,167,1,1,0,1,0
23,183,183,17,9,8,2,1
3,188,188,43,43,0,1,0
4,191,191,24,24,0,1,0
0,200,200,1,1,0,1,0
32,212,212,9,5,4,2,1
22,220,220,68,45,23,4,3
13,232,232,7,7,0,1,0
15,246,246,3,3,0,1,0
28,248,248,5,5,0,1,0
20,257,257,3,3,0,1,0
2,274,274,61,46,15,4,3
1,314,314,52,37,15,2,1
6,316,316,72,72,0,1,0
11,325,325,72,72,0,1,0
5,329,329,118,118,0,1,0
31,341,341,67,58,9,2,1
25,360,360,19,19,0,1,0
12,362,362,77,51,26,2,1
9,377,377,1,1,0,1,0
30,391,391,9,2,7,2,1
8,403,403,33,33,0,1,0
14,428,428,54,54,0,1,0
24,462,462,21,15,6,2,1
18,464,464,137,137,0,1,0
17,474,474,56,56,0,1,0
29,478,478,24,24,0,1,0
21,494,494,59,59,0,1,0
7,496,496,23,12,11,2,1

5,110,110,9,2,7,2,1
18,119,119,4,4,0,1,0
26,124,124,9,9,0,1,0
22,124,124,16,16,0,1,0
6,125,125,9,9,0,1,0
34,132,132,13,1,12,3,2
1,148,148,1,1,0,1,0
40,153,153,74,64,10,2,1
0,159,159,11,11,0,1,0
41,160,160,35,35,0,1,0
39,172,172,14,11,3,2,1
21,181,181,8,8,0,1,0
32,183,183,19,19,0,1,0
33,200,200,8,5,3,2,1
12,210,210,6,6,0,1,0
16,221,221,82,82,0,1,0
7,230,230,4,4,0,1,0
13,233,233,38,38,0,1,0
10,234,234,23,23,0,1,0
38,235,235,11,11,0,1,0
17,244,244,11,11,0,1,0
28,249,249,9,9,0,1,0
15,254,254,8,8,0,1,0
14,283,283,45,45,0,1,0
8,292,292,4,4,0,1,0
25,303,303,13,3,10,2,1
4,304,304,10,10,0,1,0
23,305,305,7,7,0,1,0
2,332,332,38,21,17,2,1
42,335,335,9,9,0,1,0
9,347,347,8,8,0,1,0
29,353,353,3,3,0,1,0
3,358,358,43,43,0,1,0
36,374,374,15,7,8,3,2
30,399,399,216,156,60,4,3
27,412,412,7,4,3,2,1
37,435,435,30,8,22,3,2
31,437,437,18,18,0,1,0
35,454,454,21,21,0,1,0
11,479,479,22,22,0,1,0
19,484,484,80,64,16,4,3
24,488,488,5,5,0,1,0
20,500,500,70,44,26,3,2

32,106,106,6,6,0,1,0
28,121,121,13,1,12,4,3
14,129,129,6,3,3,2,1
9,142,142,26,26,0,1,0
5,163,163,4,4,0,1,0
36,168,168,12,1,11,2,1
11,173,173,6,1,5,2,1
18,179,179,2,2,0,1,0
16,213,213,15,15,0,1,0
38,220,220,1,1,0,1,0
7,229,229,33,9,24,4,3
17,233,233,8,8,0,1,0
39,246,246,1,1,0,1,0
35,257,257,109,73,36,3,2
0,264,264,17,1,16,3,2
10,275,275,1,1,0,1,0
19,292,292,14,14,0,1,0
30,295,295,52,52,0,1,0
8,297,297,21,21,0,1,0
1,327,327,94,94,0,1,0
31,328,328,1,1,0,1,0
12,353,353,38,16,22,3,2
27,362,362,27,3,24,3,2
21,367,367,11,2,9,4,3
20,370,370,52,26,26,3,2
3,377,377,1,1,0,1,0
6,378,378,1,1,0,1,0
13,387,387,122,42,80,3,2
23,394,394,28,4,24,2,1
33,407,407,3,3,0,1,0
40,412,412,74,22,52,3,2
25,428,428,69,16,53,4,3
29,437,437,23,23,0,1,0
34,437,437,99,11,88,3,2
2,447,447,81,18,63,4,3
4,459,459,80,80,0,1,0
22,466,466,31,31,0,1,0
37,467,467,30,30,0,1,0
26,475,475,30,9,21,2,1
15,486,486,26,6,20,3,2
24,495,495,93,7,86,3,2

3,108,108,11,8,3,2,1
41,111,111,18,12,6,3,2
23,132,132,27,27,0,1,0
19,150,150,1,1,0,1,0
20,164,164,34,34,0,1,0
2,168,168,4,4,0,1,0
24,189,189,4,4,0,1,0
7,195,195,9,9,0,1,0
5,201,201,41,41,0,1,0
14,205,205,46,10,36,3,2
26,211,211,20,7,13,2,1
0,219,219,1,1,0,1,0
22,226,226,3,3,0,1,0
29,246,246,28,28,0,1,0
17,250,250,8,8,0,1,0
6,253,253,1,1,0,1,0
1,254,254,21,21,0,1,0
4,255,255,1,1,0,1,0
38,266,266,75,11,64,3,2
13,278,278,33,18,15,2,1
9,278,278,8,8,0,1,0
12,291,291,59,59,0,1,0
25,294,294,1,1,0,1,0
35,298,298,68,57,11,2,1
34,306,306,31,9,22,2,1
10,309,309,46,6,40,3,2
16,316,316,12,12,0,1,0
27,329,329,77,54,23,2,1
32,329,329,3,3,0,1,0
36,338,338,83,25,58,4,3
39,343,343,5,5,0,1,0
8,398,398,82,68,14,3,2
15,410,410,29,29,0,1,0
33,415,415,8,8,0,1,0
31,450,450,7,7,0,1,0
40,470,470,31,31,0,1,0
30,478,478,50,9,41,4,3
11,483,483,7,7,0,1,0
28,487,487,33,3,30,3,2
18,488,488,28,28,0,1,0
37,491,491,15,5,10,3,2
21,493,493,86,45,41,2,1

7,101,101,32,8,24,2,1
14,102,102,5,5,0,1,0
18,109,109,13,13,0,1,0
13,115,115,12,12,0,1,0
17,119,119,25,9,16,2,1
23,130,130,5,5,0,1,0
25,191,191,3,3,0,1,0
30,197,197,38,18,20,2,1
28,215,215,7,7,0,1,0
8,223,223,17,17,0,1,0
9,244,244,4,4,0,1,0
27,265,265,41,21,20,2,1
4,270,270,27,18,9,4,3
16,281,281,23,23,0,1,0
15,285,285,18,8,10,2,1
0,289,289,70,70,0,1,0
10,342,342,46,46,0,1,0
12,343,343,39,30,9,2,1
3,347,347,103,100,3,2,1
24,349,349,25,5,20,2,1
34,350,350,52,52,0,1,0
21,352,352,73,61,12,4,3
6,352,352,39,11,28,3,2
26,357,357,30,2,28,4,3
5,373,373,11,2,9,2,1
19,381,381,93,62,31,2,1
11,390,390,10,10,0,1,0
20,398,398,4,4,0,1,0
32,407,407,27,27,0,1,0
31,432,432,1,1,0,1,0
22,433,433,20,20,0,1,0
29,443,443,22,22,0,1,0
1,453,453,78,25,53,3,2
33,469,469,97,97,0,1,0
2,473,473,103,25,78,3,2

37,105,105,6,6,0,1,0
29,114,114,5,5,0,1,0
0,125,125,16,6,10,2,1
25,139,139,2,2,0,1,0
18,145,145,2,2,0,1,0
36,149,149,22,2,20,4,3
4,157,157,9,9,0,1,0
3,165,165,13,1,12,3,2
7,173,173,9,2,7,2,1
10,180,180,31,31,0,1,0
31,191,191,71,71,0,1,0
24,205,205,15,15,0,1,0
16,206,206,53,39,14,3,2
22,221,221,3,3,0,1,0
2,234,234,51,51,0,1,0
33,244,244,8,8,0,1,0
26,251,251,47,13,34,3,2
13,293,293,4,4,0,1,0
12,298,298,11,7,4,2,1
11,299,299,94,83,11,2,1
9,304,304,12,12,0,1,0
14,307,307,25,11,14,2,1
21,310,310,11,2,9,4,3
34,329,329,16,16,0,1,0
30,363,363,1,1,0,1,0
15,368,368,9,9,0,1,0
32,385,385,115,115,0,1,0
23,399,399,134,78,56,3,2
6,415,415,71,71,0,1,0
35,429,429,27,27,0,1,0
8,437,437,5,5,0,1,0
38,439,439,10,4,6,3,2
19,444,444,10,10,0,1,0
20,446,446,33,33,0,1,0
28,452,452,13,8,5,2,1
27,466,466,80,30,50,2,1
1,469,469,61,14,47,3,2
5,475,475,84,84,0,1,0
17,486,486,13,5,8,3,2

28,122,122,11,11,0,1,0
18,128,128,1,1,0,1,0
36,134,134,33,33,0,1,0
29,134,134,2,2,0,1,0
23,135,135,4,4,0,1,0
3,164,164,1,1,0,1,0
33,171,171,9,9,0,1,0
9,175,175,4,1,3,2,1
24,177,177,4,4,0,1,0
30,222,222,1,1,0,1,0
1,223,223,21,14,7,2,1
4,228,228,37,37,0,1,0
35,255,255,50,50,0,1,0
21,265,265,23,1,22,3,2
16,284,284,53,8,45,4,3
34,287,287,42,2,40,3,2
38,309,309,47,47,0,1,0
12,313,313,12,12,0,1,0
0,314,314,6,6,0,1,0
8,343,343,39,39,0,1,0
7,355,355,14,14,0,1,0
2,370,370,3,3,0,1,0
27,373,373,71,71,0,1,0
17,377,377,31,31,0,1,0
19,381,381,47,1,46,3,2
37,389,389,60,19,41,2,1
11,394,394,2,2,0,1,0
25,399,399,21,21,0,1,0
14,399,399,65,35,30,4,3
39,408,408,28,28,0,1,0
10,422,422,205,163,42,3,2
20,429,429,22,4,18,3,2
32,437,437,27,27,0,1,0
6,442,442,110,64,46,3,2
31,454,454,62,30,32,2,1
13,463,463,49,49,0,1,0
5,466,466,37,21,16,2,1
22,469,469,23,23,0,1,0
15,474,474,5,5,0,1,0
26,492,492,116,116,0,1,0

17,102,102,3,3,0,1,0
24,103,103,30,30,0,1,0
23,116,116,2,2,0,1,0
11,126,126,12,12,0,1,0
1,132,132,22,3,19,2,1
6,137,137,18,10,8,3,2
38,137,137,8,8,0,1,0
30,145,145,9,9,0,1,0
8,151,151,18,18,0,1,0
13,168,168,22,22,0,1,0
5,174,174,2,2,0,1,0
10,188,188,43,43,0,1,0
32,220,220,29,2,27,4,3
26,228,228,62,53,9,2,1
27,230,230,15,15,0,1,0
14,236,236,14,5,9,2,1
4,238,238,96,6,90,4,3
35,249,249,7,1,6,2,1
18,252,252,15,15,0,1,0
29,255,255,37,8,29,2,1
9,256,256,4,4,0,1,0
40,266,266,2,2,0,1,0
31,282,282,13,6,7,2,1
33,299,299,3,3,0,1,0
37,307,307,27,17,10,2,1
25,307,307,28,9,19,3,2
36,325,325,78,64,14,2,1
2,336,336,2,2,0,1,0
34,361,361,2,2,0,1,0
19,369,369,6,6,0,1,0
41,379,379,24,24,0,1,0
20,396,396,60,60,0,1,0
22,406,406,37,22,15,2,1
12,408,408,14,4,10,3,2
3,435,435,24,2,22,3,2
16,452,452,3,3,0,1,0
39,460,460,100,64,36,4,3
7,474,474,22,17,5,2,1
28,482,482,54,11,43,2,1
0,491,491,68,68,0,1,0
21,492,492,33,23,10,2,1
15,500,500,14,14,0,1,0

0,106,106,8,5,3,2,1
12,112,112,18,18,0,1,0
25,139,139,29,15,14,3,2
3,160,160,21,21,0,1,0
9,164,164,4,4,0,1,0
18,179,179,32,32,0,1,0
2,189,189,5,5,0,1,0
36,192,192,8,5,3,2,1
28,203,203,14,14,0,1,0
23,209,209,17,17,0,1,0
4,213,213,14,4,10,3,2
17,213,213,14,6,8,2,1
29,223,223,3,3,0,1,0
13,256,256,3,3,0,1,0
34,256,256,1,1,0,1,0
19,317,317,48,48,0,1,0
24,325,325,2,2,0,1,0
7,356,356,48,22,26,2,1
10,361,361,25,25,0,1,0
15,368,368,61,61,0,1,0
35,375,375,125,17,108,4,3
6,380,380,32,17,15,3,2
26,387,387,18,4,14,4,3
32,390,390,1,1,0,1,0
20,393,393,83,83,0,1,0
14,393,393,42,42,0,1,0
33,407,407,41,11,30,2,1
30,414,414,54,4,50,2,1
31,417,417,24,24,0,1,0
11,434,434,39,39,0,1,0
5,439,439,5,5,0,1,0
37,455,455,6,6,0,1,0
21,474,474,13,4,9,4,3
27,478,478,44,44,0,1,0
16,483,483,233,166,67,4,3
8,483,483,93,93,0,1,0
1,485,485,50,36,14,3,2
22,496,496,131,102,29,2,1

14,105,105,1,1,0,1,0
5,109,109,17,17,0,1,0
20,119,119,19,8,11,2,1
16,132,132,23,15,8,2,1
38,158,158,5,1,4,2,1
22,195,195,2,2,0,1,0
27,207,207,37,23,14,3,2
19,209,209,10,10,0,1,0
39,214,214,17,17,0,1,0
8,219,219,9,9,0,1,0
25,223,223,14,14,0,1,0
42,234,234,17,17,0,1,0
23,234,234,25,1,24,4,3
40,237,237,5,5,0,1,0
35,237,237,2,2,0,1,0
34,241,241,33,8,25,2,1
24,246,246,4,4,0,1,0
36,257,257,31,1,30,4,3
2,273,273,5,5,0,1,0
9,276,276,17,11,6,3,2
29,291,291,39,26,13,2,1
37,299,299,4,4,0,1,0
21,315,315,5,2,3,2,1
17,345,345,8,8,0,1,0
12,375,375,36,6,30,3,2
10,389,389,17,17,0,1,0
33,392,392,77,77,0,1,0
41,393,393,121,121,0,1,0
30,393,393,65,65,0,1,0
6,395,395,43,43,0,1,0
26,401,401,7,3,4,2,1
11,405,405,77,9,68,3,2
0,409,409,175,125,50,4,3
7,444,444,19,1,18,3,2
31,447,447,74,47,27,2,1
4,449,449,2,2,0,1,0
28,456,456,35,25,10,2,1
32,474,474,63,63,0,1,0
18,485,485,3,3,0,1,0
15,485,485,37,2,35,4,3
3,493,493,25,25,0,1,0
13,497,497,58,58,0,1,0
43,498,498,51,51,0,1,0
1,499,499,8,2,6,3,2

34,113,113,1,1,0,1,0
22,119,119,7,7,0,1,0
9,119,119,1,1,0,1,0
32,148,148,1,1,0,1,0
7,163,163,12,6,6,3,2
21,193,193,15,15,0,1,0
6,198,198,2,2,0,1,0
12,202,202,26,20,6,2,1
37,205,205,48,48,0,1,0
20,209,209,8,8,0,1,0
17,212,212,10,10,0,1,0
40,227,227,2,2,0,1,0
1,229,229,10,2,8,2,1
24,237,237,52,5,47,2,1
35,238,238,3,3,0,1,0
29,268,268,50,50,0,1,0
26,271,271,17,17,0,1,0
10,275,275,36,36,0,1,0
15,280,280,36,18,18,4,3
5,301,301,1,1,0,1,0
23,312,312,18,18,0,1,0
25,316,316,37,37,0,1,0
33,328,328,3,3,0,1,0
39,346,346,78,78,0,1,0
27,360,360,51,51,0,1,0
19,387,387,5,2,3,2,1
0,396,396,19,19,0,1,0
4,401,401,47,47,0,1,0
36,409,409,106,100,6,2,1
3,410,410,103,103,0,1,0
11,417,417,50,50,0,1,0
14,419,419,64,64,0,1,0
38,426,426,17,7,10,3,2
2,439,439,19,19,0,1,0
41,445,445,12,12,0,1,0
16,445,445,102,61,41,2,1
8,449,449,51,18,33,4,3
31,469,469,7,7,0,1,0
30,474,474,125,125,0,1,0
13,495,495,65,29,36,2,1
28,498,498,39,39,0,1,0
18,500,500,46,46,0,1,0

5,102,102,2,2,0,1,0
40,109,109,7,7,0,1,0
6,129,129,1,1,0,1,0
21,138,138,22,10,12,3,2
8,139,139,4,1,3,2,1
15,143,143,4,1,3,2,1
29,148,148,4,4,0,1,0
36,156,156,29,7,22,2,1
25,172,172,35,3,32,4,3
24,191,191,44,2,42,4,3
2,210,210,2,2,0,1,0
38,222,222,23,16,7,2,1
28,223,223,26,10,16,3,2
18,230,230,1,1,0,1,0
27,236,236,33,33,0,1,0
30,239,239,15,5,10,2,1
33,267,267,48,2,46,3,2
13,296,296,69,69,0,1,0
9,304,304,37,37,0,1,0
16,312,312,43,43,0,1,0
20,313,313,8,2,6,3,2
34,325,325,5,2,3,2,1
23,327,327,17,1,16,2,1
4,346,346,43,23,20,3,2
22,348,348,10,4,6,2,1
3,348,348,116,46,70,4,3
1,348,348,11,5,6,2,1
39,366,366,6,6,0,1,0
12,380,380,14,2,12,4,3
41,381,381,31,31,0,1,0
14,392,392,36,36,0,1,0
31,396,396,48,3,45,4,3
19,400,400,34,34,0,1,0
35,406,406,17,17,0,1,0
10,423,423,69,39,30,3,2
17,426,426,20,7,13,4,3
11,434,434,7,7,0,1,0
26,460,460,46,46,0,1,0
7,472,472,123,123,0,1,0
37,477,477,24,24,0,1,0
0,478,478,3,3,0,1,0
42,479,479,119,75,44,4,3
32,490,490,2,2,0,1,0

2,102,102,4,4,0,1,0
18,103,103,9,9,0,1,0
10,109,109,12,7,5,2,1
3,110,110,5,2,3,2,1
1,114,114,1,1,0,1,0
27,119,119,52,52,0,1,0
32,124,124,2,2,0,1,0
11,127,127,2,2,0,1,0
38,128,128,22,19,3,2,1
31,144,144,5,5,0,1,0
20,167,167,27,27,0,1,0
25,184,184,12,12,0,1,0
13,214,214,7,7,0,1,0
33,234,234,12,12,0,1,0
30,243,243,6,3,3,2,1
24,256,256,8,8,0,1,0
14,265,265,102,74,28,3,2
26,268,268,60,10,50,2,1
6,271,271,38,38,0,1,0
36,271,271,59,59,0,1,0
39,277,277,34,17,17,3,2
15,293,293,76,17,59,4,3
28,302,302,3,3,0,1,0
4,317,317,21,21,0,1,0
29,332,332,3,3,0,1,0
37,351,351,4,4,0,1,0
19,356,356,4,4,0,1,0
22,360,360,4,1,3,2,1
21,382,382,19,10,9,4,3
35,392,392,71,71,0,1,0
17,395,395,65,32,33,2,1
0,404,404,64,4,60,3,2
12,412,412,49,21,28,2,1
9,416,416,39,39,0,1,0
34,427,427,63,33,30,4,3
16,428,428,19,19,0,1,0
8,454,454,5,5,0,1,0
23,485,485,32,16,16,3,2
5,487,487,2,2,0,1,0
7,489,489,22,2,20,3,2
40,492,492,81,39,42,3,2

28,102,102,1,1,0,1,0
33,104,104,7,7,0,1,0
16,125,125,1,1,0,1,0
24,126,126,5,1,4,2,1
11,149,149,5,2,3,2,1
20,152,152,12,12,0,1,0
21,153,153,15,15,0,1,0
41,161,161,1,1,0,1,0
18,172,172,1,1,0,1,0
3,197,197,28,16,12,4,3
39,197,197,28,4,24,3,2
32,199,199,20,12,8,3,2
2,226,226,12,3,9,3,2
25,230,230,14,14,0,1,0
37,243,243,5,5,0,1,0
17,261,261,78,78,0,1,0
8,276,276,8,8,0,1,0
31,285,285,18,4,14,3,2
40,287,287,7,7,0,1,0
42,288,288,5,5,0,1,0
26,290,290,72,22,50,2,1
29,291,291,94,94,0,1,0
35,294,294,50,50,0,1,0
5,296,296,8,8,0,1,0
34,298,298,95,11,84,4,3
15,316,316,90,36,54,3,2
19,327,327,1,1,0,1,0
13,328,328,3,3,0,1,0
0,346,346,50,9,41,2,1
9,354,354,3,3,0,1,0
7,366,366,8,8,0,1,0
14,369,369,1,1,0,1,0
22,392,392,68,68,0,1,0
23,409,409,68,8,60,4,3
1,414,414,47,23,24,4,3
27,423,423,33,13,20,3,2
4,425,425,79,79,0,1,0
38,435,435,39,39,0,1,0
36,444,444,42,13,29,3,2
30,462,462,1,1,0,1,0
10,472,472,42,10,32,3,2
12,482,482,79,13,66,4,3
6,483,483,13,13,0,1,0

31,122,122,7,7,0,1,0
9,138,138,6,6,0,1,0
14,144,144,22,1,21,3,2
41,145,145,18,3,15,2,1
28,171,171,31,31,0,1,0
8,190,190,14,1,13,2,1
12,201,201,4,4,0,1,0
35,208,208,16,16,0,1,0
6,224,224,38,23,15,4,3
27,225,225,44,18,26,2,1
0,228,228,4,4,0,1,0
10,234,234,21,12,9,2,1
26,235,235,16,7,9,4,3
39,254,254,8,8,0,1,0
13,268,268,17,1,16,3,2
3,294,294,16,16,0,1,0
34,298,298,7,1,6,2,1
36,299,299,1,1,0,1,0
40,306,306,92,43,49,2,1
18,334,334,34,34,0,1,0
24,337,337,15,9,6,2,1
33,360,360,4,4,0,1,0
1,361,361,38,38,0,1,0
19,367,367,69,59,10,2,1
30,374,374,85,85,0,1,0
5,379,379,13,1,12,4,3
37,380,380,74,36,38,3,2
25,395,395,26,26,0,1,0
23,409,409,86,38,48,4,3
29,411,411,5,2,3,2,1
15,413,413,63,20,43,2,1
2,413,413,25,15,10,2,1
11,420,420,1,1,0,1,0
4,457,457,73,29,44,4,3
7,461,461,35,23,12,3,2
16,467,467,33,11,22,3,2
22,468,468,37,37,0,1,0
20,478,478,21,15,6,3,2
21,479,479,105,105,0,1,0
32,479,479,35,35,0,1,0
17,480,480,49,49,0,1,0
38,494,494,30,30,0,1,0

3,103,103,10,10,0,1,0
34,127,127,5,5,0,1,0
23,131,131,21,5,16,2,1
31,135,135,5,5,0,1,0
26,153,153,4,4,0,1,0
25,172,172,26,26,0,1,0
40,185,185,50,4,46,4,3
1,198,198,23,1,22,3,2
17,199,199,14,3,11,2,1
10,208,208,7,7,0,1,0
27,213,213,36,24,12,2,1
22,291,291,73,73,0,1,0
35,297,297,78,28,50,2,1
37,306,306,1,1,0,1,0
24,312,312,25,3,22,3,2
13,334,334,24,24,0,1,0
32,357,357,12,12,0,1,0
14,365,365,14,4,10,3,2
39,379,379,12,12,0,1,0
0,380,380,22,22,0,1,0
4,390,390,12,4,8,3,2
38,393,393,9,2,7,2,1
6,408,408,15,4,11,3,2
21,411,411,90,90,0,1,0
30,421,421,3,3,0,1,0
29,423,423,2,2,0,1,0
41,428,428,89,89,0,1,0
15,448,448,140,137,3,2,1
7,450,450,1,1,0,1,0
36,455,455,30,9,21,4,3
8,457,457,44,26,18,4,3
19,466,466,4,4,0,1,0
12,468,468,19,2,17,2,1
16,468,468,6,6,0,1,0
5,472,472,84,60,24,2,1
18,473,473,40,33,7,2,1
9,484,484,23,2,21,2,1
28,490,490,32,4,28,4,3
20,491,491,1,1,0,1,0
2,492,492,32,24,8,3,2
11,493,493,63,22,41,3,2
42,494,494,32,32,0,1,0
33,495,495,164,164,0,1,0

24,108,108,2,2,0,1,0
4,117,117,6,6,0,1,0
0,117,117,8,3,5,2,1
29,120,120,4,4,0,1,0
30,124,124,16,16,0,1,0
25,139,139,25,25,0,1,0
6,140,140,16,4,12,2,1
23,156,156,11,1,10,2,1
15,159,159,52,34,18,2,1
8,160,160,20,20,0,1,0
2,167,167,1,1,0,1,0
19,195,195,45,45,0,1,0
27,202,202,21,21,0,1,0
21,206,206,25,8,17,4,3
11,215,215,12,12,0,1,0
13,229,229,34,34,0,1,0
14,239,239,72,72,0,1,0
28,249,249,35,35,0,1,0
16,256,256,4,4,0,1,0
31,265,265,52,52,0,1,0
3,285,285,8,8,0,1,0
20,289,289,37,10,27,2,1
18,319,319,13,13,0,1,0
5,323,323,10,10,0,1,0
12,331,331,10,10,0,1,0
26,343,343,4,4,0,1,0
22,362,362,11,3,8,2,1
34,365,365,86,77,9,4,3
35,396,396,45,45,0,1,0
10,419,419,2,2,0,1,0
33,422,422,33,10,23,3,2
1,426,426,207,155,52,4,3
9,459,459,1,1,0,1,0
17,464,464,59,59,0,1,0
7,464,464,103,59,44,2,1
32,491,491,18,6,12,3,2

19,109,109,14,14,0,1,0
29,120,120,3,3,0,1,0
25,130,130,1,1,0,1,0
5,135,135,5,1,4,2,1
32,137,137,5,5,0,1,0
1,138,138,27,27,0,1,0
14,151,151,3,3,0,1,0
27,151,151,3,3,0,1,0
21,152,152,10,10,0,1,0
24,155,155,7,2,5,2,1
36,171,171,25,25,0,1,0
2,175,175,8,3,5,2,1
31,176,176,80,80,0,1,0
10,187,187,17,17,0,1,0
9,189,189,1,1,0,1,0
33,210,210,37,17,20,3,2
35,235,235,18,15,3,2,1
8,262,262,23,23,0,1,0
34,274,274,97,45,52,4,3
4,279,279,53,38,15,2,1
6,352,352,26,4,22,2,1
26,360,360,25,25,0,1,0
11,374,374,37,30,7,2,1
28,377,377,1,1,0,1,0
22,395,395,2,2,0,1,0
0,403,403,15,15,0,1,0
3,410,410,94,52,42,4,3
17,421,421,41,29,12,4,3
12,433,433,20,13,7,2,1
23,435,435,91,13,78,3,2
30,447,447,7,4,3,2,1
13,447,447,64,64,0,1,0
16,448,448,16,16,0,1,0
15,455,455,216,216,0,1,0
18,462,462,8,4,4,2,1
20,473,473,46,7,39,2,1
7,487,487,92,32,60,4,3

18,102,102,10,10,0,1,0
21,104,104,35,35,0,1,0
38,118,118,1,1,0,1,0
23,120,120,5,1,4,2,1
29,121,121,9,5,4,2,1
34,124,124,5,1,4,2,1
27,135,135,2,2,0,1,0
37,137,137,19,19,0,1,0
39,148,148,21,9,12,3,2
19,149,149,4,4,0,1,0
17,150,150,8,8,0,1,0
42,156,156,78,78,0,1,0
12,159,159,28,4,24,3,2
35,163,163,11,11,0,1,0
40,165,165,13,5,8,3,2
9,171,171,1,1,0,1,0
8,198,198,15,8,7,2,1
14,207,207,5,1,4,2,1
41,215,215,19,1,18,2,1
16,238,238,2,2,0,1,0
22,253,253,25,4,21,4,3
43,263,263,28,28,0,1,0
15,286,286,19,19,0,1,0
20,301,301,32,2,30,3,2
10,308,308,3,3,0,1,0
13,322,322,10,10,0,1,0
6,324,324,72,51,21,4,3
30,362,362,6,6,0,1,0
32,363,363,8,1,7,2,1
26,367,367,10,2,8,2,1
0,367,367,18,18,0,1,0
44,369,369,1,1,0,1,0
4,369,369,20,14,6,2,1
45,384,384,41,41,0,1,0
46,385,385,99,18,81,4,3
36,394,394,47,41,6,3,2
31,396,396,81,40,41,4,3
2,401,401,11,8,3,2,1
5,409,409,5,5,0,1,0
33,435,435,11,2,9,4,3
3,445,445,1,1,0,1,0
1,449,449,18,6,12,2,1
11,453,453,67,22,45,4,3
28,458,458,16,7,9,2,1
25,464,464,1,1,0,1,0
24,467,467,19,19,0,1,0
7,477,477,104,35,69,4,3

38,105,105,2,2,0,1,0
11,109,109,23,1,22,3,2
19,129,129,6,2,4,2,1
18,140,140,28,4,24,2,1
3,146,146,3,3,0,1,0
22,165,165,2,2,0,1,0
0,166,166,16,16,0,1,0
30,171,171,12,2,10,3,2
41,178,178,38,19,19,2,1
24,196,196,24,24,0,1,0
14,203,203,12,12,0,1,0
28,217,217,12,7,5,2,1
39,227,227,19,19,0,1,0
26,248,248,87,87,0,1,0
17,253,253,8,1,7,2,1
40,264,264,13,13,0,1,0
36,264,264,81,48,33,2,1
23,269,269,55,12,43,4,3
31,296,296,20,20,0,1,0
29,303,303,22,22,0,1,0
35,309,309,24,21,3,2,1
16,322,322,63,19,44,2,1
15,333,333,10,6,4,2,1
10,336,336,21,21,0,1,0
13,351,351,5,5,0,1,0
2,373,373,2,2,0,1,0
32,378,378,5,1,4,2,1
6,385,385,9,9,0,1,0
5,392,392,45,8,37,2,1
7,408,408,44,32,12,4,3
25,412,412,5,2,3,2,1
21,418,418,19,19,0,1,0
4,420,420,3,3,0,1,0
37,448,448,26,5,21,3,2
8,462,462,35,20,15,4,3
34,464,464,31,21,10,2,1
27,469,469,27,27,0,1,0
33,474,474,64,64,0,1,0
12,475,475,189,140,49,4,3
9,484,484,6,2,4,2,1
1,485,485,1,1,0,1,0
20,495,495,119,101,18,4,3

9,101,101,10,7,3,2,1
28,102,102,4,4,0,1,0
33,125,125,4,1,3,2,1
10,127,127,6,6,0,1,0
35,129,129,10,1,9,4,3
23,146,146,13,13,0,1,0
40,166,166,11,11,0,1,0
34,172,172,16,1,15,2,1
18,182,182,21,21,0,1,0
46,199,199,44,29,15,4,3
27,201,201,7,7,0,1,0
2,201,201,4,4,0,1,0
31,207,207,48,12,36,3,2
8,226,226,1,1,0,1,0
17,237,237,23,7,16,3,2
26,244,244,13,2,11,3,2
6,258,258,97,97,0,1,0
4,262,262,16,16,0,1,0
37,265,265,48,20,28,3,2
47,278,278,2,2,0,1,0
1,283,283,1,1,0,1,0
30,301,301,12,12,0,1,0
14,302,302,10,1,9,4,3
12,313,313,8,8,0,1,0
44,315,315,48,48,0,1,0
21,345,345,10,10,0,1,0
19,345,345,26,20,6,3,2
0,354,354,4,1,3,2,1
3,360,360,9,9,0,1,0
45,362,362,36,14,22,3,2
13,364,364,56,8,48,2,1
36,366,366,113,77,36,3,2
25,367,367,6,3,3,2,1
15,378,378,21,21,0,1,0
20,379,379,10,6,4,2,1
22,384,384,31,28,3,2,1
32,411,411,34,12,22,2,1
16,430,430,62,19,43,3,2
42,432,432,30,16,14,3,2
24,439,439,23,23,0,1,0
7,439,439,4,4,0,1,0
11,442,442,37,37,0,1,0
41,442,442,7,7,0,1,0
43,457,457,33,26,7,2,1
29,473,473,45,39,6,2,1
38,478,478,41,41,0,1,0
39,479,479,32,9,23,2,1
5,500,500,89,23,66,3,2

12,105,105,12,12,0,1,0
4,106,106,10,1,9,2,1
22,106,106,27,5,22,3,2
1,116,116,17,17,0,1,0
16,122,122,22,7,15,4,3
19,127,127,22,10,12,4,3
21,144,144,6,6,0,1,0
14,159,159,15,9,6,3,2
23,163,163,19,2,17,2,1
11,175,175,29,29,0,1,0
33,178,178,14,6,8,3,2
35,196,196,31,31,0,1,0
34,216,216,2,2,0,1,0
10,216,216,9,9,0,1,0
37,227,227,15,7,8,2,1
25,241,241,5,5,0,1,0
30,247,247,33,33,0,1,0
32,249,249,59,20,39,4,3
9,264,264,10,10,0,1,0
8,268,268,5,5,0,1,0
31,281,281,5,5,0,1,0
36,283,283,46,6,40,3,2
27,284,284,9,4,5,2,1
26,324,324,33,18,15,4,3
24,338,338,18,18,0,1,0
20,343,343,51,51,0,1,0
0,346,346,10,10,0,1,0
2,346,346,15,15,0,1,0
39,346,346,34,34,0,1,0
38,358,358,69,69,0,1,0
28,363,363,33,33,0,1,0
3,364,364,4,4,0,1,0
6,385,385,32,15,17,4,3
7,420,420,7,7,0,1,0
29,432,432,12,12,0,1,0
17,438,438,27,12,15,2,1
5,445,445,48,4,44,4,3
13,473,473,12,12,0,1,0
15,474,474,149,115,34,3,2
18,496,496,122,122,0,1,0

25,114,114,2,2,0,1,0
5,122,122,52,12,40,3,2
14,139,139,1,1,0,1,0
2,141,141,4,4,0,1,0
31,158,158,38,4,34,2,1
0,163,163,13,13,0,1,0
27,171,171,43,43,0,1,0
36,175,175,19,19,0,1,0
21,181,181,12,4,8,3,2
9,187,187,3,3,0,1,0
13,187,187,4,4,0,1,0
35,191,191,14,6,8,2,1
15,191,191,24,1,23,2,1
30,199,199,16,6,10,3,2
26,210,210,8,8,0,1,0
4,213,213,12,12,0,1,0
44,217,217,11,11,0,1,0
37,220,220,68,61,7,2,1
34,224,224,13,13,0,1,0
10,226,226,19,15,4,2,1
29,226,226,41,13,28,2,1
42,227,227,1,1,0,1,0
8,230,230,4,1,3,2,1
18,256,256,27,18,9,2,1
43,259,259,4,4,0,1,0
33,270,270,10,6,4,2,1
12,316,316,15,15,0,1,0
20,318,318,28,28,0,1,0
24,323,323,5,5,0,1,0
28,335,335,39,27,12,4,3
3,336,336,16,16,0,1,0
41,349,349,47,47,0,1,0
1,367,367,44,44,0,1,0
6,375,375,33,33,0,1,0
17,408,408,59,11,48,4,3
16,433,433,35,35,0,1,0
11,433,433,14,5,9,4,3
19,434,434,27,27,0,1,0
32,437,437,63,35,28,2,1
38,438,438,21,4,17,3,2
7,444,444,7,7,0,1,0
22,450,450,12,12,0,1,0
23,454,454,90,90,0,1,0
39,484,484,41,38,3,2,1
40,491,491,22,22,0,1,0

3,115,115,18,18,0,1,0
1,130,130,1,1,0,1,0
19,131,131,9,9,0,1,0
16,145,145,14,2,12,2,1
4,174,174,22,22,0,1,0
14,178,178,24,18,6,2,1
24,191,191,27,27,0,1,0
25,214,214,6,6,0,1,0
6,220,220,22,17,5,2,1
0,222,222,3,3,0,1,0
23,251,251,15,5,10,2,1
26,252,252,15,6,9,2,1
30,269,269,2,2,0,1,0
31,301,301,36,36,0,1,0
2,302,302,181,172,9,4,3
5,308,308,9,9,0,1,0
9,314,314,99,21,78,4,3
29,353,353,48,48,0,1,0
15,356,356,8,8,0,1,0
27,371,371,151,144,7,2,1
20,372,372,24,8,16,3,2
22,373,373,17,8,9,2,1
17,380,380,43,43,0,1,0
21,387,387,85,85,0,1,0
10,394,394,131,35,96,3,2
18,407,407,9,9,0,1,0
7,434,434,14,14,0,1,0
12,436,436,69,69,0,1,0
13,445,445,54,26,28,2,1
28,448,448,7,7,0,1,0
8,457,457,30,16,14,2,1
11,496,496,110,29,81,4,3

34,101,101,29,29,0,1,0
8,137,137,1,1,0,1,0
9,139,139,25,17,8,3,2
37,159,159,5,5,0,1,0
10,170,170,1,1,0,1,0
13,180,180,23,2,21,2,1
18,206,206,2,2,0,1,0
1,209,209,18,18,0,1,0
33,233,233,61,30,31,2,1
36,242,242,57,57,0,1,0
15,249,249,10,7,3,2,1
3,261,261,23,4,19,4,3
14,287,287,1,1,0,1,0
25,303,303,4,4,0,1,0
4,304,304,83,83,0,1,0
5,313,313,3,3,0,1,0
0,317,317,19,9,10,2,1
19,336,336,1,1,0,1,0
27,352,352,21,21,0,1,0
22,366,366,74,74,0,1,0
7,378,378,26,26,0,1,0
35,379,379,5,5,0,1,0
26,409,409,15,15,0,1,0
6,412,412,6,6,0,1,0
29,420,420,20,2,18,4,3
23,421,421,82,41,41,3,2
2,425,425,125,63,62,4,3
21,430,430,34,34,0,1,0
31,430,430,27,18,9,4,3
24,442,442,33,33,0,1,0
32,442,442,12,12,0,1,0
30,451,451,153,56,97,4,3
17,456,456,129,20,109,4,3
16,473,473,147,147,0,1,0
28,484,484,8,2,6,3,2
12,490,490,23,12,11,2,1
11,492,492,50,23,27,4,3
20,500,500,16,16,0,1,0

1,115,115,1,1,0,1,0
31,115,115,3,3,0,1,0
0,149,149,24,24,0,1,0
9,156,156,1,1,0,1,0
3,165,165,15,15,0,1,0
18,169,169,17,5,12,4,3
36,184,184,12,9,3,2,1
11,189,189,35,35,0,1,0
21,204,204,2,2,0,1,0
5,205,205,21,13,8,2,1
41,205,205,52,2,50,2,1
38,212,212,7,7,0,1,0
15,212,212,11,11,0,1,0
23,221,221,28,16,12,4,3
25,227,227,10,10,0,1,0
10,238,238,101,31,70,4,3
19,255,255,6,6,0,1,0
42,259,259,10,10,0,1,0
13,270,270,35,35,0,1,0
2,277,277,35,35,0,1,0
17,301,301,24,24,0,1,0
4,302,302,8,2,6,3,2
28,303,303,50,44,6,3,2
27,306,306,16,10,6,2,1
24,318,318,40,23,17,2,1
6,318,318,19,19,0,1,0
39,332,332,125,116,9,2,1
35,334,334,21,21,0,1,0
14,347,347,13,13,0,1,0
26,353,353,71,50,21,2,1
30,360,360,7,7,0,1,0
40,374,374,61,61,0,1,0
12,386,386,16,5,11,2,1
7,390,390,20,20,0,1,0
29,399,399,2,2,0,1,0
8,419,419,89,89,0,1,0
22,426,426,8,8,0,1,0
16,434,434,12,2,10,3,2
37,447,447,20,20,0,1,0
20,475,475,12,3,9,4,3
32,480,480,97,97,0,1,0
34,480,480,1,1,0,1,0
33,487,487,16,16,0,1,0

0,100,100,7,7,0,1,0
15,100,100,1,1,0,1,0
34,104,104,1,1,0,1,0
13,110,110,9,4,5,2,1
37,127,127,5,5,0,1,0
45,132,132,6,6,0,1,0
43,137,137,12,12,0,1,0
1,140,140,3,3,0,1,0
48,143,143,8,2,6,2,1
8,152,152,14,11,3,2,1
9,158,158,1,1,0,1,0
39,172,172,8,8,0,1,0
11,175,175,1,1,0,1,0
5,175,175,16,16,0,1,0
26,197,197,8,8,0,1,0
29,199,199,6,6,0,1,0
32,211,211,1,1,0,1,0
24,214,214,1,1,0,1,0
23,220,220,32,20,12,3,2
25,229,229,3,3,0,1,0
42,232,232,77,39,38,3,2
33,236,236,18,18,0,1,0
46,239,239,46,31,15,2,1
31,252,252,93,93,0,1,0
35,255,255,3,3,0,1,0
7,259,259,5,5,0,1,0
4,270,270,12,12,0,1,0
3,283,283,98,68,30,2,1
44,295,295,11,11,0,1,0
30,303,303,9,9,0,1,0
12,323,323,6,1,5,2,1
16,329,329,15,15,0,1,0
22,332,332,108,55,53,4,3
18,333,333,4,4,0,1,0
28,349,349,7,7,0,1,0
20,350,350,16,9,7,2,1
47,361,361,37,37,0,1,0
38,369,369,9,9,0,1,0
49,382,382,46,46,0,1,0
17,407,407,16,4,12,2,1
36,415,415,124,124,0,1,0
19,431,431,59,59,0,1,0
41,432,432,61,16,45,2,1
10,433,433,2,2,0,1,0
14,443,443,71,9,62,3,2
27,455,455,13,3,10,3,2
2,462,462,46,46,0,1,0
6,486,486,21,3,18,2,1
40,489,489,11,5,6,3,2
21,494,494,1,1,0,1,0

10,103,103,3,3,0,1,0
23,108,108,2,2,0,1,0
34,113,113,3,3,0,1,0
3,115,115,7,1,6,3,2
35,117,117,28,28,0,1,0
31,125,125,13,13,0,1,0
29,134,134,9,9,0,1,0
13,171,171,13,8,5,2,1
1,173,173,4,1,3,2,1
6,198,198,53,13,40,3,2
24,203,203,16,16,0,1,0
15,209,209,37,28,9,4,3
30,238,238,23,23,0,1,0
27,247,247,13,4,9,3,2
11,251,251,12,1,11,2,1
19,258,258,8,8,0,1,0
5,270,270,66,66,0,1,0
25,298,298,2,2,0,1,0
7,324,324,71,12,59,3,2
17,330,330,18,18,0,1,0
14,331,331,12,12,0,1,0
16,333,333,24,24,0,1,0
12,343,343,58,8,50,3,2
18,363,363,117,14,103,4,3
32,370,370,1,1,0,1,0
8,372,372,20,5,15,4,3
33,373,373,110,67,43,2,1
20,386,386,80,7,73,3,2
21,388,388,7,7,0,1,0
4,402,402,32,6,26,2,1
28,407,407,79,35,44,2,1
0,432,432,37,37,0,1,0
22,437,437,44,20,24,3,2
9,437,437,103,81,22,2,1
26,438,438,24,21,3,2,1
2,457,457,91,91,0,1,0

12,122,122,3,3,0,1,0
17,127,127,3,3,0,1,0
34,128,128,9,6,3,2,1
1,134,134,1,1,0,1,0
13,143,143,14,14,0,1,0
21,144,144,11,11,0,1,0
9,159,159,6,6,0,1,0
14,180,180,11,11,0,1,0
18,184,184,2,2,0,1,0
20,191,191,27,27,0,1,0
30,193,193,3,3,0,1,0
3,202,202,32,28,4,2,1
29,204,204,21,4,17,4,3
27,215,215,26,11,15,4,3
40,227,227,13,13,0,1,0
38,233,233,3,3,0,1,0
35,240,240,19,19,0,1,0
41,253,253,58,35,23,2,1
37,268,268,13,13,0,1,0
22,291,291,43,5,38,2,1
26,297,297,36,2,34,3,2
2,305,305,17,5,12,3,2
10,309,309,47,11,36,2,1
4,314,314,4,4,0,1,0
33,333,333,13,5,8,3,2
24,343,343,38,8,30,3,2
0,355,355,58,27,31,2,1
31,387,387,72,72,0,1,0
36,388,388,33,26,7,2,1
5,400,400,71,47,24,4,3
8,405,405,4,4,0,1,0
42,415,415,133,115,18,2,1
28,419,419,46,5,41,2,1
19,423,423,20,2,18,4,3
7,437,437,8,8,0,1,0
16,438,438,38,38,0,1,0
32,449,449,6,6,0,1,0
6,466,466,162,144,18,4,3
23,467,467,31,31,0,1,0
25,481,481,4,1,3,2,1
39,481,481,112,4,108,4,3
15,492,492,17,17,0,1,0
11,499,499,55,55,0,1,0

10,106,106,11,5,6,3,2
32,109,109,22,1,21,2,1
0,112,112,1,1,0,1,0
13,118,118,10,10,0,1,0
23,119,119,5,2,3,2,1
33,128,128,12,12,0,1,0
14,132,132,27,8,19,2,1
12,144,144,28,28,0,1,0
22,146,146,2,2,0,1,0
34,170,170,5,5,0,1,0
1,195,195,1,1,0,1,0
38,209,209,36,24,12,2,1
28,212,212,4,4,0,1,0
5,221,221,2,2,0,1,0
9,226,226,3,3,0,1,0
36,227,227,15,11,4,2,1
15,231,231,32,32,0,1,0
4,244,244,17,5,12,3,2
26,251,251,60,60,0,1,0
37,257,257,63,14,49,2,1
20,265,265,11,11,0,1,0
17,268,268,2,2,0,1,0
29,280,280,11,11,0,1,0
25,293,293,1,1,0,1,0
6,295,295,67,18,49,2,1
2,297,297,38,22,16,2,1
41,315,315,21,5,16,2,1
21,346,346,4,4,0,1,0
18,349,349,14,14,0,1,0
16,362,362,86,48,38,3,2
11,380,380,48,8,40,2,1
31,394,394,32,2,30,3,2
24,396,396,13,1,12,3,2
27,410,410,172,55,117,4,3
19,438,438,71,71,0,1,0
8,443,443,27,27,0,1,0
35,449,449,28,19,9,4,3
7,487,487,28,28,0,1,0
3,488,488,34,14,20,3,2
30,495,495,59,40,19,2,1
40,498,498,10,10,0,1,0
39,499,499,38,7,31,4,3

5,112,112,12,2,10,2,1
10,116,116,1,1,0,1,0
6,130,130,8,8,0,1,0
11,132,132,1,1,0,1,0
19,137,137,31,31,0,1,0
35,161,161,9,1,8,3,2
12,170,170,8,8,0,1,0
16,198,198,33,33,0,1,0
31,199,199,8,8,0,1,0
29,206,206,5,1,4,2,1
2,210,210,13,13,0,1,0
3,211,211,8,5,3,2,1
21,237,237,11,5,6,3,2
26,247,247,79,79,0,1,0
37,252,252,11,6,5,2,1
13,255,255,13,13,0,1,0
40,259,259,19,4,15,3,2
28,265,265,36,36,0,1,0
42,286,286,36,36,0,1,0
34,287,287,57,57,0,1,0
7,293,293,1,1,0,1,0
38,314,314,70,70,0,1,0
27,323,323,39,9,30,4,3
39,327,327,4,4,0,1,0
36,331,331,6,6,0,1,0
41,340,340,11,5,6,3,2
18,355,355,27,27,0,1,0
22,376,376,147,122,25,4,3
1,377,377,70,2,68,3,2
15,382,382,30,30,0,1,0
30,396,396,13,3,10,3,2
8,401,401,5,5,0,1,0
17,402,402,6,6,0,1,0
20,415,415,37,37,0,1,0
33,425,425,90,60,30,2,1
0,426,426,109,109,0,1,0
9,440,440,11,1,10,2,1
4,452,452,1,1,0,1,0
23,461,461,42,42,0,1,0
25,466,466,89,35,54,4,3
14,468,468,21,21,0,1,0
24,470,470,2,2,0,1,0
32,491,491,37,4,33,2,1

15,101,101,1,1,0,1,0
39,144,144,11,5,6,2,1
16,150,150,1,1,0,1,0
14,152,152,21,21,0,1,0
5,155,155,6,6,0,1,0
31,157,157,32,32,0,1,0
23,159,159,23,23,0,1,0
20,162,162,2,2,0,1,0
10,172,172,1,1,0,1,0
21,187,187,7,7,0,1,0
28,198,198,6,6,0,1,0
26,248,248,38,23,15,4,3
37,252,252,2,2,0,1,0
6,252,252,17,17,0,1,0
27,260,260,54,54,0,1,0
22,283,283,3,3,0,1,0
7,284,284,52,52,0,1,0
36,298,298,83,83,0,1,0
24,299,299,7,7,0,1,0
34,308,308,48,48,0,1,0
33,324,324,34,34,0,1,0
1,325,325,23,11,12,4,3
3,340,340,6,6,0,1,0
29,351,351,24,24,0,1,0
38,355,355,16,16,0,1,0
19,360,360,9,6,3,2,1
41,367,367,73,35,38,2,1
17,371,371,55,30,25,2,1
2,375,375,1,1,0,1,0
13,378,378,17,17,0,1,0
40,411,411,57,57,0,1,0
25,417,417,2,2,0,1,0
35,435,435,16,16,0,1,0
9,435,435,30,30,0,1,0
4,438,438,164,83,81,4,3
12,448,448,76,40,36,2,1
11,449,449,32,32,0,1,0
32,454,454,35,35,0,1,0
18,457,457,57,28,29,2,1
30,467,467,29,29,0,1,0
8,485,485,152,73,79,4,3
0,494,494,36,36,0,1,0

4,106,106,11,11,0,1,0
14,116,116,7,7,0,1,0
28,116,116,35,11,24,3,2
15,129,129,2,2,0,1,0
1,160,160,9,6,3,2,1
35,165,165,3,3,0,1,0
8,166,166,4,4,0,1,0
6,171,171,3,3,0,1,0
3,172,172,1,1,0,1,0
27,174,174,19,19,0,1,0
34,187,187,16,16,0,1,0
18,190,190,3,3,0,1,0
33,190,190,25,15,10,2,1
21,209,209,17,17,0,1,0
19,216,216,18,14,4,2,1
29,224,224,16,16,0,1,0
10,231,231,4,4,0,1,0
25,248,248,15,7,8,2,1
13,248,248,18,10,8,2,1
0,252,252,6,1,5,2,1
31,252,252,11,11,0,1,0
2,256,256,60,60,0,1,0
30,257,257,38,13,25,2,1
24,303,303,16,16,0,1,0
38,306,306,1,1,0,1,0
37,345,345,12,12,0,1,0
26,346,346,46,46,0,1,0
9,346,346,91,38,53,4,3
36,361,361,24,24,0,1,0
17,364,364,23,8,15,4,3
42,401,401,184,184,0,1,0
5,405,405,80,44,36,4,3
41,412,412,15,11,4,2,1
23,416,416,35,13,22,4,3
40,417,417,28,19,9,4,3
32,435,435,31,31,0,1,0
11,439,439,43,37,6,2,1
22,442,442,1,1,0,1,0
39,447,447,30,27,3,2,1
12,463,463,2,2,0,1,0
20,472,472,10,1,9,2,1
16,477,477,193,106,87,4,3
7,484,484,25,5,20,3,2
43,500,500,35,35,0,1,0

30,114,114,8,1,7,2,1
3,134,134,28,28,0,1,0
0,142,142,58,20,38,3,2
19,163,163,1,1,0,1,0
25,166,166,35,5,30,2,1
11,169,169,19,16,3,2,1
16,172,172,24,5,19,4,3
7,178,178,12,12,0,1,0
23,184,184,8,3,5,2,1
17,194,194,14,14,0,1,0
24,203,203,54,54,0,1,0
31,205,205,16,16,0,1,0
36,219,219,15,9,6,3,2
35,220,220,6,1,5,2,1
28,248,248,24,9,15,2,1
34,259,259,6,6,0,1,0
15,260,260,22,22,0,1,0
2,270,270,20,1,19,2,1
12,275,275,4,1,3,2,1
27,325,325,21,10,11,2,1
22,329,329,51,51,0,1,0
20,344,344,100,42,58,3,2
26,357,357,11,11,0,1,0
5,363,363,27,27,0,1,0
32,366,366,39,39,0,1,0
6,369,369,61,61,0,1,0
33,397,397,84,84,0,1,0
29,397,397,19,19,0,1,0
37,399,399,19,1,18,4,3
1,414,414,9,3,6,2,1
4,421,421,41,10,31,2,1
9,459,459,107,107,0,1,0
18,460,460,68,17,51,4,3
14,461,461,22,9,13,2,1
13,467,467,27,27,0,1,0
21,477,477,24,2,22,2,1
10,487,487,7,7,0,1,0
8,489,489,54,10,44,3,2

29,104,104,23,23,0,1,0
33,113,113,9,3,6,2,1
20,122,122,17,17,0,1,0
37,126,126,11,11,0,1,0
10,130,130,10,10,0,1,0
41,168,168,3,3,0,1,0
27,169,169,22,22,0,1,0
9,173,173,7,4,3,2,1
23,189,189,14,2,12,4,3
11,191,191,32,32,0,1,0
5,192,192,2,2,0,1,0
14,202,202,13,3,10,3,2
6,204,204,9,9,0,1,0
19,228,228,5,5,0,1,0
35,261,261,3,3,0,1,0
0,263,263,20,11,9,2,1
32,293,293,1,1,0,1,0
25,305,305,55,55,0,1,0
26,311,311,14,2,12,3,2
7,322,322,13,9,4,2,1
21,327,327,23,1,22,2,1
22,331,331,13,13,0,1,0
40,345,345,53,53,0,1,0
12,352,352,29,29,0,1,0
18,357,357,14,14,0,1,0
16,358,358,34,2,32,2,1
31,361,361,51,29,22,2,1
38,371,371,10,10,0,1,0
15,378,378,68,44,24,2,1
34,382,382,96,96,0,1,0
17,382,382,11,1,10,3,2
39,384,384,39,39,0,1,0
8,388,388,6,3,3,2,1
30,409,409,66,66,0,1,0
1,440,440,76,62,14,2,1
2,445,445,93,66,27,4,3
36,450,450,44,7,37,2,1
24,455,455,53,23,30,2,1
4,461,461,161,98,63,4,3
13,463,463,9,9,0,1,0
3,483,483,28,8,20,3,2
28,496,496,51,47,4,2,1

31,101,101,8,8,0,1,0
26,103,103,6,6,0,1,0
33,139,139,19,11,8,2,1
37,140,140,17,17,0,1,0
1,141,141,3,3,0,1,0
35,149,149,23,23,0,1,0
23,154,154,23,23,0,1,0
2,155,155,13,13,0,1,0
13,181,181,10,3,7,2,1
34,188,188,28,28,0,1,0
40,193,193,45,11,34,4,3
7,200,200,23,23,0,1,0
20,217,217,22,22,0,1,0
24,236,236,3,3,0,1,0
38,240,240,38,6,32,2,1
10,257,257,6,6,0,1,0
43,259,259,14,14,0,1,0
17,261,261,23,16,7,2,1
22,267,267,58,16,42,4,3
6,298,298,11,5,6,2,1
28,298,298,9,9,0,1,0
3,300,300,31,15,16,2,1
11,312,312,6,6,0,1,0
8,314,314,54,54,0,1,0
36,325,325,48,48,0,1,0
16,333,333,40,40,0,1,0
9,335,335,75,75,0,1,0
14,342,342,4,4,0,1,0
19,347,347,49,49,0,1,0
4,349,349,6,6,0,1,0
32,358,358,29,29,0,1,0
27,365,365,12,12,0,1,0
0,366,366,19,19,0,1,0
5,378,378,24,2,22,2,1
41,380,380,54,24,30,3,2
42,387,387,36,5,31,2,1
25,425,425,16,16,0,1,0
29,446,446,22,22,0,1,0
18,453,453,35,35,0,1,0
39,462,462,38,5,33,2,1
15,463,463,17,7,10,2,1
21,489,489,17,9,8,2,1
12,494,494,19,19,0,1,0
30,497,497,96,18,78,4,3

38,104,104,9,9,0,1,0
27,116,116,13,1,12,2,1
1,121,121,22,22,0,1,0
8,133,133,16,16,0,1,0
7,148,148,4,4,0,1,0
17,153,153,1,1,0,1,0
16,181,181,30,30,0,1,0
3,201,201,11,4,7,2,1
28,203,203,48,37,11,2,1
41,212,212,2,2,0,1,0
37,215,215,10,10,0,1,0
23,216,216,13,7,6,2,1
9,219,219,1,1,0,1,0
42,220,220,7,7,0,1,0
2,265,265,57,57,0,1,0
21,289,289,32,32,0,1,0
15,290,290,8,1,7,2,1
6,294,294,31,31,0,1,0
5,304,304,4,4,0,1,0
36,308,308,5,5,0,1,0
22,319,319,48,48,0,1,0
19,341,341,47,26,21,4,3
31,344,344,44,44,0,1,0
35,345,345,22,22,0,1,0
12,361,361,14,11,3,2,1
34,374,374,30,18,12,4,3
10,389,389,33,33,0,1,0
32,392,392,21,2,19,2,1
39,414,414,21,11,10,3,2
11,417,417,43,43,0,1,0
20,422,422,45,45,0,1,0
4,425,425,93,19,74,3,2
33,428,428,21,21,0,1,0
26,430,430,6,2,4,2,1
24,436,436,228,202,26,2,1
13,444,444,1,1,0,1,0
29,462,462,5,5,0,1,0
40,463,463,75,55,20,3,2
18,475,475,56,32,24,4,3
30,484,484,88,4,84,3,2
25,487,487,57,57,0,1,0
14,491,491,3,3,0,1,0
0,495,495,1,1,0,1,0

14,117,117,22,22,0,1,0
34,123,123,8,8,0,1,0
37,131,131,1,1,0,1,0
22,168,168,2,2,0,1,0
17,187,187,32,32,0,1,0
24,189,189,1,1,0,1,0
21,200,200,22,22,0,1,0
27,212,212,17,17,0,1,0
3,219,219,31,31,0,1,0
8,222,222,3,3,0,1,0
25,225,225,23,7,16,2,1
23,226,226,25,25,0,1,0
19,231,231,17,3,14,4,3
35,247,247,17,17,0,1,0
9,255,255,5,5,0,1,0
18,283,283,14,14,0,1,0
36,307,307,15,15,0,1,0
13,309,309,29,23,6,3,2
16,327,327,47,43,4,2,1
11,330,330,17,1,16,2,1
31,346,346,10,4,6,3,2
2,351,351,42,42,0,1,0
4,353,353,3,3,0,1,0
29,353,353,21,6,15,2,1
5,357,357,13,9,4,2,1
26,374,374,225,75,150,4,3
10,400,400,127,127,0,1,0
30,400,400,8,5,3,2,1
6,402,402,41,16,25,2,1
28,412,412,117,90,27,4,3
15,420,420,15,15,0,1,0
0,423,423,9,1,8,3,2
1,426,426,22,10,12,3,2
33,444,444,39,39,0,1,0
32,460,460,104,104,0,1,0
12,482,482,88,43,45,4,3
20,498,498,1,1,0,1,0
7,499,499,151,101,50,2,1

24,102,102,4,4,0,1,0
1,102,102,13,13,0,1,0
20,106,106,6,1,5,2,1
15,158,158,16,16,0,1,0
29,165,165,24,8,16,2,1
7,186,186,26,26,0,1,0
34,186,186,10,10,0,1,0
22,204,204,14,14,0,1,0
3,211,211,86,33,53,4,3
2,213,213,9,5,4,2,1
31,231,231,28,7,21,2,1
9,246,246,55,20,35,2,1
8,250,250,14,14,0,1,0
35,251,251,76,48,28,2,1
21,253,253,3,3,0,1,0
11,271,271,7,7,0,1,0
6,282,282,29,11,18,4,3
25,294,294,52,18,34,2,1
32,325,325,14,4,10,2,1
14,331,331,1,1,0,1,0
0,333,333,148,45,103,4,3
18,339,339,65,65,0,1,0
33,341,341,8,2,6,2,1
30,351,351,14,14,0,1,0
19,357,357,34,34,0,1,0
10,369,369,19,10,9,2,1
13,393,393,43,43,0,1,0
16,404,404,21,2,19,2,1
4,409,409,6,6,0,1,0
17,411,411,16,16,0,1,0
23,442,442,219,219,0,1,0
12,475,475,59,11,48,3,2
26,482,482,31,31,0,1,0
28,489,489,5,5,0,1,0
27,494,494,7,7,0,1,0
5,496,496,14,6,8,3,2

14,120,120,6,6,0,1,0
23,121,121,15,12,3,2,1
7,190,190,1,1,0,1,0
16,201,201,17,5,12,3,2
21,212,212,3,3,0,1,0
10,215,215,33,5,28,4,3
24,220,220,46,31,15,2,1
17,245,245,13,4,9,2,1
18,250,250,5,5,0,1,0
0,250,250,36,36,0,1,0
22,253,253,4,4,0,1,0
5,272,272,35,35,0,1,0
4,294,294,114,49,65,4,3
26,313,313,20,20,0,1,0
1,322,322,89,39,50,3,2
31,325,325,28,28,0,1,0
20,329,329,11,11,0,1,0
12,333,333,153,15,138,4,3
3,346,346,34,34,0,1,0
29,351,351,34,34,0,1,0
25,359,359,32,17,15,2,1
9,398,398,57,57,0,1,0
19,402,402,232,232,0,1,0
11,407,407,3,3,0,1,0
30,410,410,36,9,27,4,3
15,415,415,21,12,9,4,3
8,439,439,18,18,0,1,0
6,442,442,19,19,0,1,0
28,469,469,76,60,16,3,2
32,473,473,1,1,0,1,0
2,487,487,56,12,44,2,1
13,495,495,38,38,0,1,0
27,500,500,68,68,0,1,0

24,100,100,5,5,0,1,0
18,118,118,5,5,0,1,0
6,119,119,18,18,0,1,0
28,120,120,18,18,0,1,0
4,123,123,3,3,0,1,0
14,154,154,46,46,0,1,0
23,198,198,14,3,11,2,1
16,201,201,1,1,0,1,0
1,221,221,1,1,0,1,0
36,229,229,33,33,0,1,0
9,237,237,11,3,8,2,1
26,243,243,20,2,18,4,3
10,252,252,1,1,0,1,0
37,260,260,78,21,57,4,3
20,268,268,2,2,0,1,0
30,286,286,20,20,0,1,0
34,288,288,68,49,19,2,1
0,290,290,79,43,36,3,2
3,300,300,19,10,9,2,1
22,309,309,2,2,0,1,0
8,309,309,12,1,11,4,3
38,341,341,11,11,0,1,0
11,342,342,7,7,0,1,0
35,344,344,44,35,9,4,3
32,345,345,12,12,0,1,0
40,346,346,11,5,6,3,2
19,353,353,12,2,10,2,1
27,358,358,46,7,39,2,1
17,372,372,29,14,15,4,3
5,377,377,20,20,0,1,0
12,388,388,63,11,52,3,2
21,403,403,95,95,0,1,0
29,407,407,23,23,0,1,0
2,409,409,3,3,0,1,0
13,415,415,43,22,21,3,2
25,435,435,43,35,8,2,1
15,475,475,94,94,0,1,0
7,485,485,73,21,52,3,2
31,485,485,51,10,41,3,2
39,487,487,8,8,0,1,0
33,488,488,24,6,18,2,1
41,500,500,121,112,9,2,1

28,116,116,6,6,0,1,0
10,119,119,51,51,0,1,0
31,134,134,10,10,0,1,0
3,148,148,2,2,0,1,0
19,154,154,1,1,0,1,0
29,171,171,15,15,0,1,0
26,179,179,17,17,0,1,0
34,181,181,8,8,0,1,0
23,194,194,8,8,0,1,0
8,210,210,30,30,0,1,0
18,281,281,3,3,0,1,0
33,288,288,3,3,0,1,0
21,305,305,38,23,15,2,1
27,314,314,34,34,0,1,0
22,338,338,10,4,6,3,2
15,346,346,183,183,0,1,0
24,346,346,8,3,5,2,1
25,354,354,1,1,0,1,0
9,356,356,118,40,78,3,2
0,366,366,5,5,0,1,0
12,408,408,121,23,98,3,2
6,411,411,40,30,10,2,1
16,424,424,43,29,14,4,3
20,431,431,32,6,26,2,1
14,442,442,1,1,0,1,0
30,443,443,19,19,0,1,0
17,448,448,166,140,26,2,1
7,453,453,54,54,0,1,0
2,467,467,106,58,48,4,3
11,468,468,23,23,0,1,0
4,473,473,3,3,0,1,0
32,483,483,101,23,78,3,2
1,493,493,81,45,36,4,3
13,495,495,17,5,12,3,2
5,498,498,37,2,35,4,3

0,107,107,8,8,0,1,0
43,117,117,7,7,0,1,0
11,120,120,4,4,0,1,0
18,131,131,7,7,0,1,0
10,136,136,32,14,18,2,1
25,151,151,9,3,6,2,1
12,152,152,10,10,0,1,0
29,163,163,4,4,0,1,0
3,185,185,14,4,10,2,1
33,191,191,11,11,0,1,0
24,198,198,22,1,21,3,2
39,202,202,29,29,0,1,0
40,202,202,16,16,0,1,0
15,202,202,17,11,6,3,2
38,203,203,22,16,6,3,2
31,207,207,8,8,0,1,0
2,218,218,15,6,9,2,1
36,220,220,32,32,0,1,0
41,226,226,4,4,0,1,0
1,228,228,30,27,3,2,1
9,238,238,15,15,0,1,0
45,246,246,21,4,17,2,1
5,257,257,17,17,0,1,0
6,275,275,6,3,3,2,1
21,286,286,24,4,20,3,2
26,287,287,44,44,0,1,0
23,298,298,5,5,0,1,0
34,304,304,25,25,0,1,0
13,304,304,24,24,0,1,0
35,307,307,22,22,0,1,0
44,327,327,10,2,8,3,2
20,337,337,2,2,0,1,0
37,353,353,44,14,30,3,2
30,362,362,201,157,44,3,2
16,375,375,8,8,0,1,0
32,377,377,3,3,0,1,0
22,389,389,52,7,45,2,1
42,399,399,20,4,16,2,1
7,412,412,24,24,0,1,0
27,417,417,64,64,0,1,0
4,420,420,24,9,15,2,1
28,427,427,22,22,0,1,0
14,470,470,65,65,0,1,0
8,475,475,10,10,0,1,0
17,484,484,56,51,5,2,1
19,495,495,64,23,41,2,1

15,112,112,4,1,3,2,1
18,120,120,3,3,0,1,0
13,130,130,3,3,0,1,0
12,155,155,18,18,0,1,0
33,158,158,27,8,19,2,1
7,166,166,11,2,9,4,3
14,169,169,56,23,33,4,3
28,170,170,1,1,0,1,0
8,179,179,9,9,0,1,0
37,185,185,22,16,6,3,2
36,188,188,38,13,25,2,1
30,200,200,5,5,0,1,0
1,230,230,3,3,0,1,0
17,232,232,32,4,28,3,2
3,234,234,9,9,0,1,0
5,248,248,44,44,0,1,0
29,252,252,13,4,9,4,3
23,269,269,15,3,12,4,3
27,273,273,6,6,0,1,0
16,291,291,39,35,4,2,1
34,295,295,25,25,0,1,0
20,299,299,7,7,0,1,0
26,303,303,69,69,0,1,0
9,308,308,10,1,9,4,3
38,331,331,32,32,0,1,0
6,336,336,38,38,0,1,0
21,365,365,50,28,22,2,1
10,372,372,39,39,0,1,0
4,377,377,53,27,26,3,2
2,379,379,57,57,0,1,0
24,382,382,9,1,8,2,1
0,383,383,76,28,48,2,1
31,384,384,25,25,0,1,0
11,385,385,44,26,18,3,2
19,394,394,23,23,0,1,0
35,412,412,109,109,0,1,0
32,418,418,81,51,30,2,1
25,481,481,99,91,8,3,2
22,497,497,2,2,0,1,0

15,111,111,4,1,3,2,1
3,118,118,20,20,0,1,0
19,129,129,7,2,5,2,1
23,137,137,25,25,0,1,0
14,148,148,8,8,0,1,0
32,154,154,49,4,45,2,1
27,190,190,15,4,11,2,1
20,217,217,26,16,10,3,2
34,261,261,7,7,0,1,0
4,269,269,3,3,0,1,0
12,273,273,3,3,0,1,0
2,275,275,21,13,8,2,1
21,275,275,15,9,6,2,1
24,286,286,84,2,82,4,3
11,319,319,51,25,26,3,2
35,320,320,9,1,8,3,2
30,332,332,34,34,0,1,0
7,335,335,75,75,0,1,0
0,342,342,11,5,6,2,1
16,350,350,11,11,0,1,0
5,351,351,254,221,33,4,3
17,363,363,6,6,0,1,0
8,376,376,20,20,0,1,0
10,395,395,49,37,12,2,1
22,398,398,53,30,23,2,1
25,408,408,76,14,62,4,3
6,412,412,5,5,0,1,0
26,423,423,3,3,0,1,0
31,425,425,51,51,0,1,0
9,434,434,109,109,0,1,0
29,436,436,54,45,9,4,3
13,441,441,24,24,0,1,0
28,446,446,30,30,0,1,0
18,465,465,11,2,9,2,1
1,470,470,6,6,0,1,0
33,500,500,36,18,18,3,2

4,103,103,3,3,0,1,0
0,104,104,21,21,0,1,0
5,135,135,24,24,0,1,0
33,158,158,1,1,0,1,0
34,158,158,2,2,0,1,0
19,174,174,32,32,0,1,0
6,174,174,4,1,3,2,1
20,184,184,1,1,0,1,0
14,190,190,22,22,0,1,0
15,191,191,51,22,29,2,1
13,193,193,1,1,0,1,0
12,196,196,7,7,0,1,0
18,200,200,9,9,0,1,0
16,206,206,26,8,18,2,1
40,211,211,17,13,4,2,1
28,224,224,39,39,0,1,0
11,230,230,14,14,0,1,0
3,244,244,13,2,11,2,1
32,248,248,8,1,7,2,1
21,259,259,42,12,30,3,2
45,275,275,14,4,10,2,1
26,278,278,57,57,0,1,0
7,299,299,1,1,0,1,0
42,306,306,22,22,0,1,0
41,327,327,149,20,129,4,3
35,329,329,19,3,16,3,2
37,335,335,5,2,3,2,1
1,336,336,1,1,0,1,0
43,350,350,58,58,0,1,0
25,357,357,11,11,0,1,0
44,359,359,71,71,0,1,0
10,368,368,10,7,3,2,1
38,381,381,61,13,48,3,2
29,393,393,45,22,23,2,1
27,410,410,18,18,0,1,0
36,411,411,11,1,10,2,1
39,416,416,10,10,0,1,0
22,423,423,43,43,0,1,0
2,424,424,16,16,0,1,0
17,427,427,53,25,28,3,2
9,445,445,3,3,0,1,0
23,450,450,61,4,57,4,3
8,469,469,2,2,0,1,0
24,478,478,16,16,0,1,0
30,484,484,16,1,15,3,2
31,488,488,52,52,0,1,0

46,105,105,9,6,3,2,1
29,109,109,18,11,7,2,1
23,115,115,1,1,0,1,0
31,116,116,16,16,0,1,0
11,141,141,10,10,0,1,0
27,148,148,26,16,10,3,2
6,159,159,72,46,26,2,1
44,169,169,6,6,0,1,0
25,170,170,1,1,0,1,0
32,171,171,5,2,3,2,1
3,180,180,1,1,0,1,0
15,200,200,4,1,3,2,1
0,210,210,25,10,15,4,3
26,213,213,2,2,0,1,0
33,218,218,9,9,0,1,0
40,220,220,4,4,0,1,0
30,221,221,51,3,48,2,1
8,231,231,27,7,20,2,1
5,233,233,10,10,0,1,0
14,262,262,9,9,0,1,0
17,268,268,47,47,0,1,0
34,276,276,33,33,0,1,0
13,306,306,15,10,5,2,1
7,310,310,26,20,6,3,2
37,321,321,92,70,22,3,2
2,322,322,22,10,12,2,1
42,331,331,40,40,0,1,0
1,339,339,2,2,0,1,0
21,345,345,50,11,39,4,3
19,345,345,1,1,0,1,0
4,350,350,45,45,0,1,0
16,353,353,7,7,0,1,0
39,357,357,34,24,10,3,2
9,360,360,53,1,52,3,2
45,370,370,15,9,6,2,1
35,404,404,105,39,66,4,3
41,420,420,16,4,12,3,2
22,424,424,11,11,0,1,0
10,426,426,26,26,0,1,0
36,428,428,10,10,0,1,0
24,428,428,1,1,0,1,0
38,435,435,12,12,0,1,0
28,440,440,12,12,0,1,0
43,449,449,38,21,17,2,1
12,455,455,70,70,0,1,0
18,487,487,21,21,0,1,0
20,499,499,1,1,0,1,0

38,100,100,21,5,16,2,1
14,132,132,1,1,0,1,0
16,140,140,34,3,31,3,2
0,155,155,13,13,0,1,0
1,165,165,8,1,7,2,1
2,173,173,11,11,0,1,0
43,174,174,13,13,0,1,0
40,177,177,65,15,50,3,2
32,178,178,18,18,0,1,0
28,188,188,11,11,0,1,0
42,189,189,1,1,0,1,0
3,196,196,2,2,0,1,0
23,200,200,20,20,0,1,0
27,207,207,5,5,0,1,0
17,224,224,29,18,11,2,1
4,233,233,7,7,0,1,0
39,234,234,10,2,8,3,2
12,240,240,20,20,0,1,0
10,247,247,8,4,4,2,1
15,281,281,71,51,20,3,2
34,285,285,16,4,12,2,1
21,307,307,33,33,0,1,0
35,320,320,96,96,0,1,0
7,321,321,12,12,0,1,0
18,326,326,82,55,27,2,1
11,327,327,26,26,0,1,0
26,335,335,18,18,0,1,0
5,344,344,19,19,0,1,0
9,345,345,26,26,0,1,0
29,354,354,14,14,0,1,0
30,367,367,81,81,0,1,0
36,378,378,5,5,0,1,0
37,383,383,17,17,0,1,0
6,392,392,8,8,0,1,0
25,401,401,33,25,8,3,2
8,429,429,2,2,0,1,0
24,436,436,40,40,0,1,0
19,443,443,1,1,0,1,0
13,464,464,22,22,0,1,0
41,476,476,52,1,51,4,3
20,478,478,48,48,0,1,0
22,479,479,21,6,15,4,3
33,482,482,71,71,0,1,0
31,486,486,37,37,0,1,0
44,491,491,2,2,0,1,0

27,118,118,13,13,0,1,0
38,123,123,14,14,0,1,0
36,140,140,16,16,0,1,0
13,142,142,20,16,4,2,1
37,167,167,7,7,0,1,0
42,178,178,1,1,0,1,0
43,179,179,56,30,26,4,3
30,208,208,64,64,0,1,0
41,213,213,36,6,30,3,2
6,217,217,16,16,0,1,0
33,217,217,34,34,0,1,0
20,218,218,25,25,0,1,0
12,246,246,5,5,0,1,0
28,258,258,23,23,0,1,0
21,260,260,18,6,12,2,1
9,261,261,3,3,0,1,0
26,273,273,7,7,0,1,0
40,278,278,5,5,0,1,0
39,279,279,35,3,32,2,1
8,288,288,1,1,0,1,0
15,289,289,12,2,10,2,1
34,295,295,18,7,11,2,1
29,315,315,18,18,0,1,0
23,317,317,51,9,42,4,3
3,338,338,3,3,0,1,0
14,341,341,61,61,0,1,0
5,350,350,24,24,0,1,0
10,361,361,23,12,11,2,1
44,377,377,6,6,0,1,0
11,379,379,10,10,0,1,0
1,383,383,80,80,0,1,0
4,391,391,53,27,26,3,2
35,401,401,26,26,0,1,0
0,401,401,1,1,0,1,0
22,438,438,74,35,39,2,1
2,440,440,96,34,62,3,2
24,456,456,1,1,0,1,0
7,464,464,19,2,17,3,2
18,468,468,39,34,5,2,1
17,480,480,31,31,0,1,0
31,490,490,54,42,12,3,2
32,491,491,69,69,0,1,0
16,492,492,3,3,0,1,0
19,493,493,43,43,0,1,0
25,496,496,4,4,0,1,0

13,106,106,36,5,31,2,1
23,116,116,29,17,12,4,3
8,119,119,6,6,0,1,0
16,142,142,2,2,0,1,0
36,173,173,8,8,0,1,0
18,184,184,15,1,14,2,1
26,212,212,15,5,10,3,2
24,224,224,5,5,0,1,0
22,243,243,25,4,21,4,3
6,253,253,67,67,0,1,0
4,256,256,21,21,0,1,0
37,269,269,3,3,0,1,0
31,285,285,71,71,0,1,0
33,295,295,10,4,6,3,2
19,297,297,32,32,0,1,0
3,300,300,36,3,33,4,3
12,310,310,8,4,4,2,1
14,317,317,24,2,22,3,2
27,318,318,35,15,20,3,2
20,323,323,37,2,35,2,1
5,327,327,96,96,0,1,0
9,330,330,5,5,0,1,0
17,334,334,100,100,0,1,0
15,336,336,20,11,9,4,3
10,340,340,3,3,0,1,0
30,352,352,13,13,0,1,0
7,357,357,17,7,10,3,2
32,358,358,16,16,0,1,0
11,395,395,23,3,20,2,1
25,404,404,128,46,82,4,3
2,419,419,1,1,0,1,0
1,443,443,94,47,47,2,1
28,452,452,21,15,6,2,1
29,455,455,15,15,0,1,0
0,473,473,15,15,0,1,0
34,473,473,52,34,18,3,2
21,486,486,68,45,23,4,3
35,497,497,50,50,0,1,0

34,111,111,3,3,0,1,0
9,146,146,21,21,0,1,0
14,147,147,14,14,0,1,0
12,153,153,11,11,0,1,0
16,160,160,20,2,18,3,2
28,181,181,21,4,17,4,3
1,189,189,11,11,0,1,0
35,202,202,24,24,0,1,0
37,211,211,7,1,6,2,1
20,231,231,27,12,15,4,3
21,234,234,18,8,10,2,1
17,237,237,27,21,6,3,2
8,261,261,22,22,0,1,0
18,264,264,14,9,5,2,1
10,271,271,12,4,8,3,2
33,274,274,111,103,8,2,1
27,301,301,1,1,0,1,0
22,319,319,6,3,3,2,1
5,321,321,17,17,0,1,0
40,321,321,43,43,0,1,0
6,321,321,1,1,0,1,0
25,325,325,128,110,18,4,3
7,344,344,7,7,0,1,0
19,346,346,160,112,48,3,2
32,357,357,74,38,36,2,1
36,382,382,53,53,0,1,0
31,382,382,1,1,0,1,0
3,392,392,10,10,0,1,0
26,406,406,35,35,0,1,0
29,414,414,26,26,0,1,0
15,425,425,51,21,30,4,3
4,425,425,30,30,0,1,0
30,435,435,10,2,8,3,2
2,442,442,21,21,0,1,0
11,448,448,34,34,0,1,0
39,452,452,29,3,26,2,1
0,453,453,56,40,16,3,2
24,455,455,18,14,4,2,1
38,461,461,10,1,9,4,3
13,473,473,45,15,30,2,1
23,484,484,29,29,0,1,0

28,101,101,19,9,10,3,2
30,123,123,3,3,0,1,0
13,145,145,33,33,0,1,0
3,171,171,6,6,0,1,0
37,183,183,6,1,5,2,1
11,184,184,5,5,0,1,0
0,197,197,19,1,18,4,3
27,204,204,19,19,0,1,0
18,207,207,15,11,4,2,1
1,211,211,78,78,0,1,0
32,270,270,7,7,0,1,0
21,272,272,11,11,0,1,0
14,289,289,45,25,20,2,1
33,289,289,73,28,45,2,1
38,308,308,30,8,22,4,3
12,316,316,48,39,9,4,3
17,316,316,1,1,0,1,0
22,322,322,45,45,0,1,0
29,329,329,69,24,45,2,1
34,349,349,90,30,60,4,3
8,359,359,34,34,0,1,0
26,373,373,28,28,0,1,0
39,389,389,11,7,4,2,1
6,390,390,30,30,0,1,0
16,392,392,27,16,11,2,1
36,395,395,27,2,25,2,1
2,397,397,7,3,4,2,1
35,408,408,48,48,0,1,0
4,412,412,34,34,0,1,0
31,413,413,21,7,14,2,1
5,431,431,4,4,0,1,0
9,432,432,7,3,4,2,1
10,451,451,16,16,0,1,0
20,453,453,46,2,44,3,2
23,463,463,26,26,0,1,0
19,470,470,74,74,0,1,0
25,471,471,17,11,6,2,1
7,473,473,33,21,12,4,3
24,482,482,68,31,37,2,1
15,489,489,114,114,0,1,0

47,111,111,15,7,8,2,1
37,115,115,9,1,8,3,2
34,117,117,12,12,0,1,0
11,129,129,1,1,0,1,0
5,136,136,2,2,0,1,0
7,153,153,2,2,0,1,0
43,158,158,10,10,0,1,0
51,162,162,19,2,17,2,1
18,168,168,5,5,0,1,0
10,169,169,4,4,0,1,0
3,169,169,8,8,0,1,0
19,171,171,20,16,4,2,1
44,177,177,4,1,3,2,1
13,178,178,7,7,0,1,0
27,179,179,1,1,0,1,0
31,181,181,12,12,0,1,0
48,193,193,7,7,0,1,0
29,208,208,10,3,7,2,1
17,219,219,9,1,8,3,2
24,219,219,8,1,7,2,1
4,226,226,31,7,24,2,1
30,228,228,1,1,0,1,0
42,231,231,37,23,14,3,2
50,233,233,73,73,0,1,0
21,239,239,15,3,12,4,3
40,243,243,5,2,3,2,1
39,261,261,67,67,0,1,0
38,262,262,60,14,46,2,1
0,269,269,26,26,0,1,0
35,280,280,17,7,10,3,2
26,283,283,2,2,0,1,0
16,283,283,18,9,9,4,3
23,287,287,5,1,4,2,1
41,287,287,13,13,0,1,0
28,297,297,71,71,0,1,0
33,307,307,5,5,0,1,0
25,308,308,2,2,0,1,0
14,314,314,12,5,7,2,1
49,336,336,12,3,9,2,1
2,339,339,34,34,0,1,0
53,344,344,4,4,0,1,0
6,345,345,20,20,0,1,0
9,350,350,66,19,47,4,3
22,353,353,7,1,6,2,1
52,361,361,28,18,10,2,1
32,362,362,22,6,16,3,2
12,363,363,62,62,0,1,0
1,367,367,21,14,7,2,1
36,397,397,30,30,0,1,0
45,424,424,71,71,0,1,0
20,440,440,9,3,6,2,1
46,495,495,13,7,6,2,1
8,498,498,15,3,12,3,2
15,500,500,58,9,49,2,1

36,114,114,6,6,0,1,0
28,120,120,48,48,0,1,0
15,128,128,3,3,0,1,0
44,133,133,4,4,0,1,0
45,139,139,19,19,0,1,0
38,146,146,11,11,0,1,0
19,161,161,11,11,0,1,0
7,166,166,7,7,0,1,0
29,200,200,39,31,8,3,2
0,202,202,33,15,18,4,3
47,210,210,9,9,0,1,0
25,212,212,3,3,0,1,0
3,214,214,25,25,0,1,0
39,216,216,9,9,0,1,0
8,220,220,17,3,14,2,1
14,231,231,4,4,0,1,0
22,234,234,18,18,0,1,0
41,241,241,9,5,4,2,1
1,253,253,2,2,0,1,0
11,262,262,12,4,8,3,2
9,263,263,8,1,7,2,1
23,276,276,21,11,10,3,2
42,287,287,69,37,32,2,1
37,287,287,13,13,0,1,0
27,287,287,21,9,12,3,2
2,297,297,4,1,3,2,1
5,299,299,4,4,0,1,0
31,302,302,93,85,8,2,1
13,312,312,28,4,24,4,3
32,322,322,19,16,3,2,1
30,331,331,18,18,0,1,0
12,332,332,1,1,0,1,0
46,342,342,14,6,8,2,1
4,347,347,56,48,8,3,2
24,355,355,13,13,0,1,0
33,397,397,6,6,0,1,0
20,402,402,29,24,5,2,1
16,415,415,49,15,34,2,1
43,419,419,47,47,0,1,0
34,423,423,34,34,0,1,0
35,441,441,13,13,0,1,0
21,446,446,29,29,0,1,0
40,459,459,23,5,18,4,3
26,466,466,19,9,10,2,1
18,467,467,12,12,0,1,0
6,467,467,1,1,0,1,0
10,485,485,234,234,0,1,0
17,492,492,22,3,19,2,1

22,101,101,4,4,0,1,0
6,101,101,12,6,6,3,2
19,103,103,11,11,0,1,0
38,112,112,16,6,10,3,2
3,125,125,1,1,0,1,0
0,129,129,18,1,17,2,1
32,132,132,20,20,0,1,0
4,149,149,2,2,0,1,0
14,150,150,12,9,3,2,1
17,159,159,7,2,5,2,1
33,176,176,17,14,3,2,1
7,182,182,26,18,8,2,1
36,194,194,15,9,6,3,2
34,203,203,20,20,0,1,0
16,204,204,9,6,3,2,1
28,222,222,8,8,0,1,0
12,226,226,4,4,0,1,0
20,228,228,25,25,0,1,0
24,230,230,23,23,0,1,0
1,261,261,2,2,0,1,0
18,278,278,67,1,66,4,3
31,287,287,10,5,5,2,1
29,315,315,42,42,0,1,0
13,316,316,1,1,0,1,0
30,329,329,10,7,3,2,1
42,329,329,5,5,0,1,0
37,339,339,21,1,20,2,1
21,370,370,19,1,18,2,1
2,374,374,71,71,0,1,0
5,381,381,22,5,17,3,2
27,402,402,40,40,0,1,0
15,404,404,58,58,0,1,0
43,409,409,36,1,35,2,1
23,424,424,8,5,3,2,1
8,426,426,115,37,78,3,2
11,448,448,58,58,0,1,0
25,451,451,28,28,0,1,0
40,452,452,26,2,24,3,2
35,453,453,120,35,85,4,3
10,455,455,2,2,0,1,0
9,464,464,9,9,0,1,0
39,464,464,68,48,20,3,2
26,475,475,150,150,0,1,0
41,486,486,10,10,0,1,0

13,100,100,2,2,0,1,0
22,103,103,4,4,0,1,0
21,103,103,1,1,0,1,0
2,112,112,29,29,0,1,0
20,118,118,2,2,0,1,0
10,125,125,5,1,4,2,1
8,147,147,27,9,18,4,3
1,157,157,17,17,0,1,0
7,158,158,6,6,0,1,0
3,170,170,3,3,0,1,0
15,182,182,77,59,18,3,2
5,188,188,12,12,0,1,0
38,196,196,19,19,0,1,0
41,211,211,3,3,0,1,0
18,215,215,22,5,17,2,1
16,218,218,14,14,0,1,0
36,224,224,14,4,10,3,2
28,230,230,32,32,0,1,0
4,241,241,28,28,0,1,0
35,249,249,20,8,12,2,1
11,250,250,1,1,0,1,0
30,257,257,25,25,0,1,0
24,260,260,24,24,0,1,0
6,263,263,20,1,19,4,3
14,283,283,1,1,0,1,0
26,316,316,56,38,18,2,1
25,325,325,19,19,0,1,0
37,336,336,8,8,0,1,0
19,346,346,18,18,0,1,0
31,350,350,18,6,12,4,3
40,357,357,68,48,20,3,2
29,366,366,37,37,0,1,0
34,412,412,13,4,9,2,1
39,415,415,79,79,0,1,0
27,418,418,52,35,17,2,1
32,418,418,32,17,15,2,1
23,440,440,127,87,40,2,1
9,449,449,57,13,44,3,2
42,452,452,21,3,18,3,2
17,462,462,73,73,0,1,0
33,480,480,42,17,25,4,3
12,480,480,6,6,0,1,0
0,488,488,32,4,28,2,1

12,106,106,4,4,0,1,0
5,109,109,4,4,0,1,0
26,109,109,2,2,0,1,0
32,129,129,5,5,0,1,0
15,149,149,2,2,0,1,0
2,161,161,1,1,0,1,0
44,172,172,17,17,0,1,0
4,188,188,3,3,0,1,0
13,188,188,27,27,0,1,0
33,189,189,66,66,0,1,0
14,195,195,7,2,5,2,1
3,197,197,6,6,0,1,0
22,226,226,29,29,0,1,0
8,228,228,1,1,0,1,0
24,238,238,7,7,0,1,0
30,250,250,12,12,0,1,0
39,251,251,7,1,6,2,1
40,254,254,6,2,4,2,1
20,280,280,17,2,15,2,1
17,281,281,8,3,5,2,1
23,296,296,17,17,0,1,0
37,300,300,46,1,45,2,1
19,306,306,66,66,0,1,0
27,333,333,42,35,7,2,1
6,335,335,16,16,0,1,0
28,335,335,80,80,0,1,0
41,346,346,63,63,0,1,0
21,352,352,48,14,34,4,3
10,352,352,26,18,8,2,1
31,355,355,18,18,0,1,0
1,363,363,3,3,0,1,0
36,375,375,9,9,0,1,0
11,379,379,30,17,13,2,1
25,384,384,25,25,0,1,0
16,387,387,77,13,64,3,2
34,392,392,11,11,0,1,0
7,405,405,91,67,24,2,1
0,429,429,85,39,46,3,2
9,439,439,62,62,0,1,0
29,447,447,1,1,0,1,0
43,461,461,60,18,42,2,1
35,464,464,24,24,0,1,0
18,474,474,23,23,0,1,0
38,483,483,178,178,0,1,0
42,488,488,9,9,0,1,0

24,115,115,8,8,0,1,0
21,131,131,17,17,0,1,0
33,138,138,30,17,13,2,1
20,142,142,8,8,0,1,0
23,146,146,6,2,4,2,1
16,150,150,7,1,6,3,2
10,156,156,14,14,0,1,0
11,163,163,14,6,8,2,1
27,185,185,37,37,0,1,0
25,187,187,3,3,0,1,0
38,203,203,1,1,0,1,0
29,206,206,4,4,0,1,0
17,238,238,3,3,0,1,0
13,241,241,6,6,0,1,0
37,244,244,18,6,12,3,2
8,250,250,20,20,0,1,0
32,267,267,11,11,0,1,0
12,273,273,91,91,0,1,0
0,275,275,6,6,0,1,0
22,287,287,39,10,29,2,1
26,292,292,32,20,12,4,3
9,298,298,3,3,0,1,0
28,301,301,8,8,0,1,0
6,310,310,72,64,8,2,1
2,336,336,30,8,22,2,1
7,337,337,154,105,49,2,1
34,337,337,41,31,10,2,1
35,338,338,169,76,93,4,3
14,371,371,18,4,14,3,2
31,376,376,67,26,41,2,1
15,381,381,48,20,28,3,2
5,407,407,30,3,27,2,1
18,422,422,58,58,0,1,0
4,423,423,25,12,13,2,1
30,441,441,7,2,5,2,1
36,445,445,11,8,3,2,1
1,446,446,8,2,6,2,1
19,471,471,33,33,0,1,0
3,480,480,26,4,22,2,1

35,108,108,5,2,3,2,1
37,111,111,5,5,0,1,0
26,116,116,35,35,0,1,0
40,151,151,25,25,0,1,0
12,152,152,5,5,0,1,0
3,165,165,1,1,0,1,0
10,170,170,9,2,7,2,1
29,178,178,11,11,0,1,0
18,188,188,1,1,0,1,0
23,200,200,30,30,0,1,0
14,214,214,2,2,0,1,0
25,219,219,11,5,6,2,1
43,230,230,2,2,0,1,0
24,239,239,2,2,0,1,0
6,254,254,38,22,16,2,1
48,255,255,3,3,0,1,0
30,259,259,33,13,20,3,2
31,262,262,49,49,0,1,0
34,266,266,24,12,12,4,3
17,267,267,21,14,7,2,1
2,279,279,45,45,0,1,0
39,284,284,46,46,0,1,0
38,290,290,48,48,0,1,0
9,293,293,29,29,0,1,0
32,302,302,1,1,0,1,0
21,311,311,1,1,0,1,0
27,318,318,27,15,12,4,3
1,320,320,23,1,22,2,1
13,328,328,3,3,0,1,0
7,333,333,12,1,11,2,1
33,335,335,5,5,0,1,0
41,342,342,135,135,0,1,0
28,351,351,5,5,0,1,0
8,358,358,75,38,37,2,1
44,377,377,4,4,0,1,0
16,390,390,8,8,0,1,0
47,394,394,39,8,31,2,1
11,404,404,42,6,36,2,1
4,409,409,6,6,0,1,0
46,426,426,25,7,18,3,2
22,439,439,6,1,5,2,1
45,448,448,78,10,68,3,2
15,449,449,56,13,43,2,1
19,449,449,39,39,0,1,0
42,458,458,69,69,0,1,0
0,462,462,10,1,9,2,1
20,492,492,4,4,0,1,0
36,498,498,31,9,22,4,3
5,499,499,37,7,30,2,1

19,104,104,3,3,0,1,0
10,110,110,1,1,0,1,0
1,110,110,1,1,0,1,0
29,116,116,2,2,0,1,0
35,125,125,15,3,12,4,3
28,131,131,24,2,22,2,1
22,132,132,6,6,0,1,0
36,132,132,9,9,0,1,0
25,165,165,16,16,0,1,0
27,173,173,7,7,0,1,0
0,185,185,17,10,7,2,1
18,193,193,18,6,12,4,3
12,194,194,16,1,15,2,1
31,212,212,15,15,0,1,0
21,213,213,9,5,4,2,1
7,230,230,13,9,4,2,1
30,232,232,46,46,0,1,0
8,242,242,37,6,31,4,3
9,264,264,49,40,9,4,3
16,281,281,77,77,0,1,0
2,309,309,1,1,0,1,0
24,309,309,6,1,5,2,1
15,313,313,12,12,0,1,0
4,339,339,29,29,0,1,0
17,358,358,52,7,45,2,1
5,358,358,30,30,0,1,0
14,360,360,3,3,0,1,0
26,366,366,23,23,0,1,0
20,370,370,91,2,89,4,3
32,380,380,15,15,0,1,0
34,380,380,8,8,0,1,0
3,384,384,36,36,0,1,0
23,392,392,15,15,0,1,0
37,416,416,205,184,21,2,1
13,470,470,20,16,4,2,1
6,474,474,229,134,95,4,3
33,479,479,64,64,0,1,0
11,500,500,78,78,0,1,0

28,113,113,7,7,0,1,0
29,140,140,6,6,0,1,0
4,144,144,7,1,6,3,2
34,147,147,105,33,72,4,3
37,151,151,15,11,4,2,1
2,156,156,14,14,0,1,0
1,159,159,11,11,0,1,0
18,174,174,6,6,0,1,0
44,185,185,11,2,9,2,1
32,206,206,32,32,0,1,0
33,210,210,19,1,18,3,2
14,213,213,3,3,0,1,0
19,225,225,70,59,11,2,1
17,234,234,13,6,7,2,1
15,236,236,19,9,10,3,2
36,246,246,11,11,0,1,0
10,246,246,35,35,0,1,0
22,256,256,15,7,8,2,1
43,272,272,25,25,0,1,0
40,314,314,10,10,0,1,0
35,314,314,30,30,0,1,0
16,325,325,2,2,0,1,0
5,331,331,14,14,0,1,0
41,341,341,13,13,0,1,0
9,352,352,23,8,15,4,3
24,360,360,20,20,0,1,0
11,363,363,2,2,0,1,0
39,374,374,16,9,7,2,1
38,380,380,34,34,0,1,0
23,396,396,9,9,0,1,0
8,398,398,25,25,0,1,0
27,400,400,24,9,15,2,1
26,402,402,2,2,0,1,0
0,413,413,24,24,0,1,0
12,422,422,122,93,29,2,1
42,425,425,46,46,0,1,0
30,426,426,36,36,0,1,0
6,430,430,21,21,0,1,0
21,438,438,89,89,0,1,0
20,445,445,51,44,7,2,1
13,449,449,17,17,0,1,0
31,455,455,2,2,0,1,0
25,458,458,53,53,0,1,0
7,463,463,35,1,34,3,2
3,491,491,5,1,4,2,1

8,108,108,13,3,10,3,2
4,120,120,11,2,9,2,1
43,129,129,18,18,0,1,0
37,144,144,4,4,0,1,0
36,144,144,4,4,0,1,0
29,149,149,3,3,0,1,0
40,156,156,26,5,21,4,3
12,177,177,30,30,0,1,0
25,188,188,5,1,4,2,1
16,198,198,24,6,18,4,3
41,218,218,1,1,0,1,0
10,228,228,6,6,0,1,0
17,231,231,1,1,0,1,0
1,240,240,2,2,0,1,0
28,249,249,2,2,0,1,0
11,269,269,1,1,0,1,0
23,280,280,31,7,24,3,2
34,283,283,8,5,3,2,1
3,294,294,39,39,0,1,0
20,297,297,86,70,16,3,2
35,301,301,35,35,0,1,0
42,318,318,12,8,4,2,1
38,336,336,32,32,0,1,0
31,341,341,148,148,0,1,0
0,345,345,53,53,0,1,0
14,345,345,4,1,3,2,1
27,352,352,75,2,73,4,3
15,376,376,10,10,0,1,0
32,382,382,24,1,23,3,2
18,396,396,20,1,19,2,1
30,402,402,53,6,47,3,2
26,425,425,115,115,0,1,0
9,427,427,12,12,0,1,0
6,446,446,4,4,0,1,0
39,453,453,44,44,0,1,0
19,456,456,38,14,24,3,2
24,461,461,54,38,16,3,2
2,466,466,66,66,0,1,0
33,469,469,5,1,4,2,1
5,474,474,20,20,0,1,0
13,477,477,1,1,0,1,0
7,492,492,3,3,0,1,0
22,496,496,49,49,0,1,0
21,498,498,135,135,0,1,0

1,104,104,1,1,0,1,0
32,105,105,16,16,0,1,0
38,107,107,27,4,23,2,1
16,109,109,25,25,0,1,0
6,110,110,5,2,3,2,1
41,110,110,15,1,14,3,2
40,111,111,3,3,0,1,0
45,112,112,21,21,0,1,0
13,113,113,11,11,0,1,0
3,129,129,2,2,0,1,0
12,136,136,1,1,0,1,0
42,137,137,1,1,0,1,0
24,146,146,3,3,0,1,0
39,165,165,9,9,0,1,0
29,168,168,2,2,0,1,0
37,172,172,10,5,5,2,1
5,182,182,7,1,6,2,1
2,216,216,4,4,0,1,0
26,237,237,35,35,0,1,0
20,240,240,34,34,0,1,0
35,245,245,23,23,0,1,0
0,255,255,2,2,0,1,0
31,266,266,29,6,23,2,1
11,287,287,3,3,0,1,0
46,293,293,13,8,5,2,1
27,312,312,70,70,0,1,0
9,326,326,55,19,36,4,3
18,339,339,6,1,5,2,1
23,341,341,69,21,48,3,2
17,354,354,73,73,0,1,0
4,356,356,11,11,0,1,0
34,361,361,14,14,0,1,0
30,368,368,10,10,0,1,0
33,375,375,8,8,0,1,0
43,377,377,79,79,0,1,0
21,380,380,50,50,0,1,0
8,389,389,29,29,0,1,0
25,398,398,3,3,0,1,0
14,415,415,25,12,13,2,1
28,423,423,38,8,30,4,3
10,426,426,52,52,0,1,0
22,428,428,5,1,4,2,1
7,433,433,42,31,11,2,1
19,456,456,15,15,0,1,0
36,488,488,116,44,72,3,2
15,499,499,25,16,9,4,3
44,500,500,34,6,28,2,1

34,110,110,20,20,0,1,0
27,129,129,21,21,0,1,0
33,131,131,6,6,0,1,0
6,132,132,9,3,6,3,2
20,148,148,2,2,0,1,0
35,166,166,3,3,0,1,0
32,169,169,52,52,0,1,0
0,179,179,23,23,0,1,0
8,184,184,48,11,37,2,1
24,203,203,5,5,0,1,0
22,203,203,33,33,0,1,0
5,204,204,44,24,20,3,2
26,239,239,41,41,0,1,0
13,249,249,110,80,30,4,3
29,250,250,11,11,0,1,0
12,251,251,4,1,3,2,1
19,251,251,42,2,40,3,2
17,271,271,8,4,4,2,1
9,275,275,78,78,0,1,0
23,282,282,28,28,0,1,0
11,323,323,44,2,42,3,2
4,332,332,7,7,0,1,0
1,349,349,16,16,0,1,0
18,357,357,1,1,0,1,0
16,372,372,16,16,0,1,0
10,373,373,1,1,0,1,0
3,384,384,17,17,0,1,0
21,385,385,34,34,0,1,0
2,386,386,10,2,8,3,2
30,397,397,9,9,0,1,0
31,409,409,69,69,0,1,0
7,420,420,16,10,6,2,1
15,430,430,79,73,6,2,1
14,457,457,41,23,18,4,3
25,487,487,19,19,0,1,0
28,496,496,129,102,27,2,1

33,104,104,15,9,6,3,2
2,106,106,18,10,8,2,1
25,123,123,3,3,0,1,0
31,127,127,6,6,0,1,0
24,128,128,6,6,0,1,0
27,134,134,20,20,0,1,0
4,149,149,32,4,28,3,2
28,158,158,12,8,4,2,1
11,167,167,39,3,36,3,2
26,173,173,4,4,0,1,0
32,176,176,32,32,0,1,0
20,177,177,4,4,0,1,0
17,183,183,13,8,5,2,1
19,202,202,19,19,0,1,0
29,204,204,3,3,0,1,0
37,222,222,10,10,0,1,0
12,235,235,15,7,8,2,1
36,247,247,30,30,0,1,0
1,249,249,43,43,0,1,0
16,255,255,1,1,0,1,0
10,265,265,8,8,0,1,0
15,274,274,5,2,3,2,1
34,275,275,5,5,0,1,0
8,283,283,16,16,0,1,0
13,290,290,9,1,8,3,2
18,303,303,23,5,18,3,2
39,313,313,18,18,0,1,0
6,319,319,40,7,33,4,3
42,324,324,38,38,0,1,0
7,328,328,14,4,10,2,1
0,329,329,5,5,0,1,0
38,338,338,56,8,48,4,3
30,341,341,86,26,60,4,3
23,360,360,4,1,3,2,1
21,372,372,1,1,0,1,0
22,401,401,3,3,0,1,0
5,408,408,22,22,0,1,0
9,414,414,47,19,28,2,1
41,426,426,165,71,94,3,2
3,445,445,48,17,31,2,1
35,464,464,44,44,0,1,0
43,476,476,5,5,0,1,0
40,490,490,32,6,26,3,2
14,495,495,130,108,22,3,2

2,102,102,14,8,6,2,1
44,111,111,7,7,0,1,0
39,130,130,41,41,0,1,0
37,131,131,8,8,0,1,0
33,142,142,28,28,0,1,0
34,143,143,12,5,7,2,1
19,151,151,8,8,0,1,0
3,158,158,7,7,0,1,0
17,164,164,12,12,0,1,0
22,176,176,2,2,0,1,0
6,178,178,4,4,0,1,0
32,180,180,15,3,12,2,1
27,184,184,5,5,0,1,0
40,186,186,16,6,10,2,1
25,186,186,48,48,0,1,0
35,188,188,66,20,46,3,2
24,194,194,7,7,0,1,0
8,194,194,19,13,6,3,2
26,216,216,6,6,0,1,0
5,221,221,24,24,0,1,0
12,222,222,3,3,0,1,0
30,250,250,4,4,0,1,0
41,263,263,46,25,21,4,3
4,267,267,1,1,0,1,0
0,290,290,36,2,34,3,2
7,303,303,5,5,0,1,0
9,306,306,15,3,12,4,3
21,310,310,82,82,0,1,0
13,317,317,6,6,0,1,0
31,345,345,1,1,0,1,0
16,346,346,83,83,0,1,0
15,349,349,8,1,7,2,1
38,364,364,66,27,39,2,1
1,366,366,2,2,0,1,0
28,372,372,1,1,0,1,0
23,372,372,55,55,0,1,0
43,374,374,4,1,3,2,1
10,407,407,73,33,40,3,2
29,409,409,20,20,0,1,0
11,416,416,49,49,0,1,0
18,463,463,17,2,15,2,1
42,464,464,18,2,16,2,1
36,470,470,13,13,0,1,0
20,490,490,40,40,0,1,0
14,495,495,48,48,0,1,0

10,104,104,16,16,0,1,0
11,126,126,13,13,0,1,0
9,139,139,7,1,6,2,1
23,148,148,50,50,0,1,0
12,176,176,27,27,0,1,0
39,179,179,4,1,3,2,1
13,209,209,70,70,0,1,0
32,212,212,45,27,18,2,1
3,236,236,9,3,6,2,1
33,236,236,52,30,22,2,1
5,243,243,5,5,0,1,0
37,247,247,48,22,26,2,1
35,262,262,1,1,0,1,0
26,274,274,32,32,0,1,0
2,279,279,11,11,0,1,0
7,279,279,13,13,0,1,0
24,282,282,46,46,0,1,0
14,294,294,22,16,6,3,2
21,306,306,4,4,0,1,0
17,308,308,46,46,0,1,0
4,310,310,72,24,48,4,3
6,323,323,15,8,7,2,1
18,325,325,7,3,4,2,1
8,343,343,14,14,0,1,0
0,346,346,92,51,41,2,1
19,363,363,26,26,0,1,0
1,366,366,24,8,16,4,3
29,371,371,24,10,14,3,2
31,374,374,16,16,0,1,0
30,390,390,2,2,0,1,0
28,406,406,72,72,0,1,0
22,419,419,16,16,0,1,0
25,429,429,35,26,9,4,3
36,432,432,34,4,30,4,3
15,435,435,25,13,12,3,2
20,451,451,12,12,0,1,0
34,468,468,59,28,31,2,1
27,471,471,1,1,0,1,0
38,476,476,53,38,15,3,2
16,489,489,17,17,0,1,0

27,101,101,35,31,4,2,1
3,103,103,1,1,0,1,0
7,104,104,6,6,0,1,0
30,119,119,7,7,0,1,0
21,123,123,16,1,15,4,3
13,126,126,21,5,16,2,1
35,135,135,11,1,10,3,2
26,137,137,14,14,0,1,0
17,166,166,2,2,0,1,0
15,183,183,1,1,0,1,0
29,183,183,30,4,26,2,1
39,208,208,2,2,0,1,0
2,210,210,20,20,0,1,0
25,214,214,24,24,0,1,0
5,222,222,37,37,0,1,0
20,231,231,1,1,0,1,0
28,243,243,23,23,0,1,0
14,245,245,33,5,28,3,2
11,253,253,18,18,0,1,0
12,257,257,10,10,0,1,0
1,261,261,34,34,0,1,0
10,264,264,16,16,0,1,0
0,283,283,1,1,0,1,0
24,304,304,39,33,6,3,2
16,330,330,8,8,0,1,0
8,393,393,67,10,57,4,3
23,393,393,9,3,6,2,1
36,399,399,52,52,0,1,0
6,404,404,68,68,0,1,0
38,411,411,22,22,0,1,0
9,418,418,69,29,40,4,3
40,441,441,4,1,3,2,1
43,445,445,50,50,0,1,0
32,447,447,8,8,0,1,0
31,454,454,43,7,36,4,3
19,456,456,31,7,24,3,2
42,458,458,100,10,90,4,3
34,462,462,7,1,6,3,2
22,466,466,53,53,0,1,0
41,472,472,72,72,0,1,0
4,478,478,24,8,16,3,2
44,481,481,57,36,21,4,3
37,489,489,5,5,0,1,0
18,499,499,1,1,0,1,0
33,500,500,72,72,0,1,0

9,105,105,5,5,0,1,0
35,123,123,19,19,0,1,0
39,143,143,12,2,10,3,2
40,145,145,4,4,0,1,0
27,154,154,5,5,0,1,0
34,156,156,56,32,24,3,2
24,166,166,13,1,12,4,3
13,167,167,43,43,0,1,0
6,174,174,8,8,0,1,0
17,182,182,18,18,0,1,0
32,183,183,24,24,0,1,0
37,194,194,26,6,20,3,2
7,203,203,21,9,12,4,3
0,221,221,4,4,0,1,0
26,222,222,11,11,0,1,0
16,242,242,4,4,0,1,0
25,247,247,10,10,0,1,0
8,262,262,28,28,0,1,0
19,262,262,46,10,36,2,1
22,271,271,27,27,0,1,0
5,283,283,8,8,0,1,0
33,326,326,1,1,0,1,0
18,330,330,1,1,0,1,0
1,330,330,7,7,0,1,0
20,333,333,120,70,50,2,1
41,340,340,89,3,86,3,2
12,348,348,122,104,18,3,2
28,372,372,22,3,19,4,3
15,381,381,88,88,0,1,0
36,382,382,18,18,0,1,0
23,390,390,31,31,0,1,0
14,407,407,2,2,0,1,0
30,416,416,14,14,0,1,0
11,427,427,16,16,0,1,0
10,430,430,9,9,0,1,0
21,438,438,1,1,0,1,0
2,438,438,6,6,0,1,0
3,447,447,4,4,0,1,0
31,454,454,152,108,44,4,3
4,459,459,22,22,0,1,0
29,472,472,10,3,7,2,1
38,489,489,4,4,0,1,0

11,104,104,2,2,0,1,0
3,112,112,12,12,0,1,0
40,120,120,27,9,18,4,3
30,125,125,10,10,0,1,0
16,127,127,4,4,0,1,0
24,144,144,2,2,0,1,0
4,148,148,49,49,0,1,0
23,158,158,10,10,0,1,0
31,159,159,17,7,10,2,1
17,170,170,1,1,0,1,0
38,172,172,25,7,18,4,3
2,179,179,12,5,7,2,1
18,191,191,2,2,0,1,0
0,202,202,1,1,0,1,0
8,202,202,12,12,0,1,0
32,213,213,24,24,0,1,0
10,215,215,10,5,5,2,1
12,233,233,82,2,80,3,2
1,237,237,2,2,0,1,0
34,248,248,14,14,0,1,0
9,260,260,29,29,0,1,0
27,267,267,20,20,0,1,0
14,281,281,40,40,0,1,0
36,283,283,69,60,9,2,1
6,283,283,14,3,11,2,1
25,293,293,68,68,0,1,0
5,297,297,19,10,9,4,3
37,301,301,50,50,0,1,0
26,370,370,8,8,0,1,0
35,393,393,3,3,0,1,0
29,410,410,50,50,0,1,0
33,412,412,7,3,4,2,1
7,441,441,27,1,26,3,2
13,456,456,115,99,16,3,2
20,460,460,79,61,18,4,3
22,463,463,48,12,36,3,2
19,468,468,4,4,0,1,0
21,470,470,30,2,28,3,2
39,473,473,20,17,3,2,1
15,480,480,46,46,0,1,0
28,500,500,73,73,0,1,0

10,104,104,21,5,16,2,1
26,107,107,27,27,0,1,0
38,119,119,11,2,9,2,1
40,127,127,1,1,0,1,0
39,127,127,21,21,0,1,0
13,145,145,14,14,0,1,0
22,167,167,5,5,0,1,0
28,172,172,18,18,0,1,0
24,176,176,8,5,3,2,1
21,179,179,2,2,0,1,0
9,184,184,22,22,0,1,0
6,203,203,16,5,11,2,1
43,223,223,11,11,0,1,0
3,234,234,7,7,0,1,0
20,258,258,46,46,0,1,0
23,273,273,18,18,0,1,0
19,322,322,19,1,18,3,2
32,340,340,12,9,3,2,1
27,348,348,2,2,0,1,0
1,365,365,41,41,0,1,0
15,370,370,36,36,0,1,0
35,370,370,113,58,55,4,3
34,384,384,28,28,0,1,0
42,402,402,18,18,0,1,0
0,406,406,76,49,27,4,3
33,412,412,104,48,56,3,2
18,415,415,34,29,5,2,1
14,416,416,40,40,0,1,0
2,418,418,87,9,78,3,2
25,418,418,13,10,3,2,1
31,419,419,85,34,51,3,2
37,424,424,10,6,4,2,1
5,425,425,28,9,19,4,3
17,431,431,15,15,0,1,0
4,432,432,20,20,0,1,0
12,447,447,1,1,0,1,0
16,466,466,62,17,45,4,3
30,470,470,79,12,67,4,3
7,478,478,26,16,10,2,1
8,478,478,2,2,0,1,0
11,485,485,4,4,0,1,0
41,485,485,16,16,0,1,0
29,492,492,54,54,0,1,0
36,493,493,25,7,18,3,2

6,111,111,11,2,9,4,3
3,123,123,22,10,12,4,3
38,129,129,5,5,0,1,0
39,129,129,7,7,0,1,0
36,146,146,39,39,0,1,0
7,156,156,6,1,5,2,1
9,157,157,2,2,0,1,0
18,159,159,8,8,0,1,0
22,181,181,9,1,8,3,2
1,187,187,8,8,0,1,0
2,192,192,28,18,10,2,1
27,194,194,3,3,0,1,0
32,197,197,22,22,0,1,0
34,219,219,62,3,59,4,3
19,221,221,14,14,0,1,0
25,243,243,15,12,3,2,1
31,249,249,5,5,0,1,0
16,249,249,51,51,0,1,0
17,258,258,40,40,0,1,0
35,277,277,30,3,27,4,3
26,278,278,7,7,0,1,0
8,289,289,10,10,0,1,0
12,330,330,123,46,77,4,3
11,332,332,40,17,23,4,3
28,347,347,7,2,5,2,1
0,354,354,42,42,0,1,0
21,355,355,5,5,0,1,0
30,357,357,25,25,0,1,0
15,365,365,1,1,0,1,0
29,384,384,54,10,44,2,1
10,385,385,10,1,9,2,1
14,389,389,31,13,18,4,3
37,395,395,6,3,3,2,1
5,400,400,17,3,14,2,1
13,410,410,50,50,0,1,0
20,417,417,72,72,0,1,0
24,421,421,29,16,13,2,1
33,424,424,123,74,49,4,3
4,447,447,41,23,18,4,3
23,498,498,102,60,42,4,3

3,103,103,14,5,9,2,1
4,109,109,9,9,0,1,0
19,128,128,31,31,0,1,0
41,151,151,20,20,0,1,0
42,154,154,17,17,0,1,0
25,156,156,21,4,17,2,1
33,167,167,45,2,43,2,1
35,169,169,18,15,3,2,1
14,194,194,13,5,8,3,2
32,198,198,8,8,0,1,0
17,210,210,4,4,0,1,0
20,211,211,1,1,0,1,0
36,213,213,12,12,0,1,0
6,228,228,13,13,0,1,0
37,235,235,2,2,0,1,0
10,241,241,3,3,0,1,0
8,250,250,20,20,0,1,0
39,263,263,24,24,0,1,0
2,269,269,38,12,26,3,2
5,269,269,16,7,9,2,1
0,270,270,3,3,0,1,0
9,289,289,4,4,0,1,0
13,291,291,52,27,25,4,3
30,296,296,61,27,34,2,1
38,310,310,15,6,9,4,3
23,311,311,56,56,0,1,0
21,335,335,97,97,0,1,0
11,353,353,18,18,0,1,0
16,358,358,2,2,0,1,0
28,368,368,26,26,0,1,0
27,369,369,16,4,12,3,2
29,372,372,9,6,3,2,1
1,403,403,34,9,25,2,1
18,429,429,2,2,0,1,0
24,460,460,65,65,0,1,0
7,461,461,108,78,30,3,2
34,463,463,36,30,6,2,1
15,465,465,11,3,8,3,2
26,466,466,38,38,0,1,0
40,471,471,36,36,0,1,0
12,473,473,28,10,18,2,1
22,476,476,68,16,52,3,2
31,496,496,66,19,47,2,1

30,109,109,2,2,0,1,0
2,114,114,47,8,39,4,3
5,128,128,31,31,0,1,0
20,140,140,10,10,0,1,0
15,169,169,9,9,0,1,0
11,188,188,9,1,8,3,2
7,190,190,2,2,0,1,0
18,209,209,39,29,10,3,2
33,229,229,8,8,0,1,0
21,231,231,19,19,0,1,0
12,234,234,15,15,0,1,0
17,264,264,37,37,0,1,0
8,273,273,3,3,0,1,0
13,290,290,25,2,23,2,1
14,313,313,82,44,38,4,3
35,322,322,7,2,5,2,1
1,329,329,12,3,9,2,1
34,331,331,67,40,27,4,3
9,332,332,98,26,72,4,3
22,334,334,32,6,26,2,1
10,338,338,13,5,8,3,2
24,355,355,8,8,0,1,0
26,366,366,13,13,0,1,0
31,367,367,62,37,25,2,1
4,373,373,13,13,0,1,0
28,389,389,1,1,0,1,0
6,390,390,20,4,16,3,2
3,396,396,91,43,48,4,3
27,428,428,50,50,0,1,0
32,446,446,21,11,10,2,1
19,448,448,7,7,0,1,0
25,459,459,47,47,0,1,0
0,462,462,59,27,32,4,3
29,463,463,167,85,82,4,3
23,465,465,109,49,60,3,2
16,468,468,32,24,8,3,2

34,106,106,14,14,0,1,0
9,125,125,4,4,0,1,0
33,134,134,33,18,15,4,3
4,157,157,16,16,0,1,0
1,160,160,2,2,0,1,0
22,163,163,8,8,0,1,0
35,188,188,6,6,0,1,0
3,196,196,9,9,0,1,0
14,205,205,3,3,0,1,0
37,245,245,42,32,10,2,1
30,246,246,2,2,0,1,0
21,264,264,25,13,12,2,1
25,267,267,57,40,17,4,3
27,269,269,29,29,0,1,0
13,269,269,23,23,0,1,0
7,269,269,7,7,0,1,0
18,289,289,14,14,0,1,0
16,294,294,25,25,0,1,0
29,306,306,93,62,31,2,1
0,322,322,57,57,0,1,0
36,357,357,25,12,13,3,2
24,359,359,41,8,33,3,2
11,363,363,83,83,0,1,0
15,364,364,21,9,12,2,1
38,373,373,39,39,0,1,0
5,402,402,85,85,0,1,0
6,422,422,95,68,27,4,3
12,424,424,93,29,64,3,2
19,433,433,69,69,0,1,0
17,444,444,8,8,0,1,0
28,455,455,4,4,0,1,0
26,459,459,7,2,5,2,1
2,467,467,90,90,0,1,0
10,470,470,64,64,0,1,0
8,478,478,40,40,0,1,0
20,479,479,77,32,45,4,3
23,485,485,5,5,0,1,0
32,487,487,15,5,10,3,2
31,491,491,3,3,0,1,0

23,126,126,44,18,26,2,1
8,130,130,5,2,3,2,1
34,136,136,5,5,0,1,0
26,139,139,12,12,0,1,0
21,145,145,1,1,0,1,0
38,148,148,8,8,0,1,0
28,155,155,3,3,0,1,0
33,157,157,9,3,6,3,2
5,167,167,8,8,0,1,0
16,174,174,3,3,0,1,0
24,190,190,7,7,0,1,0
17,191,191,7,7,0,1,0
10,205,205,4,4,0,1,0
41,230,230,8,8,0,1,0
27,238,238,39,32,7,2,1
7,241,241,77,77,0,1,0
29,247,247,10,1,9,3,2
35,266,266,50,42,8,2,1
1,284,284,6,2,4,2,1
20,285,285,20,20,0,1,0
37,286,286,35,35,0,1,0
39,286,286,3,3,0,1,0
40,290,290,37,37,0,1,0
12,304,304,20,20,0,1,0
13,313,313,13,13,0,1,0
15,321,321,55,8,47,2,1
31,337,337,44,21,23,2,1
25,375,375,19,19,0,1,0
6,378,378,14,14,0,1,0
19,380,380,7,3,4,2,1
2,384,384,71,71,0,1,0
18,391,391,28,10,18,2,1
0,421,421,22,15,7,2,1
42,426,426,191,133,58,4,3
14,429,429,4,1,3,2,1
36,441,441,12,12,0,1,0
11,455,455,31,31,0,1,0
22,455,455,153,36,117,4,3
3,458,458,54,54,0,1,0
9,463,463,70,70,0,1,0
4,466,466,46,8,38,3,2
30,467,467,3,3,0,1,0
32,500,500,31,31,0,1,0

9,105,105,1,1,0,1,0
27,127,127,3,3,0,1,0
19,139,139,16,16,0,1,0
2,141,141,7,7,0,1,0
10,142,142,12,2,10,2,1
12,156,156,5,5,0,1,0
14,170,170,52,52,0,1,0
26,179,179,33,11,22,3,2
28,198,198,9,9,0,1,0
33,220,220,7,7,0,1,0
31,223,223,4,4,0,1,0
17,229,229,12,5,7,2,1
8,229,229,19,4,15,2,1
22,233,233,11,11,0,1,0
20,236,236,7,7,0,1,0
36,264,264,75,9,66,4,3
23,268,268,2,2,0,1,0
16,295,295,29,29,0,1,0
30,296,296,8,2,6,2,1
35,305,305,30,2,28,3,2
4,310,310,23,13,10,3,2
7,311,311,84,2,82,3,2
25,323,323,17,3,14,3,2
3,335,335,13,13,0,1,0
6,338,338,38,38,0,1,0
11,341,341,60,3,57,4,3
1,341,341,43,43,0,1,0
37,350,350,8,2,6,2,1
18,373,373,75,7,68,4,3
0,408,408,15,15,0,1,0
34,445,445,25,25,0,1,0
24,450,450,55,55,0,1,0
5,453,453,36,3,33,4,3
15,472,472,174,146,28,3,2
29,475,475,151,102,49,4,3
13,479,479,2,2,0,1,0
32,496,496,72,54,18,2,1
21,499,499,104,47,57,4,3

28,100,100,7,7,0,1,0
9,121,121,4,4,0,1,0
16,124,124,21,21,0,1,0
17,126,126,1,1,0,1,0
4,145,145,20,20,0,1,0
29,146,146,5,2,3,2,1
33,169,169,6,6,0,1,0
34,188,188,1,1,0,1,0
3,201,201,1,1,0,1,0
30,202,202,37,37,0,1,0
2,235,235,61,50,11,2,1
13,248,248,31,31,0,1,0
20,276,276,33,3,30,2,1
27,283,283,119,81,38,3,2
5,286,286,39,39,0,1,0
12,288,288,14,14,0,1,0
22,307,307,28,23,5,2,1
24,308,308,13,2,11,2,1
21,318,318,25,1,24,3,2
7,331,331,16,16,0,1,0
6,337,337,14,14,0,1,0
18,339,339,2,2,0,1,0
10,363,363,2,2,0,1,0
26,378,378,92,60,32,2,1
35,387,387,67,19,48,3,2
1,427,427,111,66,45,4,3
25,430,430,5,5,0,1,0
32,431,431,27,27,0,1,0
15,435,435,48,48,0,1,0
14,435,435,39,32,7,2,1
0,446,446,22,8,14,2,1
11,449,449,51,17,34,3,2
8,455,455,245,155,90,3,2
23,482,482,3,3,0,1,0
31,492,492,64,4,60,4,3
19,499,499,79,4,75,4,3

5,109,109,5,1,4,2,1
14,113,113,11,5,6,3,2
21,119,119,6,6,0,1,0
20,126,126,3,3,0,1,0
26,141,141,8,4,4,2,1
40,142,142,6,6,0,1,0
3,145,145,6,6,0,1,0
4,162,162,23,9,14,4,3
25,172,172,7,7,0,1,0
31,176,176,2,2,0,1,0
23,184,184,24,3,21,4,3
17,185,185,24,6,18,2,1
27,188,188,9,5,4,2,1
35,196,196,28,28,0,1,0
19,205,205,4,1,3,2,1
9,210,210,7,3,4,2,1
1,214,214,24,24,0,1,0
32,216,216,57,57,0,1,0
16,223,223,41,41,0,1,0
39,243,243,65,14,51,4,3
18,244,244,43,34,9,2,1
8,253,253,28,28,0,1,0
46,254,254,42,6,36,2,1
28,259,259,22,22,0,1,0
34,273,273,14,2,12,3,2
37,278,278,33,33,0,1,0
30,283,283,8,8,0,1,0
38,287,287,1,1,0,1,0
29,290,290,21,15,6,2,1
44,304,304,29,8,21,2,1
42,315,315,46,46,0,1,0
13,324,324,12,12,0,1,0
12,327,327,12,12,0,1,0
36,345,345,30,30,0,1,0
45,346,346,99,90,9,4,3
10,349,349,53,46,7,2,1
2,371,371,24,24,0,1,0
15,382,382,23,23,0,1,0
24,384,384,27,27,0,1,0
6,389,389,3,3,0,1,0
22,393,393,6,6,0,1,0
33,444,444,4,4,0,1,0
41,467,467,8,8,0,1,0
7,474,474,27,10,17,2,1
43,489,489,46,7,39,4,3
11,495,495,19,16,3,2,1
0,498,498,36,23,13,2,1

39,124,124,38,14,24,2,1
2,144,144,1,1,0,1,0
33,151,151,18,18,0,1,0
5,174,174,10,10,0,1,0
14,175,175,1,1,0,1,0
19,191,191,19,9,10,2,1
25,193,193,15,8,7,2,1
4,200,200,51,51,0,1,0
30,204,204,5,5,0,1,0
15,207,207,31,15,16,2,1
13,212,212,53,2,51,4,3
17,218,218,33,3,30,3,2
40,218,218,33,18,15,2,1
10,229,229,1,1,0,1,0
34,243,243,19,5,14,3,2
11,243,243,19,19,0,1,0
1,270,270,32,19,13,2,1
12,288,288,16,16,0,1,0
3,289,289,8,8,0,1,0
38,294,294,4,4,0,1,0
20,298,298,12,2,10,3,2
7,323,323,45,45,0,1,0
29,350,350,47,27,20,4,3
0,357,357,60,20,40,2,1
31,359,359,6,6,0,1,0
26,366,366,47,47,0,1,0
8,367,367,47,47,0,1,0
27,383,383,2,2,0,1,0
18,396,396,1,1,0,1,0
32,408,408,69,32,37,4,3
35,415,415,7,1,6,2,1
22,430,430,140,106,34,3,2
36,433,433,31,12,19,3,2
23,451,451,9,5,4,2,1
21,456,456,59,59,0,1,0
28,461,461,41,41,0,1,0
6,464,464,48,48,0,1,0
37,467,467,3,3,0,1,0
16,473,473,5,5,0,1,0
24,477,477,103,103,0,1,0
41,479,479,32,32,0,1,0
9,482,482,9,9,0,1,0

41,100,100,22,22,0,1,0
15,105,105,9,6,3,2,1
8,106,106,6,6,0,1,0
19,109,109,5,5,0,1,0
16,109,109,19,2,17,3,2
1,110,110,5,5,0,1,0
21,124,124,2,2,0,1,0
5,141,141,3,3,0,1,0
34,143,143,1,1,0,1,0
43,148,148,28,28,0,1,0
4,152,152,6,6,0,1,0
18,212,212,1,1,0,1,0
3,219,219,6,2,4,2,1
23,237,237,41,41,0,1,0
12,252,252,13,13,0,1,0
14,259,259,29,29,0,1,0
29,260,260,5,5,0,1,0
9,266,266,27,8,19,2,1
2,294,294,37,10,27,2,1
0,311,311,19,7,12,4,3
37,312,312,14,2,12,4,3
36,322,322,17,8,9,4,3
6,330,330,14,14,0,1,0
32,336,336,132,97,35,3,2
42,353,353,5,5,0,1,0
39,365,365,23,23,0,1,0
10,392,392,9,6,3,2,1
28,416,416,37,6,31,2,1
35,421,421,17,9,8,3,2
7,427,427,11,11,0,1,0
20,433,433,39,3,36,3,2
38,434,434,11,11,0,1,0
24,443,443,3,3,0,1,0
40,444,444,19,3,16,2,1
31,451,451,104,82,22,3,2
17,457,457,10,5,5,2,1
22,458,458,21,11,10,3,2
44,461,461,83,29,54,4,3
27,463,463,84,72,12,4,3
26,464,464,37,37,0,1,0
25,465,465,181,98,83,4,3
11,467,467,66,5,61,4,3
13,467,467,34,13,21,4,3
30,475,475,1,1,0,1,0
33,480,480,15,5,10,2,1
45,489,489,61,43,18,4,3

36,129,129,14,14,0,1,0
8,129,129,7,7,0,1,0
41,130,130,22,22,0,1,0
35,133,133,6,6,0,1,0
40,137,137,35,8,27,4,3
39,172,172,17,17,0,1,0
38,175,175,3,3,0,1,0
11,201,201,4,4,0,1,0
26,204,204,69,69,0,1,0
33,208,208,7,7,0,1,0
19,223,223,6,2,4,2,1
16,223,223,20,20,0,1,0
25,228,228,9,3,6,2,1
31,231,231,3,3,0,1,0
17,235,235,57,44,13,2,1
21,239,239,36,27,9,4,3
29,255,255,30,30,0,1,0
4,263,263,5,5,0,1,0
22,271,271,2,2,0,1,0
1,278,278,12,3,9,2,1
18,304,304,14,7,7,2,1
27,317,317,27,11,16,2,1
2,320,320,87,87,0,1,0
23,323,323,42,15,27,2,1
30,324,324,30,30,0,1,0
9,333,333,1,1,0,1,0
13,349,349,3,3,0,1,0
20,357,357,55,14,41,4,3
10,389,389,35,12,23,4,3
12,399,399,10,2,8,2,1
32,405,405,11,3,8,2,1
5,427,427,35,4,31,4,3
37,427,427,32,32,0,1,0
0,429,429,119,107,12,2,1
34,439,439,4,1,3,2,1
14,450,450,7,7,0,1,0
7,450,450,69,29,40,2,1
6,463,463,5,5,0,1,0
15,470,470,39,3,36,3,2
3,477,477,65,31,34,3,2
28,497,497,102,65,37,2,1
24,500,500,88,64,24,3,2

10,139,139,14,14,0,1,0
32,141,141,31,31,0,1,0
4,150,150,15,15,0,1,0
44,153,153,31,9,22,3,2
37,158,158,39,1,38,2,1
15,160,160,6,6,0,1,0
12,172,172,1,1,0,1,0
46,182,182,4,1,3,2,1
24,189,189,1,1,0,1,0
35,207,207,13,13,0,1,0
25,218,218,1,1,0,1,0
18,219,219,1,1,0,1,0
8,219,219,15,15,0,1,0
43,225,225,11,11,0,1,0
42,242,242,10,7,3,2,1
27,253,253,7,2,5,2,1
34,254,254,65,61,4,2,1
30,254,254,15,15,0,1,0
29,280,280,46,46,0,1,0
38,297,297,30,30,0,1,0
23,303,303,80,80,0,1,0
1,309,309,1,1,0,1,0
21,313,313,24,2,22,2,1
6,329,329,13,6,7,2,1
33,344,344,35,35,0,1,0
11,349,349,32,8,24,4,3
39,355,355,6,6,0,1,0
13,355,355,116,116,0,1,0
31,357,357,37,37,0,1,0
22,359,359,27,27,0,1,0
47,360,360,8,8,0,1,0
16,362,362,14,2,12,4,3
28,369,369,9,9,0,1,0
2,372,372,17,17,0,1,0
9,378,378,17,5,12,2,1
26,390,390,12,4,8,2,1
40,395,395,11,11,0,1,0
7,396,396,15,9,6,2,1
19,411,411,37,28,9,2,1
17,413,413,70,52,18,2,1
41,415,415,50,50,0,1,0
5,426,426,16,16,0,1,0
45,482,482,72,72,0,1,0
36,486,486,26,13,13,3,2
48,489,489,9,9,0,1,0
3,490,490,12,12,0,1,0
0,499,499,67,67,0,1,0
20,499,499,12,2,10,3,2
14,500,500,33,33,0,1,0

7,108,108,1,1,0,1,0
23,124,124,8,8,0,1,0
9,146,146,1,1,0,1,0
21,148,148,10,5,5,2,1
38,152,152,15,6,9,2,1
17,152,152,13,1,12,3,2
36,155,155,14,14,0,1,0
18,164,164,64,55,9,4,3
4,167,167,6,6,0,1,0
31,186,186,2,2,0,1,0
27,211,211,49,31,18,4,3
25,211,211,2,2,0,1,0
30,211,211,27,27,0,1,0
13,212,212,37,1,36,2,1
19,221,221,25,4,21,4,3
1,239,239,37,32,5,2,1
3,241,241,70,70,0,1,0
26,256,256,66,66,0,1,0
10,268,268,16,7,9,4,3
6,302,302,9,4,5,2,1
2,336,336,18,12,6,3,2
16,337,337,34,4,30,3,2
11,338,338,49,49,0,1,0
32,346,346,34,34,0,1,0
14,353,353,25,9,16,3,2
24,386,386,29,29,0,1,0
20,387,387,1,1,0,1,0
29,391,391,100,100,0,1,0
28,392,392,17,8,9,2,1
0,402,402,5,1,4,2,1
34,409,409,34,34,0,1,0
35,424,424,106,106,0,1,0
33,447,447,13,13,0,1,0
37,448,448,24,6,18,3,2
8,460,460,54,10,44,2,1
12,465,465,49,49,0,1,0
15,469,469,64,64,0,1,0
5,490,490,11,5,6,3,2
22,492,492,38,38,0,1,0

14,107,107,3,3,0,1,0
32,123,123,8,8,0,1,0
11,130,130,22,22,0,1,0
34,136,136,14,8,6,3,2
7,141,141,68,44,24,3,2
8,142,142,42,20,22,2,1
10,148,148,5,2,3,2,1
36,164,164,7,7,0,1,0
0,166,166,1,1,0,1,0
22,169,169,22,22,0,1,0
17,179,179,20,20,0,1,0
21,189,189,35,15,20,3,2
37,197,197,43,43,0,1,0
26,197,197,16,9,7,3,2
1,198,198,9,5,4,2,1
12,232,232,4,4,0,1,0
9,235,235,33,33,0,1,0
38,242,242,40,14,26,4,3
2,245,245,24,24,0,1,0
25,250,250,78,78,0,1,0
13,261,261,90,90,0,1,0
20,268,268,2,2,0,1,0
4,270,270,11,5,6,2,1
35,275,275,26,2,24,2,1
15,276,276,3,3,0,1,0
27,280,280,5,5,0,1,0
24,287,287,35,17,18,4,3
30,310,310,9,9,0,1,0
29,316,316,10,10,0,1,0
31,330,330,50,10,40,2,1
33,348,348,19,3,16,3,2
6,354,354,1,1,0,1,0
28,369,369,43,43,0,1,0
23,376,376,9,9,0,1,0
18,381,381,1,1,0,1,0
39,400,400,34,12,22,3,2
5,427,427,25,22,3,2,1
16,466,466,18,18,0,1,0
3,475,475,13,13,0,1,0
19,476,476,22,22,0,1,0

3,112,112,27,27,0,1,0
37,119,119,2,2,0,1,0
13,124,124,9,9,0,1,0
23,129,129,8,1,7,2,1
30,135,135,6,6,0,1,0
16,160,160,26,4,22,3,2
6,170,170,3,3,0,1,0
25,179,179,5,5,0,1,0
18,180,180,21,12,9,4,3
0,181,181,1,1,0,1,0
9,197,197,9,3,6,3,2
44,203,203,1,1,0,1,0
26,209,209,1,1,0,1,0
24,213,213,33,6,27,4,3
1,215,215,14,14,0,1,0
42,218,218,33,3,30,4,3
19,230,230,13,13,0,1,0
31,258,258,19,19,0,1,0
28,265,265,3,3,0,1,0
20,278,278,4,1,3,2,1
2,283,283,5,5,0,1,0
38,289,289,51,42,9,2,1
12,300,300,43,19,24,4,3
11,301,301,85,39,46,3,2
10,312,312,24,8,16,2,1
43,315,315,39,15,24,4,3
22,320,320,31,2,29,4,3
35,321,321,4,4,0,1,0
8,324,324,19,19,0,1,0
5,337,337,1,1,0,1,0
46,343,343,18,18,0,1,0
21,343,343,3,3,0,1,0
34,352,352,56,40,16,3,2
14,411,411,34,10,24,4,3
7,419,419,10,5,5,2,1
41,419,419,115,77,38,3,2
45,427,427,84,71,13,2,1
29,445,445,23,9,14,4,3
36,460,460,55,40,15,2,1
27,461,461,63,63,0,1,0
32,472,472,52,7,45,2,1
15,477,477,2,2,0,1,0
4,478,478,2,2,0,1,0
17,479,479,74,74,0,1,0
33,480,480,29,29,0,1,0
39,481,481,83,15,68,4,3
40,483,483,43,1,42,4,3

7,101,101,1,1,0,1,0
11,101,101,6,6,0,1,0
10,107,107,25,1,24,4,3
13,135,135,19,19,0,1,0
4,138,138,6,6,0,1,0
19,140,140,1,1,0,1,0
12,144,144,7,7,0,1,0
30,144,144,1,1,0,1,0
39,146,146,5,5,0,1,0
3,154,154,8,8,0,1,0
6,154,154,11,3,8,2,1
24,172,172,3,3,0,1,0
38,191,191,1,1,0,1,0
35,192,192,10,7,3,2,1
42,193,193,8,2,6,3,2
36,231,231,16,16,0,1,0
9,247,247,93,93,0,1,0
22,253,253,2,2,0,1,0
31,256,256,73,9,64,3,2
40,265,265,41,21,20,2,1
37,285,285,16,16,0,1,0
2,303,303,17,17,0,1,0
28,315,315,17,17,0,1,0
15,333,333,4,1,3,2,1
26,340,340,11,1,10,2,1
5,342,342,27,6,21,2,1
27,365,365,17,9,8,2,1
8,377,377,10,6,4,2,1
18,380,380,36,36,0,1,0
20,380,380,53,3,50,3,2
16,380,380,16,16,0,1,0
17,381,381,8,5,3,2,1
0,384,384,52,52,0,1,0
14,395,395,21,12,9,4,3
21,403,403,48,16,32,3,2
32,422,422,60,21,39,2,1
34,438,438,153,78,75,4,3
29,463,463,34,34,0,1,0
23,464,464,79,23,56,3,2
1,471,471,82,82,0,1,0
41,478,478,90,90,0,1,0
25,488,488,109,61,48,2,1
33,495,495,18,4,14,2,1

35,107,107,6,6,0,1,0
28,108,108,4,1,3,2,1
15,112,112,7,7,0,1,0
38,117,117,29,8,21,4,3
5,128,128,7,7,0,1,0
2,146,146,14,9,5,2,1
39,151,151,8,8,0,1,0
32,164,164,6,6,0,1,0
34,167,167,22,22,0,1,0
33,171,171,64,49,15,2,1
8,176,176,31,25,6,2,1
16,189,189,15,15,0,1,0
24,189,189,4,4,0,1,0
25,192,192,24,24,0,1,0
1,195,195,25,7,18,3,2
31,203,203,29,19,10,2,1
29,258,258,2,2,0,1,0
10,306,306,81,47,34,4,3
37,312,312,2,2,0,1,0
21,313,313,33,18,15,4,3
19,317,317,26,26,0,1,0
0,328,328,12,12,0,1,0
22,329,329,3,3,0,1,0
11,331,331,1,1,0,1,0
13,346,346,18,18,0,1,0
14,355,355,143,25,118,4,3
6,359,359,11,11,0,1,0
27,402,402,36,7,29,4,3
23,421,421,56,56,0,1,0
3,421,421,5,5,0,1,0
4,428,428,13,7,6,2,1
9,436,436,63,63,0,1,0
20,437,437,9,3,6,3,2
12,439,439,46,46,0,1,0
30,447,447,137,137,0,1,0
18,458,458,27,27,0,1,0
7,473,473,75,44,31,2,1
17,483,483,11,11,0,1,0
26,492,492,50,35,15,2,1
36,494,494,16,5,11,2,1

10,109,109,3,3,0,1,0
32,112,112,20,8,12,3,2
6,121,121,25,20,5,2,1
4,132,132,14,2,12,3,2
27,153,153,16,16,0,1,0
23,184,184,20,20,0,1,0
19,195,195,28,28,0,1,0
20,206,206,50,50,0,1,0
11,226,226,41,1,40,3,2
1,243,243,6,6,0,1,0
30,244,244,8,8,0,1,0
2,277,277,83,83,0,1,0
13,281,281,4,1,3,2,1
33,285,285,51,36,15,4,3
15,285,285,14,5,9,4,3
7,287,287,96,24,72,4,3
21,287,287,40,10,30,4,3
25,288,288,10,10,0,1,0
14,315,315,19,19,0,1,0
5,324,324,12,12,0,1,0
28,349,349,80,28,52,3,2
29,351,351,24,6,18,2,1
17,386,386,22,15,7,3,2
18,390,390,2,2,0,1,0
0,393,393,74,74,0,1,0
22,396,396,54,44,10,3,2
24,413,413,54,54,0,1,0
12,419,419,4,1,3,2,1
3,422,422,106,91,15,4,3
8,431,431,85,7,78,4,3
31,440,440,18,1,17,2,1
26,488,488,12,12,0,1,0
9,491,491,61,12,49,2,1
16,493,493,33,21,12,2,1

10,108,108,1,1,0,1,0
2,114,114,6,6,0,1,0
24,119,119,6,6,0,1,0
3,120,120,8,8,0,1,0
19,124,124,6,1,5,2,1
35,131,131,50,2,48,3,2
18,146,146,6,6,0,1,0
15,152,152,1,1,0,1,0
49,152,152,22,22,0,1,0
17,159,159,8,8,0,1,0
51,165,165,34,21,13,2,1
13,186,186,5,2,3,2,1
33,196,196,14,14,0,1,0
4,204,204,7,3,4,2,1
45,206,206,14,1,13,3,2
38,213,213,1,1,0,1,0
39,220,220,26,26,0,1,0
21,220,220,1,1,0,1,0
1,222,222,5,2,3,2,1
43,229,229,20,20,0,1,0
11,237,237,1,1,0,1,0
30,238,238,17,17,0,1,0
40,241,241,10,1,9,2,1
44,243,243,11,8,3,2,1
5,246,246,2,2,0,1,0
50,250,250,7,7,0,1,0
22,272,272,19,19,0,1,0
8,279,279,50,50,0,1,0
20,283,283,31,31,0,1,0
42,299,299,51,51,0,1,0
28,300,300,10,10,0,1,0
16,309,309,32,16,16,3,2
6,320,320,22,22,0,1,0
31,333,333,32,32,0,1,0
7,334,334,1,1,0,1,0
26,337,337,16,6,10,2,1
25,338,338,72,24,48,3,2
27,338,338,27,27,0,1,0
41,345,345,52,7,45,4,3
0,353,353,5,2,3,2,1
14,372,372,26,5,21,2,1
34,374,374,25,5,20,2,1
48,387,387,24,6,18,3,2
12,392,392,34,34,0,1,0
29,393,393,26,14,12,4,3
23,409,409,26,2,24,4,3
32,413,413,15,8,7,2,1
47,420,420,50,18,32,3,2
37,439,439,56,56,0,1,0
36,449,449,1,1,0,1,0
9,491,491,98,10,88,3,2
46,498,498,55,35,20,2,1

0,121,121,38,38,0,1,0
13,143,143,8,3,5,2,1
21,178,178,2,2,0,1,0
25,196,196,6,6,0,1,0
19,201,201,18,18,0,1,0
26,211,211,5,5,0,1,0
28,225,225,6,3,3,2,1
5,230,230,29,11,18,3,2
39,233,233,1,1,0,1,0
11,247,247,6,6,0,1,0
16,250,250,1,1,0,1,0
8,253,253,30,30,0,1,0
6,269,269,1,1,0,1,0
1,296,296,1,1,0,1,0
3,327,327,21,13,8,2,1
35,328,328,13,4,9,4,3
12,338,338,80,32,48,4,3
30,341,341,7,2,5,2,1
18,343,343,17,17,0,1,0
38,352,352,19,2,17,2,1
15,357,357,16,16,0,1,0
24,377,377,52,52,0,1,0
29,383,383,100,22,78,4,3
23,384,384,59,59,0,1,0
27,391,391,128,82,46,3,2
34,396,396,94,34,60,4,3
31,398,398,25,25,0,1,0
20,403,403,62,27,35,2,1
37,407,407,11,11,0,1,0
14,414,414,47,29,18,4,3
10,414,414,37,6,31,4,3
32,437,437,66,23,43,2,1
22,441,441,51,35,16,2,1
7,447,447,94,41,53,4,3
9,456,456,77,77,0,1,0
2,460,460,30,1,29,2,1
33,465,465,12,12,0,1,0
4,466,466,27,27,0,1,0
36,469,469,78,78,0,1,0
17,494,494,81,81,0,1,0

13,110,110,42,42,0,1,0
32,110,110,38,10,28,2,1
10,112,112,4,4,0,1,0
17,132,132,17,17,0,1,0
12,164,164,20,20,0,1,0
28,169,169,4,4,0,1,0
18,182,182,18,18,0,1,0
6,185,185,63,63,0,1,0
2,185,185,60,60,0,1,0
1,198,198,11,5,6,3,2
4,199,199,4,1,3,2,1
21,200,200,3,3,0,1,0
7,212,212,33,33,0,1,0
31,224,224,2,2,0,1,0
0,232,232,1,1,0,1,0
27,238,238,16,10,6,2,1
16,240,240,2,2,0,1,0
3,250,250,32,14,18,4,3
20,260,260,21,2,19,2,1
14,279,279,19,4,15,4,3
30,301,301,29,29,0,1,0
23,305,305,83,9,74,4,3
15,315,315,6,2,4,2,1
22,331,331,47,11,36,2,1
24,342,342,56,56,0,1,0
5,361,361,32,32,0,1,0
9,384,384,40,4,36,3,2
25,400,400,42,42,0,1,0
29,402,402,27,27,0,1,0
19,408,408,14,1,13,4,3
8,414,414,46,46,0,1,0
33,425,425,14,3,11,2,1
26,429,429,114,73,41,2,1
11,447,447,60,28,32,3,2

29,104,104,17,17,0,1,0
6,113,113,2,2,0,1,0
12,123,123,3,3,0,1,0
10,136,136,16,16,0,1,0
11,153,153,36,3,33,4,3
3,153,153,7,7,0,1,0
1,157,157,4,4,0,1,0
5,158,158,16,16,0,1,0
27,170,170,2,2,0,1,0
26,178,178,24,13,11,3,2
0,189,189,16,16,0,1,0
18,189,189,36,36,0,1,0
7,202,202,4,4,0,1,0
30,224,224,32,23,9,4,3
8,228,228,72,63,9,4,3
15,238,238,1,1,0,1,0
16,256,256,21,14,7,2,1
21,261,261,53,20,33,4,3
25,264,264,4,4,0,1,0
31,296,296,2,2,0,1,0
9,320,320,41,41,0,1,0
4,352,352,262,222,40,3,2
17,357,357,35,35,0,1,0
19,359,359,33,33,0,1,0
20,373,373,91,27,64,4,3
28,389,389,68,68,0,1,0
13,391,391,19,19,0,1,0
22,404,404,43,30,13,2,1
23,445,445,92,26,66,4,3
2,445,445,74,74,0,1,0
24,483,483,13,2,11,2,1
14,488,488,30,30,0,1,0

15,102,102,13,13,0,1,0
20,111,111,16,16,0,1,0
41,119,119,20,20,0,1,0
8,123,123,4,4,0,1,0
28,132,132,36,36,0,1,0
23,145,145,2,2,0,1,0
9,156,156,14,14,0,1,0
6,171,171,27,27,0,1,0
0,174,174,24,24,0,1,0
2,188,188,1,1,0,1,0
13,191,191,6,3,3,2,1
17,192,192,8,8,0,1,0
14,224,224,6,1,5,2,1
29,241,241,21,12,9,4,3
22,242,242,41,17,24,3,2
1,245,245,72,57,15,2,1
38,249,249,22,22,0,1,0
37,258,258,3,3,0,1,0
21,260,260,11,8,3,2,1
27,288,288,23,23,0,1,0
35,308,308,24,24,0,1,0
25,313,313,104,95,9,4,3
36,336,336,48,48,0,1,0
26,354,354,4,4,0,1,0
3,359,359,2,2,0,1,0
32,380,380,8,8,0,1,0
10,381,381,7,7,0,1,0
33,389,389,48,18,30,3,2
34,391,391,17,14,3,2,1
4,402,402,112,112,0,1,0
18,404,404,127,81,46,3,2
39,408,408,47,47,0,1,0
11,420,420,57,57,0,1,0
5,423,423,3,3,0,1,0
7,438,438,5,5,0,1,0
19,441,441,15,7,8,2,1
24,442,442,26,26,0,1,0
12,443,443,27,1,26,3,2
31,466,466,38,14,24,3,2
16,476,476,2,2,0,1,0
30,487,487,63,47,16,2,1
40,490,490,1,1,0,1,0

0,131,131,28,28,0,1,0
30,141,141,7,7,0,1,0
24,149,149,28,20,8,3,2
7,166,166,5,2,3,2,1
6,192,192,57,57,0,1,0
28,208,208,12,12,0,1,0
8,214,214,41,41,0,1,0
32,230,230,5,5,0,1,0
12,231,231,21,21,0,1,0
23,251,251,22,8,14,3,2
4,265,265,13,13,0,1,0
16,274,274,1,1,0,1,0
3,283,283,40,40,0,1,0
13,285,285,12,8,4,2,1
20,292,292,97,7,90,3,2
29,294,294,8,8,0,1,0
18,306,306,76,76,0,1,0
21,321,321,29,5,24,2,1
10,335,335,41,41,0,1,0
26,337,337,59,1,58,4,3
22,367,367,31,5,26,2,1
19,387,387,48,48,0,1,0
5,392,392,5,2,3,2,1
25,392,392,8,8,0,1,0
34,403,403,52,52,0,1,0
15,403,403,1,1,0,1,0
27,406,406,2,2,0,1,0
33,411,411,28,4,24,2,1
9,413,413,83,62,21,4,3
14,456,456,65,9,56,3,2
31,459,459,49,13,36,3,2
17,468,468,100,100,0,1,0
2,490,490,200,101,99,4,3
11,496,496,20,14,6,3,2
1,496,496,9,9,0,1,0

21,110,110,10,10,0,1,0
31,112,112,13,1,12,3,2
6,146,146,38,38,0,1,0
7,159,159,8,8,0,1,0
29,168,168,2,2,0,1,0
1,172,172,15,15,0,1,0
5,187,187,9,9,0,1,0
10,192,192,49,34,15,2,1
4,202,202,13,13,0,1,0
23,211,211,1,1,0,1,0
30,221,221,1,1,0,1,0
16,228,228,4,4,0,1,0
18,231,231,12,12,0,1,0
19,247,247,13,13,0,1,0
24,275,275,41,9,32,4,3
22,278,278,42,3,39,4,3
11,281,281,53,53,0,1,0
20,283,283,76,76,0,1,0
2,298,298,29,29,0,1,0
12,335,335,1,1,0,1,0
17,351,351,9,9,0,1,0
34,357,357,104,50,54,3,2
3,376,376,9,1,8,3,2
25,385,385,10,10,0,1,0
28,387,387,9,9,0,1,0
26,388,388,63,52,11,4,3
0,430,430,157,112,45,4,3
14,435,435,49,23,26,2,1
15,441,441,49,49,0,1,0
13,463,463,16,4,12,4,3
27,476,476,118,118,0,1,0
32,476,476,101,67,34,4,3
9,479,479,193,193,0,1,0
33,485,485,5,5,0,1,0
8,488,488,4,4,0,1,0

32,109,109,18,18,0,1,0
31,111,111,1,1,0,1,0
24,119,119,8,3,5,2,1
29,140,140,65,65,0,1,0
33,157,157,2,2,0,1,0
48,165,165,3,3,0,1,0
2,166,166,27,22,5,2,1
0,166,166,11,11,0,1,0
15,167,167,2,2,0,1,0
45,176,176,19,19,0,1,0
43,177,177,15,15,0,1,0
4,179,179,5,1,4,2,1
8,181,181,9,9,0,1,0
20,182,182,22,22,0,1,0
36,196,196,30,30,0,1,0
13,208,208,8,8,0,1,0
35,214,214,4,4,0,1,0
46,215,215,3,3,0,1,0
1,224,224,13,13,0,1,0
26,224,224,24,4,20,2,1
41,225,225,4,4,0,1,0
5,239,239,25,6,19,2,1
11,243,243,27,27,0,1,0
23,251,251,12,4,8,3,2
17,253,253,26,26,0,1,0
44,255,255,11,7,4,2,1
10,279,279,6,6,0,1,0
18,291,291,39,39,0,1,0
37,317,317,80,80,0,1,0
34,324,324,31,26,5,2,1
19,339,339,2,2,0,1,0
38,341,341,26,26,0,1,0
12,342,342,8,3,5,2,1
22,352,352,9,9,0,1,0
39,353,353,10,5,5,2,1
47,395,395,40,18,22,4,3
3,402,402,3,3,0,1,0
28,410,410,50,50,0,1,0
7,422,422,38,38,0,1,0
40,431,431,72,38,34,2,1
16,431,431,29,5,24,2,1
14,443,443,19,19,0,1,0
21,443,443,30,30,0,1,0
9,448,448,5,5,0,1,0
6,456,456,90,48,42,4,3
25,468,468,9,9,0,1,0
30,480,480,98,30,68,3,2
27,482,482,43,21,22,3,2
42,499,499,8,8,0,1,0

25,103,103,12,12,0,1,0
21,116,116,5,5,0,1,0
15,125,125,11,5,6,2,1
16,134,134,7,7,0,1,0
33,155,155,20,20,0,1,0
34,178,178,21,13,8,3,2
23,180,180,11,11,0,1,0
4,190,190,16,8,8,2,1
31,194,194,36,36,0,1,0
30,197,197,9,3,6,3,2
12,201,201,3,3,0,1,0
27,225,225,28,16,12,2,1
5,230,230,2,2,0,1,0
36,235,235,63,36,27,2,1
35,242,242,7,7,0,1,0
37,249,249,68,68,0,1,0
18,260,260,13,13,0,1,0
17,271,271,75,7,68,3,2
26,298,298,17,17,0,1,0
6,302,302,16,16,0,1,0
20,307,307,33,9,24,2,1
10,314,314,72,63,9,4,3
0,325,325,18,13,5,2,1
29,329,329,45,28,17,2,1
19,341,341,3,3,0,1,0
7,356,356,3,3,0,1,0
24,364,364,2,2,0,1,0
14,387,387,13,13,0,1,0
28,390,390,85,44,41,2,1
1,401,401,139,23,116,4,3
13,426,426,37,19,18,2,1
9,433,433,34,14,20,3,2
8,458,458,2,2,0,1,0
32,461,461,18,6,12,2,1
3,465,465,224,224,0,1,0
22,467,467,18,18,0,1,0
2,490,490,19,19,0,1,0
11,491,491,29,29,0,1,0

22,102,102,4,4,0,1,0
20,102,102,20,20,0,1,0
23,105,105,7,7,0,1,0
12,115,115,1,1,0,1,0
28,121,121,4,4,0,1,0
4,146,146,13,13,0,1,0
43,146,146,62,40,22,4,3
3,156,156,49,49,0,1,0
32,160,160,1,1,0,1,0
49,161,161,5,5,0,1,0
17,172,172,17,17,0,1,0
30,180,180,1,1,0,1,0
24,184,184,1,1,0,1,0
33,196,196,25,25,0,1,0
15,220,220,6,6,0,1,0
7,237,237,39,39,0,1,0
8,251,251,4,1,3,2,1
31,265,265,5,5,0,1,0
29,266,266,26,26,0,1,0
38,291,291,61,61,0,1,0
14,293,293,5,5,0,1,0
0,293,293,14,14,0,1,0
16,296,296,8,2,6,3,2
44,304,304,23,23,0,1,0
18,305,305,24,4,20,4,3
9,307,307,11,11,0,1,0
6,317,317,7,7,0,1,0
19,323,323,10,1,9,2,1
37,331,331,69,53,16,2,1
47,338,338,21,14,7,2,1
34,340,340,29,29,0,1,0
25,349,349,1,1,0,1,0
42,352,352,19,19,0,1,0
10,363,363,39,29,10,3,2
11,367,367,27,9,18,2,1
45,368,368,69,7,62,3,2
46,372,372,34,34,0,1,0
13,373,373,36,36,0,1,0
41,379,379,8,1,7,2,1
40,397,397,21,21,0,1,0
26,405,405,18,18,0,1,0
2,408,408,6,6,0,1,0
21,447,447,5,5,0,1,0
39,453,453,66,26,40,3,2
35,459,459,43,43,0,1,0
5,470,470,26,26,0,1,0
1,475,475,33,33,0,1,0
36,480,480,14,14,0,1,0
27,486,486,54,22,32,2,1
48,489,489,55,55,0,1,0

29,106,106,2,2,0,1,0
24,109,109,1,1,0,1,0
14,112,112,1,1,0,1,0
13,113,113,1,1,0,1,0
2,120,120,1,1,0,1,0
21,138,138,13,13,0,1,0
23,140,140,7,7,0,1,0
41,144,144,2,2,0,1,0
44,144,144,25,25,0,1,0
34,150,150,5,5,0,1,0
19,172,172,1,1,0,1,0
39,173,173,5,1,4,2,1
9,199,199,1,1,0,1,0
30,204,204,8,2,6,3,2
32,253,253,16,16,0,1,0
27,253,253,48,48,0,1,0
45,258,258,16,2,14,3,2
37,279,279,126,126,0,1,0
7,282,282,61,49,12,4,3
18,289,289,6,6,0,1,0
11,295,295,33,1,32,3,2
0,312,312,32,32,0,1,0
22,315,315,40,13,27,2,1
15,321,321,21,10,11,2,1
1,328,328,4,4,0,1,0
4,332,332,55,55,0,1,0
28,349,349,6,6,0,1,0
38,355,355,20,20,0,1,0
31,373,373,20,20,0,1,0
10,384,384,60,37,23,2,1
3,395,395,11,3,8,3,2
8,412,412,1,1,0,1,0
20,423,423,92,92,0,1,0
12,423,423,18,5,13,2,1
46,429,429,68,68,0,1,0
25,438,438,13,4,9,4,3
42,441,441,48,35,13,2,1
16,441,441,49,49,0,1,0
17,443,443,64,27,37,4,3
40,444,444,24,24,0,1,0
43,452,452,62,62,0,1,0
33,453,453,4,4,0,1,0
36,454,454,168,168,0,1,0
6,457,457,20,20,0,1,0
26,475,475,62,62,0,1,0
35,488,488,1,1,0,1,0
5,492,492,41,7,34,2,1

0,103,103,22,22,0,1,0
7,105,105,5,1,4,2,1
27,113,113,9,9,0,1,0
36,115,115,28,19,9,4,3
18,140,140,7,2,5,2,1
3,144,144,2,2,0,1,0
30,146,146,15,6,9,2,1
32,146,146,67,26,41,2,1
31,151,151,23,23,0,1,0
35,159,159,8,8,0,1,0
12,164,164,45,8,37,2,1
15,169,169,1,1,0,1,0
29,178,178,2,2,0,1,0
37,181,181,34,4,30,2,1
26,183,183,13,13,0,1,0
5,183,183,4,1,3,2,1
16,201,201,6,6,0,1,0
4,207,207,23,23,0,1,0
6,211,211,107,22,85,4,3
33,212,212,7,7,0,1,0
11,256,256,24,6,18,2,1
34,262,262,6,2,4,2,1
10,271,271,97,55,42,4,3
1,282,282,9,9,0,1,0
19,293,293,6,6,0,1,0
38,351,351,23,8,15,4,3
14,362,362,3,3,0,1,0
25,365,365,7,7,0,1,0
9,369,369,7,7,0,1,0
23,390,390,40,22,18,3,2
20,400,400,51,51,0,1,0
22,410,410,24,24,0,1,0
2,420,420,29,2,27,4,3
24,429,429,40,6,34,4,3
17,460,460,1,1,0,1,0
8,465,465,38,38,0,1,0
21,471,471,36,5,31,4,3
28,478,478,37,7,30,2,1
13,488,488,30,30,0,1,0

38,101,101,2,2,0,1,0
14,112,112,1,1,0,1,0
4,119,119,5,5,0,1,0
0,121,121,18,8,10,3,2
39,125,125,8,1,7,2,1
27,135,135,27,14,13,2,1
7,144,144,8,8,0,1,0
40,151,151,13,2,11,2,1
24,152,152,14,14,0,1,0
36,160,160,3,3,0,1,0
29,170,170,66,45,21,4,3
34,173,173,14,8,6,2,1
10,237,237,69,65,4,2,1
13,244,244,7,1,6,2,1
2,251,251,21,21,0,1,0
28,253,253,6,6,0,1,0
6,264,264,2,2,0,1,0
25,265,265,64,64,0,1,0
1,287,287,25,1,24,4,3
18,300,300,6,6,0,1,0
30,302,302,17,4,13,4,3
16,303,303,17,17,0,1,0
17,348,348,55,55,0,1,0
12,351,351,5,5,0,1,0
21,354,354,10,10,0,1,0
19,377,377,14,3,11,4,3
5,385,385,100,40,60,4,3
41,405,405,5,5,0,1,0
33,412,412,182,120,62,3,2
20,420,420,14,14,0,1,0
32,422,422,38,6,32,2,1
3,425,425,7,7,0,1,0
9,429,429,163,147,16,3,2
11,438,438,6,6,0,1,0
31,439,439,4,4,0,1,0
8,445,445,11,11,0,1,0
15,456,456,94,64,30,2,1
23,465,465,31,25,6,3,2
26,472,472,39,39,0,1,0
35,489,489,16,16,0,1,0
22,492,492,9,9,0,1,0
37,494,494,10,3,7,2,1

18,106,106,6,1,5,2,1
32,110,110,6,2,4,2,1
2,128,128,39,6,33,4,3
36,130,130,26,26,0,1,0
19,133,133,2,2,0,1,0
33,135,135,6,6,0,1,0
27,141,141,37,37,0,1,0
25,142,142,13,13,0,1,0
14,143,143,6,6,0,1,0
3,147,147,4,1,3,2,1
17,158,158,3,3,0,1,0
6,163,163,36,30,6,3,2
41,164,164,7,7,0,1,0
34,168,168,14,14,0,1,0
11,186,186,1,1,0,1,0
10,189,189,11,1,10,3,2
21,192,192,2,2,0,1,0
24,211,211,67,67,0,1,0
44,238,238,34,34,0,1,0
42,239,239,6,1,5,2,1
38,257,257,6,6,0,1,0
12,274,274,3,3,0,1,0
40,285,285,24,24,0,1,0
8,299,299,5,5,0,1,0
7,307,307,11,7,4,2,1
30,310,310,29,11,18,4,3
29,316,316,3,3,0,1,0
35,318,318,12,12,0,1,0
28,334,334,1,1,0,1,0
5,344,344,29,11,18,4,3
4,347,347,25,9,16,2,1
9,349,349,49,19,30,4,3
13,356,356,3,3,0,1,0
20,357,357,35,21,14,2,1
23,369,369,8,8,0,1,0
39,376,376,113,113,0,1,0
15,377,377,21,21,0,1,0
43,402,402,37,37,0,1,0
26,422,422,90,9,81,4,3
45,424,424,92,47,45,2,1
31,434,434,11,11,0,1,0
0,443,443,43,43,0,1,0
16,445,445,39,11,28,3,2
1,449,449,3,3,0,1,0
37,463,463,40,32,8,3,2
22,466,466,48,48,0,1,0

28,113,113,10,10,0,1,0
32,114,114,2,2,0,1,0
37,116,116,38,38,0,1,0
8,117,117,5,1,4,2,1
19,123,123,6,6,0,1,0
26,123,123,11,4,7,2,1
0,124,124,26,26,0,1,0
18,131,131,17,8,9,2,1
24,152,152,2,2,0,1,0
33,156,156,1,1,0,1,0
14,167,167,41,41,0,1,0
20,173,173,20,20,0,1,0
29,189,189,18,9,9,4,3
9,194,194,9,9,0,1,0
15,199,199,4,4,0,1,0
4,201,201,25,19,6,2,1
5,205,205,3,3,0,1,0
17,237,237,25,25,0,1,0
23,255,255,25,25,0,1,0
38,263,263,38,38,0,1,0
36,281,281,38,4,34,3,2
25,290,290,32,32,0,1,0
12,301,301,41,14,27,2,1
6,327,327,6,3,3,2,1
27,328,328,5,5,0,1,0
31,331,331,25,13,12,2,1
30,335,335,33,1,32,3,2
2,338,338,7,7,0,1,0
21,354,354,84,66,18,4,3
22,397,397,45,37,8,2,1
39,402,402,34,34,0,1,0
10,403,403,12,12,0,1,0
7,408,408,57,27,30,2,1
1,417,417,34,22,12,2,1
16,428,428,16,5,11,2,1
13,456,456,22,22,0,1,0
11,458,458,83,50,33,2,1
35,458,458,21,6,15,2,1
34,475,475,63,3,60,4,3
3,483,483,156,134,22,2,1

19,100,100,2,2,0,1,0
13,106,106,12,3,9,2,1
39,107,107,4,1,3,2,1
17,108,108,4,4,0,1,0
14,128,128,5,5,0,1,0
11,148,148,9,9,0,1,0
21,175,175,36,19,17,4,3
27,179,179,4,4,0,1,0
41,182,182,10,10,0,1,0
5,185,185,19,10,9,4,3
18,192,192,11,11,0,1,0
28,196,196,68,44,24,3,2
4,208,208,59,5,54,4,3
26,261,261,2,2,0,1,0
25,262,262,15,11,4,2,1
3,280,280,13,13,0,1,0
15,299,299,56,31,25,3,2
6,305,305,45,5,40,3,2
38,313,313,4,4,0,1,0
29,327,327,18,18,0,1,0
36,334,334,65,5,60,3,2
24,342,342,18,18,0,1,0
8,347,347,15,1,14,3,2
23,370,370,22,8,14,2,1
37,376,376,33,33,0,1,0
34,383,383,18,3,15,3,2
30,384,384,184,174,10,3,2
2,385,385,81,70,11,2,1
9,388,388,23,23,0,1,0
16,394,394,12,12,0,1,0
40,398,398,1,1,0,1,0
7,421,421,53,14,39,2,1
31,430,430,53,29,24,4,3
0,440,440,28,28,0,1,0
22,453,453,29,17,12,4,3
10,466,466,2,2,0,1,0
1,473,473,3,3,0,1,0
33,476,476,48,48,0,1,0
32,478,478,63,24,39,4,3
12,489,489,51,51,0,1,0
35,499,499,49,49,0,1,0
20,499,499,26,11,15,4,3

44,106,106,23,23,0,1,0
21,113,113,2,2,0,1,0
11,115,115,5,5,0,1,0
24,122,122,4,4,0,1,0
10,124,124,4,4,0,1,0
15,132,132,9,1,8,3,2
5,149,149,14,5,9,4,3
14,150,150,5,5,0,1,0
33,164,164,16,1,15,2,1
45,190,190,7,7,0,1,0
18,199,199,16,1,15,4,3
26,200,200,111,111,0,1,0
23,202,202,25,11,14,3,2
32,209,209,12,12,0,1,0
41,212,212,9,9,0,1,0
27,256,256,59,59,0,1,0
22,263,263,16,2,14,3,2
42,266,266,26,4,22,3,2
3,278,278,9,9,0,1,0
13,303,303,27,27,0,1,0
43,305,305,51,34,17,2,1
36,319,319,5,5,0,1,0
17,319,319,5,5,0,1,0
37,319,319,6,6,0,1,0
9,325,325,87,7,80,4,3
0,326,326,67,13,54,3,2
31,340,340,41,35,6,3,2
30,340,340,40,5,35,2,1
8,346,346,46,46,0,1,0
38,362,362,7,7,0,1,0
12,368,368,57,45,12,2,1
7,376,376,5,5,0,1,0
1,386,386,18,11,7,2,1
16,389,389,36,36,0,1,0
39,401,401,10,10,0,1,0
40,412,412,4,4,0,1,0
6,413,413,9,9,0,1,0
25,415,415,46,8,38,3,2
20,420,420,26,18,8,3,2
2,423,423,8,8,0,1,0
4,423,423,54,54,0,1,0
19,426,426,10,10,0,1,0
35,427,427,3,3,0,1,0
34,475,475,22,5,17,2,1
28,486,486,64,13,51,4,3
29,494,494,8,8,0,1,0

22,107,107,3,3,0,1,0
32,128,128,6,6,0,1,0
18,140,140,7,7,0,1,0
3,169,169,19,19,0,1,0
11,202,202,18,18,0,1,0
0,211,211,1,1,0,1,0
8,235,235,42,20,22,2,1
28,237,237,19,19,0,1,0
2,239,239,28,28,0,1,0
5,243,243,44,44,0,1,0
13,250,250,4,4,0,1,0
16,277,277,48,48,0,1,0
14,279,279,36,36,0,1,0
24,285,285,8,4,4,2,1
40,288,288,3,3,0,1,0
33,305,305,23,23,0,1,0
23,314,314,12,12,0,1,0
10,321,321,2,2,0,1,0
21,346,346,17,3,14,3,2
9,350,350,64,16,48,2,1
30,364,364,38,5,33,2,1
39,366,366,41,41,0,1,0
7,368,368,58,50,8,2,1
27,368,368,60,40,20,2,1
15,379,379,62,34,28,3,2
35,382,382,68,38,30,2,1
12,389,389,60,14,46,2,1
25,394,394,60,60,0,1,0
34,396,396,127,127,0,1,0
31,400,400,65,31,34,2,1
19,417,417,3,3,0,1,0
1,426,426,24,15,9,2,1
17,433,433,1,1,0,1,0
20,437,437,32,32,0,1,0
37,452,452,68,68,0,1,0
36,453,453,75,75,0,1,0
4,463,463,56,8,48,4,3
6,473,473,12,7,5,2,1
29,475,475,5,5,0,1,0
26,477,477,46,46,0,1,0
38,496,496,27,18,9,4,3

27,102,102,10,4,6,2,1
19,108,108,5,5,0,1,0
4,138,138,32,17,15,3,2
16,139,139,22,22,0,1,0
31,155,155,8,8,0,1,0
25,168,168,37,37,0,1,0
35,169,169,1,1,0,1,0
30,174,174,21,21,0,1,0
33,188,188,44,44,0,1,0
3,196,196,69,33,36,2,1
26,218,218,70,70,0,1,0
8,231,231,25,9,16,3,2
36,237,237,19,7,12,4,3
18,237,237,12,4,8,3,2
29,241,241,1,1,0,1,0
7,252,252,61,58,3,2,1
5,270,270,1,1,0,1,0
15,281,281,1,1,0,1,0
17,282,282,34,34,0,1,0
24,294,294,15,6,9,4,3
11,302,302,13,5,8,3,2
23,308,308,6,6,0,1,0
6,336,336,18,6,12,2,1
12,346,346,33,9,24,4,3
34,347,347,5,2,3,2,1
0,353,353,31,17,14,2,1
22,358,358,38,38,0,1,0
20,366,366,18,18,0,1,0
32,371,371,50,50,0,1,0
14,378,378,47,47,0,1,0
10,385,385,107,38,69,4,3
21,409,409,32,21,11,2,1
2,427,427,74,74,0,1,0
9,481,481,12,9,3,2,1
13,485,485,12,12,0,1,0
28,493,493,120,94,26,2,1
1,496,496,1,1,0,1,0

37,110,110,4,4,0,1,0
28,117,117,4,4,0,1,0
2,122,122,14,1,13,2,1
22,133,133,2,2,0,1,0
16,146,146,27,1,26,3,2
27,147,147,10,10,0,1,0
21,153,153,5,5,0,1,0
6,162,162,12,12,0,1,0
20,165,165,9,9,0,1,0
34,168,168,1,1,0,1,0
23,187,187,15,15,0,1,0
9,206,206,8,2,6,2,1
25,217,217,49,49,0,1,0
0,225,225,1,1,0,1,0
8,239,239,4,4,0,1,0
24,243,243,5,1,4,2,1
35,244,244,10,6,4,2,1
31,247,247,11,5,6,3,2
18,248,248,1,1,0,1,0
7,253,253,6,2,4,2,1
33,265,265,31,22,9,4,3
30,275,275,29,16,13,4,3
5,294,294,7,7,0,1,0
17,307,307,16,16,0,1,0
43,343,343,32,32,0,1,0
32,355,355,8,8,0,1,0
12,364,364,12,6,6,2,1
14,369,369,9,1,8,3,2
1,378,378,10,5,5,2,1
44,380,380,75,75,0,1,0
36,380,380,71,71,0,1,0
10,380,380,22,7,15,3,2
39,400,400,34,34,0,1,0
26,404,404,23,23,0,1,0
15,407,407,62,62,0,1,0
45,408,408,39,18,21,4,3
19,414,414,96,58,38,2,1
38,438,438,65,65,0,1,0
42,444,444,58,58,0,1,0
29,449,449,151,118,33,4,3
4,468,468,22,22,0,1,0
13,470,470,6,6,0,1,0
11,476,476,106,106,0,1,0
40,482,482,1,1,0,1,0
3,489,489,112,81,31,2,1
41,490,490,112,44,68,3,2

39,123,123,11,11,0,1,0
19,127,127,3,3,0,1,0
28,130,130,9,9,0,1,0
34,135,135,11,11,0,1,0
17,136,136,3,3,0,1,0
36,137,137,2,2,0,1,0
31,161,161,25,3,22,3,2
21,171,171,12,12,0,1,0
3,172,172,1,1,0,1,0
0,178,178,11,1,10,3,2
43,187,187,28,28,0,1,0
8,191,191,21,21,0,1,0
18,195,195,6,6,0,1,0
10,201,201,36,15,21,2,1
14,202,202,9,3,6,2,1
35,206,206,19,19,0,1,0
33,260,260,77,77,0,1,0
23,273,273,17,5,12,4,3
4,285,285,4,4,0,1,0
11,294,294,39,39,0,1,0
9,312,312,30,30,0,1,0
42,313,313,41,41,0,1,0
22,324,324,60,60,0,1,0
16,342,342,32,32,0,1,0
27,350,350,12,12,0,1,0
15,358,358,3,3,0,1,0
1,359,359,119,31,88,3,2
30,364,364,73,28,45,4,3
32,374,374,27,21,6,2,1
37,376,376,4,1,3,2,1
24,376,376,28,14,14,3,2
5,382,382,42,26,16,2,1
25,387,387,55,30,25,3,2
12,405,405,22,22,0,1,0
29,420,420,42,21,21,2,1
41,423,423,51,2,49,4,3
40,433,433,1,1,0,1,0
6,449,449,31,22,9,4,3
13,451,451,1,1,0,1,0
26,451,451,72,48,24,4,3
2,452,452,73,43,30,4,3
20,457,457,12,6,6,2,1
7,471,471,51,51,0,1,0
38,492,492,23,1,22,3,2

28,111,111,44,44,0,1,0
39,146,146,10,1,9,2,1
22,149,149,15,5,10,2,1
27,152,152,13,13,0,1,0
17,181,181,7,1,6,2,1
11,193,193,3,3,0,1,0
2,212,212,18,12,6,3,2
3,222,222,16,16,0,1,0
42,225,225,9,9,0,1,0
0,226,226,60,60,0,1,0
5,242,242,32,32,0,1,0
12,242,242,33,33,0,1,0
31,249,249,21,21,0,1,0
25,250,250,16,16,0,1,0
40,252,252,17,3,14,3,2
15,260,260,45,12,33,4,3
32,261,261,96,96,0,1,0
18,261,261,14,14,0,1,0
21,266,266,15,15,0,1,0
38,280,280,1,1,0,1,0
6,281,281,35,35,0,1,0
7,290,290,12,12,0,1,0
24,297,297,9,4,5,2,1
35,309,309,17,1,16,4,3
37,320,320,7,7,0,1,0
41,322,322,15,15,0,1,0
8,322,322,4,4,0,1,0
34,341,341,18,9,9,3,2
1,342,342,48,48,0,1,0
36,344,344,133,93,40,2,1
19,353,353,5,1,4,2,1
23,358,358,9,4,5,2,1
43,359,359,11,11,0,1,0
9,364,364,15,10,5,2,1
20,378,378,55,55,0,1,0
10,379,379,3,3,0,1,0
13,410,410,25,25,0,1,0
30,420,420,20,10,10,2,1
16,425,425,74,74,0,1,0
4,441,441,6,6,0,1,0
29,465,465,48,2,46,3,2
14,470,470,34,34,0,1,0
33,480,480,34,34,0,1,0
26,492,492,5,2,3,2,1

25,112,112,49,49,0,1,0
15,115,115,7,2,5,2,1
16,125,125,9,9,0,1,0
20,127,127,9,9,0,1,0
8,139,139,9,9,0,1,0
7,166,166,3,3,0,1,0
33,176,176,9,3,6,3,2
17,177,177,21,21,0,1,0
22,183,183,39,27,12,2,1
1,189,189,29,8,21,4,3
35,211,211,19,4,15,2,1
36,213,213,1,1,0,1,0
2,230,230,1,1,0,1,0
31,251,251,14,1,13,2,1
28,256,256,25,19,6,2,1
21,268,268,5,5,0,1,0
18,272,272,19,19,0,1,0
32,274,274,46,46,0,1,0
12,275,275,6,3,3,2,1
29,287,287,19,1,18,2,1
24,322,322,71,24,47,2,1
10,333,333,110,52,58,3,2
23,343,343,40,22,18,2,1
34,354,354,14,14,0,1,0
6,368,368,74,8,66,3,2
26,392,392,10,3,7,2,1
11,406,406,134,52,82,4,3
19,412,412,40,40,0,1,0
5,415,415,8,1,7,2,1
30,416,416,27,17,10,3,2
9,419,419,36,4,32,3,2
38,433,433,3,3,0,1,0
13,436,436,21,2,19,2,1
4,441,441,30,30,0,1,0
27,448,448,4,4,0,1,0
37,451,451,26,13,13,2,1
0,460,460,15,15,0,1,0
39,479,479,123,111,12,4,3
3,487,487,22,22,0,1,0
40,493,493,12,2,10,3,2
41,494,494,12,6,6,3,2
14,499,499,36,36,0,1,0

29,112,112,9,9,0,1,0
8,125,125,3,3,0,1,0
38,164,164,27,27,0,1,0
25,164,164,1,1,0,1,0
7,164,164,3,3,0,1,0
18,179,179,4,4,0,1,0
37,188,188,12,8,4,2,1
14,195,195,12,3,9,2,1
19,200,200,2,2,0,1,0
34,201,201,52,52,0,1,0
33,210,210,2,2,0,1,0
0,227,227,118,118,0,1,0
39,231,231,4,4,0,1,0
26,242,242,6,6,0,1,0
6,246,246,5,2,3,2,1
12,247,247,1,1,0,1,0
9,265,265,17,1,16,2,1
27,280,280,16,16,0,1,0
3,307,307,63,63,0,1,0
24,311,311,1,1,0,1,0
36,324,324,45,6,39,4,3
4,331,331,4,1,3,2,1
30,377,377,108,54,54,3,2
32,379,379,48,48,0,1,0
22,388,388,91,79,12,4,3
15,388,388,22,10,12,3,2
10,411,411,29,29,0,1,0
21,412,412,1,1,0,1,0
1,420,420,29,29,0,1,0
17,429,429,3,3,0,1,0
23,449,449,84,35,49,2,1
20,470,470,125,57,68,3,2
28,471,471,86,86,0,1,0
16,471,471,12,12,0,1,0
5,471,471,3,3,0,1,0
2,474,474,171,161,10,2,1
40,480,480,60,60,0,1,0
35,481,481,17,8,9,4,3
13,486,486,57,31,26,3,2
41,487,487,2,2,0,1,0
31,489,489,16,10,6,2,1
11,495,495,29,19,10,2,1

28,123,123,9,2,7,2,1
31,134,134,28,28,0,1,0
19,134,134,16,16,0,1,0
18,145,145,16,5,11,2,1
13,175,175,15,15,0,1,0
34,176,176,6,1,5,2,1
7,181,181,8,8,0,1,0
15,185,185,9,4,5,2,1
36,186,186,10,7,3,2,1
33,187,187,23,2,21,3,2
5,189,189,27,27,0,1,0
41,194,194,14,5,9,4,3
43,195,195,29,3,26,4,3
12,218,218,38,2,36,4,3
23,276,276,7,7,0,1,0
22,278,278,7,2,5,2,1
11,284,284,20,4,16,4,3
44,307,307,17,2,15,2,1
8,327,327,27,27,0,1,0
3,328,328,1,1,0,1,0
25,328,328,30,16,14,3,2
40,341,341,61,36,25,2,1
17,348,348,1,1,0,1,0
39,351,351,52,4,48,2,1
2,361,361,2,2,0,1,0
38,364,364,17,17,0,1,0
27,381,381,36,5,31,2,1
35,383,383,42,42,0,1,0
26,387,387,79,27,52,3,2
21,397,397,60,6,54,4,3
30,398,398,29,29,0,1,0
20,406,406,19,15,4,2,1
16,428,428,85,85,0,1,0
42,428,428,13,13,0,1,0
24,433,433,34,12,22,2,1
37,448,448,30,30,0,1,0
1,453,453,12,3,9,3,2
9,465,465,107,92,15,4,3
29,475,475,40,6,34,4,3
4,476,476,25,15,10,2,1
6,483,483,21,21,0,1,0
10,491,491,2,2,0,1,0
14,493,493,96,96,0,1,0
0,496,496,17,17,0,1,0
32,498,498,71,43,28,2,1

5,106,106,1,1,0,1,0
20,150,150,16,8,8,2,1
29,170,170,12,4,8,3,2
0,171,171,6,6,0,1,0
35,181,181,21,21,0,1,0
6,189,189,43,43,0,1,0
13,207,207,9,9,0,1,0
4,212,212,1,1,0,1,0
19,229,229,1,1,0,1,0
7,231,231,4,1,3,2,1
33,239,239,11,1,10,2,1
27,246,246,53,47,6,2,1
25,246,246,102,78,24,3,2
15,255,255,4,4,0,1,0
1,270,270,4,1,3,2,1
26,282,282,5,5,0,1,0
31,283,283,17,2,15,4,3
38,294,294,47,24,23,2,1
40,300,300,42,42,0,1,0
10,307,307,10,6,4,2,1
37,328,328,10,3,7,2,1
2,332,332,1,1,0,1,0
3,337,337,46,19,27,4,3
30,337,337,3,3,0,1,0
36,373,373,10,10,0,1,0
43,378,378,2,2,0,1,0
23,378,378,145,145,0,1,0
12,385,385,47,47,0,1,0
41,391,391,28,23,5,2,1
9,400,400,46,24,22,2,1
22,404,404,4,4,0,1,0
8,411,411,35,35,0,1,0
24,416,416,4,4,0,1,0
11,417,417,9,2,7,2,1
42,420,420,26,26,0,1,0
16,444,444,17,2,15,4,3
17,447,447,143,128,15,4,3
18,452,452,18,11,7,2,1
14,463,463,45,45,0,1,0
34,480,480,49,16,33,4,3
39,485,485,48,4,44,3,2
28,488,488,23,23,0,1,0
21,498,498,58,58,0,1,0
32,500,500,166,132,34,3,2

29,117,117,7,7,0,1,0
2,127,127,4,1,3,2,1
1,144,144,36,32,4,2,1
23,148,148,4,4,0,1,0
20,156,156,7,4,3,2,1
30,187,187,49,49,0,1,0
27,187,187,3,3,0,1,0
22,200,200,17,9,8,2,1
3,221,221,47,37,10,2,1
7,273,273,30,30,0,1,0
15,288,288,50,50,0,1,0
18,289,289,10,1,9,3,2
33,307,307,5,5,0,1,0
35,311,311,60,60,0,1,0
0,318,318,67,67,0,1,0
6,330,330,45,45,0,1,0
28,342,342,38,38,0,1,0
13,347,347,13,13,0,1,0
24,361,361,36,11,25,2,1
17,377,377,49,49,0,1,0
19,380,380,1,1,0,1,0
4,394,394,28,23,5,2,1
16,409,409,45,2,43,2,1
8,414,414,18,18,0,1,0
25,414,414,64,28,36,3,2
34,420,420,89,23,66,3,2
21,425,425,48,48,0,1,0
26,437,437,107,89,18,2,1
9,446,446,51,1,50,2,1
12,460,460,156,123,33,2,1
14,467,467,37,5,32,2,1
31,469,469,25,25,0,1,0
5,484,484,31,7,24,3,2
10,490,490,13,13,0,1,0
32,499,499,35,8,27,4,3
11,500,500,50,50,0,1,0

0,101,101,3,3,0,1,0
9,102,102,1,1,0,1,0
19,111,111,21,21,0,1,0
21,121,121,1,1,0,1,0
44,124,124,8,8,0,1,0
3,137,137,15,5,10,3,2
40,163,163,16,16,0,1,0
23,180,180,14,4,10,2,1
24,184,184,51,51,0,1,0
13,199,199,12,12,0,1,0
26,204,204,22,22,0,1,0
8,209,209,1,1,0,1,0
46,213,213,1,1,0,1,0
31,220,220,6,6,0,1,0
6,256,256,12,12,0,1,0
28,268,268,28,16,12,3,2
47,274,274,57,3,54,4,3
41,286,286,7,7,0,1,0
32,287,287,15,15,0,1,0
16,288,288,32,32,0,1,0
7,295,295,11,2,9,4,3
1,296,296,14,5,9,2,1
37,298,298,71,51,20,2,1
5,302,302,9,1,8,2,1
27,316,316,2,2,0,1,0
39,322,322,83,83,0,1,0
45,323,323,33,1,32,3,2
18,336,336,14,14,0,1,0
12,338,338,10,4,6,2,1
20,341,341,25,25,0,1,0
49,342,342,56,25,31,2,1
22,343,343,18,5,13,2,1
42,355,355,36,17,19,4,3
14,374,374,2,2,0,1,0
36,396,396,54,18,36,3,2
48,397,397,38,38,0,1,0
35,402,402,25,25,0,1,0
33,406,406,34,34,0,1,0
38,413,413,57,57,0,1,0
34,437,437,66,31,35,2,1
29,448,448,3,3,0,1,0
30,453,453,9,4,5,2,1
17,455,455,24,9,15,4,3
43,464,464,5,5,0,1,0
10,465,465,44,17,27,2,1
4,473,473,38,38,0,1,0
11,487,487,13,13,0,1,0
2,487,487,33,33,0,1,0
15,489,489,68,2,66,3,2
25,494,494,36,26,10,2,1

19,104,104,24,24,0,1,0
25,111,111,7,7,0,1,0
27,117,117,9,4,5,2,1
29,118,118,15,15,0,1,0
11,119,119,4,4,0,1,0
3,120,120,15,15,0,1,0
5,139,139,7,7,0,1,0
17,158,158,16,1,15,2,1
18,161,161,2,2,0,1,0
8,182,182,15,15,0,1,0
30,186,186,29,25,4,2,1
26,208,208,7,7,0,1,0
15,230,230,16,8,8,3,2
21,237,237,11,4,7,2,1
14,264,264,24,3,21,3,2
9,277,277,33,33,0,1,0
13,285,285,55,55,0,1,0
2,296,296,78,78,0,1,0
20,314,314,90,48,42,4,3
0,315,315,8,8,0,1,0
7,320,320,34,34,0,1,0
1,332,332,142,130,12,4,3
22,341,341,68,53,15,4,3
12,342,342,100,100,0,1,0
24,361,361,5,1,4,2,1
16,406,406,124,108,16,4,3
23,412,412,16,16,0,1,0
33,446,446,25,6,19,4,3
28,448,448,21,21,0,1,0
31,449,449,20,10,10,3,2
6,459,459,4,4,0,1,0
4,471,471,61,61,0,1,0
32,474,474,20,8,12,3,2
10,488,488,71,71,0,1,0

5,100,100,7,7,0,1,0
8,109,109,5,2,3,2,1
1,134,134,6,6,0,1,0
13,151,151,2,2,0,1,0
17,153,153,20,20,0,1,0
23,161,161,1,1,0,1,0
2,168,168,1,1,0,1,0
43,169,169,12,12,0,1,0
12,176,176,47,47,0,1,0
26,184,184,21,9,12,2,1
20,203,203,1,1,0,1,0
15,213,213,4,4,0,1,0
30,246,246,36,26,10,2,1
38,246,246,16,1,15,4,3
19,253,253,1,1,0,1,0
10,260,260,38,38,0,1,0
35,260,260,2,2,0,1,0
40,292,292,26,26,0,1,0
27,294,294,11,2,9,2,1
16,307,307,34,3,31,3,2
7,308,308,7,7,0,1,0
11,329,329,30,30,0,1,0
14,333,333,89,63,26,2,1
37,336,336,22,8,14,4,3
18,345,345,19,19,0,1,0
31,348,348,27,27,0,1,0
44,348,348,56,35,21,2,1
33,359,359,4,4,0,1,0
39,363,363,65,23,42,4,3
25,367,367,114,83,31,3,2
24,370,370,107,26,81,4,3
36,379,379,92,26,66,4,3
0,385,385,21,1,20,3,2
22,394,394,30,30,0,1,0
4,405,405,27,27,0,1,0
29,414,414,27,6,21,2,1
3,416,416,2,2,0,1,0
34,432,432,17,17,0,1,0
28,434,434,75,13,62,3,2
32,449,449,23,23,0,1,0
42,453,453,20,20,0,1,0
9,468,468,23,11,12,4,3
21,474,474,32,32,0,1,0
41,489,489,42,4,38,2,1
6,499,499,44,6,38,4,3

17,116,116,25,18,7,2,1
33,118,118,2,2,0,1,0
31,123,123,8,1,7,2,1
26,130,130,3,3,0,1,0
19,140,140,19,19,0,1,0
16,192,192,8,1,7,2,1
9,196,196,7,7,0,1,0
0,271,271,74,8,66,3,2
15,285,285,18,18,0,1,0
10,289,289,20,5,15,4,3
18,295,295,131,131,0,1,0
24,297,297,17,17,0,1,0
28,306,306,68,68,0,1,0
32,314,314,10,10,0,1,0
3,323,323,1,1,0,1,0
2,330,330,193,153,40,3,2
21,334,334,21,21,0,1,0
7,374,374,1,1,0,1,0
23,401,401,10,10,0,1,0
22,411,411,96,96,0,1,0
1,411,411,17,5,12,4,3
14,414,414,3,3,0,1,0
29,420,420,3,3,0,1,0
30,424,424,50,50,0,1,0
13,426,426,31,18,13,2,1
27,432,432,88,69,19,2,1
5,449,449,116,116,0,1,0
8,465,465,112,112,0,1,0
12,472,472,28,23,5,2,1
20,481,481,23,23,0,1,0
4,482,482,74,74,0,1,0
25,483,483,10,1,9,4,3
11,485,485,89,89,0,1,0
6,500,500,12,3,9,2,1

16,109,109,1,1,0,1,0
26,110,110,10,2,8,3,2
34,114,114,5,1,4,2,1
23,141,141,16,3,13,2,1
30,147,147,6,6,0,1,0
4,154,154,1,1,0,1,0
40,162,162,2,2,0,1,0
19,162,162,37,21,16,2,1
9,173,173,50,12,38,2,1
25,177,177,32,32,0,1,0
33,186,186,2,2,0,1,0
35,187,187,23,19,4,2,1
42,189,189,7,7,0,1,0
38,195,195,24,24,0,1,0
10,209,209,1,1,0,1,0
29,214,214,44,44,0,1,0
14,215,215,9,9,0,1,0
36,228,228,2,2,0,1,0
37,229,229,35,26,9,4,3
2,234,234,5,2,3,2,1
43,235,235,24,3,21,2,1
20,239,239,3,3,0,1,0
11,248,248,13,13,0,1,0
7,264,264,15,15,0,1,0
41,284,284,15,15,0,1,0
13,291,291,53,4,49,2,1
32,293,293,149,14,135,4,3
24,332,332,42,5,37,2,1
39,338,338,20,20,0,1,0
8,344,344,1,1,0,1,0
3,344,344,33,5,28,3,2
5,345,345,50,8,42,4,3
1,355,355,33,33,0,1,0
12,363,363,26,14,12,4,3
21,368,368,13,13,0,1,0
18,386,386,50,1,49,2,1
27,410,410,6,6,0,1,0
15,418,418,15,15,0,1,0
6,424,424,88,88,0,1,0
0,437,437,22,11,11,2,1
22,441,441,52,34,18,4,3
28,476,476,41,41,0,1,0
31,492,492,31,4,27,2,1
17,496,496,1,1,0,1,0

20,103,103,14,6,8,2,1
18,107,107,2,2,0,1,0
8,115,115,2,2,0,1,0
7,116,116,29,2,27,4,3
29,117,117,20,20,0,1,0
28,123,123,11,2,9,2,1
3,140,140,15,3,12,4,3
15,203,203,65,65,0,1,0
11,206,206,35,30,5,2,1
1,223,223,52,52,0,1,0
24,235,235,23,14,9,4,3
32,241,241,45,45,0,1,0
17,248,248,23,4,19,2,1
0,285,285,17,17,0,1,0
27,289,289,7,7,0,1,0
9,330,330,2,2,0,1,0
6,335,335,210,146,64,4,3
4,352,352,26,12,14,2,1
26,359,359,26,12,14,3,2
2,380,380,28,9,19,3,2
25,384,384,3,3,0,1,0
22,386,386,18,3,15,2,1
19,388,388,10,10,0,1,0
30,392,392,31,31,0,1,0
31,392,392,37,31,6,2,1
12,422,422,71,17,54,4,3
5,425,425,25,25,0,1,0
21,426,426,60,39,21,4,3
10,446,446,70,32,38,2,1
16,448,448,5,5,0,1,0
13,449,449,75,30,45,2,1
23,455,455,42,42,0,1,0
14,498,498,76,76,0,1,0

20,109,109,8,2,6,2,1
35,111,111,24,19,5,2,1
5,118,118,2,2,0,1,0
26,118,118,14,1,13,3,2
21,130,130,9,3,6,2,1
41,134,134,7,7,0,1,0
37,134,134,46,24,22,4,3
28,145,145,2,2,0,1,0
16,145,145,9,4,5,2,1
44,155,155,18,2,16,2,1
1,167,167,11,3,8,2,1
7,175,175,32,32,0,1,0
51,190,190,23,23,0,1,0
11,200,200,1,1,0,1,0
48,210,210,14,14,0,1,0
30,212,212,1,1,0,1,0
18,242,242,12,4,8,3,2
14,249,249,3,3,0,1,0
50,252,252,58,58,0,1,0
31,260,260,41,41,0,1,0
8,261,261,13,13,0,1,0
17,263,263,10,4,6,3,2
25,266,266,4,4,0,1,0
49,278,278,2,2,0,1,0
45,291,291,19,1,18,3,2
34,294,294,24,9,15,4,3
27,319,319,1,1,0,1,0
42,319,319,27,5,22,3,2
15,322,322,3,3,0,1,0
9,337,337,2,2,0,1,0
47,341,341,37,37,0,1,0
40,345,345,3,3,0,1,0
13,349,349,5,5,0,1,0
6,355,355,25,3,22,4,3
29,363,363,12,8,4,2,1
10,364,364,23,5,18,3,2
2,372,372,149,87,62,3,2
32,372,372,27,27,0,1,0
33,375,375,28,28,0,1,0
12,389,389,50,50,0,1,0
3,403,403,9,9,0,1,0
23,414,414,6,6,0,1,0
0,422,422,12,12,0,1,0
4,422,422,15,3,12,2,1
38,432,432,12,6,6,3,2
46,432,432,29,29,0,1,0
19,437,437,55,11,44,3,2
39,455,455,47,47,0,1,0
43,460,460,3,3,0,1,0
24,466,466,52,39,13,2,1
36,481,481,88,6,82,3,2
22,482,482,1,1,0,1,0

25,114,114,4,4,0,1,0
17,119,119,1,1,0,1,0
13,126,126,33,21,12,3,2
8,132,132,1,1,0,1,0
4,146,146,24,13,11,2,1
32,146,146,5,5,0,1,0
7,163,163,21,14,7,2,1
0,182,182,2,2,0,1,0
38,186,186,30,24,6,2,1
18,200,200,28,20,8,2,1
29,203,203,9,3,6,3,2
23,212,212,31,31,0,1,0
28,224,224,40,28,12,3,2
19,255,255,31,31,0,1,0
26,273,273,90,25,65,3,2
34,294,294,12,5,7,2,1
15,323,323,22,22,0,1,0
33,337,337,47,7,40,2,1
12,340,340,33,33,0,1,0
37,343,343,23,23,0,1,0
39,349,349,37,37,0,1,0
35,354,354,26,2,24,4,3
24,355,355,12,12,0,1,0
14,380,380,24,10,14,2,1
22,393,393,2,2,0,1,0
5,394,394,28,28,0,1,0
2,406,406,43,13,30,4,3
27,411,411,26,4,22,3,2
9,412,412,13,5,8,2,1
30,413,413,69,38,31,2,1
21,430,430,30,30,0,1,0
10,434,434,45,45,0,1,0
6,437,437,48,34,14,3,2
1,443,443,83,53,30,4,3
11,458,458,15,15,0,1,0
40,465,465,3,3,0,1,0
31,476,476,86,32,54,4,3
20,482,482,15,15,0,1,0
36,487,487,74,71,3,2,1
3,494,494,75,30,45,4,3
16,500,500,52,52,0,1,0

23,105,105,1,1,0,1,0
18,109,109,5,2,3,2,1
11,114,114,13,9,4,2,1
30,133,133,12,12,0,1,0
2,135,135,7,7,0,1,0
9,150,150,32,32,0,1,0
10,150,150,1,1,0,1,0
37,171,171,15,9,6,2,1
19,175,175,20,8,12,3,2
41,185,185,2,2,0,1,0
28,198,198,26,20,6,3,2
4,207,207,1,1,0,1,0
32,212,212,5,1,4,2,1
17,226,226,27,27,0,1,0
36,232,232,5,5,0,1,0
44,245,245,12,1,11,2,1
20,273,273,74,74,0,1,0
1,281,281,27,4,23,2,1
14,289,289,1,1,0,1,0
5,302,302,2,2,0,1,0
21,304,304,20,10,10,2,1
16,318,318,24,24,0,1,0
22,320,320,25,1,24,4,3
27,330,330,5,5,0,1,0
39,370,370,96,96,0,1,0
40,378,378,44,44,0,1,0
13,384,384,15,15,0,1,0
26,394,394,27,12,15,2,1
31,397,397,59,59,0,1,0
6,399,399,5,5,0,1,0
34,407,407,8,1,7,2,1
0,413,413,77,33,44,4,3
43,430,430,9,9,0,1,0
29,433,433,90,90,0,1,0
7,447,447,34,34,0,1,0
15,453,453,1,1,0,1,0
42,454,454,96,15,81,4,3
38,454,454,19,13,6,2,1
25,456,456,17,10,7,2,1
33,461,461,167,138,29,2,1
3,463,463,84,10,74,4,3
12,470,470,16,10,6,3,2
35,479,479,55,35,20,2,1
8,481,481,44,27,17,3,2
24,492,492,50,1,49,2,1

26,117,117,10,7,3,2,1
27,146,146,14,14,0,1,0
11,147,147,38,38,0,1,0
17,162,162,9,3,6,2,1
18,166,166,49,21,28,2,1
13,191,191,6,6,0,1,0
19,198,198,66,12,54,4,3
4,217,217,94,88,6,2,1
15,217,217,2,2,0,1,0
16,224,224,5,5,0,1,0
24,238,238,45,45,0,1,0
14,240,240,8,8,0,1,0
25,255,255,37,19,18,3,2
1,256,256,4,4,0,1,0
31,265,265,5,5,0,1,0
23,282,282,2,2,0,1,0
5,285,285,8,4,4,2,1
0,289,289,39,39,0,1,0
12,297,297,36,24,12,4,3
20,307,307,44,44,0,1,0
33,314,314,18,18,0,1,0
2,316,316,77,77,0,1,0
22,332,332,39,16,23,2,1
29,332,332,31,19,12,4,3
32,341,341,36,36,0,1,0
6,345,345,20,4,16,2,1
21,352,352,12,3,9,2,1
28,369,369,71,21,50,2,1
30,388,388,4,4,0,1,0
9,405,405,64,3,61,4,3
10,432,432,124,18,106,4,3
7,447,447,42,30,12,2,1
3,455,455,6,6,0,1,0
8,483,483,62,62,0,1,0

18,102,102,7,7,0,1,0
19,103,103,1,1,0,1,0
24,137,137,40,14,26,3,2
10,138,138,10,1,9,2,1
39,143,143,8,2,6,2,1
42,172,172,6,2,4,2,1
34,191,191,4,4,0,1,0
29,202,202,29,29,0,1,0
31,209,209,17,11,6,3,2
17,221,221,7,7,0,1,0
40,246,246,1,1,0,1,0
27,248,248,2,2,0,1,0
20,252,252,5,1,4,2,1
5,255,255,40,40,0,1,0
6,263,263,26,11,15,4,3
3,267,267,12,2,10,3,2
44,273,273,34,34,0,1,0
25,280,280,6,6,0,1,0
14,284,284,38,38,0,1,0
22,288,288,79,79,0,1,0
11,332,332,1,1,0,1,0
15,336,336,36,6,30,3,2
41,340,340,34,34,0,1,0
21,350,350,7,7,0,1,0
23,357,357,1,1,0,1,0
28,367,367,43,43,0,1,0
38,369,369,95,51,44,3,2
47,370,370,6,6,0,1,0
36,391,391,50,50,0,1,0
45,395,395,38,38,0,1,0
4,402,402,25,25,0,1,0
16,405,405,29,29,0,1,0
8,407,407,11,11,0,1,0
2,419,419,6,6,0,1,0
33,438,438,10,1,9,2,1
30,443,443,7,1,6,2,1
0,444,444,55,39,16,3,2
26,445,445,93,93,0,1,0
43,447,447,168,69,99,4,3
46,448,448,123,83,40,4,3
35,449,449,3,3,0,1,0
32,456,456,60,45,15,2,1
7,465,465,30,30,0,1,0
13,472,472,1,1,0,1,0
12,474,474,7,3,4,2,1
9,477,477,4,4,0,1,0
1,489,489,18,18,0,1,0
37,498,498,13,13,0,1,0

0,113,113,5,5,0,1,0
40,115,115,11,11,0,1,0
37,115,115,12,12,0,1,0
32,134,134,15,15,0,1,0
45,141,141,14,14,0,1,0
3,154,154,13,13,0,1,0
17,157,157,11,11,0,1,0
30,176,176,11,5,6,2,1
42,188,188,16,16,0,1,0
19,204,204,8,8,0,1,0
13,207,207,10,6,4,2,1
44,208,208,2,2,0,1,0
41,230,230,33,33,0,1,0
8,241,241,4,4,0,1,0
38,243,243,59,18,41,2,1
5,255,255,10,10,0,1,0
1,259,259,79,40,39,4,3
7,266,266,18,18,0,1,0
34,275,275,65,65,0,1,0
36,276,276,24,24,0,1,0
4,293,293,30,8,22,2,1
14,294,294,3,3,0,1,0
10,309,309,8,8,0,1,0
21,319,319,27,15,12,4,3
11,325,325,10,5,5,2,1
15,346,346,5,2,3,2,1
12,352,352,19,19,0,1,0
31,355,355,11,11,0,1,0
2,356,356,50,50,0,1,0
29,363,363,18,1,17,2,1
39,379,379,5,1,4,2,1
6,383,383,77,42,35,3,2
16,387,387,32,32,0,1,0
26,399,399,8,8,0,1,0
43,405,405,37,27,10,2,1
22,422,422,22,22,0,1,0
18,436,436,3,3,0,1,0
23,449,449,4,4,0,1,0
28,454,454,101,47,54,4,3
9,463,463,27,27,0,1,0
33,465,465,64,14,50,4,3
20,470,470,5,5,0,1,0
24,475,475,56,17,39,2,1
35,481,481,50,14,36,3,2
25,486,486,139,139,0,1,0
27,492,492,46,28,18,2,1

37,121,121,11,3,8,2,1
8,125,125,9,9,0,1,0
19,127,127,1,1,0,1,0
40,151,151,4,1,3,2,1
44,175,175,13,13,0,1,0
6,180,180,16,1,15,4,3
17,185,185,30,15,15,2,1
10,194,194,33,33,0,1,0
3,216,216,3,3,0,1,0
36,222,222,29,29,0,1,0
22,224,224,2,2,0,1,0
35,234,234,52,22,30,2,1
1,238,238,1,1,0,1,0
7,254,254,3,3,0,1,0
2,258,258,3,3,0,1,0
26,268,268,3,3,0,1,0
14,272,272,50,9,41,4,3
29,292,292,64,43,21,2,1
39,294,294,3,3,0,1,0
28,305,305,8,8,0,1,0
12,311,311,12,3,9,4,3
0,325,325,6,6,0,1,0
11,341,341,8,2,6,3,2
45,345,345,80,80,0,1,0
20,346,346,11,11,0,1,0
18,349,349,11,11,0,1,0
25,362,362,5,5,0,1,0
32,363,363,54,2,52,4,3
24,365,365,1,1,0,1,0
5,369,369,34,34,0,1,0
16,377,377,49,49,0,1,0
34,384,384,68,68,0,1,0
27,385,385,32,32,0,1,0
31,389,389,68,52,16,3,2
9,393,393,9,9,0,1,0
41,405,405,42,42,0,1,0
43,406,406,44,33,11,2,1
15,412,412,2,2,0,1,0
30,420,420,5,5,0,1,0
33,436,436,43,43,0,1,0
13,436,436,146,68,78,3,2
21,455,455,25,25,0,1,0
4,465,465,149,112,37,2,1
38,467,467,37,37,0,1,0
23,469,469,68,68,0,1,0
42,475,475,2,2,0,1,0

32,103,103,7,7,0,1,0
43,104,104,2,2,0,1,0
42,105,105,5,5,0,1,0
2,118,118,2,2,0,1,0
1,133,133,8,8,0,1,0
39,136,136,2,2,0,1,0
14,137,137,12,12,0,1,0
36,138,138,16,16,0,1,0
35,140,140,2,2,0,1,0
7,144,144,18,18,0,1,0
30,147,147,1,1,0,1,0
19,148,148,3,3,0,1,0
31,151,151,44,12,32,3,2
28,162,162,14,14,0,1,0
15,163,163,52,52,0,1,0
13,195,195,21,17,4,2,1
23,207,207,22,13,9,4,3
38,226,226,30,30,0,1,0
40,232,232,2,2,0,1,0
29,233,233,12,7,5,2,1
37,240,240,105,93,12,2,1
26,243,243,12,12,0,1,0
0,243,243,20,20,0,1,0
18,258,258,9,9,0,1,0
34,275,275,39,35,4,2,1
5,277,277,8,8,0,1,0
12,281,281,66,18,48,4,3
22,313,313,1,1,0,1,0
17,327,327,30,16,14,2,1
3,345,345,42,30,12,4,3
16,361,361,30,14,16,2,1
24,366,366,52,21,31,3,2
11,368,368,36,36,0,1,0
33,373,373,35,35,0,1,0
8,398,398,8,8,0,1,0
27,420,420,12,4,8,3,2
9,424,424,6,6,0,1,0
25,426,426,68,68,0,1,0
41,435,435,62,62,0,1,0
6,441,441,57,25,32,3,2
4,448,448,46,11,35,2,1
10,457,457,45,45,0,1,0
21,467,467,6,6,0,1,0
20,474,474,1,1,0,1,0

10,123,123,23,23,0,1,0
15,129,129,1,1,0,1,0
21,137,137,7,4,3,2,1
5,141,141,44,22,22,3,2
30,156,156,3,3,0,1,0
9,162,162,16,1,15,4,3
3,181,181,51,18,33,4,3
16,204,204,6,2,4,2,1
7,214,214,31,31,0,1,0
20,234,234,14,14,0,1,0
26,240,240,29,29,0,1,0
35,249,249,31,31,0,1,0
4,252,252,1,1,0,1,0
28,258,258,13,5,8,3,2
37,264,264,12,12,0,1,0
8,274,274,18,18,0,1,0
22,297,297,11,11,0,1,0
25,325,325,26,26,0,1,0
32,341,341,79,34,45,2,1
31,346,346,41,6,35,4,3
18,361,361,47,30,17,2,1
0,364,364,54,54,0,1,0
1,368,368,41,41,0,1,0
29,368,368,77,77,0,1,0
17,370,370,39,39,0,1,0
33,396,396,6,1,5,2,1
19,401,401,26,14,12,2,1
13,414,414,32,32,0,1,0
36,414,414,20,11,9,4,3
12,415,415,36,33,3,2,1
34,419,419,56,16,40,2,1
11,419,419,9,5,4,2,1
2,444,444,37,13,24,4,3
6,446,446,21,21,0,1,0
14,475,475,90,76,14,3,2
27,481,481,109,55,54,4,3
24,484,484,65,30,35,3,2
23,490,490,64,52,12,4,3

20,108,108,5,1,4,2,1
1,121,121,7,7,0,1,0
15,128,128,1,1,0,1,0
22,149,149,6,6,0,1,0
30,157,157,4,4,0,1,0
27,160,160,18,18,0,1,0
34,181,181,3,3,0,1,0
23,185,185,23,23,0,1,0
32,188,188,46,46,0,1,0
11,198,198,2,2,0,1,0
5,210,210,13,13,0,1,0
17,215,215,7,7,0,1,0
29,218,218,8,1,7,2,1
16,219,219,27,14,13,2,1
18,234,234,53,27,26,3,2
25,234,234,28,5,23,2,1
36,236,236,2,2,0,1,0
31,250,250,30,17,13,2,1
19,278,278,27,27,0,1,0
0,284,284,65,27,38,3,2
13,309,309,37,25,12,4,3
24,310,310,16,16,0,1,0
9,317,317,64,64,0,1,0
2,357,357,164,34,130,4,3
7,359,359,12,6,6,3,2
12,367,367,13,5,8,2,1
3,371,371,1,1,0,1,0
8,397,397,45,22,23,2,1
26,413,413,167,167,0,1,0
28,415,415,78,19,59,3,2
6,447,447,159,159,0,1,0
14,447,447,45,7,38,2,1
10,464,464,31,10,21,2,1
33,471,471,8,4,4,2,1
4,481,481,12,12,0,1,0
21,486,486,16,4,12,4,3
35,498,498,50,4,46,4,3

15,102,102,7,7,0,1,0
16,103,103,13,13,0,1,0
32,110,110,3,3,0,1,0
10,125,125,6,6,0,1,0
40,128,128,8,8,0,1,0
45,156,156,25,15,10,3,2
33,173,173,10,10,0,1,0
36,177,177,16,2,14,2,1
25,192,192,16,2,14,2,1
30,192,192,4,1,3,2,1
19,201,201,79,79,0,1,0
38,204,204,51,5,46,2,1
24,208,208,2,2,0,1,0
42,210,210,7,7,0,1,0
2,224,224,11,11,0,1,0
28,232,232,25,7,18,3,2
23,251,251,13,1,12,2,1
21,252,252,32,32,0,1,0
22,253,253,9,4,5,2,1
27,254,254,10,10,0,1,0
6,270,270,17,17,0,1,0
12,300,300,22,4,18,4,3
8,302,302,7,4,3,2,1
14,315,315,1,1,0,1,0
41,318,318,15,15,0,1,0
0,340,340,18,9,9,2,1
17,355,355,19,19,0,1,0
43,356,356,15,15,0,1,0
11,366,366,29,7,22,2,1
29,367,367,266,220,46,2,1
35,371,371,26,8,18,3,2
1,384,384,10,10,0,1,0
39,386,386,47,47,0,1,0
7,386,386,11,11,0,1,0
9,392,392,58,21,37,2,1
37,395,395,16,4,12,3,2
20,401,401,26,26,0,1,0
5,405,405,34,12,22,2,1
3,410,410,13,3,10,2,1
31,414,414,4,4,0,1,0
18,415,415,9,3,6,3,2
4,416,416,30,3,27,2,1
44,420,420,9,6,3,2,1
34,427,427,36,36,0,1,0
13,492,492,92,83,9,4,3
26,494,494,15,4,11,2,1

12,110,110,18,18,0,1,0
1,114,114,17,11,6,3,2
19,131,131,10,2,8,3,2
8,144,144,8,8,0,1,0
42,165,165,12,12,0,1,0
17,177,177,3,3,0,1,0
0,188,188,3,3,0,1,0
6,192,192,1,1,0,1,0
11,193,193,7,7,0,1,0
41,201,201,6,6,0,1,0
28,213,213,6,6,0,1,0
35,216,216,14,4,10,2,1
26,216,216,23,7,16,2,1
31,225,225,6,3,3,2,1
20,226,226,26,26,0,1,0
36,235,235,7,4,3,2,1
5,236,236,9,9,0,1,0
2,236,236,112,15,97,4,3
30,257,257,39,7,32,2,1
15,271,271,7,7,0,1,0
39,275,275,29,17,12,4,3
32,282,282,44,12,32,3,2
10,289,289,13,13,0,1,0
7,305,305,1,1,0,1,0
4,308,308,35,35,0,1,0
14,309,309,36,14,22,2,1
24,311,311,4,4,0,1,0
33,340,340,31,1,30,3,2
38,342,342,69,21,48,4,3
16,351,351,1,1,0,1,0
13,355,355,19,19,0,1,0
43,364,364,54,21,33,2,1
18,378,378,7,2,5,2,1
23,385,385,31,7,24,2,1
21,387,387,20,11,9,4,3
25,392,392,68,29,39,4,3
3,397,397,97,41,56,3,2
22,419,419,17,17,0,1,0
9,429,429,25,25,0,1,0
37,446,446,116,116,0,1,0
27,456,456,11,6,5,2,1
29,458,458,56,56,0,1,0
34,493,493,44,44,0,1,0
40,498,498,70,4,66,3,2

23,104,104,22,6,16,2,1
2,113,113,12,3,9,4,3
30,116,116,17,9,8,2,1
34,130,130,4,4,0,1,0
17,136,136,1,1,0,1,0
10,142,142,8,2,6,2,1
0,160,160,7,7,0,1,0
15,199,199,1,1,0,1,0
43,199,199,10,3,7,2,1
24,210,210,15,10,5,2,1
25,216,216,1,1,0,1,0
31,225,225,2,2,0,1,0
26,243,243,110,11,99,4,3
7,250,250,50,50,0,1,0
39,266,266,51,13,38,2,1
42,267,267,33,33,0,1,0
21,278,278,8,8,0,1,0
32,290,290,78,57,21,4,3
16,298,298,35,30,5,2,1
41,301,301,16,16,0,1,0
33,305,305,9,3,6,2,1
29,318,318,9,2,7,2,1
13,325,325,30,12,18,2,1
18,325,325,16,2,14,3,2
22,342,342,13,13,0,1,0
12,346,346,36,36,0,1,0
44,350,350,23,3,20,3,2
8,362,362,4,1,3,2,1
36,374,374,44,44,0,1,0
5,379,379,32,2,30,3,2
20,386,386,29,29,0,1,0
6,386,386,58,45,13,2,1
9,386,386,5,5,0,1,0
40,399,399,40,31,9,4,3
4,402,402,27,5,22,3,2
11,411,411,18,3,15,3,2
14,433,433,28,12,16,3,2
27,433,433,60,60,0,1,0
37,433,433,25,25,0,1,0
1,456,456,84,15,69,4,3
35,460,460,38,16,22,2,1
38,473,473,6,6,0,1,0
3,478,478,16,16,0,1,0
28,492,492,37,37,0,1,0
19,497,497,71,32,39,2,1

30,104,104,26,26,0,1,0
25,121,121,13,7,6,2,1
23,125,125,6,6,0,1,0
37,148,148,3,3,0,1,0
34,163,163,3,3,0,1,0
26,187,187,19,19,0,1,0
9,209,209,58,6,52,3,2
29,216,216,9,9,0,1,0
21,221,221,10,10,0,1,0
5,237,237,27,2,25,2,1
28,242,242,32,19,13,3,2
0,243,243,3,3,0,1,0
7,244,244,9,1,8,3,2
8,251,251,32,12,20,2,1
3,254,254,20,4,16,3,2
14,267,267,4,1,3,2,1
32,272,272,20,20,0,1,0
17,274,274,101,20,81,4,3
22,290,290,20,3,17,2,1
38,301,301,65,65,0,1,0
15,302,302,50,2,48,4,3
6,303,303,86,86,0,1,0
31,305,305,5,5,0,1,0
11,306,306,20,5,15,2,1
19,321,321,2,2,0,1,0
1,330,330,10,3,7,2,1
33,332,332,7,3,4,2,1
2,332,332,28,16,12,4,3
4,346,346,14,14,0,1,0
10,359,359,41,29,12,2,1
12,362,362,17,17,0,1,0
39,382,382,99,53,46,3,2
20,415,415,14,10,4,2,1
24,416,416,21,3,18,4,3
27,422,422,218,134,84,4,3
35,457,457,3,3,0,1,0
36,487,487,4,4,0,1,0
13,488,488,41,12,29,2,1
18,489,489,23,16,7,2,1
16,494,494,1,1,0,1,0

18,121,121,6,6,0,1,0
17,125,125,18,18,0,1,0
37,128,128,6,6,0,1,0
20,132,132,4,4,0,1,0
2,148,148,10,10,0,1,0
7,160,160,9,9,0,1,0
24,176,176,3,3,0,1,0
8,178,178,7,7,0,1,0
21,185,185,10,2,8,3,2
27,228,228,12,5,7,2,1
9,235,235,57,21,36,3,2
13,256,256,28,28,0,1,0
15,257,257,31,31,0,1,0
3,262,262,10,3,7,2,1
36,299,299,104,82,22,4,3
6,314,314,41,41,0,1,0
11,321,321,67,28,39,4,3
31,327,327,96,63,33,4,3
0,329,329,108,79,29,2,1
14,348,348,1,1,0,1,0
10,355,355,40,23,17,2,1
29,371,371,31,5,26,3,2
32,377,377,2,2,0,1,0
1,394,394,48,48,0,1,0
12,394,394,33,1,32,2,1
22,395,395,64,17,47,2,1
30,442,442,6,6,0,1,0
35,443,443,79,11,68,3,2
25,449,449,24,24,0,1,0
16,450,450,19,1,18,4,3
38,460,460,5,2,3,2,1
28,464,464,26,16,10,3,2
23,467,467,67,4,63,4,3
19,470,470,91,11,80,3,2
5,474,474,24,24,0,1,0
34,475,475,13,13,0,1,0
33,484,484,15,15,0,1,0
4,494,494,27,27,0,1,0
26,499,499,113,29,84,4,3

10,106,106,1,1,0,1,0
37,113,113,5,5,0,1,0
18,115,115,10,10,0,1,0
31,126,126,4,4,0,1,0
8,129,129,1,1,0,1,0
28,140,140,12,12,0,1,0
21,142,142,2,2,0,1,0
2,162,162,6,3,3,2,1
36,166,166,26,12,14,2,1
40,170,170,33,23,10,2,1
30,171,171,2,2,0,1,0
25,180,180,54,33,21,4,3
35,195,195,11,5,6,3,2
34,196,196,56,49,7,2,1
27,201,201,68,26,42,4,3
6,202,202,3,3,0,1,0
38,204,204,18,18,0,1,0
19,206,206,29,20,9,4,3
39,208,208,15,15,0,1,0
32,212,212,16,16,0,1,0
15,217,217,1,1,0,1,0
41,218,218,24,24,0,1,0
4,220,220,2,2,0,1,0
3,230,230,2,2,0,1,0
0,242,242,56,39,17,2,1
45,244,244,1,1,0,1,0
5,246,246,1,1,0,1,0
17,270,270,73,66,7,2,1
12,295,295,89,89,0,1,0
26,297,297,6,1,5,2,1
33,303,303,2,2,0,1,0
14,310,310,9,9,0,1,0
9,312,312,31,31,0,1,0
7,317,317,8,8,0,1,0
13,317,317,1,1,0,1,0
22,328,328,32,32,0,1,0
20,354,354,15,15,0,1,0
11,355,355,27,10,17,2,1
16,396,396,11,11,0,1,0
1,405,405,28,16,12,2,1
23,409,409,31,21,10,2,1
43,468,468,78,69,9,2,1
29,470,470,60,60,0,1,0
44,475,475,53,26,27,4,3
24,482,482,9,9,0,1,0
42,497,497,36,8,28,3,2

14,103,103,7,7,0,1,0
12,123,123,1,1,0,1,0
34,124,124,11,11,0,1,0
4,135,135,6,6,0,1,0
3,137,137,1,1,0,1,0
24,160,160,5,5,0,1,0
18,161,161,20,20,0,1,0
9,174,174,21,7,14,4,3
31,178,178,7,7,0,1,0
16,194,194,28,7,21,2,1
6,251,251,8,1,7,2,1
20,262,262,48,33,15,2,1
36,262,262,112,25,87,4,3
37,283,283,23,3,20,2,1
38,285,285,5,5,0,1,0
26,298,298,28,14,14,2,1
2,312,312,25,25,0,1,0
30,314,314,6,6,0,1,0
8,316,316,11,11,0,1,0
17,319,319,48,22,26,2,1
15,333,333,42,42,0,1,0
7,333,333,18,18,0,1,0
23,350,350,44,16,28,2,1
29,362,362,67,49,18,4,3
39,363,363,5,2,3,2,1
35,364,364,16,16,0,1,0
33,368,368,5,5,0,1,0
1,368,368,42,42,0,1,0
25,375,375,2,2,0,1,0
10,394,394,67,67,0,1,0
21,397,397,32,18,14,3,2
22,402,402,32,12,20,3,2
0,422,422,65,35,30,4,3
32,439,439,145,145,0,1,0
19,450,450,141,72,69,4,3
5,466,466,63,41,22,2,1
11,486,486,29,29,0,1,0
13,489,489,29,22,7,2,1
27,494,494,80,80,0,1,0
28,495,495,4,4,0,1,0

26,121,121,1,1,0,1,0
34,148,148,14,14,0,1,0
27,159,159,6,6,0,1,0
21,207,207,53,53,0,1,0
6,233,233,43,7,36,4,3
0,234,234,101,61,40,4,3
36,235,235,72,48,24,3,2
30,240,240,25,25,0,1,0
5,244,244,14,14,0,1,0
1,251,251,48,48,0,1,0
10,253,253,39,39,0,1,0
12,262,262,7,7,0,1,0
11,303,303,4,4,0,1,0
22,304,304,9,9,0,1,0
24,309,309,38,1,37,2,1
35,319,319,15,8,7,2,1
17,348,348,25,3,22,3,2
23,359,359,71,51,20,3,2
31,375,375,19,9,10,3,2
3,382,382,10,2,8,3,2
7,384,384,25,4,21,4,3
2,386,386,133,133,0,1,0
33,394,394,27,27,0,1,0
28,394,394,36,28,8,3,2
4,419,419,92,29,63,4,3
32,422,422,3,3,0,1,0
14,435,435,18,6,12,3,2
29,435,435,47,47,0,1,0
25,435,435,42,42,0,1,0
15,440,440,9,2,7,2,1
9,442,442,13,13,0,1,0
20,446,446,4,4,0,1,0
8,463,463,8,8,0,1,0
18,476,476,36,36,0,1,0
19,481,481,121,121,0,1,0
16,494,494,3,3,0,1,0
13,494,494,85,36,49,2,1

27,108,108,4,1,3,2,1
22,109,109,12,12,0,1,0
41,111,111,3,3,0,1,0
4,112,112,3,3,0,1,0
43,119,119,10,2,8,3,2
6,130,130,14,1,13,2,1
12,131,131,7,1,6,2,1
25,149,149,15,15,0,1,0
13,159,159,1,1,0,1,0
39,172,172,12,9,3,2,1
29,179,179,3,3,0,1,0
44,184,184,48,43,5,2,1
23,186,186,6,6,0,1,0
36,191,191,28,28,0,1,0
30,191,191,36,20,16,3,2
21,196,196,6,3,3,2,1
35,200,200,7,7,0,1,0
14,209,209,1,1,0,1,0
2,230,230,4,4,0,1,0
9,232,232,41,41,0,1,0
42,246,246,35,35,0,1,0
8,258,258,1,1,0,1,0
20,260,260,1,1,0,1,0
26,265,265,19,3,16,2,1
33,270,270,10,1,9,2,1
31,272,272,13,13,0,1,0
18,284,284,57,57,0,1,0
15,297,297,1,1,0,1,0
7,298,298,62,16,46,2,1
1,346,346,18,18,0,1,0
37,347,347,1,1,0,1,0
19,353,353,3,3,0,1,0
40,356,356,2,2,0,1,0
24,363,363,22,22,0,1,0
38,379,379,154,132,22,3,2
48,388,388,28,18,10,3,2
0,391,391,23,23,0,1,0
16,396,396,15,15,0,1,0
10,406,406,95,95,0,1,0
11,427,427,53,3,50,2,1
47,431,431,59,35,24,3,2
32,436,436,8,8,0,1,0
5,437,437,26,11,15,4,3
34,440,440,51,22,29,2,1
45,458,458,95,95,0,1,0
3,480,480,58,58,0,1,0
17,488,488,22,22,0,1,0
46,496,496,9,2,7,2,1
28,500,500,2,2,0,1,0

19,105,105,29,29,0,1,0
23,131,131,9,9,0,1,0
7,136,136,1,1,0,1,0
14,164,164,2,2,0,1,0
27,173,173,3,3,0,1,0
8,183,183,123,63,60,3,2
25,198,198,17,17,0,1,0
6,209,209,22,22,0,1,0
3,213,213,45,45,0,1,0
12,245,245,69,63,6,2,1
24,257,257,4,4,0,1,0
10,283,283,19,19,0,1,0
4,294,294,9,9,0,1,0
5,294,294,12,2,10,3,2
16,312,312,13,13,0,1,0
26,350,350,1,1,0,1,0
9,352,352,47,47,0,1,0
1,354,354,24,24,0,1,0
33,355,355,10,10,0,1,0
15,357,357,7,4,3,2,1
34,405,405,261,261,0,1,0
20,422,422,45,45,0,1,0
21,432,432,30,30,0,1,0
32,444,444,52,8,44,3,2
11,446,446,48,11,37,2,1
2,451,451,5,2,3,2,1
13,453,453,1,1,0,1,0
30,453,453,10,10,0,1,0
28,460,460,27,27,0,1,0
22,469,469,24,24,0,1,0
29,478,478,13,13,0,1,0
0,483,483,123,54,69,4,3
18,485,485,111,98,13,2,1
31,492,492,35,35,0,1,0
17,493,493,37,37,0,1,0

38,101,101,5,1,4,2,1
16,105,105,11,3,8,3,2
13,115,115,3,3,0,1,0
19,116,116,6,2,4,2,1
15,121,121,9,2,7,2,1
12,123,123,6,6,0,1,0
22,128,128,4,4,0,1,0
9,132,132,2,2,0,1,0
21,148,148,7,7,0,1,0
37,154,154,12,4,8,2,1
23,167,167,52,52,0,1,0
33,176,176,31,31,0,1,0
11,188,188,6,6,0,1,0
49,191,191,3,3,0,1,0
44,194,194,27,27,0,1,0
34,195,195,6,6,0,1,0
40,202,202,28,28,0,1,0
43,210,210,38,38,0,1,0
35,215,215,13,6,7,2,1
10,220,220,5,1,4,2,1
2,229,229,20,20,0,1,0
7,234,234,31,31,0,1,0
5,242,242,6,6,0,1,0
29,244,244,1,1,0,1,0
48,249,249,4,4,0,1,0
17,249,249,12,12,0,1,0
26,269,269,18,18,0,1,0
28,272,272,13,13,0,1,0
1,277,277,8,8,0,1,0
46,290,290,61,22,39,2,1
0,292,292,32,32,0,1,0
4,296,296,5,5,0,1,0
25,308,308,25,7,18,3,2
20,327,327,70,70,0,1,0
36,328,328,50,50,0,1,0
41,337,337,13,13,0,1,0
27,351,351,21,21,0,1,0
14,352,352,1,1,0,1,0
3,367,367,6,6,0,1,0
32,370,370,1,1,0,1,0
39,377,377,98,83,15,2,1
24,378,378,58,58,0,1,0
42,384,384,14,4,10,2,1
45,385,385,3,3,0,1,0
6,409,409,12,6,6,3,2
8,413,413,22,22,0,1,0
31,427,427,127,84,43,2,1
30,432,432,62,20,42,3,2
47,455,455,3,3,0,1,0
18,481,481,28,17,11,4,3

29,112,112,22,22,0,1,0
17,122,122,5,5,0,1,0
31,122,122,9,9,0,1,0
5,130,130,24,24,0,1,0
4,138,138,1,1,0,1,0
0,154,154,2,2,0,1,0
25,160,160,35,23,12,2,1
9,164,164,17,17,0,1,0
6,166,166,23,9,14,3,2
16,169,169,13,10,3,2,1
30,178,178,18,18,0,1,0
28,179,179,5,5,0,1,0
27,179,179,4,4,0,1,0
10,182,182,19,15,4,2,1
38,194,194,15,2,13,2,1
33,220,220,61,34,27,2,1
8,245,245,145,111,34,3,2
36,265,265,70,54,16,2,1
34,271,271,6,2,4,2,1
18,274,274,10,10,0,1,0
13,276,276,3,3,0,1,0
15,280,280,1,1,0,1,0
12,295,295,75,18,57,4,3
24,300,300,3,3,0,1,0
37,328,328,22,16,6,3,2
22,338,338,11,1,10,2,1
1,347,347,15,15,0,1,0
20,362,362,3,3,0,1,0
19,362,362,17,3,14,3,2
14,369,369,40,40,0,1,0
26,370,370,31,31,0,1,0
7,377,377,39,17,22,3,2
21,380,380,7,7,0,1,0
2,400,400,22,10,12,2,1
11,456,456,43,33,10,3,2
32,462,462,200,173,27,2,1
3,462,462,15,15,0,1,0
35,467,467,13,13,0,1,0
23,480,480,19,11,8,2,1

35,104,104,34,7,27,4,3
40,105,105,12,6,6,3,2
32,110,110,22,4,18,4,3
15,113,113,4,4,0,1,0
11,133,133,13,13,0,1,0
42,133,133,1,1,0,1,0
16,142,142,16,16,0,1,0
41,142,142,10,10,0,1,0
28,142,142,11,11,0,1,0
8,146,146,15,15,0,1,0
34,151,151,16,7,9,4,3
12,155,155,2,2,0,1,0
23,161,161,1,1,0,1,0
13,174,174,6,3,3,2,1
19,178,178,19,19,0,1,0
18,193,193,1,1,0,1,0
6,198,198,24,7,17,2,1
10,227,227,6,1,5,2,1
20,231,231,3,3,0,1,0
7,233,233,38,1,37,2,1
22,242,242,23,11,12,4,3
21,266,266,12,12,0,1,0
17,275,275,1,1,0,1,0
3,276,276,20,6,14,2,1
26,288,288,3,3,0,1,0
39,305,305,3,3,0,1,0
30,308,308,5,5,0,1,0
0,309,309,11,1,10,2,1
1,326,326,77,77,0,1,0
27,326,326,1,1,0,1,0
36,339,339,20,20,0,1,0
37,348,348,51,23,28,2,1
24,354,354,35,20,15,4,3
2,359,359,51,51,0,1,0
29,374,374,4,4,0,1,0
38,379,379,101,10,91,3,2
25,389,389,52,2,50,2,1
31,395,395,114,93,21,4,3
5,395,395,82,82,0,1,0
4,432,432,37,37,0,1,0
9,468,468,70,45,25,2,1
33,486,486,40,15,25,2,1
14,490,490,47,47,0,1,0

40,101,101,25,25,0,1,0
39,113,113,2,2,0,1,0
42,120,120,10,3,7,2,1
37,125,125,4,4,0,1,0
29,127,127,37,37,0,1,0
23,131,131,15,15,0,1,0
4,139,139,4,4,0,1,0
22,139,139,25,11,14,3,2
41,142,142,17,3,14,3,2
12,158,158,2,2,0,1,0
9,165,165,22,22,0,1,0
14,172,172,10,2,8,3,2
33,177,177,7,7,0,1,0
0,186,186,1,1,0,1,0
27,195,195,11,11,0,1,0
31,199,199,11,11,0,1,0
44,199,199,13,1,12,4,3
21,211,211,11,5,6,2,1
43,217,217,19,19,0,1,0
35,220,220,19,19,0,1,0
11,242,242,6,6,0,1,0
2,247,247,22,22,0,1,0
17,263,263,35,35,0,1,0
25,264,264,2,2,0,1,0
20,273,273,7,7,0,1,0
36,287,287,66,50,16,3,2
8,337,337,102,53,49,4,3
34,354,354,6,6,0,1,0
30,363,363,20,20,0,1,0
7,375,375,21,21,0,1,0
16,378,378,29,19,10,3,2
15,382,382,7,4,3,2,1
24,398,398,15,5,10,2,1
13,412,412,5,5,0,1,0
5,414,414,1,1,0,1,0
26,428,428,1,1,0,1,0
18,430,430,2,2,0,1,0
32,434,434,77,77,0,1,0
6,445,445,198,151,47,4,3
38,447,447,157,91,66,4,3
1,447,447,30,30,0,1,0
10,457,457,21,21,0,1,0
19,482,482,31,31,0,1,0
3,485,485,5,5,0,1,0
28,487,487,7,7,0,1,0

19,104,104,3,3,0,1,0
2,118,118,10,10,0,1,0
39,131,131,1,1,0,1,0
4,155,155,49,32,17,2,1
13,158,158,3,3,0,1,0
1,162,162,4,4,0,1,0
22,163,163,26,26,0,1,0
17,177,177,14,14,0,1,0
23,183,183,23,23,0,1,0
35,187,187,13,13,0,1,0
28,189,189,10,2,8,2,1
27,191,191,23,23,0,1,0
33,194,194,7,7,0,1,0
11,201,201,4,1,3,2,1
0,211,211,8,1,7,2,1
41,219,219,27,27,0,1,0
14,293,293,31,31,0,1,0
30,299,299,8,8,0,1,0
40,302,302,5,1,4,2,1
25,319,319,49,23,26,3,2
8,320,320,8,8,0,1,0
16,328,328,7,4,3,2,1
38,341,341,37,7,30,3,2
21,359,359,32,32,0,1,0
5,363,363,7,7,0,1,0
36,365,365,16,2,14,2,1
26,367,367,99,96,3,2,1
31,367,367,8,1,7,2,1
10,388,388,13,13,0,1,0
37,390,390,122,84,38,2,1
12,395,395,30,15,15,2,1
32,395,395,6,6,0,1,0
3,396,396,33,33,0,1,0
6,403,403,97,27,70,3,2
34,412,412,14,14,0,1,0
24,420,420,58,58,0,1,0
29,429,429,87,87,0,1,0
20,432,432,19,19,0,1,0
15,453,453,116,95,21,4,3
7,454,454,86,86,0,1,0
18,470,470,75,75,0,1,0
9,482,482,23,23,0,1,0

6,100,100,5,5,0,1,0
27,112,112,16,16,0,1,0
19,112,112,11,11,0,1,0
29,154,154,42,18,24,4,3
13,159,159,8,8,0,1,0
28,168,168,7,7,0,1,0
30,175,175,15,1,14,3,2
14,176,176,2,2,0,1,0
38,191,191,2,2,0,1,0
10,195,195,27,27,0,1,0
4,196,196,63,63,0,1,0
36,205,205,25,4,21,2,1
31,241,241,18,4,14,2,1
18,256,256,9,9,0,1,0
37,256,256,7,3,4,2,1
5,257,257,6,6,0,1,0
0,284,284,7,7,0,1,0
16,285,285,41,13,28,4,3
35,291,291,30,30,0,1,0
3,295,295,22,5,17,2,1
11,306,306,4,4,0,1,0
33,309,309,115,71,44,2,1
25,328,328,47,25,22,3,2
34,339,339,3,3,0,1,0
23,344,344,16,16,0,1,0
21,360,360,46,28,18,2,1
15,371,371,18,18,0,1,0
8,379,379,69,9,60,4,3
24,401,401,1,1,0,1,0
7,417,417,9,9,0,1,0
32,418,418,101,17,84,3,2
9,421,421,76,51,25,4,3
1,421,421,5,5,0,1,0
2,437,437,16,16,0,1,0
22,443,443,25,7,18,3,2
20,473,473,32,32,0,1,0
12,479,479,158,118,40,4,3
26,482,482,2,2,0,1,0
17,485,485,147,137,10,3,2

6,138,138,7,7,0,1,0
4,151,151,34,34,0,1,0
43,162,162,2,2,0,1,0
8,172,172,9,9,0,1,0
42,172,172,1,1,0,1,0
19,182,182,1,1,0,1,0
11,192,192,6,2,4,2,1
12,192,192,3,3,0,1,0
16,195,195,5,2,3,2,1
10,198,198,7,1,6,3,2
36,207,207,30,30,0,1,0
7,217,217,27,27,0,1,0
34,220,220,26,9,17,2,1
40,229,229,9,9,0,1,0
35,251,251,8,8,0,1,0
5,260,260,24,24,0,1,0
9,286,286,10,6,4,2,1
21,291,291,1,1,0,1,0
39,298,298,51,27,24,2,1
31,301,301,33,20,13,2,1
28,302,302,8,8,0,1,0
30,303,303,36,36,0,1,0
0,303,303,65,11,54,3,2
41,304,304,31,31,0,1,0
23,307,307,25,16,9,4,3
29,307,307,52,8,44,4,3
27,315,315,4,4,0,1,0
17,320,320,1,1,0,1,0
14,350,350,33,33,0,1,0
26,353,353,6,3,3,2,1
1,372,372,42,42,0,1,0
24,390,390,111,111,0,1,0
2,390,390,33,33,0,1,0
22,398,398,66,51,15,4,3
20,401,401,28,18,10,3,2
15,401,401,25,16,9,4,3
32,409,409,132,113,19,2,1
13,419,419,15,12,3,2,1
18,426,426,135,105,30,2,1
37,434,434,21,21,0,1,0
3,450,450,28,28,0,1,0
38,454,454,64,64,0,1,0
33,454,454,5,1,4,2,1
25,457,457,70,61,9,4,3

8,109,109,13,13,0,1,0
29,115,115,31,31,0,1,0
13,117,117,17,7,10,2,1
34,137,137,8,2,6,3,2
1,146,146,1,1,0,1,0
30,159,159,11,5,6,2,1
16,184,184,28,17,11,2,1
2,191,191,93,15,78,4,3
22,195,195,3,3,0,1,0
10,197,197,23,14,9,4,3
0,198,198,10,10,0,1,0
31,210,210,33,33,0,1,0
4,211,211,57,57,0,1,0
17,216,216,4,4,0,1,0
7,218,218,45,45,0,1,0
3,219,219,6,6,0,1,0
12,224,224,10,1,9,2,1
33,225,225,5,5,0,1,0
5,230,230,33,33,0,1,0
32,230,230,52,5,47,2,1
35,240,240,9,5,4,2,1
11,278,278,25,25,0,1,0
28,286,286,103,83,20,2,1
14,289,289,5,5,0,1,0
26,298,298,5,5,0,1,0
9,309,309,13,8,5,2,1
24,321,321,64,48,16,2,1
21,326,326,71,25,46,2,1
36,327,327,18,18,0,1,0
6,362,362,20,20,0,1,0
15,368,368,10,1,9,4,3
19,376,376,39,39,0,1,0
20,384,384,2,2,0,1,0
23,390,390,19,7,12,2,1
18,399,399,16,2,14,3,2
25,411,411,10,10,0,1,0
27,471,471,49,49,0,1,0

19,111,111,11,11,0,1,0
20,125,125,8,8,0,1,0
37,126,126,6,3,3,2,1
33,132,132,32,32,0,1,0
36,139,139,18,18,0,1,0
28,146,146,22,22,0,1,0
6,175,175,9,9,0,1,0
38,178,178,3,3,0,1,0
29,182,182,3,3,0,1,0
13,221,221,25,25,0,1,0
5,223,223,4,1,3,2,1
35,260,260,1,1,0,1,0
15,263,263,34,17,17,2,1
18,266,266,23,23,0,1,0
4,266,266,10,10,0,1,0
10,275,275,31,16,15,4,3
27,279,279,65,15,50,3,2
14,302,302,72,43,29,4,3
0,302,302,30,30,0,1,0
17,304,304,7,1,6,3,2
8,312,312,41,41,0,1,0
9,352,352,15,15,0,1,0
22,353,353,37,29,8,3,2
39,357,357,9,1,8,2,1
26,360,360,42,27,15,2,1
2,373,373,1,1,0,1,0
30,392,392,56,56,0,1,0
11,395,395,41,6,35,2,1
23,400,400,37,25,12,4,3
7,406,406,14,14,0,1,0
24,415,415,18,2,16,3,2
31,439,439,75,75,0,1,0
34,440,440,167,167,0,1,0
12,442,442,43,43,0,1,0
1,460,460,105,105,0,1,0
16,475,475,58,16,42,3,2
3,477,477,111,22,89,4,3
32,477,477,17,17,0,1,0
21,480,480,9,9,0,1,0
25,498,498,3,3,0,1,0

10,107,107,7,7,0,1,0
37,117,117,6,6,0,1,0
20,119,119,6,6,0,1,0
15,133,133,29,29,0,1,0
11,152,152,17,17,0,1,0
4,153,153,18,10,8,2,1
1,168,168,7,7,0,1,0
18,183,183,48,22,26,2,1
5,184,184,40,40,0,1,0
31,193,193,9,6,3,2,1
30,198,198,4,4,0,1,0
28,211,211,29,29,0,1,0
0,223,223,2,2,0,1,0
17,229,229,55,55,0,1,0
9,233,233,54,38,16,3,2
12,244,244,4,4,0,1,0
13,245,245,5,5,0,1,0
23,256,256,23,23,0,1,0
25,271,271,58,58,0,1,0
16,275,275,7,1,6,2,1
26,296,296,19,19,0,1,0
24,306,306,91,58,33,4,3
19,316,316,33,33,0,1,0
29,321,321,44,5,39,2,1
39,330,330,51,19,32,3,2
38,359,359,40,40,0,1,0
6,364,364,10,10,0,1,0
34,373,373,12,1,11,2,1
22,382,382,2,2,0,1,0
33,420,420,11,11,0,1,0
27,424,424,34,34,0,1,0
8,436,436,16,2,14,3,2
36,440,440,56,17,39,2,1
7,450,450,34,34,0,1,0
3,452,452,1,1,0,1,0
14,458,458,80,80,0,1,0
32,459,459,31,31,0,1,0
35,463,463,78,66,12,3,2
21,475,475,75,25,50,2,1
2,483,483,1,1,0,1,0

9,111,111,1,1,0,1,0
17,118,118,5,5,0,1,0
20,129,129,18,18,0,1,0
24,130,130,43,31,12,2,1
25,138,138,20,20,0,1,0
11,139,139,4,4,0,1,0
8,145,145,41,41,0,1,0
4,148,148,12,7,5,2,1
12,149,149,14,3,11,4,3
2,152,152,2,2,0,1,0
18,156,156,30,30,0,1,0
7,173,173,6,6,0,1,0
32,202,202,20,4,16,2,1
23,208,208,8,8,0,1,0
3,219,219,47,41,6,3,2
6,231,231,4,1,3,2,1
26,256,256,30,14,16,2,1
27,275,275,23,23,0,1,0
22,280,280,5,5,0,1,0
14,281,281,15,3,12,3,2
36,286,286,77,77,0,1,0
0,287,287,3,3,0,1,0
29,332,332,7,2,5,2,1
21,352,352,23,23,0,1,0
39,361,361,186,168,18,3,2
15,379,379,84,25,59,4,3
19,384,384,49,49,0,1,0
34,404,404,4,4,0,1,0
37,404,404,11,5,6,3,2
31,411,411,22,22,0,1,0
33,414,414,46,11,35,2,1
1,425,425,112,70,42,3,2
13,444,444,37,37,0,1,0
10,453,453,5,5,0,1,0
40,460,460,21,3,18,3,2
5,461,461,20,20,0,1,0
16,464,464,17,4,13,2,1
38,474,474,14,1,13,4,3
30,479,479,17,3,14,4,3
28,497,497,7,1,6,3,2
35,500,500,5,5,0,1,0

38,117,117,4,4,0,1,0
25,117,117,21,21,0,1,0
21,134,134,19,13,6,2,1
9,139,139,1,1,0,1,0
4,140,140,12,2,10,2,1
22,175,175,15,8,7,2,1
14,181,181,5,5,0,1,0
18,188,188,1,1,0,1,0
27,190,190,58,58,0,1,0
1,206,206,26,26,0,1,0
35,220,220,6,6,0,1,0
31,237,237,7,7,0,1,0
11,258,258,44,40,4,2,1
29,263,263,1,1,0,1,0
26,271,271,40,28,12,3,2
39,285,285,3,3,0,1,0
37,308,308,22,2,20,3,2
8,311,311,39,27,12,2,1
15,312,312,4,1,3,2,1
28,335,335,30,30,0,1,0
23,349,349,34,29,5,2,1
19,350,350,5,5,0,1,0
7,354,354,38,38,0,1,0
24,354,354,18,9,9,4,3
0,364,364,1,1,0,1,0
30,365,365,5,5,0,1,0
6,380,380,20,13,7,2,1
16,392,392,33,9,24,2,1
3,399,399,31,6,25,3,2
5,406,406,90,83,7,2,1
34,415,415,29,29,0,1,0
20,429,429,51,18,33,2,1
40,430,430,48,48,0,1,0
12,438,438,126,126,0,1,0
10,445,445,71,29,42,4,3
32,452,452,49,43,6,2,1
41,460,460,2,2,0,1,0
2,471,471,46,31,15,2,1
33,475,475,206,81,125,4,3
36,477,477,76,57,19,3,2
17,480,480,25,22,3,2,1
13,490,490,11,1,10,3,2

25,115,115,27,15,12,4,3
35,120,120,2,2,0,1,0
29,124,124,3,3,0,1,0
20,133,133,11,11,0,1,0
31,144,144,12,12,0,1,0
15,157,157,17,17,0,1,0
24,164,164,6,6,0,1,0
37,171,171,14,3,11,2,1
23,173,173,3,3,0,1,0
34,187,187,53,53,0,1,0
33,199,199,14,14,0,1,0
14,203,203,49,49,0,1,0
16,225,225,33,13,20,4,3
18,225,225,28,4,24,2,1
30,232,232,10,2,8,3,2
12,234,234,20,20,0,1,0
21,268,268,50,50,0,1,0
19,279,279,17,4,13,2,1
26,281,281,49,4,45,2,1
2,326,326,109,8,101,4,3
32,334,334,85,76,9,4,3
28,342,342,9,9,0,1,0
27,345,345,6,6,0,1,0
9,366,366,5,5,0,1,0
17,374,374,31,31,0,1,0
11,378,378,14,14,0,1,0
4,380,380,41,41,0,1,0
7,393,393,65,23,42,3,2
8,402,402,45,6,39,2,1
36,405,405,34,1,33,2,1
5,410,410,5,5,0,1,0
10,412,412,31,8,23,2,1
22,414,414,61,61,0,1,0
3,445,445,84,40,44,2,1
1,452,452,5,1,4,2,1
6,455,455,4,4,0,1,0
13,484,484,115,115,0,1,0
0,487,487,16,16,0,1,0

28,121,121,10,10,0,1,0
10,124,124,7,7,0,1,0
15,127,127,1,1,0,1,0
29,133,133,38,16,22,2,1
36,146,146,16,2,14,3,2
40,147,147,5,2,3,2,1
39,147,147,1,1,0,1,0
32,195,195,62,19,43,3,2
24,197,197,7,3,4,2,1
38,199,199,9,9,0,1,0
1,227,227,40,40,0,1,0
31,255,255,34,22,12,4,3
13,260,260,9,9,0,1,0
26,260,260,13,1,12,2,1
0,261,261,26,4,22,2,1
3,263,263,4,4,0,1,0
21,263,263,71,71,0,1,0
25,280,280,66,54,12,4,3
22,285,285,11,11,0,1,0
37,299,299,20,5,15,4,3
9,302,302,83,83,0,1,0
14,314,314,71,10,61,4,3
5,317,317,17,17,0,1,0
2,349,349,34,12,22,2,1
19,350,350,3,3,0,1,0
17,363,363,1,1,0,1,0
11,374,374,80,80,0,1,0
6,376,376,65,65,0,1,0
8,384,384,5,5,0,1,0
18,388,388,44,21,23,2,1
34,390,390,55,31,24,2,1
7,402,402,25,15,10,3,2
33,405,405,48,48,0,1,0
30,408,408,14,14,0,1,0
12,413,413,85,14,71,3,2
20,419,419,30,17,13,2,1
16,421,421,9,6,3,2,1
35,445,445,2,2,0,1,0
23,456,456,7,7,0,1,0
4,464,464,34,34,0,1,0
27,485,485,11,11,0,1,0

26,112,112,9,9,0,1,0
25,119,119,19,19,0,1,0
1,126,126,1,1,0,1,0
36,140,140,5,5,0,1,0
12,141,141,4,4,0,1,0
5,141,141,8,5,3,2,1
29,149,149,27,10,17,2,1
23,156,156,20,20,0,1,0
19,169,169,4,4,0,1,0
21,176,176,4,4,0,1,0
37,177,177,28,28,0,1,0
33,186,186,25,16,9,4,3
31,195,195,5,1,4,2,1
6,198,198,56,32,24,4,3
39,211,211,1,1,0,1,0
40,212,212,9,9,0,1,0
38,238,238,49,49,0,1,0
2,250,250,23,12,11,3,2
0,251,251,45,45,0,1,0
18,252,252,35,35,0,1,0
15,253,253,1,1,0,1,0
7,258,258,8,8,0,1,0
17,267,267,92,92,0,1,0
3,269,269,17,11,6,2,1
20,288,288,16,16,0,1,0
22,300,300,3,3,0,1,0
4,301,301,1,1,0,1,0
24,308,308,37,37,0,1,0
41,308,308,36,36,0,1,0
16,318,318,23,11,12,2,1
34,342,342,48,20,28,3,2
43,358,358,80,80,0,1,0
9,412,412,108,70,38,3,2
13,425,425,8,8,0,1,0
27,436,436,55,11,44,3,2
11,438,438,6,2,4,2,1
28,439,439,37,33,4,2,1
42,439,439,6,6,0,1,0
32,448,448,31,31,0,1,0
35,454,454,9,3,6,3,2
30,473,473,49,49,0,1,0
10,473,473,41,22,19,2,1
14,484,484,29,29,0,1,0
8,489,489,8,8,0,1,0

4,107,107,44,10,34,3,2
7,124,124,2,2,0,1,0
8,142,142,18,18,0,1,0
10,145,145,1,1,0,1,0
5,168,168,4,4,0,1,0
13,174,174,40,40,0,1,0
12,182,182,35,35,0,1,0
21,183,183,3,3,0,1,0
22,191,191,2,2,0,1,0
14,217,217,12,1,11,2,1
15,217,217,15,5,10,3,2
3,221,221,94,40,54,4,3
16,223,223,4,4,0,1,0
18,233,233,4,1,3,2,1
24,251,251,109,1,108,4,3
20,252,252,74,74,0,1,0
29,256,256,17,13,4,2,1
17,260,260,2,2,0,1,0
9,260,260,4,1,3,2,1
11,268,268,31,31,0,1,0
23,290,290,2,2,0,1,0
30,296,296,16,7,9,4,3
2,301,301,63,63,0,1,0
27,304,304,63,25,38,2,1
1,404,404,10,10,0,1,0
32,410,410,82,25,57,4,3
19,418,418,9,9,0,1,0
28,427,427,18,8,10,2,1
31,452,452,12,12,0,1,0
26,455,455,26,1,25,2,1
6,462,462,35,12,23,4,3
0,478,478,63,6,57,3,2
25,478,478,40,16,24,3,2
33,496,496,176,41,135,4,3

46,110,110,15,11,4,2,1
21,112,112,1,1,0,1,0
48,122,122,19,19,0,1,0
1,137,137,8,8,0,1,0
12,147,147,37,22,15,4,3
34,154,154,25,25,0,1,0
11,188,188,5,2,3,2,1
36,191,191,5,2,3,2,1
6,191,191,1,1,0,1,0
40,198,198,16,16,0,1,0
25,207,207,17,1,16,2,1
22,224,224,21,4,17,2,1
10,225,225,4,4,0,1,0
35,234,234,16,16,0,1,0
29,235,235,1,1,0,1,0
45,249,249,4,4,0,1,0
37,260,260,1,1,0,1,0
4,271,271,14,14,0,1,0
14,275,275,1,1,0,1,0
44,275,275,42,42,0,1,0
7,277,277,6,6,0,1,0
20,282,282,19,8,11,2,1
3,297,297,61,38,23,2,1
26,299,299,13,3,10,3,2
39,300,300,27,27,0,1,0
5,312,312,28,28,0,1,0
51,312,312,14,2,12,4,3
49,323,323,47,47,0,1,0
33,339,339,38,38,0,1,0
38,339,339,35,29,6,2,1
41,368,368,45,45,0,1,0
15,369,369,15,15,0,1,0
0,369,369,23,4,19,2,1
16,376,376,13,13,0,1,0
13,396,396,45,3,42,2,1
31,398,398,32,32,0,1,0
18,400,400,9,5,4,2,1
17,402,402,7,1,6,2,1
30,402,402,1,1,0,1,0
47,405,405,13,13,0,1,0
2,418,418,7,7,0,1,0
28,426,426,3,3,0,1,0
42,431,431,136,34,102,4,3
8,437,437,35,8,27,4,3
9,445,445,65,21,44,2,1
19,451,451,12,3,9,2,1
43,465,465,89,89,0,1,0
50,471,471,29,20,9,4,3
27,476,476,43,1,42,2,1
23,489,489,104,27,77,3,2
32,499,499,13,13,0,1,0
24,500,500,8,8,0,1,0

24,103,103,13,13,0,1,0
17,106,106,13,13,0,1,0
28,109,109,6,6,0,1,0
34,116,116,4,4,0,1,0
35,127,127,4,4,0,1,0
5,135,135,1,1,0,1,0
21,148,148,7,7,0,1,0
1,149,149,3,3,0,1,0
39,151,151,19,19,0,1,0
27,169,169,41,41,0,1,0
8,173,173,16,16,0,1,0
31,189,189,8,8,0,1,0
15,204,204,1,1,0,1,0
7,217,217,9,3,6,2,1
6,226,226,24,24,0,1,0
33,233,233,39,39,0,1,0
25,235,235,38,11,27,4,3
36,243,243,36,36,0,1,0
32,248,248,6,2,4,2,1
19,250,250,35,4,31,2,1
30,257,257,42,19,23,2,1
41,260,260,42,8,34,3,2
43,266,266,21,21,0,1,0
16,274,274,37,7,30,4,3
12,275,275,53,47,6,2,1
40,279,279,29,15,14,2,1
23,319,319,5,5,0,1,0
4,350,350,26,11,15,4,3
11,361,361,18,18,0,1,0
18,366,366,19,10,9,4,3
14,374,374,91,25,66,4,3
37,379,379,4,1,3,2,1
22,391,391,12,4,8,3,2
20,399,399,60,60,0,1,0
26,404,404,5,5,0,1,0
38,424,424,19,10,9,4,3
13,425,425,44,44,0,1,0
42,436,436,67,1,66,4,3
10,443,443,82,82,0,1,0
3,471,471,17,13,4,2,1
9,473,473,41,2,39,3,2
0,485,485,24,14,10,2,1
2,490,490,7,7,0,1,0
29,491,491,81,63,18,3,2

30,107,107,6,6,0,1,0
2,122,122,15,15,0,1,0
15,136,136,6,6,0,1,0
17,140,140,14,14,0,1,0
22,185,185,6,6,0,1,0
20,188,188,15,4,11,2,1
14,226,226,12,3,9,2,1
0,231,231,38,12,26,3,2
33,238,238,8,8,0,1,0
6,255,255,5,5,0,1,0
13,257,257,184,132,52,4,3
16,265,265,3,3,0,1,0
11,279,279,15,15,0,1,0
25,280,280,1,1,0,1,0
19,285,285,8,2,6,3,2
27,308,308,170,95,75,4,3
5,313,313,28,8,20,3,2
21,315,315,37,27,10,3,2
12,323,323,11,2,9,4,3
9,337,337,40,40,0,1,0
10,345,345,3,3,0,1,0
26,357,357,90,90,0,1,0
29,359,359,62,28,34,2,1
4,364,364,51,51,0,1,0
18,379,379,3,3,0,1,0
28,390,390,50,50,0,1,0
32,402,402,31,31,0,1,0
3,408,408,55,16,39,4,3
1,420,420,110,80,30,3,2
23,426,426,56,47,9,4,3
24,429,429,4,4,0,1,0
31,443,443,61,11,50,2,1
7,463,463,17,5,12,4,3
8,478,478,48,48,0,1,0

25,107,107,57,53,4,2,1
31,125,125,8,8,0,1,0
35,126,126,2,2,0,1,0
34,149,149,6,6,0,1,0
11,156,156,12,12,0,1,0
24,163,163,21,21,0,1,0
0,168,168,41,41,0,1,0
8,188,188,40,5,35,2,1
13,197,197,15,15,0,1,0
19,209,209,24,24,0,1,0
7,213,213,2,2,0,1,0
29,213,213,1,1,0,1,0
10,228,228,6,6,0,1,0
9,254,254,79,79,0,1,0
23,263,263,8,8,0,1,0
4,268,268,18,6,12,2,1
36,299,299,78,10,68,4,3
15,318,318,68,38,30,3,2
32,323,323,69,33,36,4,3
30,329,329,13,2,11,2,1
6,332,332,3,3,0,1,0
14,333,333,3,3,0,1,0
5,356,356,58,58,0,1,0
22,370,370,67,16,51,4,3
21,375,375,20,20,0,1,0
2,376,376,40,40,0,1,0
3,378,378,26,26,0,1,0
1,401,401,75,59,16,3,2
20,410,410,15,15,0,1,0
26,424,424,11,11,0,1,0
17,458,458,5,2,3,2,1
27,464,464,22,13,9,4,3
33,465,465,75,75,0,1,0
16,467,467,83,83,0,1,0
12,471,471,20,20,0,1,0
18,475,475,29,29,0,1,0
28,488,488,3,3,0,1,0

46,111,111,2,2,0,1,0
9,115,115,9,4,5,2,1
20,116,116,3,3,0,1,0
28,120,120,5,2,3,2,1
38,129,129,2,2,0,1,0
45,135,135,31,31,0,1,0
1,141,141,4,4,0,1,0
51,150,150,15,15,0,1,0
13,152,152,1,1,0,1,0
48,165,165,30,2,28,3,2
23,192,192,37,3,34,3,2
5,212,212,64,52,12,4,3
52,226,226,3,3,0,1,0
47,227,227,53,46,7,2,1
25,229,229,7,7,0,1,0
12,237,237,14,5,9,2,1
26,244,244,38,38,0,1,0
15,250,250,6,6,0,1,0
6,255,255,57,57,0,1,0
10,256,256,2,2,0,1,0
29,256,256,1,1,0,1,0
42,262,262,20,7,13,2,1
4,272,272,36,14,22,3,2
35,277,277,2,2,0,1,0
49,287,287,104,69,35,2,1
44,287,287,3,3,0,1,0
27,305,305,1,1,0,1,0
24,313,313,4,4,0,1,0
33,326,326,1,1,0,1,0
53,328,328,83,83,0,1,0
18,329,329,1,1,0,1,0
36,330,330,2,2,0,1,0
16,332,332,1,1,0,1,0
31,334,334,9,9,0,1,0
0,342,342,41,41,0,1,0
14,348,348,3,3,0,1,0
34,368,368,65,29,36,4,3
30,383,383,3,3,0,1,0
43,384,384,19,7,12,4,3
8,393,393,16,16,0,1,0
22,396,396,6,6,0,1,0
50,413,413,81,37,44,2,1
2,427,427,29,29,0,1,0
11,435,435,12,4,8,2,1
32,441,441,38,38,0,1,0
40,443,443,1,1,0,1,0
41,457,457,7,7,0,1,0
3,457,457,1,1,0,1,0
17,458,458,5,5,0,1,0
39,463,463,36,22,14,3,2
19,474,474,58,24,34,2,1
37,481,481,8,8,0,1,0
21,489,489,40,23,17,2,1
7,490,490,23,15,8,3,2

27,100,100,5,5,0,1,0
0,105,105,29,29,0,1,0
32,112,112,19,2,17,3,2
15,142,142,1,1,0,1,0
2,154,154,17,17,0,1,0
22,169,169,18,18,0,1,0
1,175,175,3,3,0,1,0
34,179,179,37,37,0,1,0
4,193,193,14,14,0,1,0
18,219,219,24,24,0,1,0
38,232,232,7,1,6,3,2
36,244,244,9,5,4,2,1
12,247,247,16,16,0,1,0
31,262,262,3,3,0,1,0
20,275,275,21,13,8,3,2
13,276,276,2,2,0,1,0
5,283,283,26,4,22,3,2
10,284,284,11,11,0,1,0
37,289,289,8,2,6,2,1
35,292,292,134,42,92,3,2
7,312,312,13,13,0,1,0
19,325,325,199,158,41,2,1
9,326,326,10,10,0,1,0
21,328,328,64,64,0,1,0
17,339,339,7,7,0,1,0
11,339,339,3,3,0,1,0
23,351,351,26,8,18,4,3
39,352,352,18,18,0,1,0
16,366,366,44,17,27,2,1
8,369,369,2,2,0,1,0
24,369,369,50,18,32,3,2
26,374,374,19,19,0,1,0
3,385,385,30,2,28,4,3
28,396,396,72,72,0,1,0
29,407,407,15,12,3,2,1
33,417,417,6,2,4,2,1
25,456,456,46,46,0,1,0
14,456,456,112,64,48,4,3
30,488,488,12,2,10,3,2
6,488,488,21,7,14,3,2

2,100,100,1,1,0,1,0
7,106,106,30,10,20,3,2
36,111,111,4,1,3,2,1
4,113,113,2,2,0,1,0
6,119,119,5,5,0,1,0
31,143,143,37,23,14,2,1
40,170,170,13,13,0,1,0
23,181,181,4,4,0,1,0
20,182,182,26,8,18,3,2
11,188,188,34,14,20,2,1
28,188,188,40,34,6,2,1
10,191,191,25,25,0,1,0
38,195,195,13,13,0,1,0
25,198,198,17,17,0,1,0
39,218,218,54,54,0,1,0
41,221,221,32,18,14,2,1
24,226,226,2,2,0,1,0
16,236,236,4,1,3,2,1
26,242,242,46,46,0,1,0
1,247,247,32,28,4,2,1
0,251,251,2,2,0,1,0
29,264,264,52,52,0,1,0
33,276,276,7,4,3,2,1
18,281,281,35,35,0,1,0
22,321,321,15,1,14,2,1
9,336,336,15,15,0,1,0
35,346,346,63,63,0,1,0
19,354,354,77,77,0,1,0
3,359,359,7,1,6,2,1
27,366,366,13,2,11,2,1
12,366,366,65,45,20,3,2
13,367,367,13,13,0,1,0
21,389,389,62,62,0,1,0
8,391,391,8,8,0,1,0
5,405,405,19,4,15,4,3
42,421,421,21,21,0,1,0
15,429,429,33,33,0,1,0
37,434,434,61,21,40,3,2
14,438,438,1,1,0,1,0
34,441,441,15,2,13,2,1
30,471,471,8,8,0,1,0
17,473,473,32,32,0,1,0
32,486,486,3,3,0,1,0

41,105,105,14,9,5,2,1
31,113,113,16,4,12,3,2
17,119,119,1,1,0,1,0
16,122,122,13,13,0,1,0
10,132,132,10,10,0,1,0
15,134,134,13,3,10,2,1
43,134,134,4,1,3,2,1
30,143,143,13,13,0,1,0
42,157,157,27,27,0,1,0
39,184,184,33,33,0,1,0
44,189,189,22,22,0,1,0
20,216,216,1,1,0,1,0
4,222,222,1,1,0,1,0
9,230,230,17,3,14,2,1
13,232,232,10,7,3,2,1
38,246,246,24,24,0,1,0
6,257,257,17,5,12,4,3
29,271,271,18,12,6,3,2
1,279,279,14,14,0,1,0
36,283,283,28,4,24,4,3
21,286,286,61,61,0,1,0
8,292,292,6,6,0,1,0
24,298,298,18,18,0,1,0
35,303,303,11,3,8,3,2
7,320,320,21,21,0,1,0
5,321,321,91,59,32,3,2
27,321,321,14,14,0,1,0
32,323,323,85,49,36,3,2
40,332,332,93,93,0,1,0
11,343,343,15,6,9,4,3
12,365,365,119,95,24,3,2
37,386,386,14,14,0,1,0
0,386,386,10,3,7,2,1
25,387,387,1,1,0,1,0
22,405,405,10,10,0,1,0
14,411,411,19,19,0,1,0
2,420,420,26,2,24,4,3
19,435,435,28,21,7,2,1
3,437,437,22,22,0,1,0
26,451,451,14,8,6,2,1
18,451,451,47,43,4,2,1
34,458,458,49,49,0,1,0
23,469,469,38,38,0,1,0
33,490,490,26,26,0,1,0
28,490,490,34,22,12,3,2

14,112,112,15,15,0,1,0
8,133,133,14,14,0,1,0
29,134,134,8,8,0,1,0
34,150,150,30,2,28,3,2
30,164,164,5,5,0,1,0
22,166,166,34,34,0,1,0
5,173,173,14,1,13,4,3
16,190,190,13,5,8,3,2
9,192,192,2,2,0,1,0
26,197,197,7,7,0,1,0
25,206,206,15,6,9,2,1
10,214,214,11,2,9,2,1
24,227,227,51,51,0,1,0
28,245,245,3,3,0,1,0
6,271,271,2,2,0,1,0
18,285,285,5,5,0,1,0
2,290,290,105,93,12,4,3
32,303,303,86,86,0,1,0
13,323,323,38,16,22,2,1
1,349,349,26,20,6,2,1
3,358,358,115,7,108,4,3
23,382,382,14,14,0,1,0
4,387,387,64,49,15,2,1
20,389,389,57,57,0,1,0
19,395,395,19,19,0,1,0
31,395,395,8,2,6,3,2
15,399,399,41,7,34,2,1
12,402,402,59,13,46,2,1
36,403,403,20,11,9,4,3
33,419,419,43,28,15,2,1
27,423,423,41,41,0,1,0
7,427,427,57,57,0,1,0
35,427,427,46,46,0,1,0
21,434,434,21,21,0,1,0
17,438,438,103,64,39,4,3
11,451,451,12,5,7,2,1
0,474,474,44,4,40,3,2

33,102,102,2,2,0,1,0
6,107,107,19,19,0,1,0
30,112,112,23,23,0,1,0
10,119,119,36,31,5,2,1
24,134,134,4,4,0,1,0
12,136,136,2,2,0,1,0
8,169,169,24,24,0,1,0
34,179,179,2,2,0,1,0
16,186,186,17,5,12,2,1
29,187,187,12,6,6,2,1
2,199,199,29,3,26,2,1
15,214,214,5,5,0,1,0
9,220,220,50,26,24,4,3
38,225,225,30,8,22,3,2
7,225,225,29,15,14,2,1
3,226,226,36,12,24,3,2
28,250,250,57,57,0,1,0
25,259,259,8,8,0,1,0
37,269,269,1,1,0,1,0
1,271,271,8,8,0,1,0
17,296,296,7,7,0,1,0
27,300,300,15,12,3,2,1
32,304,304,53,53,0,1,0
23,307,307,50,22,28,2,1
5,309,309,2,2,0,1,0
14,309,309,48,42,6,2,1
36,313,313,15,7,8,3,2
20,329,329,74,56,18,2,1
11,330,330,30,7,23,2,1
22,363,363,20,5,15,4,3
18,364,364,38,38,0,1,0
26,380,380,34,34,0,1,0
21,388,388,24,11,13,2,1
13,428,428,24,24,0,1,0
0,433,433,34,34,0,1,0
19,456,456,75,39,36,4,3
35,469,469,29,29,0,1,0
31,475,475,103,77,26,3,2
4,490,490,21,21,0,1,0

16,101,101,7,7,0,1,0
33,111,111,11,11,0,1,0
36,117,117,3,3,0,1,0
8,132,132,7,7,0,1,0
7,142,142,1,1,0,1,0
22,149,149,44,44,0,1,0
14,159,159,29,17,12,4,3
28,168,168,19,11,8,3,2
3,174,174,4,1,3,2,1
24,177,177,34,5,29,2,1
1,188,188,39,17,22,3,2
18,190,190,30,30,0,1,0
37,194,194,20,4,16,2,1
13,201,201,5,5,0,1,0
39,206,206,18,13,5,2,1
32,240,240,49,49,0,1,0
26,247,247,2,2,0,1,0
17,249,249,8,1,7,2,1
15,250,250,1,1,0,1,0
4,251,251,19,19,0,1,0
2,257,257,44,44,0,1,0
35,264,264,8,2,6,3,2
6,274,274,108,108,0,1,0
12,292,292,5,5,0,1,0
0,298,298,1,1,0,1,0
27,298,298,6,6,0,1,0
25,333,333,20,20,0,1,0
19,345,345,25,15,10,3,2
20,376,376,18,12,6,2,1
31,378,378,13,13,0,1,0
34,384,384,13,5,8,3,2
38,392,392,27,27,0,1,0
10,425,425,28,16,12,2,1
29,464,464,33,33,0,1,0
23,465,465,93,47,46,4,3
9,467,467,6,2,4,2,1
11,491,491,186,126,60,3,2
40,492,492,27,27,0,1,0
21,492,492,120,51,69,3,2
30,493,493,44,44,0,1,0
5,499,499,1,1,0,1,0

35,119,119,1,1,0,1,0
8,134,134,6,3,3,2,1
38,143,143,26,26,0,1,0
0,150,150,31,31,0,1,0
12,166,166,3,3,0,1,0
15,167,167,48,32,16,2,1
14,167,167,1,1,0,1,0
42,170,170,2,2,0,1,0
37,171,171,3,3,0,1,0
13,173,173,18,18,0,1,0
26,178,178,10,7,3,2,1
7,183,183,6,6,0,1,0
31,196,196,89,89,0,1,0
28,200,200,37,37,0,1,0
10,202,202,6,6,0,1,0
21,206,206,36,36,0,1,0
40,221,221,55,15,40,2,1
5,222,222,5,5,0,1,0
3,242,242,6,6,0,1,0
30,250,250,21,9,12,4,3
2,255,255,24,24,0,1,0
34,277,277,32,2,30,3,2
41,283,283,2,2,0,1,0
18,289,289,1,1,0,1,0
19,294,294,27,27,0,1,0
23,299,299,4,4,0,1,0
25,341,341,18,18,0,1,0
29,345,345,7,3,4,2,1
4,348,348,5,5,0,1,0
36,350,350,25,1,24,3,2
39,355,355,88,52,36,2,1
20,364,364,55,50,5,2,1
1,374,374,11,11,0,1,0
27,385,385,5,5,0,1,0
33,392,392,9,9,0,1,0
32,393,393,61,13,48,2,1
9,399,399,10,4,6,3,2
6,422,422,5,5,0,1,0
16,450,450,116,85,31,2,1
17,460,460,118,28,90,3,2
22,493,493,1,1,0,1,0
11,496,496,56,31,25,2,1
24,497,497,35,35,0,1,0

11,100,100,1,1,0,1,0
21,103,103,6,6,0,1,0
5,109,109,2,2,0,1,0
14,129,129,43,43,0,1,0
9,130,130,13,2,11,2,1
2,141,141,10,10,0,1,0
18,142,142,5,5,0,1,0
32,150,150,8,8,0,1,0
27,156,156,35,35,0,1,0
4,182,182,6,6,0,1,0
3,200,200,4,4,0,1,0
6,237,237,12,12,0,1,0
35,241,241,22,22,0,1,0
37,254,254,54,54,0,1,0
22,259,259,23,8,15,4,3
12,261,261,76,22,54,3,2
20,289,289,12,12,0,1,0
28,289,289,8,8,0,1,0
41,290,290,3,3,0,1,0
1,301,301,37,37,0,1,0
40,308,308,47,43,4,2,1
30,315,315,65,59,6,3,2
29,316,316,23,23,0,1,0
36,343,343,36,36,0,1,0
31,349,349,8,8,0,1,0
7,352,352,30,9,21,2,1
15,359,359,13,13,0,1,0
38,362,362,62,49,13,2,1
13,376,376,16,16,0,1,0
8,383,383,3,3,0,1,0
23,387,387,20,6,14,2,1
10,410,410,70,12,58,4,3
17,417,417,64,64,0,1,0
16,418,418,16,16,0,1,0
33,428,428,69,7,62,4,3
26,443,443,27,27,0,1,0
0,447,447,80,80,0,1,0
19,454,454,49,49,0,1,0
39,463,463,92,24,68,3,2
24,465,465,4,4,0,1,0
34,467,467,27,27,0,1,0
25,490,490,26,3,23,3,2

34,102,102,7,7,0,1,0
6,106,106,17,17,0,1,0
11,107,107,40,24,16,3,2
22,115,115,15,2,13,2,1
18,128,128,6,6,0,1,0
0,129,129,1,1,0,1,0
19,142,142,28,28,0,1,0
25,180,180,73,53,20,3,2
33,181,181,3,3,0,1,0
20,213,213,31,31,0,1,0
32,221,221,13,13,0,1,0
30,228,228,28,28,0,1,0
5,234,234,18,9,9,4,3
7,243,243,39,39,0,1,0
12,259,259,62,6,56,4,3
16,262,262,31,17,14,3,2
35,276,276,28,28,0,1,0
1,281,281,2,2,0,1,0
36,287,287,1,1,0,1,0
29,293,293,9,3,6,2,1
2,305,305,2,2,0,1,0
28,315,315,4,1,3,2,1
13,352,352,38,8,30,2,1
17,367,367,35,35,0,1,0
9,371,371,29,7,22,2,1
15,387,387,36,36,0,1,0
26,391,391,29,29,0,1,0
14,394,394,30,18,12,2,1
31,396,396,6,6,0,1,0
24,405,405,8,4,4,2,1
3,408,408,124,13,111,4,3
4,408,408,13,2,11,2,1
21,411,411,34,20,14,3,2
8,432,432,69,9,60,3,2
27,441,441,145,133,12,4,3
10,446,446,1,1,0,1,0
23,465,465,36,36,0,1,0

38,101,101,8,2,6,3,2
25,123,123,1,1,0,1,0
42,125,125,21,21,0,1,0
34,146,146,10,2,8,2,1
27,148,148,4,4,0,1,0
12,149,149,36,36,0,1,0
6,156,156,15,15,0,1,0
29,157,157,12,3,9,2,1
3,163,163,2,2,0,1,0
28,169,169,16,16,0,1,0
8,183,183,9,9,0,1,0
32,200,200,5,5,0,1,0
37,202,202,34,26,8,2,1
10,218,218,19,16,3,2,1
33,219,219,15,7,8,2,1
2,223,223,8,8,0,1,0
7,251,251,9,9,0,1,0
22,254,254,66,20,46,3,2
16,263,263,10,10,0,1,0
19,271,271,7,2,5,2,1
24,306,306,93,12,81,4,3
31,326,326,22,22,0,1,0
23,328,328,7,7,0,1,0
15,336,336,10,10,0,1,0
41,341,341,92,92,0,1,0
18,343,343,3,3,0,1,0
36,346,346,9,9,0,1,0
4,350,350,17,17,0,1,0
1,351,351,167,149,18,2,1
17,363,363,81,54,27,4,3
5,385,385,24,1,23,3,2
9,387,387,1,1,0,1,0
21,403,403,32,32,0,1,0
20,409,409,11,11,0,1,0
11,424,424,8,8,0,1,0
14,431,431,10,7,3,2,1
35,433,433,13,5,8,3,2
13,444,444,8,1,7,2,1
26,448,448,122,122,0,1,0
40,454,454,102,27,75,4,3
39,472,472,26,4,22,2,1
0,482,482,49,11,38,3,2
30,491,491,1,1,0,1,0

13,108,108,3,3,0,1,0
4,121,121,66,50,16,3,2
5,130,130,18,2,16,3,2
0,137,137,34,34,0,1,0
1,139,139,32,32,0,1,0
17,144,144,7,4,3,2,1
25,168,168,1,1,0,1,0
10,172,172,7,7,0,1,0
16,203,203,6,6,0,1,0
29,214,214,63,63,0,1,0
8,241,241,3,3,0,1,0
31,264,264,66,40,26,3,2
22,265,265,78,78,0,1,0
15,277,277,58,22,36,2,1
9,282,282,24,18,6,2,1
12,283,283,6,6,0,1,0
11,286,286,28,8,20,3,2
6,303,303,68,50,18,2,1
26,308,308,33,33,0,1,0
20,328,328,10,10,0,1,0
23,346,346,57,57,0,1,0
14,351,351,11,11,0,1,0
19,361,361,6,6,0,1,0
24,364,364,21,21,0,1,0
28,399,399,32,5,27,2,1
3,412,412,70,6,64,4,3
21,418,418,13,13,0,1,0
18,432,432,28,28,0,1,0
30,432,432,37,11,26,3,2
27,440,440,84,33,51,4,3
7,444,444,5,1,4,2,1
2,462,462,92,60,32,2,1

25,100,100,5,1,4,2,1
23,101,101,14,4,10,2,1
29,104,104,7,1,6,3,2
8,106,106,8,8,0,1,0
20,108,108,1,1,0,1,0
30,110,110,1,1,0,1,0
3,128,128,2,2,0,1,0
37,145,145,12,12,0,1,0
40,150,150,25,25,0,1,0
43,154,154,3,3,0,1,0
35,156,156,22,11,11,2,1
15,175,175,12,12,0,1,0
12,175,175,3,3,0,1,0
18,175,175,4,4,0,1,0
34,184,184,6,6,0,1,0
14,197,197,26,26,0,1,0
33,208,208,53,53,0,1,0
36,208,208,35,25,10,2,1
9,213,213,9,9,0,1,0
31,219,219,29,17,12,2,1
2,222,222,15,15,0,1,0
22,230,230,50,50,0,1,0
6,235,235,49,49,0,1,0
24,266,266,11,6,5,2,1
16,288,288,12,12,0,1,0
26,293,293,4,4,0,1,0
21,295,295,43,34,9,2,1
38,312,312,102,88,14,3,2
32,312,312,35,35,0,1,0
27,324,324,19,7,12,2,1
4,331,331,51,21,30,2,1
13,334,334,70,49,21,4,3
1,335,335,19,1,18,2,1
19,336,336,17,14,3,2,1
17,364,364,17,11,6,2,1
41,388,388,8,2,6,2,1
28,393,393,92,25,67,4,3
11,398,398,22,4,18,3,2
39,408,408,11,11,0,1,0
44,413,413,34,34,0,1,0
7,420,420,6,6,0,1,0
10,450,450,18,18,0,1,0
5,459,459,42,4,38,3,2
0,468,468,18,18,0,1,0
42,468,468,26,26,0,1,0

34,118,118,4,4,0,1,0
14,118,118,15,10,5,2,1
18,140,140,29,17,12,2,1
12,149,149,14,5,9,2,1
17,157,157,49,49,0,1,0
32,160,160,25,25,0,1,0
15,161,161,11,3,8,2,1
4,176,176,56,56,0,1,0
26,196,196,2,2,0,1,0
9,197,197,6,2,4,2,1
6,200,200,3,3,0,1,0
2,212,212,4,4,0,1,0
35,216,216,62,10,52,4,3
24,219,219,2,2,0,1,0
31,222,222,13,6,7,2,1
19,253,253,14,14,0,1,0
1,278,278,17,3,14,2,1
13,295,295,37,37,0,1,0
11,304,304,56,35,21,2,1
16,308,308,34,34,0,1,0
8,318,318,6,6,0,1,0
3,329,329,63,33,30,3,2
5,343,343,61,38,23,2,1
30,365,365,42,27,15,4,3
25,371,371,33,33,0,1,0
7,397,397,2,2,0,1,0
20,420,420,45,45,0,1,0
0,430,430,121,67,54,4,3
21,444,444,7,7,0,1,0
33,451,451,35,35,0,1,0
22,457,457,33,3,30,2,1
28,471,471,45,42,3,2,1
10,484,484,137,26,111,4,3
27,486,486,62,62,0,1,0
23,490,490,5,2,3,2,1
29,490,490,43,43,0,1,0

29,106,106,6,6,0,1,0
47,114,114,33,33,0,1,0
26,117,117,6,6,0,1,0
10,119,119,7,2,5,2,1
17,123,123,4,1,3,2,1
27,128,128,14,14,0,1,0
28,130,130,7,7,0,1,0
2,134,134,24,18,6,3,2
40,148,148,6,1,5,2,1
15,171,171,2,2,0,1,0
31,182,182,3,3,0,1,0
23,195,195,21,12,9,4,3
13,201,201,20,20,0,1,0
48,204,204,11,11,0,1,0
0,214,214,1,1,0,1,0
32,221,221,5,5,0,1,0
14,233,233,27,10,17,2,1
44,233,233,3,3,0,1,0
36,237,237,18,18,0,1,0
20,266,266,33,1,32,3,2
42,267,267,2,2,0,1,0
38,272,272,26,14,12,3,2
37,278,278,32,1,31,4,3
21,287,287,16,4,12,3,2
5,298,298,1,1,0,1,0
34,314,314,10,10,0,1,0
24,329,329,15,15,0,1,0
16,335,335,1,1,0,1,0
46,338,338,94,90,4,2,1
50,339,339,119,41,78,3,2
8,341,341,14,14,0,1,0
49,341,341,28,14,14,3,2
43,352,352,6,6,0,1,0
3,373,373,1,1,0,1,0
12,379,379,31,22,9,4,3
25,396,396,26,26,0,1,0
18,398,398,13,5,8,3,2
1,403,403,52,33,19,2,1
45,411,411,14,6,8,2,1
6,424,424,2,2,0,1,0
7,426,426,23,23,0,1,0
30,449,449,79,79,0,1,0
22,456,456,5,5,0,1,0
9,456,456,70,49,21,4,3
19,460,460,16,7,9,4,3
11,466,466,21,6,15,3,2
4,472,472,27,27,0,1,0
33,479,479,15,12,3,2,1
41,481,481,57,29,28,2,1
35,489,489,150,126,24,4,3
39,500,500,27,27,0,1,0

9,103,103,11,11,0,1,0
21,104,104,7,7,0,1,0
4,108,108,13,13,0,1,0
11,115,115,20,20,0,1,0
27,146,146,18,2,16,3,2
33,158,158,2,2,0,1,0
19,162,162,59,59,0,1,0
32,172,172,5,5,0,1,0
31,183,183,21,21,0,1,0
3,184,184,10,1,9,4,3
5,194,194,11,11,0,1,0
12,198,198,18,18,0,1,0
6,232,232,5,5,0,1,0
13,233,233,20,20,0,1,0
1,237,237,76,43,33,4,3
17,242,242,12,12,0,1,0
16,256,256,26,2,24,4,3
30,283,283,12,4,8,2,1
22,290,290,74,74,0,1,0
0,318,318,18,18,0,1,0
20,320,320,7,7,0,1,0
14,321,321,5,2,3,2,1
7,336,336,73,7,66,4,3
25,347,347,50,50,0,1,0
18,350,350,32,32,0,1,0
23,352,352,79,3,76,3,2
8,353,353,107,107,0,1,0
2,353,353,133,105,28,2,1
24,372,372,50,50,0,1,0
26,376,376,13,13,0,1,0
15,401,401,62,34,28,2,1
29,422,422,19,11,8,3,2
10,440,440,7,7,0,1,0
28,458,458,8,3,5,2,1

32,101,101,10,10,0,1,0
1,103,103,9,9,0,1,0
6,116,116,4,4,0,1,0
3,143,143,43,43,0,1,0
30,150,150,5,5,0,1,0
25,157,157,31,31,0,1,0
38,164,164,14,14,0,1,0
28,172,172,52,35,17,2,1
20,175,175,4,4,0,1,0
10,175,175,19,19,0,1,0
4,176,176,44,44,0,1,0
11,189,189,9,3,6,2,1
16,215,215,5,2,3,2,1
37,231,231,10,10,0,1,0
12,263,263,2,2,0,1,0
34,299,299,93,60,33,2,1
5,312,312,23,23,0,1,0
17,313,313,72,15,57,4,3
14,313,313,10,5,5,2,1
22,325,325,51,51,0,1,0
13,326,326,19,19,0,1,0
8,357,357,77,77,0,1,0
7,365,365,29,21,8,2,1
0,368,368,1,1,0,1,0
40,389,389,9,6,3,2,1
23,395,395,36,17,19,4,3
35,401,401,41,41,0,1,0
29,406,406,1,1,0,1,0
27,407,407,1,1,0,1,0
19,410,410,5,5,0,1,0
33,413,413,11,7,4,2,1
26,416,416,38,38,0,1,0
36,417,417,5,5,0,1,0
31,428,428,3,3,0,1,0
9,431,431,16,16,0,1,0
2,433,433,19,19,0,1,0
21,456,456,32,12,20,2,1
15,480,480,121,60,61,3,2
18,482,482,41,2,39,4,3
24,498,498,178,31,147,4,3
39,500,500,14,14,0,1,0

9,101,101,31,31,0,1,0
27,113,113,9,9,0,1,0
7,136,136,21,21,0,1,0
3,139,139,5,2,3,2,1
21,140,140,9,9,0,1,0
5,149,149,50,26,24,3,2
15,175,175,8,8,0,1,0
29,175,175,22,22,0,1,0
1,181,181,20,20,0,1,0
11,182,182,5,5,0,1,0
2,195,195,15,7,8,2,1
20,215,215,4,4,0,1,0
0,221,221,17,17,0,1,0
32,228,228,3,3,0,1,0
13,256,256,6,6,0,1,0
24,257,257,2,2,0,1,0
25,278,278,83,23,60,3,2
35,279,279,33,14,19,2,1
16,283,283,8,8,0,1,0
17,290,290,17,9,8,2,1
30,294,294,31,31,0,1,0
26,324,324,128,82,46,2,1
18,327,327,30,5,25,3,2
22,329,329,15,8,7,2,1
12,329,329,62,62,0,1,0
28,349,349,31,31,0,1,0
8,374,374,16,13,3,2,1
4,381,381,5,5,0,1,0
33,386,386,87,87,0,1,0
19,404,404,71,71,0,1,0
14,426,426,102,102,0,1,0
34,428,428,2,2,0,1,0
31,433,433,16,16,0,1,0
23,441,441,14,14,0,1,0
36,451,451,27,11,16,3,2
10,464,464,96,15,81,4,3
6,481,481,43,4,39,4,3

27,110,110,20,20,0,1,0
1,115,115,2,2,0,1,0
18,116,116,7,7,0,1,0
3,163,163,2,2,0,1,0
38,178,178,15,15,0,1,0
35,189,189,25,25,0,1,0
36,209,209,19,7,12,4,3
32,215,215,15,5,10,3,2
14,261,261,34,27,7,2,1
23,271,271,73,13,60,3,2
10,271,271,41,5,36,4,3
6,285,285,15,15,0,1,0
25,308,308,24,16,8,2,1
17,312,312,19,19,0,1,0
2,328,328,10,10,0,1,0
30,329,329,102,50,52,4,3
26,331,331,3,3,0,1,0
15,332,332,103,103,0,1,0
29,345,345,8,1,7,2,1
21,356,356,20,11,9,2,1
12,360,360,7,1,6,3,2
4,369,369,31,5,26,3,2
16,371,371,52,52,0,1,0
37,381,381,2,2,0,1,0
9,383,383,20,14,6,2,1
33,393,393,39,3,36,4,3
31,405,405,66,30,36,2,1
39,411,411,10,10,0,1,0
24,436,436,56,56,0,1,0
0,436,436,48,3,45,4,3
34,438,438,22,22,0,1,0
13,440,440,74,74,0,1,0
20,447,447,39,39,0,1,0
5,454,454,28,19,9,4,3
7,472,472,1,1,0,1,0
22,475,475,33,7,26,3,2
28,477,477,57,57,0,1,0
40,480,480,33,33,0,1,0
8,482,482,26,26,0,1,0
19,488,488,92,59,33,2,1
11,500,500,104,6,98,3,2

15,102,102,3,3,0,1,0
10,133,133,1,1,0,1,0
14,136,136,28,6,22,3,2
35,148,148,16,2,14,3,2
8,149,149,12,2,10,2,1
34,160,160,38,9,29,2,1
36,167,167,1,1,0,1,0
3,168,168,6,6,0,1,0
33,170,170,20,4,16,2,1
0,174,174,26,2,24,4,3
41,181,181,4,4,0,1,0
38,188,188,72,65,7,2,1
20,207,207,5,5,0,1,0
4,215,215,19,14,5,2,1
25,237,237,30,30,0,1,0
30,272,272,17,17,0,1,0
13,274,274,43,43,0,1,0
32,280,280,2,2,0,1,0
31,290,290,28,7,21,2,1
22,304,304,4,1,3,2,1
12,305,305,46,36,10,3,2
27,308,308,54,54,0,1,0
19,314,314,10,2,8,3,2
7,326,326,12,4,8,2,1
42,326,326,94,94,0,1,0
24,334,334,28,28,0,1,0
17,355,355,100,100,0,1,0
9,383,383,37,37,0,1,0
18,386,386,15,11,4,2,1
26,401,401,41,1,40,2,1
39,415,415,5,5,0,1,0
37,425,425,34,19,15,4,3
1,449,449,1,1,0,1,0
11,462,462,15,9,6,2,1
6,464,464,48,48,0,1,0
43,467,467,16,1,15,2,1
29,470,470,19,19,0,1,0
23,471,471,12,12,0,1,0
28,482,482,21,21,0,1,0
5,485,485,13,10,3,2,1
40,491,491,7,4,3,2,1
2,492,492,80,62,18,3,2
21,499,499,85,17,68,3,2
16,499,499,25,8,17,2,1

12,113,113,1,1,0,1,0
28,117,117,4,4,0,1,0
23,121,121,6,2,4,2,1
22,143,143,5,2,3,2,1
20,151,151,9,1,8,3,2
32,154,154,9,9,0,1,0
34,155,155,15,15,0,1,0
48,172,172,4,1,3,2,1
1,174,174,2,2,0,1,0
36,193,193,39,39,0,1,0
3,198,198,61,23,38,2,1
11,202,202,3,3,0,1,0
24,202,202,7,1,6,3,2
21,206,206,7,7,0,1,0
30,206,206,31,31,0,1,0
43,233,233,20,20,0,1,0
47,234,234,10,6,4,2,1
14,244,244,13,5,8,2,1
37,252,252,47,16,31,4,3
39,297,297,26,26,0,1,0
45,300,300,16,1,15,2,1
33,302,302,52,22,30,4,3
13,319,319,20,20,0,1,0
29,341,341,27,27,0,1,0
7,343,343,39,15,24,3,2
15,346,346,11,11,0,1,0
6,350,350,31,31,0,1,0
17,355,355,17,11,6,3,2
31,367,367,28,2,26,3,2
5,369,369,34,8,26,4,3
9,370,370,45,25,20,2,1
49,377,377,51,51,0,1,0
18,384,384,13,13,0,1,0
19,390,390,3,3,0,1,0
40,395,395,15,15,0,1,0
0,401,401,41,8,33,4,3
44,406,406,39,9,30,4,3
42,442,442,133,28,105,4,3
16,452,452,20,2,18,2,1
25,453,453,3,3,0,1,0
38,460,460,23,23,0,1,0
27,460,460,76,54,22,2,1
35,468,468,14,14,0,1,0
2,476,476,55,39,16,2,1
41,479,479,70,5,65,4,3
46,488,488,5,5,0,1,0
26,488,488,35,31,4,2,1
8,489,489,5,5,0,1,0
10,492,492,45,45,0,1,0
4,494,494,36,2,34,2,1

6,126,126,30,30,0,1,0
35,126,126,48,48,0,1,0
32,132,132,12,12,0,1,0
4,155,155,5,1,4,2,1
10,159,159,14,14,0,1,0
33,178,178,39,28,11,4,3
18,186,186,17,17,0,1,0
30,214,214,9,3,6,3,2
19,233,233,1,1,0,1,0
22,246,246,14,6,8,3,2
11,248,248,18,18,0,1,0
40,262,262,12,2,10,3,2
3,266,266,1,1,0,1,0
21,277,277,20,5,15,2,1
14,280,280,6,6,0,1,0
5,295,295,31,17,14,2,1
25,305,305,18,3,15,2,1
24,323,323,6,6,0,1,0
39,328,328,28,4,24,4,3
41,331,331,38,6,32,2,1
15,343,343,28,13,15,4,3
36,358,358,55,55,0,1,0
9,362,362,25,15,10,2,1
16,372,372,12,12,0,1,0
31,375,375,14,2,12,4,3
7,379,379,1,1,0,1,0
37,387,387,63,45,18,4,3
28,389,389,34,14,20,3,2
20,390,390,46,30,16,2,1
34,391,391,15,12,3,2,1
13,395,395,3,3,0,1,0
12,414,414,36,36,0,1,0
38,414,414,76,10,66,4,3
2,422,422,31,3,28,3,2
26,434,434,28,28,0,1,0
8,441,441,67,34,33,4,3
0,446,446,219,219,0,1,0
1,448,448,15,15,0,1,0
29,448,448,2,2,0,1,0
17,450,450,56,56,0,1,0
27,462,462,76,16,60,3,2
23,492,492,12,12,0,1,0

8,116,116,17,17,0,1,0
15,120,120,6,3,3,2,1
18,125,125,2,2,0,1,0
33,133,133,9,9,0,1,0
28,133,133,19,7,12,3,2
25,136,136,1,1,0,1,0
11,137,137,11,5,6,2,1
17,149,149,14,14,0,1,0
41,152,152,48,48,0,1,0
37,153,153,2,2,0,1,0
9,155,155,1,1,0,1,0
39,158,158,8,8,0,1,0
31,174,174,7,7,0,1,0
30,183,183,8,5,3,2,1
0,192,192,9,1,8,3,2
38,196,196,31,19,12,3,2
19,203,203,10,10,0,1,0
3,207,207,43,15,28,3,2
14,239,239,2,2,0,1,0
7,262,262,28,28,0,1,0
10,266,266,1,1,0,1,0
12,280,280,83,83,0,1,0
36,281,281,3,3,0,1,0
34,290,290,20,6,14,2,1
24,292,292,21,13,8,3,2
5,296,296,2,2,0,1,0
29,308,308,7,2,5,2,1
45,309,309,17,3,14,3,2
44,309,309,42,42,0,1,0
16,316,316,7,4,3,2,1
13,336,336,7,7,0,1,0
35,365,365,124,124,0,1,0
42,365,365,48,48,0,1,0
23,379,379,28,28,0,1,0
46,391,391,52,40,12,2,1
1,392,392,20,4,16,3,2
21,395,395,10,2,8,3,2
6,398,398,63,36,27,4,3
22,416,416,43,43,0,1,0
27,424,424,2,2,0,1,0
2,428,428,61,49,12,2,1
20,430,430,44,11,33,2,1
43,437,437,10,10,0,1,0
4,458,458,13,1,12,3,2
26,459,459,32,32,0,1,0
47,479,479,12,12,0,1,0
32,481,481,82,82,0,1,0
40,495,495,45,21,24,2,1

13,102,102,1,1,0,1,0
6,109,109,1,1,0,1,0
9,124,124,7,7,0,1,0
37,130,130,21,21,0,1,0
39,142,142,14,4,10,2,1
40,147,147,12,12,0,1,0
8,149,149,1,1,0,1,0
34,155,155,39,6,33,2,1
22,164,164,4,4,0,1,0
45,169,169,31,2,29,3,2
3,184,184,12,4,8,2,1
23,187,187,67,67,0,1,0
24,188,188,1,1,0,1,0
2,194,194,2,2,0,1,0
0,199,199,26,18,8,2,1
35,204,204,17,17,0,1,0
36,228,228,8,2,6,3,2
42,249,249,28,2,26,3,2
20,253,253,10,1,9,4,3
44,269,269,7,7,0,1,0
43,293,293,5,5,0,1,0
17,294,294,41,41,0,1,0
7,298,298,38,26,12,4,3
16,300,300,23,1,22,2,1
31,317,317,14,14,0,1,0
5,326,326,20,3,17,2,1
1,333,333,4,4,0,1,0
46,344,344,102,102,0,1,0
32,347,347,19,19,0,1,0
4,370,370,3,3,0,1,0
29,370,370,44,41,3,2,1
19,375,375,48,5,43,4,3
25,380,380,39,39,0,1,0
30,383,383,1,1,0,1,0
47,389,389,19,19,0,1,0
27,394,394,41,21,20,2,1
12,394,394,12,12,0,1,0
21,396,396,46,4,42,2,1
11,431,431,16,3,13,2,1
26,432,432,11,11,0,1,0
10,433,433,33,7,26,3,2
14,439,439,34,34,0,1,0
41,443,443,71,41,30,3,2
15,444,444,37,37,0,1,0
33,468,468,14,14,0,1,0
28,487,487,50,4,46,2,1
38,491,491,64,64,0,1,0
18,498,498,40,40,0,1,0

22,110,110,7,7,0,1,0
6,111,111,2,2,0,1,0
19,113,113,22,22,0,1,0
20,134,134,39,39,0,1,0
3,137,137,1,1,0,1,0
21,142,142,27,3,24,2,1
30,156,156,34,5,29,2,1
18,167,167,1,1,0,1,0
34,170,170,1,1,0,1,0
33,205,205,91,11,80,3,2
26,211,211,8,8,0,1,0
10,218,218,43,43,0,1,0
4,239,239,24,24,0,1,0
16,250,250,14,14,0,1,0
11,253,253,43,43,0,1,0
31,261,261,44,23,21,4,3
12,269,269,28,3,25,4,3
5,293,293,2,2,0,1,0
23,304,304,48,48,0,1,0
35,310,310,16,16,0,1,0
28,330,330,1,1,0,1,0
9,343,343,47,47,0,1,0
29,350,350,4,4,0,1,0
13,383,383,56,10,46,2,1
8,390,390,38,6,32,3,2
14,403,403,12,3,9,4,3
24,414,414,6,3,3,2,1
32,420,420,36,19,17,4,3
25,425,425,9,9,0,1,0
27,428,428,3,3,0,1,0
7,433,433,81,81,0,1,0
15,443,443,230,128,102,4,3
2,464,464,1,1,0,1,0
17,469,469,7,2,5,2,1
1,481,481,60,43,17,2,1
0,500,500,77,59,18,4,3

34,125,125,7,1,6,3,2
30,157,157,5,5,0,1,0
17,159,159,29,29,0,1,0
29,161,161,22,13,9,4,3
21,169,169,43,43,0,1,0
26,188,188,21,21,0,1,0
8,192,192,71,5,66,4,3
0,193,193,39,31,8,2,1
14,193,193,7,7,0,1,0
7,202,202,2,2,0,1,0
13,204,204,16,12,4,2,1
15,214,214,20,3,17,2,1
33,215,215,12,12,0,1,0
19,216,216,36,15,21,4,3
4,218,218,20,20,0,1,0
1,220,220,13,13,0,1,0
2,230,230,91,91,0,1,0
28,231,231,2,2,0,1,0
12,259,259,37,37,0,1,0
35,281,281,24,24,0,1,0
25,293,293,38,26,12,2,1
11,321,321,31,31,0,1,0
5,328,328,40,40,0,1,0
32,330,330,28,12,16,2,1
20,351,351,59,33,26,2,1
16,351,351,40,5,35,2,1
22,358,358,32,11,21,4,3
10,382,382,17,17,0,1,0
18,396,396,18,7,11,2,1
3,420,420,8,3,5,2,1
9,446,446,9,3,6,3,2
23,451,451,54,45,9,4,3
27,477,477,19,1,18,4,3
24,478,478,30,30,0,1,0
31,481,481,53,53,0,1,0
6,488,488,107,37,70,3,2

29,112,112,22,11,11,2,1
8,120,120,1,1,0,1,0
22,138,138,29,3,26,2,1
36,148,148,8,8,0,1,0
38,158,158,17,17,0,1,0
25,165,165,13,13,0,1,0
14,166,166,2,2,0,1,0
6,218,218,30,30,0,1,0
4,232,232,35,22,13,3,2
30,250,250,31,13,18,2,1
33,255,255,21,11,10,3,2
1,259,259,14,4,10,2,1
19,264,264,1,1,0,1,0
7,269,269,27,15,12,4,3
5,296,296,11,6,5,2,1
21,296,296,70,23,47,2,1
11,310,310,63,63,0,1,0
26,311,311,12,12,0,1,0
18,325,325,56,33,23,2,1
9,329,329,17,17,0,1,0
2,344,344,7,1,6,3,2
15,350,350,69,27,42,4,3
13,365,365,68,31,37,3,2
3,365,365,19,13,6,2,1
35,370,370,25,19,6,2,1
24,374,374,6,1,5,2,1
34,381,381,14,1,13,3,2
28,382,382,55,55,0,1,0
20,385,385,46,6,40,2,1
23,396,396,7,1,6,2,1
27,399,399,128,80,48,3,2
32,401,401,52,43,9,4,3
17,411,411,52,52,0,1,0
31,432,432,8,8,0,1,0
12,440,440,24,10,14,2,1
16,444,444,4,4,0,1,0
10,450,450,66,38,28,3,2
0,481,481,136,72,64,4,3
37,494,494,19,19,0,1,0

38,112,112,1,1,0,1,0
11,126,126,1,1,0,1,0
30,127,127,2,2,0,1,0
43,128,128,33,33,0,1,0
18,133,133,22,22,0,1,0
48,133,133,7,1,6,2,1
33,141,141,7,7,0,1,0
5,142,142,3,3,0,1,0
31,143,143,12,12,0,1,0
20,152,152,2,2,0,1,0
44,157,157,35,18,17,2,1
19,169,169,18,18,0,1,0
16,172,172,2,2,0,1,0
22,179,179,10,10,0,1,0
10,207,207,17,1,16,3,2
36,207,207,2,2,0,1,0
23,209,209,13,13,0,1,0
28,216,216,16,16,0,1,0
37,228,228,19,19,0,1,0
24,229,229,34,34,0,1,0
29,236,236,13,4,9,2,1
14,251,251,11,3,8,2,1
40,268,268,6,6,0,1,0
45,288,288,5,5,0,1,0
0,301,301,28,16,12,4,3
12,301,301,40,31,9,4,3
7,308,308,7,7,0,1,0
41,309,309,7,7,0,1,0
42,320,320,33,19,14,2,1
1,331,331,45,45,0,1,0
46,352,352,99,99,0,1,0
3,358,358,46,46,0,1,0
21,363,363,46,46,0,1,0
9,367,367,12,12,0,1,0
17,388,388,51,11,40,4,3
32,394,394,13,3,10,2,1
47,422,422,57,27,30,4,3
39,435,435,79,19,60,3,2
13,438,438,8,4,4,2,1
15,443,443,58,58,0,1,0
8,443,443,30,1,29,2,1
26,445,445,6,2,4,2,1
27,446,446,5,5,0,1,0
34,457,457,178,178,0,1,0
2,472,472,8,8,0,1,0
6,475,475,1,1,0,1,0
4,476,476,64,13,51,3,2
25,494,494,5,5,0,1,0
35,500,500,13,5,8,2,1

2,112,112,3,3,0,1,0
12,114,114,28,28,0,1,0
30,157,157,13,4,9,4,3
8,160,160,34,26,8,2,1
32,163,163,12,12,0,1,0
1,177,177,14,7,7,2,1
24,191,191,6,6,0,1,0
18,200,200,21,21,0,1,0
0,220,220,23,23,0,1,0
14,225,225,7,7,0,1,0
13,251,251,50,38,12,2,1
5,285,285,30,30,0,1,0
31,290,290,30,12,18,2,1
25,306,306,22,22,0,1,0
20,311,311,9,9,0,1,0
23,315,315,2,2,0,1,0
4,325,325,64,9,55,4,3
15,325,325,175,175,0,1,0
9,327,327,70,70,0,1,0
16,356,356,18,9,9,2,1
6,365,365,153,42,111,4,3
19,369,369,7,1,6,3,2
7,387,387,26,9,17,2,1
17,403,403,69,52,17,2,1
3,404,404,109,19,90,4,3
29,405,405,98,72,26,2,1
11,410,410,8,2,6,3,2
22,417,417,32,32,0,1,0
26,417,417,12,12,0,1,0
27,450,450,8,2,6,2,1
21,470,470,56,56,0,1,0
28,470,470,19,9,10,3,2
10,490,490,22,13,9,4,3

36,103,103,28,28,0,1,0
6,110,110,2,2,0,1,0
7,110,110,16,10,6,3,2
12,127,127,1,1,0,1,0
13,143,143,6,2,4,2,1
20,152,152,20,20,0,1,0
21,155,155,51,32,19,2,1
1,157,157,5,2,3,2,1
0,167,167,16,2,14,3,2
27,167,167,27,27,0,1,0
29,207,207,6,6,0,1,0
40,218,218,9,9,0,1,0
23,246,246,18,4,14,3,2
8,252,252,3,3,0,1,0
2,256,256,27,7,20,3,2
4,261,261,1,1,0,1,0
32,268,268,34,34,0,1,0
31,271,271,2,2,0,1,0
5,277,277,22,22,0,1,0
26,316,316,84,26,58,3,2
15,319,319,2,2,0,1,0
24,324,324,2,2,0,1,0
17,324,324,67,53,14,3,2
30,334,334,21,11,10,2,1
39,350,350,26,5,21,2,1
34,366,366,17,17,0,1,0
16,374,374,9,9,0,1,0
28,380,380,92,92,0,1,0
25,394,394,13,4,9,4,3
11,396,396,22,3,19,2,1
35,400,400,5,5,0,1,0
3,407,407,65,26,39,4,3
37,427,427,10,2,8,3,2
18,436,436,48,48,0,1,0
19,440,440,18,18,0,1,0
14,457,457,120,35,85,4,3
38,457,457,63,63,0,1,0
10,472,472,98,4,94,3,2
33,484,484,23,23,0,1,0
22,492,492,23,7,16,3,2
9,497,497,127,71,56,4,3

33,101,101,1,1,0,1,0
11,127,127,12,12,0,1,0
4,134,134,26,13,13,2,1
2,149,149,9,3,6,2,1
31,181,181,18,18,0,1,0
28,198,198,13,7,6,3,2
0,210,210,13,2,11,2,1
38,224,224,36,36,0,1,0
32,234,234,26,26,0,1,0
13,236,236,50,50,0,1,0
18,246,246,58,58,0,1,0
23,246,246,35,20,15,4,3
15,255,255,8,8,0,1,0
24,256,256,64,64,0,1,0
26,268,268,32,17,15,2,1
16,291,291,1,1,0,1,0
19,295,295,79,79,0,1,0
29,299,299,44,44,0,1,0
1,313,313,8,8,0,1,0
27,315,315,19,11,8,3,2
5,328,328,1,1,0,1,0
34,341,341,91,40,51,4,3
39,357,357,74,8,66,3,2
37,363,363,31,23,8,2,1
35,379,379,3,3,0,1,0
22,383,383,6,3,3,2,1
30,392,392,35,26,9,4,3
36,403,403,16,3,13,2,1
20,404,404,9,3,6,3,2
7,405,405,21,21,0,1,0
21,411,411,8,8,0,1,0
10,416,416,41,8,33,4,3
9,427,427,81,1,80,3,2
12,428,428,6,6,0,1,0
17,450,450,7,4,3,2,1
14,452,452,28,19,9,4,3
3,452,452,8,8,0,1,0
8,483,483,52,52,0,1,0
25,486,486,55,12,43,2,1
6,488,488,124,103,21,4,3

5,100,100,1,1,0,1,0
25,102,102,6,6,0,1,0
16,110,110,24,24,0,1,0
20,115,115,27,13,14,2,1
21,120,120,3,3,0,1,0
35,132,132,67,67,0,1,0
9,144,144,29,8,21,4,3
0,165,165,5,5,0,1,0
13,173,173,3,3,0,1,0
1,189,189,11,11,0,1,0
18,206,206,30,30,0,1,0
36,212,212,1,1,0,1,0
30,222,222,10,10,0,1,0
34,224,224,10,10,0,1,0
14,227,227,15,15,0,1,0
28,238,238,72,72,0,1,0
31,248,248,3,3,0,1,0
6,248,248,35,35,0,1,0
3,251,251,13,2,11,2,1
11,255,255,14,14,0,1,0
7,267,267,50,50,0,1,0
19,272,272,11,8,3,2,1
23,283,283,57,42,15,2,1
37,290,290,37,37,0,1,0
27,291,291,3,3,0,1,0
22,342,342,21,2,19,2,1
33,353,353,3,3,0,1,0
4,353,353,163,110,53,4,3
32,366,366,39,39,0,1,0
17,379,379,5,2,3,2,1
24,385,385,1,1,0,1,0
26,435,435,26,26,0,1,0
8,438,438,12,7,5,2,1
10,446,446,39,39,0,1,0
29,449,449,15,15,0,1,0
2,451,451,2,2,0,1,0
15,484,484,177,111,66,4,3
12,493,493,3,3,0,1,0

26,103,103,7,7,0,1,0
19,110,110,17,17,0,1,0
27,132,132,20,20,0,1,0
34,147,147,64,12,52,3,2
37,162,162,8,8,0,1,0
4,174,174,55,43,12,3,2
14,200,200,8,8,0,1,0
31,208,208,18,18,0,1,0
18,213,213,3,3,0,1,0
16,217,217,35,23,12,4,3
24,218,218,3,3,0,1,0
15,236,236,67,67,0,1,0
36,243,243,7,7,0,1,0
22,244,244,16,7,9,4,3
32,257,257,1,1,0,1,0
5,262,262,18,18,0,1,0
10,303,303,7,7,0,1,0
29,305,305,1,1,0,1,0
2,331,331,63,33,30,2,1
7,344,344,2,2,0,1,0
30,347,347,2,2,0,1,0
3,348,348,8,8,0,1,0
28,359,359,91,91,0,1,0
0,366,366,10,5,5,2,1
17,396,396,16,16,0,1,0
20,409,409,40,40,0,1,0
21,415,415,60,57,3,2,1
23,420,420,5,5,0,1,0
9,425,425,26,2,24,4,3
13,427,427,10,10,0,1,0
1,434,434,44,41,3,2,1
12,451,451,67,28,39,4,3
6,458,458,36,4,32,3,2
33,460,460,63,18,45,2,1
11,463,463,76,43,33,3,2
8,469,469,114,30,84,4,3
25,477,477,151,112,39,4,3
35,496,496,3,3,0,1,0

21,117,117,2,2,0,1,0
26,149,149,8,8,0,1,0
34,152,152,31,31,0,1,0
12,157,157,19,8,11,2,1
7,169,169,15,15,0,1,0
36,180,180,2,2,0,1,0
8,188,188,15,1,14,2,1
20,202,202,31,26,5,2,1
13,203,203,45,45,0,1,0
29,211,211,15,11,4,2,1
15,213,213,12,12,0,1,0
31,240,240,6,6,0,1,0
30,244,244,46,15,31,2,1
28,248,248,59,59,0,1,0
4,250,250,8,8,0,1,0
14,252,252,27,1,26,2,1
37,257,257,10,10,0,1,0
10,260,260,10,4,6,2,1
33,260,260,11,3,8,2,1
17,263,263,38,38,0,1,0
16,266,266,46,46,0,1,0
18,316,316,7,7,0,1,0
24,326,326,39,18,21,4,3
32,338,338,16,16,0,1,0
6,358,358,14,7,7,2,1
35,386,386,22,11,11,2,1
9,391,391,10,10,0,1,0
2,396,396,12,9,3,2,1
23,407,407,13,13,0,1,0
1,410,410,117,18,99,4,3
22,423,423,2,2,0,1,0
25,430,430,140,105,35,4,3
0,436,436,11,3,8,3,2
5,441,441,85,40,45,4,3
27,470,470,88,16,72,4,3
11,476,476,18,3,15,4,3
3,480,480,145,76,69,3,2
19,494,494,100,28,72,4,3

10,121,121,4,4,0,1,0
32,127,127,4,1,3,2,1
36,133,133,32,32,0,1,0
11,135,135,21,6,15,4,3
38,147,147,3,3,0,1,0
30,155,155,19,3,16,2,1
41,168,168,18,12,6,2,1
15,171,171,9,4,5,2,1
4,204,204,26,26,0,1,0
12,216,216,17,1,16,4,3
3,240,240,29,29,0,1,0
5,241,241,4,4,0,1,0
39,258,258,50,42,8,3,2
29,261,261,15,4,11,2,1
28,272,272,35,18,17,2,1
35,275,275,27,27,0,1,0
24,286,286,16,16,0,1,0
20,287,287,2,2,0,1,0
18,296,296,22,2,20,2,1
25,312,312,39,39,0,1,0
6,317,317,6,6,0,1,0
37,327,327,39,13,26,3,2
19,335,335,41,29,12,4,3
7,345,345,36,1,35,2,1
1,357,357,8,8,0,1,0
34,367,367,52,44,8,3,2
0,371,371,70,26,44,4,3
2,371,371,20,20,0,1,0
40,376,376,11,11,0,1,0
23,388,388,106,37,69,4,3
8,390,390,4,1,3,2,1
33,395,395,38,38,0,1,0
26,405,405,2,2,0,1,0
27,408,408,19,19,0,1,0
14,412,412,9,9,0,1,0
13,422,422,4,4,0,1,0
42,432,432,4,4,0,1,0
31,434,434,61,61,0,1,0
16,434,434,77,35,42,2,1
17,438,438,17,2,15,4,3
21,466,466,155,61,94,4,3
9,466,466,98,12,86,3,2
22,480,480,11,11,0,1,0

13,101,101,2,2,0,1,0
32,103,103,22,19,3,2,1
35,147,147,22,12,10,3,2
31,173,173,15,3,12,3,2
17,209,209,22,15,7,2,1
0,216,216,25,25,0,1,0
36,227,227,18,18,0,1,0
2,242,242,27,27,0,1,0
30,254,254,12,12,0,1,0
22,255,255,9,1,8,3,2
20,262,262,64,64,0,1,0
18,282,282,6,6,0,1,0
8,295,295,1,1,0,1,0
16,306,306,42,42,0,1,0
37,307,307,33,33,0,1,0
12,324,324,30,30,0,1,0
27,357,357,57,57,0,1,0
6,361,361,13,4,9,2,1
10,361,361,79,36,43,2,1
38,363,363,42,42,0,1,0
14,368,368,67,67,0,1,0
29,372,372,2,2,0,1,0
4,385,385,7,1,6,3,2
24,391,391,5,5,0,1,0
1,407,407,89,74,15,4,3
23,410,410,57,3,54,3,2
7,410,410,11,11,0,1,0
15,410,410,16,16,0,1,0
11,412,412,15,15,0,1,0
3,417,417,45,11,34,4,3
34,423,423,29,29,0,1,0
19,425,425,98,41,57,4,3
28,429,429,107,65,42,4,3
25,433,433,41,5,36,2,1
39,437,437,41,41,0,1,0
21,459,459,13,13,0,1,0
5,468,468,103,103,0,1,0
26,476,476,17,17,0,1,0
9,484,484,29,20,9,4,3
33,498,498,31,12,19,2,1

5,105,105,7,7,0,1,0
15,131,131,19,19,0,1,0
24,141,141,11,3,8,2,1
7,146,146,73,73,0,1,0
3,151,151,5,1,4,2,1
18,153,153,15,6,9,2,1
11,157,157,19,1,18,4,3
29,170,170,23,23,0,1,0
0,189,189,29,20,9,4,3
23,191,191,55,29,26,4,3
4,198,198,39,39,0,1,0
32,199,199,3,3,0,1,0
6,216,216,1,1,0,1,0
26,229,229,9,2,7,2,1
27,236,236,25,10,15,4,3
21,260,260,8,8,0,1,0
9,278,278,9,3,6,3,2
14,287,287,7,1,6,2,1
1,288,288,16,7,9,4,3
2,306,306,82,52,30,3,2
28,309,309,3,3,0,1,0
16,316,316,45,33,12,3,2
10,317,317,18,18,0,1,0
30,318,318,20,20,0,1,0
33,342,342,85,55,30,3,2
13,359,359,55,22,33,2,1
22,365,365,20,20,0,1,0
8,378,378,12,12,0,1,0
34,388,388,25,25,0,1,0
17,408,408,21,21,0,1,0
20,430,430,35,35,0,1,0
19,443,443,34,34,0,1,0
12,460,460,8,8,0,1,0
25,461,461,37,22,15,4,3
35,468,468,58,27,31,4,3
36,492,492,57,57,0,1,0
31,494,494,135,135,0,1,0

7,105,105,1,1,0,1,0
5,118,118,31,7,24,4,3
16,125,125,4,4,0,1,0
32,136,136,3,3,0,1,0
21,155,155,1,1,0,1,0
22,171,171,13,13,0,1,0
19,190,190,1,1,0,1,0
2,213,213,90,48,42,2,1
18,215,215,19,11,8,2,1
9,237,237,16,16,0,1,0
40,248,248,42,42,0,1,0
12,256,256,8,8,0,1,0
20,261,261,17,17,0,1,0
31,275,275,22,22,0,1,0
14,280,280,12,5,7,2,1
8,283,283,12,3,9,4,3
1,288,288,25,15,10,3,2
15,299,299,9,1,8,2,1
17,301,301,20,20,0,1,0
4,325,325,12,12,0,1,0
30,327,327,61,61,0,1,0
26,332,332,15,15,0,1,0
37,335,335,67,67,0,1,0
13,355,355,85,45,40,3,2
29,358,358,64,64,0,1,0
35,359,359,35,23,12,4,3
24,366,366,9,3,6,2,1
27,377,377,25,25,0,1,0
36,394,394,2,2,0,1,0
0,395,395,32,32,0,1,0
6,406,406,25,4,21,4,3
10,410,410,27,27,0,1,0
25,411,411,47,5,42,3,2
11,420,420,49,49,0,1,0
28,429,429,132,74,58,3,2
38,440,440,2,2,0,1,0
33,442,442,27,21,6,3,2
39,447,447,27,5,22,2,1
3,448,448,66,62,4,2,1
34,457,457,37,9,28,3,2
23,459,459,112,78,34,3,2

17,109,109,8,8,0,1,0
31,111,111,1,1,0,1,0
27,169,169,5,5,0,1,0
30,172,172,13,9,4,2,1
15,194,194,21,11,10,2,1
26,201,201,71,21,50,2,1
18,214,214,13,6,7,2,1
24,222,222,3,3,0,1,0
13,223,223,17,9,8,2,1
2,230,230,24,12,12,3,2
19,232,232,42,42,0,1,0
16,248,248,2,2,0,1,0
5,251,251,5,1,4,2,1
29,266,266,20,11,9,4,3
14,271,271,34,19,15,4,3
23,306,306,25,25,0,1,0
22,309,309,25,10,15,4,3
12,315,315,156,78,78,4,3
21,354,354,17,3,14,3,2
6,366,366,7,4,3,2,1
8,367,367,43,17,26,2,1
28,373,373,5,5,0,1,0
0,379,379,93,93,0,1,0
25,423,423,5,5,0,1,0
1,424,424,110,110,0,1,0
4,438,438,67,67,0,1,0
7,443,443,1,1,0,1,0
3,461,461,41,19,22,2,1
10,472,472,359,305,54,4,3
20,476,476,56,22,34,3,2
11,485,485,103,79,24,2,1
9,487,487,9,9,0,1,0

14,100,100,6,6,0,1,0
23,175,175,21,10,11,2,1
10,182,182,1,1,0,1,0
6,215,215,33,19,14,3,2
4,224,224,18,15,3,2,1
21,234,234,82,36,46,3,2
35,241,241,35,3,32,3,2
28,246,246,34,34,0,1,0
37,257,257,30,5,25,2,1
16,260,260,51,44,7,3,2
30,261,261,10,10,0,1,0
8,265,265,47,9,38,3,2
9,267,267,3,3,0,1,0
32,279,279,9,6,3,2,1
17,297,297,40,40,0,1,0
20,301,301,37,16,21,2,1
7,306,306,98,36,62,4,3
15,314,314,40,25,15,2,1
11,323,323,53,6,47,3,2
22,327,327,38,23,15,2,1
36,335,335,3,3,0,1,0
33,339,339,18,18,0,1,0
24,347,347,35,35,0,1,0
19,365,365,72,64,8,3,2
31,376,376,49,7,42,3,2
5,386,386,2,2,0,1,0
1,394,394,28,22,6,3,2
27,396,396,4,4,0,1,0
29,412,412,11,11,0,1,0
2,418,418,26,26,0,1,0
26,427,427,3,3,0,1,0
38,435,435,114,57,57,4,3
3,437,437,72,36,36,4,3
18,449,449,10,1,9,4,3
12,452,452,5,1,4,2,1
13,460,460,80,26,54,3,2
34,466,466,1,1,0,1,0
0,481,481,29,29,0,1,0
25,497,497,24,24,0,1,0

15,125,125,1,1,0,1,0
39,129,129,10,10,0,1,0
26,136,136,2,2,0,1,0
33,145,145,19,19,0,1,0
31,155,155,3,3,0,1,0
16,162,162,1,1,0,1,0
42,170,170,19,19,0,1,0
48,181,181,24,24,0,1,0
32,183,183,18,4,14,3,2
20,185,185,22,22,0,1,0
41,186,186,66,66,0,1,0
21,192,192,6,6,0,1,0
51,200,200,11,11,0,1,0
2,220,220,26,26,0,1,0
29,225,225,9,9,0,1,0
10,227,227,7,7,0,1,0
40,232,232,8,4,4,2,1
11,247,247,10,10,0,1,0
12,249,249,7,7,0,1,0
45,291,291,29,19,10,3,2
49,292,292,31,31,0,1,0
44,305,305,14,14,0,1,0
37,307,307,13,5,8,3,2
25,312,312,11,11,0,1,0
35,314,314,18,18,0,1,0
27,315,315,25,25,0,1,0
6,316,316,11,1,10,2,1
47,319,319,22,3,19,2,1
5,336,336,17,7,10,3,2
46,336,336,23,23,0,1,0
13,338,338,10,4,6,3,2
7,339,339,82,1,81,4,3
8,368,368,6,6,0,1,0
1,371,371,58,58,0,1,0
4,373,373,37,37,0,1,0
18,375,375,4,4,0,1,0
43,383,383,19,14,5,2,1
34,391,391,111,38,73,4,3
28,399,399,29,29,0,1,0
17,407,407,64,28,36,2,1
24,411,411,19,19,0,1,0
9,420,420,4,4,0,1,0
50,420,420,3,3,0,1,0
23,427,427,8,8,0,1,0
3,441,441,6,2,4,2,1
36,457,457,36,36,0,1,0
0,463,463,40,40,0,1,0
30,473,473,100,61,39,4,3
14,475,475,19,19,0,1,0
19,475,475,14,11,3,2,1
38,482,482,65,37,28,3,2
22,485,485,53,4,49,2,1

27,100,100,5,2,3,2,1
41,107,107,4,4,0,1,0
2,108,108,21,21,0,1,0
3,199,199,11,11,0,1,0
38,209,209,3,3,0,1,0
5,210,210,3,3,0,1,0
36,212,212,49,13,36,4,3
43,244,244,7,7,0,1,0
28,244,244,23,23,0,1,0
8,247,247,29,11,18,4,3
17,249,249,9,9,0,1,0
0,256,256,9,3,6,3,2
39,256,256,20,20,0,1,0
30,269,269,46,46,0,1,0
35,272,272,52,52,0,1,0
31,275,275,39,39,0,1,0
14,290,290,6,1,5,2,1
7,301,301,1,1,0,1,0
18,304,304,1,1,0,1,0
11,311,311,1,1,0,1,0
37,320,320,3,3,0,1,0
33,323,323,1,1,0,1,0
9,333,333,15,15,0,1,0
26,334,334,73,15,58,3,2
34,346,346,23,23,0,1,0
29,349,349,41,41,0,1,0
6,360,360,64,16,48,3,2
22,360,360,35,35,0,1,0
1,372,372,7,7,0,1,0
16,374,374,56,41,15,2,1
13,375,375,2,2,0,1,0
21,376,376,24,2,22,3,2
45,387,387,10,6,4,2,1
44,389,389,50,50,0,1,0
23,396,396,81,67,14,3,2
19,408,408,16,16,0,1,0
24,411,411,17,17,0,1,0
4,416,416,21,21,0,1,0
15,418,418,19,1,18,3,2
32,427,427,53,45,8,2,1
12,434,434,1,1,0,1,0
10,437,437,18,3,15,4,3
42,445,445,116,116,0,1,0
40,447,447,24,24,0,1,0
20,467,467,132,108,24,4,3
25,471,471,119,119,0,1,0

39,116,116,2,2,0,1,0
10,122,122,13,1,12,4,3
22,123,123,1,1,0,1,0
19,129,129,17,5,12,2,1
13,144,144,1,1,0,1,0
1,152,152,18,18,0,1,0
29,161,161,27,27,0,1,0
15,163,163,3,3,0,1,0
3,166,166,52,16,36,2,1
4,169,169,3,3,0,1,0
28,174,174,37,37,0,1,0
40,186,186,4,1,3,2,1
24,201,201,10,10,0,1,0
20,209,209,59,43,16,2,1
16,212,212,32,15,17,2,1
12,228,228,3,3,0,1,0
37,236,236,86,64,22,3,2
25,268,268,14,3,11,2,1
18,273,273,35,9,26,2,1
36,297,297,11,11,0,1,0
32,298,298,35,35,0,1,0
17,300,300,44,44,0,1,0
7,301,301,50,50,0,1,0
38,302,302,40,40,0,1,0
30,303,303,33,24,9,2,1
27,305,305,16,16,0,1,0
35,321,321,69,33,36,4,3
23,338,338,37,23,14,2,1
41,341,341,2,2,0,1,0
21,341,341,10,10,0,1,0
11,352,352,42,42,0,1,0
33,365,365,72,28,44,3,2
2,391,391,2,2,0,1,0
31,393,393,17,17,0,1,0
9,415,415,21,21,0,1,0
6,419,419,44,31,13,4,3
5,435,435,12,12,0,1,0
26,439,439,9,1,8,2,1
8,466,466,14,4,10,3,2
34,473,473,51,37,14,2,1
0,500,500,6,6,0,1,0
14,500,500,11,1,10,2,1

29,115,115,1,1,0,1,0
19,117,117,7,7,0,1,0
11,124,124,31,9,22,3,2
6,127,127,23,23,0,1,0
30,128,128,10,10,0,1,0
28,160,160,18,9,9,4,3
20,162,162,32,14,18,4,3
17,175,175,8,5,3,2,1
9,179,179,11,5,6,3,2
31,181,181,22,22,0,1,0
10,189,189,10,4,6,2,1
23,190,190,10,10,0,1,0
13,200,200,10,10,0,1,0
12,227,227,58,58,0,1,0
32,232,232,20,20,0,1,0
35,236,236,12,12,0,1,0
7,239,239,7,1,6,2,1
1,240,240,61,7,54,3,2
5,260,260,23,23,0,1,0
33,266,266,36,5,31,2,1
15,277,277,10,3,7,2,1
14,286,286,10,10,0,1,0
26,298,298,64,64,0,1,0
4,321,321,12,12,0,1,0
22,324,324,96,96,0,1,0
8,344,344,17,17,0,1,0
0,351,351,24,24,0,1,0
24,363,363,6,6,0,1,0
18,365,365,33,10,23,2,1
2,371,371,66,26,40,2,1
16,402,402,81,81,0,1,0
21,412,412,9,9,0,1,0
34,413,413,109,4,105,4,3
3,432,432,75,39,36,4,3
36,450,450,7,7,0,1,0
25,455,455,44,2,42,2,1
27,483,483,40,40,0,1,0

16,105,105,18,18,0,1,0
6,127,127,23,23,0,1,0
28,130,130,9,3,6,2,1
25,139,139,49,19,30,3,2
36,142,142,2,2,0,1,0
34,145,145,2,2,0,1,0
19,180,180,2,2,0,1,0
23,183,183,46,36,10,3,2
29,185,185,16,16,0,1,0
10,203,203,6,2,4,2,1
15,204,204,11,11,0,1,0
18,209,209,15,15,0,1,0
26,213,213,12,6,6,2,1
5,222,222,42,8,34,3,2
1,236,236,9,9,0,1,0
14,256,256,10,10,0,1,0
32,263,263,19,15,4,2,1
2,278,278,28,16,12,3,2
24,294,294,9,9,0,1,0
7,305,305,22,22,0,1,0
3,309,309,10,3,7,2,1
35,315,315,147,129,18,2,1
11,336,336,1,1,0,1,0
8,341,341,39,26,13,2,1
31,344,344,122,46,76,3,2
12,353,353,166,112,54,4,3
27,358,358,25,25,0,1,0
20,408,408,2,2,0,1,0
4,408,408,44,44,0,1,0
21,409,409,20,12,8,3,2
30,418,418,11,11,0,1,0
9,420,420,63,63,0,1,0
0,438,438,3,3,0,1,0
22,454,454,7,1,6,3,2
13,459,459,112,105,7,2,1
17,460,460,4,4,0,1,0
33,481,481,7,4,3,2,1

33,107,107,7,7,0,1,0
46,114,114,4,4,0,1,0
31,117,117,4,4,0,1,0
42,119,119,19,19,0,1,0
5,123,123,14,9,5,2,1
27,129,129,12,3,9,4,3
2,131,131,4,4,0,1,0
26,158,158,18,11,7,2,1
30,160,160,44,44,0,1,0
25,169,169,7,7,0,1,0
36,188,188,3,3,0,1,0
19,193,193,11,11,0,1,0
11,196,196,8,8,0,1,0
22,198,198,16,5,11,3,2
34,218,218,20,13,7,2,1
37,223,223,32,20,12,4,3
24,226,226,5,1,4,2,1
20,229,229,12,5,7,2,1
41,239,239,8,8,0,1,0
16,239,239,44,29,15,2,1
12,243,243,1,1,0,1,0
3,244,244,1,1,0,1,0
7,265,265,121,70,51,4,3
43,273,273,32,6,26,3,2
23,275,275,3,3,0,1,0
40,286,286,4,4,0,1,0
9,301,301,14,14,0,1,0
13,315,315,17,17,0,1,0
44,322,322,44,38,6,3,2
10,323,323,3,3,0,1,0
1,330,330,27,27,0,1,0
17,335,335,24,12,12,3,2
0,340,340,36,12,24,2,1
4,347,347,21,6,15,4,3
14,368,368,6,6,0,1,0
45,400,400,49,49,0,1,0
35,400,400,7,7,0,1,0
6,401,401,20,4,16,2,1
48,413,413,8,3,5,2,1
39,424,424,97,55,42,3,2
29,454,454,12,8,4,2,1
32,474,474,28,19,9,4,3
18,475,475,13,13,0,1,0
38,479,479,72,45,27,2,1
8,481,481,22,22,0,1,0
21,482,482,42,19,23,2,1
15,487,487,17,17,0,1,0
28,491,491,2,2,0,1,0
47,494,494,144,7,137,4,3

15,109,109,4,4,0,1,0
22,109,109,2,2,0,1,0
23,112,112,12,12,0,1,0
8,114,114,35,35,0,1,0
32,117,117,3,3,0,1,0
20,129,129,23,12,11,2,1
14,138,138,5,5,0,1,0
13,140,140,61,61,0,1,0
10,148,148,28,11,17,2,1
26,165,165,11,11,0,1,0
11,170,170,5,5,0,1,0
19,178,178,2,2,0,1,0
17,180,180,42,34,8,2,1
16,182,182,19,19,0,1,0
7,218,218,103,103,0,1,0
3,230,230,4,4,0,1,0
0,231,231,94,49,45,4,3
21,234,234,55,55,0,1,0
6,245,245,28,28,0,1,0
25,288,288,19,4,15,4,3
1,304,304,17,17,0,1,0
24,310,310,8,8,0,1,0
29,326,326,42,42,0,1,0
28,340,340,9,3,6,3,2
30,344,344,3,3,0,1,0
31,346,346,54,34,20,2,1
5,372,372,20,20,0,1,0
2,373,373,5,5,0,1,0
9,400,400,41,23,18,3,2
27,414,414,64,6,58,3,2
12,438,438,70,1,69,4,3
18,440,440,4,4,0,1,0
4,452,452,36,36,0,1,0

5,106,106,5,5,0,1,0
6,107,107,12,12,0,1,0
22,120,120,2,2,0,1,0
23,125,125,12,12,0,1,0
20,142,142,40,40,0,1,0
26,145,145,2,2,0,1,0
4,148,148,9,9,0,1,0
12,156,156,16,16,0,1,0
2,166,166,8,8,0,1,0
29,200,200,1,1,0,1,0
27,204,204,16,8,8,3,2
28,208,208,32,13,19,2,1
10,227,227,4,1,3,2,1
38,238,238,53,53,0,1,0
14,253,253,62,40,22,3,2
18,258,258,61,61,0,1,0
19,264,264,32,32,0,1,0
0,267,267,24,21,3,2,1
1,273,273,66,58,8,2,1
24,274,274,2,2,0,1,0
15,280,280,55,52,3,2,1
21,294,294,44,5,39,2,1
3,324,324,2,2,0,1,0
11,354,354,20,16,4,2,1
30,376,376,45,12,33,4,3
8,396,396,1,1,0,1,0
9,401,401,131,90,41,2,1
31,413,413,115,115,0,1,0
25,429,429,3,3,0,1,0
16,430,430,39,6,33,2,1
7,434,434,49,12,37,2,1
36,439,439,3,3,0,1,0
33,441,441,47,47,0,1,0
34,459,459,33,15,18,4,3
17,490,490,2,2,0,1,0
35,492,492,77,77,0,1,0
13,493,493,2,2,0,1,0
32,494,494,52,12,40,4,3
37,497,497,17,17,0,1,0

30,112,112,20,8,12,2,1
34,114,114,3,3,0,1,0
10,136,136,26,5,21,2,1
2,194,194,20,20,0,1,0
14,220,220,6,6,0,1,0
36,220,220,28,28,0,1,0
27,229,229,11,11,0,1,0
7,264,264,13,13,0,1,0
28,267,267,24,24,0,1,0
0,268,268,4,4,0,1,0
9,274,274,43,43,0,1,0
4,283,283,12,12,0,1,0
16,311,311,89,12,77,3,2
5,314,314,30,14,16,2,1
40,317,317,63,33,30,4,3
29,318,318,2,2,0,1,0
25,335,335,77,50,27,4,3
24,336,336,54,54,0,1,0
26,337,337,16,4,12,3,2
19,342,342,7,7,0,1,0
20,352,352,87,40,47,2,1
18,379,379,7,1,6,2,1
15,389,389,18,18,0,1,0
37,404,404,6,6,0,1,0
35,416,416,114,81,33,4,3
1,419,419,24,24,0,1,0
22,422,422,8,2,6,2,1
39,422,422,55,16,39,4,3
38,447,447,1,1,0,1,0
17,462,462,28,7,21,2,1
32,463,463,74,8,66,3,2
8,466,466,53,47,6,2,1
3,467,467,29,29,0,1,0
33,471,471,24,6,18,3,2
13,472,472,41,11,30,2,1
21,475,475,27,27,0,1,0
6,488,488,33,11,22,4,3
11,488,488,35,35,0,1,0
31,489,489,88,88,0,1,0
23,492,492,15,11,4,2,1
12,500,500,91,61,30,4,3

11,103,103,4,4,0,1,0
39,106,106,6,6,0,1,0
22,114,114,12,9,3,2,1
31,125,125,9,9,0,1,0
35,138,138,1,1,0,1,0
28,139,139,23,23,0,1,0
14,152,152,11,11,0,1,0
2,155,155,13,6,7,2,1
24,161,161,4,1,3,2,1
18,169,169,23,23,0,1,0
32,171,171,4,1,3,2,1
9,179,179,29,7,22,2,1
38,197,197,1,1,0,1,0
13,219,219,19,19,0,1,0
3,222,222,27,5,22,2,1
21,250,250,17,14,3,2,1
6,261,261,22,22,0,1,0
16,275,275,50,16,34,4,3
27,279,279,46,40,6,3,2
7,281,281,1,1,0,1,0
30,285,285,29,11,18,4,3
12,291,291,41,41,0,1,0
20,291,291,13,7,6,3,2
19,309,309,3,3,0,1,0
36,314,314,10,2,8,2,1
17,319,319,12,12,0,1,0
29,333,333,54,54,0,1,0
0,336,336,19,19,0,1,0
15,357,357,92,69,23,2,1
8,363,363,13,13,0,1,0
34,370,370,45,38,7,2,1
23,389,389,12,9,3,2,1
4,394,394,154,28,126,4,3
10,397,397,15,15,0,1,0
25,415,415,127,30,97,4,3
1,426,426,8,8,0,1,0
26,449,449,112,100,12,3,2
33,473,473,50,1,49,2,1
5,490,490,22,22,0,1,0
37,499,499,97,37,60,4,3

18,129,129,2,2,0,1,0
40,131,131,26,5,21,2,1
16,134,134,11,11,0,1,0
10,142,142,15,3,12,3,2
34,161,161,38,29,9,4,3
0,165,165,29,5,24,4,3
30,173,173,6,6,0,1,0
1,174,174,5,5,0,1,0
24,197,197,4,4,0,1,0
20,204,204,12,12,0,1,0
3,214,214,35,35,0,1,0
6,214,214,2,2,0,1,0
8,231,231,38,38,0,1,0
7,243,243,56,32,24,4,3
35,253,253,2,2,0,1,0
26,256,256,26,11,15,2,1
13,265,265,11,2,9,2,1
23,265,265,28,14,14,2,1
43,270,270,21,21,0,1,0
5,289,289,21,1,20,3,2
9,297,297,1,1,0,1,0
32,300,300,23,23,0,1,0
46,301,301,6,6,0,1,0
38,307,307,32,3,29,2,1
14,324,324,10,4,6,2,1
11,327,327,16,13,3,2,1
28,345,345,5,2,3,2,1
41,351,351,22,3,19,2,1
17,351,351,7,7,0,1,0
12,354,354,73,73,0,1,0
2,361,361,3,3,0,1,0
25,366,366,4,4,0,1,0
4,383,383,4,4,0,1,0
15,400,400,52,43,9,4,3
33,405,405,15,7,8,2,1
27,407,407,81,81,0,1,0
21,413,413,13,3,10,3,2
29,421,421,38,18,20,3,2
42,423,423,21,7,14,3,2
39,424,424,19,19,0,1,0
22,425,425,23,23,0,1,0
44,437,437,31,19,12,3,2
31,445,445,117,69,48,3,2
45,459,459,23,23,0,1,0
19,462,462,33,33,0,1,0
37,468,468,18,18,0,1,0
36,495,495,175,107,68,3,2

4,106,106,9,9,0,1,0
32,115,115,27,18,9,4,3
28,117,117,2,2,0,1,0
3,133,133,8,8,0,1,0
8,138,138,1,1,0,1,0
48,150,150,6,2,4,2,1
11,150,150,24,24,0,1,0
31,154,154,44,44,0,1,0
7,160,160,54,54,0,1,0
45,170,170,11,11,0,1,0
47,184,184,36,36,0,1,0
42,186,186,13,13,0,1,0
14,193,193,32,10,22,2,1
41,200,200,25,25,0,1,0
12,203,203,7,7,0,1,0
24,206,206,4,4,0,1,0
18,225,225,13,13,0,1,0
27,232,232,4,1,3,2,1
2,243,243,6,6,0,1,0
36,249,249,19,10,9,2,1
46,253,253,27,27,0,1,0
30,262,262,32,32,0,1,0
44,268,268,7,7,0,1,0
9,285,285,2,2,0,1,0
25,296,296,11,11,0,1,0
39,301,301,15,7,8,2,1
16,307,307,39,39,0,1,0
43,321,321,38,23,15,4,3
40,328,328,26,15,11,2,1
38,333,333,14,3,11,2,1
22,338,338,26,23,3,2,1
23,339,339,35,3,32,3,2
29,346,346,21,4,17,2,1
6,361,361,1,1,0,1,0
20,364,364,5,5,0,1,0
0,370,370,25,25,0,1,0
21,376,376,14,14,0,1,0
13,376,376,36,36,0,1,0
19,400,400,17,17,0,1,0
34,415,415,20,14,6,2,1
17,436,436,42,30,12,4,3
10,443,443,10,10,0,1,0
26,448,448,10,10,0,1,0
33,453,453,6,6,0,1,0
35,461,461,83,83,0,1,0
15,471,471,69,69,0,1,0
37,472,472,41,41,0,1,0
5,494,494,55,49,6,3,2
1,499,499,4,4,0,1,0

28,124,124,11,5,6,2,1
18,129,129,8,8,0,1,0
30,138,138,9,9,0,1,0
22,143,143,3,3,0,1,0
12,147,147,7,7,0,1,0
24,159,159,11,11,0,1,0
27,161,161,10,10,0,1,0
21,180,180,41,41,0,1,0
5,180,180,16,8,8,2,1
36,187,187,2,2,0,1,0
40,190,190,32,32,0,1,0
15,203,203,1,1,0,1,0
23,208,208,19,19,0,1,0
3,224,224,3,3,0,1,0
29,226,226,14,14,0,1,0
14,236,236,1,1,0,1,0
17,241,241,18,6,12,3,2
31,241,241,31,31,0,1,0
20,248,248,81,81,0,1,0
13,255,255,16,16,0,1,0
0,256,256,6,6,0,1,0
38,260,260,18,18,0,1,0
1,283,283,49,49,0,1,0
39,309,309,50,32,18,3,2
25,311,311,1,1,0,1,0
9,334,334,56,24,32,2,1
42,343,343,13,13,0,1,0
41,368,368,80,80,0,1,0
10,379,379,1,1,0,1,0
2,389,389,92,47,45,4,3
32,393,393,13,13,0,1,0
26,394,394,58,58,0,1,0
7,395,395,45,27,18,3,2
34,401,401,64,25,39,2,1
35,404,404,30,1,29,2,1
37,405,405,70,70,0,1,0
33,406,406,91,73,18,3,2
4,409,409,34,17,17,2,1
11,439,439,33,11,22,3,2
6,442,442,37,37,0,1,0
16,452,452,34,34,0,1,0
19,466,466,14,5,9,2,1
8,470,470,2,2,0,1,0

7,104,104,3,3,0,1,0
8,122,122,18,18,0,1,0
36,123,123,17,17,0,1,0
34,125,125,15,5,10,3,2
28,133,133,23,23,0,1,0
18,134,134,11,4,7,2,1
33,160,160,2,2,0,1,0
24,160,160,7,7,0,1,0
11,166,166,4,4,0,1,0
0,170,170,7,7,0,1,0
19,178,178,6,2,4,2,1
5,205,205,11,11,0,1,0
12,249,249,37,14,23,2,1
26,251,251,20,20,0,1,0
27,254,254,23,23,0,1,0
3,260,260,23,23,0,1,0
9,265,265,26,2,24,2,1
13,274,274,22,9,13,2,1
4,292,292,35,35,0,1,0
10,307,307,80,69,11,2,1
14,323,323,4,4,0,1,0
22,329,329,48,30,18,4,3
23,329,329,45,45,0,1,0
1,331,331,55,55,0,1,0
2,342,342,165,155,10,3,2
16,352,352,10,10,0,1,0
32,368,368,3,3,0,1,0
31,416,416,2,2,0,1,0
25,433,433,70,58,12,4,3
30,457,457,54,26,28,2,1
35,459,459,49,49,0,1,0
15,463,463,82,30,52,3,2
6,473,473,21,9,12,2,1
20,479,479,76,76,0,1,0
17,484,484,18,18,0,1,0
29,495,495,84,34,50,3,2
21,496,496,110,85,25,2,1

21,109,109,5,2,3,2,1
0,114,114,7,7,0,1,0
2,119,119,4,4,0,1,0
23,139,139,6,6,0,1,0
13,146,146,1,1,0,1,0
1,164,164,6,6,0,1,0
33,171,171,16,9,7,2,1
5,172,172,13,13,0,1,0
39,184,184,1,1,0,1,0
28,193,193,26,5,21,2,1
10,219,219,7,7,0,1,0
4,223,223,3,3,0,1,0
7,233,233,10,10,0,1,0
25,238,238,27,11,16,2,1
35,239,239,17,2,15,2,1
34,243,243,33,27,6,3,2
31,249,249,7,7,0,1,0
30,250,250,9,9,0,1,0
24,262,262,10,10,0,1,0
40,271,271,28,28,0,1,0
16,305,305,73,73,0,1,0
9,310,310,38,13,25,4,3
32,312,312,117,117,0,1,0
38,325,325,20,7,13,3,2
3,343,343,31,16,15,2,1
8,353,353,76,37,39,4,3
29,355,355,24,1,23,2,1
17,357,357,31,3,28,3,2
11,372,372,114,114,0,1,0
18,372,372,28,10,18,3,2
36,381,381,2,2,0,1,0
6,387,387,26,26,0,1,0
27,388,388,41,4,37,4,3
15,404,404,48,48,0,1,0
14,409,409,56,6,50,3,2
41,429,429,64,64,0,1,0
12,432,432,1,1,0,1,0
22,445,445,184,184,0,1,0
26,456,456,2,2,0,1,0
20,460,460,68,16,52,3,2
19,483,483,24,2,22,3,2
37,484,484,25,19,6,3,2

35,116,116,3,3,0,1,0
6,126,126,1,1,0,1,0
4,129,129,2,2,0,1,0
34,144,144,39,39,0,1,0
25,158,158,9,9,0,1,0
42,167,167,17,17,0,1,0
9,189,189,43,22,21,2,1
10,191,191,15,8,7,2,1
39,195,195,22,2,20,2,1
5,214,214,10,10,0,1,0
14,217,217,31,9,22,2,1
2,225,225,7,7,0,1,0
28,235,235,33,33,0,1,0
24,244,244,51,18,33,4,3
0,247,247,19,2,17,2,1
8,255,255,7,7,0,1,0
15,267,267,1,1,0,1,0
36,269,269,25,25,0,1,0
13,285,285,104,38,66,4,3
38,287,287,24,8,16,2,1
21,301,301,9,9,0,1,0
41,304,304,47,21,26,4,3
33,312,312,21,5,16,2,1
12,312,312,6,6,0,1,0
7,316,316,64,49,15,4,3
27,319,319,15,15,0,1,0
11,328,328,3,3,0,1,0
3,329,329,71,71,0,1,0
29,330,330,1,1,0,1,0
16,334,334,3,3,0,1,0
23,338,338,54,54,0,1,0
20,345,345,14,2,12,4,3
32,355,355,8,8,0,1,0
26,360,360,42,42,0,1,0
31,363,363,48,13,35,4,3
18,389,389,10,10,0,1,0
40,403,403,6,6,0,1,0
17,405,405,5,5,0,1,0
1,420,420,80,53,27,2,1
22,438,438,89,29,60,4,3
19,439,439,9,5,4,2,1
37,440,440,30,14,16,2,1
30,474,474,75,75,0,1,0

29,103,103,7,2,5,2,1
16,110,110,11,11,0,1,0
3,119,119,5,5,0,1,0
4,128,128,78,78,0,1,0
2,137,137,3,3,0,1,0
6,137,137,8,8,0,1,0
20,140,140,27,11,16,3,2
18,148,148,7,7,0,1,0
25,166,166,31,23,8,2,1
7,166,166,5,2,3,2,1
23,178,178,3,3,0,1,0
37,202,202,6,6,0,1,0
34,208,208,1,1,0,1,0
35,230,230,20,7,13,2,1
17,245,245,38,17,21,3,2
26,254,254,91,91,0,1,0
22,262,262,17,1,16,3,2
1,274,274,14,14,0,1,0
10,278,278,3,3,0,1,0
11,287,287,4,4,0,1,0
39,296,296,18,18,0,1,0
12,319,319,3,3,0,1,0
38,328,328,19,19,0,1,0
0,350,350,99,35,64,3,2
14,351,351,6,6,0,1,0
8,366,366,101,101,0,1,0
36,366,366,71,71,0,1,0
27,372,372,10,10,0,1,0
19,385,385,2,2,0,1,0
21,385,385,34,6,28,3,2
28,392,392,1,1,0,1,0
32,408,408,2,2,0,1,0
9,410,410,8,5,3,2,1
31,417,417,23,23,0,1,0
15,418,418,9,3,6,3,2
24,452,452,82,30,52,3,2
30,473,473,41,15,26,2,1
5,489,489,104,83,21,2,1
13,498,498,9,9,0,1,0
33,499,499,138,51,87,4,3

6,111,111,1,1,0,1,0
7,111,111,1,1,0,1,0
3,116,116,22,22,0,1,0
14,116,116,25,25,0,1,0
23,146,146,11,11,0,1,0
31,147,147,5,1,4,2,1
30,160,160,37,37,0,1,0
33,187,187,11,11,0,1,0
2,231,231,3,3,0,1,0
24,238,238,53,28,25,2,1
19,239,239,51,10,41,2,1
5,239,239,62,26,36,4,3
15,242,242,12,3,9,4,3
21,260,260,21,21,0,1,0
32,262,262,21,21,0,1,0
27,286,286,25,18,7,2,1
28,307,307,8,8,0,1,0
9,310,310,10,10,0,1,0
25,317,317,16,16,0,1,0
26,351,351,22,16,6,2,1
20,358,358,8,8,0,1,0
0,374,374,63,63,0,1,0
29,387,387,40,27,13,2,1
8,400,400,170,162,8,2,1
22,405,405,121,121,0,1,0
1,414,414,63,63,0,1,0
13,453,453,5,2,3,2,1
17,458,458,23,23,0,1,0
4,465,465,84,13,71,4,3
10,467,467,12,6,6,3,2
18,470,470,26,7,19,3,2
16,484,484,39,6,33,4,3
11,487,487,22,16,6,2,1
12,489,489,130,63,67,4,3
34,495,495,81,81,0,1,0

42,103,103,3,3,0,1,0
23,104,104,9,9,0,1,0
29,112,112,26,14,12,3,2
2,133,133,5,5,0,1,0
15,144,144,11,11,0,1,0
26,165,165,8,4,4,2,1
28,185,185,18,18,0,1,0
37,185,185,1,1,0,1,0
9,187,187,19,19,0,1,0
44,189,189,1,1,0,1,0
25,198,198,9,5,4,2,1
27,223,223,41,41,0,1,0
40,241,241,34,16,18,2,1
35,241,241,61,52,9,4,3
7,258,258,32,32,0,1,0
6,259,259,26,26,0,1,0
43,264,264,24,8,16,3,2
38,266,266,23,23,0,1,0
22,269,269,25,25,0,1,0
4,281,281,100,90,10,3,2
24,290,290,18,18,0,1,0
11,291,291,7,7,0,1,0
13,300,300,22,22,0,1,0
33,301,301,47,47,0,1,0
41,302,302,13,13,0,1,0
18,313,313,20,20,0,1,0
32,315,315,13,1,12,3,2
1,335,335,7,1,6,2,1
39,351,351,49,49,0,1,0
3,384,384,1,1,0,1,0
12,393,393,63,63,0,1,0
30,419,419,3,3,0,1,0
36,433,433,3,3,0,1,0
46,436,436,117,9,108,4,3
5,440,440,5,5,0,1,0
34,446,446,49,49,0,1,0
16,446,446,54,31,23,2,1
45,452,452,12,3,9,4,3
10,464,464,54,54,0,1,0
20,470,470,40,40,0,1,0
14,481,481,23,13,10,2,1
31,490,490,56,8,48,2,1
19,492,492,36,36,0,1,0
17,492,492,19,1,18,2,1
21,496,496,3,3,0,1,0
8,498,498,1,1,0,1,0
0,500,500,11,11,0,1,0

38,136,136,26,5,21,2,1
40,139,139,16,16,0,1,0
33,152,152,1,1,0,1,0
4,160,160,7,7,0,1,0
32,169,169,38,21,17,2,1
3,170,170,26,26,0,1,0
10,192,192,17,5,12,2,1
31,211,211,52,52,0,1,0
14,219,219,36,36,0,1,0
6,226,226,11,5,6,3,2
18,226,226,1,1,0,1,0
28,228,228,5,5,0,1,0
36,232,232,15,15,0,1,0
17,244,244,31,31,0,1,0
11,280,280,25,25,0,1,0
30,296,296,35,31,4,2,1
41,301,301,51,51,0,1,0
2,304,304,35,35,0,1,0
21,307,307,35,35,0,1,0
8,309,309,4,4,0,1,0
16,320,320,6,6,0,1,0
24,322,322,32,32,0,1,0
37,323,323,18,1,17,2,1
13,332,332,110,110,0,1,0
19,333,333,18,18,0,1,0
20,343,343,21,2,19,2,1
22,346,346,19,13,6,2,1
1,366,366,18,6,12,3,2
34,374,374,108,108,0,1,0
7,377,377,15,11,4,2,1
25,386,386,37,37,0,1,0
0,401,401,40,40,0,1,0
39,407,407,44,8,36,4,3
26,408,408,5,5,0,1,0
23,412,412,19,19,0,1,0
29,428,428,6,6,0,1,0
27,429,429,35,14,21,4,3
35,458,458,11,11,0,1,0
12,458,458,64,64,0,1,0
9,483,483,66,45,21,2,1
5,497,497,17,8,9,2,1
15,497,497,37,17,20,3,2

15,105,105,3,3,0,1,0
4,121,121,28,4,24,2,1
10,123,123,33,20,13,2,1
21,132,132,20,20,0,1,0
6,138,138,16,4,12,4,3
11,138,138,16,9,7,2,1
5,157,157,34,26,8,3,2
18,173,173,5,5,0,1,0
1,179,179,11,11,0,1,0
3,180,180,18,9,9,2,1
33,196,196,9,9,0,1,0
13,219,219,36,21,15,4,3
34,221,221,10,10,0,1,0
17,245,245,149,135,14,3,2
8,252,252,4,4,0,1,0
22,258,258,5,5,0,1,0
16,261,261,8,8,0,1,0
2,302,302,52,4,48,4,3
23,319,319,16,16,0,1,0
25,353,353,67,52,15,2,1
28,357,357,85,85,0,1,0
20,375,375,13,1,12,4,3
9,385,385,50,15,35,2,1
31,394,394,38,38,0,1,0
27,397,397,3,3,0,1,0
14,409,409,40,40,0,1,0
30,412,412,6,3,3,2,1
26,414,414,63,16,47,2,1
12,444,444,7,7,0,1,0
32,444,444,39,39,0,1,0
29,481,481,72,53,19,2,1
19,483,483,6,6,0,1,0
24,488,488,21,21,0,1,0
7,496,496,138,76,62,3,2
0,498,498,9,1,8,3,2

33,104,104,3,3,0,1,0
12,111,111,15,3,12,2,1
2,130,130,10,7,3,2,1
38,137,137,4,4,0,1,0
41,138,138,19,9,10,3,2
16,141,141,1,1,0,1,0
45,145,145,12,1,11,2,1
44,164,164,6,2,4,2,1
19,177,177,2,2,0,1,0
0,210,210,34,34,0,1,0
26,217,217,7,7,0,1,0
39,219,219,54,27,27,4,3
1,224,224,11,11,0,1,0
5,227,227,37,37,0,1,0
8,227,227,8,8,0,1,0
42,237,237,34,34,0,1,0
6,247,247,7,7,0,1,0
21,250,250,9,9,0,1,0
13,254,254,3,3,0,1,0
15,263,263,24,5,19,2,1
36,268,268,23,19,4,2,1
31,273,273,32,32,0,1,0
29,283,283,7,7,0,1,0
43,285,285,8,8,0,1,0
25,291,291,60,60,0,1,0
24,304,304,40,13,27,4,3
27,313,313,25,25,0,1,0
10,316,316,20,20,0,1,0
40,339,339,97,97,0,1,0
30,343,343,14,14,0,1,0
9,382,382,27,9,18,2,1
17,383,383,14,14,0,1,0
37,393,393,79,40,39,4,3
34,402,402,23,23,0,1,0
3,408,408,7,7,0,1,0
32,412,412,104,92,12,2,1
4,430,430,53,7,46,3,2
18,431,431,96,96,0,1,0
14,431,431,5,5,0,1,0
11,434,434,2,2,0,1,0
35,442,442,17,11,6,3,2
7,444,444,4,4,0,1,0
20,455,455,42,35,7,2,1
22,456,456,66,4,62,3,2
28,477,477,44,44,0,1,0
23,487,487,29,22,7,2,1

3,108,108,16,16,0,1,0
35,115,115,36,36,0,1,0
31,121,121,17,17,0,1,0
13,138,138,28,3,25,2,1
34,138,138,1,1,0,1,0
1,154,154,34,27,7,2,1
41,178,178,18,18,0,1,0
14,184,184,1,1,0,1,0
24,195,195,12,4,8,3,2
19,219,219,52,52,0,1,0
36,220,220,34,10,24,2,1
25,225,225,21,21,0,1,0
32,235,235,17,17,0,1,0
21,236,236,9,4,5,2,1
40,265,265,31,22,9,4,3
17,275,275,4,4,0,1,0
18,275,275,35,35,0,1,0
7,290,290,8,8,0,1,0
22,292,292,8,8,0,1,0
20,306,306,2,2,0,1,0
11,316,316,28,5,23,2,1
16,316,316,23,23,0,1,0
37,318,318,22,10,12,4,3
28,322,322,18,18,0,1,0
15,330,330,29,29,0,1,0
38,331,331,29,5,24,3,2
27,338,338,1,1,0,1,0
6,341,341,16,16,0,1,0
0,382,382,38,24,14,2,1
12,384,384,18,18,0,1,0
4,392,392,7,7,0,1,0
23,405,405,35,5,30,3,2
9,420,420,69,41,28,2,1
5,429,429,39,18,21,4,3
29,430,430,51,40,11,2,1
39,442,442,6,6,0,1,0
33,452,452,63,63,0,1,0
43,453,453,51,51,0,1,0
26,453,453,41,24,17,2,1
2,473,473,19,9,10,2,1
30,477,477,121,82,39,3,2
42,477,477,16,16,0,1,0
10,481,481,27,27,0,1,0
8,497,497,23,13,10,3,2

5,101,101,1,1,0,1,0
21,103,103,6,6,0,1,0
34,122,122,1,1,0,1,0
4,158,158,28,28,0,1,0
33,168,168,13,1,12,2,1
6,185,185,3,3,0,1,0
16,211,211,34,34,0,1,0
29,212,212,15,15,0,1,0
13,221,221,47,2,45,4,3
15,239,239,12,12,0,1,0
11,241,241,6,6,0,1,0
9,248,248,26,26,0,1,0
32,253,253,33,9,24,4,3
37,261,261,15,2,13,2,1
39,269,269,29,13,16,2,1
31,272,272,73,44,29,2,1
19,272,272,10,10,0,1,0
28,277,277,82,82,0,1,0
35,279,279,3,3,0,1,0
25,303,303,9,9,0,1,0
30,310,310,11,11,0,1,0
20,315,315,29,29,0,1,0
40,328,328,76,8,68,3,2
3,329,329,16,16,0,1,0
38,337,337,33,1,32,2,1
10,356,356,22,5,17,4,3
27,360,360,5,5,0,1,0
1,364,364,19,1,18,3,2
7,368,368,44,3,41,2,1
36,385,385,33,1,32,3,2
18,396,396,38,27,11,2,1
0,414,414,9,9,0,1,0
8,419,419,61,49,12,4,3
12,429,429,79,79,0,1,0
24,430,430,75,75,0,1,0
23,442,442,24,24,0,1,0
14,448,448,72,72,0,1,0
17,452,452,39,39,0,1,0
26,455,455,94,22,72,4,3
2,456,456,63,20,43,2,1
22,462,462,5,5,0,1,0

32,105,105,16,1,15,2,1
36,116,116,3,3,0,1,0
17,128,128,14,14,0,1,0
4,133,133,1,1,0,1,0
18,151,151,4,1,3,2,1
3,168,168,56,47,9,4,3
14,169,169,10,10,0,1,0
41,191,191,15,15,0,1,0
21,199,199,10,10,0,1,0
35,205,205,33,33,0,1,0
37,206,206,6,1,5,2,1
24,216,216,12,12,0,1,0
1,226,226,1,1,0,1,0
47,231,231,28,28,0,1,0
5,237,237,1,1,0,1,0
43,242,242,82,1,81,4,3
38,247,247,2,2,0,1,0
30,248,248,68,40,28,3,2
15,250,250,29,5,24,4,3
34,257,257,13,13,0,1,0
6,288,288,17,4,13,2,1
8,313,313,7,4,3,2,1
46,315,315,7,7,0,1,0
25,319,319,24,24,0,1,0
48,323,323,58,37,21,4,3
2,345,345,30,30,0,1,0
10,358,358,1,1,0,1,0
9,363,363,14,14,0,1,0
45,378,378,19,19,0,1,0
40,388,388,41,41,0,1,0
20,393,393,60,60,0,1,0
27,397,397,8,8,0,1,0
13,420,420,23,23,0,1,0
0,424,424,1,1,0,1,0
7,426,426,45,45,0,1,0
11,432,432,18,6,12,3,2
12,433,433,15,5,10,4,3
42,434,434,5,5,0,1,0
44,436,436,23,23,0,1,0
28,445,445,98,53,45,4,3
26,461,461,14,1,13,3,2
22,462,462,43,43,0,1,0
39,471,471,21,11,10,2,1
31,471,471,65,50,15,2,1
29,474,474,86,37,49,2,1
33,477,477,8,8,0,1,0
19,480,480,63,52,11,2,1
23,483,483,23,9,14,2,1
16,492,492,8,8,0,1,0

2,103,103,19,1,18,2,1
12,106,106,16,16,0,1,0
23,109,109,11,7,4,2,1
3,125,125,1,1,0,1,0
25,132,132,9,2,7,2,1
30,134,134,15,15,0,1,0
17,138,138,24,2,22,3,2
6,144,144,5,5,0,1,0
1,159,159,1,1,0,1,0
4,160,160,11,11,0,1,0
21,166,166,13,2,11,2,1
32,178,178,7,7,0,1,0
27,196,196,26,26,0,1,0
11,214,214,25,25,0,1,0
10,215,215,5,1,4,2,1
29,228,228,3,3,0,1,0
20,235,235,33,33,0,1,0
37,242,242,5,5,0,1,0
19,243,243,27,27,0,1,0
13,254,254,132,74,58,3,2
36,266,266,54,54,0,1,0
34,288,288,40,40,0,1,0
24,302,302,32,19,13,2,1
14,325,325,24,24,0,1,0
31,327,327,9,1,8,2,1
16,338,338,97,67,30,2,1
15,344,344,9,9,0,1,0
7,362,362,9,9,0,1,0
28,381,381,81,81,0,1,0
38,384,384,9,9,0,1,0
9,422,422,29,6,23,3,2
5,426,426,1,1,0,1,0
8,432,432,3,3,0,1,0
35,440,440,66,66,0,1,0
33,444,444,17,11,6,2,1
18,446,446,96,96,0,1,0
26,465,465,23,23,0,1,0
22,479,479,131,72,59,4,3
0,493,493,5,5,0,1,0

6,113,113,21,21,0,1,0
11,123,123,25,18,7,2,1
15,128,128,8,8,0,1,0
14,129,129,10,1,9,2,1
12,129,129,24,12,12,3,2
23,129,129,3,3,0,1,0
4,157,157,5,5,0,1,0
35,165,165,7,2,5,2,1
7,171,171,4,4,0,1,0
17,184,184,39,39,0,1,0
34,201,201,32,5,27,3,2
19,203,203,84,84,0,1,0
21,203,203,14,6,8,3,2
22,220,220,24,4,20,4,3
9,235,235,6,3,3,2,1
24,246,246,7,3,4,2,1
26,248,248,7,7,0,1,0
10,249,249,29,8,21,3,2
13,252,252,73,20,53,3,2
2,294,294,16,16,0,1,0
3,305,305,42,42,0,1,0
28,306,306,88,88,0,1,0
18,308,308,40,35,5,2,1
5,317,317,36,7,29,2,1
1,318,318,8,8,0,1,0
29,343,343,25,13,12,4,3
0,368,368,41,29,12,4,3
37,372,372,8,8,0,1,0
27,380,380,27,27,0,1,0
36,387,387,89,89,0,1,0
16,404,404,1,1,0,1,0
30,417,417,4,4,0,1,0
31,434,434,49,49,0,1,0
25,439,439,17,4,13,2,1
20,456,456,93,7,86,3,2
32,466,466,32,32,0,1,0
38,483,483,9,9,0,1,0
33,488,488,12,4,8,2,1
8,492,492,6,3,3,2,1

15,104,104,1,1,0,1,0
35,108,108,15,15,0,1,0
31,150,150,29,29,0,1,0
40,151,151,1,1,0,1,0
27,175,175,6,3,3,2,1
6,178,178,11,1,10,3,2
28,182,182,14,8,6,3,2
24,189,189,4,4,0,1,0
44,203,203,34,2,32,4,3
42,203,203,16,16,0,1,0
14,237,237,35,15,20,3,2
2,255,255,14,8,6,2,1
18,256,256,22,4,18,3,2
3,260,260,6,6,0,1,0
20,272,272,45,42,3,2,1
38,273,273,48,3,45,4,3
29,282,282,2,2,0,1,0
30,288,288,2,2,0,1,0
4,301,301,66,66,0,1,0
46,303,303,16,16,0,1,0
43,307,307,9,2,7,2,1
17,311,311,11,2,9,4,3
9,321,321,27,15,12,3,2
22,332,332,4,4,0,1,0
1,347,347,9,5,4,2,1
37,348,348,103,13,90,4,3
5,353,353,2,2,0,1,0
41,358,358,4,4,0,1,0
34,368,368,2,2,0,1,0
11,381,381,45,45,0,1,0
26,389,389,25,25,0,1,0
10,393,393,17,17,0,1,0
45,395,395,43,43,0,1,0
33,417,417,28,8,20,2,1
47,425,425,7,7,0,1,0
21,433,433,8,8,0,1,0
23,441,441,2,2,0,1,0
0,450,450,8,4,4,2,1
12,456,456,16,16,0,1,0
19,458,458,25,5,20,3,2
13,461,461,51,5,46,3,2
7,461,461,67,43,24,2,1
39,463,463,28,28,0,1,0
16,471,471,98,98,0,1,0
48,475,475,5,5,0,1,0
32,479,479,114,99,15,4,3
25,479,479,7,7,0,1,0
8,486,486,50,35,15,2,1
36,491,491,177,93,84,4,3

34,114,114,1,1,0,1,0
36,125,125,6,6,0,1,0
35,130,130,40,2,38,3,2
39,144,144,18,6,12,2,1
42,146,146,23,8,15,4,3
30,153,153,22,22,0,1,0
8,167,167,19,12,7,2,1
17,168,168,10,10,0,1,0
4,175,175,11,11,0,1,0
24,187,187,22,2,20,2,1
18,210,210,26,5,21,2,1
20,214,214,14,14,0,1,0
31,223,223,2,2,0,1,0
13,250,250,8,8,0,1,0
43,253,253,62,11,51,4,3
16,253,253,8,1,7,2,1
25,255,255,5,5,0,1,0
45,264,264,30,30,0,1,0
41,264,264,7,1,6,2,1
29,269,269,41,41,0,1,0
10,278,278,18,18,0,1,0
15,294,294,1,1,0,1,0
27,305,305,2,2,0,1,0
2,322,322,1,1,0,1,0
40,324,324,63,42,21,2,1
22,327,327,97,42,55,3,2
3,350,350,2,2,0,1,0
14,352,352,2,2,0,1,0
19,373,373,20,20,0,1,0
0,384,384,13,7,6,3,2
21,388,388,183,183,0,1,0
44,420,420,15,1,14,2,1
11,427,427,9,9,0,1,0
46,436,436,54,2,52,4,3
1,437,437,77,77,0,1,0
5,447,447,9,9,0,1,0
32,452,452,42,10,32,4,3
7,459,459,8,1,7,2,1
33,469,469,26,26,0,1,0
26,470,470,41,19,22,4,3
28,471,471,53,17,36,4,3
12,481,481,9,1,8,2,1
6,486,486,21,2,19,2,1
37,492,492,4,4,0,1,0
23,492,492,16,16,0,1,0
38,500,500,37,37,0,1,0
9,500,500,10,4,6,2,1

9,105,105,10,10,0,1,0
0,108,108,14,3,11,2,1
11,118,118,39,39,0,1,0
34,120,120,11,3,8,3,2
1,127,127,7,7,0,1,0
14,134,134,1,1,0,1,0
21,135,135,3,3,0,1,0
33,179,179,2,2,0,1,0
6,204,204,74,11,63,4,3
36,262,262,14,6,8,3,2
3,272,272,37,3,34,4,3
4,291,291,46,23,23,2,1
13,303,303,40,40,0,1,0
10,312,312,34,34,0,1,0
24,323,323,81,81,0,1,0
30,345,345,3,3,0,1,0
25,347,347,88,56,32,3,2
31,348,348,94,30,64,4,3
7,356,356,7,7,0,1,0
23,366,366,20,20,0,1,0
32,387,387,48,48,0,1,0
35,401,401,67,67,0,1,0
26,423,423,12,4,8,3,2
17,427,427,13,2,11,2,1
15,429,429,41,31,10,2,1
2,430,430,38,17,21,2,1
19,436,436,58,58,0,1,0
20,445,445,40,40,0,1,0
22,460,460,1,1,0,1,0
28,462,462,48,48,0,1,0
29,463,463,44,8,36,2,1
5,468,468,1,1,0,1,0
18,485,485,17,8,9,2,1
12,487,487,111,57,54,3,2
16,487,487,14,6,8,3,2
8,489,489,11,11,0,1,0
27,496,496,105,48,57,4,3

32,140,140,16,16,0,1,0
29,145,145,3,3,0,1,0
35,146,146,3,3,0,1,0
19,152,152,4,4,0,1,0
25,163,163,10,1,9,2,1
2,176,176,52,47,5,2,1
13,176,176,5,5,0,1,0
12,180,180,3,3,0,1,0
27,190,190,1,1,0,1,0
7,208,208,38,38,0,1,0
1,228,228,15,15,0,1,0
24,252,252,12,12,0,1,0
16,276,276,59,14,45,4,3
20,283,283,20,20,0,1,0
39,299,299,9,9,0,1,0
37,302,302,108,8,100,3,2
30,303,303,8,3,5,2,1
10,306,306,4,4,0,1,0
22,311,311,12,12,0,1,0
15,315,315,12,12,0,1,0
6,324,324,1,1,0,1,0
8,342,342,36,27,9,2,1
33,344,344,40,26,14,2,1
4,353,353,82,82,0,1,0
26,359,359,40,40,0,1,0
5,360,360,23,11,12,2,1
9,365,365,25,11,14,3,2
28,378,378,12,12,0,1,0
18,384,384,60,60,0,1,0
3,387,387,61,61,0,1,0
34,388,388,11,2,9,2,1
21,397,397,14,1,13,4,3
23,406,406,71,71,0,1,0
31,420,420,303,279,24,4,3
38,432,432,11,4,7,2,1
36,438,438,2,2,0,1,0
11,438,438,53,11,42,3,2
17,440,440,2,2,0,1,0
14,482,482,55,46,9,4,3
0,493,493,46,4,42,3,2

23,102,102,20,12,8,3,2
35,117,117,20,12,8,2,1
17,128,128,4,4,0,1,0
13,145,145,4,1,3,2,1
0,151,151,12,12,0,1,0
22,157,157,8,4,4,2,1
2,158,158,9,3,6,2,1
21,160,160,2,2,0,1,0
30,170,170,22,8,14,2,1
4,181,181,33,33,0,1,0
39,196,196,37,13,24,2,1
16,203,203,15,1,14,2,1
7,220,220,37,37,0,1,0
33,232,232,23,23,0,1,0
20,243,243,29,2,27,4,3
18,264,264,15,3,12,4,3
14,267,267,3,3,0,1,0
37,270,270,84,3,81,4,3
27,288,288,9,5,4,2,1
24,288,288,8,8,0,1,0
10,291,291,33,33,0,1,0
42,300,300,11,4,7,2,1
9,305,305,82,44,38,2,1
19,318,318,48,17,31,2,1
1,327,327,14,2,12,2,1
34,327,327,10,10,0,1,0
38,346,346,64,25,39,2,1
41,359,359,5,5,0,1,0
15,364,364,8,4,4,2,1
3,364,364,88,52,36,4,3
12,371,371,12,12,0,1,0
36,388,388,22,7,15,2,1
32,391,391,18,18,0,1,0
29,393,393,6,6,0,1,0
11,397,397,1,1,0,1,0
8,415,415,13,7,6,3,2
26,421,421,31,9,22,3,2
40,430,430,20,20,0,1,0
28,440,440,120,120,0,1,0
31,450,450,17,9,8,3,2
6,472,472,19,19,0,1,0
5,482,482,91,34,57,4,3
25,485,485,31,8,23,2,1

0,107,107,23,23,0,1,0
6,108,108,25,25,0,1,0
31,116,116,27,27,0,1,0
20,120,120,1,1,0,1,0
5,127,127,10,10,0,1,0
25,133,133,10,10,0,1,0
21,162,162,17,17,0,1,0
7,167,167,31,31,0,1,0
18,171,171,1,1,0,1,0
29,195,195,20,20,0,1,0
27,229,229,21,21,0,1,0
19,233,233,17,13,4,2,1
13,239,239,15,8,7,2,1
2,249,249,8,4,4,2,1
8,257,257,12,4,8,3,2
11,257,257,65,25,40,3,2
42,266,266,26,2,24,3,2
43,278,278,42,42,0,1,0
41,280,280,12,12,0,1,0
37,284,284,19,1,18,3,2
14,290,290,13,1,12,3,2
3,303,303,44,44,0,1,0
15,311,311,3,3,0,1,0
34,312,312,37,19,18,2,1
36,312,312,15,15,0,1,0
40,320,320,5,5,0,1,0
12,322,322,24,24,0,1,0
9,332,332,29,25,4,2,1
24,352,352,3,3,0,1,0
10,353,353,51,51,0,1,0
17,357,357,10,10,0,1,0
1,358,358,5,5,0,1,0
22,363,363,17,17,0,1,0
28,386,386,10,10,0,1,0
4,392,392,16,16,0,1,0
39,395,395,70,2,68,3,2
26,401,401,55,2,53,3,2
35,421,421,10,10,0,1,0
38,423,423,59,43,16,3,2
30,447,447,118,118,0,1,0
32,448,448,44,6,38,4,3
16,450,450,5,1,4,2,1
33,476,476,55,55,0,1,0
23,500,500,28,20,8,3,2

34,100,100,2,2,0,1,0
17,119,119,8,8,0,1,0
25,122,122,7,4,3,2,1
19,139,139,15,9,6,2,1
9,145,145,5,5,0,1,0
12,150,150,23,23,0,1,0
10,151,151,14,4,10,3,2
18,160,160,4,1,3,2,1
7,184,184,4,4,0,1,0
5,188,188,47,47,0,1,0
21,198,198,67,11,56,3,2
11,199,199,14,14,0,1,0
31,218,218,52,28,24,3,2
15,236,236,76,76,0,1,0
20,244,244,45,45,0,1,0
36,263,263,4,4,0,1,0
4,273,273,11,11,0,1,0
8,280,280,10,10,0,1,0
37,298,298,39,29,10,2,1
32,304,304,13,13,0,1,0
27,310,310,56,42,14,3,2
22,315,315,14,14,0,1,0
33,341,341,20,20,0,1,0
13,344,344,50,50,0,1,0
1,376,376,12,3,9,2,1
26,426,426,3,3,0,1,0
35,429,429,62,62,0,1,0
30,431,431,4,4,0,1,0
3,432,432,67,67,0,1,0
0,452,452,81,81,0,1,0
2,452,452,8,8,0,1,0
29,461,461,165,165,0,1,0
23,466,466,8,8,0,1,0
16,470,470,114,74,40,2,1
6,472,472,49,49,0,1,0
14,483,483,19,19,0,1,0
24,487,487,12,4,8,3,2
28,497,497,22,22,0,1,0

28,102,102,8,4,4,2,1
35,123,123,28,28,0,1,0
15,124,124,10,10,0,1,0
0,129,129,21,4,17,2,1
3,135,135,20,20,0,1,0
10,141,141,3,3,0,1,0
24,142,142,14,14,0,1,0
16,148,148,5,5,0,1,0
11,158,158,10,10,0,1,0
1,177,177,63,16,47,2,1
19,185,185,33,5,28,3,2
22,193,193,50,3,47,4,3
20,212,212,26,26,0,1,0
29,212,212,21,21,0,1,0
2,212,212,13,9,4,2,1
23,218,218,4,4,0,1,0
8,244,244,7,7,0,1,0
33,255,255,4,1,3,2,1
34,256,256,13,5,8,3,2
26,257,257,95,95,0,1,0
25,261,261,5,5,0,1,0
39,314,314,13,13,0,1,0
27,318,318,49,13,36,3,2
17,326,326,34,13,21,2,1
14,363,363,13,9,4,2,1
5,364,364,29,29,0,1,0
9,378,378,10,10,0,1,0
12,389,389,111,111,0,1,0
38,408,408,13,13,0,1,0
37,415,415,43,4,39,4,3
30,422,422,62,8,54,4,3
32,442,442,36,23,13,4,3
6,443,443,55,13,42,2,1
4,446,446,14,14,0,1,0
13,453,453,8,5,3,2,1
36,471,471,14,3,11,2,1
18,479,479,36,36,0,1,0
7,481,481,43,43,0,1,0
21,482,482,30,30,0,1,0
31,495,495,13,10,3,2,1

8,121,121,2,2,0,1,0
36,121,121,7,7,0,1,0
32,127,127,12,12,0,1,0
16,154,154,12,12,0,1,0
26,174,174,36,18,18,4,3
2,179,179,16,4,12,3,2
27,180,180,2,2,0,1,0
39,180,180,62,62,0,1,0
18,185,185,23,23,0,1,0
35,186,186,36,36,0,1,0
25,205,205,9,3,6,3,2
30,217,217,17,2,15,3,2
31,237,237,28,28,0,1,0
10,240,240,2,2,0,1,0
20,240,240,11,11,0,1,0
37,247,247,19,5,14,4,3
17,258,258,34,8,26,2,1
19,268,268,14,14,0,1,0
0,284,284,2,2,0,1,0
12,298,298,54,54,0,1,0
4,312,312,4,4,0,1,0
40,321,321,66,27,39,4,3
34,330,330,66,66,0,1,0
42,340,340,22,22,0,1,0
15,351,351,110,32,78,3,2
7,351,351,40,28,12,4,3
23,354,354,11,5,6,2,1
43,358,358,36,22,14,2,1
24,360,360,32,32,0,1,0
9,396,396,60,60,0,1,0
22,413,413,13,4,9,4,3
41,413,413,14,1,13,2,1
21,413,413,3,3,0,1,0
33,414,414,4,4,0,1,0
5,424,424,16,16,0,1,0
13,424,424,100,100,0,1,0
29,427,427,13,4,9,4,3
11,427,427,22,8,14,3,2
14,429,429,22,6,16,3,2
3,434,434,1,1,0,1,0
1,443,443,16,16,0,1,0
6,461,461,88,61,27,4,3
28,484,484,24,5,19,2,1
38,496,496,18,9,9,2,1

29,126,126,26,26,0,1,0
28,156,156,11,11,0,1,0
24,158,158,13,13,0,1,0
41,164,164,35,35,0,1,0
26,167,167,32,32,0,1,0
3,169,169,9,9,0,1,0
30,196,196,21,15,6,3,2
6,203,203,13,13,0,1,0
42,208,208,1,1,0,1,0
33,223,223,88,67,21,2,1
10,225,225,9,9,0,1,0
43,241,241,4,4,0,1,0
22,247,247,39,39,0,1,0
15,265,265,19,7,12,2,1
38,267,267,27,27,0,1,0
27,273,273,34,34,0,1,0
37,277,277,9,9,0,1,0
44,278,278,19,11,8,2,1
11,279,279,42,12,30,3,2
2,288,288,3,3,0,1,0
0,295,295,2,2,0,1,0
21,299,299,19,4,15,2,1
32,304,304,21,21,0,1,0
16,315,315,45,45,0,1,0
39,318,318,10,6,4,2,1
8,335,335,36,29,7,2,1
23,340,340,39,39,0,1,0
17,349,349,7,4,3,2,1
40,361,361,22,17,5,2,1
13,382,382,64,64,0,1,0
20,392,392,36,13,23,3,2
19,406,406,36,30,6,2,1
4,412,412,28,28,0,1,0
18,431,431,38,38,0,1,0
35,431,431,13,3,10,2,1
34,461,461,99,9,90,4,3
9,464,464,4,1,3,2,1
12,472,472,71,5,66,3,2
36,476,476,39,39,0,1,0
31,480,480,7,3,4,2,1
7,482,482,4,4,0,1,0
14,485,485,39,39,0,1,0
25,488,488,3,3,0,1,0
1,491,491,43,17,26,2,1
5,499,499,39,3,36,4,3

28,100,100,5,2,3,2,1
34,117,117,19,19,0,1,0
32,122,122,25,1,24,4,3
29,135,135,2,2,0,1,0
20,179,179,34,34,0,1,0
30,187,187,60,48,12,4,3
16,205,205,6,3,3,2,1
33,213,213,10,10,0,1,0
17,217,217,30,10,20,2,1
35,229,229,6,6,0,1,0
24,237,237,15,6,9,4,3
10,242,242,39,39,0,1,0
12,249,249,25,25,0,1,0
27,249,249,18,18,0,1,0
9,276,276,2,2,0,1,0
26,277,277,42,7,35,2,1
19,278,278,5,5,0,1,0
14,297,297,63,15,48,4,3
23,323,323,53,32,21,4,3
1,325,325,15,3,12,3,2
13,332,332,32,13,19,2,1
8,353,353,54,54,0,1,0
6,384,384,13,13,0,1,0
15,406,406,71,71,0,1,0
5,413,413,4,4,0,1,0
4,420,420,26,26,0,1,0
2,420,420,30,15,15,2,1
22,423,423,86,86,0,1,0
11,429,429,20,8,12,4,3
7,436,436,157,88,69,4,3
3,438,438,2,2,0,1,0
21,438,438,30,30,0,1,0
18,453,453,11,11,0,1,0
31,461,461,41,17,24,4,3
25,466,466,7,7,0,1,0
0,494,494,228,228,0,1,0

7,101,101,1,1,0,1,0
12,112,112,36,28,8,3,2
22,146,146,36,36,0,1,0
31,149,149,21,4,17,2,1
0,154,154,15,15,0,1,0
5,158,158,4,1,3,2,1
8,158,158,17,17,0,1,0
23,181,181,17,17,0,1,0
32,204,204,9,9,0,1,0
6,209,209,91,70,21,2,1
13,218,218,6,6,0,1,0
24,225,225,17,17,0,1,0
28,228,228,7,7,0,1,0
18,228,228,5,5,0,1,0
30,234,234,20,10,10,2,1
11,241,241,2,2,0,1,0
1,251,251,11,11,0,1,0
10,256,256,52,15,37,3,2
19,263,263,31,31,0,1,0
29,267,267,14,14,0,1,0
38,325,325,20,2,18,2,1
37,326,326,18,6,12,2,1
2,354,354,44,13,31,2,1
25,354,354,15,9,6,2,1
3,371,371,1,1,0,1,0
27,376,376,68,68,0,1,0
36,401,401,98,98,0,1,0
33,401,401,5,2,3,2,1
20,405,405,66,33,33,2,1
14,416,416,27,7,20,2,1
4,425,425,69,6,63,4,3
17,439,439,69,69,0,1,0
9,446,446,19,16,3,2,1
26,447,447,33,21,12,3,2
21,456,456,115,115,0,1,0
34,470,470,3,3,0,1,0
39,482,482,60,9,51,4,3
16,487,487,6,3,3,2,1
15,496,496,8,8,0,1,0
35,496,496,25,25,0,1,0

4,101,101,2,2,0,1,0
22,102,102,4,1,3,2,1
9,102,102,12,12,0,1,0
39,105,105,26,10,16,3,2
7,108,108,10,10,0,1,0
51,109,109,11,11,0,1,0
16,114,114,9,1,8,3,2
21,162,162,2,2,0,1,0
10,166,166,8,8,0,1,0
41,166,166,2,2,0,1,0
11,169,169,1,1,0,1,0
24,183,183,20,20,0,1,0
45,188,188,1,1,0,1,0
31,188,188,1,1,0,1,0
17,192,192,8,5,3,2,1
19,236,236,40,40,0,1,0
18,245,245,26,17,9,2,1
49,255,255,92,80,12,3,2
3,276,276,85,35,50,4,3
29,278,278,11,11,0,1,0
34,280,280,42,42,0,1,0
15,294,294,17,17,0,1,0
47,308,308,3,3,0,1,0
20,322,322,5,5,0,1,0
37,326,326,27,27,0,1,0
6,342,342,6,6,0,1,0
35,346,346,61,20,41,3,2
13,358,358,7,7,0,1,0
1,377,377,5,2,3,2,1
12,383,383,51,51,0,1,0
48,388,388,3,3,0,1,0
46,388,388,19,4,15,4,3
33,388,388,23,14,9,4,3
36,403,403,48,11,37,2,1
25,406,406,7,7,0,1,0
44,414,414,128,44,84,4,3
50,415,415,11,11,0,1,0
40,419,419,48,13,35,2,1
28,425,425,17,5,12,2,1
0,428,428,45,13,32,2,1
14,432,432,4,4,0,1,0
23,441,441,31,14,17,2,1
2,441,441,24,11,13,2,1
5,441,441,38,9,29,2,1
32,458,458,72,27,45,3,2
27,460,460,46,46,0,1,0
8,462,462,2,2,0,1,0
26,474,474,8,8,0,1,0
38,475,475,2,2,0,1,0
43,476,476,13,13,0,1,0
30,491,491,23,20,3,2,1
42,497,497,12,12,0,1,0

41,100,100,5,5,0,1,0
24,112,112,6,6,0,1,0
39,141,141,15,15,0,1,0
14,161,161,3,3,0,1,0
35,164,164,3,3,0,1,0
42,168,168,9,9,0,1,0
29,185,185,6,2,4,2,1
5,197,197,6,6,0,1,0
10,201,201,7,7,0,1,0
23,214,214,68,38,30,3,2
32,215,215,12,12,0,1,0
2,216,216,57,42,15,4,3
37,252,252,14,8,6,2,1
15,267,267,13,13,0,1,0
45,268,268,116,104,12,2,1
34,272,272,12,12,0,1,0
16,278,278,25,2,23,2,1
4,289,289,17,17,0,1,0
31,291,291,17,17,0,1,0
44,292,292,7,1,6,3,2
13,296,296,22,1,21,2,1
30,307,307,67,67,0,1,0
38,309,309,38,38,0,1,0
6,327,327,1,1,0,1,0
21,334,334,1,1,0,1,0
28,339,339,19,13,6,3,2
0,343,343,142,96,46,2,1
22,346,346,1,1,0,1,0
12,357,357,51,51,0,1,0
33,368,368,37,37,0,1,0
43,370,370,72,29,43,2,1
27,372,372,108,108,0,1,0
1,373,373,31,16,15,2,1
40,399,399,9,5,4,2,1
20,420,420,11,11,0,1,0
8,432,432,7,7,0,1,0
25,433,433,9,3,6,3,2
26,433,433,29,29,0,1,0
18,440,440,17,17,0,1,0
17,456,456,1,1,0,1,0
9,458,458,14,14,0,1,0
7,463,463,72,26,46,2,1
19,479,479,1,1,0,1,0
3,480,480,10,10,0,1,0
11,495,495,24,24,0,1,0
36,496,496,19,1,18,2,1

16,100,100,10,6,4,2,1
34,101,101,4,4,0,1,0
26,109,109,3,3,0,1,0
33,125,125,14,14,0,1,0
19,128,128,1,1,0,1,0
13,178,178,21,21,0,1,0
28,182,182,20,8,12,2,1
21,183,183,55,55,0,1,0
14,193,193,53,53,0,1,0
40,216,216,21,7,14,3,2
36,216,216,12,12,0,1,0
27,236,236,24,24,0,1,0
12,238,238,16,16,0,1,0
38,241,241,8,5,3,2,1
4,245,245,23,16,7,2,1
5,269,269,35,35,0,1,0
32,275,275,44,5,39,3,2
22,275,275,30,30,0,1,0
9,286,286,20,13,7,2,1
15,290,290,20,2,18,4,3
41,292,292,1,1,0,1,0
1,294,294,4,4,0,1,0
6,310,310,9,6,3,2,1
10,321,321,12,4,8,3,2
2,324,324,17,1,16,3,2
25,340,340,3,3,0,1,0
0,345,345,35,9,26,2,1
7,347,347,17,17,0,1,0
30,364,364,66,66,0,1,0
11,378,378,14,14,0,1,0
31,384,384,18,18,0,1,0
29,394,394,156,30,126,4,3
8,409,409,58,58,0,1,0
23,430,430,94,94,0,1,0
39,452,452,103,45,58,4,3
24,460,460,22,18,4,2,1
3,462,462,1,1,0,1,0
17,464,464,12,3,9,2,1
18,468,468,30,16,14,2,1
20,470,470,103,91,12,4,3
37,478,478,16,16,0,1,0
35,499,499,16,16,0,1,0

5,110,110,1,1,0,1,0
12,113,113,16,16,0,1,0
32,115,115,5,5,0,1,0
28,115,115,14,2,12,4,3
30,123,123,6,6,0,1,0
33,145,145,13,13,0,1,0
37,151,151,10,10,0,1,0
41,153,153,15,15,0,1,0
13,177,177,12,9,3,2,1
22,184,184,1,1,0,1,0
11,187,187,37,37,0,1,0
23,205,205,18,8,10,2,1
16,212,212,12,12,0,1,0
24,214,214,4,4,0,1,0
36,221,221,3,3,0,1,0
2,227,227,7,7,0,1,0
4,235,235,1,1,0,1,0
31,236,236,78,78,0,1,0
1,245,245,30,22,8,3,2
39,251,251,3,3,0,1,0
19,284,284,10,10,0,1,0
15,291,291,93,50,43,2,1
38,296,296,1,1,0,1,0
9,332,332,11,2,9,2,1
34,345,345,6,6,0,1,0
10,345,345,6,6,0,1,0
21,358,358,54,44,10,2,1
43,372,372,16,16,0,1,0
42,376,376,50,5,45,4,3
6,391,391,131,126,5,2,1
17,399,399,29,3,26,2,1
27,410,410,19,19,0,1,0
26,421,421,30,4,26,3,2
0,424,424,25,18,7,2,1
44,427,427,231,216,15,4,3
3,430,430,9,9,0,1,0
40,438,438,130,46,84,4,3
29,444,444,3,3,0,1,0
25,447,447,4,4,0,1,0
14,457,457,10,3,7,2,1
35,466,466,29,7,22,2,1
20,472,472,16,16,0,1,0
7,488,488,8,4,4,2,1
18,493,493,3,3,0,1,0
8,495,495,68,68,0,1,0

24,114,114,22,22,0,1,0
31,114,114,8,8,0,1,0
18,132,132,1,1,0,1,0
20,138,138,34,34,0,1,0
32,167,167,37,9,28,2,1
35,202,202,19,19,0,1,0
4,204,204,56,56,0,1,0
14,205,205,1,1,0,1,0
11,215,215,24,24,0,1,0
28,232,232,4,1,3,2,1
42,246,246,80,57,23,2,1
8,257,257,15,15,0,1,0
12,258,258,1,1,0,1,0
0,269,269,11,3,8,2,1
13,269,269,20,20,0,1,0
25,282,282,9,9,0,1,0
36,289,289,18,18,0,1,0
15,311,311,80,80,0,1,0
39,314,314,38,19,19,3,2
17,316,316,12,3,9,2,1
16,341,341,1,1,0,1,0
9,350,350,42,10,32,2,1
1,353,353,78,9,69,3,2
27,357,357,29,13,16,3,2
2,380,380,3,3,0,1,0
5,387,387,1,1,0,1,0
22,387,387,6,6,0,1,0
21,398,398,60,42,18,4,3
33,398,398,18,18,0,1,0
26,406,406,16,2,14,3,2
19,407,407,7,1,6,2,1
38,412,412,18,12,6,2,1
30,412,412,45,45,0,1,0
10,414,414,16,16,0,1,0
41,417,417,42,37,5,2,1
29,429,429,5,5,0,1,0
40,440,440,3,3,0,1,0
3,445,445,9,9,0,1,0
7,448,448,36,4,32,2,1
6,458,458,95,17,78,4,3
37,461,461,116,30,86,3,2
34,462,462,31,31,0,1,0
23,471,471,71,37,34,2,1

21,118,118,23,1,22,4,3
15,118,118,2,2,0,1,0
14,120,120,10,10,0,1,0
22,122,122,17,17,0,1,0
10,129,129,12,3,9,2,1
9,157,157,6,6,0,1,0
25,160,160,8,8,0,1,0
32,170,170,10,10,0,1,0
34,172,172,2,2,0,1,0
23,172,172,7,7,0,1,0
28,174,174,15,3,12,2,1
24,191,191,38,38,0,1,0
17,201,201,12,3,9,4,3
13,205,205,50,50,0,1,0
41,225,225,3,3,0,1,0
2,237,237,8,4,4,2,1
26,255,255,44,44,0,1,0
36,284,284,20,20,0,1,0
30,288,288,20,4,16,3,2
19,313,313,18,4,14,2,1
40,326,326,54,54,0,1,0
29,329,329,74,68,6,3,2
5,331,331,52,52,0,1,0
4,333,333,34,28,6,2,1
35,360,360,19,14,5,2,1
37,363,363,95,51,44,2,1
6,371,371,14,14,0,1,0
18,374,374,19,19,0,1,0
33,375,375,14,14,0,1,0
12,392,392,2,2,0,1,0
16,396,396,19,19,0,1,0
7,398,398,1,1,0,1,0
39,409,409,67,67,0,1,0
31,413,413,39,29,10,2,1
0,420,420,164,130,34,3,2
11,425,425,63,25,38,4,3
20,433,433,11,11,0,1,0
8,445,445,7,7,0,1,0
27,448,448,24,24,0,1,0
3,449,449,16,16,0,1,0
1,451,451,75,28,47,2,1
38,452,452,33,33,0,1,0

28,119,119,25,10,15,2,1
27,120,120,10,10,0,1,0
4,121,121,8,8,0,1,0
8,127,127,3,3,0,1,0
15,142,142,1,1,0,1,0
6,172,172,38,1,37,2,1
22,188,188,23,8,15,4,3
31,191,191,17,14,3,2,1
9,192,192,60,41,19,2,1
32,198,198,10,10,0,1,0
24,206,206,12,12,0,1,0
29,210,210,10,10,0,1,0
1,217,217,17,11,6,3,2
11,226,226,53,23,30,3,2
14,240,240,50,50,0,1,0
13,241,241,3,3,0,1,0
3,254,254,29,29,0,1,0
10,264,264,36,15,21,2,1
25,269,269,28,8,20,3,2
30,269,269,46,46,0,1,0
33,313,313,12,12,0,1,0
21,314,314,66,59,7,2,1
2,314,314,80,80,0,1,0
35,339,339,110,56,54,4,3
16,344,344,14,3,11,2,1
36,350,350,23,23,0,1,0
5,357,357,3,3,0,1,0
23,371,371,40,2,38,3,2
12,380,380,84,71,13,2,1
18,447,447,15,15,0,1,0
0,448,448,22,22,0,1,0
17,457,457,56,48,8,2,1
20,479,479,18,12,6,3,2
7,489,489,6,6,0,1,0
34,496,496,42,42,0,1,0
19,498,498,9,6,3,2,1
26,500,500,27,17,10,3,2

36,115,115,7,7,0,1,0
26,123,123,2,2,0,1,0
32,128,128,17,17,0,1,0
9,143,143,19,19,0,1,0
29,143,143,12,12,0,1,0
39,163,163,6,6,0,1,0
27,181,181,17,17,0,1,0
30,221,221,14,5,9,4,3
41,222,222,9,2,7,2,1
0,222,222,35,15,20,3,2
12,223,223,10,10,0,1,0
42,223,223,8,1,7,2,1
20,224,224,31,31,0,1,0
8,247,247,1,1,0,1,0
17,251,251,24,24,0,1,0
18,254,254,116,116,0,1,0
19,258,258,8,2,6,3,2
1,272,272,4,4,0,1,0
25,275,275,9,9,0,1,0
2,284,284,1,1,0,1,0
4,307,307,22,22,0,1,0
28,312,312,16,6,10,3,2
15,317,317,6,1,5,2,1
16,321,321,47,47,0,1,0
35,343,343,103,103,0,1,0
24,344,344,50,45,5,2,1
21,361,361,15,7,8,2,1
5,374,374,50,39,11,2,1
38,374,374,59,59,0,1,0
43,382,382,14,5,9,2,1
13,385,385,8,8,0,1,0
22,389,389,22,22,0,1,0
7,405,405,26,26,0,1,0
34,406,406,22,22,0,1,0
6,407,407,13,13,0,1,0
23,416,416,45,45,0,1,0
11,432,432,53,5,48,3,2
40,434,434,47,14,33,2,1
31,445,445,43,43,0,1,0
10,453,453,12,2,10,3,2
3,456,456,17,17,0,1,0
14,464,464,19,19,0,1,0
37,471,471,104,29,75,4,3
33,484,484,133,90,43,3,2

37,116,116,1,1,0,1,0
12,177,177,7,1,6,3,2
25,179,179,18,18,0,1,0
18,180,180,5,1,4,2,1
21,184,184,10,2,8,2,1
27,189,189,15,15,0,1,0
23,200,200,18,4,14,2,1
4,201,201,6,1,5,2,1
40,214,214,9,9,0,1,0
0,218,218,2,2,0,1,0
31,226,226,1,1,0,1,0
34,232,232,23,23,0,1,0
38,238,238,22,22,0,1,0
33,252,252,1,1,0,1,0
8,253,253,6,6,0,1,0
30,254,254,47,47,0,1,0
10,259,259,63,51,12,3,2
24,280,280,18,18,0,1,0
35,304,304,4,4,0,1,0
26,307,307,192,112,80,3,2
11,326,326,30,30,0,1,0
32,331,331,8,8,0,1,0
7,341,341,32,32,0,1,0
19,345,345,48,48,0,1,0
28,359,359,46,46,0,1,0
36,362,362,18,18,0,1,0
1,363,363,5,5,0,1,0
2,368,368,76,76,0,1,0
3,375,375,27,5,22,3,2
6,390,390,78,4,74,3,2
29,407,407,19,19,0,1,0
14,409,409,67,33,34,4,3
5,422,422,34,34,0,1,0
17,433,433,60,32,28,3,2
9,455,455,96,64,32,2,1
13,455,455,4,4,0,1,0
15,459,459,7,7,0,1,0
16,471,471,28,28,0,1,0
22,473,473,122,83,39,4,3
20,474,474,63,63,0,1,0
39,481,481,38,5,33,4,3

14,100,100,25,1,24,3,2
2,105,105,28,28,0,1,0
10,106,106,10,10,0,1,0
19,113,113,19,19,0,1,0
1,130,130,36,25,11,2,1
11,141,141,8,1,7,2,1
23,152,152,12,2,10,2,1
27,168,168,9,4,5,2,1
13,184,184,10,10,0,1,0
3,231,231,24,24,0,1,0
17,275,275,27,23,4,2,1
4,278,278,137,137,0,1,0
15,283,283,19,19,0,1,0
6,284,284,2,2,0,1,0
32,291,291,63,33,30,4,3
25,295,295,34,22,12,4,3
5,322,322,6,6,0,1,0
24,323,323,15,3,12,3,2
22,329,329,12,4,8,2,1
21,338,338,1,1,0,1,0
33,342,342,122,46,76,3,2
12,348,348,2,2,0,1,0
20,351,351,40,40,0,1,0
8,367,367,32,32,0,1,0
30,380,380,39,39,0,1,0
28,403,403,50,38,12,3,2
16,409,409,62,56,6,3,2
34,421,421,60,1,59,4,3
26,424,424,39,6,33,4,3
7,425,425,6,2,4,2,1
35,426,426,15,8,7,2,1
18,432,432,11,11,0,1,0
31,437,437,13,7,6,3,2
9,451,451,25,25,0,1,0
29,457,457,20,20,0,1,0
0,463,463,69,69,0,1,0

27,105,105,6,6,0,1,0
21,114,114,1,1,0,1,0
12,114,114,14,14,0,1,0
22,117,117,14,2,12,4,3
3,121,121,7,4,3,2,1
19,127,127,7,7,0,1,0
36,170,170,2,2,0,1,0
37,182,182,18,12,6,2,1
30,192,192,5,2,3,2,1
16,194,194,1,1,0,1,0
18,195,195,35,3,32,4,3
26,204,204,13,13,0,1,0
24,230,230,100,100,0,1,0
1,232,232,31,31,0,1,0
32,245,245,8,8,0,1,0
28,249,249,18,4,14,3,2
11,273,273,7,2,5,2,1
9,298,298,8,8,0,1,0
17,308,308,28,2,26,3,2
33,323,323,39,39,0,1,0
14,324,324,37,37,0,1,0
5,324,324,18,15,3,2,1
34,342,342,34,34,0,1,0
31,347,347,14,1,13,2,1
6,358,358,115,115,0,1,0
38,382,382,2,2,0,1,0
35,383,383,9,9,0,1,0
8,383,383,2,2,0,1,0
10,397,397,21,1,20,2,1
2,399,399,64,64,0,1,0
23,400,400,84,55,29,2,1
0,415,415,80,80,0,1,0
25,420,420,161,43,118,4,3
13,451,451,50,50,0,1,0
29,452,452,5,1,4,2,1
4,465,465,58,35,23,2,1
39,471,471,7,7,0,1,0
20,492,492,103,103,0,1,0
15,494,494,40,28,12,4,3
7,494,494,44,38,6,2,1

21,106,106,7,1,6,3,2
31,111,111,8,8,0,1,0
9,146,146,12,2,10,3,2
34,168,168,41,11,30,3,2
12,170,170,53,53,0,1,0
19,197,197,22,22,0,1,0
7,201,201,12,4,8,3,2
4,247,247,137,137,0,1,0
14,248,248,7,4,3,2,1
16,250,250,20,6,14,3,2
20,256,256,9,9,0,1,0
8,279,279,40,4,36,4,3
18,296,296,14,14,0,1,0
6,303,303,2,2,0,1,0
24,304,304,63,3,60,4,3
1,311,311,7,7,0,1,0
3,327,327,1,1,0,1,0
32,328,328,11,11,0,1,0
0,336,336,26,2,24,3,2
17,360,360,69,69,0,1,0
22,364,364,49,1,48,3,2
35,386,386,11,3,8,2,1
11,392,392,40,40,0,1,0
13,393,393,27,27,0,1,0
10,399,399,119,47,72,4,3
25,402,402,41,20,21,2,1
28,402,402,31,19,12,2,1
27,405,405,31,31,0,1,0
15,417,417,5,1,4,2,1
36,420,420,186,186,0,1,0
23,438,438,17,9,8,2,1
2,458,458,30,30,0,1,0
26,466,466,6,6,0,1,0
5,472,472,41,41,0,1,0
33,473,473,21,21,0,1,0
30,485,485,31,31,0,1,0
29,486,486,6,6,0,1,0

9,101,101,21,5,16,2,1
33,118,118,16,16,0,1,0
37,136,136,31,31,0,1,0
35,139,139,14,14,0,1,0
10,141,141,5,5,0,1,0
4,164,164,9,9,0,1,0
0,177,177,2,2,0,1,0
27,180,180,31,9,22,2,1
18,183,183,18,18,0,1,0
28,185,185,4,1,3,2,1
25,203,203,8,8,0,1,0
17,228,228,4,4,0,1,0
7,242,242,11,11,0,1,0
14,259,259,33,33,0,1,0
13,262,262,13,1,12,3,2
31,286,286,14,14,0,1,0
23,289,289,16,16,0,1,0
11,292,292,19,7,12,4,3
38,301,301,5,2,3,2,1
30,304,304,63,63,0,1,0
22,327,327,12,12,0,1,0
26,334,334,21,7,14,2,1
40,335,335,68,12,56,4,3
36,339,339,30,16,14,3,2
34,339,339,105,51,54,4,3
6,350,350,109,109,0,1,0
15,381,381,5,5,0,1,0
5,390,390,29,14,15,2,1
2,396,396,37,37,0,1,0
21,397,397,8,8,0,1,0
24,404,404,59,21,38,2,1
8,411,411,5,5,0,1,0
3,421,421,103,41,62,3,2
12,436,436,47,47,0,1,0
20,440,440,37,13,24,3,2
32,441,441,3,3,0,1,0
1,469,469,13,8,5,2,1
29,477,477,9,3,6,3,2
16,478,478,117,117,0,1,0
19,490,490,37,37,0,1,0
39,495,495,59,59,0,1,0

0,105,105,1,1,0,1,0
21,125,125,26,26,0,1,0
32,134,134,1,1,0,1,0
15,148,148,7,7,0,1,0
35,155,155,21,21,0,1,0
18,172,172,15,3,12,3,2
23,179,179,11,11,0,1,0
4,198,198,35,19,16,2,1
28,201,201,11,11,0,1,0
1,218,218,1,1,0,1,0
16,228,228,19,5,14,2,1
24,234,234,38,38,0,1,0
33,237,237,79,10,69,4,3
17,245,245,3,3,0,1,0
12,257,257,6,6,0,1,0
13,267,267,42,33,9,4,3
27,279,279,34,34,0,1,0
38,308,308,10,10,0,1,0
5,317,317,14,1,13,2,1
6,322,322,69,69,0,1,0
37,329,329,11,1,10,3,2
19,329,329,17,1,16,3,2
8,342,342,3,3,0,1,0
36,360,360,1,1,0,1,0
31,367,367,63,63,0,1,0
3,378,378,8,8,0,1,0
26,381,381,44,23,21,4,3
25,383,383,3,3,0,1,0
39,394,394,16,16,0,1,0
14,395,395,48,18,30,2,1
34,404,404,63,17,46,3,2
11,414,414,50,50,0,1,0
7,424,424,114,96,18,4,3
20,445,445,3,3,0,1,0
22,448,448,1,1,0,1,0
30,470,470,54,54,0,1,0
9,475,475,126,44,82,3,2
29,484,484,131,31,100,3,2
10,487,487,46,16,30,4,3
2,497,497,94,12,82,3,2

11,108,108,18,7,11,2,1
32,110,110,7,7,0,1,0
14,114,114,1,1,0,1,0
29,141,141,13,4,9,2,1
2,142,142,41,12,29,2,1
22,147,147,38,5,33,4,3
21,149,149,1,1,0,1,0
23,162,162,18,14,4,2,1
5,164,164,26,15,11,2,1
6,168,168,15,4,11,2,1
9,171,171,1,1,0,1,0
4,201,201,36,36,0,1,0
36,205,205,21,21,0,1,0
12,211,211,23,23,0,1,0
33,242,242,29,11,18,4,3
37,246,246,20,17,3,2,1
1,257,257,1,1,0,1,0
16,261,261,8,4,4,2,1
30,262,262,26,17,9,2,1
17,272,272,40,40,0,1,0
26,289,289,2,2,0,1,0
13,295,295,76,76,0,1,0
31,299,299,1,1,0,1,0
7,309,309,26,26,0,1,0
35,324,324,14,2,12,4,3
27,331,331,71,44,27,3,2
24,362,362,17,17,0,1,0
10,365,365,97,97,0,1,0
15,386,386,6,3,3,2,1
3,390,390,26,26,0,1,0
19,399,399,48,48,0,1,0
0,399,399,22,8,14,3,2
18,420,420,3,3,0,1,0
34,432,432,16,16,0,1,0
28,435,435,43,10,33,2,1
8,445,445,27,15,12,2,1
20,474,474,65,56,9,4,3
38,474,474,77,77,0,1,0
25,499,499,118,15,103,4,3

2,110,110,6,6,0,1,0
7,111,111,6,6,0,1,0
10,115,115,8,4,4,2,1
9,115,115,1,1,0,1,0
46,116,116,40,40,0,1,0
19,118,118,5,5,0,1,0
36,124,124,12,2,10,3,2
18,129,129,12,6,6,2,1
11,134,134,2,2,0,1,0
29,135,135,5,2,3,2,1
44,160,160,35,23,12,2,1
47,163,163,21,21,0,1,0
32,163,163,9,9,0,1,0
30,177,177,18,18,0,1,0
45,194,194,13,8,5,2,1
4,209,209,9,9,0,1,0
39,211,211,15,2,13,3,2
21,215,215,21,2,19,3,2
42,223,223,50,50,0,1,0
22,225,225,29,25,4,2,1
8,227,227,10,3,7,3,2
5,234,234,8,8,0,1,0
6,242,242,1,1,0,1,0
17,257,257,9,9,0,1,0
33,258,258,45,45,0,1,0
14,263,263,21,21,0,1,0
15,268,268,7,7,0,1,0
1,274,274,1,1,0,1,0
28,314,314,27,27,0,1,0
38,352,352,6,6,0,1,0
20,367,367,82,8,74,3,2
40,370,370,25,25,0,1,0
12,379,379,45,45,0,1,0
37,391,391,14,5,9,2,1
0,400,400,36,36,0,1,0
24,413,413,15,12,3,2,1
43,420,420,46,46,0,1,0
31,427,427,50,27,23,2,1
26,436,436,12,5,7,2,1
35,440,440,2,2,0,1,0
41,442,442,18,18,0,1,0
3,443,443,75,64,11,2,1
16,452,452,2,2,0,1,0
34,455,455,18,7,11,2,1
13,465,465,9,9,0,1,0
23,474,474,3,3,0,1,0
25,488,488,146,94,52,3,2
27,492,492,85,85,0,1,0

0,113,113,10,4,6,2,1
27,114,114,6,6,0,1,0
18,120,120,1,1,0,1,0
32,128,128,18,10,8,2,1
1,130,130,1,1,0,1,0
7,138,138,23,23,0,1,0
4,153,153,5,5,0,1,0
33,158,158,11,11,0,1,0
36,159,159,39,39,0,1,0
19,162,162,12,12,0,1,0
20,182,182,1,1,0,1,0
12,201,201,25,22,3,2,1
24,201,201,1,1,0,1,0
34,219,219,13,4,9,2,1
22,239,239,14,14,0,1,0
26,244,244,3,3,0,1,0
16,268,268,4,1,3,2,1
25,302,302,50,50,0,1,0
21,330,330,67,24,43,2,1
29,340,340,77,77,0,1,0
8,357,357,35,35,0,1,0
10,359,359,14,6,8,2,1
37,360,360,136,28,108,4,3
35,361,361,12,12,0,1,0
17,387,387,27,6,21,2,1
30,388,388,49,49,0,1,0
14,404,404,116,116,0,1,0
11,404,404,131,111,20,2,1
2,406,406,35,28,7,2,1
3,407,407,10,10,0,1,0
31,411,411,21,5,16,3,2
5,416,416,8,8,0,1,0
23,426,426,17,17,0,1,0
9,433,433,73,73,0,1,0
38,457,457,1,1,0,1,0
6,462,462,25,13,12,2,1
28,476,476,44,26,18,4,3
13,483,483,125,14,111,4,3
15,486,486,65,25,40,2,1

2,113,113,27,27,0,1,0
29,115,115,2,2,0,1,0
4,121,121,6,1,5,2,1
32,130,130,7,7,0,1,0
7,131,131,8,2,6,3,2
26,134,134,4,4,0,1,0
24,141,141,10,10,0,1,0
15,149,149,1,1,0,1,0
10,161,161,25,25,0,1,0
13,193,193,17,17,0,1,0
20,194,194,4,4,0,1,0
0,207,207,90,83,7,2,1
19,211,211,4,4,0,1,0
21,211,211,25,25,0,1,0
31,223,223,35,8,27,2,1
36,224,224,22,22,0,1,0
8,225,225,12,6,6,3,2
3,236,236,30,6,24,3,2
34,237,237,19,11,8,3,2
12,278,278,9,9,0,1,0
25,281,281,36,36,0,1,0
1,311,311,133,133,0,1,0
27,318,318,127,61,66,3,2
5,320,320,2,2,0,1,0
17,335,335,8,8,0,1,0
11,336,336,26,8,18,3,2
6,342,342,51,51,0,1,0
16,353,353,2,2,0,1,0
35,362,362,63,63,0,1,0
28,365,365,106,106,0,1,0
33,371,371,36,28,8,2,1
37,382,382,7,7,0,1,0
30,386,386,7,1,6,3,2
14,396,396,12,2,10,3,2
23,415,415,8,2,6,2,1
18,419,419,52,33,19,4,3
22,438,438,45,27,18,4,3
9,462,462,16,16,0,1,0

3,110,110,43,43,0,1,0
21,111,111,5,5,0,1,0
30,117,117,11,11,0,1,0
35,125,125,3,3,0,1,0
18,144,144,17,17,0,1,0
8,153,153,3,3,0,1,0
2,157,157,32,32,0,1,0
23,163,163,61,56,5,2,1
5,165,165,8,4,4,2,1
24,165,165,26,26,0,1,0
39,185,185,49,49,0,1,0
14,190,190,16,2,14,4,3
0,204,204,7,7,0,1,0
9,226,226,41,7,34,3,2
31,228,228,25,18,7,2,1
32,240,240,11,5,6,2,1
11,251,251,46,37,9,2,1
12,252,252,3,3,0,1,0
7,272,272,37,5,32,2,1
16,278,278,5,2,3,2,1
20,295,295,36,36,0,1,0
28,298,298,7,7,0,1,0
13,300,300,26,26,0,1,0
33,321,321,4,4,0,1,0
10,328,328,15,15,0,1,0
29,332,332,13,1,12,4,3
6,334,334,2,2,0,1,0
37,340,340,6,6,0,1,0
38,403,403,41,41,0,1,0
26,406,406,9,9,0,1,0
34,409,409,63,63,0,1,0
17,419,419,57,9,48,4,3
22,428,428,7,3,4,2,1
4,441,441,31,6,25,2,1
36,447,447,84,51,33,4,3
15,454,454,27,27,0,1,0
1,463,463,19,1,18,3,2
25,467,467,47,47,0,1,0
19,494,494,62,22,40,3,2
27,496,496,70,37,33,4,3

39,105,105,27,27,0,1,0
38,112,112,11,11,0,1,0
37,114,114,22,13,9,2,1
28,121,121,2,2,0,1,0
18,131,131,13,2,11,2,1
26,135,135,17,10,7,2,1
34,136,136,11,11,0,1,0
10,145,145,10,3,7,2,1
0,154,154,6,6,0,1,0
40,166,166,7,7,0,1,0
14,169,169,6,6,0,1,0
13,177,177,48,48,0,1,0
24,199,199,21,15,6,2,1
21,215,215,6,2,4,2,1
11,216,216,1,1,0,1,0
22,218,218,10,5,5,2,1
2,221,221,30,30,0,1,0
17,269,269,28,28,0,1,0
41,278,278,80,50,30,4,3
12,288,288,44,14,30,4,3
23,298,298,10,10,0,1,0
16,302,302,24,24,0,1,0
31,302,302,31,13,18,2,1
25,307,307,6,6,0,1,0
9,319,319,2,2,0,1,0
5,332,332,8,8,0,1,0
27,344,344,26,26,0,1,0
4,344,344,6,6,0,1,0
36,352,352,54,54,0,1,0
19,377,377,47,47,0,1,0
1,383,383,10,3,7,2,1
32,419,419,88,46,42,4,3
15,422,422,57,57,0,1,0
30,428,428,37,37,0,1,0
8,432,432,5,5,0,1,0
20,432,432,37,37,0,1,0
7,448,448,87,66,21,4,3
29,451,451,19,19,0,1,0
3,453,453,71,71,0,1,0
6,463,463,94,85,9,2,1
33,477,477,34,23,11,2,1
35,489,489,3,3,0,1,0

32,110,110,8,8,0,1,0
27,118,118,3,3,0,1,0
14,121,121,2,2,0,1,0
0,123,123,2,2,0,1,0
39,123,123,9,3,6,3,2
21,141,141,23,2,21,2,1
1,144,144,6,1,5,2,1
26,144,144,62,62,0,1,0
11,146,146,3,3,0,1,0
2,148,148,23,3,20,3,2
36,157,157,4,1,3,2,1
30,158,158,5,2,3,2,1
18,198,198,20,20,0,1,0
34,205,205,52,52,0,1,0
10,230,230,20,20,0,1,0
5,252,252,28,28,0,1,0
7,273,273,79,11,68,3,2
17,280,280,20,20,0,1,0
38,292,292,31,23,8,3,2
19,298,298,1,1,0,1,0
29,303,303,71,71,0,1,0
12,307,307,49,49,0,1,0
24,324,324,12,12,0,1,0
40,327,327,13,13,0,1,0
9,329,329,12,4,8,2,1
13,342,342,35,11,24,3,2
20,345,345,82,75,7,2,1
28,357,357,14,14,0,1,0
35,376,376,37,2,35,3,2
25,386,386,15,3,12,3,2
4,388,388,53,53,0,1,0
15,395,395,3,3,0,1,0
22,417,417,23,5,18,2,1
41,421,421,45,12,33,4,3
6,425,425,15,15,0,1,0
16,426,426,51,51,0,1,0
8,449,449,19,19,0,1,0
3,476,476,24,9,15,3,2
33,482,482,119,119,0,1,0
31,496,496,40,27,13,2,1
37,496,496,9,1,8,2,1
23,498,498,11,11,0,1,0

31,103,103,7,1,6,3,2
18,127,127,2,2,0,1,0
35,137,137,1,1,0,1,0
39,140,140,11,4,7,2,1
32,145,145,5,5,0,1,0
30,158,158,2,2,0,1,0
38,167,167,26,26,0,1,0
22,173,173,2,2,0,1,0
41,173,173,29,29,0,1,0
21,173,173,11,3,8,2,1
19,184,184,5,5,0,1,0
1,185,185,28,8,20,3,2
13,187,187,3,3,0,1,0
24,198,198,37,7,30,3,2
15,207,207,1,1,0,1,0
12,210,210,7,7,0,1,0
36,212,212,5,5,0,1,0
33,216,216,9,2,7,2,1
44,222,222,14,14,0,1,0
8,242,242,27,27,0,1,0
7,245,245,61,55,6,2,1
6,248,248,6,6,0,1,0
23,263,263,5,5,0,1,0
42,264,264,26,10,16,3,2
4,273,273,56,44,12,3,2
28,288,288,56,56,0,1,0
0,321,321,59,32,27,4,3
40,325,325,31,31,0,1,0
11,340,340,15,1,14,3,2
10,365,365,34,12,22,3,2
2,369,369,64,27,37,2,1
3,371,371,36,4,32,3,2
16,382,382,28,17,11,2,1
34,389,389,20,20,0,1,0
14,394,394,20,20,0,1,0
37,401,401,63,15,48,4,3
43,416,416,97,25,72,4,3
20,432,432,33,23,10,2,1
9,444,444,11,11,0,1,0
27,445,445,137,52,85,4,3
17,446,446,16,16,0,1,0
29,448,448,3,3,0,1,0
26,451,451,56,32,24,4,3
25,459,459,7,7,0,1,0
5,469,469,6,3,3,2,1
45,488,488,62,62,0,1,0

3,100,100,8,8,0,1,0
18,103,103,3,3,0,1,0
31,105,105,8,8,0,1,0
41,109,109,13,13,0,1,0
25,117,117,12,5,7,2,1
47,118,118,31,31,0,1,0
21,119,119,6,6,0,1,0
37,126,126,12,4,8,2,1
29,162,162,32,2,30,4,3
22,169,169,17,3,14,3,2
5,169,169,9,9,0,1,0
12,183,183,9,9,0,1,0
45,183,183,1,1,0,1,0
20,198,198,1,1,0,1,0
16,217,217,16,2,14,2,1
40,218,218,39,9,30,3,2
35,225,225,12,9,3,2,1
10,229,229,6,6,0,1,0
30,261,261,32,25,7,2,1
0,268,268,8,2,6,3,2
8,269,269,55,55,0,1,0
13,282,282,20,20,0,1,0
14,291,291,1,1,0,1,0
39,298,298,8,2,6,3,2
6,300,300,15,5,10,3,2
38,300,300,5,5,0,1,0
19,307,307,130,75,55,4,3
43,309,309,8,2,6,3,2
17,330,330,28,28,0,1,0
46,331,331,16,8,8,3,2
11,339,339,24,24,0,1,0
42,346,346,12,12,0,1,0
9,352,352,11,11,0,1,0
15,352,352,26,14,12,2,1
32,355,355,14,5,9,4,3
34,365,365,91,91,0,1,0
7,373,373,15,2,13,2,1
1,377,377,37,5,32,2,1
23,424,424,1,1,0,1,0
24,424,424,8,2,6,2,1
2,441,441,54,30,24,3,2
27,445,445,6,3,3,2,1
33,449,449,72,72,0,1,0
4,456,456,3,3,0,1,0
26,468,468,40,17,23,2,1
36,470,470,19,10,9,4,3
44,477,477,22,12,10,3,2
28,481,481,122,122,0,1,0

22,116,116,1,1,0,1,0
28,116,116,20,3,17,2,1
40,136,136,5,5,0,1,0
34,137,137,2,2,0,1,0
20,139,139,21,2,19,2,1
53,144,144,5,5,0,1,0
46,146,146,20,7,13,2,1
12,152,152,1,1,0,1,0
11,175,175,7,7,0,1,0
35,177,177,11,6,5,2,1
5,177,177,1,1,0,1,0
30,182,182,1,1,0,1,0
24,201,201,11,11,0,1,0
52,210,210,26,26,0,1,0
2,213,213,29,21,8,2,1
41,215,215,59,55,4,2,1
48,222,222,20,20,0,1,0
18,226,226,35,35,0,1,0
45,226,226,47,19,28,3,2
10,229,229,19,19,0,1,0
13,243,243,20,5,15,3,2
39,249,249,6,6,0,1,0
26,252,252,55,11,44,3,2
8,262,262,9,9,0,1,0
38,285,285,43,4,39,4,3
4,287,287,14,14,0,1,0
27,290,290,2,2,0,1,0
6,293,293,46,27,19,2,1
37,300,300,85,85,0,1,0
19,302,302,6,6,0,1,0
3,309,309,4,4,0,1,0
23,329,329,14,14,0,1,0
21,356,356,1,1,0,1,0
1,368,368,12,12,0,1,0
33,370,370,16,9,7,2,1
14,395,395,7,7,0,1,0
7,395,395,23,11,12,4,3
17,395,395,29,8,21,4,3
36,397,397,10,10,0,1,0
29,398,398,21,5,16,3,2
31,405,405,1,1,0,1,0
43,406,406,4,4,0,1,0
15,416,416,31,13,18,3,2
25,429,429,37,37,0,1,0
44,440,440,26,26,0,1,0
51,442,442,139,100,39,4,3
42,445,445,2,2,0,1,0
0,461,461,1,1,0,1,0
16,464,464,14,4,10,3,2
49,476,476,25,2,23,3,2
50,476,476,31,31,0,1,0
9,488,488,20,20,0,1,0
32,495,495,21,21,0,1,0
47,496,496,32,4,28,3,2

13,113,113,11,11,0,1,0
11,117,117,1,1,0,1,0
12,126,126,18,18,0,1,0
15,133,133,46,46,0,1,0
0,135,135,1,1,0,1,0
3,156,156,25,25,0,1,0
7,167,167,1,1,0,1,0
19,170,170,14,14,0,1,0
6,181,181,1,1,0,1,0
26,216,216,8,8,0,1,0
23,232,232,14,14,0,1,0
36,233,233,17,4,13,2,1
32,242,242,23,14,9,4,3
30,262,262,35,5,30,4,3
29,276,276,8,5,3,2,1
9,297,297,15,5,10,2,1
16,301,301,21,3,18,3,2
1,316,316,13,13,0,1,0
33,318,318,14,5,9,4,3
10,323,323,8,3,5,2,1
2,326,326,7,2,5,2,1
35,340,340,11,5,6,2,1
14,357,357,40,40,0,1,0
39,358,358,148,10,138,4,3
38,367,367,21,5,16,3,2
18,390,390,21,9,12,4,3
40,393,393,44,26,18,2,1
27,395,395,99,99,0,1,0
28,397,397,11,1,10,3,2
17,397,397,18,6,12,2,1
5,409,409,164,138,26,2,1
21,412,412,42,42,0,1,0
24,441,441,1,1,0,1,0
37,442,442,67,67,0,1,0
25,445,445,107,29,78,4,3
4,452,452,87,36,51,4,3
8,459,459,17,17,0,1,0
22,461,461,10,10,0,1,0
34,480,480,17,17,0,1,0
31,481,481,56,56,0,1,0
20,484,484,46,46,0,1,0

31,103,103,12,12,0,1,0
20,110,110,7,7,0,1,0
23,152,152,4,1,3,2,1
4,155,155,1,1,0,1,0
14,165,165,23,20,3,2,1
18,168,168,57,57,0,1,0
37,170,170,9,9,0,1,0
2,174,174,2,2,0,1,0
10,176,176,9,9,0,1,0
3,181,181,2,2,0,1,0
15,196,196,3,3,0,1,0
16,211,211,25,3,22,3,2
9,215,215,61,54,7,2,1
36,218,218,10,6,4,2,1
26,224,224,12,12,0,1,0
7,234,234,5,5,0,1,0
28,270,270,14,5,9,3,2
1,298,298,72,41,31,2,1
39,299,299,127,88,39,2,1
32,301,301,97,24,73,3,2
30,317,317,15,15,0,1,0
12,327,327,14,14,0,1,0
25,330,330,14,14,0,1,0
13,338,338,13,13,0,1,0
21,353,353,3,3,0,1,0
35,355,355,7,2,5,2,1
22,362,362,94,34,60,4,3
11,372,372,111,111,0,1,0
17,376,376,35,35,0,1,0
5,380,380,8,8,0,1,0
29,381,381,57,30,27,2,1
27,386,386,31,31,0,1,0
0,389,389,36,36,0,1,0
6,393,393,24,24,0,1,0
33,422,422,29,14,15,2,1
19,438,438,14,14,0,1,0
8,480,480,40,30,10,2,1
38,482,482,7,7,0,1,0
34,484,484,62,7,55,3,2
24,494,494,33,27,6,3,2

19,101,101,8,5,3,2,1
7,116,116,9,5,4,2,1
10,124,124,18,2,16,3,2
27,124,124,2,2,0,1,0
31,132,132,7,1,6,2,1
16,134,134,13,3,10,3,2
20,140,140,1,1,0,1,0
32,159,159,1,1,0,1,0
17,165,165,30,23,7,2,1
5,173,173,22,1,21,4,3
12,176,176,62,2,60,3,2
26,180,180,10,10,0,1,0
25,181,181,16,5,11,2,1
6,206,206,80,38,42,3,2
34,209,209,42,42,0,1,0
30,216,216,29,2,27,4,3
11,255,255,28,10,18,4,3
3,264,264,3,3,0,1,0
18,264,264,51,31,20,3,2
22,266,266,47,5,42,3,2
21,268,268,72,47,25,2,1
28,280,280,28,7,21,2,1
8,285,285,9,9,0,1,0
36,288,288,60,22,38,2,1
9,290,290,5,5,0,1,0
23,293,293,32,9,23,2,1
4,302,302,6,1,5,2,1
24,315,315,23,11,12,4,3
33,338,338,10,1,9,4,3
0,342,342,22,3,19,4,3
15,381,381,59,44,15,4,3
13,414,414,29,29,0,1,0
29,416,416,14,14,0,1,0
1,452,452,17,17,0,1,0
14,481,481,107,15,92,4,3
35,494,494,13,13,0,1,0
2,500,500,38,38,0,1,0

24,153,153,57,36,21,2,1
4,166,166,7,7,0,1,0
8,169,169,6,1,5,2,1
34,169,169,18,18,0,1,0
11,180,180,25,25,0,1,0
31,184,184,4,4,0,1,0
9,194,194,20,2,18,2,1
29,198,198,15,5,10,3,2
17,204,204,12,12,0,1,0
19,213,213,28,16,12,4,3
25,258,258,18,18,0,1,0
3,268,268,84,64,20,3,2
16,276,276,12,12,0,1,0
5,278,278,42,37,5,2,1
33,282,282,13,4,9,4,3
18,287,287,32,1,31,3,2
20,300,300,56,50,6,3,2
12,305,305,86,86,0,1,0
28,319,319,63,63,0,1,0
1,357,357,83,83,0,1,0
2,360,360,22,22,0,1,0
30,364,364,6,6,0,1,0
6,366,366,23,4,19,2,1
26,382,382,5,1,4,2,1
21,389,389,101,81,20,2,1
14,400,400,59,23,36,3,2
13,411,411,87,37,50,3,2
7,426,426,21,21,0,1,0
15,433,433,1,1,0,1,0
10,435,435,47,21,26,3,2
0,445,445,28,28,0,1,0
23,453,453,22,22,0,1,0
22,462,462,49,49,0,1,0
32,462,462,72,54,18,4,3
27,465,465,7,7,0,1,0

2,105,105,1,1,0,1,0
38,122,122,9,9,0,1,0
8,124,124,5,5,0,1,0
9,126,126,3,3,0,1,0
7,158,158,1,1,0,1,0
23,160,160,59,13,46,2,1
11,177,177,18,18,0,1,0
33,193,193,41,11,30,3,2
18,194,194,27,27,0,1,0
27,198,198,6,6,0,1,0
28,200,200,20,1,19,2,1
15,203,203,32,16,16,2,1
14,210,210,9,9,0,1,0
13,264,264,31,31,0,1,0
5,266,266,35,14,21,2,1
34,267,267,5,5,0,1,0
30,276,276,11,6,5,2,1
16,296,296,11,8,3,2,1
1,299,299,35,35,0,1,0
26,301,301,30,30,0,1,0
29,302,302,50,50,0,1,0
32,319,319,9,9,0,1,0
24,322,322,5,5,0,1,0
19,322,322,15,15,0,1,0
22,325,325,27,27,0,1,0
40,333,333,14,6,8,3,2
25,339,339,34,15,19,2,1
3,346,346,2,2,0,1,0
20,353,353,100,100,0,1,0
37,364,364,125,125,0,1,0
4,370,370,74,24,50,3,2
39,372,372,6,2,4,2,1
36,374,374,9,5,4,2,1
6,384,384,1,1,0,1,0
21,413,413,68,68,0,1,0
35,414,414,40,40,0,1,0
17,454,454,67,34,33,4,3
10,466,466,3,3,0,1,0
31,477,477,7,7,0,1,0
0,491,491,10,10,0,1,0
12,493,493,179,164,15,2,1

7,111,111,2,2,0,1,0
10,113,113,13,13,0,1,0
40,123,123,2,2,0,1,0
39,144,144,6,6,0,1,0
27,148,148,36,31,5,2,1
1,155,155,47,11,36,2,1
36,164,164,5,5,0,1,0
26,187,187,18,18,0,1,0
33,191,191,12,2,10,3,2
23,192,192,8,8,0,1,0
17,204,204,5,5,0,1,0
37,207,207,68,36,32,3,2
5,235,235,2,2,0,1,0
2,238,238,8,8,0,1,0
19,244,244,2,2,0,1,0
32,251,251,14,2,12,3,2
21,259,259,17,9,8,3,2
9,295,295,50,50,0,1,0
30,317,317,3,3,0,1,0
25,329,329,10,10,0,1,0
3,337,337,74,34,40,3,2
8,337,337,3,3,0,1,0
12,346,346,30,18,12,4,3
4,348,348,71,32,39,4,3
20,349,349,88,43,45,2,1
14,355,355,59,59,0,1,0
16,382,382,27,15,12,3,2
29,387,387,95,95,0,1,0
22,395,395,48,48,0,1,0
6,405,405,1,1,0,1,0
38,405,405,82,28,54,3,2
0,423,423,8,8,0,1,0
15,428,428,50,21,29,2,1
18,431,431,12,12,0,1,0
11,437,437,42,42,0,1,0
35,440,440,64,52,12,4,3
34,446,446,30,30,0,1,0
31,447,447,32,22,10,3,2
28,459,459,67,67,0,1,0
24,471,471,12,12,0,1,0
13,482,482,24,24,0,1,0

21,100,100,1,1,0,1,0
19,103,103,24,24,0,1,0
23,114,114,7,7,0,1,0
3,134,134,8,8,0,1,0
16,136,136,11,2,9,2,1
33,137,137,23,3,20,2,1
32,145,145,3,3,0,1,0
30,152,152,1,1,0,1,0
8,156,156,19,19,0,1,0
29,158,158,14,14,0,1,0
12,159,159,11,11,0,1,0
31,171,171,5,5,0,1,0
14,176,176,8,4,4,2,1
37,208,208,13,7,6,2,1
11,214,214,67,28,39,3,2
35,217,217,12,12,0,1,0
5,230,230,1,1,0,1,0
43,231,231,16,16,0,1,0
9,232,232,22,18,4,2,1
10,257,257,3,3,0,1,0
34,287,287,15,3,12,4,3
27,291,291,2,2,0,1,0
0,294,294,29,29,0,1,0
26,304,304,38,2,36,3,2
1,305,305,38,38,0,1,0
36,329,329,28,1,27,4,3
38,332,332,203,188,15,4,3
40,342,342,2,2,0,1,0
20,364,364,27,3,24,2,1
25,371,371,5,1,4,2,1
17,383,383,36,18,18,2,1
41,384,384,31,31,0,1,0
7,389,389,29,29,0,1,0
24,391,391,8,8,0,1,0
18,394,394,5,5,0,1,0
6,398,398,27,27,0,1,0
4,400,400,45,2,43,2,1
15,419,419,64,14,50,4,3
13,426,426,2,2,0,1,0
42,441,441,62,41,21,4,3
2,445,445,1,1,0,1,0
39,467,467,42,39,3,2,1
22,484,484,38,38,0,1,0
28,491,491,155,47,108,4,3

14,101,101,10,2,8,3,2
22,104,104,31,31,0,1,0
23,116,116,15,15,0,1,0
33,141,141,21,21,0,1,0
26,152,152,9,9,0,1,0
10,167,167,3,3,0,1,0
37,172,172,26,26,0,1,0
27,177,177,3,3,0,1,0
32,219,219,22,22,0,1,0
20,230,230,7,7,0,1,0
35,235,235,4,4,0,1,0
31,249,249,37,11,26,3,2
13,258,258,5,5,0,1,0
1,266,266,82,61,21,4,3
15,271,271,28,13,15,2,1
38,275,275,16,16,0,1,0
4,283,283,39,39,0,1,0
30,283,283,15,2,13,4,3
16,297,297,10,10,0,1,0
9,297,297,58,36,22,2,1
34,300,300,101,101,0,1,0
6,320,320,4,1,3,2,1
29,321,321,15,15,0,1,0
28,344,344,11,11,0,1,0
17,346,346,36,36,0,1,0
19,356,356,80,80,0,1,0
18,362,362,26,2,24,3,2
21,369,369,18,6,12,2,1
8,376,376,29,29,0,1,0
5,390,390,7,7,0,1,0
0,427,427,76,76,0,1,0
40,432,432,78,78,0,1,0
2,446,446,35,35,0,1,0
36,452,452,28,28,0,1,0
7,457,457,19,19,0,1,0
25,461,461,15,15,0,1,0
39,461,461,16,1,15,2,1
3,462,462,26,11,15,2,1
12,464,464,26,9,17,2,1
11,471,471,66,66,0,1,0
24,500,500,46,46,0,1,0

26,103,103,5,5,0,1,0
28,115,115,2,2,0,1,0
36,132,132,29,29,0,1,0
27,134,134,20,20,0,1,0
9,142,142,18,12,6,3,2
2,155,155,1,1,0,1,0
34,157,157,7,7,0,1,0
17,191,191,17,17,0,1,0
15,216,216,38,38,0,1,0
12,220,220,21,17,4,2,1
38,227,227,7,7,0,1,0
0,230,230,13,5,8,2,1
31,231,231,1,1,0,1,0
4,233,233,101,79,22,2,1
21,238,238,7,7,0,1,0
20,239,239,1,1,0,1,0
10,242,242,8,2,6,3,2
18,278,278,7,1,6,3,2
3,297,297,14,2,12,4,3
39,300,300,22,5,17,2,1
40,314,314,23,23,0,1,0
32,327,327,147,147,0,1,0
19,330,330,2,2,0,1,0
37,337,337,2,2,0,1,0
35,339,339,4,4,0,1,0
44,352,352,14,8,6,2,1
8,365,365,20,20,0,1,0
1,366,366,2,2,0,1,0
13,372,372,81,81,0,1,0
23,389,389,1,1,0,1,0
25,400,400,56,56,0,1,0
42,403,403,37,7,30,4,3
29,414,414,11,2,9,3,2
33,417,417,103,103,0,1,0
5,429,429,47,47,0,1,0
14,429,429,27,27,0,1,0
41,434,434,96,76,20,2,1
11,445,445,3,3,0,1,0
43,445,445,31,31,0,1,0
6,453,453,14,10,4,2,1
30,461,461,40,23,17,2,1
24,471,471,32,32,0,1,0
22,479,479,45,38,7,2,1
7,483,483,86,86,0,1,0
16,485,485,20,16,4,2,1

1,119,119,9,3,6,2,1
40,120,120,6,6,0,1,0
6,121,121,7,7,0,1,0
0,124,124,3,3,0,1,0
39,127,127,9,9,0,1,0
9,132,132,6,6,0,1,0
10,153,153,5,5,0,1,0
8,158,158,3,3,0,1,0
14,164,164,8,8,0,1,0
36,164,164,17,8,9,2,1
42,166,166,3,3,0,1,0
32,180,180,1,1,0,1,0
3,184,184,46,46,0,1,0
17,216,216,15,15,0,1,0
5,218,218,32,32,0,1,0
24,227,227,7,7,0,1,0
27,250,250,64,18,46,3,2
44,254,254,28,25,3,2,1
11,261,261,47,20,27,2,1
38,263,263,70,21,49,4,3
35,265,265,20,5,15,4,3
45,282,282,16,16,0,1,0
28,287,287,59,51,8,3,2
15,292,292,4,4,0,1,0
31,293,293,10,5,5,2,1
13,296,296,7,7,0,1,0
21,316,316,30,5,25,2,1
23,336,336,67,67,0,1,0
7,336,336,59,23,36,3,2
41,353,353,17,3,14,2,1
46,356,356,25,20,5,2,1
37,362,362,49,18,31,2,1
26,368,368,13,13,0,1,0
34,374,374,3,3,0,1,0
4,386,386,31,8,23,2,1
33,388,388,11,8,3,2,1
20,400,400,15,15,0,1,0
43,402,402,77,17,60,4,3
16,414,414,15,7,8,3,2
12,420,420,49,26,23,3,2
18,446,446,19,3,16,3,2
19,455,455,7,4,3,2,1
22,456,456,6,6,0,1,0
30,470,470,128,128,0,1,0
2,496,496,60,4,56,3,2
29,497,497,23,23,0,1,0
25,499,499,8,5,3,2,1

35,110,110,22,4,18,4,3
7,128,128,1,1,0,1,0
19,128,128,19,9,10,3,2
0,140,140,6,3,3,2,1
2,149,149,8,8,0,1,0
26,165,165,2,2,0,1,0
45,175,175,5,5,0,1,0
44,180,180,7,7,0,1,0
40,200,200,22,10,12,2,1
30,207,207,15,15,0,1,0
23,215,215,18,18,0,1,0
13,218,218,6,6,0,1,0
3,224,224,1,1,0,1,0
42,225,225,16,16,0,1,0
28,227,227,19,19,0,1,0
8,230,230,17,2,15,2,1
18,237,237,20,20,0,1,0
29,253,253,1,1,0,1,0
33,261,261,13,4,9,4,3
36,267,267,67,36,31,2,1
17,274,274,19,19,0,1,0
25,280,280,6,3,3,2,1
21,280,280,2,2,0,1,0
32,301,301,18,8,10,2,1
9,306,306,22,14,8,3,2
14,316,316,4,1,3,2,1
11,344,344,5,2,3,2,1
4,344,344,12,12,0,1,0
38,363,363,49,19,30,3,2
5,376,376,40,40,0,1,0
22,376,376,156,27,129,4,3
1,380,380,17,17,0,1,0
34,389,389,48,48,0,1,0
27,391,391,3,3,0,1,0
31,392,392,8,8,0,1,0
6,396,396,2,2,0,1,0
41,422,422,214,174,40,4,3
20,432,432,1,1,0,1,0
24,434,434,14,14,0,1,0
10,447,447,31,12,19,2,1
43,447,447,42,42,0,1,0
37,449,449,34,34,0,1,0
16,454,454,40,40,0,1,0
39,458,458,47,11,36,3,2
15,465,465,165,111,54,4,3
12,469,469,58,58,0,1,0

39,102,102,11,11,0,1,0
7,108,108,2,2,0,1,0
13,114,114,3,3,0,1,0
34,117,117,13,7,6,2,1
19,123,123,3,3,0,1,0
16,145,145,16,13,3,2,1
29,152,152,8,8,0,1,0
22,158,158,47,47,0,1,0
40,167,167,14,14,0,1,0
11,169,169,7,7,0,1,0
24,171,171,10,10,0,1,0
36,183,183,18,18,0,1,0
32,196,196,13,13,0,1,0
0,203,203,8,3,5,2,1
17,212,212,7,3,4,2,1
4,215,215,1,1,0,1,0
31,221,221,22,22,0,1,0
14,224,224,35,20,15,4,3
28,228,228,9,9,0,1,0
35,265,265,22,15,7,2,1
30,285,285,34,34,0,1,0
25,287,287,6,6,0,1,0
33,290,290,6,6,0,1,0
5,304,304,146,146,0,1,0
1,304,304,65,17,48,4,3
23,327,327,20,20,0,1,0
6,334,334,1,1,0,1,0
2,349,349,15,15,0,1,0
3,360,360,114,109,5,2,1
20,365,365,19,3,16,2,1
37,366,366,106,19,87,3,2
26,381,381,14,14,0,1,0
15,394,394,1,1,0,1,0
9,409,409,61,61,0,1,0
12,428,428,6,6,0,1,0
8,449,449,9,9,0,1,0
27,459,459,24,9,15,2,1
21,469,469,153,47,106,4,3
38,470,470,5,5,0,1,0
10,481,481,46,46,0,1,0
18,481,481,76,76,0,1,0

13,102,102,2,2,0,1,0
24,110,110,20,2,18,4,3
14,125,125,50,20,30,3,2
7,127,127,8,8,0,1,0
19,142,142,3,3,0,1,0
33,161,161,4,4,0,1,0
20,178,178,3,3,0,1,0
0,186,186,34,34,0,1,0
11,196,196,5,5,0,1,0
17,225,225,4,4,0,1,0
29,229,229,43,23,20,2,1
4,242,242,11,11,0,1,0
10,254,254,35,30,5,2,1
8,262,262,35,1,34,4,3
3,267,267,18,18,0,1,0
25,267,267,2,2,0,1,0
2,273,273,18,2,16,2,1
22,291,291,10,1,9,2,1
21,297,297,4,4,0,1,0
18,311,311,25,15,10,3,2
5,312,312,80,11,69,4,3
23,315,315,17,5,12,2,1
26,324,324,56,56,0,1,0
9,326,326,76,39,37,3,2
32,343,343,26,26,0,1,0
37,348,348,13,13,0,1,0
35,348,348,90,40,50,2,1
34,356,356,115,33,82,3,2
12,368,368,58,58,0,1,0
36,382,382,111,111,0,1,0
31,405,405,26,10,16,3,2
28,409,409,2,2,0,1,0
16,410,410,7,7,0,1,0
6,415,415,17,9,8,3,2
27,434,434,59,59,0,1,0
15,458,458,50,50,0,1,0
1,471,471,14,14,0,1,0
30,485,485,26,26,0,1,0

21,103,103,23,23,0,1,0
2,145,145,6,2,4,2,1
19,149,149,5,2,3,2,1
11,159,159,6,6,0,1,0
22,174,174,9,9,0,1,0
8,193,193,12,12,0,1,0
5,193,193,41,41,0,1,0
31,196,196,11,11,0,1,0
24,206,206,34,2,32,3,2
32,210,210,31,31,0,1,0
12,212,212,45,39,6,2,1
13,217,217,1,1,0,1,0
36,228,228,5,5,0,1,0
29,238,238,3,3,0,1,0
6,253,253,2,2,0,1,0
33,261,261,30,24,6,2,1
3,279,279,5,5,0,1,0
28,279,279,11,2,9,4,3
17,280,280,1,1,0,1,0
23,282,282,8,8,0,1,0
25,283,283,21,21,0,1,0
38,295,295,24,3,21,3,2
35,318,318,26,13,13,2,1
39,333,333,128,42,86,3,2
7,337,337,46,34,12,3,2
16,343,343,52,52,0,1,0
20,354,354,78,20,58,4,3
14,365,365,21,4,17,2,1
4,372,372,37,11,26,3,2
34,383,383,92,80,12,3,2
40,412,412,4,4,0,1,0
9,426,426,124,77,47,4,3
26,442,442,48,28,20,2,1
15,452,452,43,43,0,1,0
37,468,468,37,5,32,3,2
30,470,470,25,17,8,3,2
10,471,471,14,6,8,3,2
1,475,475,99,43,56,3,2
0,490,490,27,27,0,1,0
18,491,491,11,11,0,1,0
27,495,495,32,32,0,1,0

14,106,106,6,1,5,2,1
33,115,115,38,38,0,1,0
13,121,121,6,6,0,1,0
24,129,129,11,3,8,2,1
27,150,150,22,22,0,1,0
29,150,150,10,2,8,3,2
19,156,156,1,1,0,1,0
42,166,166,5,5,0,1,0
30,167,167,1,1,0,1,0
3,168,168,15,15,0,1,0
43,172,172,21,17,4,2,1
41,176,176,2,2,0,1,0
16,181,181,20,15,5,2,1
45,190,190,58,58,0,1,0
46,191,191,4,4,0,1,0
5,206,206,16,16,0,1,0
6,210,210,3,3,0,1,0
22,214,214,4,4,0,1,0
10,221,221,1,1,0,1,0
48,223,223,17,17,0,1,0
1,224,224,12,12,0,1,0
11,270,270,2,2,0,1,0
2,286,286,42,42,0,1,0
28,287,287,90,90,0,1,0
26,289,289,11,3,8,3,2
34,299,299,2,2,0,1,0
0,301,301,2,2,0,1,0
32,315,315,30,10,20,2,1
18,324,324,29,9,20,3,2
25,325,325,26,26,0,1,0
31,328,328,6,6,0,1,0
39,335,335,6,6,0,1,0
8,358,358,73,55,18,2,1
47,361,361,36,7,29,2,1
15,367,367,30,10,20,2,1
23,370,370,12,12,0,1,0
40,376,376,27,8,19,4,3
17,387,387,2,2,0,1,0
9,390,390,30,30,0,1,0
7,408,408,1,1,0,1,0
36,413,413,14,14,0,1,0
4,413,413,30,30,0,1,0
21,418,418,25,22,3,2,1
37,424,424,29,7,22,2,1
12,435,435,1,1,0,1,0
20,437,437,1,1,0,1,0
35,453,453,24,24,0,1,0
38,471,471,30,7,23,2,1
44,491,491,167,167,0,1,0
49,500,500,134,14,120,4,3

20,102,102,10,4,6,3,2
35,132,132,2,2,0,1,0
43,140,140,14,2,12,2,1
7,159,159,21,6,15,2,1
14,169,169,14,1,13,2,1
37,173,173,9,9,0,1,0
17,177,177,14,14,0,1,0
11,178,178,12,12,0,1,0
29,201,201,21,5,16,2,1
28,215,215,5,5,0,1,0
19,217,217,16,16,0,1,0
9,220,220,1,1,0,1,0
34,226,226,3,3,0,1,0
21,227,227,18,15,3,2,1
27,233,233,21,6,15,2,1
24,248,248,33,33,0,1,0
41,257,257,41,17,24,2,1
33,267,267,25,16,9,4,3
15,274,274,104,104,0,1,0
31,279,279,41,27,14,3,2
16,301,301,29,29,0,1,0
25,316,316,148,148,0,1,0
12,316,316,11,8,3,2,1
3,325,325,14,2,12,3,2
42,329,329,21,21,0,1,0
32,332,332,14,2,12,2,1
10,338,338,33,14,19,2,1
5,355,355,50,50,0,1,0
2,366,366,17,17,0,1,0
4,366,366,2,2,0,1,0
39,373,373,124,41,83,4,3
38,411,411,23,23,0,1,0
6,418,418,13,2,11,2,1
40,429,429,37,21,16,2,1
18,430,430,69,57,12,2,1
26,442,442,6,1,5,2,1
30,447,447,15,6,9,2,1
23,451,451,25,3,22,2,1
22,474,474,10,10,0,1,0
1,483,483,6,6,0,1,0
36,487,487,5,2,3,2,1
13,497,497,120,89,31,2,1
8,498,498,7,7,0,1,0
0,498,498,2,2,0,1,0

12,101,101,1,1,0,1,0
27,104,104,13,1,12,4,3
31,123,123,15,9,6,2,1
38,129,129,15,15,0,1,0
26,131,131,59,10,49,4,3
14,157,157,9,3,6,2,1
30,187,187,38,31,7,2,1
6,187,187,53,53,0,1,0
18,195,195,6,6,0,1,0
37,196,196,19,11,8,2,1
22,197,197,36,9,27,4,3
11,203,203,47,47,0,1,0
34,208,208,6,2,4,2,1
33,215,215,3,3,0,1,0
19,229,229,47,47,0,1,0
1,233,233,1,1,0,1,0
3,246,246,12,12,0,1,0
13,270,270,12,12,0,1,0
40,275,275,25,5,20,3,2
28,277,277,4,4,0,1,0
23,278,278,28,28,0,1,0
32,287,287,46,26,20,3,2
8,304,304,107,37,70,4,3
2,312,312,13,4,9,2,1
16,336,336,14,14,0,1,0
4,341,341,50,1,49,2,1
0,341,341,24,24,0,1,0
39,356,356,34,2,32,2,1
10,356,356,11,11,0,1,0
29,362,362,7,7,0,1,0
20,379,379,10,10,0,1,0
24,397,397,10,1,9,2,1
25,403,403,5,5,0,1,0
7,415,415,13,13,0,1,0
9,420,420,23,23,0,1,0
35,428,428,20,9,11,2,1
36,432,432,35,2,33,4,3
5,440,440,4,4,0,1,0
15,442,442,81,81,0,1,0
17,493,493,48,48,0,1,0
21,495,495,27,27,0,1,0

17,109,109,18,18,0,1,0
27,136,136,5,2,3,2,1
39,137,137,6,3,3,2,1
13,138,138,4,4,0,1,0
3,159,159,12,12,0,1,0
32,159,159,45,45,0,1,0
20,165,165,3,3,0,1,0
24,169,169,17,17,0,1,0
6,171,171,20,20,0,1,0
10,172,172,19,9,10,3,2
34,200,200,16,16,0,1,0
14,209,209,5,5,0,1,0
37,210,210,5,5,0,1,0
30,236,236,4,1,3,2,1
31,237,237,16,16,0,1,0
21,238,238,23,23,0,1,0
29,245,245,28,28,0,1,0
36,259,259,84,84,0,1,0
16,261,261,98,17,81,4,3
19,274,274,45,45,0,1,0
26,281,281,7,7,0,1,0
1,308,308,63,24,39,4,3
38,320,320,104,92,12,4,3
15,329,329,3,3,0,1,0
25,347,347,45,45,0,1,0
0,352,352,90,68,22,3,2
8,362,362,29,29,0,1,0
9,369,369,19,3,16,2,1
33,400,400,44,44,0,1,0
12,403,403,1,1,0,1,0
28,418,418,56,8,48,4,3
4,419,419,24,24,0,1,0
35,447,447,17,17,0,1,0
5,462,462,46,4,42,4,3
2,465,465,9,9,0,1,0
18,471,471,1,1,0,1,0
7,471,471,42,42,0,1,0
23,471,471,12,12,0,1,0
11,481,481,33,11,22,2,1
22,496,496,28,28,0,1,0

4,103,103,7,4,3,2,1
15,117,117,1,1,0,1,0
3,133,133,9,9,0,1,0
12,146,146,75,75,0,1,0
5,149,149,1,1,0,1,0
0,153,153,15,3,12,2,1
14,154,154,38,38,0,1,0
33,170,170,28,20,8,3,2
9,190,190,1,1,0,1,0
8,195,195,11,11,0,1,0
20,220,220,5,5,0,1,0
7,222,222,21,21,0,1,0
30,226,226,14,5,9,3,2
29,234,234,33,18,15,2,1
18,240,240,63,46,17,2,1
25,255,255,23,5,18,2,1
6,271,271,104,66,38,2,1
16,284,284,18,18,0,1,0
26,305,305,53,53,0,1,0
36,308,308,54,16,38,3,2
19,316,316,21,21,0,1,0
13,320,320,2,2,0,1,0
10,339,339,9,9,0,1,0
23,355,355,12,12,0,1,0
11,357,357,39,39,0,1,0
32,362,362,27,5,22,4,3
27,369,369,114,114,0,1,0
24,371,371,54,54,0,1,0
34,408,408,24,14,10,2,1
1,427,427,72,72,0,1,0
21,442,442,13,9,4,2,1
28,445,445,20,20,0,1,0
31,472,472,4,4,0,1,0
35,474,474,26,26,0,1,0
22,474,474,38,38,0,1,0
2,481,481,38,22,16,2,1
17,490,490,14,3,11,2,1

31,114,114,5,5,0,1,0
6,123,123,16,16,0,1,0
7,141,141,46,46,0,1,0
24,169,169,35,3,32,3,2
0,173,173,49,33,16,3,2
19,186,186,13,13,0,1,0
3,220,220,4,4,0,1,0
13,220,220,4,4,0,1,0
22,241,241,6,2,4,2,1
29,261,261,3,3,0,1,0
15,278,278,43,23,20,3,2
16,285,285,11,1,10,2,1
28,293,293,33,27,6,3,2
33,325,325,120,80,40,3,2
2,337,337,26,11,15,3,2
26,337,337,4,4,0,1,0
12,342,342,21,18,3,2,1
21,346,346,2,2,0,1,0
11,358,358,46,46,0,1,0
17,377,377,83,83,0,1,0
10,399,399,9,9,0,1,0
1,400,400,67,27,40,3,2
32,406,406,68,30,38,3,2
5,411,411,68,68,0,1,0
23,428,428,154,31,123,4,3
14,435,435,17,17,0,1,0
20,435,435,10,4,6,3,2
4,442,442,173,148,25,2,1
25,443,443,43,43,0,1,0
9,458,458,19,13,6,2,1
18,462,462,12,12,0,1,0
8,464,464,79,59,20,3,2
27,469,469,2,2,0,1,0
30,495,495,26,7,19,2,1

17,104,104,14,14,0,1,0
4,113,113,77,29,48,2,1
11,116,116,2,2,0,1,0
29,123,123,14,14,0,1,0
18,127,127,4,4,0,1,0
16,132,132,11,11,0,1,0
35,153,153,20,5,15,4,3
30,161,161,21,21,0,1,0
22,176,176,18,9,9,4,3
12,224,224,41,41,0,1,0
8,238,238,19,19,0,1,0
3,254,254,1,1,0,1,0
23,266,266,3,3,0,1,0
34,272,272,17,5,12,4,3
27,275,275,36,36,0,1,0
36,285,285,60,5,55,4,3
24,301,301,15,10,5,2,1
1,311,311,1,1,0,1,0
13,330,330,8,8,0,1,0
20,347,347,24,24,0,1,0
7,360,360,7,7,0,1,0
25,360,360,73,60,13,2,1
28,363,363,4,4,0,1,0
31,369,369,19,19,0,1,0
32,406,406,109,109,0,1,0
5,416,416,48,11,37,4,3
19,418,418,35,9,26,2,1
21,420,420,79,28,51,4,3
26,425,425,22,22,0,1,0
14,438,438,92,37,55,4,3
2,444,444,1,1,0,1,0
10,444,444,11,6,5,2,1
6,445,445,14,6,8,2,1
33,445,445,8,8,0,1,0
0,467,467,28,8,20,2,1
15,482,482,165,165,0,1,0
9,483,483,60,60,0,1,0

7,100,100,9,1,8,3,2
27,103,103,3,3,0,1,0
37,113,113,8,4,4,2,1
40,114,114,1,1,0,1,0
32,116,116,15,9,6,3,2
3,131,131,11,1,10,3,2
23,132,132,9,3,6,2,1
24,148,148,4,4,0,1,0
36,160,160,38,38,0,1,0
20,166,166,11,11,0,1,0
15,178,178,59,59,0,1,0
26,184,184,3,3,0,1,0
1,190,190,1,1,0,1,0
35,193,193,8,8,0,1,0
13,200,200,10,2,8,3,2
2,228,228,13,13,0,1,0
0,237,237,13,13,0,1,0
41,258,258,51,51,0,1,0
30,268,268,231,165,66,3,2
33,271,271,1,1,0,1,0
18,296,296,50,4,46,3,2
19,296,296,43,16,27,4,3
17,298,298,30,20,10,3,2
12,307,307,1,1,0,1,0
9,320,320,30,26,4,2,1
21,320,320,32,32,0,1,0
28,329,329,14,2,12,2,1
5,330,330,25,20,5,2,1
6,342,342,5,5,0,1,0
14,345,345,43,34,9,4,3
11,348,348,61,61,0,1,0
38,365,365,19,9,10,3,2
16,397,397,1,1,0,1,0
29,400,400,10,6,4,2,1
22,411,411,26,2,24,3,2
42,417,417,1,1,0,1,0
4,423,423,38,38,0,1,0
34,425,425,7,7,0,1,0
43,430,430,22,14,8,2,1
10,443,443,14,6,8,2,1
39,456,456,66,54,12,3,2
25,458,458,13,1,12,3,2
8,460,460,4,4,0,1,0
31,465,465,30,2,28,2,1

20,100,100,45,5,40,3,2
8,110,110,6,6,0,1,0
22,138,138,2,2,0,1,0
34,146,146,3,3,0,1,0
35,176,176,17,2,15,4,3
44,186,186,3,3,0,1,0
17,189,189,4,4,0,1,0
3,197,197,17,17,0,1,0
37,201,201,7,7,0,1,0
39,203,203,34,1,33,4,3
40,235,235,8,8,0,1,0
0,241,241,65,32,33,4,3
23,244,244,6,1,5,2,1
21,256,256,13,13,0,1,0
32,262,262,7,2,5,2,1
43,276,276,5,5,0,1,0
42,295,295,34,34,0,1,0
16,297,297,27,9,18,3,2
9,299,299,17,3,14,3,2
25,301,301,1,1,0,1,0
11,305,305,6,6,0,1,0
38,308,308,50,50,0,1,0
15,308,308,15,15,0,1,0
1,310,310,9,3,6,3,2
36,313,313,87,87,0,1,0
24,319,319,44,25,19,2,1
4,322,322,31,5,26,2,1
33,325,325,42,9,33,2,1
13,330,330,1,1,0,1,0
18,341,341,26,8,18,3,2
27,355,355,3,3,0,1,0
19,359,359,13,3,10,3,2
14,380,380,5,5,0,1,0
41,381,381,34,11,23,2,1
10,397,397,7,3,4,2,1
26,404,404,9,9,0,1,0
12,407,407,14,14,0,1,0
31,408,408,24,24,0,1,0
30,414,414,2,2,0,1,0
28,418,418,2,2,0,1,0
47,420,420,67,67,0,1,0
46,423,423,41,31,10,3,2
5,447,447,7,4,3,2,1
29,453,453,24,24,0,1,0
7,455,455,49,19,30,4,3
45,460,460,174,169,5,2,1
6,480,480,2,2,0,1,0
48,487,487,46,25,21,2,1
2,490,490,100,92,8,3,2

29,105,105,35,35,0,1,0
31,113,113,1,1,0,1,0
30,114,114,13,13,0,1,0
5,115,115,24,5,19,2,1
43,140,140,20,20,0,1,0
6,169,169,2,2,0,1,0
10,171,171,16,12,4,2,1
42,171,171,18,15,3,2,1
3,174,174,2,2,0,1,0
37,185,185,14,1,13,2,1
38,199,199,16,11,5,2,1
11,199,199,10,10,0,1,0
2,210,210,12,12,0,1,0
25,211,211,3,3,0,1,0
13,218,218,1,1,0,1,0
24,264,264,21,21,0,1,0
16,280,280,18,18,0,1,0
32,292,292,22,22,0,1,0
20,298,298,3,3,0,1,0
33,308,308,27,27,0,1,0
12,310,310,11,11,0,1,0
36,320,320,6,6,0,1,0
22,332,332,14,2,12,4,3
19,336,336,20,13,7,2,1
41,342,342,42,42,0,1,0
1,351,351,38,38,0,1,0
34,363,363,26,26,0,1,0
14,366,366,6,6,0,1,0
17,367,367,107,107,0,1,0
23,375,375,28,28,0,1,0
40,389,389,97,40,57,4,3
0,392,392,27,6,21,4,3
9,405,405,14,14,0,1,0
15,406,406,24,18,6,2,1
35,408,408,3,3,0,1,0
4,424,424,88,88,0,1,0
18,437,437,25,22,3,2,1
26,445,445,40,40,0,1,0
7,448,448,126,89,37,4,3
27,450,450,47,24,23,2,1
39,461,461,84,20,64,3,2
28,465,465,30,30,0,1,0
21,475,475,16,16,0,1,0
8,488,488,58,58,0,1,0

0,109,109,4,4,0,1,0
8,110,110,1,1,0,1,0
26,110,110,12,12,0,1,0
30,120,120,15,2,13,2,1
17,125,125,57,27,30,3,2
15,132,132,16,6,10,3,2
31,143,143,11,5,6,2,1
12,165,165,25,5,20,3,2
28,167,167,8,8,0,1,0
23,176,176,37,7,30,3,2
27,179,179,61,45,16,3,2
1,180,180,36,1,35,2,1
4,189,189,15,15,0,1,0
37,206,206,25,18,7,2,1
32,212,212,7,7,0,1,0
16,215,215,17,11,6,2,1
7,217,217,41,41,0,1,0
36,225,225,30,30,0,1,0
13,236,236,8,8,0,1,0
11,241,241,39,39,0,1,0
33,267,267,21,5,16,2,1
3,273,273,39,25,14,3,2
22,288,288,17,11,6,2,1
19,292,292,9,9,0,1,0
24,295,295,82,82,0,1,0
10,327,327,1,1,0,1,0
14,343,343,24,14,10,2,1
6,347,347,22,22,0,1,0
25,374,374,2,2,0,1,0
20,391,391,11,4,7,2,1
21,411,411,18,18,0,1,0
34,440,440,98,60,38,2,1
35,450,450,22,22,0,1,0
18,461,461,12,12,0,1,0
29,463,463,10,10,0,1,0
9,464,464,11,11,0,1,0
5,471,471,28,28,0,1,0
2,499,499,63,49,14,3,2

3,101,101,8,3,5,2,1
38,106,106,17,5,12,3,2
24,113,113,3,3,0,1,0
25,114,114,21,21,0,1,0
41,118,118,3,3,0,1,0
22,131,131,8,8,0,1,0
27,132,132,8,8,0,1,0
40,146,146,29,29,0,1,0
8,153,153,5,2,3,2,1
6,166,166,35,35,0,1,0
7,167,167,2,2,0,1,0
17,168,168,13,13,0,1,0
2,175,175,1,1,0,1,0
26,178,178,2,2,0,1,0
39,191,191,7,7,0,1,0
28,204,204,50,35,15,2,1
16,205,205,4,1,3,2,1
34,209,209,7,7,0,1,0
29,211,211,64,16,48,2,1
13,215,215,2,2,0,1,0
35,219,219,11,11,0,1,0
12,223,223,65,65,0,1,0
21,281,281,17,17,0,1,0
33,294,294,15,15,0,1,0
1,301,301,4,4,0,1,0
36,313,313,43,43,0,1,0
42,328,328,12,2,10,4,3
20,332,332,8,1,7,2,1
5,348,348,57,22,35,3,2
30,352,352,5,2,3,2,1
18,355,355,8,8,0,1,0
0,370,370,8,8,0,1,0
14,374,374,2,2,0,1,0
9,380,380,7,4,3,2,1
19,389,389,57,3,54,3,2
43,396,396,24,16,8,3,2
32,403,403,56,56,0,1,0
15,417,417,15,8,7,2,1
10,435,435,172,133,39,4,3
44,445,445,22,4,18,2,1
31,456,456,122,64,58,3,2
37,456,456,69,13,56,3,2
4,473,473,5,5,0,1,0
11,482,482,26,13,13,2,1
23,486,486,12,12,0,1,0
45,494,494,10,10,0,1,0

29,100,100,9,2,7,2,1
18,104,104,21,12,9,4,3
12,109,109,1,1,0,1,0
11,113,113,5,5,0,1,0
14,116,116,21,21,0,1,0
30,123,123,2,2,0,1,0
22,124,124,15,8,7,2,1
4,142,142,47,47,0,1,0
2,148,148,5,5,0,1,0
25,158,158,25,5,20,3,2
31,159,159,60,32,28,3,2
37,171,171,4,4,0,1,0
32,173,173,7,7,0,1,0
6,177,177,22,22,0,1,0
5,180,180,15,15,0,1,0
35,231,231,32,32,0,1,0
26,234,234,32,3,29,3,2
33,267,267,14,14,0,1,0
17,275,275,27,27,0,1,0
36,288,288,42,42,0,1,0
8,308,308,17,5,12,3,2
15,317,317,86,86,0,1,0
1,333,333,36,13,23,4,3
13,334,334,20,20,0,1,0
20,341,341,15,2,13,2,1
3,341,341,27,27,0,1,0
0,352,352,1,1,0,1,0
9,356,356,3,3,0,1,0
16,365,365,2,2,0,1,0
21,380,380,40,34,6,2,1
7,384,384,7,7,0,1,0
27,401,401,40,40,0,1,0
23,435,435,79,29,50,3,2
38,451,451,2,2,0,1,0
34,456,456,89,44,45,2,1
19,456,456,11,11,0,1,0
24,477,477,33,33,0,1,0
28,480,480,10,3,7,2,1
10,494,494,141,109,32,2,1

26,102,102,9,2,7,2,1
1,104,104,30,3,27,4,3
31,154,154,12,12,0,1,0
27,157,157,1,1,0,1,0
38,160,160,6,3,3,2,1
13,164,164,10,4,6,2,1
35,165,165,57,12,45,4,3
39,167,167,19,19,0,1,0
32,168,168,15,6,9,4,3
20,168,168,32,3,29,4,3
8,174,174,10,5,5,2,1
12,182,182,3,3,0,1,0
2,188,188,20,20,0,1,0
7,188,188,4,4,0,1,0
14,195,195,3,3,0,1,0
33,205,205,42,24,18,4,3
17,207,207,10,1,9,2,1
5,213,213,12,12,0,1,0
19,214,214,19,19,0,1,0
41,215,215,29,18,11,2,1
9,227,227,41,30,11,2,1
6,228,228,18,18,0,1,0
28,229,229,9,1,8,2,1
16,253,253,54,19,35,2,1
11,259,259,17,17,0,1,0
15,267,267,1,1,0,1,0
10,272,272,17,17,0,1,0
23,279,279,5,5,0,1,0
36,295,295,53,53,0,1,0
4,329,329,21,21,0,1,0
29,345,345,73,28,45,3,2
42,379,379,8,8,0,1,0
21,382,382,29,10,19,2,1
24,385,385,25,10,15,4,3
22,393,393,7,7,0,1,0
18,418,418,50,14,36,3,2
25,436,436,41,16,25,2,1
0,442,442,68,22,46,3,2
34,443,443,13,7,6,3,2
3,444,444,7,1,6,3,2
37,454,454,29,2,27,3,2
30,464,464,49,28,21,2,1
40,487,487,63,63,0,1,0

18,106,106,5,5,0,1,0
38,110,110,13,13,0,1,0
6,111,111,9,5,4,2,1
4,143,143,24,7,17,2,1
25,160,160,26,26,0,1,0
35,179,179,24,24,0,1,0
40,179,179,3,3,0,1,0
11,186,186,1,1,0,1,0
10,200,200,4,4,0,1,0
9,208,208,5,1,4,2,1
17,209,209,70,26,44,3,2
29,214,214,62,23,39,4,3
32,214,214,4,1,3,2,1
0,250,250,16,16,0,1,0
12,269,269,105,60,45,2,1
5,274,274,11,11,0,1,0
7,283,283,24,5,19,4,3
31,292,292,6,6,0,1,0
21,301,301,5,5,0,1,0
26,303,303,18,12,6,2,1
30,307,307,33,13,20,2,1
24,329,329,17,7,10,2,1
2,335,335,16,16,0,1,0
19,342,342,1,1,0,1,0
15,345,345,49,17,32,3,2
23,353,353,7,3,4,2,1
3,358,358,1,1,0,1,0
28,390,390,8,8,0,1,0
41,411,411,17,17,0,1,0
13,421,421,43,43,0,1,0
1,429,429,5,5,0,1,0
37,435,435,30,30,0,1,0
8,447,447,8,2,6,2,1
16,448,448,110,86,24,4,3
20,450,450,36,36,0,1,0
33,471,471,47,47,0,1,0
34,472,472,109,109,0,1,0
27,477,477,57,57,0,1,0
39,478,478,66,8,58,3,2
14,480,480,13,13,0,1,0
42,488,488,73,39,34,2,1
36,493,493,84,2,82,3,2
43,495,495,5,5,0,1,0
22,497,497,12,12,0,1,0

12,101,101,3,3,0,1,0
19,116,116,2,2,0,1,0
20,139,139,3,3,0,1,0
24,155,155,4,4,0,1,0
28,163,163,7,7,0,1,0
11,168,168,15,15,0,1,0
8,169,169,5,5,0,1,0
2,176,176,12,12,0,1,0
3,200,200,90,49,41,2,1
7,213,213,50,26,24,3,2
21,219,219,17,17,0,1,0
32,229,229,28,18,10,2,1
27,239,239,11,2,9,4,3
16,241,241,2,2,0,1,0
10,252,252,98,32,66,3,2
34,253,253,18,5,13,4,3
31,253,253,15,15,0,1,0
5,256,256,14,5,9,2,1
25,265,265,48,9,39,4,3
6,268,268,31,31,0,1,0
18,269,269,5,5,0,1,0
13,273,273,5,5,0,1,0
30,283,283,92,21,71,4,3
0,295,295,36,8,28,2,1
35,300,300,41,41,0,1,0
26,315,315,25,11,14,3,2
17,340,340,5,5,0,1,0
33,350,350,21,1,20,2,1
4,352,352,31,14,17,2,1
1,369,369,14,14,0,1,0
15,379,379,99,73,26,3,2
23,392,392,96,24,72,4,3
29,404,404,24,8,16,2,1
9,414,414,4,1,3,2,1
14,427,427,1,1,0,1,0
22,448,448,190,190,0,1,0

1,108,108,8,8,0,1,0
4,115,115,62,62,0,1,0
2,144,144,6,2,4,2,1
0,151,151,1,1,0,1,0
11,182,182,17,17,0,1,0
14,185,185,11,11,0,1,0
19,196,196,51,51,0,1,0
15,206,206,28,5,23,2,1
5,212,212,12,3,9,4,3
29,219,219,14,1,13,2,1
16,222,222,45,9,36,4,3
25,225,225,32,14,18,4,3
10,233,233,35,1,34,4,3
34,239,239,6,6,0,1,0
7,268,268,29,29,0,1,0
3,285,285,22,22,0,1,0
21,298,298,1,1,0,1,0
22,302,302,5,5,0,1,0
20,318,318,11,11,0,1,0
24,330,330,4,1,3,2,1
33,357,357,1,1,0,1,0
30,368,368,58,58,0,1,0
17,371,371,130,100,30,2,1
26,384,384,74,74,0,1,0
27,386,386,13,8,5,2,1
23,388,388,85,61,24,4,3
32,396,396,27,6,21,4,3
37,424,424,15,5,10,2,1
18,425,425,104,89,15,2,1
28,447,447,43,29,14,3,2
31,449,449,45,39,6,2,1
36,453,453,34,34,0,1,0
12,454,454,3,3,0,1,0
35,464,464,115,55,60,3,2
6,468,468,21,5,16,2,1
13,469,469,6,6,0,1,0
8,476,476,6,3,3,2,1
9,492,492,14,4,10,3,2

1,143,143,28,7,21,2,1
30,156,156,1,1,0,1,0
37,163,163,25,25,0,1,0
38,163,163,11,11,0,1,0
2,172,172,36,12,24,3,2
23,179,179,9,9,0,1,0
6,193,193,15,15,0,1,0
17,206,206,5,5,0,1,0
41,231,231,93,85,8,2,1
34,233,233,26,26,0,1,0
25,234,234,28,28,0,1,0
39,239,239,23,23,0,1,0
0,239,239,38,38,0,1,0
19,241,241,2,2,0,1,0
40,245,245,20,14,6,2,1
22,263,263,4,4,0,1,0
21,274,274,3,3,0,1,0
4,275,275,20,13,7,2,1
3,278,278,13,6,7,2,1
29,281,281,6,6,0,1,0
13,296,296,50,50,0,1,0
5,297,297,25,25,0,1,0
35,310,310,50,38,12,2,1
33,314,314,20,4,16,3,2
11,319,319,72,72,0,1,0
14,324,324,19,19,0,1,0
28,327,327,47,5,42,2,1
36,329,329,15,12,3,2,1
27,339,339,15,15,0,1,0
16,342,342,27,6,21,2,1
8,354,354,1,1,0,1,0
18,355,355,25,25,0,1,0
10,376,376,10,10,0,1,0
7,390,390,69,49,20,3,2
26,403,403,7,7,0,1,0
20,418,418,31,31,0,1,0
12,418,418,31,6,25,2,1
31,439,439,158,134,24,2,1
32,442,442,29,29,0,1,0
24,453,453,9,9,0,1,0
9,458,458,19,3,16,2,1
15,484,484,56,56,0,1,0

40,109,109,2,2,0,1,0
26,121,121,44,39,5,2,1
36,135,135,3,3,0,1,0
18,154,154,1,1,0,1,0
3,165,165,9,9,0,1,0
20,176,176,5,1,4,2,1
37,198,198,10,10,0,1,0
13,200,200,16,16,0,1,0
28,201,201,30,10,20,2,1
7,202,202,3,3,0,1,0
15,208,208,19,12,7,2,1
39,218,218,37,5,32,2,1
2,218,218,24,24,0,1,0
8,220,220,1,1,0,1,0
34,222,222,9,2,7,2,1
19,226,226,23,23,0,1,0
11,227,227,22,9,13,2,1
30,229,229,39,5,34,3,2
22,230,230,43,43,0,1,0
25,232,232,16,8,8,3,2
1,234,234,15,15,0,1,0
21,241,241,7,1,6,3,2
38,267,267,24,12,12,3,2
14,270,270,22,8,14,3,2
4,292,292,9,9,0,1,0
10,292,292,33,33,0,1,0
17,302,302,21,9,12,4,3
6,305,305,50,38,12,2,1
29,312,312,5,5,0,1,0
24,314,314,23,1,22,3,2
23,327,327,39,39,0,1,0
5,330,330,104,36,68,3,2
31,349,349,19,19,0,1,0
33,351,351,26,26,0,1,0
35,353,353,37,37,0,1,0
12,356,356,7,7,0,1,0
16,360,360,9,9,0,1,0
27,360,360,14,8,6,2,1
0,372,372,71,35,36,3,2
9,394,394,49,9,40,2,1
32,396,396,3,3,0,1,0
41,411,411,74,42,32,3,2
42,422,422,97,9,88,4,3

33,150,150,36,2,34,2,1
18,163,163,34,34,0,1,0
2,168,168,6,2,4,2,1
30,175,175,40,40,0,1,0
21,187,187,50,6,44,2,1
9,187,187,15,1,14,3,2
37,187,187,24,4,20,3,2
34,190,190,25,25,0,1,0
22,207,207,7,7,0,1,0
29,211,211,4,1,3,2,1
44,218,218,26,14,12,2,1
40,239,239,6,6,0,1,0
24,242,242,25,5,20,2,1
1,244,244,21,21,0,1,0
11,244,244,17,13,4,2,1
20,249,249,13,13,0,1,0
8,254,254,20,5,15,4,3
36,283,283,10,10,0,1,0
4,299,299,19,19,0,1,0
6,299,299,46,46,0,1,0
5,307,307,10,10,0,1,0
3,309,309,9,1,8,2,1
15,310,310,7,7,0,1,0
0,314,314,12,2,10,2,1
31,337,337,2,2,0,1,0
38,347,347,2,2,0,1,0
13,348,348,43,4,39,4,3
42,363,363,20,9,11,2,1
35,366,366,114,54,60,4,3
28,384,384,141,105,36,3,2
14,400,400,7,7,0,1,0
16,402,402,23,23,0,1,0
25,402,402,5,2,3,2,1
26,424,424,22,22,0,1,0
10,425,425,25,9,16,2,1
27,432,432,28,21,7,2,1
43,435,435,36,1,35,4,3
23,444,444,4,4,0,1,0
32,449,449,11,2,9,3,2
39,449,449,36,36,0,1,0
17,480,480,25,25,0,1,0
12,488,488,118,78,40,4,3
19,494,494,10,5,5,2,1
41,495,495,22,22,0,1,0
7,497,497,32,28,4,2,1

18,104,104,5,5,0,1,0
20,135,135,13,2,11,2,1
1,147,147,13,3,10,3,2
11,162,162,4,4,0,1,0
40,189,189,6,6,0,1,0
13,197,197,29,23,6,3,2
21,197,197,5,2,3,2,1
17,220,220,8,3,5,2,1
24,223,223,27,8,19,3,2
31,226,226,6,6,0,1,0
26,232,232,5,5,0,1,0
15,235,235,13,13,0,1,0
38,246,246,8,8,0,1,0
30,249,249,60,60,0,1,0
41,250,250,1,1,0,1,0
0,256,256,67,18,49,4,3
25,257,257,1,1,0,1,0
33,268,268,89,38,51,4,3
28,291,291,7,7,0,1,0
16,294,294,18,6,12,4,3
4,298,298,32,12,20,3,2
14,300,300,12,12,0,1,0
23,307,307,83,83,0,1,0
35,315,315,32,6,26,2,1
36,319,319,12,12,0,1,0
9,326,326,41,21,20,2,1
32,327,327,86,47,39,4,3
34,331,331,4,4,0,1,0
7,356,356,81,9,72,4,3
19,373,373,1,1,0,1,0
12,413,413,6,6,0,1,0
10,426,426,60,6,54,4,3
37,429,429,96,82,14,3,2
39,438,438,48,13,35,2,1
29,445,445,5,5,0,1,0
27,459,459,4,4,0,1,0
6,464,464,61,61,0,1,0
8,469,469,18,18,0,1,0
3,483,483,102,24,78,4,3
5,490,490,51,32,19,2,1
22,495,495,77,11,66,4,3
2,496,496,8,8,0,1,0

24,120,120,26,2,24,2,1
5,128,128,10,10,0,1,0
39,151,151,13,13,0,1,0
25,155,155,15,10,5,2,1
7,158,158,1,1,0,1,0
12,164,164,1,1,0,1,0
20,176,176,1,1,0,1,0
41,186,186,9,9,0,1,0
28,191,191,26,26,0,1,0
27,208,208,10,10,0,1,0
30,214,214,3,3,0,1,0
3,238,238,39,39,0,1,0
18,242,242,1,1,0,1,0
29,257,257,1,1,0,1,0
17,263,263,11,11,0,1,0
35,264,264,42,6,36,3,2
11,280,280,1,1,0,1,0
16,282,282,8,8,0,1,0
37,296,296,16,16,0,1,0
26,296,296,4,1,3,2,1
38,303,303,16,16,0,1,0
34,308,308,56,56,0,1,0
22,309,309,4,4,0,1,0
15,309,309,153,87,66,3,2
13,314,314,11,11,0,1,0
6,324,324,24,7,17,2,1
32,325,325,4,4,0,1,0
10,332,332,7,7,0,1,0
1,353,353,24,24,0,1,0
8,373,373,25,5,20,2,1
19,387,387,8,4,4,2,1
4,394,394,142,100,42,3,2
33,409,409,149,149,0,1,0
9,430,430,32,8,24,4,3
40,444,444,79,1,78,4,3
23,460,460,60,27,33,2,1
36,469,469,58,38,20,3,2
2,470,470,12,2,10,3,2
31,471,471,52,10,42,2,1
21,481,481,74,74,0,1,0
0,493,493,25,25,0,1,0
14,497,497,108,67,41,2,1

10,103,103,12,12,0,1,0
37,110,110,25,5,20,2,1
0,140,140,11,11,0,1,0
14,159,159,7,7,0,1,0
38,165,165,11,11,0,1,0
16,195,195,60,60,0,1,0
8,198,198,12,1,11,3,2
39,216,216,1,1,0,1,0
30,218,218,10,1,9,4,3
45,220,220,33,33,0,1,0
26,235,235,8,8,0,1,0
29,237,237,32,25,7,2,1
25,251,251,6,6,0,1,0
48,255,255,71,29,42,4,3
44,256,256,19,19,0,1,0
9,290,290,7,1,6,2,1
47,298,298,31,31,0,1,0
22,300,300,1,1,0,1,0
31,302,302,85,57,28,4,3
34,303,303,22,14,8,3,2
4,327,327,5,5,0,1,0
21,334,334,22,9,13,4,3
18,341,341,3,3,0,1,0
46,351,351,36,1,35,2,1
35,358,358,15,3,12,2,1
28,371,371,9,9,0,1,0
1,374,374,9,9,0,1,0
17,374,374,4,1,3,2,1
42,375,375,48,3,45,4,3
24,377,377,1,1,0,1,0
3,378,378,11,11,0,1,0
27,378,378,20,20,0,1,0
43,378,378,3,3,0,1,0
19,379,379,5,5,0,1,0
13,380,380,73,73,0,1,0
11,380,380,6,3,3,2,1
36,406,406,30,17,13,2,1
2,430,430,102,39,63,4,3
32,436,436,41,41,0,1,0
41,437,437,19,19,0,1,0
40,438,438,12,6,6,3,2
12,441,441,12,12,0,1,0
7,451,451,59,30,29,2,1
20,452,452,75,32,43,2,1
23,452,452,44,44,0,1,0
5,462,462,63,38,25,2,1
6,467,467,4,4,0,1,0
15,468,468,24,14,10,3,2
33,493,493,36,36,0,1,0

15,109,109,14,14,0,1,0
34,110,110,2,2,0,1,0
38,118,118,32,32,0,1,0
18,124,124,1,1,0,1,0
2,127,127,3,3,0,1,0
29,127,127,1,1,0,1,0
35,146,146,15,15,0,1,0
19,148,148,6,3,3,2,1
36,152,152,2,2,0,1,0
9,157,157,20,20,0,1,0
25,160,160,7,7,0,1,0
26,173,173,5,5,0,1,0
40,176,176,28,8,20,3,2
33,194,194,3,3,0,1,0
3,222,222,62,8,54,4,3
31,229,229,5,5,0,1,0
22,234,234,17,17,0,1,0
21,237,237,44,2,42,2,1
32,238,238,71,71,0,1,0
27,248,248,9,6,3,2,1
14,265,265,1,1,0,1,0
41,291,291,22,22,0,1,0
4,292,292,10,1,9,4,3
24,305,305,160,160,0,1,0
5,320,320,7,2,5,2,1
0,325,325,39,1,38,3,2
37,332,332,27,27,0,1,0
10,340,340,13,5,8,2,1
7,357,357,8,8,0,1,0
11,367,367,46,46,0,1,0
17,378,378,60,60,0,1,0
12,393,393,2,2,0,1,0
16,397,397,102,102,0,1,0
8,409,409,19,19,0,1,0
28,419,419,3,3,0,1,0
30,425,425,68,5,63,4,3
1,444,444,40,11,29,4,3
39,454,454,37,37,0,1,0
20,459,459,44,34,10,3,2
6,463,463,85,45,40,2,1
23,467,467,13,2,11,4,3
13,478,478,4,4,0,1,0

31,105,105,16,16,0,1,0
27,127,127,25,25,0,1,0
34,152,152,9,9,0,1,0
28,159,159,17,4,13,2,1
26,170,170,4,4,0,1,0
1,171,171,66,66,0,1,0
9,186,186,6,6,0,1,0
16,208,208,9,9,0,1,0
20,219,219,31,31,0,1,0
7,235,235,30,21,9,2,1
0,246,246,36,16,20,3,2
2,268,268,28,19,9,2,1
11,271,271,3,3,0,1,0
15,281,281,51,33,18,3,2
14,282,282,6,6,0,1,0
21,290,290,31,31,0,1,0
30,309,309,17,8,9,2,1
4,321,321,1,1,0,1,0
35,322,322,33,33,0,1,0
3,335,335,25,25,0,1,0
29,340,340,38,38,0,1,0
13,350,350,82,79,3,2,1
22,357,357,24,3,21,4,3
33,365,365,63,63,0,1,0
8,368,368,67,31,36,3,2
6,369,369,58,22,36,2,1
12,401,401,105,39,66,4,3
23,413,413,93,93,0,1,0
17,414,414,41,41,0,1,0
18,420,420,96,84,12,4,3
24,435,435,8,8,0,1,0
10,446,446,34,10,24,4,3
32,453,453,9,9,0,1,0
19,456,456,45,23,22,2,1
5,468,468,1,1,0,1,0
25,474,474,2,2,0,1,0

22,100,100,9,6,3,2,1
4,102,102,1,1,0,1,0
15,104,104,7,2,5,2,1
3,110,110,10,10,0,1,0
16,136,136,1,1,0,1,0
1,146,146,3,3,0,1,0
30,155,155,5,5,0,1,0
33,155,155,38,2,36,4,3
6,168,168,11,3,8,3,2
9,168,168,5,5,0,1,0
24,184,184,51,51,0,1,0
25,198,198,10,1,9,2,1
8,201,201,17,7,10,3,2
17,207,207,27,12,15,4,3
34,215,215,3,3,0,1,0
20,222,222,11,4,7,2,1
35,224,224,16,16,0,1,0
0,226,226,3,3,0,1,0
5,233,233,26,26,0,1,0
11,234,234,45,45,0,1,0
2,258,258,59,11,48,3,2
36,269,269,9,4,5,2,1
18,281,281,12,3,9,2,1
21,310,310,6,6,0,1,0
13,313,313,55,55,0,1,0
29,314,314,1,1,0,1,0
12,321,321,26,26,0,1,0
7,361,361,41,41,0,1,0
38,386,386,19,19,0,1,0
14,401,401,103,31,72,4,3
40,402,402,80,80,0,1,0
23,410,410,154,71,83,3,2
31,425,425,74,62,12,4,3
37,434,434,5,2,3,2,1
26,446,446,10,4,6,2,1
19,447,447,66,66,0,1,0
39,465,465,51,51,0,1,0
27,475,475,23,3,20,3,2
28,480,480,90,72,18,3,2
32,498,498,16,3,13,2,1
10,498,498,41,41,0,1,0

27,110,110,14,14,0,1,0
2,114,114,19,19,0,1,0
18,116,116,15,15,0,1,0
35,127,127,3,3,0,1,0
31,134,134,13,13,0,1,0
15,153,153,15,3,12,4,3
28,176,176,10,10,0,1,0
17,188,188,5,2,3,2,1
6,194,194,10,10,0,1,0
36,197,197,11,11,0,1,0
19,214,214,32,8,24,2,1
29,221,221,70,70,0,1,0
12,228,228,15,15,0,1,0
25,257,257,21,21,0,1,0
7,269,269,45,32,13,4,3
26,269,269,5,2,3,2,1
34,270,270,20,20,0,1,0
37,288,288,3,3,0,1,0
13,313,313,6,6,0,1,0
5,342,342,10,3,7,2,1
20,343,343,62,8,54,3,2
32,344,344,29,29,0,1,0
10,350,350,10,6,4,2,1
1,350,350,123,96,27,4,3
24,353,353,19,19,0,1,0
30,355,355,23,23,0,1,0
11,358,358,28,28,0,1,0
0,387,387,63,36,27,4,3
16,402,402,67,29,38,3,2
33,410,410,57,42,15,4,3
22,418,418,78,78,0,1,0
14,422,422,19,11,8,3,2
9,430,430,3,3,0,1,0
21,443,443,2,2,0,1,0
3,455,455,11,1,10,2,1
4,480,480,125,125,0,1,0
8,482,482,123,45,78,4,3
23,497,497,92,37,55,3,2

16,105,105,6,6,0,1,0
36,118,118,17,8,9,2,1
3,160,160,2,2,0,1,0
9,165,165,12,5,7,2,1
2,166,166,8,8,0,1,0
14,167,167,17,8,9,4,3
26,191,191,33,12,21,2,1
40,195,195,17,17,0,1,0
12,202,202,4,4,0,1,0
22,213,213,2,2,0,1,0
27,219,219,109,104,5,2,1
8,225,225,6,6,0,1,0
34,227,227,45,31,14,2,1
21,240,240,33,33,0,1,0
18,252,252,7,7,0,1,0
35,270,270,23,13,10,2,1
7,276,276,13,13,0,1,0
29,286,286,23,23,0,1,0
15,287,287,24,24,0,1,0
33,291,291,17,14,3,2,1
5,310,310,69,36,33,2,1
10,310,310,7,7,0,1,0
25,310,310,3,3,0,1,0
19,317,317,10,1,9,4,3
0,346,346,94,94,0,1,0
28,381,381,62,62,0,1,0
31,404,404,55,55,0,1,0
30,407,407,7,1,6,3,2
6,413,413,40,40,0,1,0
11,413,413,87,1,86,4,3
4,422,422,128,32,96,4,3
37,437,437,9,9,0,1,0
17,438,438,31,13,18,4,3
41,445,445,7,7,0,1,0
20,445,445,25,10,15,4,3
13,445,445,33,22,11,2,1
1,451,451,4,4,0,1,0
39,455,455,26,26,0,1,0
32,456,456,8,8,0,1,0
23,459,459,1,1,0,1,0
38,461,461,30,26,4,2,1
24,464,464,90,22,68,4,3

27,143,143,5,5,0,1,0
12,148,148,1,1,0,1,0
19,167,167,49,18,31,2,1
18,178,178,45,5,40,2,1
20,184,184,8,8,0,1,0
21,201,201,7,7,0,1,0
7,226,226,12,12,0,1,0
15,237,237,1,1,0,1,0
9,267,267,61,61,0,1,0
6,271,271,17,7,10,2,1
2,276,276,22,22,0,1,0
10,293,293,39,1,38,4,3
17,307,307,20,20,0,1,0
22,317,317,1,1,0,1,0
0,364,364,240,240,0,1,0
16,370,370,52,4,48,2,1
5,380,380,82,82,0,1,0
11,383,383,57,27,30,2,1
28,394,394,58,43,15,2,1
8,396,396,137,137,0,1,0
14,399,399,16,16,0,1,0
25,413,413,44,44,0,1,0
1,417,417,58,16,42,2,1
13,420,420,34,1,33,2,1
3,422,422,176,140,36,3,2
23,433,433,38,38,0,1,0
26,446,446,81,62,19,2,1
24,456,456,1,1,0,1,0
4,470,470,13,1,12,3,2

9,100,100,9,9,0,1,0
21,125,125,7,7,0,1,0
35,125,125,4,1,3,2,1
39,133,133,15,15,0,1,0
26,143,143,34,7,27,2,1
5,172,172,5,5,0,1,0
30,174,174,6,6,0,1,0
18,174,174,23,23,0,1,0
33,190,190,29,29,0,1,0
37,193,193,36,36,0,1,0
1,203,203,19,19,0,1,0
20,210,210,35,23,12,4,3
7,224,224,12,3,9,2,1
15,224,224,1,1,0,1,0
32,231,231,37,1,36,4,3
2,231,231,29,10,19,2,1
27,234,234,52,52,0,1,0
34,239,239,26,4,22,2,1
36,242,242,69,21,48,2,1
40,244,244,2,2,0,1,0
6,265,265,8,3,5,2,1
3,272,272,65,35,30,4,3
0,273,273,2,2,0,1,0
31,297,297,9,9,0,1,0
16,306,306,45,45,0,1,0
13,306,306,42,42,0,1,0
10,307,307,29,29,0,1,0
4,308,308,31,7,24,2,1
28,331,331,26,26,0,1,0
25,333,333,4,1,3,2,1
14,382,382,14,2,12,4,3
29,392,392,30,4,26,3,2
22,408,408,8,8,0,1,0
19,418,418,75,63,12,4,3
24,432,432,24,3,21,4,3
12,440,440,22,13,9,4,3
11,452,452,82,82,0,1,0
17,460,460,9,9,0,1,0
38,467,467,10,10,0,1,0
8,483,483,14,14,0,1,0
23,486,486,46,46,0,1,0
41,495,495,54,54,0,1,0

40,109,109,5,5,0,1,0
38,113,113,10,10,0,1,0
7,145,145,19,14,5,2,1
28,149,149,22,2,20,2,1
15,152,152,1,1,0,1,0
32,156,156,34,26,8,3,2
33,156,156,25,25,0,1,0
26,159,159,2,2,0,1,0
36,159,159,1,1,0,1,0
10,168,168,1,1,0,1,0
25,175,175,20,20,0,1,0
3,176,176,2,2,0,1,0
2,182,182,19,19,0,1,0
16,208,208,6,6,0,1,0
23,228,228,19,2,17,4,3
9,228,228,8,8,0,1,0
35,243,243,52,24,28,3,2
24,249,249,60,60,0,1,0
27,251,251,5,5,0,1,0
19,255,255,42,42,0,1,0
8,264,264,1,1,0,1,0
37,272,272,18,18,0,1,0
11,304,304,45,26,19,2,1
12,314,314,92,86,6,2,1
20,317,317,145,92,53,4,3
4,319,319,9,9,0,1,0
22,346,346,2,2,0,1,0
14,349,349,38,9,29,4,3
41,369,369,29,3,26,3,2
1,374,374,11,11,0,1,0
29,375,375,90,19,71,3,2
6,389,389,2,2,0,1,0
13,392,392,21,21,0,1,0
21,399,399,1,1,0,1,0
39,407,407,29,29,0,1,0
30,418,418,16,16,0,1,0
5,436,436,45,45,0,1,0
17,458,458,28,8,20,4,3
18,460,460,100,87,13,2,1
0,477,477,1,1,0,1,0
34,487,487,44,44,0,1,0
31,490,490,56,22,34,3,2

30,103,103,7,1,6,2,1
10,107,107,12,12,0,1,0
41,108,108,4,4,0,1,0
27,121,121,8,8,0,1,0
12,127,127,4,4,0,1,0
11,136,136,8,8,0,1,0
38,147,147,9,9,0,1,0
24,154,154,12,4,8,3,2
28,155,155,22,11,11,2,1
2,183,183,6,6,0,1,0
34,187,187,7,7,0,1,0
40,188,188,41,5,36,2,1
18,191,191,1,1,0,1,0
33,192,192,12,6,6,2,1
15,217,217,8,5,3,2,1
36,222,222,4,4,0,1,0
16,229,229,26,15,11,2,1
0,268,268,31,9,22,3,2
35,273,273,9,3,6,2,1
22,284,284,55,19,36,4,3
7,296,296,7,4,3,2,1
8,299,299,9,9,0,1,0
17,306,306,151,144,7,2,1
25,318,318,33,33,0,1,0
37,325,325,30,30,0,1,0
5,326,326,10,2,8,3,2
21,354,354,94,35,59,3,2
32,370,370,27,13,14,2,1
19,374,374,16,16,0,1,0
9,384,384,40,40,0,1,0
29,386,386,105,32,73,4,3
6,396,396,1,1,0,1,0
3,400,400,22,17,5,2,1
23,407,407,47,47,0,1,0
31,421,421,52,42,10,2,1
4,443,443,7,3,4,2,1
1,451,451,19,12,7,2,1
26,460,460,19,6,13,2,1
13,466,466,25,25,0,1,0
14,468,468,105,79,26,3,2
39,476,476,102,102,0,1,0
20,492,492,55,55,0,1,0

17,103,103,21,1,20,3,2
26,114,114,6,1,5,2,1
20,125,125,18,18,0,1,0
32,135,135,19,19,0,1,0
7,138,138,8,8,0,1,0
37,140,140,28,21,7,2,1
4,142,142,16,16,0,1,0
33,155,155,23,23,0,1,0
38,156,156,12,12,0,1,0
18,161,161,8,2,6,2,1
13,174,174,12,12,0,1,0
23,192,192,20,20,0,1,0
39,198,198,3,3,0,1,0
11,214,214,31,22,9,4,3
22,218,218,23,10,13,2,1
14,247,247,10,10,0,1,0
0,253,253,19,13,6,2,1
8,276,276,35,11,24,2,1
6,304,304,16,16,0,1,0
35,305,305,34,34,0,1,0
25,308,308,34,31,3,2,1
10,314,314,46,30,16,4,3
34,319,319,11,11,0,1,0
31,323,323,38,12,26,3,2
5,324,324,50,12,38,3,2
40,325,325,54,49,5,2,1
41,341,341,108,108,0,1,0
2,351,351,1,1,0,1,0
24,352,352,38,27,11,2,1
19,354,354,21,21,0,1,0
9,363,363,32,32,0,1,0
30,379,379,7,7,0,1,0
1,385,385,10,5,5,2,1
29,386,386,4,1,3,2,1
3,392,392,16,16,0,1,0
28,415,415,66,55,11,2,1
16,422,422,27,9,18,4,3
15,439,439,11,11,0,1,0
36,441,441,16,6,10,3,2
27,454,454,4,4,0,1,0
21,465,465,44,44,0,1,0
12,484,484,108,48,60,4,3

27,109,109,14,14,0,1,0
0,114,114,4,4,0,1,0
22,173,173,20,20,0,1,0
11,188,188,4,4,0,1,0
8,193,193,102,32,70,3,2
21,196,196,1,1,0,1,0
31,206,206,36,36,0,1,0
17,207,207,8,8,0,1,0
25,208,208,49,1,48,3,2
32,221,221,21,21,0,1,0
23,222,222,9,9,0,1,0
10,225,225,33,15,18,3,2
4,227,227,1,1,0,1,0
26,234,234,16,16,0,1,0
19,238,238,24,18,6,2,1
7,242,242,77,38,39,4,3
5,275,275,67,67,0,1,0
24,276,276,25,8,17,2,1
1,280,280,20,20,0,1,0
9,287,287,1,1,0,1,0
13,288,288,42,3,39,4,3
6,296,296,9,9,0,1,0
34,297,297,2,2,0,1,0
35,326,326,5,1,4,2,1
28,331,331,39,12,27,4,3
33,338,338,5,5,0,1,0
20,372,372,76,58,18,4,3
2,373,373,8,8,0,1,0
30,389,389,63,63,0,1,0
18,392,392,59,59,0,1,0
12,394,394,64,22,42,2,1
15,415,415,39,39,0,1,0
29,422,422,17,17,0,1,0
14,434,434,55,55,0,1,0
3,445,445,21,21,0,1,0
16,467,467,110,36,74,4,3

41,105,105,14,9,5,2,1
23,109,109,2,2,0,1,0
29,112,112,14,14,0,1,0
3,121,121,22,5,17,2,1
38,137,137,20,20,0,1,0
13,148,148,14,3,11,4,3
8,150,150,17,11,6,3,2
22,161,161,2,2,0,1,0
9,163,163,39,1,38,3,2
30,177,177,8,3,5,2,1
1,189,189,8,1,7,2,1
12,195,195,27,15,12,2,1
42,198,198,5,5,0,1,0
37,214,214,3,3,0,1,0
28,220,220,2,2,0,1,0
26,226,226,24,2,22,4,3
17,228,228,11,2,9,4,3
2,231,231,21,21,0,1,0
43,234,234,6,6,0,1,0
33,236,236,14,14,0,1,0
21,238,238,9,9,0,1,0
32,259,259,34,13,21,4,3
34,269,269,64,14,50,2,1
40,281,281,82,40,42,4,3
18,286,286,27,27,0,1,0
6,319,319,18,2,16,4,3
14,337,337,14,14,0,1,0
25,352,352,34,34,0,1,0
10,358,358,4,4,0,1,0
15,362,362,31,31,0,1,0
5,364,364,2,2,0,1,0
0,365,365,7,7,0,1,0
36,375,375,86,86,0,1,0
11,375,375,19,5,14,3,2
31,376,376,8,8,0,1,0
19,407,407,50,50,0,1,0
16,408,408,102,96,6,2,1
4,412,412,21,21,0,1,0
24,437,437,80,80,0,1,0
39,437,437,20,20,0,1,0
35,451,451,25,11,14,3,2
20,451,451,60,60,0,1,0
27,457,457,31,31,0,1,0
7,484,484,30,30,0,1,0

11,129,129,3,3,0,1,0
36,136,136,5,2,3,2,1
34,136,136,37,4,33,4,3
8,151,151,1,1,0,1,0
37,152,152,23,23,0,1,0
19,168,168,11,1,10,3,2
1,170,170,21,21,0,1,0
3,182,182,1,1,0,1,0
9,186,186,61,61,0,1,0
35,194,194,2,2,0,1,0
25,198,198,1,1,0,1,0
12,224,224,57,57,0,1,0
14,235,235,36,15,21,2,1
4,243,243,19,19,0,1,0
18,258,258,60,60,0,1,0
32,260,260,2,2,0,1,0
6,263,263,8,8,0,1,0
15,283,283,61,11,50,2,1
22,288,288,18,18,0,1,0
13,294,294,25,4,21,4,3
0,314,314,6,6,0,1,0
5,328,328,6,1,5,2,1
23,329,329,26,26,0,1,0
7,345,345,15,15,0,1,0
28,357,357,33,33,0,1,0
33,366,366,60,36,24,2,1
10,373,373,12,12,0,1,0
38,393,393,4,4,0,1,0
17,401,401,4,4,0,1,0
21,410,410,40,12,28,3,2
20,415,415,34,10,24,4,3
24,442,442,73,73,0,1,0
31,459,459,43,43,0,1,0
2,461,461,71,71,0,1,0
16,476,476,90,30,60,4,3
30,479,479,34,34,0,1,0
29,488,488,155,114,41,2,1
27,494,494,58,7,51,4,3
26,500,500,66,58,8,2,1

27,106,106,4,4,0,1,0
24,114,114,13,1,12,3,2
7,128,128,26,3,23,4,3
4,129,129,19,19,0,1,0
21,163,163,1,1,0,1,0
30,167,167,5,1,4,2,1
12,169,169,37,8,29,3,2
1,175,175,8,4,4,2,1
9,204,204,44,44,0,1,0
20,213,213,5,1,4,2,1
26,219,219,3,3,0,1,0
2,238,238,80,10,70,3,2
23,238,238,7,1,6,3,2
31,260,260,20,20,0,1,0
11,315,315,12,6,6,3,2
13,329,329,9,9,0,1,0
19,353,353,8,2,6,3,2
5,357,357,5,5,0,1,0
15,386,386,45,45,0,1,0
16,389,389,66,66,0,1,0
18,403,403,4,4,0,1,0
25,409,409,173,117,56,3,2
17,419,419,19,19,0,1,0
28,421,421,43,26,17,2,1
14,425,425,101,3,98,3,2
22,426,426,123,28,95,4,3
8,426,426,250,207,43,2,1
3,447,447,65,23,42,4,3
0,452,452,13,13,0,1,0
29,452,452,23,17,6,2,1
6,481,481,84,12,72,3,2
10,494,494,32,23,9,4,3

33,106,106,5,5,0,1,0
41,107,107,12,12,0,1,0
16,131,131,2,2,0,1,0
14,134,134,1,1,0,1,0
31,135,135,8,8,0,1,0
2,149,149,23,23,0,1,0
29,160,160,34,24,10,3,2
3,204,204,16,16,0,1,0
12,217,217,26,26,0,1,0
34,224,224,106,16,90,3,2
23,240,240,84,28,56,3,2
35,248,248,1,1,0,1,0
32,249,249,8,8,0,1,0
27,280,280,16,10,6,2,1
28,301,301,10,10,0,1,0
6,304,304,1,1,0,1,0
26,330,330,33,33,0,1,0
21,335,335,36,19,17,2,1
30,335,335,8,8,0,1,0
15,338,338,14,14,0,1,0
5,353,353,5,5,0,1,0
37,354,354,34,34,0,1,0
24,363,363,14,3,11,2,1
0,367,367,52,52,0,1,0
18,377,377,18,2,16,3,2
22,382,382,45,2,43,2,1
7,383,383,53,53,0,1,0
11,395,395,8,8,0,1,0
8,398,398,75,75,0,1,0
19,416,416,28,5,23,2,1
1,419,419,5,5,0,1,0
40,426,426,13,13,0,1,0
36,428,428,1,1,0,1,0
39,439,439,20,5,15,4,3
38,448,448,81,18,63,4,3
10,453,453,135,113,22,3,2
13,463,463,29,25,4,2,1
17,468,468,16,1,15,4,3
25,475,475,10,10,0,1,0
4,493,493,100,25,75,4,3
20,494,494,49,49,0,1,0
9,496,496,73,29,44,3,2

13,109,109,4,4,0,1,0
24,116,116,4,4,0,1,0
36,123,123,10,10,0,1,0
31,123,123,3,3,0,1,0
11,132,132,1,1,0,1,0
29,132,132,18,14,4,2,1
18,142,142,15,15,0,1,0
12,148,148,1,1,0,1,0
27,170,170,7,7,0,1,0
16,171,171,12,6,6,2,1
20,174,174,1,1,0,1,0
0,192,192,6,6,0,1,0
32,203,203,2,2,0,1,0
21,226,226,46,39,7,2,1
7,226,226,38,38,0,1,0
26,238,238,22,22,0,1,0
15,276,276,17,17,0,1,0
41,283,283,18,9,9,4,3
33,285,285,30,15,15,2,1
28,292,292,86,86,0,1,0
9,292,292,33,15,18,3,2
40,308,308,91,53,38,3,2
25,317,317,12,12,0,1,0
43,339,339,25,25,0,1,0
2,342,342,37,37,0,1,0
6,345,345,17,17,0,1,0
14,346,346,1,1,0,1,0
8,360,360,4,1,3,2,1
39,366,366,8,2,6,3,2
1,394,394,14,4,10,2,1
38,394,394,59,33,26,2,1
37,396,396,2,2,0,1,0
30,407,407,32,2,30,2,1
4,419,419,95,11,84,4,3
42,421,421,181,181,0,1,0
17,424,424,39,39,0,1,0
3,432,432,50,30,20,3,2
5,432,432,12,12,0,1,0
10,441,441,22,22,0,1,0
19,454,454,81,73,8,3,2
23,471,471,23,12,11,2,1
22,480,480,117,111,6,3,2
34,485,485,6,2,4,2,1
35,500,500,26,26,0,1,0

35,100,100,7,7,0,1,0
9,104,104,15,6,9,4,3
8,116,116,17,5,12,4,3
32,128,128,16,16,0,1,0
1,130,130,5,5,0,1,0
10,142,142,55,3,52,3,2
4,152,152,20,11,9,4,3
39,152,152,51,51,0,1,0
13,170,170,15,15,0,1,0
33,183,183,13,13,0,1,0
21,185,185,10,10,0,1,0
29,194,194,4,4,0,1,0
28,195,195,19,19,0,1,0
2,201,201,3,3,0,1,0
38,219,219,16,16,0,1,0
22,222,222,7,7,0,1,0
12,229,229,1,1,0,1,0
5,259,259,8,8,0,1,0
6,259,259,1,1,0,1,0
40,261,261,17,17,0,1,0
17,262,262,13,6,7,2,1
18,265,265,7,1,6,2,1
42,268,268,22,22,0,1,0
20,299,299,10,1,9,2,1
14,321,321,38,24,14,2,1
25,337,337,5,1,4,2,1
19,369,369,47,5,42,2,1
34,393,393,18,2,16,4,3
26,395,395,23,23,0,1,0
31,395,395,2,2,0,1,0
7,425,425,86,20,66,4,3
3,425,425,27,27,0,1,0
15,429,429,26,26,0,1,0
36,440,440,124,124,0,1,0
23,441,441,25,15,10,3,2
11,448,448,40,40,0,1,0
16,448,448,19,8,11,2,1
0,455,455,52,52,0,1,0
24,476,476,1,1,0,1,0
27,481,481,114,114,0,1,0
41,483,483,48,22,26,4,3
30,485,485,54,54,0,1,0
37,490,490,93,93,0,1,0

20,112,112,25,25,0,1,0
10,132,132,3,3,0,1,0
39,145,145,12,3,9,2,1
14,153,153,1,1,0,1,0
38,154,154,22,22,0,1,0
37,160,160,25,11,14,3,2
15,161,161,11,11,0,1,0
4,162,162,1,1,0,1,0
17,166,166,24,3,21,3,2
8,181,181,39,39,0,1,0
0,189,189,7,7,0,1,0
7,192,192,30,22,8,3,2
36,199,199,9,9,0,1,0
26,211,211,2,2,0,1,0
9,213,213,5,5,0,1,0
5,233,233,37,37,0,1,0
32,235,235,18,1,17,2,1
22,257,257,15,15,0,1,0
33,280,280,5,5,0,1,0
21,281,281,1,1,0,1,0
28,297,297,68,68,0,1,0
18,314,314,18,6,12,4,3
27,317,317,3,3,0,1,0
3,327,327,16,7,9,4,3
11,334,334,43,34,9,4,3
13,337,337,67,55,12,3,2
19,345,345,15,15,0,1,0
29,347,347,54,29,25,2,1
40,366,366,28,28,0,1,0
34,367,367,18,18,0,1,0
24,372,372,163,163,0,1,0
2,428,428,63,28,35,4,3
23,460,460,36,2,34,4,3
16,460,460,28,10,18,4,3
31,464,464,31,31,0,1,0
35,469,469,18,18,0,1,0
1,477,477,1,1,0,1,0
25,490,490,7,7,0,1,0
12,490,490,60,14,46,2,1
6,497,497,64,17,47,4,3
30,499,499,145,69,76,4,3

32,105,105,5,5,0,1,0
23,108,108,17,2,15,2,1
34,117,117,4,4,0,1,0
11,120,120,3,3,0,1,0
1,129,129,1,1,0,1,0
9,129,129,1,1,0,1,0
28,131,131,16,16,0,1,0
6,137,137,4,1,3,2,1
3,161,161,23,1,22,2,1
27,164,164,15,15,0,1,0
18,169,169,41,41,0,1,0
13,172,172,27,4,23,2,1
2,218,218,67,3,64,3,2
19,229,229,20,20,0,1,0
20,232,232,20,20,0,1,0
26,238,238,13,13,0,1,0
16,251,251,26,26,0,1,0
17,256,256,26,26,0,1,0
10,269,269,8,8,0,1,0
29,276,276,53,53,0,1,0
25,284,284,72,72,0,1,0
33,295,295,16,3,13,2,1
30,332,332,60,6,54,3,2
5,355,355,45,15,30,2,1
15,379,379,3,3,0,1,0
35,379,379,34,30,4,2,1
4,403,403,124,82,42,4,3
24,404,404,45,25,20,3,2
12,409,409,264,241,23,2,1
31,418,418,6,6,0,1,0
0,423,423,35,27,8,2,1
8,436,436,32,32,0,1,0
7,442,442,6,6,0,1,0
14,451,451,17,1,16,2,1
21,456,456,9,9,0,1,0
22,481,481,3,3,0,1,0

5,169,169,22,9,13,2,1
38,179,179,2,2,0,1,0
24,191,191,2,2,0,1,0
18,202,202,25,25,0,1,0
22,211,211,7,4,3,2,1
35,219,219,32,32,0,1,0
37,230,230,88,22,66,4,3
9,235,235,2,2,0,1,0
14,259,259,52,33,19,2,1
27,269,269,83,41,42,3,2
4,273,273,22,22,0,1,0
33,289,289,34,34,0,1,0
32,300,300,35,35,0,1,0
20,303,303,79,35,44,2,1
15,307,307,37,4,33,4,3
36,321,321,1,1,0,1,0
10,323,323,89,89,0,1,0
13,324,324,17,17,0,1,0
31,338,338,4,4,0,1,0
21,344,344,3,3,0,1,0
0,345,345,15,15,0,1,0
30,349,349,30,22,8,2,1
3,350,350,10,10,0,1,0
8,353,353,40,12,28,2,1
29,356,356,14,5,9,4,3
17,359,359,7,7,0,1,0
26,360,360,59,59,0,1,0
6,360,360,14,2,12,3,2
11,369,369,36,28,8,2,1
7,396,396,1,1,0,1,0
12,399,399,114,114,0,1,0
1,408,408,98,76,22,3,2
16,421,421,31,31,0,1,0
23,446,446,14,11,3,2,1
2,449,449,29,29,0,1,0
19,459,459,94,94,0,1,0
25,466,466,8,4,4,2,1
28,478,478,27,2,25,2,1
34,488,488,11,11,0,1,0

39,101,101,2,2,0,1,0
24,110,110,2,2,0,1,0
17,121,121,16,4,12,2,1
16,136,136,8,8,0,1,0
20,140,140,4,4,0,1,0
14,140,140,10,2,8,3,2
31,170,170,11,11,0,1,0
22,176,176,27,13,14,3,2
33,182,182,46,46,0,1,0
41,187,187,6,6,0,1,0
21,188,188,36,30,6,3,2
32,201,201,32,32,0,1,0
15,203,203,36,14,22,3,2
26,204,204,48,27,21,4,3
6,208,208,1,1,0,1,0
30,212,212,31,15,16,2,1
29,218,218,12,2,10,3,2
5,253,253,2,2,0,1,0
23,255,255,28,17,11,2,1
10,263,263,41,41,0,1,0
38,264,264,102,102,0,1,0
12,290,290,8,8,0,1,0
4,312,312,20,20,0,1,0
13,312,312,19,19,0,1,0
1,313,313,8,3,5,2,1
34,314,314,4,4,0,1,0
0,325,325,32,15,17,2,1
19,346,346,95,37,58,3,2
37,349,349,18,18,0,1,0
18,356,356,80,80,0,1,0
8,362,362,35,19,16,3,2
11,367,367,5,5,0,1,0
9,408,408,44,34,10,3,2
2,427,427,21,3,18,2,1
3,444,444,17,7,10,3,2
36,444,444,40,29,11,2,1
28,449,449,20,20,0,1,0
40,455,455,4,4,0,1,0
7,477,477,44,39,5,2,1
27,481,481,77,31,46,4,3
35,490,490,14,14,0,1,0
25,494,494,9,9,0,1,0

10,114,114,1,1,0,1,0
34,122,122,1,1,0,1,0
11,128,128,15,1,14,2,1
32,143,143,11,11,0,1,0
29,147,147,12,12,0,1,0
20,161,161,2,2,0,1,0
8,174,174,11,11,0,1,0
31,178,178,18,10,8,3,2
13,184,184,1,1,0,1,0
6,186,186,24,24,0,1,0
38,200,200,8,2,6,3,2
42,212,212,14,14,0,1,0
33,218,218,10,10,0,1,0
24,221,221,33,24,9,4,3
9,222,222,2,2,0,1,0
19,251,251,24,24,0,1,0
40,264,264,12,12,0,1,0
27,272,272,24,14,10,3,2
7,280,280,9,1,8,2,1
30,283,283,74,28,46,3,2
3,290,290,19,19,0,1,0
28,293,293,11,11,0,1,0
5,357,357,48,1,47,2,1
15,360,360,1,1,0,1,0
14,380,380,43,43,0,1,0
12,386,386,28,20,8,3,2
0,398,398,13,9,4,2,1
17,403,403,35,21,14,2,1
25,417,417,62,47,15,4,3
26,421,421,40,11,29,4,3
4,430,430,9,9,0,1,0
21,436,436,24,24,0,1,0
16,437,437,273,273,0,1,0
41,437,437,154,154,0,1,0
18,438,438,4,4,0,1,0
39,438,438,32,32,0,1,0
36,454,454,19,19,0,1,0
1,454,454,26,22,4,2,1
23,458,458,48,27,21,4,3
35,475,475,98,50,48,2,1
22,482,482,22,22,0,1,0
37,489,489,12,12,0,1,0
2,494,494,102,59,43,4,3

31,110,110,10,10,0,1,0
24,111,111,3,3,0,1,0
16,114,114,8,5,3,2,1
6,118,118,9,9,0,1,0
25,152,152,7,7,0,1,0
17,154,154,6,1,5,2,1
9,155,155,35,29,6,2,1
28,160,160,14,14,0,1,0
29,192,192,50,50,0,1,0
3,228,228,87,61,26,2,1
20,241,241,14,14,0,1,0
34,249,249,57,57,0,1,0
18,259,259,5,5,0,1,0
15,261,261,2,2,0,1,0
19,266,266,64,35,29,2,1
4,274,274,1,1,0,1,0
11,276,276,13,13,0,1,0
12,310,310,7,7,0,1,0
27,327,327,25,25,0,1,0
21,332,332,25,17,8,2,1
26,335,335,117,89,28,2,1
14,358,358,5,1,4,2,1
2,367,367,32,32,0,1,0
0,377,377,79,19,60,3,2
23,383,383,24,10,14,3,2
1,387,387,12,12,0,1,0
32,398,398,67,40,27,4,3
30,411,411,23,7,16,2,1
5,413,413,1,1,0,1,0
33,413,413,11,3,8,2,1
13,416,416,198,198,0,1,0
8,457,457,63,3,60,3,2
22,468,468,23,10,13,2,1
10,468,468,48,16,32,3,2
7,475,475,87,13,74,3,2

10,101,101,11,6,5,2,1
31,124,124,15,15,0,1,0
0,147,147,12,12,0,1,0
3,148,148,17,12,5,2,1
9,148,148,56,32,24,2,1
22,158,158,19,2,17,3,2
41,167,167,40,1,39,2,1
16,170,170,22,22,0,1,0
19,175,175,19,19,0,1,0
17,190,190,5,5,0,1,0
12,196,196,56,56,0,1,0
18,201,201,32,32,0,1,0
26,211,211,13,6,7,2,1
29,231,231,3,3,0,1,0
33,233,233,64,41,23,2,1
35,264,264,6,3,3,2,1
5,283,283,7,7,0,1,0
15,285,285,30,30,0,1,0
13,292,292,7,3,4,2,1
39,296,296,33,33,0,1,0
34,304,304,7,1,6,3,2
14,308,308,35,28,7,2,1
11,325,325,8,8,0,1,0
36,358,358,27,3,24,2,1
20,368,368,8,1,7,2,1
25,368,368,77,77,0,1,0
1,371,371,22,22,0,1,0
6,376,376,29,29,0,1,0
8,382,382,6,6,0,1,0
32,390,390,46,37,9,4,3
40,400,400,135,68,67,4,3
38,413,413,16,16,0,1,0
7,420,420,1,1,0,1,0
21,421,421,27,20,7,2,1
37,435,435,25,25,0,1,0
30,442,442,32,22,10,3,2
23,448,448,29,17,12,2,1
28,450,450,15,15,0,1,0
27,459,459,1,1,0,1,0
2,477,477,12,6,6,3,2
4,479,479,24,3,21,4,3
24,498,498,20,20,0,1,0

31,100,100,5,5,0,1,0
12,137,137,20,20,0,1,0
20,150,150,37,37,0,1,0
11,167,167,20,7,13,2,1
25,169,169,2,2,0,1,0
22,178,178,11,11,0,1,0
26,180,180,19,19,0,1,0
15,187,187,21,21,0,1,0
6,189,189,17,9,8,2,1
16,198,198,1,1,0,1,0
5,202,202,5,5,0,1,0
27,223,223,33,9,24,4,3
18,248,248,40,32,8,2,1
3,257,257,6,6,0,1,0
17,260,260,42,25,17,2,1
14,266,266,64,42,22,2,1
32,279,279,44,22,22,2,1
1,280,280,29,10,19,2,1
0,285,285,3,3,0,1,0
29,285,285,33,3,30,4,3
8,290,290,80,38,42,4,3
13,293,293,13,13,0,1,0
39,315,315,31,31,0,1,0
36,317,317,35,17,18,3,2
38,318,318,11,3,8,3,2
23,327,327,27,1,26,3,2
24,349,349,50,50,0,1,0
30,358,358,4,1,3,2,1
4,363,363,2,2,0,1,0
2,374,374,48,26,22,2,1
34,375,375,31,31,0,1,0
9,380,380,29,29,0,1,0
21,383,383,61,61,0,1,0
33,440,440,108,38,70,3,2
19,455,455,14,4,10,3,2
10,470,470,73,13,60,3,2
37,477,477,24,24,0,1,0
7,489,489,42,42,0,1,0
35,496,496,56,23,33,4,3
28,497,497,6,1,5,2,1

3,101,101,10,10,0,1,0
32,110,110,1,1,0,1,0
9,114,114,19,19,0,1,0
7,118,118,25,13,12,4,3
25,127,127,11,11,0,1,0
42,127,127,13,1,12,3,2
14,135,135,3,3,0,1,0
39,136,136,17,17,0,1,0
22,142,142,15,15,0,1,0
36,147,147,10,10,0,1,0
29,160,160,15,15,0,1,0
13,171,171,1,1,0,1,0
16,191,191,1,1,0,1,0
8,198,198,22,3,19,2,1
27,218,218,10,4,6,3,2
35,219,219,2,2,0,1,0
37,241,241,11,3,8,3,2
20,249,249,18,18,0,1,0
31,266,266,25,25,0,1,0
38,278,278,23,23,0,1,0
4,289,289,26,26,0,1,0
11,305,305,8,1,7,2,1
0,310,310,63,63,0,1,0
28,323,323,25,5,20,2,1
24,328,328,41,41,0,1,0
6,328,328,73,3,70,3,2
15,336,336,13,3,10,3,2
40,357,357,20,20,0,1,0
10,367,367,2,2,0,1,0
1,376,376,65,38,27,4,3
17,376,376,44,44,0,1,0
12,379,379,5,5,0,1,0
2,381,381,15,1,14,2,1
34,390,390,92,42,50,4,3
26,393,393,44,44,0,1,0
19,417,417,45,45,0,1,0
18,424,424,12,4,8,2,1
23,429,429,31,31,0,1,0
30,459,459,90,63,27,4,3
33,467,467,47,11,36,4,3
41,477,477,26,26,0,1,0
21,491,491,26,7,19,4,3
5,493,493,5,2,3,2,1
43,499,499,161,62,99,4,3

23,102,102,13,13,0,1,0
33,113,113,21,21,0,1,0
27,115,115,15,11,4,2,1
8,122,122,9,9,0,1,0
34,138,138,10,10,0,1,0
26,151,151,20,20,0,1,0
5,154,154,21,21,0,1,0
11,161,161,15,15,0,1,0
24,162,162,17,17,0,1,0
25,171,171,18,6,12,3,2
30,177,177,34,34,0,1,0
17,189,189,2,2,0,1,0
6,194,194,75,49,26,3,2
12,194,194,10,10,0,1,0
14,212,212,23,23,0,1,0
29,219,219,81,81,0,1,0
19,220,220,11,11,0,1,0
16,229,229,14,4,10,2,1
9,232,232,18,1,17,2,1
7,233,233,8,8,0,1,0
15,287,287,26,13,13,2,1
13,310,310,16,16,0,1,0
0,333,333,13,13,0,1,0
22,339,339,9,9,0,1,0
2,339,339,48,48,0,1,0
18,351,351,9,4,5,2,1
32,374,374,49,49,0,1,0
21,376,376,13,8,5,2,1
28,386,386,40,17,23,2,1
31,424,424,9,9,0,1,0
1,451,451,257,257,0,1,0
3,493,493,55,37,18,4,3
10,494,494,20,6,14,3,2
4,499,499,43,43,0,1,0
20,500,500,35,1,34,2,1

37,118,118,5,5,0,1,0
13,135,135,8,8,0,1,0
34,135,135,3,3,0,1,0
2,136,136,4,4,0,1,0
22,137,137,38,38,0,1,0
7,137,137,16,16,0,1,0
11,138,138,28,3,25,4,3
15,142,142,3,3,0,1,0
14,146,146,9,9,0,1,0
18,164,164,8,8,0,1,0
35,174,174,21,21,0,1,0
8,196,196,9,9,0,1,0
16,206,206,37,37,0,1,0
25,206,206,11,1,10,3,2
27,231,231,30,30,0,1,0
6,245,245,58,58,0,1,0
10,260,260,3,3,0,1,0
30,279,279,20,20,0,1,0
32,282,282,51,15,36,2,1
24,283,283,98,26,72,4,3
12,285,285,1,1,0,1,0
20,286,286,18,18,0,1,0
31,286,286,4,4,0,1,0
5,290,290,12,12,0,1,0
0,332,332,111,7,104,4,3
3,336,336,10,2,8,3,2
39,338,338,94,12,82,3,2
9,338,338,127,46,81,4,3
28,387,387,7,7,0,1,0
36,408,408,31,21,10,2,1
29,429,429,28,28,0,1,0
21,447,447,3,3,0,1,0
4,462,462,21,21,0,1,0
33,467,467,20,20,0,1,0
38,472,472,35,35,0,1,0
23,476,476,31,31,0,1,0
1,479,479,13,13,0,1,0
19,486,486,6,6,0,1,0
26,489,489,42,42,0,1,0
17,497,497,58,58,0,1,0

20,108,108,13,13,0,1,0
31,112,112,5,5,0,1,0
33,120,120,3,3,0,1,0
1,121,121,10,4,6,3,2
4,135,135,13,1,12,2,1
21,136,136,7,4,3,2,1
0,136,136,18,1,17,2,1
17,147,147,7,7,0,1,0
27,153,153,5,5,0,1,0
39,172,172,14,5,9,3,2
16,187,187,16,16,0,1,0
37,193,193,21,21,0,1,0
25,206,206,18,18,0,1,0
15,212,212,1,1,0,1,0
7,241,241,70,43,27,2,1
26,245,245,11,11,0,1,0
38,247,247,6,6,0,1,0
32,250,250,13,10,3,2,1
34,265,265,34,34,0,1,0
36,276,276,52,24,28,3,2
23,282,282,73,41,32,3,2
24,283,283,71,71,0,1,0
22,289,289,31,31,0,1,0
12,291,291,37,32,5,2,1
3,303,303,7,2,5,2,1
35,313,313,26,3,23,2,1
19,326,326,10,1,9,2,1
11,350,350,78,44,34,2,1
10,354,354,1,1,0,1,0
30,357,357,28,12,16,2,1
13,358,358,14,3,11,2,1
28,360,360,20,7,13,2,1
6,379,379,33,33,0,1,0
40,381,381,100,67,33,4,3
29,414,414,2,2,0,1,0
9,424,424,38,38,0,1,0
5,431,431,4,4,0,1,0
2,440,440,17,17,0,1,0
14,440,440,18,18,0,1,0
8,453,453,109,109,0,1,0
41,496,496,63,57,6,3,2
18,497,497,68,46,22,3,2

17,104,104,1,1,0,1,0
18,129,129,18,2,16,3,2
15,140,140,22,10,12,2,1
2,149,149,15,15,0,1,0
37,183,183,19,19,0,1,0
24,199,199,18,4,14,3,2
20,204,204,26,26,0,1,0
25,206,206,8,1,7,2,1
11,210,210,42,3,39,4,3
23,217,217,9,9,0,1,0
8,220,220,52,41,11,2,1
29,231,231,10,2,8,3,2
27,235,235,22,10,12,3,2
31,236,236,29,29,0,1,0
12,240,240,1,1,0,1,0
32,265,265,17,13,4,2,1
21,276,276,27,27,0,1,0
36,295,295,42,15,27,2,1
22,303,303,79,79,0,1,0
7,324,324,97,55,42,3,2
6,348,348,32,16,16,3,2
1,364,364,26,26,0,1,0
33,365,365,59,9,50,3,2
5,374,374,1,1,0,1,0
3,392,392,70,70,0,1,0
0,394,394,29,24,5,2,1
10,401,401,31,31,0,1,0
4,404,404,103,103,0,1,0
14,407,407,1,1,0,1,0
35,418,418,22,22,0,1,0
16,419,419,22,22,0,1,0
19,420,420,45,6,39,2,1
13,421,421,32,24,8,3,2
9,431,431,49,13,36,3,2
26,434,434,34,34,0,1,0
34,449,449,55,19,36,3,2
30,455,455,15,8,7,2,1
28,467,467,54,54,0,1,0

23,104,104,16,3,13,2,1
33,119,119,2,2,0,1,0
27,124,124,2,2,0,1,0
39,126,126,31,31,0,1,0
48,130,130,9,9,0,1,0
4,139,139,6,6,0,1,0
35,141,141,4,1,3,2,1
30,141,141,14,5,9,3,2
37,151,151,50,5,45,2,1
6,167,167,8,8,0,1,0
24,167,167,18,11,7,2,1
42,171,171,91,47,44,3,2
46,176,176,15,15,0,1,0
34,190,190,4,4,0,1,0
7,218,218,11,3,8,3,2
20,223,223,6,6,0,1,0
0,232,232,7,2,5,2,1
45,244,244,17,12,5,2,1
16,257,257,27,5,22,3,2
18,261,261,1,1,0,1,0
41,263,263,18,4,14,3,2
2,265,265,11,7,4,2,1
1,267,267,5,5,0,1,0
38,268,268,18,10,8,3,2
29,286,286,42,42,0,1,0
44,290,290,2,2,0,1,0
17,300,300,21,21,0,1,0
22,322,322,26,5,21,4,3
40,323,323,3,3,0,1,0
13,323,323,27,2,25,3,2
36,333,333,1,1,0,1,0
11,341,341,2,2,0,1,0
9,343,343,68,68,0,1,0
32,347,347,8,1,7,2,1
25,351,351,7,7,0,1,0
26,357,357,35,31,4,2,1
5,365,365,58,4,54,4,3
28,376,376,52,19,33,2,1
8,383,383,56,32,24,3,2
10,429,429,3,3,0,1,0
47,434,434,41,11,30,4,3
12,442,442,20,5,15,2,1
43,451,451,7,2,5,2,1
15,462,462,21,5,16,3,2
3,471,471,7,4,3,2,1
14,474,474,34,3,31,2,1
19,478,478,79,53,26,3,2
31,482,482,53,53,0,1,0
21,493,493,3,3,0,1,0

6,103,103,1,1,0,1,0
19,109,109,14,14,0,1,0
18,123,123,2,2,0,1,0
8,134,134,12,12,0,1,0
5,142,142,12,12,0,1,0
36,143,143,10,10,0,1,0
0,144,144,13,13,0,1,0
2,191,191,6,6,0,1,0
28,191,191,34,34,0,1,0
44,196,196,3,3,0,1,0
33,203,203,25,7,18,3,2
37,203,203,27,27,0,1,0
43,203,203,30,8,22,3,2
35,207,207,1,1,0,1,0
25,216,216,5,5,0,1,0
24,218,218,5,5,0,1,0
41,232,232,14,14,0,1,0
1,237,237,9,9,0,1,0
9,241,241,39,21,18,4,3
16,249,249,2,2,0,1,0
21,249,249,1,1,0,1,0
31,253,253,42,8,34,3,2
39,261,261,5,5,0,1,0
23,270,270,23,23,0,1,0
30,289,289,15,4,11,2,1
32,297,297,33,33,0,1,0
26,300,300,7,7,0,1,0
11,300,300,82,66,16,3,2
22,301,301,8,8,0,1,0
14,302,302,56,56,0,1,0
34,322,322,10,6,4,2,1
10,323,323,1,1,0,1,0
29,328,328,1,1,0,1,0
42,335,335,105,27,78,3,2
40,348,348,60,24,36,4,3
47,351,351,23,9,14,3,2
13,368,368,32,19,13,2,1
7,376,376,21,1,20,3,2
38,400,400,70,33,37,4,3
4,435,435,20,5,15,4,3
17,442,442,38,10,28,3,2
27,443,443,44,17,27,4,3
45,447,447,24,5,19,2,1
46,452,452,63,25,38,3,2
15,453,453,40,27,13,2,1
3,464,464,86,86,0,1,0
20,477,477,10,2,8,3,2
12,494,494,13,1,12,3,2

12,103,103,10,10,0,1,0
25,111,111,14,2,12,2,1
29,116,116,33,2,31,4,3
2,119,119,10,10,0,1,0
28,127,127,2,2,0,1,0
31,176,176,17,17,0,1,0
40,188,188,31,31,0,1,0
17,205,205,22,22,0,1,0
20,227,227,1,1,0,1,0
15,247,247,16,16,0,1,0
6,259,259,29,29,0,1,0
34,259,259,16,7,9,2,1
41,268,268,1,1,0,1,0
5,287,287,77,77,0,1,0
26,307,307,27,27,0,1,0
19,308,308,31,13,18,4,3
35,314,314,26,2,24,4,3
9,327,327,42,42,0,1,0
37,328,328,27,21,6,3,2
27,330,330,8,8,0,1,0
18,334,334,42,24,18,3,2
38,348,348,8,8,0,1,0
33,354,354,146,76,70,3,2
3,356,356,15,15,0,1,0
13,365,365,115,115,0,1,0
32,372,372,8,8,0,1,0
30,375,375,1,1,0,1,0
4,384,384,14,14,0,1,0
8,405,405,14,14,0,1,0
10,407,407,41,27,14,3,2
39,420,420,110,110,0,1,0
16,425,425,48,48,0,1,0
7,426,426,5,5,0,1,0
14,432,432,1,1,0,1,0
1,438,438,39,39,0,1,0
24,447,447,4,4,0,1,0
21,455,455,64,64,0,1,0
0,460,460,8,8,0,1,0
36,473,473,32,2,30,2,1
11,473,473,3,3,0,1,0
23,487,487,54,54,0,1,0
22,488,488,48,48,0,1,0

36,106,106,8,8,0,1,0
29,128,128,5,5,0,1,0
35,138,138,5,5,0,1,0
37,140,140,13,13,0,1,0
26,171,171,23,23,0,1,0
23,172,172,15,15,0,1,0
1,174,174,10,10,0,1,0
40,177,177,27,8,19,2,1
13,185,185,9,9,0,1,0
19,191,191,11,1,10,3,2
16,193,193,39,19,20,3,2
6,194,194,23,23,0,1,0
33,194,194,11,1,10,2,1
0,225,225,24,24,0,1,0
21,276,276,15,15,0,1,0
10,276,276,22,8,14,2,1
2,287,287,11,11,0,1,0
11,290,290,25,25,0,1,0
28,290,290,24,15,9,4,3
8,310,310,12,12,0,1,0
32,323,323,33,33,0,1,0
38,324,324,183,183,0,1,0
20,328,328,71,71,0,1,0
18,352,352,20,5,15,2,1
25,355,355,23,2,21,4,3
3,374,374,11,3,8,2,1
15,397,397,11,1,10,3,2
17,405,405,48,48,0,1,0
24,411,411,3,3,0,1,0
9,424,424,40,40,0,1,0
27,434,434,24,12,12,4,3
4,436,436,17,14,3,2,1
39,437,437,28,8,20,3,2
30,442,442,82,39,43,2,1
7,448,448,142,121,21,2,1
5,452,452,40,31,9,4,3
34,454,454,29,29,0,1,0
42,457,457,8,8,0,1,0
14,457,457,29,25,4,2,1
12,461,461,13,1,12,3,2
22,472,472,16,10,6,3,2
41,474,474,50,50,0,1,0
31,492,492,24,24,0,1,0

6,107,107,2,2,0,1,0
21,112,112,15,3,12,3,2
18,122,122,31,31,0,1,0
31,131,131,6,6,0,1,0
29,173,173,22,10,12,4,3
23,173,173,1,1,0,1,0
4,176,176,42,42,0,1,0
5,180,180,1,1,0,1,0
36,183,183,18,12,6,3,2
7,196,196,2,2,0,1,0
34,197,197,11,2,9,2,1
39,202,202,12,12,0,1,0
22,235,235,12,12,0,1,0
20,239,239,1,1,0,1,0
28,249,249,19,11,8,3,2
9,264,264,56,8,48,2,1
8,267,267,17,3,14,2,1
24,273,273,95,56,39,4,3
0,282,282,31,31,0,1,0
38,324,324,39,39,0,1,0
32,346,346,41,41,0,1,0
35,365,365,27,3,24,2,1
2,370,370,2,2,0,1,0
11,372,372,82,82,0,1,0
12,378,378,50,11,39,2,1
25,384,384,7,2,5,2,1
13,391,391,26,26,0,1,0
30,392,392,21,3,18,3,2
3,398,398,100,100,0,1,0
10,401,401,11,11,0,1,0
17,407,407,36,36,0,1,0
16,411,411,21,18,3,2,1
33,414,414,73,49,24,2,1
37,435,435,126,68,58,4,3
1,448,448,3,3,0,1,0
27,460,460,10,10,0,1,0
15,463,463,33,21,12,4,3
14,475,475,42,42,0,1,0
19,476,476,38,38,0,1,0
26,489,489,83,21,62,3,2

16,101,101,3,3,0,1,0
21,106,106,5,5,0,1,0
33,120,120,30,13,17,2,1
7,121,121,11,11,0,1,0
12,144,144,5,5,0,1,0
45,144,144,33,33,0,1,0
17,169,169,10,10,0,1,0
14,192,192,21,21,0,1,0
20,200,200,8,2,6,3,2
23,201,201,1,1,0,1,0
26,209,209,6,3,3,2,1
42,218,218,9,6,3,2,1
6,224,224,22,22,0,1,0
22,234,234,1,1,0,1,0
13,238,238,14,14,0,1,0
34,243,243,15,15,0,1,0
15,253,253,87,39,48,2,1
28,255,255,11,7,4,2,1
38,262,262,48,41,7,2,1
41,267,267,42,6,36,4,3
29,280,280,26,1,25,2,1
5,286,286,1,1,0,1,0
31,291,291,26,26,0,1,0
3,291,291,1,1,0,1,0
43,295,295,15,15,0,1,0
8,309,309,16,16,0,1,0
36,340,340,26,26,0,1,0
44,343,343,8,8,0,1,0
35,344,344,18,5,13,2,1
4,348,348,65,59,6,3,2
19,357,357,3,3,0,1,0
30,388,388,41,41,0,1,0
32,391,391,11,3,8,3,2
10,401,401,15,7,8,2,1
46,405,405,69,69,0,1,0
11,407,407,60,60,0,1,0
39,408,408,5,2,3,2,1
25,410,410,68,68,0,1,0
1,415,415,1,1,0,1,0
27,426,426,31,31,0,1,0
18,439,439,33,13,20,4,3
40,440,440,126,126,0,1,0
24,455,455,21,21,0,1,0
9,470,470,37,13,24,3,2
37,475,475,6,3,3,2,1
2,487,487,15,3,12,4,3
0,492,492,106,10,96,3,2

17,105,105,8,2,6,2,1
14,106,106,4,4,0,1,0
10,129,129,3,3,0,1,0
32,184,184,11,11,0,1,0
26,185,185,21,21,0,1,0
5,186,186,8,8,0,1,0
29,204,204,39,39,0,1,0
20,207,207,31,5,26,2,1
35,221,221,3,3,0,1,0
36,226,226,21,5,16,2,1
13,240,240,6,6,0,1,0
16,258,258,7,7,0,1,0
30,262,262,1,1,0,1,0
19,293,293,40,40,0,1,0
31,295,295,5,2,3,2,1
4,304,304,1,1,0,1,0
6,306,306,55,15,40,3,2
21,314,314,2,2,0,1,0
24,315,315,27,2,25,3,2
22,319,319,25,25,0,1,0
0,337,337,33,21,12,4,3
9,341,341,38,38,0,1,0
7,362,362,163,124,39,4,3
11,365,365,23,23,0,1,0
25,367,367,37,13,24,3,2
2,370,370,13,4,9,4,3
15,372,372,77,77,0,1,0
28,383,383,74,43,31,2,1
34,396,396,70,30,40,2,1
12,408,408,46,4,42,4,3
1,432,432,50,50,0,1,0
23,440,440,34,7,27,4,3
8,445,445,197,182,15,2,1
33,453,453,36,24,12,4,3
27,455,455,128,50,78,3,2
3,465,465,12,12,0,1,0
18,471,471,52,8,44,2,1

4,100,100,23,23,0,1,0
13,109,109,9,9,0,1,0
21,117,117,3,3,0,1,0
27,123,123,7,2,5,2,1
19,127,127,8,8,0,1,0
36,137,137,4,4,0,1,0
12,145,145,9,4,5,2,1
22,147,147,24,15,9,4,3
14,150,150,39,21,18,3,2
26,173,173,6,6,0,1,0
35,181,181,38,38,0,1,0
39,225,225,4,4,0,1,0
31,231,231,11,4,7,2,1
37,238,238,7,4,3,2,1
41,260,260,3,3,0,1,0
29,260,260,27,21,6,3,2
16,261,261,10,10,0,1,0
11,272,272,32,22,10,2,1
30,285,285,48,36,12,4,3
32,286,286,40,17,23,2,1
3,292,292,22,22,0,1,0
1,303,303,4,4,0,1,0
40,306,306,24,6,18,3,2
33,322,322,125,116,9,4,3
38,326,326,20,12,8,2,1
23,328,328,14,14,0,1,0
6,335,335,18,4,14,2,1
10,354,354,2,2,0,1,0
34,365,365,38,38,0,1,0
15,366,366,2,2,0,1,0
8,372,372,186,174,12,3,2
7,383,383,2,2,0,1,0
24,392,392,63,55,8,2,1
20,412,412,20,20,0,1,0
0,418,418,23,23,0,1,0
2,423,423,44,2,42,3,2
25,435,435,80,80,0,1,0
5,463,463,4,4,0,1,0
17,469,469,54,20,34,3,2
18,483,483,9,9,0,1,0
9,488,488,57,32,25,2,1
28,494,494,4,4,0,1,0

24,100,100,3,3,0,1,0
35,105,105,3,3,0,1,0
0,120,120,2,2,0,1,0
8,122,122,8,8,0,1,0
28,156,156,26,18,8,3,2
32,170,170,11,3,8,2,1
3,173,173,21,21,0,1,0
36,177,177,4,4,0,1,0
25,181,181,13,13,0,1,0
17,187,187,5,5,0,1,0
40,203,203,20,15,5,2,1
27,203,203,55,55,0,1,0
41,213,213,35,35,0,1,0
11,218,218,13,6,7,2,1
2,227,227,39,27,12,4,3
20,231,231,15,3,12,4,3
22,239,239,1,1,0,1,0
31,244,244,40,24,16,2,1
33,246,246,15,3,12,2,1
7,292,292,27,12,15,4,3
13,294,294,16,16,0,1,0
37,302,302,26,26,0,1,0
21,317,317,4,4,0,1,0
4,321,321,11,11,0,1,0
16,336,336,103,103,0,1,0
15,343,343,28,7,21,2,1
39,344,344,12,12,0,1,0
10,345,345,2,2,0,1,0
18,360,360,32,29,3,2,1
6,369,369,1,1,0,1,0
5,386,386,118,13,105,4,3
26,389,389,5,5,0,1,0
34,392,392,10,10,0,1,0
12,394,394,55,28,27,2,1
19,403,403,3,3,0,1,0
29,407,407,12,8,4,2,1
42,410,410,28,14,14,2,1
38,418,418,4,4,0,1,0
23,428,428,48,34,14,2,1
30,441,441,180,180,0,1,0
44,449,449,97,28,69,4,3
1,454,454,9,6,3,2,1
9,473,473,22,22,0,1,0
14,482,482,64,25,39,4,3
43,498,498,20,9,11,2,1

44,101,101,1,1,0,1,0
38,103,103,7,2,5,2,1
1,121,121,17,3,14,2,1
25,133,133,13,5,8,3,2
8,141,141,6,1,5,2,1
41,144,144,36,8,28,3,2
47,157,157,31,9,22,3,2
23,170,170,1,1,0,1,0
29,175,175,28,28,0,1,0
18,192,192,36,36,0,1,0
2,215,215,1,1,0,1,0
3,216,216,47,47,0,1,0
22,226,226,1,1,0,1,0
5,230,230,1,1,0,1,0
39,233,233,11,11,0,1,0
43,237,237,7,7,0,1,0
10,253,253,6,3,3,2,1
27,260,260,3,3,0,1,0
6,262,262,17,6,11,2,1
21,268,268,25,25,0,1,0
45,269,269,27,27,0,1,0
40,288,288,13,7,6,2,1
24,290,290,1,1,0,1,0
37,291,291,35,27,8,3,2
26,301,301,36,36,0,1,0
34,302,302,14,14,0,1,0
31,309,309,27,27,0,1,0
36,325,325,24,6,18,3,2
32,330,330,47,47,0,1,0
30,331,331,44,44,0,1,0
13,335,335,38,12,26,3,2
17,336,336,7,7,0,1,0
16,361,361,10,10,0,1,0
48,362,362,102,3,99,4,3
14,366,366,28,20,8,2,1
42,385,385,5,1,4,2,1
0,389,389,20,20,0,1,0
9,407,407,61,61,0,1,0
19,423,423,25,25,0,1,0
33,430,430,37,19,18,3,2
28,434,434,105,105,0,1,0
46,435,435,48,48,0,1,0
12,453,453,21,21,0,1,0
35,454,454,20,14,6,3,2
11,459,459,4,4,0,1,0
15,467,467,24,6,18,2,1
7,485,485,14,14,0,1,0
20,491,491,28,28,0,1,0
4,496,496,23,23,0,1,0

6,101,101,16,16,0,1,0
0,114,114,1,1,0,1,0
28,125,125,1,1,0,1,0
21,136,136,5,5,0,1,0
14,197,197,19,14,5,2,1
15,224,224,14,8,6,2,1
4,236,236,4,4,0,1,0
27,247,247,25,3,22,2,1
11,248,248,29,13,16,2,1
23,249,249,12,12,0,1,0
18,254,254,22,4,18,3,2
30,262,262,53,53,0,1,0
7,265,265,38,15,23,3,2
20,282,282,4,4,0,1,0
12,297,297,41,14,27,2,1
31,298,298,14,5,9,2,1
29,304,304,13,13,0,1,0
3,304,304,21,5,16,2,1
34,312,312,17,17,0,1,0
33,338,338,1,1,0,1,0
32,340,340,8,8,0,1,0
10,400,400,46,46,0,1,0
19,406,406,167,88,79,4,3
22,406,406,123,43,80,3,2
9,432,432,21,21,0,1,0
8,433,433,205,148,57,4,3
16,434,434,5,5,0,1,0
17,444,444,109,58,51,4,3
25,450,450,20,20,0,1,0
1,455,455,2,2,0,1,0
24,455,455,16,6,10,2,1
35,458,458,63,21,42,4,3
26,459,459,84,70,14,3,2
5,471,471,134,68,66,3,2
13,476,476,118,118,0,1,0
2,489,489,9,5,4,2,1

23,100,100,9,9,0,1,0
14,101,101,5,5,0,1,0
27,115,115,4,4,0,1,0
36,143,143,26,26,0,1,0
10,146,146,5,5,0,1,0
12,164,164,5,2,3,2,1
5,166,166,2,2,0,1,0
29,194,194,1,1,0,1,0
4,203,203,2,2,0,1,0
19,205,205,27,10,17,2,1
3,219,219,2,2,0,1,0
22,240,240,15,10,5,2,1
35,247,247,18,18,0,1,0
18,251,251,22,4,18,2,1
0,267,267,33,5,28,3,2
33,271,271,26,26,0,1,0
21,284,284,15,15,0,1,0
17,288,288,25,25,0,1,0
25,303,303,12,4,8,2,1
30,316,316,18,18,0,1,0
2,354,354,9,9,0,1,0
32,366,366,68,68,0,1,0
11,367,367,55,55,0,1,0
16,368,368,82,49,33,4,3
1,372,372,63,39,24,2,1
24,376,376,159,107,52,4,3
15,377,377,43,1,42,2,1
6,381,381,109,28,81,4,3
26,385,385,14,14,0,1,0
13,387,387,77,68,9,2,1
28,392,392,63,5,58,3,2
20,404,404,31,14,17,3,2
8,407,407,9,9,0,1,0
31,429,429,43,19,24,4,3
7,465,465,122,74,48,2,1
9,474,474,133,123,10,3,2
34,480,480,29,17,12,4,3

13,118,118,2,2,0,1,0
27,120,120,16,13,3,2,1
30,128,128,2,2,0,1,0
10,148,148,3,3,0,1,0
24,166,166,11,11,0,1,0
7,186,186,43,28,15,2,1
32,200,200,8,8,0,1,0
22,210,210,20,11,9,2,1
3,223,223,44,13,31,4,3
18,227,227,37,19,18,3,2
37,241,241,40,8,32,3,2
14,242,242,10,3,7,2,1
9,250,250,6,6,0,1,0
29,253,253,43,18,25,2,1
21,261,261,18,6,12,4,3
17,265,265,26,18,8,2,1
19,275,275,5,2,3,2,1
23,305,305,5,5,0,1,0
25,317,317,32,32,0,1,0
6,320,320,16,16,0,1,0
16,324,324,1,1,0,1,0
28,329,329,45,45,0,1,0
0,339,339,68,68,0,1,0
33,376,376,1,1,0,1,0
4,379,379,9,6,3,2,1
5,380,380,20,20,0,1,0
15,381,381,85,85,0,1,0
1,408,408,109,2,107,4,3
20,409,409,61,5,56,4,3
12,414,414,21,21,0,1,0
31,416,416,142,107,35,2,1
8,435,435,41,23,18,4,3
36,448,448,60,60,0,1,0
2,456,456,108,69,39,4,3
26,469,469,37,21,16,2,1
35,475,475,22,15,7,2,1
11,488,488,83,83,0,1,0
34,491,491,52,52,0,1,0

13,105,105,5,1,4,2,1
6,112,112,1,1,0,1,0
17,127,127,11,5,6,3,2
25,129,129,34,14,20,4,3
34,132,132,5,1,4,2,1
8,133,133,1,1,0,1,0
3,144,144,17,17,0,1,0
7,151,151,2,2,0,1,0
24,154,154,30,10,20,2,1
46,157,157,39,11,28,4,3
27,158,158,10,4,6,3,2
11,165,165,23,1,22,3,2
31,172,172,10,6,4,2,1
26,185,185,18,15,3,2,1
10,200,200,13,13,0,1,0
41,207,207,17,12,5,2,1
29,207,207,7,4,3,2,1
43,213,213,10,10,0,1,0
38,215,215,26,26,0,1,0
33,223,223,10,10,0,1,0
39,231,231,53,25,28,3,2
5,245,245,11,11,0,1,0
44,248,248,12,12,0,1,0
42,283,283,38,22,16,3,2
14,284,284,5,2,3,2,1
45,294,294,7,7,0,1,0
23,295,295,51,51,0,1,0
4,305,305,28,28,0,1,0
0,318,318,3,3,0,1,0
20,323,323,7,7,0,1,0
36,324,324,77,77,0,1,0
15,333,333,25,12,13,2,1
32,339,339,1,1,0,1,0
28,345,345,37,23,14,2,1
16,348,348,34,16,18,3,2
18,365,365,45,13,32,2,1
19,386,386,9,9,0,1,0
1,410,410,55,55,0,1,0
2,426,426,19,19,0,1,0
35,426,426,64,42,22,3,2
9,440,440,1,1,0,1,0
37,452,452,26,9,17,2,1
22,473,473,32,14,18,4,3
30,486,486,128,128,0,1,0
21,488,488,14,2,12,4,3
40,489,489,25,3,22,2,1
12,495,495,2,2,0,1,0

29,104,104,3,3,0,1,0
33,108,108,13,8,5,2,1
31,113,113,3,3,0,1,0
2,130,130,1,1,0,1,0
32,132,132,16,16,0,1,0
12,148,148,22,2,20,2,1
1,159,159,1,1,0,1,0
34,162,162,19,3,16,3,2
3,178,178,38,26,12,2,1
4,191,191,8,8,0,1,0
7,205,205,1,1,0,1,0
6,207,207,11,2,9,3,2
23,210,210,1,1,0,1,0
0,226,226,23,23,0,1,0
36,245,245,35,35,0,1,0
22,248,248,9,9,0,1,0
25,284,284,9,9,0,1,0
28,300,300,51,3,48,2,1
14,311,311,4,4,0,1,0
30,312,312,69,3,66,4,3
26,327,327,14,9,5,2,1
19,340,340,58,58,0,1,0
10,355,355,79,33,46,3,2
9,357,357,48,48,0,1,0
8,358,358,120,46,74,4,3
17,360,360,38,38,0,1,0
27,375,375,37,8,29,2,1
13,381,381,53,12,41,2,1
18,384,384,81,73,8,3,2
21,394,394,31,25,6,3,2
37,396,396,33,33,0,1,0
38,409,409,11,11,0,1,0
5,412,412,8,8,0,1,0
11,423,423,101,83,18,2,1
15,428,428,1,1,0,1,0
16,435,435,1,1,0,1,0
24,449,449,104,20,84,4,3
20,487,487,134,87,47,3,2
35,490,490,10,1,9,2,1

27,115,115,2,2,0,1,0
3,115,115,1,1,0,1,0
14,124,124,12,12,0,1,0
24,152,152,6,2,4,2,1
10,161,161,27,27,0,1,0
13,175,175,143,111,32,3,2
34,185,185,8,8,0,1,0
32,196,196,17,5,12,4,3
35,219,219,5,5,0,1,0
2,219,219,9,9,0,1,0
18,245,245,12,1,11,2,1
33,250,250,9,9,0,1,0
8,269,269,19,19,0,1,0
7,274,274,6,6,0,1,0
0,284,284,52,28,24,3,2
6,296,296,21,21,0,1,0
16,313,313,3,3,0,1,0
4,324,324,16,16,0,1,0
26,333,333,9,3,6,3,2
1,334,334,41,41,0,1,0
30,345,345,25,25,0,1,0
5,345,345,18,6,12,3,2
9,352,352,11,11,0,1,0
29,367,367,20,6,14,3,2
21,386,386,16,4,12,2,1
23,402,402,320,320,0,1,0
11,405,405,36,24,12,4,3
19,432,432,79,4,75,4,3
20,441,441,25,9,16,3,2
17,443,443,15,3,12,3,2
28,448,448,13,13,0,1,0
22,453,453,9,6,3,2,1
31,455,455,164,164,0,1,0
15,459,459,8,8,0,1,0
12,472,472,76,16,60,4,3
25,491,491,29,2,27,2,1

18,106,106,4,4,0,1,0
7,108,108,1,1,0,1,0
27,111,111,8,8,0,1,0
2,117,117,21,21,0,1,0
34,124,124,2,2,0,1,0
8,145,145,4,1,3,2,1
5,147,147,112,112,0,1,0
32,154,154,11,11,0,1,0
36,158,158,8,2,6,3,2
39,164,164,1,1,0,1,0
4,198,198,6,6,0,1,0
23,209,209,53,53,0,1,0
0,214,214,15,1,14,2,1
21,223,223,46,17,29,4,3
9,228,228,9,9,0,1,0
10,242,242,2,2,0,1,0
16,245,245,22,11,11,4,3
15,245,245,20,20,0,1,0
13,253,253,24,6,18,4,3
30,258,258,63,63,0,1,0
17,266,266,10,5,5,2,1
20,269,269,4,4,0,1,0
28,276,276,2,2,0,1,0
11,277,277,21,21,0,1,0
25,289,289,31,31,0,1,0
35,292,292,35,19,16,2,1
29,298,298,43,31,12,2,1
37,308,308,35,11,24,4,3
33,327,327,59,22,37,2,1
3,346,346,56,20,36,4,3
14,356,356,4,4,0,1,0
1,390,390,84,84,0,1,0
6,415,415,10,10,0,1,0
26,420,420,55,44,11,2,1
31,424,424,8,4,4,2,1
38,452,452,87,13,74,3,2
22,464,464,34,23,11,2,1
24,476,476,9,9,0,1,0
19,478,478,16,4,12,4,3
12,490,490,5,1,4,2,1

39,114,114,14,14,0,1,0
35,118,118,25,21,4,2,1
6,120,120,1,1,0,1,0
23,129,129,1,1,0,1,0
20,147,147,20,20,0,1,0
32,151,151,2,2,0,1,0
26,164,164,35,8,27,2,1
8,167,167,38,38,0,1,0
21,177,177,15,15,0,1,0
15,180,180,23,23,0,1,0
16,184,184,23,2,21,2,1
40,199,199,12,8,4,2,1
12,208,208,5,1,4,2,1
37,225,225,46,11,35,4,3
13,234,234,1,1,0,1,0
24,237,237,15,3,12,3,2
2,239,239,25,25,0,1,0
0,254,254,19,19,0,1,0
22,256,256,48,15,33,4,3
33,258,258,7,7,0,1,0
27,267,267,20,17,3,2,1
25,277,277,64,38,26,3,2
28,281,281,40,40,0,1,0
18,323,323,3,3,0,1,0
19,347,347,40,40,0,1,0
5,352,352,51,12,39,2,1
41,371,371,20,20,0,1,0
34,377,377,40,33,7,2,1
30,380,380,31,31,0,1,0
29,393,393,17,17,0,1,0
10,404,404,63,57,6,2,1
7,405,405,22,1,21,4,3
38,432,432,20,2,18,2,1
3,434,434,9,9,0,1,0
14,438,438,67,7,60,3,2
31,441,441,27,27,0,1,0
9,442,442,88,78,10,3,2
11,445,445,5,5,0,1,0
17,446,446,2,2,0,1,0
4,473,473,49,19,30,3,2
1,495,495,56,33,23,2,1
36,498,498,42,42,0,1,0

4,103,103,35,27,8,3,2
9,106,106,2,2,0,1,0
42,115,115,2,2,0,1,0
29,116,116,4,4,0,1,0
23,124,124,15,3,12,3,2
0,124,124,9,6,3,2,1
13,128,128,20,20,0,1,0
19,129,129,28,28,0,1,0
32,134,134,16,16,0,1,0
3,143,143,1,1,0,1,0
41,146,146,2,2,0,1,0
40,146,146,17,1,16,2,1
36,152,152,3,3,0,1,0
10,157,157,11,11,0,1,0
35,167,167,2,2,0,1,0
14,186,186,7,7,0,1,0
1,194,194,3,3,0,1,0
11,198,198,8,8,0,1,0
17,199,199,2,2,0,1,0
5,203,203,2,2,0,1,0
22,207,207,67,67,0,1,0
16,215,215,1,1,0,1,0
37,219,219,53,53,0,1,0
20,222,222,14,14,0,1,0
34,229,229,8,1,7,2,1
18,317,317,17,13,4,2,1
30,319,319,9,9,0,1,0
28,343,343,137,80,57,4,3
39,355,355,46,7,39,4,3
2,361,361,8,8,0,1,0
6,362,362,29,11,18,4,3
33,364,364,10,2,8,2,1
25,378,378,3,3,0,1,0
8,388,388,40,32,8,3,2
31,419,419,51,24,27,2,1
38,429,429,34,18,16,2,1
7,433,433,20,20,0,1,0
24,440,440,121,108,13,2,1
21,443,443,33,21,12,2,1
26,443,443,1,1,0,1,0
15,450,450,5,5,0,1,0
12,469,469,106,55,51,4,3
27,476,476,119,84,35,2,1

5,106,106,15,3,12,3,2
38,122,122,30,30,0,1,0
30,125,125,3,3,0,1,0
35,141,141,24,24,0,1,0
36,166,166,24,24,0,1,0
4,173,173,42,42,0,1,0
20,190,190,10,10,0,1,0
0,191,191,7,7,0,1,0
17,197,197,18,18,0,1,0
14,200,200,1,1,0,1,0
25,212,212,30,30,0,1,0
37,212,212,23,1,22,2,1
24,223,223,5,2,3,2,1
31,228,228,9,9,0,1,0
39,257,257,26,26,0,1,0
11,269,269,24,24,0,1,0
23,277,277,42,9,33,4,3
18,285,285,22,11,11,2,1
15,296,296,88,88,0,1,0
26,300,300,8,4,4,2,1
16,318,318,22,7,15,2,1
1,331,331,2,2,0,1,0
27,333,333,96,90,6,2,1
7,348,348,38,21,17,2,1
33,350,350,37,19,18,2,1
9,353,353,42,42,0,1,0
2,358,358,3,3,0,1,0
10,361,361,4,4,0,1,0
3,366,366,27,27,0,1,0
19,395,395,14,14,0,1,0
21,396,396,22,22,0,1,0
13,397,397,14,2,12,3,2
29,407,407,32,15,17,2,1
40,409,409,69,28,41,3,2
32,409,409,48,48,0,1,0
6,422,422,125,117,8,3,2
34,426,426,2,2,0,1,0
8,427,427,77,55,22,2,1
12,455,455,11,11,0,1,0
22,463,463,9,9,0,1,0
28,464,464,14,1,13,3,2

17,101,101,11,11,0,1,0
10,111,111,10,10,0,1,0
34,115,115,8,5,3,2,1
25,125,125,6,6,0,1,0
27,128,128,7,7,0,1,0
19,141,141,13,9,4,2,1
41,145,145,73,73,0,1,0
8,150,150,18,8,10,3,2
39,151,151,6,6,0,1,0
32,154,154,5,5,0,1,0
0,164,164,7,7,0,1,0
31,173,173,2,2,0,1,0
42,177,177,29,19,10,3,2
9,187,187,21,15,6,2,1
28,199,199,9,1,8,3,2
5,200,200,8,5,3,2,1
4,218,218,26,26,0,1,0
2,225,225,1,1,0,1,0
26,242,242,43,3,40,3,2
13,243,243,6,6,0,1,0
3,255,255,1,1,0,1,0
20,264,264,9,9,0,1,0
43,280,280,85,7,78,3,2
14,289,289,3,3,0,1,0
11,294,294,14,10,4,2,1
7,311,311,34,34,0,1,0
16,313,313,17,17,0,1,0
18,320,320,32,32,0,1,0
15,323,323,29,12,17,2,1
23,337,337,43,43,0,1,0
21,337,337,18,12,6,3,2
29,338,338,18,18,0,1,0
33,351,351,18,18,0,1,0
24,352,352,48,36,12,4,3
40,374,374,10,10,0,1,0
12,384,384,39,24,15,4,3
35,417,417,22,22,0,1,0
6,431,431,57,57,0,1,0
36,432,432,24,24,0,1,0
30,434,434,4,4,0,1,0
37,438,438,10,10,0,1,0
38,451,451,83,50,33,4,3
1,457,457,147,65,82,3,2
22,466,466,28,28,0,1,0

1,131,131,5,5,0,1,0
12,133,133,4,4,0,1,0
48,133,133,7,7,0,1,0
3,142,142,2,2,0,1,0
44,146,146,4,4,0,1,0
4,153,153,1,1,0,1,0
8,154,154,8,8,0,1,0
22,189,189,2,2,0,1,0
33,189,189,7,3,4,2,1
9,191,191,1,1,0,1,0
7,199,199,18,2,16,2,1
47,201,201,1,1,0,1,0
28,208,208,23,23,0,1,0
50,219,219,7,3,4,2,1
39,227,227,8,8,0,1,0
11,237,237,75,11,64,3,2
45,239,239,21,5,16,3,2
31,250,250,71,23,48,2,1
25,255,255,5,5,0,1,0
17,265,265,2,2,0,1,0
10,270,270,24,24,0,1,0
24,280,280,14,14,0,1,0
41,281,281,40,19,21,4,3
0,286,286,17,17,0,1,0
35,287,287,102,102,0,1,0
2,290,290,19,9,10,2,1
23,295,295,27,12,15,2,1
20,306,306,10,2,8,2,1
16,307,307,35,12,23,2,1
37,310,310,9,9,0,1,0
14,311,311,12,5,7,2,1
32,312,312,13,3,10,3,2
27,316,316,19,19,0,1,0
30,325,325,25,3,22,3,2
18,329,329,28,28,0,1,0
6,349,349,30,20,10,2,1
26,349,349,7,7,0,1,0
29,350,350,47,47,0,1,0
5,357,357,22,22,0,1,0
13,357,357,3,3,0,1,0
46,371,371,37,37,0,1,0
40,372,372,141,141,0,1,0
15,376,376,70,70,0,1,0
49,399,399,22,22,0,1,0
36,400,400,37,27,10,2,1
21,402,402,3,3,0,1,0
43,409,409,10,10,0,1,0
34,411,411,18,6,12,4,3
42,417,417,5,5,0,1,0
19,422,422,14,14,0,1,0
38,443,443,90,90,0,1,0

25,102,102,10,3,7,3,2
36,103,103,1,1,0,1,0
7,106,106,22,22,0,1,0
23,106,106,7,7,0,1,0
17,123,123,32,11,21,2,1
28,136,136,17,17,0,1,0
2,138,138,43,22,21,4,3
33,145,145,44,13,31,3,2
4,158,158,15,15,0,1,0
32,162,162,43,22,21,2,1
18,171,171,19,13,6,2,1
31,199,199,41,41,0,1,0
11,211,211,13,7,6,2,1
14,216,216,1,1,0,1,0
34,216,216,20,2,18,2,1
38,241,241,33,33,0,1,0
20,249,249,3,3,0,1,0
3,263,263,5,5,0,1,0
5,274,274,3,3,0,1,0
12,309,309,6,1,5,2,1
40,319,319,32,16,16,3,2
1,325,325,17,12,5,2,1
16,338,338,7,1,6,2,1
6,378,378,30,30,0,1,0
24,378,378,45,45,0,1,0
30,393,393,11,2,9,2,1
41,402,402,25,25,0,1,0
8,409,409,66,66,0,1,0
29,414,414,34,22,12,2,1
9,416,416,40,3,37,3,2
15,425,425,24,24,0,1,0
13,432,432,79,79,0,1,0
22,433,433,18,18,0,1,0
19,444,444,55,22,33,4,3
37,450,450,21,7,14,3,2
39,465,465,7,7,0,1,0
27,472,472,49,49,0,1,0
26,474,474,23,23,0,1,0
21,479,479,30,30,0,1,0
10,482,482,3,3,0,1,0
35,484,484,42,26,16,3,2
0,489,489,23,14,9,2,1

5,111,111,1,1,0,1,0
34,115,115,1,1,0,1,0
11,128,128,5,5,0,1,0
31,131,131,1,1,0,1,0
10,140,140,11,2,9,2,1
42,167,167,40,18,22,3,2
30,178,178,21,7,14,2,1
39,182,182,6,1,5,2,1
15,184,184,11,11,0,1,0
28,197,197,62,62,0,1,0
38,224,224,9,9,0,1,0
17,237,237,51,16,35,3,2
16,249,249,4,4,0,1,0
3,249,249,1,1,0,1,0
37,259,259,19,5,14,2,1
19,275,275,32,32,0,1,0
8,282,282,78,58,20,3,2
40,307,307,40,5,35,2,1
29,313,313,16,1,15,2,1
35,314,314,5,2,3,2,1
2,315,315,5,5,0,1,0
18,316,316,1,1,0,1,0
36,325,325,56,17,39,4,3
21,327,327,22,16,6,2,1
25,348,348,74,56,18,3,2
6,351,351,37,10,27,4,3
12,353,353,106,64,42,2,1
23,393,393,33,33,0,1,0
33,398,398,69,69,0,1,0
41,400,400,47,47,0,1,0
22,404,404,16,4,12,4,3
14,409,409,21,21,0,1,0
1,412,412,172,172,0,1,0
0,427,427,7,7,0,1,0
9,433,433,18,3,15,4,3
20,437,437,43,13,30,3,2
32,445,445,29,5,24,4,3
4,445,445,1,1,0,1,0
13,448,448,8,2,6,2,1
7,453,453,4,4,0,1,0
26,460,460,17,9,8,3,2
24,485,485,67,40,27,2,1
27,488,488,4,4,0,1,0

20,107,107,15,9,6,3,2
13,136,136,17,5,12,2,1
8,160,160,55,26,29,2,1
2,174,174,12,2,10,2,1
3,176,176,66,66,0,1,0
35,177,177,18,1,17,4,3
24,180,180,10,10,0,1,0
16,186,186,19,19,0,1,0
34,191,191,36,12,24,4,3
14,193,193,15,3,12,2,1
1,197,197,9,9,0,1,0
5,201,201,29,2,27,4,3
17,215,215,2,2,0,1,0
9,239,239,1,1,0,1,0
22,249,249,4,4,0,1,0
15,277,277,21,8,13,2,1
12,278,278,49,44,5,2,1
11,279,279,32,5,27,4,3
4,323,323,54,54,0,1,0
18,329,329,104,81,23,2,1
10,331,331,20,11,9,4,3
27,339,339,48,9,39,4,3
21,348,348,9,9,0,1,0
31,353,353,25,7,18,4,3
0,357,357,47,27,20,2,1
33,369,369,51,51,0,1,0
6,375,375,29,29,0,1,0
30,379,379,21,8,13,2,1
25,389,389,61,61,0,1,0
26,420,420,11,1,10,2,1
32,426,426,11,3,8,3,2
23,435,435,22,7,15,2,1
29,443,443,110,110,0,1,0
19,445,445,40,24,16,2,1
7,458,458,6,2,4,2,1
28,480,480,36,20,16,3,2

12,119,119,18,18,0,1,0
28,124,124,20,20,0,1,0
2,132,132,2,2,0,1,0
0,154,154,8,8,0,1,0
9,178,178,20,1,19,4,3
13,182,182,1,1,0,1,0
3,185,185,10,10,0,1,0
20,203,203,26,26,0,1,0
15,207,207,8,4,4,2,1
16,228,228,5,1,4,2,1
31,235,235,45,29,16,3,2
26,237,237,14,4,10,3,2
24,244,244,61,57,4,2,1
1,252,252,14,14,0,1,0
33,267,267,41,19,22,2,1
11,281,281,55,16,39,4,3
6,283,283,119,94,25,2,1
29,299,299,45,45,0,1,0
14,304,304,69,23,46,4,3
30,322,322,15,2,13,3,2
10,333,333,27,27,0,1,0
34,338,338,71,50,21,4,3
7,349,349,60,60,0,1,0
22,380,380,21,21,0,1,0
23,396,396,25,3,22,3,2
4,409,409,50,50,0,1,0
5,409,409,3,3,0,1,0
8,427,427,141,141,0,1,0
18,434,434,21,21,0,1,0
32,441,441,59,59,0,1,0
19,453,453,44,16,28,3,2
21,455,455,26,26,0,1,0
27,460,460,7,2,5,2,1
25,461,461,16,9,7,2,1
17,489,489,58,58,0,1,0

11,109,109,7,7,0,1,0
39,119,119,2,2,0,1,0
33,133,133,4,4,0,1,0
35,135,135,15,4,11,2,1
40,140,140,33,33,0,1,0
22,150,150,2,2,0,1,0
23,152,152,13,2,11,3,2
25,157,157,3,3,0,1,0
5,185,185,4,4,0,1,0
30,202,202,7,4,3,2,1
2,209,209,1,1,0,1,0
14,232,232,25,25,0,1,0
16,234,234,7,3,4,2,1
21,243,243,17,17,0,1,0
17,255,255,14,9,5,2,1
6,262,262,58,4,54,4,3
18,268,268,30,15,15,4,3
4,273,273,50,50,0,1,0
28,294,294,5,5,0,1,0
42,308,308,52,11,41,2,1
24,321,321,45,28,17,2,1
12,343,343,13,9,4,2,1
36,348,348,4,4,0,1,0
27,350,350,13,13,0,1,0
29,354,354,4,4,0,1,0
15,358,358,34,29,5,2,1
37,358,358,3,3,0,1,0
41,362,362,109,91,18,4,3
38,371,371,55,13,42,4,3
31,373,373,13,1,12,2,1
3,377,377,10,10,0,1,0
8,379,379,3,3,0,1,0
7,387,387,10,7,3,2,1
9,402,402,63,26,37,2,1
19,403,403,4,4,0,1,0
0,416,416,22,2,20,2,1
34,417,417,4,4,0,1,0
13,424,424,32,6,26,3,2
20,430,430,79,7,72,4,3
26,462,462,131,53,78,3,2
32,464,464,158,77,81,4,3
1,469,469,79,79,0,1,0
10,481,481,134,114,20,4,3

5,105,105,7,4,3,2,1
6,116,116,1,1,0,1,0
0,118,118,8,3,5,2,1
13,130,130,15,15,0,1,0
17,134,134,19,19,0,1,0
36,162,162,15,15,0,1,0
10,189,189,31,27,4,2,1
9,194,194,13,13,0,1,0
31,204,204,54,54,0,1,0
21,212,212,5,5,0,1,0
11,228,228,14,6,8,2,1
39,237,237,16,5,11,2,1
4,258,258,7,7,0,1,0
15,260,260,23,12,11,2,1
23,261,261,16,2,14,2,1
18,279,279,4,4,0,1,0
14,302,302,67,67,0,1,0
26,316,316,48,48,0,1,0
40,326,326,94,52,42,4,3
32,334,334,30,6,24,3,2
19,339,339,12,12,0,1,0
28,339,339,45,35,10,2,1
1,343,343,19,19,0,1,0
29,346,346,8,5,3,2,1
25,367,367,9,9,0,1,0
8,369,369,158,39,119,4,3
30,377,377,1,1,0,1,0
34,377,377,42,32,10,3,2
38,380,380,20,20,0,1,0
37,386,386,33,11,22,3,2
12,392,392,35,26,9,4,3
3,399,399,39,34,5,2,1
35,401,401,34,3,31,4,3
27,407,407,29,29,0,1,0
2,416,416,2,2,0,1,0
7,421,421,22,22,0,1,0
33,431,431,7,3,4,2,1
16,450,450,26,26,0,1,0
22,453,453,26,26,0,1,0
20,466,466,63,38,25,2,1
24,468,468,154,126,28,2,1

3,101,101,2,2,0,1,0
18,102,102,71,32,39,4,3
13,141,141,1,1,0,1,0
23,146,146,27,27,0,1,0
10,148,148,1,1,0,1,0
20,155,155,6,6,0,1,0
17,159,159,2,2,0,1,0
27,163,163,11,4,7,2,1
31,171,171,9,9,0,1,0
1,194,194,96,4,92,3,2
19,201,201,30,24,6,3,2
14,224,224,11,8,3,2,1
15,265,265,10,3,7,3,2
25,294,294,39,9,30,3,2
4,312,312,2,2,0,1,0
16,312,312,55,12,43,2,1
0,320,320,48,48,0,1,0
5,346,346,25,5,20,3,2
28,355,355,11,11,0,1,0
12,360,360,45,28,17,2,1
26,368,368,2,2,0,1,0
22,377,377,37,37,0,1,0
29,385,385,38,14,24,3,2
11,397,397,111,111,0,1,0
7,406,406,85,85,0,1,0
2,423,423,122,26,96,3,2
6,461,461,38,38,0,1,0
24,467,467,2,2,0,1,0
30,476,476,8,4,4,2,1
9,479,479,176,88,88,3,2
21,484,484,31,31,0,1,0
8,487,487,12,2,10,2,1

29,102,102,44,44,0,1,0
8,107,107,26,26,0,1,0
30,110,110,1,1,0,1,0
3,118,118,31,4,27,4,3
41,127,127,9,5,4,2,1
24,132,132,21,21,0,1,0
0,162,162,40,40,0,1,0
14,162,162,14,14,0,1,0
18,175,175,8,8,0,1,0
28,179,179,11,11,0,1,0
11,215,215,11,1,10,2,1
42,218,218,3,3,0,1,0
21,223,223,48,21,27,2,1
5,228,228,14,14,0,1,0
27,230,230,14,3,11,2,1
2,231,231,4,1,3,2,1
6,233,233,3,3,0,1,0
12,238,238,29,20,9,4,3
23,256,256,48,3,45,4,3
38,257,257,17,7,10,3,2
20,287,287,5,5,0,1,0
36,297,297,2,2,0,1,0
22,327,327,20,10,10,2,1
4,329,329,76,76,0,1,0
15,340,340,12,12,0,1,0
32,344,344,51,51,0,1,0
17,346,346,17,17,0,1,0
7,346,346,10,10,0,1,0
13,358,358,5,5,0,1,0
19,362,362,1,1,0,1,0
31,362,362,6,6,0,1,0
35,364,364,7,7,0,1,0
9,380,380,21,18,3,2,1
16,389,389,21,21,0,1,0
25,405,405,95,95,0,1,0
39,411,411,10,10,0,1,0
34,419,419,1,1,0,1,0
40,423,423,108,64,44,2,1
1,437,437,2,2,0,1,0
33,448,448,53,2,51,4,3
37,458,458,61,24,37,4,3
26,484,484,15,6,9,2,1
10,487,487,41,7,34,2,1

31,101,101,8,8,0,1,0
32,108,108,35,2,33,2,1
20,126,126,7,7,0,1,0
33,139,139,6,6,0,1,0
11,156,156,22,22,0,1,0
28,162,162,12,4,8,3,2
12,164,164,22,22,0,1,0
30,174,174,33,6,27,4,3
26,182,182,14,14,0,1,0
1,198,198,7,7,0,1,0
5,212,212,43,43,0,1,0
17,220,220,50,50,0,1,0
18,227,227,10,10,0,1,0
29,245,245,3,3,0,1,0
6,249,249,53,26,27,2,1
2,250,250,30,6,24,4,3
9,284,284,34,34,0,1,0
15,293,293,34,34,0,1,0
37,297,297,2,2,0,1,0
27,309,309,81,7,74,3,2
39,318,318,3,3,0,1,0
19,318,318,6,6,0,1,0
35,319,319,27,27,0,1,0
23,332,332,21,1,20,3,2
10,348,348,41,41,0,1,0
38,357,357,2,2,0,1,0
3,357,357,3,3,0,1,0
14,401,401,60,18,42,3,2
4,406,406,6,1,5,2,1
34,412,412,9,9,0,1,0
16,412,412,21,15,6,3,2
25,420,420,13,13,0,1,0
21,423,423,56,56,0,1,0
7,431,431,8,8,0,1,0
24,435,435,34,34,0,1,0
13,438,438,78,17,61,4,3
0,449,449,16,16,0,1,0
22,449,449,39,39,0,1,0
36,469,469,187,167,20,2,1
8,499,499,27,19,8,2,1

7,171,171,1,1,0,1,0
15,178,178,7,7,0,1,0
37,184,184,18,14,4,2,1
36,209,209,29,9,20,3,2
8,213,213,1,1,0,1,0
2,218,218,15,15,0,1,0
24,221,221,5,5,0,1,0
28,226,226,26,26,0,1,0
10,235,235,53,32,21,2,1
30,236,236,12,6,6,2,1
16,238,238,76,76,0,1,0
22,242,242,4,4,0,1,0
35,255,255,21,3,18,3,2
27,262,262,31,31,0,1,0
0,270,270,14,2,12,3,2
34,291,291,43,21,22,2,1
3,298,298,114,114,0,1,0
5,322,322,8,8,0,1,0
17,322,322,1,1,0,1,0
32,325,325,18,18,0,1,0
31,332,332,8,8,0,1,0
6,358,358,57,7,50,2,1
29,361,361,22,12,10,3,2
20,362,362,166,76,90,4,3
38,381,381,33,33,0,1,0
23,388,388,35,9,26,2,1
9,440,440,26,26,0,1,0
33,441,441,24,24,0,1,0
21,442,442,38,38,0,1,0
18,444,444,1,1,0,1,0
12,457,457,106,91,15,2,1
4,463,463,14,14,0,1,0
13,463,463,85,65,20,2,1
1,464,464,38,38,0,1,0
26,475,475,28,28,0,1,0
25,486,486,48,48,0,1,0
14,487,487,26,26,0,1,0
11,489,489,36,16,20,2,1
19,493,493,86,64,22,2,1

21,107,107,1,1,0,1,0
15,107,107,6,6,0,1,0
23,116,116,1,1,0,1,0
7,124,124,6,6,0,1,0
33,159,159,1,1,0,1,0
31,166,166,3,3,0,1,0
5,194,194,66,66,0,1,0
13,213,213,21,21,0,1,0
10,225,225,28,13,15,4,3
16,247,247,68,68,0,1,0
28,248,248,46,37,9,4,3
18,255,255,61,3,58,4,3
27,257,257,37,37,0,1,0
29,271,271,15,15,0,1,0
12,288,288,28,28,0,1,0
20,290,290,9,4,5,2,1
26,295,295,8,8,0,1,0
14,302,302,33,21,12,3,2
17,306,306,33,33,0,1,0
0,336,336,30,6,24,2,1
1,343,343,12,12,0,1,0
9,355,355,32,5,27,4,3
8,381,381,33,33,0,1,0
2,395,395,92,63,29,4,3
3,399,399,22,22,0,1,0
11,400,400,36,28,8,2,1
24,408,408,20,20,0,1,0
22,433,433,107,107,0,1,0
34,435,435,11,11,0,1,0
19,447,447,10,2,8,2,1
25,461,461,76,76,0,1,0
30,463,463,12,12,0,1,0
6,469,469,1,1,0,1,0
4,471,471,237,117,120,4,3
32,471,471,161,161,0,1,0

21,119,119,2,2,0,1,0
42,123,123,14,11,3,2,1
44,135,135,4,4,0,1,0
16,148,148,12,4,8,3,2
41,149,149,11,11,0,1,0
5,163,163,1,1,0,1,0
34,168,168,28,28,0,1,0
46,202,202,51,34,17,2,1
39,208,208,38,1,37,2,1
23,219,219,21,16,5,2,1
36,220,220,32,32,0,1,0
26,221,221,7,7,0,1,0
31,239,239,11,11,0,1,0
22,241,241,1,1,0,1,0
32,242,242,49,25,24,2,1
2,244,244,17,7,10,2,1
27,249,249,16,2,14,3,2
43,250,250,23,23,0,1,0
28,253,253,6,6,0,1,0
11,262,262,28,28,0,1,0
6,264,264,5,1,4,2,1
19,268,268,1,1,0,1,0
18,278,278,8,8,0,1,0
4,281,281,20,10,10,2,1
30,296,296,56,56,0,1,0
10,305,305,29,29,0,1,0
45,307,307,14,14,0,1,0
3,309,309,34,34,0,1,0
20,323,323,3,3,0,1,0
29,331,331,62,8,54,4,3
40,340,340,18,18,0,1,0
33,343,343,2,2,0,1,0
47,346,346,55,18,37,2,1
38,350,350,1,1,0,1,0
17,350,350,40,11,29,4,3
35,360,360,23,19,4,2,1
12,365,365,12,7,5,2,1
15,378,378,41,41,0,1,0
24,383,383,36,30,6,2,1
7,385,385,13,13,0,1,0
8,393,393,20,20,0,1,0
1,414,414,72,24,48,3,2
25,415,415,79,79,0,1,0
0,423,423,2,2,0,1,0
37,457,457,1,1,0,1,0
9,463,463,21,21,0,1,0
14,488,488,153,132,21,4,3
13,492,492,12,12,0,1,0

30,113,113,9,9,0,1,0
0,115,115,31,31,0,1,0
2,131,131,37,37,0,1,0
17,135,135,6,6,0,1,0
21,150,150,90,90,0,1,0
16,161,161,6,6,0,1,0
18,195,195,14,14,0,1,0
19,206,206,10,4,6,2,1
10,225,225,77,77,0,1,0
1,243,243,48,4,44,2,1
29,251,251,28,2,26,3,2
27,266,266,2,2,0,1,0
14,295,295,10,5,5,2,1
7,329,329,1,1,0,1,0
6,342,342,13,13,0,1,0
24,358,358,36,36,0,1,0
23,392,392,9,4,5,2,1
12,399,399,186,144,42,3,2
9,415,415,67,67,0,1,0
11,432,432,35,20,15,2,1
4,442,442,193,193,0,1,0
22,446,446,46,46,0,1,0
15,460,460,11,11,0,1,0
20,469,469,25,22,3,2,1
26,473,473,42,12,30,4,3
25,476,476,5,2,3,2,1
5,478,478,61,27,34,4,3
8,483,483,57,7,50,3,2
28,486,486,7,7,0,1,0
13,489,489,15,15,0,1,0
3,497,497,12,12,0,1,0

15,108,108,3,3,0,1,0
21,111,111,10,10,0,1,0
5,136,136,2,2,0,1,0
31,137,137,6,1,5,2,1
4,138,138,9,6,3,2,1
26,144,144,25,7,18,3,2
12,152,152,14,11,3,2,1
24,153,153,22,10,12,3,2
33,161,161,43,43,0,1,0
50,173,173,45,5,40,4,3
32,173,173,20,20,0,1,0
8,181,181,18,8,10,3,2
49,187,187,1,1,0,1,0
39,194,194,2,2,0,1,0
43,203,203,21,15,6,2,1
9,207,207,3,3,0,1,0
37,210,210,3,3,0,1,0
11,220,220,9,1,8,2,1
44,233,233,42,42,0,1,0
16,241,241,3,3,0,1,0
40,241,241,19,11,8,2,1
23,246,246,7,7,0,1,0
34,247,247,4,4,0,1,0
3,258,258,2,2,0,1,0
38,273,273,1,1,0,1,0
1,281,281,32,32,0,1,0
36,283,283,20,20,0,1,0
14,289,289,17,5,12,4,3
48,315,315,5,5,0,1,0
19,331,331,25,25,0,1,0
18,332,332,61,47,14,2,1
13,334,334,11,11,0,1,0
25,336,336,23,20,3,2,1
29,358,358,12,12,0,1,0
17,360,360,3,3,0,1,0
7,361,361,8,4,4,2,1
46,386,386,34,34,0,1,0
41,396,396,22,22,0,1,0
30,403,403,15,1,14,2,1
27,409,409,1,1,0,1,0
2,414,414,11,11,0,1,0
0,415,415,48,16,32,2,1
22,418,418,74,53,21,2,1
47,426,426,135,120,15,2,1
6,437,437,3,3,0,1,0
35,439,439,41,41,0,1,0
51,443,443,93,71,22,3,2
42,491,491,10,10,0,1,0
28,493,493,26,26,0,1,0
10,494,494,21,1,20,2,1
20,495,495,44,44,0,1,0
45,496,496,56,4,52,4,3

35,103,103,1,1,0,1,0
34,106,106,21,21,0,1,0
38,113,113,2,2,0,1,0
0,137,137,5,2,3,2,1
28,143,143,47,17,30,2,1
37,150,150,29,5,24,4,3
21,159,159,1,1,0,1,0
7,166,166,23,23,0,1,0
29,178,178,2,2,0,1,0
17,192,192,16,16,0,1,0
44,205,205,38,9,29,2,1
26,217,217,22,22,0,1,0
39,228,228,6,2,4,2,1
2,230,230,19,3,16,3,2
33,231,231,26,14,12,4,3
3,242,242,7,7,0,1,0
36,263,263,48,6,42,4,3
31,268,268,13,13,0,1,0
30,270,270,17,1,16,4,3
40,271,271,45,9,36,4,3
8,288,288,42,12,30,4,3
1,291,291,16,16,0,1,0
24,302,302,82,26,56,4,3
43,303,303,44,14,30,4,3
27,307,307,3,3,0,1,0
16,310,310,2,2,0,1,0
11,310,310,15,7,8,3,2
22,311,311,18,18,0,1,0
4,341,341,29,29,0,1,0
6,353,353,28,28,0,1,0
9,354,354,70,70,0,1,0
41,371,371,40,17,23,2,1
25,373,373,30,30,0,1,0
19,384,384,26,26,0,1,0
5,387,387,1,1,0,1,0
32,388,388,7,4,3,2,1
13,405,405,63,32,31,2,1
14,451,451,15,3,12,4,3
42,459,459,23,23,0,1,0
20,466,466,18,7,11,2,1
10,468,468,20,3,17,2,1
23,478,478,6,6,0,1,0
15,482,482,2,2,0,1,0
18,494,494,47,16,31,2,1
12,499,499,113,59,54,4,3

37,119,119,11,8,3,2,1
17,121,121,11,5,6,2,1
32,132,132,24,18,6,3,2
20,141,141,2,2,0,1,0
2,152,152,1,1,0,1,0
7,158,158,1,1,0,1,0
26,159,159,18,10,8,2,1
33,160,160,26,26,0,1,0
3,175,175,23,23,0,1,0
0,189,189,7,7,0,1,0
9,189,189,3,3,0,1,0
11,206,206,11,11,0,1,0
31,222,222,10,1,9,4,3
13,237,237,145,55,90,4,3
14,237,237,25,2,23,2,1
25,243,243,13,13,0,1,0
19,244,244,5,2,3,2,1
22,245,245,4,4,0,1,0
10,270,270,1,1,0,1,0
29,276,276,3,3,0,1,0
34,281,281,16,7,9,4,3
4,292,292,14,2,12,2,1
12,305,305,23,23,0,1,0
5,311,311,14,14,0,1,0
24,320,320,77,25,52,4,3
6,327,327,21,3,18,4,3
23,341,341,26,7,19,2,1
35,353,353,66,66,0,1,0
16,371,371,5,5,0,1,0
1,419,419,14,14,0,1,0
18,432,432,33,33,0,1,0
27,436,436,183,183,0,1,0
21,448,448,15,5,10,3,2
36,455,455,56,38,18,2,1
15,475,475,83,8,75,4,3
30,493,493,39,12,27,4,3
28,497,497,15,3,12,4,3
8,499,499,245,200,45,2,1

20,110,110,3,3,0,1,0
32,121,121,2,2,0,1,0
36,132,132,8,5,3,2,1
27,159,159,6,3,3,2,1
18,166,166,5,5,0,1,0
37,166,166,2,2,0,1,0
23,206,206,8,4,4,2,1
30,209,209,19,10,9,4,3
41,214,214,2,2,0,1,0
19,216,216,22,7,15,2,1
12,218,218,24,24,0,1,0
17,222,222,4,4,0,1,0
3,260,260,8,8,0,1,0
26,262,262,13,13,0,1,0
1,270,270,28,28,0,1,0
2,294,294,18,10,8,3,2
8,296,296,26,26,0,1,0
0,301,301,72,72,0,1,0
34,306,306,12,12,0,1,0
42,311,311,15,15,0,1,0
4,315,315,51,51,0,1,0
10,321,321,47,47,0,1,0
24,323,323,11,11,0,1,0
6,342,342,150,6,144,4,3
33,346,346,19,5,14,2,1
21,360,360,12,12,0,1,0
29,361,361,178,119,59,3,2
31,379,379,81,58,23,4,3
7,385,385,2,2,0,1,0
38,396,396,27,27,0,1,0
15,408,408,24,24,0,1,0
40,410,410,2,2,0,1,0
5,417,417,26,18,8,2,1
13,417,417,14,5,9,2,1
28,423,423,129,81,48,4,3
9,428,428,6,6,0,1,0
39,429,429,98,63,35,4,3
11,432,432,24,24,0,1,0
16,460,460,14,14,0,1,0
35,492,492,49,31,18,4,3
25,493,493,61,13,48,3,2
22,495,495,66,30,36,2,1
14,496,496,9,9,0,1,0

4,102,102,39,3,36,2,1
6,103,103,1,1,0,1,0
28,120,120,11,11,0,1,0
22,139,139,16,16,0,1,0
33,139,139,12,12,0,1,0
16,143,143,20,8,12,3,2
5,156,156,7,7,0,1,0
26,160,160,1,1,0,1,0
1,186,186,4,4,0,1,0
15,195,195,20,20,0,1,0
9,197,197,4,4,0,1,0
24,222,222,5,5,0,1,0
17,251,251,2,2,0,1,0
36,262,262,29,29,0,1,0
31,262,262,39,39,0,1,0
12,271,271,3,3,0,1,0
8,283,283,2,2,0,1,0
3,300,300,12,4,8,2,1
14,315,315,10,1,9,4,3
13,321,321,6,6,0,1,0
29,324,324,48,17,31,2,1
37,325,325,30,24,6,2,1
10,331,331,111,10,101,4,3
0,333,333,33,3,30,3,2
20,348,348,3,3,0,1,0
39,370,370,101,101,0,1,0
35,382,382,44,40,4,2,1
38,387,387,7,2,5,2,1
18,388,388,82,82,0,1,0
7,397,397,51,18,33,4,3
32,403,403,43,5,38,3,2
19,434,434,2,2,0,1,0
25,447,447,33,33,0,1,0
27,448,448,54,24,30,3,2
2,463,463,57,11,46,3,2
30,485,485,29,21,8,3,2
11,487,487,127,46,81,4,3
21,489,489,57,57,0,1,0
23,496,496,103,59,44,3,2
34,498,498,58,8,50,2,1

29,105,105,18,12,6,3,2
1,105,105,4,4,0,1,0
31,116,116,7,1,6,3,2
27,128,128,2,2,0,1,0
18,131,131,28,28,0,1,0
30,139,139,10,10,0,1,0
34,142,142,21,21,0,1,0
35,153,153,12,12,0,1,0
9,156,156,6,6,0,1,0
24,163,163,7,7,0,1,0
32,171,171,6,6,0,1,0
26,197,197,11,11,0,1,0
8,199,199,3,3,0,1,0
7,231,231,36,13,23,2,1
4,274,274,22,22,0,1,0
6,302,302,81,39,42,3,2
25,305,305,33,25,8,2,1
0,310,310,29,29,0,1,0
33,324,324,46,46,0,1,0
13,337,337,31,11,20,3,2
12,337,337,31,11,20,3,2
10,347,347,118,9,109,4,3
19,351,351,23,23,0,1,0
2,361,361,3,3,0,1,0
28,362,362,43,19,24,2,1
22,387,387,68,64,4,2,1
11,390,390,47,14,33,4,3
3,395,395,113,31,82,3,2
14,407,407,63,18,45,2,1
23,408,408,2,2,0,1,0
15,410,410,60,18,42,4,3
21,423,423,53,5,48,2,1
16,428,428,3,3,0,1,0
36,452,452,110,26,84,3,2
20,465,465,32,32,0,1,0
5,480,480,31,31,0,1,0
17,488,488,48,48,0,1,0

43,118,118,11,11,0,1,0
36,121,121,20,20,0,1,0
37,126,126,23,1,22,3,2
28,133,133,3,3,0,1,0
21,149,149,9,9,0,1,0
0,166,166,16,16,0,1,0
4,173,173,1,1,0,1,0
1,174,174,6,3,3,2,1
13,178,178,9,9,0,1,0
24,180,180,18,10,8,3,2
9,180,180,20,16,4,2,1
10,184,184,1,1,0,1,0
8,189,189,11,2,9,3,2
38,204,204,7,2,5,2,1
39,206,206,3,3,0,1,0
44,217,217,41,41,0,1,0
16,217,217,22,7,15,3,2
17,222,222,21,5,16,2,1
42,226,226,8,8,0,1,0
20,253,253,9,9,0,1,0
25,259,259,9,9,0,1,0
35,264,264,2,2,0,1,0
3,264,264,3,3,0,1,0
19,268,268,13,2,11,3,2
30,278,278,18,18,0,1,0
22,336,336,6,6,0,1,0
15,343,343,4,4,0,1,0
40,364,364,34,34,0,1,0
2,378,378,118,40,78,4,3
29,382,382,4,1,3,2,1
26,383,383,57,43,14,2,1
23,392,392,42,36,6,3,2
12,393,393,5,5,0,1,0
32,408,408,11,11,0,1,0
34,418,418,28,28,0,1,0
31,424,424,128,64,64,4,3
33,434,434,169,126,43,4,3
6,437,437,12,4,8,3,2
7,443,443,45,36,9,2,1
5,445,445,133,102,31,4,3
45,461,461,19,15,4,2,1
14,464,464,19,19,0,1,0
27,466,466,50,23,27,4,3
18,476,476,60,18,42,2,1
41,487,487,25,19,6,3,2
11,489,489,48,34,14,2,1

28,101,101,44,44,0,1,0
7,122,122,17,1,16,3,2
21,133,133,23,23,0,1,0
22,135,135,4,4,0,1,0
27,160,160,13,13,0,1,0
8,165,165,17,14,3,2,1
18,178,178,20,2,18,4,3
17,179,179,65,15,50,3,2
25,190,190,2,2,0,1,0
1,198,198,17,17,0,1,0
2,200,200,14,2,12,4,3
33,204,204,17,17,0,1,0
19,208,208,13,13,0,1,0
14,223,223,5,2,3,2,1
35,251,251,9,9,0,1,0
16,255,255,27,27,0,1,0
13,267,267,32,8,24,2,1
0,271,271,21,5,16,3,2
30,273,273,34,16,18,3,2
11,275,275,32,32,0,1,0
23,276,276,32,32,0,1,0
32,278,278,9,9,0,1,0
4,278,278,6,2,4,2,1
5,291,291,59,59,0,1,0
37,292,292,8,2,6,3,2
15,294,294,50,2,48,2,1
31,298,298,49,49,0,1,0
29,324,324,15,15,0,1,0
3,333,333,42,34,8,2,1
36,371,371,22,22,0,1,0
9,393,393,55,55,0,1,0
10,398,398,20,2,18,3,2
20,418,418,57,57,0,1,0
12,418,418,5,5,0,1,0
34,439,439,25,25,0,1,0
24,464,464,24,5,19,2,1
6,474,474,36,3,33,4,3
26,488,488,101,15,86,3,2

9,109,109,17,17,0,1,0
37,118,118,2,2,0,1,0
21,146,146,4,4,0,1,0
23,147,147,32,32,0,1,0
18,156,156,18,18,0,1,0
17,170,170,2,2,0,1,0
24,175,175,25,25,0,1,0
5,182,182,13,13,0,1,0
16,187,187,8,2,6,3,2
34,201,201,6,6,0,1,0
28,203,203,26,26,0,1,0
33,214,214,14,14,0,1,0
31,216,216,18,2,16,3,2
8,236,236,12,12,0,1,0
32,236,236,4,1,3,2,1
22,240,240,33,33,0,1,0
26,244,244,15,15,0,1,0
15,256,256,14,5,9,2,1
1,260,260,28,28,0,1,0
14,265,265,43,21,22,2,1
13,274,274,33,24,9,4,3
10,282,282,70,7,63,4,3
12,298,298,14,14,0,1,0
0,298,298,21,21,0,1,0
29,300,300,47,47,0,1,0
36,308,308,8,3,5,2,1
30,311,311,3,3,0,1,0
3,315,315,26,26,0,1,0
25,327,327,58,11,47,2,1
7,354,354,14,14,0,1,0
20,360,360,31,31,0,1,0
19,374,374,11,3,8,3,2
4,378,378,11,1,10,3,2
35,399,399,103,58,45,4,3
38,432,432,117,41,76,4,3
11,447,447,116,110,6,3,2
2,463,463,115,34,81,4,3
27,477,477,50,31,19,2,1
6,483,483,40,6,34,3,2

37,104,104,8,8,0,1,0
39,108,108,5,5,0,1,0
13,139,139,5,1,4,2,1
0,140,140,2,2,0,1,0
28,144,144,2,2,0,1,0
16,172,172,8,8,0,1,0
8,174,174,9,2,7,2,1
20,178,178,11,11,0,1,0
31,179,179,38,38,0,1,0
29,199,199,70,70,0,1,0
36,200,200,49,5,44,4,3
30,210,210,1,1,0,1,0
12,218,218,7,1,6,2,1
2,224,224,68,68,0,1,0
22,286,286,19,19,0,1,0
21,306,306,32,32,0,1,0
19,309,309,25,25,0,1,0
4,320,320,112,52,60,3,2
15,321,321,22,22,0,1,0
17,323,323,44,44,0,1,0
23,325,325,9,9,0,1,0
11,332,332,25,25,0,1,0
14,334,334,32,27,5,2,1
38,335,335,51,41,10,2,1
26,335,335,13,13,0,1,0
18,349,349,31,31,0,1,0
32,351,351,5,2,3,2,1
7,363,363,13,8,5,2,1
33,371,371,5,2,3,2,1
27,373,373,24,24,0,1,0
3,379,379,125,18,107,4,3
25,382,382,100,47,53,4,3
24,394,394,65,65,0,1,0
6,439,439,9,9,0,1,0
1,441,441,31,31,0,1,0
5,443,443,53,53,0,1,0
10,460,460,10,10,0,1,0
9,465,465,11,1,10,3,2
34,485,485,27,27,0,1,0
35,491,491,32,20,12,4,3

32,100,100,6,6,0,1,0
10,103,103,15,8,7,2,1
34,113,113,5,5,0,1,0
9,118,118,7,7,0,1,0
39,119,119,8,8,0,1,0
29,132,132,19,9,10,2,1
38,135,135,21,2,19,2,1
5,140,140,51,46,5,2,1
41,145,145,16,16,0,1,0
40,148,148,19,7,12,2,1
11,161,161,16,16,0,1,0
6,168,168,1,1,0,1,0
2,185,185,3,3,0,1,0
27,191,191,1,1,0,1,0
30,197,197,36,19,17,2,1
36,202,202,4,4,0,1,0
13,203,203,29,20,9,2,1
35,212,212,23,7,16,2,1
33,217,217,77,69,8,2,1
28,250,250,3,3,0,1,0
0,255,255,13,13,0,1,0
16,260,260,39,39,0,1,0
31,282,282,21,21,0,1,0
26,292,292,2,2,0,1,0
20,296,296,38,38,0,1,0
1,312,312,3,3,0,1,0
19,328,328,12,8,4,2,1
24,330,330,93,93,0,1,0
4,336,336,19,19,0,1,0
21,346,346,20,6,14,2,1
14,371,371,3,3,0,1,0
25,375,375,22,22,0,1,0
18,400,400,1,1,0,1,0
23,407,407,31,31,0,1,0
3,415,415,1,1,0,1,0
12,415,415,7,3,4,2,1
17,460,460,64,64,0,1,0
42,470,470,1,1,0,1,0
37,475,475,75,75,0,1,0
22,476,476,64,64,0,1,0
15,479,479,82,82,0,1,0
8,493,493,55,31,24,3,2
7,495,495,45,17,28,2,1

38,111,111,5,5,0,1,0
33,128,128,3,3,0,1,0
41,135,135,3,3,0,1,0
31,137,137,8,8,0,1,0
13,144,144,4,4,0,1,0
20,148,148,50,4,46,3,2
12,166,166,24,17,7,2,1
1,168,168,4,4,0,1,0
7,186,186,38,38,0,1,0
32,198,198,96,45,51,4,3
26,220,220,60,34,26,3,2
39,240,240,15,15,0,1,0
30,249,249,52,52,0,1,0
19,272,272,17,2,15,4,3
14,280,280,13,13,0,1,0
35,310,310,34,31,3,2,1
9,311,311,49,16,33,2,1
6,326,326,1,1,0,1,0
3,334,334,17,17,0,1,0
22,341,341,11,11,0,1,0
15,344,344,11,2,9,4,3
10,344,344,6,6,0,1,0
23,365,365,37,6,31,2,1
8,371,371,9,9,0,1,0
18,392,392,85,61,24,3,2
28,394,394,1,1,0,1,0
40,399,399,5,5,0,1,0
17,402,402,50,38,12,2,1
2,409,409,53,53,0,1,0
11,409,409,65,8,57,4,3
5,416,416,62,62,0,1,0
27,417,417,41,41,0,1,0
16,423,423,8,1,7,2,1
4,444,444,1,1,0,1,0
34,445,445,8,8,0,1,0
24,446,446,44,25,19,2,1
37,450,450,28,28,0,1,0
36,465,465,62,31,31,2,1
29,483,483,6,2,4,2,1
21,487,487,24,24,0,1,0
0,488,488,9,3,6,3,2
25,498,498,89,89,0,1,0

30,107,107,2,2,0,1,0
3,109,109,30,30,0,1,0
6,132,132,23,13,10,2,1
9,135,135,5,5,0,1,0
23,160,160,58,8,50,3,2
7,178,178,3,3,0,1,0
20,180,180,2,2,0,1,0
32,182,182,3,3,0,1,0
1,190,190,1,1,0,1,0
14,195,195,5,5,0,1,0
15,196,196,1,1,0,1,0
8,201,201,4,4,0,1,0
36,204,204,4,4,0,1,0
27,211,211,2,2,0,1,0
22,218,218,11,11,0,1,0
26,224,224,24,6,18,4,3
33,244,244,40,2,38,3,2
28,251,251,116,116,0,1,0
2,251,251,32,24,8,3,2
12,278,278,10,10,0,1,0
21,286,286,29,29,0,1,0
31,288,288,29,13,16,3,2
11,314,314,1,1,0,1,0
17,318,318,56,56,0,1,0
19,320,320,48,48,0,1,0
34,323,323,33,5,28,2,1
0,334,334,79,34,45,2,1
4,335,335,57,57,0,1,0
18,339,339,17,17,0,1,0
5,348,348,4,4,0,1,0
29,351,351,21,11,10,2,1
37,378,378,40,17,23,2,1
10,400,400,60,60,0,1,0
16,404,404,180,180,0,1,0
25,408,408,9,9,0,1,0
35,475,475,44,44,0,1,0
13,485,485,41,28,13,2,1
24,499,499,15,15,0,1,0

13,117,117,22,10,12,3,2
36,127,127,2,2,0,1,0
0,139,139,1,1,0,1,0
9,144,144,41,23,18,2,1
20,194,194,20,20,0,1,0
23,201,201,14,14,0,1,0
18,201,201,34,1,33,2,1
4,208,208,52,52,0,1,0
11,213,213,9,1,8,2,1
29,226,226,48,48,0,1,0
1,244,244,3,3,0,1,0
28,253,253,5,5,0,1,0
7,254,254,15,5,10,3,2
8,273,273,9,9,0,1,0
37,277,277,152,152,0,1,0
3,277,277,7,7,0,1,0
24,286,286,12,12,0,1,0
31,290,290,10,10,0,1,0
21,306,306,62,2,60,3,2
38,318,318,70,70,0,1,0
34,333,333,10,10,0,1,0
27,341,341,9,3,6,3,2
5,347,347,32,32,0,1,0
30,347,347,8,8,0,1,0
2,353,353,8,8,0,1,0
17,354,354,17,7,10,2,1
26,364,364,1,1,0,1,0
25,372,372,38,35,3,2,1
22,384,384,35,13,22,3,2
10,384,384,8,8,0,1,0
32,385,385,12,12,0,1,0
33,394,394,9,3,6,3,2
14,396,396,11,11,0,1,0
15,400,400,39,26,13,4,3
12,431,431,153,21,132,4,3
39,434,434,68,68,0,1,0
35,444,444,38,38,0,1,0
19,449,449,72,72,0,1,0
6,450,450,44,44,0,1,0
16,466,466,4,4,0,1,0

2,104,104,17,4,13,2,1
4,113,113,1,1,0,1,0
33,116,116,26,26,0,1,0
39,125,125,28,4,24,3,2
1,126,126,2,2,0,1,0
25,128,128,11,11,0,1,0
36,128,128,14,14,0,1,0
38,134,134,1,1,0,1,0
3,139,139,17,1,16,3,2
9,140,140,3,3,0,1,0
30,142,142,5,5,0,1,0
29,155,155,12,2,10,3,2
34,165,165,2,2,0,1,0
8,165,165,31,31,0,1,0
10,179,179,9,1,8,3,2
22,200,200,3,3,0,1,0
27,204,204,21,10,11,4,3
12,238,238,8,8,0,1,0
15,249,249,76,22,54,4,3
17,264,264,2,2,0,1,0
40,274,274,13,13,0,1,0
7,276,276,77,59,18,3,2
13,285,285,26,26,0,1,0
26,298,298,29,29,0,1,0
31,312,312,13,13,0,1,0
6,319,319,74,74,0,1,0
28,334,334,25,7,18,4,3
24,338,338,25,25,0,1,0
18,357,357,19,13,6,3,2
35,362,362,50,14,36,2,1
37,370,370,123,123,0,1,0
32,371,371,11,1,10,2,1
5,377,377,8,8,0,1,0
19,421,421,33,33,0,1,0
21,432,432,134,134,0,1,0
11,433,433,22,18,4,2,1
20,437,437,19,19,0,1,0
0,439,439,2,2,0,1,0
23,447,447,7,1,6,2,1
14,473,473,1,1,0,1,0
16,494,494,113,103,10,3,2

27,105,105,19,9,10,2,1
24,115,115,1,1,0,1,0
37,131,131,2,2,0,1,0
35,138,138,19,11,8,3,2
9,148,148,7,7,0,1,0
19,152,152,19,11,8,3,2
33,156,156,74,74,0,1,0
38,160,160,40,24,16,2,1
41,169,169,5,5,0,1,0
43,175,175,5,5,0,1,0
3,177,177,4,4,0,1,0
32,181,181,9,3,6,3,2
39,204,204,1,1,0,1,0
28,207,207,24,12,12,4,3
0,212,212,45,12,33,4,3
17,215,215,58,40,18,4,3
31,243,243,1,1,0,1,0
26,243,243,9,9,0,1,0
4,248,248,1,1,0,1,0
10,248,248,14,6,8,3,2
16,255,255,14,4,10,3,2
8,258,258,1,1,0,1,0
14,260,260,32,32,0,1,0
2,266,266,7,7,0,1,0
34,275,275,9,2,7,2,1
7,281,281,11,3,8,2,1
12,318,318,4,4,0,1,0
29,318,318,1,1,0,1,0
18,345,345,33,33,0,1,0
25,346,346,74,8,66,4,3
42,347,347,50,20,30,3,2
1,352,352,10,10,0,1,0
30,359,359,24,5,19,4,3
20,379,379,4,4,0,1,0
15,399,399,34,10,24,3,2
36,402,402,80,40,40,2,1
22,427,427,28,18,10,2,1
21,434,434,68,23,45,3,2
23,440,440,65,65,0,1,0
40,448,448,27,27,0,1,0
11,468,468,51,51,0,1,0
5,482,482,13,7,6,3,2
6,491,491,44,44,0,1,0
13,494,494,93,18,75,4,3

14,112,112,8,2,6,2,1
19,113,113,11,11,0,1,0
15,120,120,26,12,14,3,2
30,126,126,4,4,0,1,0
16,142,142,7,7,0,1,0
28,152,152,1,1,0,1,0
24,164,164,15,4,11,2,1
22,194,194,2,2,0,1,0
11,204,204,11,11,0,1,0
25,205,205,74,74,0,1,0
10,228,228,12,6,6,3,2
3,242,242,59,23,36,2,1
5,285,285,74,27,47,2,1
27,288,288,17,17,0,1,0
20,306,306,111,111,0,1,0
29,313,313,56,56,0,1,0
26,335,335,6,6,0,1,0
13,342,342,32,32,0,1,0
6,352,352,64,4,60,4,3
4,356,356,69,39,30,4,3
17,362,362,36,36,0,1,0
7,380,380,249,197,52,3,2
9,387,387,24,4,20,3,2
8,446,446,40,37,3,2,1
12,454,454,50,29,21,2,1
23,460,460,23,9,14,3,2
1,470,470,95,65,30,2,1
2,479,479,3,3,0,1,0
21,481,481,8,8,0,1,0
0,490,490,28,2,26,3,2
18,496,496,33,3,30,3,2

20,100,100,5,1,4,2,1
3,114,114,4,1,3,2,1
41,116,116,10,10,0,1,0
9,126,126,8,3,5,2,1
8,138,138,2,2,0,1,0
28,153,153,5,5,0,1,0
39,153,153,4,1,3,2,1
14,163,163,1,1,0,1,0
34,169,169,44,8,36,3,2
40,169,169,3,3,0,1,0
42,174,174,39,30,9,2,1
24,182,182,5,5,0,1,0
16,185,185,31,31,0,1,0
25,208,208,6,6,0,1,0
43,211,211,11,1,10,2,1
17,221,221,3,3,0,1,0
21,233,233,17,1,16,2,1
36,244,244,9,9,0,1,0
6,245,245,8,8,0,1,0
51,248,248,15,3,12,4,3
5,255,255,2,2,0,1,0
7,256,256,37,37,0,1,0
46,261,261,29,5,24,3,2
10,291,291,23,11,12,2,1
30,300,300,23,15,8,3,2
27,304,304,8,8,0,1,0
38,312,312,43,43,0,1,0
18,314,314,3,3,0,1,0
49,316,316,13,10,3,2,1
2,327,327,17,6,11,2,1
37,339,339,78,43,35,4,3
31,340,340,5,5,0,1,0
29,342,342,8,8,0,1,0
33,360,360,2,2,0,1,0
47,360,360,5,5,0,1,0
12,362,362,17,17,0,1,0
45,379,379,21,4,17,3,2
19,391,391,10,10,0,1,0
50,399,399,43,27,16,3,2
1,400,400,30,30,0,1,0
35,409,409,70,25,45,2,1
44,411,411,42,42,0,1,0
48,418,418,11,7,4,2,1
22,436,436,77,77,0,1,0
32,442,442,124,88,36,4,3
13,451,451,1,1,0,1,0
11,469,469,41,35,6,3,2
23,477,477,162,66,96,3,2
4,477,477,1,1,0,1,0
26,486,486,38,38,0,1,0
15,488,488,3,3,0,1,0
0,492,492,90,60,30,4,3

22,120,120,15,15,0,1,0
6,158,158,12,2,10,3,2
13,172,172,6,6,0,1,0
3,176,176,54,54,0,1,0
21,183,183,2,2,0,1,0
24,201,201,35,35,0,1,0
18,217,217,12,1,11,2,1
19,233,233,8,8,0,1,0
15,238,238,51,41,10,3,2
25,241,241,25,25,0,1,0
8,250,250,7,7,0,1,0
2,252,252,47,36,11,2,1
29,264,264,13,13,0,1,0
4,277,277,48,48,0,1,0
5,286,286,54,8,46,3,2
1,291,291,93,85,8,3,2
10,317,317,44,44,0,1,0
16,321,321,35,35,0,1,0
20,322,322,15,15,0,1,0
30,328,328,37,19,18,2,1
31,329,329,19,19,0,1,0
7,347,347,38,38,0,1,0
17,351,351,2,2,0,1,0
28,353,353,24,5,19,2,1
26,357,357,112,97,15,2,1
0,373,373,16,16,0,1,0
9,376,376,27,27,0,1,0
33,390,390,39,34,5,2,1
14,431,431,50,50,0,1,0
23,454,454,70,63,7,2,1
11,457,457,52,32,20,3,2
27,463,463,80,80,0,1,0
12,471,471,45,45,0,1,0
34,476,476,32,9,23,2,1
32,480,480,31,7,24,4,3

15,115,115,14,14,0,1,0
7,121,121,31,7,24,2,1
0,132,132,2,2,0,1,0
25,135,135,1,1,0,1,0
24,138,138,17,17,0,1,0
2,157,157,24,24,0,1,0
36,165,165,8,2,6,2,1
13,174,174,60,9,51,4,3
30,181,181,8,8,0,1,0
4,182,182,8,8,0,1,0
31,185,185,2,2,0,1,0
19,190,190,6,6,0,1,0
32,198,198,10,10,0,1,0
6,225,225,56,56,0,1,0
22,226,226,1,1,0,1,0
10,244,244,45,41,4,2,1
35,251,251,47,4,43,4,3
11,257,257,5,5,0,1,0
18,263,263,156,130,26,3,2
5,273,273,5,5,0,1,0
12,276,276,64,64,0,1,0
8,288,288,41,41,0,1,0
23,292,292,12,12,0,1,0
26,298,298,14,14,0,1,0
14,311,311,19,16,3,2,1
1,317,317,13,5,8,3,2
17,334,334,192,192,0,1,0
9,381,381,8,3,5,2,1
20,386,386,19,19,0,1,0
29,389,389,18,18,0,1,0
21,407,407,1,1,0,1,0
27,417,417,8,2,6,3,2
34,420,420,1,1,0,1,0
33,422,422,40,3,37,3,2
28,432,432,27,27,0,1,0
16,443,443,40,18,22,3,2
3,476,476,4,1,3,2,1

15,102,102,29,7,22,2,1
13,117,117,21,21,0,1,0
34,129,129,4,4,0,1,0
27,141,141,6,6,0,1,0
29,178,178,10,10,0,1,0
16,196,196,12,12,0,1,0
23,200,200,2,2,0,1,0
25,219,219,59,29,30,4,3
11,220,220,7,7,0,1,0
3,224,224,17,17,0,1,0
8,228,228,16,2,14,4,3
21,232,232,1,1,0,1,0
22,251,251,7,3,4,2,1
5,260,260,38,11,27,4,3
9,263,263,23,23,0,1,0
6,264,264,48,31,17,3,2
20,291,291,49,49,0,1,0
30,298,298,115,54,61,4,3
33,313,313,76,18,58,3,2
18,314,314,5,2,3,2,1
28,320,320,15,15,0,1,0
19,327,327,52,6,46,2,1
14,331,331,50,18,32,2,1
2,347,347,11,1,10,2,1
26,352,352,8,2,6,3,2
0,373,373,20,20,0,1,0
12,390,390,14,14,0,1,0
17,411,411,7,4,3,2,1
35,412,412,16,4,12,3,2
1,430,430,87,63,24,3,2
24,440,440,66,66,0,1,0
4,445,445,32,5,27,3,2
10,460,460,61,24,37,2,1
7,462,462,122,27,95,4,3
31,466,466,80,56,24,2,1
32,485,485,59,17,42,3,2

16,106,106,11,11,0,1,0
9,115,115,19,19,0,1,0
3,119,119,8,8,0,1,0
10,121,121,28,7,21,4,3
1,154,154,6,6,0,1,0
33,163,163,30,3,27,2,1
30,201,201,32,18,14,4,3
40,206,206,3,3,0,1,0
15,206,206,6,6,0,1,0
17,209,209,38,14,24,4,3
27,209,209,7,3,4,2,1
4,214,214,3,3,0,1,0
29,227,227,8,2,6,2,1
26,227,227,19,19,0,1,0
13,240,240,1,1,0,1,0
23,247,247,34,34,0,1,0
11,251,251,11,2,9,4,3
37,260,260,70,43,27,4,3
24,264,264,36,2,34,2,1
35,281,281,4,4,0,1,0
7,296,296,2,2,0,1,0
28,301,301,78,78,0,1,0
39,313,313,21,9,12,4,3
34,319,319,10,10,0,1,0
18,342,342,48,48,0,1,0
25,349,349,9,2,7,2,1
20,352,352,32,20,12,2,1
21,353,353,14,14,0,1,0
2,365,365,1,1,0,1,0
32,367,367,42,13,29,2,1
31,391,391,3,3,0,1,0
38,398,398,2,2,0,1,0
0,437,437,54,10,44,2,1
6,439,439,12,12,0,1,0
5,440,440,73,73,0,1,0
36,441,441,73,64,9,4,3
19,444,444,55,55,0,1,0
14,454,454,60,22,38,2,1
22,465,465,115,115,0,1,0
12,465,465,38,38,0,1,0
8,466,466,105,45,60,4,3

15,105,105,7,7,0,1,0
0,134,134,11,1,10,3,2
27,160,160,5,5,0,1,0
10,161,161,61,10,51,4,3
30,176,176,8,8,0,1,0
16,179,179,19,19,0,1,0
21,189,189,17,17,0,1,0
25,203,203,10,2,8,3,2
9,227,227,25,25,0,1,0
28,268,268,4,4,0,1,0
18,309,309,58,9,49,2,1
22,337,337,116,116,0,1,0
17,342,342,53,5,48,4,3
12,346,346,33,20,13,2,1
24,346,346,5,5,0,1,0
23,357,357,56,20,36,3,2
2,358,358,35,35,0,1,0
11,373,373,23,23,0,1,0
29,378,378,43,43,0,1,0
19,395,395,10,10,0,1,0
33,411,411,42,42,0,1,0
5,415,415,10,2,8,2,1
7,430,430,155,121,34,2,1
34,431,431,39,39,0,1,0
1,442,442,30,8,22,3,2
14,450,450,19,1,18,4,3
32,451,451,91,77,14,2,1
6,454,454,39,39,0,1,0
31,454,454,34,34,0,1,0
20,465,465,62,62,0,1,0
13,466,466,119,76,43,2,1
26,469,469,14,14,0,1,0
8,474,474,69,24,45,4,3
3,491,491,8,8,0,1,0
4,493,493,88,78,10,2,1

41,108,108,10,10,0,1,0
12,113,113,24,1,23,4,3
35,123,123,26,12,14,3,2
19,126,126,8,1,7,2,1
37,127,127,5,5,0,1,0
6,130,130,2,2,0,1,0
17,132,132,7,3,4,2,1
39,161,161,33,6,27,4,3
25,166,166,3,3,0,1,0
8,166,166,6,6,0,1,0
23,192,192,43,21,22,2,1
29,208,208,9,9,0,1,0
24,218,218,25,1,24,4,3
0,236,236,46,46,0,1,0
21,239,239,31,31,0,1,0
20,259,259,1,1,0,1,0
27,271,271,66,35,31,4,3
22,277,277,4,4,0,1,0
15,285,285,40,10,30,3,2
28,289,289,5,5,0,1,0
33,295,295,10,10,0,1,0
1,302,302,51,51,0,1,0
18,314,314,10,10,0,1,0
34,318,318,17,17,0,1,0
36,328,328,7,7,0,1,0
14,332,332,25,11,14,2,1
9,335,335,4,4,0,1,0
31,359,359,78,28,50,2,1
26,364,364,37,37,0,1,0
32,364,364,65,2,63,4,3
4,386,386,40,40,0,1,0
3,388,388,10,10,0,1,0
16,396,396,48,10,38,3,2
7,412,412,1,1,0,1,0
38,427,427,42,29,13,2,1
13,437,437,45,39,6,2,1
40,459,459,31,17,14,2,1
11,467,467,47,37,10,2,1
5,474,474,116,74,42,4,3
2,480,480,26,26,0,1,0
30,482,482,24,24,0,1,0
10,500,500,55,55,0,1,0

21,100,100,8,8,0,1,0
12,100,100,1,1,0,1,0
28,106,106,13,13,0,1,0
35,119,119,3,3,0,1,0
9,155,155,31,31,0,1,0
32,155,155,9,3,6,2,1
30,156,156,22,22,0,1,0
27,159,159,13,5,8,2,1
22,162,162,8,5,3,2,1
37,170,170,22,16,6,2,1
4,193,193,1,1,0,1,0
26,223,223,22,6,16,3,2
5,228,228,1,1,0,1,0
16,265,265,32,2,30,3,2
10,268,268,12,5,7,2,1
24,271,271,15,9,6,3,2
20,286,286,2,2,0,1,0
23,287,287,4,4,0,1,0
36,302,302,39,39,0,1,0
33,304,304,9,9,0,1,0
2,304,304,67,27,40,3,2
15,304,304,21,21,0,1,0
11,352,352,12,12,0,1,0
31,355,355,103,103,0,1,0
19,358,358,48,21,27,4,3
13,380,380,78,44,34,2,1
25,382,382,32,32,0,1,0
1,383,383,167,125,42,4,3
18,390,390,80,80,0,1,0
8,412,412,30,30,0,1,0
14,414,414,5,5,0,1,0
6,426,426,77,41,36,2,1
0,428,428,21,21,0,1,0
7,439,439,53,53,0,1,0
34,443,443,14,14,0,1,0
17,473,473,65,65,0,1,0
3,480,480,38,38,0,1,0
29,483,483,134,92,42,4,3

3,124,124,9,9,0,1,0
5,131,131,42,12,30,2,1
21,149,149,1,1,0,1,0
0,151,151,22,22,0,1,0
19,167,167,6,6,0,1,0
16,168,168,26,12,14,2,1
17,174,174,71,18,53,3,2
28,183,183,5,5,0,1,0
14,188,188,33,33,0,1,0
24,194,194,104,54,50,3,2
8,199,199,25,25,0,1,0
1,225,225,12,12,0,1,0
29,229,229,2,2,0,1,0
32,243,243,18,2,16,2,1
11,245,245,44,44,0,1,0
33,251,251,2,2,0,1,0
27,268,268,19,19,0,1,0
13,292,292,69,69,0,1,0
15,295,295,21,21,0,1,0
20,302,302,14,14,0,1,0
26,347,347,13,4,9,2,1
10,360,360,16,5,11,2,1
6,362,362,34,11,23,2,1
9,388,388,61,16,45,2,1
12,397,397,23,23,0,1,0
18,398,398,56,42,14,3,2
4,412,412,69,69,0,1,0
31,420,420,6,2,4,2,1
30,428,428,2,2,0,1,0
23,432,432,2,2,0,1,0
22,476,476,20,20,0,1,0
25,476,476,85,85,0,1,0
2,479,479,39,39,0,1,0
7,488,488,129,98,31,2,1

1,105,105,31,31,0,1,0
17,135,135,3,3,0,1,0
0,155,155,6,6,0,1,0
5,158,158,15,15,0,1,0
2,172,172,1,1,0,1,0
12,174,174,72,52,20,2,1
21,179,179,10,10,0,1,0
8,184,184,22,22,0,1,0
32,201,201,29,13,16,2,1
25,205,205,13,13,0,1,0
9,222,222,14,14,0,1,0
3,224,224,8,8,0,1,0
20,230,230,45,45,0,1,0
28,240,240,37,15,22,2,1
35,244,244,4,4,0,1,0
23,251,251,43,43,0,1,0
29,264,264,12,12,0,1,0
22,281,281,15,5,10,3,2
19,287,287,28,8,20,2,1
24,308,308,15,7,8,2,1
26,313,313,8,2,6,3,2
30,315,315,55,37,18,4,3
10,324,324,1,1,0,1,0
14,341,341,24,24,0,1,0
18,344,344,24,16,8,2,1
15,362,362,97,52,45,4,3
13,362,362,25,9,16,3,2
34,370,370,4,4,0,1,0
7,425,425,11,11,0,1,0
11,427,427,31,14,17,2,1
33,427,427,63,32,31,2,1
16,427,427,9,3,6,2,1
31,457,457,84,66,18,3,2
6,467,467,87,51,36,4,3
4,474,474,113,50,63,4,3
27,480,480,166,32,134,4,3

16,116,116,7,7,0,1,0
35,125,125,18,12,6,2,1
9,128,128,7,7,0,1,0
1,147,147,1,1,0,1,0
22,150,150,4,4,0,1,0
19,156,156,23,5,18,4,3
8,157,157,24,5,19,2,1
5,158,158,17,17,0,1,0
6,163,163,17,3,14,2,1
4,165,165,23,5,18,2,1
7,199,199,34,1,33,2,1
26,215,215,10,10,0,1,0
38,222,222,13,4,9,4,3
18,230,230,10,10,0,1,0
20,230,230,2,2,0,1,0
27,260,260,14,14,0,1,0
28,303,303,36,24,12,3,2
3,306,306,3,3,0,1,0
15,314,314,14,6,8,3,2
29,318,318,44,29,15,2,1
12,319,319,1,1,0,1,0
36,326,326,31,31,0,1,0
37,337,337,14,2,12,4,3
10,338,338,64,12,52,3,2
33,347,347,34,22,12,2,1
24,368,368,111,57,54,3,2
13,369,369,69,16,53,4,3
14,378,378,33,33,0,1,0
11,379,379,3,3,0,1,0
21,379,379,16,16,0,1,0
34,397,397,15,3,12,4,3
17,436,436,41,34,7,2,1
23,439,439,105,30,75,4,3
30,450,450,18,8,10,2,1
0,452,452,45,32,13,2,1
32,461,461,135,36,99,4,3
31,486,486,28,7,21,4,3
2,488,488,215,215,0,1,0
25,495,495,27,11,16,2,1

38,110,110,12,12,0,1,0
21,118,118,5,5,0,1,0
8,131,131,15,15,0,1,0
36,132,132,3,3,0,1,0
1,148,148,11,11,0,1,0
44,155,155,8,8,0,1,0
24,181,181,22,22,0,1,0
3,186,186,25,4,21,2,1
43,206,206,25,1,24,3,2
32,222,222,46,46,0,1,0
11,224,224,7,7,0,1,0
9,233,233,33,23,10,2,1
33,236,236,7,2,5,2,1
41,237,237,9,9,0,1,0
29,239,239,8,8,0,1,0
40,244,244,82,33,49,2,1
25,246,246,34,25,9,4,3
45,252,252,21,21,0,1,0
16,253,253,5,2,3,2,1
23,254,254,22,22,0,1,0
18,270,270,30,25,5,2,1
30,274,274,78,30,48,4,3
10,277,277,17,2,15,4,3
28,279,279,24,12,12,2,1
13,305,305,1,1,0,1,0
46,305,305,23,11,12,4,3
35,308,308,4,4,0,1,0
12,321,321,4,1,3,2,1
37,322,322,48,48,0,1,0
19,324,324,43,28,15,2,1
22,330,330,28,7,21,4,3
31,337,337,15,15,0,1,0
39,337,337,22,2,20,2,1
4,349,349,36,36,0,1,0
34,371,371,32,16,16,2,1
5,374,374,44,24,20,3,2
15,380,380,11,11,0,1,0
20,382,382,19,10,9,2,1
6,384,384,16,16,0,1,0
42,384,384,12,12,0,1,0
14,385,385,9,1,8,3,2
27,386,386,68,52,16,3,2
26,422,422,27,27,0,1,0
0,424,424,69,41,28,3,2
17,441,441,21,8,13,2,1
2,461,461,13,3,10,2,1
7,463,463,11,11,0,1,0

17,103,103,10,6,4,2,1
29,127,127,3,3,0,1,0
30,132,132,5,5,0,1,0
5,136,136,5,5,0,1,0
0,142,142,21,13,8,2,1
12,167,167,4,4,0,1,0
41,177,177,71,29,42,4,3
42,180,180,40,40,0,1,0
22,184,184,2,2,0,1,0
4,192,192,32,32,0,1,0
7,198,198,14,14,0,1,0
25,202,202,15,15,0,1,0
14,204,204,13,3,10,3,2
9,217,217,9,5,4,2,1
35,219,219,33,33,0,1,0
1,220,220,40,8,32,4,3
38,242,242,5,5,0,1,0
16,282,282,31,4,27,2,1
24,283,283,19,1,18,3,2
43,288,288,9,9,0,1,0
8,305,305,3,3,0,1,0
39,319,319,3,3,0,1,0
20,325,325,21,9,12,2,1
15,332,332,29,6,23,2,1
33,340,340,67,67,0,1,0
34,344,344,75,75,0,1,0
6,351,351,29,11,18,4,3
28,363,363,4,4,0,1,0
10,382,382,101,15,86,4,3
37,389,389,34,34,0,1,0
40,411,411,13,13,0,1,0
23,434,434,9,3,6,2,1
21,440,440,7,7,0,1,0
31,445,445,22,22,0,1,0
18,449,449,5,5,0,1,0
32,462,462,106,106,0,1,0
36,466,466,48,18,30,2,1
2,466,466,6,2,4,2,1
11,467,467,131,89,42,3,2
26,473,473,3,3,0,1,0
13,483,483,15,2,13,2,1
19,490,490,75,57,18,4,3
27,495,495,34,2,32,4,3
3,496,496,8,8,0,1,0

18,108,108,1,1,0,1,0
39,109,109,11,3,8,2,1
21,113,113,12,12,0,1,0
6,142,142,9,9,0,1,0
43,156,156,26,7,19,3,2
22,170,170,9,9,0,1,0
24,172,172,8,8,0,1,0
1,175,175,6,6,0,1,0
10,187,187,1,1,0,1,0
17,192,192,9,9,0,1,0
42,196,196,50,50,0,1,0
8,200,200,33,33,0,1,0
25,202,202,4,4,0,1,0
36,222,222,32,11,21,4,3
30,222,222,23,23,0,1,0
40,236,236,43,43,0,1,0
35,249,249,33,33,0,1,0
20,252,252,12,4,8,2,1
41,261,261,5,5,0,1,0
28,279,279,9,1,8,3,2
12,291,291,64,64,0,1,0
7,311,311,51,7,44,4,3
0,316,316,4,4,0,1,0
4,321,321,97,84,13,3,2
29,344,344,2,2,0,1,0
9,354,354,1,1,0,1,0
33,371,371,9,9,0,1,0
34,374,374,28,28,0,1,0
23,382,382,25,11,14,2,1
13,389,389,18,5,13,2,1
38,391,391,15,15,0,1,0
26,396,396,44,44,0,1,0
19,408,408,16,16,0,1,0
5,411,411,11,11,0,1,0
16,413,413,18,4,14,2,1
32,419,419,152,152,0,1,0
31,422,422,38,5,33,4,3
27,427,427,26,6,20,3,2
15,427,427,37,7,30,3,2
14,434,434,65,59,6,2,1
11,450,450,49,13,36,2,1
3,453,453,5,5,0,1,0
44,467,467,31,31,0,1,0
2,480,480,70,53,17,2,1
37,482,482,20,20,0,1,0

17,106,106,2,2,0,1,0
32,132,132,15,15,0,1,0
25,141,141,2,2,0,1,0
13,148,148,9,3,6,2,1
19,148,148,6,6,0,1,0
2,175,175,62,62,0,1,0
26,191,191,29,29,0,1,0
15,195,195,4,4,0,1,0
37,200,200,39,9,30,2,1
27,222,222,26,8,18,3,2
7,223,223,7,7,0,1,0
30,233,233,15,15,0,1,0
12,257,257,14,14,0,1,0
14,260,260,32,4,28,2,1
0,261,261,3,3,0,1,0
21,265,265,46,46,0,1,0
38,269,269,38,38,0,1,0
35,274,274,86,52,34,3,2
31,276,276,7,7,0,1,0
5,280,280,72,29,43,2,1
16,284,284,8,4,4,2,1
18,286,286,45,45,0,1,0
22,301,301,4,4,0,1,0
11,311,311,68,12,56,3,2
20,319,319,32,2,30,3,2
4,321,321,17,17,0,1,0
9,343,343,7,7,0,1,0
33,358,358,3,3,0,1,0
34,371,371,37,31,6,3,2
8,375,375,16,16,0,1,0
29,389,389,20,2,18,2,1
24,390,390,41,41,0,1,0
36,392,392,29,29,0,1,0
23,445,445,46,5,41,2,1
28,453,453,58,58,0,1,0
10,468,468,79,79,0,1,0
3,471,471,50,50,0,1,0
1,477,477,17,17,0,1,0
6,480,480,114,114,0,1,0

15,107,107,21,21,0,1,0
39,116,116,4,4,0,1,0
7,128,128,5,2,3,2,1
41,139,139,10,4,6,2,1
23,143,143,26,2,24,2,1
14,144,144,3,3,0,1,0
30,160,160,6,6,0,1,0
20,166,166,9,6,3,2,1
12,178,178,15,7,8,2,1
16,184,184,25,9,16,4,3
18,198,198,3,3,0,1,0
3,256,256,3,3,0,1,0
9,291,291,43,17,26,2,1
13,292,292,20,8,12,4,3
28,301,301,35,35,0,1,0
31,307,307,34,34,0,1,0
21,311,311,42,42,0,1,0
6,312,312,20,20,0,1,0
1,312,312,34,34,0,1,0
37,318,318,58,58,0,1,0
19,328,328,67,67,0,1,0
11,334,334,12,12,0,1,0
42,340,340,102,8,94,3,2
25,341,341,17,17,0,1,0
2,345,345,28,28,0,1,0
34,349,349,10,10,0,1,0
38,358,358,17,17,0,1,0
36,361,361,28,13,15,2,1
17,371,371,57,12,45,4,3
10,375,375,21,21,0,1,0
40,379,379,48,23,25,2,1
29,384,384,21,13,8,3,2
4,392,392,25,21,4,2,1
33,395,395,8,8,0,1,0
26,402,402,70,70,0,1,0
0,409,409,10,10,0,1,0
35,420,420,98,79,19,3,2
8,421,421,104,39,65,4,3
5,448,448,17,17,0,1,0
24,450,450,41,41,0,1,0
32,451,451,35,35,0,1,0
27,452,452,12,3,9,3,2
22,476,476,7,7,0,1,0

28,105,105,2,2,0,1,0
7,105,105,1,1,0,1,0
6,111,111,13,13,0,1,0
26,113,113,7,7,0,1,0
10,129,129,8,8,0,1,0
0,140,140,54,54,0,1,0
21,144,144,7,2,5,2,1
14,145,145,49,49,0,1,0
13,183,183,15,15,0,1,0
30,201,201,16,7,9,4,3
19,208,208,9,1,8,2,1
15,216,216,3,3,0,1,0
2,229,229,18,18,0,1,0
3,265,265,37,37,0,1,0
24,281,281,75,65,10,2,1
8,283,283,38,7,31,2,1
11,284,284,30,30,0,1,0
1,309,309,4,4,0,1,0
9,315,315,79,52,27,4,3
27,353,353,33,33,0,1,0
25,358,358,86,86,0,1,0
18,379,379,4,4,0,1,0
20,388,388,6,6,0,1,0
16,389,389,13,1,12,3,2
34,400,400,12,12,0,1,0
23,402,402,76,76,0,1,0
35,402,402,37,9,28,2,1
22,405,405,115,87,28,2,1
31,410,410,42,5,37,2,1
4,414,414,26,26,0,1,0
29,420,420,47,47,0,1,0
17,421,421,33,33,0,1,0
12,477,477,17,17,0,1,0
5,497,497,87,72,15,4,3
33,498,498,81,81,0,1,0
32,500,500,39,19,20,2,1

15,110,110,16,8,8,3,2
21,111,111,2,2,0,1,0
31,117,117,13,7,6,2,1
3,129,129,17,17,0,1,0
17,130,130,3,3,0,1,0
34,142,142,5,5,0,1,0
0,146,146,35,35,0,1,0
6,157,157,2,2,0,1,0
19,163,163,13,4,9,4,3
29,176,176,7,7,0,1,0
1,181,181,13,13,0,1,0
25,232,232,27,27,0,1,0
35,241,241,28,28,0,1,0
16,253,253,52,52,0,1,0
10,260,260,11,11,0,1,0
9,261,261,1,1,0,1,0
26,266,266,35,35,0,1,0
22,289,289,18,18,0,1,0
24,309,309,5,1,4,2,1
23,331,331,5,5,0,1,0
32,343,343,32,32,0,1,0
28,352,352,88,44,44,4,3
27,355,355,4,4,0,1,0
2,359,359,22,22,0,1,0
5,392,392,24,11,13,4,3
20,405,405,142,123,19,2,1
33,405,405,45,45,0,1,0
30,407,407,64,64,0,1,0
13,414,414,116,5,111,4,3
18,425,425,42,36,6,2,1
8,448,448,30,14,16,3,2
12,454,454,44,7,37,2,1
11,470,470,138,138,0,1,0
14,490,490,129,38,91,4,3
7,491,491,109,49,60,3,2
4,495,495,4,4,0,1,0

24,170,170,14,14,0,1,0
13,195,195,33,27,6,2,1
12,201,201,7,7,0,1,0
20,207,207,37,37,0,1,0
30,212,212,9,1,8,2,1
8,227,227,18,18,0,1,0
27,237,237,4,4,0,1,0
25,241,241,5,5,0,1,0
4,243,243,28,28,0,1,0
6,257,257,4,1,3,2,1
9,257,257,49,44,5,2,1
1,263,263,28,28,0,1,0
2,263,263,57,57,0,1,0
23,290,290,51,3,48,2,1
17,291,291,38,38,0,1,0
5,291,291,60,60,0,1,0
29,306,306,6,6,0,1,0
7,313,313,24,12,12,3,2
14,316,316,48,48,0,1,0
15,351,351,15,3,12,4,3
0,361,361,107,86,21,4,3
3,371,371,206,191,15,4,3
21,384,384,122,71,51,4,3
28,388,388,3,3,0,1,0
11,398,398,1,1,0,1,0
26,400,400,133,67,66,4,3
10,401,401,57,11,46,3,2
16,404,404,58,46,12,4,3
18,443,443,20,8,12,4,3
19,465,465,13,3,10,2,1
22,500,500,48,48,0,1,0

12,110,110,32,26,6,2,1
14,113,113,2,2,0,1,0
11,124,124,16,16,0,1,0
27,126,126,8,8,0,1,0
4,138,138,8,1,7,3,2
36,149,149,21,21,0,1,0
5,151,151,10,10,0,1,0
23,172,172,21,5,16,3,2
2,178,178,9,9,0,1,0
31,194,194,17,17,0,1,0
29,197,197,32,32,0,1,0
33,203,203,3,3,0,1,0
35,220,220,8,2,6,3,2
24,222,222,4,4,0,1,0
20,225,225,4,4,0,1,0
9,242,242,61,46,15,4,3
17,247,247,3,3,0,1,0
32,257,257,40,14,26,2,1
22,281,281,115,115,0,1,0
16,281,281,9,3,6,3,2
7,286,286,17,5,12,4,3
1,287,287,50,24,26,2,1
13,299,299,16,1,15,2,1
8,320,320,147,147,0,1,0
6,327,327,42,14,28,2,1
30,329,329,6,6,0,1,0
28,353,353,11,11,0,1,0
19,355,355,66,66,0,1,0
37,359,359,3,3,0,1,0
15,366,366,1,1,0,1,0
18,385,385,85,39,46,3,2
0,396,396,11,11,0,1,0
21,397,397,52,41,11,2,1
10,405,405,19,14,5,2,1
25,414,414,17,17,0,1,0
3,426,426,60,22,38,3,2
34,436,436,63,7,56,4,3
26,492,492,15,3,12,4,3

39,104,104,4,4,0,1,0
21,117,117,7,3,4,2,1
22,118,118,6,6,0,1,0
0,118,118,6,6,0,1,0
26,120,120,2,2,0,1,0
29,122,122,10,10,0,1,0
6,126,126,1,1,0,1,0
27,131,131,17,2,15,2,1
13,135,135,6,6,0,1,0
19,159,159,17,13,4,2,1
10,164,164,28,28,0,1,0
20,170,170,17,17,0,1,0
35,186,186,5,5,0,1,0
18,195,195,15,1,14,3,2
16,206,206,22,22,0,1,0
9,220,220,27,27,0,1,0
28,222,222,10,6,4,2,1
25,226,226,22,22,0,1,0
31,251,251,1,1,0,1,0
5,255,255,1,1,0,1,0
7,285,285,5,5,0,1,0
2,285,285,6,6,0,1,0
4,292,292,20,20,0,1,0
24,293,293,1,1,0,1,0
15,314,314,19,5,14,3,2
33,337,337,22,6,16,2,1
34,345,345,22,3,19,3,2
38,350,350,73,9,64,3,2
12,392,392,13,7,6,2,1
1,401,401,95,84,11,2,1
3,406,406,116,3,113,4,3
36,411,411,114,33,81,4,3
32,427,427,247,247,0,1,0
23,429,429,31,22,9,4,3
37,433,433,23,9,14,2,1
17,434,434,73,39,34,3,2
8,451,451,46,46,0,1,0
11,466,466,119,39,80,3,2
30,479,479,41,41,0,1,0
14,499,499,31,31,0,1,0

19,113,113,41,29,12,4,3
2,114,114,13,1,12,2,1
6,132,132,1,1,0,1,0
12,134,134,28,13,15,4,3
28,140,140,2,2,0,1,0
8,145,145,1,1,0,1,0
17,154,154,34,10,24,3,2
24,160,160,12,12,0,1,0
0,191,191,11,11,0,1,0
5,209,209,15,3,12,2,1
32,211,211,13,5,8,2,1
18,213,213,26,17,9,4,3
16,218,218,4,1,3,2,1
34,233,233,7,7,0,1,0
29,240,240,43,14,29,2,1
7,251,251,15,1,14,2,1
3,261,261,2,2,0,1,0
33,279,279,40,40,0,1,0
10,282,282,5,5,0,1,0
21,286,286,9,9,0,1,0
22,288,288,54,44,10,2,1
13,292,292,17,17,0,1,0
20,295,295,42,6,36,2,1
4,309,309,43,43,0,1,0
1,314,314,78,45,33,2,1
23,335,335,20,16,4,2,1
31,337,337,25,11,14,3,2
15,337,337,33,33,0,1,0
25,339,339,12,1,11,2,1
35,354,354,5,5,0,1,0
30,400,400,41,41,0,1,0
14,409,409,8,8,0,1,0
27,414,414,57,2,55,3,2
11,442,442,43,19,24,3,2
9,443,443,244,146,98,3,2
36,446,446,27,27,0,1,0
26,481,481,50,42,8,3,2
37,498,498,51,9,42,3,2

16,112,112,1,1,0,1,0
9,126,126,1,1,0,1,0
19,127,127,5,5,0,1,0
17,128,128,1,1,0,1,0
10,129,129,19,9,10,3,2
23,159,159,4,1,3,2,1
39,165,165,29,29,0,1,0
22,167,167,9,9,0,1,0
21,168,168,5,2,3,2,1
2,178,178,27,17,10,2,1
38,186,186,20,20,0,1,0
32,186,186,11,11,0,1,0
35,197,197,20,5,15,4,3
26,222,222,7,7,0,1,0
13,251,251,2,2,0,1,0
29,252,252,46,34,12,3,2
42,258,258,12,6,6,2,1
27,267,267,21,21,0,1,0
3,283,283,48,29,19,4,3
4,298,298,42,18,24,2,1
25,320,320,85,51,34,4,3
24,329,329,17,5,12,4,3
20,339,339,16,5,11,2,1
12,352,352,33,33,0,1,0
1,362,362,93,93,0,1,0
7,373,373,9,9,0,1,0
6,389,389,3,3,0,1,0
14,390,390,16,8,8,2,1
18,408,408,65,65,0,1,0
0,411,411,98,98,0,1,0
41,411,411,3,3,0,1,0
15,422,422,17,10,7,2,1
5,429,429,41,8,33,2,1
30,436,436,22,2,20,2,1
28,439,439,8,8,0,1,0
8,441,441,54,54,0,1,0
36,449,449,15,15,0,1,0
40,460,460,44,44,0,1,0
11,465,465,53,31,22,3,2
31,473,473,101,101,0,1,0
37,483,483,127,100,27,3,2
34,499,499,27,17,10,2,1
33,500,500,83,83,0,1,0

34,102,102,2,2,0,1,0
17,109,109,9,9,0,1,0
36,110,110,24,24,0,1,0
28,112,112,7,2,5,2,1
7,137,137,12,9,3,2,1
44,144,144,14,2,12,3,2
15,156,156,1,1,0,1,0
39,167,167,6,1,5,2,1
18,182,182,2,2,0,1,0
4,200,200,11,11,0,1,0
22,202,202,29,29,0,1,0
32,211,211,20,4,16,3,2
41,221,221,42,42,0,1,0
5,236,236,3,3,0,1,0
31,241,241,36,1,35,3,2
46,256,256,9,5,4,2,1
40,274,274,86,35,51,4,3
16,275,275,11,11,0,1,0
43,284,284,51,51,0,1,0
10,300,300,112,25,87,4,3
29,300,300,12,4,8,2,1
19,302,302,9,2,7,2,1
9,308,308,6,1,5,2,1
25,314,314,6,6,0,1,0
42,330,330,38,18,20,3,2
38,338,338,3,3,0,1,0
20,338,338,1,1,0,1,0
21,348,348,18,18,0,1,0
30,349,349,1,1,0,1,0
45,352,352,27,1,26,2,1
6,367,367,20,11,9,4,3
11,381,381,70,40,30,4,3
35,389,389,9,9,0,1,0
8,395,395,48,38,10,2,1
0,407,407,28,7,21,4,3
37,416,416,52,11,41,4,3
13,433,433,20,12,8,3,2
3,440,440,31,5,26,3,2
26,440,440,95,21,74,3,2
33,442,442,60,60,0,1,0
23,442,442,70,44,26,3,2
24,446,446,45,45,0,1,0
27,451,451,52,52,0,1,0
12,458,458,1,1,0,1,0
2,459,459,7,7,0,1,0
14,477,477,2,2,0,1,0
1,489,489,12,3,9,2,1

2,104,104,5,1,4,2,1
46,105,105,6,6,0,1,0
38,131,131,4,4,0,1,0
43,151,151,3,3,0,1,0
0,158,158,28,10,18,3,2
5,163,163,10,7,3,2,1
24,164,164,6,6,0,1,0
14,173,173,7,4,3,2,1
8,174,174,8,8,0,1,0
13,179,179,3,3,0,1,0
29,184,184,32,32,0,1,0
39,193,193,2,2,0,1,0
3,208,208,37,25,12,2,1
45,222,222,1,1,0,1,0
22,225,225,2,2,0,1,0
21,242,242,15,12,3,2,1
35,246,246,41,7,34,3,2
15,270,270,19,11,8,2,1
6,277,277,3,3,0,1,0
42,283,283,40,40,0,1,0
9,290,290,58,58,0,1,0
34,315,315,149,5,144,4,3
4,318,318,43,16,27,4,3
7,325,325,81,54,27,4,3
32,334,334,37,23,14,3,2
18,345,345,18,6,12,4,3
12,349,349,5,5,0,1,0
28,359,359,10,4,6,3,2
27,360,360,9,9,0,1,0
19,362,362,34,4,30,4,3
44,369,369,38,38,0,1,0
41,386,386,16,13,3,2,1
10,393,393,70,16,54,3,2
47,394,394,45,45,0,1,0
31,398,398,63,9,54,3,2
23,402,402,19,16,3,2,1
16,402,402,31,31,0,1,0
30,402,402,8,8,0,1,0
17,431,431,2,2,0,1,0
25,437,437,3,3,0,1,0
26,441,441,43,37,6,2,1
37,448,448,5,5,0,1,0
40,450,450,63,33,30,3,2
33,457,457,88,67,21,2,1
1,457,457,2,2,0,1,0
20,477,477,14,1,13,2,1
36,486,486,23,12,11,2,1
11,490,490,15,15,0,1,0

35,105,105,20,4,16,3,2
16,114,114,14,4,10,3,2
25,131,131,2,2,0,1,0
22,133,133,2,2,0,1,0
14,134,134,22,22,0,1,0
30,141,141,23,23,0,1,0
32,163,163,5,5,0,1,0
24,163,163,25,25,0,1,0
4,170,170,10,1,9,2,1
36,177,177,10,10,0,1,0
6,190,190,1,1,0,1,0
38,203,203,26,14,12,2,1
0,205,205,68,68,0,1,0
26,206,206,7,7,0,1,0
3,209,209,3,3,0,1,0
34,209,209,22,22,0,1,0
20,240,240,20,20,0,1,0
17,256,256,60,30,30,3,2
23,267,267,50,10,40,2,1
18,270,270,33,5,28,2,1
29,279,279,4,4,0,1,0
7,291,291,25,15,10,3,2
28,309,309,33,33,0,1,0
31,333,333,35,14,21,2,1
11,345,345,3,3,0,1,0
19,362,362,13,13,0,1,0
1,372,372,94,18,76,3,2
15,379,379,113,24,89,4,3
12,383,383,29,11,18,3,2
33,385,385,79,79,0,1,0
8,394,394,9,9,0,1,0
5,403,403,29,1,28,2,1
27,411,411,2,2,0,1,0
10,417,417,22,19,3,2,1
13,435,435,14,14,0,1,0
2,458,458,21,21,0,1,0
21,465,465,95,41,54,4,3
9,469,469,1,1,0,1,0
37,494,494,101,101,0,1,0

30,102,102,2,2,0,1,0
14,109,109,4,4,0,1,0
38,118,118,7,2,5,2,1
5,174,174,53,38,15,4,3
35,183,183,10,4,6,3,2
17,198,198,18,18,0,1,0
25,206,206,52,32,20,3,2
24,213,213,7,7,0,1,0
19,216,216,11,3,8,2,1
12,226,226,1,1,0,1,0
22,234,234,62,62,0,1,0
15,246,246,27,7,20,2,1
29,250,250,28,28,0,1,0
16,264,264,43,43,0,1,0
1,269,269,9,9,0,1,0
27,277,277,53,53,0,1,0
13,283,283,22,22,0,1,0
26,286,286,95,73,22,3,2
40,291,291,51,51,0,1,0
3,310,310,22,22,0,1,0
28,313,313,1,1,0,1,0
8,320,320,9,3,6,2,1
21,320,320,25,9,16,2,1
34,344,344,16,16,0,1,0
7,348,348,153,153,0,1,0
20,351,351,29,16,13,2,1
18,354,354,1,1,0,1,0
2,356,356,33,33,0,1,0
6,406,406,42,1,41,2,1
32,415,415,17,17,0,1,0
33,415,415,26,15,11,2,1
39,426,426,52,6,46,3,2
37,433,433,2,2,0,1,0
9,441,441,8,5,3,2,1
23,447,447,23,8,15,4,3
31,454,454,22,11,11,4,3
11,468,468,4,4,0,1,0
0,481,481,6,6,0,1,0
10,488,488,113,89,24,4,3
36,489,489,45,45,0,1,0
4,490,490,19,19,0,1,0

18,100,100,5,1,4,2,1
3,104,104,9,3,6,3,2
24,147,147,3,3,0,1,0
23,150,150,16,16,0,1,0
34,153,153,32,32,0,1,0
9,170,170,5,5,0,1,0
1,172,172,1,1,0,1,0
26,177,177,11,2,9,4,3
31,209,209,24,24,0,1,0
8,225,225,75,48,27,4,3
16,226,226,37,37,0,1,0
20,232,232,63,63,0,1,0
14,263,263,26,16,10,2,1
6,288,288,14,10,4,2,1
11,293,293,5,2,3,2,1
21,301,301,74,74,0,1,0
2,303,303,32,32,0,1,0
12,304,304,19,19,0,1,0
7,338,338,7,1,6,2,1
25,339,339,1,1,0,1,0
27,350,350,106,94,12,2,1
17,354,354,65,65,0,1,0
30,364,364,34,14,20,2,1
4,377,377,104,17,87,4,3
28,405,405,2,2,0,1,0
13,411,411,123,123,0,1,0
15,411,411,33,1,32,2,1
36,414,414,10,10,0,1,0
19,417,417,3,3,0,1,0
0,426,426,92,92,0,1,0
33,426,426,19,11,8,3,2
5,441,441,37,37,0,1,0
10,455,455,35,35,0,1,0
35,461,461,31,8,23,2,1
22,484,484,38,38,0,1,0
29,488,488,45,45,0,1,0
32,496,496,30,6,24,3,2

6,115,115,1,1,0,1,0
7,126,126,15,2,13,2,1
25,131,131,10,10,0,1,0
22,134,134,1,1,0,1,0
39,140,140,11,11,0,1,0
36,142,142,2,2,0,1,0
21,158,158,1,1,0,1,0
13,163,163,20,20,0,1,0
24,170,170,11,11,0,1,0
0,171,171,4,1,3,2,1
2,186,186,1,1,0,1,0
23,193,193,5,5,0,1,0
10,193,193,4,4,0,1,0
16,193,193,2,2,0,1,0
40,213,213,9,9,0,1,0
1,221,221,15,15,0,1,0
9,245,245,47,23,24,3,2
34,250,250,7,1,6,3,2
12,255,255,13,13,0,1,0
8,260,260,47,7,40,3,2
29,262,262,33,29,4,2,1
14,277,277,25,7,18,4,3
3,312,312,35,16,19,4,3
11,320,320,44,44,0,1,0
15,328,328,81,3,78,4,3
31,333,333,73,62,11,2,1
28,366,366,62,20,42,2,1
26,376,376,60,45,15,4,3
18,379,379,27,4,23,4,3
30,391,391,39,39,0,1,0
37,406,406,25,9,16,2,1
4,410,410,1,1,0,1,0
20,413,413,110,32,78,3,2
41,415,415,18,7,11,2,1
19,445,445,1,1,0,1,0
38,451,451,72,72,0,1,0
5,454,454,77,23,54,3,2
42,457,457,47,19,28,4,3
35,470,470,74,22,52,3,2
32,479,479,97,51,46,3,2
17,479,479,42,22,20,2,1
27,491,491,2,2,0,1,0
33,496,496,101,23,78,4,3

43,105,105,4,4,0,1,0
33,111,111,13,1,12,2,1
47,117,117,9,9,0,1,0
36,122,122,3,3,0,1,0
21,126,126,5,1,4,2,1
17,131,131,27,19,8,3,2
44,138,138,4,4,0,1,0
48,140,140,6,6,0,1,0
34,148,148,5,5,0,1,0
0,150,150,1,1,0,1,0
41,156,156,3,3,0,1,0
19,160,160,2,2,0,1,0
22,168,168,7,7,0,1,0
15,177,177,33,33,0,1,0
13,183,183,5,5,0,1,0
11,183,183,11,11,0,1,0
5,188,188,31,5,26,2,1
8,206,206,4,4,0,1,0
25,206,206,8,2,6,3,2
45,210,210,39,19,20,3,2
26,215,215,30,19,11,4,3
6,217,217,54,22,32,2,1
12,220,220,1,1,0,1,0
29,226,226,1,1,0,1,0
7,238,238,6,3,3,2,1
46,257,257,12,12,0,1,0
18,260,260,32,2,30,4,3
3,276,276,31,31,0,1,0
50,294,294,105,21,84,4,3
1,301,301,6,6,0,1,0
40,302,302,38,2,36,3,2
4,303,303,29,16,13,2,1
32,323,323,49,25,24,4,3
35,330,330,12,1,11,4,3
38,340,340,34,7,27,2,1
14,341,341,6,3,3,2,1
39,341,341,17,17,0,1,0
28,355,355,6,6,0,1,0
27,357,357,26,2,24,3,2
10,363,363,9,5,4,2,1
9,375,375,5,5,0,1,0
16,396,396,15,15,0,1,0
30,403,403,1,1,0,1,0
31,404,404,99,99,0,1,0
23,429,429,24,18,6,2,1
37,438,438,55,22,33,4,3
24,438,438,33,33,0,1,0
20,440,440,35,30,5,2,1
49,452,452,89,77,12,2,1
2,461,461,13,3,10,2,1
42,487,487,22,8,14,2,1

14,101,101,11,4,7,2,1
18,106,106,25,6,19,2,1
1,112,112,1,1,0,1,0
34,121,121,9,9,0,1,0
28,129,129,2,2,0,1,0
10,147,147,2,2,0,1,0
25,163,163,13,2,11,2,1
24,178,178,45,45,0,1,0
32,180,180,17,1,16,3,2
5,188,188,6,3,3,2,1
33,208,208,27,8,19,2,1
7,212,212,21,7,14,3,2
11,235,235,46,46,0,1,0
29,270,270,41,5,36,4,3
40,272,272,22,4,18,2,1
35,275,275,25,25,0,1,0
19,295,295,33,30,3,2,1
22,302,302,48,48,0,1,0
8,313,313,90,69,21,4,3
2,321,321,30,12,18,2,1
9,338,338,14,14,0,1,0
4,351,351,4,4,0,1,0
17,359,359,84,84,0,1,0
15,366,366,2,2,0,1,0
0,371,371,8,8,0,1,0
27,375,375,45,31,14,2,1
37,376,376,9,6,3,2,1
20,377,377,64,64,0,1,0
3,387,387,6,6,0,1,0
30,397,397,48,48,0,1,0
13,401,401,13,5,8,2,1
38,439,439,24,24,0,1,0
39,450,450,112,16,96,3,2
31,454,454,74,34,40,3,2
26,455,455,15,2,13,3,2
41,456,456,26,8,18,2,1
12,456,456,51,13,38,2,1
16,459,459,21,21,0,1,0
36,465,465,12,12,0,1,0
6,470,470,44,2,42,3,2
21,480,480,15,12,3,2,1
23,485,485,27,27,0,1,0

11,102,102,7,7,0,1,0
7,116,116,6,6,0,1,0
3,144,144,31,3,28,3,2
5,167,167,20,9,11,2,1
29,186,186,3,3,0,1,0
13,191,191,7,7,0,1,0
22,208,208,38,38,0,1,0
24,223,223,18,3,15,4,3
4,241,241,44,18,26,2,1
25,247,247,79,13,66,4,3
17,261,261,5,1,4,2,1
6,268,268,36,36,0,1,0
27,281,281,40,12,28,3,2
18,313,313,30,13,17,2,1
20,320,320,71,71,0,1,0
23,332,332,56,40,16,3,2
10,342,342,51,51,0,1,0
28,352,352,17,17,0,1,0
9,361,361,38,26,12,3,2
21,379,379,2,2,0,1,0
1,383,383,297,256,41,2,1
15,388,388,29,14,15,3,2
16,390,390,1,1,0,1,0
2,395,395,34,19,15,2,1
8,404,404,62,23,39,2,1
19,407,407,33,3,30,2,1
14,441,441,39,39,0,1,0
26,455,455,51,51,0,1,0
12,463,463,59,59,0,1,0
0,475,475,84,84,0,1,0

6,114,114,8,8,0,1,0
37,136,136,5,5,0,1,0
19,137,137,19,1,18,4,3
15,140,140,48,36,12,3,2
5,158,158,23,7,16,3,2
3,165,165,8,8,0,1,0
0,173,173,21,21,0,1,0
25,176,176,6,6,0,1,0
24,190,190,13,3,10,2,1
33,201,201,2,2,0,1,0
30,209,209,12,9,3,2,1
27,212,212,8,8,0,1,0
32,215,215,8,8,0,1,0
28,228,228,31,21,10,3,2
13,234,234,28,10,18,2,1
7,235,235,11,11,0,1,0
40,236,236,5,5,0,1,0
16,241,241,18,7,11,2,1
18,245,245,4,1,3,2,1
2,254,254,37,37,0,1,0
10,268,268,23,23,0,1,0
17,273,273,14,14,0,1,0
26,281,281,60,51,9,4,3
38,293,293,157,111,46,4,3
43,299,299,10,4,6,2,1
9,302,302,16,16,0,1,0
42,306,306,19,5,14,3,2
34,336,336,49,49,0,1,0
31,336,336,10,1,9,3,2
20,350,350,31,15,16,2,1
21,362,362,14,7,7,2,1
35,376,376,115,80,35,2,1
8,376,376,24,4,20,3,2
41,390,390,52,6,46,3,2
36,394,394,36,36,0,1,0
11,402,402,27,27,0,1,0
29,415,415,17,17,0,1,0
22,423,423,7,7,0,1,0
23,436,436,36,36,0,1,0
12,444,444,4,1,3,2,1
14,476,476,27,19,8,2,1
39,480,480,4,1,3,2,1
1,487,487,49,49,0,1,0
4,490,490,8,5,3,2,1

4,157,157,11,11,0,1,0
5,172,172,21,21,0,1,0
11,185,185,2,2,0,1,0
18,204,204,29,29,0,1,0
27,205,205,12,2,10,3,2
21,210,210,18,5,13,2,1
26,217,217,35,26,9,2,1
7,229,229,69,69,0,1,0
10,234,234,10,10,0,1,0
23,244,244,5,2,3,2,1
13,271,271,24,6,18,3,2
32,277,277,47,47,0,1,0
17,277,277,59,40,19,2,1
28,300,300,2,2,0,1,0
19,306,306,14,14,0,1,0
12,311,311,22,5,17,2,1
3,311,311,20,20,0,1,0
20,320,320,58,58,0,1,0
2,322,322,27,27,0,1,0
24,326,326,43,43,0,1,0
16,329,329,89,77,12,4,3
6,330,330,91,91,0,1,0
1,334,334,97,42,55,3,2
25,342,342,4,4,0,1,0
29,352,352,61,61,0,1,0
15,373,373,10,10,0,1,0
30,393,393,68,29,39,2,1
31,409,409,12,4,8,2,1
14,414,414,13,13,0,1,0
9,434,434,278,278,0,1,0
8,457,457,4,4,0,1,0
22,471,471,8,8,0,1,0
0,481,481,10,10,0,1,0

4,100,100,6,6,0,1,0
0,104,104,1,1,0,1,0
24,107,107,6,6,0,1,0
22,124,124,6,6,0,1,0
42,125,125,2,2,0,1,0
18,133,133,16,4,12,2,1
34,135,135,72,54,18,4,3
35,144,144,23,15,8,3,2
30,151,151,6,6,0,1,0
6,151,151,30,30,0,1,0
12,155,155,4,4,0,1,0
36,177,177,25,3,22,2,1
17,206,206,5,5,0,1,0
39,207,207,4,1,3,2,1
3,219,219,19,6,13,2,1
9,232,232,9,9,0,1,0
7,233,233,75,31,44,3,2
33,258,258,2,2,0,1,0
23,264,264,4,4,0,1,0
21,265,265,17,17,0,1,0
11,283,283,2,2,0,1,0
10,283,283,1,1,0,1,0
31,285,285,11,5,6,2,1
26,286,286,9,9,0,1,0
44,287,287,4,4,0,1,0
1,297,297,2,2,0,1,0
13,313,313,67,67,0,1,0
20,317,317,1,1,0,1,0
25,327,327,3,3,0,1,0
43,329,329,22,7,15,2,1
40,352,352,33,7,26,2,1
32,370,370,1,1,0,1,0
2,395,395,21,21,0,1,0
16,424,424,115,103,12,4,3
15,428,428,28,11,17,2,1
14,433,433,4,4,0,1,0
8,433,433,21,21,0,1,0
38,434,434,159,46,113,4,3
37,462,462,41,41,0,1,0
29,466,466,47,47,0,1,0
5,469,469,70,70,0,1,0
27,471,471,91,91,0,1,0
28,472,472,28,7,21,4,3
41,478,478,28,6,22,3,2
19,490,490,52,52,0,1,0

14,118,118,21,7,14,3,2
31,143,143,1,1,0,1,0
8,145,145,34,34,0,1,0
35,155,155,14,14,0,1,0
39,159,159,35,9,26,2,1
13,174,174,9,2,7,2,1
21,175,175,7,7,0,1,0
27,184,184,81,63,18,4,3
38,188,188,11,11,0,1,0
23,194,194,3,3,0,1,0
28,196,196,29,6,23,2,1
29,206,206,35,35,0,1,0
24,208,208,22,22,0,1,0
17,218,218,1,1,0,1,0
16,221,221,25,2,23,2,1
12,223,223,2,2,0,1,0
5,239,239,25,7,18,2,1
36,246,246,40,40,0,1,0
2,248,248,17,17,0,1,0
19,259,259,93,93,0,1,0
42,260,260,9,1,8,3,2
37,266,266,18,5,13,3,2
40,269,269,26,26,0,1,0
41,270,270,16,10,6,2,1
9,280,280,64,64,0,1,0
15,292,292,12,12,0,1,0
20,300,300,28,28,0,1,0
7,325,325,65,65,0,1,0
0,339,339,9,3,6,3,2
33,349,349,1,1,0,1,0
4,358,358,1,1,0,1,0
10,362,362,12,6,6,2,1
3,370,370,19,5,14,3,2
22,378,378,18,18,0,1,0
25,380,380,29,29,0,1,0
30,382,382,48,48,0,1,0
32,402,402,4,4,0,1,0
43,406,406,10,10,0,1,0
34,435,435,22,22,0,1,0
1,440,440,1,1,0,1,0
6,461,461,1,1,0,1,0
26,496,496,48,16,32,3,2
18,498,498,46,2,44,2,1
11,499,499,1,1,0,1,0

25,111,111,38,16,22,2,1
1,125,125,6,1,5,2,1
41,147,147,33,23,10,2,1
21,150,150,3,3,0,1,0
38,152,152,7,7,0,1,0
28,174,174,6,6,0,1,0
3,175,175,30,22,8,2,1
23,183,183,10,3,7,2,1
37,188,188,7,7,0,1,0
7,216,216,1,1,0,1,0
35,225,225,1,1,0,1,0
11,242,242,9,9,0,1,0
39,246,246,11,2,9,4,3
13,247,247,8,5,3,2,1
0,253,253,1,1,0,1,0
26,255,255,24,24,0,1,0
8,259,259,1,1,0,1,0
32,263,263,45,45,0,1,0
20,273,273,34,12,22,4,3
12,279,279,10,10,0,1,0
34,288,288,40,27,13,2,1
36,291,291,14,4,10,3,2
17,291,291,153,48,105,4,3
24,303,303,14,14,0,1,0
31,310,310,104,75,29,4,3
9,311,311,28,28,0,1,0
29,314,314,31,17,14,3,2
16,316,316,4,4,0,1,0
18,338,338,36,10,26,3,2
2,365,365,9,2,7,2,1
27,366,366,29,29,0,1,0
10,370,370,62,35,27,4,3
19,379,379,1,1,0,1,0
6,394,394,1,1,0,1,0
15,407,407,57,57,0,1,0
5,417,417,39,39,0,1,0
30,442,442,34,34,0,1,0
40,457,457,6,6,0,1,0
4,466,466,14,5,9,2,1
22,467,467,22,22,0,1,0
33,478,478,48,18,30,4,3
14,486,486,159,159,0,1,0

6,121,121,7,7,0,1,0
36,126,126,33,9,24,2,1
27,132,132,19,19,0,1,0
0,154,154,3,3,0,1,0
10,160,160,8,8,0,1,0
28,163,163,18,18,0,1,0
22,173,173,1,1,0,1,0
14,175,175,9,9,0,1,0
31,176,176,54,27,27,4,3
20,181,181,12,12,0,1,0
23,197,197,1,1,0,1,0
39,198,198,13,4,9,2,1
26,228,228,20,11,9,4,3
1,237,237,1,1,0,1,0
9,246,246,16,16,0,1,0
18,250,250,10,10,0,1,0
32,254,254,29,10,19,3,2
19,262,262,73,48,25,2,1
33,272,272,19,2,17,2,1
13,279,279,12,6,6,2,1
37,284,284,103,42,61,4,3
5,293,293,49,37,12,2,1
16,294,294,1,1,0,1,0
38,295,295,44,22,22,3,2
29,296,296,3,3,0,1,0
4,303,303,2,2,0,1,0
12,307,307,70,38,32,4,3
2,308,308,15,15,0,1,0
15,326,326,19,19,0,1,0
35,332,332,4,4,0,1,0
11,383,383,114,30,84,4,3
30,386,386,7,7,0,1,0
3,395,395,78,59,19,2,1
7,398,398,7,7,0,1,0
34,409,409,57,24,33,4,3
17,411,411,1,1,0,1,0
21,418,418,37,37,0,1,0
8,446,446,162,69,93,4,3
25,478,478,2,2,0,1,0
24,482,482,9,9,0,1,0

0,111,111,3,3,0,1,0
42,126,126,7,7,0,1,0
8,128,128,12,12,0,1,0
25,129,129,1,1,0,1,0
27,136,136,9,9,0,1,0
43,145,145,2,2,0,1,0
32,167,167,2,2,0,1,0
11,169,169,1,1,0,1,0
18,194,194,22,22,0,1,0
34,197,197,12,12,0,1,0
13,202,202,30,30,0,1,0
40,207,207,15,3,12,2,1
12,242,242,42,23,19,2,1
5,252,252,55,23,32,4,3
39,291,291,56,47,9,4,3
38,295,295,24,24,0,1,0
17,301,301,89,85,4,2,1
21,309,309,21,12,9,4,3
30,317,317,63,35,28,3,2
26,319,319,75,62,13,2,1
37,321,321,86,86,0,1,0
10,329,329,9,9,0,1,0
35,343,343,28,3,25,2,1
7,345,345,8,8,0,1,0
19,352,352,10,10,0,1,0
23,354,354,14,7,7,2,1
2,362,362,21,9,12,4,3
15,366,366,20,20,0,1,0
4,367,367,31,31,0,1,0
36,372,372,21,21,0,1,0
16,379,379,8,8,0,1,0
28,381,381,43,43,0,1,0
6,392,392,41,41,0,1,0
3,407,407,23,7,16,3,2
24,411,411,71,21,50,2,1
31,433,433,3,3,0,1,0
33,443,443,15,15,0,1,0
22,449,449,11,11,0,1,0
9,450,450,57,13,44,2,1
29,465,465,69,69,0,1,0
1,465,465,26,8,18,3,2
20,468,468,20,20,0,1,0
14,469,469,52,10,42,4,3
41,477,477,80,66,14,2,1

18,100,100,1,1,0,1,0
12,104,104,5,5,0,1,0
3,108,108,10,10,0,1,0
38,126,126,29,29,0,1,0
10,144,144,35,2,33,2,1
27,145,145,18,18,0,1,0
6,150,150,10,3,7,2,1
2,162,162,18,6,12,3,2
7,165,165,3,3,0,1,0
24,170,170,1,1,0,1,0
16,175,175,2,2,0,1,0
4,178,178,1,1,0,1,0
23,183,183,4,4,0,1,0
41,184,184,13,13,0,1,0
26,185,185,4,4,0,1,0
20,194,194,12,2,10,3,2
21,200,200,17,17,0,1,0
33,206,206,84,12,72,4,3
31,233,233,10,1,9,2,1
17,244,244,20,20,0,1,0
13,256,256,15,15,0,1,0
29,258,258,6,6,0,1,0
39,264,264,4,1,3,2,1
32,281,281,26,15,11,2,1
15,296,296,2,2,0,1,0
43,306,306,19,8,11,2,1
11,309,309,49,49,0,1,0
28,310,310,25,25,0,1,0
9,326,326,171,115,56,4,3
8,331,331,8,8,0,1,0
25,350,350,52,14,38,3,2
30,373,373,21,3,18,4,3
1,373,373,2,2,0,1,0
5,398,398,69,69,0,1,0
14,409,409,32,32,0,1,0
19,424,424,10,10,0,1,0
35,429,429,82,15,67,3,2
42,438,438,55,52,3,2,1
36,463,463,62,37,25,2,1
22,478,478,30,1,29,2,1
0,487,487,13,13,0,1,0
34,488,488,14,11,3,2,1
37,491,491,26,26,0,1,0
40,498,498,61,5,56,3,2

10,112,112,2,2,0,1,0
29,116,116,22,18,4,2,1
12,120,120,1,1,0,1,0
34,126,126,8,8,0,1,0
8,131,131,1,1,0,1,0
19,144,144,37,7,30,4,3
21,153,153,18,6,12,4,3
15,158,158,6,6,0,1,0
38,170,170,3,3,0,1,0
30,175,175,15,15,0,1,0
7,187,187,23,23,0,1,0
26,210,210,50,15,35,2,1
2,224,224,1,1,0,1,0
31,234,234,9,3,6,2,1
25,241,241,26,26,0,1,0
9,275,275,27,27,0,1,0
1,276,276,15,3,12,2,1
17,299,299,31,2,29,4,3
32,315,315,38,38,0,1,0
36,340,340,11,3,8,3,2
23,369,369,50,50,0,1,0
0,381,381,60,36,24,2,1
24,406,406,37,11,26,2,1
4,422,422,39,39,0,1,0
11,422,422,45,23,22,2,1
18,422,422,117,117,0,1,0
22,429,429,55,55,0,1,0
33,442,442,90,90,0,1,0
5,444,444,75,66,9,4,3
14,444,444,41,21,20,3,2
28,444,444,14,14,0,1,0
35,445,445,14,4,10,3,2
3,454,454,78,78,0,1,0
20,455,455,53,53,0,1,0
13,458,458,115,21,94,4,3
37,466,466,3,3,0,1,0
27,477,477,17,1,16,2,1
16,478,478,34,34,0,1,0
6,485,485,76,40,36,2,1

34,106,106,3,3,0,1,0
35,109,109,5,5,0,1,0
36,116,116,5,5,0,1,0
5,128,128,1,1,0,1,0
15,144,144,4,4,0,1,0
16,145,145,11,11,0,1,0
22,164,164,1,1,0,1,0
0,168,168,26,2,24,2,1
11,171,171,2,2,0,1,0
30,173,173,56,56,0,1,0
21,223,223,11,6,5,2,1
7,229,229,25,1,24,4,3
43,237,237,5,1,4,2,1
25,245,245,6,1,5,2,1
10,256,256,33,33,0,1,0
19,259,259,17,11,6,3,2
28,262,262,30,16,14,2,1
32,265,265,52,9,43,2,1
17,272,272,76,76,0,1,0
33,279,279,66,55,11,2,1
1,294,294,31,13,18,4,3
2,302,302,6,2,4,2,1
31,303,303,8,8,0,1,0
8,315,315,11,7,4,2,1
3,319,319,7,7,0,1,0
38,320,320,3,3,0,1,0
41,339,339,29,29,0,1,0
14,363,363,46,46,0,1,0
26,366,366,37,21,16,2,1
4,374,374,7,1,6,2,1
18,376,376,18,18,0,1,0
13,379,379,93,93,0,1,0
20,380,380,4,4,0,1,0
37,387,387,38,38,0,1,0
9,396,396,103,103,0,1,0
27,410,410,103,103,0,1,0
24,412,412,14,6,8,2,1
40,445,445,51,25,26,3,2
29,454,454,90,6,84,4,3
6,459,459,58,20,38,4,3
39,459,459,10,1,9,2,1
12,465,465,27,3,24,2,1
42,481,481,26,26,0,1,0
23,500,500,4,4,0,1,0

8,133,133,13,13,0,1,0
39,181,181,25,1,24,2,1
34,183,183,87,41,46,3,2
41,196,196,16,16,0,1,0
27,202,202,5,2,3,2,1
23,206,206,2,2,0,1,0
2,218,218,1,1,0,1,0
19,229,229,9,9,0,1,0
1,233,233,11,5,6,2,1
43,237,237,14,3,11,2,1
14,238,238,18,18,0,1,0
5,242,242,58,9,49,3,2
20,301,301,1,1,0,1,0
12,304,304,51,51,0,1,0
22,328,328,1,1,0,1,0
4,330,330,15,3,12,2,1
0,337,337,1,1,0,1,0
28,347,347,11,11,0,1,0
17,351,351,8,8,0,1,0
9,370,370,20,20,0,1,0
40,371,371,7,7,0,1,0
16,374,374,13,13,0,1,0
29,375,375,3,3,0,1,0
36,382,382,26,2,24,4,3
6,387,387,19,16,3,2,1
46,391,391,21,2,19,2,1
37,396,396,20,20,0,1,0
3,402,402,18,18,0,1,0
45,403,403,2,2,0,1,0
13,405,405,28,28,0,1,0
18,406,406,29,29,0,1,0
25,406,406,52,19,33,4,3
47,409,409,3,3,0,1,0
44,412,412,22,8,14,3,2
24,412,412,37,16,21,2,1
35,418,418,97,73,24,2,1
31,433,433,14,4,10,3,2
32,434,434,141,141,0,1,0
42,439,439,64,64,0,1,0
11,450,450,101,94,7,2,1
26,455,455,67,36,31,4,3
15,455,455,14,2,12,3,2
7,467,467,46,32,14,3,2
21,469,469,51,21,30,3,2
33,488,488,40,18,22,2,1
38,489,489,65,23,42,3,2
10,489,489,33,33,0,1,0
30,498,498,16,9,7,2,1

30,118,118,12,3,9,2,1
10,125,125,8,3,5,2,1
4,125,125,19,19,0,1,0
16,139,139,1,1,0,1,0
21,144,144,7,3,4,2,1
14,162,162,25,25,0,1,0
24,171,171,13,4,9,2,1
1,176,176,1,1,0,1,0
7,178,178,28,16,12,4,3
13,178,178,63,63,0,1,0
11,180,180,1,1,0,1,0
29,186,186,19,19,0,1,0
17,204,204,21,21,0,1,0
22,217,217,50,10,40,3,2
34,219,219,29,29,0,1,0
25,222,222,41,11,30,4,3
2,249,249,81,81,0,1,0
18,262,262,51,51,0,1,0
26,263,263,30,18,12,3,2
33,284,284,72,72,0,1,0
31,309,309,2,2,0,1,0
0,316,316,1,1,0,1,0
15,324,324,27,27,0,1,0
27,379,379,32,2,30,3,2
23,397,397,34,34,0,1,0
19,406,406,10,10,0,1,0
20,407,407,69,39,30,4,3
6,427,427,82,77,5,2,1
32,427,427,10,1,9,4,3
12,433,433,81,7,74,3,2
5,486,486,174,134,40,2,1
8,487,487,5,5,0,1,0
9,492,492,2,2,0,1,0
28,494,494,11,11,0,1,0
3,497,497,15,3,12,4,3

39,107,107,6,6,0,1,0
9,109,109,12,4,8,3,2
18,114,114,7,4,3,2,1
10,123,123,3,3,0,1,0
14,123,123,22,14,8,2,1
15,130,130,7,7,0,1,0
24,149,149,8,2,6,2,1
32,168,168,13,3,10,2,1
0,170,170,23,23,0,1,0
28,183,183,11,11,0,1,0
4,208,208,38,38,0,1,0
27,217,217,17,5,12,3,2
6,228,228,7,1,6,3,2
13,247,247,6,2,4,2,1
31,254,254,10,10,0,1,0
1,264,264,45,45,0,1,0
20,271,271,10,2,8,3,2
26,282,282,7,1,6,2,1
11,288,288,100,76,24,4,3
8,299,299,22,17,5,2,1
7,299,299,15,6,9,4,3
34,313,313,31,31,0,1,0
36,313,313,75,6,69,4,3
2,323,323,21,12,9,4,3
40,338,338,18,2,16,2,1
25,354,354,71,11,60,4,3
23,361,361,60,52,8,3,2
30,365,365,104,83,21,2,1
33,375,375,13,3,10,2,1
19,395,395,1,1,0,1,0
5,397,397,21,21,0,1,0
22,406,406,127,37,90,4,3
37,419,419,18,18,0,1,0
29,428,428,10,10,0,1,0
35,434,434,7,7,0,1,0
17,439,439,53,53,0,1,0
3,453,453,7,7,0,1,0
41,456,456,42,22,20,2,1
38,474,474,37,17,20,2,1
21,474,474,44,44,0,1,0
12,474,474,77,77,0,1,0
16,500,500,5,5,0,1,0

28,100,100,4,4,0,1,0
24,107,107,4,4,0,1,0
19,108,108,3,3,0,1,0
4,112,112,4,1,3,2,1
41,122,122,5,5,0,1,0
14,128,128,10,10,0,1,0
0,148,148,15,7,8,2,1
30,150,150,16,8,8,3,2
21,153,153,1,1,0,1,0
6,161,161,2,2,0,1,0
38,201,201,26,11,15,4,3
8,202,202,7,3,4,2,1
25,218,218,16,4,12,4,3
29,229,229,14,14,0,1,0
9,242,242,113,113,0,1,0
34,244,244,42,32,10,3,2
11,254,254,30,6,24,3,2
23,260,260,4,4,0,1,0
31,262,262,69,29,40,3,2
18,277,277,21,21,0,1,0
7,296,296,39,39,0,1,0
26,302,302,25,25,0,1,0
33,308,308,2,2,0,1,0
3,310,310,24,24,0,1,0
17,330,330,6,3,3,2,1
1,331,331,19,4,15,4,3
12,340,340,4,4,0,1,0
36,343,343,73,46,27,4,3
27,354,354,47,5,42,3,2
39,384,384,52,52,0,1,0
37,426,426,149,149,0,1,0
2,432,432,16,16,0,1,0
22,432,432,11,5,6,3,2
16,463,463,15,3,12,4,3
20,466,466,117,117,0,1,0
15,469,469,22,13,9,2,1
40,474,474,8,8,0,1,0
13,481,481,40,40,0,1,0
10,481,481,35,35,0,1,0
5,496,496,111,18,93,4,3
32,496,496,16,16,0,1,0
35,497,497,57,57,0,1,0

34,129,129,17,5,12,4,3
28,131,131,15,3,12,3,2
4,139,139,1,1,0,1,0
32,142,142,10,2,8,3,2
29,142,142,20,20,0,1,0
14,148,148,9,4,5,2,1
0,149,149,86,78,8,3,2
24,162,162,11,11,0,1,0
31,169,169,10,10,0,1,0
35,172,172,5,5,0,1,0
15,196,196,4,4,0,1,0
8,216,216,9,6,3,2,1
19,218,218,8,3,5,2,1
36,222,222,69,69,0,1,0
22,236,236,4,1,3,2,1
11,236,236,7,7,0,1,0
7,238,238,30,3,27,2,1
18,241,241,35,35,0,1,0
20,262,262,57,40,17,2,1
12,278,278,3,3,0,1,0
17,288,288,45,28,17,2,1
37,299,299,27,27,0,1,0
25,300,300,10,1,9,2,1
23,301,301,5,5,0,1,0
33,313,313,50,22,28,2,1
2,313,313,7,1,6,3,2
27,332,332,109,109,0,1,0
16,356,356,10,10,0,1,0
1,378,378,112,112,0,1,0
30,380,380,28,28,0,1,0
21,384,384,4,1,3,2,1
6,391,391,24,24,0,1,0
13,396,396,31,31,0,1,0
5,397,397,45,34,11,2,1
38,407,407,9,9,0,1,0
10,409,409,31,1,30,4,3
9,450,450,8,8,0,1,0
3,453,453,61,61,0,1,0
26,495,495,54,54,0,1,0

4,100,100,9,3,6,2,1
29,112,112,1,1,0,1,0
26,131,131,2,2,0,1,0
12,134,134,27,27,0,1,0
32,137,137,35,17,18,3,2
31,177,177,6,6,0,1,0
35,178,178,10,10,0,1,0
16,185,185,22,22,0,1,0
36,187,187,45,15,30,4,3
10,196,196,20,20,0,1,0
38,205,205,3,3,0,1,0
6,211,211,67,41,26,3,2
1,218,218,5,5,0,1,0
5,218,218,1,1,0,1,0
28,218,218,44,44,0,1,0
30,221,221,2,2,0,1,0
24,225,225,10,10,0,1,0
14,243,243,3,3,0,1,0
34,260,260,13,1,12,4,3
9,268,268,8,2,6,3,2
8,290,290,1,1,0,1,0
0,296,296,8,8,0,1,0
7,297,297,14,2,12,2,1
22,310,310,15,15,0,1,0
25,333,333,4,4,0,1,0
23,345,345,51,51,0,1,0
20,351,351,93,53,40,3,2
33,355,355,48,16,32,3,2
27,358,358,27,27,0,1,0
39,359,359,49,46,3,2,1
3,369,369,10,10,0,1,0
2,378,378,104,104,0,1,0
13,386,386,126,126,0,1,0
19,389,389,33,19,14,2,1
18,394,394,1,1,0,1,0
15,430,430,16,12,4,2,1
11,450,450,53,53,0,1,0
37,455,455,54,54,0,1,0
17,474,474,73,39,34,3,2
21,498,498,88,10,78,3,2

15,108,108,24,10,14,2,1
25,113,113,10,4,6,3,2
22,128,128,14,14,0,1,0
5,143,143,12,12,0,1,0
44,158,158,16,16,0,1,0
10,160,160,8,8,0,1,0
43,160,160,11,3,8,3,2
6,162,162,2,2,0,1,0
12,163,163,2,2,0,1,0
33,179,179,3,3,0,1,0
2,186,186,9,6,3,2,1
18,194,194,23,4,19,3,2
31,196,196,1,1,0,1,0
17,200,200,15,3,12,3,2
32,202,202,5,5,0,1,0
42,204,204,48,48,0,1,0
16,218,218,9,9,0,1,0
29,218,218,8,8,0,1,0
3,219,219,15,6,9,4,3
37,223,223,14,3,11,2,1
40,265,265,21,21,0,1,0
4,280,280,17,4,13,2,1
8,287,287,12,2,10,3,2
35,304,304,22,22,0,1,0
1,309,309,94,94,0,1,0
28,311,311,7,1,6,2,1
41,317,317,29,17,12,4,3
30,317,317,3,3,0,1,0
34,335,335,35,35,0,1,0
24,338,338,29,29,0,1,0
23,339,339,1,1,0,1,0
21,347,347,10,10,0,1,0
11,371,371,49,49,0,1,0
39,375,375,80,80,0,1,0
14,386,386,4,4,0,1,0
27,430,430,14,14,0,1,0
9,433,433,85,34,51,3,2
38,435,435,13,13,0,1,0
20,436,436,67,58,9,2,1
26,442,442,96,27,69,4,3
19,466,466,20,20,0,1,0
0,471,471,11,11,0,1,0
13,472,472,3,3,0,1,0
7,486,486,34,18,16,2,1
36,500,500,265,223,42,2,1

42,105,105,4,4,0,1,0
45,116,116,17,10,7,2,1
22,129,129,11,3,8,3,2
25,139,139,3,3,0,1,0
23,154,154,9,9,0,1,0
18,156,156,1,1,0,1,0
24,161,161,1,1,0,1,0
33,161,161,25,25,0,1,0
10,169,169,8,5,3,2,1
13,182,182,15,10,5,2,1
16,205,205,6,6,0,1,0
26,221,221,66,66,0,1,0
19,225,225,7,7,0,1,0
34,233,233,3,3,0,1,0
20,237,237,26,11,15,2,1
14,254,254,1,1,0,1,0
46,257,257,11,3,8,3,2
29,269,269,11,5,6,2,1
2,270,270,10,10,0,1,0
47,273,273,52,22,30,2,1
0,281,281,2,2,0,1,0
12,301,301,19,5,14,2,1
44,303,303,26,11,15,4,3
27,310,310,1,1,0,1,0
40,321,321,49,49,0,1,0
3,331,331,15,15,0,1,0
7,336,336,4,4,0,1,0
6,337,337,17,5,12,4,3
48,346,346,39,18,21,4,3
8,348,348,48,48,0,1,0
31,358,358,20,20,0,1,0
15,361,361,32,20,12,4,3
41,378,378,64,64,0,1,0
21,393,393,18,18,0,1,0
11,400,400,14,14,0,1,0
17,400,400,44,44,0,1,0
5,422,422,37,17,20,3,2
35,427,427,45,45,0,1,0
30,430,430,3,3,0,1,0
36,445,445,103,103,0,1,0
37,458,458,103,28,75,4,3
43,458,458,80,80,0,1,0
4,462,462,131,45,86,4,3
28,466,466,26,12,14,3,2
39,468,468,17,17,0,1,0
32,478,478,8,8,0,1,0
38,480,480,20,20,0,1,0
9,482,482,59,1,58,3,2
1,485,485,17,17,0,1,0

9,102,102,34,34,0,1,0
23,125,125,21,11,10,2,1
14,130,130,5,5,0,1,0
12,146,146,1,1,0,1,0
33,156,156,3,3,0,1,0
6,180,180,1,1,0,1,0
18,190,190,7,3,4,2,1
2,196,196,20,5,15,4,3
15,229,229,23,3,20,2,1
20,234,234,85,35,50,3,2
24,245,245,3,3,0,1,0
22,249,249,16,1,15,2,1
10,249,249,64,20,44,3,2
30,261,261,12,12,0,1,0
3,262,262,30,6,24,3,2
32,263,263,14,14,0,1,0
27,319,319,15,6,9,4,3
19,333,333,20,17,3,2,1
11,360,360,46,5,41,3,2
21,372,372,26,26,0,1,0
0,374,374,35,23,12,2,1
8,382,382,166,88,78,4,3
26,406,406,44,44,0,1,0
29,407,407,101,81,20,2,1
17,413,413,151,117,34,4,3
28,427,427,1,1,0,1,0
5,431,431,15,15,0,1,0
4,431,431,29,29,0,1,0
1,435,435,57,32,25,2,1
31,437,437,59,59,0,1,0
7,447,447,80,80,0,1,0
16,448,448,20,9,11,2,1
25,465,465,26,26,0,1,0
13,495,495,56,56,0,1,0

38,112,112,1,1,0,1,0
16,159,159,18,18,0,1,0
30,161,161,13,13,0,1,0
14,176,176,5,5,0,1,0
29,198,198,9,9,0,1,0
0,209,209,9,9,0,1,0
41,222,222,62,3,59,3,2
28,229,229,12,12,0,1,0
20,236,236,6,6,0,1,0
26,248,248,23,9,14,2,1
15,255,255,12,6,6,3,2
2,258,258,84,84,0,1,0
12,263,263,26,26,0,1,0
40,273,273,40,40,0,1,0
6,274,274,13,5,8,3,2
24,280,280,78,78,0,1,0
37,284,284,3,3,0,1,0
22,287,287,6,1,5,2,1
34,293,293,9,9,0,1,0
27,301,301,25,25,0,1,0
13,311,311,41,41,0,1,0
17,313,313,41,41,0,1,0
11,329,329,59,59,0,1,0
31,351,351,23,7,16,3,2
23,357,357,26,26,0,1,0
8,360,360,2,2,0,1,0
39,362,362,15,15,0,1,0
32,396,396,14,3,11,2,1
33,397,397,19,19,0,1,0
19,399,399,2,2,0,1,0
7,413,413,130,16,114,4,3
9,414,414,17,17,0,1,0
1,427,427,11,11,0,1,0
10,435,435,46,46,0,1,0
18,455,455,12,12,0,1,0
3,458,458,49,49,0,1,0
4,465,465,39,39,0,1,0
36,470,470,132,132,0,1,0
21,472,472,19,4,15,4,3
25,476,476,164,164,0,1,0
5,477,477,36,24,12,4,3
35,490,490,8,8,0,1,0

17,102,102,2,2,0,1,0
25,103,103,4,4,0,1,0
8,114,114,1,1,0,1,0
16,115,115,5,5,0,1,0
5,123,123,10,7,3,2,1
42,130,130,5,5,0,1,0
44,132,132,16,16,0,1,0
30,144,144,23,23,0,1,0
15,150,150,11,11,0,1,0
18,162,162,7,7,0,1,0
23,176,176,37,5,32,3,2
40,189,189,10,4,6,3,2
21,219,219,21,21,0,1,0
45,219,219,8,8,0,1,0
11,228,228,17,9,8,3,2
43,228,228,50,2,48,4,3
33,228,228,6,6,0,1,0
3,249,249,3,3,0,1,0
14,276,276,2,2,0,1,0
37,283,283,3,3,0,1,0
38,298,298,19,19,0,1,0
9,325,325,29,29,0,1,0
24,339,339,81,65,16,2,1
26,340,340,30,21,9,2,1
28,374,374,45,45,0,1,0
12,386,386,14,14,0,1,0
39,386,386,38,38,0,1,0
29,388,388,112,112,0,1,0
13,396,396,8,8,0,1,0
19,419,419,2,2,0,1,0
1,420,420,63,35,28,3,2
2,433,433,29,29,0,1,0
34,434,434,34,34,0,1,0
20,437,437,20,20,0,1,0
7,438,438,25,1,24,3,2
32,447,447,78,78,0,1,0
4,467,467,59,59,0,1,0
35,470,470,65,60,5,2,1
41,471,471,35,35,0,1,0
22,471,471,151,124,27,4,3
36,475,475,46,4,42,2,1
6,483,483,2,2,0,1,0
0,492,492,56,47,9,2,1
27,494,494,54,12,42,2,1
10,495,495,11,11,0,1,0
31,496,496,20,7,13,2,1

19,106,106,21,6,15,4,3
8,106,106,11,11,0,1,0
2,108,108,1,1,0,1,0
12,111,111,14,14,0,1,0
5,116,116,13,8,5,2,1
9,122,122,30,27,3,2,1
14,135,135,1,1,0,1,0
4,139,139,8,8,0,1,0
25,146,146,4,1,3,2,1
3,158,158,33,10,23,2,1
1,160,160,1,1,0,1,0
18,164,164,2,2,0,1,0
17,166,166,4,1,3,2,1
31,169,169,17,17,0,1,0
37,189,189,39,12,27,4,3
20,198,198,7,2,5,2,1
32,207,207,29,7,22,2,1
29,209,209,12,3,9,4,3
34,210,210,15,12,3,2,1
21,216,216,62,62,0,1,0
28,230,230,33,33,0,1,0
22,252,252,23,1,22,3,2
24,252,252,30,30,0,1,0
40,261,261,10,10,0,1,0
35,271,271,11,11,0,1,0
13,281,281,1,1,0,1,0
6,289,289,61,43,18,2,1
10,310,310,32,32,0,1,0
41,349,349,12,12,0,1,0
30,362,362,2,2,0,1,0
11,364,364,25,11,14,3,2
16,387,387,8,8,0,1,0
38,395,395,58,24,34,3,2
23,396,396,83,83,0,1,0
39,400,400,70,2,68,3,2
27,402,402,101,47,54,4,3
7,422,422,9,1,8,3,2
15,424,424,49,23,26,3,2
0,435,435,10,2,8,2,1
36,488,488,32,7,25,2,1
26,499,499,49,49,0,1,0
33,499,499,3,3,0,1,0

34,102,102,5,5,0,1,0
35,147,147,16,1,15,4,3
7,148,148,16,9,7,2,1
15,155,155,20,20,0,1,0
1,161,161,9,9,0,1,0
6,164,164,12,4,8,3,2
24,169,169,15,15,0,1,0
4,174,174,49,49,0,1,0
18,175,175,2,2,0,1,0
10,178,178,11,11,0,1,0
31,180,180,6,6,0,1,0
9,183,183,9,9,0,1,0
12,187,187,7,7,0,1,0
13,189,189,47,11,36,4,3
28,196,196,7,7,0,1,0
38,222,222,58,46,12,2,1
41,233,233,23,7,16,3,2
11,238,238,84,2,82,3,2
23,258,258,1,1,0,1,0
33,259,259,25,25,0,1,0
26,271,271,22,22,0,1,0
30,283,283,6,6,0,1,0
29,285,285,9,3,6,2,1
0,316,316,11,11,0,1,0
37,323,323,15,7,8,3,2
5,337,337,28,28,0,1,0
42,351,351,2,2,0,1,0
40,363,363,57,27,30,4,3
20,368,368,9,9,0,1,0
14,378,378,32,32,0,1,0
39,395,395,53,15,38,3,2
8,396,396,12,2,10,3,2
17,408,408,10,10,0,1,0
25,410,410,38,9,29,2,1
27,420,420,113,65,48,2,1
22,423,423,32,16,16,2,1
36,428,428,171,99,72,3,2
32,434,434,8,8,0,1,0
19,441,441,11,11,0,1,0
2,441,441,1,1,0,1,0
16,453,453,64,4,60,4,3
3,456,456,1,1,0,1,0
21,498,498,32,25,7,2,1

30,105,105,7,7,0,1,0
34,108,108,6,6,0,1,0
23,114,114,8,8,0,1,0
20,131,131,2,2,0,1,0
35,158,158,9,9,0,1,0
18,168,168,50,21,29,2,1
25,169,169,38,38,0,1,0
24,170,170,3,3,0,1,0
16,176,176,1,1,0,1,0
26,197,197,20,2,18,3,2
12,198,198,1,1,0,1,0
7,217,217,58,37,21,2,1
31,221,221,13,13,0,1,0
21,224,224,68,56,12,2,1
8,229,229,93,93,0,1,0
5,239,239,20,10,10,3,2
19,240,240,35,26,9,2,1
17,256,256,37,2,35,2,1
1,267,267,41,41,0,1,0
4,272,272,7,7,0,1,0
33,277,277,19,19,0,1,0
9,281,281,18,18,0,1,0
27,315,315,6,3,3,2,1
3,323,323,11,2,9,2,1
10,330,330,90,54,36,4,3
22,334,334,12,3,9,2,1
0,342,342,48,42,6,2,1
14,363,363,15,1,14,3,2
13,414,414,15,3,12,2,1
29,442,442,56,12,44,2,1
28,448,448,66,66,0,1,0
11,451,451,7,7,0,1,0
32,478,478,38,9,29,2,1
6,480,480,27,19,8,3,2
15,495,495,69,69,0,1,0
2,498,498,129,101,28,4,3

40,101,101,13,5,8,3,2
15,101,101,10,10,0,1,0
13,102,102,6,3,3,2,1
7,105,105,2,2,0,1,0
44,126,126,11,11,0,1,0
8,144,144,11,11,0,1,0
42,152,152,6,6,0,1,0
11,163,163,23,14,9,2,1
31,169,169,44,15,29,2,1
17,190,190,17,3,14,3,2
36,207,207,23,4,19,4,3
24,215,215,2,2,0,1,0
25,217,217,35,20,15,4,3
12,218,218,5,1,4,2,1
9,224,224,35,35,0,1,0
35,249,249,24,24,0,1,0
16,254,254,2,2,0,1,0
30,254,254,8,8,0,1,0
19,259,259,17,17,0,1,0
10,288,288,30,30,0,1,0
33,302,302,4,4,0,1,0
34,318,318,8,1,7,2,1
37,318,318,22,13,9,4,3
27,322,322,2,2,0,1,0
26,324,324,12,12,0,1,0
0,328,328,79,38,41,2,1
3,356,356,3,3,0,1,0
1,356,356,7,7,0,1,0
18,358,358,17,17,0,1,0
20,359,359,20,7,13,3,2
14,376,376,35,35,0,1,0
22,383,383,15,3,12,3,2
32,399,399,73,73,0,1,0
5,420,420,65,23,42,3,2
39,420,420,58,49,9,4,3
21,425,425,10,10,0,1,0
41,427,427,40,7,33,2,1
28,428,428,7,7,0,1,0
2,430,430,28,1,27,4,3
38,437,437,29,29,0,1,0
43,476,476,113,113,0,1,0
23,483,483,66,21,45,2,1
6,485,485,121,121,0,1,0
29,489,489,115,115,0,1,0
4,492,492,9,9,0,1,0

27,109,109,17,3,14,3,2
26,116,116,13,13,0,1,0
7,121,121,7,7,0,1,0
33,125,125,2,2,0,1,0
37,127,127,34,28,6,2,1
1,155,155,7,3,4,2,1
44,170,170,3,3,0,1,0
34,172,172,9,5,4,2,1
15,173,173,11,5,6,2,1
29,180,180,9,9,0,1,0
21,202,202,20,9,11,2,1
43,213,213,30,3,27,2,1
35,218,218,25,25,0,1,0
42,226,226,33,12,21,2,1
31,226,226,40,40,0,1,0
14,229,229,2,2,0,1,0
30,240,240,17,4,13,3,2
19,252,252,12,6,6,3,2
25,252,252,2,2,0,1,0
24,268,268,2,2,0,1,0
10,270,270,25,22,3,2,1
0,270,270,67,58,9,2,1
3,274,274,51,45,6,2,1
9,281,281,20,12,8,3,2
8,292,292,5,1,4,2,1
4,311,311,11,3,8,3,2
6,315,315,92,92,0,1,0
5,318,318,28,28,0,1,0
17,333,333,35,8,27,2,1
20,336,336,32,6,26,3,2
2,367,367,13,13,0,1,0
18,369,369,24,7,17,2,1
23,371,371,3,3,0,1,0
38,374,374,125,83,42,3,2
22,382,382,12,12,0,1,0
13,386,386,8,8,0,1,0
16,392,392,54,54,0,1,0
39,398,398,1,1,0,1,0
41,407,407,32,2,30,4,3
36,417,417,7,7,0,1,0
11,419,419,49,49,0,1,0
32,420,420,46,14,32,4,3
28,467,467,61,34,27,4,3
40,468,468,20,3,17,2,1
12,476,476,12,8,4,2,1

37,100,100,8,8,0,1,0
16,113,113,13,13,0,1,0
34,114,114,3,3,0,1,0
8,131,131,10,10,0,1,0
32,176,176,20,20,0,1,0
4,192,192,43,43,0,1,0
36,221,221,5,2,3,2,1
9,243,243,12,12,0,1,0
2,243,243,17,17,0,1,0
22,247,247,2,2,0,1,0
10,264,264,50,50,0,1,0
33,272,272,37,37,0,1,0
0,279,279,29,9,20,3,2
23,284,284,64,33,31,2,1
21,286,286,39,39,0,1,0
28,297,297,8,8,0,1,0
27,298,298,20,20,0,1,0
11,304,304,121,108,13,4,3
13,326,326,57,15,42,3,2
24,334,334,95,33,62,3,2
26,338,338,24,4,20,3,2
6,339,339,4,4,0,1,0
14,345,345,1,1,0,1,0
35,353,353,49,49,0,1,0
17,369,369,21,12,9,2,1
1,396,396,6,6,0,1,0
7,400,400,7,7,0,1,0
19,405,405,133,127,6,3,2
30,405,405,35,35,0,1,0
3,410,410,68,34,34,3,2
18,415,415,7,7,0,1,0
31,438,438,43,43,0,1,0
5,438,438,65,65,0,1,0
25,446,446,55,26,29,2,1
12,452,452,56,56,0,1,0
15,474,474,27,15,12,4,3
29,477,477,16,4,12,3,2
20,499,499,6,2,4,2,1

14,104,104,4,4,0,1,0
27,129,129,6,6,0,1,0
7,153,153,5,5,0,1,0
3,153,153,1,1,0,1,0
10,168,168,19,19,0,1,0
19,189,189,2,2,0,1,0
24,199,199,28,28,0,1,0
38,204,204,22,17,5,2,1
20,205,205,17,7,10,3,2
16,230,230,25,25,0,1,0
15,235,235,7,7,0,1,0
12,237,237,138,86,52,4,3
26,258,258,30,18,12,2,1
32,260,260,22,22,0,1,0
21,261,261,31,13,18,4,3
2,286,286,7,7,0,1,0
5,306,306,32,32,0,1,0
17,307,307,136,136,0,1,0
4,311,311,1,1,0,1,0
36,320,320,82,20,62,3,2
13,341,341,3,3,0,1,0
8,343,343,50,5,45,3,2
34,343,343,13,7,6,3,2
33,344,344,18,2,16,2,1
35,349,349,67,67,0,1,0
0,353,353,17,17,0,1,0
6,362,362,18,18,0,1,0
30,364,364,47,17,30,2,1
23,373,373,111,35,76,3,2
22,373,373,1,1,0,1,0
37,380,380,9,9,0,1,0
18,427,427,24,24,0,1,0
9,431,431,31,5,26,3,2
31,437,437,83,83,0,1,0
29,439,439,6,6,0,1,0
11,443,443,53,53,0,1,0
28,458,458,41,41,0,1,0
25,472,472,21,15,6,3,2
1,491,491,7,7,0,1,0

23,111,111,7,7,0,1,0
19,116,116,4,1,3,2,1
26,126,126,9,2,7,2,1
25,150,150,21,21,0,1,0
6,158,158,6,3,3,2,1
0,164,164,5,1,4,2,1
30,183,183,19,19,0,1,0
8,187,187,9,6,3,2,1
28,187,187,7,2,5,2,1
4,193,193,55,55,0,1,0
11,193,193,6,1,5,2,1
33,214,214,14,14,0,1,0
20,215,215,52,11,41,2,1
32,234,234,57,57,0,1,0
27,237,237,8,1,7,2,1
2,244,244,4,4,0,1,0
9,252,252,24,24,0,1,0
3,253,253,15,15,0,1,0
31,258,258,11,11,0,1,0
38,266,266,56,56,0,1,0
24,268,268,25,16,9,4,3
22,274,274,20,17,3,2,1
39,279,279,58,58,0,1,0
34,292,292,29,21,8,2,1
16,297,297,11,1,10,3,2
41,299,299,5,5,0,1,0
14,302,302,6,6,0,1,0
37,312,312,32,32,0,1,0
40,317,317,30,30,0,1,0
17,318,318,3,3,0,1,0
35,325,325,30,30,0,1,0
42,334,334,2,2,0,1,0
10,354,354,49,49,0,1,0
21,358,358,1,1,0,1,0
5,396,396,95,13,82,3,2
36,414,414,112,76,36,4,3
13,427,427,6,6,0,1,0
43,435,435,26,26,0,1,0
12,436,436,43,23,20,4,3
29,464,464,18,18,0,1,0
7,464,464,1,1,0,1,0
18,475,475,121,57,64,4,3
15,498,498,7,7,0,1,0
1,499,499,80,80,0,1,0

41,113,113,21,21,0,1,0
19,137,137,1,1,0,1,0
20,137,137,15,15,0,1,0
1,162,162,31,11,20,2,1
5,182,182,3,3,0,1,0
30,193,193,1,1,0,1,0
13,202,202,2,2,0,1,0
32,203,203,17,2,15,4,3
0,210,210,87,39,48,3,2
12,212,212,12,6,6,2,1
33,231,231,17,8,9,4,3
21,242,242,7,7,0,1,0
37,246,246,9,3,6,2,1
34,247,247,3,3,0,1,0
11,248,248,8,8,0,1,0
2,249,249,1,1,0,1,0
25,254,254,12,12,0,1,0
16,258,258,17,13,4,2,1
28,271,271,28,10,18,3,2
6,276,276,57,17,40,3,2
40,288,288,92,92,0,1,0
23,300,300,36,36,0,1,0
10,306,306,64,25,39,4,3
26,307,307,33,33,0,1,0
35,308,308,1,1,0,1,0
4,333,333,10,10,0,1,0
8,346,346,21,21,0,1,0
24,367,367,99,99,0,1,0
14,383,383,27,27,0,1,0
27,397,397,41,41,0,1,0
29,400,400,42,33,9,4,3
39,400,400,60,55,5,2,1
22,404,404,67,5,62,4,3
36,427,427,8,3,5,2,1
17,440,440,52,52,0,1,0
15,445,445,27,18,9,2,1
3,460,460,43,3,40,2,1
31,470,470,15,15,0,1,0
9,477,477,55,55,0,1,0
7,482,482,28,9,19,2,1
18,486,486,21,2,19,2,1
38,487,487,48,15,33,2,1

35,113,113,16,16,0,1,0
36,113,113,1,1,0,1,0
19,122,122,1,1,0,1,0
28,128,128,12,12,0,1,0
26,132,132,7,7,0,1,0
1,163,163,27,27,0,1,0
17,176,176,5,1,4,2,1
3,182,182,1,1,0,1,0
24,186,186,19,2,17,2,1
37,192,192,45,45,0,1,0
27,209,209,41,41,0,1,0
33,226,226,18,18,0,1,0
16,250,250,43,19,24,4,3
25,262,262,13,13,0,1,0
0,273,273,1,1,0,1,0
32,288,288,23,14,9,2,1
38,309,309,76,76,0,1,0
21,324,324,27,3,24,2,1
14,341,341,10,1,9,4,3
20,341,341,79,5,74,4,3
2,345,345,11,11,0,1,0
13,350,350,1,1,0,1,0
39,350,350,14,14,0,1,0
10,357,357,114,86,28,3,2
22,366,366,80,80,0,1,0
34,367,367,5,1,4,2,1
30,383,383,22,8,14,2,1
8,394,394,25,25,0,1,0
4,396,396,5,5,0,1,0
23,399,399,20,20,0,1,0
5,406,406,5,5,0,1,0
29,417,417,69,31,38,3,2
31,417,417,22,22,0,1,0
15,423,423,106,18,88,4,3
12,432,432,69,17,52,3,2
9,434,434,13,13,0,1,0
6,445,445,89,80,9,2,1
7,453,453,34,34,0,1,0
18,453,453,83,83,0,1,0
40,463,463,34,34,0,1,0
11,477,477,7,7,0,1,0

3,116,116,2,2,0,1,0
25,118,118,10,10,0,1,0
30,121,121,30,16,14,3,2
10,152,152,28,28,0,1,0
12,154,154,3,3,0,1,0
29,163,163,3,3,0,1,0
6,172,172,1,1,0,1,0
26,194,194,4,4,0,1,0
40,205,205,27,12,15,2,1
23,209,209,32,32,0,1,0
36,237,237,6,6,0,1,0
39,243,243,28,1,27,2,1
20,255,255,17,17,0,1,0
8,255,255,46,41,5,2,1
0,257,257,9,1,8,3,2
1,262,262,15,1,14,3,2
32,263,263,18,6,12,3,2
14,270,270,3,3,0,1,0
19,281,281,9,9,0,1,0
18,292,292,49,5,44,2,1
31,305,305,4,4,0,1,0
38,307,307,10,10,0,1,0
7,308,308,9,3,6,3,2
4,325,325,68,34,34,3,2
9,327,327,61,61,0,1,0
17,347,347,33,33,0,1,0
11,372,372,12,12,0,1,0
35,374,374,13,1,12,4,3
2,382,382,22,22,0,1,0
42,385,385,82,45,37,2,1
37,387,387,26,26,0,1,0
15,392,392,2,2,0,1,0
28,395,395,44,44,0,1,0
21,406,406,66,4,62,3,2
27,417,417,74,16,58,3,2
16,428,428,55,31,24,3,2
34,432,432,6,6,0,1,0
33,438,438,4,4,0,1,0
24,441,441,85,8,77,3,2
13,455,455,13,2,11,4,3
41,466,466,178,132,46,3,2
22,468,468,54,54,0,1,0
5,472,472,11,11,0,1,0
43,496,496,35,35,0,1,0

35,104,104,11,3,8,3,2
11,105,105,5,2,3,2,1
25,112,112,17,5,12,2,1
15,116,116,3,3,0,1,0
0,119,119,1,1,0,1,0
28,127,127,6,6,0,1,0
5,134,134,8,8,0,1,0
4,137,137,1,1,0,1,0
21,160,160,25,9,16,2,1
36,183,183,51,51,0,1,0
24,197,197,13,13,0,1,0
1,223,223,13,13,0,1,0
34,223,223,19,3,16,2,1
3,231,231,69,29,40,3,2
19,233,233,1,1,0,1,0
38,235,235,48,48,0,1,0
33,266,266,3,3,0,1,0
30,276,276,12,12,0,1,0
2,277,277,18,18,0,1,0
9,282,282,1,1,0,1,0
7,288,288,83,83,0,1,0
41,314,314,85,78,7,2,1
23,315,315,49,49,0,1,0
16,324,324,16,16,0,1,0
13,332,332,133,4,129,4,3
27,342,342,55,55,0,1,0
10,345,345,22,22,0,1,0
22,348,348,11,11,0,1,0
8,350,350,20,11,9,4,3
17,359,359,6,1,5,2,1
14,368,368,61,34,27,4,3
31,369,369,11,3,8,2,1
18,372,372,40,40,0,1,0
37,431,431,6,6,0,1,0
39,452,452,14,5,9,4,3
40,453,453,129,105,24,4,3
6,454,454,13,13,0,1,0
12,457,457,26,26,0,1,0
32,464,464,2,2,0,1,0
29,484,484,12,12,0,1,0
26,486,486,17,17,0,1,0
20,495,495,17,17,0,1,0

16,101,101,28,28,0,1,0
12,119,119,9,9,0,1,0
29,128,128,2,2,0,1,0
30,129,129,15,10,5,2,1
0,155,155,3,3,0,1,0
17,167,167,63,63,0,1,0
26,204,204,60,60,0,1,0
4,205,205,31,31,0,1,0
35,206,206,26,26,0,1,0
18,215,215,13,13,0,1,0
14,217,217,14,4,10,2,1
15,220,220,31,1,30,3,2
3,229,229,10,10,0,1,0
33,250,250,1,1,0,1,0
24,270,270,1,1,0,1,0
21,287,287,29,6,23,2,1
8,301,301,4,4,0,1,0
11,305,305,3,3,0,1,0
7,311,311,3,3,0,1,0
5,312,312,55,6,49,2,1
2,319,319,41,41,0,1,0
25,324,324,64,58,6,3,2
13,339,339,100,51,49,4,3
22,359,359,108,83,25,2,1
6,371,371,57,11,46,3,2
19,373,373,16,4,12,3,2
28,377,377,6,6,0,1,0
23,380,380,21,21,0,1,0
34,391,391,52,52,0,1,0
9,393,393,32,22,10,3,2
10,398,398,128,26,102,4,3
31,407,407,14,4,10,3,2
20,412,412,9,9,0,1,0
27,416,416,40,40,0,1,0
36,416,416,11,3,8,2,1
32,423,423,3,3,0,1,0
1,500,500,20,3,17,2,1

4,119,119,1,1,0,1,0
27,126,126,61,13,48,3,2
11,127,127,2,2,0,1,0
22,134,134,4,4,0,1,0
17,134,134,26,26,0,1,0
7,143,143,1,1,0,1,0
35,155,155,15,15,0,1,0
12,158,158,26,26,0,1,0
3,169,169,2,2,0,1,0
13,171,171,60,60,0,1,0
32,174,174,1,1,0,1,0
14,177,177,33,33,0,1,0
16,186,186,30,9,21,4,3
25,194,194,2,2,0,1,0
31,195,195,56,38,18,4,3
26,198,198,8,8,0,1,0
0,209,209,17,17,0,1,0
21,209,209,5,5,0,1,0
30,210,210,10,10,0,1,0
10,249,249,47,19,28,2,1
2,266,266,23,2,21,2,1
18,266,266,17,17,0,1,0
1,296,296,63,63,0,1,0
28,334,334,14,7,7,2,1
8,338,338,13,7,6,2,1
34,351,351,4,1,3,2,1
5,357,357,18,18,0,1,0
19,398,398,14,14,0,1,0
24,401,401,51,23,28,2,1
20,406,406,4,4,0,1,0
37,421,421,19,19,0,1,0
38,450,450,95,43,52,3,2
6,453,453,35,35,0,1,0
9,460,460,1,1,0,1,0
23,470,470,10,7,3,2,1
36,475,475,11,1,10,3,2
29,478,478,90,27,63,4,3
33,498,498,150,150,0,1,0
15,499,499,50,10,40,3,2

10,105,105,33,27,6,3,2
25,113,113,23,13,10,3,2
28,117,117,2,2,0,1,0
9,131,131,11,11,0,1,0
14,142,142,12,12,0,1,0
1,143,143,32,20,12,4,3
23,155,155,40,13,27,2,1
32,167,167,24,6,18,2,1
0,171,171,36,9,27,2,1
30,171,171,29,1,28,2,1
24,191,191,22,7,15,4,3
15,194,194,17,3,14,3,2
4,202,202,16,2,14,3,2
27,226,226,15,15,0,1,0
3,235,235,11,11,0,1,0
31,250,250,21,21,0,1,0
18,250,250,1,1,0,1,0
7,257,257,29,29,0,1,0
12,268,268,10,10,0,1,0
29,275,275,31,31,0,1,0
11,309,309,83,8,75,4,3
22,338,338,15,1,14,2,1
6,347,347,4,1,3,2,1
5,354,354,84,4,80,4,3
8,367,367,103,50,53,3,2
20,381,381,45,30,15,4,3
17,391,391,27,27,0,1,0
2,398,398,7,2,5,2,1
19,409,409,40,40,0,1,0
21,429,429,114,86,28,2,1
16,459,459,2,2,0,1,0
13,462,462,35,25,10,3,2
33,493,493,5,5,0,1,0
26,496,496,46,16,30,2,1

31,101,101,14,14,0,1,0
35,105,105,3,3,0,1,0
27,141,141,7,7,0,1,0
23,144,144,12,12,0,1,0
20,152,152,2,2,0,1,0
19,171,171,6,6,0,1,0
8,203,203,36,36,0,1,0
32,212,212,60,60,0,1,0
30,212,212,45,37,8,2,1
7,229,229,60,60,0,1,0
9,249,249,6,6,0,1,0
2,269,269,25,10,15,2,1
15,283,283,46,46,0,1,0
14,290,290,2,2,0,1,0
17,297,297,64,32,32,2,1
16,310,310,3,3,0,1,0
26,312,312,66,29,37,4,3
25,328,328,18,18,0,1,0
4,330,330,146,146,0,1,0
28,336,336,6,6,0,1,0
36,338,338,12,12,0,1,0
5,348,348,78,66,12,4,3
34,348,348,6,6,0,1,0
11,356,356,11,7,4,2,1
3,358,358,2,2,0,1,0
6,374,374,5,5,0,1,0
10,379,379,3,3,0,1,0
13,385,385,30,15,15,4,3
38,400,400,215,133,82,3,2
12,405,405,43,43,0,1,0
33,408,408,21,21,0,1,0
0,412,412,29,11,18,4,3
24,418,418,21,21,0,1,0
37,428,428,38,2,36,2,1
29,445,445,26,1,25,2,1
21,467,467,22,22,0,1,0
18,487,487,3,3,0,1,0
22,488,488,15,15,0,1,0
1,492,492,32,32,0,1,0

40,104,104,19,4,15,2,1
5,136,136,1,1,0,1,0
18,138,138,11,11,0,1,0
15,149,149,2,2,0,1,0
32,171,171,29,29,0,1,0
46,189,189,62,62,0,1,0
49,200,200,17,17,0,1,0
28,205,205,17,3,14,3,2
44,223,223,8,8,0,1,0
45,226,226,3,3,0,1,0
3,231,231,29,17,12,2,1
36,233,233,6,6,0,1,0
29,243,243,5,5,0,1,0
34,253,253,34,2,32,4,3
25,255,255,8,8,0,1,0
13,262,262,1,1,0,1,0
10,263,263,7,1,6,3,2
41,264,264,11,11,0,1,0
8,265,265,4,4,0,1,0
39,268,268,31,14,17,2,1
11,292,292,77,77,0,1,0
19,294,294,32,32,0,1,0
22,304,304,14,2,12,3,2
0,308,308,10,10,0,1,0
37,321,321,90,65,25,2,1
42,321,321,29,22,7,2,1
33,323,323,27,5,22,3,2
43,324,324,3,3,0,1,0
30,332,332,2,2,0,1,0
35,336,336,9,9,0,1,0
12,341,341,2,2,0,1,0
21,346,346,90,54,36,3,2
17,359,359,1,1,0,1,0
1,366,366,65,65,0,1,0
9,369,369,12,12,0,1,0
6,377,377,20,20,0,1,0
16,389,389,43,21,22,3,2
20,390,390,6,6,0,1,0
2,396,396,44,31,13,2,1
26,404,404,1,1,0,1,0
4,412,412,27,17,10,2,1
24,436,436,12,12,0,1,0
23,440,440,34,12,22,2,1
31,441,441,19,1,18,4,3
38,459,459,62,62,0,1,0
27,461,461,20,3,17,2,1
48,477,477,80,80,0,1,0
7,481,481,49,49,0,1,0
47,486,486,30,30,0,1,0
14,496,496,28,8,20,3,2

7,105,105,2,2,0,1,0
31,108,108,1,1,0,1,0
35,123,123,3,3,0,1,0
33,125,125,1,1,0,1,0
17,129,129,4,4,0,1,0
32,130,130,6,3,3,2,1
11,131,131,22,22,0,1,0
34,135,135,7,7,0,1,0
26,157,157,2,2,0,1,0
23,159,159,50,26,24,3,2
3,163,163,71,11,60,4,3
25,181,181,15,6,9,2,1
4,195,195,46,46,0,1,0
22,201,201,6,6,0,1,0
16,220,220,26,21,5,2,1
30,233,233,8,8,0,1,0
1,234,234,16,16,0,1,0
6,239,239,16,16,0,1,0
28,241,241,27,27,0,1,0
27,250,250,32,32,0,1,0
29,262,262,2,2,0,1,0
24,265,265,13,13,0,1,0
15,297,297,14,5,9,4,3
21,326,326,104,79,25,2,1
19,330,330,63,63,0,1,0
2,337,337,57,15,42,4,3
12,341,341,34,13,21,2,1
5,344,344,14,14,0,1,0
20,361,361,75,75,0,1,0
9,376,376,30,30,0,1,0
8,383,383,27,15,12,4,3
36,400,400,14,14,0,1,0
13,407,407,14,5,9,2,1
14,417,417,31,22,9,2,1
38,417,417,55,55,0,1,0
10,448,448,70,70,0,1,0
0,450,450,9,9,0,1,0
18,472,472,31,15,16,2,1
37,488,488,129,123,6,3,2

32,109,109,1,1,0,1,0
19,116,116,16,16,0,1,0
9,117,117,2,2,0,1,0
20,124,124,6,6,0,1,0
11,125,125,17,17,0,1,0
13,126,126,16,7,9,4,3
36,128,128,52,52,0,1,0
35,134,134,18,18,0,1,0
23,145,145,1,1,0,1,0
18,146,146,30,30,0,1,0
10,150,150,48,26,22,2,1
0,158,158,10,10,0,1,0
12,174,174,62,9,53,4,3
33,183,183,1,1,0,1,0
29,183,183,21,17,4,2,1
15,187,187,31,1,30,2,1
8,194,194,4,1,3,2,1
31,196,196,4,4,0,1,0
21,201,201,10,5,5,2,1
7,203,203,11,3,8,3,2
2,209,209,7,2,5,2,1
28,257,257,31,31,0,1,0
16,273,273,1,1,0,1,0
17,317,317,25,25,0,1,0
3,339,339,46,7,39,4,3
1,348,348,44,44,0,1,0
34,367,367,13,5,8,3,2
24,374,374,1,1,0,1,0
22,381,381,69,69,0,1,0
14,383,383,1,1,0,1,0
30,401,401,2,2,0,1,0
25,422,422,178,178,0,1,0
5,423,423,14,14,0,1,0
37,434,434,23,23,0,1,0
6,444,444,142,114,28,3,2
27,465,465,34,6,28,3,2
26,488,488,3,3,0,1,0
4,488,488,3,3,0,1,0

35,147,147,11,7,4,2,1
28,147,147,24,24,0,1,0
31,158,158,6,6,0,1,0
38,211,211,18,14,4,2,1
17,211,211,11,11,0,1,0
19,213,213,20,1,19,4,3
10,226,226,9,9,0,1,0
2,231,231,9,9,0,1,0
6,238,238,30,30,0,1,0
29,242,242,21,21,0,1,0
4,246,246,24,24,0,1,0
5,247,247,7,1,6,3,2
27,247,247,37,19,18,3,2
8,247,247,37,37,0,1,0
12,250,250,24,13,11,2,1
26,264,264,32,1,31,2,1
7,266,266,87,87,0,1,0
23,281,281,10,10,0,1,0
21,287,287,34,11,23,4,3
15,295,295,28,2,26,2,1
34,299,299,86,26,60,3,2
39,310,310,8,8,0,1,0
0,316,316,46,28,18,2,1
22,319,319,70,70,0,1,0
16,323,323,1,1,0,1,0
20,331,331,9,9,0,1,0
1,337,337,37,23,14,4,3
13,351,351,9,1,8,3,2
11,364,364,10,10,0,1,0
30,370,370,70,70,0,1,0
33,398,398,28,28,0,1,0
9,405,405,30,30,0,1,0
14,428,428,26,26,0,1,0
36,432,432,2,2,0,1,0
32,452,452,41,41,0,1,0
3,472,472,162,39,123,4,3
18,479,479,33,33,0,1,0
37,480,480,49,23,26,2,1
24,480,480,52,52,0,1,0
25,497,497,18,18,0,1,0

7,107,107,26,26,0,1,0
11,121,121,2,2,0,1,0
33,146,146,11,1,10,2,1
34,148,148,7,7,0,1,0
24,151,151,7,1,6,2,1
28,161,161,4,1,3,2,1
45,168,168,14,10,4,2,1
17,184,184,1,1,0,1,0
36,207,207,65,12,53,3,2
42,209,209,40,4,36,3,2
9,213,213,31,5,26,4,3
26,216,216,49,38,11,2,1
13,220,220,16,3,13,2,1
21,225,225,57,57,0,1,0
2,236,236,18,18,0,1,0
1,239,239,11,1,10,4,3
31,272,272,1,1,0,1,0
3,278,278,11,11,0,1,0
27,280,280,8,4,4,2,1
38,300,300,8,8,0,1,0
10,300,300,34,34,0,1,0
6,308,308,24,4,20,4,3
15,309,309,4,4,0,1,0
43,327,327,8,8,0,1,0
40,327,327,55,3,52,4,3
39,333,333,44,44,0,1,0
25,343,343,11,11,0,1,0
30,348,348,26,26,0,1,0
19,353,353,53,53,0,1,0
23,353,353,22,22,0,1,0
20,370,370,2,2,0,1,0
44,374,374,39,7,32,2,1
0,395,395,45,45,0,1,0
4,414,414,2,2,0,1,0
16,416,416,26,26,0,1,0
35,420,420,62,62,0,1,0
8,425,425,63,63,0,1,0
5,429,429,2,2,0,1,0
22,432,432,31,10,21,2,1
29,434,434,1,1,0,1,0
12,450,450,12,1,11,2,1
41,451,451,12,12,0,1,0
32,458,458,125,11,114,4,3
18,460,460,22,6,16,3,2
14,466,466,57,57,0,1,0
37,485,485,30,6,24,2,1

0,100,100,9,9,0,1,0
11,106,106,11,8,3,2,1
29,108,108,2,2,0,1,0
5,109,109,17,17,0,1,0
3,116,116,2,2,0,1,0
17,141,141,4,4,0,1,0
12,148,148,38,38,0,1,0
10,148,148,7,1,6,3,2
34,185,185,27,12,15,4,3
35,186,186,17,17,0,1,0
26,208,208,32,32,0,1,0
33,213,213,63,63,0,1,0
37,217,217,14,14,0,1,0
28,217,217,13,13,0,1,0
20,220,220,26,26,0,1,0
7,223,223,10,7,3,2,1
2,224,224,28,28,0,1,0
9,236,236,100,9,91,3,2
24,237,237,50,50,0,1,0
22,244,244,9,9,0,1,0
6,255,255,18,10,8,3,2
27,296,296,2,2,0,1,0
31,300,300,13,13,0,1,0
4,305,305,52,41,11,2,1
1,314,314,24,24,0,1,0
36,330,330,64,64,0,1,0
19,334,334,64,60,4,2,1
30,337,337,9,1,8,2,1
18,369,369,27,3,24,3,2
21,374,374,39,10,29,2,1
15,381,381,5,2,3,2,1
25,382,382,16,16,0,1,0
8,383,383,46,30,16,2,1
16,390,390,82,58,24,3,2
14,404,404,8,8,0,1,0
23,417,417,14,6,8,2,1
32,477,477,59,30,29,4,3
13,499,499,14,14,0,1,0

7,117,117,1,1,0,1,0
4,122,122,2,2,0,1,0
28,138,138,6,6,0,1,0
20,169,169,2,2,0,1,0
9,170,170,65,65,0,1,0
26,171,171,4,4,0,1,0
10,182,182,17,17,0,1,0
37,184,184,19,19,0,1,0
2,200,200,30,16,14,4,3
21,206,206,3,3,0,1,0
17,208,208,71,63,8,2,1
35,216,216,14,11,3,2,1
38,224,224,7,1,6,3,2
36,226,226,8,8,0,1,0
6,291,291,55,29,26,3,2
15,305,305,5,5,0,1,0
18,314,314,58,17,41,2,1
31,317,317,101,7,94,3,2
23,324,324,23,11,12,3,2
1,332,332,42,42,0,1,0
25,333,333,45,45,0,1,0
5,340,340,22,22,0,1,0
27,343,343,141,101,40,3,2
3,347,347,1,1,0,1,0
34,354,354,16,16,0,1,0
8,371,371,5,5,0,1,0
16,374,374,8,8,0,1,0
32,401,401,11,2,9,4,3
11,412,412,13,2,11,2,1
14,418,418,37,37,0,1,0
33,422,422,143,143,0,1,0
29,440,440,95,1,94,3,2
22,452,452,21,21,0,1,0
13,466,466,75,57,18,2,1
19,470,470,3,3,0,1,0
12,470,470,13,13,0,1,0
0,481,481,40,21,19,4,3
30,483,483,40,1,39,2,1
24,484,484,5,2,3,2,1

41,109,109,4,4,0,1,0
34,110,110,34,23,11,2,1
39,122,122,1,1,0,1,0
1,123,123,1,1,0,1,0
29,135,135,35,1,34,2,1
40,137,137,2,2,0,1,0
11,153,153,18,12,6,2,1
24,186,186,21,21,0,1,0
9,192,192,5,5,0,1,0
27,194,194,41,41,0,1,0
25,204,204,36,36,0,1,0
23,211,211,25,9,16,2,1
19,225,225,13,13,0,1,0
2,233,233,28,28,0,1,0
18,248,248,3,3,0,1,0
32,258,258,18,7,11,2,1
38,265,265,17,17,0,1,0
6,291,291,24,5,19,2,1
28,297,297,10,2,8,3,2
20,308,308,34,8,26,3,2
15,308,308,56,34,22,2,1
36,342,342,46,9,37,2,1
21,343,343,3,3,0,1,0
7,351,351,32,9,23,2,1
22,372,372,23,13,10,3,2
35,373,373,57,40,17,3,2
8,374,374,29,29,0,1,0
26,378,378,19,13,6,2,1
30,384,384,59,17,42,3,2
3,386,386,5,5,0,1,0
5,400,400,107,87,20,3,2
13,402,402,48,24,24,2,1
12,420,420,57,39,18,4,3
31,420,420,8,8,0,1,0
14,425,425,4,4,0,1,0
17,455,455,3,3,0,1,0
10,470,470,14,8,6,3,2
33,474,474,21,21,0,1,0
16,479,479,128,128,0,1,0
0,481,481,117,59,58,3,2
4,481,481,8,1,7,2,1
37,487,487,11,11,0,1,0

22,102,102,11,2,9,4,3
1,117,117,2,2,0,1,0
14,124,124,18,9,9,2,1
10,145,145,20,20,0,1,0
16,157,157,4,4,0,1,0
36,158,158,35,35,0,1,0
30,167,167,11,11,0,1,0
20,172,172,9,9,0,1,0
28,178,178,6,6,0,1,0
5,222,222,12,12,0,1,0
9,236,236,43,7,36,3,2
31,245,245,30,15,15,4,3
17,249,249,7,7,0,1,0
0,252,252,42,42,0,1,0
24,254,254,32,20,12,4,3
8,265,265,35,23,12,2,1
13,270,270,20,3,17,4,3
4,270,270,11,11,0,1,0
7,276,276,3,3,0,1,0
32,294,294,34,13,21,2,1
23,315,315,22,22,0,1,0
25,318,318,92,43,49,4,3
26,321,321,77,31,46,3,2
2,326,326,14,14,0,1,0
6,327,327,22,2,20,4,3
33,332,332,1,1,0,1,0
37,344,344,57,27,30,2,1
27,348,348,4,4,0,1,0
35,375,375,5,5,0,1,0
34,403,403,7,4,3,2,1
21,405,405,82,77,5,2,1
18,406,406,15,15,0,1,0
15,406,406,208,178,30,4,3
3,414,414,42,2,40,3,2
19,416,416,40,13,27,2,1
11,450,450,65,20,45,4,3
12,470,470,56,56,0,1,0
29,493,493,25,19,6,2,1

25,111,111,21,21,0,1,0
22,112,112,17,17,0,1,0
4,120,120,20,8,12,2,1
20,141,141,23,23,0,1,0
15,150,150,31,22,9,4,3
23,160,160,8,2,6,3,2
18,165,165,3,3,0,1,0
28,169,169,6,6,0,1,0
36,179,179,8,2,6,3,2
33,179,179,12,12,0,1,0
19,179,179,15,15,0,1,0
24,191,191,29,14,15,2,1
2,201,201,5,5,0,1,0
13,218,218,8,8,0,1,0
12,224,224,11,11,0,1,0
6,229,229,34,19,15,2,1
14,231,231,7,7,0,1,0
11,233,233,14,14,0,1,0
17,285,285,5,5,0,1,0
10,290,290,46,12,34,2,1
30,306,306,8,5,3,2,1
27,326,326,7,7,0,1,0
35,333,333,8,8,0,1,0
3,342,342,34,21,13,4,3
21,355,355,6,6,0,1,0
39,361,361,117,15,102,4,3
9,362,362,150,112,38,2,1
26,381,381,86,82,4,2,1
16,391,391,1,1,0,1,0
5,393,393,62,62,0,1,0
38,418,418,72,72,0,1,0
34,426,426,3,3,0,1,0
0,445,445,22,14,8,3,2
37,449,449,50,50,0,1,0
29,467,467,32,32,0,1,0
8,468,468,70,70,0,1,0
32,474,474,60,60,0,1,0
31,476,476,32,8,24,3,2
7,492,492,6,6,0,1,0
1,496,496,59,41,18,4,3

4,100,100,1,1,0,1,0
21,105,105,6,6,0,1,0
34,130,130,1,1,0,1,0
36,134,134,26,26,0,1,0
18,140,140,14,14,0,1,0
24,143,143,19,1,18,2,1
35,163,163,2,2,0,1,0
13,165,165,36,36,0,1,0
33,174,174,11,11,0,1,0
10,183,183,7,7,0,1,0
2,193,193,1,1,0,1,0
1,205,205,5,5,0,1,0
42,211,211,2,2,0,1,0
7,218,218,28,28,0,1,0
20,242,242,49,49,0,1,0
23,252,252,24,24,0,1,0
32,268,268,66,5,61,4,3
27,276,276,6,6,0,1,0
9,280,280,24,13,11,2,1
30,281,281,33,4,29,2,1
37,295,295,7,1,6,2,1
29,314,314,47,47,0,1,0
22,314,314,31,1,30,4,3
28,315,315,112,98,14,3,2
6,318,318,10,10,0,1,0
11,325,325,6,1,5,2,1
15,338,338,9,1,8,2,1
41,357,357,45,5,40,3,2
25,364,364,44,12,32,3,2
45,373,373,86,44,42,4,3
3,384,384,35,35,0,1,0
12,399,399,5,5,0,1,0
43,411,411,11,11,0,1,0
8,421,421,67,13,54,3,2
40,422,422,18,18,0,1,0
14,434,434,21,21,0,1,0
44,438,438,32,32,0,1,0
31,441,441,103,52,51,4,3
39,444,444,29,5,24,3,2
0,453,453,80,14,66,3,2
26,454,454,18,18,0,1,0
19,469,469,25,21,4,2,1
17,485,485,1,1,0,1,0
5,488,488,21,1,20,4,3
38,495,495,4,4,0,1,0
16,496,496,10,4,6,3,2

17,106,106,15,5,10,2,1
7,131,131,4,4,0,1,0
11,132,132,1,1,0,1,0
34,133,133,19,19,0,1,0
39,134,134,4,1,3,2,1
24,151,151,8,1,7,2,1
18,164,164,12,12,0,1,0
2,183,183,29,29,0,1,0
35,196,196,16,16,0,1,0
36,198,198,59,59,0,1,0
38,200,200,2,2,0,1,0
21,206,206,13,7,6,3,2
28,210,210,18,18,0,1,0
13,222,222,4,4,0,1,0
19,237,237,12,12,0,1,0
15,245,245,9,2,7,2,1
12,266,266,43,43,0,1,0
30,278,278,53,5,48,4,3
16,279,279,6,2,4,2,1
4,284,284,17,17,0,1,0
32,284,284,6,6,0,1,0
26,290,290,81,81,0,1,0
33,300,300,38,38,0,1,0
23,307,307,43,19,24,4,3
6,311,311,33,1,32,2,1
14,321,321,44,28,16,2,1
5,337,337,62,62,0,1,0
1,346,346,46,46,0,1,0
27,358,358,1,1,0,1,0
37,384,384,5,1,4,2,1
29,400,400,108,78,30,3,2
8,405,405,38,30,8,2,1
20,410,410,2,2,0,1,0
31,418,418,16,3,13,2,1
3,419,419,42,22,20,2,1
10,447,447,89,89,0,1,0
22,450,450,15,3,12,2,1
40,463,463,31,21,10,3,2
25,472,472,41,41,0,1,0
9,479,479,1,1,0,1,0
0,482,482,136,60,76,4,3

23,101,101,6,6,0,1,0
9,111,111,8,8,0,1,0
5,115,115,33,33,0,1,0
22,136,136,17,1,16,3,2
30,148,148,5,5,0,1,0
13,169,169,7,7,0,1,0
16,171,171,12,12,0,1,0
10,173,173,11,3,8,2,1
25,175,175,38,38,0,1,0
33,195,195,3,3,0,1,0
24,202,202,60,60,0,1,0
27,217,217,1,1,0,1,0
0,220,220,40,25,15,4,3
3,243,243,43,2,41,3,2
28,244,244,42,32,10,3,2
14,259,259,50,22,28,4,3
2,265,265,58,26,32,2,1
6,300,300,40,4,36,2,1
32,324,324,38,38,0,1,0
19,336,336,41,15,26,3,2
1,345,345,169,169,0,1,0
7,350,350,79,4,75,4,3
29,350,350,24,24,0,1,0
4,362,362,12,12,0,1,0
17,368,368,3,3,0,1,0
12,379,379,9,3,6,3,2
20,385,385,43,43,0,1,0
15,401,401,63,42,21,4,3
31,402,402,66,66,0,1,0
8,409,409,8,8,0,1,0
26,451,451,31,15,16,2,1
11,457,457,16,16,0,1,0
18,474,474,2,2,0,1,0
21,490,490,13,13,0,1,0

13,106,106,1,1,0,1,0
24,121,121,21,7,14,3,2
3,142,142,14,14,0,1,0
32,145,145,10,10,0,1,0
17,149,149,13,13,0,1,0
22,172,172,17,9,8,3,2
39,175,175,40,40,0,1,0
12,207,207,64,64,0,1,0
1,214,214,7,7,0,1,0
0,216,216,4,4,0,1,0
7,220,220,6,2,4,2,1
25,237,237,4,1,3,2,1
27,245,245,37,29,8,2,1
11,253,253,41,20,21,3,2
23,254,254,24,24,0,1,0
41,257,257,8,8,0,1,0
2,276,276,17,17,0,1,0
28,290,290,44,6,38,4,3
10,311,311,1,1,0,1,0
30,314,314,95,31,64,4,3
16,318,318,13,13,0,1,0
34,320,320,81,62,19,2,1
15,324,324,30,18,12,2,1
8,332,332,52,16,36,4,3
5,334,334,43,26,17,2,1
4,350,350,19,4,15,2,1
33,358,358,77,5,72,3,2
20,360,360,70,44,26,3,2
36,372,372,23,23,0,1,0
9,381,381,74,74,0,1,0
6,397,397,8,3,5,2,1
40,399,399,2,2,0,1,0
31,407,407,17,7,10,3,2
26,410,410,13,13,0,1,0
35,410,410,5,5,0,1,0
18,413,413,14,14,0,1,0
19,427,427,20,4,16,2,1
29,429,429,11,11,0,1,0
38,437,437,26,26,0,1,0
14,459,459,57,31,26,2,1
21,463,463,48,24,24,2,1
37,470,470,9,9,0,1,0

38,117,117,10,10,0,1,0
25,120,120,3,3,0,1,0
36,122,122,20,20,0,1,0
23,123,123,14,14,0,1,0
47,134,134,22,22,0,1,0
35,136,136,20,3,17,3,2
16,137,137,1,1,0,1,0
7,138,138,2,2,0,1,0
29,143,143,7,7,0,1,0
13,148,148,6,6,0,1,0
28,159,159,14,14,0,1,0
41,170,170,4,4,0,1,0
4,210,210,18,18,0,1,0
20,222,222,89,89,0,1,0
44,226,226,33,33,0,1,0
12,236,236,17,9,8,3,2
17,255,255,6,6,0,1,0
21,260,260,10,10,0,1,0
39,263,263,10,10,0,1,0
46,264,264,6,6,0,1,0
26,267,267,36,36,0,1,0
19,291,291,18,18,0,1,0
32,301,301,5,5,0,1,0
14,305,305,25,13,12,4,3
15,308,308,9,9,0,1,0
11,311,311,44,44,0,1,0
2,314,314,11,11,0,1,0
8,315,315,7,7,0,1,0
0,317,317,36,36,0,1,0
18,318,318,14,2,12,4,3
5,318,318,9,9,0,1,0
31,337,337,55,43,12,2,1
43,338,338,36,12,24,3,2
24,357,357,39,39,0,1,0
30,368,368,27,27,0,1,0
42,390,390,21,9,12,2,1
22,398,398,35,22,13,2,1
33,413,413,47,31,16,3,2
3,416,416,4,4,0,1,0
40,419,419,7,7,0,1,0
6,433,433,27,27,0,1,0
9,437,437,1,1,0,1,0
34,438,438,23,23,0,1,0
27,440,440,23,7,16,2,1
45,452,452,199,187,12,4,3
10,460,460,44,14,30,3,2
1,473,473,32,14,18,4,3
37,489,489,39,16,23,2,1

21,100,100,1,1,0,1,0
27,109,109,18,18,0,1,0
36,116,116,24,6,18,3,2
5,118,118,1,1,0,1,0
16,124,124,20,13,7,2,1
34,127,127,28,28,0,1,0
9,164,164,8,2,6,2,1
2,166,166,3,3,0,1,0
26,171,171,6,1,5,2,1
17,177,177,3,3,0,1,0
0,227,227,164,70,94,3,2
31,233,233,8,8,0,1,0
38,238,238,8,8,0,1,0
33,244,244,8,4,4,2,1
30,248,248,16,9,7,2,1
23,249,249,19,19,0,1,0
20,264,264,14,6,8,3,2
19,288,288,17,9,8,3,2
25,289,289,49,22,27,2,1
1,292,292,45,20,25,2,1
37,298,298,24,24,0,1,0
39,355,355,62,62,0,1,0
28,361,361,23,23,0,1,0
12,372,372,37,28,9,4,3
15,389,389,57,49,8,3,2
7,394,394,17,11,6,2,1
32,409,409,130,25,105,4,3
24,438,438,3,3,0,1,0
10,439,439,33,33,0,1,0
13,452,452,7,7,0,1,0
8,453,453,24,24,0,1,0
29,454,454,119,30,89,4,3
11,459,459,42,42,0,1,0
14,459,459,17,17,0,1,0
6,459,459,10,10,0,1,0
4,463,463,52,28,24,4,3
35,486,486,7,7,0,1,0
18,488,488,16,16,0,1,0
3,493,493,42,30,12,3,2
22,499,499,10,1,9,2,1

33,111,111,9,9,0,1,0
2,117,117,10,4,6,3,2
16,129,129,18,2,16,2,1
38,161,161,19,19,0,1,0
30,165,165,5,5,0,1,0
8,171,171,32,32,0,1,0
17,187,187,13,13,0,1,0
9,193,193,6,6,0,1,0
4,194,194,21,9,12,2,1
31,197,197,1,1,0,1,0
3,215,215,10,4,6,3,2
28,224,224,30,11,19,2,1
18,225,225,67,1,66,3,2
21,232,232,7,2,5,2,1
20,245,245,14,3,11,2,1
32,253,253,3,3,0,1,0
1,267,267,35,3,32,2,1
36,268,268,44,44,0,1,0
7,274,274,41,41,0,1,0
19,279,279,8,8,0,1,0
14,291,291,29,29,0,1,0
39,292,292,19,19,0,1,0
25,302,302,12,12,0,1,0
15,304,304,9,4,5,2,1
23,310,310,54,9,45,4,3
29,316,316,96,30,66,4,3
35,331,331,1,1,0,1,0
11,334,334,10,4,6,2,1
34,342,342,40,15,25,2,1
37,350,350,58,31,27,2,1
24,351,351,35,5,30,4,3
5,355,355,5,5,0,1,0
0,359,359,72,45,27,3,2
40,395,395,25,15,10,2,1
12,415,415,62,62,0,1,0
27,417,417,3,3,0,1,0
10,422,422,60,46,14,3,2
13,445,445,1,1,0,1,0
22,451,451,108,66,42,4,3
6,465,465,1,1,0,1,0
26,467,467,88,20,68,3,2

10,102,102,8,2,6,3,2
29,117,117,4,4,0,1,0
0,140,140,3,3,0,1,0
18,155,155,3,3,0,1,0
34,156,156,23,23,0,1,0
11,158,158,21,8,13,3,2
39,173,173,40,23,17,2,1
27,175,175,45,45,0,1,0
38,177,177,4,1,3,2,1
1,205,205,5,5,0,1,0
20,205,205,27,10,17,2,1
14,222,222,15,8,7,2,1
23,238,238,27,27,0,1,0
2,248,248,12,2,10,3,2
30,250,250,18,18,0,1,0
28,261,261,68,68,0,1,0
32,272,272,50,13,37,2,1
37,279,279,3,3,0,1,0
24,285,285,14,4,10,3,2
41,302,302,47,47,0,1,0
16,310,310,40,40,0,1,0
21,314,314,34,28,6,2,1
7,315,315,17,17,0,1,0
33,328,328,12,12,0,1,0
6,328,328,81,81,0,1,0
13,359,359,21,21,0,1,0
5,362,362,3,3,0,1,0
4,368,368,36,36,0,1,0
31,369,369,14,14,0,1,0
35,388,388,41,41,0,1,0
15,392,392,74,35,39,2,1
17,417,417,109,34,75,3,2
25,420,420,23,23,0,1,0
36,425,425,18,18,0,1,0
42,441,441,53,53,0,1,0
26,444,444,26,26,0,1,0
12,444,444,53,23,30,2,1
3,450,450,3,3,0,1,0
22,466,466,32,32,0,1,0
9,468,468,37,18,19,2,1
19,472,472,19,14,5,2,1
40,489,489,16,4,12,3,2
8,490,490,5,5,0,1,0

16,103,103,1,1,0,1,0
21,120,120,2,2,0,1,0
11,131,131,19,3,16,4,3
28,141,141,14,8,6,2,1
33,142,142,22,22,0,1,0
20,162,162,7,3,4,2,1
26,174,174,26,26,0,1,0
22,174,174,26,26,0,1,0
5,179,179,14,14,0,1,0
25,198,198,30,30,0,1,0
6,205,205,51,51,0,1,0
10,207,207,46,12,34,3,2
4,208,208,68,68,0,1,0
32,221,221,32,8,24,3,2
17,234,234,40,26,14,2,1
18,246,246,2,2,0,1,0
31,253,253,8,4,4,2,1
24,288,288,21,21,0,1,0
30,294,294,6,6,0,1,0
15,301,301,25,25,0,1,0
3,306,306,7,7,0,1,0
7,312,312,1,1,0,1,0
1,317,317,61,61,0,1,0
12,331,331,50,14,36,2,1
36,371,371,28,28,0,1,0
13,372,372,24,24,0,1,0
35,377,377,25,20,5,2,1
9,424,424,55,55,0,1,0
19,430,430,74,20,54,4,3
2,434,434,1,1,0,1,0
14,445,445,102,68,34,3,2
34,445,445,2,2,0,1,0
0,457,457,6,6,0,1,0
29,460,460,213,201,12,4,3
8,475,475,40,40,0,1,0
27,484,484,14,14,0,1,0
23,494,494,14,14,0,1,0

23,104,104,13,4,9,4,3
4,104,104,19,19,0,1,0
29,106,106,4,4,0,1,0
15,115,115,2,2,0,1,0
10,125,125,27,14,13,2,1
28,129,129,19,19,0,1,0
36,130,130,17,3,14,4,3
9,147,147,4,1,3,2,1
12,152,152,8,2,6,2,1
34,154,154,9,6,3,2,1
5,172,172,10,10,0,1,0
3,194,194,7,7,0,1,0
7,210,210,1,1,0,1,0
14,214,214,3,3,0,1,0
17,214,214,1,1,0,1,0
27,218,218,31,4,27,4,3
19,220,220,32,32,0,1,0
2,256,256,19,10,9,4,3
18,327,327,11,11,0,1,0
6,338,338,56,56,0,1,0
26,352,352,100,13,87,4,3
8,353,353,23,23,0,1,0
22,371,371,1,1,0,1,0
31,373,373,63,9,54,4,3
24,409,409,30,30,0,1,0
25,429,429,71,44,27,4,3
16,434,434,64,25,39,2,1
33,437,437,69,61,8,2,1
0,437,437,53,8,45,4,3
21,438,438,27,27,0,1,0
11,441,441,34,4,30,2,1
1,451,451,133,39,94,4,3
13,456,456,204,196,8,3,2
32,460,460,73,7,66,3,2
20,476,476,19,19,0,1,0
30,484,484,13,5,8,2,1
35,487,487,36,10,26,2,1

7,103,103,7,7,0,1,0
4,132,132,7,3,4,2,1
31,134,134,29,1,28,2,1
11,151,151,3,3,0,1,0
0,157,157,45,45,0,1,0
22,158,158,23,23,0,1,0
13,167,167,24,24,0,1,0
26,176,176,8,8,0,1,0
25,197,197,23,5,18,3,2
33,215,215,13,6,7,2,1
6,222,222,1,1,0,1,0
10,223,223,59,59,0,1,0
39,242,242,2,2,0,1,0
37,247,247,27,18,9,4,3
16,254,254,8,3,5,2,1
27,273,273,49,49,0,1,0
32,277,277,56,56,0,1,0
21,293,293,7,7,0,1,0
41,301,301,31,31,0,1,0
1,301,301,45,38,7,2,1
24,307,307,19,1,18,4,3
18,309,309,1,1,0,1,0
8,323,323,1,1,0,1,0
23,331,331,1,1,0,1,0
14,352,352,63,63,0,1,0
34,357,357,12,1,11,2,1
2,357,357,28,13,15,4,3
17,367,367,17,1,16,3,2
5,372,372,52,52,0,1,0
36,375,375,73,10,63,4,3
19,377,377,8,8,0,1,0
29,382,382,67,67,0,1,0
40,415,415,82,76,6,3,2
15,416,416,44,44,0,1,0
28,418,418,32,32,0,1,0
20,430,430,59,19,40,2,1
38,434,434,5,5,0,1,0
35,450,450,24,4,20,3,2
9,468,468,92,92,0,1,0
30,483,483,20,20,0,1,0
3,489,489,11,11,0,1,0
12,493,493,12,12,0,1,0

5,103,103,19,19,0,1,0
8,112,112,53,53,0,1,0
26,127,127,22,18,4,2,1
16,129,129,13,4,9,2,1
25,136,136,20,15,5,2,1
17,154,154,1,1,0,1,0
23,163,163,8,8,0,1,0
18,167,167,37,37,0,1,0
10,193,193,29,29,0,1,0
33,202,202,28,28,0,1,0
6,231,231,22,10,12,4,3
7,240,240,15,2,13,3,2
14,266,266,40,22,18,3,2
3,280,280,4,4,0,1,0
4,316,316,14,14,0,1,0
13,323,323,1,1,0,1,0
21,331,331,3,3,0,1,0
29,332,332,28,28,0,1,0
2,341,341,64,22,42,3,2
9,342,342,1,1,0,1,0
15,342,342,104,69,35,2,1
1,347,347,25,25,0,1,0
27,360,360,57,57,0,1,0
12,373,373,26,26,0,1,0
35,382,382,4,4,0,1,0
20,388,388,59,34,25,2,1
34,392,392,43,17,26,2,1
28,393,393,16,12,4,2,1
32,402,402,13,5,8,2,1
19,404,404,2,2,0,1,0
11,405,405,73,73,0,1,0
0,419,419,3,3,0,1,0
24,421,421,56,44,12,4,3
31,443,443,4,4,0,1,0
22,459,459,166,52,114,4,3
30,481,481,47,17,30,2,1

36,112,112,1,1,0,1,0
1,121,121,3,3,0,1,0
42,123,123,51,13,38,2,1
15,131,131,58,31,27,2,1
43,151,151,4,4,0,1,0
25,176,176,16,16,0,1,0
20,178,178,3,3,0,1,0
9,184,184,2,2,0,1,0
2,197,197,16,16,0,1,0
32,197,197,4,4,0,1,0
28,199,199,31,31,0,1,0
41,201,201,64,56,8,3,2
24,207,207,3,3,0,1,0
11,208,208,19,11,8,2,1
17,224,224,4,4,0,1,0
44,242,242,1,1,0,1,0
18,248,248,11,4,7,2,1
27,279,279,19,19,0,1,0
21,289,289,31,31,0,1,0
0,291,291,2,2,0,1,0
40,292,292,67,67,0,1,0
31,301,301,1,1,0,1,0
7,314,314,10,10,0,1,0
14,329,329,28,28,0,1,0
10,332,332,6,6,0,1,0
6,339,339,66,66,0,1,0
29,341,341,28,6,22,3,2
4,359,359,27,27,0,1,0
12,369,369,34,34,0,1,0
22,389,389,1,1,0,1,0
23,392,392,7,1,6,2,1
30,401,401,15,15,0,1,0
33,403,403,32,32,0,1,0
19,413,413,161,80,81,4,3
16,417,417,70,70,0,1,0
34,425,425,2,2,0,1,0
26,426,426,55,44,11,2,1
8,451,451,5,5,0,1,0
35,453,453,31,31,0,1,0
13,459,459,13,7,6,3,2
39,474,474,4,1,3,2,1
5,480,480,3,3,0,1,0
37,491,491,79,43,36,3,2
3,493,493,12,12,0,1,0
38,496,496,62,62,0,1,0

43,114,114,14,4,10,2,1
9,126,126,14,6,8,2,1
26,126,126,19,5,14,3,2
40,126,126,18,8,10,2,1
31,132,132,2,2,0,1,0
7,138,138,1,1,0,1,0
1,139,139,1,1,0,1,0
3,142,142,18,18,0,1,0
14,154,154,13,5,8,3,2
0,158,158,7,1,6,3,2
22,161,161,10,10,0,1,0
32,162,162,29,29,0,1,0
20,170,170,14,6,8,2,1
8,182,182,39,39,0,1,0
6,184,184,12,12,0,1,0
25,195,195,52,52,0,1,0
21,204,204,36,13,23,4,3
34,209,209,25,25,0,1,0
15,222,222,7,7,0,1,0
10,227,227,1,1,0,1,0
16,250,250,36,24,12,3,2
19,256,256,51,6,45,4,3
33,261,261,1,1,0,1,0
28,279,279,13,3,10,2,1
2,295,295,53,12,41,2,1
39,299,299,10,10,0,1,0
29,309,309,16,16,0,1,0
17,312,312,10,10,0,1,0
23,334,334,21,21,0,1,0
4,362,362,6,6,0,1,0
13,365,365,53,13,40,3,2
30,366,366,2,2,0,1,0
35,409,409,148,141,7,2,1
36,409,409,18,1,17,4,3
18,414,414,3,3,0,1,0
38,417,417,37,37,0,1,0
37,419,419,27,27,0,1,0
27,419,419,4,4,0,1,0
41,420,420,38,9,29,4,3
42,456,456,44,44,0,1,0
24,478,478,71,59,12,4,3
11,479,479,55,5,50,2,1
5,479,479,4,4,0,1,0
12,493,493,37,19,18,3,2

25,100,100,17,17,0,1,0
33,110,110,31,16,15,4,3
22,131,131,9,9,0,1,0
5,134,134,5,1,4,2,1
24,145,145,25,25,0,1,0
37,148,148,13,2,11,3,2
3,166,166,9,2,7,2,1
26,176,176,9,9,0,1,0
32,180,180,4,4,0,1,0
0,181,181,4,4,0,1,0
29,207,207,31,6,25,4,3
13,242,242,45,45,0,1,0
31,250,250,72,72,0,1,0
8,252,252,47,15,32,2,1
35,269,269,35,35,0,1,0
27,275,275,9,1,8,2,1
2,278,278,58,36,22,2,1
4,284,284,1,1,0,1,0
12,294,294,1,1,0,1,0
14,306,306,7,7,0,1,0
7,315,315,27,27,0,1,0
30,339,339,36,36,0,1,0
11,352,352,77,17,60,4,3
16,353,353,20,8,12,2,1
23,381,381,20,8,12,3,2
20,389,389,21,14,7,2,1
18,390,390,35,35,0,1,0
21,393,393,4,1,3,2,1
19,408,408,18,18,0,1,0
6,422,422,56,4,52,3,2
1,425,425,75,49,26,2,1
9,429,429,7,1,6,3,2
17,430,430,16,10,6,2,1
15,448,448,21,9,12,3,2
10,464,464,235,187,48,4,3
34,465,465,7,7,0,1,0
28,467,467,19,19,0,1,0
36,467,467,87,87,0,1,0

22,102,102,16,16,0,1,0
44,106,106,15,3,12,4,3
41,106,106,2,2,0,1,0
7,108,108,2,2,0,1,0
28,112,112,4,4,0,1,0
16,135,135,10,7,3,2,1
18,139,139,9,9,0,1,0
46,146,146,11,2,9,2,1
0,152,152,1,1,0,1,0
40,167,167,39,25,14,2,1
20,200,200,2,2,0,1,0
14,216,216,29,29,0,1,0
29,216,216,33,33,0,1,0
2,237,237,23,3,20,3,2
3,241,241,24,24,0,1,0
34,255,255,13,4,9,4,3
27,258,258,67,37,30,3,2
37,276,276,26,6,20,2,1
21,278,278,4,1,3,2,1
25,280,280,2,2,0,1,0
4,282,282,64,24,40,4,3
19,289,289,4,4,0,1,0
1,290,290,2,2,0,1,0
15,296,296,7,7,0,1,0
17,320,320,39,39,0,1,0
39,324,324,3,3,0,1,0
13,326,326,3,3,0,1,0
11,334,334,6,6,0,1,0
8,343,343,35,35,0,1,0
23,360,360,14,14,0,1,0
26,365,365,21,1,20,3,2
30,374,374,20,20,0,1,0
45,379,379,2,2,0,1,0
9,399,399,18,8,10,3,2
36,402,402,1,1,0,1,0
38,411,411,61,33,28,3,2
10,411,411,3,3,0,1,0
24,426,426,31,31,0,1,0
5,428,428,135,15,120,4,3
31,442,442,45,7,38,2,1
32,455,455,120,92,28,2,1
12,461,461,29,29,0,1,0
6,481,481,94,1,93,4,3
33,488,488,43,17,26,3,2
43,491,491,30,30,0,1,0
42,495,495,117,99,18,4,3
35,496,496,3,3,0,1,0

5,109,109,2,2,0,1,0
37,124,124,8,8,0,1,0
32,136,136,3,3,0,1,0
12,144,144,10,1,9,2,1
0,145,145,27,21,6,3,2
24,151,151,5,5,0,1,0
9,155,155,9,9,0,1,0
21,156,156,26,9,17,2,1
7,171,171,14,10,4,2,1
23,184,184,44,17,27,4,3
28,204,204,69,12,57,4,3
15,215,215,15,5,10,3,2
8,215,215,16,8,8,3,2
4,217,217,2,2,0,1,0
29,252,252,19,14,5,2,1
19,266,266,49,49,0,1,0
26,277,277,21,21,0,1,0
2,287,287,73,73,0,1,0
20,289,289,27,16,11,2,1
36,296,296,5,1,4,2,1
25,301,301,4,1,3,2,1
30,348,348,15,15,0,1,0
1,351,351,123,123,0,1,0
11,354,354,92,40,52,3,2
27,360,360,35,35,0,1,0
16,361,361,50,10,40,4,3
22,364,364,111,29,82,3,2
10,399,399,14,14,0,1,0
33,401,401,45,45,0,1,0
35,408,408,1,1,0,1,0
17,433,433,9,9,0,1,0
31,434,434,59,11,48,4,3
34,439,439,2,2,0,1,0
13,452,452,24,24,0,1,0
6,454,454,27,15,12,3,2
14,462,462,62,22,40,3,2
3,466,466,60,35,25,2,1
18,482,482,11,1,10,2,1

27,141,141,20,10,10,2,1
2,147,147,6,3,3,2,1
16,151,151,14,5,9,4,3
23,164,164,1,1,0,1,0
35,165,165,4,4,0,1,0
19,173,173,7,7,0,1,0
38,175,175,12,12,0,1,0
30,198,198,10,10,0,1,0
22,214,214,24,24,0,1,0
21,228,228,13,13,0,1,0
36,230,230,14,14,0,1,0
15,233,233,7,7,0,1,0
40,254,254,2,2,0,1,0
28,255,255,20,11,9,2,1
9,260,260,28,28,0,1,0
32,267,267,61,61,0,1,0
12,283,283,6,6,0,1,0
34,283,283,3,3,0,1,0
3,285,285,23,4,19,4,3
24,290,290,1,1,0,1,0
11,299,299,21,21,0,1,0
20,302,302,12,1,11,3,2
48,321,321,50,50,0,1,0
17,328,328,7,7,0,1,0
29,330,330,20,14,6,3,2
0,341,341,61,39,22,2,1
10,346,346,21,21,0,1,0
18,350,350,35,35,0,1,0
46,355,355,17,17,0,1,0
7,355,355,24,13,11,2,1
47,366,366,82,30,52,3,2
43,366,366,163,163,0,1,0
6,378,378,34,34,0,1,0
26,386,386,53,34,19,2,1
41,397,397,23,23,0,1,0
5,400,400,8,8,0,1,0
8,414,414,92,48,44,3,2
44,415,415,41,41,0,1,0
13,420,420,28,8,20,3,2
1,424,424,1,1,0,1,0
39,426,426,6,1,5,2,1
25,428,428,12,12,0,1,0
37,443,443,19,19,0,1,0
33,445,445,110,99,11,2,1
14,464,464,11,11,0,1,0
45,469,469,6,3,3,2,1
42,487,487,82,2,80,4,3
4,497,497,31,31,0,1,0
31,497,497,1,1,0,1,0

10,105,105,3,3,0,1,0
29,106,106,7,7,0,1,0
35,120,120,11,6,5,2,1
9,121,121,11,11,0,1,0
14,129,129,1,1,0,1,0
18,151,151,15,4,11,2,1
27,161,161,11,11,0,1,0
5,173,173,35,31,4,2,1
31,181,181,1,1,0,1,0
11,204,204,6,1,5,2,1
24,210,210,14,3,11,4,3
38,216,216,14,14,0,1,0
34,224,224,27,27,0,1,0
13,230,230,20,20,0,1,0
36,257,257,137,123,14,3,2
17,262,262,58,36,22,3,2
22,302,302,13,13,0,1,0
33,304,304,8,8,0,1,0
37,328,328,134,110,24,4,3
2,331,331,59,59,0,1,0
15,355,355,24,15,9,4,3
4,357,357,24,3,21,2,1
30,360,360,2,2,0,1,0
8,366,366,35,11,24,2,1
32,385,385,19,19,0,1,0
7,394,394,28,28,0,1,0
25,399,399,16,6,10,3,2
21,422,422,5,1,4,2,1
0,424,424,5,1,4,2,1
1,428,428,50,50,0,1,0
12,433,433,86,60,26,4,3
26,453,453,42,42,0,1,0
16,459,459,52,36,16,3,2
6,461,461,88,8,80,3,2
23,471,471,105,105,0,1,0
20,479,479,21,14,7,2,1
28,486,486,22,22,0,1,0
19,489,489,15,7,8,3,2
3,499,499,61,61,0,1,0

32,108,108,3,3,0,1,0
14,108,108,10,10,0,1,0
9,110,110,38,38,0,1,0
6,144,144,10,10,0,1,0
3,147,147,25,5,20,2,1
5,149,149,9,9,0,1,0
11,151,151,29,15,14,2,1
28,156,156,3,3,0,1,0
34,169,169,15,15,0,1,0
25,175,175,3,3,0,1,0
0,214,214,17,17,0,1,0
13,222,222,30,30,0,1,0
30,223,223,16,7,9,2,1
17,227,227,53,53,0,1,0
33,235,235,9,9,0,1,0
24,243,243,11,2,9,2,1
8,248,248,32,32,0,1,0
4,250,250,27,18,9,4,3
26,254,254,62,62,0,1,0
7,269,269,49,49,0,1,0
18,274,274,72,42,30,4,3
12,287,287,1,1,0,1,0
15,288,288,40,40,0,1,0
27,315,315,1,1,0,1,0
2,322,322,3,3,0,1,0
10,334,334,29,5,24,4,3
20,335,335,9,9,0,1,0
19,335,335,40,17,23,2,1
22,365,365,17,17,0,1,0
31,393,393,25,21,4,2,1
16,394,394,3,3,0,1,0
1,401,401,136,103,33,4,3
23,413,413,92,83,9,4,3
21,458,458,74,74,0,1,0
29,467,467,100,80,20,3,2

35,100,100,31,31,0,1,0
11,107,107,24,24,0,1,0
10,107,107,14,14,0,1,0
26,120,120,19,19,0,1,0
23,121,121,15,15,0,1,0
25,122,122,7,7,0,1,0
38,131,131,2,2,0,1,0
4,148,148,29,21,8,3,2
8,148,148,1,1,0,1,0
6,172,172,2,2,0,1,0
21,211,211,13,13,0,1,0
40,212,212,3,3,0,1,0
12,217,217,10,2,8,2,1
28,217,217,47,44,3,2,1
3,231,231,23,23,0,1,0
27,234,234,6,6,0,1,0
17,241,241,57,45,12,2,1
22,244,244,8,2,6,3,2
7,248,248,2,2,0,1,0
24,254,254,20,20,0,1,0
37,268,268,3,3,0,1,0
33,269,269,22,22,0,1,0
31,291,291,55,55,0,1,0
13,298,298,3,3,0,1,0
9,301,301,72,72,0,1,0
5,308,308,13,6,7,2,1
34,310,310,52,25,27,4,3
36,317,317,61,21,40,3,2
30,324,324,23,7,16,2,1
15,335,335,5,5,0,1,0
16,335,335,39,39,0,1,0
2,338,338,4,4,0,1,0
29,341,341,21,15,6,2,1
18,387,387,95,8,87,4,3
39,417,417,28,28,0,1,0
1,418,418,44,32,12,3,2
32,429,429,51,21,30,4,3
14,445,445,30,20,10,3,2
0,452,452,26,11,15,4,3
20,453,453,40,16,24,2,1
19,494,494,21,21,0,1,0

20,106,106,5,5,0,1,0
13,123,123,4,4,0,1,0
1,124,124,20,5,15,2,1
27,126,126,15,15,0,1,0
9,142,142,5,5,0,1,0
8,154,154,19,8,11,2,1
17,155,155,2,2,0,1,0
6,160,160,18,6,12,2,1
23,174,174,75,75,0,1,0
7,188,188,18,18,0,1,0
22,196,196,20,8,12,2,1
11,226,226,10,5,5,2,1
12,252,252,34,34,0,1,0
18,269,269,3,3,0,1,0
2,277,277,277,203,74,3,2
4,281,281,66,12,54,3,2
16,283,283,37,19,18,4,3
14,285,285,38,29,9,4,3
26,298,298,23,23,0,1,0
30,310,310,4,4,0,1,0
21,321,321,40,12,28,3,2
29,322,322,11,11,0,1,0
15,416,416,53,29,24,3,2
28,423,423,23,17,6,3,2
31,442,442,75,12,63,4,3
5,443,443,46,6,40,3,2
25,452,452,19,19,0,1,0
19,466,466,78,48,30,4,3
10,474,474,16,16,0,1,0
0,475,475,14,14,0,1,0
3,479,479,14,14,0,1,0
24,487,487,41,41,0,1,0

33,103,103,7,7,0,1,0
26,111,111,13,13,0,1,0
18,132,132,9,9,0,1,0
27,136,136,1,1,0,1,0
29,143,143,29,29,0,1,0
17,149,149,36,36,0,1,0
3,164,164,4,4,0,1,0
20,173,173,1,1,0,1,0
19,188,188,32,32,0,1,0
42,193,193,6,6,0,1,0
41,203,203,16,16,0,1,0
2,204,204,1,1,0,1,0
8,206,206,1,1,0,1,0
5,213,213,6,3,3,2,1
35,230,230,22,16,6,3,2
21,234,234,85,51,34,2,1
4,234,234,7,7,0,1,0
16,238,238,21,21,0,1,0
15,248,248,27,27,0,1,0
22,254,254,16,16,0,1,0
0,258,258,26,26,0,1,0
28,270,270,107,35,72,4,3
1,271,271,13,13,0,1,0
44,273,273,62,62,0,1,0
9,274,274,13,13,0,1,0
45,275,275,13,13,0,1,0
37,307,307,5,5,0,1,0
36,318,318,27,27,0,1,0
30,338,338,20,20,0,1,0
39,346,346,17,17,0,1,0
25,367,367,46,6,40,4,3
11,367,367,55,16,39,4,3
31,374,374,77,77,0,1,0
32,377,377,3,3,0,1,0
34,427,427,56,41,15,2,1
12,434,434,16,16,0,1,0
6,435,435,6,6,0,1,0
38,460,460,45,17,28,3,2
14,467,467,5,2,3,2,1
24,469,469,5,5,0,1,0
7,483,483,5,5,0,1,0
10,484,484,12,12,0,1,0
13,489,489,37,37,0,1,0
43,492,492,34,20,14,2,1
23,494,494,72,38,34,2,1
40,500,500,27,4,23,4,3

6,119,119,13,1,12,2,1
15,120,120,7,7,0,1,0
36,135,135,5,2,3,2,1
17,148,148,19,1,18,2,1
4,152,152,1,1,0,1,0
7,159,159,2,2,0,1,0
38,160,160,10,2,8,2,1
28,161,161,11,3,8,3,2
8,162,162,14,3,11,2,1
26,166,166,17,6,11,2,1
29,169,169,28,6,22,3,2
18,171,171,18,18,0,1,0
31,174,174,10,10,0,1,0
13,177,177,65,65,0,1,0
34,184,184,18,5,13,2,1
24,192,192,12,2,10,3,2
12,221,221,16,4,12,2,1
2,223,223,6,6,0,1,0
16,223,223,16,11,5,2,1
22,232,232,34,10,24,3,2
1,238,238,35,35,0,1,0
14,268,268,37,37,0,1,0
32,282,282,49,23,26,2,1
3,295,295,39,6,33,4,3
40,311,311,30,17,13,2,1
9,314,314,12,2,10,2,1
37,339,339,39,39,0,1,0
20,354,354,5,1,4,2,1
21,356,356,34,7,27,4,3
35,380,380,6,6,0,1,0
19,381,381,8,8,0,1,0
42,385,385,26,14,12,3,2
0,393,393,19,19,0,1,0
39,402,402,141,111,30,4,3
10,412,412,18,18,0,1,0
33,415,415,52,52,0,1,0
5,425,425,35,5,30,3,2
43,429,429,34,3,31,2,1
41,434,434,3,3,0,1,0
11,436,436,18,4,14,3,2
25,473,473,22,22,0,1,0
27,493,493,107,45,62,3,2
30,494,494,47,47,0,1,0
23,495,495,4,4,0,1,0

25,125,125,19,19,0,1,0
13,135,135,10,6,4,2,1
3,147,147,1,1,0,1,0
35,174,174,3,3,0,1,0
29,184,184,2,2,0,1,0
11,189,189,26,26,0,1,0
36,191,191,33,9,24,3,2
14,196,196,34,34,0,1,0
12,213,213,15,15,0,1,0
23,215,215,24,24,0,1,0
19,252,252,4,4,0,1,0
24,253,253,3,3,0,1,0
28,263,263,30,5,25,3,2
4,278,278,55,55,0,1,0
10,286,286,14,4,10,3,2
7,294,294,32,20,12,4,3
20,294,294,25,25,0,1,0
31,303,303,31,31,0,1,0
18,305,305,11,11,0,1,0
26,309,309,67,36,31,3,2
16,316,316,30,30,0,1,0
8,333,333,27,12,15,2,1
30,339,339,33,8,25,4,3
2,349,349,125,112,13,2,1
9,355,355,34,3,31,3,2
6,361,361,9,3,6,2,1
34,369,369,26,26,0,1,0
37,382,382,1,1,0,1,0
1,384,384,98,10,88,4,3
27,396,396,3,3,0,1,0
33,403,403,73,10,63,4,3
22,413,413,38,10,28,4,3
5,413,413,4,4,0,1,0
17,433,433,6,3,3,2,1
32,445,445,147,30,117,4,3
0,448,448,64,20,44,3,2
38,472,472,62,62,0,1,0
21,475,475,50,40,10,2,1
15,498,498,35,35,0,1,0

17,111,111,5,5,0,1,0
16,113,113,1,1,0,1,0
1,191,191,20,6,14,3,2
29,191,191,4,1,3,2,1
20,217,217,12,6,6,3,2
31,218,218,6,6,0,1,0
23,220,220,8,8,0,1,0
15,225,225,85,8,77,3,2
5,226,226,1,1,0,1,0
24,233,233,35,35,0,1,0
14,233,233,22,22,0,1,0
12,234,234,1,1,0,1,0
4,277,277,58,21,37,3,2
9,279,279,62,35,27,3,2
19,285,285,3,3,0,1,0
26,297,297,50,23,27,3,2
11,303,303,13,13,0,1,0
6,325,325,71,32,39,4,3
32,334,334,39,27,12,3,2
8,339,339,13,7,6,2,1
25,341,341,100,88,12,4,3
28,358,358,6,6,0,1,0
27,379,379,33,33,0,1,0
3,380,380,54,6,48,2,1
21,389,389,2,2,0,1,0
30,397,397,17,17,0,1,0
33,397,397,134,29,105,4,3
18,397,397,51,41,10,3,2
7,415,415,53,53,0,1,0
22,436,436,9,9,0,1,0
0,436,436,4,4,0,1,0
2,445,445,124,88,36,4,3
10,470,470,161,81,80,3,2
13,475,475,122,42,80,3,2

28,104,104,11,8,3,2,1
36,109,109,4,4,0,1,0
19,118,118,7,7,0,1,0
37,124,124,24,24,0,1,0
22,137,137,11,3,8,2,1
5,138,138,2,2,0,1,0
24,139,139,4,4,0,1,0
41,143,143,5,5,0,1,0
34,146,146,7,7,0,1,0
30,161,161,23,23,0,1,0
16,167,167,7,7,0,1,0
3,203,203,6,1,5,2,1
2,214,214,40,40,0,1,0
25,255,255,7,7,0,1,0
0,256,256,74,74,0,1,0
4,257,257,3,3,0,1,0
7,258,258,2,2,0,1,0
15,271,271,31,13,18,4,3
27,301,301,69,69,0,1,0
20,301,301,16,12,4,2,1
23,302,302,60,37,23,2,1
35,303,303,15,15,0,1,0
18,314,314,5,5,0,1,0
29,330,330,3,3,0,1,0
31,345,345,10,2,8,2,1
38,351,351,81,57,24,2,1
8,351,351,1,1,0,1,0
11,353,353,29,29,0,1,0
12,369,369,6,3,3,2,1
9,378,378,10,4,6,3,2
6,389,389,127,127,0,1,0
14,416,416,23,23,0,1,0
39,417,417,19,19,0,1,0
21,428,428,51,33,18,3,2
42,439,439,118,48,70,3,2
26,440,440,2,2,0,1,0
17,455,455,91,7,84,4,3
10,456,456,41,32,9,2,1
13,467,467,45,45,0,1,0
40,481,481,39,23,16,3,2
32,484,484,24,6,18,3,2
33,485,485,112,32,80,3,2
1,492,492,40,7,33,2,1

42,102,102,9,9,0,1,0
35,103,103,13,13,0,1,0
34,124,124,2,2,0,1,0
30,131,131,11,11,0,1,0
21,137,137,6,1,5,2,1
43,150,150,7,7,0,1,0
19,153,153,11,11,0,1,0
4,161,161,1,1,0,1,0
11,166,166,21,21,0,1,0
41,166,166,17,7,10,3,2
24,184,184,1,1,0,1,0
6,187,187,1,1,0,1,0
27,189,189,16,2,14,3,2
10,191,191,20,20,0,1,0
26,192,192,4,4,0,1,0
39,193,193,18,11,7,2,1
33,224,224,1,1,0,1,0
12,245,245,7,7,0,1,0
38,254,254,86,31,55,3,2
28,262,262,5,5,0,1,0
31,296,296,33,14,19,3,2
17,302,302,10,10,0,1,0
20,316,316,104,104,0,1,0
14,316,316,111,72,39,4,3
8,319,319,17,5,12,3,2
40,329,329,16,16,0,1,0
0,330,330,17,17,0,1,0
1,339,339,45,45,0,1,0
7,340,340,22,4,18,4,3
44,353,353,124,70,54,3,2
13,362,362,1,1,0,1,0
9,363,363,21,3,18,3,2
3,365,365,23,23,0,1,0
5,390,390,34,34,0,1,0
36,407,407,13,13,0,1,0
18,421,421,11,11,0,1,0
15,425,425,10,2,8,3,2
32,431,431,39,39,0,1,0
37,446,446,80,52,28,2,1
29,454,454,30,16,14,2,1
22,463,463,56,56,0,1,0
23,465,465,9,9,0,1,0
2,474,474,3,3,0,1,0
16,478,478,90,3,87,4,3
25,483,483,71,71,0,1,0

10,104,104,4,4,0,1,0
19,105,105,15,15,0,1,0
27,114,114,13,13,0,1,0
17,119,119,8,8,0,1,0
5,140,140,3,3,0,1,0
28,143,143,1,1,0,1,0
13,144,144,28,1,27,2,1
24,162,162,10,4,6,3,2
6,165,165,23,23,0,1,0
32,167,167,17,5,12,2,1
38,167,167,27,3,24,4,3
11,194,194,16,9,7,2,1
4,214,214,15,15,0,1,0
14,223,223,1,1,0,1,0
2,278,278,25,13,12,3,2
9,315,315,19,13,6,2,1
33,317,317,31,15,16,3,2
23,331,331,17,7,10,2,1
15,351,351,5,5,0,1,0
1,354,354,26,6,20,3,2
34,356,356,41,41,0,1,0
40,356,356,69,69,0,1,0
7,368,368,38,29,9,4,3
29,390,390,45,45,0,1,0
36,391,391,14,14,0,1,0
21,392,392,62,24,38,3,2
8,400,400,7,4,3,2,1
30,407,407,1,1,0,1,0
35,420,420,108,63,45,4,3
22,423,423,28,21,7,2,1
12,438,438,71,23,48,2,1
26,441,441,49,49,0,1,0
20,450,450,28,10,18,4,3
16,450,450,66,66,0,1,0
18,453,453,64,64,0,1,0
39,455,455,9,3,6,2,1
31,473,473,42,42,0,1,0
0,476,476,22,22,0,1,0
37,477,477,55,55,0,1,0
25,480,480,76,44,32,3,2
3,497,497,161,79,82,4,3

9,108,108,1,1,0,1,0
31,124,124,15,6,9,2,1
18,126,126,3,3,0,1,0
7,157,157,2,2,0,1,0
5,172,172,12,4,8,3,2
6,172,172,26,13,13,2,1
36,179,179,1,1,0,1,0
25,195,195,25,7,18,4,3
3,213,213,19,5,14,3,2
21,215,215,33,6,27,3,2
16,222,222,77,77,0,1,0
19,222,222,26,3,23,2,1
24,229,229,3,3,0,1,0
29,229,229,31,31,0,1,0
12,234,234,9,9,0,1,0
28,237,237,7,7,0,1,0
14,256,256,61,40,21,4,3
8,262,262,9,1,8,2,1
23,265,265,15,1,14,3,2
11,269,269,13,7,6,3,2
4,273,273,24,24,0,1,0
30,278,278,1,1,0,1,0
35,304,304,42,42,0,1,0
1,311,311,18,11,7,2,1
40,358,358,11,6,5,2,1
39,365,365,47,6,41,2,1
17,368,368,97,97,0,1,0
26,369,369,45,45,0,1,0
32,392,392,4,4,0,1,0
13,411,411,27,27,0,1,0
22,414,414,52,52,0,1,0
2,432,432,26,2,24,2,1
33,436,436,58,9,49,2,1
27,438,438,29,6,23,4,3
34,439,439,157,157,0,1,0
15,454,454,10,2,8,3,2
20,463,463,18,18,0,1,0
37,481,481,83,41,42,4,3
10,488,488,89,3,86,4,3
0,492,492,21,21,0,1,0
38,495,495,54,8,46,3,2

31,103,103,2,2,0,1,0
26,113,113,2,2,0,1,0
22,115,115,2,2,0,1,0
25,122,122,4,4,0,1,0
27,127,127,1,1,0,1,0
34,131,131,32,3,29,2,1
33,132,132,4,4,0,1,0
3,138,138,1,1,0,1,0
45,145,145,9,9,0,1,0
20,151,151,14,14,0,1,0
18,155,155,2,2,0,1,0
12,167,167,4,4,0,1,0
0,173,173,4,4,0,1,0
19,180,180,16,10,6,2,1
2,183,183,6,6,0,1,0
6,185,185,26,3,23,2,1
4,205,205,15,15,0,1,0
23,210,210,5,2,3,2,1
5,246,246,66,66,0,1,0
24,263,263,3,3,0,1,0
46,278,278,56,29,27,2,1
7,287,287,1,1,0,1,0
1,292,292,41,41,0,1,0
11,295,295,10,10,0,1,0
38,304,304,56,56,0,1,0
41,312,312,11,11,0,1,0
16,330,330,19,11,8,2,1
36,344,344,36,36,0,1,0
29,348,348,60,60,0,1,0
8,350,350,13,7,6,3,2
40,354,354,44,44,0,1,0
35,361,361,49,49,0,1,0
21,369,369,5,1,4,2,1
44,382,382,79,25,54,4,3
39,418,418,54,42,12,2,1
15,439,439,73,7,66,4,3
37,443,443,2,2,0,1,0
17,447,447,34,34,0,1,0
10,450,450,3,3,0,1,0
32,461,461,71,71,0,1,0
30,467,467,25,20,5,2,1
42,473,473,8,8,0,1,0
43,475,475,2,2,0,1,0
14,480,480,14,3,11,3,2
28,482,482,73,13,60,4,3
9,495,495,29,29,0,1,0
13,495,495,256,238,18,3,2

2,103,103,3,3,0,1,0
12,113,113,15,8,7,2,1
9,138,138,6,6,0,1,0
32,146,146,7,7,0,1,0
22,165,165,9,9,0,1,0
0,168,168,14,14,0,1,0
7,180,180,4,4,0,1,0
28,184,184,44,39,5,2,1
15,199,199,92,47,45,4,3
27,214,214,32,13,19,3,2
29,249,249,12,12,0,1,0
20,261,261,61,61,0,1,0
30,269,269,13,1,12,4,3
33,272,272,18,9,9,4,3
36,281,281,8,8,0,1,0
26,292,292,58,52,6,2,1
17,303,303,30,18,12,4,3
38,305,305,26,26,0,1,0
1,325,325,105,63,42,4,3
6,326,326,9,9,0,1,0
14,327,327,41,41,0,1,0
35,337,337,22,22,0,1,0
34,338,338,6,6,0,1,0
8,355,355,14,14,0,1,0
3,358,358,33,33,0,1,0
25,358,358,73,61,12,3,2
4,391,391,41,41,0,1,0
5,403,403,8,8,0,1,0
39,422,422,38,35,3,2,1
13,435,435,4,4,0,1,0
21,435,435,21,21,0,1,0
10,437,437,9,9,0,1,0
16,449,449,30,30,0,1,0
37,451,451,20,20,0,1,0
24,455,455,77,77,0,1,0
18,460,460,7,7,0,1,0
11,476,476,122,46,76,3,2
23,489,489,94,94,0,1,0
31,491,491,3,3,0,1,0
19,499,499,14,14,0,1,0

1,103,103,41,15,26,2,1
9,106,106,18,18,0,1,0
34,108,108,6,6,0,1,0
7,113,113,3,3,0,1,0
32,131,131,11,11,0,1,0
31,136,136,10,10,0,1,0
16,138,138,24,3,21,4,3
24,142,142,19,19,0,1,0
28,156,156,4,4,0,1,0
26,159,159,10,10,0,1,0
6,160,160,12,12,0,1,0
18,184,184,140,92,48,3,2
27,190,190,10,10,0,1,0
19,217,217,36,30,6,2,1
10,220,220,6,3,3,2,1
17,222,222,9,9,0,1,0
21,228,228,15,3,12,2,1
5,232,232,5,5,0,1,0
23,246,246,3,3,0,1,0
2,249,249,9,9,0,1,0
33,255,255,4,4,0,1,0
3,269,269,12,8,4,2,1
29,299,299,6,6,0,1,0
14,306,306,101,21,80,3,2
11,331,331,33,33,0,1,0
8,354,354,39,33,6,3,2
0,360,360,136,16,120,4,3
20,365,365,7,7,0,1,0
22,408,408,25,25,0,1,0
13,430,430,37,24,13,2,1
15,457,457,41,41,0,1,0
12,458,458,19,1,18,4,3
25,467,467,43,3,40,3,2
30,487,487,20,20,0,1,0
4,500,500,79,29,50,3,2

25,101,101,9,1,8,3,2
2,121,121,2,2,0,1,0
1,129,129,20,3,17,2,1
3,137,137,35,19,16,2,1
32,144,144,11,11,0,1,0
12,147,147,1,1,0,1,0
10,161,161,12,12,0,1,0
16,162,162,15,5,10,2,1
4,214,214,19,5,14,2,1
5,221,221,2,2,0,1,0
8,227,227,53,31,22,2,1
26,229,229,23,6,17,2,1
23,232,232,25,6,19,2,1
7,241,241,35,35,0,1,0
37,243,243,13,5,8,2,1
18,247,247,12,12,0,1,0
36,259,259,35,1,34,3,2
33,273,273,10,10,0,1,0
15,275,275,39,39,0,1,0
11,276,276,13,13,0,1,0
22,282,282,33,33,0,1,0
9,301,301,37,37,0,1,0
30,304,304,10,10,0,1,0
14,316,316,40,40,0,1,0
0,318,318,30,5,25,2,1
34,323,323,22,22,0,1,0
6,330,330,13,7,6,3,2
35,335,335,36,36,0,1,0
24,341,341,21,2,19,3,2
21,347,347,26,6,20,3,2
20,350,350,108,108,0,1,0
17,350,350,45,45,0,1,0
19,399,399,4,4,0,1,0
28,428,428,41,41,0,1,0
31,441,441,24,24,0,1,0
29,447,447,41,41,0,1,0
13,451,451,101,101,0,1,0
27,475,475,172,172,0,1,0

20,108,108,6,6,0,1,0
32,127,127,12,12,0,1,0
33,155,155,38,12,26,3,2
24,163,163,38,1,37,2,1
6,164,164,35,21,14,2,1
37,164,164,1,1,0,1,0
7,166,166,27,27,0,1,0
22,170,170,1,1,0,1,0
18,182,182,2,2,0,1,0
8,187,187,16,16,0,1,0
34,195,195,57,15,42,2,1
11,195,195,47,47,0,1,0
26,213,213,1,1,0,1,0
3,214,214,43,31,12,4,3
38,221,221,35,5,30,4,3
12,223,223,4,4,0,1,0
0,264,264,6,6,0,1,0
16,296,296,24,5,19,2,1
17,301,301,20,20,0,1,0
2,304,304,68,68,0,1,0
13,305,305,1,1,0,1,0
31,315,315,11,11,0,1,0
10,347,347,139,121,18,4,3
25,348,348,17,17,0,1,0
36,351,351,1,1,0,1,0
29,375,375,2,2,0,1,0
14,383,383,4,4,0,1,0
9,395,395,20,14,6,3,2
23,399,399,13,7,6,2,1
27,405,405,150,102,48,3,2
35,406,406,21,21,0,1,0
4,409,409,10,10,0,1,0
19,423,423,18,4,14,3,2
28,429,429,31,9,22,2,1
1,448,448,18,18,0,1,0
5,456,456,5,5,0,1,0
21,460,460,112,87,25,2,1
15,462,462,63,18,45,4,3
30,474,474,24,9,15,4,3

25,114,114,5,5,0,1,0
19,118,118,6,2,4,2,1
5,128,128,15,15,0,1,0
17,149,149,4,4,0,1,0
36,150,150,1,1,0,1,0
16,194,194,49,49,0,1,0
10,197,197,2,2,0,1,0
7,199,199,39,3,36,3,2
21,200,200,1,1,0,1,0
14,205,205,11,11,0,1,0
18,214,214,28,28,0,1,0
9,231,231,7,2,5,2,1
45,231,231,17,2,15,4,3
35,240,240,26,26,0,1,0
42,241,241,29,1,28,2,1
4,242,242,12,12,0,1,0
37,248,248,7,7,0,1,0
15,251,251,47,2,45,4,3
34,259,259,39,24,15,2,1
3,266,266,10,10,0,1,0
31,273,273,2,2,0,1,0
33,283,283,3,3,0,1,0
2,284,284,1,1,0,1,0
47,285,285,157,25,132,4,3
11,287,287,28,28,0,1,0
23,296,296,5,1,4,2,1
1,301,301,28,15,13,2,1
13,316,316,6,6,0,1,0
41,327,327,47,47,0,1,0
29,332,332,12,12,0,1,0
27,337,337,18,18,0,1,0
38,340,340,6,1,5,2,1
6,358,358,23,23,0,1,0
24,370,370,47,30,17,2,1
22,389,389,11,11,0,1,0
43,392,392,98,65,33,4,3
32,404,404,3,3,0,1,0
26,405,405,11,11,0,1,0
28,406,406,48,48,0,1,0
46,418,418,56,56,0,1,0
8,435,435,1,1,0,1,0
44,439,439,44,35,9,4,3
30,467,467,34,34,0,1,0
12,476,476,19,19,0,1,0
0,486,486,108,28,80,3,2
20,487,487,7,2,5,2,1
39,489,489,9,9,0,1,0
40,500,500,37,37,0,1,0

40,106,106,8,3,5,2,1
32,110,110,2,2,0,1,0
21,112,112,9,2,7,2,1
36,120,120,6,6,0,1,0
5,126,126,3,3,0,1,0
30,128,128,2,2,0,1,0
35,129,129,20,20,0,1,0
45,146,146,5,5,0,1,0
13,149,149,30,30,0,1,0
23,156,156,3,3,0,1,0
26,170,170,4,4,0,1,0
33,171,171,19,9,10,2,1
4,171,171,1,1,0,1,0
18,174,174,1,1,0,1,0
12,182,182,5,5,0,1,0
11,183,183,3,3,0,1,0
15,193,193,9,6,3,2,1
38,195,195,33,1,32,3,2
7,198,198,13,1,12,3,2
1,225,225,43,15,28,4,3
27,250,250,99,3,96,4,3
48,255,255,41,8,33,4,3
46,256,256,41,15,26,2,1
28,256,256,46,46,0,1,0
0,267,267,24,24,0,1,0
16,270,270,3,3,0,1,0
6,279,279,12,4,8,2,1
49,282,282,48,4,44,3,2
8,289,289,2,2,0,1,0
37,296,296,1,1,0,1,0
24,297,297,13,3,10,3,2
3,300,300,10,10,0,1,0
9,303,303,18,18,0,1,0
41,321,321,17,17,0,1,0
29,321,321,1,1,0,1,0
25,381,381,56,17,39,4,3
2,386,386,5,2,3,2,1
22,399,399,9,1,8,3,2
10,404,404,1,1,0,1,0
44,415,415,213,207,6,3,2
47,420,420,20,2,18,3,2
19,430,430,46,46,0,1,0
31,437,437,97,52,45,3,2
42,447,447,1,1,0,1,0
14,449,449,24,24,0,1,0
20,456,456,10,10,0,1,0
39,461,461,24,8,16,2,1
43,471,471,5,2,3,2,1
17,486,486,30,30,0,1,0
34,487,487,5,5,0,1,0

28,102,102,10,10,0,1,0
14,119,119,1,1,0,1,0
22,119,119,4,4,0,1,0
35,124,124,13,13,0,1,0
25,127,127,1,1,0,1,0
47,144,144,35,12,23,2,1
26,147,147,25,10,15,2,1
13,148,148,21,17,4,2,1
20,157,157,49,49,0,1,0
7,165,165,1,1,0,1,0
24,165,165,1,1,0,1,0
5,185,185,1,1,0,1,0
48,200,200,50,27,23,2,1
19,203,203,5,5,0,1,0
29,218,218,3,3,0,1,0
40,226,226,3,3,0,1,0
44,238,238,3,3,0,1,0
36,239,239,29,29,0,1,0
15,240,240,18,18,0,1,0
41,241,241,15,12,3,2,1
9,245,245,37,19,18,3,2
46,249,249,30,30,0,1,0
34,268,268,23,5,18,2,1
27,278,278,6,6,0,1,0
12,286,286,34,8,26,3,2
3,290,290,1,1,0,1,0
33,292,292,2,2,0,1,0
11,293,293,24,3,21,2,1
16,300,300,9,3,6,3,2
30,305,305,18,18,0,1,0
10,318,318,30,30,0,1,0
2,324,324,33,15,18,4,3
21,325,325,7,3,4,2,1
4,346,346,34,34,0,1,0
31,349,349,88,43,45,4,3
6,373,373,1,1,0,1,0
17,385,385,47,10,37,2,1
23,386,386,9,9,0,1,0
42,386,386,85,85,0,1,0
37,409,409,70,39,31,2,1
38,430,430,16,16,0,1,0
32,434,434,68,68,0,1,0
45,435,435,1,1,0,1,0
39,462,462,25,25,0,1,0
8,475,475,4,4,0,1,0
1,477,477,12,12,0,1,0
18,484,484,90,90,0,1,0
0,485,485,14,14,0,1,0
43,498,498,23,6,17,2,1

12,104,104,2,2,0,1,0
25,113,113,6,2,4,2,1
36,150,150,14,14,0,1,0
10,162,162,3,3,0,1,0
31,162,162,2,2,0,1,0
26,163,163,6,6,0,1,0
24,193,193,9,4,5,2,1
18,199,199,32,32,0,1,0
6,199,199,66,38,28,2,1
4,205,205,5,5,0,1,0
23,231,231,7,7,0,1,0
2,242,242,10,7,3,2,1
5,248,248,2,2,0,1,0
3,261,261,1,1,0,1,0
41,267,267,15,15,0,1,0
16,282,282,1,1,0,1,0
33,304,304,23,5,18,4,3
30,306,306,48,48,0,1,0
8,320,320,6,6,0,1,0
17,334,334,25,25,0,1,0
27,336,336,10,10,0,1,0
0,337,337,47,39,8,2,1
29,341,341,214,192,22,2,1
9,342,342,35,32,3,2,1
15,349,349,9,9,0,1,0
11,350,350,21,21,0,1,0
22,351,351,25,15,10,3,2
28,354,354,15,5,10,2,1
40,370,370,47,47,0,1,0
34,380,380,106,34,72,4,3
20,386,386,8,2,6,2,1
35,386,386,29,29,0,1,0
13,389,389,140,140,0,1,0
42,392,392,14,1,13,2,1
1,398,398,21,21,0,1,0
37,401,401,53,53,0,1,0
32,416,416,1,1,0,1,0
39,434,434,49,1,48,4,3
19,450,450,50,50,0,1,0
21,464,464,84,15,69,4,3
14,484,484,22,7,15,2,1
7,486,486,61,43,18,3,2
38,496,496,6,6,0,1,0

25,129,129,8,8,0,1,0
16,146,146,40,40,0,1,0
23,148,148,1,1,0,1,0
14,151,151,14,14,0,1,0
9,159,159,4,4,0,1,0
2,161,161,20,8,12,2,1
17,161,161,6,6,0,1,0
34,182,182,14,14,0,1,0
8,197,197,1,1,0,1,0
26,212,212,25,25,0,1,0
32,228,228,4,4,0,1,0
11,231,231,1,1,0,1,0
30,256,256,12,2,10,3,2
1,270,270,1,1,0,1,0
33,306,306,77,77,0,1,0
3,309,309,246,148,98,3,2
13,321,321,5,5,0,1,0
20,337,337,8,8,0,1,0
5,339,339,48,48,0,1,0
7,353,353,68,68,0,1,0
12,380,380,16,16,0,1,0
31,380,380,31,3,28,2,1
29,392,392,6,2,4,2,1
22,392,392,21,13,8,2,1
0,393,393,69,60,9,4,3
35,397,397,84,9,75,4,3
28,417,417,41,7,34,2,1
15,419,419,127,64,63,4,3
18,423,423,36,36,0,1,0
19,439,439,66,66,0,1,0
21,444,444,70,70,0,1,0
4,458,458,21,21,0,1,0
24,460,460,89,89,0,1,0
6,467,467,5,5,0,1,0
27,469,469,35,27,8,2,1
10,498,498,11,3,8,3,2

5,119,119,11,11,0,1,0
37,127,127,6,3,3,2,1
39,140,140,6,6,0,1,0
36,149,149,50,3,47,2,1
38,153,153,49,17,32,2,1
31,161,161,2,2,0,1,0
18,166,166,7,7,0,1,0
4,173,173,15,1,14,2,1
10,178,178,3,3,0,1,0
34,179,179,6,2,4,2,1
13,184,184,2,2,0,1,0
29,198,198,49,49,0,1,0
7,224,224,21,6,15,4,3
2,231,231,71,50,21,4,3
23,243,243,22,2,20,3,2
6,266,266,18,7,11,2,1
16,284,284,27,27,0,1,0
1,287,287,34,28,6,3,2
19,292,292,24,24,0,1,0
27,293,293,4,4,0,1,0
14,304,304,37,37,0,1,0
35,317,317,2,2,0,1,0
15,323,323,6,6,0,1,0
3,327,327,13,6,7,2,1
28,335,335,6,6,0,1,0
0,342,342,1,1,0,1,0
30,343,343,8,4,4,2,1
32,354,354,54,54,0,1,0
26,364,364,19,7,12,2,1
8,368,368,47,41,6,2,1
9,377,377,8,8,0,1,0
12,378,378,234,164,70,3,2
21,411,411,36,36,0,1,0
11,411,411,13,13,0,1,0
22,440,440,91,23,68,3,2
25,446,446,8,8,0,1,0
33,448,448,75,45,30,2,1
20,463,463,11,1,10,3,2
24,489,489,73,5,68,3,2
17,494,494,3,3,0,1,0

37,107,107,18,14,4,2,1
7,118,118,23,13,10,2,1
16,121,121,2,2,0,1,0
10,127,127,7,7,0,1,0
35,135,135,35,20,15,2,1
14,136,136,1,1,0,1,0
21,137,137,3,3,0,1,0
26,140,140,17,5,12,3,2
20,143,143,18,18,0,1,0
19,153,153,21,12,9,4,3
2,157,157,2,2,0,1,0
8,159,159,27,8,19,3,2
44,161,161,43,43,0,1,0
6,169,169,26,10,16,2,1
45,174,174,14,2,12,4,3
30,175,175,18,18,0,1,0
15,212,212,4,4,0,1,0
29,212,212,27,27,0,1,0
38,218,218,24,24,0,1,0
17,218,218,18,18,0,1,0
11,227,227,5,5,0,1,0
0,232,232,3,3,0,1,0
42,239,239,25,5,20,2,1
31,262,262,50,33,17,2,1
36,264,264,28,19,9,4,3
9,268,268,4,4,0,1,0
34,273,273,4,1,3,2,1
1,274,274,27,27,0,1,0
40,275,275,6,1,5,2,1
5,287,287,4,4,0,1,0
23,289,289,1,1,0,1,0
24,294,294,15,5,10,2,1
22,295,295,19,10,9,2,1
41,296,296,15,6,9,4,3
4,334,334,13,13,0,1,0
28,343,343,10,10,0,1,0
39,403,403,2,2,0,1,0
13,409,409,38,38,0,1,0
3,423,423,53,16,37,2,1
32,425,425,16,8,8,2,1
46,438,438,17,9,8,2,1
27,449,449,26,8,18,4,3
43,455,455,13,13,0,1,0
33,456,456,108,108,0,1,0
18,463,463,28,2,26,2,1
12,486,486,130,130,0,1,0
25,497,497,9,9,0,1,0

9,115,115,18,6,12,4,3
21,125,125,7,2,5,2,1
31,129,129,28,28,0,1,0
29,130,130,11,11,0,1,0
3,131,131,4,4,0,1,0
22,136,136,5,5,0,1,0
6,147,147,8,8,0,1,0
27,196,196,35,35,0,1,0
18,198,198,24,24,0,1,0
28,212,212,28,28,0,1,0
13,232,232,3,3,0,1,0
1,233,233,6,3,3,2,1
33,250,250,58,58,0,1,0
8,254,254,8,1,7,2,1
11,291,291,25,15,10,3,2
4,294,294,14,2,12,3,2
34,309,309,29,5,24,2,1
30,318,318,21,21,0,1,0
32,318,318,14,4,10,2,1
26,327,327,52,52,0,1,0
36,331,331,4,1,3,2,1
7,342,342,7,3,4,2,1
25,345,345,16,12,4,2,1
5,359,359,91,77,14,3,2
19,361,361,45,45,0,1,0
17,362,362,78,50,28,3,2
12,362,362,37,37,0,1,0
38,387,387,6,6,0,1,0
14,402,402,125,125,0,1,0
16,410,410,87,48,39,4,3
20,424,424,51,51,0,1,0
0,441,441,59,59,0,1,0
37,445,445,6,6,0,1,0
24,446,446,24,24,0,1,0
2,451,451,2,2,0,1,0
10,467,467,29,1,28,4,3
23,469,469,58,28,30,4,3
35,478,478,107,107,0,1,0
15,483,483,58,58,0,1,0

2,104,104,2,2,0,1,0
24,109,109,1,1,0,1,0
29,113,113,5,5,0,1,0
36,123,123,6,6,0,1,0
9,149,149,6,6,0,1,0
38,150,150,42,42,0,1,0
14,154,154,21,21,0,1,0
41,162,162,49,49,0,1,0
30,162,162,20,16,4,2,1
28,165,165,25,4,21,4,3
39,179,179,12,12,0,1,0
31,186,186,45,45,0,1,0
15,192,192,14,3,11,2,1
26,194,194,7,7,0,1,0
27,214,214,23,10,13,2,1
6,221,221,11,11,0,1,0
17,233,233,10,10,0,1,0
37,236,236,11,3,8,3,2
18,242,242,42,42,0,1,0
42,245,245,24,17,7,2,1
8,262,262,1,1,0,1,0
7,274,274,6,6,0,1,0
32,275,275,6,6,0,1,0
33,277,277,37,19,18,4,3
4,282,282,52,22,30,4,3
21,295,295,29,11,18,4,3
20,295,295,10,1,9,2,1
11,299,299,9,9,0,1,0
34,312,312,1,1,0,1,0
1,319,319,37,11,26,3,2
13,327,327,25,25,0,1,0
19,333,333,29,29,0,1,0
5,345,345,53,5,48,3,2
25,347,347,22,3,19,2,1
0,352,352,21,7,14,3,2
40,376,376,42,42,0,1,0
10,411,411,13,13,0,1,0
35,419,419,40,29,11,2,1
3,425,425,112,112,0,1,0
22,428,428,19,1,18,4,3
16,437,437,69,33,36,2,1
23,440,440,33,21,12,4,3
12,492,492,51,35,16,3,2

23,117,117,5,1,4,2,1
40,125,125,11,1,10,3,2
41,136,136,6,1,5,2,1
44,146,146,19,19,0,1,0
3,173,173,24,24,0,1,0
4,178,178,5,5,0,1,0
34,188,188,19,19,0,1,0
39,192,192,11,11,0,1,0
24,196,196,1,1,0,1,0
0,219,219,29,29,0,1,0
19,221,221,6,3,3,2,1
7,223,223,26,8,18,3,2
37,227,227,42,42,0,1,0
5,233,233,3,3,0,1,0
33,261,261,37,13,24,4,3
6,266,266,45,45,0,1,0
2,279,279,13,13,0,1,0
14,279,279,8,8,0,1,0
25,296,296,43,9,34,3,2
15,301,301,30,30,0,1,0
32,306,306,3,3,0,1,0
10,312,312,13,13,0,1,0
11,312,312,7,7,0,1,0
36,321,321,31,1,30,4,3
9,323,323,9,1,8,3,2
8,338,338,32,32,0,1,0
20,349,349,89,89,0,1,0
38,361,361,11,11,0,1,0
28,368,368,52,10,42,3,2
16,368,368,29,29,0,1,0
12,370,370,89,89,0,1,0
17,391,391,3,3,0,1,0
27,392,392,7,7,0,1,0
13,395,395,51,51,0,1,0
18,407,407,9,9,0,1,0
42,412,412,4,4,0,1,0
30,422,422,108,27,81,4,3
31,437,437,20,20,0,1,0
1,438,438,18,18,0,1,0
29,442,442,37,4,33,4,3
43,443,443,38,30,8,2,1
22,443,443,1,1,0,1,0
21,451,451,86,78,8,2,1
26,456,456,72,72,0,1,0
35,457,457,96,81,15,4,3

39,117,117,11,3,8,3,2
31,125,125,5,2,3,2,1
10,140,140,2,2,0,1,0
33,147,147,10,5,5,2,1
25,157,157,43,19,24,4,3
12,159,159,54,54,0,1,0
38,171,171,1,1,0,1,0
40,184,184,27,23,4,2,1
42,201,201,4,1,3,2,1
11,204,204,26,8,18,2,1
24,216,216,60,60,0,1,0
21,221,221,18,18,0,1,0
2,225,225,1,1,0,1,0
5,226,226,30,12,18,3,2
30,255,255,3,3,0,1,0
8,257,257,53,53,0,1,0
4,286,286,47,22,25,2,1
35,290,290,7,4,3,2,1
9,290,290,20,2,18,4,3
27,292,292,35,10,25,2,1
20,296,296,24,24,0,1,0
32,315,315,85,15,70,3,2
28,315,315,53,53,0,1,0
16,316,316,29,29,0,1,0
1,318,318,34,34,0,1,0
34,322,322,83,48,35,2,1
22,336,336,5,5,0,1,0
29,341,341,20,20,0,1,0
3,343,343,8,8,0,1,0
0,347,347,15,5,10,3,2
26,357,357,3,3,0,1,0
19,357,357,13,10,3,2,1
18,364,364,82,26,56,3,2
7,367,367,19,3,16,3,2
36,389,389,6,6,0,1,0
13,402,402,27,12,15,2,1
6,411,411,17,17,0,1,0
17,425,425,9,4,5,2,1
15,430,430,8,8,0,1,0
14,449,449,17,10,7,2,1
37,491,491,9,9,0,1,0
23,495,495,16,2,14,3,2
41,496,496,66,16,50,3,2

12,104,104,3,3,0,1,0
35,153,153,4,4,0,1,0
20,180,180,26,26,0,1,0
33,184,184,2,2,0,1,0
22,185,185,9,1,8,2,1
6,195,195,39,39,0,1,0
29,232,232,40,40,0,1,0
26,257,257,34,34,0,1,0
27,261,261,2,2,0,1,0
19,265,265,20,20,0,1,0
25,273,273,70,26,44,2,1
3,292,292,21,7,14,2,1
24,295,295,9,9,0,1,0
8,298,298,7,7,0,1,0
9,299,299,20,2,18,3,2
31,304,304,19,12,7,2,1
14,305,305,104,68,36,4,3
17,315,315,2,2,0,1,0
28,320,320,4,1,3,2,1
10,351,351,16,6,10,3,2
5,352,352,17,11,6,2,1
34,357,357,10,7,3,2,1
4,366,366,34,34,0,1,0
23,371,371,108,73,35,2,1
2,377,377,17,17,0,1,0
15,386,386,67,3,64,3,2
0,389,389,107,23,84,4,3
13,405,405,132,132,0,1,0
11,414,414,5,2,3,2,1
32,422,422,25,14,11,2,1
18,480,480,175,175,0,1,0
16,491,491,35,29,6,2,1
1,496,496,69,69,0,1,0
21,497,497,101,41,60,4,3
7,498,498,55,55,0,1,0
30,499,499,19,19,0,1,0

12,127,127,14,4,10,3,2
17,149,149,12,2,10,2,1
22,152,152,3,3,0,1,0
5,174,174,3,3,0,1,0
13,174,174,26,26,0,1,0
0,175,175,33,15,18,3,2
37,177,177,1,1,0,1,0
4,180,180,1,1,0,1,0
35,188,188,4,1,3,2,1
33,192,192,11,11,0,1,0
32,218,218,21,21,0,1,0
7,222,222,6,6,0,1,0
28,234,234,51,51,0,1,0
8,242,242,39,39,0,1,0
2,244,244,1,1,0,1,0
40,246,246,33,2,31,2,1
15,273,273,33,16,17,2,1
41,279,279,28,21,7,2,1
9,282,282,53,15,38,3,2
19,282,282,16,9,7,2,1
25,295,295,20,20,0,1,0
18,303,303,30,9,21,2,1
24,327,327,59,59,0,1,0
14,331,331,41,41,0,1,0
43,333,333,8,8,0,1,0
23,342,342,9,3,6,2,1
39,349,349,139,139,0,1,0
16,363,363,10,10,0,1,0
10,366,366,36,36,0,1,0
29,394,394,15,4,11,2,1
38,404,404,38,17,21,4,3
3,408,408,26,14,12,4,3
11,420,420,46,31,15,4,3
27,420,420,27,27,0,1,0
36,435,435,77,35,42,3,2
26,451,451,44,20,24,3,2
42,451,451,4,4,0,1,0
34,460,460,78,78,0,1,0
6,475,475,31,31,0,1,0
21,475,475,16,16,0,1,0
30,478,478,1,1,0,1,0
20,480,480,65,1,64,3,2
1,488,488,44,44,0,1,0
31,497,497,40,40,0,1,0

22,112,112,4,4,0,1,0
13,113,113,5,2,3,2,1
1,116,116,21,2,19,2,1
25,131,131,19,1,18,4,3
30,132,132,17,17,0,1,0
10,134,134,10,10,0,1,0
24,135,135,2,2,0,1,0
21,135,135,26,18,8,3,2
11,160,160,25,1,24,4,3
2,161,161,26,26,0,1,0
40,171,171,31,31,0,1,0
37,212,212,55,55,0,1,0
35,242,242,39,19,20,2,1
28,243,243,1,1,0,1,0
17,256,256,31,31,0,1,0
18,256,256,16,13,3,2,1
3,260,260,1,1,0,1,0
39,269,269,13,13,0,1,0
0,273,273,12,12,0,1,0
34,274,274,71,71,0,1,0
19,280,280,13,13,0,1,0
16,282,282,5,5,0,1,0
41,283,283,9,9,0,1,0
36,304,304,24,8,16,3,2
32,307,307,63,63,0,1,0
6,340,340,33,33,0,1,0
23,342,342,9,9,0,1,0
7,368,368,24,15,9,2,1
4,372,372,36,21,15,4,3
15,390,390,35,35,0,1,0
8,393,393,46,43,3,2,1
26,396,396,4,4,0,1,0
31,405,405,40,18,22,3,2
14,415,415,41,25,16,3,2
20,417,417,9,9,0,1,0
5,424,424,45,12,33,4,3
33,425,425,13,13,0,1,0
29,442,442,12,1,11,2,1
12,456,456,17,1,16,2,1
27,458,458,58,58,0,1,0
38,472,472,80,34,46,3,2
9,489,489,81,40,41,2,1

33,101,101,12,12,0,1,0
32,109,109,9,9,0,1,0
7,115,115,18,18,0,1,0
3,124,124,8,1,7,2,1
6,159,159,5,5,0,1,0
14,163,163,20,10,10,3,2
13,174,174,19,19,0,1,0
8,179,179,1,1,0,1,0
18,184,184,6,6,0,1,0
15,202,202,2,2,0,1,0
28,226,226,9,9,0,1,0
9,233,233,57,57,0,1,0
22,233,233,22,22,0,1,0
37,240,240,29,29,0,1,0
29,245,245,23,6,17,2,1
39,247,247,17,8,9,2,1
38,275,275,33,3,30,2,1
25,300,300,56,56,0,1,0
23,324,324,14,2,12,4,3
36,339,339,93,93,0,1,0
2,347,347,79,79,0,1,0
11,354,354,8,8,0,1,0
21,355,355,14,14,0,1,0
19,361,361,15,15,0,1,0
27,375,375,85,19,66,4,3
5,399,399,5,1,4,2,1
20,411,411,34,12,22,2,1
40,423,423,87,87,0,1,0
4,423,423,29,19,10,2,1
16,444,444,1,1,0,1,0
0,446,446,43,14,29,2,1
24,447,447,34,4,30,4,3
31,452,452,5,5,0,1,0
34,459,459,32,7,25,4,3
41,473,473,19,19,0,1,0
12,474,474,57,44,13,2,1
30,475,475,12,2,10,3,2
35,482,482,46,16,30,4,3
10,482,482,55,49,6,2,1
1,487,487,27,2,25,2,1
17,496,496,169,133,36,4,3
26,498,498,17,3,14,2,1

20,104,104,1,1,0,1,0
18,125,125,6,2,4,2,1
13,127,127,2,2,0,1,0
3,135,135,1,1,0,1,0
14,142,142,1,1,0,1,0
29,144,144,70,70,0,1,0
45,182,182,79,16,63,4,3
0,192,192,2,2,0,1,0
19,193,193,29,11,18,3,2
38,197,197,12,1,11,2,1
43,202,202,24,24,0,1,0
34,226,226,6,6,0,1,0
2,228,228,48,48,0,1,0
8,235,235,47,47,0,1,0
10,240,240,12,12,0,1,0
23,241,241,1,1,0,1,0
12,250,250,12,4,8,3,2
33,261,261,3,3,0,1,0
1,289,289,5,5,0,1,0
9,292,292,31,4,27,4,3
30,294,294,21,13,8,3,2
25,310,310,3,3,0,1,0
26,321,321,31,24,7,2,1
5,327,327,13,13,0,1,0
40,327,327,64,28,36,3,2
32,333,333,2,2,0,1,0
31,360,360,23,1,22,3,2
39,363,363,15,15,0,1,0
28,379,379,24,2,22,2,1
36,402,402,27,15,12,4,3
22,405,405,2,2,0,1,0
27,406,406,52,52,0,1,0
11,406,406,66,15,51,4,3
16,415,415,54,54,0,1,0
37,418,418,8,2,6,2,1
41,434,434,12,2,10,2,1
15,449,449,99,37,62,4,3
6,450,450,4,4,0,1,0
7,456,456,116,78,38,2,1
21,462,462,52,52,0,1,0
17,468,468,53,25,28,2,1
44,469,469,26,26,0,1,0
42,473,473,13,1,12,3,2
4,482,482,7,7,0,1,0
24,488,488,22,12,10,3,2
35,493,493,17,6,11,2,1

31,103,103,1,1,0,1,0
15,108,108,26,14,12,4,3
13,110,110,10,10,0,1,0
2,110,110,4,4,0,1,0
10,125,125,35,25,10,3,2
37,140,140,27,27,0,1,0
22,159,159,4,4,0,1,0
14,160,160,9,9,0,1,0
17,162,162,26,26,0,1,0
9,171,171,2,2,0,1,0
3,183,183,38,38,0,1,0
24,188,188,22,22,0,1,0
6,190,190,4,4,0,1,0
29,193,193,13,13,0,1,0
19,202,202,9,9,0,1,0
33,219,219,7,7,0,1,0
36,236,236,25,6,19,2,1
32,245,245,2,2,0,1,0
5,245,245,7,7,0,1,0
26,280,280,11,11,0,1,0
39,309,309,85,85,0,1,0
11,310,310,30,21,9,4,3
23,314,314,27,9,18,4,3
7,315,315,30,30,0,1,0
20,316,316,10,10,0,1,0
16,321,321,4,1,3,2,1
27,330,330,3,3,0,1,0
35,330,330,19,19,0,1,0
18,338,338,32,27,5,2,1
4,343,343,48,9,39,4,3
12,365,365,18,18,0,1,0
8,387,387,18,12,6,3,2
30,401,401,8,2,6,2,1
34,403,403,132,72,60,3,2
28,409,409,3,3,0,1,0
0,429,429,104,54,50,2,1
25,436,436,97,5,92,4,3
40,444,444,154,116,38,3,2
1,462,462,7,7,0,1,0
21,471,471,9,9,0,1,0
38,490,490,35,35,0,1,0

41,105,105,1,1,0,1,0
42,134,134,16,3,13,2,1
37,147,147,3,3,0,1,0
43,148,148,13,13,0,1,0
23,151,151,1,1,0,1,0
24,151,151,4,4,0,1,0
22,170,170,1,1,0,1,0
9,176,176,10,10,0,1,0
2,177,177,5,5,0,1,0
16,196,196,4,4,0,1,0
34,201,201,56,26,30,4,3
5,206,206,32,32,0,1,0
30,222,222,27,27,0,1,0
3,229,229,6,6,0,1,0
40,231,231,17,5,12,4,3
20,236,236,2,2,0,1,0
11,249,249,9,2,7,2,1
21,264,264,8,4,4,2,1
44,264,264,20,20,0,1,0
18,267,267,24,24,0,1,0
31,269,269,55,1,54,4,3
26,280,280,10,4,6,2,1
38,283,283,35,35,0,1,0
39,305,305,32,8,24,3,2
1,307,307,14,5,9,4,3
33,308,308,30,7,23,2,1
13,315,315,14,5,9,4,3
17,321,321,15,15,0,1,0
32,324,324,30,30,0,1,0
35,335,335,53,50,3,2,1
15,338,338,114,114,0,1,0
6,361,361,43,1,42,3,2
19,367,367,6,2,4,2,1
4,370,370,58,31,27,4,3
8,391,391,30,17,13,3,2
0,394,394,1,1,0,1,0
25,417,417,3,3,0,1,0
7,421,421,71,5,66,4,3
27,430,430,21,21,0,1,0
28,445,445,26,26,0,1,0
10,478,478,18,2,16,3,2
14,485,485,80,80,0,1,0
36,489,489,11,11,0,1,0
45,489,489,107,107,0,1,0
29,493,493,43,43,0,1,0
12,497,497,142,106,36,3,2

29,100,100,15,15,0,1,0
30,123,123,19,19,0,1,0
23,125,125,18,18,0,1,0
28,127,127,14,14,0,1,0
24,132,132,6,6,0,1,0
4,133,133,1,1,0,1,0
13,141,141,4,4,0,1,0
34,142,142,5,5,0,1,0
5,162,162,10,10,0,1,0
36,166,166,17,9,8,3,2
32,172,172,10,10,0,1,0
2,206,206,42,2,40,3,2
8,232,232,36,23,13,2,1
1,240,240,6,6,0,1,0
15,241,241,14,8,6,2,1
12,247,247,47,47,0,1,0
19,256,256,4,4,0,1,0
9,257,257,28,14,14,3,2
25,272,272,24,24,0,1,0
17,296,296,15,15,0,1,0
35,301,301,19,14,5,2,1
6,320,320,107,107,0,1,0
27,325,325,39,20,19,2,1
31,355,355,84,84,0,1,0
20,359,359,98,98,0,1,0
26,368,368,89,66,23,4,3
7,377,377,140,81,59,4,3
18,379,379,1,1,0,1,0
14,388,388,2,2,0,1,0
21,395,395,43,43,0,1,0
22,406,406,6,6,0,1,0
11,411,411,32,12,20,3,2
10,415,415,68,68,0,1,0
0,419,419,25,16,9,4,3
37,429,429,19,14,5,2,1
16,487,487,47,47,0,1,0
33,490,490,18,18,0,1,0
3,491,491,1,1,0,1,0

22,103,103,5,5,0,1,0
20,110,110,31,22,9,4,3
16,118,118,19,19,0,1,0
40,120,120,13,13,0,1,0
15,123,123,14,6,8,2,1
25,144,144,8,8,0,1,0
2,147,147,22,22,0,1,0
29,149,149,11,3,8,3,2
41,158,158,9,9,0,1,0
31,161,161,6,2,4,2,1
23,170,170,6,1,5,2,1
3,178,178,9,9,0,1,0
33,195,195,1,1,0,1,0
19,211,211,4,4,0,1,0
10,215,215,11,11,0,1,0
4,216,216,3,3,0,1,0
1,224,224,5,5,0,1,0
38,259,259,19,14,5,2,1
36,268,268,29,29,0,1,0
39,271,271,57,57,0,1,0
34,271,271,27,27,0,1,0
32,276,276,47,3,44,4,3
7,301,301,31,31,0,1,0
17,326,326,10,2,8,2,1
42,334,334,38,38,0,1,0
24,338,338,3,3,0,1,0
28,342,342,70,23,47,2,1
26,367,367,46,24,22,3,2
30,380,380,27,5,22,3,2
21,382,382,33,4,29,2,1
9,386,386,17,17,0,1,0
14,386,386,15,15,0,1,0
13,389,389,7,7,0,1,0
27,423,423,97,51,46,2,1
18,434,434,93,93,0,1,0
11,450,450,32,32,0,1,0
5,465,465,183,183,0,1,0
6,465,465,13,13,0,1,0
35,466,466,49,40,9,4,3
0,474,474,2,2,0,1,0
12,478,478,6,6,0,1,0
8,478,478,4,4,0,1,0
43,482,482,10,10,0,1,0
37,497,497,83,44,39,2,1

3,105,105,10,10,0,1,0
0,120,120,2,2,0,1,0
24,124,124,3,3,0,1,0
12,134,134,1,1,0,1,0
16,144,144,18,12,6,2,1
40,148,148,7,1,6,3,2
25,150,150,5,1,4,2,1
4,173,173,28,28,0,1,0
15,184,184,2,2,0,1,0
9,187,187,27,14,13,2,1
28,201,201,46,46,0,1,0
38,212,212,1,1,0,1,0
19,220,220,7,7,0,1,0
8,228,228,14,14,0,1,0
6,229,229,16,6,10,2,1
22,248,248,29,1,28,2,1
29,279,279,28,18,10,2,1
11,280,280,83,83,0,1,0
34,294,294,3,3,0,1,0
18,298,298,30,30,0,1,0
13,303,303,12,12,0,1,0
35,311,311,20,7,13,2,1
7,333,333,23,23,0,1,0
26,338,338,56,6,50,2,1
36,352,352,12,12,0,1,0
2,358,358,20,12,8,2,1
27,387,387,14,2,12,4,3
32,387,387,149,149,0,1,0
10,388,388,55,10,45,2,1
1,395,395,12,12,0,1,0
33,411,411,7,1,6,2,1
31,416,416,4,4,0,1,0
37,417,417,73,69,4,2,1
30,438,438,15,5,10,3,2
20,447,447,35,8,27,2,1
21,452,452,49,49,0,1,0
39,468,468,144,97,47,3,2
14,472,472,25,25,0,1,0
23,484,484,65,43,22,3,2
5,489,489,142,142,0,1,0
17,500,500,61,61,0,1,0

17,100,100,28,28,0,1,0
36,102,102,8,8,0,1,0
11,105,105,9,6,3,2,1
12,108,108,4,4,0,1,0
2,113,113,8,2,6,3,2
27,113,113,5,1,4,2,1
15,125,125,52,30,22,2,1
4,133,133,1,1,0,1,0
41,142,142,15,9,6,3,2
29,143,143,4,4,0,1,0
1,143,143,3,3,0,1,0
25,149,149,8,8,0,1,0
30,186,186,28,15,13,2,1
35,200,200,45,31,14,2,1
39,215,215,10,10,0,1,0
13,217,217,38,38,0,1,0
20,228,228,12,12,0,1,0
14,293,293,37,1,36,3,2
19,293,293,13,1,12,4,3
21,296,296,44,44,0,1,0
26,325,325,39,14,25,2,1
7,326,326,15,15,0,1,0
40,334,334,4,4,0,1,0
3,338,338,3,3,0,1,0
8,343,343,12,5,7,2,1
31,350,350,34,22,12,3,2
37,365,365,15,15,0,1,0
5,379,379,5,5,0,1,0
9,387,387,3,3,0,1,0
33,388,388,80,29,51,4,3
34,389,389,10,10,0,1,0
23,393,393,109,74,35,2,1
28,403,403,7,4,3,2,1
10,404,404,54,6,48,4,3
22,408,408,42,42,0,1,0
32,426,426,39,39,0,1,0
18,430,430,8,8,0,1,0
16,431,431,29,25,4,2,1
24,446,446,141,95,46,4,3
38,463,463,13,13,0,1,0
6,466,466,14,14,0,1,0
42,491,491,36,21,15,2,1
0,497,497,36,36,0,1,0

21,101,101,16,16,0,1,0
16,102,102,3,3,0,1,0
36,107,107,4,4,0,1,0
13,130,130,3,3,0,1,0
9,132,132,15,15,0,1,0
28,146,146,21,21,0,1,0
39,161,161,44,44,0,1,0
17,165,165,5,1,4,2,1
5,167,167,7,7,0,1,0
33,183,183,17,6,11,2,1
19,191,191,14,1,13,3,2
4,203,203,1,1,0,1,0
14,224,224,9,1,8,3,2
29,231,231,32,32,0,1,0
1,254,254,38,3,35,2,1
12,263,263,26,26,0,1,0
24,281,281,1,1,0,1,0
40,294,294,120,100,20,2,1
2,298,298,55,55,0,1,0
0,311,311,38,38,0,1,0
8,321,321,11,11,0,1,0
20,324,324,26,16,10,2,1
18,336,336,42,42,0,1,0
25,336,336,33,21,12,2,1
27,338,338,55,25,30,3,2
22,338,338,2,2,0,1,0
31,339,339,1,1,0,1,0
37,344,344,5,1,4,2,1
38,352,352,30,30,0,1,0
3,368,368,11,2,9,4,3
15,394,394,75,75,0,1,0
30,406,406,30,30,0,1,0
26,417,417,36,17,19,2,1
6,426,426,63,63,0,1,0
35,435,435,8,8,0,1,0
23,439,439,62,62,0,1,0
7,443,443,103,68,35,4,3
34,446,446,37,5,32,2,1
10,466,466,52,39,13,2,1
32,493,493,3,3,0,1,0
11,497,497,68,30,38,2,1

25,132,132,5,1,4,2,1
37,149,149,2,2,0,1,0
9,177,177,12,4,8,3,2
28,178,178,1,1,0,1,0
11,186,186,1,1,0,1,0
24,189,189,2,2,0,1,0
21,195,195,7,1,6,3,2
5,218,218,30,10,20,2,1
10,222,222,24,16,8,3,2
32,226,226,6,3,3,2,1
36,228,228,43,8,35,2,1
20,228,228,26,18,8,2,1
27,235,235,18,4,14,3,2
8,240,240,30,2,28,2,1
6,261,261,122,122,0,1,0
15,264,264,9,9,0,1,0
30,271,271,23,23,0,1,0
4,274,274,36,27,9,4,3
3,280,280,4,4,0,1,0
2,285,285,51,51,0,1,0
14,285,285,9,9,0,1,0
18,305,305,22,10,12,2,1
38,317,317,133,11,122,4,3
0,320,320,8,8,0,1,0
13,323,323,7,7,0,1,0
22,325,325,79,4,75,4,3
26,344,344,78,78,0,1,0
40,347,347,30,26,4,2,1
7,350,350,15,3,12,4,3
34,351,351,44,44,0,1,0
16,374,374,38,6,32,3,2
19,389,389,59,59,0,1,0
31,391,391,1,1,0,1,0
33,394,394,94,74,20,3,2
29,397,397,44,14,30,4,3
23,405,405,15,1,14,2,1
1,444,444,9,2,7,2,1
39,458,458,15,15,0,1,0
17,461,461,51,3,48,3,2
35,466,466,20,14,6,2,1
12,498,498,20,2,18,3,2

13,104,104,2,2,0,1,0
19,118,118,3,3,0,1,0
35,120,120,13,9,4,2,1
11,121,121,2,2,0,1,0
8,130,130,6,6,0,1,0
12,144,144,2,2,0,1,0
0,148,148,4,4,0,1,0
20,158,158,24,24,0,1,0
6,166,166,26,26,0,1,0
25,172,172,40,19,21,2,1
24,194,194,37,16,21,4,3
38,196,196,29,29,0,1,0
1,203,203,3,3,0,1,0
18,211,211,19,14,5,2,1
31,226,226,13,13,0,1,0
29,226,226,54,54,0,1,0
14,233,233,68,68,0,1,0
16,236,236,31,21,10,3,2
15,250,250,21,21,0,1,0
4,258,258,24,14,10,2,1
32,277,277,20,3,17,2,1
28,287,287,34,34,0,1,0
42,295,295,18,18,0,1,0
30,309,309,23,23,0,1,0
3,323,323,4,4,0,1,0
23,335,335,7,1,6,3,2
26,343,343,39,29,10,2,1
21,368,368,4,4,0,1,0
43,375,375,11,3,8,3,2
37,394,394,9,9,0,1,0
40,395,395,5,5,0,1,0
34,400,400,63,19,44,2,1
5,408,408,112,112,0,1,0
27,413,413,10,5,5,2,1
9,417,417,34,5,29,2,1
22,418,418,6,6,0,1,0
36,420,420,62,47,15,2,1
17,425,425,2,2,0,1,0
7,445,445,80,51,29,2,1
10,447,447,15,7,8,3,2
39,449,449,42,42,0,1,0
41,451,451,24,2,22,3,2
44,458,458,100,100,0,1,0
33,478,478,21,12,9,4,3
2,495,495,8,8,0,1,0

5,106,106,11,7,4,2,1
27,131,131,6,3,3,2,1
22,152,152,3,3,0,1,0
16,186,186,1,1,0,1,0
32,213,213,1,1,0,1,0
10,217,217,5,1,4,2,1
33,217,217,15,15,0,1,0
24,219,219,26,26,0,1,0
20,225,225,74,74,0,1,0
4,226,226,54,20,34,3,2
3,233,233,22,22,0,1,0
8,233,233,1,1,0,1,0
37,235,235,22,3,19,2,1
39,244,244,16,5,11,2,1
12,262,262,24,24,0,1,0
42,278,278,64,64,0,1,0
6,294,294,17,3,14,2,1
28,296,296,28,8,20,3,2
34,307,307,21,17,4,2,1
13,336,336,8,8,0,1,0
14,336,336,39,9,30,4,3
40,341,341,136,100,36,4,3
26,356,356,14,14,0,1,0
2,380,380,5,1,4,2,1
29,382,382,17,17,0,1,0
41,382,382,25,21,4,2,1
36,393,393,9,9,0,1,0
15,394,394,18,18,0,1,0
11,394,394,4,4,0,1,0
1,398,398,22,10,12,2,1
21,399,399,57,6,51,4,3
38,399,399,32,32,0,1,0
31,405,405,79,49,30,4,3
17,407,407,125,49,76,3,2
7,412,412,15,15,0,1,0
0,417,417,26,26,0,1,0
9,420,420,31,31,0,1,0
25,428,428,8,8,0,1,0
35,452,452,96,6,90,4,3
19,461,461,10,1,9,2,1
18,463,463,58,58,0,1,0
23,471,471,49,49,0,1,0
30,492,492,33,33,0,1,0

29,103,103,5,5,0,1,0
4,104,104,11,11,0,1,0
3,104,104,22,22,0,1,0
16,143,143,13,1,12,4,3
26,144,144,12,4,8,3,2
18,157,157,12,7,5,2,1
12,169,169,41,41,0,1,0
30,184,184,34,34,0,1,0
38,193,193,22,22,0,1,0
37,196,196,22,1,21,4,3
20,200,200,61,18,43,2,1
0,205,205,24,10,14,3,2
19,211,211,5,2,3,2,1
32,228,228,4,4,0,1,0
36,234,234,23,1,22,2,1
25,243,243,101,11,90,3,2
14,255,255,9,9,0,1,0
5,271,271,4,4,0,1,0
24,273,273,25,25,0,1,0
13,279,279,10,10,0,1,0
17,282,282,24,24,0,1,0
10,287,287,23,23,0,1,0
1,296,296,18,18,0,1,0
23,307,307,2,2,0,1,0
8,308,308,111,26,85,4,3
22,314,314,48,40,8,3,2
28,317,317,8,8,0,1,0
39,318,318,30,5,25,4,3
2,333,333,7,7,0,1,0
27,336,336,1,1,0,1,0
7,341,341,8,8,0,1,0
21,345,345,5,5,0,1,0
35,379,379,18,18,0,1,0
9,384,384,59,35,24,2,1
15,393,393,46,16,30,2,1
34,418,418,10,2,8,2,1
11,453,453,40,40,0,1,0
31,469,469,86,86,0,1,0
6,475,475,27,27,0,1,0
33,477,477,14,8,6,3,2

39,100,100,2,2,0,1,0
34,110,110,11,11,0,1,0
21,120,120,1,1,0,1,0
32,135,135,4,4,0,1,0
30,150,150,2,2,0,1,0
17,166,166,12,2,10,2,1
15,168,168,26,17,9,4,3
24,187,187,47,47,0,1,0
42,206,206,2,2,0,1,0
25,208,208,52,52,0,1,0
27,216,216,9,9,0,1,0
37,219,219,19,1,18,4,3
22,226,226,14,14,0,1,0
31,247,247,4,4,0,1,0
6,296,296,2,2,0,1,0
18,300,300,11,1,10,2,1
13,302,302,1,1,0,1,0
16,302,302,2,2,0,1,0
26,329,329,9,9,0,1,0
38,338,338,7,7,0,1,0
41,349,349,11,11,0,1,0
40,354,354,7,7,0,1,0
9,354,354,37,6,31,2,1
43,359,359,84,84,0,1,0
29,381,381,148,144,4,2,1
35,388,388,14,6,8,2,1
8,389,389,30,30,0,1,0
12,390,390,60,60,0,1,0
7,390,390,62,62,0,1,0
3,392,392,33,33,0,1,0
10,400,400,74,74,0,1,0
5,412,412,142,82,60,3,2
0,415,415,10,10,0,1,0
11,419,419,8,8,0,1,0
14,422,422,21,21,0,1,0
1,440,440,1,1,0,1,0
4,445,445,44,44,0,1,0
20,448,448,2,2,0,1,0
19,458,458,38,4,34,3,2
36,470,470,18,5,13,2,1
33,477,477,130,50,80,3,2
28,486,486,75,75,0,1,0
2,492,492,41,41,0,1,0
23,495,495,88,6,82,3,2

2,105,105,31,31,0,1,0
24,106,106,42,27,15,4,3
3,112,112,8,8,0,1,0
28,128,128,24,24,0,1,0
32,162,162,4,1,3,2,1
21,172,172,12,4,8,3,2
29,173,173,2,2,0,1,0
11,174,174,37,22,15,4,3
10,180,180,1,1,0,1,0
5,201,201,24,24,0,1,0
14,208,208,12,12,0,1,0
9,218,218,47,34,13,2,1
17,222,222,53,53,0,1,0
19,225,225,21,21,0,1,0
22,269,269,98,98,0,1,0
31,292,292,28,28,0,1,0
20,344,344,33,33,0,1,0
8,350,350,63,42,21,3,2
16,351,351,28,21,7,2,1
35,359,359,11,11,0,1,0
0,360,360,10,10,0,1,0
18,379,379,39,39,0,1,0
15,390,390,40,40,0,1,0
1,395,395,2,2,0,1,0
37,400,400,2,2,0,1,0
33,402,402,49,31,18,3,2
30,402,402,6,6,0,1,0
23,403,403,47,47,0,1,0
34,406,406,17,17,0,1,0
13,413,413,56,56,0,1,0
6,414,414,9,9,0,1,0
25,424,424,24,14,10,2,1
7,436,436,42,42,0,1,0
26,453,453,14,14,0,1,0
4,454,454,12,12,0,1,0
12,460,460,3,3,0,1,0
38,474,474,106,4,102,4,3
36,483,483,19,7,12,3,2
27,499,499,3,3,0,1,0

32,100,100,4,1,3,2,1
27,100,100,15,15,0,1,0
30,106,106,8,4,4,2,1
21,108,108,20,20,0,1,0
1,115,115,12,12,0,1,0
12,128,128,4,4,0,1,0
22,148,148,10,1,9,4,3
18,167,167,14,14,0,1,0
15,177,177,35,35,0,1,0
11,183,183,20,8,12,3,2
20,190,190,45,45,0,1,0
29,194,194,12,6,6,3,2
6,222,222,9,9,0,1,0
34,247,247,35,9,26,3,2
33,261,261,41,11,30,3,2
40,263,263,52,10,42,2,1
5,272,272,3,3,0,1,0
19,274,274,48,16,32,2,1
9,276,276,3,3,0,1,0
13,297,297,14,14,0,1,0
36,308,308,5,5,0,1,0
14,313,313,9,3,6,2,1
35,315,315,11,1,10,3,2
41,316,316,27,20,7,2,1
0,317,317,16,4,12,4,3
3,339,339,83,83,0,1,0
37,353,353,23,23,0,1,0
28,360,360,6,6,0,1,0
39,366,366,8,8,0,1,0
4,377,377,3,3,0,1,0
43,382,382,42,26,16,3,2
25,386,386,85,85,0,1,0
42,387,387,68,68,0,1,0
38,391,391,93,73,20,2,1
16,391,391,1,1,0,1,0
10,403,403,74,55,19,2,1
23,405,405,7,7,0,1,0
31,409,409,57,57,0,1,0
2,410,410,57,21,36,3,2
17,418,418,6,6,0,1,0
8,440,440,1,1,0,1,0
26,448,448,39,39,0,1,0
24,452,452,7,7,0,1,0
7,493,493,4,1,3,2,1

36,111,111,18,18,0,1,0
4,118,118,3,3,0,1,0
0,124,124,21,8,13,2,1
29,136,136,7,7,0,1,0
13,142,142,16,16,0,1,0
39,147,147,11,2,9,2,1
23,160,160,47,47,0,1,0
7,166,166,7,7,0,1,0
26,167,167,54,28,26,3,2
9,173,173,32,32,0,1,0
40,183,183,4,4,0,1,0
42,189,189,22,10,12,2,1
11,196,196,21,21,0,1,0
17,226,226,10,10,0,1,0
24,238,238,36,36,0,1,0
15,245,245,2,2,0,1,0
20,253,253,47,2,45,4,3
28,273,273,22,14,8,2,1
8,280,280,1,1,0,1,0
41,292,292,10,10,0,1,0
16,295,295,11,11,0,1,0
22,295,295,19,7,12,3,2
1,300,300,5,5,0,1,0
18,303,303,11,3,8,3,2
43,313,313,3,3,0,1,0
32,327,327,35,20,15,4,3
27,355,355,36,30,6,2,1
38,356,356,18,4,14,2,1
19,361,361,8,8,0,1,0
33,365,365,70,29,41,4,3
35,366,366,70,20,50,3,2
12,368,368,3,3,0,1,0
44,371,371,49,3,46,4,3
6,398,398,10,10,0,1,0
3,402,402,1,1,0,1,0
30,402,402,25,25,0,1,0
5,407,407,4,1,3,2,1
37,417,417,2,2,0,1,0
45,431,431,47,47,0,1,0
14,434,434,5,5,0,1,0
2,453,453,1,1,0,1,0
21,461,461,8,8,0,1,0
25,466,466,105,55,50,2,1
34,469,469,32,17,15,2,1
31,473,473,70,70,0,1,0
10,485,485,94,48,46,2,1

12,114,114,6,6,0,1,0
38,118,118,9,9,0,1,0
10,125,125,19,14,5,2,1
6,130,130,11,11,0,1,0
33,142,142,30,6,24,4,3
24,152,152,7,7,0,1,0
32,154,154,37,13,24,4,3
28,158,158,24,24,0,1,0
11,160,160,27,15,12,4,3
4,162,162,7,7,0,1,0
15,234,234,6,2,4,2,1
26,234,234,57,26,31,2,1
20,254,254,23,10,13,2,1
23,269,269,29,13,16,2,1
3,281,281,9,9,0,1,0
5,282,282,40,40,0,1,0
37,285,285,18,2,16,3,2
16,291,291,13,13,0,1,0
30,292,292,1,1,0,1,0
14,293,293,8,1,7,2,1
9,297,297,12,9,3,2,1
19,299,299,23,1,22,2,1
27,307,307,30,10,20,4,3
7,322,322,31,31,0,1,0
39,326,326,83,50,33,3,2
22,326,326,10,5,5,2,1
31,326,326,19,19,0,1,0
34,330,330,22,15,7,2,1
36,343,343,20,20,0,1,0
41,346,346,17,17,0,1,0
2,363,363,24,6,18,3,2
18,366,366,9,9,0,1,0
1,377,377,37,13,24,4,3
13,386,386,17,17,0,1,0
40,401,401,6,6,0,1,0
8,404,404,4,4,0,1,0
25,415,415,9,9,0,1,0
29,421,421,94,94,0,1,0
0,454,454,179,44,135,4,3
17,454,454,12,12,0,1,0
35,480,480,7,1,6,3,2
21,489,489,127,127,0,1,0

20,100,100,20,20,0,1,0
6,101,101,28,7,21,2,1
18,105,105,2,2,0,1,0
31,145,145,7,7,0,1,0
12,152,152,4,4,0,1,0
28,156,156,6,3,3,2,1
32,166,166,14,14,0,1,0
14,170,170,43,7,36,3,2
7,176,176,1,1,0,1,0
13,188,188,1,1,0,1,0
1,190,190,3,3,0,1,0
2,200,200,2,2,0,1,0
29,229,229,13,13,0,1,0
24,243,243,24,24,0,1,0
36,247,247,2,2,0,1,0
26,298,298,16,4,12,3,2
10,301,301,1,1,0,1,0
22,311,311,64,64,0,1,0
23,315,315,46,46,0,1,0
9,319,319,4,4,0,1,0
25,319,319,27,27,0,1,0
19,335,335,87,87,0,1,0
17,352,352,31,31,0,1,0
35,361,361,33,33,0,1,0
0,362,362,89,81,8,3,2
21,364,364,4,1,3,2,1
27,366,366,61,42,19,2,1
15,367,367,76,48,28,2,1
8,380,380,16,16,0,1,0
34,398,398,96,49,47,2,1
11,410,410,18,3,15,3,2
3,422,422,2,2,0,1,0
4,429,429,130,130,0,1,0
30,432,432,3,3,0,1,0
16,449,449,147,147,0,1,0
33,467,467,66,32,34,2,1
5,476,476,104,6,98,3,2

15,110,110,1,1,0,1,0
30,114,114,29,5,24,3,2
37,154,154,26,26,0,1,0
1,173,173,18,18,0,1,0
29,197,197,1,1,0,1,0
31,202,202,2,2,0,1,0
22,203,203,2,2,0,1,0
46,208,208,4,4,0,1,0
19,208,208,43,43,0,1,0
16,209,209,3,3,0,1,0
3,220,220,4,4,0,1,0
28,238,238,1,1,0,1,0
36,251,251,98,26,72,4,3
4,255,255,15,15,0,1,0
40,260,260,19,10,9,4,3
44,264,264,8,8,0,1,0
24,264,264,3,3,0,1,0
35,269,269,63,45,18,4,3
5,275,275,28,7,21,4,3
33,275,275,82,46,36,4,3
17,289,289,18,18,0,1,0
25,297,297,26,26,0,1,0
34,308,308,15,3,12,3,2
18,309,309,9,9,0,1,0
32,309,309,30,17,13,2,1
41,316,316,16,16,0,1,0
9,333,333,2,2,0,1,0
8,336,336,49,34,15,4,3
12,357,357,36,11,25,2,1
42,359,359,16,16,0,1,0
10,368,368,41,41,0,1,0
0,374,374,10,6,4,2,1
13,374,374,26,26,0,1,0
27,384,384,32,13,19,4,3
26,390,390,24,12,12,2,1
6,394,394,10,10,0,1,0
11,398,398,3,3,0,1,0
7,406,406,59,59,0,1,0
38,409,409,21,6,15,4,3
21,414,414,8,5,3,2,1
45,437,437,14,4,10,3,2
20,458,458,56,56,0,1,0
14,468,468,181,181,0,1,0
2,474,474,10,10,0,1,0
39,482,482,12,12,0,1,0
23,482,482,18,15,3,2,1
43,489,489,57,9,48,4,3

33,119,119,36,36,0,1,0
39,121,121,3,3,0,1,0
9,127,127,11,1,10,3,2
37,136,136,63,46,17,2,1
41,141,141,5,5,0,1,0
28,143,143,40,40,0,1,0
25,149,149,3,3,0,1,0
38,155,155,4,4,0,1,0
6,170,170,20,20,0,1,0
17,174,174,28,15,13,2,1
0,177,177,20,13,7,2,1
21,196,196,7,7,0,1,0
13,202,202,33,33,0,1,0
20,203,203,8,4,4,2,1
43,205,205,6,6,0,1,0
34,223,223,10,7,3,2,1
31,227,227,23,23,0,1,0
30,252,252,9,9,0,1,0
11,255,255,10,10,0,1,0
2,296,296,39,39,0,1,0
16,300,300,27,27,0,1,0
22,316,316,45,45,0,1,0
32,327,327,58,49,9,4,3
36,332,332,59,59,0,1,0
1,334,334,50,12,38,3,2
46,335,335,7,7,0,1,0
5,341,341,1,1,0,1,0
24,364,364,17,17,0,1,0
23,366,366,9,9,0,1,0
19,377,377,13,13,0,1,0
26,383,383,27,27,0,1,0
12,384,384,16,16,0,1,0
14,390,390,51,13,38,3,2
29,404,404,7,7,0,1,0
27,421,421,30,12,18,4,3
18,436,436,56,56,0,1,0
40,443,443,27,27,0,1,0
44,451,451,10,6,4,2,1
3,457,457,1,1,0,1,0
42,460,460,18,18,0,1,0
10,461,461,28,28,0,1,0
4,468,468,1,1,0,1,0
8,471,471,37,18,19,2,1
15,472,472,25,17,8,3,2
7,476,476,17,17,0,1,0
35,485,485,43,30,13,2,1
45,500,500,13,13,0,1,0

42,107,107,15,1,14,3,2
7,111,111,13,10,3,2,1
21,114,114,10,10,0,1,0
11,120,120,38,38,0,1,0
32,126,126,1,1,0,1,0
3,128,128,1,1,0,1,0
33,134,134,4,4,0,1,0
38,138,138,43,43,0,1,0
28,157,157,11,4,7,2,1
4,158,158,13,13,0,1,0
30,160,160,16,7,9,4,3
19,166,166,2,2,0,1,0
36,182,182,35,8,27,4,3
1,191,191,34,20,14,3,2
16,209,209,5,2,3,2,1
0,217,217,26,2,24,4,3
26,218,218,55,11,44,4,3
6,233,233,30,30,0,1,0
2,245,245,9,9,0,1,0
40,255,255,58,58,0,1,0
13,302,302,29,29,0,1,0
34,307,307,27,5,22,2,1
24,311,311,10,10,0,1,0
9,311,311,1,1,0,1,0
17,351,351,1,1,0,1,0
22,365,365,29,29,0,1,0
10,367,367,11,11,0,1,0
12,378,378,13,13,0,1,0
15,382,382,21,17,4,2,1
37,390,390,18,18,0,1,0
39,406,406,65,44,21,4,3
23,418,418,9,9,0,1,0
35,428,428,50,32,18,2,1
25,433,433,27,8,19,2,1
31,435,435,11,1,10,3,2
18,443,443,68,68,0,1,0
20,453,453,82,64,18,4,3
41,456,456,17,8,9,4,3
27,469,469,21,3,18,4,3
8,475,475,47,31,16,3,2
5,478,478,21,21,0,1,0
14,481,481,54,54,0,1,0
29,493,493,33,24,9,4,3

32,138,138,14,14,0,1,0
12,141,141,29,29,0,1,0
3,143,143,3,3,0,1,0
6,143,143,92,16,76,3,2
8,145,145,5,5,0,1,0
28,147,147,13,13,0,1,0
19,169,169,7,4,3,2,1
9,173,173,4,4,0,1,0
14,196,196,27,27,0,1,0
24,202,202,15,2,13,2,1
4,230,230,3,3,0,1,0
20,234,234,83,11,72,3,2
15,241,241,9,9,0,1,0
1,244,244,7,7,0,1,0
18,259,259,24,24,0,1,0
11,260,260,9,9,0,1,0
17,267,267,10,10,0,1,0
21,296,296,103,103,0,1,0
25,299,299,1,1,0,1,0
26,354,354,24,24,0,1,0
27,363,363,93,45,48,4,3
10,404,404,9,9,0,1,0
7,411,411,40,40,0,1,0
22,424,424,1,1,0,1,0
31,424,424,30,23,7,2,1
2,428,428,118,57,61,4,3
29,432,432,16,6,10,3,2
23,433,433,28,28,0,1,0
13,435,435,13,1,12,3,2
0,445,445,12,12,0,1,0
16,460,460,58,58,0,1,0
30,491,491,32,8,24,2,1
5,498,498,287,287,0,1,0

8,103,103,8,8,0,1,0
3,108,108,11,11,0,1,0
37,110,110,24,24,0,1,0
33,120,120,6,6,0,1,0
20,128,128,11,11,0,1,0
15,144,144,14,3,11,2,1
0,161,161,18,14,4,2,1
26,171,171,6,6,0,1,0
24,175,175,13,13,0,1,0
32,207,207,8,5,3,2,1
9,212,212,11,2,9,2,1
21,213,213,7,7,0,1,0
23,216,216,24,24,0,1,0
36,226,226,65,65,0,1,0
1,237,237,21,13,8,2,1
31,239,239,16,8,8,2,1
38,240,240,11,11,0,1,0
27,273,273,47,13,34,2,1
22,278,278,74,34,40,3,2
4,284,284,72,54,18,3,2
6,304,304,40,34,6,2,1
30,306,306,8,8,0,1,0
2,310,310,53,53,0,1,0
39,331,331,35,19,16,3,2
25,356,356,66,66,0,1,0
34,364,364,60,25,35,2,1
35,364,364,17,17,0,1,0
18,382,382,10,10,0,1,0
13,388,388,27,27,0,1,0
14,397,397,2,2,0,1,0
12,402,402,83,57,26,4,3
10,414,414,25,25,0,1,0
16,419,419,71,47,24,3,2
11,429,429,66,51,15,4,3
17,431,431,25,25,0,1,0
41,441,441,1,1,0,1,0
19,448,448,5,5,0,1,0
40,458,458,20,11,9,4,3
5,461,461,1,1,0,1,0
7,483,483,18,18,0,1,0
29,490,490,16,16,0,1,0
28,490,490,36,36,0,1,0

5,102,102,8,8,0,1,0
34,113,113,2,2,0,1,0
22,132,132,5,5,0,1,0
18,144,144,3,3,0,1,0
4,168,168,10,4,6,3,2
38,176,176,17,4,13,2,1
1,181,181,39,25,14,3,2
24,186,186,9,9,0,1,0
41,195,195,52,23,29,2,1
46,196,196,17,17,0,1,0
31,201,201,25,25,0,1,0
26,202,202,24,24,0,1,0
16,214,214,13,1,12,2,1
37,225,225,4,1,3,2,1
29,230,230,17,17,0,1,0
3,231,231,3,3,0,1,0
13,237,237,1,1,0,1,0
35,242,242,7,7,0,1,0
20,243,243,4,4,0,1,0
23,246,246,74,47,27,2,1
12,248,248,28,4,24,3,2
9,254,254,1,1,0,1,0
27,277,277,31,31,0,1,0
40,277,277,16,2,14,3,2
42,282,282,31,31,0,1,0
19,318,318,63,43,20,4,3
15,327,327,8,1,7,2,1
44,334,334,98,41,57,4,3
17,337,337,51,51,0,1,0
33,340,340,23,1,22,2,1
21,359,359,4,4,0,1,0
43,366,366,37,5,32,2,1
6,376,376,46,46,0,1,0
8,384,384,14,3,11,2,1
14,394,394,11,11,0,1,0
2,404,404,31,6,25,4,3
7,406,406,42,42,0,1,0
30,411,411,25,25,0,1,0
10,436,436,2,2,0,1,0
11,442,442,37,37,0,1,0
36,448,448,32,19,13,2,1
28,450,450,108,59,49,3,2
39,454,454,13,13,0,1,0
25,464,464,19,19,0,1,0
0,484,484,15,10,5,2,1
32,489,489,77,11,66,3,2
45,490,490,12,12,0,1,0

8,121,121,6,3,3,2,1
3,122,122,1,1,0,1,0
33,122,122,2,2,0,1,0
17,141,141,26,26,0,1,0
16,145,145,39,18,21,4,3
4,146,146,20,20,0,1,0
5,151,151,1,1,0,1,0
18,164,164,36,12,24,2,1
30,169,169,8,8,0,1,0
11,181,181,7,7,0,1,0
10,202,202,9,1,8,3,2
15,223,223,1,1,0,1,0
31,225,225,32,6,26,3,2
36,234,234,65,17,48,2,1
28,238,238,6,6,0,1,0
12,271,271,1,1,0,1,0
27,271,271,12,12,0,1,0
26,273,273,43,9,34,2,1
14,278,278,159,111,48,3,2
13,281,281,14,14,0,1,0
19,299,299,12,6,6,2,1
24,318,318,31,31,0,1,0
29,320,320,4,4,0,1,0
34,337,337,34,22,12,4,3
0,342,342,106,67,39,4,3
9,349,349,36,36,0,1,0
21,380,380,89,84,5,2,1
1,391,391,49,49,0,1,0
2,394,394,5,5,0,1,0
20,394,394,45,3,42,2,1
23,403,403,61,1,60,4,3
35,426,426,8,8,0,1,0
6,452,452,21,2,19,2,1
32,475,475,35,2,33,4,3
22,477,477,15,15,0,1,0
25,484,484,20,20,0,1,0
7,495,495,111,73,38,3,2

16,100,100,2,2,0,1,0
20,103,103,8,8,0,1,0
24,114,114,4,4,0,1,0
39,116,116,2,2,0,1,0
14,117,117,1,1,0,1,0
38,137,137,19,19,0,1,0
7,140,140,4,4,0,1,0
37,141,141,35,11,24,4,3
30,162,162,10,10,0,1,0
42,166,166,16,16,0,1,0
13,167,167,12,8,4,2,1
12,168,168,7,7,0,1,0
40,173,173,1,1,0,1,0
21,182,182,5,1,4,2,1
28,193,193,1,1,0,1,0
36,202,202,29,29,0,1,0
2,208,208,36,22,14,2,1
17,228,228,1,1,0,1,0
33,237,237,7,7,0,1,0
48,245,245,6,6,0,1,0
47,294,294,65,65,0,1,0
23,307,307,12,6,6,2,1
8,314,314,63,19,44,2,1
44,328,328,4,4,0,1,0
0,339,339,97,39,58,3,2
4,349,349,23,4,19,4,3
9,352,352,14,6,8,3,2
3,353,353,18,13,5,2,1
11,360,360,6,1,5,2,1
22,371,371,8,5,3,2,1
25,378,378,29,7,22,3,2
34,383,383,44,44,0,1,0
15,395,395,63,63,0,1,0
29,395,395,96,96,0,1,0
26,413,413,12,12,0,1,0
27,418,418,3,3,0,1,0
43,420,420,78,33,45,4,3
45,421,421,23,23,0,1,0
31,440,440,82,69,13,2,1
19,444,444,75,75,0,1,0
5,450,450,32,32,0,1,0
1,451,451,68,28,40,2,1
41,471,471,65,18,47,4,3
6,475,475,20,1,19,2,1
35,480,480,10,5,5,2,1
32,492,492,19,19,0,1,0
10,493,493,1,1,0,1,0
46,494,494,32,17,15,2,1
18,495,495,41,30,11,2,1

10,102,102,5,5,0,1,0
34,112,112,26,20,6,3,2
15,114,114,2,2,0,1,0
6,125,125,2,2,0,1,0
0,127,127,20,20,0,1,0
16,136,136,4,4,0,1,0
29,147,147,1,1,0,1,0
32,162,162,47,47,0,1,0
35,172,172,4,4,0,1,0
14,193,193,9,9,0,1,0
21,197,197,3,3,0,1,0
20,202,202,1,1,0,1,0
33,214,214,7,2,5,2,1
38,216,216,5,5,0,1,0
39,218,218,19,1,18,3,2
40,238,238,19,10,9,2,1
11,239,239,12,12,0,1,0
30,241,241,15,15,0,1,0
2,249,249,1,1,0,1,0
36,254,254,19,19,0,1,0
31,255,255,84,35,49,2,1
17,267,267,2,2,0,1,0
18,267,267,17,7,10,3,2
4,276,276,14,14,0,1,0
27,278,278,74,74,0,1,0
24,291,291,27,3,24,4,3
8,292,292,3,3,0,1,0
5,311,311,140,140,0,1,0
41,323,323,21,21,0,1,0
12,328,328,1,1,0,1,0
23,345,345,32,18,14,2,1
37,358,358,64,64,0,1,0
9,359,359,18,18,0,1,0
26,368,368,40,40,0,1,0
42,372,372,11,3,8,3,2
22,376,376,49,49,0,1,0
1,406,406,7,7,0,1,0
13,406,406,6,3,3,2,1
43,415,415,7,1,6,2,1
28,435,435,13,4,9,2,1
3,435,435,8,8,0,1,0
25,439,439,7,7,0,1,0
19,461,461,46,46,0,1,0
7,481,481,290,290,0,1,0

