33,101,101,5,5,0,1,0
16,105,105,26,26,0,1,0
21,115,115,17,8,9,4,3
14,117,117,10,10,0,1,0
17,136,136,13,13,0,1,0
8,142,142,8,5,3,2,1
5,149,149,2,2,0,1,0
22,149,149,8,2,6,3,2
12,153,153,20,3,17,4,3
30,154,154,27,9,18,2,1
19,167,167,8,8,0,1,0
34,198,198,67,25,42,4,3
0,203,203,7,7,0,1,0
10,208,208,1,1,0,1,0
18,209,209,13,13,0,1,0
24,211,211,4,1,3,2,1
32,243,243,2,2,0,1,0
26,276,276,13,13,0,1,0
11,281,281,13,13,0,1,0
20,292,292,35,17,18,4,3
15,310,310,20,20,0,1,0
27,310,310,10,10,0,1,0
7,313,313,12,12,0,1,0
2,329,329,130,62,68,3,2
28,342,342,22,1,21,4,3
13,343,343,7,7,0,1,0
4,368,368,3,3,0,1,0
25,373,373,46,46,0,1,0
6,381,381,38,24,14,3,2
31,384,384,2,2,0,1,0
9,407,407,14,14,0,1,0
23,412,412,66,66,0,1,0
29,417,417,105,75,30,2,1
3,461,461,73,73,0,1,0
1,462,462,3,3,0,1,0

4,111,111,18,3,15,4,3
37,116,116,12,4,8,2,1
36,138,138,3,3,0,1,0
0,141,141,10,5,5,2,1
10,148,148,4,1,3,2,1
21,154,154,3,3,0,1,0
6,162,162,15,12,3,2,1
19,163,163,6,6,0,1,0
35,182,182,3,3,0,1,0
12,183,183,2,2,0,1,0
3,185,185,2,2,0,1,0
8,196,196,11,3,8,3,2
14,202,202,31,13,18,3,2
34,212,212,15,15,0,1,0
20,214,214,35,35,0,1,0
9,233,233,21,1,20,2,1
5,240,240,16,7,9,2,1
11,254,254,28,28,0,1,0
13,258,258,6,6,0,1,0
27,271,271,17,17,0,1,0
28,272,272,12,12,0,1,0
30,277,277,6,6,0,1,0
7,293,293,27,27,0,1,0
15,308,308,17,8,9,4,3
23,319,319,4,4,0,1,0
22,320,320,81,62,19,2,1
1,334,334,6,6,0,1,0
29,335,335,1,1,0,1,0
18,361,361,69,69,0,1,0
33,373,373,24,24,0,1,0
31,384,384,223,179,44,3,2
24,393,393,37,37,0,1,0
32,393,393,76,76,0,1,0
2,439,439,3,3,0,1,0
16,471,471,46,10,36,4,3
17,487,487,22,22,0,1,0
25,493,493,4,4,0,1,0
26,500,500,41,41,0,1,0

9,107,107,4,4,0,1,0
21,114,114,2,2,0,1,0
14,130,130,1,1,0,1,0
7,150,150,4,1,3,2,1
23,190,190,78,57,21,2,1
35,193,193,5,5,0,1,0
5,226,226,14,14,0,1,0
28,232,232,38,23,15,2,1
3,244,244,34,16,18,4,3
12,251,251,1,1,0,1,0
20,253,253,12,12,0,1,0
17,254,254,16,1,15,4,3
34,264,264,24,1,23,2,1
15,267,267,5,2,3,2,1
16,271,271,8,3,5,2,1
25,274,274,52,52,0,1,0
24,286,286,11,1,10,3,2
18,298,298,9,6,3,2,1
6,299,299,8,1,7,2,1
26,328,328,37,37,0,1,0
13,331,331,54,15,39,4,3
31,348,348,64,54,10,2,1
4,376,376,20,17,3,2,1
32,399,399,22,18,4,2,1
11,419,419,1,1,0,1,0
33,423,423,20,20,0,1,0
2,428,428,39,39,0,1,0
22,434,434,17,17,0,1,0
19,443,443,36,10,26,2,1
8,444,444,1,1,0,1,0
0,446,446,32,2,30,3,2
29,448,448,6,1,5,2,1
10,456,456,50,2,48,4,3
27,469,469,1,1,0,1,0
30,477,477,91,52,39,2,1
1,481,481,280,245,35,2,1

7,122,122,1,1,0,1,0
6,125,125,19,19,0,1,0
11,125,125,23,23,0,1,0
1,127,127,2,2,0,1,0
17,130,130,9,9,0,1,0
26,134,134,5,2,3,2,1
35,142,142,14,14,0,1,0
12,146,146,14,14,0,1,0
31,163,163,46,46,0,1,0
16,190,190,9,9,0,1,0
18,191,191,12,3,9,4,3
27,214,214,12,12,0,1,0
20,246,246,15,15,0,1,0
5,250,250,1,1,0,1,0
21,264,264,99,90,9,4,3
3,273,273,19,19,0,1,0
13,317,317,12,3,9,3,2
25,324,324,7,2,5,2,1
29,326,326,18,18,0,1,0
9,330,330,25,25,0,1,0
19,337,337,12,4,8,3,2
23,349,349,66,66,0,1,0
28,352,352,1,1,0,1,0
14,364,364,10,10,0,1,0
15,370,370,25,14,11,2,1
33,372,372,33,21,12,3,2
30,375,375,22,22,0,1,0
34,377,377,87,37,50,3,2
4,395,395,80,80,0,1,0
24,407,407,1,1,0,1,0
2,408,408,76,76,0,1,0
32,420,420,9,9,0,1,0
10,470,470,47,13,34,2,1
22,485,485,26,11,15,4,3
8,489,489,48,48,0,1,0
0,499,499,31,17,14,2,1

7,112,112,1,1,0,1,0
14,115,115,23,23,0,1,0
1,119,119,36,15,21,4,3
32,132,132,17,1,16,4,3
20,137,137,14,8,6,3,2
11,145,145,23,19,4,2,1
26,148,148,5,5,0,1,0
3,156,156,2,2,0,1,0
28,156,156,3,3,0,1,0
8,187,187,5,5,0,1,0
30,191,191,22,22,0,1,0
22,205,205,34,4,30,3,2
17,225,225,30,30,0,1,0
23,238,238,5,5,0,1,0
25,242,242,15,5,10,2,1
4,257,257,1,1,0,1,0
24,276,276,16,2,14,3,2
5,283,283,61,61,0,1,0
19,298,298,83,11,72,4,3
12,317,317,54,26,28,2,1
21,327,327,46,11,35,2,1
29,364,364,2,2,0,1,0
13,368,368,25,16,9,4,3
27,378,378,36,36,0,1,0
31,386,386,14,14,0,1,0
18,404,404,138,138,0,1,0
16,405,405,34,5,29,2,1
33,436,436,15,15,0,1,0
6,440,440,2,2,0,1,0
0,454,454,6,6,0,1,0
2,459,459,6,6,0,1,0
15,468,468,32,2,30,3,2
10,477,477,34,7,27,4,3
9,482,482,23,23,0,1,0

8,112,112,6,6,0,1,0
21,125,125,2,2,0,1,0
37,129,129,18,18,0,1,0
41,134,134,6,3,3,2,1
22,141,141,6,6,0,1,0
0,154,154,6,6,0,1,0
24,183,183,1,1,0,1,0
32,202,202,12,12,0,1,0
13,208,208,10,5,5,2,1
29,210,210,7,7,0,1,0
11,213,213,8,8,0,1,0
19,215,215,3,3,0,1,0
16,220,220,73,13,60,4,3
26,225,225,12,4,8,2,1
4,226,226,1,1,0,1,0
28,226,226,9,9,0,1,0
17,277,277,45,9,36,3,2
9,285,285,36,36,0,1,0
31,287,287,16,4,12,4,3
15,290,290,23,16,7,2,1
6,297,297,30,1,29,2,1
12,301,301,34,10,24,2,1
7,314,314,3,3,0,1,0
3,323,323,43,43,0,1,0
2,323,323,2,2,0,1,0
36,324,324,14,8,6,2,1
23,327,327,39,39,0,1,0
40,346,346,144,78,66,3,2
35,360,360,80,51,29,4,3
5,368,368,23,14,9,2,1
30,381,381,11,5,6,2,1
27,391,391,24,8,16,2,1
1,411,411,8,8,0,1,0
39,412,412,13,13,0,1,0
10,437,437,8,8,0,1,0
25,438,438,3,3,0,1,0
34,483,483,2,2,0,1,0
18,484,484,20,20,0,1,0
33,485,485,175,175,0,1,0
38,488,488,17,2,15,3,2
20,491,491,2,2,0,1,0
14,492,492,3,3,0,1,0

18,102,102,9,9,0,1,0
17,105,105,29,20,9,4,3
15,112,112,23,9,14,3,2
19,121,121,22,5,17,2,1
14,129,129,28,28,0,1,0
23,133,133,8,5,3,2,1
7,178,178,5,5,0,1,0
24,183,183,15,15,0,1,0
31,205,205,15,1,14,4,3
28,212,212,15,15,0,1,0
20,220,220,47,17,30,4,3
13,284,284,3,3,0,1,0
9,287,287,2,2,0,1,0
16,314,314,18,10,8,2,1
11,316,316,52,23,29,2,1
27,317,317,3,3,0,1,0
6,328,328,18,2,16,4,3
5,358,358,77,30,47,2,1
2,368,368,33,33,0,1,0
0,379,379,5,2,3,2,1
29,379,379,18,4,14,2,1
8,383,383,46,19,27,2,1
21,389,389,66,66,0,1,0
30,398,398,29,29,0,1,0
1,398,398,63,63,0,1,0
10,404,404,31,2,29,2,1
22,427,427,6,6,0,1,0
25,446,446,40,40,0,1,0
12,462,462,8,8,0,1,0
3,483,483,18,18,0,1,0
4,487,487,92,9,83,4,3
26,499,499,69,51,18,2,1

29,119,119,6,2,4,2,1
17,123,123,20,20,0,1,0
9,143,143,19,19,0,1,0
4,146,146,24,24,0,1,0
13,147,147,14,14,0,1,0
2,154,154,2,2,0,1,0
10,161,161,19,19,0,1,0
24,182,182,42,42,0,1,0
32,211,211,15,6,9,2,1
21,219,219,11,11,0,1,0
23,226,226,28,28,0,1,0
30,250,250,34,6,28,2,1
12,256,256,31,31,0,1,0
16,271,271,7,3,4,2,1
8,299,299,10,1,9,4,3
0,311,311,14,14,0,1,0
33,317,317,22,2,20,3,2
28,318,318,70,33,37,2,1
18,324,324,18,18,0,1,0
1,325,325,64,16,48,2,1
26,356,356,23,9,14,2,1
27,384,384,3,3,0,1,0
5,393,393,1,1,0,1,0
15,399,399,40,14,26,2,1
25,413,413,89,56,33,4,3
14,413,413,7,7,0,1,0
11,423,423,123,123,0,1,0
6,429,429,15,3,12,2,1
22,430,430,16,7,9,3,2
31,442,442,13,4,9,4,3
3,452,452,1,1,0,1,0
19,459,459,45,45,0,1,0
20,474,474,78,30,48,3,2
7,485,485,22,22,0,1,0

19,106,106,25,20,5,2,1
21,108,108,9,1,8,3,2
4,114,114,12,12,0,1,0
15,117,117,5,5,0,1,0
25,148,148,5,1,4,2,1
13,158,158,7,7,0,1,0
24,161,161,15,2,13,2,1
26,184,184,2,2,0,1,0
16,248,248,1,1,0,1,0
20,269,269,21,17,4,2,1
27,276,276,18,1,17,2,1
18,296,296,24,24,0,1,0
9,312,312,82,82,0,1,0
5,327,327,7,7,0,1,0
3,335,335,219,84,135,4,3
7,354,354,16,16,0,1,0
6,356,356,24,24,0,1,0
11,359,359,25,4,21,2,1
12,363,363,57,57,0,1,0
14,366,366,35,35,0,1,0
10,371,371,33,6,27,4,3
8,375,375,28,28,0,1,0
2,382,382,3,3,0,1,0
17,405,405,16,3,13,2,1
23,409,409,196,148,48,2,1
22,435,435,40,40,0,1,0
0,449,449,27,3,24,2,1
1,460,460,66,10,56,4,3

5,101,101,1,1,0,1,0
27,104,104,5,5,0,1,0
8,116,116,13,10,3,2,1
24,121,121,2,2,0,1,0
20,129,129,15,15,0,1,0
7,150,150,1,1,0,1,0
13,178,178,64,64,0,1,0
26,179,179,12,12,0,1,0
29,182,182,34,2,32,3,2
32,194,194,26,26,0,1,0
11,195,195,35,16,19,2,1
4,198,198,29,29,0,1,0
3,230,230,7,7,0,1,0
33,237,237,21,21,0,1,0
12,259,259,34,3,31,4,3
31,271,271,34,17,17,2,1
6,274,274,9,9,0,1,0
15,282,282,35,15,20,3,2
22,317,317,95,19,76,3,2
0,321,321,23,20,3,2,1
9,327,327,48,18,30,4,3
1,331,331,25,25,0,1,0
16,335,335,9,9,0,1,0
28,354,354,24,24,0,1,0
25,363,363,15,15,0,1,0
14,373,373,21,9,12,4,3
30,385,385,90,81,9,4,3
21,393,393,9,9,0,1,0
18,398,398,40,22,18,4,3
2,406,406,2,2,0,1,0
17,409,409,32,10,22,2,1
19,412,412,25,14,11,2,1
23,445,445,8,2,6,2,1
10,499,499,4,4,0,1,0

26,105,105,7,7,0,1,0
17,105,105,4,1,3,2,1
11,108,108,24,16,8,2,1
20,113,113,1,1,0,1,0
35,115,115,44,44,0,1,0
19,139,139,25,4,21,4,3
7,143,143,7,7,0,1,0
30,146,146,1,1,0,1,0
8,169,169,5,5,0,1,0
18,188,188,2,2,0,1,0
13,191,191,9,9,0,1,0
0,198,198,1,1,0,1,0
2,212,212,17,3,14,4,3
10,223,223,3,3,0,1,0
5,225,225,30,30,0,1,0
33,248,248,64,55,9,4,3
21,252,252,2,2,0,1,0
16,271,271,18,18,0,1,0
22,272,272,36,36,0,1,0
12,277,277,1,1,0,1,0
31,278,278,11,7,4,2,1
15,290,290,37,33,4,2,1
14,297,297,4,4,0,1,0
6,313,313,5,2,3,2,1
9,327,327,64,64,0,1,0
29,328,328,7,7,0,1,0
34,341,341,2,2,0,1,0
23,352,352,58,58,0,1,0
32,360,360,41,14,27,2,1
37,378,378,6,1,5,2,1
24,410,410,5,2,3,2,1
1,414,414,13,13,0,1,0
3,414,414,5,5,0,1,0
27,429,429,26,26,0,1,0
36,430,430,78,57,21,2,1
28,431,431,53,42,11,2,1
25,448,448,21,12,9,4,3
4,463,463,144,140,4,2,1

29,101,101,3,3,0,1,0
13,117,117,7,2,5,2,1
8,121,121,8,3,5,2,1
2,123,123,6,6,0,1,0
22,139,139,7,4,3,2,1
18,140,140,6,6,0,1,0
23,161,161,2,2,0,1,0
19,175,175,24,24,0,1,0
4,183,183,10,3,7,3,2
11,203,203,56,34,22,3,2
9,210,210,28,4,24,3,2
10,213,213,3,3,0,1,0
20,275,275,16,16,0,1,0
7,281,281,86,66,20,4,3
31,294,294,29,20,9,4,3
1,298,298,26,6,20,4,3
6,303,303,2,2,0,1,0
28,313,313,95,65,30,2,1
32,323,323,7,7,0,1,0
17,339,339,1,1,0,1,0
16,377,377,4,4,0,1,0
14,380,380,41,25,16,3,2
24,382,382,40,40,0,1,0
15,390,390,1,1,0,1,0
34,412,412,79,66,13,2,1
33,446,446,21,10,11,2,1
3,459,459,9,9,0,1,0
27,465,465,50,24,26,2,1
12,471,471,82,52,30,4,3
0,481,481,4,1,3,2,1
26,483,483,38,4,34,2,1
5,484,484,87,87,0,1,0
30,485,485,20,20,0,1,0
21,494,494,40,40,0,1,0
25,499,499,134,93,41,2,1

33,102,102,11,11,0,1,0
39,106,106,10,10,0,1,0
7,109,109,16,5,11,2,1
18,122,122,1,1,0,1,0
1,174,174,11,11,0,1,0
10,179,179,4,4,0,1,0
16,200,200,1,1,0,1,0
26,209,209,3,3,0,1,0
12,210,210,28,28,0,1,0
27,233,233,24,12,12,4,3
22,245,245,8,8,0,1,0
9,253,253,31,31,0,1,0
38,256,256,53,53,0,1,0
34,260,260,20,20,0,1,0
32,268,268,60,60,0,1,0
25,274,274,19,5,14,2,1
21,278,278,16,16,0,1,0
14,282,282,1,1,0,1,0
31,294,294,67,67,0,1,0
30,300,300,1,1,0,1,0
29,303,303,1,1,0,1,0
24,305,305,56,26,30,3,2
23,331,331,36,36,0,1,0
3,345,345,2,2,0,1,0
17,354,354,10,10,0,1,0
11,375,375,21,21,0,1,0
20,391,391,4,1,3,2,1
8,391,391,111,15,96,3,2
4,401,401,52,52,0,1,0
36,409,409,94,63,31,2,1
13,413,413,17,8,9,4,3
37,424,424,6,3,3,2,1
19,425,425,21,8,13,2,1
15,426,426,46,46,0,1,0
28,442,442,12,12,0,1,0
35,473,473,24,24,0,1,0
2,477,477,39,15,24,4,3
5,481,481,18,6,12,4,3
6,482,482,2,2,0,1,0
0,497,497,30,3,27,4,3

10,117,117,14,9,5,2,1
27,133,133,6,6,0,1,0
8,180,180,54,18,36,4,3
22,185,185,50,2,48,4,3
2,186,186,27,12,15,4,3
25,204,204,43,43,0,1,0
6,220,220,8,8,0,1,0
17,235,235,2,2,0,1,0
5,243,243,3,3,0,1,0
9,278,278,119,11,108,4,3
28,298,298,14,14,0,1,0
16,299,299,55,43,12,2,1
26,303,303,1,1,0,1,0
12,310,310,23,10,13,2,1
15,327,327,9,2,7,2,1
3,334,334,1,1,0,1,0
18,339,339,27,22,5,2,1
21,371,371,15,1,14,3,2
24,374,374,1,1,0,1,0
20,391,391,53,53,0,1,0
1,396,396,40,14,26,2,1
23,420,420,23,5,18,3,2
14,425,425,125,110,15,4,3
0,438,438,8,2,6,2,1
13,458,458,82,25,57,4,3
11,478,478,77,77,0,1,0
7,479,479,31,13,18,2,1
4,486,486,67,60,7,2,1
19,500,500,19,15,4,2,1

31,110,110,20,20,0,1,0
17,111,111,14,14,0,1,0
16,131,131,11,5,6,3,2
33,133,133,4,4,0,1,0
27,136,136,4,4,0,1,0
6,153,153,1,1,0,1,0
19,157,157,13,13,0,1,0
32,169,169,7,7,0,1,0
25,174,174,2,2,0,1,0
14,191,191,13,13,0,1,0
1,203,203,5,5,0,1,0
28,238,238,17,13,4,2,1
3,251,251,43,43,0,1,0
10,255,255,47,24,23,2,1
15,258,258,26,10,16,2,1
30,265,265,18,6,12,4,3
13,267,267,33,33,0,1,0
4,283,283,11,11,0,1,0
20,298,298,42,42,0,1,0
34,298,298,130,80,50,2,1
12,309,309,21,7,14,3,2
0,313,313,6,6,0,1,0
5,346,346,34,19,15,4,3
26,354,354,43,43,0,1,0
21,380,380,76,73,3,2,1
11,380,380,8,8,0,1,0
29,393,393,6,1,5,2,1
18,400,400,85,85,0,1,0
23,413,413,15,15,0,1,0
24,440,440,67,67,0,1,0
8,467,467,10,10,0,1,0
2,478,478,6,6,0,1,0
7,484,484,21,21,0,1,0
22,486,486,11,6,5,2,1
9,495,495,87,27,60,3,2

5,105,105,4,1,3,2,1
7,106,106,3,3,0,1,0
35,115,115,18,8,10,2,1
8,116,116,23,23,0,1,0
26,126,126,1,1,0,1,0
16,129,129,1,1,0,1,0
12,141,141,3,3,0,1,0
1,143,143,2,2,0,1,0
17,149,149,12,8,4,2,1
6,152,152,17,17,0,1,0
3,162,162,1,1,0,1,0
20,165,165,6,1,5,2,1
24,174,174,14,6,8,3,2
9,174,174,9,9,0,1,0
28,176,176,57,50,7,2,1
33,191,191,4,1,3,2,1
2,200,200,32,32,0,1,0
11,210,210,21,21,0,1,0
32,222,222,53,15,38,2,1
18,241,241,5,5,0,1,0
19,248,248,39,39,0,1,0
4,293,293,10,10,0,1,0
14,295,295,7,7,0,1,0
15,308,308,7,7,0,1,0
10,309,309,15,15,0,1,0
0,309,309,36,36,0,1,0
36,317,317,30,30,0,1,0
37,320,320,45,45,0,1,0
27,329,329,2,2,0,1,0
31,338,338,4,4,0,1,0
22,379,379,20,20,0,1,0
21,382,382,4,1,3,2,1
25,402,402,67,18,49,4,3
23,449,449,19,8,11,2,1
30,459,459,9,5,4,2,1
13,472,472,148,73,75,4,3
34,479,479,79,1,78,4,3
29,494,494,54,17,37,4,3

16,121,121,23,9,14,3,2
26,142,142,29,2,27,3,2
20,158,158,20,5,15,2,1
19,187,187,23,23,0,1,0
22,213,213,48,12,36,3,2
6,218,218,33,18,15,4,3
4,229,229,21,13,8,3,2
28,237,237,13,13,0,1,0
3,279,279,27,1,26,2,1
23,285,285,23,23,0,1,0
17,286,286,50,2,48,3,2
10,291,291,46,5,41,2,1
21,293,293,22,15,7,2,1
11,315,315,32,32,0,1,0
13,317,317,20,20,0,1,0
2,334,334,83,83,0,1,0
15,343,343,41,41,0,1,0
24,344,344,26,26,0,1,0
9,349,349,23,23,0,1,0
5,356,356,13,13,0,1,0
8,366,366,136,123,13,2,1
12,371,371,3,3,0,1,0
0,372,372,28,28,0,1,0
27,376,376,7,1,6,2,1
14,419,419,14,4,10,2,1
1,426,426,26,2,24,2,1
7,450,450,61,61,0,1,0
25,467,467,15,6,9,4,3
18,482,482,22,22,0,1,0

4,101,101,10,5,5,2,1
35,119,119,8,8,0,1,0
13,120,120,5,1,4,2,1
33,172,172,12,12,0,1,0
5,188,188,1,1,0,1,0
31,191,191,10,10,0,1,0
8,224,224,30,20,10,3,2
27,245,245,30,30,0,1,0
20,272,272,18,7,11,2,1
24,298,298,9,9,0,1,0
1,299,299,68,26,42,4,3
23,301,301,4,4,0,1,0
7,311,311,7,7,0,1,0
17,312,312,12,4,8,2,1
34,325,325,11,11,0,1,0
11,342,342,1,1,0,1,0
0,342,342,30,30,0,1,0
28,358,358,34,7,27,4,3
10,362,362,8,8,0,1,0
21,364,364,103,103,0,1,0
12,369,369,8,5,3,2,1
19,376,376,6,6,0,1,0
15,389,389,15,4,11,2,1
9,399,399,6,6,0,1,0
3,402,402,8,5,3,2,1
18,408,408,7,7,0,1,0
14,410,410,110,110,0,1,0
25,411,411,58,46,12,3,2
32,420,420,57,21,36,4,3
6,445,445,116,116,0,1,0
29,446,446,37,37,0,1,0
16,449,449,53,23,30,4,3
26,460,460,72,72,0,1,0
30,480,480,98,62,36,2,1
22,481,481,38,33,5,2,1
2,490,490,71,71,0,1,0

19,132,132,11,11,0,1,0
6,147,147,18,18,0,1,0
2,158,158,13,13,0,1,0
8,161,161,1,1,0,1,0
18,168,168,23,23,0,1,0
27,188,188,12,12,0,1,0
4,196,196,6,6,0,1,0
17,197,197,6,2,4,2,1
12,202,202,3,3,0,1,0
26,204,204,41,11,30,4,3
25,209,209,8,1,7,2,1
11,209,209,24,24,0,1,0
13,217,217,20,20,0,1,0
22,222,222,1,1,0,1,0
0,276,276,81,81,0,1,0
7,277,277,40,40,0,1,0
14,291,291,24,24,0,1,0
9,309,309,85,62,23,2,1
1,353,353,20,20,0,1,0
24,358,358,91,42,49,4,3
10,359,359,81,38,43,2,1
23,363,363,38,38,0,1,0
21,369,369,60,60,0,1,0
5,403,403,58,17,41,2,1
20,430,430,81,81,0,1,0
16,452,452,62,62,0,1,0
15,464,464,17,3,14,2,1
3,498,498,54,54,0,1,0

33,103,103,13,13,0,1,0
0,105,105,7,1,6,2,1
18,110,110,4,4,0,1,0
7,112,112,2,2,0,1,0
12,114,114,14,14,0,1,0
19,120,120,3,3,0,1,0
15,121,121,1,1,0,1,0
3,126,126,4,4,0,1,0
34,146,146,30,30,0,1,0
13,150,150,6,6,0,1,0
29,153,153,7,7,0,1,0
10,159,159,57,22,35,2,1
1,166,166,7,2,5,2,1
17,166,166,13,5,8,2,1
26,170,170,10,10,0,1,0
8,178,178,5,5,0,1,0
6,201,201,9,1,8,3,2
28,206,206,2,2,0,1,0
20,207,207,2,2,0,1,0
21,220,220,6,6,0,1,0
16,234,234,1,1,0,1,0
32,249,249,34,34,0,1,0
22,286,286,22,22,0,1,0
5,307,307,13,13,0,1,0
14,312,312,1,1,0,1,0
25,315,315,23,23,0,1,0
31,339,339,51,51,0,1,0
36,360,360,67,34,33,4,3
9,361,361,22,6,16,2,1
27,373,373,18,18,0,1,0
30,385,385,18,2,16,3,2
23,409,409,27,27,0,1,0
2,423,423,55,55,0,1,0
11,426,426,123,123,0,1,0
4,433,433,25,14,11,2,1
37,434,434,56,56,0,1,0
24,482,482,40,12,28,3,2
35,489,489,58,7,51,4,3
38,495,495,75,21,54,3,2

8,102,102,10,10,0,1,0
0,103,103,11,3,8,3,2
24,105,105,13,13,0,1,0
7,108,108,15,3,12,2,1
15,132,132,11,3,8,3,2
21,133,133,11,2,9,4,3
14,195,195,27,8,19,2,1
28,229,229,51,19,32,3,2
2,232,232,16,16,0,1,0
13,241,241,34,6,28,2,1
26,268,268,27,5,22,3,2
11,314,314,11,2,9,2,1
12,330,330,2,2,0,1,0
20,343,343,73,73,0,1,0
10,343,343,49,33,16,2,1
4,354,354,77,77,0,1,0
1,375,375,14,14,0,1,0
23,399,399,7,7,0,1,0
18,400,400,25,25,0,1,0
27,403,403,15,15,0,1,0
3,405,405,16,1,15,4,3
6,406,406,63,46,17,2,1
22,411,411,75,47,28,3,2
19,412,412,77,77,0,1,0
17,419,419,9,9,0,1,0
29,421,421,16,1,15,4,3
9,431,431,120,112,8,2,1
16,446,446,46,46,0,1,0
25,473,473,11,11,0,1,0
5,495,495,68,68,0,1,0

23,103,103,7,7,0,1,0
13,125,125,7,7,0,1,0
1,127,127,26,7,19,3,2
2,163,163,2,2,0,1,0
14,172,172,12,3,9,2,1
4,179,179,104,104,0,1,0
16,182,182,16,16,0,1,0
0,196,196,20,5,15,2,1
6,266,266,14,5,9,4,3
15,277,277,76,3,73,4,3
10,294,294,21,21,0,1,0
19,317,317,72,72,0,1,0
21,329,329,6,6,0,1,0
27,352,352,2,2,0,1,0
26,360,360,56,14,42,2,1
17,361,361,117,66,51,4,3
18,382,382,24,24,0,1,0
24,391,391,45,45,0,1,0
20,393,393,4,4,0,1,0
25,439,439,50,20,30,3,2
9,450,450,96,70,26,3,2
22,452,452,6,1,5,2,1
8,453,453,46,4,42,2,1
7,469,469,5,5,0,1,0
3,475,475,47,32,15,4,3
5,484,484,12,12,0,1,0
12,495,495,11,11,0,1,0
11,500,500,64,6,58,3,2

31,110,110,35,35,0,1,0
14,111,111,14,11,3,2,1
23,113,113,7,7,0,1,0
3,135,135,24,18,6,3,2
13,135,135,3,3,0,1,0
32,156,156,20,20,0,1,0
25,168,168,16,2,14,3,2
9,175,175,8,8,0,1,0
18,179,179,5,5,0,1,0
29,194,194,16,16,0,1,0
27,195,195,12,3,9,4,3
22,216,216,7,7,0,1,0
28,223,223,19,19,0,1,0
17,244,244,11,11,0,1,0
15,251,251,1,1,0,1,0
19,259,259,55,55,0,1,0
1,297,297,2,2,0,1,0
10,306,306,1,1,0,1,0
20,325,325,22,2,20,3,2
7,351,351,45,45,0,1,0
21,358,358,1,1,0,1,0
8,365,365,46,2,44,2,1
2,370,370,126,126,0,1,0
30,380,380,101,68,33,4,3
11,395,395,28,28,0,1,0
5,395,395,42,42,0,1,0
24,477,477,69,51,18,4,3
6,478,478,51,51,0,1,0
12,486,486,24,12,12,4,3
4,486,486,8,5,3,2,1
26,487,487,4,4,0,1,0
16,488,488,59,19,40,3,2
0,489,489,73,17,56,3,2

23,104,104,11,5,6,2,1
31,110,110,1,1,0,1,0
12,129,129,4,1,3,2,1
33,133,133,10,10,0,1,0
3,134,134,2,2,0,1,0
8,165,165,29,13,16,2,1
14,173,173,10,10,0,1,0
24,176,176,17,4,13,2,1
18,182,182,39,39,0,1,0
26,186,186,12,12,0,1,0
29,196,196,44,14,30,3,2
28,220,220,25,4,21,2,1
1,224,224,10,10,0,1,0
0,240,240,42,42,0,1,0
19,248,248,46,46,0,1,0
21,283,283,26,26,0,1,0
17,288,288,16,16,0,1,0
15,299,299,1,1,0,1,0
5,301,301,6,3,3,2,1
27,305,305,37,37,0,1,0
25,331,331,4,4,0,1,0
4,379,379,102,3,99,4,3
16,397,397,95,54,41,2,1
11,411,411,19,11,8,2,1
22,417,417,80,80,0,1,0
7,429,429,32,3,29,2,1
30,440,440,21,9,12,3,2
2,465,465,5,5,0,1,0
13,473,473,92,62,30,2,1
20,476,476,20,20,0,1,0
9,484,484,70,40,30,2,1
32,484,484,19,19,0,1,0
10,485,485,4,1,3,2,1
6,497,497,18,18,0,1,0

25,109,109,12,3,9,2,1
3,112,112,1,1,0,1,0
15,121,121,3,3,0,1,0
27,136,136,66,58,8,3,2
12,153,153,15,15,0,1,0
13,208,208,1,1,0,1,0
26,210,210,20,20,0,1,0
11,214,214,24,5,19,3,2
22,238,238,11,4,7,2,1
14,260,260,14,14,0,1,0
16,277,277,6,6,0,1,0
23,278,278,1,1,0,1,0
17,301,301,49,29,20,2,1
9,314,314,22,16,6,2,1
6,317,317,23,14,9,2,1
0,320,320,4,1,3,2,1
1,331,331,233,185,48,3,2
19,367,367,18,18,0,1,0
8,391,391,49,49,0,1,0
24,393,393,98,16,82,3,2
4,394,394,10,1,9,2,1
5,400,400,78,78,0,1,0
2,413,413,95,24,71,4,3
18,417,417,41,41,0,1,0
7,428,428,19,7,12,3,2
20,441,441,35,35,0,1,0
21,489,489,28,17,11,4,3
10,491,491,1,1,0,1,0

3,107,107,5,5,0,1,0
25,107,107,6,3,3,2,1
20,129,129,52,20,32,2,1
8,136,136,38,12,26,3,2
9,140,140,10,1,9,4,3
34,141,141,10,10,0,1,0
6,184,184,7,1,6,2,1
2,189,189,42,42,0,1,0
21,190,190,22,22,0,1,0
32,211,211,12,12,0,1,0
31,225,225,22,8,14,2,1
27,225,225,42,14,28,2,1
30,236,236,32,8,24,4,3
5,238,238,9,9,0,1,0
0,239,239,14,14,0,1,0
11,240,240,5,5,0,1,0
4,253,253,63,24,39,4,3
26,287,287,2,2,0,1,0
15,289,289,7,7,0,1,0
22,289,289,72,24,48,2,1
18,294,294,18,7,11,2,1
23,299,299,3,3,0,1,0
33,310,310,16,16,0,1,0
7,321,321,7,7,0,1,0
14,338,338,18,18,0,1,0
1,342,342,44,44,0,1,0
10,349,349,44,23,21,2,1
12,352,352,7,7,0,1,0
17,352,352,3,3,0,1,0
35,370,370,5,5,0,1,0
24,371,371,9,9,0,1,0
29,386,386,50,50,0,1,0
16,400,400,37,37,0,1,0
13,441,441,7,7,0,1,0
28,464,464,18,18,0,1,0
19,496,496,12,12,0,1,0

25,118,118,4,4,0,1,0
26,147,147,1,1,0,1,0
19,147,147,14,3,11,2,1
8,174,174,7,1,6,3,2
30,198,198,10,4,6,2,1
34,201,201,19,19,0,1,0
28,202,202,30,12,18,4,3
4,205,205,16,16,0,1,0
23,231,231,7,7,0,1,0
10,244,244,11,11,0,1,0
14,245,245,4,4,0,1,0
16,251,251,60,6,54,3,2
22,252,252,3,3,0,1,0
29,274,274,169,169,0,1,0
17,304,304,9,9,0,1,0
31,328,328,84,14,70,4,3
12,341,341,23,11,12,2,1
5,350,350,39,13,26,2,1
9,351,351,25,4,21,2,1
13,356,356,15,15,0,1,0
2,365,365,22,22,0,1,0
32,387,387,10,2,8,3,2
27,396,396,2,2,0,1,0
35,399,399,8,1,7,2,1
20,410,410,5,5,0,1,0
33,411,411,24,24,0,1,0
0,415,415,79,46,33,4,3
36,420,420,6,1,5,2,1
21,424,424,57,17,40,3,2
24,427,427,53,53,0,1,0
1,430,430,16,16,0,1,0
6,430,430,12,12,0,1,0
18,464,464,113,79,34,2,1
15,479,479,41,14,27,2,1
11,480,480,4,4,0,1,0
3,484,484,36,36,0,1,0
7,490,490,12,12,0,1,0

0,101,101,12,12,0,1,0
29,112,112,38,38,0,1,0
32,126,126,9,1,8,3,2
8,131,131,19,19,0,1,0
7,151,151,11,5,6,2,1
5,155,155,26,26,0,1,0
21,161,161,1,1,0,1,0
14,162,162,1,1,0,1,0
16,166,166,3,3,0,1,0
19,173,173,9,9,0,1,0
17,209,209,2,2,0,1,0
26,250,250,1,1,0,1,0
15,261,261,4,4,0,1,0
33,270,270,8,8,0,1,0
34,284,284,4,4,0,1,0
35,290,290,70,70,0,1,0
10,314,314,17,17,0,1,0
22,344,344,88,39,49,4,3
6,364,364,6,6,0,1,0
18,365,365,12,4,8,3,2
3,367,367,9,9,0,1,0
1,368,368,20,12,8,3,2
31,381,381,24,24,0,1,0
28,382,382,35,35,0,1,0
24,390,390,3,3,0,1,0
11,393,393,158,158,0,1,0
12,394,394,85,85,0,1,0
13,394,394,59,55,4,2,1
30,410,410,8,8,0,1,0
23,438,438,36,36,0,1,0
27,458,458,162,18,144,4,3
25,467,467,8,8,0,1,0
4,471,471,4,4,0,1,0
9,489,489,9,9,0,1,0
2,495,495,11,8,3,2,1
20,497,497,20,6,14,2,1

6,128,128,13,13,0,1,0
11,132,132,5,5,0,1,0
17,134,134,31,12,19,2,1
34,148,148,2,2,0,1,0
28,169,169,4,4,0,1,0
19,173,173,1,1,0,1,0
26,198,198,10,2,8,3,2
32,211,211,16,10,6,3,2
16,220,220,7,3,4,2,1
23,222,222,8,1,7,2,1
10,224,224,1,1,0,1,0
0,237,237,34,34,0,1,0
35,258,258,123,51,72,4,3
18,273,273,16,7,9,2,1
25,307,307,26,20,6,2,1
1,310,310,43,9,34,4,3
24,330,330,22,3,19,4,3
12,333,333,2,2,0,1,0
8,346,346,24,24,0,1,0
7,351,351,8,8,0,1,0
5,356,356,2,2,0,1,0
30,370,370,28,28,0,1,0
14,383,383,53,53,0,1,0
15,384,384,9,9,0,1,0
27,386,386,23,11,12,3,2
9,389,389,20,20,0,1,0
3,416,416,119,71,48,4,3
2,417,417,24,24,0,1,0
31,433,433,36,26,10,3,2
13,443,443,10,4,6,3,2
29,458,458,5,5,0,1,0
33,458,458,77,77,0,1,0
4,470,470,77,61,16,2,1
20,478,478,113,113,0,1,0
21,481,481,51,51,0,1,0
22,489,489,28,28,0,1,0

5,101,101,26,26,0,1,0
25,104,104,5,1,4,2,1
15,125,125,13,4,9,4,3
11,126,126,4,4,0,1,0
23,151,151,6,6,0,1,0
4,155,155,2,2,0,1,0
24,167,167,21,21,0,1,0
1,167,167,28,10,18,3,2
2,218,218,27,18,9,4,3
8,243,243,10,10,0,1,0
16,251,251,9,9,0,1,0
7,253,253,31,31,0,1,0
10,324,324,37,37,0,1,0
14,330,330,41,41,0,1,0
22,346,346,5,2,3,2,1
26,355,355,37,37,0,1,0
3,362,362,88,88,0,1,0
18,370,370,9,9,0,1,0
17,375,375,126,112,14,2,1
19,377,377,28,16,12,3,2
6,396,396,67,49,18,3,2
0,400,400,1,1,0,1,0
21,401,401,10,10,0,1,0
13,401,401,44,44,0,1,0
29,406,406,132,62,70,3,2
9,424,424,41,29,12,2,1
27,454,454,2,2,0,1,0
28,460,460,63,63,0,1,0
12,475,475,52,52,0,1,0
20,483,483,50,50,0,1,0

16,119,119,4,4,0,1,0
27,120,120,4,4,0,1,0
26,127,127,21,7,14,3,2
31,132,132,1,1,0,1,0
34,136,136,1,1,0,1,0
28,145,145,9,9,0,1,0
5,164,164,1,1,0,1,0
10,165,165,33,11,22,3,2
1,179,179,14,3,11,2,1
7,188,188,4,4,0,1,0
0,188,188,23,23,0,1,0
18,200,200,5,5,0,1,0
33,210,210,1,1,0,1,0
37,216,216,104,83,21,4,3
8,218,218,34,16,18,3,2
4,225,225,38,38,0,1,0
17,242,242,39,9,30,2,1
3,242,242,7,7,0,1,0
21,261,261,25,19,6,3,2
23,276,276,9,9,0,1,0
30,278,278,3,3,0,1,0
12,292,292,6,6,0,1,0
11,297,297,1,1,0,1,0
24,318,318,6,6,0,1,0
15,321,321,4,4,0,1,0
22,327,327,10,10,0,1,0
14,335,335,6,6,0,1,0
6,353,353,9,5,4,2,1
38,355,355,26,26,0,1,0
20,357,357,41,12,29,2,1
9,357,357,28,25,3,2,1
32,362,362,3,3,0,1,0
25,368,368,6,6,0,1,0
36,447,447,93,48,45,2,1
35,454,454,58,58,0,1,0
13,459,459,27,27,0,1,0
29,464,464,179,179,0,1,0
19,472,472,21,9,12,4,3
2,498,498,48,48,0,1,0

9,101,101,41,7,34,2,1
17,103,103,1,1,0,1,0
1,121,121,35,35,0,1,0
6,137,137,1,1,0,1,0
24,140,140,1,1,0,1,0
28,153,153,36,29,7,2,1
5,166,166,27,27,0,1,0
25,185,185,34,1,33,4,3
11,225,225,6,6,0,1,0
23,233,233,14,1,13,2,1
16,253,253,4,4,0,1,0
27,264,264,16,16,0,1,0
21,283,283,81,12,69,4,3
18,285,285,9,1,8,2,1
15,298,298,133,85,48,3,2
29,303,303,26,26,0,1,0
26,313,313,38,18,20,3,2
3,329,329,27,3,24,4,3
0,340,340,21,8,13,2,1
10,341,341,41,3,38,4,3
4,364,364,98,64,34,3,2
22,375,375,6,2,4,2,1
12,383,383,20,4,16,3,2
7,393,393,12,8,4,2,1
19,396,396,6,6,0,1,0
13,400,400,17,7,10,2,1
2,429,429,18,18,0,1,0
8,471,471,4,4,0,1,0
20,488,488,1,1,0,1,0
14,496,496,33,33,0,1,0

14,101,101,9,9,0,1,0
18,125,125,29,3,26,3,2
30,130,130,3,3,0,1,0
10,137,137,1,1,0,1,0
11,154,154,1,1,0,1,0
5,195,195,20,1,19,2,1
31,197,197,39,24,15,2,1
22,203,203,20,20,0,1,0
21,203,203,25,25,0,1,0
26,208,208,70,36,34,2,1
29,210,210,14,2,12,4,3
19,259,259,11,5,6,3,2
3,271,271,18,4,14,2,1
7,278,278,3,3,0,1,0
27,282,282,1,1,0,1,0
23,293,293,27,27,0,1,0
17,297,297,31,17,14,2,1
6,314,314,17,17,0,1,0
9,340,340,52,26,26,2,1
0,342,342,110,110,0,1,0
20,360,360,17,17,0,1,0
1,370,370,105,105,0,1,0
13,386,386,50,50,0,1,0
4,386,386,17,4,13,2,1
24,400,400,6,6,0,1,0
32,422,422,15,1,14,2,1
28,426,426,76,28,48,4,3
16,428,428,42,42,0,1,0
8,460,460,10,4,6,3,2
2,463,463,2,2,0,1,0
15,464,464,25,15,10,3,2
25,470,470,30,14,16,2,1
33,472,472,33,33,0,1,0
12,490,490,24,2,22,3,2

31,113,113,7,4,3,2,1
10,122,122,23,7,16,2,1
24,125,125,10,6,4,2,1
28,126,126,19,11,8,2,1
9,130,130,7,7,0,1,0
15,150,150,16,4,12,3,2
19,159,159,5,5,0,1,0
20,178,178,2,2,0,1,0
3,180,180,9,9,0,1,0
17,214,214,11,2,9,2,1
13,216,216,58,28,30,4,3
5,220,220,21,10,11,2,1
16,220,220,57,36,21,2,1
29,225,225,30,30,0,1,0
30,226,226,38,4,34,3,2
4,245,245,35,35,0,1,0
7,255,255,23,6,17,4,3
11,281,281,13,13,0,1,0
18,294,294,54,4,50,2,1
25,323,323,88,51,37,2,1
21,348,348,36,36,0,1,0
22,356,356,12,2,10,4,3
26,394,394,25,22,3,2,1
2,419,419,58,58,0,1,0
27,421,421,10,10,0,1,0
6,422,422,11,11,0,1,0
14,435,435,77,77,0,1,0
8,443,443,1,1,0,1,0
0,461,461,43,43,0,1,0
1,478,478,37,37,0,1,0
12,492,492,24,24,0,1,0
23,496,496,9,6,3,2,1

9,101,101,21,21,0,1,0
12,107,107,11,11,0,1,0
22,127,127,26,14,12,3,2
11,132,132,3,3,0,1,0
16,147,147,23,23,0,1,0
25,150,150,17,4,13,2,1
19,153,153,11,11,0,1,0
28,160,160,14,6,8,2,1
7,189,189,7,7,0,1,0
15,194,194,11,11,0,1,0
27,200,200,4,1,3,2,1
21,209,209,19,19,0,1,0
4,218,218,73,46,27,4,3
18,219,219,2,2,0,1,0
1,263,263,68,68,0,1,0
23,287,287,45,45,0,1,0
26,339,339,60,31,29,2,1
3,344,344,71,3,68,3,2
6,345,345,65,18,47,2,1
17,346,346,9,4,5,2,1
8,356,356,35,35,0,1,0
14,367,367,3,3,0,1,0
20,372,372,18,18,0,1,0
24,393,393,136,97,39,2,1
5,435,435,3,3,0,1,0
0,448,448,9,9,0,1,0
13,460,460,31,3,28,3,2
10,466,466,42,18,24,2,1
2,492,492,17,12,5,2,1

18,121,121,17,17,0,1,0
24,149,149,33,33,0,1,0
28,154,154,41,41,0,1,0
13,156,156,24,24,0,1,0
26,158,158,24,20,4,2,1
2,163,163,4,4,0,1,0
25,178,178,20,11,9,2,1
8,189,189,38,20,18,4,3
4,207,207,3,3,0,1,0
15,238,238,40,9,31,2,1
19,244,244,3,3,0,1,0
1,246,246,11,11,0,1,0
30,246,246,14,6,8,3,2
14,276,276,4,4,0,1,0
0,286,286,26,2,24,4,3
27,305,305,60,22,38,3,2
16,329,329,15,3,12,4,3
17,336,336,17,14,3,2,1
7,338,338,126,17,109,4,3
12,338,338,7,2,5,2,1
10,349,349,6,6,0,1,0
21,350,350,8,2,6,3,2
22,361,361,10,10,0,1,0
23,402,402,6,6,0,1,0
29,407,407,29,21,8,3,2
32,408,408,5,5,0,1,0
3,413,413,1,1,0,1,0
34,424,424,25,25,0,1,0
31,448,448,11,3,8,2,1
33,477,477,94,33,61,4,3
5,478,478,11,11,0,1,0
11,479,479,18,1,17,4,3
6,479,479,54,54,0,1,0
20,486,486,89,89,0,1,0
9,491,491,35,35,0,1,0

17,101,101,4,4,0,1,0
21,104,104,4,4,0,1,0
31,108,108,6,6,0,1,0
14,110,110,1,1,0,1,0
30,113,113,32,17,15,4,3
34,119,119,10,2,8,2,1
15,120,120,13,13,0,1,0
27,134,134,5,5,0,1,0
16,154,154,2,2,0,1,0
32,154,154,24,13,11,2,1
9,177,177,1,1,0,1,0
35,179,179,13,2,11,2,1
29,184,184,14,2,12,3,2
25,202,202,6,2,4,2,1
19,216,216,10,4,6,2,1
10,252,252,45,45,0,1,0
22,253,253,33,33,0,1,0
33,268,268,50,50,0,1,0
26,272,272,6,6,0,1,0
20,290,290,20,9,11,2,1
8,293,293,21,7,14,3,2
36,312,312,27,27,0,1,0
24,321,321,77,24,53,3,2
23,324,324,9,9,0,1,0
11,333,333,7,7,0,1,0
4,338,338,1,1,0,1,0
6,347,347,16,16,0,1,0
0,395,395,1,1,0,1,0
2,397,397,15,5,10,2,1
5,412,412,36,12,24,3,2
7,441,441,18,18,0,1,0
13,449,449,57,57,0,1,0
1,459,459,149,149,0,1,0
28,463,463,62,62,0,1,0
12,469,469,34,34,0,1,0
18,479,479,34,34,0,1,0
3,486,486,111,15,96,4,3

7,101,101,8,8,0,1,0
19,101,101,5,5,0,1,0
0,103,103,17,17,0,1,0
29,134,134,6,6,0,1,0
14,145,145,8,8,0,1,0
31,148,148,30,14,16,2,1
18,164,164,9,9,0,1,0
11,165,165,6,3,3,2,1
27,179,179,5,2,3,2,1
8,189,189,25,25,0,1,0
20,199,199,27,10,17,2,1
12,205,205,24,24,0,1,0
22,234,234,22,2,20,3,2
9,237,237,11,11,0,1,0
4,241,241,27,27,0,1,0
15,242,242,1,1,0,1,0
5,278,278,11,5,6,3,2
23,307,307,45,45,0,1,0
28,307,307,46,25,21,2,1
24,311,311,80,80,0,1,0
30,319,319,22,5,17,4,3
16,327,327,1,1,0,1,0
32,358,358,55,17,38,2,1
25,361,361,30,4,26,3,2
26,364,364,35,8,27,4,3
10,367,367,27,21,6,2,1
13,374,374,69,69,0,1,0
33,391,391,17,17,0,1,0
21,392,392,14,14,0,1,0
2,405,405,1,1,0,1,0
1,430,430,24,10,14,2,1
3,434,434,134,62,72,4,3
17,456,456,4,4,0,1,0
6,475,475,84,84,0,1,0

17,107,107,1,1,0,1,0
6,118,118,8,1,7,2,1
19,121,121,5,2,3,2,1
3,122,122,1,1,0,1,0
18,154,154,41,15,26,2,1
31,160,160,65,33,32,2,1
8,179,179,10,7,3,2,1
24,205,205,20,9,11,2,1
11,210,210,20,2,18,4,3
4,241,241,95,47,48,2,1
7,243,243,32,6,26,2,1
20,244,244,34,34,0,1,0
22,302,302,12,4,8,2,1
30,338,338,25,25,0,1,0
0,355,355,47,33,14,2,1
15,372,372,39,39,0,1,0
10,390,390,44,44,0,1,0
26,392,392,7,7,0,1,0
16,393,393,47,10,37,2,1
14,393,393,29,29,0,1,0
21,397,397,1,1,0,1,0
29,402,402,52,52,0,1,0
28,418,418,49,9,40,3,2
12,426,426,73,73,0,1,0
2,428,428,18,18,0,1,0
5,435,435,1,1,0,1,0
1,435,435,19,8,11,2,1
25,440,440,49,10,39,4,3
27,447,447,25,25,0,1,0
13,449,449,72,18,54,3,2
9,468,468,2,2,0,1,0
23,479,479,2,2,0,1,0

35,105,105,24,24,0,1,0
10,118,118,23,6,17,2,1
29,124,124,31,1,30,3,2
19,134,134,53,4,49,2,1
11,138,138,16,16,0,1,0
24,146,146,11,11,0,1,0
2,154,154,5,1,4,2,1
26,162,162,20,8,12,4,3
14,167,167,17,4,13,2,1
31,167,167,8,8,0,1,0
25,199,199,1,1,0,1,0
21,199,199,21,21,0,1,0
16,203,203,9,9,0,1,0
4,209,209,12,12,0,1,0
6,225,225,8,8,0,1,0
15,245,245,29,1,28,2,1
18,252,252,7,7,0,1,0
1,266,266,24,14,10,2,1
28,279,279,14,2,12,2,1
9,297,297,8,8,0,1,0
34,300,300,9,9,0,1,0
7,334,334,9,5,4,2,1
33,353,353,12,2,10,3,2
22,374,374,105,35,70,3,2
8,388,388,24,24,0,1,0
5,392,392,9,6,3,2,1
17,395,395,1,1,0,1,0
27,419,419,17,17,0,1,0
3,422,422,23,23,0,1,0
30,423,423,47,47,0,1,0
32,430,430,66,23,43,2,1
23,436,436,38,38,0,1,0
13,463,463,23,5,18,4,3
20,465,465,6,3,3,2,1
0,466,466,35,17,18,3,2
12,491,491,34,7,27,4,3

31,138,138,5,5,0,1,0
35,140,140,10,10,0,1,0
24,152,152,18,6,12,2,1
2,152,152,23,23,0,1,0
34,163,163,40,40,0,1,0
33,182,182,18,18,0,1,0
20,190,190,1,1,0,1,0
12,198,198,5,5,0,1,0
21,200,200,4,4,0,1,0
18,204,204,9,6,3,2,1
26,219,219,91,61,30,3,2
17,226,226,1,1,0,1,0
29,234,234,9,9,0,1,0
27,238,238,11,11,0,1,0
32,244,244,14,7,7,2,1
8,249,249,27,2,25,2,1
23,263,263,1,1,0,1,0
30,272,272,62,62,0,1,0
4,275,275,14,14,0,1,0
5,280,280,7,7,0,1,0
19,289,289,7,7,0,1,0
11,314,314,69,69,0,1,0
6,323,323,26,15,11,2,1
22,340,340,47,47,0,1,0
1,350,350,17,4,13,2,1
10,377,377,6,3,3,2,1
13,381,381,5,5,0,1,0
16,415,415,4,4,0,1,0
9,425,425,146,146,0,1,0
3,429,429,21,21,0,1,0
14,441,441,6,6,0,1,0
0,458,458,14,8,6,3,2
28,464,464,19,19,0,1,0
25,466,466,35,4,31,4,3
7,466,466,21,18,3,2,1
15,497,497,149,140,9,4,3

20,115,115,16,2,14,3,2
5,117,117,6,6,0,1,0
7,124,124,35,17,18,4,3
0,184,184,39,12,27,4,3
23,194,194,25,6,19,2,1
25,195,195,24,4,20,3,2
6,198,198,43,43,0,1,0
11,200,200,9,1,8,2,1
16,210,210,6,6,0,1,0
24,216,216,11,6,5,2,1
4,254,254,11,11,0,1,0
26,261,261,21,2,19,2,1
13,294,294,14,5,9,2,1
14,302,302,21,10,11,2,1
9,307,307,13,13,0,1,0
22,315,315,14,14,0,1,0
2,315,315,10,10,0,1,0
15,335,335,108,12,96,4,3
3,370,370,58,20,38,2,1
17,373,373,25,10,15,3,2
12,379,379,112,27,85,4,3
21,406,406,8,5,3,2,1
19,443,443,4,4,0,1,0
8,449,449,110,110,0,1,0
1,454,454,44,44,0,1,0
27,472,472,68,6,62,3,2
10,479,479,85,57,28,3,2
18,481,481,30,30,0,1,0

34,104,104,14,2,12,2,1
20,106,106,24,24,0,1,0
23,107,107,7,7,0,1,0
22,109,109,16,16,0,1,0
2,115,115,6,6,0,1,0
25,135,135,5,2,3,2,1
28,140,140,3,3,0,1,0
11,148,148,6,6,0,1,0
26,159,159,35,35,0,1,0
24,162,162,3,3,0,1,0
16,163,163,12,12,0,1,0
19,163,163,12,12,0,1,0
18,171,171,37,37,0,1,0
13,200,200,58,58,0,1,0
14,238,238,17,2,15,2,1
33,244,244,16,16,0,1,0
12,244,244,5,2,3,2,1
7,258,258,25,25,0,1,0
10,294,294,11,8,3,2,1
29,342,342,32,32,0,1,0
30,354,354,26,11,15,2,1
15,359,359,34,1,33,4,3
8,365,365,21,14,7,2,1
4,385,385,9,9,0,1,0
21,391,391,85,85,0,1,0
17,398,398,122,122,0,1,0
3,404,404,43,43,0,1,0
32,406,406,13,13,0,1,0
1,433,433,30,18,12,4,3
27,441,441,35,7,28,4,3
5,443,443,1,1,0,1,0
0,460,460,9,5,4,2,1
6,466,466,3,3,0,1,0
9,468,468,7,4,3,2,1
31,481,481,71,32,39,2,1

1,103,103,11,11,0,1,0
16,109,109,1,1,0,1,0
3,120,120,1,1,0,1,0
26,137,137,8,3,5,2,1
6,144,144,3,3,0,1,0
22,165,165,24,24,0,1,0
34,169,169,5,1,4,2,1
2,173,173,6,2,4,2,1
24,177,177,33,5,28,3,2
30,184,184,17,17,0,1,0
32,215,215,51,8,43,2,1
8,241,241,7,7,0,1,0
29,243,243,41,17,24,3,2
28,247,247,20,12,8,3,2
4,253,253,13,5,8,2,1
10,264,264,47,47,0,1,0
36,295,295,24,4,20,2,1
13,300,300,5,5,0,1,0
17,322,322,72,40,32,2,1
25,328,328,29,9,20,3,2
5,334,334,19,19,0,1,0
19,341,341,35,26,9,4,3
11,360,360,91,57,34,2,1
9,364,364,28,12,16,2,1
0,378,378,2,2,0,1,0
21,383,383,61,28,33,4,3
14,407,407,54,30,24,3,2
27,416,416,38,38,0,1,0
20,419,419,20,5,15,4,3
12,437,437,2,2,0,1,0
18,448,448,39,21,18,4,3
23,455,455,16,16,0,1,0
35,491,491,37,13,24,4,3
31,492,492,37,37,0,1,0
33,493,493,12,5,7,2,1
7,496,496,36,24,12,2,1
15,497,497,41,1,40,3,2

3,152,152,3,3,0,1,0
14,157,157,1,1,0,1,0
5,158,158,1,1,0,1,0
15,183,183,58,58,0,1,0
22,183,183,25,16,9,2,1
26,188,188,3,3,0,1,0
12,190,190,2,2,0,1,0
4,191,191,3,3,0,1,0
18,191,191,22,22,0,1,0
25,199,199,26,15,11,2,1
7,200,200,14,14,0,1,0
8,202,202,2,2,0,1,0
21,255,255,8,8,0,1,0
27,257,257,26,26,0,1,0
6,257,257,56,38,18,2,1
16,269,269,18,18,0,1,0
19,283,283,24,4,20,2,1
9,292,292,34,5,29,4,3
32,297,297,10,10,0,1,0
23,300,300,48,48,0,1,0
10,325,325,22,16,6,3,2
20,335,335,33,8,25,2,1
2,344,344,6,6,0,1,0
11,370,370,10,10,0,1,0
31,371,371,1,1,0,1,0
0,388,388,103,103,0,1,0
13,390,390,56,53,3,2,1
33,431,431,27,27,0,1,0
30,434,434,11,11,0,1,0
17,450,450,87,87,0,1,0
24,454,454,135,135,0,1,0
28,460,460,36,18,18,3,2
29,480,480,121,24,97,4,3
1,493,493,15,4,11,4,3

26,124,124,7,7,0,1,0
25,141,141,4,4,0,1,0
12,147,147,4,4,0,1,0
29,175,175,3,3,0,1,0
33,221,221,7,7,0,1,0
17,224,224,1,1,0,1,0
7,228,228,1,1,0,1,0
3,235,235,9,6,3,2,1
13,251,251,29,29,0,1,0
20,255,255,63,7,56,3,2
24,255,255,25,25,0,1,0
28,259,259,25,9,16,4,3
23,260,260,46,12,34,2,1
36,265,265,62,11,51,3,2
18,300,300,64,64,0,1,0
1,305,305,1,1,0,1,0
4,313,313,15,15,0,1,0
5,330,330,16,16,0,1,0
8,344,344,1,1,0,1,0
32,359,359,6,6,0,1,0
10,360,360,22,15,7,2,1
37,360,360,9,9,0,1,0
31,361,361,82,20,62,3,2
16,367,367,34,34,0,1,0
9,372,372,5,5,0,1,0
6,386,386,78,60,18,2,1
14,391,391,14,1,13,2,1
15,394,394,4,4,0,1,0
22,394,394,9,9,0,1,0
11,400,400,70,70,0,1,0
27,405,405,35,2,33,2,1
30,430,430,12,12,0,1,0
19,434,434,49,49,0,1,0
21,447,447,10,4,6,2,1
0,448,448,4,4,0,1,0
34,452,452,23,23,0,1,0
38,467,467,110,86,24,3,2
2,483,483,44,44,0,1,0
35,497,497,108,8,100,3,2

14,108,108,6,6,0,1,0
12,112,112,18,18,0,1,0
3,120,120,12,12,0,1,0
22,137,137,1,1,0,1,0
8,141,141,30,6,24,3,2
19,148,148,25,25,0,1,0
4,160,160,21,21,0,1,0
11,164,164,2,2,0,1,0
13,167,167,28,28,0,1,0
10,168,168,8,8,0,1,0
9,179,179,8,8,0,1,0
20,186,186,15,2,13,2,1
2,193,193,3,3,0,1,0
0,200,200,19,19,0,1,0
7,224,224,17,3,14,3,2
17,272,272,4,4,0,1,0
21,279,279,22,6,16,2,1
26,280,280,23,9,14,2,1
5,294,294,12,12,0,1,0
15,296,296,27,7,20,2,1
24,348,348,4,4,0,1,0
18,365,365,94,26,68,3,2
16,377,377,5,5,0,1,0
6,388,388,16,3,13,2,1
27,409,409,11,11,0,1,0
25,445,445,136,82,54,4,3
1,464,464,213,111,102,4,3
23,465,465,11,11,0,1,0
29,481,481,85,85,0,1,0
28,486,486,114,49,65,4,3

5,105,105,1,1,0,1,0
13,109,109,8,4,4,2,1
23,116,116,2,2,0,1,0
14,128,128,25,1,24,2,1
1,169,169,14,14,0,1,0
2,173,173,24,6,18,3,2
11,177,177,1,1,0,1,0
9,230,230,46,46,0,1,0
20,256,256,1,1,0,1,0
22,270,270,35,35,0,1,0
10,273,273,49,49,0,1,0
7,298,298,105,29,76,3,2
18,301,301,112,35,77,4,3
4,310,310,103,49,54,4,3
8,315,315,11,11,0,1,0
19,327,327,10,10,0,1,0
12,394,394,13,3,10,2,1
21,444,444,8,8,0,1,0
17,447,447,133,133,0,1,0
0,453,453,137,75,62,4,3
16,465,465,18,9,9,2,1
15,469,469,4,4,0,1,0
3,469,469,54,12,42,2,1
6,476,476,127,127,0,1,0

0,104,104,3,3,0,1,0
21,109,109,4,4,0,1,0
29,112,112,5,5,0,1,0
3,124,124,23,8,15,4,3
22,144,144,4,4,0,1,0
13,152,152,18,6,12,4,3
17,164,164,18,9,9,4,3
33,173,173,28,6,22,3,2
31,178,178,50,41,9,2,1
18,183,183,28,28,0,1,0
1,201,201,8,8,0,1,0
7,208,208,12,12,0,1,0
30,212,212,4,4,0,1,0
27,241,241,16,16,0,1,0
6,250,250,43,43,0,1,0
32,251,251,2,2,0,1,0
19,255,255,29,29,0,1,0
10,269,269,31,31,0,1,0
24,273,273,11,11,0,1,0
26,284,284,19,19,0,1,0
4,301,301,46,25,21,4,3
16,309,309,9,9,0,1,0
8,351,351,29,7,22,2,1
15,384,384,85,48,37,2,1
9,386,386,16,16,0,1,0
23,389,389,43,8,35,2,1
5,417,417,4,1,3,2,1
25,418,418,12,6,6,2,1
20,441,441,44,44,0,1,0
11,441,441,15,15,0,1,0
2,467,467,5,5,0,1,0
28,467,467,176,107,69,4,3
12,480,480,4,4,0,1,0
14,493,493,93,29,64,3,2

10,121,121,6,2,4,2,1
0,142,142,17,13,4,2,1
7,142,142,49,27,22,2,1
11,144,144,10,10,0,1,0
19,150,150,17,2,15,3,2
8,162,162,1,1,0,1,0
6,175,175,12,2,10,3,2
29,181,181,19,9,10,3,2
17,187,187,84,84,0,1,0
2,196,196,15,15,0,1,0
14,219,219,9,9,0,1,0
28,225,225,7,3,4,2,1
18,254,254,1,1,0,1,0
24,261,261,23,23,0,1,0
15,266,266,37,25,12,3,2
3,268,268,10,10,0,1,0
20,283,283,8,8,0,1,0
27,308,308,48,48,0,1,0
4,310,310,17,2,15,4,3
26,324,324,23,23,0,1,0
16,346,346,29,29,0,1,0
13,346,346,10,6,4,2,1
5,357,357,27,27,0,1,0
30,385,385,9,9,0,1,0
12,441,441,139,103,36,4,3
23,444,444,57,57,0,1,0
25,447,447,39,18,21,4,3
1,467,467,36,36,0,1,0
21,469,469,36,14,22,3,2
22,470,470,22,7,15,4,3
9,474,474,112,15,97,4,3

11,111,111,11,11,0,1,0
20,122,122,4,4,0,1,0
14,132,132,1,1,0,1,0
19,153,153,23,23,0,1,0
12,155,155,51,51,0,1,0
3,194,194,52,26,26,2,1
8,207,207,15,12,3,2,1
1,214,214,146,38,108,4,3
10,214,214,2,2,0,1,0
5,230,230,42,42,0,1,0
6,244,244,43,43,0,1,0
18,292,292,5,5,0,1,0
16,298,298,26,26,0,1,0
4,306,306,4,4,0,1,0
2,310,310,37,37,0,1,0
13,329,329,41,11,30,3,2
7,333,333,25,6,19,2,1
22,361,361,13,13,0,1,0
23,367,367,49,49,0,1,0
9,426,426,89,89,0,1,0
21,431,431,12,5,7,2,1
0,453,453,39,39,0,1,0
17,462,462,104,6,98,3,2
15,495,495,37,37,0,1,0

23,109,109,1,1,0,1,0
8,115,115,8,8,0,1,0
6,126,126,16,16,0,1,0
20,126,126,4,4,0,1,0
17,145,145,2,2,0,1,0
7,148,148,23,5,18,4,3
18,155,155,5,5,0,1,0
12,169,169,18,18,0,1,0
9,182,182,5,5,0,1,0
5,218,218,41,33,8,3,2
13,229,229,70,70,0,1,0
30,245,245,5,5,0,1,0
14,255,255,31,12,19,2,1
15,263,263,46,16,30,2,1
1,302,302,9,9,0,1,0
10,323,323,5,5,0,1,0
25,324,324,27,27,0,1,0
21,338,338,27,27,0,1,0
3,351,351,41,41,0,1,0
16,361,361,8,2,6,2,1
19,367,367,65,65,0,1,0
2,380,380,27,15,12,3,2
22,409,409,56,11,45,2,1
11,412,412,2,2,0,1,0
24,413,413,131,131,0,1,0
29,441,441,17,17,0,1,0
27,475,475,159,123,36,4,3
0,488,488,9,2,7,2,1
28,491,491,11,11,0,1,0
4,493,493,34,9,25,2,1
31,493,493,16,16,0,1,0
26,494,494,138,71,67,4,3

13,101,101,24,8,16,3,2
0,126,126,31,1,30,3,2
22,128,128,3,3,0,1,0
6,142,142,20,2,18,4,3
11,167,167,12,6,6,3,2
15,172,172,20,20,0,1,0
17,179,179,32,19,13,2,1
2,180,180,16,3,13,4,3
29,183,183,10,10,0,1,0
1,226,226,11,11,0,1,0
26,227,227,16,5,11,2,1
20,236,236,2,2,0,1,0
18,242,242,45,17,28,3,2
4,268,268,37,13,24,4,3
3,282,282,23,23,0,1,0
19,293,293,45,15,30,2,1
10,300,300,5,5,0,1,0
7,333,333,17,1,16,2,1
5,344,344,3,3,0,1,0
23,354,354,61,33,28,3,2
8,385,385,71,71,0,1,0
9,426,426,18,6,12,4,3
30,426,426,100,100,0,1,0
21,455,455,44,44,0,1,0
25,460,460,37,37,0,1,0
28,464,464,14,4,10,3,2
16,473,473,90,86,4,2,1
14,483,483,75,75,0,1,0
12,490,490,44,41,3,2,1
27,493,493,4,4,0,1,0
24,497,497,11,11,0,1,0

6,102,102,19,19,0,1,0
28,111,111,4,4,0,1,0
19,130,130,4,4,0,1,0
23,138,138,1,1,0,1,0
25,142,142,2,2,0,1,0
2,148,148,11,11,0,1,0
13,162,162,4,4,0,1,0
8,184,184,21,1,20,2,1
14,186,186,9,5,4,2,1
3,195,195,68,42,26,2,1
20,198,198,8,8,0,1,0
22,205,205,13,13,0,1,0
30,221,221,11,11,0,1,0
16,232,232,5,5,0,1,0
15,254,254,59,59,0,1,0
24,262,262,21,5,16,2,1
29,269,269,44,44,0,1,0
9,284,284,10,4,6,2,1
4,317,317,35,35,0,1,0
7,342,342,27,23,4,2,1
31,374,374,77,44,33,2,1
1,374,374,12,4,8,3,2
17,406,406,4,4,0,1,0
10,406,406,9,9,0,1,0
27,407,407,55,55,0,1,0
34,408,408,48,48,0,1,0
26,428,428,31,31,0,1,0
0,443,443,5,5,0,1,0
5,443,443,29,4,25,2,1
33,446,446,4,1,3,2,1
18,449,449,7,7,0,1,0
21,485,485,160,123,37,4,3
11,490,490,76,31,45,2,1
12,491,491,7,1,6,3,2
32,498,498,141,94,47,2,1

12,100,100,9,9,0,1,0
0,126,126,11,3,8,3,2
19,145,145,12,12,0,1,0
5,159,159,19,19,0,1,0
16,167,167,5,5,0,1,0
28,201,201,38,38,0,1,0
3,209,209,1,1,0,1,0
29,225,225,2,2,0,1,0
24,239,239,5,5,0,1,0
13,245,245,1,1,0,1,0
9,270,270,7,7,0,1,0
10,302,302,16,9,7,2,1
33,312,312,13,4,9,2,1
25,342,342,50,50,0,1,0
30,350,350,4,4,0,1,0
18,362,362,44,12,32,4,3
1,363,363,6,6,0,1,0
26,365,365,24,24,0,1,0
6,366,366,70,61,9,4,3
21,367,367,134,77,57,4,3
32,368,368,12,12,0,1,0
14,371,371,34,16,18,2,1
27,377,377,31,5,26,3,2
31,381,381,9,9,0,1,0
2,384,384,66,3,63,4,3
22,403,403,96,32,64,3,2
7,438,438,4,1,3,2,1
11,453,453,74,12,62,3,2
17,454,454,77,77,0,1,0
4,458,458,2,2,0,1,0
8,479,479,81,33,48,3,2
20,488,488,15,15,0,1,0
23,496,496,71,71,0,1,0
34,496,496,71,71,0,1,0
15,498,498,39,1,38,3,2

17,113,113,4,4,0,1,0
22,121,121,29,15,14,3,2
15,160,160,22,22,0,1,0
1,173,173,34,16,18,4,3
23,198,198,43,34,9,3,2
11,215,215,59,26,33,4,3
0,220,220,28,9,19,2,1
20,220,220,1,1,0,1,0
10,240,240,43,43,0,1,0
13,245,245,24,11,13,3,2
7,250,250,13,13,0,1,0
9,270,270,27,12,15,3,2
12,279,279,7,3,4,2,1
29,280,280,12,12,0,1,0
6,294,294,24,24,0,1,0
24,304,304,13,13,0,1,0
3,318,318,5,5,0,1,0
27,322,322,11,7,4,2,1
5,334,334,21,21,0,1,0
2,335,335,32,6,26,3,2
4,353,353,77,77,0,1,0
28,363,363,10,10,0,1,0
8,388,388,29,29,0,1,0
26,400,400,86,2,84,3,2
14,410,410,93,93,0,1,0
19,422,422,17,17,0,1,0
21,425,425,41,41,0,1,0
18,439,439,88,41,47,2,1
16,440,440,1,1,0,1,0
25,461,461,32,2,30,4,3

13,107,107,9,1,8,2,1
29,114,114,11,11,0,1,0
10,119,119,27,17,10,2,1
2,138,138,26,14,12,3,2
7,156,156,4,4,0,1,0
15,164,164,17,11,6,2,1
23,168,168,1,1,0,1,0
1,190,190,2,2,0,1,0
9,208,208,1,1,0,1,0
4,221,221,13,1,12,3,2
5,226,226,7,7,0,1,0
18,249,249,14,14,0,1,0
11,258,258,61,61,0,1,0
25,261,261,9,9,0,1,0
20,277,277,14,14,0,1,0
22,286,286,26,26,0,1,0
28,309,309,48,30,18,3,2
3,337,337,121,121,0,1,0
8,347,347,42,11,31,4,3
12,363,363,5,5,0,1,0
26,394,394,108,61,47,4,3
0,396,396,1,1,0,1,0
17,407,407,65,65,0,1,0
14,455,455,82,82,0,1,0
19,464,464,93,93,0,1,0
6,464,464,113,87,26,2,1
24,481,481,21,21,0,1,0
27,496,496,27,27,0,1,0
16,497,497,7,7,0,1,0
21,497,497,56,11,45,2,1

8,105,105,1,1,0,1,0
12,110,110,10,10,0,1,0
7,126,126,2,2,0,1,0
1,129,129,5,5,0,1,0
13,130,130,4,4,0,1,0
32,133,133,7,7,0,1,0
19,176,176,6,6,0,1,0
28,179,179,8,8,0,1,0
22,181,181,23,8,15,4,3
25,195,195,36,36,0,1,0
31,202,202,26,26,0,1,0
16,203,203,1,1,0,1,0
2,207,207,7,7,0,1,0
37,213,213,24,24,0,1,0
9,273,273,8,2,6,2,1
6,281,281,45,7,38,2,1
23,282,282,24,17,7,2,1
4,293,293,1,1,0,1,0
30,301,301,14,9,5,2,1
26,305,305,32,32,0,1,0
5,315,315,25,21,4,2,1
3,327,327,52,37,15,4,3
0,331,331,22,22,0,1,0
15,334,334,34,10,24,4,3
20,334,334,47,47,0,1,0
40,340,340,39,39,0,1,0
33,360,360,89,89,0,1,0
35,360,360,79,79,0,1,0
18,387,387,65,65,0,1,0
21,389,389,14,14,0,1,0
34,398,398,21,21,0,1,0
14,446,446,24,24,0,1,0
38,447,447,80,20,60,3,2
10,460,460,14,14,0,1,0
29,463,463,12,12,0,1,0
27,464,464,9,9,0,1,0
17,465,465,38,38,0,1,0
36,466,466,25,2,23,3,2
24,468,468,1,1,0,1,0
39,479,479,23,23,0,1,0
11,480,480,9,9,0,1,0

22,122,122,17,9,8,3,2
30,126,126,28,28,0,1,0
14,136,136,17,17,0,1,0
2,136,136,14,14,0,1,0
16,165,165,1,1,0,1,0
29,201,201,55,55,0,1,0
27,201,201,3,3,0,1,0
0,206,206,13,9,4,2,1
15,217,217,15,15,0,1,0
11,233,233,31,31,0,1,0
9,257,257,15,6,9,2,1
3,259,259,4,1,3,2,1
18,259,259,14,3,11,2,1
28,275,275,31,21,10,2,1
12,280,280,90,63,27,2,1
4,288,288,1,1,0,1,0
21,305,305,18,18,0,1,0
10,317,317,19,10,9,4,3
17,330,330,20,13,7,2,1
5,331,331,7,3,4,2,1
7,347,347,47,47,0,1,0
19,352,352,5,5,0,1,0
6,354,354,56,56,0,1,0
20,373,373,50,5,45,2,1
1,384,384,57,1,56,3,2
24,434,434,89,17,72,4,3
23,448,448,64,64,0,1,0
8,459,459,80,54,26,3,2
26,470,470,20,20,0,1,0
13,478,478,41,19,22,2,1
25,482,482,42,42,0,1,0

30,108,108,15,15,0,1,0
2,109,109,1,1,0,1,0
8,135,135,23,23,0,1,0
19,142,142,4,4,0,1,0
20,157,157,6,3,3,2,1
27,170,170,21,21,0,1,0
3,190,190,27,17,10,3,2
10,207,207,37,37,0,1,0
11,237,237,7,7,0,1,0
17,244,244,21,21,0,1,0
0,252,252,5,5,0,1,0
24,256,256,10,1,9,2,1
6,260,260,3,3,0,1,0
7,262,262,24,2,22,3,2
1,269,269,23,23,0,1,0
23,275,275,17,2,15,3,2
29,293,293,68,16,52,3,2
18,308,308,126,103,23,4,3
12,311,311,10,10,0,1,0
16,317,317,6,6,0,1,0
28,355,355,47,47,0,1,0
14,378,378,58,4,54,4,3
22,398,398,49,17,32,2,1
26,402,402,14,14,0,1,0
13,420,420,31,31,0,1,0
4,420,420,201,185,16,3,2
15,440,440,10,1,9,4,3
25,443,443,71,44,27,4,3
5,457,457,19,4,15,4,3
21,466,466,3,3,0,1,0
9,495,495,30,30,0,1,0
31,500,500,3,3,0,1,0

12,106,106,1,1,0,1,0
19,112,112,3,3,0,1,0
1,113,113,12,5,7,2,1
5,123,123,19,19,0,1,0
11,155,155,10,5,5,2,1
3,159,159,19,19,0,1,0
7,189,189,69,47,22,2,1
13,211,211,61,61,0,1,0
29,259,259,50,1,49,2,1
9,287,287,21,21,0,1,0
26,289,289,42,42,0,1,0
15,304,304,50,30,20,3,2
4,311,311,20,20,0,1,0
10,334,334,40,26,14,2,1
30,361,361,39,3,36,4,3
17,362,362,1,1,0,1,0
18,372,372,39,5,34,2,1
27,377,377,39,3,36,2,1
28,385,385,34,19,15,2,1
14,388,388,7,1,6,3,2
2,391,391,1,1,0,1,0
0,393,393,54,54,0,1,0
25,403,403,10,6,4,2,1
23,406,406,11,11,0,1,0
16,440,440,9,9,0,1,0
8,460,460,22,22,0,1,0
24,473,473,7,3,4,2,1
22,485,485,13,13,0,1,0
21,487,487,35,35,0,1,0
20,496,496,247,226,21,4,3
6,497,497,15,10,5,2,1

30,111,111,45,45,0,1,0
24,122,122,15,10,5,2,1
4,148,148,7,7,0,1,0
6,152,152,3,3,0,1,0
18,153,153,6,3,3,2,1
15,162,162,28,17,11,2,1
23,211,211,13,1,12,4,3
33,214,214,2,2,0,1,0
12,237,237,16,5,11,2,1
5,242,242,8,8,0,1,0
2,243,243,5,2,3,2,1
21,245,245,12,2,10,2,1
14,267,267,24,2,22,3,2
25,271,271,58,58,0,1,0
3,291,291,20,17,3,2,1
16,330,330,62,23,39,4,3
27,332,332,40,40,0,1,0
29,334,334,8,2,6,2,1
11,348,348,7,7,0,1,0
28,361,361,17,17,0,1,0
9,361,361,42,42,0,1,0
8,374,374,1,1,0,1,0
0,377,377,6,6,0,1,0
7,381,381,89,37,52,3,2
17,384,384,37,25,12,2,1
10,387,387,35,35,0,1,0
22,389,389,14,14,0,1,0
20,395,395,46,24,22,2,1
32,397,397,10,10,0,1,0
35,404,404,95,95,0,1,0
34,411,411,13,1,12,4,3
19,436,436,66,12,54,3,2
26,438,438,27,6,21,4,3
1,442,442,44,44,0,1,0
13,448,448,13,13,0,1,0
31,455,455,34,1,33,2,1

3,121,121,2,2,0,1,0
7,125,125,2,2,0,1,0
27,130,130,9,6,3,2,1
0,138,138,5,5,0,1,0
30,142,142,4,4,0,1,0
4,186,186,1,1,0,1,0
31,244,244,52,30,22,2,1
24,245,245,1,1,0,1,0
14,248,248,43,4,39,3,2
5,250,250,62,20,42,4,3
23,253,253,26,7,19,2,1
22,266,266,2,2,0,1,0
29,281,281,15,15,0,1,0
15,281,281,18,3,15,4,3
19,298,298,96,63,33,2,1
16,303,303,7,1,6,2,1
6,304,304,13,3,10,3,2
25,335,335,12,2,10,2,1
12,336,336,12,6,6,3,2
17,365,365,29,29,0,1,0
1,371,371,50,8,42,4,3
28,376,376,151,151,0,1,0
34,379,379,53,53,0,1,0
32,381,381,2,2,0,1,0
9,391,391,92,42,50,3,2
33,409,409,5,5,0,1,0
18,423,423,7,7,0,1,0
11,432,432,40,40,0,1,0
2,437,437,14,5,9,2,1
8,438,438,2,2,0,1,0
21,446,446,5,1,4,2,1
35,456,456,55,55,0,1,0
20,458,458,12,12,0,1,0
26,461,461,188,132,56,3,2
13,474,474,4,4,0,1,0
10,495,495,8,8,0,1,0

23,105,105,12,5,7,2,1
3,116,116,3,3,0,1,0
19,150,150,29,14,15,4,3
8,170,170,11,2,9,2,1
4,185,185,22,22,0,1,0
20,198,198,15,15,0,1,0
13,212,212,4,4,0,1,0
6,222,222,13,13,0,1,0
2,245,245,54,54,0,1,0
22,249,249,23,23,0,1,0
17,253,253,24,10,14,2,1
25,272,272,72,44,28,2,1
5,279,279,87,51,36,2,1
18,295,295,29,29,0,1,0
7,297,297,55,44,11,2,1
15,359,359,41,41,0,1,0
11,365,365,5,5,0,1,0
16,371,371,1,1,0,1,0
1,374,374,55,55,0,1,0
26,378,378,57,21,36,2,1
14,406,406,16,16,0,1,0
0,424,424,136,136,0,1,0
9,448,448,36,36,0,1,0
21,459,459,67,48,19,2,1
10,483,483,33,18,15,4,3
12,492,492,68,2,66,3,2
24,496,496,34,8,26,3,2

15,112,112,3,3,0,1,0
27,147,147,32,11,21,4,3
32,147,147,36,8,28,2,1
8,161,161,10,10,0,1,0
17,192,192,9,5,4,2,1
12,200,200,23,23,0,1,0
29,218,218,12,12,0,1,0
30,223,223,7,7,0,1,0
19,233,233,8,8,0,1,0
22,234,234,10,10,0,1,0
5,248,248,8,8,0,1,0
33,250,250,4,4,0,1,0
14,264,264,1,1,0,1,0
11,266,266,8,8,0,1,0
6,289,289,18,9,9,4,3
3,297,297,66,39,27,4,3
34,341,341,31,31,0,1,0
1,343,343,12,4,8,3,2
20,346,346,76,24,52,4,3
9,347,347,70,67,3,2,1
31,347,347,19,19,0,1,0
26,358,358,42,32,10,3,2
0,359,359,5,5,0,1,0
23,374,374,76,35,41,2,1
28,383,383,2,2,0,1,0
7,415,415,11,11,0,1,0
13,416,416,81,65,16,2,1
4,420,420,33,33,0,1,0
25,432,432,22,22,0,1,0
18,436,436,37,37,0,1,0
2,441,441,101,35,66,4,3
24,461,461,2,2,0,1,0
21,462,462,114,81,33,2,1
16,474,474,5,5,0,1,0
10,475,475,59,59,0,1,0

17,122,122,6,6,0,1,0
0,122,122,4,4,0,1,0
33,129,129,20,12,8,2,1
25,134,134,3,3,0,1,0
22,136,136,12,12,0,1,0
7,152,152,11,11,0,1,0
5,170,170,2,2,0,1,0
6,177,177,24,11,13,2,1
19,184,184,19,1,18,4,3
27,193,193,25,25,0,1,0
24,194,194,11,5,6,2,1
9,220,220,26,26,0,1,0
11,220,220,3,3,0,1,0
1,224,224,18,18,0,1,0
14,233,233,8,8,0,1,0
13,234,234,33,33,0,1,0
10,241,241,11,11,0,1,0
31,284,284,16,16,0,1,0
8,285,285,21,17,4,2,1
23,295,295,13,7,6,2,1
18,311,311,33,2,31,2,1
20,316,316,17,17,0,1,0
2,330,330,20,20,0,1,0
15,338,338,14,8,6,3,2
26,372,372,3,3,0,1,0
3,385,385,157,157,0,1,0
16,385,385,5,5,0,1,0
29,401,401,42,42,0,1,0
12,413,413,76,29,47,3,2
4,483,483,44,44,0,1,0
32,488,488,132,132,0,1,0
21,490,490,30,1,29,2,1
28,490,490,27,27,0,1,0
30,490,490,151,111,40,3,2

18,100,100,4,1,3,2,1
17,106,106,2,2,0,1,0
13,112,112,1,1,0,1,0
5,153,153,37,37,0,1,0
0,174,174,1,1,0,1,0
31,179,179,32,23,9,2,1
22,197,197,22,22,0,1,0
2,235,235,20,2,18,3,2
30,243,243,17,17,0,1,0
4,280,280,14,4,10,3,2
3,287,287,38,38,0,1,0
19,295,295,46,28,18,2,1
28,305,305,21,21,0,1,0
29,313,313,27,27,0,1,0
9,315,315,48,24,24,3,2
11,318,318,24,10,14,2,1
15,324,324,8,8,0,1,0
16,352,352,5,5,0,1,0
25,354,354,27,27,0,1,0
8,367,367,9,5,4,2,1
14,368,368,66,13,53,3,2
26,375,375,4,4,0,1,0
24,376,376,11,5,6,3,2
20,388,388,107,107,0,1,0
10,399,399,34,4,30,2,1
1,409,409,27,18,9,4,3
21,454,454,20,20,0,1,0
12,465,465,90,90,0,1,0
6,473,473,39,9,30,3,2
23,474,474,99,90,9,2,1
27,480,480,120,120,0,1,0
7,494,494,96,57,39,2,1

26,109,109,24,24,0,1,0
4,110,110,39,32,7,2,1
20,213,213,7,7,0,1,0
5,215,215,103,64,39,2,1
3,217,217,8,8,0,1,0
25,243,243,1,1,0,1,0
12,247,247,37,15,22,2,1
10,249,249,12,6,6,3,2
13,252,252,15,15,0,1,0
0,274,274,2,2,0,1,0
21,275,275,2,2,0,1,0
23,313,313,9,1,8,3,2
9,361,361,1,1,0,1,0
15,363,363,120,49,71,4,3
1,364,364,69,1,68,4,3
7,379,379,84,84,0,1,0
14,381,381,48,5,43,2,1
16,385,385,58,58,0,1,0
22,393,393,27,13,14,2,1
19,424,424,24,21,3,2,1
8,443,443,27,9,18,2,1
2,455,455,28,4,24,2,1
27,459,459,32,32,0,1,0
24,468,468,14,4,10,2,1
17,477,477,140,140,0,1,0
11,480,480,17,17,0,1,0
6,483,483,50,50,0,1,0
18,500,500,1,1,0,1,0

22,114,114,18,18,0,1,0
14,115,115,12,12,0,1,0
13,125,125,3,3,0,1,0
3,147,147,22,10,12,4,3
23,155,155,22,22,0,1,0
17,156,156,3,3,0,1,0
12,156,156,4,1,3,2,1
9,193,193,63,63,0,1,0
4,195,195,19,19,0,1,0
25,198,198,11,3,8,2,1
24,210,210,4,4,0,1,0
27,226,226,55,25,30,4,3
16,230,230,22,22,0,1,0
20,231,231,46,25,21,2,1
1,302,302,73,73,0,1,0
26,307,307,67,67,0,1,0
0,321,321,11,5,6,3,2
18,322,322,12,12,0,1,0
7,371,371,57,57,0,1,0
11,379,379,2,2,0,1,0
21,409,409,65,57,8,3,2
15,427,427,37,6,31,2,1
10,448,448,5,5,0,1,0
5,454,454,68,68,0,1,0
2,471,471,23,23,0,1,0
8,476,476,6,6,0,1,0
19,479,479,23,23,0,1,0
6,482,482,178,178,0,1,0

16,112,112,8,2,6,2,1
2,121,121,1,1,0,1,0
34,128,128,1,1,0,1,0
33,144,144,1,1,0,1,0
26,148,148,24,4,20,3,2
3,168,168,2,2,0,1,0
4,177,177,8,8,0,1,0
13,187,187,1,1,0,1,0
15,193,193,12,12,0,1,0
8,206,206,24,24,0,1,0
10,220,220,33,33,0,1,0
9,235,235,13,3,10,3,2
5,241,241,2,2,0,1,0
19,244,244,1,1,0,1,0
23,247,247,16,6,10,2,1
6,255,255,38,18,20,3,2
22,263,263,36,36,0,1,0
27,264,264,14,7,7,2,1
28,300,300,46,14,32,3,2
7,303,303,18,9,9,2,1
20,309,309,58,58,0,1,0
18,314,314,9,9,0,1,0
25,337,337,47,47,0,1,0
31,345,345,44,36,8,3,2
1,368,368,14,5,9,4,3
17,370,370,12,12,0,1,0
24,411,411,137,119,18,4,3
21,411,411,7,1,6,3,2
29,415,415,66,66,0,1,0
11,427,427,60,42,18,3,2
12,439,439,145,128,17,2,1
36,444,444,71,71,0,1,0
32,445,445,13,7,6,2,1
35,451,451,32,32,0,1,0
14,462,462,8,8,0,1,0
0,467,467,37,37,0,1,0
30,475,475,5,5,0,1,0

12,121,121,10,10,0,1,0
29,140,140,17,17,0,1,0
9,144,144,38,11,27,4,3
27,169,169,38,38,0,1,0
30,174,174,52,52,0,1,0
33,203,203,4,4,0,1,0
17,203,203,2,2,0,1,0
24,218,218,14,5,9,2,1
6,230,230,3,3,0,1,0
20,232,232,4,4,0,1,0
0,254,254,47,38,9,3,2
8,254,254,30,19,11,2,1
13,261,261,5,5,0,1,0
32,285,285,25,25,0,1,0
7,289,289,1,1,0,1,0
28,300,300,13,4,9,4,3
19,316,316,56,56,0,1,0
2,323,323,17,4,13,2,1
10,325,325,10,1,9,2,1
25,330,330,2,2,0,1,0
22,332,332,3,3,0,1,0
1,341,341,1,1,0,1,0
31,367,367,19,1,18,3,2
34,376,376,31,2,29,2,1
16,378,378,5,1,4,2,1
21,382,382,148,64,84,4,3
15,391,391,46,10,36,3,2
14,400,400,103,103,0,1,0
3,407,407,58,16,42,3,2
18,418,418,16,1,15,2,1
23,420,420,13,13,0,1,0
5,431,431,64,25,39,4,3
11,433,433,10,10,0,1,0
4,436,436,34,34,0,1,0
26,460,460,5,2,3,2,1

15,110,110,16,1,15,3,2
7,116,116,10,10,0,1,0
9,121,121,5,5,0,1,0
2,131,131,34,15,19,2,1
3,137,137,11,11,0,1,0
21,179,179,23,20,3,2,1
14,184,184,13,13,0,1,0
27,194,194,55,55,0,1,0
8,221,221,1,1,0,1,0
13,249,249,17,4,13,2,1
25,283,283,60,60,0,1,0
6,284,284,12,12,0,1,0
19,296,296,7,4,3,2,1
20,297,297,3,3,0,1,0
23,362,362,3,3,0,1,0
22,363,363,20,20,0,1,0
16,368,368,99,72,27,4,3
18,369,369,46,17,29,2,1
0,373,373,34,27,7,2,1
1,398,398,62,40,22,3,2
4,421,421,134,134,0,1,0
29,430,430,19,5,14,3,2
24,450,450,10,10,0,1,0
11,457,457,84,27,57,4,3
28,461,461,33,2,31,4,3
26,462,462,31,7,24,4,3
17,477,477,45,29,16,3,2
5,486,486,81,33,48,3,2
12,489,489,25,10,15,2,1
10,491,491,25,25,0,1,0

1,116,116,2,2,0,1,0
25,136,136,17,5,12,2,1
12,154,154,4,1,3,2,1
21,178,178,10,2,8,2,1
31,189,189,1,1,0,1,0
22,194,194,5,5,0,1,0
10,199,199,66,66,0,1,0
24,219,219,32,12,20,2,1
3,261,261,1,1,0,1,0
11,263,263,9,9,0,1,0
30,271,271,8,8,0,1,0
19,291,291,127,127,0,1,0
4,294,294,11,3,8,3,2
2,299,299,81,81,0,1,0
29,309,309,19,4,15,4,3
32,312,312,69,44,25,2,1
13,331,331,49,10,39,4,3
18,336,336,36,23,13,2,1
26,340,340,12,12,0,1,0
27,344,344,59,31,28,3,2
23,396,396,25,19,6,2,1
8,396,396,1,1,0,1,0
9,398,398,28,11,17,3,2
6,404,404,8,5,3,2,1
16,406,406,1,1,0,1,0
28,408,408,7,4,3,2,1
33,428,428,39,17,22,3,2
0,432,432,99,93,6,3,2
15,434,434,29,12,17,2,1
20,455,455,15,15,0,1,0
14,456,456,51,51,0,1,0
17,476,476,39,26,13,2,1
7,489,489,18,18,0,1,0
5,493,493,54,30,24,4,3

12,117,117,21,5,16,3,2
5,124,124,24,12,12,2,1
9,125,125,20,20,0,1,0
1,144,144,1,1,0,1,0
23,152,152,27,27,0,1,0
25,159,159,38,11,27,4,3
18,172,172,5,5,0,1,0
15,179,179,16,7,9,2,1
6,207,207,65,65,0,1,0
11,212,212,1,1,0,1,0
8,255,255,47,47,0,1,0
19,274,274,27,10,17,2,1
17,304,304,49,49,0,1,0
7,357,357,143,2,141,4,3
13,363,363,2,2,0,1,0
20,372,372,30,6,24,2,1
10,374,374,27,1,26,2,1
0,381,381,2,2,0,1,0
16,384,384,49,1,48,2,1
14,410,410,69,69,0,1,0
22,459,459,31,31,0,1,0
2,470,470,135,57,78,4,3
24,485,485,1,1,0,1,0
3,490,490,8,8,0,1,0
21,495,495,64,52,12,2,1
4,499,499,18,18,0,1,0

35,102,102,6,3,3,2,1
12,102,102,6,3,3,2,1
23,118,118,4,4,0,1,0
0,126,126,12,12,0,1,0
8,143,143,2,2,0,1,0
6,144,144,10,10,0,1,0
32,147,147,12,4,8,2,1
10,156,156,3,3,0,1,0
34,169,169,35,35,0,1,0
19,176,176,24,24,0,1,0
39,191,191,31,31,0,1,0
21,193,193,3,3,0,1,0
28,198,198,7,7,0,1,0
29,201,201,6,1,5,2,1
18,210,210,19,4,15,2,1
26,211,211,14,14,0,1,0
31,220,220,8,1,7,2,1
27,233,233,65,3,62,4,3
37,252,252,37,37,0,1,0
4,256,256,16,16,0,1,0
38,258,258,5,5,0,1,0
13,265,265,43,43,0,1,0
22,270,270,57,1,56,3,2
36,273,273,26,26,0,1,0
11,297,297,11,4,7,2,1
7,305,305,27,27,0,1,0
1,312,312,1,1,0,1,0
16,314,314,37,16,21,2,1
20,319,319,12,1,11,3,2
15,354,354,9,1,8,2,1
30,365,365,87,54,33,4,3
5,375,375,20,9,11,2,1
17,392,392,23,23,0,1,0
2,402,402,54,8,46,3,2
14,431,431,1,1,0,1,0
9,440,440,25,16,9,2,1
24,461,461,48,6,42,4,3
3,480,480,10,2,8,2,1
25,494,494,15,15,0,1,0
33,495,495,22,22,0,1,0

13,115,115,14,5,9,4,3
8,119,119,17,4,13,2,1
22,143,143,8,8,0,1,0
29,148,148,11,11,0,1,0
6,163,163,15,3,12,3,2
28,171,171,7,4,3,2,1
20,247,247,44,44,0,1,0
18,247,247,4,4,0,1,0
11,249,249,50,11,39,4,3
30,251,251,88,70,18,3,2
1,270,270,89,89,0,1,0
19,289,289,32,32,0,1,0
21,310,310,28,28,0,1,0
17,316,316,19,5,14,2,1
25,343,343,42,35,7,2,1
3,344,344,1,1,0,1,0
0,345,345,13,13,0,1,0
16,374,374,2,2,0,1,0
9,378,378,10,10,0,1,0
12,390,390,59,59,0,1,0
15,400,400,86,41,45,4,3
7,403,403,17,17,0,1,0
5,433,433,11,11,0,1,0
4,437,437,1,1,0,1,0
23,438,438,41,41,0,1,0
27,438,438,55,48,7,2,1
26,456,456,2,2,0,1,0
14,457,457,142,142,0,1,0
2,461,461,6,6,0,1,0
24,483,483,44,44,0,1,0
10,488,488,50,16,34,2,1

23,112,112,6,1,5,2,1
22,118,118,2,2,0,1,0
28,131,131,15,15,0,1,0
0,154,154,1,1,0,1,0
3,166,166,16,1,15,4,3
2,168,168,31,22,9,2,1
6,174,174,24,24,0,1,0
1,176,176,9,2,7,2,1
31,207,207,15,7,8,3,2
24,217,217,42,9,33,2,1
8,229,229,26,3,23,2,1
17,255,255,40,40,0,1,0
19,266,266,65,56,9,4,3
18,298,298,7,4,3,2,1
9,301,301,9,9,0,1,0
15,304,304,28,21,7,3,2
29,313,313,27,18,9,4,3
12,333,333,31,15,16,3,2
10,347,347,1,1,0,1,0
13,349,349,10,10,0,1,0
30,351,351,108,64,44,4,3
16,352,352,65,53,12,3,2
14,357,357,58,54,4,2,1
26,358,358,6,6,0,1,0
25,362,362,19,19,0,1,0
5,365,365,31,31,0,1,0
7,367,367,56,53,3,2,1
11,399,399,28,28,0,1,0
20,437,437,42,11,31,2,1
21,446,446,2,2,0,1,0
4,485,485,53,7,46,2,1
32,488,488,25,13,12,4,3
27,491,491,75,58,17,2,1

26,119,119,2,2,0,1,0
0,119,119,2,2,0,1,0
20,122,122,8,1,7,2,1
6,139,139,38,13,25,4,3
30,161,161,1,1,0,1,0
2,176,176,1,1,0,1,0
9,194,194,31,22,9,4,3
7,195,195,12,12,0,1,0
28,204,204,3,3,0,1,0
17,207,207,98,64,34,2,1
15,258,258,10,10,0,1,0
3,268,268,25,10,15,3,2
29,277,277,4,4,0,1,0
1,279,279,16,8,8,3,2
19,286,286,27,27,0,1,0
25,309,309,15,6,9,3,2
5,321,321,31,31,0,1,0
14,338,338,24,24,0,1,0
21,347,347,1,1,0,1,0
16,358,358,84,84,0,1,0
23,369,369,52,31,21,4,3
8,379,379,69,61,8,3,2
4,393,393,47,10,37,4,3
13,400,400,107,102,5,2,1
10,433,433,7,7,0,1,0
22,438,438,22,17,5,2,1
27,446,446,119,75,44,3,2
11,457,457,80,20,60,4,3
24,482,482,7,7,0,1,0
12,489,489,3,3,0,1,0
18,490,490,71,51,20,3,2

14,113,113,14,14,0,1,0
4,140,140,42,42,0,1,0
21,187,187,2,2,0,1,0
15,196,196,10,10,0,1,0
20,229,229,55,13,42,3,2
28,239,239,31,10,21,2,1
25,239,239,13,7,6,3,2
9,248,248,28,2,26,3,2
17,256,256,4,4,0,1,0
7,257,257,51,51,0,1,0
5,279,279,33,3,30,2,1
12,312,312,52,52,0,1,0
18,314,314,10,2,8,3,2
0,314,314,9,9,0,1,0
26,325,325,3,3,0,1,0
1,327,327,43,4,39,4,3
27,334,334,40,40,0,1,0
6,348,348,27,7,20,3,2
29,365,365,4,4,0,1,0
11,378,378,3,3,0,1,0
3,381,381,76,76,0,1,0
10,386,386,12,2,10,2,1
8,402,402,63,7,56,3,2
24,433,433,79,20,59,3,2
22,438,438,3,3,0,1,0
2,445,445,17,6,11,2,1
23,454,454,52,4,48,4,3
19,464,464,175,88,87,4,3
16,469,469,72,72,0,1,0
13,477,477,16,16,0,1,0

6,100,100,18,18,0,1,0
12,103,103,18,1,17,4,3
5,122,122,23,23,0,1,0
9,142,142,2,2,0,1,0
17,144,144,44,44,0,1,0
4,145,145,40,31,9,4,3
7,184,184,16,2,14,3,2
20,192,192,32,19,13,2,1
24,203,203,14,14,0,1,0
16,205,205,23,8,15,4,3
28,206,206,9,9,0,1,0
22,211,211,3,3,0,1,0
14,225,225,12,12,0,1,0
10,251,251,18,12,6,3,2
0,263,263,2,2,0,1,0
26,273,273,14,9,5,2,1
13,289,289,10,10,0,1,0
27,289,289,27,6,21,4,3
23,303,303,14,3,11,2,1
15,347,347,30,2,28,3,2
3,362,362,49,49,0,1,0
19,364,364,87,63,24,4,3
18,383,383,94,84,10,3,2
25,384,384,25,25,0,1,0
8,427,427,3,3,0,1,0
29,431,431,3,3,0,1,0
21,457,457,13,1,12,4,3
11,483,483,62,14,48,3,2
2,484,484,132,51,81,4,3
1,484,484,11,2,9,2,1

8,104,104,8,8,0,1,0
10,124,124,6,1,5,2,1
19,134,134,20,8,12,3,2
11,135,135,3,3,0,1,0
1,140,140,47,47,0,1,0
14,163,163,16,7,9,4,3
13,169,169,8,8,0,1,0
9,169,169,13,3,10,3,2
2,175,175,4,1,3,2,1
3,193,193,43,25,18,2,1
26,217,217,48,4,44,3,2
23,232,232,10,4,6,2,1
20,252,252,24,24,0,1,0
17,265,265,28,28,0,1,0
7,271,271,61,61,0,1,0
4,304,304,64,64,0,1,0
6,308,308,66,36,30,3,2
5,345,345,10,10,0,1,0
0,364,364,52,52,0,1,0
24,382,382,88,1,87,4,3
18,418,418,48,10,38,3,2
22,430,430,38,38,0,1,0
12,451,451,2,2,0,1,0
16,464,464,7,7,0,1,0
21,471,471,22,22,0,1,0
15,474,474,15,6,9,4,3
25,491,491,156,36,120,4,3

25,100,100,4,1,3,2,1
16,114,114,4,4,0,1,0
15,152,152,2,2,0,1,0
17,170,170,18,18,0,1,0
5,171,171,11,11,0,1,0
18,198,198,3,3,0,1,0
6,204,204,3,3,0,1,0
21,205,205,41,19,22,2,1
0,207,207,111,62,49,2,1
20,212,212,50,50,0,1,0
4,218,218,10,10,0,1,0
3,224,224,42,42,0,1,0
10,226,226,35,20,15,2,1
28,237,237,19,10,9,2,1
22,248,248,65,65,0,1,0
9,269,269,45,2,43,2,1
26,274,274,36,36,0,1,0
19,288,288,62,62,0,1,0
7,335,335,35,3,32,3,2
12,348,348,5,5,0,1,0
14,367,367,34,10,24,2,1
27,372,372,18,1,17,4,3
11,393,393,22,10,12,2,1
24,398,398,27,27,0,1,0
1,399,399,55,55,0,1,0
23,405,405,14,2,12,3,2
13,420,420,19,7,12,2,1
2,421,421,8,3,5,2,1
8,430,430,43,43,0,1,0

26,109,109,16,16,0,1,0
22,123,123,21,3,18,2,1
7,127,127,13,10,3,2,1
0,163,163,19,19,0,1,0
27,163,163,19,11,8,3,2
20,169,169,6,6,0,1,0
28,192,192,3,3,0,1,0
14,200,200,11,5,6,3,2
16,210,210,4,4,0,1,0
5,218,218,55,8,47,2,1
23,222,222,12,12,0,1,0
2,228,228,25,25,0,1,0
3,266,266,4,4,0,1,0
9,277,277,43,43,0,1,0
1,284,284,23,23,0,1,0
12,288,288,6,6,0,1,0
8,291,291,14,5,9,2,1
19,331,331,4,4,0,1,0
4,339,339,58,58,0,1,0
17,347,347,2,2,0,1,0
6,367,367,1,1,0,1,0
21,389,389,45,45,0,1,0
25,391,391,178,136,42,2,1
15,398,398,44,18,26,3,2
18,403,403,18,6,12,2,1
11,412,412,79,27,52,3,2
29,427,427,15,15,0,1,0
13,447,447,55,21,34,3,2
10,465,465,98,98,0,1,0
24,488,488,119,73,46,4,3

22,104,104,2,2,0,1,0
0,128,128,21,6,15,2,1
1,131,131,18,15,3,2,1
26,140,140,23,7,16,2,1
31,147,147,8,8,0,1,0
32,155,155,18,4,14,3,2
19,157,157,3,3,0,1,0
28,160,160,11,11,0,1,0
6,167,167,1,1,0,1,0
33,185,185,77,28,49,2,1
16,195,195,5,1,4,2,1
21,196,196,29,11,18,4,3
17,218,218,21,21,0,1,0
18,238,238,10,10,0,1,0
35,239,239,11,11,0,1,0
34,240,240,33,12,21,2,1
25,252,252,17,2,15,2,1
2,254,254,93,12,81,4,3
13,258,258,10,10,0,1,0
9,264,264,12,4,8,3,2
23,289,289,8,8,0,1,0
29,303,303,49,33,16,2,1
14,317,317,8,4,4,2,1
24,332,332,8,8,0,1,0
5,341,341,29,17,12,4,3
8,349,349,2,2,0,1,0
11,350,350,10,10,0,1,0
4,357,357,14,1,13,2,1
20,363,363,32,25,7,2,1
10,372,372,8,8,0,1,0
7,394,394,88,20,68,3,2
12,422,422,8,3,5,2,1
27,454,454,7,4,3,2,1
3,455,455,90,90,0,1,0
30,494,494,43,43,0,1,0
15,494,494,8,4,4,2,1

14,113,113,8,8,0,1,0
4,116,116,18,6,12,3,2
19,131,131,4,1,3,2,1
18,139,139,14,2,12,4,3
8,140,140,10,5,5,2,1
10,156,156,22,22,0,1,0
7,163,163,6,6,0,1,0
27,178,178,41,7,34,2,1
5,216,216,36,36,0,1,0
20,234,234,102,72,30,3,2
9,239,239,1,1,0,1,0
1,245,245,2,2,0,1,0
26,273,273,5,1,4,2,1
2,281,281,4,4,0,1,0
23,284,284,31,19,12,4,3
11,285,285,34,34,0,1,0
28,305,305,44,2,42,4,3
0,315,315,121,29,92,3,2
3,317,317,30,25,5,2,1
25,361,361,13,1,12,2,1
21,370,370,13,13,0,1,0
12,402,402,128,77,51,4,3
24,406,406,36,36,0,1,0
13,430,430,33,33,0,1,0
15,442,442,83,76,7,2,1
22,458,458,4,4,0,1,0
16,480,480,3,3,0,1,0
17,491,491,25,21,4,2,1
6,500,500,43,8,35,4,3

25,103,103,2,2,0,1,0
32,113,113,3,3,0,1,0
4,126,126,4,4,0,1,0
23,152,152,37,13,24,3,2
0,170,170,2,2,0,1,0
29,188,188,16,6,10,3,2
11,193,193,13,2,11,3,2
1,214,214,13,13,0,1,0
24,217,217,25,4,21,2,1
5,218,218,9,9,0,1,0
2,225,225,14,1,13,2,1
27,241,241,1,1,0,1,0
20,242,242,18,18,0,1,0
7,244,244,15,9,6,3,2
8,250,250,9,9,0,1,0
28,258,258,37,11,26,3,2
15,262,262,51,51,0,1,0
17,267,267,11,11,0,1,0
22,273,273,5,5,0,1,0
33,287,287,60,60,0,1,0
30,312,312,18,4,14,2,1
16,327,327,20,20,0,1,0
34,362,362,16,9,7,2,1
12,365,365,60,60,0,1,0
14,416,416,37,37,0,1,0
19,419,419,22,22,0,1,0
21,424,424,194,53,141,4,3
31,427,427,28,28,0,1,0
10,436,436,79,67,12,2,1
9,447,447,84,84,0,1,0
26,449,449,2,2,0,1,0
18,458,458,34,34,0,1,0
6,464,464,26,9,17,4,3
3,466,466,41,11,30,2,1
13,486,486,44,44,0,1,0

10,128,128,31,6,25,2,1
15,130,130,2,2,0,1,0
24,151,151,17,17,0,1,0
22,181,181,14,14,0,1,0
14,207,207,4,4,0,1,0
6,221,221,15,15,0,1,0
2,268,268,197,142,55,3,2
0,292,292,6,6,0,1,0
19,333,333,64,34,30,3,2
8,339,339,79,79,0,1,0
9,345,345,6,6,0,1,0
20,345,345,86,86,0,1,0
21,359,359,47,25,22,4,3
5,364,364,4,1,3,2,1
11,366,366,15,15,0,1,0
13,375,375,33,33,0,1,0
12,394,394,17,12,5,2,1
4,442,442,69,51,18,3,2
3,464,464,116,116,0,1,0
18,464,464,93,5,88,3,2
7,474,474,50,19,31,2,1
1,474,474,10,10,0,1,0
23,481,481,9,9,0,1,0
16,490,490,32,4,28,2,1
17,500,500,59,59,0,1,0

23,133,133,8,8,0,1,0
28,133,133,7,7,0,1,0
2,138,138,2,2,0,1,0
4,140,140,19,19,0,1,0
17,152,152,3,3,0,1,0
29,159,159,8,8,0,1,0
30,160,160,5,5,0,1,0
15,161,161,59,3,56,4,3
8,163,163,2,2,0,1,0
1,167,167,4,4,0,1,0
11,171,171,3,3,0,1,0
24,190,190,27,18,9,4,3
3,190,190,14,14,0,1,0
18,194,194,19,1,18,4,3
33,199,199,5,5,0,1,0
12,205,205,15,15,0,1,0
19,222,222,24,24,0,1,0
14,235,235,16,16,0,1,0
27,268,268,11,5,6,3,2
16,274,274,6,6,0,1,0
10,296,296,72,72,0,1,0
13,313,313,29,8,21,2,1
20,325,325,106,106,0,1,0
22,334,334,55,55,0,1,0
26,354,354,125,110,15,4,3
32,365,365,18,18,0,1,0
5,370,370,24,2,22,3,2
0,377,377,3,3,0,1,0
31,401,401,27,27,0,1,0
6,409,409,42,42,0,1,0
9,410,410,37,37,0,1,0
7,414,414,31,13,18,2,1
34,417,417,13,1,12,2,1
21,432,432,14,2,12,4,3
25,498,498,52,52,0,1,0

12,126,126,4,1,3,2,1
0,138,138,11,11,0,1,0
28,150,150,17,17,0,1,0
23,155,155,40,40,0,1,0
9,165,165,8,8,0,1,0
1,170,170,38,38,0,1,0
26,188,188,4,1,3,2,1
10,205,205,1,1,0,1,0
3,252,252,28,28,0,1,0
25,283,283,1,1,0,1,0
15,296,296,17,17,0,1,0
8,320,320,144,55,89,4,3
24,320,320,1,1,0,1,0
4,325,325,61,21,40,2,1
21,348,348,41,24,17,4,3
20,352,352,6,6,0,1,0
6,363,363,16,6,10,3,2
17,363,363,5,5,0,1,0
5,383,383,49,49,0,1,0
18,395,395,20,20,0,1,0
14,431,431,33,19,14,3,2
16,437,437,16,16,0,1,0
19,444,444,75,53,22,3,2
7,449,449,39,27,12,4,3
13,476,476,126,54,72,4,3
22,477,477,21,21,0,1,0
2,485,485,43,43,0,1,0
27,488,488,185,119,66,4,3
11,497,497,61,11,50,3,2

22,103,103,2,2,0,1,0
21,117,117,19,19,0,1,0
19,118,118,49,49,0,1,0
32,132,132,12,2,10,2,1
5,142,142,19,16,3,2,1
11,148,148,1,1,0,1,0
33,153,153,11,5,6,2,1
14,165,165,28,28,0,1,0
2,166,166,1,1,0,1,0
9,167,167,27,27,0,1,0
18,173,173,7,2,5,2,1
25,196,196,10,2,8,2,1
13,200,200,13,13,0,1,0
12,206,206,17,17,0,1,0
29,237,237,12,3,9,2,1
23,253,253,2,2,0,1,0
20,267,267,34,22,12,4,3
16,277,277,1,1,0,1,0
27,282,282,37,37,0,1,0
30,285,285,47,47,0,1,0
4,292,292,20,20,0,1,0
15,292,292,20,20,0,1,0
0,296,296,28,28,0,1,0
31,316,316,39,39,0,1,0
8,331,331,55,24,31,2,1
17,337,337,8,1,7,2,1
24,359,359,29,11,18,4,3
10,376,376,27,21,6,3,2
26,399,399,23,23,0,1,0
3,405,405,106,25,81,4,3
7,409,409,9,4,5,2,1
6,461,461,40,40,0,1,0
28,484,484,24,24,0,1,0
1,495,495,54,54,0,1,0

5,100,100,6,3,3,2,1
21,123,123,3,3,0,1,0
18,130,130,10,10,0,1,0
20,134,134,2,2,0,1,0
9,163,163,16,16,0,1,0
11,188,188,2,2,0,1,0
25,199,199,29,8,21,4,3
6,207,207,8,8,0,1,0
17,225,225,34,34,0,1,0
15,273,273,59,59,0,1,0
12,273,273,4,1,3,2,1
2,277,277,37,37,0,1,0
16,289,289,5,5,0,1,0
7,309,309,161,161,0,1,0
14,310,310,67,49,18,4,3
0,311,311,100,56,44,2,1
4,317,317,81,37,44,3,2
19,319,319,17,7,10,3,2
22,332,332,59,31,28,3,2
1,368,368,10,2,8,2,1
3,386,386,13,13,0,1,0
8,415,415,48,48,0,1,0
13,428,428,35,35,0,1,0
23,460,460,51,15,36,3,2
24,470,470,122,66,56,3,2
10,493,493,31,31,0,1,0

14,142,142,1,1,0,1,0
6,142,142,2,2,0,1,0
25,148,148,27,8,19,2,1
31,195,195,20,6,14,3,2
19,196,196,1,1,0,1,0
32,221,221,29,2,27,4,3
16,224,224,2,2,0,1,0
13,250,250,26,26,0,1,0
24,256,256,1,1,0,1,0
1,266,266,40,11,29,2,1
11,269,269,1,1,0,1,0
0,288,288,85,85,0,1,0
10,295,295,16,16,0,1,0
30,304,304,84,22,62,3,2
12,312,312,48,48,0,1,0
23,321,321,19,19,0,1,0
18,325,325,73,7,66,3,2
8,331,331,24,24,0,1,0
4,338,338,18,18,0,1,0
9,352,352,2,2,0,1,0
5,354,354,38,38,0,1,0
20,355,355,23,5,18,4,3
3,363,363,23,23,0,1,0
15,402,402,22,22,0,1,0
26,407,407,29,7,22,3,2
27,436,436,118,10,108,4,3
2,446,446,32,32,0,1,0
17,446,446,29,29,0,1,0
7,450,450,42,1,41,2,1
28,457,457,30,30,0,1,0
34,463,463,18,18,0,1,0
21,465,465,78,64,14,3,2
22,466,466,12,12,0,1,0
33,482,482,58,10,48,4,3
29,483,483,18,18,0,1,0

13,106,106,15,6,9,2,1
3,112,112,13,3,10,3,2
2,133,133,10,10,0,1,0
14,139,139,10,10,0,1,0
28,140,140,14,14,0,1,0
8,154,154,2,2,0,1,0
5,193,193,28,16,12,2,1
9,205,205,9,9,0,1,0
16,216,216,21,21,0,1,0
24,223,223,30,12,18,3,2
18,260,260,4,4,0,1,0
23,265,265,8,8,0,1,0
7,274,274,44,44,0,1,0
29,280,280,36,8,28,2,1
15,280,280,8,2,6,2,1
4,280,280,21,13,8,2,1
11,320,320,44,32,12,2,1
10,326,326,2,2,0,1,0
32,340,340,3,3,0,1,0
6,348,348,31,1,30,4,3
19,351,351,41,26,15,4,3
0,352,352,24,12,12,4,3
33,364,364,80,43,37,4,3
20,378,378,3,3,0,1,0
34,422,422,28,28,0,1,0
26,429,429,50,26,24,3,2
21,444,444,8,8,0,1,0
31,446,446,44,6,38,3,2
12,453,453,20,20,0,1,0
22,460,460,68,68,0,1,0
30,461,461,13,13,0,1,0
17,462,462,26,26,0,1,0
27,467,467,147,135,12,4,3
25,478,478,2,2,0,1,0
35,479,479,96,79,17,2,1
1,481,481,48,36,12,3,2

13,133,133,8,8,0,1,0
6,145,145,1,1,0,1,0
25,148,148,3,3,0,1,0
0,166,166,93,93,0,1,0
1,171,171,8,8,0,1,0
5,181,181,10,10,0,1,0
11,188,188,22,4,18,3,2
8,216,216,1,1,0,1,0
28,227,227,38,38,0,1,0
4,235,235,18,18,0,1,0
20,238,238,23,23,0,1,0
12,264,264,17,2,15,2,1
22,268,268,32,24,8,2,1
21,270,270,16,4,12,4,3
7,274,274,7,7,0,1,0
9,296,296,44,17,27,4,3
10,302,302,45,5,40,3,2
19,312,312,74,39,35,4,3
15,317,317,2,2,0,1,0
14,349,349,47,47,0,1,0
18,366,366,83,83,0,1,0
23,378,378,34,22,12,2,1
2,421,421,113,68,45,4,3
26,439,439,32,32,0,1,0
16,447,447,16,16,0,1,0
24,453,453,78,70,8,2,1
27,453,453,19,3,16,3,2
3,469,469,37,21,16,2,1
17,489,489,46,46,0,1,0

25,101,101,5,5,0,1,0
5,124,124,1,1,0,1,0
18,132,132,17,17,0,1,0
4,154,154,10,2,8,3,2
14,156,156,28,4,24,4,3
23,181,181,7,1,6,2,1
27,200,200,7,7,0,1,0
7,205,205,47,47,0,1,0
0,217,217,5,5,0,1,0
3,222,222,41,15,26,2,1
20,244,244,19,19,0,1,0
21,252,252,11,8,3,2,1
28,267,267,47,10,37,4,3
16,284,284,27,13,14,3,2
6,286,286,9,9,0,1,0
19,305,305,79,25,54,4,3
22,311,311,55,4,51,4,3
12,312,312,40,40,0,1,0
9,318,318,56,56,0,1,0
1,369,369,80,41,39,2,1
24,376,376,7,1,6,2,1
8,388,388,90,90,0,1,0
26,392,392,6,3,3,2,1
11,415,415,76,76,0,1,0
13,418,418,21,21,0,1,0
10,437,437,8,8,0,1,0
2,440,440,47,47,0,1,0
17,459,459,85,80,5,2,1
15,477,477,52,52,0,1,0

6,148,148,1,1,0,1,0
3,156,156,18,18,0,1,0
4,186,186,11,11,0,1,0
13,191,191,27,5,22,2,1
9,197,197,5,5,0,1,0
23,198,198,1,1,0,1,0
16,219,219,8,8,0,1,0
11,230,230,35,4,31,2,1
7,267,267,4,4,0,1,0
22,295,295,62,47,15,2,1
2,297,297,149,122,27,3,2
12,305,305,88,42,46,2,1
14,331,331,4,4,0,1,0
10,346,346,29,1,28,3,2
17,347,347,76,16,60,3,2
21,347,347,33,23,10,2,1
1,357,357,30,30,0,1,0
20,358,358,11,4,7,2,1
19,394,394,5,2,3,2,1
18,397,397,151,37,114,4,3
26,398,398,7,7,0,1,0
5,414,414,1,1,0,1,0
8,419,419,102,102,0,1,0
24,430,430,16,8,8,2,1
25,434,434,15,15,0,1,0
27,469,469,39,39,0,1,0
0,473,473,149,113,36,2,1
15,488,488,10,4,6,3,2

16,115,115,16,16,0,1,0
4,123,123,1,1,0,1,0
7,133,133,19,19,0,1,0
1,148,148,8,8,0,1,0
5,158,158,4,1,3,2,1
27,159,159,7,4,3,2,1
32,184,184,4,4,0,1,0
17,200,200,6,6,0,1,0
24,207,207,101,101,0,1,0
13,230,230,33,17,16,2,1
12,249,249,1,1,0,1,0
29,261,261,56,56,0,1,0
6,294,294,18,18,0,1,0
20,308,308,11,11,0,1,0
30,317,317,32,32,0,1,0
31,338,338,47,47,0,1,0
23,351,351,2,2,0,1,0
3,358,358,92,92,0,1,0
10,361,361,65,65,0,1,0
9,361,361,28,28,0,1,0
21,366,366,7,7,0,1,0
8,383,383,112,46,66,3,2
19,395,395,67,21,46,2,1
22,397,397,1,1,0,1,0
0,398,398,20,20,0,1,0
26,398,398,103,57,46,2,1
28,410,410,12,12,0,1,0
25,435,435,6,6,0,1,0
18,455,455,25,3,22,2,1
11,465,465,4,4,0,1,0
2,476,476,8,2,6,3,2
14,493,493,42,42,0,1,0
15,497,497,28,6,22,2,1

5,108,108,4,4,0,1,0
34,108,108,26,26,0,1,0
19,117,117,16,16,0,1,0
16,118,118,2,2,0,1,0
2,118,118,8,8,0,1,0
28,133,133,2,2,0,1,0
3,145,145,39,39,0,1,0
22,156,156,1,1,0,1,0
1,162,162,11,11,0,1,0
7,176,176,4,4,0,1,0
31,191,191,3,3,0,1,0
10,201,201,11,8,3,2,1
12,209,209,25,25,0,1,0
6,216,216,8,4,4,2,1
25,216,216,65,19,46,3,2
11,223,223,39,31,8,3,2
21,228,228,12,12,0,1,0
20,243,243,68,22,46,3,2
23,258,258,14,14,0,1,0
9,303,303,16,7,9,2,1
0,306,306,1,1,0,1,0
26,308,308,2,2,0,1,0
14,326,326,52,39,13,2,1
8,330,330,7,2,5,2,1
33,331,331,55,6,49,2,1
30,336,336,22,22,0,1,0
35,343,343,22,22,0,1,0
32,349,349,33,5,28,2,1
18,380,380,1,1,0,1,0
13,380,380,34,34,0,1,0
17,386,386,75,75,0,1,0
24,418,418,1,1,0,1,0
29,429,429,29,29,0,1,0
27,465,465,96,72,24,4,3
4,475,475,32,10,22,2,1
15,482,482,4,4,0,1,0

29,115,115,27,9,18,2,1
1,122,122,14,14,0,1,0
15,140,140,14,9,5,2,1
7,177,177,6,6,0,1,0
13,193,193,1,1,0,1,0
28,202,202,26,12,14,2,1
24,211,211,1,1,0,1,0
12,216,216,4,4,0,1,0
20,217,217,1,1,0,1,0
9,221,221,15,15,0,1,0
10,222,222,31,14,17,2,1
36,241,241,32,32,0,1,0
11,258,258,5,5,0,1,0
21,260,260,84,34,50,2,1
30,267,267,24,4,20,2,1
25,276,276,13,5,8,3,2
27,291,291,28,13,15,4,3
0,303,303,11,11,0,1,0
8,311,311,4,1,3,2,1
32,322,322,9,5,4,2,1
34,338,338,67,67,0,1,0
6,340,340,95,76,19,2,1
22,354,354,2,2,0,1,0
2,365,365,16,4,12,4,3
31,374,374,24,24,0,1,0
4,380,380,26,2,24,2,1
26,387,387,66,54,12,3,2
19,394,394,9,9,0,1,0
33,398,398,14,7,7,2,1
16,411,411,26,16,10,3,2
23,422,422,1,1,0,1,0
35,437,437,31,31,0,1,0
14,448,448,31,31,0,1,0
17,464,464,85,29,56,4,3
18,473,473,10,2,8,2,1
3,474,474,35,2,33,4,3
5,478,478,107,98,9,2,1

6,100,100,36,5,31,2,1
21,119,119,8,8,0,1,0
9,133,133,13,13,0,1,0
23,148,148,6,6,0,1,0
14,153,153,16,10,6,3,2
25,160,160,65,7,58,3,2
13,171,171,17,17,0,1,0
16,173,173,59,59,0,1,0
24,176,176,2,2,0,1,0
7,231,231,183,99,84,3,2
11,237,237,41,41,0,1,0
15,255,255,14,3,11,4,3
12,292,292,13,9,4,2,1
0,306,306,3,3,0,1,0
4,310,310,4,4,0,1,0
18,329,329,38,8,30,2,1
3,352,352,8,8,0,1,0
8,353,353,9,9,0,1,0
10,360,360,17,17,0,1,0
22,362,362,2,2,0,1,0
2,413,413,67,67,0,1,0
19,415,415,10,2,8,3,2
20,438,438,21,21,0,1,0
17,457,457,25,1,24,2,1
5,459,459,37,37,0,1,0
1,483,483,20,20,0,1,0

3,101,101,10,1,9,2,1
20,102,102,19,19,0,1,0
5,115,115,11,5,6,3,2
12,115,115,9,9,0,1,0
10,123,123,32,5,27,3,2
9,126,126,36,7,29,4,3
11,128,128,1,1,0,1,0
13,145,145,3,3,0,1,0
31,158,158,31,31,0,1,0
15,171,171,11,11,0,1,0
30,174,174,13,13,0,1,0
22,214,214,15,11,4,2,1
19,220,220,24,24,0,1,0
7,255,255,32,32,0,1,0
29,284,284,12,2,10,2,1
4,301,301,10,10,0,1,0
0,321,321,22,22,0,1,0
14,341,341,15,9,6,3,2
21,346,346,7,7,0,1,0
16,356,356,20,20,0,1,0
26,363,363,22,1,21,2,1
1,389,389,25,25,0,1,0
24,396,396,13,13,0,1,0
23,405,405,13,13,0,1,0
18,409,409,102,102,0,1,0
32,414,414,19,7,12,4,3
6,421,421,7,7,0,1,0
28,440,440,8,2,6,3,2
17,452,452,102,86,16,2,1
8,456,456,106,106,0,1,0
2,465,465,23,16,7,2,1
25,485,485,48,48,0,1,0
27,486,486,81,81,0,1,0

35,110,110,5,5,0,1,0
32,119,119,3,3,0,1,0
1,141,141,5,5,0,1,0
3,150,150,1,1,0,1,0
0,151,151,3,3,0,1,0
19,153,153,1,1,0,1,0
36,155,155,38,38,0,1,0
37,161,161,13,3,10,2,1
25,205,205,66,29,37,2,1
7,215,215,50,44,6,2,1
31,231,231,30,30,0,1,0
15,233,233,2,2,0,1,0
23,235,235,27,27,0,1,0
30,237,237,21,12,9,4,3
9,253,253,28,28,0,1,0
20,256,256,9,5,4,2,1
6,262,262,4,1,3,2,1
18,263,263,16,1,15,4,3
11,273,273,15,15,0,1,0
13,292,292,1,1,0,1,0
10,296,296,36,24,12,4,3
2,305,305,46,33,13,2,1
24,305,305,1,1,0,1,0
22,307,307,14,14,0,1,0
21,330,330,41,41,0,1,0
29,344,344,37,19,18,3,2
12,349,349,34,19,15,4,3
4,371,371,30,16,14,4,3
14,384,384,15,2,13,2,1
27,396,396,69,31,38,2,1
8,401,401,4,1,3,2,1
26,421,421,1,1,0,1,0
33,429,429,13,13,0,1,0
17,449,449,106,44,62,4,3
16,474,474,3,3,0,1,0
28,481,481,78,78,0,1,0
5,481,481,70,70,0,1,0
34,485,485,26,26,0,1,0

6,100,100,22,22,0,1,0
23,110,110,3,3,0,1,0
28,125,125,61,2,59,4,3
27,169,169,4,1,3,2,1
9,173,173,21,21,0,1,0
17,187,187,29,29,0,1,0
20,216,216,3,3,0,1,0
12,229,229,15,15,0,1,0
10,236,236,19,4,15,4,3
24,245,245,17,12,5,2,1
33,248,248,7,7,0,1,0
30,249,249,15,15,0,1,0
3,268,268,8,8,0,1,0
8,275,275,10,10,0,1,0
31,279,279,6,6,0,1,0
5,290,290,19,19,0,1,0
18,295,295,59,21,38,3,2
22,301,301,4,4,0,1,0
25,312,312,13,5,8,2,1
26,326,326,15,4,11,2,1
29,330,330,59,25,34,2,1
4,335,335,57,57,0,1,0
13,353,353,66,51,15,2,1
2,354,354,22,22,0,1,0
32,354,354,13,3,10,2,1
16,356,356,38,17,21,4,3
1,366,366,31,7,24,3,2
15,388,388,1,1,0,1,0
7,396,396,35,35,0,1,0
19,408,408,75,43,32,3,2
11,444,444,24,24,0,1,0
21,462,462,93,61,32,3,2
14,473,473,11,11,0,1,0
0,484,484,25,25,0,1,0

15,103,103,6,6,0,1,0
16,105,105,2,2,0,1,0
34,105,105,19,3,16,3,2
28,125,125,36,36,0,1,0
11,134,134,1,1,0,1,0
32,138,138,18,4,14,3,2
37,157,157,3,3,0,1,0
26,170,170,16,16,0,1,0
5,176,176,3,3,0,1,0
9,184,184,1,1,0,1,0
17,193,193,88,88,0,1,0
20,210,210,5,5,0,1,0
29,221,221,1,1,0,1,0
30,235,235,11,11,0,1,0
6,245,245,8,8,0,1,0
14,256,256,10,10,0,1,0
39,262,262,11,5,6,3,2
23,297,297,13,13,0,1,0
33,310,310,20,20,0,1,0
25,311,311,74,31,43,4,3
24,324,324,32,32,0,1,0
18,326,326,1,1,0,1,0
2,338,338,4,4,0,1,0
22,344,344,56,56,0,1,0
12,347,347,18,18,0,1,0
19,353,353,15,1,14,2,1
13,358,358,109,79,30,3,2
36,389,389,108,108,0,1,0
7,390,390,12,12,0,1,0
8,390,390,5,5,0,1,0
0,392,392,33,5,28,3,2
38,399,399,18,18,0,1,0
31,401,401,15,12,3,2,1
3,402,402,17,5,12,4,3
35,449,449,28,8,20,3,2
27,455,455,4,1,3,2,1
21,465,465,39,39,0,1,0
10,474,474,4,4,0,1,0
4,482,482,15,4,11,2,1
1,488,488,15,2,13,4,3

20,115,115,3,3,0,1,0
29,141,141,24,12,12,4,3
8,141,141,5,5,0,1,0
11,153,153,27,22,5,2,1
13,157,157,9,9,0,1,0
15,165,165,14,9,5,2,1
18,165,165,6,3,3,2,1
21,236,236,23,5,18,4,3
27,258,258,9,9,0,1,0
30,275,275,49,10,39,2,1
9,281,281,4,4,0,1,0
25,292,292,9,1,8,2,1
2,295,295,30,19,11,2,1
0,297,297,9,6,3,2,1
1,312,312,46,46,0,1,0
26,326,326,27,27,0,1,0
14,331,331,33,16,17,2,1
5,331,331,41,41,0,1,0
4,335,335,85,1,84,4,3
31,337,337,106,13,93,4,3
28,364,364,13,13,0,1,0
12,365,365,9,2,7,2,1
10,371,371,52,22,30,2,1
16,380,380,75,15,60,3,2
17,399,399,71,71,0,1,0
7,403,403,23,17,6,2,1
32,447,447,56,30,26,3,2
22,478,478,3,3,0,1,0
24,479,479,7,2,5,2,1
23,479,479,89,3,86,4,3
19,485,485,52,13,39,4,3
6,498,498,24,24,0,1,0
3,500,500,5,5,0,1,0

12,105,105,16,8,8,2,1
14,123,123,1,1,0,1,0
29,137,137,35,23,12,4,3
22,138,138,7,7,0,1,0
0,153,153,45,45,0,1,0
2,154,154,18,10,8,2,1
19,156,156,27,4,23,2,1
30,168,168,33,12,21,2,1
10,175,175,30,30,0,1,0
5,176,176,18,18,0,1,0
26,183,183,11,11,0,1,0
9,212,212,8,4,4,2,1
21,216,216,16,9,7,2,1
18,217,217,2,2,0,1,0
16,219,219,13,13,0,1,0
17,227,227,8,8,0,1,0
3,244,244,18,18,0,1,0
23,255,255,4,4,0,1,0
8,264,264,29,29,0,1,0
27,274,274,93,44,49,4,3
25,304,304,34,34,0,1,0
24,343,343,48,48,0,1,0
20,353,353,29,29,0,1,0
7,361,361,3,3,0,1,0
15,400,400,2,2,0,1,0
4,422,422,39,13,26,2,1
28,448,448,14,14,0,1,0
6,452,452,76,25,51,4,3
1,470,470,9,9,0,1,0
11,479,479,68,68,0,1,0
13,500,500,55,55,0,1,0

1,100,100,8,8,0,1,0
20,135,135,13,13,0,1,0
5,150,150,1,1,0,1,0
21,152,152,2,2,0,1,0
9,158,158,25,1,24,4,3
12,173,173,39,39,0,1,0
15,200,200,5,5,0,1,0
14,216,216,6,6,0,1,0
18,235,235,6,2,4,2,1
17,248,248,9,9,0,1,0
3,249,249,58,35,23,4,3
29,284,284,20,10,10,2,1
26,299,299,5,5,0,1,0
10,305,305,1,1,0,1,0
13,315,315,13,4,9,4,3
2,320,320,38,2,36,3,2
22,321,321,18,10,8,2,1
25,321,321,30,11,19,2,1
23,324,324,19,11,8,2,1
6,354,354,25,25,0,1,0
4,367,367,54,31,23,2,1
0,376,376,46,46,0,1,0
24,376,376,2,2,0,1,0
19,397,397,221,154,67,4,3
8,408,408,24,12,12,4,3
27,411,411,90,67,23,2,1
28,412,412,15,15,0,1,0
31,420,420,42,32,10,3,2
16,466,466,61,15,46,3,2
7,469,469,128,82,46,3,2
11,476,476,6,6,0,1,0
30,491,491,53,25,28,3,2

1,104,104,1,1,0,1,0
0,107,107,3,3,0,1,0
27,116,116,8,8,0,1,0
15,127,127,6,6,0,1,0
21,138,138,21,10,11,2,1
18,155,155,1,1,0,1,0
14,162,162,28,28,0,1,0
10,167,167,19,19,0,1,0
17,180,180,10,5,5,2,1
34,187,187,5,5,0,1,0
2,221,221,4,4,0,1,0
30,221,221,39,25,14,3,2
23,250,250,48,17,31,2,1
9,252,252,2,2,0,1,0
16,260,260,12,5,7,2,1
36,274,274,16,16,0,1,0
26,277,277,15,9,6,3,2
24,306,306,6,6,0,1,0
33,319,319,35,1,34,3,2
4,323,323,2,2,0,1,0
13,327,327,31,3,28,3,2
29,329,329,109,73,36,3,2
5,342,342,23,23,0,1,0
6,361,361,27,27,0,1,0
8,393,393,95,48,47,4,3
3,395,395,2,2,0,1,0
32,406,406,16,16,0,1,0
7,427,427,25,25,0,1,0
12,431,431,56,16,40,3,2
28,438,438,22,3,19,2,1
25,450,450,51,51,0,1,0
19,451,451,46,46,0,1,0
11,464,464,56,48,8,2,1
22,464,464,32,6,26,2,1
35,477,477,15,2,13,4,3
31,484,484,65,27,38,3,2
20,487,487,95,11,84,4,3

23,111,111,18,18,0,1,0
28,118,118,6,6,0,1,0
2,129,129,4,4,0,1,0
7,142,142,1,1,0,1,0
26,147,147,8,8,0,1,0
9,156,156,1,1,0,1,0
22,158,158,11,11,0,1,0
14,176,176,26,8,18,2,1
11,206,206,45,31,14,3,2
13,211,211,19,13,6,3,2
33,213,213,3,3,0,1,0
31,257,257,9,9,0,1,0
27,266,266,5,5,0,1,0
4,291,291,1,1,0,1,0
25,295,295,26,8,18,3,2
8,320,320,20,13,7,2,1
18,320,320,26,26,0,1,0
12,325,325,44,32,12,4,3
29,327,327,2,2,0,1,0
6,334,334,19,8,11,2,1
21,349,349,26,7,19,2,1
0,357,357,26,4,22,2,1
17,362,362,137,137,0,1,0
10,370,370,12,7,5,2,1
30,383,383,4,4,0,1,0
16,412,412,14,14,0,1,0
1,433,433,45,9,36,2,1
3,434,434,38,38,0,1,0
15,443,443,14,14,0,1,0
19,446,446,102,6,96,4,3
5,466,466,48,3,45,4,3
24,480,480,145,89,56,3,2
20,498,498,6,6,0,1,0
32,499,499,210,158,52,3,2

8,110,110,19,1,18,4,3
32,118,118,2,2,0,1,0
19,128,128,1,1,0,1,0
31,137,137,6,6,0,1,0
0,141,141,7,7,0,1,0
14,167,167,3,3,0,1,0
20,174,174,9,6,3,2,1
6,183,183,2,2,0,1,0
30,194,194,63,63,0,1,0
29,198,198,18,7,11,2,1
22,204,204,16,5,11,2,1
21,217,217,8,8,0,1,0
5,227,227,9,4,5,2,1
13,242,242,18,1,17,2,1
1,278,278,17,1,16,4,3
3,278,278,6,3,3,2,1
4,287,287,1,1,0,1,0
27,311,311,125,116,9,4,3
24,313,313,14,14,0,1,0
25,345,345,8,8,0,1,0
23,355,355,10,10,0,1,0
16,380,380,6,6,0,1,0
9,390,390,3,3,0,1,0
7,399,399,76,76,0,1,0
2,405,405,110,62,48,2,1
28,417,417,76,76,0,1,0
11,421,421,32,8,24,2,1
10,426,426,38,20,18,3,2
15,430,430,56,56,0,1,0
12,433,433,160,116,44,3,2
18,458,458,53,37,16,3,2
26,460,460,51,4,47,2,1
17,475,475,39,39,0,1,0

2,109,109,20,11,9,4,3
20,150,150,8,8,0,1,0
19,158,158,10,10,0,1,0
16,200,200,35,19,16,3,2
18,203,203,40,1,39,2,1
0,209,209,2,2,0,1,0
4,221,221,36,12,24,4,3
10,230,230,6,6,0,1,0
6,239,239,27,27,0,1,0
23,254,254,12,12,0,1,0
25,277,277,11,5,6,2,1
28,278,278,8,8,0,1,0
21,280,280,44,44,0,1,0
8,285,285,12,12,0,1,0
15,318,318,39,39,0,1,0
3,343,343,39,19,20,2,1
1,354,354,11,11,0,1,0
31,362,362,16,16,0,1,0
27,373,373,47,47,0,1,0
5,378,378,94,67,27,2,1
12,385,385,6,6,0,1,0
17,395,395,13,4,9,4,3
24,416,416,76,76,0,1,0
30,417,417,70,39,31,2,1
13,420,420,47,32,15,4,3
14,421,421,17,17,0,1,0
22,423,423,30,30,0,1,0
7,440,440,68,48,20,2,1
9,461,461,44,44,0,1,0
11,465,465,61,35,26,3,2
29,476,476,74,74,0,1,0
26,494,494,39,39,0,1,0

30,104,104,1,1,0,1,0
6,112,112,1,1,0,1,0
34,129,129,18,8,10,3,2
23,132,132,3,3,0,1,0
24,136,136,23,11,12,2,1
32,161,161,19,11,8,3,2
12,169,169,22,4,18,2,1
10,179,179,25,9,16,3,2
11,212,212,34,34,0,1,0
26,216,216,2,2,0,1,0
37,246,246,16,16,0,1,0
17,289,289,13,4,9,4,3
4,302,302,4,4,0,1,0
28,310,310,24,12,12,4,3
3,312,312,5,1,4,2,1
9,319,319,11,11,0,1,0
38,325,325,39,7,32,3,2
19,336,336,39,7,32,2,1
21,356,356,7,3,4,2,1
16,361,361,16,12,4,2,1
36,363,363,4,4,0,1,0
8,366,366,75,75,0,1,0
25,368,368,1,1,0,1,0
15,383,383,1,1,0,1,0
35,393,393,17,17,0,1,0
20,407,407,1,1,0,1,0
29,409,409,16,8,8,2,1
7,423,423,104,44,60,4,3
5,448,448,23,11,12,2,1
1,450,450,30,30,0,1,0
31,453,453,18,11,7,2,1
18,456,456,26,10,16,3,2
14,464,464,9,2,7,2,1
13,469,469,48,48,0,1,0
27,489,489,360,310,50,2,1
33,492,492,16,7,9,4,3
0,492,492,4,4,0,1,0
2,499,499,26,26,0,1,0
22,500,500,30,3,27,4,3

31,111,111,10,3,7,2,1
32,117,117,17,13,4,2,1
29,118,118,16,16,0,1,0
21,120,120,3,3,0,1,0
30,123,123,10,2,8,3,2
10,128,128,19,19,0,1,0
23,135,135,6,3,3,2,1
11,145,145,1,1,0,1,0
24,145,145,3,3,0,1,0
14,165,165,5,5,0,1,0
7,180,180,20,6,14,2,1
8,181,181,4,4,0,1,0
27,182,182,28,16,12,3,2
1,186,186,1,1,0,1,0
9,192,192,38,38,0,1,0
4,206,206,38,38,0,1,0
6,215,215,9,9,0,1,0
5,218,218,14,4,10,2,1
22,240,240,15,15,0,1,0
12,252,252,14,14,0,1,0
0,273,273,3,3,0,1,0
25,277,277,36,32,4,2,1
19,322,322,42,42,0,1,0
26,323,323,46,13,33,2,1
20,334,334,1,1,0,1,0
33,341,341,49,3,46,4,3
34,344,344,17,17,0,1,0
3,351,351,21,21,0,1,0
2,379,379,3,3,0,1,0
18,418,418,41,41,0,1,0
16,424,424,68,53,15,2,1
13,440,440,33,33,0,1,0
28,444,444,128,112,16,3,2
15,480,480,44,44,0,1,0
17,497,497,114,79,35,2,1

0,115,115,7,7,0,1,0
20,118,118,4,1,3,2,1
23,132,132,3,3,0,1,0
22,132,132,5,2,3,2,1
19,146,146,22,5,17,2,1
10,154,154,100,91,9,2,1
13,160,160,14,2,12,3,2
3,164,164,5,5,0,1,0
6,166,166,35,14,21,4,3
17,175,175,3,3,0,1,0
26,176,176,28,28,0,1,0
11,178,178,9,9,0,1,0
15,179,179,1,1,0,1,0
12,192,192,18,18,0,1,0
25,206,206,27,27,0,1,0
18,213,213,49,17,32,2,1
7,225,225,3,3,0,1,0
16,272,272,24,24,0,1,0
24,298,298,2,2,0,1,0
5,311,311,38,17,21,4,3
9,330,330,57,57,0,1,0
2,371,371,5,2,3,2,1
8,388,388,13,7,6,3,2
4,405,405,98,72,26,3,2
14,426,426,111,78,33,4,3
1,468,468,24,24,0,1,0
21,480,480,129,124,5,2,1

5,102,102,20,20,0,1,0
19,150,150,3,3,0,1,0
6,159,159,56,13,43,2,1
13,169,169,3,3,0,1,0
7,190,190,42,42,0,1,0
1,220,220,17,17,0,1,0
22,249,249,63,63,0,1,0
14,259,259,19,10,9,4,3
9,278,278,5,5,0,1,0
24,295,295,48,48,0,1,0
21,309,309,31,31,0,1,0
17,322,322,67,26,41,2,1
16,347,347,21,21,0,1,0
3,369,369,14,14,0,1,0
11,377,377,8,8,0,1,0
10,389,389,21,21,0,1,0
20,422,422,40,40,0,1,0
23,439,439,32,32,0,1,0
18,444,444,145,119,26,3,2
4,447,447,57,57,0,1,0
12,456,456,17,1,16,3,2
0,461,461,169,61,108,4,3
15,470,470,47,13,34,3,2
2,475,475,39,39,0,1,0
8,499,499,70,70,0,1,0

0,102,102,7,7,0,1,0
13,106,106,1,1,0,1,0
6,111,111,5,1,4,2,1
1,122,122,1,1,0,1,0
24,153,153,13,3,10,2,1
31,157,157,19,19,0,1,0
7,162,162,80,6,74,3,2
19,185,185,31,31,0,1,0
18,215,215,39,39,0,1,0
3,228,228,34,3,31,2,1
21,238,238,41,41,0,1,0
15,241,241,23,23,0,1,0
17,249,249,4,1,3,2,1
9,263,263,31,31,0,1,0
12,279,279,4,1,3,2,1
22,284,284,34,34,0,1,0
16,287,287,6,6,0,1,0
28,288,288,4,4,0,1,0
27,319,319,23,4,19,2,1
5,333,333,39,39,0,1,0
11,336,336,14,14,0,1,0
8,347,347,25,25,0,1,0
10,354,354,48,41,7,2,1
2,366,366,54,8,46,3,2
23,371,371,142,124,18,4,3
4,401,401,20,8,12,2,1
26,409,409,14,4,10,2,1
14,412,412,15,3,12,3,2
25,429,429,7,7,0,1,0
30,437,437,49,21,28,2,1
20,450,450,19,13,6,3,2
29,485,485,37,8,29,2,1

10,118,118,23,17,6,2,1
27,123,123,16,16,0,1,0
17,130,130,10,10,0,1,0
1,131,131,2,2,0,1,0
3,135,135,5,5,0,1,0
12,149,149,6,6,0,1,0
8,151,151,24,24,0,1,0
18,171,171,6,6,0,1,0
26,206,206,26,2,24,2,1
15,221,221,3,3,0,1,0
25,227,227,42,42,0,1,0
29,236,236,14,6,8,2,1
9,236,236,12,12,0,1,0
20,242,242,40,16,24,4,3
6,278,278,12,12,0,1,0
11,283,283,126,21,105,4,3
5,311,311,4,4,0,1,0
16,312,312,7,1,6,2,1
14,327,327,17,3,14,2,1
21,344,344,40,10,30,3,2
23,345,345,43,43,0,1,0
0,365,365,56,49,7,2,1
7,367,367,49,49,0,1,0
19,380,380,93,67,26,3,2
28,384,384,21,21,0,1,0
4,428,428,30,30,0,1,0
22,444,444,2,2,0,1,0
2,451,451,60,42,18,4,3
30,453,453,35,20,15,4,3
24,468,468,91,42,49,2,1
13,468,468,28,28,0,1,0

0,128,128,1,1,0,1,0
14,128,128,22,22,0,1,0
16,137,137,18,18,0,1,0
29,175,175,34,34,0,1,0
18,186,186,3,3,0,1,0
21,195,195,28,6,22,3,2
9,209,209,39,9,30,3,2
5,218,218,8,2,6,2,1
11,222,222,1,1,0,1,0
23,233,233,3,3,0,1,0
7,240,240,88,41,47,4,3
19,240,240,9,2,7,2,1
25,265,265,52,38,14,2,1
4,270,270,58,12,46,2,1
28,284,284,11,11,0,1,0
17,290,290,28,28,0,1,0
12,294,294,3,3,0,1,0
30,306,306,51,51,0,1,0
27,322,322,31,14,17,2,1
31,333,333,46,13,33,2,1
26,336,336,41,41,0,1,0
20,338,338,54,54,0,1,0
2,354,354,7,1,6,2,1
15,395,395,75,75,0,1,0
24,397,397,18,18,0,1,0
22,398,398,12,12,0,1,0
1,415,415,21,10,11,3,2
8,456,456,3,3,0,1,0
6,456,456,5,5,0,1,0
3,472,472,1,1,0,1,0
13,474,474,112,112,0,1,0
10,482,482,41,41,0,1,0

7,103,103,39,39,0,1,0
21,109,109,2,2,0,1,0
15,116,116,9,9,0,1,0
5,123,123,1,1,0,1,0
12,136,136,28,7,21,3,2
17,145,145,30,6,24,2,1
13,150,150,6,6,0,1,0
9,176,176,63,39,24,3,2
3,185,185,1,1,0,1,0
6,209,209,1,1,0,1,0
8,225,225,44,44,0,1,0
4,229,229,27,27,0,1,0
26,232,232,4,4,0,1,0
16,257,257,34,34,0,1,0
2,310,310,3,3,0,1,0
0,351,351,21,15,6,3,2
23,358,358,16,16,0,1,0
20,390,390,12,4,8,3,2
10,402,402,125,32,93,4,3
18,404,404,68,25,43,3,2
25,405,405,8,8,0,1,0
19,433,433,27,27,0,1,0
14,441,441,70,28,42,2,1
22,476,476,53,5,48,3,2
1,482,482,73,37,36,3,2
11,494,494,37,37,0,1,0
24,494,494,133,112,21,2,1

18,100,100,2,2,0,1,0
25,118,118,19,5,14,2,1
9,126,126,9,9,0,1,0
11,132,132,5,5,0,1,0
23,140,140,2,2,0,1,0
17,143,143,2,2,0,1,0
0,146,146,67,67,0,1,0
3,184,184,24,24,0,1,0
15,204,204,23,7,16,2,1
1,209,209,1,1,0,1,0
26,219,219,57,10,47,4,3
30,220,220,89,80,9,2,1
29,236,236,12,2,10,3,2
2,246,246,42,5,37,4,3
4,247,247,2,2,0,1,0
13,268,268,3,3,0,1,0
10,274,274,19,19,0,1,0
28,276,276,1,1,0,1,0
16,279,279,33,33,0,1,0
12,320,320,39,2,37,2,1
7,332,332,81,81,0,1,0
21,336,336,10,10,0,1,0
20,340,340,29,29,0,1,0
24,367,367,11,11,0,1,0
8,388,388,37,37,0,1,0
14,391,391,52,19,33,4,3
5,399,399,17,17,0,1,0
27,409,409,16,10,6,2,1
19,450,450,96,96,0,1,0
6,479,479,1,1,0,1,0
22,489,489,38,38,0,1,0

4,122,122,1,1,0,1,0
12,133,133,1,1,0,1,0
28,135,135,13,4,9,3,2
24,153,153,16,4,12,4,3
3,155,155,5,5,0,1,0
9,172,172,40,1,39,4,3
1,183,183,15,15,0,1,0
27,192,192,22,22,0,1,0
25,215,215,23,23,0,1,0
26,230,230,3,3,0,1,0
5,255,255,74,74,0,1,0
18,274,274,81,81,0,1,0
14,277,277,36,26,10,3,2
19,277,277,12,12,0,1,0
0,291,291,19,5,14,3,2
15,296,296,32,32,0,1,0
17,299,299,9,1,8,3,2
13,311,311,23,23,0,1,0
7,313,313,1,1,0,1,0
10,335,335,74,16,58,3,2
22,336,336,38,17,21,3,2
30,344,344,45,11,34,3,2
6,367,367,7,3,4,2,1
20,391,391,98,26,72,3,2
11,402,402,96,49,47,3,2
8,416,416,37,37,0,1,0
2,429,429,47,47,0,1,0
16,436,436,34,34,0,1,0
21,471,471,45,45,0,1,0
23,475,475,13,3,10,2,1
29,490,490,10,10,0,1,0

21,101,101,8,8,0,1,0
15,114,114,5,5,0,1,0
27,116,116,23,23,0,1,0
26,116,116,5,5,0,1,0
10,122,122,8,3,5,2,1
3,145,145,1,1,0,1,0
11,162,162,8,8,0,1,0
7,163,163,17,14,3,2,1
2,168,168,22,22,0,1,0
4,177,177,25,25,0,1,0
22,179,179,1,1,0,1,0
19,239,239,30,30,0,1,0
20,260,260,35,35,0,1,0
13,270,270,67,61,6,2,1
28,300,300,21,3,18,3,2
1,302,302,104,104,0,1,0
12,313,313,51,51,0,1,0
25,332,332,18,18,0,1,0
17,336,336,86,86,0,1,0
0,338,338,22,1,21,4,3
14,366,366,22,22,0,1,0
5,379,379,46,46,0,1,0
8,422,422,56,56,0,1,0
18,429,429,7,1,6,3,2
24,444,444,82,22,60,3,2
6,445,445,100,97,3,2,1
16,448,448,47,47,0,1,0
9,468,468,24,24,0,1,0
23,488,488,8,5,3,2,1

22,101,101,4,4,0,1,0
17,114,114,10,10,0,1,0
30,115,115,10,10,0,1,0
32,123,123,5,5,0,1,0
29,127,127,4,4,0,1,0
3,128,128,30,11,19,2,1
18,128,128,1,1,0,1,0
23,133,133,5,5,0,1,0
24,136,136,8,2,6,2,1
1,140,140,4,4,0,1,0
2,152,152,27,27,0,1,0
16,171,171,14,4,10,2,1
21,179,179,90,54,36,2,1
27,224,224,89,89,0,1,0
7,225,225,40,36,4,2,1
15,226,226,29,29,0,1,0
31,239,239,1,1,0,1,0
11,249,249,62,36,26,2,1
28,251,251,6,2,4,2,1
10,272,272,4,4,0,1,0
0,324,324,13,13,0,1,0
19,370,370,41,15,26,3,2
6,374,374,10,10,0,1,0
8,377,377,20,20,0,1,0
25,398,398,30,30,0,1,0
12,407,407,38,38,0,1,0
4,414,414,12,12,0,1,0
14,431,431,1,1,0,1,0
9,459,459,31,31,0,1,0
20,463,463,49,49,0,1,0
26,473,473,8,8,0,1,0
5,486,486,24,24,0,1,0
33,487,487,50,50,0,1,0
13,490,490,30,30,0,1,0

8,100,100,19,19,0,1,0
24,108,108,12,12,0,1,0
29,114,114,7,4,3,2,1
30,142,142,1,1,0,1,0
5,199,199,1,1,0,1,0
20,201,201,4,4,0,1,0
18,202,202,42,24,18,3,2
21,205,205,31,13,18,3,2
26,209,209,9,9,0,1,0
28,257,257,11,2,9,4,3
19,259,259,46,46,0,1,0
7,293,293,29,11,18,3,2
16,313,313,87,31,56,3,2
3,314,314,2,2,0,1,0
0,330,330,17,2,15,2,1
14,336,336,26,9,17,2,1
6,339,339,78,55,23,2,1
15,341,341,89,73,16,2,1
13,342,342,32,20,12,3,2
11,369,369,31,9,22,4,3
12,375,375,54,14,40,2,1
27,383,383,48,7,41,2,1
22,403,403,2,2,0,1,0
9,432,432,99,91,8,2,1
25,433,433,5,5,0,1,0
17,465,465,46,4,42,3,2
2,468,468,70,30,40,3,2
1,476,476,31,13,18,4,3
4,483,483,11,2,9,4,3
23,496,496,19,19,0,1,0
10,497,497,77,43,34,3,2

1,122,122,52,25,27,2,1
30,141,141,10,10,0,1,0
23,145,145,1,1,0,1,0
16,155,155,39,23,16,2,1
25,173,173,4,4,0,1,0
14,202,202,12,12,0,1,0
24,219,219,35,3,32,3,2
22,228,228,29,7,22,3,2
26,232,232,5,5,0,1,0
15,239,239,20,15,5,2,1
12,245,245,16,13,3,2,1
8,246,246,6,6,0,1,0
9,265,265,7,7,0,1,0
0,278,278,6,6,0,1,0
6,297,297,6,3,3,2,1
13,305,305,35,35,0,1,0
7,346,346,34,3,31,2,1
31,346,346,17,17,0,1,0
20,354,354,36,36,0,1,0
27,380,380,79,67,12,4,3
4,404,404,2,2,0,1,0
19,405,405,102,81,21,4,3
11,411,411,2,2,0,1,0
2,422,422,96,96,0,1,0
5,427,427,7,7,0,1,0
28,427,427,32,6,26,4,3
18,442,442,46,46,0,1,0
29,456,456,40,40,0,1,0
17,469,469,79,79,0,1,0
3,478,478,38,16,22,4,3
32,490,490,10,10,0,1,0
21,496,496,81,45,36,3,2
10,496,496,39,39,0,1,0

11,111,111,1,1,0,1,0
35,114,114,18,3,15,2,1
24,119,119,11,11,0,1,0
21,135,135,45,45,0,1,0
17,136,136,1,1,0,1,0
38,139,139,25,25,0,1,0
16,139,139,3,3,0,1,0
4,151,151,3,3,0,1,0
19,169,169,15,15,0,1,0
12,174,174,2,2,0,1,0
9,176,176,3,3,0,1,0
14,195,195,29,29,0,1,0
20,196,196,27,1,26,3,2
6,213,213,4,4,0,1,0
2,221,221,7,7,0,1,0
10,227,227,2,2,0,1,0
37,228,228,6,6,0,1,0
23,230,230,6,6,0,1,0
5,234,234,1,1,0,1,0
36,245,245,111,111,0,1,0
28,251,251,14,14,0,1,0
3,254,254,30,30,0,1,0
0,255,255,20,20,0,1,0
18,270,270,27,23,4,2,1
30,297,297,10,4,6,3,2
25,315,315,11,6,5,2,1
7,332,332,9,6,3,2,1
13,341,341,1,1,0,1,0
15,347,347,24,17,7,2,1
8,392,392,28,28,0,1,0
27,402,402,48,21,27,2,1
22,413,413,19,11,8,2,1
29,415,415,22,10,12,3,2
1,417,417,96,12,84,4,3
32,453,453,31,11,20,2,1
26,462,462,50,50,0,1,0
33,462,462,37,37,0,1,0
34,466,466,22,8,14,3,2
31,477,477,48,9,39,4,3

0,106,106,20,20,0,1,0
29,117,117,12,8,4,2,1
4,121,121,1,1,0,1,0
8,150,150,11,6,5,2,1
15,151,151,21,3,18,2,1
27,159,159,26,26,0,1,0
22,162,162,10,10,0,1,0
1,164,164,16,16,0,1,0
2,205,205,35,35,0,1,0
12,225,225,28,28,0,1,0
24,237,237,47,10,37,2,1
14,253,253,2,2,0,1,0
17,260,260,41,11,30,4,3
25,271,271,26,26,0,1,0
32,275,275,49,40,9,4,3
23,276,276,10,10,0,1,0
5,301,301,28,28,0,1,0
7,322,322,31,13,18,2,1
13,322,322,5,5,0,1,0
16,340,340,20,11,9,2,1
30,375,375,35,3,32,2,1
21,380,380,1,1,0,1,0
19,387,387,76,76,0,1,0
10,390,390,29,29,0,1,0
11,396,396,39,9,30,2,1
18,409,409,30,30,0,1,0
28,420,420,51,12,39,4,3
26,428,428,22,4,18,4,3
9,453,453,71,41,30,3,2
6,454,454,21,21,0,1,0
20,456,456,17,7,10,3,2
3,458,458,69,69,0,1,0
31,481,481,28,28,0,1,0

4,118,118,1,1,0,1,0
30,119,119,12,12,0,1,0
33,152,152,16,10,6,2,1
12,155,155,17,17,0,1,0
19,161,161,3,3,0,1,0
23,171,171,15,7,8,2,1
24,186,186,36,28,8,3,2
26,189,189,18,18,0,1,0
27,193,193,34,9,25,4,3
25,196,196,9,9,0,1,0
21,224,224,3,3,0,1,0
7,231,231,26,14,12,2,1
22,242,242,15,15,0,1,0
18,256,256,8,8,0,1,0
14,265,265,31,8,23,2,1
31,286,286,1,1,0,1,0
2,287,287,67,27,40,2,1
1,288,288,11,2,9,4,3
3,288,288,6,1,5,2,1
13,311,311,10,10,0,1,0
35,313,313,22,1,21,3,2
5,316,316,3,3,0,1,0
8,336,336,3,3,0,1,0
9,337,337,71,29,42,4,3
15,345,345,44,44,0,1,0
29,347,347,1,1,0,1,0
17,366,366,33,33,0,1,0
32,367,367,104,22,82,4,3
6,435,435,66,66,0,1,0
34,443,443,25,10,15,2,1
10,467,467,35,35,0,1,0
16,469,469,75,31,44,4,3
20,473,473,72,27,45,4,3
0,475,475,13,4,9,2,1
28,499,499,91,43,48,3,2
11,500,500,10,10,0,1,0

5,104,104,3,3,0,1,0
25,126,126,12,12,0,1,0
29,141,141,2,2,0,1,0
23,146,146,9,6,3,2,1
7,153,153,29,20,9,4,3
6,155,155,49,49,0,1,0
20,155,155,21,21,0,1,0
22,157,157,20,20,0,1,0
26,160,160,5,5,0,1,0
17,190,190,75,75,0,1,0
4,190,190,36,36,0,1,0
3,198,198,42,9,33,4,3
8,202,202,6,6,0,1,0
18,207,207,13,1,12,4,3
21,231,231,4,4,0,1,0
12,254,254,16,16,0,1,0
14,266,266,13,1,12,2,1
9,271,271,13,3,10,2,1
28,286,286,46,46,0,1,0
1,290,290,26,26,0,1,0
11,308,308,1,1,0,1,0
13,321,321,8,8,0,1,0
15,322,322,42,35,7,2,1
0,342,342,20,2,18,2,1
10,344,344,27,10,17,2,1
27,357,357,22,22,0,1,0
19,360,360,36,17,19,2,1
2,377,377,83,3,80,3,2
24,412,412,7,7,0,1,0
30,472,472,65,41,24,2,1
16,493,493,44,7,37,2,1

4,129,129,16,2,14,3,2
23,167,167,3,3,0,1,0
25,192,192,11,3,8,2,1
9,233,233,68,68,0,1,0
8,249,249,21,21,0,1,0
7,259,259,113,113,0,1,0
0,317,317,21,1,20,2,1
2,320,320,26,8,18,3,2
5,328,328,14,14,0,1,0
16,356,356,52,1,51,4,3
6,369,369,1,1,0,1,0
12,379,379,34,34,0,1,0
14,394,394,62,17,45,4,3
13,400,400,87,87,0,1,0
19,420,420,30,2,28,3,2
22,422,422,37,4,33,3,2
1,431,431,161,56,105,4,3
15,439,439,65,65,0,1,0
20,442,442,22,22,0,1,0
21,444,444,11,11,0,1,0
10,448,448,33,33,0,1,0
18,452,452,35,35,0,1,0
24,461,461,28,10,18,3,2
11,463,463,41,29,12,3,2
3,468,468,46,4,42,4,3
17,489,489,122,35,87,4,3

18,102,102,3,3,0,1,0
34,115,115,13,8,5,2,1
13,122,122,32,5,27,4,3
6,123,123,3,3,0,1,0
21,128,128,2,2,0,1,0
3,145,145,3,3,0,1,0
5,147,147,1,1,0,1,0
19,161,161,27,27,0,1,0
23,180,180,77,32,45,4,3
24,193,193,3,3,0,1,0
12,214,214,6,6,0,1,0
30,222,222,7,3,4,2,1
32,225,225,24,24,0,1,0
33,258,258,25,11,14,3,2
20,298,298,77,56,21,2,1
1,302,302,7,7,0,1,0
26,311,311,2,2,0,1,0
14,336,336,19,12,7,2,1
15,353,353,11,11,0,1,0
16,359,359,47,47,0,1,0
10,364,364,7,7,0,1,0
8,369,369,41,41,0,1,0
31,373,373,7,7,0,1,0
11,383,383,25,25,0,1,0
29,383,383,23,23,0,1,0
28,394,394,7,7,0,1,0
4,406,406,33,8,25,2,1
9,408,408,34,34,0,1,0
25,414,414,14,5,9,4,3
2,459,459,97,97,0,1,0
7,468,468,72,72,0,1,0
27,471,471,15,15,0,1,0
17,475,475,82,25,57,4,3
22,477,477,111,7,104,4,3
0,495,495,46,46,0,1,0

10,105,105,2,2,0,1,0
12,133,133,31,31,0,1,0
22,142,142,43,43,0,1,0
2,152,152,40,40,0,1,0
13,171,171,17,2,15,4,3
8,174,174,15,3,12,3,2
28,178,178,6,1,5,2,1
14,183,183,1,1,0,1,0
25,208,208,14,2,12,2,1
26,212,212,15,15,0,1,0
18,240,240,24,24,0,1,0
3,244,244,6,2,4,2,1
29,251,251,4,1,3,2,1
1,261,261,57,37,20,3,2
5,300,300,18,14,4,2,1
0,314,314,15,15,0,1,0
17,322,322,11,11,0,1,0
16,325,325,12,12,0,1,0
20,350,350,14,6,8,3,2
21,372,372,2,2,0,1,0
9,405,405,37,2,35,4,3
7,410,410,95,14,81,4,3
6,416,416,57,45,12,2,1
4,441,441,13,5,8,2,1
15,455,455,18,6,12,4,3
11,458,458,27,19,8,3,2
23,466,466,91,66,25,2,1
27,472,472,127,127,0,1,0
19,487,487,49,49,0,1,0
24,492,492,151,85,66,4,3

6,100,100,2,2,0,1,0
0,105,105,26,26,0,1,0
31,111,111,4,4,0,1,0
17,114,114,14,14,0,1,0
2,114,114,2,2,0,1,0
29,117,117,10,10,0,1,0
21,127,127,3,3,0,1,0
20,137,137,1,1,0,1,0
7,153,153,1,1,0,1,0
13,166,166,10,10,0,1,0
1,205,205,1,1,0,1,0
19,206,206,26,22,4,2,1
23,234,234,26,17,9,4,3
25,258,258,21,14,7,2,1
8,259,259,23,23,0,1,0
3,286,286,45,36,9,4,3
15,303,303,14,14,0,1,0
12,330,330,69,69,0,1,0
28,334,334,38,38,0,1,0
30,348,348,38,26,12,3,2
22,348,348,75,39,36,2,1
11,349,349,57,34,23,3,2
27,366,366,39,39,0,1,0
18,379,379,12,12,0,1,0
4,412,412,17,17,0,1,0
26,435,435,76,16,60,3,2
9,436,436,54,4,50,4,3
10,440,440,108,108,0,1,0
24,441,441,2,2,0,1,0
16,472,472,138,138,0,1,0
14,483,483,12,12,0,1,0
5,491,491,71,25,46,2,1

21,105,105,4,4,0,1,0
27,118,118,25,25,0,1,0
3,130,130,1,1,0,1,0
20,144,144,4,4,0,1,0
16,166,166,41,21,20,2,1
5,191,191,24,10,14,2,1
8,192,192,3,3,0,1,0
1,207,207,4,4,0,1,0
13,220,220,19,19,0,1,0
17,233,233,18,18,0,1,0
24,241,241,20,20,0,1,0
18,245,245,22,19,3,2,1
19,252,252,2,2,0,1,0
14,260,260,21,16,5,2,1
6,301,301,1,1,0,1,0
23,306,306,28,28,0,1,0
4,322,322,13,5,8,2,1
11,348,348,40,40,0,1,0
0,356,356,8,8,0,1,0
30,368,368,2,2,0,1,0
25,372,372,39,32,7,2,1
12,376,376,18,13,5,2,1
22,380,380,79,61,18,3,2
28,394,394,59,59,0,1,0
10,397,397,7,7,0,1,0
2,399,399,399,372,27,4,3
9,412,412,6,1,5,2,1
7,429,429,2,2,0,1,0
29,437,437,9,9,0,1,0
15,467,467,105,48,57,4,3
26,485,485,15,15,0,1,0

12,104,104,6,6,0,1,0
18,111,111,11,11,0,1,0
16,123,123,4,1,3,2,1
30,133,133,27,27,0,1,0
10,134,134,12,12,0,1,0
13,137,137,37,21,16,3,2
4,142,142,6,3,3,2,1
11,163,163,23,17,6,3,2
0,225,225,23,23,0,1,0
19,261,261,77,77,0,1,0
21,263,263,13,1,12,4,3
31,271,271,9,9,0,1,0
15,284,284,9,6,3,2,1
23,311,311,70,70,0,1,0
22,311,311,43,25,18,4,3
26,311,311,48,30,18,2,1
8,335,335,16,5,11,2,1
9,351,351,14,14,0,1,0
2,353,353,18,18,0,1,0
20,363,363,9,9,0,1,0
25,373,373,2,2,0,1,0
6,377,377,42,15,27,2,1
33,386,386,44,44,0,1,0
32,414,414,5,5,0,1,0
28,420,420,33,33,0,1,0
3,425,425,6,6,0,1,0
5,439,439,46,31,15,4,3
29,440,440,12,12,0,1,0
24,444,444,22,14,8,3,2
27,449,449,10,1,9,2,1
7,450,450,54,54,0,1,0
14,451,451,87,87,0,1,0
1,458,458,17,17,0,1,0
34,491,491,93,37,56,4,3
17,495,495,8,8,0,1,0

8,100,100,1,1,0,1,0
24,119,119,3,3,0,1,0
0,122,122,2,2,0,1,0
29,147,147,12,12,0,1,0
7,151,151,11,11,0,1,0
12,155,155,6,2,4,2,1
33,165,165,17,17,0,1,0
23,172,172,5,5,0,1,0
6,172,172,37,37,0,1,0
18,178,178,27,7,20,2,1
2,213,213,5,5,0,1,0
22,213,213,6,2,4,2,1
15,217,217,23,10,13,2,1
39,227,227,51,11,40,2,1
35,234,234,48,48,0,1,0
28,246,246,11,11,0,1,0
21,249,249,27,8,19,3,2
1,252,252,2,2,0,1,0
19,253,253,29,9,20,3,2
20,265,265,8,4,4,2,1
16,284,284,73,31,42,2,1
3,290,290,8,8,0,1,0
5,295,295,8,8,0,1,0
32,298,298,15,15,0,1,0
17,320,320,8,8,0,1,0
38,341,341,9,9,0,1,0
25,349,349,68,68,0,1,0
37,353,353,17,6,11,2,1
30,373,373,11,11,0,1,0
26,376,376,45,45,0,1,0
11,382,382,1,1,0,1,0
27,387,387,60,60,0,1,0
10,403,403,23,23,0,1,0
36,414,414,18,7,11,2,1
34,421,421,106,106,0,1,0
31,432,432,17,17,0,1,0
9,448,448,18,18,0,1,0
13,465,465,6,6,0,1,0
14,467,467,37,9,28,4,3
4,492,492,59,59,0,1,0

28,108,108,6,6,0,1,0
8,109,109,1,1,0,1,0
10,115,115,19,19,0,1,0
25,122,122,4,4,0,1,0
6,132,132,27,10,17,2,1
9,143,143,11,2,9,4,3
1,145,145,14,14,0,1,0
17,173,173,6,6,0,1,0
5,186,186,15,15,0,1,0
4,204,204,3,3,0,1,0
14,227,227,13,13,0,1,0
26,252,252,60,13,47,4,3
31,259,259,17,7,10,3,2
7,259,259,14,14,0,1,0
16,299,299,16,7,9,2,1
27,309,309,62,38,24,2,1
11,331,331,49,49,0,1,0
21,337,337,4,4,0,1,0
29,346,346,124,124,0,1,0
30,348,348,30,30,0,1,0
23,360,360,55,55,0,1,0
13,361,361,47,17,30,3,2
2,393,393,15,15,0,1,0
0,402,402,43,43,0,1,0
19,406,406,53,53,0,1,0
18,433,433,35,11,24,3,2
22,434,434,2,2,0,1,0
20,445,445,32,6,26,3,2
3,476,476,78,6,72,3,2
12,486,486,36,36,0,1,0
15,487,487,88,8,80,3,2
24,495,495,24,9,15,2,1

6,101,101,15,15,0,1,0
12,101,101,11,5,6,3,2
10,103,103,1,1,0,1,0
15,107,107,6,3,3,2,1
16,111,111,10,10,0,1,0
8,142,142,1,1,0,1,0
7,169,169,6,6,0,1,0
13,193,193,11,11,0,1,0
21,250,250,66,66,0,1,0
11,254,254,29,20,9,2,1
2,265,265,61,61,0,1,0
26,284,284,53,37,16,3,2
9,317,317,38,5,33,2,1
20,320,320,62,17,45,2,1
0,326,326,33,7,26,3,2
19,337,337,24,2,22,2,1
29,352,352,8,8,0,1,0
14,361,361,124,124,0,1,0
28,368,368,29,29,0,1,0
18,372,372,41,41,0,1,0
22,377,377,30,30,0,1,0
25,397,397,13,13,0,1,0
4,405,405,13,13,0,1,0
27,413,413,12,6,6,3,2
24,444,444,17,3,14,2,1
1,453,453,79,58,21,2,1
23,458,458,107,19,88,4,3
3,460,460,29,29,0,1,0
30,472,472,47,21,26,3,2
31,479,479,3,3,0,1,0
5,487,487,1,1,0,1,0
17,493,493,45,45,0,1,0

6,105,105,1,1,0,1,0
1,124,124,3,3,0,1,0
12,125,125,21,21,0,1,0
10,128,128,3,3,0,1,0
21,190,190,7,7,0,1,0
28,204,204,3,3,0,1,0
25,207,207,43,9,34,3,2
26,215,215,10,4,6,2,1
9,219,219,6,6,0,1,0
2,222,222,56,50,6,2,1
5,257,257,33,33,0,1,0
30,260,260,4,1,3,2,1
19,271,271,68,59,9,2,1
29,295,295,10,10,0,1,0
18,300,300,50,50,0,1,0
23,307,307,10,3,7,2,1
15,311,311,25,25,0,1,0
7,331,331,6,6,0,1,0
4,356,356,132,132,0,1,0
24,363,363,104,104,0,1,0
11,366,366,24,24,0,1,0
16,374,374,7,2,5,2,1
0,391,391,35,35,0,1,0
8,394,394,40,40,0,1,0
27,421,421,12,12,0,1,0
20,437,437,32,32,0,1,0
14,449,449,2,2,0,1,0
17,455,455,10,10,0,1,0
3,459,459,92,10,82,3,2
13,466,466,55,46,9,2,1
22,469,469,145,49,96,4,3

21,137,137,17,17,0,1,0
20,144,144,28,6,22,3,2
18,192,192,8,8,0,1,0
30,194,194,10,10,0,1,0
8,203,203,3,3,0,1,0
0,208,208,1,1,0,1,0
11,215,215,11,7,4,2,1
12,219,219,13,5,8,2,1
4,223,223,4,4,0,1,0
13,232,232,27,27,0,1,0
7,241,241,1,1,0,1,0
17,244,244,42,42,0,1,0
5,248,248,4,1,3,2,1
1,250,250,140,140,0,1,0
23,250,250,25,25,0,1,0
16,266,266,10,10,0,1,0
19,278,278,5,5,0,1,0
14,282,282,4,4,0,1,0
32,282,282,13,13,0,1,0
24,306,306,44,44,0,1,0
27,315,315,49,49,0,1,0
29,324,324,17,11,6,3,2
10,334,334,41,1,40,3,2
34,336,336,37,7,30,4,3
25,336,336,11,11,0,1,0
31,347,347,50,5,45,2,1
15,347,347,20,20,0,1,0
6,368,368,2,2,0,1,0
28,379,379,18,18,0,1,0
33,380,380,62,56,6,2,1
22,401,401,19,5,14,2,1
35,412,412,23,15,8,2,1
9,420,420,11,1,10,3,2
2,468,468,108,32,76,3,2
26,470,470,77,5,72,4,3
3,498,498,15,15,0,1,0

18,104,104,14,14,0,1,0
23,119,119,9,9,0,1,0
15,120,120,4,1,3,2,1
4,139,139,11,5,6,2,1
25,182,182,6,3,3,2,1
20,198,198,10,10,0,1,0
7,233,233,2,2,0,1,0
10,241,241,3,3,0,1,0
30,256,256,38,38,0,1,0
19,310,310,9,9,0,1,0
16,334,334,9,9,0,1,0
6,335,335,36,4,32,3,2
3,339,339,13,1,12,3,2
9,344,344,28,28,0,1,0
29,345,345,25,25,0,1,0
11,357,357,43,43,0,1,0
31,370,370,38,16,22,3,2
17,372,372,14,8,6,3,2
0,384,384,65,17,48,3,2
8,395,395,229,163,66,3,2
14,407,407,27,15,12,3,2
22,415,415,3,3,0,1,0
13,420,420,32,5,27,2,1
26,427,427,16,16,0,1,0
24,431,431,10,2,8,2,1
27,436,436,19,19,0,1,0
28,437,437,215,140,75,4,3
21,444,444,141,141,0,1,0
2,454,454,36,36,0,1,0
1,476,476,43,43,0,1,0
5,488,488,22,22,0,1,0
12,499,499,10,10,0,1,0

6,100,100,3,3,0,1,0
8,125,125,4,4,0,1,0
21,127,127,7,4,3,2,1
25,129,129,4,1,3,2,1
34,132,132,4,1,3,2,1
33,136,136,14,14,0,1,0
0,158,158,5,5,0,1,0
29,170,170,23,4,19,4,3
28,186,186,27,2,25,2,1
15,234,234,28,19,9,4,3
5,253,253,2,2,0,1,0
24,262,262,44,3,41,2,1
3,279,279,33,1,32,3,2
17,298,298,2,2,0,1,0
27,302,302,18,18,0,1,0
32,307,307,17,17,0,1,0
1,336,336,48,48,0,1,0
2,348,348,38,38,0,1,0
30,353,353,31,21,10,2,1
26,364,364,78,12,66,3,2
13,366,366,15,15,0,1,0
12,367,367,15,15,0,1,0
23,417,417,112,112,0,1,0
18,417,417,53,53,0,1,0
16,422,422,49,38,11,4,3
10,434,434,4,4,0,1,0
11,435,435,91,4,87,4,3
22,443,443,46,4,42,4,3
9,451,451,71,34,37,4,3
31,463,463,40,24,16,3,2
19,474,474,2,2,0,1,0
14,479,479,10,7,3,2,1
20,482,482,43,43,0,1,0
4,493,493,92,92,0,1,0
7,495,495,47,47,0,1,0

19,106,106,3,3,0,1,0
0,125,125,18,8,10,3,2
11,142,142,23,23,0,1,0
22,144,144,21,15,6,2,1
12,146,146,11,7,4,2,1
23,156,156,3,3,0,1,0
25,174,174,3,3,0,1,0
30,186,186,57,36,21,2,1
33,187,187,18,18,0,1,0
13,197,197,41,41,0,1,0
10,201,201,20,20,0,1,0
7,207,207,1,1,0,1,0
4,244,244,9,1,8,3,2
20,245,245,23,23,0,1,0
14,276,276,46,2,44,2,1
16,278,278,68,68,0,1,0
1,289,289,10,10,0,1,0
8,294,294,3,3,0,1,0
21,296,296,8,3,5,2,1
3,301,301,1,1,0,1,0
26,307,307,12,12,0,1,0
2,315,315,23,1,22,2,1
24,319,319,115,93,22,4,3
6,341,341,21,4,17,2,1
9,342,342,23,23,0,1,0
32,375,375,2,2,0,1,0
34,392,392,4,4,0,1,0
28,407,407,52,3,49,2,1
27,408,408,14,5,9,2,1
5,410,410,2,2,0,1,0
31,426,426,106,106,0,1,0
18,454,454,58,58,0,1,0
29,458,458,33,18,15,4,3
15,465,465,1,1,0,1,0
17,490,490,37,3,34,3,2

21,120,120,3,3,0,1,0
5,120,120,1,1,0,1,0
3,120,120,6,2,4,2,1
20,123,123,15,12,3,2,1
9,141,141,14,7,7,2,1
19,148,148,11,11,0,1,0
31,151,151,7,7,0,1,0
11,152,152,3,3,0,1,0
30,163,163,4,4,0,1,0
6,173,173,17,17,0,1,0
14,191,191,58,58,0,1,0
25,191,191,46,18,28,3,2
28,226,226,73,73,0,1,0
17,235,235,10,10,0,1,0
10,242,242,9,9,0,1,0
24,280,280,14,7,7,2,1
26,310,310,27,27,0,1,0
4,338,338,7,4,3,2,1
8,367,367,14,8,6,2,1
23,367,367,20,1,19,4,3
16,380,380,77,77,0,1,0
1,383,383,31,23,8,2,1
27,383,383,18,2,16,2,1
12,410,410,9,9,0,1,0
15,412,412,60,60,0,1,0
32,415,415,37,37,0,1,0
18,418,418,145,145,0,1,0
7,430,430,16,16,0,1,0
29,432,432,7,7,0,1,0
2,440,440,18,12,6,2,1
0,460,460,164,129,35,2,1
13,478,478,19,19,0,1,0
22,495,495,25,25,0,1,0

0,102,102,9,9,0,1,0
28,119,119,3,3,0,1,0
3,124,124,6,1,5,2,1
15,127,127,17,17,0,1,0
5,159,159,23,23,0,1,0
18,169,169,17,9,8,2,1
6,191,191,24,24,0,1,0
29,222,222,55,7,48,2,1
24,232,232,47,38,9,4,3
7,236,236,11,1,10,2,1
14,270,270,23,23,0,1,0
2,278,278,14,6,8,2,1
26,291,291,19,19,0,1,0
16,299,299,32,5,27,4,3
4,301,301,92,92,0,1,0
1,305,305,13,13,0,1,0
13,311,311,24,24,0,1,0
9,319,319,48,48,0,1,0
12,354,354,25,25,0,1,0
11,371,371,32,32,0,1,0
22,372,372,73,58,15,2,1
21,377,377,22,22,0,1,0
27,377,377,39,6,33,4,3
25,397,397,31,7,24,2,1
20,433,433,48,48,0,1,0
17,454,454,7,2,5,2,1
10,455,455,76,76,0,1,0
23,478,478,51,15,36,2,1
19,479,479,1,1,0,1,0
8,488,488,97,54,43,4,3

2,126,126,5,5,0,1,0
30,134,134,14,14,0,1,0
29,186,186,13,9,4,2,1
19,195,195,63,13,50,2,1
15,200,200,2,2,0,1,0
27,236,236,35,25,10,3,2
16,241,241,49,49,0,1,0
26,261,261,7,7,0,1,0
1,266,266,11,6,5,2,1
23,281,281,7,7,0,1,0
11,295,295,7,7,0,1,0
8,297,297,100,12,88,3,2
20,317,317,1,1,0,1,0
24,346,346,5,2,3,2,1
13,347,347,2,2,0,1,0
14,359,359,13,13,0,1,0
7,368,368,67,67,0,1,0
6,370,370,40,10,30,2,1
28,373,373,63,63,0,1,0
12,377,377,17,17,0,1,0
9,390,390,95,46,49,2,1
0,402,402,27,27,0,1,0
22,410,410,7,4,3,2,1
3,413,413,97,60,37,3,2
4,433,433,59,51,8,2,1
17,438,438,9,9,0,1,0
25,444,444,60,22,38,4,3
18,453,453,70,70,0,1,0
5,458,458,29,29,0,1,0
10,460,460,17,5,12,2,1
21,496,496,99,42,57,4,3

24,107,107,17,8,9,2,1
23,116,116,1,1,0,1,0
10,133,133,1,1,0,1,0
28,153,153,3,3,0,1,0
27,172,172,17,17,0,1,0
1,183,183,1,1,0,1,0
2,188,188,2,2,0,1,0
4,211,211,22,22,0,1,0
13,235,235,11,6,5,2,1
20,247,247,13,13,0,1,0
26,250,250,40,40,0,1,0
15,261,261,40,40,0,1,0
17,276,276,10,10,0,1,0
12,281,281,56,56,0,1,0
34,283,283,6,6,0,1,0
7,299,299,8,8,0,1,0
8,312,312,25,25,0,1,0
25,313,313,52,14,38,3,2
5,319,319,3,3,0,1,0
6,319,319,1,1,0,1,0
22,326,326,103,58,45,4,3
21,343,343,19,11,8,2,1
11,344,344,22,22,0,1,0
33,350,350,19,7,12,3,2
0,355,355,112,112,0,1,0
32,355,355,49,49,0,1,0
18,382,382,70,70,0,1,0
31,396,396,8,8,0,1,0
30,433,433,34,34,0,1,0
29,436,436,113,16,97,4,3
3,462,462,15,15,0,1,0
16,465,465,68,68,0,1,0
19,477,477,7,2,5,2,1
9,480,480,70,70,0,1,0
14,493,493,16,7,9,4,3

26,120,120,26,26,0,1,0
11,121,121,5,5,0,1,0
0,128,128,7,7,0,1,0
27,140,140,11,11,0,1,0
12,146,146,1,1,0,1,0
16,151,151,29,15,14,2,1
35,153,153,2,2,0,1,0
29,154,154,35,35,0,1,0
10,162,162,10,4,6,2,1
6,182,182,1,1,0,1,0
25,213,213,34,13,21,4,3
24,231,231,5,2,3,2,1
5,254,254,21,21,0,1,0
28,260,260,4,4,0,1,0
13,263,263,38,38,0,1,0
3,268,268,8,5,3,2,1
14,295,295,1,1,0,1,0
31,295,295,37,25,12,2,1
33,303,303,60,33,27,4,3
7,309,309,16,7,9,4,3
1,323,323,50,26,24,4,3
22,337,337,46,11,35,3,2
9,344,344,2,2,0,1,0
8,364,364,15,15,0,1,0
20,366,366,9,9,0,1,0
21,373,373,6,6,0,1,0
38,378,378,39,2,37,2,1
34,387,387,9,5,4,2,1
17,396,396,7,7,0,1,0
36,428,428,60,60,0,1,0
18,435,435,29,6,23,2,1
2,436,436,27,27,0,1,0
15,437,437,60,60,0,1,0
4,445,445,45,45,0,1,0
30,452,452,68,46,22,2,1
19,458,458,75,23,52,3,2
37,474,474,10,10,0,1,0
23,494,494,28,28,0,1,0
32,494,494,37,37,0,1,0

0,104,104,42,16,26,3,2
27,118,118,3,3,0,1,0
18,165,165,10,2,8,2,1
5,197,197,20,6,14,2,1
1,207,207,31,10,21,4,3
9,211,211,1,1,0,1,0
28,218,218,41,41,0,1,0
12,221,221,51,51,0,1,0
21,229,229,5,5,0,1,0
26,230,230,48,20,28,2,1
17,232,232,53,7,46,3,2
6,233,233,1,1,0,1,0
11,235,235,39,39,0,1,0
7,251,251,14,14,0,1,0
30,253,253,2,2,0,1,0
23,269,269,11,11,0,1,0
22,295,295,33,16,17,2,1
24,295,295,26,26,0,1,0
2,300,300,25,3,22,4,3
10,301,301,27,12,15,2,1
14,320,320,18,6,12,2,1
19,325,325,8,8,0,1,0
8,329,329,4,1,3,2,1
15,357,357,117,39,78,4,3
29,377,377,31,31,0,1,0
4,379,379,41,20,21,2,1
16,393,393,13,2,11,2,1
25,396,396,12,2,10,3,2
20,398,398,62,53,9,4,3
3,447,447,35,17,18,2,1
13,449,449,25,25,0,1,0

11,108,108,23,8,15,2,1
32,113,113,20,10,10,2,1
18,114,114,8,8,0,1,0
5,115,115,1,1,0,1,0
16,123,123,1,1,0,1,0
29,134,134,2,2,0,1,0
26,138,138,31,1,30,3,2
21,154,154,3,3,0,1,0
15,159,159,4,4,0,1,0
20,162,162,18,18,0,1,0
33,168,168,12,12,0,1,0
28,168,168,2,2,0,1,0
10,185,185,14,8,6,3,2
13,186,186,4,1,3,2,1
14,189,189,7,2,5,2,1
12,196,196,25,5,20,2,1
24,228,228,15,1,14,2,1
1,235,235,20,16,4,2,1
9,274,274,41,41,0,1,0
25,294,294,16,16,0,1,0
17,302,302,3,3,0,1,0
22,321,321,33,33,0,1,0
7,325,325,4,4,0,1,0
23,332,332,78,37,41,2,1
30,365,365,21,21,0,1,0
4,406,406,101,101,0,1,0
2,426,426,94,4,90,3,2
6,437,437,10,10,0,1,0
0,441,441,11,11,0,1,0
19,455,455,78,78,0,1,0
34,461,461,94,94,0,1,0
3,461,461,13,2,11,3,2
8,480,480,103,103,0,1,0
31,482,482,8,8,0,1,0
27,498,498,43,19,24,4,3

20,114,114,15,15,0,1,0
17,115,115,12,12,0,1,0
4,123,123,3,3,0,1,0
29,136,136,18,1,17,3,2
14,165,165,4,4,0,1,0
30,168,168,66,22,44,3,2
28,178,178,15,15,0,1,0
25,206,206,1,1,0,1,0
11,223,223,27,6,21,2,1
18,226,226,9,9,0,1,0
8,271,271,15,15,0,1,0
13,278,278,19,2,17,4,3
1,290,290,35,35,0,1,0
27,307,307,3,3,0,1,0
19,314,314,21,21,0,1,0
12,322,322,127,95,32,3,2
3,335,335,39,9,30,4,3
22,340,340,46,42,4,2,1
16,352,352,13,13,0,1,0
26,358,358,47,17,30,3,2
15,368,368,95,31,64,3,2
10,378,378,124,84,40,3,2
24,435,435,4,4,0,1,0
21,443,443,34,34,0,1,0
0,446,446,53,23,30,2,1
23,462,462,9,3,6,2,1
2,462,462,12,12,0,1,0
5,471,471,4,4,0,1,0
7,475,475,27,27,0,1,0
6,498,498,1,1,0,1,0
9,500,500,69,39,30,4,3

27,104,104,17,2,15,3,2
33,131,131,1,1,0,1,0
19,139,139,6,6,0,1,0
2,144,144,11,5,6,3,2
30,144,144,32,14,18,4,3
24,145,145,15,15,0,1,0
23,157,157,3,3,0,1,0
11,180,180,13,5,8,3,2
17,188,188,3,3,0,1,0
13,198,198,33,33,0,1,0
21,198,198,39,39,0,1,0
34,211,211,12,12,0,1,0
8,240,240,33,33,0,1,0
15,283,283,6,6,0,1,0
12,291,291,15,15,0,1,0
7,316,316,7,1,6,2,1
3,320,320,7,7,0,1,0
5,321,321,13,13,0,1,0
10,324,324,2,2,0,1,0
14,345,345,5,5,0,1,0
1,355,355,44,44,0,1,0
31,369,369,8,2,6,2,1
35,376,376,11,11,0,1,0
29,377,377,46,10,36,4,3
18,386,386,26,17,9,2,1
9,391,391,54,54,0,1,0
22,400,400,94,31,63,3,2
25,400,400,15,9,6,2,1
36,401,401,50,19,31,2,1
20,413,413,40,10,30,2,1
6,420,420,83,5,78,3,2
26,427,427,4,4,0,1,0
32,439,439,78,78,0,1,0
16,458,458,15,12,3,2,1
0,461,461,114,24,90,3,2
28,474,474,51,51,0,1,0
4,475,475,4,4,0,1,0

25,107,107,3,3,0,1,0
3,111,111,22,22,0,1,0
1,116,116,5,5,0,1,0
35,120,120,21,21,0,1,0
29,120,120,8,8,0,1,0
26,127,127,10,1,9,4,3
8,144,144,7,7,0,1,0
12,150,150,16,16,0,1,0
30,151,151,5,1,4,2,1
9,184,184,30,10,20,4,3
27,194,194,42,42,0,1,0
13,202,202,6,6,0,1,0
15,206,206,11,4,7,2,1
34,210,210,16,10,6,3,2
33,212,212,92,10,82,3,2
19,217,217,12,12,0,1,0
24,227,227,8,8,0,1,0
6,229,229,3,3,0,1,0
18,236,236,10,2,8,2,1
10,241,241,22,22,0,1,0
0,245,245,1,1,0,1,0
28,253,253,10,7,3,2,1
16,253,253,23,13,10,3,2
7,278,278,69,62,7,2,1
2,292,292,14,4,10,2,1
22,300,300,51,51,0,1,0
20,315,315,1,1,0,1,0
31,338,338,10,10,0,1,0
21,355,355,2,2,0,1,0
32,357,357,7,7,0,1,0
4,369,369,26,18,8,3,2
11,372,372,48,30,18,2,1
23,440,440,103,103,0,1,0
5,441,441,2,2,0,1,0
17,472,472,7,7,0,1,0
14,482,482,72,72,0,1,0

7,109,109,26,14,12,4,3
10,109,109,7,1,6,2,1
2,155,155,94,58,36,3,2
16,181,181,17,17,0,1,0
18,194,194,18,3,15,2,1
13,195,195,8,8,0,1,0
15,197,197,28,28,0,1,0
21,224,224,32,32,0,1,0
11,250,250,19,19,0,1,0
22,253,253,76,28,48,4,3
0,266,266,37,33,4,2,1
20,297,297,5,5,0,1,0
5,297,297,44,30,14,3,2
17,306,306,89,89,0,1,0
14,330,330,14,2,12,3,2
12,339,339,53,53,0,1,0
19,344,344,30,18,12,2,1
3,352,352,89,89,0,1,0
9,370,370,17,17,0,1,0
23,408,408,9,5,4,2,1
1,462,462,18,9,9,4,3
8,468,468,13,13,0,1,0
4,487,487,76,76,0,1,0
6,493,493,10,10,0,1,0

1,121,121,3,3,0,1,0
5,127,127,2,2,0,1,0
35,138,138,4,1,3,2,1
11,144,144,2,2,0,1,0
31,155,155,83,59,24,2,1
33,171,171,10,10,0,1,0
29,178,178,3,3,0,1,0
27,181,181,68,15,53,3,2
7,205,205,1,1,0,1,0
4,219,219,15,15,0,1,0
16,235,235,1,1,0,1,0
23,237,237,21,21,0,1,0
2,241,241,2,2,0,1,0
26,244,244,19,11,8,2,1
32,247,247,1,1,0,1,0
37,248,248,28,18,10,3,2
36,250,250,29,29,0,1,0
0,289,289,106,52,54,4,3
20,293,293,4,1,3,2,1
13,312,312,7,7,0,1,0
30,320,320,24,6,18,4,3
10,324,324,6,1,5,2,1
24,352,352,1,1,0,1,0
9,383,383,63,32,31,2,1
14,384,384,37,15,22,2,1
17,392,392,47,32,15,2,1
28,394,394,27,23,4,2,1
21,409,409,19,19,0,1,0
8,409,409,39,39,0,1,0
15,418,418,29,29,0,1,0
22,422,422,1,1,0,1,0
25,423,423,15,15,0,1,0
18,436,436,102,90,12,2,1
12,442,442,51,13,38,2,1
6,445,445,8,8,0,1,0
3,485,485,32,32,0,1,0
34,490,490,22,8,14,2,1
19,496,496,7,7,0,1,0

5,110,110,16,16,0,1,0
12,115,115,12,12,0,1,0
17,131,131,3,3,0,1,0
6,142,142,41,16,25,2,1
13,144,144,27,27,0,1,0
20,151,151,20,20,0,1,0
9,183,183,2,2,0,1,0
2,211,211,35,35,0,1,0
14,234,234,35,35,0,1,0
16,248,248,5,2,3,2,1
8,256,256,2,2,0,1,0
1,260,260,145,36,109,4,3
22,263,263,26,15,11,2,1
19,263,263,19,15,4,2,1
3,281,281,35,2,33,4,3
4,303,303,50,8,42,4,3
18,312,312,28,28,0,1,0
0,324,324,51,51,0,1,0
15,339,339,23,23,0,1,0
21,411,411,22,12,10,3,2
7,413,413,189,189,0,1,0
11,417,417,3,3,0,1,0
10,480,480,71,71,0,1,0

5,103,103,22,8,14,2,1
2,105,105,10,4,6,2,1
26,112,112,14,14,0,1,0
7,150,150,31,9,22,3,2
3,153,153,4,4,0,1,0
28,153,153,1,1,0,1,0
15,184,184,8,8,0,1,0
14,187,187,11,2,9,4,3
13,209,209,31,1,30,3,2
27,218,218,25,10,15,4,3
4,226,226,3,3,0,1,0
21,231,231,26,26,0,1,0
20,235,235,28,4,24,4,3
0,251,251,84,9,75,4,3
6,253,253,10,10,0,1,0
9,305,305,9,2,7,2,1
22,320,320,44,17,27,4,3
19,326,326,19,19,0,1,0
29,328,328,105,42,63,4,3
25,329,329,30,30,0,1,0
17,361,361,18,18,0,1,0
10,374,374,6,6,0,1,0
12,404,404,67,19,48,2,1
24,427,427,21,21,0,1,0
11,427,427,45,45,0,1,0
18,428,428,7,1,6,3,2
23,444,444,13,13,0,1,0
1,446,446,65,36,29,3,2
30,470,470,70,70,0,1,0
16,480,480,102,35,67,4,3
8,494,494,1,1,0,1,0

32,110,110,40,17,23,2,1
18,131,131,1,1,0,1,0
10,149,149,5,2,3,2,1
12,157,157,44,44,0,1,0
22,161,161,3,3,0,1,0
33,167,167,35,9,26,3,2
9,182,182,45,45,0,1,0
0,185,185,6,3,3,2,1
2,202,202,29,29,0,1,0
14,213,213,1,1,0,1,0
29,218,218,7,7,0,1,0
1,234,234,13,13,0,1,0
4,254,254,14,14,0,1,0
16,266,266,4,4,0,1,0
7,279,279,6,3,3,2,1
25,302,302,72,52,20,3,2
28,308,308,3,3,0,1,0
21,326,326,55,29,26,3,2
31,335,335,26,26,0,1,0
11,342,342,1,1,0,1,0
20,345,345,27,27,0,1,0
17,370,370,42,42,0,1,0
3,392,392,21,21,0,1,0
30,412,412,16,2,14,2,1
8,419,419,143,138,5,2,1
23,422,422,57,3,54,3,2
19,431,431,27,20,7,2,1
6,438,438,1,1,0,1,0
27,440,440,15,15,0,1,0
15,443,443,65,65,0,1,0
13,446,446,15,3,12,2,1
5,457,457,9,9,0,1,0
26,475,475,27,27,0,1,0
24,488,488,48,21,27,2,1

6,117,117,18,11,7,2,1
16,131,131,6,6,0,1,0
23,146,146,1,1,0,1,0
25,151,151,38,38,0,1,0
0,154,154,47,22,25,2,1
7,177,177,19,19,0,1,0
1,186,186,7,7,0,1,0
28,195,195,2,2,0,1,0
9,214,214,1,1,0,1,0
18,245,245,13,13,0,1,0
19,258,258,7,7,0,1,0
27,262,262,16,10,6,3,2
8,272,272,14,2,12,2,1
17,305,305,18,18,0,1,0
10,314,314,18,7,11,2,1
4,317,317,10,10,0,1,0
26,339,339,101,14,87,4,3
12,356,356,9,9,0,1,0
29,359,359,97,72,25,2,1
15,362,362,24,1,23,2,1
30,367,367,49,5,44,4,3
2,369,369,2,2,0,1,0
14,382,382,3,3,0,1,0
13,385,385,62,62,0,1,0
11,421,421,5,1,4,2,1
20,427,427,29,29,0,1,0
31,432,432,41,24,17,2,1
24,434,434,1,1,0,1,0
3,441,441,69,69,0,1,0
5,447,447,187,187,0,1,0
21,453,453,87,87,0,1,0
22,496,496,26,17,9,4,3

29,111,111,10,10,0,1,0
26,113,113,5,5,0,1,0
10,123,123,44,40,4,2,1
9,136,136,1,1,0,1,0
23,140,140,14,14,0,1,0
15,157,157,7,7,0,1,0
32,161,161,9,1,8,3,2
1,164,164,38,23,15,2,1
31,187,187,48,48,0,1,0
28,192,192,6,6,0,1,0
25,227,227,18,10,8,2,1
20,229,229,19,7,12,3,2
7,229,229,3,3,0,1,0
18,237,237,15,15,0,1,0
24,252,252,25,25,0,1,0
0,262,262,8,8,0,1,0
13,275,275,10,10,0,1,0
5,289,289,73,35,38,3,2
17,297,297,39,39,0,1,0
11,318,318,37,37,0,1,0
6,327,327,11,11,0,1,0
21,362,362,54,2,52,4,3
4,366,366,59,55,4,2,1
8,388,388,12,12,0,1,0
22,429,429,41,41,0,1,0
27,443,443,103,27,76,3,2
16,445,445,12,5,7,2,1
14,448,448,58,4,54,3,2
3,456,456,7,7,0,1,0
2,475,475,3,3,0,1,0
12,478,478,51,51,0,1,0
19,488,488,49,49,0,1,0
30,492,492,12,12,0,1,0

22,113,113,3,3,0,1,0
1,115,115,7,7,0,1,0
10,119,119,1,1,0,1,0
25,122,122,15,2,13,2,1
20,131,131,1,1,0,1,0
18,146,146,3,3,0,1,0
16,148,148,6,6,0,1,0
29,156,156,11,5,6,3,2
19,171,171,5,5,0,1,0
3,182,182,47,47,0,1,0
36,187,187,6,3,3,2,1
23,193,193,5,2,3,2,1
0,218,218,3,3,0,1,0
31,228,228,38,38,0,1,0
30,253,253,4,4,0,1,0
28,278,278,21,21,0,1,0
35,292,292,42,34,8,3,2
17,298,298,62,62,0,1,0
2,301,301,23,11,12,2,1
38,319,319,8,3,5,2,1
24,320,320,48,48,0,1,0
12,321,321,24,20,4,2,1
26,335,335,30,30,0,1,0
13,336,336,20,20,0,1,0
21,337,337,12,12,0,1,0
7,352,352,13,13,0,1,0
37,361,361,31,31,0,1,0
5,368,368,10,7,3,2,1
33,373,373,111,31,80,3,2
34,374,374,39,3,36,3,2
32,387,387,5,5,0,1,0
4,392,392,10,10,0,1,0
11,393,393,59,52,7,2,1
8,414,414,12,4,8,3,2
6,415,415,134,134,0,1,0
14,443,443,8,8,0,1,0
15,443,443,7,7,0,1,0
9,477,477,29,29,0,1,0
27,480,480,100,4,96,4,3

27,100,100,8,8,0,1,0
19,101,101,3,3,0,1,0
12,141,141,13,4,9,2,1
17,152,152,22,22,0,1,0
26,175,175,28,10,18,3,2
2,190,190,14,14,0,1,0
4,193,193,13,4,9,2,1
8,237,237,3,3,0,1,0
23,239,239,20,20,0,1,0
3,247,247,5,5,0,1,0
13,264,264,1,1,0,1,0
16,271,271,111,21,90,4,3
10,286,286,33,33,0,1,0
9,326,326,26,26,0,1,0
29,328,328,63,1,62,3,2
21,328,328,12,12,0,1,0
22,340,340,5,5,0,1,0
32,342,342,51,51,0,1,0
1,342,342,30,30,0,1,0
31,353,353,95,95,0,1,0
28,355,355,105,56,49,4,3
0,374,374,91,58,33,2,1
24,387,387,25,14,11,2,1
20,407,407,39,27,12,2,1
18,432,432,2,2,0,1,0
15,454,454,28,28,0,1,0
6,455,455,17,17,0,1,0
5,462,462,15,15,0,1,0
25,466,466,6,6,0,1,0
7,474,474,5,5,0,1,0
30,481,481,3,3,0,1,0
14,492,492,61,61,0,1,0
11,495,495,65,38,27,4,3

5,102,102,3,3,0,1,0
10,120,120,12,2,10,3,2
14,133,133,19,19,0,1,0
8,144,144,12,3,9,2,1
0,154,154,1,1,0,1,0
24,154,154,3,3,0,1,0
35,157,157,21,9,12,2,1
38,172,172,10,4,6,2,1
29,177,177,7,1,6,3,2
22,178,178,4,4,0,1,0
16,196,196,19,13,6,2,1
13,208,208,5,5,0,1,0
7,208,208,12,12,0,1,0
28,210,210,53,42,11,2,1
2,211,211,16,16,0,1,0
31,231,231,9,1,8,3,2
17,253,253,18,18,0,1,0
4,255,255,21,21,0,1,0
25,265,265,25,2,23,2,1
37,270,270,44,44,0,1,0
34,271,271,18,4,14,3,2
26,273,273,25,25,0,1,0
3,284,284,14,14,0,1,0
41,284,284,31,31,0,1,0
12,292,292,7,3,4,2,1
6,307,307,3,3,0,1,0
40,347,347,74,6,68,3,2
33,375,375,14,14,0,1,0
9,393,393,10,10,0,1,0
23,395,395,26,26,0,1,0
11,434,434,37,4,33,4,3
15,439,439,35,22,13,2,1
27,439,439,36,27,9,4,3
20,444,444,29,3,26,3,2
1,445,445,32,32,0,1,0
32,456,456,28,6,22,3,2
21,458,458,41,20,21,2,1
18,475,475,58,47,11,2,1
36,487,487,41,22,19,2,1
19,490,490,4,4,0,1,0
30,495,495,19,19,0,1,0
39,499,499,80,80,0,1,0

7,108,108,7,1,6,2,1
24,123,123,10,10,0,1,0
21,135,135,16,2,14,3,2
29,148,148,24,24,0,1,0
40,170,170,12,12,0,1,0
15,176,176,13,10,3,2,1
27,202,202,29,29,0,1,0
14,234,234,31,31,0,1,0
3,249,249,2,2,0,1,0
5,250,250,17,17,0,1,0
0,253,253,2,2,0,1,0
23,256,256,20,20,0,1,0
25,260,260,70,29,41,3,2
30,281,281,5,5,0,1,0
12,282,282,24,24,0,1,0
26,295,295,6,6,0,1,0
32,310,310,12,12,0,1,0
6,311,311,11,4,7,2,1
19,312,312,16,16,0,1,0
28,312,312,15,15,0,1,0
31,324,324,108,77,31,2,1
33,330,330,10,10,0,1,0
11,337,337,21,21,0,1,0
17,350,350,10,10,0,1,0
39,355,355,58,44,14,2,1
36,356,356,56,6,50,2,1
37,361,361,5,2,3,2,1
34,368,368,33,33,0,1,0
10,382,382,44,44,0,1,0
8,396,396,14,3,11,3,2
22,397,397,1,1,0,1,0
35,409,409,25,25,0,1,0
4,430,430,51,51,0,1,0
13,432,432,47,25,22,2,1
9,435,435,21,2,19,2,1
1,459,459,12,12,0,1,0
38,460,460,3,3,0,1,0
2,467,467,34,14,20,2,1
16,471,471,18,9,9,4,3
18,476,476,3,3,0,1,0
20,494,494,69,48,21,4,3

2,106,106,11,11,0,1,0
1,114,114,40,25,15,4,3
17,119,119,1,1,0,1,0
15,122,122,7,3,4,2,1
7,124,124,4,4,0,1,0
26,133,133,21,21,0,1,0
27,151,151,8,8,0,1,0
8,165,165,59,59,0,1,0
3,189,189,5,5,0,1,0
18,189,189,23,5,18,3,2
9,199,199,8,3,5,2,1
12,201,201,6,3,3,2,1
14,212,212,11,11,0,1,0
5,216,216,59,59,0,1,0
19,217,217,15,7,8,3,2
24,236,236,48,48,0,1,0
28,249,249,58,58,0,1,0
16,258,258,5,5,0,1,0
0,279,279,2,2,0,1,0
23,296,296,32,24,8,2,1
25,304,304,6,6,0,1,0
21,315,315,28,28,0,1,0
10,319,319,5,5,0,1,0
4,365,365,26,26,0,1,0
22,392,392,95,42,53,4,3
20,423,423,29,2,27,2,1
29,457,457,66,8,58,3,2
11,469,469,27,5,22,3,2
6,498,498,50,31,19,2,1
13,499,499,67,67,0,1,0

20,106,106,2,2,0,1,0
43,111,111,10,2,8,3,2
5,116,116,4,4,0,1,0
23,120,120,11,11,0,1,0
11,129,129,3,3,0,1,0
32,149,149,5,5,0,1,0
29,151,151,14,14,0,1,0
1,164,164,2,2,0,1,0
41,167,167,3,3,0,1,0
35,181,181,7,7,0,1,0
22,190,190,19,19,0,1,0
44,203,203,8,2,6,2,1
36,216,216,16,16,0,1,0
8,217,217,1,1,0,1,0
3,224,224,1,1,0,1,0
24,225,225,3,3,0,1,0
27,237,237,12,12,0,1,0
28,261,261,40,40,0,1,0
12,264,264,1,1,0,1,0
0,265,265,7,2,5,2,1
31,269,269,2,2,0,1,0
40,283,283,37,13,24,3,2
25,294,294,4,4,0,1,0
2,295,295,20,8,12,2,1
16,295,295,26,26,0,1,0
19,310,310,37,16,21,4,3
34,319,319,24,10,14,2,1
6,319,319,33,25,8,3,2
38,329,329,32,32,0,1,0
15,357,357,4,4,0,1,0
9,365,365,5,2,3,2,1
30,391,391,50,50,0,1,0
7,397,397,46,46,0,1,0
4,400,400,17,17,0,1,0
39,402,402,74,44,30,3,2
13,422,422,18,18,0,1,0
17,434,434,11,11,0,1,0
42,450,450,136,1,135,4,3
21,450,450,23,5,18,2,1
14,456,456,51,39,12,3,2
10,458,458,15,10,5,2,1
26,474,474,21,15,6,3,2
37,487,487,31,31,0,1,0
33,493,493,130,130,0,1,0
18,496,496,89,39,50,2,1

32,101,101,4,4,0,1,0
7,141,141,5,5,0,1,0
29,155,155,10,1,9,4,3
21,158,158,1,1,0,1,0
2,162,162,19,4,15,4,3
5,169,169,8,8,0,1,0
6,172,172,13,13,0,1,0
24,177,177,61,53,8,3,2
0,183,183,4,4,0,1,0
39,185,185,11,11,0,1,0
17,187,187,3,3,0,1,0
26,193,193,33,29,4,2,1
36,198,198,13,13,0,1,0
22,204,204,2,2,0,1,0
23,219,219,16,16,0,1,0
9,230,230,15,15,0,1,0
8,231,231,65,41,24,2,1
16,259,259,1,1,0,1,0
33,273,273,42,22,20,3,2
37,279,279,23,11,12,2,1
27,289,289,27,27,0,1,0
40,295,295,9,9,0,1,0
12,297,297,21,3,18,4,3
19,315,315,5,5,0,1,0
4,319,319,10,5,5,2,1
28,322,322,48,42,6,3,2
25,333,333,153,111,42,3,2
3,353,353,20,16,4,2,1
13,363,363,3,3,0,1,0
11,367,367,10,1,9,4,3
35,390,390,14,10,4,2,1
38,391,391,28,28,0,1,0
30,402,402,20,20,0,1,0
31,417,417,40,40,0,1,0
18,425,425,35,35,0,1,0
10,430,430,19,19,0,1,0
14,434,434,19,2,17,2,1
1,441,441,6,3,3,2,1
20,448,448,30,30,0,1,0
15,449,449,19,9,10,2,1
34,470,470,4,4,0,1,0

15,109,109,16,16,0,1,0
5,110,110,7,4,3,2,1
21,134,134,17,9,8,2,1
4,153,153,5,5,0,1,0
22,162,162,7,7,0,1,0
23,168,168,5,5,0,1,0
8,177,177,17,17,0,1,0
26,182,182,46,46,0,1,0
2,209,209,53,53,0,1,0
3,217,217,1,1,0,1,0
14,222,222,30,30,0,1,0
20,244,244,16,16,0,1,0
31,254,254,82,57,25,2,1
30,255,255,17,3,14,2,1
28,272,272,15,15,0,1,0
13,273,273,5,5,0,1,0
7,273,273,113,113,0,1,0
9,306,306,3,3,0,1,0
29,308,308,22,22,0,1,0
27,311,311,9,9,0,1,0
18,332,332,40,19,21,4,3
10,344,344,11,11,0,1,0
25,345,345,9,9,0,1,0
24,362,362,65,65,0,1,0
1,369,369,68,6,62,4,3
11,388,388,38,38,0,1,0
0,439,439,14,14,0,1,0
19,467,467,1,1,0,1,0
17,470,470,34,8,26,3,2
6,492,492,14,14,0,1,0
16,499,499,87,54,33,2,1
12,499,499,29,8,21,2,1

35,105,105,25,13,12,2,1
38,120,120,3,3,0,1,0
9,122,122,2,2,0,1,0
25,131,131,4,4,0,1,0
17,142,142,27,21,6,2,1
32,150,150,17,14,3,2,1
15,153,153,10,10,0,1,0
4,162,162,8,8,0,1,0
14,166,166,5,5,0,1,0
33,166,166,23,23,0,1,0
27,186,186,6,2,4,2,1
11,190,190,3,3,0,1,0
23,200,200,3,3,0,1,0
12,231,231,9,3,6,2,1
16,233,233,11,11,0,1,0
5,253,253,50,50,0,1,0
13,261,261,31,31,0,1,0
28,266,266,41,16,25,2,1
26,269,269,13,13,0,1,0
18,272,272,10,10,0,1,0
2,285,285,15,8,7,2,1
7,302,302,2,2,0,1,0
30,336,336,134,86,48,2,1
21,344,344,25,25,0,1,0
1,352,352,17,17,0,1,0
6,359,359,4,4,0,1,0
39,363,363,6,6,0,1,0
36,391,391,36,36,0,1,0
34,392,392,60,60,0,1,0
24,396,396,26,16,10,2,1
0,404,404,16,4,12,3,2
19,406,406,16,16,0,1,0
37,415,415,2,2,0,1,0
8,417,417,3,3,0,1,0
10,428,428,24,24,0,1,0
20,436,436,41,17,24,4,3
3,450,450,84,66,18,4,3
22,474,474,79,23,56,3,2
29,477,477,5,5,0,1,0
31,489,489,57,16,41,2,1

21,103,103,3,3,0,1,0
24,106,106,11,11,0,1,0
7,107,107,17,3,14,2,1
6,129,129,16,16,0,1,0
23,136,136,24,24,0,1,0
25,148,148,10,10,0,1,0
20,154,154,19,19,0,1,0
11,170,170,4,4,0,1,0
17,192,192,29,16,13,2,1
27,195,195,30,22,8,3,2
8,212,212,23,6,17,2,1
10,230,230,15,7,8,3,2
9,236,236,60,60,0,1,0
13,239,239,36,6,30,3,2
19,242,242,13,13,0,1,0
2,246,246,3,3,0,1,0
5,254,254,23,23,0,1,0
26,299,299,9,9,0,1,0
22,303,303,39,13,26,3,2
1,305,305,16,16,0,1,0
0,339,339,32,8,24,4,3
28,344,344,1,1,0,1,0
31,346,346,14,6,8,2,1
12,362,362,73,73,0,1,0
3,417,417,25,25,0,1,0
14,420,420,46,46,0,1,0
29,425,425,108,62,46,2,1
16,435,435,14,14,0,1,0
30,435,435,72,54,18,3,2
18,457,457,58,58,0,1,0
15,464,464,21,21,0,1,0
4,497,497,25,25,0,1,0

15,105,105,4,4,0,1,0
6,111,111,1,1,0,1,0
24,125,125,1,1,0,1,0
16,135,135,57,57,0,1,0
29,148,148,14,6,8,2,1
28,149,149,17,17,0,1,0
10,176,176,5,5,0,1,0
20,177,177,3,3,0,1,0
18,213,213,3,3,0,1,0
27,225,225,6,6,0,1,0
4,245,245,7,7,0,1,0
1,246,246,102,52,50,2,1
21,250,250,82,6,76,3,2
2,254,254,5,5,0,1,0
17,264,264,9,3,6,2,1
23,278,278,59,59,0,1,0
26,284,284,49,49,0,1,0
9,286,286,29,12,17,2,1
3,299,299,8,8,0,1,0
13,303,303,39,33,6,2,1
7,308,308,13,13,0,1,0
5,326,326,106,58,48,3,2
12,363,363,13,7,6,2,1
11,375,375,4,4,0,1,0
14,400,400,3,3,0,1,0
0,408,408,86,51,35,2,1
22,408,408,34,16,18,3,2
25,466,466,20,5,15,4,3
8,472,472,104,50,54,3,2
19,482,482,10,3,7,2,1

17,165,165,3,3,0,1,0
6,203,203,7,4,3,2,1
16,207,207,36,36,0,1,0
1,210,210,7,2,5,2,1
10,219,219,25,25,0,1,0
26,240,240,44,44,0,1,0
14,250,250,89,45,44,2,1
11,258,258,4,4,0,1,0
2,266,266,29,29,0,1,0
8,282,282,21,21,0,1,0
13,284,284,22,22,0,1,0
3,317,317,139,86,53,3,2
19,318,318,46,46,0,1,0
7,324,324,27,27,0,1,0
5,353,353,39,23,16,2,1
23,369,369,69,69,0,1,0
20,371,371,35,35,0,1,0
0,385,385,177,93,84,4,3
4,388,388,45,45,0,1,0
24,390,390,57,27,30,4,3
18,415,415,2,2,0,1,0
12,425,425,25,7,18,2,1
21,430,430,4,4,0,1,0
9,433,433,13,1,12,3,2
22,451,451,2,2,0,1,0
25,451,451,24,24,0,1,0
15,452,452,45,45,0,1,0

22,129,129,28,4,24,4,3
26,133,133,3,3,0,1,0
18,137,137,12,7,5,2,1
6,142,142,28,28,0,1,0
30,147,147,1,1,0,1,0
4,155,155,1,1,0,1,0
23,190,190,2,2,0,1,0
31,190,190,3,3,0,1,0
1,208,208,36,30,6,3,2
7,253,253,1,1,0,1,0
5,262,262,4,4,0,1,0
13,270,270,11,11,0,1,0
2,299,299,3,3,0,1,0
8,306,306,35,35,0,1,0
9,321,321,39,2,37,2,1
24,322,322,8,8,0,1,0
32,323,323,22,22,0,1,0
19,327,327,150,132,18,3,2
3,333,333,8,2,6,3,2
34,334,334,18,2,16,2,1
16,335,335,47,41,6,2,1
10,403,403,78,38,40,4,3
28,418,418,50,50,0,1,0
12,418,418,27,10,17,2,1
14,423,423,91,91,0,1,0
0,434,434,27,27,0,1,0
15,437,437,16,3,13,2,1
20,441,441,5,5,0,1,0
29,442,442,54,5,49,3,2
33,444,444,4,4,0,1,0
25,455,455,21,21,0,1,0
11,462,462,35,35,0,1,0
17,493,493,11,4,7,2,1
21,496,496,90,90,0,1,0
27,497,497,130,130,0,1,0

20,106,106,5,5,0,1,0
4,107,107,1,1,0,1,0
5,115,115,16,16,0,1,0
33,143,143,4,4,0,1,0
38,169,169,96,15,81,4,3
9,170,170,3,3,0,1,0
22,182,182,9,9,0,1,0
21,182,182,28,4,24,2,1
15,189,189,6,6,0,1,0
37,201,201,14,6,8,3,2
30,210,210,16,9,7,2,1
25,216,216,13,7,6,2,1
8,218,218,28,28,0,1,0
39,223,223,4,4,0,1,0
42,232,232,1,1,0,1,0
26,240,240,8,1,7,2,1
7,251,251,34,21,13,3,2
29,252,252,51,51,0,1,0
36,260,260,38,23,15,4,3
23,273,273,1,1,0,1,0
34,276,276,23,12,11,2,1
13,281,281,17,2,15,4,3
27,285,285,3,3,0,1,0
32,289,289,27,1,26,3,2
18,332,332,13,13,0,1,0
40,362,362,79,79,0,1,0
10,364,364,11,11,0,1,0
2,379,379,3,3,0,1,0
12,384,384,35,35,0,1,0
17,389,389,12,4,8,2,1
28,410,410,16,16,0,1,0
14,411,411,14,5,9,2,1
41,414,414,6,6,0,1,0
3,418,418,32,32,0,1,0
11,420,420,31,2,29,2,1
31,432,432,6,6,0,1,0
16,435,435,17,17,0,1,0
1,451,451,27,27,0,1,0
35,452,452,20,20,0,1,0
19,476,476,68,68,0,1,0
0,480,480,16,2,14,3,2
6,484,484,35,10,25,2,1
24,487,487,1,1,0,1,0

3,109,109,16,16,0,1,0
29,113,113,4,4,0,1,0
14,133,133,1,1,0,1,0
17,136,136,8,5,3,2,1
11,165,165,1,1,0,1,0
20,178,178,50,50,0,1,0
7,179,179,30,30,0,1,0
15,197,197,22,22,0,1,0
10,223,223,45,45,0,1,0
1,266,266,45,45,0,1,0
2,278,278,3,3,0,1,0
4,289,289,40,11,29,4,3
9,289,289,13,13,0,1,0
23,291,291,15,2,13,4,3
27,294,294,23,23,0,1,0
8,301,301,8,2,6,3,2
0,331,331,12,12,0,1,0
22,354,354,48,12,36,3,2
19,373,373,112,112,0,1,0
18,380,380,108,86,22,2,1
25,388,388,4,4,0,1,0
21,416,416,37,37,0,1,0
26,416,416,38,38,0,1,0
24,422,422,14,14,0,1,0
16,423,423,5,1,4,2,1
28,426,426,22,1,21,2,1
6,445,445,202,97,105,4,3
5,467,467,18,5,13,2,1
13,469,469,27,12,15,4,3
12,483,483,50,28,22,3,2

12,123,123,4,4,0,1,0
5,149,149,1,1,0,1,0
16,150,150,9,9,0,1,0
6,156,156,5,5,0,1,0
30,164,164,16,16,0,1,0
25,169,169,34,24,10,2,1
1,176,176,15,15,0,1,0
26,201,201,6,6,0,1,0
24,203,203,4,4,0,1,0
40,214,214,19,19,0,1,0
13,216,216,9,9,0,1,0
34,221,221,6,6,0,1,0
19,222,222,7,7,0,1,0
11,227,227,10,4,6,2,1
39,227,227,95,86,9,4,3
8,236,236,74,12,62,3,2
32,241,241,9,3,6,2,1
29,261,261,3,3,0,1,0
31,264,264,63,55,8,2,1
35,303,303,12,3,9,2,1
4,318,318,4,1,3,2,1
23,320,320,5,5,0,1,0
2,323,323,4,4,0,1,0
41,351,351,71,71,0,1,0
38,352,352,31,11,20,2,1
15,367,367,18,18,0,1,0
37,371,371,14,14,0,1,0
3,379,379,38,11,27,4,3
17,381,381,43,43,0,1,0
21,385,385,2,2,0,1,0
9,404,404,21,21,0,1,0
27,405,405,12,12,0,1,0
33,409,409,24,24,0,1,0
10,413,413,5,5,0,1,0
14,426,426,20,20,0,1,0
0,450,450,42,2,40,2,1
20,471,471,25,25,0,1,0
28,488,488,95,95,0,1,0
36,492,492,15,5,10,2,1
18,493,493,19,13,6,2,1
7,495,495,12,12,0,1,0
22,496,496,52,7,45,2,1

5,115,115,10,10,0,1,0
7,127,127,16,16,0,1,0
29,131,131,11,11,0,1,0
21,138,138,6,6,0,1,0
17,154,154,9,4,5,2,1
12,160,160,12,12,0,1,0
2,168,168,3,3,0,1,0
23,168,168,1,1,0,1,0
30,171,171,8,8,0,1,0
36,174,174,31,9,22,4,3
13,184,184,8,8,0,1,0
1,188,188,11,2,9,2,1
4,196,196,6,6,0,1,0
31,205,205,2,2,0,1,0
8,220,220,5,5,0,1,0
16,227,227,7,7,0,1,0
18,227,227,16,2,14,2,1
28,235,235,41,5,36,3,2
10,246,246,18,18,0,1,0
6,256,256,21,6,15,2,1
26,265,265,12,12,0,1,0
20,265,265,50,50,0,1,0
0,274,274,42,27,15,4,3
24,277,277,28,16,12,3,2
19,289,289,55,55,0,1,0
34,304,304,23,8,15,2,1
9,335,335,2,2,0,1,0
32,363,363,74,50,24,4,3
35,364,364,62,62,0,1,0
11,371,371,25,25,0,1,0
25,375,375,116,50,66,3,2
27,380,380,13,13,0,1,0
22,417,417,26,19,7,2,1
14,457,457,11,6,5,2,1
3,472,472,54,54,0,1,0
33,494,494,49,13,36,3,2
15,499,499,40,25,15,4,3

12,101,101,18,9,9,4,3
15,121,121,6,6,0,1,0
19,126,126,15,4,11,2,1
23,140,140,26,10,16,3,2
14,148,148,41,27,14,2,1
7,154,154,17,17,0,1,0
2,172,172,8,8,0,1,0
22,172,172,21,21,0,1,0
11,175,175,11,1,10,3,2
25,182,182,2,2,0,1,0
5,190,190,3,3,0,1,0
6,206,206,33,11,22,3,2
16,235,235,5,5,0,1,0
10,238,238,16,16,0,1,0
26,243,243,14,14,0,1,0
18,253,253,17,3,14,2,1
9,265,265,39,39,0,1,0
21,266,266,33,33,0,1,0
8,271,271,36,36,0,1,0
1,275,275,23,4,19,3,2
24,278,278,41,41,0,1,0
13,336,336,65,65,0,1,0
17,358,358,105,84,21,4,3
0,373,373,67,67,0,1,0
29,374,374,24,4,20,3,2
20,396,396,10,10,0,1,0
3,407,407,77,77,0,1,0
28,435,435,20,4,16,3,2
4,449,449,16,16,0,1,0
27,488,488,12,12,0,1,0

7,105,105,4,4,0,1,0
31,107,107,2,2,0,1,0
30,110,110,7,1,6,3,2
12,146,146,15,12,3,2,1
28,146,146,14,3,11,4,3
24,156,156,18,2,16,2,1
2,157,157,2,2,0,1,0
22,166,166,31,31,0,1,0
13,177,177,21,21,0,1,0
20,189,189,5,5,0,1,0
32,202,202,18,18,0,1,0
1,225,225,26,26,0,1,0
0,244,244,20,4,16,3,2
33,251,251,13,13,0,1,0
27,252,252,20,20,0,1,0
29,254,254,7,7,0,1,0
26,283,283,37,37,0,1,0
10,289,289,39,5,34,3,2
14,299,299,4,4,0,1,0
8,312,312,1,1,0,1,0
11,312,312,75,72,3,2,1
16,313,313,5,5,0,1,0
19,326,326,7,4,3,2,1
18,352,352,31,19,12,3,2
5,372,372,11,11,0,1,0
25,381,381,103,72,31,4,3
23,381,381,9,9,0,1,0
9,383,383,25,21,4,2,1
4,383,383,24,9,15,4,3
17,396,396,62,62,0,1,0
34,418,418,93,19,74,3,2
15,420,420,54,38,16,3,2
35,428,428,48,48,0,1,0
21,432,432,41,41,0,1,0
36,449,449,22,4,18,2,1
6,453,453,40,40,0,1,0
3,497,497,30,30,0,1,0

3,100,100,1,1,0,1,0
37,124,124,9,9,0,1,0
23,124,124,14,2,12,2,1
10,132,132,9,6,3,2,1
33,135,135,10,4,6,2,1
13,149,149,4,4,0,1,0
29,149,149,17,2,15,2,1
20,157,157,12,12,0,1,0
24,164,164,33,4,29,2,1
8,165,165,2,2,0,1,0
36,168,168,25,25,0,1,0
22,181,181,17,17,0,1,0
14,181,181,15,15,0,1,0
28,186,186,52,22,30,2,1
38,203,203,6,3,3,2,1
27,206,206,3,3,0,1,0
31,218,218,12,12,0,1,0
5,229,229,1,1,0,1,0
0,236,236,33,33,0,1,0
2,240,240,37,1,36,4,3
7,248,248,21,21,0,1,0
12,276,276,21,3,18,2,1
16,278,278,69,39,30,4,3
34,279,279,37,37,0,1,0
32,289,289,30,19,11,2,1
19,296,296,3,3,0,1,0
35,313,313,4,4,0,1,0
6,325,325,15,5,10,3,2
18,348,348,33,13,20,3,2
4,353,353,1,1,0,1,0
21,358,358,5,1,4,2,1
26,365,365,47,47,0,1,0
11,371,371,54,54,0,1,0
17,384,384,10,10,0,1,0
9,422,422,42,42,0,1,0
30,431,431,64,64,0,1,0
25,471,471,6,6,0,1,0
1,482,482,12,2,10,2,1
15,492,492,30,4,26,4,3

14,109,109,1,1,0,1,0
20,110,110,7,3,4,2,1
4,133,133,26,26,0,1,0
17,142,142,36,32,4,2,1
26,143,143,15,3,12,3,2
22,195,195,18,5,13,2,1
15,218,218,22,22,0,1,0
31,221,221,3,3,0,1,0
30,224,224,15,15,0,1,0
18,232,232,10,10,0,1,0
19,241,241,71,71,0,1,0
11,243,243,64,2,62,3,2
21,253,253,18,18,0,1,0
24,286,286,16,1,15,2,1
25,299,299,1,1,0,1,0
10,337,337,108,43,65,4,3
13,368,368,17,2,15,2,1
6,373,373,3,3,0,1,0
28,374,374,19,5,14,2,1
1,387,387,1,1,0,1,0
0,399,399,182,166,16,2,1
29,403,403,2,2,0,1,0
3,409,409,33,11,22,2,1
7,414,414,3,3,0,1,0
12,438,438,6,6,0,1,0
32,441,441,25,13,12,3,2
9,444,444,11,4,7,2,1
16,452,452,1,1,0,1,0
27,453,453,114,60,54,4,3
23,460,460,100,13,87,4,3
8,478,478,3,3,0,1,0
5,482,482,30,30,0,1,0
2,486,486,1,1,0,1,0

16,100,100,21,21,0,1,0
22,107,107,17,17,0,1,0
2,118,118,3,3,0,1,0
23,122,122,2,2,0,1,0
15,135,135,19,6,13,2,1
11,136,136,18,4,14,2,1
21,161,161,6,6,0,1,0
19,162,162,5,5,0,1,0
4,187,187,4,4,0,1,0
7,197,197,5,5,0,1,0
6,227,227,22,22,0,1,0
25,235,235,5,5,0,1,0
8,284,284,5,5,0,1,0
26,301,301,44,44,0,1,0
17,304,304,21,16,5,2,1
28,304,304,6,6,0,1,0
10,313,313,56,16,40,2,1
3,313,313,8,8,0,1,0
1,315,315,130,6,124,4,3
24,329,329,8,8,0,1,0
5,336,336,29,3,26,3,2
30,351,351,27,9,18,2,1
9,353,353,6,6,0,1,0
29,376,376,23,23,0,1,0
0,390,390,51,13,38,3,2
13,397,397,118,82,36,4,3
14,419,419,47,10,37,2,1
20,457,457,60,60,0,1,0
27,465,465,26,26,0,1,0
18,471,471,207,207,0,1,0
12,478,478,10,6,4,2,1

2,123,123,2,2,0,1,0
32,127,127,40,40,0,1,0
3,130,130,9,9,0,1,0
33,132,132,24,24,0,1,0
17,133,133,3,3,0,1,0
28,133,133,11,2,9,4,3
4,136,136,2,2,0,1,0
35,143,143,3,3,0,1,0
25,148,148,26,26,0,1,0
30,160,160,20,9,11,2,1
19,163,163,9,9,0,1,0
20,174,174,9,9,0,1,0
23,181,181,11,11,0,1,0
36,188,188,9,2,7,2,1
5,196,196,3,3,0,1,0
24,212,212,46,25,21,4,3
31,214,214,6,6,0,1,0
13,221,221,1,1,0,1,0
8,234,234,26,26,0,1,0
11,234,234,52,24,28,2,1
27,243,243,51,36,15,4,3
15,261,261,23,15,8,3,2
34,275,275,3,3,0,1,0
26,281,281,27,27,0,1,0
0,286,286,67,67,0,1,0
22,293,293,3,3,0,1,0
10,296,296,32,17,15,2,1
21,300,300,4,4,0,1,0
18,302,302,7,7,0,1,0
7,316,316,9,2,7,2,1
16,325,325,15,12,3,2,1
37,365,365,3,3,0,1,0
1,369,369,30,30,0,1,0
12,383,383,84,84,0,1,0
6,387,387,42,21,21,4,3
9,390,390,16,13,3,2,1
29,419,419,24,24,0,1,0
14,469,469,13,4,9,4,3

19,115,115,5,5,0,1,0
30,127,127,12,8,4,2,1
25,138,138,22,10,12,3,2
33,152,152,6,6,0,1,0
3,153,153,20,6,14,2,1
0,154,154,1,1,0,1,0
2,180,180,16,16,0,1,0
21,196,196,40,40,0,1,0
35,197,197,5,5,0,1,0
17,216,216,22,7,15,4,3
34,216,216,26,11,15,2,1
11,217,217,1,1,0,1,0
8,229,229,21,17,4,2,1
14,237,237,1,1,0,1,0
6,249,249,27,27,0,1,0
1,249,249,18,18,0,1,0
36,259,259,37,6,31,4,3
28,261,261,31,14,17,3,2
31,276,276,38,29,9,4,3
27,288,288,49,49,0,1,0
12,294,294,37,27,10,3,2
18,309,309,11,11,0,1,0
4,315,315,24,24,0,1,0
22,327,327,6,6,0,1,0
20,330,330,27,12,15,4,3
29,340,340,37,16,21,4,3
26,340,340,73,73,0,1,0
7,353,353,10,4,6,2,1
16,356,356,21,4,17,2,1
32,369,369,2,2,0,1,0
5,386,386,5,5,0,1,0
10,389,389,21,21,0,1,0
9,413,413,61,61,0,1,0
23,415,415,45,2,43,4,3
15,422,422,41,41,0,1,0
37,439,439,37,9,28,2,1
13,465,465,12,3,9,4,3
24,489,489,43,43,0,1,0

8,121,121,3,3,0,1,0
1,129,129,9,1,8,3,2
9,158,158,46,32,14,3,2
5,161,161,36,36,0,1,0
20,161,161,128,74,54,3,2
12,192,192,15,15,0,1,0
22,220,220,16,6,10,2,1
6,233,233,21,21,0,1,0
28,273,273,19,4,15,4,3
23,280,280,20,20,0,1,0
11,284,284,34,34,0,1,0
14,299,299,17,1,16,2,1
25,315,315,6,6,0,1,0
29,316,316,50,50,0,1,0
16,330,330,2,2,0,1,0
4,333,333,111,52,59,4,3
2,357,357,5,5,0,1,0
24,379,379,34,8,26,2,1
13,393,393,42,42,0,1,0
15,395,395,23,23,0,1,0
10,411,411,29,1,28,2,1
21,422,422,28,28,0,1,0
19,435,435,18,18,0,1,0
26,448,448,8,5,3,2,1
3,464,464,53,19,34,2,1
27,467,467,8,8,0,1,0
17,484,484,31,2,29,2,1
18,485,485,10,10,0,1,0
7,493,493,31,9,22,2,1
0,499,499,1,1,0,1,0

35,100,100,11,11,0,1,0
18,102,102,1,1,0,1,0
39,102,102,13,13,0,1,0
28,108,108,8,8,0,1,0
0,144,144,23,2,21,2,1
7,156,156,12,12,0,1,0
22,168,168,1,1,0,1,0
34,168,168,7,4,3,2,1
8,173,173,7,1,6,2,1
30,174,174,1,1,0,1,0
9,192,192,13,13,0,1,0
1,200,200,21,21,0,1,0
11,201,201,45,33,12,2,1
26,205,205,1,1,0,1,0
25,211,211,2,2,0,1,0
6,219,219,10,10,0,1,0
24,228,228,79,79,0,1,0
36,236,236,44,14,30,2,1
17,244,244,7,7,0,1,0
32,256,256,17,17,0,1,0
14,273,273,20,7,13,2,1
3,276,276,1,1,0,1,0
27,281,281,68,68,0,1,0
16,285,285,14,14,0,1,0
12,288,288,44,36,8,3,2
19,293,293,22,22,0,1,0
29,296,296,41,20,21,2,1
2,298,298,36,9,27,4,3
4,308,308,43,43,0,1,0
21,309,309,6,1,5,2,1
33,329,329,7,3,4,2,1
15,342,342,9,9,0,1,0
23,366,366,5,2,3,2,1
13,370,370,35,35,0,1,0
37,413,413,9,9,0,1,0
10,425,425,1,1,0,1,0
5,443,443,24,4,20,3,2
31,456,456,88,35,53,4,3
38,463,463,26,26,0,1,0
20,491,491,6,3,3,2,1

5,105,105,16,16,0,1,0
27,115,115,6,6,0,1,0
28,137,137,1,1,0,1,0
4,138,138,8,2,6,2,1
11,160,160,20,8,12,3,2
9,178,178,1,1,0,1,0
12,180,180,14,2,12,4,3
20,190,190,25,7,18,2,1
1,205,205,5,5,0,1,0
15,241,241,2,2,0,1,0
22,249,249,2,2,0,1,0
23,253,253,4,4,0,1,0
0,272,272,36,36,0,1,0
31,286,286,37,37,0,1,0
30,294,294,17,17,0,1,0
19,309,309,14,7,7,2,1
16,318,318,27,22,5,2,1
25,318,318,60,47,13,2,1
24,341,341,14,14,0,1,0
21,362,362,7,7,0,1,0
29,367,367,27,13,14,2,1
10,381,381,80,21,59,3,2
2,393,393,31,31,0,1,0
6,415,415,52,32,20,2,1
7,437,437,27,6,21,2,1
17,446,446,307,307,0,1,0
3,449,449,31,7,24,3,2
13,466,466,37,37,0,1,0
8,469,469,10,3,7,2,1
14,472,472,176,35,141,4,3
18,487,487,37,37,0,1,0
26,494,494,7,3,4,2,1

3,120,120,1,1,0,1,0
24,120,120,18,18,0,1,0
17,125,125,10,10,0,1,0
8,137,137,20,20,0,1,0
31,147,147,13,2,11,2,1
4,157,157,30,30,0,1,0
22,179,179,34,16,18,2,1
28,180,180,13,10,3,2,1
12,195,195,25,25,0,1,0
20,230,230,19,19,0,1,0
16,233,233,33,33,0,1,0
1,249,249,25,7,18,3,2
26,263,263,44,3,41,4,3
2,272,272,40,19,21,2,1
23,290,290,7,7,0,1,0
29,293,293,10,10,0,1,0
14,298,298,16,16,0,1,0
7,315,315,25,25,0,1,0
13,341,341,2,2,0,1,0
32,344,344,5,2,3,2,1
11,351,351,15,7,8,3,2
19,356,356,15,4,11,2,1
9,358,358,22,19,3,2,1
25,359,359,159,125,34,3,2
0,366,366,40,6,34,2,1
10,382,382,15,5,10,2,1
15,388,388,95,49,46,4,3
27,409,409,23,23,0,1,0
5,417,417,13,7,6,2,1
30,428,428,55,9,46,3,2
21,472,472,23,3,20,3,2
6,485,485,35,35,0,1,0
18,492,492,8,8,0,1,0

21,109,109,19,19,0,1,0
24,124,124,16,12,4,2,1
15,127,127,1,1,0,1,0
5,129,129,5,5,0,1,0
16,138,138,12,7,5,2,1
20,152,152,9,1,8,3,2
7,185,185,14,14,0,1,0
10,191,191,52,23,29,4,3
19,193,193,32,16,16,3,2
2,242,242,1,1,0,1,0
9,250,250,27,12,15,2,1
17,269,269,1,1,0,1,0
11,269,269,4,4,0,1,0
31,276,276,35,21,14,3,2
13,289,289,27,27,0,1,0
30,304,304,69,69,0,1,0
32,317,317,37,7,30,2,1
29,331,331,28,2,26,2,1
14,334,334,77,44,33,4,3
1,346,346,12,12,0,1,0
22,352,352,34,34,0,1,0
26,388,388,62,62,0,1,0
8,391,391,3,3,0,1,0
4,402,402,80,16,64,4,3
28,409,409,15,15,0,1,0
6,412,412,28,8,20,3,2
23,426,426,2,2,0,1,0
18,433,433,89,8,81,4,3
25,455,455,7,2,5,2,1
3,463,463,44,44,0,1,0
0,464,464,37,23,14,3,2
12,477,477,90,90,0,1,0
27,499,499,14,6,8,3,2

33,138,138,13,13,0,1,0
0,147,147,13,13,0,1,0
6,160,160,9,2,7,2,1
18,166,166,10,10,0,1,0
7,192,192,9,9,0,1,0
15,201,201,17,17,0,1,0
31,212,212,5,5,0,1,0
10,218,218,2,2,0,1,0
24,241,241,5,5,0,1,0
25,274,274,30,11,19,3,2
11,281,281,21,21,0,1,0
12,294,294,3,3,0,1,0
4,299,299,1,1,0,1,0
1,308,308,53,33,20,2,1
8,326,326,24,24,0,1,0
34,329,329,43,8,35,2,1
30,342,342,6,6,0,1,0
35,343,343,15,6,9,2,1
20,355,355,45,31,14,4,3
16,360,360,55,25,30,4,3
2,371,371,16,16,0,1,0
5,382,382,31,31,0,1,0
28,383,383,56,56,0,1,0
3,395,395,43,31,12,4,3
32,398,398,200,115,85,4,3
29,399,399,2,2,0,1,0
19,414,414,36,36,0,1,0
26,419,419,27,27,0,1,0
21,428,428,5,5,0,1,0
13,429,429,34,34,0,1,0
27,451,451,87,87,0,1,0
9,456,456,77,77,0,1,0
36,457,457,15,3,12,4,3
17,464,464,16,10,6,2,1
22,483,483,13,13,0,1,0
23,486,486,99,51,48,4,3
14,500,500,20,20,0,1,0

18,116,116,11,3,8,3,2
35,120,120,19,19,0,1,0
29,122,122,5,2,3,2,1
38,126,126,5,2,3,2,1
20,149,149,1,1,0,1,0
14,154,154,1,1,0,1,0
12,178,178,4,4,0,1,0
24,181,181,1,1,0,1,0
13,183,183,16,2,14,3,2
37,194,194,6,1,5,2,1
26,203,203,11,2,9,4,3
32,208,208,13,2,11,2,1
39,216,216,6,6,0,1,0
3,222,222,13,3,10,3,2
0,251,251,3,3,0,1,0
7,256,256,4,4,0,1,0
28,257,257,56,56,0,1,0
23,282,282,108,11,97,4,3
40,292,292,15,15,0,1,0
25,295,295,4,4,0,1,0
16,302,302,23,15,8,2,1
5,310,310,42,36,6,3,2
41,325,325,95,95,0,1,0
22,330,330,21,3,18,4,3
19,331,331,31,31,0,1,0
2,337,337,20,8,12,4,3
9,342,342,20,13,7,2,1
10,361,361,28,7,21,4,3
6,378,378,11,11,0,1,0
17,411,411,49,49,0,1,0
34,413,413,78,78,0,1,0
1,423,423,28,28,0,1,0
21,423,423,8,8,0,1,0
8,431,431,20,20,0,1,0
27,438,438,144,52,92,3,2
36,443,443,31,31,0,1,0
31,466,466,8,2,6,2,1
4,468,468,16,12,4,2,1
11,481,481,1,1,0,1,0
33,483,483,12,2,10,2,1
15,484,484,8,1,7,2,1
30,486,486,18,4,14,3,2

9,109,109,6,6,0,1,0
1,125,125,24,5,19,2,1
20,131,131,10,10,0,1,0
27,136,136,46,10,36,4,3
22,139,139,9,9,0,1,0
14,162,162,8,2,6,2,1
2,181,181,1,1,0,1,0
24,210,210,18,8,10,3,2
19,224,224,6,6,0,1,0
8,227,227,38,38,0,1,0
10,227,227,22,22,0,1,0
15,251,251,13,13,0,1,0
0,283,283,7,2,5,2,1
11,293,293,65,65,0,1,0
28,305,305,68,68,0,1,0
13,316,316,12,12,0,1,0
12,324,324,31,31,0,1,0
7,328,328,19,3,16,3,2
4,331,331,61,3,58,3,2
16,355,355,4,4,0,1,0
18,368,368,93,93,0,1,0
25,397,397,14,14,0,1,0
23,403,403,57,57,0,1,0
6,412,412,147,143,4,2,1
26,431,431,16,16,0,1,0
17,449,449,27,27,0,1,0
3,450,450,31,31,0,1,0
5,457,457,34,3,31,4,3
21,461,461,64,64,0,1,0

19,124,124,5,5,0,1,0
24,124,124,23,13,10,3,2
4,133,133,20,20,0,1,0
25,135,135,19,9,10,2,1
26,140,140,15,15,0,1,0
10,149,149,15,15,0,1,0
21,165,165,9,9,0,1,0
16,182,182,36,36,0,1,0
11,198,198,29,18,11,2,1
1,231,231,40,40,0,1,0
18,245,245,3,3,0,1,0
9,246,246,11,2,9,3,2
27,274,274,63,63,0,1,0
17,287,287,20,20,0,1,0
0,301,301,10,1,9,2,1
20,303,303,1,1,0,1,0
12,321,321,14,14,0,1,0
2,358,358,92,5,87,4,3
29,381,381,13,13,0,1,0
13,386,386,31,21,10,2,1
5,386,386,84,51,33,2,1
28,390,390,21,5,16,3,2
14,407,407,47,17,30,3,2
7,427,427,45,45,0,1,0
3,438,438,43,43,0,1,0
15,463,463,28,28,0,1,0
22,475,475,46,32,14,2,1
23,482,482,76,30,46,2,1
6,497,497,13,1,12,2,1
8,499,499,5,5,0,1,0
30,500,500,93,93,0,1,0

3,111,111,18,6,12,2,1
9,113,113,7,7,0,1,0
23,114,114,4,4,0,1,0
1,120,120,2,2,0,1,0
18,131,131,4,4,0,1,0
19,145,145,18,2,16,3,2
28,148,148,31,31,0,1,0
34,156,156,37,37,0,1,0
33,163,163,14,4,10,2,1
7,187,187,32,22,10,2,1
11,203,203,18,18,0,1,0
16,203,203,3,3,0,1,0
27,218,218,57,57,0,1,0
2,222,222,14,14,0,1,0
15,237,237,52,52,0,1,0
6,243,243,4,1,3,2,1
17,273,273,15,7,8,3,2
31,300,300,16,16,0,1,0
21,304,304,4,4,0,1,0
20,307,307,18,18,0,1,0
12,314,314,44,24,20,2,1
13,320,320,11,5,6,2,1
29,353,353,4,4,0,1,0
32,360,360,14,7,7,2,1
0,370,370,19,11,8,2,1
14,386,386,55,55,0,1,0
5,408,408,38,32,6,3,2
30,424,424,43,35,8,2,1
4,434,434,48,48,0,1,0
8,436,436,1,1,0,1,0
10,445,445,57,13,44,4,3
22,450,450,39,21,18,4,3
26,461,461,5,1,4,2,1
25,466,466,26,26,0,1,0
24,491,491,121,121,0,1,0

21,119,119,2,2,0,1,0
9,127,127,3,3,0,1,0
0,146,146,41,41,0,1,0
25,159,159,15,15,0,1,0
19,182,182,8,8,0,1,0
28,196,196,21,5,16,2,1
20,228,228,11,11,0,1,0
29,276,276,9,9,0,1,0
14,284,284,8,8,0,1,0
2,288,288,50,4,46,2,1
10,303,303,50,45,5,2,1
15,317,317,12,12,0,1,0
5,332,332,9,9,0,1,0
27,335,335,89,20,69,4,3
18,337,337,8,8,0,1,0
4,344,344,12,4,8,2,1
3,346,346,35,14,21,2,1
7,363,363,15,5,10,3,2
6,378,378,90,90,0,1,0
23,390,390,112,57,55,3,2
11,416,416,1,1,0,1,0
12,431,431,86,73,13,2,1
17,437,437,4,4,0,1,0
22,447,447,16,16,0,1,0
26,449,449,186,139,47,2,1
13,464,464,57,45,12,4,3
8,465,465,80,80,0,1,0
24,470,470,53,14,39,4,3
16,481,481,38,38,0,1,0
1,481,481,9,1,8,2,1

9,114,114,2,2,0,1,0
26,123,123,1,1,0,1,0
15,134,134,35,15,20,3,2
4,151,151,44,44,0,1,0
8,152,152,4,4,0,1,0
0,156,156,5,5,0,1,0
28,159,159,13,6,7,2,1
6,170,170,27,6,21,4,3
30,183,183,9,3,6,3,2
31,184,184,48,48,0,1,0
21,203,203,9,1,8,2,1
13,228,228,3,3,0,1,0
7,256,256,14,14,0,1,0
20,257,257,3,3,0,1,0
17,283,283,11,5,6,3,2
27,293,293,21,8,13,2,1
1,297,297,9,5,4,2,1
29,300,300,69,3,66,4,3
22,327,327,61,54,7,2,1
5,375,375,5,5,0,1,0
25,376,376,18,11,7,2,1
12,381,381,110,110,0,1,0
23,389,389,38,16,22,2,1
2,407,407,23,16,7,2,1
3,425,425,47,47,0,1,0
16,440,440,2,2,0,1,0
32,442,442,71,3,68,4,3
24,442,442,45,40,5,2,1
18,445,445,96,96,0,1,0
11,475,475,18,1,17,2,1
14,479,479,19,19,0,1,0
19,482,482,9,1,8,3,2
10,482,482,79,79,0,1,0

19,101,101,1,1,0,1,0
23,106,106,1,1,0,1,0
15,107,107,10,10,0,1,0
24,109,109,17,17,0,1,0
18,122,122,4,4,0,1,0
22,129,129,1,1,0,1,0
16,149,149,2,2,0,1,0
8,202,202,50,36,14,2,1
5,218,218,5,1,4,2,1
11,228,228,9,9,0,1,0
17,236,236,23,3,20,2,1
25,249,249,10,10,0,1,0
10,258,258,49,17,32,2,1
14,272,272,29,1,28,3,2
6,280,280,21,5,16,2,1
20,282,282,93,78,15,4,3
13,291,291,57,14,43,2,1
12,292,292,92,92,0,1,0
9,306,306,2,2,0,1,0
4,317,317,78,22,56,4,3
21,392,392,4,4,0,1,0
0,411,411,71,71,0,1,0
2,421,421,109,109,0,1,0
7,480,480,1,1,0,1,0
1,480,480,11,4,7,2,1
3,498,498,273,273,0,1,0

6,107,107,7,7,0,1,0
31,110,110,12,2,10,2,1
4,114,114,1,1,0,1,0
34,116,116,10,4,6,3,2
9,121,121,2,2,0,1,0
33,128,128,7,1,6,3,2
17,135,135,27,9,18,2,1
20,141,141,1,1,0,1,0
11,142,142,10,10,0,1,0
19,177,177,1,1,0,1,0
30,186,186,31,8,23,2,1
1,187,187,36,36,0,1,0
7,198,198,19,3,16,2,1
16,204,204,24,12,12,3,2
0,209,209,1,1,0,1,0
13,214,214,1,1,0,1,0
27,227,227,30,21,9,4,3
24,252,252,7,7,0,1,0
15,259,259,27,8,19,4,3
12,260,260,3,3,0,1,0
38,275,275,43,43,0,1,0
37,285,285,17,17,0,1,0
32,288,288,59,59,0,1,0
18,307,307,4,4,0,1,0
5,319,319,57,57,0,1,0
23,320,320,9,1,8,3,2
22,340,340,32,15,17,2,1
10,363,363,9,9,0,1,0
21,367,367,30,30,0,1,0
28,375,375,20,12,8,2,1
8,378,378,1,1,0,1,0
35,378,378,36,36,0,1,0
3,383,383,64,44,20,3,2
2,389,389,46,46,0,1,0
36,417,417,7,2,5,2,1
29,436,436,179,131,48,2,1
26,437,437,5,5,0,1,0
25,448,448,5,5,0,1,0
14,478,478,8,2,6,3,2

2,117,117,2,2,0,1,0
3,121,121,14,14,0,1,0
27,121,121,5,1,4,2,1
15,122,122,4,4,0,1,0
1,138,138,14,6,8,2,1
18,142,142,1,1,0,1,0
0,146,146,12,12,0,1,0
19,175,175,9,9,0,1,0
5,175,175,20,1,19,2,1
12,210,210,5,5,0,1,0
8,229,229,13,13,0,1,0
21,265,265,2,2,0,1,0
7,266,266,17,10,7,2,1
22,311,311,14,3,11,2,1
6,317,317,2,2,0,1,0
26,319,319,100,76,24,4,3
29,320,320,124,31,93,3,2
10,323,323,39,39,0,1,0
11,324,324,40,40,0,1,0
14,347,347,134,80,54,4,3
23,372,372,12,12,0,1,0
24,373,373,93,16,77,4,3
17,379,379,39,2,37,2,1
25,390,390,12,12,0,1,0
4,391,391,91,83,8,2,1
30,408,408,12,12,0,1,0
9,411,411,33,33,0,1,0
16,414,414,43,43,0,1,0
28,453,453,12,12,0,1,0
20,486,486,85,75,10,3,2
13,490,490,38,16,22,2,1

11,116,116,2,2,0,1,0
28,119,119,41,5,36,4,3
22,121,121,3,3,0,1,0
13,156,156,1,1,0,1,0
33,157,157,8,8,0,1,0
29,174,174,22,19,3,2,1
6,193,193,26,14,12,3,2
27,205,205,2,2,0,1,0
1,208,208,20,11,9,2,1
4,215,215,1,1,0,1,0
8,232,232,41,41,0,1,0
31,236,236,24,9,15,4,3
26,236,236,41,25,16,3,2
21,249,249,20,20,0,1,0
5,255,255,3,3,0,1,0
18,271,271,38,38,0,1,0
32,280,280,11,1,10,2,1
0,292,292,18,18,0,1,0
34,315,315,28,28,0,1,0
15,321,321,24,12,12,3,2
2,328,328,102,102,0,1,0
25,342,342,17,17,0,1,0
24,347,347,113,87,26,2,1
12,351,351,28,19,9,2,1
30,353,353,23,9,14,2,1
19,375,375,26,1,25,2,1
20,379,379,14,3,11,2,1
7,410,410,46,46,0,1,0
23,424,424,22,22,0,1,0
9,424,424,44,44,0,1,0
14,435,435,60,12,48,2,1
16,459,459,13,1,12,4,3
10,465,465,13,7,6,2,1
3,476,476,34,2,32,2,1
17,478,478,3,3,0,1,0

38,118,118,57,57,0,1,0
36,122,122,6,3,3,2,1
17,130,130,9,9,0,1,0
14,138,138,40,40,0,1,0
1,142,142,1,1,0,1,0
30,151,151,12,12,0,1,0
3,158,158,3,3,0,1,0
25,178,178,3,3,0,1,0
18,183,183,5,5,0,1,0
20,194,194,23,23,0,1,0
21,210,210,24,24,0,1,0
28,220,220,28,14,14,2,1
15,222,222,30,30,0,1,0
16,224,224,5,1,4,2,1
35,228,228,5,5,0,1,0
4,248,248,16,16,0,1,0
27,263,263,2,2,0,1,0
9,270,270,31,31,0,1,0
6,277,277,4,4,0,1,0
13,278,278,6,3,3,2,1
26,305,305,56,26,30,2,1
19,305,305,9,9,0,1,0
37,312,312,4,1,3,2,1
12,315,315,36,5,31,2,1
8,318,318,38,38,0,1,0
32,325,325,7,3,4,2,1
39,325,325,43,10,33,4,3
7,327,327,3,3,0,1,0
10,339,339,6,6,0,1,0
22,385,385,14,14,0,1,0
34,390,390,42,30,12,4,3
2,397,397,5,5,0,1,0
0,399,399,47,42,5,2,1
33,450,450,53,13,40,3,2
31,451,451,17,17,0,1,0
23,478,478,22,22,0,1,0
11,479,479,5,5,0,1,0
24,497,497,38,33,5,2,1
5,498,498,35,26,9,4,3
29,499,499,75,41,34,4,3

2,100,100,7,7,0,1,0
1,108,108,3,3,0,1,0
26,111,111,6,6,0,1,0
18,112,112,10,1,9,4,3
22,124,124,23,23,0,1,0
35,134,134,7,7,0,1,0
34,171,171,22,3,19,2,1
33,200,200,24,24,0,1,0
27,201,201,37,27,10,3,2
7,209,209,4,1,3,2,1
0,220,220,16,16,0,1,0
30,221,221,2,2,0,1,0
25,223,223,58,35,23,4,3
15,247,247,1,1,0,1,0
17,259,259,17,5,12,3,2
20,260,260,11,11,0,1,0
11,282,282,47,47,0,1,0
8,300,300,37,22,15,2,1
9,302,302,2,2,0,1,0
24,307,307,23,6,17,2,1
13,315,315,92,4,88,3,2
21,358,358,3,3,0,1,0
14,363,363,31,19,12,4,3
5,364,364,43,11,32,3,2
16,373,373,50,50,0,1,0
4,377,377,16,16,0,1,0
29,380,380,39,39,0,1,0
3,385,385,1,1,0,1,0
23,406,406,26,8,18,3,2
6,425,425,53,41,12,2,1
32,429,429,104,104,0,1,0
12,430,430,48,13,35,2,1
19,461,461,15,7,8,2,1
31,464,464,45,45,0,1,0
10,471,471,6,6,0,1,0
28,472,472,6,6,0,1,0

6,113,113,29,7,22,3,2
15,121,121,11,11,0,1,0
23,132,132,6,6,0,1,0
25,139,139,16,16,0,1,0
19,148,148,18,4,14,2,1
7,196,196,98,49,49,2,1
3,252,252,41,41,0,1,0
8,254,254,38,28,10,3,2
0,269,269,39,39,0,1,0
13,301,301,27,27,0,1,0
2,306,306,46,46,0,1,0
26,311,311,25,25,0,1,0
17,317,317,39,5,34,4,3
10,324,324,40,22,18,4,3
21,333,333,51,51,0,1,0
5,336,336,4,4,0,1,0
18,340,340,24,24,0,1,0
16,343,343,65,29,36,4,3
11,347,347,10,10,0,1,0
22,356,356,92,92,0,1,0
1,371,371,13,13,0,1,0
4,372,372,9,9,0,1,0
20,389,389,27,27,0,1,0
14,430,430,35,35,0,1,0
24,441,441,29,5,24,3,2
12,457,457,21,9,12,3,2
9,465,465,20,12,8,2,1

9,120,120,1,1,0,1,0
7,142,142,17,1,16,2,1
11,153,153,44,16,28,2,1
25,172,172,8,4,4,2,1
22,203,203,25,10,15,2,1
26,228,228,16,16,0,1,0
18,240,240,3,3,0,1,0
23,255,255,121,73,48,4,3
5,270,270,7,4,3,2,1
4,286,286,79,79,0,1,0
12,308,308,3,3,0,1,0
21,312,312,14,1,13,2,1
0,326,326,11,11,0,1,0
8,350,350,50,18,32,3,2
16,368,368,57,10,47,2,1
13,373,373,87,83,4,2,1
24,385,385,23,23,0,1,0
27,397,397,3,3,0,1,0
15,411,411,20,20,0,1,0
10,420,420,38,38,0,1,0
6,440,440,58,36,22,2,1
17,444,444,76,60,16,3,2
14,446,446,35,35,0,1,0
3,449,449,61,33,28,3,2
20,460,460,12,1,11,2,1
2,470,470,137,125,12,4,3
19,471,471,30,3,27,4,3
1,483,483,30,19,11,2,1

4,112,112,15,6,9,2,1
27,115,115,18,7,11,2,1
25,119,119,20,20,0,1,0
11,137,137,18,18,0,1,0
19,141,141,9,9,0,1,0
26,166,166,1,1,0,1,0
13,166,166,16,6,10,2,1
14,167,167,2,2,0,1,0
2,173,173,2,2,0,1,0
3,193,193,25,25,0,1,0
17,202,202,1,1,0,1,0
18,203,203,4,4,0,1,0
12,216,216,11,11,0,1,0
24,239,239,40,16,24,4,3
0,276,276,11,5,6,2,1
36,306,306,76,4,72,3,2
10,312,312,40,4,36,4,3
5,314,314,26,2,24,2,1
30,315,315,49,49,0,1,0
1,339,339,21,11,10,3,2
8,352,352,2,2,0,1,0
23,367,367,1,1,0,1,0
28,371,371,2,2,0,1,0
31,372,372,60,39,21,2,1
9,380,380,5,1,4,2,1
34,383,383,39,15,24,2,1
15,384,384,19,19,0,1,0
37,394,394,17,17,0,1,0
20,397,397,27,9,18,3,2
7,423,423,29,29,0,1,0
33,435,435,14,8,6,3,2
35,442,442,11,11,0,1,0
22,444,444,12,12,0,1,0
21,450,450,127,99,28,2,1
29,462,462,125,26,99,4,3
6,462,462,21,7,14,2,1
32,467,467,30,30,0,1,0
16,484,484,49,22,27,2,1

7,116,116,34,34,0,1,0
11,117,117,1,1,0,1,0
23,119,119,1,1,0,1,0
31,123,123,20,20,0,1,0
27,125,125,44,44,0,1,0
17,142,142,3,3,0,1,0
25,153,153,24,24,0,1,0
8,154,154,1,1,0,1,0
9,157,157,12,12,0,1,0
4,167,167,8,8,0,1,0
10,169,169,16,4,12,2,1
33,173,173,5,5,0,1,0
15,178,178,2,2,0,1,0
13,182,182,6,6,0,1,0
26,203,203,24,24,0,1,0
3,216,216,48,20,28,3,2
32,240,240,1,1,0,1,0
18,254,254,12,12,0,1,0
30,268,268,57,37,20,3,2
19,286,286,19,19,0,1,0
28,288,288,29,29,0,1,0
12,296,296,40,40,0,1,0
0,299,299,20,10,10,3,2
1,300,300,4,4,0,1,0
21,313,313,11,11,0,1,0
24,354,354,53,18,35,2,1
6,378,378,57,36,21,4,3
22,379,379,54,54,0,1,0
14,400,400,4,4,0,1,0
29,416,416,6,2,4,2,1
16,419,419,35,35,0,1,0
5,426,426,66,45,21,2,1
2,455,455,78,78,0,1,0
20,479,479,16,1,15,2,1

6,115,115,10,2,8,3,2
5,115,115,2,2,0,1,0
1,117,117,21,21,0,1,0
4,127,127,1,1,0,1,0
31,132,132,20,2,18,3,2
18,163,163,18,18,0,1,0
19,173,173,2,2,0,1,0
8,176,176,70,30,40,3,2
28,184,184,1,1,0,1,0
10,192,192,3,3,0,1,0
29,204,204,6,2,4,2,1
30,217,217,60,60,0,1,0
0,220,220,3,3,0,1,0
20,224,224,45,45,0,1,0
17,227,227,53,53,0,1,0
24,229,229,8,2,6,2,1
3,259,259,18,8,10,3,2
26,263,263,60,60,0,1,0
23,301,301,15,15,0,1,0
32,307,307,25,17,8,2,1
25,317,317,33,33,0,1,0
27,325,325,1,1,0,1,0
12,344,344,57,48,9,4,3
13,363,363,7,7,0,1,0
21,387,387,4,4,0,1,0
22,411,411,42,20,22,4,3
11,418,418,73,36,37,4,3
7,423,423,24,19,5,2,1
2,435,435,2,2,0,1,0
15,463,463,16,2,14,2,1
9,464,464,26,26,0,1,0
16,477,477,60,2,58,3,2
14,482,482,85,52,33,4,3

4,115,115,20,7,13,2,1
14,148,148,5,5,0,1,0
7,153,153,3,3,0,1,0
0,157,157,14,1,13,3,2
27,161,161,22,22,0,1,0
15,167,167,13,13,0,1,0
29,177,177,1,1,0,1,0
24,191,191,5,5,0,1,0
17,193,193,39,1,38,3,2
12,200,200,18,18,0,1,0
21,206,206,7,7,0,1,0
5,214,214,58,58,0,1,0
26,227,227,18,18,0,1,0
1,228,228,5,5,0,1,0
10,246,246,1,1,0,1,0
13,267,267,51,29,22,3,2
19,288,288,24,7,17,2,1
25,292,292,50,50,0,1,0
28,301,301,19,1,18,4,3
3,316,316,68,24,44,3,2
9,341,341,34,34,0,1,0
11,353,353,32,8,24,3,2
16,358,358,94,94,0,1,0
23,370,370,1,1,0,1,0
20,382,382,1,1,0,1,0
6,413,413,26,26,0,1,0
31,418,418,127,90,37,4,3
30,438,438,42,42,0,1,0
18,452,452,57,23,34,4,3
2,469,469,29,29,0,1,0
8,495,495,49,6,43,2,1
22,500,500,15,15,0,1,0

14,126,126,14,14,0,1,0
10,129,129,19,19,0,1,0
15,134,134,8,8,0,1,0
16,161,161,23,5,18,3,2
0,189,189,6,6,0,1,0
23,193,193,44,35,9,4,3
20,196,196,2,2,0,1,0
5,208,208,44,16,28,3,2
29,220,220,7,3,4,2,1
17,225,225,6,6,0,1,0
18,235,235,22,4,18,4,3
22,242,242,5,2,3,2,1
6,270,270,2,2,0,1,0
11,272,272,26,23,3,2,1
2,285,285,42,16,26,4,3
25,293,293,6,6,0,1,0
26,318,318,37,37,0,1,0
3,354,354,4,4,0,1,0
13,354,354,41,41,0,1,0
27,365,365,141,141,0,1,0
7,366,366,50,50,0,1,0
19,379,379,46,46,0,1,0
8,404,404,5,5,0,1,0
1,418,418,63,40,23,3,2
12,430,430,137,104,33,2,1
24,452,452,39,23,16,2,1
28,454,454,37,37,0,1,0
21,475,475,42,42,0,1,0
4,481,481,55,55,0,1,0
9,500,500,51,11,40,2,1

6,109,109,1,1,0,1,0
13,115,115,7,7,0,1,0
27,119,119,5,5,0,1,0
33,130,130,4,4,0,1,0
17,134,134,12,12,0,1,0
24,137,137,7,7,0,1,0
19,138,138,1,1,0,1,0
10,146,146,1,1,0,1,0
18,158,158,16,16,0,1,0
4,162,162,42,42,0,1,0
20,170,170,2,2,0,1,0
7,178,178,19,3,16,3,2
5,192,192,17,7,10,3,2
8,214,214,6,3,3,2,1
15,214,214,12,1,11,2,1
21,225,225,15,15,0,1,0
3,236,236,12,3,9,4,3
35,240,240,16,16,0,1,0
12,251,251,30,10,20,4,3
14,290,290,1,1,0,1,0
16,305,305,18,4,14,2,1
0,326,326,12,5,7,2,1
1,366,366,3,3,0,1,0
22,380,380,58,58,0,1,0
34,383,383,6,6,0,1,0
36,394,394,40,35,5,2,1
32,401,401,19,11,8,3,2
29,402,402,26,26,0,1,0
37,404,404,140,127,13,2,1
23,416,416,45,45,0,1,0
30,422,422,32,32,0,1,0
31,425,425,52,52,0,1,0
2,432,432,30,2,28,2,1
28,435,435,2,2,0,1,0
11,454,454,3,3,0,1,0
9,474,474,169,169,0,1,0
25,485,485,151,126,25,2,1
26,486,486,43,35,8,2,1

12,109,109,1,1,0,1,0
8,121,121,28,28,0,1,0
17,145,145,14,14,0,1,0
10,155,155,13,13,0,1,0
14,165,165,5,5,0,1,0
21,192,192,26,26,0,1,0
15,197,197,16,5,11,2,1
30,212,212,9,1,8,2,1
3,240,240,15,15,0,1,0
11,253,253,3,3,0,1,0
25,300,300,156,156,0,1,0
20,312,312,59,17,42,2,1
16,316,316,19,19,0,1,0
4,318,318,16,16,0,1,0
19,324,324,2,2,0,1,0
22,331,331,12,12,0,1,0
31,340,340,11,11,0,1,0
7,341,341,65,2,63,4,3
13,344,344,71,71,0,1,0
29,353,353,37,1,36,3,2
5,359,359,9,5,4,2,1
24,360,360,18,2,16,2,1
28,362,362,3,3,0,1,0
26,376,376,54,10,44,2,1
9,407,407,100,100,0,1,0
23,432,432,28,12,16,3,2
1,435,435,20,5,15,4,3
0,440,440,18,12,6,3,2
18,460,460,43,17,26,3,2
27,462,462,23,11,12,2,1
6,473,473,70,20,50,3,2
2,488,488,67,17,50,2,1

23,124,124,1,1,0,1,0
8,130,130,11,3,8,2,1
12,135,135,8,8,0,1,0
26,145,145,26,19,7,2,1
17,145,145,8,4,4,2,1
25,170,170,54,8,46,4,3
13,201,201,2,2,0,1,0
27,205,205,37,37,0,1,0
5,212,212,31,15,16,3,2
21,216,216,9,9,0,1,0
28,234,234,18,6,12,3,2
7,243,243,12,12,0,1,0
19,266,266,14,9,5,2,1
11,267,267,64,64,0,1,0
10,274,274,29,1,28,3,2
16,281,281,9,9,0,1,0
9,311,311,56,56,0,1,0
2,342,342,87,87,0,1,0
15,346,346,64,4,60,4,3
24,355,355,1,1,0,1,0
3,361,361,36,36,0,1,0
0,373,373,58,58,0,1,0
20,386,386,61,39,22,3,2
6,386,386,10,5,5,2,1
22,391,391,14,14,0,1,0
1,409,409,68,10,58,3,2
18,412,412,118,118,0,1,0
14,414,414,3,3,0,1,0
4,443,443,17,17,0,1,0

30,104,104,1,1,0,1,0
7,108,108,2,2,0,1,0
5,113,113,13,13,0,1,0
0,126,126,8,4,4,2,1
3,137,137,21,13,8,3,2
38,153,153,13,1,12,4,3
9,160,160,1,1,0,1,0
12,165,165,4,4,0,1,0
17,173,173,14,8,6,3,2
40,173,173,3,3,0,1,0
35,177,177,34,34,0,1,0
20,181,181,2,2,0,1,0
14,202,202,25,25,0,1,0
29,204,204,1,1,0,1,0
31,207,207,1,1,0,1,0
10,210,210,22,22,0,1,0
34,221,221,93,93,0,1,0
32,248,248,33,33,0,1,0
19,263,263,18,13,5,2,1
27,273,273,30,15,15,2,1
1,273,273,5,5,0,1,0
25,285,285,5,5,0,1,0
26,290,290,45,3,42,2,1
15,308,308,7,1,6,3,2
33,317,317,4,4,0,1,0
28,345,345,54,54,0,1,0
2,355,355,15,10,5,2,1
36,357,357,12,12,0,1,0
21,361,361,11,3,8,3,2
4,364,364,47,7,40,2,1
39,371,371,1,1,0,1,0
24,395,395,8,8,0,1,0
11,400,400,7,4,3,2,1
18,401,401,27,27,0,1,0
37,403,403,13,1,12,4,3
22,405,405,6,6,0,1,0
6,423,423,49,30,19,2,1
16,429,429,22,22,0,1,0
41,443,443,116,23,93,4,3
8,464,464,24,24,0,1,0
23,476,476,28,28,0,1,0
13,484,484,85,13,72,4,3

7,102,102,5,1,4,2,1
1,104,104,5,5,0,1,0
30,118,118,8,8,0,1,0
18,125,125,6,6,0,1,0
28,130,130,5,5,0,1,0
26,133,133,16,8,8,3,2
24,135,135,9,1,8,2,1
16,145,145,19,2,17,2,1
22,164,164,2,2,0,1,0
10,187,187,28,28,0,1,0
15,189,189,9,3,6,2,1
27,189,189,9,9,0,1,0
21,196,196,1,1,0,1,0
11,213,213,13,13,0,1,0
5,219,219,43,28,15,2,1
6,220,220,24,9,15,2,1
31,239,239,27,4,23,4,3
9,240,240,8,2,6,2,1
34,250,250,98,61,37,2,1
13,254,254,13,1,12,4,3
23,262,262,1,1,0,1,0
14,262,262,4,1,3,2,1
25,302,302,32,32,0,1,0
0,308,308,28,1,27,4,3
19,314,314,55,55,0,1,0
33,324,324,60,5,55,4,3
4,332,332,36,36,0,1,0
38,334,334,7,7,0,1,0
2,359,359,44,14,30,4,3
32,367,367,50,50,0,1,0
8,380,380,30,30,0,1,0
20,386,386,7,1,6,2,1
37,412,412,7,7,0,1,0
17,418,418,4,4,0,1,0
36,418,418,25,13,12,2,1
12,436,436,5,5,0,1,0
35,441,441,68,17,51,4,3
3,446,446,13,13,0,1,0
29,446,446,47,24,23,3,2

9,100,100,25,10,15,4,3
12,121,121,12,12,0,1,0
18,128,128,5,5,0,1,0
28,130,130,16,4,12,3,2
19,148,148,6,6,0,1,0
24,168,168,14,10,4,2,1
7,187,187,10,3,7,3,2
5,211,211,12,8,4,2,1
6,230,230,28,13,15,2,1
22,234,234,4,4,0,1,0
3,240,240,30,30,0,1,0
17,282,282,5,5,0,1,0
20,301,301,82,82,0,1,0
30,307,307,55,55,0,1,0
21,314,314,13,13,0,1,0
16,323,323,9,9,0,1,0
2,324,324,1,1,0,1,0
26,324,324,27,20,7,2,1
29,338,338,47,47,0,1,0
15,339,339,12,4,8,3,2
8,371,371,50,50,0,1,0
13,378,378,112,70,42,4,3
0,385,385,79,28,51,3,2
10,414,414,1,1,0,1,0
4,426,426,2,2,0,1,0
11,427,427,66,66,0,1,0
23,432,432,82,60,22,2,1
14,458,458,9,9,0,1,0
1,461,461,34,34,0,1,0
25,474,474,100,100,0,1,0
27,483,483,67,67,0,1,0

31,102,102,13,13,0,1,0
6,110,110,8,2,6,3,2
32,125,125,19,19,0,1,0
8,133,133,6,6,0,1,0
30,174,174,16,16,0,1,0
0,202,202,5,5,0,1,0
12,202,202,1,1,0,1,0
2,210,210,9,9,0,1,0
20,225,225,54,54,0,1,0
7,228,228,21,21,0,1,0
24,240,240,21,21,0,1,0
14,251,251,47,47,0,1,0
3,257,257,4,4,0,1,0
5,294,294,170,56,114,4,3
1,330,330,6,1,5,2,1
10,339,339,42,42,0,1,0
28,350,350,30,30,0,1,0
9,353,353,2,2,0,1,0
25,363,363,8,8,0,1,0
13,376,376,47,47,0,1,0
22,395,395,10,10,0,1,0
18,406,406,35,35,0,1,0
21,410,410,11,11,0,1,0
26,412,412,37,37,0,1,0
19,417,417,11,11,0,1,0
17,431,431,149,75,74,4,3
4,432,432,38,38,0,1,0
15,437,437,20,1,19,2,1
23,445,445,21,9,12,2,1
29,463,463,21,21,0,1,0
16,469,469,59,26,33,4,3
11,470,470,2,2,0,1,0
27,480,480,63,63,0,1,0

34,100,100,19,15,4,2,1
8,104,104,8,8,0,1,0
9,108,108,4,1,3,2,1
19,130,130,6,6,0,1,0
32,165,165,20,12,8,3,2
35,173,173,25,12,13,4,3
2,189,189,6,6,0,1,0
28,189,189,14,14,0,1,0
16,213,213,15,15,0,1,0
15,227,227,25,7,18,2,1
23,237,237,51,27,24,4,3
17,238,238,1,1,0,1,0
0,242,242,3,3,0,1,0
13,251,251,7,4,3,2,1
7,266,266,22,22,0,1,0
24,272,272,3,3,0,1,0
25,305,305,9,9,0,1,0
12,306,306,74,74,0,1,0
5,306,306,13,6,7,2,1
11,309,309,35,35,0,1,0
31,323,323,6,6,0,1,0
1,323,323,5,5,0,1,0
10,326,326,64,64,0,1,0
26,330,330,3,3,0,1,0
14,338,338,70,18,52,3,2
30,340,340,30,18,12,3,2
3,364,364,31,11,20,3,2
21,383,383,4,4,0,1,0
33,438,438,56,10,46,3,2
22,443,443,14,14,0,1,0
4,457,457,6,1,5,2,1
6,457,457,32,32,0,1,0
27,463,463,142,53,89,4,3
29,472,472,75,63,12,4,3
20,473,473,46,46,0,1,0
18,497,497,58,29,29,2,1

14,131,131,3,3,0,1,0
27,141,141,5,5,0,1,0
1,151,151,14,8,6,3,2
36,166,166,7,7,0,1,0
3,169,169,1,1,0,1,0
0,175,175,13,6,7,2,1
34,193,193,10,10,0,1,0
33,195,195,42,42,0,1,0
35,211,211,5,1,4,2,1
8,218,218,10,10,0,1,0
6,225,225,15,2,13,4,3
25,228,228,3,3,0,1,0
37,238,238,10,10,0,1,0
2,239,239,22,22,0,1,0
16,269,269,3,3,0,1,0
29,274,274,54,2,52,3,2
24,285,285,45,45,0,1,0
11,295,295,1,1,0,1,0
22,309,309,46,46,0,1,0
31,318,318,95,31,64,3,2
18,319,319,16,3,13,2,1
19,331,331,12,12,0,1,0
21,334,334,4,4,0,1,0
23,335,335,21,21,0,1,0
20,342,342,22,6,16,3,2
28,347,347,73,58,15,2,1
4,358,358,5,5,0,1,0
12,369,369,11,4,7,2,1
17,374,374,38,38,0,1,0
13,374,374,35,1,34,3,2
9,385,385,87,14,73,4,3
32,394,394,26,3,23,2,1
7,406,406,45,3,42,3,2
26,409,409,22,5,17,2,1
30,445,445,53,53,0,1,0
5,453,453,30,7,23,2,1
38,479,479,21,17,4,2,1
10,489,489,63,2,61,4,3
15,490,490,51,5,46,2,1

22,100,100,7,7,0,1,0
24,121,121,10,10,0,1,0
6,125,125,6,6,0,1,0
4,127,127,36,20,16,3,2
36,129,129,2,2,0,1,0
0,140,140,12,5,7,2,1
31,142,142,31,31,0,1,0
13,146,146,4,4,0,1,0
26,195,195,9,9,0,1,0
23,228,228,12,4,8,3,2
17,237,237,8,4,4,2,1
38,266,266,32,32,0,1,0
3,277,277,5,5,0,1,0
25,282,282,75,75,0,1,0
16,283,283,31,8,23,2,1
27,286,286,5,5,0,1,0
33,315,315,99,53,46,4,3
35,316,316,74,26,48,2,1
32,322,322,25,9,16,2,1
1,324,324,2,2,0,1,0
8,325,325,3,3,0,1,0
37,355,355,3,3,0,1,0
12,357,357,3,3,0,1,0
21,368,368,66,52,14,2,1
28,379,379,12,3,9,4,3
30,381,381,2,2,0,1,0
19,388,388,13,13,0,1,0
14,393,393,33,33,0,1,0
2,397,397,47,47,0,1,0
10,405,405,33,3,30,4,3
20,428,428,34,8,26,3,2
11,436,436,14,9,5,2,1
18,441,441,16,13,3,2,1
5,448,448,22,16,6,2,1
15,450,450,15,15,0,1,0
7,454,454,14,14,0,1,0
29,464,464,33,7,26,3,2
9,490,490,74,16,58,3,2
34,492,492,33,33,0,1,0

6,112,112,8,8,0,1,0
10,124,124,6,6,0,1,0
11,130,130,18,18,0,1,0
2,157,157,13,1,12,3,2
26,175,175,13,13,0,1,0
14,196,196,9,6,3,2,1
21,228,228,9,9,0,1,0
8,242,242,20,2,18,4,3
13,273,273,75,45,30,4,3
1,283,283,1,1,0,1,0
15,300,300,74,74,0,1,0
9,321,321,1,1,0,1,0
22,323,323,55,19,36,3,2
24,336,336,19,19,0,1,0
18,339,339,25,1,24,4,3
23,341,341,17,17,0,1,0
25,363,363,15,15,0,1,0
28,365,365,30,30,0,1,0
17,382,382,84,16,68,3,2
20,411,411,5,5,0,1,0
19,424,424,38,38,0,1,0
5,441,441,51,51,0,1,0
27,449,449,11,11,0,1,0
16,459,459,56,12,44,2,1
4,461,461,62,62,0,1,0
3,487,487,373,373,0,1,0
0,493,493,6,6,0,1,0
7,498,498,59,59,0,1,0
12,499,499,12,9,3,2,1

25,101,101,20,20,0,1,0
24,107,107,8,2,6,2,1
19,119,119,7,2,5,2,1
10,152,152,1,1,0,1,0
30,155,155,34,10,24,3,2
6,170,170,24,24,0,1,0
1,171,171,6,6,0,1,0
5,207,207,36,36,0,1,0
33,209,209,16,16,0,1,0
3,212,212,10,10,0,1,0
0,217,217,5,2,3,2,1
2,241,241,27,3,24,3,2
29,245,245,16,2,14,4,3
4,257,257,9,1,8,3,2
23,272,272,60,48,12,4,3
8,294,294,1,1,0,1,0
28,328,328,88,88,0,1,0
15,353,353,4,4,0,1,0
14,353,353,39,14,25,2,1
18,361,361,33,33,0,1,0
13,365,365,17,8,9,4,3
12,368,368,73,4,69,4,3
11,389,389,114,6,108,4,3
26,394,394,28,28,0,1,0
20,403,403,2,2,0,1,0
27,418,418,82,64,18,4,3
16,426,426,67,67,0,1,0
7,427,427,72,21,51,4,3
32,432,432,10,7,3,2,1
22,450,450,4,1,3,2,1
17,457,457,12,12,0,1,0
21,458,458,1,1,0,1,0
9,482,482,6,3,3,2,1
31,496,496,30,30,0,1,0

18,111,111,21,21,0,1,0
5,121,121,16,16,0,1,0
27,121,121,6,1,5,2,1
25,139,139,27,27,0,1,0
10,142,142,25,1,24,3,2
15,152,152,9,9,0,1,0
33,155,155,28,8,20,4,3
14,164,164,35,3,32,2,1
24,166,166,3,3,0,1,0
16,175,175,13,13,0,1,0
2,188,188,6,6,0,1,0
28,196,196,6,6,0,1,0
4,208,208,6,6,0,1,0
26,208,208,6,6,0,1,0
30,212,212,23,23,0,1,0
17,234,234,42,42,0,1,0
7,248,248,12,5,7,2,1
3,249,249,10,2,8,3,2
11,257,257,4,4,0,1,0
23,261,261,26,5,21,4,3
8,313,313,6,6,0,1,0
0,329,329,12,2,10,3,2
22,357,357,59,34,25,2,1
13,386,386,10,6,4,2,1
12,395,395,57,57,0,1,0
32,400,400,55,55,0,1,0
1,414,414,50,50,0,1,0
21,420,420,26,26,0,1,0
6,442,442,16,6,10,3,2
31,467,467,54,54,0,1,0
29,469,469,50,50,0,1,0
34,469,469,112,24,88,3,2
20,483,483,30,30,0,1,0
19,486,486,14,4,10,3,2
9,498,498,18,18,0,1,0

25,113,113,2,2,0,1,0
6,126,126,3,3,0,1,0
7,148,148,1,1,0,1,0
22,159,159,23,23,0,1,0
1,169,169,50,38,12,4,3
15,170,170,35,35,0,1,0
29,172,172,24,6,18,3,2
33,186,186,19,16,3,2,1
5,187,187,1,1,0,1,0
27,201,201,13,13,0,1,0
19,241,241,4,1,3,2,1
0,258,258,35,35,0,1,0
4,273,273,1,1,0,1,0
9,285,285,1,1,0,1,0
28,299,299,54,54,0,1,0
21,302,302,16,16,0,1,0
24,334,334,9,9,0,1,0
26,343,343,59,29,30,3,2
3,348,348,1,1,0,1,0
18,348,348,88,10,78,4,3
30,351,351,10,10,0,1,0
23,352,352,31,31,0,1,0
8,353,353,27,3,24,2,1
11,363,363,6,6,0,1,0
2,389,389,11,7,4,2,1
20,403,403,10,10,0,1,0
32,421,421,10,6,4,2,1
12,428,428,52,52,0,1,0
10,436,436,34,34,0,1,0
34,446,446,197,197,0,1,0
31,447,447,48,48,0,1,0
14,452,452,20,20,0,1,0
17,454,454,74,36,38,4,3
16,457,457,5,5,0,1,0
13,466,466,59,14,45,2,1

5,104,104,4,4,0,1,0
4,110,110,6,6,0,1,0
20,120,120,2,2,0,1,0
15,149,149,1,1,0,1,0
34,158,158,5,5,0,1,0
23,162,162,12,12,0,1,0
28,163,163,7,1,6,2,1
24,169,169,1,1,0,1,0
37,169,169,6,6,0,1,0
30,175,175,1,1,0,1,0
35,180,180,23,23,0,1,0
19,180,180,34,21,13,2,1
9,184,184,1,1,0,1,0
31,192,192,6,2,4,2,1
14,196,196,22,22,0,1,0
36,221,221,66,8,58,3,2
29,231,231,10,10,0,1,0
6,236,236,9,9,0,1,0
32,245,245,71,38,33,4,3
26,249,249,35,21,14,2,1
16,263,263,42,27,15,2,1
0,265,265,5,2,3,2,1
38,285,285,5,5,0,1,0
3,307,307,14,14,0,1,0
22,313,313,50,32,18,4,3
25,319,319,39,3,36,4,3
21,331,331,13,8,5,2,1
10,342,342,37,37,0,1,0
11,346,346,37,37,0,1,0
39,356,356,75,44,31,2,1
17,368,368,1,1,0,1,0
33,377,377,50,23,27,2,1
13,377,377,2,2,0,1,0
18,404,404,10,10,0,1,0
27,413,413,42,10,32,3,2
12,413,413,10,10,0,1,0
7,434,434,31,19,12,4,3
8,441,441,31,31,0,1,0
1,470,470,77,27,50,4,3
2,478,478,32,32,0,1,0

3,118,118,6,6,0,1,0
25,152,152,19,2,17,2,1
22,154,154,8,2,6,2,1
5,170,170,2,2,0,1,0
14,183,183,13,8,5,2,1
24,187,187,13,7,6,3,2
32,193,193,2,2,0,1,0
6,211,211,12,12,0,1,0
29,213,213,16,1,15,3,2
17,216,216,44,44,0,1,0
15,226,226,6,6,0,1,0
9,228,228,3,3,0,1,0
10,240,240,6,2,4,2,1
21,251,251,67,67,0,1,0
8,278,278,10,10,0,1,0
18,294,294,119,67,52,3,2
19,294,294,16,16,0,1,0
34,296,296,5,1,4,2,1
36,299,299,3,3,0,1,0
20,334,334,3,3,0,1,0
13,352,352,6,1,5,2,1
26,361,361,31,1,30,4,3
2,370,370,11,2,9,3,2
7,377,377,18,9,9,4,3
31,384,384,8,8,0,1,0
23,406,406,170,38,132,4,3
0,421,421,26,18,8,2,1
33,425,425,20,2,18,2,1
35,427,427,3,3,0,1,0
30,427,427,80,38,42,4,3
27,429,429,45,16,29,2,1
16,431,431,25,16,9,4,3
11,432,432,7,3,4,2,1
4,433,433,60,39,21,2,1
12,443,443,64,28,36,2,1
28,471,471,63,63,0,1,0
1,477,477,60,60,0,1,0

2,102,102,6,6,0,1,0
3,113,113,1,1,0,1,0
28,118,118,10,1,9,2,1
14,136,136,10,5,5,2,1
9,168,168,28,28,0,1,0
27,177,177,7,7,0,1,0
6,183,183,3,3,0,1,0
1,192,192,1,1,0,1,0
16,203,203,13,13,0,1,0
20,217,217,2,2,0,1,0
18,283,283,27,14,13,2,1
24,294,294,92,55,37,4,3
22,302,302,8,8,0,1,0
10,315,315,14,1,13,2,1
8,315,315,92,34,58,3,2
12,317,317,71,54,17,2,1
7,330,330,17,17,0,1,0
19,333,333,4,4,0,1,0
30,344,344,162,84,78,3,2
29,349,349,22,22,0,1,0
26,372,372,74,21,53,4,3
13,379,379,1,1,0,1,0
17,381,381,5,5,0,1,0
4,383,383,24,24,0,1,0
23,388,388,3,3,0,1,0
25,406,406,11,11,0,1,0
15,455,455,10,10,0,1,0
11,461,461,12,8,4,2,1
21,465,465,83,71,12,4,3
5,476,476,21,3,18,3,2
0,494,494,259,226,33,4,3

19,107,107,13,1,12,4,3
1,117,117,12,12,0,1,0
6,151,151,1,1,0,1,0
16,152,152,3,3,0,1,0
12,154,154,8,2,6,2,1
17,168,168,8,5,3,2,1
9,177,177,6,6,0,1,0
14,180,180,29,29,0,1,0
11,183,183,27,5,22,2,1
20,188,188,5,5,0,1,0
23,193,193,8,8,0,1,0
7,196,196,87,87,0,1,0
27,204,204,1,1,0,1,0
2,231,231,3,3,0,1,0
0,262,262,34,34,0,1,0
13,284,284,30,15,15,4,3
18,326,326,96,96,0,1,0
3,330,330,39,21,18,4,3
4,361,361,2,2,0,1,0
29,364,364,37,15,22,2,1
5,388,388,101,101,0,1,0
28,396,396,36,36,0,1,0
21,398,398,4,4,0,1,0
10,433,433,3,3,0,1,0
25,439,439,57,57,0,1,0
8,441,441,77,77,0,1,0
22,443,443,50,50,0,1,0
24,443,443,23,8,15,2,1
26,456,456,72,72,0,1,0
15,498,498,131,131,0,1,0

9,111,111,2,2,0,1,0
0,112,112,26,26,0,1,0
17,113,113,1,1,0,1,0
2,147,147,1,1,0,1,0
32,161,161,1,1,0,1,0
14,169,169,23,20,3,2,1
18,181,181,7,7,0,1,0
20,187,187,44,10,34,3,2
21,204,204,37,33,4,2,1
10,217,217,11,11,0,1,0
30,223,223,15,5,10,3,2
1,245,245,5,2,3,2,1
4,291,291,4,1,3,2,1
6,296,296,32,32,0,1,0
22,302,302,18,18,0,1,0
11,310,310,13,13,0,1,0
7,324,324,8,2,6,2,1
23,336,336,100,100,0,1,0
16,342,342,52,52,0,1,0
24,348,348,56,56,0,1,0
25,353,353,16,8,8,3,2
13,353,353,97,97,0,1,0
12,354,354,37,37,0,1,0
27,360,360,42,42,0,1,0
34,396,396,18,18,0,1,0
33,397,397,3,3,0,1,0
3,400,400,65,65,0,1,0
29,401,401,91,62,29,2,1
15,407,407,6,2,4,2,1
28,424,424,43,25,18,4,3
8,431,431,27,11,16,3,2
31,436,436,14,2,12,2,1
26,442,442,9,1,8,2,1
5,459,459,60,13,47,2,1
19,474,474,13,8,5,2,1

25,100,100,2,2,0,1,0
17,122,122,75,65,10,3,2
3,126,126,5,5,0,1,0
19,135,135,6,6,0,1,0
24,145,145,18,2,16,2,1
23,183,183,25,3,22,3,2
10,185,185,10,10,0,1,0
8,217,217,13,4,9,2,1
0,227,227,30,6,24,2,1
14,227,227,31,7,24,2,1
22,241,241,17,17,0,1,0
9,287,287,10,5,5,2,1
5,299,299,135,135,0,1,0
4,327,327,197,99,98,4,3
12,331,331,7,7,0,1,0
15,333,333,12,12,0,1,0
20,339,339,11,11,0,1,0
7,360,360,5,5,0,1,0
21,388,388,62,20,42,2,1
13,398,398,45,36,9,4,3
1,401,401,7,1,6,3,2
2,403,403,78,78,0,1,0
18,443,443,17,17,0,1,0
16,456,456,1,1,0,1,0
11,475,475,11,2,9,2,1
6,484,484,28,19,9,4,3

7,106,106,8,8,0,1,0
3,115,115,21,9,12,4,3
12,118,118,39,30,9,4,3
23,120,120,32,32,0,1,0
26,153,153,15,15,0,1,0
10,157,157,12,2,10,3,2
31,159,159,40,40,0,1,0
13,174,174,4,4,0,1,0
22,174,174,2,2,0,1,0
20,175,175,11,11,0,1,0
29,181,181,2,2,0,1,0
25,182,182,4,4,0,1,0
15,188,188,25,7,18,3,2
2,194,194,16,16,0,1,0
9,208,208,13,13,0,1,0
14,225,225,28,28,0,1,0
19,228,228,29,11,18,4,3
1,251,251,41,35,6,2,1
5,254,254,8,8,0,1,0
11,279,279,8,8,0,1,0
6,286,286,1,1,0,1,0
28,362,362,35,1,34,3,2
24,379,379,13,1,12,4,3
27,381,381,25,11,14,2,1
4,400,400,87,75,12,3,2
8,426,426,10,1,9,2,1
21,427,427,44,44,0,1,0
0,473,473,22,22,0,1,0
16,476,476,138,100,38,3,2
30,484,484,13,13,0,1,0
18,493,493,34,34,0,1,0
17,498,498,46,46,0,1,0

26,113,113,17,17,0,1,0
8,124,124,16,16,0,1,0
2,148,148,11,11,0,1,0
9,160,160,20,9,11,2,1
0,177,177,1,1,0,1,0
20,190,190,12,12,0,1,0
16,197,197,4,4,0,1,0
15,199,199,37,37,0,1,0
23,200,200,3,3,0,1,0
27,217,217,82,82,0,1,0
1,231,231,4,4,0,1,0
29,247,247,16,7,9,4,3
11,274,274,28,28,0,1,0
17,297,297,38,38,0,1,0
4,303,303,74,74,0,1,0
19,333,333,38,38,0,1,0
14,336,336,43,18,25,2,1
30,336,336,3,3,0,1,0
24,346,346,7,7,0,1,0
31,357,357,14,14,0,1,0
21,360,360,15,15,0,1,0
28,361,361,52,26,26,4,3
13,382,382,10,10,0,1,0
18,385,385,79,21,58,3,2
3,394,394,26,14,12,4,3
7,399,399,21,10,11,2,1
22,403,403,61,30,31,4,3
10,415,415,78,19,59,3,2
5,427,427,85,42,43,2,1
25,441,441,42,12,30,2,1
6,452,452,21,21,0,1,0
12,462,462,6,6,0,1,0

22,104,104,7,2,5,2,1
2,122,122,1,1,0,1,0
25,131,131,1,1,0,1,0
30,139,139,13,1,12,4,3
14,149,149,8,8,0,1,0
18,169,169,4,1,3,2,1
32,187,187,36,36,0,1,0
17,192,192,42,42,0,1,0
10,196,196,13,3,10,2,1
31,198,198,22,5,17,2,1
3,210,210,32,16,16,2,1
6,213,213,10,10,0,1,0
24,216,216,5,5,0,1,0
0,216,216,19,19,0,1,0
29,282,282,70,70,0,1,0
16,283,283,13,13,0,1,0
5,316,316,30,4,26,3,2
26,319,319,34,34,0,1,0
12,326,326,21,15,6,2,1
28,327,327,66,6,60,4,3
13,340,340,48,4,44,3,2
1,360,360,52,5,47,2,1
20,373,373,48,3,45,3,2
21,378,378,22,3,19,2,1
33,394,394,28,28,0,1,0
7,416,416,1,1,0,1,0
8,429,429,96,78,18,3,2
27,445,445,18,18,0,1,0
19,453,453,25,3,22,2,1
11,453,453,40,34,6,2,1
23,454,454,93,56,37,2,1
9,477,477,5,5,0,1,0
15,487,487,41,21,20,2,1
4,494,494,35,35,0,1,0

20,108,108,3,3,0,1,0
13,126,126,1,1,0,1,0
23,129,129,2,2,0,1,0
6,139,139,8,8,0,1,0
1,150,150,15,5,10,3,2
26,165,165,16,8,8,2,1
5,183,183,1,1,0,1,0
21,196,196,14,14,0,1,0
25,198,198,15,15,0,1,0
32,203,203,45,21,24,2,1
10,219,219,8,2,6,2,1
9,223,223,6,6,0,1,0
0,224,224,43,22,21,4,3
31,233,233,9,9,0,1,0
4,236,236,71,31,40,2,1
24,239,239,38,24,14,3,2
14,239,239,7,7,0,1,0
8,244,244,1,1,0,1,0
18,253,253,25,25,0,1,0
27,256,256,3,3,0,1,0
12,276,276,2,2,0,1,0
15,296,296,30,21,9,2,1
3,300,300,55,31,24,3,2
22,337,337,49,1,48,2,1
34,348,348,21,21,0,1,0
19,360,360,17,13,4,2,1
11,369,369,44,20,24,4,3
29,415,415,64,54,10,2,1
28,421,421,52,11,41,2,1
30,422,422,41,37,4,2,1
33,424,424,119,119,0,1,0
16,425,425,3,3,0,1,0
7,428,428,2,2,0,1,0
17,463,463,14,14,0,1,0
2,493,493,142,82,60,3,2

14,112,112,6,3,3,2,1
1,122,122,1,1,0,1,0
4,125,125,10,10,0,1,0
0,128,128,21,15,6,2,1
24,135,135,40,40,0,1,0
13,145,145,9,9,0,1,0
8,155,155,1,1,0,1,0
31,157,157,11,7,4,2,1
11,167,167,19,19,0,1,0
17,178,178,10,10,0,1,0
7,182,182,6,6,0,1,0
19,182,182,9,1,8,3,2
27,188,188,11,6,5,2,1
9,210,210,23,19,4,2,1
34,228,228,34,31,3,2,1
20,237,237,1,1,0,1,0
16,256,256,36,17,19,2,1
21,262,262,44,20,24,2,1
36,278,278,1,1,0,1,0
15,279,279,50,50,0,1,0
22,302,302,47,44,3,2,1
6,319,319,12,12,0,1,0
28,326,326,9,9,0,1,0
5,354,354,1,1,0,1,0
26,360,360,1,1,0,1,0
32,367,367,61,61,0,1,0
18,369,369,44,44,0,1,0
29,377,377,35,5,30,2,1
30,380,380,9,2,7,2,1
23,432,432,9,3,6,3,2
25,436,436,17,1,16,3,2
35,444,444,120,96,24,3,2
2,446,446,55,6,49,2,1
10,447,447,33,33,0,1,0
12,491,491,12,12,0,1,0
33,497,497,42,28,14,2,1
3,498,498,80,80,0,1,0

12,122,122,47,34,13,2,1
10,128,128,20,20,0,1,0
8,131,131,3,3,0,1,0
30,144,144,1,1,0,1,0
21,172,172,22,22,0,1,0
17,172,172,8,8,0,1,0
18,215,215,25,25,0,1,0
23,224,224,34,9,25,2,1
6,246,246,6,6,0,1,0
15,247,247,44,28,16,3,2
20,267,267,5,5,0,1,0
24,279,279,10,10,0,1,0
2,297,297,87,27,60,4,3
14,313,313,3,3,0,1,0
26,326,326,67,67,0,1,0
25,335,335,22,3,19,2,1
11,338,338,69,29,40,2,1
22,340,340,94,10,84,3,2
7,344,344,1,1,0,1,0
3,347,347,4,4,0,1,0
31,360,360,24,24,0,1,0
9,363,363,4,4,0,1,0
5,377,377,13,13,0,1,0
27,382,382,27,1,26,2,1
0,391,391,46,46,0,1,0
19,410,410,24,12,12,4,3
28,438,438,53,9,44,3,2
13,460,460,3,3,0,1,0
29,464,464,11,3,8,3,2
16,466,466,112,68,44,4,3
4,477,477,57,31,26,3,2
1,500,500,13,13,0,1,0

7,123,123,12,12,0,1,0
21,166,166,6,6,0,1,0
20,189,189,16,8,8,3,2
22,193,193,1,1,0,1,0
0,204,204,77,29,48,3,2
4,234,234,8,1,7,2,1
8,244,244,4,4,0,1,0
2,248,248,45,45,0,1,0
9,250,250,140,140,0,1,0
17,266,266,40,1,39,4,3
25,279,279,15,1,14,3,2
10,286,286,86,41,45,4,3
1,293,293,69,18,51,4,3
18,311,311,10,10,0,1,0
24,326,326,11,11,0,1,0
23,343,343,4,1,3,2,1
11,362,362,133,133,0,1,0
12,375,375,99,67,32,2,1
15,384,384,91,41,50,2,1
19,414,414,9,9,0,1,0
16,433,433,9,3,6,3,2
5,443,443,21,12,9,2,1
14,444,444,5,2,3,2,1
13,453,453,2,2,0,1,0
6,490,490,24,24,0,1,0
3,491,491,2,2,0,1,0

30,125,125,1,1,0,1,0
6,133,133,13,13,0,1,0
29,140,140,11,11,0,1,0
4,142,142,2,2,0,1,0
17,146,146,29,14,15,2,1
5,155,155,42,42,0,1,0
13,168,168,6,6,0,1,0
12,169,169,19,19,0,1,0
8,172,172,9,9,0,1,0
1,189,189,17,13,4,2,1
25,204,204,5,5,0,1,0
0,217,217,7,1,6,2,1
2,228,228,17,9,8,3,2
11,241,241,11,11,0,1,0
26,252,252,50,23,27,4,3
16,278,278,13,13,0,1,0
28,282,282,1,1,0,1,0
3,300,300,27,2,25,3,2
19,301,301,2,2,0,1,0
15,309,309,50,50,0,1,0
23,355,355,38,38,0,1,0
18,370,370,12,12,0,1,0
24,371,371,50,34,16,3,2
27,375,375,158,158,0,1,0
22,390,390,61,61,0,1,0
7,397,397,114,2,112,4,3
9,418,418,78,6,72,4,3
14,419,419,88,4,84,4,3
10,432,432,1,1,0,1,0
20,439,439,24,5,19,4,3
21,488,488,1,1,0,1,0

5,103,103,7,3,4,2,1
34,106,106,35,35,0,1,0
3,111,111,5,1,4,2,1
31,150,150,8,8,0,1,0
0,172,172,38,38,0,1,0
1,176,176,2,2,0,1,0
4,191,191,25,5,20,2,1
30,216,216,33,3,30,3,2
35,219,219,16,16,0,1,0
9,225,225,10,10,0,1,0
6,231,231,12,12,0,1,0
28,235,235,12,12,0,1,0
19,258,258,1,1,0,1,0
23,269,269,4,4,0,1,0
27,278,278,17,17,0,1,0
13,283,283,5,5,0,1,0
7,298,298,1,1,0,1,0
36,309,309,39,1,38,2,1
18,340,340,6,6,0,1,0
24,344,344,51,32,19,2,1
14,353,353,17,17,0,1,0
17,354,354,48,48,0,1,0
15,355,355,7,7,0,1,0
26,375,375,53,32,21,4,3
20,385,385,4,4,0,1,0
32,408,408,32,4,28,3,2
29,411,411,3,3,0,1,0
33,419,419,24,8,16,2,1
12,422,422,80,48,32,3,2
22,432,432,39,6,33,2,1
8,433,433,18,11,7,2,1
25,435,435,81,6,75,4,3
2,463,463,124,7,117,4,3
16,465,465,84,54,30,2,1
11,475,475,11,11,0,1,0
21,484,484,27,27,0,1,0
10,495,495,35,18,17,3,2

12,102,102,11,3,8,3,2
7,102,102,9,9,0,1,0
1,105,105,1,1,0,1,0
27,145,145,5,5,0,1,0
4,150,150,10,1,9,2,1
31,162,162,24,14,10,2,1
29,169,169,3,3,0,1,0
20,200,200,2,2,0,1,0
11,211,211,31,31,0,1,0
9,213,213,6,3,3,2,1
10,235,235,28,7,21,4,3
28,246,246,4,4,0,1,0
30,258,258,34,19,15,4,3
8,276,276,1,1,0,1,0
6,279,279,15,15,0,1,0
17,282,282,9,9,0,1,0
21,285,285,41,41,0,1,0
13,300,300,24,16,8,3,2
2,302,302,17,5,12,4,3
33,306,306,44,32,12,4,3
23,369,369,13,7,6,2,1
18,379,379,69,12,57,4,3
19,395,395,2,2,0,1,0
14,397,397,25,2,23,4,3
34,399,399,3,3,0,1,0
26,404,404,59,13,46,3,2
0,413,413,60,6,54,3,2
5,414,414,43,43,0,1,0
16,416,416,39,39,0,1,0
15,424,424,93,70,23,2,1
22,448,448,66,66,0,1,0
3,456,456,1,1,0,1,0
25,458,458,109,109,0,1,0
24,490,490,155,86,69,4,3
32,494,494,42,42,0,1,0

17,103,103,34,34,0,1,0
23,107,107,17,17,0,1,0
7,153,153,1,1,0,1,0
10,160,160,25,5,20,3,2
21,164,164,10,1,9,2,1
13,169,169,16,16,0,1,0
19,176,176,11,11,0,1,0
0,210,210,56,34,22,2,1
4,217,217,75,75,0,1,0
25,235,235,74,17,57,4,3
11,249,249,16,8,8,3,2
1,275,275,36,23,13,2,1
15,286,286,20,5,15,4,3
16,308,308,4,4,0,1,0
20,310,310,5,1,4,2,1
26,323,323,28,9,19,2,1
9,334,334,22,22,0,1,0
22,338,338,12,2,10,3,2
24,367,367,13,13,0,1,0
18,371,371,27,5,22,2,1
12,388,388,71,2,69,4,3
6,390,390,1,1,0,1,0
14,404,404,15,15,0,1,0
2,441,441,19,9,10,3,2
3,459,459,165,150,15,4,3
8,475,475,74,74,0,1,0
5,497,497,36,19,17,3,2

24,105,105,2,2,0,1,0
33,106,106,6,3,3,2,1
21,114,114,3,3,0,1,0
18,121,121,29,29,0,1,0
16,126,126,2,2,0,1,0
29,131,131,2,2,0,1,0
3,132,132,1,1,0,1,0
19,134,134,4,4,0,1,0
17,153,153,7,1,6,2,1
12,156,156,3,3,0,1,0
5,164,164,11,8,3,2,1
0,177,177,13,3,10,3,2
4,178,178,4,4,0,1,0
6,180,180,15,15,0,1,0
27,186,186,5,5,0,1,0
7,189,189,14,11,3,2,1
31,204,204,20,20,0,1,0
10,230,230,4,4,0,1,0
35,241,241,49,49,0,1,0
38,267,267,12,6,6,3,2
22,267,267,41,41,0,1,0
37,268,268,8,8,0,1,0
1,271,271,8,8,0,1,0
2,277,277,44,44,0,1,0
11,287,287,10,2,8,2,1
20,292,292,37,23,14,2,1
23,294,294,62,62,0,1,0
28,307,307,65,5,60,4,3
8,321,321,1,1,0,1,0
25,327,327,78,78,0,1,0
32,331,331,11,11,0,1,0
15,343,343,47,47,0,1,0
34,404,404,43,43,0,1,0
36,429,429,12,12,0,1,0
14,435,435,29,29,0,1,0
26,436,436,54,27,27,2,1
13,463,463,8,8,0,1,0
9,464,464,70,25,45,2,1
30,482,482,92,92,0,1,0

5,103,103,1,1,0,1,0
24,119,119,3,3,0,1,0
12,130,130,8,8,0,1,0
4,144,144,6,6,0,1,0
1,152,152,28,28,0,1,0
18,169,169,21,21,0,1,0
10,186,186,21,11,10,2,1
8,188,188,27,3,24,2,1
21,214,214,15,15,0,1,0
13,247,247,3,3,0,1,0
20,265,265,7,4,3,2,1
25,267,267,33,28,5,2,1
7,294,294,11,11,0,1,0
22,317,317,69,69,0,1,0
16,326,326,15,15,0,1,0
3,331,331,136,13,123,4,3
19,336,336,56,30,26,2,1
6,353,353,5,5,0,1,0
0,366,366,114,95,19,2,1
28,393,393,37,15,22,3,2
27,404,404,31,31,0,1,0
15,422,422,30,30,0,1,0
9,431,431,47,17,30,3,2
11,436,436,27,27,0,1,0
23,461,461,143,26,117,4,3
26,462,462,61,19,42,4,3
14,468,468,10,10,0,1,0
17,470,470,52,52,0,1,0
2,476,476,51,51,0,1,0

23,107,107,1,1,0,1,0
11,114,114,8,8,0,1,0
1,126,126,5,5,0,1,0
17,127,127,2,2,0,1,0
26,151,151,31,31,0,1,0
3,173,173,2,2,0,1,0
4,179,179,19,11,8,3,2
24,239,239,10,10,0,1,0
9,253,253,42,42,0,1,0
22,261,261,20,20,0,1,0
15,272,272,6,6,0,1,0
5,291,291,39,39,0,1,0
14,303,303,17,17,0,1,0
19,313,313,22,2,20,3,2
20,317,317,84,4,80,4,3
27,327,327,14,14,0,1,0
16,338,338,131,131,0,1,0
25,341,341,43,43,0,1,0
8,341,341,4,4,0,1,0
21,365,365,32,32,0,1,0
6,367,367,123,123,0,1,0
2,402,402,33,11,22,3,2
12,405,405,57,57,0,1,0
13,413,413,11,11,0,1,0
18,442,442,30,30,0,1,0
10,457,457,122,22,100,4,3
7,465,465,51,9,42,3,2
0,500,500,134,80,54,4,3

20,113,113,2,2,0,1,0
6,123,123,6,6,0,1,0
17,124,124,9,1,8,2,1
35,155,155,4,4,0,1,0
8,156,156,17,17,0,1,0
31,175,175,44,44,0,1,0
15,181,181,19,19,0,1,0
22,199,199,23,13,10,3,2
27,202,202,16,16,0,1,0
4,209,209,64,64,0,1,0
5,229,229,2,2,0,1,0
25,288,288,10,10,0,1,0
34,290,290,31,7,24,4,3
26,295,295,38,14,24,4,3
32,304,304,5,5,0,1,0
30,309,309,1,1,0,1,0
36,314,314,13,1,12,2,1
21,323,323,71,37,34,3,2
1,339,339,82,35,47,4,3
7,346,346,13,13,0,1,0
23,355,355,129,129,0,1,0
28,356,356,1,1,0,1,0
3,367,367,14,14,0,1,0
16,383,383,4,4,0,1,0
11,388,388,5,2,3,2,1
29,412,412,25,13,12,4,3
24,419,419,73,73,0,1,0
10,427,427,61,17,44,3,2
0,433,433,21,5,16,2,1
13,434,434,46,46,0,1,0
12,439,439,26,19,7,2,1
19,442,442,39,39,0,1,0
33,443,443,4,1,3,2,1
9,445,445,4,4,0,1,0
18,446,446,6,1,5,2,1
14,465,465,45,15,30,4,3
2,469,469,16,4,12,2,1

15,100,100,22,6,16,2,1
18,125,125,3,3,0,1,0
9,137,137,36,27,9,4,3
20,139,139,50,12,38,3,2
27,140,140,3,3,0,1,0
14,153,153,5,5,0,1,0
2,165,165,10,10,0,1,0
16,186,186,2,2,0,1,0
19,206,206,23,16,7,2,1
6,211,211,7,1,6,2,1
17,221,221,39,39,0,1,0
1,234,234,64,10,54,3,2
24,245,245,8,8,0,1,0
25,261,261,25,25,0,1,0
5,307,307,4,4,0,1,0
29,320,320,98,98,0,1,0
31,326,326,17,17,0,1,0
26,339,339,1,1,0,1,0
4,342,342,15,15,0,1,0
23,345,345,79,49,30,3,2
0,352,352,78,70,8,3,2
11,370,370,15,15,0,1,0
13,384,384,16,7,9,4,3
30,401,401,24,21,3,2,1
7,405,405,9,9,0,1,0
12,413,413,44,29,15,2,1
3,425,425,46,46,0,1,0
10,441,441,10,10,0,1,0
8,441,441,44,44,0,1,0
22,474,474,12,12,0,1,0
21,482,482,6,6,0,1,0
28,499,499,54,54,0,1,0

24,134,134,28,1,27,4,3
27,164,164,47,47,0,1,0
1,180,180,4,4,0,1,0
30,180,180,8,8,0,1,0
31,194,194,20,12,8,3,2
19,196,196,8,1,7,2,1
25,204,204,9,9,0,1,0
7,218,218,15,6,9,3,2
6,219,219,25,25,0,1,0
8,229,229,17,4,13,2,1
16,238,238,26,20,6,2,1
23,257,257,2,2,0,1,0
0,264,264,56,56,0,1,0
28,275,275,3,3,0,1,0
26,292,292,17,10,7,2,1
21,293,293,36,36,0,1,0
11,296,296,32,15,17,2,1
13,326,326,11,11,0,1,0
2,330,330,67,67,0,1,0
5,336,336,4,4,0,1,0
17,370,370,15,15,0,1,0
9,372,372,104,51,53,4,3
20,390,390,35,25,10,2,1
12,411,411,9,3,6,3,2
15,420,420,32,32,0,1,0
3,422,422,1,1,0,1,0
29,424,424,165,42,123,4,3
18,429,429,28,13,15,3,2
22,458,458,3,3,0,1,0
4,459,459,141,99,42,3,2
10,470,470,2,2,0,1,0
14,479,479,29,29,0,1,0

13,109,109,1,1,0,1,0
19,115,115,15,12,3,2,1
28,117,117,1,1,0,1,0
4,118,118,5,5,0,1,0
0,130,130,15,6,9,3,2
36,130,130,4,4,0,1,0
37,163,163,34,34,0,1,0
5,180,180,10,2,8,2,1
23,181,181,6,3,3,2,1
14,184,184,10,5,5,2,1
2,190,190,4,1,3,2,1
6,191,191,37,19,18,2,1
38,196,196,27,15,12,4,3
29,196,196,2,2,0,1,0
26,209,209,27,27,0,1,0
34,232,232,8,8,0,1,0
18,259,259,12,12,0,1,0
8,261,261,16,6,10,2,1
16,267,267,25,14,11,2,1
20,277,277,6,6,0,1,0
33,280,280,60,52,8,2,1
17,290,290,23,23,0,1,0
22,327,327,19,19,0,1,0
24,379,379,6,6,0,1,0
25,393,393,16,16,0,1,0
31,404,404,37,37,0,1,0
11,416,416,16,16,0,1,0
12,422,422,5,5,0,1,0
30,426,426,10,10,0,1,0
1,433,433,14,14,0,1,0
15,460,460,107,4,103,4,3
9,464,464,50,46,4,2,1
32,469,469,176,176,0,1,0
3,470,470,16,16,0,1,0
7,470,470,21,21,0,1,0
27,479,479,29,6,23,2,1
35,483,483,105,105,0,1,0
21,500,500,9,9,0,1,0
10,500,500,49,49,0,1,0

26,121,121,10,1,9,2,1
20,125,125,2,2,0,1,0
0,137,137,9,9,0,1,0
11,154,154,1,1,0,1,0
18,170,170,1,1,0,1,0
28,184,184,14,1,13,2,1
6,187,187,15,15,0,1,0
14,207,207,3,3,0,1,0
8,215,215,33,13,20,4,3
17,236,236,8,8,0,1,0
29,247,247,14,7,7,2,1
2,255,255,12,12,0,1,0
21,255,255,31,31,0,1,0
25,255,255,36,36,0,1,0
15,281,281,3,3,0,1,0
9,328,328,22,22,0,1,0
4,329,329,9,6,3,2,1
1,357,357,12,2,10,3,2
7,365,365,41,17,24,4,3
5,376,376,100,61,39,4,3
12,378,378,17,6,11,4,3
27,384,384,10,10,0,1,0
24,393,393,25,25,0,1,0
3,395,395,130,48,82,3,2
16,401,401,13,2,11,2,1
23,423,423,162,33,129,4,3
30,430,430,1,1,0,1,0
10,431,431,30,30,0,1,0
22,454,454,87,87,0,1,0
13,454,454,124,124,0,1,0
31,462,462,38,30,8,2,1
19,465,465,146,110,36,4,3

13,100,100,3,3,0,1,0
32,101,101,6,3,3,2,1
21,112,112,10,7,3,2,1
19,117,117,5,2,3,2,1
0,146,146,1,1,0,1,0
7,146,146,2,2,0,1,0
12,148,148,1,1,0,1,0
25,162,162,16,10,6,2,1
1,165,165,24,24,0,1,0
31,168,168,8,8,0,1,0
26,188,188,22,22,0,1,0
14,201,201,3,3,0,1,0
8,202,202,12,12,0,1,0
29,254,254,4,4,0,1,0
30,277,277,58,4,54,4,3
20,277,277,5,5,0,1,0
2,280,280,39,7,32,2,1
23,288,288,54,18,36,3,2
24,301,301,1,1,0,1,0
11,321,321,41,31,10,3,2
6,323,323,91,46,45,2,1
10,362,362,29,19,10,3,2
16,388,388,13,13,0,1,0
28,405,405,39,39,0,1,0
27,433,433,23,23,0,1,0
4,461,461,27,2,25,2,1
5,466,466,2,2,0,1,0
18,475,475,199,156,43,4,3
17,478,478,57,57,0,1,0
9,488,488,14,14,0,1,0
15,490,490,250,204,46,2,1
22,500,500,34,27,7,2,1
3,500,500,30,2,28,2,1

22,109,109,15,15,0,1,0
20,114,114,11,4,7,3,2
17,120,120,17,17,0,1,0
2,129,129,10,10,0,1,0
24,176,176,17,2,15,2,1
14,177,177,2,2,0,1,0
19,198,198,32,32,0,1,0
11,204,204,13,1,12,2,1
13,211,211,36,36,0,1,0
26,222,222,11,11,0,1,0
16,236,236,15,12,3,2,1
3,252,252,74,74,0,1,0
18,263,263,10,1,9,2,1
4,263,263,79,10,69,3,2
9,271,271,8,8,0,1,0
34,294,294,18,18,0,1,0
33,299,299,37,16,21,4,3
10,314,314,6,6,0,1,0
12,323,323,26,26,0,1,0
8,346,346,5,5,0,1,0
28,355,355,13,2,11,2,1
29,369,369,64,52,12,4,3
7,395,395,19,19,0,1,0
23,397,397,108,4,104,4,3
25,425,425,107,11,96,4,3
1,433,433,17,17,0,1,0
27,435,435,34,34,0,1,0
15,441,441,9,9,0,1,0
6,453,453,15,15,0,1,0
31,460,460,15,11,4,2,1
21,465,465,11,11,0,1,0
0,465,465,62,62,0,1,0
5,479,479,12,12,0,1,0
32,498,498,8,8,0,1,0
30,500,500,13,13,0,1,0

33,108,108,24,24,0,1,0
27,120,120,11,6,5,2,1
24,125,125,1,1,0,1,0
10,140,140,17,9,8,2,1
5,148,148,9,9,0,1,0
29,156,156,15,6,9,2,1
37,168,168,8,8,0,1,0
31,181,181,70,62,8,2,1
21,182,182,17,11,6,3,2
13,197,197,18,13,5,2,1
4,211,211,13,13,0,1,0
26,234,234,8,8,0,1,0
16,237,237,3,3,0,1,0
34,241,241,25,3,22,3,2
3,270,270,21,21,0,1,0
14,270,270,33,18,15,2,1
22,271,271,8,2,6,2,1
2,279,279,51,51,0,1,0
8,284,284,13,13,0,1,0
32,294,294,80,32,48,2,1
30,318,318,5,5,0,1,0
0,328,328,28,9,19,2,1
35,332,332,8,8,0,1,0
28,355,355,25,25,0,1,0
23,356,356,32,17,15,4,3
15,358,358,26,26,0,1,0
20,372,372,12,12,0,1,0
9,376,376,34,34,0,1,0
17,381,381,16,16,0,1,0
19,405,405,15,15,0,1,0
18,410,410,76,16,60,4,3
7,418,418,6,6,0,1,0
12,427,427,21,21,0,1,0
6,439,439,2,2,0,1,0
1,442,442,51,51,0,1,0
11,453,453,1,1,0,1,0
25,485,485,65,35,30,3,2
36,485,485,2,2,0,1,0

9,108,108,1,1,0,1,0
30,111,111,12,12,0,1,0
11,112,112,5,1,4,2,1
37,131,131,17,17,0,1,0
4,149,149,38,38,0,1,0
7,161,161,9,1,8,2,1
38,173,173,38,33,5,2,1
12,187,187,15,15,0,1,0
28,208,208,11,5,6,2,1
25,221,221,7,7,0,1,0
8,223,223,33,33,0,1,0
20,248,248,1,1,0,1,0
40,255,255,15,3,12,4,3
24,258,258,17,17,0,1,0
1,273,273,9,1,8,3,2
0,278,278,11,2,9,2,1
26,306,306,28,28,0,1,0
10,310,310,3,3,0,1,0
16,319,319,26,6,20,2,1
6,338,338,2,2,0,1,0
27,346,346,13,13,0,1,0
39,350,350,41,41,0,1,0
34,353,353,70,39,31,2,1
5,355,355,42,42,0,1,0
18,376,376,64,18,46,3,2
3,379,379,38,13,25,2,1
33,383,383,50,50,0,1,0
2,386,386,33,15,18,3,2
36,398,398,26,22,4,2,1
32,404,404,3,3,0,1,0
23,428,428,32,32,0,1,0
13,436,436,5,5,0,1,0
31,441,441,37,37,0,1,0
21,451,451,27,1,26,3,2
17,454,454,8,8,0,1,0
22,459,459,4,4,0,1,0
35,459,459,59,34,25,2,1
15,467,467,2,2,0,1,0
29,488,488,81,18,63,4,3
19,492,492,14,14,0,1,0
14,494,494,45,45,0,1,0

1,101,101,3,3,0,1,0
26,111,111,5,5,0,1,0
16,122,122,6,6,0,1,0
8,133,133,1,1,0,1,0
14,135,135,27,9,18,2,1
21,155,155,49,49,0,1,0
13,158,158,25,1,24,2,1
6,180,180,1,1,0,1,0
9,183,183,1,1,0,1,0
4,200,200,11,11,0,1,0
19,214,214,5,5,0,1,0
25,280,280,7,3,4,2,1
5,293,293,22,22,0,1,0
10,307,307,98,26,72,4,3
2,344,344,6,3,3,2,1
20,346,346,8,1,7,2,1
23,363,363,56,26,30,3,2
24,373,373,61,40,21,4,3
29,377,377,21,21,0,1,0
27,389,389,31,15,16,4,3
17,409,409,36,12,24,4,3
22,423,423,28,28,0,1,0
15,424,424,47,47,0,1,0
7,427,427,21,21,0,1,0
28,435,435,97,80,17,2,1
12,438,438,41,41,0,1,0
11,438,438,141,141,0,1,0
0,467,467,88,65,23,2,1
18,470,470,4,4,0,1,0
3,490,490,137,137,0,1,0

14,124,124,3,3,0,1,0
8,170,170,21,15,6,2,1
23,170,170,11,11,0,1,0
26,184,184,1,1,0,1,0
24,188,188,12,1,11,2,1
11,218,218,1,1,0,1,0
25,219,219,49,3,46,2,1
22,243,243,9,9,0,1,0
28,267,267,3,3,0,1,0
16,278,278,4,4,0,1,0
2,285,285,5,5,0,1,0
31,287,287,38,38,0,1,0
0,302,302,10,4,6,2,1
6,303,303,7,7,0,1,0
1,319,319,68,18,50,4,3
15,325,325,20,20,0,1,0
10,333,333,72,72,0,1,0
4,346,346,5,5,0,1,0
3,354,354,62,62,0,1,0
32,356,356,42,12,30,3,2
29,396,396,34,34,0,1,0
9,402,402,21,9,12,2,1
19,406,406,98,75,23,2,1
12,417,417,14,2,12,4,3
13,422,422,11,11,0,1,0
30,441,441,203,59,144,4,3
27,449,449,15,15,0,1,0
17,455,455,20,14,6,2,1
5,463,463,227,140,87,4,3
7,469,469,16,3,13,2,1
33,480,480,55,5,50,4,3
18,486,486,6,6,0,1,0
20,493,493,1,1,0,1,0
21,494,494,7,7,0,1,0

31,102,102,6,6,0,1,0
26,112,112,10,10,0,1,0
19,118,118,2,2,0,1,0
12,128,128,2,2,0,1,0
22,131,131,12,6,6,2,1
1,147,147,9,9,0,1,0
0,168,168,1,1,0,1,0
3,171,171,13,1,12,3,2
24,174,174,6,6,0,1,0
17,179,179,122,59,63,4,3
30,191,191,41,41,0,1,0
25,196,196,73,64,9,4,3
35,197,197,5,5,0,1,0
15,201,201,12,12,0,1,0
5,207,207,21,6,15,4,3
2,209,209,5,2,3,2,1
10,232,232,4,4,0,1,0
18,247,247,15,6,9,2,1
13,256,256,1,1,0,1,0
28,259,259,12,12,0,1,0
8,275,275,19,11,8,2,1
14,283,283,1,1,0,1,0
11,285,285,12,6,6,2,1
34,291,291,11,1,10,2,1
27,297,297,5,1,4,2,1
9,300,300,11,3,8,2,1
23,306,306,2,2,0,1,0
33,313,313,24,3,21,4,3
29,329,329,19,2,17,3,2
16,347,347,4,1,3,2,1
36,369,369,34,21,13,2,1
6,377,377,27,27,0,1,0
37,382,382,55,55,0,1,0
4,422,422,15,7,8,3,2
38,424,424,35,19,16,2,1
32,449,449,121,121,0,1,0
20,449,449,15,1,14,2,1
21,477,477,20,20,0,1,0
7,499,499,22,22,0,1,0

2,110,110,1,1,0,1,0
22,124,124,10,2,8,2,1
11,138,138,25,8,17,2,1
24,180,180,1,1,0,1,0
8,192,192,5,5,0,1,0
9,219,219,1,1,0,1,0
28,223,223,13,13,0,1,0
3,225,225,10,10,0,1,0
25,227,227,15,9,6,3,2
12,233,233,78,78,0,1,0
30,254,254,31,31,0,1,0
14,260,260,13,4,9,4,3
18,263,263,16,16,0,1,0
7,283,283,39,11,28,4,3
20,284,284,15,15,0,1,0
5,322,322,13,8,5,2,1
16,324,324,18,5,13,2,1
33,328,328,48,48,0,1,0
19,331,331,138,86,52,3,2
4,340,340,1,1,0,1,0
17,343,343,26,26,0,1,0
13,367,367,82,82,0,1,0
0,393,393,41,29,12,4,3
32,399,399,168,154,14,2,1
10,416,416,52,19,33,2,1
27,427,427,1,1,0,1,0
26,443,443,4,4,0,1,0
1,447,447,12,2,10,2,1
15,455,455,29,29,0,1,0
31,469,469,12,12,0,1,0
23,473,473,35,35,0,1,0
21,497,497,3,3,0,1,0
6,499,499,48,48,0,1,0
29,500,500,39,21,18,2,1

13,169,169,1,1,0,1,0
10,177,177,22,22,0,1,0
23,182,182,12,6,6,2,1
11,185,185,15,3,12,2,1
7,220,220,7,3,4,2,1
22,220,220,9,9,0,1,0
8,228,228,19,11,8,2,1
26,244,244,7,7,0,1,0
24,247,247,14,14,0,1,0
2,287,287,51,17,34,2,1
14,301,301,31,13,18,4,3
16,348,348,12,12,0,1,0
28,350,350,13,13,0,1,0
27,364,364,38,38,0,1,0
25,377,377,35,19,16,2,1
29,378,378,33,33,0,1,0
19,384,384,19,9,10,2,1
15,394,394,153,153,0,1,0
3,402,402,92,16,76,3,2
20,409,409,21,16,5,2,1
9,415,415,140,98,42,2,1
1,417,417,57,57,0,1,0
21,422,422,104,91,13,2,1
5,432,432,5,5,0,1,0
18,435,435,41,41,0,1,0
12,441,441,41,41,0,1,0
4,455,455,18,18,0,1,0
6,460,460,82,19,63,4,3
17,497,497,70,10,60,3,2
0,499,499,38,38,0,1,0

5,107,107,5,1,4,2,1
19,125,125,9,9,0,1,0
29,133,133,13,7,6,2,1
30,136,136,13,13,0,1,0
26,158,158,4,4,0,1,0
8,184,184,20,11,9,4,3
17,213,213,5,5,0,1,0
4,222,222,53,53,0,1,0
7,223,223,5,5,0,1,0
22,225,225,35,27,8,3,2
2,226,226,23,23,0,1,0
16,247,247,11,4,7,2,1
0,268,268,18,7,11,2,1
21,269,269,10,2,8,3,2
12,276,276,3,3,0,1,0
18,276,276,21,12,9,2,1
11,280,280,4,4,0,1,0
3,296,296,20,20,0,1,0
25,322,322,91,69,22,3,2
20,337,337,41,41,0,1,0
23,348,348,18,6,12,3,2
13,358,358,10,10,0,1,0
14,368,368,32,32,0,1,0
9,376,376,74,14,60,3,2
27,388,388,28,8,20,2,1
1,405,405,20,5,15,4,3
24,408,408,120,69,51,3,2
15,458,458,11,11,0,1,0
6,463,463,128,95,33,4,3
10,491,491,140,140,0,1,0
28,496,496,79,30,49,2,1

31,123,123,30,30,0,1,0
34,124,124,9,9,0,1,0
11,131,131,41,41,0,1,0
3,142,142,1,1,0,1,0
28,145,145,12,12,0,1,0
14,154,154,1,1,0,1,0
16,167,167,45,22,23,2,1
27,169,169,9,9,0,1,0
13,205,205,12,12,0,1,0
32,208,208,1,1,0,1,0
4,227,227,13,13,0,1,0
5,227,227,11,4,7,3,2
17,243,243,8,8,0,1,0
6,264,264,60,60,0,1,0
9,266,266,20,11,9,2,1
33,289,289,1,1,0,1,0
25,292,292,56,20,36,4,3
19,294,294,25,25,0,1,0
21,295,295,79,79,0,1,0
15,312,312,26,26,0,1,0
30,321,321,18,14,4,2,1
18,330,330,17,7,10,2,1
29,344,344,12,4,8,2,1
0,371,371,73,7,66,4,3
10,377,377,26,19,7,2,1
8,380,380,1,1,0,1,0
20,392,392,44,21,23,3,2
26,397,397,20,6,14,2,1
7,412,412,14,14,0,1,0
22,415,415,12,1,11,2,1
24,437,437,32,1,31,4,3
1,455,455,1,1,0,1,0
23,457,457,125,89,36,2,1
2,457,457,22,22,0,1,0
12,463,463,8,8,0,1,0

29,121,121,53,50,3,2,1
19,144,144,30,14,16,2,1
11,151,151,18,10,8,3,2
24,153,153,18,4,14,3,2
8,195,195,43,43,0,1,0
30,225,225,14,9,5,2,1
6,232,232,3,3,0,1,0
13,234,234,7,7,0,1,0
31,272,272,29,19,10,3,2
7,277,277,1,1,0,1,0
20,304,304,24,24,0,1,0
27,304,304,40,6,34,3,2
25,330,330,29,29,0,1,0
3,379,379,56,17,39,2,1
1,385,385,111,111,0,1,0
5,403,403,73,39,34,3,2
22,415,415,14,14,0,1,0
12,435,435,27,11,16,2,1
18,440,440,6,2,4,2,1
23,449,449,60,60,0,1,0
10,457,457,58,58,0,1,0
0,464,464,32,11,21,4,3
2,464,464,19,1,18,4,3
9,465,465,49,49,0,1,0
15,467,467,7,7,0,1,0
21,468,468,14,2,12,3,2
26,473,473,34,6,28,2,1
28,474,474,5,1,4,2,1
4,474,474,22,22,0,1,0
16,475,475,42,42,0,1,0
17,477,477,7,3,4,2,1
14,488,488,64,34,30,4,3

14,102,102,14,14,0,1,0
15,122,122,22,22,0,1,0
26,123,123,4,4,0,1,0
2,124,124,1,1,0,1,0
11,134,134,7,7,0,1,0
4,144,144,15,15,0,1,0
1,149,149,18,8,10,3,2
21,169,169,8,8,0,1,0
18,200,200,17,5,12,2,1
0,219,219,17,10,7,2,1
9,233,233,1,1,0,1,0
5,249,249,1,1,0,1,0
25,285,285,12,2,10,3,2
3,297,297,80,64,16,3,2
24,310,310,8,8,0,1,0
16,331,331,4,4,0,1,0
8,334,334,28,28,0,1,0
17,335,335,18,8,10,3,2
7,343,343,74,9,65,4,3
12,354,354,112,70,42,2,1
27,354,354,97,53,44,3,2
23,361,361,23,23,0,1,0
22,370,370,50,7,43,3,2
10,382,382,113,113,0,1,0
13,383,383,22,8,14,2,1
19,393,393,163,118,45,4,3
28,418,418,31,31,0,1,0
20,432,432,3,3,0,1,0
6,456,456,23,6,17,2,1

4,108,108,1,1,0,1,0
8,148,148,83,83,0,1,0
16,168,168,7,7,0,1,0
2,185,185,40,40,0,1,0
32,206,206,23,23,0,1,0
17,215,215,9,9,0,1,0
27,217,217,9,3,6,2,1
13,225,225,15,15,0,1,0
10,243,243,34,22,12,4,3
12,246,246,1,1,0,1,0
6,270,270,28,2,26,3,2
7,281,281,18,18,0,1,0
21,314,314,60,60,0,1,0
22,323,323,43,7,36,4,3
31,331,331,15,2,13,2,1
5,349,349,20,20,0,1,0
29,351,351,48,48,0,1,0
25,351,351,35,17,18,4,3
23,363,363,22,5,17,4,3
11,369,369,11,5,6,2,1
19,391,391,49,49,0,1,0
1,402,402,3,3,0,1,0
14,407,407,4,4,0,1,0
3,412,412,74,25,49,2,1
28,427,427,51,5,46,2,1
30,438,438,92,36,56,4,3
9,450,450,21,1,20,2,1
0,453,453,18,8,10,3,2
26,465,465,56,50,6,2,1
15,469,469,13,13,0,1,0
18,471,471,24,6,18,3,2
24,479,479,13,8,5,2,1
20,493,493,54,22,32,3,2

19,110,110,16,6,10,3,2
14,116,116,22,4,18,3,2
16,126,126,33,30,3,2,1
30,139,139,4,1,3,2,1
2,143,143,2,2,0,1,0
12,158,158,1,1,0,1,0
29,158,158,34,34,0,1,0
18,167,167,9,5,4,2,1
3,188,188,1,1,0,1,0
15,190,190,24,24,0,1,0
5,193,193,11,1,10,3,2
13,227,227,1,1,0,1,0
32,229,229,24,24,0,1,0
9,230,230,11,11,0,1,0
1,238,238,54,54,0,1,0
25,266,266,2,2,0,1,0
8,275,275,1,1,0,1,0
10,282,282,20,8,12,2,1
24,284,284,23,19,4,2,1
22,302,302,41,41,0,1,0
7,309,309,7,7,0,1,0
26,312,312,23,23,0,1,0
21,326,326,87,43,44,3,2
11,330,330,55,55,0,1,0
33,340,340,84,84,0,1,0
31,346,346,16,10,6,3,2
20,375,375,21,21,0,1,0
6,391,391,12,12,0,1,0
0,393,393,26,3,23,2,1
27,420,420,7,7,0,1,0
17,423,423,101,5,96,3,2
23,438,438,15,6,9,4,3
4,480,480,30,30,0,1,0
28,494,494,58,58,0,1,0

19,102,102,23,1,22,2,1
1,102,102,18,12,6,2,1
26,129,129,4,4,0,1,0
12,164,164,11,6,5,2,1
17,192,192,15,15,0,1,0
5,204,204,1,1,0,1,0
24,209,209,30,30,0,1,0
6,227,227,6,6,0,1,0
27,227,227,1,1,0,1,0
22,245,245,10,10,0,1,0
9,258,258,39,39,0,1,0
25,260,260,31,31,0,1,0
2,271,271,12,9,3,2,1
0,281,281,25,17,8,3,2
20,288,288,5,2,3,2,1
31,295,295,100,69,31,2,1
29,299,299,57,57,0,1,0
3,307,307,10,4,6,2,1
15,326,326,86,37,49,3,2
16,332,332,29,13,16,3,2
21,372,372,14,14,0,1,0
23,373,373,34,4,30,4,3
10,381,381,63,63,0,1,0
11,383,383,42,8,34,2,1
28,405,405,16,1,15,2,1
18,407,407,9,1,8,3,2
14,408,408,30,22,8,2,1
13,437,437,24,13,11,2,1
8,451,451,53,3,50,2,1
4,468,468,67,67,0,1,0
7,477,477,39,35,4,2,1
30,494,494,78,10,68,3,2

24,124,124,8,8,0,1,0
34,124,124,24,11,13,2,1
31,136,136,4,4,0,1,0
13,147,147,11,11,0,1,0
4,191,191,11,11,0,1,0
11,198,198,8,8,0,1,0
29,199,199,18,4,14,3,2
20,208,208,28,12,16,3,2
16,221,221,5,5,0,1,0
21,278,278,29,5,24,4,3
14,289,289,8,8,0,1,0
5,308,308,10,2,8,2,1
3,308,308,63,63,0,1,0
2,319,319,14,14,0,1,0
10,321,321,1,1,0,1,0
8,339,339,3,3,0,1,0
26,346,346,34,25,9,2,1
18,347,347,34,10,24,4,3
23,357,357,13,9,4,2,1
30,358,358,7,7,0,1,0
32,367,367,9,2,7,2,1
28,367,367,50,50,0,1,0
12,369,369,25,21,4,2,1
19,374,374,59,10,49,3,2
7,377,377,24,24,0,1,0
25,385,385,11,11,0,1,0
22,416,416,120,68,52,3,2
6,416,416,6,6,0,1,0
0,422,422,8,8,0,1,0
1,435,435,40,40,0,1,0
33,435,435,43,43,0,1,0
9,440,440,123,123,0,1,0
17,452,452,162,106,56,3,2
15,489,489,46,46,0,1,0
27,490,490,58,18,40,2,1

11,103,103,4,4,0,1,0
25,104,104,3,3,0,1,0
22,105,105,9,1,8,2,1
19,107,107,7,3,4,2,1
0,111,111,3,3,0,1,0
5,115,115,1,1,0,1,0
21,117,117,7,2,5,2,1
14,135,135,31,13,18,2,1
9,219,219,55,10,45,4,3
13,229,229,49,49,0,1,0
28,247,247,7,2,5,2,1
26,256,256,46,46,0,1,0
6,264,264,1,1,0,1,0
20,273,273,80,80,0,1,0
17,308,308,26,5,21,3,2
24,320,320,5,5,0,1,0
18,346,346,62,62,0,1,0
7,359,359,125,7,118,4,3
3,374,374,117,78,39,4,3
4,374,374,21,21,0,1,0
27,387,387,16,1,15,2,1
15,394,394,15,15,0,1,0
23,405,405,19,19,0,1,0
12,407,407,40,19,21,2,1
2,438,438,81,81,0,1,0
8,443,443,17,17,0,1,0
16,449,449,25,25,0,1,0
1,458,458,93,93,0,1,0
10,482,482,14,9,5,2,1

26,104,104,13,13,0,1,0
1,117,117,48,48,0,1,0
10,182,182,15,12,3,2,1
6,202,202,9,6,3,2,1
19,202,202,27,27,0,1,0
18,214,214,1,1,0,1,0
4,242,242,13,13,0,1,0
20,281,281,14,1,13,2,1
28,288,288,76,57,19,2,1
8,301,301,6,6,0,1,0
21,303,303,10,7,3,2,1
17,316,316,29,20,9,4,3
27,322,322,39,17,22,2,1
5,335,335,101,35,66,4,3
23,335,335,64,59,5,2,1
13,339,339,16,16,0,1,0
2,348,348,55,55,0,1,0
9,355,355,2,2,0,1,0
15,374,374,13,13,0,1,0
14,396,396,24,24,0,1,0
16,414,414,15,15,0,1,0
12,440,440,26,26,0,1,0
22,443,443,11,2,9,2,1
24,445,445,41,41,0,1,0
7,449,449,111,11,100,3,2
3,460,460,4,1,3,2,1
25,461,461,116,94,22,4,3
29,467,467,52,52,0,1,0
11,485,485,6,6,0,1,0
0,495,495,74,46,28,4,3

15,106,106,6,6,0,1,0
22,125,125,8,8,0,1,0
19,131,131,1,1,0,1,0
0,144,144,11,6,5,2,1
4,158,158,15,15,0,1,0
26,162,162,72,72,0,1,0
9,187,187,13,4,9,4,3
30,196,196,88,57,31,2,1
13,202,202,26,26,0,1,0
2,210,210,15,9,6,2,1
23,212,212,3,3,0,1,0
12,255,255,50,50,0,1,0
6,264,264,3,3,0,1,0
8,278,278,118,4,114,4,3
16,304,304,35,35,0,1,0
31,307,307,2,2,0,1,0
21,321,321,8,8,0,1,0
18,329,329,40,1,39,4,3
7,334,334,1,1,0,1,0
27,339,339,11,11,0,1,0
14,339,339,17,17,0,1,0
17,340,340,84,36,48,4,3
1,352,352,9,2,7,2,1
29,354,354,17,17,0,1,0
10,360,360,23,5,18,2,1
20,364,364,7,4,3,2,1
11,378,378,24,24,0,1,0
32,391,391,13,13,0,1,0
5,402,402,43,36,7,2,1
3,422,422,19,19,0,1,0
28,439,439,11,1,10,3,2
24,441,441,12,12,0,1,0
25,458,458,28,28,0,1,0

16,135,135,4,4,0,1,0
19,138,138,15,6,9,2,1
18,169,169,2,2,0,1,0
28,185,185,6,6,0,1,0
7,186,186,18,18,0,1,0
26,193,193,19,19,0,1,0
32,195,195,46,31,15,4,3
14,235,235,11,11,0,1,0
12,237,237,19,4,15,2,1
5,261,261,32,32,0,1,0
1,270,270,4,4,0,1,0
33,286,286,10,10,0,1,0
24,287,287,34,34,0,1,0
15,298,298,7,7,0,1,0
11,304,304,44,44,0,1,0
27,304,304,76,13,63,4,3
20,307,307,12,3,9,4,3
4,318,318,30,18,12,4,3
10,328,328,65,20,45,4,3
30,352,352,6,6,0,1,0
25,362,362,26,26,0,1,0
22,370,370,63,6,57,4,3
2,370,370,10,7,3,2,1
13,378,378,58,15,43,2,1
6,378,378,36,36,0,1,0
17,380,380,26,15,11,2,1
3,383,383,1,1,0,1,0
8,401,401,12,4,8,3,2
31,432,432,65,65,0,1,0
34,444,444,50,5,45,2,1
21,452,452,58,16,42,4,3
29,455,455,24,24,0,1,0
0,472,472,156,156,0,1,0
9,497,497,17,1,16,2,1
23,498,498,2,2,0,1,0

15,107,107,5,2,3,2,1
35,127,127,6,3,3,2,1
31,146,146,19,19,0,1,0
30,172,172,2,2,0,1,0
24,191,191,9,1,8,2,1
19,192,192,3,3,0,1,0
13,195,195,4,1,3,2,1
22,212,212,19,11,8,2,1
4,214,214,9,3,6,2,1
0,215,215,77,77,0,1,0
1,217,217,33,33,0,1,0
25,225,225,24,24,0,1,0
7,235,235,10,10,0,1,0
12,241,241,4,4,0,1,0
11,275,275,1,1,0,1,0
17,304,304,21,21,0,1,0
34,305,305,11,11,0,1,0
20,318,318,11,7,4,2,1
6,320,320,63,35,28,2,1
27,320,320,47,6,41,4,3
21,325,325,4,4,0,1,0
10,337,337,4,4,0,1,0
3,374,374,114,57,57,4,3
26,377,377,2,2,0,1,0
14,407,407,2,2,0,1,0
28,410,410,108,57,51,4,3
29,430,430,22,22,0,1,0
2,430,430,26,20,6,2,1
8,433,433,36,36,0,1,0
23,450,450,61,61,0,1,0
32,455,455,199,67,132,4,3
9,457,457,27,27,0,1,0
16,462,462,49,49,0,1,0
33,466,466,35,35,0,1,0
18,489,489,1,1,0,1,0
5,493,493,2,2,0,1,0

36,104,104,1,1,0,1,0
3,131,131,12,6,6,3,2
26,136,136,1,1,0,1,0
9,146,146,14,2,12,3,2
34,147,147,7,7,0,1,0
14,158,158,9,1,8,3,2
19,165,165,1,1,0,1,0
39,179,179,19,19,0,1,0
12,192,192,8,8,0,1,0
33,196,196,34,34,0,1,0
27,202,202,20,10,10,2,1
25,240,240,46,3,43,3,2
6,258,258,34,28,6,3,2
35,264,264,10,10,0,1,0
15,275,275,2,2,0,1,0
16,281,281,9,3,6,2,1
17,289,289,13,5,8,2,1
28,299,299,12,12,0,1,0
2,303,303,5,5,0,1,0
20,305,305,26,26,0,1,0
7,306,306,20,5,15,4,3
21,311,311,10,10,0,1,0
10,329,329,17,17,0,1,0
40,334,334,14,14,0,1,0
0,336,336,97,39,58,3,2
24,347,347,4,4,0,1,0
29,348,348,50,50,0,1,0
13,357,357,14,5,9,4,3
4,368,368,18,4,14,3,2
18,377,377,9,9,0,1,0
22,381,381,46,46,0,1,0
8,398,398,34,34,0,1,0
38,399,399,91,73,18,4,3
32,404,404,49,49,0,1,0
31,416,416,2,2,0,1,0
11,419,419,1,1,0,1,0
1,429,429,2,2,0,1,0
37,431,431,38,20,18,2,1
23,473,473,37,37,0,1,0
30,480,480,138,45,93,4,3
5,481,481,66,66,0,1,0

15,107,107,1,1,0,1,0
26,151,151,6,6,0,1,0
3,172,172,3,3,0,1,0
2,196,196,30,30,0,1,0
7,211,211,1,1,0,1,0
17,212,212,34,30,4,2,1
30,239,239,4,4,0,1,0
21,241,241,9,9,0,1,0
28,251,251,1,1,0,1,0
11,267,267,3,3,0,1,0
31,267,267,15,15,0,1,0
25,289,289,11,7,4,2,1
16,302,302,20,12,8,3,2
12,317,317,1,1,0,1,0
29,328,328,121,49,72,3,2
19,337,337,96,44,52,4,3
9,338,338,81,57,24,4,3
13,344,344,16,4,12,2,1
23,360,360,27,10,17,4,3
1,365,365,30,8,22,3,2
14,365,365,52,2,50,3,2
6,369,369,6,6,0,1,0
33,383,383,27,6,21,2,1
4,384,384,122,44,78,3,2
5,409,409,46,11,35,2,1
8,430,430,38,8,30,3,2
27,437,437,17,17,0,1,0
32,445,445,45,45,0,1,0
20,457,457,21,21,0,1,0
24,468,468,1,1,0,1,0
18,479,479,7,1,6,2,1
22,484,484,207,207,0,1,0
0,493,493,51,51,0,1,0
10,497,497,14,14,0,1,0

5,101,101,8,4,4,2,1
28,108,108,28,23,5,2,1
22,120,120,9,9,0,1,0
20,155,155,6,6,0,1,0
9,165,165,9,9,0,1,0
10,168,168,20,5,15,4,3
12,181,181,53,9,44,3,2
13,189,189,40,1,39,4,3
2,191,191,2,2,0,1,0
21,191,191,15,15,0,1,0
14,195,195,13,13,0,1,0
24,208,208,67,24,43,4,3
16,223,223,29,12,17,2,1
3,224,224,2,2,0,1,0
19,228,228,2,2,0,1,0
8,228,228,24,24,0,1,0
29,238,238,2,2,0,1,0
1,240,240,39,4,35,4,3
25,247,247,38,8,30,4,3
18,287,287,13,13,0,1,0
7,333,333,37,4,33,4,3
6,345,345,77,59,18,4,3
17,373,373,10,10,0,1,0
11,425,425,62,62,0,1,0
0,428,428,20,20,0,1,0
27,428,428,123,123,0,1,0
15,441,441,27,3,24,4,3
23,455,455,22,22,0,1,0
4,485,485,14,2,12,3,2
26,487,487,6,6,0,1,0

21,100,100,7,7,0,1,0
24,118,118,13,13,0,1,0
20,153,153,4,4,0,1,0
22,162,162,20,20,0,1,0
14,165,165,8,8,0,1,0
13,170,170,2,2,0,1,0
8,173,173,19,19,0,1,0
11,178,178,1,1,0,1,0
1,192,192,21,15,6,2,1
4,227,227,18,18,0,1,0
31,240,240,12,12,0,1,0
2,241,241,30,6,24,4,3
26,257,257,62,24,38,2,1
7,266,266,28,28,0,1,0
30,290,290,54,54,0,1,0
16,291,291,31,31,0,1,0
25,293,293,50,6,44,3,2
23,297,297,30,30,0,1,0
9,335,335,13,4,9,2,1
18,348,348,51,51,0,1,0
5,348,348,19,19,0,1,0
17,354,354,32,18,14,3,2
0,377,377,41,29,12,2,1
29,391,391,2,2,0,1,0
3,417,417,50,50,0,1,0
10,420,420,30,14,16,2,1
15,428,428,94,86,8,3,2
19,436,436,20,20,0,1,0
28,437,437,11,11,0,1,0
27,443,443,101,17,84,4,3
6,459,459,127,127,0,1,0
12,479,479,6,6,0,1,0
32,488,488,5,2,3,2,1

12,140,140,9,1,8,2,1
20,142,142,14,8,6,3,2
17,164,164,1,1,0,1,0
15,165,165,6,2,4,2,1
7,171,171,48,1,47,2,1
22,180,180,70,66,4,2,1
14,187,187,6,3,3,2,1
1,269,269,2,2,0,1,0
19,269,269,30,20,10,2,1
8,269,269,8,2,6,2,1
23,271,271,50,17,33,4,3
5,272,272,1,1,0,1,0
6,285,285,23,23,0,1,0
10,289,289,60,24,36,4,3
0,306,306,21,13,8,2,1
24,321,321,72,72,0,1,0
26,351,351,9,9,0,1,0
21,374,374,30,30,0,1,0
4,379,379,73,41,32,3,2
13,383,383,16,16,0,1,0
3,430,430,16,6,10,2,1
18,444,444,4,4,0,1,0
25,450,450,24,14,10,3,2
16,453,453,40,40,0,1,0
2,467,467,63,37,26,3,2
27,480,480,90,90,0,1,0
11,498,498,174,127,47,2,1
9,500,500,104,104,0,1,0

29,107,107,4,4,0,1,0
8,127,127,3,3,0,1,0
27,151,151,30,2,28,3,2
22,156,156,51,51,0,1,0
18,170,170,7,3,4,2,1
5,197,197,46,16,30,4,3
26,238,238,20,12,8,2,1
12,242,242,6,6,0,1,0
3,247,247,103,103,0,1,0
15,273,273,40,29,11,2,1
25,276,276,5,5,0,1,0
20,295,295,17,17,0,1,0
24,303,303,2,2,0,1,0
28,315,315,15,3,12,4,3
9,322,322,52,9,43,4,3
4,336,336,10,2,8,3,2
0,337,337,11,1,10,2,1
13,339,339,41,26,15,2,1
21,340,340,14,5,9,2,1
1,357,357,21,21,0,1,0
14,376,376,6,6,0,1,0
6,385,385,59,59,0,1,0
30,386,386,19,19,0,1,0
2,415,415,6,6,0,1,0
19,435,435,84,43,41,4,3
17,439,439,78,78,0,1,0
7,459,459,11,3,8,3,2
16,461,461,71,71,0,1,0
10,468,468,127,85,42,2,1
23,470,470,24,24,0,1,0
11,494,494,10,4,6,3,2

1,102,102,43,28,15,4,3
17,114,114,4,4,0,1,0
6,134,134,31,7,24,3,2
10,142,142,19,11,8,3,2
30,144,144,9,9,0,1,0
3,156,156,42,28,14,2,1
31,161,161,28,28,0,1,0
8,172,172,36,20,16,3,2
27,172,172,37,29,8,2,1
13,190,190,5,5,0,1,0
25,205,205,21,21,0,1,0
28,258,258,11,6,5,2,1
26,271,271,9,9,0,1,0
20,288,288,18,9,9,4,3
16,296,296,4,4,0,1,0
2,296,296,17,13,4,2,1
14,306,306,1,1,0,1,0
19,318,318,36,36,0,1,0
4,321,321,1,1,0,1,0
21,349,349,104,70,34,2,1
23,358,358,18,3,15,2,1
0,360,360,19,1,18,4,3
29,362,362,30,30,0,1,0
15,372,372,1,1,0,1,0
11,416,416,20,10,10,3,2
7,426,426,14,4,10,2,1
22,428,428,83,65,18,4,3
9,443,443,21,21,0,1,0
18,455,455,64,64,0,1,0
12,456,456,10,2,8,3,2
24,460,460,7,7,0,1,0
5,463,463,19,1,18,3,2

37,101,101,7,7,0,1,0
0,113,113,1,1,0,1,0
13,123,123,4,4,0,1,0
2,124,124,9,9,0,1,0
1,130,130,9,9,0,1,0
5,149,149,11,11,0,1,0
6,194,194,7,7,0,1,0
34,204,204,31,12,19,2,1
32,225,225,4,1,3,2,1
3,231,231,58,33,25,2,1
8,232,232,26,14,12,4,3
16,241,241,1,1,0,1,0
21,282,282,1,1,0,1,0
19,283,283,4,4,0,1,0
7,283,283,22,6,16,3,2
31,312,312,26,17,9,4,3
28,315,315,34,34,0,1,0
20,324,324,53,43,10,3,2
38,325,325,51,27,24,2,1
17,332,332,36,36,0,1,0
29,336,336,35,35,0,1,0
23,339,339,48,48,0,1,0
9,367,367,13,13,0,1,0
30,375,375,36,10,26,2,1
12,382,382,21,16,5,2,1
4,406,406,28,28,0,1,0
15,408,408,19,19,0,1,0
10,415,415,56,18,38,3,2
36,426,426,26,21,5,2,1
33,447,447,73,27,46,2,1
18,458,458,2,2,0,1,0
25,466,466,20,20,0,1,0
14,470,470,64,32,32,2,1
24,474,474,88,16,72,3,2
26,486,486,74,44,30,2,1
22,490,490,6,6,0,1,0
35,491,491,19,3,16,3,2
27,494,494,26,26,0,1,0
11,495,495,39,29,10,2,1

21,113,113,1,1,0,1,0
12,119,119,5,5,0,1,0
31,134,134,14,2,12,2,1
19,135,135,6,6,0,1,0
27,136,136,17,17,0,1,0
24,146,146,6,1,5,2,1
34,157,157,8,8,0,1,0
20,162,162,10,10,0,1,0
17,175,175,5,5,0,1,0
18,184,184,23,23,0,1,0
37,185,185,4,4,0,1,0
28,187,187,47,26,21,2,1
14,206,206,7,7,0,1,0
5,228,228,11,11,0,1,0
15,237,237,1,1,0,1,0
25,239,239,40,10,30,3,2
13,256,256,1,1,0,1,0
6,261,261,58,46,12,4,3
16,273,273,20,20,0,1,0
3,282,282,2,2,0,1,0
32,302,302,48,48,0,1,0
9,331,331,6,3,3,2,1
22,333,333,30,30,0,1,0
2,340,340,48,34,14,3,2
36,341,341,6,6,0,1,0
29,342,342,11,11,0,1,0
7,343,343,7,1,6,2,1
0,360,360,36,36,0,1,0
4,362,362,54,9,45,4,3
1,364,364,34,2,32,2,1
35,386,386,32,5,27,2,1
11,428,428,20,7,13,2,1
38,438,438,23,23,0,1,0
33,442,442,7,1,6,2,1
30,477,477,55,5,50,2,1
26,479,479,179,179,0,1,0
8,487,487,109,14,95,4,3
10,487,487,7,1,6,3,2
23,492,492,9,1,8,2,1

18,127,127,8,5,3,2,1
16,136,136,2,2,0,1,0
21,163,163,2,2,0,1,0
20,173,173,1,1,0,1,0
28,187,187,2,2,0,1,0
6,202,202,20,14,6,3,2
22,212,212,60,60,0,1,0
23,216,216,26,10,16,2,1
15,224,224,26,9,17,2,1
7,239,239,59,59,0,1,0
13,243,243,8,8,0,1,0
12,252,252,36,12,24,4,3
10,269,269,94,44,50,2,1
32,271,271,31,31,0,1,0
3,279,279,25,25,0,1,0
8,280,280,49,49,0,1,0
17,307,307,7,7,0,1,0
5,328,328,37,37,0,1,0
11,366,366,3,3,0,1,0
24,370,370,79,13,66,3,2
19,381,381,42,17,25,2,1
29,391,391,17,10,7,2,1
27,396,396,48,48,0,1,0
9,402,402,14,14,0,1,0
25,404,404,95,79,16,3,2
0,406,406,18,18,0,1,0
2,447,447,4,1,3,2,1
30,457,457,19,13,6,2,1
31,458,458,35,35,0,1,0
14,471,471,1,1,0,1,0
4,487,487,58,41,17,2,1
26,495,495,77,77,0,1,0
1,499,499,4,4,0,1,0

6,104,104,9,9,0,1,0
29,106,106,6,6,0,1,0
3,142,142,10,1,9,2,1
2,145,145,30,22,8,3,2
25,147,147,12,8,4,2,1
8,169,169,7,7,0,1,0
19,175,175,19,3,16,3,2
31,179,179,1,1,0,1,0
1,193,193,7,7,0,1,0
24,210,210,19,19,0,1,0
0,214,214,22,22,0,1,0
13,225,225,5,5,0,1,0
18,227,227,21,12,9,2,1
15,235,235,38,6,32,2,1
14,235,235,32,23,9,4,3
28,263,263,39,39,0,1,0
12,280,280,16,16,0,1,0
5,289,289,28,28,0,1,0
26,295,295,1,1,0,1,0
17,301,301,78,16,62,3,2
7,306,306,58,21,37,2,1
20,337,337,65,32,33,2,1
23,342,342,8,8,0,1,0
16,346,346,27,27,0,1,0
30,352,352,18,18,0,1,0
22,359,359,51,51,0,1,0
27,361,361,29,10,19,2,1
10,405,405,13,13,0,1,0
21,428,428,94,94,0,1,0
11,430,430,46,46,0,1,0
9,474,474,25,25,0,1,0
4,486,486,98,87,11,2,1

18,100,100,6,3,3,2,1
22,111,111,10,6,4,2,1
21,122,122,8,1,7,2,1
27,149,149,4,4,0,1,0
34,161,161,3,3,0,1,0
36,182,182,26,26,0,1,0
9,195,195,2,2,0,1,0
32,202,202,3,3,0,1,0
14,211,211,1,1,0,1,0
33,220,220,11,11,0,1,0
1,252,252,12,1,11,2,1
25,263,263,47,47,0,1,0
3,268,268,7,7,0,1,0
26,271,271,74,28,46,3,2
15,276,276,9,9,0,1,0
12,295,295,31,2,29,2,1
4,305,305,23,23,0,1,0
5,309,309,40,12,28,3,2
7,328,328,31,13,18,3,2
8,337,337,7,1,6,3,2
23,341,341,104,29,75,4,3
20,342,342,24,24,0,1,0
2,348,348,101,62,39,2,1
29,359,359,46,10,36,3,2
13,360,360,5,5,0,1,0
17,362,362,2,2,0,1,0
16,376,376,36,10,26,4,3
24,386,386,32,32,0,1,0
0,408,408,1,1,0,1,0
6,426,426,39,39,0,1,0
11,433,433,46,10,36,2,1
19,443,443,108,88,20,2,1
35,457,457,17,17,0,1,0
28,458,458,19,19,0,1,0
30,462,462,68,68,0,1,0
31,470,470,12,12,0,1,0
10,486,486,36,24,12,4,3

17,117,117,22,12,10,2,1
8,118,118,1,1,0,1,0
30,122,122,13,13,0,1,0
23,127,127,6,6,0,1,0
14,133,133,4,4,0,1,0
0,141,141,2,2,0,1,0
32,147,147,22,22,0,1,0
10,162,162,10,2,8,2,1
11,165,165,11,3,8,2,1
31,180,180,13,13,0,1,0
16,180,180,10,4,6,3,2
21,197,197,19,11,8,3,2
26,210,210,18,18,0,1,0
4,216,216,15,1,14,3,2
3,222,222,116,116,0,1,0
22,257,257,15,3,12,3,2
5,258,258,5,5,0,1,0
27,261,261,12,12,0,1,0
25,273,273,69,59,10,2,1
13,301,301,3,3,0,1,0
24,303,303,6,6,0,1,0
18,309,309,57,57,0,1,0
1,331,331,23,6,17,2,1
2,336,336,55,21,34,3,2
6,348,348,56,12,44,3,2
7,364,364,29,29,0,1,0
9,379,379,48,20,28,3,2
20,386,386,56,56,0,1,0
15,411,411,4,4,0,1,0
29,418,418,14,14,0,1,0
19,451,451,54,54,0,1,0
12,453,453,60,11,49,2,1
28,491,491,10,10,0,1,0

12,115,115,16,16,0,1,0
9,129,129,3,3,0,1,0
29,133,133,6,1,5,2,1
20,142,142,1,1,0,1,0
7,154,154,48,48,0,1,0
10,160,160,12,12,0,1,0
30,178,178,29,7,22,2,1
22,182,182,14,1,13,2,1
3,195,195,5,5,0,1,0
4,219,219,70,40,30,2,1
14,240,240,4,4,0,1,0
27,271,271,58,10,48,3,2
28,277,277,23,23,0,1,0
5,291,291,6,3,3,2,1
31,291,291,43,43,0,1,0
32,315,315,6,6,0,1,0
1,316,316,3,3,0,1,0
11,318,318,4,4,0,1,0
17,326,326,7,7,0,1,0
21,332,332,99,70,29,2,1
26,342,342,13,13,0,1,0
18,346,346,15,8,7,2,1
8,356,356,12,12,0,1,0
19,382,382,2,2,0,1,0
16,382,382,7,2,5,2,1
23,387,387,44,16,28,2,1
15,395,395,152,152,0,1,0
0,402,402,1,1,0,1,0
13,411,411,22,22,0,1,0
2,423,423,36,27,9,4,3
25,440,440,94,58,36,2,1
6,477,477,33,6,27,4,3
24,491,491,66,66,0,1,0

1,111,111,8,4,4,2,1
7,202,202,70,70,0,1,0
11,205,205,17,1,16,3,2
5,211,211,56,56,0,1,0
3,214,214,13,7,6,3,2
13,232,232,44,44,0,1,0
22,277,277,28,28,0,1,0
2,289,289,95,26,69,4,3
4,290,290,30,30,0,1,0
14,302,302,8,4,4,2,1
6,333,333,30,4,26,2,1
10,339,339,23,23,0,1,0
18,339,339,16,10,6,2,1
21,341,341,46,12,34,4,3
9,363,363,28,16,12,2,1
19,365,365,19,19,0,1,0
20,371,371,31,10,21,4,3
12,402,402,8,1,7,2,1
15,416,416,43,22,21,2,1
26,423,423,83,25,58,4,3
23,434,434,33,33,0,1,0
25,448,448,116,20,96,3,2
17,455,455,56,27,29,2,1
24,463,463,44,12,32,4,3
16,470,470,14,14,0,1,0
8,471,471,81,12,69,3,2
0,476,476,9,9,0,1,0

31,120,120,19,19,0,1,0
20,120,120,4,4,0,1,0
19,126,126,16,16,0,1,0
6,161,161,7,1,6,3,2
23,162,162,9,9,0,1,0
32,200,200,47,29,18,4,3
3,213,213,40,3,37,2,1
18,241,241,14,14,0,1,0
11,265,265,109,63,46,2,1
4,266,266,1,1,0,1,0
7,280,280,2,2,0,1,0
16,284,284,9,6,3,2,1
22,287,287,61,37,24,4,3
8,307,307,29,1,28,2,1
33,316,316,6,6,0,1,0
5,318,318,30,30,0,1,0
28,322,322,88,83,5,2,1
0,323,323,20,20,0,1,0
27,336,336,14,6,8,2,1
24,345,345,4,4,0,1,0
25,351,351,6,6,0,1,0
14,372,372,20,20,0,1,0
34,373,373,67,20,47,2,1
21,396,396,23,23,0,1,0
26,399,399,2,2,0,1,0
9,405,405,30,30,0,1,0
15,408,408,33,21,12,2,1
30,420,420,82,50,32,2,1
29,427,427,7,7,0,1,0
10,436,436,40,40,0,1,0
1,438,438,5,5,0,1,0
12,443,443,75,69,6,3,2
13,452,452,22,22,0,1,0
17,482,482,28,9,19,2,1
2,491,491,9,9,0,1,0

29,103,103,8,8,0,1,0
4,107,107,8,8,0,1,0
14,108,108,11,11,0,1,0
3,110,110,1,1,0,1,0
6,116,116,4,4,0,1,0
5,116,116,35,35,0,1,0
30,128,128,4,4,0,1,0
31,135,135,6,6,0,1,0
16,143,143,10,6,4,2,1
1,160,160,1,1,0,1,0
10,176,176,1,1,0,1,0
24,197,197,3,3,0,1,0
28,206,206,20,4,16,2,1
33,223,223,2,2,0,1,0
20,252,252,56,9,47,4,3
15,253,253,25,20,5,2,1
2,269,269,3,3,0,1,0
23,283,283,40,37,3,2,1
17,297,297,39,21,18,4,3
13,306,306,22,6,16,2,1
21,318,318,3,3,0,1,0
18,347,347,58,16,42,2,1
7,351,351,4,1,3,2,1
26,360,360,5,5,0,1,0
11,369,369,1,1,0,1,0
32,369,369,114,42,72,3,2
8,384,384,47,47,0,1,0
27,389,389,56,17,39,4,3
9,403,403,23,7,16,4,3
12,429,429,129,77,52,3,2
34,437,437,22,12,10,2,1
0,461,461,10,2,8,3,2
22,466,466,16,1,15,4,3
19,466,466,57,57,0,1,0
25,498,498,154,96,58,4,3

25,110,110,2,2,0,1,0
21,132,132,37,37,0,1,0
7,136,136,14,14,0,1,0
28,142,142,31,31,0,1,0
1,147,147,1,1,0,1,0
27,185,185,4,4,0,1,0
13,204,204,12,12,0,1,0
4,204,204,1,1,0,1,0
12,218,218,35,35,0,1,0
18,233,233,8,8,0,1,0
17,245,245,4,4,0,1,0
19,258,258,86,86,0,1,0
2,284,284,16,16,0,1,0
26,291,291,5,5,0,1,0
24,305,305,4,4,0,1,0
8,319,319,18,6,12,3,2
3,329,329,8,4,4,2,1
6,334,334,249,249,0,1,0
29,344,344,21,21,0,1,0
16,360,360,48,48,0,1,0
22,365,365,7,7,0,1,0
23,381,381,106,22,84,4,3
15,390,390,54,54,0,1,0
14,396,396,21,13,8,3,2
20,420,420,2,2,0,1,0
11,422,422,90,24,66,4,3
10,435,435,10,10,0,1,0
5,451,451,16,16,0,1,0
9,475,475,7,2,5,2,1
0,481,481,47,47,0,1,0

22,106,106,19,13,6,2,1
26,119,119,14,1,13,3,2
2,121,121,8,2,6,2,1
12,163,163,7,2,5,2,1
10,164,164,25,25,0,1,0
20,167,167,11,11,0,1,0
19,191,191,24,24,0,1,0
24,193,193,3,3,0,1,0
23,227,227,10,2,8,3,2
4,233,233,19,19,0,1,0
9,235,235,1,1,0,1,0
13,258,258,20,2,18,4,3
21,258,258,44,44,0,1,0
1,263,263,37,37,0,1,0
14,266,266,31,31,0,1,0
16,280,280,64,64,0,1,0
8,313,313,1,1,0,1,0
0,324,324,92,17,75,4,3
18,330,330,11,11,0,1,0
31,342,342,35,28,7,2,1
17,355,355,29,23,6,3,2
5,356,356,51,27,24,3,2
25,363,363,17,5,12,3,2
6,386,386,25,25,0,1,0
28,411,411,51,39,12,2,1
30,429,429,20,17,3,2,1
27,447,447,61,61,0,1,0
11,464,464,36,36,0,1,0
15,472,472,37,6,31,3,2
3,473,473,99,39,60,4,3
29,483,483,56,11,45,4,3
7,488,488,29,15,14,3,2

21,126,126,14,14,0,1,0
15,130,130,10,10,0,1,0
11,144,144,2,2,0,1,0
31,156,156,12,7,5,2,1
10,161,161,13,8,5,2,1
22,165,165,2,2,0,1,0
5,183,183,10,10,0,1,0
23,185,185,52,32,20,2,1
3,210,210,24,24,0,1,0
25,211,211,47,47,0,1,0
1,215,215,10,10,0,1,0
17,220,220,1,1,0,1,0
26,226,226,25,9,16,3,2
19,241,241,38,38,0,1,0
14,243,243,57,57,0,1,0
24,243,243,33,33,0,1,0
13,247,247,6,6,0,1,0
20,291,291,34,34,0,1,0
28,292,292,5,2,3,2,1
7,292,292,18,18,0,1,0
6,307,307,1,1,0,1,0
32,312,312,42,42,0,1,0
27,327,327,8,8,0,1,0
16,329,329,17,17,0,1,0
4,365,365,36,4,32,4,3
9,369,369,65,65,0,1,0
12,379,379,73,7,66,3,2
29,407,407,26,26,0,1,0
0,424,424,40,40,0,1,0
18,425,425,13,6,7,2,1
8,475,475,12,12,0,1,0
30,484,484,62,6,56,3,2
2,493,493,124,90,34,2,1

26,101,101,8,8,0,1,0
25,112,112,30,16,14,2,1
30,137,137,44,44,0,1,0
13,144,144,2,2,0,1,0
20,163,163,7,1,6,3,2
14,166,166,49,40,9,2,1
3,175,175,1,1,0,1,0
7,208,208,5,1,4,2,1
12,225,225,11,11,0,1,0
19,261,261,10,4,6,2,1
2,264,264,20,5,15,4,3
32,266,266,17,8,9,4,3
24,275,275,3,3,0,1,0
1,284,284,22,22,0,1,0
31,291,291,11,11,0,1,0
33,305,305,60,2,58,3,2
6,311,311,9,9,0,1,0
5,315,315,67,61,6,2,1
15,317,317,4,1,3,2,1
29,328,328,8,8,0,1,0
9,353,353,20,5,15,4,3
16,362,362,14,2,12,4,3
23,371,371,16,16,0,1,0
0,372,372,7,7,0,1,0
8,383,383,110,65,45,2,1
4,396,396,55,1,54,3,2
28,422,422,92,92,0,1,0
18,467,467,51,51,0,1,0
10,473,473,73,73,0,1,0
11,476,476,18,6,12,4,3
21,477,477,2,2,0,1,0
17,482,482,35,35,0,1,0
22,493,493,2,2,0,1,0
27,496,496,87,38,49,3,2

25,105,105,8,4,4,2,1
26,106,106,6,6,0,1,0
22,108,108,1,1,0,1,0
13,109,109,1,1,0,1,0
35,112,112,2,2,0,1,0
11,140,140,1,1,0,1,0
5,147,147,1,1,0,1,0
0,180,180,1,1,0,1,0
32,183,183,4,4,0,1,0
20,189,189,24,16,8,2,1
23,207,207,34,4,30,3,2
17,219,219,20,20,0,1,0
15,230,230,9,9,0,1,0
3,237,237,9,9,0,1,0
19,246,246,14,14,0,1,0
4,253,253,16,6,10,3,2
6,253,253,1,1,0,1,0
29,255,255,19,19,0,1,0
16,261,261,10,10,0,1,0
8,271,271,9,6,3,2,1
9,296,296,165,80,85,4,3
36,338,338,53,53,0,1,0
30,340,340,16,12,4,2,1
21,361,361,40,13,27,2,1
7,373,373,9,9,0,1,0
2,404,404,32,32,0,1,0
34,406,406,19,19,0,1,0
18,409,409,12,12,0,1,0
12,410,410,35,35,0,1,0
33,411,411,25,11,14,2,1
1,433,433,51,45,6,3,2
27,434,434,63,6,57,4,3
24,447,447,45,25,20,2,1
10,447,447,17,2,15,2,1
14,451,451,69,23,46,2,1
31,465,465,223,94,129,4,3
28,466,466,29,29,0,1,0

20,117,117,8,8,0,1,0
2,122,122,1,1,0,1,0
5,139,139,35,35,0,1,0
24,140,140,13,5,8,3,2
16,157,157,5,5,0,1,0
11,180,180,8,4,4,2,1
8,196,196,15,15,0,1,0
21,204,204,1,1,0,1,0
27,207,207,13,13,0,1,0
25,256,256,32,15,17,4,3
14,279,279,1,1,0,1,0
10,294,294,75,75,0,1,0
9,301,301,5,5,0,1,0
22,302,302,34,34,0,1,0
30,304,304,20,10,10,3,2
3,310,310,34,34,0,1,0
18,311,311,30,30,0,1,0
1,334,334,14,14,0,1,0
6,340,340,2,2,0,1,0
26,349,349,48,22,26,3,2
23,350,350,176,26,150,4,3
4,352,352,24,15,9,4,3
15,357,357,1,1,0,1,0
7,375,375,1,1,0,1,0
29,376,376,49,49,0,1,0
28,390,390,26,26,0,1,0
17,417,417,6,1,5,2,1
12,433,433,48,34,14,3,2
31,438,438,32,24,8,2,1
13,439,439,167,123,44,3,2
19,476,476,21,18,3,2,1
0,481,481,107,107,0,1,0

9,123,123,1,1,0,1,0
11,140,140,41,29,12,4,3
3,151,151,1,1,0,1,0
21,157,157,12,12,0,1,0
10,158,158,5,5,0,1,0
5,163,163,4,4,0,1,0
23,177,177,5,5,0,1,0
13,183,183,9,9,0,1,0
30,186,186,41,41,0,1,0
6,191,191,10,2,8,2,1
17,206,206,3,3,0,1,0
32,215,215,10,6,4,2,1
19,219,219,7,7,0,1,0
33,264,264,8,8,0,1,0
22,275,275,98,59,39,3,2
0,275,275,15,15,0,1,0
8,279,279,3,3,0,1,0
16,280,280,2,2,0,1,0
2,290,290,47,47,0,1,0
29,303,303,32,29,3,2,1
27,304,304,23,7,16,3,2
15,306,306,2,2,0,1,0
20,331,331,24,24,0,1,0
35,340,340,35,11,24,2,1
26,344,344,50,13,37,2,1
36,373,373,9,9,0,1,0
4,395,395,113,55,58,3,2
37,413,413,4,4,0,1,0
7,416,416,3,3,0,1,0
25,418,418,23,15,8,2,1
18,421,421,42,32,10,2,1
1,455,455,75,43,32,2,1
28,461,461,78,78,0,1,0
12,468,468,38,38,0,1,0
31,470,470,26,11,15,2,1
34,490,490,47,23,24,3,2
24,499,499,54,45,9,2,1
14,499,499,31,31,0,1,0

31,116,116,14,8,6,3,2
29,129,129,9,9,0,1,0
8,139,139,5,5,0,1,0
10,141,141,3,3,0,1,0
14,152,152,39,39,0,1,0
33,154,154,4,4,0,1,0
27,155,155,46,28,18,3,2
15,159,159,22,18,4,2,1
25,160,160,17,17,0,1,0
17,183,183,15,1,14,3,2
26,242,242,2,2,0,1,0
18,265,265,23,11,12,4,3
11,266,266,66,66,0,1,0
23,273,273,6,3,3,2,1
9,276,276,7,1,6,2,1
6,276,276,87,54,33,4,3
19,280,280,8,8,0,1,0
35,285,285,124,94,30,3,2
0,292,292,28,13,15,4,3
16,293,293,7,2,5,2,1
24,301,301,24,24,0,1,0
2,305,305,21,16,5,2,1
3,322,322,13,3,10,3,2
22,349,349,4,4,0,1,0
28,358,358,20,2,18,4,3
34,374,374,22,13,9,4,3
13,383,383,2,2,0,1,0
30,391,391,4,1,3,2,1
5,406,406,15,1,14,3,2
4,418,418,14,14,0,1,0
20,443,443,4,4,0,1,0
32,445,445,17,17,0,1,0
1,456,456,4,4,0,1,0
12,463,463,20,20,0,1,0
7,476,476,4,4,0,1,0
21,490,490,136,115,21,4,3

3,119,119,1,1,0,1,0
28,127,127,3,3,0,1,0
4,161,161,8,1,7,2,1
1,166,166,10,10,0,1,0
16,175,175,10,10,0,1,0
5,183,183,3,3,0,1,0
2,190,190,13,1,12,2,1
25,213,213,44,22,22,3,2
9,217,217,100,8,92,3,2
24,254,254,10,10,0,1,0
10,271,271,113,79,34,3,2
27,288,288,4,1,3,2,1
19,296,296,66,66,0,1,0
6,297,297,65,65,0,1,0
12,321,321,3,3,0,1,0
22,331,331,60,60,0,1,0
0,339,339,14,14,0,1,0
15,342,342,60,60,0,1,0
23,344,344,26,16,10,2,1
26,354,354,1,1,0,1,0
8,370,370,36,36,0,1,0
13,412,412,23,20,3,2,1
20,429,429,79,4,75,4,3
11,450,450,45,4,41,2,1
17,453,453,31,31,0,1,0
7,457,457,25,25,0,1,0
18,468,468,61,61,0,1,0
14,474,474,15,4,11,2,1
21,480,480,76,63,13,2,1

17,132,132,3,3,0,1,0
8,144,144,3,3,0,1,0
10,145,145,3,3,0,1,0
5,150,150,9,6,3,2,1
26,213,213,69,69,0,1,0
3,222,222,69,69,0,1,0
15,226,226,11,11,0,1,0
25,228,228,10,10,0,1,0
27,247,247,22,10,12,3,2
4,250,250,20,7,13,2,1
9,278,278,42,42,0,1,0
20,290,290,49,13,36,2,1
1,306,306,16,16,0,1,0
6,332,332,19,7,12,3,2
13,342,342,59,35,24,3,2
24,366,366,6,6,0,1,0
23,394,394,36,31,5,2,1
14,397,397,9,9,0,1,0
16,407,407,120,100,20,2,1
18,408,408,81,58,23,4,3
11,414,414,144,8,136,4,3
12,416,416,35,35,0,1,0
21,420,420,16,1,15,2,1
2,441,441,63,9,54,3,2
0,445,445,81,31,50,4,3
19,464,464,1,1,0,1,0
7,488,488,86,66,20,3,2
22,499,499,6,6,0,1,0

23,120,120,8,8,0,1,0
8,168,168,25,25,0,1,0
7,177,177,26,8,18,3,2
0,201,201,26,14,12,3,2
25,210,210,3,3,0,1,0
30,239,239,6,3,3,2,1
26,258,258,87,35,52,3,2
20,273,273,27,13,14,3,2
28,297,297,7,7,0,1,0
19,308,308,22,3,19,2,1
2,320,320,1,1,0,1,0
5,320,320,24,24,0,1,0
13,325,325,87,87,0,1,0
15,334,334,58,58,0,1,0
21,351,351,41,33,8,2,1
22,351,351,26,26,0,1,0
14,355,355,16,8,8,2,1
10,390,390,2,2,0,1,0
9,397,397,37,37,0,1,0
18,418,418,136,136,0,1,0
3,421,421,12,12,0,1,0
1,438,438,31,31,0,1,0
27,444,444,29,29,0,1,0
6,447,447,103,82,21,2,1
11,455,455,108,42,66,4,3
4,467,467,49,49,0,1,0
16,470,470,42,42,0,1,0
17,483,483,9,3,6,2,1
29,484,484,28,28,0,1,0
12,490,490,8,8,0,1,0
24,492,492,34,8,26,3,2

34,111,111,6,6,0,1,0
17,127,127,4,4,0,1,0
29,130,130,3,3,0,1,0
10,134,134,11,5,6,3,2
27,140,140,8,5,3,2,1
6,142,142,12,12,0,1,0
8,166,166,11,2,9,2,1
41,170,170,15,2,13,2,1
2,186,186,16,2,14,2,1
35,187,187,30,30,0,1,0
14,187,187,9,3,6,3,2
12,193,193,4,4,0,1,0
31,199,199,6,1,5,2,1
0,207,207,26,26,0,1,0
3,217,217,6,6,0,1,0
38,230,230,23,23,0,1,0
22,247,247,25,16,9,2,1
5,288,288,1,1,0,1,0
36,303,303,6,6,0,1,0
33,303,303,35,15,20,3,2
15,323,323,4,4,0,1,0
37,324,324,145,63,82,3,2
32,334,334,14,1,13,2,1
30,336,336,110,97,13,4,3
21,345,345,40,12,28,2,1
24,347,347,6,1,5,2,1
16,348,348,5,2,3,2,1
20,362,362,23,23,0,1,0
18,375,375,1,1,0,1,0
40,380,380,2,2,0,1,0
13,386,386,49,13,36,2,1
19,407,407,64,64,0,1,0
11,417,417,26,20,6,2,1
9,419,419,9,3,6,2,1
25,419,419,4,4,0,1,0
1,425,425,50,50,0,1,0
7,428,428,36,6,30,2,1
28,462,462,4,4,0,1,0
4,465,465,48,12,36,4,3
26,467,467,24,18,6,2,1
39,481,481,54,54,0,1,0
23,500,500,8,8,0,1,0

19,103,103,2,2,0,1,0
3,126,126,50,50,0,1,0
18,159,159,28,2,26,3,2
25,202,202,41,41,0,1,0
0,233,233,2,2,0,1,0
11,249,249,17,5,12,2,1
22,263,263,4,4,0,1,0
5,308,308,6,1,5,2,1
7,318,318,112,13,99,4,3
4,322,322,16,16,0,1,0
16,331,331,43,43,0,1,0
14,341,341,12,12,0,1,0
8,349,349,31,10,21,2,1
21,361,361,89,35,54,3,2
6,382,382,49,49,0,1,0
12,389,389,120,97,23,2,1
10,393,393,5,1,4,2,1
24,394,394,18,18,0,1,0
1,403,403,56,8,48,3,2
2,407,407,10,10,0,1,0
20,416,416,9,9,0,1,0
23,420,420,3,3,0,1,0
13,451,451,90,90,0,1,0
15,472,472,1,1,0,1,0
17,482,482,67,67,0,1,0
9,495,495,195,195,0,1,0

11,139,139,2,2,0,1,0
9,160,160,18,4,14,3,2
21,172,172,4,4,0,1,0
4,183,183,79,25,54,3,2
19,203,203,34,34,0,1,0
26,228,228,13,1,12,4,3
23,252,252,98,63,35,3,2
0,257,257,3,3,0,1,0
12,271,271,7,7,0,1,0
3,290,290,98,92,6,2,1
1,300,300,29,11,18,4,3
17,315,315,28,16,12,3,2
8,326,326,34,34,0,1,0
20,345,345,31,31,0,1,0
14,352,352,24,24,0,1,0
22,363,363,2,2,0,1,0
15,368,368,28,28,0,1,0
2,383,383,2,2,0,1,0
5,407,407,70,31,39,2,1
10,412,412,44,1,43,2,1
7,415,415,81,36,45,2,1
16,418,418,18,8,10,3,2
18,423,423,68,53,15,4,3
6,457,457,12,12,0,1,0
13,463,463,83,37,46,4,3
24,477,477,16,16,0,1,0
25,497,497,98,31,67,4,3

27,100,100,2,2,0,1,0
16,131,131,15,15,0,1,0
25,142,142,18,3,15,4,3
15,166,166,10,10,0,1,0
24,178,178,2,2,0,1,0
26,186,186,25,19,6,3,2
0,188,188,86,22,64,4,3
6,189,189,1,1,0,1,0
1,200,200,11,3,8,3,2
20,200,200,23,6,17,2,1
7,233,233,80,60,20,2,1
4,252,252,1,1,0,1,0
23,266,266,83,30,53,4,3
29,292,292,4,4,0,1,0
5,297,297,9,9,0,1,0
10,320,320,17,12,5,2,1
13,331,331,63,35,28,3,2
11,347,347,1,1,0,1,0
9,347,347,43,43,0,1,0
22,349,349,16,16,0,1,0
19,392,392,14,14,0,1,0
3,410,410,95,53,42,4,3
12,415,415,7,7,0,1,0
14,425,425,156,36,120,4,3
21,448,448,5,1,4,2,1
28,448,448,64,16,48,2,1
17,474,474,53,53,0,1,0
2,474,474,23,23,0,1,0
8,480,480,19,14,5,2,1
18,498,498,9,9,0,1,0

24,113,113,7,7,0,1,0
13,131,131,24,24,0,1,0
30,131,131,5,5,0,1,0
21,137,137,19,19,0,1,0
11,139,139,7,7,0,1,0
33,172,172,1,1,0,1,0
7,178,178,15,15,0,1,0
29,205,205,73,36,37,2,1
27,237,237,5,5,0,1,0
28,248,248,2,2,0,1,0
10,250,250,1,1,0,1,0
34,270,270,34,4,30,4,3
36,286,286,14,5,9,2,1
2,302,302,38,38,0,1,0
18,303,303,1,1,0,1,0
8,308,308,37,37,0,1,0
37,318,318,133,67,66,4,3
4,324,324,4,4,0,1,0
3,335,335,45,45,0,1,0
22,355,355,9,1,8,3,2
12,357,357,13,13,0,1,0
16,379,379,79,31,48,4,3
17,390,390,20,20,0,1,0
23,392,392,10,10,0,1,0
32,392,392,115,70,45,4,3
5,403,403,33,33,0,1,0
31,405,405,10,10,0,1,0
1,415,415,45,45,0,1,0
9,415,415,7,7,0,1,0
14,423,423,4,4,0,1,0
6,423,423,25,25,0,1,0
25,434,434,21,4,17,2,1
15,450,450,49,13,36,3,2
19,460,460,11,11,0,1,0
0,461,461,15,3,12,4,3
20,471,471,3,3,0,1,0
26,490,490,27,27,0,1,0
35,496,496,35,35,0,1,0

19,107,107,39,39,0,1,0
24,107,107,15,15,0,1,0
4,120,120,1,1,0,1,0
29,129,129,4,4,0,1,0
28,141,141,7,1,6,2,1
27,148,148,45,9,36,2,1
16,152,152,63,63,0,1,0
30,168,168,17,7,10,2,1
17,194,194,13,10,3,2,1
3,196,196,2,2,0,1,0
26,201,201,6,3,3,2,1
0,210,210,41,5,36,3,2
34,222,222,3,3,0,1,0
18,243,243,6,3,3,2,1
1,252,252,23,23,0,1,0
20,274,274,33,33,0,1,0
10,297,297,45,45,0,1,0
13,309,309,10,6,4,2,1
25,310,310,25,25,0,1,0
8,310,310,20,20,0,1,0
32,332,332,13,2,11,3,2
23,338,338,43,43,0,1,0
2,340,340,17,6,11,2,1
11,342,342,29,14,15,4,3
7,374,374,21,21,0,1,0
14,380,380,55,19,36,3,2
33,390,390,29,29,0,1,0
9,399,399,57,30,27,4,3
5,403,403,4,1,3,2,1
15,412,412,12,12,0,1,0
21,414,414,1,1,0,1,0
22,430,430,40,32,8,3,2
12,437,437,5,5,0,1,0
31,442,442,32,13,19,2,1
6,446,446,6,6,0,1,0

12,145,145,5,5,0,1,0
19,152,152,1,1,0,1,0
13,189,189,15,15,0,1,0
4,201,201,55,55,0,1,0
3,202,202,6,6,0,1,0
2,266,266,42,34,8,2,1
10,274,274,32,32,0,1,0
1,311,311,15,15,0,1,0
9,316,316,60,15,45,2,1
5,318,318,21,2,19,2,1
0,326,326,18,18,0,1,0
23,326,326,34,25,9,4,3
25,327,327,48,48,0,1,0
18,331,331,32,32,0,1,0
17,338,338,30,12,18,2,1
20,350,350,43,43,0,1,0
22,381,381,4,4,0,1,0
14,387,387,63,48,15,2,1
16,397,397,89,78,11,2,1
8,406,406,8,8,0,1,0
21,423,423,74,47,27,4,3
7,452,452,81,69,12,4,3
26,464,464,27,18,9,4,3
15,465,465,45,45,0,1,0
11,470,470,35,35,0,1,0
6,470,470,218,131,87,4,3
24,473,473,72,72,0,1,0

18,113,113,1,1,0,1,0
28,115,115,39,35,4,2,1
7,136,136,40,40,0,1,0
12,166,166,67,49,18,4,3
4,181,181,14,2,12,3,2
20,191,191,11,7,4,2,1
8,201,201,28,4,24,3,2
25,212,212,20,20,0,1,0
9,213,213,21,3,18,4,3
13,218,218,8,8,0,1,0
6,226,226,31,24,7,2,1
11,227,227,1,1,0,1,0
5,238,238,8,4,4,2,1
3,244,244,17,2,15,4,3
2,261,261,22,22,0,1,0
21,308,308,17,7,10,2,1
17,314,314,1,1,0,1,0
24,315,315,24,3,21,4,3
15,320,320,18,18,0,1,0
16,334,334,67,67,0,1,0
22,358,358,80,66,14,2,1
1,383,383,6,3,3,2,1
27,384,384,26,26,0,1,0
14,425,425,24,24,0,1,0
23,437,437,82,37,45,4,3
10,449,449,103,103,0,1,0
0,454,454,8,8,0,1,0
19,469,469,35,35,0,1,0
26,473,473,44,11,33,4,3

25,111,111,7,7,0,1,0
13,118,118,6,6,0,1,0
3,118,118,7,7,0,1,0
34,140,140,35,29,6,2,1
19,154,154,13,8,5,2,1
5,159,159,7,7,0,1,0
23,212,212,13,13,0,1,0
14,251,251,50,50,0,1,0
18,280,280,34,20,14,3,2
22,295,295,12,9,3,2,1
29,307,307,66,41,25,4,3
35,325,325,73,13,60,4,3
0,332,332,5,5,0,1,0
30,339,339,4,4,0,1,0
6,379,379,7,7,0,1,0
1,393,393,1,1,0,1,0
8,394,394,18,18,0,1,0
24,396,396,37,37,0,1,0
26,410,410,3,3,0,1,0
10,420,420,22,13,9,4,3
32,426,426,75,75,0,1,0
33,427,427,41,14,27,2,1
7,428,428,32,18,14,4,3
31,430,430,73,37,36,4,3
9,436,436,15,15,0,1,0
17,442,442,15,1,14,3,2
20,445,445,50,50,0,1,0
21,448,448,6,6,0,1,0
27,458,458,16,4,12,2,1
16,459,459,91,47,44,4,3
2,460,460,52,52,0,1,0
12,466,466,14,14,0,1,0
28,467,467,27,27,0,1,0
15,479,479,3,3,0,1,0
11,489,489,172,127,45,4,3
4,491,491,32,5,27,4,3

28,124,124,10,2,8,2,1
39,136,136,1,1,0,1,0
12,164,164,6,2,4,2,1
30,173,173,61,61,0,1,0
10,180,180,39,39,0,1,0
24,191,191,12,4,8,2,1
31,214,214,47,47,0,1,0
20,217,217,1,1,0,1,0
34,220,220,22,22,0,1,0
23,220,220,4,1,3,2,1
14,233,233,40,8,32,3,2
7,239,239,38,38,0,1,0
2,249,249,2,2,0,1,0
3,259,259,2,2,0,1,0
8,273,273,1,1,0,1,0
32,273,273,15,15,0,1,0
17,276,276,1,1,0,1,0
15,277,277,1,1,0,1,0
26,290,290,40,40,0,1,0
25,294,294,17,2,15,4,3
6,314,314,11,1,10,4,3
16,315,315,34,12,22,2,1
36,324,324,42,42,0,1,0
27,324,324,12,8,4,2,1
19,349,349,29,29,0,1,0
5,379,379,18,14,4,2,1
4,401,401,32,26,6,2,1
1,403,403,11,11,0,1,0
33,404,404,43,2,41,2,1
18,409,409,23,23,0,1,0
38,417,417,17,17,0,1,0
0,420,420,81,51,30,3,2
11,444,444,57,57,0,1,0
35,459,459,33,33,0,1,0
22,464,464,8,8,0,1,0
9,469,469,73,73,0,1,0
21,473,473,2,2,0,1,0
37,480,480,84,84,0,1,0
13,481,481,16,16,0,1,0
29,492,492,1,1,0,1,0

13,103,103,22,22,0,1,0
4,112,112,1,1,0,1,0
29,132,132,9,1,8,3,2
26,140,140,24,4,20,2,1
3,197,197,7,3,4,2,1
24,206,206,36,36,0,1,0
32,215,215,29,29,0,1,0
27,225,225,7,4,3,2,1
30,230,230,8,8,0,1,0
21,232,232,22,5,17,2,1
33,241,241,14,14,0,1,0
8,244,244,9,1,8,2,1
9,247,247,1,1,0,1,0
2,249,249,43,4,39,2,1
5,251,251,7,1,6,3,2
25,256,256,1,1,0,1,0
22,269,269,103,75,28,3,2
0,301,301,30,30,0,1,0
15,353,353,10,10,0,1,0
7,388,388,68,68,0,1,0
17,392,392,17,17,0,1,0
23,401,401,33,33,0,1,0
10,403,403,64,64,0,1,0
6,414,414,4,4,0,1,0
31,420,420,8,8,0,1,0
16,422,422,2,2,0,1,0
12,428,428,42,42,0,1,0
20,430,430,67,67,0,1,0
28,455,455,7,3,4,2,1
11,463,463,42,24,18,4,3
19,484,484,56,56,0,1,0
14,485,485,140,140,0,1,0
1,493,493,52,52,0,1,0
18,498,498,43,43,0,1,0

0,103,103,13,13,0,1,0
14,110,110,42,42,0,1,0
6,120,120,35,13,22,3,2
23,158,158,7,7,0,1,0
20,159,159,1,1,0,1,0
8,168,168,28,28,0,1,0
7,172,172,13,13,0,1,0
28,184,184,15,1,14,2,1
29,185,185,26,26,0,1,0
18,191,191,2,2,0,1,0
1,243,243,4,4,0,1,0
17,245,245,51,9,42,3,2
4,248,248,4,4,0,1,0
3,273,273,4,1,3,2,1
12,287,287,8,8,0,1,0
13,289,289,7,1,6,2,1
2,289,289,39,29,10,2,1
5,323,323,34,18,16,2,1
10,340,340,1,1,0,1,0
21,354,354,14,10,4,2,1
22,360,360,66,57,9,2,1
15,368,368,15,15,0,1,0
25,375,375,32,32,0,1,0
30,377,377,26,20,6,2,1
19,387,387,61,33,28,3,2
11,419,419,73,49,24,4,3
9,422,422,21,21,0,1,0
27,456,456,16,4,12,4,3
26,463,463,66,21,45,2,1
24,485,485,178,118,60,3,2
16,497,497,8,4,4,2,1

27,106,106,11,1,10,2,1
7,145,145,9,9,0,1,0
16,154,154,3,3,0,1,0
6,169,169,1,1,0,1,0
31,201,201,21,21,0,1,0
32,222,222,9,9,0,1,0
28,230,230,33,33,0,1,0
19,233,233,3,3,0,1,0
20,251,251,10,2,8,2,1
17,256,256,7,1,6,2,1
2,285,285,12,12,0,1,0
9,288,288,35,35,0,1,0
15,290,290,7,7,0,1,0
13,299,299,9,6,3,2,1
18,304,304,6,6,0,1,0
29,317,317,26,26,0,1,0
25,317,317,20,20,0,1,0
23,324,324,33,33,0,1,0
8,334,334,65,23,42,4,3
10,359,359,16,16,0,1,0
4,365,365,10,10,0,1,0
35,371,371,7,7,0,1,0
26,373,373,99,54,45,4,3
39,381,381,28,14,14,2,1
3,381,381,1,1,0,1,0
22,381,381,21,21,0,1,0
38,405,405,17,1,16,4,3
37,415,415,26,26,0,1,0
21,422,422,60,4,56,3,2
11,426,426,69,45,24,2,1
33,431,431,34,12,22,3,2
5,435,435,2,2,0,1,0
1,436,436,4,4,0,1,0
12,450,450,20,20,0,1,0
0,471,471,67,67,0,1,0
30,471,471,16,6,10,3,2
34,471,471,197,197,0,1,0
24,483,483,32,32,0,1,0
14,499,499,132,105,27,4,3
36,499,499,15,12,3,2,1

28,124,124,19,15,4,2,1
6,134,134,5,5,0,1,0
15,141,141,4,4,0,1,0
19,144,144,17,5,12,3,2
8,168,168,1,1,0,1,0
0,172,172,18,9,9,4,3
22,187,187,40,36,4,2,1
25,211,211,43,43,0,1,0
5,240,240,70,58,12,4,3
11,242,242,10,10,0,1,0
1,246,246,1,1,0,1,0
12,255,255,11,7,4,2,1
7,277,277,6,2,4,2,1
9,283,283,45,5,40,2,1
16,302,302,30,24,6,2,1
20,352,352,71,71,0,1,0
17,356,356,9,9,0,1,0
14,360,360,7,3,4,2,1
10,377,377,37,37,0,1,0
2,380,380,204,123,81,4,3
3,389,389,2,2,0,1,0
26,409,409,8,8,0,1,0
29,417,417,23,23,0,1,0
24,422,422,27,27,0,1,0
18,427,427,43,15,28,3,2
27,429,429,9,9,0,1,0
4,431,431,100,50,50,3,2
21,433,433,63,8,55,4,3
13,454,454,9,9,0,1,0
23,487,487,81,51,30,3,2

13,100,100,1,1,0,1,0
6,102,102,18,18,0,1,0
11,127,127,2,2,0,1,0
33,136,136,1,1,0,1,0
24,141,141,16,6,10,2,1
30,145,145,38,20,18,3,2
0,159,159,26,26,0,1,0
35,160,160,11,11,0,1,0
29,163,163,59,29,30,3,2
9,165,165,5,5,0,1,0
4,172,172,9,5,4,2,1
22,176,176,35,35,0,1,0
39,185,185,2,2,0,1,0
19,210,210,45,24,21,2,1
25,212,212,5,5,0,1,0
37,225,225,22,7,15,2,1
7,230,230,8,8,0,1,0
32,240,240,42,23,19,2,1
3,268,268,16,16,0,1,0
2,271,271,6,6,0,1,0
15,275,275,1,1,0,1,0
18,280,280,36,36,0,1,0
20,289,289,17,17,0,1,0
14,294,294,1,1,0,1,0
26,312,312,4,1,3,2,1
38,314,314,27,15,12,4,3
36,316,316,7,7,0,1,0
28,323,323,31,5,26,3,2
17,328,328,1,1,0,1,0
12,336,336,34,10,24,2,1
21,340,340,20,4,16,3,2
27,342,342,66,11,55,4,3
8,344,344,3,3,0,1,0
10,351,351,28,8,20,2,1
16,405,405,8,8,0,1,0
5,425,425,49,49,0,1,0
1,438,438,3,3,0,1,0
34,438,438,21,21,0,1,0
23,450,450,16,16,0,1,0
31,476,476,31,7,24,3,2

22,102,102,11,11,0,1,0
5,138,138,3,3,0,1,0
13,143,143,8,8,0,1,0
20,175,175,12,8,4,2,1
27,176,176,6,6,0,1,0
10,182,182,18,6,12,3,2
16,194,194,14,4,10,3,2
7,195,195,16,4,12,3,2
9,206,206,18,18,0,1,0
0,214,214,8,8,0,1,0
21,216,216,49,34,15,4,3
29,220,220,4,4,0,1,0
24,259,259,25,9,16,3,2
23,273,273,11,1,10,3,2
17,277,277,43,43,0,1,0
33,291,291,9,9,0,1,0
6,296,296,3,3,0,1,0
11,305,305,10,10,0,1,0
18,316,316,20,8,12,3,2
1,334,334,29,29,0,1,0
35,344,344,2,2,0,1,0
8,344,344,2,2,0,1,0
4,349,349,1,1,0,1,0
26,351,351,17,2,15,4,3
32,351,351,172,96,76,3,2
15,380,380,97,73,24,3,2
12,384,384,68,68,0,1,0
31,385,385,27,5,22,2,1
28,398,398,50,50,0,1,0
25,413,413,9,5,4,2,1
2,424,424,26,26,0,1,0
34,434,434,6,6,0,1,0
14,435,435,66,50,16,3,2
19,440,440,23,23,0,1,0
30,451,451,105,21,84,3,2
3,488,488,44,44,0,1,0

25,125,125,37,4,33,2,1
4,156,156,4,4,0,1,0
30,187,187,4,1,3,2,1
19,194,194,12,12,0,1,0
11,196,196,16,16,0,1,0
13,257,257,53,53,0,1,0
1,259,259,79,79,0,1,0
18,268,268,8,8,0,1,0
15,279,279,21,21,0,1,0
12,280,280,20,20,0,1,0
16,286,286,25,6,19,2,1
29,288,288,12,5,7,2,1
24,325,325,14,14,0,1,0
17,328,328,16,16,0,1,0
3,353,353,73,1,72,4,3
23,353,353,7,7,0,1,0
8,359,359,66,39,27,4,3
20,363,363,30,9,21,2,1
10,393,393,48,48,0,1,0
2,415,415,23,11,12,3,2
9,422,422,2,2,0,1,0
27,437,437,143,143,0,1,0
21,451,451,96,24,72,3,2
14,451,451,33,33,0,1,0
0,454,454,40,40,0,1,0
22,470,470,4,4,0,1,0
26,476,476,84,49,35,2,1
7,490,490,5,5,0,1,0
28,496,496,48,48,0,1,0
5,498,498,72,45,27,2,1
6,500,500,11,11,0,1,0

3,100,100,1,1,0,1,0
9,111,111,8,8,0,1,0
15,122,122,24,24,0,1,0
27,122,122,2,2,0,1,0
7,128,128,16,10,6,2,1
19,132,132,20,5,15,4,3
21,138,138,12,12,0,1,0
28,155,155,36,36,0,1,0
30,223,223,32,2,30,4,3
14,227,227,64,64,0,1,0
10,231,231,57,57,0,1,0
29,241,241,41,41,0,1,0
24,253,253,24,8,16,3,2
26,255,255,14,8,6,3,2
6,259,259,22,6,16,2,1
22,292,292,45,11,34,2,1
23,292,292,12,12,0,1,0
8,323,323,17,17,0,1,0
5,326,326,84,74,10,2,1
11,328,328,31,1,30,4,3
2,366,366,13,13,0,1,0
0,380,380,28,10,18,3,2
18,388,388,3,3,0,1,0
12,419,419,30,2,28,2,1
25,425,425,3,3,0,1,0
16,436,436,41,27,14,2,1
13,459,459,52,4,48,2,1
1,464,464,5,5,0,1,0
17,470,470,51,9,42,4,3
4,473,473,34,22,12,2,1
20,485,485,39,23,16,2,1

8,114,114,5,5,0,1,0
11,123,123,23,15,8,2,1
26,126,126,18,3,15,4,3
5,151,151,12,12,0,1,0
27,163,163,3,3,0,1,0
21,186,186,13,13,0,1,0
6,200,200,15,7,8,2,1
4,211,211,16,16,0,1,0
20,211,211,16,16,0,1,0
32,234,234,22,15,7,2,1
17,246,246,7,7,0,1,0
31,250,250,61,7,54,3,2
2,254,254,34,34,0,1,0
15,259,259,1,1,0,1,0
30,280,280,1,1,0,1,0
12,288,288,8,8,0,1,0
9,312,312,7,7,0,1,0
23,332,332,142,84,58,3,2
16,346,346,15,4,11,4,3
10,358,358,15,2,13,3,2
25,363,363,26,14,12,3,2
3,384,384,34,34,0,1,0
0,386,386,11,5,6,2,1
19,422,422,12,12,0,1,0
14,434,434,44,4,40,4,3
13,438,438,27,22,5,2,1
29,439,439,12,12,0,1,0
22,446,446,104,70,34,2,1
18,459,459,26,26,0,1,0
28,472,472,17,17,0,1,0
1,483,483,143,42,101,4,3
7,491,491,143,45,98,4,3
24,498,498,36,36,0,1,0

11,114,114,11,11,0,1,0
27,153,153,7,7,0,1,0
21,154,154,1,1,0,1,0
28,179,179,24,19,5,2,1
24,183,183,10,10,0,1,0
19,183,183,10,10,0,1,0
32,184,184,10,10,0,1,0
3,221,221,21,21,0,1,0
31,232,232,87,87,0,1,0
16,235,235,7,7,0,1,0
5,243,243,36,36,0,1,0
6,244,244,21,7,14,2,1
7,258,258,9,9,0,1,0
10,270,270,51,25,26,3,2
17,286,286,31,31,0,1,0
12,293,293,30,30,0,1,0
4,304,304,10,10,0,1,0
29,324,324,37,37,0,1,0
14,331,331,5,5,0,1,0
13,338,338,7,7,0,1,0
8,347,347,72,72,0,1,0
30,354,354,28,23,5,2,1
20,366,366,48,15,33,4,3
2,370,370,142,13,129,4,3
26,399,399,16,16,0,1,0
15,408,408,51,7,44,2,1
1,417,417,4,4,0,1,0
18,422,422,15,3,12,3,2
25,428,428,76,4,72,3,2
9,429,429,7,7,0,1,0
0,468,468,5,5,0,1,0
22,475,475,7,7,0,1,0
23,483,483,98,29,69,4,3

8,111,111,32,32,0,1,0
7,119,119,25,1,24,4,3
1,141,141,3,3,0,1,0
23,158,158,12,12,0,1,0
15,163,163,44,32,12,4,3
12,189,189,8,1,7,2,1
21,195,195,10,10,0,1,0
29,227,227,2,2,0,1,0
17,227,227,77,77,0,1,0
20,228,228,26,18,8,2,1
13,229,229,17,17,0,1,0
14,244,244,10,1,9,2,1
16,270,270,5,5,0,1,0
18,281,281,43,43,0,1,0
32,288,288,2,2,0,1,0
5,298,298,7,7,0,1,0
2,317,317,16,2,14,3,2
10,333,333,2,2,0,1,0
6,333,333,27,27,0,1,0
27,337,337,33,26,7,2,1
19,344,344,21,21,0,1,0
31,356,356,9,9,0,1,0
9,373,373,3,3,0,1,0
0,383,383,33,17,16,4,3
30,389,389,61,61,0,1,0
25,398,398,36,18,18,4,3
3,409,409,62,62,0,1,0
24,415,415,3,3,0,1,0
26,415,415,31,31,0,1,0
11,426,426,27,7,20,3,2
28,444,444,73,35,38,3,2
22,470,470,95,57,38,2,1
4,477,477,80,66,14,3,2

31,106,106,23,23,0,1,0
14,114,114,1,1,0,1,0
29,129,129,7,7,0,1,0
10,130,130,4,4,0,1,0
25,130,130,7,7,0,1,0
30,135,135,19,15,4,2,1
1,143,143,3,3,0,1,0
9,152,152,1,1,0,1,0
33,166,166,4,4,0,1,0
3,168,168,14,14,0,1,0
7,200,200,8,8,0,1,0
18,209,209,1,1,0,1,0
5,221,221,30,30,0,1,0
22,230,230,26,26,0,1,0
36,242,242,9,6,3,2,1
0,255,255,43,43,0,1,0
26,258,258,45,9,36,2,1
17,260,260,17,2,15,4,3
32,277,277,73,73,0,1,0
20,278,278,59,32,27,4,3
2,300,300,18,3,15,4,3
34,304,304,9,3,6,3,2
8,326,326,41,41,0,1,0
11,334,334,7,7,0,1,0
6,359,359,1,1,0,1,0
21,383,383,10,5,5,2,1
16,385,385,14,6,8,2,1
12,396,396,48,4,44,3,2
28,417,417,9,1,8,3,2
27,438,438,91,55,36,4,3
24,444,444,89,89,0,1,0
15,460,460,92,42,50,3,2
4,464,464,23,23,0,1,0
23,475,475,35,35,0,1,0
19,483,483,72,16,56,3,2
13,498,498,29,11,18,3,2
35,500,500,4,4,0,1,0

5,115,115,1,1,0,1,0
27,122,122,14,2,12,3,2
7,127,127,7,7,0,1,0
20,146,146,13,8,5,2,1
0,176,176,2,2,0,1,0
18,202,202,6,6,0,1,0
32,213,213,25,13,12,3,2
24,223,223,15,15,0,1,0
2,224,224,60,60,0,1,0
15,231,231,5,1,4,2,1
11,238,238,14,5,9,3,2
12,243,243,2,2,0,1,0
30,261,261,1,1,0,1,0
14,264,264,48,16,32,2,1
22,270,270,69,69,0,1,0
8,281,281,8,3,5,2,1
33,285,285,37,37,0,1,0
31,290,290,2,2,0,1,0
28,300,300,116,88,28,2,1
17,301,301,20,2,18,4,3
16,310,310,94,42,52,4,3
4,321,321,56,56,0,1,0
26,331,331,52,24,28,3,2
13,336,336,8,8,0,1,0
6,336,336,38,38,0,1,0
29,344,344,20,4,16,3,2
25,350,350,23,10,13,2,1
23,363,363,3,3,0,1,0
21,403,403,8,5,3,2,1
10,416,416,14,14,0,1,0
9,428,428,45,27,18,2,1
19,443,443,22,22,0,1,0
34,464,464,45,35,10,2,1
3,472,472,7,7,0,1,0
1,475,475,45,45,0,1,0

28,134,134,6,1,5,2,1
5,152,152,10,10,0,1,0
26,175,175,21,21,0,1,0
3,222,222,25,25,0,1,0
14,231,231,9,2,7,3,2
7,248,248,19,7,12,3,2
10,259,259,13,13,0,1,0
33,268,268,40,40,0,1,0
13,272,272,30,18,12,4,3
15,291,291,1,1,0,1,0
25,292,292,34,34,0,1,0
20,307,307,19,19,0,1,0
32,312,312,36,36,0,1,0
6,313,313,7,7,0,1,0
21,316,316,12,4,8,2,1
27,318,318,1,1,0,1,0
31,320,320,14,14,0,1,0
9,321,321,19,19,0,1,0
24,325,325,25,21,4,2,1
16,334,334,14,14,0,1,0
8,339,339,4,1,3,2,1
1,352,352,38,38,0,1,0
12,357,357,115,115,0,1,0
0,369,369,79,79,0,1,0
2,372,372,51,2,49,2,1
30,374,374,2,2,0,1,0
11,407,407,52,24,28,3,2
17,425,425,13,13,0,1,0
22,427,427,11,3,8,3,2
23,458,458,5,5,0,1,0
19,467,467,113,95,18,4,3
29,478,478,164,98,66,3,2
4,484,484,33,26,7,2,1
18,496,496,112,55,57,4,3

20,102,102,27,5,22,3,2
33,146,146,3,3,0,1,0
16,157,157,1,1,0,1,0
6,187,187,13,3,10,3,2
26,189,189,8,8,0,1,0
10,202,202,18,10,8,3,2
9,209,209,77,68,9,4,3
17,231,231,11,11,0,1,0
1,240,240,48,48,0,1,0
29,278,278,13,13,0,1,0
15,279,279,6,6,0,1,0
2,287,287,27,27,0,1,0
23,314,314,9,9,0,1,0
3,314,314,41,17,24,4,3
13,317,317,3,3,0,1,0
11,333,333,23,23,0,1,0
30,343,343,31,23,8,3,2
12,344,344,61,1,60,3,2
24,350,350,31,5,26,3,2
19,353,353,30,4,26,3,2
22,364,364,16,6,10,2,1
0,395,395,43,17,26,2,1
18,408,408,7,7,0,1,0
8,410,410,14,14,0,1,0
21,439,439,8,8,0,1,0
4,449,449,38,5,33,2,1
28,465,465,11,11,0,1,0
5,466,466,18,18,0,1,0
32,466,466,278,220,58,4,3
7,470,470,7,7,0,1,0
25,474,474,23,23,0,1,0
31,485,485,70,12,58,3,2
14,490,490,18,18,0,1,0
27,499,499,35,10,25,2,1

15,109,109,16,8,8,2,1
6,117,117,5,5,0,1,0
14,127,127,3,3,0,1,0
23,132,132,9,9,0,1,0
4,133,133,2,2,0,1,0
20,142,142,7,1,6,2,1
25,149,149,28,16,12,2,1
30,149,149,64,14,50,2,1
9,154,154,4,4,0,1,0
27,163,163,18,18,0,1,0
0,167,167,29,29,0,1,0
21,174,174,6,6,0,1,0
19,175,175,9,9,0,1,0
3,192,192,35,35,0,1,0
22,194,194,12,5,7,2,1
17,196,196,5,5,0,1,0
31,201,201,6,2,4,2,1
33,202,202,53,22,31,2,1
7,210,210,4,4,0,1,0
28,225,225,32,6,26,3,2
26,225,225,15,4,11,2,1
16,227,227,57,57,0,1,0
11,247,247,40,40,0,1,0
5,281,281,9,3,6,2,1
29,284,284,10,10,0,1,0
2,286,286,7,7,0,1,0
18,287,287,13,13,0,1,0
36,345,345,19,7,12,2,1
10,349,349,32,32,0,1,0
8,374,374,12,12,0,1,0
32,376,376,16,2,14,3,2
35,378,378,23,23,0,1,0
34,392,392,19,4,15,2,1
12,457,457,1,1,0,1,0
1,467,467,8,8,0,1,0
13,468,468,89,65,24,3,2
24,495,495,1,1,0,1,0

14,112,112,2,2,0,1,0
11,149,149,11,11,0,1,0
5,152,152,4,1,3,2,1
31,158,158,28,6,22,2,1
19,159,159,33,33,0,1,0
30,162,162,11,4,7,2,1
15,181,181,16,16,0,1,0
12,204,204,34,8,26,3,2
24,208,208,7,4,3,2,1
1,216,216,7,1,6,3,2
2,221,221,12,12,0,1,0
13,243,243,43,43,0,1,0
4,283,283,30,30,0,1,0
23,297,297,1,1,0,1,0
7,315,315,19,13,6,2,1
0,324,324,1,1,0,1,0
17,348,348,2,2,0,1,0
27,351,351,61,12,49,2,1
20,351,351,21,14,7,2,1
9,360,360,5,5,0,1,0
29,367,367,39,39,0,1,0
16,372,372,81,22,59,4,3
25,378,378,117,61,56,3,2
33,380,380,70,4,66,4,3
21,386,386,7,7,0,1,0
18,390,390,24,14,10,2,1
26,411,411,1,1,0,1,0
8,432,432,10,10,0,1,0
3,437,437,96,57,39,2,1
10,437,437,65,24,41,2,1
22,439,439,35,35,0,1,0
28,457,457,43,43,0,1,0
6,463,463,77,77,0,1,0
32,486,486,23,3,20,2,1

27,103,103,5,1,4,2,1
12,109,109,5,2,3,2,1
16,116,116,2,2,0,1,0
13,131,131,1,1,0,1,0
0,151,151,3,3,0,1,0
23,153,153,8,8,0,1,0
35,159,159,69,69,0,1,0
5,167,167,6,6,0,1,0
28,177,177,27,18,9,4,3
24,178,178,22,12,10,2,1
9,178,178,11,11,0,1,0
18,195,195,3,3,0,1,0
22,225,225,10,10,0,1,0
17,228,228,4,4,0,1,0
33,233,233,19,19,0,1,0
32,236,236,5,2,3,2,1
10,242,242,9,3,6,2,1
14,280,280,11,11,0,1,0
26,321,321,10,10,0,1,0
25,348,348,28,2,26,3,2
7,351,351,78,78,0,1,0
3,354,354,32,24,8,2,1
19,356,356,5,5,0,1,0
2,364,364,39,9,30,4,3
15,366,366,76,76,0,1,0
4,376,376,21,21,0,1,0
29,380,380,36,36,0,1,0
21,382,382,63,34,29,2,1
34,409,409,30,30,0,1,0
8,421,421,23,13,10,3,2
20,427,427,1,1,0,1,0
11,436,436,22,2,20,3,2
1,440,440,213,196,17,4,3
6,441,441,7,2,5,2,1
30,476,476,8,8,0,1,0
31,493,493,107,69,38,3,2

1,114,114,15,15,0,1,0
19,122,122,7,7,0,1,0
7,151,151,1,1,0,1,0
4,181,181,41,41,0,1,0
35,185,185,4,4,0,1,0
6,192,192,4,1,3,2,1
10,197,197,7,2,5,2,1
0,202,202,43,26,17,2,1
24,205,205,32,5,27,2,1
29,212,212,22,22,0,1,0
15,217,217,7,7,0,1,0
5,229,229,22,14,8,3,2
9,231,231,52,52,0,1,0
23,231,231,25,25,0,1,0
26,263,263,13,13,0,1,0
12,267,267,24,24,0,1,0
11,310,310,28,4,24,3,2
25,312,312,68,68,0,1,0
30,327,327,28,28,0,1,0
18,339,339,16,16,0,1,0
32,347,347,18,4,14,4,3
33,368,368,93,9,84,4,3
2,373,373,27,11,16,2,1
8,374,374,9,6,3,2,1
22,386,386,108,75,33,4,3
13,400,400,36,36,0,1,0
27,408,408,7,1,6,3,2
3,420,420,13,4,9,2,1
14,427,427,1,1,0,1,0
28,447,447,13,13,0,1,0
34,447,447,19,19,0,1,0
31,448,448,54,3,51,4,3
17,450,450,48,22,26,3,2
16,486,486,2,2,0,1,0
21,489,489,40,26,14,2,1
20,493,493,5,5,0,1,0

7,132,132,2,2,0,1,0
2,154,154,10,10,0,1,0
13,155,155,4,1,3,2,1
20,178,178,4,1,3,2,1
16,183,183,6,6,0,1,0
27,187,187,16,16,0,1,0
25,203,203,37,2,35,2,1
8,209,209,41,27,14,3,2
15,216,216,6,6,0,1,0
1,222,222,26,7,19,2,1
4,233,233,38,11,27,2,1
21,254,254,3,3,0,1,0
26,257,257,6,6,0,1,0
3,308,308,1,1,0,1,0
17,312,312,3,3,0,1,0
18,317,317,27,27,0,1,0
19,329,329,48,48,0,1,0
11,359,359,47,47,0,1,0
22,361,361,6,2,4,2,1
0,366,366,2,2,0,1,0
14,405,405,87,25,62,4,3
6,408,408,83,68,15,2,1
23,417,417,51,51,0,1,0
24,423,423,52,45,7,2,1
30,425,425,239,211,28,2,1
28,427,427,68,6,62,3,2
9,433,433,55,55,0,1,0
29,438,438,6,2,4,2,1
12,451,451,18,18,0,1,0
5,477,477,45,3,42,3,2
10,498,498,100,10,90,3,2

11,119,119,4,4,0,1,0
21,131,131,16,16,0,1,0
15,150,150,13,13,0,1,0
5,195,195,1,1,0,1,0
27,204,204,3,3,0,1,0
6,246,246,1,1,0,1,0
16,275,275,35,35,0,1,0
24,283,283,2,2,0,1,0
0,295,295,145,129,16,2,1
28,309,309,1,1,0,1,0
1,316,316,14,2,12,4,3
20,354,354,22,14,8,2,1
4,371,371,20,20,0,1,0
8,372,372,46,6,40,3,2
25,374,374,11,3,8,3,2
2,378,378,20,20,0,1,0
9,386,386,69,43,26,3,2
22,394,394,121,101,20,2,1
3,406,406,89,8,81,4,3
17,406,406,22,22,0,1,0
10,410,410,21,3,18,2,1
7,414,414,122,122,0,1,0
12,420,420,20,4,16,2,1
14,428,428,135,76,59,3,2
13,435,435,42,39,3,2,1
26,480,480,10,10,0,1,0
19,489,489,95,95,0,1,0
23,492,492,56,56,0,1,0
18,499,499,35,35,0,1,0

7,105,105,10,4,6,3,2
34,105,105,33,24,9,2,1
16,109,109,3,3,0,1,0
8,110,110,5,5,0,1,0
17,120,120,2,2,0,1,0
18,124,124,4,4,0,1,0
3,147,147,7,7,0,1,0
30,165,165,20,12,8,3,2
21,172,172,9,9,0,1,0
39,189,189,26,1,25,3,2
2,190,190,8,5,3,2,1
12,207,207,18,18,0,1,0
35,209,209,26,3,23,2,1
29,239,239,13,4,9,2,1
23,261,261,7,7,0,1,0
31,280,280,3,3,0,1,0
32,287,287,2,2,0,1,0
9,302,302,56,19,37,2,1
24,303,303,21,9,12,2,1
6,311,311,8,8,0,1,0
15,313,313,18,18,0,1,0
28,326,326,3,3,0,1,0
22,332,332,31,7,24,4,3
33,346,346,7,4,3,2,1
38,353,353,52,52,0,1,0
25,356,356,22,13,9,4,3
13,356,356,36,36,0,1,0
20,367,367,13,1,12,4,3
40,388,388,107,41,66,3,2
37,393,393,22,22,0,1,0
1,406,406,1,1,0,1,0
0,414,414,45,45,0,1,0
14,416,416,14,3,11,2,1
11,416,416,67,4,63,4,3
5,431,431,37,37,0,1,0
36,442,442,3,3,0,1,0
27,452,452,31,7,24,4,3
4,462,462,56,35,21,4,3
26,466,466,100,65,35,4,3
19,482,482,8,8,0,1,0
10,489,489,16,16,0,1,0

34,110,110,7,2,5,2,1
17,118,118,1,1,0,1,0
10,122,122,1,1,0,1,0
28,123,123,1,1,0,1,0
18,126,126,26,12,14,3,2
15,153,153,7,7,0,1,0
30,163,163,1,1,0,1,0
16,165,165,8,8,0,1,0
5,172,172,12,2,10,3,2
24,174,174,19,1,18,2,1
11,190,190,2,2,0,1,0
0,203,203,11,1,10,2,1
29,217,217,68,68,0,1,0
31,260,260,36,27,9,4,3
26,265,265,63,63,0,1,0
12,266,266,4,4,0,1,0
27,278,278,81,7,74,3,2
19,281,281,1,1,0,1,0
9,298,298,15,15,0,1,0
21,317,317,7,7,0,1,0
6,340,340,36,6,30,2,1
14,347,347,19,15,4,2,1
2,366,366,28,28,0,1,0
8,380,380,22,6,16,3,2
3,389,389,7,7,0,1,0
22,392,392,29,29,0,1,0
7,406,406,55,55,0,1,0
20,412,412,9,9,0,1,0
4,415,415,133,52,81,4,3
13,417,417,14,14,0,1,0
32,418,418,45,45,0,1,0
1,422,422,119,43,76,3,2
23,433,433,42,27,15,4,3
25,462,462,6,1,5,2,1
33,473,473,61,15,46,2,1

21,109,109,2,2,0,1,0
1,169,169,33,19,14,2,1
3,193,193,1,1,0,1,0
15,193,193,11,1,10,2,1
25,215,215,32,14,18,4,3
7,243,243,4,4,0,1,0
26,273,273,35,35,0,1,0
10,286,286,1,1,0,1,0
29,297,297,73,4,69,4,3
19,301,301,6,2,4,2,1
5,304,304,33,7,26,2,1
12,307,307,52,34,18,3,2
24,320,320,33,6,27,2,1
22,320,320,28,22,6,3,2
9,326,326,8,8,0,1,0
11,344,344,22,4,18,4,3
13,349,349,5,2,3,2,1
20,377,377,131,113,18,3,2
6,399,399,84,66,18,4,3
8,404,404,30,30,0,1,0
27,414,414,79,79,0,1,0
16,418,418,55,9,46,4,3
14,421,421,2,2,0,1,0
23,439,439,12,2,10,3,2
4,451,451,299,223,76,3,2
28,456,456,7,7,0,1,0
18,467,467,19,7,12,4,3
0,471,471,15,15,0,1,0
2,475,475,8,8,0,1,0
17,492,492,14,14,0,1,0
30,500,500,18,18,0,1,0

5,101,101,3,3,0,1,0
20,109,109,14,14,0,1,0
1,119,119,17,14,3,2,1
19,123,123,11,3,8,3,2
22,129,129,2,2,0,1,0
4,142,142,3,3,0,1,0
7,166,166,3,3,0,1,0
9,206,206,43,1,42,4,3
17,224,224,19,4,15,2,1
11,235,235,67,3,64,3,2
27,244,244,13,13,0,1,0
16,251,251,38,38,0,1,0
3,259,259,92,40,52,3,2
15,292,292,41,41,0,1,0
14,293,293,17,17,0,1,0
12,307,307,19,5,14,2,1
6,316,316,32,5,27,2,1
23,318,318,109,82,27,4,3
18,333,333,9,6,3,2,1
13,380,380,16,16,0,1,0
21,381,381,87,66,21,4,3
2,389,389,22,9,13,2,1
24,398,398,20,20,0,1,0
10,419,419,2,2,0,1,0
0,450,450,125,86,39,2,1
25,464,464,15,15,0,1,0
26,466,466,58,58,0,1,0
8,486,486,50,14,36,3,2

4,100,100,1,1,0,1,0
36,101,101,3,3,0,1,0
35,112,112,3,3,0,1,0
17,124,124,3,3,0,1,0
2,154,154,1,1,0,1,0
20,157,157,31,13,18,4,3
27,165,165,26,26,0,1,0
5,175,175,3,3,0,1,0
32,189,189,22,8,14,3,2
12,194,194,14,2,12,2,1
1,200,200,17,17,0,1,0
31,211,211,16,16,0,1,0
8,233,233,5,5,0,1,0
25,249,249,21,21,0,1,0
6,250,250,31,22,9,4,3
19,264,264,21,2,19,2,1
22,264,264,1,1,0,1,0
21,271,271,6,6,0,1,0
7,283,283,20,12,8,3,2
38,302,302,7,7,0,1,0
39,309,309,64,25,39,4,3
10,310,310,34,8,26,3,2
24,312,312,12,12,0,1,0
9,332,332,13,13,0,1,0
29,343,343,7,7,0,1,0
16,353,353,2,2,0,1,0
34,369,369,94,50,44,2,1
18,382,382,5,5,0,1,0
30,384,384,56,44,12,4,3
13,391,391,41,6,35,2,1
33,392,392,10,1,9,4,3
0,427,427,134,70,64,3,2
14,445,445,40,40,0,1,0
15,481,481,41,41,0,1,0
23,481,481,22,9,13,2,1
3,483,483,5,5,0,1,0
11,485,485,24,8,16,4,3
28,488,488,25,25,0,1,0
26,497,497,82,2,80,3,2
37,500,500,108,56,52,3,2

18,126,126,21,21,0,1,0
2,138,138,37,22,15,2,1
12,141,141,21,21,0,1,0
3,146,146,2,2,0,1,0
24,189,189,54,20,34,3,2
20,197,197,27,27,0,1,0
25,217,217,31,19,12,4,3
6,230,230,33,33,0,1,0
21,260,260,5,5,0,1,0
15,270,270,10,10,0,1,0
8,280,280,19,14,5,2,1
5,281,281,41,9,32,4,3
31,300,300,4,4,0,1,0
22,311,311,17,3,14,3,2
32,314,314,59,59,0,1,0
11,320,320,19,4,15,2,1
16,328,328,8,5,3,2,1
19,353,353,1,1,0,1,0
13,354,354,1,1,0,1,0
28,358,358,85,39,46,3,2
14,365,365,62,62,0,1,0
10,381,381,72,66,6,2,1
4,394,394,5,5,0,1,0
30,397,397,51,21,30,3,2
17,413,413,7,7,0,1,0
23,414,414,1,1,0,1,0
0,425,425,4,4,0,1,0
9,427,427,33,21,12,2,1
26,435,435,6,6,0,1,0
29,436,436,78,70,8,3,2
7,454,454,41,13,28,3,2
27,459,459,19,19,0,1,0
1,484,484,68,68,0,1,0

17,102,102,19,4,15,2,1
28,108,108,1,1,0,1,0
20,121,121,13,7,6,2,1
22,141,141,2,2,0,1,0
5,153,153,1,1,0,1,0
16,161,161,15,3,12,3,2
12,162,162,2,2,0,1,0
26,192,192,26,7,19,2,1
30,203,203,21,21,0,1,0
8,235,235,14,2,12,2,1
13,241,241,6,6,0,1,0
23,261,261,78,78,0,1,0
11,261,261,9,3,6,2,1
25,263,263,41,41,0,1,0
0,281,281,16,16,0,1,0
21,288,288,44,20,24,4,3
14,294,294,10,10,0,1,0
19,301,301,5,5,0,1,0
24,313,313,78,6,72,4,3
9,325,325,1,1,0,1,0
4,330,330,56,44,12,4,3
10,347,347,24,24,0,1,0
15,349,349,91,91,0,1,0
6,361,361,1,1,0,1,0
7,363,363,53,13,40,3,2
18,377,377,14,1,13,2,1
27,390,390,2,2,0,1,0
29,456,456,16,10,6,3,2
2,458,458,224,152,72,4,3
1,461,461,67,49,18,4,3
31,464,464,20,20,0,1,0
3,468,468,40,2,38,3,2

18,111,111,11,11,0,1,0
27,119,119,10,10,0,1,0
2,126,126,16,1,15,3,2
22,137,137,55,55,0,1,0
28,165,165,37,37,0,1,0
3,166,166,66,39,27,4,3
21,167,167,6,1,5,2,1
0,183,183,1,1,0,1,0
12,214,214,22,9,13,2,1
13,221,221,10,10,0,1,0
8,225,225,18,18,0,1,0
17,246,246,7,7,0,1,0
20,255,255,30,25,5,2,1
7,257,257,5,1,4,2,1
19,270,270,17,6,11,2,1
16,288,288,29,29,0,1,0
24,300,300,12,12,0,1,0
25,338,338,23,13,10,2,1
1,350,350,144,144,0,1,0
6,368,368,27,3,24,4,3
14,372,372,36,11,25,4,3
4,378,378,35,19,16,3,2
23,385,385,52,30,22,3,2
26,408,408,39,11,28,2,1
11,421,421,15,7,8,2,1
5,428,428,22,5,17,4,3
9,435,435,27,27,0,1,0
15,446,446,3,3,0,1,0
10,467,467,68,5,63,4,3

18,114,114,8,4,4,2,1
19,143,143,7,7,0,1,0
11,143,143,26,26,0,1,0
4,153,153,23,19,4,2,1
1,155,155,15,5,10,2,1
7,178,178,35,35,0,1,0
25,187,187,22,7,15,4,3
3,193,193,8,8,0,1,0
6,251,251,40,40,0,1,0
8,253,253,1,1,0,1,0
0,269,269,20,7,13,2,1
24,305,305,106,106,0,1,0
23,306,306,1,1,0,1,0
2,309,309,53,53,0,1,0
15,313,313,23,2,21,4,3
10,340,340,163,99,64,3,2
5,366,366,11,11,0,1,0
20,376,376,56,11,45,2,1
17,380,380,19,4,15,2,1
26,434,434,12,6,6,2,1
13,439,439,77,77,0,1,0
27,451,451,8,8,0,1,0
12,455,455,12,12,0,1,0
9,455,455,9,9,0,1,0
22,459,459,126,90,36,4,3
14,479,479,105,9,96,3,2
16,483,483,7,7,0,1,0
21,490,490,6,3,3,2,1

15,101,101,9,9,0,1,0
19,109,109,1,1,0,1,0
4,138,138,22,22,0,1,0
18,168,168,4,4,0,1,0
24,172,172,4,1,3,2,1
21,183,183,12,7,5,2,1
6,184,184,57,45,12,2,1
1,192,192,40,40,0,1,0
10,195,195,15,10,5,2,1
9,204,204,45,6,39,2,1
5,215,215,13,6,7,2,1
20,220,220,12,12,0,1,0
17,253,253,17,17,0,1,0
16,297,297,47,47,0,1,0
11,314,314,110,110,0,1,0
0,315,315,38,32,6,2,1
23,344,344,22,19,3,2,1
8,355,355,35,13,22,2,1
12,357,357,44,12,32,3,2
2,408,408,159,53,106,4,3
13,442,442,5,5,0,1,0
7,451,451,48,48,0,1,0
14,472,472,78,42,36,3,2
22,472,472,60,16,44,2,1
3,485,485,72,72,0,1,0

2,110,110,7,7,0,1,0
0,111,111,41,13,28,2,1
27,118,118,3,3,0,1,0
11,152,152,11,11,0,1,0
14,157,157,1,1,0,1,0
21,157,157,2,2,0,1,0
15,171,171,41,41,0,1,0
22,179,179,59,59,0,1,0
23,237,237,11,11,0,1,0
30,242,242,61,15,46,3,2
25,242,242,8,8,0,1,0
8,250,250,57,57,0,1,0
13,255,255,1,1,0,1,0
20,286,286,23,16,7,2,1
12,295,295,25,12,13,2,1
9,326,326,2,2,0,1,0
31,337,337,3,3,0,1,0
1,338,338,14,14,0,1,0
3,342,342,4,4,0,1,0
28,347,347,6,3,3,2,1
18,359,359,10,10,0,1,0
5,363,363,35,35,0,1,0
17,367,367,34,34,0,1,0
16,395,395,2,2,0,1,0
7,404,404,16,16,0,1,0
6,408,408,107,74,33,4,3
26,412,412,25,13,12,4,3
10,414,414,8,8,0,1,0
19,436,436,78,55,23,3,2
24,457,457,65,65,0,1,0
29,469,469,153,153,0,1,0
4,480,480,29,29,0,1,0

21,106,106,31,16,15,4,3
27,164,164,39,21,18,4,3
39,175,175,20,20,0,1,0
20,175,175,2,2,0,1,0
5,197,197,10,10,0,1,0
17,231,231,23,23,0,1,0
10,234,234,8,8,0,1,0
7,252,252,55,40,15,2,1
1,284,284,5,5,0,1,0
26,286,286,7,4,3,2,1
22,287,287,1,1,0,1,0
18,294,294,1,1,0,1,0
16,295,295,23,23,0,1,0
32,298,298,13,13,0,1,0
35,303,303,20,4,16,2,1
2,304,304,1,1,0,1,0
23,312,312,12,12,0,1,0
38,321,321,45,45,0,1,0
37,323,323,12,3,9,2,1
11,332,332,8,8,0,1,0
0,334,334,3,3,0,1,0
9,335,335,13,6,7,2,1
36,343,343,55,8,47,4,3
33,349,349,82,48,34,2,1
28,356,356,2,2,0,1,0
8,358,358,8,8,0,1,0
29,362,362,9,9,0,1,0
4,374,374,9,1,8,2,1
24,382,382,1,1,0,1,0
14,402,402,3,3,0,1,0
30,404,404,21,21,0,1,0
3,407,407,66,2,64,3,2
40,420,420,125,32,93,4,3
15,442,442,94,94,0,1,0
13,446,446,43,22,21,4,3
19,448,448,19,10,9,4,3
25,449,449,10,10,0,1,0
34,452,452,7,7,0,1,0
6,479,479,2,2,0,1,0
31,485,485,73,55,18,2,1
12,485,485,50,20,30,4,3

4,102,102,1,1,0,1,0
32,110,110,2,2,0,1,0
18,119,119,9,9,0,1,0
8,121,121,9,9,0,1,0
34,126,126,48,30,18,4,3
15,128,128,4,4,0,1,0
9,129,129,15,15,0,1,0
7,134,134,15,15,0,1,0
35,195,195,13,13,0,1,0
14,199,199,14,14,0,1,0
27,211,211,13,9,4,2,1
28,212,212,28,13,15,4,3
12,216,216,13,1,12,3,2
3,243,243,56,56,0,1,0
22,247,247,2,2,0,1,0
31,252,252,10,10,0,1,0
26,256,256,1,1,0,1,0
0,257,257,29,29,0,1,0
16,283,283,93,63,30,4,3
36,288,288,11,8,3,2,1
25,292,292,47,47,0,1,0
17,315,315,14,2,12,2,1
13,323,323,44,44,0,1,0
19,334,334,16,8,8,3,2
24,351,351,67,67,0,1,0
29,357,357,45,45,0,1,0
21,362,362,1,1,0,1,0
33,369,369,11,11,0,1,0
11,374,374,14,14,0,1,0
2,381,381,1,1,0,1,0
30,386,386,79,79,0,1,0
1,388,388,3,3,0,1,0
10,403,403,12,12,0,1,0
5,404,404,12,12,0,1,0
20,469,469,10,10,0,1,0
6,479,479,11,7,4,2,1
23,494,494,86,86,0,1,0

0,114,114,24,8,16,2,1
11,116,116,1,1,0,1,0
12,117,117,14,1,13,2,1
7,120,120,2,2,0,1,0
26,127,127,18,18,0,1,0
29,134,134,13,3,10,3,2
13,158,158,4,4,0,1,0
14,159,159,2,2,0,1,0
30,166,166,21,21,0,1,0
25,179,179,34,13,21,2,1
24,182,182,8,5,3,2,1
6,206,206,65,38,27,2,1
27,218,218,10,2,8,3,2
21,224,224,31,31,0,1,0
23,240,240,27,22,5,2,1
18,304,304,57,57,0,1,0
19,309,309,65,65,0,1,0
4,314,314,2,2,0,1,0
1,360,360,14,2,12,3,2
3,365,365,26,4,22,3,2
15,383,383,47,47,0,1,0
22,406,406,9,3,6,3,2
16,416,416,50,50,0,1,0
5,422,422,75,35,40,4,3
2,438,438,54,54,0,1,0
17,440,440,10,1,9,4,3
9,443,443,24,24,0,1,0
10,467,467,160,82,78,4,3
8,468,468,38,20,18,4,3
28,471,471,22,10,12,2,1
20,491,491,5,5,0,1,0

16,104,104,13,9,4,2,1
18,106,106,10,10,0,1,0
25,120,120,5,5,0,1,0
21,122,122,25,17,8,3,2
2,127,127,2,2,0,1,0
3,137,137,1,1,0,1,0
13,141,141,11,5,6,3,2
11,147,147,12,12,0,1,0
19,164,164,15,15,0,1,0
30,174,174,32,4,28,2,1
15,177,177,37,37,0,1,0
22,179,179,4,4,0,1,0
9,191,191,1,1,0,1,0
27,209,209,41,41,0,1,0
14,213,213,31,31,0,1,0
0,220,220,2,2,0,1,0
10,244,244,1,1,0,1,0
32,245,245,20,8,12,4,3
24,250,250,17,5,12,3,2
20,262,262,27,27,0,1,0
5,278,278,14,14,0,1,0
8,290,290,8,3,5,2,1
23,298,298,26,16,10,3,2
31,328,328,6,1,5,2,1
34,343,343,30,30,0,1,0
35,344,344,46,6,40,3,2
17,344,344,54,54,0,1,0
26,353,353,16,16,0,1,0
7,360,360,28,20,8,2,1
4,367,367,6,3,3,2,1
12,376,376,49,49,0,1,0
29,382,382,2,2,0,1,0
33,385,385,46,46,0,1,0
1,400,400,67,67,0,1,0
28,424,424,98,78,20,2,1
6,428,428,46,8,38,3,2

0,136,136,2,2,0,1,0
20,144,144,13,13,0,1,0
25,161,161,9,3,6,2,1
11,166,166,49,40,9,4,3
26,175,175,43,20,23,2,1
13,196,196,6,1,5,2,1
15,200,200,32,8,24,4,3
2,208,208,23,2,21,4,3
18,209,209,13,13,0,1,0
4,214,214,31,19,12,3,2
9,224,224,20,20,0,1,0
14,234,234,2,2,0,1,0
8,235,235,49,49,0,1,0
24,246,246,88,58,30,3,2
21,246,246,23,23,0,1,0
7,251,251,63,50,13,3,2
6,257,257,35,13,22,2,1
27,269,269,16,9,7,2,1
19,328,328,13,13,0,1,0
23,344,344,45,7,38,3,2
1,371,371,19,11,8,2,1
16,372,372,45,45,0,1,0
17,389,389,8,1,7,2,1
5,397,397,27,27,0,1,0
10,407,407,56,56,0,1,0
3,452,452,42,22,20,2,1
22,479,479,44,32,12,4,3
12,486,486,35,35,0,1,0

3,115,115,13,5,8,2,1
23,116,116,2,2,0,1,0
11,119,119,6,6,0,1,0
24,124,124,3,3,0,1,0
19,128,128,39,39,0,1,0
7,147,147,7,2,5,2,1
14,177,177,14,14,0,1,0
8,178,178,23,8,15,4,3
6,206,206,10,10,0,1,0
25,216,216,18,18,0,1,0
2,220,220,12,5,7,2,1
20,306,306,93,93,0,1,0
5,324,324,20,5,15,4,3
4,341,341,190,190,0,1,0
16,351,351,37,37,0,1,0
21,354,354,17,17,0,1,0
1,378,378,66,28,38,3,2
22,391,391,44,24,20,2,1
0,394,394,137,137,0,1,0
12,403,403,54,42,12,3,2
26,409,409,8,2,6,2,1
15,416,416,37,37,0,1,0
9,429,429,23,23,0,1,0
17,448,448,64,64,0,1,0
10,448,448,6,6,0,1,0
13,460,460,2,2,0,1,0
18,493,493,57,45,12,3,2

14,116,116,18,18,0,1,0
24,117,117,3,3,0,1,0
32,179,179,46,46,0,1,0
7,190,190,4,4,0,1,0
15,191,191,8,8,0,1,0
17,220,220,22,22,0,1,0
16,232,232,46,46,0,1,0
25,235,235,21,21,0,1,0
29,237,237,91,60,31,2,1
12,242,242,22,14,8,3,2
5,243,243,3,3,0,1,0
6,263,263,1,1,0,1,0
0,265,265,4,1,3,2,1
9,265,265,31,1,30,2,1
27,313,313,16,16,0,1,0
1,313,313,38,38,0,1,0
19,314,314,30,30,0,1,0
2,327,327,21,3,18,4,3
8,329,329,10,5,5,2,1
28,364,364,2,2,0,1,0
3,383,383,26,26,0,1,0
10,384,384,29,21,8,2,1
26,387,387,77,67,10,3,2
31,400,400,20,20,0,1,0
23,406,406,31,31,0,1,0
13,406,406,1,1,0,1,0
18,425,425,46,2,44,2,1
11,437,437,28,28,0,1,0
21,444,444,9,9,0,1,0
30,464,464,28,18,10,2,1
4,465,465,242,212,30,2,1
22,483,483,11,11,0,1,0
20,498,498,42,42,0,1,0

23,103,103,7,1,6,3,2
21,107,107,15,6,9,3,2
14,119,119,44,35,9,4,3
24,136,136,32,32,0,1,0
18,157,157,4,4,0,1,0
1,161,161,18,18,0,1,0
3,196,196,43,1,42,4,3
19,198,198,47,3,44,2,1
28,259,259,5,5,0,1,0
15,282,282,58,9,49,2,1
2,286,286,28,7,21,2,1
4,312,312,3,3,0,1,0
17,313,313,27,21,6,3,2
20,320,320,2,2,0,1,0
22,324,324,41,41,0,1,0
16,369,369,7,7,0,1,0
7,392,392,67,60,7,2,1
6,394,394,22,15,7,2,1
13,398,398,11,3,8,3,2
27,403,403,2,2,0,1,0
9,410,410,22,22,0,1,0
5,410,410,140,74,66,4,3
11,419,419,19,11,8,2,1
10,425,425,3,3,0,1,0
26,426,426,13,8,5,2,1
8,452,452,77,17,60,3,2
25,467,467,10,5,5,2,1
0,477,477,137,79,58,3,2
12,496,496,15,2,13,2,1

33,110,110,2,2,0,1,0
31,135,135,1,1,0,1,0
24,137,137,33,33,0,1,0
7,152,152,8,2,6,3,2
22,176,176,23,1,22,2,1
29,181,181,28,10,18,2,1
0,188,188,11,11,0,1,0
14,190,190,8,4,4,2,1
4,205,205,6,2,4,2,1
27,210,210,18,12,6,3,2
32,220,220,47,30,17,4,3
13,240,240,39,16,23,2,1
26,248,248,40,33,7,2,1
10,254,254,9,9,0,1,0
23,257,257,32,32,0,1,0
11,283,283,15,15,0,1,0
16,288,288,77,77,0,1,0
18,316,316,6,2,4,2,1
2,321,321,18,18,0,1,0
9,343,343,86,27,59,4,3
8,345,345,64,64,0,1,0
28,353,353,47,47,0,1,0
34,362,362,4,4,0,1,0
1,379,379,60,30,30,3,2
20,393,393,31,31,0,1,0
30,401,401,20,20,0,1,0
25,407,407,16,16,0,1,0
21,418,418,40,40,0,1,0
17,439,439,6,6,0,1,0
19,446,446,39,39,0,1,0
12,456,456,23,23,0,1,0
3,457,457,16,16,0,1,0
15,457,457,25,4,21,4,3
5,485,485,22,22,0,1,0
6,486,486,15,15,0,1,0

18,102,102,5,5,0,1,0
20,107,107,5,2,3,2,1
6,112,112,45,45,0,1,0
30,134,134,12,2,10,3,2
25,135,135,40,10,30,3,2
23,142,142,11,11,0,1,0
0,194,194,19,3,16,2,1
4,207,207,52,25,27,4,3
29,208,208,31,31,0,1,0
7,223,223,16,16,0,1,0
31,232,232,19,19,0,1,0
14,302,302,1,1,0,1,0
28,304,304,63,63,0,1,0
26,315,315,3,3,0,1,0
17,320,320,31,19,12,2,1
1,325,325,37,37,0,1,0
2,328,328,16,5,11,2,1
13,333,333,16,8,8,3,2
32,353,353,4,4,0,1,0
15,353,353,1,1,0,1,0
11,372,372,74,1,73,4,3
12,381,381,29,29,0,1,0
27,392,392,83,35,48,3,2
21,408,408,15,7,8,3,2
5,410,410,8,8,0,1,0
9,433,433,7,4,3,2,1
16,449,449,6,6,0,1,0
24,457,457,12,12,0,1,0
19,464,464,108,33,75,4,3
22,471,471,11,11,0,1,0
8,474,474,42,42,0,1,0
3,497,497,53,17,36,4,3
10,499,499,21,21,0,1,0

0,114,114,7,7,0,1,0
9,119,119,2,2,0,1,0
20,125,125,8,8,0,1,0
3,127,127,3,3,0,1,0
13,139,139,1,1,0,1,0
25,146,146,4,1,3,2,1
14,156,156,7,7,0,1,0
4,242,242,2,2,0,1,0
11,243,243,8,8,0,1,0
8,261,261,25,1,24,2,1
5,271,271,54,54,0,1,0
23,286,286,40,40,0,1,0
27,324,324,15,1,14,2,1
1,325,325,85,73,12,4,3
7,341,341,97,97,0,1,0
26,355,355,40,19,21,4,3
18,378,378,8,8,0,1,0
16,385,385,49,25,24,4,3
21,389,389,9,9,0,1,0
24,407,407,53,34,19,2,1
10,412,412,70,70,0,1,0
12,418,418,72,41,31,4,3
6,428,428,77,29,48,4,3
28,450,450,116,80,36,4,3
17,466,466,71,71,0,1,0
19,469,469,15,15,0,1,0
2,475,475,45,45,0,1,0
22,490,490,40,2,38,3,2
15,491,491,180,171,9,4,3

28,110,110,1,1,0,1,0
24,124,124,31,2,29,2,1
16,154,154,4,4,0,1,0
19,174,174,3,3,0,1,0
12,186,186,27,5,22,3,2
10,198,198,2,2,0,1,0
1,217,217,54,54,0,1,0
29,229,229,2,2,0,1,0
0,231,231,1,1,0,1,0
6,233,233,1,1,0,1,0
30,242,242,36,36,0,1,0
8,284,284,38,12,26,3,2
23,310,310,28,6,22,3,2
32,323,323,18,12,6,3,2
22,323,323,44,44,0,1,0
2,341,341,1,1,0,1,0
7,350,350,11,11,0,1,0
5,358,358,61,9,52,3,2
15,358,358,36,9,27,2,1
17,393,393,21,21,0,1,0
21,395,395,158,133,25,2,1
31,407,407,4,4,0,1,0
9,426,426,41,9,32,3,2
25,435,435,42,16,26,3,2
14,444,444,84,84,0,1,0
13,461,461,7,4,3,2,1
4,472,472,124,124,0,1,0
3,475,475,67,7,60,3,2
11,481,481,10,2,8,3,2
20,482,482,38,38,0,1,0
26,487,487,89,32,57,3,2
18,494,494,15,15,0,1,0
27,497,497,32,2,30,2,1

31,105,105,20,10,10,3,2
3,113,113,3,3,0,1,0
26,117,117,5,2,3,2,1
32,130,130,1,1,0,1,0
22,131,131,20,15,5,2,1
12,137,137,25,25,0,1,0
23,140,140,7,7,0,1,0
28,153,153,8,8,0,1,0
15,202,202,56,56,0,1,0
2,204,204,26,20,6,3,2
1,234,234,17,7,10,3,2
27,238,238,26,26,0,1,0
25,269,269,43,43,0,1,0
7,278,278,21,7,14,3,2
30,280,280,15,1,14,4,3
20,305,305,46,14,32,4,3
21,306,306,4,4,0,1,0
4,307,307,23,19,4,2,1
18,318,318,102,48,54,4,3
0,340,340,5,5,0,1,0
11,347,347,71,71,0,1,0
14,357,357,5,1,4,2,1
6,371,371,37,37,0,1,0
5,372,372,27,27,0,1,0
19,380,380,94,94,0,1,0
24,409,409,19,1,18,2,1
10,439,439,21,21,0,1,0
8,450,450,42,42,0,1,0
17,469,469,10,10,0,1,0
16,471,471,95,95,0,1,0
29,483,483,12,6,6,3,2
9,493,493,7,7,0,1,0
13,498,498,1,1,0,1,0

11,101,101,15,10,5,2,1
20,139,139,12,6,6,3,2
22,146,146,11,5,6,2,1
13,183,183,11,11,0,1,0
8,186,186,1,1,0,1,0
34,203,203,1,1,0,1,0
29,205,205,8,4,4,2,1
28,209,209,6,3,3,2,1
16,234,234,19,19,0,1,0
14,246,246,7,7,0,1,0
33,248,248,30,13,17,2,1
24,261,261,8,8,0,1,0
10,285,285,3,3,0,1,0
23,287,287,53,53,0,1,0
30,287,287,33,33,0,1,0
15,301,301,28,4,24,2,1
0,303,303,9,3,6,3,2
31,306,306,12,6,6,3,2
17,323,323,31,9,22,2,1
26,329,329,7,4,3,2,1
4,342,342,56,26,30,3,2
2,367,367,5,5,0,1,0
19,379,379,29,14,15,2,1
36,384,384,9,2,7,2,1
35,432,432,63,63,0,1,0
6,444,444,173,166,7,2,1
21,446,446,27,27,0,1,0
18,449,449,16,16,0,1,0
7,451,451,21,21,0,1,0
12,452,452,10,4,6,3,2
5,458,458,31,22,9,4,3
32,460,460,53,53,0,1,0
27,462,462,22,22,0,1,0
25,477,477,273,273,0,1,0
3,486,486,38,11,27,2,1
9,493,493,31,31,0,1,0
1,496,496,3,3,0,1,0

28,124,124,1,1,0,1,0
1,137,137,13,13,0,1,0
30,153,153,8,8,0,1,0
25,159,159,30,12,18,4,3
26,163,163,20,11,9,4,3
6,178,178,9,6,3,2,1
2,185,185,3,3,0,1,0
10,189,189,18,4,14,3,2
8,193,193,22,22,0,1,0
4,224,224,8,2,6,3,2
18,233,233,23,23,0,1,0
19,243,243,23,14,9,2,1
0,248,248,4,1,3,2,1
23,255,255,38,38,0,1,0
24,260,260,17,17,0,1,0
13,263,263,8,8,0,1,0
16,278,278,17,17,0,1,0
9,294,294,7,1,6,3,2
17,296,296,9,9,0,1,0
11,312,312,14,2,12,2,1
7,337,337,4,4,0,1,0
21,355,355,34,10,24,4,3
3,382,382,39,39,0,1,0
27,392,392,66,54,12,2,1
12,409,409,249,196,53,3,2
29,412,412,55,55,0,1,0
5,441,441,114,42,72,4,3
20,467,467,90,69,21,3,2
22,469,469,76,26,50,2,1
15,472,472,7,7,0,1,0
14,493,493,48,5,43,2,1

16,105,105,8,8,0,1,0
25,125,125,21,17,4,2,1
2,130,130,42,42,0,1,0
27,134,134,18,18,0,1,0
30,199,199,24,19,5,2,1
11,200,200,29,29,0,1,0
24,201,201,4,4,0,1,0
18,215,215,19,19,0,1,0
6,234,234,29,29,0,1,0
19,234,234,16,16,0,1,0
17,249,249,51,33,18,3,2
8,256,256,22,22,0,1,0
7,264,264,6,6,0,1,0
13,287,287,13,5,8,2,1
4,291,291,24,18,6,3,2
9,295,295,66,66,0,1,0
23,306,306,33,33,0,1,0
14,319,319,43,1,42,4,3
21,334,334,9,9,0,1,0
20,346,346,8,8,0,1,0
1,354,354,12,2,10,2,1
31,357,357,40,40,0,1,0
26,365,365,102,93,9,4,3
22,425,425,1,1,0,1,0
28,427,427,78,78,0,1,0
3,436,436,30,30,0,1,0
12,445,445,58,18,40,3,2
15,456,456,27,27,0,1,0
10,457,457,9,9,0,1,0
29,471,471,13,13,0,1,0
0,491,491,44,44,0,1,0
5,500,500,6,6,0,1,0

1,110,110,5,2,3,2,1
3,113,113,4,1,3,2,1
23,143,143,5,5,0,1,0
4,144,144,3,3,0,1,0
19,161,161,15,6,9,2,1
0,168,168,5,5,0,1,0
17,170,170,21,9,12,2,1
28,184,184,9,4,5,2,1
25,188,188,10,10,0,1,0
16,201,201,18,18,0,1,0
15,212,212,64,64,0,1,0
24,212,212,20,20,0,1,0
22,237,237,9,9,0,1,0
7,258,258,35,35,0,1,0
27,264,264,12,1,11,2,1
2,267,267,11,11,0,1,0
9,280,280,17,2,15,4,3
12,304,304,24,9,15,4,3
13,316,316,7,7,0,1,0
11,317,317,11,11,0,1,0
26,333,333,121,105,16,2,1
10,359,359,29,1,28,3,2
18,363,363,29,4,25,2,1
5,370,370,5,5,0,1,0
6,380,380,288,195,93,4,3
21,413,413,37,37,0,1,0
20,414,414,13,5,8,2,1
8,488,488,130,50,80,3,2
14,492,492,63,63,0,1,0

17,158,158,24,24,0,1,0
25,166,166,1,1,0,1,0
19,178,178,54,19,35,2,1
15,193,193,8,8,0,1,0
22,197,197,3,3,0,1,0
10,260,260,44,19,25,4,3
1,261,261,13,13,0,1,0
18,288,288,28,28,0,1,0
9,291,291,10,10,0,1,0
20,308,308,6,6,0,1,0
23,334,334,9,9,0,1,0
5,338,338,5,5,0,1,0
8,349,349,12,2,10,3,2
6,359,359,96,69,27,4,3
0,359,359,41,41,0,1,0
11,379,379,32,32,0,1,0
26,392,392,16,16,0,1,0
13,397,397,47,47,0,1,0
16,402,402,22,9,13,2,1
29,407,407,116,2,114,4,3
24,417,417,118,1,117,4,3
21,426,426,54,14,40,3,2
2,429,429,82,28,54,3,2
7,433,433,133,115,18,4,3
14,435,435,57,41,16,3,2
12,448,448,39,15,24,3,2
3,464,464,36,12,24,3,2
4,476,476,25,3,22,3,2
28,483,483,13,5,8,2,1
27,495,495,9,9,0,1,0

23,111,111,2,2,0,1,0
0,144,144,2,2,0,1,0
17,157,157,12,2,10,3,2
2,165,165,25,25,0,1,0
33,172,172,15,15,0,1,0
27,176,176,81,28,53,3,2
21,181,181,1,1,0,1,0
13,199,199,1,1,0,1,0
31,204,204,14,14,0,1,0
24,208,208,50,50,0,1,0
25,216,216,12,12,0,1,0
28,219,219,22,22,0,1,0
5,221,221,9,9,0,1,0
8,230,230,9,9,0,1,0
7,232,232,15,7,8,2,1
18,243,243,49,49,0,1,0
10,248,248,15,10,5,2,1
12,250,250,22,22,0,1,0
1,269,269,54,54,0,1,0
9,281,281,19,19,0,1,0
11,300,300,26,26,0,1,0
34,326,326,2,2,0,1,0
3,377,377,15,15,0,1,0
30,382,382,7,1,6,3,2
14,393,393,25,25,0,1,0
6,396,396,1,1,0,1,0
22,400,400,24,24,0,1,0
29,413,413,100,100,0,1,0
20,421,421,13,6,7,2,1
35,443,443,70,2,68,3,2
36,447,447,3,3,0,1,0
4,450,450,10,10,0,1,0
32,453,453,20,20,0,1,0
19,453,453,62,15,47,2,1
16,455,455,83,35,48,2,1
26,471,471,26,17,9,2,1
15,474,474,13,13,0,1,0

0,106,106,6,6,0,1,0
4,133,133,4,4,0,1,0
8,133,133,12,12,0,1,0
30,141,141,40,40,0,1,0
25,164,164,10,10,0,1,0
3,165,165,4,1,3,2,1
29,166,166,27,15,12,3,2
5,182,182,1,1,0,1,0
6,215,215,19,19,0,1,0
9,225,225,59,41,18,4,3
1,241,241,45,6,39,4,3
15,242,242,2,2,0,1,0
10,276,276,1,1,0,1,0
13,281,281,1,1,0,1,0
26,285,285,3,3,0,1,0
19,287,287,6,6,0,1,0
14,309,309,135,135,0,1,0
21,321,321,15,15,0,1,0
18,339,339,39,6,33,2,1
17,340,340,10,10,0,1,0
20,360,360,14,7,7,2,1
2,394,394,63,24,39,2,1
24,398,398,199,199,0,1,0
27,400,400,25,25,0,1,0
31,401,401,56,48,8,2,1
16,408,408,15,15,0,1,0
23,411,411,38,8,30,2,1
22,416,416,2,2,0,1,0
7,426,426,67,15,52,3,2
28,430,430,4,4,0,1,0
11,433,433,13,13,0,1,0
12,480,480,10,10,0,1,0
32,485,485,26,26,0,1,0

28,100,100,13,1,12,2,1
36,138,138,19,4,15,2,1
3,139,139,1,1,0,1,0
0,152,152,7,7,0,1,0
30,152,152,2,2,0,1,0
34,167,167,1,1,0,1,0
23,182,182,6,6,0,1,0
14,188,188,11,3,8,3,2
38,196,196,39,36,3,2,1
39,196,196,3,3,0,1,0
21,231,231,17,17,0,1,0
24,233,233,1,1,0,1,0
19,235,235,6,1,5,2,1
41,246,246,55,55,0,1,0
40,255,255,8,8,0,1,0
15,258,258,12,7,5,2,1
25,271,271,6,6,0,1,0
32,273,273,16,16,0,1,0
16,273,273,10,1,9,2,1
27,275,275,35,13,22,2,1
9,298,298,7,7,0,1,0
5,310,310,3,3,0,1,0
7,311,311,14,4,10,3,2
1,329,329,12,12,0,1,0
4,340,340,76,22,54,3,2
8,344,344,40,40,0,1,0
26,353,353,29,8,21,4,3
22,360,360,59,59,0,1,0
29,375,375,79,58,21,4,3
35,399,399,144,48,96,4,3
2,410,410,39,23,16,2,1
13,420,420,1,1,0,1,0
42,425,425,19,2,17,2,1
33,431,431,6,6,0,1,0
12,435,435,7,7,0,1,0
10,450,450,32,2,30,4,3
31,453,453,4,1,3,2,1
11,458,458,8,8,0,1,0
20,484,484,21,9,12,3,2
17,484,484,21,6,15,4,3
37,487,487,28,4,24,3,2
18,497,497,126,36,90,3,2
6,498,498,3,3,0,1,0

11,128,128,19,15,4,2,1
27,131,131,4,4,0,1,0
13,151,151,4,4,0,1,0
24,187,187,16,8,8,3,2
2,193,193,22,22,0,1,0
25,196,196,48,14,34,3,2
14,199,199,2,2,0,1,0
9,200,200,10,2,8,3,2
31,207,207,16,7,9,4,3
0,210,210,5,5,0,1,0
15,220,220,6,1,5,2,1
8,234,234,53,53,0,1,0
29,247,247,8,2,6,3,2
21,249,249,23,23,0,1,0
30,250,250,6,6,0,1,0
20,253,253,4,1,3,2,1
4,261,261,36,36,0,1,0
5,270,270,8,8,0,1,0
1,279,279,51,51,0,1,0
33,283,283,54,45,9,4,3
12,285,285,62,62,0,1,0
32,315,315,14,5,9,2,1
26,322,322,57,15,42,3,2
16,337,337,8,8,0,1,0
18,339,339,4,4,0,1,0
3,371,371,46,46,0,1,0
17,408,408,26,26,0,1,0
19,431,431,80,80,0,1,0
23,451,451,41,7,34,2,1
28,456,456,146,17,129,4,3
6,459,459,2,2,0,1,0
10,478,478,35,35,0,1,0
7,479,479,56,56,0,1,0
22,490,490,2,2,0,1,0

24,109,109,4,4,0,1,0
5,120,120,6,1,5,2,1
0,126,126,19,19,0,1,0
32,126,126,26,26,0,1,0
21,137,137,25,5,20,2,1
20,146,146,13,2,11,2,1
29,160,160,1,1,0,1,0
27,163,163,34,34,0,1,0
1,184,184,36,1,35,2,1
13,193,193,32,32,0,1,0
25,205,205,19,19,0,1,0
7,212,212,9,9,0,1,0
3,242,242,26,14,12,2,1
22,257,257,23,13,10,2,1
2,261,261,1,1,0,1,0
4,276,276,3,3,0,1,0
10,282,282,58,15,43,2,1
31,291,291,46,25,21,2,1
19,323,323,29,15,14,3,2
12,324,324,74,16,58,3,2
9,341,341,11,8,3,2,1
14,365,365,5,5,0,1,0
15,385,385,42,42,0,1,0
8,388,388,40,40,0,1,0
17,406,406,22,9,13,2,1
30,416,416,24,11,13,2,1
28,420,420,26,26,0,1,0
16,421,421,13,4,9,4,3
11,434,434,2,2,0,1,0
23,449,449,50,45,5,2,1
26,449,449,28,1,27,2,1
33,477,477,40,32,8,3,2
6,482,482,45,45,0,1,0
18,484,484,50,50,0,1,0

30,113,113,6,6,0,1,0
31,136,136,4,4,0,1,0
3,141,141,55,55,0,1,0
5,182,182,8,8,0,1,0
25,192,192,64,4,60,4,3
28,239,239,5,5,0,1,0
23,248,248,17,2,15,2,1
18,248,248,5,5,0,1,0
6,250,250,11,2,9,4,3
15,292,292,8,8,0,1,0
8,299,299,6,6,0,1,0
16,301,301,64,34,30,3,2
4,314,314,63,63,0,1,0
13,320,320,18,18,0,1,0
0,325,325,32,11,21,4,3
29,347,347,3,3,0,1,0
1,354,354,20,12,8,3,2
20,359,359,6,6,0,1,0
10,362,362,5,5,0,1,0
2,375,375,6,6,0,1,0
21,376,376,99,63,36,4,3
24,377,377,50,14,36,2,1
11,377,377,44,44,0,1,0
27,386,386,71,17,54,3,2
12,410,410,69,9,60,4,3
14,421,421,27,27,0,1,0
19,431,431,3,3,0,1,0
26,443,443,112,112,0,1,0
17,457,457,10,10,0,1,0
9,460,460,66,66,0,1,0
7,470,470,67,67,0,1,0
22,492,492,3,3,0,1,0

27,127,127,11,11,0,1,0
19,136,136,5,5,0,1,0
25,138,138,38,38,0,1,0
18,193,193,7,7,0,1,0
9,203,203,43,43,0,1,0
5,239,239,11,11,0,1,0
2,240,240,19,19,0,1,0
21,250,250,51,11,40,2,1
3,271,271,28,1,27,3,2
23,274,274,30,30,0,1,0
26,280,280,2,2,0,1,0
10,291,291,101,101,0,1,0
16,329,329,79,55,24,4,3
24,332,332,61,61,0,1,0
15,334,334,8,1,7,2,1
7,352,352,58,58,0,1,0
22,359,359,46,46,0,1,0
13,364,364,50,7,43,2,1
0,371,371,64,64,0,1,0
17,375,375,27,27,0,1,0
1,399,399,45,7,38,2,1
11,416,416,25,15,10,3,2
8,416,416,21,21,0,1,0
6,442,442,75,75,0,1,0
14,459,459,20,10,10,2,1
4,467,467,39,16,23,4,3
20,472,472,10,10,0,1,0
12,487,487,13,6,7,2,1

3,102,102,3,3,0,1,0
5,107,107,20,20,0,1,0
20,112,112,3,3,0,1,0
6,116,116,27,21,6,2,1
22,116,116,15,15,0,1,0
28,124,124,9,9,0,1,0
16,156,156,27,27,0,1,0
12,160,160,1,1,0,1,0
34,188,188,42,42,0,1,0
10,225,225,16,10,6,3,2
25,230,230,27,2,25,3,2
2,231,231,1,1,0,1,0
18,245,245,2,2,0,1,0
26,252,252,2,2,0,1,0
29,256,256,51,18,33,2,1
33,260,260,4,4,0,1,0
23,271,271,14,14,0,1,0
7,274,274,20,3,17,4,3
32,293,293,31,31,0,1,0
30,306,306,25,8,17,2,1
21,311,311,14,3,11,2,1
1,319,319,13,8,5,2,1
15,372,372,21,21,0,1,0
17,384,384,35,20,15,4,3
4,398,398,67,67,0,1,0
8,414,414,3,3,0,1,0
0,418,418,48,48,0,1,0
19,423,423,156,140,16,3,2
31,435,435,12,12,0,1,0
13,440,440,17,17,0,1,0
11,450,450,105,68,37,4,3
24,462,462,62,14,48,3,2
27,476,476,14,14,0,1,0
9,483,483,18,18,0,1,0
14,485,485,14,3,11,2,1

21,113,113,9,9,0,1,0
29,126,126,21,21,0,1,0
24,137,137,11,11,0,1,0
8,138,138,5,5,0,1,0
3,158,158,35,35,0,1,0
22,158,158,5,2,3,2,1
6,162,162,1,1,0,1,0
4,175,175,14,10,4,2,1
12,180,180,6,6,0,1,0
28,212,212,27,27,0,1,0
25,221,221,5,5,0,1,0
14,224,224,1,1,0,1,0
26,225,225,12,3,9,2,1
30,243,243,26,11,15,4,3
9,248,248,44,44,0,1,0
19,261,261,9,1,8,3,2
18,297,297,22,10,12,3,2
2,300,300,10,10,0,1,0
13,303,303,55,18,37,3,2
16,304,304,35,35,0,1,0
23,318,318,16,6,10,3,2
15,320,320,128,101,27,2,1
0,341,341,43,43,0,1,0
31,348,348,30,30,0,1,0
10,362,362,27,27,0,1,0
5,385,385,3,3,0,1,0
27,421,421,176,176,0,1,0
7,437,437,22,22,0,1,0
1,448,448,44,44,0,1,0
11,451,451,32,32,0,1,0
17,453,453,20,20,0,1,0
20,490,490,71,36,35,2,1

7,102,102,17,9,8,2,1
11,110,110,23,23,0,1,0
1,113,113,16,7,9,3,2
8,119,119,6,6,0,1,0
0,131,131,1,1,0,1,0
10,134,134,3,3,0,1,0
30,135,135,28,28,0,1,0
3,180,180,9,9,0,1,0
9,194,194,48,8,40,3,2
20,202,202,2,2,0,1,0
15,205,205,14,2,12,3,2
26,209,209,21,11,10,2,1
4,217,217,43,43,0,1,0
31,251,251,55,55,0,1,0
5,272,272,7,1,6,2,1
12,276,276,61,33,28,3,2
17,277,277,9,9,0,1,0
19,282,282,11,11,0,1,0
21,334,334,6,6,0,1,0
6,336,336,38,5,33,4,3
25,346,346,16,16,0,1,0
23,350,350,26,5,21,4,3
13,380,380,8,8,0,1,0
14,382,382,19,2,17,2,1
16,383,383,45,38,7,2,1
2,385,385,4,4,0,1,0
22,390,390,99,68,31,2,1
18,391,391,28,9,19,3,2
28,417,417,45,21,24,2,1
27,449,449,26,9,17,2,1
29,481,481,3,3,0,1,0
24,500,500,132,129,3,2,1

15,108,108,6,6,0,1,0
12,119,119,3,3,0,1,0
11,120,120,34,34,0,1,0
5,126,126,2,2,0,1,0
29,132,132,2,2,0,1,0
8,142,142,10,10,0,1,0
30,153,153,44,44,0,1,0
19,179,179,48,10,38,4,3
26,182,182,17,5,12,3,2
27,189,189,7,1,6,3,2
20,194,194,8,8,0,1,0
16,201,201,5,5,0,1,0
3,206,206,6,2,4,2,1
18,210,210,20,20,0,1,0
0,212,212,29,6,23,2,1
2,230,230,1,1,0,1,0
17,239,239,9,4,5,2,1
22,252,252,11,11,0,1,0
10,273,273,5,5,0,1,0
32,276,276,8,8,0,1,0
14,322,322,11,11,0,1,0
13,340,340,44,44,0,1,0
1,346,346,10,5,5,2,1
4,357,357,7,7,0,1,0
31,361,361,125,92,33,2,1
21,366,366,16,16,0,1,0
23,377,377,8,1,7,2,1
33,388,388,122,91,31,2,1
28,390,390,56,11,45,4,3
7,391,391,52,52,0,1,0
24,402,402,13,13,0,1,0
9,417,417,30,3,27,4,3
6,421,421,50,50,0,1,0
35,450,450,32,32,0,1,0
25,473,473,7,7,0,1,0
34,473,473,44,9,35,4,3

27,105,105,4,4,0,1,0
1,119,119,51,1,50,3,2
26,127,127,10,10,0,1,0
2,155,155,24,20,4,2,1
18,163,163,4,4,0,1,0
14,183,183,45,40,5,2,1
28,186,186,13,3,10,2,1
11,218,218,39,39,0,1,0
17,258,258,21,2,19,2,1
22,260,260,31,3,28,2,1
19,270,270,30,30,0,1,0
9,273,273,31,1,30,3,2
23,275,275,10,2,8,2,1
10,281,281,36,36,0,1,0
0,289,289,82,12,70,3,2
4,292,292,4,4,0,1,0
21,294,294,28,28,0,1,0
5,331,331,25,25,0,1,0
20,334,334,67,67,0,1,0
7,354,354,55,10,45,4,3
3,356,356,11,11,0,1,0
24,371,371,12,12,0,1,0
8,383,383,1,1,0,1,0
6,413,413,8,8,0,1,0
25,447,447,110,110,0,1,0
13,461,461,76,76,0,1,0
16,478,478,1,1,0,1,0
12,478,478,8,8,0,1,0
15,482,482,41,23,18,4,3

2,100,100,6,6,0,1,0
7,106,106,5,5,0,1,0
6,108,108,17,9,8,3,2
33,122,122,3,3,0,1,0
38,146,146,32,4,28,3,2
34,148,148,1,1,0,1,0
23,155,155,17,3,14,4,3
3,157,157,7,3,4,2,1
1,166,166,4,4,0,1,0
22,180,180,62,62,0,1,0
17,212,212,9,9,0,1,0
13,234,234,28,28,0,1,0
37,235,235,62,62,0,1,0
4,243,243,3,3,0,1,0
11,255,255,33,15,18,3,2
10,289,289,42,12,30,3,2
19,293,293,13,13,0,1,0
0,294,294,14,11,3,2,1
20,295,295,3,3,0,1,0
8,295,295,2,2,0,1,0
16,297,297,3,3,0,1,0
35,314,314,31,31,0,1,0
32,328,328,14,4,10,3,2
24,354,354,57,57,0,1,0
12,374,374,13,10,3,2,1
21,383,383,17,9,8,2,1
28,391,391,111,111,0,1,0
26,394,394,46,8,38,3,2
31,395,395,32,32,0,1,0
27,399,399,40,40,0,1,0
18,412,412,10,10,0,1,0
29,434,434,21,21,0,1,0
25,437,437,5,5,0,1,0
30,440,440,3,3,0,1,0
5,445,445,38,6,32,2,1
36,458,458,25,25,0,1,0
15,459,459,46,12,34,2,1
9,479,479,4,4,0,1,0
14,488,488,30,30,0,1,0

18,102,102,25,19,6,2,1
25,111,111,10,10,0,1,0
20,119,119,7,7,0,1,0
23,144,144,37,37,0,1,0
0,158,158,23,9,14,2,1
19,168,168,11,11,0,1,0
17,174,174,2,2,0,1,0
15,262,262,39,14,25,2,1
10,270,270,49,49,0,1,0
9,307,307,59,59,0,1,0
7,308,308,31,31,0,1,0
12,308,308,18,1,17,2,1
6,326,326,142,97,45,2,1
24,329,329,38,38,0,1,0
1,354,354,10,2,8,2,1
21,381,381,81,29,52,4,3
8,411,411,14,14,0,1,0
22,412,412,2,2,0,1,0
5,422,422,38,24,14,3,2
11,424,424,46,42,4,2,1
16,435,435,13,13,0,1,0
26,440,440,8,2,6,2,1
4,443,443,54,54,0,1,0
13,462,462,62,38,24,3,2
2,465,465,125,95,30,4,3
14,475,475,39,7,32,3,2
3,484,484,1,1,0,1,0

17,120,120,13,13,0,1,0
1,126,126,1,1,0,1,0
19,149,149,8,8,0,1,0
13,155,155,25,25,0,1,0
15,183,183,56,20,36,4,3
25,184,184,3,3,0,1,0
4,222,222,1,1,0,1,0
27,235,235,8,8,0,1,0
3,240,240,78,78,0,1,0
2,248,248,17,17,0,1,0
11,262,262,14,14,0,1,0
14,264,264,15,7,8,3,2
18,273,273,24,24,0,1,0
8,277,277,3,3,0,1,0
9,286,286,160,111,49,2,1
22,304,304,38,38,0,1,0
7,321,321,27,17,10,3,2
6,333,333,13,7,6,2,1
21,333,333,68,19,49,2,1
20,370,370,14,14,0,1,0
12,381,381,40,40,0,1,0
16,401,401,89,54,35,2,1
24,407,407,2,2,0,1,0
26,425,425,1,1,0,1,0
23,439,439,43,43,0,1,0
0,462,462,124,4,120,4,3
5,469,469,46,31,15,4,3
10,478,478,39,39,0,1,0

25,102,102,1,1,0,1,0
24,112,112,1,1,0,1,0
31,139,139,21,8,13,2,1
38,147,147,11,11,0,1,0
36,186,186,3,3,0,1,0
20,197,197,15,15,0,1,0
21,229,229,5,5,0,1,0
32,232,232,4,4,0,1,0
4,238,238,4,1,3,2,1
6,240,240,1,1,0,1,0
30,248,248,11,11,0,1,0
14,251,251,27,27,0,1,0
15,256,256,18,18,0,1,0
11,258,258,49,49,0,1,0
3,263,263,25,25,0,1,0
10,270,270,11,1,10,2,1
40,271,271,6,2,4,2,1
37,273,273,17,5,12,2,1
22,279,279,11,11,0,1,0
1,282,282,17,17,0,1,0
9,290,290,16,4,12,3,2
42,299,299,53,53,0,1,0
5,322,322,12,12,0,1,0
7,337,337,67,56,11,2,1
39,345,345,49,49,0,1,0
17,350,350,1,1,0,1,0
2,354,354,60,14,46,4,3
0,355,355,41,6,35,2,1
35,372,372,9,2,7,2,1
29,381,381,73,73,0,1,0
23,382,382,38,12,26,3,2
18,393,393,18,18,0,1,0
41,396,396,7,7,0,1,0
34,408,408,11,5,6,2,1
8,415,415,4,1,3,2,1
16,418,418,1,1,0,1,0
33,426,426,5,1,4,2,1
12,447,447,19,9,10,2,1
28,456,456,266,266,0,1,0
26,456,456,27,27,0,1,0
19,476,476,9,3,6,3,2
27,491,491,31,17,14,3,2
13,492,492,1,1,0,1,0

25,127,127,6,6,0,1,0
19,145,145,3,3,0,1,0
29,162,162,5,5,0,1,0
22,163,163,9,9,0,1,0
8,200,200,46,46,0,1,0
27,206,206,34,34,0,1,0
9,213,213,15,12,3,2,1
18,225,225,41,41,0,1,0
10,239,239,5,5,0,1,0
31,243,243,19,5,14,3,2
4,264,264,45,45,0,1,0
14,266,266,47,47,0,1,0
21,353,353,61,61,0,1,0
2,353,353,1,1,0,1,0
23,355,355,21,21,0,1,0
3,371,371,30,3,27,4,3
13,378,378,15,9,6,3,2
12,378,378,13,1,12,3,2
17,382,382,8,8,0,1,0
6,384,384,8,8,0,1,0
16,390,390,33,33,0,1,0
7,394,394,8,1,7,2,1
20,395,395,36,7,29,2,1
11,399,399,15,15,0,1,0
5,402,402,40,31,9,2,1
30,413,413,47,47,0,1,0
1,420,420,6,6,0,1,0
28,421,421,119,95,24,2,1
0,423,423,67,67,0,1,0
15,432,432,183,105,78,4,3
24,464,464,57,57,0,1,0
26,494,494,48,22,26,2,1

26,106,106,8,8,0,1,0
11,108,108,13,5,8,3,2
8,108,108,1,1,0,1,0
6,197,197,11,1,10,3,2
7,204,204,12,12,0,1,0
13,205,205,11,11,0,1,0
14,225,225,16,6,10,4,3
3,226,226,77,77,0,1,0
9,226,226,100,36,64,3,2
23,242,242,8,4,4,2,1
12,268,268,19,19,0,1,0
17,349,349,30,4,26,2,1
22,355,355,66,24,42,3,2
4,362,362,50,41,9,2,1
18,368,368,71,53,18,4,3
27,380,380,43,43,0,1,0
2,398,398,2,2,0,1,0
10,404,404,54,24,30,3,2
15,425,425,2,2,0,1,0
0,433,433,72,72,0,1,0
16,444,444,71,10,61,4,3
19,445,445,2,2,0,1,0
24,446,446,17,17,0,1,0
20,447,447,99,54,45,4,3
5,454,454,57,26,31,2,1
25,458,458,70,10,60,4,3
1,469,469,4,4,0,1,0
21,495,495,82,43,39,4,3

3,114,114,12,12,0,1,0
15,118,118,6,6,0,1,0
14,128,128,9,1,8,2,1
8,161,161,3,3,0,1,0
5,180,180,11,11,0,1,0
12,196,196,35,35,0,1,0
16,200,200,9,1,8,2,1
26,201,201,6,6,0,1,0
27,204,204,37,10,27,4,3
0,218,218,12,4,8,3,2
4,222,222,62,19,43,2,1
19,237,237,82,44,38,2,1
17,242,242,25,25,0,1,0
22,247,247,4,4,0,1,0
1,256,256,28,28,0,1,0
10,277,277,13,13,0,1,0
18,287,287,37,37,0,1,0
2,317,317,6,6,0,1,0
23,318,318,30,30,0,1,0
7,321,321,33,15,18,2,1
24,336,336,11,1,10,2,1
20,342,342,26,26,0,1,0
21,348,348,7,1,6,2,1
9,362,362,109,76,33,3,2
11,364,364,29,16,13,3,2
6,420,420,178,81,97,4,3
13,452,452,50,50,0,1,0
25,459,459,68,68,0,1,0

19,114,114,2,2,0,1,0
8,136,136,56,35,21,4,3
12,150,150,17,17,0,1,0
18,170,170,34,21,13,2,1
21,172,172,19,19,0,1,0
16,182,182,35,16,19,2,1
13,209,209,34,34,0,1,0
3,212,212,14,10,4,2,1
1,217,217,13,13,0,1,0
15,225,225,55,50,5,2,1
7,229,229,81,9,72,4,3
9,255,255,15,3,12,2,1
2,277,277,72,37,35,3,2
0,290,290,7,7,0,1,0
24,294,294,43,1,42,3,2
4,333,333,11,6,5,2,1
17,357,357,26,26,0,1,0
6,358,358,109,109,0,1,0
5,360,360,32,3,29,2,1
20,363,363,11,11,0,1,0
23,368,368,12,12,0,1,0
22,384,384,12,12,0,1,0
14,405,405,50,50,0,1,0
11,422,422,36,6,30,3,2
10,447,447,5,5,0,1,0

30,101,101,5,5,0,1,0
18,119,119,21,21,0,1,0
10,124,124,20,2,18,3,2
29,145,145,42,42,0,1,0
15,149,149,1,1,0,1,0
32,192,192,48,48,0,1,0
17,193,193,15,1,14,2,1
23,206,206,5,5,0,1,0
14,211,211,9,1,8,2,1
9,215,215,1,1,0,1,0
25,217,217,18,2,16,4,3
6,235,235,13,1,12,3,2
13,252,252,6,6,0,1,0
5,255,255,37,1,36,4,3
21,278,278,107,107,0,1,0
22,279,279,26,14,12,3,2
19,281,281,9,6,3,2,1
12,281,281,6,6,0,1,0
8,290,290,23,23,0,1,0
2,311,311,60,60,0,1,0
26,322,322,7,2,5,2,1
27,330,330,8,2,6,3,2
1,337,337,12,12,0,1,0
24,365,365,24,18,6,3,2
28,372,372,4,4,0,1,0
20,389,389,10,10,0,1,0
0,391,391,44,34,10,3,2
7,396,396,66,24,42,2,1
11,398,398,60,46,14,2,1
4,459,459,17,8,9,4,3
3,460,460,99,12,87,4,3
16,484,484,73,61,12,4,3
31,493,493,14,14,0,1,0

25,162,162,6,1,5,2,1
18,172,172,1,1,0,1,0
26,174,174,3,3,0,1,0
23,175,175,50,50,0,1,0
11,180,180,19,19,0,1,0
27,185,185,9,9,0,1,0
2,192,192,12,4,8,2,1
8,212,212,12,1,11,2,1
6,223,223,111,111,0,1,0
5,250,250,26,26,0,1,0
7,298,298,33,33,0,1,0
13,300,300,100,48,52,4,3
20,309,309,4,4,0,1,0
19,310,310,40,18,22,2,1
3,311,311,10,10,0,1,0
12,335,335,19,11,8,3,2
0,349,349,64,17,47,2,1
17,350,350,36,12,24,4,3
16,363,363,83,83,0,1,0
10,363,363,45,2,43,2,1
21,370,370,18,6,12,3,2
24,380,380,33,27,6,3,2
1,381,381,5,5,0,1,0
4,395,395,29,10,19,2,1
9,414,414,100,17,83,4,3
14,416,416,10,10,0,1,0
15,460,460,91,48,43,4,3
22,464,464,8,8,0,1,0

2,113,113,8,8,0,1,0
29,142,142,6,6,0,1,0
20,147,147,11,11,0,1,0
6,163,163,14,3,11,2,1
16,171,171,24,24,0,1,0
1,187,187,6,6,0,1,0
8,213,213,27,2,25,2,1
4,221,221,38,38,0,1,0
22,222,222,13,8,5,2,1
25,251,251,7,7,0,1,0
12,266,266,5,5,0,1,0
0,285,285,18,18,0,1,0
17,306,306,38,38,0,1,0
24,321,321,25,3,22,2,1
7,336,336,1,1,0,1,0
14,337,337,27,5,22,2,1
18,382,382,20,20,0,1,0
19,394,394,62,8,54,3,2
23,394,394,92,92,0,1,0
10,395,395,27,13,14,2,1
3,395,395,44,26,18,4,3
28,402,402,31,31,0,1,0
21,421,421,159,24,135,4,3
9,437,437,118,80,38,3,2
5,442,442,104,14,90,3,2
13,450,450,84,47,37,2,1
27,455,455,7,7,0,1,0
15,456,456,13,13,0,1,0
30,462,462,23,1,22,2,1
26,482,482,48,39,9,2,1
11,498,498,38,38,0,1,0

1,130,130,22,11,11,2,1
20,131,131,10,10,0,1,0
31,148,148,27,14,13,3,2
19,149,149,21,21,0,1,0
8,153,153,1,1,0,1,0
27,206,206,6,1,5,2,1
0,222,222,8,4,4,2,1
15,252,252,59,59,0,1,0
2,255,255,2,2,0,1,0
26,264,264,58,58,0,1,0
18,280,280,15,15,0,1,0
13,283,283,31,22,9,4,3
10,300,300,4,4,0,1,0
4,303,303,7,7,0,1,0
25,314,314,49,49,0,1,0
28,323,323,30,30,0,1,0
22,323,323,54,54,0,1,0
3,324,324,8,8,0,1,0
5,325,325,60,31,29,2,1
16,329,329,1,1,0,1,0
7,373,373,108,23,85,4,3
14,374,374,23,23,0,1,0
9,376,376,91,49,42,4,3
6,383,383,6,3,3,2,1
17,400,400,50,50,0,1,0
23,400,400,13,13,0,1,0
30,410,410,29,9,20,2,1
32,411,411,32,32,0,1,0
29,415,415,58,21,37,4,3
21,426,426,5,5,0,1,0
12,432,432,24,9,15,4,3
11,463,463,58,58,0,1,0
24,475,475,24,13,11,2,1

8,107,107,47,4,43,2,1
9,133,133,2,2,0,1,0
25,150,150,25,2,23,2,1
3,167,167,10,2,8,3,2
7,167,167,26,3,23,3,2
16,195,195,22,19,3,2,1
26,222,222,5,5,0,1,0
20,239,239,27,1,26,3,2
2,258,258,15,6,9,2,1
14,268,268,9,4,5,2,1
6,272,272,35,12,23,2,1
4,275,275,20,20,0,1,0
13,280,280,10,10,0,1,0
22,287,287,16,4,12,4,3
1,336,336,87,69,18,4,3
15,358,358,20,20,0,1,0
5,362,362,9,9,0,1,0
0,374,374,80,80,0,1,0
27,383,383,25,25,0,1,0
23,389,389,21,3,18,2,1
10,393,393,32,10,22,2,1
18,406,406,45,10,35,2,1
19,411,411,100,31,69,4,3
21,413,413,59,59,0,1,0
17,414,414,73,73,0,1,0
11,422,422,27,15,12,2,1
28,424,424,33,25,8,3,2
24,455,455,74,14,60,4,3
12,479,479,14,7,7,2,1

14,113,113,5,1,4,2,1
2,122,122,23,23,0,1,0
18,136,136,11,1,10,2,1
7,140,140,4,4,0,1,0
24,148,148,1,1,0,1,0
6,149,149,26,17,9,2,1
10,174,174,7,4,3,2,1
21,206,206,24,24,0,1,0
4,212,212,14,9,5,2,1
20,221,221,40,22,18,2,1
16,228,228,17,17,0,1,0
11,241,241,123,53,70,3,2
12,241,241,35,24,11,2,1
0,255,255,30,7,23,3,2
22,267,267,17,12,5,2,1
28,295,295,96,76,20,3,2
27,299,299,1,1,0,1,0
5,326,326,5,5,0,1,0
19,357,357,1,1,0,1,0
17,377,377,73,73,0,1,0
26,378,378,3,3,0,1,0
8,389,389,8,8,0,1,0
1,409,409,39,6,33,2,1
15,412,412,69,63,6,3,2
23,469,469,12,1,11,2,1
9,477,477,52,32,20,4,3
13,492,492,148,124,24,3,2
25,494,494,17,3,14,2,1
3,496,496,45,45,0,1,0

32,101,101,10,10,0,1,0
23,112,112,21,9,12,2,1
12,119,119,2,2,0,1,0
11,133,133,2,2,0,1,0
26,170,170,26,26,0,1,0
0,200,200,1,1,0,1,0
24,212,212,13,9,4,2,1
22,221,221,3,3,0,1,0
14,249,249,14,10,4,2,1
25,266,266,13,13,0,1,0
10,272,272,6,6,0,1,0
6,274,274,24,4,20,4,3
29,281,281,71,28,43,2,1
34,289,289,1,1,0,1,0
33,289,289,67,67,0,1,0
30,290,290,7,3,4,2,1
8,294,294,11,3,8,3,2
4,300,300,5,5,0,1,0
5,300,300,14,6,8,3,2
18,313,313,4,4,0,1,0
7,321,321,7,1,6,3,2
9,337,337,159,159,0,1,0
13,342,342,16,8,8,2,1
15,364,364,12,7,5,2,1
19,367,367,23,23,0,1,0
20,369,369,19,7,12,4,3
31,370,370,16,16,0,1,0
21,385,385,57,57,0,1,0
2,386,386,84,43,41,4,3
17,395,395,6,6,0,1,0
1,433,433,101,5,96,4,3
27,444,444,104,54,50,2,1
16,446,446,46,2,44,4,3
3,454,454,65,65,0,1,0
28,470,470,8,8,0,1,0

11,105,105,14,14,0,1,0
0,109,109,9,5,4,2,1
17,124,124,2,2,0,1,0
14,124,124,8,3,5,2,1
18,124,124,13,13,0,1,0
30,130,130,2,2,0,1,0
25,135,135,5,5,0,1,0
15,150,150,17,11,6,2,1
2,158,158,41,41,0,1,0
29,168,168,26,22,4,2,1
23,171,171,5,5,0,1,0
9,195,195,21,21,0,1,0
10,224,224,11,11,0,1,0
3,225,225,1,1,0,1,0
24,228,228,21,12,9,4,3
33,241,241,48,48,0,1,0
7,261,261,20,20,0,1,0
1,277,277,2,2,0,1,0
16,286,286,1,1,0,1,0
8,288,288,5,5,0,1,0
27,293,293,2,2,0,1,0
5,309,309,17,10,7,2,1
21,347,347,56,42,14,2,1
32,355,355,10,6,4,2,1
12,371,371,38,32,6,2,1
19,374,374,24,24,0,1,0
22,375,375,14,14,0,1,0
35,396,396,35,35,0,1,0
34,408,408,82,82,0,1,0
28,427,427,103,103,0,1,0
4,465,465,62,44,18,4,3
31,471,471,49,1,48,4,3
13,473,473,28,28,0,1,0
26,483,483,72,18,54,3,2
20,489,489,42,42,0,1,0
6,496,496,73,73,0,1,0

26,103,103,3,3,0,1,0
2,131,131,8,8,0,1,0
0,135,135,25,25,0,1,0
30,156,156,32,32,0,1,0
10,157,157,4,4,0,1,0
28,159,159,11,11,0,1,0
4,187,187,40,19,21,4,3
7,198,198,25,25,0,1,0
1,205,205,11,7,4,2,1
25,213,213,5,5,0,1,0
29,237,237,47,47,0,1,0
12,279,279,38,32,6,3,2
20,282,282,22,1,21,4,3
19,293,293,39,39,0,1,0
23,295,295,35,35,0,1,0
11,312,312,7,7,0,1,0
8,315,315,1,1,0,1,0
16,319,319,8,8,0,1,0
14,332,332,160,19,141,4,3
24,345,345,12,3,9,4,3
27,351,351,4,4,0,1,0
17,360,360,70,70,0,1,0
18,368,368,5,5,0,1,0
22,369,369,38,5,33,4,3
9,382,382,24,8,16,3,2
3,397,397,4,4,0,1,0
21,428,428,5,5,0,1,0
15,452,452,171,94,77,4,3
13,466,466,14,2,12,3,2
6,470,470,72,31,41,2,1
5,487,487,17,17,0,1,0

14,128,128,14,7,7,2,1
1,139,139,33,3,30,2,1
7,141,141,1,1,0,1,0
8,165,165,19,19,0,1,0
4,175,175,43,16,27,4,3
29,177,177,5,5,0,1,0
2,179,179,28,28,0,1,0
28,189,189,13,13,0,1,0
27,190,190,13,13,0,1,0
26,205,205,13,13,0,1,0
20,214,214,15,15,0,1,0
10,229,229,3,3,0,1,0
22,237,237,30,30,0,1,0
18,244,244,5,5,0,1,0
25,270,270,8,8,0,1,0
11,292,292,27,27,0,1,0
21,294,294,60,60,0,1,0
19,294,294,8,8,0,1,0
17,295,295,2,2,0,1,0
16,307,307,100,64,36,4,3
6,313,313,11,3,8,2,1
23,319,319,17,17,0,1,0
30,336,336,3,3,0,1,0
0,342,342,81,81,0,1,0
31,378,378,183,99,84,4,3
15,380,380,30,18,12,4,3
3,412,412,6,6,0,1,0
13,436,436,35,35,0,1,0
9,440,440,29,23,6,2,1
12,467,467,40,40,0,1,0
5,492,492,14,5,9,4,3
24,500,500,21,21,0,1,0

16,102,102,3,3,0,1,0
27,103,103,21,21,0,1,0
29,141,141,4,4,0,1,0
10,173,173,7,7,0,1,0
32,215,215,14,14,0,1,0
22,220,220,2,2,0,1,0
35,230,230,45,45,0,1,0
3,246,246,46,8,38,3,2
30,248,248,19,10,9,4,3
33,262,262,30,30,0,1,0
31,283,283,9,3,6,3,2
14,285,285,16,6,10,3,2
11,299,299,9,6,3,2,1
8,305,305,29,5,24,4,3
7,309,309,43,43,0,1,0
5,309,309,24,24,0,1,0
15,312,312,6,6,0,1,0
20,321,321,24,24,0,1,0
17,328,328,53,53,0,1,0
13,329,329,77,77,0,1,0
4,358,358,14,14,0,1,0
34,363,363,15,15,0,1,0
28,370,370,23,6,17,2,1
24,376,376,15,15,0,1,0
18,383,383,9,9,0,1,0
36,389,389,21,21,0,1,0
1,389,389,11,2,9,2,1
25,395,395,131,73,58,4,3
19,401,401,6,6,0,1,0
0,405,405,19,19,0,1,0
6,414,414,9,9,0,1,0
26,428,428,66,66,0,1,0
21,442,442,74,74,0,1,0
9,445,445,68,32,36,2,1
2,447,447,42,42,0,1,0
23,467,467,27,9,18,3,2
12,476,476,17,9,8,3,2

6,106,106,1,1,0,1,0
10,126,126,1,1,0,1,0
24,144,144,12,8,4,2,1
25,153,153,14,8,6,2,1
12,171,171,59,23,36,4,3
7,184,184,12,12,0,1,0
13,211,211,31,1,30,2,1
27,235,235,67,43,24,4,3
21,293,293,25,25,0,1,0
11,294,294,12,12,0,1,0
15,303,303,15,6,9,4,3
5,327,327,103,16,87,4,3
28,328,328,49,49,0,1,0
22,330,330,11,8,3,2,1
8,335,335,4,1,3,2,1
0,346,346,84,27,57,4,3
3,348,348,72,72,0,1,0
26,361,361,16,16,0,1,0
2,370,370,35,11,24,3,2
16,377,377,54,54,0,1,0
14,393,393,35,35,0,1,0
19,394,394,28,10,18,3,2
18,395,395,34,34,0,1,0
17,401,401,30,21,9,4,3
23,419,419,4,1,3,2,1
4,420,420,74,2,72,3,2
1,451,451,25,25,0,1,0
9,479,479,15,15,0,1,0
20,493,493,89,44,45,4,3

1,109,109,2,2,0,1,0
5,125,125,1,1,0,1,0
18,130,130,12,12,0,1,0
14,140,140,15,15,0,1,0
33,149,149,5,5,0,1,0
37,190,190,22,16,6,2,1
15,192,192,1,1,0,1,0
13,213,213,6,6,0,1,0
20,220,220,5,5,0,1,0
21,227,227,10,10,0,1,0
7,253,253,9,5,4,2,1
17,269,269,4,4,0,1,0
35,272,272,35,11,24,4,3
3,286,286,36,36,0,1,0
11,304,304,15,15,0,1,0
16,306,306,3,3,0,1,0
29,306,306,34,2,32,3,2
12,331,331,50,50,0,1,0
26,347,347,12,12,0,1,0
4,354,354,44,10,34,3,2
34,366,366,4,4,0,1,0
32,382,382,39,39,0,1,0
0,395,395,12,12,0,1,0
31,395,395,86,44,42,3,2
25,397,397,17,17,0,1,0
6,398,398,86,86,0,1,0
10,400,400,38,38,0,1,0
22,407,407,34,34,0,1,0
27,421,421,79,31,48,2,1
30,450,450,112,112,0,1,0
23,458,458,67,67,0,1,0
8,459,459,81,81,0,1,0
19,469,469,18,9,9,4,3
28,470,470,5,5,0,1,0
24,477,477,37,37,0,1,0
36,487,487,36,13,23,2,1
2,489,489,79,79,0,1,0
9,490,490,24,24,0,1,0

33,103,103,17,17,0,1,0
2,120,120,6,3,3,2,1
43,139,139,50,6,44,3,2
5,140,140,1,1,0,1,0
25,148,148,4,4,0,1,0
28,149,149,7,7,0,1,0
17,150,150,13,13,0,1,0
11,152,152,2,2,0,1,0
30,158,158,3,3,0,1,0
8,162,162,5,5,0,1,0
4,164,164,2,2,0,1,0
15,172,172,1,1,0,1,0
9,177,177,2,2,0,1,0
22,177,177,5,5,0,1,0
21,179,179,1,1,0,1,0
0,206,206,10,10,0,1,0
14,219,219,8,8,0,1,0
16,228,228,7,7,0,1,0
34,238,238,12,12,0,1,0
7,239,239,47,37,10,2,1
18,252,252,1,1,0,1,0
26,275,275,13,8,5,2,1
29,283,283,48,15,33,4,3
41,285,285,8,8,0,1,0
1,299,299,29,4,25,3,2
24,303,303,54,54,0,1,0
39,304,304,60,44,16,3,2
20,310,310,24,24,0,1,0
31,316,316,38,10,28,3,2
27,322,322,41,20,21,4,3
36,324,324,2,2,0,1,0
10,327,327,15,7,8,2,1
35,334,334,4,4,0,1,0
3,346,346,19,19,0,1,0
38,392,392,3,3,0,1,0
37,418,418,63,63,0,1,0
6,420,420,41,41,0,1,0
19,428,428,19,7,12,4,3
12,433,433,11,11,0,1,0
13,450,450,69,69,0,1,0
23,454,454,26,13,13,2,1
40,457,457,29,29,0,1,0
32,486,486,72,72,0,1,0
42,494,494,45,10,35,2,1

3,109,109,13,13,0,1,0
33,114,114,14,5,9,4,3
26,130,130,2,2,0,1,0
21,131,131,12,6,6,3,2
34,136,136,8,8,0,1,0
5,155,155,9,9,0,1,0
12,163,163,9,4,5,2,1
2,164,164,3,3,0,1,0
18,173,173,2,2,0,1,0
8,179,179,58,48,10,3,2
9,186,186,23,15,8,2,1
27,202,202,31,2,29,4,3
14,216,216,2,2,0,1,0
22,232,232,37,37,0,1,0
15,243,243,35,13,22,3,2
20,247,247,59,59,0,1,0
29,248,248,27,7,20,3,2
6,250,250,33,16,17,2,1
13,253,253,42,42,0,1,0
16,257,257,16,16,0,1,0
7,280,280,17,17,0,1,0
17,289,289,1,1,0,1,0
11,294,294,52,7,45,4,3
32,304,304,38,3,35,2,1
31,325,325,50,50,0,1,0
23,334,334,8,8,0,1,0
28,337,337,41,9,32,3,2
4,356,356,1,1,0,1,0
24,397,397,1,1,0,1,0
25,436,436,11,11,0,1,0
10,448,448,54,6,48,4,3
19,464,464,71,29,42,3,2
30,480,480,37,37,0,1,0
1,485,485,2,2,0,1,0
0,494,494,4,4,0,1,0

19,106,106,33,33,0,1,0
20,111,111,6,2,4,2,1
8,118,118,11,11,0,1,0
12,126,126,13,13,0,1,0
0,143,143,9,4,5,2,1
23,158,158,16,4,12,4,3
16,190,190,18,6,12,2,1
4,201,201,1,1,0,1,0
21,223,223,11,11,0,1,0
22,226,226,3,3,0,1,0
29,252,252,110,104,6,2,1
26,267,267,2,2,0,1,0
18,283,283,30,30,0,1,0
3,317,317,23,3,20,4,3
27,319,319,41,41,0,1,0
9,326,326,135,23,112,4,3
7,354,354,38,5,33,4,3
15,369,369,19,19,0,1,0
2,378,378,58,58,0,1,0
17,383,383,2,2,0,1,0
14,404,404,12,4,8,3,2
6,408,408,36,36,0,1,0
5,431,431,34,34,0,1,0
24,431,431,38,24,14,3,2
28,446,446,38,17,21,4,3
25,453,453,31,31,0,1,0
11,475,475,6,6,0,1,0
1,488,488,84,84,0,1,0
13,490,490,75,33,42,2,1
10,497,497,42,42,0,1,0

22,107,107,21,21,0,1,0
0,112,112,23,23,0,1,0
7,116,116,9,9,0,1,0
26,132,132,9,9,0,1,0
21,135,135,2,2,0,1,0
9,169,169,19,1,18,4,3
27,171,171,27,27,0,1,0
6,175,175,4,4,0,1,0
16,195,195,14,14,0,1,0
19,195,195,3,3,0,1,0
17,205,205,20,6,14,3,2
5,226,226,18,3,15,4,3
10,241,241,1,1,0,1,0
8,250,250,13,13,0,1,0
25,261,261,7,7,0,1,0
24,262,262,2,2,0,1,0
14,278,278,9,9,0,1,0
18,297,297,28,11,17,2,1
3,313,313,1,1,0,1,0
2,321,321,71,71,0,1,0
4,330,330,24,6,18,3,2
31,349,349,179,35,144,4,3
1,356,356,75,42,33,2,1
30,362,362,4,4,0,1,0
15,376,376,111,9,102,4,3
28,385,385,6,6,0,1,0
13,400,400,5,5,0,1,0
20,401,401,80,80,0,1,0
29,414,414,39,39,0,1,0
23,423,423,20,20,0,1,0
11,469,469,88,25,63,4,3
12,491,491,6,6,0,1,0

9,109,109,7,1,6,3,2
12,130,130,25,15,10,3,2
18,132,132,5,5,0,1,0
0,160,160,2,2,0,1,0
7,171,171,1,1,0,1,0
14,190,190,19,6,13,2,1
31,196,196,16,1,15,2,1
5,196,196,10,4,6,3,2
20,198,198,11,7,4,2,1
8,232,232,10,2,8,3,2
26,242,242,16,6,10,2,1
16,270,270,65,65,0,1,0
28,274,274,15,6,9,4,3
6,282,282,35,15,20,3,2
25,282,282,26,26,0,1,0
21,294,294,9,9,0,1,0
30,297,297,10,10,0,1,0
29,298,298,20,6,14,2,1
13,310,310,45,7,38,2,1
27,322,322,86,73,13,4,3
17,349,349,48,48,0,1,0
24,381,381,35,1,34,2,1
1,381,381,2,2,0,1,0
2,391,391,28,9,19,2,1
3,392,392,71,11,60,4,3
19,393,393,42,42,0,1,0
23,419,419,32,5,27,4,3
4,459,459,145,145,0,1,0
22,474,474,94,94,0,1,0
15,479,479,58,58,0,1,0
10,479,479,61,25,36,4,3
11,487,487,20,17,3,2,1

16,113,113,31,7,24,3,2
14,145,145,45,23,22,3,2
24,149,149,10,10,0,1,0
23,150,150,53,53,0,1,0
34,153,153,9,3,6,2,1
1,170,170,3,3,0,1,0
27,197,197,21,13,8,2,1
21,197,197,3,3,0,1,0
35,198,198,87,17,70,4,3
2,198,198,7,7,0,1,0
25,231,231,19,19,0,1,0
13,232,232,1,1,0,1,0
28,269,269,42,42,0,1,0
4,270,270,31,31,0,1,0
22,307,307,17,17,0,1,0
18,328,328,27,27,0,1,0
0,333,333,1,1,0,1,0
9,353,353,62,57,5,2,1
5,364,364,36,4,32,3,2
11,373,373,13,3,10,3,2
29,376,376,52,52,0,1,0
6,382,382,13,5,8,3,2
26,388,388,7,1,6,2,1
10,399,399,7,7,0,1,0
32,402,402,3,3,0,1,0
15,402,402,9,9,0,1,0
3,407,407,11,11,0,1,0
30,429,429,9,9,0,1,0
19,440,440,48,30,18,3,2
33,450,450,3,3,0,1,0
7,460,460,66,55,11,4,3
17,464,464,13,13,0,1,0
31,465,465,18,6,12,3,2
12,468,468,12,2,10,3,2
8,471,471,20,20,0,1,0
20,474,474,31,10,21,4,3

0,113,113,4,4,0,1,0
27,122,122,2,2,0,1,0
36,130,130,23,23,0,1,0
35,133,133,21,7,14,2,1
15,142,142,25,25,0,1,0
4,150,150,6,3,3,2,1
17,158,158,2,2,0,1,0
29,159,159,10,10,0,1,0
20,171,171,20,11,9,4,3
14,177,177,17,1,16,2,1
18,178,178,23,5,18,3,2
1,181,181,2,2,0,1,0
22,190,190,5,5,0,1,0
43,222,222,12,4,8,2,1
5,255,255,11,11,0,1,0
26,268,268,10,1,9,4,3
13,268,268,12,12,0,1,0
11,274,274,37,22,15,4,3
32,289,289,33,33,0,1,0
6,292,292,1,1,0,1,0
31,311,311,33,33,0,1,0
23,320,320,1,1,0,1,0
9,340,340,4,4,0,1,0
7,344,344,21,21,0,1,0
8,351,351,66,66,0,1,0
21,353,353,6,6,0,1,0
19,368,368,15,7,8,3,2
2,369,369,1,1,0,1,0
38,383,383,63,51,12,3,2
10,385,385,24,18,6,3,2
34,388,388,28,28,0,1,0
28,391,391,12,4,8,3,2
40,393,393,43,43,0,1,0
25,401,401,1,1,0,1,0
3,418,418,64,20,44,2,1
39,436,436,21,21,0,1,0
16,438,438,3,3,0,1,0
37,447,447,47,47,0,1,0
42,452,452,164,164,0,1,0
24,454,454,43,43,0,1,0
30,462,462,17,4,13,2,1
41,464,464,7,1,6,2,1
12,473,473,16,7,9,4,3
33,497,497,4,4,0,1,0

5,101,101,1,1,0,1,0
25,117,117,22,7,15,2,1
20,119,119,16,16,0,1,0
4,124,124,1,1,0,1,0
8,151,151,8,8,0,1,0
14,164,164,23,4,19,2,1
1,165,165,23,23,0,1,0
3,165,165,3,3,0,1,0
24,194,194,6,3,3,2,1
13,194,194,4,4,0,1,0
10,214,214,4,4,0,1,0
26,219,219,4,4,0,1,0
19,278,278,27,21,6,3,2
28,294,294,36,36,0,1,0
7,304,304,206,164,42,4,3
15,330,330,2,2,0,1,0
6,358,358,8,8,0,1,0
23,359,359,10,10,0,1,0
12,362,362,49,49,0,1,0
18,367,367,16,16,0,1,0
21,367,367,37,37,0,1,0
9,378,378,22,22,0,1,0
27,379,379,51,36,15,4,3
2,382,382,42,4,38,3,2
16,386,386,21,21,0,1,0
17,407,407,102,64,38,3,2
11,466,466,43,40,3,2,1
0,470,470,121,121,0,1,0
22,493,493,132,112,20,2,1

20,100,100,9,9,0,1,0
3,119,119,10,10,0,1,0
10,121,121,4,1,3,2,1
22,130,130,3,3,0,1,0
35,148,148,1,1,0,1,0
7,155,155,5,5,0,1,0
25,157,157,26,3,23,3,2
24,191,191,36,28,8,2,1
33,198,198,2,2,0,1,0
14,206,206,21,21,0,1,0
36,217,217,64,64,0,1,0
19,250,250,1,1,0,1,0
11,264,264,1,1,0,1,0
34,268,268,6,6,0,1,0
31,271,271,36,36,0,1,0
6,272,272,50,34,16,2,1
4,289,289,5,5,0,1,0
12,314,314,77,77,0,1,0
28,316,316,60,29,31,4,3
18,328,328,26,13,13,2,1
26,344,344,28,28,0,1,0
32,345,345,13,2,11,2,1
15,348,348,11,2,9,2,1
16,368,368,10,10,0,1,0
0,371,371,42,42,0,1,0
9,372,372,29,11,18,3,2
1,384,384,28,9,19,4,3
29,407,407,68,16,52,3,2
13,415,415,48,48,0,1,0
2,418,418,6,6,0,1,0
23,419,419,2,2,0,1,0
17,424,424,37,33,4,2,1
5,432,432,8,8,0,1,0
27,437,437,51,23,28,2,1
30,441,441,51,27,24,3,2
21,481,481,35,35,0,1,0
8,499,499,85,5,80,3,2

14,151,151,21,5,16,2,1
10,167,167,31,31,0,1,0
17,172,172,11,11,0,1,0
8,187,187,17,17,0,1,0
28,190,190,2,2,0,1,0
27,198,198,20,20,0,1,0
12,200,200,2,2,0,1,0
23,200,200,47,47,0,1,0
18,205,205,18,18,0,1,0
11,205,205,21,7,14,2,1
9,272,272,4,4,0,1,0
21,284,284,24,24,0,1,0
4,284,284,2,2,0,1,0
2,288,288,157,129,28,3,2
26,295,295,18,5,13,2,1
25,299,299,48,48,0,1,0
20,309,309,47,38,9,2,1
16,311,311,2,2,0,1,0
15,323,323,9,9,0,1,0
22,331,331,87,87,0,1,0
6,370,370,82,70,12,4,3
19,377,377,6,6,0,1,0
24,382,382,57,15,42,2,1
0,414,414,30,2,28,3,2
13,444,444,22,14,8,2,1
29,450,450,34,23,11,2,1
3,478,478,27,7,20,3,2
5,481,481,51,51,0,1,0
7,487,487,62,62,0,1,0
1,498,498,6,6,0,1,0

12,119,119,16,4,12,4,3
26,135,135,90,90,0,1,0
11,149,149,21,9,12,3,2
1,160,160,3,3,0,1,0
18,160,160,2,2,0,1,0
5,195,195,1,1,0,1,0
9,200,200,3,3,0,1,0
7,207,207,1,1,0,1,0
15,211,211,39,6,33,4,3
28,213,213,4,4,0,1,0
29,215,215,13,13,0,1,0
2,262,262,3,3,0,1,0
32,272,272,12,4,8,3,2
17,287,287,55,26,29,2,1
6,296,296,15,7,8,3,2
23,299,299,15,7,8,3,2
25,315,315,11,1,10,3,2
3,321,321,1,1,0,1,0
16,326,326,1,1,0,1,0
10,343,343,166,102,64,4,3
21,345,345,8,2,6,3,2
0,349,349,5,5,0,1,0
20,367,367,1,1,0,1,0
24,383,383,2,2,0,1,0
14,384,384,47,47,0,1,0
13,400,400,6,6,0,1,0
30,428,428,24,24,0,1,0
22,430,430,15,6,9,4,3
27,442,442,40,31,9,2,1
4,449,449,170,104,66,4,3
31,470,470,126,126,0,1,0
8,485,485,7,1,6,3,2
19,487,487,33,16,17,2,1

31,120,120,9,9,0,1,0
2,133,133,4,4,0,1,0
14,145,145,2,2,0,1,0
1,160,160,4,4,0,1,0
0,167,167,31,11,20,3,2
30,177,177,5,5,0,1,0
10,182,182,4,4,0,1,0
15,185,185,4,1,3,2,1
25,190,190,37,37,0,1,0
32,231,231,14,14,0,1,0
33,239,239,19,16,3,2,1
4,247,247,20,20,0,1,0
34,267,267,43,15,28,2,1
12,268,268,132,68,64,4,3
11,276,276,24,3,21,3,2
22,297,297,24,12,12,2,1
29,310,310,79,4,75,4,3
5,313,313,1,1,0,1,0
24,314,314,37,6,31,4,3
13,325,325,34,10,24,3,2
20,327,327,6,6,0,1,0
18,332,332,61,43,18,3,2
35,343,343,29,29,0,1,0
9,344,344,20,14,6,3,2
19,359,359,5,2,3,2,1
21,368,368,5,5,0,1,0
16,390,390,8,3,5,2,1
17,392,392,2,2,0,1,0
28,395,395,15,15,0,1,0
23,397,397,59,59,0,1,0
26,438,438,40,40,0,1,0
8,450,450,39,34,5,2,1
7,461,461,40,1,39,4,3
27,465,465,82,53,29,2,1
6,476,476,24,24,0,1,0
3,482,482,15,15,0,1,0

40,108,108,5,5,0,1,0
23,112,112,1,1,0,1,0
31,144,144,2,2,0,1,0
8,162,162,3,3,0,1,0
28,179,179,34,34,0,1,0
14,186,186,16,11,5,2,1
7,191,191,1,1,0,1,0
36,197,197,28,28,0,1,0
15,208,208,20,20,0,1,0
13,214,214,12,12,0,1,0
0,228,228,11,11,0,1,0
30,236,236,25,25,0,1,0
37,249,249,12,8,4,2,1
17,270,270,2,2,0,1,0
16,274,274,2,2,0,1,0
22,291,291,1,1,0,1,0
9,300,300,23,23,0,1,0
19,303,303,2,2,0,1,0
6,305,305,51,51,0,1,0
12,316,316,9,4,5,2,1
29,318,318,11,11,0,1,0
1,334,334,10,10,0,1,0
21,339,339,27,17,10,3,2
39,387,387,43,43,0,1,0
38,387,387,7,2,5,2,1
27,414,414,9,5,4,2,1
18,414,414,10,7,3,2,1
34,419,419,8,2,6,3,2
32,424,424,17,17,0,1,0
24,430,430,17,17,0,1,0
3,438,438,78,34,44,3,2
26,443,443,51,12,39,2,1
33,445,445,44,4,40,3,2
25,446,446,179,59,120,4,3
4,447,447,22,22,0,1,0
20,464,464,161,161,0,1,0
35,480,480,104,91,13,2,1
11,481,481,19,19,0,1,0
5,487,487,18,18,0,1,0
2,488,488,78,78,0,1,0
10,495,495,1,1,0,1,0

7,116,116,19,7,12,3,2
13,126,126,20,4,16,3,2
5,135,135,3,3,0,1,0
0,135,135,36,36,0,1,0
3,141,141,12,12,0,1,0
15,142,142,25,17,8,2,1
26,156,156,18,3,15,4,3
12,161,161,2,2,0,1,0
8,161,161,4,4,0,1,0
33,164,164,22,18,4,2,1
30,201,201,38,5,33,2,1
25,204,204,17,17,0,1,0
19,210,210,7,7,0,1,0
11,246,246,1,1,0,1,0
18,250,250,35,9,26,2,1
2,258,258,13,3,10,2,1
16,265,265,14,2,12,3,2
29,285,285,63,63,0,1,0
32,288,288,38,38,0,1,0
6,308,308,51,4,47,2,1
20,315,315,46,25,21,2,1
14,317,317,28,28,0,1,0
28,343,343,20,20,0,1,0
4,350,350,62,41,21,2,1
23,371,371,12,1,11,2,1
22,384,384,8,8,0,1,0
10,399,399,25,13,12,4,3
21,408,408,35,35,0,1,0
24,431,431,40,20,20,3,2
31,441,441,49,49,0,1,0
17,443,443,24,10,14,3,2
27,450,450,12,12,0,1,0
9,476,476,3,3,0,1,0
1,480,480,14,14,0,1,0

34,136,136,14,14,0,1,0
32,140,140,8,8,0,1,0
30,147,147,24,12,12,4,3
23,147,147,16,3,13,2,1
18,163,163,8,8,0,1,0
14,169,169,6,6,0,1,0
28,170,170,2,2,0,1,0
16,171,171,7,3,4,2,1
0,176,176,39,6,33,2,1
11,176,176,30,30,0,1,0
31,179,179,10,10,0,1,0
4,190,190,8,1,7,3,2
5,198,198,32,32,0,1,0
6,208,208,20,2,18,3,2
2,222,222,17,17,0,1,0
21,224,224,17,9,8,2,1
24,244,244,1,1,0,1,0
10,286,286,8,8,0,1,0
22,294,294,21,9,12,3,2
7,298,298,16,16,0,1,0
8,308,308,4,4,0,1,0
29,317,317,13,13,0,1,0
1,337,337,34,2,32,2,1
9,363,363,21,21,0,1,0
15,367,367,41,41,0,1,0
3,381,381,2,2,0,1,0
26,399,399,119,77,42,2,1
12,424,424,39,39,0,1,0
13,425,425,101,46,55,4,3
27,435,435,28,28,0,1,0
20,440,440,45,45,0,1,0
25,441,441,94,94,0,1,0
33,468,468,106,48,58,4,3
19,494,494,19,8,11,4,3
17,497,497,4,1,3,2,1

4,130,130,44,44,0,1,0
12,134,134,3,3,0,1,0
3,145,145,29,29,0,1,0
32,149,149,7,1,6,2,1
14,150,150,41,41,0,1,0
11,155,155,3,3,0,1,0
8,180,180,1,1,0,1,0
29,190,190,3,3,0,1,0
27,203,203,9,9,0,1,0
21,203,203,12,2,10,3,2
9,257,257,7,7,0,1,0
34,259,259,2,2,0,1,0
1,271,271,67,28,39,4,3
10,283,283,10,7,3,2,1
2,287,287,9,1,8,3,2
6,310,310,35,5,30,2,1
23,322,322,26,10,16,2,1
20,324,324,24,7,17,2,1
33,336,336,48,48,0,1,0
0,359,359,1,1,0,1,0
31,378,378,37,1,36,4,3
16,397,397,5,5,0,1,0
24,419,419,113,8,105,4,3
13,421,421,6,6,0,1,0
18,424,424,24,2,22,2,1
26,434,434,91,91,0,1,0
17,438,438,26,26,0,1,0
7,440,440,7,7,0,1,0
30,440,440,20,20,0,1,0
25,442,442,8,8,0,1,0
15,450,450,21,11,10,3,2
5,461,461,37,26,11,2,1
22,466,466,138,132,6,3,2
19,470,470,12,12,0,1,0
28,498,498,96,48,48,4,3

16,100,100,4,1,3,2,1
30,100,100,1,1,0,1,0
29,115,115,11,11,0,1,0
7,124,124,1,1,0,1,0
36,133,133,2,2,0,1,0
1,171,171,6,6,0,1,0
12,175,175,2,2,0,1,0
0,208,208,3,3,0,1,0
37,208,208,3,3,0,1,0
10,247,247,25,25,0,1,0
2,247,247,18,10,8,3,2
4,250,250,25,25,0,1,0
23,263,263,19,19,0,1,0
5,267,267,1,1,0,1,0
3,268,268,4,4,0,1,0
13,289,289,43,43,0,1,0
34,291,291,67,37,30,3,2
19,291,291,1,1,0,1,0
27,306,306,26,26,0,1,0
22,310,310,18,8,10,3,2
39,324,324,13,4,9,4,3
21,332,332,113,113,0,1,0
31,350,350,9,9,0,1,0
17,351,351,19,19,0,1,0
15,352,352,36,5,31,4,3
8,355,355,8,8,0,1,0
33,366,366,19,19,0,1,0
26,371,371,96,66,30,4,3
6,378,378,22,22,0,1,0
38,383,383,21,2,19,4,3
14,387,387,10,1,9,2,1
32,406,406,164,164,0,1,0
28,412,412,2,2,0,1,0
24,413,413,9,3,6,3,2
18,415,415,41,5,36,4,3
25,423,423,52,52,0,1,0
9,424,424,1,1,0,1,0
40,426,426,46,20,26,2,1
35,446,446,49,25,24,3,2
11,449,449,22,10,12,3,2
20,486,486,69,43,26,3,2

26,109,109,7,4,3,2,1
0,116,116,11,11,0,1,0
32,127,127,10,10,0,1,0
5,167,167,21,6,15,4,3
17,172,172,61,61,0,1,0
10,188,188,4,4,0,1,0
18,214,214,17,2,15,4,3
23,217,217,17,3,14,2,1
20,219,219,31,31,0,1,0
14,221,221,26,1,25,4,3
15,225,225,38,6,32,3,2
3,254,254,3,3,0,1,0
9,274,274,63,30,33,2,1
1,289,289,19,6,13,2,1
11,292,292,85,85,0,1,0
29,300,300,60,60,0,1,0
8,309,309,11,11,0,1,0
21,322,322,38,38,0,1,0
6,338,338,4,4,0,1,0
22,350,350,4,4,0,1,0
25,352,352,2,2,0,1,0
12,354,354,41,1,40,2,1
19,355,355,15,15,0,1,0
7,360,360,7,3,4,2,1
28,366,366,37,37,0,1,0
27,375,375,57,35,22,4,3
4,402,402,26,26,0,1,0
24,404,404,53,53,0,1,0
16,432,432,49,7,42,4,3
13,434,434,34,15,19,2,1
30,435,435,15,15,0,1,0
2,442,442,15,4,11,4,3
31,499,499,17,17,0,1,0

23,100,100,47,47,0,1,0
25,111,111,7,1,6,2,1
2,117,117,1,1,0,1,0
1,137,137,26,26,0,1,0
27,144,144,1,1,0,1,0
3,156,156,22,19,3,2,1
4,156,156,1,1,0,1,0
0,167,167,5,5,0,1,0
32,189,189,1,1,0,1,0
9,207,207,5,5,0,1,0
11,218,218,24,2,22,2,1
29,257,257,48,48,0,1,0
31,275,275,5,5,0,1,0
17,291,291,22,22,0,1,0
30,307,307,8,8,0,1,0
10,324,324,49,43,6,3,2
8,333,333,24,24,0,1,0
18,336,336,12,12,0,1,0
14,341,341,41,14,27,2,1
24,347,347,43,33,10,2,1
6,365,365,8,8,0,1,0
5,369,369,22,22,0,1,0
26,407,407,45,1,44,2,1
15,415,415,39,26,13,2,1
12,417,417,46,31,15,4,3
7,418,418,136,68,68,3,2
28,421,421,77,22,55,4,3
33,423,423,10,10,0,1,0
19,438,438,42,42,0,1,0
22,451,451,23,3,20,2,1
13,452,452,8,8,0,1,0
16,464,464,21,9,12,4,3
20,481,481,39,7,32,3,2
21,488,488,74,74,0,1,0

20,101,101,7,7,0,1,0
27,119,119,7,7,0,1,0
23,119,119,29,17,12,3,2
7,123,123,3,3,0,1,0
21,140,140,1,1,0,1,0
9,164,164,5,1,4,2,1
12,168,168,1,1,0,1,0
25,173,173,78,20,58,3,2
1,186,186,17,17,0,1,0
22,192,192,12,7,5,2,1
16,230,230,25,25,0,1,0
6,246,246,45,45,0,1,0
8,313,313,29,21,8,3,2
13,326,326,42,42,0,1,0
5,337,337,66,6,60,3,2
17,361,361,15,7,8,2,1
18,361,361,71,18,53,4,3
2,371,371,29,9,20,2,1
24,373,373,25,25,0,1,0
15,376,376,9,9,0,1,0
19,384,384,7,7,0,1,0
4,386,386,5,5,0,1,0
26,415,415,60,26,34,3,2
14,417,417,9,9,0,1,0
11,441,441,66,66,0,1,0
10,461,461,193,193,0,1,0
0,475,475,31,31,0,1,0
3,487,487,126,42,84,3,2

17,100,100,11,2,9,4,3
15,103,103,6,1,5,2,1
25,122,122,17,17,0,1,0
30,129,129,17,17,0,1,0
8,136,136,4,4,0,1,0
31,157,157,21,21,0,1,0
1,165,165,8,8,0,1,0
7,176,176,5,5,0,1,0
22,186,186,8,8,0,1,0
26,191,191,25,13,12,4,3
29,207,207,8,2,6,3,2
4,217,217,30,5,25,2,1
24,220,220,14,2,12,3,2
18,220,220,87,42,45,2,1
5,221,221,15,15,0,1,0
3,227,227,9,9,0,1,0
12,238,238,21,21,0,1,0
6,239,239,2,2,0,1,0
2,266,266,10,10,0,1,0
16,274,274,72,50,22,2,1
14,299,299,67,16,51,4,3
10,309,309,55,55,0,1,0
11,312,312,4,4,0,1,0
13,324,324,57,46,11,2,1
23,353,353,14,14,0,1,0
32,373,373,34,23,11,2,1
0,384,384,73,43,30,4,3
28,425,425,45,45,0,1,0
21,436,436,36,36,0,1,0
27,454,454,30,30,0,1,0
20,461,461,10,10,0,1,0
9,476,476,7,7,0,1,0
19,480,480,20,5,15,4,3

11,126,126,13,13,0,1,0
4,157,157,65,14,51,4,3
14,159,159,24,24,0,1,0
24,176,176,45,30,15,4,3
7,190,190,1,1,0,1,0
23,192,192,15,15,0,1,0
10,234,234,1,1,0,1,0
25,255,255,41,15,26,3,2
18,265,265,22,22,0,1,0
1,275,275,34,9,25,2,1
13,279,279,53,53,0,1,0
3,306,306,48,48,0,1,0
29,314,314,27,11,16,3,2
8,323,323,10,10,0,1,0
27,328,328,105,60,45,4,3
0,336,336,4,4,0,1,0
16,345,345,17,17,0,1,0
5,350,350,78,5,73,4,3
9,353,353,81,81,0,1,0
22,362,362,21,21,0,1,0
28,367,367,3,3,0,1,0
19,376,376,20,20,0,1,0
17,388,388,9,9,0,1,0
6,391,391,15,15,0,1,0
26,393,393,33,3,30,3,2
2,399,399,17,17,0,1,0
20,407,407,7,7,0,1,0
12,449,449,12,12,0,1,0
15,461,461,74,74,0,1,0
21,479,479,15,3,12,4,3

10,116,116,3,3,0,1,0
3,130,130,4,1,3,2,1
9,134,134,3,3,0,1,0
2,147,147,21,21,0,1,0
36,158,158,55,55,0,1,0
14,168,168,12,12,0,1,0
8,169,169,14,14,0,1,0
25,187,187,1,1,0,1,0
20,197,197,6,6,0,1,0
11,232,232,1,1,0,1,0
26,245,245,2,2,0,1,0
23,259,259,22,22,0,1,0
5,304,304,53,44,9,4,3
13,304,304,10,10,0,1,0
4,324,324,38,10,28,4,3
7,331,331,7,1,6,3,2
12,334,334,9,1,8,3,2
15,341,341,39,39,0,1,0
31,344,344,70,20,50,3,2
16,361,361,99,31,68,3,2
6,364,364,12,12,0,1,0
35,371,371,18,7,11,4,3
27,399,399,10,10,0,1,0
17,417,417,18,6,12,2,1
28,418,418,24,24,0,1,0
0,423,423,94,68,26,3,2
1,426,426,2,2,0,1,0
34,426,426,18,18,0,1,0
18,436,436,14,14,0,1,0
29,442,442,104,4,100,3,2
22,450,450,9,9,0,1,0
33,453,453,46,46,0,1,0
24,470,470,9,9,0,1,0
32,476,476,70,18,52,3,2
21,485,485,45,31,14,2,1
19,493,493,48,48,0,1,0
30,496,496,88,88,0,1,0

29,125,125,41,41,0,1,0
23,126,126,19,7,12,4,3
2,146,146,15,15,0,1,0
7,148,148,16,16,0,1,0
24,157,157,22,22,0,1,0
12,168,168,27,27,0,1,0
0,183,183,24,18,6,2,1
5,215,215,2,2,0,1,0
13,224,224,27,5,22,3,2
16,238,238,5,5,0,1,0
4,256,256,24,24,0,1,0
3,260,260,23,11,12,3,2
10,283,283,4,4,0,1,0
19,289,289,9,9,0,1,0
28,290,290,1,1,0,1,0
21,291,291,3,3,0,1,0
27,292,292,83,8,75,3,2
30,294,294,41,10,31,2,1
26,303,303,67,67,0,1,0
9,314,314,55,55,0,1,0
15,332,332,37,1,36,3,2
31,340,340,2,2,0,1,0
11,354,354,31,16,15,2,1
8,375,375,11,7,4,2,1
14,378,378,112,43,69,3,2
1,391,391,6,2,4,2,1
25,397,397,11,4,7,2,1
17,408,408,17,8,9,2,1
20,416,416,46,15,31,3,2
18,426,426,21,21,0,1,0
22,463,463,34,34,0,1,0
6,495,495,29,29,0,1,0

13,101,101,4,1,3,2,1
16,106,106,1,1,0,1,0
31,111,111,8,8,0,1,0
8,119,119,9,3,6,2,1
26,131,131,14,14,0,1,0
27,149,149,8,8,0,1,0
11,152,152,35,30,5,2,1
3,167,167,1,1,0,1,0
18,168,168,23,11,12,4,3
22,168,168,70,70,0,1,0
30,172,172,16,6,10,2,1
1,194,194,60,39,21,2,1
10,202,202,10,10,0,1,0
33,203,203,2,2,0,1,0
20,220,220,2,2,0,1,0
0,236,236,53,4,49,2,1
14,238,238,21,21,0,1,0
32,245,245,31,31,0,1,0
9,252,252,6,6,0,1,0
4,261,261,13,1,12,4,3
7,269,269,23,23,0,1,0
12,275,275,15,15,0,1,0
25,338,338,19,19,0,1,0
23,354,354,12,12,0,1,0
19,362,362,38,30,8,3,2
2,364,364,23,17,6,2,1
5,402,402,34,34,0,1,0
6,424,424,7,7,0,1,0
28,428,428,35,35,0,1,0
34,435,435,60,50,10,2,1
21,435,435,41,26,15,2,1
24,460,460,56,53,3,2,1
15,467,467,12,9,3,2,1
29,472,472,54,42,12,4,3
17,472,472,15,15,0,1,0

20,110,110,5,5,0,1,0
25,123,123,33,12,21,3,2
16,137,137,1,1,0,1,0
14,146,146,21,21,0,1,0
24,172,172,22,1,21,4,3
27,202,202,30,30,0,1,0
28,205,205,9,5,4,2,1
18,207,207,29,17,12,2,1
35,213,213,4,4,0,1,0
12,240,240,2,2,0,1,0
9,246,246,28,28,0,1,0
26,254,254,35,17,18,3,2
5,260,260,8,4,4,2,1
17,274,274,25,16,9,2,1
4,277,277,32,32,0,1,0
7,277,277,43,43,0,1,0
3,289,289,3,3,0,1,0
32,311,311,38,38,0,1,0
22,313,313,24,24,0,1,0
8,347,347,18,9,9,3,2
19,349,349,44,8,36,4,3
34,355,355,20,9,11,2,1
29,371,371,11,11,0,1,0
21,389,389,34,34,0,1,0
23,394,394,39,39,0,1,0
0,398,398,44,18,26,3,2
30,420,420,7,7,0,1,0
1,423,423,3,3,0,1,0
6,443,443,27,12,15,4,3
10,452,452,10,10,0,1,0
31,455,455,42,10,32,3,2
13,458,458,40,8,32,2,1
15,460,460,59,11,48,3,2
33,471,471,28,1,27,2,1
11,472,472,48,48,0,1,0
36,479,479,119,119,0,1,0
2,481,481,24,24,0,1,0

9,122,122,11,11,0,1,0
4,136,136,9,4,5,2,1
12,148,148,11,11,0,1,0
15,151,151,13,13,0,1,0
36,158,158,16,1,15,4,3
18,160,160,11,11,0,1,0
13,182,182,1,1,0,1,0
32,186,186,10,10,0,1,0
1,194,194,1,1,0,1,0
11,198,198,3,3,0,1,0
19,201,201,15,15,0,1,0
29,216,216,2,2,0,1,0
3,237,237,74,74,0,1,0
34,247,247,1,1,0,1,0
37,250,250,8,8,0,1,0
6,252,252,1,1,0,1,0
26,273,273,12,12,0,1,0
2,284,284,73,73,0,1,0
23,311,311,19,6,13,2,1
8,321,321,5,1,4,2,1
16,324,324,24,24,0,1,0
17,355,355,3,3,0,1,0
0,369,369,27,27,0,1,0
35,387,387,23,23,0,1,0
14,419,419,7,7,0,1,0
31,420,420,65,65,0,1,0
24,427,427,91,46,45,4,3
27,436,436,119,99,20,3,2
21,437,437,13,8,5,2,1
10,437,437,44,44,0,1,0
28,453,453,44,44,0,1,0
7,461,461,36,36,0,1,0
25,470,470,15,4,11,2,1
5,482,482,68,68,0,1,0
20,490,490,2,2,0,1,0
30,491,491,111,79,32,2,1
33,498,498,126,76,50,3,2
22,500,500,8,8,0,1,0

4,123,123,2,2,0,1,0
16,152,152,1,1,0,1,0
10,153,153,32,32,0,1,0
7,215,215,46,46,0,1,0
1,223,223,11,11,0,1,0
23,226,226,27,27,0,1,0
26,237,237,58,50,8,3,2
27,238,238,23,8,15,2,1
6,249,249,21,13,8,3,2
24,288,288,3,3,0,1,0
8,292,292,25,25,0,1,0
11,304,304,17,17,0,1,0
19,313,313,5,5,0,1,0
13,317,317,31,31,0,1,0
0,328,328,8,4,4,2,1
15,352,352,70,31,39,4,3
17,353,353,71,71,0,1,0
22,353,353,7,1,6,3,2
25,362,362,97,72,25,2,1
21,366,366,5,5,0,1,0
9,395,395,112,112,0,1,0
5,410,410,145,88,57,4,3
2,446,446,4,4,0,1,0
20,446,446,64,37,27,4,3
18,462,462,6,6,0,1,0
3,475,475,27,27,0,1,0
12,482,482,77,77,0,1,0
14,490,490,29,8,21,4,3
28,494,494,59,43,16,3,2

28,118,118,8,8,0,1,0
12,120,120,28,17,11,2,1
33,122,122,11,11,0,1,0
1,136,136,33,33,0,1,0
11,158,158,18,18,0,1,0
26,160,160,19,19,0,1,0
27,183,183,8,8,0,1,0
8,200,200,20,20,0,1,0
0,201,201,10,10,0,1,0
7,208,208,16,16,0,1,0
24,212,212,2,2,0,1,0
15,213,213,16,7,9,2,1
31,229,229,3,3,0,1,0
3,237,237,12,2,10,2,1
16,241,241,9,2,7,3,2
5,256,256,13,13,0,1,0
2,272,272,7,7,0,1,0
22,272,272,16,3,13,2,1
17,277,277,5,5,0,1,0
30,327,327,18,7,11,2,1
9,334,334,21,11,10,2,1
25,341,341,71,36,35,4,3
18,354,354,65,65,0,1,0
10,366,366,78,78,0,1,0
14,373,373,8,3,5,2,1
6,392,392,11,11,0,1,0
32,396,396,33,19,14,2,1
29,418,418,52,29,23,2,1
21,432,432,7,4,3,2,1
4,454,454,91,13,78,4,3
23,483,483,104,94,10,3,2
19,492,492,51,51,0,1,0
13,494,494,1,1,0,1,0
20,497,497,120,115,5,2,1

3,115,115,4,4,0,1,0
36,121,121,19,19,0,1,0
10,123,123,4,4,0,1,0
24,128,128,29,25,4,2,1
6,133,133,19,3,16,3,2
32,144,144,5,5,0,1,0
29,155,155,10,10,0,1,0
2,172,172,13,5,8,3,2
0,190,190,1,1,0,1,0
18,205,205,1,1,0,1,0
19,206,206,17,17,0,1,0
1,217,217,11,11,0,1,0
13,239,239,32,6,26,2,1
9,244,244,80,66,14,2,1
30,249,249,13,13,0,1,0
21,301,301,7,3,4,2,1
5,302,302,32,32,0,1,0
11,313,313,20,2,18,4,3
12,314,314,5,5,0,1,0
7,321,321,44,44,0,1,0
27,324,324,6,6,0,1,0
23,331,331,110,91,19,2,1
28,336,336,20,3,17,2,1
25,340,340,6,6,0,1,0
33,350,350,48,12,36,4,3
20,350,350,14,2,12,4,3
8,363,363,12,12,0,1,0
37,384,384,14,2,12,2,1
15,390,390,7,7,0,1,0
22,405,405,43,16,27,4,3
31,405,405,22,22,0,1,0
4,409,409,33,33,0,1,0
17,442,442,19,19,0,1,0
16,479,479,1,1,0,1,0
34,483,483,35,35,0,1,0
35,483,483,124,63,61,4,3
26,493,493,4,4,0,1,0
14,495,495,73,73,0,1,0

25,122,122,6,6,0,1,0
19,137,137,1,1,0,1,0
8,143,143,12,6,6,2,1
28,152,152,9,1,8,2,1
26,165,165,4,4,0,1,0
30,165,165,30,30,0,1,0
21,189,189,11,1,10,2,1
22,200,200,43,43,0,1,0
31,223,223,5,5,0,1,0
4,226,226,8,8,0,1,0
29,234,234,28,28,0,1,0
15,246,246,9,1,8,2,1
0,267,267,21,5,16,2,1
24,276,276,66,4,62,3,2
27,282,282,71,71,0,1,0
23,327,327,26,26,0,1,0
12,341,341,32,32,0,1,0
5,344,344,39,10,29,2,1
17,360,360,37,5,32,3,2
9,376,376,23,14,9,4,3
10,384,384,1,1,0,1,0
14,397,397,97,49,48,3,2
6,419,419,92,72,20,2,1
20,436,436,60,18,42,4,3
13,440,440,40,40,0,1,0
2,447,447,46,46,0,1,0
16,447,447,71,71,0,1,0
32,452,452,25,10,15,2,1
1,465,465,56,56,0,1,0
18,476,476,15,7,8,2,1
11,483,483,51,51,0,1,0
7,485,485,1,1,0,1,0
3,500,500,26,26,0,1,0

30,101,101,8,8,0,1,0
20,108,108,1,1,0,1,0
26,122,122,4,1,3,2,1
21,146,146,21,1,20,3,2
0,150,150,11,11,0,1,0
3,157,157,29,29,0,1,0
1,174,174,33,33,0,1,0
19,207,207,36,17,19,3,2
18,215,215,4,4,0,1,0
6,223,223,11,11,0,1,0
28,232,232,5,5,0,1,0
10,248,248,24,3,21,2,1
24,288,288,3,3,0,1,0
9,305,305,7,7,0,1,0
16,311,311,56,34,22,2,1
14,326,326,44,17,27,4,3
17,333,333,58,40,18,4,3
13,335,335,25,16,9,2,1
22,336,336,136,116,20,2,1
5,338,338,64,64,0,1,0
4,343,343,23,23,0,1,0
7,344,344,37,37,0,1,0
2,353,353,15,15,0,1,0
15,355,355,25,25,0,1,0
27,367,367,92,52,40,2,1
23,379,379,10,10,0,1,0
25,446,446,2,2,0,1,0
8,451,451,6,6,0,1,0
29,475,475,14,2,12,2,1
12,496,496,56,56,0,1,0
11,497,497,121,37,84,4,3

16,137,137,19,3,16,3,2
7,138,138,43,3,40,4,3
0,150,150,18,10,8,3,2
8,155,155,19,1,18,2,1
6,160,160,4,4,0,1,0
23,170,170,4,4,0,1,0
15,185,185,6,6,0,1,0
18,194,194,36,14,22,4,3
11,222,222,16,16,0,1,0
2,227,227,11,2,9,4,3
12,254,254,40,40,0,1,0
29,270,270,70,10,60,3,2
1,274,274,18,8,10,3,2
10,308,308,10,4,6,3,2
3,321,321,54,54,0,1,0
9,322,322,47,47,0,1,0
21,331,331,7,7,0,1,0
26,334,334,58,7,51,4,3
19,351,351,66,66,0,1,0
13,356,356,16,9,7,2,1
14,357,357,8,8,0,1,0
27,380,380,6,6,0,1,0
17,398,398,17,17,0,1,0
20,406,406,48,9,39,3,2
24,406,406,6,6,0,1,0
25,414,414,33,5,28,2,1
4,419,419,99,99,0,1,0
22,449,449,133,133,0,1,0
5,453,453,23,7,16,2,1
28,462,462,7,4,3,2,1

21,109,109,15,7,8,2,1
4,110,110,1,1,0,1,0
17,113,113,1,1,0,1,0
19,130,130,9,9,0,1,0
37,135,135,2,2,0,1,0
38,144,144,18,7,11,2,1
20,149,149,2,2,0,1,0
23,151,151,53,5,48,2,1
0,154,154,31,5,26,3,2
3,160,160,13,13,0,1,0
2,179,179,13,9,4,2,1
36,182,182,2,2,0,1,0
24,191,191,3,3,0,1,0
25,213,213,2,2,0,1,0
26,214,214,13,13,0,1,0
6,218,218,17,17,0,1,0
30,234,234,16,16,0,1,0
31,247,247,10,3,7,2,1
14,249,249,15,15,0,1,0
33,251,251,39,18,21,3,2
18,272,272,32,8,24,2,1
5,311,311,5,2,3,2,1
29,338,338,33,3,30,2,1
11,347,347,5,5,0,1,0
34,368,368,20,10,10,3,2
1,398,398,21,9,12,4,3
9,402,402,112,112,0,1,0
16,416,416,11,3,8,2,1
15,421,421,81,45,36,4,3
10,424,424,13,13,0,1,0
32,430,430,76,24,52,3,2
13,431,431,1,1,0,1,0
35,432,432,1,1,0,1,0
7,443,443,6,6,0,1,0
27,448,448,182,140,42,3,2
8,448,448,18,2,16,3,2
12,460,460,33,33,0,1,0
28,473,473,18,18,0,1,0
22,485,485,6,2,4,2,1

1,106,106,3,3,0,1,0
19,114,114,39,39,0,1,0
3,123,123,22,8,14,3,2
9,130,130,7,7,0,1,0
20,134,134,1,1,0,1,0
29,137,137,14,4,10,2,1
18,153,153,5,5,0,1,0
23,176,176,3,3,0,1,0
31,189,189,26,9,17,4,3
21,191,191,55,18,37,2,1
14,192,192,9,1,8,3,2
15,203,203,51,12,39,4,3
5,229,229,1,1,0,1,0
32,240,240,10,10,0,1,0
33,274,274,23,19,4,2,1
28,280,280,33,5,28,3,2
25,289,289,12,12,0,1,0
4,294,294,19,1,18,4,3
26,313,313,4,4,0,1,0
13,316,316,13,7,6,2,1
11,317,317,31,31,0,1,0
10,332,332,123,87,36,2,1
7,334,334,23,23,0,1,0
22,346,346,34,25,9,4,3
16,361,361,8,8,0,1,0
8,362,362,10,5,5,2,1
24,384,384,65,20,45,3,2
2,384,384,1,1,0,1,0
27,416,416,30,4,26,2,1
0,418,418,55,55,0,1,0
12,464,464,4,4,0,1,0
17,469,469,39,39,0,1,0
30,485,485,36,2,34,2,1
6,493,493,59,59,0,1,0

22,108,108,8,2,6,2,1
38,108,108,14,9,5,2,1
10,114,114,1,1,0,1,0
23,121,121,2,2,0,1,0
34,124,124,5,5,0,1,0
33,130,130,22,9,13,2,1
8,131,131,11,1,10,2,1
29,134,134,1,1,0,1,0
30,134,134,4,4,0,1,0
27,158,158,61,61,0,1,0
19,160,160,1,1,0,1,0
17,172,172,1,1,0,1,0
31,176,176,32,10,22,2,1
14,181,181,5,2,3,2,1
13,183,183,9,9,0,1,0
21,215,215,4,1,3,2,1
0,216,216,29,25,4,2,1
6,235,235,7,7,0,1,0
37,260,260,9,9,0,1,0
20,315,315,86,52,34,3,2
35,344,344,110,42,68,4,3
36,357,357,6,1,5,2,1
15,374,374,20,20,0,1,0
11,379,379,8,2,6,2,1
3,385,385,13,4,9,2,1
25,389,389,6,6,0,1,0
32,406,406,40,4,36,3,2
39,406,406,42,22,20,2,1
9,409,409,20,20,0,1,0
5,413,413,37,29,8,3,2
4,415,415,105,52,53,4,3
16,424,424,31,31,0,1,0
28,426,426,11,2,9,4,3
12,436,436,27,27,0,1,0
24,458,458,9,9,0,1,0
7,458,458,83,67,16,2,1
26,465,465,33,18,15,4,3
2,476,476,7,4,3,2,1
1,490,490,19,16,3,2,1
18,493,493,4,4,0,1,0

22,100,100,1,1,0,1,0
0,105,105,2,2,0,1,0
30,108,108,7,7,0,1,0
7,138,138,69,69,0,1,0
25,138,138,3,3,0,1,0
21,143,143,23,20,3,2,1
5,161,161,14,14,0,1,0
23,165,165,4,4,0,1,0
15,169,169,36,20,16,3,2
16,173,173,26,14,12,2,1
18,185,185,20,13,7,2,1
11,191,191,1,1,0,1,0
27,212,212,50,50,0,1,0
8,214,214,16,13,3,2,1
28,231,231,21,21,0,1,0
14,243,243,16,16,0,1,0
19,244,244,24,24,0,1,0
1,257,257,8,8,0,1,0
2,271,271,7,7,0,1,0
3,276,276,24,24,0,1,0
17,302,302,12,2,10,3,2
26,326,326,69,18,51,4,3
4,328,328,27,6,21,2,1
29,355,355,11,11,0,1,0
20,361,361,59,59,0,1,0
12,397,397,62,12,50,2,1
10,398,398,12,12,0,1,0
13,446,446,10,10,0,1,0
9,448,448,88,60,28,3,2
31,458,458,81,81,0,1,0
24,460,460,22,22,0,1,0
6,496,496,4,1,3,2,1

1,108,108,31,22,9,4,3
11,115,115,1,1,0,1,0
18,120,120,20,20,0,1,0
21,129,129,12,2,10,2,1
5,133,133,7,3,4,2,1
10,160,160,10,2,8,3,2
20,162,162,4,4,0,1,0
8,171,171,3,3,0,1,0
4,182,182,23,23,0,1,0
7,184,184,3,3,0,1,0
14,189,189,4,4,0,1,0
27,203,203,6,6,0,1,0
13,295,295,32,32,0,1,0
17,305,305,13,6,7,2,1
22,309,309,21,21,0,1,0
28,316,316,17,17,0,1,0
12,324,324,83,83,0,1,0
2,348,348,14,9,5,2,1
9,352,352,109,91,18,4,3
23,366,366,53,46,7,2,1
16,368,368,9,1,8,2,1
3,374,374,57,57,0,1,0
0,377,377,19,7,12,2,1
15,387,387,11,11,0,1,0
19,400,400,150,134,16,2,1
26,416,416,146,107,39,2,1
25,424,424,5,2,3,2,1
24,432,432,36,36,0,1,0
6,447,447,99,75,24,2,1

5,113,113,1,1,0,1,0
21,132,132,20,20,0,1,0
17,165,165,12,3,9,4,3
11,194,194,24,24,0,1,0
10,199,199,10,3,7,2,1
0,214,214,113,35,78,4,3
12,215,215,72,72,0,1,0
26,236,236,21,5,16,3,2
2,239,239,36,36,0,1,0
3,242,242,10,10,0,1,0
28,262,262,79,58,21,4,3
27,302,302,24,15,9,4,3
1,313,313,4,4,0,1,0
4,316,316,29,29,0,1,0
20,324,324,5,2,3,2,1
13,329,329,22,22,0,1,0
19,337,337,6,6,0,1,0
15,356,356,26,26,0,1,0
6,381,381,4,4,0,1,0
8,425,425,26,26,0,1,0
24,430,430,98,98,0,1,0
7,432,432,50,31,19,2,1
14,446,446,107,11,96,4,3
18,447,447,20,13,7,2,1
9,455,455,33,33,0,1,0
16,458,458,36,19,17,2,1
25,470,470,31,31,0,1,0
23,480,480,44,2,42,3,2
22,497,497,2,2,0,1,0

8,100,100,1,1,0,1,0
19,120,120,2,2,0,1,0
20,128,128,19,19,0,1,0
6,131,131,11,11,0,1,0
3,148,148,44,44,0,1,0
26,150,150,17,3,14,2,1
17,156,156,7,7,0,1,0
34,158,158,21,21,0,1,0
29,164,164,22,12,10,2,1
13,168,168,4,4,0,1,0
24,181,181,6,6,0,1,0
1,211,211,1,1,0,1,0
25,228,228,22,22,0,1,0
14,229,229,1,1,0,1,0
31,234,234,20,20,0,1,0
2,237,237,40,31,9,4,3
39,238,238,10,10,0,1,0
36,238,238,44,19,25,2,1
22,255,255,9,9,0,1,0
28,258,258,2,2,0,1,0
41,278,278,18,10,8,2,1
21,291,291,22,22,0,1,0
32,297,297,34,34,0,1,0
23,311,311,24,7,17,2,1
37,317,317,31,16,15,2,1
5,318,318,33,33,0,1,0
12,321,321,35,21,14,2,1
40,331,331,44,44,0,1,0
35,333,333,17,8,9,3,2
7,334,334,13,1,12,4,3
0,345,345,1,1,0,1,0
4,365,365,7,3,4,2,1
30,392,392,34,34,0,1,0
33,400,400,66,46,20,2,1
27,403,403,59,49,10,3,2
38,448,448,29,29,0,1,0
10,456,456,17,11,6,2,1
15,476,476,34,34,0,1,0
16,492,492,30,30,0,1,0
18,493,493,8,5,3,2,1
9,496,496,3,3,0,1,0
11,498,498,8,8,0,1,0

9,127,127,7,7,0,1,0
19,129,129,15,1,14,2,1
3,130,130,1,1,0,1,0
15,144,144,34,34,0,1,0
28,145,145,25,16,9,4,3
29,155,155,9,9,0,1,0
22,166,166,1,1,0,1,0
31,173,173,1,1,0,1,0
21,184,184,35,35,0,1,0
8,188,188,14,14,0,1,0
25,195,195,65,65,0,1,0
14,212,212,4,4,0,1,0
6,216,216,20,5,15,4,3
23,240,240,36,30,6,3,2
30,263,263,6,6,0,1,0
26,269,269,28,28,0,1,0
0,320,320,70,58,12,2,1
7,321,321,4,4,0,1,0
2,328,328,56,1,55,4,3
11,332,332,26,26,0,1,0
1,339,339,21,21,0,1,0
10,393,393,58,58,0,1,0
4,416,416,8,2,6,2,1
18,445,445,8,3,5,2,1
24,460,460,28,9,19,2,1
16,465,465,95,40,55,4,3
12,465,465,115,89,26,3,2
5,478,478,41,41,0,1,0
17,480,480,87,87,0,1,0
27,487,487,1,1,0,1,0
13,488,488,37,5,32,2,1
20,489,489,2,2,0,1,0

34,103,103,2,2,0,1,0
26,112,112,6,6,0,1,0
17,127,127,1,1,0,1,0
8,145,145,10,10,0,1,0
15,157,157,18,18,0,1,0
36,176,176,4,4,0,1,0
33,186,186,48,8,40,2,1
18,192,192,14,14,0,1,0
0,197,197,22,7,15,4,3
4,199,199,28,25,3,2,1
20,203,203,19,19,0,1,0
2,205,205,35,12,23,4,3
1,218,218,11,11,0,1,0
16,219,219,33,9,24,4,3
21,221,221,31,31,0,1,0
25,261,261,35,23,12,4,3
29,284,284,30,21,9,2,1
14,296,296,4,4,0,1,0
27,300,300,91,91,0,1,0
6,300,300,19,15,4,2,1
11,303,303,3,3,0,1,0
19,308,308,16,4,12,2,1
5,317,317,7,7,0,1,0
30,327,327,28,28,0,1,0
22,341,341,18,18,0,1,0
3,353,353,35,35,0,1,0
24,357,357,31,31,0,1,0
7,370,370,35,25,10,2,1
12,382,382,23,4,19,2,1
10,414,414,7,3,4,2,1
23,423,423,100,37,63,4,3
35,428,428,50,31,19,4,3
9,429,429,12,12,0,1,0
31,446,446,30,30,0,1,0
13,449,449,9,9,0,1,0
37,490,490,6,2,4,2,1
32,491,491,1,1,0,1,0
28,497,497,37,14,23,2,1

22,101,101,3,3,0,1,0
14,115,115,4,4,0,1,0
21,145,145,50,50,0,1,0
3,160,160,37,5,32,3,2
9,168,168,14,14,0,1,0
6,176,176,2,2,0,1,0
18,191,191,32,32,0,1,0
23,213,213,19,19,0,1,0
1,226,226,10,10,0,1,0
4,228,228,22,22,0,1,0
24,229,229,8,8,0,1,0
30,240,240,4,4,0,1,0
0,253,253,18,18,0,1,0
11,267,267,15,15,0,1,0
2,272,272,140,23,117,4,3
26,298,298,11,5,6,2,1
13,322,322,14,6,8,2,1
31,325,325,53,53,0,1,0
10,332,332,15,15,0,1,0
8,341,341,13,13,0,1,0
5,344,344,20,20,0,1,0
25,390,390,29,3,26,3,2
33,390,390,2,2,0,1,0
7,409,409,30,30,0,1,0
20,412,412,65,51,14,3,2
19,413,413,39,39,0,1,0
17,416,416,54,54,0,1,0
15,425,425,16,5,11,2,1
28,443,443,58,58,0,1,0
16,444,444,3,3,0,1,0
29,463,463,64,38,26,2,1
27,468,468,51,51,0,1,0
12,484,484,12,12,0,1,0
32,491,491,17,17,0,1,0

16,100,100,3,3,0,1,0
31,103,103,3,3,0,1,0
11,107,107,21,21,0,1,0
6,113,113,5,1,4,2,1
35,124,124,32,10,22,3,2
24,126,126,2,2,0,1,0
15,136,136,3,3,0,1,0
10,145,145,8,5,3,2,1
33,148,148,20,9,11,2,1
28,154,154,1,1,0,1,0
29,172,172,16,16,0,1,0
9,190,190,2,2,0,1,0
17,190,190,1,1,0,1,0
12,190,190,6,6,0,1,0
14,197,197,5,5,0,1,0
8,206,206,1,1,0,1,0
23,208,208,16,16,0,1,0
3,217,217,16,6,10,3,2
20,237,237,4,1,3,2,1
5,249,249,3,3,0,1,0
0,250,250,19,19,0,1,0
32,285,285,46,46,0,1,0
4,325,325,138,110,28,3,2
21,329,329,45,36,9,4,3
22,361,361,9,9,0,1,0
7,365,365,21,3,18,4,3
26,367,367,27,22,5,2,1
34,386,386,97,82,15,2,1
30,391,391,23,9,14,2,1
19,416,416,67,6,61,4,3
25,428,428,50,50,0,1,0
2,446,446,106,106,0,1,0
27,467,467,83,83,0,1,0
13,474,474,55,55,0,1,0
18,483,483,1,1,0,1,0
1,498,498,8,8,0,1,0

12,117,117,23,11,12,2,1
6,124,124,14,14,0,1,0
20,129,129,29,14,15,2,1
23,134,134,3,3,0,1,0
15,147,147,14,4,10,2,1
8,148,148,3,3,0,1,0
19,158,158,19,19,0,1,0
4,166,166,12,2,10,3,2
10,173,173,67,21,46,2,1
16,197,197,62,26,36,2,1
25,202,202,15,1,14,2,1
27,224,224,27,27,0,1,0
18,239,239,4,1,3,2,1
21,242,242,28,28,0,1,0
13,247,247,3,3,0,1,0
24,260,260,34,34,0,1,0
17,265,265,22,22,0,1,0
29,275,275,18,9,9,4,3
30,303,303,61,22,39,4,3
11,307,307,1,1,0,1,0
2,309,309,9,9,0,1,0
22,317,317,14,4,10,3,2
5,318,318,1,1,0,1,0
3,328,328,5,5,0,1,0
28,330,330,4,4,0,1,0
0,359,359,7,7,0,1,0
1,406,406,50,50,0,1,0
31,424,424,26,26,0,1,0
9,425,425,98,98,0,1,0
26,434,434,10,10,0,1,0
14,453,453,102,84,18,2,1
7,479,479,29,7,22,3,2

9,114,114,11,11,0,1,0
2,137,137,9,5,4,2,1
3,148,148,27,1,26,2,1
7,195,195,25,25,0,1,0
12,203,203,19,5,14,2,1
25,240,240,47,35,12,3,2
11,242,242,14,14,0,1,0
17,250,250,42,27,15,2,1
10,257,257,35,17,18,3,2
1,287,287,8,8,0,1,0
23,308,308,47,4,43,2,1
13,308,308,11,1,10,3,2
18,335,335,20,20,0,1,0
5,341,341,131,32,99,4,3
8,343,343,119,119,0,1,0
22,343,343,67,58,9,4,3
6,364,364,45,45,0,1,0
19,370,370,96,80,16,2,1
0,381,381,13,1,12,3,2
4,391,391,7,7,0,1,0
20,417,417,9,3,6,2,1
21,434,434,6,6,0,1,0
26,445,445,112,28,84,4,3
24,446,446,10,10,0,1,0
27,460,460,26,18,8,2,1
16,471,471,23,12,11,2,1
15,481,481,12,6,6,3,2
14,482,482,10,10,0,1,0

2,124,124,5,5,0,1,0
19,127,127,1,1,0,1,0
8,134,134,35,35,0,1,0
5,139,139,27,27,0,1,0
0,171,171,18,6,12,4,3
24,192,192,17,17,0,1,0
18,193,193,5,5,0,1,0
17,200,200,23,23,0,1,0
10,202,202,8,8,0,1,0
21,227,227,32,26,6,3,2
14,230,230,9,9,0,1,0
4,316,316,20,10,10,4,3
23,329,329,47,21,26,2,1
15,332,332,28,15,13,2,1
11,353,353,29,3,26,3,2
7,371,371,132,132,0,1,0
9,387,387,124,114,10,3,2
20,397,397,99,99,0,1,0
16,431,431,31,1,30,3,2
6,444,444,140,26,114,4,3
12,446,446,41,33,8,3,2
1,457,457,10,10,0,1,0
22,459,459,5,5,0,1,0
3,460,460,114,70,44,3,2
13,496,496,57,57,0,1,0

27,101,101,11,11,0,1,0
5,111,111,1,1,0,1,0
21,117,117,17,5,12,3,2
28,137,137,12,12,0,1,0
4,178,178,46,46,0,1,0
16,230,230,67,67,0,1,0
11,234,234,27,11,16,3,2
12,238,238,17,2,15,4,3
0,239,239,21,21,0,1,0
19,245,245,31,13,18,2,1
14,253,253,12,3,9,2,1
23,268,268,81,81,0,1,0
26,277,277,32,7,25,2,1
20,277,277,6,1,5,2,1
7,278,278,46,11,35,2,1
15,295,295,3,3,0,1,0
3,304,304,21,21,0,1,0
29,307,307,4,4,0,1,0
10,324,324,2,2,0,1,0
6,338,338,31,6,25,2,1
8,365,365,26,26,0,1,0
24,365,365,1,1,0,1,0
13,392,392,7,7,0,1,0
2,395,395,117,3,114,4,3
17,421,421,17,17,0,1,0
18,421,421,18,18,0,1,0
1,438,438,17,13,4,2,1
22,439,439,23,23,0,1,0
25,444,444,69,69,0,1,0
30,475,475,42,42,0,1,0
9,492,492,121,121,0,1,0
31,499,499,19,19,0,1,0

15,120,120,1,1,0,1,0
22,140,140,17,9,8,2,1
10,144,144,38,38,0,1,0
28,146,146,3,3,0,1,0
6,148,148,13,13,0,1,0
25,156,156,2,2,0,1,0
2,176,176,19,3,16,3,2
1,182,182,2,2,0,1,0
7,212,212,29,29,0,1,0
19,229,229,11,11,0,1,0
17,230,230,3,3,0,1,0
31,262,262,100,77,23,2,1
4,271,271,3,3,0,1,0
3,276,276,24,19,5,2,1
12,288,288,11,2,9,2,1
23,308,308,1,1,0,1,0
0,319,319,29,29,0,1,0
16,320,320,1,1,0,1,0
20,351,351,35,2,33,4,3
29,353,353,31,31,0,1,0
9,356,356,39,39,0,1,0
14,376,376,50,20,30,3,2
30,393,393,49,27,22,4,3
13,402,402,50,50,0,1,0
5,411,411,41,13,28,2,1
11,430,430,98,98,0,1,0
24,467,467,71,71,0,1,0
26,472,472,88,72,16,3,2
18,475,475,97,97,0,1,0
21,484,484,22,3,19,2,1
8,492,492,32,2,30,4,3
27,493,493,59,38,21,4,3

4,155,155,1,1,0,1,0
23,157,157,2,2,0,1,0
7,179,179,29,21,8,3,2
8,179,179,26,8,18,3,2
6,182,182,35,29,6,3,2
18,186,186,3,3,0,1,0
2,210,210,13,1,12,3,2
5,237,237,4,4,0,1,0
10,247,247,50,50,0,1,0
29,250,250,29,29,0,1,0
3,254,254,10,10,0,1,0
0,255,255,70,46,24,3,2
26,284,284,22,22,0,1,0
24,297,297,3,3,0,1,0
27,333,333,22,2,20,2,1
25,344,344,58,43,15,2,1
13,347,347,21,10,11,2,1
12,369,369,105,26,79,4,3
28,374,374,82,70,12,3,2
1,378,378,13,13,0,1,0
17,378,378,73,73,0,1,0
14,381,381,30,4,26,3,2
19,406,406,50,50,0,1,0
9,409,409,37,22,15,2,1
16,416,416,30,7,23,2,1
21,420,420,31,23,8,2,1
22,420,420,12,3,9,4,3
15,462,462,150,35,115,4,3
20,472,472,22,22,0,1,0
11,474,474,14,6,8,2,1

16,106,106,35,5,30,4,3
6,125,125,1,1,0,1,0
5,152,152,19,1,18,4,3
15,206,206,13,4,9,4,3
7,223,223,70,19,51,4,3
23,247,247,4,4,0,1,0
8,270,270,25,25,0,1,0
21,280,280,12,12,0,1,0
24,281,281,26,2,24,3,2
19,283,283,13,5,8,2,1
13,293,293,22,22,0,1,0
2,297,297,24,24,0,1,0
0,297,297,9,2,7,2,1
25,298,298,4,4,0,1,0
26,300,300,18,9,9,2,1
18,301,301,53,53,0,1,0
10,315,315,77,21,56,3,2
9,322,322,98,29,69,4,3
17,353,353,58,24,34,3,2
27,359,359,36,36,0,1,0
4,361,361,56,40,16,2,1
20,365,365,44,10,34,3,2
11,390,390,50,50,0,1,0
14,414,414,49,15,34,3,2
1,414,414,48,7,41,2,1
22,435,435,68,68,0,1,0
12,455,455,24,19,5,2,1
3,468,468,1,1,0,1,0

16,103,103,7,3,4,2,1
25,110,110,10,10,0,1,0
21,127,127,3,3,0,1,0
22,131,131,22,22,0,1,0
28,145,145,1,1,0,1,0
8,151,151,1,1,0,1,0
1,153,153,26,26,0,1,0
26,169,169,21,3,18,3,2
0,208,208,20,20,0,1,0
27,258,258,25,25,0,1,0
12,265,265,10,7,3,2,1
11,277,277,10,4,6,2,1
19,287,287,1,1,0,1,0
14,288,288,103,103,0,1,0
23,290,290,23,8,15,4,3
13,321,321,36,31,5,2,1
7,328,328,56,56,0,1,0
18,348,348,95,77,18,3,2
20,353,353,10,1,9,4,3
17,362,362,29,29,0,1,0
4,388,388,28,10,18,4,3
5,402,402,104,83,21,4,3
10,413,413,27,27,0,1,0
9,415,415,160,74,86,3,2
15,419,419,33,19,14,3,2
3,436,436,31,8,23,2,1
24,440,440,14,2,12,4,3
29,447,447,56,56,0,1,0
2,480,480,18,15,3,2,1
6,484,484,40,11,29,2,1

2,101,101,2,2,0,1,0
12,135,135,1,1,0,1,0
18,166,166,13,13,0,1,0
0,181,181,52,52,0,1,0
19,191,191,1,1,0,1,0
11,221,221,3,3,0,1,0
34,229,229,12,2,10,3,2
3,230,230,1,1,0,1,0
6,235,235,17,17,0,1,0
33,271,271,18,18,0,1,0
32,278,278,69,69,0,1,0
14,284,284,42,14,28,2,1
15,287,287,6,6,0,1,0
25,295,295,23,9,14,2,1
30,296,296,37,37,0,1,0
28,309,309,78,2,76,3,2
10,312,312,40,11,29,4,3
23,313,313,44,44,0,1,0
35,322,322,48,27,21,4,3
22,325,325,54,54,0,1,0
31,333,333,1,1,0,1,0
27,335,335,8,1,7,2,1
4,346,346,5,5,0,1,0
1,348,348,12,12,0,1,0
26,351,351,48,8,40,3,2
9,357,357,32,22,10,2,1
8,363,363,47,26,21,2,1
13,370,370,61,7,54,4,3
20,373,373,17,17,0,1,0
24,391,391,44,44,0,1,0
36,407,407,14,7,7,2,1
21,435,435,5,5,0,1,0
16,439,439,27,27,0,1,0
5,450,450,18,18,0,1,0
7,481,481,36,36,0,1,0
17,492,492,79,3,76,3,2
29,500,500,11,11,0,1,0

21,110,110,35,26,9,4,3
23,113,113,4,4,0,1,0
14,145,145,27,27,0,1,0
27,165,165,1,1,0,1,0
5,167,167,10,10,0,1,0
28,168,168,4,4,0,1,0
18,192,192,9,9,0,1,0
16,249,249,36,36,0,1,0
30,250,250,18,18,0,1,0
19,258,258,49,43,6,3,2
1,277,277,1,1,0,1,0
25,287,287,97,24,73,4,3
24,293,293,1,1,0,1,0
7,306,306,16,16,0,1,0
17,332,332,81,34,47,2,1
32,340,340,2,2,0,1,0
26,352,352,23,7,16,3,2
3,356,356,36,36,0,1,0
6,376,376,38,38,0,1,0
31,378,378,47,47,0,1,0
13,387,387,57,57,0,1,0
11,392,392,10,10,0,1,0
10,406,406,53,53,0,1,0
29,410,410,7,7,0,1,0
9,412,412,59,38,21,2,1
15,415,415,41,4,37,2,1
12,419,419,77,46,31,2,1
4,420,420,53,13,40,3,2
0,423,423,4,4,0,1,0
8,425,425,33,24,9,2,1
22,427,427,30,30,0,1,0
20,429,429,34,34,0,1,0
2,456,456,5,2,3,2,1

17,103,103,17,17,0,1,0
3,114,114,5,5,0,1,0
8,116,116,11,11,0,1,0
14,117,117,2,2,0,1,0
0,121,121,3,3,0,1,0
20,130,130,24,12,12,3,2
34,135,135,18,11,7,2,1
11,171,171,12,12,0,1,0
16,174,174,8,1,7,2,1
4,179,179,25,25,0,1,0
25,182,182,4,1,3,2,1
27,192,192,22,22,0,1,0
26,195,195,30,12,18,2,1
7,202,202,9,9,0,1,0
2,203,203,15,5,10,3,2
13,205,205,35,35,0,1,0
19,213,213,18,14,4,2,1
5,214,214,20,13,7,2,1
33,244,244,25,25,0,1,0
22,260,260,62,62,0,1,0
15,274,274,22,22,0,1,0
18,283,283,12,12,0,1,0
1,285,285,11,11,0,1,0
23,292,292,14,14,0,1,0
30,337,337,30,5,25,2,1
31,368,368,4,4,0,1,0
29,376,376,11,11,0,1,0
28,382,382,93,59,34,2,1
21,392,392,24,12,12,4,3
6,419,419,116,116,0,1,0
32,433,433,36,36,0,1,0
10,436,436,7,3,4,2,1
9,450,450,1,1,0,1,0
35,453,453,45,45,0,1,0
24,477,477,9,1,8,3,2
12,487,487,37,3,34,3,2

8,140,140,30,6,24,3,2
22,152,152,35,16,19,2,1
6,167,167,39,39,0,1,0
11,187,187,9,9,0,1,0
28,196,196,17,17,0,1,0
16,202,202,41,41,0,1,0
2,211,211,3,3,0,1,0
15,222,222,27,17,10,2,1
12,230,230,37,37,0,1,0
21,235,235,18,6,12,3,2
0,264,264,1,1,0,1,0
23,266,266,14,14,0,1,0
19,270,270,35,15,20,3,2
14,294,294,63,63,0,1,0
1,315,315,6,1,5,2,1
3,315,315,5,5,0,1,0
4,317,317,36,31,5,2,1
26,326,326,3,3,0,1,0
17,327,327,10,10,0,1,0
13,330,330,33,33,0,1,0
25,337,337,18,18,0,1,0
5,352,352,23,23,0,1,0
7,367,367,70,24,46,2,1
20,411,411,3,3,0,1,0
10,440,440,140,128,12,4,3
18,476,476,1,1,0,1,0
24,476,476,90,90,0,1,0
27,480,480,57,41,16,2,1
9,500,500,102,46,56,3,2

32,106,106,10,2,8,2,1
8,112,112,1,1,0,1,0
5,113,113,7,1,6,3,2
19,133,133,8,2,6,2,1
12,142,142,31,31,0,1,0
17,168,168,1,1,0,1,0
24,189,189,6,6,0,1,0
13,210,210,1,1,0,1,0
6,229,229,9,1,8,2,1
20,230,230,3,3,0,1,0
23,233,233,19,6,13,2,1
0,236,236,9,9,0,1,0
35,241,241,39,39,0,1,0
7,245,245,3,3,0,1,0
16,250,250,2,2,0,1,0
25,262,262,14,10,4,2,1
29,273,273,35,35,0,1,0
9,274,274,59,13,46,2,1
18,313,313,72,24,48,4,3
22,321,321,4,1,3,2,1
2,343,343,21,21,0,1,0
1,345,345,36,27,9,4,3
27,355,355,13,13,0,1,0
31,375,375,30,30,0,1,0
28,375,375,6,6,0,1,0
15,380,380,15,15,0,1,0
30,385,385,39,39,0,1,0
21,414,414,184,184,0,1,0
4,416,416,7,7,0,1,0
33,432,432,34,34,0,1,0
3,435,435,74,60,14,2,1
11,444,444,50,3,47,2,1
26,465,465,110,110,0,1,0
34,469,469,24,24,0,1,0
10,481,481,70,70,0,1,0
14,487,487,25,25,0,1,0

2,102,102,1,1,0,1,0
19,137,137,14,14,0,1,0
21,150,150,24,24,0,1,0
33,178,178,12,12,0,1,0
24,180,180,48,48,0,1,0
18,183,183,4,4,0,1,0
10,187,187,35,35,0,1,0
9,214,214,2,2,0,1,0
1,218,218,7,1,6,3,2
20,226,226,9,9,0,1,0
34,233,233,36,36,0,1,0
16,235,235,86,10,76,4,3
36,244,244,15,15,0,1,0
5,247,247,14,14,0,1,0
4,249,249,25,8,17,2,1
31,254,254,25,25,0,1,0
11,258,258,3,3,0,1,0
23,260,260,4,4,0,1,0
3,270,270,13,13,0,1,0
6,283,283,74,8,66,4,3
26,309,309,32,32,0,1,0
15,328,328,14,5,9,4,3
8,329,329,8,8,0,1,0
27,333,333,19,3,16,3,2
14,337,337,6,6,0,1,0
35,350,350,44,44,0,1,0
22,354,354,10,10,0,1,0
30,376,376,10,1,9,2,1
17,383,383,15,7,8,2,1
28,384,384,43,43,0,1,0
32,384,384,59,38,21,4,3
25,389,389,55,13,42,2,1
7,396,396,1,1,0,1,0
0,438,438,2,2,0,1,0
29,457,457,29,29,0,1,0
13,470,470,103,103,0,1,0
12,492,492,3,3,0,1,0

2,101,101,10,10,0,1,0
6,105,105,3,3,0,1,0
26,110,110,12,12,0,1,0
21,111,111,13,13,0,1,0
20,132,132,2,2,0,1,0
8,137,137,6,3,3,2,1
12,156,156,1,1,0,1,0
13,168,168,17,17,0,1,0
30,177,177,33,33,0,1,0
22,187,187,3,3,0,1,0
17,192,192,7,7,0,1,0
9,197,197,19,19,0,1,0
24,216,216,43,43,0,1,0
11,227,227,1,1,0,1,0
19,265,265,3,3,0,1,0
4,272,272,3,3,0,1,0
32,276,276,18,2,16,2,1
34,277,277,88,19,69,3,2
36,285,285,5,5,0,1,0
28,300,300,54,4,50,3,2
16,303,303,31,18,13,3,2
7,321,321,1,1,0,1,0
3,324,324,5,5,0,1,0
37,348,348,28,28,0,1,0
1,348,348,6,6,0,1,0
31,377,377,42,11,31,3,2
14,383,383,132,62,70,3,2
23,385,385,58,58,0,1,0
15,398,398,139,116,23,2,1
35,399,399,18,18,0,1,0
29,421,421,9,2,7,3,2
10,425,425,2,2,0,1,0
0,437,437,64,24,40,2,1
25,438,438,30,17,13,2,1
5,443,443,2,2,0,1,0
18,446,446,20,11,9,2,1
27,483,483,28,20,8,2,1
33,495,495,2,2,0,1,0

23,102,102,2,2,0,1,0
3,124,124,4,1,3,2,1
39,137,137,9,9,0,1,0
5,141,141,3,3,0,1,0
40,150,150,31,7,24,2,1
12,160,160,1,1,0,1,0
8,175,175,31,31,0,1,0
21,181,181,9,9,0,1,0
22,197,197,29,29,0,1,0
19,208,208,1,1,0,1,0
7,215,215,1,1,0,1,0
30,217,217,48,1,47,2,1
16,235,235,22,1,21,2,1
6,250,250,5,5,0,1,0
1,251,251,1,1,0,1,0
20,262,262,6,6,0,1,0
10,267,267,23,23,0,1,0
28,275,275,15,7,8,3,2
26,287,287,14,14,0,1,0
35,292,292,51,9,42,3,2
24,297,297,12,12,0,1,0
17,322,322,55,47,8,2,1
36,325,325,13,1,12,2,1
11,337,337,24,24,0,1,0
34,340,340,35,35,0,1,0
0,352,352,1,1,0,1,0
37,357,357,66,42,24,3,2
14,363,363,9,1,8,2,1
18,363,363,4,4,0,1,0
13,370,370,58,42,16,2,1
4,373,373,19,19,0,1,0
38,377,377,13,1,12,4,3
29,405,405,58,58,0,1,0
41,405,405,27,27,0,1,0
27,410,410,11,11,0,1,0
33,423,423,39,9,30,3,2
2,445,445,37,37,0,1,0
15,446,446,4,1,3,2,1
9,449,449,8,5,3,2,1
31,485,485,9,9,0,1,0
32,491,491,68,46,22,2,1
25,493,493,134,96,38,4,3

13,104,104,54,18,36,4,3
7,109,109,6,6,0,1,0
4,121,121,1,1,0,1,0
32,129,129,24,24,0,1,0
14,132,132,4,1,3,2,1
8,133,133,1,1,0,1,0
20,151,151,15,15,0,1,0
5,173,173,35,10,25,2,1
25,177,177,7,7,0,1,0
15,178,178,19,19,0,1,0
12,181,181,9,9,0,1,0
23,193,193,40,40,0,1,0
2,219,219,44,44,0,1,0
9,222,222,25,4,21,4,3
21,264,264,4,4,0,1,0
29,273,273,8,8,0,1,0
16,285,285,38,19,19,4,3
1,289,289,1,1,0,1,0
22,293,293,9,9,0,1,0
10,308,308,17,17,0,1,0
28,367,367,22,22,0,1,0
31,375,375,25,25,0,1,0
26,403,403,2,2,0,1,0
0,415,415,22,22,0,1,0
19,416,416,157,157,0,1,0
17,444,444,12,12,0,1,0
27,445,445,85,36,49,3,2
30,445,445,68,68,0,1,0
24,462,462,52,52,0,1,0
11,465,465,7,1,6,2,1
18,471,471,14,9,5,2,1
6,498,498,16,7,9,4,3
3,499,499,9,1,8,2,1

19,105,105,8,8,0,1,0
36,105,105,7,1,6,2,1
16,116,116,14,4,10,2,1
24,127,127,1,1,0,1,0
5,128,128,9,1,8,3,2
31,138,138,7,7,0,1,0
11,145,145,5,5,0,1,0
1,146,146,4,4,0,1,0
20,152,152,20,7,13,4,3
7,161,161,4,4,0,1,0
17,162,162,7,4,3,2,1
3,194,194,5,5,0,1,0
2,216,216,27,27,0,1,0
0,222,222,6,2,4,2,1
9,232,232,10,1,9,2,1
8,256,256,4,4,0,1,0
34,257,257,6,6,0,1,0
23,291,291,11,2,9,2,1
13,293,293,21,7,14,3,2
35,298,298,35,35,0,1,0
37,305,305,45,10,35,2,1
6,306,306,56,56,0,1,0
15,338,338,11,5,6,3,2
28,348,348,41,41,0,1,0
39,366,366,41,41,0,1,0
21,374,374,16,16,0,1,0
18,376,376,56,56,0,1,0
38,376,376,4,4,0,1,0
29,382,382,106,106,0,1,0
14,389,389,11,7,4,2,1
12,392,392,11,11,0,1,0
32,398,398,7,7,0,1,0
30,400,400,101,101,0,1,0
4,422,422,82,18,64,4,3
10,425,425,6,2,4,2,1
33,426,426,70,70,0,1,0
27,447,447,16,16,0,1,0
25,456,456,22,8,14,3,2
22,473,473,26,26,0,1,0
26,476,476,87,25,62,4,3

9,156,156,4,4,0,1,0
4,182,182,1,1,0,1,0
27,191,191,9,9,0,1,0
33,228,228,3,3,0,1,0
8,228,228,4,4,0,1,0
28,242,242,40,40,0,1,0
26,245,245,20,20,0,1,0
21,250,250,124,124,0,1,0
25,259,259,4,4,0,1,0
0,260,260,26,26,0,1,0
12,273,273,102,26,76,3,2
16,280,280,83,83,0,1,0
15,282,282,11,11,0,1,0
5,287,287,5,5,0,1,0
14,302,302,46,9,37,2,1
20,309,309,2,2,0,1,0
6,314,314,53,19,34,4,3
17,317,317,33,33,0,1,0
19,341,341,11,11,0,1,0
23,342,342,38,38,0,1,0
32,343,343,17,17,0,1,0
18,344,344,1,1,0,1,0
1,363,363,47,47,0,1,0
30,372,372,19,19,0,1,0
10,379,379,15,3,12,2,1
22,388,388,7,7,0,1,0
11,417,417,30,10,20,3,2
31,422,422,24,24,0,1,0
7,439,439,4,4,0,1,0
24,445,445,131,131,0,1,0
3,452,452,5,5,0,1,0
29,484,484,89,89,0,1,0
2,496,496,16,6,10,2,1
13,500,500,4,4,0,1,0

26,108,108,1,1,0,1,0
25,114,114,26,26,0,1,0
3,131,131,27,27,0,1,0
13,141,141,3,3,0,1,0
1,159,159,35,35,0,1,0
30,175,175,97,21,76,3,2
22,184,184,1,1,0,1,0
0,184,184,2,2,0,1,0
14,201,201,35,14,21,2,1
2,209,209,11,7,4,2,1
8,211,211,21,3,18,2,1
18,218,218,10,10,0,1,0
28,223,223,23,6,17,2,1
6,226,226,21,7,14,2,1
19,262,262,11,8,3,2,1
20,280,280,24,24,0,1,0
17,280,280,6,6,0,1,0
15,308,308,16,16,0,1,0
4,328,328,40,40,0,1,0
29,344,344,41,33,8,2,1
5,345,345,42,29,13,2,1
7,353,353,21,21,0,1,0
9,381,381,9,9,0,1,0
12,391,391,57,57,0,1,0
23,392,392,36,1,35,2,1
31,394,394,22,22,0,1,0
24,397,397,11,11,0,1,0
21,399,399,68,68,0,1,0
16,408,408,15,15,0,1,0
27,429,429,14,14,0,1,0
10,462,462,62,62,0,1,0
11,469,469,31,18,13,4,3

17,158,158,8,3,5,2,1
22,163,163,44,34,10,2,1
10,171,171,23,23,0,1,0
6,180,180,12,5,7,2,1
1,201,201,12,7,5,2,1
9,202,202,4,4,0,1,0
14,221,221,13,7,6,3,2
0,241,241,56,56,0,1,0
30,278,278,35,35,0,1,0
12,293,293,20,14,6,3,2
25,307,307,6,6,0,1,0
28,311,311,2,2,0,1,0
2,314,314,1,1,0,1,0
20,322,322,28,28,0,1,0
15,338,338,24,2,22,3,2
27,352,352,119,26,93,4,3
29,359,359,77,77,0,1,0
13,370,370,31,9,22,2,1
21,373,373,99,99,0,1,0
5,393,393,135,102,33,4,3
7,401,401,3,3,0,1,0
19,405,405,2,2,0,1,0
16,410,410,20,7,13,2,1
4,417,417,52,38,14,3,2
26,451,451,3,3,0,1,0
23,464,464,9,3,6,3,2
3,468,468,77,77,0,1,0
18,479,479,1,1,0,1,0
24,480,480,45,45,0,1,0
8,492,492,114,59,55,3,2
11,492,492,1,1,0,1,0

28,126,126,4,4,0,1,0
2,133,133,33,2,31,4,3
19,153,153,6,6,0,1,0
5,161,161,9,9,0,1,0
8,179,179,29,15,14,2,1
17,180,180,8,8,0,1,0
24,182,182,6,6,0,1,0
12,186,186,33,25,8,3,2
32,205,205,32,32,0,1,0
30,209,209,11,11,0,1,0
7,214,214,1,1,0,1,0
31,230,230,5,5,0,1,0
15,239,239,12,12,0,1,0
13,270,270,14,4,10,2,1
16,278,278,56,56,0,1,0
26,282,282,146,146,0,1,0
33,288,288,4,4,0,1,0
27,302,302,34,34,0,1,0
25,310,310,14,2,12,3,2
9,313,313,1,1,0,1,0
22,325,325,25,25,0,1,0
20,333,333,22,22,0,1,0
4,339,339,22,22,0,1,0
6,385,385,67,28,39,4,3
10,385,385,13,13,0,1,0
14,395,395,7,7,0,1,0
11,399,399,33,24,9,2,1
23,405,405,27,14,13,4,3
3,407,407,7,7,0,1,0
29,438,438,111,103,8,2,1
21,462,462,24,9,15,2,1
0,472,472,16,7,9,4,3
18,477,477,44,44,0,1,0
1,480,480,85,40,45,4,3

8,104,104,7,7,0,1,0
29,104,104,3,3,0,1,0
2,133,133,13,1,12,4,3
18,140,140,47,25,22,3,2
27,154,154,5,1,4,2,1
16,178,178,22,22,0,1,0
11,203,203,11,11,0,1,0
26,207,207,3,3,0,1,0
1,231,231,38,38,0,1,0
12,235,235,16,16,0,1,0
17,246,246,24,24,0,1,0
31,264,264,17,17,0,1,0
14,266,266,31,31,0,1,0
7,278,278,21,21,0,1,0
25,283,283,58,58,0,1,0
21,290,290,71,71,0,1,0
24,302,302,60,10,50,3,2
30,305,305,4,4,0,1,0
9,319,319,90,40,50,2,1
5,320,320,66,24,42,4,3
6,331,331,14,5,9,4,3
13,333,333,25,10,15,4,3
20,352,352,4,4,0,1,0
19,360,360,70,70,0,1,0
0,380,380,3,3,0,1,0
33,384,384,28,22,6,3,2
23,384,384,32,9,23,2,1
28,393,393,1,1,0,1,0
15,394,394,15,5,10,3,2
4,408,408,11,5,6,2,1
3,435,435,1,1,0,1,0
10,473,473,27,27,0,1,0
32,474,474,55,55,0,1,0
22,481,481,7,3,4,2,1

6,136,136,7,1,6,3,2
30,171,171,3,3,0,1,0
31,177,177,36,36,0,1,0
29,189,189,4,4,0,1,0
12,190,190,20,20,0,1,0
16,192,192,24,2,22,2,1
1,196,196,37,37,0,1,0
25,217,217,59,59,0,1,0
10,217,217,51,51,0,1,0
13,227,227,35,23,12,2,1
26,272,272,33,18,15,4,3
14,284,284,13,13,0,1,0
27,291,291,23,8,15,4,3
24,303,303,18,18,0,1,0
5,310,310,9,9,0,1,0
8,324,324,17,8,9,2,1
19,324,324,67,67,0,1,0
17,328,328,28,28,0,1,0
33,338,338,19,9,10,3,2
9,355,355,44,32,12,2,1
20,361,361,30,15,15,2,1
15,375,375,11,11,0,1,0
2,396,396,8,8,0,1,0
3,397,397,19,19,0,1,0
7,398,398,10,2,8,2,1
11,410,410,46,46,0,1,0
23,415,415,40,40,0,1,0
21,430,430,46,46,0,1,0
34,433,433,26,5,21,4,3
22,434,434,76,72,4,2,1
0,434,434,1,1,0,1,0
18,457,457,57,57,0,1,0
28,486,486,17,17,0,1,0
32,487,487,16,10,6,2,1
4,489,489,21,5,16,3,2

6,100,100,7,3,4,2,1
18,122,122,16,3,13,2,1
0,140,140,1,1,0,1,0
2,148,148,26,7,19,2,1
15,152,152,19,15,4,2,1
20,176,176,30,14,16,3,2
5,200,200,6,6,0,1,0
23,207,207,55,15,40,4,3
19,248,248,7,7,0,1,0
28,260,260,10,10,0,1,0
26,267,267,7,4,3,2,1
7,272,272,16,16,0,1,0
27,276,276,13,2,11,2,1
10,299,299,80,80,0,1,0
16,305,305,85,3,82,3,2
25,308,308,6,6,0,1,0
29,313,313,56,20,36,3,2
4,344,344,99,35,64,4,3
21,345,345,11,4,7,2,1
22,350,350,32,32,0,1,0
13,353,353,25,25,0,1,0
1,355,355,41,4,37,4,3
30,362,362,60,60,0,1,0
9,391,391,36,36,0,1,0
11,394,394,51,51,0,1,0
24,410,410,9,9,0,1,0
17,411,411,4,4,0,1,0
12,461,461,4,4,0,1,0
3,464,464,9,9,0,1,0
8,486,486,117,97,20,4,3
14,495,495,14,14,0,1,0

2,158,158,8,8,0,1,0
29,187,187,14,14,0,1,0
21,188,188,10,1,9,4,3
32,189,189,34,25,9,4,3
20,203,203,25,9,16,3,2
33,220,220,32,32,0,1,0
17,240,240,38,38,0,1,0
5,249,249,1,1,0,1,0
10,254,254,19,15,4,2,1
19,266,266,15,6,9,2,1
1,271,271,7,4,3,2,1
26,277,277,42,42,0,1,0
15,277,277,33,33,0,1,0
18,281,281,23,23,0,1,0
23,290,290,32,32,0,1,0
7,298,298,6,6,0,1,0
9,307,307,12,2,10,3,2
0,311,311,21,9,12,4,3
24,316,316,5,5,0,1,0
31,322,322,41,41,0,1,0
30,330,330,4,4,0,1,0
27,334,334,50,50,0,1,0
11,344,344,1,1,0,1,0
4,348,348,111,21,90,3,2
28,349,349,69,50,19,2,1
16,363,363,108,108,0,1,0
13,367,367,6,3,3,2,1
6,374,374,1,1,0,1,0
3,404,404,17,17,0,1,0
22,413,413,25,13,12,4,3
12,422,422,22,22,0,1,0
8,423,423,32,18,14,3,2
14,432,432,102,102,0,1,0
25,474,474,44,44,0,1,0

27,114,114,9,9,0,1,0
6,120,120,1,1,0,1,0
5,137,137,8,8,0,1,0
17,139,139,22,16,6,2,1
15,144,144,9,9,0,1,0
35,151,151,11,4,7,2,1
14,162,162,1,1,0,1,0
3,195,195,1,1,0,1,0
21,197,197,5,2,3,2,1
9,202,202,20,20,0,1,0
0,211,211,5,5,0,1,0
20,217,217,5,5,0,1,0
18,220,220,26,26,0,1,0
25,224,224,26,26,0,1,0
19,238,238,17,17,0,1,0
30,240,240,12,3,9,4,3
23,240,240,22,13,9,2,1
16,255,255,11,1,10,3,2
1,261,261,64,20,44,3,2
22,270,270,32,4,28,3,2
28,271,271,41,41,0,1,0
13,280,280,8,1,7,2,1
12,288,288,67,67,0,1,0
2,295,295,17,17,0,1,0
34,303,303,8,8,0,1,0
26,306,306,8,8,0,1,0
4,312,312,9,9,0,1,0
24,330,330,5,5,0,1,0
29,335,335,53,53,0,1,0
36,342,342,57,57,0,1,0
31,386,386,33,6,27,4,3
7,387,387,75,36,39,4,3
33,434,434,167,136,31,2,1
8,438,438,3,3,0,1,0
10,448,448,53,53,0,1,0
11,456,456,7,7,0,1,0
32,469,469,28,10,18,3,2

4,103,103,6,2,4,2,1
16,114,114,4,4,0,1,0
20,137,137,20,8,12,4,3
2,138,138,25,25,0,1,0
19,153,153,7,3,4,2,1
26,172,172,13,13,0,1,0
31,193,193,1,1,0,1,0
15,205,205,10,1,9,2,1
33,225,225,41,1,40,2,1
1,229,229,44,22,22,4,3
14,245,245,25,7,18,4,3
10,252,252,1,1,0,1,0
24,253,253,17,3,14,3,2
13,253,253,6,6,0,1,0
3,275,275,28,28,0,1,0
21,281,281,22,4,18,2,1
11,281,281,47,47,0,1,0
22,282,282,18,5,13,2,1
0,284,284,36,10,26,2,1
5,340,340,23,23,0,1,0
7,363,363,20,20,0,1,0
30,368,368,9,9,0,1,0
12,387,387,51,51,0,1,0
9,402,402,7,7,0,1,0
28,409,409,81,36,45,4,3
25,428,428,5,5,0,1,0
18,428,428,186,39,147,4,3
6,430,430,14,14,0,1,0
17,444,444,61,55,6,2,1
23,458,458,60,34,26,3,2
32,464,464,20,4,16,3,2
8,494,494,58,58,0,1,0
29,494,494,61,36,25,2,1
27,495,495,3,3,0,1,0

15,117,117,15,5,10,3,2
16,136,136,9,9,0,1,0
12,146,146,18,3,15,4,3
0,147,147,8,2,6,3,2
33,165,165,4,4,0,1,0
3,165,165,5,2,3,2,1
30,174,174,4,4,0,1,0
31,203,203,3,3,0,1,0
1,210,210,8,8,0,1,0
25,213,213,27,9,18,3,2
32,222,222,72,13,59,3,2
17,223,223,20,2,18,2,1
9,235,235,22,22,0,1,0
10,245,245,34,23,11,2,1
13,245,245,31,5,26,3,2
24,252,252,32,32,0,1,0
23,272,272,5,5,0,1,0
21,285,285,46,25,21,2,1
14,300,300,30,2,28,3,2
29,325,325,2,2,0,1,0
18,331,331,58,58,0,1,0
20,350,350,15,15,0,1,0
22,356,356,64,52,12,4,3
8,357,357,16,16,0,1,0
26,381,381,75,43,32,2,1
4,399,399,31,6,25,4,3
19,402,402,34,10,24,4,3
28,408,408,14,14,0,1,0
2,442,442,104,54,50,2,1
6,453,453,51,2,49,2,1
11,460,460,31,6,25,3,2
7,470,470,25,25,0,1,0
27,470,470,42,18,24,4,3
5,480,480,10,10,0,1,0

18,119,119,12,2,10,3,2
20,121,121,48,48,0,1,0
2,122,122,11,2,9,4,3
28,145,145,11,3,8,3,2
29,149,149,5,5,0,1,0
4,163,163,27,3,24,4,3
6,173,173,27,27,0,1,0
0,177,177,25,25,0,1,0
22,180,180,1,1,0,1,0
17,207,207,12,2,10,3,2
16,211,211,23,23,0,1,0
9,217,217,12,12,0,1,0
8,223,223,12,2,10,3,2
25,224,224,27,9,18,2,1
7,243,243,4,4,0,1,0
12,281,281,11,11,0,1,0
1,292,292,20,7,13,4,3
27,313,313,73,73,0,1,0
15,321,321,16,16,0,1,0
24,323,323,14,14,0,1,0
14,331,331,9,3,6,3,2
11,338,338,6,3,3,2,1
13,353,353,144,139,5,2,1
26,362,362,36,36,0,1,0
3,375,375,29,29,0,1,0
21,389,389,12,12,0,1,0
32,402,402,96,96,0,1,0
10,403,403,18,18,0,1,0
23,429,429,11,4,7,2,1
31,460,460,48,48,0,1,0
19,465,465,28,28,0,1,0
30,478,478,1,1,0,1,0
5,486,486,39,19,20,3,2

29,112,112,15,15,0,1,0
20,119,119,6,6,0,1,0
36,123,123,12,12,0,1,0
19,147,147,1,1,0,1,0
33,151,151,3,3,0,1,0
38,173,173,23,23,0,1,0
24,179,179,47,5,42,4,3
5,224,224,9,9,0,1,0
7,231,231,2,2,0,1,0
28,232,232,41,3,38,3,2
34,233,233,21,9,12,3,2
30,241,241,8,8,0,1,0
0,244,244,1,1,0,1,0
11,247,247,8,8,0,1,0
26,249,249,22,16,6,3,2
18,258,258,38,17,21,2,1
35,280,280,1,1,0,1,0
2,281,281,1,1,0,1,0
14,284,284,1,1,0,1,0
15,304,304,18,18,0,1,0
39,309,309,28,19,9,4,3
13,324,324,9,3,6,2,1
16,329,329,28,16,12,4,3
4,338,338,36,36,0,1,0
6,340,340,91,79,12,4,3
1,347,347,85,35,50,3,2
37,349,349,11,11,0,1,0
3,359,359,14,6,8,3,2
8,363,363,28,8,20,2,1
31,390,390,66,36,30,4,3
32,403,403,42,30,12,4,3
27,404,404,39,1,38,3,2
25,420,420,43,43,0,1,0
10,428,428,28,28,0,1,0
17,451,451,24,24,0,1,0
23,461,461,11,2,9,4,3
21,469,469,31,25,6,3,2
22,471,471,60,11,49,2,1
12,473,473,12,12,0,1,0
9,500,500,18,2,16,3,2

12,103,103,27,27,0,1,0
21,117,117,14,5,9,2,1
4,125,125,4,4,0,1,0
22,127,127,3,3,0,1,0
16,129,129,12,12,0,1,0
27,163,163,12,12,0,1,0
10,177,177,21,1,20,2,1
20,179,179,22,22,0,1,0
14,180,180,4,4,0,1,0
5,183,183,54,44,10,3,2
23,188,188,17,11,6,2,1
2,203,203,1,1,0,1,0
24,209,209,1,1,0,1,0
7,223,223,58,30,28,3,2
1,227,227,13,3,10,2,1
18,242,242,72,41,31,2,1
19,271,271,17,17,0,1,0
8,285,285,35,9,26,3,2
13,292,292,7,7,0,1,0
6,295,295,48,48,0,1,0
11,301,301,34,34,0,1,0
3,321,321,11,5,6,2,1
26,334,334,35,35,0,1,0
25,347,347,7,7,0,1,0
17,380,380,85,25,60,4,3
9,413,413,20,11,9,4,3
0,460,460,162,68,94,3,2
15,491,491,50,50,0,1,0

20,123,123,2,2,0,1,0
7,165,165,14,14,0,1,0
8,184,184,59,59,0,1,0
19,192,192,2,2,0,1,0
33,201,201,13,13,0,1,0
27,206,206,18,3,15,2,1
23,208,208,8,8,0,1,0
14,212,212,4,4,0,1,0
0,215,215,8,8,0,1,0
24,218,218,5,5,0,1,0
9,239,239,1,1,0,1,0
2,252,252,6,3,3,2,1
28,258,258,10,10,0,1,0
32,270,270,54,54,0,1,0
11,271,271,14,14,0,1,0
10,293,293,3,3,0,1,0
29,308,308,34,34,0,1,0
21,313,313,31,21,10,3,2
26,315,315,85,25,60,4,3
31,327,327,10,10,0,1,0
3,338,338,7,7,0,1,0
22,340,340,38,38,0,1,0
34,343,343,51,34,17,2,1
17,358,358,30,30,0,1,0
16,365,365,26,19,7,2,1
12,373,373,67,67,0,1,0
5,383,383,29,23,6,2,1
25,401,401,99,99,0,1,0
13,414,414,45,45,0,1,0
1,420,420,128,128,0,1,0
30,438,438,59,32,27,4,3
15,440,440,1,1,0,1,0
4,445,445,27,27,0,1,0
18,459,459,39,39,0,1,0
6,496,496,28,12,16,3,2

26,109,109,3,3,0,1,0
8,127,127,1,1,0,1,0
19,148,148,9,1,8,3,2
5,152,152,2,2,0,1,0
0,178,178,31,22,9,4,3
13,185,185,5,5,0,1,0
11,194,194,14,14,0,1,0
3,234,234,59,59,0,1,0
7,249,249,6,6,0,1,0
14,263,263,72,33,39,4,3
25,277,277,1,1,0,1,0
22,288,288,8,8,0,1,0
20,290,290,21,14,7,2,1
6,307,307,23,23,0,1,0
12,333,333,48,48,0,1,0
10,339,339,32,23,9,4,3
21,364,364,1,1,0,1,0
9,383,383,103,10,93,4,3
24,388,388,5,5,0,1,0
27,389,389,9,1,8,2,1
28,390,390,48,48,0,1,0
16,401,401,136,116,20,2,1
18,403,403,32,32,0,1,0
1,410,410,64,22,42,2,1
2,420,420,131,83,48,3,2
23,438,438,162,159,3,2,1
17,467,467,6,6,0,1,0
4,481,481,4,4,0,1,0
15,496,496,87,87,0,1,0

8,105,105,4,4,0,1,0
19,106,106,34,12,22,3,2
33,108,108,5,5,0,1,0
25,110,110,1,1,0,1,0
2,119,119,1,1,0,1,0
9,147,147,7,7,0,1,0
34,164,164,11,5,6,3,2
10,167,167,14,14,0,1,0
22,183,183,6,6,0,1,0
16,193,193,6,6,0,1,0
15,206,206,4,4,0,1,0
29,238,238,49,49,0,1,0
13,240,240,2,2,0,1,0
27,267,267,2,2,0,1,0
35,270,270,17,6,11,2,1
36,276,276,36,36,0,1,0
30,278,278,13,3,10,2,1
7,301,301,13,13,0,1,0
20,307,307,1,1,0,1,0
18,321,321,34,18,16,3,2
26,330,330,58,52,6,2,1
37,339,339,44,3,41,2,1
4,344,344,57,3,54,3,2
23,345,345,20,10,10,2,1
6,346,346,11,11,0,1,0
0,357,357,51,37,14,2,1
5,367,367,7,7,0,1,0
38,370,370,60,29,31,3,2
31,397,397,67,15,52,3,2
32,418,418,2,2,0,1,0
21,425,425,64,22,42,4,3
28,443,443,153,132,21,4,3
14,445,445,26,10,16,2,1
17,447,447,3,3,0,1,0
11,449,449,24,24,0,1,0
12,460,460,1,1,0,1,0
1,466,466,54,13,41,2,1
24,486,486,5,5,0,1,0
3,493,493,55,55,0,1,0

6,105,105,17,10,7,2,1
14,105,105,1,1,0,1,0
28,108,108,28,28,0,1,0
11,111,111,11,1,10,3,2
4,117,117,7,1,6,2,1
13,117,117,14,14,0,1,0
27,153,153,5,5,0,1,0
16,154,154,6,6,0,1,0
5,156,156,6,2,4,2,1
19,168,168,24,24,0,1,0
29,258,258,1,1,0,1,0
0,259,259,4,4,0,1,0
31,268,268,47,29,18,3,2
21,268,268,3,3,0,1,0
9,268,268,37,37,0,1,0
25,277,277,13,13,0,1,0
20,282,282,65,26,39,4,3
8,301,301,54,54,0,1,0
1,316,316,66,24,42,3,2
30,353,353,17,2,15,3,2
17,362,362,42,1,41,4,3
26,369,369,44,44,0,1,0
10,370,370,56,19,37,3,2
24,398,398,48,6,42,4,3
15,424,424,48,48,0,1,0
7,434,434,70,6,64,4,3
3,452,452,26,26,0,1,0
2,453,453,1,1,0,1,0
23,461,461,88,88,0,1,0
22,485,485,14,5,9,4,3
18,490,490,33,12,21,2,1
12,492,492,42,42,0,1,0

2,106,106,7,7,0,1,0
15,123,123,71,71,0,1,0
4,131,131,1,1,0,1,0
28,131,131,28,28,0,1,0
24,134,134,14,2,12,3,2
3,149,149,26,26,0,1,0
23,160,160,48,23,25,2,1
16,161,161,11,11,0,1,0
17,185,185,11,11,0,1,0
29,225,225,23,23,0,1,0
25,238,238,27,22,5,2,1
11,263,263,47,33,14,2,1
12,277,277,16,1,15,4,3
26,293,293,54,54,0,1,0
9,306,306,19,1,18,3,2
31,320,320,31,31,0,1,0
0,332,332,12,12,0,1,0
22,332,332,16,13,3,2,1
7,335,335,10,10,0,1,0
14,360,360,44,29,15,4,3
30,360,360,35,18,17,4,3
6,375,375,30,23,7,2,1
19,377,377,26,26,0,1,0
27,382,382,20,5,15,4,3
10,384,384,12,1,11,2,1
1,419,419,41,26,15,4,3
18,437,437,31,31,0,1,0
20,458,458,12,12,0,1,0
8,470,470,20,6,14,3,2
13,477,477,13,1,12,3,2
5,486,486,8,8,0,1,0
21,500,500,19,1,18,3,2

3,101,101,4,4,0,1,0
32,119,119,29,9,20,2,1
29,120,120,14,14,0,1,0
26,125,125,23,1,22,4,3
25,139,139,22,22,0,1,0
6,170,170,36,6,30,2,1
31,188,188,1,1,0,1,0
13,203,203,5,5,0,1,0
20,207,207,4,4,0,1,0
11,210,210,29,1,28,2,1
17,213,213,48,45,3,2,1
12,216,216,28,11,17,2,1
23,248,248,17,17,0,1,0
24,249,249,2,2,0,1,0
27,258,258,10,7,3,2,1
18,277,277,49,22,27,4,3
9,281,281,20,2,18,3,2
0,284,284,15,7,8,2,1
22,287,287,58,4,54,3,2
14,300,300,15,15,0,1,0
30,324,324,22,4,18,2,1
21,338,338,5,5,0,1,0
7,363,363,12,2,10,3,2
15,376,376,141,141,0,1,0
5,385,385,32,4,28,4,3
16,394,394,27,5,22,2,1
28,396,396,34,31,3,2,1
10,404,404,93,41,52,4,3
4,409,409,3,3,0,1,0
8,462,462,25,13,12,2,1
19,465,465,10,10,0,1,0
2,466,466,8,8,0,1,0
1,499,499,8,8,0,1,0

21,106,106,13,13,0,1,0
27,128,128,15,15,0,1,0
1,130,130,11,11,0,1,0
4,167,167,4,4,0,1,0
32,204,204,5,5,0,1,0
22,209,209,13,13,0,1,0
11,237,237,21,21,0,1,0
31,241,241,50,50,0,1,0
9,241,241,6,6,0,1,0
2,262,262,11,11,0,1,0
19,268,268,3,3,0,1,0
30,269,269,14,14,0,1,0
15,283,283,99,99,0,1,0
17,285,285,1,1,0,1,0
3,310,310,21,5,16,3,2
8,314,314,1,1,0,1,0
6,333,333,25,13,12,2,1
24,338,338,164,128,36,3,2
33,343,343,28,28,0,1,0
23,346,346,19,19,0,1,0
7,355,355,42,27,15,2,1
18,358,358,57,57,0,1,0
35,370,370,2,2,0,1,0
5,393,393,2,2,0,1,0
26,399,399,30,18,12,2,1
13,400,400,33,18,15,2,1
16,408,408,60,26,34,3,2
29,412,412,4,4,0,1,0
14,436,436,62,2,60,3,2
28,447,447,29,17,12,2,1
10,452,452,15,15,0,1,0
20,459,459,6,6,0,1,0
0,467,467,60,60,0,1,0
34,477,477,79,79,0,1,0
25,480,480,46,46,0,1,0
12,493,493,6,6,0,1,0

14,101,101,3,3,0,1,0
23,103,103,8,3,5,2,1
33,131,131,28,28,0,1,0
19,137,137,18,12,6,2,1
10,139,139,8,8,0,1,0
15,143,143,8,8,0,1,0
2,143,143,1,1,0,1,0
9,147,147,4,4,0,1,0
0,170,170,2,2,0,1,0
8,176,176,5,5,0,1,0
3,177,177,41,29,12,3,2
21,179,179,20,20,0,1,0
30,179,179,4,1,3,2,1
27,183,183,3,3,0,1,0
1,185,185,1,1,0,1,0
7,198,198,18,18,0,1,0
29,201,201,1,1,0,1,0
17,219,219,21,21,0,1,0
11,226,226,39,15,24,4,3
20,263,263,58,11,47,2,1
34,300,300,42,37,5,2,1
31,303,303,17,17,0,1,0
18,320,320,16,2,14,2,1
12,321,321,7,7,0,1,0
4,334,334,58,58,0,1,0
13,343,343,35,3,32,3,2
24,359,359,25,4,21,4,3
6,379,379,15,15,0,1,0
32,385,385,102,102,0,1,0
22,386,386,16,8,8,3,2
26,409,409,42,42,0,1,0
5,459,459,83,44,39,2,1
28,466,466,12,12,0,1,0
25,468,468,62,52,10,3,2
16,499,499,110,68,42,4,3

9,100,100,12,12,0,1,0
27,117,117,3,3,0,1,0
8,120,120,8,8,0,1,0
5,139,139,1,1,0,1,0
30,146,146,46,46,0,1,0
23,152,152,32,11,21,2,1
17,160,160,1,1,0,1,0
4,165,165,40,40,0,1,0
31,167,167,26,6,20,4,3
1,178,178,6,6,0,1,0
22,189,189,2,2,0,1,0
14,207,207,14,2,12,2,1
19,207,207,8,8,0,1,0
3,231,231,17,5,12,3,2
11,231,231,19,19,0,1,0
26,234,234,4,4,0,1,0
37,257,257,33,28,5,2,1
6,260,260,6,6,0,1,0
38,274,274,22,5,17,2,1
34,277,277,21,3,18,4,3
32,292,292,16,16,0,1,0
35,313,313,21,21,0,1,0
28,321,321,24,20,4,2,1
36,328,328,9,9,0,1,0
2,346,346,20,20,0,1,0
7,350,350,5,5,0,1,0
33,383,383,55,55,0,1,0
10,389,389,34,34,0,1,0
29,398,398,8,8,0,1,0
20,404,404,24,15,9,2,1
15,418,418,16,16,0,1,0
18,421,421,33,21,12,3,2
21,427,427,62,39,23,2,1
0,452,452,10,7,3,2,1
24,478,478,14,2,12,4,3
16,482,482,36,36,0,1,0
13,483,483,24,6,18,3,2
25,496,496,101,80,21,4,3
12,500,500,102,54,48,4,3

34,105,105,17,9,8,3,2
18,116,116,3,3,0,1,0
12,123,123,10,7,3,2,1
25,133,133,27,1,26,3,2
11,151,151,1,1,0,1,0
23,168,168,17,9,8,3,2
35,175,175,1,1,0,1,0
26,189,189,11,1,10,3,2
21,196,196,2,2,0,1,0
3,206,206,11,11,0,1,0
22,227,227,11,11,0,1,0
15,229,229,23,11,12,3,2
17,254,254,6,6,0,1,0
28,275,275,32,32,0,1,0
4,298,298,26,26,0,1,0
0,310,310,4,4,0,1,0
30,329,329,11,3,8,2,1
33,332,332,24,14,10,3,2
5,336,336,27,6,21,2,1
6,339,339,7,7,0,1,0
27,360,360,74,5,69,4,3
19,403,403,31,16,15,4,3
31,416,416,5,5,0,1,0
2,422,422,19,19,0,1,0
24,430,430,167,131,36,2,1
13,437,437,5,5,0,1,0
16,440,440,86,56,30,4,3
14,442,442,21,21,0,1,0
8,455,455,116,92,24,3,2
1,456,456,89,20,69,4,3
20,463,463,10,4,6,3,2
10,468,468,116,116,0,1,0
32,475,475,86,19,67,4,3
9,478,478,3,3,0,1,0
29,491,491,9,9,0,1,0
7,499,499,14,14,0,1,0

20,113,113,3,3,0,1,0
10,167,167,6,6,0,1,0
5,190,190,79,79,0,1,0
21,206,206,13,13,0,1,0
19,206,206,7,7,0,1,0
14,214,214,41,17,24,3,2
6,220,220,9,9,0,1,0
23,233,233,8,8,0,1,0
24,238,238,6,1,5,2,1
22,256,256,38,2,36,2,1
12,265,265,70,70,0,1,0
28,300,300,36,36,0,1,0
2,318,318,13,5,8,2,1
9,340,340,87,87,0,1,0
29,343,343,3,3,0,1,0
3,370,370,28,28,0,1,0
26,371,371,39,39,0,1,0
27,378,378,41,9,32,2,1
8,391,391,20,1,19,2,1
18,397,397,3,3,0,1,0
4,407,407,32,32,0,1,0
7,415,415,34,17,17,2,1
25,420,420,70,53,17,2,1
17,424,424,64,18,46,2,1
1,427,427,2,2,0,1,0
13,429,429,50,50,0,1,0
15,453,453,68,65,3,2,1
0,463,463,39,13,26,2,1
16,482,482,139,31,108,4,3
11,484,484,27,2,25,3,2

2,105,105,7,4,3,2,1
33,121,121,13,7,6,2,1
34,125,125,2,2,0,1,0
5,153,153,5,5,0,1,0
4,164,164,1,1,0,1,0
30,173,173,46,46,0,1,0
7,210,210,2,2,0,1,0
27,212,212,2,2,0,1,0
29,231,231,3,3,0,1,0
12,239,239,16,16,0,1,0
14,251,251,2,2,0,1,0
26,260,260,27,27,0,1,0
9,288,288,53,53,0,1,0
13,297,297,23,23,0,1,0
6,308,308,33,33,0,1,0
24,308,308,62,62,0,1,0
21,312,312,33,3,30,4,3
10,325,325,39,39,0,1,0
15,328,328,18,18,0,1,0
23,341,341,25,25,0,1,0
19,344,344,26,26,0,1,0
11,362,362,46,46,0,1,0
0,363,363,41,41,0,1,0
32,368,368,13,13,0,1,0
31,370,370,72,16,56,4,3
20,373,373,91,17,74,3,2
35,402,402,29,25,4,2,1
22,403,403,17,17,0,1,0
17,406,406,48,1,47,3,2
25,429,429,48,6,42,2,1
28,432,432,18,18,0,1,0
18,450,450,64,10,54,3,2
16,450,450,12,6,6,3,2
8,467,467,17,17,0,1,0
1,470,470,52,4,48,4,3
3,493,493,59,59,0,1,0

3,124,124,9,9,0,1,0
26,155,155,51,51,0,1,0
18,164,164,2,2,0,1,0
15,168,168,6,6,0,1,0
24,178,178,15,4,11,2,1
21,184,184,17,1,16,2,1
27,185,185,23,6,17,2,1
10,193,193,37,37,0,1,0
22,207,207,5,5,0,1,0
11,225,225,41,17,24,3,2
7,235,235,10,1,9,2,1
0,253,253,11,11,0,1,0
2,264,264,36,1,35,2,1
19,296,296,30,2,28,3,2
12,300,300,9,9,0,1,0
29,307,307,52,52,0,1,0
23,308,308,42,19,23,2,1
8,339,339,37,13,24,4,3
25,341,341,11,5,6,3,2
28,347,347,29,11,18,2,1
30,365,365,67,19,48,2,1
6,384,384,38,14,24,4,3
9,395,395,169,44,125,4,3
1,395,395,10,3,7,3,2
14,402,402,14,2,12,3,2
17,403,403,44,29,15,4,3
13,422,422,41,41,0,1,0
20,449,449,18,18,0,1,0
16,479,479,38,32,6,2,1
4,479,479,45,45,0,1,0
5,499,499,7,7,0,1,0

26,102,102,2,2,0,1,0
11,107,107,1,1,0,1,0
17,107,107,9,1,8,3,2
12,112,112,17,17,0,1,0
2,116,116,6,6,0,1,0
5,121,121,27,12,15,2,1
19,125,125,23,23,0,1,0
28,186,186,3,3,0,1,0
7,189,189,5,5,0,1,0
22,198,198,40,40,0,1,0
29,200,200,3,3,0,1,0
18,227,227,16,16,0,1,0
8,270,270,53,32,21,2,1
4,278,278,20,2,18,4,3
24,278,278,25,25,0,1,0
10,289,289,10,10,0,1,0
3,311,311,26,26,0,1,0
1,322,322,31,12,19,2,1
13,324,324,2,2,0,1,0
25,335,335,4,1,3,2,1
16,341,341,22,4,18,3,2
15,355,355,4,4,0,1,0
20,380,380,36,8,28,2,1
14,397,397,40,6,34,2,1
27,409,409,151,151,0,1,0
0,442,442,36,36,0,1,0
6,469,469,42,42,0,1,0
9,483,483,231,206,25,2,1
21,487,487,100,97,3,2,1
23,494,494,45,45,0,1,0

10,115,115,2,2,0,1,0
6,147,147,26,26,0,1,0
25,159,159,12,4,8,3,2
30,163,163,3,3,0,1,0
14,173,173,2,2,0,1,0
24,181,181,1,1,0,1,0
17,237,237,1,1,0,1,0
0,243,243,5,5,0,1,0
1,244,244,70,18,52,4,3
8,252,252,46,4,42,3,2
3,256,256,2,2,0,1,0
18,265,265,62,62,0,1,0
15,274,274,40,17,23,2,1
28,276,276,9,1,8,3,2
29,287,287,21,3,18,4,3
2,314,314,89,89,0,1,0
32,330,330,210,117,93,4,3
26,335,335,39,39,0,1,0
20,340,340,24,14,10,2,1
16,343,343,33,15,18,2,1
21,349,349,12,12,0,1,0
19,355,355,37,2,35,2,1
4,356,356,4,4,0,1,0
7,366,366,20,20,0,1,0
22,370,370,6,6,0,1,0
5,381,381,6,6,0,1,0
31,381,381,23,8,15,2,1
13,405,405,13,13,0,1,0
27,420,420,17,2,15,4,3
11,429,429,78,18,60,3,2
23,438,438,49,43,6,2,1
12,465,465,13,4,9,2,1
9,499,499,25,19,6,3,2

30,108,108,17,17,0,1,0
36,115,115,9,1,8,3,2
5,115,115,7,7,0,1,0
24,119,119,4,4,0,1,0
0,121,121,5,1,4,2,1
10,129,129,14,1,13,2,1
18,154,154,11,1,10,3,2
32,161,161,37,22,15,4,3
16,162,162,4,1,3,2,1
19,174,174,9,9,0,1,0
8,176,176,7,7,0,1,0
27,180,180,48,10,38,3,2
15,188,188,5,2,3,2,1
25,202,202,28,3,25,2,1
6,229,229,4,4,0,1,0
14,236,236,26,26,0,1,0
43,254,254,2,2,0,1,0
26,258,258,13,8,5,2,1
13,274,274,21,21,0,1,0
41,297,297,7,7,0,1,0
11,315,315,15,5,10,2,1
39,323,323,35,19,16,3,2
21,324,324,9,9,0,1,0
17,333,333,3,3,0,1,0
20,335,335,3,3,0,1,0
3,346,346,4,4,0,1,0
7,350,350,9,1,8,2,1
33,365,365,14,14,0,1,0
42,368,368,14,2,12,4,3
38,384,384,89,17,72,4,3
12,398,398,2,2,0,1,0
29,409,409,17,17,0,1,0
2,412,412,7,2,5,2,1
4,421,421,63,17,46,3,2
28,428,428,67,67,0,1,0
23,432,432,17,7,10,3,2
35,438,438,7,7,0,1,0
22,445,445,6,3,3,2,1
9,447,447,7,7,0,1,0
1,451,451,50,18,32,2,1
37,453,453,121,121,0,1,0
34,468,468,66,30,36,2,1
40,487,487,19,19,0,1,0
31,498,498,25,21,4,2,1

25,104,104,5,5,0,1,0
6,110,110,29,7,22,4,3
20,127,127,5,5,0,1,0
12,142,142,7,2,5,2,1
15,166,166,28,28,0,1,0
16,184,184,41,23,18,4,3
5,187,187,15,10,5,2,1
9,193,193,1,1,0,1,0
8,203,203,15,15,0,1,0
28,208,208,33,21,12,3,2
2,218,218,21,1,20,3,2
3,232,232,8,8,0,1,0
10,254,254,52,1,51,4,3
14,277,277,11,5,6,3,2
13,278,278,23,23,0,1,0
19,279,279,16,16,0,1,0
30,300,300,2,2,0,1,0
24,333,333,54,37,17,2,1
11,335,335,1,1,0,1,0
0,362,362,30,21,9,4,3
17,388,388,24,12,12,2,1
4,397,397,16,9,7,2,1
22,414,414,42,42,0,1,0
27,419,419,35,30,5,2,1
1,424,424,153,153,0,1,0
26,436,436,8,8,0,1,0
29,437,437,52,52,0,1,0
23,443,443,130,111,19,4,3
21,451,451,27,16,11,2,1
18,489,489,18,18,0,1,0
7,499,499,92,2,90,4,3

2,102,102,5,5,0,1,0
24,109,109,8,8,0,1,0
29,130,130,22,18,4,2,1
9,162,162,7,7,0,1,0
15,180,180,20,6,14,2,1
1,206,206,2,2,0,1,0
30,207,207,61,9,52,4,3
10,212,212,32,10,22,3,2
25,235,235,20,20,0,1,0
6,244,244,1,1,0,1,0
7,244,244,15,15,0,1,0
12,244,244,172,151,21,4,3
28,257,257,7,7,0,1,0
22,266,266,18,18,0,1,0
17,271,271,19,19,0,1,0
5,302,302,4,4,0,1,0
14,310,310,32,32,0,1,0
3,310,310,9,9,0,1,0
23,311,311,66,54,12,4,3
31,313,313,61,40,21,4,3
26,318,318,10,2,8,3,2
8,362,362,8,2,6,3,2
18,370,370,5,5,0,1,0
16,370,370,5,5,0,1,0
21,372,372,27,11,16,3,2
19,389,389,40,14,26,3,2
11,392,392,64,25,39,4,3
20,421,421,1,1,0,1,0
13,436,436,43,21,22,3,2
27,451,451,90,8,82,4,3
0,469,469,10,4,6,2,1
4,478,478,8,3,5,2,1

14,105,105,3,3,0,1,0
22,110,110,3,3,0,1,0
18,140,140,7,7,0,1,0
29,144,144,19,19,0,1,0
13,168,168,13,5,8,2,1
9,205,205,33,33,0,1,0
5,236,236,79,79,0,1,0
0,238,238,9,9,0,1,0
21,244,244,27,27,0,1,0
19,246,246,10,3,7,2,1
15,262,262,53,5,48,3,2
12,266,266,3,3,0,1,0
16,285,285,19,19,0,1,0
8,306,306,50,20,30,3,2
7,316,316,1,1,0,1,0
10,324,324,73,73,0,1,0
4,340,340,16,16,0,1,0
20,357,357,19,19,0,1,0
28,378,378,170,32,138,4,3
11,381,381,103,65,38,3,2
24,382,382,18,18,0,1,0
26,403,403,5,5,0,1,0
23,420,420,2,2,0,1,0
6,436,436,89,35,54,4,3
17,445,445,48,35,13,2,1
2,455,455,26,3,23,2,1
1,458,458,3,3,0,1,0
3,487,487,3,3,0,1,0
27,488,488,52,52,0,1,0
25,497,497,101,101,0,1,0

9,100,100,10,10,0,1,0
6,107,107,9,9,0,1,0
14,127,127,3,3,0,1,0
3,148,148,13,7,6,3,2
29,152,152,14,14,0,1,0
27,155,155,6,6,0,1,0
32,158,158,4,1,3,2,1
11,170,170,18,4,14,3,2
33,171,171,17,11,6,2,1
30,174,174,20,20,0,1,0
25,182,182,2,2,0,1,0
34,209,209,20,1,19,2,1
2,221,221,9,9,0,1,0
8,226,226,4,4,0,1,0
0,233,233,34,15,19,2,1
21,244,244,53,41,12,3,2
26,257,257,51,51,0,1,0
10,259,259,16,16,0,1,0
12,274,274,38,27,11,2,1
31,298,298,16,16,0,1,0
17,304,304,3,3,0,1,0
20,314,314,111,36,75,4,3
7,322,322,65,41,24,4,3
23,324,324,33,33,0,1,0
24,336,336,13,13,0,1,0
13,354,354,10,10,0,1,0
16,355,355,60,60,0,1,0
22,368,368,20,20,0,1,0
15,370,370,13,13,0,1,0
18,378,378,15,11,4,2,1
35,386,386,11,11,0,1,0
4,397,397,16,16,0,1,0
1,406,406,4,1,3,2,1
19,434,434,16,7,9,2,1
5,457,457,102,102,0,1,0
28,479,479,51,37,14,2,1

0,141,141,4,1,3,2,1
22,156,156,36,36,0,1,0
15,160,160,1,1,0,1,0
2,173,173,3,3,0,1,0
35,173,173,19,7,12,4,3
7,176,176,29,8,21,2,1
20,179,179,16,16,0,1,0
30,181,181,28,15,13,2,1
36,194,194,2,2,0,1,0
19,201,201,13,3,10,3,2
8,203,203,4,4,0,1,0
33,205,205,15,15,0,1,0
21,205,205,8,8,0,1,0
25,208,208,12,3,9,4,3
1,218,218,41,1,40,3,2
18,220,220,4,4,0,1,0
31,225,225,14,14,0,1,0
32,236,236,4,4,0,1,0
16,256,256,3,3,0,1,0
13,266,266,17,17,0,1,0
24,295,295,52,52,0,1,0
5,305,305,31,31,0,1,0
34,306,306,13,7,6,2,1
28,312,312,42,6,36,2,1
9,318,318,33,6,27,4,3
4,320,320,6,6,0,1,0
10,323,323,83,83,0,1,0
27,329,329,13,3,10,2,1
3,353,353,24,10,14,3,2
14,358,358,50,50,0,1,0
26,384,384,22,22,0,1,0
17,415,415,45,45,0,1,0
11,422,422,28,9,19,2,1
6,445,445,14,5,9,4,3
12,467,467,17,7,10,2,1
29,468,468,42,42,0,1,0
23,492,492,166,166,0,1,0

11,103,103,3,3,0,1,0
38,106,106,22,19,3,2,1
34,127,127,18,9,9,4,3
10,136,136,2,2,0,1,0
35,142,142,1,1,0,1,0
15,159,159,10,10,0,1,0
31,162,162,13,8,5,2,1
3,163,163,33,14,19,2,1
24,175,175,11,11,0,1,0
8,176,176,12,9,3,2,1
19,180,180,1,1,0,1,0
21,183,183,16,16,0,1,0
25,184,184,8,8,0,1,0
36,203,203,5,5,0,1,0
6,214,214,62,28,34,3,2
18,215,215,1,1,0,1,0
14,219,219,5,2,3,2,1
2,229,229,13,13,0,1,0
26,232,232,5,5,0,1,0
17,233,233,5,5,0,1,0
16,272,272,8,2,6,2,1
20,274,274,2,2,0,1,0
37,303,303,15,6,9,4,3
30,340,340,1,1,0,1,0
32,340,340,74,35,39,2,1
0,367,367,27,19,8,2,1
12,382,382,52,5,47,2,1
29,396,396,84,62,22,3,2
23,402,402,7,3,4,2,1
22,404,404,7,2,5,2,1
4,441,441,33,5,28,3,2
5,447,447,1,1,0,1,0
9,448,448,21,2,19,2,1
27,449,449,27,27,0,1,0
33,474,474,10,1,9,4,3
1,477,477,129,50,79,3,2
13,487,487,16,16,0,1,0
7,488,488,22,22,0,1,0
28,490,490,225,225,0,1,0

22,104,104,1,1,0,1,0
3,111,111,2,2,0,1,0
1,151,151,14,6,8,3,2
4,168,168,1,1,0,1,0
6,177,177,10,3,7,2,1
34,192,192,66,58,8,2,1
14,193,193,17,17,0,1,0
20,196,196,24,3,21,4,3
32,196,196,21,11,10,3,2
17,197,197,12,12,0,1,0
38,199,199,45,11,34,3,2
26,204,204,7,7,0,1,0
28,208,208,8,8,0,1,0
8,230,230,15,15,0,1,0
19,231,231,10,10,0,1,0
7,247,247,1,1,0,1,0
27,260,260,19,19,0,1,0
18,264,264,29,24,5,2,1
25,271,271,6,6,0,1,0
39,273,273,4,4,0,1,0
5,287,287,6,3,3,2,1
13,292,292,29,4,25,3,2
35,301,301,72,25,47,4,3
12,322,322,60,17,43,4,3
11,349,349,17,17,0,1,0
9,351,351,35,26,9,2,1
15,352,352,7,7,0,1,0
2,360,360,11,11,0,1,0
10,369,369,7,7,0,1,0
16,382,382,28,21,7,2,1
0,423,423,105,105,0,1,0
37,433,433,21,3,18,3,2
29,438,438,18,12,6,3,2
23,439,439,3,3,0,1,0
31,446,446,2,2,0,1,0
24,446,446,8,8,0,1,0
36,454,454,30,30,0,1,0
30,461,461,129,72,57,4,3
21,468,468,34,3,31,2,1
33,493,493,33,19,14,3,2

6,107,107,2,2,0,1,0
29,109,109,3,3,0,1,0
32,116,116,32,32,0,1,0
18,119,119,5,5,0,1,0
27,126,126,6,6,0,1,0
23,155,155,9,2,7,2,1
26,158,158,18,18,0,1,0
20,158,158,4,1,3,2,1
8,209,209,6,6,0,1,0
1,224,224,41,17,24,4,3
16,230,230,7,7,0,1,0
24,257,257,9,5,4,2,1
7,260,260,8,8,0,1,0
12,262,262,3,3,0,1,0
19,264,264,8,3,5,2,1
3,274,274,16,16,0,1,0
21,280,280,32,32,0,1,0
30,295,295,11,11,0,1,0
31,324,324,74,11,63,4,3
5,343,343,181,118,63,4,3
13,363,363,28,28,0,1,0
15,375,375,2,2,0,1,0
22,380,380,95,25,70,3,2
28,392,392,85,49,36,3,2
9,396,396,6,2,4,2,1
0,398,398,18,18,0,1,0
25,403,403,53,53,0,1,0
14,412,412,75,27,48,2,1
11,421,421,9,9,0,1,0
4,447,447,30,15,15,2,1
17,483,483,3,3,0,1,0
10,485,485,23,23,0,1,0
2,497,497,126,81,45,4,3

17,104,104,29,10,19,2,1
32,145,145,31,31,0,1,0
18,161,161,1,1,0,1,0
10,164,164,51,51,0,1,0
3,167,167,4,4,0,1,0
29,175,175,18,13,5,2,1
22,196,196,14,2,12,3,2
20,206,206,5,1,4,2,1
26,216,216,32,8,24,2,1
30,245,245,21,21,0,1,0
2,267,267,2,2,0,1,0
5,290,290,5,5,0,1,0
31,296,296,17,1,16,3,2
0,297,297,1,1,0,1,0
9,315,315,6,6,0,1,0
14,323,323,21,21,0,1,0
13,324,324,66,51,15,4,3
8,325,325,46,37,9,2,1
25,340,340,81,41,40,4,3
4,340,340,6,2,4,2,1
28,377,377,20,11,9,4,3
1,378,378,19,3,16,2,1
34,388,388,137,125,12,4,3
12,388,388,22,22,0,1,0
24,394,394,40,14,26,2,1
21,396,396,15,15,0,1,0
36,400,400,27,15,12,4,3
23,402,402,11,5,6,2,1
37,412,412,15,12,3,2,1
35,415,415,8,8,0,1,0
27,428,428,5,5,0,1,0
19,430,430,15,15,0,1,0
15,435,435,37,37,0,1,0
33,450,450,19,19,0,1,0
6,457,457,51,1,50,3,2
7,468,468,23,23,0,1,0
11,469,469,11,7,4,2,1
16,472,472,16,16,0,1,0

1,133,133,17,9,8,3,2
25,135,135,10,4,6,2,1
24,166,166,6,3,3,2,1
7,169,169,13,9,4,2,1
15,169,169,11,6,5,2,1
0,175,175,15,15,0,1,0
12,177,177,4,1,3,2,1
6,183,183,43,13,30,2,1
14,211,211,56,2,54,4,3
5,234,234,42,36,6,2,1
3,239,239,3,3,0,1,0
32,243,243,21,3,18,4,3
23,254,254,31,18,13,2,1
18,277,277,28,20,8,2,1
16,305,305,29,8,21,4,3
30,309,309,8,3,5,2,1
26,320,320,36,26,10,2,1
2,330,330,13,13,0,1,0
28,333,333,63,63,0,1,0
9,350,350,5,5,0,1,0
4,366,366,31,20,11,2,1
13,378,378,4,4,0,1,0
21,383,383,159,23,136,4,3
27,403,403,37,32,5,2,1
8,410,410,60,60,0,1,0
31,410,410,7,7,0,1,0
10,411,411,4,4,0,1,0
19,413,413,20,1,19,4,3
20,421,421,19,19,0,1,0
17,432,432,5,2,3,2,1
33,444,444,9,3,6,2,1
22,447,447,43,43,0,1,0
11,470,470,56,28,28,4,3
29,479,479,70,50,20,2,1

0,106,106,1,1,0,1,0
17,108,108,22,22,0,1,0
27,115,115,3,3,0,1,0
23,115,115,11,11,0,1,0
6,144,144,2,2,0,1,0
16,155,155,15,15,0,1,0
28,185,185,25,25,0,1,0
14,186,186,13,3,10,2,1
3,202,202,14,14,0,1,0
20,210,210,49,1,48,3,2
31,214,214,32,2,30,2,1
24,237,237,8,5,3,2,1
21,257,257,9,6,3,2,1
19,273,273,14,14,0,1,0
8,275,275,30,30,0,1,0
7,281,281,21,4,17,2,1
13,282,282,6,6,0,1,0
1,286,286,20,17,3,2,1
9,306,306,55,21,34,3,2
25,308,308,30,20,10,2,1
12,327,327,59,59,0,1,0
15,342,342,30,14,16,3,2
18,360,360,66,66,0,1,0
30,367,367,38,38,0,1,0
4,387,387,42,42,0,1,0
11,414,414,123,30,93,4,3
26,451,451,57,57,0,1,0
22,453,453,29,16,13,2,1
2,468,468,60,18,42,3,2
5,472,472,31,31,0,1,0
10,487,487,57,57,0,1,0
29,493,493,2,2,0,1,0

15,130,130,7,7,0,1,0
7,132,132,18,6,12,3,2
24,146,146,10,10,0,1,0
28,159,159,15,5,10,2,1
29,184,184,9,9,0,1,0
11,186,186,5,5,0,1,0
14,187,187,56,38,18,3,2
20,187,187,2,2,0,1,0
13,194,194,23,23,0,1,0
10,211,211,4,4,0,1,0
12,212,212,9,9,0,1,0
30,246,246,2,2,0,1,0
19,255,255,51,22,29,2,1
5,258,258,27,8,19,3,2
0,260,260,46,40,6,2,1
17,267,267,41,41,0,1,0
27,268,268,3,3,0,1,0
18,282,282,93,93,0,1,0
6,362,362,31,4,27,4,3
9,367,367,1,1,0,1,0
16,370,370,61,22,39,4,3
2,378,378,6,6,0,1,0
25,402,402,75,57,18,4,3
22,414,414,25,20,5,2,1
21,421,421,42,16,26,3,2
26,443,443,27,22,5,2,1
23,470,470,39,39,0,1,0
8,486,486,16,16,0,1,0
4,493,493,102,102,0,1,0
3,499,499,30,30,0,1,0
1,500,500,136,111,25,4,3

17,110,110,6,6,0,1,0
18,119,119,3,3,0,1,0
23,127,127,23,23,0,1,0
14,128,128,16,16,0,1,0
13,133,133,1,1,0,1,0
8,164,164,12,9,3,2,1
15,173,173,4,4,0,1,0
2,183,183,27,27,0,1,0
10,185,185,42,8,34,2,1
1,190,190,13,1,12,4,3
34,193,193,24,6,18,2,1
22,214,214,51,30,21,2,1
0,229,229,11,11,0,1,0
35,235,235,2,2,0,1,0
30,240,240,36,2,34,3,2
32,258,258,30,30,0,1,0
5,266,266,1,1,0,1,0
16,278,278,5,5,0,1,0
28,283,283,67,67,0,1,0
21,286,286,18,18,0,1,0
27,297,297,25,8,17,2,1
6,299,299,49,49,0,1,0
11,309,309,45,3,42,2,1
12,321,321,33,12,21,2,1
20,327,327,54,54,0,1,0
33,334,334,7,2,5,2,1
26,365,365,8,8,0,1,0
4,386,386,1,1,0,1,0
9,387,387,25,25,0,1,0
3,398,398,37,18,19,2,1
7,398,398,1,1,0,1,0
25,413,413,10,3,7,2,1
29,419,419,3,3,0,1,0
24,441,441,72,72,0,1,0
31,449,449,11,11,0,1,0
19,465,465,95,95,0,1,0

9,111,111,16,16,0,1,0
25,148,148,9,9,0,1,0
3,154,154,3,3,0,1,0
24,154,154,66,66,0,1,0
7,162,162,15,15,0,1,0
10,163,163,52,52,0,1,0
22,164,164,7,7,0,1,0
4,189,189,20,8,12,4,3
19,191,191,20,20,0,1,0
14,201,201,39,33,6,3,2
5,204,204,23,8,15,4,3
6,250,250,23,23,0,1,0
13,262,262,4,4,0,1,0
17,269,269,15,10,5,2,1
18,275,275,39,32,7,2,1
8,317,317,40,40,0,1,0
1,334,334,68,18,50,3,2
20,337,337,31,31,0,1,0
23,350,350,2,2,0,1,0
2,356,356,28,3,25,2,1
26,366,366,9,2,7,2,1
15,366,366,11,3,8,3,2
28,370,370,30,4,26,4,3
12,399,399,103,13,90,3,2
16,402,402,83,1,82,3,2
27,402,402,41,21,20,3,2
11,421,421,6,6,0,1,0
0,477,477,17,17,0,1,0
21,490,490,23,23,0,1,0

31,101,101,6,6,0,1,0
1,127,127,15,4,11,4,3
20,147,147,14,2,12,4,3
19,171,171,8,8,0,1,0
28,174,174,19,12,7,2,1
18,175,175,12,12,0,1,0
11,179,179,15,15,0,1,0
10,181,181,24,24,0,1,0
21,194,194,28,28,0,1,0
26,212,212,7,7,0,1,0
2,215,215,23,15,8,2,1
23,216,216,26,4,22,2,1
14,224,224,8,8,0,1,0
25,248,248,77,63,14,3,2
0,249,249,38,14,24,3,2
8,252,252,43,43,0,1,0
6,259,259,25,4,21,4,3
16,300,300,8,8,0,1,0
9,307,307,7,7,0,1,0
15,308,308,59,59,0,1,0
13,333,333,7,7,0,1,0
12,351,351,18,12,6,2,1
30,387,387,64,40,24,4,3
3,390,390,14,1,13,2,1
5,450,450,135,113,22,3,2
22,451,451,34,34,0,1,0
27,451,451,57,30,27,4,3
29,463,463,1,1,0,1,0
24,468,468,60,16,44,2,1
4,470,470,7,2,5,2,1
32,482,482,37,25,12,3,2
7,490,490,20,1,19,2,1
17,498,498,40,40,0,1,0

19,110,110,6,6,0,1,0
12,127,127,2,2,0,1,0
5,137,137,14,14,0,1,0
14,143,143,10,10,0,1,0
40,148,148,9,9,0,1,0
39,156,156,3,3,0,1,0
11,163,163,2,2,0,1,0
18,170,170,18,3,15,2,1
29,176,176,30,30,0,1,0
13,181,181,5,2,3,2,1
28,188,188,47,3,44,4,3
25,213,213,3,3,0,1,0
0,227,227,3,3,0,1,0
23,231,231,26,11,15,2,1
24,232,232,39,39,0,1,0
3,235,235,3,3,0,1,0
2,237,237,19,6,13,2,1
32,239,239,22,16,6,3,2
37,246,246,1,1,0,1,0
16,249,249,2,2,0,1,0
31,253,253,29,18,11,2,1
4,255,255,11,11,0,1,0
6,267,267,27,27,0,1,0
27,273,273,81,63,18,2,1
22,309,309,8,8,0,1,0
10,315,315,2,2,0,1,0
1,348,348,142,7,135,4,3
36,351,351,2,2,0,1,0
9,356,356,2,2,0,1,0
21,356,356,15,15,0,1,0
34,390,390,34,18,16,2,1
33,390,390,54,38,16,3,2
8,391,391,2,2,0,1,0
30,407,407,16,4,12,2,1
15,421,421,2,2,0,1,0
38,427,427,62,40,22,2,1
17,434,434,22,12,10,2,1
7,463,463,49,10,39,4,3
35,471,471,23,23,0,1,0
20,491,491,9,3,6,3,2
26,499,499,71,47,24,4,3

4,101,101,1,1,0,1,0
20,121,121,6,3,3,2,1
8,137,137,7,2,5,2,1
22,146,146,5,5,0,1,0
9,159,159,6,6,0,1,0
18,180,180,13,5,8,2,1
24,211,211,18,18,0,1,0
21,217,217,32,32,0,1,0
27,219,219,50,50,0,1,0
19,219,219,36,36,0,1,0
17,226,226,12,12,0,1,0
13,238,238,35,35,0,1,0
15,257,257,10,1,9,4,3
26,277,277,5,5,0,1,0
6,284,284,20,20,0,1,0
1,288,288,40,23,17,2,1
23,311,311,52,52,0,1,0
12,342,342,40,40,0,1,0
5,386,386,197,197,0,1,0
7,392,392,104,42,62,3,2
2,437,437,10,10,0,1,0
16,439,439,108,9,99,4,3
3,440,440,15,5,10,2,1
11,440,440,153,117,36,4,3
0,464,464,41,41,0,1,0
14,468,468,2,2,0,1,0
10,474,474,12,12,0,1,0
25,477,477,27,12,15,2,1

9,109,109,9,9,0,1,0
6,115,115,1,1,0,1,0
10,115,115,22,4,18,4,3
17,128,128,16,3,13,2,1
8,145,145,7,7,0,1,0
27,160,160,9,9,0,1,0
1,166,166,83,7,76,3,2
14,188,188,19,19,0,1,0
19,193,193,3,3,0,1,0
20,195,195,5,5,0,1,0
5,206,206,1,1,0,1,0
16,236,236,6,6,0,1,0
22,240,240,65,19,46,2,1
4,306,306,33,33,0,1,0
7,355,355,113,17,96,4,3
15,357,357,53,19,34,3,2
21,370,370,9,3,6,2,1
2,373,373,35,17,18,3,2
23,379,379,3,3,0,1,0
0,383,383,49,24,25,2,1
13,385,385,42,18,24,2,1
3,387,387,43,43,0,1,0
26,395,395,104,41,63,4,3
25,414,414,27,13,14,3,2
18,464,464,92,92,0,1,0
11,491,491,3,3,0,1,0
24,492,492,81,81,0,1,0
12,497,497,13,4,9,4,3

9,101,101,2,2,0,1,0
7,116,116,32,32,0,1,0
28,123,123,26,26,0,1,0
27,162,162,17,17,0,1,0
20,168,168,13,13,0,1,0
26,173,173,6,6,0,1,0
2,186,186,15,15,0,1,0
16,203,203,2,2,0,1,0
21,215,215,38,38,0,1,0
23,217,217,15,1,14,4,3
29,222,222,5,5,0,1,0
1,236,236,6,3,3,2,1
19,241,241,25,7,18,2,1
25,242,242,45,19,26,3,2
24,267,267,34,34,0,1,0
31,294,294,52,36,16,3,2
3,296,296,10,1,9,2,1
18,341,341,67,6,61,3,2
10,351,351,111,101,10,2,1
15,373,373,70,70,0,1,0
22,373,373,25,19,6,2,1
30,379,379,25,16,9,4,3
6,386,386,25,9,16,2,1
0,420,420,10,10,0,1,0
12,426,426,15,1,14,3,2
13,430,430,10,10,0,1,0
11,431,431,31,7,24,3,2
4,431,431,38,29,9,4,3
5,434,434,106,106,0,1,0
8,470,470,10,2,8,3,2
17,488,488,1,1,0,1,0
14,488,488,43,43,0,1,0

22,104,104,2,2,0,1,0
20,107,107,18,8,10,3,2
34,112,112,17,17,0,1,0
10,129,129,1,1,0,1,0
32,140,140,9,6,3,2,1
14,148,148,25,25,0,1,0
27,154,154,5,5,0,1,0
11,191,191,1,1,0,1,0
15,197,197,17,4,13,2,1
21,210,210,54,54,0,1,0
7,220,220,3,3,0,1,0
6,222,222,5,5,0,1,0
12,223,223,12,6,6,3,2
13,231,231,18,4,14,3,2
26,239,239,40,34,6,2,1
4,253,253,35,17,18,4,3
2,274,274,49,49,0,1,0
31,278,278,24,10,14,3,2
29,291,291,21,7,14,3,2
16,305,305,4,4,0,1,0
3,323,323,7,7,0,1,0
5,337,337,28,28,0,1,0
25,342,342,11,7,4,2,1
35,352,352,10,4,6,3,2
28,358,358,15,2,13,2,1
18,427,427,48,48,0,1,0
9,430,430,87,87,0,1,0
19,436,436,30,13,17,2,1
8,442,442,101,101,0,1,0
30,477,477,14,14,0,1,0
33,480,480,41,16,25,2,1
1,481,481,10,4,6,2,1
17,482,482,40,16,24,3,2
24,488,488,75,57,18,3,2
0,488,488,7,7,0,1,0
23,499,499,122,92,30,3,2

16,117,117,1,1,0,1,0
27,130,130,25,1,24,2,1
11,153,153,47,6,41,2,1
14,165,165,2,2,0,1,0
5,184,184,12,12,0,1,0
19,185,185,12,12,0,1,0
15,187,187,3,3,0,1,0
3,195,195,7,1,6,3,2
10,200,200,7,7,0,1,0
8,205,205,10,10,0,1,0
25,228,228,43,7,36,3,2
6,233,233,69,69,0,1,0
23,240,240,69,69,0,1,0
33,245,245,38,38,0,1,0
0,250,250,25,25,0,1,0
18,261,261,8,8,0,1,0
2,266,266,2,2,0,1,0
17,269,269,31,31,0,1,0
7,277,277,72,56,16,2,1
22,286,286,3,3,0,1,0
32,288,288,10,10,0,1,0
9,324,324,1,1,0,1,0
30,326,326,1,1,0,1,0
31,332,332,66,66,0,1,0
26,354,354,15,15,0,1,0
34,360,360,52,35,17,2,1
29,364,364,75,19,56,3,2
21,391,391,11,2,9,4,3
1,391,391,27,13,14,2,1
28,398,398,21,21,0,1,0
20,407,407,4,4,0,1,0
24,427,427,4,4,0,1,0
4,458,458,59,59,0,1,0
12,468,468,18,18,0,1,0
13,478,478,12,12,0,1,0

18,111,111,7,4,3,2,1
8,126,126,1,1,0,1,0
30,139,139,3,3,0,1,0
0,142,142,43,17,26,3,2
24,147,147,4,4,0,1,0
17,149,149,15,1,14,2,1
16,157,157,50,24,26,3,2
10,163,163,12,12,0,1,0
31,181,181,6,6,0,1,0
22,235,235,54,54,0,1,0
4,242,242,30,21,9,4,3
12,243,243,10,4,6,3,2
25,282,282,20,2,18,2,1
7,294,294,64,64,0,1,0
5,313,313,94,49,45,4,3
11,321,321,41,20,21,2,1
14,331,331,1,1,0,1,0
3,360,360,43,43,0,1,0
29,389,389,107,95,12,4,3
1,404,404,3,3,0,1,0
15,411,411,33,33,0,1,0
20,413,413,50,32,18,4,3
6,417,417,3,3,0,1,0
19,432,432,44,44,0,1,0
28,441,441,23,5,18,2,1
27,444,444,38,8,30,4,3
2,458,458,18,9,9,4,3
13,463,463,36,4,32,2,1
26,465,465,1,1,0,1,0
23,481,481,47,21,26,2,1
21,499,499,19,19,0,1,0
9,500,500,36,36,0,1,0

21,109,109,3,3,0,1,0
24,135,135,7,7,0,1,0
30,140,140,42,42,0,1,0
13,148,148,43,43,0,1,0
15,150,150,5,1,4,2,1
12,165,165,19,6,13,2,1
25,175,175,5,5,0,1,0
26,189,189,6,6,0,1,0
2,208,208,2,2,0,1,0
3,222,222,38,38,0,1,0
1,229,229,23,23,0,1,0
11,258,258,22,22,0,1,0
0,261,261,11,1,10,2,1
20,272,272,75,21,54,3,2
35,280,280,51,29,22,3,2
19,290,290,6,6,0,1,0
22,295,295,6,6,0,1,0
6,308,308,25,25,0,1,0
32,313,313,6,6,0,1,0
16,320,320,19,19,0,1,0
8,331,331,36,36,0,1,0
23,356,356,29,1,28,2,1
17,360,360,1,1,0,1,0
27,373,373,132,63,69,4,3
4,376,376,11,11,0,1,0
9,385,385,7,7,0,1,0
28,385,385,2,2,0,1,0
5,396,396,54,7,47,3,2
14,423,423,6,3,3,2,1
34,435,435,34,34,0,1,0
7,449,449,45,45,0,1,0
29,450,450,26,14,12,3,2
18,453,453,16,1,15,4,3
31,457,457,16,16,0,1,0
33,465,465,40,10,30,4,3
10,474,474,70,47,23,2,1

15,111,111,1,1,0,1,0
1,160,160,17,17,0,1,0
24,168,168,55,55,0,1,0
12,199,199,5,5,0,1,0
23,242,242,55,55,0,1,0
0,262,262,92,44,48,4,3
2,263,263,24,24,0,1,0
6,275,275,9,9,0,1,0
9,286,286,22,13,9,2,1
18,289,289,85,58,27,2,1
11,290,290,26,15,11,3,2
14,304,304,22,10,12,4,3
19,305,305,6,1,5,2,1
17,321,321,5,2,3,2,1
22,338,338,29,29,0,1,0
13,358,358,12,12,0,1,0
8,367,367,78,78,0,1,0
21,371,371,38,4,34,2,1
4,373,373,184,149,35,4,3
16,379,379,74,32,42,2,1
3,392,392,43,37,6,3,2
20,398,398,16,16,0,1,0
10,476,476,4,4,0,1,0
5,476,476,4,1,3,2,1
7,484,484,95,44,51,4,3

33,113,113,2,2,0,1,0
0,144,144,5,5,0,1,0
5,148,148,16,16,0,1,0
25,164,164,25,10,15,4,3
35,173,173,23,23,0,1,0
29,183,183,7,3,4,2,1
3,199,199,9,9,0,1,0
8,213,213,6,6,0,1,0
19,216,216,32,32,0,1,0
4,222,222,59,22,37,2,1
10,223,223,49,49,0,1,0
17,228,228,1,1,0,1,0
14,239,239,43,8,35,2,1
34,263,263,88,88,0,1,0
1,265,265,1,1,0,1,0
31,269,269,17,17,0,1,0
27,269,269,23,23,0,1,0
6,291,291,18,4,14,3,2
30,314,314,50,30,20,3,2
20,350,350,6,6,0,1,0
11,354,354,15,5,10,3,2
23,359,359,101,27,74,4,3
22,367,367,19,19,0,1,0
32,374,374,3,3,0,1,0
18,381,381,54,54,0,1,0
13,381,381,19,6,13,3,2
15,384,384,10,10,0,1,0
28,384,384,32,12,20,2,1
26,405,405,56,10,46,4,3
12,421,421,45,35,10,3,2
7,424,424,31,25,6,2,1
2,441,441,1,1,0,1,0
16,444,444,1,1,0,1,0
21,460,460,16,10,6,2,1
9,468,468,28,14,14,2,1
24,482,482,12,12,0,1,0

14,104,104,3,3,0,1,0
32,130,130,12,12,0,1,0
30,144,144,7,1,6,3,2
28,174,174,46,20,26,3,2
8,212,212,8,8,0,1,0
13,214,214,13,13,0,1,0
16,216,216,5,5,0,1,0
29,228,228,24,24,0,1,0
10,235,235,16,1,15,4,3
2,250,250,13,13,0,1,0
24,269,269,57,31,26,2,1
33,282,282,3,3,0,1,0
25,283,283,28,14,14,4,3
23,324,324,78,78,0,1,0
31,326,326,16,16,0,1,0
22,327,327,14,14,0,1,0
9,341,341,121,49,72,4,3
34,343,343,5,5,0,1,0
21,355,355,2,2,0,1,0
20,361,361,51,43,8,3,2
6,368,368,59,26,33,2,1
15,374,374,28,9,19,3,2
0,382,382,38,26,12,4,3
11,393,393,29,29,0,1,0
5,420,420,23,19,4,2,1
12,445,445,24,9,15,2,1
19,448,448,7,7,0,1,0
7,449,449,1,1,0,1,0
17,452,452,77,39,38,3,2
18,455,455,7,7,0,1,0
3,464,464,29,29,0,1,0
1,473,473,36,36,0,1,0
27,482,482,112,112,0,1,0
4,494,494,65,47,18,4,3
26,496,496,29,29,0,1,0

5,101,101,13,13,0,1,0
7,113,113,2,2,0,1,0
19,125,125,14,14,0,1,0
0,157,157,24,18,6,2,1
22,179,179,24,24,0,1,0
2,216,216,106,106,0,1,0
11,253,253,50,50,0,1,0
4,258,258,31,31,0,1,0
18,285,285,35,35,0,1,0
10,296,296,43,43,0,1,0
16,303,303,20,12,8,2,1
15,308,308,3,3,0,1,0
9,311,311,30,30,0,1,0
13,326,326,22,5,17,2,1
6,352,352,40,40,0,1,0
21,370,370,61,46,15,2,1
8,391,391,27,20,7,2,1
17,393,393,16,16,0,1,0
1,395,395,89,58,31,2,1
12,420,420,1,1,0,1,0
3,430,430,159,127,32,2,1
14,466,466,68,2,66,3,2
20,493,493,116,99,17,2,1

11,139,139,2,2,0,1,0
2,149,149,32,8,24,4,3
12,161,161,5,5,0,1,0
0,177,177,80,80,0,1,0
17,184,184,4,4,0,1,0
7,211,211,27,1,26,3,2
20,217,217,10,6,4,2,1
22,239,239,51,28,23,2,1
13,251,251,22,10,12,4,3
9,254,254,52,52,0,1,0
18,285,285,19,19,0,1,0
14,351,351,6,6,0,1,0
19,369,369,10,3,7,2,1
16,374,374,139,59,80,4,3
3,397,397,90,4,86,3,2
4,407,407,24,5,19,2,1
21,414,414,35,13,22,3,2
8,428,428,140,140,0,1,0
23,430,430,7,7,0,1,0
6,434,434,71,48,23,3,2
10,435,435,27,27,0,1,0
15,487,487,21,21,0,1,0
5,488,488,108,39,69,4,3
1,496,496,67,55,12,4,3

9,102,102,4,1,3,2,1
5,125,125,45,13,32,2,1
12,125,125,54,54,0,1,0
17,133,133,14,14,0,1,0
19,137,137,26,3,23,2,1
14,145,145,33,24,9,2,1
10,148,148,65,30,35,2,1
26,152,152,13,1,12,3,2
18,157,157,10,10,0,1,0
8,180,180,28,3,25,2,1
25,182,182,23,2,21,4,3
1,217,217,29,29,0,1,0
13,231,231,13,5,8,3,2
3,241,241,1,1,0,1,0
4,250,250,30,30,0,1,0
20,257,257,22,7,15,4,3
24,262,262,4,4,0,1,0
27,291,291,3,3,0,1,0
0,306,306,21,21,0,1,0
7,313,313,26,19,7,2,1
2,360,360,16,16,0,1,0
21,383,383,18,18,0,1,0
22,420,420,28,28,0,1,0
23,432,432,18,18,0,1,0
6,437,437,40,40,0,1,0
11,444,444,27,9,18,2,1
15,481,481,10,4,6,3,2
16,485,485,28,10,18,3,2

17,123,123,2,2,0,1,0
22,125,125,1,1,0,1,0
26,156,156,27,27,0,1,0
9,159,159,3,3,0,1,0
0,184,184,65,65,0,1,0
5,230,230,56,40,16,3,2
15,231,231,11,3,8,3,2
3,247,247,11,11,0,1,0
10,266,266,53,20,33,4,3
16,270,270,22,22,0,1,0
1,283,283,33,30,3,2,1
2,290,290,13,13,0,1,0
14,296,296,29,29,0,1,0
12,296,296,49,22,27,4,3
27,299,299,15,5,10,3,2
20,320,320,14,14,0,1,0
19,334,334,14,14,0,1,0
25,347,347,54,29,25,2,1
8,380,380,16,16,0,1,0
4,390,390,51,22,29,2,1
7,410,410,60,42,18,2,1
11,412,412,93,93,0,1,0
23,414,414,37,37,0,1,0
13,458,458,102,45,57,4,3
24,474,474,42,12,30,4,3
21,475,475,34,34,0,1,0
18,484,484,133,51,82,3,2
6,496,496,17,5,12,2,1

2,103,103,31,23,8,2,1
12,107,107,3,3,0,1,0
11,109,109,7,7,0,1,0
15,123,123,5,2,3,2,1
22,125,125,20,20,0,1,0
29,138,138,3,3,0,1,0
4,144,144,19,10,9,2,1
17,170,170,18,18,0,1,0
3,201,201,16,7,9,2,1
28,208,208,26,22,4,2,1
26,211,211,15,10,5,2,1
9,223,223,25,7,18,4,3
27,223,223,73,19,54,3,2
20,231,231,72,72,0,1,0
1,238,238,16,16,0,1,0
13,247,247,31,5,26,2,1
7,285,285,3,3,0,1,0
23,301,301,3,3,0,1,0
5,333,333,39,29,10,3,2
19,373,373,23,14,9,4,3
30,394,394,43,17,26,2,1
18,401,401,22,22,0,1,0
25,408,408,8,2,6,3,2
6,418,418,25,7,18,4,3
10,433,433,145,125,20,2,1
16,448,448,63,21,42,2,1
21,453,453,6,6,0,1,0
8,455,455,16,16,0,1,0
24,464,464,24,6,18,4,3
14,475,475,19,15,4,2,1
0,480,480,45,45,0,1,0

14,102,102,2,2,0,1,0
3,120,120,13,13,0,1,0
9,120,120,1,1,0,1,0
20,151,151,12,12,0,1,0
28,178,178,10,10,0,1,0
24,184,184,4,4,0,1,0
1,200,200,5,5,0,1,0
11,209,209,24,3,21,4,3
19,220,220,13,8,5,2,1
5,227,227,16,16,0,1,0
16,241,241,86,65,21,4,3
21,253,253,6,6,0,1,0
15,269,269,35,35,0,1,0
18,270,270,105,33,72,4,3
31,287,287,28,28,0,1,0
27,322,322,80,75,5,2,1
30,330,330,3,3,0,1,0
4,332,332,40,7,33,4,3
12,357,357,10,4,6,2,1
32,371,371,28,10,18,2,1
0,371,371,32,32,0,1,0
10,373,373,9,3,6,3,2
22,384,384,4,4,0,1,0
7,392,392,27,27,0,1,0
25,393,393,6,6,0,1,0
8,393,393,40,40,0,1,0
23,425,425,7,1,6,3,2
17,428,428,65,14,51,4,3
29,429,429,82,62,20,3,2
26,430,430,79,1,78,3,2
13,438,438,19,19,0,1,0
2,444,444,21,15,6,2,1
6,451,451,112,112,0,1,0

29,105,105,2,2,0,1,0
21,106,106,16,11,5,2,1
28,136,136,18,4,14,3,2
33,159,159,3,3,0,1,0
2,188,188,1,1,0,1,0
3,204,204,5,5,0,1,0
15,211,211,25,4,21,4,3
23,221,221,14,14,0,1,0
1,240,240,46,38,8,2,1
7,274,274,12,4,8,2,1
0,287,287,27,3,24,4,3
30,289,289,16,16,0,1,0
18,290,290,45,45,0,1,0
20,319,319,18,7,11,2,1
27,324,324,2,2,0,1,0
26,361,361,6,6,0,1,0
25,371,371,12,12,0,1,0
12,384,384,1,1,0,1,0
31,397,397,94,58,36,3,2
10,399,399,10,10,0,1,0
13,401,401,31,31,0,1,0
22,403,403,59,59,0,1,0
17,406,406,69,45,24,4,3
5,422,422,112,87,25,2,1
24,429,429,149,111,38,2,1
8,431,431,1,1,0,1,0
14,433,433,54,54,0,1,0
16,452,452,50,50,0,1,0
6,462,462,21,3,18,2,1
9,465,465,80,80,0,1,0
32,466,466,30,30,0,1,0
4,478,478,34,34,0,1,0
11,482,482,27,13,14,2,1
19,483,483,61,61,0,1,0

22,126,126,2,2,0,1,0
29,136,136,9,9,0,1,0
8,168,168,9,9,0,1,0
16,172,172,31,31,0,1,0
12,172,172,20,2,18,4,3
32,185,185,20,20,0,1,0
31,190,190,62,51,11,4,3
1,199,199,3,3,0,1,0
10,202,202,6,6,0,1,0
20,235,235,27,27,0,1,0
18,244,244,94,37,57,4,3
34,259,259,91,91,0,1,0
19,279,279,24,24,0,1,0
23,285,285,5,5,0,1,0
2,291,291,10,10,0,1,0
9,315,315,38,4,34,2,1
14,319,319,3,3,0,1,0
11,323,323,1,1,0,1,0
26,347,347,27,12,15,4,3
21,350,350,15,3,12,3,2
28,366,366,27,27,0,1,0
5,367,367,27,22,5,2,1
15,386,386,1,1,0,1,0
30,386,386,36,20,16,2,1
17,397,397,12,12,0,1,0
6,427,427,57,57,0,1,0
4,429,429,12,3,9,2,1
25,439,439,23,23,0,1,0
13,444,444,19,19,0,1,0
7,447,447,48,48,0,1,0
27,467,467,57,57,0,1,0
24,471,471,44,40,4,2,1
35,472,472,33,21,12,4,3
0,489,489,72,72,0,1,0
3,493,493,1,1,0,1,0
33,496,496,5,2,3,2,1

9,111,111,7,7,0,1,0
7,135,135,7,7,0,1,0
22,137,137,29,29,0,1,0
13,166,166,33,12,21,4,3
29,178,178,25,25,0,1,0
5,181,181,5,1,4,2,1
32,204,204,27,27,0,1,0
21,212,212,20,5,15,4,3
26,224,224,24,1,23,3,2
11,235,235,76,13,63,4,3
20,237,237,24,24,0,1,0
8,255,255,53,15,38,3,2
30,261,261,6,6,0,1,0
27,277,277,54,54,0,1,0
2,285,285,5,5,0,1,0
6,296,296,30,2,28,4,3
0,314,314,1,1,0,1,0
34,352,352,1,1,0,1,0
31,357,357,27,6,21,4,3
1,364,364,10,4,6,2,1
14,366,366,5,5,0,1,0
24,369,369,60,46,14,2,1
18,393,393,12,12,0,1,0
25,396,396,32,32,0,1,0
12,410,410,9,9,0,1,0
15,411,411,21,6,15,2,1
3,426,426,41,15,26,3,2
33,427,427,48,29,19,2,1
17,437,437,24,18,6,3,2
10,440,440,24,24,0,1,0
23,441,441,77,23,54,4,3
4,449,449,1,1,0,1,0
16,454,454,115,115,0,1,0
19,484,484,5,5,0,1,0
28,487,487,2,2,0,1,0

11,138,138,11,11,0,1,0
9,141,141,18,6,12,3,2
0,143,143,18,18,0,1,0
16,148,148,18,18,0,1,0
10,151,151,35,15,20,3,2
23,161,161,7,7,0,1,0
1,173,173,8,4,4,2,1
7,190,190,8,8,0,1,0
32,200,200,76,30,46,2,1
29,213,213,5,2,3,2,1
20,213,213,20,4,16,2,1
27,221,221,17,17,0,1,0
14,234,234,1,1,0,1,0
3,239,239,15,15,0,1,0
26,244,244,26,26,0,1,0
12,245,245,20,16,4,2,1
17,269,269,32,8,24,3,2
13,271,271,27,18,9,2,1
22,271,271,5,5,0,1,0
6,277,277,5,5,0,1,0
31,286,286,18,18,0,1,0
8,296,296,6,6,0,1,0
15,310,310,16,16,0,1,0
18,358,358,74,39,35,4,3
19,360,360,44,20,24,3,2
24,372,372,32,32,0,1,0
5,387,387,132,132,0,1,0
2,400,400,47,47,0,1,0
28,418,418,81,81,0,1,0
21,477,477,26,26,0,1,0
25,493,493,16,2,14,3,2
30,496,496,3,3,0,1,0
4,499,499,17,17,0,1,0

12,101,101,3,3,0,1,0
26,105,105,5,5,0,1,0
25,111,111,13,10,3,2,1
17,125,125,1,1,0,1,0
7,148,148,1,1,0,1,0
2,156,156,5,5,0,1,0
10,156,156,12,12,0,1,0
30,174,174,13,2,11,4,3
20,177,177,5,1,4,2,1
32,194,194,1,1,0,1,0
9,235,235,16,16,0,1,0
34,240,240,24,24,0,1,0
5,247,247,11,11,0,1,0
35,261,261,3,3,0,1,0
16,269,269,12,12,0,1,0
22,275,275,109,109,0,1,0
6,286,286,1,1,0,1,0
11,293,293,36,10,26,3,2
31,328,328,4,1,3,2,1
21,338,338,29,6,23,2,1
28,339,339,42,42,0,1,0
23,347,347,12,2,10,2,1
24,348,348,22,4,18,2,1
18,357,357,51,51,0,1,0
3,363,363,16,16,0,1,0
8,382,382,28,19,9,2,1
14,389,389,18,8,10,2,1
4,398,398,12,4,8,3,2
15,408,408,217,217,0,1,0
19,415,415,2,2,0,1,0
27,428,428,212,71,141,4,3
29,454,454,12,12,0,1,0
0,458,458,101,38,63,4,3
13,474,474,9,9,0,1,0
33,479,479,7,1,6,3,2
1,480,480,25,25,0,1,0

27,126,126,20,17,3,2,1
3,127,127,18,18,0,1,0
15,136,136,7,7,0,1,0
13,140,140,18,18,0,1,0
7,143,143,12,6,6,3,2
20,143,143,1,1,0,1,0
25,162,162,23,5,18,4,3
16,164,164,14,14,0,1,0
29,183,183,59,43,16,3,2
12,195,195,6,6,0,1,0
24,211,211,50,41,9,4,3
22,240,240,4,4,0,1,0
18,255,255,10,10,0,1,0
9,257,257,12,12,0,1,0
6,267,267,152,144,8,3,2
1,277,277,26,21,5,2,1
30,277,277,59,50,9,2,1
17,314,314,67,16,51,4,3
11,320,320,3,3,0,1,0
28,326,326,1,1,0,1,0
14,328,328,23,23,0,1,0
10,352,352,8,8,0,1,0
8,354,354,13,13,0,1,0
4,361,361,11,11,0,1,0
0,362,362,12,12,0,1,0
26,367,367,7,7,0,1,0
5,392,392,49,9,40,2,1
31,403,403,15,15,0,1,0
19,417,417,27,2,25,2,1
2,419,419,55,55,0,1,0
23,444,444,22,22,0,1,0
21,447,447,13,13,0,1,0

9,116,116,11,6,5,2,1
10,126,126,13,10,3,2,1
27,126,126,8,8,0,1,0
15,129,129,13,1,12,3,2
4,129,129,4,4,0,1,0
26,130,130,1,1,0,1,0
1,142,142,18,8,10,3,2
21,155,155,26,10,16,3,2
20,197,197,30,30,0,1,0
3,210,210,10,10,0,1,0
24,279,279,9,9,0,1,0
2,290,290,12,12,0,1,0
8,297,297,1,1,0,1,0
13,300,300,19,9,10,2,1
19,319,319,28,4,24,3,2
11,320,320,125,32,93,4,3
14,324,324,38,24,14,2,1
23,337,337,8,1,7,2,1
6,368,368,181,52,129,4,3
16,377,377,18,6,12,2,1
17,403,403,10,2,8,2,1
18,403,403,107,71,36,3,2
7,442,442,35,35,0,1,0
25,442,442,2,2,0,1,0
0,451,451,79,79,0,1,0
22,455,455,91,17,74,4,3
5,483,483,8,8,0,1,0
12,485,485,128,59,69,4,3

27,103,103,8,8,0,1,0
2,117,117,22,19,3,2,1
4,155,155,16,2,14,4,3
0,170,170,9,3,6,3,2
26,191,191,46,23,23,3,2
6,193,193,9,9,0,1,0
30,195,195,7,2,5,2,1
16,199,199,31,13,18,4,3
5,204,204,33,33,0,1,0
10,216,216,23,19,4,2,1
8,220,220,1,1,0,1,0
32,231,231,41,41,0,1,0
28,236,236,12,12,0,1,0
31,240,240,7,4,3,2,1
14,243,243,29,15,14,3,2
24,257,257,8,3,5,2,1
11,263,263,2,2,0,1,0
9,272,272,35,35,0,1,0
7,287,287,33,33,0,1,0
20,291,291,32,10,22,3,2
22,293,293,72,55,17,2,1
3,322,322,35,10,25,2,1
12,326,326,54,10,44,3,2
25,341,341,2,2,0,1,0
23,345,345,17,17,0,1,0
13,366,366,3,3,0,1,0
18,381,381,116,69,47,2,1
17,382,382,34,34,0,1,0
33,412,412,3,3,0,1,0
19,422,422,54,54,0,1,0
1,427,427,5,5,0,1,0
21,434,434,45,45,0,1,0
29,448,448,20,1,19,4,3
15,450,450,13,1,12,4,3

14,113,113,10,10,0,1,0
17,179,179,31,15,16,2,1
19,199,199,3,3,0,1,0
24,214,214,21,3,18,4,3
16,246,246,2,2,0,1,0
13,258,258,32,15,17,2,1
22,264,264,7,7,0,1,0
6,269,269,37,16,21,4,3
0,324,324,17,2,15,4,3
20,338,338,43,43,0,1,0
7,340,340,65,65,0,1,0
8,375,375,72,18,54,3,2
15,379,379,6,6,0,1,0
11,382,382,25,2,23,2,1
3,385,385,177,157,20,3,2
10,385,385,6,6,0,1,0
1,419,419,50,4,46,2,1
25,436,436,150,150,0,1,0
2,437,437,66,2,64,3,2
21,439,439,69,69,0,1,0
5,454,454,33,11,22,3,2
12,463,463,76,76,0,1,0
4,481,481,18,13,5,2,1
26,488,488,96,96,0,1,0
23,488,488,13,13,0,1,0
9,490,490,85,31,54,3,2
18,498,498,2,2,0,1,0

8,131,131,1,1,0,1,0
29,135,135,10,10,0,1,0
5,140,140,19,8,11,2,1
27,141,141,19,19,0,1,0
28,157,157,3,3,0,1,0
9,163,163,14,14,0,1,0
18,173,173,4,4,0,1,0
21,179,179,19,19,0,1,0
12,199,199,1,1,0,1,0
16,202,202,47,19,28,3,2
13,210,210,35,35,0,1,0
30,219,219,29,12,17,4,3
14,235,235,19,5,14,2,1
22,260,260,5,5,0,1,0
20,281,281,71,21,50,3,2
26,281,281,10,7,3,2,1
11,295,295,26,26,0,1,0
19,308,308,54,21,33,2,1
24,333,333,44,44,0,1,0
3,338,338,53,14,39,4,3
17,343,343,25,25,0,1,0
2,355,355,58,58,0,1,0
15,362,362,64,61,3,2,1
1,380,380,5,1,4,2,1
0,387,387,1,1,0,1,0
10,393,393,24,9,15,4,3
25,417,417,53,53,0,1,0
23,423,423,24,24,0,1,0
4,426,426,47,39,8,3,2
7,434,434,53,53,0,1,0
6,482,482,108,108,0,1,0
31,486,486,22,7,15,2,1

13,101,101,28,28,0,1,0
3,109,109,5,5,0,1,0
5,123,123,8,8,0,1,0
8,130,130,2,2,0,1,0
21,154,154,45,38,7,2,1
11,167,167,8,8,0,1,0
23,169,169,35,11,24,3,2
4,177,177,12,5,7,2,1
22,200,200,16,16,0,1,0
1,223,223,6,1,5,2,1
16,243,243,32,16,16,2,1
20,246,246,10,10,0,1,0
12,249,249,6,6,0,1,0
19,250,250,2,2,0,1,0
0,256,256,38,38,0,1,0
28,261,261,16,16,0,1,0
27,279,279,15,1,14,2,1
24,284,284,57,57,0,1,0
18,288,288,28,28,0,1,0
14,350,350,30,30,0,1,0
9,360,360,130,73,57,4,3
7,374,374,49,12,37,2,1
17,387,387,18,18,0,1,0
25,391,391,17,9,8,2,1
15,409,409,31,4,27,4,3
6,465,465,23,23,0,1,0
30,470,470,3,3,0,1,0
29,471,471,73,22,51,4,3
2,479,479,1,1,0,1,0
10,481,481,122,122,0,1,0
26,496,496,65,18,47,4,3

24,101,101,7,7,0,1,0
25,103,103,11,11,0,1,0
23,137,137,1,1,0,1,0
34,144,144,51,19,32,2,1
31,158,158,11,11,0,1,0
9,175,175,3,3,0,1,0
19,175,175,4,4,0,1,0
15,191,191,16,10,6,2,1
38,200,200,20,11,9,2,1
0,211,211,2,2,0,1,0
3,214,214,6,2,4,2,1
21,222,222,12,12,0,1,0
7,222,222,12,6,6,3,2
32,226,226,36,20,16,3,2
18,229,229,10,10,0,1,0
26,232,232,6,6,0,1,0
22,237,237,54,3,51,4,3
28,243,243,23,23,0,1,0
16,249,249,4,4,0,1,0
27,257,257,31,7,24,4,3
1,263,263,12,12,0,1,0
12,272,272,27,27,0,1,0
8,302,302,10,10,0,1,0
10,306,306,3,3,0,1,0
37,323,323,16,16,0,1,0
5,330,330,61,61,0,1,0
4,342,342,14,4,10,3,2
30,344,344,17,17,0,1,0
6,345,345,32,32,0,1,0
20,375,375,53,45,8,3,2
36,389,389,49,4,45,4,3
2,397,397,2,2,0,1,0
35,448,448,14,9,5,2,1
33,456,456,6,1,5,2,1
11,459,459,13,13,0,1,0
29,466,466,118,118,0,1,0
17,484,484,119,92,27,3,2
13,485,485,40,40,0,1,0
14,492,492,17,3,14,3,2

28,121,121,14,6,8,3,2
32,131,131,16,2,14,3,2
30,140,140,2,2,0,1,0
18,145,145,40,40,0,1,0
13,157,157,3,3,0,1,0
9,184,184,53,5,48,4,3
7,188,188,19,19,0,1,0
22,199,199,12,12,0,1,0
23,202,202,26,21,5,2,1
16,210,210,38,38,0,1,0
1,226,226,43,22,21,4,3
3,247,247,58,58,0,1,0
11,257,257,31,3,28,2,1
29,268,268,54,50,4,2,1
27,282,282,12,6,6,3,2
0,293,293,61,31,30,4,3
12,308,308,5,5,0,1,0
15,322,322,4,4,0,1,0
19,337,337,18,18,0,1,0
24,347,347,19,19,0,1,0
17,347,347,41,34,7,2,1
20,348,348,20,20,0,1,0
31,353,353,3,3,0,1,0
26,360,360,2,2,0,1,0
5,362,362,13,7,6,2,1
4,401,401,27,27,0,1,0
25,420,420,4,4,0,1,0
6,434,434,15,4,11,2,1
10,449,449,4,4,0,1,0
2,472,472,10,2,8,3,2
21,481,481,170,149,21,4,3
14,481,481,30,7,23,4,3
8,484,484,1,1,0,1,0

34,119,119,21,1,20,2,1
16,142,142,1,1,0,1,0
10,151,151,5,5,0,1,0
29,152,152,1,1,0,1,0
7,158,158,10,10,0,1,0
0,187,187,7,7,0,1,0
21,193,193,21,7,14,2,1
12,207,207,42,36,6,2,1
22,233,233,41,27,14,2,1
9,234,234,2,2,0,1,0
14,244,244,4,4,0,1,0
20,261,261,98,98,0,1,0
1,262,262,33,16,17,2,1
27,284,284,6,2,4,2,1
28,290,290,9,6,3,2,1
24,297,297,9,3,6,2,1
6,307,307,8,8,0,1,0
17,350,350,10,2,8,2,1
26,372,372,21,9,12,2,1
4,381,381,30,30,0,1,0
3,396,396,14,14,0,1,0
30,407,407,36,8,28,3,2
15,410,410,34,34,0,1,0
8,420,420,211,166,45,2,1
5,427,427,31,22,9,2,1
25,433,433,43,43,0,1,0
33,438,438,3,3,0,1,0
11,442,442,15,15,0,1,0
18,444,444,18,18,0,1,0
19,462,462,83,15,68,4,3
31,470,470,26,8,18,3,2
32,470,470,12,12,0,1,0
13,476,476,24,24,0,1,0
2,492,492,76,9,67,4,3
23,500,500,94,14,80,4,3

0,105,105,7,4,3,2,1
4,109,109,6,2,4,2,1
20,165,165,22,4,18,3,2
9,176,176,3,3,0,1,0
24,192,192,22,22,0,1,0
28,199,199,12,8,4,2,1
25,205,205,38,38,0,1,0
3,231,231,63,39,24,4,3
27,234,234,8,8,0,1,0
10,240,240,20,20,0,1,0
7,244,244,25,1,24,2,1
5,263,263,40,40,0,1,0
23,284,284,46,46,0,1,0
2,289,289,11,11,0,1,0
8,297,297,19,19,0,1,0
12,310,310,35,35,0,1,0
26,326,326,8,8,0,1,0
14,341,341,1,1,0,1,0
6,366,366,57,57,0,1,0
16,369,369,28,28,0,1,0
21,402,402,15,3,12,4,3
15,413,413,119,114,5,2,1
19,423,423,14,7,7,2,1
13,434,434,62,5,57,4,3
22,439,439,120,48,72,4,3
17,441,441,17,9,8,2,1
18,468,468,9,9,0,1,0
1,477,477,45,45,0,1,0
11,484,484,187,82,105,4,3

27,101,101,24,24,0,1,0
0,104,104,7,7,0,1,0
21,126,126,7,1,6,3,2
5,127,127,8,2,6,3,2
16,131,131,5,1,4,2,1
7,135,135,2,2,0,1,0
31,135,135,10,4,6,2,1
25,158,158,14,14,0,1,0
8,160,160,19,1,18,3,2
14,160,160,46,14,32,2,1
30,165,165,5,5,0,1,0
9,170,170,82,32,50,2,1
18,205,205,4,4,0,1,0
13,230,230,29,17,12,4,3
2,234,234,3,3,0,1,0
22,235,235,5,2,3,2,1
15,269,269,2,2,0,1,0
6,279,279,9,4,5,2,1
32,292,292,1,1,0,1,0
12,336,336,3,3,0,1,0
28,347,347,86,53,33,2,1
3,357,357,30,1,29,2,1
33,371,371,38,13,25,2,1
23,382,382,27,19,8,3,2
20,410,410,219,219,0,1,0
4,423,423,6,6,0,1,0
29,445,445,45,33,12,3,2
11,445,445,12,3,9,4,3
1,445,445,61,33,28,2,1
24,458,458,5,2,3,2,1
19,462,462,16,8,8,2,1
26,473,473,3,3,0,1,0
17,484,484,5,5,0,1,0
10,495,495,34,34,0,1,0

9,105,105,21,8,13,2,1
6,116,116,5,1,4,2,1
22,120,120,18,18,0,1,0
18,132,132,1,1,0,1,0
21,181,181,28,28,0,1,0
13,186,186,14,2,12,3,2
31,187,187,8,1,7,2,1
4,192,192,20,14,6,2,1
30,200,200,21,1,20,4,3
11,212,212,18,18,0,1,0
33,226,226,14,1,13,2,1
27,249,249,12,2,10,3,2
26,260,260,26,18,8,3,2
5,266,266,12,2,10,3,2
23,272,272,14,14,0,1,0
28,275,275,71,71,0,1,0
17,285,285,7,7,0,1,0
15,288,288,2,2,0,1,0
19,303,303,5,5,0,1,0
35,316,316,6,6,0,1,0
25,318,318,32,14,18,4,3
1,322,322,71,71,0,1,0
20,327,327,30,30,0,1,0
0,329,329,13,10,3,2,1
10,351,351,96,66,30,4,3
34,359,359,10,10,0,1,0
29,359,359,42,36,6,2,1
2,376,376,72,15,57,4,3
36,380,380,15,3,12,3,2
7,382,382,3,3,0,1,0
12,385,385,10,6,4,2,1
16,389,389,23,23,0,1,0
24,397,397,119,119,0,1,0
32,422,422,26,26,0,1,0
3,474,474,14,14,0,1,0
8,493,493,7,7,0,1,0
14,495,495,20,12,8,3,2

2,105,105,8,8,0,1,0
9,147,147,15,8,7,2,1
12,158,158,2,2,0,1,0
30,160,160,38,22,16,3,2
28,160,160,8,8,0,1,0
20,203,203,14,14,0,1,0
34,211,211,11,7,4,2,1
17,230,230,20,2,18,4,3
19,233,233,1,1,0,1,0
8,236,236,13,6,7,2,1
18,256,256,1,1,0,1,0
33,263,263,29,29,0,1,0
27,270,270,52,52,0,1,0
1,281,281,1,1,0,1,0
31,308,308,7,7,0,1,0
24,313,313,12,12,0,1,0
15,314,314,1,1,0,1,0
13,328,328,5,5,0,1,0
32,340,340,10,7,3,2,1
3,349,349,101,59,42,4,3
11,354,354,32,2,30,3,2
26,354,354,53,38,15,4,3
29,356,356,29,9,20,2,1
7,358,358,48,1,47,4,3
5,361,361,46,14,32,2,1
16,390,390,69,12,57,4,3
21,400,400,16,16,0,1,0
23,402,402,5,5,0,1,0
25,405,405,5,5,0,1,0
0,414,414,2,2,0,1,0
35,418,418,205,85,120,4,3
22,428,428,15,15,0,1,0
10,438,438,55,55,0,1,0
6,482,482,3,3,0,1,0
14,486,486,93,93,0,1,0
4,495,495,45,45,0,1,0

25,116,116,4,4,0,1,0
42,118,118,10,10,0,1,0
40,119,119,4,4,0,1,0
30,128,128,2,2,0,1,0
38,131,131,9,9,0,1,0
37,138,138,15,15,0,1,0
21,151,151,3,3,0,1,0
44,166,166,13,5,8,2,1
14,166,166,6,6,0,1,0
8,171,171,1,1,0,1,0
16,180,180,30,30,0,1,0
12,191,191,1,1,0,1,0
23,205,205,4,4,0,1,0
24,206,206,17,8,9,4,3
26,207,207,1,1,0,1,0
13,225,225,23,5,18,2,1
9,228,228,4,4,0,1,0
17,237,237,12,1,11,2,1
32,238,238,32,32,0,1,0
4,248,248,3,3,0,1,0
3,252,252,7,7,0,1,0
39,280,280,20,20,0,1,0
28,287,287,21,3,18,2,1
34,293,293,1,1,0,1,0
10,298,298,7,7,0,1,0
7,311,311,5,5,0,1,0
5,312,312,8,2,6,2,1
2,316,316,23,11,12,3,2
20,320,320,16,7,9,4,3
35,327,327,13,13,0,1,0
43,346,346,23,23,0,1,0
29,369,369,73,73,0,1,0
22,377,377,8,8,0,1,0
1,382,382,45,45,0,1,0
15,383,383,23,23,0,1,0
11,418,418,20,20,0,1,0
18,425,425,135,15,120,4,3
27,426,426,2,2,0,1,0
19,438,438,8,3,5,2,1
33,458,458,197,164,33,2,1
36,462,462,13,13,0,1,0
41,465,465,123,87,36,4,3
0,465,465,67,61,6,3,2
6,476,476,12,7,5,2,1
31,494,494,6,6,0,1,0

6,120,120,25,25,0,1,0
0,183,183,1,1,0,1,0
15,200,200,38,38,0,1,0
5,202,202,5,5,0,1,0
11,223,223,6,6,0,1,0
21,232,232,29,29,0,1,0
23,246,246,6,6,0,1,0
20,258,258,10,10,0,1,0
22,283,283,28,7,21,4,3
16,294,294,87,87,0,1,0
9,301,301,31,31,0,1,0
28,314,314,9,3,6,2,1
10,325,325,12,7,5,2,1
4,335,335,218,218,0,1,0
3,350,350,30,17,13,3,2
2,383,383,22,16,6,2,1
19,387,387,26,26,0,1,0
27,393,393,1,1,0,1,0
8,414,414,8,8,0,1,0
25,424,424,25,25,0,1,0
12,427,427,83,57,26,2,1
14,429,429,35,13,22,3,2
24,436,436,27,18,9,2,1
17,456,456,182,153,29,2,1
1,459,459,3,3,0,1,0
18,473,473,17,5,12,2,1
7,488,488,89,41,48,4,3
13,490,490,31,14,17,2,1
26,496,496,27,10,17,4,3

1,106,106,20,20,0,1,0
27,184,184,31,31,0,1,0
26,186,186,8,4,4,2,1
5,217,217,10,10,0,1,0
15,221,221,58,49,9,2,1
18,224,224,3,3,0,1,0
20,235,235,24,24,0,1,0
25,241,241,10,10,0,1,0
22,244,244,5,5,0,1,0
13,257,257,78,78,0,1,0
21,287,287,18,18,0,1,0
7,288,288,33,33,0,1,0
3,321,321,13,7,6,2,1
4,332,332,2,2,0,1,0
8,337,337,16,6,10,3,2
16,352,352,91,65,26,3,2
6,355,355,49,17,32,3,2
28,364,364,9,5,4,2,1
12,374,374,15,15,0,1,0
23,413,413,4,4,0,1,0
17,422,422,17,1,16,4,3
2,434,434,17,17,0,1,0
9,438,438,46,46,0,1,0
0,443,443,93,55,38,3,2
10,472,472,178,118,60,4,3
19,480,480,3,3,0,1,0
24,491,491,101,101,0,1,0
14,497,497,33,33,0,1,0
11,497,497,124,31,93,4,3

22,103,103,33,33,0,1,0
33,114,114,4,4,0,1,0
14,114,114,3,3,0,1,0
12,120,120,5,5,0,1,0
3,134,134,5,5,0,1,0
8,142,142,31,31,0,1,0
4,164,164,35,22,13,2,1
25,173,173,29,17,12,4,3
30,217,217,18,18,0,1,0
21,231,231,48,48,0,1,0
13,233,233,48,3,45,4,3
9,233,233,1,1,0,1,0
20,235,235,15,1,14,2,1
19,254,254,13,13,0,1,0
15,261,261,5,5,0,1,0
31,272,272,3,3,0,1,0
2,274,274,38,38,0,1,0
10,275,275,2,2,0,1,0
26,284,284,18,15,3,2,1
29,303,303,22,22,0,1,0
23,308,308,13,10,3,2,1
7,310,310,5,1,4,2,1
34,311,311,33,17,16,2,1
35,313,313,95,95,0,1,0
28,318,318,8,3,5,2,1
32,319,319,14,14,0,1,0
18,340,340,4,4,0,1,0
16,356,356,80,80,0,1,0
6,359,359,27,21,6,2,1
17,405,405,30,30,0,1,0
27,410,410,9,3,6,2,1
5,416,416,18,9,9,4,3
11,425,425,11,11,0,1,0
0,431,431,44,44,0,1,0
24,440,440,27,27,0,1,0
1,496,496,33,33,0,1,0

16,108,108,4,1,3,2,1
18,118,118,1,1,0,1,0
13,120,120,43,43,0,1,0
9,120,120,4,4,0,1,0
29,137,137,15,6,9,4,3
11,143,143,7,7,0,1,0
7,160,160,2,2,0,1,0
24,192,192,13,1,12,3,2
4,204,204,2,2,0,1,0
10,205,205,18,18,0,1,0
19,207,207,6,1,5,2,1
2,215,215,1,1,0,1,0
17,241,241,10,10,0,1,0
8,262,262,75,55,20,3,2
12,279,279,5,5,0,1,0
22,279,279,12,2,10,2,1
3,293,293,18,6,12,3,2
14,300,300,20,20,0,1,0
1,334,334,101,85,16,3,2
32,381,381,38,17,21,4,3
5,381,381,8,8,0,1,0
25,389,389,62,53,9,4,3
27,407,407,18,18,0,1,0
31,417,417,42,42,0,1,0
6,420,420,30,30,0,1,0
28,438,438,41,33,8,3,2
26,449,449,78,18,60,4,3
0,457,457,37,12,25,2,1
21,461,461,84,69,15,4,3
15,463,463,47,13,34,3,2
30,467,467,64,46,18,4,3
23,488,488,74,56,18,4,3
20,495,495,89,62,27,4,3

8,118,118,6,6,0,1,0
31,127,127,1,1,0,1,0
35,142,142,8,8,0,1,0
29,152,152,10,10,0,1,0
3,163,163,20,12,8,2,1
4,200,200,9,3,6,3,2
11,200,200,62,62,0,1,0
13,207,207,23,17,6,3,2
27,212,212,16,2,14,3,2
24,231,231,151,151,0,1,0
9,236,236,16,16,0,1,0
18,237,237,1,1,0,1,0
23,272,272,19,19,0,1,0
1,274,274,6,6,0,1,0
17,306,306,12,3,9,2,1
26,321,321,49,34,15,4,3
16,324,324,5,5,0,1,0
22,325,325,3,3,0,1,0
20,337,337,12,12,0,1,0
14,349,349,95,1,94,3,2
15,361,361,12,1,11,4,3
2,374,374,35,8,27,4,3
21,375,375,48,48,0,1,0
34,381,381,28,28,0,1,0
7,387,387,63,36,27,4,3
10,398,398,21,5,16,3,2
32,422,422,33,2,31,4,3
6,440,440,4,4,0,1,0
19,447,447,42,6,36,4,3
12,453,453,9,2,7,2,1
25,456,456,21,21,0,1,0
30,458,458,18,6,12,2,1
5,476,476,29,20,9,2,1
33,476,476,45,36,9,2,1
28,482,482,25,25,0,1,0
0,497,497,7,7,0,1,0

7,131,131,22,22,0,1,0
32,138,138,4,4,0,1,0
6,146,146,2,2,0,1,0
14,167,167,5,2,3,2,1
26,176,176,78,78,0,1,0
11,178,178,1,1,0,1,0
28,192,192,4,4,0,1,0
21,200,200,6,1,5,2,1
0,213,213,3,3,0,1,0
1,215,215,3,3,0,1,0
8,215,215,10,10,0,1,0
2,229,229,32,25,7,2,1
17,240,240,5,5,0,1,0
27,244,244,129,33,96,3,2
4,270,270,24,24,0,1,0
19,275,275,26,26,0,1,0
24,279,279,78,78,0,1,0
13,286,286,10,1,9,4,3
5,324,324,53,6,47,2,1
30,330,330,12,5,7,2,1
18,335,335,4,4,0,1,0
16,335,335,14,5,9,2,1
3,360,360,107,62,45,4,3
20,361,361,2,2,0,1,0
23,365,365,3,3,0,1,0
10,377,377,47,9,38,3,2
31,379,379,10,4,6,3,2
22,398,398,25,25,0,1,0
12,430,430,22,22,0,1,0
29,456,456,6,1,5,2,1
25,460,460,10,1,9,2,1
15,470,470,54,26,28,4,3
9,493,493,125,75,50,2,1

26,112,112,3,3,0,1,0
29,118,118,27,27,0,1,0
27,125,125,10,10,0,1,0
30,128,128,40,9,31,2,1
19,135,135,3,3,0,1,0
13,135,135,25,25,0,1,0
4,161,161,14,2,12,3,2
6,187,187,15,15,0,1,0
22,192,192,15,15,0,1,0
25,198,198,11,11,0,1,0
23,208,208,36,26,10,2,1
21,221,221,8,8,0,1,0
10,224,224,3,3,0,1,0
1,232,232,10,10,0,1,0
16,264,264,9,9,0,1,0
0,268,268,24,24,0,1,0
20,321,321,86,2,84,4,3
7,325,325,39,27,12,3,2
5,326,326,11,11,0,1,0
15,328,328,25,15,10,3,2
14,359,359,7,1,6,2,1
3,361,361,15,3,12,3,2
12,369,369,34,34,0,1,0
8,371,371,61,61,0,1,0
11,384,384,21,21,0,1,0
9,389,389,173,81,92,3,2
28,409,409,55,13,42,3,2
18,410,410,21,21,0,1,0
2,415,415,23,16,7,2,1
24,435,435,15,3,12,4,3
17,451,451,16,4,12,4,3
31,471,471,35,35,0,1,0

27,111,111,12,12,0,1,0
5,111,111,23,9,14,3,2
17,111,111,14,10,4,2,1
30,117,117,3,3,0,1,0
1,133,133,20,20,0,1,0
15,158,158,18,6,12,4,3
25,166,166,7,7,0,1,0
3,174,174,10,10,0,1,0
18,193,193,49,6,43,2,1
4,203,203,29,24,5,2,1
23,218,218,21,21,0,1,0
0,219,219,9,9,0,1,0
28,240,240,17,17,0,1,0
32,263,263,42,4,38,2,1
10,292,292,8,5,3,2,1
19,340,340,67,26,41,2,1
24,342,342,47,6,41,4,3
21,348,348,2,2,0,1,0
6,349,349,20,4,16,2,1
12,357,357,15,11,4,2,1
11,358,358,17,7,10,3,2
29,370,370,54,44,10,2,1
7,378,378,21,21,0,1,0
8,394,394,76,54,22,3,2
20,409,409,86,38,48,4,3
31,428,428,3,3,0,1,0
22,432,432,21,21,0,1,0
16,438,438,69,69,0,1,0
9,444,444,63,63,0,1,0
13,454,454,9,9,0,1,0
26,480,480,1,1,0,1,0
14,491,491,35,35,0,1,0
2,496,496,37,37,0,1,0

26,104,104,12,7,5,2,1
21,111,111,5,5,0,1,0
10,115,115,1,1,0,1,0
0,126,126,8,8,0,1,0
11,138,138,7,7,0,1,0
12,150,150,17,17,0,1,0
32,157,157,2,2,0,1,0
23,161,161,22,22,0,1,0
19,201,201,1,1,0,1,0
25,256,256,27,27,0,1,0
30,259,259,7,3,4,2,1
6,287,287,16,4,12,4,3
3,305,305,23,9,14,2,1
9,311,311,9,9,0,1,0
22,324,324,62,32,30,4,3
34,326,326,56,56,0,1,0
14,328,328,32,2,30,2,1
16,330,330,14,14,0,1,0
20,331,331,31,31,0,1,0
27,358,358,72,72,0,1,0
31,374,374,57,33,24,4,3
4,376,376,40,40,0,1,0
33,386,386,62,62,0,1,0
13,388,388,22,22,0,1,0
15,392,392,17,1,16,2,1
1,398,398,43,43,0,1,0
2,402,402,104,89,15,4,3
18,403,403,36,36,0,1,0
5,412,412,13,13,0,1,0
29,414,414,5,5,0,1,0
24,432,432,9,9,0,1,0
8,439,439,21,13,8,2,1
17,449,449,127,94,33,4,3
7,452,452,17,17,0,1,0
35,459,459,2,2,0,1,0
28,475,475,88,50,38,4,3

18,111,111,3,3,0,1,0
12,115,115,10,10,0,1,0
8,121,121,1,1,0,1,0
32,132,132,18,8,10,3,2
15,136,136,28,8,20,2,1
6,139,139,5,1,4,2,1
5,140,140,7,2,5,2,1
13,164,164,11,3,8,2,1
4,186,186,12,12,0,1,0
25,217,217,31,31,0,1,0
14,221,221,29,24,5,2,1
17,228,228,22,22,0,1,0
34,243,243,6,6,0,1,0
26,249,249,29,29,0,1,0
11,290,290,2,2,0,1,0
28,292,292,23,1,22,3,2
7,303,303,38,38,0,1,0
9,312,312,13,7,6,3,2
2,317,317,70,2,68,4,3
33,317,317,3,3,0,1,0
21,319,319,41,30,11,2,1
30,331,331,4,4,0,1,0
35,334,334,2,2,0,1,0
36,344,344,63,37,26,3,2
23,365,365,8,8,0,1,0
16,371,371,9,9,0,1,0
3,378,378,12,2,10,3,2
10,380,380,40,30,10,3,2
27,384,384,51,9,42,3,2
19,385,385,42,42,0,1,0
1,403,403,5,5,0,1,0
31,412,412,65,65,0,1,0
24,431,431,158,158,0,1,0
20,451,451,26,6,20,3,2
29,456,456,34,34,0,1,0
22,467,467,15,3,12,4,3
0,488,488,45,45,0,1,0

19,100,100,1,1,0,1,0
20,105,105,23,23,0,1,0
24,115,115,2,2,0,1,0
8,129,129,3,3,0,1,0
5,137,137,30,15,15,2,1
17,139,139,10,10,0,1,0
11,167,167,1,1,0,1,0
21,186,186,15,9,6,3,2
30,187,187,31,12,19,3,2
14,188,188,21,2,19,3,2
12,192,192,86,86,0,1,0
4,216,216,33,15,18,2,1
29,237,237,76,76,0,1,0
15,280,280,43,40,3,2,1
9,283,283,45,39,6,3,2
7,285,285,6,6,0,1,0
6,288,288,57,12,45,2,1
0,312,312,5,5,0,1,0
1,313,313,19,13,6,2,1
27,319,319,19,19,0,1,0
18,325,325,60,60,0,1,0
13,328,328,1,1,0,1,0
22,330,330,17,8,9,2,1
2,349,349,54,24,30,2,1
26,367,367,11,11,0,1,0
25,375,375,1,1,0,1,0
23,383,383,43,2,41,4,3
16,390,390,18,18,0,1,0
10,443,443,4,4,0,1,0
28,473,473,57,57,0,1,0
3,499,499,10,7,3,2,1

9,100,100,29,1,28,2,1
6,117,117,51,51,0,1,0
5,137,137,17,17,0,1,0
17,180,180,2,2,0,1,0
27,186,186,2,2,0,1,0
0,190,190,1,1,0,1,0
3,190,190,32,16,16,2,1
13,208,208,7,7,0,1,0
24,212,212,7,3,4,2,1
22,215,215,5,5,0,1,0
11,216,216,3,3,0,1,0
8,263,263,16,10,6,3,2
29,285,285,77,35,42,4,3
4,288,288,39,39,0,1,0
25,290,290,59,59,0,1,0
26,309,309,21,21,0,1,0
19,317,317,36,12,24,4,3
7,325,325,49,7,42,3,2
14,334,334,6,6,0,1,0
28,357,357,27,27,0,1,0
21,359,359,57,23,34,2,1
12,360,360,4,4,0,1,0
20,367,367,51,33,18,2,1
10,401,401,59,47,12,4,3
18,407,407,2,2,0,1,0
1,410,410,5,5,0,1,0
2,420,420,5,5,0,1,0
16,457,457,60,40,20,3,2
15,489,489,58,58,0,1,0
23,491,491,124,124,0,1,0

6,138,138,8,2,6,2,1
16,140,140,10,1,9,4,3
31,169,169,14,14,0,1,0
11,187,187,12,9,3,2,1
7,190,190,26,1,25,2,1
15,209,209,6,6,0,1,0
17,213,213,5,5,0,1,0
5,238,238,29,29,0,1,0
4,239,239,4,4,0,1,0
1,245,245,4,4,0,1,0
14,248,248,57,57,0,1,0
27,249,249,8,8,0,1,0
21,255,255,7,7,0,1,0
3,270,270,73,73,0,1,0
23,306,306,11,3,8,3,2
30,309,309,86,86,0,1,0
0,315,315,73,10,63,3,2
10,318,318,2,2,0,1,0
24,322,322,12,12,0,1,0
28,330,330,25,25,0,1,0
9,349,349,4,4,0,1,0
8,362,362,71,41,30,4,3
29,399,399,35,35,0,1,0
18,403,403,28,16,12,2,1
25,403,403,48,40,8,2,1
2,427,427,61,15,46,4,3
20,438,438,62,62,0,1,0
12,452,452,32,2,30,4,3
19,457,457,187,49,138,4,3
26,490,490,27,27,0,1,0
13,494,494,1,1,0,1,0
22,500,500,43,43,0,1,0

2,101,101,1,1,0,1,0
8,110,110,29,29,0,1,0
22,124,124,17,4,13,2,1
16,133,133,11,2,9,4,3
15,137,137,1,1,0,1,0
20,145,145,29,29,0,1,0
5,153,153,17,17,0,1,0
24,160,160,17,17,0,1,0
23,164,164,23,23,0,1,0
34,165,165,9,5,4,2,1
11,180,180,9,9,0,1,0
28,198,198,9,9,0,1,0
7,205,205,8,8,0,1,0
6,240,240,3,3,0,1,0
25,242,242,28,4,24,2,1
0,252,252,25,25,0,1,0
13,253,253,43,12,31,4,3
32,291,291,50,50,0,1,0
26,315,315,16,16,0,1,0
14,323,323,76,31,45,4,3
30,339,339,26,26,0,1,0
3,369,369,34,16,18,3,2
21,372,372,57,57,0,1,0
12,372,372,5,5,0,1,0
9,375,375,24,24,0,1,0
10,408,408,41,2,39,2,1
19,412,412,23,9,14,2,1
17,438,438,4,4,0,1,0
33,438,438,42,42,0,1,0
29,450,450,12,12,0,1,0
27,451,451,21,6,15,2,1
18,452,452,21,21,0,1,0
1,471,471,3,3,0,1,0
4,488,488,92,92,0,1,0
31,497,497,78,78,0,1,0

21,103,103,4,1,3,2,1
23,106,106,3,3,0,1,0
31,123,123,5,2,3,2,1
6,125,125,5,5,0,1,0
22,133,133,13,7,6,3,2
20,161,161,5,5,0,1,0
2,203,203,2,2,0,1,0
0,212,212,11,11,0,1,0
24,218,218,25,5,20,3,2
28,239,239,86,56,30,3,2
10,243,243,9,9,0,1,0
33,250,250,43,17,26,2,1
1,287,287,120,3,117,4,3
13,299,299,21,6,15,2,1
11,300,300,46,46,0,1,0
4,306,306,99,86,13,2,1
25,310,310,20,20,0,1,0
17,312,312,30,30,0,1,0
8,331,331,10,10,0,1,0
14,333,333,3,3,0,1,0
9,334,334,7,1,6,2,1
7,337,337,36,36,0,1,0
15,353,353,53,53,0,1,0
16,370,370,5,5,0,1,0
30,382,382,14,11,3,2,1
12,390,390,1,1,0,1,0
5,434,434,10,10,0,1,0
29,439,439,29,2,27,4,3
3,451,451,20,11,9,2,1
18,457,457,11,11,0,1,0
27,459,459,98,10,88,3,2
32,461,461,32,32,0,1,0
26,466,466,117,96,21,4,3
19,480,480,12,12,0,1,0

12,102,102,19,11,8,3,2
19,103,103,6,1,5,2,1
14,117,117,5,5,0,1,0
6,125,125,8,2,6,3,2
4,127,127,11,5,6,2,1
24,157,157,2,2,0,1,0
25,170,170,21,2,19,2,1
15,191,191,21,21,0,1,0
3,225,225,8,2,6,2,1
23,255,255,31,13,18,3,2
30,258,258,33,33,0,1,0
26,270,270,29,8,21,4,3
1,296,296,4,4,0,1,0
17,321,321,74,60,14,2,1
18,322,322,55,29,26,3,2
16,324,324,1,1,0,1,0
22,335,335,22,22,0,1,0
13,336,336,56,35,21,4,3
27,344,344,74,74,0,1,0
28,348,348,10,10,0,1,0
2,368,368,88,88,0,1,0
11,388,388,22,6,16,3,2
21,405,405,19,3,16,2,1
29,416,416,13,5,8,3,2
0,417,417,53,9,44,3,2
10,440,440,29,29,0,1,0
7,447,447,19,9,10,3,2
8,450,450,57,57,0,1,0
5,453,453,115,45,70,3,2
20,460,460,81,21,60,3,2
9,485,485,49,49,0,1,0

16,127,127,15,15,0,1,0
1,134,134,30,30,0,1,0
13,158,158,3,3,0,1,0
24,161,161,31,31,0,1,0
7,190,190,4,4,0,1,0
15,195,195,10,10,0,1,0
21,197,197,5,5,0,1,0
28,201,201,23,16,7,2,1
25,210,210,24,17,7,2,1
22,212,212,7,7,0,1,0
3,220,220,17,17,0,1,0
20,225,225,1,1,0,1,0
11,235,235,21,3,18,2,1
5,252,252,1,1,0,1,0
17,289,289,103,103,0,1,0
9,290,290,16,8,8,2,1
29,306,306,31,5,26,3,2
14,307,307,82,82,0,1,0
8,311,311,41,41,0,1,0
6,318,318,35,23,12,4,3
12,334,334,82,82,0,1,0
4,353,353,15,15,0,1,0
19,354,354,18,10,8,2,1
31,369,369,22,22,0,1,0
10,380,380,71,71,0,1,0
0,394,394,1,1,0,1,0
26,416,416,48,48,0,1,0
30,437,437,10,10,0,1,0
23,449,449,67,25,42,3,2
18,484,484,13,7,6,3,2
27,486,486,69,69,0,1,0
2,489,489,37,25,12,2,1

6,100,100,9,9,0,1,0
11,124,124,4,4,0,1,0
16,134,134,18,18,0,1,0
29,140,140,7,7,0,1,0
17,151,151,6,6,0,1,0
13,154,154,3,3,0,1,0
8,158,158,2,2,0,1,0
15,175,175,11,1,10,2,1
19,226,226,32,2,30,4,3
12,238,238,45,45,0,1,0
28,252,252,63,12,51,4,3
4,260,260,57,57,0,1,0
27,267,267,74,74,0,1,0
9,276,276,56,50,6,3,2
30,285,285,33,33,0,1,0
0,288,288,20,12,8,3,2
18,300,300,3,3,0,1,0
14,317,317,36,3,33,2,1
23,331,331,5,5,0,1,0
3,351,351,94,65,29,2,1
25,352,352,19,19,0,1,0
5,355,355,16,7,9,4,3
20,364,364,15,15,0,1,0
22,365,365,60,13,47,2,1
10,378,378,8,4,4,2,1
31,403,403,8,8,0,1,0
26,439,439,21,21,0,1,0
7,450,450,10,10,0,1,0
2,453,453,44,4,40,4,3
24,465,465,113,24,89,4,3
1,469,469,64,64,0,1,0
21,484,484,8,8,0,1,0

3,104,104,3,3,0,1,0
2,111,111,22,1,21,2,1
11,114,114,7,7,0,1,0
20,132,132,12,4,8,3,2
18,143,143,15,15,0,1,0
0,145,145,5,5,0,1,0
13,155,155,12,12,0,1,0
10,165,165,3,3,0,1,0
6,177,177,17,3,14,2,1
1,179,179,4,4,0,1,0
31,222,222,24,17,7,2,1
25,233,233,8,4,4,2,1
23,255,255,17,5,12,3,2
16,268,268,45,33,12,4,3
19,294,294,27,27,0,1,0
7,300,300,1,1,0,1,0
4,311,311,15,3,12,2,1
21,313,313,77,27,50,3,2
28,327,327,134,74,60,4,3
22,333,333,18,18,0,1,0
12,335,335,49,37,12,4,3
15,352,352,86,86,0,1,0
26,373,373,33,33,0,1,0
30,382,382,16,16,0,1,0
27,388,388,30,22,8,2,1
29,407,407,14,14,0,1,0
17,409,409,1,1,0,1,0
24,421,421,4,4,0,1,0
5,425,425,113,87,26,2,1
14,430,430,14,8,6,2,1
9,466,466,68,35,33,4,3
8,485,485,86,83,3,2,1

5,113,113,6,6,0,1,0
19,117,117,5,1,4,2,1
9,125,125,13,7,6,3,2
20,138,138,4,4,0,1,0
26,145,145,63,53,10,3,2
33,178,178,59,59,0,1,0
32,194,194,30,30,0,1,0
31,200,200,5,5,0,1,0
30,202,202,2,2,0,1,0
7,211,211,14,10,4,2,1
11,214,214,18,6,12,4,3
21,216,216,22,22,0,1,0
23,220,220,13,13,0,1,0
8,227,227,5,5,0,1,0
14,242,242,1,1,0,1,0
29,244,244,12,1,11,2,1
3,274,274,1,1,0,1,0
18,275,275,63,31,32,3,2
17,308,308,5,1,4,2,1
28,329,329,48,6,42,4,3
16,332,332,8,8,0,1,0
1,336,336,36,14,22,3,2
2,340,340,44,20,24,3,2
34,347,347,2,2,0,1,0
12,357,357,16,8,8,3,2
10,365,365,12,12,0,1,0
6,366,366,4,4,0,1,0
13,408,408,63,37,26,3,2
35,422,422,5,5,0,1,0
15,431,431,35,20,15,2,1
24,452,452,12,4,8,3,2
22,472,472,13,13,0,1,0
27,480,480,6,6,0,1,0
25,480,480,100,100,0,1,0
0,488,488,1,1,0,1,0
4,488,488,190,97,93,4,3

16,101,101,10,1,9,2,1
5,105,105,2,2,0,1,0
13,120,120,5,5,0,1,0
3,121,121,7,7,0,1,0
24,122,122,7,7,0,1,0
9,130,130,29,17,12,4,3
11,148,148,26,26,0,1,0
10,160,160,14,2,12,4,3
29,161,161,4,4,0,1,0
25,163,163,38,38,0,1,0
14,197,197,6,1,5,2,1
8,220,220,4,4,0,1,0
17,231,231,9,9,0,1,0
20,260,260,2,2,0,1,0
27,273,273,56,4,52,3,2
19,302,302,39,39,0,1,0
21,305,305,104,64,40,4,3
26,309,309,25,1,24,3,2
12,311,311,32,28,4,2,1
0,313,313,41,17,24,2,1
22,314,314,8,8,0,1,0
2,315,315,91,24,67,3,2
4,334,334,19,13,6,2,1
32,357,357,39,39,0,1,0
7,378,378,25,15,10,2,1
33,410,410,63,29,34,2,1
23,420,420,1,1,0,1,0
28,428,428,39,39,0,1,0
31,429,429,4,4,0,1,0
1,456,456,21,21,0,1,0
6,464,464,9,4,5,2,1
18,493,493,57,57,0,1,0
15,494,494,50,30,20,3,2
30,496,496,22,22,0,1,0

0,112,112,1,1,0,1,0
23,112,112,12,9,3,2,1
4,115,115,2,2,0,1,0
22,118,118,8,8,0,1,0
24,134,134,1,1,0,1,0
17,138,138,12,2,10,3,2
3,158,158,20,20,0,1,0
2,169,169,9,6,3,2,1
18,184,184,28,22,6,2,1
9,213,213,23,23,0,1,0
31,215,215,15,15,0,1,0
6,224,224,40,28,12,2,1
7,240,240,47,47,0,1,0
29,241,241,13,13,0,1,0
25,271,271,24,10,14,2,1
26,282,282,27,17,10,3,2
8,299,299,2,2,0,1,0
12,299,299,14,14,0,1,0
30,313,313,82,73,9,3,2
15,315,315,30,30,0,1,0
5,315,315,48,22,26,4,3
13,325,325,56,56,0,1,0
20,359,359,35,19,16,3,2
10,372,372,4,4,0,1,0
32,374,374,40,2,38,3,2
11,394,394,30,3,27,4,3
28,407,407,36,36,0,1,0
27,423,423,109,72,37,4,3
14,424,424,56,56,0,1,0
19,436,436,31,17,14,2,1
21,442,442,11,11,0,1,0
1,494,494,1,1,0,1,0
16,495,495,108,75,33,4,3

7,104,104,5,5,0,1,0
22,109,109,19,19,0,1,0
0,131,131,9,2,7,3,2
4,138,138,18,6,12,4,3
30,139,139,1,1,0,1,0
25,147,147,2,2,0,1,0
28,155,155,9,9,0,1,0
11,164,164,31,9,22,3,2
3,165,165,2,2,0,1,0
24,178,178,11,11,0,1,0
9,178,178,67,53,14,2,1
18,179,179,17,9,8,2,1
8,185,185,1,1,0,1,0
29,192,192,1,1,0,1,0
1,209,209,40,26,14,2,1
16,212,212,65,28,37,2,1
5,212,212,1,1,0,1,0
14,226,226,17,2,15,2,1
6,230,230,2,2,0,1,0
17,277,277,1,1,0,1,0
10,306,306,102,6,96,3,2
27,317,317,6,2,4,2,1
23,319,319,29,8,21,2,1
2,330,330,4,4,0,1,0
13,361,361,28,28,0,1,0
19,372,372,83,10,73,4,3
26,385,385,163,136,27,4,3
12,387,387,27,27,0,1,0
15,403,403,23,23,0,1,0
21,440,440,7,7,0,1,0
20,457,457,39,2,37,4,3

27,150,150,46,46,0,1,0
18,158,158,1,1,0,1,0
20,169,169,29,29,0,1,0
17,176,176,11,11,0,1,0
30,197,197,18,1,17,2,1
35,200,200,21,21,0,1,0
2,201,201,21,5,16,3,2
12,233,233,3,3,0,1,0
25,242,242,11,11,0,1,0
5,244,244,12,12,0,1,0
22,251,251,16,10,6,3,2
7,261,261,19,5,14,3,2
37,311,311,3,3,0,1,0
0,321,321,10,10,0,1,0
3,329,329,17,17,0,1,0
28,335,335,55,55,0,1,0
33,350,350,45,33,12,3,2
8,351,351,10,6,4,2,1
19,359,359,1,1,0,1,0
10,364,364,7,7,0,1,0
6,367,367,8,8,0,1,0
31,375,375,92,80,12,2,1
15,376,376,6,6,0,1,0
11,398,398,15,1,14,2,1
21,417,417,58,58,0,1,0
13,417,417,61,15,46,2,1
16,418,418,132,93,39,2,1
29,426,426,7,3,4,2,1
4,431,431,9,1,8,2,1
26,436,436,75,46,29,4,3
24,455,455,31,31,0,1,0
9,458,458,46,41,5,2,1
23,476,476,11,11,0,1,0
14,481,481,25,5,20,3,2
34,485,485,18,18,0,1,0
1,488,488,67,27,40,3,2
32,493,493,45,45,0,1,0
36,496,496,27,27,0,1,0

26,120,120,6,6,0,1,0
31,129,129,3,3,0,1,0
8,130,130,19,1,18,4,3
6,153,153,3,3,0,1,0
14,161,161,36,6,30,2,1
33,163,163,7,7,0,1,0
17,165,165,9,9,0,1,0
19,173,173,23,23,0,1,0
7,193,193,23,1,22,4,3
20,199,199,17,4,13,2,1
9,214,214,9,9,0,1,0
16,230,230,10,10,0,1,0
15,246,246,5,2,3,2,1
13,252,252,6,3,3,2,1
3,271,271,36,9,27,4,3
4,277,277,20,14,6,3,2
0,286,286,19,19,0,1,0
25,292,292,56,50,6,3,2
23,311,311,12,8,4,2,1
10,318,318,73,37,36,2,1
32,353,353,6,6,0,1,0
22,372,372,151,28,123,4,3
12,372,372,77,3,74,3,2
24,396,396,57,11,46,4,3
30,414,414,26,15,11,4,3
21,431,431,43,7,36,3,2
27,470,470,23,17,6,2,1
11,481,481,48,48,0,1,0
5,481,481,23,23,0,1,0
28,483,483,39,39,0,1,0
18,485,485,45,21,24,2,1
1,486,486,2,2,0,1,0
29,488,488,61,17,44,3,2
2,488,488,24,24,0,1,0

18,100,100,9,9,0,1,0
13,111,111,21,21,0,1,0
8,122,122,7,7,0,1,0
11,133,133,7,7,0,1,0
16,220,220,9,9,0,1,0
0,241,241,10,1,9,2,1
2,255,255,5,5,0,1,0
6,282,282,10,2,8,3,2
10,299,299,1,1,0,1,0
26,303,303,2,2,0,1,0
27,314,314,16,6,10,2,1
4,324,324,58,16,42,4,3
1,326,326,36,24,12,4,3
25,348,348,34,34,0,1,0
24,369,369,43,31,12,3,2
23,390,390,106,97,9,4,3
15,396,396,58,42,16,2,1
3,411,411,244,244,0,1,0
20,411,411,6,6,0,1,0
7,417,417,101,41,60,4,3
12,425,425,12,12,0,1,0
9,436,436,83,5,78,4,3
22,440,440,52,52,0,1,0
5,451,451,36,18,18,2,1
14,476,476,46,21,25,2,1
17,486,486,58,58,0,1,0
19,490,490,107,107,0,1,0
21,499,499,11,1,10,2,1

25,100,100,5,5,0,1,0
2,118,118,1,1,0,1,0
13,121,121,7,1,6,2,1
32,178,178,23,2,21,3,2
35,197,197,61,6,55,3,2
34,197,197,9,9,0,1,0
26,198,198,32,32,0,1,0
12,203,203,10,10,0,1,0
21,215,215,6,6,0,1,0
9,222,222,7,3,4,2,1
5,255,255,8,2,6,2,1
17,263,263,16,12,4,2,1
15,264,264,28,15,13,2,1
28,267,267,2,2,0,1,0
11,268,268,48,48,0,1,0
4,292,292,33,33,0,1,0
6,296,296,47,47,0,1,0
33,306,306,1,1,0,1,0
7,308,308,54,54,0,1,0
19,317,317,53,29,24,3,2
22,323,323,3,3,0,1,0
27,334,334,59,59,0,1,0
31,342,342,20,20,0,1,0
14,355,355,4,4,0,1,0
16,357,357,9,9,0,1,0
24,378,378,15,5,10,2,1
3,408,408,24,24,0,1,0
8,411,411,16,4,12,4,3
0,412,412,22,22,0,1,0
20,447,447,169,140,29,2,1
29,451,451,76,37,39,4,3
1,464,464,67,67,0,1,0
30,466,466,27,27,0,1,0
18,482,482,34,34,0,1,0
10,487,487,30,30,0,1,0
23,494,494,9,9,0,1,0

1,108,108,7,1,6,3,2
8,112,112,14,2,12,3,2
27,115,115,19,19,0,1,0
15,121,121,17,17,0,1,0
17,158,158,43,8,35,2,1
14,189,189,13,5,8,3,2
0,209,209,1,1,0,1,0
12,213,213,5,5,0,1,0
21,216,216,6,6,0,1,0
30,225,225,17,1,16,3,2
16,253,253,33,19,14,2,1
18,253,253,32,13,19,2,1
23,256,256,6,6,0,1,0
28,262,262,24,7,17,2,1
13,265,265,22,3,19,2,1
7,292,292,60,60,0,1,0
22,305,305,13,2,11,2,1
20,306,306,10,1,9,4,3
24,309,309,31,31,0,1,0
25,320,320,45,18,27,4,3
9,338,338,153,148,5,2,1
26,375,375,16,4,12,2,1
5,394,394,46,46,0,1,0
19,394,394,58,10,48,2,1
10,402,402,12,12,0,1,0
4,430,430,13,1,12,4,3
3,436,436,46,5,41,2,1
2,473,473,33,33,0,1,0
11,482,482,78,33,45,3,2
6,482,482,28,28,0,1,0
29,495,495,36,6,30,3,2

28,105,105,4,4,0,1,0
14,117,117,4,4,0,1,0
8,134,134,1,1,0,1,0
16,142,142,4,4,0,1,0
19,158,158,14,14,0,1,0
21,162,162,10,10,0,1,0
11,173,173,3,3,0,1,0
27,173,173,1,1,0,1,0
20,186,186,21,5,16,2,1
3,209,209,4,1,3,2,1
5,216,216,52,52,0,1,0
0,220,220,32,5,27,4,3
18,228,228,37,37,0,1,0
25,250,250,22,6,16,2,1
4,260,260,35,8,27,4,3
10,279,279,49,40,9,4,3
22,304,304,23,23,0,1,0
12,305,305,5,5,0,1,0
15,307,307,37,22,15,3,2
24,348,348,15,15,0,1,0
9,378,378,102,93,9,4,3
6,379,379,22,3,19,2,1
2,411,411,62,8,54,4,3
1,434,434,49,20,29,4,3
23,452,452,62,14,48,2,1
26,467,467,62,9,53,4,3
7,492,492,125,26,99,4,3
17,493,493,139,139,0,1,0
13,493,493,115,58,57,4,3

19,133,133,6,6,0,1,0
27,139,139,13,3,10,3,2
29,140,140,1,1,0,1,0
8,157,157,9,3,6,3,2
32,178,178,6,6,0,1,0
26,178,178,15,11,4,2,1
34,180,180,10,2,8,2,1
23,188,188,34,25,9,2,1
18,200,200,30,4,26,2,1
5,200,200,7,7,0,1,0
31,204,204,10,10,0,1,0
20,206,206,25,13,12,3,2
40,207,207,25,25,0,1,0
7,226,226,35,5,30,2,1
35,238,238,10,10,0,1,0
39,253,253,74,33,41,2,1
38,273,273,63,63,0,1,0
17,275,275,8,8,0,1,0
33,275,275,12,12,0,1,0
15,290,290,7,7,0,1,0
6,293,293,14,11,3,2,1
3,305,305,3,3,0,1,0
21,317,317,4,1,3,2,1
0,356,356,6,6,0,1,0
13,358,358,13,13,0,1,0
36,376,376,30,30,0,1,0
28,382,382,117,104,13,2,1
2,389,389,5,5,0,1,0
24,429,429,39,39,0,1,0
12,431,431,21,21,0,1,0
10,434,434,19,19,0,1,0
11,439,439,38,18,20,3,2
25,440,440,67,40,27,4,3
16,440,440,1,1,0,1,0
9,443,443,43,23,20,3,2
22,451,451,61,18,43,2,1
30,452,452,2,2,0,1,0
1,461,461,39,20,19,2,1
37,477,477,20,11,9,2,1
14,491,491,7,2,5,2,1
4,495,495,32,32,0,1,0

10,127,127,30,20,10,3,2
8,186,186,1,1,0,1,0
13,193,193,8,8,0,1,0
7,201,201,53,38,15,4,3
0,219,219,26,26,0,1,0
18,231,231,14,14,0,1,0
22,234,234,12,12,0,1,0
27,250,250,7,4,3,2,1
6,259,259,20,20,0,1,0
4,269,269,2,2,0,1,0
14,269,269,16,16,0,1,0
2,286,286,45,6,39,4,3
5,295,295,77,77,0,1,0
16,297,297,51,9,42,4,3
24,300,300,17,5,12,2,1
17,337,337,18,9,9,2,1
1,358,358,16,16,0,1,0
11,368,368,8,8,0,1,0
25,376,376,82,26,56,3,2
9,379,379,117,76,41,4,3
15,397,397,120,24,96,3,2
12,403,403,57,35,22,2,1
23,428,428,56,8,48,4,3
21,442,442,10,7,3,2,1
26,460,460,36,12,24,4,3
19,462,462,16,4,12,2,1
20,462,462,80,40,40,2,1
3,480,480,47,12,35,4,3

22,109,109,15,15,0,1,0
19,135,135,15,11,4,2,1
29,138,138,7,7,0,1,0
7,159,159,19,19,0,1,0
14,176,176,47,8,39,4,3
9,199,199,22,22,0,1,0
1,200,200,3,3,0,1,0
3,272,272,42,42,0,1,0
18,285,285,57,57,0,1,0
15,290,290,1,1,0,1,0
23,292,292,26,26,0,1,0
10,308,308,39,39,0,1,0
17,314,314,6,6,0,1,0
20,317,317,53,15,38,3,2
24,324,324,5,5,0,1,0
30,324,324,82,82,0,1,0
16,330,330,5,1,4,2,1
25,333,333,39,17,22,2,1
27,363,363,9,9,0,1,0
6,377,377,82,12,70,4,3
32,379,379,42,20,22,3,2
21,383,383,26,26,0,1,0
0,406,406,2,2,0,1,0
11,416,416,29,29,0,1,0
28,418,418,37,37,0,1,0
4,439,439,8,8,0,1,0
26,446,446,48,48,0,1,0
8,456,456,63,13,50,2,1
31,464,464,33,20,13,4,3
2,470,470,26,17,9,2,1
13,488,488,55,55,0,1,0
12,489,489,61,30,31,2,1
5,494,494,24,4,20,3,2

18,111,111,20,20,0,1,0
27,114,114,1,1,0,1,0
0,137,137,3,3,0,1,0
4,178,178,11,8,3,2,1
32,178,178,6,6,0,1,0
22,182,182,3,3,0,1,0
12,188,188,5,5,0,1,0
9,189,189,43,43,0,1,0
19,201,201,31,31,0,1,0
24,212,212,9,9,0,1,0
15,245,245,35,2,33,2,1
1,250,250,3,3,0,1,0
10,254,254,12,12,0,1,0
13,265,265,30,30,0,1,0
8,270,270,21,21,0,1,0
26,287,287,43,43,0,1,0
31,335,335,9,9,0,1,0
17,335,335,26,14,12,3,2
6,339,339,9,9,0,1,0
25,349,349,12,8,4,2,1
23,367,367,29,12,17,2,1
2,375,375,115,37,78,4,3
21,386,386,13,13,0,1,0
11,397,397,39,21,18,4,3
20,410,410,194,176,18,2,1
14,417,417,25,25,0,1,0
30,420,420,61,61,0,1,0
5,454,454,28,28,0,1,0
28,461,461,51,2,49,4,3
29,488,488,34,13,21,4,3
16,491,491,59,23,36,4,3
3,496,496,31,11,20,2,1
7,497,497,67,23,44,2,1

3,115,115,14,14,0,1,0
28,124,124,8,8,0,1,0
16,124,124,3,3,0,1,0
14,129,129,1,1,0,1,0
6,141,141,17,17,0,1,0
11,143,143,11,1,10,2,1
15,179,179,25,25,0,1,0
27,182,182,7,4,3,2,1
20,266,266,9,9,0,1,0
0,286,286,23,17,6,2,1
23,290,290,11,6,5,2,1
13,307,307,33,11,22,2,1
1,330,330,1,1,0,1,0
12,343,343,43,19,24,4,3
10,345,345,24,6,18,2,1
25,345,345,16,16,0,1,0
18,347,347,61,61,0,1,0
7,349,349,6,2,4,2,1
26,369,369,13,7,6,3,2
9,387,387,13,1,12,2,1
24,404,404,127,79,48,2,1
19,406,406,66,66,0,1,0
17,429,429,107,9,98,4,3
8,433,433,31,18,13,2,1
2,453,453,106,55,51,4,3
5,461,461,109,109,0,1,0
21,463,463,36,36,0,1,0
22,474,474,53,53,0,1,0
4,494,494,203,113,90,3,2

35,118,118,5,1,4,2,1
9,141,141,2,2,0,1,0
5,165,165,4,1,3,2,1
27,201,201,9,6,3,2,1
0,202,202,19,19,0,1,0
23,206,206,28,28,0,1,0
17,209,209,14,2,12,3,2
30,224,224,15,15,0,1,0
2,230,230,14,1,13,2,1
24,235,235,65,41,24,4,3
33,236,236,7,7,0,1,0
13,240,240,13,7,6,2,1
4,246,246,24,5,19,2,1
14,252,252,46,46,0,1,0
6,263,263,22,22,0,1,0
18,271,271,25,6,19,4,3
26,284,284,25,25,0,1,0
21,296,296,41,41,0,1,0
29,307,307,51,2,49,2,1
34,308,308,9,9,0,1,0
22,315,315,6,3,3,2,1
11,317,317,57,57,0,1,0
16,348,348,5,5,0,1,0
7,355,355,16,1,15,2,1
8,369,369,37,3,34,3,2
12,390,390,2,2,0,1,0
1,393,393,16,16,0,1,0
31,398,398,37,37,0,1,0
3,402,402,54,15,39,4,3
36,404,404,40,2,38,2,1
20,408,408,64,40,24,4,3
28,416,416,16,16,0,1,0
32,446,446,132,30,102,4,3
15,450,450,1,1,0,1,0
19,457,457,63,7,56,3,2
10,466,466,7,7,0,1,0
25,485,485,32,9,23,2,1

6,101,101,2,2,0,1,0
17,105,105,3,3,0,1,0
31,109,109,2,2,0,1,0
0,112,112,9,9,0,1,0
15,135,135,1,1,0,1,0
14,140,140,1,1,0,1,0
34,155,155,41,41,0,1,0
2,159,159,19,16,3,2,1
18,161,161,18,12,6,3,2
20,171,171,4,4,0,1,0
5,183,183,35,3,32,2,1
16,184,184,4,4,0,1,0
19,193,193,1,1,0,1,0
32,211,211,17,5,12,2,1
8,223,223,20,20,0,1,0
22,262,262,2,2,0,1,0
21,267,267,73,42,31,2,1
13,271,271,10,2,8,3,2
28,272,272,57,5,52,3,2
1,285,285,1,1,0,1,0
10,300,300,17,1,16,3,2
3,303,303,24,24,0,1,0
23,333,333,27,20,7,2,1
26,349,349,16,16,0,1,0
30,355,355,9,3,6,3,2
25,356,356,21,21,0,1,0
29,360,360,9,6,3,2,1
33,365,365,21,21,0,1,0
4,376,376,12,3,9,2,1
37,382,382,35,24,11,2,1
36,390,390,13,5,8,2,1
11,413,413,22,22,0,1,0
12,427,427,62,36,26,3,2
35,433,433,29,5,24,4,3
9,439,439,94,53,41,2,1
27,452,452,84,84,0,1,0
24,468,468,172,172,0,1,0
7,499,499,1,1,0,1,0

21,112,112,15,5,10,3,2
27,141,141,9,3,6,2,1
15,147,147,1,1,0,1,0
1,171,171,42,42,0,1,0
31,186,186,17,1,16,3,2
29,191,191,4,4,0,1,0
6,212,212,63,63,0,1,0
16,219,219,17,3,14,3,2
11,239,239,29,5,24,4,3
7,248,248,42,42,0,1,0
30,257,257,9,9,0,1,0
2,266,266,47,47,0,1,0
14,288,288,30,20,10,3,2
23,298,298,25,16,9,2,1
0,302,302,2,2,0,1,0
17,303,303,14,14,0,1,0
28,332,332,86,86,0,1,0
4,336,336,1,1,0,1,0
19,346,346,38,38,0,1,0
3,350,350,59,59,0,1,0
10,357,357,7,7,0,1,0
5,364,364,7,7,0,1,0
26,365,365,13,10,3,2,1
13,402,402,32,1,31,2,1
8,427,427,17,7,10,3,2
18,433,433,91,91,0,1,0
12,435,435,16,12,4,2,1
24,449,449,9,1,8,3,2
20,449,449,55,37,18,4,3
22,452,452,49,2,47,4,3
9,458,458,51,51,0,1,0
25,479,479,106,74,32,4,3

4,100,100,1,1,0,1,0
0,105,105,23,23,0,1,0
15,106,106,2,2,0,1,0
7,137,137,36,2,34,2,1
18,152,152,5,5,0,1,0
30,185,185,47,47,0,1,0
24,188,188,13,1,12,3,2
1,218,218,1,1,0,1,0
14,244,244,13,13,0,1,0
11,255,255,3,3,0,1,0
22,257,257,89,89,0,1,0
28,286,286,12,12,0,1,0
5,305,305,2,2,0,1,0
16,315,315,9,9,0,1,0
12,336,336,73,9,64,3,2
23,337,337,2,2,0,1,0
19,348,348,29,5,24,2,1
27,364,364,41,20,21,4,3
9,369,369,56,56,0,1,0
21,397,397,23,12,11,2,1
25,404,404,66,38,28,3,2
13,406,406,22,13,9,4,3
2,409,409,10,4,6,2,1
6,412,412,4,4,0,1,0
20,416,416,10,10,0,1,0
3,420,420,114,8,106,4,3
29,429,429,41,2,39,2,1
17,441,441,15,3,12,4,3
10,457,457,93,19,74,3,2
8,477,477,48,6,42,3,2
26,480,480,129,129,0,1,0

2,141,141,12,12,0,1,0
5,149,149,16,3,13,2,1
25,153,153,14,1,13,4,3
8,157,157,2,2,0,1,0
15,168,168,10,10,0,1,0
30,186,186,14,1,13,4,3
23,186,186,18,18,0,1,0
13,228,228,30,30,0,1,0
20,231,231,19,9,10,3,2
21,239,239,13,13,0,1,0
16,240,240,7,7,0,1,0
3,270,270,4,4,0,1,0
0,273,273,35,35,0,1,0
4,274,274,12,12,0,1,0
7,275,275,8,8,0,1,0
29,281,281,17,17,0,1,0
11,292,292,22,22,0,1,0
24,299,299,43,31,12,3,2
26,301,301,9,3,6,2,1
10,307,307,1,1,0,1,0
6,335,335,10,10,0,1,0
27,337,337,20,2,18,3,2
28,372,372,35,1,34,3,2
9,389,389,49,49,0,1,0
12,393,393,176,176,0,1,0
18,395,395,18,18,0,1,0
14,405,405,83,71,12,3,2
1,417,417,67,67,0,1,0
19,422,422,103,22,81,4,3
17,458,458,140,85,55,4,3
22,495,495,78,63,15,4,3

19,117,117,14,7,7,2,1
13,117,117,18,18,0,1,0
5,127,127,34,2,32,3,2
18,129,129,18,18,0,1,0
29,142,142,12,12,0,1,0
4,155,155,32,20,12,4,3
24,186,186,14,1,13,2,1
1,203,203,28,12,16,3,2
11,206,206,3,3,0,1,0
27,209,209,7,7,0,1,0
14,244,244,4,4,0,1,0
26,255,255,6,2,4,2,1
7,263,263,9,9,0,1,0
8,274,274,6,6,0,1,0
3,305,305,18,7,11,2,1
22,310,310,61,43,18,2,1
20,312,312,30,3,27,2,1
16,315,315,7,7,0,1,0
21,347,347,2,2,0,1,0
6,352,352,6,6,0,1,0
28,353,353,20,2,18,3,2
15,374,374,140,140,0,1,0
25,394,394,50,50,0,1,0
12,397,397,9,9,0,1,0
23,421,421,53,53,0,1,0
2,468,468,36,4,32,2,1
10,470,470,65,65,0,1,0
0,487,487,154,29,125,4,3
9,497,497,67,32,35,2,1
17,498,498,68,53,15,4,3

6,132,132,1,1,0,1,0
13,151,151,1,1,0,1,0
24,153,153,20,20,0,1,0
19,159,159,43,43,0,1,0
22,166,166,56,24,32,4,3
2,176,176,16,8,8,3,2
3,197,197,22,22,0,1,0
20,203,203,5,5,0,1,0
29,204,204,10,2,8,3,2
26,207,207,19,14,5,2,1
12,207,207,48,48,0,1,0
14,215,215,45,22,23,2,1
27,218,218,6,3,3,2,1
7,231,231,10,10,0,1,0
17,243,243,5,5,0,1,0
8,246,246,24,14,10,3,2
9,247,247,28,17,11,2,1
16,259,259,10,6,4,2,1
30,274,274,5,5,0,1,0
1,335,335,13,1,12,3,2
4,347,347,94,25,69,4,3
25,384,384,9,9,0,1,0
11,399,399,73,58,15,2,1
10,442,442,27,27,0,1,0
5,443,443,49,16,33,4,3
18,475,475,39,39,0,1,0
28,476,476,6,2,4,2,1
21,486,486,2,2,0,1,0
15,487,487,120,59,61,3,2
23,492,492,124,3,121,4,3
0,498,498,12,4,8,2,1

6,152,152,7,7,0,1,0
1,155,155,9,2,7,2,1
28,172,172,4,4,0,1,0
2,207,207,50,45,5,2,1
15,225,225,1,1,0,1,0
31,231,231,16,3,13,3,2
0,244,244,7,7,0,1,0
14,257,257,9,1,8,3,2
22,274,274,72,12,60,4,3
34,300,300,28,28,0,1,0
5,304,304,1,1,0,1,0
25,333,333,13,2,11,2,1
12,347,347,52,52,0,1,0
27,351,351,16,2,14,3,2
3,359,359,44,6,38,3,2
18,360,360,65,50,15,4,3
17,363,363,8,8,0,1,0
32,375,375,3,3,0,1,0
23,385,385,16,16,0,1,0
33,396,396,78,10,68,3,2
11,397,397,8,8,0,1,0
24,409,409,63,14,49,2,1
20,412,412,40,11,29,3,2
10,440,440,3,3,0,1,0
19,447,447,48,28,20,4,3
8,450,450,23,23,0,1,0
7,451,451,6,3,3,2,1
4,452,452,39,11,28,3,2
21,457,457,18,1,17,4,3
16,458,458,41,34,7,2,1
30,465,465,120,82,38,4,3
13,465,465,143,136,7,2,1
9,472,472,64,27,37,4,3
26,484,484,46,46,0,1,0
29,489,489,46,16,30,2,1

7,104,104,1,1,0,1,0
37,104,104,35,35,0,1,0
24,117,117,4,1,3,2,1
23,121,121,18,18,0,1,0
29,125,125,6,6,0,1,0
22,147,147,9,5,4,2,1
14,166,166,5,1,4,2,1
16,170,170,6,6,0,1,0
12,173,173,20,5,15,4,3
34,178,178,14,14,0,1,0
11,179,179,28,5,23,2,1
3,198,198,43,43,0,1,0
5,200,200,4,4,0,1,0
32,206,206,3,3,0,1,0
2,208,208,37,37,0,1,0
25,223,223,6,2,4,2,1
8,225,225,9,9,0,1,0
33,245,245,25,13,12,4,3
36,245,245,16,6,10,3,2
1,245,245,4,4,0,1,0
10,255,255,48,20,28,3,2
31,270,270,40,40,0,1,0
20,275,275,1,1,0,1,0
9,316,316,23,3,20,4,3
38,330,330,26,26,0,1,0
17,344,344,2,2,0,1,0
30,352,352,25,25,0,1,0
26,374,374,49,49,0,1,0
19,388,388,25,4,21,4,3
0,402,402,12,3,9,2,1
4,419,419,6,6,0,1,0
27,432,432,71,71,0,1,0
13,437,437,46,38,8,3,2
28,447,447,49,17,32,2,1
21,470,470,10,10,0,1,0
18,475,475,2,2,0,1,0
15,486,486,64,16,48,4,3
35,486,486,39,39,0,1,0
6,487,487,41,4,37,3,2

25,100,100,1,1,0,1,0
8,103,103,1,1,0,1,0
19,115,115,17,5,12,3,2
34,125,125,18,18,0,1,0
29,126,126,5,1,4,2,1
31,172,172,25,25,0,1,0
28,175,175,13,13,0,1,0
3,188,188,22,22,0,1,0
27,211,211,3,3,0,1,0
16,248,248,2,2,0,1,0
2,263,263,12,12,0,1,0
5,276,276,7,7,0,1,0
0,277,277,22,12,10,3,2
23,278,278,45,45,0,1,0
1,300,300,12,3,9,4,3
21,314,314,66,12,54,3,2
9,318,318,79,51,28,4,3
11,326,326,1,1,0,1,0
22,329,329,67,34,33,2,1
10,334,334,6,6,0,1,0
24,338,338,3,3,0,1,0
20,339,339,31,31,0,1,0
26,345,345,17,5,12,3,2
6,353,353,79,79,0,1,0
7,371,371,15,10,5,2,1
12,378,378,26,14,12,2,1
35,406,406,33,20,13,2,1
14,422,422,32,32,0,1,0
30,450,450,127,15,112,4,3
15,465,465,66,34,32,3,2
18,482,482,64,64,0,1,0
13,484,484,23,23,0,1,0
32,487,487,30,8,22,3,2
33,487,487,27,2,25,3,2
17,488,488,34,26,8,2,1
4,495,495,32,6,26,2,1

21,109,109,24,24,0,1,0
4,111,111,25,25,0,1,0
19,114,114,2,2,0,1,0
2,118,118,4,4,0,1,0
1,122,122,11,4,7,2,1
12,129,129,6,1,5,2,1
27,142,142,2,2,0,1,0
5,145,145,20,7,13,3,2
6,167,167,12,12,0,1,0
3,184,184,31,13,18,3,2
26,188,188,5,5,0,1,0
7,200,200,20,20,0,1,0
13,213,213,39,39,0,1,0
16,217,217,4,4,0,1,0
18,231,231,46,46,0,1,0
0,231,231,17,3,14,3,2
20,239,239,10,10,0,1,0
24,253,253,3,3,0,1,0
11,263,263,10,10,0,1,0
30,271,271,7,7,0,1,0
8,286,286,36,36,0,1,0
10,297,297,19,10,9,2,1
9,300,300,1,1,0,1,0
29,327,327,2,2,0,1,0
25,331,331,86,62,24,2,1
14,356,356,85,10,75,4,3
23,373,373,159,69,90,4,3
15,375,375,10,10,0,1,0
17,410,410,26,17,9,4,3
28,424,424,39,39,0,1,0
22,425,425,77,34,43,4,3

32,102,102,6,6,0,1,0
14,125,125,11,11,0,1,0
1,133,133,1,1,0,1,0
11,139,139,1,1,0,1,0
27,159,159,5,5,0,1,0
16,169,169,46,20,26,2,1
22,193,193,10,1,9,2,1
7,204,204,1,1,0,1,0
31,205,205,12,12,0,1,0
30,216,216,22,12,10,3,2
28,225,225,5,5,0,1,0
24,225,225,5,2,3,2,1
29,236,236,9,9,0,1,0
21,241,241,21,21,0,1,0
13,254,254,14,1,13,4,3
18,260,260,6,6,0,1,0
15,275,275,23,23,0,1,0
6,312,312,16,10,6,2,1
8,318,318,5,5,0,1,0
19,331,331,51,1,50,2,1
20,335,335,6,6,0,1,0
5,338,338,9,9,0,1,0
17,354,354,9,3,6,3,2
9,364,364,91,91,0,1,0
26,365,365,152,100,52,3,2
10,374,374,11,1,10,3,2
4,379,379,10,10,0,1,0
0,418,418,72,45,27,2,1
25,434,434,178,106,72,4,3
2,437,437,164,100,64,3,2
3,439,439,6,2,4,2,1
12,456,456,34,4,30,3,2
23,470,470,19,19,0,1,0
34,495,495,1,1,0,1,0
33,498,498,61,20,41,2,1

6,101,101,11,3,8,3,2
5,119,119,25,9,16,4,3
24,143,143,8,8,0,1,0
28,158,158,10,4,6,2,1
1,159,159,17,17,0,1,0
13,164,164,12,3,9,2,1
19,176,176,8,8,0,1,0
26,190,190,23,23,0,1,0
20,222,222,2,2,0,1,0
0,248,248,2,2,0,1,0
36,249,249,35,35,0,1,0
31,255,255,14,10,4,2,1
11,260,260,16,6,10,2,1
17,305,305,11,11,0,1,0
10,310,310,15,15,0,1,0
34,311,311,15,15,0,1,0
32,312,312,112,23,89,4,3
15,315,315,18,18,0,1,0
8,329,329,38,22,16,2,1
2,341,341,12,12,0,1,0
30,344,344,7,7,0,1,0
33,366,366,50,50,0,1,0
23,381,381,52,10,42,4,3
9,420,420,52,16,36,2,1
16,425,425,75,62,13,2,1
29,428,428,26,15,11,2,1
27,434,434,19,1,18,4,3
18,449,449,22,6,16,3,2
22,454,454,30,1,29,2,1
14,464,464,8,8,0,1,0
35,468,468,114,18,96,3,2
7,474,474,5,5,0,1,0
3,486,486,24,9,15,4,3
25,487,487,7,7,0,1,0
21,490,490,29,29,0,1,0
12,498,498,15,3,12,2,1
4,500,500,115,105,10,2,1

26,113,113,3,3,0,1,0
13,145,145,7,7,0,1,0
1,158,158,37,37,0,1,0
18,170,170,38,26,12,3,2
25,176,176,51,3,48,2,1
17,185,185,2,2,0,1,0
23,189,189,40,40,0,1,0
3,230,230,56,25,31,2,1
14,238,238,44,44,0,1,0
27,265,265,41,41,0,1,0
12,273,273,20,20,0,1,0
22,274,274,30,3,27,2,1
20,275,275,16,8,8,2,1
2,308,308,11,11,0,1,0
9,316,316,24,11,13,2,1
19,336,336,16,4,12,4,3
4,347,347,53,20,33,4,3
7,350,350,79,31,48,3,2
28,364,364,21,2,19,2,1
10,365,365,48,30,18,2,1
21,378,378,23,23,0,1,0
16,379,379,2,2,0,1,0
11,390,390,39,39,0,1,0
15,464,464,38,38,0,1,0
0,470,470,31,21,10,3,2
24,483,483,30,30,0,1,0
5,486,486,55,45,10,3,2
8,498,498,53,26,27,2,1
6,498,498,21,13,8,3,2

11,101,101,3,3,0,1,0
32,104,104,1,1,0,1,0
25,106,106,3,3,0,1,0
23,112,112,7,7,0,1,0
34,127,127,2,2,0,1,0
18,142,142,4,4,0,1,0
22,174,174,15,15,0,1,0
13,182,182,1,1,0,1,0
36,183,183,32,9,23,2,1
35,190,190,14,14,0,1,0
19,199,199,30,22,8,3,2
30,200,200,14,14,0,1,0
40,210,210,10,10,0,1,0
17,217,217,29,29,0,1,0
26,227,227,12,3,9,4,3
2,241,241,9,9,0,1,0
12,262,262,25,25,0,1,0
21,275,275,4,4,0,1,0
39,292,292,39,39,0,1,0
1,293,293,6,2,4,2,1
3,306,306,1,1,0,1,0
7,318,318,83,63,20,2,1
41,341,341,33,1,32,3,2
33,342,342,11,11,0,1,0
27,348,348,6,6,0,1,0
28,353,353,48,48,0,1,0
29,355,355,128,128,0,1,0
5,358,358,2,2,0,1,0
37,365,365,14,2,12,4,3
20,379,379,10,2,8,3,2
15,381,381,23,23,0,1,0
0,396,396,33,11,22,2,1
10,416,416,78,40,38,4,3
31,422,422,155,141,14,3,2
9,435,435,28,14,14,2,1
4,435,435,36,3,33,3,2
6,459,459,3,3,0,1,0
38,463,463,5,5,0,1,0
24,490,490,6,6,0,1,0
16,490,490,30,30,0,1,0
8,492,492,27,14,13,2,1
14,494,494,3,3,0,1,0

20,102,102,24,24,0,1,0
16,120,120,12,12,0,1,0
25,125,125,33,13,20,3,2
23,127,127,2,2,0,1,0
31,141,141,23,23,0,1,0
21,170,170,7,7,0,1,0
30,174,174,11,11,0,1,0
19,183,183,3,3,0,1,0
17,188,188,5,1,4,2,1
28,216,216,44,14,30,4,3
4,226,226,11,2,9,3,2
22,227,227,1,1,0,1,0
2,240,240,25,21,4,2,1
32,253,253,20,3,17,3,2
14,260,260,15,15,0,1,0
13,268,268,23,4,19,2,1
3,272,272,26,15,11,2,1
24,286,286,32,27,5,2,1
9,295,295,70,70,0,1,0
7,297,297,26,5,21,4,3
0,301,301,36,36,0,1,0
29,303,303,3,3,0,1,0
10,324,324,15,9,6,2,1
5,333,333,1,1,0,1,0
15,351,351,12,12,0,1,0
8,352,352,10,10,0,1,0
6,395,395,45,45,0,1,0
27,434,434,25,25,0,1,0
11,441,441,3,3,0,1,0
26,454,454,121,121,0,1,0
12,462,462,45,30,15,4,3
18,491,491,37,37,0,1,0
1,499,499,167,128,39,4,3

10,109,109,2,2,0,1,0
24,115,115,13,13,0,1,0
0,128,128,3,3,0,1,0
25,137,137,23,23,0,1,0
3,143,143,5,5,0,1,0
5,146,146,27,27,0,1,0
26,184,184,17,17,0,1,0
20,218,218,3,3,0,1,0
21,221,221,42,42,0,1,0
19,275,275,25,25,0,1,0
9,284,284,36,36,0,1,0
18,287,287,40,7,33,2,1
15,331,331,6,6,0,1,0
17,331,331,43,13,30,2,1
12,371,371,15,15,0,1,0
8,387,387,137,86,51,4,3
16,394,394,19,5,14,3,2
4,405,405,78,78,0,1,0
14,407,407,67,67,0,1,0
6,414,414,73,43,30,3,2
11,423,423,61,61,0,1,0
7,428,428,100,48,52,3,2
2,430,430,93,63,30,2,1
23,449,449,29,14,15,2,1
1,453,453,19,2,17,2,1
22,459,459,5,5,0,1,0
13,495,495,102,102,0,1,0

0,107,107,15,15,0,1,0
11,112,112,2,2,0,1,0
7,114,114,11,11,0,1,0
16,125,125,18,6,12,4,3
6,173,173,30,5,25,2,1
14,177,177,3,3,0,1,0
20,217,217,16,16,0,1,0
18,223,223,12,12,0,1,0
23,228,228,33,33,0,1,0
3,243,243,30,3,27,2,1
19,261,261,40,18,22,4,3
15,271,271,13,13,0,1,0
13,283,283,21,16,5,2,1
5,300,300,11,1,10,2,1
27,300,300,63,48,15,4,3
24,318,318,46,7,39,4,3
2,347,347,6,6,0,1,0
1,370,370,130,103,27,4,3
10,409,409,77,77,0,1,0
22,410,410,4,1,3,2,1
21,411,411,32,2,30,3,2
28,420,420,46,34,12,3,2
4,446,446,19,4,15,4,3
25,448,448,18,4,14,2,1
12,465,465,79,13,66,3,2
9,470,470,82,82,0,1,0
26,481,481,131,69,62,3,2
8,492,492,34,34,0,1,0
17,495,495,26,26,0,1,0

12,109,109,12,4,8,3,2
19,114,114,9,3,6,3,2
11,194,194,9,9,0,1,0
33,210,210,21,21,0,1,0
4,239,239,33,17,16,2,1
28,245,245,22,14,8,2,1
29,248,248,6,6,0,1,0
15,259,259,4,1,3,2,1
5,263,263,13,13,0,1,0
13,271,271,27,7,20,3,2
10,276,276,27,18,9,2,1
16,278,278,3,3,0,1,0
6,282,282,1,1,0,1,0
14,284,284,74,26,48,3,2
1,301,301,44,13,31,2,1
25,312,312,41,3,38,3,2
23,317,317,13,13,0,1,0
26,346,346,3,3,0,1,0
8,346,346,41,41,0,1,0
21,361,361,82,64,18,4,3
20,363,363,57,57,0,1,0
27,366,366,7,7,0,1,0
3,378,378,15,11,4,2,1
30,381,381,11,7,4,2,1
18,401,401,19,15,4,2,1
17,402,402,69,35,34,3,2
34,409,409,107,41,66,4,3
32,413,413,2,2,0,1,0
0,431,431,58,11,47,2,1
9,435,435,13,13,0,1,0
7,440,440,27,27,0,1,0
31,444,444,92,92,0,1,0
2,450,450,9,1,8,3,2
24,474,474,45,45,0,1,0
22,492,492,76,36,40,3,2

10,120,120,18,18,0,1,0
31,127,127,7,7,0,1,0
7,133,133,25,1,24,4,3
3,143,143,6,6,0,1,0
27,147,147,18,18,0,1,0
20,157,157,40,40,0,1,0
11,168,168,3,3,0,1,0
21,169,169,17,17,0,1,0
29,195,195,5,5,0,1,0
35,200,200,11,2,9,4,3
28,203,203,12,12,0,1,0
4,218,218,5,5,0,1,0
15,221,221,44,8,36,3,2
26,227,227,31,17,14,2,1
18,232,232,11,11,0,1,0
36,247,247,33,3,30,4,3
5,255,255,6,3,3,2,1
1,259,259,26,11,15,2,1
14,303,303,21,21,0,1,0
6,354,354,12,12,0,1,0
25,355,355,15,15,0,1,0
16,358,358,5,2,3,2,1
0,369,369,27,27,0,1,0
33,383,383,46,46,0,1,0
30,395,395,32,16,16,2,1
17,400,400,18,8,10,2,1
23,428,428,68,38,30,3,2
32,429,429,115,43,72,4,3
24,432,432,100,62,38,3,2
8,438,438,9,1,8,2,1
22,440,440,9,3,6,2,1
2,451,451,9,2,7,2,1
19,467,467,14,14,0,1,0
12,467,467,75,34,41,2,1
13,475,475,40,40,0,1,0
9,495,495,3,3,0,1,0
34,496,496,14,4,10,2,1

9,112,112,17,17,0,1,0
22,133,133,13,13,0,1,0
32,135,135,3,3,0,1,0
34,155,155,44,30,14,2,1
19,160,160,3,3,0,1,0
17,169,169,40,30,10,2,1
23,176,176,13,5,8,2,1
3,177,177,2,2,0,1,0
25,185,185,31,7,24,2,1
0,206,206,1,1,0,1,0
5,216,216,4,4,0,1,0
18,222,222,46,12,34,2,1
16,235,235,2,2,0,1,0
1,244,244,1,1,0,1,0
14,249,249,17,17,0,1,0
28,252,252,54,42,12,3,2
8,263,263,32,32,0,1,0
30,271,271,2,2,0,1,0
33,282,282,1,1,0,1,0
13,284,284,6,6,0,1,0
10,295,295,5,1,4,2,1
11,306,306,3,3,0,1,0
7,306,306,36,5,31,2,1
6,322,322,22,13,9,4,3
4,350,350,160,65,95,4,3
27,350,350,63,63,0,1,0
21,379,379,31,12,19,2,1
26,394,394,16,16,0,1,0
15,410,410,10,10,0,1,0
12,428,428,10,10,0,1,0
29,431,431,136,61,75,4,3
20,452,452,20,20,0,1,0
24,476,476,40,40,0,1,0
2,486,486,15,15,0,1,0
31,496,496,2,2,0,1,0

14,103,103,1,1,0,1,0
22,104,104,1,1,0,1,0
24,115,115,1,1,0,1,0
10,124,124,17,4,13,2,1
7,128,128,1,1,0,1,0
17,132,132,2,2,0,1,0
6,133,133,8,4,4,2,1
30,156,156,5,1,4,2,1
11,189,189,3,3,0,1,0
4,209,209,58,18,40,3,2
20,215,215,21,21,0,1,0
31,236,236,63,63,0,1,0
15,241,241,4,4,0,1,0
26,262,262,12,6,6,2,1
32,265,265,2,2,0,1,0
29,298,298,4,4,0,1,0
8,306,306,64,4,60,3,2
23,342,342,34,6,28,2,1
9,345,345,73,7,66,3,2
25,352,352,35,21,14,2,1
19,354,354,40,40,0,1,0
0,356,356,17,17,0,1,0
28,356,356,124,13,111,4,3
3,370,370,31,22,9,4,3
27,391,391,60,8,52,3,2
16,393,393,32,32,0,1,0
1,393,393,1,1,0,1,0
5,414,414,74,74,0,1,0
21,420,420,120,9,111,4,3
13,429,429,93,3,90,4,3
2,452,452,14,14,0,1,0
18,454,454,20,20,0,1,0
12,469,469,6,6,0,1,0

11,130,130,33,19,14,2,1
3,135,135,29,14,15,2,1
7,146,146,17,17,0,1,0
1,154,154,7,7,0,1,0
12,159,159,44,28,16,2,1
4,168,168,1,1,0,1,0
8,168,168,1,1,0,1,0
18,169,169,4,4,0,1,0
28,171,171,33,33,0,1,0
27,190,190,22,22,0,1,0
21,223,223,29,20,9,4,3
20,224,224,21,9,12,2,1
13,226,226,19,7,12,4,3
16,228,228,29,22,7,2,1
23,255,255,1,1,0,1,0
29,265,265,11,11,0,1,0
24,287,287,23,23,0,1,0
9,288,288,47,47,0,1,0
6,305,305,3,3,0,1,0
26,336,336,90,6,84,3,2
22,381,381,111,111,0,1,0
30,390,390,1,1,0,1,0
17,391,391,61,6,55,4,3
0,396,396,9,9,0,1,0
14,401,401,8,3,5,2,1
25,403,403,32,32,0,1,0
5,413,413,48,48,0,1,0
15,424,424,8,8,0,1,0
10,434,434,51,51,0,1,0
2,456,456,68,68,0,1,0
19,461,461,3,3,0,1,0

3,126,126,11,11,0,1,0
8,133,133,2,2,0,1,0
27,137,137,12,6,6,2,1
25,138,138,19,19,0,1,0
16,156,156,2,2,0,1,0
0,191,191,19,19,0,1,0
28,192,192,8,8,0,1,0
29,204,204,48,31,17,2,1
21,218,218,19,7,12,3,2
37,226,226,30,30,0,1,0
11,228,228,7,7,0,1,0
14,240,240,11,3,8,3,2
4,251,251,49,49,0,1,0
13,259,259,4,4,0,1,0
2,263,263,43,43,0,1,0
26,307,307,7,7,0,1,0
9,312,312,10,10,0,1,0
7,314,314,5,5,0,1,0
22,322,322,13,2,11,2,1
1,324,324,1,1,0,1,0
32,333,333,41,17,24,4,3
15,344,344,123,123,0,1,0
5,350,350,9,9,0,1,0
33,358,358,58,16,42,4,3
34,362,362,26,16,10,2,1
31,368,368,5,5,0,1,0
39,375,375,81,42,39,2,1
10,375,375,57,57,0,1,0
20,379,379,35,17,18,2,1
17,379,379,3,3,0,1,0
19,419,419,5,5,0,1,0
38,428,428,30,12,18,3,2
12,431,431,33,15,18,3,2
18,452,452,3,3,0,1,0
6,453,453,3,3,0,1,0
30,462,462,22,22,0,1,0
24,463,463,22,22,0,1,0
23,475,475,9,9,0,1,0
35,485,485,71,56,15,2,1
36,490,490,39,14,25,2,1

21,108,108,21,21,0,1,0
12,110,110,6,1,5,2,1
1,112,112,62,26,36,4,3
11,129,129,33,33,0,1,0
29,158,158,14,14,0,1,0
18,180,180,11,11,0,1,0
19,186,186,27,27,0,1,0
4,202,202,3,3,0,1,0
22,204,204,44,6,38,2,1
10,207,207,18,18,0,1,0
14,219,219,4,4,0,1,0
15,226,226,13,1,12,4,3
20,230,230,28,5,23,2,1
8,242,242,36,12,24,3,2
6,243,243,14,14,0,1,0
0,275,275,21,7,14,2,1
23,280,280,12,12,0,1,0
16,292,292,6,3,3,2,1
2,295,295,18,18,0,1,0
7,332,332,46,46,0,1,0
24,353,353,55,40,15,2,1
25,368,368,25,5,20,2,1
26,375,375,152,96,56,3,2
17,399,399,5,5,0,1,0
27,405,405,11,11,0,1,0
9,406,406,2,2,0,1,0
5,415,415,17,2,15,4,3
3,447,447,21,21,0,1,0
28,455,455,3,3,0,1,0
13,484,484,29,3,26,2,1

10,101,101,5,5,0,1,0
17,124,124,32,13,19,4,3
2,131,131,21,2,19,2,1
21,157,157,17,17,0,1,0
19,161,161,3,3,0,1,0
24,163,163,32,7,25,2,1
5,177,177,53,47,6,3,2
6,205,205,19,3,16,2,1
0,209,209,20,20,0,1,0
13,219,219,8,8,0,1,0
25,248,248,3,3,0,1,0
7,269,269,45,45,0,1,0
22,281,281,18,18,0,1,0
8,299,299,31,25,6,3,2
4,328,328,17,8,9,4,3
23,380,380,16,6,10,3,2
14,382,382,3,3,0,1,0
15,394,394,18,18,0,1,0
16,398,398,24,15,9,2,1
18,409,409,135,99,36,2,1
3,424,424,36,4,32,3,2
1,429,429,55,55,0,1,0
12,443,443,90,1,89,4,3
20,454,454,75,30,45,2,1
9,478,478,199,161,38,3,2
11,489,489,16,16,0,1,0

6,104,104,4,4,0,1,0
11,104,104,23,23,0,1,0
1,120,120,2,2,0,1,0
2,122,122,12,2,10,3,2
26,130,130,10,4,6,2,1
21,131,131,2,2,0,1,0
30,133,133,6,6,0,1,0
18,133,133,31,31,0,1,0
17,137,137,7,2,5,2,1
19,147,147,18,18,0,1,0
5,209,209,28,18,10,3,2
23,240,240,56,52,4,2,1
0,244,244,41,41,0,1,0
9,259,259,28,28,0,1,0
22,264,264,12,3,9,4,3
20,273,273,38,38,0,1,0
7,306,306,14,14,0,1,0
14,329,329,8,8,0,1,0
15,330,330,52,23,29,2,1
29,338,338,51,51,0,1,0
4,352,352,23,13,10,3,2
10,356,356,27,18,9,4,3
8,378,378,9,3,6,3,2
13,403,403,68,68,0,1,0
16,411,411,81,11,70,4,3
12,419,419,10,4,6,2,1
3,430,430,167,129,38,3,2
24,430,430,10,10,0,1,0
25,432,432,50,16,34,2,1
28,456,456,4,4,0,1,0
27,471,471,7,2,5,2,1

0,107,107,6,2,4,2,1
13,121,121,11,1,10,2,1
4,127,127,1,1,0,1,0
28,149,149,22,12,10,3,2
5,156,156,1,1,0,1,0
29,157,157,3,3,0,1,0
7,162,162,1,1,0,1,0
1,173,173,6,6,0,1,0
6,178,178,16,4,12,2,1
18,180,180,25,21,4,2,1
8,185,185,37,37,0,1,0
12,200,200,10,10,0,1,0
22,212,212,1,1,0,1,0
17,222,222,10,10,0,1,0
25,236,236,4,4,0,1,0
9,250,250,60,10,50,2,1
3,253,253,45,45,0,1,0
23,262,262,40,40,0,1,0
19,272,272,11,7,4,2,1
30,281,281,81,47,34,2,1
24,305,305,62,62,0,1,0
16,322,322,13,1,12,2,1
21,323,323,31,27,4,2,1
11,323,323,129,59,70,4,3
10,328,328,12,12,0,1,0
14,346,346,4,4,0,1,0
15,367,367,48,48,0,1,0
32,371,371,42,42,0,1,0
20,386,386,9,9,0,1,0
31,478,478,13,5,8,2,1
27,482,482,70,70,0,1,0
26,488,488,78,9,69,4,3
2,499,499,12,12,0,1,0

16,109,109,10,10,0,1,0
20,114,114,4,1,3,2,1
13,131,131,27,21,6,3,2
24,152,152,2,2,0,1,0
27,175,175,14,14,0,1,0
21,221,221,77,51,26,3,2
5,231,231,8,4,4,2,1
28,250,250,9,9,0,1,0
8,270,270,26,26,0,1,0
17,278,278,26,26,0,1,0
9,283,283,25,25,0,1,0
10,300,300,12,2,10,2,1
4,320,320,126,126,0,1,0
3,338,338,16,1,15,2,1
14,342,342,20,20,0,1,0
11,352,352,11,11,0,1,0
18,383,383,22,22,0,1,0
23,385,385,56,23,33,3,2
7,390,390,255,144,111,4,3
26,426,426,84,56,28,2,1
12,436,436,14,8,6,3,2
25,436,436,57,1,56,3,2
2,437,437,1,1,0,1,0
19,440,440,5,5,0,1,0
0,457,457,9,2,7,2,1
15,460,460,22,10,12,3,2
22,475,475,45,45,0,1,0
6,478,478,26,26,0,1,0
1,482,482,52,52,0,1,0

8,104,104,18,10,8,2,1
11,105,105,1,1,0,1,0
9,132,132,16,16,0,1,0
4,161,161,6,6,0,1,0
28,174,174,18,2,16,2,1
1,182,182,36,18,18,3,2
14,184,184,6,6,0,1,0
32,187,187,4,4,0,1,0
18,207,207,9,9,0,1,0
10,216,216,53,5,48,3,2
12,244,244,1,1,0,1,0
21,264,264,54,15,39,4,3
31,295,295,34,1,33,4,3
6,309,309,4,4,0,1,0
3,315,315,29,29,0,1,0
30,328,328,22,10,12,2,1
2,342,342,77,77,0,1,0
29,358,358,20,20,0,1,0
25,362,362,6,2,4,2,1
5,363,363,17,8,9,2,1
27,366,366,57,21,36,4,3
13,379,379,8,8,0,1,0
24,395,395,3,3,0,1,0
23,395,395,23,10,13,2,1
26,399,399,174,30,144,4,3
0,400,400,8,8,0,1,0
22,415,415,41,41,0,1,0
15,425,425,26,26,0,1,0
17,430,430,30,2,28,3,2
19,468,468,43,43,0,1,0
16,482,482,74,74,0,1,0
20,484,484,35,24,11,2,1
7,491,491,72,72,0,1,0

8,101,101,10,1,9,4,3
33,101,101,10,6,4,2,1
25,112,112,2,2,0,1,0
18,115,115,4,4,0,1,0
28,122,122,11,11,0,1,0
5,129,129,6,6,0,1,0
6,132,132,14,7,7,2,1
23,137,137,1,1,0,1,0
4,143,143,12,8,4,2,1
11,146,146,3,3,0,1,0
12,152,152,7,7,0,1,0
16,166,166,1,1,0,1,0
15,166,166,3,3,0,1,0
21,175,175,1,1,0,1,0
17,178,178,22,22,0,1,0
24,183,183,33,33,0,1,0
2,230,230,17,7,10,2,1
3,234,234,5,5,0,1,0
22,237,237,5,5,0,1,0
30,242,242,33,33,0,1,0
0,247,247,61,61,0,1,0
37,264,264,56,22,34,2,1
14,264,264,42,42,0,1,0
13,276,276,45,45,0,1,0
31,280,280,17,17,0,1,0
27,287,287,175,117,58,3,2
19,317,317,51,44,7,2,1
32,317,317,1,1,0,1,0
29,326,326,17,5,12,3,2
36,327,327,22,6,16,3,2
10,340,340,22,22,0,1,0
1,355,355,17,17,0,1,0
34,393,393,10,10,0,1,0
20,395,395,2,2,0,1,0
9,409,409,1,1,0,1,0
26,440,440,2,2,0,1,0
35,441,441,22,16,6,3,2
7,482,482,32,32,0,1,0

10,107,107,15,15,0,1,0
22,108,108,7,7,0,1,0
4,119,119,1,1,0,1,0
26,122,122,37,37,0,1,0
30,137,137,3,3,0,1,0
25,183,183,9,1,8,2,1
14,199,199,20,20,0,1,0
37,219,219,47,28,19,2,1
16,231,231,7,4,3,2,1
31,246,246,17,8,9,2,1
9,251,251,16,16,0,1,0
18,255,255,1,1,0,1,0
36,259,259,14,5,9,2,1
19,275,275,22,6,16,2,1
20,287,287,2,2,0,1,0
24,300,300,4,4,0,1,0
2,308,308,63,16,47,2,1
29,322,322,24,24,0,1,0
21,335,335,50,42,8,3,2
32,339,339,62,25,37,2,1
15,342,342,23,23,0,1,0
28,342,342,71,5,66,4,3
34,344,344,16,7,9,2,1
17,348,348,6,1,5,2,1
5,352,352,116,98,18,4,3
3,360,360,36,9,27,4,3
7,372,372,8,8,0,1,0
0,373,373,11,11,0,1,0
6,382,382,7,3,4,2,1
1,407,407,20,20,0,1,0
8,421,421,10,2,8,2,1
27,426,426,103,7,96,4,3
33,432,432,6,2,4,2,1
35,433,433,22,13,9,2,1
13,474,474,15,1,14,3,2
23,476,476,11,6,5,2,1
11,480,480,26,6,20,2,1
12,482,482,34,25,9,4,3

16,107,107,9,9,0,1,0
26,130,130,14,14,0,1,0
6,164,164,5,5,0,1,0
20,169,169,60,60,0,1,0
30,178,178,2,2,0,1,0
13,183,183,31,31,0,1,0
9,191,191,5,5,0,1,0
3,203,203,42,42,0,1,0
11,224,224,19,19,0,1,0
12,224,224,25,1,24,2,1
7,226,226,56,32,24,3,2
5,243,243,9,9,0,1,0
23,262,262,14,8,6,2,1
22,277,277,9,9,0,1,0
21,288,288,9,9,0,1,0
4,298,298,6,6,0,1,0
15,312,312,77,77,0,1,0
10,317,317,2,2,0,1,0
17,321,321,2,2,0,1,0
27,322,322,37,12,25,3,2
25,361,361,31,15,16,2,1
14,367,367,41,41,0,1,0
19,382,382,113,36,77,4,3
29,401,401,28,28,0,1,0
18,412,412,40,21,19,2,1
8,430,430,101,74,27,4,3
1,435,435,98,98,0,1,0
24,454,454,11,11,0,1,0
0,471,471,30,4,26,4,3
28,486,486,9,9,0,1,0
2,500,500,13,8,5,2,1

16,114,114,7,3,4,2,1
10,131,131,18,18,0,1,0
11,165,165,7,7,0,1,0
14,172,172,6,2,4,2,1
9,178,178,21,21,0,1,0
18,181,181,2,2,0,1,0
3,186,186,8,8,0,1,0
7,207,207,22,22,0,1,0
2,228,228,1,1,0,1,0
21,237,237,18,1,17,2,1
27,254,254,6,6,0,1,0
26,256,256,25,1,24,3,2
23,274,274,9,9,0,1,0
24,292,292,95,17,78,3,2
25,292,292,45,45,0,1,0
15,331,331,31,19,12,3,2
0,344,344,27,27,0,1,0
8,356,356,203,150,53,4,3
19,365,365,24,24,0,1,0
17,403,403,49,49,0,1,0
20,404,404,63,63,0,1,0
13,410,410,47,47,0,1,0
6,432,432,22,2,20,3,2
4,436,436,58,58,0,1,0
22,441,441,92,16,76,3,2
5,459,459,114,36,78,4,3
1,459,459,32,12,20,2,1
12,494,494,25,25,0,1,0

12,104,104,1,1,0,1,0
13,113,113,30,30,0,1,0
11,115,115,2,2,0,1,0
23,118,118,6,6,0,1,0
5,164,164,2,2,0,1,0
15,167,167,16,11,5,2,1
9,169,169,25,25,0,1,0
22,175,175,38,38,0,1,0
19,178,178,15,15,0,1,0
21,192,192,2,2,0,1,0
30,196,196,23,8,15,2,1
16,205,205,17,12,5,2,1
2,220,220,12,3,9,4,3
1,237,237,55,6,49,4,3
6,285,285,11,11,0,1,0
25,286,286,2,2,0,1,0
28,288,288,53,53,0,1,0
27,293,293,13,1,12,4,3
7,307,307,28,28,0,1,0
10,316,316,2,2,0,1,0
26,341,341,6,3,3,2,1
20,352,352,1,1,0,1,0
29,379,379,46,46,0,1,0
17,400,400,92,32,60,4,3
3,416,416,28,28,0,1,0
0,423,423,107,107,0,1,0
4,445,445,83,71,12,4,3
18,470,470,52,52,0,1,0
14,491,491,80,4,76,3,2
8,495,495,28,28,0,1,0
24,496,496,130,130,0,1,0

4,109,109,10,10,0,1,0
22,131,131,19,19,0,1,0
15,170,170,31,31,0,1,0
2,175,175,6,6,0,1,0
16,178,178,19,7,12,2,1
13,181,181,49,1,48,4,3
14,186,186,24,12,12,2,1
25,192,192,19,1,18,3,2
27,196,196,9,1,8,2,1
7,207,207,14,14,0,1,0
1,211,211,27,3,24,2,1
8,213,213,13,1,12,2,1
10,221,221,61,11,50,3,2
23,223,223,2,2,0,1,0
9,244,244,6,6,0,1,0
6,253,253,28,2,26,3,2
5,258,258,2,2,0,1,0
21,275,275,11,11,0,1,0
24,279,279,28,28,0,1,0
18,288,288,4,4,0,1,0
19,341,341,18,18,0,1,0
11,361,361,95,74,21,4,3
12,410,410,19,9,10,4,3
26,432,432,62,6,56,4,3
0,437,437,86,86,0,1,0
17,440,440,65,28,37,3,2
28,482,482,66,66,0,1,0
3,487,487,143,11,132,4,3
20,496,496,2,2,0,1,0

15,107,107,1,1,0,1,0
30,110,110,12,1,11,3,2
18,114,114,10,10,0,1,0
2,118,118,16,7,9,2,1
37,123,123,16,4,12,4,3
7,143,143,12,3,9,2,1
5,145,145,12,5,7,2,1
33,152,152,34,34,0,1,0
3,169,169,5,2,3,2,1
24,171,171,26,4,22,3,2
22,203,203,8,8,0,1,0
10,214,214,14,14,0,1,0
13,222,222,15,15,0,1,0
21,224,224,2,2,0,1,0
27,230,230,64,64,0,1,0
6,230,230,9,1,8,3,2
19,235,235,17,17,0,1,0
1,243,243,2,2,0,1,0
23,246,246,23,5,18,3,2
20,298,298,27,14,13,2,1
36,303,303,7,7,0,1,0
38,304,304,26,14,12,3,2
0,305,305,64,64,0,1,0
11,307,307,1,1,0,1,0
12,313,313,43,9,34,4,3
39,319,319,55,26,29,4,3
29,320,320,12,12,0,1,0
14,337,337,44,44,0,1,0
4,356,356,3,3,0,1,0
35,361,361,1,1,0,1,0
16,377,377,31,31,0,1,0
28,417,417,59,13,46,4,3
31,428,428,5,2,3,2,1
34,433,433,21,8,13,2,1
25,446,446,26,26,0,1,0
26,455,455,41,41,0,1,0
32,462,462,31,31,0,1,0
8,473,473,22,22,0,1,0
17,485,485,6,6,0,1,0
9,500,500,29,29,0,1,0

10,102,102,10,1,9,2,1
29,105,105,5,5,0,1,0
1,124,124,32,26,6,3,2
26,133,133,18,18,0,1,0
17,141,141,21,7,14,2,1
23,170,170,17,1,16,4,3
28,176,176,7,7,0,1,0
4,197,197,41,41,0,1,0
8,197,197,14,14,0,1,0
15,206,206,2,2,0,1,0
30,218,218,1,1,0,1,0
0,277,277,1,1,0,1,0
2,288,288,11,11,0,1,0
25,301,301,9,9,0,1,0
12,314,314,18,18,0,1,0
21,336,336,21,21,0,1,0
13,341,341,35,35,0,1,0
24,343,343,28,19,9,2,1
9,363,363,6,2,4,2,1
20,380,380,40,40,0,1,0
22,386,386,20,20,0,1,0
19,401,401,13,13,0,1,0
6,405,405,29,29,0,1,0
7,409,409,69,69,0,1,0
16,410,410,269,228,41,3,2
5,413,413,61,23,38,2,1
27,443,443,8,1,7,2,1
11,448,448,27,13,14,2,1
14,455,455,65,65,0,1,0
18,457,457,51,51,0,1,0
3,459,459,72,72,0,1,0

20,132,132,4,4,0,1,0
9,143,143,11,8,3,2,1
13,196,196,36,36,0,1,0
28,197,197,15,15,0,1,0
27,201,201,4,4,0,1,0
14,206,206,31,22,9,4,3
12,211,211,78,57,21,4,3
0,222,222,24,24,0,1,0
25,226,226,55,9,46,3,2
21,247,247,12,4,8,2,1
22,257,257,6,3,3,2,1
2,259,259,36,26,10,2,1
26,301,301,70,56,14,2,1
23,310,310,10,2,8,3,2
1,320,320,6,6,0,1,0
8,321,321,44,44,0,1,0
10,338,338,19,19,0,1,0
24,345,345,100,100,0,1,0
4,356,356,110,110,0,1,0
18,366,366,48,4,44,4,3
17,375,375,2,2,0,1,0
16,387,387,21,14,7,2,1
5,399,399,11,11,0,1,0
7,417,417,9,9,0,1,0
3,417,417,10,5,5,2,1
15,429,429,17,17,0,1,0
6,436,436,113,113,0,1,0
19,446,446,31,31,0,1,0
11,480,480,27,27,0,1,0

26,119,119,5,5,0,1,0
8,132,132,1,1,0,1,0
13,149,149,3,3,0,1,0
7,175,175,53,37,16,3,2
30,191,191,18,1,17,3,2
31,193,193,2,2,0,1,0
5,211,211,9,5,4,2,1
29,214,214,10,1,9,2,1
12,232,232,6,1,5,2,1
14,248,248,33,2,31,3,2
16,249,249,21,21,0,1,0
23,251,251,46,46,0,1,0
28,258,258,127,41,86,3,2
34,258,258,8,4,4,2,1
22,277,277,59,19,40,3,2
20,294,294,35,35,0,1,0
15,302,302,36,27,9,2,1
35,314,314,84,24,60,3,2
25,315,315,6,1,5,2,1
10,339,339,16,16,0,1,0
27,346,346,27,27,0,1,0
11,362,362,38,35,3,2,1
1,366,366,54,6,48,4,3
19,390,390,18,7,11,2,1
3,408,408,6,6,0,1,0
4,413,413,48,33,15,2,1
0,428,428,17,17,0,1,0
9,435,435,2,2,0,1,0
18,444,444,6,6,0,1,0
21,449,449,18,3,15,2,1
33,458,458,16,16,0,1,0
36,460,460,14,2,12,2,1
24,462,462,6,3,3,2,1
32,466,466,18,9,9,4,3
6,484,484,66,38,28,2,1
2,490,490,35,35,0,1,0
17,496,496,3,3,0,1,0

1,110,110,6,6,0,1,0
11,131,131,53,35,18,2,1
23,143,143,4,4,0,1,0
17,147,147,3,3,0,1,0
15,163,163,12,12,0,1,0
16,170,170,7,3,4,2,1
30,177,177,44,44,0,1,0
29,179,179,65,65,0,1,0
2,188,188,6,6,0,1,0
34,194,194,9,9,0,1,0
32,199,199,2,2,0,1,0
27,208,208,21,1,20,3,2
4,213,213,15,7,8,3,2
8,233,233,13,7,6,2,1
33,240,240,1,1,0,1,0
7,241,241,29,29,0,1,0
13,251,251,1,1,0,1,0
6,265,265,8,2,6,3,2
12,283,283,13,13,0,1,0
20,327,327,5,5,0,1,0
24,327,327,22,22,0,1,0
14,333,333,12,12,0,1,0
22,338,338,97,97,0,1,0
25,339,339,5,5,0,1,0
10,345,345,11,2,9,4,3
26,349,349,46,46,0,1,0
28,363,363,20,2,18,2,1
9,406,406,77,77,0,1,0
5,414,414,39,39,0,1,0
31,427,427,72,38,34,2,1
18,429,429,37,15,22,3,2
3,437,437,35,5,30,4,3
21,447,447,4,4,0,1,0
19,465,465,34,23,11,2,1
0,489,489,64,64,0,1,0

31,103,103,17,17,0,1,0
21,107,107,4,4,0,1,0
1,108,108,1,1,0,1,0
12,145,145,1,1,0,1,0
17,147,147,49,22,27,2,1
27,148,148,17,17,0,1,0
29,162,162,10,7,3,2,1
0,171,171,5,2,3,2,1
20,179,179,1,1,0,1,0
38,200,200,1,1,0,1,0
4,246,246,7,1,6,2,1
26,247,247,12,12,0,1,0
34,250,250,24,10,14,3,2
30,261,261,11,3,8,3,2
3,262,262,32,32,0,1,0
14,275,275,25,25,0,1,0
22,278,278,11,11,0,1,0
11,282,282,5,1,4,2,1
9,283,283,5,5,0,1,0
6,295,295,24,15,9,2,1
37,318,318,65,28,37,2,1
5,319,319,14,14,0,1,0
39,320,320,37,10,27,2,1
13,343,343,51,7,44,3,2
25,357,357,32,32,0,1,0
33,361,361,4,4,0,1,0
7,375,375,44,7,37,2,1
18,384,384,8,5,3,2,1
36,384,384,81,51,30,4,3
28,390,390,15,2,13,2,1
8,396,396,7,7,0,1,0
15,410,410,21,14,7,2,1
16,432,432,38,38,0,1,0
10,449,449,68,68,0,1,0
24,462,462,138,138,0,1,0
23,468,468,35,35,0,1,0
32,472,472,33,33,0,1,0
19,473,473,14,14,0,1,0
35,493,493,29,29,0,1,0
2,498,498,19,19,0,1,0

16,111,111,13,3,10,2,1
7,158,158,4,1,3,2,1
10,161,161,14,8,6,2,1
18,183,183,17,17,0,1,0
24,188,188,21,18,3,2,1
6,189,189,36,28,8,2,1
12,199,199,15,1,14,4,3
13,248,248,15,15,0,1,0
20,280,280,22,2,20,2,1
21,290,290,16,16,0,1,0
0,307,307,42,20,22,3,2
3,311,311,19,13,6,3,2
5,314,314,48,48,0,1,0
14,331,331,15,15,0,1,0
9,334,334,160,160,0,1,0
8,342,342,44,44,0,1,0
19,365,365,12,6,6,2,1
25,373,373,102,79,23,4,3
22,377,377,13,4,9,2,1
15,387,387,82,30,52,3,2
1,401,401,84,84,0,1,0
4,429,429,17,17,0,1,0
27,457,457,23,1,22,2,1
11,470,470,7,7,0,1,0
2,478,478,1,1,0,1,0
28,478,478,17,12,5,2,1
23,479,479,9,1,8,3,2
26,494,494,34,8,26,2,1
17,497,497,167,89,78,4,3

17,112,112,8,8,0,1,0
11,124,124,2,2,0,1,0
25,125,125,35,35,0,1,0
7,126,126,6,1,5,2,1
1,144,144,10,1,9,2,1
5,158,158,42,28,14,2,1
28,165,165,12,12,0,1,0
14,172,172,1,1,0,1,0
22,174,174,30,30,0,1,0
29,176,176,12,12,0,1,0
3,201,201,22,9,13,2,1
15,205,205,14,2,12,3,2
4,238,238,68,32,36,2,1
31,241,241,18,18,0,1,0
10,244,244,41,25,16,4,3
23,246,246,9,3,6,3,2
12,266,266,41,22,19,4,3
30,313,313,34,10,24,3,2
0,349,349,17,1,16,4,3
20,352,352,81,37,44,2,1
24,362,362,88,22,66,3,2
26,389,389,1,1,0,1,0
9,404,404,38,16,22,2,1
8,406,406,49,49,0,1,0
27,436,436,8,8,0,1,0
19,437,437,49,15,34,2,1
2,439,439,8,8,0,1,0
21,452,452,6,6,0,1,0
6,460,460,3,3,0,1,0
16,462,462,29,15,14,3,2
13,475,475,59,59,0,1,0
18,480,480,33,33,0,1,0

34,107,107,29,29,0,1,0
7,119,119,17,9,8,3,2
35,127,127,7,3,4,2,1
9,137,137,3,3,0,1,0
36,147,147,5,5,0,1,0
23,179,179,4,1,3,2,1
24,182,182,13,1,12,3,2
29,197,197,10,2,8,3,2
33,203,203,19,1,18,4,3
0,210,210,11,7,4,2,1
26,232,232,12,12,0,1,0
3,232,232,32,32,0,1,0
13,235,235,46,37,9,4,3
30,238,238,20,20,0,1,0
27,257,257,1,1,0,1,0
31,265,265,53,10,43,2,1
11,280,280,1,1,0,1,0
20,293,293,16,9,7,2,1
2,295,295,12,12,0,1,0
16,299,299,33,11,22,2,1
32,301,301,62,62,0,1,0
15,332,332,30,30,0,1,0
25,337,337,59,59,0,1,0
37,354,354,62,62,0,1,0
1,363,363,12,12,0,1,0
8,371,371,15,15,0,1,0
5,388,388,15,6,9,4,3
6,397,397,1,1,0,1,0
12,406,406,45,26,19,2,1
17,432,432,15,15,0,1,0
14,433,433,44,32,12,3,2
18,437,437,20,5,15,2,1
28,447,447,30,14,16,2,1
21,454,454,44,44,0,1,0
10,468,468,13,13,0,1,0
4,476,476,6,6,0,1,0
22,495,495,33,33,0,1,0
19,499,499,103,43,60,3,2

6,108,108,10,10,0,1,0
8,118,118,6,2,4,2,1
13,155,155,7,7,0,1,0
2,179,179,66,12,54,4,3
20,198,198,32,32,0,1,0
0,203,203,14,4,10,2,1
18,209,209,29,11,18,3,2
21,225,225,29,29,0,1,0
3,235,235,44,40,4,2,1
19,236,236,99,52,47,2,1
16,257,257,8,8,0,1,0
14,284,284,2,2,0,1,0
9,313,313,16,8,8,2,1
5,339,339,154,154,0,1,0
15,348,348,1,1,0,1,0
4,350,350,26,26,0,1,0
1,380,380,170,136,34,3,2
12,389,389,53,21,32,3,2
10,396,396,11,3,8,2,1
11,396,396,25,9,16,2,1
7,398,398,2,2,0,1,0
17,468,468,127,84,43,2,1

25,117,117,31,31,0,1,0
13,135,135,27,27,0,1,0
4,144,144,11,4,7,2,1
1,147,147,9,1,8,3,2
10,184,184,14,8,6,3,2
19,200,200,45,45,0,1,0
6,202,202,34,34,0,1,0
3,239,239,31,31,0,1,0
12,243,243,55,31,24,4,3
18,245,245,1,1,0,1,0
27,248,248,18,6,12,2,1
16,252,252,15,15,0,1,0
26,257,257,24,24,0,1,0
20,262,262,21,1,20,4,3
5,266,266,16,16,0,1,0
9,295,295,13,4,9,2,1
24,297,297,56,56,0,1,0
8,308,308,39,39,0,1,0
14,324,324,44,20,24,3,2
29,333,333,46,46,0,1,0
31,338,338,39,39,0,1,0
21,340,340,60,60,0,1,0
15,382,382,39,39,0,1,0
22,387,387,14,14,0,1,0
23,392,392,47,47,0,1,0
28,397,397,6,3,3,2,1
17,407,407,15,15,0,1,0
11,434,434,11,3,8,2,1
30,443,443,4,1,3,2,1
7,443,443,38,27,11,2,1
2,476,476,3,3,0,1,0
0,486,486,38,24,14,2,1

26,101,101,8,8,0,1,0
15,101,101,2,2,0,1,0
11,111,111,38,38,0,1,0
18,114,114,2,2,0,1,0
0,119,119,5,5,0,1,0
13,125,125,7,7,0,1,0
17,174,174,10,10,0,1,0
25,177,177,10,10,0,1,0
33,185,185,1,1,0,1,0
10,246,246,15,7,8,2,1
5,253,253,3,3,0,1,0
14,278,278,86,4,82,3,2
4,279,279,1,1,0,1,0
16,286,286,8,8,0,1,0
30,287,287,13,1,12,3,2
20,295,295,50,50,0,1,0
22,306,306,4,1,3,2,1
1,311,311,10,10,0,1,0
28,331,331,96,76,20,2,1
32,337,337,15,15,0,1,0
2,343,343,50,8,42,2,1
9,351,351,24,24,0,1,0
7,354,354,10,3,7,2,1
29,362,362,2,2,0,1,0
27,375,375,121,79,42,3,2
21,382,382,33,15,18,2,1
3,415,415,25,25,0,1,0
24,423,423,7,7,0,1,0
34,449,449,84,41,43,2,1
8,449,449,123,123,0,1,0
6,460,460,14,1,13,2,1
19,479,479,64,28,36,3,2
23,482,482,6,6,0,1,0
31,492,492,75,61,14,3,2
12,496,496,8,8,0,1,0

15,112,112,2,2,0,1,0
16,120,120,12,3,9,2,1
17,122,122,8,1,7,2,1
0,131,131,54,54,0,1,0
24,166,166,21,21,0,1,0
3,178,178,19,5,14,3,2
8,178,178,54,23,31,2,1
11,184,184,6,6,0,1,0
4,204,204,1,1,0,1,0
14,205,205,37,37,0,1,0
5,212,212,16,7,9,2,1
23,237,237,1,1,0,1,0
18,250,250,13,1,12,4,3
12,273,273,69,69,0,1,0
27,281,281,71,17,54,4,3
2,284,284,1,1,0,1,0
21,294,294,8,8,0,1,0
7,298,298,9,3,6,3,2
20,307,307,25,18,7,2,1
29,356,356,13,13,0,1,0
26,359,359,12,4,8,3,2
28,364,364,19,13,6,3,2
22,366,366,24,24,0,1,0
1,368,368,63,63,0,1,0
19,375,375,81,81,0,1,0
10,380,380,2,2,0,1,0
25,387,387,121,30,91,4,3
13,441,441,16,16,0,1,0
9,452,452,53,21,32,3,2
6,484,484,24,2,22,2,1

14,111,111,26,10,16,2,1
18,114,114,14,2,12,2,1
0,129,129,34,34,0,1,0
15,165,165,24,10,14,2,1
17,175,175,7,7,0,1,0
27,187,187,25,11,14,2,1
20,187,187,20,20,0,1,0
8,207,207,1,1,0,1,0
7,243,243,30,30,0,1,0
5,251,251,44,5,39,4,3
4,254,254,22,22,0,1,0
11,272,272,3,3,0,1,0
2,299,299,84,30,54,4,3
12,336,336,67,22,45,4,3
16,381,381,1,1,0,1,0
19,389,389,44,4,40,2,1
23,395,395,84,39,45,4,3
29,424,424,18,3,15,4,3
28,443,443,48,48,0,1,0
24,446,446,18,18,0,1,0
1,447,447,2,2,0,1,0
21,457,457,31,31,0,1,0
26,462,462,18,18,0,1,0
6,472,472,55,55,0,1,0
22,485,485,98,98,0,1,0
13,489,489,13,4,9,4,3
3,492,492,46,46,0,1,0
9,495,495,11,11,0,1,0
10,496,496,96,15,81,4,3
25,500,500,11,2,9,4,3

28,170,170,1,1,0,1,0
21,185,185,6,6,0,1,0
5,185,185,10,10,0,1,0
14,192,192,33,15,18,3,2
25,215,215,23,19,4,2,1
1,221,221,39,21,18,3,2
13,228,228,8,8,0,1,0
0,245,245,9,9,0,1,0
4,253,253,1,1,0,1,0
24,269,269,17,3,14,2,1
30,272,272,48,48,0,1,0
19,304,304,19,16,3,2,1
15,328,328,19,19,0,1,0
27,332,332,43,43,0,1,0
12,353,353,53,5,48,2,1
20,353,353,22,17,5,2,1
31,364,364,7,7,0,1,0
9,385,385,69,3,66,4,3
7,387,387,7,4,3,2,1
18,389,389,127,114,13,2,1
22,398,398,6,1,5,2,1
32,400,400,73,28,45,4,3
11,404,404,52,52,0,1,0
6,408,408,53,34,19,2,1
10,410,410,37,2,35,2,1
29,421,421,103,103,0,1,0
16,443,443,51,29,22,2,1
3,452,452,16,1,15,2,1
23,456,456,58,58,0,1,0
17,463,463,27,27,0,1,0
2,484,484,67,28,39,4,3
26,489,489,5,2,3,2,1
8,491,491,39,9,30,3,2

19,111,111,7,7,0,1,0
21,120,120,1,1,0,1,0
24,121,121,16,16,0,1,0
0,167,167,18,9,9,4,3
16,173,173,6,6,0,1,0
10,179,179,42,42,0,1,0
15,180,180,4,4,0,1,0
2,208,208,3,3,0,1,0
29,210,210,15,15,0,1,0
20,231,231,1,1,0,1,0
11,234,234,10,3,7,2,1
17,242,242,6,6,0,1,0
1,270,270,14,6,8,2,1
32,272,272,21,21,0,1,0
28,284,284,36,8,28,2,1
18,294,294,25,25,0,1,0
8,299,299,13,13,0,1,0
9,323,323,14,14,0,1,0
33,349,349,41,27,14,3,2
12,359,359,4,4,0,1,0
37,371,371,17,17,0,1,0
31,372,372,86,71,15,2,1
26,381,381,45,45,0,1,0
13,382,382,95,65,30,4,3
14,389,389,12,3,9,2,1
27,436,436,1,1,0,1,0
36,437,437,10,3,7,2,1
34,445,445,48,21,27,2,1
7,448,448,52,19,33,4,3
22,458,458,32,28,4,2,1
35,463,463,87,87,0,1,0
25,464,464,20,3,17,2,1
30,473,473,18,18,0,1,0
6,475,475,15,6,9,2,1
23,485,485,113,41,72,4,3
4,494,494,141,65,76,3,2
3,495,495,3,3,0,1,0
5,498,498,46,34,12,2,1

16,102,102,1,1,0,1,0
29,121,121,15,15,0,1,0
19,128,128,55,40,15,4,3
26,153,153,15,15,0,1,0
24,170,170,19,1,18,4,3
32,177,177,38,3,35,2,1
12,188,188,3,3,0,1,0
4,197,197,11,4,7,2,1
21,225,225,24,24,0,1,0
25,241,241,17,6,11,4,3
23,243,243,20,9,11,2,1
5,249,249,4,4,0,1,0
1,252,252,15,7,8,3,2
15,269,269,3,3,0,1,0
9,276,276,35,21,14,3,2
27,284,284,21,5,16,3,2
2,286,286,8,8,0,1,0
11,292,292,46,46,0,1,0
35,295,295,8,8,0,1,0
33,296,296,23,5,18,4,3
6,296,296,13,5,8,2,1
8,304,304,9,2,7,2,1
31,308,308,81,47,34,2,1
14,356,356,65,12,53,3,2
28,363,363,6,6,0,1,0
10,365,365,61,28,33,4,3
7,376,376,8,8,0,1,0
18,404,404,11,2,9,4,3
0,405,405,27,27,0,1,0
20,413,413,29,29,0,1,0
34,417,417,22,22,0,1,0
3,456,456,19,19,0,1,0
17,471,471,23,9,14,2,1
13,478,478,32,32,0,1,0
22,479,479,37,4,33,3,2
30,481,481,83,69,14,3,2

2,106,106,17,5,12,4,3
11,110,110,5,5,0,1,0
17,125,125,3,3,0,1,0
25,130,130,5,1,4,2,1
0,133,133,1,1,0,1,0
6,152,152,1,1,0,1,0
10,152,152,22,22,0,1,0
26,152,152,19,19,0,1,0
15,154,154,5,1,4,2,1
1,164,164,11,6,5,2,1
20,229,229,4,1,3,2,1
33,230,230,41,41,0,1,0
36,261,261,19,19,0,1,0
23,281,281,2,2,0,1,0
4,282,282,1,1,0,1,0
24,321,321,1,1,0,1,0
8,322,322,1,1,0,1,0
16,329,329,4,4,0,1,0
21,344,344,36,7,29,2,1
9,347,347,27,3,24,3,2
27,372,372,14,6,8,3,2
35,386,386,161,95,66,4,3
22,387,387,19,19,0,1,0
31,389,389,20,2,18,2,1
19,395,395,21,21,0,1,0
12,396,396,43,13,30,3,2
7,405,405,145,145,0,1,0
18,408,408,56,56,0,1,0
28,417,417,103,13,90,4,3
13,432,432,15,15,0,1,0
29,454,454,26,26,0,1,0
34,461,461,17,17,0,1,0
14,469,469,80,55,25,2,1
32,474,474,87,63,24,4,3
5,474,474,19,19,0,1,0
3,475,475,46,46,0,1,0
30,489,489,4,4,0,1,0

13,109,109,8,8,0,1,0
16,120,120,2,2,0,1,0
1,171,171,8,8,0,1,0
7,184,184,34,34,0,1,0
17,197,197,21,11,10,3,2
14,213,213,7,7,0,1,0
19,219,219,13,13,0,1,0
23,246,246,32,32,0,1,0
6,248,248,1,1,0,1,0
11,260,260,7,3,4,2,1
27,281,281,8,8,0,1,0
26,284,284,32,32,0,1,0
21,307,307,83,83,0,1,0
9,312,312,4,4,0,1,0
12,315,315,101,89,12,2,1
28,316,316,12,12,0,1,0
31,318,318,21,21,0,1,0
8,326,326,26,17,9,4,3
3,337,337,28,28,0,1,0
29,339,339,24,24,0,1,0
18,345,345,26,4,22,2,1
5,346,346,62,62,0,1,0
25,347,347,25,4,21,4,3
10,353,353,1,1,0,1,0
15,361,361,19,16,3,2,1
20,377,377,167,167,0,1,0
2,416,416,44,30,14,4,3
30,422,422,14,14,0,1,0
4,436,436,56,56,0,1,0
22,449,449,30,16,14,2,1
24,468,468,17,1,16,2,1
0,495,495,133,90,43,3,2

12,110,110,2,2,0,1,0
14,118,118,1,1,0,1,0
8,155,155,23,8,15,2,1
23,170,170,14,9,5,2,1
0,188,188,1,1,0,1,0
31,198,198,13,13,0,1,0
11,202,202,6,6,0,1,0
10,248,248,1,1,0,1,0
15,252,252,23,2,21,3,2
5,267,267,26,12,14,3,2
16,272,272,46,46,0,1,0
17,290,290,26,15,11,2,1
18,291,291,11,8,3,2,1
26,298,298,4,1,3,2,1
13,300,300,19,3,16,3,2
4,322,322,6,6,0,1,0
6,324,324,8,8,0,1,0
21,346,346,8,3,5,2,1
30,348,348,88,88,0,1,0
29,359,359,77,77,0,1,0
1,372,372,24,24,0,1,0
28,373,373,61,61,0,1,0
33,380,380,38,38,0,1,0
3,387,387,14,9,5,2,1
22,393,393,5,2,3,2,1
24,393,393,24,4,20,3,2
20,396,396,38,38,0,1,0
34,398,398,31,5,26,2,1
32,402,402,89,26,63,4,3
7,405,405,13,1,12,3,2
25,432,432,49,49,0,1,0
2,463,463,166,166,0,1,0
9,465,465,142,110,32,3,2
19,467,467,10,1,9,4,3
27,484,484,51,51,0,1,0

27,112,112,1,1,0,1,0
35,121,121,22,10,12,2,1
7,122,122,9,6,3,2,1
5,122,122,1,1,0,1,0
19,126,126,6,2,4,2,1
31,132,132,4,1,3,2,1
26,153,153,15,15,0,1,0
6,162,162,5,2,3,2,1
3,165,165,3,3,0,1,0
32,171,171,6,6,0,1,0
1,181,181,15,1,14,3,2
15,181,181,12,12,0,1,0
4,190,190,13,1,12,4,3
23,203,203,3,3,0,1,0
10,213,213,3,3,0,1,0
24,222,222,13,13,0,1,0
22,262,262,123,123,0,1,0
16,268,268,40,13,27,2,1
14,278,278,3,3,0,1,0
13,303,303,152,128,24,3,2
18,310,310,23,3,20,3,2
33,339,339,29,24,5,2,1
21,343,343,18,18,0,1,0
30,346,346,47,47,0,1,0
2,369,369,3,3,0,1,0
25,370,370,21,11,10,3,2
0,378,378,49,4,45,2,1
34,380,380,45,14,31,2,1
28,381,381,14,14,0,1,0
8,396,396,7,1,6,3,2
11,396,396,1,1,0,1,0
20,417,417,36,18,18,3,2
12,427,427,116,23,93,4,3
9,457,457,12,12,0,1,0
29,485,485,84,43,41,4,3
17,485,485,2,2,0,1,0

28,100,100,8,8,0,1,0
3,106,106,1,1,0,1,0
2,119,119,15,5,10,2,1
22,120,120,12,6,6,3,2
6,127,127,14,2,12,4,3
13,132,132,1,1,0,1,0
15,164,164,16,2,14,2,1
27,177,177,13,13,0,1,0
12,182,182,23,12,11,4,3
0,186,186,24,24,0,1,0
35,221,221,16,16,0,1,0
5,221,221,10,10,0,1,0
4,268,268,11,11,0,1,0
1,281,281,4,4,0,1,0
33,291,291,1,1,0,1,0
7,298,298,21,6,15,4,3
25,307,307,125,125,0,1,0
32,315,315,11,4,7,2,1
17,316,316,65,65,0,1,0
30,319,319,30,30,0,1,0
14,343,343,27,27,0,1,0
11,346,346,6,3,3,2,1
24,366,366,17,17,0,1,0
20,368,368,65,65,0,1,0
10,377,377,1,1,0,1,0
18,384,384,37,37,0,1,0
19,385,385,102,102,0,1,0
8,401,401,34,28,6,3,2
29,409,409,16,10,6,2,1
23,412,412,49,39,10,2,1
16,448,448,29,26,3,2,1
31,452,452,11,11,0,1,0
21,459,459,98,14,84,3,2
26,465,465,38,5,33,2,1
34,494,494,32,5,27,2,1
9,497,497,4,4,0,1,0

17,115,115,4,4,0,1,0
31,136,136,2,2,0,1,0
14,140,140,1,1,0,1,0
0,145,145,2,2,0,1,0
28,156,156,29,29,0,1,0
19,162,162,2,2,0,1,0
20,164,164,4,4,0,1,0
1,167,167,20,20,0,1,0
12,194,194,7,7,0,1,0
24,204,204,3,3,0,1,0
25,213,213,2,2,0,1,0
30,222,222,4,4,0,1,0
21,222,222,68,68,0,1,0
26,225,225,48,4,44,2,1
6,235,235,66,40,26,2,1
8,241,241,10,10,0,1,0
29,270,270,23,23,0,1,0
9,273,273,14,14,0,1,0
18,283,283,3,3,0,1,0
4,292,292,16,1,15,2,1
11,303,303,50,38,12,4,3
16,315,315,58,9,49,2,1
15,344,344,91,19,72,4,3
2,353,353,114,114,0,1,0
10,373,373,1,1,0,1,0
23,419,419,30,30,0,1,0
13,451,451,10,4,6,2,1
27,453,453,131,125,6,2,1
3,454,454,91,91,0,1,0
7,466,466,5,5,0,1,0
5,477,477,3,3,0,1,0
22,490,490,80,80,0,1,0

7,101,101,1,1,0,1,0
15,113,113,10,1,9,4,3
36,116,116,4,1,3,2,1
19,116,116,1,1,0,1,0
3,132,132,9,4,5,2,1
9,135,135,26,3,23,2,1
27,142,142,3,3,0,1,0
14,147,147,16,16,0,1,0
0,150,150,10,10,0,1,0
11,153,153,7,7,0,1,0
16,156,156,1,1,0,1,0
13,159,159,1,1,0,1,0
6,160,160,38,38,0,1,0
26,189,189,20,20,0,1,0
33,196,196,13,13,0,1,0
37,212,212,15,15,0,1,0
10,233,233,1,1,0,1,0
18,238,238,1,1,0,1,0
28,243,243,9,9,0,1,0
4,250,250,11,8,3,2,1
25,286,286,49,49,0,1,0
34,292,292,91,34,57,4,3
1,311,311,69,32,37,4,3
2,313,313,5,5,0,1,0
29,320,320,8,8,0,1,0
8,324,324,29,29,0,1,0
31,325,325,32,16,16,2,1
21,337,337,23,23,0,1,0
5,344,344,41,12,29,3,2
23,346,346,8,2,6,3,2
22,355,355,19,7,12,2,1
38,363,363,60,60,0,1,0
17,364,364,16,1,15,4,3
35,375,375,40,28,12,3,2
30,408,408,11,11,0,1,0
12,429,429,5,5,0,1,0
20,436,436,27,27,0,1,0
32,452,452,127,127,0,1,0
24,476,476,52,16,36,2,1
39,488,488,3,3,0,1,0

9,118,118,1,1,0,1,0
6,125,125,23,3,20,2,1
24,140,140,11,11,0,1,0
27,163,163,8,5,3,2,1
23,168,168,35,19,16,4,3
25,178,178,24,3,21,3,2
11,185,185,13,13,0,1,0
22,191,191,18,6,12,3,2
18,193,193,3,3,0,1,0
16,194,194,1,1,0,1,0
19,204,204,3,3,0,1,0
5,212,212,28,20,8,2,1
17,233,233,1,1,0,1,0
2,253,253,13,13,0,1,0
29,256,256,1,1,0,1,0
0,302,302,67,67,0,1,0
3,306,306,56,46,10,2,1
1,307,307,17,9,8,3,2
21,319,319,52,31,21,2,1
20,357,357,68,68,0,1,0
14,380,380,38,8,30,3,2
15,386,386,114,50,64,4,3
8,391,391,24,24,0,1,0
7,401,401,2,2,0,1,0
30,429,429,16,16,0,1,0
13,440,440,73,73,0,1,0
10,462,462,28,28,0,1,0
28,462,462,105,81,24,4,3
4,470,470,45,41,4,2,1
12,485,485,100,58,42,3,2
26,495,495,59,59,0,1,0

1,107,107,1,1,0,1,0
17,110,110,7,1,6,2,1
10,116,116,1,1,0,1,0
3,120,120,8,8,0,1,0
20,123,123,13,4,9,4,3
13,137,137,18,18,0,1,0
34,138,138,23,23,0,1,0
25,147,147,3,3,0,1,0
21,149,149,17,17,0,1,0
8,176,176,30,11,19,2,1
5,182,182,11,1,10,4,3
35,183,183,47,47,0,1,0
14,193,193,26,26,0,1,0
23,209,209,7,1,6,3,2
24,269,269,39,20,19,2,1
22,284,284,22,22,0,1,0
28,285,285,6,6,0,1,0
26,290,290,58,58,0,1,0
11,296,296,12,8,4,2,1
15,321,321,11,4,7,2,1
0,328,328,15,7,8,3,2
29,341,341,81,63,18,3,2
27,361,361,14,2,12,3,2
7,371,371,43,6,37,2,1
12,371,371,30,20,10,3,2
30,381,381,20,8,12,4,3
4,382,382,47,47,0,1,0
6,384,384,5,2,3,2,1
2,388,388,143,68,75,4,3
16,404,404,13,13,0,1,0
31,427,427,58,58,0,1,0
32,430,430,11,5,6,3,2
33,460,460,2,2,0,1,0
19,465,465,7,7,0,1,0
18,492,492,29,29,0,1,0
9,495,495,14,14,0,1,0

19,112,112,13,13,0,1,0
32,136,136,24,24,0,1,0
25,136,136,1,1,0,1,0
2,143,143,2,2,0,1,0
20,143,143,15,4,11,2,1
5,147,147,21,21,0,1,0
26,156,156,73,73,0,1,0
11,172,172,20,20,0,1,0
21,173,173,10,5,5,2,1
30,194,194,27,27,0,1,0
22,206,206,19,3,16,3,2
13,209,209,40,40,0,1,0
8,211,211,1,1,0,1,0
17,211,211,2,2,0,1,0
28,230,230,25,16,9,2,1
10,241,241,1,1,0,1,0
27,257,257,4,4,0,1,0
12,287,287,21,21,0,1,0
23,294,294,11,8,3,2,1
7,301,301,6,6,0,1,0
15,320,320,44,5,39,3,2
18,330,330,22,22,0,1,0
3,331,331,12,12,0,1,0
0,333,333,7,7,0,1,0
4,345,345,12,12,0,1,0
31,381,381,35,25,10,3,2
16,397,397,14,14,0,1,0
1,423,423,198,198,0,1,0
29,434,434,27,19,8,3,2
14,438,438,1,1,0,1,0
24,468,468,40,35,5,2,1
6,469,469,82,59,23,2,1
9,473,473,59,35,24,4,3

18,108,108,10,10,0,1,0
9,137,137,19,7,12,4,3
3,140,140,3,3,0,1,0
2,174,174,9,4,5,2,1
22,189,189,32,32,0,1,0
17,200,200,27,9,18,2,1
5,216,216,51,36,15,2,1
11,219,219,31,8,23,3,2
6,232,232,57,57,0,1,0
0,233,233,15,5,10,3,2
19,238,238,14,2,12,4,3
23,254,254,31,31,0,1,0
10,267,267,2,2,0,1,0
12,271,271,7,7,0,1,0
7,280,280,159,58,101,4,3
20,287,287,13,13,0,1,0
1,287,287,30,30,0,1,0
14,325,325,50,50,0,1,0
21,349,349,31,1,30,3,2
15,421,421,46,4,42,2,1
16,434,434,44,44,0,1,0
8,443,443,24,10,14,2,1
4,446,446,138,30,108,4,3
13,449,449,87,21,66,3,2

30,105,105,11,11,0,1,0
22,106,106,6,6,0,1,0
17,117,117,9,6,3,2,1
29,118,118,12,12,0,1,0
13,119,119,13,4,9,4,3
14,150,150,1,1,0,1,0
1,184,184,7,7,0,1,0
7,187,187,3,3,0,1,0
12,201,201,13,9,4,2,1
16,202,202,58,58,0,1,0
23,214,214,14,14,0,1,0
28,218,218,16,16,0,1,0
32,239,239,10,2,8,2,1
10,265,265,2,2,0,1,0
2,268,268,17,17,0,1,0
31,269,269,17,1,16,3,2
15,270,270,7,7,0,1,0
4,291,291,35,17,18,3,2
3,297,297,84,40,44,3,2
21,316,316,14,14,0,1,0
8,328,328,2,2,0,1,0
11,387,387,29,29,0,1,0
20,388,388,180,72,108,4,3
26,418,418,14,14,0,1,0
5,419,419,4,1,3,2,1
18,425,425,1,1,0,1,0
24,428,428,80,80,0,1,0
9,429,429,38,29,9,2,1
0,450,450,117,117,0,1,0
25,465,465,21,21,0,1,0
27,469,469,34,34,0,1,0
19,479,479,101,27,74,3,2
6,479,479,67,67,0,1,0

23,108,108,5,5,0,1,0
26,110,110,22,22,0,1,0
13,119,119,11,11,0,1,0
9,121,121,8,8,0,1,0
30,157,157,1,1,0,1,0
0,163,163,1,1,0,1,0
18,170,170,18,18,0,1,0
24,170,170,12,2,10,2,1
29,190,190,1,1,0,1,0
22,198,198,15,15,0,1,0
21,201,201,41,41,0,1,0
17,202,202,42,42,0,1,0
2,224,224,24,24,0,1,0
5,229,229,17,3,14,3,2
7,240,240,11,11,0,1,0
33,246,246,6,6,0,1,0
15,250,250,40,40,0,1,0
16,273,273,12,12,0,1,0
10,277,277,17,5,12,4,3
27,283,283,22,5,17,4,3
35,311,311,10,10,0,1,0
4,317,317,15,15,0,1,0
14,338,338,11,11,0,1,0
25,343,343,13,13,0,1,0
6,363,363,8,2,6,2,1
28,366,366,74,39,35,2,1
12,382,382,48,48,0,1,0
11,383,383,80,32,48,3,2
34,383,383,76,43,33,4,3
19,400,400,49,49,0,1,0
1,402,402,22,22,0,1,0
32,419,419,133,25,108,4,3
8,427,427,2,2,0,1,0
3,431,431,5,1,4,2,1
31,453,453,13,13,0,1,0
20,458,458,53,53,0,1,0

16,100,100,5,5,0,1,0
1,104,104,15,15,0,1,0
20,119,119,2,2,0,1,0
32,127,127,6,6,0,1,0
21,132,132,17,17,0,1,0
26,135,135,3,3,0,1,0
3,140,140,2,2,0,1,0
17,146,146,3,3,0,1,0
0,200,200,4,4,0,1,0
30,209,209,36,24,12,4,3
14,224,224,73,58,15,4,3
23,233,233,16,16,0,1,0
12,234,234,2,2,0,1,0
33,240,240,64,18,46,4,3
28,256,256,25,25,0,1,0
11,281,281,15,15,0,1,0
24,289,289,23,15,8,2,1
29,295,295,30,30,0,1,0
5,311,311,51,51,0,1,0
4,345,345,6,6,0,1,0
6,348,348,1,1,0,1,0
13,365,365,12,12,0,1,0
22,367,367,4,1,3,2,1
27,399,399,74,49,25,4,3
8,410,410,140,140,0,1,0
18,420,420,20,20,0,1,0
9,426,426,65,65,0,1,0
15,428,428,43,43,0,1,0
10,439,439,11,1,10,3,2
25,464,464,26,5,21,2,1
7,473,473,42,32,10,3,2
2,484,484,19,19,0,1,0
31,487,487,62,62,0,1,0
19,496,496,100,16,84,3,2

4,113,113,6,6,0,1,0
30,130,130,5,5,0,1,0
1,140,140,15,3,12,2,1
16,150,150,9,9,0,1,0
0,156,156,5,1,4,2,1
10,162,162,1,1,0,1,0
22,181,181,31,27,4,2,1
8,198,198,2,2,0,1,0
18,206,206,8,8,0,1,0
20,238,238,15,9,6,3,2
7,244,244,48,48,0,1,0
17,249,249,69,69,0,1,0
3,252,252,1,1,0,1,0
2,257,257,45,35,10,3,2
13,277,277,38,33,5,2,1
27,277,277,15,15,0,1,0
19,287,287,96,48,48,4,3
12,304,304,58,15,43,4,3
9,305,305,32,32,0,1,0
24,321,321,23,23,0,1,0
28,388,388,45,30,15,4,3
31,389,389,54,54,0,1,0
11,392,392,9,3,6,2,1
25,402,402,3,3,0,1,0
32,408,408,1,1,0,1,0
26,432,432,30,30,0,1,0
23,449,449,8,5,3,2,1
15,452,452,42,18,24,2,1
21,460,460,9,5,4,2,1
14,465,465,56,29,27,4,3
5,469,469,132,132,0,1,0
6,474,474,3,3,0,1,0
29,496,496,103,85,18,2,1

22,133,133,27,27,0,1,0
31,137,137,6,3,3,2,1
7,139,139,37,37,0,1,0
13,152,152,7,7,0,1,0
26,182,182,35,35,0,1,0
12,187,187,10,3,7,2,1
23,230,230,15,15,0,1,0
9,238,238,22,22,0,1,0
16,252,252,3,3,0,1,0
18,253,253,47,37,10,3,2
4,268,268,10,5,5,2,1
30,273,273,16,16,0,1,0
27,278,278,3,3,0,1,0
14,285,285,6,6,0,1,0
8,298,298,63,63,0,1,0
15,300,300,22,22,0,1,0
2,305,305,60,60,0,1,0
3,306,306,25,25,0,1,0
20,308,308,85,37,48,4,3
25,319,319,30,6,24,2,1
6,319,319,32,4,28,3,2
21,324,324,43,28,15,4,3
28,341,341,29,24,5,2,1
19,357,357,25,1,24,2,1
24,383,383,13,13,0,1,0
5,402,402,7,3,4,2,1
10,408,408,38,38,0,1,0
0,413,413,50,17,33,4,3
29,451,451,19,19,0,1,0
1,485,485,43,3,40,3,2
11,492,492,50,50,0,1,0
17,499,499,59,11,48,2,1

29,101,101,58,58,0,1,0
14,179,179,38,38,0,1,0
16,185,185,14,14,0,1,0
31,188,188,24,11,13,2,1
27,193,193,16,4,12,2,1
17,199,199,3,3,0,1,0
5,216,216,16,16,0,1,0
20,218,218,8,8,0,1,0
9,224,224,4,4,0,1,0
3,224,224,30,4,26,2,1
18,237,237,18,18,0,1,0
26,242,242,11,1,10,2,1
19,253,253,3,3,0,1,0
4,263,263,33,9,24,3,2
23,282,282,8,8,0,1,0
24,295,295,2,2,0,1,0
22,307,307,32,23,9,2,1
0,314,314,19,14,5,2,1
2,323,323,1,1,0,1,0
28,374,374,89,89,0,1,0
11,379,379,25,1,24,3,2
21,385,385,88,88,0,1,0
25,386,386,2,2,0,1,0
15,400,400,4,1,3,2,1
7,400,400,22,22,0,1,0
6,403,403,17,9,8,2,1
1,404,404,49,49,0,1,0
30,409,409,8,8,0,1,0
13,412,412,32,20,12,3,2
8,414,414,168,168,0,1,0
32,416,416,17,8,9,2,1
33,449,449,1,1,0,1,0
10,454,454,32,32,0,1,0
12,477,477,18,5,13,2,1

16,102,102,2,2,0,1,0
1,105,105,2,2,0,1,0
32,108,108,18,2,16,2,1
11,142,142,37,37,0,1,0
18,151,151,6,6,0,1,0
12,157,157,1,1,0,1,0
6,163,163,24,24,0,1,0
9,165,165,84,84,0,1,0
31,169,169,31,13,18,4,3
10,172,172,4,4,0,1,0
19,182,182,17,17,0,1,0
24,207,207,3,3,0,1,0
30,219,219,23,23,0,1,0
3,221,221,54,54,0,1,0
14,225,225,1,1,0,1,0
29,272,272,27,27,0,1,0
21,280,280,2,2,0,1,0
25,296,296,15,8,7,2,1
4,296,296,21,5,16,3,2
35,297,297,25,20,5,2,1
5,306,306,10,10,0,1,0
23,353,353,79,61,18,3,2
28,361,361,42,42,0,1,0
8,369,369,9,9,0,1,0
27,392,392,29,1,28,3,2
33,399,399,131,2,129,4,3
2,411,411,8,8,0,1,0
20,412,412,7,7,0,1,0
26,423,423,7,7,0,1,0
34,439,439,11,8,3,2,1
17,447,447,17,5,12,3,2
15,451,451,3,3,0,1,0
13,461,461,4,4,0,1,0
0,469,469,4,4,0,1,0
7,473,473,13,13,0,1,0
22,488,488,58,28,30,3,2

10,114,114,20,20,0,1,0
25,117,117,7,7,0,1,0
13,124,124,8,8,0,1,0
5,126,126,1,1,0,1,0
15,141,141,15,15,0,1,0
21,172,172,4,4,0,1,0
23,178,178,14,14,0,1,0
20,194,194,40,40,0,1,0
2,215,215,11,2,9,4,3
24,252,252,92,92,0,1,0
17,270,270,5,5,0,1,0
6,306,306,32,20,12,4,3
3,321,321,77,77,0,1,0
18,337,337,4,4,0,1,0
19,349,349,32,4,28,2,1
7,351,351,55,13,42,3,2
8,369,369,89,85,4,2,1
22,376,376,27,27,0,1,0
1,378,378,32,32,0,1,0
16,384,384,46,46,0,1,0
12,397,397,32,32,0,1,0
26,400,400,11,3,8,3,2
4,406,406,17,17,0,1,0
0,408,408,102,41,61,4,3
27,423,423,113,17,96,4,3
9,441,441,105,45,60,4,3
11,446,446,4,4,0,1,0
14,473,473,18,13,5,2,1

15,114,114,1,1,0,1,0
24,115,115,21,21,0,1,0
3,134,134,7,7,0,1,0
23,142,142,4,1,3,2,1
20,150,150,3,3,0,1,0
13,172,172,38,5,33,2,1
33,174,174,5,5,0,1,0
2,189,189,8,8,0,1,0
5,190,190,3,3,0,1,0
6,192,192,8,5,3,2,1
32,196,196,55,42,13,2,1
31,196,196,26,26,0,1,0
9,206,206,41,41,0,1,0
12,210,210,3,3,0,1,0
11,213,213,12,5,7,2,1
4,260,260,57,57,0,1,0
7,263,263,1,1,0,1,0
8,295,295,10,10,0,1,0
16,312,312,8,5,3,2,1
10,312,312,12,12,0,1,0
1,333,333,95,37,58,3,2
28,337,337,127,51,76,3,2
30,351,351,61,49,12,4,3
22,361,361,3,3,0,1,0
29,379,379,2,2,0,1,0
25,385,385,31,31,0,1,0
17,400,400,17,10,7,2,1
19,414,414,46,46,0,1,0
26,429,429,44,9,35,2,1
18,458,458,3,3,0,1,0
21,475,475,35,7,28,3,2
27,476,476,10,6,4,2,1
14,491,491,131,74,57,3,2
0,498,498,17,17,0,1,0

5,110,110,32,26,6,2,1
7,126,126,18,12,6,3,2
14,133,133,1,1,0,1,0
27,166,166,36,10,26,3,2
6,172,172,59,20,39,2,1
3,179,179,7,7,0,1,0
8,185,185,1,1,0,1,0
19,227,227,15,15,0,1,0
25,230,230,29,29,0,1,0
16,253,253,27,27,0,1,0
17,265,265,5,5,0,1,0
26,295,295,50,17,33,4,3
2,313,313,19,19,0,1,0
15,313,313,15,15,0,1,0
21,360,360,64,7,57,3,2
1,383,383,122,66,56,3,2
23,387,387,86,86,0,1,0
12,394,394,43,17,26,3,2
22,398,398,8,8,0,1,0
0,398,398,38,9,29,2,1
4,404,404,41,41,0,1,0
13,410,410,7,1,6,2,1
24,453,453,14,5,9,4,3
10,473,473,45,45,0,1,0
18,480,480,34,6,28,3,2
20,486,486,108,62,46,3,2
9,497,497,40,10,30,2,1
11,500,500,14,14,0,1,0

27,123,123,39,39,0,1,0
15,143,143,12,12,0,1,0
34,157,157,20,12,8,3,2
30,162,162,4,4,0,1,0
20,163,163,3,3,0,1,0
6,167,167,1,1,0,1,0
28,176,176,1,1,0,1,0
0,189,189,4,4,0,1,0
16,190,190,14,11,3,2,1
13,198,198,3,3,0,1,0
19,224,224,3,3,0,1,0
14,242,242,45,45,0,1,0
3,246,246,28,8,20,2,1
37,249,249,66,66,0,1,0
1,263,263,5,1,4,2,1
38,295,295,3,3,0,1,0
29,303,303,61,54,7,2,1
5,309,309,7,7,0,1,0
17,314,314,49,49,0,1,0
8,320,320,1,1,0,1,0
35,336,336,56,56,0,1,0
36,336,336,47,47,0,1,0
33,340,340,16,9,7,2,1
26,351,351,6,6,0,1,0
25,378,378,27,8,19,2,1
4,385,385,40,40,0,1,0
9,405,405,11,11,0,1,0
10,407,407,44,44,0,1,0
22,411,411,1,1,0,1,0
23,448,448,66,66,0,1,0
11,455,455,9,9,0,1,0
32,467,467,32,2,30,3,2
21,468,468,16,1,15,4,3
24,469,469,10,10,0,1,0
18,472,472,142,118,24,4,3
7,494,494,83,17,66,3,2
12,494,494,1,1,0,1,0
2,498,498,51,51,0,1,0
31,500,500,1,1,0,1,0

6,103,103,2,2,0,1,0
18,106,106,17,4,13,2,1
8,145,145,1,1,0,1,0
0,160,160,1,1,0,1,0
15,187,187,9,5,4,2,1
4,192,192,9,9,0,1,0
24,212,212,22,7,15,4,3
19,225,225,11,11,0,1,0
20,254,254,30,30,0,1,0
23,255,255,26,20,6,2,1
12,301,301,7,7,0,1,0
10,303,303,8,1,7,2,1
31,308,308,95,31,64,3,2
35,320,320,23,23,0,1,0
3,338,338,26,26,0,1,0
5,360,360,85,13,72,3,2
7,366,366,2,2,0,1,0
2,369,369,5,5,0,1,0
11,371,371,37,37,0,1,0
27,376,376,9,1,8,2,1
30,393,393,54,20,34,3,2
26,397,397,123,91,32,3,2
21,402,402,9,9,0,1,0
16,403,403,77,39,38,2,1
32,413,413,21,21,0,1,0
9,417,417,38,13,25,3,2
25,420,420,18,18,0,1,0
13,424,424,73,73,0,1,0
17,464,464,45,45,0,1,0
22,467,467,45,45,0,1,0
29,467,467,69,69,0,1,0
28,468,468,28,8,20,2,1
14,469,469,58,4,54,4,3
34,475,475,8,2,6,2,1
1,494,494,53,53,0,1,0
33,494,494,4,4,0,1,0

24,103,103,19,6,13,2,1
11,109,109,16,12,4,2,1
3,148,148,26,2,24,4,3
12,188,188,21,9,12,3,2
13,196,196,43,43,0,1,0
6,213,213,38,38,0,1,0
5,228,228,56,44,12,2,1
22,229,229,3,3,0,1,0
4,280,280,1,1,0,1,0
29,295,295,48,1,47,2,1
7,328,328,20,3,17,4,3
0,339,339,13,13,0,1,0
26,344,344,50,50,0,1,0
28,345,345,4,4,0,1,0
23,354,354,55,33,22,3,2
2,361,361,94,8,86,3,2
27,371,371,33,33,0,1,0
10,375,375,21,21,0,1,0
9,379,379,10,3,7,2,1
25,384,384,71,45,26,3,2
20,385,385,48,48,0,1,0
21,393,393,27,27,0,1,0
14,394,394,20,7,13,4,3
19,398,398,10,10,0,1,0
15,414,414,14,4,10,2,1
18,421,421,27,27,0,1,0
8,428,428,2,2,0,1,0
16,440,440,74,50,24,3,2
17,445,445,65,65,0,1,0
1,447,447,33,19,14,2,1

26,100,100,6,3,3,2,1
30,104,104,2,2,0,1,0
16,122,122,4,4,0,1,0
10,149,149,11,11,0,1,0
21,150,150,5,5,0,1,0
9,163,163,11,4,7,3,2
8,177,177,21,21,0,1,0
18,208,208,9,2,7,2,1
23,210,210,44,16,28,3,2
24,219,219,9,9,0,1,0
2,221,221,1,1,0,1,0
29,231,231,59,55,4,2,1
33,233,233,6,6,0,1,0
11,245,245,2,2,0,1,0
15,246,246,35,4,31,4,3
14,251,251,1,1,0,1,0
7,254,254,7,7,0,1,0
0,263,263,14,5,9,2,1
3,283,283,25,6,19,4,3
6,289,289,69,11,58,3,2
19,294,294,16,16,0,1,0
34,304,304,4,4,0,1,0
25,307,307,47,47,0,1,0
27,338,338,4,4,0,1,0
20,380,380,3,3,0,1,0
17,384,384,18,18,0,1,0
13,385,385,25,25,0,1,0
5,387,387,90,30,60,4,3
12,391,391,22,8,14,2,1
35,393,393,243,243,0,1,0
32,424,424,34,34,0,1,0
22,434,434,43,43,0,1,0
31,464,464,1,1,0,1,0
1,483,483,87,87,0,1,0
4,489,489,31,4,27,2,1
28,493,493,5,1,4,2,1

13,102,102,1,1,0,1,0
27,107,107,1,1,0,1,0
3,119,119,27,27,0,1,0
8,134,134,13,6,7,2,1
15,150,150,16,4,12,4,3
2,150,150,3,3,0,1,0
4,153,153,3,3,0,1,0
26,168,168,7,7,0,1,0
10,177,177,11,3,8,2,1
16,186,186,2,2,0,1,0
21,191,191,1,1,0,1,0
0,198,198,46,46,0,1,0
6,204,204,10,10,0,1,0
23,239,239,4,4,0,1,0
18,241,241,44,6,38,3,2
29,267,267,12,4,8,3,2
7,272,272,33,12,21,4,3
22,274,274,50,50,0,1,0
28,288,288,25,25,0,1,0
11,341,341,1,1,0,1,0
20,347,347,17,17,0,1,0
19,369,369,58,58,0,1,0
1,409,409,13,13,0,1,0
14,420,420,30,30,0,1,0
17,435,435,1,1,0,1,0
25,437,437,257,203,54,4,3
12,446,446,2,2,0,1,0
24,458,458,67,25,42,4,3
30,468,468,5,5,0,1,0
9,489,489,318,264,54,4,3
5,493,493,1,1,0,1,0

3,105,105,3,3,0,1,0
27,109,109,1,1,0,1,0
33,109,109,2,2,0,1,0
24,110,110,34,34,0,1,0
32,141,141,4,4,0,1,0
6,160,160,12,4,8,2,1
28,160,160,16,9,7,2,1
9,161,161,3,3,0,1,0
7,165,165,6,6,0,1,0
11,171,171,2,2,0,1,0
1,186,186,7,7,0,1,0
2,195,195,3,3,0,1,0
14,209,209,3,3,0,1,0
26,220,220,16,7,9,2,1
18,226,226,43,43,0,1,0
19,233,233,3,3,0,1,0
13,276,276,1,1,0,1,0
30,278,278,9,9,0,1,0
4,313,313,7,7,0,1,0
23,318,318,40,28,12,2,1
15,321,321,20,7,13,2,1
10,330,330,16,16,0,1,0
25,336,336,66,66,0,1,0
16,365,365,6,2,4,2,1
21,373,373,47,47,0,1,0
0,388,388,157,69,88,3,2
12,401,401,84,8,76,3,2
29,413,413,24,10,14,2,1
20,443,443,28,28,0,1,0
17,443,443,48,13,35,2,1
22,446,446,88,16,72,4,3
31,450,450,69,23,46,3,2
5,455,455,42,10,32,2,1
34,490,490,66,66,0,1,0
8,500,500,104,54,50,3,2

11,116,116,37,31,6,3,2
10,129,129,24,12,12,2,1
14,135,135,11,5,6,3,2
5,143,143,4,4,0,1,0
31,180,180,28,28,0,1,0
16,190,190,15,15,0,1,0
24,200,200,17,17,0,1,0
21,223,223,1,1,0,1,0
0,225,225,8,8,0,1,0
8,269,269,38,1,37,2,1
19,292,292,36,36,0,1,0
28,311,311,21,21,0,1,0
22,311,311,2,2,0,1,0
6,315,315,11,11,0,1,0
12,317,317,1,1,0,1,0
29,322,322,2,2,0,1,0
18,346,346,70,70,0,1,0
7,369,369,6,6,0,1,0
9,369,369,39,16,23,3,2
4,374,374,161,59,102,4,3
3,389,389,1,1,0,1,0
23,399,399,109,67,42,3,2
20,399,399,61,46,15,4,3
1,403,403,18,3,15,4,3
25,404,404,23,23,0,1,0
13,409,409,19,6,13,2,1
26,430,430,59,59,0,1,0
15,432,432,41,29,12,4,3
27,437,437,31,13,18,2,1
2,442,442,14,14,0,1,0
17,472,472,71,71,0,1,0
30,479,479,27,10,17,2,1

25,101,101,18,18,0,1,0
17,137,137,2,2,0,1,0
18,144,144,6,6,0,1,0
14,149,149,48,28,20,2,1
7,153,153,20,20,0,1,0
9,159,159,2,2,0,1,0
5,162,162,16,7,9,2,1
2,175,175,16,16,0,1,0
28,211,211,39,39,0,1,0
29,215,215,3,3,0,1,0
26,216,216,52,52,0,1,0
22,221,221,17,17,0,1,0
16,232,232,5,5,0,1,0
24,241,241,32,19,13,2,1
23,253,253,3,3,0,1,0
19,275,275,42,7,35,2,1
6,280,280,68,68,0,1,0
10,283,283,43,5,38,2,1
20,290,290,6,6,0,1,0
12,304,304,1,1,0,1,0
11,320,320,14,14,0,1,0
8,326,326,2,2,0,1,0
1,332,332,62,20,42,2,1
31,336,336,18,10,8,2,1
21,336,336,2,2,0,1,0
13,400,400,14,14,0,1,0
33,401,401,1,1,0,1,0
34,411,411,23,1,22,3,2
3,414,414,3,3,0,1,0
4,417,417,65,10,55,4,3
30,428,428,166,82,84,4,3
27,457,457,20,20,0,1,0
0,462,462,4,4,0,1,0
32,463,463,31,31,0,1,0
15,477,477,14,14,0,1,0

6,106,106,9,9,0,1,0
0,111,111,5,5,0,1,0
25,126,126,2,2,0,1,0
29,126,126,1,1,0,1,0
19,166,166,22,6,16,2,1
18,212,212,38,38,0,1,0
16,231,231,11,2,9,4,3
27,251,251,25,7,18,3,2
26,269,269,6,6,0,1,0
17,270,270,56,56,0,1,0
1,272,272,16,5,11,2,1
22,273,273,18,12,6,2,1
20,277,277,13,13,0,1,0
23,294,294,34,20,14,3,2
21,336,336,31,10,21,2,1
8,353,353,8,5,3,2,1
7,355,355,3,3,0,1,0
2,361,361,68,31,37,3,2
11,374,374,35,35,0,1,0
24,395,395,20,8,12,3,2
5,428,428,20,6,14,3,2
3,429,429,120,120,0,1,0
10,435,435,40,40,0,1,0
30,445,445,37,3,34,3,2
4,449,449,13,2,11,2,1
15,456,456,196,120,76,3,2
28,459,459,22,22,0,1,0
12,464,464,83,53,30,3,2
9,478,478,45,25,20,2,1
13,484,484,5,5,0,1,0
14,498,498,183,161,22,3,2

22,118,118,2,2,0,1,0
34,119,119,2,2,0,1,0
29,133,133,6,6,0,1,0
32,145,145,47,41,6,3,2
18,162,162,43,43,0,1,0
23,162,162,22,22,0,1,0
2,170,170,21,21,0,1,0
21,179,179,15,15,0,1,0
3,185,185,1,1,0,1,0
0,193,193,59,59,0,1,0
6,210,210,1,1,0,1,0
8,212,212,3,3,0,1,0
26,243,243,49,31,18,4,3
9,244,244,22,22,0,1,0
14,255,255,24,2,22,3,2
5,259,259,25,25,0,1,0
10,298,298,8,8,0,1,0
30,317,317,52,8,44,2,1
31,330,330,7,7,0,1,0
4,338,338,29,29,0,1,0
13,362,362,14,14,0,1,0
20,364,364,17,17,0,1,0
15,377,377,8,4,4,2,1
12,378,378,24,18,6,2,1
33,397,397,63,23,40,3,2
1,407,407,6,6,0,1,0
24,418,418,34,34,0,1,0
16,427,427,34,10,24,2,1
27,436,436,23,23,0,1,0
7,439,439,29,19,10,2,1
11,445,445,32,32,0,1,0
35,450,450,41,5,36,2,1
25,459,459,4,4,0,1,0
19,461,461,23,23,0,1,0
17,467,467,39,39,0,1,0
28,482,482,91,91,0,1,0

6,108,108,12,12,0,1,0
29,112,112,6,2,4,2,1
21,118,118,4,4,0,1,0
24,148,148,3,3,0,1,0
13,151,151,24,17,7,2,1
3,152,152,21,21,0,1,0
0,155,155,6,3,3,2,1
32,183,183,31,9,22,3,2
8,183,183,7,1,6,2,1
27,210,210,1,1,0,1,0
19,226,226,3,3,0,1,0
25,228,228,99,99,0,1,0
1,232,232,1,1,0,1,0
22,243,243,32,32,0,1,0
11,276,276,24,18,6,2,1
26,283,283,19,19,0,1,0
23,289,289,24,5,19,3,2
15,290,290,36,36,0,1,0
18,310,310,29,14,15,4,3
2,313,313,24,19,5,2,1
9,318,318,22,16,6,2,1
30,321,321,50,31,19,4,3
28,330,330,40,40,0,1,0
17,335,335,8,8,0,1,0
31,340,340,27,27,0,1,0
16,392,392,52,52,0,1,0
4,401,401,9,9,0,1,0
12,401,401,4,4,0,1,0
5,420,420,23,11,12,2,1
36,427,427,10,7,3,2,1
34,432,432,17,9,8,3,2
20,435,435,19,4,15,3,2
37,446,446,24,4,20,2,1
7,452,452,23,3,20,3,2
14,468,468,57,57,0,1,0
35,484,484,73,73,0,1,0
10,488,488,76,13,63,4,3
33,491,491,19,19,0,1,0

4,108,108,54,31,23,4,3
23,130,130,40,40,0,1,0
13,145,145,39,1,38,2,1
26,153,153,34,7,27,4,3
5,154,154,5,2,3,2,1
11,158,158,4,4,0,1,0
1,167,167,20,20,0,1,0
8,191,191,24,18,6,2,1
10,193,193,7,1,6,2,1
14,202,202,18,1,17,2,1
12,233,233,14,14,0,1,0
7,255,255,1,1,0,1,0
25,265,265,15,11,4,2,1
0,272,272,29,9,20,2,1
22,278,278,6,6,0,1,0
3,297,297,51,51,0,1,0
19,299,299,31,31,0,1,0
18,305,305,42,3,39,2,1
24,331,331,47,47,0,1,0
21,331,331,47,39,8,2,1
2,340,340,3,3,0,1,0
27,365,365,45,9,36,4,3
28,371,371,4,1,3,2,1
15,378,378,18,10,8,3,2
16,394,394,15,15,0,1,0
17,425,425,52,44,8,3,2
29,448,448,13,1,12,2,1
20,464,464,19,19,0,1,0
6,473,473,48,48,0,1,0
9,479,479,20,20,0,1,0

20,104,104,3,3,0,1,0
24,109,109,3,3,0,1,0
29,119,119,19,19,0,1,0
5,125,125,7,4,3,2,1
8,198,198,16,13,3,2,1
30,198,198,13,2,11,2,1
32,219,219,8,4,4,2,1
33,248,248,26,26,0,1,0
27,259,259,6,2,4,2,1
28,263,263,8,2,6,3,2
11,266,266,6,6,0,1,0
2,267,267,10,3,7,2,1
34,280,280,18,12,6,3,2
14,285,285,19,1,18,4,3
0,289,289,73,73,0,1,0
6,305,305,45,30,15,2,1
19,315,315,34,22,12,2,1
7,337,337,16,4,12,3,2
25,342,342,22,19,3,2,1
22,349,349,21,21,0,1,0
23,385,385,33,19,14,3,2
9,388,388,3,3,0,1,0
15,390,390,39,27,12,4,3
16,391,391,53,53,0,1,0
1,395,395,18,10,8,3,2
21,408,408,20,20,0,1,0
3,415,415,49,30,19,2,1
17,428,428,26,6,20,3,2
18,431,431,68,60,8,3,2
12,434,434,12,12,0,1,0
26,439,439,77,43,34,4,3
4,460,460,58,58,0,1,0
10,460,460,47,47,0,1,0
13,464,464,4,4,0,1,0
31,476,476,260,180,80,4,3

3,114,114,5,5,0,1,0
25,134,134,16,4,12,2,1
5,161,161,11,11,0,1,0
11,173,173,3,3,0,1,0
30,181,181,9,9,0,1,0
26,186,186,7,7,0,1,0
4,205,205,9,4,5,2,1
7,226,226,18,18,0,1,0
27,233,233,25,9,16,3,2
1,235,235,33,1,32,2,1
22,250,250,43,17,26,3,2
21,277,277,44,20,24,2,1
28,280,280,26,13,13,3,2
32,295,295,86,74,12,2,1
18,300,300,55,55,0,1,0
16,319,319,4,4,0,1,0
13,321,321,19,3,16,3,2
0,321,321,40,40,0,1,0
6,328,328,42,42,0,1,0
29,343,343,9,1,8,2,1
9,368,368,1,1,0,1,0
12,370,370,23,12,11,2,1
2,385,385,21,21,0,1,0
33,400,400,15,5,10,2,1
17,409,409,156,24,132,4,3
31,413,413,27,21,6,2,1
23,419,419,33,33,0,1,0
8,423,423,87,41,46,3,2
19,441,441,33,22,11,2,1
10,457,457,37,37,0,1,0
24,462,462,19,19,0,1,0
15,483,483,33,33,0,1,0
20,485,485,46,46,0,1,0
14,491,491,13,9,4,2,1

4,100,100,3,3,0,1,0
28,127,127,2,2,0,1,0
33,148,148,25,8,17,2,1
22,154,154,12,12,0,1,0
5,181,181,2,2,0,1,0
27,206,206,11,11,0,1,0
10,208,208,1,1,0,1,0
25,218,218,33,33,0,1,0
32,232,232,21,21,0,1,0
1,238,238,28,28,0,1,0
23,261,261,69,69,0,1,0
11,288,288,1,1,0,1,0
18,292,292,5,5,0,1,0
21,293,293,16,3,13,2,1
14,296,296,11,11,0,1,0
16,298,298,148,142,6,2,1
26,302,302,30,27,3,2,1
7,304,304,2,2,0,1,0
6,321,321,2,2,0,1,0
17,330,330,11,11,0,1,0
2,348,348,23,12,11,2,1
0,353,353,1,1,0,1,0
31,354,354,12,12,0,1,0
30,355,355,15,7,8,2,1
29,362,362,56,56,0,1,0
12,377,377,58,10,48,2,1
35,390,390,28,10,18,4,3
24,413,413,18,18,0,1,0
19,421,421,4,4,0,1,0
3,430,430,44,44,0,1,0
8,450,450,51,7,44,2,1
20,455,455,45,45,0,1,0
34,464,464,97,37,60,4,3
9,480,480,6,6,0,1,0
13,486,486,31,31,0,1,0
15,499,499,156,141,15,4,3

18,119,119,12,12,0,1,0
34,131,131,21,21,0,1,0
2,140,140,13,7,6,2,1
13,156,156,1,1,0,1,0
28,156,156,2,2,0,1,0
6,157,157,3,3,0,1,0
4,177,177,4,4,0,1,0
23,177,177,1,1,0,1,0
31,184,184,17,10,7,2,1
19,184,184,30,7,23,2,1
12,214,214,7,1,6,3,2
22,231,231,16,16,0,1,0
5,260,260,7,2,5,2,1
32,270,270,35,8,27,4,3
16,302,302,71,3,68,3,2
3,302,302,25,25,0,1,0
20,314,314,45,45,0,1,0
27,318,318,36,15,21,4,3
0,324,324,44,44,0,1,0
8,337,337,106,8,98,3,2
15,338,338,31,7,24,4,3
1,338,338,49,49,0,1,0
10,347,347,42,29,13,2,1
11,363,363,15,15,0,1,0
33,401,401,1,1,0,1,0
17,411,411,11,11,0,1,0
25,416,416,41,23,18,2,1
9,420,420,2,2,0,1,0
30,435,435,14,14,0,1,0
7,438,438,7,7,0,1,0
29,461,461,27,27,0,1,0
26,467,467,45,35,10,3,2
14,479,479,43,16,27,2,1
24,483,483,153,63,90,4,3
21,498,498,68,17,51,3,2

8,117,117,12,12,0,1,0
26,127,127,11,11,0,1,0
22,130,130,18,9,9,2,1
24,139,139,2,2,0,1,0
3,146,146,2,2,0,1,0
13,156,156,36,36,0,1,0
15,160,160,15,10,5,2,1
27,163,163,26,26,0,1,0
11,175,175,30,30,0,1,0
19,198,198,1,1,0,1,0
29,202,202,20,13,7,2,1
0,215,215,3,3,0,1,0
28,225,225,5,5,0,1,0
23,230,230,17,17,0,1,0
16,242,242,6,6,0,1,0
10,244,244,1,1,0,1,0
9,251,251,4,4,0,1,0
36,262,262,20,20,0,1,0
20,267,267,24,16,8,3,2
2,286,286,20,20,0,1,0
32,289,289,18,6,12,4,3
31,334,334,9,1,8,3,2
25,343,343,56,56,0,1,0
6,351,351,10,10,0,1,0
34,368,368,4,4,0,1,0
12,368,368,14,2,12,2,1
35,398,398,10,10,0,1,0
14,409,409,20,2,18,3,2
5,411,411,119,119,0,1,0
4,412,412,21,13,8,3,2
37,419,419,117,104,13,2,1
17,424,424,23,6,17,2,1
7,425,425,2,2,0,1,0
1,430,430,15,5,10,2,1
33,463,463,32,32,0,1,0
21,466,466,63,63,0,1,0
30,470,470,156,80,76,4,3
18,474,474,38,38,0,1,0

30,106,106,12,6,6,2,1
17,109,109,4,4,0,1,0
9,117,117,1,1,0,1,0
21,141,141,2,2,0,1,0
13,158,158,9,2,7,2,1
12,178,178,1,1,0,1,0
2,203,203,12,4,8,3,2
3,222,222,65,38,27,4,3
15,225,225,28,28,0,1,0
18,254,254,16,8,8,3,2
27,282,282,23,3,20,3,2
10,301,301,20,5,15,4,3
29,309,309,23,1,22,3,2
6,314,314,12,6,6,2,1
1,317,317,21,5,16,2,1
24,318,318,23,4,19,2,1
14,353,353,92,92,0,1,0
5,356,356,2,2,0,1,0
20,356,356,126,100,26,3,2
28,390,390,19,19,0,1,0
23,398,398,54,12,42,4,3
22,411,411,86,86,0,1,0
7,414,414,15,3,12,4,3
31,428,428,31,31,0,1,0
25,429,429,1,1,0,1,0
16,448,448,80,61,19,2,1
4,450,450,43,43,0,1,0
11,454,454,52,52,0,1,0
8,477,477,28,24,4,2,1
19,483,483,81,51,30,4,3
0,492,492,154,154,0,1,0
26,498,498,5,2,3,2,1

1,102,102,23,9,14,2,1
7,129,129,21,21,0,1,0
20,140,140,1,1,0,1,0
26,142,142,9,9,0,1,0
24,142,142,46,10,36,3,2
2,166,166,5,2,3,2,1
11,185,185,22,4,18,4,3
4,196,196,12,12,0,1,0
6,207,207,11,8,3,2,1
12,213,213,23,4,19,4,3
19,268,268,2,2,0,1,0
23,269,269,7,7,0,1,0
14,287,287,8,2,6,2,1
25,289,289,38,38,0,1,0
9,305,305,9,1,8,3,2
28,317,317,7,7,0,1,0
18,320,320,14,14,0,1,0
5,338,338,24,7,17,2,1
15,354,354,14,1,13,2,1
8,363,363,44,44,0,1,0
3,371,371,96,96,0,1,0
10,394,394,12,2,10,3,2
16,412,412,34,4,30,3,2
0,423,423,5,5,0,1,0
17,429,429,9,3,6,2,1
29,436,436,41,13,28,3,2
22,447,447,252,226,26,2,1
13,462,462,147,127,20,4,3
27,468,468,39,39,0,1,0
21,489,489,47,19,28,3,2

24,101,101,1,1,0,1,0
13,108,108,15,3,12,4,3
7,125,125,40,2,38,2,1
10,156,156,25,11,14,3,2
15,182,182,13,13,0,1,0
6,201,201,26,4,22,3,2
2,228,228,6,3,3,2,1
11,245,245,4,4,0,1,0
26,273,273,82,4,78,3,2
22,286,286,14,14,0,1,0
3,291,291,8,8,0,1,0
21,294,294,60,60,0,1,0
12,298,298,81,81,0,1,0
28,310,310,18,18,0,1,0
14,310,310,33,1,32,2,1
9,312,312,48,48,0,1,0
25,329,329,2,2,0,1,0
0,330,330,2,2,0,1,0
29,366,366,6,6,0,1,0
20,383,383,19,5,14,4,3
8,391,391,1,1,0,1,0
4,393,393,81,59,22,3,2
27,408,408,108,108,0,1,0
1,409,409,15,15,0,1,0
18,413,413,50,24,26,3,2
23,424,424,22,22,0,1,0
5,430,430,47,43,4,2,1
19,434,434,16,8,8,2,1
16,449,449,68,68,0,1,0
17,459,459,60,60,0,1,0

9,134,134,2,2,0,1,0
16,135,135,3,3,0,1,0
14,141,141,8,3,5,2,1
5,143,143,16,16,0,1,0
19,185,185,12,12,0,1,0
8,198,198,20,20,0,1,0
2,205,205,29,9,20,2,1
26,206,206,4,4,0,1,0
0,212,212,18,18,0,1,0
10,216,216,8,1,7,2,1
18,244,244,8,8,0,1,0
3,256,256,57,57,0,1,0
7,256,256,18,18,0,1,0
20,258,258,9,9,0,1,0
1,280,280,32,32,0,1,0
21,282,282,27,9,18,3,2
11,299,299,4,4,0,1,0
6,395,395,55,55,0,1,0
4,421,421,43,33,10,3,2
30,422,422,25,25,0,1,0
24,443,443,3,3,0,1,0
13,450,450,55,55,0,1,0
15,454,454,30,12,18,4,3
22,467,467,15,15,0,1,0
23,476,476,207,86,121,4,3
28,482,482,37,37,0,1,0
29,484,484,57,57,0,1,0
25,488,488,184,153,31,2,1
27,491,491,64,52,12,2,1
12,493,493,135,99,36,4,3
17,500,500,30,30,0,1,0

5,111,111,38,10,28,3,2
20,119,119,3,3,0,1,0
3,137,137,26,26,0,1,0
2,156,156,11,7,4,2,1
14,169,169,5,5,0,1,0
8,175,175,4,4,0,1,0
10,189,189,33,33,0,1,0
1,189,189,3,3,0,1,0
15,238,238,33,33,0,1,0
11,245,245,23,5,18,3,2
21,271,271,19,19,0,1,0
0,286,286,71,28,43,2,1
12,290,290,84,56,28,3,2
24,291,291,22,22,0,1,0
23,297,297,57,6,51,4,3
16,298,298,5,5,0,1,0
27,332,332,12,3,9,2,1
25,339,339,102,49,53,4,3
19,362,362,5,5,0,1,0
13,366,366,24,24,0,1,0
26,367,367,14,14,0,1,0
4,371,371,4,1,3,2,1
17,390,390,16,13,3,2,1
6,435,435,14,14,0,1,0
18,464,464,107,73,34,3,2
22,477,477,34,1,33,2,1
9,488,488,180,126,54,4,3
7,499,499,17,4,13,2,1

35,104,104,3,3,0,1,0
23,108,108,7,7,0,1,0
6,111,111,3,3,0,1,0
39,115,115,2,2,0,1,0
38,126,126,14,2,12,2,1
12,133,133,13,9,4,2,1
26,146,146,13,13,0,1,0
14,148,148,7,4,3,2,1
10,153,153,11,11,0,1,0
18,154,154,34,10,24,2,1
2,156,156,55,55,0,1,0
7,171,171,1,1,0,1,0
28,173,173,5,5,0,1,0
15,225,225,5,5,0,1,0
25,238,238,15,1,14,3,2
21,254,254,18,9,9,4,3
0,259,259,4,4,0,1,0
17,282,282,3,3,0,1,0
24,291,291,47,47,0,1,0
37,321,321,68,21,47,2,1
41,330,330,8,2,6,3,2
4,335,335,14,14,0,1,0
3,337,337,8,8,0,1,0
31,354,354,77,62,15,4,3
11,367,367,21,21,0,1,0
5,371,371,28,28,0,1,0
33,374,374,6,6,0,1,0
34,419,419,28,28,0,1,0
9,430,430,6,6,0,1,0
40,431,431,96,54,42,2,1
29,438,438,8,8,0,1,0
30,440,440,124,115,9,4,3
16,456,456,7,7,0,1,0
8,466,466,14,9,5,2,1
19,466,466,14,8,6,2,1
13,469,469,9,2,7,2,1
27,471,471,51,24,27,4,3
32,475,475,30,30,0,1,0
20,485,485,16,16,0,1,0
22,493,493,7,7,0,1,0
36,495,495,63,55,8,2,1
1,496,496,8,1,7,2,1

22,104,104,12,3,9,4,3
19,142,142,24,14,10,2,1
16,151,151,26,18,8,2,1
28,162,162,19,11,8,2,1
6,174,174,12,12,0,1,0
15,181,181,5,5,0,1,0
24,183,183,8,8,0,1,0
20,189,189,42,42,0,1,0
0,202,202,129,30,99,4,3
5,204,204,3,3,0,1,0
10,210,210,29,2,27,3,2
8,221,221,1,1,0,1,0
2,224,224,31,1,30,4,3
13,226,226,22,5,17,3,2
25,231,231,4,4,0,1,0
7,311,311,17,2,15,4,3
27,323,323,11,11,0,1,0
9,368,368,19,19,0,1,0
4,372,372,76,59,17,4,3
11,378,378,17,14,3,2,1
1,389,389,18,11,7,2,1
12,400,400,24,21,3,2,1
29,413,413,87,87,0,1,0
3,424,424,16,16,0,1,0
14,454,454,116,116,0,1,0
23,457,457,8,8,0,1,0
18,461,461,51,3,48,4,3
21,471,471,6,6,0,1,0
17,482,482,31,31,0,1,0
26,494,494,22,10,12,3,2

14,119,119,46,46,0,1,0
6,145,145,61,41,20,2,1
20,164,164,42,10,32,4,3
8,185,185,8,8,0,1,0
12,206,206,35,35,0,1,0
3,206,206,4,4,0,1,0
17,209,209,19,19,0,1,0
2,235,235,16,16,0,1,0
23,244,244,19,19,0,1,0
25,248,248,25,25,0,1,0
0,253,253,4,4,0,1,0
19,257,257,23,5,18,4,3
13,260,260,21,21,0,1,0
7,293,293,13,13,0,1,0
1,305,305,32,32,0,1,0
21,323,323,3,3,0,1,0
5,337,337,16,10,6,3,2
22,344,344,1,1,0,1,0
24,351,351,4,4,0,1,0
16,405,405,13,13,0,1,0
15,439,439,8,2,6,2,1
11,459,459,96,62,34,2,1
26,464,464,3,3,0,1,0
9,469,469,88,54,34,4,3
4,472,472,75,66,9,4,3
10,483,483,136,37,99,4,3
27,488,488,8,8,0,1,0
18,496,496,138,96,42,3,2

4,117,117,1,1,0,1,0
31,120,120,12,12,0,1,0
16,122,122,20,20,0,1,0
22,147,147,8,8,0,1,0
29,177,177,29,11,18,4,3
18,180,180,39,39,0,1,0
30,181,181,8,8,0,1,0
23,196,196,3,3,0,1,0
27,201,201,13,8,5,2,1
2,206,206,38,7,31,2,1
11,236,236,21,4,17,4,3
28,255,255,37,27,10,3,2
17,270,270,6,1,5,2,1
13,283,283,17,4,13,2,1
6,285,285,67,67,0,1,0
3,290,290,99,71,28,3,2
24,311,311,29,16,13,2,1
14,316,316,25,16,9,4,3
10,321,321,3,3,0,1,0
1,324,324,1,1,0,1,0
26,330,330,7,3,4,2,1
5,353,353,11,11,0,1,0
9,354,354,22,22,0,1,0
0,361,361,25,3,22,2,1
15,365,365,59,34,25,3,2
21,373,373,22,16,6,3,2
12,381,381,35,35,0,1,0
25,384,384,53,53,0,1,0
19,389,389,126,126,0,1,0
8,409,409,4,4,0,1,0
7,455,455,75,61,14,3,2
20,500,500,4,4,0,1,0

29,119,119,18,4,14,3,2
9,181,181,4,1,3,2,1
23,183,183,7,1,6,2,1
7,185,185,6,6,0,1,0
22,185,185,38,20,18,2,1
3,228,228,5,5,0,1,0
24,230,230,13,13,0,1,0
2,241,241,7,4,3,2,1
26,289,289,1,1,0,1,0
19,294,294,109,49,60,3,2
21,303,303,27,27,0,1,0
28,321,321,62,18,44,3,2
13,322,322,53,6,47,2,1
12,332,332,24,16,8,2,1
0,335,335,91,91,0,1,0
10,336,336,47,47,0,1,0
1,352,352,139,125,14,2,1
16,358,358,50,5,45,4,3
14,383,383,62,47,15,4,3
8,390,390,8,5,3,2,1
6,415,415,54,54,0,1,0
11,417,417,32,32,0,1,0
27,438,438,4,4,0,1,0
5,442,442,92,71,21,2,1
15,453,453,43,34,9,4,3
18,459,459,16,4,12,2,1
20,471,471,3,3,0,1,0
25,471,471,3,3,0,1,0
4,475,475,8,8,0,1,0
17,485,485,35,3,32,2,1

17,116,116,16,16,0,1,0
19,124,124,44,23,21,2,1
30,157,157,18,18,0,1,0
25,162,162,2,2,0,1,0
33,169,169,28,20,8,2,1
13,173,173,1,1,0,1,0
22,192,192,15,15,0,1,0
0,224,224,13,9,4,2,1
34,232,232,1,1,0,1,0
12,240,240,1,1,0,1,0
9,261,261,35,35,0,1,0
6,262,262,8,8,0,1,0
29,280,280,36,4,32,3,2
18,289,289,49,3,46,3,2
32,293,293,44,6,38,3,2
7,305,305,22,4,18,2,1
28,342,342,5,1,4,2,1
3,351,351,4,4,0,1,0
14,362,362,20,10,10,3,2
15,370,370,50,1,49,2,1
8,373,373,8,8,0,1,0
4,374,374,3,3,0,1,0
10,376,376,40,40,0,1,0
24,394,394,16,8,8,2,1
21,399,399,60,60,0,1,0
2,405,405,66,21,45,4,3
5,424,424,9,9,0,1,0
20,427,427,13,1,12,3,2
23,430,430,1,1,0,1,0
16,464,464,63,63,0,1,0
26,465,465,129,129,0,1,0
27,466,466,33,7,26,3,2
31,480,480,18,11,7,2,1
11,485,485,63,63,0,1,0
1,498,498,101,74,27,4,3

26,104,104,6,6,0,1,0
18,112,112,6,6,0,1,0
28,144,144,23,8,15,2,1
5,160,160,15,15,0,1,0
7,162,162,58,27,31,3,2
2,187,187,12,3,9,2,1
23,196,196,36,27,9,4,3
8,226,226,35,35,0,1,0
24,228,228,6,6,0,1,0
3,247,247,54,54,0,1,0
6,259,259,6,6,0,1,0
29,265,265,37,37,0,1,0
12,271,271,20,20,0,1,0
31,289,289,1,1,0,1,0
10,291,291,14,14,0,1,0
0,327,327,4,4,0,1,0
19,337,337,36,24,12,3,2
30,340,340,54,42,12,4,3
15,346,346,32,25,7,2,1
27,359,359,57,9,48,4,3
14,380,380,79,79,0,1,0
32,406,406,48,48,0,1,0
25,407,407,3,3,0,1,0
20,422,422,73,10,63,3,2
17,427,427,41,41,0,1,0
16,428,428,12,2,10,3,2
9,442,442,16,10,6,2,1
13,454,454,5,5,0,1,0
1,455,455,37,13,24,4,3
21,495,495,31,31,0,1,0
11,495,495,35,31,4,2,1
4,499,499,13,3,10,3,2
22,500,500,65,1,64,3,2

23,122,122,40,31,9,4,3
19,127,127,3,3,0,1,0
29,130,130,4,4,0,1,0
11,142,142,19,19,0,1,0
5,145,145,31,31,0,1,0
31,152,152,3,3,0,1,0
28,161,161,27,27,0,1,0
27,184,184,1,1,0,1,0
24,188,188,18,18,0,1,0
6,191,191,25,4,21,2,1
13,193,193,20,5,15,2,1
25,210,210,8,8,0,1,0
30,220,220,45,45,0,1,0
8,228,228,12,5,7,2,1
20,229,229,3,3,0,1,0
0,256,256,18,8,10,3,2
33,267,267,74,12,62,3,2
15,270,270,30,30,0,1,0
35,270,270,79,53,26,2,1
14,300,300,2,2,0,1,0
34,307,307,24,11,13,2,1
18,309,309,30,15,15,4,3
3,319,319,29,29,0,1,0
9,355,355,50,4,46,2,1
1,383,383,6,6,0,1,0
7,392,392,13,13,0,1,0
4,419,419,53,53,0,1,0
21,427,427,6,6,0,1,0
32,431,431,2,2,0,1,0
16,436,436,8,8,0,1,0
26,439,439,23,23,0,1,0
22,455,455,1,1,0,1,0
12,470,470,26,2,24,2,1
10,480,480,36,13,23,2,1
17,488,488,23,3,20,2,1
2,488,488,29,12,17,2,1

31,169,169,32,32,0,1,0
7,199,199,3,3,0,1,0
18,215,215,3,3,0,1,0
34,215,215,33,16,17,2,1
5,215,215,8,8,0,1,0
4,223,223,37,10,27,4,3
19,244,244,3,3,0,1,0
28,261,261,11,1,10,2,1
27,284,284,10,10,0,1,0
12,292,292,18,4,14,3,2
11,298,298,21,21,0,1,0
29,300,300,21,21,0,1,0
22,308,308,21,21,0,1,0
17,316,316,17,5,12,3,2
23,317,317,21,15,6,3,2
0,332,332,5,5,0,1,0
10,356,356,75,45,30,4,3
6,366,366,5,5,0,1,0
1,367,367,96,96,0,1,0
15,399,399,35,8,27,4,3
25,401,401,62,32,30,2,1
33,408,408,41,41,0,1,0
16,408,408,29,29,0,1,0
9,409,409,8,8,0,1,0
32,439,439,37,14,23,2,1
2,445,445,3,3,0,1,0
24,471,471,66,2,64,3,2
21,473,473,66,66,0,1,0
3,477,477,101,101,0,1,0
8,478,478,11,5,6,2,1
30,478,478,28,28,0,1,0
14,479,479,40,40,0,1,0
13,486,486,87,4,83,4,3
26,488,488,2,2,0,1,0
20,496,496,152,152,0,1,0

32,106,106,35,23,12,3,2
40,110,110,5,1,4,2,1
14,127,127,5,5,0,1,0
27,167,167,2,2,0,1,0
21,175,175,9,9,0,1,0
6,190,190,8,8,0,1,0
7,203,203,4,4,0,1,0
37,204,204,11,11,0,1,0
2,224,224,22,15,7,2,1
18,225,225,5,5,0,1,0
17,233,233,7,7,0,1,0
10,243,243,9,9,0,1,0
23,263,263,4,4,0,1,0
34,266,266,37,2,35,3,2
22,272,272,25,25,0,1,0
13,289,289,44,44,0,1,0
5,297,297,10,7,3,2,1
4,302,302,26,7,19,3,2
15,306,306,17,17,0,1,0
20,306,306,3,3,0,1,0
11,306,306,10,10,0,1,0
36,308,308,28,28,0,1,0
26,316,316,18,18,0,1,0
41,324,324,53,53,0,1,0
24,331,331,56,26,30,3,2
0,345,345,9,9,0,1,0
39,346,346,54,17,37,2,1
31,348,348,8,2,6,3,2
30,349,349,67,47,20,4,3
9,352,352,66,66,0,1,0
28,374,374,18,14,4,2,1
29,379,379,12,2,10,2,1
25,386,386,2,2,0,1,0
38,432,432,70,12,58,4,3
19,434,434,15,15,0,1,0
8,440,440,3,3,0,1,0
33,441,441,60,36,24,4,3
16,441,441,38,12,26,2,1
42,460,460,14,14,0,1,0
1,477,477,12,6,6,3,2
3,483,483,24,10,14,2,1
35,485,485,8,8,0,1,0
12,487,487,66,21,45,4,3

10,101,101,3,3,0,1,0
7,116,116,16,16,0,1,0
2,133,133,1,1,0,1,0
26,143,143,10,10,0,1,0
21,184,184,75,75,0,1,0
24,207,207,26,5,21,4,3
19,220,220,16,16,0,1,0
12,237,237,73,73,0,1,0
29,237,237,1,1,0,1,0
11,274,274,14,14,0,1,0
0,291,291,9,5,4,2,1
30,301,301,42,42,0,1,0
20,301,301,61,7,54,4,3
17,308,308,29,3,26,2,1
15,320,320,2,2,0,1,0
3,336,336,5,5,0,1,0
27,342,342,1,1,0,1,0
13,348,348,49,49,0,1,0
14,351,351,25,20,5,2,1
22,371,371,10,4,6,2,1
9,372,372,53,13,40,4,3
5,391,391,21,21,0,1,0
23,393,393,4,4,0,1,0
6,404,404,65,65,0,1,0
1,408,408,119,119,0,1,0
25,428,428,36,36,0,1,0
18,450,450,33,9,24,4,3
4,458,458,37,37,0,1,0
28,485,485,138,75,63,4,3
16,493,493,11,3,8,3,2
8,494,494,39,6,33,3,2

33,116,116,12,6,6,2,1
10,126,126,6,6,0,1,0
1,142,142,23,11,12,4,3
13,143,143,33,20,13,2,1
3,161,161,7,3,4,2,1
22,164,164,4,4,0,1,0
24,184,184,28,14,14,2,1
20,187,187,33,33,0,1,0
2,202,202,10,4,6,2,1
25,203,203,4,4,0,1,0
32,206,206,3,3,0,1,0
34,224,224,34,34,0,1,0
27,224,224,46,1,45,4,3
29,249,249,46,38,8,2,1
7,252,252,15,10,5,2,1
12,264,264,13,9,4,2,1
23,268,268,14,5,9,4,3
9,275,275,4,4,0,1,0
0,276,276,10,10,0,1,0
15,308,308,46,46,0,1,0
21,323,323,59,16,43,2,1
4,325,325,41,23,18,3,2
30,332,332,4,1,3,2,1
31,349,349,22,22,0,1,0
26,363,363,14,6,8,2,1
5,385,385,41,41,0,1,0
19,407,407,6,6,0,1,0
11,439,439,9,9,0,1,0
6,441,441,6,6,0,1,0
14,456,456,5,5,0,1,0
17,458,458,28,21,7,2,1
8,460,460,104,52,52,3,2
18,475,475,34,6,28,3,2
16,483,483,59,25,34,2,1
28,486,486,118,28,90,4,3

26,106,106,2,2,0,1,0
7,124,124,5,5,0,1,0
15,125,125,2,2,0,1,0
27,131,131,18,3,15,4,3
20,158,158,2,2,0,1,0
25,162,162,13,5,8,3,2
19,165,165,6,6,0,1,0
4,174,174,24,24,0,1,0
10,185,185,17,17,0,1,0
1,186,186,10,2,8,3,2
9,188,188,1,1,0,1,0
17,191,191,12,12,0,1,0
2,213,213,41,8,33,2,1
12,221,221,6,3,3,2,1
0,290,290,23,23,0,1,0
16,297,297,13,1,12,4,3
22,306,306,158,158,0,1,0
24,319,319,80,80,0,1,0
14,338,338,69,69,0,1,0
3,345,345,143,143,0,1,0
11,354,354,1,1,0,1,0
29,359,359,56,22,34,3,2
6,391,391,77,44,33,2,1
30,398,398,71,21,50,3,2
28,413,413,16,16,0,1,0
13,415,415,11,11,0,1,0
21,431,431,16,3,13,4,3
18,456,456,1,1,0,1,0
23,490,490,20,20,0,1,0
5,493,493,20,20,0,1,0
8,499,499,44,44,0,1,0

26,100,100,1,1,0,1,0
29,100,100,14,14,0,1,0
15,102,102,4,4,0,1,0
3,107,107,3,3,0,1,0
8,109,109,13,3,10,2,1
17,111,111,1,1,0,1,0
5,146,146,38,11,27,4,3
31,151,151,6,6,0,1,0
37,161,161,6,6,0,1,0
21,170,170,2,2,0,1,0
33,172,172,1,1,0,1,0
20,205,205,7,7,0,1,0
13,226,226,60,60,0,1,0
38,236,236,41,41,0,1,0
18,239,239,11,11,0,1,0
6,251,251,9,6,3,2,1
32,262,262,15,15,0,1,0
24,288,288,1,1,0,1,0
0,290,290,9,9,0,1,0
16,290,290,21,21,0,1,0
9,293,293,22,3,19,2,1
23,293,293,63,63,0,1,0
2,313,313,1,1,0,1,0
22,318,318,31,13,18,2,1
12,321,321,22,22,0,1,0
35,328,328,7,7,0,1,0
30,330,330,152,145,7,2,1
25,339,339,52,36,16,3,2
4,343,343,60,60,0,1,0
11,347,347,6,6,0,1,0
28,390,390,79,52,27,4,3
14,393,393,19,7,12,4,3
36,393,393,2,2,0,1,0
1,405,405,42,42,0,1,0
7,405,405,1,1,0,1,0
19,419,419,6,6,0,1,0
27,430,430,6,3,3,2,1
10,434,434,19,19,0,1,0
34,434,434,44,30,14,3,2

10,113,113,28,13,15,4,3
29,152,152,8,8,0,1,0
20,167,167,11,2,9,4,3
12,179,179,18,3,15,2,1
5,192,192,16,16,0,1,0
7,204,204,18,18,0,1,0
19,215,215,14,2,12,4,3
1,236,236,3,3,0,1,0
11,236,236,17,17,0,1,0
28,236,236,2,2,0,1,0
6,245,245,16,16,0,1,0
17,261,261,78,39,39,4,3
8,265,265,15,15,0,1,0
9,272,272,12,12,0,1,0
26,278,278,73,63,10,2,1
4,278,278,26,26,0,1,0
13,286,286,20,20,0,1,0
30,305,305,1,1,0,1,0
22,320,320,2,2,0,1,0
2,322,322,59,32,27,4,3
18,322,322,54,4,50,3,2
27,344,344,11,7,4,2,1
25,346,346,1,1,0,1,0
15,355,355,85,43,42,3,2
21,362,362,78,78,0,1,0
23,371,371,91,58,33,3,2
16,399,399,58,4,54,3,2
0,426,426,27,12,15,4,3
14,435,435,37,37,0,1,0
31,435,435,17,3,14,4,3
24,465,465,7,7,0,1,0
3,485,485,47,47,0,1,0

10,114,114,2,2,0,1,0
28,119,119,17,17,0,1,0
31,139,139,50,50,0,1,0
26,152,152,4,1,3,2,1
27,153,153,13,4,9,4,3
36,153,153,2,2,0,1,0
30,163,163,1,1,0,1,0
15,182,182,11,5,6,3,2
3,194,194,10,10,0,1,0
8,194,194,37,25,12,4,3
29,198,198,20,20,0,1,0
21,200,200,9,9,0,1,0
6,202,202,6,6,0,1,0
32,206,206,5,1,4,2,1
11,213,213,18,3,15,2,1
24,229,229,77,31,46,2,1
25,234,234,33,33,0,1,0
23,238,238,22,22,0,1,0
5,244,244,31,3,28,2,1
13,259,259,7,1,6,2,1
16,263,263,68,68,0,1,0
9,271,271,28,28,0,1,0
34,298,298,32,25,7,2,1
0,299,299,1,1,0,1,0
1,307,307,46,22,24,3,2
35,324,324,12,12,0,1,0
20,340,340,1,1,0,1,0
2,362,362,2,2,0,1,0
33,373,373,25,19,6,2,1
17,383,383,29,1,28,3,2
37,404,404,20,20,0,1,0
12,408,408,41,27,14,2,1
7,409,409,37,37,0,1,0
14,450,450,5,5,0,1,0
19,465,465,2,2,0,1,0
22,472,472,25,25,0,1,0
18,477,477,38,23,15,4,3
4,484,484,40,1,39,2,1

9,115,115,3,3,0,1,0
17,123,123,6,6,0,1,0
0,127,127,1,1,0,1,0
3,135,135,31,22,9,2,1
2,139,139,4,1,3,2,1
32,146,146,21,21,0,1,0
5,149,149,10,10,0,1,0
24,168,168,46,13,33,2,1
15,198,198,17,17,0,1,0
8,201,201,61,11,50,4,3
4,219,219,35,35,0,1,0
12,221,221,1,1,0,1,0
29,221,221,4,4,0,1,0
26,222,222,59,23,36,3,2
19,229,229,1,1,0,1,0
10,247,247,5,5,0,1,0
7,260,260,4,4,0,1,0
28,263,263,8,1,7,2,1
30,311,311,25,13,12,4,3
14,314,314,70,10,60,3,2
11,325,325,1,1,0,1,0
20,341,341,20,7,13,2,1
25,342,342,3,3,0,1,0
1,344,344,36,6,30,4,3
6,350,350,20,6,14,3,2
27,364,364,1,1,0,1,0
21,380,380,74,49,25,2,1
31,382,382,98,57,41,2,1
16,388,388,81,81,0,1,0
22,389,389,44,44,0,1,0
23,397,397,5,1,4,2,1
18,460,460,31,4,27,2,1
13,463,463,5,5,0,1,0
33,485,485,49,13,36,4,3

5,107,107,19,5,14,3,2
9,135,135,22,22,0,1,0
23,170,170,35,35,0,1,0
8,268,268,42,42,0,1,0
4,277,277,66,66,0,1,0
24,277,277,30,30,0,1,0
25,279,279,14,2,12,4,3
12,290,290,13,13,0,1,0
7,299,299,2,2,0,1,0
14,313,313,39,39,0,1,0
15,331,331,2,2,0,1,0
17,335,335,56,2,54,4,3
10,339,339,16,2,14,3,2
19,360,360,55,13,42,2,1
22,367,367,32,8,24,2,1
6,372,372,82,82,0,1,0
2,372,372,93,93,0,1,0
20,373,373,24,16,8,2,1
21,395,395,18,5,13,2,1
0,401,401,18,18,0,1,0
16,423,423,34,4,30,4,3
13,429,429,32,32,0,1,0
26,437,437,95,51,44,3,2
1,456,456,79,18,61,4,3
18,457,457,78,78,0,1,0
3,473,473,58,36,22,3,2
11,495,495,12,6,6,3,2

23,105,105,9,2,7,2,1
1,126,126,6,6,0,1,0
7,137,137,4,4,0,1,0
30,143,143,11,11,0,1,0
3,149,149,9,9,0,1,0
38,150,150,16,16,0,1,0
27,154,154,13,5,8,3,2
32,182,182,6,6,0,1,0
10,203,203,10,2,8,2,1
37,212,212,19,5,14,3,2
29,214,214,31,13,18,2,1
5,215,215,23,23,0,1,0
41,223,223,34,15,19,2,1
33,224,224,16,16,0,1,0
25,229,229,16,7,9,4,3
26,238,238,33,33,0,1,0
12,253,253,8,8,0,1,0
24,255,255,2,2,0,1,0
39,260,260,26,16,10,2,1
34,262,262,59,5,54,3,2
31,273,273,16,16,0,1,0
14,276,276,1,1,0,1,0
19,277,277,31,31,0,1,0
15,281,281,6,2,4,2,1
11,305,305,63,51,12,2,1
20,311,311,12,12,0,1,0
0,311,311,15,15,0,1,0
18,316,316,70,52,18,2,1
16,330,330,36,36,0,1,0
13,334,334,1,1,0,1,0
6,335,335,8,8,0,1,0
2,339,339,5,5,0,1,0
9,344,344,14,7,7,2,1
35,355,355,29,17,12,3,2
8,366,366,21,12,9,4,3
21,372,372,3,3,0,1,0
28,377,377,14,9,5,2,1
36,388,388,27,3,24,3,2
22,417,417,26,26,0,1,0
17,420,420,7,7,0,1,0
40,429,429,72,60,12,2,1
4,441,441,56,56,0,1,0

14,111,111,4,4,0,1,0
25,119,119,14,14,0,1,0
22,121,121,1,1,0,1,0
16,166,166,2,2,0,1,0
19,169,169,1,1,0,1,0
32,183,183,27,6,21,4,3
15,185,185,7,7,0,1,0
17,192,192,4,1,3,2,1
5,204,204,3,3,0,1,0
11,219,219,14,11,3,2,1
3,239,239,18,12,6,2,1
23,246,246,4,4,0,1,0
26,254,254,42,42,0,1,0
10,262,262,5,5,0,1,0
13,267,267,19,3,16,3,2
12,273,273,6,1,5,2,1
24,286,286,50,2,48,4,3
20,288,288,16,16,0,1,0
8,311,311,61,61,0,1,0
21,311,311,9,9,0,1,0
6,355,355,66,30,36,3,2
29,385,385,144,114,30,2,1
31,391,391,33,33,0,1,0
28,393,393,32,32,0,1,0
7,394,394,10,10,0,1,0
30,413,413,9,9,0,1,0
18,420,420,95,72,23,4,3
1,430,430,20,20,0,1,0
9,434,434,106,106,0,1,0
4,455,455,48,6,42,4,3
0,483,483,5,5,0,1,0
2,488,488,214,214,0,1,0
27,492,492,46,20,26,2,1

16,155,155,1,1,0,1,0
17,164,164,16,16,0,1,0
10,166,166,12,9,3,2,1
23,184,184,42,24,18,3,2
19,203,203,34,34,0,1,0
13,231,231,49,49,0,1,0
18,242,242,9,9,0,1,0
6,254,254,44,44,0,1,0
28,260,260,40,40,0,1,0
4,266,266,57,7,50,4,3
1,288,288,121,113,8,2,1
5,301,301,33,22,11,2,1
11,308,308,19,19,0,1,0
3,310,310,23,23,0,1,0
21,325,325,33,15,18,4,3
9,331,331,4,4,0,1,0
0,362,362,68,55,13,2,1
22,363,363,55,37,18,3,2
12,370,370,73,58,15,4,3
24,394,394,1,1,0,1,0
14,409,409,17,3,14,3,2
2,419,419,19,19,0,1,0
8,467,467,14,14,0,1,0
25,468,468,31,6,25,2,1
27,473,473,7,7,0,1,0
26,493,493,39,39,0,1,0
15,494,494,62,62,0,1,0
7,496,496,1,1,0,1,0
20,500,500,74,51,23,3,2

11,110,110,2,2,0,1,0
32,111,111,13,13,0,1,0
17,112,112,13,7,6,2,1
14,126,126,5,1,4,2,1
20,128,128,2,2,0,1,0
31,138,138,8,3,5,2,1
21,167,167,53,26,27,4,3
7,170,170,4,4,0,1,0
3,185,185,19,19,0,1,0
30,196,196,1,1,0,1,0
12,201,201,7,1,6,2,1
16,204,204,1,1,0,1,0
8,220,220,19,7,12,4,3
18,222,222,17,5,12,2,1
23,262,262,4,4,0,1,0
24,263,263,28,28,0,1,0
19,271,271,54,24,30,4,3
26,271,271,3,3,0,1,0
9,285,285,42,20,22,2,1
33,287,287,3,3,0,1,0
27,294,294,2,2,0,1,0
35,322,322,49,35,14,3,2
15,341,341,55,27,28,2,1
34,348,348,22,22,0,1,0
6,349,349,15,9,6,2,1
29,350,350,130,88,42,3,2
0,376,376,49,49,0,1,0
4,390,390,4,4,0,1,0
5,396,396,44,6,38,4,3
28,400,400,67,67,0,1,0
1,409,409,5,5,0,1,0
25,413,413,11,3,8,2,1
22,414,414,79,65,14,2,1
10,444,444,81,81,0,1,0
2,469,469,36,36,0,1,0
13,489,489,13,4,9,4,3

24,111,111,8,8,0,1,0
13,140,140,78,16,62,3,2
14,144,144,29,1,28,3,2
4,155,155,5,1,4,2,1
28,165,165,6,6,0,1,0
11,196,196,6,6,0,1,0
9,215,215,12,3,9,4,3
27,221,221,1,1,0,1,0
17,229,229,15,11,4,2,1
19,229,229,6,3,3,2,1
22,231,231,4,4,0,1,0
5,247,247,20,10,10,3,2
25,253,253,23,23,0,1,0
16,266,266,26,26,0,1,0
12,295,295,1,1,0,1,0
1,298,298,127,92,35,2,1
21,308,308,30,30,0,1,0
20,310,310,1,1,0,1,0
2,328,328,3,3,0,1,0
15,338,338,64,64,0,1,0
8,342,342,99,99,0,1,0
26,375,375,49,34,15,4,3
18,378,378,6,6,0,1,0
10,400,400,66,66,0,1,0
6,406,406,19,19,0,1,0
7,423,423,72,63,9,4,3
0,437,437,47,47,0,1,0
23,454,454,15,10,5,2,1
3,483,483,89,44,45,3,2

10,100,100,1,1,0,1,0
4,114,114,1,1,0,1,0
15,114,114,1,1,0,1,0
19,133,133,15,15,0,1,0
3,135,135,2,2,0,1,0
29,196,196,90,90,0,1,0
0,214,214,14,14,0,1,0
8,215,215,26,12,14,2,1
28,218,218,40,40,0,1,0
2,230,230,16,16,0,1,0
11,240,240,10,10,0,1,0
16,246,246,18,2,16,3,2
6,253,253,19,12,7,2,1
27,259,259,24,1,23,2,1
1,260,260,37,37,0,1,0
5,275,275,34,12,22,2,1
20,281,281,72,2,70,3,2
17,286,286,17,17,0,1,0
9,290,290,50,50,0,1,0
14,306,306,9,9,0,1,0
24,321,321,16,16,0,1,0
31,335,335,11,11,0,1,0
23,335,335,48,48,0,1,0
32,342,342,20,6,14,2,1
12,346,346,1,1,0,1,0
34,356,356,12,4,8,3,2
30,384,384,35,35,0,1,0
26,405,405,3,3,0,1,0
33,414,414,30,21,9,2,1
25,437,437,21,9,12,2,1
18,438,438,18,4,14,3,2
36,462,462,71,23,48,4,3
21,465,465,23,23,0,1,0
13,470,470,11,11,0,1,0
35,481,481,34,5,29,2,1
7,497,497,75,36,39,2,1
22,498,498,36,36,0,1,0

28,103,103,1,1,0,1,0
20,116,116,6,3,3,2,1
21,127,127,27,14,13,2,1
19,146,146,3,3,0,1,0
16,159,159,21,21,0,1,0
15,183,183,5,1,4,2,1
29,198,198,7,7,0,1,0
5,201,201,45,23,22,3,2
17,232,232,6,6,0,1,0
30,241,241,57,30,27,4,3
8,242,242,3,3,0,1,0
23,251,251,35,35,0,1,0
11,261,261,14,14,0,1,0
4,288,288,9,9,0,1,0
33,298,298,5,1,4,2,1
32,301,301,13,4,9,4,3
0,303,303,19,12,7,2,1
27,303,303,32,32,0,1,0
14,310,310,33,19,14,2,1
9,321,321,12,3,9,4,3
35,324,324,7,7,0,1,0
34,336,336,60,60,0,1,0
31,341,341,65,29,36,4,3
24,357,357,62,62,0,1,0
25,373,373,2,2,0,1,0
18,398,398,53,17,36,4,3
2,405,405,8,4,4,2,1
7,410,410,70,52,18,2,1
13,410,410,93,93,0,1,0
3,430,430,10,10,0,1,0
6,430,430,30,9,21,2,1
12,434,434,35,35,0,1,0
10,465,465,18,2,16,4,3
26,468,468,30,30,0,1,0
22,477,477,75,6,69,4,3
1,495,495,54,54,0,1,0

6,120,120,2,2,0,1,0
15,133,133,17,8,9,4,3
23,135,135,26,4,22,2,1
8,137,137,7,7,0,1,0
21,145,145,14,14,0,1,0
9,153,153,25,1,24,3,2
27,162,162,30,27,3,2,1
10,166,166,8,8,0,1,0
24,167,167,2,2,0,1,0
20,190,190,13,13,0,1,0
2,226,226,50,50,0,1,0
26,246,246,41,19,22,3,2
25,281,281,24,19,5,2,1
17,282,282,42,42,0,1,0
1,285,285,14,14,0,1,0
29,297,297,5,1,4,2,1
7,320,320,5,5,0,1,0
4,322,322,74,74,0,1,0
16,329,329,104,104,0,1,0
11,334,334,37,26,11,2,1
28,348,348,16,3,13,2,1
14,378,378,17,17,0,1,0
5,409,409,117,112,5,2,1
3,421,421,77,77,0,1,0
19,428,428,31,31,0,1,0
18,431,431,19,7,12,2,1
12,465,465,1,1,0,1,0
22,487,487,3,3,0,1,0
0,495,495,104,23,81,4,3
13,497,497,7,7,0,1,0

26,120,120,1,1,0,1,0
6,122,122,1,1,0,1,0
11,126,126,16,16,0,1,0
3,136,136,4,4,0,1,0
22,148,148,8,8,0,1,0
9,150,150,10,5,5,2,1
34,187,187,18,18,0,1,0
24,193,193,17,5,12,4,3
7,206,206,32,32,0,1,0
12,232,232,7,2,5,2,1
32,245,245,15,3,12,4,3
14,246,246,1,1,0,1,0
8,251,251,5,1,4,2,1
29,260,260,12,2,10,2,1
0,281,281,31,19,12,4,3
25,288,288,89,77,12,3,2
19,292,292,4,4,0,1,0
10,295,295,14,14,0,1,0
23,340,340,3,3,0,1,0
13,349,349,65,56,9,4,3
33,366,366,64,19,45,3,2
18,370,370,29,29,0,1,0
28,375,375,19,10,9,2,1
2,387,387,2,2,0,1,0
5,389,389,31,31,0,1,0
17,398,398,51,51,0,1,0
27,407,407,85,63,22,3,2
16,429,429,47,32,15,4,3
20,429,429,66,66,0,1,0
31,432,432,14,5,9,2,1
1,451,451,16,16,0,1,0
4,464,464,28,6,22,2,1
30,468,468,20,13,7,2,1
21,469,469,132,81,51,4,3
15,471,471,150,30,120,4,3

32,110,110,24,24,0,1,0
10,116,116,16,1,15,2,1
3,139,139,33,33,0,1,0
24,145,145,14,14,0,1,0
14,150,150,1,1,0,1,0
4,153,153,23,13,10,2,1
26,182,182,35,35,0,1,0
33,183,183,18,18,0,1,0
2,185,185,18,5,13,2,1
5,209,209,14,14,0,1,0
16,214,214,9,9,0,1,0
9,218,218,14,4,10,2,1
31,222,222,5,5,0,1,0
27,234,234,18,3,15,4,3
25,244,244,13,5,8,3,2
18,276,276,11,11,0,1,0
29,286,286,34,3,31,2,1
30,293,293,14,1,13,3,2
19,298,298,16,11,5,2,1
21,300,300,10,1,9,4,3
28,308,308,65,65,0,1,0
17,310,310,24,9,15,2,1
12,318,318,32,32,0,1,0
22,382,382,33,33,0,1,0
13,416,416,48,48,0,1,0
15,418,418,2,2,0,1,0
1,426,426,3,3,0,1,0
8,426,426,39,20,19,2,1
20,432,432,16,16,0,1,0
11,437,437,15,4,11,2,1
6,458,458,16,16,0,1,0
23,493,493,120,120,0,1,0
0,493,493,103,67,36,4,3
7,496,496,62,53,9,4,3

26,100,100,10,10,0,1,0
15,112,112,28,28,0,1,0
11,147,147,74,32,42,3,2
6,201,201,14,14,0,1,0
23,205,205,61,29,32,2,1
24,217,217,11,7,4,2,1
19,237,237,23,8,15,4,3
21,258,258,27,23,4,2,1
10,261,261,25,5,20,3,2
13,270,270,7,7,0,1,0
27,276,276,36,15,21,4,3
4,285,285,14,14,0,1,0
16,295,295,13,13,0,1,0
12,303,303,7,7,0,1,0
1,310,310,6,6,0,1,0
14,315,315,45,19,26,3,2
5,348,348,54,54,0,1,0
22,370,370,42,42,0,1,0
0,383,383,30,6,24,2,1
17,398,398,8,8,0,1,0
9,401,401,61,34,27,4,3
25,411,411,4,1,3,2,1
2,418,418,24,6,18,3,2
18,426,426,68,68,0,1,0
3,445,445,27,27,0,1,0
7,463,463,56,56,0,1,0
20,478,478,35,35,0,1,0
8,487,487,119,98,21,2,1

2,111,111,2,2,0,1,0
11,131,131,5,5,0,1,0
37,142,142,17,17,0,1,0
28,147,147,1,1,0,1,0
33,151,151,9,9,0,1,0
25,155,155,2,2,0,1,0
29,162,162,4,4,0,1,0
4,197,197,15,15,0,1,0
16,199,199,1,1,0,1,0
30,202,202,13,13,0,1,0
8,207,207,1,1,0,1,0
9,224,224,5,5,0,1,0
38,226,226,11,11,0,1,0
32,262,262,6,6,0,1,0
31,287,287,12,12,0,1,0
19,290,290,5,5,0,1,0
22,292,292,3,3,0,1,0
27,295,295,92,73,19,2,1
23,302,302,30,30,0,1,0
15,302,302,11,3,8,2,1
10,307,307,20,8,12,2,1
21,309,309,21,2,19,2,1
12,329,329,45,45,0,1,0
18,331,331,58,58,0,1,0
24,331,331,13,3,10,3,2
17,352,352,19,19,0,1,0
3,361,361,76,24,52,4,3
36,366,366,72,72,0,1,0
39,369,369,1,1,0,1,0
1,383,383,40,40,0,1,0
35,401,401,164,47,117,4,3
20,404,404,39,39,0,1,0
0,405,405,25,4,21,2,1
6,408,408,77,77,0,1,0
5,423,423,12,12,0,1,0
26,430,430,103,28,75,4,3
7,439,439,7,7,0,1,0
40,443,443,7,1,6,3,2
13,489,489,1,1,0,1,0
14,499,499,13,13,0,1,0
34,500,500,29,29,0,1,0

21,135,135,9,9,0,1,0
15,155,155,19,2,17,2,1
17,176,176,15,15,0,1,0
0,178,178,6,6,0,1,0
29,187,187,24,8,16,4,3
11,200,200,26,26,0,1,0
30,201,201,48,6,42,4,3
26,208,208,19,19,0,1,0
7,211,211,31,21,10,3,2
10,220,220,34,7,27,4,3
6,227,227,1,1,0,1,0
27,239,239,56,14,42,3,2
16,261,261,4,4,0,1,0
34,266,266,13,13,0,1,0
9,281,281,1,1,0,1,0
25,292,292,50,14,36,3,2
19,298,298,15,9,6,2,1
22,312,312,3,3,0,1,0
18,317,317,1,1,0,1,0
13,333,333,39,25,14,2,1
23,342,342,18,6,12,3,2
24,348,348,22,18,4,2,1
33,357,357,61,23,38,3,2
14,364,364,87,87,0,1,0
32,417,417,6,6,0,1,0
8,432,432,20,3,17,2,1
20,443,443,33,2,31,2,1
1,452,452,73,64,9,2,1
2,462,462,3,3,0,1,0
5,463,463,73,73,0,1,0
31,464,464,54,26,28,3,2
12,466,466,27,12,15,2,1
4,492,492,21,3,18,4,3
3,495,495,36,36,0,1,0
28,499,499,49,49,0,1,0

16,115,115,9,9,0,1,0
27,116,116,5,5,0,1,0
2,121,121,3,3,0,1,0
8,121,121,8,8,0,1,0
23,130,130,6,6,0,1,0
0,148,148,9,4,5,2,1
28,153,153,14,14,0,1,0
3,154,154,2,2,0,1,0
33,177,177,8,8,0,1,0
15,188,188,28,20,8,2,1
19,224,224,19,11,8,3,2
10,246,246,2,2,0,1,0
7,255,255,28,28,0,1,0
30,266,266,27,27,0,1,0
26,278,278,117,97,20,2,1
29,279,279,51,51,0,1,0
14,283,283,112,104,8,3,2
17,285,285,11,1,10,2,1
25,285,285,36,16,20,2,1
20,286,286,13,4,9,2,1
18,293,293,41,3,38,3,2
22,297,297,15,6,9,2,1
13,311,311,11,11,0,1,0
1,325,325,27,27,0,1,0
21,327,327,4,1,3,2,1
31,328,328,11,1,10,3,2
12,334,334,37,22,15,2,1
24,339,339,24,24,0,1,0
5,357,357,74,8,66,3,2
6,396,396,28,28,0,1,0
9,440,440,11,11,0,1,0
32,457,457,64,64,0,1,0
4,459,459,7,7,0,1,0
11,476,476,52,40,12,2,1

31,109,109,6,6,0,1,0
1,113,113,3,3,0,1,0
36,122,122,20,20,0,1,0
10,124,124,1,1,0,1,0
26,148,148,12,12,0,1,0
20,151,151,13,8,5,2,1
6,151,151,2,2,0,1,0
28,156,156,11,11,0,1,0
22,171,171,15,10,5,2,1
3,183,183,8,1,7,2,1
14,191,191,58,46,12,4,3
5,221,221,25,25,0,1,0
30,237,237,53,33,20,3,2
24,240,240,18,13,5,2,1
16,254,254,24,9,15,4,3
12,266,266,25,1,24,3,2
13,276,276,13,1,12,3,2
29,298,298,16,7,9,4,3
35,299,299,2,2,0,1,0
32,304,304,45,45,0,1,0
0,315,315,10,6,4,2,1
15,332,332,1,1,0,1,0
25,350,350,35,35,0,1,0
9,361,361,117,75,42,3,2
33,363,363,24,3,21,4,3
23,405,405,59,59,0,1,0
2,408,408,10,10,0,1,0
27,414,414,69,69,0,1,0
18,438,438,80,80,0,1,0
37,447,447,55,47,8,3,2
17,447,447,23,23,0,1,0
4,449,449,23,23,0,1,0
11,461,461,1,1,0,1,0
8,466,466,9,9,0,1,0
34,468,468,29,29,0,1,0
19,476,476,7,7,0,1,0
21,488,488,15,6,9,4,3
7,494,494,17,17,0,1,0

1,120,120,1,1,0,1,0
29,123,123,11,8,3,2,1
22,126,126,4,4,0,1,0
7,129,129,1,1,0,1,0
18,136,136,24,5,19,3,2
34,154,154,14,3,11,2,1
0,172,172,41,26,15,4,3
21,175,175,1,1,0,1,0
4,176,176,12,12,0,1,0
33,186,186,1,1,0,1,0
16,197,197,60,48,12,3,2
30,198,198,12,12,0,1,0
14,207,207,34,34,0,1,0
12,229,229,18,18,0,1,0
5,237,237,1,1,0,1,0
9,251,251,7,4,3,2,1
19,251,251,22,10,12,4,3
15,274,274,8,8,0,1,0
3,285,285,9,1,8,3,2
28,316,316,87,69,18,3,2
31,321,321,70,70,0,1,0
10,325,325,1,1,0,1,0
17,326,326,10,10,0,1,0
20,333,333,2,2,0,1,0
11,333,333,1,1,0,1,0
13,350,350,23,3,20,3,2
37,354,354,1,1,0,1,0
23,371,371,99,99,0,1,0
6,381,381,39,39,0,1,0
38,387,387,63,63,0,1,0
25,391,391,3,3,0,1,0
2,391,391,7,3,4,2,1
36,401,401,11,11,0,1,0
32,407,407,84,84,0,1,0
27,435,435,12,2,10,2,1
8,440,440,47,47,0,1,0
24,472,472,25,25,0,1,0
35,484,484,42,42,0,1,0
26,494,494,25,1,24,2,1

25,124,124,6,6,0,1,0
6,128,128,19,1,18,4,3
2,133,133,1,1,0,1,0
17,164,164,4,4,0,1,0
8,176,176,1,1,0,1,0
7,179,179,25,7,18,2,1
4,180,180,6,6,0,1,0
9,182,182,27,27,0,1,0
20,185,185,22,22,0,1,0
5,196,196,7,7,0,1,0
3,202,202,31,31,0,1,0
26,236,236,19,19,0,1,0
24,247,247,52,4,48,4,3
12,284,284,56,40,16,3,2
15,307,307,11,11,0,1,0
11,311,311,43,43,0,1,0
23,315,315,78,22,56,3,2
14,324,324,82,31,51,4,3
13,347,347,42,42,0,1,0
21,381,381,19,4,15,2,1
27,388,388,13,13,0,1,0
18,404,404,32,6,26,2,1
22,428,428,90,90,0,1,0
0,430,430,50,16,34,3,2
16,440,440,59,32,27,4,3
10,445,445,41,3,38,3,2
1,448,448,5,5,0,1,0
30,448,448,38,38,0,1,0
29,467,467,28,8,20,2,1
19,472,472,18,18,0,1,0
28,493,493,87,87,0,1,0

27,117,117,26,11,15,2,1
22,182,182,14,1,13,2,1
15,188,188,4,4,0,1,0
21,194,194,9,9,0,1,0
24,195,195,10,10,0,1,0
30,223,223,5,5,0,1,0
28,233,233,53,53,0,1,0
14,236,236,8,8,0,1,0
19,244,244,3,3,0,1,0
16,264,264,22,22,0,1,0
0,265,265,7,3,4,2,1
18,280,280,66,26,40,3,2
2,286,286,14,1,13,2,1
26,298,298,46,46,0,1,0
3,299,299,30,30,0,1,0
17,304,304,8,8,0,1,0
5,310,310,9,9,0,1,0
1,319,319,12,12,0,1,0
8,343,343,61,22,39,4,3
29,352,352,83,40,43,2,1
7,386,386,79,33,46,3,2
20,394,394,32,32,0,1,0
6,404,404,7,7,0,1,0
4,407,407,70,34,36,4,3
10,408,408,40,40,0,1,0
12,428,428,43,36,7,2,1
13,435,435,6,6,0,1,0
9,449,449,135,96,39,4,3
31,465,465,2,2,0,1,0
23,472,472,11,11,0,1,0
11,491,491,109,52,57,4,3
25,495,495,61,8,53,4,3

19,105,105,1,1,0,1,0
10,110,110,24,24,0,1,0
15,150,150,34,26,8,3,2
2,162,162,57,15,42,4,3
28,174,174,9,9,0,1,0
26,177,177,18,1,17,2,1
31,183,183,22,22,0,1,0
0,183,183,15,8,7,2,1
9,191,191,5,5,0,1,0
3,202,202,5,1,4,2,1
12,243,243,35,2,33,4,3
18,255,255,17,1,16,2,1
4,271,271,21,21,0,1,0
20,280,280,1,1,0,1,0
23,283,283,11,11,0,1,0
16,295,295,4,4,0,1,0
22,298,298,36,2,34,3,2
5,301,301,48,44,4,2,1
6,344,344,10,10,0,1,0
25,347,347,93,93,0,1,0
13,362,362,20,10,10,2,1
14,364,364,4,4,0,1,0
27,367,367,115,115,0,1,0
29,382,382,17,17,0,1,0
21,391,391,24,24,0,1,0
11,402,402,41,3,38,2,1
30,414,414,45,45,0,1,0
8,433,433,13,13,0,1,0
1,449,449,25,11,14,2,1
7,461,461,3,3,0,1,0
17,478,478,34,22,12,4,3
24,493,493,118,75,43,2,1

2,106,106,3,3,0,1,0
14,133,133,29,22,7,2,1
26,170,170,36,36,0,1,0
0,179,179,2,2,0,1,0
8,195,195,9,5,4,2,1
29,197,197,3,3,0,1,0
16,207,207,15,15,0,1,0
1,215,215,8,2,6,2,1
11,224,224,7,7,0,1,0
17,238,238,12,12,0,1,0
31,240,240,27,16,11,2,1
15,242,242,1,1,0,1,0
10,266,266,26,20,6,2,1
18,267,267,6,6,0,1,0
32,268,268,2,2,0,1,0
21,271,271,31,7,24,2,1
30,284,284,49,11,38,3,2
3,285,285,124,30,94,3,2
9,287,287,4,4,0,1,0
5,312,312,15,3,12,4,3
7,315,315,76,76,0,1,0
20,329,329,102,81,21,4,3
27,347,347,67,67,0,1,0
24,368,368,19,9,10,2,1
6,372,372,38,16,22,3,2
12,399,399,26,2,24,2,1
4,402,402,18,13,5,2,1
19,411,411,22,6,16,3,2
25,424,424,61,61,0,1,0
13,430,430,46,46,0,1,0
23,434,434,7,3,4,2,1
22,434,434,43,7,36,3,2
28,485,485,27,9,18,3,2

9,100,100,15,6,9,2,1
4,113,113,7,7,0,1,0
27,139,139,4,4,0,1,0
15,153,153,11,3,8,2,1
0,168,168,28,28,0,1,0
5,184,184,15,15,0,1,0
26,187,187,30,30,0,1,0
8,194,194,17,14,3,2,1
14,260,260,21,21,0,1,0
29,269,269,25,5,20,3,2
3,270,270,37,5,32,3,2
21,271,271,31,27,4,2,1
23,272,272,31,4,27,2,1
28,281,281,5,5,0,1,0
20,285,285,3,3,0,1,0
25,288,288,159,159,0,1,0
2,316,316,1,1,0,1,0
24,325,325,24,24,0,1,0
1,335,335,130,52,78,4,3
22,362,362,48,48,0,1,0
17,364,364,15,12,3,2,1
16,374,374,10,10,0,1,0
19,380,380,7,7,0,1,0
6,380,380,11,11,0,1,0
12,401,401,56,34,22,2,1
13,402,402,13,13,0,1,0
10,416,416,37,27,10,3,2
11,451,451,58,58,0,1,0
18,481,481,47,34,13,2,1
7,491,491,53,53,0,1,0

1,126,126,1,1,0,1,0
22,131,131,4,4,0,1,0
24,169,169,18,18,0,1,0
11,177,177,8,8,0,1,0
0,192,192,83,33,50,2,1
12,244,244,18,11,7,2,1
6,245,245,68,68,0,1,0
16,249,249,16,3,13,2,1
8,266,266,1,1,0,1,0
19,270,270,17,7,10,3,2
13,284,284,10,10,0,1,0
23,285,285,73,73,0,1,0
21,294,294,15,4,11,2,1
2,302,302,40,10,30,3,2
14,315,315,3,3,0,1,0
5,346,346,27,27,0,1,0
20,352,352,91,25,66,4,3
9,367,367,20,20,0,1,0
27,371,371,9,9,0,1,0
17,375,375,61,15,46,2,1
7,392,392,73,38,35,2,1
25,410,410,51,19,32,2,1
15,469,469,14,14,0,1,0
10,472,472,17,17,0,1,0
26,473,473,122,122,0,1,0
28,473,473,6,1,5,2,1
4,475,475,90,90,0,1,0
3,484,484,41,41,0,1,0
18,485,485,66,53,13,2,1

18,115,115,5,2,3,2,1
10,126,126,1,1,0,1,0
19,147,147,26,26,0,1,0
26,156,156,50,11,39,4,3
20,183,183,5,5,0,1,0
0,192,192,55,55,0,1,0
9,219,219,5,5,0,1,0
16,240,240,19,19,0,1,0
3,275,275,28,28,0,1,0
6,299,299,31,31,0,1,0
2,300,300,70,70,0,1,0
7,302,302,50,2,48,4,3
8,305,305,121,28,93,4,3
1,312,312,3,3,0,1,0
27,313,313,29,17,12,3,2
4,332,332,68,47,21,2,1
22,349,349,38,32,6,2,1
11,376,376,18,18,0,1,0
12,380,380,8,8,0,1,0
24,384,384,11,11,0,1,0
14,398,398,31,31,0,1,0
25,409,409,88,61,27,4,3
17,426,426,24,24,0,1,0
15,454,454,14,14,0,1,0
23,457,457,85,44,41,4,3
21,458,458,44,8,36,3,2
5,476,476,10,10,0,1,0
13,477,477,29,29,0,1,0

20,106,106,19,7,12,4,3
7,132,132,11,3,8,2,1
18,147,147,11,1,10,3,2
5,150,150,12,1,11,3,2
14,158,158,2,2,0,1,0
3,164,164,11,5,6,3,2
10,164,164,73,59,14,3,2
6,179,179,27,27,0,1,0
2,184,184,5,5,0,1,0
0,221,221,13,13,0,1,0
15,223,223,28,23,5,2,1
29,236,236,5,5,0,1,0
9,239,239,17,17,0,1,0
26,240,240,9,1,8,3,2
21,247,247,16,1,15,2,1
25,258,258,74,74,0,1,0
11,260,260,19,19,0,1,0
1,278,278,27,27,0,1,0
24,307,307,52,42,10,2,1
17,335,335,23,23,0,1,0
19,344,344,24,14,10,3,2
27,354,354,64,25,39,4,3
22,373,373,46,46,0,1,0
23,377,377,31,4,27,4,3
12,384,384,8,5,3,2,1
13,388,388,14,4,10,2,1
30,415,415,55,15,40,4,3
28,419,419,6,6,0,1,0
8,458,458,32,19,13,2,1
16,461,461,1,1,0,1,0
4,488,488,150,52,98,4,3

6,100,100,14,3,11,2,1
15,132,132,27,11,16,2,1
24,133,133,7,7,0,1,0
22,139,139,11,11,0,1,0
16,163,163,7,7,0,1,0
10,179,179,42,35,7,2,1
12,179,179,62,62,0,1,0
18,202,202,4,4,0,1,0
1,208,208,31,13,18,4,3
0,239,239,16,11,5,2,1
13,250,250,10,7,3,2,1
27,255,255,6,6,0,1,0
5,258,258,2,2,0,1,0
11,271,271,42,42,0,1,0
28,272,272,86,50,36,2,1
2,294,294,21,21,0,1,0
25,320,320,47,47,0,1,0
9,320,320,15,3,12,4,3
23,394,394,14,5,9,3,2
7,400,400,22,22,0,1,0
26,407,407,7,7,0,1,0
20,431,431,59,12,47,2,1
14,434,434,72,72,0,1,0
17,435,435,65,65,0,1,0
19,453,453,53,4,49,2,1
8,455,455,27,27,0,1,0
4,455,455,76,76,0,1,0
3,472,472,49,49,0,1,0
21,495,495,41,15,26,3,2

3,108,108,9,4,5,2,1
2,116,116,19,19,0,1,0
13,140,140,9,9,0,1,0
14,151,151,25,8,17,2,1
10,162,162,5,5,0,1,0
25,164,164,13,3,10,3,2
18,173,173,16,10,6,2,1
12,186,186,103,59,44,2,1
6,219,219,10,10,0,1,0
8,226,226,12,12,0,1,0
9,255,255,14,8,6,2,1
26,274,274,8,3,5,2,1
5,295,295,54,54,0,1,0
15,295,295,9,4,5,2,1
16,332,332,31,1,30,4,3
23,336,336,78,78,0,1,0
27,342,342,3,3,0,1,0
11,346,346,9,1,8,2,1
1,358,358,9,9,0,1,0
17,363,363,62,62,0,1,0
7,387,387,122,26,96,4,3
24,391,391,18,3,15,4,3
28,417,417,63,63,0,1,0
20,426,426,3,3,0,1,0
19,446,446,2,2,0,1,0
4,448,448,8,4,4,2,1
21,454,454,125,95,30,2,1
0,481,481,25,25,0,1,0
22,487,487,89,80,9,2,1

10,105,105,14,14,0,1,0
4,113,113,24,9,15,4,3
28,134,134,18,18,0,1,0
30,138,138,37,16,21,4,3
22,140,140,8,2,6,3,2
26,141,141,13,4,9,4,3
27,149,149,31,22,9,4,3
7,162,162,3,3,0,1,0
16,168,168,13,13,0,1,0
32,180,180,8,8,0,1,0
23,220,220,8,8,0,1,0
14,224,224,27,21,6,2,1
12,231,231,3,3,0,1,0
11,252,252,20,2,18,4,3
6,283,283,62,48,14,2,1
17,283,283,29,29,0,1,0
19,297,297,5,5,0,1,0
13,304,304,5,1,4,2,1
33,341,341,89,89,0,1,0
20,353,353,15,4,11,2,1
1,367,367,6,6,0,1,0
9,374,374,58,58,0,1,0
0,393,393,49,49,0,1,0
15,409,409,44,44,0,1,0
31,420,420,140,122,18,4,3
29,425,425,29,1,28,2,1
3,429,429,38,33,5,2,1
5,448,448,18,6,12,3,2
25,451,451,3,3,0,1,0
2,462,462,15,15,0,1,0
24,464,464,25,7,18,4,3
21,471,471,5,5,0,1,0
8,479,479,22,13,9,2,1
18,483,483,2,2,0,1,0

2,111,111,4,4,0,1,0
14,122,122,38,38,0,1,0
31,131,131,3,3,0,1,0
7,143,143,4,4,0,1,0
17,154,154,12,12,0,1,0
27,159,159,10,4,6,3,2
26,164,164,7,7,0,1,0
6,170,170,16,16,0,1,0
22,171,171,10,10,0,1,0
20,171,171,94,94,0,1,0
19,178,178,14,14,0,1,0
3,180,180,21,21,0,1,0
16,217,217,39,3,36,4,3
21,220,220,13,1,12,3,2
30,234,234,23,9,14,3,2
28,249,249,18,9,9,4,3
5,249,249,45,33,12,3,2
13,306,306,4,4,0,1,0
12,316,316,50,50,0,1,0
25,327,327,20,10,10,2,1
18,354,354,6,2,4,2,1
15,366,366,38,32,6,3,2
8,370,370,6,6,0,1,0
10,378,378,2,2,0,1,0
4,383,383,137,116,21,4,3
1,394,394,26,4,22,2,1
24,441,441,25,25,0,1,0
0,448,448,11,11,0,1,0
29,461,461,58,28,30,2,1
9,462,462,16,1,15,4,3
11,474,474,26,18,8,2,1
23,487,487,36,36,0,1,0

0,118,118,1,1,0,1,0
18,132,132,11,11,0,1,0
21,142,142,14,6,8,2,1
7,145,145,16,16,0,1,0
26,169,169,2,2,0,1,0
15,178,178,1,1,0,1,0
5,195,195,17,17,0,1,0
25,230,230,52,7,45,2,1
12,235,235,15,15,0,1,0
20,243,243,23,23,0,1,0
3,247,247,13,4,9,4,3
8,263,263,1,1,0,1,0
30,268,268,16,16,0,1,0
16,272,272,16,6,10,3,2
4,288,288,45,26,19,2,1
17,290,290,15,1,14,2,1
24,293,293,5,5,0,1,0
34,295,295,8,2,6,2,1
31,306,306,17,17,0,1,0
32,307,307,64,21,43,2,1
10,319,319,37,37,0,1,0
33,321,321,155,127,28,2,1
11,334,334,20,14,6,2,1
19,342,342,21,10,11,4,3
27,370,370,10,2,8,3,2
14,402,402,4,4,0,1,0
9,407,407,37,37,0,1,0
2,415,415,21,21,0,1,0
1,420,420,17,17,0,1,0
23,430,430,79,76,3,2,1
13,432,432,190,190,0,1,0
6,439,439,51,51,0,1,0
29,449,449,11,11,0,1,0
22,479,479,22,16,6,2,1
28,485,485,2,2,0,1,0

0,109,109,1,1,0,1,0
12,109,109,10,2,8,2,1
18,118,118,20,20,0,1,0
19,134,134,14,14,0,1,0
4,148,148,1,1,0,1,0
16,149,149,3,3,0,1,0
14,170,170,17,9,8,3,2
10,200,200,21,21,0,1,0
30,207,207,24,24,0,1,0
29,216,216,20,12,8,3,2
26,241,241,2,2,0,1,0
11,288,288,134,43,91,4,3
32,290,290,24,6,18,3,2
27,322,322,17,17,0,1,0
15,323,323,4,4,0,1,0
3,325,325,71,47,24,2,1
31,330,330,31,31,0,1,0
23,331,331,16,16,0,1,0
5,334,334,1,1,0,1,0
6,336,336,47,43,4,2,1
1,350,350,60,8,52,3,2
13,390,390,25,25,0,1,0
8,420,420,19,1,18,4,3
25,425,425,63,63,0,1,0
7,426,426,40,40,0,1,0
17,437,437,33,1,32,2,1
24,446,446,52,47,5,2,1
21,452,452,39,39,0,1,0
2,466,466,1,1,0,1,0
20,478,478,122,122,0,1,0
28,485,485,72,5,67,3,2
9,489,489,27,27,0,1,0
22,490,490,11,11,0,1,0

8,113,113,24,14,10,2,1
9,121,121,6,3,3,2,1
20,129,129,5,5,0,1,0
23,159,159,17,12,5,2,1
24,188,188,31,31,0,1,0
11,223,223,5,5,0,1,0
0,224,224,5,5,0,1,0
2,238,238,6,6,0,1,0
13,250,250,22,22,0,1,0
19,252,252,30,2,28,2,1
5,277,277,17,17,0,1,0
1,290,290,9,9,0,1,0
22,294,294,11,2,9,4,3
14,311,311,104,90,14,3,2
18,319,319,8,4,4,2,1
10,322,322,5,2,3,2,1
12,329,329,75,30,45,2,1
4,330,330,80,31,49,3,2
6,367,367,77,77,0,1,0
3,394,394,219,201,18,4,3
16,400,400,133,133,0,1,0
17,406,406,21,21,0,1,0
15,406,406,3,3,0,1,0
21,465,465,6,3,3,2,1
7,472,472,115,46,69,4,3

16,114,114,3,3,0,1,0
14,114,114,11,11,0,1,0
1,122,122,3,3,0,1,0
12,135,135,1,1,0,1,0
28,135,135,1,1,0,1,0
13,161,161,10,4,6,2,1
6,172,172,2,2,0,1,0
19,178,178,16,1,15,4,3
4,181,181,29,15,14,2,1
2,188,188,60,60,0,1,0
7,197,197,29,19,10,2,1
27,200,200,43,26,17,2,1
30,203,203,9,9,0,1,0
20,228,228,4,1,3,2,1
26,237,237,10,5,5,2,1
11,238,238,34,34,0,1,0
32,239,239,81,53,28,2,1
23,261,261,28,12,16,2,1
24,298,298,6,6,0,1,0
5,308,308,54,10,44,2,1
0,336,336,33,33,0,1,0
17,378,378,14,14,0,1,0
3,380,380,19,7,12,4,3
18,399,399,62,48,14,2,1
31,401,401,17,17,0,1,0
22,405,405,151,151,0,1,0
8,409,409,1,1,0,1,0
9,411,411,33,33,0,1,0
21,421,421,9,9,0,1,0
29,445,445,7,4,3,2,1
10,453,453,37,13,24,3,2
25,481,481,50,32,18,3,2
15,491,491,58,58,0,1,0

9,121,121,11,11,0,1,0
22,131,131,7,3,4,2,1
1,137,137,5,5,0,1,0
21,140,140,2,2,0,1,0
19,157,157,9,6,3,2,1
8,159,159,51,13,38,3,2
25,160,160,34,34,0,1,0
35,165,165,17,17,0,1,0
26,166,166,29,29,0,1,0
15,176,176,10,4,6,3,2
5,176,176,2,2,0,1,0
32,210,210,29,29,0,1,0
30,212,212,28,1,27,2,1
29,230,230,15,15,0,1,0
13,250,250,5,5,0,1,0
0,270,270,4,1,3,2,1
33,290,290,6,1,5,2,1
23,306,306,54,14,40,2,1
11,310,310,19,19,0,1,0
6,314,314,9,9,0,1,0
18,336,336,13,1,12,4,3
3,338,338,26,3,23,2,1
27,343,343,24,9,15,2,1
12,374,374,72,40,32,2,1
31,388,388,8,4,4,2,1
17,439,439,2,2,0,1,0
20,451,451,97,97,0,1,0
2,458,458,40,40,0,1,0
34,458,458,39,39,0,1,0
7,460,460,180,170,10,3,2
16,473,473,18,18,0,1,0
4,474,474,6,6,0,1,0
10,481,481,28,9,19,2,1
14,490,490,1,1,0,1,0
28,493,493,31,14,17,2,1
24,497,497,44,44,0,1,0

19,104,104,12,12,0,1,0
21,106,106,6,6,0,1,0
15,119,119,1,1,0,1,0
0,136,136,29,2,27,4,3
33,139,139,49,19,30,2,1
1,143,143,32,12,20,2,1
10,162,162,1,1,0,1,0
11,163,163,14,14,0,1,0
7,169,169,2,2,0,1,0
27,173,173,9,9,0,1,0
32,217,217,34,6,28,3,2
22,235,235,10,6,4,2,1
30,246,246,28,7,21,4,3
20,246,246,3,3,0,1,0
14,247,247,18,18,0,1,0
6,252,252,3,3,0,1,0
17,274,274,58,58,0,1,0
2,286,286,4,4,0,1,0
23,307,307,26,11,15,2,1
25,333,333,9,3,6,2,1
8,335,335,53,44,9,2,1
24,343,343,52,52,0,1,0
18,365,365,76,76,0,1,0
26,386,386,21,21,0,1,0
16,413,413,14,14,0,1,0
28,428,428,15,15,0,1,0
5,429,429,115,31,84,4,3
9,429,429,60,60,0,1,0
12,434,434,1,1,0,1,0
31,487,487,58,58,0,1,0
13,490,490,46,46,0,1,0
29,496,496,28,2,26,3,2
3,497,497,15,15,0,1,0
4,499,499,7,7,0,1,0

24,108,108,1,1,0,1,0
25,127,127,15,9,6,2,1
12,151,151,2,2,0,1,0
14,195,195,7,7,0,1,0
10,199,199,36,9,27,4,3
4,228,228,65,65,0,1,0
7,263,263,1,1,0,1,0
21,265,265,17,17,0,1,0
27,266,266,68,68,0,1,0
5,272,272,4,1,3,2,1
32,281,281,18,2,16,3,2
30,285,285,11,1,10,2,1
31,336,336,21,21,0,1,0
8,350,350,18,9,9,2,1
28,352,352,3,3,0,1,0
20,358,358,25,15,10,3,2
17,372,372,41,9,32,2,1
0,382,382,27,27,0,1,0
22,383,383,46,33,13,2,1
16,388,388,144,144,0,1,0
29,406,406,3,3,0,1,0
18,412,412,22,1,21,4,3
3,415,415,9,9,0,1,0
9,427,427,6,6,0,1,0
15,440,440,142,142,0,1,0
23,449,449,75,75,0,1,0
6,450,450,20,3,17,2,1
13,454,454,1,1,0,1,0
11,460,460,28,28,0,1,0
2,462,462,24,24,0,1,0
19,463,463,67,67,0,1,0
26,483,483,163,67,96,4,3
1,485,485,28,2,26,3,2

4,185,185,14,14,0,1,0
3,187,187,5,5,0,1,0
11,188,188,33,5,28,3,2
8,193,193,23,8,15,4,3
1,202,202,119,119,0,1,0
2,204,204,103,67,36,3,2
12,208,208,25,25,0,1,0
17,214,214,4,4,0,1,0
0,265,265,31,7,24,4,3
15,278,278,10,10,0,1,0
18,282,282,52,52,0,1,0
7,292,292,3,3,0,1,0
16,295,295,3,3,0,1,0
9,301,301,91,91,0,1,0
21,303,303,6,3,3,2,1
19,313,313,2,2,0,1,0
20,321,321,12,12,0,1,0
13,364,364,8,8,0,1,0
5,379,379,61,42,19,2,1
22,385,385,78,29,49,4,3
10,430,430,118,118,0,1,0
6,438,438,56,52,4,2,1
14,445,445,41,19,22,3,2

24,104,104,6,2,4,2,1
9,114,114,30,2,28,3,2
1,126,126,14,1,13,2,1
7,136,136,12,12,0,1,0
10,136,136,6,6,0,1,0
6,142,142,52,5,47,3,2
12,186,186,9,9,0,1,0
5,208,208,53,53,0,1,0
29,210,210,16,10,6,3,2
3,220,220,5,5,0,1,0
20,230,230,7,2,5,2,1
17,239,239,15,15,0,1,0
2,249,249,15,12,3,2,1
18,250,250,49,49,0,1,0
13,251,251,44,29,15,4,3
11,252,252,2,2,0,1,0
25,254,254,34,8,26,2,1
14,260,260,11,11,0,1,0
15,272,272,49,7,42,2,1
16,298,298,5,2,3,2,1
28,314,314,32,8,24,4,3
21,331,331,32,32,0,1,0
4,352,352,37,37,0,1,0
23,375,375,84,34,50,2,1
26,375,375,13,13,0,1,0
22,376,376,40,16,24,4,3
8,394,394,3,3,0,1,0
27,401,401,95,95,0,1,0
19,467,467,15,15,0,1,0
0,497,497,23,4,19,4,3

7,100,100,22,4,18,3,2
13,125,125,4,4,0,1,0
29,130,130,18,18,0,1,0
23,134,134,44,5,39,4,3
5,175,175,5,5,0,1,0
25,176,176,56,3,53,4,3
11,185,185,1,1,0,1,0
17,233,233,1,1,0,1,0
9,265,265,16,4,12,3,2
18,267,267,10,1,9,2,1
16,268,268,21,18,3,2,1
21,281,281,56,48,8,2,1
2,282,282,69,13,56,3,2
1,302,302,42,8,34,2,1
15,304,304,6,6,0,1,0
10,306,306,12,8,4,2,1
19,309,309,42,6,36,4,3
26,319,319,25,25,0,1,0
12,342,342,27,27,0,1,0
4,346,346,10,10,0,1,0
20,358,358,5,5,0,1,0
6,380,380,35,29,6,2,1
28,392,392,41,3,38,3,2
0,422,422,69,69,0,1,0
14,435,435,21,21,0,1,0
27,438,438,7,7,0,1,0
8,452,452,20,20,0,1,0
22,473,473,16,16,0,1,0
24,473,473,32,32,0,1,0
3,478,478,205,149,56,4,3

19,119,119,3,3,0,1,0
14,123,123,21,21,0,1,0
25,142,142,2,2,0,1,0
9,146,146,11,11,0,1,0
27,159,159,16,16,0,1,0
28,163,163,7,7,0,1,0
24,184,184,16,16,0,1,0
16,190,190,19,19,0,1,0
15,210,210,20,20,0,1,0
18,267,267,22,22,0,1,0
4,303,303,22,22,0,1,0
12,313,313,1,1,0,1,0
21,313,313,36,36,0,1,0
17,316,316,51,51,0,1,0
22,320,320,10,10,0,1,0
6,323,323,20,14,6,2,1
31,335,335,129,129,0,1,0
20,336,336,27,27,0,1,0
1,351,351,26,26,0,1,0
2,361,361,15,15,0,1,0
10,366,366,121,16,105,4,3
30,376,376,31,31,0,1,0
26,385,385,15,15,0,1,0
5,403,403,35,35,0,1,0
3,417,417,96,12,84,4,3
0,419,419,1,1,0,1,0
23,424,424,119,40,79,4,3
8,430,430,112,112,0,1,0
11,434,434,3,3,0,1,0
29,455,455,3,3,0,1,0
7,466,466,33,33,0,1,0
13,480,480,10,10,0,1,0

0,106,106,31,31,0,1,0
19,147,147,5,1,4,2,1
9,177,177,10,10,0,1,0
22,189,189,66,52,14,3,2
2,198,198,20,4,16,2,1
16,213,213,3,3,0,1,0
24,214,214,18,18,0,1,0
12,229,229,16,16,0,1,0
1,231,231,9,9,0,1,0
11,237,237,8,2,6,3,2
8,248,248,18,3,15,4,3
15,256,256,38,38,0,1,0
14,260,260,54,54,0,1,0
10,281,281,2,2,0,1,0
7,286,286,56,11,45,2,1
23,307,307,20,20,0,1,0
28,309,309,72,24,48,3,2
26,312,312,14,8,6,3,2
29,315,315,22,22,0,1,0
25,340,340,13,13,0,1,0
27,405,405,1,1,0,1,0
21,435,435,52,52,0,1,0
13,437,437,32,32,0,1,0
6,470,470,143,143,0,1,0
18,477,477,42,5,37,3,2
20,485,485,12,12,0,1,0
4,491,491,93,45,48,4,3
17,492,492,55,7,48,4,3
5,498,498,48,22,26,3,2
3,500,500,35,35,0,1,0

19,101,101,31,31,0,1,0
14,121,121,12,4,8,3,2
17,123,123,8,8,0,1,0
12,142,142,7,1,6,3,2
23,158,158,22,22,0,1,0
22,179,179,1,1,0,1,0
30,187,187,10,10,0,1,0
31,211,211,18,6,12,3,2
26,217,217,21,6,15,4,3
7,218,218,3,3,0,1,0
10,221,221,10,2,8,2,1
9,230,230,19,19,0,1,0
25,232,232,44,44,0,1,0
32,241,241,80,11,69,4,3
21,252,252,11,11,0,1,0
1,257,257,9,9,0,1,0
29,262,262,41,5,36,4,3
4,287,287,54,27,27,4,3
8,306,306,65,65,0,1,0
18,322,322,4,4,0,1,0
2,324,324,89,17,72,3,2
0,327,327,1,1,0,1,0
16,330,330,77,77,0,1,0
28,330,330,24,3,21,2,1
27,360,360,17,17,0,1,0
6,371,371,7,7,0,1,0
5,371,371,3,3,0,1,0
11,380,380,59,59,0,1,0
24,381,381,2,2,0,1,0
20,386,386,6,6,0,1,0
3,394,394,31,9,22,2,1
15,412,412,28,17,11,2,1
13,491,491,18,4,14,2,1

28,107,107,6,6,0,1,0
23,109,109,9,9,0,1,0
2,127,127,9,9,0,1,0
29,139,139,24,16,8,3,2
8,158,158,19,11,8,3,2
25,190,190,20,20,0,1,0
27,193,193,6,3,3,2,1
22,203,203,5,5,0,1,0
11,207,207,20,6,14,3,2
7,222,222,63,63,0,1,0
30,232,232,35,13,22,2,1
15,246,246,5,5,0,1,0
9,259,259,38,20,18,3,2
18,279,279,33,15,18,2,1
10,286,286,15,15,0,1,0
24,287,287,8,8,0,1,0
31,292,292,60,60,0,1,0
3,300,300,17,17,0,1,0
21,302,302,7,7,0,1,0
13,323,323,6,6,0,1,0
6,325,325,3,3,0,1,0
12,333,333,11,11,0,1,0
17,349,349,77,22,55,3,2
19,352,352,21,3,18,4,3
1,369,369,159,153,6,3,2
5,380,380,43,31,12,4,3
26,403,403,43,17,26,2,1
4,434,434,15,6,9,2,1
16,436,436,63,15,48,3,2
0,438,438,29,17,12,3,2
20,443,443,51,32,19,2,1
14,500,500,25,25,0,1,0

29,109,109,1,1,0,1,0
26,119,119,5,1,4,2,1
1,122,122,5,1,4,2,1
22,128,128,9,9,0,1,0
9,139,139,18,18,0,1,0
16,142,142,13,13,0,1,0
6,142,142,6,6,0,1,0
4,151,151,7,3,4,2,1
20,153,153,1,1,0,1,0
8,156,156,20,8,12,4,3
12,170,170,29,4,25,4,3
11,181,181,19,14,5,2,1
21,198,198,11,7,4,2,1
27,211,211,13,9,4,2,1
14,236,236,5,5,0,1,0
30,285,285,18,18,0,1,0
32,293,293,46,7,39,3,2
13,305,305,8,8,0,1,0
17,310,310,6,1,5,2,1
19,314,314,30,4,26,2,1
7,346,346,51,33,18,4,3
5,355,355,2,2,0,1,0
2,361,361,78,78,0,1,0
18,372,372,83,83,0,1,0
15,381,381,16,9,7,2,1
10,424,424,24,4,20,2,1
31,438,438,18,18,0,1,0
23,450,450,55,55,0,1,0
0,451,451,133,43,90,3,2
3,451,451,18,18,0,1,0
24,458,458,228,123,105,4,3
28,474,474,73,45,28,2,1
25,499,499,7,3,4,2,1

3,122,122,25,25,0,1,0
7,126,126,10,10,0,1,0
21,130,130,6,6,0,1,0
12,139,139,6,1,5,2,1
13,159,159,5,5,0,1,0
24,160,160,37,13,24,3,2
18,186,186,23,23,0,1,0
29,204,204,9,9,0,1,0
2,215,215,23,23,0,1,0
25,219,219,15,3,12,3,2
6,227,227,32,32,0,1,0
27,254,254,47,29,18,4,3
9,268,268,63,63,0,1,0
26,270,270,17,2,15,2,1
5,282,282,33,18,15,4,3
10,282,282,32,32,0,1,0
30,287,287,42,42,0,1,0
28,287,287,12,4,8,2,1
31,312,312,31,4,27,4,3
22,324,324,20,6,14,2,1
23,340,340,21,12,9,4,3
4,363,363,23,20,3,2,1
0,368,368,2,2,0,1,0
8,400,400,10,10,0,1,0
1,408,408,19,2,17,2,1
19,416,416,53,11,42,2,1
17,420,420,3,3,0,1,0
11,437,437,54,41,13,2,1
15,453,453,46,17,29,4,3
16,459,459,97,61,36,4,3
20,483,483,51,15,36,2,1
14,487,487,80,26,54,4,3

14,110,110,14,14,0,1,0
10,132,132,2,2,0,1,0
15,134,134,6,1,5,2,1
8,136,136,44,22,22,2,1
13,142,142,14,14,0,1,0
24,150,150,2,2,0,1,0
21,181,181,8,8,0,1,0
23,183,183,2,2,0,1,0
18,203,203,8,8,0,1,0
20,204,204,6,6,0,1,0
12,207,207,28,28,0,1,0
3,244,244,31,31,0,1,0
30,250,250,8,8,0,1,0
7,279,279,3,3,0,1,0
9,287,287,5,5,0,1,0
27,342,342,104,19,85,4,3
25,348,348,60,60,0,1,0
16,352,352,7,1,6,3,2
26,360,360,23,23,0,1,0
29,368,368,16,5,11,2,1
0,381,381,18,3,15,3,2
17,387,387,34,18,16,3,2
4,406,406,34,18,16,3,2
11,414,414,88,88,0,1,0
31,422,422,225,135,90,4,3
2,436,436,2,2,0,1,0
1,439,439,24,17,7,2,1
5,442,442,30,6,24,2,1
28,445,445,54,43,11,2,1
6,453,453,107,97,10,2,1
22,463,463,2,2,0,1,0
19,469,469,52,33,19,2,1

9,107,107,25,25,0,1,0
21,117,117,12,12,0,1,0
7,130,130,35,30,5,2,1
16,168,168,23,23,0,1,0
6,175,175,2,2,0,1,0
26,176,176,13,13,0,1,0
23,198,198,2,2,0,1,0
17,204,204,50,19,31,2,1
10,234,234,18,18,0,1,0
5,257,257,4,4,0,1,0
28,261,261,7,4,3,2,1
0,267,267,112,112,0,1,0
29,287,287,49,26,23,2,1
2,321,321,4,4,0,1,0
11,321,321,26,6,20,2,1
25,333,333,56,16,40,2,1
13,351,351,30,30,0,1,0
1,353,353,79,79,0,1,0
4,358,358,6,6,0,1,0
24,371,371,111,111,0,1,0
3,398,398,11,11,0,1,0
8,428,428,34,15,19,2,1
14,434,434,8,4,4,2,1
18,435,435,43,4,39,4,3
27,442,442,27,27,0,1,0
15,455,455,1,1,0,1,0
19,467,467,36,36,0,1,0
20,480,480,1,1,0,1,0
12,487,487,23,23,0,1,0
22,487,487,65,65,0,1,0

18,102,102,3,3,0,1,0
3,126,126,2,2,0,1,0
2,150,150,1,1,0,1,0
4,151,151,10,10,0,1,0
20,182,182,15,15,0,1,0
26,183,183,30,30,0,1,0
28,186,186,24,24,0,1,0
15,200,200,51,24,27,4,3
40,202,202,34,19,15,4,3
11,212,212,14,3,11,2,1
1,215,215,17,17,0,1,0
14,224,224,5,1,4,2,1
6,234,234,4,1,3,2,1
19,243,243,17,17,0,1,0
33,244,244,2,2,0,1,0
5,250,250,1,1,0,1,0
23,252,252,49,1,48,3,2
0,274,274,8,2,6,3,2
31,274,274,26,19,7,2,1
24,280,280,5,5,0,1,0
17,284,284,11,8,3,2,1
21,291,291,1,1,0,1,0
22,304,304,6,2,4,2,1
38,312,312,8,8,0,1,0
35,313,313,31,25,6,2,1
10,331,331,32,32,0,1,0
32,350,350,46,46,0,1,0
9,390,390,21,1,20,2,1
41,393,393,73,67,6,2,1
12,410,410,6,6,0,1,0
13,416,416,82,82,0,1,0
27,417,417,77,47,30,2,1
8,419,419,25,25,0,1,0
34,436,436,40,10,30,3,2
25,436,436,12,12,0,1,0
7,445,445,51,44,7,2,1
36,464,464,11,3,8,3,2
29,465,465,11,11,0,1,0
37,467,467,2,2,0,1,0
16,473,473,9,9,0,1,0
30,497,497,2,2,0,1,0
39,500,500,141,31,110,4,3

34,106,106,1,1,0,1,0
6,116,116,1,1,0,1,0
29,121,121,16,4,12,2,1
19,125,125,13,4,9,2,1
14,140,140,12,12,0,1,0
28,148,148,9,9,0,1,0
10,152,152,17,17,0,1,0
2,167,167,46,46,0,1,0
24,222,222,5,2,3,2,1
12,228,228,36,28,8,2,1
23,238,238,77,23,54,4,3
22,250,250,38,10,28,3,2
32,256,256,37,4,33,4,3
5,257,257,1,1,0,1,0
26,261,261,11,2,9,4,3
1,273,273,4,4,0,1,0
0,273,273,14,4,10,3,2
18,292,292,8,8,0,1,0
20,305,305,50,14,36,3,2
16,311,311,10,10,0,1,0
13,332,332,4,1,3,2,1
30,358,358,18,18,0,1,0
4,365,365,32,32,0,1,0
21,369,369,51,33,18,3,2
8,369,369,17,17,0,1,0
11,385,385,85,85,0,1,0
17,388,388,11,7,4,2,1
25,390,390,57,28,29,2,1
3,398,398,162,162,0,1,0
33,417,417,20,12,8,3,2
15,452,452,8,5,3,2,1
31,492,492,28,28,0,1,0
7,492,492,1,1,0,1,0
9,494,494,5,2,3,2,1
27,499,499,23,23,0,1,0

30,104,104,5,5,0,1,0
9,111,111,21,21,0,1,0
15,123,123,7,7,0,1,0
0,131,131,1,1,0,1,0
7,145,145,10,10,0,1,0
8,161,161,1,1,0,1,0
25,174,174,26,26,0,1,0
4,176,176,5,5,0,1,0
6,206,206,5,5,0,1,0
29,223,223,29,25,4,2,1
24,230,230,3,3,0,1,0
19,247,247,20,2,18,2,1
20,248,248,11,6,5,2,1
22,249,249,27,27,0,1,0
31,259,259,4,1,3,2,1
18,281,281,86,86,0,1,0
26,322,322,8,4,4,2,1
10,330,330,1,1,0,1,0
21,340,340,18,10,8,3,2
23,344,344,38,38,0,1,0
17,344,344,21,13,8,2,1
32,356,356,32,28,4,2,1
33,360,360,6,6,0,1,0
3,368,368,16,16,0,1,0
5,379,379,21,17,4,2,1
13,380,380,36,18,18,3,2
28,396,396,108,18,90,4,3
12,401,401,6,6,0,1,0
11,432,432,42,16,26,3,2
14,439,439,98,60,38,3,2
1,449,449,242,230,12,3,2
2,463,463,1,1,0,1,0
16,483,483,42,42,0,1,0
27,486,486,81,30,51,4,3

24,101,101,1,1,0,1,0
11,113,113,6,6,0,1,0
14,122,122,1,1,0,1,0
20,125,125,6,6,0,1,0
3,173,173,38,22,16,4,3
12,190,190,12,12,0,1,0
15,195,195,26,11,15,4,3
19,196,196,26,26,0,1,0
18,199,199,1,1,0,1,0
34,244,244,16,16,0,1,0
7,257,257,9,1,8,3,2
28,275,275,7,2,5,2,1
27,277,277,40,40,0,1,0
2,278,278,30,30,0,1,0
32,282,282,36,36,0,1,0
17,288,288,3,3,0,1,0
26,300,300,55,55,0,1,0
31,303,303,34,7,27,3,2
30,316,316,1,1,0,1,0
9,354,354,40,40,0,1,0
8,356,356,92,92,0,1,0
22,358,358,80,74,6,2,1
0,360,360,4,1,3,2,1
6,365,365,72,63,9,2,1
25,381,381,8,8,0,1,0
5,393,393,4,4,0,1,0
21,421,421,62,26,36,3,2
13,440,440,17,17,0,1,0
29,445,445,102,68,34,2,1
1,456,456,45,45,0,1,0
16,460,460,53,53,0,1,0
23,472,472,70,19,51,3,2
33,473,473,3,3,0,1,0
4,483,483,59,47,12,2,1
10,485,485,1,1,0,1,0

8,106,106,7,7,0,1,0
25,121,121,34,16,18,2,1
15,127,127,22,2,20,4,3
21,133,133,12,12,0,1,0
28,134,134,5,2,3,2,1
14,140,140,5,2,3,2,1
11,141,141,3,3,0,1,0
20,171,171,13,5,8,3,2
34,176,176,4,1,3,2,1
9,195,195,25,19,6,2,1
22,208,208,4,4,0,1,0
32,212,212,21,21,0,1,0
5,213,213,34,19,15,2,1
10,214,214,3,3,0,1,0
12,221,221,14,1,13,2,1
6,225,225,86,86,0,1,0
2,234,234,8,8,0,1,0
7,245,245,7,7,0,1,0
35,254,254,23,10,13,2,1
24,255,255,26,5,21,2,1
27,257,257,12,12,0,1,0
23,285,285,46,19,27,2,1
33,287,287,34,6,28,2,1
16,327,327,15,6,9,2,1
1,386,386,43,43,0,1,0
13,389,389,4,4,0,1,0
3,402,402,6,6,0,1,0
18,410,410,1,1,0,1,0
0,410,410,58,58,0,1,0
17,427,427,8,8,0,1,0
4,433,433,22,22,0,1,0
26,434,434,34,34,0,1,0
30,450,450,43,43,0,1,0
29,467,467,39,39,0,1,0
31,471,471,109,37,72,4,3
19,476,476,47,47,0,1,0

11,102,102,21,12,9,2,1
33,106,106,7,7,0,1,0
21,107,107,2,2,0,1,0
24,125,125,1,1,0,1,0
14,131,131,11,11,0,1,0
28,134,134,8,8,0,1,0
7,168,168,26,17,9,2,1
27,171,171,45,45,0,1,0
8,208,208,5,5,0,1,0
17,215,215,24,11,13,2,1
18,232,232,29,29,0,1,0
6,236,236,1,1,0,1,0
9,238,238,33,9,24,3,2
35,266,266,18,18,0,1,0
5,277,277,1,1,0,1,0
31,277,277,51,51,0,1,0
1,284,284,3,3,0,1,0
23,289,289,41,5,36,2,1
32,295,295,10,10,0,1,0
10,297,297,56,24,32,2,1
4,303,303,5,5,0,1,0
34,312,312,9,9,0,1,0
15,313,313,1,1,0,1,0
25,317,317,19,7,12,3,2
26,319,319,3,3,0,1,0
29,326,326,70,55,15,2,1
3,329,329,13,7,6,2,1
36,332,332,61,38,23,2,1
0,343,343,1,1,0,1,0
13,362,362,84,75,9,4,3
2,370,370,2,2,0,1,0
19,378,378,25,13,12,2,1
37,400,400,23,2,21,2,1
12,436,436,14,14,0,1,0
22,453,453,60,3,57,4,3
20,455,455,17,17,0,1,0
30,470,470,56,56,0,1,0
16,483,483,48,7,41,2,1

8,105,105,1,1,0,1,0
27,114,114,15,15,0,1,0
34,119,119,5,5,0,1,0
13,119,119,2,2,0,1,0
14,123,123,3,3,0,1,0
7,154,154,13,3,10,2,1
20,178,178,29,21,8,2,1
33,181,181,45,12,33,2,1
9,195,195,6,6,0,1,0
21,196,196,37,2,35,3,2
0,196,196,20,7,13,2,1
4,199,199,24,6,18,2,1
17,221,221,23,2,21,4,3
24,228,228,26,26,0,1,0
32,239,239,6,6,0,1,0
16,239,239,3,3,0,1,0
28,272,272,7,7,0,1,0
11,275,275,22,22,0,1,0
25,290,290,6,1,5,2,1
12,302,302,27,13,14,2,1
15,307,307,4,4,0,1,0
2,311,311,41,41,0,1,0
22,311,311,42,42,0,1,0
19,320,320,11,11,0,1,0
5,333,333,7,3,4,2,1
36,333,333,23,2,21,4,3
30,369,369,25,7,18,4,3
23,373,373,91,91,0,1,0
18,375,375,14,3,11,2,1
31,378,378,118,118,0,1,0
10,399,399,13,9,4,2,1
29,403,403,9,1,8,2,1
26,412,412,18,3,15,2,1
1,414,414,16,12,4,2,1
3,443,443,73,73,0,1,0
37,444,444,34,19,15,4,3
6,458,458,47,47,0,1,0
35,465,465,27,17,10,2,1

8,104,104,7,7,0,1,0
31,105,105,6,6,0,1,0
21,109,109,4,4,0,1,0
36,149,149,29,29,0,1,0
3,150,150,1,1,0,1,0
16,160,160,3,3,0,1,0
12,193,193,47,33,14,2,1
14,200,200,19,19,0,1,0
35,200,200,2,2,0,1,0
27,208,208,13,13,0,1,0
29,221,221,27,27,0,1,0
37,221,221,56,29,27,4,3
32,223,223,18,5,13,2,1
0,224,224,13,13,0,1,0
20,245,245,1,1,0,1,0
24,275,275,40,40,0,1,0
22,280,280,4,4,0,1,0
17,299,299,4,4,0,1,0
33,300,300,11,2,9,2,1
25,304,304,158,113,45,4,3
23,310,310,4,4,0,1,0
6,335,335,56,41,15,4,3
28,349,349,1,1,0,1,0
13,352,352,47,47,0,1,0
9,353,353,24,15,9,4,3
7,383,383,9,9,0,1,0
15,395,395,23,23,0,1,0
1,409,409,2,2,0,1,0
11,432,432,60,21,39,4,3
19,436,436,26,26,0,1,0
30,441,441,9,2,7,2,1
2,455,455,5,5,0,1,0
26,459,459,9,3,6,2,1
4,463,463,2,2,0,1,0
5,475,475,51,51,0,1,0
18,481,481,61,35,26,3,2
34,487,487,35,17,18,4,3
10,494,494,80,66,14,3,2

6,109,109,1,1,0,1,0
7,126,126,3,3,0,1,0
2,149,149,21,11,10,3,2
12,171,171,42,33,9,2,1
9,175,175,11,1,10,2,1
8,213,213,32,16,16,3,2
1,220,220,62,62,0,1,0
10,253,253,45,36,9,4,3
19,255,255,26,26,0,1,0
17,283,283,5,5,0,1,0
18,314,314,105,14,91,4,3
15,316,316,16,16,0,1,0
4,318,318,33,6,27,4,3
0,322,322,87,87,0,1,0
3,349,349,281,281,0,1,0
16,349,349,14,14,0,1,0
5,361,361,72,72,0,1,0
11,393,393,15,15,0,1,0
13,405,405,54,2,52,3,2
14,449,449,2,2,0,1,0
20,500,500,16,4,12,2,1

30,113,113,2,2,0,1,0
35,114,114,30,16,14,2,1
16,122,122,12,12,0,1,0
15,158,158,14,5,9,4,3
29,159,159,3,3,0,1,0
4,162,162,17,1,16,3,2
34,163,163,2,2,0,1,0
20,172,172,8,1,7,3,2
12,177,177,24,12,12,4,3
6,179,179,13,13,0,1,0
18,207,207,1,1,0,1,0
23,209,209,19,5,14,2,1
8,212,212,1,1,0,1,0
19,212,212,7,4,3,2,1
11,219,219,2,2,0,1,0
33,223,223,2,2,0,1,0
9,226,226,12,4,8,3,2
21,233,233,28,19,9,4,3
28,251,251,1,1,0,1,0
0,274,274,14,4,10,2,1
24,294,294,3,3,0,1,0
25,303,303,2,2,0,1,0
36,327,327,155,113,42,4,3
1,354,354,1,1,0,1,0
2,369,369,30,23,7,2,1
22,377,377,3,3,0,1,0
14,380,380,49,49,0,1,0
26,391,391,53,8,45,4,3
31,410,410,7,7,0,1,0
17,425,425,18,6,12,3,2
27,429,429,170,152,18,4,3
5,430,430,50,41,9,4,3
10,436,436,19,9,10,2,1
13,445,445,103,89,14,3,2
7,455,455,7,1,6,3,2
3,458,458,108,108,0,1,0
32,479,479,19,19,0,1,0

25,106,106,8,8,0,1,0
27,117,117,11,11,0,1,0
29,120,120,11,11,0,1,0
3,136,136,20,20,0,1,0
8,159,159,12,7,5,2,1
23,160,160,20,20,0,1,0
18,162,162,12,12,0,1,0
6,186,186,40,3,37,2,1
4,198,198,12,12,0,1,0
19,217,217,38,26,12,2,1
1,249,249,10,5,5,2,1
26,256,256,9,9,0,1,0
20,291,291,49,49,0,1,0
5,298,298,21,11,10,2,1
7,327,327,66,34,32,2,1
11,333,333,11,11,0,1,0
22,345,345,6,6,0,1,0
21,354,354,14,6,8,3,2
0,395,395,50,9,41,2,1
2,415,415,39,39,0,1,0
15,417,417,11,11,0,1,0
14,419,419,42,14,28,3,2
13,455,455,18,10,8,2,1
9,456,456,6,1,5,2,1
16,468,468,114,92,22,3,2
12,472,472,79,3,76,3,2
24,477,477,65,31,34,3,2
10,485,485,154,64,90,4,3
17,488,488,8,5,3,2,1
28,497,497,108,60,48,4,3

0,102,102,1,1,0,1,0
27,102,102,25,10,15,4,3
9,120,120,34,7,27,2,1
12,125,125,4,4,0,1,0
31,135,135,18,10,8,3,2
21,142,142,4,4,0,1,0
28,142,142,24,8,16,3,2
30,164,164,6,6,0,1,0
33,173,173,3,3,0,1,0
22,182,182,51,51,0,1,0
24,195,195,34,28,6,2,1
10,195,195,7,7,0,1,0
15,244,244,3,3,0,1,0
37,256,256,38,38,0,1,0
23,300,300,9,2,7,2,1
26,307,307,65,27,38,2,1
25,333,333,6,6,0,1,0
14,340,340,10,10,0,1,0
13,341,341,3,3,0,1,0
7,342,342,6,6,0,1,0
20,355,355,18,18,0,1,0
18,358,358,6,6,0,1,0
38,365,365,78,50,28,3,2
3,372,372,20,3,17,2,1
2,380,380,17,17,0,1,0
35,391,391,3,3,0,1,0
29,405,405,14,14,0,1,0
19,406,406,34,34,0,1,0
5,408,408,43,7,36,4,3
4,420,420,1,1,0,1,0
1,420,420,31,5,26,2,1
32,424,424,47,11,36,2,1
16,433,433,28,28,0,1,0
34,435,435,32,32,0,1,0
6,465,465,48,4,44,3,2
36,471,471,7,4,3,2,1
17,475,475,1,1,0,1,0
11,494,494,70,70,0,1,0
8,497,497,60,23,37,2,1

35,100,100,6,6,0,1,0
1,103,103,3,3,0,1,0
25,115,115,5,5,0,1,0
8,117,117,6,6,0,1,0
33,128,128,14,2,12,4,3
22,132,132,10,10,0,1,0
7,137,137,4,4,0,1,0
11,139,139,10,10,0,1,0
3,145,145,30,24,6,2,1
34,163,163,2,2,0,1,0
23,176,176,25,5,20,2,1
37,198,198,2,2,0,1,0
15,216,216,9,5,4,2,1
10,227,227,1,1,0,1,0
6,234,234,33,9,24,3,2
29,245,245,13,10,3,2,1
0,249,249,16,16,0,1,0
32,250,250,7,7,0,1,0
14,270,270,14,14,0,1,0
31,275,275,58,58,0,1,0
2,276,276,6,6,0,1,0
26,303,303,114,33,81,4,3
16,310,310,59,59,0,1,0
5,315,315,4,4,0,1,0
24,354,354,60,10,50,2,1
17,360,360,38,38,0,1,0
12,363,363,31,31,0,1,0
4,372,372,10,2,8,2,1
20,396,396,50,50,0,1,0
27,420,420,19,1,18,4,3
28,422,422,21,21,0,1,0
30,438,438,89,74,15,4,3
36,442,442,23,8,15,3,2
13,448,448,35,2,33,2,1
19,459,459,4,4,0,1,0
21,465,465,8,8,0,1,0
9,490,490,37,27,10,2,1
18,500,500,80,20,60,3,2

29,102,102,31,31,0,1,0
36,107,107,21,6,15,2,1
14,113,113,14,14,0,1,0
17,115,115,1,1,0,1,0
18,129,129,13,1,12,4,3
7,131,131,6,6,0,1,0
26,153,153,31,31,0,1,0
28,171,171,19,19,0,1,0
20,178,178,3,3,0,1,0
16,194,194,2,2,0,1,0
0,196,196,14,4,10,2,1
30,197,197,23,23,0,1,0
35,229,229,9,9,0,1,0
24,274,274,15,15,0,1,0
34,278,278,6,6,0,1,0
8,286,286,2,2,0,1,0
21,295,295,29,29,0,1,0
12,296,296,69,31,38,2,1
32,317,317,7,7,0,1,0
11,323,323,10,1,9,2,1
5,336,336,17,9,8,2,1
3,336,336,16,10,6,2,1
19,352,352,15,15,0,1,0
22,354,354,36,6,30,4,3
23,355,355,57,57,0,1,0
4,360,360,54,54,0,1,0
37,385,385,1,1,0,1,0
31,415,415,31,1,30,3,2
15,421,421,75,49,26,3,2
33,422,422,2,2,0,1,0
9,432,432,10,10,0,1,0
2,438,438,26,26,0,1,0
27,444,444,63,35,28,3,2
10,445,445,68,56,12,4,3
6,463,463,30,13,17,2,1
13,474,474,19,19,0,1,0
25,475,475,35,35,0,1,0
1,477,477,22,7,15,2,1

32,109,109,21,8,13,3,2
25,125,125,14,8,6,3,2
15,126,126,23,23,0,1,0
30,136,136,25,25,0,1,0
18,144,144,3,3,0,1,0
29,148,148,15,7,8,2,1
5,153,153,2,2,0,1,0
22,159,159,25,25,0,1,0
34,160,160,29,3,26,3,2
26,184,184,7,7,0,1,0
20,198,198,27,27,0,1,0
33,223,223,58,36,22,2,1
16,227,227,10,3,7,2,1
13,252,252,4,1,3,2,1
2,262,262,9,3,6,3,2
24,262,262,6,3,3,2,1
19,271,271,10,2,8,2,1
1,282,282,14,4,10,3,2
14,304,304,24,5,19,2,1
11,310,310,77,47,30,2,1
28,327,327,3,3,0,1,0
12,345,345,11,1,10,3,2
0,356,356,5,5,0,1,0
4,401,401,62,11,51,3,2
9,405,405,8,8,0,1,0
31,417,417,9,2,7,2,1
3,420,420,44,30,14,3,2
17,430,430,81,52,29,2,1
8,443,443,32,32,0,1,0
21,445,445,1,1,0,1,0
6,462,462,46,46,0,1,0
27,464,464,43,43,0,1,0
10,479,479,11,11,0,1,0
7,480,480,101,53,48,4,3
23,494,494,42,42,0,1,0

12,109,109,1,1,0,1,0
22,122,122,27,27,0,1,0
0,146,146,32,32,0,1,0
1,154,154,45,45,0,1,0
10,158,158,7,1,6,3,2
34,189,189,28,28,0,1,0
16,196,196,41,41,0,1,0
7,224,224,50,19,31,3,2
27,237,237,17,9,8,2,1
18,243,243,18,3,15,4,3
13,260,260,1,1,0,1,0
4,271,271,11,11,0,1,0
9,273,273,36,17,19,2,1
14,276,276,1,1,0,1,0
32,308,308,43,43,0,1,0
8,313,313,31,31,0,1,0
11,319,319,10,10,0,1,0
31,324,324,3,3,0,1,0
5,345,345,6,6,0,1,0
2,345,345,5,5,0,1,0
24,345,345,36,36,0,1,0
19,345,345,76,46,30,3,2
30,357,357,16,13,3,2,1
6,358,358,5,1,4,2,1
3,371,371,5,5,0,1,0
33,378,378,46,19,27,2,1
15,387,387,6,6,0,1,0
28,396,396,75,75,0,1,0
29,400,400,10,4,6,3,2
17,401,401,59,32,27,4,3
26,453,453,6,6,0,1,0
25,454,454,101,101,0,1,0
23,460,460,11,11,0,1,0
21,466,466,19,19,0,1,0
20,477,477,17,2,15,2,1

26,113,113,32,32,0,1,0
5,116,116,18,18,0,1,0
1,116,116,9,2,7,2,1
15,129,129,4,4,0,1,0
27,139,139,1,1,0,1,0
24,140,140,12,4,8,3,2
2,141,141,66,30,36,4,3
19,150,150,26,14,12,3,2
11,157,157,7,7,0,1,0
17,188,188,33,33,0,1,0
3,207,207,3,3,0,1,0
6,239,239,2,2,0,1,0
25,254,254,32,5,27,2,1
16,260,260,32,7,25,3,2
12,269,269,22,6,16,4,3
4,283,283,61,17,44,3,2
7,285,285,24,24,0,1,0
21,289,289,6,6,0,1,0
20,344,344,13,1,12,3,2
18,357,357,93,56,37,2,1
0,360,360,20,11,9,4,3
9,367,367,33,1,32,2,1
29,391,391,12,2,10,2,1
23,435,435,27,27,0,1,0
22,438,438,15,15,0,1,0
8,443,443,54,54,0,1,0
28,464,464,33,33,0,1,0
14,481,481,56,56,0,1,0
10,489,489,48,48,0,1,0
13,495,495,42,2,40,3,2

26,110,110,13,5,8,3,2
13,111,111,1,1,0,1,0
28,119,119,9,9,0,1,0
29,126,126,21,21,0,1,0
1,131,131,4,4,0,1,0
20,133,133,1,1,0,1,0
24,144,144,6,1,5,2,1
2,148,148,2,2,0,1,0
4,164,164,5,2,3,2,1
14,166,166,9,5,4,2,1
31,167,167,18,18,0,1,0
30,178,178,20,20,0,1,0
17,201,201,24,24,0,1,0
18,202,202,65,39,26,2,1
10,206,206,43,22,21,4,3
19,219,219,27,5,22,3,2
32,226,226,18,8,10,3,2
27,233,233,21,21,0,1,0
9,246,246,36,14,22,3,2
6,286,286,15,15,0,1,0
34,293,293,31,31,0,1,0
16,297,297,17,5,12,2,1
23,320,320,3,3,0,1,0
33,330,330,77,29,48,4,3
7,359,359,14,11,3,2,1
8,384,384,49,18,31,3,2
5,387,387,15,11,4,2,1
0,391,391,63,25,38,2,1
22,404,404,29,29,0,1,0
11,450,450,26,26,0,1,0
12,466,466,40,19,21,2,1
3,484,484,19,19,0,1,0
21,492,492,103,103,0,1,0
15,493,493,5,5,0,1,0
25,497,497,46,8,38,2,1

28,104,104,13,13,0,1,0
12,127,127,20,20,0,1,0
2,127,127,3,3,0,1,0
27,131,131,8,8,0,1,0
20,182,182,6,3,3,2,1
0,186,186,6,6,0,1,0
24,206,206,9,9,0,1,0
7,211,211,8,8,0,1,0
13,237,237,13,13,0,1,0
3,239,239,6,6,0,1,0
21,248,248,22,22,0,1,0
16,248,248,18,8,10,3,2
6,255,255,122,122,0,1,0
18,259,259,20,4,16,3,2
14,272,272,55,1,54,3,2
29,304,304,20,20,0,1,0
11,310,310,5,5,0,1,0
9,316,316,42,10,32,4,3
25,317,317,106,72,34,4,3
15,325,325,90,90,0,1,0
22,331,331,3,3,0,1,0
5,364,364,38,38,0,1,0
1,372,372,18,10,8,3,2
10,383,383,87,15,72,4,3
17,386,386,6,6,0,1,0
19,427,427,7,7,0,1,0
4,450,450,101,79,22,3,2
23,487,487,79,64,15,4,3
26,488,488,24,4,20,2,1
8,489,489,19,19,0,1,0

22,100,100,4,4,0,1,0
24,110,110,13,13,0,1,0
16,124,124,30,4,26,3,2
18,141,141,6,6,0,1,0
28,143,143,80,80,0,1,0
20,143,143,9,9,0,1,0
10,149,149,7,7,0,1,0
32,187,187,55,55,0,1,0
8,189,189,5,5,0,1,0
30,192,192,18,6,12,4,3
6,200,200,3,3,0,1,0
13,209,209,51,51,0,1,0
17,214,214,7,7,0,1,0
29,225,225,38,38,0,1,0
9,260,260,47,33,14,2,1
12,273,273,71,43,28,2,1
4,290,290,45,7,38,3,2
2,299,299,7,4,3,2,1
26,304,304,8,8,0,1,0
11,318,318,12,12,0,1,0
3,350,350,1,1,0,1,0
5,389,389,72,72,0,1,0
14,397,397,16,16,0,1,0
1,402,402,20,5,15,4,3
21,404,404,8,8,0,1,0
0,405,405,6,2,4,2,1
7,412,412,32,32,0,1,0
25,420,420,19,5,14,3,2
31,426,426,4,4,0,1,0
15,436,436,1,1,0,1,0
27,446,446,26,26,0,1,0
19,486,486,27,27,0,1,0
23,488,488,4,4,0,1,0

32,126,126,4,1,3,2,1
6,169,169,39,39,0,1,0
7,192,192,48,12,36,4,3
27,209,209,3,3,0,1,0
19,211,211,103,94,9,4,3
29,223,223,17,17,0,1,0
8,226,226,9,9,0,1,0
28,229,229,1,1,0,1,0
22,245,245,33,19,14,4,3
21,251,251,15,3,12,2,1
0,276,276,39,39,0,1,0
1,311,311,11,1,10,2,1
25,313,313,35,25,10,2,1
10,325,325,22,22,0,1,0
26,334,334,22,22,0,1,0
30,335,335,9,9,0,1,0
33,347,347,14,3,11,2,1
4,353,353,25,25,0,1,0
17,358,358,36,25,11,2,1
18,374,374,14,8,6,2,1
5,380,380,4,1,3,2,1
16,407,407,38,38,0,1,0
11,427,427,1,1,0,1,0
14,434,434,43,8,35,2,1
31,439,439,86,86,0,1,0
3,446,446,65,38,27,4,3
20,459,459,56,51,5,2,1
2,460,460,16,4,12,2,1
9,460,460,40,40,0,1,0
13,465,465,26,1,25,4,3
12,466,466,25,4,21,4,3
23,468,468,68,68,0,1,0
15,477,477,39,39,0,1,0
24,487,487,35,35,0,1,0

23,105,105,1,1,0,1,0
0,107,107,7,7,0,1,0
28,109,109,1,1,0,1,0
16,112,112,7,7,0,1,0
18,135,135,16,7,9,2,1
26,147,147,9,9,0,1,0
24,150,150,17,2,15,4,3
2,152,152,12,6,6,2,1
13,181,181,6,6,0,1,0
21,195,195,6,6,0,1,0
14,200,200,16,2,14,2,1
22,214,214,24,24,0,1,0
8,224,224,92,72,20,2,1
27,271,271,45,12,33,4,3
1,290,290,40,40,0,1,0
5,337,337,25,16,9,2,1
12,360,360,46,12,34,2,1
19,361,361,72,72,0,1,0
10,362,362,95,95,0,1,0
7,399,399,1,1,0,1,0
6,402,402,22,4,18,2,1
25,402,402,145,145,0,1,0
17,405,405,33,17,16,2,1
4,408,408,8,3,5,2,1
20,430,430,56,26,30,4,3
11,435,435,21,21,0,1,0
15,455,455,31,31,0,1,0
3,466,466,120,90,30,3,2
9,486,486,30,3,27,3,2

5,114,114,21,5,16,2,1
8,130,130,8,8,0,1,0
21,136,136,15,12,3,2,1
7,137,137,19,9,10,3,2
20,137,137,19,19,0,1,0
11,145,145,16,16,0,1,0
10,150,150,6,3,3,2,1
6,152,152,10,10,0,1,0
18,153,153,5,5,0,1,0
27,186,186,34,4,30,2,1
19,187,187,7,7,0,1,0
25,233,233,6,1,5,2,1
2,249,249,52,36,16,4,3
0,256,256,48,32,16,2,1
13,283,283,8,8,0,1,0
3,332,332,34,21,13,3,2
17,352,352,5,5,0,1,0
26,379,379,15,15,0,1,0
23,396,396,129,71,58,3,2
22,403,403,39,39,0,1,0
9,415,415,2,2,0,1,0
16,418,418,32,18,14,3,2
4,422,422,72,36,36,2,1
28,439,439,89,89,0,1,0
15,448,448,14,3,11,2,1
24,452,452,40,26,14,2,1
14,470,470,92,92,0,1,0
12,487,487,74,59,15,4,3
1,492,492,86,86,0,1,0

8,115,115,8,8,0,1,0
20,118,118,3,3,0,1,0
0,129,129,11,11,0,1,0
7,162,162,28,28,0,1,0
24,172,172,16,16,0,1,0
11,176,176,17,8,9,2,1
23,189,189,43,8,35,2,1
13,194,194,14,4,10,3,2
5,207,207,4,4,0,1,0
10,321,321,4,4,0,1,0
6,324,324,8,3,5,2,1
21,337,337,8,8,0,1,0
1,345,345,128,109,19,2,1
9,400,400,114,62,52,3,2
18,405,405,32,2,30,3,2
15,412,412,31,31,0,1,0
17,412,412,20,4,16,2,1
25,428,428,51,44,7,2,1
22,439,439,25,3,22,2,1
19,445,445,27,27,0,1,0
3,467,467,78,78,0,1,0
2,470,470,25,13,12,2,1
16,476,476,29,29,0,1,0
12,476,476,25,25,0,1,0
4,480,480,170,152,18,4,3
14,484,484,256,240,16,3,2

8,110,110,83,20,63,3,2
11,114,114,16,16,0,1,0
23,120,120,17,8,9,2,1
16,133,133,15,5,10,3,2
14,139,139,15,15,0,1,0
15,148,148,14,11,3,2,1
17,170,170,6,1,5,2,1
10,212,212,20,6,14,3,2
20,223,223,29,29,0,1,0
1,242,242,34,25,9,4,3
18,248,248,20,20,0,1,0
5,326,326,39,39,0,1,0
0,326,326,23,23,0,1,0
24,332,332,62,8,54,4,3
19,341,341,11,4,7,2,1
4,395,395,6,6,0,1,0
2,410,410,13,13,0,1,0
21,411,411,12,3,9,2,1
3,423,423,25,25,0,1,0
9,448,448,42,42,0,1,0
13,459,459,60,60,0,1,0
7,461,461,18,18,0,1,0
6,464,464,172,91,81,4,3
12,490,490,65,65,0,1,0
22,495,495,48,12,36,3,2

26,100,100,14,5,9,4,3
36,102,102,3,3,0,1,0
20,112,112,12,12,0,1,0
21,116,116,8,8,0,1,0
5,131,131,1,1,0,1,0
25,140,140,4,4,0,1,0
7,151,151,3,3,0,1,0
14,156,156,25,9,16,2,1
18,161,161,6,6,0,1,0
34,164,164,13,2,11,2,1
0,174,174,23,7,16,2,1
28,181,181,3,3,0,1,0
3,211,211,10,3,7,2,1
1,228,228,49,20,29,4,3
2,233,233,4,4,0,1,0
11,241,241,47,20,27,4,3
22,249,249,191,191,0,1,0
10,255,255,15,4,11,2,1
17,256,256,24,24,0,1,0
23,261,261,15,15,0,1,0
33,284,284,28,4,24,3,2
32,302,302,9,9,0,1,0
16,303,303,8,8,0,1,0
30,320,320,6,6,0,1,0
9,346,346,73,16,57,4,3
35,348,348,1,1,0,1,0
29,349,349,20,7,13,2,1
13,406,406,1,1,0,1,0
6,412,412,30,3,27,2,1
19,413,413,9,1,8,2,1
15,429,429,26,1,25,2,1
24,445,445,22,1,21,3,2
27,451,451,21,21,0,1,0
12,452,452,25,25,0,1,0
8,460,460,22,5,17,3,2
31,469,469,71,36,35,2,1
4,482,482,8,8,0,1,0

6,106,106,17,17,0,1,0
21,169,169,35,27,8,3,2
0,170,170,21,21,0,1,0
25,191,191,9,3,6,3,2
12,201,201,19,19,0,1,0
9,216,216,37,37,0,1,0
8,223,223,60,39,21,2,1
28,226,226,5,5,0,1,0
18,275,275,34,34,0,1,0
16,278,278,46,46,0,1,0
27,300,300,69,20,49,2,1
29,312,312,11,2,9,2,1
1,333,333,42,36,6,3,2
19,337,337,62,62,0,1,0
5,348,348,7,1,6,2,1
13,350,350,2,2,0,1,0
20,352,352,35,19,16,3,2
11,364,364,22,7,15,4,3
24,370,370,14,8,6,3,2
15,378,378,52,52,0,1,0
17,401,401,46,46,0,1,0
26,403,403,3,3,0,1,0
4,407,407,137,102,35,3,2
3,408,408,27,17,10,3,2
10,408,408,55,55,0,1,0
7,437,437,3,3,0,1,0
2,447,447,12,12,0,1,0
22,469,469,31,3,28,2,1
23,486,486,14,10,4,2,1
14,494,494,58,58,0,1,0

12,120,120,24,24,0,1,0
8,121,121,31,31,0,1,0
6,129,129,5,1,4,2,1
1,159,159,13,1,12,4,3
3,169,169,4,1,3,2,1
14,194,194,1,1,0,1,0
24,219,219,6,6,0,1,0
9,236,236,24,24,0,1,0
21,244,244,28,28,0,1,0
11,264,264,39,39,0,1,0
13,291,291,31,31,0,1,0
0,300,300,2,2,0,1,0
29,322,322,11,2,9,4,3
23,341,341,28,18,10,2,1
2,359,359,7,7,0,1,0
34,364,364,71,7,64,4,3
10,373,373,79,21,58,3,2
22,374,374,5,5,0,1,0
20,383,383,40,28,12,4,3
5,384,384,25,25,0,1,0
25,385,385,5,1,4,2,1
17,394,394,20,20,0,1,0
31,400,400,12,12,0,1,0
28,401,401,63,3,60,4,3
7,411,411,2,2,0,1,0
33,422,422,101,69,32,2,1
18,428,428,8,8,0,1,0
4,449,449,28,28,0,1,0
27,462,462,9,9,0,1,0
19,467,467,17,17,0,1,0
15,471,471,7,7,0,1,0
30,478,478,219,219,0,1,0
26,488,488,27,1,26,4,3
16,494,494,91,91,0,1,0
32,494,494,20,20,0,1,0

7,110,110,43,21,22,3,2
24,114,114,7,7,0,1,0
26,124,124,17,17,0,1,0
20,131,131,11,4,7,2,1
10,145,145,1,1,0,1,0
5,151,151,10,10,0,1,0
32,222,222,52,2,50,3,2
15,227,227,26,5,21,4,3
18,251,251,6,6,0,1,0
21,259,259,71,45,26,2,1
12,262,262,1,1,0,1,0
11,274,274,35,30,5,2,1
4,279,279,17,3,14,2,1
1,287,287,12,12,0,1,0
3,295,295,23,1,22,3,2
6,302,302,7,3,4,2,1
33,313,313,18,18,0,1,0
29,317,317,6,3,3,2,1
30,319,319,42,42,0,1,0
27,321,321,23,6,17,4,3
19,343,343,3,3,0,1,0
22,346,346,51,9,42,2,1
0,353,353,25,25,0,1,0
17,359,359,36,28,8,3,2
23,388,388,60,11,49,3,2
14,402,402,49,49,0,1,0
34,419,419,3,3,0,1,0
13,443,443,18,4,14,2,1
9,447,447,19,19,0,1,0
16,448,448,32,13,19,4,3
28,450,450,2,2,0,1,0
2,455,455,9,9,0,1,0
8,459,459,91,16,75,4,3
25,476,476,61,61,0,1,0
31,498,498,53,37,16,3,2

19,119,119,11,8,3,2,1
21,130,130,33,33,0,1,0
17,137,137,28,28,0,1,0
26,145,145,22,4,18,4,3
12,152,152,35,8,27,2,1
23,180,180,3,3,0,1,0
2,182,182,19,1,18,2,1
25,225,225,3,3,0,1,0
3,230,230,82,10,72,4,3
7,245,245,26,26,0,1,0
22,264,264,4,4,0,1,0
0,274,274,1,1,0,1,0
1,282,282,8,8,0,1,0
30,298,298,28,8,20,3,2
8,305,305,93,20,73,4,3
28,325,325,2,2,0,1,0
4,340,340,44,44,0,1,0
20,363,363,75,35,40,3,2
6,366,366,2,2,0,1,0
14,367,367,94,94,0,1,0
11,369,369,4,4,0,1,0
29,381,381,119,58,61,4,3
9,385,385,9,1,8,3,2
27,385,385,3,3,0,1,0
24,397,397,49,3,46,3,2
18,409,409,1,1,0,1,0
15,433,433,37,21,16,2,1
5,439,439,8,8,0,1,0
16,471,471,17,9,8,2,1
13,472,472,8,8,0,1,0
10,498,498,4,4,0,1,0

3,109,109,22,22,0,1,0
9,117,117,7,7,0,1,0
2,120,120,21,2,19,4,3
26,130,130,32,21,11,2,1
8,133,133,21,21,0,1,0
23,136,136,3,3,0,1,0
4,137,137,14,2,12,4,3
6,164,164,8,4,4,2,1
25,210,210,2,2,0,1,0
24,216,216,21,21,0,1,0
15,234,234,25,25,0,1,0
18,235,235,93,87,6,2,1
0,258,258,11,1,10,2,1
19,290,290,3,3,0,1,0
13,291,291,4,4,0,1,0
12,318,318,138,76,62,3,2
17,337,337,9,9,0,1,0
28,352,352,20,20,0,1,0
7,366,366,13,13,0,1,0
10,382,382,65,22,43,2,1
21,383,383,132,52,80,4,3
27,395,395,7,7,0,1,0
29,397,397,39,39,0,1,0
16,411,411,36,12,24,2,1
22,416,416,8,8,0,1,0
14,420,420,38,3,35,2,1
5,442,442,20,15,5,2,1
11,449,449,1,1,0,1,0
20,474,474,2,2,0,1,0
1,491,491,56,56,0,1,0

24,129,129,66,53,13,2,1
15,130,130,1,1,0,1,0
7,145,145,15,15,0,1,0
2,148,148,21,21,0,1,0
22,149,149,14,14,0,1,0
19,150,150,17,17,0,1,0
32,154,154,7,3,4,2,1
8,162,162,25,25,0,1,0
26,177,177,20,9,11,3,2
1,195,195,1,1,0,1,0
28,215,215,1,1,0,1,0
9,231,231,44,44,0,1,0
6,255,255,65,65,0,1,0
31,277,277,1,1,0,1,0
30,280,280,28,28,0,1,0
10,288,288,14,14,0,1,0
17,320,320,3,3,0,1,0
3,324,324,7,4,3,2,1
12,340,340,17,14,3,2,1
18,343,343,110,80,30,4,3
14,356,356,49,49,0,1,0
20,362,362,27,27,0,1,0
23,370,370,4,4,0,1,0
13,382,382,44,4,40,2,1
27,400,400,24,24,0,1,0
0,431,431,16,16,0,1,0
11,460,460,14,14,0,1,0
21,466,466,46,46,0,1,0
16,472,472,57,57,0,1,0
25,473,473,5,5,0,1,0
5,480,480,45,25,20,3,2
4,487,487,39,20,19,2,1
29,495,495,31,31,0,1,0
33,499,499,4,4,0,1,0

28,101,101,16,1,15,2,1
0,103,103,12,12,0,1,0
17,118,118,32,20,12,2,1
26,120,120,5,2,3,2,1
2,132,132,8,3,5,2,1
29,175,175,14,11,3,2,1
3,179,179,9,9,0,1,0
7,182,182,49,49,0,1,0
12,204,204,23,1,22,2,1
24,239,239,18,6,12,2,1
9,290,290,42,42,0,1,0
15,313,313,69,48,21,4,3
1,318,318,35,35,0,1,0
25,330,330,9,9,0,1,0
19,330,330,34,17,17,2,1
18,334,334,58,58,0,1,0
21,336,336,2,2,0,1,0
8,345,345,50,37,13,2,1
11,356,356,34,5,29,3,2
22,365,365,31,11,20,3,2
16,367,367,58,9,49,3,2
23,380,380,49,49,0,1,0
27,401,401,8,5,3,2,1
4,424,424,16,3,13,3,2
5,431,431,31,31,0,1,0
6,432,432,32,32,0,1,0
20,433,433,24,12,12,2,1
13,481,481,18,18,0,1,0
10,486,486,134,92,42,2,1
14,488,488,15,15,0,1,0

22,104,104,5,5,0,1,0
3,121,121,40,40,0,1,0
31,136,136,4,4,0,1,0
0,140,140,21,21,0,1,0
23,149,149,66,21,45,2,1
1,164,164,5,5,0,1,0
5,166,166,16,16,0,1,0
27,172,172,19,19,0,1,0
19,190,190,1,1,0,1,0
26,193,193,56,56,0,1,0
21,211,211,36,36,0,1,0
30,286,286,4,4,0,1,0
2,308,308,21,4,17,2,1
15,316,316,45,45,0,1,0
7,319,319,18,12,6,3,2
14,339,339,8,8,0,1,0
11,364,364,2,2,0,1,0
17,384,384,8,8,0,1,0
10,389,389,117,117,0,1,0
20,390,390,13,3,10,3,2
4,403,403,47,47,0,1,0
29,409,409,10,10,0,1,0
8,413,413,3,3,0,1,0
24,416,416,35,27,8,2,1
18,417,417,49,49,0,1,0
9,425,425,1,1,0,1,0
12,439,439,32,32,0,1,0
13,440,440,19,19,0,1,0
28,440,440,29,5,24,3,2
6,442,442,69,48,21,4,3
25,470,470,54,24,30,3,2
16,493,493,34,34,0,1,0

12,133,133,14,5,9,4,3
17,133,133,2,2,0,1,0
4,136,136,50,50,0,1,0
15,148,148,4,4,0,1,0
23,165,165,4,4,0,1,0
1,179,179,3,3,0,1,0
30,217,217,1,1,0,1,0
7,226,226,13,13,0,1,0
9,227,227,35,32,3,2,1
29,229,229,16,2,14,3,2
5,238,238,3,3,0,1,0
6,247,247,52,52,0,1,0
11,278,278,1,1,0,1,0
28,280,280,62,50,12,2,1
8,282,282,48,48,0,1,0
13,297,297,12,12,0,1,0
20,308,308,34,3,31,2,1
22,313,313,18,6,12,3,2
16,331,331,22,4,18,3,2
18,340,340,76,46,30,2,1
0,345,345,48,48,0,1,0
21,367,367,9,9,0,1,0
2,402,402,23,3,20,2,1
14,404,404,18,10,8,2,1
25,409,409,18,18,0,1,0
26,419,419,129,129,0,1,0
10,424,424,44,20,24,4,3
3,448,448,43,43,0,1,0
24,471,471,92,51,41,2,1
19,476,476,9,9,0,1,0
31,484,484,116,62,54,4,3
27,496,496,3,3,0,1,0

32,114,114,21,1,20,3,2
23,120,120,3,3,0,1,0
15,128,128,10,6,4,2,1
3,202,202,1,1,0,1,0
26,206,206,14,8,6,2,1
21,210,210,5,5,0,1,0
5,226,226,1,1,0,1,0
7,234,234,19,8,11,3,2
13,278,278,66,30,36,4,3
28,290,290,20,16,4,2,1
4,299,299,13,10,3,2,1
0,307,307,8,2,6,2,1
27,312,312,4,4,0,1,0
10,314,314,39,39,0,1,0
24,328,328,14,4,10,3,2
8,336,336,24,24,0,1,0
35,343,343,40,14,26,3,2
6,351,351,11,11,0,1,0
12,362,362,56,38,18,2,1
29,371,371,7,7,0,1,0
11,373,373,3,3,0,1,0
22,374,374,98,20,78,3,2
30,381,381,23,2,21,2,1
33,382,382,34,34,0,1,0
14,382,382,1,1,0,1,0
34,389,389,19,19,0,1,0
1,398,398,41,26,15,2,1
25,404,404,119,71,48,4,3
17,432,432,23,3,20,4,3
36,433,433,71,27,44,2,1
31,435,435,62,17,45,4,3
20,438,438,67,1,66,3,2
9,448,448,9,2,7,2,1
19,481,481,48,33,15,2,1
16,481,481,67,28,39,4,3
18,489,489,63,24,39,2,1
2,499,499,18,12,6,2,1

16,103,103,15,12,3,2,1
2,117,117,16,6,10,2,1
6,120,120,3,3,0,1,0
5,126,126,13,13,0,1,0
32,129,129,15,15,0,1,0
24,129,129,9,1,8,2,1
7,140,140,1,1,0,1,0
20,143,143,10,10,0,1,0
17,159,159,36,12,24,4,3
22,167,167,9,1,8,2,1
34,188,188,1,1,0,1,0
10,189,189,5,5,0,1,0
13,195,195,3,3,0,1,0
30,212,212,6,6,0,1,0
33,243,243,8,8,0,1,0
9,243,243,43,6,37,2,1
0,244,244,6,6,0,1,0
8,262,262,28,4,24,2,1
18,296,296,8,8,0,1,0
27,315,315,15,7,8,2,1
21,341,341,44,44,0,1,0
23,348,348,9,1,8,3,2
19,348,348,8,8,0,1,0
15,356,356,2,2,0,1,0
28,376,376,132,132,0,1,0
25,381,381,73,73,0,1,0
4,394,394,1,1,0,1,0
14,412,412,142,22,120,4,3
31,435,435,11,1,10,3,2
29,454,454,133,47,86,4,3
12,456,456,40,14,26,2,1
11,466,466,17,17,0,1,0
26,474,474,79,58,21,4,3
1,484,484,25,25,0,1,0
3,497,497,25,19,6,3,2

19,118,118,5,5,0,1,0
27,137,137,38,38,0,1,0
13,166,166,1,1,0,1,0
25,169,169,15,5,10,2,1
24,174,174,16,6,10,3,2
23,182,182,47,47,0,1,0
5,183,183,23,23,0,1,0
3,205,205,81,56,25,2,1
20,205,205,14,1,13,2,1
4,207,207,10,7,3,2,1
17,213,213,2,2,0,1,0
8,217,217,5,5,0,1,0
21,231,231,8,8,0,1,0
16,259,259,25,25,0,1,0
10,264,264,62,36,26,3,2
0,296,296,23,23,0,1,0
22,339,339,26,26,0,1,0
9,368,368,27,27,0,1,0
14,388,388,53,5,48,3,2
7,395,395,200,200,0,1,0
18,408,408,59,8,51,4,3
11,411,411,23,12,11,2,1
15,459,459,50,50,0,1,0
2,460,460,14,14,0,1,0
12,466,466,53,53,0,1,0
6,474,474,1,1,0,1,0
26,488,488,36,36,0,1,0
1,493,493,14,4,10,4,3

15,101,101,1,1,0,1,0
23,136,136,72,72,0,1,0
21,188,188,2,2,0,1,0
20,199,199,1,1,0,1,0
11,236,236,73,73,0,1,0
2,273,273,22,10,12,2,1
16,294,294,42,6,36,4,3
8,310,310,66,36,30,4,3
24,319,319,36,9,27,4,3
22,320,320,32,32,0,1,0
0,341,341,8,8,0,1,0
3,368,368,27,6,21,4,3
7,371,371,102,92,10,2,1
18,400,400,13,7,6,3,2
19,404,404,17,9,8,2,1
5,411,411,86,73,13,2,1
10,423,423,1,1,0,1,0
12,424,424,74,32,42,4,3
9,429,429,28,7,21,2,1
6,430,430,39,28,11,2,1
25,447,447,7,7,0,1,0
27,462,462,8,8,0,1,0
13,469,469,90,73,17,2,1
4,471,471,31,6,25,4,3
17,475,475,62,62,0,1,0
26,477,477,23,23,0,1,0
1,485,485,94,58,36,3,2
14,492,492,34,4,30,4,3

18,115,115,5,5,0,1,0
35,121,121,3,3,0,1,0
30,121,121,14,2,12,2,1
8,135,135,10,10,0,1,0
17,138,138,13,13,0,1,0
11,151,151,93,93,0,1,0
3,157,157,4,1,3,2,1
13,175,175,8,8,0,1,0
20,188,188,31,31,0,1,0
0,218,218,7,1,6,2,1
2,222,222,10,5,5,2,1
7,232,232,1,1,0,1,0
12,236,236,1,1,0,1,0
32,238,238,19,19,0,1,0
22,258,258,16,16,0,1,0
14,276,276,19,9,10,3,2
31,313,313,11,11,0,1,0
28,317,317,91,91,0,1,0
10,318,318,71,20,51,4,3
26,328,328,12,12,0,1,0
33,347,347,55,55,0,1,0
19,351,351,17,17,0,1,0
4,352,352,50,8,42,2,1
21,365,365,14,2,12,4,3
15,377,377,12,12,0,1,0
24,382,382,62,62,0,1,0
29,382,382,6,2,4,2,1
16,393,393,5,1,4,2,1
6,401,401,4,1,3,2,1
34,410,410,75,36,39,4,3
1,436,436,10,7,3,2,1
5,436,436,1,1,0,1,0
25,455,455,65,58,7,2,1
23,466,466,25,25,0,1,0
27,489,489,30,30,0,1,0
9,500,500,27,3,24,4,3

4,101,101,7,7,0,1,0
14,120,120,18,3,15,2,1
11,145,145,8,8,0,1,0
24,163,163,1,1,0,1,0
9,176,176,16,16,0,1,0
21,203,203,32,32,0,1,0
2,217,217,38,23,15,2,1
22,233,233,19,12,7,2,1
16,237,237,18,11,7,2,1
30,242,242,54,54,0,1,0
33,248,248,2,2,0,1,0
15,261,261,28,28,0,1,0
28,267,267,81,69,12,3,2
13,269,269,7,7,0,1,0
25,274,274,57,57,0,1,0
29,277,277,25,16,9,4,3
7,284,284,19,2,17,2,1
34,286,286,8,8,0,1,0
18,302,302,59,8,51,4,3
8,313,313,1,1,0,1,0
12,316,316,46,4,42,4,3
27,331,331,36,36,0,1,0
31,335,335,25,11,14,2,1
10,338,338,1,1,0,1,0
23,343,343,45,45,0,1,0
6,349,349,22,2,20,3,2
0,350,350,15,4,11,2,1
20,354,354,17,17,0,1,0
32,356,356,10,10,0,1,0
17,375,375,19,19,0,1,0
26,377,377,46,46,0,1,0
3,440,440,37,33,4,2,1
5,454,454,1,1,0,1,0
1,474,474,93,18,75,4,3
19,487,487,3,3,0,1,0

35,101,101,15,15,0,1,0
24,114,114,3,3,0,1,0
38,122,122,5,5,0,1,0
6,136,136,6,6,0,1,0
43,144,144,31,22,9,4,3
2,153,153,4,4,0,1,0
25,160,160,3,3,0,1,0
13,166,166,1,1,0,1,0
41,171,171,16,16,0,1,0
36,183,183,10,4,6,2,1
20,198,198,7,7,0,1,0
10,205,205,1,1,0,1,0
11,211,211,17,17,0,1,0
14,218,218,24,16,8,2,1
18,222,222,4,4,0,1,0
19,234,234,15,5,10,2,1
40,240,240,4,4,0,1,0
29,242,242,1,1,0,1,0
32,247,247,17,17,0,1,0
21,262,262,14,14,0,1,0
42,276,276,53,5,48,4,3
39,277,277,14,14,0,1,0
27,279,279,3,3,0,1,0
31,280,280,44,44,0,1,0
30,290,290,56,56,0,1,0
15,292,292,45,11,34,2,1
0,296,296,35,20,15,4,3
7,307,307,42,42,0,1,0
44,315,315,12,7,5,2,1
22,346,346,13,2,11,2,1
12,346,346,24,24,0,1,0
33,352,352,37,37,0,1,0
8,368,368,1,1,0,1,0
16,377,377,25,25,0,1,0
17,377,377,38,38,0,1,0
26,386,386,3,3,0,1,0
34,398,398,79,61,18,3,2
23,414,414,21,12,9,2,1
5,421,421,59,59,0,1,0
4,426,426,2,2,0,1,0
1,443,443,9,9,0,1,0
28,468,468,16,16,0,1,0
37,473,473,24,24,0,1,0
3,484,484,76,76,0,1,0
9,497,497,1,1,0,1,0

27,108,108,42,20,22,2,1
34,114,114,4,4,0,1,0
20,123,123,14,4,10,2,1
16,127,127,8,2,6,3,2
4,134,134,5,1,4,2,1
3,146,146,3,3,0,1,0
6,150,150,1,1,0,1,0
18,157,157,21,21,0,1,0
28,176,176,19,8,11,4,3
32,180,180,9,9,0,1,0
33,185,185,28,28,0,1,0
12,186,186,6,3,3,2,1
17,187,187,1,1,0,1,0
24,209,209,27,18,9,4,3
5,215,215,1,1,0,1,0
39,219,219,42,42,0,1,0
38,232,232,16,16,0,1,0
26,244,244,11,2,9,4,3
40,249,249,39,1,38,3,2
19,256,256,10,10,0,1,0
13,258,258,14,1,13,2,1
22,264,264,3,3,0,1,0
14,270,270,1,1,0,1,0
0,272,272,13,13,0,1,0
30,273,273,22,22,0,1,0
10,283,283,54,54,0,1,0
31,312,312,4,4,0,1,0
15,333,333,15,15,0,1,0
8,342,342,5,5,0,1,0
9,342,342,11,11,0,1,0
25,355,355,4,4,0,1,0
37,359,359,12,4,8,2,1
36,383,383,71,45,26,2,1
21,385,385,34,34,0,1,0
1,399,399,108,14,94,3,2
7,404,404,37,37,0,1,0
11,416,416,8,8,0,1,0
23,430,430,12,2,10,3,2
29,481,481,23,23,0,1,0
35,490,490,34,8,26,2,1
2,493,493,59,59,0,1,0

23,127,127,1,1,0,1,0
9,151,151,7,7,0,1,0
35,154,154,28,28,0,1,0
12,162,162,14,2,12,4,3
32,163,163,3,3,0,1,0
7,168,168,16,4,12,4,3
34,195,195,6,6,0,1,0
3,198,198,32,32,0,1,0
18,199,199,5,5,0,1,0
17,200,200,21,21,0,1,0
42,209,209,11,11,0,1,0
30,213,213,34,4,30,3,2
5,214,214,19,19,0,1,0
38,225,225,12,12,0,1,0
14,225,225,16,16,0,1,0
40,236,236,21,21,0,1,0
4,245,245,7,7,0,1,0
33,255,255,25,25,0,1,0
11,266,266,33,11,22,2,1
2,280,280,25,11,14,3,2
1,289,289,18,18,0,1,0
36,303,303,164,147,17,2,1
6,307,307,20,20,0,1,0
26,309,309,15,5,10,3,2
44,314,314,1,1,0,1,0
27,324,324,2,2,0,1,0
20,334,334,1,1,0,1,0
28,335,335,5,5,0,1,0
13,350,350,19,19,0,1,0
16,350,350,7,4,3,2,1
25,363,363,4,4,0,1,0
10,384,384,1,1,0,1,0
24,399,399,25,25,0,1,0
22,414,414,4,1,3,2,1
41,419,419,47,47,0,1,0
43,425,425,42,23,19,2,1
31,429,429,27,27,0,1,0
21,430,430,9,9,0,1,0
8,442,442,69,69,0,1,0
0,459,459,10,6,4,2,1
19,467,467,51,51,0,1,0
37,480,480,42,30,12,4,3
29,488,488,17,5,12,2,1
15,491,491,2,2,0,1,0
39,495,495,2,2,0,1,0

4,122,122,15,15,0,1,0
11,123,123,13,13,0,1,0
32,124,124,30,30,0,1,0
26,138,138,3,3,0,1,0
21,163,163,42,3,39,2,1
10,172,172,14,14,0,1,0
6,174,174,1,1,0,1,0
28,182,182,1,1,0,1,0
8,186,186,4,4,0,1,0
2,192,192,14,2,12,2,1
24,195,195,13,13,0,1,0
33,217,217,2,2,0,1,0
7,276,276,25,25,0,1,0
3,291,291,31,5,26,2,1
31,295,295,16,1,15,4,3
14,312,312,52,37,15,4,3
12,315,315,6,6,0,1,0
27,325,325,1,1,0,1,0
18,367,367,17,17,0,1,0
15,368,368,23,2,21,2,1
0,379,379,42,35,7,2,1
30,406,406,89,57,32,3,2
5,409,409,1,1,0,1,0
25,414,414,29,8,21,2,1
1,427,427,118,118,0,1,0
9,430,430,7,7,0,1,0
20,434,434,141,93,48,4,3
22,440,440,5,1,4,2,1
13,440,440,77,31,46,2,1
17,461,461,39,34,5,2,1
23,463,463,10,10,0,1,0
29,473,473,5,5,0,1,0
16,487,487,39,39,0,1,0
19,490,490,133,133,0,1,0

3,102,102,5,5,0,1,0
33,108,108,3,3,0,1,0
31,122,122,17,17,0,1,0
30,134,134,6,6,0,1,0
9,146,146,16,16,0,1,0
12,160,160,51,24,27,2,1
5,181,181,1,1,0,1,0
18,181,181,16,7,9,4,3
23,182,182,29,19,10,3,2
1,186,186,8,3,5,2,1
16,187,187,1,1,0,1,0
25,198,198,16,6,10,3,2
8,210,210,3,3,0,1,0
35,221,221,28,28,0,1,0
2,231,231,36,12,24,3,2
22,231,231,17,6,11,3,2
0,243,243,3,3,0,1,0
19,244,244,11,11,0,1,0
17,250,250,13,2,11,2,1
28,258,258,9,9,0,1,0
20,263,263,45,18,27,4,3
11,263,263,49,24,25,2,1
34,275,275,43,4,39,4,3
36,286,286,69,4,65,3,2
6,303,303,9,6,3,2,1
26,304,304,26,26,0,1,0
10,330,330,29,5,24,3,2
13,344,344,4,1,3,2,1
4,393,393,54,54,0,1,0
7,398,398,11,11,0,1,0
24,399,399,9,9,0,1,0
27,431,431,41,10,31,2,1
29,435,435,3,3,0,1,0
21,440,440,128,26,102,4,3
15,443,443,6,6,0,1,0
32,493,493,24,6,18,4,3
14,495,495,19,19,0,1,0

30,118,118,4,4,0,1,0
12,118,118,15,15,0,1,0
6,123,123,20,20,0,1,0
8,129,129,15,4,11,3,2
17,131,131,2,2,0,1,0
27,136,136,4,4,0,1,0
5,142,142,8,8,0,1,0
9,165,165,13,4,9,4,3
25,194,194,4,4,0,1,0
1,203,203,5,5,0,1,0
4,204,204,30,19,11,2,1
7,210,210,2,2,0,1,0
33,215,215,50,25,25,4,3
22,216,216,5,5,0,1,0
21,220,220,5,5,0,1,0
16,222,222,25,7,18,2,1
24,251,251,18,1,17,2,1
10,252,252,12,12,0,1,0
31,262,262,8,8,0,1,0
2,283,283,16,16,0,1,0
36,291,291,12,3,9,2,1
20,350,350,35,35,0,1,0
3,354,354,16,1,15,4,3
23,360,360,12,12,0,1,0
26,373,373,107,67,40,3,2
11,378,378,27,27,0,1,0
29,379,379,9,9,0,1,0
32,380,380,100,52,48,4,3
0,380,380,22,3,19,4,3
28,406,406,123,57,66,4,3
13,411,411,12,12,0,1,0
14,433,433,85,85,0,1,0
18,434,434,10,10,0,1,0
35,440,440,15,15,0,1,0
19,446,446,20,20,0,1,0
34,453,453,82,50,32,2,1
15,476,476,38,19,19,4,3

29,110,110,23,23,0,1,0
36,131,131,15,15,0,1,0
26,157,157,2,2,0,1,0
11,159,159,12,3,9,4,3
8,159,159,5,5,0,1,0
18,190,190,1,1,0,1,0
15,192,192,2,2,0,1,0
34,216,216,38,38,0,1,0
7,219,219,3,3,0,1,0
19,241,241,19,1,18,4,3
0,253,253,1,1,0,1,0
30,260,260,44,23,21,2,1
9,263,263,7,7,0,1,0
1,265,265,2,2,0,1,0
4,267,267,66,8,58,4,3
38,278,278,52,52,0,1,0
5,282,282,28,28,0,1,0
27,289,289,17,5,12,4,3
35,292,292,40,40,0,1,0
16,311,311,7,7,0,1,0
10,337,337,11,11,0,1,0
31,337,337,14,5,9,2,1
22,338,338,18,18,0,1,0
23,341,341,1,1,0,1,0
32,350,350,2,2,0,1,0
6,367,367,56,34,22,3,2
39,376,376,23,17,6,2,1
2,412,412,35,35,0,1,0
33,416,416,20,9,11,2,1
21,423,423,35,7,28,2,1
3,431,431,79,79,0,1,0
12,434,434,21,21,0,1,0
20,437,437,55,27,28,4,3
28,447,447,32,32,0,1,0
24,456,456,10,10,0,1,0
13,456,456,78,15,63,3,2
14,456,456,5,1,4,2,1
37,480,480,11,1,10,2,1
17,496,496,15,15,0,1,0
25,497,497,141,141,0,1,0

14,100,100,1,1,0,1,0
22,111,111,13,13,0,1,0
35,139,139,31,2,29,4,3
7,139,139,21,21,0,1,0
26,140,140,14,2,12,4,3
24,140,140,23,2,21,4,3
25,141,141,12,12,0,1,0
13,144,144,12,12,0,1,0
2,153,153,2,2,0,1,0
34,155,155,50,37,13,2,1
8,156,156,23,23,0,1,0
9,182,182,68,32,36,4,3
5,206,206,2,2,0,1,0
11,207,207,1,1,0,1,0
33,217,217,18,18,0,1,0
17,217,217,4,4,0,1,0
4,230,230,18,3,15,4,3
3,254,254,3,3,0,1,0
6,276,276,1,1,0,1,0
0,279,279,68,6,62,3,2
19,302,302,23,23,0,1,0
21,302,302,24,24,0,1,0
16,306,306,7,7,0,1,0
18,319,319,2,2,0,1,0
1,330,330,9,2,7,3,2
29,354,354,1,1,0,1,0
30,385,385,95,80,15,2,1
32,387,387,3,3,0,1,0
23,405,405,5,5,0,1,0
28,407,407,54,18,36,2,1
20,415,415,10,2,8,3,2
27,420,420,4,4,0,1,0
12,420,420,35,35,0,1,0
10,460,460,36,36,0,1,0
15,480,480,76,58,18,4,3
31,492,492,12,6,6,3,2

20,109,109,2,2,0,1,0
24,143,143,34,19,15,2,1
4,150,150,42,42,0,1,0
19,155,155,6,6,0,1,0
7,168,168,17,17,0,1,0
1,172,172,98,98,0,1,0
13,179,179,20,3,17,3,2
28,248,248,21,21,0,1,0
3,253,253,16,16,0,1,0
18,262,262,28,1,27,4,3
6,268,268,8,8,0,1,0
2,274,274,9,3,6,3,2
25,277,277,21,21,0,1,0
0,287,287,42,42,0,1,0
10,287,287,11,11,0,1,0
21,290,290,13,13,0,1,0
15,301,301,1,1,0,1,0
5,305,305,20,20,0,1,0
27,329,329,52,52,0,1,0
12,353,353,37,5,32,2,1
22,360,360,119,31,88,3,2
8,377,377,25,14,11,2,1
23,391,391,74,38,36,4,3
11,394,394,22,22,0,1,0
17,398,398,44,44,0,1,0
9,413,413,20,20,0,1,0
14,456,456,19,11,8,3,2
16,473,473,32,32,0,1,0
26,478,478,5,5,0,1,0

27,104,104,7,1,6,3,2
21,112,112,10,4,6,2,1
30,131,131,10,10,0,1,0
17,135,135,7,1,6,3,2
4,195,195,4,4,0,1,0
29,195,195,3,3,0,1,0
0,198,198,6,6,0,1,0
8,212,212,34,34,0,1,0
23,219,219,45,45,0,1,0
7,220,220,49,49,0,1,0
5,223,223,19,16,3,2,1
13,233,233,25,4,21,4,3
11,254,254,12,12,0,1,0
14,261,261,33,33,0,1,0
10,279,279,21,21,0,1,0
20,289,289,11,2,9,2,1
19,303,303,56,23,33,4,3
22,308,308,119,68,51,4,3
25,311,311,21,2,19,4,3
18,329,329,13,13,0,1,0
3,339,339,9,1,8,3,2
2,342,342,31,9,22,2,1
12,356,356,111,111,0,1,0
16,390,390,33,21,12,4,3
26,407,407,12,12,0,1,0
1,443,443,21,11,10,2,1
9,448,448,31,4,27,4,3
28,466,466,21,21,0,1,0
6,490,490,88,88,0,1,0
24,492,492,93,88,5,2,1
15,493,493,31,4,27,2,1

18,113,113,8,3,5,2,1
14,151,151,1,1,0,1,0
1,170,170,4,4,0,1,0
19,188,188,3,3,0,1,0
28,213,213,11,11,0,1,0
23,221,221,19,19,0,1,0
9,222,222,22,3,19,2,1
32,237,237,43,34,9,4,3
2,240,240,31,7,24,3,2
21,294,294,14,6,8,3,2
6,298,298,73,34,39,4,3
13,337,337,1,1,0,1,0
15,350,350,18,12,6,2,1
4,350,350,25,25,0,1,0
8,360,360,56,56,0,1,0
24,377,377,82,82,0,1,0
3,381,381,47,47,0,1,0
26,384,384,30,30,0,1,0
11,385,385,10,10,0,1,0
25,387,387,34,34,0,1,0
0,388,388,39,39,0,1,0
17,424,424,21,15,6,2,1
7,425,425,167,130,37,2,1
16,440,440,22,22,0,1,0
27,443,443,2,2,0,1,0
22,445,445,102,15,87,4,3
31,445,445,138,127,11,2,1
20,447,447,13,13,0,1,0
10,447,447,4,4,0,1,0
12,455,455,20,20,0,1,0
30,457,457,75,67,8,3,2
29,472,472,1,1,0,1,0
5,482,482,34,27,7,2,1

16,136,136,6,6,0,1,0
18,185,185,53,23,30,3,2
20,196,196,14,5,9,2,1
3,197,197,35,9,26,2,1
10,226,226,35,11,24,2,1
24,229,229,27,10,17,2,1
14,232,232,8,8,0,1,0
22,258,258,3,3,0,1,0
21,268,268,15,15,0,1,0
5,271,271,58,21,37,2,1
26,286,286,9,5,4,2,1
6,288,288,87,87,0,1,0
12,292,292,4,4,0,1,0
15,304,304,25,9,16,3,2
23,314,314,153,125,28,2,1
9,317,317,32,14,18,4,3
0,338,338,10,10,0,1,0
11,385,385,7,1,6,3,2
25,406,406,48,30,18,2,1
8,415,415,58,12,46,2,1
4,417,417,9,9,0,1,0
17,421,421,65,65,0,1,0
19,421,421,16,16,0,1,0
2,425,425,38,38,0,1,0
7,447,447,40,16,24,4,3
13,450,450,28,16,12,3,2
1,498,498,140,96,44,4,3

2,106,106,9,9,0,1,0
8,127,127,17,17,0,1,0
33,128,128,5,5,0,1,0
6,143,143,20,20,0,1,0
13,162,162,48,48,0,1,0
24,163,163,2,2,0,1,0
11,211,211,3,3,0,1,0
20,220,220,12,12,0,1,0
1,232,232,14,14,0,1,0
27,232,232,18,8,10,2,1
29,244,244,22,22,0,1,0
10,249,249,2,2,0,1,0
21,255,255,39,39,0,1,0
25,259,259,22,10,12,2,1
23,295,295,12,12,0,1,0
3,297,297,19,19,0,1,0
18,302,302,3,3,0,1,0
22,327,327,65,44,21,4,3
16,335,335,30,30,0,1,0
12,363,363,4,4,0,1,0
14,376,376,3,3,0,1,0
26,378,378,89,29,60,3,2
28,382,382,170,86,84,4,3
7,385,385,44,44,0,1,0
32,394,394,7,1,6,2,1
5,409,409,133,7,126,4,3
0,427,427,32,32,0,1,0
30,439,439,27,27,0,1,0
19,466,466,27,27,0,1,0
4,468,468,1,1,0,1,0
15,471,471,26,26,0,1,0
17,472,472,46,10,36,4,3
31,473,473,25,25,0,1,0
9,500,500,11,11,0,1,0

18,103,103,2,2,0,1,0
15,180,180,9,9,0,1,0
1,184,184,14,14,0,1,0
27,184,184,7,7,0,1,0
19,195,195,5,5,0,1,0
13,200,200,19,7,12,4,3
14,217,217,78,34,44,3,2
0,224,224,18,18,0,1,0
23,231,231,28,6,22,2,1
32,238,238,33,4,29,2,1
10,239,239,65,24,41,2,1
22,253,253,11,11,0,1,0
5,261,261,20,20,0,1,0
30,277,277,30,12,18,4,3
24,280,280,10,10,0,1,0
11,298,298,39,12,27,4,3
17,299,299,59,26,33,2,1
12,313,313,26,19,7,2,1
9,315,315,1,1,0,1,0
4,318,318,31,31,0,1,0
16,319,319,4,4,0,1,0
7,320,320,54,54,0,1,0
8,339,339,1,1,0,1,0
31,349,349,14,3,11,2,1
3,370,370,30,30,0,1,0
26,371,371,71,64,7,2,1
25,422,422,115,55,60,4,3
21,431,431,75,43,32,2,1
6,446,446,3,3,0,1,0
28,456,456,19,9,10,2,1
20,465,465,86,86,0,1,0
2,471,471,2,2,0,1,0
29,476,476,2,2,0,1,0

5,122,122,21,21,0,1,0
23,129,129,15,6,9,2,1
26,135,135,15,15,0,1,0
36,145,145,20,6,14,4,3
32,149,149,6,6,0,1,0
28,160,160,42,32,10,3,2
22,161,161,4,4,0,1,0
10,162,162,6,6,0,1,0
37,177,177,6,6,0,1,0
20,186,186,1,1,0,1,0
24,204,204,25,4,21,3,2
29,216,216,7,7,0,1,0
27,218,218,3,3,0,1,0
15,223,223,6,6,0,1,0
6,235,235,12,4,8,3,2
4,257,257,1,1,0,1,0
0,268,268,1,1,0,1,0
34,277,277,24,24,0,1,0
7,288,288,35,35,0,1,0
33,306,306,8,4,4,2,1
35,306,306,122,30,92,4,3
21,314,314,12,4,8,2,1
1,314,314,12,12,0,1,0
25,330,330,6,3,3,2,1
11,337,337,27,3,24,3,2
19,341,341,1,1,0,1,0
14,349,349,35,8,27,2,1
31,365,365,11,11,0,1,0
17,379,379,49,5,44,2,1
9,392,392,27,27,0,1,0
39,396,396,50,50,0,1,0
40,401,401,7,1,6,2,1
16,403,403,22,1,21,4,3
2,415,415,2,2,0,1,0
3,432,432,33,33,0,1,0
13,435,435,24,24,0,1,0
12,440,440,52,16,36,2,1
38,440,440,130,130,0,1,0
30,441,441,4,1,3,2,1
18,448,448,56,56,0,1,0
8,475,475,12,12,0,1,0

20,102,102,12,6,6,3,2
18,110,110,1,1,0,1,0
6,112,112,3,3,0,1,0
2,112,112,19,19,0,1,0
8,161,161,8,2,6,3,2
13,163,163,24,24,0,1,0
12,165,165,32,32,0,1,0
16,189,189,6,6,0,1,0
5,189,189,10,3,7,2,1
31,240,240,14,14,0,1,0
17,253,253,6,6,0,1,0
15,268,268,18,8,10,3,2
22,275,275,14,14,0,1,0
24,278,278,12,12,0,1,0
1,312,312,14,2,12,2,1
26,317,317,29,29,0,1,0
27,330,330,57,12,45,4,3
21,330,330,16,8,8,3,2
11,342,342,85,7,78,4,3
30,342,342,48,48,0,1,0
0,347,347,24,24,0,1,0
25,373,373,18,7,11,4,3
29,379,379,46,26,20,2,1
28,385,385,147,147,0,1,0
19,397,397,75,75,0,1,0
7,400,400,88,88,0,1,0
14,413,413,1,1,0,1,0
9,414,414,3,3,0,1,0
10,422,422,3,3,0,1,0
3,422,422,114,14,100,3,2
23,433,433,48,48,0,1,0
4,469,469,11,6,5,2,1

16,102,102,5,5,0,1,0
17,102,102,22,22,0,1,0
8,138,138,4,4,0,1,0
24,140,140,7,1,6,3,2
10,148,148,53,53,0,1,0
25,164,164,3,3,0,1,0
21,169,169,64,30,34,3,2
15,185,185,30,17,13,2,1
3,194,194,20,2,18,2,1
2,203,203,9,3,6,2,1
11,242,242,16,16,0,1,0
14,269,269,27,27,0,1,0
5,283,283,4,4,0,1,0
18,308,308,30,30,0,1,0
12,323,323,6,6,0,1,0
19,324,324,6,1,5,2,1
6,345,345,17,11,6,2,1
26,355,355,78,18,60,4,3
23,362,362,13,1,12,4,3
1,363,363,74,17,57,4,3
9,384,384,67,53,14,2,1
22,418,418,22,3,19,2,1
7,424,424,124,124,0,1,0
20,445,445,44,44,0,1,0
13,459,459,23,5,18,4,3
0,473,473,141,72,69,4,3
4,480,480,18,4,14,4,3

23,116,116,22,22,0,1,0
24,158,158,26,26,0,1,0
26,166,166,25,25,0,1,0
15,183,183,19,9,10,3,2
17,196,196,13,13,0,1,0
10,206,206,14,14,0,1,0
8,207,207,48,48,0,1,0
19,210,210,22,22,0,1,0
6,211,211,1,1,0,1,0
2,253,253,4,1,3,2,1
27,273,273,7,7,0,1,0
29,285,285,24,24,0,1,0
25,293,293,22,4,18,4,3
21,306,306,40,40,0,1,0
11,311,311,71,40,31,3,2
16,318,318,31,31,0,1,0
3,331,331,15,10,5,2,1
5,351,351,99,9,90,4,3
13,353,353,67,43,24,3,2
9,356,356,10,3,7,2,1
12,359,359,9,9,0,1,0
22,375,375,74,74,0,1,0
0,376,376,22,22,0,1,0
4,381,381,124,40,84,3,2
14,418,418,22,22,0,1,0
1,441,441,25,8,17,2,1
28,442,442,20,20,0,1,0
18,443,443,24,24,0,1,0
20,450,450,41,41,0,1,0
7,494,494,20,2,18,4,3

31,101,101,10,2,8,3,2
2,116,116,22,22,0,1,0
7,139,139,40,40,0,1,0
20,139,139,9,9,0,1,0
23,142,142,4,4,0,1,0
1,143,143,8,8,0,1,0
4,154,154,26,7,19,2,1
30,162,162,31,31,0,1,0
15,165,165,4,4,0,1,0
8,188,188,11,5,6,3,2
24,194,194,6,6,0,1,0
14,206,206,5,2,3,2,1
25,236,236,17,17,0,1,0
21,262,262,48,48,0,1,0
26,268,268,57,39,18,4,3
17,270,270,1,1,0,1,0
9,271,271,16,16,0,1,0
16,291,291,30,4,26,3,2
3,299,299,1,1,0,1,0
29,304,304,75,41,34,3,2
13,341,341,98,12,86,4,3
12,351,351,18,18,0,1,0
6,367,367,10,10,0,1,0
22,371,371,38,4,34,3,2
18,381,381,28,6,22,3,2
10,388,388,59,6,53,3,2
11,405,405,45,45,0,1,0
19,407,407,5,5,0,1,0
5,419,419,32,4,28,2,1
0,423,423,11,11,0,1,0
27,440,440,71,22,49,4,3
28,446,446,22,22,0,1,0

25,102,102,25,25,0,1,0
5,107,107,3,3,0,1,0
30,114,114,2,2,0,1,0
22,199,199,26,26,0,1,0
27,228,228,16,16,0,1,0
21,229,229,2,2,0,1,0
29,236,236,3,3,0,1,0
19,270,270,14,6,8,2,1
13,272,272,34,34,0,1,0
0,302,302,61,40,21,2,1
9,314,314,43,43,0,1,0
10,316,316,5,5,0,1,0
28,318,318,23,23,0,1,0
2,327,327,180,66,114,4,3
4,332,332,3,3,0,1,0
6,348,348,3,3,0,1,0
23,349,349,15,8,7,2,1
8,349,349,9,3,6,2,1
7,356,356,8,3,5,2,1
17,369,369,19,19,0,1,0
1,418,418,88,9,79,4,3
14,423,423,1,1,0,1,0
24,425,425,38,5,33,4,3
11,428,428,38,38,0,1,0
18,430,430,71,44,27,2,1
16,438,438,188,116,72,4,3
26,449,449,7,7,0,1,0
20,453,453,10,4,6,2,1
12,488,488,41,41,0,1,0
3,488,488,45,21,24,2,1
15,496,496,102,102,0,1,0

22,102,102,4,4,0,1,0
33,103,103,11,11,0,1,0
2,107,107,1,1,0,1,0
20,116,116,15,15,0,1,0
27,118,118,4,4,0,1,0
18,128,128,15,5,10,2,1
17,139,139,13,1,12,3,2
8,142,142,1,1,0,1,0
31,142,142,69,69,0,1,0
1,164,164,1,1,0,1,0
14,174,174,10,2,8,2,1
13,177,177,13,13,0,1,0
15,206,206,3,3,0,1,0
0,234,234,1,1,0,1,0
21,246,246,16,6,10,3,2
24,271,271,4,4,0,1,0
11,277,277,31,31,0,1,0
19,295,295,3,3,0,1,0
10,302,302,131,89,42,3,2
5,305,305,4,4,0,1,0
6,339,339,15,5,10,2,1
9,342,342,48,6,42,4,3
3,343,343,44,31,13,4,3
25,360,360,8,1,7,2,1
32,376,376,37,37,0,1,0
4,393,393,21,6,15,4,3
30,411,411,65,19,46,3,2
16,418,418,5,5,0,1,0
12,420,420,164,130,34,2,1
7,422,422,4,4,0,1,0
23,442,442,95,80,15,4,3
29,482,482,28,16,12,3,2
26,483,483,10,10,0,1,0
28,489,489,32,14,18,4,3

4,100,100,4,4,0,1,0
32,104,104,1,1,0,1,0
19,106,106,24,4,20,2,1
29,122,122,7,1,6,3,2
8,129,129,7,4,3,2,1
9,132,132,35,21,14,2,1
6,144,144,13,13,0,1,0
16,148,148,8,8,0,1,0
26,184,184,18,10,8,3,2
31,207,207,27,11,16,3,2
13,208,208,1,1,0,1,0
10,210,210,4,4,0,1,0
3,225,225,72,47,25,4,3
1,236,236,6,6,0,1,0
22,242,242,10,2,8,3,2
2,245,245,6,3,3,2,1
20,249,249,17,17,0,1,0
28,250,250,1,1,0,1,0
15,265,265,7,7,0,1,0
30,266,266,11,11,0,1,0
25,332,332,5,5,0,1,0
24,340,340,131,68,63,4,3
27,346,346,100,100,0,1,0
7,355,355,116,77,39,4,3
21,363,363,2,2,0,1,0
17,394,394,22,22,0,1,0
12,396,396,9,5,4,2,1
14,429,429,108,11,97,4,3
23,436,436,89,89,0,1,0
0,444,444,1,1,0,1,0
18,445,445,2,2,0,1,0
5,455,455,30,30,0,1,0
11,462,462,6,6,0,1,0

4,100,100,11,6,5,2,1
26,113,113,22,22,0,1,0
24,119,119,10,3,7,2,1
31,124,124,16,2,14,2,1
27,126,126,11,11,0,1,0
1,127,127,1,1,0,1,0
30,181,181,10,7,3,2,1
35,182,182,28,28,0,1,0
14,183,183,10,2,8,2,1
12,185,185,3,3,0,1,0
25,200,200,3,3,0,1,0
17,227,227,1,1,0,1,0
13,231,231,40,8,32,3,2
33,235,235,23,14,9,4,3
10,257,257,2,2,0,1,0
8,267,267,26,4,22,2,1
18,268,268,2,2,0,1,0
36,271,271,10,7,3,2,1
22,276,276,11,11,0,1,0
19,337,337,8,8,0,1,0
15,352,352,28,19,9,4,3
11,354,354,18,10,8,2,1
6,361,361,4,4,0,1,0
20,394,394,22,8,14,3,2
3,400,400,16,2,14,2,1
38,401,401,37,9,28,3,2
0,410,410,154,111,43,4,3
23,419,419,9,9,0,1,0
9,420,420,62,62,0,1,0
16,423,423,12,12,0,1,0
5,425,425,39,4,35,4,3
34,440,440,231,143,88,3,2
7,441,441,66,14,52,3,2
2,446,446,7,3,4,2,1
32,455,455,10,10,0,1,0
29,466,466,12,12,0,1,0
37,472,472,5,5,0,1,0
28,475,475,42,2,40,2,1
21,496,496,6,6,0,1,0

21,107,107,10,10,0,1,0
20,126,126,3,3,0,1,0
5,131,131,27,7,20,3,2
19,134,134,11,11,0,1,0
24,146,146,55,27,28,3,2
32,153,153,12,2,10,3,2
14,155,155,19,1,18,2,1
10,157,157,16,16,0,1,0
6,160,160,14,14,0,1,0
30,164,164,7,7,0,1,0
3,187,187,1,1,0,1,0
4,190,190,10,10,0,1,0
17,191,191,29,9,20,2,1
33,204,204,15,7,8,2,1
0,211,211,22,22,0,1,0
9,254,254,6,6,0,1,0
15,265,265,18,12,6,2,1
18,275,275,12,3,9,2,1
23,298,298,6,6,0,1,0
26,322,322,57,19,38,3,2
1,357,357,43,43,0,1,0
22,359,359,79,63,16,2,1
25,377,377,6,6,0,1,0
12,380,380,30,10,20,3,2
13,382,382,33,14,19,3,2
7,382,382,19,1,18,4,3
2,382,382,21,21,0,1,0
29,399,399,3,3,0,1,0
16,412,412,41,41,0,1,0
34,417,417,60,6,54,3,2
28,434,434,6,6,0,1,0
11,473,473,25,25,0,1,0
31,481,481,19,4,15,4,3
27,487,487,113,64,49,4,3
8,500,500,45,45,0,1,0

2,125,125,9,1,8,3,2
27,165,165,29,29,0,1,0
1,173,173,3,3,0,1,0
29,203,203,34,34,0,1,0
20,206,206,6,6,0,1,0
13,213,213,27,18,9,4,3
7,219,219,43,43,0,1,0
11,233,233,4,4,0,1,0
12,258,258,2,2,0,1,0
25,266,266,1,1,0,1,0
24,266,266,69,57,12,4,3
30,268,268,6,1,5,2,1
31,293,293,20,20,0,1,0
16,314,314,9,5,4,2,1
22,319,319,20,20,0,1,0
28,333,333,11,11,0,1,0
6,341,341,23,23,0,1,0
15,343,343,4,1,3,2,1
17,343,343,58,58,0,1,0
23,370,370,58,29,29,4,3
32,411,411,75,75,0,1,0
8,422,422,35,13,22,2,1
19,424,424,2,2,0,1,0
26,424,424,30,11,19,3,2
3,444,444,102,102,0,1,0
18,445,445,41,35,6,2,1
21,447,447,58,15,43,2,1
5,452,452,29,29,0,1,0
10,460,460,33,6,27,2,1
9,482,482,82,8,74,3,2
14,483,483,153,15,138,4,3
0,490,490,53,53,0,1,0
4,493,493,7,7,0,1,0

22,105,105,8,8,0,1,0
24,113,113,13,13,0,1,0
1,141,141,3,3,0,1,0
10,142,142,9,9,0,1,0
25,178,178,3,3,0,1,0
18,182,182,10,10,0,1,0
21,185,185,18,18,0,1,0
12,187,187,23,23,0,1,0
14,190,190,93,38,55,3,2
7,205,205,70,70,0,1,0
15,255,255,26,11,15,2,1
19,268,268,10,10,0,1,0
9,273,273,44,23,21,2,1
11,295,295,10,2,8,2,1
6,298,298,15,15,0,1,0
5,301,301,39,39,0,1,0
8,309,309,167,71,96,4,3
3,316,316,47,21,26,3,2
16,318,318,112,6,106,4,3
2,367,367,12,8,4,2,1
20,377,377,1,1,0,1,0
23,384,384,2,2,0,1,0
0,388,388,68,68,0,1,0
13,477,477,20,20,0,1,0
17,480,480,12,1,11,2,1
4,482,482,1,1,0,1,0

6,104,104,4,1,3,2,1
18,112,112,3,3,0,1,0
14,114,114,18,18,0,1,0
0,118,118,5,5,0,1,0
25,120,120,2,2,0,1,0
2,124,124,29,29,0,1,0
22,125,125,10,10,0,1,0
24,126,126,13,3,10,2,1
13,135,135,12,6,6,3,2
27,187,187,61,61,0,1,0
23,191,191,2,2,0,1,0
26,195,195,23,3,20,3,2
15,201,201,49,49,0,1,0
7,205,205,31,31,0,1,0
1,206,206,1,1,0,1,0
10,213,213,21,21,0,1,0
17,243,243,55,55,0,1,0
3,270,270,38,38,0,1,0
28,308,308,6,6,0,1,0
9,349,349,28,4,24,4,3
16,367,367,32,25,7,2,1
8,406,406,77,27,50,3,2
20,414,414,44,17,27,4,3
11,431,431,16,1,15,2,1
12,435,435,34,3,31,2,1
5,437,437,163,107,56,3,2
29,447,447,26,26,0,1,0
4,447,447,21,21,0,1,0
21,464,464,13,1,12,4,3
19,481,481,16,16,0,1,0

26,109,109,14,5,9,4,3
30,109,109,3,3,0,1,0
7,113,113,1,1,0,1,0
25,124,124,29,21,8,2,1
19,158,158,42,31,11,2,1
12,161,161,28,25,3,2,1
2,168,168,1,1,0,1,0
24,191,191,2,2,0,1,0
14,197,197,3,3,0,1,0
9,209,209,47,7,40,2,1
16,210,210,2,2,0,1,0
20,212,212,10,4,6,3,2
17,224,224,1,1,0,1,0
10,225,225,14,14,0,1,0
6,237,237,41,26,15,2,1
21,239,239,33,1,32,3,2
23,265,265,87,75,12,4,3
28,267,267,3,3,0,1,0
5,268,268,22,22,0,1,0
15,271,271,6,6,0,1,0
8,279,279,30,30,0,1,0
18,281,281,67,5,62,3,2
0,299,299,9,9,0,1,0
29,314,314,12,1,11,2,1
13,319,319,47,20,27,2,1
22,362,362,49,49,0,1,0
3,428,428,1,1,0,1,0
1,440,440,46,46,0,1,0
11,444,444,179,111,68,3,2
4,483,483,30,20,10,2,1
27,484,484,2,2,0,1,0

2,102,102,14,5,9,2,1
17,115,115,15,3,12,2,1
31,126,126,2,2,0,1,0
20,142,142,9,9,0,1,0
24,148,148,38,11,27,4,3
16,152,152,2,2,0,1,0
22,156,156,9,4,5,2,1
12,160,160,41,41,0,1,0
8,190,190,21,7,14,4,3
27,192,192,13,13,0,1,0
5,237,237,1,1,0,1,0
10,242,242,10,10,0,1,0
1,255,255,3,3,0,1,0
18,263,263,61,49,12,2,1
0,296,296,24,24,0,1,0
25,296,296,41,30,11,2,1
26,300,300,29,19,10,2,1
3,315,315,48,41,7,2,1
29,335,335,2,2,0,1,0
23,336,336,70,70,0,1,0
7,365,365,28,10,18,3,2
9,403,403,6,2,4,2,1
19,406,406,73,43,30,3,2
13,406,406,55,55,0,1,0
14,415,415,95,95,0,1,0
30,438,438,23,23,0,1,0
15,453,453,97,97,0,1,0
4,464,464,26,26,0,1,0
28,482,482,28,11,17,2,1
11,483,483,25,25,0,1,0
21,495,495,35,17,18,4,3
6,497,497,14,7,7,2,1

21,102,102,2,2,0,1,0
10,103,103,3,3,0,1,0
29,126,126,19,19,0,1,0
14,136,136,1,1,0,1,0
8,149,149,17,5,12,4,3
20,151,151,6,6,0,1,0
1,166,166,2,2,0,1,0
24,195,195,104,8,96,4,3
15,198,198,7,2,5,2,1
5,216,216,9,9,0,1,0
12,238,238,111,111,0,1,0
3,269,269,8,8,0,1,0
0,290,290,53,7,46,3,2
11,291,291,3,3,0,1,0
18,299,299,19,19,0,1,0
4,303,303,77,38,39,4,3
31,345,345,9,9,0,1,0
19,348,348,9,9,0,1,0
13,349,349,57,15,42,2,1
28,375,375,54,54,0,1,0
7,380,380,28,18,10,2,1
9,382,382,35,35,0,1,0
22,385,385,56,30,26,4,3
26,394,394,14,10,4,2,1
2,408,408,2,2,0,1,0
16,409,409,42,42,0,1,0
30,410,410,21,21,0,1,0
17,416,416,61,9,52,3,2
25,417,417,34,20,14,2,1
6,430,430,37,26,11,2,1
27,490,490,15,7,8,2,1
23,497,497,15,9,6,3,2

16,113,113,2,2,0,1,0
25,126,126,47,4,43,2,1
19,134,134,7,3,4,2,1
10,147,147,5,5,0,1,0
3,153,153,27,27,0,1,0
13,168,168,7,7,0,1,0
9,173,173,4,4,0,1,0
18,225,225,19,19,0,1,0
30,249,249,16,10,6,3,2
1,249,249,5,5,0,1,0
26,311,311,39,5,34,2,1
24,319,319,4,4,0,1,0
21,325,325,11,3,8,2,1
6,326,326,12,12,0,1,0
12,327,327,5,2,3,2,1
20,329,329,9,9,0,1,0
7,331,331,9,1,8,3,2
17,342,342,17,17,0,1,0
5,344,344,31,15,16,2,1
11,351,351,6,6,0,1,0
8,360,360,55,55,0,1,0
23,376,376,19,19,0,1,0
14,382,382,82,10,72,4,3
27,404,404,29,1,28,2,1
31,424,424,4,4,0,1,0
28,461,461,48,19,29,4,3
2,465,465,184,54,130,4,3
4,469,469,17,17,0,1,0
0,475,475,34,34,0,1,0
15,487,487,121,13,108,4,3
22,492,492,3,3,0,1,0
29,499,499,272,189,83,3,2

26,105,105,3,3,0,1,0
28,112,112,1,1,0,1,0
14,117,117,1,1,0,1,0
4,184,184,16,7,9,4,3
21,186,186,11,5,6,2,1
3,190,190,21,14,7,2,1
9,197,197,35,35,0,1,0
29,205,205,14,8,6,2,1
16,211,211,45,45,0,1,0
18,214,214,7,7,0,1,0
8,215,215,72,72,0,1,0
7,227,227,32,18,14,2,1
0,266,266,16,16,0,1,0
30,284,284,26,10,16,3,2
20,293,293,15,15,0,1,0
5,307,307,23,23,0,1,0
27,310,310,9,9,0,1,0
6,331,331,61,61,0,1,0
11,344,344,10,10,0,1,0
22,358,358,60,60,0,1,0
13,361,361,27,27,0,1,0
24,363,363,26,11,15,2,1
2,372,372,26,10,16,2,1
17,382,382,47,40,7,2,1
25,385,385,53,30,23,2,1
10,391,391,37,13,24,2,1
23,427,427,92,77,15,4,3
1,429,429,43,43,0,1,0
15,435,435,83,42,41,4,3
19,488,488,63,63,0,1,0
12,492,492,26,26,0,1,0

28,100,100,15,12,3,2,1
0,118,118,2,2,0,1,0
14,139,139,1,1,0,1,0
5,140,140,10,10,0,1,0
31,167,167,3,3,0,1,0
29,201,201,22,15,7,2,1
2,202,202,6,6,0,1,0
4,208,208,55,46,9,4,3
8,231,231,6,6,0,1,0
3,241,241,17,11,6,2,1
1,244,244,1,1,0,1,0
6,251,251,45,33,12,2,1
9,253,253,26,26,0,1,0
26,263,263,99,53,46,3,2
12,269,269,90,48,42,3,2
23,269,269,17,17,0,1,0
15,282,282,2,2,0,1,0
30,285,285,5,5,0,1,0
13,300,300,9,9,0,1,0
32,316,316,20,7,13,2,1
24,327,327,57,27,30,4,3
10,338,338,9,9,0,1,0
16,341,341,7,7,0,1,0
20,348,348,6,6,0,1,0
11,354,354,83,75,8,3,2
21,360,360,85,67,18,2,1
22,371,371,21,3,18,3,2
17,399,399,55,47,8,2,1
18,405,405,29,29,0,1,0
33,440,440,23,13,10,2,1
27,444,444,25,13,12,2,1
7,476,476,18,10,8,3,2
19,477,477,12,12,0,1,0
25,486,486,68,30,38,2,1

0,100,100,9,9,0,1,0
27,104,104,11,11,0,1,0
12,116,116,15,3,12,4,3
3,117,117,5,5,0,1,0
25,135,135,1,1,0,1,0
7,155,155,24,24,0,1,0
2,160,160,12,3,9,4,3
30,162,162,5,5,0,1,0
18,163,163,1,1,0,1,0
1,178,178,24,24,0,1,0
14,188,188,56,56,0,1,0
24,210,210,3,3,0,1,0
5,211,211,8,8,0,1,0
22,211,211,31,8,23,2,1
16,258,258,8,3,5,2,1
9,270,270,8,2,6,2,1
6,277,277,23,14,9,2,1
19,296,296,52,36,16,3,2
10,309,309,49,35,14,3,2
26,347,347,56,39,17,2,1
13,363,363,8,2,6,2,1
17,373,373,21,13,8,3,2
8,386,386,4,4,0,1,0
20,387,387,17,17,0,1,0
29,394,394,4,4,0,1,0
15,450,450,129,48,81,4,3
23,455,455,20,5,15,4,3
11,456,456,104,33,71,4,3
21,467,467,115,31,84,4,3
4,480,480,51,39,12,3,2
28,480,480,125,14,111,4,3

24,108,108,21,21,0,1,0
22,144,144,50,50,0,1,0
10,151,151,35,35,0,1,0
32,159,159,26,13,13,3,2
30,173,173,13,1,12,2,1
3,178,178,6,6,0,1,0
7,190,190,38,38,0,1,0
26,198,198,38,38,0,1,0
8,201,201,8,8,0,1,0
4,237,237,25,17,8,3,2
23,247,247,54,54,0,1,0
9,265,265,33,33,0,1,0
14,275,275,3,3,0,1,0
18,277,277,3,3,0,1,0
33,288,288,19,19,0,1,0
2,301,301,4,4,0,1,0
28,301,301,1,1,0,1,0
31,305,305,2,2,0,1,0
5,319,319,47,13,34,2,1
20,346,346,6,6,0,1,0
27,366,366,25,25,0,1,0
11,368,368,11,8,3,2,1
25,369,369,32,32,0,1,0
13,395,395,6,1,5,2,1
12,422,422,20,3,17,2,1
6,432,432,3,3,0,1,0
1,446,446,8,8,0,1,0
29,450,450,34,34,0,1,0
19,454,454,12,12,0,1,0
0,456,456,135,78,57,4,3
21,460,460,37,37,0,1,0
17,464,464,21,21,0,1,0
15,466,466,67,1,66,3,2
16,485,485,45,45,0,1,0

30,114,114,12,12,0,1,0
22,123,123,2,2,0,1,0
1,141,141,2,2,0,1,0
25,156,156,9,2,7,2,1
32,182,182,15,5,10,2,1
4,219,219,33,33,0,1,0
17,233,233,2,2,0,1,0
6,247,247,15,6,9,2,1
29,250,250,45,6,39,2,1
0,251,251,142,142,0,1,0
26,251,251,1,1,0,1,0
11,264,264,41,8,33,2,1
18,307,307,35,35,0,1,0
10,313,313,13,1,12,3,2
12,328,328,6,6,0,1,0
15,329,329,21,3,18,2,1
21,343,343,38,38,0,1,0
3,349,349,19,19,0,1,0
16,355,355,28,16,12,4,3
13,357,357,33,3,30,2,1
28,365,365,11,11,0,1,0
24,387,387,53,12,41,3,2
2,402,402,6,6,0,1,0
19,403,403,86,86,0,1,0
20,407,407,25,5,20,2,1
31,414,414,4,4,0,1,0
27,420,420,201,145,56,4,3
14,425,425,9,9,0,1,0
5,461,461,2,2,0,1,0
23,468,468,12,3,9,4,3
8,489,489,81,48,33,2,1
9,497,497,41,29,12,2,1
7,498,498,9,9,0,1,0

23,151,151,6,6,0,1,0
6,167,167,9,9,0,1,0
9,187,187,11,11,0,1,0
14,209,209,6,6,0,1,0
26,223,223,4,4,0,1,0
22,224,224,2,2,0,1,0
13,230,230,36,36,0,1,0
10,240,240,14,14,0,1,0
1,274,274,81,81,0,1,0
4,277,277,99,65,34,3,2
27,278,278,106,20,86,3,2
7,285,285,35,6,29,2,1
16,301,301,7,7,0,1,0
5,324,324,25,5,20,3,2
25,325,325,45,45,0,1,0
17,348,348,5,5,0,1,0
20,348,348,24,24,0,1,0
0,351,351,22,22,0,1,0
12,362,362,10,10,0,1,0
18,373,373,9,9,0,1,0
3,409,409,52,52,0,1,0
11,410,410,134,134,0,1,0
8,410,410,20,9,11,2,1
19,448,448,7,7,0,1,0
15,453,453,116,17,99,4,3
2,467,467,5,5,0,1,0
24,467,467,143,126,17,4,3
21,476,476,59,59,0,1,0

24,101,101,2,2,0,1,0
3,121,121,5,1,4,2,1
32,123,123,5,5,0,1,0
4,151,151,2,2,0,1,0
8,162,162,28,28,0,1,0
1,171,171,7,7,0,1,0
27,181,181,9,9,0,1,0
25,196,196,29,1,28,2,1
23,197,197,33,33,0,1,0
0,207,207,37,3,34,3,2
2,219,219,1,1,0,1,0
19,228,228,8,8,0,1,0
21,236,236,56,56,0,1,0
22,279,279,4,4,0,1,0
17,297,297,23,23,0,1,0
10,307,307,28,22,6,3,2
28,331,331,17,17,0,1,0
11,340,340,133,133,0,1,0
9,350,350,1,1,0,1,0
29,371,371,53,53,0,1,0
18,401,401,16,9,7,2,1
20,406,406,16,2,14,3,2
15,427,427,5,5,0,1,0
13,437,437,10,10,0,1,0
30,438,438,90,90,0,1,0
26,445,445,74,49,25,3,2
16,454,454,3,3,0,1,0
5,459,459,35,13,22,3,2
7,473,473,100,31,69,4,3
6,485,485,13,13,0,1,0
12,487,487,15,15,0,1,0
31,494,494,98,53,45,4,3
14,495,495,137,14,123,4,3

24,110,110,34,34,0,1,0
16,133,133,23,11,12,4,3
6,135,135,41,41,0,1,0
25,165,165,10,2,8,3,2
5,167,167,5,5,0,1,0
10,176,176,40,22,18,3,2
15,184,184,26,26,0,1,0
0,213,213,2,2,0,1,0
9,213,213,8,3,5,2,1
21,217,217,2,2,0,1,0
29,218,218,32,12,20,2,1
1,222,222,21,8,13,2,1
17,243,243,13,13,0,1,0
8,251,251,7,1,6,2,1
7,257,257,29,4,25,2,1
4,262,262,2,2,0,1,0
26,268,268,28,16,12,3,2
33,290,290,10,4,6,2,1
19,296,296,6,6,0,1,0
14,296,296,10,5,5,2,1
11,302,302,11,11,0,1,0
3,310,310,37,2,35,2,1
31,320,320,17,17,0,1,0
13,326,326,5,5,0,1,0
32,341,341,135,26,109,4,3
27,349,349,47,13,34,2,1
22,369,369,23,7,16,2,1
30,387,387,59,16,43,2,1
28,422,422,6,6,0,1,0
2,424,424,69,69,0,1,0
12,428,428,7,7,0,1,0
23,444,444,21,21,0,1,0
20,476,476,20,5,15,2,1
18,481,481,23,15,8,2,1

29,100,100,3,3,0,1,0
16,113,113,25,12,13,2,1
24,117,117,26,26,0,1,0
6,122,122,1,1,0,1,0
25,125,125,21,21,0,1,0
26,163,163,18,3,15,2,1
28,170,170,9,9,0,1,0
1,186,186,26,26,0,1,0
22,221,221,69,69,0,1,0
14,252,252,9,9,0,1,0
20,267,267,3,3,0,1,0
17,273,273,41,13,28,4,3
8,280,280,5,1,4,2,1
11,285,285,24,24,0,1,0
5,326,326,7,7,0,1,0
15,330,330,51,20,31,3,2
33,331,331,95,33,62,4,3
12,348,348,60,40,20,4,3
31,354,354,3,3,0,1,0
21,356,356,3,3,0,1,0
19,389,389,41,10,31,2,1
4,389,389,38,12,26,3,2
10,405,405,60,60,0,1,0
18,409,409,21,21,0,1,0
30,440,440,75,75,0,1,0
27,446,446,26,26,0,1,0
3,451,451,24,4,20,3,2
7,457,457,49,49,0,1,0
32,473,473,10,3,7,2,1
13,474,474,4,4,0,1,0
9,476,476,3,3,0,1,0
2,491,491,48,20,28,3,2
0,495,495,39,16,23,2,1
23,500,500,14,14,0,1,0

1,112,112,44,10,34,2,1
6,141,141,27,9,18,3,2
16,145,145,6,6,0,1,0
13,148,148,1,1,0,1,0
11,161,161,16,16,0,1,0
21,165,165,27,27,0,1,0
2,186,186,26,26,0,1,0
19,212,212,9,9,0,1,0
8,238,238,52,4,48,2,1
10,262,262,17,11,6,2,1
14,269,269,4,4,0,1,0
17,289,289,14,7,7,2,1
12,329,329,14,8,6,3,2
3,339,339,11,11,0,1,0
5,373,373,26,17,9,2,1
9,378,378,24,20,4,2,1
20,394,394,147,98,49,3,2
24,397,397,42,14,28,2,1
7,409,409,60,60,0,1,0
4,409,409,26,11,15,2,1
23,445,445,11,11,0,1,0
22,459,459,72,12,60,4,3
15,460,460,137,137,0,1,0
18,474,474,41,33,8,3,2
0,492,492,171,171,0,1,0

9,117,117,12,4,8,2,1
24,119,119,2,2,0,1,0
27,121,121,7,7,0,1,0
8,127,127,5,5,0,1,0
6,150,150,17,3,14,2,1
4,173,173,7,1,6,3,2
14,187,187,78,10,68,3,2
17,189,189,6,6,0,1,0
7,202,202,19,19,0,1,0
16,231,231,1,1,0,1,0
25,238,238,16,16,0,1,0
22,265,265,25,25,0,1,0
19,266,266,58,58,0,1,0
21,267,267,18,6,12,3,2
1,283,283,5,5,0,1,0
10,301,301,37,37,0,1,0
28,354,354,11,11,0,1,0
5,377,377,46,46,0,1,0
23,394,394,16,5,11,2,1
13,395,395,114,92,22,3,2
18,410,410,2,2,0,1,0
11,413,413,7,3,4,2,1
2,421,421,55,55,0,1,0
0,422,422,68,26,42,4,3
20,426,426,13,13,0,1,0
29,448,448,102,84,18,3,2
12,458,458,110,31,79,4,3
15,489,489,100,44,56,3,2
26,492,492,58,36,22,3,2
3,494,494,55,36,19,2,1

26,105,105,8,8,0,1,0
15,127,127,11,2,9,2,1
29,132,132,11,11,0,1,0
7,172,172,1,1,0,1,0
8,187,187,2,2,0,1,0
35,199,199,6,6,0,1,0
30,207,207,18,5,13,3,2
20,212,212,46,46,0,1,0
9,214,214,5,5,0,1,0
25,225,225,21,7,14,2,1
19,254,254,7,2,5,2,1
11,265,265,3,3,0,1,0
28,277,277,8,1,7,2,1
34,281,281,4,4,0,1,0
14,283,283,41,9,32,4,3
23,284,284,20,20,0,1,0
2,286,286,15,15,0,1,0
22,286,286,14,4,10,2,1
16,287,287,13,13,0,1,0
17,291,291,32,32,0,1,0
27,311,311,8,8,0,1,0
21,323,323,64,14,50,3,2
18,328,328,76,37,39,4,3
6,353,353,16,11,5,2,1
3,366,366,52,52,0,1,0
0,381,381,60,60,0,1,0
31,399,399,47,47,0,1,0
12,400,400,79,68,11,2,1
13,404,404,4,4,0,1,0
32,410,410,37,3,34,3,2
4,421,421,19,10,9,4,3
24,444,444,158,158,0,1,0
10,450,450,82,74,8,2,1
5,471,471,10,10,0,1,0
33,483,483,46,13,33,2,1
1,487,487,25,10,15,4,3

22,106,106,6,6,0,1,0
31,110,110,3,3,0,1,0
28,129,129,9,9,0,1,0
14,139,139,18,11,7,2,1
8,158,158,8,2,6,3,2
18,161,161,16,4,12,2,1
3,180,180,19,19,0,1,0
13,180,180,20,20,0,1,0
5,195,195,13,13,0,1,0
32,212,212,12,8,4,2,1
33,216,216,1,1,0,1,0
1,217,217,2,2,0,1,0
20,229,229,65,65,0,1,0
7,237,237,1,1,0,1,0
29,245,245,70,52,18,2,1
11,250,250,80,44,36,3,2
21,267,267,15,15,0,1,0
0,272,272,12,4,8,3,2
4,274,274,10,10,0,1,0
16,308,308,16,9,7,2,1
23,321,321,20,20,0,1,0
26,326,326,31,31,0,1,0
10,332,332,10,10,0,1,0
15,340,340,67,21,46,3,2
2,342,342,6,6,0,1,0
9,365,365,69,48,21,4,3
27,384,384,5,2,3,2,1
25,386,386,63,63,0,1,0
30,392,392,102,102,0,1,0
6,409,409,11,5,6,3,2
19,412,412,9,9,0,1,0
24,413,413,30,30,0,1,0
17,453,453,82,82,0,1,0
12,477,477,14,14,0,1,0

15,111,111,1,1,0,1,0
4,115,115,7,7,0,1,0
26,138,138,11,5,6,2,1
18,148,148,4,4,0,1,0
20,153,153,45,29,16,3,2
1,159,159,31,19,12,3,2
12,164,164,4,4,0,1,0
9,166,166,2,2,0,1,0
28,173,173,4,4,0,1,0
13,179,179,1,1,0,1,0
6,203,203,6,6,0,1,0
29,211,211,6,6,0,1,0
7,226,226,57,57,0,1,0
30,275,275,23,8,15,2,1
8,322,322,4,4,0,1,0
16,324,324,132,68,64,3,2
0,339,339,56,28,28,2,1
11,348,348,90,61,29,2,1
14,349,349,79,42,37,4,3
27,350,350,18,18,0,1,0
3,368,368,9,1,8,2,1
24,379,379,9,9,0,1,0
22,402,402,52,32,20,3,2
10,413,413,89,89,0,1,0
25,414,414,38,38,0,1,0
23,416,416,51,29,22,2,1
19,438,438,56,56,0,1,0
5,462,462,48,15,33,4,3
21,468,468,10,5,5,2,1
2,474,474,7,7,0,1,0
17,500,500,56,56,0,1,0

6,104,104,2,2,0,1,0
27,107,107,9,9,0,1,0
3,120,120,8,8,0,1,0
16,135,135,1,1,0,1,0
8,136,136,8,2,6,2,1
22,143,143,28,8,20,3,2
19,145,145,4,4,0,1,0
13,182,182,53,44,9,4,3
20,196,196,16,6,10,2,1
28,233,233,32,32,0,1,0
25,244,244,37,22,15,2,1
14,246,246,71,71,0,1,0
26,251,251,93,54,39,2,1
18,253,253,22,22,0,1,0
33,265,265,5,5,0,1,0
5,272,272,17,17,0,1,0
15,275,275,30,30,0,1,0
9,289,289,14,14,0,1,0
4,298,298,7,7,0,1,0
12,328,328,9,1,8,2,1
23,338,338,9,2,7,2,1
7,339,339,68,13,55,4,3
10,358,358,15,15,0,1,0
1,361,361,27,9,18,2,1
29,378,378,46,46,0,1,0
17,407,407,67,19,48,4,3
31,415,415,26,26,0,1,0
34,438,438,17,17,0,1,0
2,440,440,3,3,0,1,0
30,453,453,42,42,0,1,0
21,462,462,68,36,32,3,2
24,473,473,8,8,0,1,0
32,478,478,28,28,0,1,0
11,487,487,10,10,0,1,0
0,497,497,1,1,0,1,0

10,102,102,8,8,0,1,0
6,107,107,10,2,8,3,2
4,108,108,9,9,0,1,0
25,124,124,1,1,0,1,0
14,135,135,28,18,10,3,2
23,138,138,13,13,0,1,0
12,144,144,8,8,0,1,0
33,162,162,12,2,10,3,2
16,184,184,6,6,0,1,0
30,186,186,10,4,6,2,1
20,195,195,95,29,66,4,3
31,199,199,11,11,0,1,0
18,203,203,4,4,0,1,0
34,206,206,3,3,0,1,0
2,208,208,1,1,0,1,0
8,222,222,13,3,10,3,2
5,224,224,2,2,0,1,0
21,228,228,4,4,0,1,0
29,247,247,81,35,46,2,1
32,266,266,12,4,8,2,1
1,298,298,18,18,0,1,0
22,319,319,84,84,0,1,0
26,326,326,2,2,0,1,0
28,329,329,13,5,8,3,2
27,335,335,20,6,14,2,1
17,336,336,12,12,0,1,0
13,380,380,25,22,3,2,1
19,383,383,5,2,3,2,1
15,397,397,138,99,39,3,2
7,405,405,21,9,12,2,1
24,428,428,31,23,8,3,2
0,439,439,1,1,0,1,0
3,457,457,64,12,52,3,2
11,458,458,115,115,0,1,0
9,460,460,2,2,0,1,0

19,104,104,3,3,0,1,0
0,110,110,2,2,0,1,0
1,114,114,11,11,0,1,0
11,126,126,11,11,0,1,0
8,146,146,20,20,0,1,0
28,161,161,15,15,0,1,0
23,167,167,5,5,0,1,0
20,189,189,26,21,5,2,1
25,227,227,34,2,32,3,2
5,230,230,64,10,54,3,2
15,257,257,10,7,3,2,1
7,275,275,26,26,0,1,0
18,275,275,8,8,0,1,0
31,284,284,34,34,0,1,0
26,288,288,6,3,3,2,1
6,289,289,1,1,0,1,0
4,291,291,19,10,9,2,1
27,297,297,71,71,0,1,0
2,299,299,1,1,0,1,0
30,304,304,20,9,11,2,1
13,306,306,5,5,0,1,0
9,333,333,154,128,26,4,3
14,336,336,2,2,0,1,0
17,336,336,36,22,14,2,1
29,366,366,44,8,36,2,1
22,381,381,142,55,87,4,3
10,397,397,14,14,0,1,0
16,404,404,71,27,44,2,1
24,404,404,8,5,3,2,1
3,443,443,20,20,0,1,0
21,454,454,8,8,0,1,0
32,485,485,43,16,27,4,3
12,490,490,18,18,0,1,0

6,113,113,19,10,9,4,3
34,118,118,7,7,0,1,0
14,119,119,3,3,0,1,0
13,135,135,40,40,0,1,0
24,147,147,1,1,0,1,0
16,151,151,20,20,0,1,0
19,159,159,1,1,0,1,0
23,169,169,15,7,8,2,1
28,171,171,13,1,12,3,2
31,192,192,55,55,0,1,0
27,218,218,20,8,12,2,1
1,227,227,15,15,0,1,0
17,227,227,1,1,0,1,0
3,252,252,2,2,0,1,0
36,286,286,29,15,14,2,1
11,294,294,20,20,0,1,0
5,299,299,11,11,0,1,0
25,300,300,53,20,33,2,1
10,306,306,29,8,21,2,1
21,333,333,65,45,20,2,1
8,334,334,37,37,0,1,0
4,362,362,9,9,0,1,0
0,371,371,16,10,6,3,2
26,380,380,33,9,24,3,2
20,381,381,16,2,14,4,3
30,388,388,23,17,6,3,2
2,397,397,82,7,75,4,3
7,399,399,16,13,3,2,1
22,401,401,1,1,0,1,0
12,417,417,46,46,0,1,0
35,429,429,64,64,0,1,0
15,473,473,7,7,0,1,0
33,474,474,42,2,40,2,1
32,492,492,52,52,0,1,0
29,493,493,32,26,6,2,1
18,494,494,13,13,0,1,0
9,497,497,38,38,0,1,0

20,105,105,28,18,10,3,2
21,108,108,7,1,6,2,1
11,111,111,1,1,0,1,0
23,111,111,6,6,0,1,0
3,125,125,2,2,0,1,0
25,157,157,30,30,0,1,0
30,163,163,4,4,0,1,0
8,166,166,9,9,0,1,0
17,166,166,17,17,0,1,0
10,171,171,7,7,0,1,0
15,174,174,16,16,0,1,0
22,231,231,2,2,0,1,0
18,239,239,12,12,0,1,0
27,256,256,32,32,0,1,0
14,265,265,2,2,0,1,0
0,267,267,20,20,0,1,0
4,298,298,173,44,129,4,3
12,304,304,31,1,30,3,2
7,313,313,81,60,21,4,3
19,319,319,25,13,12,2,1
28,320,320,102,62,40,3,2
2,360,360,52,9,43,2,1
24,405,405,26,26,0,1,0
13,415,415,27,17,10,3,2
5,434,434,10,1,9,4,3
16,443,443,38,38,0,1,0
9,448,448,9,9,0,1,0
29,451,451,49,49,0,1,0
26,458,458,2,2,0,1,0
6,468,468,61,15,46,3,2
1,491,491,36,15,21,2,1

12,112,112,1,1,0,1,0
25,112,112,19,19,0,1,0
10,118,118,11,11,0,1,0
7,155,155,5,5,0,1,0
19,159,159,2,2,0,1,0
6,175,175,31,31,0,1,0
0,176,176,9,9,0,1,0
22,184,184,1,1,0,1,0
13,192,192,28,14,14,2,1
26,192,192,3,3,0,1,0
14,201,201,1,1,0,1,0
5,218,218,3,3,0,1,0
24,218,218,24,4,20,2,1
17,232,232,21,21,0,1,0
15,277,277,53,10,43,2,1
3,278,278,32,29,3,2,1
20,324,324,53,26,27,3,2
1,333,333,109,109,0,1,0
31,345,345,43,43,0,1,0
2,376,376,66,44,22,2,1
9,381,381,15,3,12,4,3
8,387,387,5,5,0,1,0
18,400,400,62,24,38,3,2
30,406,406,21,17,4,2,1
27,411,411,47,47,0,1,0
16,445,445,119,83,36,4,3
11,462,462,23,2,21,2,1
4,467,467,76,48,28,2,1
21,476,476,10,10,0,1,0
29,480,480,127,84,43,2,1
23,484,484,7,7,0,1,0
28,497,497,27,18,9,4,3

30,108,108,17,17,0,1,0
7,110,110,1,1,0,1,0
10,127,127,1,1,0,1,0
5,129,129,4,4,0,1,0
3,141,141,9,9,0,1,0
18,143,143,19,12,7,2,1
14,147,147,14,14,0,1,0
21,166,166,2,2,0,1,0
24,198,198,23,23,0,1,0
27,211,211,18,9,9,4,3
6,214,214,8,8,0,1,0
4,227,227,30,17,13,4,3
1,235,235,32,22,10,2,1
13,243,243,51,38,13,2,1
25,244,244,10,10,0,1,0
16,262,262,8,8,0,1,0
15,276,276,27,27,0,1,0
32,283,283,17,5,12,4,3
31,297,297,63,24,39,4,3
8,304,304,37,31,6,3,2
26,308,308,73,32,41,2,1
22,325,325,15,15,0,1,0
33,328,328,63,63,0,1,0
20,335,335,8,2,6,3,2
11,346,346,35,35,0,1,0
0,379,379,30,13,17,2,1
23,386,386,4,4,0,1,0
12,388,388,2,2,0,1,0
28,390,390,108,69,39,4,3
2,399,399,34,34,0,1,0
34,404,404,29,7,22,3,2
9,448,448,88,88,0,1,0
29,451,451,38,38,0,1,0
19,457,457,6,6,0,1,0
17,495,495,14,2,12,3,2

8,103,103,24,3,21,4,3
35,121,121,3,3,0,1,0
37,122,122,8,5,3,2,1
9,147,147,6,6,0,1,0
29,149,149,1,1,0,1,0
23,151,151,24,24,0,1,0
11,186,186,6,1,5,2,1
30,189,189,34,34,0,1,0
3,195,195,1,1,0,1,0
21,215,215,1,1,0,1,0
22,221,221,12,7,5,2,1
12,244,244,2,2,0,1,0
32,245,245,4,4,0,1,0
15,246,246,12,12,0,1,0
5,252,252,1,1,0,1,0
26,253,253,15,15,0,1,0
24,271,271,2,2,0,1,0
14,281,281,9,9,0,1,0
4,284,284,110,110,0,1,0
6,295,295,46,3,43,2,1
38,306,306,3,3,0,1,0
17,310,310,17,5,12,4,3
10,323,323,1,1,0,1,0
33,324,324,11,3,8,3,2
34,326,326,96,34,62,3,2
27,334,334,33,33,0,1,0
36,337,337,82,32,50,2,1
2,343,343,1,1,0,1,0
20,374,374,14,2,12,2,1
25,375,375,2,2,0,1,0
31,381,381,73,37,36,3,2
1,386,386,3,3,0,1,0
28,387,387,46,30,16,3,2
0,387,387,3,3,0,1,0
7,398,398,23,3,20,3,2
19,406,406,46,28,18,2,1
18,417,417,17,1,16,3,2
16,425,425,30,30,0,1,0
13,426,426,17,3,14,2,1
39,427,427,121,31,90,4,3

14,102,102,3,3,0,1,0
18,106,106,4,4,0,1,0
13,159,159,9,9,0,1,0
1,166,166,7,7,0,1,0
16,166,166,3,3,0,1,0
23,186,186,33,33,0,1,0
25,201,201,28,28,0,1,0
20,207,207,10,10,0,1,0
2,228,228,49,31,18,2,1
6,246,246,19,19,0,1,0
26,249,249,4,4,0,1,0
3,255,255,1,1,0,1,0
8,267,267,1,1,0,1,0
15,288,288,9,9,0,1,0
24,306,306,25,11,14,3,2
12,307,307,19,19,0,1,0
10,318,318,17,5,12,4,3
0,346,346,41,41,0,1,0
11,352,352,140,35,105,4,3
5,377,377,111,79,32,3,2
4,384,384,16,3,13,2,1
19,428,428,121,66,55,4,3
28,434,434,98,98,0,1,0
7,438,438,28,14,14,2,1
21,462,462,168,108,60,4,3
9,462,462,106,106,0,1,0
22,479,479,39,39,0,1,0
17,484,484,8,2,6,2,1
27,488,488,18,4,14,3,2

12,114,114,7,4,3,2,1
31,121,121,3,3,0,1,0
19,132,132,5,5,0,1,0
24,151,151,10,10,0,1,0
0,166,166,3,3,0,1,0
21,179,179,22,22,0,1,0
7,199,199,3,3,0,1,0
10,214,214,2,2,0,1,0
34,229,229,14,14,0,1,0
2,258,258,3,3,0,1,0
26,261,261,38,15,23,2,1
11,263,263,15,9,6,3,2
14,282,282,112,72,40,3,2
13,291,291,4,4,0,1,0
6,300,300,11,11,0,1,0
16,303,303,41,33,8,3,2
29,309,309,49,14,35,2,1
33,318,318,144,86,58,3,2
18,329,329,31,13,18,4,3
25,343,343,2,2,0,1,0
22,368,368,14,14,0,1,0
5,379,379,13,5,8,3,2
20,382,382,25,11,14,2,1
3,383,383,9,5,4,2,1
1,386,386,179,179,0,1,0
15,398,398,11,11,0,1,0
9,405,405,61,61,0,1,0
32,417,417,4,4,0,1,0
17,426,426,12,12,0,1,0
27,440,440,88,43,45,4,3
30,450,450,27,27,0,1,0
4,452,452,3,3,0,1,0
28,472,472,67,10,57,4,3
23,490,490,21,7,14,3,2
8,494,494,9,9,0,1,0

23,101,101,27,15,12,3,2
2,105,105,12,12,0,1,0
26,106,106,33,22,11,2,1
34,125,125,4,4,0,1,0
24,150,150,5,5,0,1,0
20,150,150,1,1,0,1,0
19,157,157,6,1,5,2,1
32,178,178,12,12,0,1,0
35,181,181,56,8,48,4,3
15,194,194,1,1,0,1,0
33,201,201,3,3,0,1,0
21,202,202,14,6,8,3,2
16,216,216,65,13,52,3,2
11,219,219,3,3,0,1,0
10,236,236,1,1,0,1,0
1,250,250,26,12,14,3,2
3,265,265,12,12,0,1,0
29,320,320,1,1,0,1,0
30,343,343,49,27,22,2,1
6,343,343,1,1,0,1,0
14,350,350,44,44,0,1,0
31,354,354,1,1,0,1,0
22,358,358,25,25,0,1,0
4,366,366,46,16,30,2,1
18,389,389,34,19,15,4,3
28,393,393,17,17,0,1,0
8,406,406,6,6,0,1,0
7,407,407,79,79,0,1,0
25,420,420,88,88,0,1,0
17,428,428,1,1,0,1,0
12,430,430,23,3,20,3,2
0,440,440,70,40,30,2,1
13,443,443,52,39,13,2,1
5,460,460,39,39,0,1,0
27,469,469,28,9,19,2,1
9,472,472,6,6,0,1,0

6,112,112,3,3,0,1,0
20,130,130,19,19,0,1,0
22,132,132,25,25,0,1,0
2,181,181,2,2,0,1,0
15,184,184,12,5,7,2,1
21,192,192,8,8,0,1,0
8,212,212,4,4,0,1,0
5,215,215,74,74,0,1,0
25,233,233,27,1,26,3,2
23,236,236,14,14,0,1,0
11,256,256,16,1,15,2,1
14,261,261,3,3,0,1,0
4,280,280,118,118,0,1,0
26,301,301,56,17,39,2,1
1,301,301,71,71,0,1,0
3,315,315,13,1,12,4,3
27,325,325,85,44,41,2,1
12,327,327,67,50,17,2,1
18,327,327,23,23,0,1,0
10,332,332,29,29,0,1,0
7,394,394,16,2,14,3,2
19,416,416,31,31,0,1,0
0,430,430,64,50,14,2,1
13,432,432,9,9,0,1,0
9,433,433,71,42,29,2,1
16,435,435,15,15,0,1,0
17,451,451,13,13,0,1,0
24,499,499,56,5,51,4,3

21,107,107,10,10,0,1,0
14,138,138,1,1,0,1,0
28,143,143,6,3,3,2,1
11,146,146,14,4,10,2,1
2,167,167,10,6,4,2,1
19,178,178,24,24,0,1,0
6,214,214,35,35,0,1,0
20,237,237,8,8,0,1,0
31,259,259,3,3,0,1,0
13,274,274,43,5,38,4,3
8,276,276,1,1,0,1,0
30,279,279,82,82,0,1,0
0,289,289,1,1,0,1,0
29,289,289,10,2,8,3,2
7,298,298,40,40,0,1,0
37,305,305,109,35,74,4,3
23,305,305,18,18,0,1,0
10,324,324,47,16,31,2,1
5,325,325,10,6,4,2,1
16,329,329,30,30,0,1,0
24,331,331,25,4,21,4,3
1,334,334,13,4,9,4,3
12,338,338,34,34,0,1,0
15,343,343,2,2,0,1,0
35,351,351,17,5,12,4,3
25,363,363,19,4,15,4,3
32,371,371,2,2,0,1,0
17,397,397,6,6,0,1,0
34,398,398,1,1,0,1,0
4,406,406,29,19,10,2,1
9,426,426,52,7,45,4,3
36,428,428,152,82,70,3,2
18,434,434,8,8,0,1,0
27,450,450,20,3,17,2,1
26,461,461,69,6,63,4,3
33,462,462,18,3,15,2,1
22,469,469,25,19,6,2,1
3,483,483,37,37,0,1,0

24,103,103,23,14,9,4,3
32,117,117,10,10,0,1,0
22,122,122,6,6,0,1,0
30,124,124,11,11,0,1,0
12,132,132,8,2,6,3,2
31,146,146,3,3,0,1,0
1,189,189,24,24,0,1,0
6,199,199,1,1,0,1,0
3,217,217,32,32,0,1,0
28,227,227,24,24,0,1,0
15,229,229,14,4,10,2,1
21,240,240,74,43,31,2,1
8,244,244,24,4,20,3,2
23,256,256,48,28,20,2,1
17,261,261,22,10,12,2,1
25,263,263,50,10,40,2,1
20,263,263,17,1,16,2,1
7,272,272,15,15,0,1,0
29,276,276,4,4,0,1,0
18,281,281,15,15,0,1,0
4,288,288,1,1,0,1,0
0,296,296,1,1,0,1,0
26,320,320,26,12,14,3,2
33,326,326,7,1,6,2,1
5,343,343,33,33,0,1,0
16,369,369,1,1,0,1,0
19,384,384,12,12,0,1,0
2,387,387,57,15,42,4,3
27,400,400,51,44,7,2,1
10,403,403,82,37,45,2,1
13,441,441,45,45,0,1,0
9,444,444,49,41,8,3,2
11,449,449,20,20,0,1,0
34,455,455,20,3,17,2,1
14,476,476,94,36,58,3,2

28,104,104,12,12,0,1,0
7,124,124,21,12,9,4,3
13,128,128,9,9,0,1,0
4,140,140,4,4,0,1,0
26,156,156,5,5,0,1,0
17,173,173,37,29,8,3,2
19,186,186,53,53,0,1,0
30,188,188,47,47,0,1,0
2,223,223,30,30,0,1,0
27,244,244,12,12,0,1,0
9,267,267,4,1,3,2,1
8,273,273,27,9,18,4,3
33,295,295,1,1,0,1,0
11,298,298,20,5,15,4,3
15,312,312,25,11,14,3,2
18,314,314,60,60,0,1,0
5,318,318,5,5,0,1,0
22,331,331,162,133,29,2,1
12,348,348,9,9,0,1,0
21,349,349,10,7,3,2,1
1,356,356,9,9,0,1,0
31,368,368,1,1,0,1,0
6,387,387,19,12,7,2,1
16,411,411,132,94,38,3,2
20,436,436,28,16,12,3,2
25,441,441,1,1,0,1,0
23,446,446,4,1,3,2,1
3,457,457,87,87,0,1,0
10,469,469,15,15,0,1,0
14,481,481,23,23,0,1,0
32,486,486,30,30,0,1,0
29,492,492,4,4,0,1,0
0,499,499,10,4,6,3,2
24,500,500,22,22,0,1,0

9,102,102,6,6,0,1,0
3,112,112,28,17,11,2,1
8,113,113,31,31,0,1,0
32,125,125,8,5,3,2,1
29,170,170,1,1,0,1,0
17,176,176,28,28,0,1,0
21,177,177,17,1,16,3,2
27,202,202,3,3,0,1,0
20,202,202,33,33,0,1,0
16,205,205,2,2,0,1,0
11,213,213,2,2,0,1,0
23,225,225,7,4,3,2,1
10,231,231,7,4,3,2,1
15,231,231,5,5,0,1,0
31,259,259,21,9,12,4,3
5,268,268,1,1,0,1,0
2,282,282,8,5,3,2,1
25,282,282,10,3,7,2,1
12,301,301,1,1,0,1,0
19,334,334,24,7,17,2,1
4,346,346,43,43,0,1,0
1,348,348,9,9,0,1,0
24,351,351,103,60,43,4,3
7,367,367,81,63,18,4,3
13,371,371,10,10,0,1,0
0,418,418,37,10,27,3,2
26,423,423,30,30,0,1,0
14,453,453,137,92,45,2,1
18,460,460,185,44,141,4,3
6,470,470,59,1,58,3,2
28,482,482,9,9,0,1,0
30,485,485,53,9,44,3,2
22,498,498,10,10,0,1,0

28,101,101,25,17,8,2,1
18,102,102,1,1,0,1,0
15,105,105,2,2,0,1,0
27,120,120,4,4,0,1,0
29,121,121,26,23,3,2,1
19,122,122,12,12,0,1,0
33,124,124,23,17,6,2,1
10,131,131,4,4,0,1,0
31,134,134,6,2,4,2,1
26,142,142,16,16,0,1,0
11,143,143,4,4,0,1,0
9,174,174,3,3,0,1,0
0,176,176,1,1,0,1,0
17,200,200,10,1,9,4,3
1,220,220,6,6,0,1,0
34,228,228,16,7,9,4,3
23,241,241,11,6,5,2,1
32,270,270,26,16,10,3,2
30,286,286,4,1,3,2,1
6,298,298,2,2,0,1,0
14,298,298,13,3,10,2,1
4,305,305,23,23,0,1,0
7,333,333,72,45,27,4,3
13,345,345,24,24,0,1,0
8,356,356,1,1,0,1,0
5,372,372,91,65,26,2,1
25,373,373,3,3,0,1,0
36,377,377,66,16,50,2,1
12,400,400,16,16,0,1,0
20,403,403,8,8,0,1,0
3,427,427,51,51,0,1,0
2,432,432,10,10,0,1,0
22,437,437,46,46,0,1,0
35,459,459,44,2,42,4,3
24,464,464,60,32,28,2,1
21,478,478,71,56,15,4,3
16,493,493,150,150,0,1,0
37,497,497,34,34,0,1,0

10,117,117,4,4,0,1,0
21,133,133,9,9,0,1,0
14,151,151,14,8,6,3,2
30,170,170,12,12,0,1,0
29,176,176,23,8,15,4,3
6,218,218,1,1,0,1,0
26,220,220,1,1,0,1,0
35,220,220,25,5,20,2,1
34,224,224,79,7,72,4,3
2,235,235,1,1,0,1,0
3,238,238,16,16,0,1,0
16,238,238,12,12,0,1,0
25,246,246,17,17,0,1,0
27,249,249,3,3,0,1,0
33,252,252,63,5,58,3,2
37,254,254,35,35,0,1,0
20,255,255,10,10,0,1,0
31,265,265,57,15,42,3,2
32,284,284,12,12,0,1,0
18,298,298,21,16,5,2,1
24,303,303,21,7,14,3,2
12,303,303,31,1,30,3,2
19,313,313,30,24,6,2,1
11,331,331,2,2,0,1,0
5,333,333,83,83,0,1,0
38,354,354,23,23,0,1,0
36,360,360,15,1,14,2,1
7,383,383,23,2,21,4,3
28,390,390,6,6,0,1,0
4,392,392,7,7,0,1,0
13,392,392,28,28,0,1,0
8,393,393,92,71,21,2,1
23,397,397,15,15,0,1,0
9,406,406,34,34,0,1,0
17,437,437,49,49,0,1,0
0,464,464,12,12,0,1,0
1,478,478,25,10,15,2,1
22,488,488,27,27,0,1,0
15,499,499,2,2,0,1,0

23,141,141,3,3,0,1,0
30,142,142,2,2,0,1,0
16,180,180,1,1,0,1,0
26,194,194,12,7,5,2,1
31,200,200,17,17,0,1,0
17,240,240,17,3,14,2,1
28,245,245,66,29,37,2,1
15,252,252,31,31,0,1,0
4,275,275,4,1,3,2,1
7,276,276,15,15,0,1,0
18,283,283,56,56,0,1,0
32,287,287,23,5,18,3,2
19,289,289,37,15,22,3,2
9,291,291,12,12,0,1,0
27,295,295,31,13,18,2,1
24,305,305,46,19,27,4,3
3,339,339,12,6,6,2,1
20,343,343,4,4,0,1,0
10,363,363,38,38,0,1,0
1,365,365,52,8,44,3,2
13,371,371,17,17,0,1,0
25,374,374,24,12,12,2,1
22,378,378,110,80,30,4,3
2,393,393,161,101,60,4,3
11,395,395,6,6,0,1,0
12,395,395,35,8,27,2,1
0,402,402,76,76,0,1,0
5,425,425,45,24,21,2,1
8,447,447,7,7,0,1,0
6,451,451,58,40,18,3,2
21,457,457,7,7,0,1,0
29,481,481,30,22,8,3,2
14,486,486,40,40,0,1,0

18,100,100,1,1,0,1,0
4,102,102,5,5,0,1,0
31,109,109,4,4,0,1,0
7,122,122,7,7,0,1,0
32,130,130,12,12,0,1,0
30,142,142,13,13,0,1,0
36,165,165,21,10,11,2,1
3,169,169,5,5,0,1,0
2,170,170,56,5,51,4,3
24,175,175,77,77,0,1,0
17,175,175,34,30,4,2,1
16,178,178,8,8,0,1,0
26,186,186,8,8,0,1,0
22,198,198,18,18,0,1,0
13,219,219,15,8,7,2,1
9,244,244,1,1,0,1,0
8,246,246,21,12,9,2,1
12,262,262,9,9,0,1,0
27,276,276,20,20,0,1,0
28,290,290,3,3,0,1,0
23,301,301,17,9,8,3,2
6,305,305,7,2,5,2,1
0,323,323,1,1,0,1,0
1,336,336,23,4,19,4,3
34,345,345,37,37,0,1,0
35,346,346,33,33,0,1,0
10,349,349,90,36,54,3,2
15,357,357,1,1,0,1,0
19,360,360,12,12,0,1,0
21,364,364,54,54,0,1,0
20,382,382,18,3,15,4,3
29,420,420,20,8,12,4,3
33,426,426,7,7,0,1,0
14,445,445,24,24,0,1,0
5,449,449,44,6,38,3,2
11,454,454,49,35,14,3,2
25,458,458,74,74,0,1,0

13,115,115,17,7,10,2,1
30,119,119,3,3,0,1,0
16,174,174,3,3,0,1,0
3,195,195,4,1,3,2,1
10,203,203,5,2,3,2,1
12,212,212,19,19,0,1,0
1,218,218,22,10,12,2,1
9,256,256,16,1,15,4,3
19,275,275,49,49,0,1,0
2,283,283,11,11,0,1,0
25,286,286,12,12,0,1,0
7,328,328,130,130,0,1,0
4,328,328,26,26,0,1,0
6,336,336,33,20,13,2,1
22,337,337,22,22,0,1,0
14,346,346,9,5,4,2,1
20,365,365,42,42,0,1,0
5,369,369,62,11,51,3,2
24,379,379,93,57,36,3,2
8,380,380,29,8,21,4,3
11,398,398,8,8,0,1,0
15,410,410,53,53,0,1,0
29,437,437,132,15,117,4,3
23,439,439,40,12,28,3,2
28,451,451,6,6,0,1,0
17,458,458,11,11,0,1,0
18,467,467,35,3,32,3,2
0,469,469,118,41,77,4,3
26,482,482,72,26,46,2,1
21,483,483,26,19,7,2,1
27,500,500,47,26,21,4,3

7,134,134,2,2,0,1,0
22,155,155,2,2,0,1,0
27,159,159,11,11,0,1,0
2,162,162,12,4,8,3,2
19,164,164,46,46,0,1,0
5,173,173,11,7,4,2,1
32,175,175,50,5,45,4,3
24,180,180,32,32,0,1,0
11,189,189,23,6,17,4,3
6,223,223,1,1,0,1,0
23,227,227,1,1,0,1,0
4,258,258,9,9,0,1,0
12,272,272,43,43,0,1,0
0,283,283,34,34,0,1,0
10,290,290,29,16,13,2,1
21,308,308,67,43,24,4,3
14,316,316,36,36,0,1,0
33,318,318,5,5,0,1,0
17,331,331,49,49,0,1,0
29,332,332,2,2,0,1,0
16,345,345,3,3,0,1,0
20,350,350,3,3,0,1,0
15,355,355,6,6,0,1,0
28,375,375,1,1,0,1,0
18,388,388,38,38,0,1,0
8,398,398,12,4,8,2,1
13,417,417,11,5,6,3,2
30,419,419,3,3,0,1,0
26,425,425,164,146,18,3,2
35,426,426,69,69,0,1,0
3,439,439,49,49,0,1,0
1,447,447,4,1,3,2,1
34,472,472,110,35,75,4,3
31,482,482,2,2,0,1,0
25,492,492,17,8,9,2,1
9,499,499,33,33,0,1,0

3,129,129,28,23,5,2,1
6,131,131,6,6,0,1,0
4,140,140,11,6,5,2,1
13,156,156,5,1,4,2,1
5,161,161,17,5,12,2,1
8,178,178,6,6,0,1,0
25,212,212,23,23,0,1,0
0,242,242,36,36,0,1,0
22,264,264,73,62,11,2,1
18,264,264,5,5,0,1,0
27,271,271,45,6,39,2,1
2,293,293,88,73,15,2,1
19,294,294,35,35,0,1,0
1,299,299,34,4,30,3,2
17,300,300,32,32,0,1,0
16,317,317,18,9,9,4,3
23,326,326,7,7,0,1,0
24,354,354,4,4,0,1,0
20,356,356,81,21,60,3,2
10,373,373,17,8,9,2,1
21,382,382,4,4,0,1,0
7,393,393,54,54,0,1,0
26,404,404,66,66,0,1,0
12,409,409,28,4,24,4,3
15,424,424,37,13,24,3,2
9,461,461,8,8,0,1,0
11,475,475,170,149,21,4,3
14,487,487,75,75,0,1,0

15,108,108,2,2,0,1,0
21,110,110,12,12,0,1,0
27,113,113,6,6,0,1,0
17,119,119,7,4,3,2,1
2,136,136,7,1,6,2,1
26,172,172,2,2,0,1,0
8,181,181,8,8,0,1,0
11,181,181,3,3,0,1,0
28,184,184,9,3,6,2,1
7,197,197,110,54,56,3,2
6,203,203,19,19,0,1,0
16,207,207,5,1,4,2,1
20,211,211,4,4,0,1,0
0,221,221,70,63,7,2,1
12,257,257,6,6,0,1,0
1,271,271,21,11,10,4,3
19,277,277,92,50,42,2,1
14,282,282,47,8,39,2,1
22,284,284,69,69,0,1,0
25,290,290,7,1,6,3,2
9,295,295,25,25,0,1,0
24,301,301,40,16,24,2,1
29,313,313,75,75,0,1,0
3,325,325,10,10,0,1,0
4,329,329,46,27,19,2,1
10,345,345,1,1,0,1,0
23,363,363,59,59,0,1,0
13,414,414,31,11,20,3,2
18,475,475,1,1,0,1,0
5,497,497,43,12,31,2,1

7,103,103,2,2,0,1,0
22,125,125,34,34,0,1,0
19,151,151,5,5,0,1,0
18,160,160,6,6,0,1,0
26,174,174,16,6,10,3,2
3,186,186,37,37,0,1,0
10,209,209,15,3,12,3,2
20,224,224,32,23,9,4,3
6,254,254,61,49,12,3,2
17,286,286,11,11,0,1,0
31,292,292,36,25,11,2,1
27,296,296,107,11,96,3,2
21,297,297,23,10,13,2,1
28,299,299,4,4,0,1,0
29,309,309,17,14,3,2,1
13,335,335,24,24,0,1,0
4,342,342,1,1,0,1,0
15,347,347,41,15,26,3,2
11,347,347,18,18,0,1,0
2,355,355,2,2,0,1,0
30,357,357,33,29,4,2,1
8,367,367,36,29,7,2,1
0,382,382,82,82,0,1,0
9,443,443,65,65,0,1,0
14,444,444,51,33,18,4,3
1,462,462,14,14,0,1,0
12,472,472,16,16,0,1,0
23,473,473,46,46,0,1,0
24,481,481,17,9,8,2,1
16,486,486,41,41,0,1,0
25,493,493,35,14,21,4,3
5,499,499,91,76,15,2,1

9,103,103,4,4,0,1,0
14,104,104,1,1,0,1,0
28,106,106,17,17,0,1,0
16,109,109,5,2,3,2,1
21,114,114,4,4,0,1,0
3,126,126,44,9,35,3,2
6,131,131,7,2,5,2,1
17,134,134,8,8,0,1,0
25,138,138,26,26,0,1,0
24,157,157,45,16,29,2,1
22,172,172,8,8,0,1,0
8,222,222,6,6,0,1,0
5,233,233,28,28,0,1,0
4,250,250,30,24,6,3,2
18,252,252,67,67,0,1,0
20,258,258,14,4,10,2,1
26,264,264,1,1,0,1,0
12,274,274,74,53,21,2,1
7,297,297,46,10,36,3,2
27,307,307,10,6,4,2,1
19,360,360,85,21,64,3,2
1,383,383,26,26,0,1,0
15,385,385,50,50,0,1,0
11,397,397,62,56,6,2,1
13,407,407,26,26,0,1,0
2,413,413,66,12,54,4,3
0,427,427,19,19,0,1,0
10,427,427,17,17,0,1,0
23,487,487,16,10,6,2,1

17,128,128,21,21,0,1,0
22,137,137,29,16,13,2,1
2,141,141,13,13,0,1,0
9,147,147,23,15,8,3,2
3,159,159,11,11,0,1,0
7,179,179,24,10,14,3,2
21,179,179,27,27,0,1,0
16,186,186,54,11,43,2,1
24,187,187,1,1,0,1,0
18,213,213,2,2,0,1,0
11,216,216,26,3,23,4,3
23,269,269,8,8,0,1,0
20,275,275,12,12,0,1,0
6,284,284,32,32,0,1,0
13,285,285,27,9,18,2,1
15,300,300,23,8,15,2,1
8,321,321,12,12,0,1,0
0,337,337,95,95,0,1,0
1,344,344,154,129,25,2,1
10,356,356,4,4,0,1,0
5,365,365,98,26,72,4,3
12,388,388,5,5,0,1,0
4,450,450,1,1,0,1,0
14,476,476,157,91,66,4,3
19,482,482,2,2,0,1,0
25,494,494,40,8,32,3,2

16,110,110,3,3,0,1,0
26,132,132,15,15,0,1,0
3,151,151,16,16,0,1,0
15,162,162,9,9,0,1,0
5,176,176,63,37,26,2,1
17,176,176,34,11,23,4,3
23,193,193,11,11,0,1,0
11,237,237,61,46,15,4,3
18,268,268,13,13,0,1,0
8,273,273,63,63,0,1,0
0,285,285,4,1,3,2,1
7,291,291,23,23,0,1,0
25,293,293,11,11,0,1,0
6,300,300,51,51,0,1,0
14,311,311,34,34,0,1,0
4,325,325,10,10,0,1,0
19,341,341,10,10,0,1,0
24,369,369,50,50,0,1,0
21,385,385,13,13,0,1,0
20,394,394,11,5,6,2,1
2,395,395,116,116,0,1,0
1,410,410,16,16,0,1,0
12,441,441,179,179,0,1,0
22,448,448,4,4,0,1,0
9,454,454,20,20,0,1,0
10,464,464,109,79,30,3,2
13,473,473,44,4,40,4,3

28,128,128,25,4,21,2,1
17,141,141,15,15,0,1,0
30,146,146,9,4,5,2,1
1,148,148,9,2,7,2,1
14,154,154,8,8,0,1,0
12,156,156,24,14,10,3,2
0,172,172,12,12,0,1,0
6,174,174,5,5,0,1,0
16,179,179,47,47,0,1,0
20,182,182,4,4,0,1,0
8,191,191,7,2,5,2,1
2,207,207,16,2,14,2,1
13,213,213,7,7,0,1,0
11,215,215,57,25,32,3,2
4,225,225,12,12,0,1,0
18,238,238,12,7,5,2,1
31,244,244,69,69,0,1,0
36,253,253,56,56,0,1,0
35,277,277,52,46,6,2,1
10,303,303,6,6,0,1,0
25,315,315,10,10,0,1,0
21,319,319,8,5,3,2,1
23,331,331,35,35,0,1,0
26,335,335,73,28,45,4,3
34,342,342,20,13,7,2,1
7,345,345,22,22,0,1,0
24,359,359,4,4,0,1,0
15,362,362,19,19,0,1,0
3,367,367,28,28,0,1,0
9,379,379,20,8,12,3,2
5,398,398,12,12,0,1,0
32,406,406,19,19,0,1,0
22,409,409,17,17,0,1,0
27,468,468,40,40,0,1,0
19,477,477,16,16,0,1,0
29,495,495,20,20,0,1,0
33,499,499,8,8,0,1,0

11,102,102,13,7,6,3,2
0,103,103,28,2,26,3,2
2,105,105,36,21,15,2,1
10,126,126,27,27,0,1,0
17,141,141,43,43,0,1,0
19,150,150,7,4,3,2,1
13,152,152,2,2,0,1,0
23,156,156,5,5,0,1,0
5,168,168,3,3,0,1,0
16,180,180,3,3,0,1,0
9,199,199,43,5,38,3,2
6,208,208,11,11,0,1,0
1,234,234,20,8,12,3,2
3,238,238,29,20,9,2,1
20,239,239,11,6,5,2,1
14,266,266,8,8,0,1,0
12,327,327,14,9,5,2,1
21,371,371,11,11,0,1,0
7,375,375,119,36,83,4,3
22,375,375,12,12,0,1,0
15,423,423,13,13,0,1,0
4,439,439,172,172,0,1,0
18,470,470,25,25,0,1,0
8,478,478,196,142,54,4,3

10,106,106,14,14,0,1,0
2,120,120,21,16,5,2,1
7,130,130,46,11,35,2,1
13,132,132,6,6,0,1,0
9,136,136,5,2,3,2,1
0,148,148,41,41,0,1,0
20,171,171,6,6,0,1,0
14,174,174,27,27,0,1,0
6,180,180,14,10,4,2,1
3,189,189,15,11,4,2,1
25,192,192,3,3,0,1,0
15,233,233,17,3,14,3,2
24,242,242,53,46,7,2,1
21,255,255,27,11,16,3,2
16,263,263,19,19,0,1,0
8,289,289,77,77,0,1,0
19,292,292,79,51,28,3,2
23,309,309,6,6,0,1,0
1,314,314,49,49,0,1,0
4,315,315,33,33,0,1,0
18,319,319,18,18,0,1,0
11,349,349,36,36,0,1,0
12,374,374,68,68,0,1,0
5,390,390,29,20,9,4,3
22,426,426,58,34,24,3,2
17,428,428,5,5,0,1,0

11,118,118,12,12,0,1,0
22,119,119,39,39,0,1,0
21,134,134,3,3,0,1,0
25,138,138,30,30,0,1,0
23,140,140,29,11,18,4,3
0,156,156,8,8,0,1,0
2,165,165,2,2,0,1,0
6,183,183,7,7,0,1,0
17,191,191,1,1,0,1,0
33,204,204,12,5,7,2,1
5,213,213,1,1,0,1,0
34,219,219,12,12,0,1,0
24,221,221,49,27,22,3,2
29,228,228,5,5,0,1,0
13,238,238,36,26,10,2,1
20,278,278,4,4,0,1,0
3,281,281,25,5,20,2,1
16,297,297,17,17,0,1,0
28,300,300,13,10,3,2,1
15,322,322,12,3,9,4,3
35,332,332,14,14,0,1,0
31,338,338,29,19,10,3,2
27,362,362,13,2,11,2,1
14,369,369,10,10,0,1,0
8,371,371,71,71,0,1,0
7,372,372,12,12,0,1,0
9,373,373,35,35,0,1,0
19,374,374,3,3,0,1,0
30,393,393,38,38,0,1,0
12,396,396,55,55,0,1,0
10,415,415,3,3,0,1,0
18,439,439,37,37,0,1,0
4,443,443,74,61,13,3,2
1,463,463,141,141,0,1,0
32,481,481,19,4,15,4,3
26,494,494,73,73,0,1,0

8,113,113,12,3,9,4,3
7,121,121,6,6,0,1,0
11,129,129,19,10,9,2,1
21,130,130,3,3,0,1,0
0,136,136,4,1,3,2,1
16,151,151,51,41,10,2,1
3,160,160,50,4,46,2,1
14,175,175,21,3,18,3,2
6,179,179,49,24,25,2,1
9,213,213,1,1,0,1,0
5,224,224,1,1,0,1,0
19,237,237,12,12,0,1,0
26,242,242,33,33,0,1,0
23,246,246,1,1,0,1,0
18,247,247,27,3,24,4,3
28,283,283,10,10,0,1,0
24,289,289,14,14,0,1,0
2,290,290,55,55,0,1,0
17,303,303,6,6,0,1,0
22,303,303,57,48,9,4,3
12,303,303,39,39,0,1,0
25,344,344,116,71,45,4,3
15,409,409,6,2,4,2,1
4,410,410,65,22,43,4,3
20,413,413,20,4,16,2,1
13,430,430,54,15,39,4,3
10,432,432,38,38,0,1,0
1,435,435,48,48,0,1,0
27,445,445,15,8,7,2,1

5,121,121,6,6,0,1,0
21,157,157,24,24,0,1,0
23,180,180,11,11,0,1,0
17,191,191,17,17,0,1,0
13,202,202,27,1,26,3,2
24,203,203,10,4,6,2,1
6,209,209,25,25,0,1,0
27,234,234,28,28,0,1,0
7,237,237,1,1,0,1,0
16,260,260,19,19,0,1,0
3,267,267,117,102,15,4,3
14,269,269,47,11,36,3,2
2,288,288,10,10,0,1,0
1,290,290,39,30,9,3,2
8,293,293,3,3,0,1,0
10,307,307,4,4,0,1,0
26,309,309,14,6,8,2,1
22,312,312,1,1,0,1,0
12,324,324,52,52,0,1,0
15,331,331,26,18,8,2,1
11,360,360,4,4,0,1,0
25,372,372,55,55,0,1,0
0,372,372,64,21,43,2,1
19,376,376,30,30,0,1,0
20,383,383,10,10,0,1,0
4,394,394,41,41,0,1,0
28,411,411,27,19,8,3,2
18,419,419,12,3,9,4,3
9,439,439,19,19,0,1,0
30,449,449,31,3,28,3,2
29,465,465,252,164,88,3,2

2,102,102,9,1,8,3,2
30,118,118,9,9,0,1,0
16,129,129,16,16,0,1,0
8,142,142,6,6,0,1,0
32,148,148,13,13,0,1,0
14,176,176,7,2,5,2,1
26,219,219,1,1,0,1,0
33,250,250,7,3,4,2,1
21,254,254,12,12,0,1,0
25,259,259,26,26,0,1,0
10,268,268,20,4,16,2,1
9,269,269,41,41,0,1,0
28,275,275,7,7,0,1,0
5,276,276,3,3,0,1,0
29,281,281,28,13,15,4,3
17,282,282,38,38,0,1,0
11,284,284,25,13,12,3,2
0,302,302,14,2,12,2,1
19,349,349,88,88,0,1,0
7,351,351,66,66,0,1,0
20,364,364,3,3,0,1,0
18,366,366,17,7,10,3,2
12,382,382,63,27,36,2,1
23,415,415,117,51,66,4,3
27,423,423,69,25,44,2,1
4,444,444,26,1,25,2,1
24,455,455,38,38,0,1,0
3,477,477,127,73,54,4,3
15,480,480,12,12,0,1,0
22,483,483,143,143,0,1,0
1,488,488,18,8,10,3,2
13,492,492,10,10,0,1,0
31,492,492,14,14,0,1,0
6,498,498,21,21,0,1,0

24,120,120,19,5,14,3,2
16,127,127,3,3,0,1,0
22,129,129,2,2,0,1,0
14,156,156,9,9,0,1,0
1,175,175,14,1,13,2,1
23,175,175,26,8,18,4,3
5,184,184,39,39,0,1,0
12,198,198,36,20,16,2,1
13,201,201,20,20,0,1,0
30,209,209,8,5,3,2,1
19,214,214,23,23,0,1,0
26,215,215,23,7,16,2,1
7,222,222,2,2,0,1,0
2,250,250,13,13,0,1,0
21,259,259,1,1,0,1,0
9,275,275,84,84,0,1,0
17,280,280,45,45,0,1,0
28,328,328,8,2,6,2,1
4,345,345,26,26,0,1,0
11,355,355,76,55,21,4,3
29,362,362,70,37,33,4,3
10,375,375,1,1,0,1,0
18,379,379,121,85,36,2,1
15,390,390,63,63,0,1,0
0,407,407,5,2,3,2,1
8,446,446,13,13,0,1,0
3,457,457,28,11,17,3,2
6,467,467,98,98,0,1,0
20,479,479,46,17,29,2,1
25,480,480,4,4,0,1,0
27,481,481,34,15,19,4,3

5,109,109,11,4,7,2,1
18,135,135,3,3,0,1,0
30,137,137,14,14,0,1,0
32,151,151,22,22,0,1,0
19,157,157,19,1,18,3,2
26,159,159,24,11,13,2,1
14,189,189,18,10,8,3,2
6,212,212,3,3,0,1,0
7,216,216,28,28,0,1,0
0,229,229,19,11,8,3,2
27,231,231,5,5,0,1,0
29,247,247,74,4,70,3,2
12,288,288,5,5,0,1,0
11,290,290,5,5,0,1,0
28,291,291,22,22,0,1,0
24,299,299,6,6,0,1,0
15,302,302,15,7,8,3,2
1,302,302,1,1,0,1,0
16,324,324,114,89,25,2,1
3,348,348,43,27,16,3,2
31,348,348,53,32,21,4,3
17,360,360,16,16,0,1,0
13,373,373,48,48,0,1,0
22,378,378,28,22,6,2,1
10,384,384,53,45,8,3,2
8,409,409,23,14,9,2,1
23,410,410,76,76,0,1,0
21,441,441,15,15,0,1,0
25,453,453,33,33,0,1,0
9,454,454,24,16,8,3,2
2,469,469,76,76,0,1,0
20,495,495,57,57,0,1,0
4,498,498,39,15,24,3,2

22,105,105,5,5,0,1,0
0,107,107,3,3,0,1,0
30,114,114,9,9,0,1,0
16,123,123,5,5,0,1,0
26,130,130,5,1,4,2,1
18,138,138,53,7,46,2,1
13,141,141,3,3,0,1,0
32,168,168,34,1,33,2,1
23,174,174,6,6,0,1,0
14,178,178,56,39,17,2,1
20,208,208,22,12,10,3,2
10,251,251,43,23,20,2,1
21,259,259,1,1,0,1,0
29,280,280,42,12,30,4,3
17,280,280,5,5,0,1,0
25,282,282,38,38,0,1,0
28,283,283,23,16,7,2,1
7,298,298,15,4,11,2,1
1,324,324,15,10,5,2,1
24,330,330,31,31,0,1,0
9,335,335,65,37,28,3,2
4,337,337,11,11,0,1,0
6,351,351,36,36,0,1,0
33,365,365,19,7,12,2,1
19,373,373,23,11,12,4,3
15,378,378,1,1,0,1,0
27,397,397,63,35,28,4,3
5,433,433,31,10,21,2,1
8,448,448,51,6,45,2,1
12,451,451,36,2,34,4,3
11,452,452,60,32,28,2,1
2,460,460,13,2,11,2,1
3,471,471,72,24,48,4,3
31,491,491,5,5,0,1,0

1,105,105,3,3,0,1,0
14,111,111,10,1,9,4,3
22,132,132,7,4,3,2,1
24,154,154,6,6,0,1,0
10,174,174,15,7,8,3,2
8,184,184,27,19,8,3,2
12,205,205,47,17,30,3,2
0,216,216,69,69,0,1,0
25,219,219,3,3,0,1,0
19,232,232,17,3,14,3,2
15,235,235,33,7,26,3,2
18,294,294,100,100,0,1,0
28,295,295,42,42,0,1,0
6,304,304,50,50,0,1,0
3,314,314,7,7,0,1,0
9,319,319,43,35,8,2,1
21,353,353,15,15,0,1,0
11,356,356,28,7,21,4,3
16,360,360,30,30,0,1,0
5,389,389,114,89,25,3,2
23,402,402,47,47,0,1,0
26,406,406,19,1,18,3,2
4,416,416,3,3,0,1,0
2,421,421,13,13,0,1,0
20,453,453,23,23,0,1,0
17,467,467,64,15,49,2,1
7,474,474,28,6,22,2,1
13,496,496,23,12,11,2,1
27,498,498,107,79,28,3,2

14,105,105,1,1,0,1,0
8,159,159,10,10,0,1,0
13,160,160,25,4,21,2,1
15,160,160,17,3,14,3,2
17,161,161,40,40,0,1,0
11,167,167,37,37,0,1,0
21,169,169,5,2,3,2,1
20,199,199,55,4,51,4,3
7,205,205,19,19,0,1,0
23,223,223,5,5,0,1,0
2,269,269,31,31,0,1,0
24,269,269,39,39,0,1,0
25,272,272,20,20,0,1,0
22,286,286,8,8,0,1,0
6,292,292,30,30,0,1,0
27,301,301,3,3,0,1,0
28,321,321,76,62,14,3,2
29,328,328,36,36,0,1,0
19,340,340,21,18,3,2,1
3,393,393,123,123,0,1,0
0,401,401,41,4,37,4,3
5,430,430,22,22,0,1,0
1,443,443,12,12,0,1,0
26,454,454,35,35,0,1,0
4,456,456,110,22,88,4,3
10,460,460,12,4,8,3,2
18,468,468,45,30,15,2,1
9,482,482,39,39,0,1,0
12,485,485,4,4,0,1,0
16,499,499,47,41,6,2,1

6,104,104,10,2,8,2,1
4,108,108,1,1,0,1,0
28,115,115,18,12,6,3,2
3,125,125,23,23,0,1,0
8,127,127,22,10,12,4,3
21,153,153,7,7,0,1,0
23,162,162,22,22,0,1,0
13,177,177,14,5,9,2,1
12,178,178,13,5,8,3,2
16,178,178,4,4,0,1,0
19,196,196,11,11,0,1,0
5,200,200,6,6,0,1,0
11,236,236,3,3,0,1,0
24,243,243,30,6,24,4,3
25,244,244,87,1,86,4,3
30,283,283,10,10,0,1,0
15,287,287,50,50,0,1,0
26,307,307,48,13,35,2,1
10,310,310,66,30,36,4,3
27,321,321,14,2,12,3,2
7,328,328,27,27,0,1,0
1,330,330,70,70,0,1,0
14,379,379,116,104,12,4,3
9,389,389,23,23,0,1,0
20,406,406,7,7,0,1,0
2,427,427,15,6,9,2,1
18,440,440,56,24,32,3,2
17,446,446,7,7,0,1,0
22,470,470,15,15,0,1,0
29,474,474,67,67,0,1,0
0,498,498,18,14,4,2,1

13,101,101,17,17,0,1,0
30,107,107,1,1,0,1,0
21,127,127,16,16,0,1,0
3,147,147,13,13,0,1,0
17,169,169,18,18,0,1,0
20,170,170,8,1,7,2,1
4,195,195,4,4,0,1,0
15,202,202,32,32,0,1,0
31,221,221,2,2,0,1,0
8,223,223,14,4,10,3,2
29,235,235,27,17,10,3,2
23,250,250,14,10,4,2,1
28,302,302,15,2,13,2,1
25,304,304,9,9,0,1,0
10,308,308,9,9,0,1,0
16,312,312,21,7,14,3,2
2,317,317,6,6,0,1,0
9,318,318,69,23,46,3,2
22,324,324,48,8,40,3,2
26,337,337,23,7,16,3,2
12,349,349,4,1,3,2,1
11,364,364,3,3,0,1,0
0,375,375,13,10,3,2,1
14,379,379,1,1,0,1,0
6,384,384,29,5,24,4,3
7,397,397,100,67,33,4,3
34,418,418,161,161,0,1,0
19,422,422,74,74,0,1,0
1,428,428,4,4,0,1,0
24,447,447,43,43,0,1,0
33,458,458,22,7,15,2,1
18,479,479,51,51,0,1,0
27,481,481,84,84,0,1,0
5,488,488,80,80,0,1,0
32,491,491,47,47,0,1,0

25,115,115,21,14,7,2,1
16,132,132,7,1,6,2,1
24,142,142,23,3,20,2,1
26,153,153,9,9,0,1,0
7,157,157,15,15,0,1,0
5,187,187,1,1,0,1,0
1,192,192,3,3,0,1,0
4,195,195,13,4,9,2,1
8,212,212,20,1,19,2,1
12,220,220,5,5,0,1,0
13,227,227,11,11,0,1,0
2,238,238,10,6,4,2,1
35,252,252,1,1,0,1,0
19,258,258,21,9,12,3,2
38,259,259,47,47,0,1,0
6,259,259,21,4,17,3,2
9,260,260,83,77,6,3,2
28,263,263,45,45,0,1,0
10,265,265,23,2,21,2,1
29,287,287,21,21,0,1,0
18,290,290,3,3,0,1,0
33,298,298,12,6,6,3,2
14,316,316,1,1,0,1,0
23,321,321,36,15,21,4,3
3,331,331,33,33,0,1,0
31,332,332,64,64,0,1,0
37,333,333,9,9,0,1,0
36,334,334,12,12,0,1,0
0,336,336,13,10,3,2,1
32,350,350,9,1,8,3,2
27,354,354,63,47,16,3,2
30,354,354,33,33,0,1,0
11,371,371,15,2,13,2,1
15,374,374,17,5,12,3,2
20,402,402,28,28,0,1,0
17,419,419,25,25,0,1,0
21,439,439,76,25,51,4,3
34,479,479,45,12,33,4,3
22,494,494,24,13,11,2,1

20,108,108,16,16,0,1,0
14,125,125,23,11,12,4,3
9,131,131,37,37,0,1,0
25,157,157,1,1,0,1,0
6,168,168,1,1,0,1,0
15,178,178,25,16,9,2,1
11,201,201,107,86,21,4,3
28,243,243,4,4,0,1,0
10,273,273,11,11,0,1,0
23,275,275,22,5,17,2,1
29,288,288,3,3,0,1,0
1,311,311,36,1,35,2,1
12,321,321,23,23,0,1,0
26,330,330,26,26,0,1,0
13,337,337,14,14,0,1,0
0,354,354,20,20,0,1,0
21,356,356,30,18,12,4,3
17,357,357,39,23,16,2,1
18,357,357,22,22,0,1,0
5,359,359,9,9,0,1,0
2,382,382,18,18,0,1,0
7,390,390,8,8,0,1,0
3,402,402,21,9,12,2,1
24,405,405,44,33,11,2,1
27,420,420,110,42,68,3,2
22,421,421,58,58,0,1,0
8,431,431,30,12,18,4,3
19,454,454,51,23,28,3,2
16,461,461,44,44,0,1,0
4,468,468,112,42,70,3,2

24,107,107,6,1,5,2,1
15,118,118,13,5,8,3,2
4,132,132,1,1,0,1,0
21,163,163,34,21,13,2,1
19,170,170,31,3,28,3,2
3,191,191,10,5,5,2,1
10,210,210,33,5,28,2,1
12,211,211,58,28,30,3,2
16,211,211,25,7,18,2,1
5,225,225,25,1,24,4,3
23,227,227,2,2,0,1,0
2,235,235,36,6,30,4,3
14,255,255,19,19,0,1,0
26,271,271,36,4,32,3,2
17,273,273,11,1,10,2,1
13,285,285,9,9,0,1,0
18,298,298,2,2,0,1,0
6,300,300,24,24,0,1,0
0,312,312,4,4,0,1,0
22,314,314,30,30,0,1,0
27,315,315,14,14,0,1,0
8,320,320,114,84,30,4,3
20,329,329,14,9,5,2,1
28,329,329,28,28,0,1,0
11,347,347,61,39,22,2,1
29,350,350,85,53,32,2,1
9,358,358,32,26,6,3,2
1,359,359,33,2,31,2,1
7,458,458,3,3,0,1,0
25,468,468,84,84,0,1,0

20,102,102,9,9,0,1,0
16,127,127,12,4,8,2,1
5,129,129,1,1,0,1,0
18,149,149,6,6,0,1,0
6,165,165,4,4,0,1,0
33,165,165,14,14,0,1,0
22,179,179,5,5,0,1,0
27,203,203,21,15,6,3,2
3,209,209,32,17,15,2,1
19,215,215,4,4,0,1,0
26,231,231,28,28,0,1,0
29,234,234,20,7,13,2,1
10,269,269,1,1,0,1,0
8,282,282,4,4,0,1,0
11,288,288,15,15,0,1,0
4,295,295,19,4,15,4,3
9,322,322,71,45,26,2,1
14,322,322,7,7,0,1,0
34,327,327,38,24,14,2,1
31,329,329,38,38,0,1,0
0,333,333,48,21,27,2,1
24,334,334,9,3,6,2,1
2,339,339,41,41,0,1,0
35,348,348,19,14,5,2,1
17,365,365,3,3,0,1,0
7,397,397,42,13,29,4,3
1,415,415,120,120,0,1,0
28,422,422,17,17,0,1,0
21,450,450,49,49,0,1,0
30,471,471,145,55,90,3,2
12,475,475,86,86,0,1,0
13,477,477,11,1,10,2,1
32,481,481,1,1,0,1,0
15,486,486,7,1,6,3,2
23,487,487,25,25,0,1,0
25,492,492,145,49,96,3,2

16,106,106,3,3,0,1,0
4,109,109,11,11,0,1,0
15,112,112,5,2,3,2,1
6,138,138,1,1,0,1,0
24,140,140,7,3,4,2,1
23,149,149,28,25,3,2,1
11,170,170,3,3,0,1,0
32,192,192,17,17,0,1,0
26,197,197,23,23,0,1,0
17,214,214,5,5,0,1,0
21,221,221,13,2,11,2,1
30,231,231,3,3,0,1,0
29,244,244,10,7,3,2,1
33,266,266,58,31,27,4,3
25,271,271,9,3,6,2,1
28,276,276,58,58,0,1,0
31,292,292,52,52,0,1,0
8,293,293,1,1,0,1,0
19,305,305,65,45,20,2,1
27,317,317,19,1,18,3,2
2,319,319,59,59,0,1,0
12,322,322,105,47,58,3,2
22,345,345,5,5,0,1,0
13,355,355,92,62,30,2,1
9,355,355,12,12,0,1,0
34,369,369,48,27,21,3,2
20,373,373,10,10,0,1,0
3,374,374,43,15,28,2,1
18,394,394,11,11,0,1,0
0,410,410,4,1,3,2,1
7,452,452,14,14,0,1,0
1,476,476,41,13,28,2,1
14,482,482,26,26,0,1,0
5,496,496,24,24,0,1,0
10,499,499,100,100,0,1,0

0,118,118,8,8,0,1,0
5,122,122,1,1,0,1,0
25,148,148,10,10,0,1,0
18,165,165,7,7,0,1,0
12,173,173,17,3,14,2,1
23,173,173,8,8,0,1,0
28,176,176,2,2,0,1,0
29,177,177,6,6,0,1,0
9,181,181,12,3,9,4,3
6,182,182,1,1,0,1,0
27,204,204,6,6,0,1,0
4,218,218,3,3,0,1,0
20,260,260,140,140,0,1,0
19,261,261,3,3,0,1,0
13,271,271,79,43,36,3,2
24,297,297,58,58,0,1,0
2,306,306,57,42,15,4,3
22,309,309,10,10,0,1,0
1,336,336,2,2,0,1,0
3,352,352,34,34,0,1,0
8,363,363,66,66,0,1,0
15,384,384,42,42,0,1,0
10,399,399,26,18,8,2,1
17,404,404,15,15,0,1,0
31,415,415,127,88,39,2,1
26,438,438,48,48,0,1,0
11,444,444,4,4,0,1,0
16,473,473,21,21,0,1,0
14,478,478,4,4,0,1,0
7,488,488,189,189,0,1,0
30,495,495,34,3,31,2,1
21,497,497,28,11,17,2,1

20,107,107,2,2,0,1,0
25,107,107,3,3,0,1,0
32,117,117,3,3,0,1,0
8,180,180,16,16,0,1,0
11,196,196,15,1,14,3,2
35,196,196,16,16,0,1,0
33,218,218,12,12,0,1,0
28,220,220,1,1,0,1,0
34,234,234,51,30,21,4,3
19,266,266,8,8,0,1,0
26,271,271,17,17,0,1,0
23,281,281,25,3,22,3,2
27,317,317,135,135,0,1,0
13,323,323,6,6,0,1,0
30,329,329,38,38,0,1,0
5,334,334,56,56,0,1,0
10,337,337,6,6,0,1,0
3,347,347,56,26,30,2,1
24,351,351,23,23,0,1,0
7,361,361,10,10,0,1,0
0,363,363,71,71,0,1,0
16,364,364,59,4,55,3,2
1,373,373,28,1,27,4,3
29,377,377,118,70,48,2,1
31,378,378,3,3,0,1,0
18,403,403,28,28,0,1,0
4,413,413,13,13,0,1,0
22,413,413,22,9,13,2,1
9,419,419,20,20,0,1,0
12,420,420,1,1,0,1,0
6,431,431,84,14,70,3,2
21,439,439,31,5,26,2,1
15,450,450,7,7,0,1,0
17,459,459,4,4,0,1,0
2,474,474,1,1,0,1,0
14,500,500,104,58,46,2,1

22,100,100,14,14,0,1,0
29,137,137,3,3,0,1,0
4,154,154,7,7,0,1,0
8,160,160,1,1,0,1,0
9,165,165,2,2,0,1,0
32,172,172,10,6,4,2,1
17,191,191,13,2,11,3,2
13,192,192,33,33,0,1,0
2,197,197,1,1,0,1,0
31,204,204,19,19,0,1,0
26,217,217,21,21,0,1,0
24,241,241,20,20,0,1,0
18,261,261,30,18,12,4,3
7,276,276,9,9,0,1,0
15,280,280,48,12,36,2,1
12,291,291,18,18,0,1,0
10,293,293,10,10,0,1,0
34,305,305,43,43,0,1,0
30,345,345,64,34,30,3,2
28,349,349,17,17,0,1,0
16,359,359,29,29,0,1,0
1,363,363,13,13,0,1,0
14,368,368,24,12,12,3,2
6,374,374,57,32,25,2,1
23,379,379,2,2,0,1,0
20,384,384,6,3,3,2,1
36,385,385,29,5,24,3,2
35,409,409,148,21,127,4,3
21,421,421,4,4,0,1,0
5,427,427,100,82,18,3,2
27,438,438,86,86,0,1,0
19,454,454,36,30,6,2,1
0,457,457,17,7,10,2,1
33,471,471,4,4,0,1,0
25,472,472,54,2,52,3,2
3,480,480,43,2,41,3,2
11,498,498,43,10,33,4,3

29,102,102,1,1,0,1,0
23,112,112,3,3,0,1,0
38,114,114,2,2,0,1,0
22,174,174,1,1,0,1,0
20,176,176,2,2,0,1,0
36,189,189,38,4,34,3,2
33,190,190,31,8,23,4,3
6,199,199,10,1,9,2,1
26,199,199,18,18,0,1,0
14,212,212,3,3,0,1,0
8,216,216,20,20,0,1,0
15,219,219,6,6,0,1,0
16,220,220,15,15,0,1,0
5,220,220,73,37,36,3,2
32,231,231,6,6,0,1,0
28,236,236,77,40,37,2,1
2,243,243,19,19,0,1,0
25,251,251,18,18,0,1,0
13,253,253,4,1,3,2,1
10,270,270,5,5,0,1,0
31,279,279,62,62,0,1,0
37,303,303,2,2,0,1,0
12,304,304,2,2,0,1,0
21,341,341,31,5,26,2,1
24,354,354,15,5,10,3,2
19,363,363,4,1,3,2,1
4,365,365,38,7,31,2,1
9,372,372,17,7,10,3,2
7,380,380,16,7,9,4,3
1,396,396,69,69,0,1,0
11,405,405,31,11,20,2,1
3,408,408,5,5,0,1,0
18,412,412,5,2,3,2,1
27,416,416,107,87,20,3,2
30,437,437,12,12,0,1,0
17,464,464,100,100,0,1,0
0,481,481,48,26,22,3,2
35,490,490,28,11,17,4,3
34,492,492,47,33,14,3,2

18,114,114,62,42,20,2,1
19,139,139,18,18,0,1,0
26,164,164,3,3,0,1,0
21,173,173,9,9,0,1,0
9,181,181,32,32,0,1,0
23,191,191,16,16,0,1,0
13,205,205,31,25,6,3,2
10,209,209,14,5,9,2,1
24,210,210,25,1,24,3,2
11,211,211,13,1,12,4,3
20,225,225,22,22,0,1,0
14,265,265,2,2,0,1,0
7,266,266,10,10,0,1,0
17,286,286,14,14,0,1,0
5,315,315,85,26,59,4,3
0,330,330,13,13,0,1,0
8,339,339,50,50,0,1,0
2,374,374,57,57,0,1,0
1,376,376,15,5,10,3,2
3,387,387,53,5,48,2,1
6,450,450,152,36,116,4,3
27,453,453,35,35,0,1,0
16,467,467,8,8,0,1,0
25,475,475,69,16,53,4,3
15,479,479,4,4,0,1,0
22,483,483,49,31,18,3,2
12,484,484,18,8,10,3,2
4,490,490,66,39,27,4,3

21,108,108,1,1,0,1,0
43,111,111,4,4,0,1,0
24,113,113,1,1,0,1,0
29,131,131,6,6,0,1,0
38,149,149,3,3,0,1,0
0,172,172,3,3,0,1,0
16,176,176,1,1,0,1,0
32,191,191,19,19,0,1,0
2,198,198,30,3,27,2,1
41,202,202,9,9,0,1,0
23,227,227,12,4,8,3,2
4,229,229,23,11,12,2,1
22,232,232,4,4,0,1,0
42,239,239,95,95,0,1,0
14,245,245,17,17,0,1,0
11,247,247,20,17,3,2,1
19,259,259,8,8,0,1,0
34,260,260,29,8,21,4,3
30,270,270,22,22,0,1,0
26,277,277,3,3,0,1,0
35,278,278,7,7,0,1,0
40,279,279,33,30,3,2,1
7,280,280,45,8,37,2,1
20,282,282,21,6,15,4,3
39,290,290,18,14,4,2,1
33,326,326,6,2,4,2,1
9,337,337,6,6,0,1,0
31,362,362,50,18,32,3,2
15,366,366,7,7,0,1,0
25,370,370,51,51,0,1,0
27,402,402,7,7,0,1,0
6,402,402,17,5,12,2,1
36,405,405,36,36,0,1,0
13,406,406,52,52,0,1,0
5,426,426,14,3,11,3,2
37,427,427,28,16,12,2,1
12,427,427,35,7,28,2,1
10,430,430,33,33,0,1,0
3,434,434,29,29,0,1,0
17,439,439,4,4,0,1,0
8,450,450,8,8,0,1,0
1,458,458,30,30,0,1,0
28,459,459,130,98,32,3,2
18,492,492,48,48,0,1,0

13,106,106,17,4,13,2,1
2,121,121,23,23,0,1,0
30,157,157,16,16,0,1,0
1,159,159,3,3,0,1,0
6,168,168,5,5,0,1,0
25,171,171,20,20,0,1,0
14,194,194,18,18,0,1,0
7,200,200,21,17,4,2,1
28,219,219,2,2,0,1,0
17,229,229,6,2,4,2,1
18,231,231,31,11,20,2,1
19,246,246,3,3,0,1,0
4,260,260,26,26,0,1,0
22,264,264,7,7,0,1,0
29,275,275,18,18,0,1,0
27,285,285,9,9,0,1,0
9,288,288,31,1,30,2,1
36,294,294,8,3,5,2,1
35,296,296,1,1,0,1,0
3,300,300,2,2,0,1,0
12,310,310,3,3,0,1,0
15,313,313,15,15,0,1,0
16,332,332,59,59,0,1,0
37,343,343,86,72,14,3,2
23,351,351,101,53,48,3,2
31,353,353,80,53,27,4,3
21,356,356,19,19,0,1,0
34,384,384,75,35,40,3,2
5,406,406,4,4,0,1,0
33,420,420,9,9,0,1,0
11,438,438,25,25,0,1,0
24,444,444,21,21,0,1,0
26,453,453,23,23,0,1,0
0,464,464,16,1,15,2,1
32,470,470,77,29,48,2,1
20,479,479,27,27,0,1,0
8,488,488,22,17,5,2,1
10,495,495,62,20,42,3,2

27,100,100,10,10,0,1,0
19,114,114,16,11,5,2,1
1,114,114,6,6,0,1,0
15,121,121,6,6,0,1,0
31,141,141,6,6,0,1,0
33,146,146,45,45,0,1,0
32,168,168,35,7,28,3,2
7,169,169,32,32,0,1,0
38,175,175,7,4,3,2,1
35,180,180,34,34,0,1,0
36,181,181,1,1,0,1,0
13,200,200,35,7,28,3,2
11,210,210,40,8,32,3,2
23,210,210,2,2,0,1,0
10,223,223,3,3,0,1,0
2,232,232,4,4,0,1,0
9,232,232,1,1,0,1,0
8,246,246,19,11,8,3,2
22,248,248,1,1,0,1,0
25,259,259,8,8,0,1,0
24,260,260,4,4,0,1,0
21,268,268,14,10,4,2,1
26,275,275,23,3,20,2,1
17,292,292,10,10,0,1,0
28,297,297,99,99,0,1,0
12,317,317,20,20,0,1,0
29,343,343,33,33,0,1,0
34,350,350,13,13,0,1,0
0,362,362,1,1,0,1,0
20,366,366,27,16,11,2,1
37,368,368,20,3,17,2,1
6,368,368,45,24,21,4,3
16,394,394,66,66,0,1,0
5,396,396,10,10,0,1,0
4,407,407,3,3,0,1,0
14,430,430,33,33,0,1,0
18,448,448,3,3,0,1,0
3,450,450,21,21,0,1,0
39,450,450,38,2,36,3,2
30,500,500,2,2,0,1,0

27,103,103,11,11,0,1,0
24,129,129,22,22,0,1,0
12,145,145,5,1,4,2,1
7,183,183,19,12,7,2,1
9,190,190,47,5,42,2,1
13,220,220,27,27,0,1,0
3,238,238,20,4,16,2,1
1,264,264,66,22,44,2,1
26,274,274,23,23,0,1,0
4,276,276,3,3,0,1,0
23,288,288,8,8,0,1,0
2,303,303,30,30,0,1,0
0,317,317,146,128,18,2,1
17,322,322,84,72,12,4,3
25,338,338,8,8,0,1,0
14,344,344,8,8,0,1,0
6,358,358,6,2,4,2,1
22,371,371,33,33,0,1,0
21,387,387,52,52,0,1,0
19,390,390,18,11,7,2,1
28,405,405,54,54,0,1,0
10,410,410,2,2,0,1,0
5,425,425,15,15,0,1,0
8,430,430,51,8,43,3,2
29,431,431,134,134,0,1,0
11,434,434,6,6,0,1,0
15,464,464,9,1,8,2,1
16,479,479,20,20,0,1,0
20,497,497,22,22,0,1,0
18,499,499,53,3,50,4,3

18,116,116,17,17,0,1,0
2,157,157,10,10,0,1,0
23,168,168,1,1,0,1,0
24,225,225,8,8,0,1,0
5,228,228,44,44,0,1,0
25,275,275,31,31,0,1,0
14,281,281,11,3,8,2,1
20,287,287,8,2,6,3,2
10,304,304,15,15,0,1,0
1,305,305,1,1,0,1,0
21,310,310,21,3,18,3,2
13,334,334,8,8,0,1,0
11,335,335,14,14,0,1,0
15,349,349,18,6,12,4,3
7,373,373,23,11,12,2,1
9,375,375,46,29,17,2,1
19,375,375,95,29,66,4,3
22,388,388,83,83,0,1,0
8,389,389,106,67,39,2,1
4,417,417,105,43,62,3,2
16,452,452,92,92,0,1,0
17,452,452,34,34,0,1,0
0,471,471,260,218,42,4,3
3,477,477,11,4,7,2,1
6,489,489,28,10,18,2,1
12,499,499,141,70,71,4,3

25,100,100,2,2,0,1,0
26,136,136,2,2,0,1,0
19,145,145,3,3,0,1,0
13,152,152,41,41,0,1,0
8,180,180,3,3,0,1,0
4,188,188,31,31,0,1,0
21,199,199,9,9,0,1,0
16,200,200,5,1,4,2,1
7,205,205,71,71,0,1,0
10,213,213,4,4,0,1,0
27,262,262,4,4,0,1,0
3,272,272,77,11,66,4,3
15,284,284,11,11,0,1,0
2,308,308,29,11,18,2,1
23,339,339,18,11,7,2,1
6,341,341,17,5,12,3,2
22,342,342,32,14,18,2,1
9,372,372,17,17,0,1,0
17,376,376,53,53,0,1,0
24,385,385,4,4,0,1,0
5,394,394,4,4,0,1,0
14,426,426,13,1,12,4,3
12,426,426,291,195,96,4,3
20,435,435,17,8,9,2,1
1,448,448,102,32,70,3,2
18,461,461,57,45,12,3,2
11,483,483,42,12,30,2,1
0,494,494,127,106,21,4,3

7,102,102,2,2,0,1,0
9,123,123,1,1,0,1,0
8,134,134,2,2,0,1,0
14,144,144,21,21,0,1,0
24,148,148,10,7,3,2,1
12,179,179,3,3,0,1,0
23,205,205,28,6,22,2,1
5,217,217,13,5,8,2,1
22,237,237,25,7,18,3,2
17,243,243,39,10,29,4,3
21,290,290,41,17,24,4,3
4,309,309,56,2,54,4,3
2,319,319,15,3,12,3,2
15,323,323,10,6,4,2,1
25,338,338,112,37,75,4,3
0,345,345,19,19,0,1,0
10,420,420,241,198,43,2,1
19,424,424,84,84,0,1,0
6,424,424,1,1,0,1,0
16,427,427,17,8,9,4,3
27,433,433,80,80,0,1,0
3,440,440,92,48,44,3,2
1,455,455,24,4,20,3,2
29,459,459,17,17,0,1,0
26,461,461,5,5,0,1,0
28,463,463,2,2,0,1,0
11,470,470,108,11,97,4,3
20,470,470,7,2,5,2,1
18,474,474,8,8,0,1,0
13,494,494,64,64,0,1,0

32,123,123,13,13,0,1,0
18,133,133,18,5,13,2,1
11,140,140,1,1,0,1,0
23,150,150,25,25,0,1,0
7,162,162,10,10,0,1,0
1,172,172,1,1,0,1,0
10,184,184,4,4,0,1,0
35,185,185,12,12,0,1,0
9,191,191,5,5,0,1,0
22,219,219,2,2,0,1,0
3,226,226,15,5,10,3,2
19,252,252,11,1,10,3,2
26,254,254,32,23,9,2,1
25,276,276,24,13,11,2,1
12,323,323,19,10,9,4,3
2,326,326,19,19,0,1,0
28,328,328,14,14,0,1,0
13,336,336,3,3,0,1,0
24,336,336,4,4,0,1,0
16,336,336,72,23,49,3,2
17,370,370,12,2,10,2,1
15,375,375,18,8,10,2,1
38,388,388,198,118,80,4,3
20,398,398,25,4,21,4,3
0,401,401,16,16,0,1,0
14,418,418,45,45,0,1,0
27,420,420,21,3,18,4,3
4,426,426,6,6,0,1,0
6,428,428,175,114,61,4,3
33,451,451,3,3,0,1,0
31,459,459,48,36,12,3,2
21,472,472,35,35,0,1,0
29,473,473,29,29,0,1,0
8,474,474,28,14,14,3,2
36,475,475,19,12,7,2,1
37,477,477,91,82,9,4,3
5,491,491,19,19,0,1,0
30,492,492,16,16,0,1,0
34,492,492,12,12,0,1,0

32,103,103,25,25,0,1,0
33,106,106,23,23,0,1,0
36,122,122,4,4,0,1,0
9,124,124,23,11,12,3,2
18,127,127,1,1,0,1,0
12,132,132,9,3,6,3,2
3,154,154,2,2,0,1,0
27,167,167,14,3,11,2,1
38,168,168,22,13,9,4,3
24,168,168,21,7,14,3,2
7,211,211,53,17,36,2,1
13,217,217,2,2,0,1,0
35,257,257,22,22,0,1,0
23,265,265,16,16,0,1,0
19,285,285,18,7,11,2,1
31,287,287,40,40,0,1,0
34,291,291,17,8,9,4,3
1,294,294,14,10,4,2,1
22,296,296,6,6,0,1,0
29,320,320,39,39,0,1,0
21,322,322,16,16,0,1,0
30,325,325,11,11,0,1,0
17,327,327,21,21,0,1,0
14,327,327,19,1,18,4,3
25,346,346,13,1,12,4,3
28,363,363,16,13,3,2,1
26,368,368,45,45,0,1,0
20,375,375,46,46,0,1,0
8,395,395,76,39,37,2,1
4,406,406,12,12,0,1,0
2,413,413,3,3,0,1,0
16,424,424,11,11,0,1,0
10,435,435,19,8,11,2,1
15,437,437,46,19,27,4,3
37,441,441,43,43,0,1,0
6,442,442,12,12,0,1,0
0,446,446,20,8,12,4,3
11,448,448,58,16,42,3,2
5,480,480,17,17,0,1,0

23,103,103,9,3,6,3,2
12,126,126,27,17,10,2,1
15,127,127,1,1,0,1,0
2,138,138,11,11,0,1,0
19,222,222,19,19,0,1,0
17,228,228,17,17,0,1,0
32,235,235,18,9,9,2,1
27,241,241,9,4,5,2,1
20,242,242,21,21,0,1,0
31,248,248,62,62,0,1,0
1,258,258,7,7,0,1,0
25,268,268,33,33,0,1,0
29,281,281,20,20,0,1,0
9,292,292,20,14,6,2,1
22,311,311,14,14,0,1,0
14,316,316,25,25,0,1,0
10,325,325,15,15,0,1,0
13,329,329,6,6,0,1,0
18,333,333,18,18,0,1,0
3,336,336,15,15,0,1,0
16,340,340,33,24,9,4,3
0,346,346,10,2,8,3,2
26,401,401,42,42,0,1,0
6,402,402,89,23,66,4,3
11,424,424,24,24,0,1,0
21,437,437,5,1,4,2,1
28,448,448,7,7,0,1,0
24,449,449,94,60,34,3,2
8,449,449,67,67,0,1,0
5,452,452,20,12,8,2,1
30,452,452,131,57,74,3,2
7,457,457,3,3,0,1,0
4,499,499,205,77,128,4,3

15,112,112,2,2,0,1,0
24,115,115,43,43,0,1,0
32,120,120,7,7,0,1,0
4,121,121,17,17,0,1,0
13,152,152,2,2,0,1,0
26,165,165,12,2,10,3,2
2,202,202,17,14,3,2,1
27,207,207,2,2,0,1,0
5,222,222,3,3,0,1,0
21,229,229,10,10,0,1,0
1,237,237,39,39,0,1,0
22,248,248,14,14,0,1,0
17,253,253,6,6,0,1,0
3,261,261,7,7,0,1,0
16,272,272,18,6,12,3,2
14,282,282,73,4,69,4,3
11,290,290,74,74,0,1,0
20,334,334,17,3,14,3,2
19,335,335,4,4,0,1,0
6,338,338,66,63,3,2,1
12,384,384,15,6,9,4,3
25,404,404,174,130,44,4,3
0,415,415,1,1,0,1,0
10,416,416,17,17,0,1,0
29,417,417,29,3,26,2,1
8,421,421,1,1,0,1,0
23,432,432,3,3,0,1,0
18,437,437,38,8,30,4,3
28,446,446,7,7,0,1,0
9,468,468,30,13,17,2,1
30,488,488,149,111,38,4,3
31,490,490,7,3,4,2,1
7,492,492,107,27,80,3,2

34,100,100,7,4,3,2,1
17,104,104,1,1,0,1,0
5,109,109,6,6,0,1,0
20,110,110,8,8,0,1,0
24,113,113,7,7,0,1,0
33,133,133,4,4,0,1,0
19,134,134,5,5,0,1,0
10,160,160,2,2,0,1,0
21,161,161,68,26,42,3,2
13,169,169,21,21,0,1,0
18,178,178,6,6,0,1,0
11,185,185,7,1,6,2,1
26,199,199,32,23,9,4,3
25,225,225,14,3,11,2,1
7,262,262,4,4,0,1,0
30,291,291,39,39,0,1,0
28,300,300,6,6,0,1,0
16,301,301,32,32,0,1,0
6,306,306,27,27,0,1,0
29,313,313,9,1,8,3,2
23,342,342,28,7,21,3,2
32,359,359,14,2,12,4,3
22,365,365,72,72,0,1,0
9,376,376,57,25,32,3,2
0,395,395,26,18,8,3,2
1,400,400,87,6,81,4,3
14,407,407,20,20,0,1,0
8,430,430,61,5,56,4,3
4,441,441,100,9,91,3,2
15,449,449,49,1,48,2,1
12,471,471,31,31,0,1,0
3,473,473,6,6,0,1,0
31,475,475,11,1,10,3,2
2,476,476,39,39,0,1,0
27,493,493,97,67,30,2,1

0,105,105,3,3,0,1,0
13,115,115,10,10,0,1,0
14,130,130,24,9,15,4,3
10,160,160,16,11,5,2,1
27,182,182,7,7,0,1,0
16,186,186,14,14,0,1,0
2,190,190,34,17,17,2,1
18,199,199,28,28,0,1,0
9,208,208,14,2,12,2,1
22,224,224,63,29,34,3,2
1,241,241,22,22,0,1,0
28,253,253,5,5,0,1,0
24,268,268,3,3,0,1,0
11,275,275,22,3,19,4,3
25,317,317,7,7,0,1,0
21,333,333,59,15,44,3,2
26,339,339,85,85,0,1,0
17,347,347,58,58,0,1,0
7,363,363,29,14,15,2,1
6,380,380,18,18,0,1,0
23,391,391,28,28,0,1,0
4,399,399,15,15,0,1,0
5,412,412,17,5,12,4,3
20,425,425,19,9,10,3,2
12,428,428,132,76,56,3,2
8,437,437,208,208,0,1,0
3,440,440,28,28,0,1,0
15,441,441,21,11,10,2,1
19,481,481,9,9,0,1,0

23,105,105,30,22,8,3,2
25,146,146,10,10,0,1,0
11,148,148,3,3,0,1,0
3,151,151,4,4,0,1,0
8,151,151,47,47,0,1,0
13,161,161,4,4,0,1,0
19,163,163,11,11,0,1,0
28,180,180,3,3,0,1,0
32,186,186,12,12,0,1,0
4,189,189,5,2,3,2,1
16,208,208,29,29,0,1,0
12,221,221,24,1,23,2,1
18,226,226,6,6,0,1,0
26,242,242,33,1,32,2,1
1,255,255,32,32,0,1,0
30,261,261,64,43,21,4,3
14,267,267,8,8,0,1,0
29,285,285,9,3,6,3,2
6,300,300,16,16,0,1,0
7,320,320,19,19,0,1,0
24,339,339,23,23,0,1,0
31,344,344,9,9,0,1,0
27,347,347,1,1,0,1,0
21,366,366,71,25,46,3,2
22,371,371,28,20,8,2,1
10,390,390,104,89,15,2,1
15,393,393,18,18,0,1,0
0,434,434,11,11,0,1,0
5,440,440,23,23,0,1,0
20,449,449,115,72,43,2,1
2,482,482,68,68,0,1,0
17,485,485,35,35,0,1,0
9,490,490,71,65,6,2,1

19,100,100,8,8,0,1,0
22,120,120,2,2,0,1,0
34,121,121,18,18,0,1,0
26,121,121,34,15,19,2,1
37,122,122,7,7,0,1,0
36,140,140,15,15,0,1,0
11,144,144,1,1,0,1,0
35,161,161,26,11,15,2,1
39,166,166,1,1,0,1,0
33,177,177,5,2,3,2,1
5,192,192,10,5,5,2,1
31,218,218,3,3,0,1,0
23,218,218,14,14,0,1,0
16,230,230,28,28,0,1,0
2,243,243,18,13,5,2,1
17,248,248,12,12,0,1,0
9,257,257,34,34,0,1,0
30,257,257,4,4,0,1,0
12,262,262,2,2,0,1,0
21,285,285,15,15,0,1,0
6,307,307,1,1,0,1,0
27,325,325,103,103,0,1,0
14,341,341,1,1,0,1,0
24,347,347,69,69,0,1,0
4,348,348,26,13,13,3,2
18,355,355,55,25,30,4,3
40,360,360,4,1,3,2,1
7,377,377,4,4,0,1,0
1,388,388,1,1,0,1,0
10,398,398,1,1,0,1,0
25,436,436,14,14,0,1,0
15,443,443,1,1,0,1,0
32,450,450,63,59,4,2,1
20,452,452,15,9,6,2,1
28,458,458,38,38,0,1,0
3,463,463,16,16,0,1,0
29,464,464,51,22,29,2,1
0,466,466,75,25,50,3,2
13,479,479,3,3,0,1,0
38,494,494,59,59,0,1,0
8,496,496,127,127,0,1,0

13,110,110,2,2,0,1,0
16,147,147,24,13,11,2,1
19,174,174,2,2,0,1,0
20,184,184,26,17,9,2,1
17,195,195,16,16,0,1,0
4,197,197,4,4,0,1,0
26,209,209,59,18,41,4,3
14,222,222,27,1,26,2,1
18,229,229,45,45,0,1,0
7,234,234,5,5,0,1,0
2,253,253,39,39,0,1,0
22,266,266,30,3,27,2,1
11,287,287,100,100,0,1,0
3,316,316,32,17,15,2,1
12,329,329,13,8,5,2,1
21,340,340,2,2,0,1,0
27,350,350,54,54,0,1,0
8,357,357,49,9,40,3,2
28,359,359,2,2,0,1,0
10,364,364,83,1,82,3,2
0,374,374,17,7,10,3,2
24,374,374,29,17,12,2,1
6,392,392,127,112,15,4,3
9,419,419,18,18,0,1,0
25,431,431,36,36,0,1,0
5,450,450,24,24,0,1,0
15,451,451,49,49,0,1,0
1,460,460,39,34,5,2,1
23,474,474,35,35,0,1,0

1,122,122,2,2,0,1,0
31,147,147,1,1,0,1,0
26,149,149,6,6,0,1,0
8,153,153,36,5,31,2,1
37,153,153,25,7,18,4,3
25,174,174,3,3,0,1,0
2,187,187,17,5,12,4,3
36,253,253,9,1,8,2,1
19,267,267,16,4,12,2,1
11,273,273,1,1,0,1,0
33,278,278,12,5,7,2,1
12,297,297,22,22,0,1,0
34,302,302,3,3,0,1,0
13,315,315,31,31,0,1,0
22,327,327,116,22,94,3,2
17,332,332,17,17,0,1,0
7,350,350,1,1,0,1,0
9,354,354,1,1,0,1,0
16,361,361,1,1,0,1,0
0,365,365,20,20,0,1,0
14,383,383,36,6,30,3,2
5,384,384,82,1,81,4,3
30,407,407,15,15,0,1,0
29,410,410,14,14,0,1,0
23,438,438,98,50,48,2,1
24,440,440,72,16,56,4,3
32,446,446,117,97,20,2,1
6,450,450,1,1,0,1,0
20,451,451,25,25,0,1,0
35,455,455,33,33,0,1,0
3,471,471,67,27,40,2,1
18,473,473,73,40,33,4,3
21,483,483,40,4,36,3,2
4,487,487,19,8,11,2,1
27,488,488,33,15,18,2,1
10,493,493,55,55,0,1,0
28,496,496,52,52,0,1,0
15,499,499,6,6,0,1,0

30,121,121,4,4,0,1,0
7,156,156,2,2,0,1,0
2,179,179,12,12,0,1,0
20,199,199,14,6,8,2,1
26,202,202,15,3,12,3,2
22,228,228,2,2,0,1,0
18,238,238,7,7,0,1,0
28,245,245,4,4,0,1,0
14,247,247,53,11,42,4,3
6,255,255,80,29,51,4,3
23,278,278,74,43,31,2,1
15,279,279,18,10,8,3,2
10,287,287,35,35,0,1,0
21,307,307,4,4,0,1,0
4,324,324,71,35,36,2,1
0,345,345,1,1,0,1,0
11,348,348,14,14,0,1,0
25,361,361,184,145,39,4,3
1,369,369,76,40,36,4,3
9,380,380,4,4,0,1,0
24,391,391,45,9,36,4,3
29,393,393,45,45,0,1,0
13,394,394,78,48,30,3,2
5,418,418,1,1,0,1,0
12,429,429,5,5,0,1,0
27,453,453,37,1,36,3,2
19,466,466,19,3,16,3,2
17,490,490,48,48,0,1,0
3,499,499,26,26,0,1,0
16,500,500,51,15,36,2,1
8,500,500,65,7,58,3,2

6,128,128,4,4,0,1,0
0,133,133,31,18,13,2,1
15,134,134,18,3,15,4,3
21,138,138,14,14,0,1,0
3,164,164,5,5,0,1,0
1,167,167,9,1,8,2,1
22,169,169,1,1,0,1,0
7,192,192,4,4,0,1,0
26,202,202,53,45,8,3,2
13,216,216,12,12,0,1,0
19,265,265,2,2,0,1,0
17,282,282,15,6,9,2,1
16,284,284,60,60,0,1,0
27,288,288,13,13,0,1,0
24,288,288,6,6,0,1,0
14,294,294,6,6,0,1,0
12,298,298,8,2,6,2,1
8,311,311,43,43,0,1,0
9,326,326,32,32,0,1,0
32,361,361,19,19,0,1,0
10,361,361,23,14,9,4,3
25,372,372,3,3,0,1,0
29,384,384,24,3,21,4,3
2,395,395,4,4,0,1,0
28,398,398,48,32,16,2,1
5,424,424,105,57,48,3,2
11,436,436,90,18,72,4,3
4,441,441,9,1,8,3,2
20,464,464,14,4,10,2,1
31,466,466,77,15,62,3,2
18,467,467,58,58,0,1,0
23,484,484,222,195,27,4,3
30,493,493,52,40,12,4,3

5,127,127,1,1,0,1,0
2,139,139,22,8,14,2,1
24,143,143,18,1,17,2,1
18,146,146,25,7,18,3,2
4,151,151,5,5,0,1,0
27,152,152,5,5,0,1,0
29,174,174,20,15,5,2,1
20,216,216,1,1,0,1,0
21,222,222,13,13,0,1,0
0,257,257,11,3,8,3,2
9,263,263,15,15,0,1,0
17,266,266,15,15,0,1,0
8,269,269,43,43,0,1,0
23,276,276,66,40,26,2,1
28,278,278,37,37,0,1,0
14,286,286,41,41,0,1,0
3,287,287,38,23,15,4,3
11,296,296,3,3,0,1,0
6,332,332,49,17,32,2,1
12,353,353,131,103,28,3,2
26,362,362,53,15,38,2,1
7,363,363,63,9,54,3,2
19,368,368,10,10,0,1,0
1,381,381,41,8,33,4,3
13,382,382,1,1,0,1,0
25,386,386,75,75,0,1,0
16,412,412,1,1,0,1,0
15,433,433,1,1,0,1,0
10,468,468,92,92,0,1,0
22,494,494,89,68,21,4,3

31,131,131,5,5,0,1,0
12,132,132,9,2,7,2,1
8,134,134,19,19,0,1,0
3,151,151,3,3,0,1,0
22,157,157,25,25,0,1,0
27,179,179,64,52,12,4,3
6,181,181,17,8,9,2,1
10,186,186,38,29,9,2,1
5,195,195,4,4,0,1,0
25,204,204,34,26,8,3,2
1,209,209,3,3,0,1,0
20,216,216,40,22,18,4,3
4,227,227,69,69,0,1,0
15,227,227,19,11,8,3,2
23,235,235,2,2,0,1,0
11,262,262,15,15,0,1,0
21,267,267,23,7,16,3,2
14,295,295,34,34,0,1,0
7,303,303,37,37,0,1,0
18,318,318,36,3,33,4,3
28,321,321,4,4,0,1,0
24,325,325,17,12,5,2,1
19,360,360,35,10,25,4,3
9,365,365,126,100,26,3,2
30,411,411,54,12,42,3,2
0,431,431,1,1,0,1,0
26,432,432,33,27,6,2,1
13,443,443,2,2,0,1,0
16,454,454,5,5,0,1,0
2,467,467,3,3,0,1,0
29,480,480,65,15,50,3,2
17,482,482,1,1,0,1,0

6,129,129,15,2,13,3,2
5,151,151,3,3,0,1,0
3,162,162,10,3,7,2,1
8,163,163,12,12,0,1,0
9,163,163,3,3,0,1,0
22,167,167,15,1,14,2,1
18,192,192,21,21,0,1,0
15,193,193,54,3,51,4,3
11,200,200,34,34,0,1,0
10,210,210,11,2,9,3,2
20,217,217,13,5,8,3,2
26,232,232,49,49,0,1,0
1,237,237,47,10,37,2,1
27,244,244,2,2,0,1,0
17,292,292,2,2,0,1,0
2,296,296,6,6,0,1,0
23,305,305,10,2,8,2,1
16,315,315,5,5,0,1,0
21,317,317,19,19,0,1,0
28,344,344,127,34,93,4,3
29,344,344,40,40,0,1,0
30,355,355,148,148,0,1,0
31,355,355,16,16,0,1,0
24,429,429,4,4,0,1,0
12,435,435,15,6,9,4,3
0,450,450,86,86,0,1,0
25,451,451,24,24,0,1,0
4,460,460,24,1,23,2,1
19,469,469,13,13,0,1,0
13,487,487,145,70,75,4,3
7,488,488,1,1,0,1,0
14,489,489,7,7,0,1,0

3,110,110,1,1,0,1,0
24,125,125,6,6,0,1,0
8,135,135,3,3,0,1,0
39,179,179,11,3,8,3,2
17,180,180,1,1,0,1,0
26,186,186,1,1,0,1,0
6,196,196,10,10,0,1,0
1,198,198,50,50,0,1,0
20,211,211,28,28,0,1,0
21,212,212,9,2,7,2,1
23,217,217,3,3,0,1,0
11,218,218,17,1,16,4,3
27,236,236,25,10,15,2,1
12,250,250,14,3,11,2,1
36,251,251,30,16,14,2,1
9,267,267,8,8,0,1,0
40,270,270,24,1,23,2,1
0,274,274,38,5,33,4,3
32,286,286,62,38,24,4,3
5,293,293,2,2,0,1,0
28,294,294,114,10,104,4,3
2,301,301,24,8,16,2,1
22,311,311,11,4,7,2,1
10,339,339,56,8,48,2,1
33,359,359,103,20,83,4,3
37,362,362,24,1,23,4,3
15,383,383,9,9,0,1,0
4,398,398,8,2,6,2,1
31,400,400,15,15,0,1,0
25,405,405,12,2,10,2,1
14,406,406,18,7,11,2,1
29,415,415,4,4,0,1,0
7,424,424,6,6,0,1,0
19,425,425,31,6,25,3,2
16,427,427,26,8,18,3,2
35,428,428,25,25,0,1,0
18,431,431,24,24,0,1,0
30,436,436,35,35,0,1,0
38,457,457,23,23,0,1,0
13,466,466,67,58,9,4,3
34,499,499,10,6,4,2,1

1,110,110,26,26,0,1,0
17,112,112,2,2,0,1,0
5,123,123,4,4,0,1,0
14,126,126,12,7,5,2,1
28,137,137,7,2,5,2,1
9,163,163,21,8,13,2,1
25,198,198,26,1,25,2,1
13,217,217,31,31,0,1,0
20,279,279,1,1,0,1,0
6,286,286,49,49,0,1,0
18,296,296,1,1,0,1,0
27,307,307,31,31,0,1,0
11,320,320,31,1,30,4,3
7,332,332,48,48,0,1,0
21,335,335,12,12,0,1,0
3,346,346,85,85,0,1,0
0,356,356,66,29,37,2,1
4,375,375,45,45,0,1,0
15,377,377,20,11,9,2,1
23,384,384,95,13,82,4,3
2,387,387,41,41,0,1,0
19,405,405,119,85,34,2,1
22,406,406,114,20,94,4,3
16,420,420,35,35,0,1,0
26,427,427,28,22,6,2,1
12,446,446,40,40,0,1,0
24,468,468,11,11,0,1,0
10,476,476,10,10,0,1,0
8,490,490,11,1,10,2,1

23,100,100,5,1,4,2,1
24,102,102,1,1,0,1,0
15,131,131,1,1,0,1,0
4,132,132,13,4,9,2,1
33,141,141,1,1,0,1,0
20,145,145,10,1,9,2,1
28,146,146,4,1,3,2,1
30,155,155,4,4,0,1,0
21,159,159,14,14,0,1,0
5,163,163,1,1,0,1,0
34,170,170,4,4,0,1,0
36,181,181,7,3,4,2,1
2,196,196,8,8,0,1,0
41,210,210,71,19,52,3,2
39,218,218,55,8,47,2,1
22,222,222,8,8,0,1,0
9,228,228,61,22,39,3,2
19,240,240,23,23,0,1,0
12,242,242,1,1,0,1,0
32,242,242,39,23,16,4,3
14,271,271,16,16,0,1,0
13,280,280,16,16,0,1,0
11,281,281,67,15,52,3,2
40,294,294,47,47,0,1,0
8,298,298,12,2,10,3,2
38,309,309,36,36,0,1,0
25,331,331,34,25,9,2,1
1,333,333,6,3,3,2,1
31,337,337,28,28,0,1,0
29,338,338,12,4,8,3,2
10,341,341,8,8,0,1,0
27,355,355,14,3,11,2,1
37,357,357,68,68,0,1,0
18,362,362,12,12,0,1,0
7,372,372,4,4,0,1,0
0,395,395,54,54,0,1,0
3,400,400,7,7,0,1,0
6,415,415,16,16,0,1,0
16,422,422,19,5,14,3,2
17,457,457,4,4,0,1,0
26,466,466,54,7,47,4,3
35,477,477,13,13,0,1,0

27,110,110,1,1,0,1,0
4,134,134,5,5,0,1,0
29,141,141,17,17,0,1,0
26,177,177,27,27,0,1,0
7,183,183,15,15,0,1,0
5,189,189,13,13,0,1,0
14,196,196,7,3,4,2,1
31,199,199,24,7,17,2,1
30,220,220,31,10,21,3,2
8,228,228,22,3,19,2,1
32,234,234,3,3,0,1,0
12,241,241,84,6,78,4,3
19,260,260,12,12,0,1,0
16,275,275,10,10,0,1,0
15,283,283,20,8,12,2,1
6,293,293,13,2,11,4,3
25,306,306,144,144,0,1,0
24,307,307,41,9,32,2,1
21,308,308,18,18,0,1,0
3,327,327,38,38,0,1,0
0,336,336,60,45,15,2,1
11,342,342,7,7,0,1,0
23,407,407,10,5,5,2,1
9,442,442,91,25,66,4,3
17,451,451,10,10,0,1,0
1,456,456,28,12,16,2,1
22,460,460,50,35,15,2,1
20,460,460,60,39,21,2,1
28,461,461,27,11,16,3,2
2,467,467,10,3,7,2,1
18,469,469,7,7,0,1,0
10,473,473,74,74,0,1,0
13,499,499,10,1,9,2,1

6,102,102,3,3,0,1,0
13,105,105,3,3,0,1,0
14,116,116,1,1,0,1,0
11,138,138,3,3,0,1,0
22,158,158,25,19,6,3,2
27,161,161,2,2,0,1,0
9,172,172,12,3,9,2,1
29,175,175,1,1,0,1,0
34,182,182,16,16,0,1,0
3,182,182,51,25,26,2,1
23,190,190,2,2,0,1,0
30,200,200,16,6,10,2,1
25,203,203,33,33,0,1,0
28,209,209,9,9,0,1,0
32,214,214,46,46,0,1,0
33,247,247,18,14,4,2,1
10,262,262,17,2,15,2,1
18,289,289,86,55,31,2,1
21,294,294,7,7,0,1,0
16,336,336,11,11,0,1,0
20,340,340,11,11,0,1,0
7,351,351,46,24,22,2,1
5,359,359,11,1,10,2,1
4,373,373,15,5,10,3,2
15,380,380,27,27,0,1,0
1,412,412,65,45,20,3,2
26,431,431,6,6,0,1,0
0,435,435,7,7,0,1,0
2,438,438,6,3,3,2,1
12,452,452,18,18,0,1,0
19,464,464,96,96,0,1,0
24,483,483,202,202,0,1,0
17,484,484,84,28,56,3,2
8,487,487,46,36,10,2,1
31,492,492,43,15,28,2,1

27,105,105,3,3,0,1,0
20,106,106,5,5,0,1,0
2,113,113,38,11,27,4,3
13,124,124,5,1,4,2,1
10,138,138,34,14,20,3,2
24,146,146,9,9,0,1,0
8,150,150,11,5,6,2,1
28,169,169,1,1,0,1,0
1,185,185,3,3,0,1,0
5,193,193,5,5,0,1,0
11,230,230,96,72,24,3,2
22,230,230,36,2,34,3,2
0,280,280,20,17,3,2,1
9,331,331,4,4,0,1,0
21,335,335,75,3,72,3,2
25,343,343,24,24,0,1,0
16,352,352,56,43,13,2,1
4,368,368,8,8,0,1,0
15,369,369,22,15,7,2,1
6,372,372,16,1,15,2,1
18,394,394,25,25,0,1,0
12,396,396,88,7,81,4,3
26,408,408,21,1,20,2,1
17,431,431,16,1,15,2,1
23,448,448,226,219,7,2,1
19,455,455,23,19,4,2,1
7,455,455,30,30,0,1,0
3,495,495,24,24,0,1,0
14,497,497,37,37,0,1,0

24,104,104,19,19,0,1,0
15,153,153,36,36,0,1,0
0,155,155,10,10,0,1,0
8,161,161,13,2,11,2,1
5,169,169,41,34,7,2,1
26,185,185,10,2,8,2,1
9,208,208,11,11,0,1,0
16,209,209,8,3,5,2,1
22,235,235,2,2,0,1,0
14,257,257,29,29,0,1,0
17,257,257,80,32,48,4,3
4,258,258,14,2,12,4,3
20,266,266,44,19,25,2,1
18,304,304,17,17,0,1,0
11,305,305,4,4,0,1,0
2,324,324,13,2,11,4,3
12,337,337,8,8,0,1,0
23,344,344,10,10,0,1,0
19,365,365,27,15,12,4,3
21,380,380,32,18,14,3,2
13,387,387,44,20,24,4,3
3,413,413,33,33,0,1,0
7,416,416,216,130,86,3,2
6,443,443,1,1,0,1,0
25,444,444,55,55,0,1,0
1,452,452,193,133,60,4,3
10,454,454,17,17,0,1,0

22,121,121,12,12,0,1,0
32,137,137,7,7,0,1,0
8,144,144,6,6,0,1,0
6,169,169,1,1,0,1,0
24,169,169,5,5,0,1,0
23,178,178,23,5,18,2,1
1,185,185,2,2,0,1,0
25,194,194,1,1,0,1,0
9,236,236,35,20,15,4,3
21,245,245,6,6,0,1,0
14,247,247,16,16,0,1,0
18,248,248,9,9,0,1,0
31,257,257,19,19,0,1,0
2,282,282,78,78,0,1,0
29,286,286,42,39,3,2,1
33,288,288,78,78,0,1,0
12,300,300,80,50,30,4,3
28,309,309,28,12,16,2,1
19,316,316,17,1,16,3,2
4,347,347,28,28,0,1,0
3,356,356,15,15,0,1,0
17,359,359,1,1,0,1,0
10,391,391,90,90,0,1,0
16,393,393,5,5,0,1,0
11,404,404,18,18,0,1,0
13,407,407,22,22,0,1,0
0,408,408,5,1,4,2,1
30,409,409,36,8,28,3,2
36,428,428,61,61,0,1,0
27,428,428,24,24,0,1,0
5,430,430,17,5,12,4,3
26,437,437,35,35,0,1,0
34,462,462,5,2,3,2,1
35,463,463,155,77,78,3,2
15,465,465,16,11,5,2,1
7,473,473,41,41,0,1,0
20,497,497,28,5,23,2,1

2,103,103,5,5,0,1,0
12,115,115,1,1,0,1,0
22,126,126,2,2,0,1,0
5,127,127,19,6,13,2,1
18,141,141,34,34,0,1,0
11,146,146,33,9,24,3,2
0,149,149,13,9,4,2,1
17,174,174,3,3,0,1,0
15,189,189,19,2,17,2,1
16,189,189,4,4,0,1,0
26,194,194,19,9,10,2,1
28,201,201,3,3,0,1,0
19,207,207,18,3,15,2,1
8,217,217,25,25,0,1,0
25,236,236,1,1,0,1,0
21,241,241,67,21,46,3,2
10,276,276,24,24,0,1,0
4,286,286,12,3,9,2,1
13,314,314,3,3,0,1,0
7,314,314,23,6,17,2,1
29,324,324,37,37,0,1,0
14,331,331,9,9,0,1,0
1,332,332,100,100,0,1,0
20,370,370,126,118,8,2,1
27,385,385,35,35,0,1,0
9,389,389,97,97,0,1,0
24,417,417,22,19,3,2,1
23,447,447,31,3,28,2,1
3,465,465,62,25,37,3,2
6,480,480,21,3,18,4,3
30,488,488,46,46,0,1,0

4,113,113,16,16,0,1,0
12,128,128,28,22,6,2,1
29,137,137,14,14,0,1,0
13,138,138,10,7,3,2,1
1,143,143,1,1,0,1,0
32,152,152,13,13,0,1,0
5,175,175,1,1,0,1,0
18,205,205,11,3,8,3,2
21,210,210,17,14,3,2,1
27,216,216,26,26,0,1,0
28,217,217,26,26,0,1,0
33,232,232,9,9,0,1,0
11,239,239,27,27,0,1,0
23,241,241,5,5,0,1,0
15,254,254,34,1,33,2,1
7,257,257,18,18,0,1,0
24,261,261,40,6,34,3,2
31,282,282,20,4,16,2,1
26,286,286,38,38,0,1,0
16,288,288,3,3,0,1,0
36,290,290,27,27,0,1,0
9,322,322,35,11,24,4,3
30,328,328,48,4,44,2,1
0,342,342,16,4,12,3,2
2,350,350,47,37,10,3,2
14,358,358,5,5,0,1,0
34,372,372,99,15,84,3,2
6,374,374,41,14,27,4,3
17,392,392,10,10,0,1,0
20,416,416,5,5,0,1,0
19,423,423,54,54,0,1,0
25,430,430,36,6,30,3,2
8,434,434,64,64,0,1,0
35,463,463,28,28,0,1,0
3,468,468,22,2,20,4,3
10,476,476,1,1,0,1,0
22,499,499,30,30,0,1,0

14,119,119,28,4,24,3,2
1,137,137,9,9,0,1,0
28,154,154,24,14,10,3,2
9,166,166,7,7,0,1,0
27,172,172,26,10,16,3,2
30,188,188,3,3,0,1,0
7,195,195,62,26,36,3,2
24,219,219,30,6,24,4,3
15,228,228,1,1,0,1,0
34,231,231,83,51,32,2,1
6,261,261,11,5,6,2,1
21,262,262,28,28,0,1,0
22,268,268,54,54,0,1,0
11,269,269,5,1,4,2,1
5,283,283,8,5,3,2,1
2,283,283,8,8,0,1,0
26,290,290,9,9,0,1,0
31,314,314,57,43,14,3,2
12,340,340,12,3,9,2,1
13,342,342,7,7,0,1,0
32,346,346,10,2,8,3,2
29,347,347,2,2,0,1,0
8,353,353,96,74,22,3,2
35,356,356,11,1,10,3,2
16,362,362,19,1,18,2,1
25,365,365,14,14,0,1,0
17,375,375,8,4,4,2,1
20,376,376,48,37,11,2,1
19,385,385,61,17,44,2,1
0,393,393,25,3,22,3,2
18,402,402,38,38,0,1,0
10,413,413,25,25,0,1,0
33,425,425,4,1,3,2,1
3,460,460,12,4,8,3,2
4,461,461,6,6,0,1,0
23,498,498,19,13,6,3,2

11,108,108,1,1,0,1,0
18,109,109,3,3,0,1,0
7,153,153,42,42,0,1,0
21,155,155,23,9,14,2,1
6,169,169,10,10,0,1,0
9,169,169,10,2,8,2,1
25,190,190,22,12,10,3,2
23,200,200,3,3,0,1,0
31,202,202,20,20,0,1,0
13,209,209,10,10,0,1,0
29,218,218,28,9,19,4,3
22,230,230,50,11,39,4,3
12,234,234,9,4,5,2,1
0,268,268,73,25,48,4,3
10,312,312,2,2,0,1,0
30,353,353,15,6,9,2,1
17,357,357,32,32,0,1,0
20,379,379,16,10,6,2,1
15,383,383,119,119,0,1,0
3,389,389,6,6,0,1,0
5,408,408,54,54,0,1,0
19,409,409,51,51,0,1,0
27,413,413,15,6,9,2,1
16,416,416,4,4,0,1,0
1,429,429,46,46,0,1,0
4,442,442,10,7,3,2,1
24,446,446,140,140,0,1,0
14,448,448,32,5,27,2,1
8,454,454,9,3,6,3,2
28,466,466,56,56,0,1,0
26,468,468,47,47,0,1,0
2,489,489,75,61,14,2,1

3,111,111,18,8,10,4,3
19,130,130,5,2,3,2,1
26,132,132,22,22,0,1,0
36,135,135,6,3,3,2,1
20,152,152,9,3,6,3,2
27,153,153,5,5,0,1,0
7,177,177,14,7,7,2,1
25,191,191,5,5,0,1,0
11,200,200,1,1,0,1,0
23,204,204,35,18,17,2,1
22,212,212,35,5,30,2,1
1,231,231,6,6,0,1,0
33,238,238,51,3,48,3,2
30,243,243,2,2,0,1,0
32,246,246,14,14,0,1,0
9,258,258,4,1,3,2,1
2,264,264,9,4,5,2,1
24,284,284,17,17,0,1,0
17,291,291,53,53,0,1,0
21,310,310,56,12,44,2,1
29,343,343,57,10,47,2,1
10,345,345,15,2,13,4,3
35,350,350,1,1,0,1,0
12,353,353,3,3,0,1,0
5,361,361,98,26,72,4,3
4,363,363,16,6,10,3,2
28,404,404,90,76,14,3,2
6,417,417,10,10,0,1,0
34,430,430,21,16,5,2,1
8,436,436,85,16,69,4,3
0,437,437,37,37,0,1,0
18,459,459,50,29,21,4,3
15,460,460,2,2,0,1,0
37,461,461,13,13,0,1,0
14,472,472,12,12,0,1,0
13,481,481,4,4,0,1,0
31,483,483,103,77,26,3,2
16,497,497,1,1,0,1,0

17,109,109,21,1,20,4,3
11,127,127,7,7,0,1,0
8,154,154,43,4,39,2,1
14,161,161,28,28,0,1,0
9,180,180,23,23,0,1,0
24,187,187,12,12,0,1,0
0,205,205,77,67,10,2,1
5,225,225,40,25,15,2,1
1,242,242,73,73,0,1,0
19,263,263,64,64,0,1,0
13,286,286,18,4,14,2,1
20,313,313,28,16,12,2,1
15,327,327,86,86,0,1,0
4,348,348,7,7,0,1,0
23,357,357,14,6,8,2,1
7,377,377,48,48,0,1,0
2,377,377,34,34,0,1,0
6,396,396,6,1,5,2,1
18,400,400,22,22,0,1,0
3,426,426,30,30,0,1,0
10,428,428,7,7,0,1,0
25,432,432,44,14,30,3,2
16,434,434,40,40,0,1,0
26,440,440,26,26,0,1,0
21,461,461,30,30,0,1,0
12,467,467,23,23,0,1,0
22,471,471,12,12,0,1,0

9,122,122,13,1,12,4,3
26,132,132,9,9,0,1,0
25,145,145,25,25,0,1,0
20,172,172,1,1,0,1,0
30,176,176,6,2,4,2,1
4,185,185,5,5,0,1,0
14,185,185,24,3,21,4,3
15,190,190,50,50,0,1,0
3,198,198,25,11,14,3,2
16,209,209,5,5,0,1,0
28,245,245,3,3,0,1,0
1,247,247,42,19,23,2,1
2,260,260,35,23,12,3,2
22,268,268,1,1,0,1,0
12,269,269,67,21,46,3,2
36,270,270,6,3,3,2,1
8,304,304,3,3,0,1,0
35,309,309,64,21,43,3,2
19,309,309,7,7,0,1,0
29,322,322,32,23,9,2,1
24,322,322,40,40,0,1,0
37,345,345,41,7,34,4,3
13,345,345,2,2,0,1,0
10,370,370,4,4,0,1,0
32,374,374,2,2,0,1,0
38,384,384,28,1,27,2,1
7,388,388,2,2,0,1,0
23,394,394,26,26,0,1,0
27,397,397,59,59,0,1,0
18,401,401,1,1,0,1,0
33,426,426,28,13,15,2,1
21,436,436,32,1,31,4,3
11,439,439,2,2,0,1,0
0,445,445,6,6,0,1,0
34,447,447,21,21,0,1,0
6,452,452,8,8,0,1,0
31,465,465,170,131,39,2,1
17,469,469,78,46,32,3,2
5,495,495,15,15,0,1,0

11,105,105,6,6,0,1,0
15,111,111,3,3,0,1,0
20,117,117,14,14,0,1,0
23,137,137,21,11,10,2,1
6,173,173,3,3,0,1,0
34,186,186,39,39,0,1,0
13,198,198,24,6,18,4,3
26,202,202,13,13,0,1,0
32,221,221,10,10,0,1,0
28,224,224,11,3,8,3,2
8,229,229,2,2,0,1,0
3,236,236,53,15,38,3,2
25,273,273,4,4,0,1,0
16,286,286,6,6,0,1,0
2,292,292,29,14,15,2,1
30,295,295,22,10,12,3,2
29,307,307,3,3,0,1,0
21,324,324,23,23,0,1,0
33,335,335,54,5,49,4,3
12,336,336,9,6,3,2,1
24,346,346,16,13,3,2,1
18,354,354,15,15,0,1,0
4,355,355,40,16,24,3,2
0,356,356,30,30,0,1,0
1,370,370,18,2,16,2,1
17,405,405,3,3,0,1,0
10,414,414,7,7,0,1,0
35,429,429,4,4,0,1,0
14,438,438,19,19,0,1,0
27,447,447,23,23,0,1,0
19,453,453,52,28,24,2,1
22,457,457,119,119,0,1,0
31,458,458,171,61,110,4,3
36,469,469,20,20,0,1,0
9,470,470,1,1,0,1,0
7,475,475,77,61,16,3,2
5,495,495,124,58,66,4,3

1,107,107,1,1,0,1,0
12,109,109,5,1,4,2,1
14,142,142,6,6,0,1,0
28,143,143,7,1,6,2,1
16,144,144,3,3,0,1,0
3,154,154,11,3,8,3,2
31,161,161,5,5,0,1,0
19,163,163,14,14,0,1,0
26,178,178,17,3,14,3,2
0,179,179,10,7,3,2,1
8,180,180,36,7,29,2,1
11,189,189,1,1,0,1,0
7,191,191,5,5,0,1,0
2,198,198,32,32,0,1,0
27,202,202,33,19,14,3,2
23,221,221,55,55,0,1,0
29,229,229,23,23,0,1,0
30,231,231,15,15,0,1,0
17,238,238,81,81,0,1,0
21,250,250,37,3,34,3,2
15,250,250,11,1,10,3,2
33,265,265,22,15,7,2,1
4,294,294,7,3,4,2,1
24,316,316,46,8,38,2,1
13,333,333,34,1,33,2,1
25,335,335,15,15,0,1,0
5,356,356,1,1,0,1,0
34,361,361,22,6,16,3,2
10,395,395,5,5,0,1,0
18,396,396,80,80,0,1,0
6,408,408,13,5,8,2,1
32,422,422,26,11,15,2,1
9,426,426,87,45,42,3,2
20,474,474,43,43,0,1,0
22,495,495,76,64,12,3,2

14,129,129,9,9,0,1,0
26,139,139,38,38,0,1,0
27,150,150,17,12,5,2,1
0,158,158,3,3,0,1,0
6,176,176,42,42,0,1,0
9,180,180,3,3,0,1,0
22,183,183,4,4,0,1,0
16,192,192,7,7,0,1,0
3,204,204,1,1,0,1,0
28,208,208,59,7,52,3,2
20,214,214,3,3,0,1,0
18,217,217,1,1,0,1,0
25,228,228,5,5,0,1,0
8,240,240,50,50,0,1,0
10,260,260,29,29,0,1,0
7,280,280,24,24,0,1,0
23,301,301,27,1,26,3,2
2,311,311,57,3,54,4,3
12,325,325,46,26,20,2,1
5,333,333,86,20,66,4,3
24,388,388,70,70,0,1,0
11,395,395,31,22,9,4,3
17,398,398,40,40,0,1,0
13,433,433,99,48,51,4,3
4,463,463,6,6,0,1,0
1,463,463,6,6,0,1,0
19,467,467,2,2,0,1,0
15,473,473,36,14,22,3,2
21,490,490,117,81,36,3,2
29,500,500,53,2,51,4,3

28,104,104,6,6,0,1,0
26,113,113,2,2,0,1,0
16,117,117,2,2,0,1,0
31,121,121,6,6,0,1,0
23,131,131,3,3,0,1,0
9,133,133,12,12,0,1,0
7,139,139,5,2,3,2,1
15,156,156,9,9,0,1,0
30,168,168,2,2,0,1,0
4,199,199,3,3,0,1,0
37,239,239,96,63,33,2,1
34,248,248,24,9,15,4,3
35,269,269,68,2,66,4,3
1,270,270,18,1,17,2,1
36,274,274,6,6,0,1,0
39,283,283,12,12,0,1,0
24,303,303,63,23,40,4,3
13,314,314,16,2,14,4,3
0,323,323,64,42,22,3,2
12,329,329,5,5,0,1,0
32,334,334,29,20,9,4,3
10,348,348,12,12,0,1,0
17,348,348,23,5,18,4,3
33,349,349,93,3,90,3,2
20,350,350,3,3,0,1,0
3,376,376,16,1,15,4,3
11,378,378,12,4,8,3,2
22,380,380,51,13,38,3,2
8,398,398,42,36,6,2,1
19,409,409,18,10,8,3,2
14,415,415,15,15,0,1,0
2,415,415,27,27,0,1,0
21,425,425,48,24,24,4,3
40,428,428,15,7,8,3,2
25,433,433,36,36,0,1,0
27,445,445,17,17,0,1,0
6,453,453,10,2,8,3,2
18,472,472,37,4,33,2,1
38,474,474,27,27,0,1,0
29,480,480,49,23,26,2,1
5,493,493,20,15,5,2,1

1,140,140,1,1,0,1,0
8,143,143,5,5,0,1,0
7,149,149,56,56,0,1,0
16,155,155,46,4,42,4,3
27,156,156,17,2,15,4,3
29,157,157,23,9,14,3,2
4,157,157,24,24,0,1,0
25,170,170,3,3,0,1,0
17,177,177,3,3,0,1,0
3,178,178,19,9,10,3,2
22,180,180,48,9,39,2,1
14,180,180,6,6,0,1,0
28,197,197,2,2,0,1,0
13,228,228,17,8,9,4,3
5,250,250,55,15,40,3,2
18,298,298,31,31,0,1,0
11,350,350,21,15,6,2,1
20,366,366,16,16,0,1,0
6,377,377,58,30,28,2,1
23,379,379,35,35,0,1,0
15,396,396,7,4,3,2,1
24,399,399,136,123,13,4,3
10,404,404,50,36,14,3,2
12,407,407,21,21,0,1,0
21,428,428,26,8,18,3,2
26,443,443,13,5,8,2,1
0,446,446,1,1,0,1,0
2,457,457,1,1,0,1,0
9,467,467,110,87,23,3,2
19,494,494,21,21,0,1,0

8,101,101,24,24,0,1,0
17,108,108,2,2,0,1,0
9,109,109,5,5,0,1,0
30,111,111,7,7,0,1,0
22,118,118,23,23,0,1,0
23,118,118,12,1,11,2,1
14,138,138,2,2,0,1,0
26,144,144,41,32,9,4,3
0,146,146,11,11,0,1,0
18,151,151,29,16,13,2,1
34,170,170,28,12,16,3,2
19,176,176,3,3,0,1,0
12,190,190,1,1,0,1,0
5,201,201,1,1,0,1,0
1,213,213,17,17,0,1,0
20,220,220,1,1,0,1,0
7,227,227,30,30,0,1,0
11,253,253,36,1,35,4,3
2,334,334,28,28,0,1,0
29,336,336,11,1,10,3,2
6,344,344,57,57,0,1,0
3,360,360,31,12,19,4,3
35,382,382,16,16,0,1,0
27,388,388,3,3,0,1,0
10,393,393,2,2,0,1,0
21,395,395,87,83,4,2,1
28,399,399,19,9,10,3,2
33,419,419,53,53,0,1,0
24,434,434,24,14,10,3,2
25,443,443,26,5,21,2,1
32,453,453,91,82,9,4,3
4,461,461,24,24,0,1,0
31,466,466,13,1,12,2,1
13,472,472,5,1,4,2,1
16,493,493,45,40,5,2,1
15,500,500,70,12,58,3,2

19,113,113,1,1,0,1,0
12,117,117,11,11,0,1,0
8,129,129,4,4,0,1,0
37,131,131,6,6,0,1,0
36,141,141,1,1,0,1,0
33,145,145,11,11,0,1,0
30,149,149,15,4,11,2,1
34,172,172,20,1,19,2,1
3,181,181,5,5,0,1,0
1,203,203,8,1,7,3,2
22,221,221,44,44,0,1,0
31,224,224,24,24,0,1,0
14,231,231,19,19,0,1,0
32,236,236,44,44,0,1,0
23,252,252,11,6,5,2,1
15,258,258,8,2,6,3,2
5,259,259,20,14,6,3,2
28,268,268,31,9,22,2,1
35,276,276,11,5,6,3,2
7,293,293,18,18,0,1,0
29,296,296,6,2,4,2,1
10,299,299,9,9,0,1,0
24,306,306,72,72,0,1,0
9,313,313,37,37,0,1,0
21,327,327,34,10,24,3,2
2,328,328,76,55,21,4,3
25,347,347,17,3,14,3,2
11,355,355,14,5,9,2,1
4,366,366,18,18,0,1,0
20,389,389,12,12,0,1,0
13,389,389,32,32,0,1,0
16,449,449,24,3,21,3,2
27,452,452,58,37,21,2,1
26,455,455,68,39,29,2,1
18,458,458,12,12,0,1,0
17,489,489,70,44,26,2,1
6,493,493,101,72,29,2,1
0,497,497,18,4,14,3,2

21,103,103,1,1,0,1,0
7,122,122,21,3,18,3,2
2,127,127,12,12,0,1,0
14,131,131,25,25,0,1,0
20,136,136,2,2,0,1,0
4,146,146,4,4,0,1,0
22,158,158,25,25,0,1,0
19,190,190,30,24,6,2,1
11,231,231,12,4,8,2,1
1,233,233,18,10,8,3,2
30,266,266,17,8,9,4,3
26,270,270,5,5,0,1,0
32,271,271,45,13,32,3,2
23,275,275,36,24,12,3,2
12,280,280,22,10,12,2,1
5,290,290,17,5,12,2,1
10,305,305,86,86,0,1,0
8,309,309,55,33,22,3,2
25,309,309,2,2,0,1,0
16,311,311,50,32,18,2,1
15,342,342,6,6,0,1,0
9,354,354,7,7,0,1,0
27,369,369,12,12,0,1,0
24,417,417,97,63,34,2,1
3,440,440,47,29,18,2,1
18,444,444,83,83,0,1,0
6,447,447,17,2,15,2,1
13,450,450,20,16,4,2,1
17,457,457,100,4,96,3,2
29,474,474,44,44,0,1,0
0,475,475,1,1,0,1,0
31,480,480,10,10,0,1,0
28,483,483,60,36,24,4,3

0,117,117,8,8,0,1,0
21,120,120,2,2,0,1,0
4,124,124,52,52,0,1,0
17,128,128,7,1,6,2,1
3,138,138,2,2,0,1,0
28,138,138,46,17,29,4,3
2,139,139,1,1,0,1,0
1,155,155,8,8,0,1,0
24,160,160,3,3,0,1,0
19,162,162,1,1,0,1,0
8,163,163,9,9,0,1,0
13,164,164,17,9,8,3,2
16,186,186,39,39,0,1,0
7,202,202,8,2,6,2,1
9,204,204,9,9,0,1,0
10,212,212,71,26,45,2,1
11,268,268,30,30,0,1,0
5,277,277,67,67,0,1,0
20,279,279,101,3,98,3,2
12,301,301,25,1,24,3,2
26,332,332,33,33,0,1,0
27,343,343,22,22,0,1,0
15,364,364,55,55,0,1,0
22,378,378,18,18,0,1,0
29,382,382,1,1,0,1,0
14,383,383,33,33,0,1,0
6,391,391,11,11,0,1,0
25,397,397,2,2,0,1,0
18,409,409,37,37,0,1,0
23,428,428,34,34,0,1,0

17,107,107,17,17,0,1,0
19,118,118,1,1,0,1,0
33,118,118,33,10,23,4,3
26,134,134,24,12,12,4,3
16,148,148,16,16,0,1,0
1,178,178,2,2,0,1,0
27,181,181,12,12,0,1,0
28,234,234,12,12,0,1,0
34,236,236,57,21,36,2,1
29,250,250,28,20,8,3,2
0,257,257,5,2,3,2,1
35,264,264,24,24,0,1,0
31,265,265,10,10,0,1,0
3,280,280,34,8,26,3,2
15,293,293,6,2,4,2,1
13,316,316,29,29,0,1,0
32,320,320,9,9,0,1,0
2,325,325,7,7,0,1,0
24,326,326,4,4,0,1,0
10,337,337,63,63,0,1,0
30,348,348,33,33,0,1,0
25,353,353,6,6,0,1,0
22,355,355,10,10,0,1,0
7,361,361,66,2,64,4,3
18,387,387,39,39,0,1,0
8,410,410,22,14,8,3,2
12,413,413,14,6,8,2,1
23,427,427,38,38,0,1,0
11,435,435,73,73,0,1,0
6,439,439,84,38,46,2,1
20,441,441,6,6,0,1,0
9,459,459,25,3,22,3,2
4,461,461,14,2,12,2,1
5,493,493,4,4,0,1,0
14,493,493,15,12,3,2,1
21,494,494,148,148,0,1,0

33,107,107,2,2,0,1,0
27,111,111,12,12,0,1,0
38,141,141,18,8,10,2,1
14,150,150,8,3,5,2,1
41,150,150,8,8,0,1,0
12,154,154,1,1,0,1,0
5,165,165,7,2,5,2,1
24,184,184,7,7,0,1,0
10,186,186,59,45,14,3,2
0,191,191,4,1,3,2,1
1,217,217,9,2,7,2,1
25,219,219,1,1,0,1,0
15,231,231,10,10,0,1,0
8,256,256,9,3,6,3,2
22,280,280,7,7,0,1,0
23,286,286,23,18,5,2,1
18,291,291,1,1,0,1,0
6,293,293,13,7,6,3,2
19,303,303,41,9,32,4,3
39,308,308,51,51,0,1,0
37,316,316,17,17,0,1,0
13,324,324,6,1,5,2,1
3,354,354,1,1,0,1,0
32,358,358,56,56,0,1,0
34,381,381,16,6,10,3,2
2,409,409,2,2,0,1,0
35,416,416,2,2,0,1,0
36,424,424,3,3,0,1,0
40,428,428,52,52,0,1,0
7,435,435,1,1,0,1,0
17,435,435,119,78,41,4,3
20,451,451,77,47,30,3,2
9,451,451,56,56,0,1,0
26,455,455,142,142,0,1,0
16,457,457,4,4,0,1,0
4,458,458,4,4,0,1,0
11,464,464,38,24,14,3,2
31,469,469,56,28,28,2,1
28,476,476,2,2,0,1,0
29,481,481,88,50,38,2,1
21,493,493,7,2,5,2,1
30,500,500,80,70,10,2,1

22,116,116,8,2,6,2,1
0,138,138,36,9,27,3,2
1,147,147,50,50,0,1,0
15,148,148,17,17,0,1,0
8,154,154,11,3,8,2,1
12,157,157,19,19,0,1,0
4,157,157,1,1,0,1,0
24,161,161,17,9,8,2,1
5,178,178,109,109,0,1,0
9,179,179,15,3,12,4,3
3,200,200,19,2,17,2,1
18,259,259,49,49,0,1,0
7,292,292,10,10,0,1,0
2,321,321,1,1,0,1,0
20,352,352,61,34,27,2,1
17,371,371,33,33,0,1,0
23,385,385,9,6,3,2,1
11,404,404,69,27,42,3,2
13,407,407,22,22,0,1,0
21,412,412,16,8,8,3,2
14,419,419,50,11,39,4,3
16,427,427,31,3,28,3,2
10,430,430,85,61,24,3,2
19,464,464,1,1,0,1,0
6,487,487,89,35,54,4,3

11,101,101,4,4,0,1,0
12,112,112,2,2,0,1,0
30,114,114,1,1,0,1,0
27,114,114,13,5,8,3,2
20,121,121,1,1,0,1,0
28,151,151,1,1,0,1,0
25,162,162,10,10,0,1,0
14,165,165,25,13,12,4,3
29,183,183,36,36,0,1,0
21,197,197,104,71,33,4,3
1,211,211,20,5,15,4,3
6,217,217,4,1,3,2,1
16,224,224,18,18,0,1,0
24,236,236,8,8,0,1,0
2,240,240,36,28,8,3,2
15,244,244,22,22,0,1,0
22,244,244,2,2,0,1,0
18,261,261,38,5,33,4,3
13,275,275,1,1,0,1,0
7,288,288,70,22,48,2,1
23,308,308,82,82,0,1,0
9,339,339,25,1,24,4,3
3,344,344,7,7,0,1,0
17,355,355,16,16,0,1,0
8,372,372,27,3,24,3,2
5,394,394,29,24,5,2,1
4,423,423,53,53,0,1,0
10,437,437,105,83,22,2,1
0,456,456,128,128,0,1,0
26,459,459,20,20,0,1,0
19,460,460,3,3,0,1,0

13,101,101,1,1,0,1,0
23,113,113,14,4,10,3,2
24,129,129,23,2,21,2,1
31,133,133,7,1,6,2,1
30,134,134,5,5,0,1,0
14,148,148,6,2,4,2,1
19,176,176,45,13,32,2,1
4,200,200,16,7,9,2,1
21,204,204,19,19,0,1,0
5,205,205,1,1,0,1,0
20,219,219,18,2,16,3,2
3,229,229,13,5,8,2,1
29,239,239,48,48,0,1,0
16,254,254,98,98,0,1,0
17,282,282,46,46,0,1,0
15,321,321,1,1,0,1,0
12,325,325,26,10,16,3,2
9,325,325,65,65,0,1,0
8,336,336,12,2,10,3,2
0,342,342,6,6,0,1,0
27,354,354,36,36,0,1,0
7,363,363,81,69,12,2,1
28,369,369,23,23,0,1,0
25,376,376,3,3,0,1,0
22,390,390,68,68,0,1,0
10,396,396,6,6,0,1,0
6,432,432,10,1,9,4,3
11,447,447,34,18,16,3,2
26,449,449,25,25,0,1,0
1,461,461,122,67,55,3,2
2,475,475,40,1,39,3,2
18,480,480,3,3,0,1,0
32,481,481,22,5,17,2,1

35,100,100,6,6,0,1,0
37,111,111,6,6,0,1,0
27,124,124,5,2,3,2,1
29,125,125,24,6,18,3,2
5,150,150,6,6,0,1,0
34,150,150,30,2,28,3,2
0,163,163,12,12,0,1,0
42,174,174,1,1,0,1,0
44,189,189,7,7,0,1,0
32,190,190,1,1,0,1,0
13,197,197,9,1,8,2,1
10,200,200,14,11,3,2,1
30,208,208,22,4,18,4,3
23,214,214,2,2,0,1,0
20,233,233,13,1,12,2,1
6,237,237,1,1,0,1,0
17,241,241,5,5,0,1,0
21,243,243,8,4,4,2,1
1,249,249,23,5,18,4,3
9,249,249,37,37,0,1,0
43,271,271,109,91,18,2,1
3,280,280,57,57,0,1,0
19,293,293,28,28,0,1,0
22,295,295,4,4,0,1,0
39,297,297,2,2,0,1,0
28,302,302,1,1,0,1,0
18,304,304,23,7,16,3,2
12,304,304,9,9,0,1,0
31,314,314,14,14,0,1,0
16,315,315,1,1,0,1,0
7,328,328,10,3,7,2,1
8,333,333,6,2,4,2,1
26,348,348,2,2,0,1,0
14,369,369,7,3,4,2,1
38,370,370,39,39,0,1,0
36,374,374,7,7,0,1,0
24,440,440,1,1,0,1,0
15,453,453,164,65,99,4,3
2,464,464,1,1,0,1,0
11,474,474,17,5,12,4,3
41,478,478,59,21,38,4,3
40,485,485,14,14,0,1,0
33,489,489,119,84,35,4,3
25,500,500,9,9,0,1,0
4,500,500,25,7,18,3,2

1,117,117,22,22,0,1,0
9,125,125,2,2,0,1,0
16,132,132,6,6,0,1,0
22,144,144,2,2,0,1,0
11,168,168,32,32,0,1,0
12,177,177,21,21,0,1,0
8,181,181,1,1,0,1,0
24,187,187,22,6,16,2,1
14,188,188,9,9,0,1,0
4,192,192,10,2,8,3,2
26,202,202,106,106,0,1,0
29,207,207,16,16,0,1,0
27,215,215,16,16,0,1,0
25,225,225,12,7,5,2,1
10,233,233,42,42,0,1,0
28,284,284,58,17,41,2,1
6,285,285,1,1,0,1,0
2,289,289,4,4,0,1,0
15,299,299,10,10,0,1,0
13,306,306,7,7,0,1,0
32,322,322,2,2,0,1,0
21,339,339,10,10,0,1,0
19,339,339,16,10,6,2,1
20,354,354,36,36,0,1,0
0,382,382,12,9,3,2,1
17,400,400,25,25,0,1,0
30,402,402,9,9,0,1,0
5,408,408,110,110,0,1,0
31,417,417,47,47,0,1,0
3,457,457,100,38,62,3,2
23,469,469,52,52,0,1,0
7,484,484,81,72,9,4,3
18,494,494,33,14,19,3,2

32,101,101,1,1,0,1,0
25,102,102,4,4,0,1,0
4,113,113,26,22,4,2,1
18,120,120,5,5,0,1,0
8,140,140,11,11,0,1,0
35,143,143,10,10,0,1,0
1,151,151,33,3,30,3,2
14,159,159,33,30,3,2,1
13,160,160,10,10,0,1,0
7,183,183,12,12,0,1,0
3,209,209,10,2,8,2,1
6,212,212,13,13,0,1,0
5,234,234,5,2,3,2,1
0,244,244,2,2,0,1,0
28,246,246,15,15,0,1,0
36,267,267,5,5,0,1,0
26,278,278,103,31,72,3,2
19,278,278,19,1,18,2,1
24,282,282,53,12,41,2,1
34,299,299,2,2,0,1,0
17,312,312,10,10,0,1,0
33,319,319,32,7,25,2,1
10,323,323,2,2,0,1,0
15,336,336,29,8,21,2,1
22,371,371,1,1,0,1,0
12,391,391,3,3,0,1,0
11,396,396,42,7,35,2,1
31,396,396,74,74,0,1,0
29,404,404,18,18,0,1,0
2,412,412,23,8,15,2,1
16,442,442,22,5,17,4,3
23,446,446,39,39,0,1,0
9,465,465,28,13,15,2,1
20,465,465,40,40,0,1,0
21,469,469,71,71,0,1,0
27,487,487,89,53,36,4,3
30,492,492,55,55,0,1,0

6,102,102,17,12,5,2,1
14,108,108,1,1,0,1,0
26,121,121,12,12,0,1,0
5,126,126,10,10,0,1,0
11,127,127,9,9,0,1,0
10,138,138,4,4,0,1,0
8,146,146,15,3,12,4,3
1,175,175,5,5,0,1,0
32,208,208,22,22,0,1,0
2,209,209,9,9,0,1,0
22,220,220,9,9,0,1,0
29,221,221,7,1,6,2,1
30,240,240,41,5,36,2,1
31,247,247,3,3,0,1,0
16,256,256,3,3,0,1,0
20,270,270,61,61,0,1,0
23,283,283,20,20,0,1,0
36,284,284,2,2,0,1,0
34,289,289,12,6,6,3,2
0,302,302,1,1,0,1,0
7,315,315,49,1,48,2,1
28,317,317,15,7,8,2,1
13,345,345,49,3,46,2,1
12,368,368,35,4,31,2,1
3,378,378,2,2,0,1,0
18,394,394,30,30,0,1,0
15,416,416,15,15,0,1,0
27,425,425,14,14,0,1,0
24,426,426,7,7,0,1,0
17,434,434,97,23,74,3,2
21,434,434,103,103,0,1,0
19,439,439,22,22,0,1,0
33,477,477,56,56,0,1,0
4,477,477,21,21,0,1,0
9,478,478,1,1,0,1,0
25,483,483,242,128,114,4,3
35,484,484,50,22,28,3,2

8,118,118,33,33,0,1,0
19,131,131,51,30,21,4,3
9,132,132,1,1,0,1,0
20,137,137,5,5,0,1,0
4,140,140,3,3,0,1,0
6,187,187,3,3,0,1,0
23,192,192,25,25,0,1,0
28,195,195,25,6,19,2,1
15,228,228,1,1,0,1,0
12,246,246,7,7,0,1,0
24,272,272,42,18,24,4,3
29,292,292,61,61,0,1,0
2,301,301,91,79,12,4,3
27,305,305,18,18,0,1,0
30,312,312,36,36,0,1,0
22,316,316,1,1,0,1,0
26,325,325,15,15,0,1,0
5,329,329,41,41,0,1,0
13,346,346,12,12,0,1,0
25,351,351,58,7,51,4,3
7,363,363,28,28,0,1,0
10,387,387,52,52,0,1,0
17,404,404,20,20,0,1,0
16,428,428,37,17,20,3,2
11,430,430,15,15,0,1,0
0,459,459,30,30,0,1,0
1,466,466,144,90,54,4,3
21,476,476,1,1,0,1,0
18,478,478,24,24,0,1,0
3,481,481,14,6,8,3,2
14,495,495,67,17,50,3,2

17,111,111,15,7,8,2,1
1,121,121,59,44,15,4,3
21,124,124,13,9,4,2,1
29,136,136,64,40,24,4,3
22,146,146,17,17,0,1,0
28,156,156,10,10,0,1,0
31,180,180,13,7,6,2,1
26,182,182,25,25,0,1,0
18,186,186,11,11,0,1,0
23,196,196,8,1,7,2,1
9,199,199,1,1,0,1,0
12,212,212,4,1,3,2,1
6,234,234,37,31,6,2,1
5,252,252,29,29,0,1,0
15,276,276,19,1,18,2,1
3,279,279,43,43,0,1,0
8,293,293,16,9,7,2,1
27,310,310,9,2,7,2,1
2,315,315,8,8,0,1,0
25,326,326,13,13,0,1,0
11,335,335,59,37,22,2,1
24,343,343,66,30,36,4,3
19,358,358,18,18,0,1,0
10,367,367,6,6,0,1,0
30,373,373,8,8,0,1,0
14,414,414,13,3,10,3,2
16,427,427,21,21,0,1,0
0,451,451,14,2,12,4,3
4,460,460,27,23,4,2,1
13,495,495,74,33,41,2,1
20,498,498,31,16,15,2,1
7,498,498,25,16,9,4,3

6,102,102,5,5,0,1,0
22,112,112,15,10,5,2,1
16,118,118,12,12,0,1,0
15,127,127,12,6,6,2,1
31,160,160,4,4,0,1,0
29,180,180,48,48,0,1,0
24,222,222,2,2,0,1,0
26,258,258,3,3,0,1,0
38,260,260,20,20,0,1,0
9,264,264,7,1,6,3,2
28,269,269,3,3,0,1,0
20,284,284,17,4,13,2,1
19,299,299,7,7,0,1,0
18,304,304,20,5,15,4,3
10,308,308,46,36,10,3,2
0,308,308,25,8,17,2,1
14,309,309,5,5,0,1,0
8,311,311,16,16,0,1,0
7,313,313,1,1,0,1,0
21,326,326,21,14,7,2,1
25,331,331,62,20,42,4,3
13,333,333,52,8,44,2,1
17,338,338,40,40,0,1,0
4,338,338,46,46,0,1,0
2,343,343,5,5,0,1,0
37,352,352,70,20,50,2,1
30,362,362,68,56,12,4,3
1,362,362,50,50,0,1,0
23,376,376,25,3,22,2,1
34,386,386,7,7,0,1,0
35,405,405,17,8,9,4,3
12,406,406,13,13,0,1,0
36,431,431,92,35,57,4,3
3,453,453,18,9,9,4,3
32,458,458,51,28,23,2,1
11,460,460,7,7,0,1,0
5,478,478,17,2,15,4,3
33,486,486,68,57,11,2,1
27,488,488,30,14,16,2,1

13,115,115,12,12,0,1,0
10,115,115,3,3,0,1,0
31,115,115,4,4,0,1,0
26,117,117,6,3,3,2,1
16,130,130,3,3,0,1,0
37,148,148,15,15,0,1,0
3,148,148,3,3,0,1,0
24,152,152,37,37,0,1,0
0,182,182,8,3,5,2,1
22,192,192,13,5,8,3,2
35,195,195,14,9,5,2,1
36,215,215,1,1,0,1,0
4,215,215,21,21,0,1,0
20,227,227,1,1,0,1,0
33,230,230,27,27,0,1,0
32,244,244,20,20,0,1,0
30,255,255,12,12,0,1,0
18,256,256,58,32,26,3,2
23,290,290,27,15,12,2,1
9,316,316,36,36,0,1,0
25,326,326,44,14,30,2,1
7,343,343,3,3,0,1,0
28,347,347,27,27,0,1,0
29,367,367,42,18,24,3,2
2,373,373,80,62,18,3,2
27,389,389,39,39,0,1,0
34,394,394,114,114,0,1,0
21,400,400,8,2,6,2,1
17,409,409,12,12,0,1,0
19,419,419,24,2,22,2,1
14,422,422,11,11,0,1,0
5,423,423,44,44,0,1,0
12,423,423,1,1,0,1,0
6,428,428,9,9,0,1,0
1,449,449,82,82,0,1,0
11,459,459,65,65,0,1,0
8,481,481,9,9,0,1,0
15,500,500,57,10,47,2,1

2,135,135,17,17,0,1,0
11,141,141,16,1,15,4,3
23,141,141,8,2,6,2,1
15,143,143,7,1,6,3,2
12,144,144,21,9,12,4,3
28,154,154,16,12,4,2,1
7,202,202,3,3,0,1,0
1,216,216,34,34,0,1,0
3,245,245,33,33,0,1,0
14,268,268,52,52,0,1,0
0,277,277,5,1,4,2,1
18,287,287,96,72,24,3,2
19,294,294,6,6,0,1,0
8,302,302,30,30,0,1,0
6,312,312,32,14,18,4,3
29,320,320,3,3,0,1,0
27,337,337,111,111,0,1,0
22,356,356,7,2,5,2,1
26,372,372,67,67,0,1,0
21,382,382,28,14,14,3,2
9,407,407,7,2,5,2,1
30,413,413,48,48,0,1,0
4,415,415,17,8,9,4,3
25,416,416,4,1,3,2,1
17,425,425,28,5,23,2,1
20,430,430,6,6,0,1,0
10,435,435,21,21,0,1,0
5,459,459,169,169,0,1,0
24,466,466,39,7,32,4,3
16,495,495,78,52,26,3,2
13,496,496,11,11,0,1,0

19,107,107,5,2,3,2,1
22,124,124,15,12,3,2,1
11,153,153,27,3,24,3,2
1,155,155,7,7,0,1,0
0,160,160,23,11,12,4,3
16,167,167,22,22,0,1,0
18,174,174,9,5,4,2,1
26,180,180,26,26,0,1,0
4,223,223,17,7,10,2,1
10,223,223,43,37,6,2,1
5,230,230,23,23,0,1,0
30,246,246,7,7,0,1,0
15,259,259,18,15,3,2,1
9,281,281,10,10,0,1,0
13,285,285,16,7,9,4,3
6,288,288,108,105,3,2,1
3,291,291,6,6,0,1,0
23,291,291,22,22,0,1,0
8,312,312,2,2,0,1,0
24,323,323,75,60,15,4,3
17,335,335,86,77,9,2,1
29,343,343,24,24,0,1,0
7,364,364,14,14,0,1,0
2,374,374,100,39,61,3,2
12,381,381,3,3,0,1,0
21,390,390,69,17,52,3,2
28,414,414,5,5,0,1,0
20,455,455,46,46,0,1,0
27,456,456,24,12,12,4,3
14,466,466,28,28,0,1,0
25,484,484,27,27,0,1,0

19,107,107,5,5,0,1,0
16,115,115,18,18,0,1,0
24,119,119,2,2,0,1,0
0,122,122,29,26,3,2,1
26,146,146,12,12,0,1,0
4,156,156,3,3,0,1,0
3,160,160,11,7,4,2,1
15,165,165,25,8,17,2,1
6,173,173,29,29,0,1,0
2,194,194,25,13,12,2,1
9,200,200,25,2,23,2,1
27,203,203,26,26,0,1,0
13,217,217,63,43,20,3,2
25,232,232,38,29,9,4,3
10,246,246,81,9,72,4,3
12,251,251,10,4,6,2,1
23,339,339,14,14,0,1,0
11,372,372,69,4,65,4,3
5,384,384,8,1,7,2,1
7,388,388,52,52,0,1,0
14,394,394,72,72,0,1,0
1,399,399,27,27,0,1,0
18,404,404,16,4,12,3,2
8,417,417,49,49,0,1,0
22,439,439,71,11,60,4,3
17,456,456,11,11,0,1,0
20,466,466,24,24,0,1,0
21,500,500,29,1,28,2,1

30,116,116,12,12,0,1,0
0,118,118,31,3,28,2,1
27,122,122,24,24,0,1,0
26,127,127,4,4,0,1,0
29,141,141,16,16,0,1,0
31,149,149,16,8,8,3,2
21,165,165,29,29,0,1,0
22,178,178,3,3,0,1,0
10,185,185,9,4,5,2,1
32,190,190,57,14,43,4,3
18,195,195,15,15,0,1,0
11,201,201,52,2,50,3,2
3,214,214,1,1,0,1,0
9,232,232,52,52,0,1,0
5,237,237,46,36,10,2,1
12,252,252,16,13,3,2,1
23,268,268,2,2,0,1,0
15,282,282,1,1,0,1,0
7,287,287,1,1,0,1,0
20,353,353,59,3,56,3,2
1,357,357,5,5,0,1,0
6,357,357,49,49,0,1,0
13,374,374,1,1,0,1,0
8,380,380,12,4,8,2,1
24,382,382,56,13,43,2,1
14,385,385,16,10,6,3,2
19,405,405,16,9,7,2,1
25,414,414,15,15,0,1,0
17,425,425,8,8,0,1,0
28,427,427,48,32,16,3,2
4,437,437,62,38,24,3,2
2,444,444,56,23,33,3,2
16,478,478,20,20,0,1,0

2,136,136,12,12,0,1,0
24,140,140,17,8,9,2,1
13,160,160,12,4,8,2,1
27,169,169,11,6,5,2,1
6,179,179,4,1,3,2,1
22,188,188,5,5,0,1,0
20,198,198,28,16,12,2,1
19,209,209,3,3,0,1,0
15,213,213,4,4,0,1,0
21,222,222,2,2,0,1,0
28,236,236,32,5,27,2,1
18,254,254,27,27,0,1,0
4,286,286,10,10,0,1,0
26,291,291,14,7,7,2,1
32,295,295,46,46,0,1,0
16,306,306,211,98,113,4,3
0,319,319,20,6,14,4,3
9,321,321,5,5,0,1,0
3,323,323,8,8,0,1,0
10,324,324,9,1,8,2,1
8,337,337,1,1,0,1,0
25,337,337,21,21,0,1,0
5,371,371,5,5,0,1,0
30,374,374,49,49,0,1,0
12,388,388,50,1,49,2,1
11,403,403,20,2,18,2,1
7,408,408,7,2,5,2,1
14,417,417,10,10,0,1,0
29,432,432,21,10,11,4,3
31,445,445,16,16,0,1,0
23,451,451,134,40,94,3,2
33,470,470,70,70,0,1,0
1,470,470,38,7,31,2,1
17,485,485,58,51,7,2,1
34,493,493,92,6,86,4,3

30,109,109,16,5,11,2,1
18,127,127,30,30,0,1,0
31,136,136,37,16,21,4,3
26,139,139,5,2,3,2,1
11,146,146,8,3,5,2,1
8,183,183,15,3,12,3,2
2,185,185,16,4,12,3,2
10,190,190,1,1,0,1,0
14,193,193,2,2,0,1,0
6,198,198,6,6,0,1,0
3,199,199,15,15,0,1,0
20,223,223,6,2,4,2,1
17,232,232,22,22,0,1,0
34,244,244,7,7,0,1,0
24,264,264,23,7,16,2,1
0,291,291,15,5,10,2,1
21,298,298,32,32,0,1,0
9,298,298,30,27,3,2,1
25,302,302,1,1,0,1,0
23,344,344,103,88,15,2,1
27,357,357,73,73,0,1,0
22,358,358,55,55,0,1,0
4,372,372,23,23,0,1,0
15,375,375,10,10,0,1,0
32,393,393,14,14,0,1,0
12,408,408,26,14,12,4,3
13,415,415,5,1,4,2,1
28,415,415,58,14,44,2,1
16,444,444,149,149,0,1,0
7,453,453,40,40,0,1,0
5,460,460,36,36,0,1,0
33,460,460,9,4,5,2,1
1,473,473,53,53,0,1,0
29,475,475,30,7,23,2,1
19,484,484,2,2,0,1,0

8,100,100,2,2,0,1,0
6,112,112,17,8,9,2,1
32,118,118,12,1,11,2,1
14,121,121,4,4,0,1,0
24,128,128,5,5,0,1,0
3,144,144,1,1,0,1,0
15,163,163,2,2,0,1,0
34,163,163,104,1,103,4,3
10,186,186,23,11,12,3,2
23,205,205,3,3,0,1,0
0,211,211,4,4,0,1,0
29,236,236,1,1,0,1,0
37,250,250,6,2,4,2,1
27,251,251,8,3,5,2,1
4,263,263,37,37,0,1,0
28,296,296,29,29,0,1,0
11,304,304,41,9,32,3,2
5,326,326,50,50,0,1,0
12,327,327,4,4,0,1,0
21,329,329,3,3,0,1,0
16,337,337,16,16,0,1,0
30,366,366,13,13,0,1,0
1,372,372,5,5,0,1,0
26,375,375,44,44,0,1,0
20,382,382,57,57,0,1,0
2,387,387,9,9,0,1,0
19,399,399,25,2,23,2,1
25,400,400,87,87,0,1,0
35,402,402,47,17,30,2,1
22,404,404,2,2,0,1,0
17,406,406,14,5,9,4,3
36,413,413,1,1,0,1,0
31,427,427,52,52,0,1,0
33,437,437,23,23,0,1,0
9,453,453,1,1,0,1,0
7,454,454,35,23,12,4,3
18,482,482,62,36,26,2,1
13,490,490,121,92,29,4,3

8,125,125,29,29,0,1,0
2,137,137,16,6,10,3,2
26,139,139,15,10,5,2,1
7,148,148,8,8,0,1,0
21,177,177,10,10,0,1,0
25,207,207,18,18,0,1,0
4,215,215,15,3,12,4,3
10,216,216,9,3,6,2,1
12,217,217,26,26,0,1,0
31,234,234,6,6,0,1,0
19,244,244,29,1,28,4,3
30,248,248,6,6,0,1,0
24,251,251,11,11,0,1,0
1,257,257,7,3,4,2,1
18,260,260,4,1,3,2,1
9,264,264,2,2,0,1,0
16,272,272,19,9,10,3,2
15,273,273,30,18,12,3,2
22,277,277,3,3,0,1,0
27,279,279,76,76,0,1,0
13,286,286,53,53,0,1,0
6,326,326,58,16,42,3,2
32,327,327,12,6,6,3,2
20,327,327,9,9,0,1,0
5,344,344,28,28,0,1,0
17,350,350,48,43,5,2,1
29,352,352,12,12,0,1,0
0,356,356,42,42,0,1,0
11,368,368,11,1,10,3,2
28,395,395,39,39,0,1,0
23,463,463,247,247,0,1,0
14,490,490,21,21,0,1,0
3,491,491,58,58,0,1,0

13,105,105,11,11,0,1,0
2,124,124,5,5,0,1,0
25,124,124,33,33,0,1,0
1,131,131,1,1,0,1,0
5,144,144,33,1,32,3,2
4,146,146,2,2,0,1,0
29,155,155,6,1,5,2,1
6,166,166,28,28,0,1,0
15,173,173,37,37,0,1,0
33,187,187,7,1,6,2,1
16,216,216,10,2,8,2,1
14,218,218,2,2,0,1,0
22,236,236,20,20,0,1,0
21,245,245,3,3,0,1,0
17,259,259,18,18,0,1,0
20,267,267,17,10,7,2,1
9,302,302,18,15,3,2,1
26,307,307,43,33,10,3,2
0,319,319,83,83,0,1,0
3,320,320,9,9,0,1,0
32,324,324,66,66,0,1,0
23,325,325,91,91,0,1,0
27,326,326,6,1,5,2,1
19,337,337,78,60,18,3,2
11,342,342,12,6,6,3,2
7,345,345,20,14,6,2,1
18,388,388,16,16,0,1,0
28,410,410,16,1,15,2,1
8,430,430,1,1,0,1,0
10,431,431,37,37,0,1,0
24,441,441,15,15,0,1,0
30,482,482,38,38,0,1,0
12,487,487,83,18,65,4,3
31,492,492,31,23,8,2,1

25,104,104,11,11,0,1,0
17,105,105,20,20,0,1,0
7,125,125,3,3,0,1,0
33,128,128,8,8,0,1,0
15,128,128,16,16,0,1,0
21,148,148,4,4,0,1,0
11,171,171,6,6,0,1,0
19,174,174,8,4,4,2,1
4,188,188,5,5,0,1,0
26,223,223,16,4,12,2,1
2,224,224,54,2,52,3,2
24,233,233,2,2,0,1,0
29,250,250,33,2,31,2,1
28,260,260,33,21,12,3,2
27,263,263,90,90,0,1,0
8,268,268,17,17,0,1,0
16,283,283,1,1,0,1,0
31,286,286,16,2,14,2,1
12,288,288,17,17,0,1,0
32,336,336,38,38,0,1,0
20,339,339,12,5,7,2,1
0,343,343,2,2,0,1,0
10,344,344,37,13,24,2,1
1,369,369,102,102,0,1,0
23,371,371,64,64,0,1,0
3,389,389,50,22,28,2,1
30,390,390,4,4,0,1,0
9,393,393,58,26,32,4,3
5,423,423,22,1,21,4,3
6,432,432,4,4,0,1,0
13,433,433,33,6,27,4,3
22,438,438,106,106,0,1,0
14,443,443,13,3,10,2,1
18,448,448,34,2,32,2,1

14,112,112,19,10,9,4,3
8,129,129,28,4,24,2,1
18,134,134,4,4,0,1,0
20,138,138,13,1,12,4,3
22,182,182,10,10,0,1,0
4,204,204,32,1,31,4,3
27,214,214,5,5,0,1,0
2,218,218,57,57,0,1,0
10,234,234,1,1,0,1,0
24,249,249,1,1,0,1,0
30,256,256,22,15,7,2,1
9,257,257,5,2,3,2,1
12,257,257,10,10,0,1,0
7,268,268,1,1,0,1,0
6,281,281,69,69,0,1,0
26,282,282,15,11,4,2,1
21,291,291,130,114,16,2,1
1,320,320,30,30,0,1,0
5,336,336,40,40,0,1,0
13,349,349,35,35,0,1,0
0,351,351,43,39,4,2,1
17,365,365,71,26,45,4,3
11,365,365,13,5,8,2,1
3,394,394,6,6,0,1,0
25,433,433,14,2,12,3,2
15,436,436,21,21,0,1,0
16,452,452,42,27,15,4,3
29,455,455,45,45,0,1,0
19,476,476,23,16,7,2,1
23,484,484,79,11,68,4,3
28,488,488,80,2,78,3,2

29,120,120,17,17,0,1,0
11,120,120,32,32,0,1,0
5,136,136,10,10,0,1,0
26,153,153,23,17,6,2,1
3,159,159,1,1,0,1,0
21,203,203,18,18,0,1,0
27,206,206,16,16,0,1,0
18,219,219,3,3,0,1,0
7,252,252,6,6,0,1,0
23,256,256,25,6,19,2,1
16,288,288,5,5,0,1,0
28,298,298,123,123,0,1,0
12,313,313,28,28,0,1,0
19,317,317,3,3,0,1,0
2,319,319,11,11,0,1,0
8,325,325,1,1,0,1,0
22,345,345,15,8,7,2,1
15,355,355,9,3,6,2,1
10,369,369,46,28,18,2,1
4,370,370,20,6,14,2,1
13,377,377,18,2,16,2,1
24,385,385,54,54,0,1,0
6,395,395,148,126,22,3,2
9,396,396,63,63,0,1,0
20,415,415,54,54,0,1,0
1,417,417,69,30,39,4,3
25,427,427,29,29,0,1,0
14,460,460,84,84,0,1,0
0,473,473,84,34,50,2,1
17,499,499,13,13,0,1,0

21,114,114,15,1,14,3,2
34,131,131,4,1,3,2,1
1,133,133,1,1,0,1,0
25,141,141,1,1,0,1,0
5,149,149,2,2,0,1,0
26,161,161,17,17,0,1,0
16,173,173,50,21,29,2,1
13,184,184,14,14,0,1,0
29,186,186,3,3,0,1,0
0,198,198,30,30,0,1,0
28,198,198,3,3,0,1,0
9,234,234,8,8,0,1,0
32,236,236,16,16,0,1,0
12,240,240,24,24,0,1,0
35,241,241,51,51,0,1,0
7,243,243,65,50,15,4,3
15,261,261,12,12,0,1,0
20,276,276,11,5,6,3,2
27,282,282,17,17,0,1,0
3,305,305,46,7,39,2,1
17,312,312,8,2,6,3,2
14,337,337,20,20,0,1,0
6,344,344,16,12,4,2,1
31,354,354,51,51,0,1,0
22,356,356,3,3,0,1,0
2,367,367,1,1,0,1,0
11,396,396,26,26,0,1,0
30,417,417,14,14,0,1,0
36,424,424,36,36,0,1,0
23,427,427,24,4,20,2,1
18,434,434,14,7,7,3,2
24,436,436,232,232,0,1,0
10,451,451,2,2,0,1,0
8,455,455,43,43,0,1,0
33,458,458,61,47,14,2,1
19,483,483,44,44,0,1,0
4,486,486,1,1,0,1,0

11,113,113,1,1,0,1,0
2,115,115,7,7,0,1,0
0,118,118,16,16,0,1,0
27,119,119,10,10,0,1,0
26,123,123,27,3,24,3,2
32,127,127,31,31,0,1,0
9,131,131,2,2,0,1,0
33,134,134,38,13,25,2,1
24,152,152,7,7,0,1,0
29,158,158,12,3,9,2,1
28,173,173,6,6,0,1,0
10,179,179,1,1,0,1,0
8,225,225,2,2,0,1,0
30,226,226,42,42,0,1,0
16,234,234,32,26,6,2,1
21,246,246,12,3,9,4,3
15,253,253,90,80,10,3,2
6,258,258,42,3,39,4,3
17,280,280,49,49,0,1,0
5,289,289,15,15,0,1,0
14,298,298,8,8,0,1,0
19,316,316,33,33,0,1,0
12,322,322,40,40,0,1,0
3,326,326,48,6,42,2,1
18,331,331,5,5,0,1,0
22,362,362,12,12,0,1,0
1,374,374,13,13,0,1,0
13,381,381,28,1,27,2,1
31,414,414,2,2,0,1,0
23,432,432,70,28,42,3,2
20,443,443,38,38,0,1,0
4,468,468,32,12,20,2,1
25,486,486,6,6,0,1,0
7,490,490,5,5,0,1,0

4,115,115,2,2,0,1,0
21,127,127,9,9,0,1,0
29,128,128,11,8,3,2,1
9,218,218,3,3,0,1,0
3,223,223,12,12,0,1,0
13,251,251,33,33,0,1,0
10,253,253,36,36,0,1,0
1,254,254,88,31,57,4,3
28,256,256,5,5,0,1,0
11,257,257,49,49,0,1,0
2,261,261,18,9,9,4,3
17,261,261,28,16,12,2,1
0,300,300,53,23,30,3,2
5,300,300,63,63,0,1,0
25,308,308,28,28,0,1,0
20,314,314,27,9,18,3,2
6,315,315,3,3,0,1,0
15,346,346,16,8,8,3,2
26,362,362,18,3,15,4,3
8,368,368,5,5,0,1,0
16,390,390,32,25,7,2,1
30,404,404,7,3,4,2,1
22,406,406,17,3,14,3,2
27,419,419,39,39,0,1,0
31,421,421,88,2,86,3,2
14,425,425,50,34,16,2,1
24,426,426,37,7,30,3,2
12,448,448,15,1,14,2,1
19,452,452,119,41,78,3,2
18,453,453,54,23,31,2,1
23,491,491,101,22,79,4,3
7,497,497,14,9,5,2,1

33,110,110,35,32,3,2,1
6,133,133,26,2,24,4,3
21,139,139,17,17,0,1,0
34,142,142,27,27,0,1,0
16,175,175,1,1,0,1,0
31,188,188,8,8,0,1,0
3,202,202,1,1,0,1,0
22,208,208,43,43,0,1,0
23,246,246,7,3,4,2,1
30,254,254,8,8,0,1,0
25,254,254,27,1,26,2,1
15,262,262,29,29,0,1,0
17,297,297,56,41,15,4,3
24,311,311,13,13,0,1,0
29,313,313,12,3,9,4,3
26,321,321,54,38,16,2,1
7,329,329,18,18,0,1,0
9,336,336,5,5,0,1,0
4,341,341,1,1,0,1,0
0,343,343,41,41,0,1,0
18,370,370,31,3,28,3,2
20,376,376,60,60,0,1,0
13,377,377,67,67,0,1,0
5,381,381,4,4,0,1,0
19,393,393,1,1,0,1,0
27,402,402,42,42,0,1,0
35,406,406,20,20,0,1,0
28,411,411,38,38,0,1,0
2,413,413,31,31,0,1,0
36,414,414,34,13,21,4,3
8,434,434,63,44,19,2,1
12,451,451,43,43,0,1,0
32,457,457,3,3,0,1,0
11,466,466,28,28,0,1,0
1,476,476,28,20,8,3,2
14,481,481,14,8,6,3,2
10,486,486,3,3,0,1,0

4,105,105,17,17,0,1,0
3,109,109,3,3,0,1,0
17,112,112,2,2,0,1,0
7,149,149,31,1,30,3,2
13,150,150,19,19,0,1,0
10,164,164,11,11,0,1,0
9,171,171,10,2,8,3,2
20,184,184,6,6,0,1,0
21,194,194,100,100,0,1,0
11,198,198,6,1,5,2,1
0,226,226,9,9,0,1,0
30,250,250,1,1,0,1,0
22,299,299,39,17,22,3,2
26,314,314,10,10,0,1,0
25,327,327,78,33,45,4,3
31,327,327,13,13,0,1,0
12,335,335,13,1,12,3,2
27,343,343,34,14,20,3,2
15,345,345,1,1,0,1,0
2,352,352,32,2,30,4,3
16,368,368,26,21,5,2,1
18,371,371,24,8,16,2,1
1,378,378,84,2,82,3,2
32,401,401,23,3,20,3,2
23,402,402,25,5,20,3,2
24,411,411,82,64,18,3,2
14,426,426,18,5,13,2,1
29,429,429,35,20,15,4,3
8,434,434,83,65,18,4,3
6,435,435,19,19,0,1,0
19,438,438,15,15,0,1,0
28,466,466,12,9,3,2,1
5,497,497,89,39,50,4,3

2,106,106,9,2,7,2,1
8,109,109,22,22,0,1,0
7,139,139,1,1,0,1,0
19,161,161,7,3,4,2,1
13,162,162,3,3,0,1,0
3,166,166,2,2,0,1,0
1,196,196,8,8,0,1,0
16,201,201,1,1,0,1,0
18,203,203,16,8,8,2,1
25,213,213,37,7,30,3,2
6,220,220,13,5,8,3,2
15,225,225,3,3,0,1,0
0,232,232,72,42,30,2,1
24,247,247,52,30,22,2,1
14,274,274,11,11,0,1,0
20,279,279,116,43,73,3,2
23,293,293,4,4,0,1,0
21,315,315,27,27,0,1,0
12,346,346,64,64,0,1,0
5,349,349,161,158,3,2,1
4,367,367,102,102,0,1,0
10,382,382,44,44,0,1,0
26,407,407,19,19,0,1,0
9,418,418,13,6,7,2,1
11,422,422,21,21,0,1,0
17,429,429,80,22,58,3,2
22,441,441,32,32,0,1,0

21,107,107,9,1,8,3,2
13,109,109,8,8,0,1,0
38,120,120,4,4,0,1,0
0,121,121,1,1,0,1,0
6,139,139,1,1,0,1,0
18,140,140,3,3,0,1,0
34,143,143,6,6,0,1,0
39,146,146,15,9,6,3,2
28,152,152,13,13,0,1,0
7,152,152,3,3,0,1,0
3,185,185,32,10,22,3,2
25,189,189,25,25,0,1,0
24,189,189,10,2,8,3,2
35,200,200,14,8,6,2,1
4,212,212,3,3,0,1,0
37,223,223,54,29,25,2,1
10,230,230,1,1,0,1,0
42,235,235,4,4,0,1,0
22,255,255,6,3,3,2,1
20,261,261,48,23,25,2,1
26,315,315,37,14,23,2,1
2,317,317,8,8,0,1,0
40,325,325,18,18,0,1,0
17,326,326,12,12,0,1,0
31,330,330,19,19,0,1,0
9,335,335,1,1,0,1,0
32,336,336,31,31,0,1,0
33,344,344,17,14,3,2,1
19,373,373,22,22,0,1,0
36,399,399,68,68,0,1,0
29,406,406,48,48,0,1,0
8,409,409,8,5,3,2,1
12,425,425,36,12,24,2,1
27,426,426,83,83,0,1,0
14,427,427,29,29,0,1,0
23,431,431,23,2,21,4,3
11,443,443,37,37,0,1,0
30,453,453,73,25,48,3,2
15,456,456,21,7,14,3,2
41,457,457,66,66,0,1,0
16,483,483,46,46,0,1,0
1,491,491,3,3,0,1,0
5,494,494,52,31,21,4,3

12,122,122,9,3,6,3,2
25,139,139,1,1,0,1,0
23,155,155,3,3,0,1,0
4,160,160,2,2,0,1,0
27,168,168,11,11,0,1,0
21,168,168,37,37,0,1,0
8,170,170,10,1,9,2,1
19,172,172,2,2,0,1,0
3,191,191,17,12,5,2,1
16,207,207,17,17,0,1,0
17,219,219,52,43,9,2,1
13,222,222,47,5,42,2,1
24,257,257,17,9,8,3,2
7,259,259,73,16,57,4,3
15,295,295,8,8,0,1,0
5,296,296,116,68,48,3,2
26,300,300,17,17,0,1,0
14,314,314,14,6,8,2,1
6,318,318,21,2,19,2,1
10,327,327,1,1,0,1,0
9,341,341,142,135,7,2,1
1,363,363,28,28,0,1,0
11,374,374,28,16,12,3,2
18,435,435,47,13,34,3,2
20,454,454,11,11,0,1,0
22,468,468,180,114,66,3,2
0,472,472,5,5,0,1,0
2,490,490,59,12,47,2,1

19,102,102,2,2,0,1,0
27,118,118,7,7,0,1,0
5,120,120,18,10,8,3,2
23,129,129,2,2,0,1,0
21,129,129,36,36,0,1,0
14,144,144,7,4,3,2,1
13,152,152,5,2,3,2,1
30,184,184,15,15,0,1,0
4,225,225,46,46,0,1,0
3,251,251,37,28,9,4,3
20,256,256,30,30,0,1,0
10,284,284,5,5,0,1,0
16,286,286,11,11,0,1,0
25,298,298,55,55,0,1,0
8,302,302,23,23,0,1,0
12,311,311,44,23,21,2,1
29,317,317,35,35,0,1,0
1,337,337,1,1,0,1,0
15,349,349,33,28,5,2,1
24,351,351,29,9,20,3,2
18,355,355,102,102,0,1,0
11,379,379,1,1,0,1,0
26,394,394,17,17,0,1,0
9,394,394,142,119,23,2,1
2,406,406,36,23,13,2,1
28,406,406,49,49,0,1,0
7,410,410,17,8,9,2,1
17,413,413,24,16,8,2,1
22,472,472,17,2,15,4,3
0,473,473,91,55,36,4,3
6,485,485,46,46,0,1,0

20,116,116,2,2,0,1,0
8,140,140,28,14,14,2,1
9,148,148,13,13,0,1,0
30,154,154,5,5,0,1,0
14,160,160,14,14,0,1,0
2,184,184,2,2,0,1,0
23,186,186,6,2,4,2,1
10,197,197,6,2,4,2,1
24,224,224,11,11,0,1,0
27,235,235,28,5,23,2,1
22,240,240,5,2,3,2,1
3,247,247,53,53,0,1,0
16,260,260,4,4,0,1,0
25,268,268,37,37,0,1,0
29,285,285,6,6,0,1,0
28,294,294,174,156,18,2,1
11,299,299,89,5,84,4,3
21,317,317,109,109,0,1,0
26,336,336,19,19,0,1,0
17,338,338,2,2,0,1,0
19,342,342,10,10,0,1,0
5,344,344,2,2,0,1,0
31,359,359,44,44,0,1,0
33,363,363,4,4,0,1,0
13,373,373,7,3,4,2,1
18,377,377,2,2,0,1,0
6,379,379,60,60,0,1,0
0,420,420,36,8,28,3,2
15,428,428,36,36,0,1,0
32,442,442,18,18,0,1,0
1,455,455,3,3,0,1,0
12,473,473,88,73,15,2,1
7,486,486,45,42,3,2,1
4,487,487,7,3,4,2,1

11,131,131,3,3,0,1,0
34,134,134,5,2,3,2,1
17,138,138,16,16,0,1,0
13,156,156,3,3,0,1,0
25,168,168,3,3,0,1,0
21,170,170,7,7,0,1,0
36,177,177,11,3,8,3,2
35,189,189,5,1,4,2,1
7,219,219,16,4,12,2,1
31,223,223,19,19,0,1,0
4,240,240,47,47,0,1,0
37,251,251,44,9,35,4,3
27,281,281,2,2,0,1,0
6,287,287,51,51,0,1,0
24,287,287,10,10,0,1,0
30,293,293,8,8,0,1,0
2,311,311,10,10,0,1,0
33,321,321,117,51,66,3,2
3,324,324,28,3,25,2,1
12,334,334,50,8,42,3,2
8,337,337,5,5,0,1,0
0,340,340,29,29,0,1,0
19,340,340,40,40,0,1,0
28,343,343,82,22,60,4,3
10,384,384,64,64,0,1,0
29,385,385,76,76,0,1,0
20,394,394,3,3,0,1,0
26,397,397,65,65,0,1,0
18,399,399,11,3,8,3,2
9,427,427,16,1,15,2,1
32,444,444,9,9,0,1,0
16,446,446,1,1,0,1,0
14,449,449,45,10,35,2,1
15,453,453,2,2,0,1,0
23,462,462,26,9,17,2,1
5,471,471,58,19,39,2,1
1,498,498,1,1,0,1,0
22,499,499,62,62,0,1,0

10,104,104,2,2,0,1,0
8,159,159,5,5,0,1,0
6,183,183,36,36,0,1,0
4,184,184,20,20,0,1,0
14,207,207,18,8,10,3,2
19,217,217,33,29,4,2,1
1,227,227,35,35,0,1,0
11,229,229,8,5,3,2,1
21,248,248,55,55,0,1,0
17,262,262,10,2,8,2,1
16,284,284,130,85,45,4,3
18,312,312,19,8,11,2,1
20,314,314,18,18,0,1,0
5,355,355,148,44,104,4,3
23,368,368,6,6,0,1,0
22,389,389,16,16,0,1,0
15,403,403,60,24,36,2,1
12,414,414,75,47,28,2,1
13,440,440,5,5,0,1,0
9,453,453,33,21,12,3,2
0,466,466,23,7,16,3,2
7,484,484,16,16,0,1,0
2,492,492,154,106,48,4,3
3,494,494,163,139,24,4,3

19,125,125,17,11,6,2,1
8,130,130,3,3,0,1,0
25,134,134,49,8,41,2,1
21,140,140,2,2,0,1,0
4,143,143,1,1,0,1,0
17,145,145,4,4,0,1,0
18,165,165,4,4,0,1,0
16,182,182,17,3,14,3,2
26,187,187,2,2,0,1,0
20,198,198,1,1,0,1,0
27,218,218,9,4,5,2,1
29,245,245,35,30,5,2,1
28,262,262,38,2,36,2,1
3,265,265,32,16,16,2,1
11,270,270,42,15,27,4,3
22,272,272,15,15,0,1,0
1,283,283,55,17,38,2,1
13,304,304,30,2,28,3,2
7,324,324,45,12,33,4,3
30,327,327,109,84,25,2,1
31,371,371,10,10,0,1,0
2,372,372,118,118,0,1,0
12,373,373,2,2,0,1,0
24,374,374,47,20,27,2,1
5,377,377,7,7,0,1,0
15,401,401,32,4,28,4,3
6,403,403,55,30,25,2,1
0,411,411,48,48,0,1,0
23,416,416,37,37,0,1,0
14,442,442,34,25,9,4,3
10,442,442,14,14,0,1,0
9,464,464,37,37,0,1,0

9,122,122,18,18,0,1,0
11,123,123,14,14,0,1,0
7,135,135,6,6,0,1,0
1,137,137,2,2,0,1,0
33,152,152,6,6,0,1,0
26,156,156,34,34,0,1,0
22,172,172,16,1,15,2,1
25,195,195,2,2,0,1,0
14,242,242,63,63,0,1,0
8,244,244,34,34,0,1,0
0,246,246,1,1,0,1,0
23,246,246,65,36,29,4,3
29,247,247,22,12,10,3,2
13,251,251,65,34,31,2,1
20,252,252,9,3,6,2,1
21,270,270,7,1,6,2,1
24,272,272,19,19,0,1,0
19,309,309,13,13,0,1,0
17,317,317,4,4,0,1,0
15,319,319,4,4,0,1,0
27,339,339,7,7,0,1,0
12,355,355,70,10,60,3,2
16,356,356,2,2,0,1,0
5,368,368,22,8,14,3,2
30,368,368,16,3,13,2,1
6,369,369,64,52,12,3,2
10,379,379,12,2,10,2,1
2,380,380,12,6,6,3,2
4,395,395,26,1,25,2,1
28,402,402,118,118,0,1,0
32,416,416,81,3,78,4,3
18,435,435,74,17,57,4,3
3,491,491,14,14,0,1,0
31,494,494,8,3,5,2,1

22,104,104,3,3,0,1,0
25,110,110,17,17,0,1,0
4,113,113,5,5,0,1,0
38,114,114,49,49,0,1,0
20,115,115,6,6,0,1,0
10,150,150,19,16,3,2,1
9,161,161,14,14,0,1,0
29,168,168,15,5,10,2,1
2,177,177,8,2,6,2,1
8,182,182,20,20,0,1,0
31,187,187,8,5,3,2,1
15,194,194,55,55,0,1,0
14,204,204,25,25,0,1,0
0,210,210,1,1,0,1,0
11,226,226,1,1,0,1,0
23,230,230,5,5,0,1,0
3,239,239,21,7,14,2,1
24,245,245,22,10,12,3,2
13,248,248,8,8,0,1,0
5,257,257,26,26,0,1,0
30,259,259,3,3,0,1,0
12,270,270,3,3,0,1,0
39,270,270,67,25,42,4,3
27,273,273,23,11,12,2,1
36,289,289,16,16,0,1,0
37,295,295,8,8,0,1,0
6,298,298,4,4,0,1,0
28,298,298,12,12,0,1,0
18,335,335,2,2,0,1,0
7,335,335,21,21,0,1,0
33,336,336,10,10,0,1,0
16,387,387,35,10,25,4,3
35,416,416,10,10,0,1,0
26,427,427,8,8,0,1,0
17,444,444,1,1,0,1,0
19,444,444,34,12,22,2,1
1,457,457,26,14,12,3,2
21,460,460,61,4,57,4,3
34,468,468,54,8,46,2,1
32,470,470,78,27,51,4,3

28,105,105,6,6,0,1,0
13,110,110,1,1,0,1,0
21,122,122,16,16,0,1,0
0,130,130,4,4,0,1,0
16,131,131,16,9,7,2,1
3,132,132,42,42,0,1,0
7,145,145,1,1,0,1,0
23,167,167,57,57,0,1,0
1,178,178,10,10,0,1,0
12,190,190,50,28,22,3,2
14,191,191,14,5,9,4,3
17,191,191,6,1,5,2,1
24,230,230,40,40,0,1,0
20,252,252,8,8,0,1,0
30,254,254,12,4,8,3,2
26,300,300,4,4,0,1,0
27,301,301,43,4,39,4,3
15,304,304,14,7,7,2,1
8,304,304,18,18,0,1,0
19,307,307,80,80,0,1,0
22,353,353,9,1,8,3,2
6,357,357,59,56,3,2,1
18,362,362,23,15,8,3,2
29,365,365,48,48,0,1,0
5,387,387,10,2,8,3,2
25,424,424,7,7,0,1,0
2,427,427,127,77,50,3,2
9,445,445,34,34,0,1,0
10,459,459,19,10,9,4,3
4,478,478,30,30,0,1,0
11,487,487,58,58,0,1,0

36,107,107,13,7,6,3,2
3,113,113,10,10,0,1,0
29,113,113,17,17,0,1,0
30,128,128,2,2,0,1,0
24,160,160,6,3,3,2,1
27,167,167,52,37,15,4,3
16,182,182,31,4,27,2,1
33,192,192,25,25,0,1,0
13,193,193,8,8,0,1,0
34,193,193,11,11,0,1,0
23,197,197,6,6,0,1,0
14,230,230,20,20,0,1,0
38,232,232,1,1,0,1,0
21,234,234,10,10,0,1,0
7,244,244,5,5,0,1,0
1,250,250,7,7,0,1,0
18,255,255,5,2,3,2,1
9,267,267,61,28,33,2,1
32,277,277,30,30,0,1,0
20,312,312,14,14,0,1,0
31,330,330,2,2,0,1,0
22,335,335,23,23,0,1,0
19,339,339,20,12,8,3,2
11,353,353,59,59,0,1,0
26,361,361,55,40,15,2,1
25,377,377,27,12,15,4,3
37,388,388,121,111,10,3,2
0,395,395,62,1,61,4,3
35,402,402,9,9,0,1,0
12,441,441,8,8,0,1,0
2,455,455,26,13,13,2,1
8,456,456,11,11,0,1,0
6,478,478,46,46,0,1,0
4,479,479,27,12,15,2,1
10,483,483,24,24,0,1,0
17,486,486,24,24,0,1,0
5,488,488,12,1,11,2,1
28,491,491,48,18,30,3,2
15,494,494,1,1,0,1,0

2,101,101,6,6,0,1,0
6,105,105,19,19,0,1,0
14,107,107,5,5,0,1,0
4,108,108,8,8,0,1,0
26,118,118,14,14,0,1,0
3,149,149,41,19,22,3,2
28,169,169,2,2,0,1,0
19,170,170,11,1,10,3,2
10,186,186,21,11,10,2,1
20,219,219,12,5,7,2,1
1,226,226,13,13,0,1,0
15,242,242,18,3,15,2,1
23,247,247,21,21,0,1,0
24,250,250,24,2,22,2,1
7,256,256,25,16,9,4,3
27,272,272,6,6,0,1,0
13,290,290,13,13,0,1,0
9,292,292,46,32,14,3,2
21,305,305,3,3,0,1,0
30,323,323,24,24,0,1,0
0,337,337,37,23,14,3,2
18,365,365,191,191,0,1,0
32,368,368,92,48,44,2,1
31,374,374,22,22,0,1,0
5,389,389,29,14,15,4,3
12,420,420,21,21,0,1,0
29,423,423,29,2,27,4,3
11,428,428,8,2,6,3,2
8,466,466,26,26,0,1,0
25,468,468,24,10,14,3,2
16,477,477,53,3,50,2,1
22,490,490,10,10,0,1,0
17,490,490,63,13,50,4,3

2,110,110,31,17,14,3,2
7,113,113,22,4,18,4,3
6,122,122,12,12,0,1,0
24,155,155,12,12,0,1,0
1,161,161,10,2,8,3,2
27,169,169,53,3,50,3,2
9,174,174,1,1,0,1,0
20,185,185,38,29,9,4,3
15,189,189,13,13,0,1,0
0,192,192,23,23,0,1,0
21,227,227,24,24,0,1,0
16,238,238,26,26,0,1,0
22,253,253,14,2,12,3,2
26,293,293,58,35,23,2,1
4,321,321,14,2,12,2,1
23,336,336,4,4,0,1,0
10,366,366,11,11,0,1,0
17,409,409,43,28,15,4,3
13,411,411,85,85,0,1,0
12,415,415,20,4,16,2,1
28,417,417,3,3,0,1,0
8,422,422,46,46,0,1,0
19,431,431,104,104,0,1,0
18,443,443,6,2,4,2,1
25,443,443,31,6,25,2,1
14,469,469,16,1,15,4,3
29,469,469,6,6,0,1,0
5,474,474,86,70,16,2,1
3,482,482,93,72,21,4,3
11,486,486,13,13,0,1,0

27,104,104,10,10,0,1,0
20,107,107,3,3,0,1,0
2,136,136,3,3,0,1,0
10,144,144,39,2,37,4,3
14,152,152,5,5,0,1,0
1,160,160,14,14,0,1,0
34,169,169,1,1,0,1,0
7,179,179,14,8,6,2,1
5,198,198,1,1,0,1,0
0,212,212,7,7,0,1,0
17,216,216,25,25,0,1,0
15,253,253,43,11,32,3,2
8,272,272,63,63,0,1,0
30,280,280,24,24,0,1,0
31,297,297,111,77,34,2,1
13,299,299,24,4,20,3,2
3,327,327,11,11,0,1,0
12,328,328,60,60,0,1,0
19,338,338,18,4,14,2,1
6,339,339,5,2,3,2,1
29,356,356,11,3,8,3,2
24,362,362,48,1,47,2,1
26,362,362,29,29,0,1,0
4,367,367,9,6,3,2,1
28,392,392,10,1,9,2,1
33,392,392,8,8,0,1,0
16,400,400,13,7,6,2,1
25,406,406,21,6,15,3,2
18,406,406,5,5,0,1,0
21,407,407,12,12,0,1,0
32,407,407,228,228,0,1,0
9,416,416,45,21,24,2,1
11,482,482,31,16,15,4,3
22,482,482,13,13,0,1,0
23,482,482,13,3,10,2,1

1,102,102,3,3,0,1,0
15,128,128,2,2,0,1,0
24,152,152,47,47,0,1,0
14,162,162,38,38,0,1,0
21,170,170,9,9,0,1,0
4,222,222,37,13,24,4,3
27,227,227,24,6,18,2,1
18,227,227,16,16,0,1,0
16,242,242,5,5,0,1,0
25,259,259,11,11,0,1,0
8,270,270,142,40,102,4,3
11,297,297,28,28,0,1,0
0,300,300,17,17,0,1,0
20,301,301,25,25,0,1,0
12,315,315,1,1,0,1,0
6,343,343,6,6,0,1,0
22,344,344,11,11,0,1,0
3,345,345,16,2,14,2,1
5,355,355,1,1,0,1,0
7,375,375,76,30,46,2,1
10,375,375,50,33,17,2,1
28,391,391,15,15,0,1,0
2,392,392,76,42,34,2,1
17,401,401,20,20,0,1,0
23,421,421,47,47,0,1,0
13,444,444,27,27,0,1,0
9,446,446,57,6,51,4,3
26,465,465,48,48,0,1,0
19,469,469,144,98,46,3,2

15,108,108,5,5,0,1,0
38,127,127,2,2,0,1,0
13,133,133,1,1,0,1,0
10,143,143,1,1,0,1,0
18,144,144,3,3,0,1,0
22,166,166,28,28,0,1,0
4,173,173,1,1,0,1,0
39,174,174,6,6,0,1,0
17,179,179,28,18,10,3,2
32,181,181,13,5,8,3,2
37,203,203,10,10,0,1,0
12,215,215,12,3,9,2,1
35,226,226,12,12,0,1,0
9,228,228,62,26,36,2,1
19,229,229,21,2,19,2,1
27,250,250,12,1,11,4,3
25,251,251,45,7,38,4,3
31,290,290,6,6,0,1,0
21,293,293,53,10,43,2,1
36,294,294,27,27,0,1,0
14,295,295,56,6,50,3,2
2,298,298,10,10,0,1,0
5,303,303,16,2,14,2,1
30,335,335,117,113,4,2,1
7,340,340,17,5,12,4,3
6,351,351,1,1,0,1,0
29,370,370,3,3,0,1,0
34,377,377,72,30,42,4,3
26,393,393,31,18,13,2,1
24,404,404,8,8,0,1,0
33,425,425,172,100,72,4,3
16,429,429,3,3,0,1,0
28,434,434,8,8,0,1,0
1,450,450,5,5,0,1,0
23,462,462,22,13,9,4,3
3,470,470,1,1,0,1,0
11,475,475,20,20,0,1,0
8,477,477,20,20,0,1,0
20,491,491,14,8,6,3,2
0,495,495,39,39,0,1,0

12,110,110,57,57,0,1,0
29,124,124,13,13,0,1,0
27,126,126,36,9,27,3,2
2,144,144,14,14,0,1,0
5,147,147,19,19,0,1,0
26,163,163,2,2,0,1,0
8,181,181,6,3,3,2,1
6,211,211,19,19,0,1,0
14,223,223,6,6,0,1,0
9,246,246,13,6,7,2,1
18,258,258,13,13,0,1,0
25,264,264,34,25,9,4,3
24,267,267,2,2,0,1,0
1,275,275,20,5,15,2,1
10,291,291,53,53,0,1,0
17,305,305,23,1,22,3,2
15,306,306,166,92,74,4,3
23,308,308,7,7,0,1,0
4,318,318,37,10,27,4,3
0,328,328,10,7,3,2,1
19,335,335,8,2,6,3,2
3,337,337,12,12,0,1,0
28,375,375,11,11,0,1,0
16,385,385,11,11,0,1,0
21,412,412,73,73,0,1,0
7,435,435,6,1,5,2,1
13,442,442,40,1,39,4,3
22,458,458,19,19,0,1,0
11,471,471,65,17,48,2,1
20,497,497,36,36,0,1,0

6,115,115,5,5,0,1,0
15,122,122,7,7,0,1,0
13,128,128,14,9,5,2,1
19,129,129,2,2,0,1,0
26,136,136,4,4,0,1,0
0,154,154,14,4,10,3,2
18,160,160,32,32,0,1,0
4,203,203,3,3,0,1,0
14,207,207,3,3,0,1,0
28,212,212,76,61,15,4,3
1,213,213,26,19,7,2,1
20,224,224,6,6,0,1,0
12,225,225,20,20,0,1,0
2,232,232,18,18,0,1,0
11,260,260,60,24,36,4,3
17,265,265,22,12,10,2,1
8,269,269,10,2,8,2,1
21,280,280,18,18,0,1,0
24,280,280,95,20,75,4,3
25,288,288,1,1,0,1,0
7,288,288,14,14,0,1,0
10,303,303,48,17,31,2,1
5,324,324,49,6,43,2,1
30,324,324,16,16,0,1,0
27,337,337,22,7,15,2,1
3,357,357,75,75,0,1,0
29,371,371,38,38,0,1,0
16,378,378,13,8,5,2,1
23,441,441,66,66,0,1,0
22,447,447,29,29,0,1,0
9,448,448,92,48,44,4,3

12,143,143,15,15,0,1,0
26,145,145,19,19,0,1,0
7,155,155,84,56,28,2,1
25,161,161,26,26,0,1,0
11,163,163,29,14,15,4,3
14,175,175,12,6,6,2,1
4,192,192,48,18,30,4,3
23,193,193,27,9,18,3,2
18,213,213,23,23,0,1,0
6,254,254,25,1,24,4,3
24,269,269,10,4,6,3,2
17,275,275,12,5,7,2,1
19,282,282,39,14,25,2,1
22,284,284,20,20,0,1,0
15,302,302,20,20,0,1,0
20,318,318,42,42,0,1,0
0,336,336,18,3,15,4,3
16,337,337,36,18,18,3,2
5,363,363,26,26,0,1,0
13,372,372,48,9,39,4,3
3,375,375,10,5,5,2,1
2,379,379,127,127,0,1,0
8,396,396,20,10,10,3,2
9,400,400,4,4,0,1,0
10,433,433,50,50,0,1,0
21,463,463,9,9,0,1,0
1,466,466,22,22,0,1,0

9,119,119,22,19,3,2,1
14,149,149,7,7,0,1,0
18,172,172,6,6,0,1,0
6,202,202,30,2,28,3,2
25,209,209,88,88,0,1,0
1,225,225,33,18,15,4,3
22,232,232,26,20,6,2,1
13,241,241,11,11,0,1,0
11,248,248,3,3,0,1,0
20,253,253,22,19,3,2,1
2,285,285,3,3,0,1,0
28,316,316,38,15,23,2,1
7,325,325,8,8,0,1,0
5,329,329,85,21,64,3,2
12,357,357,29,6,23,2,1
29,363,363,75,75,0,1,0
10,366,366,9,1,8,2,1
32,376,376,10,10,0,1,0
3,384,384,22,22,0,1,0
17,387,387,22,12,10,2,1
19,391,391,6,6,0,1,0
30,395,395,1,1,0,1,0
24,402,402,56,45,11,2,1
15,417,417,1,1,0,1,0
26,439,439,62,62,0,1,0
4,441,441,132,132,0,1,0
23,449,449,1,1,0,1,0
21,456,456,1,1,0,1,0
27,465,465,2,2,0,1,0
31,466,466,107,98,9,4,3
33,470,470,40,40,0,1,0
16,471,471,12,2,10,2,1
8,481,481,34,4,30,3,2
0,486,486,51,12,39,4,3

3,102,102,9,9,0,1,0
6,105,105,1,1,0,1,0
27,107,107,12,12,0,1,0
31,109,109,4,4,0,1,0
25,114,114,14,14,0,1,0
13,118,118,11,11,0,1,0
38,119,119,17,4,13,2,1
7,128,128,5,5,0,1,0
37,132,132,3,3,0,1,0
15,132,132,10,2,8,3,2
32,134,134,20,8,12,3,2
12,136,136,1,1,0,1,0
36,142,142,3,3,0,1,0
8,162,162,1,1,0,1,0
5,171,171,5,5,0,1,0
16,180,180,9,9,0,1,0
23,204,204,25,25,0,1,0
21,210,210,4,4,0,1,0
28,220,220,23,7,16,3,2
20,229,229,11,11,0,1,0
10,229,229,1,1,0,1,0
33,243,243,19,1,18,4,3
11,255,255,72,72,0,1,0
18,270,270,3,3,0,1,0
30,297,297,66,66,0,1,0
34,306,306,56,56,0,1,0
19,307,307,1,1,0,1,0
35,318,318,8,2,6,2,1
17,337,337,4,4,0,1,0
0,348,348,5,5,0,1,0
29,356,356,9,5,4,2,1
14,360,360,4,1,3,2,1
9,372,372,13,13,0,1,0
22,388,388,19,19,0,1,0
4,408,408,93,93,0,1,0
2,410,410,180,150,30,4,3
1,438,438,20,20,0,1,0
26,447,447,77,33,44,3,2
24,467,467,46,19,27,4,3

8,116,116,3,3,0,1,0
18,136,136,8,8,0,1,0
11,138,138,10,10,0,1,0
10,175,175,22,1,21,4,3
1,182,182,19,12,7,2,1
3,189,189,41,21,20,3,2
5,200,200,8,8,0,1,0
31,210,210,43,34,9,2,1
17,212,212,1,1,0,1,0
25,225,225,55,4,51,4,3
26,230,230,1,1,0,1,0
21,231,231,4,4,0,1,0
23,239,239,23,23,0,1,0
29,248,248,7,7,0,1,0
13,253,253,16,16,0,1,0
24,255,255,36,36,0,1,0
2,288,288,38,11,27,4,3
19,292,292,26,26,0,1,0
20,309,309,2,2,0,1,0
12,330,330,3,3,0,1,0
22,337,337,24,6,18,2,1
15,344,344,8,8,0,1,0
30,345,345,21,7,14,2,1
4,381,381,89,71,18,2,1
32,399,399,5,5,0,1,0
28,400,400,40,19,21,2,1
0,406,406,7,7,0,1,0
16,413,413,37,25,12,3,2
27,414,414,51,30,21,3,2
33,419,419,15,15,0,1,0
7,421,421,17,11,6,3,2
14,428,428,40,10,30,3,2
6,473,473,91,91,0,1,0
9,480,480,28,7,21,4,3
34,496,496,192,192,0,1,0

1,115,115,7,4,3,2,1
13,122,122,10,1,9,2,1
18,123,123,28,28,0,1,0
27,150,150,23,23,0,1,0
2,176,176,7,7,0,1,0
0,208,208,17,17,0,1,0
16,211,211,4,4,0,1,0
19,234,234,21,21,0,1,0
15,242,242,11,1,10,3,2
23,259,259,85,64,21,4,3
11,262,262,50,50,0,1,0
8,268,268,209,188,21,4,3
3,289,289,5,5,0,1,0
24,297,297,4,1,3,2,1
6,306,306,28,19,9,4,3
5,312,312,1,1,0,1,0
20,325,325,27,15,12,2,1
4,331,331,23,9,14,3,2
12,353,353,40,4,36,3,2
17,382,382,30,17,13,2,1
7,382,382,19,1,18,4,3
22,407,407,74,68,6,3,2
14,420,420,8,1,7,2,1
21,433,433,32,32,0,1,0
10,469,469,52,24,28,3,2
26,486,486,35,17,18,4,3
25,491,491,23,5,18,4,3
9,492,492,52,52,0,1,0

34,115,115,13,13,0,1,0
9,146,146,10,10,0,1,0
10,151,151,22,22,0,1,0
11,151,151,20,4,16,3,2
23,165,165,41,29,12,4,3
2,173,173,6,6,0,1,0
7,188,188,2,2,0,1,0
1,223,223,12,12,0,1,0
26,226,226,34,34,0,1,0
3,241,241,1,1,0,1,0
25,250,250,13,13,0,1,0
15,254,254,12,4,8,2,1
12,256,256,6,6,0,1,0
18,267,267,39,19,20,2,1
16,277,277,1,1,0,1,0
19,296,296,17,3,14,2,1
30,300,300,20,8,12,4,3
27,302,302,51,51,0,1,0
0,339,339,79,79,0,1,0
24,343,343,39,39,0,1,0
14,344,344,17,17,0,1,0
5,346,346,55,55,0,1,0
29,365,365,32,1,31,3,2
13,365,365,27,27,0,1,0
20,379,379,20,20,0,1,0
22,383,383,18,18,0,1,0
28,387,387,5,5,0,1,0
32,392,392,4,4,0,1,0
17,410,410,63,19,44,3,2
35,412,412,30,30,0,1,0
6,412,412,12,7,5,2,1
21,415,415,18,1,17,2,1
4,425,425,65,65,0,1,0
31,445,445,132,86,46,4,3
33,486,486,45,23,22,3,2
8,499,499,11,11,0,1,0

14,142,142,9,1,8,2,1
10,149,149,16,16,0,1,0
24,157,157,9,1,8,2,1
25,170,170,8,5,3,2,1
12,184,184,17,17,0,1,0
5,187,187,18,18,0,1,0
2,205,205,61,31,30,4,3
13,221,221,17,17,0,1,0
0,222,222,31,31,0,1,0
3,235,235,36,36,0,1,0
19,245,245,101,5,96,4,3
18,282,282,9,9,0,1,0
6,283,283,109,109,0,1,0
4,298,298,57,57,0,1,0
7,326,326,46,46,0,1,0
23,342,342,69,69,0,1,0
22,371,371,1,1,0,1,0
21,374,374,60,60,0,1,0
9,377,377,13,13,0,1,0
16,402,402,56,56,0,1,0
1,420,420,14,8,6,2,1
11,421,421,30,30,0,1,0
15,448,448,4,1,3,2,1
17,449,449,70,70,0,1,0
20,470,470,3,3,0,1,0
8,476,476,61,61,0,1,0

9,132,132,26,16,10,3,2
7,146,146,2,2,0,1,0
26,157,157,22,22,0,1,0
10,164,164,4,4,0,1,0
22,175,175,26,26,0,1,0
27,190,190,34,34,0,1,0
4,191,191,15,15,0,1,0
29,210,210,16,16,0,1,0
23,211,211,50,14,36,3,2
25,227,227,9,3,6,3,2
11,238,238,34,7,27,4,3
8,253,253,5,5,0,1,0
30,256,256,86,86,0,1,0
1,270,270,15,15,0,1,0
3,275,275,1,1,0,1,0
12,284,284,6,6,0,1,0
17,299,299,2,2,0,1,0
15,304,304,4,4,0,1,0
6,309,309,2,2,0,1,0
14,313,313,36,6,30,3,2
28,333,333,37,37,0,1,0
24,345,345,27,15,12,4,3
13,371,371,16,9,7,2,1
0,392,392,75,28,47,3,2
20,392,392,18,18,0,1,0
19,402,402,56,56,0,1,0
2,410,410,175,85,90,4,3
21,416,416,18,11,7,2,1
16,433,433,1,1,0,1,0
18,485,485,18,18,0,1,0
5,497,497,130,95,35,2,1

24,103,103,8,8,0,1,0
10,126,126,13,13,0,1,0
36,127,127,5,5,0,1,0
0,128,128,9,3,6,3,2
32,150,150,22,22,0,1,0
13,158,158,1,1,0,1,0
7,162,162,9,9,0,1,0
34,168,168,2,2,0,1,0
4,182,182,12,3,9,2,1
17,210,210,9,9,0,1,0
21,253,253,110,10,100,3,2
18,256,256,24,13,11,2,1
26,256,256,50,26,24,2,1
29,259,259,7,7,0,1,0
31,262,262,39,39,0,1,0
1,267,267,8,8,0,1,0
19,269,269,22,1,21,2,1
22,277,277,29,23,6,2,1
11,282,282,1,1,0,1,0
25,296,296,4,4,0,1,0
2,303,303,52,52,0,1,0
27,316,316,34,34,0,1,0
5,323,323,14,4,10,3,2
16,342,342,9,9,0,1,0
30,347,347,3,3,0,1,0
23,367,367,45,45,0,1,0
33,382,382,10,2,8,2,1
9,383,383,13,10,3,2,1
6,383,383,46,31,15,2,1
12,388,388,32,25,7,2,1
8,388,388,129,129,0,1,0
20,390,390,9,5,4,2,1
3,399,399,18,2,16,2,1
35,423,423,9,9,0,1,0
14,459,459,36,4,32,3,2
15,468,468,43,43,0,1,0
28,495,495,75,49,26,2,1

17,109,109,7,7,0,1,0
20,113,113,5,5,0,1,0
8,137,137,11,11,0,1,0
18,138,138,51,51,0,1,0
26,151,151,29,29,0,1,0
33,153,153,6,6,0,1,0
30,166,166,19,19,0,1,0
10,181,181,36,36,0,1,0
27,189,189,23,11,12,2,1
1,218,218,20,20,0,1,0
2,230,230,8,8,0,1,0
11,231,231,4,4,0,1,0
19,248,248,15,4,11,2,1
28,268,268,10,5,5,2,1
3,275,275,5,5,0,1,0
25,275,275,27,3,24,3,2
24,294,294,17,17,0,1,0
31,295,295,13,13,0,1,0
9,298,298,7,7,0,1,0
7,344,344,50,50,0,1,0
6,353,353,34,11,23,2,1
23,367,367,39,29,10,2,1
0,371,371,15,10,5,2,1
29,383,383,65,50,15,2,1
21,386,386,29,8,21,4,3
16,392,392,81,81,0,1,0
4,421,421,127,43,84,4,3
14,448,448,24,1,23,4,3
22,458,458,14,2,12,3,2
15,482,482,69,26,43,2,1
12,489,489,33,33,0,1,0
5,491,491,6,6,0,1,0
13,492,492,3,3,0,1,0
32,495,495,37,25,12,3,2

17,114,114,14,14,0,1,0
6,150,150,8,8,0,1,0
10,159,159,10,2,8,2,1
27,171,171,12,8,4,2,1
3,172,172,30,15,15,2,1
16,189,189,2,2,0,1,0
0,202,202,1,1,0,1,0
2,210,210,24,12,12,4,3
24,213,213,18,18,0,1,0
15,217,217,6,6,0,1,0
28,221,221,11,11,0,1,0
9,246,246,80,67,13,2,1
21,264,264,4,1,3,2,1
20,275,275,9,9,0,1,0
4,289,289,38,4,34,2,1
11,295,295,33,33,0,1,0
5,304,304,2,2,0,1,0
13,309,309,8,5,3,2,1
12,324,324,1,1,0,1,0
26,332,332,108,31,77,4,3
7,359,359,140,140,0,1,0
19,370,370,68,68,0,1,0
14,372,372,75,25,50,3,2
22,401,401,33,33,0,1,0
23,424,424,49,4,45,2,1
1,428,428,36,18,18,4,3
25,487,487,76,76,0,1,0
8,496,496,69,19,50,3,2
18,499,499,64,12,52,3,2

20,101,101,14,14,0,1,0
6,128,128,4,4,0,1,0
8,136,136,1,1,0,1,0
30,143,143,5,5,0,1,0
31,145,145,23,23,0,1,0
32,173,173,5,2,3,2,1
21,175,175,4,4,0,1,0
29,175,175,49,49,0,1,0
28,189,189,15,15,0,1,0
10,204,204,26,26,0,1,0
1,225,225,22,9,13,2,1
7,235,235,11,1,10,2,1
2,248,248,9,9,0,1,0
24,249,249,1,1,0,1,0
12,265,265,23,23,0,1,0
16,282,282,2,2,0,1,0
15,293,293,1,1,0,1,0
23,315,315,36,16,20,2,1
18,362,362,70,4,66,3,2
33,388,388,32,17,15,4,3
14,391,391,48,10,38,3,2
0,391,391,38,38,0,1,0
13,394,394,30,4,26,3,2
27,401,401,39,39,0,1,0
3,402,402,66,66,0,1,0
17,408,408,130,82,48,4,3
22,411,411,110,29,81,4,3
11,416,416,18,15,3,2,1
5,426,426,75,75,0,1,0
19,440,440,14,4,10,2,1
9,451,451,16,1,15,2,1
25,463,463,45,37,8,3,2
26,480,480,3,3,0,1,0
4,485,485,60,60,0,1,0

20,109,109,1,1,0,1,0
15,110,110,18,10,8,3,2
30,111,111,3,3,0,1,0
21,117,117,4,4,0,1,0
16,123,123,30,14,16,3,2
25,131,131,37,5,32,4,3
29,172,172,1,1,0,1,0
17,192,192,5,2,3,2,1
14,212,212,22,18,4,2,1
9,226,226,34,7,27,2,1
13,232,232,36,7,29,2,1
4,238,238,30,10,20,3,2
23,261,261,55,22,33,2,1
2,272,272,81,47,34,3,2
27,283,283,16,11,5,2,1
24,285,285,9,9,0,1,0
1,294,294,3,3,0,1,0
19,310,310,60,60,0,1,0
5,322,322,7,7,0,1,0
10,329,329,27,27,0,1,0
28,345,345,10,10,0,1,0
22,345,345,51,51,0,1,0
0,358,358,7,7,0,1,0
3,364,364,31,31,0,1,0
8,410,410,11,11,0,1,0
26,418,418,54,33,21,2,1
11,429,429,34,4,30,4,3
12,437,437,112,112,0,1,0
6,457,457,57,49,8,3,2
7,463,463,30,20,10,2,1
18,472,472,28,1,27,4,3

1,100,100,1,1,0,1,0
22,130,130,24,9,15,2,1
23,161,161,28,28,0,1,0
25,183,183,13,13,0,1,0
11,185,185,6,6,0,1,0
19,201,201,5,5,0,1,0
30,208,208,3,3,0,1,0
12,212,212,42,42,0,1,0
0,221,221,8,8,0,1,0
13,225,225,15,1,14,3,2
20,250,250,11,11,0,1,0
8,257,257,2,2,0,1,0
9,257,257,19,19,0,1,0
18,264,264,11,1,10,3,2
36,265,265,1,1,0,1,0
10,280,280,24,10,14,3,2
24,289,289,16,16,0,1,0
17,291,291,2,2,0,1,0
14,298,298,29,29,0,1,0
15,322,322,48,48,0,1,0
32,322,322,25,25,0,1,0
34,345,345,58,58,0,1,0
16,345,345,26,12,14,2,1
33,365,365,37,37,0,1,0
29,394,394,79,1,78,3,2
4,396,396,49,27,22,3,2
7,404,404,3,3,0,1,0
5,420,420,32,19,13,2,1
35,432,432,24,24,0,1,0
27,437,437,25,10,15,2,1
3,447,447,77,77,0,1,0
31,464,464,53,53,0,1,0
2,465,465,23,23,0,1,0
28,476,476,15,15,0,1,0
21,479,479,151,121,30,3,2
26,490,490,1,1,0,1,0
6,497,497,111,111,0,1,0

31,103,103,4,4,0,1,0
18,142,142,9,9,0,1,0
1,166,166,34,4,30,4,3
29,167,167,9,4,5,2,1
28,184,184,8,8,0,1,0
3,227,227,27,27,0,1,0
25,229,229,13,13,0,1,0
14,237,237,32,20,12,2,1
9,240,240,9,6,3,2,1
21,247,247,8,8,0,1,0
32,263,263,5,1,4,2,1
5,266,266,44,44,0,1,0
24,267,267,41,8,33,2,1
30,272,272,41,1,40,4,3
19,278,278,5,1,4,2,1
33,284,284,6,3,3,2,1
4,311,311,9,4,5,2,1
15,366,366,9,9,0,1,0
0,371,371,4,1,3,2,1
2,375,375,78,78,0,1,0
16,376,376,34,25,9,4,3
6,377,377,38,16,22,2,1
7,383,383,18,3,15,3,2
22,404,404,116,77,39,4,3
20,408,408,17,17,0,1,0
12,426,426,5,1,4,2,1
11,427,427,5,5,0,1,0
10,428,428,6,1,5,2,1
13,458,458,98,41,57,3,2
36,459,459,35,35,0,1,0
8,464,464,14,14,0,1,0
27,469,469,41,29,12,3,2
23,482,482,45,45,0,1,0
17,483,483,12,4,8,3,2
26,489,489,84,84,0,1,0
35,489,489,3,3,0,1,0
34,495,495,164,44,120,4,3

4,107,107,5,5,0,1,0
14,121,121,24,24,0,1,0
22,126,126,5,2,3,2,1
25,127,127,20,20,0,1,0
13,148,148,12,12,0,1,0
17,149,149,27,7,20,3,2
11,167,167,55,55,0,1,0
29,186,186,26,26,0,1,0
20,187,187,4,4,0,1,0
5,189,189,53,32,21,2,1
2,195,195,6,6,0,1,0
3,222,222,7,7,0,1,0
21,224,224,49,49,0,1,0
26,240,240,44,4,40,3,2
28,254,254,39,39,0,1,0
8,275,275,37,22,15,2,1
12,304,304,24,24,0,1,0
27,313,313,1,1,0,1,0
0,316,316,1,1,0,1,0
10,338,338,5,5,0,1,0
9,339,339,5,5,0,1,0
7,356,356,63,36,27,4,3
1,357,357,62,62,0,1,0
19,371,371,32,23,9,4,3
30,382,382,28,2,26,2,1
18,395,395,16,6,10,3,2
6,411,411,3,3,0,1,0
23,428,428,8,2,6,3,2
24,464,464,47,15,32,2,1
15,477,477,35,24,11,2,1
16,484,484,68,2,66,4,3

3,107,107,1,1,0,1,0
14,107,107,14,14,0,1,0
11,120,120,39,39,0,1,0
22,123,123,5,1,4,2,1
27,154,154,9,1,8,3,2
13,159,159,1,1,0,1,0
12,164,164,20,10,10,3,2
23,204,204,37,37,0,1,0
9,215,215,13,13,0,1,0
20,215,215,10,10,0,1,0
7,222,222,4,4,0,1,0
25,222,222,1,1,0,1,0
8,228,228,62,57,5,2,1
4,243,243,43,43,0,1,0
18,267,267,17,17,0,1,0
16,270,270,8,3,5,2,1
0,302,302,23,15,8,2,1
28,303,303,57,3,54,3,2
19,359,359,17,2,15,2,1
2,379,379,19,19,0,1,0
21,408,408,8,2,6,2,1
6,411,411,63,51,12,4,3
29,430,430,20,20,0,1,0
30,470,470,157,152,5,2,1
26,476,476,79,67,12,4,3
15,483,483,16,2,14,3,2
31,485,485,52,52,0,1,0
10,487,487,25,25,0,1,0
1,489,489,54,50,4,2,1
5,494,494,3,3,0,1,0
17,498,498,137,137,0,1,0
24,500,500,8,3,5,2,1

14,101,101,26,5,21,2,1
21,104,104,34,26,8,2,1
27,115,115,11,11,0,1,0
12,115,115,18,4,14,3,2
4,119,119,47,47,0,1,0
7,132,132,17,5,12,4,3
0,141,141,5,5,0,1,0
26,148,148,38,25,13,2,1
11,170,170,49,49,0,1,0
16,179,179,6,6,0,1,0
13,207,207,4,4,0,1,0
9,207,207,5,5,0,1,0
10,214,214,41,5,36,3,2
1,304,304,1,1,0,1,0
3,327,327,2,2,0,1,0
17,328,328,18,1,17,2,1
22,350,350,13,5,8,3,2
20,373,373,79,79,0,1,0
24,374,374,5,5,0,1,0
8,384,384,77,77,0,1,0
15,395,395,34,24,10,2,1
23,431,431,6,6,0,1,0
25,442,442,2,2,0,1,0
19,458,458,1,1,0,1,0
5,471,471,8,8,0,1,0
18,477,477,28,28,0,1,0
6,490,490,145,133,12,4,3
2,500,500,7,7,0,1,0

10,100,100,10,10,0,1,0
26,107,107,1,1,0,1,0
7,125,125,4,4,0,1,0
21,132,132,6,1,5,2,1
17,168,168,5,2,3,2,1
8,175,175,1,1,0,1,0
13,202,202,45,45,0,1,0
4,204,204,36,36,0,1,0
12,209,209,29,29,0,1,0
25,217,217,125,125,0,1,0
2,237,237,4,4,0,1,0
18,240,240,4,4,0,1,0
28,250,250,27,27,0,1,0
6,263,263,62,12,50,3,2
22,266,266,26,26,0,1,0
3,272,272,21,21,0,1,0
11,297,297,16,9,7,2,1
15,304,304,1,1,0,1,0
5,307,307,26,6,20,2,1
9,323,323,37,37,0,1,0
0,339,339,9,3,6,3,2
20,350,350,44,32,12,4,3
29,363,363,10,1,9,4,3
1,370,370,115,67,48,3,2
19,395,395,19,19,0,1,0
30,410,410,87,87,0,1,0
23,432,432,30,14,16,4,3
14,447,447,2,2,0,1,0
27,454,454,44,44,0,1,0
24,488,488,39,39,0,1,0
16,498,498,41,8,33,2,1

4,101,101,1,1,0,1,0
20,114,114,7,7,0,1,0
6,118,118,3,3,0,1,0
29,126,126,17,17,0,1,0
21,128,128,33,33,0,1,0
17,140,140,48,22,26,4,3
31,145,145,3,3,0,1,0
11,150,150,43,22,21,4,3
5,153,153,61,34,27,4,3
2,177,177,5,5,0,1,0
19,181,181,12,2,10,2,1
12,181,181,1,1,0,1,0
18,189,189,34,3,31,2,1
3,195,195,15,15,0,1,0
24,204,204,18,18,0,1,0
13,222,222,22,22,0,1,0
8,270,270,5,2,3,2,1
1,274,274,9,9,0,1,0
9,282,282,33,33,0,1,0
22,296,296,9,4,5,2,1
27,297,297,13,3,10,2,1
10,364,364,48,48,0,1,0
0,366,366,24,24,0,1,0
14,380,380,62,50,12,2,1
7,398,398,29,29,0,1,0
26,399,399,32,32,0,1,0
23,411,411,5,5,0,1,0
15,415,415,29,29,0,1,0
28,449,449,1,1,0,1,0
30,453,453,99,99,0,1,0
16,464,464,4,4,0,1,0
25,494,494,48,48,0,1,0

22,103,103,22,2,20,2,1
30,119,119,14,14,0,1,0
24,150,150,3,3,0,1,0
0,163,163,37,37,0,1,0
20,170,170,14,2,12,4,3
27,174,174,37,15,22,3,2
21,190,190,3,3,0,1,0
3,191,191,13,4,9,4,3
7,191,191,55,41,14,2,1
5,198,198,4,1,3,2,1
6,207,207,18,18,0,1,0
2,207,207,9,9,0,1,0
28,252,252,48,48,0,1,0
8,276,276,47,47,0,1,0
29,294,294,10,3,7,2,1
17,312,312,14,14,0,1,0
23,334,334,35,25,10,2,1
15,338,338,18,18,0,1,0
1,343,343,5,5,0,1,0
19,347,347,11,11,0,1,0
16,357,357,47,47,0,1,0
26,359,359,74,11,63,4,3
14,360,360,39,10,29,2,1
10,382,382,78,6,72,3,2
18,388,388,76,28,48,3,2
31,393,393,10,4,6,3,2
25,408,408,8,4,4,2,1
11,431,431,4,4,0,1,0
9,457,457,7,3,4,2,1
13,474,474,46,46,0,1,0
4,490,490,8,8,0,1,0
12,493,493,88,31,57,4,3

10,103,103,4,1,3,2,1
6,114,114,2,2,0,1,0
19,117,117,6,2,4,2,1
24,125,125,7,7,0,1,0
2,140,140,21,21,0,1,0
12,146,146,15,15,0,1,0
5,163,163,8,8,0,1,0
13,166,166,7,1,6,2,1
8,179,179,35,2,33,2,1
17,200,200,15,1,14,3,2
15,201,201,41,16,25,2,1
14,239,239,10,10,0,1,0
11,293,293,11,11,0,1,0
4,307,307,61,61,0,1,0
9,336,336,7,7,0,1,0
23,353,353,19,19,0,1,0
18,373,373,10,10,0,1,0
7,374,374,59,59,0,1,0
25,398,398,49,49,0,1,0
1,408,408,61,57,4,2,1
20,416,416,43,9,34,2,1
21,422,422,48,48,0,1,0
22,438,438,185,128,57,4,3
3,443,443,62,62,0,1,0
16,468,468,70,8,62,3,2
0,492,492,257,119,138,4,3

23,103,103,11,11,0,1,0
3,117,117,6,2,4,2,1
4,156,156,7,4,3,2,1
26,167,167,12,5,7,2,1
31,169,169,4,1,3,2,1
30,180,180,17,17,0,1,0
12,192,192,35,9,26,4,3
29,192,192,9,9,0,1,0
5,211,211,11,11,0,1,0
8,216,216,22,22,0,1,0
6,242,242,9,5,4,2,1
22,257,257,5,5,0,1,0
11,265,265,15,15,0,1,0
10,275,275,19,19,0,1,0
34,302,302,10,2,8,3,2
19,321,321,9,9,0,1,0
0,323,323,7,7,0,1,0
25,334,334,60,60,0,1,0
20,336,336,101,101,0,1,0
28,340,340,84,72,12,2,1
16,345,345,27,13,14,2,1
32,348,348,6,6,0,1,0
27,372,372,27,19,8,2,1
1,377,377,108,39,69,4,3
14,385,385,43,43,0,1,0
33,394,394,115,37,78,4,3
24,397,397,33,33,0,1,0
18,409,409,7,2,5,2,1
9,410,410,58,58,0,1,0
17,421,421,18,18,0,1,0
15,432,432,8,8,0,1,0
2,456,456,23,2,21,2,1
21,477,477,9,5,4,2,1
13,486,486,92,50,42,4,3
7,491,491,24,6,18,2,1

23,125,125,11,1,10,3,2
6,166,166,13,13,0,1,0
31,168,168,10,4,6,2,1
25,169,169,8,8,0,1,0
10,182,182,11,11,0,1,0
8,217,217,13,1,12,3,2
18,221,221,12,12,0,1,0
15,244,244,16,16,0,1,0
20,266,266,34,12,22,3,2
24,273,273,43,7,36,4,3
11,293,293,7,1,6,2,1
12,302,302,78,18,60,3,2
32,305,305,25,25,0,1,0
2,306,306,11,11,0,1,0
27,312,312,73,30,43,2,1
3,314,314,59,50,9,4,3
14,327,327,6,2,4,2,1
0,350,350,2,2,0,1,0
19,366,366,115,1,114,4,3
13,384,384,51,48,3,2,1
28,410,410,44,44,0,1,0
7,418,418,16,16,0,1,0
9,419,419,42,42,0,1,0
4,433,433,98,98,0,1,0
5,438,438,46,46,0,1,0
33,439,439,7,7,0,1,0
30,444,444,54,54,0,1,0
22,451,451,38,38,0,1,0
29,454,454,15,15,0,1,0
34,479,479,29,29,0,1,0
1,481,481,2,2,0,1,0
17,486,486,38,29,9,2,1
26,490,490,36,36,0,1,0
16,492,492,34,4,30,3,2
21,496,496,6,6,0,1,0

20,106,106,1,1,0,1,0
12,111,111,5,5,0,1,0
15,136,136,2,2,0,1,0
42,140,140,4,4,0,1,0
3,140,140,23,23,0,1,0
16,143,143,27,8,19,4,3
5,143,143,22,22,0,1,0
34,170,170,7,7,0,1,0
23,191,191,4,4,0,1,0
10,196,196,5,5,0,1,0
13,200,200,35,25,10,3,2
31,217,217,7,7,0,1,0
21,225,225,1,1,0,1,0
33,226,226,21,21,0,1,0
6,243,243,2,2,0,1,0
19,253,253,11,1,10,2,1
2,269,269,4,4,0,1,0
38,280,280,46,18,28,3,2
30,289,289,18,18,0,1,0
17,296,296,4,4,0,1,0
26,299,299,6,6,0,1,0
7,320,320,11,11,0,1,0
18,331,331,28,21,7,2,1
39,341,341,5,2,3,2,1
29,352,352,109,19,90,3,2
35,367,367,15,15,0,1,0
0,374,374,22,22,0,1,0
14,377,377,1,1,0,1,0
36,377,377,41,20,21,4,3
4,402,402,17,17,0,1,0
1,407,407,20,4,16,2,1
22,413,413,49,49,0,1,0
9,419,419,2,2,0,1,0
24,434,434,1,1,0,1,0
28,436,436,106,106,0,1,0
32,439,439,36,25,11,4,3
27,451,451,21,10,11,2,1
8,452,452,99,99,0,1,0
37,454,454,92,92,0,1,0
25,463,463,1,1,0,1,0
40,470,470,5,5,0,1,0
41,472,472,71,1,70,3,2
11,485,485,39,1,38,3,2

4,121,121,5,5,0,1,0
22,126,126,4,1,3,2,1
10,137,137,3,3,0,1,0
11,171,171,4,4,0,1,0
15,176,176,27,27,0,1,0
29,200,200,13,4,9,2,1
1,201,201,19,19,0,1,0
3,207,207,2,2,0,1,0
28,225,225,15,15,0,1,0
19,228,228,32,13,19,2,1
21,233,233,41,41,0,1,0
9,239,239,5,5,0,1,0
26,265,265,22,22,0,1,0
31,277,277,11,11,0,1,0
34,279,279,12,12,0,1,0
5,283,283,24,7,17,2,1
16,299,299,19,19,0,1,0
6,305,305,1,1,0,1,0
14,312,312,2,2,0,1,0
24,322,322,74,66,8,3,2
23,336,336,26,11,15,4,3
13,342,342,1,1,0,1,0
32,348,348,115,23,92,3,2
7,348,348,60,60,0,1,0
17,359,359,9,1,8,2,1
0,362,362,152,124,28,4,3
25,371,371,1,1,0,1,0
12,377,377,3,3,0,1,0
20,397,397,94,75,19,4,3
27,404,404,24,11,13,2,1
8,411,411,129,83,46,2,1
30,416,416,2,2,0,1,0
18,440,440,18,1,17,4,3
33,452,452,21,9,12,4,3
2,488,488,46,46,0,1,0

4,119,119,31,11,20,2,1
14,140,140,16,16,0,1,0
19,150,150,28,11,17,2,1
28,153,153,34,34,0,1,0
7,156,156,1,1,0,1,0
21,168,168,7,1,6,2,1
23,175,175,31,31,0,1,0
13,195,195,5,5,0,1,0
5,224,224,1,1,0,1,0
29,241,241,15,15,0,1,0
10,241,241,27,27,0,1,0
24,251,251,11,2,9,2,1
26,285,285,13,13,0,1,0
11,287,287,27,27,0,1,0
15,300,300,29,23,6,3,2
27,304,304,54,54,0,1,0
20,315,315,58,58,0,1,0
9,334,334,48,14,34,2,1
12,362,362,29,29,0,1,0
16,375,375,28,28,0,1,0
0,383,383,70,53,17,2,1
22,395,395,28,28,0,1,0
1,401,401,43,22,21,4,3
8,406,406,32,2,30,2,1
17,413,413,9,1,8,3,2
25,418,418,19,5,14,2,1
18,443,443,29,29,0,1,0
6,453,453,1,1,0,1,0
2,454,454,136,49,87,4,3
3,463,463,95,28,67,4,3

6,104,104,5,5,0,1,0
31,112,112,4,4,0,1,0
5,124,124,13,13,0,1,0
21,128,128,36,9,27,2,1
23,130,130,5,5,0,1,0
27,131,131,2,2,0,1,0
19,143,143,37,10,27,4,3
24,151,151,3,3,0,1,0
0,157,157,35,22,13,2,1
16,159,159,3,3,0,1,0
26,166,166,38,38,0,1,0
10,173,173,20,20,0,1,0
33,176,176,49,19,30,4,3
11,209,209,35,35,0,1,0
2,230,230,9,9,0,1,0
28,241,241,1,1,0,1,0
14,252,252,2,2,0,1,0
12,252,252,80,7,73,4,3
22,253,253,35,4,31,2,1
32,289,289,14,3,11,2,1
17,317,317,21,18,3,2,1
3,391,391,45,45,0,1,0
7,399,399,12,2,10,4,3
30,431,431,24,2,22,3,2
8,436,436,3,3,0,1,0
25,437,437,3,3,0,1,0
1,445,445,35,35,0,1,0
13,446,446,84,54,30,4,3
29,447,447,10,4,6,3,2
20,458,458,95,71,24,2,1
15,458,458,17,17,0,1,0
9,484,484,1,1,0,1,0
18,486,486,5,5,0,1,0
4,489,489,17,7,10,3,2

3,150,150,8,5,3,2,1
7,158,158,25,25,0,1,0
23,200,200,75,65,10,2,1
12,227,227,11,11,0,1,0
14,249,249,13,13,0,1,0
22,260,260,28,28,0,1,0
4,266,266,24,24,0,1,0
2,267,267,6,1,5,2,1
19,280,280,19,1,18,2,1
24,296,296,9,9,0,1,0
16,298,298,34,13,21,2,1
5,307,307,65,5,60,4,3
20,319,319,16,16,0,1,0
29,358,358,90,64,26,2,1
6,373,373,8,8,0,1,0
28,382,382,48,30,18,4,3
10,386,386,50,50,0,1,0
31,389,389,75,75,0,1,0
18,392,392,7,7,0,1,0
25,400,400,25,25,0,1,0
11,402,402,15,15,0,1,0
8,430,430,180,79,101,4,3
21,431,431,23,23,0,1,0
1,433,433,3,3,0,1,0
0,437,437,37,37,0,1,0
17,445,445,3,3,0,1,0
9,458,458,8,8,0,1,0
30,458,458,1,1,0,1,0
26,462,462,53,53,0,1,0
13,467,467,61,7,54,3,2
27,470,470,22,22,0,1,0
15,482,482,57,57,0,1,0

7,127,127,4,4,0,1,0
30,134,134,11,3,8,2,1
23,143,143,17,17,0,1,0
25,149,149,10,10,0,1,0
34,157,157,17,17,0,1,0
11,160,160,1,1,0,1,0
26,179,179,17,3,14,3,2
12,202,202,24,8,16,4,3
33,221,221,12,3,9,4,3
8,234,234,19,19,0,1,0
32,259,259,17,6,11,2,1
29,279,279,30,4,26,2,1
21,280,280,11,11,0,1,0
15,286,286,4,4,0,1,0
19,291,291,91,73,18,4,3
5,297,297,8,1,7,2,1
18,304,304,19,3,16,2,1
9,316,316,43,23,20,3,2
24,320,320,6,6,0,1,0
4,333,333,4,4,0,1,0
22,376,376,17,17,0,1,0
31,379,379,28,10,18,3,2
10,380,380,29,23,6,2,1
27,380,380,30,14,16,3,2
17,388,388,51,51,0,1,0
1,397,397,80,80,0,1,0
20,400,400,138,81,57,4,3
28,405,405,10,4,6,3,2
0,416,416,1,1,0,1,0
6,438,438,48,6,42,3,2
16,450,450,82,52,30,2,1
3,451,451,1,1,0,1,0
2,453,453,26,26,0,1,0
13,491,491,14,14,0,1,0
14,494,494,159,153,6,3,2

29,102,102,10,10,0,1,0
26,106,106,1,1,0,1,0
3,108,108,4,4,0,1,0
5,127,127,25,25,0,1,0
11,135,135,16,16,0,1,0
31,146,146,11,11,0,1,0
23,155,155,16,1,15,4,3
7,156,156,3,3,0,1,0
18,162,162,2,2,0,1,0
8,179,179,8,8,0,1,0
27,188,188,4,4,0,1,0
19,214,214,71,71,0,1,0
33,230,230,1,1,0,1,0
9,246,246,4,4,0,1,0
13,322,322,4,4,0,1,0
10,328,328,4,4,0,1,0
35,329,329,3,3,0,1,0
1,334,334,65,47,18,2,1
25,340,340,109,109,0,1,0
34,345,345,142,63,79,4,3
12,354,354,1,1,0,1,0
32,357,357,52,10,42,3,2
4,373,373,34,34,0,1,0
24,376,376,35,35,0,1,0
14,381,381,32,32,0,1,0
17,385,385,23,3,20,3,2
36,387,387,39,19,20,2,1
16,415,415,48,24,24,3,2
6,421,421,8,5,3,2,1
28,427,427,32,32,0,1,0
2,430,430,35,6,29,2,1
21,442,442,19,10,9,2,1
20,444,444,47,8,39,2,1
30,451,451,38,9,29,2,1
22,455,455,18,18,0,1,0
0,463,463,7,7,0,1,0
15,477,477,15,15,0,1,0

10,101,101,1,1,0,1,0
5,108,108,2,2,0,1,0
38,110,110,3,3,0,1,0
43,112,112,20,20,0,1,0
6,120,120,1,1,0,1,0
27,122,122,3,3,0,1,0
12,135,135,1,1,0,1,0
21,144,144,16,16,0,1,0
37,147,147,5,2,3,2,1
26,162,162,6,6,0,1,0
9,168,168,3,3,0,1,0
4,169,169,1,1,0,1,0
33,178,178,5,2,3,2,1
19,179,179,4,4,0,1,0
2,186,186,48,10,38,3,2
11,191,191,1,1,0,1,0
1,193,193,1,1,0,1,0
17,194,194,9,3,6,2,1
49,205,205,77,25,52,3,2
0,205,205,41,3,38,3,2
47,234,234,10,1,9,2,1
20,235,235,10,3,7,2,1
41,235,235,47,4,43,2,1
16,242,242,32,32,0,1,0
36,252,252,19,7,12,2,1
31,278,278,7,7,0,1,0
25,290,290,9,9,0,1,0
13,301,301,16,4,12,4,3
42,301,301,2,2,0,1,0
44,311,311,28,28,0,1,0
7,313,313,15,15,0,1,0
32,336,336,23,9,14,2,1
22,339,339,5,5,0,1,0
45,342,342,24,10,14,2,1
46,351,351,7,7,0,1,0
28,352,352,2,2,0,1,0
30,368,368,5,5,0,1,0
3,374,374,8,3,5,2,1
29,381,381,26,18,8,3,2
23,410,410,3,3,0,1,0
39,446,446,4,4,0,1,0
35,453,453,12,12,0,1,0
48,457,457,71,71,0,1,0
15,460,460,15,15,0,1,0
18,482,482,1,1,0,1,0
14,483,483,37,28,9,2,1
24,488,488,6,6,0,1,0
8,492,492,69,28,41,2,1
34,494,494,18,15,3,2,1
40,500,500,145,66,79,4,3

34,113,113,20,20,0,1,0
20,118,118,2,2,0,1,0
28,123,123,15,5,10,2,1
12,131,131,11,3,8,3,2
16,139,139,9,1,8,2,1
14,153,153,7,1,6,3,2
33,155,155,9,9,0,1,0
0,195,195,8,2,6,2,1
36,199,199,5,2,3,2,1
30,210,210,21,3,18,4,3
29,214,214,7,7,0,1,0
17,221,221,3,3,0,1,0
31,225,225,18,18,0,1,0
22,246,246,85,85,0,1,0
19,253,253,41,32,9,2,1
27,256,256,22,6,16,2,1
4,257,257,3,3,0,1,0
18,269,269,27,2,25,2,1
32,277,277,13,13,0,1,0
24,312,312,31,31,0,1,0
13,322,322,17,17,0,1,0
26,324,324,59,7,52,3,2
10,353,353,19,19,0,1,0
15,367,367,2,2,0,1,0
7,378,378,3,3,0,1,0
8,390,390,23,18,5,2,1
2,398,398,16,16,0,1,0
3,406,406,78,38,40,3,2
35,420,420,29,29,0,1,0
1,421,421,17,17,0,1,0
5,429,429,128,113,15,2,1
25,433,433,45,45,0,1,0
6,439,439,90,29,61,3,2
23,445,445,24,2,22,2,1
9,486,486,9,9,0,1,0
21,492,492,27,27,0,1,0
11,500,500,44,34,10,3,2

13,121,121,68,25,43,3,2
11,121,121,3,3,0,1,0
8,130,130,21,21,0,1,0
7,176,176,36,4,32,4,3
14,182,182,3,3,0,1,0
9,183,183,3,3,0,1,0
18,246,246,4,4,0,1,0
37,260,260,21,6,15,2,1
15,264,264,5,1,4,2,1
6,272,272,1,1,0,1,0
28,279,279,4,1,3,2,1
23,296,296,29,6,23,4,3
19,315,315,8,8,0,1,0
1,321,321,5,5,0,1,0
22,329,329,93,4,89,4,3
33,331,331,11,11,0,1,0
4,338,338,9,9,0,1,0
2,352,352,29,29,0,1,0
30,378,378,17,1,16,2,1
35,383,383,15,15,0,1,0
36,389,389,37,37,0,1,0
16,390,390,22,22,0,1,0
34,394,394,90,69,21,2,1
10,396,396,44,1,43,2,1
32,415,415,17,17,0,1,0
25,416,416,171,114,57,4,3
3,417,417,2,2,0,1,0
17,418,418,2,2,0,1,0
24,419,419,22,1,21,2,1
21,441,441,26,2,24,4,3
26,463,463,1,1,0,1,0
0,473,473,5,5,0,1,0
20,474,474,1,1,0,1,0
12,475,475,10,4,6,3,2
31,484,484,12,12,0,1,0
29,485,485,6,6,0,1,0
27,487,487,80,60,20,2,1
5,492,492,77,14,63,4,3

19,127,127,16,4,12,2,1
8,129,129,31,31,0,1,0
22,139,139,34,34,0,1,0
26,163,163,24,9,15,4,3
11,170,170,15,8,7,2,1
24,205,205,2,2,0,1,0
9,221,221,1,1,0,1,0
31,223,223,14,3,11,2,1
6,230,230,16,16,0,1,0
16,255,255,10,2,8,3,2
12,274,274,1,1,0,1,0
1,275,275,19,13,6,3,2
2,281,281,39,39,0,1,0
33,302,302,7,7,0,1,0
20,304,304,9,9,0,1,0
18,338,338,14,14,0,1,0
7,345,345,1,1,0,1,0
15,348,348,38,38,0,1,0
25,348,348,42,5,37,2,1
28,348,348,43,17,26,2,1
14,349,349,2,2,0,1,0
0,357,357,36,36,0,1,0
5,363,363,53,53,0,1,0
27,364,364,100,43,57,4,3
21,382,382,39,3,36,3,2
13,390,390,47,8,39,2,1
4,396,396,1,1,0,1,0
29,398,398,80,34,46,2,1
30,413,413,3,3,0,1,0
23,419,419,20,20,0,1,0
17,434,434,112,112,0,1,0
32,443,443,30,9,21,2,1
10,460,460,38,38,0,1,0
3,488,488,58,43,15,4,3

13,102,102,17,17,0,1,0
17,111,111,2,2,0,1,0
14,121,121,17,17,0,1,0
22,157,157,4,4,0,1,0
6,159,159,5,5,0,1,0
1,181,181,1,1,0,1,0
7,205,205,1,1,0,1,0
5,222,222,1,1,0,1,0
29,224,224,1,1,0,1,0
20,229,229,11,11,0,1,0
19,246,246,27,27,0,1,0
18,257,257,2,2,0,1,0
31,275,275,56,38,18,4,3
24,282,282,78,78,0,1,0
11,287,287,21,21,0,1,0
30,301,301,90,61,29,2,1
2,314,314,7,7,0,1,0
26,352,352,33,15,18,2,1
21,410,410,63,63,0,1,0
25,429,429,40,40,0,1,0
12,432,432,17,17,0,1,0
3,443,443,52,22,30,4,3
0,461,461,7,7,0,1,0
15,461,461,20,20,0,1,0
4,462,462,351,326,25,2,1
27,464,464,53,53,0,1,0
28,484,484,16,16,0,1,0
16,490,490,27,3,24,3,2
8,492,492,62,10,52,3,2
9,493,493,24,5,19,2,1
23,498,498,42,42,0,1,0
10,498,498,1,1,0,1,0

24,111,111,2,2,0,1,0
9,139,139,9,9,0,1,0
25,164,164,19,19,0,1,0
16,168,168,28,28,0,1,0
12,171,171,6,6,0,1,0
13,173,173,4,1,3,2,1
15,189,189,60,29,31,2,1
18,202,202,18,18,0,1,0
10,211,211,33,33,0,1,0
23,217,217,13,7,6,3,2
17,231,231,6,6,0,1,0
4,233,233,92,64,28,2,1
14,247,247,51,51,0,1,0
5,254,254,6,3,3,2,1
6,286,286,52,52,0,1,0
20,313,313,17,17,0,1,0
0,317,317,61,21,40,3,2
22,334,334,11,11,0,1,0
7,337,337,22,6,16,3,2
2,337,337,5,5,0,1,0
3,353,353,140,98,42,4,3
1,378,378,40,40,0,1,0
8,390,390,64,64,0,1,0
19,435,435,95,52,43,2,1
11,481,481,6,6,0,1,0
21,484,484,53,53,0,1,0

10,158,158,8,8,0,1,0
6,184,184,5,5,0,1,0
23,194,194,30,15,15,2,1
22,200,200,20,20,0,1,0
9,214,214,80,10,70,3,2
1,264,264,93,76,17,4,3
7,279,279,4,4,0,1,0
5,282,282,12,12,0,1,0
21,290,290,14,14,0,1,0
11,308,308,10,10,0,1,0
20,310,310,5,2,3,2,1
13,311,311,5,5,0,1,0
3,320,320,45,45,0,1,0
18,339,339,17,7,10,2,1
2,347,347,34,34,0,1,0
8,380,380,14,2,12,3,2
14,386,386,10,10,0,1,0
24,394,394,4,4,0,1,0
19,427,427,34,34,0,1,0
17,443,443,50,15,35,4,3
16,447,447,33,33,0,1,0
25,449,449,82,72,10,2,1
0,458,458,141,41,100,4,3
15,469,469,69,69,0,1,0
4,470,470,99,63,36,2,1
12,488,488,254,226,28,2,1

7,118,118,12,6,6,3,2
31,144,144,18,18,0,1,0
5,158,158,4,4,0,1,0
15,169,169,1,1,0,1,0
6,195,195,1,1,0,1,0
18,205,205,3,3,0,1,0
26,211,211,14,14,0,1,0
27,246,246,24,1,23,4,3
23,248,248,46,10,36,3,2
1,250,250,31,22,9,3,2
12,258,258,11,11,0,1,0
11,262,262,10,10,0,1,0
30,298,298,30,30,0,1,0
17,298,298,19,4,15,4,3
8,305,305,44,10,34,3,2
21,308,308,30,30,0,1,0
2,318,318,100,100,0,1,0
4,329,329,29,17,12,4,3
25,330,330,28,28,0,1,0
10,331,331,24,24,0,1,0
29,337,337,26,26,0,1,0
22,368,368,49,45,4,2,1
9,380,380,51,51,0,1,0
28,384,384,18,11,7,2,1
19,390,390,33,18,15,4,3
0,405,405,1,1,0,1,0
3,417,417,87,14,73,4,3
24,427,427,69,16,53,3,2
20,438,438,109,70,39,4,3
32,441,441,6,1,5,2,1
33,458,458,43,43,0,1,0
14,475,475,27,15,12,4,3
13,482,482,60,22,38,3,2
16,487,487,24,18,6,2,1

19,105,105,4,4,0,1,0
15,136,136,7,7,0,1,0
21,142,142,18,1,17,2,1
18,147,147,9,9,0,1,0
1,168,168,81,33,48,3,2
22,169,169,2,2,0,1,0
27,175,175,14,3,11,2,1
9,211,211,41,41,0,1,0
23,271,271,1,1,0,1,0
0,276,276,43,43,0,1,0
7,289,289,39,27,12,4,3
28,298,298,74,74,0,1,0
2,306,306,20,20,0,1,0
11,334,334,85,69,16,2,1
16,348,348,28,28,0,1,0
3,361,361,1,1,0,1,0
14,365,365,35,23,12,3,2
5,366,366,25,13,12,4,3
25,367,367,17,13,4,2,1
12,406,406,6,6,0,1,0
13,416,416,41,19,22,3,2
4,435,435,6,1,5,2,1
6,450,450,15,15,0,1,0
8,459,459,76,50,26,3,2
24,464,464,8,8,0,1,0
26,467,467,111,45,66,4,3
20,471,471,195,83,112,4,3
10,477,477,7,7,0,1,0
17,480,480,10,10,0,1,0

7,129,129,5,1,4,2,1
1,131,131,21,21,0,1,0
30,137,137,3,3,0,1,0
15,165,165,1,1,0,1,0
9,182,182,4,4,0,1,0
13,197,197,14,14,0,1,0
6,212,212,1,1,0,1,0
14,242,242,1,1,0,1,0
21,255,255,3,3,0,1,0
19,256,256,3,3,0,1,0
4,262,262,13,5,8,3,2
33,274,274,16,4,12,3,2
8,274,274,8,8,0,1,0
22,282,282,12,12,0,1,0
26,288,288,4,4,0,1,0
5,292,292,64,64,0,1,0
23,309,309,36,17,19,4,3
31,320,320,28,28,0,1,0
2,332,332,26,8,18,4,3
24,381,381,51,12,39,2,1
3,386,386,37,37,0,1,0
32,398,398,58,44,14,3,2
28,414,414,57,15,42,2,1
29,433,433,22,22,0,1,0
11,435,435,70,58,12,4,3
25,436,436,89,73,16,3,2
0,440,440,146,47,99,4,3
18,444,444,168,34,134,4,3
17,455,455,110,90,20,2,1
10,488,488,19,1,18,2,1
12,498,498,9,6,3,2,1
27,500,500,25,15,10,3,2
20,500,500,79,79,0,1,0
16,500,500,15,15,0,1,0

1,100,100,11,2,9,4,3
5,137,137,3,3,0,1,0
16,182,182,13,7,6,2,1
7,192,192,17,17,0,1,0
0,206,206,39,9,30,4,3
2,209,209,53,1,52,3,2
24,225,225,5,5,0,1,0
10,225,225,20,11,9,4,3
6,226,226,49,16,33,2,1
23,259,259,10,10,0,1,0
19,260,260,64,64,0,1,0
11,260,260,61,61,0,1,0
18,265,265,1,1,0,1,0
9,267,267,118,62,56,3,2
13,272,272,23,7,16,3,2
12,288,288,7,4,3,2,1
20,290,290,90,90,0,1,0
21,332,332,31,19,12,4,3
3,337,337,18,7,11,2,1
14,339,339,38,29,9,4,3
25,345,345,6,6,0,1,0
8,347,347,75,25,50,3,2
4,347,347,3,3,0,1,0
15,383,383,77,60,17,2,1
17,479,479,20,6,14,2,1
22,499,499,21,1,20,3,2

0,118,118,46,34,12,2,1
9,134,134,12,12,0,1,0
17,149,149,4,4,0,1,0
2,158,158,34,34,0,1,0
18,160,160,12,12,0,1,0
23,161,161,25,25,0,1,0
15,165,165,32,21,11,2,1
21,203,203,1,1,0,1,0
20,209,209,42,42,0,1,0
19,248,248,8,4,4,2,1
6,257,257,50,50,0,1,0
8,310,310,13,3,10,2,1
16,311,311,21,12,9,4,3
5,313,313,81,68,13,2,1
3,316,316,19,6,13,2,1
4,320,320,46,9,37,2,1
7,334,334,1,1,0,1,0
14,341,341,19,19,0,1,0
22,355,355,8,8,0,1,0
11,384,384,21,13,8,3,2
13,399,399,21,7,14,3,2
24,417,417,105,50,55,4,3
25,423,423,37,23,14,2,1
1,427,427,29,13,16,4,3
26,450,450,3,3,0,1,0
12,470,470,163,63,100,3,2
10,488,488,67,67,0,1,0

20,115,115,26,6,20,3,2
7,119,119,5,5,0,1,0
8,130,130,4,4,0,1,0
17,134,134,14,3,11,2,1
29,140,140,7,7,0,1,0
12,163,163,6,6,0,1,0
24,172,172,19,10,9,2,1
14,197,197,8,8,0,1,0
6,211,211,5,5,0,1,0
22,233,233,1,1,0,1,0
15,235,235,34,34,0,1,0
9,237,237,1,1,0,1,0
2,275,275,133,64,69,4,3
13,284,284,26,4,22,3,2
0,286,286,16,6,10,3,2
23,293,293,36,21,15,2,1
26,295,295,24,24,0,1,0
18,297,297,26,16,10,2,1
11,302,302,8,8,0,1,0
1,322,322,185,185,0,1,0
27,332,332,15,15,0,1,0
3,334,334,8,8,0,1,0
25,341,341,39,1,38,3,2
21,360,360,36,21,15,4,3
28,422,422,34,5,29,4,3
4,430,430,12,2,10,2,1
10,431,431,19,7,12,4,3
16,450,450,9,9,0,1,0
19,460,460,140,62,78,4,3
5,492,492,67,27,40,4,3

12,105,105,5,5,0,1,0
1,113,113,1,1,0,1,0
18,123,123,7,7,0,1,0
11,132,132,15,5,10,3,2
16,134,134,2,2,0,1,0
20,157,157,2,2,0,1,0
6,167,167,19,2,17,2,1
28,178,178,11,11,0,1,0
8,189,189,4,4,0,1,0
25,193,193,8,8,0,1,0
22,203,203,15,15,0,1,0
29,210,210,94,40,54,3,2
23,213,213,23,13,10,3,2
27,222,222,19,19,0,1,0
14,230,230,6,2,4,2,1
7,230,230,111,111,0,1,0
5,231,231,11,11,0,1,0
13,246,246,3,3,0,1,0
17,254,254,15,2,13,2,1
26,264,264,17,3,14,3,2
9,297,297,15,15,0,1,0
21,317,317,4,4,0,1,0
3,326,326,35,2,33,2,1
2,335,335,5,5,0,1,0
24,412,412,48,33,15,2,1
15,435,435,37,37,0,1,0
19,444,444,166,49,117,4,3
10,444,444,81,81,0,1,0
4,494,494,84,52,32,2,1
0,498,498,114,102,12,4,3

26,120,120,5,5,0,1,0
28,149,149,1,1,0,1,0
31,150,150,14,11,3,2,1
2,168,168,21,6,15,2,1
27,168,168,6,2,4,2,1
16,195,195,17,10,7,2,1
14,199,199,15,15,0,1,0
11,199,199,1,1,0,1,0
5,201,201,51,1,50,3,2
4,206,206,18,2,16,2,1
13,263,263,11,3,8,3,2
21,288,288,66,30,36,2,1
18,290,290,10,10,0,1,0
29,293,293,29,1,28,4,3
22,302,302,96,64,32,2,1
32,311,311,20,13,7,2,1
23,323,323,34,18,16,2,1
3,326,326,1,1,0,1,0
7,341,341,51,44,7,2,1
9,366,366,7,7,0,1,0
25,375,375,12,12,0,1,0
10,390,390,52,18,34,3,2
15,405,405,1,1,0,1,0
30,434,434,86,86,0,1,0
1,441,441,95,26,69,4,3
6,446,446,2,2,0,1,0
20,449,449,7,7,0,1,0
17,454,454,66,66,0,1,0
8,456,456,63,53,10,2,1
12,460,460,17,2,15,2,1
19,472,472,96,96,0,1,0
24,475,475,6,2,4,2,1
0,483,483,109,28,81,4,3

31,116,116,11,8,3,2,1
18,136,136,4,4,0,1,0
1,147,147,21,10,11,4,3
14,151,151,16,16,0,1,0
19,160,160,47,9,38,2,1
7,186,186,4,4,0,1,0
21,192,192,25,7,18,3,2
16,194,194,22,7,15,2,1
17,219,219,6,6,0,1,0
30,232,232,9,9,0,1,0
24,240,240,10,10,0,1,0
28,247,247,2,2,0,1,0
8,251,251,51,35,16,2,1
6,255,255,3,3,0,1,0
3,261,261,3,3,0,1,0
15,266,266,47,47,0,1,0
25,286,286,48,36,12,2,1
12,298,298,4,4,0,1,0
32,301,301,11,11,0,1,0
13,304,304,50,50,0,1,0
0,315,315,29,5,24,4,3
2,334,334,20,20,0,1,0
10,343,343,48,8,40,2,1
34,365,365,97,55,42,4,3
33,371,371,7,1,6,3,2
22,372,372,71,71,0,1,0
9,374,374,44,44,0,1,0
27,375,375,33,33,0,1,0
26,379,379,21,9,12,3,2
20,387,387,15,15,0,1,0
23,405,405,24,24,0,1,0
29,447,447,46,10,36,4,3
5,484,484,44,13,31,2,1
4,499,499,3,3,0,1,0
11,500,500,37,31,6,3,2

4,104,104,2,2,0,1,0
18,118,118,7,7,0,1,0
21,173,173,16,1,15,2,1
16,176,176,4,4,0,1,0
22,189,189,11,5,6,3,2
3,197,197,4,4,0,1,0
7,198,198,40,28,12,4,3
17,223,223,36,6,30,2,1
32,233,233,1,1,0,1,0
31,234,234,24,24,0,1,0
27,236,236,19,19,0,1,0
26,236,236,62,4,58,3,2
13,240,240,45,45,0,1,0
11,246,246,1,1,0,1,0
24,255,255,3,3,0,1,0
19,258,258,4,4,0,1,0
5,266,266,52,12,40,3,2
29,299,299,82,58,24,2,1
12,328,328,9,9,0,1,0
1,330,330,10,10,0,1,0
34,339,339,59,8,51,4,3
33,351,351,27,27,0,1,0
15,373,373,5,5,0,1,0
28,378,378,18,18,0,1,0
14,382,382,50,23,27,2,1
8,397,397,23,23,0,1,0
0,404,404,40,22,18,3,2
10,418,418,47,16,31,2,1
6,420,420,11,3,8,2,1
20,432,432,54,30,24,3,2
30,450,450,71,44,27,4,3
25,466,466,5,5,0,1,0
2,475,475,24,11,13,2,1
23,483,483,66,40,26,2,1
9,489,489,88,88,0,1,0

17,103,103,1,1,0,1,0
20,106,106,21,11,10,2,1
37,112,112,29,29,0,1,0
26,113,113,4,4,0,1,0
18,136,136,9,3,6,3,2
35,142,142,9,9,0,1,0
25,145,145,43,43,0,1,0
0,146,146,4,4,0,1,0
12,148,148,8,8,0,1,0
11,148,148,2,2,0,1,0
34,162,162,5,5,0,1,0
5,166,166,2,2,0,1,0
29,182,182,30,14,16,3,2
27,202,202,22,22,0,1,0
1,208,208,13,13,0,1,0
31,223,223,12,1,11,2,1
33,245,245,29,29,0,1,0
36,293,293,15,4,11,2,1
30,293,293,58,29,29,2,1
13,294,294,1,1,0,1,0
19,295,295,19,19,0,1,0
4,298,298,3,3,0,1,0
16,313,313,3,3,0,1,0
22,325,325,6,6,0,1,0
32,329,329,19,16,3,2,1
14,339,339,11,1,10,4,3
10,350,350,5,5,0,1,0
21,356,356,57,57,0,1,0
8,375,375,127,127,0,1,0
24,386,386,2,2,0,1,0
7,386,386,58,13,45,4,3
2,395,395,32,9,23,4,3
23,398,398,7,3,4,2,1
6,418,418,44,5,39,3,2
3,424,424,16,16,0,1,0
15,435,435,28,28,0,1,0
9,447,447,38,2,36,2,1
28,494,494,83,17,66,3,2

12,110,110,11,11,0,1,0
17,119,119,20,20,0,1,0
11,124,124,20,20,0,1,0
31,146,146,1,1,0,1,0
13,148,148,27,3,24,3,2
20,184,184,26,20,6,2,1
29,193,193,42,1,41,2,1
30,205,205,33,8,25,3,2
23,220,220,11,11,0,1,0
8,226,226,9,1,8,3,2
14,249,249,16,16,0,1,0
25,250,250,1,1,0,1,0
5,253,253,5,5,0,1,0
26,258,258,15,7,8,3,2
18,264,264,2,2,0,1,0
9,285,285,1,1,0,1,0
24,313,313,37,29,8,2,1
0,340,340,51,21,30,3,2
21,351,351,42,42,0,1,0
28,353,353,103,103,0,1,0
19,355,355,1,1,0,1,0
1,359,359,22,22,0,1,0
22,420,420,14,14,0,1,0
3,423,423,48,48,0,1,0
27,443,443,10,10,0,1,0
7,446,446,15,9,6,2,1
4,452,452,13,5,8,2,1
16,454,454,106,6,100,3,2
15,478,478,28,28,0,1,0
10,480,480,216,160,56,3,2
6,489,489,39,39,0,1,0
2,500,500,27,7,20,2,1

22,108,108,13,7,6,2,1
0,111,111,16,16,0,1,0
19,146,146,3,3,0,1,0
29,167,167,7,4,3,2,1
9,195,195,1,1,0,1,0
23,228,228,20,20,0,1,0
17,228,228,56,43,13,2,1
11,254,254,7,7,0,1,0
20,265,265,41,41,0,1,0
24,269,269,12,4,8,2,1
21,294,294,28,28,0,1,0
5,296,296,33,1,32,4,3
6,299,299,15,15,0,1,0
16,307,307,16,5,11,2,1
1,310,310,19,19,0,1,0
3,319,319,17,17,0,1,0
4,336,336,105,33,72,4,3
10,342,342,1,1,0,1,0
25,344,344,48,48,0,1,0
32,346,346,18,18,0,1,0
14,347,347,23,12,11,2,1
7,347,347,32,32,0,1,0
15,350,350,1,1,0,1,0
33,351,351,10,1,9,2,1
18,365,365,76,10,66,3,2
2,419,419,70,18,52,3,2
31,429,429,15,15,0,1,0
28,435,435,38,13,25,2,1
27,461,461,55,25,30,2,1
12,465,465,24,16,8,2,1
8,471,471,55,30,25,2,1
13,474,474,18,7,11,2,1
26,483,483,117,40,77,4,3
30,490,490,73,73,0,1,0

13,114,114,35,5,30,3,2
27,128,128,2,2,0,1,0
20,128,128,16,16,0,1,0
21,134,134,33,15,18,4,3
4,142,142,1,1,0,1,0
10,147,147,2,2,0,1,0
14,159,159,5,5,0,1,0
28,168,168,11,11,0,1,0
19,175,175,11,2,9,2,1
7,199,199,7,7,0,1,0
3,210,210,23,23,0,1,0
0,230,230,10,10,0,1,0
15,234,234,6,6,0,1,0
2,260,260,53,24,29,2,1
24,291,291,65,2,63,4,3
18,295,295,11,11,0,1,0
29,309,309,17,17,0,1,0
9,317,317,139,79,60,4,3
11,321,321,9,9,0,1,0
25,321,321,29,17,12,4,3
8,365,365,8,8,0,1,0
16,365,365,60,55,5,2,1
22,394,394,20,2,18,4,3
17,434,434,92,92,0,1,0
6,438,438,7,7,0,1,0
12,445,445,8,4,4,2,1
1,447,447,37,37,0,1,0
26,449,449,21,21,0,1,0
23,464,464,85,85,0,1,0
5,477,477,133,105,28,2,1

15,101,101,18,18,0,1,0
9,106,106,2,2,0,1,0
30,117,117,6,6,0,1,0
5,122,122,21,21,0,1,0
17,122,122,3,3,0,1,0
11,128,128,9,5,4,2,1
13,140,140,7,7,0,1,0
26,147,147,24,10,14,3,2
25,162,162,21,21,0,1,0
14,179,179,22,16,6,2,1
4,200,200,47,47,0,1,0
29,230,230,26,10,16,3,2
2,246,246,12,4,8,2,1
3,256,256,4,4,0,1,0
24,264,264,9,3,6,3,2
0,268,268,46,25,21,2,1
21,273,273,12,6,6,2,1
16,277,277,2,2,0,1,0
27,283,283,53,11,42,2,1
23,298,298,5,5,0,1,0
6,325,325,2,2,0,1,0
18,345,345,63,63,0,1,0
22,348,348,36,15,21,4,3
12,348,348,66,5,61,4,3
8,397,397,16,16,0,1,0
31,401,401,22,13,9,2,1
32,406,406,59,59,0,1,0
33,410,410,29,29,0,1,0
19,410,410,113,15,98,3,2
20,412,412,9,1,8,2,1
28,444,444,15,15,0,1,0
10,457,457,52,3,49,2,1
1,463,463,45,2,43,2,1
7,464,464,18,14,4,2,1

11,109,109,4,4,0,1,0
10,110,110,20,2,18,2,1
15,114,114,28,20,8,2,1
14,115,115,10,10,0,1,0
24,116,116,81,81,0,1,0
30,117,117,16,1,15,2,1
19,137,137,8,8,0,1,0
3,160,160,48,5,43,3,2
0,165,165,1,1,0,1,0
34,168,168,6,1,5,2,1
25,190,190,26,26,0,1,0
1,198,198,9,9,0,1,0
13,202,202,1,1,0,1,0
12,208,208,46,46,0,1,0
29,229,229,5,5,0,1,0
33,243,243,10,4,6,3,2
16,245,245,9,9,0,1,0
26,256,256,3,3,0,1,0
6,274,274,8,8,0,1,0
7,274,274,16,7,9,4,3
17,288,288,43,31,12,4,3
21,297,297,7,7,0,1,0
31,297,297,1,1,0,1,0
28,318,318,36,36,0,1,0
9,320,320,17,17,0,1,0
18,322,322,14,2,12,3,2
4,337,337,27,27,0,1,0
20,342,342,6,6,0,1,0
23,347,347,1,1,0,1,0
22,357,357,69,9,60,4,3
2,382,382,4,1,3,2,1
32,386,386,26,26,0,1,0
5,388,388,1,1,0,1,0
8,465,465,5,5,0,1,0
27,479,479,37,34,3,2,1

33,130,130,38,38,0,1,0
21,140,140,37,5,32,3,2
22,148,148,33,33,0,1,0
12,157,157,10,10,0,1,0
28,192,192,9,9,0,1,0
26,200,200,12,12,0,1,0
16,205,205,11,11,0,1,0
30,212,212,10,10,0,1,0
3,230,230,1,1,0,1,0
9,236,236,6,6,0,1,0
2,249,249,10,4,6,2,1
17,273,273,5,5,0,1,0
25,279,279,21,21,0,1,0
19,288,288,8,8,0,1,0
15,321,321,14,8,6,3,2
29,323,323,92,65,27,2,1
18,328,328,73,73,0,1,0
27,342,342,36,7,29,2,1
10,356,356,37,23,14,2,1
23,371,371,13,13,0,1,0
24,398,398,15,1,14,4,3
6,404,404,48,48,0,1,0
14,405,405,87,78,9,4,3
34,406,406,15,3,12,4,3
31,419,419,8,8,0,1,0
20,431,431,21,5,16,2,1
8,440,440,10,10,0,1,0
1,446,446,29,29,0,1,0
7,451,451,52,1,51,4,3
0,452,452,40,40,0,1,0
32,462,462,10,1,9,4,3
5,472,472,92,59,33,2,1
4,485,485,67,35,32,3,2
13,490,490,3,3,0,1,0
11,500,500,31,5,26,2,1

32,104,104,8,8,0,1,0
24,116,116,16,16,0,1,0
37,122,122,21,13,8,3,2
21,123,123,2,2,0,1,0
29,124,124,3,3,0,1,0
6,128,128,7,7,0,1,0
22,130,130,2,2,0,1,0
9,134,134,9,1,8,3,2
3,138,138,1,1,0,1,0
2,157,157,9,9,0,1,0
13,158,158,22,10,12,2,1
4,163,163,1,1,0,1,0
31,164,164,5,5,0,1,0
30,183,183,17,10,7,2,1
35,187,187,16,16,0,1,0
27,189,189,41,41,0,1,0
1,193,193,4,1,3,2,1
8,214,214,8,8,0,1,0
39,218,218,25,25,0,1,0
16,239,239,2,2,0,1,0
19,247,247,1,1,0,1,0
5,254,254,36,4,32,2,1
26,265,265,62,28,34,3,2
33,285,285,18,18,0,1,0
7,295,295,100,100,0,1,0
23,301,301,36,22,14,2,1
12,301,301,1,1,0,1,0
38,302,302,66,18,48,2,1
40,307,307,6,6,0,1,0
34,340,340,29,15,14,2,1
14,369,369,31,31,0,1,0
17,381,381,2,2,0,1,0
0,383,383,46,12,34,2,1
10,387,387,42,42,0,1,0
36,425,425,15,6,9,4,3
15,442,442,16,16,0,1,0
20,461,461,8,2,6,2,1
28,490,490,15,8,7,2,1
11,493,493,1,1,0,1,0
18,494,494,27,27,0,1,0
25,497,497,69,69,0,1,0

21,139,139,18,18,0,1,0
11,142,142,9,1,8,3,2
2,155,155,21,8,13,4,3
23,157,157,19,2,17,2,1
20,187,187,8,8,0,1,0
1,211,211,74,74,0,1,0
22,243,243,10,10,0,1,0
17,246,246,5,5,0,1,0
18,254,254,29,8,21,2,1
25,261,261,2,2,0,1,0
14,262,262,48,3,45,2,1
4,266,266,20,9,11,3,2
7,269,269,3,3,0,1,0
6,298,298,32,10,22,2,1
24,306,306,2,2,0,1,0
19,308,308,61,50,11,2,1
3,363,363,109,27,82,3,2
15,367,367,2,2,0,1,0
10,378,378,152,142,10,3,2
26,398,398,81,81,0,1,0
0,422,422,5,5,0,1,0
9,431,431,38,38,0,1,0
13,445,445,155,122,33,4,3
12,453,453,38,38,0,1,0
8,476,476,35,5,30,2,1
16,477,477,30,25,5,2,1
5,497,497,22,3,19,2,1

12,126,126,1,1,0,1,0
6,132,132,12,4,8,3,2
21,132,132,2,2,0,1,0
23,166,166,1,1,0,1,0
0,170,170,48,36,12,2,1
14,198,198,44,44,0,1,0
10,201,201,8,8,0,1,0
19,254,254,41,29,12,4,3
9,287,287,5,5,0,1,0
1,304,304,2,2,0,1,0
16,307,307,63,63,0,1,0
31,308,308,11,3,8,2,1
13,324,324,13,13,0,1,0
32,325,325,21,21,0,1,0
3,326,326,36,24,12,3,2
20,337,337,3,3,0,1,0
15,342,342,28,3,25,4,3
24,343,343,68,68,0,1,0
11,346,346,11,8,3,2,1
22,349,349,31,16,15,4,3
30,360,360,9,3,6,2,1
27,369,369,4,4,0,1,0
29,387,387,74,2,72,3,2
4,397,397,141,141,0,1,0
18,412,412,16,16,0,1,0
5,418,418,4,4,0,1,0
28,423,423,184,152,32,2,1
2,438,438,28,18,10,2,1
25,441,441,38,38,0,1,0
17,441,441,1,1,0,1,0
8,466,466,5,1,4,2,1
7,481,481,11,11,0,1,0
33,483,483,37,22,15,2,1
26,498,498,91,76,15,4,3

14,122,122,1,1,0,1,0
26,127,127,5,5,0,1,0
12,141,141,17,2,15,4,3
22,158,158,18,9,9,2,1
23,169,169,45,26,19,2,1
0,179,179,58,22,36,3,2
1,183,183,39,28,11,2,1
3,207,207,18,13,5,2,1
21,220,220,73,73,0,1,0
2,230,230,6,6,0,1,0
13,235,235,4,4,0,1,0
29,244,244,2,2,0,1,0
16,247,247,1,1,0,1,0
15,249,249,6,6,0,1,0
5,250,250,26,4,22,3,2
28,251,251,21,8,13,2,1
11,315,315,6,3,3,2,1
20,322,322,81,75,6,3,2
27,336,336,37,19,18,2,1
17,347,347,50,15,35,2,1
25,364,364,7,7,0,1,0
6,369,369,14,14,0,1,0
10,373,373,82,82,0,1,0
9,379,379,65,3,62,4,3
7,380,380,17,17,0,1,0
24,390,390,4,1,3,2,1
19,440,440,62,62,0,1,0
4,442,442,51,51,0,1,0
8,447,447,46,46,0,1,0
18,449,449,33,33,0,1,0

34,103,103,29,10,19,2,1
35,111,111,1,1,0,1,0
26,115,115,29,29,0,1,0
31,121,121,20,10,10,3,2
25,125,125,5,1,4,2,1
17,130,130,2,2,0,1,0
27,133,133,2,2,0,1,0
30,144,144,39,39,0,1,0
24,167,167,6,6,0,1,0
7,193,193,2,2,0,1,0
8,216,216,63,63,0,1,0
29,221,221,6,6,0,1,0
10,231,231,20,1,19,4,3
28,283,283,55,55,0,1,0
4,298,298,19,19,0,1,0
32,299,299,31,31,0,1,0
23,329,329,14,4,10,2,1
0,357,357,5,5,0,1,0
20,357,357,55,33,22,2,1
2,366,366,27,24,3,2,1
19,368,368,18,18,0,1,0
15,372,372,45,45,0,1,0
1,377,377,16,5,11,2,1
6,377,377,14,11,3,2,1
18,389,389,2,2,0,1,0
9,390,390,48,27,21,2,1
14,427,427,37,7,30,4,3
12,430,430,37,1,36,3,2
3,431,431,27,9,18,2,1
21,435,435,9,9,0,1,0
13,443,443,43,43,0,1,0
33,450,450,79,79,0,1,0
11,454,454,43,22,21,4,3
5,455,455,15,1,14,3,2
22,469,469,4,1,3,2,1
36,469,469,3,3,0,1,0
16,482,482,26,26,0,1,0

27,109,109,11,11,0,1,0
30,124,124,1,1,0,1,0
28,128,128,19,19,0,1,0
10,152,152,4,4,0,1,0
1,153,153,1,1,0,1,0
0,161,161,32,11,21,2,1
31,169,169,30,30,0,1,0
20,178,178,6,6,0,1,0
14,179,179,14,8,6,2,1
19,189,189,41,5,36,3,2
3,190,190,36,36,0,1,0
32,195,195,3,3,0,1,0
25,195,195,4,1,3,2,1
24,208,208,4,4,0,1,0
18,222,222,36,1,35,2,1
15,239,239,24,24,0,1,0
29,248,248,41,21,20,2,1
11,254,254,55,55,0,1,0
17,258,258,6,1,5,2,1
7,258,258,19,8,11,2,1
2,289,289,15,15,0,1,0
8,321,321,14,14,0,1,0
22,335,335,54,18,36,4,3
21,339,339,24,24,0,1,0
16,342,342,17,17,0,1,0
26,369,369,69,37,32,3,2
12,372,372,71,35,36,4,3
13,391,391,7,7,0,1,0
5,404,404,33,20,13,2,1
9,405,405,37,25,12,3,2
4,418,418,53,21,32,3,2
6,450,450,26,26,0,1,0
23,496,496,66,22,44,2,1

30,108,108,8,8,0,1,0
4,108,108,12,7,5,2,1
9,120,120,21,14,7,2,1
6,121,121,1,1,0,1,0
10,125,125,1,1,0,1,0
31,143,143,21,1,20,2,1
5,160,160,10,10,0,1,0
12,167,167,21,21,0,1,0
19,189,189,7,2,5,2,1
7,193,193,32,32,0,1,0
25,202,202,7,7,0,1,0
13,207,207,5,5,0,1,0
18,209,209,49,49,0,1,0
14,218,218,89,69,20,4,3
20,221,221,3,3,0,1,0
1,229,229,11,2,9,2,1
28,254,254,65,18,47,3,2
27,265,265,7,3,4,2,1
3,300,300,13,13,0,1,0
29,338,338,14,8,6,3,2
17,351,351,14,11,3,2,1
22,367,367,13,13,0,1,0
0,376,376,17,8,9,4,3
24,386,386,145,118,27,2,1
2,431,431,24,16,8,2,1
16,437,437,5,5,0,1,0
8,445,445,5,5,0,1,0
15,455,455,57,14,43,2,1
23,459,459,48,12,36,2,1
26,468,468,73,73,0,1,0
21,483,483,25,25,0,1,0
11,488,488,90,90,0,1,0

17,100,100,10,10,0,1,0
34,111,111,14,5,9,4,3
2,113,113,1,1,0,1,0
30,118,118,9,9,0,1,0
23,136,136,14,2,12,3,2
38,162,162,2,2,0,1,0
13,164,164,16,16,0,1,0
6,166,166,6,6,0,1,0
9,176,176,51,41,10,2,1
7,179,179,59,25,34,3,2
33,183,183,46,19,27,3,2
16,196,196,1,1,0,1,0
19,207,207,10,10,0,1,0
28,207,207,6,6,0,1,0
37,221,221,51,3,48,2,1
4,224,224,11,11,0,1,0
27,252,252,6,1,5,2,1
32,257,257,7,7,0,1,0
14,265,265,7,7,0,1,0
0,269,269,16,16,0,1,0
22,278,278,1,1,0,1,0
35,352,352,9,2,7,2,1
21,367,367,22,22,0,1,0
39,370,370,56,28,28,3,2
18,380,380,7,7,0,1,0
29,381,381,26,26,0,1,0
25,385,385,33,33,0,1,0
12,385,385,1,1,0,1,0
1,387,387,22,5,17,2,1
5,393,393,18,18,0,1,0
36,395,395,84,47,37,3,2
26,400,400,59,59,0,1,0
11,400,400,1,1,0,1,0
3,414,414,20,20,0,1,0
8,416,416,21,13,8,3,2
15,432,432,22,22,0,1,0
31,446,446,30,12,18,2,1
20,452,452,4,4,0,1,0
10,467,467,48,48,0,1,0
24,491,491,50,34,16,2,1

23,101,101,4,4,0,1,0
29,121,121,3,3,0,1,0
35,147,147,9,9,0,1,0
30,147,147,57,5,52,3,2
16,149,149,2,2,0,1,0
11,193,193,27,27,0,1,0
32,205,205,81,81,0,1,0
36,211,211,15,4,11,2,1
1,220,220,40,18,22,2,1
22,237,237,35,35,0,1,0
13,257,257,2,2,0,1,0
4,265,265,31,31,0,1,0
15,267,267,20,20,0,1,0
31,277,277,3,3,0,1,0
9,296,296,10,4,6,2,1
26,321,321,33,33,0,1,0
27,334,334,45,38,7,2,1
25,342,342,5,5,0,1,0
10,352,352,4,4,0,1,0
37,359,359,9,9,0,1,0
8,366,366,79,9,70,3,2
17,369,369,37,21,16,2,1
24,382,382,11,11,0,1,0
14,384,384,5,5,0,1,0
21,387,387,14,14,0,1,0
20,403,403,21,21,0,1,0
7,414,414,2,2,0,1,0
33,416,416,40,40,0,1,0
5,422,422,16,13,3,2,1
0,423,423,1,1,0,1,0
6,427,427,81,81,0,1,0
19,440,440,28,5,23,2,1
34,441,441,25,7,18,3,2
18,444,444,27,19,8,2,1
28,458,458,17,5,12,3,2
3,465,465,53,53,0,1,0
2,469,469,49,49,0,1,0
12,498,498,13,13,0,1,0

1,131,131,6,6,0,1,0
27,143,143,14,14,0,1,0
5,146,146,19,7,12,3,2
35,155,155,6,6,0,1,0
31,156,156,3,3,0,1,0
0,170,170,4,4,0,1,0
33,176,176,73,28,45,2,1
32,178,178,50,50,0,1,0
40,200,200,2,2,0,1,0
23,219,219,1,1,0,1,0
19,225,225,17,8,9,4,3
12,234,234,7,3,4,2,1
36,242,242,5,2,3,2,1
14,247,247,7,7,0,1,0
30,248,248,33,17,16,3,2
26,250,250,10,10,0,1,0
22,254,254,16,16,0,1,0
18,273,273,10,2,8,2,1
11,273,273,31,31,0,1,0
3,277,277,40,25,15,4,3
34,284,284,6,6,0,1,0
25,288,288,7,1,6,2,1
13,302,302,22,22,0,1,0
37,318,318,10,10,0,1,0
20,322,322,48,48,0,1,0
16,331,331,28,28,0,1,0
9,335,335,29,3,26,2,1
28,361,361,21,21,0,1,0
38,375,375,74,74,0,1,0
6,377,377,29,29,0,1,0
39,380,380,18,18,0,1,0
7,385,385,11,11,0,1,0
15,392,392,34,6,28,2,1
24,404,404,7,7,0,1,0
21,405,405,1,1,0,1,0
8,424,424,21,7,14,4,3
17,435,435,20,20,0,1,0
4,452,452,49,40,9,4,3
29,471,471,94,94,0,1,0
2,481,481,11,11,0,1,0
10,495,495,36,36,0,1,0

19,101,101,4,4,0,1,0
1,118,118,2,2,0,1,0
18,121,121,24,24,0,1,0
7,123,123,7,7,0,1,0
24,141,141,30,30,0,1,0
14,151,151,2,2,0,1,0
10,161,161,1,1,0,1,0
8,163,163,1,1,0,1,0
2,181,181,45,34,11,2,1
15,182,182,26,26,0,1,0
21,241,241,24,24,0,1,0
16,267,267,12,12,0,1,0
28,268,268,53,10,43,4,3
0,271,271,86,30,56,3,2
27,275,275,24,2,22,3,2
5,291,291,3,3,0,1,0
12,293,293,54,14,40,2,1
13,295,295,19,4,15,4,3
3,298,298,54,23,31,2,1
22,328,328,27,3,24,4,3
17,365,365,53,53,0,1,0
4,370,370,95,66,29,4,3
29,371,371,4,4,0,1,0
11,427,427,101,101,0,1,0
20,433,433,21,21,0,1,0
9,440,440,1,1,0,1,0
26,466,466,61,32,29,2,1
6,471,471,6,6,0,1,0
23,472,472,71,71,0,1,0
25,480,480,19,3,16,3,2

13,105,105,2,2,0,1,0
5,108,108,10,10,0,1,0
23,136,136,2,2,0,1,0
26,137,137,7,7,0,1,0
12,139,139,11,11,0,1,0
24,159,159,16,13,3,2,1
19,165,165,3,3,0,1,0
18,196,196,62,20,42,3,2
22,205,205,11,11,0,1,0
6,227,227,19,5,14,2,1
10,245,245,43,3,40,3,2
4,255,255,12,12,0,1,0
9,264,264,60,7,53,4,3
3,283,283,45,45,0,1,0
28,289,289,46,20,26,2,1
20,311,311,21,21,0,1,0
17,325,325,5,5,0,1,0
15,326,326,47,47,0,1,0
7,361,361,31,2,29,2,1
1,364,364,19,19,0,1,0
21,373,373,12,12,0,1,0
25,375,375,79,25,54,3,2
27,402,402,5,2,3,2,1
16,403,403,78,78,0,1,0
2,403,403,48,42,6,3,2
11,451,451,61,30,31,2,1
0,452,452,6,3,3,2,1
30,456,456,66,12,54,3,2
14,460,460,41,41,0,1,0
29,486,486,53,28,25,2,1
8,491,491,109,109,0,1,0

16,100,100,2,2,0,1,0
27,117,117,20,20,0,1,0
3,159,159,7,4,3,2,1
17,165,165,12,12,0,1,0
2,189,189,12,12,0,1,0
22,195,195,24,6,18,4,3
4,212,212,2,2,0,1,0
35,218,218,11,2,9,2,1
32,220,220,41,8,33,2,1
8,239,239,68,20,48,4,3
20,242,242,6,3,3,2,1
33,248,248,30,7,23,2,1
7,249,249,5,5,0,1,0
14,256,256,1,1,0,1,0
11,266,266,13,1,12,3,2
24,293,293,15,15,0,1,0
6,301,301,6,6,0,1,0
25,315,315,20,20,0,1,0
38,327,327,5,5,0,1,0
30,331,331,1,1,0,1,0
23,332,332,30,2,28,2,1
29,340,340,89,2,87,4,3
19,345,345,6,1,5,2,1
21,347,347,2,2,0,1,0
9,360,360,43,43,0,1,0
36,360,360,13,5,8,3,2
34,393,393,129,91,38,3,2
12,399,399,14,14,0,1,0
5,416,416,19,19,0,1,0
26,422,422,48,48,0,1,0
18,433,433,76,76,0,1,0
31,433,433,12,12,0,1,0
37,436,436,7,7,0,1,0
10,452,452,78,50,28,3,2
28,455,455,42,36,6,2,1
15,462,462,118,118,0,1,0
1,482,482,7,3,4,2,1
13,487,487,11,11,0,1,0
0,487,487,3,3,0,1,0

19,100,100,3,3,0,1,0
6,107,107,3,3,0,1,0
15,112,112,1,1,0,1,0
29,116,116,30,30,0,1,0
18,132,132,25,8,17,2,1
0,132,132,18,18,0,1,0
17,136,136,7,7,0,1,0
1,160,160,18,18,0,1,0
23,162,162,21,21,0,1,0
4,173,173,1,1,0,1,0
3,203,203,1,1,0,1,0
22,206,206,8,8,0,1,0
25,243,243,19,13,6,2,1
32,278,278,52,52,0,1,0
31,279,279,5,5,0,1,0
20,310,310,1,1,0,1,0
28,320,320,71,71,0,1,0
21,333,333,30,30,0,1,0
8,338,338,31,31,0,1,0
33,368,368,5,5,0,1,0
2,376,376,34,34,0,1,0
26,379,379,102,102,0,1,0
16,380,380,13,7,6,2,1
12,393,393,1,1,0,1,0
27,396,396,15,9,6,3,2
10,404,404,31,31,0,1,0
5,409,409,127,72,55,4,3
7,424,424,55,22,33,2,1
13,430,430,6,6,0,1,0
14,431,431,15,15,0,1,0
24,432,432,8,8,0,1,0
30,457,457,25,5,20,3,2
11,462,462,128,32,96,3,2
9,463,463,91,18,73,4,3

21,101,101,9,6,3,2,1
6,108,108,2,2,0,1,0
17,121,121,3,3,0,1,0
22,125,125,16,16,0,1,0
13,140,140,28,21,7,2,1
8,148,148,3,3,0,1,0
5,151,151,44,31,13,2,1
14,215,215,30,30,0,1,0
12,261,261,2,2,0,1,0
15,284,284,83,20,63,4,3
2,309,309,53,50,3,2,1
18,313,313,45,45,0,1,0
1,334,334,3,3,0,1,0
16,345,345,4,4,0,1,0
3,361,361,200,191,9,4,3
20,361,361,75,75,0,1,0
19,397,397,12,3,9,4,3
10,424,424,79,79,0,1,0
7,433,433,44,44,0,1,0
0,451,451,182,182,0,1,0
4,467,467,73,13,60,4,3
11,473,473,13,3,10,2,1
9,500,500,16,4,12,4,3

33,121,121,5,2,3,2,1
19,128,128,5,5,0,1,0
29,129,129,6,6,0,1,0
9,136,136,5,5,0,1,0
22,179,179,41,41,0,1,0
13,223,223,3,3,0,1,0
26,224,224,14,10,4,2,1
16,228,228,5,5,0,1,0
1,230,230,1,1,0,1,0
27,253,253,89,89,0,1,0
3,271,271,10,2,8,2,1
23,275,275,13,4,9,4,3
15,291,291,67,20,47,2,1
17,303,303,8,8,0,1,0
28,311,311,18,18,0,1,0
8,327,327,38,38,0,1,0
12,382,382,41,41,0,1,0
4,395,395,42,42,0,1,0
32,396,396,5,5,0,1,0
0,406,406,59,20,39,2,1
11,406,406,96,45,51,3,2
31,415,415,3,3,0,1,0
21,418,418,62,62,0,1,0
24,422,422,152,88,64,4,3
7,426,426,89,89,0,1,0
30,428,428,9,9,0,1,0
14,436,436,9,9,0,1,0
18,443,443,29,29,0,1,0
5,448,448,12,5,7,2,1
10,450,450,34,6,28,2,1
20,451,451,53,53,0,1,0
25,457,457,15,15,0,1,0
6,489,489,70,22,48,2,1
2,498,498,22,22,0,1,0

18,107,107,6,6,0,1,0
20,121,121,6,6,0,1,0
19,126,126,18,18,0,1,0
9,126,126,2,2,0,1,0
1,133,133,1,1,0,1,0
26,149,149,1,1,0,1,0
10,175,175,36,15,21,2,1
21,184,184,32,32,0,1,0
8,197,197,27,7,20,3,2
15,209,209,26,17,9,4,3
29,216,216,4,4,0,1,0
0,218,218,17,17,0,1,0
24,259,259,15,9,6,3,2
12,268,268,4,4,0,1,0
30,279,279,33,17,16,3,2
28,281,281,28,14,14,2,1
17,291,291,96,39,57,4,3
22,308,308,61,61,0,1,0
2,310,310,26,26,0,1,0
7,340,340,31,7,24,3,2
14,356,356,56,12,44,2,1
3,378,378,74,36,38,4,3
25,380,380,36,21,15,2,1
27,383,383,4,4,0,1,0
6,403,403,4,4,0,1,0
11,428,428,62,62,0,1,0
4,430,430,22,3,19,2,1
31,450,450,79,79,0,1,0
5,450,450,62,41,21,4,3
23,483,483,20,20,0,1,0
13,486,486,71,25,46,2,1
16,490,490,24,13,11,2,1

14,102,102,14,5,9,4,3
4,121,121,34,34,0,1,0
20,132,132,13,9,4,2,1
23,169,169,8,8,0,1,0
26,182,182,40,31,9,2,1
17,185,185,16,13,3,2,1
10,208,208,56,56,0,1,0
27,212,212,5,1,4,2,1
0,254,254,17,17,0,1,0
25,259,259,1,1,0,1,0
1,265,265,18,6,12,4,3
19,265,265,37,1,36,4,3
22,274,274,23,6,17,2,1
24,290,290,11,11,0,1,0
12,302,302,37,37,0,1,0
8,305,305,13,13,0,1,0
18,353,353,36,8,28,2,1
29,353,353,68,68,0,1,0
28,372,372,54,13,41,2,1
5,374,374,42,25,17,2,1
16,377,377,20,1,19,3,2
3,394,394,1,1,0,1,0
13,414,414,80,80,0,1,0
6,430,430,27,27,0,1,0
11,436,436,26,4,22,2,1
7,438,438,70,37,33,4,3
2,476,476,27,19,8,3,2
15,477,477,37,37,0,1,0
9,480,480,50,24,26,4,3
21,498,498,95,55,40,3,2

29,105,105,2,2,0,1,0
19,113,113,13,7,6,3,2
7,116,116,61,61,0,1,0
11,128,128,1,1,0,1,0
16,129,129,4,4,0,1,0
5,145,145,2,2,0,1,0
27,169,169,69,34,35,2,1
24,187,187,32,17,15,4,3
25,191,191,14,14,0,1,0
13,206,206,4,4,0,1,0
23,219,219,5,5,0,1,0
18,243,243,26,4,22,3,2
12,245,245,25,25,0,1,0
26,247,247,5,5,0,1,0
22,264,264,9,1,8,3,2
8,306,306,34,34,0,1,0
28,312,312,55,52,3,2,1
14,322,322,14,14,0,1,0
2,358,358,17,3,14,3,2
3,381,381,1,1,0,1,0
10,382,382,144,115,29,2,1
1,385,385,8,8,0,1,0
0,396,396,24,24,0,1,0
17,403,403,23,23,0,1,0
21,410,410,17,4,13,2,1
6,431,431,57,57,0,1,0
9,465,465,39,4,35,3,2
4,472,472,25,25,0,1,0
15,481,481,35,5,30,2,1
20,488,488,106,70,36,4,3
30,498,498,31,16,15,4,3

26,112,112,2,2,0,1,0
15,119,119,22,22,0,1,0
16,121,121,3,3,0,1,0
2,121,121,45,14,31,2,1
20,121,121,4,4,0,1,0
14,171,171,2,2,0,1,0
8,177,177,8,8,0,1,0
10,196,196,8,8,0,1,0
4,197,197,12,1,11,2,1
30,217,217,6,6,0,1,0
28,222,222,29,7,22,2,1
32,228,228,30,6,24,4,3
6,236,236,17,17,0,1,0
13,237,237,2,2,0,1,0
18,237,237,21,18,3,2,1
23,257,257,51,51,0,1,0
3,257,257,13,13,0,1,0
11,276,276,9,9,0,1,0
0,287,287,101,13,88,4,3
29,295,295,56,56,0,1,0
22,309,309,13,1,12,4,3
5,319,319,28,10,18,4,3
1,320,320,2,2,0,1,0
21,344,344,6,6,0,1,0
24,347,347,1,1,0,1,0
31,364,364,102,102,0,1,0
27,368,368,34,12,22,2,1
17,379,379,3,3,0,1,0
25,381,381,37,37,0,1,0
7,384,384,50,28,22,2,1
9,416,416,22,9,13,2,1
12,452,452,34,34,0,1,0
19,487,487,133,103,30,4,3

13,124,124,34,34,0,1,0
26,145,145,9,9,0,1,0
2,173,173,10,7,3,2,1
30,179,179,93,34,59,4,3
24,193,193,13,1,12,4,3
6,194,194,3,3,0,1,0
9,198,198,12,12,0,1,0
23,202,202,45,45,0,1,0
31,208,208,17,6,11,2,1
10,216,216,1,1,0,1,0
4,240,240,18,2,16,2,1
16,248,248,34,34,0,1,0
28,257,257,28,18,10,3,2
1,260,260,14,8,6,3,2
12,266,266,18,18,0,1,0
25,267,267,20,12,8,3,2
5,278,278,19,19,0,1,0
8,284,284,16,16,0,1,0
21,294,294,20,20,0,1,0
29,346,346,40,26,14,3,2
19,355,355,16,16,0,1,0
18,375,375,8,8,0,1,0
22,379,379,13,7,6,2,1
3,391,391,1,1,0,1,0
15,399,399,11,2,9,4,3
17,412,412,9,4,5,2,1
27,429,429,17,6,11,2,1
14,438,438,1,1,0,1,0
0,442,442,289,202,87,4,3
7,464,464,15,15,0,1,0
11,465,465,69,23,46,3,2
20,472,472,4,4,0,1,0

23,109,109,1,1,0,1,0
0,111,111,4,4,0,1,0
12,113,113,22,22,0,1,0
15,133,133,3,3,0,1,0
26,136,136,10,3,7,2,1
22,144,144,31,31,0,1,0
19,145,145,10,10,0,1,0
17,202,202,57,29,28,2,1
18,216,216,40,40,0,1,0
7,218,218,14,5,9,2,1
20,228,228,5,2,3,2,1
27,264,264,40,8,32,3,2
5,315,315,232,176,56,4,3
2,333,333,3,3,0,1,0
9,335,335,6,6,0,1,0
11,360,360,32,24,8,2,1
3,360,360,86,56,30,4,3
25,369,369,59,59,0,1,0
21,376,376,9,9,0,1,0
8,391,391,9,9,0,1,0
13,392,392,42,32,10,3,2
10,413,413,1,1,0,1,0
16,432,432,19,12,7,2,1
1,455,455,32,11,21,4,3
14,462,462,37,9,28,3,2
6,469,469,119,25,94,3,2
4,471,471,29,29,0,1,0
24,496,496,1,1,0,1,0

9,135,135,30,30,0,1,0
25,149,149,28,10,18,3,2
4,159,159,20,2,18,2,1
11,188,188,1,1,0,1,0
5,203,203,8,8,0,1,0
16,206,206,58,58,0,1,0
2,223,223,3,3,0,1,0
3,240,240,75,75,0,1,0
8,244,244,16,3,13,3,2
12,244,244,8,8,0,1,0
24,304,304,64,64,0,1,0
13,304,304,9,9,0,1,0
17,324,324,14,14,0,1,0
14,337,337,3,3,0,1,0
6,364,364,112,37,75,4,3
20,372,372,98,73,25,4,3
7,391,391,123,77,46,3,2
22,397,397,39,16,23,2,1
0,412,412,14,14,0,1,0
10,425,425,54,54,0,1,0
23,429,429,53,8,45,2,1
18,431,431,35,15,20,4,3
15,451,451,11,11,0,1,0
1,466,466,80,80,0,1,0
19,477,477,42,42,0,1,0
21,480,480,8,4,4,2,1

29,108,108,4,4,0,1,0
5,114,114,1,1,0,1,0
8,161,161,8,8,0,1,0
23,162,162,11,11,0,1,0
1,167,167,15,1,14,3,2
11,178,178,8,8,0,1,0
30,181,181,20,11,9,4,3
31,186,186,25,20,5,2,1
9,194,194,3,3,0,1,0
22,203,203,62,26,36,2,1
15,205,205,63,21,42,3,2
20,207,207,23,23,0,1,0
0,212,212,14,5,9,2,1
2,221,221,46,46,0,1,0
24,224,224,18,18,0,1,0
28,229,229,21,8,13,3,2
18,268,268,26,6,20,3,2
17,288,288,29,29,0,1,0
25,316,316,3,3,0,1,0
10,325,325,53,53,0,1,0
13,332,332,27,27,0,1,0
4,343,343,5,2,3,2,1
7,358,358,41,7,34,3,2
26,384,384,12,12,0,1,0
3,404,404,76,76,0,1,0
27,418,418,32,25,7,2,1
6,473,473,9,2,7,3,2
19,475,475,11,11,0,1,0
21,482,482,100,100,0,1,0
14,483,483,28,28,0,1,0
12,483,483,80,24,56,3,2
32,489,489,74,32,42,4,3
16,496,496,3,3,0,1,0

30,147,147,9,4,5,2,1
0,210,210,33,33,0,1,0
16,258,258,54,38,16,3,2
29,275,275,19,19,0,1,0
27,276,276,7,1,6,3,2
15,286,286,17,7,10,3,2
5,300,300,47,47,0,1,0
10,309,309,55,55,0,1,0
6,317,317,1,1,0,1,0
28,321,321,9,2,7,2,1
20,350,350,134,99,35,2,1
22,358,358,35,35,0,1,0
23,380,380,33,8,25,4,3
17,395,395,38,16,22,2,1
19,417,417,25,25,0,1,0
9,421,421,5,5,0,1,0
2,422,422,46,46,0,1,0
1,437,437,49,49,0,1,0
7,438,438,151,43,108,4,3
8,438,438,70,70,0,1,0
25,444,444,43,23,20,3,2
4,447,447,41,41,0,1,0
21,448,448,5,1,4,2,1
14,457,457,23,11,12,3,2
12,457,457,3,3,0,1,0
18,459,459,2,2,0,1,0
13,460,460,10,10,0,1,0
24,477,477,96,42,54,3,2
3,485,485,76,43,33,2,1
11,487,487,20,20,0,1,0
26,499,499,69,24,45,2,1

14,106,106,15,12,3,2,1
31,109,109,10,10,0,1,0
32,115,115,14,4,10,3,2
24,124,124,4,4,0,1,0
8,126,126,24,24,0,1,0
0,139,139,6,2,4,2,1
15,161,161,1,1,0,1,0
22,174,174,15,15,0,1,0
30,178,178,27,12,15,4,3
16,187,187,10,3,7,2,1
10,188,188,1,1,0,1,0
7,208,208,13,4,9,2,1
19,217,217,3,3,0,1,0
20,233,233,77,61,16,2,1
25,241,241,16,4,12,4,3
11,252,252,7,7,0,1,0
3,259,259,26,22,4,2,1
6,265,265,11,6,5,2,1
27,287,287,25,25,0,1,0
12,291,291,51,7,44,2,1
4,355,355,11,6,5,2,1
23,357,357,13,13,0,1,0
5,366,366,6,6,0,1,0
17,372,372,27,8,19,2,1
1,375,375,4,4,0,1,0
9,397,397,59,59,0,1,0
21,425,425,4,4,0,1,0
26,433,433,42,42,0,1,0
13,438,438,14,5,9,4,3
29,451,451,33,33,0,1,0
18,457,457,58,52,6,2,1
2,460,460,238,238,0,1,0
28,493,493,116,88,28,3,2

22,111,111,8,8,0,1,0
5,117,117,20,15,5,2,1
9,149,149,19,19,0,1,0
7,150,150,25,8,17,2,1
1,158,158,9,9,0,1,0
11,179,179,1,1,0,1,0
2,184,184,11,11,0,1,0
20,205,205,2,2,0,1,0
21,210,210,70,40,30,3,2
31,234,234,9,2,7,2,1
26,253,253,33,33,0,1,0
3,261,261,60,22,38,2,1
0,264,264,46,46,0,1,0
24,270,270,16,1,15,4,3
8,285,285,22,4,18,3,2
19,285,285,60,60,0,1,0
27,320,320,91,91,0,1,0
15,328,328,40,28,12,4,3
28,332,332,51,1,50,4,3
10,336,336,11,11,0,1,0
18,346,346,11,1,10,3,2
12,359,359,8,8,0,1,0
16,360,360,52,8,44,3,2
25,372,372,20,6,14,3,2
23,376,376,8,8,0,1,0
30,408,408,7,2,5,2,1
4,414,414,9,9,0,1,0
32,423,423,52,13,39,4,3
29,431,431,12,12,0,1,0
17,445,445,30,30,0,1,0
14,456,456,4,4,0,1,0
6,456,456,1,1,0,1,0
13,475,475,85,74,11,2,1

19,100,100,3,3,0,1,0
12,102,102,6,6,0,1,0
16,110,110,3,3,0,1,0
10,118,118,28,28,0,1,0
7,172,172,15,3,12,3,2
11,180,180,45,45,0,1,0
21,192,192,39,39,0,1,0
17,212,212,4,4,0,1,0
18,223,223,34,34,0,1,0
9,226,226,10,1,9,2,1
14,260,260,43,43,0,1,0
20,273,273,22,2,20,3,2
22,275,275,43,43,0,1,0
0,281,281,4,4,0,1,0
8,283,283,6,6,0,1,0
23,314,314,30,30,0,1,0
3,315,315,84,57,27,4,3
4,324,324,26,1,25,2,1
15,332,332,4,4,0,1,0
2,355,355,218,218,0,1,0
13,378,378,33,33,0,1,0
5,395,395,111,20,91,4,3
6,474,474,10,10,0,1,0
1,483,483,114,39,75,3,2

29,123,123,20,4,16,3,2
2,124,124,36,26,10,2,1
5,144,144,32,32,0,1,0
23,160,160,2,2,0,1,0
13,168,168,4,4,0,1,0
17,172,172,3,3,0,1,0
28,188,188,31,31,0,1,0
6,193,193,15,15,0,1,0
9,232,232,9,3,6,3,2
15,236,236,31,8,23,2,1
14,246,246,47,47,0,1,0
27,246,246,13,13,0,1,0
0,268,268,4,4,0,1,0
30,286,286,49,34,15,4,3
10,294,294,1,1,0,1,0
11,297,297,22,2,20,2,1
4,322,322,24,1,23,2,1
3,324,324,28,14,14,2,1
20,333,333,66,66,0,1,0
22,335,335,60,30,30,3,2
19,360,360,53,53,0,1,0
21,361,361,14,14,0,1,0
16,362,362,64,64,0,1,0
12,379,379,1,1,0,1,0
25,385,385,1,1,0,1,0
31,407,407,7,7,0,1,0
8,412,412,11,3,8,2,1
26,420,420,18,18,0,1,0
7,429,429,109,91,18,4,3
24,454,454,39,39,0,1,0
18,460,460,71,71,0,1,0
1,480,480,43,20,23,2,1

32,103,103,35,35,0,1,0
21,106,106,2,2,0,1,0
8,114,114,2,2,0,1,0
26,129,129,18,18,0,1,0
4,134,134,1,1,0,1,0
28,141,141,12,12,0,1,0
16,149,149,1,1,0,1,0
29,175,175,31,21,10,3,2
23,187,187,2,2,0,1,0
20,201,201,3,3,0,1,0
1,211,211,7,7,0,1,0
30,247,247,18,18,0,1,0
25,256,256,32,32,0,1,0
18,286,286,11,3,8,3,2
27,288,288,27,27,0,1,0
13,315,315,9,1,8,3,2
15,315,315,58,58,0,1,0
12,324,324,79,46,33,4,3
19,333,333,42,42,0,1,0
2,341,341,27,11,16,2,1
31,355,355,13,7,6,2,1
6,356,356,10,10,0,1,0
10,357,357,41,41,0,1,0
11,394,394,88,41,47,2,1
7,398,398,26,4,22,3,2
17,421,421,2,2,0,1,0
24,440,440,73,56,17,2,1
5,469,469,4,4,0,1,0
14,469,469,11,1,10,3,2
9,477,477,63,63,0,1,0
3,480,480,66,66,0,1,0
0,481,481,126,126,0,1,0
33,495,495,63,63,0,1,0
22,500,500,34,34,0,1,0

6,102,102,34,34,0,1,0
9,107,107,49,13,36,2,1
2,112,112,2,2,0,1,0
11,118,118,12,12,0,1,0
1,121,121,32,18,14,2,1
17,134,134,14,14,0,1,0
14,146,146,22,12,10,3,2
18,153,153,52,47,5,2,1
16,156,156,9,6,3,2,1
23,168,168,34,34,0,1,0
7,175,175,16,1,15,4,3
13,177,177,11,3,8,3,2
25,177,177,6,6,0,1,0
22,190,190,12,6,6,2,1
10,216,216,28,12,16,3,2
8,216,216,21,17,4,2,1
24,280,280,24,24,0,1,0
5,281,281,17,2,15,4,3
0,289,289,7,1,6,2,1
12,293,293,1,1,0,1,0
3,311,311,34,34,0,1,0
21,313,313,15,1,14,3,2
4,386,386,6,6,0,1,0
15,386,386,58,58,0,1,0
20,408,408,11,1,10,4,3
26,443,443,44,10,34,3,2
19,499,499,55,49,6,2,1

18,103,103,2,2,0,1,0
2,103,103,19,19,0,1,0
25,105,105,10,10,0,1,0
0,108,108,1,1,0,1,0
10,115,115,20,20,0,1,0
19,116,116,20,3,17,3,2
26,128,128,21,6,15,4,3
16,128,128,4,4,0,1,0
21,132,132,23,23,0,1,0
6,142,142,25,25,0,1,0
23,144,144,9,3,6,3,2
8,152,152,2,2,0,1,0
14,157,157,27,27,0,1,0
24,176,176,5,5,0,1,0
20,243,243,5,2,3,2,1
3,250,250,3,3,0,1,0
1,258,258,38,38,0,1,0
4,266,266,71,25,46,3,2
22,305,305,1,1,0,1,0
15,306,306,17,9,8,3,2
13,326,326,26,13,13,2,1
7,373,373,99,62,37,4,3
5,394,394,102,102,0,1,0
17,416,416,87,53,34,2,1
11,466,466,77,62,15,4,3
12,495,495,97,10,87,4,3
9,497,497,47,16,31,2,1

18,108,108,29,29,0,1,0
13,109,109,11,5,6,2,1
3,126,126,8,4,4,2,1
12,126,126,1,1,0,1,0
17,155,155,6,6,0,1,0
29,163,163,4,4,0,1,0
23,184,184,14,14,0,1,0
19,191,191,5,5,0,1,0
9,197,197,35,7,28,4,3
30,206,206,5,5,0,1,0
25,232,232,1,1,0,1,0
4,236,236,14,14,0,1,0
2,244,244,38,18,20,3,2
32,271,271,8,8,0,1,0
15,284,284,1,1,0,1,0
16,291,291,19,1,18,4,3
20,305,305,5,5,0,1,0
22,317,317,13,13,0,1,0
24,327,327,32,32,0,1,0
31,328,328,139,92,47,2,1
7,337,337,48,48,0,1,0
26,342,342,46,38,8,3,2
0,354,354,4,4,0,1,0
14,373,373,13,2,11,2,1
5,374,374,34,34,0,1,0
1,401,401,51,51,0,1,0
28,408,408,50,36,14,3,2
10,417,417,42,42,0,1,0
21,439,439,49,49,0,1,0
11,478,478,55,22,33,4,3
8,494,494,1,1,0,1,0
27,497,497,92,29,63,4,3
6,499,499,171,171,0,1,0

10,103,103,5,5,0,1,0
12,113,113,22,22,0,1,0
8,117,117,1,1,0,1,0
32,142,142,14,14,0,1,0
20,142,142,11,1,10,2,1
30,152,152,8,8,0,1,0
26,160,160,16,16,0,1,0
3,167,167,35,35,0,1,0
1,170,170,16,3,13,2,1
21,173,173,2,2,0,1,0
5,182,182,3,3,0,1,0
6,207,207,46,46,0,1,0
18,232,232,82,82,0,1,0
4,244,244,19,19,0,1,0
27,248,248,27,27,0,1,0
22,270,270,21,17,4,2,1
17,277,277,19,13,6,2,1
2,309,309,74,74,0,1,0
31,330,330,22,22,0,1,0
11,331,331,41,41,0,1,0
13,336,336,27,7,20,2,1
9,341,341,1,1,0,1,0
15,354,354,10,10,0,1,0
28,357,357,12,12,0,1,0
25,358,358,94,43,51,4,3
7,373,373,13,9,4,2,1
29,382,382,100,100,0,1,0
19,389,389,3,3,0,1,0
23,403,403,10,10,0,1,0
16,411,411,78,41,37,3,2
24,434,434,12,5,7,2,1
0,452,452,10,5,5,2,1
14,460,460,3,3,0,1,0

17,107,107,2,2,0,1,0
12,126,126,1,1,0,1,0
0,138,138,1,1,0,1,0
1,150,150,24,24,0,1,0
20,151,151,9,9,0,1,0
26,186,186,18,12,6,2,1
21,187,187,36,18,18,3,2
11,193,193,48,48,0,1,0
22,214,214,34,12,22,2,1
13,223,223,17,13,4,2,1
24,231,231,49,49,0,1,0
4,263,263,1,1,0,1,0
9,264,264,21,21,0,1,0
15,269,269,108,39,69,4,3
25,272,272,1,1,0,1,0
29,308,308,5,2,3,2,1
23,320,320,1,1,0,1,0
5,327,327,21,6,15,4,3
27,355,355,2,2,0,1,0
18,357,357,155,143,12,3,2
10,361,361,25,25,0,1,0
6,384,384,30,21,9,2,1
19,406,406,38,4,34,3,2
30,418,418,20,20,0,1,0
7,428,428,42,18,24,3,2
3,430,430,29,29,0,1,0
31,434,434,15,5,10,3,2
14,439,439,30,30,0,1,0
2,457,457,24,24,0,1,0
16,460,460,84,66,18,4,3
28,478,478,34,34,0,1,0
8,497,497,59,15,44,3,2

26,117,117,6,6,0,1,0
17,121,121,28,28,0,1,0
8,121,121,17,13,4,2,1
28,134,134,25,25,0,1,0
13,167,167,2,2,0,1,0
3,170,170,12,12,0,1,0
16,178,178,10,10,0,1,0
27,188,188,7,7,0,1,0
18,206,206,19,14,5,2,1
11,226,226,37,6,31,2,1
23,230,230,17,3,14,2,1
10,257,257,33,33,0,1,0
9,273,273,49,49,0,1,0
19,281,281,29,29,0,1,0
25,284,284,10,10,0,1,0
5,304,304,17,8,9,4,3
12,339,339,17,17,0,1,0
22,350,350,61,11,50,2,1
21,359,359,8,2,6,2,1
0,376,376,34,34,0,1,0
14,408,408,10,3,7,2,1
24,416,416,167,23,144,4,3
4,417,417,23,23,0,1,0
29,425,425,23,17,6,3,2
20,430,430,5,1,4,2,1
1,430,430,13,13,0,1,0
6,434,434,102,102,0,1,0
2,445,445,47,47,0,1,0
30,446,446,2,2,0,1,0
31,462,462,44,44,0,1,0
7,473,473,110,61,49,2,1
15,500,500,13,7,6,2,1

11,112,112,7,7,0,1,0
28,114,114,2,2,0,1,0
27,131,131,7,3,4,2,1
4,132,132,20,20,0,1,0
17,132,132,4,4,0,1,0
3,135,135,11,11,0,1,0
25,158,158,6,1,5,2,1
5,161,161,14,14,0,1,0
22,195,195,38,15,23,2,1
16,197,197,9,9,0,1,0
14,201,201,58,7,51,4,3
19,217,217,15,5,10,2,1
10,232,232,36,36,0,1,0
13,236,236,5,5,0,1,0
20,272,272,39,18,21,4,3
26,274,274,64,29,35,2,1
12,286,286,8,5,3,2,1
21,292,292,10,10,0,1,0
24,338,338,16,16,0,1,0
0,339,339,19,19,0,1,0
2,348,348,16,2,14,3,2
1,350,350,1,1,0,1,0
8,352,352,53,53,0,1,0
29,379,379,78,6,72,3,2
23,397,397,56,56,0,1,0
15,407,407,21,9,12,3,2
30,409,409,28,13,15,2,1
31,421,421,34,18,16,2,1
6,427,427,104,82,22,2,1
18,435,435,103,34,69,4,3
7,486,486,34,34,0,1,0
9,495,495,52,52,0,1,0

35,110,110,3,3,0,1,0
2,116,116,7,7,0,1,0
7,133,133,5,5,0,1,0
9,142,142,1,1,0,1,0
3,164,164,1,1,0,1,0
21,168,168,7,7,0,1,0
16,171,171,1,1,0,1,0
13,193,193,8,1,7,2,1
0,219,219,47,47,0,1,0
12,223,223,13,13,0,1,0
24,224,224,7,3,4,2,1
15,245,245,9,3,6,3,2
23,252,252,20,20,0,1,0
20,253,253,35,23,12,4,3
38,261,261,15,7,8,2,1
39,269,269,20,20,0,1,0
17,273,273,10,10,0,1,0
31,274,274,16,7,9,2,1
1,278,278,5,1,4,2,1
34,332,332,16,16,0,1,0
6,343,343,27,24,3,2,1
19,349,349,63,18,45,2,1
4,358,358,27,27,0,1,0
5,358,358,36,30,6,2,1
36,369,369,3,3,0,1,0
14,377,377,15,6,9,4,3
37,389,389,106,1,105,4,3
10,396,396,1,1,0,1,0
28,404,404,16,3,13,4,3
33,406,406,10,10,0,1,0
26,412,412,132,56,76,3,2
8,430,430,20,6,14,2,1
25,443,443,51,4,47,4,3
18,443,443,20,20,0,1,0
32,453,453,70,26,44,2,1
29,458,458,6,6,0,1,0
27,471,471,28,28,0,1,0
40,485,485,159,159,0,1,0
11,486,486,95,95,0,1,0
22,488,488,12,6,6,3,2
30,489,489,11,5,6,3,2

29,137,137,36,36,0,1,0
18,196,196,6,6,0,1,0
5,199,199,7,7,0,1,0
12,225,225,14,4,10,2,1
1,237,237,11,11,0,1,0
11,241,241,15,5,10,2,1
21,242,242,21,11,10,2,1
4,263,263,31,31,0,1,0
25,278,278,47,18,29,4,3
27,296,296,5,5,0,1,0
6,306,306,23,23,0,1,0
23,314,314,52,10,42,4,3
24,326,326,23,18,5,2,1
19,331,331,2,2,0,1,0
17,342,342,20,1,19,2,1
8,346,346,39,39,0,1,0
9,356,356,112,77,35,2,1
26,367,367,3,3,0,1,0
2,367,367,30,5,25,2,1
16,368,368,33,4,29,2,1
28,369,369,1,1,0,1,0
7,374,374,59,59,0,1,0
3,393,393,13,13,0,1,0
20,431,431,95,55,40,4,3
22,449,449,26,1,25,4,3
14,449,449,63,32,31,2,1
0,467,467,38,28,10,3,2
30,468,468,23,9,14,3,2
32,474,474,43,13,30,3,2
31,488,488,163,91,72,4,3
10,496,496,22,22,0,1,0
15,498,498,38,2,36,4,3
13,498,498,35,15,20,2,1

23,126,126,12,12,0,1,0
12,128,128,14,14,0,1,0
19,130,130,1,1,0,1,0
1,135,135,11,8,3,2,1
4,147,147,26,26,0,1,0
3,159,159,9,9,0,1,0
8,180,180,32,16,16,2,1
21,193,193,10,10,0,1,0
10,197,197,69,69,0,1,0
17,207,207,23,23,0,1,0
24,208,208,11,5,6,2,1
5,246,246,1,1,0,1,0
18,267,267,3,3,0,1,0
6,270,270,51,25,26,2,1
7,284,284,24,4,20,2,1
13,284,284,41,41,0,1,0
15,286,286,38,38,0,1,0
20,289,289,76,76,0,1,0
25,306,306,13,13,0,1,0
27,318,318,71,19,52,3,2
2,356,356,9,9,0,1,0
11,362,362,22,22,0,1,0
14,405,405,54,54,0,1,0
16,409,409,30,15,15,2,1
9,415,415,22,2,20,3,2
28,416,416,59,31,28,3,2
22,464,464,15,15,0,1,0
26,478,478,50,1,49,2,1
0,494,494,43,43,0,1,0
29,499,499,73,66,7,2,1

5,127,127,10,10,0,1,0
13,141,141,12,12,0,1,0
28,145,145,27,7,20,3,2
29,162,162,26,4,22,3,2
23,169,169,3,3,0,1,0
17,194,194,13,13,0,1,0
19,209,209,2,2,0,1,0
16,214,214,17,17,0,1,0
3,215,215,3,3,0,1,0
27,218,218,5,5,0,1,0
9,243,243,7,7,0,1,0
2,259,259,55,55,0,1,0
12,311,311,62,11,51,4,3
8,317,317,6,6,0,1,0
15,338,338,2,2,0,1,0
20,341,341,23,3,20,3,2
30,351,351,22,22,0,1,0
22,355,355,82,82,0,1,0
25,365,365,5,5,0,1,0
24,378,378,54,5,49,2,1
7,383,383,138,117,21,4,3
11,395,395,9,9,0,1,0
10,433,433,58,58,0,1,0
6,433,433,64,46,18,2,1
14,436,436,17,17,0,1,0
4,458,458,44,13,31,2,1
21,482,482,42,3,39,4,3
1,483,483,38,38,0,1,0
0,485,485,41,41,0,1,0
18,495,495,27,18,9,4,3
26,496,496,212,212,0,1,0

4,109,109,13,13,0,1,0
22,112,112,1,1,0,1,0
1,119,119,2,2,0,1,0
39,124,124,5,5,0,1,0
32,125,125,13,3,10,2,1
18,131,131,1,1,0,1,0
17,135,135,23,23,0,1,0
40,151,151,1,1,0,1,0
11,167,167,20,20,0,1,0
41,173,173,7,7,0,1,0
3,190,190,3,3,0,1,0
29,195,195,4,4,0,1,0
16,200,200,15,15,0,1,0
26,211,211,21,21,0,1,0
14,216,216,9,3,6,2,1
10,221,221,7,7,0,1,0
6,227,227,5,5,0,1,0
9,232,232,1,1,0,1,0
12,235,235,10,4,6,2,1
36,253,253,34,34,0,1,0
21,255,255,12,1,11,2,1
33,263,263,35,35,0,1,0
38,266,266,7,7,0,1,0
27,297,297,89,89,0,1,0
28,333,333,56,19,37,4,3
30,338,338,10,1,9,4,3
24,351,351,4,4,0,1,0
8,363,363,27,3,24,3,2
7,369,369,2,2,0,1,0
15,369,369,32,32,0,1,0
2,378,378,1,1,0,1,0
23,409,409,39,16,23,2,1
5,426,426,32,32,0,1,0
19,441,441,29,29,0,1,0
31,442,442,175,175,0,1,0
37,444,444,5,5,0,1,0
13,447,447,74,42,32,2,1
0,453,453,46,46,0,1,0
25,464,464,52,52,0,1,0
35,468,468,8,8,0,1,0
20,471,471,39,31,8,3,2
34,486,486,46,8,38,3,2

4,104,104,17,13,4,2,1
16,118,118,5,1,4,2,1
12,126,126,5,5,0,1,0
28,137,137,20,12,8,3,2
15,141,141,1,1,0,1,0
32,155,155,1,1,0,1,0
25,157,157,42,7,35,3,2
22,161,161,9,9,0,1,0
27,172,172,38,6,32,3,2
3,175,175,2,2,0,1,0
9,190,190,13,2,11,2,1
8,201,201,8,8,0,1,0
24,204,204,16,16,0,1,0
17,207,207,2,2,0,1,0
21,211,211,19,19,0,1,0
1,211,211,9,3,6,2,1
23,215,215,7,7,0,1,0
0,218,218,1,1,0,1,0
34,233,233,6,6,0,1,0
2,262,262,19,19,0,1,0
29,265,265,6,6,0,1,0
11,288,288,28,28,0,1,0
26,302,302,23,23,0,1,0
7,364,364,1,1,0,1,0
18,377,377,63,53,10,3,2
13,398,398,53,53,0,1,0
19,401,401,76,37,39,4,3
33,415,415,43,28,15,4,3
31,427,427,52,20,32,2,1
5,443,443,58,3,55,4,3
30,461,461,68,36,32,2,1
20,468,468,25,1,24,3,2
6,484,484,142,72,70,3,2
14,487,487,95,73,22,2,1
10,492,492,40,40,0,1,0

1,108,108,3,3,0,1,0
19,111,111,11,11,0,1,0
6,137,137,35,17,18,3,2
16,145,145,22,22,0,1,0
22,160,160,46,46,0,1,0
0,188,188,11,11,0,1,0
4,230,230,20,14,6,2,1
12,261,261,59,27,32,2,1
29,285,285,1,1,0,1,0
26,324,324,33,33,0,1,0
20,338,338,176,118,58,4,3
15,338,338,17,17,0,1,0
17,338,338,15,5,10,2,1
14,344,344,5,5,0,1,0
7,350,350,11,3,8,2,1
2,361,361,16,16,0,1,0
11,394,394,10,10,0,1,0
8,397,397,1,1,0,1,0
3,404,404,119,41,78,4,3
5,406,406,22,22,0,1,0
13,412,412,155,105,50,4,3
27,420,420,52,25,27,2,1
24,438,438,19,9,10,3,2
21,439,439,19,19,0,1,0
25,464,464,2,2,0,1,0
28,465,465,6,6,0,1,0
18,486,486,15,9,6,2,1
10,494,494,32,24,8,3,2
23,494,494,50,50,0,1,0
9,495,495,26,26,0,1,0

16,115,115,36,4,32,4,3
30,122,122,19,19,0,1,0
14,125,125,28,7,21,2,1
27,134,134,2,2,0,1,0
25,154,154,18,18,0,1,0
1,164,164,15,15,0,1,0
18,169,169,26,26,0,1,0
23,172,172,2,2,0,1,0
3,180,180,2,2,0,1,0
9,192,192,5,5,0,1,0
33,202,202,114,28,86,3,2
31,207,207,3,3,0,1,0
20,223,223,1,1,0,1,0
21,243,243,12,12,0,1,0
29,263,263,18,18,0,1,0
11,280,280,15,15,0,1,0
12,283,283,8,8,0,1,0
22,310,310,10,1,9,2,1
26,321,321,24,24,0,1,0
15,322,322,1,1,0,1,0
8,328,328,22,11,11,2,1
7,352,352,20,3,17,2,1
24,353,353,10,10,0,1,0
2,371,371,41,15,26,2,1
35,374,374,48,48,0,1,0
32,381,381,40,10,30,3,2
4,399,399,14,14,0,1,0
13,417,417,41,14,27,4,3
6,425,425,17,17,0,1,0
37,426,426,45,15,30,4,3
36,430,430,7,7,0,1,0
34,467,467,28,2,26,2,1
5,472,472,33,33,0,1,0
17,473,473,25,2,23,2,1
28,479,479,64,64,0,1,0
0,500,500,28,5,23,4,3
19,500,500,18,6,12,4,3
10,500,500,11,11,0,1,0

17,106,106,4,4,0,1,0
1,125,125,5,5,0,1,0
23,127,127,21,21,0,1,0
8,142,142,23,1,22,2,1
9,155,155,17,17,0,1,0
12,157,157,42,19,23,4,3
18,185,185,26,26,0,1,0
30,208,208,3,3,0,1,0
4,211,211,67,40,27,4,3
16,217,217,83,44,39,4,3
22,239,239,15,7,8,3,2
6,246,246,31,31,0,1,0
5,249,249,14,14,0,1,0
19,250,250,32,32,0,1,0
21,254,254,74,74,0,1,0
14,281,281,1,1,0,1,0
15,305,305,10,4,6,3,2
11,309,309,61,61,0,1,0
20,313,313,5,2,3,2,1
28,327,327,68,18,50,3,2
27,329,329,7,7,0,1,0
13,339,339,27,27,0,1,0
25,344,344,21,21,0,1,0
10,347,347,9,4,5,2,1
26,357,357,2,2,0,1,0
7,404,404,20,20,0,1,0
0,413,413,11,11,0,1,0
3,422,422,23,23,0,1,0
24,427,427,26,26,0,1,0
29,450,450,4,4,0,1,0
2,488,488,41,41,0,1,0

30,100,100,3,3,0,1,0
24,109,109,10,10,0,1,0
4,126,126,15,5,10,2,1
14,155,155,15,15,0,1,0
1,161,161,23,23,0,1,0
0,185,185,1,1,0,1,0
21,199,199,2,2,0,1,0
3,201,201,30,16,14,3,2
32,206,206,9,9,0,1,0
33,225,225,73,5,68,4,3
23,277,277,45,45,0,1,0
19,282,282,7,2,5,2,1
9,295,295,15,3,12,4,3
11,296,296,121,106,15,2,1
2,299,299,39,13,26,2,1
27,302,302,2,2,0,1,0
13,315,315,48,48,0,1,0
26,343,343,46,46,0,1,0
29,346,346,7,2,5,2,1
15,348,348,1,1,0,1,0
10,355,355,1,1,0,1,0
18,370,370,25,10,15,4,3
5,390,390,10,2,8,2,1
28,424,424,148,106,42,3,2
31,434,434,33,33,0,1,0
7,435,435,8,8,0,1,0
16,440,440,3,3,0,1,0
22,460,460,15,7,8,3,2
6,463,463,17,17,0,1,0
20,472,472,11,11,0,1,0
17,478,478,51,27,24,4,3
12,484,484,65,26,39,2,1
8,490,490,5,5,0,1,0
25,496,496,116,116,0,1,0

17,103,103,1,1,0,1,0
34,107,107,1,1,0,1,0
10,120,120,14,1,13,2,1
30,154,154,22,1,21,4,3
7,164,164,15,5,10,3,2
1,168,168,7,7,0,1,0
20,170,170,16,16,0,1,0
24,183,183,17,17,0,1,0
29,184,184,19,9,10,2,1
9,205,205,17,11,6,3,2
8,205,205,1,1,0,1,0
11,206,206,14,2,12,3,2
14,209,209,4,4,0,1,0
37,218,218,25,9,16,3,2
4,231,231,7,1,6,2,1
21,237,237,2,2,0,1,0
22,250,250,35,8,27,4,3
18,251,251,4,4,0,1,0
32,292,292,10,10,0,1,0
16,302,302,15,1,14,2,1
33,309,309,76,76,0,1,0
2,314,314,72,72,0,1,0
19,347,347,9,9,0,1,0
31,355,355,23,23,0,1,0
6,380,380,30,30,0,1,0
0,380,380,17,17,0,1,0
26,402,402,16,9,7,2,1
36,402,402,61,4,57,4,3
5,409,409,104,64,40,3,2
28,424,424,1,1,0,1,0
15,432,432,9,1,8,3,2
35,464,464,114,30,84,4,3
27,468,468,12,12,0,1,0
13,475,475,40,40,0,1,0
25,485,485,83,46,37,2,1
23,487,487,22,6,16,2,1
3,487,487,108,61,47,4,3
12,500,500,4,4,0,1,0

24,104,104,24,4,20,3,2
10,108,108,18,18,0,1,0
7,108,108,12,6,6,3,2
2,127,127,1,1,0,1,0
4,132,132,6,6,0,1,0
25,136,136,11,11,0,1,0
23,151,151,22,11,11,2,1
14,166,166,16,8,8,3,2
29,176,176,8,3,5,2,1
30,181,181,2,2,0,1,0
21,192,192,5,5,0,1,0
31,193,193,30,16,14,2,1
9,193,193,5,5,0,1,0
20,226,226,9,9,0,1,0
13,232,232,36,36,0,1,0
12,238,238,16,3,13,2,1
6,251,251,14,14,0,1,0
15,265,265,25,25,0,1,0
19,289,289,4,4,0,1,0
28,300,300,4,4,0,1,0
22,306,306,51,45,6,3,2
17,323,323,43,23,20,2,1
3,331,331,55,44,11,2,1
8,362,362,43,25,18,2,1
27,375,375,19,16,3,2,1
11,387,387,2,2,0,1,0
26,444,444,154,154,0,1,0
18,462,462,48,48,0,1,0
1,463,463,71,32,39,2,1
0,482,482,38,38,0,1,0
5,496,496,125,111,14,2,1
16,498,498,37,37,0,1,0

17,102,102,24,5,19,2,1
20,107,107,2,2,0,1,0
24,133,133,37,13,24,3,2
14,133,133,8,5,3,2,1
1,137,137,13,1,12,4,3
2,146,146,53,32,21,2,1
12,155,155,4,4,0,1,0
23,185,185,36,36,0,1,0
3,188,188,12,12,0,1,0
29,190,190,3,3,0,1,0
11,201,201,6,6,0,1,0
18,229,229,93,93,0,1,0
0,238,238,17,11,6,2,1
4,241,241,46,46,0,1,0
7,242,242,5,5,0,1,0
5,248,248,6,1,5,2,1
9,268,268,2,2,0,1,0
16,300,300,20,20,0,1,0
22,300,300,7,3,4,2,1
27,321,321,14,14,0,1,0
25,369,369,56,10,46,3,2
28,375,375,21,2,19,2,1
19,394,394,16,16,0,1,0
10,399,399,115,69,46,4,3
26,410,410,5,5,0,1,0
13,422,422,45,45,0,1,0
8,422,422,20,20,0,1,0
21,425,425,8,5,3,2,1
15,434,434,7,7,0,1,0
6,475,475,127,127,0,1,0

21,118,118,10,4,6,2,1
4,119,119,50,8,42,3,2
19,129,129,23,23,0,1,0
10,149,149,7,7,0,1,0
26,149,149,19,9,10,3,2
24,153,153,4,4,0,1,0
2,183,183,12,12,0,1,0
13,187,187,29,29,0,1,0
18,212,212,19,3,16,3,2
23,216,216,1,1,0,1,0
9,220,220,59,59,0,1,0
0,257,257,3,3,0,1,0
17,265,265,8,3,5,2,1
27,274,274,20,12,8,2,1
12,278,278,4,4,0,1,0
16,281,281,31,31,0,1,0
15,344,344,20,16,4,2,1
8,349,349,23,12,11,2,1
3,354,354,1,1,0,1,0
1,363,363,100,100,0,1,0
6,377,377,60,27,33,2,1
25,378,378,20,6,14,2,1
20,399,399,6,1,5,2,1
5,412,412,42,26,16,3,2
28,445,445,81,53,28,3,2
14,453,453,66,66,0,1,0
29,482,482,45,45,0,1,0
22,493,493,181,161,20,2,1
11,495,495,1,1,0,1,0
7,499,499,7,1,6,3,2

19,101,101,5,1,4,2,1
0,121,121,1,1,0,1,0
18,138,138,22,22,0,1,0
11,140,140,14,6,8,2,1
28,154,154,6,6,0,1,0
9,163,163,7,7,0,1,0
6,194,194,18,8,10,2,1
2,226,226,24,24,0,1,0
5,242,242,76,52,24,4,3
29,250,250,29,11,18,2,1
23,250,250,55,55,0,1,0
21,270,270,48,14,34,3,2
4,272,272,31,31,0,1,0
25,290,290,71,25,46,2,1
10,307,307,5,5,0,1,0
1,317,317,1,1,0,1,0
15,340,340,12,12,0,1,0
14,350,350,5,5,0,1,0
22,354,354,29,11,18,4,3
20,360,360,5,5,0,1,0
13,382,382,15,15,0,1,0
27,388,388,59,31,28,3,2
26,391,391,66,6,60,3,2
7,401,401,3,3,0,1,0
17,414,414,13,13,0,1,0
3,417,417,16,16,0,1,0
24,420,420,31,4,27,2,1
16,434,434,24,4,20,4,3
12,438,438,232,184,48,4,3
8,478,478,90,57,33,4,3

36,101,101,6,6,0,1,0
32,113,113,13,13,0,1,0
11,126,126,10,10,0,1,0
37,131,131,33,33,0,1,0
13,137,137,18,18,0,1,0
27,149,149,13,13,0,1,0
1,169,169,2,2,0,1,0
7,172,172,1,1,0,1,0
18,181,181,1,1,0,1,0
10,201,201,4,4,0,1,0
3,203,203,18,18,0,1,0
25,219,219,9,9,0,1,0
22,223,223,16,10,6,3,2
34,242,242,2,2,0,1,0
23,247,247,35,35,0,1,0
15,248,248,10,10,0,1,0
8,271,271,12,12,0,1,0
24,282,282,30,14,16,2,1
30,298,298,17,17,0,1,0
38,305,305,34,34,0,1,0
19,318,318,4,4,0,1,0
6,319,319,20,16,4,2,1
28,352,352,48,11,37,3,2
5,353,353,18,18,0,1,0
33,359,359,4,4,0,1,0
14,363,363,7,1,6,2,1
9,369,369,3,3,0,1,0
21,397,397,30,22,8,2,1
4,424,424,68,11,57,4,3
35,424,424,56,56,0,1,0
26,424,424,11,5,6,3,2
31,425,425,18,4,14,3,2
0,436,436,33,22,11,2,1
17,454,454,23,8,15,4,3
12,457,457,1,1,0,1,0
39,459,459,150,54,96,3,2
2,470,470,133,29,104,4,3
16,472,472,43,33,10,2,1
29,477,477,58,58,0,1,0
20,495,495,35,35,0,1,0

6,100,100,1,1,0,1,0
17,111,111,8,2,6,2,1
24,125,125,8,8,0,1,0
13,129,129,4,4,0,1,0
8,130,130,3,3,0,1,0
0,131,131,11,11,0,1,0
4,165,165,28,7,21,4,3
16,171,171,27,9,18,3,2
11,189,189,6,6,0,1,0
19,197,197,7,7,0,1,0
1,199,199,13,13,0,1,0
27,235,235,23,2,21,4,3
22,249,249,55,55,0,1,0
20,266,266,3,3,0,1,0
7,280,280,1,1,0,1,0
28,290,290,95,95,0,1,0
3,302,302,149,91,58,3,2
10,330,330,6,3,3,2,1
5,358,358,22,10,12,4,3
15,363,363,1,1,0,1,0
9,416,416,91,4,87,4,3
2,417,417,157,59,98,4,3
26,421,421,41,13,28,2,1
12,436,436,20,6,14,2,1
14,461,461,57,49,8,3,2
18,467,467,154,103,51,4,3
23,468,468,13,13,0,1,0
21,473,473,13,7,6,2,1
25,475,475,4,4,0,1,0

7,114,114,26,6,20,2,1
17,128,128,21,21,0,1,0
2,136,136,2,2,0,1,0
16,146,146,19,11,8,3,2
22,157,157,5,5,0,1,0
14,181,181,69,69,0,1,0
11,183,183,17,8,9,4,3
24,201,201,2,2,0,1,0
0,219,219,4,4,0,1,0
20,232,232,12,8,4,2,1
18,253,253,35,35,0,1,0
26,257,257,24,20,4,2,1
1,260,260,144,144,0,1,0
10,261,261,14,14,0,1,0
12,264,264,37,37,0,1,0
13,284,284,1,1,0,1,0
5,289,289,7,3,4,2,1
23,296,296,3,3,0,1,0
15,304,304,29,29,0,1,0
6,305,305,54,24,30,3,2
27,306,306,50,50,0,1,0
21,325,325,8,1,7,2,1
9,328,328,60,53,7,2,1
25,388,388,5,5,0,1,0
19,394,394,73,33,40,3,2
3,428,428,64,64,0,1,0
4,434,434,24,24,0,1,0
8,493,493,25,7,18,4,3

7,103,103,14,5,9,2,1
8,109,109,9,1,8,2,1
30,128,128,21,21,0,1,0
1,128,128,1,1,0,1,0
22,138,138,5,5,0,1,0
6,150,150,6,6,0,1,0
9,151,151,6,6,0,1,0
18,167,167,23,23,0,1,0
21,179,179,20,20,0,1,0
3,186,186,4,1,3,2,1
12,199,199,25,25,0,1,0
14,200,200,1,1,0,1,0
4,220,220,6,6,0,1,0
13,220,220,12,9,3,2,1
35,235,235,12,12,0,1,0
20,238,238,18,18,0,1,0
17,242,242,5,5,0,1,0
36,247,247,39,20,19,2,1
27,277,277,85,37,48,3,2
31,282,282,78,39,39,4,3
15,285,285,62,62,0,1,0
32,316,316,44,44,0,1,0
19,317,317,38,32,6,2,1
23,332,332,27,27,0,1,0
5,332,332,28,28,0,1,0
25,335,335,1,1,0,1,0
26,356,356,13,13,0,1,0
29,364,364,11,11,0,1,0
2,367,367,17,1,16,4,3
0,369,369,85,85,0,1,0
28,373,373,25,9,16,2,1
24,381,381,2,2,0,1,0
33,401,401,33,17,16,3,2
11,418,418,26,26,0,1,0
10,426,426,13,13,0,1,0
16,438,438,16,2,14,2,1
34,487,487,40,40,0,1,0

6,143,143,3,3,0,1,0
24,150,150,2,2,0,1,0
0,180,180,13,13,0,1,0
25,186,186,49,37,12,2,1
20,226,226,52,52,0,1,0
2,228,228,6,6,0,1,0
7,230,230,70,40,30,2,1
19,244,244,13,13,0,1,0
1,251,251,26,26,0,1,0
26,257,257,21,21,0,1,0
15,301,301,22,13,9,2,1
29,321,321,38,38,0,1,0
3,323,323,1,1,0,1,0
22,326,326,21,21,0,1,0
31,327,327,1,1,0,1,0
10,331,331,5,5,0,1,0
28,344,344,18,18,0,1,0
17,358,358,80,80,0,1,0
21,363,363,27,27,0,1,0
4,400,400,47,18,29,2,1
5,412,412,27,27,0,1,0
30,418,418,80,68,12,3,2
27,425,425,6,3,3,2,1
9,435,435,106,82,24,2,1
16,439,439,60,42,18,4,3
23,445,445,12,2,10,3,2
12,447,447,11,2,9,2,1
14,453,453,32,32,0,1,0
11,462,462,44,44,0,1,0
32,463,463,87,40,47,2,1
8,478,478,81,53,28,2,1
13,486,486,29,2,27,3,2
18,487,487,12,12,0,1,0

29,110,110,18,18,0,1,0
27,111,111,12,12,0,1,0
17,140,140,1,1,0,1,0
15,159,159,3,3,0,1,0
32,167,167,37,37,0,1,0
11,175,175,16,6,10,3,2
2,193,193,2,2,0,1,0
10,195,195,8,4,4,2,1
23,198,198,8,3,5,2,1
0,211,211,15,15,0,1,0
16,212,212,18,3,15,2,1
18,223,223,10,10,0,1,0
9,234,234,13,3,10,3,2
14,244,244,5,5,0,1,0
13,277,277,1,1,0,1,0
28,280,280,23,15,8,3,2
22,298,298,18,1,17,2,1
6,300,300,165,165,0,1,0
3,305,305,55,55,0,1,0
30,307,307,52,19,33,2,1
19,318,318,18,3,15,2,1
8,353,353,17,17,0,1,0
24,359,359,41,41,0,1,0
1,362,362,12,2,10,3,2
4,363,363,35,35,0,1,0
20,376,376,4,4,0,1,0
21,397,397,10,10,0,1,0
26,411,411,14,14,0,1,0
31,424,424,63,29,34,3,2
33,426,426,30,30,0,1,0
25,464,464,17,17,0,1,0
5,464,464,57,23,34,4,3
7,469,469,7,4,3,2,1
34,473,473,136,100,36,4,3
12,493,493,53,53,0,1,0

2,127,127,14,7,7,2,1
34,132,132,8,8,0,1,0
21,140,140,24,18,6,2,1
30,141,141,7,7,0,1,0
9,149,149,2,2,0,1,0
26,152,152,5,1,4,2,1
1,156,156,18,15,3,2,1
5,165,165,26,5,21,2,1
16,172,172,10,4,6,2,1
15,189,189,13,5,8,2,1
28,190,190,7,7,0,1,0
31,219,219,25,5,20,2,1
14,231,231,26,2,24,2,1
19,235,235,23,15,8,2,1
8,249,249,12,3,9,4,3
4,265,265,14,14,0,1,0
22,273,273,15,7,8,2,1
7,276,276,20,20,0,1,0
24,292,292,8,2,6,2,1
27,296,296,64,64,0,1,0
20,301,301,13,13,0,1,0
0,326,326,51,51,0,1,0
6,338,338,25,3,22,4,3
25,344,344,34,14,20,3,2
33,356,356,93,21,72,3,2
13,363,363,19,14,5,2,1
3,363,363,32,32,0,1,0
23,403,403,95,95,0,1,0
32,406,406,46,8,38,2,1
18,410,410,11,11,0,1,0
11,424,424,42,42,0,1,0
17,437,437,43,43,0,1,0
12,465,465,66,8,58,4,3
10,465,465,25,9,16,3,2
29,494,494,13,13,0,1,0

6,100,100,2,2,0,1,0
13,102,102,39,39,0,1,0
27,127,127,2,2,0,1,0
0,133,133,1,1,0,1,0
22,135,135,6,6,0,1,0
12,166,166,6,6,0,1,0
28,167,167,12,12,0,1,0
11,171,171,7,3,4,2,1
14,175,175,26,26,0,1,0
24,207,207,2,2,0,1,0
8,227,227,33,6,27,4,3
5,232,232,6,6,0,1,0
20,246,246,36,36,0,1,0
7,277,277,65,7,58,4,3
30,291,291,66,52,14,3,2
4,316,316,16,4,12,4,3
29,319,319,32,32,0,1,0
1,323,323,3,3,0,1,0
15,328,328,15,15,0,1,0
23,331,331,7,7,0,1,0
10,339,339,47,36,11,2,1
18,366,366,16,10,6,3,2
26,372,372,68,4,64,3,2
17,380,380,34,26,8,2,1
2,406,406,10,5,5,2,1
25,421,421,118,118,0,1,0
21,423,423,39,39,0,1,0
9,431,431,78,7,71,4,3
19,436,436,95,65,30,4,3
16,471,471,18,18,0,1,0
3,477,477,74,27,47,2,1

17,110,110,2,2,0,1,0
15,134,134,12,12,0,1,0
27,139,139,2,2,0,1,0
31,142,142,9,9,0,1,0
21,148,148,9,9,0,1,0
3,156,156,1,1,0,1,0
8,166,166,5,1,4,2,1
1,171,171,1,1,0,1,0
23,179,179,49,49,0,1,0
22,190,190,6,6,0,1,0
34,202,202,1,1,0,1,0
11,220,220,1,1,0,1,0
25,232,232,21,3,18,4,3
35,254,254,1,1,0,1,0
16,255,255,50,50,0,1,0
6,294,294,8,8,0,1,0
13,296,296,101,87,14,4,3
5,297,297,6,3,3,2,1
18,299,299,7,7,0,1,0
24,305,305,28,4,24,3,2
30,322,322,20,20,0,1,0
32,342,342,49,21,28,2,1
26,355,355,32,32,0,1,0
14,358,358,14,14,0,1,0
19,384,384,1,1,0,1,0
2,392,392,10,10,0,1,0
9,407,407,31,9,22,3,2
29,411,411,4,4,0,1,0
0,413,413,45,45,0,1,0
33,423,423,36,36,0,1,0
7,428,428,42,42,0,1,0
12,440,440,43,23,20,3,2
4,459,459,86,54,32,3,2
10,463,463,94,4,90,3,2
20,465,465,213,132,81,3,2
28,467,467,72,36,36,2,1

9,104,104,14,14,0,1,0
7,110,110,2,2,0,1,0
34,111,111,2,2,0,1,0
19,132,132,1,1,0,1,0
37,137,137,44,3,41,2,1
23,162,162,14,14,0,1,0
0,169,169,38,38,0,1,0
13,175,175,8,8,0,1,0
32,176,176,15,2,13,2,1
12,180,180,6,6,0,1,0
30,194,194,32,32,0,1,0
22,220,220,29,29,0,1,0
36,221,221,46,46,0,1,0
4,236,236,54,45,9,4,3
35,240,240,17,11,6,2,1
3,246,246,1,1,0,1,0
29,248,248,21,21,0,1,0
5,279,279,11,1,10,3,2
24,305,305,3,3,0,1,0
33,308,308,20,20,0,1,0
17,309,309,13,13,0,1,0
6,311,311,2,2,0,1,0
26,315,315,33,7,26,2,1
31,318,318,6,6,0,1,0
16,330,330,70,58,12,4,3
15,339,339,24,3,21,2,1
1,345,345,25,25,0,1,0
11,348,348,24,24,0,1,0
2,381,381,21,21,0,1,0
10,391,391,1,1,0,1,0
18,430,430,9,9,0,1,0
25,438,438,70,49,21,2,1
21,442,442,42,28,14,3,2
20,448,448,13,7,6,2,1
8,457,457,7,7,0,1,0
14,461,461,80,20,60,4,3
27,471,471,1,1,0,1,0
28,478,478,50,50,0,1,0

22,120,120,17,17,0,1,0
3,144,144,32,18,14,2,1
26,146,146,37,11,26,3,2
0,155,155,4,4,0,1,0
8,167,167,1,1,0,1,0
12,171,171,3,3,0,1,0
6,171,171,5,5,0,1,0
35,173,173,3,3,0,1,0
29,174,174,13,13,0,1,0
25,175,175,52,52,0,1,0
1,190,190,4,4,0,1,0
11,191,191,9,9,0,1,0
33,195,195,1,1,0,1,0
18,197,197,41,21,20,3,2
16,201,201,16,1,15,2,1
34,212,212,7,7,0,1,0
20,215,215,16,2,14,3,2
31,248,248,3,3,0,1,0
36,261,261,43,34,9,4,3
14,269,269,21,21,0,1,0
15,272,272,22,22,0,1,0
21,292,292,20,20,0,1,0
5,298,298,31,4,27,4,3
30,303,303,10,3,7,2,1
4,317,317,10,10,0,1,0
17,323,323,2,2,0,1,0
10,323,323,18,18,0,1,0
9,341,341,26,26,0,1,0
38,345,345,58,58,0,1,0
23,385,385,24,24,0,1,0
2,402,402,25,25,0,1,0
32,409,409,61,61,0,1,0
27,417,417,46,46,0,1,0
28,424,424,89,89,0,1,0
37,434,434,11,11,0,1,0
7,450,450,15,15,0,1,0
24,488,488,6,1,5,2,1
13,489,489,60,7,53,3,2
19,499,499,7,2,5,2,1

3,162,162,5,5,0,1,0
11,165,165,1,1,0,1,0
1,183,183,5,5,0,1,0
15,194,194,16,1,15,4,3
26,199,199,30,30,0,1,0
18,228,228,63,16,47,2,1
16,230,230,17,11,6,3,2
25,250,250,15,15,0,1,0
2,260,260,4,4,0,1,0
5,263,263,24,20,4,2,1
13,273,273,51,51,0,1,0
9,291,291,17,17,0,1,0
22,291,291,43,43,0,1,0
23,295,295,56,53,3,2,1
21,310,310,35,35,0,1,0
12,329,329,51,20,31,2,1
4,347,347,157,154,3,2,1
6,359,359,76,6,70,3,2
7,366,366,29,29,0,1,0
24,395,395,9,4,5,2,1
8,397,397,32,9,23,2,1
10,419,419,185,102,83,4,3
17,421,421,15,5,10,2,1
19,452,452,21,6,15,4,3
14,463,463,14,14,0,1,0
20,471,471,25,13,12,4,3
0,475,475,53,11,42,4,3

10,109,109,23,20,3,2,1
6,114,114,19,19,0,1,0
19,115,115,2,2,0,1,0
5,126,126,27,12,15,4,3
16,130,130,20,4,16,3,2
12,144,144,4,4,0,1,0
7,146,146,8,8,0,1,0
9,152,152,12,4,8,2,1
17,155,155,1,1,0,1,0
21,171,171,6,6,0,1,0
20,175,175,6,3,3,2,1
30,190,190,27,21,6,3,2
4,190,190,11,1,10,2,1
3,230,230,10,10,0,1,0
2,232,232,29,5,24,4,3
29,301,301,44,44,0,1,0
25,319,319,18,10,8,2,1
0,323,323,56,56,0,1,0
8,324,324,70,70,0,1,0
28,338,338,18,18,0,1,0
22,376,376,7,7,0,1,0
14,379,379,8,3,5,2,1
15,382,382,104,104,0,1,0
18,391,391,127,38,89,4,3
23,392,392,77,43,34,2,1
27,396,396,5,5,0,1,0
13,397,397,55,11,44,2,1
26,445,445,13,13,0,1,0
11,453,453,12,12,0,1,0
1,492,492,22,22,0,1,0
24,497,497,67,43,24,2,1

11,122,122,4,4,0,1,0
5,131,131,1,1,0,1,0
31,145,145,6,6,0,1,0
27,147,147,8,5,3,2,1
1,154,154,1,1,0,1,0
32,161,161,7,7,0,1,0
15,169,169,25,19,6,3,2
18,172,172,15,2,13,2,1
6,180,180,21,21,0,1,0
2,208,208,23,12,11,2,1
19,211,211,3,3,0,1,0
25,213,213,24,9,15,2,1
36,214,214,8,2,6,2,1
12,218,218,41,8,33,2,1
37,228,228,7,3,4,2,1
10,240,240,18,10,8,3,2
30,252,252,47,5,42,4,3
20,260,260,15,7,8,3,2
7,274,274,34,21,13,2,1
29,275,275,31,21,10,2,1
9,288,288,4,1,3,2,1
35,290,290,50,50,0,1,0
4,318,318,28,28,0,1,0
13,322,322,19,19,0,1,0
33,330,330,42,42,0,1,0
26,347,347,57,39,18,2,1
22,348,348,4,4,0,1,0
28,351,351,103,81,22,4,3
23,367,367,34,34,0,1,0
24,371,371,8,8,0,1,0
3,388,388,15,4,11,2,1
16,390,390,17,17,0,1,0
0,400,400,52,52,0,1,0
17,410,410,7,2,5,2,1
8,412,412,41,29,12,4,3
14,420,420,55,55,0,1,0
21,435,435,5,5,0,1,0
34,462,462,66,66,0,1,0

7,137,137,4,4,0,1,0
30,139,139,30,30,0,1,0
2,158,158,28,28,0,1,0
27,160,160,2,2,0,1,0
31,166,166,23,4,19,4,3
25,195,195,23,4,19,4,3
20,196,196,32,8,24,4,3
14,202,202,24,16,8,3,2
17,216,216,10,4,6,2,1
8,220,220,37,9,28,3,2
29,225,225,9,1,8,2,1
22,228,228,28,8,20,3,2
11,247,247,11,1,10,3,2
10,277,277,8,8,0,1,0
9,295,295,8,8,0,1,0
1,300,300,3,3,0,1,0
16,303,303,22,4,18,2,1
24,310,310,6,6,0,1,0
26,323,323,20,12,8,2,1
0,334,334,26,14,12,4,3
5,343,343,5,1,4,2,1
18,372,372,98,98,0,1,0
15,380,380,107,27,80,3,2
4,382,382,44,15,29,2,1
13,388,388,69,69,0,1,0
23,418,418,13,13,0,1,0
12,419,419,33,5,28,2,1
19,430,430,134,94,40,3,2
21,443,443,14,14,0,1,0
6,444,444,43,43,0,1,0
28,454,454,11,3,8,2,1
32,480,480,15,9,6,2,1
3,495,495,41,8,33,4,3

0,103,103,1,1,0,1,0
19,104,104,3,3,0,1,0
15,108,108,1,1,0,1,0
9,116,116,12,2,10,3,2
6,130,130,3,3,0,1,0
31,135,135,11,11,0,1,0
32,140,140,29,3,26,2,1
23,145,145,5,2,3,2,1
17,187,187,20,5,15,4,3
11,191,191,2,2,0,1,0
34,196,196,24,14,10,2,1
3,197,197,3,3,0,1,0
13,218,218,4,4,0,1,0
28,221,221,68,32,36,3,2
12,259,259,7,7,0,1,0
22,262,262,12,12,0,1,0
14,286,286,26,26,0,1,0
16,287,287,22,9,13,2,1
29,321,321,13,13,0,1,0
4,322,322,17,3,14,3,2
21,325,325,34,14,20,3,2
2,336,336,16,16,0,1,0
1,342,342,79,61,18,3,2
30,371,371,6,6,0,1,0
18,371,371,215,190,25,2,1
10,382,382,21,21,0,1,0
33,389,389,4,4,0,1,0
25,398,398,15,15,0,1,0
5,416,416,4,1,3,2,1
8,426,426,56,14,42,2,1
20,444,444,77,39,38,2,1
27,470,470,96,14,82,4,3
7,479,479,1,1,0,1,0
24,487,487,100,40,60,3,2
26,490,490,5,5,0,1,0

6,126,126,11,1,10,3,2
16,128,128,34,34,0,1,0
11,152,152,18,18,0,1,0
33,158,158,7,3,4,2,1
26,169,169,3,3,0,1,0
24,173,173,51,26,25,3,2
3,185,185,8,8,0,1,0
27,206,206,2,2,0,1,0
22,206,206,11,11,0,1,0
19,210,210,24,24,0,1,0
8,212,212,5,5,0,1,0
4,223,223,27,27,0,1,0
5,261,261,16,9,7,2,1
15,262,262,13,13,0,1,0
0,271,271,39,15,24,3,2
29,283,283,14,14,0,1,0
30,285,285,57,23,34,4,3
1,300,300,1,1,0,1,0
31,328,328,8,8,0,1,0
25,344,344,24,24,0,1,0
9,357,357,61,43,18,2,1
23,361,361,73,32,41,4,3
32,365,365,12,1,11,2,1
13,370,370,43,7,36,2,1
12,396,396,3,3,0,1,0
17,401,401,33,7,26,3,2
10,408,408,54,54,0,1,0
2,439,439,7,7,0,1,0
18,462,462,118,75,43,3,2
21,465,465,84,84,0,1,0
28,465,465,32,32,0,1,0
20,473,473,4,4,0,1,0
14,495,495,78,38,40,4,3
7,499,499,1,1,0,1,0

11,102,102,17,8,9,2,1
19,128,128,55,19,36,3,2
2,167,167,6,6,0,1,0
15,168,168,20,20,0,1,0
22,169,169,6,3,3,2,1
7,175,175,7,3,4,2,1
21,176,176,7,7,0,1,0
25,201,201,16,16,0,1,0
26,218,218,9,9,0,1,0
8,228,228,61,36,25,2,1
3,231,231,51,19,32,3,2
5,239,239,7,7,0,1,0
28,239,239,3,3,0,1,0
1,252,252,1,1,0,1,0
4,256,256,17,17,0,1,0
24,271,271,19,12,7,3,2
13,279,279,37,37,0,1,0
20,290,290,5,5,0,1,0
12,294,294,7,7,0,1,0
17,295,295,52,6,46,2,1
23,301,301,94,25,69,4,3
16,335,335,41,41,0,1,0
29,367,367,26,9,17,2,1
18,427,427,1,1,0,1,0
14,431,431,4,4,0,1,0
9,437,437,147,147,0,1,0
27,443,443,40,13,27,2,1
6,446,446,10,10,0,1,0
10,449,449,111,111,0,1,0
0,479,479,5,5,0,1,0

11,131,131,9,9,0,1,0
19,136,136,17,17,0,1,0
2,167,167,4,4,0,1,0
0,173,173,10,10,0,1,0
31,182,182,6,1,5,2,1
28,188,188,22,19,3,2,1
1,215,215,35,35,0,1,0
17,225,225,1,1,0,1,0
20,233,233,1,1,0,1,0
26,257,257,47,47,0,1,0
30,259,259,39,39,0,1,0
15,262,262,54,54,0,1,0
33,266,266,26,26,0,1,0
9,282,282,1,1,0,1,0
29,282,282,51,51,0,1,0
6,301,301,26,26,0,1,0
8,313,313,7,2,5,2,1
23,340,340,3,3,0,1,0
18,340,340,27,27,0,1,0
5,370,370,35,35,0,1,0
3,380,380,28,10,18,2,1
10,384,384,31,31,0,1,0
21,385,385,52,42,10,3,2
34,396,396,52,52,0,1,0
12,396,396,116,91,25,2,1
24,414,414,6,6,0,1,0
25,417,417,1,1,0,1,0
7,432,432,38,25,13,2,1
14,438,438,11,7,4,2,1
27,444,444,66,24,42,4,3
4,476,476,76,16,60,3,2
32,484,484,92,50,42,4,3
22,496,496,51,3,48,3,2
16,498,498,11,11,0,1,0
13,500,500,25,10,15,4,3

9,105,105,1,1,0,1,0
10,120,120,23,23,0,1,0
21,139,139,21,6,15,4,3
17,161,161,4,4,0,1,0
23,164,164,37,26,11,2,1
11,178,178,22,22,0,1,0
19,186,186,10,5,5,2,1
5,237,237,78,18,60,4,3
13,290,290,43,43,0,1,0
22,291,291,11,1,10,2,1
0,292,292,118,38,80,3,2
6,294,294,10,10,0,1,0
18,318,318,85,85,0,1,0
14,319,319,2,2,0,1,0
2,355,355,89,89,0,1,0
3,369,369,64,14,50,3,2
4,371,371,13,13,0,1,0
15,372,372,29,2,27,4,3
8,387,387,5,1,4,2,1
1,414,414,1,1,0,1,0
16,437,437,7,3,4,2,1
7,472,472,176,106,70,3,2
20,486,486,73,1,72,3,2
12,493,493,67,29,38,3,2

19,116,116,2,2,0,1,0
24,121,121,9,9,0,1,0
13,137,137,5,5,0,1,0
6,138,138,1,1,0,1,0
10,144,144,1,1,0,1,0
33,163,163,10,10,0,1,0
11,166,166,1,1,0,1,0
29,169,169,7,7,0,1,0
25,197,197,15,2,13,2,1
5,199,199,37,4,33,3,2
2,232,232,24,2,22,2,1
32,242,242,18,4,14,2,1
31,249,249,7,7,0,1,0
3,255,255,24,24,0,1,0
27,265,265,16,16,0,1,0
16,272,272,2,2,0,1,0
26,314,314,4,4,0,1,0
23,314,314,5,5,0,1,0
28,330,330,195,195,0,1,0
9,332,332,39,25,14,2,1
21,341,341,67,67,0,1,0
12,342,342,8,8,0,1,0
4,345,345,54,20,34,3,2
15,366,366,27,27,0,1,0
8,381,381,24,1,23,2,1
20,394,394,45,29,16,4,3
1,401,401,32,12,20,3,2
22,424,424,69,69,0,1,0
7,430,430,115,67,48,4,3
0,431,431,64,41,23,2,1
14,437,437,85,85,0,1,0
30,461,461,49,49,0,1,0
18,466,466,3,3,0,1,0
17,479,479,14,14,0,1,0

4,118,118,17,17,0,1,0
26,134,134,48,48,0,1,0
19,135,135,14,14,0,1,0
23,146,146,14,5,9,2,1
15,156,156,16,2,14,3,2
1,172,172,47,4,43,2,1
28,179,179,3,3,0,1,0
25,180,180,4,1,3,2,1
18,190,190,24,3,21,4,3
29,224,224,1,1,0,1,0
3,233,233,32,32,0,1,0
24,254,254,9,9,0,1,0
6,261,261,17,17,0,1,0
14,271,271,50,20,30,2,1
16,274,274,31,27,4,2,1
13,297,297,27,27,0,1,0
12,325,325,31,31,0,1,0
27,333,333,9,2,7,2,1
2,341,341,9,6,3,2,1
22,343,343,30,4,26,3,2
7,350,350,1,1,0,1,0
17,427,427,36,8,28,3,2
5,428,428,12,4,8,3,2
10,429,429,153,153,0,1,0
9,436,436,102,102,0,1,0
21,441,441,105,105,0,1,0
20,443,443,18,18,0,1,0
11,451,451,24,24,0,1,0
8,477,477,8,8,0,1,0
0,493,493,38,10,28,2,1

10,128,128,12,12,0,1,0
3,133,133,1,1,0,1,0
7,150,150,3,3,0,1,0
22,154,154,6,6,0,1,0
14,157,157,2,2,0,1,0
21,157,157,6,6,0,1,0
20,201,201,9,9,0,1,0
9,207,207,13,13,0,1,0
5,218,218,6,6,0,1,0
17,226,226,1,1,0,1,0
6,257,257,51,30,21,2,1
11,268,268,4,4,0,1,0
30,272,272,22,22,0,1,0
18,272,272,1,1,0,1,0
16,273,273,69,69,0,1,0
24,281,281,24,9,15,4,3
0,289,289,62,62,0,1,0
8,292,292,54,54,0,1,0
29,352,352,136,131,5,2,1
4,355,355,14,14,0,1,0
19,360,360,62,62,0,1,0
13,367,367,55,5,50,3,2
2,372,372,6,6,0,1,0
12,401,401,146,103,43,2,1
27,408,408,17,1,16,2,1
26,416,416,52,52,0,1,0
1,450,450,88,67,21,2,1
15,468,468,2,2,0,1,0
28,470,470,25,16,9,4,3
23,475,475,85,1,84,4,3
25,476,476,54,30,24,3,2

23,103,103,26,8,18,3,2
32,123,123,24,5,19,2,1
30,140,140,4,1,3,2,1
5,146,146,13,6,7,2,1
18,181,181,7,7,0,1,0
3,181,181,12,3,9,2,1
15,186,186,11,11,0,1,0
14,191,191,19,19,0,1,0
24,205,205,38,38,0,1,0
33,216,216,56,27,29,2,1
35,217,217,1,1,0,1,0
28,224,224,10,10,0,1,0
12,228,228,12,12,0,1,0
13,230,230,54,28,26,2,1
27,243,243,1,1,0,1,0
9,250,250,6,1,5,2,1
6,256,256,18,18,0,1,0
20,281,281,16,16,0,1,0
11,285,285,16,16,0,1,0
38,313,313,69,69,0,1,0
2,313,313,21,15,6,3,2
21,319,319,24,18,6,2,1
4,320,320,1,1,0,1,0
16,339,339,13,13,0,1,0
7,353,353,1,1,0,1,0
8,356,356,45,45,0,1,0
1,381,381,67,20,47,2,1
37,388,388,39,17,22,3,2
31,392,392,2,2,0,1,0
0,401,401,5,5,0,1,0
36,403,403,1,1,0,1,0
19,418,418,13,5,8,3,2
34,451,451,71,71,0,1,0
17,463,463,79,61,18,2,1
26,473,473,30,7,23,4,3
10,475,475,8,5,3,2,1
29,476,476,44,8,36,2,1
25,478,478,2,2,0,1,0
22,495,495,17,17,0,1,0

5,101,101,10,10,0,1,0
9,105,105,6,6,0,1,0
28,110,110,4,4,0,1,0
16,112,112,7,7,0,1,0
18,138,138,4,4,0,1,0
12,155,155,22,22,0,1,0
22,156,156,53,33,20,2,1
25,160,160,15,3,12,2,1
19,161,161,1,1,0,1,0
13,190,190,1,1,0,1,0
34,202,202,39,19,20,3,2
6,205,205,68,45,23,2,1
32,241,241,33,3,30,4,3
31,257,257,13,13,0,1,0
0,264,264,44,29,15,2,1
27,273,273,11,2,9,4,3
2,293,293,38,12,26,3,2
14,294,294,1,1,0,1,0
26,296,296,17,17,0,1,0
15,309,309,30,3,27,3,2
30,311,311,10,4,6,2,1
4,331,331,17,17,0,1,0
24,336,336,44,19,25,2,1
8,339,339,43,37,6,2,1
10,340,340,23,23,0,1,0
23,379,379,55,46,9,2,1
7,399,399,59,33,26,2,1
3,405,405,17,17,0,1,0
17,407,407,4,4,0,1,0
20,415,415,79,79,0,1,0
1,419,419,4,1,3,2,1
29,427,427,47,47,0,1,0
11,452,452,11,11,0,1,0
21,468,468,14,14,0,1,0
33,481,481,19,10,9,4,3

3,106,106,4,4,0,1,0
32,107,107,3,3,0,1,0
13,137,137,14,14,0,1,0
30,143,143,15,15,0,1,0
14,168,168,14,14,0,1,0
2,169,169,1,1,0,1,0
21,176,176,7,4,3,2,1
16,195,195,2,2,0,1,0
34,199,199,4,4,0,1,0
31,210,210,31,4,27,2,1
6,236,236,12,12,0,1,0
0,237,237,31,20,11,2,1
9,237,237,8,8,0,1,0
22,239,239,34,34,0,1,0
25,246,246,43,16,27,4,3
17,257,257,58,58,0,1,0
29,257,257,8,3,5,2,1
35,291,291,79,59,20,3,2
26,296,296,28,25,3,2,1
11,298,298,25,25,0,1,0
7,310,310,14,14,0,1,0
8,350,350,20,20,0,1,0
33,361,361,14,2,12,3,2
18,384,384,81,37,44,2,1
12,423,423,53,53,0,1,0
19,431,431,67,32,35,3,2
28,447,447,48,17,31,2,1
5,455,455,10,7,3,2,1
23,459,459,81,81,0,1,0
20,462,462,18,13,5,2,1
4,463,463,18,12,6,3,2
24,471,471,25,17,8,3,2
10,476,476,17,9,8,2,1
15,494,494,54,44,10,2,1
1,497,497,18,12,6,2,1
27,500,500,86,12,74,4,3

18,112,112,6,6,0,1,0
37,119,119,10,10,0,1,0
21,124,124,4,1,3,2,1
39,133,133,17,17,0,1,0
6,137,137,13,1,12,2,1
31,141,141,13,13,0,1,0
22,148,148,13,13,0,1,0
33,148,148,7,1,6,3,2
30,158,158,25,25,0,1,0
7,159,159,9,9,0,1,0
5,172,172,2,2,0,1,0
13,197,197,4,4,0,1,0
38,204,204,20,20,0,1,0
41,205,205,16,2,14,3,2
35,215,215,70,4,66,3,2
4,225,225,52,52,0,1,0
28,227,227,2,2,0,1,0
40,231,231,10,2,8,3,2
27,231,231,3,3,0,1,0
34,234,234,44,44,0,1,0
17,245,245,12,12,0,1,0
2,294,294,43,25,18,3,2
25,300,300,10,4,6,3,2
1,314,314,11,11,0,1,0
23,326,326,27,19,8,2,1
14,346,346,8,2,6,3,2
9,359,359,19,13,6,2,1
0,365,365,8,8,0,1,0
16,367,367,17,2,15,4,3
20,374,374,23,11,12,4,3
8,387,387,53,15,38,2,1
3,389,389,40,5,35,3,2
12,404,404,8,3,5,2,1
24,412,412,20,20,0,1,0
15,422,422,30,8,22,2,1
32,433,433,48,48,0,1,0
29,446,446,32,4,28,2,1
11,458,458,17,1,16,4,3
36,475,475,83,83,0,1,0
26,478,478,14,14,0,1,0
19,486,486,4,4,0,1,0
10,500,500,18,14,4,2,1

15,106,106,1,1,0,1,0
27,143,143,3,3,0,1,0
29,167,167,4,1,3,2,1
5,169,169,26,26,0,1,0
23,202,202,6,6,0,1,0
4,203,203,12,2,10,2,1
11,203,203,36,36,0,1,0
14,205,205,6,1,5,2,1
0,206,206,10,3,7,2,1
8,216,216,14,7,7,2,1
25,222,222,102,102,0,1,0
16,229,229,17,17,0,1,0
1,231,231,19,19,0,1,0
21,238,238,20,20,0,1,0
7,267,267,21,21,0,1,0
19,271,271,29,1,28,3,2
6,281,281,49,40,9,4,3
13,283,283,2,2,0,1,0
18,287,287,13,3,10,3,2
3,297,297,17,17,0,1,0
32,311,311,35,7,28,3,2
2,312,312,52,52,0,1,0
31,328,328,33,7,26,3,2
9,330,330,19,6,13,2,1
10,334,334,29,29,0,1,0
12,368,368,17,8,9,2,1
26,376,376,40,40,0,1,0
33,386,386,2,2,0,1,0
28,396,396,70,14,56,3,2
30,400,400,28,4,24,2,1
24,403,403,24,11,13,2,1
22,407,407,38,32,6,3,2
20,442,442,73,49,24,2,1
34,452,452,7,7,0,1,0
17,478,478,87,87,0,1,0

20,100,100,5,1,4,2,1
21,104,104,4,1,3,2,1
18,106,106,8,8,0,1,0
14,117,117,5,5,0,1,0
2,129,129,1,1,0,1,0
30,131,131,25,1,24,4,3
5,158,158,14,14,0,1,0
15,165,165,10,10,0,1,0
8,168,168,39,6,33,3,2
11,187,187,8,8,0,1,0
9,189,189,10,10,0,1,0
16,202,202,22,22,0,1,0
7,207,207,48,48,0,1,0
25,216,216,8,8,0,1,0
1,240,240,28,20,8,2,1
22,242,242,56,56,0,1,0
3,254,254,9,9,0,1,0
13,263,263,18,13,5,2,1
17,278,278,6,2,4,2,1
19,279,279,2,2,0,1,0
6,285,285,16,16,0,1,0
26,319,319,29,1,28,2,1
12,326,326,129,57,72,3,2
31,327,327,6,6,0,1,0
0,355,355,35,2,33,4,3
28,394,394,1,1,0,1,0
29,411,411,141,57,84,4,3
23,420,420,60,60,0,1,0
27,425,425,81,23,58,3,2
24,457,457,39,31,8,3,2
4,465,465,22,22,0,1,0
10,479,479,13,10,3,2,1

23,108,108,20,14,6,2,1
9,110,110,19,2,17,2,1
7,115,115,2,2,0,1,0
17,183,183,19,19,0,1,0
6,217,217,1,1,0,1,0
11,242,242,17,17,0,1,0
22,248,248,74,14,60,4,3
29,263,263,1,1,0,1,0
3,264,264,37,37,0,1,0
16,267,267,19,2,17,2,1
27,271,271,16,16,0,1,0
26,285,285,51,51,0,1,0
15,294,294,27,27,0,1,0
20,298,298,20,20,0,1,0
31,298,298,8,8,0,1,0
19,306,306,59,16,43,4,3
21,349,349,23,2,21,4,3
0,355,355,3,3,0,1,0
30,363,363,13,6,7,2,1
5,371,371,24,24,0,1,0
8,372,372,1,1,0,1,0
1,379,379,43,5,38,3,2
13,380,380,8,8,0,1,0
24,383,383,28,28,0,1,0
10,384,384,54,5,49,2,1
4,387,387,9,9,0,1,0
14,410,410,24,24,0,1,0
35,444,444,5,5,0,1,0
12,447,447,3,3,0,1,0
18,447,447,51,44,7,2,1
34,451,451,49,19,30,4,3
25,455,455,30,26,4,2,1
32,457,457,49,5,44,3,2
2,476,476,56,11,45,2,1
33,481,481,9,9,0,1,0
36,482,482,62,62,0,1,0
28,492,492,129,129,0,1,0

37,110,110,11,2,9,3,2
16,128,128,9,9,0,1,0
34,152,152,37,27,10,2,1
21,165,165,7,1,6,3,2
2,179,179,18,9,9,4,3
12,180,180,6,6,0,1,0
15,185,185,2,2,0,1,0
17,196,196,20,17,3,2,1
27,196,196,14,14,0,1,0
1,211,211,16,16,0,1,0
9,212,212,18,8,10,3,2
11,212,212,1,1,0,1,0
23,219,219,9,3,6,2,1
14,228,228,1,1,0,1,0
31,236,236,27,23,4,2,1
30,255,255,34,34,0,1,0
5,272,272,25,1,24,4,3
26,273,273,30,21,9,2,1
3,281,281,40,40,0,1,0
20,313,313,1,1,0,1,0
19,341,341,46,46,0,1,0
25,344,344,90,90,0,1,0
35,346,346,7,7,0,1,0
38,399,399,17,17,0,1,0
10,410,410,28,28,0,1,0
13,411,411,24,24,0,1,0
0,412,412,1,1,0,1,0
28,418,418,4,4,0,1,0
22,421,421,106,106,0,1,0
32,434,434,3,3,0,1,0
36,436,436,34,11,23,2,1
24,438,438,10,10,0,1,0
33,442,442,162,162,0,1,0
29,485,485,5,2,3,2,1
4,487,487,87,87,0,1,0
8,487,487,21,21,0,1,0
7,490,490,2,2,0,1,0
18,492,492,38,38,0,1,0
6,500,500,8,8,0,1,0

19,105,105,1,1,0,1,0
4,116,116,8,8,0,1,0
24,116,116,29,29,0,1,0
21,130,130,18,18,0,1,0
35,139,139,1,1,0,1,0
11,150,150,18,6,12,4,3
16,182,182,33,33,0,1,0
12,212,212,8,8,0,1,0
28,218,218,9,9,0,1,0
3,227,227,10,1,9,4,3
22,236,236,8,8,0,1,0
18,251,251,9,1,8,2,1
31,253,253,9,9,0,1,0
30,257,257,103,103,0,1,0
23,267,267,73,73,0,1,0
32,271,271,8,8,0,1,0
0,285,285,60,60,0,1,0
5,308,308,10,10,0,1,0
20,311,311,19,9,10,3,2
6,329,329,37,19,18,2,1
27,343,343,33,14,19,3,2
33,343,343,18,18,0,1,0
8,405,405,40,40,0,1,0
10,419,419,4,4,0,1,0
25,419,419,26,26,0,1,0
9,421,421,6,1,5,2,1
1,428,428,81,73,8,3,2
7,431,431,67,9,58,3,2
15,432,432,1,1,0,1,0
14,438,438,36,24,12,4,3
26,442,442,6,2,4,2,1
34,445,445,28,10,18,3,2
2,469,469,7,1,6,3,2
29,480,480,38,24,14,3,2
13,485,485,78,39,39,4,3
17,498,498,14,3,11,2,1

34,105,105,2,2,0,1,0
4,121,121,4,4,0,1,0
17,125,125,19,1,18,2,1
6,140,140,9,5,4,2,1
14,141,141,7,7,0,1,0
11,151,151,4,1,3,2,1
20,154,154,21,18,3,2,1
15,167,167,39,39,0,1,0
28,172,172,16,4,12,4,3
23,189,189,85,40,45,4,3
18,222,222,5,5,0,1,0
21,233,233,9,2,7,2,1
7,256,256,92,4,88,4,3
25,262,262,10,1,9,2,1
0,270,270,23,23,0,1,0
9,273,273,9,2,7,2,1
12,282,282,13,13,0,1,0
3,297,297,40,28,12,4,3
13,300,300,1,1,0,1,0
27,331,331,11,11,0,1,0
33,332,332,4,4,0,1,0
19,344,344,9,4,5,2,1
26,349,349,61,61,0,1,0
1,357,357,30,7,23,2,1
32,370,370,58,58,0,1,0
30,376,376,35,35,0,1,0
5,404,404,24,24,0,1,0
8,407,407,52,2,50,2,1
10,408,408,11,2,9,2,1
24,432,432,2,2,0,1,0
2,435,435,3,3,0,1,0
22,441,441,63,63,0,1,0
16,489,489,26,26,0,1,0
29,491,491,85,37,48,4,3
31,499,499,18,18,0,1,0

0,114,114,1,1,0,1,0
33,116,116,1,1,0,1,0
21,118,118,3,3,0,1,0
3,121,121,14,3,11,2,1
9,145,145,31,31,0,1,0
11,157,157,2,2,0,1,0
32,179,179,59,28,31,2,1
24,181,181,18,18,0,1,0
18,184,184,9,3,6,2,1
28,193,193,2,2,0,1,0
26,199,199,20,17,3,2,1
31,216,216,37,10,27,2,1
5,231,231,1,1,0,1,0
30,251,251,5,5,0,1,0
19,252,252,64,36,28,2,1
7,257,257,72,26,46,3,2
4,261,261,5,2,3,2,1
10,286,286,14,14,0,1,0
22,287,287,10,10,0,1,0
23,289,289,19,9,10,3,2
6,295,295,4,4,0,1,0
34,298,298,49,14,35,4,3
8,319,319,2,2,0,1,0
25,323,323,14,14,0,1,0
13,356,356,26,26,0,1,0
29,390,390,37,33,4,2,1
20,396,396,37,37,0,1,0
14,413,413,7,7,0,1,0
2,429,429,16,4,12,2,1
27,434,434,51,51,0,1,0
16,438,438,80,38,42,4,3
15,440,440,9,3,6,3,2
17,453,453,18,18,0,1,0
12,459,459,30,6,24,3,2
1,466,466,183,83,100,4,3

25,104,104,11,11,0,1,0
11,127,127,29,29,0,1,0
18,138,138,5,1,4,2,1
22,177,177,12,12,0,1,0
15,186,186,8,8,0,1,0
21,187,187,52,52,0,1,0
0,190,190,12,12,0,1,0
5,190,190,15,4,11,2,1
4,192,192,27,24,3,2,1
14,205,205,15,15,0,1,0
13,210,210,5,1,4,2,1
12,224,224,5,5,0,1,0
16,236,236,41,41,0,1,0
3,250,250,42,1,41,2,1
8,308,308,67,67,0,1,0
23,334,334,30,30,0,1,0
10,336,336,45,8,37,3,2
24,339,339,11,11,0,1,0
19,341,341,12,3,9,2,1
6,341,341,53,17,36,2,1
28,347,347,25,7,18,3,2
9,349,349,12,12,0,1,0
30,402,402,49,49,0,1,0
20,404,404,30,30,0,1,0
7,430,430,83,83,0,1,0
2,443,443,9,9,0,1,0
1,445,445,22,22,0,1,0
17,463,463,54,54,0,1,0
26,474,474,15,1,14,2,1
29,491,491,112,74,38,2,1
27,497,497,60,60,0,1,0

12,102,102,21,21,0,1,0
2,111,111,16,1,15,4,3
10,118,118,12,12,0,1,0
9,118,118,44,44,0,1,0
11,153,153,2,2,0,1,0
28,155,155,20,20,0,1,0
29,174,174,46,46,0,1,0
30,174,174,18,18,0,1,0
21,182,182,16,1,15,4,3
26,199,199,1,1,0,1,0
22,201,201,19,19,0,1,0
4,206,206,5,5,0,1,0
15,209,209,6,6,0,1,0
5,213,213,35,14,21,2,1
24,218,218,16,16,0,1,0
23,221,221,11,11,0,1,0
18,227,227,8,8,0,1,0
7,243,243,3,3,0,1,0
6,249,249,7,4,3,2,1
13,251,251,5,5,0,1,0
31,259,259,37,37,0,1,0
14,286,286,17,5,12,2,1
27,314,314,28,28,0,1,0
25,356,356,68,68,0,1,0
1,385,385,4,4,0,1,0
17,392,392,31,31,0,1,0
33,394,394,24,10,14,3,2
32,396,396,54,20,34,3,2
20,424,424,7,7,0,1,0
0,431,431,13,7,6,2,1
16,462,462,101,101,0,1,0
3,470,470,24,24,0,1,0
34,483,483,20,8,12,3,2
8,492,492,2,2,0,1,0
19,495,495,72,72,0,1,0

4,119,119,3,3,0,1,0
10,129,129,3,3,0,1,0
28,130,130,2,2,0,1,0
26,132,132,5,5,0,1,0
11,133,133,8,1,7,2,1
6,150,150,4,4,0,1,0
14,164,164,1,1,0,1,0
25,172,172,15,15,0,1,0
7,184,184,19,14,5,2,1
13,204,204,14,4,10,3,2
5,216,216,26,10,16,3,2
0,228,228,40,18,22,4,3
29,230,230,12,12,0,1,0
18,250,250,54,2,52,3,2
27,255,255,6,6,0,1,0
30,256,256,52,52,0,1,0
2,260,260,61,15,46,2,1
20,276,276,4,4,0,1,0
16,312,312,26,26,0,1,0
31,325,325,35,35,0,1,0
19,341,341,65,53,12,3,2
1,354,354,71,45,26,2,1
3,367,367,17,1,16,2,1
24,382,382,84,37,47,2,1
12,389,389,30,6,24,4,3
21,392,392,65,65,0,1,0
15,409,409,30,30,0,1,0
22,434,434,7,7,0,1,0
17,448,448,37,25,12,4,3
23,457,457,53,15,38,2,1
9,474,474,142,61,81,4,3
8,487,487,29,29,0,1,0

13,121,121,8,8,0,1,0
2,147,147,25,3,22,3,2
16,151,151,3,3,0,1,0
29,156,156,37,37,0,1,0
27,161,161,8,1,7,2,1
24,166,166,5,1,4,2,1
30,170,170,19,19,0,1,0
1,184,184,16,4,12,4,3
25,188,188,46,28,18,4,3
21,216,216,19,19,0,1,0
20,230,230,5,5,0,1,0
6,267,267,15,11,4,2,1
10,277,277,8,8,0,1,0
19,284,284,61,61,0,1,0
11,286,286,43,43,0,1,0
17,328,328,16,16,0,1,0
4,335,335,2,2,0,1,0
9,346,346,70,70,0,1,0
14,372,372,58,58,0,1,0
8,379,379,121,28,93,4,3
15,385,385,78,42,36,4,3
3,394,394,7,7,0,1,0
23,395,395,36,36,0,1,0
28,438,438,11,11,0,1,0
0,442,442,42,4,38,3,2
26,443,443,7,7,0,1,0
5,446,446,42,30,12,2,1
22,451,451,21,5,16,2,1
18,473,473,91,69,22,2,1
12,493,493,20,20,0,1,0
7,500,500,56,47,9,4,3

25,132,132,15,1,14,3,2
0,135,135,1,1,0,1,0
23,154,154,21,17,4,2,1
20,174,174,9,1,8,3,2
21,186,186,6,6,0,1,0
12,205,205,1,1,0,1,0
6,227,227,7,7,0,1,0
18,227,227,31,31,0,1,0
26,239,239,35,35,0,1,0
11,240,240,48,39,9,4,3
3,268,268,72,72,0,1,0
27,285,285,3,3,0,1,0
10,299,299,38,15,23,2,1
13,301,301,86,2,84,3,2
19,320,320,2,2,0,1,0
22,348,348,3,3,0,1,0
16,350,350,133,95,38,3,2
14,362,362,14,14,0,1,0
9,373,373,94,94,0,1,0
24,385,385,9,5,4,2,1
5,385,385,3,3,0,1,0
7,406,406,70,6,64,3,2
2,409,409,44,6,38,4,3
8,443,443,24,2,22,3,2
28,446,446,68,68,0,1,0
17,457,457,28,10,18,2,1
1,474,474,5,5,0,1,0
4,475,475,171,154,17,3,2
15,499,499,23,23,0,1,0

20,102,102,1,1,0,1,0
0,146,146,7,1,6,2,1
16,150,150,36,36,0,1,0
17,164,164,5,5,0,1,0
2,170,170,7,1,6,3,2
18,190,190,10,4,6,3,2
8,206,206,23,15,8,3,2
4,216,216,17,12,5,2,1
6,216,216,8,8,0,1,0
12,230,230,18,11,7,2,1
26,235,235,51,24,27,2,1
3,248,248,62,26,36,4,3
11,267,267,56,35,21,2,1
31,290,290,5,1,4,2,1
27,295,295,9,9,0,1,0
25,304,304,7,7,0,1,0
15,310,310,16,5,11,2,1
7,314,314,17,2,15,4,3
10,330,330,5,5,0,1,0
24,334,334,44,44,0,1,0
19,341,341,31,31,0,1,0
22,349,349,70,70,0,1,0
32,361,361,36,36,0,1,0
30,378,378,12,7,5,2,1
5,379,379,1,1,0,1,0
14,389,389,14,4,10,3,2
33,401,401,14,4,10,3,2
21,425,425,59,59,0,1,0
29,469,469,30,30,0,1,0
23,474,474,141,114,27,4,3
1,479,479,29,29,0,1,0
13,488,488,80,20,60,3,2
9,497,497,46,19,27,2,1
28,500,500,95,80,15,2,1

9,173,173,44,2,42,2,1
7,181,181,33,8,25,2,1
19,194,194,6,6,0,1,0
0,195,195,1,1,0,1,0
12,217,217,4,1,3,2,1
6,229,229,38,16,22,2,1
15,238,238,42,42,0,1,0
4,246,246,16,1,15,2,1
1,251,251,44,24,20,3,2
26,277,277,60,26,34,4,3
11,280,280,50,50,0,1,0
18,291,291,20,5,15,4,3
28,293,293,15,15,0,1,0
8,314,314,76,61,15,2,1
16,322,322,20,20,0,1,0
29,325,325,73,1,72,4,3
17,327,327,5,5,0,1,0
3,337,337,19,19,0,1,0
13,357,357,30,4,26,2,1
2,371,371,44,6,38,2,1
22,382,382,65,65,0,1,0
25,387,387,2,2,0,1,0
23,411,411,1,1,0,1,0
24,412,412,107,81,26,2,1
21,422,422,4,4,0,1,0
5,429,429,19,19,0,1,0
10,456,456,5,5,0,1,0
20,475,475,74,74,0,1,0
14,476,476,79,79,0,1,0
27,494,494,6,6,0,1,0

26,103,103,43,43,0,1,0
18,115,115,14,3,11,2,1
0,151,151,57,20,37,2,1
31,168,168,5,5,0,1,0
2,170,170,11,2,9,4,3
5,173,173,9,9,0,1,0
30,176,176,10,10,0,1,0
22,177,177,12,1,11,2,1
17,189,189,13,10,3,2,1
6,191,191,6,6,0,1,0
1,210,210,29,8,21,2,1
28,212,212,8,3,5,2,1
16,233,233,12,12,0,1,0
14,247,247,47,20,27,4,3
3,259,259,13,5,8,2,1
19,273,273,80,33,47,3,2
23,280,280,3,3,0,1,0
10,290,290,4,4,0,1,0
4,302,302,3,3,0,1,0
27,310,310,13,13,0,1,0
7,345,345,50,42,8,2,1
20,353,353,23,13,10,2,1
12,355,355,12,1,11,2,1
15,362,362,18,6,12,2,1
24,369,369,3,3,0,1,0
8,378,378,24,24,0,1,0
13,421,421,45,45,0,1,0
29,432,432,37,37,0,1,0
11,455,455,54,54,0,1,0
21,469,469,83,74,9,2,1
25,482,482,49,49,0,1,0
9,491,491,76,40,36,4,3

23,116,116,14,14,0,1,0
12,167,167,26,14,12,3,2
21,174,174,10,10,0,1,0
26,183,183,27,3,24,4,3
6,198,198,1,1,0,1,0
14,201,201,14,8,6,3,2
16,214,214,19,3,16,3,2
20,244,244,13,13,0,1,0
24,246,246,1,1,0,1,0
4,247,247,20,20,0,1,0
25,252,252,20,20,0,1,0
27,266,266,12,6,6,2,1
11,273,273,2,2,0,1,0
22,278,278,36,16,20,3,2
10,283,283,48,19,29,4,3
3,288,288,35,35,0,1,0
8,330,330,60,16,44,3,2
32,338,338,45,8,37,2,1
13,350,350,1,1,0,1,0
30,360,360,99,46,53,4,3
19,365,365,71,2,69,4,3
9,365,365,1,1,0,1,0
1,383,383,8,8,0,1,0
29,388,388,61,52,9,2,1
18,391,391,7,7,0,1,0
5,405,405,13,1,12,4,3
7,419,419,54,54,0,1,0
0,437,437,99,99,0,1,0
31,448,448,19,13,6,3,2
15,465,465,78,78,0,1,0
28,489,489,38,11,27,3,2
17,497,497,51,51,0,1,0
2,498,498,70,64,6,2,1

39,112,112,4,1,3,2,1
19,145,145,32,16,16,2,1
18,146,146,1,1,0,1,0
2,154,154,9,9,0,1,0
28,154,154,11,11,0,1,0
26,176,176,51,21,30,4,3
33,177,177,34,2,32,2,1
35,179,179,21,9,12,3,2
23,193,193,5,5,0,1,0
11,198,198,3,3,0,1,0
14,201,201,6,2,4,2,1
31,205,205,3,3,0,1,0
13,215,215,3,3,0,1,0
12,219,219,55,28,27,2,1
6,219,219,2,2,0,1,0
27,219,219,25,12,13,2,1
15,228,228,10,10,0,1,0
32,228,228,14,14,0,1,0
22,231,231,8,4,4,2,1
36,231,231,19,19,0,1,0
21,232,232,4,4,0,1,0
41,237,237,24,24,0,1,0
7,272,272,14,14,0,1,0
3,276,276,5,5,0,1,0
38,280,280,35,35,0,1,0
37,281,281,3,3,0,1,0
10,310,310,7,3,4,2,1
4,321,321,5,5,0,1,0
8,324,324,1,1,0,1,0
17,326,326,32,17,15,2,1
20,326,326,25,1,24,3,2
29,344,344,73,40,33,4,3
5,361,361,59,8,51,4,3
16,385,385,52,11,41,4,3
0,393,393,26,26,0,1,0
30,394,394,20,4,16,4,3
40,396,396,10,10,0,1,0
24,417,417,1,1,0,1,0
34,484,484,62,14,48,4,3
25,485,485,59,19,40,4,3
9,487,487,4,4,0,1,0
1,498,498,46,19,27,4,3

20,105,105,11,11,0,1,0
38,107,107,2,2,0,1,0
27,109,109,8,8,0,1,0
5,117,117,4,1,3,2,1
26,121,121,10,10,0,1,0
36,130,130,36,36,0,1,0
24,159,159,28,28,0,1,0
14,172,172,15,15,0,1,0
28,176,176,18,18,0,1,0
19,183,183,6,6,0,1,0
4,192,192,2,2,0,1,0
11,209,209,13,8,5,2,1
0,214,214,1,1,0,1,0
22,215,215,10,10,0,1,0
23,216,216,10,10,0,1,0
3,221,221,33,24,9,4,3
17,253,253,40,29,11,2,1
1,268,268,14,14,0,1,0
33,288,288,5,5,0,1,0
35,310,310,22,8,14,3,2
10,322,322,22,22,0,1,0
30,323,323,20,20,0,1,0
29,331,331,107,84,23,2,1
31,350,350,7,7,0,1,0
16,357,357,11,11,0,1,0
6,362,362,44,44,0,1,0
18,362,362,3,3,0,1,0
25,368,368,2,2,0,1,0
12,368,368,53,17,36,2,1
9,369,369,30,16,14,3,2
34,399,399,18,8,10,2,1
32,403,403,24,11,13,2,1
15,428,428,102,102,0,1,0
13,432,432,1,1,0,1,0
8,453,453,26,26,0,1,0
2,459,459,24,24,0,1,0
37,477,477,124,116,8,3,2
21,492,492,11,11,0,1,0
7,496,496,17,11,6,3,2

11,102,102,1,1,0,1,0
19,125,125,11,11,0,1,0
1,144,144,11,3,8,2,1
9,146,146,35,35,0,1,0
27,150,150,16,2,14,2,1
30,159,159,4,4,0,1,0
32,163,163,8,8,0,1,0
7,189,189,26,16,10,2,1
20,190,190,48,2,46,2,1
14,191,191,4,4,0,1,0
28,221,221,42,42,0,1,0
6,233,233,84,72,12,2,1
23,256,256,3,3,0,1,0
31,267,267,11,5,6,3,2
15,278,278,22,4,18,4,3
21,283,283,43,43,0,1,0
22,294,294,104,50,54,4,3
17,298,298,13,13,0,1,0
8,298,298,14,14,0,1,0
2,323,323,1,1,0,1,0
10,329,329,16,4,12,2,1
24,334,334,5,5,0,1,0
29,338,338,21,21,0,1,0
16,340,340,13,3,10,4,3
12,347,347,6,6,0,1,0
13,368,368,9,6,3,2,1
26,373,373,31,7,24,2,1
3,403,403,1,1,0,1,0
0,419,419,146,146,0,1,0
4,461,461,6,3,3,2,1
18,464,464,15,8,7,2,1
25,468,468,60,16,44,2,1
5,478,478,65,65,0,1,0

18,104,104,13,3,10,3,2
31,115,115,39,31,8,2,1
15,120,120,2,2,0,1,0
37,121,121,2,2,0,1,0
33,124,124,10,2,8,3,2
23,127,127,1,1,0,1,0
36,163,163,4,1,3,2,1
14,170,170,36,19,17,2,1
16,182,182,1,1,0,1,0
12,183,183,10,10,0,1,0
4,193,193,3,3,0,1,0
24,194,194,29,19,10,3,2
9,195,195,43,43,0,1,0
22,200,200,23,23,0,1,0
8,210,210,1,1,0,1,0
40,225,225,11,11,0,1,0
5,226,226,15,3,12,3,2
39,226,226,22,19,3,2,1
13,267,267,1,1,0,1,0
30,272,272,4,4,0,1,0
28,274,274,44,26,18,4,3
27,291,291,20,20,0,1,0
38,294,294,22,22,0,1,0
3,309,309,25,1,24,2,1
32,332,332,7,2,5,2,1
35,346,346,9,9,0,1,0
20,346,346,2,2,0,1,0
34,347,347,73,73,0,1,0
7,355,355,4,4,0,1,0
11,366,366,28,3,25,2,1
6,379,379,50,50,0,1,0
29,392,392,52,42,10,3,2
1,411,411,11,2,9,2,1
19,415,415,20,20,0,1,0
2,425,425,2,2,0,1,0
26,428,428,2,2,0,1,0
0,439,439,34,34,0,1,0
17,441,441,1,1,0,1,0
10,452,452,28,21,7,2,1
25,477,477,145,57,88,3,2
21,492,492,39,39,0,1,0

30,102,102,7,7,0,1,0
26,105,105,13,13,0,1,0
5,127,127,18,6,12,4,3
3,137,137,7,7,0,1,0
18,141,141,45,1,44,3,2
28,153,153,43,26,17,2,1
1,197,197,56,56,0,1,0
19,203,203,7,7,0,1,0
22,213,213,12,12,0,1,0
14,218,218,19,19,0,1,0
9,256,256,27,5,22,3,2
10,257,257,40,22,18,3,2
27,259,259,3,3,0,1,0
25,300,300,42,18,24,3,2
0,311,311,39,39,0,1,0
31,326,326,49,10,39,2,1
21,336,336,36,23,13,2,1
15,343,343,89,89,0,1,0
13,359,359,8,8,0,1,0
32,362,362,15,15,0,1,0
20,368,368,1,1,0,1,0
29,372,372,20,6,14,2,1
4,378,378,12,5,7,2,1
11,388,388,7,3,4,2,1
8,394,394,67,53,14,2,1
6,401,401,3,3,0,1,0
12,409,409,16,13,3,2,1
16,434,434,25,15,10,3,2
24,450,450,50,20,30,2,1
23,473,473,23,23,0,1,0
7,484,484,9,1,8,3,2
2,488,488,13,2,11,2,1
17,499,499,42,42,0,1,0

11,132,132,7,4,3,2,1
17,133,133,6,2,4,2,1
9,134,134,6,6,0,1,0
3,150,150,23,23,0,1,0
5,153,153,84,84,0,1,0
6,170,170,18,1,17,2,1
22,178,178,33,33,0,1,0
16,180,180,63,63,0,1,0
2,199,199,1,1,0,1,0
21,240,240,42,15,27,4,3
26,245,245,36,12,24,4,3
24,259,259,2,2,0,1,0
23,268,268,35,23,12,4,3
28,277,277,11,11,0,1,0
12,283,283,25,25,0,1,0
4,292,292,11,11,0,1,0
30,298,298,2,2,0,1,0
15,308,308,24,24,0,1,0
31,308,308,19,9,10,2,1
14,315,315,20,20,0,1,0
19,318,318,61,61,0,1,0
7,327,327,30,21,9,4,3
25,338,338,49,49,0,1,0
18,340,340,19,6,13,4,3
20,355,355,15,15,0,1,0
10,388,388,2,2,0,1,0
0,391,391,42,42,0,1,0
1,406,406,67,67,0,1,0
29,430,430,6,2,4,2,1
8,446,446,10,10,0,1,0
27,446,446,12,12,0,1,0
13,465,465,15,15,0,1,0

29,102,102,14,14,0,1,0
15,104,104,1,1,0,1,0
42,118,118,4,4,0,1,0
14,120,120,5,5,0,1,0
40,125,125,4,4,0,1,0
0,137,137,10,5,5,2,1
3,144,144,6,3,3,2,1
19,148,148,5,1,4,2,1
13,151,151,9,9,0,1,0
28,184,184,26,26,0,1,0
36,195,195,5,5,0,1,0
8,197,197,1,1,0,1,0
41,217,217,17,5,12,3,2
9,221,221,52,7,45,4,3
6,231,231,16,16,0,1,0
22,239,239,4,1,3,2,1
27,250,250,4,4,0,1,0
11,252,252,22,10,12,4,3
37,258,258,21,21,0,1,0
24,261,261,11,4,7,2,1
20,261,261,35,17,18,3,2
2,285,285,33,33,0,1,0
26,287,287,11,11,0,1,0
7,292,292,15,11,4,2,1
31,294,294,21,1,20,2,1
5,296,296,16,7,9,2,1
35,305,305,29,15,14,3,2
30,308,308,3,3,0,1,0
23,319,319,1,1,0,1,0
10,329,329,3,3,0,1,0
32,340,340,117,93,24,2,1
18,342,342,5,5,0,1,0
1,349,349,3,3,0,1,0
34,353,353,58,58,0,1,0
39,385,385,56,34,22,3,2
25,396,396,21,3,18,2,1
12,400,400,58,18,40,3,2
21,422,422,48,23,25,2,1
38,423,423,58,12,46,3,2
17,427,427,1,1,0,1,0
16,442,442,10,2,8,3,2
33,472,472,55,55,0,1,0
4,473,473,57,48,9,2,1

26,101,101,12,12,0,1,0
3,114,114,1,1,0,1,0
4,126,126,21,12,9,4,3
23,128,128,1,1,0,1,0
24,159,159,28,28,0,1,0
0,161,161,13,4,9,4,3
6,162,162,9,9,0,1,0
32,163,163,3,3,0,1,0
9,166,166,9,9,0,1,0
17,173,173,22,22,0,1,0
11,198,198,29,6,23,4,3
25,205,205,2,2,0,1,0
15,206,206,23,23,0,1,0
30,229,229,81,6,75,4,3
16,278,278,15,15,0,1,0
5,288,288,1,1,0,1,0
7,295,295,30,30,0,1,0
20,313,313,14,5,9,2,1
22,316,316,42,13,29,3,2
14,336,336,29,11,18,4,3
2,348,348,2,2,0,1,0
27,370,370,24,21,3,2,1
31,389,389,6,3,3,2,1
21,396,396,127,114,13,2,1
13,406,406,25,7,18,3,2
10,413,413,57,6,51,4,3
19,421,421,68,48,20,3,2
28,432,432,33,33,0,1,0
18,439,439,5,5,0,1,0
12,445,445,16,16,0,1,0
8,453,453,5,5,0,1,0
29,458,458,1,1,0,1,0
1,491,491,236,184,52,4,3

12,106,106,24,24,0,1,0
0,117,117,4,4,0,1,0
27,118,118,3,3,0,1,0
10,132,132,4,4,0,1,0
28,135,135,2,2,0,1,0
34,158,158,4,4,0,1,0
30,193,193,23,23,0,1,0
18,202,202,46,46,0,1,0
23,207,207,19,19,0,1,0
5,218,218,6,6,0,1,0
25,221,221,1,1,0,1,0
2,227,227,4,1,3,2,1
22,246,246,58,17,41,3,2
16,270,270,42,42,0,1,0
3,275,275,15,15,0,1,0
14,284,284,6,1,5,2,1
29,323,323,28,5,23,3,2
13,333,333,60,44,16,2,1
4,348,348,19,19,0,1,0
31,352,352,25,25,0,1,0
6,352,352,1,1,0,1,0
26,353,353,110,110,0,1,0
8,379,379,1,1,0,1,0
24,388,388,4,4,0,1,0
7,414,414,8,8,0,1,0
20,415,415,144,144,0,1,0
11,423,423,92,62,30,4,3
9,435,435,34,25,9,4,3
1,454,454,37,37,0,1,0
32,469,469,17,17,0,1,0
21,475,475,76,55,21,2,1
19,491,491,35,11,24,3,2
15,495,495,4,1,3,2,1
17,497,497,81,53,28,2,1
33,500,500,9,1,8,3,2

34,119,119,2,2,0,1,0
30,127,127,20,1,19,3,2
4,137,137,19,13,6,3,2
23,149,149,11,3,8,2,1
32,153,153,16,16,0,1,0
1,157,157,9,5,4,2,1
18,164,164,6,6,0,1,0
19,184,184,4,1,3,2,1
5,187,187,9,9,0,1,0
12,190,190,4,4,0,1,0
16,200,200,13,3,10,2,1
24,224,224,17,8,9,2,1
2,248,248,34,2,32,2,1
28,267,267,29,29,0,1,0
27,270,270,10,10,0,1,0
11,297,297,23,23,0,1,0
7,302,302,94,58,36,4,3
14,311,311,19,19,0,1,0
22,326,326,6,3,3,2,1
33,333,333,52,7,45,2,1
6,341,341,38,38,0,1,0
26,351,351,12,12,0,1,0
0,355,355,3,3,0,1,0
3,357,357,3,3,0,1,0
9,390,390,33,26,7,2,1
8,394,394,1,1,0,1,0
10,406,406,39,12,27,4,3
25,422,422,3,3,0,1,0
29,435,435,11,11,0,1,0
20,446,446,221,221,0,1,0
15,447,447,82,69,13,2,1
31,449,449,122,84,38,3,2
17,464,464,41,41,0,1,0
21,480,480,18,18,0,1,0
13,482,482,31,1,30,2,1

20,106,106,5,5,0,1,0
1,135,135,26,4,22,3,2
24,147,147,24,24,0,1,0
32,158,158,6,6,0,1,0
0,165,165,10,10,0,1,0
29,169,169,22,22,0,1,0
25,173,173,41,41,0,1,0
22,178,178,31,17,14,2,1
3,192,192,7,7,0,1,0
19,202,202,70,1,69,4,3
2,215,215,33,9,24,4,3
14,228,228,9,1,8,3,2
6,230,230,39,39,0,1,0
10,231,231,19,19,0,1,0
11,239,239,12,12,0,1,0
5,261,261,13,6,7,2,1
9,285,285,3,3,0,1,0
23,288,288,9,9,0,1,0
7,292,292,47,7,40,4,3
13,319,319,19,19,0,1,0
28,329,329,38,19,19,2,1
30,366,366,26,26,0,1,0
12,384,384,7,7,0,1,0
4,394,394,11,5,6,3,2
26,403,403,37,17,20,2,1
31,408,408,44,34,10,2,1
27,416,416,15,12,3,2,1
18,425,425,8,8,0,1,0
17,434,434,45,45,0,1,0
15,434,434,1,1,0,1,0
21,469,469,8,8,0,1,0
16,477,477,174,140,34,2,1
33,485,485,6,6,0,1,0
8,486,486,9,3,6,2,1

22,102,102,7,7,0,1,0
23,113,113,15,15,0,1,0
18,149,149,13,7,6,3,2
28,182,182,14,7,7,2,1
30,204,204,1,1,0,1,0
32,206,206,15,2,13,2,1
21,210,210,20,3,17,2,1
20,211,211,64,34,30,3,2
27,213,213,1,1,0,1,0
19,213,213,32,21,11,2,1
10,217,217,60,60,0,1,0
17,232,232,60,20,40,2,1
29,244,244,43,43,0,1,0
2,245,245,10,3,7,2,1
12,247,247,35,35,0,1,0
1,254,254,19,13,6,3,2
8,291,291,2,2,0,1,0
7,322,322,1,1,0,1,0
0,325,325,27,27,0,1,0
13,360,360,24,2,22,3,2
33,367,367,8,8,0,1,0
15,374,374,21,3,18,4,3
5,377,377,5,5,0,1,0
14,384,384,60,60,0,1,0
11,410,410,29,24,5,2,1
25,424,424,76,76,0,1,0
24,435,435,43,1,42,4,3
4,437,437,10,2,8,3,2
26,443,443,19,19,0,1,0
16,444,444,4,1,3,2,1
9,454,454,1,1,0,1,0
3,469,469,106,81,25,4,3
34,471,471,51,7,44,4,3
6,472,472,2,2,0,1,0
31,484,484,49,49,0,1,0

30,126,126,22,13,9,2,1
12,157,157,6,1,5,2,1
9,158,158,3,3,0,1,0
19,168,168,2,2,0,1,0
15,168,168,17,17,0,1,0
28,190,190,18,18,0,1,0
1,193,193,12,12,0,1,0
5,231,231,1,1,0,1,0
31,231,231,19,1,18,4,3
23,233,233,1,1,0,1,0
24,246,246,6,6,0,1,0
17,271,271,9,9,0,1,0
14,273,273,11,11,0,1,0
0,281,281,1,1,0,1,0
10,296,296,16,13,3,2,1
26,303,303,137,83,54,3,2
18,309,309,65,65,0,1,0
2,317,317,14,14,0,1,0
6,352,352,29,2,27,2,1
34,387,387,17,17,0,1,0
7,388,388,47,35,12,3,2
13,388,388,9,9,0,1,0
22,391,391,77,77,0,1,0
11,397,397,144,144,0,1,0
3,402,402,67,44,23,4,3
32,404,404,34,34,0,1,0
25,405,405,31,31,0,1,0
27,410,410,2,2,0,1,0
29,421,421,29,20,9,2,1
8,428,428,30,16,14,3,2
35,442,442,85,43,42,4,3
16,447,447,4,4,0,1,0
33,481,481,56,56,0,1,0
20,483,483,1,1,0,1,0
4,489,489,72,46,26,3,2
21,495,495,8,8,0,1,0

7,141,141,28,10,18,4,3
13,144,144,6,6,0,1,0
11,153,153,11,1,10,3,2
9,159,159,17,17,0,1,0
0,160,160,25,25,0,1,0
28,197,197,7,1,6,2,1
21,197,197,68,45,23,2,1
1,201,201,13,13,0,1,0
18,218,218,13,13,0,1,0
2,219,219,2,2,0,1,0
16,230,230,50,45,5,2,1
3,239,239,2,2,0,1,0
22,243,243,16,8,8,2,1
25,254,254,30,6,24,4,3
27,258,258,7,7,0,1,0
19,309,309,79,31,48,3,2
17,310,310,7,2,5,2,1
24,319,319,18,18,0,1,0
4,337,337,1,1,0,1,0
26,338,338,15,7,8,2,1
15,344,344,52,16,36,3,2
5,384,384,108,63,45,2,1
14,400,400,15,15,0,1,0
20,403,403,47,47,0,1,0
10,404,404,98,98,0,1,0
12,412,412,60,46,14,3,2
8,424,424,100,20,80,3,2
6,466,466,36,36,0,1,0
23,480,480,16,1,15,2,1

0,116,116,16,2,14,3,2
22,119,119,25,5,20,4,3
5,122,122,7,7,0,1,0
8,134,134,8,8,0,1,0
16,147,147,20,12,8,3,2
24,161,161,10,10,0,1,0
15,177,177,16,16,0,1,0
34,202,202,18,18,0,1,0
19,208,208,30,26,4,2,1
1,220,220,6,6,0,1,0
20,225,225,5,5,0,1,0
18,231,231,14,2,12,4,3
33,250,250,7,7,0,1,0
25,254,254,1,1,0,1,0
4,287,287,69,61,8,2,1
6,289,289,33,3,30,3,2
13,290,290,4,4,0,1,0
3,301,301,7,4,3,2,1
32,310,310,45,45,0,1,0
12,314,314,20,20,0,1,0
2,324,324,1,1,0,1,0
21,327,327,2,2,0,1,0
37,353,353,12,8,4,2,1
11,359,359,50,4,46,2,1
14,362,362,6,6,0,1,0
27,378,378,19,1,18,2,1
35,379,379,61,61,0,1,0
26,389,389,55,48,7,2,1
17,398,398,1,1,0,1,0
9,414,414,46,46,0,1,0
29,424,424,159,116,43,3,2
36,428,428,76,8,68,3,2
28,430,430,12,12,0,1,0
23,443,443,18,18,0,1,0
7,456,456,55,5,50,2,1
30,460,460,11,11,0,1,0
10,490,490,6,6,0,1,0
31,491,491,29,3,26,3,2

35,107,107,21,21,0,1,0
11,133,133,11,3,8,3,2
33,137,137,9,3,6,2,1
9,139,139,34,17,17,3,2
1,143,143,1,1,0,1,0
3,146,146,5,5,0,1,0
16,162,162,6,1,5,2,1
4,167,167,1,1,0,1,0
19,211,211,11,11,0,1,0
26,221,221,14,14,0,1,0
32,225,225,25,25,0,1,0
29,232,232,58,23,35,3,2
18,249,249,26,15,11,2,1
15,267,267,44,8,36,4,3
23,290,290,14,14,0,1,0
13,301,301,8,4,4,2,1
21,303,303,11,11,0,1,0
28,315,315,34,34,0,1,0
8,316,316,13,9,4,2,1
7,320,320,60,60,0,1,0
27,323,323,7,7,0,1,0
6,352,352,14,8,6,2,1
24,354,354,51,51,0,1,0
17,357,357,22,22,0,1,0
31,360,360,3,3,0,1,0
20,373,373,49,19,30,3,2
2,377,377,61,1,60,4,3
5,379,379,12,12,0,1,0
30,389,389,80,80,0,1,0
14,418,418,11,8,3,2,1
25,427,427,17,17,0,1,0
12,442,442,28,11,17,3,2
34,447,447,61,61,0,1,0
0,448,448,77,77,0,1,0
22,475,475,31,31,0,1,0
10,492,492,28,28,0,1,0

10,106,106,7,3,4,2,1
30,126,126,7,1,6,3,2
17,131,131,4,4,0,1,0
24,147,147,5,1,4,2,1
5,152,152,9,5,4,2,1
32,154,154,13,13,0,1,0
4,181,181,26,15,11,2,1
8,183,183,11,11,0,1,0
1,197,197,60,6,54,3,2
14,198,198,20,20,0,1,0
23,199,199,14,14,0,1,0
26,201,201,8,8,0,1,0
31,216,216,6,1,5,2,1
11,262,262,1,1,0,1,0
9,289,289,1,1,0,1,0
6,294,294,22,22,0,1,0
16,296,296,30,30,0,1,0
22,296,296,99,99,0,1,0
28,303,303,14,11,3,2,1
21,308,308,18,18,0,1,0
20,371,371,20,20,0,1,0
3,378,378,48,12,36,2,1
27,382,382,86,29,57,4,3
12,392,392,24,2,22,4,3
18,400,400,30,30,0,1,0
33,407,407,41,2,39,4,3
15,423,423,51,51,0,1,0
19,433,433,73,49,24,4,3
29,438,438,108,20,88,3,2
7,450,450,25,25,0,1,0
25,470,470,2,2,0,1,0
2,472,472,58,58,0,1,0
13,472,472,7,7,0,1,0
0,485,485,37,6,31,2,1
34,493,493,44,12,32,3,2

10,107,107,9,1,8,3,2
7,111,111,11,6,5,2,1
8,123,123,12,3,9,4,3
26,134,134,16,4,12,3,2
21,152,152,2,2,0,1,0
13,159,159,19,19,0,1,0
30,182,182,35,13,22,2,1
0,190,190,55,55,0,1,0
14,215,215,11,11,0,1,0
12,231,231,27,27,0,1,0
29,249,249,12,12,0,1,0
22,263,263,32,11,21,4,3
18,284,284,24,24,0,1,0
9,285,285,22,4,18,4,3
5,286,286,62,35,27,2,1
17,299,299,23,23,0,1,0
20,299,299,35,35,0,1,0
19,302,302,14,3,11,2,1
1,316,316,46,46,0,1,0
16,320,320,25,25,0,1,0
28,333,333,153,111,42,2,1
3,350,350,8,8,0,1,0
15,386,386,50,34,16,2,1
6,394,394,22,22,0,1,0
24,408,408,10,10,0,1,0
2,421,421,16,16,0,1,0
11,438,438,29,29,0,1,0
4,494,494,60,49,11,2,1
23,495,495,9,1,8,3,2
27,498,498,24,24,0,1,0
25,499,499,25,11,14,2,1

6,102,102,15,3,12,3,2
27,116,116,31,3,28,2,1
33,116,116,20,20,0,1,0
2,171,171,19,3,16,4,3
9,202,202,75,67,8,3,2
23,206,206,28,22,6,2,1
35,213,213,10,5,5,2,1
14,223,223,22,1,21,4,3
28,234,234,71,6,65,4,3
4,242,242,1,1,0,1,0
20,248,248,14,9,5,2,1
31,263,263,15,15,0,1,0
8,293,293,6,6,0,1,0
19,317,317,7,1,6,3,2
30,327,327,6,6,0,1,0
34,329,329,8,8,0,1,0
18,329,329,40,5,35,4,3
10,333,333,22,7,15,3,2
25,337,337,22,22,0,1,0
16,346,346,24,2,22,2,1
1,353,353,9,9,0,1,0
21,354,354,9,9,0,1,0
15,382,382,11,3,8,2,1
17,384,384,24,24,0,1,0
3,392,392,28,15,13,2,1
0,405,405,43,43,0,1,0
13,423,423,19,19,0,1,0
26,423,423,154,115,39,4,3
22,430,430,17,5,12,2,1
36,439,439,3,3,0,1,0
29,449,449,27,27,0,1,0
11,457,457,11,3,8,3,2
5,462,462,43,43,0,1,0
24,478,478,10,2,8,3,2
32,479,479,11,4,7,2,1
7,498,498,20,20,0,1,0
12,498,498,8,3,5,2,1

21,106,106,29,9,20,3,2
22,111,111,6,6,0,1,0
2,117,117,4,4,0,1,0
13,117,117,2,2,0,1,0
19,126,126,50,6,44,2,1
4,141,141,6,6,0,1,0
20,156,156,15,12,3,2,1
12,181,181,16,9,7,2,1
8,211,211,20,1,19,3,2
1,221,221,143,119,24,3,2
0,254,254,51,8,43,2,1
15,258,258,4,4,0,1,0
10,262,262,19,19,0,1,0
5,268,268,18,18,0,1,0
17,297,297,12,12,0,1,0
16,300,300,13,6,7,2,1
24,328,328,11,11,0,1,0
14,338,338,89,56,33,2,1
25,358,358,4,4,0,1,0
11,380,380,4,4,0,1,0
23,402,402,50,50,0,1,0
3,405,405,133,63,70,3,2
9,452,452,37,37,0,1,0
7,452,452,10,10,0,1,0
6,487,487,40,36,4,2,1
18,497,497,47,13,34,4,3

18,133,133,3,3,0,1,0
16,135,135,73,13,60,3,2
8,147,147,2,2,0,1,0
7,154,154,37,37,0,1,0
6,160,160,26,8,18,2,1
2,161,161,22,14,8,2,1
14,174,174,29,2,27,2,1
3,185,185,16,16,0,1,0
27,195,195,6,6,0,1,0
19,207,207,13,4,9,2,1
20,216,216,5,2,3,2,1
0,218,218,3,3,0,1,0
17,265,265,29,29,0,1,0
25,268,268,5,5,0,1,0
15,270,270,35,35,0,1,0
5,271,271,98,29,69,3,2
26,283,283,18,18,0,1,0
21,301,301,28,28,0,1,0
12,303,303,51,3,48,2,1
4,313,313,23,13,10,4,3
11,313,313,5,5,0,1,0
9,370,370,56,56,0,1,0
24,379,379,17,17,0,1,0
23,417,417,91,91,0,1,0
13,440,440,11,4,7,2,1
1,447,447,16,16,0,1,0
10,448,448,64,64,0,1,0
28,470,470,29,29,0,1,0
22,474,474,9,9,0,1,0

14,107,107,31,31,0,1,0
8,118,118,39,7,32,3,2
9,132,132,1,1,0,1,0
12,170,170,47,9,38,2,1
27,171,171,4,4,0,1,0
15,177,177,4,4,0,1,0
2,185,185,3,3,0,1,0
18,189,189,34,7,27,4,3
11,206,206,9,6,3,2,1
6,209,209,35,35,0,1,0
26,211,211,21,9,12,4,3
19,235,235,6,6,0,1,0
23,250,250,21,21,0,1,0
16,265,265,6,6,0,1,0
1,292,292,13,13,0,1,0
13,299,299,42,42,0,1,0
20,328,328,19,19,0,1,0
0,339,339,13,5,8,3,2
3,340,340,117,117,0,1,0
10,363,363,107,43,64,3,2
25,366,366,25,25,0,1,0
24,392,392,69,63,6,3,2
17,396,396,30,6,24,2,1
21,397,397,13,13,0,1,0
22,402,402,25,2,23,2,1
5,419,419,16,4,12,4,3
7,446,446,46,46,0,1,0
4,469,469,81,42,39,3,2

15,118,118,14,1,13,4,3
29,132,132,9,9,0,1,0
1,144,144,29,29,0,1,0
24,165,165,34,34,0,1,0
22,184,184,12,7,5,2,1
2,202,202,19,19,0,1,0
26,216,216,58,43,15,4,3
7,219,219,38,38,0,1,0
13,231,231,9,9,0,1,0
21,244,244,1,1,0,1,0
9,251,251,3,3,0,1,0
3,255,255,29,15,14,3,2
28,288,288,4,4,0,1,0
19,303,303,10,3,7,2,1
11,319,319,30,1,29,4,3
23,347,347,33,33,0,1,0
18,366,366,73,10,63,4,3
5,369,369,1,1,0,1,0
14,393,393,9,9,0,1,0
6,397,397,25,25,0,1,0
17,397,397,41,41,0,1,0
12,424,424,136,40,96,4,3
4,427,427,58,18,40,3,2
0,427,427,7,2,5,2,1
25,441,441,1,1,0,1,0
10,455,455,36,36,0,1,0
8,455,455,117,99,18,3,2
16,460,460,67,28,39,2,1
20,462,462,36,8,28,2,1
27,481,481,99,64,35,2,1

9,120,120,5,5,0,1,0
23,142,142,21,21,0,1,0
4,154,154,3,3,0,1,0
16,169,169,17,10,7,2,1
27,174,174,29,19,10,3,2
22,200,200,3,3,0,1,0
17,207,207,4,4,0,1,0
15,210,210,16,16,0,1,0
21,215,215,7,7,0,1,0
6,227,227,25,25,0,1,0
26,252,252,3,3,0,1,0
5,261,261,46,8,38,3,2
14,276,276,4,1,3,2,1
12,277,277,5,5,0,1,0
31,295,295,15,15,0,1,0
28,297,297,84,84,0,1,0
3,307,307,15,15,0,1,0
29,313,313,25,7,18,4,3
20,324,324,15,6,9,4,3
25,325,325,23,7,16,2,1
13,326,326,8,8,0,1,0
18,327,327,1,1,0,1,0
10,343,343,11,11,0,1,0
11,376,376,16,16,0,1,0
1,391,391,84,15,69,4,3
0,416,416,101,101,0,1,0
7,417,417,66,36,30,4,3
19,421,421,78,78,0,1,0
32,434,434,45,9,36,2,1
8,434,434,109,109,0,1,0
24,452,452,45,6,39,4,3
30,452,452,140,140,0,1,0
2,453,453,14,14,0,1,0

15,109,109,22,4,18,4,3
17,110,110,5,5,0,1,0
5,151,151,70,49,21,4,3
23,175,175,19,19,0,1,0
21,176,176,9,9,0,1,0
2,186,186,46,46,0,1,0
14,202,202,16,9,7,2,1
8,249,249,72,72,0,1,0
22,290,290,125,74,51,4,3
11,305,305,8,2,6,3,2
6,306,306,8,8,0,1,0
20,326,326,1,1,0,1,0
1,330,330,32,32,0,1,0
13,330,330,13,5,8,3,2
24,367,367,2,2,0,1,0
0,372,372,2,2,0,1,0
7,397,397,152,38,114,4,3
10,400,400,9,9,0,1,0
12,412,412,36,26,10,2,1
19,424,424,147,48,99,4,3
16,435,435,21,6,15,4,3
9,448,448,38,38,0,1,0
4,456,456,19,10,9,2,1
18,481,481,25,19,6,2,1
3,491,491,24,24,0,1,0

22,108,108,15,6,9,4,3
26,111,111,2,2,0,1,0
5,116,116,29,29,0,1,0
9,119,119,5,5,0,1,0
13,122,122,3,3,0,1,0
28,141,141,36,2,34,4,3
8,143,143,33,11,22,2,1
3,206,206,9,9,0,1,0
0,215,215,1,1,0,1,0
10,234,234,48,24,24,4,3
20,277,277,68,68,0,1,0
11,289,289,3,3,0,1,0
16,309,309,25,1,24,4,3
17,321,321,26,26,0,1,0
7,332,332,35,35,0,1,0
23,339,339,8,5,3,2,1
2,354,354,31,31,0,1,0
21,364,364,5,1,4,2,1
25,372,372,38,38,0,1,0
4,373,373,76,61,15,2,1
24,382,382,7,7,0,1,0
1,387,387,93,54,39,4,3
19,404,404,29,9,20,2,1
15,405,405,39,39,0,1,0
18,405,405,129,47,82,4,3
27,408,408,53,53,0,1,0
6,420,420,57,57,0,1,0
14,436,436,7,7,0,1,0
12,471,471,20,11,9,4,3

9,100,100,1,1,0,1,0
23,110,110,10,2,8,2,1
12,132,132,4,4,0,1,0
28,134,134,8,8,0,1,0
26,141,141,21,2,19,2,1
16,146,146,6,3,3,2,1
19,147,147,1,1,0,1,0
4,176,176,34,12,22,3,2
24,179,179,76,37,39,2,1
27,191,191,14,14,0,1,0
8,192,192,44,20,24,2,1
29,203,203,5,5,0,1,0
22,206,206,7,4,3,2,1
2,227,227,9,6,3,2,1
5,233,233,14,14,0,1,0
17,250,250,32,2,30,2,1
20,266,266,7,7,0,1,0
0,290,290,42,42,0,1,0
18,330,330,31,4,27,2,1
30,355,355,1,1,0,1,0
13,357,357,4,1,3,2,1
7,359,359,10,2,8,3,2
10,408,408,22,22,0,1,0
21,422,422,91,52,39,2,1
25,430,430,75,75,0,1,0
3,435,435,1,1,0,1,0
6,441,441,31,31,0,1,0
11,445,445,4,4,0,1,0
14,466,466,121,37,84,4,3
15,486,486,44,44,0,1,0
1,494,494,227,135,92,4,3

16,104,104,1,1,0,1,0
30,117,117,7,7,0,1,0
19,123,123,19,3,16,3,2
11,136,136,17,17,0,1,0
2,156,156,19,19,0,1,0
21,189,189,16,1,15,2,1
0,194,194,5,5,0,1,0
7,240,240,36,36,0,1,0
28,246,246,11,11,0,1,0
5,256,256,4,1,3,2,1
17,258,258,36,36,0,1,0
6,273,273,15,15,0,1,0
18,276,276,31,31,0,1,0
31,282,282,21,7,14,2,1
14,286,286,81,67,14,4,3
20,291,291,15,3,12,3,2
32,291,291,24,24,0,1,0
23,313,313,6,6,0,1,0
4,336,336,1,1,0,1,0
33,345,345,59,3,56,3,2
27,355,355,25,25,0,1,0
29,361,361,56,20,36,4,3
25,384,384,35,35,0,1,0
15,385,385,58,58,0,1,0
22,386,386,98,88,10,3,2
8,388,388,36,36,0,1,0
26,391,391,44,2,42,3,2
10,396,396,14,4,10,2,1
12,397,397,17,1,16,2,1
3,405,405,19,15,4,2,1
9,410,410,4,1,3,2,1
24,411,411,37,37,0,1,0
13,412,412,12,12,0,1,0
35,417,417,52,52,0,1,0
1,436,436,1,1,0,1,0
34,496,496,71,25,46,2,1

28,103,103,4,4,0,1,0
16,103,103,2,2,0,1,0
31,112,112,20,20,0,1,0
23,121,121,3,3,0,1,0
6,134,134,22,22,0,1,0
3,146,146,1,1,0,1,0
5,198,198,13,9,4,2,1
38,221,221,34,16,18,3,2
25,221,221,12,12,0,1,0
15,234,234,2,2,0,1,0
24,242,242,8,3,5,2,1
7,244,244,2,2,0,1,0
19,253,253,10,10,0,1,0
18,260,260,3,3,0,1,0
13,263,263,67,67,0,1,0
0,275,275,38,23,15,4,3
12,278,278,27,27,0,1,0
9,292,292,6,2,4,2,1
21,306,306,6,6,0,1,0
34,312,312,32,16,16,2,1
20,324,324,1,1,0,1,0
11,325,325,4,4,0,1,0
35,331,331,68,48,20,2,1
4,336,336,10,10,0,1,0
26,340,340,25,4,21,4,3
22,347,347,5,5,0,1,0
30,358,358,62,62,0,1,0
27,373,373,28,18,10,2,1
36,376,376,10,10,0,1,0
2,384,384,24,24,0,1,0
8,396,396,34,18,16,2,1
33,409,409,49,49,0,1,0
14,420,420,9,3,6,3,2
37,425,425,88,6,82,3,2
10,429,429,80,80,0,1,0
29,433,433,66,18,48,4,3
1,440,440,68,17,51,4,3
17,461,461,81,15,66,3,2
32,488,488,6,6,0,1,0

17,111,111,4,4,0,1,0
6,126,126,18,14,4,2,1
0,161,161,55,46,9,4,3
2,166,166,8,8,0,1,0
11,172,172,8,4,4,2,1
20,188,188,1,1,0,1,0
19,191,191,20,20,0,1,0
1,205,205,4,4,0,1,0
8,239,239,41,11,30,4,3
3,256,256,119,8,111,4,3
12,281,281,45,45,0,1,0
22,288,288,9,9,0,1,0
9,307,307,6,6,0,1,0
10,349,349,10,1,9,2,1
4,369,369,53,47,6,2,1
23,387,387,7,3,4,2,1
14,412,412,57,42,15,2,1
16,412,412,52,31,21,4,3
18,418,418,123,39,84,4,3
7,436,436,23,23,0,1,0
21,472,472,7,7,0,1,0
13,484,484,46,37,9,4,3
15,499,499,169,140,29,2,1
5,499,499,194,194,0,1,0

18,108,108,1,1,0,1,0
38,119,119,3,3,0,1,0
10,143,143,10,10,0,1,0
27,149,149,8,2,6,3,2
25,176,176,10,10,0,1,0
19,178,178,14,2,12,4,3
21,186,186,11,8,3,2,1
0,187,187,21,21,0,1,0
4,192,192,19,19,0,1,0
2,194,194,1,1,0,1,0
17,200,200,15,12,3,2,1
24,212,212,53,53,0,1,0
34,222,222,2,2,0,1,0
16,236,236,3,3,0,1,0
33,236,236,1,1,0,1,0
6,238,238,12,4,8,3,2
3,266,266,46,46,0,1,0
36,283,283,7,4,3,2,1
11,298,298,27,2,25,2,1
28,308,308,34,2,32,3,2
32,316,316,19,19,0,1,0
12,324,324,74,12,62,3,2
1,325,325,55,51,4,2,1
13,340,340,13,13,0,1,0
15,378,378,4,4,0,1,0
14,394,394,26,26,0,1,0
23,406,406,36,36,0,1,0
37,412,412,11,7,4,2,1
7,416,416,12,2,10,2,1
22,416,416,3,3,0,1,0
5,431,431,28,28,0,1,0
35,446,446,15,7,8,2,1
30,459,459,227,162,65,4,3
31,464,464,159,27,132,4,3
20,465,465,2,2,0,1,0
29,472,472,20,20,0,1,0
9,472,472,60,18,42,3,2
26,478,478,2,2,0,1,0
8,480,480,10,10,0,1,0

30,103,103,5,1,4,2,1
22,105,105,8,8,0,1,0
10,118,118,5,5,0,1,0
24,118,118,22,22,0,1,0
4,121,121,31,6,25,2,1
16,125,125,6,6,0,1,0
25,130,130,32,9,23,4,3
13,140,140,12,12,0,1,0
14,166,166,16,16,0,1,0
18,177,177,5,5,0,1,0
29,201,201,10,10,0,1,0
9,207,207,4,1,3,2,1
11,221,221,1,1,0,1,0
17,225,225,10,10,0,1,0
19,238,238,24,24,0,1,0
1,251,251,25,5,20,3,2
21,257,257,37,9,28,4,3
12,259,259,17,8,9,2,1
8,264,264,12,12,0,1,0
0,269,269,29,29,0,1,0
15,290,290,35,35,0,1,0
33,346,346,89,41,48,2,1
23,349,349,20,20,0,1,0
31,352,352,3,3,0,1,0
26,361,361,12,12,0,1,0
28,374,374,21,21,0,1,0
27,394,394,10,6,4,2,1
20,397,397,108,108,0,1,0
5,398,398,15,15,0,1,0
7,412,412,1,1,0,1,0
6,460,460,108,108,0,1,0
3,475,475,121,59,62,3,2
32,488,488,20,20,0,1,0
2,493,493,17,5,12,4,3

36,110,110,40,15,25,4,3
32,113,113,8,5,3,2,1
29,125,125,4,4,0,1,0
30,136,136,8,3,5,2,1
8,154,154,8,8,0,1,0
20,174,174,6,6,0,1,0
25,199,199,10,10,0,1,0
31,202,202,34,34,0,1,0
18,260,260,5,5,0,1,0
17,260,260,6,6,0,1,0
24,265,265,5,5,0,1,0
5,277,277,26,26,0,1,0
4,319,319,47,33,14,3,2
35,322,322,1,1,0,1,0
23,332,332,12,12,0,1,0
6,339,339,13,1,12,4,3
7,344,344,59,29,30,2,1
27,358,358,56,56,0,1,0
16,383,383,38,38,0,1,0
0,384,384,2,2,0,1,0
2,392,392,1,1,0,1,0
21,398,398,20,20,0,1,0
10,400,400,51,51,0,1,0
14,404,404,2,2,0,1,0
15,416,416,73,5,68,3,2
12,429,429,52,28,24,2,1
22,431,431,9,1,8,3,2
3,431,431,2,2,0,1,0
34,432,432,88,79,9,4,3
26,435,435,1,1,0,1,0
1,437,437,8,1,7,2,1
11,442,442,38,7,31,2,1
33,454,454,36,36,0,1,0
19,471,471,106,106,0,1,0
28,482,482,158,74,84,4,3
13,495,495,55,50,5,2,1
9,499,499,21,7,14,2,1

25,102,102,31,31,0,1,0
5,102,102,21,18,3,2,1
33,124,124,1,1,0,1,0
3,136,136,4,1,3,2,1
36,146,146,26,26,0,1,0
14,147,147,2,2,0,1,0
29,147,147,5,2,3,2,1
2,166,166,3,3,0,1,0
16,166,166,7,7,0,1,0
9,171,171,25,25,0,1,0
20,174,174,14,9,5,2,1
12,179,179,5,2,3,2,1
31,227,227,62,44,18,3,2
34,245,245,20,6,14,2,1
18,253,253,8,2,6,3,2
10,259,259,17,17,0,1,0
0,274,274,80,50,30,2,1
32,276,276,18,18,0,1,0
8,283,283,11,2,9,2,1
22,301,301,20,20,0,1,0
19,316,316,58,58,0,1,0
21,321,321,43,29,14,4,3
28,349,349,10,10,0,1,0
26,353,353,13,3,10,2,1
24,380,380,86,86,0,1,0
17,391,391,9,9,0,1,0
4,395,395,7,1,6,2,1
6,398,398,26,26,0,1,0
13,402,402,40,9,31,2,1
23,418,418,7,7,0,1,0
7,428,428,10,2,8,3,2
15,434,434,9,9,0,1,0
1,459,459,73,47,26,4,3
30,473,473,27,15,12,4,3
27,475,475,58,38,20,2,1
35,478,478,2,2,0,1,0
11,484,484,9,9,0,1,0

4,162,162,27,6,21,4,3
1,163,163,34,34,0,1,0
13,203,203,48,15,33,2,1
21,211,211,1,1,0,1,0
11,215,215,18,8,10,2,1
0,256,256,7,2,5,2,1
12,269,269,1,1,0,1,0
5,271,271,26,16,10,3,2
3,274,274,114,20,94,3,2
18,274,274,3,3,0,1,0
24,281,281,33,28,5,2,1
6,295,295,16,7,9,2,1
15,306,306,21,21,0,1,0
8,309,309,38,38,0,1,0
2,312,312,18,18,0,1,0
23,323,323,53,15,38,2,1
16,346,346,44,44,0,1,0
7,366,366,24,24,0,1,0
25,372,372,63,51,12,4,3
27,378,378,47,47,0,1,0
14,398,398,21,21,0,1,0
10,401,401,79,56,23,2,1
9,409,409,43,9,34,2,1
19,418,418,42,27,15,4,3
22,418,418,94,94,0,1,0
20,422,422,9,9,0,1,0
26,433,433,81,39,42,4,3
17,481,481,4,1,3,2,1

35,123,123,10,5,5,2,1
29,125,125,14,14,0,1,0
16,150,150,9,9,0,1,0
11,168,168,19,19,0,1,0
0,171,171,10,10,0,1,0
12,176,176,4,1,3,2,1
27,194,194,44,2,42,2,1
14,202,202,14,6,8,3,2
25,209,209,24,20,4,2,1
32,246,246,9,4,5,2,1
13,249,249,26,26,0,1,0
3,256,256,10,5,5,2,1
28,263,263,37,37,0,1,0
1,265,265,6,6,0,1,0
21,294,294,6,3,3,2,1
26,308,308,109,82,27,4,3
8,323,323,5,1,4,2,1
4,328,328,16,16,0,1,0
24,329,329,19,19,0,1,0
23,370,370,28,28,0,1,0
22,374,374,9,9,0,1,0
33,383,383,19,19,0,1,0
9,385,385,26,6,20,3,2
2,401,401,13,13,0,1,0
30,410,410,18,18,0,1,0
19,415,415,18,18,0,1,0
31,416,416,62,14,48,2,1
7,424,424,90,64,26,2,1
10,433,433,12,12,0,1,0
20,446,446,15,10,5,2,1
34,462,462,50,50,0,1,0
18,468,468,77,51,26,3,2
17,468,468,147,84,63,4,3
6,472,472,19,1,18,2,1
5,486,486,56,51,5,2,1
15,488,488,15,2,13,2,1

4,119,119,1,1,0,1,0
13,131,131,3,3,0,1,0
16,143,143,27,27,0,1,0
5,161,161,3,3,0,1,0
7,175,175,5,5,0,1,0
11,177,177,74,74,0,1,0
0,180,180,13,7,6,2,1
18,194,194,5,5,0,1,0
29,197,197,2,2,0,1,0
28,197,197,16,8,8,3,2
30,201,201,8,3,5,2,1
21,204,204,17,17,0,1,0
2,209,209,1,1,0,1,0
12,216,216,1,1,0,1,0
33,220,220,99,99,0,1,0
6,221,221,2,2,0,1,0
9,234,234,9,9,0,1,0
20,241,241,32,14,18,3,2
3,241,241,11,6,5,2,1
17,270,270,2,2,0,1,0
14,310,310,130,130,0,1,0
15,314,314,5,5,0,1,0
27,319,319,35,18,17,2,1
1,320,320,1,1,0,1,0
23,348,348,43,43,0,1,0
10,367,367,80,80,0,1,0
32,388,388,60,16,44,3,2
31,412,412,22,2,20,3,2
22,420,420,12,4,8,2,1
25,433,433,32,4,28,3,2
19,434,434,47,30,17,2,1
8,468,468,37,29,8,3,2
26,470,470,44,15,29,2,1
24,475,475,30,15,15,4,3

28,105,105,17,6,11,2,1
25,113,113,10,10,0,1,0
26,141,141,7,7,0,1,0
31,145,145,4,4,0,1,0
10,157,157,1,1,0,1,0
7,181,181,65,65,0,1,0
2,183,183,24,8,16,2,1
32,187,187,8,1,7,2,1
13,194,194,4,4,0,1,0
15,208,208,44,44,0,1,0
0,209,209,15,15,0,1,0
17,240,240,21,21,0,1,0
9,244,244,26,13,13,2,1
5,246,246,10,10,0,1,0
6,247,247,16,16,0,1,0
4,248,248,17,17,0,1,0
33,277,277,11,6,5,2,1
27,279,279,49,40,9,2,1
22,286,286,35,23,12,3,2
18,297,297,2,2,0,1,0
3,322,322,59,59,0,1,0
12,325,325,25,25,0,1,0
19,385,385,11,3,8,2,1
14,398,398,22,4,18,4,3
1,405,405,8,8,0,1,0
21,405,405,37,7,30,4,3
20,412,412,116,12,104,4,3
16,422,422,11,11,0,1,0
23,428,428,44,9,35,2,1
24,431,431,122,122,0,1,0
34,444,444,20,17,3,2,1
29,452,452,21,21,0,1,0
11,479,479,4,4,0,1,0
30,486,486,23,23,0,1,0
8,499,499,29,29,0,1,0

7,102,102,9,9,0,1,0
11,103,103,17,8,9,4,3
5,109,109,10,10,0,1,0
6,114,114,23,1,22,2,1
15,116,116,10,10,0,1,0
27,129,129,12,8,4,2,1
26,133,133,30,16,14,4,3
16,139,139,3,3,0,1,0
0,173,173,16,16,0,1,0
3,181,181,23,20,3,2,1
20,226,226,15,1,14,2,1
1,231,231,65,5,60,3,2
12,231,231,16,11,5,2,1
8,257,257,8,8,0,1,0
19,262,262,51,51,0,1,0
4,266,266,15,11,4,2,1
31,292,292,32,8,24,3,2
24,321,321,3,3,0,1,0
10,334,334,2,2,0,1,0
30,340,340,1,1,0,1,0
17,347,347,12,12,0,1,0
29,351,351,21,21,0,1,0
9,410,410,14,14,0,1,0
13,411,411,52,52,0,1,0
18,413,413,29,29,0,1,0
22,415,415,17,17,0,1,0
28,432,432,89,47,42,2,1
32,447,447,60,36,24,3,2
21,451,451,13,1,12,3,2
23,470,470,78,14,64,4,3
25,477,477,88,18,70,3,2
14,479,479,14,4,10,3,2
2,497,497,46,16,30,3,2

25,101,101,24,16,8,2,1
10,140,140,5,5,0,1,0
29,143,143,29,29,0,1,0
4,148,148,8,1,7,2,1
11,158,158,1,1,0,1,0
0,160,160,26,26,0,1,0
23,183,183,12,12,0,1,0
9,188,188,28,4,24,3,2
7,196,196,12,1,11,2,1
31,199,199,12,2,10,3,2
30,201,201,4,4,0,1,0
34,214,214,17,17,0,1,0
8,233,233,26,12,14,3,2
18,241,241,11,11,0,1,0
20,241,241,31,31,0,1,0
32,244,244,3,3,0,1,0
5,248,248,31,4,27,4,3
2,250,250,5,5,0,1,0
16,274,274,15,9,6,3,2
28,282,282,3,3,0,1,0
22,344,344,9,5,4,2,1
17,355,355,4,4,0,1,0
1,363,363,13,13,0,1,0
21,364,364,14,14,0,1,0
27,377,377,44,44,0,1,0
33,391,391,15,3,12,4,3
15,405,405,68,68,0,1,0
14,427,427,81,12,69,4,3
24,443,443,79,33,46,3,2
13,450,450,12,2,10,2,1
6,464,464,2,2,0,1,0
3,469,469,86,86,0,1,0
12,473,473,75,69,6,3,2
26,474,474,88,80,8,3,2
19,496,496,118,42,76,3,2

31,120,120,11,11,0,1,0
30,131,131,3,3,0,1,0
18,132,132,24,24,0,1,0
9,143,143,1,1,0,1,0
10,164,164,1,1,0,1,0
2,168,168,1,1,0,1,0
29,199,199,31,31,0,1,0
20,202,202,9,9,0,1,0
1,210,210,29,6,23,2,1
0,234,234,20,4,16,2,1
23,235,235,3,3,0,1,0
5,241,241,3,3,0,1,0
21,255,255,20,11,9,3,2
7,269,269,51,14,37,2,1
27,273,273,29,3,26,2,1
22,278,278,13,7,6,3,2
25,289,289,5,5,0,1,0
26,309,309,36,3,33,4,3
34,309,309,1,1,0,1,0
28,362,362,40,14,26,3,2
32,368,368,82,38,44,2,1
17,375,375,2,2,0,1,0
19,376,376,79,55,24,2,1
15,376,376,18,18,0,1,0
16,382,382,106,72,34,2,1
38,399,399,20,20,0,1,0
35,400,400,9,9,0,1,0
6,400,400,28,14,14,3,2
11,406,406,15,15,0,1,0
33,412,412,13,5,8,3,2
24,412,412,30,6,24,3,2
12,422,422,5,5,0,1,0
13,426,426,4,4,0,1,0
8,438,438,27,22,5,2,1
4,456,456,6,6,0,1,0
36,460,460,13,13,0,1,0
39,474,474,30,30,0,1,0
3,485,485,22,22,0,1,0
37,489,489,251,251,0,1,0
14,496,496,2,2,0,1,0

6,107,107,23,13,10,2,1
3,115,115,6,6,0,1,0
21,122,122,13,13,0,1,0
29,127,127,4,4,0,1,0
22,131,131,7,4,3,2,1
25,166,166,11,11,0,1,0
11,218,218,6,6,0,1,0
15,228,228,10,7,3,2,1
20,238,238,19,3,16,3,2
17,244,244,9,9,0,1,0
26,250,250,69,69,0,1,0
19,250,250,6,6,0,1,0
0,274,274,54,18,36,4,3
13,292,292,10,10,0,1,0
7,293,293,8,8,0,1,0
16,317,317,10,10,0,1,0
18,339,339,38,30,8,2,1
10,362,362,34,34,0,1,0
14,373,373,11,11,0,1,0
23,389,389,17,1,16,2,1
12,407,407,66,26,40,3,2
9,423,423,42,42,0,1,0
28,436,436,86,80,6,2,1
32,444,444,128,74,54,3,2
4,445,445,130,130,0,1,0
8,453,453,30,2,28,4,3
30,453,453,24,24,0,1,0
24,456,456,66,48,18,2,1
27,457,457,45,45,0,1,0
1,468,468,30,30,0,1,0
5,470,470,27,9,18,2,1
31,488,488,11,3,8,3,2
2,493,493,53,31,22,2,1

21,117,117,6,6,0,1,0
9,124,124,10,10,0,1,0
27,124,124,6,6,0,1,0
24,127,127,4,1,3,2,1
6,130,130,9,9,0,1,0
23,131,131,29,29,0,1,0
25,133,133,9,9,0,1,0
18,139,139,42,30,12,4,3
3,165,165,63,32,31,4,3
28,181,181,2,2,0,1,0
15,192,192,4,1,3,2,1
17,193,193,25,7,18,4,3
20,245,245,41,34,7,2,1
31,276,276,35,7,28,3,2
22,285,285,3,3,0,1,0
10,298,298,13,13,0,1,0
1,315,315,12,3,9,4,3
4,316,316,30,24,6,2,1
13,326,326,5,1,4,2,1
12,327,327,1,1,0,1,0
30,346,346,18,18,0,1,0
8,369,369,152,103,49,4,3
14,379,379,5,5,0,1,0
5,402,402,6,6,0,1,0
2,406,406,11,11,0,1,0
0,422,422,14,5,9,4,3
26,427,427,66,50,16,2,1
19,446,446,67,67,0,1,0
29,447,447,40,10,30,3,2
7,454,454,38,14,24,4,3
11,454,454,124,91,33,4,3
16,467,467,12,12,0,1,0

32,112,112,9,9,0,1,0
34,131,131,13,13,0,1,0
11,138,138,10,10,0,1,0
15,140,140,2,2,0,1,0
12,152,152,26,26,0,1,0
1,164,164,11,3,8,3,2
7,166,166,4,4,0,1,0
29,174,174,7,1,6,3,2
5,175,175,29,2,27,4,3
8,187,187,4,4,0,1,0
2,263,263,6,6,0,1,0
33,266,266,15,15,0,1,0
13,270,270,7,2,5,2,1
6,283,283,112,112,0,1,0
16,283,283,1,1,0,1,0
24,296,296,59,59,0,1,0
27,302,302,24,24,0,1,0
19,313,313,57,14,43,2,1
20,331,331,9,2,7,2,1
9,331,331,23,9,14,3,2
31,359,359,9,3,6,3,2
18,372,372,37,34,3,2,1
22,389,389,74,39,35,2,1
3,395,395,84,84,0,1,0
26,395,395,48,40,8,2,1
4,400,400,40,40,0,1,0
25,419,419,56,9,47,2,1
17,423,423,5,1,4,2,1
23,438,438,11,3,8,2,1
30,439,439,15,15,0,1,0
0,449,449,20,20,0,1,0
21,460,460,149,149,0,1,0
14,492,492,6,6,0,1,0
10,499,499,34,34,0,1,0
28,500,500,6,6,0,1,0

31,103,103,28,28,0,1,0
27,110,110,7,1,6,2,1
7,125,125,8,8,0,1,0
20,138,138,31,13,18,4,3
18,146,146,21,8,13,2,1
38,165,165,30,3,27,4,3
39,165,165,2,2,0,1,0
24,167,167,1,1,0,1,0
3,178,178,3,3,0,1,0
6,180,180,9,9,0,1,0
21,192,192,14,10,4,2,1
33,200,200,20,20,0,1,0
8,205,205,2,2,0,1,0
36,212,212,7,2,5,2,1
34,212,212,7,7,0,1,0
9,221,221,16,4,12,3,2
1,237,237,10,4,6,3,2
0,245,245,24,24,0,1,0
15,249,249,6,6,0,1,0
30,251,251,6,2,4,2,1
40,252,252,23,6,17,2,1
2,256,256,24,24,0,1,0
16,292,292,3,3,0,1,0
37,294,294,2,2,0,1,0
13,307,307,15,15,0,1,0
35,328,328,15,1,14,3,2
12,357,357,1,1,0,1,0
14,382,382,62,43,19,2,1
4,393,393,18,18,0,1,0
17,402,402,25,25,0,1,0
26,410,410,2,2,0,1,0
32,412,412,36,10,26,3,2
11,431,431,1,1,0,1,0
19,437,437,15,15,0,1,0
25,442,442,91,59,32,3,2
10,443,443,95,95,0,1,0
28,452,452,78,78,0,1,0
29,459,459,140,140,0,1,0
22,473,473,24,21,3,2,1
5,493,493,22,22,0,1,0
23,496,496,4,4,0,1,0

16,110,110,8,8,0,1,0
9,115,115,5,5,0,1,0
32,118,118,44,18,26,3,2
28,131,131,3,3,0,1,0
10,132,132,12,7,5,2,1
7,152,152,1,1,0,1,0
31,152,152,16,4,12,2,1
27,174,174,5,5,0,1,0
3,180,180,1,1,0,1,0
17,183,183,14,14,0,1,0
23,201,201,6,6,0,1,0
20,206,206,48,9,39,3,2
5,209,209,8,8,0,1,0
12,213,213,3,3,0,1,0
1,214,214,16,16,0,1,0
21,220,220,15,2,13,2,1
19,232,232,21,21,0,1,0
15,234,234,29,19,10,2,1
18,237,237,36,36,0,1,0
29,258,258,7,1,6,2,1
8,259,259,24,21,3,2,1
13,280,280,18,18,0,1,0
22,306,306,54,54,0,1,0
25,313,313,41,27,14,3,2
0,337,337,85,22,63,4,3
11,361,361,75,61,14,3,2
24,366,366,39,7,32,3,2
34,371,371,15,1,14,3,2
30,390,390,7,1,6,3,2
4,412,412,25,25,0,1,0
14,420,420,53,29,24,2,1
26,447,447,49,10,39,4,3
2,448,448,10,10,0,1,0
6,448,448,35,25,10,2,1
33,474,474,39,19,20,2,1

24,129,129,21,15,6,2,1
26,133,133,1,1,0,1,0
19,136,136,1,1,0,1,0
2,143,143,3,3,0,1,0
16,155,155,24,24,0,1,0
5,168,168,43,2,41,4,3
0,196,196,29,5,24,3,2
23,238,238,9,6,3,2,1
10,239,239,56,56,0,1,0
13,249,249,43,43,0,1,0
7,262,262,75,75,0,1,0
8,287,287,11,2,9,4,3
4,290,290,2,2,0,1,0
21,323,323,28,21,7,2,1
22,341,341,100,100,0,1,0
18,357,357,69,42,27,2,1
12,366,366,90,73,17,2,1
17,392,392,10,5,5,2,1
15,394,394,16,16,0,1,0
3,394,394,50,50,0,1,0
20,403,403,12,7,5,2,1
6,411,411,147,147,0,1,0
1,411,411,22,22,0,1,0
14,420,420,29,7,22,2,1
25,430,430,31,31,0,1,0
11,433,433,12,2,10,3,2
9,443,443,33,1,32,4,3

14,150,150,11,1,10,3,2
27,162,162,3,3,0,1,0
12,171,171,6,6,0,1,0
13,187,187,44,44,0,1,0
31,214,214,21,21,0,1,0
7,238,238,13,13,0,1,0
26,239,239,9,9,0,1,0
19,244,244,56,56,0,1,0
5,244,244,11,2,9,2,1
23,253,253,60,60,0,1,0
16,266,266,7,7,0,1,0
28,284,284,19,4,15,4,3
21,289,289,15,1,14,3,2
6,297,297,3,3,0,1,0
30,321,321,55,23,32,3,2
11,328,328,26,26,0,1,0
9,336,336,104,32,72,3,2
22,347,347,7,7,0,1,0
15,352,352,6,2,4,2,1
29,362,362,38,38,0,1,0
10,365,365,43,43,0,1,0
4,378,378,12,12,0,1,0
1,382,382,16,16,0,1,0
24,421,421,14,14,0,1,0
25,455,455,48,48,0,1,0
0,461,461,7,7,0,1,0
3,467,467,8,8,0,1,0
18,475,475,34,34,0,1,0
2,477,477,4,4,0,1,0
8,482,482,234,177,57,4,3
17,485,485,32,18,14,2,1
32,489,489,133,46,87,4,3
20,491,491,22,22,0,1,0

6,103,103,1,1,0,1,0
4,105,105,20,10,10,2,1
8,119,119,30,30,0,1,0
10,129,129,21,4,17,2,1
14,162,162,54,54,0,1,0
0,170,170,13,13,0,1,0
17,194,194,59,21,38,3,2
24,197,197,5,5,0,1,0
11,208,208,3,3,0,1,0
25,235,235,3,3,0,1,0
5,241,241,47,5,42,3,2
3,261,261,3,3,0,1,0
13,261,261,49,35,14,2,1
28,279,279,1,1,0,1,0
16,280,280,82,31,51,4,3
21,301,301,2,2,0,1,0
29,328,328,4,4,0,1,0
30,380,380,19,13,6,2,1
26,410,410,17,5,12,3,2
7,415,415,17,5,12,4,3
1,428,428,6,1,5,2,1
27,448,448,15,15,0,1,0
15,457,457,21,7,14,3,2
9,458,458,12,6,6,2,1
12,465,465,41,41,0,1,0
22,468,468,48,24,24,4,3
19,473,473,31,31,0,1,0
20,485,485,79,53,26,3,2
2,486,486,1,1,0,1,0
23,488,488,2,2,0,1,0
18,497,497,229,229,0,1,0

16,122,122,7,7,0,1,0
35,133,133,26,26,0,1,0
1,139,139,10,10,0,1,0
7,140,140,10,10,0,1,0
21,140,140,4,4,0,1,0
23,167,167,19,19,0,1,0
15,186,186,1,1,0,1,0
19,206,206,18,8,10,2,1
34,209,209,2,2,0,1,0
31,213,213,20,20,0,1,0
17,219,219,12,12,0,1,0
36,231,231,48,20,28,2,1
9,239,239,22,22,0,1,0
26,252,252,50,50,0,1,0
6,256,256,20,20,0,1,0
27,260,260,66,66,0,1,0
12,273,273,23,23,0,1,0
25,274,274,22,1,21,3,2
29,275,275,2,2,0,1,0
32,300,300,32,32,0,1,0
13,339,339,7,1,6,3,2
37,350,350,3,3,0,1,0
5,360,360,11,2,9,2,1
22,361,361,42,42,0,1,0
11,369,369,16,16,0,1,0
2,374,374,20,2,18,4,3
3,378,378,39,39,0,1,0
20,382,382,5,5,0,1,0
28,384,384,33,25,8,3,2
30,387,387,32,32,0,1,0
0,423,423,39,27,12,4,3
24,434,434,20,4,16,2,1
10,434,434,22,5,17,2,1
8,439,439,114,114,0,1,0
18,468,468,4,4,0,1,0
4,489,489,110,56,54,4,3
14,489,489,36,13,23,3,2
33,498,498,10,7,3,2,1

15,114,114,13,4,9,4,3
11,134,134,1,1,0,1,0
19,138,138,5,5,0,1,0
23,151,151,12,12,0,1,0
27,157,157,12,12,0,1,0
0,163,163,14,1,13,2,1
4,188,188,67,45,22,3,2
7,206,206,1,1,0,1,0
30,218,218,23,3,20,2,1
5,219,219,10,10,0,1,0
3,225,225,3,3,0,1,0
12,236,236,12,12,0,1,0
24,288,288,8,8,0,1,0
22,344,344,63,63,0,1,0
26,347,347,29,8,21,4,3
25,352,352,21,21,0,1,0
28,369,369,59,40,19,2,1
21,388,388,41,7,34,4,3
17,393,393,22,22,0,1,0
20,396,396,67,67,0,1,0
14,407,407,1,1,0,1,0
8,409,409,135,135,0,1,0
6,414,414,83,1,82,3,2
1,415,415,97,57,40,3,2
13,441,441,36,36,0,1,0
18,446,446,66,66,0,1,0
16,449,449,99,81,18,2,1
9,468,468,10,10,0,1,0
10,492,492,14,4,10,2,1
29,495,495,5,5,0,1,0
2,499,499,69,29,40,3,2

14,106,106,10,10,0,1,0
23,111,111,38,15,23,2,1
17,118,118,4,4,0,1,0
25,127,127,7,1,6,3,2
22,132,132,1,1,0,1,0
15,143,143,1,1,0,1,0
18,198,198,25,25,0,1,0
16,200,200,45,45,0,1,0
26,206,206,32,32,0,1,0
10,212,212,46,46,0,1,0
9,217,217,16,12,4,2,1
6,236,236,15,15,0,1,0
28,256,256,17,17,0,1,0
3,258,258,61,61,0,1,0
1,269,269,18,18,0,1,0
27,275,275,34,24,10,2,1
12,292,292,56,56,0,1,0
20,312,312,34,34,0,1,0
4,317,317,57,57,0,1,0
7,329,329,31,31,0,1,0
2,359,359,36,36,0,1,0
19,364,364,3,3,0,1,0
24,368,368,45,45,0,1,0
11,378,378,68,68,0,1,0
8,384,384,37,10,27,3,2
5,398,398,14,14,0,1,0
0,439,439,29,29,0,1,0
21,442,442,18,18,0,1,0
13,473,473,60,24,36,4,3

24,108,108,1,1,0,1,0
2,113,113,6,6,0,1,0
23,114,114,17,17,0,1,0
9,135,135,17,17,0,1,0
17,167,167,11,5,6,2,1
30,199,199,32,32,0,1,0
18,200,200,1,1,0,1,0
3,230,230,23,12,11,2,1
6,231,231,25,25,0,1,0
5,232,232,12,12,0,1,0
15,242,242,96,2,94,3,2
21,250,250,29,7,22,3,2
11,264,264,31,25,6,2,1
12,267,267,1,1,0,1,0
7,295,295,22,12,10,3,2
16,383,383,15,15,0,1,0
19,389,389,28,28,0,1,0
26,391,391,46,10,36,3,2
29,391,391,18,9,9,4,3
27,392,392,81,81,0,1,0
14,424,424,100,100,0,1,0
0,429,429,85,54,31,2,1
8,448,448,86,53,33,2,1
20,457,457,18,18,0,1,0
10,467,467,60,15,45,4,3
4,473,473,53,29,24,4,3
25,475,475,26,12,14,2,1
13,481,481,22,10,12,4,3
1,490,490,27,21,6,3,2
28,497,497,54,54,0,1,0
22,499,499,24,24,0,1,0

5,108,108,6,6,0,1,0
25,115,115,3,3,0,1,0
13,120,120,17,17,0,1,0
7,152,152,5,5,0,1,0
17,159,159,1,1,0,1,0
33,163,163,2,2,0,1,0
22,178,178,7,1,6,2,1
1,179,179,15,3,12,3,2
30,181,181,20,20,0,1,0
6,191,191,9,9,0,1,0
31,204,204,23,16,7,2,1
16,228,228,14,14,0,1,0
29,248,248,6,6,0,1,0
26,248,248,16,16,0,1,0
15,250,250,6,6,0,1,0
10,251,251,53,53,0,1,0
9,265,265,3,3,0,1,0
28,280,280,114,114,0,1,0
18,284,284,14,2,12,4,3
3,285,285,11,5,6,2,1
12,291,291,7,7,0,1,0
20,297,297,12,12,0,1,0
8,310,310,87,87,0,1,0
24,313,313,62,38,24,4,3
34,317,317,17,17,0,1,0
23,332,332,70,41,29,4,3
0,357,357,75,75,0,1,0
21,363,363,31,3,28,3,2
35,381,381,11,4,7,2,1
19,381,381,37,37,0,1,0
2,394,394,1,1,0,1,0
32,442,442,87,87,0,1,0
14,448,448,47,17,30,4,3
4,454,454,31,1,30,4,3
27,484,484,12,12,0,1,0
11,490,490,25,25,0,1,0

22,103,103,6,2,4,2,1
5,121,121,5,1,4,2,1
29,123,123,18,18,0,1,0
0,129,129,29,6,23,2,1
1,163,163,15,15,0,1,0
10,163,163,12,4,8,2,1
6,196,196,41,25,16,2,1
20,198,198,20,2,18,4,3
15,203,203,2,2,0,1,0
11,223,223,3,3,0,1,0
3,252,252,6,6,0,1,0
31,259,259,3,3,0,1,0
16,278,278,30,4,26,3,2
17,295,295,74,29,45,2,1
9,300,300,13,7,6,2,1
28,312,312,9,1,8,2,1
8,324,324,6,6,0,1,0
18,349,349,105,48,57,4,3
23,359,359,30,30,0,1,0
13,391,391,31,31,0,1,0
4,410,410,19,1,18,3,2
7,420,420,21,17,4,2,1
27,432,432,3,3,0,1,0
32,432,432,52,13,39,4,3
25,452,452,42,42,0,1,0
14,458,458,26,16,10,2,1
21,460,460,41,36,5,2,1
30,461,461,8,4,4,2,1
24,462,462,91,91,0,1,0
12,469,469,179,159,20,2,1
2,472,472,62,35,27,2,1
26,480,480,25,25,0,1,0
19,499,499,35,35,0,1,0

27,111,111,4,4,0,1,0
18,113,113,10,1,9,4,3
11,115,115,2,2,0,1,0
40,123,123,10,10,0,1,0
22,126,126,13,13,0,1,0
13,138,138,3,3,0,1,0
31,166,166,21,21,0,1,0
9,194,194,23,23,0,1,0
4,194,194,1,1,0,1,0
6,202,202,6,6,0,1,0
39,225,225,35,10,25,2,1
0,238,238,3,3,0,1,0
21,238,238,8,8,0,1,0
17,241,241,18,18,0,1,0
34,260,260,41,15,26,3,2
30,261,261,16,16,0,1,0
23,267,267,21,21,0,1,0
28,268,268,10,10,0,1,0
33,283,283,54,54,0,1,0
3,283,283,15,15,0,1,0
38,283,283,89,89,0,1,0
16,294,294,53,53,0,1,0
36,312,312,44,44,0,1,0
24,314,314,23,6,17,2,1
32,334,334,9,9,0,1,0
7,339,339,1,1,0,1,0
29,355,355,40,27,13,4,3
10,361,361,14,4,10,3,2
37,377,377,58,10,48,3,2
12,380,380,2,2,0,1,0
20,382,382,10,4,6,2,1
15,383,383,14,1,13,3,2
8,402,402,55,55,0,1,0
1,408,408,19,9,10,3,2
14,422,422,76,76,0,1,0
35,448,448,13,13,0,1,0
5,451,451,88,60,28,3,2
25,455,455,2,2,0,1,0
26,475,475,1,1,0,1,0
19,482,482,1,1,0,1,0
2,484,484,20,20,0,1,0

8,127,127,25,25,0,1,0
30,132,132,39,39,0,1,0
26,142,142,37,37,0,1,0
2,159,159,19,19,0,1,0
24,161,161,8,8,0,1,0
11,170,170,10,10,0,1,0
21,172,172,3,3,0,1,0
29,177,177,3,3,0,1,0
19,177,177,16,16,0,1,0
18,237,237,8,2,6,2,1
7,252,252,8,8,0,1,0
16,254,254,1,1,0,1,0
15,267,267,18,10,8,2,1
5,275,275,4,4,0,1,0
14,298,298,40,40,0,1,0
20,300,300,56,2,54,4,3
10,307,307,44,26,18,4,3
27,309,309,34,34,0,1,0
28,331,331,18,1,17,2,1
3,344,344,12,12,0,1,0
12,356,356,82,32,50,3,2
0,393,393,12,12,0,1,0
23,398,398,89,7,82,3,2
25,401,401,43,21,22,3,2
22,431,431,49,49,0,1,0
13,454,454,34,18,16,3,2
1,466,466,185,185,0,1,0
4,470,470,41,41,0,1,0
6,476,476,1,1,0,1,0
17,491,491,5,5,0,1,0
9,495,495,22,1,21,4,3

28,105,105,12,2,10,2,1
1,122,122,11,1,10,3,2
25,124,124,12,12,0,1,0
5,128,128,10,10,0,1,0
27,149,149,20,11,9,2,1
22,193,193,12,3,9,4,3
12,203,203,38,2,36,4,3
4,218,218,13,5,8,2,1
18,221,221,6,6,0,1,0
8,232,232,31,31,0,1,0
21,235,235,10,10,0,1,0
24,240,240,11,11,0,1,0
19,242,242,13,7,6,2,1
30,253,253,28,4,24,4,3
0,263,263,31,31,0,1,0
9,266,266,22,22,0,1,0
17,275,275,22,7,15,4,3
29,277,277,25,25,0,1,0
15,334,334,77,33,44,3,2
26,363,363,37,29,8,3,2
14,371,371,23,23,0,1,0
13,373,373,1,1,0,1,0
20,377,377,46,11,35,2,1
6,412,412,38,4,34,3,2
10,446,446,117,117,0,1,0
7,448,448,134,81,53,4,3
3,453,453,14,14,0,1,0
2,479,479,4,1,3,2,1
16,490,490,128,44,84,4,3
23,498,498,27,3,24,4,3
11,500,500,47,20,27,4,3

2,101,101,1,1,0,1,0
17,106,106,12,12,0,1,0
4,114,114,9,9,0,1,0
27,130,130,2,2,0,1,0
7,134,134,26,26,0,1,0
9,152,152,4,1,3,2,1
11,168,168,12,2,10,3,2
20,191,191,9,9,0,1,0
10,191,191,8,5,3,2,1
3,216,216,59,41,18,2,1
14,237,237,3,3,0,1,0
13,260,260,17,5,12,3,2
24,261,261,46,46,0,1,0
28,269,269,6,2,4,2,1
26,298,298,17,17,0,1,0
12,305,305,56,30,26,3,2
1,307,307,50,50,0,1,0
22,358,358,7,1,6,3,2
16,367,367,26,26,0,1,0
5,378,378,29,8,21,4,3
29,392,392,26,26,0,1,0
23,409,409,32,10,22,2,1
6,414,414,70,70,0,1,0
19,417,417,53,53,0,1,0
25,420,420,107,107,0,1,0
21,443,443,55,25,30,3,2
15,467,467,194,156,38,2,1
18,470,470,14,1,13,3,2
8,487,487,73,56,17,2,1
0,487,487,48,17,31,2,1

15,109,109,23,7,16,3,2
24,135,135,9,3,6,3,2
11,143,143,11,11,0,1,0
13,152,152,3,3,0,1,0
17,155,155,10,10,0,1,0
0,156,156,7,7,0,1,0
9,193,193,31,31,0,1,0
14,212,212,7,7,0,1,0
7,220,220,104,104,0,1,0
4,229,229,29,29,0,1,0
19,276,276,14,7,7,2,1
16,309,309,34,24,10,2,1
18,310,310,46,46,0,1,0
23,312,312,1,1,0,1,0
3,317,317,89,89,0,1,0
5,332,332,2,2,0,1,0
8,352,352,17,9,8,2,1
21,360,360,154,89,65,4,3
22,360,360,9,2,7,2,1
10,421,421,23,15,8,2,1
20,446,446,52,4,48,4,3
1,448,448,31,31,0,1,0
2,466,466,213,213,0,1,0
12,474,474,34,34,0,1,0
6,483,483,46,46,0,1,0

18,113,113,46,46,0,1,0
6,133,133,11,11,0,1,0
8,147,147,18,18,0,1,0
29,189,189,1,1,0,1,0
14,197,197,8,8,0,1,0
17,201,201,27,27,0,1,0
4,221,221,5,2,3,2,1
15,225,225,24,24,0,1,0
23,257,257,25,25,0,1,0
3,267,267,1,1,0,1,0
13,285,285,30,12,18,4,3
19,305,305,97,97,0,1,0
27,309,309,52,52,0,1,0
10,316,316,133,117,16,2,1
20,317,317,12,12,0,1,0
30,320,320,59,27,32,3,2
16,349,349,17,17,0,1,0
28,358,358,6,6,0,1,0
11,361,361,44,44,0,1,0
12,369,369,82,13,69,4,3
22,374,374,8,3,5,2,1
21,377,377,10,6,4,2,1
25,383,383,7,7,0,1,0
7,390,390,59,1,58,3,2
1,395,395,4,4,0,1,0
0,401,401,95,68,27,2,1
26,430,430,13,6,7,2,1
24,444,444,5,5,0,1,0
5,457,457,14,14,0,1,0
2,470,470,3,3,0,1,0
9,488,488,11,11,0,1,0

10,104,104,19,19,0,1,0
28,106,106,12,2,10,2,1
29,122,122,16,16,0,1,0
24,123,123,8,8,0,1,0
25,131,131,2,2,0,1,0
1,142,142,18,4,14,2,1
15,176,176,24,24,0,1,0
14,176,176,20,10,10,2,1
8,189,189,16,16,0,1,0
4,192,192,39,9,30,3,2
0,203,203,59,59,0,1,0
20,208,208,37,37,0,1,0
5,222,222,5,1,4,2,1
2,291,291,23,11,12,4,3
12,295,295,24,24,0,1,0
19,302,302,7,7,0,1,0
22,342,342,8,8,0,1,0
13,350,350,32,32,0,1,0
21,373,373,3,3,0,1,0
27,375,375,35,1,34,3,2
17,382,382,129,129,0,1,0
7,398,398,81,40,41,2,1
16,400,400,11,11,0,1,0
26,434,434,10,10,0,1,0
30,435,435,42,12,30,4,3
23,448,448,115,71,44,2,1
9,467,467,27,27,0,1,0
18,468,468,46,21,25,2,1
11,476,476,4,4,0,1,0
6,488,488,23,5,18,4,3
3,492,492,4,4,0,1,0

19,114,114,4,4,0,1,0
34,115,115,14,14,0,1,0
28,129,129,3,3,0,1,0
17,138,138,1,1,0,1,0
24,153,153,1,1,0,1,0
18,161,161,2,2,0,1,0
3,173,173,12,12,0,1,0
13,180,180,8,1,7,2,1
29,183,183,46,46,0,1,0
35,189,189,33,9,24,2,1
0,217,217,1,1,0,1,0
2,244,244,16,16,0,1,0
16,250,250,40,40,0,1,0
32,267,267,89,68,21,4,3
8,275,275,58,58,0,1,0
38,278,278,26,22,4,2,1
7,289,289,24,24,0,1,0
33,292,292,13,13,0,1,0
23,300,300,52,52,0,1,0
14,307,307,67,67,0,1,0
10,312,312,12,12,0,1,0
21,327,327,13,13,0,1,0
12,329,329,12,12,0,1,0
26,334,334,8,3,5,2,1
37,337,337,6,6,0,1,0
30,353,353,1,1,0,1,0
22,371,371,20,6,14,3,2
5,371,371,103,74,29,2,1
15,374,374,23,1,22,2,1
31,376,376,16,16,0,1,0
11,389,389,13,13,0,1,0
25,413,413,26,26,0,1,0
9,420,420,17,17,0,1,0
1,441,441,7,7,0,1,0
4,444,444,3,3,0,1,0
20,450,450,5,2,3,2,1
36,462,462,38,8,30,4,3
6,474,474,35,35,0,1,0
27,497,497,92,38,54,3,2

21,117,117,14,14,0,1,0
19,123,123,3,3,0,1,0
4,127,127,8,8,0,1,0
26,128,128,6,6,0,1,0
1,130,130,8,2,6,3,2
25,130,130,19,9,10,3,2
6,147,147,12,12,0,1,0
31,202,202,25,18,7,2,1
9,221,221,24,24,0,1,0
0,229,229,26,11,15,3,2
32,233,233,13,4,9,3,2
30,235,235,8,8,0,1,0
23,235,235,8,4,4,2,1
27,243,243,44,4,40,3,2
12,260,260,18,4,14,2,1
5,267,267,5,5,0,1,0
16,267,267,19,19,0,1,0
29,288,288,21,6,15,2,1
2,289,289,5,5,0,1,0
15,293,293,7,7,0,1,0
18,311,311,46,46,0,1,0
28,314,314,56,56,0,1,0
13,319,319,11,5,6,2,1
22,355,355,31,4,27,2,1
17,359,359,15,15,0,1,0
7,367,367,15,3,12,4,3
14,374,374,171,171,0,1,0
10,380,380,38,12,26,3,2
3,383,383,2,2,0,1,0
20,447,447,124,117,7,2,1
8,450,450,48,34,14,2,1
24,481,481,35,12,23,2,1
11,493,493,113,113,0,1,0

6,100,100,1,1,0,1,0
0,110,110,32,32,0,1,0
23,138,138,31,17,14,3,2
26,140,140,9,4,5,2,1
31,153,153,4,4,0,1,0
5,185,185,23,7,16,3,2
11,210,210,2,2,0,1,0
3,222,222,21,21,0,1,0
35,224,224,20,20,0,1,0
27,244,244,67,47,20,3,2
29,246,246,3,3,0,1,0
21,248,248,12,12,0,1,0
38,250,250,18,2,16,3,2
1,265,265,16,16,0,1,0
19,272,272,42,21,21,4,3
16,282,282,15,15,0,1,0
22,287,287,5,5,0,1,0
20,289,289,26,26,0,1,0
17,307,307,4,1,3,2,1
40,311,311,14,14,0,1,0
33,312,312,69,69,0,1,0
9,316,316,1,1,0,1,0
15,317,317,14,14,0,1,0
8,334,334,6,3,3,2,1
4,338,338,8,3,5,2,1
7,339,339,15,15,0,1,0
14,341,341,15,15,0,1,0
39,351,351,67,67,0,1,0
25,379,379,1,1,0,1,0
18,379,379,21,21,0,1,0
37,409,409,1,1,0,1,0
34,410,410,11,2,9,4,3
30,429,429,43,25,18,2,1
2,430,430,4,4,0,1,0
13,432,432,42,33,9,4,3
10,441,441,4,4,0,1,0
28,447,447,39,39,0,1,0
24,452,452,10,10,0,1,0
36,456,456,7,7,0,1,0
12,495,495,20,5,15,4,3
32,499,499,196,52,144,4,3

11,104,104,1,1,0,1,0
12,107,107,52,38,14,2,1
15,109,109,4,1,3,2,1
7,113,113,28,2,26,3,2
30,148,148,17,4,13,2,1
23,161,161,15,15,0,1,0
17,166,166,5,5,0,1,0
31,174,174,6,6,0,1,0
26,187,187,11,11,0,1,0
9,194,194,11,11,0,1,0
20,198,198,5,5,0,1,0
22,202,202,9,6,3,2,1
0,225,225,2,2,0,1,0
6,242,242,1,1,0,1,0
28,245,245,62,5,57,4,3
10,248,248,12,2,10,3,2
18,269,269,21,21,0,1,0
8,281,281,64,64,0,1,0
4,333,333,17,6,11,2,1
27,346,346,12,12,0,1,0
14,346,346,61,61,0,1,0
16,353,353,41,1,40,3,2
5,386,386,34,31,3,2,1
19,386,386,23,11,12,3,2
3,387,387,5,5,0,1,0
29,391,391,93,45,48,4,3
1,422,422,18,18,0,1,0
24,454,454,23,23,0,1,0
2,470,470,7,7,0,1,0
13,495,495,45,3,42,4,3
25,497,497,110,110,0,1,0
21,500,500,87,87,0,1,0

22,121,121,6,6,0,1,0
23,125,125,2,2,0,1,0
19,137,137,32,32,0,1,0
6,143,143,34,22,12,4,3
4,167,167,1,1,0,1,0
11,203,203,9,1,8,2,1
17,218,218,22,1,21,4,3
13,226,226,63,63,0,1,0
5,233,233,29,29,0,1,0
12,251,251,76,54,22,3,2
0,254,254,11,8,3,2,1
26,270,270,29,19,10,3,2
7,286,286,1,1,0,1,0
10,286,286,23,5,18,3,2
3,287,287,63,21,42,2,1
25,290,290,8,8,0,1,0
21,314,314,22,22,0,1,0
15,335,335,42,21,21,4,3
8,338,338,30,1,29,2,1
28,348,348,30,30,0,1,0
18,363,363,53,53,0,1,0
9,437,437,11,11,0,1,0
20,440,440,20,20,0,1,0
2,441,441,28,7,21,4,3
1,446,446,162,143,19,2,1
27,454,454,3,3,0,1,0
16,470,470,72,72,0,1,0
24,476,476,31,8,23,2,1
14,482,482,54,9,45,3,2

3,100,100,5,2,3,2,1
12,102,102,13,3,10,2,1
9,103,103,2,2,0,1,0
8,124,124,1,1,0,1,0
17,129,129,15,15,0,1,0
5,147,147,16,16,0,1,0
22,147,147,54,54,0,1,0
28,168,168,68,53,15,2,1
30,170,170,18,18,0,1,0
27,171,171,6,2,4,2,1
31,200,200,9,9,0,1,0
29,202,202,13,13,0,1,0
26,204,204,5,2,3,2,1
19,213,213,1,1,0,1,0
18,217,217,9,5,4,2,1
21,243,243,6,6,0,1,0
24,254,254,56,20,36,2,1
2,280,280,5,1,4,2,1
4,281,281,30,8,22,3,2
1,283,283,81,81,0,1,0
16,285,285,15,6,9,4,3
32,287,287,12,12,0,1,0
25,295,295,3,3,0,1,0
10,323,323,33,24,9,2,1
14,327,327,9,9,0,1,0
11,351,351,6,6,0,1,0
13,353,353,42,3,39,4,3
7,362,362,1,1,0,1,0
23,398,398,28,28,0,1,0
20,412,412,56,56,0,1,0
33,451,451,19,19,0,1,0
6,483,483,54,54,0,1,0
0,485,485,7,7,0,1,0
15,488,488,155,151,4,2,1

7,100,100,1,1,0,1,0
4,102,102,16,4,12,2,1
20,110,110,7,7,0,1,0
32,126,126,9,2,7,2,1
34,130,130,5,5,0,1,0
30,135,135,11,11,0,1,0
36,154,154,45,16,29,2,1
21,165,165,3,3,0,1,0
22,179,179,7,2,5,2,1
14,181,181,12,12,0,1,0
33,218,218,23,23,0,1,0
16,224,224,28,9,19,2,1
5,224,224,18,18,0,1,0
24,233,233,3,3,0,1,0
28,234,234,72,72,0,1,0
6,253,253,10,10,0,1,0
18,301,301,14,14,0,1,0
26,302,302,7,7,0,1,0
25,324,324,8,8,0,1,0
31,326,326,96,96,0,1,0
11,335,335,20,20,0,1,0
23,347,347,3,3,0,1,0
2,355,355,12,3,9,2,1
15,355,355,47,47,0,1,0
3,374,374,87,87,0,1,0
8,378,378,6,6,0,1,0
17,379,379,3,3,0,1,0
12,385,385,1,1,0,1,0
19,398,398,45,7,38,3,2
10,404,404,119,32,87,4,3
35,410,410,88,88,0,1,0
9,414,414,8,8,0,1,0
29,442,442,27,15,12,2,1
27,454,454,25,25,0,1,0
1,462,462,11,11,0,1,0
0,470,470,24,8,16,2,1
37,480,480,4,1,3,2,1
13,498,498,6,6,0,1,0

2,105,105,13,4,9,2,1
36,107,107,2,2,0,1,0
14,145,145,14,4,10,2,1
8,146,146,7,1,6,2,1
34,151,151,13,13,0,1,0
12,168,168,10,10,0,1,0
23,169,169,14,2,12,3,2
26,172,172,7,7,0,1,0
35,181,181,10,6,4,2,1
21,196,196,8,8,0,1,0
29,202,202,47,47,0,1,0
20,210,210,8,2,6,2,1
16,215,215,2,2,0,1,0
27,233,233,5,5,0,1,0
22,247,247,13,13,0,1,0
24,249,249,3,3,0,1,0
3,260,260,8,8,0,1,0
11,268,268,22,22,0,1,0
13,276,276,8,8,0,1,0
0,280,280,40,16,24,3,2
17,344,344,6,6,0,1,0
37,354,354,20,8,12,4,3
1,367,367,46,3,43,2,1
7,370,370,27,27,0,1,0
10,383,383,1,1,0,1,0
9,384,384,56,56,0,1,0
30,388,388,132,132,0,1,0
33,393,393,27,4,23,2,1
5,394,394,52,52,0,1,0
18,399,399,13,13,0,1,0
28,411,411,72,47,25,2,1
25,432,432,44,5,39,2,1
4,450,450,37,37,0,1,0
32,469,469,100,100,0,1,0
15,475,475,8,8,0,1,0
38,481,481,14,3,11,2,1
31,482,482,49,10,39,4,3
19,491,491,18,18,0,1,0
6,499,499,92,59,33,4,3

4,106,106,34,6,28,2,1
13,107,107,10,10,0,1,0
6,114,114,12,8,4,2,1
2,146,146,32,24,8,3,2
17,159,159,7,7,0,1,0
18,175,175,17,5,12,2,1
21,176,176,2,2,0,1,0
3,179,179,9,9,0,1,0
8,186,186,37,37,0,1,0
11,189,189,14,14,0,1,0
23,198,198,18,18,0,1,0
19,200,200,14,14,0,1,0
14,203,203,5,5,0,1,0
10,262,262,2,2,0,1,0
5,284,284,52,19,33,4,3
1,293,293,92,68,24,3,2
16,333,333,17,17,0,1,0
24,348,348,42,35,7,2,1
0,380,380,35,5,30,3,2
9,399,399,76,34,42,4,3
20,407,407,58,43,15,4,3
15,436,436,63,21,42,3,2
7,461,461,56,56,0,1,0
22,489,489,157,120,37,4,3
12,495,495,75,75,0,1,0

16,114,114,23,23,0,1,0
15,115,115,3,3,0,1,0
23,142,142,5,5,0,1,0
9,149,149,7,7,0,1,0
19,171,171,17,12,5,2,1
0,194,194,70,70,0,1,0
26,197,197,41,17,24,4,3
22,206,206,19,19,0,1,0
4,214,214,3,3,0,1,0
7,293,293,2,2,0,1,0
5,301,301,16,16,0,1,0
12,318,318,126,126,0,1,0
25,329,329,12,12,0,1,0
10,346,346,16,16,0,1,0
28,346,346,13,13,0,1,0
18,349,349,47,47,0,1,0
11,350,350,30,3,27,4,3
2,352,352,109,81,28,3,2
3,363,363,7,7,0,1,0
1,381,381,90,90,0,1,0
21,385,385,62,62,0,1,0
20,388,388,8,8,0,1,0
6,389,389,6,6,0,1,0
24,401,401,95,18,77,4,3
13,402,402,2,2,0,1,0
17,413,413,112,104,8,3,2
27,437,437,5,1,4,2,1
8,464,464,5,5,0,1,0
14,468,468,27,27,0,1,0

23,105,105,7,1,6,3,2
0,111,111,13,13,0,1,0
21,121,121,1,1,0,1,0
11,142,142,7,7,0,1,0
12,156,156,31,31,0,1,0
1,198,198,13,13,0,1,0
2,233,233,6,6,0,1,0
15,239,239,24,24,0,1,0
3,256,256,118,95,23,2,1
18,273,273,3,3,0,1,0
19,286,286,49,49,0,1,0
13,293,293,54,54,0,1,0
9,309,309,38,35,3,2,1
6,321,321,102,76,26,4,3
25,330,330,41,41,0,1,0
22,350,350,8,8,0,1,0
10,364,364,54,21,33,4,3
24,365,365,4,4,0,1,0
14,370,370,88,4,84,3,2
16,370,370,48,21,27,2,1
26,393,393,15,15,0,1,0
8,431,431,4,1,3,2,1
20,436,436,25,17,8,2,1
7,450,450,91,37,54,4,3
4,484,484,25,21,4,2,1
17,489,489,106,28,78,3,2
5,496,496,40,40,0,1,0

22,108,108,11,4,7,2,1
20,118,118,8,8,0,1,0
0,119,119,4,4,0,1,0
32,124,124,2,2,0,1,0
8,137,137,39,39,0,1,0
27,140,140,8,8,0,1,0
4,143,143,35,11,24,4,3
1,145,145,16,16,0,1,0
15,182,182,6,3,3,2,1
26,193,193,30,12,18,4,3
21,196,196,66,63,3,2,1
30,200,200,35,23,12,3,2
14,207,207,6,6,0,1,0
18,208,208,7,1,6,3,2
11,220,220,4,4,0,1,0
23,220,220,79,17,62,4,3
10,236,236,26,26,0,1,0
19,254,254,11,8,3,2,1
28,266,266,3,3,0,1,0
25,284,284,7,7,0,1,0
7,289,289,10,10,0,1,0
3,294,294,1,1,0,1,0
13,315,315,28,28,0,1,0
6,318,318,19,19,0,1,0
31,344,344,7,7,0,1,0
12,344,344,65,32,33,3,2
5,377,377,4,4,0,1,0
9,389,389,15,3,12,2,1
24,403,403,68,28,40,3,2
16,417,417,79,17,62,3,2
17,440,440,16,2,14,2,1
29,478,478,16,7,9,4,3
2,483,483,59,12,47,3,2

0,109,109,17,1,16,3,2
27,111,111,3,3,0,1,0
14,118,118,10,10,0,1,0
10,146,146,53,53,0,1,0
24,169,169,83,53,30,2,1
21,204,204,18,18,0,1,0
12,204,204,2,2,0,1,0
25,225,225,9,1,8,3,2
16,234,234,32,32,0,1,0
26,242,242,9,9,0,1,0
8,276,276,32,32,0,1,0
15,296,296,61,61,0,1,0
18,329,329,1,1,0,1,0
22,332,332,15,15,0,1,0
9,337,337,45,45,0,1,0
13,340,340,38,23,15,4,3
11,351,351,22,4,18,4,3
7,354,354,39,39,0,1,0
4,368,368,24,24,0,1,0
20,375,375,6,6,0,1,0
3,381,381,134,118,16,3,2
19,447,447,52,36,16,3,2
6,451,451,4,4,0,1,0
1,451,451,13,13,0,1,0
5,465,465,82,82,0,1,0
23,480,480,12,7,5,2,1
17,494,494,94,94,0,1,0
2,497,497,15,15,0,1,0

10,106,106,18,1,17,2,1
22,107,107,5,5,0,1,0
16,168,168,57,53,4,2,1
13,191,191,13,13,0,1,0
0,208,208,88,88,0,1,0
9,210,210,2,2,0,1,0
14,236,236,10,10,0,1,0
17,262,262,36,6,30,4,3
11,288,288,7,7,0,1,0
6,293,293,102,102,0,1,0
2,304,304,27,3,24,3,2
12,324,324,4,4,0,1,0
19,338,338,46,1,45,2,1
20,339,339,2,2,0,1,0
21,341,341,49,49,0,1,0
18,361,361,3,3,0,1,0
4,364,364,109,71,38,3,2
15,393,393,21,21,0,1,0
3,417,417,67,17,50,3,2
5,464,464,121,56,65,4,3
1,481,481,10,5,5,2,1
8,487,487,28,28,0,1,0
7,497,497,188,188,0,1,0

2,113,113,3,3,0,1,0
0,125,125,21,3,18,2,1
14,126,126,10,10,0,1,0
26,133,133,9,9,0,1,0
18,133,133,1,1,0,1,0
25,162,162,11,11,0,1,0
4,171,171,48,20,28,3,2
3,173,173,1,1,0,1,0
5,175,175,18,18,0,1,0
11,205,205,12,12,0,1,0
16,216,216,20,8,12,4,3
19,238,238,13,6,7,3,2
27,240,240,89,41,48,2,1
1,247,247,13,13,0,1,0
9,252,252,94,28,66,4,3
21,271,271,16,16,0,1,0
22,280,280,21,9,12,3,2
6,286,286,3,3,0,1,0
8,323,323,1,1,0,1,0
17,339,339,16,1,15,2,1
30,383,383,65,65,0,1,0
15,409,409,9,9,0,1,0
33,410,410,6,6,0,1,0
23,410,410,37,37,0,1,0
7,413,413,41,9,32,3,2
31,434,434,124,106,18,4,3
13,435,435,3,3,0,1,0
24,437,437,18,1,17,2,1
29,441,441,12,6,6,3,2
20,443,443,12,8,4,2,1
28,448,448,10,6,4,2,1
32,449,449,7,2,5,2,1
34,463,463,108,45,63,4,3
10,467,467,67,57,10,3,2
12,483,483,10,10,0,1,0

6,104,104,2,2,0,1,0
4,106,106,4,4,0,1,0
19,131,131,20,20,0,1,0
39,133,133,5,5,0,1,0
25,135,135,1,1,0,1,0
16,177,177,16,16,0,1,0
28,184,184,8,1,7,2,1
14,190,190,1,1,0,1,0
17,209,209,5,5,0,1,0
12,230,230,36,6,30,4,3
31,235,235,33,20,13,2,1
34,239,239,9,9,0,1,0
36,265,265,20,2,18,2,1
0,266,266,14,14,0,1,0
7,268,268,47,27,20,3,2
33,277,277,13,13,0,1,0
2,278,278,1,1,0,1,0
24,280,280,23,23,0,1,0
40,306,306,48,31,17,4,3
3,310,310,20,12,8,2,1
30,329,329,131,35,96,3,2
10,351,351,69,69,0,1,0
29,355,355,29,14,15,4,3
37,365,365,1,1,0,1,0
15,368,368,10,1,9,4,3
27,379,379,24,18,6,3,2
32,392,392,13,13,0,1,0
8,395,395,18,18,0,1,0
23,423,423,1,1,0,1,0
11,431,431,42,42,0,1,0
5,435,435,4,4,0,1,0
21,451,451,21,2,19,3,2
35,452,452,34,34,0,1,0
1,452,452,1,1,0,1,0
13,459,459,14,5,9,4,3
20,461,461,26,3,23,2,1
18,463,463,2,2,0,1,0
9,463,463,100,93,7,2,1
26,484,484,25,25,0,1,0
38,494,494,186,151,35,3,2
22,498,498,1,1,0,1,0

6,111,111,7,7,0,1,0
10,111,111,3,3,0,1,0
17,122,122,1,1,0,1,0
36,131,131,29,17,12,3,2
1,143,143,5,1,4,2,1
27,143,143,29,29,0,1,0
21,144,144,10,7,3,2,1
22,146,146,3,3,0,1,0
38,170,170,15,15,0,1,0
8,171,171,1,1,0,1,0
7,174,174,6,2,4,2,1
4,174,174,47,16,31,2,1
40,196,196,49,49,0,1,0
39,211,211,19,19,0,1,0
32,221,221,24,24,0,1,0
30,232,232,3,3,0,1,0
12,271,271,27,27,0,1,0
26,276,276,13,13,0,1,0
15,287,287,23,23,0,1,0
16,295,295,21,21,0,1,0
3,308,308,4,4,0,1,0
2,314,314,58,58,0,1,0
34,317,317,53,53,0,1,0
13,327,327,29,17,12,3,2
23,333,333,26,23,3,2,1
5,335,335,8,8,0,1,0
0,340,340,35,35,0,1,0
33,341,341,2,2,0,1,0
37,344,344,14,14,0,1,0
35,354,354,19,19,0,1,0
19,366,366,4,4,0,1,0
14,372,372,25,25,0,1,0
31,380,380,46,46,0,1,0
18,407,407,43,43,0,1,0
29,410,410,54,54,0,1,0
9,416,416,11,6,5,2,1
11,418,418,3,3,0,1,0
24,428,428,33,33,0,1,0
20,456,456,14,14,0,1,0
25,464,464,11,11,0,1,0
28,468,468,31,31,0,1,0

14,122,122,2,2,0,1,0
37,130,130,1,1,0,1,0
22,132,132,1,1,0,1,0
28,132,132,6,6,0,1,0
7,133,133,5,5,0,1,0
43,139,139,6,6,0,1,0
23,150,150,3,3,0,1,0
8,152,152,3,3,0,1,0
0,190,190,15,7,8,2,1
4,201,201,3,3,0,1,0
5,202,202,3,3,0,1,0
17,223,223,27,27,0,1,0
21,231,231,46,3,43,3,2
20,233,233,11,11,0,1,0
41,240,240,41,32,9,2,1
30,244,244,2,2,0,1,0
10,246,246,51,18,33,4,3
3,249,249,26,26,0,1,0
1,257,257,16,7,9,2,1
38,265,265,31,31,0,1,0
33,282,282,13,4,9,2,1
25,287,287,10,10,0,1,0
11,301,301,19,19,0,1,0
42,301,301,33,33,0,1,0
12,331,331,35,8,27,4,3
31,334,334,52,52,0,1,0
35,363,363,73,10,63,4,3
19,364,364,5,5,0,1,0
44,365,365,1,1,0,1,0
26,375,375,9,9,0,1,0
13,384,384,18,4,14,3,2
2,396,396,30,4,26,3,2
9,399,399,6,6,0,1,0
6,402,402,21,21,0,1,0
16,411,411,12,7,5,2,1
27,412,412,1,1,0,1,0
34,418,418,31,31,0,1,0
40,420,420,40,40,0,1,0
46,422,422,6,6,0,1,0
45,428,428,67,46,21,2,1
29,429,429,3,3,0,1,0
24,444,444,1,1,0,1,0
32,450,450,89,89,0,1,0
18,459,459,26,26,0,1,0
36,471,471,3,3,0,1,0
39,496,496,113,113,0,1,0
15,497,497,34,34,0,1,0

35,106,106,11,6,5,2,1
8,107,107,1,1,0,1,0
30,128,128,1,1,0,1,0
23,133,133,2,2,0,1,0
14,179,179,6,1,5,2,1
40,180,180,30,18,12,4,3
27,185,185,23,23,0,1,0
1,186,186,7,7,0,1,0
0,196,196,36,21,15,2,1
13,199,199,14,1,13,2,1
15,204,204,20,13,7,2,1
34,205,205,5,2,3,2,1
6,228,228,4,1,3,2,1
39,244,244,22,22,0,1,0
41,244,244,14,14,0,1,0
11,246,246,30,7,23,3,2
43,251,251,5,2,3,2,1
12,252,252,24,24,0,1,0
4,256,256,17,17,0,1,0
33,270,270,36,36,0,1,0
2,278,278,5,5,0,1,0
25,286,286,31,21,10,2,1
3,293,293,7,7,0,1,0
26,297,297,13,13,0,1,0
20,306,306,10,6,4,2,1
21,309,309,6,3,3,2,1
37,309,309,47,6,41,2,1
17,310,310,3,3,0,1,0
32,333,333,55,55,0,1,0
36,339,339,3,3,0,1,0
38,343,343,66,50,16,3,2
9,350,350,20,20,0,1,0
42,350,350,10,10,0,1,0
10,355,355,33,14,19,2,1
19,396,396,18,2,16,3,2
5,398,398,3,3,0,1,0
24,399,399,5,5,0,1,0
31,414,414,122,74,48,4,3
18,416,416,38,38,0,1,0
7,420,420,21,5,16,4,3
44,426,426,75,69,6,2,1
22,432,432,25,17,8,2,1
28,440,440,19,3,16,2,1
16,456,456,6,3,3,2,1
29,475,475,4,4,0,1,0

38,102,102,9,3,6,2,1
3,107,107,12,12,0,1,0
24,112,112,15,15,0,1,0
8,122,122,11,5,6,2,1
10,124,124,12,2,10,3,2
31,155,155,12,12,0,1,0
5,158,158,29,29,0,1,0
35,165,165,15,12,3,2,1
22,190,190,2,2,0,1,0
23,191,191,11,11,0,1,0
34,198,198,14,8,6,2,1
7,199,199,5,5,0,1,0
30,207,207,83,74,9,4,3
28,211,211,9,9,0,1,0
6,227,227,27,27,0,1,0
4,229,229,30,30,0,1,0
20,231,231,20,20,0,1,0
11,233,233,4,1,3,2,1
1,234,234,2,2,0,1,0
14,251,251,7,7,0,1,0
26,260,260,80,30,50,3,2
36,287,287,11,11,0,1,0
9,289,289,59,19,40,4,3
0,301,301,27,27,0,1,0
37,327,327,2,2,0,1,0
27,332,332,36,5,31,4,3
25,338,338,3,3,0,1,0
29,348,348,39,21,18,2,1
18,360,360,41,41,0,1,0
21,369,369,4,4,0,1,0
15,369,369,44,16,28,3,2
16,387,387,27,27,0,1,0
13,390,390,12,6,6,3,2
33,406,406,12,12,0,1,0
32,435,435,28,1,27,4,3
12,445,445,20,5,15,2,1
17,457,457,2,2,0,1,0
2,463,463,1,1,0,1,0
19,489,489,1,1,0,1,0

0,105,105,11,11,0,1,0
24,125,125,30,8,22,2,1
27,143,143,7,4,3,2,1
22,165,165,14,14,0,1,0
20,180,180,24,24,0,1,0
10,190,190,20,16,4,2,1
26,203,203,11,1,10,3,2
15,204,204,18,18,0,1,0
8,212,212,34,10,24,3,2
1,252,252,16,7,9,2,1
7,252,252,17,2,15,2,1
16,254,254,37,31,6,2,1
11,262,262,12,12,0,1,0
4,275,275,20,6,14,2,1
13,280,280,2,2,0,1,0
3,283,283,9,9,0,1,0
19,284,284,38,38,0,1,0
2,286,286,133,112,21,4,3
5,291,291,1,1,0,1,0
21,313,313,20,3,17,2,1
18,335,335,32,21,11,2,1
9,343,343,86,86,0,1,0
25,365,365,17,7,10,3,2
23,367,367,97,35,62,3,2
6,388,388,90,74,16,2,1
14,440,440,65,19,46,3,2
17,473,473,27,27,0,1,0
12,495,495,8,3,5,2,1

6,124,124,5,1,4,2,1
28,136,136,8,4,4,2,1
3,151,151,19,19,0,1,0
23,155,155,6,1,5,2,1
10,158,158,42,42,0,1,0
7,176,176,15,9,6,2,1
22,189,189,22,22,0,1,0
26,215,215,52,7,45,4,3
21,273,273,1,1,0,1,0
11,279,279,74,54,20,2,1
1,299,299,8,8,0,1,0
17,299,299,30,30,0,1,0
19,305,305,8,8,0,1,0
14,312,312,1,1,0,1,0
5,317,317,19,19,0,1,0
4,323,323,3,3,0,1,0
0,331,331,88,44,44,2,1
27,344,344,14,14,0,1,0
12,362,362,24,24,0,1,0
15,382,382,102,70,32,2,1
24,401,401,12,12,0,1,0
25,411,411,75,26,49,2,1
13,432,432,47,47,0,1,0
18,443,443,8,2,6,2,1
20,447,447,110,50,60,4,3
8,454,454,11,11,0,1,0
2,457,457,98,98,0,1,0
16,460,460,65,23,42,3,2
9,497,497,76,76,0,1,0

0,126,126,11,2,9,2,1
10,139,139,4,4,0,1,0
27,157,157,64,2,62,4,3
1,162,162,43,13,30,3,2
4,174,174,1,1,0,1,0
30,194,194,14,11,3,2,1
28,215,215,11,11,0,1,0
6,227,227,10,10,0,1,0
11,230,230,38,38,0,1,0
26,232,232,1,1,0,1,0
20,255,255,68,34,34,3,2
12,259,259,24,1,23,4,3
18,328,328,3,3,0,1,0
3,332,332,15,3,12,4,3
31,336,336,2,2,0,1,0
24,347,347,52,5,47,3,2
21,362,362,86,45,41,2,1
22,363,363,86,86,0,1,0
7,374,374,3,3,0,1,0
8,380,380,6,3,3,2,1
13,387,387,10,10,0,1,0
2,387,387,20,11,9,2,1
14,407,407,66,66,0,1,0
19,408,408,1,1,0,1,0
17,409,409,5,5,0,1,0
15,414,414,14,1,13,2,1
16,423,423,15,2,13,2,1
25,426,426,65,15,50,4,3
29,433,433,5,5,0,1,0
9,453,453,30,21,9,4,3
23,456,456,2,2,0,1,0
32,479,479,4,1,3,2,1
5,497,497,233,233,0,1,0

8,116,116,21,4,17,2,1
11,126,126,6,6,0,1,0
23,126,126,11,7,4,2,1
1,135,135,13,13,0,1,0
28,138,138,21,7,14,3,2
17,161,161,2,2,0,1,0
6,167,167,23,23,0,1,0
21,174,174,4,4,0,1,0
20,174,174,3,3,0,1,0
18,174,174,5,5,0,1,0
10,200,200,34,34,0,1,0
24,218,218,39,4,35,2,1
19,243,243,13,3,10,3,2
15,251,251,25,15,10,3,2
22,252,252,54,37,17,2,1
30,254,254,26,26,0,1,0
9,267,267,14,14,0,1,0
3,283,283,5,5,0,1,0
26,303,303,1,1,0,1,0
2,305,305,25,7,18,2,1
27,330,330,41,41,0,1,0
7,341,341,109,109,0,1,0
16,343,343,16,16,0,1,0
29,362,362,61,61,0,1,0
0,363,363,18,18,0,1,0
31,388,388,7,7,0,1,0
12,398,398,17,5,12,3,2
5,403,403,44,9,35,2,1
25,424,424,173,112,61,4,3
4,442,442,44,31,13,2,1
14,451,451,10,10,0,1,0
13,451,451,34,34,0,1,0

25,134,134,12,7,5,2,1
4,149,149,33,19,14,2,1
2,160,160,24,24,0,1,0
24,167,167,17,17,0,1,0
18,174,174,18,11,7,2,1
6,190,190,1,1,0,1,0
19,191,191,1,1,0,1,0
11,198,198,19,19,0,1,0
16,206,206,40,40,0,1,0
30,245,245,1,1,0,1,0
10,250,250,107,1,106,4,3
20,259,259,2,2,0,1,0
0,263,263,10,1,9,4,3
9,268,268,5,5,0,1,0
27,278,278,1,1,0,1,0
15,287,287,34,22,12,4,3
26,298,298,43,43,0,1,0
21,306,306,51,43,8,3,2
23,313,313,60,30,30,2,1
1,340,340,1,1,0,1,0
14,364,364,8,4,4,2,1
22,366,366,39,39,0,1,0
28,380,380,38,26,12,2,1
17,395,395,83,83,0,1,0
29,399,399,33,33,0,1,0
7,421,421,40,26,14,2,1
8,440,440,56,56,0,1,0
12,442,442,129,81,48,4,3
5,449,449,12,3,9,4,3
3,457,457,8,8,0,1,0
13,465,465,28,28,0,1,0

6,140,140,7,7,0,1,0
22,146,146,18,3,15,4,3
13,161,161,8,3,5,2,1
11,166,166,14,3,11,2,1
23,169,169,35,7,28,3,2
16,200,200,2,2,0,1,0
18,238,238,22,4,18,3,2
10,244,244,85,63,22,2,1
20,272,272,36,21,15,4,3
14,311,311,28,28,0,1,0
17,311,311,1,1,0,1,0
21,326,326,14,2,12,3,2
27,327,327,47,47,0,1,0
2,328,328,35,23,12,2,1
12,331,331,2,2,0,1,0
24,356,356,56,17,39,4,3
7,378,378,61,61,0,1,0
4,378,378,30,30,0,1,0
26,380,380,41,41,0,1,0
3,381,381,26,26,0,1,0
9,408,408,99,3,96,4,3
0,418,418,1,1,0,1,0
19,430,430,83,78,5,2,1
25,440,440,81,81,0,1,0
1,441,441,165,66,99,4,3
5,456,456,20,3,17,2,1
8,469,469,16,6,10,2,1
28,473,473,15,1,14,3,2
15,497,497,32,32,0,1,0

7,137,137,12,12,0,1,0
35,138,138,41,41,0,1,0
0,150,150,2,2,0,1,0
1,162,162,12,12,0,1,0
24,178,178,1,1,0,1,0
19,182,182,8,2,6,2,1
28,184,184,20,20,0,1,0
15,185,185,1,1,0,1,0
14,223,223,4,4,0,1,0
13,223,223,14,14,0,1,0
2,226,226,11,3,8,2,1
17,229,229,26,26,0,1,0
29,251,251,5,5,0,1,0
4,259,259,46,25,21,4,3
27,261,261,10,10,0,1,0
11,273,273,3,3,0,1,0
22,276,276,38,38,0,1,0
23,308,308,52,52,0,1,0
30,310,310,2,2,0,1,0
26,313,313,12,5,7,2,1
33,342,342,10,3,7,2,1
12,351,351,12,2,10,2,1
6,354,354,12,7,5,2,1
36,364,364,13,13,0,1,0
10,369,369,25,19,6,2,1
37,380,380,7,7,0,1,0
25,396,396,90,57,33,2,1
5,424,424,28,14,14,3,2
8,425,425,1,1,0,1,0
3,425,425,157,157,0,1,0
20,429,429,49,34,15,2,1
32,440,440,43,43,0,1,0
18,442,442,42,42,0,1,0
9,450,450,1,1,0,1,0
16,463,463,10,10,0,1,0
31,488,488,27,15,12,4,3
34,490,490,166,104,62,3,2
21,494,494,68,68,0,1,0

2,103,103,3,3,0,1,0
11,115,115,10,1,9,4,3
15,116,116,2,2,0,1,0
20,121,121,5,5,0,1,0
26,128,128,8,8,0,1,0
34,142,142,14,2,12,3,2
12,171,171,37,37,0,1,0
23,199,199,1,1,0,1,0
5,221,221,25,22,3,2,1
8,227,227,2,2,0,1,0
3,243,243,12,12,0,1,0
35,255,255,6,6,0,1,0
4,262,262,43,12,31,2,1
7,263,263,4,4,0,1,0
30,270,270,2,2,0,1,0
10,276,276,11,11,0,1,0
33,288,288,11,11,0,1,0
21,294,294,18,18,0,1,0
16,296,296,17,14,3,2,1
29,298,298,64,35,29,4,3
18,301,301,31,18,13,2,1
31,307,307,12,7,5,2,1
25,309,309,101,88,13,4,3
27,312,312,23,5,18,4,3
17,318,318,71,20,51,4,3
22,319,319,98,52,46,3,2
0,372,372,3,3,0,1,0
9,378,378,7,7,0,1,0
19,383,383,37,25,12,3,2
6,388,388,29,5,24,3,2
13,409,409,4,4,0,1,0
14,452,452,86,86,0,1,0
1,459,459,19,10,9,2,1
24,461,461,15,2,13,2,1
28,471,471,13,2,11,2,1
36,481,481,99,42,57,4,3
32,499,499,52,5,47,3,2

20,124,124,21,21,0,1,0
33,134,134,5,1,4,2,1
29,143,143,6,6,0,1,0
31,146,146,13,13,0,1,0
7,166,166,17,5,12,4,3
18,170,170,41,41,0,1,0
27,185,185,1,1,0,1,0
3,195,195,34,34,0,1,0
15,202,202,62,62,0,1,0
10,218,218,15,2,13,2,1
1,224,224,3,3,0,1,0
9,231,231,11,1,10,2,1
4,243,243,34,25,9,4,3
30,247,247,23,11,12,4,3
13,258,258,4,4,0,1,0
24,261,261,7,7,0,1,0
21,262,262,62,36,26,3,2
28,273,273,31,16,15,2,1
32,286,286,23,23,0,1,0
14,292,292,15,15,0,1,0
11,320,320,16,16,0,1,0
8,332,332,13,3,10,2,1
6,334,334,6,6,0,1,0
12,335,335,30,15,15,2,1
19,357,357,32,32,0,1,0
22,377,377,73,1,72,4,3
0,415,415,33,33,0,1,0
5,434,434,18,18,0,1,0
16,439,439,30,3,27,4,3
17,455,455,10,3,7,2,1
34,463,463,97,75,22,2,1
25,465,465,40,40,0,1,0
26,467,467,11,11,0,1,0
23,493,493,64,64,0,1,0
2,498,498,17,8,9,2,1

2,102,102,5,5,0,1,0
31,104,104,14,5,9,2,1
32,105,105,1,1,0,1,0
21,108,108,1,1,0,1,0
7,128,128,2,2,0,1,0
6,132,132,3,3,0,1,0
33,134,134,3,3,0,1,0
17,151,151,8,8,0,1,0
12,152,152,1,1,0,1,0
16,157,157,1,1,0,1,0
25,166,166,32,32,0,1,0
20,191,191,8,8,0,1,0
28,204,204,14,6,8,3,2
1,216,216,12,12,0,1,0
22,221,221,31,1,30,3,2
3,251,251,43,43,0,1,0
27,285,285,26,17,9,2,1
9,294,294,43,43,0,1,0
36,309,309,16,3,13,2,1
24,320,320,12,12,0,1,0
26,330,330,81,81,0,1,0
5,335,335,5,5,0,1,0
35,345,345,34,2,32,3,2
13,364,364,11,11,0,1,0
18,373,373,45,45,0,1,0
0,376,376,123,77,46,3,2
8,386,386,12,8,4,2,1
30,387,387,28,16,12,4,3
11,390,390,35,3,32,3,2
29,417,417,15,5,10,3,2
15,440,440,72,72,0,1,0
10,442,442,38,38,0,1,0
4,458,458,23,5,18,2,1
23,466,466,27,16,11,2,1
19,474,474,23,23,0,1,0
14,492,492,35,35,0,1,0
34,495,495,180,138,42,3,2

16,102,102,1,1,0,1,0
19,136,136,3,3,0,1,0
10,137,137,14,11,3,2,1
22,137,137,30,30,0,1,0
25,170,170,4,4,0,1,0
4,190,190,18,18,0,1,0
1,204,204,2,2,0,1,0
32,243,243,17,17,0,1,0
27,247,247,16,16,0,1,0
15,249,249,10,10,0,1,0
28,276,276,21,14,7,2,1
2,277,277,11,11,0,1,0
11,296,296,21,21,0,1,0
12,298,298,61,61,0,1,0
17,298,298,42,12,30,2,1
18,313,313,100,83,17,3,2
0,325,325,47,17,30,2,1
9,340,340,29,29,0,1,0
24,359,359,3,3,0,1,0
7,359,359,2,2,0,1,0
23,361,361,23,8,15,4,3
3,368,368,12,8,4,2,1
21,371,371,95,32,63,4,3
6,393,393,69,15,54,3,2
20,394,394,23,23,0,1,0
31,399,399,3,3,0,1,0
26,419,419,31,8,23,2,1
29,423,423,53,53,0,1,0
14,436,436,1,1,0,1,0
30,454,454,46,19,27,3,2
5,467,467,9,2,7,2,1
13,480,480,207,207,0,1,0
8,491,491,67,37,30,2,1

14,110,110,13,13,0,1,0
12,133,133,8,8,0,1,0
9,137,137,5,5,0,1,0
31,156,156,18,18,0,1,0
0,173,173,71,57,14,3,2
24,179,179,4,1,3,2,1
3,182,182,1,1,0,1,0
30,185,185,24,24,0,1,0
19,193,193,3,3,0,1,0
16,206,206,5,5,0,1,0
28,237,237,77,77,0,1,0
20,260,260,21,2,19,4,3
23,294,294,1,1,0,1,0
17,309,309,24,24,0,1,0
1,315,315,27,27,0,1,0
26,323,323,24,5,19,2,1
18,325,325,25,25,0,1,0
10,349,349,2,2,0,1,0
21,357,357,81,46,35,4,3
5,362,362,15,15,0,1,0
6,367,367,10,10,0,1,0
13,376,376,160,160,0,1,0
32,394,394,89,7,82,3,2
25,411,411,45,1,44,3,2
22,428,428,9,9,0,1,0
27,428,428,34,34,0,1,0
15,435,435,98,64,34,3,2
8,439,439,22,4,18,3,2
4,442,442,19,19,0,1,0
29,449,449,20,4,16,2,1
11,463,463,3,3,0,1,0
2,489,489,5,5,0,1,0
7,491,491,12,12,0,1,0

25,101,101,2,2,0,1,0
23,149,149,1,1,0,1,0
16,164,164,9,5,4,2,1
15,185,185,17,17,0,1,0
14,204,204,27,27,0,1,0
24,215,215,60,48,12,4,3
6,219,219,13,13,0,1,0
2,224,224,19,19,0,1,0
22,224,224,21,21,0,1,0
5,245,245,12,12,0,1,0
13,247,247,30,10,20,2,1
19,249,249,84,62,22,2,1
27,253,253,20,17,3,2,1
1,258,258,5,5,0,1,0
10,264,264,3,3,0,1,0
21,266,266,2,2,0,1,0
31,285,285,1,1,0,1,0
0,288,288,15,15,0,1,0
9,306,306,2,2,0,1,0
7,309,309,24,24,0,1,0
11,319,319,75,13,62,3,2
29,325,325,26,6,20,2,1
17,326,326,5,5,0,1,0
26,382,382,36,36,0,1,0
18,384,384,123,63,60,3,2
30,441,441,29,11,18,2,1
4,445,445,100,100,0,1,0
8,468,468,104,44,60,4,3
12,470,470,1,1,0,1,0
20,475,475,5,5,0,1,0
3,491,491,105,85,20,2,1
28,494,494,83,38,45,4,3

14,122,122,26,8,18,3,2
0,142,142,2,2,0,1,0
4,144,144,14,14,0,1,0
6,147,147,26,4,22,2,1
13,181,181,43,10,33,2,1
18,192,192,4,4,0,1,0
21,198,198,11,1,10,2,1
23,199,199,2,2,0,1,0
24,207,207,5,5,0,1,0
16,212,212,9,9,0,1,0
12,245,245,24,6,18,3,2
19,245,245,55,5,50,2,1
11,256,256,9,9,0,1,0
10,281,281,26,10,16,2,1
5,290,290,1,1,0,1,0
3,302,302,62,62,0,1,0
1,321,321,19,19,0,1,0
15,331,331,137,60,77,4,3
20,347,347,17,17,0,1,0
17,386,386,6,6,0,1,0
2,390,390,107,98,9,4,3
25,409,409,30,17,13,4,3
7,412,412,33,10,23,2,1
9,427,427,33,24,9,2,1
22,459,459,10,4,6,3,2
8,489,489,300,278,22,4,3

3,101,101,12,12,0,1,0
4,118,118,7,1,6,3,2
16,123,123,7,2,5,2,1
9,140,140,9,9,0,1,0
19,150,150,17,13,4,2,1
23,162,162,25,25,0,1,0
13,175,175,22,5,17,3,2
11,195,195,6,6,0,1,0
7,196,196,2,2,0,1,0
2,228,228,15,15,0,1,0
8,244,244,96,10,86,3,2
30,247,247,4,4,0,1,0
5,293,293,19,3,16,2,1
28,305,305,8,1,7,2,1
31,338,338,182,172,10,3,2
22,340,340,32,32,0,1,0
1,350,350,55,3,52,3,2
18,366,366,10,10,0,1,0
27,402,402,20,20,0,1,0
10,404,404,53,53,0,1,0
29,404,404,1,1,0,1,0
15,407,407,21,21,0,1,0
25,411,411,15,15,0,1,0
20,440,440,71,71,0,1,0
26,443,443,19,19,0,1,0
0,451,451,12,12,0,1,0
6,451,451,74,54,20,3,2
14,467,467,11,11,0,1,0
24,471,471,126,126,0,1,0
17,471,471,4,1,3,2,1
12,483,483,55,55,0,1,0
21,492,492,18,18,0,1,0

28,110,110,16,16,0,1,0
20,125,125,2,2,0,1,0
1,126,126,12,3,9,4,3
10,143,143,2,2,0,1,0
12,168,168,1,1,0,1,0
3,174,174,15,15,0,1,0
4,185,185,25,25,0,1,0
0,186,186,9,9,0,1,0
23,193,193,18,18,0,1,0
13,204,204,13,13,0,1,0
7,226,226,19,13,6,2,1
29,250,250,4,4,0,1,0
2,258,258,73,73,0,1,0
19,276,276,11,3,8,3,2
5,304,304,23,20,3,2,1
18,311,311,65,65,0,1,0
9,311,311,44,44,0,1,0
14,342,342,22,22,0,1,0
26,358,358,4,4,0,1,0
24,359,359,15,7,8,3,2
8,364,364,50,4,46,3,2
15,374,374,113,58,55,4,3
6,410,410,28,2,26,3,2
22,423,423,3,3,0,1,0
21,424,424,36,36,0,1,0
11,428,428,156,83,73,4,3
17,446,446,11,4,7,2,1
25,457,457,1,1,0,1,0
16,477,477,170,146,24,4,3
27,488,488,102,21,81,4,3

5,120,120,9,9,0,1,0
10,145,145,14,14,0,1,0
11,158,158,4,4,0,1,0
20,158,158,19,19,0,1,0
25,186,186,17,17,0,1,0
0,210,210,5,5,0,1,0
23,211,211,24,4,20,2,1
18,243,243,24,20,4,2,1
21,245,245,6,6,0,1,0
4,250,250,128,80,48,4,3
6,267,267,9,9,0,1,0
3,274,274,95,79,16,3,2
14,278,278,52,52,0,1,0
2,325,325,11,11,0,1,0
26,334,334,28,28,0,1,0
16,382,382,41,41,0,1,0
9,389,389,70,2,68,3,2
8,389,389,6,6,0,1,0
19,393,393,57,57,0,1,0
22,396,396,12,12,0,1,0
24,403,403,154,145,9,2,1
7,406,406,68,2,66,3,2
15,433,433,12,3,9,4,3
13,445,445,31,13,18,4,3
17,468,468,35,27,8,3,2
12,482,482,25,25,0,1,0
1,499,499,59,59,0,1,0

29,108,108,3,3,0,1,0
34,111,111,18,18,0,1,0
36,130,130,9,9,0,1,0
6,138,138,10,10,0,1,0
35,140,140,9,9,0,1,0
38,143,143,25,25,0,1,0
33,148,148,13,13,0,1,0
24,171,171,12,12,0,1,0
15,185,185,22,10,12,3,2
20,192,192,3,3,0,1,0
25,210,210,46,46,0,1,0
9,217,217,1,1,0,1,0
39,218,218,22,22,0,1,0
14,226,226,20,20,0,1,0
30,233,233,34,12,22,3,2
2,250,250,10,7,3,2,1
18,253,253,25,15,10,3,2
11,289,289,10,10,0,1,0
13,293,293,40,40,0,1,0
3,297,297,78,42,36,4,3
26,297,297,43,11,32,3,2
8,301,301,28,28,0,1,0
21,317,317,29,15,14,2,1
7,319,319,20,9,11,2,1
28,319,319,22,22,0,1,0
1,329,329,10,10,0,1,0
17,331,331,24,24,0,1,0
0,336,336,2,2,0,1,0
27,340,340,6,1,5,2,1
37,341,341,68,32,36,3,2
19,344,344,28,28,0,1,0
4,347,347,13,13,0,1,0
31,348,348,5,5,0,1,0
12,351,351,30,4,26,3,2
5,365,365,1,1,0,1,0
32,405,405,28,1,27,2,1
10,424,424,21,21,0,1,0
23,440,440,30,16,14,3,2
22,481,481,1,1,0,1,0
16,497,497,23,23,0,1,0

25,108,108,11,11,0,1,0
9,116,116,12,7,5,2,1
2,118,118,9,3,6,2,1
4,120,120,1,1,0,1,0
19,129,129,12,4,8,2,1
26,135,135,16,16,0,1,0
11,138,138,2,2,0,1,0
32,139,139,29,8,21,2,1
7,156,156,15,15,0,1,0
34,158,158,9,9,0,1,0
27,166,166,32,23,9,2,1
8,182,182,1,1,0,1,0
5,189,189,38,38,0,1,0
21,191,191,12,9,3,2,1
33,210,210,81,43,38,3,2
14,218,218,14,14,0,1,0
22,220,220,3,3,0,1,0
29,222,222,2,2,0,1,0
0,270,270,16,16,0,1,0
17,272,272,38,30,8,2,1
3,292,292,62,4,58,3,2
6,327,327,27,27,0,1,0
12,328,328,53,53,0,1,0
13,350,350,3,3,0,1,0
1,370,370,30,30,0,1,0
23,377,377,28,28,0,1,0
31,390,390,11,11,0,1,0
20,411,411,30,7,23,2,1
18,413,413,27,27,0,1,0
16,439,439,44,16,28,3,2
15,440,440,40,33,7,2,1
30,447,447,21,21,0,1,0
10,481,481,15,15,0,1,0
24,486,486,25,5,20,3,2
28,500,500,59,59,0,1,0

24,102,102,18,18,0,1,0
8,119,119,2,2,0,1,0
12,151,151,18,18,0,1,0
2,157,157,5,5,0,1,0
27,173,173,19,19,0,1,0
15,189,189,41,41,0,1,0
0,200,200,24,14,10,2,1
22,209,209,15,15,0,1,0
19,219,219,3,3,0,1,0
14,227,227,1,1,0,1,0
5,240,240,7,7,0,1,0
26,255,255,29,29,0,1,0
20,281,281,6,6,0,1,0
29,286,286,47,47,0,1,0
6,296,296,87,35,52,4,3
25,298,298,57,57,0,1,0
21,305,305,29,24,5,2,1
23,340,340,6,1,5,2,1
31,343,343,26,11,15,4,3
9,343,343,87,65,22,3,2
17,373,373,5,5,0,1,0
11,379,379,2,2,0,1,0
16,393,393,105,3,102,4,3
10,394,394,8,8,0,1,0
7,406,406,76,28,48,2,1
3,406,406,12,2,10,2,1
30,420,420,4,4,0,1,0
13,433,433,11,11,0,1,0
1,433,433,107,77,30,3,2
28,456,456,125,43,82,3,2
18,473,473,11,11,0,1,0
4,479,479,2,2,0,1,0

24,101,101,6,2,4,2,1
4,112,112,9,5,4,2,1
18,144,144,28,28,0,1,0
2,147,147,5,1,4,2,1
22,155,155,4,1,3,2,1
14,156,156,4,4,0,1,0
21,163,163,1,1,0,1,0
5,174,174,16,16,0,1,0
26,184,184,5,5,0,1,0
32,195,195,18,18,0,1,0
8,208,208,2,2,0,1,0
31,209,209,42,42,0,1,0
19,210,210,18,18,0,1,0
23,218,218,19,19,0,1,0
0,228,228,13,13,0,1,0
29,235,235,8,8,0,1,0
11,238,238,36,36,0,1,0
3,242,242,14,14,0,1,0
30,242,242,7,7,0,1,0
28,250,250,36,36,0,1,0
25,260,260,53,41,12,3,2
1,281,281,2,2,0,1,0
12,289,289,18,2,16,3,2
17,300,300,3,3,0,1,0
13,309,309,106,82,24,2,1
9,351,351,8,8,0,1,0
15,360,360,61,5,56,3,2
20,369,369,11,11,0,1,0
27,383,383,135,101,34,3,2
6,396,396,44,44,0,1,0
33,419,419,29,29,0,1,0
7,427,427,82,10,72,4,3
10,457,457,46,34,12,4,3
16,465,465,35,35,0,1,0

5,120,120,12,12,0,1,0
20,130,130,42,11,31,2,1
8,132,132,5,5,0,1,0
13,134,134,23,23,0,1,0
6,138,138,5,5,0,1,0
17,143,143,2,2,0,1,0
12,156,156,2,2,0,1,0
18,161,161,13,13,0,1,0
34,201,201,10,10,0,1,0
36,227,227,32,2,30,4,3
37,233,233,13,13,0,1,0
28,238,238,2,2,0,1,0
4,240,240,24,9,15,2,1
30,263,263,3,3,0,1,0
7,268,268,15,2,13,2,1
27,277,277,31,2,29,2,1
33,290,290,4,4,0,1,0
2,291,291,4,1,3,2,1
21,302,302,3,3,0,1,0
31,308,308,9,9,0,1,0
22,323,323,48,48,0,1,0
23,324,324,73,73,0,1,0
24,328,328,81,10,71,4,3
1,340,340,13,1,12,3,2
14,344,344,48,32,16,3,2
29,363,363,28,13,15,4,3
19,372,372,18,18,0,1,0
26,389,389,17,17,0,1,0
9,424,424,102,43,59,3,2
11,437,437,1,1,0,1,0
35,445,445,148,91,57,3,2
32,448,448,42,15,27,4,3
3,450,450,22,3,19,2,1
10,450,450,1,1,0,1,0
25,461,461,16,9,7,2,1
0,473,473,29,19,10,3,2
16,492,492,4,4,0,1,0
15,495,495,28,28,0,1,0

19,100,100,2,2,0,1,0
10,116,116,2,2,0,1,0
12,132,132,14,2,12,4,3
0,144,144,7,7,0,1,0
18,154,154,8,8,0,1,0
27,158,158,15,5,10,3,2
8,160,160,28,28,0,1,0
6,161,161,19,11,8,3,2
28,173,173,3,3,0,1,0
23,179,179,28,24,4,2,1
3,190,190,35,28,7,2,1
16,199,199,88,16,72,4,3
30,205,205,13,13,0,1,0
4,231,231,19,19,0,1,0
25,244,244,26,5,21,2,1
15,252,252,7,7,0,1,0
2,271,271,9,9,0,1,0
21,280,280,21,9,12,3,2
14,286,286,5,5,0,1,0
13,296,296,13,13,0,1,0
7,323,323,20,8,12,2,1
22,325,325,61,23,38,3,2
1,366,366,51,51,0,1,0
24,372,372,26,21,5,2,1
11,382,382,16,16,0,1,0
20,389,389,3,3,0,1,0
9,411,411,58,29,29,2,1
29,431,431,71,71,0,1,0
26,433,433,2,2,0,1,0
17,441,441,63,10,53,4,3
5,476,476,187,112,75,4,3

11,110,110,14,4,10,2,1
5,141,141,3,3,0,1,0
23,156,156,18,10,8,3,2
25,166,166,9,2,7,2,1
3,171,171,62,48,14,4,3
30,177,177,7,7,0,1,0
1,216,216,53,53,0,1,0
31,233,233,26,26,0,1,0
19,243,243,14,14,0,1,0
9,257,257,9,2,7,2,1
28,260,260,47,8,39,4,3
27,263,263,70,38,32,2,1
4,285,285,4,4,0,1,0
16,293,293,31,31,0,1,0
24,315,315,67,67,0,1,0
10,333,333,26,12,14,3,2
8,337,337,4,1,3,2,1
7,345,345,17,5,12,3,2
12,346,346,4,4,0,1,0
22,366,366,8,8,0,1,0
18,375,375,12,6,6,2,1
20,376,376,52,52,0,1,0
17,383,383,75,47,28,4,3
14,386,386,19,1,18,3,2
21,403,403,33,15,18,4,3
2,417,417,23,23,0,1,0
29,455,455,3,3,0,1,0
15,463,463,40,40,0,1,0
6,468,468,29,7,22,3,2
26,492,492,2,2,0,1,0
0,495,495,7,7,0,1,0
13,500,500,189,153,36,2,1

19,101,101,26,8,18,4,3
16,103,103,10,2,8,3,2
21,106,106,10,1,9,4,3
24,108,108,4,4,0,1,0
8,121,121,13,7,6,2,1
3,135,135,5,5,0,1,0
20,141,141,3,3,0,1,0
9,145,145,16,16,0,1,0
0,157,157,36,18,18,3,2
14,159,159,1,1,0,1,0
17,209,209,28,13,15,2,1
18,215,215,4,4,0,1,0
10,217,217,11,11,0,1,0
13,233,233,5,5,0,1,0
12,246,246,12,8,4,2,1
23,257,257,40,19,21,2,1
6,271,271,20,1,19,4,3
1,297,297,42,42,0,1,0
11,318,318,13,5,8,2,1
5,374,374,85,85,0,1,0
7,407,407,178,178,0,1,0
2,408,408,22,15,7,2,1
4,438,438,40,10,30,2,1
15,445,445,25,7,18,4,3
26,452,452,75,39,36,3,2
22,472,472,67,67,0,1,0
27,481,481,141,84,57,4,3
25,488,488,49,3,46,4,3

22,153,153,36,22,14,4,3
1,154,154,48,48,0,1,0
24,184,184,40,24,16,2,1
2,189,189,2,2,0,1,0
18,199,199,58,13,45,3,2
8,215,215,15,15,0,1,0
10,227,227,34,4,30,4,3
21,234,234,25,20,5,2,1
16,234,234,42,9,33,3,2
9,245,245,32,1,31,4,3
29,249,249,45,13,32,3,2
15,266,266,23,1,22,2,1
17,268,268,1,1,0,1,0
28,295,295,17,8,9,4,3
7,344,344,48,26,22,2,1
3,352,352,13,5,8,2,1
30,357,357,11,11,0,1,0
27,359,359,31,18,13,2,1
19,376,376,13,13,0,1,0
6,403,403,35,35,0,1,0
5,403,403,14,14,0,1,0
0,406,406,19,8,11,2,1
13,409,409,102,86,16,2,1
26,411,411,3,3,0,1,0
4,412,412,17,17,0,1,0
20,416,416,20,20,0,1,0
23,421,421,16,12,4,2,1
14,449,449,35,12,23,2,1
11,473,473,25,11,14,2,1
12,496,496,81,48,33,4,3
25,500,500,10,10,0,1,0

0,108,108,2,2,0,1,0
1,130,130,9,9,0,1,0
21,148,148,14,1,13,3,2
12,167,167,36,36,0,1,0
19,205,205,29,29,0,1,0
25,216,216,37,37,0,1,0
22,221,221,10,5,5,2,1
18,235,235,24,18,6,2,1
8,238,238,49,28,21,4,3
11,252,252,7,1,6,3,2
14,258,258,15,15,0,1,0
27,263,263,25,11,14,2,1
23,283,283,29,20,9,4,3
3,305,305,87,5,82,4,3
17,319,319,46,8,38,2,1
24,366,366,27,27,0,1,0
26,396,396,41,18,23,2,1
4,411,411,69,26,43,2,1
10,411,411,28,28,0,1,0
6,433,433,41,7,34,4,3
2,438,438,77,5,72,4,3
9,440,440,76,76,0,1,0
16,445,445,54,54,0,1,0
15,446,446,90,76,14,2,1
5,451,451,1,1,0,1,0
13,455,455,11,11,0,1,0
20,470,470,16,7,9,4,3
28,484,484,57,30,27,4,3
7,495,495,50,4,46,3,2

0,102,102,13,13,0,1,0
1,105,105,21,15,6,2,1
28,118,118,1,1,0,1,0
4,138,138,1,1,0,1,0
20,152,152,40,7,33,3,2
3,184,184,2,2,0,1,0
30,186,186,18,3,15,4,3
9,187,187,18,8,10,2,1
21,196,196,1,1,0,1,0
15,236,236,15,3,12,3,2
5,264,264,7,1,6,2,1
13,271,271,5,5,0,1,0
17,274,274,47,4,43,2,1
8,277,277,126,3,123,4,3
18,290,290,67,67,0,1,0
14,297,297,33,33,0,1,0
22,302,302,28,12,16,2,1
11,355,355,19,6,13,2,1
10,364,364,7,4,3,2,1
16,378,378,2,2,0,1,0
23,403,403,25,25,0,1,0
12,405,405,7,2,5,2,1
2,416,416,133,37,96,4,3
24,418,418,43,43,0,1,0
19,426,426,163,118,45,4,3
7,434,434,4,4,0,1,0
27,441,441,41,41,0,1,0
26,445,445,2,2,0,1,0
29,454,454,20,5,15,4,3
25,484,484,2,2,0,1,0
6,491,491,63,17,46,3,2

14,123,123,4,4,0,1,0
15,124,124,5,5,0,1,0
26,124,124,6,6,0,1,0
32,130,130,40,40,0,1,0
2,142,142,6,6,0,1,0
29,144,144,8,1,7,3,2
20,157,157,13,4,9,2,1
28,159,159,19,13,6,2,1
1,163,163,15,7,8,2,1
21,167,167,11,5,6,2,1
30,182,182,15,6,9,2,1
8,182,182,55,1,54,3,2
3,188,188,43,31,12,4,3
23,212,212,53,53,0,1,0
27,230,230,31,19,12,3,2
5,249,249,7,7,0,1,0
12,253,253,18,18,0,1,0
33,263,263,3,3,0,1,0
4,268,268,34,34,0,1,0
34,286,286,6,6,0,1,0
19,301,301,60,60,0,1,0
24,318,318,15,15,0,1,0
31,333,333,42,42,0,1,0
16,361,361,14,14,0,1,0
6,364,364,40,1,39,2,1
10,370,370,52,31,21,4,3
13,383,383,15,15,0,1,0
22,386,386,34,10,24,4,3
18,388,388,2,2,0,1,0
7,422,422,49,49,0,1,0
25,428,428,2,2,0,1,0
17,429,429,6,2,4,2,1
9,431,431,23,23,0,1,0
11,456,456,3,3,0,1,0
0,469,469,53,5,48,4,3

31,121,121,3,3,0,1,0
25,127,127,13,13,0,1,0
27,186,186,17,17,0,1,0
6,227,227,15,15,0,1,0
11,228,228,19,3,16,2,1
12,229,229,12,12,0,1,0
23,231,231,7,7,0,1,0
17,247,247,14,14,0,1,0
14,259,259,11,8,3,2,1
29,264,264,11,11,0,1,0
16,265,265,34,3,31,2,1
30,276,276,105,57,48,4,3
15,300,300,1,1,0,1,0
9,312,312,49,49,0,1,0
7,313,313,78,78,0,1,0
21,348,348,45,22,23,2,1
22,350,350,114,54,60,4,3
0,389,389,26,26,0,1,0
5,400,400,66,66,0,1,0
8,405,405,8,8,0,1,0
18,411,411,27,27,0,1,0
24,421,421,24,24,0,1,0
19,424,424,10,10,0,1,0
3,425,425,1,1,0,1,0
13,443,443,21,21,0,1,0
1,461,461,138,79,59,4,3
28,475,475,83,7,76,3,2
10,476,476,21,14,7,2,1
2,483,483,71,62,9,4,3
32,487,487,46,22,24,3,2
4,487,487,13,13,0,1,0
26,491,491,3,3,0,1,0
20,499,499,9,9,0,1,0

12,101,101,5,5,0,1,0
22,102,102,11,11,0,1,0
18,106,106,28,1,27,4,3
34,120,120,16,1,15,2,1
25,152,152,4,4,0,1,0
6,156,156,10,3,7,2,1
29,156,156,22,22,0,1,0
32,166,166,8,4,4,2,1
4,171,171,8,2,6,3,2
3,184,184,13,13,0,1,0
9,184,184,28,28,0,1,0
14,197,197,15,9,6,2,1
21,217,217,25,4,21,2,1
33,220,220,32,32,0,1,0
20,243,243,34,34,0,1,0
1,277,277,22,22,0,1,0
17,302,302,7,7,0,1,0
2,331,331,20,8,12,2,1
19,350,350,30,30,0,1,0
27,354,354,188,155,33,4,3
31,360,360,7,7,0,1,0
11,367,367,1,1,0,1,0
23,390,390,5,5,0,1,0
15,391,391,48,48,0,1,0
28,401,401,17,9,8,3,2
30,407,407,32,32,0,1,0
13,417,417,3,3,0,1,0
26,418,418,2,2,0,1,0
5,440,440,83,83,0,1,0
0,442,442,87,48,39,4,3
24,445,445,4,4,0,1,0
7,451,451,7,7,0,1,0
8,457,457,2,2,0,1,0
10,468,468,1,1,0,1,0
16,491,491,86,76,10,3,2

19,118,118,2,2,0,1,0
16,124,124,21,21,0,1,0
24,141,141,23,1,22,2,1
22,170,170,6,6,0,1,0
1,181,181,1,1,0,1,0
20,215,215,1,1,0,1,0
9,218,218,109,23,86,3,2
23,226,226,109,109,0,1,0
21,232,232,3,3,0,1,0
0,264,264,31,6,25,4,3
18,264,264,8,8,0,1,0
17,280,280,14,14,0,1,0
12,296,296,16,16,0,1,0
15,311,311,19,10,9,2,1
3,325,325,29,29,0,1,0
4,404,404,9,1,8,2,1
2,407,407,32,32,0,1,0
7,412,412,130,58,72,4,3
11,417,417,10,10,0,1,0
26,431,431,67,20,47,2,1
10,432,432,89,11,78,3,2
5,434,434,27,20,7,3,2
13,454,454,48,48,0,1,0
6,465,465,26,5,21,4,3
8,467,467,69,39,30,4,3
25,476,476,108,15,93,4,3
14,497,497,19,19,0,1,0

5,110,110,18,10,8,3,2
0,116,116,1,1,0,1,0
1,134,134,8,3,5,2,1
34,166,166,7,7,0,1,0
30,181,181,14,14,0,1,0
12,188,188,10,10,0,1,0
16,190,190,1,1,0,1,0
9,205,205,7,7,0,1,0
32,223,223,18,5,13,2,1
33,232,232,39,27,12,2,1
15,247,247,45,45,0,1,0
2,248,248,10,10,0,1,0
20,254,254,10,10,0,1,0
8,258,258,59,23,36,4,3
4,276,276,22,8,14,2,1
35,286,286,5,5,0,1,0
6,288,288,7,4,3,2,1
14,302,302,72,60,12,3,2
13,303,303,27,27,0,1,0
28,328,328,4,4,0,1,0
24,351,351,19,19,0,1,0
11,351,351,29,29,0,1,0
25,363,363,26,14,12,3,2
19,364,364,45,34,11,2,1
27,375,375,5,1,4,2,1
31,378,378,27,27,0,1,0
29,403,403,128,45,83,4,3
36,405,405,26,26,0,1,0
3,424,424,31,31,0,1,0
7,424,424,2,2,0,1,0
23,426,426,41,41,0,1,0
18,448,448,21,11,10,2,1
22,460,460,43,7,36,3,2
10,470,470,9,9,0,1,0
17,472,472,2,2,0,1,0
21,485,485,176,126,50,2,1
26,487,487,40,40,0,1,0

16,107,107,22,13,9,2,1
15,127,127,21,7,14,2,1
2,146,146,54,8,46,4,3
7,151,151,26,26,0,1,0
22,152,152,4,4,0,1,0
0,171,171,12,5,7,2,1
17,203,203,16,16,0,1,0
13,244,244,5,5,0,1,0
24,252,252,2,2,0,1,0
4,259,259,42,8,34,3,2
14,263,263,9,9,0,1,0
23,277,277,13,13,0,1,0
19,295,295,51,51,0,1,0
3,301,301,5,5,0,1,0
25,309,309,18,18,0,1,0
20,316,316,37,26,11,2,1
9,352,352,26,8,18,4,3
21,367,367,8,8,0,1,0
11,368,368,46,4,42,4,3
6,371,371,17,9,8,2,1
10,400,400,15,5,10,3,2
8,422,422,120,75,45,4,3
1,442,442,19,7,12,3,2
5,444,444,161,115,46,2,1
18,461,461,132,132,0,1,0
12,500,500,117,117,0,1,0

9,110,110,9,1,8,3,2
3,111,111,7,7,0,1,0
2,114,114,9,1,8,2,1
10,116,116,14,14,0,1,0
11,132,132,11,11,0,1,0
6,132,132,10,10,0,1,0
23,135,135,2,2,0,1,0
29,143,143,3,3,0,1,0
36,173,173,3,3,0,1,0
32,186,186,4,4,0,1,0
14,193,193,1,1,0,1,0
20,213,213,7,1,6,3,2
1,255,255,12,8,4,2,1
18,267,267,22,6,16,2,1
35,272,272,34,34,0,1,0
37,275,275,19,19,0,1,0
5,280,280,23,23,0,1,0
0,291,291,25,7,18,3,2
7,319,319,35,35,0,1,0
21,332,332,5,5,0,1,0
12,333,333,29,26,3,2,1
22,340,340,139,139,0,1,0
8,349,349,1,1,0,1,0
34,356,356,60,24,36,4,3
16,360,360,8,8,0,1,0
28,378,378,150,87,63,4,3
25,389,389,18,5,13,2,1
26,399,399,28,28,0,1,0
27,401,401,28,28,0,1,0
15,404,404,73,48,25,2,1
33,406,406,1,1,0,1,0
13,433,433,44,12,32,2,1
31,446,446,5,1,4,2,1
4,448,448,22,22,0,1,0
19,461,461,29,29,0,1,0
24,466,466,16,16,0,1,0
30,487,487,73,73,0,1,0
17,493,493,64,64,0,1,0

26,123,123,13,13,0,1,0
14,127,127,11,1,10,2,1
15,164,164,42,9,33,4,3
11,167,167,15,15,0,1,0
21,178,178,8,1,7,3,2
25,211,211,4,1,3,2,1
7,212,212,22,6,16,3,2
20,231,231,37,16,21,4,3
5,235,235,44,44,0,1,0
2,242,242,43,32,11,2,1
9,275,275,19,4,15,4,3
16,285,285,35,35,0,1,0
6,291,291,101,53,48,3,2
24,310,310,70,48,22,3,2
4,315,315,40,12,28,3,2
27,338,338,65,51,14,3,2
0,348,348,13,13,0,1,0
13,350,350,11,11,0,1,0
19,356,356,8,8,0,1,0
23,391,391,21,21,0,1,0
3,420,420,11,11,0,1,0
12,422,422,12,12,0,1,0
8,424,424,31,13,18,4,3
28,426,426,8,2,6,2,1
1,427,427,118,100,18,4,3
18,464,464,8,8,0,1,0
22,474,474,69,29,40,3,2
17,474,474,61,6,55,3,2
10,484,484,28,19,9,2,1

18,104,104,1,1,0,1,0
0,107,107,2,2,0,1,0
16,119,119,10,10,0,1,0
10,125,125,2,2,0,1,0
22,143,143,24,24,0,1,0
31,154,154,47,29,18,2,1
3,160,160,1,1,0,1,0
23,165,165,8,8,0,1,0
12,176,176,10,3,7,2,1
1,193,193,6,3,3,2,1
4,204,204,7,3,4,2,1
21,217,217,3,3,0,1,0
9,220,220,2,2,0,1,0
34,226,226,9,9,0,1,0
13,229,229,26,26,0,1,0
7,245,245,8,4,4,2,1
28,253,253,35,35,0,1,0
5,254,254,12,3,9,2,1
6,303,303,61,61,0,1,0
15,308,308,15,15,0,1,0
32,322,322,72,39,33,2,1
11,331,331,6,6,0,1,0
14,332,332,57,57,0,1,0
20,347,347,4,4,0,1,0
17,355,355,48,48,0,1,0
27,373,373,142,117,25,4,3
26,376,376,3,3,0,1,0
2,399,399,17,17,0,1,0
36,399,399,33,33,0,1,0
35,401,401,2,2,0,1,0
25,426,426,11,6,5,2,1
8,437,437,222,222,0,1,0
24,463,463,6,6,0,1,0
29,469,469,23,11,12,2,1
30,475,475,47,32,15,2,1
33,476,476,16,4,12,4,3
19,495,495,3,3,0,1,0

18,106,106,18,9,9,4,3
2,108,108,5,5,0,1,0
26,108,108,29,13,16,2,1
30,126,126,2,2,0,1,0
19,143,143,21,21,0,1,0
4,158,158,13,2,11,2,1
31,171,171,35,35,0,1,0
24,182,182,22,3,19,2,1
6,186,186,1,1,0,1,0
14,213,213,2,2,0,1,0
8,225,225,9,9,0,1,0
32,226,226,17,3,14,3,2
29,233,233,2,2,0,1,0
1,251,251,5,5,0,1,0
11,262,262,37,9,28,2,1
27,269,269,45,45,0,1,0
28,287,287,25,25,0,1,0
7,303,303,19,19,0,1,0
21,306,306,37,12,25,2,1
13,347,347,33,33,0,1,0
16,349,349,45,5,40,3,2
5,357,357,45,17,28,2,1
9,359,359,90,90,0,1,0
22,378,378,44,44,0,1,0
12,378,378,22,2,20,3,2
3,388,388,37,20,17,2,1
17,395,395,10,10,0,1,0
10,454,454,17,17,0,1,0
20,461,461,20,2,18,3,2
0,474,474,14,14,0,1,0
15,478,478,178,60,118,4,3
25,484,484,22,22,0,1,0
23,500,500,12,7,5,2,1

2,106,106,13,13,0,1,0
21,107,107,18,18,0,1,0
5,112,112,22,22,0,1,0
9,123,123,12,8,4,2,1
6,137,137,21,3,18,4,3
20,145,145,4,4,0,1,0
29,148,148,12,3,9,2,1
4,155,155,2,2,0,1,0
22,161,161,4,4,0,1,0
28,170,170,53,53,0,1,0
27,181,181,6,6,0,1,0
24,188,188,10,10,0,1,0
19,192,192,18,10,8,2,1
16,209,209,18,2,16,2,1
12,228,228,35,15,20,4,3
11,250,250,6,6,0,1,0
14,255,255,5,5,0,1,0
36,278,278,24,24,0,1,0
34,283,283,23,23,0,1,0
15,289,289,8,8,0,1,0
26,303,303,16,16,0,1,0
31,306,306,8,3,5,2,1
1,316,316,18,2,16,2,1
3,336,336,61,61,0,1,0
25,353,353,45,25,20,2,1
17,362,362,1,1,0,1,0
18,364,364,9,9,0,1,0
23,370,370,16,7,9,4,3
35,374,374,103,4,99,4,3
10,377,377,18,12,6,3,2
32,410,410,6,6,0,1,0
0,416,416,40,13,27,4,3
30,417,417,63,63,0,1,0
33,429,429,42,42,0,1,0
13,447,447,11,11,0,1,0
7,451,451,41,41,0,1,0
8,458,458,29,17,12,2,1

25,109,109,4,4,0,1,0
17,111,111,6,1,5,2,1
24,122,122,18,18,0,1,0
18,123,123,15,5,10,3,2
23,124,124,32,32,0,1,0
10,134,134,34,18,16,2,1
16,142,142,5,5,0,1,0
7,170,170,1,1,0,1,0
9,214,214,5,2,3,2,1
13,218,218,9,9,0,1,0
3,237,237,9,9,0,1,0
30,244,244,20,16,4,2,1
15,277,277,37,37,0,1,0
29,281,281,11,11,0,1,0
26,300,300,1,1,0,1,0
6,313,313,34,19,15,4,3
4,319,319,6,6,0,1,0
1,320,320,52,52,0,1,0
8,324,324,71,55,16,3,2
12,341,341,39,39,0,1,0
0,351,351,53,17,36,3,2
11,357,357,10,1,9,2,1
33,364,364,76,37,39,3,2
14,375,375,10,6,4,2,1
5,378,378,12,2,10,3,2
22,404,404,9,3,6,3,2
27,408,408,28,8,20,2,1
28,421,421,90,90,0,1,0
31,422,422,56,56,0,1,0
2,423,423,66,27,39,2,1
20,446,446,62,49,13,2,1
21,464,464,15,15,0,1,0
32,478,478,21,10,11,2,1
19,491,491,44,44,0,1,0

37,100,100,25,25,0,1,0
26,102,102,5,5,0,1,0
7,106,106,17,1,16,3,2
17,134,134,1,1,0,1,0
28,149,149,13,13,0,1,0
41,150,150,4,4,0,1,0
23,169,169,12,12,0,1,0
39,179,179,2,2,0,1,0
3,181,181,1,1,0,1,0
9,202,202,4,4,0,1,0
30,207,207,1,1,0,1,0
18,214,214,9,9,0,1,0
24,216,216,2,2,0,1,0
11,236,236,6,6,0,1,0
35,250,250,9,9,0,1,0
38,255,255,10,7,3,2,1
2,267,267,32,32,0,1,0
40,282,282,33,1,32,2,1
27,309,309,88,44,44,3,2
15,317,317,4,4,0,1,0
36,319,319,37,37,0,1,0
31,324,324,47,2,45,2,1
21,336,336,23,23,0,1,0
20,342,342,29,29,0,1,0
19,346,346,2,2,0,1,0
32,351,351,67,67,0,1,0
12,373,373,4,1,3,2,1
16,374,374,34,16,18,4,3
5,374,374,73,39,34,2,1
34,376,376,1,1,0,1,0
1,388,388,93,38,55,3,2
6,397,397,20,20,0,1,0
29,418,418,74,29,45,2,1
0,421,421,9,9,0,1,0
22,424,424,16,16,0,1,0
14,432,432,48,9,39,4,3
33,442,442,40,40,0,1,0
25,442,442,9,9,0,1,0
13,447,447,14,3,11,2,1
4,471,471,34,11,23,2,1
8,472,472,28,28,0,1,0
10,485,485,14,8,6,2,1

29,101,101,9,9,0,1,0
3,104,104,5,5,0,1,0
0,152,152,14,14,0,1,0
30,188,188,18,18,0,1,0
6,227,227,24,24,0,1,0
12,232,232,1,1,0,1,0
23,244,244,4,4,0,1,0
11,247,247,5,5,0,1,0
13,280,280,46,16,30,4,3
14,286,286,19,7,12,4,3
5,297,297,58,58,0,1,0
24,301,301,4,4,0,1,0
19,308,308,25,7,18,2,1
4,318,318,14,4,10,3,2
16,319,319,40,40,0,1,0
17,350,350,59,49,10,3,2
20,360,360,20,20,0,1,0
21,363,363,31,13,18,2,1
26,390,390,7,1,6,3,2
10,395,395,34,4,30,3,2
33,407,407,66,33,33,4,3
22,414,414,98,83,15,4,3
15,431,431,33,4,29,4,3
27,432,432,50,50,0,1,0
1,436,436,1,1,0,1,0
32,444,444,67,13,54,3,2
9,452,452,62,22,40,2,1
31,452,452,32,32,0,1,0
8,462,462,42,42,0,1,0
7,467,467,24,3,21,2,1
28,472,472,113,95,18,4,3
25,479,479,75,75,0,1,0
2,489,489,60,60,0,1,0
18,495,495,19,1,18,4,3

0,105,105,39,32,7,2,1
14,105,105,2,2,0,1,0
31,114,114,6,6,0,1,0
9,148,148,15,15,0,1,0
2,151,151,1,1,0,1,0
21,162,162,8,8,0,1,0
8,163,163,14,6,8,3,2
30,163,163,1,1,0,1,0
7,206,206,37,25,12,2,1
19,206,206,9,6,3,2,1
15,213,213,10,10,0,1,0
28,223,223,17,2,15,4,3
23,229,229,25,4,21,4,3
26,249,249,74,71,3,2,1
29,273,273,42,3,39,2,1
20,299,299,49,3,46,3,2
24,301,301,52,12,40,3,2
5,307,307,13,7,6,2,1
17,313,313,21,21,0,1,0
16,321,321,46,46,0,1,0
1,323,323,66,38,28,2,1
11,325,325,13,13,0,1,0
4,357,357,8,3,5,2,1
10,359,359,10,10,0,1,0
6,383,383,112,60,52,3,2
18,414,414,6,6,0,1,0
12,438,438,24,9,15,2,1
3,446,446,14,4,10,3,2
22,448,448,44,44,0,1,0
13,484,484,37,37,0,1,0
27,484,484,8,8,0,1,0
25,495,495,85,77,8,3,2

28,105,105,6,2,4,2,1
11,108,108,1,1,0,1,0
27,140,140,5,5,0,1,0
31,142,142,6,6,0,1,0
13,143,143,7,7,0,1,0
26,159,159,3,3,0,1,0
19,175,175,17,17,0,1,0
12,184,184,4,4,0,1,0
5,194,194,2,2,0,1,0
15,194,194,34,34,0,1,0
20,243,243,97,97,0,1,0
16,252,252,46,2,44,3,2
4,257,257,8,8,0,1,0
3,284,284,22,10,12,2,1
14,307,307,98,98,0,1,0
21,307,307,8,8,0,1,0
24,311,311,8,2,6,3,2
23,334,334,32,32,0,1,0
1,337,337,1,1,0,1,0
17,338,338,24,24,0,1,0
22,353,353,55,17,38,2,1
0,355,355,9,3,6,2,1
2,374,374,24,24,0,1,0
29,380,380,59,59,0,1,0
30,397,397,12,4,8,2,1
8,402,402,58,58,0,1,0
25,406,406,15,15,0,1,0
7,412,412,141,141,0,1,0
10,440,440,86,86,0,1,0
6,463,463,27,27,0,1,0
18,470,470,95,77,18,3,2
9,492,492,38,14,24,4,3

26,103,103,11,11,0,1,0
0,103,103,1,1,0,1,0
19,114,114,21,11,10,2,1
10,125,125,3,3,0,1,0
12,147,147,23,23,0,1,0
32,183,183,10,2,8,3,2
18,189,189,1,1,0,1,0
24,192,192,3,3,0,1,0
21,201,201,60,55,5,2,1
8,204,204,21,7,14,2,1
31,235,235,68,68,0,1,0
1,237,237,4,1,3,2,1
25,248,248,24,24,0,1,0
4,267,267,34,34,0,1,0
11,275,275,6,2,4,2,1
9,305,305,33,24,9,2,1
6,314,314,13,3,10,2,1
16,334,334,26,26,0,1,0
28,338,338,6,2,4,2,1
30,350,350,39,39,0,1,0
3,378,378,58,58,0,1,0
15,400,400,23,17,6,3,2
20,401,401,68,68,0,1,0
2,419,419,15,3,12,3,2
23,423,423,5,5,0,1,0
13,431,431,52,25,27,4,3
27,432,432,47,47,0,1,0
5,433,433,2,2,0,1,0
17,442,442,60,40,20,2,1
7,445,445,72,32,40,2,1
34,454,454,40,40,0,1,0
22,462,462,16,16,0,1,0
29,473,473,80,80,0,1,0
35,474,474,16,16,0,1,0
33,481,481,11,11,0,1,0
14,494,494,28,3,25,2,1

24,100,100,23,16,7,2,1
17,102,102,1,1,0,1,0
0,118,118,7,7,0,1,0
6,211,211,61,43,18,3,2
21,211,211,40,40,0,1,0
23,227,227,3,3,0,1,0
20,230,230,12,3,9,2,1
16,232,232,3,3,0,1,0
27,244,244,35,29,6,3,2
15,246,246,25,25,0,1,0
28,250,250,29,25,4,2,1
22,254,254,11,2,9,4,3
4,283,283,9,9,0,1,0
9,286,286,17,17,0,1,0
26,299,299,64,20,44,2,1
19,323,323,19,3,16,3,2
3,331,331,36,36,0,1,0
5,335,335,13,13,0,1,0
13,339,339,148,90,58,3,2
1,355,355,29,11,18,4,3
7,374,374,65,53,12,3,2
2,374,374,39,39,0,1,0
8,415,415,3,3,0,1,0
11,417,417,22,22,0,1,0
10,422,422,45,45,0,1,0
12,423,423,22,22,0,1,0
14,440,440,63,7,56,3,2
18,454,454,13,1,12,2,1
29,454,454,15,2,13,2,1
25,472,472,115,115,0,1,0

16,124,124,2,2,0,1,0
0,154,154,5,5,0,1,0
12,155,155,5,5,0,1,0
7,160,160,12,2,10,3,2
32,166,166,20,20,0,1,0
15,170,170,39,10,29,2,1
19,193,193,8,2,6,3,2
26,201,201,77,19,58,3,2
30,211,211,26,26,0,1,0
6,215,215,13,13,0,1,0
29,236,236,5,5,0,1,0
28,246,246,45,35,10,3,2
11,251,251,14,2,12,2,1
17,276,276,4,4,0,1,0
20,286,286,5,5,0,1,0
31,287,287,24,24,0,1,0
23,293,293,24,24,0,1,0
27,297,297,6,6,0,1,0
2,300,300,26,16,10,3,2
21,301,301,53,53,0,1,0
8,307,307,41,41,0,1,0
22,317,317,66,66,0,1,0
14,362,362,26,3,23,3,2
10,365,365,46,46,0,1,0
1,373,373,10,10,0,1,0
4,375,375,28,28,0,1,0
25,384,384,1,1,0,1,0
5,385,385,101,101,0,1,0
24,392,392,5,5,0,1,0
9,403,403,11,11,0,1,0
34,430,430,61,35,26,3,2
3,457,457,67,67,0,1,0
13,462,462,40,16,24,4,3
33,493,493,8,8,0,1,0
18,495,495,21,9,12,4,3

13,111,111,6,6,0,1,0
15,120,120,10,5,5,2,1
22,126,126,30,30,0,1,0
26,189,189,19,1,18,3,2
4,205,205,79,73,6,3,2
16,221,221,41,41,0,1,0
12,223,223,6,3,3,2,1
25,237,237,29,29,0,1,0
5,258,258,34,34,0,1,0
19,263,263,34,34,0,1,0
27,271,271,15,5,10,2,1
18,277,277,36,36,0,1,0
6,283,283,40,12,28,2,1
2,284,284,58,58,0,1,0
21,297,297,40,40,0,1,0
29,297,297,10,10,0,1,0
9,308,308,4,4,0,1,0
1,342,342,18,12,6,2,1
11,349,349,42,42,0,1,0
23,364,364,1,1,0,1,0
10,365,365,12,6,6,2,1
28,412,412,109,10,99,4,3
3,420,420,6,6,0,1,0
20,423,423,6,3,3,2,1
17,430,430,30,15,15,2,1
8,432,432,1,1,0,1,0
14,433,433,2,2,0,1,0
0,441,441,126,126,0,1,0
7,476,476,67,4,63,4,3
24,498,498,31,22,9,2,1

14,106,106,5,5,0,1,0
8,106,106,2,2,0,1,0
15,140,140,1,1,0,1,0
2,153,153,3,3,0,1,0
30,167,167,5,5,0,1,0
13,176,176,2,2,0,1,0
5,176,176,27,12,15,4,3
1,192,192,1,1,0,1,0
23,203,203,19,19,0,1,0
19,215,215,15,6,9,4,3
7,238,238,15,15,0,1,0
17,239,239,17,17,0,1,0
4,241,241,75,75,0,1,0
10,241,241,35,35,0,1,0
6,256,256,41,41,0,1,0
9,286,286,17,17,0,1,0
3,291,291,26,26,0,1,0
16,296,296,24,24,0,1,0
32,301,301,10,10,0,1,0
11,302,302,77,77,0,1,0
24,305,305,17,8,9,2,1
27,328,328,90,32,58,3,2
25,334,334,80,80,0,1,0
28,343,343,7,7,0,1,0
22,355,355,2,2,0,1,0
31,373,373,21,4,17,2,1
26,392,392,2,2,0,1,0
0,394,394,46,46,0,1,0
18,396,396,16,10,6,2,1
21,397,397,205,106,99,4,3
12,404,404,23,23,0,1,0
20,426,426,9,9,0,1,0
29,475,475,48,12,36,3,2

20,123,123,30,30,0,1,0
10,124,124,1,1,0,1,0
22,131,131,6,6,0,1,0
30,135,135,18,18,0,1,0
23,149,149,15,7,8,3,2
8,150,150,22,22,0,1,0
26,161,161,8,2,6,3,2
29,163,163,42,42,0,1,0
11,168,168,20,20,0,1,0
5,181,181,10,10,0,1,0
27,189,189,3,3,0,1,0
6,200,200,6,6,0,1,0
28,235,235,2,2,0,1,0
16,240,240,49,49,0,1,0
19,245,245,27,27,0,1,0
31,259,259,38,8,30,3,2
18,272,272,10,5,5,2,1
4,281,281,22,22,0,1,0
35,281,281,53,53,0,1,0
34,308,308,13,4,9,2,1
24,329,329,9,9,0,1,0
33,334,334,74,74,0,1,0
1,337,337,13,3,10,3,2
17,337,337,8,8,0,1,0
3,367,367,11,3,8,3,2
7,368,368,65,65,0,1,0
15,384,384,3,3,0,1,0
32,387,387,19,19,0,1,0
14,391,391,50,26,24,4,3
21,396,396,23,4,19,3,2
25,412,412,18,18,0,1,0
2,426,426,89,63,26,2,1
12,430,430,55,13,42,4,3
9,437,437,1,1,0,1,0
13,452,452,3,3,0,1,0
0,454,454,29,5,24,4,3

16,148,148,11,11,0,1,0
15,151,151,5,5,0,1,0
10,172,172,17,5,12,4,3
20,175,175,43,17,26,2,1
18,183,183,5,5,0,1,0
9,187,187,32,32,0,1,0
14,196,196,16,16,0,1,0
22,196,196,6,6,0,1,0
17,198,198,16,6,10,2,1
11,245,245,7,7,0,1,0
1,260,260,26,17,9,4,3
2,263,263,1,1,0,1,0
19,289,289,5,5,0,1,0
24,291,291,46,20,26,3,2
7,315,315,41,5,36,3,2
5,329,329,84,52,32,3,2
12,337,337,57,57,0,1,0
8,383,383,44,8,36,3,2
3,383,383,39,15,24,2,1
25,397,397,24,24,0,1,0
21,448,448,218,186,32,2,1
0,477,477,129,108,21,2,1
6,479,479,110,2,108,4,3
4,488,488,109,40,69,4,3
23,488,488,2,2,0,1,0
13,496,496,19,9,10,2,1

10,106,106,18,18,0,1,0
27,113,113,4,4,0,1,0
15,117,117,11,1,10,2,1
31,143,143,16,16,0,1,0
28,144,144,47,7,40,3,2
24,153,153,5,5,0,1,0
4,164,164,54,32,22,2,1
0,193,193,44,44,0,1,0
11,222,222,10,10,0,1,0
25,234,234,4,1,3,2,1
8,235,235,19,19,0,1,0
12,253,253,45,23,22,3,2
32,275,275,1,1,0,1,0
20,277,277,23,23,0,1,0
6,293,293,12,12,0,1,0
9,302,302,8,8,0,1,0
7,316,316,44,44,0,1,0
33,326,326,3,3,0,1,0
30,339,339,81,33,48,4,3
19,353,353,70,12,58,3,2
21,360,360,67,67,0,1,0
22,375,375,40,16,24,4,3
16,375,375,6,6,0,1,0
2,385,385,26,12,14,2,1
29,395,395,35,25,10,2,1
13,410,410,2,2,0,1,0
23,417,417,10,2,8,3,2
17,426,426,34,34,0,1,0
26,459,459,22,4,18,4,3
14,464,464,20,4,16,2,1
3,483,483,2,2,0,1,0
1,492,492,25,25,0,1,0
5,492,492,2,2,0,1,0
18,499,499,57,57,0,1,0

17,106,106,5,5,0,1,0
20,118,118,23,14,9,4,3
3,127,127,6,6,0,1,0
23,133,133,8,8,0,1,0
16,150,150,5,5,0,1,0
13,151,151,11,1,10,3,2
10,168,168,33,10,23,4,3
2,170,170,49,31,18,4,3
26,175,175,11,1,10,3,2
7,176,176,8,8,0,1,0
29,206,206,56,56,0,1,0
18,222,222,1,1,0,1,0
28,225,225,30,30,0,1,0
5,257,257,18,8,10,3,2
19,260,260,18,18,0,1,0
25,261,261,12,12,0,1,0
12,305,305,5,5,0,1,0
8,346,346,34,34,0,1,0
14,362,362,96,75,21,4,3
0,364,364,16,5,11,2,1
6,371,371,4,4,0,1,0
1,392,392,5,5,0,1,0
15,393,393,60,60,0,1,0
27,408,408,47,47,0,1,0
22,410,410,12,12,0,1,0
31,431,431,5,5,0,1,0
11,435,435,64,64,0,1,0
4,442,442,13,4,9,4,3
21,451,451,2,2,0,1,0
24,455,455,11,3,8,2,1
9,461,461,48,39,9,4,3
30,478,478,252,231,21,4,3

26,113,113,14,14,0,1,0
19,125,125,10,10,0,1,0
6,149,149,19,4,15,4,3
2,155,155,6,6,0,1,0
3,157,157,16,3,13,2,1
9,157,157,4,4,0,1,0
31,158,158,5,5,0,1,0
11,175,175,18,1,17,2,1
30,179,179,4,4,0,1,0
1,187,187,3,3,0,1,0
0,240,240,11,3,8,3,2
16,289,289,24,9,15,4,3
13,289,289,42,42,0,1,0
21,299,299,61,61,0,1,0
23,329,329,53,53,0,1,0
25,388,388,28,28,0,1,0
4,399,399,35,7,28,3,2
12,410,410,44,2,42,3,2
14,420,420,37,37,0,1,0
24,424,424,50,50,0,1,0
27,427,427,62,33,29,2,1
28,439,439,165,165,0,1,0
32,440,440,43,43,0,1,0
8,442,442,8,4,4,2,1
15,460,460,40,40,0,1,0
5,467,467,8,8,0,1,0
17,475,475,11,11,0,1,0
7,476,476,118,99,19,4,3
20,479,479,3,3,0,1,0
10,482,482,127,127,0,1,0
18,494,494,35,35,0,1,0
22,499,499,20,20,0,1,0
29,499,499,27,15,12,2,1

22,113,113,7,2,5,2,1
4,179,179,17,5,12,4,3
7,193,193,9,9,0,1,0
6,194,194,1,1,0,1,0
13,196,196,7,7,0,1,0
3,209,209,48,3,45,3,2
21,210,210,27,5,22,3,2
2,263,263,150,21,129,4,3
1,263,263,47,47,0,1,0
23,275,275,51,19,32,2,1
18,283,283,20,11,9,2,1
26,291,291,5,5,0,1,0
15,292,292,92,67,25,2,1
20,299,299,6,2,4,2,1
17,305,305,16,8,8,3,2
27,307,307,4,4,0,1,0
5,316,316,24,14,10,2,1
19,324,324,28,16,12,3,2
12,328,328,5,5,0,1,0
16,335,335,145,70,75,3,2
11,373,373,50,50,0,1,0
25,380,380,35,10,25,2,1
24,393,393,35,7,28,2,1
8,402,402,12,2,10,3,2
10,405,405,15,2,13,2,1
0,414,414,58,58,0,1,0
28,419,419,7,7,0,1,0
9,496,496,21,21,0,1,0
14,498,498,6,2,4,2,1

4,106,106,1,1,0,1,0
23,108,108,4,1,3,2,1
14,135,135,9,9,0,1,0
1,140,140,14,9,5,2,1
22,155,155,1,1,0,1,0
2,161,161,9,9,0,1,0
20,170,170,13,5,8,2,1
5,172,172,9,1,8,3,2
9,175,175,19,11,8,3,2
37,180,180,32,32,0,1,0
13,184,184,4,4,0,1,0
6,195,195,1,1,0,1,0
16,207,207,13,13,0,1,0
3,222,222,6,6,0,1,0
11,232,232,4,4,0,1,0
36,244,244,17,17,0,1,0
17,247,247,55,49,6,2,1
15,250,250,25,25,0,1,0
8,262,262,22,2,20,4,3
30,265,265,46,12,34,3,2
7,313,313,13,13,0,1,0
25,353,353,37,15,22,3,2
34,363,363,120,105,15,4,3
31,368,368,47,31,16,3,2
0,370,370,38,8,30,3,2
12,378,378,26,5,21,2,1
26,384,384,37,18,19,2,1
19,404,404,14,3,11,2,1
28,410,410,3,3,0,1,0
33,426,426,18,18,0,1,0
27,430,430,71,71,0,1,0
29,445,445,19,19,0,1,0
35,469,469,63,15,48,3,2
24,470,470,42,42,0,1,0
21,480,480,2,2,0,1,0
32,492,492,9,9,0,1,0
18,497,497,63,20,43,2,1
10,497,497,106,81,25,2,1

2,116,116,6,6,0,1,0
9,116,116,30,30,0,1,0
33,121,121,34,29,5,2,1
26,131,131,4,4,0,1,0
29,149,149,3,3,0,1,0
30,168,168,19,9,10,3,2
16,179,179,13,7,6,3,2
19,208,208,13,8,5,2,1
18,236,236,37,37,0,1,0
32,243,243,31,31,0,1,0
1,262,262,14,14,0,1,0
12,275,275,7,7,0,1,0
25,277,277,55,43,12,4,3
27,297,297,23,9,14,2,1
4,303,303,16,16,0,1,0
31,307,307,113,59,54,4,3
8,314,314,4,1,3,2,1
0,322,322,2,2,0,1,0
6,322,322,2,2,0,1,0
20,326,326,7,7,0,1,0
17,326,326,16,2,14,3,2
10,336,336,71,46,25,2,1
14,355,355,5,5,0,1,0
24,357,357,68,5,63,4,3
5,367,367,146,146,0,1,0
15,374,374,43,10,33,4,3
7,392,392,14,14,0,1,0
13,405,405,15,2,13,2,1
34,422,422,3,3,0,1,0
22,424,424,10,10,0,1,0
3,457,457,8,8,0,1,0
28,463,463,30,30,0,1,0
11,477,477,13,13,0,1,0
21,479,479,15,15,0,1,0
23,482,482,5,5,0,1,0

17,102,102,1,1,0,1,0
23,116,116,3,3,0,1,0
27,123,123,14,14,0,1,0
29,128,128,2,2,0,1,0
31,157,157,14,14,0,1,0
32,199,199,3,3,0,1,0
15,203,203,28,28,0,1,0
28,239,239,28,7,21,4,3
2,253,253,2,2,0,1,0
10,294,294,49,49,0,1,0
18,296,296,39,39,0,1,0
34,298,298,58,19,39,2,1
26,311,311,15,15,0,1,0
19,314,314,33,10,23,4,3
6,319,319,39,39,0,1,0
14,323,323,39,39,0,1,0
25,326,326,44,44,0,1,0
3,331,331,32,24,8,3,2
33,334,334,1,1,0,1,0
11,356,356,25,6,19,2,1
8,360,360,90,90,0,1,0
16,365,365,5,5,0,1,0
7,397,397,12,2,10,2,1
21,398,398,44,11,33,2,1
9,413,413,1,1,0,1,0
5,413,413,1,1,0,1,0
13,414,414,47,47,0,1,0
4,430,430,12,3,9,4,3
30,431,431,68,56,12,4,3
24,437,437,198,185,13,2,1
0,445,445,10,10,0,1,0
1,461,461,78,78,0,1,0
12,461,461,49,1,48,2,1
20,463,463,9,9,0,1,0
22,474,474,21,21,0,1,0

0,101,101,16,4,12,4,3
20,106,106,7,7,0,1,0
3,113,113,2,2,0,1,0
26,116,116,20,6,14,4,3
22,117,117,1,1,0,1,0
31,119,119,18,4,14,3,2
13,124,124,7,7,0,1,0
28,166,166,1,1,0,1,0
15,171,171,3,3,0,1,0
6,218,218,119,95,24,3,2
11,233,233,16,2,14,2,1
18,235,235,6,3,3,2,1
25,259,259,7,7,0,1,0
4,291,291,12,12,0,1,0
34,306,306,4,4,0,1,0
33,307,307,6,6,0,1,0
32,320,320,8,3,5,2,1
1,336,336,18,11,7,2,1
8,342,342,22,22,0,1,0
7,356,356,1,1,0,1,0
14,358,358,72,72,0,1,0
10,362,362,20,20,0,1,0
30,363,363,48,48,0,1,0
19,372,372,53,53,0,1,0
2,390,390,4,4,0,1,0
16,393,393,15,15,0,1,0
17,402,402,25,25,0,1,0
24,419,419,252,198,54,3,2
12,423,423,15,15,0,1,0
5,424,424,4,4,0,1,0
23,425,425,13,13,0,1,0
9,436,436,61,4,57,3,2
29,452,452,5,5,0,1,0
27,468,468,101,54,47,2,1
21,473,473,5,5,0,1,0

33,104,104,9,9,0,1,0
15,104,104,1,1,0,1,0
25,108,108,1,1,0,1,0
18,119,119,16,1,15,3,2
27,119,119,23,23,0,1,0
7,122,122,7,7,0,1,0
19,126,126,1,1,0,1,0
24,140,140,6,6,0,1,0
0,173,173,5,5,0,1,0
6,179,179,31,31,0,1,0
31,194,194,7,7,0,1,0
2,198,198,21,21,0,1,0
22,199,199,6,6,0,1,0
11,220,220,42,30,12,4,3
9,239,239,9,9,0,1,0
8,254,254,48,48,0,1,0
21,258,258,4,4,0,1,0
14,278,278,2,2,0,1,0
16,284,284,35,32,3,2,1
28,307,307,13,8,5,2,1
1,342,342,26,26,0,1,0
13,348,348,11,11,0,1,0
34,354,354,13,13,0,1,0
35,357,357,90,33,57,4,3
17,361,361,14,14,0,1,0
5,368,368,11,11,0,1,0
30,373,373,12,2,10,3,2
12,375,375,19,3,16,2,1
39,398,398,6,6,0,1,0
36,401,401,41,26,15,2,1
38,419,419,50,50,0,1,0
32,421,421,100,75,25,2,1
26,436,436,27,27,0,1,0
4,437,437,28,28,0,1,0
23,446,446,39,11,28,3,2
10,448,448,31,26,5,2,1
37,462,462,32,8,24,4,3
20,476,476,16,13,3,2,1
3,493,493,4,1,3,2,1
29,500,500,149,145,4,2,1

25,104,104,10,4,6,3,2
17,144,144,9,9,0,1,0
20,169,169,19,1,18,4,3
26,179,179,3,3,0,1,0
19,216,216,8,8,0,1,0
24,218,218,3,3,0,1,0
14,232,232,6,6,0,1,0
6,278,278,17,9,8,2,1
8,283,283,51,51,0,1,0
9,302,302,33,33,0,1,0
1,348,348,3,3,0,1,0
12,350,350,14,10,4,2,1
13,351,351,8,8,0,1,0
7,354,354,47,4,43,2,1
18,361,361,161,119,42,4,3
5,363,363,24,2,22,3,2
2,389,389,162,88,74,3,2
4,394,394,81,15,66,4,3
0,400,400,90,42,48,4,3
11,405,405,13,8,5,2,1
21,408,408,53,53,0,1,0
3,422,422,65,19,46,2,1
15,433,433,136,70,66,4,3
16,445,445,26,26,0,1,0
22,463,463,6,6,0,1,0
10,484,484,20,20,0,1,0
23,498,498,105,89,16,2,1

35,112,112,10,10,0,1,0
1,113,113,17,9,8,2,1
14,115,115,3,3,0,1,0
4,121,121,14,14,0,1,0
23,123,123,7,7,0,1,0
21,128,128,32,32,0,1,0
19,129,129,1,1,0,1,0
36,138,138,2,2,0,1,0
11,156,156,25,25,0,1,0
5,177,177,19,6,13,2,1
10,187,187,3,3,0,1,0
27,197,197,13,13,0,1,0
3,202,202,2,2,0,1,0
22,209,209,25,9,16,2,1
29,211,211,24,24,0,1,0
18,229,229,1,1,0,1,0
31,233,233,2,2,0,1,0
20,248,248,11,11,0,1,0
12,250,250,19,19,0,1,0
7,259,259,38,2,36,3,2
26,267,267,64,64,0,1,0
30,268,268,67,22,45,4,3
28,271,271,12,12,0,1,0
15,301,301,2,2,0,1,0
9,302,302,39,5,34,3,2
0,317,317,6,6,0,1,0
13,331,331,34,25,9,4,3
34,336,336,14,14,0,1,0
2,345,345,18,18,0,1,0
8,358,358,16,16,0,1,0
17,379,379,21,21,0,1,0
25,381,381,89,16,73,4,3
33,389,389,8,4,4,2,1
6,414,414,75,37,38,3,2
24,418,418,29,22,7,2,1
16,434,434,64,64,0,1,0
32,498,498,12,4,8,3,2

7,103,103,13,13,0,1,0
11,117,117,18,18,0,1,0
9,134,134,2,2,0,1,0
17,137,137,6,6,0,1,0
33,176,176,21,21,0,1,0
10,178,178,11,11,0,1,0
29,180,180,5,5,0,1,0
1,203,203,8,8,0,1,0
8,208,208,15,15,0,1,0
28,208,208,14,14,0,1,0
20,221,221,10,10,0,1,0
12,222,222,3,3,0,1,0
31,236,236,20,4,16,4,3
6,253,253,4,4,0,1,0
27,267,267,5,2,3,2,1
3,272,272,31,2,29,2,1
19,290,290,14,14,0,1,0
2,297,297,4,4,0,1,0
4,299,299,7,1,6,3,2
16,299,299,161,143,18,4,3
18,302,302,39,27,12,2,1
14,307,307,13,13,0,1,0
15,326,326,25,25,0,1,0
21,327,327,14,2,12,4,3
26,353,353,137,137,0,1,0
23,365,365,159,59,100,3,2
32,389,389,25,13,12,3,2
13,391,391,24,6,18,2,1
22,441,441,19,19,0,1,0
24,448,448,12,12,0,1,0
5,470,470,59,59,0,1,0
0,474,474,32,12,20,2,1
30,478,478,22,22,0,1,0
25,492,492,21,21,0,1,0

10,103,103,4,4,0,1,0
27,120,120,1,1,0,1,0
25,129,129,31,1,30,4,3
22,138,138,4,4,0,1,0
31,150,150,20,16,4,2,1
29,155,155,40,32,8,2,1
8,157,157,1,1,0,1,0
9,180,180,16,16,0,1,0
6,201,201,64,46,18,3,2
15,210,210,4,4,0,1,0
11,214,214,46,46,0,1,0
4,219,219,2,2,0,1,0
24,224,224,56,49,7,2,1
32,247,247,11,8,3,2,1
18,287,287,19,19,0,1,0
0,300,300,37,37,0,1,0
20,305,305,7,1,6,3,2
17,325,325,9,9,0,1,0
2,328,328,24,4,20,4,3
14,330,330,87,21,66,4,3
23,344,344,60,8,52,3,2
26,367,367,37,20,17,2,1
19,368,368,24,24,0,1,0
1,387,387,1,1,0,1,0
5,399,399,31,31,0,1,0
30,402,402,3,3,0,1,0
21,418,418,82,25,57,4,3
12,443,443,6,3,3,2,1
3,452,452,56,20,36,2,1
7,459,459,41,41,0,1,0
13,479,479,1,1,0,1,0
28,496,496,8,5,3,2,1
16,499,499,68,68,0,1,0

20,107,107,2,2,0,1,0
16,120,120,23,23,0,1,0
30,131,131,7,7,0,1,0
18,142,142,13,1,12,2,1
10,143,143,25,25,0,1,0
21,159,159,5,5,0,1,0
14,174,174,1,1,0,1,0
7,179,179,6,3,3,2,1
5,193,193,14,5,9,2,1
22,225,225,6,6,0,1,0
8,263,263,12,12,0,1,0
0,270,270,11,2,9,2,1
24,293,293,53,53,0,1,0
2,304,304,36,27,9,4,3
13,310,310,5,5,0,1,0
25,312,312,41,41,0,1,0
26,315,315,11,11,0,1,0
11,318,318,56,24,32,2,1
3,332,332,12,1,11,2,1
6,346,346,42,28,14,3,2
12,347,347,94,82,12,3,2
23,358,358,24,18,6,3,2
27,399,399,79,42,37,2,1
29,399,399,93,93,0,1,0
4,416,416,16,5,11,2,1
19,425,425,4,4,0,1,0
28,444,444,37,3,34,3,2
15,469,469,70,65,5,2,1
17,477,477,67,67,0,1,0
1,482,482,37,15,22,3,2
9,493,493,184,132,52,3,2

1,103,103,5,5,0,1,0
10,110,110,16,4,12,4,3
33,113,113,10,10,0,1,0
24,138,138,9,9,0,1,0
29,141,141,36,6,30,2,1
15,148,148,7,7,0,1,0
30,171,171,3,3,0,1,0
7,178,178,8,8,0,1,0
18,179,179,25,25,0,1,0
37,186,186,19,9,10,2,1
27,199,199,19,19,0,1,0
35,207,207,5,1,4,2,1
14,212,212,22,22,0,1,0
32,213,213,7,7,0,1,0
3,219,219,20,20,0,1,0
22,219,219,14,14,0,1,0
11,243,243,1,1,0,1,0
5,261,261,14,14,0,1,0
26,286,286,5,5,0,1,0
6,286,286,1,1,0,1,0
31,295,295,2,2,0,1,0
0,314,314,28,28,0,1,0
21,337,337,23,23,0,1,0
19,339,339,122,48,74,3,2
9,351,351,3,3,0,1,0
8,356,356,16,10,6,3,2
28,371,371,11,11,0,1,0
34,420,420,107,107,0,1,0
17,446,446,2,2,0,1,0
20,447,447,53,3,50,2,1
16,460,460,73,10,63,4,3
23,465,465,7,1,6,3,2
2,469,469,6,6,0,1,0
36,474,474,201,66,135,4,3
25,487,487,65,65,0,1,0
13,487,487,3,3,0,1,0
4,494,494,8,8,0,1,0
12,495,495,16,9,7,2,1

13,111,111,9,3,6,3,2
22,122,122,6,1,5,2,1
23,123,123,18,18,0,1,0
20,152,152,19,19,0,1,0
21,168,168,13,13,0,1,0
11,195,195,48,48,0,1,0
26,204,204,3,3,0,1,0
0,208,208,5,5,0,1,0
31,214,214,8,8,0,1,0
2,269,269,36,36,0,1,0
30,275,275,18,18,0,1,0
16,293,293,65,65,0,1,0
18,296,296,27,27,0,1,0
8,310,310,6,6,0,1,0
32,313,313,21,3,18,3,2
9,321,321,9,5,4,2,1
24,322,322,65,45,20,2,1
25,330,330,2,2,0,1,0
15,349,349,42,42,0,1,0
19,359,359,117,117,0,1,0
14,363,363,3,3,0,1,0
6,376,376,34,34,0,1,0
28,380,380,3,3,0,1,0
7,386,386,5,5,0,1,0
27,390,390,8,4,4,2,1
10,401,401,63,63,0,1,0
1,407,407,28,28,0,1,0
3,409,409,28,28,0,1,0
17,414,414,32,32,0,1,0
29,445,445,142,134,8,2,1
33,450,450,37,17,20,2,1
5,450,450,3,3,0,1,0
12,455,455,102,91,11,2,1
4,464,464,6,6,0,1,0

1,113,113,1,1,0,1,0
31,117,117,3,3,0,1,0
35,131,131,1,1,0,1,0
2,137,137,10,10,0,1,0
18,155,155,3,3,0,1,0
0,158,158,4,4,0,1,0
27,164,164,21,21,0,1,0
25,164,164,52,52,0,1,0
3,167,167,7,1,6,2,1
14,168,168,20,20,0,1,0
11,174,174,17,7,10,3,2
23,182,182,8,2,6,3,2
22,196,196,11,11,0,1,0
32,200,200,1,1,0,1,0
20,204,204,13,13,0,1,0
5,215,215,22,22,0,1,0
30,242,242,73,73,0,1,0
21,267,267,1,1,0,1,0
9,278,278,26,26,0,1,0
4,281,281,41,20,21,2,1
29,311,311,22,22,0,1,0
16,319,319,66,57,9,4,3
34,321,321,12,6,6,2,1
7,323,323,31,28,3,2,1
15,342,342,26,8,18,4,3
26,353,353,4,4,0,1,0
28,355,355,34,34,0,1,0
24,373,373,135,113,22,2,1
36,373,373,21,21,0,1,0
6,395,395,122,97,25,4,3
10,417,417,1,1,0,1,0
8,420,420,1,1,0,1,0
12,434,434,13,13,0,1,0
33,460,460,56,29,27,2,1
13,467,467,15,9,6,3,2
17,474,474,14,14,0,1,0
19,478,478,14,8,6,2,1

12,132,132,53,21,32,3,2
15,138,138,22,22,0,1,0
26,142,142,8,5,3,2,1
6,185,185,42,42,0,1,0
11,185,185,35,25,10,2,1
2,199,199,4,4,0,1,0
9,227,227,47,25,22,2,1
23,250,250,7,7,0,1,0
0,276,276,19,2,17,4,3
7,279,279,25,18,7,2,1
3,281,281,23,23,0,1,0
1,354,354,16,1,15,4,3
25,371,371,59,59,0,1,0
4,391,391,18,18,0,1,0
13,392,392,26,10,16,3,2
5,397,397,16,16,0,1,0
8,401,401,10,4,6,2,1
28,409,409,62,62,0,1,0
14,414,414,39,39,0,1,0
22,417,417,103,53,50,2,1
17,435,435,7,7,0,1,0
19,439,439,4,4,0,1,0
21,443,443,13,13,0,1,0
10,448,448,73,73,0,1,0
20,452,452,40,40,0,1,0
16,458,458,65,65,0,1,0
18,481,481,32,20,12,4,3
24,481,481,67,19,48,4,3
27,488,488,84,84,0,1,0

35,101,101,2,2,0,1,0
27,111,111,20,20,0,1,0
30,118,118,1,1,0,1,0
26,122,122,13,13,0,1,0
16,157,157,14,2,12,3,2
10,164,164,21,21,0,1,0
2,168,168,5,5,0,1,0
12,186,186,1,1,0,1,0
18,204,204,29,29,0,1,0
29,231,231,9,9,0,1,0
4,232,232,16,1,15,4,3
20,236,236,41,41,0,1,0
33,246,246,65,26,39,2,1
36,246,246,6,3,3,2,1
15,253,253,16,16,0,1,0
37,253,253,44,44,0,1,0
0,260,260,9,9,0,1,0
21,287,287,6,6,0,1,0
8,290,290,37,37,0,1,0
11,295,295,1,1,0,1,0
14,307,307,33,33,0,1,0
5,327,327,7,7,0,1,0
32,334,334,3,3,0,1,0
9,351,351,13,5,8,2,1
39,352,352,25,25,0,1,0
24,355,355,51,27,24,4,3
34,355,355,106,96,10,2,1
31,357,357,53,53,0,1,0
1,371,371,32,32,0,1,0
17,371,371,1,1,0,1,0
28,374,374,3,3,0,1,0
19,380,380,27,27,0,1,0
3,386,386,10,10,0,1,0
38,390,390,50,50,0,1,0
23,400,400,17,17,0,1,0
7,426,426,21,21,0,1,0
25,444,444,5,2,3,2,1
13,445,445,61,55,6,3,2
6,483,483,55,55,0,1,0
22,484,484,10,3,7,2,1

19,145,145,14,4,10,3,2
16,152,152,15,15,0,1,0
1,172,172,3,3,0,1,0
21,178,178,4,1,3,2,1
8,207,207,26,22,4,2,1
5,217,217,40,25,15,4,3
7,223,223,17,17,0,1,0
17,233,233,17,9,8,3,2
10,239,239,7,1,6,2,1
2,254,254,51,27,24,4,3
0,257,257,7,7,0,1,0
23,286,286,6,6,0,1,0
15,291,291,35,30,5,2,1
18,315,315,47,47,0,1,0
27,319,319,35,6,29,4,3
13,324,324,40,6,34,2,1
25,327,327,38,16,22,3,2
22,329,329,1,1,0,1,0
24,344,344,4,4,0,1,0
4,353,353,83,17,66,4,3
11,377,377,99,72,27,2,1
9,387,387,30,20,10,2,1
3,388,388,3,3,0,1,0
28,393,393,54,6,48,4,3
12,393,393,17,17,0,1,0
6,400,400,126,26,100,3,2
20,428,428,15,4,11,2,1
14,443,443,198,198,0,1,0
26,474,474,29,29,0,1,0

11,108,108,12,12,0,1,0
17,186,186,9,3,6,2,1
18,189,189,3,3,0,1,0
26,190,190,14,14,0,1,0
10,207,207,23,15,8,2,1
8,215,215,10,3,7,2,1
3,226,226,24,8,16,2,1
33,240,240,55,40,15,2,1
21,285,285,5,5,0,1,0
12,299,299,3,3,0,1,0
16,300,300,3,3,0,1,0
28,312,312,5,1,4,2,1
2,316,316,12,12,0,1,0
31,324,324,30,8,22,2,1
1,328,328,9,3,6,3,2
24,329,329,3,3,0,1,0
19,342,342,44,35,9,4,3
14,362,362,48,48,0,1,0
29,382,382,49,49,0,1,0
6,388,388,15,7,8,2,1
25,398,398,42,14,28,2,1
13,406,406,1,1,0,1,0
30,415,415,18,12,6,3,2
4,415,415,44,11,33,2,1
32,431,431,39,39,0,1,0
20,432,432,7,2,5,2,1
9,449,449,40,40,0,1,0
27,452,452,218,218,0,1,0
5,454,454,34,34,0,1,0
7,460,460,72,48,24,3,2
23,464,464,3,3,0,1,0
22,484,484,83,83,0,1,0
15,484,484,31,31,0,1,0
0,493,493,211,169,42,4,3

2,101,101,1,1,0,1,0
3,103,103,1,1,0,1,0
30,114,114,32,32,0,1,0
12,114,114,1,1,0,1,0
18,131,131,4,4,0,1,0
25,144,144,15,15,0,1,0
6,184,184,23,4,19,2,1
15,187,187,55,40,15,4,3
4,188,188,37,16,21,2,1
1,202,202,18,18,0,1,0
14,223,223,4,4,0,1,0
17,238,238,4,1,3,2,1
27,242,242,8,8,0,1,0
16,243,243,20,20,0,1,0
8,267,267,81,81,0,1,0
9,268,268,35,3,32,2,1
24,271,271,32,32,0,1,0
13,283,283,4,4,0,1,0
7,284,284,5,5,0,1,0
11,289,289,10,4,6,2,1
26,325,325,29,29,0,1,0
0,331,331,12,3,9,2,1
5,345,345,46,18,28,4,3
29,356,356,36,26,10,3,2
32,367,367,3,3,0,1,0
19,370,370,111,96,15,4,3
28,376,376,3,3,0,1,0
23,411,411,113,47,66,4,3
10,447,447,36,28,8,2,1
22,452,452,37,37,0,1,0
33,452,452,47,47,0,1,0
20,460,460,16,16,0,1,0
21,470,470,1,1,0,1,0
31,481,481,28,8,20,2,1

25,104,104,20,6,14,4,3
18,117,117,2,2,0,1,0
8,126,126,14,1,13,4,3
13,149,149,1,1,0,1,0
10,156,156,6,6,0,1,0
30,165,165,17,17,0,1,0
32,184,184,2,2,0,1,0
36,212,212,4,4,0,1,0
15,219,219,3,3,0,1,0
37,227,227,11,11,0,1,0
3,234,234,9,3,6,3,2
17,238,238,10,2,8,3,2
29,245,245,7,7,0,1,0
21,259,259,48,44,4,2,1
7,261,261,3,3,0,1,0
0,265,265,3,3,0,1,0
5,265,265,9,9,0,1,0
4,292,292,11,2,9,4,3
22,301,301,99,10,89,4,3
20,303,303,32,22,10,2,1
11,308,308,1,1,0,1,0
31,309,309,1,1,0,1,0
28,340,340,22,12,10,2,1
12,344,344,26,6,20,2,1
19,349,349,34,34,0,1,0
39,354,354,65,65,0,1,0
1,376,376,1,1,0,1,0
38,377,377,8,5,3,2,1
23,378,378,18,18,0,1,0
35,390,390,83,83,0,1,0
2,400,400,18,18,0,1,0
27,402,402,22,22,0,1,0
24,406,406,85,75,10,2,1
33,425,425,66,66,0,1,0
26,438,438,136,1,135,4,3
34,443,443,8,8,0,1,0
9,446,446,59,59,0,1,0
14,455,455,24,24,0,1,0
6,457,457,5,5,0,1,0
16,458,458,70,44,26,3,2

10,108,108,7,7,0,1,0
12,138,138,15,1,14,3,2
22,161,161,4,4,0,1,0
23,171,171,10,6,4,2,1
17,185,185,5,5,0,1,0
5,186,186,64,64,0,1,0
25,195,195,3,3,0,1,0
13,197,197,4,1,3,2,1
28,198,198,86,35,51,4,3
4,212,212,17,17,0,1,0
14,246,246,11,1,10,2,1
11,268,268,4,4,0,1,0
24,270,270,63,63,0,1,0
6,276,276,22,1,21,4,3
20,288,288,12,12,0,1,0
0,290,290,66,34,32,2,1
2,335,335,1,1,0,1,0
16,336,336,27,27,0,1,0
7,338,338,14,3,11,2,1
27,359,359,3,3,0,1,0
15,368,368,25,25,0,1,0
21,385,385,50,50,0,1,0
9,397,397,169,38,131,4,3
26,401,401,71,71,0,1,0
18,464,464,71,29,42,3,2
19,470,470,52,28,24,3,2
1,470,470,1,1,0,1,0
8,471,471,29,7,22,2,1
3,500,500,76,76,0,1,0

25,109,109,2,2,0,1,0
7,139,139,34,24,10,3,2
13,149,149,11,11,0,1,0
2,162,162,11,11,0,1,0
17,172,172,15,15,0,1,0
22,188,188,29,19,10,2,1
19,216,216,14,8,6,2,1
12,218,218,8,8,0,1,0
28,238,238,4,4,0,1,0
27,244,244,30,9,21,4,3
21,274,274,2,2,0,1,0
11,290,290,10,10,0,1,0
30,298,298,12,12,0,1,0
10,308,308,19,3,16,2,1
6,344,344,28,5,23,2,1
31,354,354,13,8,5,2,1
8,354,354,56,56,0,1,0
14,372,372,50,50,0,1,0
23,377,377,27,17,10,2,1
32,384,384,3,3,0,1,0
20,395,395,75,67,8,2,1
16,397,397,32,32,0,1,0
4,399,399,22,4,18,3,2
15,409,409,102,102,0,1,0
24,412,412,57,14,43,2,1
18,425,425,68,68,0,1,0
26,425,425,45,36,9,2,1
0,426,426,27,27,0,1,0
1,435,435,28,19,9,2,1
29,451,451,184,60,124,4,3
5,488,488,1,1,0,1,0
9,493,493,23,12,11,2,1
3,498,498,73,9,64,4,3

1,123,123,2,2,0,1,0
17,139,139,22,22,0,1,0
4,140,140,47,47,0,1,0
6,151,151,2,2,0,1,0
22,167,167,9,9,0,1,0
10,184,184,1,1,0,1,0
23,194,194,46,2,44,2,1
18,203,203,35,11,24,3,2
12,204,204,9,9,0,1,0
15,216,216,3,3,0,1,0
2,219,219,38,6,32,2,1
5,226,226,95,77,18,4,3
28,239,239,14,2,12,4,3
8,241,241,16,16,0,1,0
19,252,252,9,9,0,1,0
30,262,262,34,34,0,1,0
0,263,263,25,16,9,4,3
21,269,269,3,3,0,1,0
25,288,288,21,13,8,2,1
7,305,305,10,10,0,1,0
27,315,315,34,34,0,1,0
14,327,327,9,3,6,3,2
13,353,353,79,4,75,4,3
9,418,418,32,32,0,1,0
3,418,418,2,2,0,1,0
11,430,430,23,8,15,4,3
16,446,446,20,8,12,3,2
29,448,448,13,13,0,1,0
31,452,452,92,92,0,1,0
24,472,472,40,40,0,1,0
26,493,493,108,52,56,4,3
20,496,496,5,5,0,1,0

13,102,102,32,11,21,4,3
0,113,113,11,5,6,2,1
3,126,126,17,17,0,1,0
30,133,133,14,5,9,2,1
16,142,142,1,1,0,1,0
14,151,151,28,28,0,1,0
12,158,158,20,20,0,1,0
11,176,176,12,12,0,1,0
26,178,178,30,24,6,2,1
15,181,181,14,14,0,1,0
17,191,191,32,2,30,2,1
10,203,203,2,2,0,1,0
18,204,204,10,4,6,2,1
19,241,241,12,6,6,3,2
28,258,258,27,15,12,3,2
20,295,295,8,8,0,1,0
4,298,298,21,21,0,1,0
8,310,310,6,6,0,1,0
1,333,333,2,2,0,1,0
22,348,348,15,15,0,1,0
29,351,351,45,45,0,1,0
6,355,355,75,55,20,3,2
7,358,358,23,15,8,3,2
24,365,365,56,56,0,1,0
5,367,367,76,27,49,4,3
2,387,387,14,14,0,1,0
23,394,394,9,6,3,2,1
9,433,433,23,23,0,1,0
27,442,442,161,143,18,4,3
21,458,458,67,11,56,3,2
25,466,466,7,1,6,2,1

9,121,121,5,5,0,1,0
3,124,124,2,2,0,1,0
1,131,131,19,3,16,2,1
21,132,132,9,9,0,1,0
6,166,166,1,1,0,1,0
17,169,169,24,24,0,1,0
11,177,177,38,6,32,2,1
27,181,181,12,12,0,1,0
25,188,188,16,5,11,2,1
15,218,218,1,1,0,1,0
12,238,238,3,3,0,1,0
16,239,239,15,15,0,1,0
18,257,257,6,6,0,1,0
20,261,261,20,20,0,1,0
5,272,272,2,2,0,1,0
39,291,291,17,11,6,2,1
0,297,297,12,12,0,1,0
33,298,298,57,57,0,1,0
32,313,313,30,30,0,1,0
37,315,315,33,18,15,4,3
13,316,316,3,3,0,1,0
36,326,326,27,27,0,1,0
7,328,328,21,21,0,1,0
4,375,375,25,1,24,4,3
29,377,377,24,19,5,2,1
19,427,427,11,11,0,1,0
23,436,436,17,17,0,1,0
8,436,436,17,17,0,1,0
38,439,439,28,15,13,2,1
10,439,439,25,25,0,1,0
35,453,453,190,174,16,3,2
34,459,459,14,9,5,2,1
24,463,463,62,32,30,4,3
28,467,467,55,55,0,1,0
31,469,469,37,37,0,1,0
30,472,472,11,11,0,1,0
14,472,472,80,46,34,3,2
40,474,474,21,9,12,4,3
26,494,494,48,35,13,2,1
2,496,496,7,2,5,2,1
22,497,497,60,60,0,1,0

23,117,117,4,1,3,2,1
9,126,126,5,5,0,1,0
2,127,127,1,1,0,1,0
30,128,128,12,4,8,3,2
13,132,132,2,2,0,1,0
32,133,133,1,1,0,1,0
1,208,208,19,3,16,2,1
29,219,219,22,22,0,1,0
10,234,234,2,2,0,1,0
11,240,240,17,1,16,3,2
12,240,240,25,25,0,1,0
20,246,246,63,43,20,2,1
16,248,248,58,48,10,2,1
17,274,274,11,5,6,3,2
8,279,279,69,6,63,4,3
18,281,281,11,11,0,1,0
24,306,306,90,2,88,3,2
28,317,317,3,3,0,1,0
31,329,329,22,22,0,1,0
4,337,337,81,14,67,4,3
25,360,360,13,7,6,3,2
19,375,375,101,69,32,2,1
15,417,417,1,1,0,1,0
26,422,422,16,16,0,1,0
6,439,439,25,25,0,1,0
27,451,451,33,6,27,4,3
14,461,461,36,3,33,3,2
7,467,467,1,1,0,1,0
5,471,471,22,22,0,1,0
22,475,475,5,2,3,2,1
0,478,478,47,47,0,1,0
3,482,482,124,124,0,1,0
21,490,490,132,132,0,1,0

19,103,103,5,5,0,1,0
12,111,111,20,4,16,2,1
26,113,113,34,20,14,2,1
22,146,146,12,12,0,1,0
5,216,216,27,27,0,1,0
13,234,234,4,1,3,2,1
2,275,275,44,44,0,1,0
18,280,280,30,15,15,2,1
1,287,287,3,3,0,1,0
17,290,290,20,20,0,1,0
23,292,292,31,31,0,1,0
4,313,313,131,37,94,3,2
27,314,314,29,29,0,1,0
10,357,357,90,50,40,4,3
6,368,368,9,9,0,1,0
3,378,378,37,37,0,1,0
7,379,379,1,1,0,1,0
24,386,386,18,18,0,1,0
14,416,416,37,37,0,1,0
11,451,451,72,72,0,1,0
25,453,453,86,5,81,4,3
20,461,461,15,2,13,2,1
21,469,469,35,28,7,2,1
9,473,473,9,9,0,1,0
15,488,488,39,39,0,1,0
0,488,488,33,33,0,1,0
16,489,489,57,49,8,3,2
8,494,494,130,69,61,4,3

25,109,109,4,4,0,1,0
8,111,111,7,1,6,3,2
4,116,116,1,1,0,1,0
5,124,124,14,14,0,1,0
7,135,135,28,28,0,1,0
0,148,148,2,2,0,1,0
22,149,149,15,15,0,1,0
15,171,171,18,3,15,2,1
28,183,183,6,6,0,1,0
3,232,232,18,3,15,4,3
18,240,240,6,6,0,1,0
13,265,265,18,10,8,2,1
2,269,269,8,3,5,2,1
29,274,274,8,8,0,1,0
24,275,275,4,4,0,1,0
26,283,283,18,10,8,3,2
30,298,298,14,2,12,3,2
1,313,313,34,11,23,2,1
32,325,325,60,42,18,4,3
19,333,333,114,20,94,4,3
6,334,334,33,33,0,1,0
23,387,387,38,26,12,4,3
21,402,402,80,7,73,4,3
17,427,427,17,3,14,3,2
20,428,428,2,2,0,1,0
31,429,429,155,123,32,3,2
27,430,430,19,5,14,3,2
16,450,450,1,1,0,1,0
10,456,456,128,34,94,4,3
12,459,459,104,104,0,1,0
14,469,469,31,12,19,2,1
11,487,487,25,16,9,4,3
9,493,493,40,10,30,3,2

24,100,100,10,10,0,1,0
22,112,112,26,26,0,1,0
26,130,130,8,2,6,3,2
23,152,152,1,1,0,1,0
25,159,159,33,17,16,3,2
17,177,177,7,7,0,1,0
9,207,207,50,50,0,1,0
11,221,221,9,9,0,1,0
0,222,222,26,26,0,1,0
20,240,240,24,24,0,1,0
5,285,285,42,24,18,2,1
10,286,286,10,4,6,3,2
4,288,288,1,1,0,1,0
21,331,331,8,8,0,1,0
1,383,383,20,1,19,2,1
12,384,384,24,24,0,1,0
2,387,387,89,35,54,4,3
3,390,390,132,114,18,4,3
14,392,392,148,137,11,2,1
13,410,410,85,11,74,3,2
19,414,414,11,11,0,1,0
15,415,415,40,40,0,1,0
7,416,416,1,1,0,1,0
6,421,421,144,92,52,4,3
16,422,422,1,1,0,1,0
8,466,466,43,20,23,2,1
18,475,475,27,15,12,4,3

1,118,118,6,6,0,1,0
6,131,131,39,8,31,2,1
0,139,139,1,1,0,1,0
12,146,146,8,2,6,2,1
20,161,161,26,26,0,1,0
11,176,176,1,1,0,1,0
29,188,188,5,5,0,1,0
22,210,210,9,3,6,2,1
8,254,254,11,11,0,1,0
23,267,267,66,66,0,1,0
2,284,284,36,16,20,2,1
9,288,288,9,5,4,2,1
28,288,288,57,27,30,4,3
13,289,289,2,2,0,1,0
5,298,298,28,28,0,1,0
17,309,309,18,18,0,1,0
3,331,331,5,5,0,1,0
32,346,346,18,7,11,2,1
24,351,351,62,62,0,1,0
19,355,355,39,13,26,3,2
31,377,377,16,6,10,2,1
7,378,378,106,14,92,3,2
16,389,389,110,14,96,4,3
4,393,393,89,53,36,4,3
14,411,411,12,12,0,1,0
10,428,428,12,9,3,2,1
26,429,429,71,47,24,3,2
18,453,453,30,22,8,3,2
21,453,453,63,63,0,1,0
25,474,474,4,4,0,1,0
30,474,474,32,6,26,3,2
15,481,481,10,10,0,1,0
27,489,489,29,29,0,1,0

8,103,103,14,14,0,1,0
18,109,109,9,9,0,1,0
3,111,111,3,3,0,1,0
22,113,113,11,11,0,1,0
23,118,118,16,16,0,1,0
12,123,123,10,10,0,1,0
25,160,160,12,12,0,1,0
0,171,171,14,8,6,3,2
13,188,188,29,29,0,1,0
19,202,202,8,8,0,1,0
21,211,211,19,19,0,1,0
24,220,220,50,50,0,1,0
16,246,246,7,7,0,1,0
11,339,339,2,2,0,1,0
4,376,376,121,117,4,2,1
17,391,391,5,5,0,1,0
7,429,429,48,5,43,2,1
9,431,431,33,23,10,2,1
2,442,442,7,1,6,2,1
14,442,442,52,52,0,1,0
5,442,442,3,3,0,1,0
6,442,442,178,70,108,4,3
20,449,449,64,64,0,1,0
10,468,468,27,27,0,1,0
1,485,485,204,196,8,3,2
15,492,492,144,123,21,2,1

18,134,134,4,4,0,1,0
10,143,143,16,16,0,1,0
11,145,145,1,1,0,1,0
3,147,147,2,2,0,1,0
25,158,158,12,12,0,1,0
4,164,164,50,23,27,4,3
28,166,166,16,16,0,1,0
27,176,176,19,19,0,1,0
9,199,199,27,27,0,1,0
24,207,207,18,18,0,1,0
26,216,216,9,3,6,3,2
1,220,220,23,11,12,2,1
8,225,225,24,24,0,1,0
23,231,231,89,71,18,4,3
31,267,267,36,36,0,1,0
2,281,281,43,35,8,2,1
16,324,324,15,15,0,1,0
29,331,331,10,10,0,1,0
7,348,348,57,13,44,4,3
17,374,374,17,17,0,1,0
20,394,394,18,18,0,1,0
13,396,396,17,17,0,1,0
5,401,401,37,37,0,1,0
12,406,406,60,1,59,3,2
30,417,417,43,35,8,2,1
14,418,418,14,14,0,1,0
19,429,429,23,23,0,1,0
6,430,430,5,2,3,2,1
15,441,441,69,9,60,3,2
0,468,468,7,3,4,2,1
21,471,471,125,125,0,1,0
22,478,478,41,41,0,1,0

3,117,117,10,10,0,1,0
31,133,133,9,9,0,1,0
30,158,158,32,32,0,1,0
28,166,166,6,1,5,2,1
15,168,168,6,6,0,1,0
25,199,199,43,43,0,1,0
20,216,216,17,4,13,3,2
4,232,232,2,2,0,1,0
6,285,285,64,64,0,1,0
17,289,289,12,12,0,1,0
8,291,291,57,57,0,1,0
35,292,292,78,23,55,4,3
19,295,295,16,16,0,1,0
10,303,303,19,19,0,1,0
14,315,315,5,5,0,1,0
34,336,336,1,1,0,1,0
5,348,348,18,4,14,3,2
1,350,350,11,11,0,1,0
33,368,368,136,136,0,1,0
0,370,370,1,1,0,1,0
27,386,386,39,39,0,1,0
13,387,387,13,2,11,2,1
23,394,394,2,2,0,1,0
26,406,406,22,22,0,1,0
11,420,420,1,1,0,1,0
9,436,436,45,36,9,2,1
2,438,438,13,1,12,4,3
16,442,442,21,21,0,1,0
18,449,449,6,6,0,1,0
21,456,456,30,30,0,1,0
24,459,459,20,20,0,1,0
12,464,464,5,5,0,1,0
29,482,482,9,9,0,1,0
7,491,491,270,270,0,1,0
32,493,493,35,35,0,1,0
22,496,496,15,9,6,2,1

22,103,103,7,7,0,1,0
16,104,104,1,1,0,1,0
4,140,140,2,2,0,1,0
8,141,141,9,6,3,2,1
27,156,156,56,56,0,1,0
0,172,172,1,1,0,1,0
17,180,180,11,11,0,1,0
14,201,201,6,6,0,1,0
21,207,207,47,9,38,3,2
24,236,236,9,5,4,2,1
7,253,253,20,20,0,1,0
20,290,290,16,16,0,1,0
9,293,293,125,125,0,1,0
25,324,324,138,18,120,4,3
3,325,325,14,9,5,2,1
11,329,329,121,121,0,1,0
19,330,330,24,11,13,2,1
26,335,335,23,23,0,1,0
2,363,363,39,9,30,4,3
13,366,366,19,19,0,1,0
10,376,376,78,78,0,1,0
15,381,381,11,11,0,1,0
1,391,391,20,5,15,2,1
5,403,403,62,10,52,3,2
6,462,462,37,7,30,3,2
12,467,467,50,50,0,1,0
23,472,472,4,4,0,1,0
18,490,490,8,8,0,1,0

7,128,128,1,1,0,1,0
1,130,130,24,24,0,1,0
19,137,137,10,2,8,3,2
24,147,147,34,13,21,4,3
20,164,164,13,1,12,2,1
21,176,176,25,4,21,4,3
26,183,183,12,12,0,1,0
3,203,203,67,43,24,2,1
11,211,211,77,77,0,1,0
23,214,214,12,12,0,1,0
5,216,216,9,3,6,2,1
28,231,231,10,10,0,1,0
6,254,254,17,17,0,1,0
13,264,264,11,11,0,1,0
22,269,269,8,2,6,3,2
4,289,289,17,17,0,1,0
0,334,334,26,26,0,1,0
9,339,339,32,32,0,1,0
12,340,340,52,52,0,1,0
29,342,342,48,48,0,1,0
10,355,355,2,2,0,1,0
17,358,358,37,37,0,1,0
18,360,360,8,8,0,1,0
14,376,376,43,43,0,1,0
15,380,380,15,15,0,1,0
8,404,404,67,67,0,1,0
25,407,407,41,20,21,2,1
2,408,408,4,1,3,2,1
27,458,458,114,9,105,4,3
16,490,490,71,41,30,3,2

4,110,110,20,20,0,1,0
7,115,115,21,21,0,1,0
2,127,127,23,23,0,1,0
19,131,131,32,14,18,3,2
24,139,139,40,40,0,1,0
5,141,141,1,1,0,1,0
6,151,151,16,7,9,2,1
14,176,176,21,21,0,1,0
12,177,177,11,3,8,3,2
0,193,193,3,3,0,1,0
11,201,201,12,12,0,1,0
9,202,202,19,15,4,2,1
25,217,217,5,5,0,1,0
23,232,232,38,29,9,4,3
26,233,233,22,1,21,4,3
21,251,251,13,13,0,1,0
22,263,263,2,2,0,1,0
13,280,280,11,11,0,1,0
17,306,306,29,29,0,1,0
10,326,326,61,19,42,4,3
16,327,327,19,11,8,3,2
15,335,335,6,6,0,1,0
8,340,340,51,51,0,1,0
27,346,346,63,18,45,4,3
18,394,394,17,11,6,3,2
3,394,394,108,93,15,4,3
1,425,425,43,10,33,4,3
20,493,493,85,85,0,1,0
28,495,495,20,20,0,1,0

6,102,102,1,1,0,1,0
16,109,109,1,1,0,1,0
29,116,116,3,3,0,1,0
13,118,118,57,10,47,2,1
20,131,131,34,9,25,2,1
8,142,142,3,3,0,1,0
26,156,156,21,8,13,2,1
12,169,169,6,6,0,1,0
1,172,172,5,5,0,1,0
4,179,179,46,46,0,1,0
17,189,189,23,23,0,1,0
19,235,235,1,1,0,1,0
32,240,240,17,17,0,1,0
22,279,279,8,2,6,2,1
27,281,281,68,7,61,4,3
31,305,305,24,14,10,2,1
11,308,308,50,50,0,1,0
15,328,328,1,1,0,1,0
9,337,337,104,104,0,1,0
25,338,338,37,37,0,1,0
0,339,339,24,2,22,3,2
2,341,341,5,5,0,1,0
21,345,345,19,19,0,1,0
23,348,348,7,1,6,3,2
24,350,350,26,8,18,3,2
3,350,350,15,2,13,2,1
7,353,353,13,5,8,3,2
14,373,373,13,1,12,4,3
28,393,393,67,67,0,1,0
30,408,408,23,2,21,4,3
10,430,430,12,6,6,3,2
5,452,452,26,4,22,3,2
18,490,490,88,80,8,2,1

12,103,103,4,4,0,1,0
1,121,121,20,2,18,4,3
28,156,156,44,11,33,4,3
11,159,159,25,25,0,1,0
20,161,161,5,5,0,1,0
9,167,167,7,7,0,1,0
3,176,176,1,1,0,1,0
15,177,177,18,8,10,3,2
33,197,197,6,6,0,1,0
17,225,225,73,73,0,1,0
26,225,225,17,17,0,1,0
4,231,231,5,5,0,1,0
29,270,270,20,8,12,2,1
14,280,280,18,8,10,3,2
13,280,280,41,30,11,2,1
8,306,306,27,13,14,3,2
16,309,309,6,6,0,1,0
21,314,314,54,54,0,1,0
25,322,322,29,17,12,4,3
23,324,324,8,8,0,1,0
22,326,326,19,13,6,3,2
7,326,326,36,9,27,2,1
24,329,329,41,29,12,2,1
31,332,332,12,12,0,1,0
10,339,339,18,18,0,1,0
6,342,342,31,31,0,1,0
0,357,357,48,48,0,1,0
19,376,376,21,21,0,1,0
27,385,385,110,110,0,1,0
32,395,395,10,10,0,1,0
2,402,402,13,13,0,1,0
5,412,412,2,2,0,1,0
30,434,434,47,47,0,1,0
18,439,439,67,50,17,2,1

11,114,114,31,18,13,2,1
13,134,134,10,6,4,2,1
7,147,147,1,1,0,1,0
22,159,159,5,5,0,1,0
1,174,174,60,10,50,3,2
6,196,196,8,4,4,2,1
0,197,197,28,28,0,1,0
23,205,205,31,26,5,2,1
4,207,207,66,28,38,3,2
5,229,229,10,10,0,1,0
16,248,248,13,7,6,2,1
3,254,254,46,46,0,1,0
2,256,256,11,11,0,1,0
9,282,282,22,22,0,1,0
25,284,284,66,66,0,1,0
20,297,297,14,2,12,3,2
19,304,304,3,3,0,1,0
10,316,316,20,20,0,1,0
21,323,323,28,19,9,4,3
18,363,363,24,24,0,1,0
26,388,388,81,81,0,1,0
12,398,398,3,3,0,1,0
17,447,447,79,38,41,2,1
15,466,466,31,31,0,1,0
27,466,466,51,51,0,1,0
28,470,470,44,44,0,1,0
8,482,482,28,1,27,4,3
24,484,484,48,34,14,3,2
14,499,499,60,42,18,3,2

6,107,107,7,4,3,2,1
5,134,134,35,13,22,3,2
10,166,166,14,14,0,1,0
26,171,171,4,1,3,2,1
22,182,182,24,24,0,1,0
28,208,208,31,3,28,3,2
20,224,224,16,6,10,2,1
0,254,254,17,7,10,2,1
14,257,257,13,13,0,1,0
15,262,262,26,26,0,1,0
12,264,264,177,165,12,4,3
16,268,268,26,4,22,3,2
19,283,283,25,25,0,1,0
21,288,288,78,37,41,2,1
1,299,299,13,13,0,1,0
11,300,300,3,3,0,1,0
24,304,304,13,13,0,1,0
2,304,304,18,18,0,1,0
27,317,317,10,10,0,1,0
23,368,368,82,82,0,1,0
7,370,370,17,1,16,3,2
13,381,381,6,1,5,2,1
18,421,421,30,30,0,1,0
17,423,423,51,51,0,1,0
25,457,457,23,8,15,2,1
3,462,462,22,22,0,1,0
29,466,466,50,50,0,1,0
8,473,473,44,44,0,1,0
4,475,475,51,10,41,3,2
9,498,498,15,15,0,1,0

16,106,106,2,2,0,1,0
9,123,123,21,21,0,1,0
21,132,132,2,2,0,1,0
30,134,134,11,11,0,1,0
38,162,162,46,42,4,2,1
20,168,168,3,3,0,1,0
17,171,171,3,3,0,1,0
31,172,172,16,16,0,1,0
10,186,186,10,10,0,1,0
34,208,208,7,1,6,2,1
25,225,225,24,6,18,2,1
22,235,235,2,2,0,1,0
15,236,236,6,6,0,1,0
33,240,240,3,3,0,1,0
5,243,243,1,1,0,1,0
19,251,251,18,2,16,3,2
1,252,252,19,3,16,2,1
12,265,265,1,1,0,1,0
0,271,271,26,26,0,1,0
24,284,284,6,6,0,1,0
35,288,288,39,39,0,1,0
6,312,312,12,2,10,3,2
8,314,314,1,1,0,1,0
3,331,331,41,38,3,2,1
2,336,336,27,27,0,1,0
36,355,355,32,4,28,3,2
7,376,376,38,38,0,1,0
39,384,384,99,15,84,3,2
29,389,389,28,4,24,2,1
18,393,393,101,101,0,1,0
26,401,401,26,26,0,1,0
37,407,407,48,48,0,1,0
11,419,419,77,77,0,1,0
14,430,430,60,4,56,3,2
27,435,435,13,13,0,1,0
23,448,448,7,4,3,2,1
32,452,452,5,5,0,1,0
13,468,468,33,21,12,4,3
28,495,495,109,49,60,3,2
4,500,500,5,5,0,1,0

30,109,109,6,6,0,1,0
16,122,122,10,10,0,1,0
0,158,158,23,23,0,1,0
19,158,158,26,26,0,1,0
20,191,191,3,3,0,1,0
31,199,199,31,10,21,4,3
34,211,211,2,2,0,1,0
32,217,217,31,16,15,2,1
29,230,230,15,15,0,1,0
11,273,273,64,32,32,2,1
17,279,279,42,42,0,1,0
24,298,298,50,50,0,1,0
23,317,317,15,15,0,1,0
22,328,328,4,4,0,1,0
13,330,330,16,16,0,1,0
3,346,346,19,19,0,1,0
12,346,346,9,1,8,2,1
10,349,349,2,2,0,1,0
15,355,355,17,2,15,4,3
9,356,356,10,10,0,1,0
6,358,358,1,1,0,1,0
4,396,396,54,6,48,2,1
33,409,409,28,4,24,4,3
25,415,415,55,31,24,3,2
8,418,418,15,15,0,1,0
2,433,433,44,25,19,2,1
27,461,461,29,29,0,1,0
7,463,463,76,4,72,3,2
28,471,471,55,41,14,2,1
18,477,477,8,5,3,2,1
26,481,481,77,53,24,3,2
1,488,488,14,14,0,1,0
14,496,496,116,106,10,4,3
21,497,497,126,105,21,4,3
5,499,499,29,2,27,2,1

4,108,108,2,2,0,1,0
2,121,121,6,2,4,2,1
9,134,134,7,7,0,1,0
27,141,141,16,16,0,1,0
23,148,148,6,6,0,1,0
18,174,174,5,5,0,1,0
6,185,185,17,17,0,1,0
22,191,191,12,4,8,3,2
34,202,202,8,2,6,2,1
30,216,216,26,7,19,4,3
19,225,225,3,3,0,1,0
29,232,232,4,4,0,1,0
21,240,240,30,30,0,1,0
24,246,246,29,1,28,2,1
16,270,270,36,36,0,1,0
7,295,295,27,6,21,4,3
3,304,304,120,120,0,1,0
15,323,323,86,32,54,3,2
33,334,334,83,55,28,3,2
14,334,334,1,1,0,1,0
0,342,342,3,3,0,1,0
31,354,354,19,19,0,1,0
13,355,355,2,2,0,1,0
26,356,356,12,12,0,1,0
1,371,371,1,1,0,1,0
8,383,383,1,1,0,1,0
25,391,391,109,86,23,2,1
28,391,391,96,96,0,1,0
32,400,400,28,28,0,1,0
20,403,403,8,2,6,2,1
35,404,404,19,19,0,1,0
10,430,430,109,109,0,1,0
17,432,432,14,14,0,1,0
12,452,452,11,11,0,1,0
36,455,455,8,5,3,2,1
11,485,485,52,52,0,1,0
5,487,487,1,1,0,1,0

5,103,103,9,9,0,1,0
19,105,105,22,22,0,1,0
27,106,106,5,5,0,1,0
15,108,108,33,13,20,3,2
6,151,151,7,3,4,2,1
9,156,156,7,7,0,1,0
11,163,163,8,2,6,3,2
18,168,168,9,9,0,1,0
1,177,177,44,8,36,2,1
22,182,182,9,9,0,1,0
25,195,195,18,6,12,4,3
20,245,245,4,4,0,1,0
16,253,253,10,10,0,1,0
8,291,291,70,42,28,2,1
24,295,295,17,17,0,1,0
29,298,298,10,10,0,1,0
0,320,320,32,5,27,4,3
21,333,333,16,16,0,1,0
10,337,337,38,4,34,2,1
17,354,354,50,50,0,1,0
3,385,385,16,16,0,1,0
7,389,389,95,47,48,3,2
28,402,402,54,41,13,2,1
12,417,417,10,10,0,1,0
4,419,419,32,32,0,1,0
14,440,440,2,2,0,1,0
23,444,444,30,3,27,4,3
2,447,447,33,33,0,1,0
13,473,473,98,11,87,4,3
30,482,482,78,78,0,1,0
26,487,487,89,53,36,3,2

21,138,138,7,7,0,1,0
7,144,144,49,49,0,1,0
2,164,164,5,5,0,1,0
25,184,184,6,6,0,1,0
14,200,200,9,9,0,1,0
6,204,204,66,16,50,2,1
5,240,240,9,9,0,1,0
24,254,254,23,23,0,1,0
15,268,268,29,6,23,2,1
20,307,307,107,30,77,4,3
0,325,325,12,12,0,1,0
16,352,352,17,17,0,1,0
8,355,355,133,75,58,3,2
19,369,369,22,11,11,2,1
18,369,369,10,10,0,1,0
3,381,381,100,8,92,3,2
17,418,418,16,4,12,3,2
4,424,424,44,44,0,1,0
11,434,434,118,113,5,2,1
23,455,455,137,99,38,3,2
9,465,465,32,32,0,1,0
12,466,466,7,7,0,1,0
13,484,484,9,9,0,1,0
1,487,487,11,11,0,1,0
10,489,489,22,1,21,2,1
22,498,498,59,59,0,1,0

24,108,108,15,5,10,2,1
8,109,109,2,2,0,1,0
30,115,115,4,4,0,1,0
19,115,115,10,10,0,1,0
31,185,185,3,3,0,1,0
1,198,198,4,4,0,1,0
12,210,210,48,6,42,2,1
6,216,216,2,2,0,1,0
27,234,234,44,44,0,1,0
21,251,251,31,23,8,3,2
13,261,261,1,1,0,1,0
29,272,272,12,7,5,2,1
11,276,276,13,13,0,1,0
16,280,280,12,6,6,3,2
2,291,291,4,4,0,1,0
25,302,302,2,2,0,1,0
4,322,322,60,60,0,1,0
28,323,323,30,30,0,1,0
23,323,323,141,65,76,3,2
18,325,325,70,70,0,1,0
17,336,336,33,33,0,1,0
7,348,348,27,27,0,1,0
10,349,349,56,32,24,3,2
22,354,354,8,8,0,1,0
15,359,359,43,5,38,2,1
14,390,390,94,94,0,1,0
5,420,420,33,9,24,2,1
20,440,440,34,16,18,2,1
26,444,444,5,5,0,1,0
9,460,460,10,6,4,2,1
0,466,466,64,42,22,2,1
3,486,486,116,34,82,4,3

6,134,134,13,2,11,2,1
3,149,149,33,8,25,2,1
19,168,168,1,1,0,1,0
0,179,179,32,10,22,2,1
15,192,192,8,8,0,1,0
14,196,196,19,1,18,2,1
7,198,198,3,3,0,1,0
8,210,210,38,28,10,3,2
26,211,211,77,77,0,1,0
2,225,225,12,12,0,1,0
27,255,255,23,23,0,1,0
20,258,258,13,13,0,1,0
16,265,265,23,23,0,1,0
1,269,269,21,21,0,1,0
21,301,301,107,87,20,2,1
22,313,313,5,5,0,1,0
10,387,387,40,40,0,1,0
13,387,387,53,53,0,1,0
5,391,391,72,42,30,4,3
12,392,392,7,7,0,1,0
11,403,403,5,5,0,1,0
17,424,424,3,3,0,1,0
4,426,426,53,50,3,2,1
25,444,444,12,12,0,1,0
18,462,462,20,20,0,1,0
24,462,462,81,13,68,4,3
23,467,467,50,50,0,1,0
9,486,486,171,153,18,3,2

11,111,111,2,2,0,1,0
37,141,141,8,8,0,1,0
17,175,175,13,13,0,1,0
4,176,176,23,23,0,1,0
21,189,189,23,23,0,1,0
31,200,200,4,4,0,1,0
7,205,205,6,6,0,1,0
13,214,214,57,42,15,4,3
22,216,216,17,17,0,1,0
38,225,225,3,3,0,1,0
34,230,230,3,3,0,1,0
9,234,234,1,1,0,1,0
5,235,235,1,1,0,1,0
29,247,247,13,4,9,4,3
36,247,247,9,9,0,1,0
24,248,248,14,14,0,1,0
20,261,261,15,15,0,1,0
40,275,275,136,136,0,1,0
6,283,283,5,5,0,1,0
33,284,284,28,28,0,1,0
25,288,288,15,15,0,1,0
23,291,291,9,9,0,1,0
1,315,315,21,21,0,1,0
10,340,340,28,14,14,2,1
2,343,343,28,28,0,1,0
3,353,353,37,5,32,2,1
8,359,359,5,5,0,1,0
19,367,367,10,10,0,1,0
18,370,370,19,7,12,2,1
15,401,401,33,17,16,3,2
12,410,410,2,2,0,1,0
14,413,413,30,5,25,3,2
39,416,416,2,2,0,1,0
26,428,428,90,80,10,3,2
0,429,429,25,25,0,1,0
28,459,459,133,57,76,3,2
32,468,468,53,39,14,2,1
16,484,484,7,4,3,2,1
27,486,486,15,15,0,1,0
41,487,487,80,36,44,3,2
35,492,492,11,1,10,2,1
30,500,500,3,3,0,1,0

14,108,108,6,6,0,1,0
29,111,111,5,1,4,2,1
19,125,125,15,6,9,2,1
16,134,134,13,13,0,1,0
23,142,142,19,8,11,2,1
2,148,148,1,1,0,1,0
24,155,155,17,9,8,3,2
34,162,162,3,3,0,1,0
30,205,205,49,1,48,4,3
1,256,256,7,7,0,1,0
15,271,271,1,1,0,1,0
18,293,293,7,2,5,2,1
36,294,294,24,24,0,1,0
31,301,301,48,13,35,2,1
13,309,309,14,4,10,2,1
26,320,320,7,7,0,1,0
9,327,327,5,2,3,2,1
35,328,328,6,2,4,2,1
33,334,334,39,30,9,2,1
7,337,337,38,38,0,1,0
11,347,347,73,27,46,3,2
21,365,365,116,116,0,1,0
25,382,382,48,26,22,2,1
8,398,398,8,1,7,2,1
20,398,398,14,8,6,3,2
17,400,400,30,8,22,3,2
12,409,409,82,82,0,1,0
6,422,422,6,6,0,1,0
22,425,425,4,1,3,2,1
5,430,430,118,118,0,1,0
10,430,430,45,45,0,1,0
28,438,438,44,19,25,2,1
27,457,457,39,39,0,1,0
0,458,458,11,11,0,1,0
4,458,458,27,27,0,1,0
3,471,471,36,17,19,2,1
32,492,492,29,9,20,3,2

1,112,112,24,6,18,2,1
4,119,119,2,2,0,1,0
25,129,129,17,4,13,4,3
24,149,149,26,26,0,1,0
0,172,172,11,11,0,1,0
23,172,172,41,1,40,2,1
21,175,175,5,5,0,1,0
9,190,190,83,83,0,1,0
16,243,243,19,6,13,2,1
27,250,250,6,6,0,1,0
11,263,263,6,6,0,1,0
15,263,263,35,23,12,2,1
7,289,289,19,7,12,4,3
2,301,301,42,42,0,1,0
22,320,320,71,71,0,1,0
3,344,344,69,39,30,3,2
18,353,353,26,5,21,2,1
20,362,362,1,1,0,1,0
13,377,377,20,4,16,3,2
12,407,407,43,7,36,3,2
5,420,420,22,10,12,3,2
19,421,421,18,10,8,3,2
17,439,439,19,13,6,3,2
6,445,445,68,68,0,1,0
8,478,478,17,3,14,3,2
10,479,479,96,96,0,1,0
14,486,486,20,5,15,4,3
26,496,496,119,119,0,1,0

10,101,101,22,22,0,1,0
12,114,114,8,8,0,1,0
15,126,126,16,16,0,1,0
18,129,129,4,1,3,2,1
14,130,130,18,18,0,1,0
28,157,157,43,43,0,1,0
11,161,161,1,1,0,1,0
8,162,162,1,1,0,1,0
7,198,198,4,4,0,1,0
19,207,207,9,9,0,1,0
21,247,247,14,14,0,1,0
22,249,249,5,5,0,1,0
9,291,291,56,56,0,1,0
23,293,293,4,4,0,1,0
5,302,302,10,10,0,1,0
13,310,310,7,7,0,1,0
26,315,315,35,35,0,1,0
34,326,326,36,36,0,1,0
33,336,336,2,2,0,1,0
3,338,338,21,21,0,1,0
17,342,342,20,16,4,2,1
16,350,350,13,13,0,1,0
32,372,372,37,16,21,2,1
29,377,377,124,20,104,4,3
25,380,380,23,13,10,3,2
6,381,381,106,4,102,4,3
30,396,396,48,48,0,1,0
0,426,426,118,118,0,1,0
2,426,426,1,1,0,1,0
31,441,441,2,2,0,1,0
24,463,463,99,99,0,1,0
1,467,467,2,2,0,1,0
27,478,478,70,36,34,2,1
20,488,488,9,3,6,2,1
4,498,498,10,1,9,4,3

6,106,106,19,5,14,2,1
21,138,138,22,13,9,4,3
1,139,139,7,4,3,2,1
3,147,147,5,5,0,1,0
11,175,175,28,13,15,4,3
26,185,185,25,9,16,2,1
24,205,205,4,4,0,1,0
23,217,217,9,9,0,1,0
25,236,236,32,4,28,2,1
12,242,242,75,75,0,1,0
14,244,244,23,1,22,3,2
19,245,245,2,2,0,1,0
0,255,255,12,9,3,2,1
18,262,262,61,17,44,3,2
2,271,271,1,1,0,1,0
16,290,290,23,23,0,1,0
7,334,334,2,2,0,1,0
8,340,340,14,2,12,4,3
27,357,357,32,24,8,2,1
17,388,388,7,1,6,3,2
20,402,402,8,8,0,1,0
15,425,425,108,24,84,3,2
9,430,430,230,230,0,1,0
5,430,430,41,22,19,2,1
10,436,436,16,7,9,2,1
13,441,441,78,32,46,2,1
4,442,442,46,4,42,2,1
28,444,444,33,24,9,2,1
22,449,449,36,27,9,2,1

20,114,114,9,9,0,1,0
22,138,138,21,14,7,2,1
15,156,156,1,1,0,1,0
27,164,164,21,21,0,1,0
10,172,172,40,37,3,2,1
3,187,187,7,7,0,1,0
8,187,187,2,2,0,1,0
19,196,196,29,29,0,1,0
7,199,199,20,20,0,1,0
18,207,207,2,2,0,1,0
4,242,242,57,57,0,1,0
1,246,246,74,74,0,1,0
14,249,249,21,13,8,2,1
6,249,249,23,23,0,1,0
12,284,284,7,7,0,1,0
24,313,313,39,39,0,1,0
13,319,319,61,61,0,1,0
2,321,321,33,33,0,1,0
21,341,341,2,2,0,1,0
23,347,347,7,3,4,2,1
0,348,348,41,41,0,1,0
5,363,363,20,8,12,4,3
16,399,399,47,28,19,2,1
28,447,447,147,144,3,2,1
25,459,459,19,19,0,1,0
17,465,465,66,22,44,2,1
9,488,488,120,66,54,3,2
11,495,495,23,23,0,1,0
26,497,497,32,32,0,1,0

19,103,103,16,3,13,2,1
30,115,115,7,7,0,1,0
26,138,138,16,16,0,1,0
13,139,139,1,1,0,1,0
27,172,172,8,5,3,2,1
35,187,187,6,6,0,1,0
24,194,194,9,1,8,2,1
17,201,201,24,12,12,3,2
16,209,209,5,5,0,1,0
18,220,220,43,8,35,2,1
12,229,229,13,13,0,1,0
2,241,241,8,3,5,2,1
22,242,242,24,24,0,1,0
14,244,244,26,11,15,2,1
33,245,245,2,2,0,1,0
1,286,286,34,34,0,1,0
32,286,286,12,3,9,2,1
28,295,295,10,10,0,1,0
15,310,310,5,5,0,1,0
20,314,314,87,87,0,1,0
0,315,315,5,5,0,1,0
21,317,317,36,12,24,3,2
8,317,317,1,1,0,1,0
10,322,322,12,12,0,1,0
9,358,358,66,35,31,2,1
11,365,365,121,61,60,3,2
23,368,368,58,54,4,2,1
6,369,369,5,5,0,1,0
25,391,391,52,3,49,2,1
4,399,399,10,10,0,1,0
3,430,430,16,16,0,1,0
5,436,436,40,24,16,2,1
31,442,442,65,38,27,4,3
29,470,470,135,135,0,1,0
34,477,477,11,8,3,2,1
7,480,480,15,3,12,3,2

3,129,129,20,5,15,4,3
25,147,147,17,17,0,1,0
22,151,151,31,31,0,1,0
19,158,158,1,1,0,1,0
23,199,199,47,6,41,2,1
28,226,226,6,3,3,2,1
0,244,244,9,4,5,2,1
1,270,270,26,26,0,1,0
27,272,272,5,5,0,1,0
18,295,295,30,6,24,4,3
29,298,298,4,4,0,1,0
2,308,308,9,5,4,2,1
21,308,308,40,17,23,3,2
8,324,324,8,8,0,1,0
33,327,327,8,8,0,1,0
26,336,336,34,18,16,3,2
16,354,354,33,10,23,2,1
10,360,360,12,6,6,3,2
6,368,368,27,12,15,4,3
14,373,373,124,124,0,1,0
7,375,375,51,51,0,1,0
13,376,376,3,3,0,1,0
4,387,387,45,45,0,1,0
9,390,390,3,3,0,1,0
15,399,399,21,3,18,4,3
32,403,403,63,16,47,2,1
24,411,411,2,2,0,1,0
12,411,411,30,30,0,1,0
20,418,418,43,36,7,2,1
11,435,435,40,22,18,2,1
5,443,443,35,35,0,1,0
30,453,453,118,118,0,1,0
31,459,459,57,57,0,1,0
17,483,483,78,34,44,3,2

28,105,105,18,18,0,1,0
33,107,107,18,5,13,4,3
27,129,129,7,1,6,2,1
7,132,132,19,9,10,2,1
1,132,132,4,4,0,1,0
5,150,150,55,28,27,4,3
14,183,183,14,8,6,2,1
6,208,208,2,2,0,1,0
9,213,213,1,1,0,1,0
20,220,220,6,6,0,1,0
25,227,227,29,12,17,2,1
16,256,256,9,5,4,2,1
26,263,263,22,22,0,1,0
32,269,269,4,4,0,1,0
23,298,298,72,68,4,2,1
11,309,309,30,6,24,3,2
10,309,309,12,12,0,1,0
13,316,316,12,12,0,1,0
12,319,319,29,29,0,1,0
19,323,323,34,34,0,1,0
17,339,339,8,3,5,2,1
8,355,355,25,25,0,1,0
0,365,365,3,3,0,1,0
34,393,393,46,2,44,2,1
31,419,419,128,40,88,3,2
18,424,424,4,4,0,1,0
2,437,437,48,2,46,2,1
29,442,442,9,9,0,1,0
3,445,445,147,147,0,1,0
30,446,446,23,23,0,1,0
4,447,447,39,21,18,2,1
24,465,465,3,3,0,1,0
22,476,476,57,11,46,3,2
15,490,490,15,15,0,1,0
21,499,499,12,3,9,3,2

33,103,103,18,11,7,2,1
18,104,104,17,17,0,1,0
13,105,105,9,1,8,2,1
35,112,112,22,3,19,2,1
11,114,114,2,2,0,1,0
25,117,117,41,41,0,1,0
16,137,137,10,10,0,1,0
24,148,148,30,30,0,1,0
14,167,167,2,2,0,1,0
15,173,173,4,4,0,1,0
29,176,176,19,11,8,3,2
2,193,193,34,34,0,1,0
12,196,196,36,36,0,1,0
5,198,198,5,5,0,1,0
3,203,203,25,25,0,1,0
34,203,203,4,4,0,1,0
10,209,209,16,16,0,1,0
6,214,214,1,1,0,1,0
28,217,217,28,12,16,2,1
0,244,244,45,45,0,1,0
23,250,250,10,10,0,1,0
32,263,263,11,3,8,2,1
17,311,311,34,25,9,4,3
19,314,314,2,2,0,1,0
20,316,316,32,32,0,1,0
30,316,316,18,18,0,1,0
22,355,355,12,12,0,1,0
27,375,375,14,6,8,2,1
8,384,384,25,1,24,4,3
26,436,436,14,14,0,1,0
31,446,446,24,24,0,1,0
1,449,449,11,11,0,1,0
7,472,472,66,2,64,3,2
4,475,475,2,2,0,1,0
9,478,478,1,1,0,1,0
21,486,486,60,54,6,2,1
36,499,499,14,3,11,2,1

28,124,124,9,4,5,2,1
4,129,129,4,4,0,1,0
22,138,138,18,18,0,1,0
17,162,162,44,6,38,2,1
9,165,165,9,9,0,1,0
8,170,170,13,13,0,1,0
20,178,178,2,2,0,1,0
33,179,179,4,4,0,1,0
3,185,185,1,1,0,1,0
31,197,197,5,5,0,1,0
23,229,229,79,79,0,1,0
16,229,229,1,1,0,1,0
13,233,233,38,33,5,2,1
21,241,241,39,4,35,4,3
15,249,249,1,1,0,1,0
7,258,258,6,6,0,1,0
24,260,260,18,18,0,1,0
29,267,267,8,8,0,1,0
18,272,272,26,26,0,1,0
26,275,275,35,19,16,2,1
32,287,287,24,24,0,1,0
14,287,287,8,2,6,3,2
6,314,314,115,94,21,4,3
10,326,326,76,54,22,2,1
34,331,331,15,7,8,3,2
27,362,362,63,20,43,2,1
5,365,365,6,6,0,1,0
19,373,373,103,96,7,2,1
1,390,390,41,7,34,3,2
11,391,391,17,14,3,2,1
25,427,427,8,8,0,1,0
2,439,439,16,11,5,2,1
0,454,454,14,11,3,2,1
30,490,490,21,21,0,1,0
12,493,493,6,2,4,2,1

6,126,126,16,16,0,1,0
9,126,126,11,2,9,2,1
26,134,134,12,7,5,2,1
20,141,141,1,1,0,1,0
21,143,143,11,11,0,1,0
14,144,144,1,1,0,1,0
15,146,146,30,8,22,2,1
2,156,156,17,8,9,4,3
29,178,178,6,6,0,1,0
18,187,187,11,2,9,4,3
5,196,196,36,36,0,1,0
33,204,204,29,29,0,1,0
32,246,246,42,24,18,4,3
0,277,277,1,1,0,1,0
31,291,291,57,57,0,1,0
37,293,293,36,36,0,1,0
13,309,309,42,33,9,2,1
28,320,320,23,14,9,2,1
3,331,331,31,5,26,3,2
30,336,336,3,3,0,1,0
38,344,344,27,27,0,1,0
34,344,344,41,23,18,4,3
19,371,371,17,7,10,2,1
16,372,372,1,1,0,1,0
36,386,386,6,6,0,1,0
24,388,388,38,10,28,3,2
35,393,393,56,25,31,2,1
4,414,414,1,1,0,1,0
7,423,423,32,4,28,2,1
12,426,426,46,26,20,3,2
11,440,440,11,11,0,1,0
17,457,457,6,6,0,1,0
10,463,463,15,15,0,1,0
22,480,480,72,72,0,1,0
8,480,480,1,1,0,1,0
23,483,483,54,45,9,4,3
27,493,493,71,9,62,3,2
1,495,495,24,8,16,2,1
25,499,499,41,29,12,2,1

8,122,122,1,1,0,1,0
23,135,135,8,8,0,1,0
1,137,137,7,3,4,2,1
26,143,143,5,5,0,1,0
0,163,163,6,6,0,1,0
13,182,182,81,39,42,2,1
7,192,192,9,2,7,2,1
5,195,195,18,10,8,3,2
6,201,201,33,4,29,2,1
4,217,217,8,8,0,1,0
24,219,219,1,1,0,1,0
34,220,220,5,5,0,1,0
16,239,239,36,36,0,1,0
20,250,250,6,6,0,1,0
11,252,252,35,35,0,1,0
22,268,268,2,2,0,1,0
12,269,269,18,18,0,1,0
10,271,271,1,1,0,1,0
18,273,273,15,15,0,1,0
27,285,285,23,14,9,2,1
33,288,288,17,17,0,1,0
19,290,290,69,69,0,1,0
30,300,300,60,60,0,1,0
31,318,318,65,29,36,3,2
14,337,337,20,20,0,1,0
29,339,339,24,24,0,1,0
32,374,374,113,113,0,1,0
25,382,382,20,20,0,1,0
28,393,393,49,49,0,1,0
15,407,407,4,1,3,2,1
17,446,446,5,1,4,2,1
21,451,451,66,59,7,2,1
9,466,466,7,7,0,1,0
3,480,480,77,59,18,2,1
2,491,491,24,4,20,2,1

30,116,116,1,1,0,1,0
4,131,131,1,1,0,1,0
6,171,171,64,21,43,2,1
17,171,171,16,2,14,2,1
5,172,172,3,3,0,1,0
19,191,191,58,20,38,2,1
26,200,200,4,4,0,1,0
18,207,207,5,5,0,1,0
10,223,223,9,6,3,2,1
9,225,225,18,14,4,2,1
16,226,226,74,63,11,2,1
29,249,249,22,22,0,1,0
23,256,256,4,4,0,1,0
25,263,263,65,30,35,2,1
3,269,269,28,28,0,1,0
24,273,273,37,19,18,2,1
21,295,295,12,4,8,3,2
12,321,321,181,143,38,3,2
11,357,357,33,33,0,1,0
28,384,384,22,22,0,1,0
20,401,401,40,40,0,1,0
27,419,419,4,4,0,1,0
1,422,422,21,17,4,2,1
15,425,425,30,12,18,4,3
8,445,445,15,15,0,1,0
14,453,453,8,8,0,1,0
0,459,459,28,28,0,1,0
7,463,463,1,1,0,1,0
22,482,482,40,40,0,1,0
2,485,485,15,15,0,1,0
13,486,486,61,61,0,1,0

24,118,118,10,10,0,1,0
8,123,123,4,4,0,1,0
7,126,126,1,1,0,1,0
27,161,161,10,10,0,1,0
10,185,185,58,58,0,1,0
23,193,193,24,24,0,1,0
29,195,195,15,15,0,1,0
4,197,197,8,8,0,1,0
17,204,204,61,25,36,2,1
2,252,252,21,1,20,3,2
19,259,259,23,9,14,3,2
6,273,273,59,15,44,2,1
13,291,291,61,61,0,1,0
14,323,323,11,1,10,3,2
28,325,325,98,76,22,3,2
22,354,354,2,2,0,1,0
9,374,374,61,61,0,1,0
5,379,379,148,120,28,2,1
20,379,379,18,18,0,1,0
26,382,382,28,17,11,2,1
1,393,393,3,3,0,1,0
11,404,404,10,10,0,1,0
16,417,417,19,19,0,1,0
15,423,423,9,9,0,1,0
25,433,433,104,18,86,3,2
0,434,434,2,2,0,1,0
3,451,451,9,9,0,1,0
21,474,474,42,42,0,1,0
18,476,476,19,14,5,2,1
12,476,476,42,34,8,3,2

12,106,106,17,17,0,1,0
8,113,113,1,1,0,1,0
2,121,121,18,3,15,4,3
19,147,147,19,6,13,2,1
15,147,147,1,1,0,1,0
25,147,147,7,1,6,2,1
20,149,149,11,11,0,1,0
13,174,174,12,9,3,2,1
5,175,175,28,8,20,2,1
17,189,189,7,7,0,1,0
29,227,227,66,40,26,3,2
10,258,258,13,13,0,1,0
23,267,267,7,7,0,1,0
16,274,274,54,54,0,1,0
4,274,274,6,6,0,1,0
18,275,275,9,3,6,3,2
31,283,283,10,10,0,1,0
7,292,292,3,3,0,1,0
21,312,312,18,18,0,1,0
27,334,334,82,82,0,1,0
36,347,347,88,1,87,4,3
3,347,347,1,1,0,1,0
32,350,350,37,4,33,2,1
24,352,352,16,16,0,1,0
26,358,358,44,29,15,4,3
34,358,358,19,19,0,1,0
6,371,371,25,13,12,4,3
0,375,375,64,28,36,4,3
35,404,404,15,12,3,2,1
1,411,411,23,23,0,1,0
33,413,413,2,2,0,1,0
28,424,424,66,21,45,4,3
14,434,434,3,3,0,1,0
11,434,434,79,49,30,4,3
9,447,447,5,5,0,1,0
22,475,475,63,63,0,1,0
30,495,495,4,1,3,2,1

14,110,110,11,11,0,1,0
2,122,122,14,14,0,1,0
22,126,126,32,16,16,2,1
30,186,186,48,36,12,3,2
7,205,205,1,1,0,1,0
19,208,208,1,1,0,1,0
0,242,242,9,5,4,2,1
21,258,258,12,2,10,2,1
16,272,272,4,1,3,2,1
9,274,274,16,4,12,2,1
11,281,281,56,4,52,3,2
35,295,295,22,13,9,2,1
18,312,312,41,6,35,4,3
1,327,327,3,3,0,1,0
23,334,334,18,18,0,1,0
24,342,342,7,7,0,1,0
31,345,345,9,9,0,1,0
33,350,350,14,14,0,1,0
17,350,350,1,1,0,1,0
36,363,363,27,1,26,3,2
15,369,369,51,51,0,1,0
5,377,377,44,35,9,4,3
29,397,397,20,20,0,1,0
10,403,403,4,1,3,2,1
4,412,412,152,93,59,4,3
26,415,415,103,49,54,3,2
28,421,421,25,17,8,3,2
13,426,426,5,5,0,1,0
12,432,432,21,21,0,1,0
8,438,438,1,1,0,1,0
3,440,440,3,3,0,1,0
20,440,440,35,4,31,4,3
32,452,452,47,35,12,4,3
34,466,466,92,92,0,1,0
6,469,469,66,41,25,2,1
25,480,480,28,28,0,1,0
27,494,494,28,22,6,2,1

14,101,101,16,16,0,1,0
32,117,117,5,5,0,1,0
12,120,120,5,1,4,2,1
5,131,131,11,11,0,1,0
16,153,153,11,11,0,1,0
6,165,165,1,1,0,1,0
30,187,187,47,47,0,1,0
8,191,191,56,56,0,1,0
10,222,222,1,1,0,1,0
11,270,270,32,17,15,4,3
27,270,270,61,61,0,1,0
0,271,271,54,8,46,3,2
19,278,278,21,11,10,3,2
4,296,296,8,2,6,2,1
29,302,302,47,47,0,1,0
24,308,308,20,11,9,2,1
7,314,314,28,28,0,1,0
20,335,335,59,59,0,1,0
25,356,356,43,1,42,4,3
26,367,367,18,18,0,1,0
28,379,379,11,11,0,1,0
3,385,385,88,88,0,1,0
15,386,386,4,4,0,1,0
31,411,411,8,8,0,1,0
13,417,417,45,45,0,1,0
23,425,425,75,24,51,4,3
21,431,431,2,2,0,1,0
9,434,434,58,42,16,2,1
2,468,468,9,9,0,1,0
17,484,484,13,4,9,4,3
1,489,489,4,4,0,1,0
18,490,490,46,46,0,1,0
22,492,492,57,57,0,1,0

20,101,101,28,28,0,1,0
26,116,116,2,2,0,1,0
12,140,140,20,20,0,1,0
3,148,148,25,25,0,1,0
6,162,162,18,18,0,1,0
4,168,168,9,6,3,2,1
30,171,171,1,1,0,1,0
29,177,177,23,23,0,1,0
7,194,194,17,17,0,1,0
5,197,197,3,3,0,1,0
0,219,219,31,4,27,4,3
27,265,265,32,32,0,1,0
8,269,269,22,4,18,3,2
9,276,276,1,1,0,1,0
10,283,283,5,5,0,1,0
21,284,284,15,2,13,3,2
14,308,308,35,35,0,1,0
18,323,323,20,2,18,3,2
15,343,343,38,38,0,1,0
13,344,344,32,32,0,1,0
11,345,345,52,52,0,1,0
28,358,358,3,3,0,1,0
23,370,370,105,29,76,3,2
22,377,377,58,58,0,1,0
17,382,382,10,10,0,1,0
2,414,414,91,18,73,4,3
25,443,443,54,25,29,4,3
24,466,466,73,73,0,1,0
1,472,472,94,20,74,3,2
16,483,483,39,26,13,4,3
19,494,494,7,7,0,1,0

23,127,127,5,5,0,1,0
29,127,127,13,3,10,2,1
18,161,161,10,10,0,1,0
20,163,163,1,1,0,1,0
0,170,170,26,7,19,2,1
7,203,203,3,3,0,1,0
16,209,209,13,13,0,1,0
25,211,211,17,17,0,1,0
24,213,213,61,26,35,2,1
10,220,220,2,2,0,1,0
14,221,221,12,3,9,4,3
19,227,227,10,10,0,1,0
26,228,228,61,61,0,1,0
6,228,228,28,28,0,1,0
3,234,234,4,4,0,1,0
1,253,253,18,4,14,3,2
4,282,282,56,34,22,2,1
27,287,287,93,69,24,4,3
28,292,292,6,6,0,1,0
15,296,296,19,19,0,1,0
2,311,311,18,18,0,1,0
9,323,323,116,83,33,2,1
17,348,348,26,15,11,2,1
12,376,376,48,1,47,4,3
5,402,402,81,34,47,4,3
8,412,412,7,1,6,3,2
13,415,415,81,51,30,2,1
22,425,425,60,60,0,1,0
21,474,474,2,2,0,1,0
11,495,495,28,28,0,1,0

6,107,107,14,14,0,1,0
7,112,112,5,5,0,1,0
15,122,122,9,1,8,3,2
3,125,125,5,2,3,2,1
32,126,126,8,8,0,1,0
24,140,140,35,23,12,3,2
31,159,159,5,5,0,1,0
5,169,169,5,5,0,1,0
9,186,186,42,3,39,4,3
28,189,189,3,3,0,1,0
26,203,203,7,4,3,2,1
27,209,209,66,22,44,3,2
8,239,239,27,27,0,1,0
10,243,243,15,9,6,3,2
29,249,249,30,10,20,2,1
2,261,261,13,1,12,2,1
4,264,264,5,5,0,1,0
20,274,274,8,8,0,1,0
19,287,287,120,38,82,3,2
12,301,301,46,46,0,1,0
11,320,320,54,54,0,1,0
17,342,342,8,8,0,1,0
0,351,351,49,49,0,1,0
25,355,355,9,1,8,3,2
18,378,378,28,28,0,1,0
30,381,381,7,7,0,1,0
14,389,389,17,6,11,2,1
13,404,404,40,10,30,4,3
16,439,439,77,77,0,1,0
21,467,467,10,2,8,3,2
22,482,482,18,14,4,2,1
23,498,498,80,80,0,1,0
1,500,500,17,17,0,1,0

18,101,101,40,25,15,3,2
21,104,104,1,1,0,1,0
16,109,109,2,2,0,1,0
15,111,111,5,5,0,1,0
12,112,112,1,1,0,1,0
4,115,115,10,1,9,4,3
9,139,139,7,1,6,3,2
28,168,168,1,1,0,1,0
31,176,176,7,7,0,1,0
27,213,213,104,104,0,1,0
30,218,218,20,6,14,2,1
24,220,220,15,15,0,1,0
2,241,241,27,3,24,2,1
20,246,246,7,2,5,2,1
3,291,291,17,8,9,4,3
26,299,299,2,2,0,1,0
11,299,299,94,94,0,1,0
17,311,311,5,5,0,1,0
7,311,311,10,4,6,2,1
10,315,315,29,29,0,1,0
6,335,335,35,23,12,2,1
8,347,347,64,8,56,3,2
0,348,348,31,31,0,1,0
29,363,363,9,9,0,1,0
13,367,367,35,20,15,4,3
25,382,382,26,21,5,2,1
14,385,385,1,1,0,1,0
23,413,413,43,43,0,1,0
5,419,419,133,116,17,2,1
1,464,464,3,3,0,1,0
19,480,480,53,53,0,1,0
22,496,496,79,79,0,1,0

11,107,107,4,1,3,2,1
21,114,114,2,2,0,1,0
1,170,170,4,4,0,1,0
29,171,171,54,47,7,2,1
12,183,183,15,15,0,1,0
17,183,183,11,11,0,1,0
24,189,189,12,6,6,3,2
23,203,203,29,29,0,1,0
0,205,205,30,30,0,1,0
27,208,208,19,19,0,1,0
25,219,219,15,15,0,1,0
32,225,225,32,4,28,3,2
18,233,233,9,9,0,1,0
19,248,248,7,7,0,1,0
5,262,262,34,14,20,2,1
14,263,263,35,35,0,1,0
8,267,267,23,9,14,3,2
6,282,282,16,4,12,3,2
2,305,305,125,45,80,3,2
15,316,316,29,25,4,2,1
7,348,348,5,1,4,2,1
9,367,367,62,53,9,4,3
20,368,368,41,41,0,1,0
31,374,374,67,67,0,1,0
13,376,376,1,1,0,1,0
3,376,376,35,35,0,1,0
28,381,381,19,6,13,2,1
22,412,412,25,2,23,2,1
16,437,437,23,23,0,1,0
26,462,462,3,3,0,1,0
10,462,462,20,20,0,1,0
30,469,469,126,56,70,4,3
4,474,474,14,9,5,2,1

33,110,110,8,8,0,1,0
38,126,126,10,6,4,2,1
5,129,129,5,5,0,1,0
14,142,142,9,9,0,1,0
7,148,148,18,18,0,1,0
30,162,162,7,7,0,1,0
1,166,166,1,1,0,1,0
21,170,170,5,5,0,1,0
20,173,173,16,1,15,2,1
37,175,175,8,8,0,1,0
27,193,193,20,20,0,1,0
25,196,196,10,1,9,4,3
24,197,197,11,6,5,2,1
36,207,207,32,32,0,1,0
23,249,249,11,11,0,1,0
34,261,261,71,59,12,4,3
40,277,277,12,12,0,1,0
9,282,282,22,3,19,4,3
15,282,282,7,7,0,1,0
35,286,286,15,3,12,2,1
28,292,292,24,24,0,1,0
32,306,306,33,9,24,4,3
16,311,311,4,4,0,1,0
29,331,331,16,16,0,1,0
22,334,334,45,36,9,4,3
31,334,334,74,74,0,1,0
12,352,352,8,8,0,1,0
4,364,364,40,3,37,3,2
26,366,366,2,2,0,1,0
11,381,381,9,9,0,1,0
0,388,388,23,23,0,1,0
3,392,392,24,24,0,1,0
41,406,406,22,22,0,1,0
6,424,424,73,44,29,4,3
17,425,425,17,1,16,2,1
8,427,427,23,8,15,4,3
2,427,427,18,13,5,2,1
39,441,441,107,61,46,2,1
18,465,465,115,115,0,1,0
13,466,466,1,1,0,1,0
19,473,473,4,4,0,1,0
10,480,480,3,3,0,1,0

0,121,121,14,14,0,1,0
25,148,148,9,9,0,1,0
20,150,150,15,15,0,1,0
2,160,160,9,9,0,1,0
32,167,167,7,7,0,1,0
1,172,172,2,2,0,1,0
22,173,173,8,3,5,2,1
14,204,204,7,7,0,1,0
10,208,208,4,4,0,1,0
13,241,241,17,8,9,4,3
33,289,289,9,9,0,1,0
5,294,294,4,4,0,1,0
16,295,295,17,17,0,1,0
17,312,312,78,54,24,3,2
18,329,329,38,38,0,1,0
34,332,332,9,9,0,1,0
8,360,360,42,14,28,2,1
15,374,374,101,86,15,2,1
30,378,378,6,6,0,1,0
9,385,385,1,1,0,1,0
28,386,386,78,66,12,2,1
29,400,400,52,52,0,1,0
11,403,403,13,1,12,3,2
27,418,418,24,24,0,1,0
24,419,419,10,10,0,1,0
21,432,432,87,50,37,2,1
23,444,444,107,15,92,4,3
26,449,449,88,1,87,4,3
12,457,457,8,8,0,1,0
6,459,459,40,40,0,1,0
3,483,483,19,19,0,1,0
31,484,484,110,8,102,4,3
4,486,486,82,67,15,4,3
19,489,489,59,2,57,4,3
7,499,499,1,1,0,1,0
35,500,500,12,12,0,1,0

6,101,101,1,1,0,1,0
32,120,120,33,21,12,4,3
18,126,126,3,3,0,1,0
25,135,135,11,1,10,3,2
28,136,136,16,16,0,1,0
11,146,146,16,6,10,3,2
4,147,147,13,13,0,1,0
23,148,148,11,3,8,3,2
17,159,159,23,23,0,1,0
3,170,170,1,1,0,1,0
26,174,174,15,15,0,1,0
34,194,194,15,15,0,1,0
33,196,196,7,7,0,1,0
35,202,202,9,9,0,1,0
1,245,245,10,6,4,2,1
31,251,251,1,1,0,1,0
27,264,264,18,18,0,1,0
19,269,269,11,11,0,1,0
9,294,294,9,9,0,1,0
12,298,298,20,20,0,1,0
15,307,307,6,2,4,2,1
22,327,327,54,4,50,3,2
10,337,337,38,18,20,2,1
20,340,340,30,30,0,1,0
24,341,341,15,9,6,3,2
29,346,346,14,14,0,1,0
30,352,352,112,112,0,1,0
5,389,389,7,7,0,1,0
8,423,423,55,55,0,1,0
0,438,438,74,74,0,1,0
36,439,439,3,3,0,1,0
2,445,445,64,64,0,1,0
7,479,479,37,37,0,1,0
14,479,479,53,40,13,2,1
13,486,486,7,1,6,3,2
21,497,497,102,102,0,1,0
16,499,499,78,78,0,1,0

8,100,100,13,13,0,1,0
20,103,103,19,19,0,1,0
2,109,109,3,3,0,1,0
12,120,120,13,13,0,1,0
18,123,123,5,5,0,1,0
11,146,146,17,6,11,2,1
5,148,148,14,14,0,1,0
14,157,157,5,1,4,2,1
0,173,173,5,5,0,1,0
24,176,176,2,2,0,1,0
19,202,202,13,13,0,1,0
4,205,205,38,20,18,3,2
17,217,217,43,43,0,1,0
15,226,226,1,1,0,1,0
10,237,237,13,13,0,1,0
9,273,273,15,15,0,1,0
6,273,273,44,15,29,3,2
3,295,295,76,76,0,1,0
16,303,303,2,2,0,1,0
26,322,322,23,23,0,1,0
1,323,323,78,15,63,4,3
22,358,358,42,42,0,1,0
25,367,367,59,26,33,4,3
23,383,383,82,82,0,1,0
7,414,414,151,1,150,4,3
21,471,471,99,45,54,3,2
13,493,493,49,43,6,3,2

5,118,118,34,11,23,2,1
4,131,131,2,2,0,1,0
28,163,163,19,3,16,3,2
19,169,169,5,1,4,2,1
29,182,182,2,2,0,1,0
6,215,215,12,12,0,1,0
20,215,215,61,49,12,4,3
30,225,225,4,4,0,1,0
2,247,247,17,3,14,2,1
14,253,253,16,2,14,2,1
10,286,286,3,3,0,1,0
15,288,288,40,6,34,2,1
7,306,306,115,115,0,1,0
9,311,311,1,1,0,1,0
12,313,313,74,20,54,3,2
1,319,319,10,10,0,1,0
11,323,323,57,33,24,3,2
23,334,334,5,5,0,1,0
27,345,345,15,6,9,2,1
8,352,352,1,1,0,1,0
24,363,363,146,146,0,1,0
21,379,379,67,67,0,1,0
13,393,393,71,71,0,1,0
16,419,419,14,14,0,1,0
25,426,426,28,7,21,2,1
0,432,432,26,19,7,2,1
26,439,439,1,1,0,1,0
3,443,443,15,3,12,2,1
22,458,458,30,15,15,2,1
17,480,480,34,34,0,1,0
18,486,486,76,52,24,3,2

30,131,131,20,6,14,2,1
33,142,142,12,12,0,1,0
32,162,162,3,3,0,1,0
21,164,164,10,10,0,1,0
27,167,167,31,1,30,2,1
11,168,168,1,1,0,1,0
23,174,174,9,9,0,1,0
26,195,195,31,31,0,1,0
20,199,199,16,13,3,2,1
5,204,204,15,15,0,1,0
10,212,212,1,1,0,1,0
13,220,220,46,46,0,1,0
7,221,221,9,9,0,1,0
1,232,232,15,15,0,1,0
25,259,259,8,8,0,1,0
14,306,306,48,29,19,2,1
2,313,313,16,16,0,1,0
31,313,313,13,13,0,1,0
8,316,316,33,12,21,4,3
12,330,330,9,2,7,2,1
17,332,332,110,71,39,2,1
37,335,335,79,7,72,4,3
16,343,343,37,12,25,2,1
34,350,350,52,4,48,2,1
9,361,361,8,8,0,1,0
35,372,372,24,24,0,1,0
24,377,377,16,2,14,2,1
19,380,380,14,14,0,1,0
36,382,382,9,9,0,1,0
6,401,401,13,13,0,1,0
28,404,404,34,27,7,2,1
18,405,405,17,2,15,4,3
22,412,412,29,11,18,3,2
15,412,412,1,1,0,1,0
3,421,421,20,20,0,1,0
29,433,433,103,29,74,4,3
4,434,434,18,10,8,3,2
0,494,494,28,28,0,1,0

0,100,100,2,2,0,1,0
23,115,115,5,5,0,1,0
22,126,126,2,2,0,1,0
13,131,131,7,7,0,1,0
3,159,159,7,3,4,2,1
18,159,159,12,12,0,1,0
26,160,160,27,27,0,1,0
30,175,175,31,10,21,4,3
31,177,177,39,39,0,1,0
28,181,181,3,3,0,1,0
11,189,189,11,11,0,1,0
8,193,193,14,5,9,4,3
2,209,209,22,8,14,3,2
5,237,237,12,6,6,2,1
32,247,247,30,2,28,2,1
10,273,273,11,11,0,1,0
34,277,277,13,4,9,2,1
29,278,278,37,4,33,2,1
25,283,283,6,3,3,2,1
15,291,291,2,2,0,1,0
12,293,293,6,6,0,1,0
24,299,299,47,47,0,1,0
21,313,313,9,1,8,2,1
14,330,330,1,1,0,1,0
20,367,367,33,18,15,2,1
19,377,377,12,7,5,2,1
9,381,381,31,31,0,1,0
35,383,383,84,84,0,1,0
7,396,396,69,69,0,1,0
16,422,422,22,5,17,2,1
33,425,425,10,4,6,3,2
6,431,431,134,105,29,2,1
17,432,432,34,25,9,4,3
4,470,470,91,46,45,4,3
1,490,490,63,25,38,3,2
27,495,495,74,74,0,1,0

14,103,103,5,5,0,1,0
3,110,110,3,3,0,1,0
4,138,138,13,13,0,1,0
0,153,153,9,9,0,1,0
24,161,161,7,7,0,1,0
12,168,168,1,1,0,1,0
27,244,244,9,4,5,2,1
21,246,246,15,5,10,3,2
1,249,249,8,8,0,1,0
17,268,268,31,5,26,3,2
28,279,279,18,10,8,3,2
38,285,285,13,13,0,1,0
31,305,305,14,14,0,1,0
15,312,312,16,16,0,1,0
22,326,326,24,24,0,1,0
29,342,342,24,24,0,1,0
10,352,352,40,15,25,3,2
19,363,363,7,2,5,2,1
33,377,377,89,13,76,4,3
9,379,379,5,5,0,1,0
25,388,388,35,35,0,1,0
2,394,394,92,34,58,3,2
35,401,401,139,101,38,4,3
36,405,405,119,95,24,4,3
23,407,407,30,25,5,2,1
13,410,410,20,20,0,1,0
37,420,420,22,3,19,2,1
7,421,421,106,40,66,4,3
30,446,446,24,24,0,1,0
32,450,450,38,38,0,1,0
11,454,454,28,19,9,2,1
18,463,463,4,4,0,1,0
8,464,464,32,32,0,1,0
34,469,469,24,18,6,3,2
5,473,473,31,31,0,1,0
26,480,480,14,2,12,3,2
6,484,484,3,3,0,1,0
20,490,490,39,39,0,1,0
16,494,494,31,31,0,1,0

35,101,101,11,11,0,1,0
21,124,124,8,8,0,1,0
24,129,129,28,28,0,1,0
32,133,133,3,3,0,1,0
27,150,150,10,6,4,2,1
5,169,169,4,4,0,1,0
31,181,181,36,19,17,3,2
34,194,194,26,23,3,2,1
8,195,195,1,1,0,1,0
1,230,230,3,3,0,1,0
0,231,231,1,1,0,1,0
16,252,252,25,7,18,2,1
3,274,274,50,50,0,1,0
10,290,290,12,1,11,4,3
19,319,319,60,24,36,3,2
18,337,337,25,25,0,1,0
28,337,337,64,24,40,3,2
33,337,337,10,2,8,2,1
25,352,352,38,16,22,3,2
15,369,369,21,21,0,1,0
6,374,374,44,11,33,4,3
17,396,396,117,57,60,4,3
26,396,396,19,19,0,1,0
23,401,401,73,73,0,1,0
29,401,401,56,56,0,1,0
7,415,415,52,52,0,1,0
14,421,421,20,20,0,1,0
30,428,428,6,6,0,1,0
22,442,442,12,12,0,1,0
20,444,444,9,1,8,2,1
2,456,456,42,42,0,1,0
36,460,460,38,35,3,2,1
11,464,464,11,11,0,1,0
12,472,472,6,6,0,1,0
9,492,492,23,7,16,3,2
4,495,495,52,52,0,1,0
13,496,496,13,13,0,1,0

20,116,116,4,1,3,2,1
1,122,122,5,5,0,1,0
8,129,129,1,1,0,1,0
10,130,130,28,28,0,1,0
15,156,156,3,3,0,1,0
4,162,162,4,4,0,1,0
32,181,181,32,32,0,1,0
28,197,197,15,5,10,2,1
26,207,207,4,4,0,1,0
12,209,209,17,17,0,1,0
16,220,220,30,25,5,2,1
31,240,240,11,11,0,1,0
19,253,253,66,66,0,1,0
34,261,261,23,23,0,1,0
33,265,265,25,25,0,1,0
0,267,267,81,81,0,1,0
6,274,274,10,10,0,1,0
27,292,292,37,37,0,1,0
17,294,294,29,20,9,2,1
5,326,326,11,2,9,2,1
30,330,330,36,25,11,2,1
2,335,335,22,22,0,1,0
21,340,340,19,19,0,1,0
22,341,341,39,17,22,2,1
14,348,348,103,23,80,4,3
25,348,348,61,61,0,1,0
9,350,350,20,20,0,1,0
7,392,392,3,3,0,1,0
3,408,408,18,2,16,3,2
23,431,431,80,80,0,1,0
11,432,432,2,2,0,1,0
24,455,455,12,2,10,3,2
29,466,466,16,16,0,1,0
13,476,476,5,1,4,2,1
18,487,487,57,57,0,1,0

21,103,103,6,6,0,1,0
15,110,110,9,9,0,1,0
19,134,134,1,1,0,1,0
29,136,136,1,1,0,1,0
1,142,142,1,1,0,1,0
38,146,146,4,4,0,1,0
3,167,167,25,25,0,1,0
20,177,177,17,10,7,3,2
14,218,218,2,2,0,1,0
17,223,223,1,1,0,1,0
32,233,233,83,53,30,4,3
4,234,234,5,5,0,1,0
30,242,242,2,2,0,1,0
18,267,267,8,8,0,1,0
23,270,270,2,2,0,1,0
27,273,273,15,15,0,1,0
39,287,287,24,24,0,1,0
31,293,293,15,1,14,2,1
12,295,295,10,10,0,1,0
37,297,297,32,32,0,1,0
34,309,309,5,5,0,1,0
33,314,314,1,1,0,1,0
28,334,334,1,1,0,1,0
40,342,342,40,29,11,2,1
13,349,349,5,5,0,1,0
7,351,351,16,16,0,1,0
44,351,351,2,2,0,1,0
36,367,367,33,33,0,1,0
8,371,371,26,26,0,1,0
6,375,375,43,43,0,1,0
35,382,382,42,30,12,2,1
45,386,386,132,3,129,4,3
24,386,386,13,13,0,1,0
2,387,387,15,3,12,2,1
5,389,389,4,1,3,2,1
41,389,389,69,57,12,2,1
9,418,418,38,38,0,1,0
42,427,427,18,15,3,2,1
46,435,435,24,2,22,2,1
11,449,449,39,39,0,1,0
16,454,454,18,18,0,1,0
22,456,456,93,39,54,3,2
25,460,460,6,2,4,2,1
26,464,464,7,7,0,1,0
0,472,472,54,4,50,2,1
43,476,476,22,22,0,1,0
10,491,491,65,65,0,1,0

3,130,130,27,5,22,2,1
11,136,136,16,16,0,1,0
16,147,147,1,1,0,1,0
27,175,175,17,17,0,1,0
14,181,181,36,36,0,1,0
10,216,216,19,19,0,1,0
18,232,232,17,17,0,1,0
33,235,235,25,20,5,2,1
2,241,241,12,8,4,2,1
23,257,257,37,37,0,1,0
8,279,279,13,13,0,1,0
25,291,291,13,4,9,2,1
6,310,310,35,13,22,2,1
7,318,318,1,1,0,1,0
22,339,339,9,9,0,1,0
4,357,357,64,64,0,1,0
1,359,359,4,1,3,2,1
0,369,369,6,6,0,1,0
9,382,382,83,83,0,1,0
26,383,383,5,5,0,1,0
31,384,384,4,4,0,1,0
12,389,389,9,9,0,1,0
5,398,398,5,5,0,1,0
28,406,406,60,60,0,1,0
20,428,428,49,41,8,3,2
35,438,438,60,26,34,3,2
19,440,440,4,1,3,2,1
30,441,441,20,20,0,1,0
34,442,442,187,165,22,3,2
29,444,444,17,11,6,3,2
21,450,450,79,22,57,3,2
15,454,454,40,3,37,2,1
13,462,462,22,22,0,1,0
24,466,466,16,8,8,2,1
32,473,473,28,28,0,1,0
17,486,486,45,3,42,2,1

27,127,127,30,20,10,2,1
6,129,129,1,1,0,1,0
23,167,167,16,10,6,2,1
17,174,174,27,27,0,1,0
2,196,196,12,12,0,1,0
15,197,197,16,16,0,1,0
22,203,203,6,6,0,1,0
32,205,205,17,17,0,1,0
25,207,207,34,34,0,1,0
4,209,209,1,1,0,1,0
7,227,227,7,7,0,1,0
1,236,236,15,15,0,1,0
29,266,266,30,30,0,1,0
30,296,296,58,58,0,1,0
3,312,312,32,32,0,1,0
5,315,315,40,19,21,2,1
12,337,337,49,1,48,4,3
11,343,343,33,33,0,1,0
18,347,347,39,39,0,1,0
28,349,349,10,4,6,2,1
13,350,350,51,51,0,1,0
8,354,354,19,19,0,1,0
0,360,360,44,22,22,2,1
19,361,361,42,28,14,3,2
10,364,364,49,49,0,1,0
26,374,374,13,3,10,2,1
14,376,376,5,1,4,2,1
20,390,390,10,10,0,1,0
16,415,415,55,55,0,1,0
21,433,433,36,2,34,2,1
33,461,461,53,48,5,2,1
24,475,475,32,22,10,2,1
31,477,477,14,14,0,1,0
34,482,482,104,104,0,1,0
9,494,494,5,5,0,1,0

9,105,105,1,1,0,1,0
19,137,137,3,3,0,1,0
12,165,165,18,18,0,1,0
22,168,168,6,6,0,1,0
14,181,181,51,51,0,1,0
25,187,187,26,4,22,3,2
23,199,199,14,14,0,1,0
28,223,223,18,14,4,2,1
5,236,236,21,21,0,1,0
18,240,240,59,15,44,3,2
20,241,241,23,17,6,3,2
0,265,265,20,3,17,2,1
1,299,299,6,6,0,1,0
4,299,299,12,8,4,2,1
3,301,301,9,1,8,2,1
2,318,318,10,10,0,1,0
16,335,335,123,53,70,3,2
26,339,339,52,28,24,4,3
24,341,341,1,1,0,1,0
29,370,370,58,58,0,1,0
6,386,386,92,32,60,3,2
17,388,388,56,19,37,2,1
11,390,390,16,2,14,2,1
30,414,414,1,1,0,1,0
15,419,419,16,8,8,3,2
10,443,443,24,24,0,1,0
27,444,444,10,10,0,1,0
8,459,459,56,56,0,1,0
7,484,484,80,38,42,4,3
13,492,492,126,6,120,4,3
21,494,494,45,45,0,1,0
31,495,495,1,1,0,1,0

0,113,113,2,2,0,1,0
35,120,120,11,2,9,2,1
14,134,134,23,2,21,4,3
18,145,145,6,1,5,2,1
8,157,157,1,1,0,1,0
24,179,179,5,5,0,1,0
2,180,180,25,25,0,1,0
34,182,182,36,36,0,1,0
21,244,244,10,10,0,1,0
31,251,251,79,79,0,1,0
16,256,256,55,55,0,1,0
22,262,262,15,6,9,4,3
36,269,269,5,5,0,1,0
4,269,269,7,7,0,1,0
9,277,277,7,7,0,1,0
29,293,293,39,11,28,3,2
15,308,308,31,13,18,2,1
26,321,321,68,68,0,1,0
27,330,330,33,33,0,1,0
20,352,352,4,4,0,1,0
32,353,353,9,9,0,1,0
25,363,363,9,9,0,1,0
28,371,371,28,28,0,1,0
10,372,372,19,11,8,2,1
3,374,374,28,28,0,1,0
1,374,374,10,10,0,1,0
23,377,377,7,1,6,2,1
13,381,381,68,68,0,1,0
30,385,385,81,81,0,1,0
33,418,418,37,37,0,1,0
6,425,425,105,48,57,4,3
11,430,430,6,6,0,1,0
19,431,431,29,29,0,1,0
12,451,451,17,9,8,2,1
7,454,454,52,11,41,2,1
17,483,483,11,1,10,4,3
5,490,490,6,6,0,1,0

6,112,112,22,6,16,3,2
12,130,130,15,15,0,1,0
14,154,154,9,2,7,2,1
9,162,162,58,22,36,4,3
15,171,171,32,32,0,1,0
24,171,171,80,6,74,3,2
19,177,177,8,2,6,2,1
10,178,178,4,4,0,1,0
13,201,201,5,5,0,1,0
17,203,203,10,3,7,2,1
29,270,270,11,11,0,1,0
7,273,273,37,9,28,2,1
16,279,279,24,8,16,2,1
28,283,283,34,4,30,3,2
18,330,330,20,20,0,1,0
3,339,339,24,2,22,4,3
8,363,363,64,2,62,3,2
1,370,370,25,25,0,1,0
4,392,392,12,9,3,2,1
22,394,394,28,13,15,4,3
0,397,397,121,24,97,4,3
21,413,413,26,26,0,1,0
25,420,420,63,6,57,4,3
26,439,439,48,1,47,2,1
27,444,444,6,6,0,1,0
20,448,448,1,1,0,1,0
5,456,456,10,10,0,1,0
2,466,466,23,13,10,2,1
11,495,495,14,14,0,1,0
23,500,500,47,47,0,1,0

4,129,129,5,5,0,1,0
16,144,144,12,12,0,1,0
9,194,194,1,1,0,1,0
30,196,196,6,6,0,1,0
15,198,198,22,6,16,2,1
24,202,202,2,2,0,1,0
2,232,232,69,24,45,4,3
18,245,245,24,24,0,1,0
14,253,253,1,1,0,1,0
7,259,259,27,13,14,2,1
17,272,272,89,53,36,4,3
6,294,294,45,40,5,2,1
1,304,304,22,6,16,2,1
11,312,312,14,14,0,1,0
0,323,323,5,5,0,1,0
8,329,329,15,4,11,2,1
27,331,331,18,18,0,1,0
5,344,344,38,38,0,1,0
10,347,347,11,7,4,2,1
28,349,349,93,93,0,1,0
3,363,363,126,98,28,3,2
26,375,375,30,30,0,1,0
20,379,379,51,36,15,4,3
25,390,390,78,18,60,3,2
29,406,406,4,4,0,1,0
13,428,428,79,79,0,1,0
12,432,432,15,15,0,1,0
23,437,437,5,2,3,2,1
22,443,443,14,11,3,2,1
21,466,466,40,2,38,3,2
31,483,483,99,90,9,4,3
19,489,489,3,3,0,1,0

0,100,100,8,4,4,2,1
11,102,102,2,2,0,1,0
6,122,122,11,11,0,1,0
4,149,149,2,2,0,1,0
12,154,154,6,6,0,1,0
21,163,163,1,1,0,1,0
15,195,195,56,2,54,4,3
19,200,200,30,30,0,1,0
7,223,223,4,4,0,1,0
3,240,240,9,1,8,2,1
25,275,275,64,1,63,4,3
18,283,283,31,4,27,4,3
17,290,290,7,7,0,1,0
14,295,295,20,20,0,1,0
24,299,299,12,5,7,2,1
8,313,313,60,60,0,1,0
16,315,315,5,5,0,1,0
1,332,332,50,38,12,2,1
23,373,373,96,96,0,1,0
20,397,397,11,2,9,2,1
10,398,398,186,94,92,4,3
13,411,411,7,2,5,2,1
22,420,420,38,38,0,1,0
2,432,432,50,50,0,1,0
5,449,449,15,5,10,3,2
27,468,468,24,3,21,2,1
9,481,481,188,122,66,4,3
26,490,490,103,103,0,1,0

8,117,117,33,33,0,1,0
28,138,138,1,1,0,1,0
3,139,139,2,2,0,1,0
21,151,151,2,2,0,1,0
7,155,155,1,1,0,1,0
6,158,158,16,16,0,1,0
14,167,167,11,11,0,1,0
25,173,173,23,23,0,1,0
17,203,203,22,18,4,2,1
2,219,219,8,8,0,1,0
5,223,223,10,6,4,2,1
22,225,225,17,17,0,1,0
11,236,236,23,23,0,1,0
10,255,255,51,42,9,2,1
19,270,270,16,4,12,3,2
18,275,275,5,5,0,1,0
24,318,318,131,107,24,4,3
27,322,322,12,4,8,2,1
13,327,327,1,1,0,1,0
15,331,331,67,30,37,2,1
26,340,340,33,22,11,2,1
12,353,353,25,25,0,1,0
1,368,368,99,36,63,4,3
4,372,372,73,8,65,4,3
16,373,373,51,51,0,1,0
23,396,396,7,7,0,1,0
9,431,431,91,73,18,3,2
20,462,462,115,23,92,4,3
0,471,471,34,12,22,3,2

6,162,162,1,1,0,1,0
15,174,174,14,14,0,1,0
1,182,182,1,1,0,1,0
7,183,183,21,21,0,1,0
4,188,188,1,1,0,1,0
27,199,199,4,4,0,1,0
32,210,210,32,8,24,2,1
3,210,210,17,17,0,1,0
20,214,214,4,4,0,1,0
19,217,217,8,8,0,1,0
24,217,217,8,2,6,2,1
26,229,229,4,4,0,1,0
9,234,234,8,4,4,2,1
5,260,260,5,2,3,2,1
22,274,274,2,2,0,1,0
30,291,291,5,5,0,1,0
18,340,340,29,7,22,3,2
25,343,343,62,62,0,1,0
10,346,346,1,1,0,1,0
23,372,372,28,28,0,1,0
8,377,377,149,83,66,3,2
14,381,381,27,27,0,1,0
28,385,385,127,83,44,3,2
2,387,387,43,22,21,2,1
11,387,387,35,35,0,1,0
33,391,391,9,9,0,1,0
34,411,411,100,85,15,4,3
12,417,417,7,7,0,1,0
16,431,431,4,4,0,1,0
29,439,439,31,31,0,1,0
21,455,455,113,29,84,3,2
17,457,457,52,44,8,2,1
13,471,471,44,14,30,3,2
31,475,475,40,7,33,4,3
35,480,480,49,43,6,2,1
0,492,492,113,63,50,4,3

17,117,117,17,17,0,1,0
13,132,132,5,5,0,1,0
5,156,156,2,2,0,1,0
8,171,171,17,17,0,1,0
21,178,178,13,13,0,1,0
26,182,182,11,1,10,3,2
3,194,194,27,8,19,2,1
0,224,224,11,11,0,1,0
28,225,225,46,19,27,4,3
11,246,246,29,29,0,1,0
14,247,247,60,32,28,3,2
15,266,266,21,21,0,1,0
30,274,274,62,24,38,3,2
10,279,279,3,3,0,1,0
25,300,300,3,3,0,1,0
27,328,328,37,37,0,1,0
1,344,344,33,33,0,1,0
29,351,351,67,67,0,1,0
33,361,361,14,14,0,1,0
9,375,375,43,17,26,2,1
31,383,383,8,8,0,1,0
32,403,403,30,30,0,1,0
16,410,410,19,10,9,2,1
20,419,419,115,115,0,1,0
22,421,421,12,3,9,4,3
2,439,439,10,1,9,3,2
23,441,441,25,25,0,1,0
18,449,449,76,13,63,4,3
19,464,464,33,21,12,3,2
4,478,478,19,7,12,2,1
7,487,487,80,80,0,1,0
6,491,491,56,56,0,1,0
12,497,497,37,37,0,1,0
24,498,498,9,1,8,3,2

18,108,108,23,6,17,2,1
1,118,118,5,5,0,1,0
2,133,133,15,2,13,2,1
14,141,141,9,9,0,1,0
12,149,149,12,2,10,2,1
30,168,168,48,39,9,4,3
23,171,171,8,8,0,1,0
11,181,181,3,3,0,1,0
3,187,187,1,1,0,1,0
9,187,187,1,1,0,1,0
22,189,189,6,6,0,1,0
16,196,196,2,2,0,1,0
29,204,204,8,8,0,1,0
28,206,206,4,4,0,1,0
4,221,221,6,6,0,1,0
10,230,230,26,26,0,1,0
27,257,257,47,47,0,1,0
6,275,275,93,37,56,4,3
0,278,278,20,20,0,1,0
31,289,289,72,34,38,3,2
19,290,290,7,7,0,1,0
24,301,301,49,40,9,2,1
32,312,312,4,4,0,1,0
26,330,330,9,5,4,2,1
5,358,358,54,21,33,4,3
33,408,408,32,32,0,1,0
15,421,421,15,15,0,1,0
34,425,425,6,3,3,2,1
13,434,434,47,47,0,1,0
8,438,438,65,65,0,1,0
17,448,448,20,3,17,2,1
20,449,449,12,5,7,2,1
7,462,462,9,9,0,1,0
21,471,471,144,132,12,4,3
25,480,480,58,32,26,3,2

23,126,126,2,2,0,1,0
25,150,150,5,5,0,1,0
5,151,151,1,1,0,1,0
16,159,159,31,31,0,1,0
10,163,163,6,6,0,1,0
15,171,171,3,3,0,1,0
31,190,190,12,3,9,4,3
2,191,191,17,17,0,1,0
8,215,215,11,11,0,1,0
24,230,230,7,7,0,1,0
4,231,231,73,73,0,1,0
11,232,232,6,6,0,1,0
1,233,233,15,15,0,1,0
19,235,235,4,4,0,1,0
22,243,243,23,7,16,3,2
20,252,252,15,15,0,1,0
33,253,253,48,6,42,3,2
17,270,270,60,60,0,1,0
3,278,278,19,19,0,1,0
6,282,282,16,2,14,2,1
13,287,287,5,2,3,2,1
18,313,313,12,12,0,1,0
28,316,316,61,9,52,3,2
30,321,321,7,7,0,1,0
14,329,329,34,34,0,1,0
27,347,347,166,88,78,3,2
29,358,358,7,7,0,1,0
26,385,385,36,3,33,2,1
0,387,387,40,40,0,1,0
12,422,422,2,2,0,1,0
21,444,444,44,1,43,2,1
9,473,473,19,19,0,1,0
7,473,473,68,15,53,3,2
32,493,493,55,24,31,2,1
34,495,495,58,19,39,2,1

3,121,121,12,12,0,1,0
19,139,139,37,13,24,4,3
11,172,172,7,1,6,3,2
25,176,176,5,5,0,1,0
31,184,184,13,13,0,1,0
8,186,186,1,1,0,1,0
12,201,201,69,69,0,1,0
5,219,219,45,45,0,1,0
6,244,244,1,1,0,1,0
34,255,255,4,4,0,1,0
32,265,265,8,1,7,2,1
23,281,281,17,17,0,1,0
2,292,292,16,8,8,3,2
9,313,313,14,8,6,3,2
1,315,315,2,2,0,1,0
22,333,333,51,27,24,2,1
18,334,334,14,14,0,1,0
0,336,336,5,5,0,1,0
33,346,346,21,12,9,4,3
16,350,350,41,41,0,1,0
28,356,356,43,5,38,3,2
7,392,392,1,1,0,1,0
15,398,398,85,58,27,2,1
4,403,403,64,40,24,2,1
20,407,407,74,74,0,1,0
27,413,413,38,38,0,1,0
10,415,415,9,6,3,2,1
17,421,421,16,16,0,1,0
24,423,423,89,66,23,3,2
30,427,427,41,18,23,2,1
14,442,442,69,2,67,4,3
21,489,489,16,16,0,1,0
13,491,491,16,16,0,1,0
29,495,495,19,19,0,1,0
26,496,496,87,78,9,4,3

15,107,107,2,2,0,1,0
20,113,113,3,3,0,1,0
27,116,116,3,3,0,1,0
3,148,148,31,31,0,1,0
11,149,149,18,18,0,1,0
2,153,153,2,2,0,1,0
13,157,157,9,9,0,1,0
10,157,157,38,38,0,1,0
19,182,182,7,4,3,2,1
26,230,230,26,7,19,2,1
14,245,245,16,1,15,4,3
6,282,282,11,2,9,4,3
28,291,291,15,1,14,3,2
23,291,291,63,41,22,3,2
8,293,293,51,51,0,1,0
24,298,298,118,118,0,1,0
0,306,306,5,2,3,2,1
12,306,306,15,15,0,1,0
22,316,316,13,13,0,1,0
18,330,330,26,5,21,2,1
16,337,337,73,17,56,3,2
17,342,342,42,42,0,1,0
4,348,348,5,2,3,2,1
21,350,350,12,3,9,2,1
7,361,361,97,88,9,2,1
30,377,377,29,29,0,1,0
29,386,386,22,2,20,4,3
9,399,399,17,3,14,2,1
25,452,452,55,15,40,3,2
5,477,477,99,99,0,1,0
1,485,485,40,40,0,1,0

6,123,123,3,3,0,1,0
34,154,154,8,8,0,1,0
17,159,159,16,6,10,3,2
28,168,168,23,8,15,4,3
9,177,177,13,13,0,1,0
12,191,191,12,12,0,1,0
7,197,197,35,24,11,2,1
8,201,201,47,38,9,2,1
15,207,207,1,1,0,1,0
5,231,231,1,1,0,1,0
13,241,241,6,6,0,1,0
33,247,247,26,26,0,1,0
30,249,249,6,1,5,2,1
18,260,260,26,22,4,2,1
31,260,260,36,36,0,1,0
14,273,273,75,51,24,3,2
0,275,275,45,45,0,1,0
22,276,276,40,40,0,1,0
24,311,311,42,30,12,3,2
26,318,318,44,12,32,2,1
2,327,327,33,33,0,1,0
32,335,335,70,70,0,1,0
19,343,343,5,5,0,1,0
11,348,348,8,8,0,1,0
23,364,364,55,55,0,1,0
29,364,364,58,28,30,4,3
27,368,368,19,3,16,4,3
20,375,375,7,7,0,1,0
3,376,376,3,3,0,1,0
1,385,385,6,6,0,1,0
21,389,389,40,12,28,2,1
25,456,456,1,1,0,1,0
35,469,469,25,7,18,3,2
10,469,469,18,4,14,2,1
16,481,481,5,5,0,1,0
4,497,497,73,73,0,1,0

4,102,102,1,1,0,1,0
28,114,114,1,1,0,1,0
17,120,120,1,1,0,1,0
22,131,131,1,1,0,1,0
10,133,133,7,2,5,2,1
30,141,141,5,5,0,1,0
5,142,142,5,5,0,1,0
34,142,142,22,22,0,1,0
15,142,142,14,14,0,1,0
20,146,146,33,18,15,4,3
1,149,149,25,25,0,1,0
12,176,176,14,14,0,1,0
27,192,192,8,2,6,2,1
11,211,211,5,5,0,1,0
7,214,214,7,7,0,1,0
9,219,219,9,9,0,1,0
0,227,227,54,1,53,3,2
25,289,289,64,64,0,1,0
26,290,290,103,75,28,2,1
6,309,309,43,17,26,2,1
18,325,325,42,42,0,1,0
24,352,352,22,22,0,1,0
29,376,376,2,2,0,1,0
8,376,376,7,7,0,1,0
14,377,377,22,22,0,1,0
3,382,382,17,17,0,1,0
19,388,388,20,20,0,1,0
32,390,390,52,52,0,1,0
21,402,402,68,68,0,1,0
35,405,405,36,36,0,1,0
2,406,406,115,115,0,1,0
13,411,411,4,4,0,1,0
33,453,453,32,32,0,1,0
16,475,475,38,38,0,1,0
23,477,477,6,6,0,1,0
31,496,496,17,2,15,4,3

4,104,104,20,20,0,1,0
22,117,117,5,5,0,1,0
26,132,132,8,8,0,1,0
30,151,151,12,6,6,2,1
12,177,177,10,10,0,1,0
3,178,178,20,20,0,1,0
11,182,182,18,18,0,1,0
19,191,191,60,60,0,1,0
20,198,198,31,31,0,1,0
7,250,250,5,1,4,2,1
29,290,290,5,5,0,1,0
15,317,317,6,2,4,2,1
0,321,321,8,8,0,1,0
5,324,324,15,15,0,1,0
2,331,331,106,82,24,4,3
16,341,341,12,12,0,1,0
24,359,359,27,24,3,2,1
25,375,375,10,1,9,4,3
27,395,395,62,12,50,3,2
8,396,396,6,2,4,2,1
17,397,397,2,2,0,1,0
14,419,419,33,15,18,4,3
9,432,432,43,43,0,1,0
18,438,438,94,28,66,4,3
28,446,446,76,30,46,3,2
10,448,448,18,8,10,2,1
23,455,455,87,87,0,1,0
13,459,459,82,36,46,3,2
1,461,461,15,15,0,1,0
21,464,464,30,6,24,4,3
6,486,486,138,67,71,4,3

15,115,115,7,4,3,2,1
13,118,118,13,4,9,4,3
21,118,118,4,1,3,2,1
8,120,120,9,9,0,1,0
24,163,163,2,2,0,1,0
6,164,164,22,13,9,2,1
1,169,169,16,16,0,1,0
32,170,170,6,3,3,2,1
0,180,180,4,4,0,1,0
17,187,187,20,14,6,3,2
30,200,200,13,13,0,1,0
19,206,206,15,6,9,2,1
27,211,211,36,20,16,3,2
20,211,211,2,2,0,1,0
22,229,229,20,1,19,2,1
28,236,236,41,41,0,1,0
4,267,267,49,10,39,2,1
18,270,270,1,1,0,1,0
3,274,274,34,27,7,2,1
33,279,279,63,16,47,2,1
7,295,295,51,33,18,4,3
23,322,322,32,12,20,3,2
2,333,333,1,1,0,1,0
14,345,345,74,70,4,2,1
16,349,349,3,3,0,1,0
5,349,349,8,8,0,1,0
29,378,378,12,1,11,2,1
10,382,382,25,25,0,1,0
11,389,389,4,4,0,1,0
31,421,421,57,9,48,4,3
12,440,440,61,61,0,1,0
34,473,473,42,24,18,2,1
25,485,485,23,23,0,1,0
26,488,488,171,66,105,4,3
9,488,488,25,25,0,1,0

4,127,127,27,27,0,1,0
15,136,136,4,4,0,1,0
10,142,142,8,4,4,2,1
9,144,144,34,19,15,4,3
8,151,151,40,40,0,1,0
24,154,154,67,57,10,3,2
25,160,160,13,2,11,2,1
11,163,163,3,3,0,1,0
26,173,173,24,6,18,2,1
33,174,174,34,34,0,1,0
31,174,174,38,38,0,1,0
28,178,178,1,1,0,1,0
12,190,190,6,3,3,2,1
32,195,195,15,15,0,1,0
13,199,199,35,35,0,1,0
23,204,204,6,6,0,1,0
6,211,211,24,24,0,1,0
18,241,241,40,7,33,4,3
21,253,253,7,1,6,3,2
1,265,265,3,3,0,1,0
5,268,268,2,2,0,1,0
7,292,292,13,3,10,2,1
2,301,301,1,1,0,1,0
30,312,312,5,1,4,2,1
22,316,316,43,43,0,1,0
19,343,343,4,4,0,1,0
0,347,347,5,5,0,1,0
17,349,349,7,7,0,1,0
14,367,367,6,6,0,1,0
16,402,402,30,30,0,1,0
3,423,423,45,27,18,4,3
29,429,429,63,63,0,1,0
34,437,437,20,20,0,1,0
27,447,447,13,13,0,1,0
20,455,455,20,20,0,1,0

27,107,107,12,12,0,1,0
7,122,122,7,7,0,1,0
16,123,123,40,3,37,2,1
4,129,129,1,1,0,1,0
6,158,158,7,7,0,1,0
21,187,187,6,6,0,1,0
15,192,192,12,4,8,2,1
5,194,194,5,5,0,1,0
2,220,220,10,7,3,2,1
9,224,224,34,34,0,1,0
10,262,262,33,33,0,1,0
30,266,266,35,35,0,1,0
26,280,280,23,17,6,2,1
0,298,298,5,5,0,1,0
14,315,315,3,3,0,1,0
29,318,318,3,3,0,1,0
18,321,321,91,24,67,3,2
12,338,338,17,3,14,3,2
1,348,348,111,107,4,2,1
13,351,351,112,22,90,4,3
28,354,354,12,2,10,2,1
20,362,362,34,34,0,1,0
17,371,371,17,17,0,1,0
8,377,377,30,30,0,1,0
3,406,406,139,90,49,4,3
22,419,419,26,26,0,1,0
23,424,424,6,6,0,1,0
25,448,448,36,36,0,1,0
24,449,449,53,53,0,1,0
11,456,456,3,3,0,1,0
19,473,473,66,4,62,3,2

27,100,100,13,13,0,1,0
37,105,105,10,2,8,2,1
7,122,122,25,25,0,1,0
15,123,123,7,7,0,1,0
19,126,126,22,22,0,1,0
4,140,140,3,3,0,1,0
11,154,154,5,5,0,1,0
0,157,157,1,1,0,1,0
8,178,178,35,35,0,1,0
31,190,190,12,12,0,1,0
10,192,192,5,5,0,1,0
23,203,203,1,1,0,1,0
35,207,207,40,20,20,3,2
20,225,225,6,6,0,1,0
12,242,242,10,2,8,2,1
2,242,242,12,12,0,1,0
38,243,243,30,30,0,1,0
9,252,252,1,1,0,1,0
14,261,261,43,31,12,4,3
24,280,280,109,59,50,3,2
5,290,290,10,7,3,2,1
17,292,292,16,11,5,2,1
30,300,300,6,6,0,1,0
32,318,318,44,5,39,4,3
22,326,326,27,20,7,2,1
26,329,329,1,1,0,1,0
33,331,331,19,19,0,1,0
29,337,337,44,1,43,2,1
21,360,360,36,8,28,2,1
34,361,361,40,40,0,1,0
1,379,379,7,7,0,1,0
36,386,386,20,17,3,2,1
16,418,418,31,31,0,1,0
13,418,418,5,5,0,1,0
6,440,440,27,27,0,1,0
18,442,442,33,33,0,1,0
28,454,454,44,16,28,3,2
3,461,461,39,5,34,2,1
25,472,472,12,12,0,1,0

5,115,115,18,10,8,3,2
16,153,153,9,2,7,2,1
18,162,162,12,1,11,2,1
10,165,165,3,3,0,1,0
27,165,165,8,8,0,1,0
6,170,170,68,56,12,3,2
23,194,194,10,10,0,1,0
17,225,225,7,3,4,2,1
19,256,256,1,1,0,1,0
8,266,266,24,24,0,1,0
28,327,327,15,4,11,2,1
26,332,332,58,10,48,3,2
1,337,337,4,4,0,1,0
22,344,344,112,14,98,3,2
15,345,345,6,6,0,1,0
25,351,351,14,14,0,1,0
20,354,354,10,2,8,2,1
13,368,368,89,1,88,3,2
3,375,375,65,65,0,1,0
14,382,382,25,25,0,1,0
11,400,400,53,53,0,1,0
9,407,407,74,62,12,4,3
12,429,429,21,21,0,1,0
0,441,441,20,5,15,4,3
4,469,469,47,47,0,1,0
2,482,482,35,35,0,1,0
21,490,490,138,107,31,2,1
24,493,493,64,64,0,1,0
7,498,498,85,46,39,2,1

4,110,110,11,11,0,1,0
17,111,111,6,6,0,1,0
3,112,112,3,3,0,1,0
24,117,117,2,2,0,1,0
7,162,162,15,5,10,2,1
26,165,165,1,1,0,1,0
5,179,179,5,5,0,1,0
22,213,213,3,3,0,1,0
28,222,222,21,12,9,4,3
14,272,272,69,30,39,2,1
8,279,279,12,12,0,1,0
25,286,286,13,5,8,3,2
6,288,288,27,27,0,1,0
2,304,304,105,105,0,1,0
27,308,308,69,56,13,2,1
18,312,312,32,32,0,1,0
1,317,317,42,42,0,1,0
0,322,322,6,6,0,1,0
15,329,329,19,15,4,2,1
19,366,366,17,1,16,4,3
9,366,366,43,14,29,2,1
23,371,371,4,1,3,2,1
10,381,381,3,3,0,1,0
16,412,412,6,6,0,1,0
13,416,416,65,17,48,2,1
12,422,422,33,9,24,3,2
21,429,429,192,78,114,4,3
30,441,441,125,2,123,4,3
11,490,490,53,34,19,3,2
20,497,497,52,4,48,4,3
29,499,499,51,12,39,2,1

1,107,107,9,2,7,2,1
30,116,116,5,5,0,1,0
15,118,118,1,1,0,1,0
7,132,132,3,3,0,1,0
37,144,144,18,18,0,1,0
27,154,154,18,1,17,2,1
25,158,158,64,64,0,1,0
0,176,176,1,1,0,1,0
22,184,184,13,3,10,4,3
19,191,191,13,2,11,3,2
35,196,196,14,14,0,1,0
28,203,203,5,2,3,2,1
8,210,210,8,1,7,2,1
32,221,221,7,7,0,1,0
20,225,225,6,6,0,1,0
12,254,254,4,4,0,1,0
34,264,264,27,27,0,1,0
13,271,271,25,13,12,2,1
14,284,284,1,1,0,1,0
21,314,314,6,6,0,1,0
33,324,324,87,87,0,1,0
23,326,326,3,3,0,1,0
39,344,344,10,2,8,3,2
2,350,350,116,38,78,4,3
36,350,350,29,29,0,1,0
31,351,351,10,10,0,1,0
3,360,360,21,11,10,2,1
29,375,375,67,1,66,3,2
18,389,389,48,48,0,1,0
6,396,396,6,3,3,2,1
17,413,413,49,16,33,2,1
9,434,434,58,27,31,4,3
16,437,437,51,51,0,1,0
26,438,438,25,7,18,4,3
24,439,439,22,22,0,1,0
4,447,447,39,29,10,2,1
10,453,453,67,56,11,2,1
11,469,469,1,1,0,1,0
38,485,485,11,5,6,2,1
5,493,493,1,1,0,1,0

36,102,102,7,2,5,2,1
20,105,105,15,15,0,1,0
8,115,115,13,13,0,1,0
26,117,117,15,15,0,1,0
28,125,125,11,11,0,1,0
32,126,126,28,1,27,2,1
12,161,161,5,5,0,1,0
31,164,164,17,17,0,1,0
37,167,167,15,15,0,1,0
4,169,169,24,24,0,1,0
2,171,171,6,6,0,1,0
27,176,176,9,9,0,1,0
11,184,184,4,4,0,1,0
23,186,186,1,1,0,1,0
18,193,193,15,3,12,4,3
16,210,210,7,1,6,3,2
5,214,214,7,7,0,1,0
10,222,222,25,25,0,1,0
35,232,232,61,25,36,4,3
29,236,236,10,10,0,1,0
13,239,239,3,3,0,1,0
40,271,271,10,5,5,2,1
22,272,272,9,3,6,3,2
17,278,278,31,31,0,1,0
9,279,279,17,17,0,1,0
24,304,304,24,16,8,2,1
19,334,334,8,3,5,2,1
39,336,336,36,6,30,4,3
30,338,338,15,15,0,1,0
1,350,350,20,20,0,1,0
3,354,354,19,19,0,1,0
38,360,360,124,104,20,3,2
14,366,366,32,32,0,1,0
6,406,406,4,4,0,1,0
15,415,415,74,65,9,2,1
7,467,467,52,43,9,4,3
34,480,480,5,5,0,1,0
33,482,482,2,2,0,1,0
25,486,486,15,15,0,1,0
0,494,494,13,13,0,1,0
21,499,499,5,5,0,1,0

30,103,103,5,5,0,1,0
5,105,105,1,1,0,1,0
33,105,105,1,1,0,1,0
12,112,112,3,3,0,1,0
29,128,128,10,10,0,1,0
6,146,146,4,1,3,2,1
8,153,153,7,7,0,1,0
24,157,157,49,16,33,2,1
16,164,164,1,1,0,1,0
31,164,164,21,1,20,2,1
11,210,210,1,1,0,1,0
13,222,222,3,3,0,1,0
15,223,223,27,11,16,3,2
22,236,236,20,20,0,1,0
17,240,240,73,73,0,1,0
32,243,243,34,16,18,3,2
1,300,300,58,58,0,1,0
25,304,304,15,15,0,1,0
27,307,307,7,1,6,2,1
23,311,311,29,29,0,1,0
26,329,329,91,91,0,1,0
21,345,345,4,4,0,1,0
9,362,362,15,7,8,3,2
28,373,373,4,1,3,2,1
20,376,376,9,4,5,2,1
18,389,389,11,5,6,2,1
2,398,398,13,1,12,4,3
4,407,407,18,2,16,3,2
14,410,410,37,37,0,1,0
0,446,446,46,46,0,1,0
7,458,458,63,63,0,1,0
19,481,481,152,146,6,2,1
3,482,482,110,110,0,1,0
10,489,489,84,84,0,1,0

13,110,110,21,21,0,1,0
4,115,115,5,5,0,1,0
1,126,126,10,1,9,3,2
27,145,145,14,14,0,1,0
2,152,152,5,5,0,1,0
18,152,152,9,1,8,3,2
16,155,155,44,44,0,1,0
24,163,163,20,20,0,1,0
12,168,168,4,4,0,1,0
9,176,176,34,16,18,2,1
7,179,179,49,49,0,1,0
19,196,196,24,24,0,1,0
6,218,218,2,2,0,1,0
14,230,230,9,9,0,1,0
0,243,243,89,35,54,4,3
15,258,258,2,2,0,1,0
23,260,260,37,4,33,2,1
20,288,288,5,5,0,1,0
3,302,302,8,8,0,1,0
21,308,308,1,1,0,1,0
29,349,349,79,5,74,3,2
10,375,375,1,1,0,1,0
8,375,375,133,133,0,1,0
28,376,376,107,13,94,3,2
17,405,405,23,8,15,2,1
11,420,420,4,4,0,1,0
5,430,430,1,1,0,1,0
26,430,430,22,9,13,2,1
22,435,435,48,48,0,1,0
25,482,482,8,2,6,3,2

20,108,108,10,10,0,1,0
4,123,123,6,3,3,2,1
24,145,145,6,6,0,1,0
30,155,155,10,10,0,1,0
18,171,171,7,7,0,1,0
9,172,172,14,2,12,4,3
6,177,177,3,3,0,1,0
11,184,184,17,17,0,1,0
15,197,197,6,6,0,1,0
8,207,207,45,27,18,4,3
21,242,242,33,33,0,1,0
32,257,257,11,11,0,1,0
23,301,301,62,49,13,2,1
1,320,320,19,2,17,4,3
25,324,324,9,9,0,1,0
22,345,345,8,8,0,1,0
17,364,364,14,8,6,3,2
12,373,373,23,23,0,1,0
28,378,378,72,40,32,3,2
5,381,381,27,10,17,2,1
29,383,383,68,17,51,4,3
13,388,388,14,1,13,2,1
16,404,404,55,55,0,1,0
31,416,416,55,55,0,1,0
3,439,439,19,19,0,1,0
19,453,453,41,41,0,1,0
14,461,461,171,139,32,3,2
0,463,463,34,9,25,2,1
2,464,464,46,46,0,1,0
26,471,471,129,85,44,3,2
7,474,474,44,44,0,1,0
27,480,480,24,24,0,1,0
10,495,495,35,5,30,4,3

39,101,101,10,10,0,1,0
28,110,110,7,7,0,1,0
0,119,119,5,1,4,2,1
3,134,134,13,3,10,2,1
10,147,147,1,1,0,1,0
17,153,153,16,13,3,2,1
36,157,157,16,1,15,4,3
22,161,161,58,44,14,3,2
23,166,166,7,7,0,1,0
38,176,176,47,31,16,2,1
4,177,177,36,14,22,3,2
27,178,178,30,23,7,2,1
18,193,193,8,8,0,1,0
26,198,198,1,1,0,1,0
14,212,212,8,2,6,2,1
15,215,215,14,6,8,2,1
13,225,225,2,2,0,1,0
1,230,230,6,6,0,1,0
37,230,230,70,45,25,2,1
11,248,248,2,2,0,1,0
5,259,259,14,8,6,3,2
33,263,263,40,40,0,1,0
7,279,279,23,2,21,4,3
20,285,285,6,3,3,2,1
34,292,292,5,5,0,1,0
9,295,295,9,9,0,1,0
25,298,298,21,11,10,3,2
30,330,330,48,48,0,1,0
6,354,354,9,1,8,2,1
16,371,371,3,3,0,1,0
31,380,380,29,29,0,1,0
19,397,397,43,43,0,1,0
8,418,418,27,2,25,2,1
21,421,421,22,3,19,4,3
12,426,426,40,28,12,3,2
29,447,447,9,9,0,1,0
24,476,476,20,11,9,4,3
32,481,481,4,4,0,1,0
35,485,485,49,13,36,3,2
2,498,498,9,9,0,1,0

12,137,137,20,17,3,2,1
16,147,147,24,6,18,4,3
4,154,154,12,7,5,2,1
17,160,160,1,1,0,1,0
19,170,170,12,5,7,2,1
2,182,182,4,1,3,2,1
11,183,183,12,4,8,2,1
15,198,198,17,17,0,1,0
9,202,202,7,7,0,1,0
27,209,209,20,20,0,1,0
6,228,228,61,61,0,1,0
24,229,229,49,28,21,4,3
7,287,287,20,20,0,1,0
10,298,298,6,6,0,1,0
1,303,303,27,27,0,1,0
26,318,318,13,7,6,2,1
8,336,336,42,3,39,2,1
23,354,354,18,9,9,4,3
3,363,363,17,3,14,2,1
25,369,369,21,15,6,2,1
28,391,391,111,111,0,1,0
21,398,398,88,88,0,1,0
0,409,409,214,166,48,2,1
5,412,412,47,47,0,1,0
14,420,420,6,6,0,1,0
13,428,428,75,75,0,1,0
20,441,441,1,1,0,1,0
22,478,478,18,3,15,4,3
18,492,492,58,11,47,2,1

19,100,100,5,5,0,1,0
16,101,101,16,16,0,1,0
3,102,102,19,19,0,1,0
4,107,107,38,38,0,1,0
8,111,111,5,1,4,2,1
0,141,141,1,1,0,1,0
22,148,148,15,5,10,3,2
7,174,174,20,7,13,4,3
9,233,233,22,13,9,4,3
5,240,240,65,37,28,3,2
2,257,257,16,16,0,1,0
11,279,279,3,3,0,1,0
18,301,301,29,29,0,1,0
12,310,310,26,22,4,2,1
23,319,319,78,44,34,3,2
10,334,334,4,1,3,2,1
14,362,362,45,8,37,3,2
13,365,365,44,30,14,2,1
26,384,384,8,8,0,1,0
20,400,400,34,34,0,1,0
15,402,402,95,64,31,3,2
24,423,423,10,10,0,1,0
1,429,429,2,2,0,1,0
6,456,456,205,205,0,1,0
25,482,482,9,9,0,1,0
21,489,489,27,27,0,1,0
17,495,495,97,97,0,1,0

0,121,121,12,12,0,1,0
13,123,123,9,9,0,1,0
20,128,128,25,25,0,1,0
1,141,141,8,3,5,2,1
12,214,214,27,27,0,1,0
21,225,225,67,17,50,3,2
16,238,238,8,8,0,1,0
24,258,258,5,5,0,1,0
6,266,266,31,31,0,1,0
17,280,280,48,48,0,1,0
9,281,281,20,20,0,1,0
2,290,290,70,23,47,2,1
10,290,290,45,45,0,1,0
3,305,305,43,43,0,1,0
14,351,351,51,51,0,1,0
15,389,389,21,14,7,2,1
8,395,395,83,83,0,1,0
22,398,398,4,4,0,1,0
4,408,408,61,18,43,2,1
7,427,427,110,66,44,3,2
19,439,439,25,25,0,1,0
11,461,461,14,14,0,1,0
23,467,467,78,78,0,1,0
5,472,472,155,132,23,2,1
18,474,474,8,8,0,1,0

10,121,121,19,19,0,1,0
11,122,122,1,1,0,1,0
13,136,136,9,9,0,1,0
3,141,141,1,1,0,1,0
23,141,141,3,3,0,1,0
4,154,154,18,18,0,1,0
6,165,165,12,12,0,1,0
14,167,167,5,5,0,1,0
32,174,174,10,1,9,2,1
25,189,189,51,8,43,2,1
0,195,195,46,10,36,2,1
19,201,201,2,2,0,1,0
7,224,224,15,15,0,1,0
2,240,240,1,1,0,1,0
22,241,241,5,5,0,1,0
29,247,247,36,21,15,2,1
5,254,254,16,2,14,3,2
9,282,282,71,71,0,1,0
24,323,323,6,6,0,1,0
27,323,323,28,28,0,1,0
17,333,333,73,17,56,4,3
1,338,338,14,3,11,2,1
8,346,346,92,75,17,2,1
12,348,348,3,3,0,1,0
21,364,364,43,20,23,2,1
15,370,370,39,39,0,1,0
18,379,379,59,55,4,2,1
20,423,423,6,6,0,1,0
16,427,427,43,43,0,1,0
31,441,441,19,19,0,1,0
26,451,451,70,52,18,3,2
30,470,470,135,42,93,4,3
28,485,485,2,2,0,1,0

11,102,102,18,18,0,1,0
38,108,108,9,9,0,1,0
32,112,112,22,5,17,3,2
10,120,120,1,1,0,1,0
9,125,125,8,1,7,2,1
1,141,141,10,10,0,1,0
0,145,145,4,1,3,2,1
31,147,147,1,1,0,1,0
22,174,174,7,2,5,2,1
3,199,199,11,2,9,4,3
7,203,203,3,3,0,1,0
5,219,219,8,8,0,1,0
12,227,227,24,18,6,3,2
30,236,236,4,4,0,1,0
26,244,244,33,33,0,1,0
28,253,253,57,18,39,2,1
25,254,254,43,43,0,1,0
40,259,259,20,14,6,3,2
20,268,268,7,7,0,1,0
27,288,288,7,4,3,2,1
17,315,315,37,10,27,4,3
23,315,315,37,37,0,1,0
36,324,324,38,38,0,1,0
35,337,337,115,115,0,1,0
4,349,349,5,5,0,1,0
24,365,365,7,7,0,1,0
15,371,371,1,1,0,1,0
13,375,375,44,34,10,2,1
19,382,382,16,16,0,1,0
33,394,394,11,4,7,2,1
29,412,412,6,2,4,2,1
39,413,413,10,6,4,2,1
2,418,418,1,1,0,1,0
37,425,425,42,42,0,1,0
14,433,433,6,6,0,1,0
8,435,435,37,13,24,4,3
21,447,447,91,56,35,4,3
6,462,462,1,1,0,1,0
18,478,478,36,27,9,2,1
16,484,484,79,79,0,1,0
34,495,495,39,39,0,1,0

4,103,103,19,19,0,1,0
3,115,115,14,14,0,1,0
24,134,134,5,5,0,1,0
12,142,142,9,9,0,1,0
15,144,144,2,2,0,1,0
28,160,160,59,44,15,4,3
26,188,188,3,3,0,1,0
7,192,192,6,6,0,1,0
23,192,192,20,9,11,2,1
5,203,203,54,28,26,3,2
6,213,213,46,46,0,1,0
13,221,221,15,15,0,1,0
0,233,233,5,2,3,2,1
2,271,271,51,39,12,4,3
29,287,287,41,13,28,3,2
27,295,295,28,21,7,2,1
25,320,320,30,30,0,1,0
8,333,333,29,19,10,3,2
17,348,348,52,52,0,1,0
18,348,348,24,7,17,2,1
1,350,350,31,11,20,2,1
19,359,359,13,7,6,2,1
20,360,360,35,7,28,2,1
10,360,360,28,13,15,4,3
16,390,390,12,5,7,2,1
11,414,414,33,33,0,1,0
22,440,440,48,28,20,3,2
9,443,443,48,34,14,3,2
14,480,480,108,108,0,1,0
21,489,489,22,3,19,2,1

3,106,106,84,84,0,1,0
9,112,112,44,44,0,1,0
0,113,113,10,10,0,1,0
22,118,118,1,1,0,1,0
17,121,121,9,9,0,1,0
1,139,139,27,27,0,1,0
7,165,165,23,14,9,4,3
14,180,180,13,5,8,2,1
19,187,187,1,1,0,1,0
5,208,208,43,14,29,2,1
12,240,240,3,3,0,1,0
21,284,284,8,8,0,1,0
15,296,296,73,37,36,4,3
8,323,323,11,2,9,2,1
11,327,327,46,46,0,1,0
2,346,346,7,7,0,1,0
13,352,352,116,116,0,1,0
10,364,364,44,2,42,4,3
20,378,378,40,15,25,2,1
23,441,441,5,5,0,1,0
4,451,451,24,15,9,4,3
6,452,452,48,25,23,2,1
16,466,466,15,15,0,1,0
18,485,485,8,8,0,1,0

17,112,112,22,22,0,1,0
3,135,135,5,5,0,1,0
6,158,158,2,2,0,1,0
18,159,159,3,3,0,1,0
26,160,160,7,7,0,1,0
19,162,162,4,4,0,1,0
21,170,170,6,6,0,1,0
1,172,172,52,52,0,1,0
23,172,172,6,6,0,1,0
0,227,227,7,1,6,3,2
27,228,228,16,7,9,4,3
8,235,235,57,35,22,2,1
22,238,238,15,3,12,3,2
10,241,241,69,28,41,4,3
16,242,242,36,36,0,1,0
15,259,259,52,27,25,2,1
11,268,268,29,29,0,1,0
7,295,295,6,6,0,1,0
13,326,326,51,3,48,4,3
9,337,337,63,20,43,4,3
24,347,347,17,7,10,3,2
12,364,364,46,46,0,1,0
20,365,365,95,95,0,1,0
2,365,365,104,6,98,3,2
4,416,416,5,1,4,2,1
14,445,445,65,65,0,1,0
5,457,457,36,36,0,1,0
25,464,464,27,27,0,1,0

33,103,103,38,19,19,2,1
6,103,103,14,14,0,1,0
11,116,116,7,7,0,1,0
26,116,116,3,3,0,1,0
18,124,124,3,3,0,1,0
44,141,141,5,5,0,1,0
34,144,144,2,2,0,1,0
19,174,174,3,3,0,1,0
0,177,177,8,8,0,1,0
22,181,181,5,5,0,1,0
20,191,191,1,1,0,1,0
35,194,194,19,2,17,2,1
15,196,196,4,4,0,1,0
13,224,224,9,9,0,1,0
7,228,228,1,1,0,1,0
43,239,239,15,15,0,1,0
9,249,249,1,1,0,1,0
14,270,270,17,17,0,1,0
1,272,272,5,5,0,1,0
4,275,275,26,15,11,2,1
42,280,280,11,2,9,2,1
38,281,281,5,5,0,1,0
41,289,289,79,79,0,1,0
37,290,290,49,13,36,3,2
17,334,334,40,14,26,2,1
32,341,341,12,12,0,1,0
5,359,359,14,6,8,2,1
2,375,375,14,14,0,1,0
25,375,375,1,1,0,1,0
30,378,378,13,1,12,4,3
10,400,400,78,72,6,3,2
31,413,413,77,49,28,3,2
27,422,422,40,40,0,1,0
12,428,428,10,7,3,2,1
36,433,433,15,3,12,2,1
23,433,433,22,22,0,1,0
3,436,436,17,3,14,3,2
28,441,441,94,25,69,4,3
29,456,456,65,65,0,1,0
8,468,468,5,5,0,1,0
16,473,473,1,1,0,1,0
24,479,479,29,29,0,1,0
40,481,481,15,15,0,1,0
21,487,487,62,62,0,1,0
39,490,490,45,45,0,1,0

7,104,104,11,5,6,3,2
17,109,109,6,6,0,1,0
6,122,122,9,2,7,2,1
22,126,126,20,20,0,1,0
0,134,134,19,11,8,2,1
8,142,142,36,18,18,2,1
18,145,145,8,2,6,2,1
10,184,184,5,2,3,2,1
9,194,194,1,1,0,1,0
28,195,195,41,29,12,2,1
14,241,241,26,26,0,1,0
15,257,257,1,1,0,1,0
21,278,278,23,17,6,3,2
4,289,289,9,9,0,1,0
19,290,290,3,3,0,1,0
23,291,291,64,64,0,1,0
2,311,311,3,3,0,1,0
5,318,318,111,66,45,2,1
12,322,322,132,104,28,2,1
25,370,370,8,2,6,2,1
1,374,374,3,3,0,1,0
3,389,389,38,16,22,3,2
20,420,420,47,42,5,2,1
24,428,428,42,9,33,4,3
13,436,436,50,50,0,1,0
16,456,456,71,39,32,3,2
27,456,456,100,28,72,3,2
11,483,483,43,43,0,1,0
26,499,499,4,4,0,1,0

7,103,103,4,4,0,1,0
24,114,114,10,10,0,1,0
19,127,127,16,2,14,3,2
30,141,141,10,10,0,1,0
13,142,142,8,8,0,1,0
8,144,144,7,7,0,1,0
20,150,150,3,3,0,1,0
10,155,155,9,6,3,2,1
31,172,172,2,2,0,1,0
2,197,197,30,30,0,1,0
26,206,206,35,22,13,4,3
1,232,232,13,1,12,3,2
17,257,257,38,38,0,1,0
28,270,270,24,24,0,1,0
12,270,270,51,8,43,4,3
23,287,287,7,7,0,1,0
11,293,293,6,3,3,2,1
21,330,330,219,186,33,4,3
0,331,331,13,13,0,1,0
27,335,335,2,2,0,1,0
25,357,357,56,2,54,3,2
14,358,358,121,58,63,4,3
9,358,358,31,31,0,1,0
15,380,380,29,9,20,4,3
33,381,381,4,4,0,1,0
22,402,402,8,2,6,3,2
16,402,402,36,21,15,4,3
32,414,414,20,20,0,1,0
18,415,415,19,19,0,1,0
29,415,415,33,33,0,1,0
4,447,447,11,11,0,1,0
5,447,447,19,19,0,1,0
3,456,456,35,35,0,1,0
6,463,463,28,4,24,3,2

5,121,121,7,2,5,2,1
7,127,127,7,4,3,2,1
8,140,140,2,2,0,1,0
26,145,145,10,2,8,2,1
9,150,150,17,17,0,1,0
17,169,169,10,7,3,2,1
22,196,196,7,7,0,1,0
10,217,217,9,3,6,3,2
16,229,229,11,11,0,1,0
21,230,230,11,3,8,2,1
1,232,232,2,2,0,1,0
14,242,242,34,34,0,1,0
29,247,247,39,39,0,1,0
15,248,248,20,8,12,2,1
0,255,255,22,22,0,1,0
18,293,293,12,8,4,2,1
20,296,296,17,17,0,1,0
32,298,298,45,45,0,1,0
3,317,317,69,69,0,1,0
2,342,342,9,3,6,2,1
24,373,373,22,9,13,2,1
19,379,379,34,34,0,1,0
4,384,384,14,14,0,1,0
13,388,388,55,37,18,3,2
11,392,392,104,104,0,1,0
27,404,404,60,46,14,3,2
28,425,425,17,17,0,1,0
12,427,427,48,39,9,4,3
23,463,463,14,14,0,1,0
25,466,466,85,37,48,4,3
6,476,476,74,58,16,2,1
31,488,488,131,123,8,3,2
30,490,490,89,89,0,1,0

19,134,134,17,9,8,2,1
17,143,143,32,1,31,3,2
0,157,157,23,2,21,2,1
32,169,169,32,32,0,1,0
33,179,179,28,28,0,1,0
24,186,186,15,1,14,3,2
15,188,188,5,1,4,2,1
27,191,191,3,3,0,1,0
26,204,204,37,5,32,3,2
2,215,215,1,1,0,1,0
11,252,252,12,3,9,2,1
1,276,276,30,30,0,1,0
29,277,277,20,6,14,3,2
7,302,302,3,3,0,1,0
31,302,302,4,4,0,1,0
28,303,303,22,5,17,2,1
25,318,318,34,3,31,2,1
4,359,359,28,28,0,1,0
21,366,366,82,82,0,1,0
23,409,409,38,33,5,2,1
22,415,415,29,2,27,2,1
14,423,423,7,3,4,2,1
6,423,423,115,46,69,4,3
16,426,426,79,79,0,1,0
10,435,435,3,3,0,1,0
9,437,437,5,1,4,2,1
8,442,442,5,5,0,1,0
18,443,443,49,49,0,1,0
30,459,459,34,10,24,3,2
3,466,466,40,40,0,1,0
13,466,466,34,34,0,1,0
12,471,471,5,5,0,1,0
20,491,491,18,18,0,1,0
5,498,498,141,76,65,4,3

7,104,104,5,5,0,1,0
1,119,119,24,24,0,1,0
22,119,119,14,14,0,1,0
20,120,120,6,6,0,1,0
23,125,125,10,4,6,2,1
17,139,139,37,37,0,1,0
18,161,161,19,19,0,1,0
14,187,187,12,12,0,1,0
15,261,261,118,62,56,3,2
12,274,274,12,12,0,1,0
6,278,278,20,20,0,1,0
8,280,280,28,7,21,4,3
19,284,284,44,35,9,2,1
3,290,290,78,49,29,2,1
13,301,301,1,1,0,1,0
5,302,302,10,10,0,1,0
25,323,323,5,5,0,1,0
29,324,324,9,9,0,1,0
26,343,343,61,19,42,4,3
21,371,371,53,17,36,4,3
11,382,382,13,13,0,1,0
0,387,387,17,5,12,2,1
31,396,396,35,6,29,2,1
2,439,439,56,56,0,1,0
9,442,442,19,19,0,1,0
16,443,443,80,46,34,4,3
30,444,444,1,1,0,1,0
24,459,459,22,22,0,1,0
27,461,461,46,46,0,1,0
4,462,462,13,13,0,1,0
10,472,472,18,7,11,2,1
28,476,476,31,16,15,3,2

15,108,108,13,13,0,1,0
26,116,116,8,4,4,2,1
25,116,116,30,30,0,1,0
34,120,120,19,3,16,2,1
21,128,128,6,6,0,1,0
36,129,129,4,1,3,2,1
7,133,133,5,2,3,2,1
35,135,135,27,4,23,2,1
3,149,149,8,8,0,1,0
23,154,154,14,4,10,2,1
13,158,158,31,31,0,1,0
8,176,176,3,3,0,1,0
17,231,231,20,14,6,2,1
16,248,248,58,58,0,1,0
0,276,276,18,18,0,1,0
24,286,286,14,6,8,3,2
28,297,297,17,17,0,1,0
30,315,315,49,49,0,1,0
1,319,319,10,6,4,2,1
33,331,331,49,31,18,2,1
32,333,333,43,43,0,1,0
9,334,334,4,1,3,2,1
2,337,337,26,19,7,2,1
18,344,344,7,7,0,1,0
12,355,355,23,23,0,1,0
29,420,420,14,14,0,1,0
4,423,423,57,9,48,3,2
22,434,434,47,47,0,1,0
5,443,443,23,13,10,3,2
20,445,445,41,12,29,2,1
31,449,449,11,11,0,1,0
19,449,449,58,58,0,1,0
10,462,462,18,18,0,1,0
27,470,470,44,12,32,2,1
11,481,481,8,8,0,1,0
6,482,482,28,28,0,1,0
14,496,496,31,25,6,2,1

8,103,103,21,21,0,1,0
19,128,128,27,18,9,2,1
3,130,130,5,5,0,1,0
11,139,139,14,14,0,1,0
17,149,149,13,13,0,1,0
23,159,159,2,2,0,1,0
9,172,172,4,4,0,1,0
4,196,196,31,12,19,2,1
25,199,199,8,8,0,1,0
1,209,209,93,16,77,4,3
0,222,222,96,9,87,4,3
2,241,241,11,11,0,1,0
21,248,248,3,3,0,1,0
16,263,263,2,2,0,1,0
14,307,307,21,21,0,1,0
12,312,312,17,5,12,4,3
13,357,357,60,25,35,2,1
10,359,359,14,3,11,2,1
15,371,371,31,31,0,1,0
7,374,374,56,11,45,2,1
20,383,383,116,26,90,4,3
6,470,470,9,1,8,2,1
22,470,470,2,2,0,1,0
5,472,472,22,6,16,3,2
18,474,474,118,72,46,3,2
26,481,481,37,37,0,1,0
24,493,493,77,33,44,3,2

11,137,137,3,3,0,1,0
14,152,152,3,3,0,1,0
4,164,164,71,14,57,4,3
15,189,189,26,26,0,1,0
18,196,196,2,2,0,1,0
26,208,208,48,34,14,2,1
3,235,235,33,33,0,1,0
16,237,237,12,4,8,3,2
12,244,244,22,22,0,1,0
1,248,248,11,7,4,2,1
21,251,251,4,4,0,1,0
28,255,255,28,8,20,2,1
0,262,262,18,18,0,1,0
7,262,262,3,3,0,1,0
10,270,270,12,8,4,2,1
24,275,275,51,37,14,3,2
17,279,279,13,13,0,1,0
29,298,298,48,48,0,1,0
2,306,306,1,1,0,1,0
27,312,312,10,2,8,3,2
22,358,358,92,92,0,1,0
19,360,360,39,9,30,3,2
23,374,374,28,14,14,3,2
8,385,385,40,3,37,2,1
13,415,415,27,27,0,1,0
6,450,450,114,114,0,1,0
30,452,452,3,3,0,1,0
5,466,466,116,70,46,2,1
20,481,481,51,1,50,4,3
9,489,489,26,26,0,1,0
25,493,493,45,45,0,1,0

2,102,102,22,1,21,2,1
15,116,116,8,2,6,2,1
32,126,126,2,2,0,1,0
17,145,145,5,5,0,1,0
24,145,145,3,3,0,1,0
6,170,170,6,6,0,1,0
13,187,187,12,12,0,1,0
1,196,196,1,1,0,1,0
20,200,200,2,2,0,1,0
18,266,266,49,49,0,1,0
0,274,274,16,7,9,2,1
16,278,278,25,5,20,3,2
8,278,278,25,3,22,3,2
19,288,288,3,3,0,1,0
9,291,291,10,10,0,1,0
26,305,305,12,3,9,4,3
10,311,311,23,20,3,2,1
3,330,330,63,63,0,1,0
11,332,332,2,2,0,1,0
22,333,333,4,1,3,2,1
33,337,337,121,121,0,1,0
31,341,341,17,7,10,3,2
27,342,342,154,80,74,3,2
23,360,360,3,3,0,1,0
25,360,360,76,45,31,3,2
30,376,376,28,21,7,2,1
7,387,387,98,5,93,4,3
5,408,408,21,15,6,3,2
12,418,418,80,41,39,2,1
4,461,461,13,13,0,1,0
21,466,466,55,14,41,2,1
14,470,470,52,7,45,2,1
28,486,486,1,1,0,1,0
29,496,496,33,17,16,3,2

3,102,102,6,6,0,1,0
30,116,116,16,16,0,1,0
17,125,125,1,1,0,1,0
5,150,150,11,2,9,2,1
1,164,164,21,21,0,1,0
20,169,169,11,2,9,2,1
18,175,175,6,6,0,1,0
24,179,179,3,3,0,1,0
6,191,191,16,16,0,1,0
22,195,195,35,23,12,4,3
16,201,201,3,3,0,1,0
33,209,209,24,24,0,1,0
7,210,210,3,3,0,1,0
26,227,227,7,2,5,2,1
13,228,228,22,13,9,4,3
14,231,231,1,1,0,1,0
12,250,250,33,33,0,1,0
8,259,259,26,26,0,1,0
34,260,260,52,26,26,3,2
28,282,282,38,15,23,2,1
10,313,313,60,32,28,2,1
35,315,315,56,10,46,3,2
11,318,318,8,5,3,2,1
19,320,320,29,29,0,1,0
25,332,332,10,1,9,2,1
21,347,347,31,31,0,1,0
9,356,356,91,43,48,3,2
32,363,363,82,50,32,3,2
27,373,373,47,26,21,2,1
2,373,373,19,10,9,4,3
23,393,393,16,16,0,1,0
4,394,394,25,7,18,2,1
0,452,452,40,34,6,3,2
31,453,453,29,29,0,1,0
29,475,475,1,1,0,1,0
15,480,480,41,41,0,1,0

11,103,103,1,1,0,1,0
12,104,104,1,1,0,1,0
8,117,117,18,2,16,4,3
5,129,129,8,5,3,2,1
26,181,181,2,2,0,1,0
18,205,205,24,6,18,3,2
29,218,218,16,16,0,1,0
25,228,228,34,34,0,1,0
13,229,229,42,42,0,1,0
6,234,234,17,11,6,2,1
23,234,234,33,33,0,1,0
3,246,246,12,9,3,2,1
27,260,260,43,8,35,2,1
20,283,283,31,31,0,1,0
19,299,299,31,31,0,1,0
15,312,312,37,21,16,3,2
24,318,318,1,1,0,1,0
30,345,345,3,3,0,1,0
9,348,348,54,9,45,2,1
22,358,358,13,13,0,1,0
14,395,395,63,37,26,3,2
16,399,399,36,36,0,1,0
10,408,408,70,70,0,1,0
7,411,411,3,3,0,1,0
0,419,419,30,5,25,4,3
4,464,464,114,114,0,1,0
21,466,466,218,161,57,4,3
1,478,478,22,6,16,2,1
17,488,488,9,1,8,2,1
28,490,490,17,1,16,3,2
2,493,493,43,43,0,1,0
31,495,495,45,45,0,1,0

6,115,115,8,8,0,1,0
9,117,117,17,3,14,3,2
0,122,122,1,1,0,1,0
33,125,125,6,6,0,1,0
3,138,138,12,12,0,1,0
36,140,140,1,1,0,1,0
18,142,142,1,1,0,1,0
8,144,144,3,3,0,1,0
19,146,146,2,2,0,1,0
38,151,151,16,2,14,2,1
13,152,152,13,13,0,1,0
14,168,168,5,2,3,2,1
21,219,219,41,19,22,2,1
27,228,228,1,1,0,1,0
17,235,235,24,24,0,1,0
2,252,252,9,9,0,1,0
37,261,261,30,30,0,1,0
12,272,272,11,11,0,1,0
16,305,305,55,17,38,2,1
28,322,322,78,59,19,2,1
23,324,324,96,43,53,4,3
31,327,327,4,4,0,1,0
29,334,334,13,13,0,1,0
10,342,342,11,3,8,2,1
35,343,343,16,16,0,1,0
20,359,359,28,28,0,1,0
34,360,360,11,5,6,2,1
26,373,373,64,17,47,2,1
30,378,378,40,25,15,4,3
5,386,386,54,38,16,3,2
7,387,387,1,1,0,1,0
1,397,397,23,23,0,1,0
25,454,454,29,13,16,3,2
22,460,460,40,40,0,1,0
32,466,466,52,52,0,1,0
15,479,479,34,34,0,1,0
24,491,491,113,98,15,4,3
11,498,498,29,11,18,3,2
4,499,499,31,31,0,1,0

8,108,108,5,5,0,1,0
24,109,109,42,42,0,1,0
26,114,114,9,3,6,3,2
10,117,117,5,5,0,1,0
21,129,129,9,9,0,1,0
34,136,136,15,11,4,2,1
2,146,146,4,1,3,2,1
33,150,150,4,4,0,1,0
25,162,162,20,20,0,1,0
31,188,188,2,2,0,1,0
32,198,198,11,11,0,1,0
36,208,208,28,28,0,1,0
22,209,209,10,1,9,2,1
0,212,212,3,3,0,1,0
19,212,212,14,14,0,1,0
30,214,214,30,24,6,2,1
3,216,216,11,11,0,1,0
37,226,226,7,7,0,1,0
5,231,231,4,1,3,2,1
7,233,233,62,62,0,1,0
16,235,235,10,1,9,4,3
11,254,254,43,7,36,4,3
17,265,265,15,15,0,1,0
9,277,277,14,5,9,4,3
15,303,303,24,20,4,2,1
1,332,332,37,37,0,1,0
13,335,335,4,4,0,1,0
23,338,338,4,4,0,1,0
12,355,355,25,25,0,1,0
4,362,362,10,10,0,1,0
6,368,368,101,1,100,3,2
18,372,372,8,8,0,1,0
20,377,377,25,3,22,3,2
28,428,428,58,32,26,4,3
29,448,448,17,17,0,1,0
35,471,471,121,85,36,3,2
27,476,476,25,25,0,1,0
14,478,478,9,9,0,1,0

28,107,107,7,7,0,1,0
6,147,147,2,2,0,1,0
4,152,152,1,1,0,1,0
31,175,175,10,10,0,1,0
26,195,195,10,6,4,2,1
22,208,208,60,3,57,3,2
29,262,262,30,30,0,1,0
32,274,274,5,5,0,1,0
1,277,277,6,1,5,2,1
17,282,282,5,5,0,1,0
10,289,289,32,16,16,3,2
30,313,313,56,3,53,4,3
14,325,325,1,1,0,1,0
36,326,326,17,17,0,1,0
13,331,331,107,25,82,3,2
9,333,333,33,26,7,2,1
3,336,336,11,11,0,1,0
24,346,346,52,7,45,4,3
33,348,348,56,56,0,1,0
8,356,356,34,5,29,2,1
25,358,358,59,59,0,1,0
27,373,373,34,10,24,4,3
16,375,375,45,3,42,3,2
12,377,377,20,20,0,1,0
5,390,390,21,3,18,4,3
34,408,408,13,13,0,1,0
18,415,415,24,2,22,2,1
21,416,416,19,19,0,1,0
20,420,420,5,5,0,1,0
35,437,437,29,17,12,4,3
37,444,444,25,1,24,4,3
19,444,444,4,4,0,1,0
11,449,449,34,2,32,3,2
0,457,457,4,4,0,1,0
2,460,460,83,11,72,4,3
23,463,463,38,38,0,1,0
15,471,471,17,17,0,1,0
7,496,496,111,111,0,1,0

17,105,105,12,6,6,2,1
19,108,108,24,3,21,2,1
21,113,113,14,14,0,1,0
26,120,120,13,2,11,2,1
25,135,135,8,8,0,1,0
27,146,146,22,2,20,3,2
22,157,157,9,1,8,2,1
0,160,160,1,1,0,1,0
4,177,177,7,7,0,1,0
18,189,189,14,14,0,1,0
30,219,219,6,6,0,1,0
6,247,247,21,13,8,3,2
2,276,276,16,7,9,4,3
1,285,285,17,7,10,3,2
15,292,292,7,7,0,1,0
23,302,302,45,45,0,1,0
32,305,305,118,67,51,4,3
28,319,319,29,17,12,3,2
8,322,322,95,95,0,1,0
9,334,334,66,66,0,1,0
14,339,339,35,29,6,2,1
20,352,352,11,5,6,3,2
7,352,352,28,28,0,1,0
29,365,365,2,2,0,1,0
11,381,381,104,54,50,4,3
16,419,419,33,33,0,1,0
10,436,436,10,10,0,1,0
13,458,458,41,25,16,3,2
12,476,476,77,67,10,2,1
5,487,487,11,11,0,1,0
3,494,494,2,2,0,1,0
31,496,496,21,21,0,1,0
24,498,498,1,1,0,1,0

30,114,114,3,3,0,1,0
19,143,143,30,30,0,1,0
29,146,146,39,39,0,1,0
16,146,146,7,1,6,3,2
3,151,151,2,2,0,1,0
9,151,151,7,7,0,1,0
21,180,180,27,1,26,2,1
25,181,181,8,8,0,1,0
14,198,198,3,3,0,1,0
26,213,213,7,7,0,1,0
27,223,223,4,4,0,1,0
5,234,234,42,42,0,1,0
2,244,244,5,2,3,2,1
32,266,266,29,26,3,2,1
6,268,268,45,45,0,1,0
10,278,278,24,24,0,1,0
7,300,300,12,12,0,1,0
8,301,301,47,47,0,1,0
15,308,308,1,1,0,1,0
33,312,312,19,19,0,1,0
28,329,329,61,61,0,1,0
24,346,346,1,1,0,1,0
11,348,348,15,15,0,1,0
12,355,355,21,21,0,1,0
18,369,369,86,86,0,1,0
13,375,375,17,17,0,1,0
17,424,424,59,38,21,4,3
1,427,427,4,4,0,1,0
23,437,437,8,8,0,1,0
22,463,463,26,8,18,3,2
20,468,468,53,11,42,4,3
0,476,476,71,71,0,1,0
34,482,482,95,87,8,2,1
4,486,486,71,71,0,1,0
31,487,487,71,17,54,4,3

3,101,101,4,1,3,2,1
31,106,106,4,4,0,1,0
6,135,135,13,3,10,3,2
7,159,159,9,9,0,1,0
1,165,165,11,11,0,1,0
26,166,166,3,3,0,1,0
33,209,209,29,29,0,1,0
15,219,219,28,28,0,1,0
16,228,228,1,1,0,1,0
14,240,240,4,4,0,1,0
20,244,244,127,127,0,1,0
8,245,245,26,26,0,1,0
0,246,246,48,33,15,2,1
30,255,255,30,20,10,3,2
12,273,273,32,10,22,3,2
4,274,274,14,14,0,1,0
23,286,286,30,30,0,1,0
2,305,305,10,5,5,2,1
17,307,307,56,8,48,4,3
10,315,315,28,23,5,2,1
22,322,322,7,1,6,3,2
13,345,345,6,6,0,1,0
5,352,352,91,67,24,4,3
9,386,386,37,13,24,4,3
29,386,386,12,12,0,1,0
19,392,392,54,18,36,3,2
21,392,392,44,3,41,2,1
24,394,394,33,28,5,2,1
32,414,414,69,9,60,4,3
27,445,445,6,6,0,1,0
28,452,452,8,1,7,3,2
18,460,460,6,6,0,1,0
11,492,492,23,11,12,3,2
25,500,500,43,43,0,1,0

11,103,103,7,7,0,1,0
3,109,109,12,5,7,2,1
16,112,112,1,1,0,1,0
29,114,114,16,16,0,1,0
32,126,126,14,4,10,3,2
25,127,127,36,22,14,3,2
24,147,147,1,1,0,1,0
9,148,148,9,3,6,3,2
21,151,151,7,7,0,1,0
22,156,156,29,29,0,1,0
18,174,174,5,5,0,1,0
1,183,183,12,3,9,4,3
30,188,188,1,1,0,1,0
14,191,191,1,1,0,1,0
4,194,194,25,4,21,4,3
15,207,207,18,18,0,1,0
2,231,231,13,2,11,2,1
0,259,259,1,1,0,1,0
27,286,286,30,17,13,4,3
20,290,290,50,50,0,1,0
7,293,293,6,3,3,2,1
28,302,302,7,7,0,1,0
8,304,304,27,8,19,2,1
13,307,307,127,127,0,1,0
23,391,391,7,7,0,1,0
31,391,391,74,26,48,4,3
17,395,395,84,84,0,1,0
5,402,402,42,42,0,1,0
6,452,452,100,25,75,4,3
10,462,462,54,6,48,3,2
12,468,468,21,21,0,1,0
26,471,471,50,14,36,4,3
19,475,475,1,1,0,1,0

20,107,107,3,3,0,1,0
14,116,116,22,22,0,1,0
6,124,124,6,1,5,2,1
0,153,153,4,4,0,1,0
5,176,176,9,5,4,2,1
18,179,179,35,10,25,2,1
2,196,196,57,12,45,2,1
3,212,212,70,9,61,4,3
17,214,214,16,2,14,2,1
27,220,220,8,8,0,1,0
30,222,222,20,2,18,3,2
10,233,233,23,23,0,1,0
25,236,236,16,7,9,2,1
16,254,254,25,6,19,2,1
31,261,261,15,10,5,2,1
4,261,261,4,4,0,1,0
22,282,282,61,12,49,4,3
21,289,289,2,2,0,1,0
15,291,291,29,29,0,1,0
23,294,294,6,6,0,1,0
11,306,306,3,3,0,1,0
13,314,314,14,14,0,1,0
19,343,343,24,24,0,1,0
29,353,353,101,47,54,4,3
8,366,366,31,31,0,1,0
7,377,377,14,14,0,1,0
1,422,422,75,75,0,1,0
12,425,425,1,1,0,1,0
24,432,432,25,25,0,1,0
9,436,436,41,41,0,1,0
26,476,476,103,103,0,1,0
28,498,498,52,40,12,2,1

2,114,114,12,12,0,1,0
8,132,132,20,10,10,2,1
29,165,165,2,2,0,1,0
17,180,180,42,2,40,2,1
6,192,192,26,26,0,1,0
13,202,202,14,14,0,1,0
16,203,203,24,10,14,3,2
23,213,213,44,44,0,1,0
11,237,237,9,9,0,1,0
9,244,244,41,41,0,1,0
18,248,248,31,31,0,1,0
30,264,264,6,6,0,1,0
20,271,271,21,21,0,1,0
3,279,279,4,1,3,2,1
28,291,291,32,17,15,4,3
27,292,292,5,5,0,1,0
5,323,323,59,17,42,4,3
26,350,350,88,58,30,2,1
0,376,376,29,29,0,1,0
22,385,385,8,8,0,1,0
31,387,387,12,12,0,1,0
25,408,408,88,9,79,4,3
14,410,410,82,19,63,4,3
4,411,411,56,56,0,1,0
24,416,416,13,13,0,1,0
12,417,417,99,9,90,4,3
19,419,419,21,13,8,2,1
15,446,446,15,1,14,3,2
21,452,452,49,5,44,3,2
10,455,455,3,3,0,1,0
7,460,460,12,12,0,1,0
1,490,490,10,10,0,1,0

22,101,101,2,2,0,1,0
4,101,101,1,1,0,1,0
27,106,106,6,6,0,1,0
23,122,122,6,6,0,1,0
32,123,123,8,8,0,1,0
7,129,129,14,14,0,1,0
18,140,140,8,8,0,1,0
8,147,147,1,1,0,1,0
9,167,167,8,5,3,2,1
14,183,183,23,13,10,2,1
13,184,184,11,3,8,2,1
2,191,191,32,6,26,3,2
10,198,198,8,5,3,2,1
12,198,198,18,5,13,2,1
5,207,207,4,4,0,1,0
30,223,223,37,37,0,1,0
17,256,256,16,3,13,2,1
31,271,271,4,4,0,1,0
26,273,273,40,37,3,2,1
24,283,283,50,36,14,3,2
28,287,287,21,21,0,1,0
25,315,315,45,29,16,2,1
19,316,316,84,84,0,1,0
6,325,325,49,49,0,1,0
15,354,354,38,31,7,2,1
0,367,367,82,28,54,3,2
11,377,377,1,1,0,1,0
29,396,396,13,9,4,2,1
21,476,476,68,68,0,1,0
20,477,477,81,81,0,1,0
3,478,478,100,58,42,4,3
16,491,491,13,13,0,1,0
1,494,494,101,72,29,2,1

6,118,118,19,7,12,3,2
20,121,121,6,6,0,1,0
33,154,154,3,3,0,1,0
22,189,189,16,4,12,3,2
13,210,210,7,7,0,1,0
16,211,211,1,1,0,1,0
9,222,222,3,3,0,1,0
18,229,229,20,3,17,2,1
3,238,238,15,15,0,1,0
34,247,247,11,11,0,1,0
28,249,249,11,11,0,1,0
7,251,251,30,30,0,1,0
10,256,256,20,20,0,1,0
32,263,263,80,80,0,1,0
12,266,266,8,8,0,1,0
24,292,292,18,2,16,4,3
5,330,330,10,2,8,2,1
1,333,333,52,34,18,3,2
15,339,339,12,12,0,1,0
25,346,346,43,38,5,2,1
27,377,377,53,53,0,1,0
0,379,379,34,34,0,1,0
26,382,382,5,5,0,1,0
19,383,383,29,5,24,2,1
2,393,393,8,3,5,2,1
31,399,399,64,36,28,2,1
29,406,406,64,64,0,1,0
21,418,418,53,33,20,2,1
17,436,436,124,37,87,4,3
35,449,449,66,24,42,3,2
23,461,461,64,55,9,2,1
4,466,466,25,25,0,1,0
8,475,475,52,45,7,2,1
14,476,476,25,25,0,1,0
30,479,479,18,3,15,3,2
11,484,484,29,29,0,1,0
36,499,499,13,13,0,1,0

23,101,101,1,1,0,1,0
7,113,113,10,10,0,1,0
30,115,115,2,2,0,1,0
28,125,125,15,15,0,1,0
4,127,127,5,1,4,2,1
35,137,137,25,25,0,1,0
29,156,156,26,26,0,1,0
12,183,183,2,2,0,1,0
21,188,188,4,4,0,1,0
18,221,221,29,29,0,1,0
19,242,242,10,2,8,2,1
34,274,274,40,40,0,1,0
17,275,275,33,33,0,1,0
26,281,281,69,27,42,2,1
3,284,284,14,14,0,1,0
6,285,285,14,14,0,1,0
33,285,285,1,1,0,1,0
8,292,292,23,18,5,2,1
36,298,298,42,10,32,3,2
16,303,303,36,4,32,2,1
5,307,307,16,16,0,1,0
25,316,316,33,13,20,2,1
2,321,321,17,17,0,1,0
15,322,322,9,9,0,1,0
9,329,329,2,2,0,1,0
27,356,356,53,53,0,1,0
20,360,360,20,20,0,1,0
11,367,367,7,7,0,1,0
1,392,392,49,33,16,2,1
31,392,392,28,15,13,2,1
13,395,395,5,5,0,1,0
22,399,399,68,53,15,4,3
24,414,414,10,10,0,1,0
14,416,416,49,2,47,2,1
0,446,446,156,120,36,2,1
32,477,477,31,31,0,1,0
10,486,486,27,27,0,1,0

32,149,149,17,3,14,3,2
26,151,151,1,1,0,1,0
27,171,171,6,6,0,1,0
9,175,175,2,2,0,1,0
21,184,184,37,37,0,1,0
8,220,220,38,3,35,3,2
6,225,225,3,3,0,1,0
25,226,226,23,3,20,3,2
5,229,229,9,3,6,2,1
14,260,260,16,16,0,1,0
22,266,266,29,3,26,2,1
31,278,278,23,7,16,2,1
17,278,278,13,13,0,1,0
29,313,313,11,1,10,3,2
3,320,320,109,43,66,4,3
23,323,323,4,4,0,1,0
30,327,327,47,47,0,1,0
20,335,335,92,40,52,3,2
0,338,338,20,20,0,1,0
11,352,352,24,24,0,1,0
15,356,356,49,28,21,2,1
10,363,363,36,16,20,3,2
2,366,366,45,45,0,1,0
4,389,389,22,22,0,1,0
16,397,397,108,108,0,1,0
7,400,400,15,6,9,4,3
1,416,416,4,4,0,1,0
19,432,432,20,8,12,3,2
13,435,435,41,9,32,2,1
24,464,464,26,26,0,1,0
18,472,472,126,75,51,4,3
28,489,489,49,49,0,1,0
12,494,494,2,2,0,1,0

28,145,145,16,16,0,1,0
32,182,182,3,3,0,1,0
14,202,202,31,31,0,1,0
30,207,207,61,51,10,2,1
27,212,212,25,25,0,1,0
7,213,213,17,8,9,2,1
16,231,231,76,76,0,1,0
33,237,237,39,39,0,1,0
13,241,241,4,4,0,1,0
23,243,243,2,2,0,1,0
5,282,282,8,2,6,2,1
2,289,289,18,6,12,2,1
17,311,311,20,20,0,1,0
34,312,312,10,10,0,1,0
26,312,312,41,41,0,1,0
10,317,317,102,60,42,4,3
22,319,319,9,9,0,1,0
18,325,325,5,5,0,1,0
4,329,329,2,2,0,1,0
15,345,345,21,11,10,2,1
0,353,353,3,3,0,1,0
9,363,363,28,28,0,1,0
24,365,365,33,33,0,1,0
31,371,371,11,5,6,2,1
12,382,382,25,25,0,1,0
8,385,385,64,64,0,1,0
6,386,386,3,3,0,1,0
11,393,393,23,23,0,1,0
3,410,410,14,5,9,4,3
25,437,437,16,16,0,1,0
20,444,444,38,38,0,1,0
1,459,459,21,21,0,1,0
29,475,475,122,122,0,1,0
21,482,482,13,13,0,1,0
19,495,495,99,21,78,4,3

34,104,104,10,10,0,1,0
11,105,105,2,2,0,1,0
4,106,106,2,2,0,1,0
37,128,128,27,7,20,3,2
8,142,142,30,30,0,1,0
26,153,153,1,1,0,1,0
27,155,155,33,33,0,1,0
19,168,168,29,17,12,3,2
16,172,172,6,6,0,1,0
18,182,182,9,4,5,2,1
28,187,187,5,5,0,1,0
42,193,193,4,4,0,1,0
9,202,202,26,26,0,1,0
2,206,206,7,7,0,1,0
3,206,206,18,7,11,3,2
15,209,209,1,1,0,1,0
17,215,215,4,4,0,1,0
38,216,216,53,17,36,4,3
29,242,242,22,6,16,2,1
6,252,252,24,15,9,4,3
21,254,254,1,1,0,1,0
36,255,255,18,10,8,3,2
1,290,290,28,3,25,2,1
22,296,296,25,12,13,2,1
41,313,313,69,15,54,3,2
10,348,348,18,18,0,1,0
13,348,348,24,24,0,1,0
25,367,367,37,37,0,1,0
20,377,377,23,13,10,2,1
7,377,377,13,3,10,2,1
30,400,400,60,60,0,1,0
23,402,402,8,4,4,2,1
14,410,410,12,12,0,1,0
24,411,411,15,15,0,1,0
35,413,413,24,24,0,1,0
33,416,416,46,46,0,1,0
12,422,422,36,36,0,1,0
32,428,428,3,3,0,1,0
40,452,452,5,5,0,1,0
31,461,461,15,10,5,2,1
5,470,470,18,18,0,1,0
39,470,470,30,30,0,1,0
0,475,475,6,3,3,2,1

6,111,111,18,18,0,1,0
20,121,121,19,14,5,2,1
24,146,146,5,5,0,1,0
26,202,202,7,7,0,1,0
2,204,204,42,17,25,2,1
12,220,220,31,31,0,1,0
17,237,237,1,1,0,1,0
21,252,252,11,4,7,2,1
16,270,270,4,4,0,1,0
25,271,271,19,1,18,4,3
8,300,300,3,3,0,1,0
27,310,310,2,2,0,1,0
15,322,322,3,3,0,1,0
7,349,349,51,51,0,1,0
5,352,352,23,23,0,1,0
9,356,356,91,91,0,1,0
18,369,369,57,33,24,4,3
11,370,370,47,47,0,1,0
22,372,372,62,62,0,1,0
19,388,388,76,32,44,2,1
3,400,400,28,28,0,1,0
23,417,417,21,3,18,3,2
10,420,420,80,59,21,2,1
0,421,421,109,54,55,3,2
1,439,439,37,37,0,1,0
4,467,467,12,8,4,2,1
13,484,484,15,3,12,4,3
14,492,492,254,254,0,1,0

27,102,102,7,1,6,2,1
35,112,112,31,13,18,3,2
2,113,113,9,9,0,1,0
34,141,141,12,12,0,1,0
22,146,146,12,3,9,2,1
17,147,147,24,24,0,1,0
18,153,153,18,18,0,1,0
25,168,168,18,10,8,2,1
28,174,174,25,25,0,1,0
32,175,175,14,8,6,2,1
19,175,175,2,2,0,1,0
0,220,220,3,3,0,1,0
24,220,220,57,36,21,4,3
16,223,223,4,4,0,1,0
4,230,230,1,1,0,1,0
29,233,233,2,2,0,1,0
12,240,240,1,1,0,1,0
21,247,247,41,41,0,1,0
15,266,266,5,5,0,1,0
13,279,279,45,45,0,1,0
9,306,306,15,15,0,1,0
7,312,312,1,1,0,1,0
23,313,313,41,18,23,2,1
33,321,321,14,14,0,1,0
1,321,321,4,1,3,2,1
10,345,345,49,49,0,1,0
20,364,364,1,1,0,1,0
8,368,368,41,41,0,1,0
11,372,372,111,73,38,3,2
30,378,378,37,23,14,3,2
3,389,389,66,48,18,3,2
6,410,410,14,14,0,1,0
31,424,424,26,18,8,3,2
26,430,430,9,9,0,1,0
5,431,431,73,18,55,3,2
14,468,468,9,6,3,2,1

6,109,109,1,1,0,1,0
35,113,113,3,3,0,1,0
19,118,118,1,1,0,1,0
11,118,118,15,15,0,1,0
22,134,134,14,14,0,1,0
30,153,153,11,6,5,2,1
9,156,156,1,1,0,1,0
36,159,159,11,11,0,1,0
29,164,164,41,41,0,1,0
21,184,184,4,4,0,1,0
18,192,192,40,40,0,1,0
27,201,201,19,2,17,4,3
13,203,203,3,3,0,1,0
15,205,205,1,1,0,1,0
28,212,212,10,10,0,1,0
33,217,217,6,6,0,1,0
1,273,273,2,2,0,1,0
3,274,274,58,58,0,1,0
7,291,291,6,6,0,1,0
26,297,297,23,6,17,2,1
2,300,300,5,5,0,1,0
16,303,303,44,44,0,1,0
12,304,304,4,4,0,1,0
0,309,309,18,6,12,4,3
32,318,318,74,74,0,1,0
8,321,321,26,19,7,2,1
31,346,346,15,15,0,1,0
14,347,347,24,24,0,1,0
4,350,350,26,26,0,1,0
25,413,413,28,10,18,3,2
17,414,414,113,68,45,4,3
34,420,420,100,10,90,4,3
20,461,461,5,5,0,1,0
23,475,475,36,36,0,1,0
5,488,488,8,8,0,1,0
24,496,496,94,22,72,4,3
10,497,497,111,62,49,2,1

4,101,101,23,23,0,1,0
0,132,132,12,12,0,1,0
26,143,143,63,45,18,4,3
25,153,153,7,7,0,1,0
27,185,185,3,3,0,1,0
16,190,190,2,2,0,1,0
7,206,206,9,9,0,1,0
11,226,226,1,1,0,1,0
13,237,237,46,46,0,1,0
31,260,260,16,16,0,1,0
23,262,262,40,33,7,2,1
20,263,263,10,3,7,2,1
24,266,266,21,7,14,3,2
6,279,279,18,2,16,3,2
2,288,288,1,1,0,1,0
1,298,298,60,60,0,1,0
3,320,320,23,23,0,1,0
9,334,334,3,3,0,1,0
17,353,353,18,11,7,2,1
32,358,358,4,4,0,1,0
30,378,378,74,74,0,1,0
29,383,383,9,9,0,1,0
18,387,387,26,23,3,2,1
21,397,397,37,37,0,1,0
10,403,403,52,6,46,3,2
28,406,406,8,8,0,1,0
5,418,418,88,88,0,1,0
14,419,419,64,64,0,1,0
8,424,424,43,34,9,2,1
19,464,464,93,93,0,1,0
15,481,481,19,19,0,1,0
12,482,482,22,8,14,3,2
22,489,489,61,19,42,4,3

9,144,144,21,5,16,3,2
14,149,149,6,6,0,1,0
17,164,164,12,3,9,4,3
16,173,173,6,1,5,2,1
18,174,174,8,8,0,1,0
11,191,191,43,18,25,4,3
26,197,197,84,33,51,4,3
6,200,200,9,6,3,2,1
13,208,208,24,11,13,2,1
27,222,222,10,10,0,1,0
25,224,224,53,28,25,4,3
8,255,255,16,7,9,2,1
3,256,256,23,3,20,2,1
4,261,261,25,25,0,1,0
2,280,280,44,14,30,4,3
5,283,283,26,26,0,1,0
23,287,287,19,3,16,3,2
0,334,334,26,1,25,2,1
12,341,341,26,26,0,1,0
15,378,378,30,30,0,1,0
1,387,387,83,83,0,1,0
22,402,402,17,17,0,1,0
21,408,408,28,28,0,1,0
7,420,420,139,94,45,4,3
20,479,479,88,59,29,2,1
10,486,486,32,19,13,2,1
24,487,487,31,31,0,1,0
19,500,500,17,17,0,1,0

29,111,111,46,46,0,1,0
23,127,127,3,3,0,1,0
16,138,138,2,2,0,1,0
24,141,141,12,12,0,1,0
4,175,175,9,9,0,1,0
3,211,211,14,9,5,2,1
17,211,211,18,18,0,1,0
12,231,231,22,12,10,2,1
2,241,241,21,21,0,1,0
18,248,248,32,14,18,3,2
21,253,253,52,52,0,1,0
0,257,257,16,1,15,4,3
11,260,260,35,35,0,1,0
5,301,301,4,1,3,2,1
13,315,315,7,7,0,1,0
8,320,320,76,76,0,1,0
28,331,331,52,52,0,1,0
9,347,347,71,61,10,3,2
26,348,348,22,6,16,3,2
1,403,403,28,28,0,1,0
14,406,406,61,61,0,1,0
27,414,414,11,3,8,3,2
6,427,427,15,11,4,2,1
10,446,446,70,35,35,3,2
7,446,446,96,1,95,4,3
22,451,451,52,34,18,4,3
30,458,458,9,9,0,1,0
25,467,467,47,25,22,2,1
19,486,486,27,27,0,1,0
20,492,492,26,6,20,3,2
15,499,499,41,41,0,1,0

6,107,107,5,5,0,1,0
27,121,121,27,27,0,1,0
10,122,122,4,4,0,1,0
21,142,142,7,7,0,1,0
2,153,153,30,30,0,1,0
16,184,184,15,2,13,2,1
26,189,189,13,13,0,1,0
33,197,197,43,29,14,2,1
25,235,235,32,20,12,3,2
31,239,239,50,50,0,1,0
7,270,270,10,10,0,1,0
19,271,271,17,3,14,2,1
32,284,284,10,10,0,1,0
3,293,293,3,3,0,1,0
5,294,294,1,1,0,1,0
11,295,295,44,44,0,1,0
18,295,295,12,12,0,1,0
4,302,302,43,43,0,1,0
9,327,327,47,47,0,1,0
24,341,341,47,47,0,1,0
20,342,342,23,1,22,3,2
12,360,360,12,12,0,1,0
15,363,363,4,4,0,1,0
0,373,373,16,16,0,1,0
23,383,383,18,4,14,4,3
1,387,387,83,66,17,2,1
30,388,388,29,29,0,1,0
17,393,393,36,36,0,1,0
8,396,396,2,2,0,1,0
29,415,415,24,20,4,2,1
28,430,430,70,54,16,3,2
22,446,446,18,18,0,1,0
14,457,457,55,28,27,4,3
13,463,463,111,72,39,4,3

16,113,113,13,13,0,1,0
4,137,137,31,25,6,2,1
29,146,146,6,1,5,2,1
5,146,146,3,3,0,1,0
21,158,158,5,5,0,1,0
0,162,162,5,2,3,2,1
23,162,162,6,6,0,1,0
7,183,183,39,39,0,1,0
20,194,194,14,14,0,1,0
9,197,197,2,2,0,1,0
18,199,199,54,54,0,1,0
8,214,214,12,12,0,1,0
11,215,215,3,3,0,1,0
2,218,218,13,3,10,3,2
6,222,222,14,14,0,1,0
10,247,247,18,18,0,1,0
27,262,262,1,1,0,1,0
19,264,264,62,28,34,3,2
3,312,312,50,50,0,1,0
1,330,330,17,17,0,1,0
22,341,341,40,2,38,3,2
30,343,343,35,2,33,2,1
15,349,349,9,1,8,2,1
17,353,353,2,2,0,1,0
26,360,360,11,5,6,3,2
24,414,414,83,72,11,3,2
31,430,430,80,80,0,1,0
28,450,450,26,26,0,1,0
32,454,454,68,68,0,1,0
14,458,458,60,9,51,4,3
25,462,462,42,28,14,3,2
13,477,477,53,53,0,1,0
12,497,497,119,17,102,4,3

1,109,109,9,6,3,2,1
34,122,122,8,8,0,1,0
25,122,122,2,2,0,1,0
31,137,137,42,1,41,2,1
12,153,153,12,2,10,2,1
9,167,167,17,17,0,1,0
33,191,191,8,8,0,1,0
19,195,195,20,20,0,1,0
4,202,202,14,14,0,1,0
32,222,222,7,7,0,1,0
13,232,232,10,10,0,1,0
24,244,244,37,37,0,1,0
15,253,253,1,1,0,1,0
21,255,255,35,24,11,2,1
16,257,257,64,64,0,1,0
27,282,282,103,103,0,1,0
29,285,285,29,23,6,2,1
8,321,321,28,16,12,2,1
17,322,322,21,21,0,1,0
28,341,341,61,61,0,1,0
5,364,364,95,95,0,1,0
22,364,364,34,34,0,1,0
23,375,375,3,3,0,1,0
7,400,400,14,14,0,1,0
11,406,406,17,17,0,1,0
0,414,414,46,19,27,4,3
10,415,415,18,18,0,1,0
14,419,419,5,5,0,1,0
30,454,454,8,5,3,2,1
2,464,464,120,73,47,3,2
26,464,464,7,2,5,2,1
20,476,476,2,2,0,1,0
3,484,484,2,2,0,1,0
18,487,487,17,3,14,4,3
6,494,494,9,1,8,3,2

8,101,101,3,3,0,1,0
28,112,112,8,3,5,2,1
30,113,113,11,2,9,4,3
1,129,129,1,1,0,1,0
29,137,137,41,7,34,2,1
7,142,142,15,3,12,4,3
24,146,146,39,2,37,4,3
33,146,146,4,1,3,2,1
5,158,158,4,1,3,2,1
9,159,159,18,18,0,1,0
12,162,162,6,6,0,1,0
17,165,165,11,11,0,1,0
32,191,191,46,46,0,1,0
26,194,194,4,4,0,1,0
36,195,195,16,7,9,4,3
19,207,207,35,3,32,2,1
15,209,209,20,10,10,2,1
20,227,227,5,5,0,1,0
11,229,229,3,3,0,1,0
34,256,256,9,1,8,2,1
27,270,270,26,7,19,2,1
13,272,272,8,8,0,1,0
4,275,275,18,18,0,1,0
23,280,280,5,5,0,1,0
0,280,280,24,24,0,1,0
18,293,293,1,1,0,1,0
39,314,314,7,2,5,2,1
21,339,339,13,13,0,1,0
37,343,343,31,13,18,3,2
10,344,344,2,2,0,1,0
2,353,353,1,1,0,1,0
3,358,358,4,4,0,1,0
38,376,376,3,3,0,1,0
14,394,394,22,10,12,4,3
16,399,399,15,15,0,1,0
6,440,440,179,87,92,3,2
25,453,453,5,5,0,1,0
31,487,487,23,23,0,1,0
35,497,497,113,92,21,4,3
22,500,500,78,78,0,1,0

4,104,104,1,1,0,1,0
9,104,104,1,1,0,1,0
19,116,116,17,17,0,1,0
3,120,120,14,2,12,2,1
6,125,125,8,8,0,1,0
15,141,141,17,17,0,1,0
1,150,150,3,3,0,1,0
25,152,152,11,11,0,1,0
2,152,152,2,2,0,1,0
12,174,174,17,6,11,4,3
5,177,177,18,18,0,1,0
13,178,178,48,14,34,4,3
17,178,178,7,7,0,1,0
11,185,185,38,38,0,1,0
30,193,193,1,1,0,1,0
8,226,226,25,25,0,1,0
16,227,227,18,18,0,1,0
31,264,264,5,5,0,1,0
7,268,268,72,12,60,4,3
10,310,310,23,23,0,1,0
27,328,328,5,5,0,1,0
26,334,334,73,73,0,1,0
32,346,346,77,56,21,2,1
14,348,348,9,9,0,1,0
18,375,375,5,2,3,2,1
20,393,393,28,28,0,1,0
0,412,412,7,7,0,1,0
29,434,434,49,49,0,1,0
21,448,448,31,18,13,2,1
22,455,455,62,36,26,2,1
28,465,465,29,9,20,2,1
24,490,490,7,2,5,2,1
23,495,495,204,151,53,4,3

6,101,101,22,22,0,1,0
1,114,114,8,8,0,1,0
2,122,122,14,8,6,2,1
15,128,128,3,3,0,1,0
4,151,151,7,1,6,3,2
19,169,169,33,33,0,1,0
28,186,186,11,11,0,1,0
24,200,200,23,23,0,1,0
20,203,203,5,5,0,1,0
26,217,217,92,92,0,1,0
17,223,223,8,8,0,1,0
3,231,231,4,4,0,1,0
8,240,240,19,19,0,1,0
11,252,252,69,69,0,1,0
14,279,279,9,9,0,1,0
23,286,286,31,31,0,1,0
5,308,308,3,3,0,1,0
9,313,313,3,3,0,1,0
29,331,331,64,28,36,3,2
21,333,333,9,9,0,1,0
10,344,344,31,23,8,3,2
13,345,345,21,21,0,1,0
18,355,355,35,12,23,2,1
25,377,377,14,14,0,1,0
16,379,379,20,20,0,1,0
22,382,382,32,17,15,2,1
7,404,404,39,9,30,4,3
0,455,455,51,10,41,2,1
12,457,457,184,142,42,4,3
27,489,489,55,5,50,3,2

20,101,101,1,1,0,1,0
17,101,101,13,13,0,1,0
1,155,155,17,17,0,1,0
23,159,159,16,7,9,2,1
31,160,160,17,7,10,3,2
28,184,184,8,3,5,2,1
16,198,198,1,1,0,1,0
11,202,202,59,25,34,3,2
21,211,211,12,12,0,1,0
18,215,215,16,7,9,2,1
25,223,223,25,1,24,2,1
24,223,223,7,7,0,1,0
19,227,227,2,2,0,1,0
7,243,243,14,7,7,2,1
35,260,260,19,1,18,2,1
33,269,269,75,45,30,4,3
36,275,275,40,31,9,4,3
2,287,287,14,14,0,1,0
26,297,297,12,12,0,1,0
0,302,302,67,16,51,4,3
22,304,304,17,17,0,1,0
32,308,308,51,17,34,2,1
10,310,310,11,11,0,1,0
30,310,310,12,8,4,2,1
15,310,310,11,6,5,2,1
3,311,311,53,23,30,4,3
9,331,331,11,11,0,1,0
13,384,384,22,7,15,4,3
29,392,392,10,10,0,1,0
14,398,398,4,1,3,2,1
8,400,400,27,27,0,1,0
27,401,401,10,10,0,1,0
12,414,414,5,5,0,1,0
4,462,462,53,11,42,2,1
5,478,478,23,1,22,2,1
6,486,486,33,33,0,1,0
34,494,494,163,58,105,4,3

24,102,102,2,2,0,1,0
19,120,120,2,2,0,1,0
11,157,157,7,7,0,1,0
25,158,158,1,1,0,1,0
4,177,177,21,5,16,2,1
12,178,178,5,2,3,2,1
14,188,188,20,10,10,3,2
17,250,250,1,1,0,1,0
18,260,260,49,9,40,2,1
5,263,263,6,6,0,1,0
13,271,271,43,8,35,3,2
8,278,278,37,10,27,4,3
15,307,307,121,61,60,4,3
3,322,322,123,123,0,1,0
10,327,327,80,80,0,1,0
0,357,357,37,37,0,1,0
20,400,400,110,23,87,4,3
2,403,403,72,7,65,4,3
7,415,415,169,79,90,4,3
1,426,426,58,10,48,3,2
16,426,426,17,17,0,1,0
6,427,427,6,3,3,2,1
23,438,438,20,8,12,3,2
9,477,477,50,50,0,1,0
22,492,492,11,11,0,1,0
21,495,495,21,21,0,1,0

28,102,102,46,41,5,2,1
3,103,103,4,1,3,2,1
19,112,112,21,21,0,1,0
23,173,173,5,2,3,2,1
9,186,186,31,31,0,1,0
22,186,186,41,4,37,4,3
4,190,190,13,13,0,1,0
7,208,208,2,2,0,1,0
18,211,211,49,49,0,1,0
12,214,214,15,15,0,1,0
6,215,215,6,6,0,1,0
27,215,215,29,29,0,1,0
21,217,217,21,21,0,1,0
15,244,244,28,15,13,2,1
30,254,254,5,5,0,1,0
17,264,264,23,1,22,3,2
25,288,288,2,2,0,1,0
5,290,290,1,1,0,1,0
24,291,291,2,2,0,1,0
26,297,297,2,2,0,1,0
20,300,300,23,23,0,1,0
2,321,321,10,10,0,1,0
31,337,337,1,1,0,1,0
33,349,349,19,19,0,1,0
10,362,362,51,51,0,1,0
0,364,364,3,3,0,1,0
29,401,401,25,11,14,3,2
13,402,402,153,83,70,4,3
1,413,413,5,5,0,1,0
8,449,449,54,54,0,1,0
11,455,455,32,11,21,2,1
14,480,480,54,10,44,4,3
16,489,489,68,35,33,4,3
32,497,497,26,26,0,1,0

12,116,116,9,9,0,1,0
5,122,122,4,4,0,1,0
28,122,122,9,3,6,2,1
36,129,129,17,17,0,1,0
30,131,131,20,8,12,2,1
7,138,138,19,19,0,1,0
3,155,155,34,17,17,3,2
11,163,163,31,31,0,1,0
35,170,170,9,6,3,2,1
14,213,213,2,2,0,1,0
9,231,231,1,1,0,1,0
33,238,238,23,6,17,2,1
8,243,243,12,12,0,1,0
15,246,246,23,9,14,2,1
32,265,265,4,4,0,1,0
16,270,270,47,47,0,1,0
31,278,278,25,7,18,4,3
27,294,294,47,47,0,1,0
34,298,298,20,8,12,3,2
17,305,305,6,6,0,1,0
0,309,309,4,4,0,1,0
26,326,326,157,107,50,2,1
21,354,354,16,2,14,2,1
10,354,354,1,1,0,1,0
20,357,357,43,43,0,1,0
18,364,364,52,22,30,3,2
1,388,388,22,22,0,1,0
19,426,426,25,16,9,4,3
25,441,441,17,17,0,1,0
23,447,447,32,10,22,2,1
29,449,449,27,14,13,2,1
6,461,461,31,31,0,1,0
13,463,463,41,26,15,2,1
4,467,467,1,1,0,1,0
22,495,495,38,38,0,1,0
24,496,496,7,7,0,1,0
2,497,497,21,21,0,1,0

7,108,108,2,2,0,1,0
18,123,123,5,5,0,1,0
8,123,123,8,8,0,1,0
29,126,126,3,3,0,1,0
27,128,128,1,1,0,1,0
15,131,131,8,8,0,1,0
5,137,137,1,1,0,1,0
9,159,159,16,16,0,1,0
16,178,178,1,1,0,1,0
30,206,206,3,3,0,1,0
24,210,210,40,40,0,1,0
23,231,231,31,25,6,2,1
35,239,239,1,1,0,1,0
0,243,243,2,2,0,1,0
1,245,245,4,4,0,1,0
2,250,250,9,9,0,1,0
11,275,275,28,12,16,2,1
10,278,278,1,1,0,1,0
6,288,288,4,4,0,1,0
31,295,295,13,4,9,4,3
32,318,318,62,62,0,1,0
4,324,324,58,2,56,3,2
21,333,333,28,21,7,2,1
28,357,357,53,53,0,1,0
13,365,365,24,11,13,2,1
3,389,389,75,15,60,4,3
22,400,400,23,23,0,1,0
34,411,411,122,122,0,1,0
17,418,418,83,24,59,4,3
33,422,422,61,5,56,3,2
26,437,437,35,35,0,1,0
20,441,441,11,4,7,2,1
12,448,448,38,38,0,1,0
25,455,455,85,54,31,2,1
14,490,490,75,1,74,3,2
19,497,497,123,111,12,2,1

14,107,107,5,5,0,1,0
12,117,117,11,11,0,1,0
30,154,154,7,7,0,1,0
9,168,168,15,15,0,1,0
29,202,202,2,2,0,1,0
10,219,219,12,12,0,1,0
31,241,241,30,30,0,1,0
21,256,256,4,4,0,1,0
7,258,258,12,12,0,1,0
22,286,286,61,61,0,1,0
23,299,299,25,25,0,1,0
20,302,302,38,12,26,4,3
2,308,308,91,91,0,1,0
15,320,320,29,29,0,1,0
4,324,324,43,31,12,3,2
6,336,336,53,16,37,2,1
24,374,374,28,16,12,4,3
13,374,374,94,94,0,1,0
26,386,386,88,13,75,4,3
5,393,393,66,66,0,1,0
18,398,398,23,3,20,3,2
27,427,427,124,42,82,3,2
3,429,429,4,4,0,1,0
8,436,436,34,20,14,2,1
11,438,438,22,12,10,3,2
28,456,456,42,27,15,2,1
0,469,469,17,17,0,1,0
17,470,470,43,43,0,1,0
19,470,470,8,8,0,1,0
16,484,484,74,74,0,1,0
25,499,499,4,4,0,1,0
1,500,500,1,1,0,1,0

3,120,120,1,1,0,1,0
25,123,123,5,5,0,1,0
21,131,131,1,1,0,1,0
15,153,153,6,1,5,2,1
14,156,156,14,14,0,1,0
7,160,160,8,8,0,1,0
22,169,169,6,6,0,1,0
30,180,180,28,28,0,1,0
38,184,184,14,14,0,1,0
17,198,198,1,1,0,1,0
29,229,229,13,13,0,1,0
32,239,239,27,27,0,1,0
35,249,249,69,69,0,1,0
12,259,259,1,1,0,1,0
31,260,260,25,25,0,1,0
2,281,281,6,6,0,1,0
19,284,284,8,2,6,3,2
4,294,294,27,20,7,2,1
28,294,294,11,1,10,2,1
36,302,302,28,14,14,3,2
27,308,308,27,15,12,2,1
11,315,315,4,4,0,1,0
23,315,315,42,5,37,4,3
10,346,346,20,3,17,4,3
6,347,347,102,51,51,4,3
37,353,353,11,11,0,1,0
8,357,357,1,1,0,1,0
34,362,362,11,11,0,1,0
13,382,382,91,73,18,3,2
9,404,404,24,6,18,2,1
0,411,411,1,1,0,1,0
1,415,415,51,19,32,2,1
33,426,426,31,17,14,3,2
24,439,439,58,8,50,3,2
20,440,440,45,21,24,2,1
16,460,460,6,6,0,1,0
26,464,464,92,68,24,3,2
18,464,464,112,85,27,2,1
5,478,478,36,23,13,3,2

2,110,110,8,8,0,1,0
26,135,135,5,5,0,1,0
19,160,160,20,20,0,1,0
7,174,174,28,28,0,1,0
18,175,175,12,3,9,4,3
25,211,211,21,3,18,3,2
9,214,214,108,97,11,2,1
0,225,225,4,4,0,1,0
16,236,236,16,13,3,2,1
10,238,238,5,5,0,1,0
30,244,244,16,16,0,1,0
20,247,247,14,14,0,1,0
5,254,254,5,5,0,1,0
4,259,259,1,1,0,1,0
17,265,265,3,3,0,1,0
22,273,273,95,9,86,3,2
23,284,284,32,9,23,2,1
6,302,302,31,9,22,2,1
12,317,317,27,19,8,2,1
8,328,328,66,66,0,1,0
15,331,331,47,8,39,4,3
14,350,350,2,2,0,1,0
13,364,364,7,7,0,1,0
29,368,368,23,23,0,1,0
1,378,378,3,3,0,1,0
28,410,410,25,25,0,1,0
3,424,424,75,19,56,3,2
24,434,434,29,29,0,1,0
27,442,442,88,40,48,3,2
11,477,477,97,67,30,4,3
21,493,493,55,55,0,1,0

14,106,106,4,4,0,1,0
19,119,119,20,5,15,2,1
15,130,130,1,1,0,1,0
25,142,142,5,5,0,1,0
17,166,166,15,15,0,1,0
32,169,169,5,2,3,2,1
3,170,170,18,18,0,1,0
26,185,185,18,18,0,1,0
11,187,187,4,4,0,1,0
23,192,192,13,5,8,2,1
6,193,193,37,15,22,3,2
16,206,206,18,18,0,1,0
7,213,213,9,5,4,2,1
21,258,258,20,20,0,1,0
24,262,262,44,21,23,2,1
27,303,303,36,26,10,3,2
9,325,325,52,52,0,1,0
30,330,330,25,25,0,1,0
28,347,347,15,15,0,1,0
10,367,367,2,2,0,1,0
4,370,370,15,6,9,2,1
1,383,383,83,9,74,3,2
29,386,386,68,68,0,1,0
13,390,390,77,77,0,1,0
22,398,398,2,2,0,1,0
20,431,431,149,110,39,2,1
12,437,437,28,7,21,4,3
0,442,442,28,28,0,1,0
8,446,446,15,15,0,1,0
2,471,471,146,100,46,2,1
18,472,472,67,55,12,4,3
5,475,475,8,4,4,2,1
31,482,482,1,1,0,1,0

26,135,135,13,5,8,2,1
27,159,159,12,12,0,1,0
17,160,160,2,2,0,1,0
11,169,169,9,9,0,1,0
0,170,170,1,1,0,1,0
22,190,190,36,3,33,2,1
10,190,190,17,2,15,2,1
23,196,196,16,16,0,1,0
4,199,199,1,1,0,1,0
29,202,202,12,1,11,4,3
1,229,229,1,1,0,1,0
12,245,245,34,34,0,1,0
6,260,260,34,34,0,1,0
25,287,287,1,1,0,1,0
24,295,295,84,84,0,1,0
8,301,301,10,10,0,1,0
15,334,334,52,26,26,2,1
7,343,343,146,113,33,4,3
5,350,350,36,36,0,1,0
13,353,353,143,103,40,2,1
18,361,361,50,50,0,1,0
28,362,362,15,1,14,3,2
9,366,366,27,27,0,1,0
3,373,373,10,10,0,1,0
20,402,402,53,13,40,4,3
19,413,413,20,9,11,3,2
14,416,416,31,3,28,2,1
21,444,444,105,75,30,2,1
2,477,477,15,15,0,1,0
16,490,490,7,7,0,1,0
30,493,493,27,13,14,2,1

1,110,110,27,27,0,1,0
0,116,116,8,8,0,1,0
9,129,129,30,3,27,4,3
11,147,147,11,11,0,1,0
19,155,155,26,8,18,2,1
3,165,165,18,18,0,1,0
20,166,166,17,17,0,1,0
27,175,175,39,39,0,1,0
2,179,179,67,67,0,1,0
25,183,183,30,30,0,1,0
12,214,214,4,4,0,1,0
6,243,243,8,2,6,3,2
13,251,251,18,6,12,2,1
22,263,263,11,11,0,1,0
14,264,264,32,32,0,1,0
30,274,274,29,9,20,2,1
4,322,322,18,2,16,3,2
26,327,327,26,2,24,3,2
29,327,327,6,6,0,1,0
28,344,344,36,20,16,3,2
16,348,348,29,1,28,2,1
23,350,350,22,10,12,2,1
15,357,357,35,35,0,1,0
8,366,366,7,4,3,2,1
21,404,404,6,6,0,1,0
5,426,426,43,1,42,2,1
10,450,450,15,1,14,2,1
7,471,471,21,1,20,3,2
18,472,472,73,46,27,4,3
17,477,477,58,29,29,2,1
24,489,489,42,36,6,2,1

17,115,115,10,2,8,3,2
29,119,119,10,3,7,2,1
21,127,127,15,15,0,1,0
25,135,135,16,2,14,3,2
31,140,140,3,3,0,1,0
23,143,143,30,20,10,2,1
10,161,161,1,1,0,1,0
32,163,163,21,15,6,3,2
0,166,166,10,1,9,2,1
6,168,168,6,6,0,1,0
13,170,170,1,1,0,1,0
11,183,183,30,30,0,1,0
2,192,192,10,10,0,1,0
28,207,207,36,36,0,1,0
7,224,224,34,34,0,1,0
12,227,227,7,3,4,2,1
20,227,227,20,20,0,1,0
26,248,248,5,5,0,1,0
33,263,263,12,12,0,1,0
18,273,273,52,52,0,1,0
16,277,277,2,2,0,1,0
34,279,279,1,1,0,1,0
4,302,302,22,15,7,2,1
5,312,312,55,3,52,4,3
1,327,327,36,9,27,3,2
8,330,330,51,51,0,1,0
14,342,342,8,8,0,1,0
19,345,345,47,47,0,1,0
30,359,359,17,5,12,3,2
15,362,362,7,7,0,1,0
35,376,376,26,26,0,1,0
3,380,380,3,3,0,1,0
24,389,389,166,105,61,4,3
22,390,390,28,28,0,1,0
9,426,426,47,15,32,3,2
27,476,476,4,4,0,1,0

34,101,101,7,7,0,1,0
24,102,102,18,9,9,3,2
15,113,113,10,2,8,3,2
31,114,114,5,1,4,2,1
4,120,120,9,1,8,2,1
3,123,123,8,1,7,2,1
13,129,129,4,4,0,1,0
9,136,136,22,22,0,1,0
14,141,141,19,7,12,4,3
6,179,179,22,1,21,4,3
22,190,190,59,59,0,1,0
19,198,198,5,5,0,1,0
37,201,201,7,7,0,1,0
11,204,204,14,10,4,2,1
25,218,218,16,1,15,2,1
33,219,219,4,4,0,1,0
30,241,241,44,2,42,3,2
29,242,242,34,34,0,1,0
8,243,243,4,4,0,1,0
17,255,255,40,40,0,1,0
5,260,260,3,3,0,1,0
26,261,261,23,23,0,1,0
10,270,270,4,4,0,1,0
27,274,274,10,10,0,1,0
20,275,275,8,2,6,2,1
16,278,278,5,5,0,1,0
1,323,323,14,14,0,1,0
21,329,329,3,3,0,1,0
2,330,330,54,33,21,4,3
7,350,350,8,8,0,1,0
28,368,368,4,4,0,1,0
12,396,396,104,104,0,1,0
18,418,418,16,8,8,2,1
36,425,425,46,25,21,4,3
32,426,426,47,32,15,2,1
35,426,426,46,13,33,3,2
23,430,430,51,51,0,1,0
0,493,493,21,17,4,2,1

8,100,100,8,8,0,1,0
21,103,103,17,5,12,3,2
23,107,107,4,4,0,1,0
17,108,108,9,3,6,2,1
26,142,142,37,13,24,4,3
27,143,143,20,7,13,2,1
16,146,146,6,6,0,1,0
24,168,168,39,2,37,4,3
11,168,168,18,5,13,2,1
12,172,172,8,8,0,1,0
5,179,179,25,15,10,3,2
31,198,198,11,11,0,1,0
19,203,203,21,21,0,1,0
13,203,203,5,5,0,1,0
9,204,204,3,3,0,1,0
25,216,216,26,3,23,4,3
14,216,216,60,60,0,1,0
6,220,220,22,2,20,2,1
1,224,224,5,2,3,2,1
3,258,258,1,1,0,1,0
18,272,272,4,4,0,1,0
30,274,274,5,1,4,2,1
32,287,287,51,33,18,2,1
29,323,323,5,1,4,2,1
0,367,367,70,70,0,1,0
22,405,405,12,4,8,2,1
20,438,438,43,43,0,1,0
4,440,440,28,28,0,1,0
2,440,440,58,9,49,2,1
7,441,441,25,2,23,2,1
15,460,460,117,117,0,1,0
28,469,469,41,31,10,3,2
10,498,498,23,11,12,3,2

0,118,118,10,10,0,1,0
25,124,124,9,3,6,3,2
34,128,128,12,12,0,1,0
22,136,136,1,1,0,1,0
17,137,137,1,1,0,1,0
29,158,158,14,5,9,4,3
26,160,160,3,3,0,1,0
5,178,178,10,10,0,1,0
28,185,185,26,10,16,2,1
23,193,193,15,2,13,2,1
19,205,205,7,7,0,1,0
14,271,271,39,18,21,4,3
27,271,271,64,27,37,4,3
33,272,272,15,15,0,1,0
32,294,294,59,41,18,4,3
4,297,297,68,44,24,4,3
18,301,301,1,1,0,1,0
15,305,305,21,21,0,1,0
20,329,329,2,2,0,1,0
37,340,340,91,65,26,3,2
35,347,347,80,80,0,1,0
7,347,347,16,8,8,2,1
12,367,367,4,4,0,1,0
6,371,371,71,19,52,3,2
30,378,378,18,18,0,1,0
13,387,387,17,1,16,2,1
16,417,417,1,1,0,1,0
3,426,426,1,1,0,1,0
10,430,430,56,18,38,4,3
21,431,431,12,4,8,3,2
24,437,437,10,10,0,1,0
9,446,446,57,9,48,4,3
31,457,457,7,3,4,2,1
2,471,471,90,54,36,2,1
1,490,490,33,33,0,1,0
11,491,491,34,11,23,2,1
8,497,497,28,28,0,1,0
36,498,498,30,22,8,3,2

0,101,101,1,1,0,1,0
16,105,105,15,15,0,1,0
6,129,129,33,33,0,1,0
19,136,136,8,8,0,1,0
30,139,139,43,1,42,4,3
8,146,146,29,11,18,3,2
4,157,157,26,26,0,1,0
25,164,164,41,41,0,1,0
31,175,175,8,2,6,3,2
27,184,184,9,9,0,1,0
23,198,198,10,4,6,2,1
5,198,198,17,13,4,2,1
7,216,216,1,1,0,1,0
24,240,240,10,3,7,3,2
12,257,257,15,10,5,2,1
22,258,258,16,16,0,1,0
21,262,262,24,8,16,3,2
18,271,271,16,16,0,1,0
11,302,302,2,2,0,1,0
10,320,320,26,26,0,1,0
1,339,339,15,6,9,2,1
29,344,344,9,9,0,1,0
26,349,349,67,67,0,1,0
2,382,382,47,23,24,3,2
3,393,393,61,34,27,4,3
17,411,411,48,9,39,3,2
13,417,417,54,33,21,4,3
28,421,421,19,5,14,2,1
15,422,422,32,16,16,3,2
20,435,435,49,34,15,4,3
32,483,483,62,62,0,1,0
9,485,485,30,30,0,1,0
14,497,497,1,1,0,1,0

10,115,115,2,2,0,1,0
2,118,118,13,2,11,2,1
33,123,123,8,2,6,2,1
29,124,124,22,22,0,1,0
22,125,125,48,48,0,1,0
0,130,130,9,9,0,1,0
15,142,142,44,12,32,3,2
16,163,163,44,34,10,3,2
24,164,164,4,4,0,1,0
28,180,180,24,24,0,1,0
30,187,187,13,13,0,1,0
1,197,197,1,1,0,1,0
3,234,234,2,2,0,1,0
7,243,243,16,16,0,1,0
9,250,250,8,1,7,2,1
4,264,264,13,13,0,1,0
20,271,271,7,4,3,2,1
18,280,280,1,1,0,1,0
17,293,293,40,24,16,3,2
12,303,303,14,9,5,2,1
25,305,305,10,4,6,3,2
26,307,307,11,11,0,1,0
23,366,366,9,9,0,1,0
32,367,367,66,66,0,1,0
31,379,379,13,13,0,1,0
27,390,390,35,21,14,3,2
19,401,401,31,9,22,2,1
6,402,402,10,10,0,1,0
14,409,409,76,76,0,1,0
11,415,415,54,54,0,1,0
13,426,426,1,1,0,1,0
21,456,456,125,11,114,4,3
5,467,467,53,53,0,1,0
8,499,499,12,12,0,1,0

2,100,100,7,7,0,1,0
31,102,102,4,4,0,1,0
7,109,109,3,3,0,1,0
32,123,123,2,2,0,1,0
34,137,137,21,21,0,1,0
29,138,138,1,1,0,1,0
3,175,175,6,2,4,2,1
23,193,193,59,59,0,1,0
24,204,204,10,10,0,1,0
14,210,210,7,7,0,1,0
1,213,213,9,9,0,1,0
18,214,214,21,21,0,1,0
5,235,235,6,2,4,2,1
16,281,281,64,39,25,4,3
27,284,284,55,31,24,4,3
11,293,293,3,3,0,1,0
26,300,300,2,2,0,1,0
21,301,301,47,32,15,4,3
20,333,333,39,12,27,2,1
28,360,360,35,11,24,2,1
13,363,363,11,2,9,2,1
30,385,385,61,61,0,1,0
12,387,387,107,107,0,1,0
9,407,407,25,25,0,1,0
15,409,409,34,19,15,4,3
0,410,410,66,66,0,1,0
8,438,438,3,3,0,1,0
17,440,440,8,3,5,2,1
33,453,453,35,2,33,4,3
19,465,465,94,94,0,1,0
6,465,465,74,74,0,1,0
22,466,466,13,13,0,1,0
10,466,466,72,26,46,2,1
4,485,485,39,31,8,3,2
25,500,500,14,14,0,1,0

8,134,134,20,5,15,4,3
2,143,143,19,2,17,2,1
5,144,144,43,43,0,1,0
20,152,152,22,1,21,4,3
1,155,155,1,1,0,1,0
17,179,179,3,3,0,1,0
12,188,188,5,5,0,1,0
21,191,191,33,33,0,1,0
11,203,203,9,9,0,1,0
25,204,204,29,23,6,2,1
16,204,204,11,11,0,1,0
23,227,227,13,1,12,3,2
15,244,244,47,47,0,1,0
22,257,257,36,36,0,1,0
19,259,259,50,50,0,1,0
10,294,294,42,12,30,4,3
6,294,294,23,23,0,1,0
14,306,306,29,26,3,2,1
18,310,310,46,8,38,3,2
3,322,322,12,12,0,1,0
26,334,334,21,14,7,2,1
0,346,346,36,22,14,3,2
7,348,348,40,23,17,2,1
13,405,405,16,10,6,3,2
4,417,417,179,179,0,1,0
9,437,437,47,34,13,2,1
24,441,441,46,29,17,2,1

1,109,109,6,6,0,1,0
28,114,114,18,18,0,1,0
18,122,122,16,16,0,1,0
21,147,147,5,5,0,1,0
20,196,196,95,14,81,4,3
2,207,207,19,19,0,1,0
27,213,213,36,36,0,1,0
17,214,214,56,56,0,1,0
6,221,221,8,8,0,1,0
11,247,247,131,53,78,3,2
13,248,248,1,1,0,1,0
26,283,283,4,1,3,2,1
23,283,283,2,2,0,1,0
9,289,289,58,58,0,1,0
25,293,293,9,9,0,1,0
3,294,294,1,1,0,1,0
19,311,311,24,16,8,2,1
12,334,334,42,22,20,3,2
22,349,349,20,20,0,1,0
14,350,350,17,17,0,1,0
8,359,359,65,28,37,4,3
15,387,387,34,34,0,1,0
10,401,401,9,9,0,1,0
24,401,401,9,1,8,2,1
16,410,410,16,16,0,1,0
5,429,429,37,5,32,3,2
7,435,435,25,25,0,1,0
0,438,438,26,16,10,2,1
4,482,482,73,73,0,1,0

13,114,114,30,9,21,4,3
23,116,116,4,4,0,1,0
17,144,144,8,4,4,2,1
1,162,162,21,3,18,2,1
26,169,169,15,12,3,2,1
0,183,183,30,30,0,1,0
7,192,192,23,23,0,1,0
4,206,206,12,6,6,3,2
3,240,240,9,9,0,1,0
6,244,244,34,34,0,1,0
16,246,246,11,11,0,1,0
19,267,267,16,16,0,1,0
5,298,298,9,9,0,1,0
21,300,300,16,12,4,2,1
10,312,312,124,124,0,1,0
12,317,317,21,12,9,4,3
22,376,376,18,9,9,2,1
25,377,377,15,15,0,1,0
28,377,377,90,60,30,4,3
14,379,379,9,9,0,1,0
11,380,380,122,15,107,4,3
15,386,386,63,63,0,1,0
18,392,392,1,1,0,1,0
2,440,440,12,6,6,3,2
8,445,445,28,19,9,2,1
27,464,464,68,14,54,4,3
20,465,465,45,45,0,1,0
24,474,474,131,10,121,4,3
9,496,496,24,24,0,1,0

20,124,124,2,2,0,1,0
4,130,130,8,8,0,1,0
9,145,145,6,6,0,1,0
8,148,148,27,20,7,2,1
24,152,152,5,5,0,1,0
0,162,162,7,7,0,1,0
16,167,167,54,54,0,1,0
21,171,171,3,3,0,1,0
15,189,189,24,1,23,2,1
5,193,193,53,53,0,1,0
11,193,193,2,2,0,1,0
6,238,238,6,6,0,1,0
18,264,264,7,1,6,2,1
19,265,265,28,1,27,2,1
26,274,274,23,11,12,3,2
14,276,276,15,15,0,1,0
22,307,307,6,6,0,1,0
17,352,352,87,29,58,4,3
1,364,364,8,1,7,2,1
12,373,373,45,45,0,1,0
13,374,374,79,79,0,1,0
7,409,409,55,10,45,4,3
23,426,426,68,11,57,4,3
2,443,443,195,168,27,4,3
10,446,446,86,68,18,2,1
25,452,452,36,25,11,2,1
3,457,457,84,84,0,1,0

20,110,110,8,8,0,1,0
1,125,125,5,5,0,1,0
11,134,134,43,38,5,2,1
29,179,179,19,1,18,4,3
23,183,183,8,8,0,1,0
2,184,184,29,20,9,2,1
6,188,188,1,1,0,1,0
24,197,197,29,29,0,1,0
13,209,209,75,75,0,1,0
15,245,245,2,2,0,1,0
18,262,262,126,126,0,1,0
8,263,263,14,14,0,1,0
28,266,266,115,66,49,2,1
5,282,282,18,18,0,1,0
27,306,306,32,32,0,1,0
30,319,319,25,15,10,3,2
14,322,322,5,5,0,1,0
25,323,323,1,1,0,1,0
26,345,345,8,8,0,1,0
9,361,361,1,1,0,1,0
10,361,361,44,1,43,2,1
4,371,371,45,22,23,2,1
0,387,387,106,106,0,1,0
3,390,390,5,5,0,1,0
16,396,396,1,1,0,1,0
19,412,412,5,5,0,1,0
12,417,417,21,21,0,1,0
21,440,440,20,2,18,2,1
7,444,444,2,2,0,1,0
22,471,471,28,28,0,1,0
17,494,494,7,7,0,1,0

30,105,105,29,29,0,1,0
11,125,125,1,1,0,1,0
19,141,141,2,2,0,1,0
26,154,154,4,4,0,1,0
7,169,169,9,9,0,1,0
5,176,176,15,15,0,1,0
3,187,187,9,9,0,1,0
0,189,189,8,8,0,1,0
1,199,199,31,31,0,1,0
31,213,213,6,2,4,2,1
24,214,214,2,2,0,1,0
32,231,231,26,2,24,3,2
21,232,232,25,18,7,2,1
33,250,250,18,13,5,2,1
15,267,267,51,21,30,3,2
9,290,290,31,4,27,4,3
12,324,324,11,3,8,2,1
25,330,330,93,64,29,2,1
27,342,342,1,1,0,1,0
20,349,349,26,6,20,2,1
6,356,356,63,48,15,4,3
14,368,368,32,6,26,3,2
8,382,382,35,35,0,1,0
29,387,387,11,1,10,3,2
28,396,396,60,52,8,3,2
13,408,408,43,7,36,4,3
17,414,414,64,34,30,3,2
22,435,435,112,103,9,4,3
23,458,458,20,7,13,2,1
16,461,461,6,6,0,1,0
18,471,471,71,54,17,2,1
2,478,478,38,29,9,2,1
4,481,481,77,49,28,4,3
10,481,481,4,4,0,1,0

6,117,117,5,5,0,1,0
33,122,122,5,5,0,1,0
34,152,152,6,6,0,1,0
23,154,154,63,16,47,2,1
26,157,157,4,4,0,1,0
28,200,200,14,2,12,4,3
19,202,202,34,13,21,2,1
4,203,203,13,13,0,1,0
9,216,216,5,5,0,1,0
7,225,225,8,8,0,1,0
25,229,229,29,29,0,1,0
27,246,246,3,3,0,1,0
32,260,260,7,3,4,2,1
11,270,270,52,19,33,4,3
10,282,282,4,4,0,1,0
1,286,286,8,3,5,2,1
30,295,295,35,22,13,3,2
31,318,318,9,9,0,1,0
20,319,319,25,25,0,1,0
3,321,321,52,52,0,1,0
21,328,328,60,21,39,2,1
18,338,338,16,1,15,2,1
29,370,370,8,1,7,2,1
22,381,381,98,74,24,4,3
15,394,394,25,18,7,2,1
13,394,394,14,14,0,1,0
0,399,399,37,37,0,1,0
8,405,405,5,5,0,1,0
16,407,407,31,14,17,2,1
17,408,408,26,26,0,1,0
2,412,412,1,1,0,1,0
14,441,441,60,23,37,2,1
24,455,455,13,13,0,1,0
5,466,466,138,68,70,3,2
12,476,476,101,70,31,2,1

30,118,118,5,2,3,2,1
7,139,139,4,1,3,2,1
27,160,160,14,10,4,2,1
11,165,165,1,1,0,1,0
5,177,177,1,1,0,1,0
35,190,190,33,33,0,1,0
26,192,192,16,16,0,1,0
16,204,204,1,1,0,1,0
23,204,204,21,13,8,2,1
22,213,213,13,13,0,1,0
15,221,221,9,9,0,1,0
14,232,232,13,5,8,2,1
37,234,234,28,6,22,3,2
25,258,258,33,33,0,1,0
3,292,292,8,8,0,1,0
21,302,302,21,21,0,1,0
6,318,318,15,15,0,1,0
12,319,319,23,23,0,1,0
2,321,321,6,6,0,1,0
34,323,323,2,2,0,1,0
32,329,329,11,2,9,2,1
20,340,340,40,40,0,1,0
18,342,342,34,1,33,4,3
4,352,352,25,15,10,3,2
29,358,358,27,5,22,3,2
31,378,378,1,1,0,1,0
9,380,380,79,79,0,1,0
28,383,383,88,36,52,4,3
1,387,387,53,34,19,2,1
13,399,399,14,4,10,3,2
10,411,411,71,71,0,1,0
17,422,422,90,46,44,2,1
8,430,430,14,3,11,4,3
19,439,439,22,4,18,2,1
24,454,454,5,5,0,1,0
36,467,467,130,130,0,1,0
0,477,477,13,4,9,2,1
38,487,487,92,71,21,4,3
33,490,490,34,19,15,4,3

24,118,118,4,1,3,2,1
4,133,133,13,8,5,2,1
9,145,145,51,1,50,3,2
8,149,149,52,4,48,4,3
22,154,154,11,11,0,1,0
14,175,175,9,9,0,1,0
11,199,199,5,5,0,1,0
15,200,200,35,8,27,4,3
5,225,225,1,1,0,1,0
1,237,237,5,2,3,2,1
20,249,249,3,3,0,1,0
3,256,256,59,52,7,2,1
19,286,286,25,25,0,1,0
17,292,292,33,33,0,1,0
12,298,298,14,6,8,3,2
21,309,309,77,5,72,3,2
6,328,328,29,29,0,1,0
0,348,348,26,26,0,1,0
26,379,379,86,20,66,4,3
7,383,383,73,73,0,1,0
27,404,404,29,22,7,2,1
2,415,415,28,28,0,1,0
23,440,440,12,6,6,3,2
18,441,441,55,22,33,3,2
16,462,462,56,17,39,4,3
10,466,466,47,35,12,3,2
13,493,493,13,13,0,1,0
25,497,497,99,81,18,4,3

4,102,102,4,1,3,2,1
32,103,103,7,7,0,1,0
5,115,115,10,2,8,2,1
13,132,132,4,4,0,1,0
11,164,164,11,11,0,1,0
10,181,181,19,19,0,1,0
1,185,185,1,1,0,1,0
7,209,209,19,19,0,1,0
6,225,225,1,1,0,1,0
26,247,247,3,3,0,1,0
18,249,249,10,2,8,2,1
8,262,262,16,16,0,1,0
25,268,268,77,53,24,2,1
19,279,279,3,3,0,1,0
17,290,290,27,27,0,1,0
14,296,296,3,3,0,1,0
3,298,298,3,3,0,1,0
16,321,321,189,177,12,4,3
20,331,331,41,9,32,2,1
23,348,348,19,3,16,2,1
0,348,348,53,53,0,1,0
27,355,355,48,37,11,2,1
2,387,387,3,3,0,1,0
9,394,394,35,35,0,1,0
30,397,397,96,88,8,2,1
28,415,415,16,12,4,2,1
31,431,431,90,90,0,1,0
22,437,437,16,3,13,2,1
15,446,446,14,14,0,1,0
12,453,453,101,101,0,1,0
24,486,486,61,37,24,3,2
21,489,489,20,5,15,2,1
29,490,490,53,38,15,2,1

31,119,119,27,27,0,1,0
34,124,124,12,12,0,1,0
29,133,133,17,5,12,4,3
15,134,134,5,5,0,1,0
41,148,148,34,19,15,4,3
0,149,149,30,30,0,1,0
11,159,159,3,3,0,1,0
7,174,174,11,11,0,1,0
16,192,192,21,21,0,1,0
30,197,197,16,16,0,1,0
14,227,227,2,2,0,1,0
28,229,229,41,41,0,1,0
39,246,246,5,5,0,1,0
32,246,246,6,6,0,1,0
38,250,250,12,12,0,1,0
19,252,252,2,2,0,1,0
40,254,254,15,15,0,1,0
10,257,257,28,28,0,1,0
26,260,260,26,9,17,2,1
23,261,261,31,25,6,3,2
35,307,307,2,2,0,1,0
8,311,311,3,3,0,1,0
25,320,320,24,24,0,1,0
9,325,325,4,4,0,1,0
6,331,331,35,1,34,2,1
27,331,331,49,49,0,1,0
13,339,339,4,4,0,1,0
36,361,361,28,4,24,3,2
5,389,389,7,7,0,1,0
12,409,409,62,41,21,4,3
3,420,420,75,75,0,1,0
20,433,433,15,3,12,3,2
2,439,439,12,12,0,1,0
21,456,456,13,4,9,4,3
33,460,460,37,13,24,3,2
17,462,462,1,1,0,1,0
1,464,464,67,31,36,4,3
22,471,471,2,2,0,1,0
37,473,473,56,56,0,1,0
4,486,486,16,16,0,1,0
18,489,489,22,22,0,1,0
24,495,495,23,23,0,1,0

14,120,120,10,10,0,1,0
16,126,126,13,1,12,4,3
8,169,169,19,9,10,3,2
10,183,183,68,38,30,3,2
0,207,207,10,5,5,2,1
22,210,210,52,52,0,1,0
11,216,216,45,45,0,1,0
23,222,222,49,13,36,2,1
2,224,224,3,3,0,1,0
17,224,224,30,20,10,3,2
5,238,238,83,83,0,1,0
4,249,249,44,44,0,1,0
28,253,253,8,8,0,1,0
13,255,255,8,8,0,1,0
20,257,257,8,2,6,3,2
12,264,264,2,2,0,1,0
15,289,289,11,11,0,1,0
26,338,338,72,29,43,2,1
7,369,369,25,25,0,1,0
27,369,369,36,15,21,4,3
9,378,378,33,23,10,2,1
1,402,402,48,21,27,4,3
6,417,417,1,1,0,1,0
18,423,423,11,3,8,2,1
25,434,434,43,43,0,1,0
3,438,438,16,4,12,4,3
24,439,439,52,33,19,4,3
19,477,477,8,2,6,3,2
21,490,490,70,25,45,4,3

26,100,100,9,5,4,2,1
17,122,122,7,7,0,1,0
20,149,149,4,4,0,1,0
2,154,154,41,5,36,4,3
12,162,162,6,1,5,2,1
19,184,184,1,1,0,1,0
30,192,192,17,17,0,1,0
29,203,203,41,15,26,3,2
27,209,209,35,15,20,3,2
0,209,209,7,3,4,2,1
5,218,218,14,14,0,1,0
10,223,223,7,7,0,1,0
13,228,228,12,12,0,1,0
11,230,230,20,20,0,1,0
24,243,243,7,7,0,1,0
3,264,264,18,18,0,1,0
4,267,267,61,8,53,3,2
28,272,272,55,55,0,1,0
6,321,321,7,7,0,1,0
14,355,355,28,11,17,2,1
15,363,363,69,5,64,4,3
7,388,388,5,5,0,1,0
22,404,404,81,6,75,4,3
18,406,406,41,41,0,1,0
21,429,429,55,10,45,2,1
31,442,442,9,9,0,1,0
8,443,443,19,19,0,1,0
9,448,448,59,38,21,2,1
16,462,462,15,9,6,2,1
25,476,476,111,30,81,4,3
23,479,479,28,28,0,1,0
1,489,489,125,125,0,1,0

29,112,112,1,1,0,1,0
21,131,131,8,8,0,1,0
33,141,141,5,1,4,2,1
19,144,144,8,5,3,2,1
8,152,152,6,6,0,1,0
4,158,158,5,5,0,1,0
28,160,160,22,22,0,1,0
34,187,187,54,3,51,4,3
5,215,215,8,8,0,1,0
27,229,229,39,1,38,3,2
17,245,245,16,7,9,2,1
2,248,248,9,9,0,1,0
32,253,253,4,4,0,1,0
30,262,262,11,11,0,1,0
1,272,272,32,32,0,1,0
37,276,276,11,11,0,1,0
20,283,283,27,21,6,3,2
12,296,296,21,11,10,2,1
24,299,299,14,7,7,2,1
35,299,299,71,71,0,1,0
6,312,312,62,62,0,1,0
18,319,319,13,13,0,1,0
16,330,330,12,12,0,1,0
26,332,332,14,14,0,1,0
7,354,354,6,6,0,1,0
0,356,356,20,20,0,1,0
15,368,368,1,1,0,1,0
11,385,385,43,1,42,3,2
14,392,392,98,72,26,3,2
13,396,396,42,25,17,2,1
31,414,414,33,7,26,3,2
9,434,434,25,25,0,1,0
3,454,454,45,45,0,1,0
25,472,472,22,22,0,1,0
36,482,482,120,40,80,4,3
22,484,484,24,8,16,4,3
10,492,492,8,8,0,1,0
23,495,495,70,59,11,2,1

0,136,136,1,1,0,1,0
22,154,154,19,11,8,3,2
18,155,155,25,18,7,2,1
25,158,158,55,55,0,1,0
3,163,163,21,7,14,3,2
23,168,168,2,2,0,1,0
4,215,215,83,83,0,1,0
20,230,230,33,24,9,4,3
21,232,232,40,1,39,4,3
12,236,236,1,1,0,1,0
16,239,239,17,9,8,2,1
14,265,265,11,11,0,1,0
7,293,293,96,84,12,4,3
15,304,304,27,8,19,4,3
6,325,325,20,20,0,1,0
24,338,338,43,43,0,1,0
9,344,344,102,21,81,4,3
11,391,391,34,16,18,3,2
5,417,417,50,50,0,1,0
10,438,438,18,18,0,1,0
13,447,447,1,1,0,1,0
19,447,447,41,41,0,1,0
8,453,453,61,29,32,4,3
1,485,485,31,13,18,4,3
2,497,497,38,8,30,4,3
17,500,500,58,58,0,1,0

22,110,110,14,14,0,1,0
3,114,114,1,1,0,1,0
19,123,123,18,18,0,1,0
23,132,132,13,4,9,2,1
18,139,139,10,10,0,1,0
24,140,140,12,4,8,2,1
2,146,146,19,19,0,1,0
25,146,146,13,5,8,2,1
7,166,166,19,19,0,1,0
11,177,177,32,32,0,1,0
13,241,241,67,67,0,1,0
17,249,249,9,9,0,1,0
6,257,257,8,8,0,1,0
1,274,274,51,51,0,1,0
16,286,286,37,17,20,2,1
26,307,307,29,29,0,1,0
21,325,325,30,17,13,2,1
30,350,350,30,4,26,3,2
0,354,354,56,6,50,2,1
15,357,357,10,10,0,1,0
28,384,384,9,5,4,2,1
27,392,392,59,59,0,1,0
5,399,399,22,22,0,1,0
8,408,408,10,3,7,2,1
20,411,411,138,90,48,2,1
10,431,431,25,1,24,4,3
29,431,431,17,17,0,1,0
9,445,445,56,13,43,2,1
12,453,453,86,86,0,1,0
14,458,458,26,3,23,3,2
4,483,483,2,2,0,1,0

26,104,104,2,2,0,1,0
14,130,130,14,14,0,1,0
28,136,136,11,11,0,1,0
21,140,140,15,15,0,1,0
16,142,142,2,2,0,1,0
0,155,155,8,8,0,1,0
24,165,165,20,20,0,1,0
20,186,186,1,1,0,1,0
8,198,198,32,21,11,2,1
13,204,204,32,32,0,1,0
2,218,218,8,2,6,2,1
12,241,241,21,21,0,1,0
17,251,251,43,15,28,3,2
10,255,255,15,15,0,1,0
18,265,265,58,44,14,4,3
25,279,279,2,2,0,1,0
1,351,351,163,93,70,3,2
4,390,390,54,54,0,1,0
6,395,395,19,19,0,1,0
3,401,401,41,10,31,2,1
15,426,426,116,35,81,4,3
5,426,426,36,4,32,3,2
27,440,440,23,23,0,1,0
11,445,445,129,129,0,1,0
22,446,446,18,13,5,2,1
7,469,469,9,9,0,1,0
9,473,473,28,28,0,1,0
23,496,496,47,23,24,4,3
19,498,498,83,41,42,3,2

6,106,106,17,11,6,3,2
4,136,136,9,6,3,2,1
8,153,153,3,3,0,1,0
30,171,171,16,16,0,1,0
12,176,176,3,3,0,1,0
3,188,188,10,10,0,1,0
13,188,188,31,31,0,1,0
18,189,189,25,10,15,2,1
32,198,198,6,6,0,1,0
20,203,203,47,47,0,1,0
14,205,205,1,1,0,1,0
11,210,210,7,2,5,2,1
15,215,215,2,2,0,1,0
31,218,218,21,21,0,1,0
33,231,231,8,8,0,1,0
17,232,232,50,50,0,1,0
5,268,268,90,63,27,4,3
26,269,269,11,11,0,1,0
0,277,277,11,11,0,1,0
7,278,278,2,2,0,1,0
16,278,278,35,6,29,2,1
23,286,286,2,2,0,1,0
21,300,300,2,2,0,1,0
35,306,306,40,17,23,3,2
34,308,308,44,10,34,2,1
28,313,313,54,8,46,3,2
29,370,370,44,44,0,1,0
19,379,379,1,1,0,1,0
9,398,398,3,3,0,1,0
22,400,400,10,10,0,1,0
10,428,428,49,4,45,4,3
1,442,442,34,34,0,1,0
2,468,468,7,7,0,1,0
27,471,471,31,31,0,1,0
24,480,480,29,29,0,1,0
25,480,480,180,90,90,4,3

34,109,109,4,4,0,1,0
2,110,110,2,2,0,1,0
32,122,122,35,35,0,1,0
9,134,134,7,7,0,1,0
27,135,135,1,1,0,1,0
26,142,142,45,15,30,3,2
6,148,148,2,2,0,1,0
10,163,163,25,25,0,1,0
31,175,175,35,6,29,3,2
4,183,183,12,12,0,1,0
33,188,188,8,8,0,1,0
17,194,194,3,3,0,1,0
30,200,200,10,10,0,1,0
0,201,201,6,6,0,1,0
18,207,207,30,6,24,3,2
22,208,208,3,3,0,1,0
14,209,209,9,6,3,2,1
29,241,241,10,10,0,1,0
28,243,243,33,33,0,1,0
7,258,258,10,10,0,1,0
3,277,277,8,2,6,3,2
35,320,320,96,22,74,4,3
12,323,323,13,5,8,2,1
20,332,332,7,7,0,1,0
13,355,355,99,99,0,1,0
5,359,359,44,8,36,2,1
8,388,388,55,7,48,4,3
1,397,397,17,17,0,1,0
24,406,406,2,2,0,1,0
23,410,410,58,19,39,4,3
25,425,425,14,14,0,1,0
16,449,449,44,32,12,3,2
19,453,453,36,4,32,3,2
11,475,475,91,91,0,1,0
15,481,481,1,1,0,1,0
21,493,493,5,1,4,2,1

32,114,114,4,1,3,2,1
20,116,116,1,1,0,1,0
17,119,119,2,2,0,1,0
33,125,125,10,10,0,1,0
22,131,131,1,1,0,1,0
12,133,133,10,2,8,2,1
10,141,141,1,1,0,1,0
35,143,143,10,3,7,2,1
42,152,152,19,19,0,1,0
3,173,173,11,11,0,1,0
29,178,178,35,35,0,1,0
30,181,181,7,7,0,1,0
8,193,193,35,35,0,1,0
40,215,215,7,7,0,1,0
14,228,228,31,31,0,1,0
16,233,233,1,1,0,1,0
37,268,268,108,108,0,1,0
28,269,269,12,4,8,2,1
25,270,270,8,8,0,1,0
41,284,284,45,45,0,1,0
23,292,292,37,37,0,1,0
6,295,295,8,8,0,1,0
7,311,311,4,4,0,1,0
11,315,315,6,6,0,1,0
0,323,323,18,15,3,2,1
1,353,353,39,21,18,3,2
15,354,354,7,7,0,1,0
9,359,359,27,3,24,4,3
38,379,379,40,18,22,3,2
19,383,383,25,3,22,2,1
4,384,384,3,3,0,1,0
39,387,387,54,54,0,1,0
26,401,401,37,37,0,1,0
24,407,407,49,37,12,2,1
13,431,431,17,7,10,2,1
27,442,442,23,23,0,1,0
18,453,453,45,9,36,4,3
21,460,460,30,30,0,1,0
5,463,463,57,27,30,2,1
36,465,465,13,1,12,3,2
31,475,475,14,14,0,1,0
34,475,475,44,44,0,1,0
2,492,492,6,6,0,1,0

11,107,107,1,1,0,1,0
12,129,129,2,2,0,1,0
22,149,149,7,7,0,1,0
3,166,166,51,31,20,3,2
8,187,187,25,25,0,1,0
7,190,190,2,2,0,1,0
10,211,211,83,62,21,4,3
30,224,224,10,4,6,2,1
15,245,245,16,16,0,1,0
0,256,256,47,19,28,2,1
21,256,256,2,2,0,1,0
9,259,259,19,19,0,1,0
28,261,261,23,15,8,3,2
16,262,262,25,10,15,2,1
18,265,265,1,1,0,1,0
19,272,272,20,20,0,1,0
29,280,280,34,34,0,1,0
24,281,281,49,25,24,4,3
6,287,287,38,14,24,3,2
25,318,318,53,8,45,2,1
13,323,323,7,7,0,1,0
20,368,368,94,94,0,1,0
4,397,397,21,11,10,3,2
14,420,420,4,4,0,1,0
23,422,422,96,39,57,4,3
17,438,438,9,9,0,1,0
2,439,439,2,2,0,1,0
26,457,457,65,11,54,4,3
1,464,464,5,5,0,1,0
5,481,481,40,40,0,1,0
32,489,489,77,52,25,3,2
27,490,490,19,19,0,1,0
31,496,496,32,32,0,1,0

26,117,117,8,2,6,2,1
3,129,129,13,2,11,2,1
2,129,129,2,2,0,1,0
12,150,150,34,34,0,1,0
1,152,152,19,5,14,2,1
8,203,203,14,14,0,1,0
7,222,222,43,43,0,1,0
9,235,235,12,6,6,3,2
14,236,236,4,4,0,1,0
27,243,243,56,56,0,1,0
6,249,249,15,15,0,1,0
22,258,258,23,1,22,3,2
10,262,262,12,12,0,1,0
21,276,276,40,30,10,3,2
24,291,291,85,85,0,1,0
11,298,298,34,34,0,1,0
18,301,301,5,5,0,1,0
34,315,315,2,2,0,1,0
23,316,316,52,34,18,3,2
13,320,320,52,36,16,3,2
5,322,322,9,9,0,1,0
19,351,351,51,29,22,2,1
32,354,354,35,35,0,1,0
29,390,390,8,8,0,1,0
31,393,393,11,11,0,1,0
20,399,399,2,2,0,1,0
4,409,409,62,32,30,4,3
16,418,418,3,3,0,1,0
33,431,431,25,1,24,3,2
17,461,461,44,44,0,1,0
28,463,463,105,27,78,4,3
15,468,468,3,3,0,1,0
30,469,469,22,14,8,3,2
25,473,473,2,2,0,1,0
0,490,490,57,16,41,4,3

16,139,139,11,11,0,1,0
15,183,183,15,15,0,1,0
22,191,191,41,20,21,2,1
24,195,195,50,50,0,1,0
14,196,196,51,28,23,4,3
9,214,214,19,9,10,3,2
3,222,222,9,9,0,1,0
13,228,228,2,2,0,1,0
11,234,234,37,15,22,2,1
0,244,244,17,17,0,1,0
26,245,245,4,1,3,2,1
2,254,254,13,1,12,4,3
5,259,259,58,54,4,2,1
6,260,260,15,1,14,2,1
7,293,293,61,61,0,1,0
10,297,297,172,122,50,4,3
4,322,322,44,44,0,1,0
18,328,328,50,40,10,3,2
8,353,353,28,12,16,3,2
12,356,356,34,21,13,2,1
23,374,374,20,20,0,1,0
21,376,376,7,7,0,1,0
20,388,388,47,35,12,4,3
19,397,397,11,8,3,2,1
25,397,397,19,7,12,3,2
17,399,399,15,1,14,2,1
1,414,414,28,4,24,3,2

7,101,101,11,11,0,1,0
10,103,103,5,5,0,1,0
6,115,115,2,2,0,1,0
16,122,122,8,8,0,1,0
22,139,139,26,20,6,3,2
24,145,145,3,3,0,1,0
11,168,168,1,1,0,1,0
4,170,170,52,34,18,3,2
3,188,188,5,5,0,1,0
17,201,201,6,6,0,1,0
5,206,206,40,40,0,1,0
25,228,228,7,2,5,2,1
1,255,255,52,2,50,2,1
2,262,262,5,5,0,1,0
20,273,273,5,5,0,1,0
12,284,284,19,9,10,2,1
14,298,298,38,12,26,2,1
0,298,298,23,9,14,3,2
18,329,329,28,28,0,1,0
26,340,340,85,37,48,2,1
21,341,341,43,43,0,1,0
9,345,345,37,30,7,2,1
15,348,348,95,92,3,2,1
19,391,391,86,86,0,1,0
13,410,410,3,3,0,1,0
8,415,415,205,205,0,1,0
23,499,499,57,57,0,1,0

4,103,103,4,4,0,1,0
3,107,107,2,2,0,1,0
32,119,119,12,8,4,2,1
10,129,129,1,1,0,1,0
27,129,129,12,12,0,1,0
17,140,140,22,13,9,4,3
1,165,165,26,26,0,1,0
16,178,178,12,12,0,1,0
0,218,218,34,34,0,1,0
26,239,239,47,47,0,1,0
2,254,254,17,11,6,3,2
23,276,276,5,5,0,1,0
11,283,283,11,7,4,2,1
6,295,295,19,10,9,4,3
7,306,306,3,3,0,1,0
24,306,306,37,37,0,1,0
22,307,307,4,4,0,1,0
30,310,310,6,6,0,1,0
9,320,320,30,11,19,2,1
21,321,321,39,39,0,1,0
8,338,338,16,13,3,2,1
13,361,361,38,38,0,1,0
31,361,361,39,20,19,2,1
19,377,377,117,29,88,3,2
29,393,393,16,16,0,1,0
25,451,451,13,13,0,1,0
15,453,453,107,95,12,4,3
18,464,464,18,11,7,2,1
5,469,469,16,4,12,2,1
14,472,472,2,2,0,1,0
33,476,476,51,18,33,4,3
28,483,483,15,15,0,1,0
12,492,492,148,148,0,1,0
20,496,496,137,20,117,4,3

26,148,148,58,58,0,1,0
24,149,149,11,11,0,1,0
21,190,190,3,3,0,1,0
27,197,197,5,5,0,1,0
5,199,199,47,47,0,1,0
17,201,201,5,5,0,1,0
1,208,208,16,16,0,1,0
14,213,213,32,16,16,3,2
11,226,226,43,14,29,2,1
23,233,233,70,64,6,3,2
25,250,250,49,49,0,1,0
12,275,275,19,9,10,2,1
0,285,285,5,1,4,2,1
31,286,286,13,5,8,2,1
20,286,286,11,3,8,2,1
13,289,289,48,20,28,3,2
8,292,292,38,25,13,2,1
4,321,321,47,8,39,2,1
22,321,321,3,3,0,1,0
2,335,335,22,11,11,2,1
3,353,353,4,4,0,1,0
7,362,362,78,78,0,1,0
6,370,370,6,2,4,2,1
30,373,373,41,25,16,3,2
19,390,390,15,15,0,1,0
10,406,406,21,9,12,2,1
16,412,412,56,56,0,1,0
29,415,415,15,15,0,1,0
9,433,433,10,10,0,1,0
28,449,449,15,15,0,1,0
15,450,450,16,16,0,1,0
18,468,468,75,75,0,1,0

16,106,106,15,15,0,1,0
0,107,107,17,17,0,1,0
23,127,127,6,6,0,1,0
30,141,141,12,12,0,1,0
13,155,155,2,2,0,1,0
12,185,185,35,35,0,1,0
15,209,209,14,14,0,1,0
2,265,265,10,10,0,1,0
10,268,268,7,7,0,1,0
6,277,277,21,21,0,1,0
35,282,282,11,11,0,1,0
1,290,290,80,10,70,4,3
21,292,292,3,3,0,1,0
22,297,297,13,13,0,1,0
11,307,307,3,3,0,1,0
28,309,309,26,4,22,3,2
20,355,355,42,2,40,2,1
31,359,359,13,3,10,3,2
5,377,377,45,45,0,1,0
29,378,378,65,65,0,1,0
25,383,383,14,14,0,1,0
4,385,385,23,23,0,1,0
19,389,389,55,55,0,1,0
27,395,395,94,94,0,1,0
3,403,403,7,2,5,2,1
32,403,403,19,19,0,1,0
7,405,405,8,3,5,2,1
14,418,418,9,1,8,3,2
33,423,423,28,28,0,1,0
9,433,433,11,11,0,1,0
26,457,457,13,1,12,3,2
24,467,467,179,179,0,1,0
8,470,470,36,6,30,4,3
17,477,477,40,40,0,1,0
34,478,478,96,85,11,2,1
18,481,481,20,20,0,1,0

2,112,112,1,1,0,1,0
5,118,118,24,8,16,3,2
4,137,137,7,7,0,1,0
0,142,142,22,19,3,2,1
31,143,143,26,26,0,1,0
24,146,146,5,5,0,1,0
15,164,164,3,3,0,1,0
22,182,182,1,1,0,1,0
19,192,192,6,6,0,1,0
12,209,209,72,9,63,4,3
10,209,209,7,1,6,3,2
14,227,227,16,7,9,4,3
16,255,255,28,12,16,4,3
7,256,256,15,7,8,2,1
27,278,278,13,13,0,1,0
25,291,291,12,7,5,2,1
21,311,311,11,11,0,1,0
17,332,332,32,32,0,1,0
1,334,334,28,22,6,3,2
18,340,340,9,9,0,1,0
9,350,350,84,51,33,4,3
20,360,360,12,12,0,1,0
26,364,364,14,6,8,3,2
8,365,365,7,1,6,2,1
11,376,376,13,1,12,3,2
28,408,408,136,86,50,2,1
3,436,436,50,35,15,4,3
29,439,439,41,41,0,1,0
30,442,442,90,35,55,3,2
13,445,445,33,33,0,1,0
6,487,487,45,29,16,2,1
23,489,489,158,136,22,3,2

5,104,104,20,4,16,2,1
26,120,120,6,1,5,2,1
20,148,148,13,1,12,3,2
13,155,155,16,16,0,1,0
14,169,169,29,29,0,1,0
4,171,171,16,16,0,1,0
19,201,201,8,8,0,1,0
11,233,233,11,11,0,1,0
3,239,239,15,1,14,3,2
21,242,242,49,21,28,2,1
27,279,279,32,11,21,2,1
10,297,297,35,24,11,2,1
30,312,312,8,3,5,2,1
28,339,339,15,15,0,1,0
0,350,350,51,51,0,1,0
7,356,356,66,16,50,4,3
23,379,379,43,15,28,3,2
24,382,382,46,10,36,3,2
2,382,382,46,46,0,1,0
8,391,391,62,62,0,1,0
29,392,392,138,51,87,4,3
25,404,404,33,4,29,4,3
18,418,418,13,13,0,1,0
12,428,428,52,36,16,3,2
16,431,431,98,8,90,4,3
1,431,431,2,2,0,1,0
15,434,434,45,40,5,2,1
22,443,443,9,9,0,1,0
6,471,471,22,6,16,2,1
17,474,474,8,2,6,3,2
9,480,480,15,15,0,1,0

4,171,171,14,14,0,1,0
31,208,208,21,6,15,4,3
21,243,243,2,2,0,1,0
20,253,253,26,26,0,1,0
29,264,264,4,1,3,2,1
25,279,279,7,7,0,1,0
7,285,285,2,2,0,1,0
30,286,286,94,94,0,1,0
19,294,294,5,5,0,1,0
16,313,313,20,10,10,3,2
18,315,315,15,7,8,2,1
12,318,318,19,19,0,1,0
11,328,328,3,3,0,1,0
3,338,338,3,3,0,1,0
27,352,352,73,21,52,3,2
14,352,352,10,10,0,1,0
9,391,391,55,5,50,2,1
13,393,393,14,2,12,3,2
23,394,394,104,26,78,4,3
8,397,397,14,8,6,2,1
1,408,408,39,20,19,2,1
5,409,409,37,7,30,2,1
22,412,412,43,4,39,4,3
17,430,430,52,6,46,3,2
26,432,432,8,8,0,1,0
15,435,435,1,1,0,1,0
28,444,444,45,45,0,1,0
2,449,449,194,50,144,4,3
6,453,453,229,187,42,4,3
0,456,456,29,5,24,4,3
10,458,458,2,2,0,1,0
24,459,459,46,46,0,1,0

19,124,124,6,6,0,1,0
5,128,128,10,3,7,2,1
16,138,138,2,2,0,1,0
27,139,139,22,2,20,3,2
34,147,147,26,26,0,1,0
21,147,147,4,4,0,1,0
26,157,157,43,26,17,2,1
31,169,169,1,1,0,1,0
3,173,173,3,3,0,1,0
12,207,207,7,1,6,3,2
10,210,210,6,2,4,2,1
30,213,213,9,2,7,2,1
15,219,219,5,5,0,1,0
7,233,233,25,25,0,1,0
28,236,236,1,1,0,1,0
17,238,238,25,25,0,1,0
24,247,247,35,35,0,1,0
23,267,267,57,57,0,1,0
22,295,295,7,7,0,1,0
25,307,307,24,24,0,1,0
11,307,307,23,23,0,1,0
0,309,309,34,34,0,1,0
33,320,320,47,47,0,1,0
6,325,325,97,19,78,4,3
14,344,344,58,58,0,1,0
32,344,344,4,4,0,1,0
29,387,387,11,11,0,1,0
8,393,393,20,14,6,3,2
4,397,397,43,43,0,1,0
20,414,414,107,98,9,4,3
13,437,437,47,47,0,1,0
9,472,472,82,24,58,3,2
18,480,480,8,8,0,1,0
2,486,486,38,9,29,4,3
1,487,487,3,3,0,1,0

20,104,104,4,4,0,1,0
12,116,116,2,2,0,1,0
25,138,138,22,18,4,2,1
7,149,149,26,22,4,2,1
15,152,152,102,69,33,2,1
8,171,171,2,2,0,1,0
4,174,174,14,9,5,2,1
28,181,181,7,7,0,1,0
26,206,206,5,5,0,1,0
22,246,246,20,20,0,1,0
27,269,269,5,5,0,1,0
6,272,272,1,1,0,1,0
13,278,278,8,3,5,2,1
1,278,278,36,36,0,1,0
16,286,286,20,5,15,4,3
29,312,312,30,27,3,2,1
9,327,327,63,28,35,2,1
10,336,336,71,71,0,1,0
30,341,341,28,18,10,3,2
24,350,350,1,1,0,1,0
14,364,364,1,1,0,1,0
5,371,371,20,20,0,1,0
2,380,380,82,34,48,2,1
18,394,394,27,27,0,1,0
21,414,414,30,18,12,2,1
17,424,424,45,35,10,3,2
3,441,441,46,4,42,3,2
11,465,465,4,4,0,1,0
0,469,469,172,40,132,4,3
23,476,476,41,41,0,1,0
19,490,490,3,3,0,1,0

10,106,106,21,18,3,2,1
29,114,114,7,7,0,1,0
18,125,125,5,1,4,2,1
35,134,134,12,12,0,1,0
12,136,136,4,4,0,1,0
16,156,156,5,5,0,1,0
11,183,183,18,10,8,2,1
25,210,210,35,35,0,1,0
19,231,231,36,26,10,3,2
4,260,260,4,4,0,1,0
33,264,264,12,3,9,4,3
13,268,268,1,1,0,1,0
36,270,270,48,26,22,2,1
23,273,273,35,35,0,1,0
24,298,298,11,7,4,2,1
32,309,309,26,26,0,1,0
6,330,330,13,13,0,1,0
22,340,340,67,33,34,2,1
0,345,345,91,35,56,3,2
21,351,351,34,34,0,1,0
20,353,353,1,1,0,1,0
1,359,359,56,56,0,1,0
26,385,385,15,15,0,1,0
37,396,396,83,11,72,3,2
28,399,399,11,11,0,1,0
8,400,400,15,15,0,1,0
5,419,419,51,51,0,1,0
14,430,430,14,4,10,3,2
7,440,440,10,4,6,3,2
31,447,447,20,20,0,1,0
3,456,456,1,1,0,1,0
9,461,461,12,4,8,3,2
17,470,470,4,4,0,1,0
30,471,471,61,34,27,4,3
15,476,476,34,34,0,1,0
2,480,480,71,26,45,4,3
27,480,480,80,80,0,1,0
34,482,482,10,3,7,2,1

2,104,104,5,5,0,1,0
28,107,107,9,9,0,1,0
23,127,127,14,8,6,2,1
7,128,128,7,4,3,2,1
17,131,131,4,4,0,1,0
10,133,133,3,3,0,1,0
32,147,147,20,8,12,2,1
21,194,194,33,9,24,2,1
18,196,196,3,3,0,1,0
16,202,202,15,15,0,1,0
8,208,208,4,4,0,1,0
13,225,225,2,2,0,1,0
31,243,243,26,26,0,1,0
25,249,249,6,6,0,1,0
1,252,252,11,2,9,4,3
24,256,256,7,7,0,1,0
6,256,256,39,25,14,2,1
22,258,258,35,5,30,3,2
27,287,287,44,44,0,1,0
26,329,329,57,57,0,1,0
15,348,348,11,2,9,3,2
5,356,356,21,21,0,1,0
4,357,357,1,1,0,1,0
30,374,374,127,25,102,4,3
3,402,402,115,115,0,1,0
9,402,402,56,14,42,4,3
12,417,417,14,2,12,2,1
0,422,422,14,14,0,1,0
20,424,424,13,13,0,1,0
11,436,436,220,220,0,1,0
29,458,458,26,26,0,1,0
19,464,464,22,16,6,2,1
14,475,475,41,36,5,2,1

18,115,115,14,14,0,1,0
25,119,119,24,6,18,2,1
16,127,127,12,12,0,1,0
2,132,132,1,1,0,1,0
26,165,165,16,16,0,1,0
6,179,179,16,16,0,1,0
14,205,205,2,2,0,1,0
12,231,231,40,1,39,4,3
9,247,247,6,6,0,1,0
7,270,270,23,19,4,2,1
24,277,277,34,30,4,2,1
15,285,285,9,4,5,2,1
13,305,305,16,16,0,1,0
5,316,316,36,5,31,4,3
19,318,318,15,6,9,4,3
10,329,329,4,4,0,1,0
28,331,331,51,51,0,1,0
20,351,351,17,1,16,2,1
30,351,351,105,105,0,1,0
8,357,357,3,3,0,1,0
1,360,360,38,22,16,3,2
3,361,361,171,58,113,4,3
21,373,373,40,31,9,2,1
0,376,376,8,8,0,1,0
11,379,379,141,141,0,1,0
27,382,382,4,4,0,1,0
17,389,389,21,21,0,1,0
23,395,395,17,17,0,1,0
29,400,400,35,35,0,1,0
4,403,403,9,4,5,2,1
31,462,462,31,31,0,1,0
22,480,480,40,19,21,3,2

3,100,100,5,1,4,2,1
21,110,110,16,1,15,4,3
34,120,120,1,1,0,1,0
2,124,124,4,4,0,1,0
13,140,140,10,10,0,1,0
18,151,151,40,40,0,1,0
19,153,153,33,5,28,2,1
23,165,165,13,13,0,1,0
8,168,168,19,16,3,2,1
29,172,172,10,10,0,1,0
28,173,173,2,2,0,1,0
22,190,190,31,31,0,1,0
5,200,200,9,9,0,1,0
24,204,204,2,2,0,1,0
1,226,226,8,8,0,1,0
9,228,228,1,1,0,1,0
33,272,272,39,24,15,2,1
20,278,278,46,46,0,1,0
11,290,290,38,38,0,1,0
31,297,297,27,27,0,1,0
30,325,325,38,38,0,1,0
16,332,332,1,1,0,1,0
4,337,337,40,40,0,1,0
26,344,344,22,18,4,2,1
12,392,392,41,41,0,1,0
10,392,392,62,3,59,4,3
14,397,397,34,1,33,4,3
25,406,406,16,13,3,2,1
7,427,427,85,85,0,1,0
15,429,429,11,2,9,4,3
6,437,437,8,8,0,1,0
0,451,451,20,5,15,2,1
27,470,470,25,25,0,1,0
17,472,472,47,24,23,3,2
32,493,493,141,141,0,1,0

20,119,119,8,8,0,1,0
13,122,122,17,17,0,1,0
27,124,124,14,5,9,2,1
17,124,124,31,23,8,3,2
21,152,152,16,3,13,2,1
11,154,154,25,25,0,1,0
0,160,160,18,18,0,1,0
30,161,161,3,3,0,1,0
25,181,181,7,7,0,1,0
16,190,190,3,3,0,1,0
9,195,195,19,14,5,2,1
10,197,197,3,3,0,1,0
22,197,197,7,7,0,1,0
15,207,207,4,4,0,1,0
2,224,224,23,4,19,2,1
32,242,242,132,75,57,4,3
8,247,247,41,41,0,1,0
18,250,250,4,4,0,1,0
23,253,253,2,2,0,1,0
24,258,258,11,11,0,1,0
12,274,274,16,16,0,1,0
31,276,276,1,1,0,1,0
29,300,300,5,5,0,1,0
4,372,372,18,18,0,1,0
7,385,385,11,11,0,1,0
1,387,387,10,10,0,1,0
3,395,395,35,35,0,1,0
14,407,407,78,78,0,1,0
26,445,445,104,104,0,1,0
5,446,446,75,20,55,4,3
6,462,462,75,75,0,1,0
28,470,470,40,40,0,1,0
19,478,478,27,27,0,1,0

35,101,101,11,1,10,2,1
1,105,105,4,4,0,1,0
30,122,122,15,15,0,1,0
14,142,142,2,2,0,1,0
33,143,143,31,5,26,3,2
36,144,144,6,6,0,1,0
17,148,148,8,8,0,1,0
32,149,149,11,2,9,4,3
5,155,155,13,10,3,2,1
2,174,174,27,27,0,1,0
8,174,174,39,39,0,1,0
24,187,187,12,12,0,1,0
37,189,189,1,1,0,1,0
18,212,212,20,20,0,1,0
34,225,225,74,74,0,1,0
23,225,225,28,13,15,4,3
0,258,258,7,1,6,3,2
25,262,262,5,5,0,1,0
7,263,263,27,12,15,2,1
19,268,268,7,7,0,1,0
15,282,282,29,29,0,1,0
21,284,284,1,1,0,1,0
31,289,289,25,4,21,4,3
4,292,292,2,2,0,1,0
9,293,293,9,9,0,1,0
29,311,311,3,3,0,1,0
22,312,312,25,25,0,1,0
16,348,348,1,1,0,1,0
10,364,364,11,2,9,2,1
6,365,365,5,1,4,2,1
12,373,373,7,7,0,1,0
26,395,395,42,12,30,4,3
20,396,396,20,12,8,3,2
13,397,397,39,39,0,1,0
27,434,434,10,10,0,1,0
11,444,444,4,4,0,1,0
3,462,462,192,178,14,3,2
28,485,485,112,6,106,4,3

24,103,103,19,12,7,2,1
27,124,124,14,14,0,1,0
18,131,131,10,10,0,1,0
15,136,136,31,21,10,2,1
11,141,141,4,4,0,1,0
6,159,159,11,5,6,3,2
8,174,174,6,6,0,1,0
10,174,174,26,26,0,1,0
12,196,196,4,4,0,1,0
28,199,199,11,11,0,1,0
7,202,202,79,1,78,3,2
3,227,227,93,93,0,1,0
19,229,229,6,6,0,1,0
13,229,229,50,50,0,1,0
23,250,250,22,22,0,1,0
25,257,257,38,17,21,2,1
9,262,262,2,2,0,1,0
16,275,275,18,18,0,1,0
2,295,295,2,2,0,1,0
22,307,307,78,16,62,4,3
0,332,332,35,17,18,4,3
4,345,345,39,39,0,1,0
17,354,354,6,6,0,1,0
14,367,367,7,4,3,2,1
21,371,371,14,2,12,3,2
20,419,419,2,2,0,1,0
26,451,451,45,2,43,4,3
5,453,453,23,14,9,4,3
1,468,468,101,101,0,1,0

29,107,107,25,7,18,4,3
28,121,121,7,7,0,1,0
22,144,144,25,25,0,1,0
5,150,150,8,8,0,1,0
8,168,168,26,12,14,2,1
20,169,169,11,11,0,1,0
7,170,170,2,2,0,1,0
0,201,201,15,15,0,1,0
2,221,221,9,9,0,1,0
4,254,254,41,13,28,2,1
16,255,255,16,16,0,1,0
9,255,255,38,38,0,1,0
30,258,258,26,11,15,2,1
18,258,258,16,7,9,2,1
26,273,273,10,10,0,1,0
1,296,296,25,25,0,1,0
3,298,298,28,28,0,1,0
31,313,313,2,2,0,1,0
24,315,315,17,17,0,1,0
10,323,323,1,1,0,1,0
27,338,338,49,49,0,1,0
25,370,370,1,1,0,1,0
15,373,373,67,43,24,4,3
11,385,385,39,11,28,2,1
23,392,392,77,47,30,3,2
19,401,401,96,6,90,4,3
6,404,404,8,8,0,1,0
12,437,437,98,98,0,1,0
13,456,456,10,10,0,1,0
17,467,467,32,32,0,1,0
21,469,469,59,59,0,1,0
14,474,474,108,78,30,3,2

23,137,137,25,25,0,1,0
16,147,147,7,7,0,1,0
33,163,163,12,12,0,1,0
11,166,166,4,4,0,1,0
27,168,168,3,3,0,1,0
28,190,190,10,1,9,2,1
17,202,202,20,20,0,1,0
22,210,210,15,15,0,1,0
2,211,211,47,47,0,1,0
26,238,238,81,81,0,1,0
8,249,249,50,50,0,1,0
25,251,251,26,21,5,2,1
9,252,252,34,34,0,1,0
10,292,292,15,15,0,1,0
30,296,296,23,23,0,1,0
29,316,316,17,2,15,2,1
34,335,335,60,60,0,1,0
19,360,360,25,25,0,1,0
7,367,367,24,2,22,4,3
32,373,373,52,13,39,4,3
31,390,390,24,15,9,2,1
6,393,393,9,9,0,1,0
18,399,399,55,10,45,4,3
35,404,404,4,4,0,1,0
4,406,406,36,6,30,3,2
21,408,408,18,18,0,1,0
13,408,408,27,15,12,3,2
24,413,413,74,74,0,1,0
20,413,413,17,17,0,1,0
14,430,430,34,22,12,2,1
5,431,431,1,1,0,1,0
0,442,442,6,6,0,1,0
15,442,442,15,15,0,1,0
3,455,455,68,68,0,1,0
12,458,458,38,38,0,1,0
1,497,497,5,5,0,1,0

13,102,102,1,1,0,1,0
27,109,109,3,3,0,1,0
38,112,112,11,4,7,2,1
34,128,128,2,2,0,1,0
4,134,134,2,2,0,1,0
20,143,143,1,1,0,1,0
26,145,145,2,2,0,1,0
32,157,157,1,1,0,1,0
15,168,168,2,2,0,1,0
22,173,173,11,11,0,1,0
29,176,176,6,2,4,2,1
31,178,178,40,13,27,4,3
19,179,179,13,13,0,1,0
24,194,194,5,1,4,2,1
7,204,204,5,2,3,2,1
42,205,205,42,22,20,3,2
35,228,228,19,19,0,1,0
21,229,229,9,1,8,3,2
30,232,232,13,6,7,2,1
39,240,240,52,52,0,1,0
1,244,244,3,3,0,1,0
0,254,254,33,20,13,4,3
16,257,257,6,6,0,1,0
14,269,269,1,1,0,1,0
28,292,292,16,16,0,1,0
25,297,297,19,11,8,3,2
12,302,302,37,37,0,1,0
23,320,320,10,10,0,1,0
3,355,355,85,85,0,1,0
40,358,358,82,39,43,2,1
10,358,358,14,10,4,2,1
37,368,368,16,16,0,1,0
11,374,374,5,5,0,1,0
6,375,375,38,38,0,1,0
36,386,386,85,85,0,1,0
33,389,389,16,7,9,2,1
5,411,411,5,5,0,1,0
18,415,415,14,14,0,1,0
41,421,421,13,1,12,4,3
2,427,427,23,15,8,2,1
44,447,447,48,19,29,2,1
43,451,451,8,8,0,1,0
9,470,470,1,1,0,1,0
17,476,476,117,69,48,4,3
8,493,493,53,53,0,1,0

0,105,105,21,6,15,4,3
15,114,114,6,6,0,1,0
16,115,115,8,8,0,1,0
17,124,124,13,6,7,2,1
5,137,137,1,1,0,1,0
21,141,141,45,1,44,2,1
8,166,166,29,29,0,1,0
4,172,172,22,1,21,2,1
11,179,179,13,13,0,1,0
29,191,191,10,10,0,1,0
25,197,197,7,7,0,1,0
1,198,198,23,23,0,1,0
12,207,207,35,13,22,3,2
31,222,222,51,47,4,2,1
24,236,236,72,72,0,1,0
7,241,241,4,4,0,1,0
26,262,262,16,16,0,1,0
10,277,277,4,4,0,1,0
23,298,298,31,31,0,1,0
13,305,305,23,14,9,4,3
19,318,318,31,3,28,2,1
3,319,319,5,5,0,1,0
27,351,351,3,3,0,1,0
2,384,384,8,2,6,3,2
28,392,392,4,4,0,1,0
14,415,415,69,29,40,2,1
22,417,417,47,47,0,1,0
6,439,439,6,6,0,1,0
9,457,457,135,31,104,4,3
20,457,457,27,27,0,1,0
18,479,479,38,38,0,1,0
30,487,487,13,3,10,3,2
32,495,495,14,8,6,2,1

14,102,102,4,4,0,1,0
11,121,121,36,36,0,1,0
7,148,148,15,1,14,2,1
16,158,158,47,47,0,1,0
5,171,171,12,12,0,1,0
3,178,178,32,14,18,4,3
0,189,189,9,9,0,1,0
17,208,208,23,15,8,3,2
9,227,227,35,5,30,2,1
18,241,241,5,1,4,2,1
1,273,273,4,1,3,2,1
31,279,279,37,37,0,1,0
29,299,299,20,7,13,2,1
2,300,300,16,4,12,3,2
15,302,302,8,4,4,2,1
6,309,309,1,1,0,1,0
26,318,318,2,2,0,1,0
25,329,329,35,35,0,1,0
12,339,339,41,41,0,1,0
28,366,366,115,78,37,2,1
27,368,368,61,31,30,2,1
10,378,378,92,92,0,1,0
4,391,391,18,18,0,1,0
19,396,396,5,1,4,2,1
23,404,404,15,3,12,3,2
21,409,409,33,33,0,1,0
8,412,412,4,4,0,1,0
20,413,413,15,15,0,1,0
13,422,422,82,24,58,4,3
30,442,442,42,42,0,1,0
24,443,443,51,1,50,3,2
22,462,462,11,11,0,1,0

19,124,124,10,1,9,2,1
9,149,149,5,5,0,1,0
27,165,165,12,6,6,2,1
20,175,175,15,5,10,3,2
22,177,177,37,7,30,4,3
6,197,197,5,5,0,1,0
23,212,212,15,3,12,2,1
31,219,219,9,6,3,2,1
34,238,238,16,16,0,1,0
13,255,255,20,8,12,2,1
36,260,260,41,17,24,2,1
25,263,263,5,5,0,1,0
11,303,303,16,16,0,1,0
14,303,303,20,20,0,1,0
1,326,326,11,5,6,2,1
30,329,329,118,118,0,1,0
17,330,330,19,19,0,1,0
2,343,343,15,4,11,3,2
5,354,354,11,6,5,2,1
15,360,360,14,14,0,1,0
12,407,407,101,41,60,4,3
29,407,407,3,3,0,1,0
24,408,408,43,13,30,3,2
28,412,412,24,24,0,1,0
0,434,434,72,72,0,1,0
16,437,437,13,13,0,1,0
4,439,439,49,49,0,1,0
8,450,450,35,35,0,1,0
37,453,453,42,42,0,1,0
32,464,464,18,18,0,1,0
35,464,464,5,5,0,1,0
26,465,465,116,116,0,1,0
3,466,466,22,7,15,4,3
18,468,468,31,20,11,4,3
21,469,469,66,42,24,4,3
33,472,472,30,30,0,1,0
7,473,473,14,5,9,4,3
10,475,475,27,27,0,1,0

23,134,134,6,6,0,1,0
15,148,148,1,1,0,1,0
11,149,149,1,1,0,1,0
12,159,159,1,1,0,1,0
9,166,166,5,5,0,1,0
0,211,211,56,56,0,1,0
8,211,211,5,2,3,2,1
22,254,254,6,6,0,1,0
6,267,267,65,65,0,1,0
30,267,267,29,29,0,1,0
17,290,290,19,7,12,2,1
25,295,295,10,10,0,1,0
7,304,304,16,3,13,2,1
16,320,320,57,57,0,1,0
4,326,326,31,17,14,2,1
19,352,352,40,40,0,1,0
20,353,353,32,8,24,2,1
31,365,365,21,2,19,2,1
3,372,372,91,64,27,2,1
26,398,398,25,1,24,2,1
28,399,399,107,25,82,4,3
27,399,399,3,3,0,1,0
5,400,400,13,5,8,3,2
14,410,410,114,114,0,1,0
21,431,431,108,67,41,3,2
1,439,439,6,6,0,1,0
13,442,442,2,2,0,1,0
24,458,458,7,7,0,1,0
29,470,470,136,75,61,3,2
2,471,471,33,33,0,1,0
18,475,475,6,6,0,1,0
10,483,483,112,69,43,4,3

32,121,121,39,7,32,3,2
29,123,123,9,9,0,1,0
6,125,125,15,15,0,1,0
12,139,139,1,1,0,1,0
33,149,149,12,12,0,1,0
22,159,159,5,5,0,1,0
18,202,202,12,12,0,1,0
19,205,205,16,16,0,1,0
23,213,213,1,1,0,1,0
16,225,225,8,4,4,2,1
17,242,242,49,23,26,2,1
4,245,245,11,11,0,1,0
5,260,260,47,32,15,4,3
20,266,266,17,2,15,4,3
31,283,283,61,61,0,1,0
0,284,284,10,1,9,2,1
13,311,311,11,4,7,2,1
7,314,314,19,19,0,1,0
3,314,314,15,7,8,2,1
9,317,317,4,4,0,1,0
2,327,327,10,7,3,2,1
27,332,332,50,50,0,1,0
36,352,352,5,5,0,1,0
26,359,359,41,25,16,3,2
1,385,385,5,5,0,1,0
25,385,385,4,4,0,1,0
30,386,386,69,18,51,4,3
10,410,410,82,67,15,4,3
28,419,419,4,4,0,1,0
34,422,422,6,6,0,1,0
11,443,443,5,5,0,1,0
21,443,443,21,21,0,1,0
14,455,455,52,52,0,1,0
24,465,465,75,53,22,2,1
35,472,472,84,34,50,2,1
8,475,475,44,1,43,3,2
37,484,484,38,31,7,2,1
15,490,490,53,53,0,1,0

18,100,100,5,5,0,1,0
0,109,109,1,1,0,1,0
12,109,109,5,5,0,1,0
25,112,112,3,3,0,1,0
24,117,117,1,1,0,1,0
3,119,119,1,1,0,1,0
33,123,123,8,8,0,1,0
13,127,127,19,19,0,1,0
35,149,149,32,32,0,1,0
11,150,150,4,4,0,1,0
28,155,155,38,9,29,2,1
5,158,158,3,3,0,1,0
16,189,189,44,44,0,1,0
37,230,230,3,3,0,1,0
32,236,236,90,24,66,3,2
34,237,237,9,1,8,3,2
20,238,238,1,1,0,1,0
8,242,242,20,20,0,1,0
14,244,244,8,3,5,2,1
27,248,248,10,10,0,1,0
10,249,249,1,1,0,1,0
4,276,276,43,30,13,2,1
9,285,285,72,72,0,1,0
2,364,364,9,9,0,1,0
30,415,415,32,32,0,1,0
29,415,415,1,1,0,1,0
21,439,439,14,14,0,1,0
7,449,449,29,17,12,3,2
36,450,450,4,4,0,1,0
6,453,453,41,14,27,2,1
26,473,473,9,9,0,1,0
1,473,473,21,8,13,2,1
23,476,476,24,24,0,1,0
19,486,486,13,13,0,1,0
17,487,487,72,56,16,3,2
22,492,492,125,57,68,4,3
31,493,493,94,79,15,2,1
15,495,495,48,23,25,2,1

14,102,102,10,10,0,1,0
19,106,106,1,1,0,1,0
28,127,127,5,5,0,1,0
0,129,129,4,4,0,1,0
7,137,137,3,3,0,1,0
27,139,139,3,3,0,1,0
25,146,146,9,9,0,1,0
8,149,149,2,2,0,1,0
12,168,168,22,22,0,1,0
24,176,176,1,1,0,1,0
9,204,204,23,23,0,1,0
2,207,207,105,66,39,4,3
13,232,232,12,12,0,1,0
17,232,232,12,12,0,1,0
16,255,255,86,74,12,2,1
1,262,262,42,42,0,1,0
3,263,263,5,1,4,2,1
6,280,280,3,3,0,1,0
11,311,311,80,74,6,3,2
22,331,331,2,2,0,1,0
5,352,352,56,42,14,2,1
18,385,385,90,55,35,2,1
15,410,410,75,51,24,4,3
4,413,413,37,22,15,4,3
23,420,420,1,1,0,1,0
21,427,427,146,146,0,1,0
20,452,452,7,7,0,1,0
26,463,463,85,25,60,4,3
10,495,495,44,44,0,1,0

15,110,110,6,3,3,2,1
29,113,113,7,7,0,1,0
6,114,114,8,8,0,1,0
12,120,120,38,38,0,1,0
21,136,136,21,1,20,2,1
26,155,155,15,6,9,2,1
18,158,158,9,9,0,1,0
25,179,179,36,36,0,1,0
4,182,182,12,9,3,2,1
14,191,191,5,5,0,1,0
24,234,234,10,4,6,3,2
9,240,240,3,3,0,1,0
8,242,242,10,1,9,4,3
0,249,249,56,24,32,3,2
20,251,251,17,5,12,3,2
27,270,270,66,56,10,2,1
16,290,290,21,12,9,4,3
1,299,299,23,23,0,1,0
5,309,309,1,1,0,1,0
28,322,322,51,51,0,1,0
19,328,328,27,27,0,1,0
23,349,349,11,3,8,2,1
10,376,376,74,74,0,1,0
17,383,383,27,27,0,1,0
31,384,384,25,14,11,2,1
22,387,387,15,15,0,1,0
7,387,387,97,79,18,3,2
30,411,411,79,8,71,4,3
2,426,426,9,9,0,1,0
11,431,431,20,20,0,1,0
3,460,460,78,78,0,1,0
13,478,478,14,14,0,1,0

25,118,118,3,3,0,1,0
29,119,119,17,5,12,3,2
6,123,123,11,6,5,2,1
10,125,125,22,4,18,4,3
9,126,126,18,18,0,1,0
0,131,131,7,7,0,1,0
7,142,142,20,20,0,1,0
17,168,168,38,38,0,1,0
8,174,174,12,12,0,1,0
27,212,212,20,20,0,1,0
28,221,221,19,19,0,1,0
21,242,242,1,1,0,1,0
24,246,246,51,2,49,2,1
20,253,253,1,1,0,1,0
13,255,255,9,9,0,1,0
4,258,258,124,124,0,1,0
2,273,273,30,30,0,1,0
1,298,298,33,33,0,1,0
23,298,298,50,1,49,2,1
3,305,305,19,8,11,2,1
19,310,310,27,27,0,1,0
14,328,328,76,53,23,2,1
26,330,330,20,20,0,1,0
5,402,402,18,6,12,4,3
18,437,437,42,17,25,2,1
22,455,455,35,16,19,3,2
11,480,480,28,11,17,2,1
16,487,487,41,31,10,2,1
15,491,491,12,12,0,1,0
12,498,498,14,14,0,1,0

32,121,121,56,4,52,3,2
14,148,148,7,1,6,2,1
1,152,152,1,1,0,1,0
21,195,195,25,7,18,4,3
10,200,200,7,3,4,2,1
0,203,203,1,1,0,1,0
7,223,223,33,16,17,3,2
18,235,235,7,1,6,2,1
20,236,236,9,2,7,2,1
5,238,238,2,2,0,1,0
4,252,252,6,6,0,1,0
8,256,256,29,29,0,1,0
17,256,256,88,88,0,1,0
12,257,257,8,2,6,3,2
15,260,260,37,19,18,4,3
9,278,278,18,12,6,3,2
30,286,286,20,4,16,3,2
2,286,286,48,48,0,1,0
31,322,322,2,2,0,1,0
19,327,327,42,9,33,4,3
6,340,340,12,12,0,1,0
27,340,340,13,4,9,4,3
23,350,350,34,21,13,2,1
35,368,368,16,5,11,2,1
13,369,369,3,3,0,1,0
28,381,381,59,50,9,4,3
33,387,387,47,47,0,1,0
34,393,393,6,6,0,1,0
11,412,412,23,23,0,1,0
22,413,413,114,90,24,2,1
24,455,455,32,14,18,4,3
16,455,455,38,38,0,1,0
3,467,467,57,57,0,1,0
25,480,480,39,7,32,3,2
29,488,488,4,4,0,1,0
26,496,496,6,6,0,1,0

26,108,108,10,1,9,4,3
10,115,115,4,4,0,1,0
28,128,128,5,5,0,1,0
16,136,136,3,3,0,1,0
19,147,147,5,5,0,1,0
24,160,160,2,2,0,1,0
7,185,185,31,11,20,3,2
13,187,187,61,61,0,1,0
6,196,196,18,18,0,1,0
21,203,203,1,1,0,1,0
22,204,204,57,40,17,2,1
27,206,206,5,5,0,1,0
0,216,216,32,32,0,1,0
1,226,226,29,29,0,1,0
8,229,229,30,30,0,1,0
4,250,250,36,36,0,1,0
5,256,256,12,12,0,1,0
14,260,260,32,32,0,1,0
11,276,276,58,12,46,2,1
2,288,288,64,53,11,2,1
12,291,291,3,3,0,1,0
18,294,294,112,43,69,4,3
3,317,317,41,17,24,4,3
23,319,319,13,13,0,1,0
15,324,324,22,4,18,4,3
17,352,352,30,2,28,2,1
9,388,388,53,53,0,1,0
25,392,392,22,9,13,2,1
20,429,429,19,8,11,2,1

5,105,105,1,1,0,1,0
12,105,105,1,1,0,1,0
13,113,113,1,1,0,1,0
3,123,123,11,4,7,2,1
6,141,141,24,20,4,2,1
34,153,153,11,11,0,1,0
15,166,166,13,3,10,2,1
16,172,172,6,6,0,1,0
18,173,173,30,30,0,1,0
17,174,174,20,20,0,1,0
14,178,178,12,2,10,3,2
22,180,180,34,5,29,2,1
10,184,184,20,20,0,1,0
25,206,206,27,27,0,1,0
0,211,211,26,26,0,1,0
8,227,227,8,8,0,1,0
35,261,261,43,43,0,1,0
4,281,281,20,5,15,4,3
20,285,285,6,6,0,1,0
36,292,292,3,3,0,1,0
26,300,300,4,4,0,1,0
11,324,324,23,15,8,2,1
9,327,327,18,18,0,1,0
29,341,341,62,62,0,1,0
19,347,347,9,1,8,2,1
23,347,347,114,23,91,4,3
2,360,360,24,14,10,3,2
37,386,386,46,46,0,1,0
7,388,388,63,29,34,3,2
1,389,389,8,8,0,1,0
33,394,394,21,21,0,1,0
24,417,417,15,6,9,2,1
27,458,458,15,1,14,2,1
31,473,473,40,19,21,4,3
21,481,481,40,7,33,4,3
32,482,482,29,4,25,2,1
30,483,483,1,1,0,1,0
28,496,496,73,35,38,2,1

29,157,157,27,27,0,1,0
10,161,161,2,2,0,1,0
34,165,165,29,29,0,1,0
28,170,170,37,25,12,3,2
25,172,172,1,1,0,1,0
5,173,173,9,1,8,3,2
27,173,173,16,16,0,1,0
6,202,202,5,5,0,1,0
41,203,203,41,41,0,1,0
4,206,206,3,3,0,1,0
26,206,206,15,2,13,2,1
11,221,221,15,15,0,1,0
21,223,223,25,19,6,2,1
17,232,232,3,3,0,1,0
19,248,248,33,33,0,1,0
32,251,251,4,1,3,2,1
33,253,253,25,13,12,4,3
8,263,263,57,57,0,1,0
12,265,265,5,5,0,1,0
15,266,266,3,3,0,1,0
37,268,268,24,24,0,1,0
23,276,276,6,3,3,2,1
0,280,280,27,11,16,3,2
7,298,298,1,1,0,1,0
16,306,306,36,29,7,2,1
36,306,306,8,8,0,1,0
31,307,307,29,12,17,2,1
14,320,320,27,27,0,1,0
35,322,322,11,11,0,1,0
9,333,333,35,14,21,2,1
3,338,338,12,12,0,1,0
13,340,340,13,2,11,2,1
39,342,342,42,1,41,2,1
2,360,360,17,11,6,3,2
30,412,412,11,1,10,3,2
18,417,417,25,25,0,1,0
42,417,417,8,8,0,1,0
1,431,431,16,13,3,2,1
40,445,445,62,29,33,2,1
38,450,450,44,44,0,1,0
22,472,472,49,35,14,3,2
24,494,494,29,13,16,3,2
20,496,496,20,20,0,1,0

12,106,106,7,2,5,2,1
20,121,121,3,3,0,1,0
1,124,124,3,3,0,1,0
18,142,142,16,4,12,4,3
3,149,149,1,1,0,1,0
14,166,166,7,7,0,1,0
23,179,179,5,2,3,2,1
17,197,197,9,9,0,1,0
26,203,203,21,16,5,2,1
5,233,233,23,2,21,2,1
2,249,249,1,1,0,1,0
10,262,262,3,3,0,1,0
13,287,287,45,15,30,2,1
9,293,293,79,76,3,2,1
8,311,311,54,54,0,1,0
4,318,318,23,23,0,1,0
11,367,367,2,2,0,1,0
22,370,370,95,53,42,4,3
7,390,390,115,58,57,4,3
6,403,403,88,88,0,1,0
19,431,431,6,6,0,1,0
27,446,446,30,19,11,2,1
15,447,447,45,14,31,4,3
24,455,455,203,185,18,4,3
25,460,460,15,7,8,3,2
16,467,467,86,27,59,4,3
21,483,483,2,2,0,1,0
28,493,493,7,7,0,1,0
0,496,496,176,129,47,4,3

10,104,104,21,21,0,1,0
29,114,114,50,16,34,2,1
11,137,137,19,4,15,4,3
27,151,151,10,10,0,1,0
0,157,157,1,1,0,1,0
35,167,167,25,10,15,2,1
13,171,171,18,18,0,1,0
7,173,173,12,2,10,4,3
8,174,174,16,3,13,2,1
4,187,187,1,1,0,1,0
9,205,205,5,5,0,1,0
32,216,216,3,3,0,1,0
12,222,222,11,11,0,1,0
17,224,224,33,33,0,1,0
16,229,229,9,3,6,3,2
21,238,238,3,3,0,1,0
18,278,278,25,7,18,2,1
36,285,285,75,31,44,3,2
33,287,287,7,1,6,2,1
15,289,289,40,2,38,3,2
30,305,305,12,4,8,2,1
26,329,329,10,7,3,2,1
19,338,338,17,2,15,2,1
25,339,339,23,7,16,3,2
34,342,342,51,19,32,2,1
2,342,342,24,2,22,2,1
6,352,352,26,26,0,1,0
20,358,358,74,2,72,4,3
22,375,375,39,39,0,1,0
14,387,387,10,4,6,2,1
23,390,390,70,70,0,1,0
3,406,406,21,21,0,1,0
24,406,406,16,16,0,1,0
28,449,449,7,7,0,1,0
1,461,461,4,4,0,1,0
5,486,486,3,3,0,1,0
31,493,493,21,21,0,1,0

10,144,144,15,6,9,2,1
20,145,145,31,1,30,3,2
4,147,147,9,9,0,1,0
13,157,157,9,3,6,2,1
17,158,158,15,15,0,1,0
21,159,159,15,7,8,2,1
3,192,192,8,5,3,2,1
6,195,195,6,6,0,1,0
8,205,205,5,5,0,1,0
35,206,206,52,52,0,1,0
22,208,208,12,3,9,2,1
34,215,215,4,4,0,1,0
12,250,250,23,23,0,1,0
18,262,262,14,14,0,1,0
5,284,284,26,26,0,1,0
28,297,297,8,8,0,1,0
14,310,310,57,57,0,1,0
7,324,324,76,14,62,3,2
0,324,324,29,29,0,1,0
19,330,330,22,22,0,1,0
1,357,357,2,2,0,1,0
30,371,371,8,2,6,3,2
27,373,373,48,34,14,2,1
2,373,373,13,3,10,3,2
15,375,375,19,11,8,3,2
23,387,387,13,2,11,2,1
32,392,392,11,11,0,1,0
29,392,392,75,27,48,2,1
9,396,396,19,12,7,2,1
24,458,458,35,17,18,4,3
33,459,459,33,3,30,2,1
31,465,465,71,11,60,4,3
26,471,471,6,6,0,1,0
16,479,479,58,8,50,4,3
25,494,494,123,119,4,2,1
11,500,500,57,36,21,4,3

23,141,141,3,3,0,1,0
14,147,147,18,3,15,2,1
18,185,185,1,1,0,1,0
31,192,192,30,30,0,1,0
2,193,193,33,9,24,2,1
12,207,207,15,3,12,2,1
0,237,237,7,7,0,1,0
30,242,242,67,67,0,1,0
8,251,251,4,4,0,1,0
15,254,254,3,3,0,1,0
13,296,296,21,8,13,2,1
24,304,304,2,2,0,1,0
26,324,324,45,3,42,3,2
22,325,325,7,7,0,1,0
19,328,328,33,33,0,1,0
20,334,334,67,60,7,2,1
21,343,343,79,79,0,1,0
7,372,372,14,14,0,1,0
17,377,377,43,30,13,2,1
33,384,384,28,28,0,1,0
16,386,386,35,35,0,1,0
5,390,390,72,72,0,1,0
9,391,391,51,51,0,1,0
28,392,392,45,29,16,3,2
1,408,408,35,35,0,1,0
10,408,408,6,6,0,1,0
29,409,409,1,1,0,1,0
27,416,416,23,23,0,1,0
4,417,417,75,61,14,2,1
6,454,454,15,12,3,2,1
32,461,461,41,41,0,1,0
3,464,464,4,1,3,2,1
11,472,472,108,66,42,3,2
25,483,483,68,68,0,1,0

25,105,105,3,3,0,1,0
24,112,112,9,9,0,1,0
5,116,116,29,13,16,3,2
13,129,129,35,23,12,4,3
8,136,136,1,1,0,1,0
7,168,168,46,18,28,2,1
4,170,170,11,11,0,1,0
16,203,203,5,1,4,2,1
2,249,249,10,10,0,1,0
26,253,253,7,7,0,1,0
15,267,267,10,4,6,3,2
11,268,268,6,6,0,1,0
20,280,280,47,14,33,4,3
18,281,281,35,35,0,1,0
12,284,284,26,26,0,1,0
23,337,337,54,54,0,1,0
21,381,381,101,2,99,4,3
9,381,381,12,12,0,1,0
19,387,387,21,21,0,1,0
10,404,404,61,61,0,1,0
17,420,420,79,52,27,4,3
3,425,425,127,97,30,2,1
22,430,430,5,5,0,1,0
6,471,471,23,23,0,1,0
14,472,472,39,17,22,2,1
1,476,476,15,15,0,1,0
0,477,477,192,192,0,1,0

16,111,111,5,5,0,1,0
11,119,119,8,8,0,1,0
3,130,130,22,10,12,2,1
19,142,142,13,1,12,4,3
28,162,162,11,11,0,1,0
1,180,180,14,8,6,2,1
14,184,184,21,21,0,1,0
17,192,192,2,2,0,1,0
12,200,200,15,6,9,4,3
21,208,208,13,2,11,3,2
13,236,236,30,30,0,1,0
10,243,243,38,27,11,2,1
15,245,245,4,4,0,1,0
20,256,256,6,1,5,2,1
7,266,266,4,1,3,2,1
32,286,286,22,22,0,1,0
26,293,293,7,7,0,1,0
30,294,294,27,1,26,2,1
2,334,334,6,6,0,1,0
0,334,334,30,27,3,2,1
9,341,341,33,33,0,1,0
5,352,352,68,68,0,1,0
6,361,361,28,25,3,2,1
34,371,371,10,6,4,2,1
33,377,377,5,5,0,1,0
27,379,379,35,12,23,2,1
31,382,382,74,48,26,2,1
22,383,383,98,77,21,2,1
4,389,389,54,24,30,2,1
29,402,402,70,70,0,1,0
8,411,411,6,3,3,2,1
18,467,467,46,46,0,1,0
24,477,477,102,39,63,4,3
23,494,494,88,88,0,1,0
25,498,498,22,22,0,1,0

30,104,104,3,3,0,1,0
22,107,107,17,7,10,3,2
15,122,122,35,26,9,4,3
4,132,132,3,3,0,1,0
25,141,141,30,20,10,2,1
0,145,145,33,33,0,1,0
8,150,150,3,3,0,1,0
23,164,164,6,6,0,1,0
16,166,166,12,12,0,1,0
18,199,199,11,11,0,1,0
17,218,218,7,7,0,1,0
31,227,227,44,44,0,1,0
19,232,232,16,16,0,1,0
20,236,236,35,35,0,1,0
7,249,249,32,32,0,1,0
6,263,263,30,30,0,1,0
5,286,286,5,5,0,1,0
29,293,293,108,53,55,3,2
24,312,312,33,33,0,1,0
11,317,317,90,9,81,4,3
3,317,317,25,9,16,2,1
10,351,351,42,8,34,2,1
12,357,357,6,6,0,1,0
13,370,370,58,12,46,2,1
14,383,383,1,1,0,1,0
1,388,388,6,6,0,1,0
9,424,424,10,10,0,1,0
28,430,430,19,19,0,1,0
27,432,432,25,25,0,1,0
26,459,459,1,1,0,1,0
2,472,472,43,21,22,2,1
21,482,482,26,26,0,1,0

21,137,137,7,7,0,1,0
24,142,142,40,6,34,3,2
28,155,155,4,4,0,1,0
20,162,162,3,3,0,1,0
12,173,173,6,6,0,1,0
3,181,181,77,53,24,4,3
23,186,186,44,37,7,2,1
27,189,189,6,6,0,1,0
19,199,199,9,9,0,1,0
31,217,217,39,11,28,3,2
30,229,229,106,64,42,4,3
7,230,230,34,4,30,4,3
13,263,263,14,1,13,4,3
18,267,267,7,4,3,2,1
1,280,280,13,1,12,4,3
15,286,286,1,1,0,1,0
2,302,302,20,11,9,4,3
29,321,321,9,1,8,3,2
6,326,326,13,13,0,1,0
14,339,339,23,23,0,1,0
25,355,355,20,5,15,4,3
33,365,365,2,2,0,1,0
26,367,367,61,61,0,1,0
17,369,369,64,41,23,2,1
4,377,377,31,7,24,3,2
8,387,387,17,17,0,1,0
11,388,388,43,43,0,1,0
32,407,407,6,6,0,1,0
9,408,408,19,19,0,1,0
16,439,439,35,16,19,2,1
22,443,443,4,4,0,1,0
10,450,450,46,1,45,2,1
0,454,454,18,18,0,1,0
5,494,494,18,18,0,1,0

15,101,101,12,12,0,1,0
24,103,103,3,3,0,1,0
23,154,154,6,6,0,1,0
21,158,158,3,3,0,1,0
31,167,167,46,46,0,1,0
1,184,184,46,39,7,2,1
8,201,201,1,1,0,1,0
9,215,215,16,16,0,1,0
18,224,224,32,32,0,1,0
6,242,242,38,17,21,4,3
20,245,245,6,6,0,1,0
2,245,245,18,18,0,1,0
30,251,251,6,6,0,1,0
0,254,254,5,5,0,1,0
16,255,255,12,2,10,3,2
29,264,264,10,10,0,1,0
19,284,284,31,31,0,1,0
33,298,298,61,28,33,4,3
13,306,306,80,73,7,2,1
14,342,342,1,1,0,1,0
32,348,348,85,85,0,1,0
10,355,355,23,12,11,2,1
28,365,365,1,1,0,1,0
11,366,366,11,1,10,2,1
17,394,394,32,5,27,2,1
7,398,398,17,17,0,1,0
3,416,416,32,25,7,2,1
4,431,431,25,25,0,1,0
34,434,434,39,9,30,2,1
26,439,439,84,84,0,1,0
27,445,445,22,22,0,1,0
5,446,446,4,4,0,1,0
25,478,478,129,129,0,1,0
22,483,483,15,15,0,1,0
12,497,497,44,44,0,1,0

22,107,107,10,10,0,1,0
20,108,108,11,11,0,1,0
1,112,112,1,1,0,1,0
18,121,121,3,3,0,1,0
7,123,123,1,1,0,1,0
32,124,124,2,2,0,1,0
8,132,132,25,25,0,1,0
34,133,133,27,11,16,2,1
21,144,144,1,1,0,1,0
30,144,144,13,13,0,1,0
12,169,169,1,1,0,1,0
23,169,169,35,35,0,1,0
3,172,172,14,2,12,4,3
28,189,189,25,15,10,2,1
37,201,201,11,11,0,1,0
35,202,202,28,28,0,1,0
27,214,214,23,7,16,2,1
11,244,244,5,5,0,1,0
16,254,254,14,3,11,2,1
25,307,307,1,1,0,1,0
26,315,315,26,18,8,3,2
17,326,326,1,1,0,1,0
38,327,327,9,9,0,1,0
33,341,341,33,14,19,2,1
15,350,350,21,9,12,4,3
14,381,381,7,7,0,1,0
13,384,384,35,23,12,4,3
10,393,393,3,3,0,1,0
36,394,394,65,55,10,2,1
31,394,394,101,62,39,4,3
19,408,408,20,20,0,1,0
9,412,412,37,37,0,1,0
4,419,419,45,45,0,1,0
24,425,425,9,1,8,3,2
5,427,427,82,60,22,2,1
6,431,431,36,36,0,1,0
2,446,446,11,7,4,2,1
29,481,481,16,3,13,3,2
0,491,491,139,40,99,4,3

34,114,114,30,11,19,2,1
19,128,128,3,3,0,1,0
32,128,128,5,1,4,2,1
41,133,133,10,7,3,2,1
6,137,137,3,3,0,1,0
4,148,148,18,18,0,1,0
25,149,149,3,3,0,1,0
11,149,149,1,1,0,1,0
9,173,173,22,17,5,2,1
39,186,186,28,28,0,1,0
8,192,192,20,2,18,2,1
7,197,197,14,1,13,3,2
30,211,211,23,7,16,3,2
36,220,220,37,9,28,3,2
22,221,221,10,10,0,1,0
40,226,226,10,10,0,1,0
5,249,249,3,3,0,1,0
1,254,254,1,1,0,1,0
29,280,280,25,25,0,1,0
38,284,284,1,1,0,1,0
18,297,297,49,10,39,4,3
3,298,298,39,39,0,1,0
23,302,302,28,28,0,1,0
33,306,306,3,3,0,1,0
2,322,322,36,18,18,4,3
24,329,329,5,5,0,1,0
28,350,350,68,68,0,1,0
20,351,351,4,1,3,2,1
35,373,373,47,47,0,1,0
13,380,380,24,24,0,1,0
12,403,403,1,1,0,1,0
27,413,413,125,122,3,2,1
0,415,415,3,3,0,1,0
17,440,440,26,26,0,1,0
31,448,448,8,8,0,1,0
10,449,449,42,42,0,1,0
26,450,450,5,5,0,1,0
37,473,473,13,13,0,1,0
14,483,483,11,11,0,1,0
15,483,483,53,35,18,4,3
16,487,487,24,6,18,3,2
21,500,500,56,56,0,1,0

7,102,102,2,2,0,1,0
16,134,134,1,1,0,1,0
19,175,175,15,15,0,1,0
5,182,182,2,2,0,1,0
21,263,263,54,22,32,4,3
18,273,273,16,16,0,1,0
12,298,298,26,18,8,2,1
22,314,314,13,13,0,1,0
2,316,316,7,7,0,1,0
10,321,321,29,3,26,3,2
0,335,335,87,87,0,1,0
23,339,339,20,2,18,4,3
17,351,351,50,14,36,3,2
11,368,368,8,8,0,1,0
24,376,376,9,9,0,1,0
8,387,387,46,3,43,3,2
14,422,422,3,3,0,1,0
15,423,423,256,208,48,3,2
4,425,425,239,227,12,4,3
25,435,435,70,38,32,4,3
20,436,436,1,1,0,1,0
1,437,437,56,56,0,1,0
9,441,441,28,4,24,4,3
6,447,447,154,154,0,1,0
3,450,450,32,23,9,2,1
13,457,457,12,12,0,1,0

10,101,101,1,1,0,1,0
17,103,103,7,7,0,1,0
22,113,113,4,4,0,1,0
18,115,115,9,6,3,2,1
27,119,119,34,34,0,1,0
20,137,137,12,12,0,1,0
16,140,140,4,1,3,2,1
19,152,152,9,3,6,2,1
23,168,168,6,6,0,1,0
7,195,195,8,8,0,1,0
13,197,197,5,5,0,1,0
31,221,221,20,11,9,4,3
26,222,222,15,5,10,3,2
3,238,238,7,1,6,2,1
15,261,261,4,4,0,1,0
12,273,273,129,91,38,3,2
5,281,281,20,20,0,1,0
25,303,303,79,61,18,4,3
8,308,308,36,36,0,1,0
37,319,319,34,34,0,1,0
11,320,320,7,7,0,1,0
6,322,322,27,27,0,1,0
33,325,325,59,19,40,3,2
21,342,342,12,2,10,2,1
30,343,343,72,72,0,1,0
36,350,350,6,6,0,1,0
14,368,368,12,12,0,1,0
28,373,373,37,17,20,2,1
0,383,383,63,63,0,1,0
32,396,396,5,1,4,2,1
35,401,401,13,2,11,2,1
9,405,405,23,1,22,3,2
2,416,416,8,5,3,2,1
34,426,426,52,20,32,3,2
29,432,432,12,1,11,4,3
1,442,442,12,12,0,1,0
4,491,491,28,28,0,1,0
24,497,497,23,23,0,1,0

27,143,143,3,3,0,1,0
6,158,158,29,29,0,1,0
3,188,188,23,23,0,1,0
8,196,196,46,46,0,1,0
20,218,218,19,19,0,1,0
14,237,237,11,11,0,1,0
10,240,240,106,91,15,4,3
24,244,244,66,52,14,3,2
19,256,256,13,13,0,1,0
17,273,273,12,12,0,1,0
4,285,285,33,33,0,1,0
9,290,290,3,3,0,1,0
15,299,299,14,14,0,1,0
23,300,300,51,19,32,2,1
18,371,371,12,5,7,2,1
7,405,405,54,13,41,2,1
22,419,419,13,13,0,1,0
21,421,421,110,80,30,3,2
5,422,422,1,1,0,1,0
16,426,426,61,49,12,3,2
0,433,433,7,7,0,1,0
12,452,452,87,87,0,1,0
13,463,463,30,30,0,1,0
11,466,466,8,1,7,2,1
25,467,467,36,17,19,3,2
26,472,472,39,30,9,4,3
1,485,485,24,8,16,3,2
2,490,490,134,92,42,4,3

2,101,101,1,1,0,1,0
0,159,159,7,7,0,1,0
3,167,167,48,48,0,1,0
28,173,173,10,10,0,1,0
11,197,197,15,15,0,1,0
20,198,198,3,3,0,1,0
12,210,210,11,3,8,3,2
29,210,210,2,2,0,1,0
31,224,224,156,30,126,4,3
36,236,236,36,4,32,3,2
23,240,240,1,1,0,1,0
13,248,248,10,2,8,2,1
9,269,269,20,20,0,1,0
15,278,278,25,25,0,1,0
19,287,287,19,10,9,4,3
1,289,289,10,10,0,1,0
7,294,294,1,1,0,1,0
32,299,299,11,11,0,1,0
17,299,299,13,9,4,2,1
4,299,299,42,42,0,1,0
34,327,327,15,2,13,2,1
5,333,333,23,11,12,2,1
37,341,341,18,14,4,2,1
6,363,363,6,6,0,1,0
22,364,364,14,7,7,2,1
30,369,369,36,36,0,1,0
35,371,371,6,6,0,1,0
16,373,373,1,1,0,1,0
24,381,381,11,1,10,2,1
10,382,382,103,103,0,1,0
8,387,387,57,57,0,1,0
27,391,391,28,6,22,2,1
18,401,401,15,4,11,2,1
26,404,404,21,21,0,1,0
21,409,409,31,17,14,3,2
33,430,430,49,49,0,1,0
25,433,433,66,66,0,1,0
14,465,465,2,2,0,1,0

1,118,118,41,8,33,2,1
3,123,123,1,1,0,1,0
26,126,126,1,1,0,1,0
23,145,145,4,1,3,2,1
20,153,153,11,2,9,4,3
22,155,155,22,22,0,1,0
0,167,167,63,11,52,3,2
12,170,170,4,1,3,2,1
17,178,178,30,9,21,2,1
15,194,194,2,2,0,1,0
25,197,197,46,46,0,1,0
6,214,214,45,45,0,1,0
14,221,221,37,10,27,4,3
18,227,227,75,42,33,4,3
10,266,266,15,15,0,1,0
9,307,307,9,9,0,1,0
13,341,341,35,31,4,2,1
5,345,345,54,30,24,4,3
11,389,389,39,7,32,3,2
2,409,409,34,6,28,3,2
24,426,426,14,14,0,1,0
19,448,448,2,2,0,1,0
16,451,451,47,47,0,1,0
7,454,454,64,64,0,1,0
8,458,458,81,81,0,1,0
21,474,474,55,18,37,2,1
4,483,483,7,7,0,1,0

30,101,101,23,5,18,3,2
6,101,101,6,6,0,1,0
16,101,101,13,4,9,2,1
3,108,108,1,1,0,1,0
20,111,111,10,10,0,1,0
21,125,125,2,2,0,1,0
10,131,131,13,13,0,1,0
19,138,138,22,4,18,2,1
1,151,151,1,1,0,1,0
28,152,152,1,1,0,1,0
31,157,157,32,19,13,2,1
29,166,166,29,29,0,1,0
13,170,170,7,1,6,3,2
25,180,180,30,30,0,1,0
9,245,245,65,46,19,2,1
11,253,253,23,23,0,1,0
0,262,262,4,4,0,1,0
7,264,264,32,16,16,2,1
17,269,269,5,5,0,1,0
4,270,270,12,12,0,1,0
15,284,284,25,15,10,2,1
8,299,299,121,76,45,3,2
18,320,320,5,1,4,2,1
5,332,332,49,49,0,1,0
24,352,352,46,18,28,3,2
22,364,364,85,32,53,4,3
26,431,431,5,2,3,2,1
14,447,447,43,26,17,2,1
23,450,450,9,9,0,1,0
2,457,457,15,4,11,2,1
27,478,478,18,6,12,2,1
12,485,485,38,14,24,2,1

0,118,118,28,28,0,1,0
23,129,129,27,15,12,2,1
24,142,142,11,1,10,3,2
9,152,152,18,18,0,1,0
25,152,152,2,2,0,1,0
22,166,166,52,52,0,1,0
3,177,177,14,14,0,1,0
19,187,187,32,8,24,4,3
21,214,214,4,4,0,1,0
8,215,215,27,27,0,1,0
1,230,230,26,26,0,1,0
2,254,254,14,14,0,1,0
4,277,277,13,13,0,1,0
13,288,288,38,11,27,4,3
17,317,317,25,4,21,4,3
7,324,324,80,73,7,2,1
15,368,368,3,3,0,1,0
26,388,388,12,12,0,1,0
27,404,404,20,8,12,4,3
10,417,417,30,30,0,1,0
14,423,423,13,13,0,1,0
20,424,424,22,22,0,1,0
11,426,426,40,40,0,1,0
6,427,427,56,38,18,4,3
16,432,432,29,29,0,1,0
12,432,432,112,16,96,4,3
5,451,451,127,101,26,2,1
18,479,479,61,52,9,2,1

27,106,106,21,21,0,1,0
4,124,124,1,1,0,1,0
23,128,128,6,1,5,2,1
8,145,145,21,21,0,1,0
18,161,161,6,3,3,2,1
5,163,163,11,1,10,3,2
33,176,176,44,14,30,3,2
19,188,188,3,3,0,1,0
1,228,228,39,29,10,2,1
25,247,247,46,46,0,1,0
28,251,251,19,14,5,2,1
31,254,254,47,29,18,3,2
35,258,258,2,2,0,1,0
14,265,265,19,19,0,1,0
29,275,275,8,2,6,3,2
15,286,286,1,1,0,1,0
17,288,288,38,38,0,1,0
20,295,295,31,13,18,2,1
12,300,300,10,10,0,1,0
30,316,316,35,2,33,2,1
2,317,317,5,5,0,1,0
16,320,320,20,2,18,4,3
24,320,320,74,46,28,3,2
9,335,335,28,17,11,2,1
32,340,340,7,2,5,2,1
6,397,397,25,17,8,3,2
11,409,409,7,7,0,1,0
21,411,411,27,16,11,2,1
26,459,459,36,14,22,4,3
7,461,461,25,19,6,2,1
3,463,463,58,58,0,1,0
36,466,466,52,18,34,3,2
10,466,466,30,30,0,1,0
13,469,469,38,6,32,3,2
22,474,474,12,12,0,1,0
34,478,478,4,4,0,1,0
0,493,493,120,120,0,1,0

35,126,126,14,5,9,3,2
13,129,129,6,6,0,1,0
16,138,138,1,1,0,1,0
29,146,146,35,35,0,1,0
36,146,146,13,13,0,1,0
10,150,150,34,34,0,1,0
17,159,159,1,1,0,1,0
27,160,160,52,52,0,1,0
7,167,167,2,2,0,1,0
23,168,168,1,1,0,1,0
32,182,182,2,2,0,1,0
12,187,187,4,4,0,1,0
33,194,194,6,6,0,1,0
1,194,194,1,1,0,1,0
38,220,220,7,7,0,1,0
40,226,226,9,9,0,1,0
6,257,257,16,2,14,2,1
5,258,258,2,2,0,1,0
39,258,258,2,2,0,1,0
11,267,267,1,1,0,1,0
19,287,287,12,8,4,2,1
31,296,296,21,3,18,3,2
14,296,296,42,7,35,2,1
3,316,316,15,15,0,1,0
21,323,323,62,44,18,2,1
15,348,348,10,10,0,1,0
26,361,361,28,7,21,2,1
18,366,366,34,34,0,1,0
9,376,376,23,23,0,1,0
25,391,391,9,9,0,1,0
8,404,404,3,3,0,1,0
22,415,415,4,4,0,1,0
28,417,417,8,1,7,3,2
4,432,432,46,46,0,1,0
0,434,434,47,28,19,2,1
20,450,450,55,8,47,2,1
34,458,458,165,155,10,3,2
24,463,463,51,12,39,2,1
37,481,481,3,3,0,1,0
41,481,481,66,66,0,1,0
30,492,492,38,14,24,2,1
2,494,494,51,51,0,1,0

1,106,106,1,1,0,1,0
21,107,107,9,9,0,1,0
28,119,119,28,10,18,4,3
24,154,154,5,2,3,2,1
22,155,155,14,14,0,1,0
15,176,176,6,6,0,1,0
12,191,191,6,3,3,2,1
33,194,194,13,13,0,1,0
10,200,200,3,3,0,1,0
26,207,207,5,1,4,2,1
16,222,222,52,52,0,1,0
14,222,222,37,37,0,1,0
32,223,223,1,1,0,1,0
17,226,226,24,3,21,3,2
20,233,233,35,35,0,1,0
27,234,234,11,11,0,1,0
8,251,251,40,40,0,1,0
30,256,256,11,11,0,1,0
7,266,266,3,3,0,1,0
9,267,267,2,2,0,1,0
3,279,279,50,5,45,2,1
18,282,282,8,5,3,2,1
2,302,302,4,1,3,2,1
13,323,323,15,5,10,3,2
19,342,342,84,84,0,1,0
25,346,346,49,49,0,1,0
11,353,353,42,42,0,1,0
4,364,364,3,3,0,1,0
29,403,403,88,33,55,4,3
6,444,444,155,77,78,4,3
31,453,453,66,66,0,1,0
23,457,457,29,17,12,4,3
5,485,485,49,35,14,2,1
0,492,492,5,1,4,2,1

8,100,100,7,3,4,2,1
26,135,135,10,10,0,1,0
19,150,150,19,6,13,2,1
24,208,208,17,1,16,3,2
7,231,231,64,64,0,1,0
18,240,240,3,3,0,1,0
17,256,256,26,26,0,1,0
3,259,259,90,90,0,1,0
16,261,261,28,28,0,1,0
4,277,277,6,6,0,1,0
20,278,278,80,80,0,1,0
11,297,297,8,4,4,2,1
22,306,306,32,18,14,2,1
12,317,317,9,5,4,2,1
1,335,335,71,51,20,2,1
15,340,340,16,11,5,2,1
6,359,359,32,32,0,1,0
23,360,360,48,1,47,4,3
0,383,383,53,53,0,1,0
21,408,408,35,35,0,1,0
25,431,431,93,51,42,2,1
13,435,435,55,37,18,3,2
9,437,437,12,12,0,1,0
14,443,443,2,2,0,1,0
10,454,454,78,69,9,2,1
2,462,462,57,57,0,1,0
5,499,499,48,4,44,3,2
27,500,500,46,3,43,2,1

28,120,120,49,5,44,3,2
12,125,125,14,2,12,4,3
24,144,144,35,4,31,3,2
19,159,159,1,1,0,1,0
13,169,169,7,1,6,3,2
1,173,173,1,1,0,1,0
3,185,185,90,54,36,4,3
7,192,192,4,1,3,2,1
18,217,217,18,9,9,2,1
5,226,226,21,21,0,1,0
26,232,232,1,1,0,1,0
10,250,250,25,25,0,1,0
17,269,269,23,17,6,2,1
15,273,273,4,4,0,1,0
11,280,280,48,12,36,2,1
21,292,292,1,1,0,1,0
14,334,334,62,2,60,3,2
22,352,352,24,24,0,1,0
4,361,361,16,16,0,1,0
9,393,393,53,8,45,4,3
8,404,404,1,1,0,1,0
16,413,413,14,9,5,2,1
6,417,417,21,21,0,1,0
25,439,439,52,34,18,3,2
27,439,439,64,64,0,1,0
0,449,449,149,74,75,4,3
2,474,474,24,7,17,2,1
20,480,480,37,37,0,1,0
23,489,489,53,5,48,4,3

