12,114,114,1,1,0,1,0
9,124,124,27,12,15,4,3
10,162,162,10,10,0,1,0
14,214,214,3,3,0,1,0
20,248,248,5,5,0,1,0
19,248,248,54,54,0,1,0
0,249,249,31,31,0,1,0
23,255,255,15,12,3,2,1
8,271,271,45,45,0,1,0
18,303,303,44,44,0,1,0
22,308,308,30,20,10,2,1
13,311,311,4,4,0,1,0
2,319,319,37,20,17,2,1
16,333,333,47,47,0,1,0
17,344,344,2,2,0,1,0
11,352,352,3,3,0,1,0
5,356,356,85,82,3,2,1
24,373,373,40,23,17,2,1
4,388,388,1,1,0,1,0
6,406,406,56,56,0,1,0
1,414,414,1,1,0,1,0
15,425,425,41,41,0,1,0
7,441,441,48,48,0,1,0
21,478,478,190,169,21,4,3
3,497,497,58,34,24,4,3

9,140,140,1,1,0,1,0
26,142,142,3,3,0,1,0
20,178,178,20,14,6,2,1
4,209,209,23,23,0,1,0
19,210,210,13,13,0,1,0
23,221,221,7,2,5,2,1
3,237,237,5,5,0,1,0
27,256,256,5,5,0,1,0
10,276,276,9,4,5,2,1
7,281,281,14,1,13,2,1
21,283,283,5,5,0,1,0
15,289,289,13,1,12,3,2
22,292,292,1,1,0,1,0
29,312,312,28,7,21,2,1
18,341,341,17,17,0,1,0
14,346,346,50,50,0,1,0
5,348,348,66,57,9,4,3
1,362,362,24,3,21,3,2
0,369,369,19,8,11,2,1
2,373,373,51,51,0,1,0
12,391,391,58,16,42,3,2
24,411,411,192,189,3,2,1
28,421,421,152,145,7,2,1
13,425,425,11,7,4,2,1
11,427,427,95,11,84,3,2
6,446,446,7,7,0,1,0
17,449,449,9,9,0,1,0
16,459,459,12,5,7,2,1
25,476,476,29,29,0,1,0
8,497,497,4,4,0,1,0

25,105,105,10,1,9,2,1
22,110,110,1,1,0,1,0
23,119,119,9,9,0,1,0
4,124,124,8,2,6,3,2
6,144,144,13,13,0,1,0
14,146,146,7,7,0,1,0
3,151,151,39,39,0,1,0
16,160,160,21,9,12,3,2
7,166,166,22,22,0,1,0
0,173,173,2,2,0,1,0
5,187,187,23,23,0,1,0
17,189,189,18,1,17,2,1
19,191,191,26,26,0,1,0
1,196,196,7,7,0,1,0
15,205,205,10,1,9,4,3
21,239,239,13,3,10,2,1
10,242,242,8,8,0,1,0
27,267,267,15,15,0,1,0
13,271,271,5,5,0,1,0
12,276,276,19,19,0,1,0
18,320,320,14,2,12,4,3
20,368,368,70,65,5,2,1
8,368,368,3,3,0,1,0
26,373,373,10,4,6,2,1
11,436,436,22,4,18,3,2
2,465,465,48,48,0,1,0
24,475,475,173,135,38,2,1
9,478,478,122,117,5,2,1

5,113,113,3,3,0,1,0
1,118,118,24,7,17,2,1
10,119,119,1,1,0,1,0
11,153,153,7,7,0,1,0
22,188,188,25,25,0,1,0
15,197,197,15,5,10,3,2
13,201,201,47,3,44,2,1
19,203,203,18,11,7,3,2
7,212,212,17,3,14,3,2
9,251,251,5,5,0,1,0
24,256,256,15,15,0,1,0
14,259,259,20,20,0,1,0
18,261,261,24,24,0,1,0
2,265,265,21,21,0,1,0
4,290,290,84,24,60,4,3
12,303,303,50,38,12,2,1
21,310,310,8,8,0,1,0
6,331,331,44,36,8,2,1
3,340,340,30,30,0,1,0
8,397,397,4,4,0,1,0
16,426,426,70,10,60,4,3
20,485,485,22,4,18,2,1
17,488,488,61,29,32,4,3
23,488,488,20,20,0,1,0
0,494,494,157,153,4,2,1

19,102,102,9,9,0,1,0
12,104,104,13,1,12,4,3
25,134,134,50,50,0,1,0
1,159,159,10,10,0,1,0
16,161,161,28,19,9,4,3
27,163,163,28,28,0,1,0
22,175,175,14,14,0,1,0
2,193,193,32,28,4,2,1
13,227,227,5,5,0,1,0
4,241,241,1,1,0,1,0
20,255,255,6,6,0,1,0
21,264,264,4,4,0,1,0
11,267,267,25,25,0,1,0
17,270,270,6,6,0,1,0
7,332,332,1,1,0,1,0
18,345,345,22,22,0,1,0
28,362,362,64,64,0,1,0
30,366,366,4,4,0,1,0
10,373,373,2,2,0,1,0
15,383,383,67,67,0,1,0
31,391,391,47,14,33,2,1
9,398,398,16,13,3,2,1
24,403,403,48,27,21,4,3
6,416,416,40,40,0,1,0
14,419,419,13,1,12,4,3
29,421,421,42,21,21,4,3
3,428,428,6,6,0,1,0
23,433,433,15,15,0,1,0
0,437,437,32,20,12,2,1
5,470,470,19,19,0,1,0
8,490,490,44,44,0,1,0
26,500,500,8,8,0,1,0

22,103,103,18,18,0,1,0
16,140,140,3,3,0,1,0
12,153,153,20,2,18,3,2
9,155,155,18,13,5,2,1
0,162,162,51,7,44,3,2
3,182,182,11,4,7,2,1
8,252,252,8,5,3,2,1
2,256,256,6,6,0,1,0
10,265,265,10,7,3,2,1
6,268,268,12,12,0,1,0
19,283,283,98,98,0,1,0
5,292,292,58,30,28,2,1
17,309,309,15,15,0,1,0
1,325,325,30,23,7,2,1
15,350,350,41,41,0,1,0
23,351,351,4,4,0,1,0
13,359,359,15,5,10,3,2
7,366,366,128,128,0,1,0
18,410,410,21,21,0,1,0
4,430,430,14,14,0,1,0
20,474,474,67,26,41,2,1
14,482,482,56,17,39,2,1
11,486,486,50,50,0,1,0
21,488,488,11,3,8,2,1

24,112,112,13,13,0,1,0
2,114,114,2,2,0,1,0
13,116,116,4,4,0,1,0
16,126,126,11,11,0,1,0
4,141,141,1,1,0,1,0
30,160,160,17,3,14,4,3
19,168,168,39,28,11,2,1
23,170,170,12,12,0,1,0
22,181,181,13,6,7,2,1
1,211,211,11,11,0,1,0
8,222,222,20,20,0,1,0
5,227,227,45,45,0,1,0
11,240,240,27,18,9,2,1
21,257,257,16,4,12,2,1
12,263,263,10,10,0,1,0
20,265,265,3,3,0,1,0
15,269,269,5,2,3,2,1
18,270,270,108,78,30,3,2
14,293,293,17,17,0,1,0
7,305,305,9,4,5,2,1
0,314,314,29,29,0,1,0
3,353,353,10,10,0,1,0
10,365,365,43,19,24,3,2
28,376,376,23,23,0,1,0
9,397,397,6,6,0,1,0
25,415,415,5,5,0,1,0
6,433,433,110,56,54,4,3
27,478,478,54,54,0,1,0
17,487,487,24,15,9,4,3
26,487,487,19,19,0,1,0
29,487,487,19,5,14,2,1

11,121,121,6,3,3,2,1
2,127,127,17,13,4,2,1
12,162,162,3,3,0,1,0
19,164,164,5,1,4,2,1
16,167,167,23,23,0,1,0
3,231,231,82,56,26,3,2
20,243,243,18,18,0,1,0
14,255,255,79,33,46,3,2
5,282,282,12,7,5,2,1
0,288,288,63,38,25,2,1
4,298,298,30,21,9,4,3
7,312,312,50,20,30,2,1
15,315,315,1,1,0,1,0
13,329,329,57,57,0,1,0
18,333,333,11,11,0,1,0
17,390,390,46,32,14,3,2
9,404,404,7,2,5,2,1
6,422,422,36,36,0,1,0
10,437,437,38,25,13,3,2
1,450,450,3,3,0,1,0
8,469,469,93,68,25,4,3
21,489,489,131,73,58,3,2

19,142,142,5,5,0,1,0
24,156,156,43,43,0,1,0
4,156,156,4,4,0,1,0
18,165,165,2,2,0,1,0
6,171,171,37,37,0,1,0
22,179,179,4,4,0,1,0
23,215,215,9,9,0,1,0
17,238,238,42,42,0,1,0
20,280,280,19,19,0,1,0
5,308,308,5,5,0,1,0
7,317,317,85,75,10,3,2
21,327,327,93,51,42,4,3
15,333,333,14,3,11,2,1
2,335,335,95,95,0,1,0
3,339,339,37,23,14,3,2
13,346,346,11,3,8,3,2
25,358,358,44,12,32,2,1
11,365,365,32,32,0,1,0
14,410,410,4,4,0,1,0
1,416,416,6,6,0,1,0
8,422,422,31,1,30,2,1
0,426,426,33,33,0,1,0
10,434,434,39,39,0,1,0
9,483,483,15,15,0,1,0
12,491,491,4,1,3,2,1
16,500,500,103,8,95,4,3

16,155,155,92,26,66,4,3
4,186,186,15,6,9,4,3
23,214,214,14,4,10,2,1
9,216,216,17,13,4,2,1
2,217,217,8,8,0,1,0
3,222,222,19,14,5,2,1
24,231,231,16,16,0,1,0
18,255,255,37,12,25,2,1
14,262,262,10,10,0,1,0
15,264,264,25,7,18,3,2
0,278,278,38,38,0,1,0
10,289,289,26,26,0,1,0
6,291,291,61,10,51,4,3
19,295,295,1,1,0,1,0
21,313,313,26,26,0,1,0
11,314,314,11,11,0,1,0
7,338,338,36,18,18,2,1
22,345,345,4,4,0,1,0
12,352,352,106,106,0,1,0
8,363,363,22,7,15,4,3
13,386,386,5,1,4,2,1
17,395,395,53,53,0,1,0
5,431,431,27,8,19,2,1
20,446,446,2,2,0,1,0
1,472,472,8,1,7,2,1
25,472,472,31,31,0,1,0

7,126,126,1,1,0,1,0
15,130,130,21,15,6,3,2
10,166,166,20,20,0,1,0
21,167,167,13,13,0,1,0
22,174,174,7,7,0,1,0
3,200,200,9,9,0,1,0
14,222,222,41,8,33,4,3
11,239,239,44,44,0,1,0
20,260,260,96,81,15,4,3
26,277,277,31,5,26,3,2
16,278,278,17,17,0,1,0
8,310,310,13,13,0,1,0
24,314,314,24,24,0,1,0
18,319,319,18,18,0,1,0
17,338,338,19,19,0,1,0
25,364,364,10,10,0,1,0
1,378,378,109,43,66,4,3
6,390,390,44,1,43,2,1
9,406,406,75,19,56,4,3
0,433,433,1,1,0,1,0
13,448,448,20,6,14,2,1
5,457,457,17,9,8,2,1
19,464,464,39,39,0,1,0
2,467,467,77,77,0,1,0
4,471,471,31,31,0,1,0
23,487,487,9,2,7,2,1
12,499,499,1,1,0,1,0

26,109,109,31,2,29,4,3
15,137,137,2,2,0,1,0
6,143,143,9,9,0,1,0
14,152,152,1,1,0,1,0
28,172,172,10,10,0,1,0
13,179,179,16,10,6,2,1
9,181,181,16,16,0,1,0
31,184,184,5,1,4,2,1
19,209,209,2,2,0,1,0
11,223,223,1,1,0,1,0
20,226,226,7,1,6,3,2
24,226,226,14,14,0,1,0
12,234,234,1,1,0,1,0
29,247,247,46,34,12,3,2
3,280,280,7,7,0,1,0
4,288,288,33,33,0,1,0
7,291,291,10,10,0,1,0
2,295,295,104,42,62,4,3
22,304,304,36,36,0,1,0
16,312,312,1,1,0,1,0
21,318,318,12,12,0,1,0
1,360,360,10,10,0,1,0
8,368,368,23,23,0,1,0
30,395,395,63,12,51,3,2
18,396,396,23,23,0,1,0
17,432,432,115,115,0,1,0
23,438,438,24,1,23,4,3
0,450,450,18,11,7,2,1
25,476,476,73,33,40,3,2
10,478,478,6,6,0,1,0
5,485,485,16,16,0,1,0
27,485,485,67,67,0,1,0

15,127,127,15,15,0,1,0
14,146,146,2,2,0,1,0
6,147,147,9,3,6,2,1
18,189,189,2,2,0,1,0
23,190,190,44,44,0,1,0
22,194,194,24,9,15,2,1
17,206,206,10,10,0,1,0
26,223,223,19,15,4,2,1
4,235,235,95,95,0,1,0
0,244,244,57,28,29,2,1
16,249,249,8,8,0,1,0
5,255,255,1,1,0,1,0
3,291,291,23,23,0,1,0
24,295,295,17,1,16,3,2
12,297,297,11,11,0,1,0
1,300,300,9,9,0,1,0
10,306,306,8,8,0,1,0
13,332,332,1,1,0,1,0
19,338,338,8,8,0,1,0
21,347,347,20,20,0,1,0
11,355,355,64,12,52,3,2
2,401,401,50,4,46,2,1
7,439,439,2,2,0,1,0
9,442,442,44,2,42,4,3
25,463,463,28,8,20,4,3
27,488,488,195,107,88,3,2
20,491,491,39,31,8,2,1
8,491,491,2,2,0,1,0

10,133,133,16,16,0,1,0
16,139,139,11,3,8,3,2
13,154,154,27,27,0,1,0
8,166,166,11,11,0,1,0
9,170,170,3,3,0,1,0
5,207,207,78,27,51,4,3
4,239,239,13,13,0,1,0
3,241,241,7,7,0,1,0
21,245,245,36,2,34,3,2
6,255,255,73,73,0,1,0
0,260,260,13,13,0,1,0
7,263,263,23,23,0,1,0
14,270,270,34,7,27,2,1
11,273,273,3,3,0,1,0
18,303,303,11,11,0,1,0
17,315,315,26,26,0,1,0
19,345,345,21,5,16,3,2
12,348,348,115,101,14,2,1
1,377,377,102,83,19,2,1
2,438,438,36,36,0,1,0
20,498,498,7,7,0,1,0
15,500,500,64,31,33,4,3

21,100,100,5,1,4,2,1
8,120,120,1,1,0,1,0
19,138,138,35,29,6,3,2
7,162,162,7,7,0,1,0
23,165,165,12,12,0,1,0
2,186,186,45,45,0,1,0
24,198,198,11,11,0,1,0
1,207,207,25,16,9,2,1
6,216,216,30,7,23,2,1
16,226,226,13,13,0,1,0
14,237,237,23,23,0,1,0
12,241,241,1,1,0,1,0
13,242,242,14,6,8,2,1
11,253,253,71,71,0,1,0
26,266,266,114,108,6,2,1
9,287,287,37,37,0,1,0
25,298,298,14,14,0,1,0
5,305,305,13,13,0,1,0
18,382,382,11,11,0,1,0
4,382,382,47,19,28,4,3
22,383,383,39,35,4,2,1
10,390,390,1,1,0,1,0
17,397,397,18,18,0,1,0
0,409,409,15,6,9,4,3
15,439,439,11,7,4,2,1
20,463,463,32,27,5,2,1
3,489,489,36,36,0,1,0

2,102,102,23,23,0,1,0
27,116,116,1,1,0,1,0
13,119,119,2,2,0,1,0
28,165,165,5,5,0,1,0
22,168,168,43,43,0,1,0
19,172,172,1,1,0,1,0
12,177,177,15,1,14,2,1
15,195,195,2,2,0,1,0
5,199,199,8,8,0,1,0
7,201,201,25,25,0,1,0
0,223,223,6,6,0,1,0
25,230,230,44,32,12,2,1
11,235,235,11,3,8,3,2
1,237,237,1,1,0,1,0
6,241,241,23,23,0,1,0
23,243,243,25,10,15,4,3
8,253,253,8,2,6,2,1
18,256,256,37,37,0,1,0
9,264,264,1,1,0,1,0
31,266,266,2,2,0,1,0
29,303,303,31,31,0,1,0
4,306,306,31,31,0,1,0
30,308,308,16,1,15,4,3
24,342,342,64,34,30,3,2
26,354,354,61,5,56,4,3
10,378,378,18,18,0,1,0
3,391,391,27,27,0,1,0
17,392,392,44,44,0,1,0
32,392,392,38,27,11,2,1
20,408,408,28,28,0,1,0
21,419,419,19,2,17,2,1
16,446,446,40,19,21,2,1
14,463,463,11,11,0,1,0

16,100,100,25,9,16,2,1
17,103,103,5,5,0,1,0
3,203,203,4,4,0,1,0
8,206,206,35,35,0,1,0
15,206,206,14,14,0,1,0
11,219,219,30,30,0,1,0
9,221,221,59,28,31,2,1
12,227,227,41,9,32,4,3
26,229,229,74,2,72,4,3
5,243,243,14,14,0,1,0
6,248,248,7,7,0,1,0
25,255,255,29,29,0,1,0
1,266,266,1,1,0,1,0
2,282,282,35,16,19,2,1
4,287,287,7,7,0,1,0
7,309,309,23,23,0,1,0
19,334,334,7,1,6,2,1
20,355,355,35,35,0,1,0
0,373,373,32,17,15,4,3
10,405,405,43,40,3,2,1
13,411,411,9,9,0,1,0
21,425,425,57,36,21,2,1
18,427,427,4,4,0,1,0
24,433,433,6,6,0,1,0
23,447,447,20,11,9,2,1
14,476,476,62,62,0,1,0
22,492,492,36,25,11,2,1

25,102,102,48,48,0,1,0
23,132,132,6,6,0,1,0
8,136,136,11,11,0,1,0
5,155,155,17,17,0,1,0
0,165,165,34,34,0,1,0
21,167,167,17,7,10,3,2
14,196,196,3,3,0,1,0
26,221,221,39,27,12,4,3
27,254,254,46,6,40,3,2
13,286,286,22,22,0,1,0
9,292,292,11,1,10,2,1
10,293,293,34,25,9,2,1
1,303,303,2,2,0,1,0
12,314,314,3,3,0,1,0
4,315,315,19,19,0,1,0
11,326,326,19,19,0,1,0
22,337,337,12,12,0,1,0
15,338,338,5,5,0,1,0
2,350,350,11,11,0,1,0
7,395,395,5,5,0,1,0
20,437,437,34,4,30,3,2
6,443,443,82,46,36,4,3
3,446,446,133,133,0,1,0
19,459,459,21,21,0,1,0
18,468,468,2,2,0,1,0
17,476,476,17,17,0,1,0
24,480,480,54,54,0,1,0
16,486,486,12,12,0,1,0

19,104,104,8,3,5,2,1
23,130,130,66,27,39,2,1
5,135,135,7,7,0,1,0
2,135,135,26,26,0,1,0
25,138,138,2,2,0,1,0
14,140,140,5,2,3,2,1
17,166,166,18,6,12,4,3
7,188,188,1,1,0,1,0
13,215,215,3,3,0,1,0
20,220,220,5,5,0,1,0
12,226,226,28,13,15,4,3
3,237,237,45,45,0,1,0
26,240,240,4,4,0,1,0
24,277,277,52,19,33,4,3
4,281,281,31,4,27,4,3
0,290,290,19,10,9,4,3
9,297,297,10,10,0,1,0
15,344,344,3,3,0,1,0
18,381,381,17,4,13,2,1
21,382,382,2,2,0,1,0
16,390,390,12,12,0,1,0
10,404,404,15,15,0,1,0
8,419,419,3,3,0,1,0
22,428,428,115,1,114,4,3
1,448,448,59,59,0,1,0
6,457,457,131,109,22,3,2
11,458,458,24,21,3,2,1

8,120,120,27,27,0,1,0
3,192,192,7,4,3,2,1
20,197,197,7,3,4,2,1
18,219,219,46,24,22,2,1
1,222,222,6,2,4,2,1
11,230,230,30,30,0,1,0
5,247,247,18,5,13,2,1
24,266,266,11,8,3,2,1
13,276,276,31,31,0,1,0
17,317,317,1,1,0,1,0
4,352,352,46,6,40,2,1
0,357,357,57,42,15,4,3
10,373,373,108,18,90,4,3
12,374,374,11,8,3,2,1
22,380,380,41,41,0,1,0
23,384,384,119,83,36,2,1
6,414,414,1,1,0,1,0
15,417,417,25,2,23,2,1
16,422,422,42,30,12,3,2
9,447,447,83,71,12,4,3
2,468,468,8,8,0,1,0
21,473,473,7,2,5,2,1
14,479,479,101,5,96,4,3
7,489,489,12,12,0,1,0
19,500,500,41,17,24,3,2

25,109,109,13,5,8,3,2
13,120,120,1,1,0,1,0
15,123,123,9,5,4,2,1
12,125,125,20,20,0,1,0
19,133,133,8,8,0,1,0
23,159,159,8,5,3,2,1
0,218,218,5,5,0,1,0
2,227,227,12,12,0,1,0
5,241,241,9,9,0,1,0
24,247,247,38,38,0,1,0
18,248,248,1,1,0,1,0
7,254,254,40,25,15,2,1
26,261,261,26,13,13,2,1
32,265,265,3,3,0,1,0
22,281,281,5,2,3,2,1
29,283,283,17,5,12,4,3
31,291,291,83,57,26,3,2
6,309,309,88,34,54,4,3
20,346,346,11,11,0,1,0
21,359,359,57,57,0,1,0
9,384,384,7,3,4,2,1
28,388,388,32,26,6,3,2
30,389,389,91,91,0,1,0
11,408,408,20,11,9,4,3
1,426,426,9,9,0,1,0
14,429,429,47,35,12,3,2
8,440,440,4,4,0,1,0
17,445,445,3,3,0,1,0
4,446,446,21,21,0,1,0
27,450,450,8,8,0,1,0
16,457,457,41,41,0,1,0
3,472,472,9,1,8,3,2
10,478,478,35,35,0,1,0

6,100,100,2,2,0,1,0
14,100,100,6,6,0,1,0
18,101,101,4,4,0,1,0
12,103,103,16,16,0,1,0
10,104,104,23,17,6,3,2
22,118,118,5,5,0,1,0
11,139,139,23,23,0,1,0
8,153,153,6,6,0,1,0
23,279,279,62,27,35,2,1
7,292,292,3,3,0,1,0
21,299,299,36,18,18,3,2
20,315,315,71,41,30,4,3
13,329,329,5,5,0,1,0
1,351,351,30,30,0,1,0
15,373,373,86,51,35,2,1
0,390,390,93,93,0,1,0
24,411,411,39,33,6,3,2
2,425,425,2,2,0,1,0
4,430,430,96,68,28,2,1
19,455,455,12,12,0,1,0
5,463,463,40,40,0,1,0
16,469,469,100,71,29,2,1
25,476,476,8,8,0,1,0
9,480,480,10,2,8,2,1
3,483,483,18,12,6,3,2
17,491,491,11,11,0,1,0

4,104,104,5,2,3,2,1
11,154,154,10,2,8,2,1
0,173,173,11,11,0,1,0
15,192,192,47,38,9,2,1
18,238,238,45,15,30,3,2
7,241,241,58,18,40,3,2
13,262,262,11,11,0,1,0
16,273,273,46,32,14,2,1
5,274,274,84,24,60,3,2
14,285,285,25,21,4,2,1
9,287,287,1,1,0,1,0
10,298,298,2,2,0,1,0
6,302,302,48,18,30,3,2
19,303,303,50,16,34,3,2
20,337,337,14,14,0,1,0
21,338,338,22,22,0,1,0
3,340,340,56,16,40,3,2
22,367,367,23,23,0,1,0
8,382,382,27,9,18,2,1
1,387,387,44,44,0,1,0
23,402,402,1,1,0,1,0
12,402,402,30,30,0,1,0
17,441,441,51,51,0,1,0
2,486,486,60,60,0,1,0

22,103,103,12,6,6,2,1
18,116,116,30,5,25,2,1
24,122,122,9,9,0,1,0
4,124,124,11,2,9,4,3
26,124,124,8,8,0,1,0
28,133,133,18,18,0,1,0
12,149,149,1,1,0,1,0
11,149,149,8,2,6,2,1
19,186,186,10,4,6,2,1
15,202,202,3,3,0,1,0
13,203,203,15,1,14,3,2
30,243,243,21,21,0,1,0
21,258,258,45,45,0,1,0
25,281,281,6,1,5,2,1
29,293,293,20,8,12,3,2
27,299,299,3,3,0,1,0
10,311,311,2,2,0,1,0
2,323,323,5,5,0,1,0
5,324,324,57,57,0,1,0
14,326,326,2,2,0,1,0
32,335,335,35,7,28,4,3
9,342,342,18,5,13,2,1
16,354,354,7,4,3,2,1
6,365,365,77,29,48,4,3
3,371,371,39,8,31,2,1
0,371,371,1,1,0,1,0
31,391,391,90,71,19,2,1
1,413,413,27,13,14,3,2
20,414,414,97,37,60,4,3
23,417,417,5,5,0,1,0
17,436,436,17,17,0,1,0
7,445,445,15,6,9,4,3
8,445,445,8,8,0,1,0

24,106,106,6,6,0,1,0
23,113,113,6,2,4,2,1
26,232,232,2,2,0,1,0
18,245,245,79,21,58,4,3
5,256,256,27,7,20,2,1
16,267,267,36,36,0,1,0
11,268,268,4,4,0,1,0
25,268,268,22,4,18,2,1
12,272,272,27,11,16,4,3
1,292,292,8,8,0,1,0
10,304,304,7,1,6,3,2
30,313,313,24,12,12,4,3
28,320,320,106,106,0,1,0
2,337,337,1,1,0,1,0
15,340,340,52,52,0,1,0
22,364,364,67,67,0,1,0
19,366,366,2,2,0,1,0
0,377,377,34,34,0,1,0
13,378,378,41,41,0,1,0
14,379,379,14,1,13,3,2
17,381,381,4,1,3,2,1
27,383,383,13,5,8,2,1
8,411,411,8,8,0,1,0
29,422,422,12,12,0,1,0
3,443,443,60,60,0,1,0
20,445,445,42,42,0,1,0
9,459,459,20,9,11,2,1
21,471,471,21,21,0,1,0
4,473,473,69,19,50,2,1
7,482,482,36,14,22,3,2
6,496,496,37,37,0,1,0

7,100,100,3,3,0,1,0
26,102,102,7,7,0,1,0
0,106,106,4,1,3,2,1
16,108,108,13,13,0,1,0
25,123,123,22,22,0,1,0
12,137,137,13,5,8,3,2
17,155,155,31,28,3,2,1
19,159,159,1,1,0,1,0
15,162,162,5,1,4,2,1
14,165,165,10,10,0,1,0
8,188,188,11,11,0,1,0
20,192,192,7,7,0,1,0
27,204,204,11,2,9,2,1
6,219,219,2,2,0,1,0
22,235,235,29,15,14,2,1
4,293,293,8,3,5,2,1
24,343,343,23,7,16,3,2
10,349,349,13,10,3,2,1
13,402,402,2,2,0,1,0
9,426,426,43,43,0,1,0
3,435,435,111,81,30,4,3
2,441,441,51,28,23,2,1
5,449,449,11,11,0,1,0
1,456,456,104,17,87,4,3
11,465,465,102,102,0,1,0
21,475,475,159,159,0,1,0
23,484,484,42,42,0,1,0
18,490,490,16,9,7,2,1

1,101,101,7,1,6,2,1
5,109,109,7,1,6,3,2
20,141,141,5,5,0,1,0
4,148,148,17,1,16,3,2
18,154,154,39,39,0,1,0
12,161,161,14,14,0,1,0
8,166,166,16,8,8,2,1
10,175,175,2,2,0,1,0
9,186,186,1,1,0,1,0
13,190,190,5,1,4,2,1
0,214,214,16,16,0,1,0
19,223,223,34,34,0,1,0
2,230,230,81,81,0,1,0
7,294,294,58,43,15,2,1
15,298,298,38,38,0,1,0
14,311,311,3,3,0,1,0
17,331,331,3,3,0,1,0
6,339,339,106,10,96,3,2
3,340,340,1,1,0,1,0
22,344,344,10,10,0,1,0
11,377,377,147,91,56,3,2
23,383,383,11,2,9,2,1
16,403,403,50,50,0,1,0
21,406,406,23,23,0,1,0

22,130,130,18,11,7,2,1
5,138,138,3,3,0,1,0
24,140,140,8,8,0,1,0
0,150,150,38,38,0,1,0
6,161,161,6,6,0,1,0
4,179,179,7,7,0,1,0
2,188,188,5,5,0,1,0
1,215,215,38,8,30,2,1
20,234,234,33,4,29,4,3
17,237,237,3,3,0,1,0
8,258,258,8,8,0,1,0
25,281,281,11,4,7,2,1
3,291,291,29,1,28,4,3
19,302,302,114,84,30,3,2
26,324,324,12,1,11,3,2
14,335,335,21,9,12,3,2
10,337,337,16,16,0,1,0
21,349,349,4,1,3,2,1
12,377,377,17,17,0,1,0
13,383,383,103,103,0,1,0
18,409,409,54,39,15,2,1
23,445,445,29,23,6,3,2
15,451,451,29,5,24,4,3
16,453,453,82,82,0,1,0
7,460,460,78,57,21,2,1
9,466,466,24,24,0,1,0
11,474,474,16,10,6,3,2

9,103,103,13,13,0,1,0
8,126,126,8,8,0,1,0
24,138,138,1,1,0,1,0
10,142,142,1,1,0,1,0
22,166,166,22,22,0,1,0
4,174,174,8,2,6,2,1
0,202,202,40,8,32,3,2
3,212,212,1,1,0,1,0
23,223,223,3,3,0,1,0
1,230,230,15,15,0,1,0
5,244,244,15,3,12,2,1
11,255,255,25,25,0,1,0
20,274,274,33,33,0,1,0
16,290,290,7,2,5,2,1
27,297,297,36,33,3,2,1
21,300,300,4,1,3,2,1
28,309,309,11,1,10,3,2
14,315,315,30,27,3,2,1
18,354,354,179,92,87,4,3
17,357,357,17,7,10,3,2
2,357,357,24,3,21,4,3
15,398,398,14,14,0,1,0
6,416,416,20,15,5,2,1
26,421,421,14,14,0,1,0
19,427,427,4,1,3,2,1
13,433,433,60,6,54,4,3
12,445,445,94,80,14,3,2
7,462,462,16,16,0,1,0
25,471,471,119,49,70,4,3

16,125,125,6,2,4,2,1
14,134,134,12,12,0,1,0
1,148,148,6,6,0,1,0
20,148,148,1,1,0,1,0
6,152,152,38,38,0,1,0
11,155,155,12,5,7,2,1
3,160,160,36,3,33,4,3
18,188,188,54,54,0,1,0
4,225,225,12,3,9,2,1
24,292,292,6,6,0,1,0
22,304,304,5,5,0,1,0
23,305,305,66,66,0,1,0
13,329,329,43,4,39,2,1
9,330,330,1,1,0,1,0
21,343,343,62,62,0,1,0
5,346,346,97,58,39,2,1
2,356,356,37,37,0,1,0
8,364,364,33,33,0,1,0
10,385,385,33,27,6,3,2
15,411,411,41,41,0,1,0
0,417,417,8,2,6,3,2
7,435,435,33,12,21,2,1
12,453,453,23,23,0,1,0
17,482,482,72,49,23,4,3
19,489,489,16,16,0,1,0

10,110,110,5,1,4,2,1
8,144,144,16,2,14,3,2
22,161,161,17,1,16,4,3
20,173,173,3,3,0,1,0
18,206,206,19,19,0,1,0
14,252,252,3,3,0,1,0
17,305,305,3,3,0,1,0
19,308,308,14,14,0,1,0
13,322,322,72,68,4,2,1
7,339,339,77,9,68,3,2
3,390,390,1,1,0,1,0
12,391,391,3,3,0,1,0
5,406,406,24,24,0,1,0
0,421,421,92,42,50,2,1
6,432,432,76,6,70,3,2
1,439,439,25,13,12,2,1
23,439,439,175,103,72,4,3
21,442,442,113,53,60,4,3
16,445,445,25,25,0,1,0
15,447,447,8,8,0,1,0
4,450,450,71,71,0,1,0
2,474,474,24,24,0,1,0
11,478,478,40,16,24,2,1
9,479,479,94,7,87,4,3

0,105,105,9,9,0,1,0
27,115,115,2,2,0,1,0
22,116,116,15,1,14,3,2
2,119,119,8,8,0,1,0
30,139,139,33,20,13,2,1
3,154,154,17,17,0,1,0
10,155,155,18,18,0,1,0
33,162,162,5,5,0,1,0
20,173,173,10,10,0,1,0
9,174,174,5,1,4,2,1
25,181,181,6,2,4,2,1
14,191,191,24,24,0,1,0
12,207,207,12,8,4,2,1
19,219,219,1,1,0,1,0
13,229,229,21,3,18,2,1
18,252,252,17,7,10,3,2
1,276,276,19,19,0,1,0
24,276,276,29,13,16,2,1
5,282,282,35,35,0,1,0
7,284,284,1,1,0,1,0
26,289,289,63,63,0,1,0
28,319,319,68,36,32,2,1
31,319,319,47,47,0,1,0
4,340,340,16,16,0,1,0
21,344,344,16,10,6,2,1
15,357,357,13,1,12,4,3
32,362,362,3,3,0,1,0
6,363,363,56,38,18,2,1
29,372,372,43,5,38,2,1
11,375,375,1,1,0,1,0
23,399,399,11,11,0,1,0
8,409,409,1,1,0,1,0
16,429,429,12,4,8,3,2
17,486,486,10,4,6,3,2

17,102,102,1,1,0,1,0
21,122,122,15,15,0,1,0
2,136,136,11,11,0,1,0
3,143,143,52,24,28,3,2
16,146,146,33,33,0,1,0
5,160,160,15,7,8,2,1
7,186,186,54,54,0,1,0
8,188,188,6,6,0,1,0
6,190,190,6,6,0,1,0
13,216,216,4,4,0,1,0
20,219,219,40,40,0,1,0
9,232,232,120,120,0,1,0
18,269,269,15,9,6,3,2
10,345,345,14,14,0,1,0
0,359,359,45,27,18,2,1
12,366,366,30,4,26,3,2
19,393,393,6,3,3,2,1
11,407,407,11,11,0,1,0
1,423,423,116,116,0,1,0
4,425,425,5,5,0,1,0
15,434,434,8,4,4,2,1
14,443,443,1,1,0,1,0

11,132,132,6,2,4,2,1
0,150,150,38,15,23,3,2
13,154,154,38,38,0,1,0
10,179,179,39,7,32,2,1
15,184,184,8,2,6,2,1
16,240,240,74,57,17,2,1
14,257,257,11,4,7,2,1
8,286,286,2,2,0,1,0
17,293,293,26,17,9,2,1
7,303,303,36,3,33,4,3
6,331,331,31,31,0,1,0
3,348,348,30,30,0,1,0
9,349,349,26,8,18,3,2
4,359,359,170,147,23,2,1
5,361,361,5,5,0,1,0
12,380,380,7,7,0,1,0
2,459,459,160,149,11,4,3
1,490,490,69,51,18,4,3

2,134,134,5,1,4,2,1
24,139,139,39,29,10,2,1
10,148,148,28,4,24,4,3
21,172,172,25,15,10,3,2
18,194,194,5,5,0,1,0
15,200,200,6,6,0,1,0
14,216,216,29,19,10,2,1
8,217,217,15,1,14,3,2
0,268,268,17,17,0,1,0
19,275,275,6,2,4,2,1
25,289,289,3,3,0,1,0
16,312,312,16,16,0,1,0
7,315,315,8,8,0,1,0
13,339,339,15,15,0,1,0
23,357,357,20,20,0,1,0
6,370,370,103,7,96,4,3
5,384,384,86,86,0,1,0
1,402,402,15,15,0,1,0
17,418,418,184,151,33,4,3
9,429,429,21,21,0,1,0
22,431,431,17,17,0,1,0
4,460,460,9,6,3,2,1
12,465,465,67,67,0,1,0
11,465,465,53,53,0,1,0
20,491,491,18,18,0,1,0
3,496,496,25,25,0,1,0

16,101,101,9,9,0,1,0
6,111,111,3,3,0,1,0
13,164,164,2,2,0,1,0
14,170,170,7,7,0,1,0
1,176,176,21,3,18,2,1
17,208,208,5,2,3,2,1
15,247,247,51,24,27,4,3
9,275,275,135,61,74,3,2
10,310,310,35,3,32,3,2
4,311,311,2,2,0,1,0
12,333,333,18,18,0,1,0
11,344,344,5,5,0,1,0
7,375,375,16,16,0,1,0
3,415,415,8,8,0,1,0
0,427,427,426,426,0,1,0
2,461,461,73,33,40,4,3
8,462,462,2,2,0,1,0
5,484,484,102,102,0,1,0

5,118,118,3,3,0,1,0
6,125,125,3,3,0,1,0
14,131,131,5,5,0,1,0
15,134,134,6,3,3,2,1
22,146,146,7,7,0,1,0
0,172,172,27,27,0,1,0
2,175,175,34,34,0,1,0
12,182,182,27,1,26,3,2
17,183,183,7,4,3,2,1
9,203,203,6,6,0,1,0
11,217,217,67,35,32,3,2
16,238,238,9,6,3,2,1
23,259,259,15,15,0,1,0
18,264,264,70,56,14,2,1
19,275,275,25,10,15,4,3
3,318,318,45,45,0,1,0
10,335,335,58,58,0,1,0
8,392,392,77,62,15,2,1
21,395,395,2,2,0,1,0
7,417,417,9,9,0,1,0
20,427,427,64,36,28,4,3
13,438,438,41,41,0,1,0
4,451,451,7,7,0,1,0
1,493,493,160,160,0,1,0

24,111,111,7,7,0,1,0
7,119,119,4,4,0,1,0
29,128,128,26,26,0,1,0
9,183,183,13,13,0,1,0
8,194,194,21,15,6,2,1
28,208,208,9,2,7,2,1
11,216,216,44,44,0,1,0
10,219,219,16,4,12,4,3
12,225,225,7,7,0,1,0
17,243,243,16,11,5,2,1
16,243,243,4,4,0,1,0
15,249,249,35,1,34,3,2
3,265,265,20,20,0,1,0
14,288,288,49,49,0,1,0
30,289,289,6,2,4,2,1
20,307,307,2,2,0,1,0
0,313,313,2,2,0,1,0
26,353,353,98,56,42,3,2
13,361,361,9,9,0,1,0
6,384,384,26,14,12,2,1
18,385,385,63,41,22,3,2
22,402,402,5,5,0,1,0
2,413,413,10,10,0,1,0
4,422,422,7,3,4,2,1
27,437,437,65,65,0,1,0
23,438,438,66,23,43,2,1
19,440,440,34,9,25,2,1
21,467,467,12,12,0,1,0
25,468,468,60,10,50,3,2
1,470,470,61,61,0,1,0
5,475,475,20,20,0,1,0

26,134,134,6,6,0,1,0
18,150,150,4,1,3,2,1
2,155,155,1,1,0,1,0
23,162,162,42,42,0,1,0
13,175,175,36,36,0,1,0
3,180,180,17,17,0,1,0
5,210,210,6,3,3,2,1
8,230,230,24,4,20,3,2
4,240,240,18,6,12,3,2
7,243,243,34,34,0,1,0
21,243,243,92,23,69,4,3
25,266,266,87,70,17,2,1
22,287,287,5,1,4,2,1
1,307,307,32,32,0,1,0
12,319,319,16,6,10,3,2
0,326,326,127,58,69,4,3
17,357,357,10,4,6,3,2
16,388,388,15,15,0,1,0
24,401,401,2,2,0,1,0
10,408,408,9,9,0,1,0
15,417,417,25,3,22,3,2
11,420,420,1,1,0,1,0
14,457,457,40,7,33,4,3
6,458,458,35,8,27,4,3
9,476,476,1,1,0,1,0
20,476,476,6,1,5,2,1
19,482,482,20,2,18,4,3

28,106,106,3,3,0,1,0
17,112,112,1,1,0,1,0
13,121,121,8,2,6,2,1
25,139,139,1,1,0,1,0
19,149,149,31,19,12,4,3
2,181,181,4,4,0,1,0
12,187,187,4,4,0,1,0
3,196,196,14,14,0,1,0
1,200,200,8,8,0,1,0
0,211,211,43,43,0,1,0
15,272,272,32,32,0,1,0
18,280,280,13,2,11,2,1
14,289,289,7,2,5,2,1
24,327,327,31,31,0,1,0
21,352,352,8,8,0,1,0
8,355,355,37,37,0,1,0
5,357,357,3,3,0,1,0
9,359,359,53,53,0,1,0
22,363,363,1,1,0,1,0
26,367,367,148,148,0,1,0
11,387,387,21,9,12,2,1
10,404,404,7,7,0,1,0
30,412,412,76,14,62,4,3
27,425,425,83,69,14,3,2
6,442,442,6,6,0,1,0
20,450,450,10,5,5,2,1
4,450,450,40,29,11,2,1
7,451,451,41,41,0,1,0
29,452,452,20,20,0,1,0
23,457,457,31,31,0,1,0
16,473,473,95,83,12,3,2

12,120,120,5,2,3,2,1
23,121,121,8,8,0,1,0
21,127,127,20,3,17,2,1
5,138,138,1,1,0,1,0
7,144,144,14,14,0,1,0
9,152,152,21,21,0,1,0
10,161,161,15,1,14,3,2
1,174,174,30,30,0,1,0
14,174,174,2,2,0,1,0
15,179,179,23,23,0,1,0
3,190,190,32,5,27,4,3
20,198,198,6,6,0,1,0
16,280,280,18,2,16,3,2
22,284,284,8,1,7,2,1
11,304,304,11,11,0,1,0
0,308,308,67,11,56,3,2
4,314,314,10,2,8,3,2
18,354,354,58,50,8,2,1
2,368,368,40,40,0,1,0
13,372,372,100,32,68,3,2
8,448,448,51,51,0,1,0
6,469,469,55,22,33,2,1
24,476,476,13,13,0,1,0
19,477,477,14,4,10,3,2
17,491,491,154,111,43,2,1

17,130,130,17,17,0,1,0
2,146,146,15,15,0,1,0
14,154,154,5,5,0,1,0
11,168,168,15,8,7,2,1
0,196,196,8,4,4,2,1
19,213,213,17,12,5,2,1
13,216,216,19,2,17,2,1
4,220,220,2,2,0,1,0
8,250,250,24,12,12,4,3
5,277,277,73,46,27,4,3
6,282,282,144,92,52,3,2
3,306,306,28,10,18,4,3
1,328,328,41,5,36,2,1
15,344,344,17,10,7,2,1
16,365,365,102,63,39,4,3
12,391,391,116,108,8,3,2
18,392,392,8,3,5,2,1
7,408,408,64,64,0,1,0
9,424,424,12,12,0,1,0
20,427,427,21,21,0,1,0
10,462,462,42,42,0,1,0

12,104,104,2,2,0,1,0
22,114,114,23,5,18,4,3
14,129,129,10,1,9,4,3
3,131,131,27,27,0,1,0
18,148,148,13,4,9,4,3
9,150,150,2,2,0,1,0
15,166,166,11,5,6,2,1
4,196,196,14,14,0,1,0
8,209,209,2,2,0,1,0
27,209,209,6,6,0,1,0
25,215,215,1,1,0,1,0
7,219,219,19,19,0,1,0
29,224,224,16,16,0,1,0
30,242,242,24,3,21,4,3
21,254,254,27,27,0,1,0
26,255,255,32,21,11,2,1
1,262,262,1,1,0,1,0
10,297,297,18,18,0,1,0
13,333,333,24,24,0,1,0
11,336,336,1,1,0,1,0
24,348,348,4,4,0,1,0
17,368,368,15,8,7,2,1
20,371,371,131,131,0,1,0
31,402,402,20,20,0,1,0
32,404,404,13,13,0,1,0
16,409,409,34,6,28,2,1
2,416,416,18,18,0,1,0
6,418,418,52,52,0,1,0
0,434,434,63,25,38,2,1
28,451,451,66,66,0,1,0
5,457,457,24,24,0,1,0
19,463,463,16,16,0,1,0
23,485,485,46,22,24,3,2

10,106,106,1,1,0,1,0
33,109,109,47,47,0,1,0
21,120,120,5,5,0,1,0
20,141,141,1,1,0,1,0
5,162,162,9,9,0,1,0
34,184,184,4,4,0,1,0
13,186,186,21,21,0,1,0
35,194,194,7,7,0,1,0
29,209,209,5,5,0,1,0
28,220,220,12,12,0,1,0
7,231,231,18,18,0,1,0
16,236,236,31,15,16,3,2
12,240,240,26,6,20,3,2
17,244,244,11,1,10,2,1
19,281,281,8,8,0,1,0
32,293,293,18,11,7,2,1
1,296,296,10,2,8,2,1
11,305,305,3,3,0,1,0
0,319,319,39,39,0,1,0
15,332,332,4,4,0,1,0
24,332,332,32,12,20,3,2
26,340,340,41,41,0,1,0
23,343,343,8,2,6,2,1
8,348,348,51,51,0,1,0
27,355,355,30,30,0,1,0
31,356,356,61,61,0,1,0
30,358,358,63,29,34,3,2
18,382,382,21,8,13,2,1
2,398,398,13,1,12,3,2
9,406,406,5,5,0,1,0
3,421,421,22,22,0,1,0
25,422,422,9,9,0,1,0
4,435,435,6,3,3,2,1
6,441,441,21,21,0,1,0
14,449,449,45,45,0,1,0
22,474,474,21,21,0,1,0

5,105,105,70,26,44,2,1
0,118,118,9,9,0,1,0
15,119,119,5,5,0,1,0
20,124,124,18,18,0,1,0
7,153,153,27,2,25,2,1
11,161,161,4,1,3,2,1
19,186,186,16,16,0,1,0
21,211,211,13,13,0,1,0
4,233,233,35,35,0,1,0
18,243,243,62,19,43,2,1
14,246,246,33,28,5,2,1
1,257,257,7,1,6,2,1
10,259,259,18,6,12,4,3
2,289,289,1,1,0,1,0
9,300,300,62,62,0,1,0
3,324,324,3,3,0,1,0
16,386,386,2,2,0,1,0
17,392,392,56,28,28,3,2
8,400,400,40,40,0,1,0
6,441,441,40,40,0,1,0
12,447,447,63,63,0,1,0
13,458,458,6,6,0,1,0

22,102,102,9,9,0,1,0
28,114,114,8,8,0,1,0
4,129,129,35,10,25,4,3
13,155,155,2,2,0,1,0
20,163,163,21,1,20,2,1
1,164,164,35,13,22,3,2
6,185,185,6,6,0,1,0
8,209,209,7,2,5,2,1
24,218,218,22,2,20,2,1
0,220,220,6,2,4,2,1
14,244,244,33,9,24,2,1
15,277,277,2,2,0,1,0
25,283,283,13,5,8,3,2
19,286,286,29,20,9,4,3
2,297,297,13,13,0,1,0
18,315,315,23,23,0,1,0
23,317,317,69,15,54,3,2
11,407,407,33,7,26,4,3
21,412,412,32,6,26,3,2
3,417,417,7,1,6,2,1
12,423,423,3,3,0,1,0
10,428,428,41,41,0,1,0
16,430,430,4,1,3,2,1
5,441,441,1,1,0,1,0
7,455,455,138,104,34,3,2
9,464,464,8,8,0,1,0
27,466,466,157,140,17,2,1
17,483,483,36,36,0,1,0
26,498,498,1,1,0,1,0

19,120,120,28,12,16,2,1
9,128,128,15,3,12,3,2
14,140,140,6,6,0,1,0
7,146,146,26,6,20,2,1
20,168,168,44,10,34,3,2
5,171,171,39,39,0,1,0
22,182,182,7,7,0,1,0
16,187,187,14,14,0,1,0
21,188,188,16,6,10,3,2
17,190,190,30,3,27,4,3
8,194,194,16,16,0,1,0
23,198,198,27,27,0,1,0
3,213,213,35,35,0,1,0
4,250,250,10,4,6,2,1
2,281,281,31,31,0,1,0
1,292,292,1,1,0,1,0
10,297,297,24,15,9,4,3
11,303,303,24,24,0,1,0
12,326,326,39,5,34,2,1
25,353,353,49,49,0,1,0
0,367,367,23,1,22,3,2
26,379,379,4,4,0,1,0
15,397,397,11,3,8,2,1
6,429,429,4,4,0,1,0
24,436,436,24,24,0,1,0
13,445,445,11,11,0,1,0
18,483,483,31,31,0,1,0

21,139,139,6,2,4,2,1
3,149,149,7,7,0,1,0
7,183,183,1,1,0,1,0
2,209,209,21,6,15,4,3
9,209,209,26,26,0,1,0
8,218,218,20,11,9,4,3
16,221,221,5,5,0,1,0
6,228,228,7,7,0,1,0
22,241,241,77,5,72,3,2
14,267,267,70,46,24,3,2
20,269,269,31,1,30,2,1
17,272,272,4,4,0,1,0
11,306,306,6,6,0,1,0
19,337,337,6,1,5,2,1
4,379,379,13,3,10,2,1
13,386,386,5,5,0,1,0
5,424,424,182,169,13,2,1
12,445,445,29,17,12,3,2
18,447,447,26,12,14,2,1
15,474,474,61,27,34,2,1
0,489,489,44,20,24,4,3
10,491,491,120,42,78,4,3
1,499,499,175,123,52,3,2

0,107,107,46,18,28,2,1
5,119,119,3,3,0,1,0
1,122,122,2,2,0,1,0
16,133,133,18,4,14,3,2
11,192,192,30,30,0,1,0
10,225,225,7,1,6,3,2
4,248,248,121,121,0,1,0
12,271,271,9,9,0,1,0
20,287,287,45,45,0,1,0
14,293,293,92,92,0,1,0
7,305,305,13,7,6,3,2
3,335,335,71,14,57,4,3
6,360,360,21,2,19,3,2
19,381,381,72,72,0,1,0
2,393,393,12,2,10,2,1
9,407,407,27,27,0,1,0
15,413,413,6,1,5,2,1
8,416,416,29,29,0,1,0
13,447,447,11,11,0,1,0
18,449,449,11,11,0,1,0
17,468,468,52,52,0,1,0

18,113,113,1,1,0,1,0
6,123,123,1,1,0,1,0
22,126,126,19,11,8,3,2
17,140,140,25,3,22,4,3
16,148,148,31,31,0,1,0
7,152,152,11,7,4,2,1
10,153,153,13,6,7,2,1
2,156,156,5,5,0,1,0
25,214,214,28,14,14,3,2
12,229,229,16,1,15,4,3
21,252,252,1,1,0,1,0
5,286,286,1,1,0,1,0
23,287,287,80,16,64,3,2
19,295,295,31,31,0,1,0
4,312,312,45,45,0,1,0
14,328,328,41,21,20,3,2
9,330,330,34,34,0,1,0
20,353,353,8,8,0,1,0
24,389,389,12,7,5,2,1
3,390,390,24,24,0,1,0
11,394,394,140,59,81,4,3
13,411,411,84,12,72,3,2
8,415,415,34,4,30,2,1
15,461,461,39,39,0,1,0
1,468,468,33,33,0,1,0
0,468,468,4,4,0,1,0
26,495,495,1,1,0,1,0

0,120,120,9,1,8,2,1
23,123,123,7,7,0,1,0
19,146,146,13,13,0,1,0
29,153,153,9,9,0,1,0
4,165,165,1,1,0,1,0
26,170,170,1,1,0,1,0
15,203,203,2,2,0,1,0
24,207,207,22,4,18,3,2
27,222,222,13,13,0,1,0
2,227,227,14,14,0,1,0
18,233,233,1,1,0,1,0
28,247,247,83,17,66,3,2
11,265,265,5,5,0,1,0
22,277,277,36,10,26,2,1
6,284,284,26,26,0,1,0
30,299,299,9,9,0,1,0
13,299,299,8,3,5,2,1
7,300,300,45,7,38,2,1
31,344,344,135,108,27,2,1
9,344,344,46,31,15,4,3
14,378,378,32,32,0,1,0
16,380,380,3,3,0,1,0
12,383,383,17,5,12,2,1
21,422,422,3,3,0,1,0
17,424,424,11,11,0,1,0
25,425,425,1,1,0,1,0
3,431,431,54,54,0,1,0
10,439,439,32,22,10,2,1
1,440,440,56,6,50,2,1
8,461,461,60,12,48,2,1
5,486,486,51,51,0,1,0
20,487,487,31,31,0,1,0

3,108,108,4,4,0,1,0
23,144,144,36,21,15,4,3
5,187,187,13,13,0,1,0
14,216,216,20,8,12,2,1
24,247,247,48,21,27,2,1
22,260,260,4,4,0,1,0
20,297,297,4,4,0,1,0
6,311,311,3,3,0,1,0
2,319,319,4,1,3,2,1
17,320,320,20,2,18,2,1
12,326,326,95,24,71,4,3
16,328,328,9,6,3,2,1
1,336,336,21,1,20,3,2
13,336,336,11,3,8,3,2
7,352,352,10,10,0,1,0
19,363,363,5,5,0,1,0
15,390,390,40,40,0,1,0
25,420,420,6,6,0,1,0
0,426,426,62,62,0,1,0
18,464,464,128,116,12,4,3
9,467,467,37,1,36,2,1
11,469,469,106,54,52,3,2
10,472,472,27,27,0,1,0
8,483,483,67,67,0,1,0
21,487,487,110,47,63,4,3
4,492,492,71,65,6,3,2

0,109,109,18,7,11,4,3
10,117,117,13,13,0,1,0
12,121,121,8,4,4,2,1
31,132,132,11,1,10,3,2
8,146,146,3,3,0,1,0
30,160,160,3,3,0,1,0
27,162,162,16,16,0,1,0
25,170,170,3,3,0,1,0
18,175,175,27,27,0,1,0
4,178,178,2,2,0,1,0
17,199,199,21,21,0,1,0
13,225,225,12,12,0,1,0
14,240,240,1,1,0,1,0
20,244,244,19,1,18,3,2
9,248,248,66,66,0,1,0
11,269,269,1,1,0,1,0
26,270,270,23,23,0,1,0
21,274,274,9,9,0,1,0
23,296,296,10,1,9,2,1
22,321,321,37,2,35,2,1
2,331,331,12,2,10,2,1
7,336,336,3,3,0,1,0
16,374,374,30,3,27,4,3
24,380,380,131,41,90,3,2
29,386,386,78,43,35,4,3
6,391,391,3,3,0,1,0
15,424,424,40,40,0,1,0
19,438,438,9,9,0,1,0
28,440,440,36,29,7,2,1
1,447,447,9,9,0,1,0
5,448,448,9,1,8,2,1
3,452,452,23,15,8,2,1
32,470,470,61,42,19,2,1

3,119,119,3,3,0,1,0
18,152,152,35,7,28,3,2
5,172,172,1,1,0,1,0
9,194,194,23,23,0,1,0
13,211,211,3,3,0,1,0
6,213,213,50,50,0,1,0
0,218,218,3,3,0,1,0
8,267,267,55,14,41,4,3
21,271,271,14,14,0,1,0
22,305,305,18,4,14,3,2
11,323,323,1,1,0,1,0
17,386,386,35,24,11,2,1
1,389,389,107,107,0,1,0
19,391,391,32,7,25,2,1
16,399,399,114,62,52,3,2
14,403,403,61,61,0,1,0
20,403,403,17,2,15,2,1
10,404,404,22,5,17,2,1
15,406,406,63,14,49,2,1
2,411,411,39,5,34,3,2
12,445,445,47,47,0,1,0
7,483,483,37,7,30,3,2
4,500,500,126,84,42,3,2

30,103,103,4,1,3,2,1
29,113,113,11,11,0,1,0
3,128,128,1,1,0,1,0
1,136,136,12,12,0,1,0
2,137,137,2,2,0,1,0
7,152,152,3,3,0,1,0
16,153,153,11,11,0,1,0
31,154,154,47,34,13,2,1
13,155,155,8,1,7,2,1
27,203,203,14,14,0,1,0
0,230,230,4,4,0,1,0
23,279,279,26,26,0,1,0
12,280,280,5,5,0,1,0
11,291,291,15,15,0,1,0
25,294,294,37,37,0,1,0
9,304,304,70,70,0,1,0
17,321,321,39,18,21,3,2
26,323,323,26,26,0,1,0
19,341,341,17,17,0,1,0
4,345,345,12,12,0,1,0
10,345,345,25,25,0,1,0
18,361,361,32,32,0,1,0
21,369,369,26,26,0,1,0
5,381,381,37,37,0,1,0
24,382,382,7,3,4,2,1
33,389,389,49,40,9,2,1
22,396,396,24,18,6,2,1
20,399,399,36,24,12,4,3
32,406,406,95,32,63,4,3
28,407,407,5,5,0,1,0
6,431,431,13,13,0,1,0
15,446,446,25,7,18,4,3
14,463,463,35,27,8,2,1
8,463,463,6,2,4,2,1

16,115,115,30,30,0,1,0
14,119,119,14,14,0,1,0
22,121,121,23,5,18,4,3
27,125,125,7,7,0,1,0
21,147,147,25,14,11,2,1
1,151,151,7,7,0,1,0
23,155,155,1,1,0,1,0
8,174,174,7,4,3,2,1
9,196,196,4,4,0,1,0
24,209,209,22,4,18,2,1
20,219,219,5,5,0,1,0
29,221,221,44,44,0,1,0
7,243,243,12,6,6,3,2
2,250,250,12,3,9,2,1
19,253,253,24,11,13,2,1
10,260,260,35,2,33,4,3
13,266,266,34,22,12,4,3
4,279,279,10,10,0,1,0
11,296,296,23,8,15,4,3
0,311,311,36,36,0,1,0
18,322,322,75,75,0,1,0
25,331,331,12,12,0,1,0
12,345,345,17,5,12,3,2
28,373,373,13,13,0,1,0
17,439,439,43,43,0,1,0
6,448,448,20,20,0,1,0
26,454,454,37,28,9,4,3
15,459,459,9,1,8,3,2
5,473,473,10,2,8,3,2
3,477,477,46,10,36,4,3

9,102,102,1,1,0,1,0
3,109,109,1,1,0,1,0
10,112,112,19,19,0,1,0
27,130,130,13,3,10,2,1
29,166,166,21,21,0,1,0
20,201,201,6,6,0,1,0
4,206,206,26,15,11,2,1
11,215,215,3,3,0,1,0
14,216,216,1,1,0,1,0
16,218,218,5,2,3,2,1
12,252,252,15,15,0,1,0
25,264,264,2,2,0,1,0
13,270,270,3,3,0,1,0
23,275,275,15,8,7,2,1
15,293,293,15,15,0,1,0
1,306,306,78,72,6,2,1
7,310,310,20,20,0,1,0
5,325,325,17,9,8,3,2
17,347,347,88,34,54,3,2
18,374,374,96,25,71,4,3
6,394,394,6,6,0,1,0
19,398,398,14,14,0,1,0
8,412,412,18,4,14,3,2
0,424,424,9,9,0,1,0
2,426,426,50,50,0,1,0
28,457,457,22,22,0,1,0
24,458,458,17,11,6,3,2
21,460,460,48,48,0,1,0
26,483,483,116,116,0,1,0
30,491,491,95,35,60,4,3
22,499,499,42,42,0,1,0

17,129,129,27,22,5,2,1
18,159,159,6,6,0,1,0
16,171,171,32,32,0,1,0
12,178,178,88,54,34,2,1
10,204,204,12,8,4,2,1
11,221,221,1,1,0,1,0
13,228,228,6,6,0,1,0
8,235,235,13,3,10,2,1
20,239,239,11,5,6,3,2
19,243,243,30,30,0,1,0
15,277,277,9,3,6,3,2
3,285,285,23,23,0,1,0
7,331,331,29,24,5,2,1
6,342,342,7,7,0,1,0
21,388,388,60,16,44,3,2
1,427,427,6,6,0,1,0
0,433,433,33,18,15,4,3
25,435,435,11,11,0,1,0
4,440,440,10,7,3,2,1
23,442,442,52,23,29,2,1
2,444,444,32,5,27,2,1
14,450,450,77,21,56,4,3
9,454,454,66,54,12,3,2
5,482,482,83,45,38,3,2
22,482,482,17,17,0,1,0
24,498,498,80,80,0,1,0

15,100,100,7,4,3,2,1
14,101,101,28,19,9,4,3
2,134,134,15,15,0,1,0
5,148,148,5,1,4,2,1
19,151,151,25,9,16,2,1
17,167,167,6,6,0,1,0
11,197,197,16,4,12,2,1
16,212,212,1,1,0,1,0
3,213,213,51,18,33,2,1
1,230,230,6,6,0,1,0
8,279,279,8,2,6,2,1
12,282,282,5,5,0,1,0
13,365,365,7,7,0,1,0
9,377,377,41,23,18,2,1
20,391,391,14,14,0,1,0
22,396,396,37,12,25,4,3
4,398,398,198,110,88,3,2
18,410,410,119,45,74,4,3
21,423,423,70,70,0,1,0
7,439,439,25,19,6,2,1
0,440,440,11,11,0,1,0
10,443,443,32,18,14,3,2
6,462,462,80,18,62,3,2

14,102,102,1,1,0,1,0
6,103,103,3,3,0,1,0
4,105,105,6,6,0,1,0
8,122,122,3,3,0,1,0
18,126,126,22,22,0,1,0
15,149,149,7,1,6,2,1
9,159,159,1,1,0,1,0
0,163,163,6,6,0,1,0
19,163,163,22,22,0,1,0
29,165,165,14,8,6,2,1
7,166,166,5,2,3,2,1
13,179,179,16,10,6,2,1
16,184,184,32,19,13,2,1
17,185,185,1,1,0,1,0
10,188,188,22,2,20,2,1
1,237,237,1,1,0,1,0
20,254,254,38,34,4,2,1
22,283,283,28,28,0,1,0
25,299,299,28,28,0,1,0
5,322,322,57,57,0,1,0
2,333,333,5,2,3,2,1
31,336,336,7,1,6,2,1
12,337,337,4,1,3,2,1
27,339,339,29,10,19,2,1
3,339,339,79,79,0,1,0
26,346,346,36,6,30,3,2
30,410,410,63,63,0,1,0
21,416,416,31,31,0,1,0
23,425,425,68,41,27,4,3
11,427,427,26,9,17,3,2
24,436,436,35,17,18,3,2
28,498,498,39,39,0,1,0

10,135,135,31,31,0,1,0
7,140,140,11,2,9,4,3
14,161,161,5,5,0,1,0
16,174,174,24,15,9,2,1
12,231,231,48,10,38,3,2
15,233,233,22,7,15,4,3
8,295,295,52,52,0,1,0
2,302,302,73,49,24,2,1
9,306,306,47,11,36,2,1
6,323,323,41,22,19,2,1
18,325,325,2,2,0,1,0
5,352,352,84,48,36,2,1
17,358,358,66,30,36,3,2
13,397,397,29,29,0,1,0
21,412,412,8,8,0,1,0
4,418,418,139,103,36,4,3
1,422,422,12,2,10,3,2
3,426,426,23,23,0,1,0
20,450,450,64,29,35,2,1
0,462,462,12,12,0,1,0
19,465,465,13,5,8,2,1
11,485,485,11,11,0,1,0

25,101,101,26,15,11,2,1
26,110,110,2,2,0,1,0
9,128,128,8,5,3,2,1
0,129,129,10,2,8,2,1
27,132,132,8,8,0,1,0
19,139,139,4,1,3,2,1
12,157,157,11,3,8,3,2
16,158,158,8,8,0,1,0
17,173,173,28,9,19,2,1
15,222,222,9,9,0,1,0
10,243,243,19,6,13,2,1
14,260,260,10,7,3,2,1
28,297,297,11,1,10,2,1
6,298,298,1,1,0,1,0
11,308,308,42,20,22,2,1
5,310,310,26,26,0,1,0
18,328,328,34,34,0,1,0
23,332,332,31,31,0,1,0
7,337,337,7,7,0,1,0
1,337,337,43,4,39,2,1
24,340,340,20,20,0,1,0
20,348,348,141,141,0,1,0
21,354,354,8,1,7,2,1
22,363,363,13,13,0,1,0
8,382,382,92,74,18,4,3
2,423,423,28,28,0,1,0
13,436,436,40,40,0,1,0
4,445,445,35,35,0,1,0
3,491,491,42,42,0,1,0

12,106,106,7,7,0,1,0
25,114,114,14,1,13,4,3
28,134,134,1,1,0,1,0
4,136,136,1,1,0,1,0
20,150,150,7,7,0,1,0
1,171,171,2,2,0,1,0
0,176,176,44,44,0,1,0
18,196,196,5,5,0,1,0
7,199,199,3,3,0,1,0
10,242,242,8,8,0,1,0
2,274,274,45,45,0,1,0
11,274,274,24,24,0,1,0
26,281,281,98,50,48,4,3
27,286,286,29,21,8,2,1
22,353,353,55,55,0,1,0
5,360,360,7,4,3,2,1
21,368,368,11,3,8,3,2
8,375,375,3,3,0,1,0
14,377,377,93,41,52,3,2
13,382,382,102,66,36,4,3
23,409,409,88,88,0,1,0
17,411,411,55,43,12,4,3
15,418,418,25,25,0,1,0
9,420,420,15,15,0,1,0
19,433,433,3,3,0,1,0
3,435,435,12,12,0,1,0
6,459,459,1,1,0,1,0
16,461,461,1,1,0,1,0
24,464,464,62,14,48,2,1

2,112,112,6,1,5,2,1
13,120,120,6,6,0,1,0
5,152,152,3,3,0,1,0
1,171,171,16,3,13,2,1
15,175,175,3,3,0,1,0
6,193,193,9,9,0,1,0
3,206,206,57,13,44,2,1
16,217,217,11,11,0,1,0
19,225,225,33,8,25,4,3
20,247,247,66,66,0,1,0
9,326,326,2,2,0,1,0
18,329,329,32,32,0,1,0
24,347,347,29,22,7,2,1
10,354,354,26,26,0,1,0
22,364,364,46,46,0,1,0
4,376,376,53,41,12,3,2
11,381,381,15,4,11,2,1
0,391,391,22,5,17,2,1
8,394,394,94,64,30,4,3
17,407,407,40,9,31,2,1
14,408,408,7,2,5,2,1
7,466,466,120,58,62,3,2
23,473,473,77,59,18,4,3
21,498,498,5,5,0,1,0
12,500,500,99,39,60,4,3

3,110,110,10,10,0,1,0
6,131,131,23,11,12,2,1
17,143,143,2,2,0,1,0
20,148,148,12,5,7,2,1
16,165,165,27,11,16,2,1
8,202,202,5,5,0,1,0
4,220,220,2,2,0,1,0
12,238,238,51,22,29,2,1
0,264,264,99,45,54,3,2
15,290,290,10,10,0,1,0
9,312,312,13,5,8,2,1
5,321,321,12,12,0,1,0
14,326,326,33,33,0,1,0
10,331,331,26,11,15,4,3
18,400,400,29,12,17,2,1
11,403,403,63,63,0,1,0
2,405,405,61,61,0,1,0
13,416,416,109,79,30,3,2
19,434,434,37,37,0,1,0
1,495,495,110,54,56,3,2
7,499,499,120,24,96,4,3

2,111,111,4,4,0,1,0
1,122,122,1,1,0,1,0
11,134,134,32,4,28,3,2
4,145,145,5,5,0,1,0
14,173,173,9,3,6,2,1
6,179,179,4,4,0,1,0
9,213,213,4,4,0,1,0
12,218,218,8,8,0,1,0
3,230,230,38,4,34,2,1
25,256,256,13,9,4,2,1
23,268,268,21,3,18,2,1
5,287,287,113,84,29,3,2
10,309,309,14,2,12,4,3
0,310,310,75,75,0,1,0
15,319,319,29,7,22,3,2
19,321,321,50,42,8,2,1
24,321,321,39,12,27,2,1
18,330,330,22,5,17,2,1
8,354,354,13,2,11,2,1
7,356,356,9,3,6,2,1
22,356,356,57,57,0,1,0
16,380,380,48,38,10,2,1
17,396,396,67,32,35,2,1
20,475,475,108,76,32,3,2
21,476,476,11,2,9,2,1
13,498,498,2,2,0,1,0

11,103,103,7,7,0,1,0
12,110,110,1,1,0,1,0
21,113,113,5,5,0,1,0
29,122,122,14,14,0,1,0
8,152,152,10,10,0,1,0
26,171,171,6,3,3,2,1
23,209,209,22,22,0,1,0
13,213,213,4,4,0,1,0
5,221,221,52,13,39,2,1
24,224,224,23,23,0,1,0
2,230,230,1,1,0,1,0
0,237,237,12,4,8,3,2
19,273,273,62,38,24,2,1
15,273,273,3,3,0,1,0
1,274,274,15,15,0,1,0
4,291,291,31,31,0,1,0
10,294,294,42,42,0,1,0
28,356,356,6,3,3,2,1
25,359,359,16,16,0,1,0
9,362,362,11,5,6,3,2
22,392,392,24,9,15,4,3
18,409,409,8,8,0,1,0
6,413,413,56,41,15,4,3
16,432,432,13,7,6,3,2
14,438,438,14,14,0,1,0
3,449,449,38,38,0,1,0
27,462,462,30,30,0,1,0
7,464,464,20,20,0,1,0
30,466,466,10,1,9,2,1
17,479,479,85,21,64,3,2
20,484,484,223,106,117,4,3

23,105,105,15,15,0,1,0
0,108,108,1,1,0,1,0
11,110,110,4,4,0,1,0
17,120,120,3,3,0,1,0
24,129,129,20,9,11,2,1
27,130,130,29,29,0,1,0
21,137,137,7,7,0,1,0
29,145,145,15,2,13,2,1
20,178,178,15,15,0,1,0
34,184,184,5,5,0,1,0
32,226,226,1,1,0,1,0
7,232,232,1,1,0,1,0
18,238,238,13,4,9,2,1
19,261,261,20,12,8,2,1
33,262,262,18,18,0,1,0
9,263,263,3,3,0,1,0
8,285,285,10,10,0,1,0
5,311,311,2,2,0,1,0
10,313,313,7,1,6,3,2
12,316,316,8,8,0,1,0
26,361,361,4,1,3,2,1
15,370,370,69,10,59,3,2
14,376,376,57,46,11,2,1
22,389,389,5,5,0,1,0
25,419,419,56,32,24,2,1
4,424,424,2,2,0,1,0
16,426,426,17,2,15,4,3
6,436,436,5,5,0,1,0
3,438,438,9,9,0,1,0
28,438,438,24,15,9,4,3
13,441,441,14,14,0,1,0
2,459,459,188,122,66,4,3
30,475,475,182,157,25,4,3
31,478,478,3,3,0,1,0
1,487,487,2,2,0,1,0

17,103,103,2,2,0,1,0
1,107,107,3,3,0,1,0
18,111,111,8,2,6,3,2
11,145,145,24,24,0,1,0
8,162,162,9,9,0,1,0
0,170,170,4,4,0,1,0
14,228,228,1,1,0,1,0
21,237,237,63,63,0,1,0
4,238,238,28,18,10,2,1
19,247,247,14,14,0,1,0
15,260,260,9,1,8,2,1
12,292,292,11,2,9,4,3
22,314,314,67,67,0,1,0
7,341,341,78,78,0,1,0
16,344,344,4,4,0,1,0
24,347,347,58,58,0,1,0
3,350,350,114,38,76,4,3
23,381,381,33,33,0,1,0
2,405,405,19,19,0,1,0
5,463,463,13,1,12,3,2
20,463,463,75,75,0,1,0
6,466,466,109,109,0,1,0
10,475,475,8,8,0,1,0
13,480,480,94,94,0,1,0
9,481,481,17,17,0,1,0

6,117,117,5,2,3,2,1
1,138,138,30,30,0,1,0
16,144,144,11,11,0,1,0
2,153,153,27,27,0,1,0
18,190,190,4,4,0,1,0
21,193,193,8,2,6,3,2
25,196,196,11,3,8,2,1
14,200,200,15,15,0,1,0
5,216,216,15,15,0,1,0
23,233,233,26,10,16,2,1
20,239,239,64,52,12,2,1
7,240,240,26,26,0,1,0
9,272,272,2,2,0,1,0
10,275,275,11,11,0,1,0
0,276,276,6,6,0,1,0
19,280,280,28,28,0,1,0
15,288,288,54,54,0,1,0
8,289,289,49,49,0,1,0
26,307,307,35,35,0,1,0
11,309,309,78,39,39,4,3
17,386,386,40,31,9,2,1
13,391,391,67,34,33,2,1
3,427,427,3,3,0,1,0
4,445,445,7,3,4,2,1
12,446,446,1,1,0,1,0
22,469,469,48,6,42,3,2
24,495,495,32,32,0,1,0

25,108,108,30,18,12,4,3
8,109,109,4,4,0,1,0
18,146,146,8,8,0,1,0
16,167,167,2,2,0,1,0
2,181,181,1,1,0,1,0
15,208,208,7,7,0,1,0
3,223,223,34,17,17,2,1
21,252,252,46,2,44,4,3
6,252,252,35,20,15,2,1
20,260,260,4,4,0,1,0
19,262,262,7,7,0,1,0
1,270,270,4,4,0,1,0
23,290,290,20,5,15,4,3
14,300,300,82,57,25,2,1
9,321,321,63,42,21,2,1
5,338,338,50,23,27,4,3
22,348,348,24,24,0,1,0
10,354,354,21,21,0,1,0
7,361,361,8,8,0,1,0
0,375,375,7,7,0,1,0
13,403,403,41,33,8,2,1
4,407,407,20,20,0,1,0
26,413,413,81,15,66,3,2
17,433,433,54,54,0,1,0
11,453,453,15,3,12,4,3
24,460,460,69,69,0,1,0
27,493,493,61,16,45,4,3
12,494,494,25,2,23,2,1

15,105,105,42,27,15,4,3
12,126,126,37,29,8,3,2
16,135,135,2,2,0,1,0
14,160,160,38,14,24,4,3
8,163,163,1,1,0,1,0
6,166,166,22,13,9,2,1
25,169,169,7,1,6,3,2
21,186,186,11,3,8,2,1
3,210,210,3,3,0,1,0
19,229,229,19,19,0,1,0
17,258,258,11,11,0,1,0
7,279,279,10,10,0,1,0
2,316,316,2,2,0,1,0
5,322,322,100,53,47,4,3
11,350,350,9,1,8,3,2
20,353,353,23,14,9,4,3
9,368,368,4,4,0,1,0
23,377,377,8,8,0,1,0
1,391,391,15,15,0,1,0
13,393,393,3,3,0,1,0
26,433,433,35,15,20,3,2
18,438,438,94,43,51,4,3
24,441,441,18,9,9,4,3
10,451,451,14,14,0,1,0
22,473,473,12,12,0,1,0
0,481,481,100,100,0,1,0
4,498,498,90,38,52,3,2

12,100,100,3,3,0,1,0
27,101,101,6,6,0,1,0
0,112,112,4,4,0,1,0
10,137,137,3,3,0,1,0
17,156,156,1,1,0,1,0
25,157,157,72,72,0,1,0
31,168,168,15,15,0,1,0
2,171,171,11,11,0,1,0
3,180,180,9,9,0,1,0
6,181,181,3,3,0,1,0
18,206,206,24,24,0,1,0
14,233,233,6,1,5,2,1
11,234,234,18,18,0,1,0
4,236,236,47,23,24,3,2
20,260,260,10,3,7,2,1
15,263,263,45,3,42,3,2
21,279,279,21,1,20,3,2
30,281,281,9,9,0,1,0
13,284,284,50,50,0,1,0
28,306,306,30,3,27,3,2
5,334,334,32,11,21,4,3
26,342,342,34,8,26,4,3
8,361,361,2,2,0,1,0
23,368,368,21,15,6,3,2
24,396,396,46,10,36,3,2
1,406,406,37,1,36,3,2
9,412,412,24,12,12,2,1
32,418,418,40,3,37,3,2
22,420,420,9,9,0,1,0
16,430,430,5,5,0,1,0
19,434,434,17,1,16,2,1
29,471,471,40,22,18,2,1
7,473,473,4,4,0,1,0

10,100,100,14,14,0,1,0
22,123,123,7,4,3,2,1
17,140,140,3,3,0,1,0
15,140,140,27,1,26,3,2
4,154,154,3,3,0,1,0
25,197,197,20,7,13,2,1
12,212,212,25,18,7,2,1
16,221,221,59,59,0,1,0
3,233,233,22,22,0,1,0
21,254,254,10,4,6,2,1
9,271,271,31,31,0,1,0
19,310,310,4,4,0,1,0
11,319,319,17,17,0,1,0
5,320,320,12,6,6,2,1
24,324,324,25,9,16,2,1
13,349,349,83,5,78,4,3
23,364,364,20,2,18,2,1
8,367,367,26,20,6,2,1
2,386,386,4,1,3,2,1
18,396,396,14,14,0,1,0
20,401,401,62,37,25,2,1
7,405,405,218,218,0,1,0
14,411,411,32,32,0,1,0
0,436,436,2,2,0,1,0
6,448,448,27,27,0,1,0
1,473,473,19,19,0,1,0

21,109,109,14,14,0,1,0
18,115,115,1,1,0,1,0
5,118,118,23,23,0,1,0
7,128,128,1,1,0,1,0
27,148,148,43,5,38,2,1
4,154,154,4,4,0,1,0
15,184,184,6,6,0,1,0
14,228,228,2,2,0,1,0
16,260,260,36,36,0,1,0
0,261,261,10,2,8,3,2
25,278,278,66,66,0,1,0
29,289,289,11,1,10,2,1
19,290,290,50,27,23,2,1
2,291,291,54,24,30,2,1
23,294,294,25,7,18,4,3
1,297,297,23,23,0,1,0
24,318,318,4,1,3,2,1
22,328,328,15,15,0,1,0
12,364,364,54,54,0,1,0
10,390,390,34,20,14,2,1
28,400,400,2,2,0,1,0
8,406,406,9,9,0,1,0
6,408,408,13,8,5,2,1
26,411,411,6,6,0,1,0
11,437,437,14,14,0,1,0
13,464,464,69,4,65,4,3
3,477,477,10,10,0,1,0
20,485,485,5,5,0,1,0
9,486,486,49,49,0,1,0
17,496,496,138,82,56,4,3

22,140,140,7,7,0,1,0
9,150,150,1,1,0,1,0
3,171,171,33,3,30,3,2
4,178,178,3,3,0,1,0
7,180,180,20,8,12,4,3
26,182,182,11,11,0,1,0
0,186,186,32,32,0,1,0
20,187,187,17,17,0,1,0
21,200,200,17,17,0,1,0
8,218,218,3,3,0,1,0
18,235,235,87,51,36,4,3
11,246,246,15,15,0,1,0
5,249,249,1,1,0,1,0
16,255,255,7,7,0,1,0
25,272,272,30,15,15,4,3
19,284,284,26,5,21,2,1
14,301,301,25,25,0,1,0
6,306,306,38,28,10,2,1
2,314,314,18,4,14,2,1
24,328,328,82,37,45,2,1
13,337,337,48,36,12,4,3
17,345,345,20,10,10,3,2
12,363,363,97,21,76,3,2
23,366,366,9,9,0,1,0
1,373,373,46,46,0,1,0
15,397,397,11,8,3,2,1
10,412,412,4,1,3,2,1

4,101,101,1,1,0,1,0
10,128,128,12,12,0,1,0
15,145,145,10,2,8,2,1
17,169,169,41,41,0,1,0
5,195,195,12,12,0,1,0
23,204,204,20,4,16,3,2
12,209,209,9,9,0,1,0
22,254,254,49,49,0,1,0
13,264,264,22,22,0,1,0
20,270,270,13,13,0,1,0
9,276,276,11,1,10,2,1
6,283,283,72,15,57,4,3
25,299,299,68,68,0,1,0
24,308,308,6,6,0,1,0
19,326,326,19,6,13,2,1
3,327,327,2,2,0,1,0
2,361,361,89,89,0,1,0
1,373,373,33,14,19,2,1
21,387,387,19,19,0,1,0
7,398,398,19,19,0,1,0
8,407,407,9,9,0,1,0
0,410,410,22,1,21,4,3
11,421,421,142,123,19,2,1
16,464,464,25,4,21,2,1
14,468,468,19,2,17,2,1
18,480,480,66,66,0,1,0

8,159,159,26,5,21,2,1
24,172,172,3,3,0,1,0
11,187,187,18,9,9,2,1
7,189,189,11,11,0,1,0
2,209,209,10,1,9,4,3
9,218,218,14,5,9,4,3
3,222,222,65,16,49,2,1
0,225,225,1,1,0,1,0
23,228,228,23,23,0,1,0
1,229,229,18,1,17,2,1
10,256,256,11,4,7,2,1
13,278,278,20,20,0,1,0
16,289,289,6,3,3,2,1
14,292,292,4,4,0,1,0
21,313,313,31,13,18,4,3
19,317,317,9,9,0,1,0
22,331,331,72,54,18,3,2
6,339,339,55,55,0,1,0
20,358,358,16,16,0,1,0
4,404,404,62,62,0,1,0
5,427,427,59,59,0,1,0
12,468,468,98,62,36,3,2
15,473,473,136,84,52,4,3
18,476,476,55,55,0,1,0
17,485,485,43,25,18,4,3

19,107,107,9,4,5,2,1
1,127,127,1,1,0,1,0
21,136,136,14,14,0,1,0
10,146,146,3,3,0,1,0
16,148,148,3,3,0,1,0
15,160,160,19,19,0,1,0
2,191,191,17,6,11,2,1
13,202,202,13,2,11,2,1
24,209,209,63,63,0,1,0
27,210,210,17,17,0,1,0
17,213,213,7,7,0,1,0
5,226,226,34,26,8,2,1
29,256,256,6,6,0,1,0
28,256,256,6,6,0,1,0
4,273,273,45,17,28,4,3
9,284,284,21,21,0,1,0
23,288,288,24,24,0,1,0
0,293,293,16,6,10,2,1
14,294,294,50,13,37,4,3
26,309,309,60,42,18,4,3
12,390,390,16,16,0,1,0
25,394,394,44,44,0,1,0
18,415,415,32,32,0,1,0
22,419,419,4,4,0,1,0
3,446,446,26,26,0,1,0
8,456,456,8,1,7,2,1
6,457,457,77,71,6,2,1
7,458,458,6,2,4,2,1
11,466,466,34,34,0,1,0
20,471,471,96,28,68,3,2

5,125,125,3,3,0,1,0
3,168,168,29,29,0,1,0
9,188,188,45,30,15,2,1
4,196,196,47,30,17,2,1
1,231,231,24,6,18,4,3
6,244,244,37,22,15,4,3
13,255,255,18,18,0,1,0
14,256,256,16,4,12,2,1
12,327,327,4,4,0,1,0
2,337,337,209,179,30,4,3
11,344,344,8,8,0,1,0
16,350,350,10,10,0,1,0
7,396,396,27,27,0,1,0
8,412,412,64,37,27,4,3
0,428,428,60,60,0,1,0
18,450,450,186,156,30,2,1
10,478,478,16,16,0,1,0
15,480,480,12,5,7,2,1
17,493,493,17,13,4,2,1

23,109,109,2,2,0,1,0
13,135,135,12,9,3,2,1
2,153,153,3,3,0,1,0
5,157,157,14,4,10,3,2
10,192,192,57,57,0,1,0
22,200,200,1,1,0,1,0
21,206,206,24,24,0,1,0
6,215,215,2,2,0,1,0
19,216,216,37,34,3,2,1
16,250,250,26,13,13,2,1
9,297,297,3,3,0,1,0
0,305,305,25,25,0,1,0
11,313,313,5,1,4,2,1
8,332,332,40,3,37,2,1
4,336,336,89,15,74,3,2
3,338,338,75,75,0,1,0
14,348,348,85,70,15,2,1
18,360,360,10,10,0,1,0
7,394,394,31,31,0,1,0
1,395,395,37,21,16,3,2
20,397,397,166,102,64,3,2
17,426,426,15,9,6,2,1
24,445,445,3,3,0,1,0
12,485,485,30,1,29,4,3
15,495,495,12,12,0,1,0

20,104,104,6,6,0,1,0
8,110,110,7,7,0,1,0
1,140,140,5,5,0,1,0
21,202,202,22,22,0,1,0
6,224,224,41,41,0,1,0
27,226,226,7,1,6,2,1
5,266,266,15,15,0,1,0
28,276,276,13,13,0,1,0
13,278,278,16,16,0,1,0
16,295,295,55,17,38,2,1
9,297,297,5,5,0,1,0
19,320,320,29,20,9,4,3
10,329,329,3,3,0,1,0
4,333,333,33,13,20,3,2
15,333,333,63,63,0,1,0
14,340,340,17,10,7,2,1
22,343,343,14,3,11,2,1
18,350,350,139,86,53,4,3
7,360,360,74,70,4,2,1
23,362,362,28,24,4,2,1
26,375,375,49,20,29,2,1
25,383,383,17,17,0,1,0
12,404,404,39,39,0,1,0
0,417,417,3,3,0,1,0
2,420,420,21,21,0,1,0
17,432,432,35,20,15,4,3
11,435,435,24,19,5,2,1
3,448,448,56,56,0,1,0
24,462,462,16,16,0,1,0

10,124,124,6,6,0,1,0
15,128,128,14,14,0,1,0
17,134,134,18,18,0,1,0
23,153,153,30,12,18,3,2
19,155,155,7,1,6,3,2
24,167,167,2,2,0,1,0
13,210,210,42,42,0,1,0
5,232,232,22,22,0,1,0
22,235,235,3,3,0,1,0
3,240,240,17,17,0,1,0
2,279,279,1,1,0,1,0
11,282,282,43,43,0,1,0
18,282,282,13,1,12,3,2
26,292,292,52,31,21,4,3
4,309,309,12,12,0,1,0
9,311,311,11,11,0,1,0
1,320,320,41,29,12,4,3
7,354,354,89,63,26,3,2
8,364,364,29,29,0,1,0
25,364,364,37,22,15,2,1
14,392,392,60,60,0,1,0
21,392,392,9,3,6,3,2
0,403,403,2,2,0,1,0
12,404,404,5,5,0,1,0
6,419,419,76,76,0,1,0
20,422,422,51,41,10,2,1
16,464,464,93,21,72,4,3

9,100,100,2,2,0,1,0
16,105,105,18,18,0,1,0
13,105,105,20,11,9,4,3
22,134,134,16,16,0,1,0
3,194,194,21,21,0,1,0
21,196,196,12,12,0,1,0
6,198,198,7,7,0,1,0
4,201,201,8,8,0,1,0
23,220,220,20,20,0,1,0
7,242,242,27,27,0,1,0
11,255,255,38,38,0,1,0
8,265,265,57,57,0,1,0
17,275,275,7,7,0,1,0
2,292,292,51,24,27,2,1
14,300,300,46,46,0,1,0
18,307,307,45,45,0,1,0
20,320,320,19,19,0,1,0
24,336,336,63,63,0,1,0
10,362,362,7,7,0,1,0
19,369,369,25,25,0,1,0
1,395,395,17,9,8,3,2
5,485,485,53,53,0,1,0
15,495,495,6,6,0,1,0
12,496,496,23,23,0,1,0
0,498,498,137,137,0,1,0

14,129,129,6,6,0,1,0
7,138,138,7,7,0,1,0
13,191,191,5,5,0,1,0
3,209,209,20,20,0,1,0
0,228,228,80,80,0,1,0
17,236,236,48,21,27,2,1
2,237,237,26,26,0,1,0
9,245,245,73,53,20,3,2
1,261,261,19,19,0,1,0
10,261,261,11,7,4,2,1
5,335,335,42,8,34,3,2
4,373,373,251,230,21,4,3
8,376,376,46,46,0,1,0
16,379,379,29,29,0,1,0
15,403,403,42,42,0,1,0
6,431,431,1,1,0,1,0
11,450,450,65,57,8,3,2
12,471,471,41,9,32,2,1

25,103,103,31,3,28,3,2
4,156,156,5,5,0,1,0
6,164,164,3,3,0,1,0
23,166,166,4,4,0,1,0
11,189,189,3,3,0,1,0
18,191,191,5,5,0,1,0
19,219,219,4,1,3,2,1
17,223,223,30,3,27,2,1
5,233,233,33,33,0,1,0
7,239,239,9,9,0,1,0
14,249,249,12,12,0,1,0
1,267,267,39,10,29,2,1
24,270,270,37,1,36,3,2
12,347,347,25,1,24,4,3
22,353,353,66,41,25,4,3
10,360,360,38,38,0,1,0
2,368,368,42,42,0,1,0
13,377,377,43,43,0,1,0
16,405,405,44,44,0,1,0
8,416,416,22,22,0,1,0
3,445,445,33,9,24,2,1
15,459,459,16,3,13,2,1
0,462,462,79,79,0,1,0
21,478,478,45,15,30,2,1
9,486,486,155,80,75,4,3
20,495,495,50,50,0,1,0

23,106,106,30,30,0,1,0
31,117,117,20,20,0,1,0
12,118,118,18,4,14,2,1
18,126,126,1,1,0,1,0
21,138,138,4,1,3,2,1
17,142,142,1,1,0,1,0
22,145,145,34,34,0,1,0
0,186,186,14,14,0,1,0
15,192,192,23,5,18,4,3
20,210,210,1,1,0,1,0
27,232,232,4,4,0,1,0
26,255,255,10,10,0,1,0
1,264,264,3,3,0,1,0
11,281,281,35,35,0,1,0
6,307,307,51,39,12,3,2
19,320,320,22,10,12,4,3
16,320,320,25,25,0,1,0
30,322,322,17,17,0,1,0
9,325,325,1,1,0,1,0
10,352,352,21,12,9,2,1
25,364,364,17,17,0,1,0
28,369,369,27,9,18,2,1
24,378,378,46,46,0,1,0
14,398,398,64,37,27,4,3
29,399,399,17,12,5,2,1
7,400,400,8,8,0,1,0
4,410,410,7,7,0,1,0
8,418,418,27,27,0,1,0
33,439,439,25,25,0,1,0
32,441,441,38,38,0,1,0
3,454,454,13,13,0,1,0
5,462,462,15,15,0,1,0
2,490,490,32,32,0,1,0
13,497,497,5,5,0,1,0
34,498,498,47,22,25,2,1

20,106,106,29,29,0,1,0
10,109,109,4,4,0,1,0
25,122,122,20,4,16,3,2
4,132,132,11,11,0,1,0
13,133,133,3,3,0,1,0
14,151,151,59,59,0,1,0
0,152,152,10,10,0,1,0
27,154,154,19,10,9,4,3
26,156,156,8,2,6,3,2
24,167,167,23,23,0,1,0
17,184,184,6,6,0,1,0
11,194,194,1,1,0,1,0
5,207,207,4,4,0,1,0
21,213,213,33,33,0,1,0
8,254,254,53,29,24,4,3
16,289,289,11,11,0,1,0
23,305,305,16,10,6,2,1
7,320,320,25,25,0,1,0
15,321,321,16,7,9,4,3
9,322,322,38,38,0,1,0
19,331,331,3,3,0,1,0
3,333,333,44,44,0,1,0
12,338,338,3,3,0,1,0
18,339,339,4,1,3,2,1
22,350,350,16,16,0,1,0
28,418,418,76,10,66,4,3
29,421,421,39,39,0,1,0
6,437,437,4,4,0,1,0
2,454,454,2,2,0,1,0
1,477,477,14,2,12,2,1

6,101,101,2,2,0,1,0
5,110,110,21,11,10,2,1
23,113,113,2,2,0,1,0
11,114,114,10,7,3,2,1
8,120,120,1,1,0,1,0
10,138,138,28,28,0,1,0
13,142,142,4,1,3,2,1
21,143,143,13,4,9,4,3
1,150,150,22,22,0,1,0
2,180,180,40,40,0,1,0
3,182,182,12,3,9,2,1
4,190,190,9,9,0,1,0
15,198,198,18,18,0,1,0
18,200,200,27,10,17,2,1
25,207,207,44,44,0,1,0
14,214,214,8,8,0,1,0
0,220,220,23,1,22,3,2
16,232,232,13,9,4,2,1
7,242,242,36,36,0,1,0
9,308,308,4,4,0,1,0
24,372,372,59,59,0,1,0
19,401,401,59,19,40,3,2
22,408,408,6,6,0,1,0
20,410,410,84,64,20,4,3
17,468,468,58,21,37,2,1
12,474,474,20,20,0,1,0

0,107,107,6,6,0,1,0
15,108,108,12,12,0,1,0
26,110,110,7,7,0,1,0
4,121,121,31,27,4,2,1
12,133,133,23,1,22,2,1
1,144,144,19,1,18,4,3
5,147,147,8,8,0,1,0
21,155,155,6,6,0,1,0
7,166,166,9,1,8,3,2
20,175,175,21,21,0,1,0
9,187,187,64,64,0,1,0
13,192,192,23,23,0,1,0
16,219,219,53,15,38,3,2
8,232,232,2,2,0,1,0
18,239,239,1,1,0,1,0
10,255,255,5,5,0,1,0
11,264,264,1,1,0,1,0
27,268,268,23,23,0,1,0
23,324,324,126,118,8,3,2
19,333,333,4,1,3,2,1
6,389,389,13,7,6,2,1
25,392,392,93,78,15,2,1
17,414,414,2,2,0,1,0
2,461,461,7,7,0,1,0
24,466,466,6,6,0,1,0
22,475,475,4,4,0,1,0
3,497,497,2,2,0,1,0
14,499,499,14,14,0,1,0

8,111,111,10,10,0,1,0
13,130,130,12,6,6,3,2
3,142,142,11,3,8,3,2
29,148,148,17,8,9,2,1
12,181,181,31,23,8,3,2
22,192,192,7,7,0,1,0
20,228,228,7,7,0,1,0
2,228,228,38,38,0,1,0
17,242,242,42,29,13,2,1
30,256,256,25,25,0,1,0
1,263,263,1,1,0,1,0
28,278,278,16,10,6,3,2
23,278,278,20,9,11,2,1
25,281,281,9,6,3,2,1
7,291,291,3,3,0,1,0
18,306,306,4,4,0,1,0
31,313,313,16,16,0,1,0
27,317,317,59,59,0,1,0
9,335,335,36,23,13,2,1
14,341,341,23,23,0,1,0
15,342,342,19,1,18,3,2
5,348,348,21,21,0,1,0
16,349,349,5,5,0,1,0
24,363,363,63,8,55,3,2
21,364,364,31,31,0,1,0
4,370,370,9,9,0,1,0
11,380,380,9,9,0,1,0
10,403,403,36,36,0,1,0
0,426,426,11,11,0,1,0
26,436,436,127,77,50,2,1
6,446,446,16,2,14,4,3
19,490,490,46,46,0,1,0

18,111,111,1,1,0,1,0
2,129,129,27,1,26,2,1
21,141,141,7,7,0,1,0
6,142,142,3,3,0,1,0
17,166,166,36,36,0,1,0
0,181,181,3,3,0,1,0
1,193,193,11,2,9,4,3
9,224,224,24,24,0,1,0
20,248,248,13,5,8,2,1
5,272,272,5,5,0,1,0
3,274,274,1,1,0,1,0
25,311,311,1,1,0,1,0
19,322,322,8,8,0,1,0
22,332,332,48,48,0,1,0
11,333,333,92,92,0,1,0
4,359,359,35,22,13,2,1
8,367,367,14,5,9,4,3
16,370,370,22,22,0,1,0
14,374,374,17,11,6,3,2
15,378,378,91,91,0,1,0
24,382,382,2,2,0,1,0
10,414,414,94,94,0,1,0
12,421,421,82,28,54,4,3
23,440,440,170,115,55,3,2
13,480,480,43,16,27,4,3
7,482,482,17,7,10,3,2

8,121,121,29,11,18,2,1
4,144,144,44,44,0,1,0
25,150,150,12,4,8,2,1
15,156,156,19,3,16,3,2
19,184,184,17,17,0,1,0
17,186,186,27,7,20,3,2
16,200,200,5,5,0,1,0
2,246,246,14,5,9,4,3
5,286,286,12,12,0,1,0
9,290,290,26,5,21,4,3
0,304,304,19,19,0,1,0
1,306,306,2,2,0,1,0
18,314,314,22,3,19,4,3
10,329,329,16,16,0,1,0
24,340,340,23,23,0,1,0
23,351,351,12,12,0,1,0
3,394,394,29,29,0,1,0
21,395,395,23,23,0,1,0
6,405,405,92,92,0,1,0
22,422,422,42,21,21,2,1
14,458,458,113,86,27,4,3
13,465,465,27,27,0,1,0
11,480,480,31,6,25,2,1
12,480,480,6,6,0,1,0
7,483,483,35,35,0,1,0
20,490,490,107,59,48,2,1

8,118,118,2,2,0,1,0
21,164,164,4,4,0,1,0
15,169,169,12,12,0,1,0
13,177,177,27,27,0,1,0
18,183,183,21,6,15,4,3
1,199,199,15,15,0,1,0
16,219,219,47,11,36,4,3
4,223,223,13,13,0,1,0
12,227,227,17,17,0,1,0
3,250,250,20,5,15,2,1
9,255,255,16,2,14,2,1
5,275,275,6,2,4,2,1
6,289,289,115,87,28,2,1
23,301,301,57,57,0,1,0
19,332,332,1,1,0,1,0
20,355,355,57,57,0,1,0
2,371,371,26,26,0,1,0
11,401,401,1,1,0,1,0
10,418,418,77,77,0,1,0
0,423,423,43,31,12,3,2
17,435,435,32,8,24,3,2
7,441,441,102,30,72,3,2
22,478,478,110,110,0,1,0
14,480,480,8,2,6,3,2

18,100,100,2,2,0,1,0
9,148,148,1,1,0,1,0
12,149,149,12,12,0,1,0
3,157,157,1,1,0,1,0
4,158,158,51,51,0,1,0
17,160,160,7,7,0,1,0
11,161,161,27,27,0,1,0
0,162,162,11,2,9,2,1
25,180,180,20,14,6,2,1
2,205,205,6,6,0,1,0
8,210,210,3,3,0,1,0
1,212,212,1,1,0,1,0
15,224,224,45,7,38,3,2
10,242,242,81,75,6,2,1
23,250,250,42,36,6,2,1
22,256,256,53,53,0,1,0
14,285,285,8,8,0,1,0
20,293,293,62,62,0,1,0
16,324,324,12,12,0,1,0
24,351,351,47,11,36,2,1
5,385,385,68,68,0,1,0
7,439,439,23,7,16,4,3
19,440,440,12,12,0,1,0
6,448,448,17,7,10,3,2
13,451,451,5,2,3,2,1
21,463,463,59,59,0,1,0

15,105,105,5,2,3,2,1
16,124,124,31,31,0,1,0
1,158,158,14,14,0,1,0
18,169,169,11,6,5,2,1
12,177,177,1,1,0,1,0
10,197,197,23,8,15,4,3
0,206,206,14,14,0,1,0
25,209,209,21,21,0,1,0
11,214,214,60,53,7,2,1
13,217,217,1,1,0,1,0
27,227,227,17,17,0,1,0
26,280,280,2,2,0,1,0
28,298,298,31,25,6,3,2
23,307,307,6,6,0,1,0
9,314,314,9,9,0,1,0
6,315,315,23,5,18,4,3
21,331,331,19,7,12,2,1
8,361,361,35,35,0,1,0
2,373,373,20,2,18,2,1
7,377,377,80,22,58,3,2
14,386,386,6,2,4,2,1
20,401,401,8,8,0,1,0
24,402,402,26,4,22,3,2
22,403,403,215,116,99,4,3
5,404,404,14,4,10,2,1
19,437,437,1,1,0,1,0
4,466,466,55,16,39,2,1
17,475,475,12,9,3,2,1
3,476,476,27,27,0,1,0

0,112,112,20,20,0,1,0
15,113,113,8,8,0,1,0
20,130,130,18,18,0,1,0
14,144,144,29,4,25,3,2
11,145,145,49,28,21,4,3
10,149,149,3,3,0,1,0
8,196,196,36,6,30,3,2
13,199,199,18,18,0,1,0
5,213,213,23,23,0,1,0
25,226,226,29,17,12,3,2
9,241,241,2,2,0,1,0
7,270,270,11,11,0,1,0
4,297,297,1,1,0,1,0
12,300,300,14,7,7,2,1
23,315,315,27,27,0,1,0
16,324,324,29,29,0,1,0
22,365,365,21,15,6,3,2
18,368,368,2,2,0,1,0
19,379,379,15,10,5,2,1
3,392,392,64,24,40,3,2
2,418,418,20,20,0,1,0
24,444,444,165,101,64,3,2
17,452,452,8,4,4,2,1
1,486,486,6,6,0,1,0
21,487,487,18,2,16,2,1
6,497,497,75,75,0,1,0

11,106,106,1,1,0,1,0
8,111,111,1,1,0,1,0
0,123,123,8,8,0,1,0
31,124,124,6,2,4,2,1
25,140,140,6,6,0,1,0
7,146,146,1,1,0,1,0
29,157,157,11,11,0,1,0
30,160,160,15,15,0,1,0
16,162,162,19,19,0,1,0
27,184,184,26,7,19,2,1
24,232,232,47,29,18,2,1
34,253,253,45,37,8,2,1
5,262,262,14,2,12,3,2
17,273,273,7,7,0,1,0
9,274,274,24,1,23,2,1
14,285,285,1,1,0,1,0
20,289,289,9,9,0,1,0
33,302,302,6,6,0,1,0
35,303,303,28,28,0,1,0
6,307,307,7,7,0,1,0
1,310,310,10,10,0,1,0
23,317,317,35,17,18,4,3
2,319,319,7,7,0,1,0
10,327,327,30,10,20,3,2
21,344,344,52,5,47,2,1
12,346,346,16,4,12,3,2
13,355,355,17,17,0,1,0
28,361,361,9,9,0,1,0
19,371,371,2,2,0,1,0
4,391,391,42,27,15,4,3
26,409,409,10,10,0,1,0
15,410,410,5,2,3,2,1
22,424,424,22,7,15,4,3
18,446,446,57,12,45,3,2
3,493,493,86,57,29,3,2
32,500,500,140,109,31,2,1

25,105,105,2,2,0,1,0
6,116,116,1,1,0,1,0
15,118,118,20,20,0,1,0
13,123,123,19,7,12,2,1
16,144,144,10,10,0,1,0
22,148,148,6,6,0,1,0
4,162,162,4,1,3,2,1
28,163,163,40,19,21,4,3
19,183,183,7,7,0,1,0
14,188,188,19,19,0,1,0
23,213,213,85,85,0,1,0
21,222,222,11,11,0,1,0
20,225,225,1,1,0,1,0
2,229,229,5,5,0,1,0
18,234,234,17,8,9,2,1
5,249,249,4,4,0,1,0
26,254,254,27,27,0,1,0
11,274,274,1,1,0,1,0
8,304,304,53,1,52,3,2
3,313,313,11,8,3,2,1
27,339,339,43,43,0,1,0
0,353,353,11,7,4,2,1
10,369,369,3,3,0,1,0
9,394,394,3,3,0,1,0
7,402,402,137,101,36,3,2
24,415,415,47,2,45,2,1
12,437,437,74,32,42,2,1
17,470,470,21,11,10,2,1
1,471,471,19,19,0,1,0

15,113,113,26,8,18,4,3
33,117,117,9,9,0,1,0
25,117,117,18,12,6,2,1
10,141,141,1,1,0,1,0
9,145,145,1,1,0,1,0
30,162,162,4,4,0,1,0
17,171,171,19,19,0,1,0
28,184,184,2,2,0,1,0
7,193,193,10,7,3,2,1
21,213,213,1,1,0,1,0
20,221,221,14,5,9,4,3
8,246,246,5,2,3,2,1
11,247,247,6,6,0,1,0
14,250,250,1,1,0,1,0
27,260,260,14,14,0,1,0
5,274,274,2,2,0,1,0
1,275,275,21,21,0,1,0
18,300,300,8,3,5,2,1
19,304,304,10,10,0,1,0
24,305,305,37,8,29,2,1
32,311,311,88,4,84,3,2
3,319,319,25,25,0,1,0
0,322,322,16,3,13,2,1
29,330,330,20,20,0,1,0
12,376,376,8,1,7,2,1
13,411,411,48,32,16,2,1
4,429,429,6,6,0,1,0
2,443,443,60,60,0,1,0
23,445,445,50,20,30,3,2
31,451,451,108,108,0,1,0
16,454,454,13,1,12,2,1
22,489,489,78,46,32,3,2
6,490,490,96,96,0,1,0
26,491,491,14,14,0,1,0

8,124,124,1,1,0,1,0
7,151,151,7,2,5,2,1
26,152,152,7,7,0,1,0
5,210,210,31,2,29,2,1
1,225,225,22,4,18,3,2
9,230,230,46,4,42,3,2
12,243,243,48,38,10,2,1
18,248,248,16,16,0,1,0
10,276,276,2,2,0,1,0
20,295,295,88,58,30,4,3
19,307,307,13,13,0,1,0
14,308,308,1,1,0,1,0
27,313,313,27,27,0,1,0
16,349,349,1,1,0,1,0
2,352,352,36,36,0,1,0
3,353,353,49,4,45,2,1
15,355,355,14,4,10,3,2
6,367,367,36,36,0,1,0
22,380,380,66,66,0,1,0
21,382,382,7,4,3,2,1
17,402,402,10,7,3,2,1
25,417,417,34,34,0,1,0
23,432,432,203,156,47,4,3
28,438,438,2,2,0,1,0
4,474,474,19,19,0,1,0
11,477,477,9,9,0,1,0
24,478,478,5,5,0,1,0
13,482,482,43,26,17,4,3
0,490,490,33,33,0,1,0

13,100,100,1,1,0,1,0
17,101,101,6,1,5,2,1
20,113,113,30,2,28,4,3
3,122,122,6,6,0,1,0
10,126,126,1,1,0,1,0
1,131,131,8,1,7,2,1
21,142,142,29,29,0,1,0
27,150,150,4,4,0,1,0
22,187,187,6,6,0,1,0
31,198,198,11,6,5,2,1
23,201,201,1,1,0,1,0
25,235,235,7,7,0,1,0
18,240,240,14,14,0,1,0
14,249,249,13,13,0,1,0
9,270,270,41,41,0,1,0
26,273,273,17,17,0,1,0
29,277,277,60,36,24,3,2
4,295,295,1,1,0,1,0
12,295,295,19,19,0,1,0
15,325,325,14,14,0,1,0
8,327,327,62,6,56,3,2
16,342,342,12,4,8,2,1
24,344,344,33,28,5,2,1
2,346,346,23,23,0,1,0
32,355,355,41,15,26,2,1
11,359,359,1,1,0,1,0
7,371,371,34,34,0,1,0
30,400,400,62,17,45,4,3
6,408,408,10,10,0,1,0
28,421,421,27,11,16,2,1
19,428,428,120,115,5,2,1
5,496,496,1,1,0,1,0
0,499,499,24,24,0,1,0

2,107,107,12,12,0,1,0
12,118,118,9,9,0,1,0
5,130,130,18,2,16,3,2
7,133,133,1,1,0,1,0
22,134,134,38,38,0,1,0
8,145,145,13,13,0,1,0
25,153,153,12,12,0,1,0
9,153,153,24,24,0,1,0
23,165,165,2,2,0,1,0
0,176,176,5,5,0,1,0
21,220,220,12,4,8,3,2
15,230,230,29,29,0,1,0
6,244,244,18,18,0,1,0
3,263,263,19,3,16,2,1
19,269,269,45,45,0,1,0
4,295,295,5,5,0,1,0
17,302,302,38,38,0,1,0
11,352,352,47,28,19,2,1
18,359,359,37,20,17,2,1
24,359,359,12,12,0,1,0
10,365,365,69,54,15,4,3
13,393,393,56,18,38,2,1
14,424,424,71,71,0,1,0
20,457,457,14,14,0,1,0
1,458,458,97,97,0,1,0
16,473,473,1,1,0,1,0

14,106,106,4,4,0,1,0
29,118,118,22,15,7,2,1
11,123,123,6,6,0,1,0
20,151,151,30,30,0,1,0
16,159,159,9,1,8,2,1
12,162,162,15,15,0,1,0
22,170,170,6,3,3,2,1
17,174,174,18,7,11,2,1
5,195,195,25,25,0,1,0
3,200,200,30,30,0,1,0
8,215,215,1,1,0,1,0
23,226,226,13,13,0,1,0
1,227,227,26,26,0,1,0
10,246,246,5,5,0,1,0
24,256,256,37,37,0,1,0
7,264,264,1,1,0,1,0
4,318,318,14,14,0,1,0
6,355,355,17,5,12,4,3
25,356,356,14,5,9,4,3
2,374,374,19,12,7,2,1
28,374,374,16,16,0,1,0
18,378,378,40,40,0,1,0
21,386,386,51,20,31,4,3
26,386,386,20,11,9,4,3
0,394,394,68,58,10,3,2
13,419,419,60,60,0,1,0
19,463,463,46,46,0,1,0
9,463,463,3,3,0,1,0
27,463,463,60,24,36,2,1
15,466,466,85,73,12,2,1

3,102,102,1,1,0,1,0
25,103,103,3,3,0,1,0
1,118,118,19,6,13,4,3
24,119,119,30,30,0,1,0
8,140,140,9,9,0,1,0
11,165,165,1,1,0,1,0
16,172,172,2,2,0,1,0
12,192,192,12,6,6,3,2
15,196,196,12,12,0,1,0
29,200,200,9,9,0,1,0
23,211,211,47,47,0,1,0
28,214,214,14,2,12,4,3
13,254,254,21,21,0,1,0
27,261,261,5,5,0,1,0
19,262,262,62,42,20,2,1
7,263,263,14,14,0,1,0
30,263,263,3,3,0,1,0
26,286,286,53,53,0,1,0
20,301,301,4,1,3,2,1
17,323,323,31,31,0,1,0
31,335,335,36,24,12,4,3
2,351,351,40,40,0,1,0
5,356,356,35,35,0,1,0
18,359,359,4,4,0,1,0
0,363,363,40,40,0,1,0
6,397,397,2,2,0,1,0
4,406,406,3,3,0,1,0
21,416,416,17,4,13,2,1
9,425,425,27,1,26,2,1
10,426,426,88,88,0,1,0
22,430,430,41,41,0,1,0
14,463,463,36,12,24,3,2

4,114,114,24,15,9,4,3
14,131,131,1,1,0,1,0
8,141,141,6,6,0,1,0
2,167,167,32,32,0,1,0
7,187,187,1,1,0,1,0
12,194,194,24,6,18,3,2
10,200,200,55,55,0,1,0
6,235,235,37,37,0,1,0
15,236,236,30,30,0,1,0
18,266,266,24,24,0,1,0
0,284,284,59,12,47,4,3
16,287,287,27,27,0,1,0
19,293,293,10,10,0,1,0
17,349,349,47,27,20,2,1
22,362,362,15,1,14,2,1
11,372,372,40,35,5,2,1
13,397,397,79,28,51,4,3
20,419,419,4,1,3,2,1
9,473,473,38,38,0,1,0
3,481,481,140,140,0,1,0
5,482,482,53,33,20,2,1
21,496,496,39,15,24,4,3
1,498,498,2,2,0,1,0

19,105,105,11,2,9,2,1
26,136,136,22,22,0,1,0
6,154,154,42,42,0,1,0
3,172,172,10,4,6,3,2
18,189,189,9,1,8,2,1
25,218,218,2,2,0,1,0
16,226,226,4,4,0,1,0
21,227,227,6,2,4,2,1
22,254,254,16,16,0,1,0
17,266,266,7,1,6,3,2
2,273,273,10,10,0,1,0
23,274,274,42,42,0,1,0
20,293,293,80,80,0,1,0
10,300,300,1,1,0,1,0
29,329,329,10,10,0,1,0
13,333,333,10,2,8,3,2
12,345,345,13,13,0,1,0
24,351,351,9,9,0,1,0
28,355,355,14,14,0,1,0
4,384,384,28,17,11,2,1
5,391,391,18,18,0,1,0
15,404,404,8,8,0,1,0
1,422,422,60,48,12,4,3
7,425,425,49,3,46,3,2
0,444,444,68,68,0,1,0
14,453,453,5,5,0,1,0
11,469,469,112,98,14,2,1
9,486,486,8,1,7,2,1
8,486,486,14,14,0,1,0
27,493,493,179,170,9,2,1

14,158,158,39,39,0,1,0
2,161,161,10,10,0,1,0
16,170,170,16,8,8,2,1
19,192,192,2,2,0,1,0
15,251,251,103,51,52,4,3
21,266,266,45,12,33,4,3
6,274,274,43,43,0,1,0
22,289,289,8,8,0,1,0
9,326,326,3,3,0,1,0
23,365,365,2,2,0,1,0
7,387,387,135,112,23,4,3
17,388,388,48,7,41,3,2
4,390,390,27,27,0,1,0
10,407,407,49,25,24,3,2
3,407,407,15,15,0,1,0
13,417,417,2,2,0,1,0
5,418,418,93,86,7,2,1
8,428,428,11,2,9,4,3
18,430,430,10,10,0,1,0
20,430,430,43,24,19,2,1
11,443,443,9,6,3,2,1
1,450,450,95,95,0,1,0
0,480,480,18,18,0,1,0
12,482,482,43,43,0,1,0

8,103,103,6,6,0,1,0
23,160,160,36,36,0,1,0
5,162,162,35,35,0,1,0
3,190,190,1,1,0,1,0
10,205,205,26,26,0,1,0
1,226,226,77,38,39,4,3
19,237,237,39,39,0,1,0
9,249,249,26,26,0,1,0
14,257,257,10,10,0,1,0
4,289,289,1,1,0,1,0
0,303,303,30,30,0,1,0
21,320,320,24,6,18,4,3
16,330,330,15,15,0,1,0
20,346,346,70,7,63,4,3
18,383,383,96,18,78,4,3
7,384,384,56,36,20,2,1
11,405,405,24,12,12,4,3
15,416,416,26,10,16,2,1
12,420,420,7,7,0,1,0
2,427,427,50,6,44,2,1
13,439,439,4,4,0,1,0
17,445,445,61,26,35,2,1
25,459,459,12,12,0,1,0
24,475,475,19,11,8,2,1
22,478,478,19,11,8,3,2
6,491,491,4,1,3,2,1

0,107,107,47,24,23,2,1
4,145,145,21,21,0,1,0
7,151,151,22,4,18,2,1
21,162,162,32,32,0,1,0
17,184,184,11,11,0,1,0
23,230,230,16,16,0,1,0
5,266,266,9,9,0,1,0
1,269,269,1,1,0,1,0
6,271,271,54,54,0,1,0
16,280,280,11,1,10,3,2
3,293,293,38,27,11,2,1
12,301,301,11,3,8,3,2
9,337,337,4,4,0,1,0
15,368,368,8,2,6,3,2
18,376,376,14,6,8,2,1
8,410,410,5,2,3,2,1
13,411,411,49,49,0,1,0
24,436,436,16,8,8,3,2
20,437,437,8,1,7,2,1
11,441,441,7,1,6,2,1
2,450,450,27,9,18,2,1
14,462,462,153,132,21,4,3
10,470,470,49,49,0,1,0
19,472,472,158,68,90,3,2
22,493,493,9,5,4,2,1

9,126,126,8,8,0,1,0
7,197,197,31,19,12,4,3
17,221,221,16,16,0,1,0
4,234,234,36,36,0,1,0
12,236,236,19,11,8,3,2
3,255,255,110,18,92,3,2
13,287,287,6,6,0,1,0
6,293,293,11,11,0,1,0
8,298,298,13,13,0,1,0
0,304,304,14,14,0,1,0
10,316,316,26,26,0,1,0
15,318,318,78,6,72,4,3
5,334,334,11,3,8,3,2
2,352,352,22,13,9,4,3
11,357,357,68,59,9,2,1
14,381,381,64,64,0,1,0
16,419,419,54,38,16,2,1
1,468,468,284,284,0,1,0

17,104,104,5,5,0,1,0
11,115,115,15,15,0,1,0
18,136,136,18,14,4,2,1
10,145,145,1,1,0,1,0
2,146,146,30,9,21,4,3
3,179,179,20,20,0,1,0
9,180,180,27,27,0,1,0
6,183,183,13,13,0,1,0
5,210,210,21,3,18,3,2
7,243,243,16,5,11,2,1
15,249,249,12,1,11,2,1
1,266,266,1,1,0,1,0
16,268,268,34,34,0,1,0
19,315,315,26,20,6,2,1
13,335,335,53,53,0,1,0
8,342,342,34,34,0,1,0
0,352,352,148,117,31,3,2
14,387,387,66,42,24,4,3
21,394,394,35,13,22,2,1
12,427,427,21,6,15,4,3
4,440,440,99,99,0,1,0
20,462,462,60,60,0,1,0

2,109,109,13,2,11,2,1
9,121,121,4,4,0,1,0
13,130,130,11,11,0,1,0
30,137,137,24,3,21,2,1
16,156,156,3,3,0,1,0
24,167,167,12,5,7,2,1
17,222,222,1,1,0,1,0
8,225,225,5,5,0,1,0
35,229,229,18,18,0,1,0
32,238,238,47,47,0,1,0
27,252,252,10,5,5,2,1
15,264,264,28,16,12,3,2
22,268,268,4,4,0,1,0
4,277,277,6,6,0,1,0
7,278,278,1,1,0,1,0
33,282,282,56,28,28,2,1
5,285,285,8,8,0,1,0
18,286,286,1,1,0,1,0
1,303,303,28,28,0,1,0
21,309,309,11,7,4,2,1
28,310,310,7,7,0,1,0
12,316,316,57,21,36,2,1
23,320,320,32,32,0,1,0
10,339,339,3,3,0,1,0
31,358,358,21,13,8,3,2
25,358,358,4,4,0,1,0
29,370,370,19,19,0,1,0
11,389,389,7,3,4,2,1
19,415,415,35,35,0,1,0
6,441,441,3,3,0,1,0
20,453,453,47,15,32,2,1
3,465,465,25,25,0,1,0
14,470,470,25,16,9,2,1
0,475,475,97,48,49,3,2
34,481,481,130,100,30,2,1
26,500,500,22,22,0,1,0

5,128,128,1,1,0,1,0
18,129,129,28,9,19,2,1
23,131,131,8,8,0,1,0
4,142,142,22,22,0,1,0
14,147,147,3,3,0,1,0
1,160,160,10,1,9,4,3
17,168,168,37,37,0,1,0
2,174,174,1,1,0,1,0
16,186,186,7,7,0,1,0
21,193,193,44,32,12,4,3
24,199,199,2,2,0,1,0
19,200,200,5,5,0,1,0
22,249,249,11,11,0,1,0
6,280,280,21,21,0,1,0
12,287,287,43,27,16,2,1
13,291,291,47,35,12,4,3
3,340,340,56,56,0,1,0
0,374,374,76,76,0,1,0
10,384,384,20,11,9,2,1
9,407,407,124,20,104,4,3
20,428,428,45,1,44,2,1
8,437,437,14,14,0,1,0
11,439,439,68,68,0,1,0
15,447,447,24,24,0,1,0
7,480,480,40,10,30,4,3

13,143,143,15,3,12,2,1
6,169,169,5,5,0,1,0
22,221,221,15,1,14,3,2
7,224,224,49,49,0,1,0
23,232,232,37,5,32,3,2
24,236,236,24,24,0,1,0
0,249,249,4,4,0,1,0
18,270,270,35,16,19,4,3
4,285,285,44,32,12,3,2
16,285,285,21,9,12,2,1
8,294,294,27,27,0,1,0
3,295,295,12,12,0,1,0
5,323,323,9,3,6,3,2
17,327,327,20,10,10,2,1
1,330,330,34,2,32,3,2
12,338,338,7,7,0,1,0
15,360,360,11,3,8,3,2
9,366,366,194,188,6,2,1
2,405,405,12,12,0,1,0
25,419,419,13,8,5,2,1
11,449,449,15,1,14,2,1
19,462,462,95,65,30,3,2
14,470,470,112,102,10,2,1
10,486,486,3,3,0,1,0
20,491,491,34,23,11,2,1
21,494,494,25,25,0,1,0

4,106,106,1,1,0,1,0
24,126,126,12,12,0,1,0
1,128,128,6,6,0,1,0
8,134,134,2,2,0,1,0
19,138,138,38,38,0,1,0
16,154,154,5,5,0,1,0
0,158,158,6,6,0,1,0
20,161,161,9,3,6,3,2
12,202,202,3,3,0,1,0
27,203,203,42,42,0,1,0
14,207,207,40,40,0,1,0
28,213,213,1,1,0,1,0
3,232,232,26,26,0,1,0
9,236,236,27,27,0,1,0
15,264,264,29,8,21,2,1
2,272,272,57,24,33,4,3
23,284,284,79,79,0,1,0
5,291,291,8,8,0,1,0
13,303,303,18,18,0,1,0
29,333,333,1,1,0,1,0
11,368,368,53,53,0,1,0
26,390,390,12,8,4,2,1
7,406,406,1,1,0,1,0
18,408,408,69,45,24,3,2
6,413,413,37,17,20,2,1
10,448,448,37,37,0,1,0
25,459,459,3,3,0,1,0
17,483,483,73,37,36,3,2
21,486,486,17,17,0,1,0
22,491,491,8,3,5,2,1

23,105,105,6,6,0,1,0
25,105,105,1,1,0,1,0
2,110,110,2,2,0,1,0
11,124,124,2,2,0,1,0
5,166,166,3,3,0,1,0
16,166,166,6,6,0,1,0
22,171,171,21,21,0,1,0
1,227,227,5,2,3,2,1
3,263,263,101,83,18,4,3
27,271,271,47,34,13,2,1
12,278,278,1,1,0,1,0
0,279,279,34,34,0,1,0
20,315,315,64,14,50,3,2
4,319,319,7,7,0,1,0
21,337,337,28,5,23,2,1
18,344,344,9,9,0,1,0
14,347,347,20,20,0,1,0
7,373,373,5,5,0,1,0
17,375,375,115,32,83,4,3
24,403,403,24,24,0,1,0
10,426,426,1,1,0,1,0
15,428,428,65,42,23,2,1
19,430,430,22,7,15,2,1
26,439,439,18,7,11,2,1
13,439,439,32,12,20,2,1
9,452,452,88,42,46,3,2
8,478,478,15,1,14,4,3
6,487,487,157,157,0,1,0

3,103,103,3,3,0,1,0
6,132,132,52,16,36,4,3
9,153,153,27,27,0,1,0
4,160,160,4,4,0,1,0
12,173,173,29,29,0,1,0
20,179,179,3,3,0,1,0
21,191,191,3,3,0,1,0
8,203,203,4,4,0,1,0
14,241,241,14,14,0,1,0
7,253,253,30,30,0,1,0
16,282,282,35,5,30,4,3
10,334,334,32,32,0,1,0
11,339,339,40,28,12,2,1
13,358,358,35,35,0,1,0
19,363,363,84,50,34,4,3
2,363,363,9,9,0,1,0
1,392,392,22,22,0,1,0
18,435,435,35,35,0,1,0
15,436,436,30,9,21,4,3
5,466,466,138,48,90,4,3
0,468,468,75,3,72,3,2
22,474,474,90,70,20,3,2
17,475,475,28,28,0,1,0

25,107,107,49,49,0,1,0
13,116,116,66,66,0,1,0
14,175,175,9,5,4,2,1
0,203,203,1,1,0,1,0
9,206,206,11,7,4,2,1
17,212,212,6,6,0,1,0
15,214,214,12,8,4,2,1
5,226,226,1,1,0,1,0
2,231,231,1,1,0,1,0
21,240,240,8,8,0,1,0
22,242,242,11,3,8,2,1
20,249,249,20,9,11,2,1
10,254,254,32,32,0,1,0
23,258,258,25,25,0,1,0
11,293,293,16,16,0,1,0
8,313,313,2,2,0,1,0
19,357,357,4,4,0,1,0
26,365,365,21,13,8,2,1
24,376,376,62,62,0,1,0
3,380,380,87,45,42,3,2
16,386,386,51,51,0,1,0
1,388,388,60,60,0,1,0
18,396,396,45,29,16,2,1
4,406,406,21,9,12,3,2
7,432,432,2,2,0,1,0
6,452,452,2,2,0,1,0
12,472,472,17,4,13,2,1

6,108,108,18,18,0,1,0
1,117,117,8,1,7,2,1
10,132,132,6,6,0,1,0
3,136,136,1,1,0,1,0
5,148,148,7,7,0,1,0
25,152,152,18,7,11,2,1
13,166,166,3,3,0,1,0
16,172,172,30,30,0,1,0
28,200,200,10,3,7,2,1
27,209,209,13,13,0,1,0
26,220,220,72,14,58,3,2
0,221,221,11,5,6,2,1
23,236,236,52,52,0,1,0
19,239,239,9,3,6,3,2
9,260,260,31,31,0,1,0
18,266,266,2,2,0,1,0
30,277,277,48,48,0,1,0
29,282,282,17,3,14,3,2
7,288,288,4,4,0,1,0
24,327,327,5,5,0,1,0
8,331,331,30,30,0,1,0
12,338,338,10,10,0,1,0
22,357,357,22,1,21,4,3
11,375,375,1,1,0,1,0
20,379,379,21,6,15,4,3
21,383,383,14,14,0,1,0
17,383,383,78,78,0,1,0
15,424,424,97,9,88,4,3
14,453,453,1,1,0,1,0
4,464,464,12,12,0,1,0
31,481,481,55,55,0,1,0
2,500,500,1,1,0,1,0

3,132,132,1,1,0,1,0
7,166,166,49,17,32,2,1
5,176,176,8,8,0,1,0
8,176,176,1,1,0,1,0
23,179,179,33,33,0,1,0
6,199,199,5,5,0,1,0
25,206,206,5,5,0,1,0
11,210,210,4,1,3,2,1
24,251,251,37,2,35,2,1
10,252,252,15,15,0,1,0
22,262,262,27,27,0,1,0
19,285,285,6,3,3,2,1
1,300,300,6,6,0,1,0
21,346,346,104,104,0,1,0
13,352,352,15,3,12,3,2
2,368,368,109,87,22,2,1
20,400,400,1,1,0,1,0
16,402,402,1,1,0,1,0
12,408,408,4,4,0,1,0
17,425,425,28,2,26,2,1
15,426,426,167,167,0,1,0
14,428,428,6,6,0,1,0
0,429,429,109,97,12,2,1
9,432,432,21,21,0,1,0
4,439,439,94,94,0,1,0
18,485,485,12,2,10,3,2

20,103,103,9,3,6,3,2
0,136,136,1,1,0,1,0
18,157,157,1,1,0,1,0
28,157,157,11,11,0,1,0
27,168,168,21,21,0,1,0
16,201,201,14,14,0,1,0
15,251,251,5,5,0,1,0
12,271,271,11,8,3,2,1
5,286,286,35,35,0,1,0
2,291,291,34,22,12,2,1
19,310,310,34,20,14,3,2
26,319,319,1,1,0,1,0
24,345,345,32,11,21,2,1
6,366,366,45,2,43,2,1
3,367,367,29,29,0,1,0
1,381,381,10,1,9,4,3
21,385,385,46,46,0,1,0
23,386,386,62,62,0,1,0
29,394,394,12,2,10,2,1
7,395,395,16,16,0,1,0
9,402,402,69,69,0,1,0
11,409,409,45,2,43,2,1
30,412,412,152,126,26,2,1
10,413,413,15,11,4,2,1
25,427,427,9,9,0,1,0
8,438,438,13,13,0,1,0
17,446,446,31,18,13,2,1
31,455,455,10,10,0,1,0
4,455,455,41,33,8,2,1
13,461,461,65,65,0,1,0
22,469,469,54,54,0,1,0
14,487,487,2,2,0,1,0

1,104,104,3,3,0,1,0
14,133,133,6,6,0,1,0
19,154,154,4,4,0,1,0
5,164,164,2,2,0,1,0
9,194,194,49,49,0,1,0
6,200,200,36,23,13,2,1
13,246,246,32,17,15,2,1
15,264,264,60,10,50,2,1
12,276,276,21,21,0,1,0
3,277,277,1,1,0,1,0
25,294,294,13,5,8,2,1
2,306,306,8,8,0,1,0
17,311,311,48,48,0,1,0
18,326,326,15,2,13,2,1
7,342,342,112,112,0,1,0
24,353,353,77,14,63,3,2
26,388,388,115,115,0,1,0
20,396,396,24,24,0,1,0
10,406,406,5,5,0,1,0
16,413,413,27,27,0,1,0
21,444,444,13,3,10,3,2
11,452,452,11,3,8,3,2
8,453,453,102,40,62,3,2
22,469,469,13,1,12,3,2
0,474,474,1,1,0,1,0
4,484,484,1,1,0,1,0
23,485,485,39,39,0,1,0

18,111,111,15,15,0,1,0
25,119,119,18,18,0,1,0
20,120,120,6,6,0,1,0
1,133,133,12,12,0,1,0
3,141,141,16,16,0,1,0
26,143,143,27,13,14,2,1
6,212,212,19,13,6,2,1
27,226,226,25,25,0,1,0
9,236,236,16,8,8,3,2
15,243,243,13,9,4,2,1
5,252,252,4,4,0,1,0
0,300,300,22,22,0,1,0
4,311,311,18,18,0,1,0
14,313,313,24,2,22,3,2
10,316,316,85,22,63,4,3
24,335,335,3,3,0,1,0
11,338,338,11,11,0,1,0
7,382,382,67,34,33,4,3
23,390,390,10,10,0,1,0
19,396,396,75,42,33,4,3
13,401,401,7,1,6,3,2
17,426,426,12,12,0,1,0
22,457,457,21,5,16,3,2
21,462,462,66,23,43,4,3
2,482,482,4,4,0,1,0
16,488,488,95,50,45,4,3
8,494,494,104,56,48,4,3
12,498,498,1,1,0,1,0

14,174,174,8,8,0,1,0
23,177,177,38,38,0,1,0
22,190,190,52,44,8,3,2
13,197,197,5,1,4,2,1
2,243,243,7,2,5,2,1
10,258,258,34,2,32,4,3
4,261,261,2,2,0,1,0
17,280,280,2,2,0,1,0
30,295,295,30,30,0,1,0
9,303,303,45,5,40,2,1
26,309,309,17,17,0,1,0
21,323,323,17,17,0,1,0
15,329,329,7,4,3,2,1
1,330,330,116,116,0,1,0
29,336,336,4,4,0,1,0
5,345,345,4,4,0,1,0
20,347,347,12,7,5,2,1
6,359,359,20,20,0,1,0
31,364,364,98,36,62,3,2
33,364,364,1,1,0,1,0
3,367,367,21,2,19,2,1
19,370,370,40,40,0,1,0
18,382,382,19,13,6,2,1
16,389,389,10,5,5,2,1
11,418,418,23,9,14,3,2
28,427,427,1,1,0,1,0
24,447,447,17,17,0,1,0
8,459,459,16,7,9,2,1
12,469,469,19,19,0,1,0
7,479,479,12,12,0,1,0
32,479,479,77,77,0,1,0
25,485,485,58,27,31,4,3
27,496,496,10,10,0,1,0
0,497,497,18,4,14,3,2

20,102,102,5,5,0,1,0
16,146,146,18,3,15,2,1
18,156,156,4,4,0,1,0
8,161,161,4,4,0,1,0
13,163,163,36,36,0,1,0
22,185,185,12,1,11,2,1
14,190,190,6,3,3,2,1
0,223,223,1,1,0,1,0
9,228,228,28,28,0,1,0
17,235,235,55,15,40,3,2
15,283,283,4,4,0,1,0
4,287,287,34,18,16,3,2
11,292,292,4,4,0,1,0
5,322,322,16,12,4,2,1
1,342,342,70,46,24,3,2
12,365,365,78,47,31,4,3
3,378,378,1,1,0,1,0
19,384,384,25,6,19,2,1
6,386,386,54,21,33,4,3
10,400,400,89,53,36,4,3
21,416,416,20,8,12,3,2
7,450,450,108,108,0,1,0
2,495,495,195,163,32,2,1

18,102,102,8,8,0,1,0
10,111,111,2,2,0,1,0
17,120,120,19,11,8,3,2
4,162,162,12,1,11,2,1
14,180,180,6,6,0,1,0
26,186,186,20,8,12,2,1
27,191,191,5,1,4,2,1
20,204,204,6,6,0,1,0
19,251,251,94,73,21,4,3
16,253,253,13,13,0,1,0
7,269,269,31,3,28,3,2
3,273,273,110,59,51,4,3
21,289,289,21,21,0,1,0
11,306,306,9,9,0,1,0
2,324,324,2,2,0,1,0
25,352,352,23,8,15,4,3
12,356,356,20,20,0,1,0
0,365,365,8,8,0,1,0
22,390,390,10,6,4,2,1
8,393,393,87,87,0,1,0
9,395,395,46,22,24,3,2
1,417,417,1,1,0,1,0
23,423,423,80,37,43,4,3
13,432,432,59,22,37,2,1
5,435,435,13,13,0,1,0
6,443,443,17,17,0,1,0
15,450,450,63,9,54,4,3
24,500,500,2,2,0,1,0

20,106,106,3,3,0,1,0
23,106,106,1,1,0,1,0
2,138,138,1,1,0,1,0
17,155,155,19,6,13,2,1
0,163,163,17,3,14,3,2
9,183,183,13,13,0,1,0
15,188,188,31,28,3,2,1
12,190,190,6,6,0,1,0
13,205,205,2,2,0,1,0
11,259,259,32,13,19,2,1
14,285,285,9,2,7,2,1
16,285,285,62,14,48,2,1
8,300,300,52,52,0,1,0
19,308,308,33,29,4,2,1
10,344,344,39,39,0,1,0
6,365,365,15,3,12,4,3
1,389,389,108,39,69,4,3
22,405,405,40,21,19,2,1
21,405,405,34,16,18,2,1
5,418,418,135,135,0,1,0
7,442,442,1,1,0,1,0
4,445,445,20,20,0,1,0
18,475,475,47,47,0,1,0
3,482,482,9,5,4,2,1
24,485,485,159,12,147,4,3

13,104,104,26,26,0,1,0
8,123,123,13,13,0,1,0
20,136,136,11,11,0,1,0
7,137,137,4,4,0,1,0
12,142,142,27,27,0,1,0
14,144,144,4,4,0,1,0
17,156,156,6,6,0,1,0
10,157,157,10,10,0,1,0
9,182,182,16,16,0,1,0
1,231,231,1,1,0,1,0
23,233,233,21,6,15,4,3
5,241,241,7,7,0,1,0
11,255,255,26,14,12,2,1
26,294,294,6,6,0,1,0
27,320,320,20,2,18,2,1
3,325,325,14,14,0,1,0
15,360,360,79,69,10,2,1
2,384,384,62,62,0,1,0
6,398,398,57,57,0,1,0
0,405,405,19,7,12,3,2
16,413,413,9,9,0,1,0
19,416,416,17,17,0,1,0
24,417,417,5,2,3,2,1
4,431,431,9,3,6,2,1
22,435,435,87,2,85,4,3
18,457,457,215,179,36,4,3
25,482,482,23,5,18,4,3
21,485,485,6,1,5,2,1

11,111,111,2,2,0,1,0
7,119,119,8,8,0,1,0
2,129,129,20,11,9,2,1
6,131,131,5,1,4,2,1
14,134,134,28,5,23,4,3
15,141,141,13,8,5,2,1
0,147,147,1,1,0,1,0
9,169,169,31,19,12,2,1
5,221,221,8,8,0,1,0
16,224,224,11,11,0,1,0
12,228,228,15,5,10,2,1
22,244,244,7,7,0,1,0
1,256,256,3,3,0,1,0
4,312,312,86,51,35,2,1
20,320,320,11,1,10,3,2
10,330,330,1,1,0,1,0
19,387,387,157,75,82,3,2
18,402,402,78,78,0,1,0
13,447,447,37,37,0,1,0
3,452,452,222,191,31,4,3
17,469,469,51,51,0,1,0
21,488,488,16,16,0,1,0
8,490,490,17,17,0,1,0

12,102,102,1,1,0,1,0
8,108,108,16,4,12,4,3
2,117,117,64,64,0,1,0
19,141,141,13,13,0,1,0
15,165,165,8,8,0,1,0
3,176,176,8,8,0,1,0
7,179,179,10,10,0,1,0
20,186,186,15,5,10,2,1
21,189,189,64,38,26,4,3
5,199,199,11,3,8,2,1
24,213,213,6,6,0,1,0
9,226,226,10,10,0,1,0
11,231,231,12,12,0,1,0
14,255,255,19,13,6,3,2
6,290,290,51,7,44,3,2
23,327,327,29,29,0,1,0
22,336,336,28,14,14,3,2
10,346,346,1,1,0,1,0
1,357,357,1,1,0,1,0
17,371,371,91,91,0,1,0
16,378,378,7,7,0,1,0
13,396,396,19,19,0,1,0
0,413,413,31,31,0,1,0
4,416,416,38,23,15,4,3
18,461,461,59,59,0,1,0
25,489,489,25,25,0,1,0

18,132,132,10,10,0,1,0
26,133,133,1,1,0,1,0
12,145,145,2,2,0,1,0
28,151,151,32,17,15,4,3
22,184,184,1,1,0,1,0
7,186,186,43,4,39,4,3
19,212,212,29,29,0,1,0
15,226,226,4,4,0,1,0
0,229,229,6,6,0,1,0
13,234,234,38,10,28,2,1
25,244,244,45,9,36,3,2
27,247,247,4,1,3,2,1
24,271,271,22,8,14,2,1
21,271,271,53,53,0,1,0
23,275,275,13,13,0,1,0
3,276,276,13,13,0,1,0
10,296,296,6,6,0,1,0
11,321,321,35,17,18,2,1
14,326,326,63,63,0,1,0
17,356,356,83,83,0,1,0
1,358,358,9,1,8,2,1
4,385,385,53,7,46,3,2
16,391,391,22,22,0,1,0
8,401,401,30,30,0,1,0
20,415,415,36,12,24,4,3
9,427,427,34,34,0,1,0
2,446,446,30,25,5,2,1
5,447,447,43,43,0,1,0
6,463,463,1,1,0,1,0

27,103,103,9,9,0,1,0
31,106,106,30,30,0,1,0
28,106,106,4,4,0,1,0
29,107,107,11,11,0,1,0
11,127,127,2,2,0,1,0
15,129,129,10,7,3,2,1
3,130,130,1,1,0,1,0
13,132,132,27,9,18,2,1
12,133,133,13,13,0,1,0
30,165,165,5,2,3,2,1
2,197,197,4,4,0,1,0
20,197,197,16,16,0,1,0
19,201,201,51,10,41,2,1
25,227,227,15,15,0,1,0
17,230,230,65,65,0,1,0
7,230,230,1,1,0,1,0
14,231,231,2,2,0,1,0
5,242,242,9,9,0,1,0
16,257,257,9,9,0,1,0
6,268,268,5,5,0,1,0
24,271,271,40,1,39,2,1
0,289,289,51,47,4,2,1
10,296,296,15,15,0,1,0
9,301,301,23,17,6,3,2
4,394,394,34,17,17,2,1
26,409,409,26,26,0,1,0
21,417,417,38,38,0,1,0
18,431,431,23,17,6,2,1
1,451,451,18,2,16,2,1
23,469,469,31,11,20,3,2
22,486,486,15,7,8,3,2
8,491,491,4,4,0,1,0

1,106,106,8,8,0,1,0
9,146,146,11,5,6,2,1
4,153,153,10,10,0,1,0
22,156,156,47,47,0,1,0
7,230,230,7,7,0,1,0
6,273,273,151,64,87,4,3
15,300,300,10,10,0,1,0
14,318,318,63,63,0,1,0
10,318,318,31,31,0,1,0
13,325,325,1,1,0,1,0
16,329,329,45,37,8,3,2
0,340,340,2,2,0,1,0
18,343,343,63,63,0,1,0
2,379,379,23,9,14,2,1
20,385,385,3,3,0,1,0
21,386,386,31,31,0,1,0
3,392,392,27,21,6,2,1
5,403,403,51,51,0,1,0
17,426,426,28,28,0,1,0
12,436,436,3,3,0,1,0
8,437,437,105,105,0,1,0
11,445,445,56,56,0,1,0
19,461,461,37,37,0,1,0

12,113,113,14,14,0,1,0
8,118,118,36,3,33,3,2
24,132,132,8,8,0,1,0
29,160,160,5,5,0,1,0
10,202,202,22,4,18,2,1
25,209,209,48,48,0,1,0
26,228,228,18,6,12,4,3
4,234,234,18,18,0,1,0
21,235,235,38,11,27,4,3
3,259,259,7,7,0,1,0
18,277,277,48,48,0,1,0
15,281,281,5,5,0,1,0
20,297,297,41,17,24,3,2
0,312,312,14,14,0,1,0
13,320,320,43,13,30,2,1
2,322,322,8,8,0,1,0
16,336,336,31,31,0,1,0
1,359,359,12,12,0,1,0
11,368,368,29,8,21,4,3
28,380,380,21,3,18,4,3
17,395,395,39,39,0,1,0
6,418,418,30,9,21,4,3
9,441,441,21,12,9,4,3
23,444,444,38,38,0,1,0
19,445,445,78,5,73,4,3
7,445,445,40,23,17,2,1
14,449,449,6,6,0,1,0
5,466,466,5,5,0,1,0
27,469,469,2,2,0,1,0
22,498,498,14,8,6,2,1

13,100,100,8,2,6,2,1
7,119,119,6,1,5,2,1
20,129,129,6,6,0,1,0
16,143,143,65,15,50,2,1
6,158,158,1,1,0,1,0
18,174,174,15,15,0,1,0
23,177,177,30,30,0,1,0
3,182,182,10,10,0,1,0
17,196,196,4,4,0,1,0
4,200,200,25,25,0,1,0
12,215,215,93,93,0,1,0
15,218,218,26,26,0,1,0
10,225,225,11,1,10,3,2
0,229,229,7,7,0,1,0
11,251,251,4,4,0,1,0
14,253,253,19,12,7,2,1
19,284,284,17,12,5,2,1
21,318,318,8,8,0,1,0
9,332,332,35,35,0,1,0
8,362,362,36,12,24,2,1
1,363,363,8,8,0,1,0
27,395,395,2,2,0,1,0
24,418,418,49,9,40,3,2
22,423,423,22,10,12,4,3
25,424,424,65,47,18,4,3
2,426,426,37,37,0,1,0
5,450,450,30,30,0,1,0
26,492,492,10,7,3,2,1

0,110,110,1,1,0,1,0
12,115,115,7,7,0,1,0
7,118,118,22,22,0,1,0
22,124,124,20,20,0,1,0
10,162,162,1,1,0,1,0
27,178,178,16,16,0,1,0
15,204,204,32,32,0,1,0
3,212,212,27,7,20,2,1
24,214,214,20,20,0,1,0
26,236,236,40,40,0,1,0
14,251,251,53,53,0,1,0
25,254,254,18,9,9,4,3
4,261,261,14,14,0,1,0
6,262,262,35,16,19,2,1
21,297,297,60,21,39,2,1
8,330,330,24,24,0,1,0
16,350,350,23,9,14,3,2
9,354,354,1,1,0,1,0
2,363,363,20,20,0,1,0
23,368,368,71,29,42,3,2
19,378,378,3,3,0,1,0
20,383,383,1,1,0,1,0
1,397,397,10,6,4,2,1
11,422,422,37,31,6,3,2
17,437,437,36,36,0,1,0
13,457,457,107,35,72,4,3
18,468,468,11,4,7,2,1
5,485,485,17,17,0,1,0

9,106,106,20,3,17,2,1
6,113,113,1,1,0,1,0
10,122,122,2,2,0,1,0
21,151,151,12,12,0,1,0
19,158,158,65,65,0,1,0
17,161,161,2,2,0,1,0
11,163,163,1,1,0,1,0
7,169,169,1,1,0,1,0
16,171,171,48,38,10,3,2
14,275,275,35,8,27,2,1
13,275,275,8,3,5,2,1
23,315,315,22,10,12,2,1
4,337,337,102,102,0,1,0
1,374,374,34,34,0,1,0
22,375,375,3,3,0,1,0
3,382,382,17,1,16,2,1
8,397,397,88,28,60,3,2
15,408,408,75,63,12,2,1
2,424,424,112,22,90,4,3
12,458,458,18,18,0,1,0
0,465,465,9,9,0,1,0
18,465,465,6,6,0,1,0
5,488,488,67,47,20,2,1
20,500,500,32,32,0,1,0

16,123,123,9,1,8,3,2
5,134,134,9,9,0,1,0
6,161,161,52,52,0,1,0
14,172,172,29,29,0,1,0
1,176,176,26,26,0,1,0
21,218,218,12,12,0,1,0
8,248,248,3,3,0,1,0
19,252,252,53,53,0,1,0
2,274,274,9,1,8,3,2
7,319,319,34,4,30,4,3
11,326,326,4,4,0,1,0
9,356,356,38,2,36,3,2
4,388,388,200,59,141,4,3
17,392,392,11,11,0,1,0
15,394,394,33,33,0,1,0
10,435,435,12,12,0,1,0
18,438,438,12,1,11,2,1
20,439,439,137,137,0,1,0
3,449,449,13,6,7,2,1
12,457,457,11,11,0,1,0
13,464,464,90,22,68,3,2
0,474,474,32,5,27,2,1

22,100,100,8,4,4,2,1
5,103,103,9,9,0,1,0
26,104,104,12,8,4,2,1
1,111,111,9,9,0,1,0
19,127,127,6,6,0,1,0
11,133,133,5,5,0,1,0
10,136,136,2,2,0,1,0
9,140,140,15,3,12,3,2
20,142,142,6,6,0,1,0
2,145,145,3,3,0,1,0
17,145,145,20,1,19,2,1
15,195,195,33,11,22,3,2
3,195,195,6,6,0,1,0
18,248,248,12,12,0,1,0
24,260,260,27,27,0,1,0
14,261,261,33,1,32,2,1
12,262,262,60,42,18,3,2
13,285,285,13,13,0,1,0
4,296,296,45,45,0,1,0
6,300,300,22,2,20,2,1
7,367,367,125,47,78,3,2
16,387,387,16,16,0,1,0
8,404,404,30,30,0,1,0
0,436,436,3,3,0,1,0
25,445,445,118,69,49,4,3
21,455,455,12,12,0,1,0
23,470,470,59,59,0,1,0

13,118,118,5,2,3,2,1
21,119,119,16,16,0,1,0
15,127,127,10,10,0,1,0
2,130,130,1,1,0,1,0
17,131,131,8,2,6,2,1
22,141,141,25,5,20,3,2
3,142,142,24,24,0,1,0
8,191,191,19,16,3,2,1
14,191,191,25,5,20,2,1
23,204,204,42,42,0,1,0
0,223,223,7,7,0,1,0
6,237,237,2,2,0,1,0
12,237,237,19,16,3,2,1
1,275,275,1,1,0,1,0
9,276,276,9,5,4,2,1
16,291,291,19,19,0,1,0
20,327,327,11,11,0,1,0
10,329,329,123,16,107,4,3
24,336,336,57,57,0,1,0
18,356,356,25,13,12,2,1
11,390,390,27,6,21,4,3
19,392,392,33,12,21,4,3
5,408,408,64,64,0,1,0
7,446,446,147,57,90,4,3
4,461,461,9,9,0,1,0

17,122,122,20,20,0,1,0
23,181,181,22,13,9,4,3
8,183,183,23,19,4,2,1
19,186,186,32,13,19,2,1
18,194,194,5,1,4,2,1
5,219,219,11,11,0,1,0
4,221,221,13,13,0,1,0
11,227,227,9,9,0,1,0
6,246,246,13,13,0,1,0
13,251,251,1,1,0,1,0
14,260,260,3,3,0,1,0
2,308,308,111,111,0,1,0
12,316,316,18,13,5,2,1
1,324,324,76,28,48,2,1
0,324,324,66,66,0,1,0
10,359,359,62,44,18,4,3
22,381,381,125,93,32,2,1
9,385,385,1,1,0,1,0
7,392,392,7,7,0,1,0
3,437,437,10,10,0,1,0
15,442,442,134,47,87,4,3
20,460,460,6,6,0,1,0
21,479,479,16,16,0,1,0
16,485,485,24,24,0,1,0

11,100,100,2,2,0,1,0
10,112,112,15,15,0,1,0
6,140,140,22,13,9,2,1
18,151,151,1,1,0,1,0
9,178,178,8,8,0,1,0
0,189,189,21,7,14,2,1
25,192,192,25,25,0,1,0
19,198,198,6,6,0,1,0
8,203,203,44,18,26,3,2
21,214,214,9,2,7,2,1
12,251,251,6,1,5,2,1
4,253,253,6,6,0,1,0
3,257,257,19,1,18,2,1
20,269,269,33,33,0,1,0
2,270,270,35,35,0,1,0
24,281,281,31,1,30,3,2
16,318,318,58,12,46,3,2
7,355,355,50,15,35,2,1
5,361,361,12,12,0,1,0
22,394,394,54,54,0,1,0
17,404,404,10,10,0,1,0
13,406,406,2,2,0,1,0
14,460,460,7,1,6,3,2
23,463,463,174,48,126,4,3
1,490,490,94,25,69,4,3
15,500,500,72,25,47,4,3

9,112,112,16,3,13,2,1
29,113,113,14,8,6,2,1
25,149,149,1,1,0,1,0
15,163,163,15,15,0,1,0
20,171,171,41,5,36,3,2
3,193,193,11,3,8,2,1
0,193,193,25,3,22,3,2
23,219,219,37,37,0,1,0
24,226,226,9,9,0,1,0
7,246,246,14,14,0,1,0
12,248,248,25,12,13,2,1
17,260,260,17,8,9,4,3
21,262,262,13,13,0,1,0
27,264,264,25,13,12,2,1
22,271,271,27,27,0,1,0
2,280,280,27,27,0,1,0
5,290,290,26,26,0,1,0
26,297,297,48,28,20,2,1
6,325,325,22,22,0,1,0
19,366,366,45,31,14,2,1
18,372,372,7,7,0,1,0
4,377,377,1,1,0,1,0
1,394,394,32,6,26,3,2
16,397,397,21,21,0,1,0
8,399,399,10,10,0,1,0
28,407,407,54,44,10,3,2
14,438,438,67,17,50,3,2
13,467,467,7,7,0,1,0
10,477,477,40,40,0,1,0
11,500,500,27,27,0,1,0

1,103,103,2,2,0,1,0
6,117,117,11,11,0,1,0
8,126,126,21,21,0,1,0
18,138,138,5,5,0,1,0
22,142,142,13,5,8,3,2
19,143,143,15,15,0,1,0
0,166,166,14,8,6,3,2
11,173,173,2,2,0,1,0
25,197,197,59,45,14,3,2
27,213,213,4,4,0,1,0
9,232,232,9,9,0,1,0
13,240,240,39,39,0,1,0
29,244,244,67,67,0,1,0
3,261,261,11,5,6,3,2
15,275,275,11,5,6,2,1
12,279,279,18,12,6,3,2
23,279,279,18,18,0,1,0
24,296,296,5,5,0,1,0
10,297,297,43,6,37,2,1
14,298,298,11,11,0,1,0
2,320,320,55,55,0,1,0
5,346,346,35,11,24,3,2
28,351,351,35,35,0,1,0
26,352,352,65,54,11,2,1
16,353,353,10,2,8,2,1
20,354,354,4,1,3,2,1
21,453,453,22,5,17,4,3
7,468,468,30,30,0,1,0
17,476,476,40,7,33,2,1
4,480,480,15,15,0,1,0

6,111,111,1,1,0,1,0
15,121,121,1,1,0,1,0
3,128,128,12,12,0,1,0
4,142,142,15,5,10,3,2
5,155,155,24,24,0,1,0
19,155,155,25,25,0,1,0
23,166,166,37,13,24,4,3
25,174,174,1,1,0,1,0
17,182,182,43,43,0,1,0
20,231,231,14,14,0,1,0
7,234,234,19,19,0,1,0
2,278,278,7,2,5,2,1
8,281,281,43,43,0,1,0
16,285,285,7,7,0,1,0
21,287,287,11,11,0,1,0
1,343,343,9,9,0,1,0
0,352,352,18,1,17,2,1
14,368,368,17,17,0,1,0
12,382,382,27,27,0,1,0
18,390,390,15,11,4,2,1
22,401,401,14,14,0,1,0
27,410,410,13,6,7,2,1
26,414,414,115,52,63,4,3
10,424,424,6,6,0,1,0
24,438,438,81,81,0,1,0
9,472,472,39,28,11,2,1
13,483,483,110,74,36,3,2
11,494,494,79,79,0,1,0

15,102,102,1,1,0,1,0
16,103,103,6,6,0,1,0
5,113,113,7,7,0,1,0
4,126,126,27,24,3,2,1
19,143,143,6,6,0,1,0
17,163,163,13,5,8,3,2
12,187,187,6,6,0,1,0
11,193,193,11,1,10,2,1
10,240,240,42,12,30,4,3
22,246,246,65,65,0,1,0
8,281,281,12,12,0,1,0
14,293,293,11,11,0,1,0
0,332,332,19,19,0,1,0
20,337,337,54,19,35,2,1
3,338,338,89,56,33,4,3
9,395,395,13,13,0,1,0
2,395,395,50,50,0,1,0
13,411,411,43,43,0,1,0
21,415,415,46,19,27,2,1
18,431,431,32,32,0,1,0
7,441,441,37,1,36,3,2
6,446,446,20,6,14,2,1
23,447,447,82,82,0,1,0
24,482,482,80,62,18,4,3
1,483,483,70,70,0,1,0

17,101,101,5,5,0,1,0
23,112,112,21,21,0,1,0
22,119,119,3,3,0,1,0
10,143,143,14,14,0,1,0
2,153,153,27,27,0,1,0
19,185,185,5,1,4,2,1
5,197,197,1,1,0,1,0
7,226,226,25,11,14,3,2
20,237,237,18,18,0,1,0
13,238,238,29,29,0,1,0
12,238,238,30,20,10,2,1
14,246,246,35,35,0,1,0
24,264,264,6,1,5,2,1
4,270,270,1,1,0,1,0
8,281,281,58,48,10,2,1
9,282,282,13,1,12,2,1
0,326,326,1,1,0,1,0
11,337,337,1,1,0,1,0
6,404,404,51,51,0,1,0
21,406,406,61,4,57,4,3
1,411,411,17,17,0,1,0
3,413,413,147,93,54,4,3
15,413,413,152,152,0,1,0
25,422,422,32,14,18,3,2
18,439,439,12,5,7,2,1
16,462,462,27,27,0,1,0

4,101,101,1,1,0,1,0
23,105,105,8,8,0,1,0
13,143,143,4,1,3,2,1
18,199,199,4,4,0,1,0
27,204,204,15,8,7,2,1
9,208,208,44,17,27,2,1
28,232,232,3,3,0,1,0
11,247,247,5,1,4,2,1
20,249,249,32,32,0,1,0
26,251,251,9,9,0,1,0
2,251,251,10,1,9,2,1
14,256,256,19,19,0,1,0
22,287,287,85,8,77,4,3
5,309,309,40,13,27,4,3
30,314,314,23,4,19,2,1
10,321,321,16,16,0,1,0
12,327,327,1,1,0,1,0
24,329,329,1,1,0,1,0
25,331,331,38,38,0,1,0
0,332,332,47,47,0,1,0
19,339,339,13,13,0,1,0
16,346,346,44,44,0,1,0
8,348,348,8,8,0,1,0
7,355,355,82,82,0,1,0
1,386,386,1,1,0,1,0
3,396,396,35,35,0,1,0
31,425,425,95,95,0,1,0
15,444,444,6,6,0,1,0
6,446,446,27,27,0,1,0
29,454,454,28,28,0,1,0
21,468,468,86,21,65,4,3
17,499,499,14,14,0,1,0

21,103,103,9,9,0,1,0
15,107,107,66,24,42,3,2
20,109,109,13,3,10,3,2
18,114,114,3,3,0,1,0
10,125,125,25,5,20,3,2
12,134,134,11,11,0,1,0
17,134,134,7,7,0,1,0
3,139,139,21,15,6,3,2
19,142,142,22,9,13,3,2
22,153,153,2,2,0,1,0
14,181,181,9,4,5,2,1
27,187,187,2,2,0,1,0
2,194,194,2,2,0,1,0
6,220,220,1,1,0,1,0
11,231,231,23,23,0,1,0
7,252,252,14,14,0,1,0
23,265,265,8,8,0,1,0
26,280,280,42,42,0,1,0
24,284,284,4,4,0,1,0
13,291,291,52,31,21,2,1
9,309,309,18,7,11,2,1
1,371,371,45,45,0,1,0
5,375,375,18,4,14,3,2
8,392,392,29,14,15,4,3
0,405,405,57,44,13,2,1
25,406,406,9,9,0,1,0
4,428,428,12,12,0,1,0
16,468,468,20,6,14,2,1

24,112,112,6,3,3,2,1
21,119,119,9,9,0,1,0
20,148,148,16,16,0,1,0
4,150,150,14,14,0,1,0
17,179,179,22,22,0,1,0
8,196,196,12,5,7,2,1
12,202,202,8,8,0,1,0
7,212,212,45,3,42,4,3
11,224,224,5,5,0,1,0
2,235,235,5,5,0,1,0
6,309,309,5,5,0,1,0
16,313,313,10,4,6,3,2
25,317,317,121,48,73,4,3
15,348,348,7,3,4,2,1
19,369,369,55,21,34,3,2
14,380,380,2,2,0,1,0
13,388,388,2,2,0,1,0
18,420,420,28,28,0,1,0
9,420,420,71,71,0,1,0
1,448,448,2,2,0,1,0
0,459,459,21,21,0,1,0
10,461,461,185,101,84,4,3
5,471,471,40,40,0,1,0
3,478,478,63,63,0,1,0
22,488,488,35,11,24,4,3
23,494,494,114,46,68,4,3

21,101,101,8,8,0,1,0
13,106,106,1,1,0,1,0
15,132,132,11,3,8,2,1
11,148,148,45,5,40,3,2
17,162,162,50,17,33,4,3
24,181,181,23,23,0,1,0
22,187,187,5,1,4,2,1
2,208,208,41,41,0,1,0
20,218,218,1,1,0,1,0
8,229,229,57,47,10,3,2
19,236,236,2,2,0,1,0
14,290,290,8,8,0,1,0
12,306,306,91,91,0,1,0
7,326,326,3,3,0,1,0
4,338,338,2,2,0,1,0
1,348,348,44,44,0,1,0
5,355,355,2,2,0,1,0
9,365,365,15,2,13,2,1
10,416,416,91,48,43,3,2
3,419,419,18,2,16,2,1
23,441,441,112,107,5,2,1
0,445,445,21,12,9,2,1
18,455,455,35,15,20,2,1
16,458,458,14,14,0,1,0
6,494,494,27,27,0,1,0

19,104,104,1,1,0,1,0
32,109,109,8,8,0,1,0
8,113,113,1,1,0,1,0
27,118,118,3,3,0,1,0
4,135,135,1,1,0,1,0
22,148,148,7,7,0,1,0
11,148,148,18,18,0,1,0
12,162,162,4,4,0,1,0
17,163,163,14,14,0,1,0
9,167,167,25,13,12,2,1
31,167,167,41,41,0,1,0
15,170,170,1,1,0,1,0
18,194,194,38,38,0,1,0
28,198,198,20,20,0,1,0
10,233,233,2,2,0,1,0
1,254,254,2,2,0,1,0
24,263,263,9,9,0,1,0
33,300,300,45,45,0,1,0
26,315,315,4,1,3,2,1
23,323,323,11,11,0,1,0
0,324,324,36,36,0,1,0
30,334,334,23,23,0,1,0
6,343,343,3,3,0,1,0
7,370,370,26,26,0,1,0
13,376,376,45,45,0,1,0
21,409,409,86,20,66,3,2
20,415,415,28,28,0,1,0
14,428,428,29,29,0,1,0
25,434,434,84,49,35,2,1
3,435,435,16,10,6,2,1
16,435,435,35,35,0,1,0
5,468,468,9,9,0,1,0
2,473,473,44,44,0,1,0
29,481,481,62,38,24,2,1

18,112,112,17,2,15,4,3
4,133,133,13,1,12,4,3
17,152,152,49,39,10,2,1
13,163,163,13,5,8,2,1
3,165,165,21,21,0,1,0
2,181,181,15,7,8,2,1
9,200,200,33,33,0,1,0
7,223,223,18,18,0,1,0
21,242,242,15,8,7,2,1
1,245,245,20,6,14,2,1
25,276,276,29,29,0,1,0
8,287,287,84,84,0,1,0
0,290,290,3,3,0,1,0
15,305,305,41,41,0,1,0
20,322,322,6,1,5,2,1
6,348,348,2,2,0,1,0
10,363,363,25,6,19,2,1
23,377,377,1,1,0,1,0
27,379,379,25,25,0,1,0
12,379,379,1,1,0,1,0
24,383,383,53,53,0,1,0
22,432,432,10,7,3,2,1
19,454,454,34,1,33,2,1
14,454,454,3,3,0,1,0
5,481,481,94,94,0,1,0
11,483,483,2,2,0,1,0
26,484,484,82,54,28,4,3
16,495,495,28,10,18,2,1

15,124,124,3,3,0,1,0
11,124,124,2,2,0,1,0
6,132,132,11,5,6,3,2
4,144,144,15,1,14,2,1
14,185,185,8,8,0,1,0
0,198,198,3,3,0,1,0
21,206,206,21,1,20,3,2
23,218,218,8,8,0,1,0
16,218,218,74,10,64,3,2
22,232,232,6,6,0,1,0
1,247,247,24,6,18,4,3
5,249,249,50,50,0,1,0
27,267,267,35,35,0,1,0
3,287,287,61,61,0,1,0
13,293,293,3,3,0,1,0
9,310,310,46,10,36,4,3
24,329,329,84,75,9,4,3
2,339,339,50,37,13,2,1
8,348,348,1,1,0,1,0
18,371,371,42,42,0,1,0
7,374,374,20,20,0,1,0
17,375,375,1,1,0,1,0
19,377,377,24,24,0,1,0
20,389,389,18,18,0,1,0
25,418,418,38,38,0,1,0
26,464,464,44,7,37,2,1
10,468,468,6,6,0,1,0
12,500,500,78,75,3,2,1

7,120,120,4,4,0,1,0
5,128,128,53,7,46,2,1
1,162,162,76,76,0,1,0
4,173,173,1,1,0,1,0
3,210,210,5,2,3,2,1
18,225,225,18,18,0,1,0
0,237,237,14,14,0,1,0
19,240,240,5,5,0,1,0
13,244,244,47,32,15,4,3
16,253,253,40,2,38,2,1
2,254,254,8,5,3,2,1
20,304,304,38,38,0,1,0
22,308,308,14,4,10,2,1
15,328,328,79,79,0,1,0
9,342,342,30,21,9,2,1
12,353,353,47,13,34,3,2
11,359,359,6,6,0,1,0
14,360,360,1,1,0,1,0
6,373,373,43,43,0,1,0
17,408,408,107,29,78,4,3
21,426,426,15,15,0,1,0
10,438,438,3,3,0,1,0
8,488,488,30,18,12,2,1

16,104,104,22,22,0,1,0
10,104,104,8,8,0,1,0
26,111,111,8,8,0,1,0
15,121,121,25,25,0,1,0
5,124,124,2,2,0,1,0
13,151,151,14,6,8,3,2
19,177,177,20,20,0,1,0
17,181,181,15,2,13,2,1
24,187,187,4,1,3,2,1
25,199,199,1,1,0,1,0
6,205,205,8,8,0,1,0
0,213,213,35,6,29,2,1
7,225,225,12,2,10,2,1
12,231,231,23,23,0,1,0
3,244,244,11,11,0,1,0
18,266,266,42,42,0,1,0
27,274,274,12,12,0,1,0
8,293,293,56,56,0,1,0
22,294,294,60,18,42,3,2
11,312,312,2,2,0,1,0
20,315,315,46,46,0,1,0
1,431,431,127,72,55,3,2
23,434,434,30,5,25,4,3
14,441,441,5,1,4,2,1
4,444,444,11,5,6,2,1
2,459,459,15,15,0,1,0
9,464,464,71,71,0,1,0
21,497,497,4,4,0,1,0

14,102,102,8,8,0,1,0
17,118,118,4,4,0,1,0
3,162,162,38,38,0,1,0
18,170,170,7,7,0,1,0
1,190,190,17,13,4,2,1
19,261,261,15,5,10,3,2
6,263,263,119,58,61,4,3
15,275,275,11,2,9,4,3
0,278,278,4,1,3,2,1
5,289,289,6,6,0,1,0
8,307,307,3,3,0,1,0
4,308,308,5,5,0,1,0
9,329,329,40,40,0,1,0
12,337,337,129,129,0,1,0
7,357,357,29,29,0,1,0
13,362,362,77,3,74,3,2
11,407,407,80,32,48,4,3
10,472,472,9,9,0,1,0
16,490,490,25,8,17,3,2
2,491,491,233,233,0,1,0

8,100,100,5,5,0,1,0
1,107,107,1,1,0,1,0
24,145,145,2,2,0,1,0
5,162,162,14,5,9,2,1
13,162,162,6,1,5,2,1
27,208,208,16,2,14,2,1
16,211,211,13,7,6,2,1
2,217,217,15,15,0,1,0
26,234,234,16,2,14,3,2
4,246,246,23,23,0,1,0
9,261,261,1,1,0,1,0
7,273,273,4,1,3,2,1
25,279,279,126,36,90,4,3
11,290,290,11,11,0,1,0
10,300,300,6,6,0,1,0
22,314,314,70,45,25,2,1
20,346,346,24,24,0,1,0
14,353,353,26,17,9,4,3
17,361,361,46,7,39,2,1
3,367,367,144,78,66,4,3
21,386,386,15,15,0,1,0
23,412,412,33,8,25,2,1
0,423,423,33,21,12,4,3
18,443,443,1,1,0,1,0
19,443,443,3,3,0,1,0
6,443,443,82,82,0,1,0
15,454,454,40,40,0,1,0
28,461,461,48,30,18,4,3
12,470,470,29,6,23,2,1

17,100,100,18,18,0,1,0
25,107,107,8,3,5,2,1
24,114,114,7,7,0,1,0
19,115,115,12,6,6,2,1
3,155,155,1,1,0,1,0
18,182,182,27,27,0,1,0
4,192,192,1,1,0,1,0
1,204,204,5,2,3,2,1
28,234,234,10,10,0,1,0
11,249,249,52,19,33,4,3
29,258,258,59,59,0,1,0
8,259,259,4,4,0,1,0
0,267,267,17,17,0,1,0
10,271,271,30,18,12,4,3
5,291,291,24,24,0,1,0
20,303,303,50,41,9,2,1
14,305,305,11,2,9,2,1
6,312,312,23,1,22,4,3
12,319,319,2,2,0,1,0
13,324,324,2,2,0,1,0
27,369,369,1,1,0,1,0
9,370,370,55,22,33,2,1
2,384,384,13,7,6,3,2
15,406,406,5,5,0,1,0
16,407,407,22,22,0,1,0
21,439,439,75,11,64,4,3
7,452,452,40,19,21,4,3
30,468,468,40,10,30,2,1
26,476,476,10,4,6,2,1
31,484,484,100,100,0,1,0
22,485,485,48,48,0,1,0
23,500,500,31,31,0,1,0

10,142,142,10,5,5,2,1
9,154,154,19,7,12,2,1
18,157,157,4,4,0,1,0
25,181,181,9,1,8,3,2
4,187,187,13,13,0,1,0
24,212,212,20,10,10,2,1
22,230,230,10,2,8,3,2
6,281,281,8,2,6,2,1
16,308,308,24,16,8,2,1
12,322,322,26,26,0,1,0
20,354,354,23,23,0,1,0
13,355,355,39,39,0,1,0
3,358,358,15,15,0,1,0
2,368,368,8,8,0,1,0
19,371,371,5,5,0,1,0
14,374,374,22,22,0,1,0
0,377,377,13,13,0,1,0
21,391,391,175,175,0,1,0
26,399,399,18,9,9,4,3
7,421,421,19,19,0,1,0
11,432,432,84,62,22,3,2
23,442,442,161,125,36,3,2
17,458,458,18,18,0,1,0
27,472,472,19,15,4,2,1
15,475,475,3,3,0,1,0
5,485,485,120,54,66,4,3
1,491,491,12,12,0,1,0
8,495,495,74,14,60,4,3

24,110,110,5,5,0,1,0
16,133,133,6,6,0,1,0
26,151,151,48,48,0,1,0
20,163,163,21,21,0,1,0
11,164,164,30,27,3,2,1
12,171,171,6,3,3,2,1
23,182,182,8,8,0,1,0
31,210,210,13,13,0,1,0
28,217,217,9,9,0,1,0
22,224,224,1,1,0,1,0
27,236,236,56,28,28,3,2
13,247,247,18,18,0,1,0
30,266,266,25,25,0,1,0
10,278,278,7,7,0,1,0
25,288,288,2,2,0,1,0
29,299,299,37,37,0,1,0
0,316,316,9,9,0,1,0
18,325,325,16,5,11,2,1
7,327,327,1,1,0,1,0
19,341,341,21,21,0,1,0
1,350,350,16,16,0,1,0
6,361,361,7,7,0,1,0
17,362,362,56,43,13,2,1
2,371,371,8,2,6,3,2
9,396,396,19,4,15,4,3
15,408,408,35,32,3,2,1
14,426,426,29,16,13,2,1
5,442,442,94,94,0,1,0
8,447,447,20,2,18,3,2
3,458,458,23,23,0,1,0
4,468,468,51,51,0,1,0
21,494,494,81,33,48,4,3

2,101,101,13,7,6,3,2
6,119,119,9,9,0,1,0
12,128,128,32,6,26,2,1
4,143,143,16,16,0,1,0
27,177,177,9,9,0,1,0
14,199,199,4,1,3,2,1
13,203,203,14,6,8,2,1
21,206,206,2,2,0,1,0
5,212,212,42,42,0,1,0
20,224,224,8,8,0,1,0
1,254,254,14,4,10,3,2
3,260,260,21,21,0,1,0
19,294,294,10,2,8,2,1
17,295,295,34,34,0,1,0
24,317,317,4,4,0,1,0
18,319,319,87,87,0,1,0
25,335,335,46,46,0,1,0
22,348,348,3,3,0,1,0
23,370,370,68,48,20,2,1
7,381,381,4,4,0,1,0
28,396,396,108,67,41,2,1
8,413,413,3,3,0,1,0
9,422,422,24,3,21,4,3
11,430,430,6,6,0,1,0
16,452,452,74,74,0,1,0
15,463,463,10,3,7,2,1
0,467,467,38,38,0,1,0
26,470,470,12,2,10,2,1
10,488,488,59,59,0,1,0

14,120,120,13,1,12,2,1
17,120,120,4,1,3,2,1
0,149,149,25,25,0,1,0
5,171,171,13,13,0,1,0
8,178,178,105,98,7,2,1
6,202,202,4,4,0,1,0
4,207,207,2,2,0,1,0
22,225,225,38,14,24,3,2
16,227,227,18,10,8,3,2
11,247,247,42,11,31,2,1
13,255,255,18,12,6,2,1
20,271,271,3,3,0,1,0
1,287,287,44,10,34,2,1
15,307,307,10,10,0,1,0
9,313,313,18,4,14,3,2
21,355,355,1,1,0,1,0
7,361,361,8,8,0,1,0
3,393,393,7,7,0,1,0
23,396,396,114,114,0,1,0
2,418,418,31,19,12,3,2
19,429,429,3,3,0,1,0
18,484,484,82,52,30,4,3
10,490,490,55,17,38,2,1
12,496,496,89,11,78,4,3

17,103,103,14,2,12,2,1
2,154,154,17,17,0,1,0
6,193,193,13,13,0,1,0
7,222,222,11,11,0,1,0
12,247,247,23,1,22,3,2
4,262,262,8,8,0,1,0
16,262,262,6,6,0,1,0
11,269,269,46,21,25,2,1
0,275,275,75,75,0,1,0
20,302,302,92,23,69,4,3
19,337,337,28,1,27,2,1
22,355,355,82,38,44,3,2
18,365,365,17,13,4,2,1
21,377,377,14,6,8,3,2
10,384,384,8,8,0,1,0
15,405,405,37,22,15,2,1
3,408,408,62,62,0,1,0
5,424,424,130,55,75,4,3
8,437,437,110,110,0,1,0
13,444,444,14,5,9,2,1
1,465,465,18,18,0,1,0
9,473,473,10,10,0,1,0
14,495,495,23,3,20,2,1

9,104,104,2,2,0,1,0
19,108,108,2,2,0,1,0
18,114,114,19,19,0,1,0
24,120,120,17,17,0,1,0
21,121,121,5,1,4,2,1
25,122,122,7,7,0,1,0
26,153,153,16,16,0,1,0
17,204,204,6,6,0,1,0
0,220,220,1,1,0,1,0
11,230,230,29,26,3,2,1
7,242,242,15,5,10,3,2
23,263,263,13,3,10,2,1
15,270,270,95,80,15,2,1
22,271,271,32,32,0,1,0
13,287,287,37,19,18,4,3
6,323,323,13,10,3,2,1
4,365,365,9,3,6,3,2
5,368,368,82,12,70,3,2
16,409,409,21,11,10,3,2
1,415,415,22,11,11,2,1
2,452,452,5,5,0,1,0
3,462,462,37,21,16,2,1
14,475,475,2,2,0,1,0
20,479,479,93,35,58,3,2
10,480,480,5,5,0,1,0
8,480,480,117,73,44,3,2
12,481,481,132,64,68,3,2

28,103,103,23,12,11,2,1
16,105,105,1,1,0,1,0
20,111,111,9,9,0,1,0
22,124,124,15,3,12,3,2
18,165,165,20,20,0,1,0
2,183,183,6,6,0,1,0
8,186,186,6,6,0,1,0
26,189,189,12,12,0,1,0
13,238,238,14,14,0,1,0
6,244,244,46,7,39,2,1
3,246,246,21,9,12,3,2
25,256,256,21,3,18,4,3
1,267,267,12,3,9,2,1
21,284,284,35,35,0,1,0
5,304,304,32,5,27,4,3
9,313,313,13,4,9,2,1
4,325,325,40,40,0,1,0
30,331,331,8,8,0,1,0
12,349,349,24,12,12,3,2
11,349,349,23,7,16,3,2
29,351,351,36,3,33,4,3
24,359,359,1,1,0,1,0
31,367,367,53,53,0,1,0
27,386,386,42,38,4,2,1
17,388,388,10,1,9,4,3
19,389,389,71,71,0,1,0
15,406,406,7,1,6,2,1
23,424,424,30,30,0,1,0
14,452,452,96,66,30,2,1
7,467,467,1,1,0,1,0
0,486,486,30,30,0,1,0
10,495,495,3,3,0,1,0

22,105,105,4,4,0,1,0
28,106,106,19,19,0,1,0
9,115,115,7,7,0,1,0
13,148,148,12,12,0,1,0
26,176,176,16,6,10,3,2
24,179,179,63,52,11,2,1
21,185,185,33,33,0,1,0
27,196,196,14,2,12,4,3
17,210,210,16,16,0,1,0
3,233,233,12,1,11,2,1
4,254,254,18,18,0,1,0
16,264,264,1,1,0,1,0
6,267,267,16,13,3,2,1
8,285,285,1,1,0,1,0
5,320,320,12,12,0,1,0
14,326,326,87,66,21,2,1
1,337,337,16,6,10,2,1
15,338,338,12,12,0,1,0
19,341,341,6,6,0,1,0
23,345,345,21,4,17,2,1
0,400,400,72,53,19,2,1
29,406,406,11,11,0,1,0
20,419,419,45,12,33,4,3
10,442,442,73,73,0,1,0
18,449,449,59,16,43,3,2
7,449,449,8,5,3,2,1
25,477,477,1,1,0,1,0
12,480,480,15,9,6,2,1
11,486,486,89,48,41,3,2
2,490,490,3,3,0,1,0

13,101,101,12,3,9,2,1
4,121,121,34,10,24,3,2
29,121,121,4,4,0,1,0
6,177,177,5,5,0,1,0
9,217,217,9,9,0,1,0
17,221,221,11,11,0,1,0
5,234,234,9,9,0,1,0
11,234,234,4,4,0,1,0
30,237,237,34,15,19,2,1
24,250,250,57,26,31,2,1
25,261,261,8,8,0,1,0
0,300,300,23,23,0,1,0
23,302,302,4,4,0,1,0
7,318,318,13,3,10,2,1
3,335,335,6,6,0,1,0
10,336,336,25,25,0,1,0
14,343,343,8,8,0,1,0
12,344,344,16,16,0,1,0
15,344,344,19,10,9,4,3
22,360,360,28,5,23,2,1
19,378,378,10,4,6,2,1
1,386,386,21,10,11,2,1
28,392,392,16,16,0,1,0
21,392,392,38,23,15,2,1
27,396,396,1,1,0,1,0
2,421,421,8,5,3,2,1
31,427,427,58,58,0,1,0
16,427,427,27,27,0,1,0
18,482,482,107,107,0,1,0
26,485,485,211,150,61,4,3
20,491,491,31,31,0,1,0
8,499,499,16,1,15,2,1

20,107,107,14,14,0,1,0
0,115,115,11,11,0,1,0
9,116,116,4,4,0,1,0
14,131,131,37,10,27,2,1
15,135,135,7,7,0,1,0
5,172,172,95,20,75,4,3
10,194,194,33,4,29,2,1
1,204,204,2,2,0,1,0
7,207,207,11,2,9,2,1
11,217,217,4,4,0,1,0
19,218,218,31,31,0,1,0
3,233,233,33,23,10,2,1
4,255,255,30,8,22,2,1
13,310,310,24,24,0,1,0
6,319,319,76,76,0,1,0
8,376,376,9,9,0,1,0
12,407,407,15,15,0,1,0
21,452,452,11,4,7,3,2
18,461,461,41,32,9,2,1
17,478,478,97,10,87,4,3
2,479,479,33,33,0,1,0
16,487,487,35,35,0,1,0

4,102,102,14,2,12,3,2
6,108,108,2,2,0,1,0
20,112,112,15,15,0,1,0
5,121,121,4,4,0,1,0
24,131,131,10,2,8,2,1
11,150,150,49,6,43,2,1
23,157,157,3,3,0,1,0
12,163,163,4,4,0,1,0
1,177,177,11,7,4,2,1
10,180,180,4,4,0,1,0
16,196,196,20,20,0,1,0
19,205,205,12,7,5,2,1
25,239,239,28,28,0,1,0
8,250,250,40,13,27,2,1
18,291,291,5,5,0,1,0
2,304,304,46,46,0,1,0
21,309,309,10,4,6,3,2
13,311,311,5,5,0,1,0
3,362,362,21,15,6,2,1
14,365,365,15,15,0,1,0
0,380,380,4,4,0,1,0
17,421,421,38,34,4,2,1
9,425,425,11,11,0,1,0
7,430,430,38,2,36,2,1
26,443,443,77,35,42,4,3
28,471,471,9,9,0,1,0
15,479,479,60,43,17,3,2
27,487,487,184,184,0,1,0
22,492,492,55,55,0,1,0

7,120,120,2,2,0,1,0
3,121,121,5,5,0,1,0
17,126,126,27,27,0,1,0
20,160,160,3,3,0,1,0
24,171,171,27,27,0,1,0
1,228,228,28,5,23,2,1
2,232,232,16,7,9,2,1
22,248,248,9,9,0,1,0
14,254,254,18,18,0,1,0
8,266,266,4,4,0,1,0
18,336,336,35,35,0,1,0
25,350,350,76,64,12,4,3
15,354,354,27,7,20,2,1
12,356,356,33,33,0,1,0
11,392,392,85,23,62,3,2
6,432,432,17,17,0,1,0
4,433,433,14,1,13,2,1
16,434,434,67,67,0,1,0
5,449,449,98,95,3,2,1
23,453,453,43,43,0,1,0
9,466,466,76,76,0,1,0
21,468,468,6,3,3,2,1
19,480,480,23,14,9,2,1
13,495,495,61,33,28,3,2
10,498,498,31,31,0,1,0
0,498,498,106,106,0,1,0

0,137,137,12,12,0,1,0
1,145,145,22,2,20,2,1
14,150,150,5,5,0,1,0
21,161,161,14,14,0,1,0
18,194,194,39,39,0,1,0
12,202,202,6,6,0,1,0
20,218,218,61,61,0,1,0
15,226,226,12,12,0,1,0
3,235,235,87,87,0,1,0
7,254,254,8,2,6,3,2
23,261,261,25,25,0,1,0
8,280,280,32,17,15,2,1
11,286,286,8,2,6,3,2
19,290,290,24,24,0,1,0
2,350,350,3,3,0,1,0
17,356,356,62,62,0,1,0
4,396,396,43,43,0,1,0
13,404,404,4,4,0,1,0
22,436,436,10,10,0,1,0
10,437,437,3,3,0,1,0
5,455,455,20,4,16,3,2
16,472,472,108,34,74,3,2
9,479,479,32,32,0,1,0
6,482,482,150,138,12,2,1

5,112,112,5,5,0,1,0
18,116,116,7,7,0,1,0
9,116,116,8,8,0,1,0
14,117,117,22,22,0,1,0
19,149,149,33,5,28,2,1
17,159,159,7,7,0,1,0
7,167,167,41,23,18,2,1
13,205,205,9,9,0,1,0
11,212,212,12,12,0,1,0
6,222,222,72,39,33,2,1
12,228,228,26,2,24,4,3
20,252,252,39,39,0,1,0
0,258,258,37,13,24,2,1
2,259,259,2,2,0,1,0
3,270,270,94,44,50,2,1
4,353,353,7,7,0,1,0
1,372,372,63,36,27,4,3
8,410,410,107,38,69,4,3
16,467,467,4,1,3,2,1
10,476,476,42,42,0,1,0
15,499,499,6,6,0,1,0

12,125,125,3,3,0,1,0
22,126,126,22,22,0,1,0
13,133,133,5,5,0,1,0
25,138,138,1,1,0,1,0
14,154,154,3,3,0,1,0
8,158,158,5,5,0,1,0
15,170,170,6,6,0,1,0
2,206,206,1,1,0,1,0
6,215,215,1,1,0,1,0
27,221,221,45,23,22,2,1
20,231,231,2,2,0,1,0
29,246,246,13,13,0,1,0
21,264,264,11,11,0,1,0
19,274,274,123,123,0,1,0
17,276,276,32,32,0,1,0
10,280,280,11,2,9,2,1
0,311,311,44,26,18,2,1
11,328,328,93,73,20,4,3
9,350,350,43,43,0,1,0
28,351,351,9,9,0,1,0
30,368,368,13,7,6,3,2
3,375,375,3,3,0,1,0
5,376,376,1,1,0,1,0
23,381,381,24,24,0,1,0
7,400,400,109,25,84,3,2
16,401,401,24,24,0,1,0
4,432,432,10,4,6,3,2
1,448,448,34,34,0,1,0
18,450,450,77,47,30,4,3
24,482,482,8,8,0,1,0
26,485,485,40,40,0,1,0

25,108,108,3,3,0,1,0
6,111,111,9,1,8,2,1
21,114,114,3,3,0,1,0
18,135,135,34,34,0,1,0
9,142,142,15,6,9,2,1
19,166,166,12,3,9,4,3
8,179,179,1,1,0,1,0
12,184,184,15,8,7,2,1
14,206,206,1,1,0,1,0
15,211,211,9,4,5,2,1
26,216,216,27,27,0,1,0
3,222,222,44,44,0,1,0
24,248,248,31,15,16,2,1
17,255,255,24,1,23,2,1
2,259,259,55,55,0,1,0
23,262,262,36,36,0,1,0
0,270,270,14,14,0,1,0
5,285,285,6,6,0,1,0
27,287,287,21,9,12,4,3
7,323,323,65,65,0,1,0
16,344,344,27,14,13,2,1
1,382,382,16,16,0,1,0
20,387,387,64,20,44,4,3
11,389,389,47,47,0,1,0
28,396,396,51,39,12,4,3
4,397,397,27,22,5,2,1
22,407,407,10,1,9,2,1
13,417,417,25,25,0,1,0
10,461,461,3,3,0,1,0

1,102,102,1,1,0,1,0
3,109,109,14,14,0,1,0
2,115,115,18,18,0,1,0
21,125,125,8,8,0,1,0
9,143,143,1,1,0,1,0
13,159,159,8,8,0,1,0
5,161,161,6,2,4,2,1
14,216,216,6,1,5,2,1
7,251,251,52,52,0,1,0
10,301,301,27,22,5,2,1
8,310,310,31,16,15,2,1
0,322,322,26,26,0,1,0
16,340,340,1,1,0,1,0
11,343,343,9,4,5,2,1
22,361,361,139,111,28,2,1
17,363,363,2,2,0,1,0
6,390,390,8,3,5,2,1
12,438,438,95,18,77,3,2
23,445,445,27,21,6,2,1
18,450,450,2,2,0,1,0
20,453,453,17,17,0,1,0
4,470,470,219,99,120,4,3
15,475,475,73,73,0,1,0
19,476,476,137,119,18,3,2

20,135,135,3,3,0,1,0
6,149,149,4,4,0,1,0
7,169,169,10,1,9,2,1
13,178,178,2,2,0,1,0
3,195,195,26,26,0,1,0
18,229,229,16,16,0,1,0
21,232,232,50,17,33,4,3
22,263,263,20,10,10,2,1
16,266,266,9,9,0,1,0
5,285,285,14,14,0,1,0
1,312,312,44,44,0,1,0
23,339,339,6,2,4,2,1
8,366,366,30,30,0,1,0
0,397,397,32,32,0,1,0
24,409,409,229,157,72,4,3
12,415,415,149,117,32,2,1
9,428,428,56,56,0,1,0
2,435,435,16,2,14,2,1
19,440,440,53,53,0,1,0
25,452,452,35,1,34,2,1
15,464,464,6,6,0,1,0
11,474,474,30,30,0,1,0
17,481,481,31,31,0,1,0
14,486,486,19,19,0,1,0
4,491,491,56,56,0,1,0
10,492,492,12,12,0,1,0

14,102,102,6,6,0,1,0
6,127,127,15,15,0,1,0
1,142,142,5,2,3,2,1
8,187,187,12,6,6,3,2
19,199,199,29,29,0,1,0
11,214,214,33,7,26,4,3
12,225,225,30,19,11,2,1
17,235,235,3,3,0,1,0
3,238,238,28,1,27,2,1
7,238,238,2,2,0,1,0
10,240,240,16,16,0,1,0
16,352,352,41,41,0,1,0
5,354,354,24,24,0,1,0
20,366,366,137,113,24,4,3
15,374,374,13,13,0,1,0
9,387,387,24,24,0,1,0
18,410,410,10,1,9,4,3
0,452,452,102,102,0,1,0
2,469,469,223,181,42,4,3
13,485,485,43,8,35,2,1
4,492,492,125,91,34,2,1

24,106,106,12,4,8,2,1
0,125,125,3,3,0,1,0
12,160,160,2,2,0,1,0
19,173,173,16,7,9,4,3
33,176,176,3,3,0,1,0
22,183,183,22,16,6,2,1
1,184,184,12,12,0,1,0
18,185,185,8,5,3,2,1
17,196,196,2,2,0,1,0
2,198,198,19,19,0,1,0
5,199,199,24,6,18,2,1
28,204,204,51,10,41,2,1
11,205,205,21,21,0,1,0
26,238,238,5,5,0,1,0
10,262,262,1,1,0,1,0
3,267,267,3,3,0,1,0
15,270,270,12,12,0,1,0
16,270,270,2,2,0,1,0
32,273,273,1,1,0,1,0
13,290,290,7,7,0,1,0
31,293,293,18,10,8,2,1
7,308,308,7,7,0,1,0
8,317,317,12,12,0,1,0
34,333,333,32,32,0,1,0
21,354,354,76,76,0,1,0
14,357,357,41,41,0,1,0
23,421,421,34,34,0,1,0
27,422,422,52,52,0,1,0
6,439,439,56,8,48,2,1
9,450,450,2,2,0,1,0
29,458,458,40,22,18,2,1
4,468,468,37,5,32,3,2
20,481,481,20,20,0,1,0
30,492,492,35,35,0,1,0
25,499,499,139,111,28,2,1

6,115,115,24,24,0,1,0
12,153,153,5,1,4,2,1
0,168,168,12,1,11,2,1
10,179,179,5,1,4,2,1
2,208,208,8,8,0,1,0
18,242,242,63,42,21,4,3
3,267,267,50,50,0,1,0
9,267,267,56,56,0,1,0
8,268,268,9,2,7,2,1
13,269,269,2,2,0,1,0
19,273,273,11,11,0,1,0
11,314,314,64,6,58,3,2
23,320,320,36,36,0,1,0
24,337,337,49,49,0,1,0
21,339,339,22,22,0,1,0
4,339,339,9,2,7,2,1
17,352,352,42,3,39,4,3
16,369,369,8,3,5,2,1
22,371,371,32,32,0,1,0
1,400,400,103,74,29,2,1
14,431,431,52,52,0,1,0
20,446,446,8,8,0,1,0
15,450,450,129,129,0,1,0
7,490,490,1,1,0,1,0
5,490,490,17,17,0,1,0

24,110,110,11,1,10,3,2
7,114,114,1,1,0,1,0
3,123,123,21,15,6,2,1
6,128,128,3,3,0,1,0
15,166,166,7,7,0,1,0
12,166,166,17,17,0,1,0
13,188,188,20,20,0,1,0
0,190,190,22,22,0,1,0
21,193,193,4,1,3,2,1
17,201,201,61,39,22,2,1
9,210,210,14,14,0,1,0
26,226,226,11,11,0,1,0
18,241,241,8,2,6,2,1
4,254,254,17,17,0,1,0
22,307,307,20,20,0,1,0
8,311,311,36,36,0,1,0
20,318,318,37,37,0,1,0
19,323,323,98,89,9,2,1
23,332,332,65,1,64,3,2
14,342,342,24,24,0,1,0
2,357,357,36,4,32,3,2
10,368,368,39,7,32,2,1
25,379,379,13,13,0,1,0
27,400,400,7,7,0,1,0
11,414,414,68,36,32,2,1
16,441,441,20,12,8,3,2
5,446,446,7,7,0,1,0
1,463,463,31,31,0,1,0

5,116,116,18,10,8,3,2
4,123,123,21,9,12,4,3
1,132,132,1,1,0,1,0
7,143,143,5,5,0,1,0
17,152,152,5,5,0,1,0
18,159,159,31,12,19,4,3
19,187,187,10,3,7,2,1
2,199,199,44,44,0,1,0
13,222,222,30,15,15,2,1
21,264,264,5,5,0,1,0
16,280,280,12,12,0,1,0
15,284,284,2,2,0,1,0
9,311,311,87,32,55,3,2
6,325,325,35,35,0,1,0
11,334,334,12,12,0,1,0
20,351,351,7,7,0,1,0
12,359,359,40,40,0,1,0
0,367,367,85,19,66,3,2
3,368,368,9,3,6,2,1
10,384,384,144,72,72,3,2
14,410,410,6,3,3,2,1
8,420,420,146,146,0,1,0

9,133,133,2,2,0,1,0
16,138,138,3,3,0,1,0
13,152,152,42,42,0,1,0
15,158,158,84,64,20,3,2
0,175,175,13,13,0,1,0
21,186,186,11,11,0,1,0
11,196,196,2,2,0,1,0
12,220,220,10,1,9,4,3
18,255,255,19,15,4,2,1
6,260,260,107,31,76,3,2
5,279,279,78,10,68,3,2
2,283,283,10,5,5,2,1
10,347,347,51,45,6,2,1
3,366,366,3,3,0,1,0
14,391,391,19,19,0,1,0
17,392,392,17,17,0,1,0
20,398,398,10,10,0,1,0
4,410,410,90,76,14,2,1
7,420,420,17,17,0,1,0
1,426,426,54,38,16,3,2
19,452,452,16,16,0,1,0
8,488,488,51,33,18,4,3

20,101,101,1,1,0,1,0
15,109,109,12,2,10,3,2
8,126,126,1,1,0,1,0
4,136,136,1,1,0,1,0
0,142,142,6,6,0,1,0
14,167,167,6,6,0,1,0
18,172,172,13,4,9,2,1
5,195,195,19,19,0,1,0
1,210,210,10,10,0,1,0
11,218,218,24,24,0,1,0
19,231,231,8,5,3,2,1
12,239,239,1,1,0,1,0
3,242,242,32,20,12,2,1
21,254,254,8,8,0,1,0
13,266,266,3,3,0,1,0
16,281,281,49,9,40,4,3
22,296,296,79,79,0,1,0
6,311,311,146,33,113,4,3
24,337,337,21,21,0,1,0
23,363,363,15,15,0,1,0
17,384,384,5,2,3,2,1
25,412,412,159,114,45,3,2
9,421,421,2,2,0,1,0
7,433,433,39,35,4,2,1
10,457,457,71,71,0,1,0
26,462,462,39,24,15,2,1
2,499,499,60,11,49,4,3

24,106,106,12,12,0,1,0
4,160,160,17,5,12,3,2
18,188,188,60,6,54,3,2
17,207,207,47,47,0,1,0
11,217,217,1,1,0,1,0
21,233,233,24,8,16,3,2
23,240,240,11,3,8,3,2
22,257,257,5,5,0,1,0
20,278,278,78,54,24,3,2
2,318,318,42,42,0,1,0
25,327,327,5,5,0,1,0
16,329,329,9,9,0,1,0
14,343,343,34,23,11,2,1
12,350,350,89,89,0,1,0
1,374,374,20,20,0,1,0
3,384,384,11,6,5,2,1
7,387,387,61,55,6,2,1
26,394,394,8,8,0,1,0
5,401,401,55,19,36,2,1
19,416,416,36,6,30,4,3
8,424,424,56,23,33,3,2
15,425,425,13,5,8,2,1
13,426,426,51,3,48,3,2
0,432,432,20,20,0,1,0
27,448,448,17,17,0,1,0
9,471,471,1,1,0,1,0
6,473,473,12,6,6,2,1
10,495,495,1,1,0,1,0

1,109,109,7,4,3,2,1
23,127,127,11,1,10,3,2
30,155,155,7,7,0,1,0
5,159,159,2,2,0,1,0
16,172,172,9,9,0,1,0
7,180,180,6,2,4,2,1
15,181,181,3,3,0,1,0
17,189,189,2,2,0,1,0
18,190,190,8,8,0,1,0
9,195,195,1,1,0,1,0
22,198,198,1,1,0,1,0
34,206,206,15,15,0,1,0
26,215,215,19,13,6,3,2
4,312,312,13,13,0,1,0
32,312,312,31,31,0,1,0
11,316,316,15,7,8,2,1
10,329,329,1,1,0,1,0
38,338,338,18,10,8,2,1
0,339,339,56,8,48,3,2
25,346,346,50,9,41,3,2
29,352,352,85,16,69,4,3
33,373,373,33,27,6,3,2
31,389,389,53,29,24,2,1
36,391,391,29,29,0,1,0
37,392,392,69,69,0,1,0
21,406,406,54,54,0,1,0
19,407,407,8,3,5,2,1
35,411,411,70,33,37,2,1
6,415,415,13,13,0,1,0
12,426,426,29,18,11,4,3
20,429,429,28,28,0,1,0
13,433,433,68,43,25,2,1
28,457,457,8,8,0,1,0
14,469,469,9,9,0,1,0
24,472,472,20,7,13,3,2
3,474,474,4,1,3,2,1
2,475,475,12,5,7,3,2
27,483,483,29,11,18,3,2
8,488,488,1,1,0,1,0

18,117,117,28,10,18,4,3
24,119,119,24,24,0,1,0
4,140,140,3,3,0,1,0
11,211,211,2,2,0,1,0
9,213,213,7,2,5,2,1
2,230,230,5,5,0,1,0
12,240,240,32,5,27,2,1
0,246,246,15,15,0,1,0
8,267,267,54,54,0,1,0
3,294,294,14,14,0,1,0
25,301,301,14,8,6,2,1
6,312,312,31,16,15,4,3
17,323,323,41,13,28,3,2
5,350,350,8,8,0,1,0
20,356,356,15,15,0,1,0
27,357,357,13,3,10,2,1
21,366,366,9,9,0,1,0
10,371,371,17,17,0,1,0
28,376,376,24,20,4,2,1
22,394,394,52,52,0,1,0
23,400,400,19,19,0,1,0
15,402,402,82,45,37,3,2
13,422,422,141,128,13,2,1
7,424,424,19,19,0,1,0
26,432,432,50,7,43,2,1
14,459,459,9,9,0,1,0
1,462,462,1,1,0,1,0
16,476,476,82,3,79,4,3
19,497,497,41,26,15,2,1

15,112,112,35,19,16,3,2
3,114,114,47,19,28,3,2
20,120,120,1,1,0,1,0
4,132,132,16,7,9,4,3
21,151,151,20,17,3,2,1
16,163,163,10,10,0,1,0
13,178,178,19,10,9,3,2
7,195,195,3,3,0,1,0
10,216,216,13,13,0,1,0
8,232,232,1,1,0,1,0
23,246,246,26,26,0,1,0
6,247,247,35,35,0,1,0
18,250,250,7,4,3,2,1
14,262,262,26,26,0,1,0
9,263,263,21,5,16,2,1
17,314,314,1,1,0,1,0
0,353,353,39,39,0,1,0
11,373,373,21,21,0,1,0
22,375,375,36,27,9,2,1
1,424,424,69,69,0,1,0
24,443,443,68,24,44,3,2
5,456,456,12,12,0,1,0
19,465,465,72,72,0,1,0
2,466,466,51,51,0,1,0
12,477,477,35,18,17,2,1

10,143,143,12,12,0,1,0
2,158,158,48,48,0,1,0
12,170,170,2,2,0,1,0
15,173,173,8,8,0,1,0
22,182,182,20,20,0,1,0
16,221,221,9,1,8,3,2
6,234,234,26,26,0,1,0
19,237,237,60,32,28,2,1
13,249,249,19,19,0,1,0
20,249,249,7,7,0,1,0
7,299,299,23,4,19,4,3
5,300,300,4,1,3,2,1
9,302,302,56,39,17,2,1
1,352,352,30,30,0,1,0
18,369,369,16,6,10,2,1
17,370,370,144,18,126,4,3
11,376,376,3,3,0,1,0
3,398,398,18,18,0,1,0
14,401,401,74,74,0,1,0
0,414,414,157,103,54,4,3
8,425,425,40,1,39,4,3
21,451,451,24,24,0,1,0
4,490,490,4,4,0,1,0

10,141,141,13,8,5,2,1
22,179,179,29,2,27,3,2
25,203,203,26,26,0,1,0
8,222,222,10,3,7,2,1
4,267,267,5,5,0,1,0
9,275,275,1,1,0,1,0
14,276,276,20,14,6,3,2
1,311,311,57,57,0,1,0
15,314,314,114,84,30,4,3
6,322,322,41,41,0,1,0
13,333,333,21,7,14,3,2
11,339,339,56,6,50,2,1
21,344,344,38,8,30,3,2
18,358,358,41,38,3,2,1
12,361,361,30,26,4,2,1
17,371,371,31,26,5,2,1
7,378,378,33,8,25,4,3
23,402,402,60,27,33,4,3
24,414,414,20,8,12,3,2
2,437,437,85,85,0,1,0
20,443,443,4,4,0,1,0
0,454,454,42,9,33,4,3
19,456,456,1,1,0,1,0
16,486,486,7,3,4,2,1
5,490,490,80,80,0,1,0
3,500,500,23,23,0,1,0

14,110,110,4,4,0,1,0
9,135,135,41,23,18,4,3
11,142,142,4,4,0,1,0
15,154,154,16,16,0,1,0
3,166,166,10,10,0,1,0
0,187,187,7,1,6,2,1
17,207,207,26,26,0,1,0
2,235,235,7,7,0,1,0
6,263,263,5,5,0,1,0
19,283,283,5,5,0,1,0
23,286,286,1,1,0,1,0
18,288,288,25,11,14,2,1
5,327,327,6,6,0,1,0
16,336,336,50,4,46,3,2
20,338,338,18,1,17,2,1
12,350,350,59,59,0,1,0
1,359,359,63,18,45,4,3
24,361,361,54,31,23,2,1
21,396,396,24,1,23,2,1
4,407,407,16,9,7,2,1
13,426,426,93,93,0,1,0
8,452,452,73,29,44,3,2
7,456,456,62,2,60,4,3
22,484,484,76,76,0,1,0
10,498,498,147,147,0,1,0

8,103,103,1,1,0,1,0
20,105,105,2,2,0,1,0
6,115,115,4,1,3,2,1
23,122,122,5,5,0,1,0
14,129,129,2,2,0,1,0
5,171,171,7,7,0,1,0
18,180,180,6,6,0,1,0
4,188,188,26,8,18,4,3
19,199,199,20,6,14,3,2
15,229,229,8,8,0,1,0
25,238,238,17,1,16,2,1
0,242,242,26,18,8,3,2
26,249,249,36,14,22,3,2
24,259,259,7,3,4,2,1
21,274,274,51,51,0,1,0
1,287,287,33,8,25,2,1
11,314,314,39,9,30,2,1
22,318,318,12,12,0,1,0
3,330,330,18,18,0,1,0
13,338,338,18,18,0,1,0
9,364,364,26,7,19,2,1
10,365,365,8,8,0,1,0
16,366,366,106,31,75,4,3
28,395,395,98,42,56,4,3
27,397,397,58,58,0,1,0
29,430,430,36,23,13,2,1
2,475,475,3,3,0,1,0
17,487,487,91,77,14,2,1
7,493,493,70,70,0,1,0
12,500,500,21,21,0,1,0

36,105,105,6,6,0,1,0
30,108,108,11,3,8,3,2
13,113,113,1,1,0,1,0
3,121,121,20,20,0,1,0
25,129,129,7,7,0,1,0
23,142,142,13,13,0,1,0
29,170,170,9,9,0,1,0
1,185,185,1,1,0,1,0
34,198,198,57,15,42,3,2
39,215,215,19,5,14,3,2
17,221,221,13,4,9,4,3
31,232,232,48,8,40,2,1
10,238,238,7,7,0,1,0
28,265,265,17,1,16,3,2
8,266,266,1,1,0,1,0
0,267,267,4,4,0,1,0
7,323,323,19,7,12,3,2
6,346,346,1,1,0,1,0
33,350,350,47,47,0,1,0
27,356,356,56,56,0,1,0
12,358,358,15,15,0,1,0
24,364,364,4,4,0,1,0
14,367,367,9,9,0,1,0
5,376,376,50,50,0,1,0
15,386,386,12,9,3,2,1
32,387,387,37,21,16,4,3
4,388,388,8,8,0,1,0
18,390,390,3,3,0,1,0
21,396,396,11,3,8,2,1
2,409,409,88,12,76,4,3
26,415,415,5,2,3,2,1
11,436,436,29,29,0,1,0
16,438,438,58,58,0,1,0
9,451,451,26,10,16,3,2
38,460,460,11,1,10,2,1
19,463,463,4,4,0,1,0
20,464,464,7,3,4,2,1
35,477,477,1,1,0,1,0
22,489,489,1,1,0,1,0
37,491,491,25,16,9,2,1

24,114,114,4,4,0,1,0
7,117,117,4,4,0,1,0
11,153,153,7,2,5,2,1
16,178,178,14,14,0,1,0
6,188,188,52,52,0,1,0
9,201,201,1,1,0,1,0
4,203,203,9,9,0,1,0
18,240,240,2,2,0,1,0
30,241,241,21,21,0,1,0
28,252,252,15,5,10,3,2
20,259,259,42,7,35,2,1
2,275,275,3,3,0,1,0
22,305,305,47,25,22,3,2
3,326,326,14,14,0,1,0
23,336,336,21,3,18,3,2
21,338,338,53,53,0,1,0
29,339,339,32,2,30,4,3
26,342,342,21,9,12,2,1
13,356,356,17,17,0,1,0
14,376,376,1,1,0,1,0
8,401,401,86,86,0,1,0
5,415,415,148,112,36,3,2
0,421,421,30,13,17,2,1
1,442,442,17,5,12,4,3
25,443,443,29,29,0,1,0
19,445,445,89,89,0,1,0
10,449,449,5,5,0,1,0
27,453,453,81,21,60,3,2
12,457,457,4,1,3,2,1
17,475,475,5,5,0,1,0
15,479,479,1,1,0,1,0

5,101,101,10,10,0,1,0
21,129,129,40,24,16,3,2
8,136,136,1,1,0,1,0
6,173,173,41,4,37,2,1
17,203,203,9,9,0,1,0
2,223,223,9,9,0,1,0
16,229,229,35,35,0,1,0
20,232,232,14,3,11,2,1
4,241,241,147,76,71,4,3
22,256,256,26,14,12,4,3
15,265,265,22,4,18,2,1
9,266,266,16,8,8,2,1
0,341,341,23,23,0,1,0
18,365,365,37,37,0,1,0
1,372,372,1,1,0,1,0
12,374,374,38,38,0,1,0
19,392,392,82,82,0,1,0
10,401,401,37,6,31,2,1
14,451,451,19,19,0,1,0
11,454,454,1,1,0,1,0
13,481,481,12,12,0,1,0
7,484,484,15,15,0,1,0
3,485,485,71,61,10,2,1

20,102,102,6,6,0,1,0
1,108,108,27,27,0,1,0
21,118,118,2,2,0,1,0
23,139,139,2,2,0,1,0
24,195,195,3,3,0,1,0
22,198,198,69,69,0,1,0
18,200,200,35,1,34,3,2
8,201,201,14,14,0,1,0
9,218,218,11,11,0,1,0
4,223,223,10,10,0,1,0
7,225,225,1,1,0,1,0
15,228,228,10,10,0,1,0
0,234,234,15,15,0,1,0
13,249,249,41,7,34,3,2
19,260,260,6,6,0,1,0
3,293,293,13,13,0,1,0
10,302,302,5,1,4,2,1
11,316,316,6,6,0,1,0
2,317,317,23,2,21,2,1
6,317,317,136,106,30,4,3
17,371,371,48,48,0,1,0
5,396,396,3,3,0,1,0
16,406,406,56,8,48,2,1
14,410,410,1,1,0,1,0
25,416,416,87,51,36,4,3
26,471,471,74,74,0,1,0
12,491,491,31,1,30,4,3

6,128,128,22,4,18,4,3
18,144,144,7,7,0,1,0
13,158,158,35,35,0,1,0
8,190,190,27,15,12,4,3
12,212,212,10,10,0,1,0
22,213,213,9,9,0,1,0
21,222,222,1,1,0,1,0
7,222,222,15,15,0,1,0
15,228,228,10,2,8,2,1
3,243,243,34,34,0,1,0
19,262,262,52,39,13,2,1
0,273,273,4,4,0,1,0
23,285,285,3,3,0,1,0
5,310,310,71,28,43,3,2
1,316,316,89,32,57,4,3
16,323,323,8,8,0,1,0
20,326,326,31,2,29,2,1
11,333,333,55,55,0,1,0
14,371,371,157,55,102,4,3
10,392,392,2,2,0,1,0
4,398,398,43,32,11,2,1
17,413,413,2,2,0,1,0
2,446,446,47,47,0,1,0
9,449,449,16,16,0,1,0

1,101,101,13,13,0,1,0
2,114,114,16,16,0,1,0
7,123,123,6,6,0,1,0
10,126,126,20,20,0,1,0
17,181,181,6,6,0,1,0
6,203,203,1,1,0,1,0
21,215,215,7,1,6,3,2
20,245,245,17,17,0,1,0
5,250,250,1,1,0,1,0
12,266,266,24,6,18,4,3
11,266,266,9,3,6,2,1
23,281,281,81,15,66,3,2
4,283,283,59,59,0,1,0
22,291,291,14,14,0,1,0
16,292,292,7,7,0,1,0
19,299,299,20,10,10,2,1
15,302,302,6,6,0,1,0
0,307,307,62,19,43,2,1
3,309,309,30,30,0,1,0
18,318,318,105,93,12,4,3
13,323,323,1,1,0,1,0
28,327,327,20,5,15,2,1
14,328,328,4,4,0,1,0
8,344,344,16,16,0,1,0
9,361,361,37,17,20,2,1
25,392,392,65,45,20,2,1
26,404,404,37,37,0,1,0
24,410,410,19,19,0,1,0
27,466,466,29,21,8,2,1

1,102,102,13,13,0,1,0
2,137,137,7,4,3,2,1
6,137,137,32,32,0,1,0
14,157,157,22,19,3,2,1
5,160,160,2,2,0,1,0
7,163,163,37,37,0,1,0
25,164,164,4,4,0,1,0
4,195,195,33,33,0,1,0
16,227,227,12,2,10,2,1
26,265,265,21,12,9,2,1
15,266,266,40,40,0,1,0
19,274,274,46,36,10,3,2
17,281,281,16,16,0,1,0
11,301,301,17,17,0,1,0
9,309,309,32,32,0,1,0
10,322,322,43,27,16,2,1
3,338,338,3,3,0,1,0
0,342,342,24,12,12,4,3
24,342,342,78,21,57,4,3
21,370,370,48,48,0,1,0
8,382,382,9,1,8,2,1
23,391,391,2,2,0,1,0
20,434,434,6,1,5,2,1
13,452,452,21,9,12,2,1
22,457,457,45,39,6,3,2
12,461,461,17,17,0,1,0
18,475,475,84,84,0,1,0

11,156,156,23,23,0,1,0
17,175,175,9,1,8,3,2
10,185,185,7,7,0,1,0
7,253,253,66,40,26,2,1
2,270,270,22,22,0,1,0
16,274,274,55,55,0,1,0
19,277,277,20,2,18,3,2
4,282,282,120,97,23,4,3
1,345,345,14,1,13,2,1
21,346,346,32,32,0,1,0
8,362,362,12,12,0,1,0
20,373,373,2,2,0,1,0
18,377,377,62,58,4,2,1
6,384,384,33,27,6,2,1
9,401,401,52,25,27,4,3
15,408,408,5,5,0,1,0
5,416,416,103,4,99,4,3
3,433,433,49,49,0,1,0
12,439,439,120,101,19,2,1
13,461,461,22,4,18,4,3
14,462,462,38,38,0,1,0
0,500,500,7,3,4,2,1

21,113,113,22,22,0,1,0
11,127,127,6,6,0,1,0
15,137,137,18,18,0,1,0
13,141,141,37,37,0,1,0
3,152,152,13,13,0,1,0
0,166,166,1,1,0,1,0
22,179,179,31,31,0,1,0
24,186,186,4,1,3,2,1
19,187,187,26,26,0,1,0
14,201,201,1,1,0,1,0
17,216,216,29,23,6,2,1
4,255,255,21,7,14,3,2
7,275,275,60,10,50,3,2
20,297,297,8,4,4,2,1
6,317,317,10,10,0,1,0
12,326,326,31,31,0,1,0
18,327,327,9,9,0,1,0
9,349,349,49,41,8,3,2
5,366,366,15,15,0,1,0
8,374,374,15,5,10,3,2
1,377,377,93,93,0,1,0
23,382,382,40,8,32,3,2
2,409,409,11,5,6,2,1
16,411,411,11,11,0,1,0
10,485,485,165,61,104,4,3

22,104,104,6,6,0,1,0
18,111,111,6,6,0,1,0
10,113,113,1,1,0,1,0
0,114,114,20,20,0,1,0
8,125,125,7,7,0,1,0
12,127,127,1,1,0,1,0
3,141,141,13,13,0,1,0
5,148,148,12,12,0,1,0
21,157,157,20,20,0,1,0
26,165,165,4,4,0,1,0
20,183,183,28,16,12,4,3
6,268,268,1,1,0,1,0
11,269,269,34,2,32,3,2
13,289,289,12,1,11,3,2
7,324,324,23,23,0,1,0
16,334,334,94,94,0,1,0
4,338,338,16,4,12,4,3
9,347,347,12,4,8,2,1
17,362,362,40,40,0,1,0
19,390,390,24,24,0,1,0
2,397,397,139,25,114,4,3
1,402,402,83,39,44,3,2
15,419,419,40,10,30,4,3
25,441,441,40,40,0,1,0
23,454,454,52,52,0,1,0
14,495,495,27,27,0,1,0
24,497,497,53,53,0,1,0

21,139,139,10,10,0,1,0
9,150,150,14,14,0,1,0
12,167,167,9,9,0,1,0
4,172,172,15,7,8,2,1
25,185,185,5,5,0,1,0
5,213,213,22,22,0,1,0
23,225,225,5,5,0,1,0
2,231,231,7,4,3,2,1
19,248,248,21,2,19,2,1
11,259,259,30,5,25,2,1
24,278,278,29,29,0,1,0
1,281,281,50,42,8,3,2
0,284,284,14,2,12,3,2
3,296,296,2,2,0,1,0
8,307,307,1,1,0,1,0
16,309,309,8,2,6,2,1
7,324,324,99,64,35,2,1
6,335,335,48,36,12,4,3
20,372,372,20,20,0,1,0
14,434,434,45,45,0,1,0
18,436,436,112,18,94,3,2
13,443,443,5,5,0,1,0
22,464,464,219,207,12,2,1
10,475,475,63,63,0,1,0
17,482,482,31,26,5,2,1
15,487,487,9,9,0,1,0

2,101,101,5,5,0,1,0
18,165,165,6,2,4,2,1
6,174,174,1,1,0,1,0
7,186,186,21,21,0,1,0
10,204,204,26,6,20,2,1
12,213,213,6,6,0,1,0
22,243,243,60,60,0,1,0
17,246,246,37,37,0,1,0
11,264,264,35,11,24,3,2
8,282,282,52,52,0,1,0
0,289,289,74,53,21,2,1
9,297,297,2,2,0,1,0
13,342,342,13,13,0,1,0
23,348,348,90,3,87,4,3
24,381,381,26,26,0,1,0
15,387,387,38,2,36,3,2
4,393,393,38,38,0,1,0
21,396,396,27,27,0,1,0
5,403,403,69,65,4,2,1
3,424,424,54,54,0,1,0
14,431,431,19,5,14,2,1
19,442,442,70,70,0,1,0
20,444,444,18,18,0,1,0
16,451,451,38,38,0,1,0
1,492,492,15,7,8,2,1

24,107,107,4,1,3,2,1
14,121,121,27,1,26,2,1
16,124,124,1,1,0,1,0
7,127,127,8,8,0,1,0
22,129,129,11,3,8,2,1
17,136,136,25,2,23,2,1
28,170,170,21,21,0,1,0
18,172,172,3,3,0,1,0
13,178,178,23,23,0,1,0
25,217,217,55,55,0,1,0
15,223,223,1,1,0,1,0
20,230,230,3,3,0,1,0
26,235,235,8,5,3,2,1
2,238,238,8,8,0,1,0
1,246,246,1,1,0,1,0
12,264,264,22,11,11,2,1
10,306,306,13,8,5,2,1
23,317,317,13,13,0,1,0
5,321,321,39,39,0,1,0
4,360,360,30,30,0,1,0
11,409,409,58,29,29,4,3
19,417,417,122,82,40,3,2
6,438,438,101,63,38,3,2
3,438,438,3,3,0,1,0
0,439,439,24,24,0,1,0
29,447,447,80,80,0,1,0
9,456,456,21,1,20,3,2
27,463,463,3,3,0,1,0
21,476,476,31,21,10,3,2
8,486,486,12,12,0,1,0

11,100,100,14,14,0,1,0
25,120,120,5,5,0,1,0
28,136,136,2,2,0,1,0
8,146,146,12,7,5,2,1
0,161,161,1,1,0,1,0
7,172,172,23,17,6,3,2
27,193,193,1,1,0,1,0
2,197,197,24,24,0,1,0
14,200,200,7,7,0,1,0
5,216,216,4,4,0,1,0
20,217,217,26,26,0,1,0
15,250,250,11,11,0,1,0
22,258,258,53,53,0,1,0
17,289,289,1,1,0,1,0
19,304,304,45,45,0,1,0
13,306,306,11,2,9,2,1
9,321,321,49,29,20,3,2
1,337,337,7,1,6,3,2
12,348,348,1,1,0,1,0
16,361,361,8,8,0,1,0
3,371,371,8,8,0,1,0
24,407,407,4,1,3,2,1
23,413,413,82,66,16,2,1
6,417,417,112,112,0,1,0
26,434,434,69,62,7,2,1
10,441,441,46,13,33,2,1
21,486,486,60,60,0,1,0
18,489,489,135,84,51,4,3
4,492,492,56,18,38,3,2

12,112,112,4,4,0,1,0
8,125,125,5,5,0,1,0
21,127,127,7,7,0,1,0
7,128,128,6,6,0,1,0
14,133,133,9,9,0,1,0
11,136,136,34,34,0,1,0
28,137,137,23,1,22,3,2
1,163,163,11,11,0,1,0
31,176,176,4,4,0,1,0
19,186,186,10,4,6,3,2
23,199,199,20,10,10,2,1
26,209,209,28,2,26,2,1
4,237,237,19,19,0,1,0
17,242,242,1,1,0,1,0
16,243,243,23,23,0,1,0
0,246,246,12,12,0,1,0
20,257,257,48,48,0,1,0
15,276,276,19,4,15,3,2
2,282,282,49,28,21,4,3
3,304,304,2,2,0,1,0
9,316,316,12,12,0,1,0
6,335,335,1,1,0,1,0
5,343,343,26,8,18,4,3
30,346,346,52,52,0,1,0
32,358,358,28,12,16,2,1
27,368,368,15,15,0,1,0
22,383,383,11,5,6,3,2
25,384,384,50,15,35,2,1
18,451,451,7,7,0,1,0
24,466,466,95,73,22,3,2
13,469,469,20,20,0,1,0
29,469,469,15,3,12,4,3
10,475,475,43,43,0,1,0

8,144,144,6,6,0,1,0
18,144,144,27,4,23,2,1
6,145,145,11,11,0,1,0
21,145,145,24,24,0,1,0
15,160,160,28,10,18,4,3
23,161,161,2,2,0,1,0
19,166,166,4,4,0,1,0
5,172,172,9,9,0,1,0
4,195,195,7,2,5,2,1
12,222,222,38,12,26,3,2
20,243,243,30,30,0,1,0
22,256,256,6,1,5,2,1
0,265,265,29,4,25,2,1
9,267,267,10,10,0,1,0
1,304,304,25,25,0,1,0
25,345,345,2,2,0,1,0
16,379,379,5,5,0,1,0
7,384,384,36,36,0,1,0
11,393,393,116,105,11,2,1
26,413,413,4,4,0,1,0
17,442,442,67,43,24,2,1
24,443,443,92,92,0,1,0
13,469,469,20,14,6,2,1
2,488,488,14,11,3,2,1
14,495,495,113,113,0,1,0
3,495,495,85,13,72,3,2
10,500,500,31,4,27,3,2

10,126,126,41,41,0,1,0
12,135,135,27,7,20,2,1
5,150,150,35,35,0,1,0
9,156,156,7,7,0,1,0
7,175,175,2,2,0,1,0
20,180,180,10,1,9,2,1
2,184,184,29,29,0,1,0
14,187,187,20,6,14,2,1
22,196,196,1,1,0,1,0
3,202,202,2,2,0,1,0
11,206,206,3,3,0,1,0
21,210,210,73,73,0,1,0
18,227,227,6,6,0,1,0
19,268,268,20,16,4,2,1
4,279,279,7,1,6,3,2
17,286,286,4,4,0,1,0
24,337,337,103,103,0,1,0
23,342,342,13,13,0,1,0
13,370,370,23,11,12,3,2
15,389,389,36,20,16,2,1
1,397,397,26,22,4,2,1
8,398,398,136,98,38,3,2
6,409,409,1,1,0,1,0
0,430,430,30,30,0,1,0
16,435,435,1,1,0,1,0

7,110,110,13,13,0,1,0
5,112,112,7,7,0,1,0
12,121,121,22,2,20,2,1
14,131,131,1,1,0,1,0
0,172,172,13,13,0,1,0
18,187,187,83,55,28,3,2
20,195,195,15,1,14,3,2
4,203,203,2,2,0,1,0
17,204,204,6,6,0,1,0
26,205,205,5,5,0,1,0
19,212,212,10,2,8,3,2
3,231,231,37,10,27,2,1
9,235,235,5,5,0,1,0
25,239,239,5,1,4,2,1
1,240,240,2,2,0,1,0
28,250,250,2,2,0,1,0
21,262,262,2,2,0,1,0
2,278,278,2,2,0,1,0
23,282,282,69,27,42,4,3
22,287,287,57,57,0,1,0
27,314,314,17,13,4,2,1
10,367,367,28,16,12,2,1
11,393,393,42,36,6,2,1
6,395,395,11,11,0,1,0
24,406,406,46,46,0,1,0
16,407,407,24,24,0,1,0
13,409,409,59,59,0,1,0
8,443,443,126,126,0,1,0
15,491,491,4,4,0,1,0

13,103,103,1,1,0,1,0
14,129,129,9,3,6,2,1
0,130,130,22,22,0,1,0
6,160,160,43,43,0,1,0
12,161,161,31,1,30,4,3
19,190,190,41,2,39,2,1
9,200,200,20,9,11,4,3
21,219,219,6,3,3,2,1
8,235,235,30,30,0,1,0
17,235,235,36,36,0,1,0
15,258,258,13,13,0,1,0
4,270,270,83,83,0,1,0
22,281,281,48,48,0,1,0
2,290,290,1,1,0,1,0
3,304,304,7,7,0,1,0
18,335,335,64,16,48,4,3
20,347,347,22,14,8,3,2
5,365,365,24,24,0,1,0
7,376,376,63,36,27,2,1
11,377,377,10,10,0,1,0
16,441,441,52,52,0,1,0
1,446,446,30,21,9,4,3
10,484,484,19,9,10,2,1

18,117,117,1,1,0,1,0
4,118,118,4,1,3,2,1
8,151,151,11,11,0,1,0
19,174,174,2,2,0,1,0
5,196,196,6,1,5,2,1
24,198,198,9,9,0,1,0
23,200,200,1,1,0,1,0
30,204,204,4,4,0,1,0
7,228,228,35,35,0,1,0
22,230,230,10,10,0,1,0
17,242,242,25,25,0,1,0
11,245,245,23,6,17,2,1
25,247,247,84,84,0,1,0
9,254,254,36,9,27,4,3
6,269,269,9,9,0,1,0
27,273,273,19,1,18,3,2
26,313,313,11,2,9,2,1
1,318,318,72,72,0,1,0
32,320,320,39,32,7,2,1
21,340,340,15,3,12,3,2
16,371,371,18,3,15,4,3
29,376,376,106,92,14,2,1
10,387,387,14,1,13,2,1
28,420,420,17,1,16,2,1
3,424,424,18,18,0,1,0
15,426,426,12,12,0,1,0
13,428,428,18,18,0,1,0
20,432,432,97,77,20,3,2
14,437,437,6,1,5,2,1
12,464,464,72,16,56,3,2
2,470,470,13,13,0,1,0
31,478,478,27,27,0,1,0
0,486,486,1,1,0,1,0

18,103,103,8,8,0,1,0
19,151,151,9,9,0,1,0
12,189,189,20,20,0,1,0
11,220,220,6,2,4,2,1
16,224,224,31,24,7,2,1
3,284,284,10,10,0,1,0
22,300,300,66,66,0,1,0
6,305,305,7,2,5,2,1
4,314,314,18,15,3,2,1
21,319,319,49,49,0,1,0
10,320,320,26,11,15,2,1
9,324,324,23,23,0,1,0
13,324,324,12,12,0,1,0
15,342,342,5,5,0,1,0
2,366,366,55,22,33,3,2
7,368,368,27,23,4,2,1
23,388,388,120,3,117,4,3
8,400,400,1,1,0,1,0
0,401,401,13,13,0,1,0
1,412,412,5,2,3,2,1
17,427,427,37,37,0,1,0
5,428,428,326,308,18,4,3
20,476,476,8,3,5,2,1
14,480,480,41,41,0,1,0

14,106,106,14,8,6,3,2
13,121,121,36,36,0,1,0
5,147,147,1,1,0,1,0
10,161,161,3,3,0,1,0
19,168,168,8,8,0,1,0
4,173,173,36,27,9,4,3
3,176,176,1,1,0,1,0
22,242,242,28,16,12,2,1
9,243,243,29,5,24,3,2
1,245,245,107,53,54,3,2
8,248,248,30,1,29,4,3
17,307,307,22,8,14,3,2
21,386,386,31,31,0,1,0
18,399,399,7,1,6,2,1
12,400,400,33,21,12,4,3
20,419,419,17,2,15,4,3
7,428,428,37,37,0,1,0
0,439,439,35,35,0,1,0
16,440,440,65,26,39,4,3
11,452,452,32,12,20,2,1
2,455,455,90,34,56,4,3
15,456,456,99,51,48,2,1
6,495,495,21,21,0,1,0

17,109,109,6,6,0,1,0
9,116,116,12,12,0,1,0
29,121,121,1,1,0,1,0
28,161,161,2,2,0,1,0
23,185,185,2,2,0,1,0
30,188,188,18,18,0,1,0
24,188,188,24,6,18,3,2
5,198,198,33,16,17,2,1
31,214,214,22,6,16,3,2
18,215,215,12,1,11,2,1
0,225,225,9,9,0,1,0
7,257,257,22,15,7,2,1
16,261,261,1,1,0,1,0
1,290,290,39,6,33,3,2
11,293,293,1,1,0,1,0
21,295,295,43,34,9,2,1
3,324,324,23,1,22,3,2
2,329,329,13,6,7,2,1
6,338,338,3,3,0,1,0
10,340,340,19,19,0,1,0
8,366,366,10,3,7,2,1
13,380,380,16,16,0,1,0
22,393,393,34,34,0,1,0
4,412,412,1,1,0,1,0
25,412,412,23,23,0,1,0
20,419,419,128,11,117,4,3
26,423,423,79,1,78,4,3
14,440,440,116,116,0,1,0
19,441,441,66,66,0,1,0
12,452,452,14,14,0,1,0
27,474,474,16,4,12,2,1
15,484,484,55,19,36,4,3

9,115,115,8,8,0,1,0
7,117,117,21,21,0,1,0
18,122,122,14,14,0,1,0
11,130,130,2,2,0,1,0
12,143,143,14,14,0,1,0
17,146,146,5,5,0,1,0
2,165,165,25,25,0,1,0
1,203,203,16,11,5,2,1
21,207,207,10,10,0,1,0
19,211,211,26,21,5,2,1
16,236,236,21,21,0,1,0
10,238,238,9,9,0,1,0
24,276,276,14,14,0,1,0
0,281,281,48,48,0,1,0
13,292,292,55,55,0,1,0
20,300,300,5,5,0,1,0
3,334,334,17,17,0,1,0
22,334,334,65,37,28,2,1
25,341,341,62,54,8,3,2
15,347,347,40,28,12,2,1
8,349,349,56,46,10,2,1
14,355,355,107,57,50,2,1
6,383,383,14,14,0,1,0
5,388,388,14,14,0,1,0
23,429,429,7,2,5,2,1
4,450,450,12,7,5,2,1
26,473,473,24,24,0,1,0

11,101,101,10,4,6,2,1
27,106,106,28,28,0,1,0
1,149,149,54,54,0,1,0
5,162,162,1,1,0,1,0
9,179,179,27,27,0,1,0
8,183,183,16,16,0,1,0
15,200,200,41,41,0,1,0
13,214,214,13,8,5,2,1
16,225,225,13,13,0,1,0
23,237,237,14,14,0,1,0
22,250,250,38,19,19,2,1
4,259,259,6,1,5,2,1
7,263,263,19,19,0,1,0
12,273,273,72,8,64,3,2
18,291,291,7,7,0,1,0
26,321,321,44,29,15,2,1
25,325,325,26,4,22,2,1
24,344,344,54,54,0,1,0
2,362,362,11,1,10,3,2
21,375,375,5,5,0,1,0
14,387,387,24,1,23,3,2
19,409,409,17,17,0,1,0
0,425,425,22,2,20,2,1
6,429,429,4,4,0,1,0
17,461,461,14,14,0,1,0
3,480,480,10,10,0,1,0
20,482,482,48,48,0,1,0
10,499,499,1,1,0,1,0

7,127,127,46,25,21,2,1
11,148,148,3,3,0,1,0
18,155,155,7,7,0,1,0
4,166,166,1,1,0,1,0
19,169,169,10,10,0,1,0
16,169,169,1,1,0,1,0
9,180,180,1,1,0,1,0
2,251,251,13,13,0,1,0
27,272,272,23,23,0,1,0
8,288,288,19,19,0,1,0
23,328,328,3,3,0,1,0
25,353,353,13,13,0,1,0
10,355,355,5,5,0,1,0
13,362,362,61,49,12,2,1
20,370,370,6,3,3,2,1
26,381,381,32,14,18,2,1
15,396,396,97,67,30,4,3
24,409,409,119,86,33,2,1
3,411,411,19,5,14,2,1
0,425,425,50,50,0,1,0
12,426,426,1,1,0,1,0
1,427,427,72,72,0,1,0
17,437,437,16,3,13,2,1
14,456,456,98,48,50,3,2
6,457,457,10,4,6,3,2
21,485,485,92,72,20,2,1
5,487,487,17,5,12,2,1
22,492,492,105,105,0,1,0

27,105,105,8,3,5,2,1
22,105,105,1,1,0,1,0
2,132,132,36,3,33,2,1
13,155,155,13,3,10,3,2
16,181,181,4,4,0,1,0
23,184,184,22,22,0,1,0
6,188,188,5,5,0,1,0
25,191,191,23,12,11,2,1
17,210,210,3,3,0,1,0
10,218,218,37,37,0,1,0
20,230,230,31,1,30,2,1
26,238,238,22,22,0,1,0
21,279,279,32,32,0,1,0
5,335,335,4,1,3,2,1
18,357,357,66,66,0,1,0
11,364,364,16,8,8,3,2
14,379,379,17,17,0,1,0
12,381,381,43,1,42,2,1
9,381,381,10,10,0,1,0
4,390,390,10,10,0,1,0
24,405,405,65,65,0,1,0
28,408,408,70,14,56,3,2
7,412,412,22,22,0,1,0
19,443,443,54,22,32,3,2
0,444,444,50,38,12,3,2
1,446,446,67,67,0,1,0
3,454,454,5,5,0,1,0
15,470,470,64,64,0,1,0
8,488,488,9,9,0,1,0

3,102,102,33,33,0,1,0
10,109,109,8,8,0,1,0
1,113,113,12,4,8,3,2
8,154,154,17,3,14,3,2
17,217,217,7,7,0,1,0
22,232,232,16,16,0,1,0
7,243,243,37,37,0,1,0
11,287,287,37,37,0,1,0
5,298,298,4,1,3,2,1
16,312,312,20,4,16,2,1
12,312,312,9,9,0,1,0
14,317,317,65,59,6,3,2
15,320,320,94,72,22,2,1
21,334,334,2,2,0,1,0
0,355,355,22,22,0,1,0
18,360,360,54,54,0,1,0
20,369,369,75,51,24,3,2
4,397,397,65,65,0,1,0
6,414,414,45,45,0,1,0
2,418,418,51,18,33,2,1
19,418,418,16,16,0,1,0
13,429,429,13,2,11,2,1
9,482,482,67,31,36,2,1

17,100,100,5,5,0,1,0
6,102,102,5,5,0,1,0
18,104,104,3,3,0,1,0
8,120,120,3,3,0,1,0
19,138,138,4,4,0,1,0
22,149,149,9,3,6,3,2
26,153,153,15,8,7,2,1
36,165,165,16,16,0,1,0
12,171,171,13,13,0,1,0
11,173,173,1,1,0,1,0
2,179,179,11,11,0,1,0
31,181,181,1,1,0,1,0
27,203,203,43,14,29,2,1
5,221,221,3,3,0,1,0
29,221,221,44,5,39,4,3
13,241,241,1,1,0,1,0
7,276,276,20,5,15,4,3
34,283,283,40,40,0,1,0
3,295,295,65,65,0,1,0
20,298,298,9,3,6,3,2
14,324,324,10,4,6,2,1
16,329,329,1,1,0,1,0
28,337,337,9,9,0,1,0
10,356,356,19,19,0,1,0
32,362,362,29,25,4,2,1
21,363,363,15,6,9,4,3
25,381,381,12,2,10,2,1
0,400,400,32,27,5,2,1
33,416,416,11,11,0,1,0
24,417,417,29,29,0,1,0
1,420,420,6,6,0,1,0
35,437,437,37,2,35,2,1
15,446,446,19,4,15,2,1
30,467,467,116,39,77,4,3
23,495,495,35,35,0,1,0
4,496,496,56,56,0,1,0
9,499,499,63,63,0,1,0

17,146,146,25,25,0,1,0
14,151,151,4,1,3,2,1
9,161,161,5,5,0,1,0
25,174,174,6,6,0,1,0
3,203,203,4,4,0,1,0
2,225,225,9,9,0,1,0
1,227,227,47,47,0,1,0
23,232,232,93,75,18,4,3
18,233,233,15,15,0,1,0
0,263,263,4,4,0,1,0
7,280,280,14,7,7,2,1
4,282,282,37,37,0,1,0
8,289,289,24,24,0,1,0
13,294,294,90,58,32,2,1
5,298,298,11,2,9,2,1
12,299,299,2,2,0,1,0
6,302,302,54,28,26,3,2
29,304,304,23,23,0,1,0
24,309,309,10,10,0,1,0
22,333,333,14,14,0,1,0
28,338,338,11,2,9,4,3
26,384,384,7,7,0,1,0
10,396,396,14,14,0,1,0
21,411,411,63,63,0,1,0
20,421,421,46,46,0,1,0
15,426,426,32,14,18,2,1
27,430,430,40,40,0,1,0
11,448,448,4,4,0,1,0
16,459,459,23,6,17,2,1
19,477,477,40,40,0,1,0

13,114,114,3,3,0,1,0
22,126,126,15,10,5,2,1
16,145,145,2,2,0,1,0
11,148,148,11,8,3,2,1
8,149,149,8,2,6,2,1
3,155,155,8,2,6,2,1
2,168,168,13,7,6,2,1
15,187,187,2,2,0,1,0
17,234,234,65,19,46,3,2
0,242,242,1,1,0,1,0
9,271,271,19,4,15,2,1
14,272,272,22,22,0,1,0
4,295,295,75,75,0,1,0
1,313,313,17,12,5,2,1
19,323,323,90,40,50,2,1
5,353,353,241,214,27,2,1
20,373,373,46,46,0,1,0
10,406,406,38,1,37,2,1
6,409,409,9,9,0,1,0
12,429,429,19,19,0,1,0
18,430,430,53,17,36,2,1
7,470,470,15,6,9,2,1
21,500,500,34,34,0,1,0

15,113,113,15,8,7,2,1
10,127,127,3,3,0,1,0
13,146,146,13,13,0,1,0
14,147,147,39,20,19,2,1
2,152,152,45,45,0,1,0
19,152,152,26,2,24,4,3
22,161,161,5,1,4,2,1
5,163,163,5,5,0,1,0
11,163,163,6,6,0,1,0
8,167,167,1,1,0,1,0
16,190,190,28,4,24,4,3
6,211,211,45,45,0,1,0
4,247,247,12,12,0,1,0
12,254,254,43,4,39,2,1
1,270,270,1,1,0,1,0
21,271,271,11,11,0,1,0
3,280,280,8,8,0,1,0
20,284,284,6,6,0,1,0
23,286,286,34,16,18,4,3
24,314,314,23,7,16,3,2
0,322,322,45,45,0,1,0
25,354,354,33,33,0,1,0
17,355,355,7,7,0,1,0
9,414,414,103,77,26,4,3
18,463,463,62,62,0,1,0
7,473,473,27,27,0,1,0

6,123,123,1,1,0,1,0
14,129,129,4,1,3,2,1
0,137,137,18,18,0,1,0
3,158,158,3,3,0,1,0
1,204,204,2,2,0,1,0
7,231,231,32,18,14,2,1
9,231,231,34,34,0,1,0
16,235,235,61,11,50,4,3
13,256,256,69,5,64,4,3
24,276,276,61,24,37,2,1
15,284,284,18,18,0,1,0
21,296,296,3,3,0,1,0
10,315,315,60,60,0,1,0
2,318,318,130,38,92,3,2
5,333,333,25,25,0,1,0
8,338,338,4,4,0,1,0
18,345,345,5,5,0,1,0
17,383,383,11,11,0,1,0
12,385,385,1,1,0,1,0
23,429,429,22,22,0,1,0
20,437,437,46,16,30,3,2
22,443,443,74,33,41,4,3
4,466,466,12,12,0,1,0
19,479,479,47,38,9,4,3
11,490,490,66,18,48,2,1

1,106,106,2,2,0,1,0
14,116,116,9,1,8,2,1
6,117,117,7,1,6,2,1
20,125,125,20,20,0,1,0
13,133,133,35,35,0,1,0
15,166,166,15,15,0,1,0
21,198,198,12,12,0,1,0
8,206,206,8,8,0,1,0
16,226,226,2,2,0,1,0
5,229,229,1,1,0,1,0
17,233,233,2,2,0,1,0
4,237,237,66,66,0,1,0
19,250,250,11,11,0,1,0
11,252,252,74,22,52,4,3
7,304,304,40,40,0,1,0
18,308,308,76,64,12,3,2
23,365,365,4,4,0,1,0
3,397,397,73,65,8,2,1
0,399,399,5,5,0,1,0
12,425,425,18,9,9,2,1
2,430,430,213,179,34,3,2
9,471,471,3,3,0,1,0
22,472,472,8,8,0,1,0
10,474,474,34,34,0,1,0

20,102,102,9,9,0,1,0
17,130,130,12,8,4,2,1
8,133,133,9,1,8,3,2
13,148,148,1,1,0,1,0
1,152,152,4,4,0,1,0
2,156,156,47,47,0,1,0
14,188,188,7,4,3,2,1
4,228,228,13,13,0,1,0
25,229,229,3,3,0,1,0
16,240,240,93,80,13,2,1
6,259,259,11,11,0,1,0
23,264,264,32,22,10,3,2
19,276,276,9,9,0,1,0
10,328,328,5,5,0,1,0
5,358,358,190,134,56,3,2
21,359,359,3,3,0,1,0
0,392,392,1,1,0,1,0
15,409,409,63,63,0,1,0
7,424,424,40,40,0,1,0
22,439,439,118,76,42,3,2
24,443,443,22,13,9,2,1
18,446,446,33,33,0,1,0
9,465,465,10,6,4,2,1
3,465,465,24,6,18,4,3
12,467,467,16,6,10,2,1
11,477,477,27,3,24,3,2

25,106,106,3,3,0,1,0
12,114,114,5,5,0,1,0
1,124,124,5,1,4,2,1
4,125,125,11,11,0,1,0
3,145,145,24,6,18,4,3
5,150,150,5,1,4,2,1
14,176,176,37,12,25,2,1
23,182,182,17,8,9,4,3
8,189,189,6,1,5,2,1
7,223,223,82,70,12,3,2
24,255,255,11,5,6,2,1
16,267,267,6,1,5,2,1
11,301,301,55,55,0,1,0
22,319,319,30,22,8,2,1
18,333,333,70,70,0,1,0
15,356,356,31,31,0,1,0
9,384,384,94,46,48,4,3
19,391,391,97,97,0,1,0
13,410,410,2,2,0,1,0
20,410,410,29,29,0,1,0
0,423,423,20,16,4,2,1
10,427,427,8,8,0,1,0
17,453,453,19,7,12,4,3
6,464,464,6,6,0,1,0
21,484,484,58,58,0,1,0
2,494,494,9,9,0,1,0
26,499,499,28,28,0,1,0

19,121,121,4,4,0,1,0
21,128,128,1,1,0,1,0
11,156,156,31,27,4,2,1
7,163,163,19,10,9,2,1
15,202,202,12,3,9,2,1
5,220,220,36,23,13,2,1
10,230,230,16,16,0,1,0
3,258,258,17,17,0,1,0
2,263,263,5,5,0,1,0
20,263,263,23,3,20,2,1
6,326,326,8,2,6,3,2
13,332,332,47,30,17,2,1
1,376,376,99,99,0,1,0
14,388,388,116,41,75,4,3
9,407,407,39,17,22,2,1
12,413,413,2,2,0,1,0
17,433,433,99,99,0,1,0
16,439,439,33,18,15,2,1
18,450,450,11,11,0,1,0
8,456,456,32,32,0,1,0
0,496,496,58,8,50,3,2
4,497,497,229,183,46,2,1

9,104,104,12,6,6,3,2
15,133,133,11,11,0,1,0
5,137,137,1,1,0,1,0
4,147,147,9,1,8,3,2
8,165,165,21,21,0,1,0
22,173,173,20,12,8,3,2
17,209,209,11,11,0,1,0
2,229,229,2,2,0,1,0
1,243,243,16,16,0,1,0
16,279,279,36,30,6,2,1
0,296,296,41,41,0,1,0
10,297,297,47,7,40,2,1
3,302,302,17,17,0,1,0
13,331,331,9,1,8,3,2
11,346,346,61,11,50,4,3
6,351,351,79,79,0,1,0
21,378,378,20,20,0,1,0
18,382,382,115,79,36,3,2
7,404,404,137,137,0,1,0
19,409,409,35,11,24,3,2
20,415,415,18,8,10,3,2
14,430,430,27,27,0,1,0
12,447,447,59,59,0,1,0
23,467,467,27,1,26,2,1

4,114,114,4,4,0,1,0
18,117,117,12,6,6,2,1
2,137,137,16,9,7,2,1
23,149,149,20,20,0,1,0
12,167,167,3,3,0,1,0
26,193,193,12,12,0,1,0
25,203,203,13,13,0,1,0
7,219,219,23,3,20,3,2
24,221,221,11,11,0,1,0
9,227,227,41,41,0,1,0
21,228,228,10,2,8,2,1
11,244,244,15,15,0,1,0
8,244,244,5,2,3,2,1
13,246,246,45,22,23,2,1
14,247,247,37,6,31,2,1
5,247,247,58,58,0,1,0
15,277,277,4,4,0,1,0
10,285,285,9,9,0,1,0
3,285,285,5,5,0,1,0
6,289,289,22,22,0,1,0
0,293,293,13,1,12,3,2
22,303,303,28,28,0,1,0
20,304,304,53,53,0,1,0
16,350,350,11,3,8,3,2
17,443,443,70,70,0,1,0
1,471,471,84,84,0,1,0
19,483,483,119,107,12,4,3

21,105,105,39,39,0,1,0
8,121,121,18,18,0,1,0
13,129,129,3,3,0,1,0
15,136,136,8,8,0,1,0
16,140,140,16,10,6,2,1
12,142,142,20,20,0,1,0
6,148,148,36,6,30,4,3
1,151,151,24,24,0,1,0
20,197,197,31,31,0,1,0
5,200,200,70,33,37,2,1
14,281,281,8,8,0,1,0
0,282,282,24,24,0,1,0
4,298,298,28,4,24,4,3
18,301,301,11,11,0,1,0
3,362,362,13,13,0,1,0
17,381,381,9,9,0,1,0
2,424,424,14,4,10,2,1
11,425,425,3,3,0,1,0
9,433,433,117,72,45,4,3
10,457,457,38,38,0,1,0
7,459,459,71,71,0,1,0
19,479,479,12,12,0,1,0

19,125,125,3,3,0,1,0
18,135,135,4,4,0,1,0
0,141,141,10,10,0,1,0
6,151,151,14,14,0,1,0
27,178,178,23,23,0,1,0
7,182,182,12,12,0,1,0
9,195,195,4,4,0,1,0
13,220,220,1,1,0,1,0
28,221,221,9,9,0,1,0
10,223,223,5,1,4,2,1
25,228,228,12,12,0,1,0
24,260,260,64,39,25,4,3
3,263,263,65,65,0,1,0
1,280,280,7,1,6,2,1
22,285,285,10,10,0,1,0
5,343,343,26,26,0,1,0
12,358,358,88,12,76,3,2
15,370,370,27,6,21,2,1
26,371,371,110,107,3,2,1
21,378,378,45,45,0,1,0
16,380,380,40,30,10,2,1
14,383,383,1,1,0,1,0
20,388,388,20,2,18,2,1
23,402,402,6,3,3,2,1
2,423,423,56,56,0,1,0
8,429,429,50,32,18,2,1
4,468,468,27,27,0,1,0
17,495,495,91,91,0,1,0
11,496,496,24,6,18,4,3

9,125,125,5,2,3,2,1
20,141,141,1,1,0,1,0
26,208,208,5,5,0,1,0
23,232,232,16,4,12,3,2
24,235,235,3,3,0,1,0
33,241,241,10,10,0,1,0
1,244,244,1,1,0,1,0
7,246,246,29,8,21,4,3
21,250,250,6,6,0,1,0
6,253,253,7,7,0,1,0
2,255,255,23,23,0,1,0
17,264,264,14,4,10,3,2
31,273,273,51,6,45,2,1
4,288,288,80,80,0,1,0
8,290,290,1,1,0,1,0
11,296,296,85,76,9,4,3
18,298,298,9,9,0,1,0
28,311,311,4,1,3,2,1
19,323,323,33,33,0,1,0
10,328,328,1,1,0,1,0
35,342,342,102,38,64,4,3
0,356,356,5,5,0,1,0
22,360,360,3,3,0,1,0
14,374,374,12,8,4,2,1
32,376,376,4,1,3,2,1
15,397,397,1,1,0,1,0
3,398,398,3,3,0,1,0
30,399,399,119,50,69,4,3
29,411,411,79,33,46,3,2
25,416,416,9,5,4,2,1
5,418,418,54,18,36,2,1
27,439,439,21,21,0,1,0
12,456,456,9,1,8,3,2
13,475,475,2,2,0,1,0
34,482,482,52,52,0,1,0
16,489,489,8,1,7,2,1

16,112,112,11,2,9,2,1
0,118,118,6,6,0,1,0
5,124,124,3,3,0,1,0
8,127,127,1,1,0,1,0
14,127,127,12,12,0,1,0
23,131,131,10,10,0,1,0
21,159,159,4,4,0,1,0
3,179,179,23,23,0,1,0
6,187,187,90,50,40,3,2
11,199,199,26,1,25,4,3
9,210,210,20,14,6,2,1
1,215,215,15,9,6,2,1
7,215,215,30,30,0,1,0
12,239,239,14,1,13,2,1
17,241,241,55,22,33,2,1
13,299,299,19,6,13,2,1
2,311,311,34,34,0,1,0
18,352,352,18,7,11,2,1
22,358,358,7,2,5,2,1
4,399,399,75,43,32,2,1
10,431,431,3,3,0,1,0
15,432,432,134,20,114,4,3
20,476,476,23,23,0,1,0
19,490,490,63,9,54,4,3

15,103,103,4,4,0,1,0
14,132,132,44,13,31,2,1
26,137,137,6,6,0,1,0
16,148,148,18,18,0,1,0
3,161,161,2,2,0,1,0
11,169,169,24,24,0,1,0
19,202,202,21,21,0,1,0
1,215,215,11,11,0,1,0
22,249,249,17,1,16,2,1
8,269,269,31,31,0,1,0
10,273,273,1,1,0,1,0
21,300,300,29,13,16,2,1
9,300,300,34,9,25,2,1
0,311,311,2,2,0,1,0
18,329,329,59,6,53,4,3
17,352,352,46,46,0,1,0
2,368,368,66,3,63,4,3
6,376,376,23,23,0,1,0
20,392,392,63,45,18,3,2
12,401,401,29,29,0,1,0
7,412,412,48,48,0,1,0
25,430,430,13,10,3,2,1
23,431,431,54,54,0,1,0
27,438,438,37,37,0,1,0
24,449,449,65,11,54,3,2
13,460,460,10,10,0,1,0
4,460,460,31,31,0,1,0
5,472,472,2,2,0,1,0

11,114,114,2,2,0,1,0
0,150,150,4,1,3,2,1
25,221,221,42,42,0,1,0
15,231,231,18,13,5,2,1
4,235,235,19,19,0,1,0
2,241,241,15,2,13,4,3
8,266,266,11,11,0,1,0
30,270,270,26,26,0,1,0
24,300,300,33,13,20,4,3
14,303,303,2,2,0,1,0
22,306,306,31,13,18,4,3
16,307,307,7,7,0,1,0
13,346,346,20,5,15,2,1
10,353,353,19,19,0,1,0
7,362,362,65,65,0,1,0
5,385,385,10,10,0,1,0
18,397,397,20,8,12,4,3
29,403,403,1,1,0,1,0
17,415,415,26,26,0,1,0
9,423,423,81,81,0,1,0
6,436,436,37,12,25,2,1
12,436,436,99,57,42,2,1
31,437,437,126,93,33,4,3
21,445,445,25,25,0,1,0
1,461,461,7,7,0,1,0
23,465,465,82,46,36,4,3
3,473,473,8,5,3,2,1
26,483,483,12,12,0,1,0
27,486,486,20,10,10,3,2
28,490,490,22,22,0,1,0
20,497,497,75,5,70,3,2
19,497,497,18,9,9,4,3

29,100,100,5,2,3,2,1
26,104,104,3,3,0,1,0
7,122,122,3,3,0,1,0
9,122,122,15,15,0,1,0
23,126,126,11,11,0,1,0
30,127,127,17,17,0,1,0
0,148,148,2,2,0,1,0
14,151,151,8,8,0,1,0
20,174,174,3,3,0,1,0
5,180,180,10,10,0,1,0
17,187,187,11,11,0,1,0
33,195,195,4,4,0,1,0
6,199,199,13,13,0,1,0
34,205,205,10,2,8,3,2
15,227,227,10,2,8,2,1
12,240,240,2,2,0,1,0
31,244,244,10,10,0,1,0
25,247,247,21,21,0,1,0
4,256,256,16,16,0,1,0
19,262,262,3,3,0,1,0
24,300,300,6,6,0,1,0
21,312,312,4,4,0,1,0
27,340,340,76,76,0,1,0
8,347,347,26,26,0,1,0
10,377,377,24,2,22,2,1
32,382,382,36,36,0,1,0
36,384,384,74,62,12,4,3
11,390,390,93,93,0,1,0
22,408,408,22,22,0,1,0
35,410,410,128,75,53,3,2
13,431,431,2,2,0,1,0
28,440,440,37,11,26,2,1
1,456,456,4,4,0,1,0
16,458,458,17,7,10,2,1
2,466,466,59,54,5,2,1
3,469,469,6,6,0,1,0
18,471,471,21,2,19,4,3

20,118,118,12,1,11,2,1
24,132,132,13,13,0,1,0
23,135,135,28,18,10,3,2
10,140,140,18,4,14,2,1
15,152,152,1,1,0,1,0
25,165,165,21,21,0,1,0
0,176,176,5,5,0,1,0
4,178,178,32,20,12,2,1
22,190,190,46,46,0,1,0
1,195,195,4,4,0,1,0
16,210,210,9,4,5,2,1
18,243,243,29,29,0,1,0
17,267,267,3,3,0,1,0
3,327,327,17,17,0,1,0
13,329,329,11,3,8,2,1
19,336,336,26,26,0,1,0
27,347,347,66,66,0,1,0
12,349,349,8,8,0,1,0
9,385,385,44,44,0,1,0
21,398,398,14,14,0,1,0
14,402,402,117,117,0,1,0
2,408,408,13,13,0,1,0
6,421,421,38,20,18,3,2
5,428,428,15,11,4,2,1
26,437,437,30,18,12,2,1
11,475,475,109,109,0,1,0
7,484,484,8,8,0,1,0
8,491,491,13,13,0,1,0

6,104,104,53,53,0,1,0
7,125,125,12,7,5,2,1
22,125,125,59,21,38,3,2
14,134,134,3,3,0,1,0
1,137,137,1,1,0,1,0
0,146,146,1,1,0,1,0
16,151,151,28,3,25,3,2
26,179,179,6,3,3,2,1
25,190,190,18,2,16,2,1
28,191,191,5,5,0,1,0
24,222,222,8,2,6,3,2
21,236,236,8,8,0,1,0
9,260,260,24,24,0,1,0
3,278,278,11,11,0,1,0
17,279,279,9,9,0,1,0
18,286,286,28,20,8,2,1
2,288,288,4,4,0,1,0
13,289,289,19,19,0,1,0
8,289,289,38,12,26,2,1
23,307,307,70,70,0,1,0
12,382,382,43,31,12,2,1
5,382,382,22,22,0,1,0
11,402,402,40,40,0,1,0
19,428,428,10,10,0,1,0
20,435,435,23,14,9,4,3
15,454,454,1,1,0,1,0
27,455,455,7,7,0,1,0
10,483,483,3,3,0,1,0
4,489,489,19,19,0,1,0

1,104,104,15,3,12,2,1
16,104,104,6,2,4,2,1
25,107,107,2,2,0,1,0
4,113,113,12,2,10,3,2
20,153,153,12,12,0,1,0
23,156,156,2,2,0,1,0
5,174,174,3,3,0,1,0
18,212,212,19,7,12,3,2
26,217,217,6,6,0,1,0
7,217,217,9,2,7,2,1
13,219,219,8,8,0,1,0
11,244,244,8,8,0,1,0
29,245,245,54,17,37,4,3
2,261,261,9,9,0,1,0
21,277,277,19,19,0,1,0
27,300,300,81,81,0,1,0
14,303,303,32,32,0,1,0
28,303,303,3,3,0,1,0
22,307,307,31,9,22,2,1
0,308,308,2,2,0,1,0
12,308,308,1,1,0,1,0
9,325,325,39,39,0,1,0
10,345,345,36,36,0,1,0
15,354,354,22,12,10,2,1
6,361,361,27,9,18,4,3
30,365,365,13,13,0,1,0
17,382,382,38,7,31,2,1
24,403,403,71,71,0,1,0
19,405,405,92,26,66,4,3
3,408,408,80,63,17,2,1
8,499,499,29,14,15,4,3

9,178,178,3,3,0,1,0
11,183,183,22,22,0,1,0
13,185,185,9,6,3,2,1
21,191,191,1,1,0,1,0
19,204,204,33,33,0,1,0
8,212,212,25,4,21,4,3
7,260,260,100,1,99,4,3
20,266,266,45,45,0,1,0
2,275,275,39,39,0,1,0
18,289,289,50,38,12,2,1
17,304,304,47,47,0,1,0
16,315,315,4,4,0,1,0
6,329,329,6,6,0,1,0
10,334,334,15,15,0,1,0
15,338,338,7,7,0,1,0
14,365,365,64,28,36,4,3
3,375,375,12,12,0,1,0
12,388,388,36,33,3,2,1
0,390,390,32,32,0,1,0
5,393,393,108,84,24,3,2
4,417,417,86,86,0,1,0
22,437,437,63,63,0,1,0
1,483,483,14,5,9,4,3

0,111,111,1,1,0,1,0
21,120,120,7,1,6,3,2
18,125,125,34,12,22,4,3
20,151,151,14,6,8,2,1
22,154,154,11,3,8,3,2
13,155,155,5,5,0,1,0
10,159,159,23,9,14,2,1
7,162,162,33,33,0,1,0
2,184,184,30,30,0,1,0
1,192,192,5,5,0,1,0
3,198,198,19,19,0,1,0
5,235,235,61,27,34,3,2
4,273,273,19,19,0,1,0
14,275,275,38,38,0,1,0
24,280,280,34,14,20,3,2
8,301,301,37,29,8,3,2
16,305,305,9,9,0,1,0
25,315,315,27,27,0,1,0
19,322,322,80,56,24,2,1
6,337,337,4,4,0,1,0
17,375,375,20,14,6,3,2
11,389,389,24,2,22,2,1
9,395,395,23,23,0,1,0
12,406,406,30,6,24,3,2
23,421,421,25,25,0,1,0
15,442,442,31,16,15,3,2

29,101,101,21,13,8,2,1
20,103,103,1,1,0,1,0
12,128,128,26,26,0,1,0
8,129,129,12,12,0,1,0
10,147,147,3,3,0,1,0
17,159,159,5,5,0,1,0
9,195,195,7,7,0,1,0
4,205,205,15,7,8,3,2
30,232,232,25,25,0,1,0
13,243,243,7,7,0,1,0
18,247,247,2,2,0,1,0
0,278,278,1,1,0,1,0
28,292,292,41,16,25,2,1
5,293,293,28,2,26,3,2
21,300,300,3,3,0,1,0
19,321,321,7,7,0,1,0
6,335,335,3,3,0,1,0
2,336,336,17,9,8,3,2
26,336,336,103,13,90,4,3
35,336,336,84,56,28,2,1
23,355,355,15,6,9,2,1
3,356,356,43,43,0,1,0
11,359,359,32,14,18,3,2
25,380,380,35,3,32,2,1
22,393,393,22,8,14,3,2
15,423,423,22,22,0,1,0
7,441,441,23,23,0,1,0
31,457,457,13,6,7,2,1
34,458,458,6,3,3,2,1
24,463,463,9,9,0,1,0
32,473,473,23,23,0,1,0
14,478,478,56,56,0,1,0
1,482,482,10,2,8,2,1
16,489,489,48,26,22,3,2
27,492,492,9,6,3,2,1
33,493,493,22,22,0,1,0

8,104,104,41,21,20,3,2
19,105,105,8,8,0,1,0
14,105,105,2,2,0,1,0
0,112,112,8,2,6,3,2
7,116,116,61,61,0,1,0
6,132,132,9,9,0,1,0
23,137,137,5,5,0,1,0
3,164,164,1,1,0,1,0
13,178,178,27,19,8,3,2
1,201,201,4,4,0,1,0
12,224,224,15,3,12,3,2
20,246,246,10,2,8,2,1
9,280,280,9,4,5,2,1
18,306,306,6,3,3,2,1
11,307,307,7,7,0,1,0
2,338,338,4,1,3,2,1
4,359,359,14,14,0,1,0
10,365,365,11,3,8,3,2
17,366,366,50,50,0,1,0
5,372,372,38,35,3,2,1
15,399,399,30,30,0,1,0
16,414,414,90,49,41,2,1
22,475,475,151,88,63,4,3
21,489,489,70,49,21,4,3

12,117,117,17,17,0,1,0
19,120,120,2,2,0,1,0
11,125,125,28,28,0,1,0
14,134,134,4,4,0,1,0
16,159,159,3,3,0,1,0
18,179,179,15,5,10,3,2
17,206,206,13,13,0,1,0
10,206,206,4,1,3,2,1
4,231,231,2,2,0,1,0
13,257,257,45,45,0,1,0
1,274,274,57,31,26,3,2
0,277,277,10,1,9,2,1
3,278,278,64,18,46,3,2
2,292,292,13,10,3,2,1
5,309,309,109,65,44,3,2
9,341,341,68,11,57,4,3
7,376,376,94,30,64,3,2
6,376,376,64,19,45,4,3
8,389,389,59,59,0,1,0
15,404,404,25,25,0,1,0
20,433,433,62,5,57,4,3

18,106,106,7,7,0,1,0
4,123,123,20,7,13,2,1
27,123,123,7,7,0,1,0
0,127,127,11,11,0,1,0
2,164,164,1,1,0,1,0
23,189,189,11,5,6,2,1
15,202,202,35,8,27,4,3
6,212,212,16,16,0,1,0
26,242,242,43,43,0,1,0
1,245,245,16,7,9,4,3
5,267,267,6,6,0,1,0
7,272,272,27,5,22,3,2
3,274,274,6,6,0,1,0
17,276,276,43,28,15,2,1
22,298,298,25,25,0,1,0
9,332,332,23,23,0,1,0
8,370,370,5,1,4,2,1
19,383,383,12,3,9,2,1
21,384,384,25,25,0,1,0
14,417,417,33,18,15,2,1
10,426,426,166,166,0,1,0
16,428,428,56,56,0,1,0
24,436,436,120,120,0,1,0
12,448,448,16,4,12,4,3
13,452,452,32,19,13,2,1
20,464,464,5,2,3,2,1
25,476,476,20,20,0,1,0
11,478,478,49,49,0,1,0

8,122,122,12,12,0,1,0
25,142,142,2,2,0,1,0
16,161,161,42,2,40,4,3
3,169,169,4,4,0,1,0
12,189,189,10,1,9,2,1
2,237,237,11,8,3,2,1
5,268,268,17,17,0,1,0
1,292,292,4,4,0,1,0
23,293,293,18,5,13,2,1
15,305,305,2,2,0,1,0
9,321,321,11,11,0,1,0
18,364,364,22,3,19,4,3
4,376,376,33,11,22,3,2
10,379,379,50,20,30,3,2
0,388,388,118,66,52,3,2
13,391,391,58,18,40,2,1
7,392,392,105,71,34,4,3
14,394,394,1,1,0,1,0
22,398,398,19,9,10,3,2
24,411,411,29,3,26,2,1
11,438,438,4,4,0,1,0
6,447,447,9,1,8,3,2
19,458,458,142,109,33,2,1
17,462,462,19,1,18,4,3
26,468,468,17,17,0,1,0
21,475,475,16,3,13,2,1
20,483,483,182,166,16,3,2

20,110,110,1,1,0,1,0
17,127,127,3,3,0,1,0
7,134,134,33,33,0,1,0
19,137,137,12,12,0,1,0
9,142,142,21,21,0,1,0
22,144,144,4,4,0,1,0
14,149,149,27,27,0,1,0
11,164,164,1,1,0,1,0
6,186,186,3,3,0,1,0
12,200,200,5,2,3,2,1
15,204,204,33,21,12,4,3
1,212,212,15,5,10,4,3
3,238,238,61,61,0,1,0
4,279,279,46,22,24,4,3
24,291,291,38,2,36,2,1
16,295,295,11,11,0,1,0
8,308,308,5,5,0,1,0
23,314,314,63,63,0,1,0
5,323,323,13,9,4,2,1
13,327,327,8,2,6,2,1
25,351,351,95,66,29,2,1
10,353,353,10,10,0,1,0
21,360,360,47,47,0,1,0
18,425,425,18,18,0,1,0
2,431,431,36,36,0,1,0
0,443,443,88,16,72,4,3

16,101,101,31,19,12,3,2
6,107,107,8,1,7,2,1
5,111,111,38,38,0,1,0
10,118,118,12,12,0,1,0
4,178,178,89,89,0,1,0
17,178,178,20,11,9,4,3
3,193,193,2,2,0,1,0
1,214,214,52,1,51,4,3
14,218,218,60,16,44,2,1
19,272,272,1,1,0,1,0
13,274,274,71,23,48,4,3
15,314,314,41,35,6,2,1
18,348,348,6,2,4,2,1
0,353,353,19,15,4,2,1
11,354,354,2,2,0,1,0
7,362,362,6,6,0,1,0
9,375,375,1,1,0,1,0
8,447,447,24,5,19,2,1
12,447,447,18,18,0,1,0
2,449,449,37,37,0,1,0

19,136,136,13,13,0,1,0
6,137,137,12,6,6,3,2
8,144,144,5,5,0,1,0
1,147,147,6,2,4,2,1
31,147,147,5,5,0,1,0
0,161,161,4,4,0,1,0
26,179,179,29,29,0,1,0
12,188,188,20,20,0,1,0
30,199,199,6,6,0,1,0
5,222,222,20,11,9,2,1
32,222,222,1,1,0,1,0
17,229,229,59,59,0,1,0
34,234,234,11,11,0,1,0
21,236,236,12,12,0,1,0
18,240,240,16,8,8,3,2
23,266,266,30,30,0,1,0
20,281,281,18,18,0,1,0
29,282,282,58,58,0,1,0
10,286,286,13,5,8,3,2
28,290,290,25,14,11,2,1
2,316,316,3,3,0,1,0
13,326,326,14,1,13,2,1
4,334,334,18,18,0,1,0
7,336,336,18,18,0,1,0
11,363,363,2,2,0,1,0
9,375,375,1,1,0,1,0
33,377,377,22,3,19,3,2
25,390,390,51,18,33,3,2
22,423,423,129,129,0,1,0
15,452,452,25,11,14,3,2
24,453,453,17,17,0,1,0
16,466,466,11,11,0,1,0
27,481,481,51,51,0,1,0
14,492,492,20,7,13,2,1
3,496,496,25,7,18,2,1

4,100,100,2,2,0,1,0
22,104,104,22,22,0,1,0
8,113,113,36,36,0,1,0
19,121,121,1,1,0,1,0
23,131,131,9,9,0,1,0
21,134,134,10,10,0,1,0
27,135,135,1,1,0,1,0
10,155,155,38,20,18,3,2
29,180,180,25,25,0,1,0
2,180,180,11,11,0,1,0
20,182,182,33,22,11,2,1
7,195,195,2,2,0,1,0
12,200,200,37,29,8,3,2
1,222,222,11,11,0,1,0
16,254,254,10,10,0,1,0
3,265,265,7,7,0,1,0
25,279,279,9,9,0,1,0
28,279,279,15,5,10,2,1
24,299,299,71,15,56,4,3
17,322,322,18,18,0,1,0
26,338,338,1,1,0,1,0
6,340,340,35,35,0,1,0
11,371,371,22,22,0,1,0
0,408,408,28,28,0,1,0
14,425,425,1,1,0,1,0
13,427,427,13,10,3,2,1
9,428,428,7,7,0,1,0
18,445,445,118,111,7,2,1
15,455,455,21,21,0,1,0
5,477,477,10,4,6,3,2

21,148,148,7,1,6,3,2
6,149,149,19,10,9,2,1
7,155,155,9,9,0,1,0
14,176,176,15,15,0,1,0
3,211,211,69,2,67,3,2
18,211,211,2,2,0,1,0
8,218,218,52,52,0,1,0
10,233,233,7,1,6,2,1
13,242,242,27,8,19,2,1
0,260,260,40,40,0,1,0
15,280,280,13,13,0,1,0
17,286,286,8,8,0,1,0
16,328,328,148,95,53,4,3
11,334,334,36,28,8,2,1
2,360,360,4,1,3,2,1
4,367,367,88,22,66,3,2
12,385,385,29,19,10,2,1
9,386,386,15,2,13,2,1
5,420,420,38,30,8,3,2
20,432,432,31,1,30,3,2
19,477,477,105,57,48,3,2
1,482,482,27,27,0,1,0

17,101,101,7,7,0,1,0
4,134,134,18,3,15,2,1
6,143,143,15,15,0,1,0
2,166,166,2,2,0,1,0
1,178,178,1,1,0,1,0
12,183,183,17,3,14,3,2
24,206,206,5,5,0,1,0
21,206,206,29,12,17,2,1
8,211,211,8,8,0,1,0
25,229,229,9,4,5,2,1
20,229,229,13,9,4,2,1
19,288,288,7,7,0,1,0
0,296,296,100,100,0,1,0
9,307,307,18,18,0,1,0
5,343,343,8,8,0,1,0
13,381,381,16,1,15,2,1
23,388,388,6,6,0,1,0
14,389,389,54,54,0,1,0
15,396,396,50,14,36,3,2
22,423,423,66,57,9,4,3
16,426,426,163,55,108,4,3
3,428,428,34,20,14,2,1
7,430,430,9,9,0,1,0
18,466,466,50,9,41,4,3
11,481,481,52,52,0,1,0
10,494,494,141,55,86,4,3

14,109,109,6,1,5,2,1
11,112,112,6,6,0,1,0
30,112,112,27,22,5,2,1
34,116,116,3,3,0,1,0
12,132,132,5,5,0,1,0
17,180,180,12,12,0,1,0
19,209,209,9,1,8,3,2
2,211,211,1,1,0,1,0
6,224,224,21,21,0,1,0
3,229,229,20,4,16,3,2
22,231,231,50,17,33,4,3
20,232,232,13,5,8,3,2
16,235,235,9,9,0,1,0
5,255,255,1,1,0,1,0
13,258,258,12,6,6,2,1
26,266,266,17,2,15,2,1
25,293,293,49,10,39,4,3
29,295,295,10,10,0,1,0
1,296,296,3,3,0,1,0
0,298,298,26,26,0,1,0
27,307,307,23,23,0,1,0
8,318,318,53,53,0,1,0
15,321,321,22,3,19,2,1
10,327,327,61,61,0,1,0
9,332,332,5,5,0,1,0
32,351,351,56,38,18,3,2
21,409,409,4,4,0,1,0
4,416,416,32,26,6,2,1
31,437,437,74,26,48,3,2
23,448,448,15,3,12,4,3
33,460,460,5,5,0,1,0
24,464,464,50,18,32,2,1
28,467,467,7,7,0,1,0
7,469,469,18,15,3,2,1
18,481,481,27,6,21,4,3

18,116,116,22,22,0,1,0
5,120,120,5,5,0,1,0
6,141,141,13,2,11,2,1
30,156,156,15,5,10,3,2
29,163,163,5,5,0,1,0
27,170,170,20,11,9,4,3
22,183,183,12,12,0,1,0
24,185,185,55,41,14,2,1
2,187,187,33,33,0,1,0
3,196,196,14,14,0,1,0
10,206,206,23,23,0,1,0
17,234,234,27,8,19,3,2
21,241,241,34,16,18,2,1
9,245,245,2,2,0,1,0
7,253,253,35,35,0,1,0
4,262,262,13,13,0,1,0
14,271,271,8,8,0,1,0
20,279,279,12,12,0,1,0
0,303,303,9,9,0,1,0
16,308,308,15,7,8,3,2
1,327,327,29,29,0,1,0
11,329,329,27,27,0,1,0
19,331,331,39,39,0,1,0
15,331,331,22,16,6,3,2
13,340,340,16,10,6,3,2
8,344,344,31,5,26,2,1
25,375,375,3,3,0,1,0
23,380,380,12,5,7,2,1
12,418,418,7,7,0,1,0
26,472,472,9,9,0,1,0
28,484,484,84,84,0,1,0

15,103,103,8,8,0,1,0
14,112,112,10,2,8,2,1
2,138,138,23,2,21,2,1
20,141,141,17,5,12,3,2
24,146,146,4,4,0,1,0
17,169,169,12,12,0,1,0
23,184,184,24,16,8,3,2
7,204,204,4,4,0,1,0
25,226,226,26,19,7,2,1
22,231,231,4,4,0,1,0
13,234,234,44,5,39,2,1
9,239,239,9,5,4,2,1
4,245,245,21,21,0,1,0
21,253,253,6,6,0,1,0
1,294,294,3,3,0,1,0
26,312,312,73,69,4,2,1
27,321,321,84,56,28,3,2
10,330,330,31,6,25,2,1
3,366,366,13,5,8,2,1
28,399,399,82,82,0,1,0
18,402,402,24,3,21,2,1
6,434,434,27,1,26,3,2
19,444,444,4,4,0,1,0
12,449,449,18,18,0,1,0
16,459,459,23,23,0,1,0
5,460,460,8,8,0,1,0
0,473,473,12,12,0,1,0
8,476,476,148,129,19,2,1
11,490,490,22,9,13,2,1

13,106,106,26,26,0,1,0
18,134,134,18,14,4,2,1
0,138,138,47,33,14,2,1
23,162,162,7,7,0,1,0
10,196,196,2,2,0,1,0
15,240,240,31,18,13,2,1
5,244,244,22,13,9,4,3
16,250,250,6,6,0,1,0
1,252,252,27,15,12,4,3
22,253,253,6,2,4,2,1
17,274,274,8,8,0,1,0
3,292,292,36,20,16,3,2
4,296,296,27,3,24,2,1
20,310,310,12,12,0,1,0
12,314,314,9,1,8,2,1
25,325,325,30,18,12,4,3
6,328,328,3,3,0,1,0
11,342,342,58,15,43,4,3
24,361,361,108,75,33,2,1
21,366,366,67,24,43,2,1
8,370,370,29,23,6,3,2
2,372,372,34,34,0,1,0
14,440,440,34,34,0,1,0
7,468,468,39,39,0,1,0
19,469,469,1,1,0,1,0
9,490,490,38,2,36,2,1

10,101,101,14,6,8,2,1
14,116,116,6,6,0,1,0
5,118,118,5,1,4,2,1
28,119,119,4,4,0,1,0
17,123,123,2,2,0,1,0
4,135,135,1,1,0,1,0
19,142,142,6,2,4,2,1
20,159,159,19,19,0,1,0
30,171,171,24,24,0,1,0
2,215,215,1,1,0,1,0
12,218,218,4,4,0,1,0
29,219,219,14,14,0,1,0
1,234,234,6,1,5,2,1
18,252,252,51,39,12,4,3
22,260,260,7,7,0,1,0
8,280,280,30,1,29,2,1
0,303,303,24,16,8,2,1
3,310,310,15,15,0,1,0
13,341,341,4,4,0,1,0
25,366,366,129,129,0,1,0
23,379,379,7,1,6,2,1
27,381,381,2,2,0,1,0
9,389,389,24,10,14,2,1
6,393,393,102,72,30,4,3
21,444,444,97,55,42,3,2
11,450,450,26,12,14,3,2
7,454,454,38,38,0,1,0
16,458,458,10,7,3,2,1
15,468,468,29,20,9,2,1
31,472,472,29,29,0,1,0
26,491,491,26,26,0,1,0
24,496,496,92,36,56,3,2

12,106,106,4,4,0,1,0
1,125,125,3,3,0,1,0
4,149,149,1,1,0,1,0
8,164,164,1,1,0,1,0
19,188,188,13,1,12,3,2
9,197,197,26,1,25,4,3
5,211,211,2,2,0,1,0
18,214,214,9,1,8,2,1
22,216,216,39,39,0,1,0
14,230,230,18,18,0,1,0
0,237,237,48,15,33,4,3
17,288,288,38,1,37,2,1
2,309,309,7,7,0,1,0
7,318,318,127,93,34,2,1
11,355,355,38,38,0,1,0
13,386,386,45,45,0,1,0
16,391,391,50,16,34,3,2
21,398,398,68,57,11,2,1
20,399,399,26,12,14,2,1
3,419,419,81,62,19,2,1
6,471,471,144,99,45,4,3
15,471,471,33,16,17,3,2
10,478,478,60,60,0,1,0

16,107,107,4,4,0,1,0
3,108,108,15,1,14,2,1
9,111,111,5,5,0,1,0
23,141,141,30,30,0,1,0
7,149,149,2,2,0,1,0
11,159,159,12,12,0,1,0
5,162,162,32,32,0,1,0
17,173,173,27,11,16,2,1
2,178,178,7,7,0,1,0
15,195,195,19,12,7,2,1
12,225,225,26,26,0,1,0
6,235,235,9,9,0,1,0
22,262,262,12,3,9,4,3
13,281,281,79,41,38,3,2
19,292,292,7,7,0,1,0
21,307,307,51,51,0,1,0
0,347,347,59,43,16,3,2
14,350,350,24,24,0,1,0
24,409,409,10,10,0,1,0
20,410,410,45,45,0,1,0
25,416,416,39,39,0,1,0
1,431,431,107,26,81,4,3
8,433,433,47,29,18,2,1
10,446,446,41,41,0,1,0
4,460,460,10,10,0,1,0
18,484,484,3,3,0,1,0

29,128,128,13,9,4,2,1
0,155,155,16,16,0,1,0
2,159,159,15,15,0,1,0
5,164,164,10,10,0,1,0
19,190,190,5,5,0,1,0
6,194,194,17,2,15,4,3
8,219,219,17,12,5,2,1
31,245,245,6,6,0,1,0
1,254,254,43,6,37,2,1
28,264,264,8,1,7,2,1
27,265,265,28,28,0,1,0
22,273,273,13,13,0,1,0
18,284,284,41,9,32,3,2
24,284,284,68,21,47,2,1
20,289,289,36,36,0,1,0
13,290,290,22,22,0,1,0
7,292,292,2,2,0,1,0
25,308,308,77,77,0,1,0
23,334,334,18,18,0,1,0
10,366,366,6,2,4,2,1
9,402,402,3,3,0,1,0
16,409,409,24,4,20,2,1
4,449,449,11,7,4,2,1
21,450,450,47,39,8,3,2
3,451,451,9,1,8,3,2
17,453,453,18,18,0,1,0
26,457,457,55,55,0,1,0
11,464,464,24,24,0,1,0
14,484,484,8,8,0,1,0
15,486,486,57,48,9,4,3
30,492,492,45,45,0,1,0
12,499,499,65,35,30,4,3

15,139,139,16,16,0,1,0
2,145,145,4,4,0,1,0
9,151,151,1,1,0,1,0
7,162,162,30,30,0,1,0
36,163,163,21,21,0,1,0
31,165,165,11,2,9,2,1
28,179,179,5,5,0,1,0
33,194,194,29,1,28,3,2
5,223,223,1,1,0,1,0
32,226,226,50,17,33,2,1
25,231,231,1,1,0,1,0
11,232,232,4,1,3,2,1
18,238,238,10,3,7,2,1
21,248,248,9,9,0,1,0
8,250,250,11,11,0,1,0
20,265,265,10,10,0,1,0
4,289,289,1,1,0,1,0
10,303,303,2,2,0,1,0
30,317,317,19,19,0,1,0
13,323,323,9,9,0,1,0
19,327,327,1,1,0,1,0
34,341,341,6,6,0,1,0
6,342,342,5,2,3,2,1
35,342,342,5,5,0,1,0
26,347,347,19,19,0,1,0
17,349,349,1,1,0,1,0
1,382,382,57,57,0,1,0
37,403,403,34,34,0,1,0
27,406,406,73,36,37,3,2
23,420,420,29,6,23,4,3
14,424,424,6,6,0,1,0
29,445,445,140,67,73,4,3
0,469,469,20,20,0,1,0
22,485,485,48,29,19,3,2
16,490,490,6,6,0,1,0
3,493,493,53,53,0,1,0
12,494,494,53,13,40,2,1
24,497,497,62,33,29,2,1

19,111,111,10,10,0,1,0
3,140,140,17,2,15,4,3
5,147,147,45,45,0,1,0
11,163,163,12,12,0,1,0
8,170,170,14,14,0,1,0
2,174,174,11,5,6,3,2
12,181,181,19,9,10,2,1
21,204,204,27,27,0,1,0
17,221,221,3,3,0,1,0
22,227,227,21,15,6,3,2
4,256,256,9,9,0,1,0
9,269,269,63,34,29,2,1
20,273,273,39,39,0,1,0
1,318,318,14,14,0,1,0
15,339,339,91,91,0,1,0
13,370,370,42,1,41,2,1
10,374,374,26,26,0,1,0
7,395,395,19,19,0,1,0
14,405,405,43,43,0,1,0
18,419,419,10,2,8,3,2
0,426,426,86,56,30,4,3
6,427,427,71,71,0,1,0
16,487,487,44,44,0,1,0

12,108,108,7,1,6,3,2
21,117,117,9,9,0,1,0
16,138,138,7,3,4,2,1
7,142,142,15,6,9,2,1
14,147,147,2,2,0,1,0
2,166,166,37,37,0,1,0
23,217,217,44,44,0,1,0
10,222,222,38,38,0,1,0
17,234,234,13,4,9,2,1
20,249,249,23,23,0,1,0
6,289,289,33,33,0,1,0
18,296,296,5,5,0,1,0
3,300,300,10,2,8,3,2
11,315,315,17,3,14,2,1
4,339,339,16,16,0,1,0
9,347,347,71,49,22,2,1
22,403,403,19,19,0,1,0
15,410,410,9,3,6,2,1
5,428,428,107,107,0,1,0
13,451,451,59,13,46,3,2
0,454,454,15,10,5,2,1
1,474,474,5,5,0,1,0
8,486,486,26,4,22,2,1
19,491,491,136,136,0,1,0
24,495,495,135,135,0,1,0

18,164,164,31,31,0,1,0
3,173,173,5,2,3,2,1
5,202,202,5,2,3,2,1
7,203,203,36,24,12,4,3
13,230,230,64,38,26,3,2
26,235,235,6,6,0,1,0
25,239,239,6,6,0,1,0
22,251,251,43,43,0,1,0
14,258,258,4,4,0,1,0
17,265,265,41,5,36,2,1
8,268,268,15,15,0,1,0
20,280,280,88,46,42,3,2
21,292,292,14,14,0,1,0
10,298,298,12,3,9,4,3
19,313,313,21,8,13,2,1
6,327,327,69,3,66,4,3
1,343,343,9,9,0,1,0
27,350,350,16,16,0,1,0
2,355,355,12,12,0,1,0
9,389,389,71,14,57,4,3
23,407,407,13,6,7,3,2
24,411,411,82,48,34,3,2
0,412,412,20,5,15,2,1
11,439,439,27,27,0,1,0
4,440,440,12,12,0,1,0
12,453,453,40,31,9,4,3
16,456,456,11,1,10,2,1
15,481,481,12,3,9,4,3

20,128,128,2,2,0,1,0
9,134,134,8,8,0,1,0
5,151,151,11,11,0,1,0
4,153,153,1,1,0,1,0
12,184,184,6,1,5,2,1
30,184,184,43,33,10,2,1
0,189,189,22,12,10,3,2
23,201,201,6,6,0,1,0
24,202,202,5,5,0,1,0
22,214,214,1,1,0,1,0
15,234,234,9,9,0,1,0
14,254,254,11,11,0,1,0
26,269,269,32,22,10,3,2
21,275,275,39,23,16,2,1
16,290,290,13,5,8,3,2
31,303,303,10,7,3,2,1
8,316,316,37,4,33,3,2
28,321,321,17,17,0,1,0
1,321,321,26,2,24,2,1
33,325,325,22,22,0,1,0
29,333,333,76,36,40,3,2
27,338,338,3,3,0,1,0
32,342,342,11,11,0,1,0
19,354,354,1,1,0,1,0
36,359,359,13,6,7,2,1
2,374,374,1,1,0,1,0
6,402,402,25,1,24,3,2
7,432,432,1,1,0,1,0
3,456,456,4,4,0,1,0
25,459,459,107,86,21,4,3
35,465,465,115,115,0,1,0
18,477,477,10,5,5,2,1
11,477,477,41,24,17,4,3
17,481,481,79,79,0,1,0
34,484,484,2,2,0,1,0
10,490,490,69,69,0,1,0
13,490,490,4,4,0,1,0

9,100,100,13,2,11,2,1
14,125,125,6,6,0,1,0
15,131,131,18,18,0,1,0
6,142,142,20,2,18,2,1
19,181,181,11,2,9,4,3
18,183,183,25,25,0,1,0
4,210,210,34,34,0,1,0
10,220,220,11,11,0,1,0
3,255,255,21,21,0,1,0
12,271,271,49,49,0,1,0
16,271,271,85,36,49,2,1
5,279,279,81,81,0,1,0
0,281,281,61,61,0,1,0
2,287,287,7,7,0,1,0
1,329,329,45,6,39,4,3
7,337,337,1,1,0,1,0
21,338,338,1,1,0,1,0
11,353,353,56,38,18,2,1
22,384,384,41,19,22,2,1
17,389,389,10,2,8,3,2
8,432,432,49,14,35,4,3
20,467,467,46,2,44,3,2
13,485,485,4,1,3,2,1

22,129,129,4,4,0,1,0
15,130,130,39,11,28,3,2
5,135,135,8,8,0,1,0
8,177,177,11,11,0,1,0
2,188,188,2,2,0,1,0
21,205,205,16,16,0,1,0
13,222,222,7,7,0,1,0
20,224,224,16,12,4,2,1
12,239,239,64,34,30,4,3
4,249,249,1,1,0,1,0
1,269,269,8,8,0,1,0
0,269,269,92,7,85,3,2
3,285,285,2,2,0,1,0
23,290,290,25,25,0,1,0
14,297,297,28,7,21,4,3
10,302,302,33,18,15,4,3
25,306,306,4,4,0,1,0
11,332,332,2,2,0,1,0
6,333,333,60,29,31,3,2
7,346,346,55,39,16,2,1
9,399,399,26,16,10,2,1
16,442,442,27,1,26,2,1
18,450,450,20,14,6,2,1
19,469,469,61,61,0,1,0
17,493,493,157,70,87,4,3
24,497,497,31,31,0,1,0

27,101,101,2,2,0,1,0
0,112,112,11,11,0,1,0
16,143,143,14,14,0,1,0
5,152,152,1,1,0,1,0
3,161,161,4,4,0,1,0
14,176,176,95,14,81,4,3
24,182,182,4,4,0,1,0
25,199,199,97,1,96,4,3
19,205,205,7,3,4,2,1
9,214,214,23,13,10,2,1
12,227,227,1,1,0,1,0
23,230,230,19,9,10,2,1
17,240,240,56,56,0,1,0
22,261,261,3,3,0,1,0
11,265,265,2,2,0,1,0
26,277,277,31,23,8,2,1
7,332,332,11,11,0,1,0
10,337,337,13,13,0,1,0
13,343,343,12,12,0,1,0
1,355,355,3,3,0,1,0
20,370,370,6,6,0,1,0
6,385,385,27,5,22,3,2
18,399,399,14,14,0,1,0
8,405,405,83,23,60,4,3
4,417,417,26,9,17,3,2
21,429,429,54,8,46,2,1
2,433,433,27,11,16,2,1
15,492,492,24,24,0,1,0

5,103,103,2,2,0,1,0
20,106,106,1,1,0,1,0
11,109,109,10,4,6,2,1
16,116,116,13,13,0,1,0
8,117,117,1,1,0,1,0
3,232,232,20,20,0,1,0
15,240,240,18,1,17,2,1
4,254,254,20,9,11,2,1
7,275,275,29,25,4,2,1
21,278,278,39,39,0,1,0
23,284,284,29,29,0,1,0
9,286,286,9,9,0,1,0
13,287,287,4,1,3,2,1
6,305,305,10,1,9,4,3
1,332,332,20,20,0,1,0
14,355,355,14,14,0,1,0
12,356,356,62,26,36,4,3
22,357,357,87,63,24,3,2
2,358,358,204,164,40,3,2
17,400,400,37,28,9,2,1
19,406,406,92,48,44,3,2
10,443,443,43,15,28,4,3
0,444,444,94,73,21,4,3
18,487,487,3,3,0,1,0

10,105,105,1,1,0,1,0
22,146,146,2,2,0,1,0
13,174,174,39,18,21,4,3
3,176,176,12,12,0,1,0
26,179,179,47,47,0,1,0
9,202,202,18,10,8,2,1
15,205,205,29,29,0,1,0
24,212,212,54,54,0,1,0
2,250,250,29,6,23,4,3
21,269,269,29,29,0,1,0
8,289,289,19,15,4,2,1
18,302,302,12,12,0,1,0
6,310,310,23,23,0,1,0
1,325,325,18,10,8,3,2
20,326,326,20,7,13,2,1
23,394,394,34,4,30,3,2
25,423,423,49,17,32,2,1
12,434,434,66,48,18,4,3
14,449,449,67,42,25,2,1
11,452,452,91,72,19,2,1
0,454,454,33,33,0,1,0
7,466,466,2,2,0,1,0
4,471,471,12,7,5,2,1
5,480,480,70,70,0,1,0
16,485,485,8,8,0,1,0
17,486,486,28,28,0,1,0
19,499,499,9,3,6,2,1

13,104,104,5,5,0,1,0
10,161,161,17,17,0,1,0
2,208,208,35,3,32,3,2
9,213,213,1,1,0,1,0
20,223,223,32,32,0,1,0
3,235,235,6,6,0,1,0
0,244,244,1,1,0,1,0
7,245,245,46,46,0,1,0
16,274,274,58,31,27,4,3
5,289,289,88,16,72,4,3
1,290,290,16,16,0,1,0
21,348,348,7,1,6,2,1
4,390,390,3,3,0,1,0
18,391,391,13,4,9,3,2
14,400,400,32,32,0,1,0
17,408,408,133,97,36,4,3
15,416,416,39,39,0,1,0
19,422,422,10,1,9,4,3
8,456,456,23,23,0,1,0
6,464,464,231,231,0,1,0
11,474,474,86,41,45,3,2
12,487,487,28,28,0,1,0

2,106,106,11,11,0,1,0
0,109,109,4,4,0,1,0
5,110,110,6,1,5,2,1
19,111,111,6,6,0,1,0
14,112,112,6,6,0,1,0
29,121,121,16,2,14,3,2
6,121,121,10,10,0,1,0
7,122,122,4,4,0,1,0
25,144,144,39,39,0,1,0
4,174,174,30,10,20,3,2
20,178,178,2,2,0,1,0
28,192,192,47,5,42,3,2
12,194,194,3,3,0,1,0
22,215,215,22,19,3,2,1
8,236,236,23,2,21,2,1
13,240,240,5,1,4,2,1
1,282,282,53,16,37,3,2
24,309,309,15,15,0,1,0
3,333,333,1,1,0,1,0
15,344,344,46,13,33,2,1
16,363,363,24,24,0,1,0
21,384,384,41,13,28,3,2
17,405,405,43,37,6,2,1
11,423,423,1,1,0,1,0
23,427,427,14,4,10,3,2
10,431,431,39,39,0,1,0
18,433,433,16,10,6,2,1
9,447,447,66,56,10,3,2
26,454,454,46,10,36,3,2
27,458,458,35,35,0,1,0

8,101,101,13,1,12,3,2
3,116,116,14,4,10,2,1
9,118,118,9,1,8,3,2
11,133,133,7,7,0,1,0
17,137,137,45,45,0,1,0
5,153,153,28,4,24,2,1
7,167,167,25,21,4,2,1
19,211,211,19,4,15,4,3
0,249,249,7,4,3,2,1
10,257,257,40,18,22,2,1
14,304,304,29,7,22,2,1
2,316,316,111,65,46,3,2
16,322,322,32,6,26,2,1
4,377,377,48,48,0,1,0
12,406,406,26,26,0,1,0
18,444,444,67,24,43,2,1
21,448,448,28,12,16,4,3
6,451,451,39,39,0,1,0
13,476,476,38,30,8,3,2
1,492,492,65,65,0,1,0
15,498,498,5,5,0,1,0
20,499,499,27,9,18,4,3

18,104,104,17,17,0,1,0
12,111,111,6,1,5,2,1
0,168,168,2,2,0,1,0
13,179,179,31,31,0,1,0
15,205,205,18,3,15,4,3
3,209,209,4,4,0,1,0
16,229,229,72,72,0,1,0
6,270,270,11,2,9,4,3
8,276,276,26,26,0,1,0
20,277,277,14,14,0,1,0
17,331,331,1,1,0,1,0
5,332,332,79,44,35,2,1
23,341,341,23,23,0,1,0
14,342,342,37,34,3,2,1
7,356,356,47,47,0,1,0
1,357,357,81,81,0,1,0
10,359,359,62,17,45,4,3
4,416,416,82,67,15,4,3
19,431,431,43,43,0,1,0
21,451,451,27,2,25,2,1
22,465,465,25,25,0,1,0
11,471,471,44,2,42,2,1
9,471,471,29,29,0,1,0
2,493,493,53,53,0,1,0

14,107,107,6,6,0,1,0
2,120,120,34,34,0,1,0
9,141,141,10,10,0,1,0
15,144,144,1,1,0,1,0
12,149,149,12,12,0,1,0
1,157,157,4,4,0,1,0
10,172,172,6,3,3,2,1
24,192,192,4,4,0,1,0
13,202,202,12,2,10,3,2
6,218,218,3,3,0,1,0
7,238,238,52,52,0,1,0
5,281,281,46,46,0,1,0
23,296,296,9,9,0,1,0
17,297,297,96,96,0,1,0
18,301,301,88,54,34,2,1
19,342,342,13,13,0,1,0
11,380,380,57,57,0,1,0
8,395,395,12,12,0,1,0
16,410,410,39,39,0,1,0
3,426,426,13,4,9,4,3
0,438,438,122,122,0,1,0
20,449,449,34,8,26,2,1
4,451,451,1,1,0,1,0
21,496,496,104,104,0,1,0
22,497,497,19,19,0,1,0

24,104,104,4,4,0,1,0
9,116,116,64,12,52,4,3
17,128,128,1,1,0,1,0
30,153,153,2,2,0,1,0
19,159,159,17,14,3,2,1
27,165,165,18,18,0,1,0
14,188,188,6,6,0,1,0
18,192,192,2,2,0,1,0
12,239,239,8,8,0,1,0
4,264,264,18,18,0,1,0
6,291,291,18,18,0,1,0
29,295,295,4,4,0,1,0
21,326,326,30,30,0,1,0
1,333,333,15,11,4,2,1
13,372,372,12,12,0,1,0
22,380,380,40,7,33,2,1
7,389,389,2,2,0,1,0
2,410,410,6,6,0,1,0
23,411,411,24,24,0,1,0
25,415,415,105,105,0,1,0
16,420,420,75,57,18,4,3
10,435,435,55,39,16,3,2
28,439,439,74,5,69,4,3
31,447,447,49,49,0,1,0
26,448,448,24,24,0,1,0
20,469,469,96,42,54,4,3
15,477,477,13,13,0,1,0
5,486,486,18,6,12,2,1
11,488,488,7,7,0,1,0
0,492,492,5,5,0,1,0
3,492,492,1,1,0,1,0
8,494,494,22,22,0,1,0

27,105,105,16,3,13,2,1
0,112,112,7,7,0,1,0
20,114,114,3,3,0,1,0
15,130,130,1,1,0,1,0
6,182,182,40,40,0,1,0
18,190,190,2,2,0,1,0
1,210,210,8,8,0,1,0
16,228,228,20,3,17,2,1
13,231,231,1,1,0,1,0
8,241,241,36,36,0,1,0
4,248,248,36,24,12,2,1
5,253,253,1,1,0,1,0
14,270,270,3,3,0,1,0
25,271,271,8,8,0,1,0
24,293,293,18,18,0,1,0
12,295,295,86,29,57,4,3
7,295,295,32,7,25,2,1
10,297,297,6,6,0,1,0
22,299,299,62,23,39,4,3
17,303,303,97,37,60,3,2
3,323,323,16,16,0,1,0
9,331,331,17,3,14,3,2
19,340,340,32,32,0,1,0
21,356,356,10,10,0,1,0
23,369,369,39,28,11,2,1
2,403,403,12,12,0,1,0
26,462,462,78,78,0,1,0
28,471,471,19,19,0,1,0
11,474,474,54,42,12,4,3

11,137,137,22,22,0,1,0
23,171,171,23,23,0,1,0
22,193,193,30,30,0,1,0
20,196,196,2,2,0,1,0
15,236,236,27,27,0,1,0
19,252,252,42,42,0,1,0
1,262,262,5,5,0,1,0
21,275,275,19,9,10,2,1
14,316,316,4,4,0,1,0
0,320,320,6,6,0,1,0
13,332,332,1,1,0,1,0
16,332,332,39,39,0,1,0
2,364,364,86,32,54,4,3
12,368,368,21,21,0,1,0
3,370,370,3,3,0,1,0
10,371,371,98,14,84,3,2
8,372,372,54,54,0,1,0
6,381,381,9,9,0,1,0
5,382,382,141,57,84,4,3
7,398,398,23,23,0,1,0
18,425,425,95,81,14,2,1
4,445,445,36,18,18,2,1
17,478,478,48,48,0,1,0
9,494,494,39,17,22,2,1

13,107,107,2,2,0,1,0
25,108,108,6,6,0,1,0
10,118,118,5,5,0,1,0
9,128,128,3,3,0,1,0
16,179,179,1,1,0,1,0
15,181,181,25,13,12,4,3
5,210,210,25,11,14,2,1
18,214,214,1,1,0,1,0
22,244,244,2,2,0,1,0
4,246,246,3,3,0,1,0
28,260,260,120,120,0,1,0
17,260,260,36,36,0,1,0
2,303,303,53,41,12,3,2
20,321,321,8,8,0,1,0
7,327,327,53,53,0,1,0
26,328,328,43,33,10,3,2
24,359,359,65,62,3,2,1
27,365,365,30,2,28,2,1
1,381,381,17,17,0,1,0
23,381,381,14,8,6,3,2
21,428,428,7,7,0,1,0
11,437,437,4,1,3,2,1
14,451,451,15,3,12,2,1
3,463,463,82,1,81,4,3
12,473,473,102,39,63,4,3
6,477,477,18,8,10,3,2
8,480,480,15,15,0,1,0
0,489,489,30,5,25,4,3
19,497,497,91,76,15,4,3

2,100,100,21,21,0,1,0
10,102,102,4,4,0,1,0
14,103,103,20,20,0,1,0
1,117,117,5,2,3,2,1
9,152,152,14,1,13,4,3
17,170,170,7,7,0,1,0
6,215,215,11,11,0,1,0
20,219,219,25,21,4,2,1
23,232,232,12,3,9,4,3
7,250,250,29,29,0,1,0
15,269,269,75,54,21,4,3
3,274,274,1,1,0,1,0
24,290,290,15,7,8,2,1
28,291,291,38,38,0,1,0
22,291,291,25,4,21,4,3
12,301,301,23,23,0,1,0
25,306,306,4,4,0,1,0
13,311,311,9,9,0,1,0
18,337,337,36,12,24,4,3
16,338,338,1,1,0,1,0
26,342,342,51,9,42,3,2
21,354,354,40,22,18,4,3
19,381,381,36,36,0,1,0
11,384,384,3,3,0,1,0
27,400,400,106,106,0,1,0
5,410,410,27,27,0,1,0
8,424,424,29,29,0,1,0
4,445,445,8,1,7,2,1
0,468,468,2,2,0,1,0
29,491,491,52,10,42,2,1

3,111,111,10,10,0,1,0
4,152,152,27,27,0,1,0
6,159,159,11,11,0,1,0
17,176,176,4,1,3,2,1
20,202,202,37,27,10,3,2
18,229,229,7,7,0,1,0
5,232,232,9,9,0,1,0
14,236,236,16,16,0,1,0
10,240,240,10,10,0,1,0
1,243,243,1,1,0,1,0
12,245,245,14,14,0,1,0
2,292,292,148,84,64,3,2
16,294,294,1,1,0,1,0
0,334,334,12,12,0,1,0
21,336,336,15,15,0,1,0
11,337,337,79,61,18,3,2
9,338,338,94,22,72,3,2
7,345,345,48,48,0,1,0
19,355,355,5,5,0,1,0
8,357,357,86,51,35,2,1
15,373,373,126,76,50,3,2
13,466,466,3,3,0,1,0

14,105,105,30,30,0,1,0
16,109,109,19,19,0,1,0
26,144,144,18,15,3,2,1
2,162,162,23,5,18,3,2
6,165,165,13,13,0,1,0
4,215,215,4,4,0,1,0
3,227,227,21,13,8,2,1
21,250,250,5,5,0,1,0
10,310,310,10,4,6,2,1
27,319,319,35,1,34,3,2
17,325,325,113,91,22,2,1
1,326,326,29,29,0,1,0
15,349,349,28,4,24,4,3
24,357,357,15,6,9,2,1
8,365,365,30,30,0,1,0
18,376,376,15,15,0,1,0
20,394,394,7,7,0,1,0
22,409,409,64,51,13,2,1
7,411,411,20,7,13,2,1
13,414,414,9,9,0,1,0
25,422,422,2,2,0,1,0
5,430,430,61,17,44,3,2
0,449,449,25,7,18,2,1
11,452,452,44,18,26,3,2
23,458,458,47,47,0,1,0
12,466,466,53,27,26,3,2
9,481,481,1,1,0,1,0
19,490,490,52,52,0,1,0

11,111,111,14,6,8,3,2
20,121,121,22,22,0,1,0
15,146,146,42,42,0,1,0
0,157,157,4,4,0,1,0
9,172,172,38,38,0,1,0
10,191,191,1,1,0,1,0
18,194,194,4,4,0,1,0
22,196,196,17,17,0,1,0
6,197,197,8,2,6,3,2
25,215,215,9,9,0,1,0
21,232,232,2,2,0,1,0
3,235,235,23,23,0,1,0
2,244,244,21,21,0,1,0
14,253,253,38,38,0,1,0
19,257,257,3,3,0,1,0
1,276,276,12,12,0,1,0
24,299,299,14,4,10,2,1
8,300,300,18,2,16,3,2
26,302,302,31,10,21,2,1
7,317,317,1,1,0,1,0
27,324,324,17,17,0,1,0
13,351,351,63,54,9,4,3
17,365,365,49,49,0,1,0
23,394,394,95,45,50,2,1
12,416,416,46,8,38,3,2
16,495,495,50,50,0,1,0
5,496,496,53,53,0,1,0
4,497,497,22,4,18,3,2

17,103,103,4,4,0,1,0
14,105,105,4,4,0,1,0
1,127,127,44,18,26,3,2
4,149,149,17,2,15,4,3
12,192,192,14,14,0,1,0
16,192,192,49,49,0,1,0
8,217,217,4,4,0,1,0
25,219,219,24,3,21,4,3
10,226,226,6,6,0,1,0
23,235,235,4,4,0,1,0
3,247,247,9,9,0,1,0
6,275,275,47,20,27,3,2
5,282,282,9,9,0,1,0
21,284,284,26,26,0,1,0
2,313,313,5,5,0,1,0
19,314,314,28,1,27,2,1
9,347,347,6,6,0,1,0
18,348,348,26,6,20,3,2
7,353,353,1,1,0,1,0
26,373,373,25,11,14,3,2
11,419,419,44,44,0,1,0
22,421,421,48,20,28,4,3
13,428,428,131,131,0,1,0
0,430,430,16,16,0,1,0
20,435,435,105,66,39,4,3
24,460,460,20,20,0,1,0
15,466,466,70,49,21,4,3

15,117,117,15,6,9,4,3
29,125,125,7,4,3,2,1
6,141,141,21,21,0,1,0
18,151,151,53,53,0,1,0
11,157,157,31,31,0,1,0
13,178,178,1,1,0,1,0
26,184,184,56,56,0,1,0
23,241,241,24,24,0,1,0
10,251,251,8,1,7,2,1
3,263,263,6,3,3,2,1
2,267,267,10,7,3,2,1
19,286,286,19,4,15,4,3
27,314,314,49,6,43,2,1
9,315,315,35,2,33,3,2
4,342,342,7,7,0,1,0
20,352,352,8,3,5,2,1
16,386,386,102,4,98,3,2
17,389,389,23,23,0,1,0
1,393,393,16,4,12,2,1
28,411,411,14,14,0,1,0
25,412,412,10,10,0,1,0
12,417,417,16,5,11,2,1
5,435,435,16,16,0,1,0
22,455,455,6,2,4,2,1
14,456,456,67,11,56,3,2
21,457,457,29,8,21,2,1
24,473,473,33,33,0,1,0
7,475,475,5,5,0,1,0
0,480,480,20,20,0,1,0
8,500,500,9,6,3,2,1

19,112,112,8,8,0,1,0
2,128,128,4,4,0,1,0
22,133,133,8,8,0,1,0
17,138,138,2,2,0,1,0
12,148,148,4,4,0,1,0
24,158,158,19,9,10,2,1
7,192,192,9,9,0,1,0
18,193,193,2,2,0,1,0
23,195,195,54,54,0,1,0
26,197,197,6,6,0,1,0
3,217,217,1,1,0,1,0
11,228,228,1,1,0,1,0
9,241,241,34,34,0,1,0
14,265,265,13,13,0,1,0
27,273,273,12,2,10,2,1
6,283,283,11,1,10,3,2
20,299,299,7,7,0,1,0
30,301,301,16,6,10,3,2
29,326,326,10,10,0,1,0
15,349,349,58,58,0,1,0
25,350,350,101,2,99,4,3
21,354,354,25,25,0,1,0
16,383,383,24,24,0,1,0
5,395,395,123,123,0,1,0
8,414,414,3,3,0,1,0
28,446,446,93,66,27,4,3
31,460,460,24,24,0,1,0
13,460,460,85,61,24,3,2
0,467,467,24,24,0,1,0
1,486,486,11,3,8,2,1
10,494,494,13,13,0,1,0
4,499,499,50,50,0,1,0

5,113,113,1,1,0,1,0
10,132,132,8,5,3,2,1
21,150,150,4,4,0,1,0
4,151,151,31,31,0,1,0
6,156,156,7,7,0,1,0
0,168,168,48,48,0,1,0
22,176,176,17,17,0,1,0
2,206,206,52,52,0,1,0
3,206,206,20,14,6,2,1
20,256,256,8,8,0,1,0
16,272,272,11,11,0,1,0
23,291,291,18,4,14,2,1
1,297,297,1,1,0,1,0
14,311,311,50,6,44,3,2
8,327,327,26,26,0,1,0
17,341,341,70,70,0,1,0
19,345,345,46,46,0,1,0
15,376,376,33,30,3,2,1
13,420,420,41,35,6,3,2
12,427,427,89,34,55,4,3
9,428,428,68,68,0,1,0
18,453,453,1,1,0,1,0
7,465,465,50,9,41,2,1
11,472,472,83,36,47,2,1

17,133,133,3,3,0,1,0
12,145,145,13,8,5,2,1
3,164,164,10,10,0,1,0
1,219,219,5,5,0,1,0
9,224,224,10,5,5,2,1
22,245,245,48,18,30,4,3
24,249,249,69,18,51,4,3
16,255,255,18,8,10,2,1
19,261,261,3,3,0,1,0
21,267,267,42,31,11,2,1
14,281,281,8,2,6,2,1
6,299,299,1,1,0,1,0
13,319,319,1,1,0,1,0
4,321,321,26,26,0,1,0
5,333,333,86,45,41,2,1
23,349,349,18,12,6,3,2
27,357,357,31,31,0,1,0
18,364,364,36,20,16,3,2
11,392,392,34,34,0,1,0
25,399,399,46,46,0,1,0
8,402,402,92,92,0,1,0
20,405,405,25,25,0,1,0
26,418,418,29,29,0,1,0
10,422,422,20,20,0,1,0
15,443,443,50,50,0,1,0
0,448,448,5,5,0,1,0
7,463,463,145,138,7,2,1
2,488,488,10,10,0,1,0

22,107,107,3,3,0,1,0
10,110,110,2,2,0,1,0
29,112,112,7,7,0,1,0
9,113,113,4,4,0,1,0
7,134,134,6,6,0,1,0
6,150,150,1,1,0,1,0
21,151,151,40,18,22,3,2
8,196,196,6,6,0,1,0
28,210,210,27,27,0,1,0
5,215,215,4,4,0,1,0
25,226,226,51,51,0,1,0
17,238,238,11,11,0,1,0
19,249,249,51,25,26,2,1
0,251,251,5,5,0,1,0
13,252,252,4,4,0,1,0
30,293,293,27,27,0,1,0
12,298,298,83,67,16,2,1
27,311,311,56,15,41,2,1
11,317,317,2,2,0,1,0
20,340,340,5,1,4,2,1
14,365,365,34,34,0,1,0
16,372,372,27,27,0,1,0
2,375,375,65,43,22,3,2
4,383,383,59,10,49,2,1
15,407,407,35,1,34,3,2
26,434,434,2,2,0,1,0
18,439,439,6,6,0,1,0
3,472,472,20,14,6,2,1
24,473,473,33,33,0,1,0
1,483,483,78,45,33,2,1
23,499,499,25,4,21,4,3

7,100,100,6,3,3,2,1
8,113,113,7,2,5,2,1
4,134,134,22,22,0,1,0
3,180,180,64,64,0,1,0
9,193,193,50,1,49,4,3
14,216,216,14,2,12,3,2
2,225,225,1,1,0,1,0
20,256,256,59,33,26,2,1
0,276,276,1,1,0,1,0
19,287,287,17,14,3,2,1
13,303,303,14,14,0,1,0
18,304,304,19,19,0,1,0
15,309,309,59,23,36,2,1
1,350,350,7,7,0,1,0
11,354,354,44,14,30,3,2
5,360,360,17,8,9,2,1
10,413,413,50,50,0,1,0
12,438,438,78,44,34,3,2
17,439,439,45,45,0,1,0
21,440,440,9,6,3,2,1
22,442,442,29,25,4,2,1
23,486,486,1,1,0,1,0
16,497,497,87,87,0,1,0
6,500,500,102,15,87,4,3

18,102,102,3,3,0,1,0
8,104,104,5,5,0,1,0
17,116,116,9,9,0,1,0
21,158,158,27,27,0,1,0
0,195,195,27,27,0,1,0
11,202,202,6,6,0,1,0
14,210,210,44,40,4,2,1
4,223,223,19,19,0,1,0
7,238,238,1,1,0,1,0
5,242,242,13,13,0,1,0
12,293,293,22,11,11,2,1
3,293,293,21,21,0,1,0
19,312,312,17,17,0,1,0
9,332,332,93,93,0,1,0
10,351,351,10,10,0,1,0
2,369,369,88,88,0,1,0
16,427,427,13,3,10,2,1
13,427,427,17,9,8,2,1
1,460,460,151,151,0,1,0
15,467,467,129,129,0,1,0
20,473,473,55,55,0,1,0
6,478,478,26,11,15,2,1
22,496,496,99,25,74,3,2

8,126,126,6,6,0,1,0
26,142,142,30,19,11,4,3
29,153,153,11,8,3,2,1
21,161,161,17,17,0,1,0
16,171,171,29,29,0,1,0
11,173,173,1,1,0,1,0
19,176,176,13,1,12,3,2
13,186,186,14,14,0,1,0
20,189,189,21,5,16,2,1
5,196,196,16,16,0,1,0
7,204,204,1,1,0,1,0
27,209,209,40,40,0,1,0
1,217,217,47,47,0,1,0
14,236,236,44,2,42,2,1
28,237,237,24,15,9,4,3
23,244,244,1,1,0,1,0
3,262,262,29,29,0,1,0
2,262,262,5,5,0,1,0
24,268,268,21,21,0,1,0
15,283,283,21,3,18,2,1
4,288,288,2,2,0,1,0
6,307,307,5,5,0,1,0
22,325,325,2,2,0,1,0
9,346,346,14,2,12,2,1
0,365,365,14,14,0,1,0
17,375,375,27,27,0,1,0
25,394,394,99,99,0,1,0
18,413,413,29,29,0,1,0
10,431,431,5,5,0,1,0
30,433,433,20,14,6,2,1
12,484,484,60,60,0,1,0

16,102,102,13,13,0,1,0
3,152,152,2,2,0,1,0
28,161,161,40,10,30,2,1
4,190,190,11,11,0,1,0
17,193,193,5,1,4,2,1
21,253,253,22,22,0,1,0
6,259,259,8,8,0,1,0
25,263,263,18,11,7,2,1
9,272,272,3,3,0,1,0
18,274,274,26,16,10,3,2
27,277,277,4,4,0,1,0
19,277,277,9,4,5,2,1
12,297,297,5,5,0,1,0
5,301,301,26,26,0,1,0
24,341,341,2,2,0,1,0
22,342,342,28,28,0,1,0
2,343,343,1,1,0,1,0
23,344,344,5,1,4,2,1
15,346,346,20,20,0,1,0
7,373,373,1,1,0,1,0
1,383,383,21,21,0,1,0
13,424,424,32,32,0,1,0
20,435,435,82,73,9,4,3
0,444,444,67,24,43,2,1
14,445,445,144,78,66,4,3
8,446,446,43,43,0,1,0
26,482,482,160,160,0,1,0
11,497,497,116,71,45,4,3
10,498,498,44,44,0,1,0

0,116,116,26,26,0,1,0
22,153,153,29,6,23,2,1
1,156,156,5,5,0,1,0
24,159,159,18,18,0,1,0
4,213,213,26,17,9,4,3
11,218,218,20,20,0,1,0
16,231,231,10,10,0,1,0
23,250,250,42,32,10,3,2
8,257,257,11,11,0,1,0
14,263,263,2,2,0,1,0
12,273,273,29,29,0,1,0
19,287,287,56,50,6,3,2
5,311,311,27,4,23,2,1
20,316,316,17,17,0,1,0
3,331,331,47,47,0,1,0
2,333,333,16,3,13,2,1
7,344,344,34,34,0,1,0
21,359,359,21,21,0,1,0
13,391,391,15,15,0,1,0
17,402,402,52,8,44,3,2
10,418,418,109,87,22,2,1
6,458,458,1,1,0,1,0
18,471,471,33,5,28,3,2
15,495,495,76,1,75,4,3
9,498,498,75,66,9,4,3

22,141,141,13,13,0,1,0
25,143,143,7,7,0,1,0
19,148,148,87,87,0,1,0
1,150,150,11,11,0,1,0
9,151,151,1,1,0,1,0
18,163,163,10,2,8,3,2
23,164,164,28,4,24,3,2
17,166,166,1,1,0,1,0
11,181,181,25,25,0,1,0
7,187,187,18,18,0,1,0
5,224,224,59,8,51,4,3
15,236,236,3,3,0,1,0
24,263,263,3,3,0,1,0
10,293,293,36,36,0,1,0
21,328,328,14,14,0,1,0
0,336,336,35,5,30,4,3
14,354,354,6,6,0,1,0
4,362,362,1,1,0,1,0
20,401,401,35,11,24,2,1
16,405,405,47,47,0,1,0
2,414,414,4,4,0,1,0
3,421,421,52,52,0,1,0
8,434,434,24,24,0,1,0
27,439,439,1,1,0,1,0
6,448,448,4,1,3,2,1
26,452,452,39,39,0,1,0
13,467,467,77,26,51,4,3
12,482,482,55,55,0,1,0

19,139,139,4,4,0,1,0
7,145,145,3,3,0,1,0
21,148,148,10,10,0,1,0
23,154,154,21,13,8,2,1
3,175,175,30,25,5,2,1
18,183,183,29,11,18,4,3
4,190,190,39,28,11,2,1
20,229,229,49,49,0,1,0
5,277,277,33,21,12,2,1
9,301,301,9,3,6,3,2
12,304,304,19,7,12,3,2
22,310,310,18,14,4,2,1
17,327,327,23,8,15,2,1
11,342,342,1,1,0,1,0
14,352,352,40,31,9,4,3
10,357,357,9,3,6,3,2
13,405,405,111,111,0,1,0
8,415,415,19,19,0,1,0
26,424,424,42,42,0,1,0
1,426,426,8,8,0,1,0
16,435,435,57,57,0,1,0
25,456,456,29,19,10,2,1
15,460,460,8,1,7,2,1
6,460,460,24,24,0,1,0
28,468,468,27,27,0,1,0
24,469,469,108,70,38,4,3
27,470,470,7,7,0,1,0
0,476,476,52,52,0,1,0
2,492,492,16,16,0,1,0

16,119,119,1,1,0,1,0
5,135,135,1,1,0,1,0
1,141,141,6,6,0,1,0
23,157,157,14,14,0,1,0
10,165,165,6,6,0,1,0
18,194,194,12,3,9,2,1
0,196,196,72,72,0,1,0
11,199,199,21,2,19,2,1
6,218,218,9,4,5,2,1
15,224,224,38,38,0,1,0
12,227,227,25,25,0,1,0
19,236,236,74,9,65,3,2
3,248,248,19,11,8,3,2
2,267,267,17,5,12,4,3
17,303,303,7,7,0,1,0
14,328,328,59,31,28,2,1
20,331,331,12,12,0,1,0
13,332,332,56,21,35,2,1
8,339,339,24,24,0,1,0
25,393,393,32,32,0,1,0
9,414,414,14,8,6,2,1
21,424,424,22,22,0,1,0
4,445,445,26,26,0,1,0
7,481,481,138,98,40,3,2
22,490,490,1,1,0,1,0
24,499,499,72,36,36,4,3

6,110,110,17,17,0,1,0
19,129,129,1,1,0,1,0
4,133,133,4,1,3,2,1
17,155,155,3,3,0,1,0
3,161,161,66,66,0,1,0
1,225,225,44,44,0,1,0
18,248,248,54,26,28,2,1
15,255,255,35,35,0,1,0
9,260,260,63,63,0,1,0
8,261,261,25,25,0,1,0
0,269,269,44,44,0,1,0
14,272,272,35,35,0,1,0
16,326,326,53,9,44,2,1
12,336,336,10,10,0,1,0
5,339,339,104,104,0,1,0
2,354,354,17,17,0,1,0
11,380,380,5,5,0,1,0
10,385,385,50,50,0,1,0
13,391,391,4,4,0,1,0
7,467,467,59,59,0,1,0

4,176,176,13,1,12,4,3
5,188,188,27,27,0,1,0
10,194,194,3,3,0,1,0
19,198,198,35,35,0,1,0
22,200,200,15,15,0,1,0
3,229,229,14,14,0,1,0
23,239,239,45,45,0,1,0
21,247,247,3,3,0,1,0
7,264,264,1,1,0,1,0
2,270,270,7,7,0,1,0
14,270,270,31,26,5,2,1
0,276,276,51,33,18,3,2
24,281,281,11,11,0,1,0
12,297,297,60,60,0,1,0
26,315,315,34,10,24,4,3
13,355,355,33,33,0,1,0
1,364,364,19,1,18,4,3
9,385,385,117,111,6,3,2
20,399,399,134,2,132,4,3
18,400,400,79,79,0,1,0
17,409,409,1,1,0,1,0
11,455,455,7,3,4,2,1
15,468,468,3,3,0,1,0
25,470,470,12,3,9,4,3
8,481,481,17,17,0,1,0
16,483,483,21,9,12,2,1
6,497,497,45,45,0,1,0

1,103,103,1,1,0,1,0
8,123,123,7,7,0,1,0
21,137,137,10,1,9,2,1
16,148,148,24,24,0,1,0
0,161,161,1,1,0,1,0
10,173,173,4,4,0,1,0
3,194,194,110,68,42,4,3
20,208,208,3,3,0,1,0
4,215,215,10,10,0,1,0
2,231,231,79,79,0,1,0
13,253,253,10,10,0,1,0
5,277,277,12,3,9,2,1
19,287,287,2,2,0,1,0
18,305,305,7,1,6,2,1
11,336,336,40,40,0,1,0
9,344,344,55,55,0,1,0
17,350,350,103,103,0,1,0
12,355,355,47,47,0,1,0
14,374,374,45,45,0,1,0
15,426,426,70,25,45,4,3
7,433,433,8,2,6,2,1
6,465,465,98,27,71,3,2

9,104,104,3,3,0,1,0
13,129,129,62,62,0,1,0
6,172,172,1,1,0,1,0
0,183,183,11,11,0,1,0
12,193,193,4,4,0,1,0
24,199,199,4,4,0,1,0
14,199,199,13,13,0,1,0
2,210,210,17,17,0,1,0
8,223,223,11,11,0,1,0
7,230,230,26,8,18,3,2
15,244,244,7,4,3,2,1
19,253,253,5,2,3,2,1
10,261,261,10,10,0,1,0
22,266,266,3,3,0,1,0
17,276,276,21,8,13,2,1
3,277,277,4,4,0,1,0
20,287,287,34,34,0,1,0
1,292,292,1,1,0,1,0
5,304,304,97,94,3,2,1
25,366,366,71,53,18,3,2
26,381,381,29,29,0,1,0
4,381,381,27,8,19,2,1
11,404,404,6,6,0,1,0
21,418,418,126,32,94,4,3
23,420,420,160,132,28,3,2
16,451,451,2,2,0,1,0
18,453,453,12,12,0,1,0

2,109,109,6,6,0,1,0
17,113,113,7,7,0,1,0
23,126,126,3,3,0,1,0
4,140,140,33,11,22,3,2
11,153,153,33,33,0,1,0
19,168,168,45,18,27,2,1
16,180,180,4,1,3,2,1
13,187,187,7,7,0,1,0
14,189,189,35,35,0,1,0
22,202,202,4,4,0,1,0
7,240,240,34,15,19,3,2
9,250,250,30,3,27,2,1
1,251,251,9,9,0,1,0
10,251,251,4,4,0,1,0
3,258,258,2,2,0,1,0
0,274,274,14,6,8,3,2
27,276,276,18,18,0,1,0
26,298,298,55,49,6,3,2
24,301,301,142,47,95,4,3
15,314,314,12,12,0,1,0
21,321,321,28,28,0,1,0
5,332,332,26,2,24,4,3
12,357,357,17,2,15,4,3
18,367,367,6,6,0,1,0
8,392,392,14,8,6,2,1
25,393,393,30,9,21,4,3
20,480,480,2,2,0,1,0
6,481,481,20,20,0,1,0

26,107,107,6,6,0,1,0
23,117,117,14,14,0,1,0
24,121,121,9,9,0,1,0
1,151,151,4,1,3,2,1
0,152,152,8,8,0,1,0
28,155,155,33,33,0,1,0
3,172,172,17,17,0,1,0
22,173,173,7,7,0,1,0
15,182,182,12,12,0,1,0
16,192,192,21,3,18,4,3
33,208,208,36,36,0,1,0
14,227,227,13,1,12,3,2
19,239,239,5,2,3,2,1
5,249,249,2,2,0,1,0
4,269,269,14,14,0,1,0
20,277,277,7,7,0,1,0
29,297,297,68,20,48,3,2
7,315,315,51,10,41,2,1
31,315,315,26,26,0,1,0
10,347,347,1,1,0,1,0
21,363,363,54,54,0,1,0
27,382,382,35,35,0,1,0
30,392,392,25,14,11,2,1
18,392,392,47,26,21,3,2
25,399,399,7,7,0,1,0
32,406,406,9,9,0,1,0
9,408,408,11,6,5,2,1
2,417,417,6,6,0,1,0
17,429,429,80,48,32,2,1
13,429,429,2,2,0,1,0
12,440,440,84,58,26,3,2
11,449,449,10,4,6,2,1
8,454,454,24,9,15,4,3
6,468,468,1,1,0,1,0

16,112,112,1,1,0,1,0
0,119,119,9,9,0,1,0
2,133,133,11,11,0,1,0
14,139,139,66,66,0,1,0
9,150,150,4,4,0,1,0
6,156,156,1,1,0,1,0
1,169,169,11,3,8,3,2
8,185,185,21,21,0,1,0
11,186,186,15,15,0,1,0
25,193,193,19,7,12,4,3
7,215,215,20,11,9,2,1
5,275,275,104,104,0,1,0
13,309,309,21,11,10,2,1
17,321,321,22,22,0,1,0
15,330,330,41,41,0,1,0
18,335,335,25,7,18,4,3
24,347,347,10,10,0,1,0
3,360,360,18,7,11,2,1
22,403,403,7,7,0,1,0
4,409,409,87,64,23,2,1
19,439,439,66,66,0,1,0
21,455,455,28,28,0,1,0
12,463,463,12,3,9,4,3
10,474,474,43,43,0,1,0
23,476,476,2,2,0,1,0
20,491,491,73,53,20,2,1

26,104,104,13,13,0,1,0
5,114,114,12,12,0,1,0
20,119,119,6,6,0,1,0
29,136,136,13,13,0,1,0
4,146,146,1,1,0,1,0
27,178,178,15,15,0,1,0
22,211,211,6,6,0,1,0
18,211,211,8,8,0,1,0
9,214,214,19,11,8,2,1
28,221,221,8,2,6,3,2
30,238,238,7,7,0,1,0
11,256,256,65,1,64,3,2
3,263,263,16,16,0,1,0
10,269,269,14,14,0,1,0
15,322,322,14,8,6,3,2
25,325,325,103,103,0,1,0
6,332,332,10,2,8,2,1
12,333,333,39,39,0,1,0
0,379,379,91,58,33,4,3
8,389,389,9,9,0,1,0
19,405,405,33,9,24,3,2
1,424,424,13,13,0,1,0
16,428,428,14,7,7,2,1
7,429,429,6,6,0,1,0
14,434,434,6,6,0,1,0
23,450,450,11,1,10,2,1
21,456,456,74,38,36,3,2
13,463,463,29,29,0,1,0
17,465,465,53,53,0,1,0
24,470,470,119,93,26,2,1
2,477,477,6,6,0,1,0

20,104,104,4,4,0,1,0
25,113,113,9,9,0,1,0
17,129,129,14,3,11,2,1
16,153,153,2,2,0,1,0
27,169,169,22,22,0,1,0
22,189,189,28,16,12,2,1
9,221,221,1,1,0,1,0
26,223,223,17,17,0,1,0
14,241,241,24,10,14,2,1
21,255,255,4,4,0,1,0
24,256,256,6,6,0,1,0
12,266,266,67,10,57,4,3
18,269,269,27,27,0,1,0
13,287,287,12,4,8,2,1
2,295,295,3,3,0,1,0
4,297,297,32,8,24,4,3
15,300,300,71,71,0,1,0
5,308,308,13,13,0,1,0
1,318,318,7,7,0,1,0
6,394,394,9,9,0,1,0
19,395,395,113,67,46,2,1
0,400,400,68,68,0,1,0
8,406,406,21,12,9,4,3
28,415,415,3,3,0,1,0
23,415,415,128,128,0,1,0
7,431,431,14,14,0,1,0
3,432,432,1,1,0,1,0
11,495,495,18,18,0,1,0
10,495,495,83,83,0,1,0

2,107,107,6,6,0,1,0
19,108,108,8,8,0,1,0
9,153,153,7,7,0,1,0
0,164,164,19,7,12,3,2
8,165,165,22,22,0,1,0
17,171,171,35,15,20,2,1
4,172,172,7,7,0,1,0
6,192,192,15,15,0,1,0
14,224,224,26,12,14,2,1
22,229,229,54,12,42,2,1
10,291,291,21,21,0,1,0
16,300,300,19,4,15,2,1
18,327,327,7,7,0,1,0
20,337,337,24,24,0,1,0
13,339,339,36,36,0,1,0
23,340,340,1,1,0,1,0
12,340,340,17,9,8,2,1
7,360,360,13,13,0,1,0
24,366,366,56,47,9,4,3
11,393,393,15,4,11,2,1
26,408,408,10,2,8,2,1
3,418,418,23,23,0,1,0
21,422,422,72,72,0,1,0
15,428,428,3,3,0,1,0
25,455,455,78,21,57,4,3
5,466,466,188,160,28,3,2
1,492,492,35,35,0,1,0

0,105,105,8,1,7,2,1
8,110,110,5,5,0,1,0
12,119,119,8,1,7,2,1
16,152,152,6,6,0,1,0
3,189,189,4,4,0,1,0
13,220,220,42,30,12,3,2
2,224,224,77,77,0,1,0
7,257,257,48,18,30,2,1
17,277,277,14,14,0,1,0
9,339,339,63,63,0,1,0
5,342,342,99,2,97,4,3
11,349,349,28,3,25,2,1
18,354,354,9,9,0,1,0
14,354,354,100,100,0,1,0
6,386,386,81,81,0,1,0
15,389,389,11,11,0,1,0
4,406,406,25,25,0,1,0
19,465,465,19,19,0,1,0
10,476,476,48,20,28,3,2
1,497,497,149,20,129,4,3

28,106,106,34,34,0,1,0
13,143,143,2,2,0,1,0
10,144,144,21,3,18,2,1
27,165,165,21,21,0,1,0
22,166,166,1,1,0,1,0
0,171,171,10,10,0,1,0
12,174,174,28,8,20,2,1
11,193,193,19,19,0,1,0
7,195,195,30,11,19,2,1
9,197,197,23,13,10,3,2
14,218,218,3,3,0,1,0
25,220,220,17,17,0,1,0
26,236,236,53,17,36,3,2
29,273,273,31,11,20,3,2
5,293,293,30,30,0,1,0
21,302,302,7,7,0,1,0
15,318,318,5,1,4,2,1
1,318,318,13,13,0,1,0
19,331,331,11,11,0,1,0
17,345,345,7,7,0,1,0
20,405,405,21,21,0,1,0
8,412,412,18,18,0,1,0
18,422,422,74,39,35,2,1
23,436,436,2,2,0,1,0
16,437,437,31,2,29,3,2
2,453,453,55,19,36,4,3
3,474,474,26,2,24,4,3
4,482,482,32,10,22,3,2
24,486,486,74,51,23,2,1
6,490,490,11,11,0,1,0

16,100,100,27,19,8,2,1
8,132,132,4,4,0,1,0
19,132,132,11,5,6,2,1
11,153,153,13,4,9,2,1
1,193,193,20,20,0,1,0
25,205,205,25,10,15,2,1
10,212,212,14,14,0,1,0
18,234,234,10,10,0,1,0
3,236,236,35,26,9,2,1
5,271,271,25,25,0,1,0
6,273,273,12,1,11,4,3
15,302,302,18,8,10,3,2
28,303,303,55,55,0,1,0
7,316,316,19,19,0,1,0
12,318,318,58,58,0,1,0
23,345,345,53,53,0,1,0
20,387,387,8,8,0,1,0
27,391,391,12,4,8,2,1
4,406,406,2,2,0,1,0
21,410,410,40,2,38,2,1
2,412,412,3,3,0,1,0
22,423,423,35,35,0,1,0
0,426,426,45,45,0,1,0
13,441,441,78,27,51,4,3
9,447,447,56,28,28,2,1
24,451,451,9,3,6,3,2
17,486,486,32,32,0,1,0
14,497,497,5,5,0,1,0
26,498,498,77,77,0,1,0

3,105,105,12,3,9,4,3
17,122,122,1,1,0,1,0
20,128,128,6,6,0,1,0
13,132,132,4,1,3,2,1
6,135,135,12,12,0,1,0
16,150,150,43,25,18,2,1
22,159,159,21,2,19,2,1
28,174,174,5,5,0,1,0
19,215,215,32,23,9,2,1
15,228,228,55,55,0,1,0
8,238,238,60,21,39,2,1
5,246,246,1,1,0,1,0
7,249,249,8,5,3,2,1
24,253,253,45,17,28,2,1
18,263,263,31,15,16,2,1
10,277,277,31,9,22,2,1
0,288,288,4,4,0,1,0
12,309,309,45,45,0,1,0
21,318,318,10,10,0,1,0
26,318,318,20,20,0,1,0
9,348,348,8,8,0,1,0
1,372,372,38,38,0,1,0
27,405,405,45,4,41,4,3
4,412,412,53,53,0,1,0
2,460,460,1,1,0,1,0
25,478,478,80,2,78,3,2
11,487,487,5,5,0,1,0
23,489,489,1,1,0,1,0
14,498,498,1,1,0,1,0

7,101,101,11,11,0,1,0
24,123,123,2,2,0,1,0
18,129,129,32,29,3,2,1
19,134,134,12,12,0,1,0
27,139,139,41,15,26,2,1
22,149,149,15,6,9,2,1
15,161,161,1,1,0,1,0
20,165,165,2,2,0,1,0
0,173,173,2,2,0,1,0
25,174,174,9,3,6,3,2
23,187,187,24,10,14,3,2
10,200,200,53,47,6,3,2
28,205,205,4,1,3,2,1
17,237,237,7,7,0,1,0
12,268,268,15,15,0,1,0
1,271,271,8,2,6,2,1
14,274,274,18,6,12,3,2
3,292,292,9,9,0,1,0
21,306,306,59,23,36,4,3
11,314,314,1,1,0,1,0
13,328,328,4,1,3,2,1
30,357,357,13,6,7,2,1
8,370,370,4,1,3,2,1
26,371,371,11,11,0,1,0
16,422,422,70,1,69,3,2
2,430,430,10,10,0,1,0
4,437,437,118,33,85,3,2
9,455,455,5,5,0,1,0
6,464,464,80,50,30,3,2
5,479,479,14,8,6,2,1
29,480,480,62,41,21,4,3

12,104,104,5,5,0,1,0
19,107,107,5,5,0,1,0
25,108,108,7,3,4,2,1
23,110,110,8,8,0,1,0
11,132,132,25,25,0,1,0
16,169,169,3,3,0,1,0
14,178,178,36,7,29,2,1
26,187,187,20,20,0,1,0
21,201,201,11,11,0,1,0
17,215,215,3,3,0,1,0
3,218,218,2,2,0,1,0
6,231,231,9,9,0,1,0
4,276,276,8,2,6,3,2
9,295,295,80,44,36,2,1
7,298,298,38,38,0,1,0
10,308,308,9,6,3,2,1
1,327,327,5,5,0,1,0
22,331,331,39,39,0,1,0
5,335,335,1,1,0,1,0
24,361,361,93,28,65,3,2
18,399,399,34,20,14,2,1
20,418,418,47,47,0,1,0
8,426,426,80,80,0,1,0
2,443,443,4,1,3,2,1
0,452,452,124,74,50,3,2
13,454,454,31,31,0,1,0
15,476,476,87,69,18,4,3

19,123,123,28,19,9,2,1
22,136,136,13,13,0,1,0
12,161,161,43,43,0,1,0
20,192,192,14,14,0,1,0
14,195,195,23,23,0,1,0
11,217,217,51,23,28,3,2
6,240,240,3,3,0,1,0
7,245,245,1,1,0,1,0
21,285,285,2,2,0,1,0
13,292,292,8,8,0,1,0
3,292,292,86,2,84,4,3
8,332,332,28,21,7,2,1
5,350,350,4,4,0,1,0
1,359,359,97,15,82,4,3
17,368,368,37,27,10,3,2
16,380,380,25,25,0,1,0
2,391,391,35,35,0,1,0
15,416,416,20,14,6,3,2
23,424,424,30,30,0,1,0
18,443,443,1,1,0,1,0
10,452,452,85,77,8,3,2
4,472,472,69,47,22,3,2
9,493,493,56,34,22,2,1
0,498,498,43,12,31,2,1

25,105,105,10,10,0,1,0
7,128,128,2,2,0,1,0
0,136,136,8,8,0,1,0
15,152,152,40,19,21,4,3
6,177,177,42,6,36,2,1
2,192,192,21,13,8,3,2
23,196,196,10,10,0,1,0
24,197,197,17,3,14,3,2
8,198,198,9,1,8,3,2
3,216,216,33,33,0,1,0
20,221,221,4,4,0,1,0
18,237,237,44,36,8,2,1
21,257,257,10,10,0,1,0
17,271,271,3,3,0,1,0
11,284,284,28,2,26,2,1
4,288,288,3,3,0,1,0
14,301,301,78,23,55,3,2
5,325,325,14,14,0,1,0
22,334,334,1,1,0,1,0
1,336,336,7,7,0,1,0
19,352,352,16,16,0,1,0
26,373,373,62,62,0,1,0
10,406,406,6,6,0,1,0
16,410,410,39,15,24,2,1
13,412,412,62,50,12,4,3
12,455,455,52,52,0,1,0
9,487,487,112,112,0,1,0

10,101,101,32,32,0,1,0
18,137,137,9,9,0,1,0
25,148,148,14,8,6,3,2
4,152,152,32,3,29,2,1
9,211,211,28,28,0,1,0
14,218,218,6,6,0,1,0
5,223,223,23,23,0,1,0
24,258,258,59,29,30,4,3
15,260,260,26,26,0,1,0
17,264,264,7,7,0,1,0
16,276,276,35,35,0,1,0
19,277,277,37,19,18,2,1
1,284,284,34,34,0,1,0
20,294,294,62,14,48,4,3
8,316,316,23,13,10,3,2
6,343,343,7,7,0,1,0
7,345,345,31,31,0,1,0
3,347,347,14,14,0,1,0
12,372,372,7,7,0,1,0
21,393,393,7,7,0,1,0
23,398,398,4,4,0,1,0
0,400,400,20,20,0,1,0
13,450,450,115,115,0,1,0
22,458,458,12,12,0,1,0
2,472,472,1,1,0,1,0
11,494,494,61,24,37,2,1

1,104,104,7,7,0,1,0
25,109,109,4,4,0,1,0
14,113,113,21,2,19,2,1
19,119,119,8,5,3,2,1
16,143,143,19,3,16,3,2
6,156,156,34,34,0,1,0
12,227,227,4,4,0,1,0
2,234,234,3,3,0,1,0
10,308,308,34,34,0,1,0
5,311,311,71,71,0,1,0
15,316,316,12,6,6,2,1
3,323,323,24,16,8,3,2
0,348,348,5,5,0,1,0
11,353,353,79,79,0,1,0
9,363,363,9,2,7,2,1
17,382,382,22,5,17,2,1
20,391,391,50,50,0,1,0
13,411,411,6,6,0,1,0
24,422,422,13,5,8,2,1
8,428,428,32,12,20,4,3
22,430,430,213,141,72,3,2
7,431,431,92,2,90,4,3
23,433,433,50,50,0,1,0
4,447,447,10,10,0,1,0
18,483,483,8,4,4,2,1
21,499,499,5,5,0,1,0

9,116,116,13,2,11,2,1
15,144,144,12,12,0,1,0
23,152,152,1,1,0,1,0
16,166,166,22,2,20,3,2
8,167,167,1,1,0,1,0
2,185,185,40,40,0,1,0
7,186,186,25,4,21,4,3
5,187,187,66,66,0,1,0
22,211,211,11,11,0,1,0
12,231,231,71,28,43,2,1
14,239,239,9,9,0,1,0
4,239,239,14,11,3,2,1
17,265,265,16,7,9,2,1
0,280,280,12,12,0,1,0
11,326,326,12,12,0,1,0
13,352,352,8,8,0,1,0
6,371,371,2,2,0,1,0
20,381,381,41,23,18,2,1
10,415,415,30,30,0,1,0
18,427,427,59,59,0,1,0
3,440,440,62,22,40,2,1
19,459,459,156,138,18,4,3
1,460,460,73,73,0,1,0
21,472,472,3,3,0,1,0

7,110,110,3,3,0,1,0
18,110,110,5,2,3,2,1
12,113,113,5,5,0,1,0
16,120,120,6,6,0,1,0
8,138,138,6,6,0,1,0
30,170,170,10,10,0,1,0
1,235,235,8,8,0,1,0
15,241,241,34,1,33,4,3
0,276,276,99,99,0,1,0
5,285,285,37,37,0,1,0
9,293,293,5,5,0,1,0
32,302,302,3,3,0,1,0
21,303,303,36,36,0,1,0
2,310,310,54,54,0,1,0
4,316,316,1,1,0,1,0
28,321,321,57,31,26,3,2
29,327,327,128,56,72,4,3
14,334,334,16,3,13,4,3
20,334,334,21,7,14,3,2
13,342,342,2,2,0,1,0
26,391,391,2,2,0,1,0
25,396,396,22,22,0,1,0
3,410,410,26,7,19,4,3
19,413,413,5,5,0,1,0
27,418,418,32,22,10,3,2
22,456,456,72,39,33,2,1
10,461,461,15,5,10,2,1
6,464,464,28,7,21,4,3
31,471,471,28,10,18,4,3
23,474,474,24,24,0,1,0
11,488,488,1,1,0,1,0
17,494,494,4,4,0,1,0
24,496,496,45,17,28,3,2

7,118,118,6,6,0,1,0
17,119,119,1,1,0,1,0
18,135,135,66,66,0,1,0
1,139,139,18,18,0,1,0
16,157,157,37,37,0,1,0
5,174,174,94,94,0,1,0
9,226,226,14,4,10,3,2
8,249,249,7,7,0,1,0
19,254,254,13,13,0,1,0
20,265,265,18,18,0,1,0
6,308,308,40,40,0,1,0
0,350,350,73,59,14,2,1
15,353,353,18,18,0,1,0
12,400,400,44,26,18,3,2
3,406,406,29,5,24,3,2
2,411,411,4,4,0,1,0
4,420,420,70,38,32,2,1
14,432,432,5,5,0,1,0
11,433,433,18,18,0,1,0
13,454,454,19,8,11,2,1
10,459,459,60,54,6,2,1

1,118,118,4,4,0,1,0
5,135,135,7,4,3,2,1
20,183,183,25,25,0,1,0
6,202,202,24,4,20,2,1
9,209,209,24,24,0,1,0
13,212,212,69,30,39,2,1
3,224,224,6,2,4,2,1
18,232,232,10,10,0,1,0
4,237,237,8,3,5,2,1
11,239,239,48,14,34,2,1
24,252,252,1,1,0,1,0
16,253,253,19,3,16,3,2
8,266,266,7,7,0,1,0
2,322,322,76,76,0,1,0
21,323,323,68,68,0,1,0
10,347,347,7,7,0,1,0
0,351,351,16,16,0,1,0
23,369,369,19,19,0,1,0
17,371,371,18,9,9,4,3
12,376,376,18,18,0,1,0
15,386,386,30,30,0,1,0
14,386,386,6,3,3,2,1
7,411,411,8,8,0,1,0
25,425,425,37,37,0,1,0
22,435,435,9,9,0,1,0
26,450,450,30,30,0,1,0
19,452,452,218,152,66,3,2

6,105,105,15,3,12,2,1
0,106,106,2,2,0,1,0
8,107,107,1,1,0,1,0
7,115,115,1,1,0,1,0
20,159,159,6,6,0,1,0
4,162,162,15,15,0,1,0
19,186,186,24,5,19,2,1
17,203,203,1,1,0,1,0
2,224,224,8,8,0,1,0
14,225,225,3,3,0,1,0
9,238,238,13,13,0,1,0
25,243,243,29,29,0,1,0
16,291,291,15,15,0,1,0
11,292,292,63,63,0,1,0
10,312,312,7,1,6,2,1
13,315,315,14,14,0,1,0
21,317,317,38,2,36,3,2
15,335,335,56,56,0,1,0
12,350,350,43,40,3,2,1
5,352,352,28,28,0,1,0
28,382,382,43,43,0,1,0
23,391,391,86,11,75,4,3
27,398,398,5,2,3,2,1
18,401,401,40,22,18,2,1
3,406,406,94,68,26,2,1
26,411,411,115,94,21,2,1
24,436,436,25,25,0,1,0
1,474,474,20,1,19,2,1
22,481,481,38,38,0,1,0

15,135,135,6,6,0,1,0
16,144,144,24,24,0,1,0
5,164,164,1,1,0,1,0
3,171,171,35,19,16,2,1
4,182,182,13,3,10,3,2
11,190,190,14,14,0,1,0
1,196,196,29,29,0,1,0
7,218,218,10,4,6,2,1
0,237,237,83,39,44,2,1
2,239,239,107,79,28,3,2
12,354,354,41,41,0,1,0
9,375,375,8,8,0,1,0
10,381,381,10,2,8,3,2
8,448,448,7,7,0,1,0
6,453,453,13,4,9,4,3
14,458,458,55,55,0,1,0
18,461,461,7,1,6,3,2
20,467,467,11,11,0,1,0
17,475,475,63,63,0,1,0
13,490,490,149,140,9,4,3
19,497,497,129,129,0,1,0

27,110,110,4,4,0,1,0
0,113,113,16,16,0,1,0
10,129,129,7,7,0,1,0
6,131,131,1,1,0,1,0
25,135,135,12,12,0,1,0
18,136,136,11,11,0,1,0
21,147,147,3,3,0,1,0
11,160,160,1,1,0,1,0
4,165,165,1,1,0,1,0
5,169,169,9,1,8,2,1
2,169,169,27,27,0,1,0
8,171,171,11,11,0,1,0
13,231,231,33,33,0,1,0
1,245,245,37,37,0,1,0
29,264,264,70,11,59,4,3
20,302,302,55,23,32,2,1
28,306,306,23,4,19,2,1
12,313,313,10,2,8,2,1
24,344,344,56,56,0,1,0
26,348,348,23,23,0,1,0
9,367,367,12,2,10,3,2
16,382,382,1,1,0,1,0
22,406,406,4,1,3,2,1
23,429,429,107,107,0,1,0
30,432,432,23,20,3,2,1
19,434,434,15,15,0,1,0
3,435,435,76,60,16,3,2
14,441,441,13,1,12,3,2
7,453,453,27,5,22,2,1
17,479,479,45,18,27,2,1
15,491,491,44,5,39,2,1

23,124,124,4,4,0,1,0
12,143,143,4,4,0,1,0
0,147,147,9,9,0,1,0
21,155,155,10,6,4,2,1
14,168,168,32,32,0,1,0
19,189,189,11,3,8,3,2
3,195,195,4,4,0,1,0
15,225,225,12,4,8,3,2
25,241,241,16,8,8,2,1
26,244,244,6,6,0,1,0
9,252,252,69,57,12,3,2
22,279,279,20,13,7,2,1
20,284,284,31,10,21,4,3
8,309,309,4,4,0,1,0
2,315,315,21,12,9,4,3
6,329,329,13,13,0,1,0
13,333,333,8,8,0,1,0
18,346,346,80,54,26,3,2
1,352,352,13,1,12,4,3
11,356,356,24,24,0,1,0
7,361,361,64,11,53,3,2
24,362,362,27,27,0,1,0
4,380,380,9,9,0,1,0
17,396,396,92,35,57,4,3
16,438,438,53,53,0,1,0
10,440,440,49,49,0,1,0
5,476,476,170,170,0,1,0

26,108,108,24,3,21,2,1
25,111,111,7,7,0,1,0
12,116,116,3,3,0,1,0
19,134,134,25,25,0,1,0
17,169,169,22,6,16,2,1
24,191,191,15,5,10,3,2
2,208,208,1,1,0,1,0
8,245,245,1,1,0,1,0
27,247,247,8,8,0,1,0
16,260,260,74,17,57,4,3
0,261,261,3,3,0,1,0
20,262,262,31,31,0,1,0
18,272,272,9,2,7,2,1
4,275,275,5,5,0,1,0
1,301,301,6,6,0,1,0
6,318,318,5,5,0,1,0
9,363,363,179,179,0,1,0
23,408,408,14,5,9,2,1
14,421,421,7,7,0,1,0
3,424,424,151,77,74,4,3
21,432,432,23,23,0,1,0
11,456,456,5,5,0,1,0
7,458,458,14,8,6,2,1
5,475,475,83,38,45,4,3
13,476,476,40,40,0,1,0
22,480,480,16,6,10,2,1
15,485,485,27,27,0,1,0
10,499,499,17,1,16,2,1

16,141,141,3,3,0,1,0
11,153,153,9,9,0,1,0
12,155,155,1,1,0,1,0
15,168,168,12,12,0,1,0
22,168,168,9,3,6,2,1
9,195,195,15,15,0,1,0
19,211,211,45,45,0,1,0
10,211,211,42,42,0,1,0
17,224,224,49,49,0,1,0
5,235,235,32,22,10,3,2
4,249,249,34,29,5,2,1
20,260,260,16,4,12,3,2
18,276,276,33,4,29,2,1
3,280,280,14,3,11,2,1
2,293,293,6,3,3,2,1
14,338,338,63,12,51,4,3
7,345,345,13,13,0,1,0
25,357,357,3,3,0,1,0
23,376,376,63,58,5,2,1
26,381,381,45,11,34,2,1
13,395,395,13,1,12,4,3
21,396,396,1,1,0,1,0
6,401,401,41,41,0,1,0
0,429,429,14,14,0,1,0
24,436,436,51,29,22,3,2
8,464,464,103,13,90,4,3
1,494,494,1,1,0,1,0
27,495,495,75,67,8,3,2

11,142,142,8,8,0,1,0
18,156,156,13,13,0,1,0
26,172,172,2,2,0,1,0
7,200,200,8,2,6,2,1
22,204,204,1,1,0,1,0
28,212,212,50,10,40,2,1
0,215,215,5,2,3,2,1
23,240,240,6,3,3,2,1
27,245,245,46,13,33,4,3
30,253,253,2,2,0,1,0
10,253,253,22,11,11,2,1
5,255,255,37,8,29,2,1
2,282,282,1,1,0,1,0
24,318,318,45,45,0,1,0
25,348,348,23,23,0,1,0
1,365,365,1,1,0,1,0
3,365,365,1,1,0,1,0
9,365,365,31,31,0,1,0
14,394,394,8,1,7,2,1
4,399,399,42,42,0,1,0
16,405,405,41,41,0,1,0
8,429,429,112,112,0,1,0
13,444,444,44,29,15,2,1
21,445,445,19,10,9,4,3
15,451,451,11,11,0,1,0
17,459,459,5,5,0,1,0
20,461,461,72,72,0,1,0
29,473,473,127,127,0,1,0
12,476,476,94,4,90,3,2
19,490,490,47,47,0,1,0
6,499,499,18,18,0,1,0

12,104,104,7,2,5,2,1
25,126,126,4,1,3,2,1
22,141,141,5,5,0,1,0
13,146,146,7,7,0,1,0
1,149,149,53,53,0,1,0
10,176,176,1,1,0,1,0
17,178,178,66,66,0,1,0
18,185,185,21,21,0,1,0
20,186,186,3,3,0,1,0
11,218,218,29,29,0,1,0
6,220,220,16,16,0,1,0
0,244,244,21,21,0,1,0
4,285,285,44,15,29,2,1
24,392,392,70,70,0,1,0
19,394,394,20,20,0,1,0
9,409,409,53,7,46,2,1
16,414,414,32,32,0,1,0
14,442,442,9,4,5,2,1
2,444,444,66,40,26,2,1
21,447,447,70,27,43,2,1
23,448,448,36,9,27,4,3
8,471,471,54,15,39,4,3
15,478,478,69,69,0,1,0
7,482,482,3,3,0,1,0
3,483,483,3,3,0,1,0
5,487,487,14,14,0,1,0

13,114,114,4,4,0,1,0
23,115,115,19,19,0,1,0
24,143,143,6,6,0,1,0
10,155,155,14,14,0,1,0
4,159,159,24,10,14,3,2
7,213,213,15,15,0,1,0
29,223,223,17,3,14,3,2
19,235,235,53,53,0,1,0
28,238,238,3,3,0,1,0
20,252,252,20,20,0,1,0
22,264,264,4,4,0,1,0
11,268,268,25,13,12,3,2
27,271,271,6,1,5,2,1
3,294,294,35,29,6,3,2
12,309,309,23,23,0,1,0
21,310,310,14,14,0,1,0
18,319,319,28,28,0,1,0
26,335,335,39,39,0,1,0
14,344,344,27,5,22,3,2
16,346,346,10,10,0,1,0
15,352,352,1,1,0,1,0
30,359,359,24,24,0,1,0
17,363,363,20,20,0,1,0
8,375,375,5,5,0,1,0
0,378,378,16,16,0,1,0
1,379,379,21,3,18,3,2
2,388,388,1,1,0,1,0
25,396,396,34,10,24,4,3
9,409,409,110,89,21,4,3
31,444,444,166,166,0,1,0
6,487,487,14,5,9,4,3
5,489,489,2,2,0,1,0

16,110,110,1,1,0,1,0
0,200,200,23,23,0,1,0
6,202,202,89,3,86,3,2
21,206,206,21,21,0,1,0
13,206,206,6,6,0,1,0
19,211,211,59,59,0,1,0
20,220,220,4,4,0,1,0
17,245,245,40,36,4,2,1
18,268,268,10,10,0,1,0
7,268,268,1,1,0,1,0
2,287,287,9,9,0,1,0
11,304,304,28,15,13,2,1
15,308,308,4,4,0,1,0
9,327,327,35,35,0,1,0
1,371,371,3,3,0,1,0
8,373,373,31,10,21,2,1
12,377,377,1,1,0,1,0
23,378,378,69,15,54,4,3
5,421,421,107,75,32,3,2
3,426,426,2,2,0,1,0
22,437,437,18,18,0,1,0
10,444,444,91,4,87,4,3
4,469,469,23,23,0,1,0
14,485,485,172,160,12,2,1

19,119,119,6,6,0,1,0
17,139,139,12,12,0,1,0
11,167,167,6,6,0,1,0
10,173,173,39,3,36,4,3
25,182,182,29,16,13,2,1
7,194,194,15,1,14,2,1
6,199,199,24,24,0,1,0
2,212,212,2,2,0,1,0
0,217,217,14,2,12,2,1
24,219,219,4,4,0,1,0
9,219,219,6,6,0,1,0
22,221,221,2,2,0,1,0
16,232,232,19,19,0,1,0
5,236,236,11,2,9,4,3
4,241,241,52,27,25,2,1
13,243,243,53,38,15,4,3
23,245,245,53,53,0,1,0
8,254,254,25,6,19,2,1
14,264,264,88,48,40,2,1
15,282,282,5,5,0,1,0
20,303,303,59,35,24,4,3
21,316,316,24,24,0,1,0
12,331,331,3,3,0,1,0
1,333,333,33,33,0,1,0
26,353,353,12,12,0,1,0
3,424,424,23,4,19,2,1
18,498,498,24,24,0,1,0

21,109,109,2,2,0,1,0
3,136,136,23,11,12,2,1
0,144,144,20,8,12,2,1
8,186,186,19,19,0,1,0
17,198,198,7,7,0,1,0
18,216,216,21,13,8,2,1
5,225,225,44,44,0,1,0
7,236,236,1,1,0,1,0
6,280,280,81,45,36,2,1
19,312,312,109,58,51,4,3
11,326,326,15,9,6,2,1
14,346,346,12,7,5,2,1
9,370,370,23,23,0,1,0
15,373,373,41,41,0,1,0
10,384,384,86,56,30,2,1
2,387,387,38,38,0,1,0
16,413,413,6,6,0,1,0
20,421,421,72,29,43,2,1
12,434,434,62,62,0,1,0
4,436,436,28,28,0,1,0
1,461,461,112,68,44,2,1
13,491,491,10,4,6,2,1

8,134,134,3,3,0,1,0
2,152,152,36,36,0,1,0
21,154,154,1,1,0,1,0
31,166,166,5,5,0,1,0
5,186,186,32,29,3,2,1
17,191,191,12,12,0,1,0
10,203,203,21,11,10,2,1
24,205,205,21,4,17,2,1
11,207,207,9,2,7,2,1
29,212,212,5,1,4,2,1
9,217,217,7,3,4,2,1
7,223,223,18,18,0,1,0
19,258,258,22,9,13,2,1
0,276,276,50,6,44,2,1
6,280,280,4,4,0,1,0
25,282,282,3,3,0,1,0
15,334,334,20,12,8,3,2
12,364,364,2,2,0,1,0
22,380,380,7,7,0,1,0
23,386,386,264,236,28,3,2
13,390,390,1,1,0,1,0
16,402,402,44,44,0,1,0
27,403,403,33,33,0,1,0
20,407,407,26,26,0,1,0
30,412,412,78,78,0,1,0
18,413,413,9,6,3,2,1
14,441,441,2,2,0,1,0
3,443,443,42,42,0,1,0
28,463,463,3,3,0,1,0
26,472,472,10,6,4,2,1
1,483,483,12,12,0,1,0
4,493,493,14,3,11,2,1

18,104,104,13,3,10,2,1
0,105,105,18,18,0,1,0
5,138,138,10,10,0,1,0
19,143,143,4,1,3,2,1
14,149,149,6,6,0,1,0
20,169,169,35,11,24,4,3
23,188,188,5,5,0,1,0
2,189,189,36,1,35,2,1
24,201,201,37,37,0,1,0
15,223,223,21,10,11,2,1
22,242,242,18,18,0,1,0
12,248,248,16,8,8,3,2
1,253,253,3,3,0,1,0
25,269,269,6,6,0,1,0
10,307,307,1,1,0,1,0
4,335,335,1,1,0,1,0
17,362,362,16,1,15,2,1
8,380,380,44,44,0,1,0
16,404,404,34,13,21,4,3
3,412,412,33,33,0,1,0
9,419,419,49,49,0,1,0
11,438,438,25,13,12,2,1
21,448,448,70,36,34,3,2
6,454,454,31,31,0,1,0
7,459,459,74,74,0,1,0
13,476,476,88,88,0,1,0
26,500,500,116,26,90,3,2

5,105,105,5,5,0,1,0
12,126,126,32,1,31,2,1
8,142,142,2,2,0,1,0
22,145,145,14,2,12,4,3
4,151,151,3,3,0,1,0
16,152,152,11,11,0,1,0
6,153,153,3,3,0,1,0
18,153,153,13,13,0,1,0
20,177,177,2,2,0,1,0
9,231,231,30,12,18,2,1
13,253,253,5,5,0,1,0
3,261,261,26,26,0,1,0
0,266,266,7,7,0,1,0
11,268,268,15,3,12,3,2
14,314,314,9,9,0,1,0
28,326,326,16,16,0,1,0
1,339,339,92,92,0,1,0
26,343,343,118,118,0,1,0
15,376,376,15,15,0,1,0
10,376,376,2,2,0,1,0
21,395,395,48,48,0,1,0
23,398,398,10,10,0,1,0
24,404,404,37,20,17,2,1
2,406,406,82,69,13,2,1
27,444,444,69,69,0,1,0
25,456,456,31,31,0,1,0
7,460,460,31,31,0,1,0
19,496,496,62,51,11,2,1
17,497,497,43,20,23,4,3

15,105,105,10,5,5,2,1
13,108,108,2,2,0,1,0
27,131,131,3,3,0,1,0
12,167,167,28,28,0,1,0
23,168,168,15,2,13,2,1
5,177,177,14,2,12,4,3
14,177,177,7,7,0,1,0
16,181,181,33,33,0,1,0
20,224,224,17,4,13,2,1
2,225,225,2,2,0,1,0
22,226,226,20,20,0,1,0
21,231,231,17,8,9,4,3
10,235,235,63,63,0,1,0
25,271,271,17,1,16,3,2
24,281,281,36,36,0,1,0
0,284,284,12,12,0,1,0
3,288,288,3,3,0,1,0
6,295,295,38,7,31,4,3
8,296,296,27,11,16,2,1
26,296,296,5,2,3,2,1
9,337,337,41,25,16,3,2
11,403,403,66,31,35,2,1
4,433,433,20,2,18,4,3
1,434,434,48,12,36,2,1
19,446,446,55,55,0,1,0
18,449,449,45,3,42,3,2
17,455,455,124,110,14,2,1
7,492,492,4,1,3,2,1

22,122,122,6,6,0,1,0
1,130,130,1,1,0,1,0
18,144,144,7,7,0,1,0
6,147,147,1,1,0,1,0
12,158,158,3,3,0,1,0
0,161,161,4,4,0,1,0
19,173,173,9,9,0,1,0
4,188,188,8,8,0,1,0
8,210,210,14,14,0,1,0
3,214,214,34,34,0,1,0
11,222,222,55,18,37,2,1
10,227,227,10,10,0,1,0
21,244,244,6,6,0,1,0
15,256,256,4,4,0,1,0
17,307,307,87,63,24,4,3
25,309,309,42,42,0,1,0
13,314,314,37,37,0,1,0
7,316,316,60,2,58,4,3
24,347,347,30,18,12,4,3
14,357,357,27,27,0,1,0
20,369,369,110,11,99,4,3
9,383,383,2,2,0,1,0
16,393,393,40,24,16,2,1
5,448,448,211,187,24,3,2
23,457,457,17,13,4,2,1
2,480,480,9,9,0,1,0

21,102,102,30,30,0,1,0
5,102,102,4,4,0,1,0
22,103,103,28,2,26,3,2
24,124,124,6,1,5,2,1
13,137,137,18,18,0,1,0
4,145,145,4,1,3,2,1
9,150,150,13,1,12,4,3
23,164,164,17,17,0,1,0
18,204,204,14,14,0,1,0
20,215,215,42,42,0,1,0
14,226,226,4,4,0,1,0
17,239,239,15,10,5,2,1
6,272,272,18,1,17,2,1
16,272,272,1,1,0,1,0
8,292,292,17,7,10,3,2
3,301,301,63,31,32,3,2
10,317,317,102,81,21,2,1
11,353,353,6,6,0,1,0
12,371,371,28,17,11,2,1
15,394,394,22,22,0,1,0
0,408,408,71,9,62,3,2
1,414,414,48,48,0,1,0
19,438,438,5,5,0,1,0
2,443,443,34,34,0,1,0
7,445,445,49,49,0,1,0

10,119,119,2,2,0,1,0
19,134,134,66,66,0,1,0
21,137,137,19,19,0,1,0
13,146,146,5,5,0,1,0
2,148,148,1,1,0,1,0
11,150,150,35,35,0,1,0
22,157,157,16,5,11,4,3
5,184,184,24,7,17,2,1
4,188,188,6,6,0,1,0
17,224,224,2,2,0,1,0
3,232,232,46,46,0,1,0
9,310,310,63,63,0,1,0
1,313,313,31,27,4,2,1
7,320,320,8,8,0,1,0
8,330,330,106,1,105,4,3
6,332,332,16,16,0,1,0
18,332,332,24,24,0,1,0
0,342,342,75,75,0,1,0
15,346,346,8,8,0,1,0
20,356,356,5,5,0,1,0
23,376,376,39,13,26,3,2
14,413,413,25,7,18,2,1
12,430,430,8,8,0,1,0
16,491,491,10,10,0,1,0

4,103,103,9,9,0,1,0
7,141,141,21,21,0,1,0
11,152,152,7,7,0,1,0
15,154,154,4,4,0,1,0
19,166,166,9,9,0,1,0
13,166,166,34,25,9,2,1
12,180,180,49,38,11,2,1
20,185,185,4,4,0,1,0
0,194,194,1,1,0,1,0
1,232,232,8,8,0,1,0
2,249,249,17,17,0,1,0
8,258,258,21,12,9,4,3
17,260,260,5,5,0,1,0
5,286,286,14,14,0,1,0
3,320,320,122,68,54,4,3
10,320,320,11,11,0,1,0
14,347,347,11,5,6,3,2
18,379,379,56,56,0,1,0
16,390,390,11,11,0,1,0
23,421,421,25,25,0,1,0
21,432,432,68,10,58,3,2
6,433,433,125,83,42,4,3
24,437,437,68,68,0,1,0
22,465,465,66,66,0,1,0
9,498,498,38,16,22,3,2

22,102,102,6,6,0,1,0
12,108,108,8,1,7,2,1
5,114,114,6,6,0,1,0
26,116,116,24,15,9,2,1
29,136,136,9,9,0,1,0
18,144,144,25,16,9,2,1
20,145,145,25,17,8,2,1
10,166,166,58,58,0,1,0
3,167,167,12,6,6,2,1
1,212,212,4,4,0,1,0
7,223,223,31,24,7,2,1
17,233,233,7,7,0,1,0
24,238,238,10,10,0,1,0
16,259,259,9,9,0,1,0
4,300,300,1,1,0,1,0
21,343,343,27,27,0,1,0
28,376,376,2,2,0,1,0
23,381,381,10,6,4,2,1
13,398,398,4,4,0,1,0
9,412,412,25,10,15,4,3
6,427,427,5,2,3,2,1
15,432,432,57,57,0,1,0
14,435,435,20,20,0,1,0
11,437,437,5,5,0,1,0
19,446,446,112,93,19,2,1
27,456,456,88,58,30,3,2
25,474,474,11,11,0,1,0
2,481,481,26,26,0,1,0
8,495,495,18,13,5,2,1
0,500,500,98,17,81,4,3

14,123,123,1,1,0,1,0
4,155,155,31,31,0,1,0
7,159,159,18,4,14,2,1
19,162,162,31,31,0,1,0
28,165,165,4,4,0,1,0
16,167,167,6,2,4,2,1
12,170,170,21,21,0,1,0
20,175,175,13,5,8,2,1
5,227,227,3,3,0,1,0
23,233,233,1,1,0,1,0
0,249,249,9,3,6,3,2
3,281,281,59,20,39,4,3
2,287,287,1,1,0,1,0
1,313,313,34,34,0,1,0
21,318,318,45,45,0,1,0
17,339,339,19,10,9,2,1
9,340,340,1,1,0,1,0
10,354,354,85,85,0,1,0
26,383,383,29,26,3,2,1
11,416,416,2,2,0,1,0
22,425,425,16,16,0,1,0
18,428,428,85,85,0,1,0
15,430,430,42,4,38,2,1
25,433,433,83,51,32,2,1
13,435,435,9,9,0,1,0
24,470,470,18,5,13,2,1
8,475,475,41,41,0,1,0
6,491,491,16,16,0,1,0
27,499,499,129,102,27,4,3

22,104,104,19,19,0,1,0
19,135,135,1,1,0,1,0
16,138,138,30,10,20,2,1
1,144,144,1,1,0,1,0
4,171,171,46,46,0,1,0
2,184,184,1,1,0,1,0
9,185,185,27,27,0,1,0
8,204,204,28,13,15,4,3
0,223,223,86,7,79,3,2
21,237,237,15,1,14,3,2
14,264,264,10,10,0,1,0
10,287,287,2,2,0,1,0
5,341,341,18,15,3,2,1
12,349,349,104,99,5,2,1
17,352,352,34,13,21,4,3
6,401,401,23,15,8,3,2
23,404,404,21,11,10,3,2
11,405,405,8,8,0,1,0
20,409,409,52,14,38,3,2
3,411,411,70,37,33,4,3
13,439,439,23,14,9,4,3
7,461,461,29,29,0,1,0
18,464,464,48,48,0,1,0
15,472,472,33,6,27,3,2

14,114,114,14,6,8,3,2
19,121,121,3,3,0,1,0
16,134,134,19,19,0,1,0
13,137,137,3,3,0,1,0
1,148,148,68,35,33,2,1
7,210,210,25,1,24,2,1
21,213,213,19,2,17,2,1
8,216,216,17,7,10,2,1
0,263,263,43,43,0,1,0
6,283,283,79,79,0,1,0
2,300,300,2,2,0,1,0
12,326,326,43,14,29,2,1
17,371,371,31,12,19,2,1
5,396,396,1,1,0,1,0
20,403,403,92,92,0,1,0
18,408,408,9,2,7,2,1
15,438,438,10,2,8,2,1
9,453,453,115,33,82,3,2
10,461,461,59,59,0,1,0
4,471,471,84,72,12,2,1
3,481,481,7,7,0,1,0
11,482,482,25,25,0,1,0

22,115,115,7,7,0,1,0
20,122,122,29,11,18,3,2
12,143,143,6,6,0,1,0
0,145,145,49,49,0,1,0
8,186,186,45,45,0,1,0
24,194,194,16,16,0,1,0
21,225,225,43,25,18,3,2
25,266,266,29,29,0,1,0
4,269,269,30,30,0,1,0
18,283,283,19,19,0,1,0
14,295,295,12,6,6,3,2
19,324,324,11,11,0,1,0
16,325,325,85,85,0,1,0
15,330,330,10,10,0,1,0
17,352,352,24,24,0,1,0
13,370,370,33,4,29,4,3
9,394,394,5,5,0,1,0
23,406,406,19,10,9,4,3
1,409,409,1,1,0,1,0
5,418,418,31,17,14,2,1
2,418,418,35,23,12,3,2
6,425,425,15,3,12,3,2
11,439,439,68,33,35,4,3
3,448,448,49,49,0,1,0
7,458,458,1,1,0,1,0
10,468,468,43,43,0,1,0

8,111,111,8,8,0,1,0
17,117,117,7,7,0,1,0
18,118,118,3,3,0,1,0
21,130,130,23,4,19,3,2
3,198,198,8,8,0,1,0
14,198,198,26,10,16,2,1
10,247,247,25,25,0,1,0
0,256,256,82,37,45,2,1
5,261,261,10,10,0,1,0
7,285,285,10,5,5,2,1
20,287,287,35,6,29,3,2
16,314,314,73,6,67,3,2
9,330,330,80,44,36,4,3
1,331,331,15,15,0,1,0
11,339,339,45,45,0,1,0
22,351,351,5,5,0,1,0
6,354,354,16,16,0,1,0
24,381,381,27,6,21,2,1
15,382,382,21,21,0,1,0
4,385,385,19,1,18,4,3
12,387,387,3,3,0,1,0
13,415,415,49,49,0,1,0
19,445,445,78,78,0,1,0
2,472,472,84,84,0,1,0
23,497,497,65,20,45,4,3

13,102,102,12,12,0,1,0
18,108,108,5,5,0,1,0
2,133,133,6,6,0,1,0
1,152,152,21,2,19,4,3
0,154,154,9,3,6,2,1
5,159,159,28,28,0,1,0
19,203,203,43,4,39,4,3
4,207,207,44,23,21,4,3
21,235,235,38,38,0,1,0
9,247,247,13,6,7,2,1
14,247,247,32,18,14,4,3
22,273,273,24,24,0,1,0
16,291,291,51,51,0,1,0
15,291,291,28,28,0,1,0
12,293,293,72,24,48,4,3
8,300,300,1,1,0,1,0
10,321,321,7,7,0,1,0
3,355,355,7,7,0,1,0
17,385,385,61,4,57,3,2
11,397,397,57,15,42,4,3
25,399,399,1,1,0,1,0
6,421,421,31,31,0,1,0
23,424,424,22,22,0,1,0
20,439,439,31,31,0,1,0
7,475,475,53,53,0,1,0
24,485,485,5,5,0,1,0

14,121,121,5,5,0,1,0
9,143,143,4,4,0,1,0
5,170,170,7,2,5,2,1
3,184,184,5,2,3,2,1
1,202,202,19,19,0,1,0
13,209,209,85,13,72,3,2
7,229,229,10,10,0,1,0
21,257,257,15,5,10,2,1
10,283,283,14,10,4,2,1
16,295,295,47,9,38,3,2
8,301,301,108,100,8,3,2
24,301,301,33,33,0,1,0
18,317,317,50,41,9,4,3
17,321,321,2,2,0,1,0
12,332,332,7,7,0,1,0
22,346,346,39,39,0,1,0
20,347,347,17,2,15,4,3
4,365,365,99,18,81,4,3
15,366,366,32,6,26,2,1
0,370,370,15,15,0,1,0
2,375,375,25,13,12,2,1
11,393,393,91,91,0,1,0
23,424,424,5,5,0,1,0
19,435,435,29,29,0,1,0
25,455,455,27,14,13,2,1
6,464,464,13,13,0,1,0

21,117,117,5,5,0,1,0
11,146,146,31,19,12,4,3
8,146,146,19,19,0,1,0
16,152,152,5,5,0,1,0
13,160,160,2,2,0,1,0
12,175,175,16,16,0,1,0
5,201,201,16,16,0,1,0
19,213,213,2,2,0,1,0
1,222,222,25,25,0,1,0
15,255,255,45,45,0,1,0
3,274,274,17,4,13,4,3
24,310,310,50,15,35,2,1
14,316,316,5,2,3,2,1
2,321,321,64,10,54,4,3
18,344,344,13,3,10,2,1
25,351,351,1,1,0,1,0
9,354,354,13,1,12,3,2
7,363,363,72,72,0,1,0
26,368,368,22,22,0,1,0
27,371,371,87,47,40,3,2
20,383,383,14,14,0,1,0
6,407,407,1,1,0,1,0
22,411,411,101,9,92,4,3
23,448,448,55,29,26,2,1
10,452,452,18,1,17,2,1
17,460,460,74,74,0,1,0
0,461,461,9,3,6,3,2
4,469,469,41,41,0,1,0

6,118,118,9,9,0,1,0
22,119,119,5,5,0,1,0
3,133,133,9,9,0,1,0
17,168,168,2,2,0,1,0
1,170,170,4,1,3,2,1
21,179,179,40,25,15,4,3
4,182,182,18,2,16,2,1
20,187,187,2,2,0,1,0
14,194,194,3,3,0,1,0
0,237,237,16,16,0,1,0
15,243,243,6,6,0,1,0
25,247,247,47,47,0,1,0
8,277,277,4,4,0,1,0
18,292,292,11,11,0,1,0
26,302,302,11,11,0,1,0
10,325,325,63,63,0,1,0
7,337,337,27,27,0,1,0
27,339,339,37,23,14,3,2
12,346,346,2,2,0,1,0
23,366,366,24,24,0,1,0
13,381,381,23,17,6,3,2
11,382,382,174,146,28,2,1
24,419,419,149,116,33,4,3
5,435,435,1,1,0,1,0
16,444,444,106,106,0,1,0
28,448,448,5,1,4,2,1
2,470,470,52,13,39,4,3
9,492,492,2,2,0,1,0
19,493,493,1,1,0,1,0

17,103,103,5,5,0,1,0
23,111,111,1,1,0,1,0
10,120,120,2,2,0,1,0
36,124,124,3,3,0,1,0
32,129,129,24,10,14,3,2
18,143,143,4,4,0,1,0
15,157,157,12,1,11,2,1
19,176,176,3,3,0,1,0
0,179,179,17,17,0,1,0
13,184,184,26,26,0,1,0
25,196,196,2,2,0,1,0
16,201,201,1,1,0,1,0
5,201,201,7,3,4,2,1
8,213,213,5,5,0,1,0
24,220,220,46,12,34,4,3
30,242,242,21,16,5,2,1
37,243,243,34,34,0,1,0
28,248,248,15,7,8,2,1
21,249,249,9,9,0,1,0
4,258,258,5,5,0,1,0
22,281,281,32,32,0,1,0
12,293,293,3,3,0,1,0
34,308,308,68,49,19,2,1
7,315,315,18,18,0,1,0
20,345,345,4,4,0,1,0
6,362,362,16,10,6,2,1
3,376,376,33,6,27,2,1
1,383,383,14,2,12,4,3
9,386,386,37,37,0,1,0
29,415,415,24,16,8,2,1
11,432,432,3,3,0,1,0
2,435,435,6,6,0,1,0
26,448,448,30,19,11,2,1
27,481,481,6,6,0,1,0
31,482,482,8,8,0,1,0
33,486,486,133,124,9,4,3
14,487,487,32,32,0,1,0
35,499,499,85,21,64,3,2

4,135,135,8,8,0,1,0
15,141,141,21,15,6,3,2
7,162,162,12,12,0,1,0
17,162,162,9,9,0,1,0
2,178,178,3,3,0,1,0
0,182,182,57,57,0,1,0
11,231,231,12,12,0,1,0
5,241,241,41,41,0,1,0
10,264,264,7,7,0,1,0
14,295,295,22,22,0,1,0
12,299,299,34,8,26,2,1
19,313,313,37,37,0,1,0
3,339,339,79,41,38,4,3
8,356,356,78,78,0,1,0
6,362,362,38,38,0,1,0
9,368,368,43,43,0,1,0
21,426,426,32,32,0,1,0
1,453,453,50,50,0,1,0
20,467,467,181,157,24,4,3
13,477,477,4,4,0,1,0
16,483,483,69,69,0,1,0
18,486,486,2,2,0,1,0

16,118,118,14,14,0,1,0
13,122,122,22,4,18,4,3
15,152,152,17,17,0,1,0
11,180,180,38,17,21,4,3
23,189,189,17,17,0,1,0
3,195,195,22,22,0,1,0
19,208,208,5,5,0,1,0
12,209,209,7,3,4,2,1
17,211,211,16,16,0,1,0
6,229,229,23,23,0,1,0
24,250,250,48,48,0,1,0
14,278,278,31,31,0,1,0
26,279,279,5,1,4,2,1
10,305,305,103,89,14,3,2
22,307,307,86,52,34,2,1
2,337,337,21,21,0,1,0
8,340,340,11,11,0,1,0
21,349,349,11,11,0,1,0
20,366,366,19,19,0,1,0
7,395,395,29,6,23,2,1
25,406,406,36,36,0,1,0
18,408,408,55,55,0,1,0
5,421,421,40,40,0,1,0
0,438,438,12,1,11,2,1
4,471,471,1,1,0,1,0
1,486,486,7,1,6,2,1
9,496,496,12,12,0,1,0

18,104,104,3,3,0,1,0
1,111,111,6,6,0,1,0
6,114,114,1,1,0,1,0
30,120,120,7,7,0,1,0
26,129,129,34,34,0,1,0
24,158,158,22,22,0,1,0
8,159,159,3,3,0,1,0
20,163,163,31,31,0,1,0
27,169,169,2,2,0,1,0
31,191,191,12,12,0,1,0
32,198,198,14,14,0,1,0
9,238,238,7,2,5,2,1
3,239,239,1,1,0,1,0
15,247,247,12,12,0,1,0
0,259,259,11,2,9,2,1
4,296,296,1,1,0,1,0
14,336,336,17,13,4,2,1
5,344,344,9,3,6,2,1
11,346,346,31,31,0,1,0
23,350,350,5,5,0,1,0
17,353,353,11,7,4,2,1
21,357,357,9,9,0,1,0
13,363,363,41,23,18,4,3
33,382,382,5,5,0,1,0
29,385,385,14,1,13,2,1
19,386,386,68,60,8,2,1
22,414,414,65,14,51,3,2
12,427,427,53,42,11,2,1
10,458,458,3,3,0,1,0
25,471,471,190,190,0,1,0
28,484,484,37,3,34,2,1
2,491,491,70,54,16,3,2
16,499,499,2,2,0,1,0
7,499,499,56,18,38,2,1

13,120,120,5,5,0,1,0
27,173,173,8,8,0,1,0
19,183,183,11,11,0,1,0
23,217,217,35,18,17,2,1
0,218,218,1,1,0,1,0
4,220,220,14,14,0,1,0
9,237,237,11,11,0,1,0
35,238,238,15,15,0,1,0
28,250,250,19,11,8,2,1
22,255,255,36,28,8,3,2
21,261,261,13,3,10,2,1
6,265,265,31,31,0,1,0
11,266,266,13,13,0,1,0
31,302,302,13,13,0,1,0
32,304,304,34,16,18,2,1
17,315,315,6,6,0,1,0
1,320,320,2,2,0,1,0
3,322,322,3,3,0,1,0
7,322,322,31,16,15,4,3
10,371,371,3,3,0,1,0
15,375,375,12,12,0,1,0
30,382,382,2,2,0,1,0
16,385,385,7,2,5,2,1
8,387,387,1,1,0,1,0
12,407,407,56,56,0,1,0
14,408,408,61,38,23,2,1
5,423,423,9,9,0,1,0
20,428,428,73,73,0,1,0
18,447,447,4,4,0,1,0
24,456,456,3,3,0,1,0
25,468,468,101,12,89,4,3
33,483,483,39,7,32,2,1
26,488,488,4,4,0,1,0
29,491,491,77,51,26,2,1
34,491,491,169,169,0,1,0
2,494,494,25,19,6,2,1

3,136,136,13,1,12,4,3
8,144,144,10,4,6,2,1
6,155,155,20,20,0,1,0
16,158,158,8,8,0,1,0
7,169,169,16,16,0,1,0
22,174,174,10,10,0,1,0
9,182,182,41,20,21,2,1
11,188,188,13,13,0,1,0
1,208,208,12,12,0,1,0
14,243,243,9,9,0,1,0
24,271,271,7,7,0,1,0
20,284,284,42,10,32,3,2
2,306,306,50,8,42,3,2
23,316,316,14,1,13,2,1
4,318,318,55,51,4,2,1
10,380,380,10,1,9,2,1
18,396,396,24,24,0,1,0
5,398,398,9,9,0,1,0
21,415,415,31,21,10,2,1
17,434,434,119,119,0,1,0
0,451,451,80,80,0,1,0
15,467,467,122,93,29,4,3
12,470,470,1,1,0,1,0
19,494,494,73,60,13,2,1
13,499,499,67,67,0,1,0

5,104,104,4,1,3,2,1
26,110,110,37,1,36,4,3
7,123,123,18,18,0,1,0
12,135,135,5,1,4,2,1
2,143,143,15,5,10,2,1
20,165,165,6,6,0,1,0
15,172,172,1,1,0,1,0
21,183,183,17,17,0,1,0
0,193,193,20,20,0,1,0
4,229,229,1,1,0,1,0
6,233,233,16,16,0,1,0
10,244,244,6,6,0,1,0
1,259,259,39,24,15,2,1
18,282,282,37,37,0,1,0
22,300,300,47,47,0,1,0
16,307,307,7,2,5,2,1
8,328,328,13,13,0,1,0
11,332,332,24,10,14,2,1
14,347,347,55,55,0,1,0
17,353,353,9,9,0,1,0
27,368,368,12,12,0,1,0
25,392,392,15,3,12,3,2
9,399,399,42,16,26,2,1
28,418,418,60,8,52,4,3
23,434,434,40,40,0,1,0
13,435,435,104,66,38,4,3
3,444,444,1,1,0,1,0
19,458,458,72,25,47,2,1
24,480,480,25,25,0,1,0

2,102,102,21,7,14,3,2
4,113,113,3,3,0,1,0
23,123,123,5,5,0,1,0
12,140,140,28,2,26,3,2
17,158,158,5,5,0,1,0
6,162,162,62,55,7,2,1
27,171,171,1,1,0,1,0
20,174,174,10,2,8,3,2
15,187,187,6,6,0,1,0
13,193,193,4,4,0,1,0
7,249,249,5,5,0,1,0
1,257,257,18,18,0,1,0
19,259,259,9,9,0,1,0
21,265,265,13,13,0,1,0
14,272,272,4,4,0,1,0
3,278,278,16,16,0,1,0
24,303,303,53,53,0,1,0
11,325,325,25,25,0,1,0
16,367,367,6,6,0,1,0
25,367,367,6,6,0,1,0
9,385,385,28,21,7,2,1
0,385,385,24,24,0,1,0
22,397,397,108,23,85,3,2
5,402,402,18,2,16,3,2
10,466,466,20,5,15,4,3
18,484,484,83,83,0,1,0
8,485,485,2,2,0,1,0
26,499,499,210,210,0,1,0

1,114,114,4,4,0,1,0
10,120,120,4,4,0,1,0
28,122,122,2,2,0,1,0
21,142,142,5,5,0,1,0
3,147,147,2,2,0,1,0
23,148,148,8,8,0,1,0
13,152,152,14,14,0,1,0
15,153,153,3,3,0,1,0
4,170,170,15,9,6,2,1
26,175,175,11,3,8,3,2
8,215,215,18,7,11,2,1
22,247,247,82,12,70,4,3
16,256,256,12,12,0,1,0
17,307,307,33,33,0,1,0
14,307,307,1,1,0,1,0
11,328,328,46,11,35,2,1
0,342,342,1,1,0,1,0
5,360,360,59,59,0,1,0
12,387,387,6,6,0,1,0
18,388,388,7,7,0,1,0
6,390,390,7,7,0,1,0
30,411,411,37,23,14,3,2
19,413,413,10,10,0,1,0
2,413,413,52,52,0,1,0
24,436,436,20,1,19,2,1
9,440,440,96,75,21,3,2
20,444,444,96,13,83,4,3
7,469,469,44,36,8,2,1
27,470,470,4,4,0,1,0
25,489,489,5,5,0,1,0
29,494,494,199,199,0,1,0

11,139,139,5,5,0,1,0
12,141,141,59,39,20,2,1
18,152,152,24,8,16,3,2
5,154,154,38,38,0,1,0
23,192,192,21,3,18,2,1
1,216,216,6,6,0,1,0
17,232,232,44,5,39,3,2
0,246,246,1,1,0,1,0
22,260,260,41,41,0,1,0
15,261,261,3,3,0,1,0
7,263,263,4,1,3,2,1
6,272,272,1,1,0,1,0
25,295,295,32,32,0,1,0
19,300,300,4,4,0,1,0
13,305,305,5,2,3,2,1
24,308,308,33,33,0,1,0
16,330,330,28,28,0,1,0
4,335,335,22,22,0,1,0
2,348,348,35,14,21,2,1
14,368,368,105,105,0,1,0
20,369,369,16,16,0,1,0
21,379,379,16,13,3,2,1
3,422,422,13,6,7,2,1
8,426,426,71,41,30,4,3
10,466,466,55,22,33,4,3
9,479,479,34,34,0,1,0

10,100,100,4,4,0,1,0
5,108,108,14,14,0,1,0
26,108,108,3,3,0,1,0
2,122,122,3,3,0,1,0
13,146,146,28,19,9,4,3
15,178,178,7,4,3,2,1
4,192,192,12,12,0,1,0
23,200,200,96,48,48,2,1
1,211,211,5,1,4,2,1
11,221,221,87,1,86,3,2
12,251,251,7,7,0,1,0
9,267,267,15,3,12,4,3
14,271,271,1,1,0,1,0
20,271,271,16,2,14,2,1
19,276,276,23,23,0,1,0
18,287,287,25,25,0,1,0
8,306,306,22,1,21,4,3
21,308,308,15,2,13,2,1
3,343,343,17,17,0,1,0
25,376,376,51,37,14,3,2
7,384,384,15,4,11,2,1
0,385,385,39,3,36,4,3
6,396,396,19,19,0,1,0
16,417,417,3,3,0,1,0
22,421,421,9,9,0,1,0
28,450,450,2,2,0,1,0
17,462,462,47,47,0,1,0
24,465,465,29,29,0,1,0
27,484,484,96,96,0,1,0

10,106,106,3,3,0,1,0
9,135,135,7,3,4,2,1
7,137,137,5,5,0,1,0
6,138,138,7,7,0,1,0
2,139,139,4,1,3,2,1
0,153,153,17,1,16,2,1
20,158,158,13,4,9,4,3
12,160,160,17,1,16,2,1
19,168,168,34,34,0,1,0
11,195,195,41,37,4,2,1
26,207,207,16,16,0,1,0
4,213,213,65,47,18,3,2
17,233,233,7,7,0,1,0
5,261,261,34,34,0,1,0
22,265,265,23,15,8,2,1
15,288,288,38,1,37,2,1
13,304,304,19,3,16,2,1
23,309,309,44,44,0,1,0
24,328,328,12,12,0,1,0
25,337,337,68,37,31,2,1
1,360,360,12,8,4,2,1
8,398,398,21,2,19,2,1
3,407,407,38,16,22,4,3
14,441,441,92,42,50,4,3
18,451,451,5,2,3,2,1
21,479,479,3,3,0,1,0
16,497,497,56,56,0,1,0

6,114,114,6,1,5,2,1
3,117,117,1,1,0,1,0
29,118,118,3,3,0,1,0
28,124,124,7,7,0,1,0
26,133,133,12,3,9,2,1
7,142,142,1,1,0,1,0
19,147,147,3,3,0,1,0
31,147,147,6,6,0,1,0
22,205,205,8,8,0,1,0
20,221,221,46,46,0,1,0
1,249,249,17,17,0,1,0
32,251,251,9,5,4,2,1
24,294,294,15,15,0,1,0
12,301,301,26,14,12,4,3
30,321,321,111,74,37,2,1
8,327,327,43,43,0,1,0
9,334,334,13,1,12,3,2
18,340,340,20,20,0,1,0
4,354,354,9,3,6,2,1
2,367,367,40,40,0,1,0
13,370,370,25,7,18,4,3
16,409,409,5,5,0,1,0
14,410,410,12,7,5,2,1
17,418,418,35,35,0,1,0
27,464,464,40,25,15,4,3
23,473,473,21,21,0,1,0
0,474,474,86,10,76,3,2
21,477,477,113,29,84,3,2
25,479,479,34,34,0,1,0
11,479,479,8,2,6,3,2
10,488,488,58,58,0,1,0
15,491,491,38,20,18,4,3
5,497,497,53,11,42,3,2

1,112,112,13,13,0,1,0
23,132,132,7,7,0,1,0
4,163,163,1,1,0,1,0
10,201,201,1,1,0,1,0
33,214,214,4,4,0,1,0
19,241,241,33,12,21,2,1
17,243,243,10,10,0,1,0
31,250,250,44,15,29,2,1
20,254,254,12,12,0,1,0
30,254,254,31,10,21,4,3
32,256,256,44,35,9,2,1
7,267,267,42,42,0,1,0
29,269,269,37,18,19,4,3
27,277,277,46,36,10,2,1
11,279,279,17,17,0,1,0
2,286,286,22,22,0,1,0
12,338,338,2,2,0,1,0
15,361,361,20,8,12,3,2
26,361,361,5,5,0,1,0
24,379,379,23,17,6,3,2
18,394,394,42,42,0,1,0
16,404,404,3,3,0,1,0
13,406,406,18,13,5,2,1
5,407,407,52,52,0,1,0
9,408,408,47,38,9,4,3
14,410,410,24,15,9,4,3
21,431,431,50,50,0,1,0
22,433,433,70,19,51,4,3
0,444,444,17,17,0,1,0
3,472,472,1,1,0,1,0
25,483,483,40,40,0,1,0
28,492,492,22,22,0,1,0
8,494,494,1,1,0,1,0
6,497,497,46,46,0,1,0

13,128,128,22,22,0,1,0
9,130,130,45,45,0,1,0
10,145,145,2,2,0,1,0
19,147,147,36,3,33,2,1
15,173,173,2,2,0,1,0
7,191,191,10,10,0,1,0
22,197,197,1,1,0,1,0
12,207,207,42,42,0,1,0
18,232,232,6,3,3,2,1
11,272,272,22,11,11,2,1
3,283,283,23,23,0,1,0
14,292,292,6,6,0,1,0
5,294,294,8,2,6,3,2
17,311,311,31,31,0,1,0
20,315,315,30,6,24,2,1
2,317,317,40,40,0,1,0
4,329,329,54,21,33,2,1
0,350,350,71,23,48,3,2
1,355,355,8,1,7,2,1
8,439,439,95,10,85,4,3
6,440,440,30,30,0,1,0
21,461,461,53,53,0,1,0
16,490,490,119,17,102,4,3

5,106,106,30,21,9,2,1
20,134,134,2,2,0,1,0
4,141,141,10,10,0,1,0
0,143,143,8,8,0,1,0
13,170,170,37,25,12,3,2
3,188,188,38,7,31,4,3
11,230,230,6,3,3,2,1
14,230,230,6,6,0,1,0
10,237,237,47,13,34,3,2
17,243,243,74,22,52,4,3
1,257,257,45,2,43,3,2
9,281,281,33,14,19,2,1
21,300,300,3,3,0,1,0
16,328,328,16,16,0,1,0
6,337,337,25,9,16,2,1
19,357,357,68,30,38,4,3
23,399,399,23,23,0,1,0
2,415,415,34,34,0,1,0
15,444,444,2,2,0,1,0
12,444,444,127,99,28,2,1
7,448,448,16,16,0,1,0
18,469,469,36,8,28,3,2
22,477,477,29,8,21,3,2
8,491,491,3,3,0,1,0

15,134,134,14,8,6,3,2
11,161,161,24,18,6,3,2
6,170,170,41,2,39,2,1
19,174,174,24,24,0,1,0
1,177,177,30,30,0,1,0
10,188,188,28,28,0,1,0
13,188,188,56,56,0,1,0
0,195,195,1,1,0,1,0
5,207,207,32,32,0,1,0
14,215,215,11,11,0,1,0
9,222,222,27,9,18,3,2
4,253,253,28,28,0,1,0
16,291,291,50,34,16,2,1
3,318,318,89,8,81,4,3
18,323,323,10,10,0,1,0
8,336,336,60,60,0,1,0
20,355,355,14,14,0,1,0
21,358,358,12,6,6,2,1
17,379,379,6,3,3,2,1
12,411,411,6,6,0,1,0
2,447,447,10,1,9,4,3
7,491,491,69,44,25,3,2

11,116,116,1,1,0,1,0
22,122,122,27,27,0,1,0
24,134,134,11,11,0,1,0
12,177,177,28,5,23,2,1
20,180,180,20,3,17,2,1
5,191,191,21,21,0,1,0
2,203,203,1,1,0,1,0
23,212,212,31,16,15,4,3
16,219,219,25,25,0,1,0
28,236,236,8,2,6,2,1
6,243,243,6,6,0,1,0
17,263,263,25,25,0,1,0
3,276,276,56,28,28,2,1
4,287,287,87,27,60,4,3
8,305,305,9,5,4,2,1
26,336,336,7,2,5,2,1
14,343,343,46,46,0,1,0
1,357,357,38,38,0,1,0
7,376,376,3,3,0,1,0
9,379,379,1,1,0,1,0
27,380,380,13,13,0,1,0
25,381,381,20,17,3,2,1
10,424,424,40,40,0,1,0
21,428,428,69,60,9,2,1
15,446,446,17,17,0,1,0
18,448,448,22,22,0,1,0
19,454,454,91,8,83,4,3
13,475,475,8,2,6,2,1
0,494,494,29,29,0,1,0

7,100,100,12,5,7,2,1
19,122,122,6,6,0,1,0
9,130,130,19,10,9,4,3
15,172,172,57,39,18,3,2
22,176,176,1,1,0,1,0
25,191,191,13,9,4,2,1
23,198,198,33,5,28,3,2
18,206,206,26,13,13,2,1
10,229,229,28,7,21,2,1
3,234,234,2,2,0,1,0
1,244,244,37,37,0,1,0
13,277,277,4,4,0,1,0
26,290,290,28,28,0,1,0
16,294,294,12,12,0,1,0
8,298,298,31,31,0,1,0
20,301,301,30,10,20,3,2
4,340,340,48,25,23,2,1
2,347,347,4,4,0,1,0
0,350,350,15,11,4,2,1
11,374,374,129,129,0,1,0
24,374,374,7,7,0,1,0
17,398,398,9,9,0,1,0
14,431,431,17,17,0,1,0
5,449,449,3,3,0,1,0
12,462,462,12,12,0,1,0
6,477,477,29,29,0,1,0
21,500,500,129,15,114,4,3

19,108,108,25,25,0,1,0
24,127,127,18,18,0,1,0
29,141,141,14,14,0,1,0
9,154,154,18,5,13,2,1
16,170,170,16,16,0,1,0
4,184,184,9,3,6,2,1
17,186,186,2,2,0,1,0
6,250,250,2,2,0,1,0
30,254,254,5,5,0,1,0
18,255,255,6,6,0,1,0
7,265,265,4,4,0,1,0
28,286,286,7,7,0,1,0
13,291,291,30,11,19,4,3
12,297,297,4,1,3,2,1
26,299,299,14,5,9,2,1
14,336,336,7,1,6,3,2
10,356,356,17,5,12,4,3
2,358,358,21,21,0,1,0
21,392,392,2,2,0,1,0
15,410,410,194,138,56,3,2
0,413,413,2,2,0,1,0
11,415,415,4,4,0,1,0
3,416,416,5,5,0,1,0
20,418,418,49,31,18,4,3
25,434,434,82,30,52,3,2
23,441,441,129,9,120,4,3
8,442,442,83,49,34,2,1
5,468,468,6,6,0,1,0
22,471,471,53,53,0,1,0
27,496,496,7,2,5,2,1
1,499,499,32,32,0,1,0

3,109,109,1,1,0,1,0
11,114,114,2,2,0,1,0
0,127,127,17,2,15,2,1
19,137,137,22,6,16,2,1
6,140,140,28,28,0,1,0
15,168,168,25,4,21,2,1
7,208,208,16,4,12,2,1
25,213,213,12,12,0,1,0
16,220,220,4,4,0,1,0
20,237,237,1,1,0,1,0
12,249,249,26,26,0,1,0
13,258,258,21,21,0,1,0
17,276,276,2,2,0,1,0
9,285,285,29,13,16,3,2
18,285,285,88,88,0,1,0
22,294,294,62,45,17,2,1
10,334,334,19,6,13,2,1
23,344,344,9,5,4,2,1
24,351,351,24,11,13,2,1
14,351,351,40,1,39,2,1
4,367,367,46,24,22,3,2
21,392,392,60,45,15,4,3
2,399,399,45,33,12,2,1
26,442,442,18,11,7,2,1
5,458,458,41,41,0,1,0
8,461,461,9,9,0,1,0
1,485,485,83,75,8,3,2

14,100,100,9,9,0,1,0
23,122,122,3,3,0,1,0
11,125,125,3,3,0,1,0
24,136,136,10,10,0,1,0
10,182,182,2,2,0,1,0
7,183,183,21,21,0,1,0
0,195,195,1,1,0,1,0
12,208,208,9,3,6,2,1
17,227,227,44,44,0,1,0
13,230,230,5,5,0,1,0
4,236,236,37,3,34,3,2
18,247,247,36,18,18,2,1
3,265,265,34,34,0,1,0
2,271,271,40,12,28,3,2
21,292,292,33,33,0,1,0
27,301,301,60,15,45,2,1
20,314,314,42,33,9,2,1
26,320,320,9,9,0,1,0
22,366,366,45,31,14,2,1
5,369,369,69,27,42,3,2
6,370,370,60,60,0,1,0
15,387,387,22,22,0,1,0
1,399,399,23,23,0,1,0
19,402,402,47,47,0,1,0
16,469,469,13,13,0,1,0
9,481,481,55,40,15,4,3
25,483,483,42,42,0,1,0
8,495,495,18,18,0,1,0

20,102,102,12,12,0,1,0
16,106,106,27,7,20,4,3
13,143,143,21,21,0,1,0
23,147,147,1,1,0,1,0
26,149,149,4,4,0,1,0
7,184,184,6,6,0,1,0
5,192,192,13,5,8,2,1
17,199,199,27,14,13,2,1
22,208,208,42,8,34,3,2
0,212,212,13,13,0,1,0
18,244,244,12,8,4,2,1
2,261,261,22,22,0,1,0
21,280,280,16,3,13,2,1
12,281,281,60,32,28,2,1
14,284,284,5,5,0,1,0
4,293,293,45,16,29,2,1
24,309,309,29,25,4,2,1
19,325,325,46,7,39,2,1
6,333,333,16,16,0,1,0
10,339,339,17,17,0,1,0
11,411,411,68,27,41,2,1
15,420,420,36,22,14,3,2
25,421,421,61,12,49,2,1
9,451,451,13,13,0,1,0
1,457,457,1,1,0,1,0
3,484,484,36,5,31,4,3
8,500,500,89,53,36,4,3

3,101,101,36,12,24,2,1
17,109,109,8,8,0,1,0
25,120,120,6,6,0,1,0
0,126,126,12,12,0,1,0
12,160,160,10,2,8,2,1
9,177,177,17,17,0,1,0
7,202,202,1,1,0,1,0
10,202,202,8,4,4,2,1
26,236,236,24,14,10,2,1
2,269,269,94,94,0,1,0
1,276,276,1,1,0,1,0
8,295,295,4,4,0,1,0
24,314,314,14,8,6,2,1
18,314,314,44,44,0,1,0
22,320,320,80,26,54,4,3
19,350,350,17,7,10,3,2
27,369,369,3,3,0,1,0
5,382,382,2,2,0,1,0
16,388,388,11,3,8,3,2
4,406,406,7,7,0,1,0
20,408,408,35,35,0,1,0
6,412,412,1,1,0,1,0
11,435,435,15,3,12,2,1
14,443,443,92,92,0,1,0
15,453,453,72,55,17,2,1
13,455,455,6,6,0,1,0
23,458,458,73,18,55,4,3
21,470,470,79,65,14,3,2

23,142,142,48,48,0,1,0
9,165,165,38,12,26,2,1
4,176,176,3,3,0,1,0
3,207,207,4,1,3,2,1
21,219,219,50,50,0,1,0
18,220,220,10,3,7,2,1
6,237,237,66,62,4,2,1
19,239,239,15,15,0,1,0
1,270,270,5,5,0,1,0
0,305,305,26,23,3,2,1
17,316,316,17,17,0,1,0
7,329,329,45,45,0,1,0
15,334,334,8,1,7,2,1
16,338,338,47,16,31,2,1
14,344,344,3,3,0,1,0
11,387,387,12,12,0,1,0
13,419,419,81,51,30,4,3
12,428,428,32,18,14,3,2
8,438,438,1,1,0,1,0
22,445,445,40,32,8,2,1
2,453,453,56,56,0,1,0
10,467,467,161,128,33,4,3
5,472,472,21,21,0,1,0
20,495,495,15,11,4,2,1

25,106,106,16,16,0,1,0
8,133,133,35,35,0,1,0
5,150,150,13,1,12,3,2
11,175,175,12,4,8,2,1
1,177,177,8,8,0,1,0
16,182,182,30,30,0,1,0
10,189,189,26,14,12,2,1
21,248,248,8,8,0,1,0
12,258,258,2,2,0,1,0
15,278,278,52,38,14,3,2
23,281,281,3,3,0,1,0
22,282,282,5,2,3,2,1
9,287,287,23,23,0,1,0
2,292,292,19,19,0,1,0
6,292,292,6,6,0,1,0
7,302,302,8,8,0,1,0
18,317,317,53,10,43,2,1
26,334,334,13,13,0,1,0
14,368,368,6,6,0,1,0
13,397,397,52,28,24,2,1
17,410,410,28,21,7,2,1
0,427,427,125,33,92,3,2
4,436,436,17,1,16,3,2
20,442,442,3,3,0,1,0
3,456,456,17,17,0,1,0
24,465,465,6,6,0,1,0
19,482,482,216,165,51,4,3

14,113,113,18,18,0,1,0
7,113,113,1,1,0,1,0
9,130,130,15,15,0,1,0
8,132,132,27,5,22,3,2
23,148,148,51,51,0,1,0
0,153,153,12,12,0,1,0
3,177,177,32,19,13,2,1
4,192,192,7,7,0,1,0
15,195,195,43,43,0,1,0
1,229,229,29,29,0,1,0
10,245,245,11,11,0,1,0
11,249,249,15,15,0,1,0
19,272,272,16,16,0,1,0
20,298,298,27,12,15,2,1
25,314,314,1,1,0,1,0
18,318,318,10,2,8,3,2
22,322,322,32,14,18,3,2
5,328,328,113,113,0,1,0
12,371,371,21,13,8,2,1
21,379,379,35,35,0,1,0
17,399,399,18,1,17,2,1
16,437,437,5,5,0,1,0
2,463,463,1,1,0,1,0
13,474,474,32,15,17,2,1
24,489,489,50,50,0,1,0
6,491,491,21,14,7,2,1

6,110,110,16,16,0,1,0
9,114,114,5,2,3,2,1
21,123,123,41,41,0,1,0
10,125,125,9,9,0,1,0
18,153,153,5,1,4,2,1
20,161,161,6,6,0,1,0
16,175,175,21,14,7,2,1
11,239,239,27,27,0,1,0
19,252,252,5,5,0,1,0
24,256,256,2,2,0,1,0
3,269,269,1,1,0,1,0
8,279,279,64,2,62,3,2
23,308,308,62,50,12,4,3
14,324,324,66,66,0,1,0
17,355,355,38,26,12,3,2
25,396,396,10,10,0,1,0
4,399,399,13,3,10,2,1
2,409,409,17,17,0,1,0
12,417,417,4,4,0,1,0
7,436,436,31,23,8,3,2
0,481,481,213,174,39,4,3
15,482,482,17,17,0,1,0
1,486,486,4,4,0,1,0
13,492,492,5,1,4,2,1
5,495,495,44,38,6,2,1
22,500,500,97,9,88,4,3

22,146,146,1,1,0,1,0
1,154,154,6,6,0,1,0
2,169,169,28,28,0,1,0
4,194,194,20,20,0,1,0
6,201,201,4,4,0,1,0
18,205,205,17,17,0,1,0
10,220,220,31,17,14,2,1
17,248,248,19,4,15,3,2
20,288,288,23,23,0,1,0
9,290,290,57,29,28,3,2
0,300,300,61,29,32,2,1
15,309,309,9,9,0,1,0
23,315,315,4,4,0,1,0
12,328,328,144,144,0,1,0
21,334,334,56,8,48,2,1
8,335,335,35,35,0,1,0
14,337,337,8,8,0,1,0
16,341,341,8,5,3,2,1
3,377,377,70,20,50,3,2
5,392,392,9,9,0,1,0
7,433,433,52,52,0,1,0
11,435,435,62,28,34,3,2
19,437,437,19,7,12,2,1
13,485,485,95,75,20,2,1

18,102,102,7,7,0,1,0
1,142,142,1,1,0,1,0
21,147,147,27,27,0,1,0
19,147,147,9,9,0,1,0
24,155,155,29,29,0,1,0
22,168,168,9,5,4,2,1
9,191,191,7,7,0,1,0
11,195,195,19,19,0,1,0
6,208,208,4,4,0,1,0
14,229,229,52,52,0,1,0
26,237,237,5,1,4,2,1
7,242,242,1,1,0,1,0
23,267,267,3,3,0,1,0
8,275,275,48,48,0,1,0
20,290,290,15,15,0,1,0
16,331,331,49,49,0,1,0
5,380,380,1,1,0,1,0
17,389,389,24,24,0,1,0
10,389,389,11,11,0,1,0
25,396,396,41,41,0,1,0
4,397,397,41,41,0,1,0
2,404,404,14,14,0,1,0
12,439,439,62,62,0,1,0
3,463,463,74,8,66,4,3
15,476,476,119,119,0,1,0
13,480,480,108,8,100,3,2
27,484,484,61,61,0,1,0
0,493,493,21,3,18,2,1

22,140,140,26,26,0,1,0
14,157,157,1,1,0,1,0
12,166,166,31,13,18,2,1
2,173,173,19,19,0,1,0
1,179,179,39,31,8,2,1
20,184,184,9,9,0,1,0
24,192,192,21,21,0,1,0
23,208,208,40,40,0,1,0
3,227,227,12,1,11,2,1
11,228,228,11,1,10,3,2
9,237,237,10,10,0,1,0
5,296,296,74,74,0,1,0
16,300,300,1,1,0,1,0
7,305,305,15,15,0,1,0
0,326,326,9,3,6,3,2
4,335,335,6,6,0,1,0
21,349,349,50,50,0,1,0
8,359,359,1,1,0,1,0
19,360,360,31,28,3,2,1
18,390,390,68,26,42,4,3
15,401,401,46,2,44,3,2
10,453,453,83,61,22,3,2
13,459,459,62,62,0,1,0
6,463,463,52,52,0,1,0
25,485,485,29,17,12,4,3
17,487,487,33,6,27,2,1

22,120,120,9,5,4,2,1
9,132,132,21,21,0,1,0
20,139,139,37,17,20,2,1
8,142,142,8,3,5,2,1
23,167,167,26,1,25,2,1
25,173,173,19,19,0,1,0
24,178,178,8,8,0,1,0
26,209,209,13,13,0,1,0
10,219,219,4,4,0,1,0
28,220,220,39,17,22,4,3
11,236,236,24,4,20,3,2
3,258,258,37,3,34,3,2
16,260,260,27,27,0,1,0
7,270,270,13,9,4,2,1
12,271,271,11,7,4,2,1
14,278,278,30,30,0,1,0
5,389,389,36,29,7,2,1
17,391,391,1,1,0,1,0
13,410,410,34,34,0,1,0
2,410,410,6,3,3,2,1
15,415,415,12,12,0,1,0
18,415,415,19,19,0,1,0
27,438,438,11,2,9,4,3
19,455,455,53,53,0,1,0
6,458,458,23,23,0,1,0
0,463,463,68,33,35,3,2
21,476,476,70,70,0,1,0
4,483,483,63,63,0,1,0
1,490,490,39,39,0,1,0

20,127,127,4,1,3,2,1
22,132,132,26,12,14,3,2
3,154,154,10,10,0,1,0
24,179,179,19,19,0,1,0
15,182,182,2,2,0,1,0
4,183,183,30,1,29,4,3
10,229,229,5,2,3,2,1
11,243,243,17,14,3,2,1
13,276,276,16,16,0,1,0
18,283,283,24,24,0,1,0
0,293,293,38,38,0,1,0
25,296,296,19,19,0,1,0
16,304,304,2,2,0,1,0
12,312,312,2,2,0,1,0
6,315,315,31,7,24,4,3
32,318,318,13,6,7,2,1
29,334,334,31,31,0,1,0
33,338,338,135,102,33,4,3
5,346,346,1,1,0,1,0
7,359,359,37,13,24,2,1
1,363,363,23,23,0,1,0
31,368,368,3,3,0,1,0
28,371,371,1,1,0,1,0
21,375,375,26,26,0,1,0
14,396,396,37,37,0,1,0
26,415,415,40,12,28,2,1
30,421,421,55,12,43,4,3
19,423,423,44,44,0,1,0
27,430,430,1,1,0,1,0
9,432,432,11,11,0,1,0
8,456,456,67,55,12,4,3
17,459,459,1,1,0,1,0
2,466,466,9,2,7,2,1
23,477,477,51,51,0,1,0

6,120,120,13,4,9,4,3
9,140,140,4,4,0,1,0
19,143,143,15,1,14,2,1
1,150,150,5,5,0,1,0
20,159,159,1,1,0,1,0
7,187,187,1,1,0,1,0
23,188,188,7,1,6,3,2
24,191,191,12,3,9,2,1
16,193,193,19,14,5,2,1
27,202,202,11,11,0,1,0
30,206,206,3,3,0,1,0
26,209,209,5,1,4,2,1
15,231,231,42,42,0,1,0
3,244,244,9,9,0,1,0
4,260,260,28,28,0,1,0
2,277,277,1,1,0,1,0
14,297,297,1,1,0,1,0
21,309,309,55,55,0,1,0
10,325,325,1,1,0,1,0
31,332,332,27,6,21,2,1
11,340,340,71,71,0,1,0
8,340,340,15,15,0,1,0
13,341,341,18,10,8,2,1
22,355,355,4,4,0,1,0
5,356,356,1,1,0,1,0
0,376,376,4,4,0,1,0
18,412,412,121,121,0,1,0
17,412,412,5,5,0,1,0
12,433,433,28,4,24,3,2
25,465,465,26,17,9,2,1
28,469,469,205,64,141,4,3
29,469,469,121,22,99,4,3

8,131,131,1,1,0,1,0
14,132,132,11,11,0,1,0
16,170,170,7,1,6,2,1
26,182,182,20,8,12,3,2
18,208,208,21,11,10,2,1
13,212,212,1,1,0,1,0
0,233,233,18,18,0,1,0
1,254,254,1,1,0,1,0
20,259,259,5,5,0,1,0
9,264,264,32,8,24,3,2
2,310,310,5,1,4,2,1
3,317,317,1,1,0,1,0
7,321,321,87,63,24,4,3
21,325,325,20,20,0,1,0
11,341,341,51,6,45,4,3
29,364,364,48,48,0,1,0
12,380,380,50,38,12,3,2
17,386,386,39,39,0,1,0
5,386,386,17,17,0,1,0
24,394,394,28,7,21,2,1
10,414,414,117,73,44,2,1
28,437,437,74,26,48,4,3
15,441,441,16,7,9,4,3
23,452,452,131,89,42,2,1
19,454,454,49,49,0,1,0
22,459,459,8,2,6,2,1
4,472,472,8,8,0,1,0
27,475,475,14,14,0,1,0
6,479,479,6,2,4,2,1
25,494,494,56,56,0,1,0

1,103,103,21,7,14,3,2
2,115,115,7,7,0,1,0
7,125,125,1,1,0,1,0
10,129,129,57,57,0,1,0
5,137,137,1,1,0,1,0
22,143,143,3,3,0,1,0
28,154,154,45,15,30,4,3
9,178,178,5,5,0,1,0
18,207,207,9,9,0,1,0
15,217,217,7,7,0,1,0
16,224,224,21,2,19,4,3
29,233,233,2,2,0,1,0
26,255,255,65,56,9,4,3
20,271,271,41,41,0,1,0
27,280,280,11,11,0,1,0
13,290,290,18,13,5,2,1
3,296,296,31,28,3,2,1
17,306,306,27,27,0,1,0
21,336,336,4,4,0,1,0
0,349,349,44,44,0,1,0
4,358,358,16,6,10,3,2
6,359,359,15,6,9,2,1
12,402,402,8,8,0,1,0
23,411,411,46,4,42,3,2
19,419,419,11,1,10,3,2
24,420,420,31,2,29,2,1
14,451,451,6,3,3,2,1
25,454,454,90,56,34,3,2
8,482,482,2,2,0,1,0
11,493,493,5,5,0,1,0

11,102,102,2,2,0,1,0
13,126,126,9,1,8,3,2
26,150,150,25,25,0,1,0
14,155,155,2,2,0,1,0
0,178,178,13,13,0,1,0
9,193,193,4,4,0,1,0
29,199,199,4,4,0,1,0
27,204,204,13,13,0,1,0
6,219,219,27,24,3,2,1
12,240,240,2,2,0,1,0
23,246,246,51,51,0,1,0
4,255,255,1,1,0,1,0
24,293,293,24,24,0,1,0
10,298,298,60,60,0,1,0
1,342,342,28,7,21,2,1
2,344,344,24,24,0,1,0
20,382,382,36,21,15,2,1
7,395,395,51,51,0,1,0
16,397,397,3,3,0,1,0
5,406,406,22,13,9,2,1
17,432,432,13,3,10,2,1
18,440,440,30,30,0,1,0
21,442,442,57,57,0,1,0
22,449,449,45,45,0,1,0
25,453,453,62,12,50,3,2
8,455,455,73,9,64,3,2
28,485,485,62,62,0,1,0
3,490,490,113,96,17,2,1
15,493,493,16,9,7,2,1
19,494,494,49,49,0,1,0

5,100,100,1,1,0,1,0
16,101,101,3,3,0,1,0
14,173,173,7,7,0,1,0
7,207,207,25,25,0,1,0
15,208,208,5,1,4,2,1
12,221,221,25,25,0,1,0
11,234,234,22,22,0,1,0
6,272,272,1,1,0,1,0
20,278,278,26,23,3,2,1
0,295,295,9,2,7,2,1
23,333,333,2,2,0,1,0
2,344,344,81,50,31,2,1
18,362,362,12,12,0,1,0
19,368,368,93,93,0,1,0
3,376,376,48,12,36,4,3
13,381,381,96,51,45,4,3
21,399,399,59,59,0,1,0
4,402,402,2,2,0,1,0
10,405,405,22,22,0,1,0
9,441,441,102,42,60,3,2
24,456,456,44,44,0,1,0
1,457,457,51,37,14,3,2
22,461,461,93,37,56,4,3
8,488,488,135,135,0,1,0
17,495,495,18,4,14,2,1

5,128,128,23,14,9,4,3
22,146,146,15,15,0,1,0
8,177,177,28,6,22,2,1
4,241,241,11,2,9,4,3
11,241,241,2,2,0,1,0
1,246,246,28,28,0,1,0
3,269,269,5,1,4,2,1
16,277,277,13,13,0,1,0
0,289,289,22,1,21,2,1
12,292,292,70,70,0,1,0
18,350,350,21,2,19,3,2
23,353,353,15,1,14,2,1
14,355,355,3,3,0,1,0
19,360,360,13,10,3,2,1
10,362,362,17,5,12,3,2
17,380,380,17,17,0,1,0
15,394,394,65,65,0,1,0
7,396,396,34,34,0,1,0
13,400,400,6,3,3,2,1
9,410,410,2,2,0,1,0
6,410,410,186,52,134,4,3
20,417,417,1,1,0,1,0
24,454,454,147,89,58,3,2
2,459,459,50,23,27,2,1
21,491,491,114,39,75,4,3

31,100,100,27,21,6,2,1
23,104,104,4,4,0,1,0
5,112,112,8,3,5,2,1
14,120,120,9,9,0,1,0
2,121,121,8,2,6,2,1
4,124,124,5,5,0,1,0
11,143,143,4,1,3,2,1
24,148,148,27,21,6,2,1
25,154,154,9,5,4,2,1
12,159,159,14,7,7,2,1
6,185,185,32,32,0,1,0
17,188,188,15,7,8,2,1
19,200,200,10,10,0,1,0
30,201,201,1,1,0,1,0
15,209,209,5,5,0,1,0
28,231,231,18,1,17,2,1
9,278,278,38,29,9,2,1
13,288,288,2,2,0,1,0
16,288,288,1,1,0,1,0
27,292,292,78,23,55,4,3
26,336,336,1,1,0,1,0
20,337,337,34,23,11,2,1
29,356,356,7,7,0,1,0
10,360,360,34,13,21,4,3
7,364,364,30,1,29,2,1
22,364,364,71,71,0,1,0
21,400,400,3,3,0,1,0
8,410,410,2,2,0,1,0
18,413,413,69,49,20,3,2
3,452,452,1,1,0,1,0
0,466,466,21,21,0,1,0
32,488,488,52,31,21,4,3
1,497,497,32,6,26,2,1

15,111,111,22,22,0,1,0
22,114,114,29,2,27,4,3
5,116,116,10,3,7,2,1
3,128,128,3,3,0,1,0
20,128,128,2,2,0,1,0
1,138,138,14,14,0,1,0
14,156,156,6,2,4,2,1
2,215,215,3,3,0,1,0
17,224,224,20,20,0,1,0
0,246,246,6,6,0,1,0
18,274,274,5,5,0,1,0
11,293,293,55,55,0,1,0
16,297,297,79,79,0,1,0
19,299,299,12,12,0,1,0
8,345,345,6,6,0,1,0
7,346,346,91,31,60,4,3
13,347,347,5,5,0,1,0
4,360,360,5,5,0,1,0
12,365,365,70,70,0,1,0
25,377,377,15,2,13,2,1
9,378,378,84,84,0,1,0
10,414,414,43,4,39,4,3
21,462,462,2,2,0,1,0
24,463,463,108,108,0,1,0
23,474,474,57,35,22,3,2
6,492,492,26,26,0,1,0

28,114,114,4,4,0,1,0
3,115,115,3,3,0,1,0
6,125,125,6,6,0,1,0
5,129,129,9,1,8,3,2
1,131,131,2,2,0,1,0
12,144,144,1,1,0,1,0
31,162,162,24,12,12,3,2
2,169,169,28,7,21,3,2
4,181,181,44,44,0,1,0
17,214,214,13,13,0,1,0
8,216,216,7,7,0,1,0
9,230,230,7,3,4,2,1
10,237,237,8,8,0,1,0
30,249,249,6,6,0,1,0
22,266,266,5,5,0,1,0
26,272,272,27,6,21,2,1
29,290,290,19,19,0,1,0
21,296,296,51,51,0,1,0
13,307,307,13,13,0,1,0
15,313,313,18,18,0,1,0
7,321,321,75,59,16,2,1
23,323,323,46,16,30,4,3
0,324,324,5,1,4,2,1
16,335,335,1,1,0,1,0
19,371,371,52,52,0,1,0
32,375,375,43,1,42,2,1
18,376,376,15,15,0,1,0
25,381,381,32,6,26,3,2
14,381,381,8,8,0,1,0
24,409,409,33,33,0,1,0
27,453,453,92,92,0,1,0
11,456,456,7,2,5,2,1
20,467,467,64,1,63,3,2

2,141,141,5,5,0,1,0
12,143,143,6,6,0,1,0
34,153,153,1,1,0,1,0
15,158,158,11,5,6,2,1
21,161,161,2,2,0,1,0
22,172,172,3,3,0,1,0
30,189,189,2,2,0,1,0
17,197,197,11,11,0,1,0
23,199,199,21,3,18,4,3
29,230,230,8,8,0,1,0
14,261,261,9,3,6,2,1
19,265,265,4,4,0,1,0
5,269,269,15,15,0,1,0
6,270,270,31,8,23,2,1
24,271,271,6,6,0,1,0
27,301,301,62,10,52,3,2
0,328,328,2,2,0,1,0
20,329,329,5,1,4,2,1
10,330,330,49,15,34,3,2
33,340,340,22,22,0,1,0
16,342,342,15,15,0,1,0
4,349,349,13,13,0,1,0
3,358,358,48,15,33,4,3
7,372,372,26,26,0,1,0
18,387,387,45,21,24,2,1
28,388,388,96,29,67,4,3
11,404,404,10,10,0,1,0
8,409,409,25,25,0,1,0
35,411,411,70,16,54,4,3
32,424,424,5,2,3,2,1
1,438,438,36,36,0,1,0
9,438,438,25,17,8,3,2
26,458,458,18,5,13,2,1
25,479,479,23,11,12,4,3
13,492,492,27,3,24,2,1
31,496,496,178,82,96,4,3

17,127,127,11,11,0,1,0
9,139,139,5,5,0,1,0
11,145,145,16,5,11,2,1
0,154,154,1,1,0,1,0
15,162,162,5,2,3,2,1
22,163,163,5,5,0,1,0
19,166,166,3,3,0,1,0
7,168,168,11,11,0,1,0
10,175,175,64,64,0,1,0
3,179,179,8,8,0,1,0
1,180,180,3,3,0,1,0
13,259,259,34,34,0,1,0
12,259,259,3,3,0,1,0
4,266,266,16,16,0,1,0
28,285,285,127,70,57,4,3
2,309,309,13,13,0,1,0
24,314,314,12,4,8,3,2
26,352,352,43,43,0,1,0
29,367,367,11,11,0,1,0
25,376,376,49,23,26,3,2
8,376,376,8,8,0,1,0
21,381,381,8,8,0,1,0
23,385,385,66,10,56,4,3
16,391,391,51,51,0,1,0
14,394,394,25,1,24,3,2
6,394,394,8,2,6,3,2
5,435,435,63,29,34,3,2
18,468,468,10,4,6,3,2
27,484,484,28,10,18,3,2
20,493,493,75,26,49,4,3

2,105,105,2,2,0,1,0
1,106,106,6,2,4,2,1
15,155,155,1,1,0,1,0
3,158,158,8,5,3,2,1
20,164,164,12,12,0,1,0
5,167,167,3,3,0,1,0
22,180,180,30,30,0,1,0
13,185,185,1,1,0,1,0
23,192,192,1,1,0,1,0
8,236,236,19,19,0,1,0
29,246,246,11,7,4,2,1
19,252,252,1,1,0,1,0
4,256,256,6,6,0,1,0
17,266,266,81,81,0,1,0
28,282,282,21,21,0,1,0
10,300,300,1,1,0,1,0
11,305,305,41,41,0,1,0
12,336,336,50,30,20,3,2
26,351,351,147,141,6,3,2
6,378,378,55,55,0,1,0
21,405,405,20,5,15,2,1
9,415,415,35,35,0,1,0
7,441,441,15,1,14,3,2
24,453,453,18,18,0,1,0
27,456,456,4,1,3,2,1
14,462,462,113,51,62,3,2
25,466,466,56,29,27,2,1
18,468,468,7,7,0,1,0
16,475,475,11,11,0,1,0
0,484,484,108,108,0,1,0

20,110,110,2,2,0,1,0
5,112,112,2,2,0,1,0
16,118,118,17,7,10,2,1
3,141,141,35,5,30,2,1
9,141,141,53,17,36,4,3
17,148,148,10,2,8,2,1
4,156,156,15,6,9,2,1
14,158,158,39,14,25,2,1
10,189,189,6,6,0,1,0
11,192,192,15,15,0,1,0
6,225,225,89,89,0,1,0
2,234,234,10,10,0,1,0
12,264,264,29,29,0,1,0
19,264,264,12,3,9,2,1
21,266,266,38,21,17,2,1
18,304,304,45,45,0,1,0
13,308,308,18,18,0,1,0
7,344,344,12,12,0,1,0
1,419,419,1,1,0,1,0
0,445,445,8,8,0,1,0
8,480,480,34,34,0,1,0
22,480,480,70,31,39,2,1
15,492,492,45,45,0,1,0

15,100,100,1,1,0,1,0
0,110,110,1,1,0,1,0
18,134,134,10,4,6,2,1
8,138,138,19,3,16,4,3
28,169,169,3,3,0,1,0
2,175,175,10,10,0,1,0
10,184,184,7,7,0,1,0
4,198,198,22,22,0,1,0
11,199,199,1,1,0,1,0
27,228,228,23,8,15,2,1
17,257,257,34,17,17,2,1
21,272,272,27,7,20,2,1
29,273,273,16,13,3,2,1
20,297,297,37,37,0,1,0
6,308,308,73,73,0,1,0
13,314,314,10,10,0,1,0
19,318,318,91,91,0,1,0
1,332,332,28,28,0,1,0
26,351,351,16,7,9,4,3
3,355,355,21,21,0,1,0
25,357,357,2,2,0,1,0
30,357,357,66,58,8,2,1
23,360,360,19,6,13,3,2
22,370,370,10,10,0,1,0
14,374,374,68,68,0,1,0
7,382,382,43,21,22,3,2
16,389,389,1,1,0,1,0
24,397,397,98,98,0,1,0
12,483,483,13,13,0,1,0
5,496,496,9,9,0,1,0
9,500,500,23,23,0,1,0

6,120,120,17,17,0,1,0
18,126,126,5,2,3,2,1
13,130,130,4,4,0,1,0
3,135,135,20,4,16,2,1
19,137,137,3,3,0,1,0
4,142,142,8,8,0,1,0
23,147,147,3,3,0,1,0
21,147,147,13,13,0,1,0
5,149,149,25,5,20,2,1
1,177,177,31,17,14,3,2
24,180,180,37,37,0,1,0
0,180,180,4,4,0,1,0
12,212,212,7,7,0,1,0
20,236,236,92,59,33,2,1
14,258,258,27,18,9,4,3
15,266,266,28,28,0,1,0
16,269,269,8,8,0,1,0
8,389,389,20,20,0,1,0
17,414,414,78,78,0,1,0
2,421,421,25,25,0,1,0
22,440,440,38,16,22,2,1
7,452,452,102,102,0,1,0
10,456,456,10,2,8,3,2
11,464,464,6,6,0,1,0
9,484,484,106,106,0,1,0

10,106,106,1,1,0,1,0
30,112,112,15,5,10,2,1
16,118,118,10,10,0,1,0
3,119,119,4,4,0,1,0
2,158,158,3,3,0,1,0
26,168,168,10,10,0,1,0
18,184,184,1,1,0,1,0
17,185,185,11,2,9,3,2
21,185,185,43,40,3,2,1
0,185,185,20,16,4,2,1
4,191,191,3,3,0,1,0
22,197,197,5,1,4,2,1
28,213,213,76,76,0,1,0
29,224,224,9,1,8,3,2
13,244,244,37,37,0,1,0
15,248,248,36,6,30,2,1
11,262,262,4,4,0,1,0
5,269,269,17,17,0,1,0
7,269,269,11,11,0,1,0
27,298,298,26,26,0,1,0
20,307,307,42,30,12,2,1
25,321,321,17,17,0,1,0
6,328,328,28,11,17,2,1
9,340,340,19,19,0,1,0
24,374,374,3,3,0,1,0
1,428,428,7,7,0,1,0
19,429,429,13,7,6,2,1
8,438,438,134,78,56,4,3
14,469,469,7,7,0,1,0
23,485,485,79,79,0,1,0
12,486,486,38,4,34,2,1

24,104,104,1,1,0,1,0
27,143,143,46,46,0,1,0
1,144,144,2,2,0,1,0
28,151,151,39,39,0,1,0
26,152,152,4,4,0,1,0
18,158,158,17,9,8,2,1
0,164,164,24,9,15,2,1
3,173,173,4,4,0,1,0
7,185,185,11,5,6,3,2
14,200,200,5,5,0,1,0
5,208,208,27,5,22,2,1
2,216,216,13,13,0,1,0
13,220,220,10,10,0,1,0
9,238,238,10,7,3,2,1
20,248,248,20,20,0,1,0
6,256,256,11,7,4,2,1
10,264,264,3,3,0,1,0
16,295,295,53,25,28,3,2
15,295,295,108,102,6,3,2
22,306,306,41,3,38,2,1
11,322,322,24,24,0,1,0
8,334,334,40,40,0,1,0
19,348,348,21,21,0,1,0
4,367,367,39,3,36,4,3
21,398,398,16,13,3,2,1
17,416,416,1,1,0,1,0
12,421,421,15,10,5,2,1
25,421,421,22,13,9,2,1
23,469,469,30,5,25,4,3

6,102,102,3,3,0,1,0
26,109,109,6,6,0,1,0
8,114,114,5,5,0,1,0
5,205,205,7,7,0,1,0
10,206,206,8,8,0,1,0
15,208,208,3,3,0,1,0
24,209,209,19,3,16,3,2
7,243,243,13,4,9,4,3
14,250,250,35,35,0,1,0
4,263,263,1,1,0,1,0
2,265,265,21,21,0,1,0
1,267,267,52,52,0,1,0
18,282,282,10,4,6,2,1
23,287,287,36,36,0,1,0
11,293,293,21,21,0,1,0
13,300,300,16,5,11,2,1
16,365,365,35,35,0,1,0
3,399,399,32,29,3,2,1
25,403,403,51,26,25,4,3
0,427,427,107,107,0,1,0
20,439,439,22,10,12,4,3
9,459,459,26,26,0,1,0
21,465,465,26,26,0,1,0
27,465,465,37,37,0,1,0
28,478,478,116,70,46,2,1
22,496,496,37,25,12,3,2
17,497,497,11,11,0,1,0
19,500,500,130,130,0,1,0
12,500,500,80,40,40,3,2

2,112,112,1,1,0,1,0
15,143,143,13,1,12,4,3
16,220,220,2,2,0,1,0
0,225,225,32,32,0,1,0
10,226,226,50,50,0,1,0
11,238,238,41,23,18,2,1
7,251,251,26,26,0,1,0
1,307,307,90,22,68,3,2
5,320,320,118,118,0,1,0
18,346,346,10,10,0,1,0
6,364,364,21,21,0,1,0
13,369,369,8,8,0,1,0
19,384,384,5,5,0,1,0
8,417,417,2,2,0,1,0
4,427,427,106,80,26,2,1
17,432,432,25,25,0,1,0
3,441,441,81,43,38,2,1
9,493,493,83,83,0,1,0
14,493,493,201,147,54,4,3
12,497,497,9,3,6,2,1

15,112,112,8,2,6,3,2
17,143,143,32,10,22,3,2
13,151,151,34,22,12,3,2
9,169,169,42,8,34,3,2
12,245,245,43,1,42,4,3
5,260,260,36,36,0,1,0
20,265,265,31,3,28,2,1
23,278,278,8,8,0,1,0
19,281,281,3,3,0,1,0
0,285,285,47,47,0,1,0
10,293,293,32,32,0,1,0
14,296,296,27,18,9,4,3
2,326,326,8,8,0,1,0
21,357,357,48,5,43,4,3
6,408,408,75,27,48,3,2
11,415,415,71,14,57,4,3
18,426,426,10,10,0,1,0
7,451,451,39,39,0,1,0
4,461,461,12,12,0,1,0
1,461,461,110,110,0,1,0
22,463,463,4,4,0,1,0
8,468,468,4,4,0,1,0
3,473,473,35,10,25,2,1
16,474,474,18,3,15,4,3

12,117,117,2,2,0,1,0
24,119,119,10,4,6,2,1
17,154,154,35,35,0,1,0
26,167,167,16,11,5,2,1
25,174,174,8,8,0,1,0
13,192,192,60,18,42,3,2
14,193,193,20,5,15,4,3
20,249,249,33,14,19,3,2
10,271,271,8,8,0,1,0
0,296,296,16,12,4,2,1
8,300,300,76,28,48,4,3
7,319,319,19,4,15,2,1
1,321,321,54,5,49,2,1
4,341,341,14,14,0,1,0
11,353,353,15,8,7,2,1
9,374,374,1,1,0,1,0
5,376,376,36,24,12,4,3
19,384,384,12,2,10,2,1
21,414,414,19,4,15,4,3
23,424,424,26,26,0,1,0
3,437,437,27,3,24,4,3
22,443,443,68,4,64,3,2
6,444,444,40,40,0,1,0
18,454,454,121,11,110,4,3
15,470,470,19,15,4,2,1
16,480,480,18,18,0,1,0
2,497,497,37,37,0,1,0

14,117,117,37,37,0,1,0
18,122,122,16,16,0,1,0
10,137,137,3,3,0,1,0
21,157,157,12,6,6,2,1
1,164,164,11,11,0,1,0
20,167,167,36,25,11,2,1
17,187,187,7,1,6,3,2
9,242,242,10,7,3,2,1
2,251,251,59,59,0,1,0
13,253,253,10,10,0,1,0
3,330,330,8,2,6,3,2
0,348,348,52,52,0,1,0
8,351,351,53,53,0,1,0
16,363,363,85,27,58,3,2
6,388,388,75,75,0,1,0
5,402,402,52,16,36,3,2
4,444,444,47,32,15,4,3
15,445,445,15,15,0,1,0
19,452,452,25,13,12,2,1
11,467,467,43,43,0,1,0
7,478,478,118,109,9,4,3
12,488,488,19,4,15,4,3

4,130,130,5,5,0,1,0
0,132,132,41,38,3,2,1
25,143,143,13,7,6,2,1
3,144,144,17,17,0,1,0
11,147,147,21,16,5,2,1
15,162,162,10,7,3,2,1
21,173,173,19,19,0,1,0
6,174,174,18,11,7,2,1
1,200,200,5,1,4,2,1
18,220,220,27,9,18,3,2
7,229,229,5,5,0,1,0
14,231,231,3,3,0,1,0
23,235,235,8,8,0,1,0
9,241,241,5,1,4,2,1
2,243,243,1,1,0,1,0
13,277,277,65,15,50,3,2
20,294,294,72,39,33,4,3
17,303,303,17,17,0,1,0
24,319,319,13,13,0,1,0
12,340,340,36,36,0,1,0
8,368,368,70,70,0,1,0
16,409,409,72,2,70,3,2
19,429,429,16,16,0,1,0
10,435,435,51,51,0,1,0
22,452,452,44,2,42,4,3
5,499,499,51,11,40,2,1

11,102,102,1,1,0,1,0
24,121,121,25,11,14,4,3
0,131,131,1,1,0,1,0
10,136,136,13,13,0,1,0
20,137,137,11,11,0,1,0
23,160,160,20,5,15,2,1
19,164,164,11,1,10,2,1
8,181,181,58,25,33,4,3
18,189,189,50,41,9,4,3
26,198,198,16,1,15,4,3
9,222,222,7,7,0,1,0
22,222,222,7,7,0,1,0
7,258,258,8,8,0,1,0
4,263,263,29,29,0,1,0
3,264,264,24,6,18,4,3
15,300,300,1,1,0,1,0
13,313,313,16,6,10,2,1
12,315,315,15,15,0,1,0
17,329,329,62,26,36,2,1
1,338,338,96,14,82,4,3
14,374,374,25,25,0,1,0
2,391,391,2,2,0,1,0
21,415,415,64,47,17,2,1
5,422,422,15,15,0,1,0
16,438,438,17,3,14,3,2
6,479,479,87,39,48,4,3
25,487,487,13,13,0,1,0

27,106,106,7,3,4,2,1
11,121,121,1,1,0,1,0
13,123,123,4,1,3,2,1
18,137,137,6,6,0,1,0
21,155,155,33,33,0,1,0
23,168,168,1,1,0,1,0
24,170,170,5,5,0,1,0
17,175,175,6,6,0,1,0
12,237,237,6,2,4,2,1
4,244,244,28,28,0,1,0
19,284,284,49,43,6,2,1
16,296,296,37,3,34,3,2
22,307,307,10,4,6,2,1
26,340,340,8,8,0,1,0
7,352,352,1,1,0,1,0
8,360,360,15,8,7,2,1
25,362,362,92,44,48,3,2
0,382,382,30,30,0,1,0
6,386,386,15,15,0,1,0
1,402,402,83,83,0,1,0
9,414,414,24,24,0,1,0
2,432,432,13,13,0,1,0
15,434,434,23,23,0,1,0
20,443,443,125,2,123,4,3
14,467,467,106,95,11,3,2
10,477,477,13,13,0,1,0
5,481,481,87,40,47,4,3
3,488,488,112,74,38,3,2

8,108,108,2,2,0,1,0
18,122,122,3,3,0,1,0
14,183,183,34,14,20,3,2
21,190,190,8,8,0,1,0
20,235,235,12,12,0,1,0
0,238,238,4,4,0,1,0
24,250,250,2,2,0,1,0
2,251,251,9,6,3,2,1
11,259,259,22,14,8,2,1
27,267,267,5,2,3,2,1
22,281,281,15,15,0,1,0
12,285,285,6,6,0,1,0
10,289,289,21,21,0,1,0
25,311,311,119,72,47,3,2
7,322,322,22,22,0,1,0
19,342,342,54,22,32,2,1
23,387,387,7,1,6,3,2
26,395,395,6,2,4,2,1
5,398,398,26,17,9,4,3
9,401,401,33,12,21,2,1
4,408,408,32,32,0,1,0
28,422,422,92,56,36,4,3
15,437,437,67,23,44,2,1
13,444,444,143,143,0,1,0
6,450,450,1,1,0,1,0
1,450,450,26,10,16,2,1
16,469,469,22,10,12,3,2
3,470,470,17,13,4,2,1
17,489,489,141,141,0,1,0

10,102,102,9,9,0,1,0
27,192,192,3,3,0,1,0
14,218,218,4,4,0,1,0
21,224,224,11,11,0,1,0
8,233,233,5,5,0,1,0
16,234,234,2,2,0,1,0
18,244,244,46,46,0,1,0
1,276,276,2,2,0,1,0
11,277,277,5,5,0,1,0
26,281,281,22,3,19,2,1
23,289,289,22,22,0,1,0
5,293,293,39,27,12,4,3
29,298,298,31,31,0,1,0
17,307,307,37,1,36,4,3
24,322,322,105,40,65,4,3
6,355,355,51,51,0,1,0
4,358,358,5,5,0,1,0
30,377,377,37,14,23,2,1
9,391,391,51,11,40,3,2
15,394,394,41,41,0,1,0
28,404,404,132,5,127,4,3
3,409,409,60,53,7,2,1
2,412,412,23,13,10,2,1
7,430,430,6,6,0,1,0
20,432,432,19,19,0,1,0
0,433,433,36,36,0,1,0
13,441,441,2,2,0,1,0
19,450,450,6,6,0,1,0
22,457,457,16,6,10,2,1
31,458,458,52,52,0,1,0
12,460,460,1,1,0,1,0
25,471,471,19,1,18,4,3

11,118,118,10,5,5,2,1
0,129,129,6,6,0,1,0
24,142,142,6,2,4,2,1
10,173,173,1,1,0,1,0
12,230,230,10,10,0,1,0
7,260,260,44,44,0,1,0
25,260,260,17,5,12,2,1
18,275,275,45,45,0,1,0
27,278,278,28,14,14,3,2
15,278,278,41,2,39,4,3
3,301,301,4,4,0,1,0
16,311,311,46,6,40,3,2
14,314,314,45,5,40,2,1
13,339,339,19,2,17,4,3
4,349,349,13,5,8,2,1
9,383,383,34,28,6,2,1
20,398,398,8,8,0,1,0
26,408,408,6,1,5,2,1
2,409,409,13,13,0,1,0
19,421,421,9,9,0,1,0
5,449,449,61,61,0,1,0
17,475,475,1,1,0,1,0
21,478,478,202,187,15,4,3
6,483,483,54,51,3,2,1
8,484,484,61,43,18,3,2
23,489,489,30,30,0,1,0
22,494,494,54,8,46,4,3
1,495,495,103,1,102,4,3

24,106,106,6,6,0,1,0
6,113,113,4,4,0,1,0
11,126,126,1,1,0,1,0
16,158,158,9,9,0,1,0
5,175,175,23,23,0,1,0
2,198,198,6,6,0,1,0
3,200,200,13,13,0,1,0
27,208,208,6,6,0,1,0
10,231,231,7,7,0,1,0
13,235,235,6,6,0,1,0
19,239,239,11,11,0,1,0
30,267,267,15,15,0,1,0
0,272,272,13,13,0,1,0
25,322,322,88,37,51,3,2
8,325,325,14,6,8,2,1
29,331,331,5,5,0,1,0
22,343,343,29,29,0,1,0
4,371,371,12,3,9,2,1
20,386,386,26,26,0,1,0
7,388,388,20,10,10,3,2
15,402,402,29,29,0,1,0
14,412,412,45,32,13,2,1
12,416,416,38,38,0,1,0
31,423,423,112,29,83,4,3
28,429,429,55,22,33,2,1
18,431,431,14,14,0,1,0
23,460,460,80,12,68,3,2
9,461,461,89,89,0,1,0
26,473,473,12,7,5,2,1
21,475,475,49,28,21,4,3
1,475,475,6,6,0,1,0
17,486,486,113,101,12,4,3

6,110,110,11,11,0,1,0
9,149,149,8,5,3,2,1
16,156,156,22,12,10,3,2
15,158,158,6,6,0,1,0
21,161,161,2,2,0,1,0
14,187,187,12,4,8,2,1
8,188,188,11,11,0,1,0
11,202,202,25,5,20,3,2
20,222,222,14,8,6,3,2
19,228,228,16,16,0,1,0
13,237,237,4,4,0,1,0
7,267,267,91,64,27,4,3
12,326,326,5,5,0,1,0
0,338,338,192,80,112,4,3
10,366,366,79,35,44,3,2
4,382,382,46,46,0,1,0
2,405,405,2,2,0,1,0
17,414,414,113,113,0,1,0
3,451,451,1,1,0,1,0
1,472,472,22,16,6,3,2
5,472,472,29,29,0,1,0
18,479,479,121,81,40,2,1

17,104,104,14,14,0,1,0
1,129,129,1,1,0,1,0
5,142,142,1,1,0,1,0
16,144,144,14,14,0,1,0
7,160,160,5,5,0,1,0
3,179,179,24,24,0,1,0
2,180,180,38,22,16,2,1
24,199,199,75,75,0,1,0
15,233,233,18,9,9,2,1
22,257,257,16,8,8,2,1
23,279,279,8,2,6,2,1
25,307,307,76,59,17,2,1
13,327,327,32,12,20,2,1
19,331,331,2,2,0,1,0
11,332,332,7,3,4,2,1
20,346,346,5,2,3,2,1
4,353,353,13,1,12,4,3
18,360,360,36,3,33,2,1
6,371,371,33,4,29,2,1
9,409,409,89,65,24,4,3
0,415,415,46,46,0,1,0
21,416,416,24,24,0,1,0
14,476,476,11,11,0,1,0
8,484,484,134,96,38,3,2
10,487,487,21,21,0,1,0
12,497,497,57,57,0,1,0

18,111,111,3,3,0,1,0
4,114,114,1,1,0,1,0
10,115,115,15,3,12,3,2
24,161,161,13,13,0,1,0
12,184,184,13,7,6,2,1
6,193,193,2,2,0,1,0
9,197,197,1,1,0,1,0
26,211,211,41,17,24,3,2
27,295,295,46,5,41,2,1
15,305,305,32,11,21,4,3
17,313,313,19,19,0,1,0
14,318,318,28,28,0,1,0
21,323,323,23,23,0,1,0
1,342,342,4,4,0,1,0
13,374,374,13,3,10,3,2
0,375,375,40,40,0,1,0
25,376,376,89,89,0,1,0
22,379,379,62,45,17,2,1
19,383,383,58,58,0,1,0
11,397,397,14,5,9,4,3
8,404,404,70,4,66,4,3
23,406,406,41,41,0,1,0
7,421,421,16,16,0,1,0
2,437,437,69,69,0,1,0
28,452,452,17,8,9,2,1
20,453,453,2,2,0,1,0
3,454,454,32,32,0,1,0
16,477,477,16,16,0,1,0
5,480,480,122,73,49,4,3

0,128,128,29,29,0,1,0
11,133,133,60,60,0,1,0
17,136,136,1,1,0,1,0
8,148,148,10,10,0,1,0
1,155,155,27,27,0,1,0
18,169,169,26,10,16,2,1
9,196,196,6,6,0,1,0
19,217,217,7,3,4,2,1
14,230,230,11,5,6,2,1
13,250,250,2,2,0,1,0
12,255,255,5,1,4,2,1
6,256,256,15,15,0,1,0
10,282,282,12,12,0,1,0
3,297,297,48,18,30,4,3
7,299,299,70,70,0,1,0
16,351,351,109,10,99,4,3
15,388,388,34,34,0,1,0
20,388,388,44,44,0,1,0
5,417,417,146,111,35,4,3
2,472,472,11,11,0,1,0
21,489,489,9,9,0,1,0
4,495,495,2,2,0,1,0

4,100,100,3,3,0,1,0
2,103,103,4,4,0,1,0
11,106,106,1,1,0,1,0
8,121,121,2,2,0,1,0
3,134,134,4,1,3,2,1
24,142,142,10,10,0,1,0
7,146,146,1,1,0,1,0
28,149,149,11,2,9,4,3
9,161,161,9,9,0,1,0
14,167,167,10,10,0,1,0
18,177,177,20,20,0,1,0
15,195,195,12,8,4,2,1
25,206,206,79,79,0,1,0
6,209,209,77,77,0,1,0
27,249,249,10,10,0,1,0
20,253,253,20,6,14,3,2
26,291,291,3,3,0,1,0
17,331,331,39,39,0,1,0
23,332,332,3,3,0,1,0
1,352,352,11,5,6,2,1
13,367,367,1,1,0,1,0
21,371,371,51,51,0,1,0
10,374,374,87,87,0,1,0
5,386,386,45,45,0,1,0
12,440,440,97,25,72,3,2
0,443,443,9,9,0,1,0
22,481,481,19,6,13,2,1
16,483,483,53,53,0,1,0
19,496,496,67,40,27,4,3

10,120,120,22,14,8,3,2
3,138,138,3,3,0,1,0
9,145,145,28,28,0,1,0
14,165,165,3,3,0,1,0
8,166,166,26,26,0,1,0
25,188,188,10,4,6,2,1
24,199,199,2,2,0,1,0
26,231,231,11,11,0,1,0
15,245,245,1,1,0,1,0
23,248,248,35,21,14,3,2
6,297,297,22,3,19,2,1
22,304,304,31,31,0,1,0
29,312,312,47,47,0,1,0
31,331,331,49,49,0,1,0
4,332,332,7,7,0,1,0
12,334,334,22,22,0,1,0
27,338,338,1,1,0,1,0
20,338,338,33,33,0,1,0
11,376,376,26,26,0,1,0
28,405,405,80,59,21,4,3
7,405,405,31,23,8,2,1
2,410,410,10,10,0,1,0
17,419,419,17,2,15,2,1
5,420,420,23,23,0,1,0
30,432,432,102,102,0,1,0
16,436,436,50,50,0,1,0
0,437,437,8,8,0,1,0
1,460,460,1,1,0,1,0
32,484,484,19,1,18,4,3
19,489,489,6,6,0,1,0
13,493,493,61,3,58,3,2
21,495,495,44,44,0,1,0
18,498,498,13,13,0,1,0

3,114,114,1,1,0,1,0
8,115,115,39,39,0,1,0
20,121,121,22,22,0,1,0
13,143,143,57,19,38,3,2
4,144,144,13,6,7,2,1
11,145,145,7,7,0,1,0
16,149,149,4,1,3,2,1
6,163,163,12,12,0,1,0
12,173,173,2,2,0,1,0
21,207,207,11,1,10,3,2
19,214,214,11,11,0,1,0
25,216,216,2,2,0,1,0
24,220,220,11,11,0,1,0
15,223,223,1,1,0,1,0
10,234,234,7,1,6,3,2
17,286,286,73,73,0,1,0
23,313,313,24,24,0,1,0
22,320,320,50,50,0,1,0
2,353,353,24,24,0,1,0
18,381,381,23,5,18,3,2
14,387,387,3,3,0,1,0
1,414,414,136,119,17,2,1
7,441,441,102,55,47,2,1
9,465,465,6,1,5,2,1
0,476,476,19,19,0,1,0
5,484,484,9,9,0,1,0

20,134,134,7,3,4,2,1
6,159,159,3,3,0,1,0
16,184,184,40,31,9,4,3
8,196,196,35,35,0,1,0
5,206,206,44,44,0,1,0
11,229,229,103,103,0,1,0
15,236,236,7,1,6,3,2
0,238,238,126,62,64,3,2
3,242,242,15,1,14,3,2
10,291,291,33,33,0,1,0
4,298,298,30,12,18,3,2
1,333,333,49,49,0,1,0
9,336,336,26,26,0,1,0
7,370,370,18,6,12,2,1
18,422,422,33,33,0,1,0
14,436,436,1,1,0,1,0
17,436,436,3,3,0,1,0
12,448,448,44,10,34,4,3
13,451,451,9,9,0,1,0
19,463,463,18,18,0,1,0
2,480,480,1,1,0,1,0
21,489,489,68,68,0,1,0

13,104,104,1,1,0,1,0
2,131,131,2,2,0,1,0
7,137,137,13,6,7,2,1
8,161,161,6,3,3,2,1
0,171,171,12,12,0,1,0
21,176,176,9,9,0,1,0
6,194,194,51,26,25,4,3
22,227,227,38,38,0,1,0
23,237,237,20,8,12,3,2
10,263,263,16,3,13,2,1
18,268,268,43,34,9,2,1
3,271,271,66,6,60,3,2
14,271,271,7,7,0,1,0
5,274,274,65,38,27,2,1
9,306,306,48,12,36,2,1
12,307,307,62,24,38,2,1
19,315,315,48,48,0,1,0
16,373,373,40,35,5,2,1
17,386,386,44,35,9,2,1
20,432,432,1,1,0,1,0
4,434,434,12,12,0,1,0
15,449,449,98,98,0,1,0
1,477,477,45,12,33,4,3
11,497,497,13,13,0,1,0

0,108,108,10,10,0,1,0
16,130,130,9,9,0,1,0
7,172,172,31,31,0,1,0
26,198,198,2,2,0,1,0
12,238,238,14,2,12,4,3
14,239,239,24,18,6,3,2
1,243,243,8,8,0,1,0
5,258,258,4,4,0,1,0
10,275,275,85,85,0,1,0
19,275,275,48,4,44,4,3
4,278,278,32,5,27,4,3
2,283,283,3,3,0,1,0
13,291,291,10,5,5,2,1
3,295,295,20,20,0,1,0
23,297,297,11,11,0,1,0
20,301,301,175,175,0,1,0
9,303,303,3,3,0,1,0
6,312,312,27,8,19,2,1
21,327,327,10,4,6,2,1
22,366,366,11,11,0,1,0
25,367,367,18,18,0,1,0
24,380,380,1,1,0,1,0
27,401,401,22,4,18,4,3
28,421,421,78,78,0,1,0
15,441,441,26,26,0,1,0
8,442,442,44,44,0,1,0
11,444,444,13,13,0,1,0
17,453,453,32,7,25,2,1
18,490,490,15,15,0,1,0

13,112,112,1,1,0,1,0
15,126,126,20,20,0,1,0
12,143,143,1,1,0,1,0
9,191,191,6,2,4,2,1
4,220,220,1,1,0,1,0
25,221,221,9,9,0,1,0
14,227,227,57,1,56,3,2
19,241,241,24,24,0,1,0
21,268,268,16,16,0,1,0
16,280,280,27,1,26,3,2
11,288,288,13,13,0,1,0
10,293,293,47,47,0,1,0
3,334,334,37,28,9,4,3
22,365,365,18,18,0,1,0
2,384,384,36,36,0,1,0
17,388,388,3,3,0,1,0
5,395,395,122,122,0,1,0
0,397,397,37,37,0,1,0
1,398,398,9,9,0,1,0
8,401,401,7,7,0,1,0
24,404,404,88,16,72,4,3
23,414,414,69,59,10,2,1
18,473,473,30,27,3,2,1
20,480,480,49,49,0,1,0
7,495,495,61,27,34,2,1
6,497,497,140,59,81,4,3

11,103,103,11,1,10,2,1
17,137,137,22,6,16,3,2
4,147,147,26,23,3,2,1
8,183,183,21,3,18,4,3
0,216,216,1,1,0,1,0
22,230,230,34,2,32,2,1
19,231,231,3,3,0,1,0
16,268,268,37,37,0,1,0
26,279,279,36,36,0,1,0
18,286,286,72,72,0,1,0
6,306,306,2,2,0,1,0
15,335,335,40,26,14,3,2
3,365,365,41,29,12,4,3
13,368,368,31,31,0,1,0
10,370,370,19,19,0,1,0
5,371,371,53,26,27,4,3
12,395,395,30,1,29,2,1
24,398,398,9,9,0,1,0
20,399,399,17,17,0,1,0
1,436,436,9,9,0,1,0
2,441,441,119,80,39,2,1
7,449,449,46,28,18,4,3
14,463,463,19,6,13,2,1
23,464,464,4,4,0,1,0
21,465,465,82,40,42,2,1
9,482,482,15,15,0,1,0
25,486,486,36,26,10,2,1

19,127,127,6,1,5,2,1
9,128,128,87,77,10,2,1
3,129,129,23,3,20,3,2
13,134,134,1,1,0,1,0
10,134,134,15,15,0,1,0
8,168,168,4,4,0,1,0
7,187,187,1,1,0,1,0
18,201,201,18,2,16,3,2
5,207,207,36,8,28,3,2
6,277,277,40,7,33,4,3
14,312,312,14,14,0,1,0
20,346,346,48,13,35,2,1
2,373,373,126,126,0,1,0
12,393,393,47,47,0,1,0
1,402,402,90,35,55,4,3
17,445,445,6,1,5,2,1
11,455,455,11,3,8,3,2
0,474,474,16,16,0,1,0
16,479,479,4,4,0,1,0
4,482,482,100,52,48,3,2
15,493,493,12,8,4,2,1

1,143,143,10,10,0,1,0
17,163,163,13,1,12,2,1
13,181,181,8,8,0,1,0
9,208,208,10,1,9,4,3
16,231,231,6,6,0,1,0
14,241,241,12,12,0,1,0
3,244,244,97,40,57,4,3
21,247,247,1,1,0,1,0
15,255,255,6,6,0,1,0
18,257,257,17,4,13,2,1
10,281,281,34,10,24,2,1
12,302,302,51,51,0,1,0
7,344,344,39,27,12,3,2
6,379,379,46,46,0,1,0
22,393,393,102,48,54,3,2
11,402,402,61,28,33,4,3
5,404,404,43,43,0,1,0
0,439,439,136,136,0,1,0
20,446,446,140,140,0,1,0
8,449,449,2,2,0,1,0
19,453,453,8,8,0,1,0
2,471,471,1,1,0,1,0
4,481,481,63,21,42,4,3

9,121,121,9,2,7,2,1
12,124,124,10,10,0,1,0
2,131,131,10,10,0,1,0
24,159,159,22,22,0,1,0
0,164,164,10,10,0,1,0
1,177,177,8,8,0,1,0
6,216,216,20,20,0,1,0
22,253,253,6,6,0,1,0
5,268,268,3,3,0,1,0
10,286,286,66,66,0,1,0
11,295,295,14,14,0,1,0
18,301,301,10,2,8,3,2
16,325,325,67,8,59,3,2
26,335,335,24,20,4,2,1
20,351,351,72,67,5,2,1
19,356,356,28,28,0,1,0
13,364,364,53,15,38,3,2
3,397,397,80,35,45,2,1
17,404,404,28,25,3,2,1
4,408,408,28,14,14,3,2
14,416,416,118,88,30,3,2
7,419,419,17,17,0,1,0
8,434,434,54,12,42,2,1
15,436,436,24,24,0,1,0
23,449,449,2,2,0,1,0
21,466,466,46,46,0,1,0
25,486,486,22,22,0,1,0

12,142,142,1,1,0,1,0
13,144,144,7,7,0,1,0
24,169,169,26,8,18,4,3
27,190,190,10,10,0,1,0
17,211,211,16,1,15,3,2
0,212,212,4,1,3,2,1
6,222,222,36,17,19,2,1
25,239,239,15,15,0,1,0
26,248,248,2,2,0,1,0
4,279,279,13,3,10,3,2
18,308,308,18,18,0,1,0
3,316,316,36,36,0,1,0
19,326,326,89,89,0,1,0
11,343,343,83,83,0,1,0
2,348,348,15,8,7,2,1
9,354,354,57,57,0,1,0
16,391,391,26,26,0,1,0
22,421,421,84,77,7,2,1
10,421,421,10,10,0,1,0
21,431,431,16,4,12,4,3
5,452,452,8,1,7,3,2
14,464,464,98,98,0,1,0
15,472,472,47,32,15,2,1
8,473,473,60,60,0,1,0
20,477,477,89,86,3,2,1
7,487,487,18,10,8,3,2
23,494,494,23,11,12,4,3
1,497,497,20,20,0,1,0

8,101,101,3,3,0,1,0
12,123,123,6,3,3,2,1
21,137,137,3,3,0,1,0
28,146,146,2,2,0,1,0
9,199,199,1,1,0,1,0
11,216,216,2,2,0,1,0
27,217,217,29,1,28,2,1
2,227,227,1,1,0,1,0
15,228,228,53,21,32,4,3
19,237,237,62,62,0,1,0
23,238,238,17,2,15,4,3
14,242,242,15,2,13,2,1
4,265,265,32,8,24,3,2
26,267,267,48,17,31,4,3
3,274,274,52,52,0,1,0
30,281,281,1,1,0,1,0
1,294,294,16,16,0,1,0
7,304,304,1,1,0,1,0
5,327,327,17,17,0,1,0
17,347,347,8,2,6,2,1
16,361,361,28,28,0,1,0
20,370,370,44,44,0,1,0
10,385,385,1,1,0,1,0
6,391,391,101,9,92,3,2
22,406,406,4,4,0,1,0
25,413,413,27,9,18,3,2
13,422,422,15,15,0,1,0
18,429,429,132,86,46,2,1
29,429,429,52,1,51,3,2
24,448,448,7,2,5,2,1
0,485,485,45,34,11,2,1

22,116,116,12,12,0,1,0
2,142,142,7,7,0,1,0
17,151,151,17,17,0,1,0
18,170,170,40,30,10,3,2
7,180,180,26,26,0,1,0
11,201,201,7,7,0,1,0
8,208,208,1,1,0,1,0
12,212,212,33,33,0,1,0
13,222,222,13,9,4,2,1
6,252,252,29,4,25,2,1
3,303,303,1,1,0,1,0
24,304,304,35,21,14,3,2
9,318,318,132,93,39,4,3
23,320,320,9,9,0,1,0
4,350,350,1,1,0,1,0
19,402,402,33,5,28,2,1
21,410,410,19,19,0,1,0
14,412,412,95,95,0,1,0
10,417,417,18,6,12,2,1
16,459,459,1,1,0,1,0
20,469,469,17,5,12,4,3
15,470,470,57,19,38,3,2
1,480,480,24,10,14,3,2
5,486,486,85,22,63,3,2
0,490,490,130,30,100,3,2

14,104,104,2,2,0,1,0
12,115,115,5,2,3,2,1
23,122,122,3,3,0,1,0
20,122,122,18,18,0,1,0
22,126,126,22,13,9,3,2
21,126,126,25,25,0,1,0
11,127,127,26,26,0,1,0
0,135,135,12,5,7,2,1
1,142,142,19,5,14,2,1
9,164,164,9,9,0,1,0
18,174,174,60,60,0,1,0
2,179,179,4,4,0,1,0
8,207,207,10,10,0,1,0
7,229,229,16,4,12,3,2
6,241,241,33,33,0,1,0
4,296,296,161,116,45,4,3
19,312,312,17,17,0,1,0
13,387,387,4,4,0,1,0
16,390,390,34,12,22,3,2
5,394,394,59,51,8,3,2
17,424,424,8,8,0,1,0
15,436,436,8,8,0,1,0
3,443,443,21,21,0,1,0
10,488,488,2,2,0,1,0

10,143,143,13,13,0,1,0
23,157,157,11,8,3,2,1
8,158,158,1,1,0,1,0
18,179,179,9,1,8,2,1
14,182,182,73,55,18,3,2
19,200,200,20,20,0,1,0
21,203,203,7,7,0,1,0
4,246,246,3,3,0,1,0
24,290,290,12,7,5,2,1
11,320,320,24,24,0,1,0
22,322,322,39,6,33,2,1
6,323,323,27,17,10,3,2
13,324,324,37,37,0,1,0
20,336,336,37,37,0,1,0
12,364,364,1,1,0,1,0
1,415,415,89,66,23,4,3
2,417,417,193,193,0,1,0
25,417,417,50,50,0,1,0
17,432,432,37,2,35,2,1
15,433,433,28,13,15,4,3
9,435,435,32,32,0,1,0
16,443,443,7,3,4,2,1
7,468,468,18,6,12,3,2
5,488,488,70,28,42,4,3
0,489,489,6,6,0,1,0
3,497,497,43,43,0,1,0

26,124,124,15,1,14,2,1
6,126,126,4,4,0,1,0
7,152,152,14,14,0,1,0
25,179,179,6,6,0,1,0
3,191,191,13,2,11,2,1
15,193,193,25,4,21,4,3
0,205,205,9,1,8,3,2
1,224,224,15,10,5,2,1
17,249,249,1,1,0,1,0
20,250,250,5,5,0,1,0
30,252,252,14,14,0,1,0
28,253,253,18,4,14,3,2
24,267,267,31,31,0,1,0
10,274,274,7,2,5,2,1
12,275,275,1,1,0,1,0
2,288,288,5,5,0,1,0
31,301,301,3,3,0,1,0
18,302,302,20,9,11,3,2
23,307,307,75,75,0,1,0
9,320,320,60,39,21,4,3
13,350,350,15,12,3,2,1
14,359,359,28,21,7,2,1
16,366,366,9,9,0,1,0
8,373,373,41,3,38,3,2
32,377,377,79,79,0,1,0
19,398,398,45,18,27,4,3
27,424,424,66,66,0,1,0
11,424,424,2,2,0,1,0
29,437,437,8,8,0,1,0
22,465,465,48,48,0,1,0
5,474,474,24,2,22,4,3
4,478,478,67,67,0,1,0
21,500,500,84,84,0,1,0

5,110,110,21,21,0,1,0
15,119,119,5,5,0,1,0
12,129,129,4,4,0,1,0
3,156,156,9,9,0,1,0
4,163,163,1,1,0,1,0
11,166,166,10,10,0,1,0
17,175,175,44,44,0,1,0
0,181,181,74,22,52,3,2
2,218,218,59,15,44,3,2
20,253,253,2,2,0,1,0
6,256,256,48,30,18,4,3
1,289,289,45,45,0,1,0
19,307,307,2,2,0,1,0
18,321,321,72,72,0,1,0
13,324,324,31,1,30,4,3
8,368,368,2,2,0,1,0
7,384,384,9,9,0,1,0
14,423,423,19,19,0,1,0
16,430,430,52,34,18,4,3
9,474,474,43,7,36,4,3
10,492,492,169,106,63,4,3

9,106,106,8,8,0,1,0
10,106,106,12,2,10,2,1
4,129,129,22,6,16,2,1
20,139,139,19,14,5,2,1
18,167,167,4,4,0,1,0
7,193,193,15,9,6,2,1
28,199,199,25,25,0,1,0
22,206,206,18,5,13,2,1
5,232,232,38,38,0,1,0
2,238,238,3,3,0,1,0
16,247,247,4,1,3,2,1
12,258,258,16,16,0,1,0
6,262,262,3,3,0,1,0
0,262,262,19,15,4,2,1
21,278,278,28,17,11,2,1
17,280,280,13,13,0,1,0
14,287,287,8,1,7,2,1
23,289,289,155,145,10,2,1
27,334,334,37,37,0,1,0
24,337,337,5,5,0,1,0
25,343,343,1,1,0,1,0
13,355,355,25,25,0,1,0
26,376,376,10,1,9,4,3
8,376,376,4,4,0,1,0
29,391,391,30,18,12,4,3
19,397,397,13,13,0,1,0
3,398,398,58,58,0,1,0
11,413,413,26,26,0,1,0
1,483,483,9,9,0,1,0
15,491,491,93,50,43,2,1

15,122,122,2,2,0,1,0
14,164,164,24,14,10,3,2
16,169,169,10,2,8,2,1
1,193,193,75,43,32,3,2
6,204,204,13,13,0,1,0
10,208,208,29,22,7,2,1
2,211,211,17,2,15,2,1
13,230,230,18,2,16,4,3
8,254,254,58,58,0,1,0
0,271,271,58,37,21,2,1
4,324,324,100,22,78,3,2
5,363,363,56,24,32,3,2
11,394,394,23,23,0,1,0
12,401,401,146,44,102,4,3
7,415,415,2,2,0,1,0
17,418,418,32,3,29,2,1
9,446,446,14,14,0,1,0
3,461,461,72,45,27,2,1
18,483,483,28,28,0,1,0

5,127,127,10,10,0,1,0
14,138,138,8,8,0,1,0
23,176,176,9,5,4,2,1
15,182,182,32,9,23,2,1
19,189,189,22,10,12,3,2
17,192,192,37,19,18,3,2
21,200,200,7,7,0,1,0
4,213,213,7,7,0,1,0
7,234,234,17,17,0,1,0
11,237,237,1,1,0,1,0
1,244,244,49,25,24,4,3
3,252,252,4,4,0,1,0
2,268,268,13,4,9,2,1
6,275,275,25,12,13,4,3
22,295,295,3,3,0,1,0
8,307,307,96,60,36,4,3
0,325,325,2,2,0,1,0
13,331,331,2,2,0,1,0
24,339,339,75,4,71,4,3
18,372,372,71,23,48,3,2
25,389,389,47,37,10,2,1
12,389,389,51,32,19,2,1
26,400,400,27,18,9,4,3
10,440,440,69,21,48,4,3
16,452,452,29,29,0,1,0
9,472,472,40,40,0,1,0
20,495,495,10,10,0,1,0
27,500,500,33,33,0,1,0

5,115,115,21,21,0,1,0
14,118,118,5,5,0,1,0
0,138,138,6,6,0,1,0
9,160,160,4,1,3,2,1
13,162,162,19,19,0,1,0
19,167,167,41,31,10,3,2
7,226,226,11,2,9,2,1
4,233,233,7,7,0,1,0
3,257,257,6,6,0,1,0
22,262,262,31,13,18,3,2
24,275,275,13,13,0,1,0
6,311,311,8,8,0,1,0
10,319,319,79,79,0,1,0
17,330,330,1,1,0,1,0
26,355,355,16,16,0,1,0
12,360,360,35,11,24,3,2
25,363,363,60,60,0,1,0
15,364,364,41,41,0,1,0
16,400,400,88,88,0,1,0
21,400,400,21,6,15,4,3
8,408,408,51,26,25,3,2
1,412,412,41,41,0,1,0
23,436,436,25,25,0,1,0
2,451,451,87,3,84,3,2
18,453,453,91,16,75,4,3
11,459,459,3,3,0,1,0
20,488,488,22,22,0,1,0
27,497,497,5,5,0,1,0

11,115,115,6,3,3,2,1
14,129,129,23,23,0,1,0
8,157,157,12,8,4,2,1
19,167,167,15,8,7,2,1
25,172,172,5,5,0,1,0
0,173,173,51,6,45,2,1
9,188,188,17,17,0,1,0
1,215,215,8,8,0,1,0
22,222,222,13,13,0,1,0
17,222,222,39,12,27,4,3
13,229,229,9,9,0,1,0
15,259,259,2,2,0,1,0
12,261,261,40,25,15,4,3
23,266,266,84,84,0,1,0
26,273,273,22,22,0,1,0
6,296,296,32,32,0,1,0
10,299,299,6,1,5,2,1
18,340,340,3,3,0,1,0
21,384,384,17,3,14,2,1
24,384,384,105,105,0,1,0
4,410,410,12,12,0,1,0
20,411,411,10,10,0,1,0
5,422,422,54,54,0,1,0
2,432,432,25,13,12,4,3
16,454,454,19,8,11,2,1
3,455,455,87,87,0,1,0
7,494,494,12,12,0,1,0

12,110,110,13,8,5,2,1
7,111,111,1,1,0,1,0
5,141,141,24,24,0,1,0
17,153,153,15,1,14,3,2
16,183,183,4,4,0,1,0
23,228,228,24,17,7,2,1
10,229,229,24,24,0,1,0
20,260,260,5,1,4,2,1
18,263,263,4,4,0,1,0
8,266,266,15,12,3,2,1
22,268,268,46,46,0,1,0
11,271,271,48,26,22,3,2
0,293,293,21,18,3,2,1
14,314,314,68,68,0,1,0
13,317,317,1,1,0,1,0
15,323,323,75,27,48,2,1
6,376,376,86,86,0,1,0
9,377,377,21,21,0,1,0
1,416,416,91,82,9,4,3
3,421,421,37,37,0,1,0
24,437,437,111,27,84,4,3
21,452,452,28,28,0,1,0
2,456,456,39,19,20,2,1
19,466,466,8,8,0,1,0
4,472,472,17,3,14,3,2

22,131,131,14,14,0,1,0
6,134,134,29,8,21,4,3
15,143,143,33,33,0,1,0
23,178,178,14,14,0,1,0
4,225,225,95,25,70,4,3
3,227,227,36,36,0,1,0
21,228,228,14,14,0,1,0
17,237,237,62,62,0,1,0
18,248,248,2,2,0,1,0
1,250,250,1,1,0,1,0
13,251,251,5,2,3,2,1
7,257,257,7,7,0,1,0
12,278,278,2,2,0,1,0
2,282,282,4,4,0,1,0
5,300,300,47,14,33,4,3
11,308,308,18,2,16,2,1
19,316,316,2,2,0,1,0
9,334,334,19,11,8,3,2
8,375,375,35,35,0,1,0
10,411,411,30,30,0,1,0
14,417,417,96,74,22,2,1
20,425,425,6,6,0,1,0
0,450,450,35,24,11,2,1
16,500,500,121,121,0,1,0

9,100,100,22,22,0,1,0
3,112,112,2,2,0,1,0
2,115,115,15,15,0,1,0
17,119,119,8,8,0,1,0
18,122,122,2,2,0,1,0
12,152,152,39,21,18,4,3
20,194,194,1,1,0,1,0
22,211,211,28,28,0,1,0
6,256,256,3,3,0,1,0
19,277,277,27,27,0,1,0
4,277,277,46,5,41,2,1
14,278,278,51,51,0,1,0
10,301,301,48,21,27,4,3
0,304,304,51,51,0,1,0
5,315,315,20,20,0,1,0
24,369,369,17,3,14,2,1
7,373,373,8,8,0,1,0
13,378,378,58,58,0,1,0
11,399,399,46,46,0,1,0
1,411,411,36,36,0,1,0
23,417,417,98,98,0,1,0
16,419,419,10,10,0,1,0
15,421,421,36,36,0,1,0
21,453,453,6,1,5,2,1
8,499,499,70,70,0,1,0

26,157,157,8,8,0,1,0
33,162,162,37,37,0,1,0
30,169,169,62,27,35,2,1
0,175,175,21,21,0,1,0
27,222,222,19,2,17,2,1
8,229,229,5,5,0,1,0
29,234,234,5,2,3,2,1
15,238,238,25,25,0,1,0
14,247,247,9,1,8,3,2
17,263,263,3,3,0,1,0
1,274,274,7,7,0,1,0
2,275,275,30,30,0,1,0
4,301,301,46,24,22,3,2
9,303,303,43,7,36,2,1
24,307,307,15,15,0,1,0
28,323,323,35,20,15,4,3
16,330,330,18,18,0,1,0
5,349,349,41,41,0,1,0
3,355,355,30,30,0,1,0
25,375,375,30,30,0,1,0
23,387,387,29,8,21,4,3
22,403,403,1,1,0,1,0
6,404,404,32,7,25,4,3
13,409,409,4,4,0,1,0
20,423,423,12,12,0,1,0
21,438,438,81,81,0,1,0
18,445,445,5,1,4,2,1
31,468,468,13,1,12,4,3
7,475,475,21,2,19,2,1
12,486,486,4,4,0,1,0
19,487,487,20,20,0,1,0
10,487,487,15,15,0,1,0
32,489,489,23,23,0,1,0
11,498,498,34,34,0,1,0

13,137,137,2,2,0,1,0
20,153,153,27,19,8,3,2
10,159,159,10,10,0,1,0
5,162,162,45,35,10,3,2
21,192,192,20,20,0,1,0
17,193,193,20,10,10,3,2
8,205,205,1,1,0,1,0
6,206,206,82,82,0,1,0
19,250,250,62,62,0,1,0
15,329,329,16,5,11,2,1
14,341,341,9,9,0,1,0
18,350,350,87,87,0,1,0
0,362,362,18,9,9,2,1
11,397,397,42,42,0,1,0
3,404,404,27,27,0,1,0
1,414,414,43,43,0,1,0
9,430,430,18,2,16,3,2
2,446,446,3,3,0,1,0
16,461,461,6,1,5,2,1
4,483,483,186,186,0,1,0
12,489,489,65,65,0,1,0
7,494,494,4,1,3,2,1

21,127,127,6,6,0,1,0
25,130,130,7,2,5,2,1
0,154,154,9,9,0,1,0
10,159,159,7,7,0,1,0
16,175,175,8,8,0,1,0
17,176,176,5,5,0,1,0
12,183,183,1,1,0,1,0
7,191,191,30,21,9,2,1
24,191,191,5,5,0,1,0
5,201,201,7,7,0,1,0
27,203,203,20,20,0,1,0
18,222,222,10,2,8,2,1
9,238,238,36,6,30,2,1
8,247,247,6,6,0,1,0
13,254,254,15,11,4,2,1
32,259,259,7,7,0,1,0
14,278,278,10,10,0,1,0
22,278,278,39,19,20,4,3
6,306,306,4,4,0,1,0
19,338,338,19,19,0,1,0
31,342,342,56,56,0,1,0
15,345,345,40,6,34,3,2
26,350,350,39,39,0,1,0
2,352,352,7,7,0,1,0
23,353,353,71,71,0,1,0
4,367,367,2,2,0,1,0
28,385,385,106,65,41,2,1
3,399,399,57,25,32,2,1
11,402,402,4,4,0,1,0
29,447,447,41,41,0,1,0
20,459,459,29,12,17,2,1
30,485,485,14,1,13,2,1
1,487,487,121,19,102,4,3

1,117,117,9,5,4,2,1
6,144,144,9,9,0,1,0
10,156,156,42,6,36,2,1
19,174,174,9,9,0,1,0
5,179,179,29,9,20,2,1
17,181,181,3,3,0,1,0
15,196,196,5,5,0,1,0
0,203,203,3,3,0,1,0
11,230,230,1,1,0,1,0
7,250,250,25,25,0,1,0
8,262,262,15,5,10,4,3
18,273,273,20,20,0,1,0
9,294,294,25,10,15,2,1
20,297,297,26,26,0,1,0
12,388,388,40,40,0,1,0
2,424,424,206,83,123,4,3
14,429,429,114,114,0,1,0
4,437,437,20,2,18,4,3
21,437,437,112,112,0,1,0
3,447,447,132,75,57,4,3
13,478,478,6,6,0,1,0
16,494,494,40,40,0,1,0

14,100,100,11,7,4,2,1
16,123,123,7,7,0,1,0
17,134,134,16,7,9,4,3
10,138,138,3,3,0,1,0
21,158,158,4,4,0,1,0
3,190,190,5,5,0,1,0
7,203,203,19,19,0,1,0
1,217,217,1,1,0,1,0
30,220,220,55,20,35,2,1
15,229,229,1,1,0,1,0
24,236,236,3,3,0,1,0
11,237,237,2,2,0,1,0
8,271,271,7,7,0,1,0
27,271,271,2,2,0,1,0
20,278,278,24,24,0,1,0
19,295,295,55,55,0,1,0
0,321,321,36,8,28,2,1
12,321,321,36,36,0,1,0
23,325,325,29,14,15,4,3
5,332,332,121,23,98,4,3
26,336,336,62,2,60,4,3
25,336,336,12,12,0,1,0
4,366,366,7,7,0,1,0
13,368,368,37,37,0,1,0
28,375,375,3,3,0,1,0
9,386,386,12,12,0,1,0
18,401,401,8,8,0,1,0
2,412,412,12,12,0,1,0
22,436,436,34,34,0,1,0
29,454,454,129,129,0,1,0
31,473,473,37,20,17,2,1
6,492,492,20,6,14,3,2

21,104,104,11,11,0,1,0
0,105,105,19,7,12,2,1
19,115,115,4,1,3,2,1
29,132,132,12,12,0,1,0
20,135,135,28,14,14,3,2
7,138,138,37,28,9,4,3
3,147,147,13,4,9,2,1
25,164,164,32,17,15,2,1
12,181,181,3,3,0,1,0
10,186,186,6,6,0,1,0
1,188,188,26,26,0,1,0
27,205,205,7,7,0,1,0
14,212,212,3,3,0,1,0
24,237,237,22,22,0,1,0
26,243,243,6,1,5,2,1
2,279,279,14,5,9,4,3
13,286,286,22,7,15,4,3
17,299,299,1,1,0,1,0
9,323,323,23,2,21,2,1
8,346,346,21,1,20,3,2
15,352,352,24,24,0,1,0
22,365,365,17,12,5,2,1
23,371,371,100,100,0,1,0
4,375,375,4,1,3,2,1
6,375,375,10,7,3,2,1
16,395,395,59,18,41,4,3
18,458,458,28,3,25,4,3
28,462,462,78,78,0,1,0
5,463,463,8,4,4,2,1
11,464,464,14,14,0,1,0

13,123,123,20,3,17,2,1
4,168,168,37,15,22,2,1
3,183,183,11,11,0,1,0
10,196,196,55,19,36,4,3
21,239,239,32,32,0,1,0
18,243,243,64,64,0,1,0
14,292,292,9,9,0,1,0
5,311,311,41,41,0,1,0
8,316,316,20,10,10,2,1
12,326,326,4,4,0,1,0
17,334,334,15,15,0,1,0
22,373,373,47,33,14,3,2
2,375,375,7,7,0,1,0
19,389,389,14,1,13,2,1
20,406,406,29,3,26,4,3
16,425,425,12,5,7,2,1
11,446,446,41,41,0,1,0
6,458,458,15,15,0,1,0
7,466,466,61,61,0,1,0
0,466,466,126,78,48,4,3
15,470,470,17,7,10,2,1
1,491,491,148,99,49,3,2
9,498,498,36,36,0,1,0

3,101,101,1,1,0,1,0
4,104,104,8,8,0,1,0
11,106,106,2,2,0,1,0
23,124,124,17,17,0,1,0
18,130,130,15,7,8,3,2
5,131,131,27,7,20,3,2
14,155,155,30,30,0,1,0
25,185,185,5,5,0,1,0
1,188,188,1,1,0,1,0
16,198,198,62,41,21,2,1
19,201,201,10,10,0,1,0
12,277,277,97,7,90,3,2
6,284,284,14,3,11,3,2
24,309,309,6,6,0,1,0
20,313,313,5,5,0,1,0
21,329,329,3,3,0,1,0
9,349,349,21,9,12,3,2
22,365,365,9,6,3,2,1
17,370,370,42,42,0,1,0
13,382,382,32,32,0,1,0
0,428,428,74,74,0,1,0
2,431,431,37,37,0,1,0
10,438,438,81,24,57,4,3
15,443,443,100,28,72,4,3
7,488,488,33,33,0,1,0
8,498,498,6,6,0,1,0

7,111,111,13,13,0,1,0
15,132,132,53,31,22,3,2
8,133,133,1,1,0,1,0
6,140,140,22,13,9,4,3
5,141,141,43,43,0,1,0
0,144,144,15,15,0,1,0
11,177,177,1,1,0,1,0
2,189,189,39,1,38,3,2
1,199,199,27,3,24,3,2
20,202,202,3,3,0,1,0
13,204,204,8,5,3,2,1
23,224,224,5,5,0,1,0
4,256,256,21,18,3,2,1
18,285,285,34,34,0,1,0
22,305,305,16,7,9,3,2
3,374,374,31,9,22,2,1
19,389,389,10,2,8,2,1
12,402,402,59,53,6,3,2
24,411,411,10,4,6,2,1
14,432,432,39,39,0,1,0
21,446,446,8,8,0,1,0
9,451,451,43,8,35,2,1
17,458,458,154,142,12,2,1
16,464,464,14,14,0,1,0
10,480,480,1,1,0,1,0

1,101,101,8,8,0,1,0
0,138,138,16,16,0,1,0
10,150,150,30,30,0,1,0
11,166,166,23,3,20,2,1
27,172,172,56,56,0,1,0
22,172,172,1,1,0,1,0
9,174,174,1,1,0,1,0
2,200,200,17,3,14,2,1
18,224,224,2,2,0,1,0
8,246,246,2,2,0,1,0
23,261,261,23,23,0,1,0
20,281,281,2,2,0,1,0
25,286,286,3,3,0,1,0
14,289,289,14,14,0,1,0
19,306,306,28,28,0,1,0
7,311,311,119,98,21,4,3
26,332,332,6,6,0,1,0
5,336,336,9,9,0,1,0
15,341,341,20,20,0,1,0
12,343,343,2,2,0,1,0
13,344,344,28,3,25,2,1
17,356,356,19,2,17,2,1
21,369,369,114,76,38,3,2
3,386,386,22,22,0,1,0
24,424,424,93,93,0,1,0
16,431,431,57,57,0,1,0
4,484,484,17,13,4,2,1
6,491,491,16,7,9,4,3

21,107,107,6,6,0,1,0
3,147,147,18,8,10,3,2
19,152,152,3,3,0,1,0
9,170,170,12,6,6,3,2
20,191,191,6,6,0,1,0
8,206,206,6,6,0,1,0
23,226,226,3,3,0,1,0
10,232,232,25,7,18,4,3
25,253,253,5,5,0,1,0
13,257,257,10,1,9,4,3
15,259,259,35,8,27,2,1
0,275,275,15,10,5,2,1
2,321,321,48,5,43,4,3
6,323,323,48,19,29,2,1
17,327,327,4,4,0,1,0
4,356,356,9,9,0,1,0
27,367,367,21,13,8,2,1
1,394,394,5,5,0,1,0
22,401,401,49,8,41,2,1
24,413,413,25,9,16,4,3
5,414,414,72,72,0,1,0
11,427,427,24,24,0,1,0
26,448,448,143,47,96,3,2
18,462,462,76,9,67,4,3
12,462,462,39,28,11,2,1
7,465,465,1,1,0,1,0
28,485,485,100,55,45,4,3
16,493,493,117,117,0,1,0
14,498,498,46,46,0,1,0

0,114,114,3,3,0,1,0
23,117,117,2,2,0,1,0
15,177,177,6,2,4,2,1
17,223,223,25,21,4,2,1
12,236,236,61,57,4,2,1
18,236,236,7,7,0,1,0
22,244,244,21,21,0,1,0
6,252,252,4,4,0,1,0
25,265,265,33,10,23,2,1
10,281,281,8,8,0,1,0
9,289,289,13,1,12,2,1
2,292,292,84,84,0,1,0
11,293,293,15,15,0,1,0
7,315,315,10,10,0,1,0
1,330,330,16,16,0,1,0
24,365,365,21,6,15,4,3
19,372,372,143,95,48,2,1
3,378,378,6,6,0,1,0
21,405,405,114,77,37,2,1
8,406,406,60,60,0,1,0
16,425,425,21,21,0,1,0
27,434,434,13,1,12,4,3
4,449,449,50,50,0,1,0
14,458,458,21,3,18,4,3
5,460,460,10,2,8,3,2
13,471,471,78,14,64,3,2
26,487,487,23,12,11,2,1
20,489,489,38,9,29,2,1

4,101,101,1,1,0,1,0
22,133,133,5,1,4,2,1
16,134,134,1,1,0,1,0
15,137,137,3,3,0,1,0
29,146,146,18,15,3,2,1
7,150,150,1,1,0,1,0
1,175,175,9,9,0,1,0
12,187,187,12,4,8,2,1
21,196,196,26,26,0,1,0
0,203,203,35,35,0,1,0
24,245,245,22,22,0,1,0
5,253,253,1,1,0,1,0
19,258,258,17,17,0,1,0
13,269,269,20,20,0,1,0
3,279,279,1,1,0,1,0
30,287,287,112,85,27,3,2
27,292,292,6,2,4,2,1
20,310,310,10,10,0,1,0
18,315,315,11,11,0,1,0
11,341,341,57,57,0,1,0
9,342,342,26,26,0,1,0
2,344,344,20,3,17,4,3
26,345,345,12,12,0,1,0
28,369,369,15,15,0,1,0
23,395,395,111,111,0,1,0
17,407,407,15,5,10,3,2
6,440,440,21,21,0,1,0
10,445,445,120,92,28,3,2
8,455,455,29,5,24,3,2
25,498,498,20,20,0,1,0
14,500,500,83,29,54,4,3

18,104,104,25,3,22,2,1
22,111,111,20,20,0,1,0
2,112,112,3,3,0,1,0
17,123,123,7,1,6,3,2
10,172,172,10,6,4,2,1
9,188,188,15,9,6,2,1
21,190,190,7,1,6,3,2
5,208,208,4,4,0,1,0
1,213,213,8,8,0,1,0
4,236,236,57,57,0,1,0
26,244,244,4,1,3,2,1
6,249,249,5,5,0,1,0
13,250,250,58,25,33,4,3
15,251,251,3,3,0,1,0
11,251,251,17,17,0,1,0
0,275,275,37,25,12,4,3
23,279,279,55,55,0,1,0
16,287,287,54,54,0,1,0
8,297,297,5,5,0,1,0
3,320,320,25,9,16,3,2
20,329,329,30,30,0,1,0
24,335,335,15,15,0,1,0
7,341,341,20,20,0,1,0
27,342,342,23,23,0,1,0
14,424,424,4,4,0,1,0
19,428,428,13,7,6,3,2
25,454,454,79,7,72,3,2
12,497,497,110,100,10,2,1

6,110,110,17,17,0,1,0
5,113,113,2,2,0,1,0
26,116,116,5,2,3,2,1
10,120,120,12,12,0,1,0
22,143,143,15,7,8,2,1
9,157,157,14,14,0,1,0
19,161,161,12,6,6,2,1
25,163,163,28,28,0,1,0
0,188,188,8,8,0,1,0
3,206,206,24,8,16,3,2
20,221,221,22,22,0,1,0
28,223,223,11,11,0,1,0
18,227,227,12,12,0,1,0
21,235,235,13,1,12,4,3
7,256,256,58,58,0,1,0
29,258,258,30,30,0,1,0
17,277,277,59,43,16,3,2
8,309,309,14,14,0,1,0
16,325,325,5,5,0,1,0
4,347,347,37,2,35,2,1
1,349,349,11,11,0,1,0
24,364,364,13,13,0,1,0
11,369,369,20,20,0,1,0
12,387,387,4,4,0,1,0
13,439,439,43,31,12,2,1
27,439,439,34,34,0,1,0
2,454,454,8,8,0,1,0
14,458,458,60,60,0,1,0
23,469,469,110,74,36,4,3
15,479,479,22,22,0,1,0

5,105,105,4,1,3,2,1
22,179,179,12,8,4,2,1
18,184,184,5,5,0,1,0
25,192,192,3,3,0,1,0
2,204,204,14,14,0,1,0
14,206,206,25,9,16,3,2
24,217,217,15,2,13,2,1
21,242,242,23,23,0,1,0
12,251,251,38,38,0,1,0
10,252,252,17,17,0,1,0
28,256,256,139,139,0,1,0
31,263,263,14,14,0,1,0
1,272,272,20,20,0,1,0
4,276,276,1,1,0,1,0
26,283,283,2,2,0,1,0
8,290,290,2,2,0,1,0
29,295,295,8,8,0,1,0
19,301,301,14,14,0,1,0
17,303,303,1,1,0,1,0
9,310,310,42,24,18,2,1
30,319,319,27,9,18,4,3
7,337,337,12,2,10,2,1
16,354,354,22,14,8,2,1
6,373,373,1,1,0,1,0
23,374,374,15,15,0,1,0
13,409,409,35,26,9,4,3
0,411,411,32,32,0,1,0
32,413,413,91,49,42,2,1
20,415,415,12,7,5,2,1
11,434,434,16,16,0,1,0
33,439,439,45,45,0,1,0
3,480,480,1,1,0,1,0
27,485,485,4,1,3,2,1
15,498,498,112,112,0,1,0

21,119,119,7,7,0,1,0
23,160,160,3,3,0,1,0
24,172,172,13,13,0,1,0
9,177,177,17,17,0,1,0
5,179,179,16,8,8,3,2
20,188,188,28,19,9,2,1
11,193,193,2,2,0,1,0
6,217,217,76,76,0,1,0
7,224,224,2,2,0,1,0
13,228,228,19,8,11,3,2
8,259,259,37,5,32,4,3
18,260,260,21,16,5,2,1
14,281,281,96,6,90,3,2
3,289,289,27,27,0,1,0
10,328,328,12,1,11,3,2
4,335,335,17,17,0,1,0
15,339,339,52,52,0,1,0
19,343,343,21,21,0,1,0
17,370,370,21,1,20,2,1
25,371,371,74,74,0,1,0
16,377,377,24,24,0,1,0
12,421,421,35,8,27,2,1
0,424,424,12,6,6,3,2
22,424,424,21,21,0,1,0
2,459,459,104,47,57,4,3
26,462,462,8,8,0,1,0
1,463,463,1,1,0,1,0

20,111,111,5,5,0,1,0
5,117,117,9,3,6,2,1
2,161,161,61,61,0,1,0
8,167,167,22,22,0,1,0
19,169,169,1,1,0,1,0
21,184,184,31,31,0,1,0
3,196,196,42,42,0,1,0
1,227,227,1,1,0,1,0
22,229,229,2,2,0,1,0
7,238,238,7,7,0,1,0
14,272,272,19,19,0,1,0
12,276,276,42,42,0,1,0
13,290,290,107,107,0,1,0
11,309,309,1,1,0,1,0
18,318,318,1,1,0,1,0
10,323,323,48,32,16,3,2
4,370,370,10,2,8,3,2
0,375,375,93,14,79,3,2
16,415,415,90,18,72,3,2
15,421,421,29,29,0,1,0
17,424,424,71,34,37,3,2
6,433,433,11,11,0,1,0
9,441,441,8,8,0,1,0
23,469,469,25,11,14,3,2

18,109,109,6,6,0,1,0
10,113,113,19,19,0,1,0
20,144,144,12,12,0,1,0
26,181,181,35,35,0,1,0
12,191,191,3,3,0,1,0
28,191,191,9,9,0,1,0
17,203,203,16,16,0,1,0
7,213,213,2,2,0,1,0
19,213,213,53,53,0,1,0
2,231,231,11,11,0,1,0
29,238,238,32,9,23,4,3
21,242,242,2,2,0,1,0
15,261,261,2,2,0,1,0
13,267,267,22,16,6,2,1
23,295,295,12,2,10,2,1
11,295,295,23,23,0,1,0
22,299,299,25,25,0,1,0
14,312,312,21,21,0,1,0
5,325,325,94,62,32,3,2
8,326,326,53,39,14,2,1
6,358,358,8,8,0,1,0
25,390,390,50,28,22,2,1
3,395,395,1,1,0,1,0
16,413,413,30,6,24,4,3
4,435,435,44,44,0,1,0
9,438,438,15,8,7,2,1
27,476,476,66,4,62,3,2
24,479,479,42,42,0,1,0
1,487,487,59,59,0,1,0
0,491,491,9,1,8,3,2

17,114,114,1,1,0,1,0
22,125,125,2,2,0,1,0
24,144,144,22,2,20,3,2
30,171,171,32,11,21,3,2
25,174,174,8,8,0,1,0
29,188,188,1,1,0,1,0
0,192,192,10,10,0,1,0
26,217,217,19,13,6,2,1
31,223,223,5,5,0,1,0
8,227,227,16,1,15,4,3
12,228,228,1,1,0,1,0
28,239,239,6,6,0,1,0
21,279,279,45,45,0,1,0
16,306,306,48,28,20,2,1
1,318,318,15,9,6,3,2
23,320,320,62,2,60,4,3
13,326,326,9,9,0,1,0
6,347,347,1,1,0,1,0
14,368,368,71,71,0,1,0
20,371,371,31,31,0,1,0
4,375,375,20,20,0,1,0
19,376,376,91,91,0,1,0
3,376,376,14,14,0,1,0
18,413,413,10,10,0,1,0
27,451,451,52,52,0,1,0
10,456,456,2,2,0,1,0
2,460,460,40,14,26,2,1
7,461,461,54,54,0,1,0
5,464,464,9,9,0,1,0
11,470,470,27,20,7,2,1
9,474,474,118,118,0,1,0
15,489,489,43,7,36,4,3

19,175,175,6,6,0,1,0
7,196,196,11,11,0,1,0
14,201,201,1,1,0,1,0
12,218,218,76,38,38,3,2
9,219,219,11,7,4,2,1
8,220,220,32,32,0,1,0
5,221,221,8,1,7,2,1
13,227,227,14,14,0,1,0
20,260,260,10,10,0,1,0
0,269,269,49,49,0,1,0
18,282,282,57,57,0,1,0
1,283,283,26,2,24,4,3
23,287,287,58,19,39,4,3
11,301,301,30,18,12,4,3
3,305,305,15,15,0,1,0
15,321,321,28,28,0,1,0
17,322,322,17,5,12,3,2
10,349,349,22,22,0,1,0
2,376,376,107,34,73,4,3
16,381,381,18,15,3,2,1
22,417,417,46,46,0,1,0
4,432,432,29,29,0,1,0
21,476,476,51,51,0,1,0
6,492,492,86,20,66,4,3
24,493,493,10,1,9,3,2

10,111,111,1,1,0,1,0
12,116,116,15,5,10,2,1
16,130,130,8,4,4,2,1
6,141,141,1,1,0,1,0
2,158,158,1,1,0,1,0
22,167,167,1,1,0,1,0
24,183,183,8,8,0,1,0
14,185,185,3,3,0,1,0
20,189,189,21,21,0,1,0
15,206,206,25,25,0,1,0
17,206,206,9,9,0,1,0
21,214,214,21,12,9,2,1
8,214,214,31,31,0,1,0
23,222,222,11,2,9,2,1
7,234,234,31,31,0,1,0
9,281,281,14,10,4,2,1
11,287,287,46,14,32,3,2
5,303,303,24,24,0,1,0
18,309,309,12,8,4,2,1
25,322,322,84,39,45,4,3
0,337,337,15,15,0,1,0
1,373,373,89,89,0,1,0
19,404,404,103,70,33,4,3
4,452,452,15,15,0,1,0
13,480,480,105,9,96,4,3
3,489,489,133,45,88,4,3

7,112,112,4,4,0,1,0
22,148,148,53,53,0,1,0
17,150,150,7,3,4,2,1
8,152,152,31,31,0,1,0
5,168,168,3,3,0,1,0
4,187,187,22,22,0,1,0
3,189,189,2,2,0,1,0
25,191,191,3,3,0,1,0
10,200,200,36,16,20,2,1
0,218,218,9,9,0,1,0
2,218,218,11,1,10,3,2
13,245,245,14,11,3,2,1
20,286,286,48,48,0,1,0
16,289,289,58,44,14,3,2
26,310,310,22,16,6,3,2
18,332,332,26,1,25,3,2
14,334,334,6,6,0,1,0
1,350,350,43,4,39,4,3
6,373,373,10,10,0,1,0
9,376,376,43,43,0,1,0
24,393,393,25,9,16,2,1
15,397,397,21,11,10,2,1
12,407,407,68,68,0,1,0
21,429,429,46,8,38,3,2
11,472,472,74,74,0,1,0
23,472,472,6,6,0,1,0
19,499,499,64,64,0,1,0

0,125,125,11,5,6,3,2
3,126,126,6,2,4,2,1
2,139,139,32,12,20,2,1
18,142,142,3,3,0,1,0
8,147,147,9,5,4,2,1
23,186,186,32,32,0,1,0
6,248,248,39,39,0,1,0
22,261,261,4,4,0,1,0
24,265,265,72,72,0,1,0
11,273,273,18,18,0,1,0
15,276,276,9,2,7,2,1
5,278,278,1,1,0,1,0
17,306,306,4,4,0,1,0
4,325,325,90,90,0,1,0
13,352,352,44,17,27,4,3
1,369,369,16,16,0,1,0
20,385,385,3,3,0,1,0
7,410,410,54,54,0,1,0
16,418,418,5,2,3,2,1
14,444,444,56,15,41,2,1
9,458,458,51,51,0,1,0
19,467,467,64,64,0,1,0
12,484,484,34,22,12,4,3
21,489,489,153,75,78,4,3
10,496,496,42,1,41,3,2

5,114,114,51,2,49,2,1
14,156,156,41,9,32,2,1
0,170,170,18,18,0,1,0
6,172,172,19,9,10,3,2
12,174,174,10,6,4,2,1
25,190,190,9,9,0,1,0
20,196,196,30,8,22,3,2
4,211,211,1,1,0,1,0
9,224,224,27,3,24,2,1
24,264,264,19,14,5,2,1
21,278,278,7,7,0,1,0
26,280,280,10,2,8,3,2
10,317,317,28,28,0,1,0
17,332,332,1,1,0,1,0
13,347,347,5,5,0,1,0
18,371,371,15,15,0,1,0
11,400,400,14,2,12,3,2
1,400,400,33,25,8,3,2
2,402,402,30,10,20,3,2
15,403,403,28,1,27,4,3
16,415,415,131,131,0,1,0
22,415,415,14,14,0,1,0
19,429,429,76,13,63,4,3
3,455,455,44,16,28,2,1
23,459,459,39,33,6,2,1
8,474,474,1,1,0,1,0
7,489,489,30,30,0,1,0

24,119,119,4,4,0,1,0
2,121,121,8,2,6,3,2
1,157,157,9,9,0,1,0
21,170,170,5,5,0,1,0
3,185,185,7,7,0,1,0
4,232,232,73,65,8,3,2
25,254,254,37,37,0,1,0
13,264,264,7,3,4,2,1
20,304,304,35,35,0,1,0
18,310,310,15,1,14,2,1
15,311,311,10,7,3,2,1
8,316,316,44,44,0,1,0
11,318,318,68,10,58,3,2
28,331,331,65,65,0,1,0
7,341,341,12,12,0,1,0
17,359,359,125,125,0,1,0
0,364,364,13,13,0,1,0
22,365,365,29,26,3,2,1
5,377,377,52,32,20,2,1
12,404,404,2,2,0,1,0
6,412,412,3,3,0,1,0
14,419,419,9,9,0,1,0
16,426,426,27,5,22,2,1
19,433,433,3,3,0,1,0
10,450,450,30,17,13,2,1
27,460,460,8,8,0,1,0
9,463,463,48,36,12,2,1
26,463,463,35,23,12,4,3
23,496,496,82,82,0,1,0

21,106,106,1,1,0,1,0
1,108,108,12,12,0,1,0
22,111,111,12,3,9,2,1
6,146,146,3,3,0,1,0
25,150,150,58,58,0,1,0
7,157,157,8,8,0,1,0
29,176,176,19,19,0,1,0
18,188,188,12,5,7,2,1
27,196,196,43,19,24,3,2
12,197,197,6,2,4,2,1
14,204,204,1,1,0,1,0
19,211,211,5,5,0,1,0
17,219,219,2,2,0,1,0
3,227,227,3,3,0,1,0
15,231,231,9,1,8,2,1
11,237,237,20,15,5,2,1
5,265,265,29,21,8,2,1
9,284,284,13,13,0,1,0
2,322,322,37,1,36,4,3
28,345,345,29,16,13,2,1
31,346,346,3,3,0,1,0
24,368,368,27,27,0,1,0
23,376,376,25,10,15,4,3
16,396,396,68,58,10,3,2
20,404,404,2,2,0,1,0
8,423,423,79,43,36,3,2
0,438,438,33,18,15,2,1
10,462,462,22,22,0,1,0
4,469,469,54,54,0,1,0
30,473,473,41,31,10,2,1
26,484,484,74,74,0,1,0
13,496,496,4,4,0,1,0

17,101,101,1,1,0,1,0
1,105,105,24,24,0,1,0
5,107,107,5,5,0,1,0
10,127,127,4,4,0,1,0
13,128,128,1,1,0,1,0
11,131,131,4,4,0,1,0
28,161,161,34,20,14,2,1
26,180,180,19,13,6,2,1
19,205,205,7,7,0,1,0
23,208,208,9,9,0,1,0
22,230,230,52,52,0,1,0
18,234,234,14,8,6,3,2
20,241,241,6,6,0,1,0
4,266,266,31,31,0,1,0
21,269,269,82,32,50,2,1
9,272,272,60,60,0,1,0
16,277,277,37,37,0,1,0
3,282,282,6,6,0,1,0
7,288,288,16,16,0,1,0
12,296,296,25,22,3,2,1
15,343,343,21,21,0,1,0
25,348,348,19,5,14,2,1
8,360,360,1,1,0,1,0
0,388,388,35,30,5,2,1
29,400,400,55,55,0,1,0
2,417,417,20,7,13,4,3
24,435,435,32,32,0,1,0
27,440,440,23,5,18,4,3
6,442,442,8,8,0,1,0
14,473,473,50,50,0,1,0

0,119,119,2,2,0,1,0
11,126,126,3,3,0,1,0
21,139,139,9,4,5,2,1
26,146,146,5,5,0,1,0
5,156,156,2,2,0,1,0
27,185,185,17,3,14,3,2
14,204,204,8,8,0,1,0
20,209,209,27,27,0,1,0
2,226,226,29,5,24,4,3
17,244,244,46,46,0,1,0
13,263,263,23,23,0,1,0
22,272,272,11,4,7,2,1
9,274,274,11,11,0,1,0
6,274,274,43,43,0,1,0
10,286,286,83,51,32,3,2
18,293,293,109,109,0,1,0
29,298,298,18,18,0,1,0
19,331,331,59,21,38,3,2
28,336,336,5,2,3,2,1
24,339,339,7,3,4,2,1
16,349,349,21,7,14,3,2
15,371,371,5,5,0,1,0
8,379,379,12,9,3,2,1
3,383,383,84,9,75,4,3
7,392,392,5,5,0,1,0
12,396,396,19,3,16,2,1
4,408,408,28,28,0,1,0
1,456,456,23,23,0,1,0
25,457,457,22,22,0,1,0
23,488,488,37,4,33,4,3

20,127,127,3,3,0,1,0
1,133,133,27,12,15,4,3
13,155,155,6,6,0,1,0
11,179,179,29,1,28,3,2
22,184,184,46,46,0,1,0
3,195,195,30,30,0,1,0
19,208,208,26,26,0,1,0
6,227,227,55,28,27,4,3
8,256,256,1,1,0,1,0
9,260,260,4,4,0,1,0
2,261,261,1,1,0,1,0
21,290,290,18,6,12,3,2
17,291,291,52,31,21,3,2
14,306,306,22,22,0,1,0
0,320,320,12,6,6,3,2
5,373,373,5,5,0,1,0
12,399,399,92,62,30,4,3
18,402,402,14,1,13,2,1
24,406,406,23,23,0,1,0
7,411,411,115,115,0,1,0
10,413,413,32,32,0,1,0
16,438,438,89,89,0,1,0
23,443,443,12,12,0,1,0
15,450,450,9,9,0,1,0
4,481,481,54,54,0,1,0

8,127,127,1,1,0,1,0
7,149,149,2,2,0,1,0
3,151,151,9,5,4,2,1
16,167,167,10,7,3,2,1
21,177,177,6,6,0,1,0
13,184,184,2,2,0,1,0
5,212,212,9,9,0,1,0
0,217,217,33,9,24,3,2
10,218,218,71,71,0,1,0
15,231,231,7,7,0,1,0
22,240,240,41,41,0,1,0
12,244,244,28,7,21,4,3
1,249,249,20,20,0,1,0
18,273,273,12,12,0,1,0
9,274,274,73,1,72,3,2
20,304,304,11,11,0,1,0
4,345,345,58,58,0,1,0
17,363,363,178,49,129,4,3
19,367,367,17,17,0,1,0
6,390,390,34,34,0,1,0
2,433,433,43,43,0,1,0
23,437,437,33,33,0,1,0
14,440,440,58,46,12,3,2
11,500,500,42,42,0,1,0

9,110,110,3,3,0,1,0
10,133,133,5,2,3,2,1
8,150,150,2,2,0,1,0
14,159,159,1,1,0,1,0
19,172,172,11,2,9,4,3
17,178,178,17,12,5,2,1
15,198,198,11,5,6,2,1
11,206,206,29,29,0,1,0
24,231,231,7,4,3,2,1
0,236,236,24,24,0,1,0
5,260,260,46,46,0,1,0
23,278,278,73,37,36,4,3
20,279,279,22,22,0,1,0
16,284,284,41,31,10,3,2
4,287,287,71,29,42,3,2
3,301,301,43,39,4,2,1
7,303,303,1,1,0,1,0
18,303,303,62,8,54,4,3
13,304,304,13,10,3,2,1
6,361,361,21,8,13,2,1
2,367,367,84,59,25,2,1
12,399,399,71,71,0,1,0
21,438,438,70,70,0,1,0
22,446,446,3,3,0,1,0
1,495,495,62,62,0,1,0

4,102,102,5,1,4,2,1
1,105,105,4,4,0,1,0
6,150,150,1,1,0,1,0
8,158,158,20,20,0,1,0
14,160,160,1,1,0,1,0
26,178,178,16,16,0,1,0
13,179,179,8,8,0,1,0
25,185,185,11,11,0,1,0
19,202,202,12,12,0,1,0
18,244,244,45,45,0,1,0
22,258,258,7,7,0,1,0
23,270,270,43,43,0,1,0
20,284,284,24,24,0,1,0
11,305,305,53,35,18,3,2
3,322,322,42,21,21,4,3
5,375,375,138,67,71,4,3
16,376,376,73,73,0,1,0
28,384,384,87,39,48,3,2
0,401,401,8,8,0,1,0
12,432,432,48,28,20,2,1
27,440,440,46,22,24,3,2
2,449,449,8,5,3,2,1
15,454,454,47,33,14,2,1
9,463,463,40,40,0,1,0
17,471,471,8,8,0,1,0
7,474,474,8,8,0,1,0
24,483,483,6,6,0,1,0
10,492,492,1,1,0,1,0
21,492,492,51,51,0,1,0

2,115,115,23,11,12,4,3
19,127,127,29,29,0,1,0
10,129,129,5,5,0,1,0
21,139,139,2,2,0,1,0
17,147,147,9,2,7,3,2
8,151,151,30,6,24,2,1
12,190,190,12,9,3,2,1
7,243,243,30,30,0,1,0
11,258,258,4,4,0,1,0
14,281,281,25,1,24,4,3
15,298,298,6,2,4,2,1
1,301,301,4,4,0,1,0
5,327,327,19,13,6,3,2
0,365,365,11,11,0,1,0
22,373,373,58,46,12,4,3
18,400,400,26,26,0,1,0
9,407,407,26,4,22,3,2
13,435,435,85,4,81,4,3
4,445,445,162,52,110,4,3
16,459,459,28,17,11,2,1
6,484,484,73,8,65,3,2
3,494,494,49,13,36,3,2
20,500,500,161,144,17,2,1

25,107,107,24,24,0,1,0
18,122,122,36,36,0,1,0
17,146,146,9,9,0,1,0
0,153,153,27,9,18,3,2
9,158,158,5,2,3,2,1
13,168,168,12,3,9,4,3
8,176,176,24,24,0,1,0
20,178,178,4,4,0,1,0
11,179,179,5,2,3,2,1
12,180,180,4,4,0,1,0
23,198,198,14,14,0,1,0
27,202,202,59,59,0,1,0
10,227,227,1,1,0,1,0
7,243,243,19,2,17,2,1
22,244,244,20,20,0,1,0
24,275,275,7,1,6,3,2
5,282,282,41,41,0,1,0
6,310,310,40,19,21,3,2
14,360,360,37,2,35,2,1
26,374,374,24,24,0,1,0
21,399,399,11,11,0,1,0
2,408,408,28,28,0,1,0
16,410,410,10,5,5,2,1
3,427,427,13,3,10,3,2
15,431,431,53,13,40,2,1
1,441,441,106,28,78,3,2
19,443,443,8,8,0,1,0
4,484,484,17,5,12,3,2

25,104,104,4,4,0,1,0
28,105,105,16,16,0,1,0
3,119,119,1,1,0,1,0
6,162,162,3,3,0,1,0
20,168,168,27,27,0,1,0
26,169,169,8,8,0,1,0
29,201,201,21,21,0,1,0
32,203,203,9,9,0,1,0
11,225,225,1,1,0,1,0
2,229,229,26,4,22,3,2
10,230,230,12,3,9,3,2
5,234,234,39,39,0,1,0
12,242,242,1,1,0,1,0
0,254,254,9,6,3,2,1
24,264,264,49,9,40,4,3
7,268,268,2,2,0,1,0
19,322,322,3,3,0,1,0
27,331,331,25,2,23,3,2
33,338,338,6,6,0,1,0
9,348,348,27,12,15,2,1
30,372,372,137,110,27,4,3
17,377,377,11,1,10,3,2
21,401,401,51,3,48,4,3
23,416,416,18,18,0,1,0
18,437,437,59,45,14,2,1
1,451,451,1,1,0,1,0
14,452,452,1,1,0,1,0
4,455,455,33,12,21,2,1
16,465,465,63,36,27,4,3
31,465,465,23,23,0,1,0
13,472,472,4,4,0,1,0
8,472,472,21,21,0,1,0
15,477,477,102,4,98,3,2
22,479,479,36,36,0,1,0

18,112,112,3,3,0,1,0
14,113,113,13,13,0,1,0
0,151,151,9,9,0,1,0
17,166,166,5,5,0,1,0
9,196,196,1,1,0,1,0
20,200,200,3,3,0,1,0
3,218,218,40,40,0,1,0
5,225,225,47,35,12,2,1
1,245,245,5,5,0,1,0
19,289,289,42,12,30,2,1
22,309,309,25,1,24,4,3
16,314,314,31,31,0,1,0
24,350,350,119,79,40,3,2
6,358,358,48,48,0,1,0
21,382,382,71,29,42,4,3
10,384,384,7,7,0,1,0
11,397,397,14,14,0,1,0
4,414,414,36,23,13,4,3
2,415,415,21,6,15,2,1
23,421,421,28,28,0,1,0
15,426,426,40,40,0,1,0
8,436,436,8,8,0,1,0
12,438,438,183,66,117,4,3
13,459,459,45,45,0,1,0
7,484,484,30,30,0,1,0
25,497,497,12,12,0,1,0

1,112,112,1,1,0,1,0
20,118,118,20,11,9,4,3
22,128,128,5,5,0,1,0
21,137,137,14,4,10,2,1
4,152,152,27,27,0,1,0
3,165,165,10,10,0,1,0
11,182,182,19,19,0,1,0
18,188,188,8,8,0,1,0
14,190,190,10,6,4,2,1
16,204,204,38,2,36,4,3
23,232,232,30,1,29,2,1
13,238,238,49,49,0,1,0
15,295,295,3,3,0,1,0
10,337,337,53,53,0,1,0
19,338,338,11,11,0,1,0
9,383,383,95,70,25,2,1
0,409,409,7,2,5,2,1
12,432,432,56,41,15,2,1
2,446,446,56,56,0,1,0
8,453,453,5,1,4,2,1
24,453,453,37,37,0,1,0
17,466,466,65,31,34,3,2
5,485,485,90,90,0,1,0
7,492,492,3,3,0,1,0
6,498,498,101,64,37,2,1

17,118,118,21,21,0,1,0
14,130,130,26,6,20,3,2
23,141,141,7,2,5,2,1
7,144,144,21,5,16,4,3
21,146,146,1,1,0,1,0
2,188,188,40,40,0,1,0
19,196,196,18,12,6,2,1
5,204,204,37,16,21,4,3
0,210,210,43,43,0,1,0
20,221,221,10,1,9,2,1
22,231,231,1,1,0,1,0
3,248,248,45,45,0,1,0
6,268,268,6,6,0,1,0
9,298,298,10,10,0,1,0
11,325,325,58,58,0,1,0
10,349,349,12,12,0,1,0
8,357,357,10,10,0,1,0
18,361,361,44,44,0,1,0
15,369,369,9,9,0,1,0
12,371,371,25,25,0,1,0
1,425,425,63,63,0,1,0
4,445,445,48,48,0,1,0
16,449,449,146,117,29,2,1
13,478,478,17,17,0,1,0

25,125,125,1,1,0,1,0
13,136,136,15,15,0,1,0
1,163,163,10,10,0,1,0
10,172,172,10,3,7,2,1
19,181,181,8,8,0,1,0
26,188,188,44,20,24,4,3
28,210,210,15,15,0,1,0
14,216,216,19,19,0,1,0
30,225,225,8,1,7,2,1
17,228,228,10,7,3,2,1
22,234,234,3,3,0,1,0
24,238,238,31,8,23,4,3
8,256,256,3,3,0,1,0
16,260,260,8,8,0,1,0
18,275,275,73,21,52,3,2
0,283,283,28,10,18,3,2
27,295,295,38,10,28,3,2
12,304,304,50,25,25,2,1
5,316,316,57,15,42,4,3
6,325,325,11,3,8,3,2
4,337,337,57,57,0,1,0
11,352,352,1,1,0,1,0
29,395,395,25,3,22,3,2
21,421,421,31,13,18,4,3
7,450,450,64,64,0,1,0
20,456,456,110,110,0,1,0
23,457,457,6,6,0,1,0
3,459,459,21,2,19,2,1
15,468,468,16,7,9,4,3
2,496,496,1,1,0,1,0
9,498,498,13,7,6,3,2

6,130,130,7,1,6,3,2
13,136,136,3,3,0,1,0
11,172,172,13,13,0,1,0
9,181,181,29,29,0,1,0
3,193,193,9,3,6,3,2
8,231,231,21,2,19,2,1
5,257,257,142,7,135,4,3
1,258,258,27,13,14,2,1
7,296,296,2,2,0,1,0
2,317,317,33,14,19,2,1
10,366,366,17,17,0,1,0
17,370,370,78,44,34,2,1
14,371,371,38,38,0,1,0
12,428,428,7,7,0,1,0
0,457,457,29,7,22,2,1
15,464,464,121,10,111,4,3
16,469,469,103,25,78,4,3
4,478,478,206,80,126,4,3
18,497,497,29,29,0,1,0

6,109,109,1,1,0,1,0
8,112,112,19,1,18,2,1
7,157,157,4,4,0,1,0
21,159,159,1,1,0,1,0
2,167,167,23,14,9,4,3
27,172,172,3,3,0,1,0
10,178,178,12,12,0,1,0
20,192,192,69,69,0,1,0
0,200,200,8,8,0,1,0
1,204,204,8,8,0,1,0
15,214,214,3,3,0,1,0
30,241,241,36,21,15,4,3
22,298,298,19,1,18,4,3
13,302,302,10,10,0,1,0
18,338,338,4,4,0,1,0
16,340,340,4,4,0,1,0
17,346,346,44,21,23,2,1
28,357,357,113,83,30,2,1
11,360,360,12,9,3,2,1
26,372,372,19,19,0,1,0
5,373,373,93,16,77,4,3
25,376,376,49,44,5,2,1
14,382,382,20,20,0,1,0
9,382,382,38,38,0,1,0
4,412,412,33,4,29,2,1
19,420,420,9,6,3,2,1
3,431,431,26,17,9,2,1
29,454,454,23,23,0,1,0
23,482,482,41,31,10,3,2
24,498,498,29,5,24,4,3
12,499,499,26,26,0,1,0

21,107,107,23,13,10,2,1
17,120,120,23,17,6,3,2
9,142,142,7,7,0,1,0
0,214,214,75,51,24,4,3
23,222,222,6,6,0,1,0
4,280,280,25,25,0,1,0
2,297,297,5,1,4,2,1
7,309,309,85,31,54,4,3
18,318,318,1,1,0,1,0
3,320,320,17,17,0,1,0
20,339,339,20,9,11,2,1
10,359,359,3,3,0,1,0
1,361,361,1,1,0,1,0
15,372,372,5,5,0,1,0
22,395,395,54,23,31,2,1
19,397,397,121,63,58,3,2
16,402,402,3,3,0,1,0
24,410,410,28,28,0,1,0
5,421,421,35,19,16,2,1
8,428,428,86,86,0,1,0
6,442,442,66,66,0,1,0
12,443,443,26,26,0,1,0
13,446,446,73,18,55,4,3
11,467,467,10,3,7,2,1
14,494,494,40,32,8,3,2

4,104,104,2,2,0,1,0
18,112,112,16,16,0,1,0
17,119,119,5,5,0,1,0
23,125,125,10,10,0,1,0
6,140,140,35,35,0,1,0
8,150,150,29,22,7,2,1
22,166,166,22,5,17,4,3
1,168,168,3,3,0,1,0
19,186,186,4,4,0,1,0
2,237,237,17,2,15,4,3
13,240,240,2,2,0,1,0
0,278,278,14,14,0,1,0
9,297,297,46,32,14,2,1
12,313,313,41,41,0,1,0
14,320,320,30,21,9,2,1
10,320,320,18,15,3,2,1
7,326,326,12,12,0,1,0
15,386,386,78,10,68,3,2
16,398,398,58,58,0,1,0
5,403,403,27,27,0,1,0
21,441,441,48,16,32,3,2
3,471,471,181,40,141,4,3
20,480,480,11,3,8,2,1
11,499,499,96,96,0,1,0

4,117,117,36,36,0,1,0
17,163,163,1,1,0,1,0
5,164,164,25,19,6,2,1
3,176,176,8,8,0,1,0
9,191,191,3,3,0,1,0
18,192,192,10,10,0,1,0
12,196,196,2,2,0,1,0
13,216,216,46,46,0,1,0
8,233,233,3,3,0,1,0
16,237,237,14,8,6,3,2
6,261,261,90,66,24,2,1
11,285,285,79,79,0,1,0
14,297,297,37,21,16,2,1
2,298,298,47,7,40,2,1
20,311,311,82,70,12,2,1
19,311,311,86,50,36,3,2
15,366,366,3,3,0,1,0
7,367,367,40,25,15,2,1
1,401,401,12,12,0,1,0
0,456,456,70,16,54,3,2
10,466,466,7,7,0,1,0

22,129,129,63,39,24,4,3
15,130,130,3,3,0,1,0
8,137,137,6,6,0,1,0
1,150,150,20,2,18,4,3
18,170,170,4,1,3,2,1
13,189,189,2,2,0,1,0
5,195,195,20,11,9,4,3
14,196,196,14,2,12,4,3
10,214,214,1,1,0,1,0
12,215,215,20,5,15,4,3
17,216,216,26,26,0,1,0
11,224,224,35,4,31,2,1
7,232,232,23,20,3,2,1
4,243,243,46,38,8,2,1
0,245,245,16,16,0,1,0
26,257,257,12,1,11,2,1
16,266,266,10,3,7,2,1
9,289,289,1,1,0,1,0
20,314,314,46,26,20,3,2
24,319,319,70,70,0,1,0
25,341,341,39,39,0,1,0
3,355,355,43,43,0,1,0
19,371,371,10,5,5,2,1
2,422,422,47,47,0,1,0
27,427,427,8,5,3,2,1
23,459,459,24,15,9,4,3
21,470,470,8,8,0,1,0
6,496,496,49,49,0,1,0

13,107,107,7,3,4,2,1
20,118,118,5,1,4,2,1
12,122,122,1,1,0,1,0
16,126,126,11,6,5,2,1
3,148,148,6,6,0,1,0
27,167,167,5,5,0,1,0
10,167,167,2,2,0,1,0
26,186,186,1,1,0,1,0
7,278,278,59,19,40,4,3
8,299,299,23,9,14,3,2
1,311,311,34,19,15,4,3
4,326,326,85,16,69,4,3
17,327,327,39,16,23,2,1
5,329,329,25,25,0,1,0
11,331,331,50,28,22,3,2
9,344,344,28,8,20,3,2
21,379,379,3,3,0,1,0
22,379,379,98,98,0,1,0
18,385,385,9,1,8,2,1
2,393,393,11,11,0,1,0
15,410,410,169,127,42,3,2
14,417,417,44,28,16,2,1
19,420,420,38,26,12,4,3
6,431,431,3,3,0,1,0
23,438,438,12,4,8,2,1
0,441,441,30,30,0,1,0
25,463,463,69,9,60,3,2
24,497,497,37,21,16,3,2

13,104,104,13,13,0,1,0
17,128,128,3,3,0,1,0
4,130,130,24,24,0,1,0
19,154,154,4,4,0,1,0
1,159,159,27,7,20,3,2
7,163,163,18,18,0,1,0
8,187,187,1,1,0,1,0
6,196,196,13,1,12,4,3
9,203,203,5,5,0,1,0
11,205,205,28,5,23,4,3
21,222,222,3,3,0,1,0
3,279,279,123,123,0,1,0
2,298,298,32,32,0,1,0
12,306,306,62,52,10,2,1
14,360,360,57,48,9,2,1
20,382,382,62,59,3,2,1
22,394,394,24,10,14,2,1
16,402,402,100,64,36,2,1
5,403,403,63,16,47,2,1
18,420,420,14,3,11,2,1
10,445,445,14,2,12,3,2
0,454,454,16,13,3,2,1
15,499,499,52,20,32,3,2

17,120,120,3,3,0,1,0
4,184,184,7,7,0,1,0
3,193,193,76,67,9,4,3
8,197,197,1,1,0,1,0
0,204,204,2,2,0,1,0
19,206,206,23,23,0,1,0
1,213,213,2,2,0,1,0
14,227,227,27,27,0,1,0
13,270,270,27,27,0,1,0
7,279,279,74,74,0,1,0
16,297,297,11,2,9,2,1
10,307,307,45,30,15,4,3
20,323,323,65,65,0,1,0
5,334,334,13,13,0,1,0
22,338,338,24,5,19,2,1
2,344,344,77,41,36,3,2
12,394,394,1,1,0,1,0
9,409,409,33,15,18,3,2
25,431,431,54,54,0,1,0
24,446,446,66,40,26,4,3
21,450,450,109,33,76,4,3
11,450,450,32,10,22,2,1
6,463,463,8,8,0,1,0
23,464,464,45,45,0,1,0
15,474,474,11,6,5,2,1
18,484,484,8,3,5,2,1

18,121,121,2,2,0,1,0
8,121,121,3,3,0,1,0
0,126,126,11,1,10,3,2
11,130,130,1,1,0,1,0
20,145,145,3,3,0,1,0
19,153,153,11,3,8,3,2
14,159,159,8,2,6,3,2
7,178,178,15,15,0,1,0
12,193,193,2,2,0,1,0
24,241,241,6,6,0,1,0
5,243,243,13,2,11,2,1
6,257,257,14,14,0,1,0
27,259,259,94,94,0,1,0
1,271,271,4,4,0,1,0
22,274,274,7,7,0,1,0
10,276,276,36,36,0,1,0
2,295,295,13,13,0,1,0
33,299,299,12,12,0,1,0
3,305,305,12,12,0,1,0
4,317,317,81,81,0,1,0
13,331,331,24,5,19,2,1
16,338,338,22,22,0,1,0
28,384,384,74,74,0,1,0
25,404,404,67,56,11,2,1
31,405,405,73,54,19,2,1
21,418,418,4,4,0,1,0
17,430,430,23,23,0,1,0
23,430,430,8,8,0,1,0
15,439,439,35,9,26,2,1
9,454,454,29,5,24,4,3
30,461,461,83,41,42,2,1
32,481,481,7,1,6,2,1
26,489,489,33,33,0,1,0
29,498,498,17,17,0,1,0

18,115,115,8,8,0,1,0
7,150,150,1,1,0,1,0
20,172,172,6,6,0,1,0
6,179,179,36,2,34,3,2
17,179,179,1,1,0,1,0
16,197,197,3,3,0,1,0
22,203,203,26,14,12,2,1
21,217,217,7,7,0,1,0
0,243,243,4,4,0,1,0
5,253,253,20,20,0,1,0
10,266,266,6,6,0,1,0
19,282,282,11,11,0,1,0
15,286,286,43,22,21,4,3
9,317,317,11,5,6,2,1
11,318,318,76,52,24,4,3
23,326,326,57,57,0,1,0
14,340,340,55,15,40,3,2
1,351,351,30,30,0,1,0
2,359,359,12,12,0,1,0
12,428,428,120,12,108,4,3
8,444,444,179,110,69,4,3
4,460,460,160,160,0,1,0
3,466,466,33,33,0,1,0
13,483,483,1,1,0,1,0

14,145,145,8,5,3,2,1
22,155,155,8,3,5,2,1
2,162,162,9,9,0,1,0
23,165,165,14,4,10,2,1
4,167,167,4,4,0,1,0
1,175,175,17,17,0,1,0
18,196,196,12,12,0,1,0
3,200,200,68,68,0,1,0
15,205,205,24,24,0,1,0
25,206,206,20,20,0,1,0
7,210,210,11,2,9,2,1
6,243,243,3,3,0,1,0
17,247,247,69,69,0,1,0
12,284,284,31,3,28,3,2
13,309,309,5,5,0,1,0
10,310,310,27,27,0,1,0
19,327,327,26,2,24,4,3
9,337,337,51,51,0,1,0
5,355,355,37,37,0,1,0
0,355,355,15,7,8,2,1
21,360,360,68,32,36,4,3
26,363,363,27,27,0,1,0
8,368,368,21,21,0,1,0
11,407,407,62,62,0,1,0
20,410,410,12,12,0,1,0
16,435,435,21,21,0,1,0
24,442,442,72,65,7,2,1

19,125,125,16,16,0,1,0
13,126,126,10,10,0,1,0
18,139,139,11,6,5,2,1
23,143,143,34,1,33,3,2
20,153,153,1,1,0,1,0
16,171,171,61,61,0,1,0
12,176,176,15,15,0,1,0
14,182,182,3,3,0,1,0
11,185,185,1,1,0,1,0
1,202,202,21,21,0,1,0
7,203,203,13,13,0,1,0
0,225,225,12,12,0,1,0
8,297,297,86,86,0,1,0
24,297,297,4,4,0,1,0
22,306,306,36,30,6,2,1
2,335,335,42,42,0,1,0
4,340,340,33,33,0,1,0
5,353,353,16,10,6,2,1
25,355,355,15,15,0,1,0
9,374,374,1,1,0,1,0
15,390,390,8,8,0,1,0
3,395,395,43,43,0,1,0
21,481,481,29,29,0,1,0
10,482,482,126,36,90,4,3
17,494,494,87,81,6,2,1
6,494,494,30,30,0,1,0

10,111,111,6,6,0,1,0
22,142,142,4,1,3,2,1
2,172,172,70,52,18,2,1
24,172,172,1,1,0,1,0
19,197,197,3,3,0,1,0
25,220,220,35,14,21,4,3
15,220,220,66,36,30,3,2
20,221,221,29,29,0,1,0
9,227,227,16,3,13,3,2
14,249,249,85,13,72,3,2
3,276,276,8,8,0,1,0
0,286,286,24,24,0,1,0
16,299,299,13,1,12,3,2
17,302,302,16,5,11,2,1
5,314,314,34,9,25,2,1
7,317,317,11,1,10,2,1
21,335,335,8,8,0,1,0
23,347,347,32,6,26,3,2
18,356,356,20,4,16,2,1
8,431,431,22,8,14,3,2
12,437,437,64,42,22,2,1
1,441,441,38,12,26,4,3
6,464,464,18,12,6,2,1
11,469,469,44,20,24,4,3
13,473,473,35,35,0,1,0
4,487,487,47,37,10,2,1

17,112,112,31,2,29,2,1
7,138,138,11,5,6,2,1
27,153,153,11,11,0,1,0
14,170,170,6,6,0,1,0
20,187,187,32,32,0,1,0
9,190,190,5,5,0,1,0
10,205,205,26,2,24,3,2
8,209,209,32,9,23,3,2
24,241,241,1,1,0,1,0
23,291,291,69,25,44,2,1
12,325,325,1,1,0,1,0
19,338,338,29,29,0,1,0
21,348,348,1,1,0,1,0
3,391,391,48,20,28,3,2
16,391,391,54,54,0,1,0
13,396,396,29,3,26,2,1
15,397,397,49,40,9,4,3
1,405,405,18,18,0,1,0
11,428,428,6,6,0,1,0
22,429,429,43,43,0,1,0
0,431,431,52,16,36,3,2
6,450,450,62,14,48,3,2
2,455,455,38,38,0,1,0
28,460,460,46,46,0,1,0
25,466,466,26,2,24,3,2
4,474,474,61,17,44,2,1
18,475,475,36,6,30,3,2
26,493,493,3,3,0,1,0
5,495,495,14,8,6,3,2

14,118,118,4,1,3,2,1
21,122,122,16,16,0,1,0
6,143,143,9,9,0,1,0
17,155,155,12,12,0,1,0
0,160,160,12,3,9,2,1
7,193,193,7,4,3,2,1
10,199,199,8,2,6,3,2
1,202,202,14,14,0,1,0
22,208,208,4,4,0,1,0
9,259,259,43,22,21,4,3
20,275,275,49,49,0,1,0
15,284,284,13,4,9,2,1
5,321,321,60,48,12,3,2
11,321,321,78,27,51,4,3
4,322,322,57,57,0,1,0
2,333,333,5,2,3,2,1
16,354,354,66,48,18,3,2
24,387,387,6,6,0,1,0
19,411,411,7,7,0,1,0
18,418,418,58,11,47,2,1
23,433,433,41,34,7,2,1
8,471,471,43,10,33,2,1
25,480,480,144,74,70,4,3
3,481,481,46,3,43,3,2
13,491,491,43,3,40,3,2
12,494,494,21,12,9,4,3

15,102,102,30,9,21,2,1
17,106,106,3,3,0,1,0
6,138,138,68,68,0,1,0
5,180,180,5,5,0,1,0
13,231,231,1,1,0,1,0
7,235,235,21,12,9,2,1
18,243,243,12,12,0,1,0
16,243,243,3,3,0,1,0
0,255,255,9,3,6,3,2
21,272,272,30,9,21,4,3
10,273,273,52,52,0,1,0
24,285,285,39,39,0,1,0
20,286,286,26,20,6,3,2
22,322,322,14,14,0,1,0
8,326,326,4,4,0,1,0
12,333,333,15,15,0,1,0
9,338,338,60,60,0,1,0
14,366,366,119,98,21,4,3
19,428,428,62,28,34,3,2
4,441,441,17,11,6,2,1
2,445,445,6,6,0,1,0
23,460,460,18,18,0,1,0
3,465,465,94,94,0,1,0
1,487,487,5,5,0,1,0
11,491,491,5,5,0,1,0

5,137,137,16,3,13,2,1
21,143,143,14,14,0,1,0
10,165,165,5,1,4,2,1
15,169,169,38,18,20,2,1
17,256,256,32,32,0,1,0
23,258,258,42,42,0,1,0
1,271,271,3,3,0,1,0
27,287,287,54,54,0,1,0
8,296,296,156,102,54,3,2
6,298,298,12,8,4,2,1
3,321,321,39,17,22,2,1
13,335,335,6,6,0,1,0
7,372,372,7,7,0,1,0
18,378,378,19,8,11,2,1
12,381,381,58,58,0,1,0
0,398,398,17,17,0,1,0
24,401,401,53,7,46,2,1
16,420,420,1,1,0,1,0
4,437,437,10,10,0,1,0
26,455,455,5,5,0,1,0
14,462,462,26,3,23,4,3
2,463,463,18,18,0,1,0
22,463,463,24,24,0,1,0
25,463,463,24,13,11,2,1
9,465,465,47,47,0,1,0
20,472,472,63,24,39,3,2
19,480,480,42,42,0,1,0
11,498,498,2,2,0,1,0

18,124,124,3,3,0,1,0
3,141,141,4,1,3,2,1
16,164,164,13,7,6,2,1
17,186,186,81,13,68,3,2
14,191,191,3,3,0,1,0
6,222,222,42,42,0,1,0
22,224,224,43,43,0,1,0
5,249,249,43,43,0,1,0
1,253,253,48,12,36,2,1
19,258,258,55,23,32,3,2
12,270,270,2,2,0,1,0
11,282,282,16,1,15,4,3
13,306,306,30,22,8,3,2
15,313,313,5,2,3,2,1
20,327,327,16,8,8,2,1
10,378,378,14,5,9,4,3
0,379,379,46,46,0,1,0
8,399,399,83,33,50,3,2
21,401,401,43,3,40,2,1
7,404,404,29,29,0,1,0
2,412,412,14,14,0,1,0
9,412,412,27,27,0,1,0
4,470,470,104,87,17,4,3

11,112,112,11,3,8,3,2
22,114,114,11,11,0,1,0
27,135,135,15,6,9,4,3
25,155,155,20,20,0,1,0
29,161,161,5,5,0,1,0
14,167,167,23,14,9,2,1
2,205,205,43,9,34,2,1
20,210,210,36,36,0,1,0
19,220,220,6,6,0,1,0
0,244,244,24,24,0,1,0
24,254,254,46,46,0,1,0
21,287,287,8,2,6,3,2
18,293,293,27,27,0,1,0
17,325,325,1,1,0,1,0
28,341,341,95,95,0,1,0
10,343,343,17,1,16,2,1
3,346,346,17,17,0,1,0
23,348,348,23,16,7,2,1
12,400,400,4,4,0,1,0
16,416,416,15,3,12,2,1
5,416,416,32,32,0,1,0
1,421,421,4,4,0,1,0
9,430,430,49,49,0,1,0
7,434,434,1,1,0,1,0
15,437,437,15,10,5,2,1
26,447,447,51,20,31,2,1
13,455,455,59,47,12,3,2
4,460,460,28,19,9,2,1
6,466,466,50,6,44,2,1
8,496,496,39,1,38,2,1

19,100,100,10,10,0,1,0
17,119,119,6,6,0,1,0
16,151,151,10,10,0,1,0
13,160,160,24,21,3,2,1
1,169,169,68,19,49,4,3
5,219,219,59,14,45,3,2
12,224,224,48,16,32,3,2
18,245,245,7,1,6,3,2
15,270,270,8,8,0,1,0
0,303,303,10,10,0,1,0
11,318,318,13,7,6,2,1
20,325,325,59,59,0,1,0
22,328,328,41,41,0,1,0
21,355,355,95,49,46,2,1
4,365,365,12,12,0,1,0
2,367,367,66,66,0,1,0
3,385,385,4,4,0,1,0
10,399,399,18,6,12,4,3
8,413,413,4,4,0,1,0
6,441,441,49,23,26,3,2
7,465,465,53,35,18,3,2
9,476,476,66,60,6,2,1
14,479,479,20,20,0,1,0

9,105,105,11,5,6,2,1
19,117,117,7,7,0,1,0
12,131,131,4,4,0,1,0
11,139,139,21,21,0,1,0
5,140,140,19,4,15,2,1
4,150,150,19,5,14,3,2
6,163,163,19,19,0,1,0
2,184,184,6,6,0,1,0
20,195,195,30,10,20,3,2
14,221,221,32,32,0,1,0
17,278,278,39,11,28,3,2
3,283,283,5,1,4,2,1
7,300,300,37,22,15,2,1
0,304,304,11,11,0,1,0
16,309,309,14,2,12,4,3
15,313,313,52,33,19,2,1
1,315,315,117,117,0,1,0
18,321,321,3,3,0,1,0
8,331,331,55,9,46,3,2
22,376,376,80,80,0,1,0
21,456,456,15,15,0,1,0
23,468,468,72,37,35,4,3
10,479,479,34,34,0,1,0
13,490,490,13,4,9,2,1

7,105,105,3,3,0,1,0
29,120,120,4,4,0,1,0
27,121,121,10,10,0,1,0
26,141,141,2,2,0,1,0
15,159,159,24,24,0,1,0
20,188,188,20,5,15,4,3
18,211,211,11,2,9,4,3
13,242,242,57,31,26,2,1
1,245,245,6,6,0,1,0
5,249,249,31,31,0,1,0
2,264,264,4,4,0,1,0
0,281,281,15,15,0,1,0
16,293,293,32,32,0,1,0
17,304,304,53,15,38,2,1
30,318,318,24,6,18,3,2
24,321,321,28,4,24,4,3
25,327,327,26,17,9,4,3
12,337,337,10,2,8,2,1
22,337,337,94,86,8,2,1
19,345,345,2,2,0,1,0
31,358,358,33,7,26,3,2
8,375,375,47,6,41,2,1
23,392,392,28,16,12,3,2
3,393,393,1,1,0,1,0
28,404,404,138,74,64,4,3
10,406,406,6,6,0,1,0
4,417,417,26,26,0,1,0
21,425,425,26,26,0,1,0
11,439,439,2,2,0,1,0
14,465,465,16,16,0,1,0
9,465,465,1,1,0,1,0
6,500,500,29,21,8,2,1

19,136,136,11,1,10,3,2
18,146,146,30,4,26,3,2
17,149,149,40,40,0,1,0
6,157,157,2,2,0,1,0
23,158,158,14,14,0,1,0
5,160,160,13,3,10,2,1
24,167,167,33,9,24,2,1
8,192,192,17,17,0,1,0
20,207,207,37,3,34,3,2
1,221,221,1,1,0,1,0
0,250,250,10,1,9,2,1
16,264,264,4,1,3,2,1
2,290,290,14,2,12,3,2
7,321,321,5,5,0,1,0
9,333,333,61,61,0,1,0
4,366,366,140,62,78,4,3
13,380,380,12,3,9,4,3
12,414,414,77,77,0,1,0
11,418,418,46,35,11,2,1
25,422,422,23,23,0,1,0
22,457,457,45,33,12,3,2
10,466,466,61,31,30,3,2
15,471,471,24,3,21,4,3
3,483,483,9,4,5,2,1
21,495,495,19,19,0,1,0
14,496,496,13,2,11,2,1

1,110,110,26,26,0,1,0
7,126,126,3,3,0,1,0
3,173,173,55,55,0,1,0
25,176,176,10,10,0,1,0
5,192,192,37,30,7,2,1
14,201,201,4,4,0,1,0
4,242,242,11,5,6,2,1
17,250,250,65,20,45,4,3
8,256,256,52,24,28,2,1
21,269,269,15,15,0,1,0
15,290,290,24,21,3,2,1
2,311,311,8,8,0,1,0
13,331,331,21,21,0,1,0
16,332,332,27,27,0,1,0
22,337,337,65,18,47,3,2
18,345,345,16,16,0,1,0
0,355,355,2,2,0,1,0
23,363,363,119,119,0,1,0
11,364,364,3,3,0,1,0
20,369,369,13,5,8,2,1
24,386,386,29,29,0,1,0
6,388,388,13,13,0,1,0
12,399,399,13,13,0,1,0
9,433,433,12,12,0,1,0
10,467,467,69,69,0,1,0
19,472,472,12,12,0,1,0

21,102,102,13,13,0,1,0
15,127,127,16,6,10,3,2
17,134,134,1,1,0,1,0
7,141,141,20,20,0,1,0
18,146,146,2,2,0,1,0
19,157,157,13,8,5,2,1
16,167,167,14,6,8,3,2
12,195,195,29,29,0,1,0
20,250,250,56,2,54,4,3
11,251,251,30,14,16,3,2
2,282,282,62,62,0,1,0
3,317,317,2,2,0,1,0
14,318,318,20,5,15,2,1
13,335,335,31,3,28,4,3
0,336,336,27,15,12,4,3
1,354,354,35,17,18,3,2
6,391,391,140,58,82,3,2
9,392,392,22,22,0,1,0
4,394,394,27,27,0,1,0
10,411,411,79,79,0,1,0
5,454,454,41,20,21,2,1
8,484,484,115,115,0,1,0

22,110,110,19,12,7,2,1
18,129,129,11,11,0,1,0
0,147,147,1,1,0,1,0
7,176,176,6,6,0,1,0
1,186,186,8,8,0,1,0
28,186,186,8,8,0,1,0
14,209,209,10,1,9,2,1
20,227,227,10,10,0,1,0
24,245,245,30,30,0,1,0
19,245,245,15,15,0,1,0
16,261,261,50,50,0,1,0
30,287,287,42,42,0,1,0
5,316,316,9,3,6,2,1
27,319,319,41,6,35,2,1
29,355,355,2,2,0,1,0
2,371,371,68,6,62,3,2
31,375,375,45,24,21,4,3
15,381,381,3,3,0,1,0
17,393,393,12,2,10,2,1
6,396,396,5,5,0,1,0
3,404,404,30,30,0,1,0
13,405,405,6,6,0,1,0
10,431,431,10,3,7,2,1
25,433,433,67,17,50,2,1
12,436,436,34,8,26,3,2
23,450,450,92,92,0,1,0
26,455,455,33,33,0,1,0
9,457,457,32,14,18,4,3
4,472,472,122,42,80,4,3
11,483,483,28,28,0,1,0
8,488,488,26,26,0,1,0
21,496,496,22,4,18,2,1

23,109,109,46,46,0,1,0
7,139,139,9,9,0,1,0
24,175,175,9,9,0,1,0
10,207,207,10,10,0,1,0
14,237,237,21,11,10,3,2
18,252,252,87,87,0,1,0
11,260,260,41,41,0,1,0
12,261,261,5,5,0,1,0
6,300,300,31,7,24,3,2
5,302,302,27,27,0,1,0
17,317,317,3,3,0,1,0
9,327,327,37,37,0,1,0
20,332,332,20,20,0,1,0
22,335,335,4,4,0,1,0
0,339,339,21,21,0,1,0
2,397,397,5,5,0,1,0
13,403,403,23,16,7,3,2
4,424,424,4,1,3,2,1
3,439,439,202,202,0,1,0
8,478,478,10,10,0,1,0
19,480,480,4,4,0,1,0
15,481,481,37,9,28,3,2
21,481,481,74,68,6,3,2
1,496,496,80,43,37,2,1
16,499,499,9,1,8,3,2

12,107,107,2,2,0,1,0
27,112,112,16,16,0,1,0
23,120,120,8,3,5,2,1
4,159,159,10,10,0,1,0
17,168,168,19,19,0,1,0
20,205,205,2,2,0,1,0
1,208,208,25,25,0,1,0
24,219,219,51,23,28,3,2
18,219,219,22,22,0,1,0
8,258,258,4,4,0,1,0
3,262,262,16,16,0,1,0
16,268,268,57,24,33,2,1
9,281,281,95,1,94,3,2
5,298,298,14,6,8,2,1
6,329,329,1,1,0,1,0
26,349,349,4,4,0,1,0
7,371,371,3,3,0,1,0
0,382,382,45,45,0,1,0
21,384,384,39,39,0,1,0
15,391,391,31,25,6,2,1
19,398,398,49,35,14,3,2
22,401,401,27,15,12,4,3
14,444,444,5,5,0,1,0
25,444,444,31,31,0,1,0
10,451,451,65,28,37,2,1
13,459,459,1,1,0,1,0
2,480,480,46,46,0,1,0
28,483,483,37,16,21,4,3
11,498,498,88,88,0,1,0

3,110,110,2,2,0,1,0
33,111,111,18,12,6,3,2
18,112,112,6,1,5,2,1
11,124,124,2,2,0,1,0
32,126,126,6,6,0,1,0
6,130,130,23,23,0,1,0
5,131,131,3,3,0,1,0
15,136,136,19,14,5,2,1
22,141,141,2,2,0,1,0
24,187,187,15,2,13,4,3
31,200,200,24,24,0,1,0
4,204,204,11,5,6,2,1
21,204,204,30,6,24,3,2
29,217,217,7,1,6,3,2
23,233,233,4,4,0,1,0
17,236,236,24,24,0,1,0
12,246,246,2,2,0,1,0
30,262,262,14,3,11,2,1
10,270,270,1,1,0,1,0
7,276,276,29,29,0,1,0
16,277,277,12,12,0,1,0
19,305,305,1,1,0,1,0
25,309,309,1,1,0,1,0
27,311,311,86,52,34,2,1
26,312,312,107,90,17,2,1
2,331,331,43,26,17,2,1
0,356,356,49,11,38,3,2
14,413,413,4,4,0,1,0
9,421,421,20,20,0,1,0
8,437,437,13,13,0,1,0
28,441,441,20,20,0,1,0
13,455,455,13,13,0,1,0
20,480,480,61,5,56,3,2
1,492,492,22,2,20,2,1

14,100,100,2,2,0,1,0
4,114,114,2,2,0,1,0
16,135,135,4,1,3,2,1
6,137,137,1,1,0,1,0
9,153,153,1,1,0,1,0
15,165,165,3,3,0,1,0
2,194,194,10,3,7,2,1
5,195,195,40,40,0,1,0
0,200,200,10,1,9,4,3
13,304,304,25,25,0,1,0
12,367,367,13,13,0,1,0
7,369,369,40,40,0,1,0
10,383,383,3,3,0,1,0
21,394,394,95,24,71,3,2
17,408,408,109,19,90,3,2
18,409,409,12,12,0,1,0
19,432,432,39,1,38,3,2
8,445,445,109,25,84,3,2
11,454,454,12,12,0,1,0
20,457,457,214,187,27,4,3
3,464,464,264,131,133,4,3
1,491,491,23,4,19,2,1

28,114,114,5,2,3,2,1
3,128,128,1,1,0,1,0
17,174,174,17,17,0,1,0
10,184,184,8,8,0,1,0
2,193,193,20,8,12,4,3
14,197,197,33,33,0,1,0
1,223,223,25,10,15,2,1
9,235,235,2,2,0,1,0
19,240,240,53,25,28,2,1
0,250,250,27,13,14,3,2
13,252,252,12,12,0,1,0
18,258,258,41,41,0,1,0
25,259,259,11,2,9,2,1
15,263,263,65,43,22,2,1
12,274,274,6,6,0,1,0
22,275,275,13,5,8,2,1
27,297,297,31,10,21,2,1
5,299,299,49,49,0,1,0
29,320,320,83,83,0,1,0
20,325,325,1,1,0,1,0
21,367,367,65,65,0,1,0
8,402,402,25,10,15,4,3
4,423,423,11,3,8,2,1
16,434,434,23,23,0,1,0
6,436,436,15,3,12,4,3
24,442,442,5,5,0,1,0
11,451,451,23,23,0,1,0
23,466,466,19,19,0,1,0
7,468,468,20,2,18,2,1
26,500,500,58,37,21,4,3

27,123,123,7,3,4,2,1
3,155,155,1,1,0,1,0
7,169,169,19,12,7,2,1
11,178,178,1,1,0,1,0
10,189,189,10,10,0,1,0
18,202,202,20,20,0,1,0
5,215,215,1,1,0,1,0
26,221,221,5,5,0,1,0
20,222,222,29,29,0,1,0
17,238,238,7,3,4,2,1
1,242,242,5,5,0,1,0
2,264,264,1,1,0,1,0
29,297,297,10,2,8,2,1
19,302,302,31,7,24,4,3
13,314,314,74,35,39,2,1
8,315,315,30,30,0,1,0
21,326,326,91,91,0,1,0
14,343,343,8,3,5,2,1
15,351,351,1,1,0,1,0
24,367,367,27,7,20,3,2
28,367,367,28,22,6,2,1
16,372,372,89,19,70,3,2
22,388,388,115,72,43,4,3
25,396,396,8,3,5,2,1
30,423,423,31,31,0,1,0
9,429,429,25,25,0,1,0
23,437,437,28,4,24,4,3
4,438,438,4,4,0,1,0
0,443,443,79,79,0,1,0
12,443,443,1,1,0,1,0
6,486,486,108,108,0,1,0

6,128,128,28,28,0,1,0
13,139,139,30,30,0,1,0
14,141,141,3,3,0,1,0
25,143,143,12,7,5,2,1
20,158,158,9,1,8,3,2
7,173,173,2,2,0,1,0
21,173,173,17,17,0,1,0
12,175,175,3,3,0,1,0
4,177,177,1,1,0,1,0
11,201,201,53,1,52,3,2
15,206,206,19,11,8,3,2
19,225,225,2,2,0,1,0
5,238,238,1,1,0,1,0
3,315,315,19,6,13,2,1
16,321,321,37,37,0,1,0
24,342,342,154,154,0,1,0
27,355,355,44,44,0,1,0
17,363,363,9,6,3,2,1
22,370,370,13,7,6,3,2
26,400,400,8,5,3,2,1
2,414,414,42,14,28,4,3
8,416,416,56,56,0,1,0
9,420,420,45,45,0,1,0
1,450,450,16,16,0,1,0
0,460,460,39,18,21,4,3
18,461,461,94,61,33,2,1
23,481,481,8,8,0,1,0
10,500,500,11,11,0,1,0

24,105,105,1,1,0,1,0
12,111,111,10,10,0,1,0
2,116,116,5,5,0,1,0
16,129,129,30,30,0,1,0
19,150,150,16,1,15,2,1
27,170,170,22,22,0,1,0
10,172,172,2,2,0,1,0
26,175,175,18,18,0,1,0
21,178,178,24,24,0,1,0
22,188,188,13,1,12,2,1
28,227,227,2,2,0,1,0
14,241,241,44,44,0,1,0
6,246,246,1,1,0,1,0
15,247,247,6,1,5,2,1
9,264,264,1,1,0,1,0
3,271,271,20,1,19,4,3
4,275,275,13,3,10,3,2
18,300,300,13,13,0,1,0
0,363,363,1,1,0,1,0
11,390,390,52,23,29,4,3
20,396,396,98,4,94,4,3
1,409,409,55,55,0,1,0
13,422,422,85,81,4,2,1
23,427,427,12,12,0,1,0
17,439,439,52,18,34,3,2
25,463,463,45,45,0,1,0
5,470,470,49,14,35,4,3
7,488,488,85,85,0,1,0
8,495,495,36,17,19,2,1

3,107,107,9,9,0,1,0
10,118,118,5,5,0,1,0
11,122,122,4,4,0,1,0
5,148,148,8,2,6,2,1
8,150,150,25,4,21,4,3
14,167,167,12,12,0,1,0
18,170,170,1,1,0,1,0
16,180,180,1,1,0,1,0
2,185,185,20,2,18,3,2
20,197,197,57,57,0,1,0
13,211,211,60,3,57,4,3
22,226,226,1,1,0,1,0
9,233,233,29,19,10,2,1
1,236,236,11,11,0,1,0
12,237,237,4,4,0,1,0
21,253,253,2,2,0,1,0
27,271,271,7,7,0,1,0
0,288,288,1,1,0,1,0
7,320,320,19,19,0,1,0
15,329,329,46,6,40,3,2
19,349,349,5,1,4,2,1
24,361,361,61,36,25,2,1
26,363,363,46,30,16,2,1
23,374,374,17,17,0,1,0
17,410,410,101,40,61,4,3
25,492,492,119,119,0,1,0
6,496,496,24,24,0,1,0
4,500,500,79,69,10,3,2

8,107,107,4,4,0,1,0
1,133,133,8,8,0,1,0
26,134,134,2,2,0,1,0
23,146,146,12,12,0,1,0
7,148,148,3,3,0,1,0
27,162,162,16,10,6,3,2
20,168,168,48,48,0,1,0
16,183,183,40,40,0,1,0
6,195,195,1,1,0,1,0
17,201,201,5,5,0,1,0
13,203,203,3,3,0,1,0
5,212,212,23,13,10,2,1
24,231,231,4,4,0,1,0
4,248,248,29,29,0,1,0
11,272,272,43,7,36,4,3
0,293,293,27,18,9,4,3
14,298,298,18,18,0,1,0
10,305,305,83,83,0,1,0
18,307,307,41,41,0,1,0
28,311,311,10,6,4,2,1
2,335,335,42,11,31,4,3
21,341,341,23,23,0,1,0
25,402,402,95,55,40,3,2
19,405,405,10,4,6,3,2
12,407,407,50,50,0,1,0
22,449,449,43,43,0,1,0
15,465,465,40,40,0,1,0
3,466,466,9,6,3,2,1
9,485,485,1,1,0,1,0

11,112,112,20,2,18,3,2
8,123,123,5,5,0,1,0
26,123,123,4,4,0,1,0
6,127,127,3,3,0,1,0
2,128,128,6,1,5,2,1
1,137,137,14,14,0,1,0
19,171,171,30,8,22,4,3
16,177,177,10,10,0,1,0
17,179,179,45,31,14,3,2
10,193,193,24,24,0,1,0
4,210,210,13,5,8,2,1
25,210,210,50,28,22,3,2
28,211,211,7,1,6,2,1
13,222,222,9,9,0,1,0
29,230,230,5,5,0,1,0
12,273,273,23,7,16,2,1
20,279,279,5,5,0,1,0
24,284,284,44,2,42,4,3
22,293,293,46,46,0,1,0
15,303,303,4,4,0,1,0
0,352,352,11,11,0,1,0
5,362,362,8,1,7,2,1
9,372,372,29,29,0,1,0
14,417,417,12,12,0,1,0
27,417,417,28,28,0,1,0
21,437,437,15,6,9,4,3
7,446,446,3,3,0,1,0
3,452,452,164,164,0,1,0
18,463,463,45,45,0,1,0
23,492,492,21,1,20,2,1

22,104,104,20,9,11,2,1
4,105,105,16,8,8,3,2
0,138,138,1,1,0,1,0
28,168,168,46,28,18,4,3
25,173,173,5,5,0,1,0
10,183,183,11,11,0,1,0
13,208,208,21,21,0,1,0
19,208,208,29,29,0,1,0
3,216,216,3,3,0,1,0
1,218,218,6,6,0,1,0
2,264,264,4,4,0,1,0
14,268,268,27,6,21,2,1
17,285,285,12,12,0,1,0
26,340,340,3,3,0,1,0
21,361,361,6,6,0,1,0
6,364,364,21,5,16,2,1
16,378,378,22,22,0,1,0
8,379,379,65,59,6,3,2
18,380,380,124,124,0,1,0
24,391,391,50,41,9,2,1
5,394,394,70,25,45,2,1
7,394,394,16,12,4,2,1
23,396,396,1,1,0,1,0
12,422,422,19,19,0,1,0
9,428,428,31,31,0,1,0
11,445,445,63,63,0,1,0
27,470,470,46,46,0,1,0
20,481,481,5,2,3,2,1
15,497,497,58,58,0,1,0

21,105,105,8,8,0,1,0
24,157,157,11,11,0,1,0
23,169,169,12,8,4,2,1
2,173,173,22,10,12,2,1
17,192,192,19,10,9,2,1
11,213,213,45,1,44,2,1
8,217,217,4,4,0,1,0
10,219,219,11,5,6,3,2
19,254,254,5,1,4,2,1
14,268,268,7,7,0,1,0
1,269,269,11,11,0,1,0
15,271,271,41,41,0,1,0
5,272,272,9,9,0,1,0
12,282,282,23,23,0,1,0
4,324,324,150,88,62,3,2
20,373,373,15,5,10,2,1
6,378,378,56,34,22,2,1
16,389,389,83,32,51,4,3
13,391,391,139,71,68,4,3
7,393,393,44,9,35,4,3
22,394,394,27,5,22,3,2
18,403,403,18,14,4,2,1
3,422,422,8,8,0,1,0
0,460,460,19,4,15,3,2
9,494,494,19,19,0,1,0

4,132,132,9,3,6,3,2
22,141,141,54,32,22,3,2
1,149,149,11,11,0,1,0
11,172,172,24,24,0,1,0
12,176,176,12,4,8,2,1
10,183,183,19,19,0,1,0
21,191,191,11,11,0,1,0
3,198,198,13,13,0,1,0
16,244,244,2,2,0,1,0
14,254,254,18,4,14,2,1
24,263,263,15,15,0,1,0
8,269,269,14,4,10,2,1
9,293,293,33,33,0,1,0
13,322,322,41,13,28,4,3
5,329,329,25,25,0,1,0
18,338,338,4,4,0,1,0
7,349,349,19,15,4,2,1
26,366,366,5,2,3,2,1
0,379,379,2,2,0,1,0
23,382,382,38,38,0,1,0
17,383,383,32,8,24,2,1
27,400,400,28,5,23,2,1
15,402,402,107,107,0,1,0
25,403,403,29,9,20,3,2
6,412,412,54,7,47,2,1
2,423,423,65,21,44,3,2
20,438,438,8,8,0,1,0
19,490,490,85,85,0,1,0

18,134,134,3,3,0,1,0
6,162,162,25,25,0,1,0
4,168,168,48,13,35,2,1
0,216,216,10,1,9,4,3
10,219,219,42,8,34,3,2
2,220,220,23,23,0,1,0
9,228,228,36,8,28,2,1
17,247,247,61,61,0,1,0
14,261,261,40,28,12,3,2
15,279,279,1,1,0,1,0
12,294,294,24,24,0,1,0
8,344,344,7,1,6,3,2
3,346,346,81,18,63,4,3
20,357,357,3,3,0,1,0
13,357,357,133,56,77,4,3
1,367,367,55,55,0,1,0
7,382,382,15,15,0,1,0
21,415,415,19,8,11,2,1
11,453,453,11,4,7,2,1
5,470,470,125,77,48,4,3
16,486,486,1,1,0,1,0
19,489,489,9,9,0,1,0

4,104,104,7,3,4,2,1
2,129,129,5,5,0,1,0
15,129,129,40,40,0,1,0
16,130,130,7,7,0,1,0
17,131,131,2,2,0,1,0
3,192,192,29,2,27,4,3
14,200,200,7,7,0,1,0
5,202,202,5,5,0,1,0
6,208,208,54,23,31,2,1
8,213,213,71,47,24,3,2
0,237,237,47,20,27,4,3
10,242,242,17,1,16,2,1
9,270,270,15,9,6,2,1
22,342,342,16,6,10,2,1
11,371,371,6,6,0,1,0
12,382,382,166,61,105,4,3
19,408,408,18,18,0,1,0
13,417,417,3,3,0,1,0
20,460,460,35,32,3,2,1
1,464,464,79,79,0,1,0
7,468,468,2,2,0,1,0
21,471,471,14,8,6,2,1
18,480,480,89,38,51,4,3

9,104,104,26,11,15,4,3
20,105,105,5,5,0,1,0
0,107,107,1,1,0,1,0
19,113,113,2,2,0,1,0
6,118,118,14,14,0,1,0
8,167,167,9,9,0,1,0
17,194,194,55,55,0,1,0
15,196,196,4,1,3,2,1
16,211,211,21,12,9,2,1
12,218,218,17,17,0,1,0
22,241,241,31,31,0,1,0
3,289,289,48,48,0,1,0
13,290,290,26,26,0,1,0
10,294,294,53,21,32,3,2
4,345,345,11,2,9,4,3
14,378,378,14,8,6,3,2
1,413,413,70,70,0,1,0
7,433,433,85,85,0,1,0
2,433,433,30,30,0,1,0
21,450,450,75,75,0,1,0
5,483,483,117,117,0,1,0
11,487,487,52,28,24,4,3
18,497,497,41,41,0,1,0

21,107,107,4,4,0,1,0
15,114,114,11,5,6,3,2
7,160,160,12,4,8,2,1
26,170,170,19,19,0,1,0
4,203,203,44,44,0,1,0
24,210,210,35,3,32,2,1
20,230,230,3,3,0,1,0
13,240,240,22,22,0,1,0
8,261,261,37,37,0,1,0
16,272,272,14,5,9,4,3
2,276,276,24,24,0,1,0
0,336,336,17,11,6,3,2
19,339,339,5,1,4,2,1
3,353,353,15,15,0,1,0
18,356,356,43,43,0,1,0
22,362,362,57,15,42,3,2
14,364,364,12,7,5,2,1
12,392,392,23,23,0,1,0
9,395,395,4,4,0,1,0
25,407,407,64,23,41,3,2
27,418,418,15,15,0,1,0
23,429,429,14,14,0,1,0
6,451,451,117,73,44,3,2
17,464,464,153,57,96,4,3
10,466,466,16,16,0,1,0
5,469,469,16,16,0,1,0
1,477,477,13,10,3,2,1
11,478,478,67,25,42,3,2

15,104,104,3,3,0,1,0
16,124,124,5,5,0,1,0
25,157,157,12,12,0,1,0
17,171,171,9,9,0,1,0
0,173,173,4,1,3,2,1
21,179,179,8,2,6,3,2
22,197,197,33,33,0,1,0
18,207,207,57,57,0,1,0
7,227,227,42,42,0,1,0
24,239,239,20,20,0,1,0
12,269,269,5,5,0,1,0
27,296,296,43,43,0,1,0
3,308,308,18,4,14,3,2
1,318,318,1,1,0,1,0
19,323,323,73,73,0,1,0
9,325,325,30,30,0,1,0
26,325,325,30,30,0,1,0
5,340,340,44,5,39,4,3
10,347,347,23,23,0,1,0
20,369,369,26,26,0,1,0
2,373,373,3,3,0,1,0
13,411,411,35,35,0,1,0
23,411,411,11,11,0,1,0
8,413,413,1,1,0,1,0
4,413,413,103,57,46,4,3
14,422,422,12,12,0,1,0
6,489,489,21,12,9,4,3
11,492,492,152,108,44,3,2

22,110,110,14,3,11,3,2
31,113,113,5,5,0,1,0
30,116,116,14,14,0,1,0
16,120,120,1,1,0,1,0
12,125,125,6,6,0,1,0
19,130,130,21,5,16,2,1
0,137,137,36,7,29,2,1
28,162,162,14,14,0,1,0
14,168,168,28,28,0,1,0
5,174,174,9,9,0,1,0
23,178,178,60,60,0,1,0
7,203,203,1,1,0,1,0
10,249,249,13,4,9,3,2
11,266,266,2,2,0,1,0
4,279,279,19,19,0,1,0
27,287,287,13,13,0,1,0
3,305,305,21,7,14,3,2
29,334,334,41,41,0,1,0
8,353,353,27,27,0,1,0
25,362,362,12,12,0,1,0
26,366,366,59,16,43,2,1
1,370,370,5,5,0,1,0
21,372,372,17,1,16,2,1
17,372,372,75,75,0,1,0
13,394,394,31,31,0,1,0
24,398,398,9,2,7,2,1
2,401,401,13,13,0,1,0
18,412,412,2,2,0,1,0
6,415,415,21,9,12,2,1
20,421,421,13,13,0,1,0
9,462,462,47,47,0,1,0
15,465,465,1,1,0,1,0

24,111,111,3,3,0,1,0
19,146,146,18,18,0,1,0
22,170,170,42,13,29,2,1
3,171,171,10,10,0,1,0
0,175,175,2,2,0,1,0
27,181,181,16,12,4,2,1
1,213,213,5,5,0,1,0
7,231,231,36,36,0,1,0
18,242,242,33,2,31,2,1
5,256,256,4,1,3,2,1
9,269,269,27,27,0,1,0
28,298,298,11,11,0,1,0
25,317,317,34,29,5,2,1
10,329,329,16,7,9,4,3
11,331,331,2,2,0,1,0
2,334,334,8,8,0,1,0
26,360,360,32,32,0,1,0
16,388,388,101,101,0,1,0
29,392,392,57,57,0,1,0
13,407,407,9,9,0,1,0
17,409,409,44,22,22,3,2
6,413,413,20,20,0,1,0
8,415,415,73,58,15,2,1
21,429,429,27,1,26,3,2
12,431,431,25,21,4,2,1
30,434,434,8,8,0,1,0
4,445,445,19,19,0,1,0
20,446,446,29,7,22,3,2
23,463,463,83,83,0,1,0
14,493,493,16,8,8,3,2
15,496,496,55,46,9,4,3

8,112,112,7,7,0,1,0
2,117,117,4,4,0,1,0
6,121,121,9,9,0,1,0
18,130,130,13,4,9,2,1
10,151,151,1,1,0,1,0
21,186,186,4,4,0,1,0
24,201,201,15,15,0,1,0
11,203,203,25,7,18,3,2
17,226,226,2,2,0,1,0
19,238,238,22,4,18,3,2
12,253,253,14,14,0,1,0
22,264,264,5,5,0,1,0
0,297,297,14,1,13,4,3
5,329,329,63,31,32,3,2
16,347,347,72,25,47,2,1
1,367,367,19,4,15,4,3
14,379,379,185,185,0,1,0
20,386,386,19,10,9,4,3
9,400,400,30,30,0,1,0
3,411,411,70,28,42,4,3
13,414,414,30,30,0,1,0
23,419,419,2,2,0,1,0
15,453,453,58,58,0,1,0
7,477,477,158,62,96,4,3
4,478,478,64,64,0,1,0

6,133,133,1,1,0,1,0
3,141,141,18,8,10,3,2
24,172,172,26,5,21,4,3
1,177,177,4,4,0,1,0
15,207,207,12,12,0,1,0
19,218,218,34,16,18,3,2
4,221,221,8,8,0,1,0
7,226,226,6,6,0,1,0
10,246,246,16,16,0,1,0
21,246,246,27,3,24,3,2
17,254,254,59,59,0,1,0
16,304,304,16,16,0,1,0
11,311,311,1,1,0,1,0
23,324,324,12,4,8,3,2
22,326,326,13,13,0,1,0
8,333,333,20,20,0,1,0
9,345,345,230,230,0,1,0
14,364,364,75,75,0,1,0
5,382,382,38,38,0,1,0
18,401,401,23,8,15,4,3
12,406,406,58,50,8,2,1
13,440,440,16,16,0,1,0
0,459,459,7,7,0,1,0
2,465,465,80,41,39,3,2
20,477,477,18,18,0,1,0

7,108,108,2,2,0,1,0
20,133,133,4,4,0,1,0
19,157,157,5,5,0,1,0
8,176,176,77,8,69,4,3
24,242,242,8,1,7,3,2
10,244,244,1,1,0,1,0
4,276,276,18,18,0,1,0
2,279,279,37,37,0,1,0
1,283,283,7,1,6,3,2
23,294,294,5,2,3,2,1
22,294,294,27,3,24,2,1
12,303,303,15,15,0,1,0
5,336,336,4,1,3,2,1
3,382,382,38,38,0,1,0
6,385,385,1,1,0,1,0
13,402,402,17,6,11,2,1
21,408,408,38,18,20,2,1
17,411,411,121,109,12,4,3
16,427,427,35,20,15,4,3
14,433,433,50,24,26,2,1
18,445,445,152,152,0,1,0
11,447,447,30,13,17,2,1
9,456,456,104,79,25,2,1
0,485,485,102,71,31,3,2
15,486,486,49,35,14,2,1

3,135,135,5,2,3,2,1
14,140,140,5,5,0,1,0
27,146,146,7,7,0,1,0
12,151,151,22,22,0,1,0
19,170,170,10,10,0,1,0
4,212,212,1,1,0,1,0
26,218,218,11,4,7,2,1
1,231,231,56,16,40,3,2
0,246,246,1,1,0,1,0
5,289,289,12,12,0,1,0
17,315,315,79,38,41,2,1
25,327,327,29,23,6,2,1
2,335,335,44,1,43,3,2
28,336,336,9,9,0,1,0
11,345,345,12,2,10,2,1
13,348,348,13,13,0,1,0
23,352,352,58,41,17,2,1
21,353,353,31,4,27,4,3
7,353,353,44,44,0,1,0
22,359,359,43,43,0,1,0
10,374,374,9,6,3,2,1
24,375,375,41,6,35,4,3
9,398,398,60,60,0,1,0
20,409,409,9,9,0,1,0
15,436,436,5,5,0,1,0
6,439,439,35,4,31,3,2
18,447,447,118,118,0,1,0
8,464,464,91,43,48,4,3
16,471,471,16,16,0,1,0

4,112,112,8,4,4,2,1
7,113,113,9,9,0,1,0
16,125,125,15,5,10,2,1
15,134,134,12,12,0,1,0
1,136,136,10,2,8,3,2
18,136,136,7,7,0,1,0
6,153,153,4,4,0,1,0
12,154,154,9,3,6,2,1
19,159,159,15,15,0,1,0
5,266,266,40,24,16,2,1
11,299,299,74,31,43,3,2
3,321,321,162,102,60,4,3
13,322,322,54,27,27,4,3
0,324,324,13,13,0,1,0
21,327,327,21,16,5,2,1
2,328,328,10,10,0,1,0
23,335,335,23,15,8,3,2
10,348,348,43,43,0,1,0
17,365,365,11,5,6,2,1
9,371,371,9,1,8,3,2
14,393,393,92,92,0,1,0
20,433,433,14,4,10,2,1
22,465,465,37,23,14,2,1
8,482,482,86,5,81,4,3

12,119,119,12,12,0,1,0
0,131,131,7,7,0,1,0
14,147,147,9,9,0,1,0
6,153,153,14,14,0,1,0
2,174,174,25,25,0,1,0
5,178,178,4,4,0,1,0
24,199,199,4,1,3,2,1
9,200,200,1,1,0,1,0
3,210,210,15,15,0,1,0
1,232,232,3,3,0,1,0
11,250,250,7,7,0,1,0
8,270,270,2,2,0,1,0
7,275,275,12,3,9,2,1
23,277,277,24,4,20,2,1
22,281,281,35,35,0,1,0
13,331,331,77,65,12,4,3
26,336,336,11,5,6,3,2
16,376,376,20,20,0,1,0
17,391,391,75,20,55,4,3
19,428,428,35,21,14,3,2
27,429,429,88,72,16,2,1
20,441,441,19,1,18,3,2
21,449,449,73,58,15,4,3
15,450,450,10,10,0,1,0
25,462,462,58,27,31,4,3
18,467,467,78,78,0,1,0
10,468,468,103,54,49,4,3
4,475,475,100,100,0,1,0

4,103,103,6,6,0,1,0
22,117,117,28,28,0,1,0
6,148,148,8,3,5,2,1
17,155,155,13,3,10,3,2
15,158,158,9,9,0,1,0
10,175,175,35,31,4,2,1
5,180,180,4,4,0,1,0
16,187,187,35,2,33,4,3
2,189,189,60,60,0,1,0
7,189,189,5,5,0,1,0
19,208,208,14,14,0,1,0
21,209,209,6,6,0,1,0
12,252,252,8,3,5,2,1
9,270,270,7,2,5,2,1
11,273,273,27,4,23,2,1
25,313,313,29,29,0,1,0
18,341,341,4,4,0,1,0
0,379,379,105,64,41,2,1
1,403,403,34,11,23,2,1
20,409,409,70,70,0,1,0
23,418,418,147,25,122,4,3
13,437,437,1,1,0,1,0
8,444,444,16,16,0,1,0
14,474,474,10,1,9,2,1
3,484,484,33,11,22,2,1
24,496,496,4,4,0,1,0

16,129,129,41,41,0,1,0
19,148,148,43,16,27,2,1
8,158,158,13,1,12,4,3
9,178,178,7,4,3,2,1
3,211,211,51,51,0,1,0
6,214,214,41,41,0,1,0
5,226,226,37,21,16,2,1
0,235,235,7,7,0,1,0
10,277,277,8,4,4,2,1
18,292,292,20,20,0,1,0
15,327,327,25,25,0,1,0
20,363,363,55,55,0,1,0
13,364,364,26,26,0,1,0
14,405,405,1,1,0,1,0
17,412,412,30,30,0,1,0
21,424,424,14,14,0,1,0
12,428,428,63,63,0,1,0
11,456,456,9,9,0,1,0
2,462,462,28,4,24,3,2
1,475,475,5,5,0,1,0
7,480,480,130,13,117,4,3
4,486,486,122,50,72,4,3

18,120,120,37,13,24,4,3
20,131,131,15,15,0,1,0
2,157,157,4,4,0,1,0
6,158,158,23,5,18,4,3
1,165,165,1,1,0,1,0
15,169,169,11,11,0,1,0
16,172,172,25,25,0,1,0
9,188,188,5,5,0,1,0
12,217,217,27,27,0,1,0
3,228,228,2,2,0,1,0
14,272,272,27,18,9,4,3
5,272,272,46,46,0,1,0
11,285,285,24,15,9,2,1
4,288,288,26,14,12,4,3
0,312,312,21,21,0,1,0
10,315,315,21,21,0,1,0
7,360,360,192,163,29,2,1
23,374,374,13,5,8,3,2
22,412,412,46,10,36,2,1
8,427,427,69,35,34,2,1
19,430,430,4,1,3,2,1
13,434,434,51,1,50,3,2
21,446,446,19,10,9,2,1
17,473,473,32,18,14,3,2

26,105,105,1,1,0,1,0
0,123,123,2,2,0,1,0
17,150,150,6,6,0,1,0
19,189,189,2,2,0,1,0
23,204,204,28,17,11,2,1
27,217,217,61,61,0,1,0
9,223,223,1,1,0,1,0
3,232,232,5,5,0,1,0
7,243,243,8,3,5,2,1
15,254,254,28,16,12,4,3
18,255,255,12,5,7,2,1
6,294,294,3,3,0,1,0
1,308,308,2,2,0,1,0
28,315,315,40,40,0,1,0
4,316,316,22,22,0,1,0
8,335,335,27,27,0,1,0
24,366,366,56,32,24,4,3
5,368,368,34,4,30,2,1
21,370,370,20,1,19,4,3
16,374,374,24,24,0,1,0
12,398,398,18,18,0,1,0
20,412,412,5,5,0,1,0
22,419,419,129,129,0,1,0
10,451,451,19,19,0,1,0
2,458,458,208,140,68,3,2
25,472,472,41,41,0,1,0
11,478,478,83,83,0,1,0
14,483,483,36,21,15,4,3
13,492,492,33,33,0,1,0

17,118,118,5,5,0,1,0
24,138,138,23,23,0,1,0
3,179,179,12,12,0,1,0
6,187,187,1,1,0,1,0
15,207,207,13,13,0,1,0
12,223,223,18,6,12,4,3
1,224,224,7,3,4,2,1
4,242,242,45,45,0,1,0
9,251,251,24,3,21,2,1
14,266,266,74,70,4,2,1
26,312,312,21,21,0,1,0
7,331,331,28,28,0,1,0
13,338,338,11,11,0,1,0
27,345,345,12,12,0,1,0
25,349,349,3,3,0,1,0
21,361,361,22,22,0,1,0
18,411,411,120,87,33,2,1
8,423,423,20,20,0,1,0
16,428,428,25,3,22,3,2
10,465,465,50,50,0,1,0
2,466,466,5,5,0,1,0
19,469,469,53,53,0,1,0
5,473,473,85,85,0,1,0
22,481,481,92,26,66,3,2
11,484,484,29,5,24,4,3
20,496,496,59,14,45,2,1
0,497,497,17,13,4,2,1
23,500,500,54,54,0,1,0

25,137,137,2,2,0,1,0
14,145,145,10,10,0,1,0
22,159,159,62,34,28,3,2
12,165,165,8,5,3,2,1
3,172,172,6,6,0,1,0
7,188,188,9,9,0,1,0
11,200,200,15,15,0,1,0
4,209,209,48,48,0,1,0
8,209,209,9,9,0,1,0
6,224,224,21,6,15,2,1
26,228,228,2,2,0,1,0
17,239,239,43,43,0,1,0
23,253,253,5,5,0,1,0
0,276,276,1,1,0,1,0
9,284,284,8,3,5,2,1
16,305,305,31,31,0,1,0
19,305,305,31,21,10,2,1
24,315,315,5,5,0,1,0
15,318,318,16,16,0,1,0
13,322,322,28,9,19,2,1
2,359,359,1,1,0,1,0
10,361,361,86,86,0,1,0
20,382,382,25,25,0,1,0
1,391,391,27,27,0,1,0
5,408,408,122,53,69,4,3
21,426,426,116,18,98,3,2
18,499,499,14,14,0,1,0

7,102,102,10,4,6,3,2
18,104,104,1,1,0,1,0
26,119,119,24,24,0,1,0
21,124,124,36,24,12,2,1
20,142,142,3,3,0,1,0
12,168,168,10,10,0,1,0
19,172,172,8,8,0,1,0
23,173,173,1,1,0,1,0
16,219,219,14,8,6,3,2
24,224,224,12,1,11,2,1
10,259,259,18,18,0,1,0
11,261,261,6,6,0,1,0
25,264,264,2,2,0,1,0
0,277,277,26,26,0,1,0
15,302,302,29,24,5,2,1
9,315,315,26,2,24,2,1
6,335,335,53,53,0,1,0
4,352,352,32,32,0,1,0
13,361,361,24,24,0,1,0
17,386,386,20,10,10,2,1
3,388,388,6,1,5,2,1
14,389,389,25,12,13,2,1
22,463,463,196,142,54,4,3
2,468,468,49,11,38,3,2
8,474,474,17,17,0,1,0
5,488,488,56,23,33,4,3
1,499,499,144,90,54,3,2

14,104,104,6,3,3,2,1
20,105,105,24,20,4,2,1
22,130,130,6,6,0,1,0
27,131,131,2,2,0,1,0
10,132,132,4,4,0,1,0
12,132,132,4,4,0,1,0
11,147,147,5,1,4,2,1
13,167,167,21,21,0,1,0
15,187,187,2,2,0,1,0
26,191,191,11,11,0,1,0
17,219,219,5,2,3,2,1
19,221,221,7,7,0,1,0
21,252,252,6,6,0,1,0
2,253,253,54,54,0,1,0
9,282,282,7,2,5,2,1
24,287,287,60,19,41,2,1
25,298,298,7,7,0,1,0
8,333,333,8,2,6,3,2
28,338,338,33,33,0,1,0
5,344,344,50,50,0,1,0
6,355,355,56,19,37,2,1
4,390,390,40,18,22,2,1
1,428,428,1,1,0,1,0
7,429,429,36,9,27,4,3
16,441,441,15,3,12,3,2
0,444,444,20,20,0,1,0
18,448,448,72,40,32,3,2
23,485,485,189,177,12,4,3
3,488,488,106,13,93,4,3

15,102,102,3,3,0,1,0
2,107,107,7,7,0,1,0
11,114,114,7,4,3,2,1
10,120,120,12,12,0,1,0
26,123,123,1,1,0,1,0
17,127,127,18,10,8,2,1
7,131,131,15,7,8,3,2
9,171,171,1,1,0,1,0
18,189,189,42,6,36,4,3
6,223,223,18,6,12,4,3
5,251,251,4,1,3,2,1
16,257,257,4,4,0,1,0
8,273,273,67,7,60,4,3
4,283,283,15,6,9,4,3
12,299,299,81,81,0,1,0
0,310,310,24,6,18,4,3
20,334,334,24,3,21,3,2
13,355,355,30,20,10,3,2
1,363,363,19,19,0,1,0
27,381,381,25,25,0,1,0
22,383,383,74,28,46,3,2
14,389,389,4,1,3,2,1
23,401,401,67,67,0,1,0
19,431,431,6,6,0,1,0
29,446,446,97,46,51,4,3
28,454,454,77,77,0,1,0
21,455,455,3,3,0,1,0
25,468,468,12,12,0,1,0
24,491,491,8,2,6,3,2
3,495,495,9,9,0,1,0

3,107,107,12,12,0,1,0
9,111,111,6,2,4,2,1
18,122,122,1,1,0,1,0
21,195,195,22,22,0,1,0
15,230,230,28,10,18,4,3
22,250,250,42,42,0,1,0
13,256,256,10,10,0,1,0
5,262,262,17,11,6,2,1
1,287,287,30,30,0,1,0
17,298,298,35,16,19,2,1
10,304,304,55,20,35,2,1
24,320,320,7,7,0,1,0
23,336,336,20,20,0,1,0
0,366,366,6,6,0,1,0
14,375,375,9,9,0,1,0
11,382,382,21,13,8,2,1
6,396,396,88,61,27,4,3
16,406,406,31,3,28,2,1
20,430,430,19,11,8,3,2
2,454,454,84,36,48,4,3
19,457,457,80,45,35,2,1
7,464,464,16,16,0,1,0
12,477,477,165,60,105,4,3
4,486,486,76,76,0,1,0
8,495,495,57,57,0,1,0

21,103,103,12,7,5,2,1
2,119,119,11,5,6,3,2
20,127,127,14,2,12,3,2
7,170,170,14,14,0,1,0
18,192,192,12,3,9,3,2
6,209,209,4,1,3,2,1
3,217,217,10,4,6,3,2
15,228,228,5,2,3,2,1
8,231,231,131,131,0,1,0
19,242,242,67,57,10,3,2
17,269,269,30,30,0,1,0
4,276,276,41,1,40,2,1
10,284,284,22,12,10,2,1
12,297,297,2,2,0,1,0
5,327,327,38,9,29,4,3
9,345,345,3,3,0,1,0
0,345,345,7,7,0,1,0
13,369,369,40,36,4,2,1
14,372,372,46,36,10,2,1
22,381,381,97,67,30,4,3
16,388,388,6,6,0,1,0
11,392,392,16,7,9,2,1
1,411,411,83,83,0,1,0

0,111,111,9,9,0,1,0
27,121,121,1,1,0,1,0
11,138,138,3,3,0,1,0
23,144,144,5,1,4,2,1
20,144,144,10,10,0,1,0
15,159,159,48,2,46,3,2
10,163,163,6,6,0,1,0
4,181,181,6,6,0,1,0
17,183,183,14,14,0,1,0
12,219,219,62,6,56,3,2
8,230,230,1,1,0,1,0
28,271,271,48,48,0,1,0
13,277,277,9,9,0,1,0
21,305,305,108,3,105,4,3
29,335,335,26,26,0,1,0
5,345,345,39,39,0,1,0
7,347,347,5,1,4,2,1
9,351,351,29,29,0,1,0
6,355,355,30,30,0,1,0
22,379,379,22,22,0,1,0
26,407,407,19,1,18,3,2
18,418,418,58,58,0,1,0
24,460,460,37,9,28,3,2
14,464,464,20,2,18,4,3
2,477,477,57,57,0,1,0
19,479,479,93,38,55,4,3
1,490,490,9,9,0,1,0
3,492,492,2,2,0,1,0
16,496,496,13,3,10,3,2
25,500,500,7,7,0,1,0

4,113,113,11,11,0,1,0
17,114,114,7,7,0,1,0
10,119,119,21,21,0,1,0
2,133,133,2,2,0,1,0
13,137,137,17,6,11,2,1
3,142,142,44,44,0,1,0
20,145,145,6,6,0,1,0
16,151,151,27,20,7,2,1
18,170,170,28,14,14,3,2
19,201,201,23,23,0,1,0
0,204,204,28,10,18,3,2
23,210,210,15,15,0,1,0
9,212,212,62,62,0,1,0
6,213,213,27,27,0,1,0
21,214,214,18,10,8,2,1
12,265,265,20,3,17,2,1
5,309,309,19,9,10,3,2
7,313,313,4,4,0,1,0
14,340,340,26,26,0,1,0
1,351,351,20,20,0,1,0
8,381,381,7,7,0,1,0
22,418,418,35,31,4,2,1
11,461,461,37,14,23,2,1
15,462,462,85,19,66,3,2

4,123,123,13,2,11,2,1
3,176,176,11,11,0,1,0
23,190,190,12,12,0,1,0
18,195,195,22,22,0,1,0
10,196,196,11,11,0,1,0
14,248,248,19,19,0,1,0
25,262,262,77,33,44,3,2
26,263,263,3,3,0,1,0
6,271,271,3,3,0,1,0
20,293,293,29,13,16,2,1
13,299,299,38,13,25,4,3
17,299,299,26,15,11,2,1
1,301,301,12,12,0,1,0
0,342,342,31,31,0,1,0
16,370,370,71,7,64,3,2
11,376,376,34,34,0,1,0
24,380,380,24,18,6,2,1
5,411,411,36,3,33,2,1
2,419,419,12,12,0,1,0
22,420,420,59,59,0,1,0
7,426,426,80,8,72,3,2
12,429,429,25,6,19,2,1
15,439,439,60,60,0,1,0
19,443,443,14,14,0,1,0
9,460,460,26,26,0,1,0
8,465,465,40,40,0,1,0
21,467,467,33,33,0,1,0
28,467,467,36,36,0,1,0
27,488,488,37,37,0,1,0

28,125,125,7,7,0,1,0
14,137,137,12,12,0,1,0
19,144,144,8,8,0,1,0
7,157,157,1,1,0,1,0
27,193,193,68,54,14,3,2
17,224,224,40,40,0,1,0
5,233,233,40,40,0,1,0
15,239,239,4,1,3,2,1
13,240,240,36,36,0,1,0
10,242,242,2,2,0,1,0
3,249,249,4,4,0,1,0
25,250,250,42,34,8,2,1
9,261,261,57,57,0,1,0
22,266,266,21,21,0,1,0
2,306,306,1,1,0,1,0
8,313,313,12,12,0,1,0
4,320,320,10,1,9,4,3
18,347,347,14,14,0,1,0
6,357,357,32,8,24,4,3
21,361,361,8,2,6,3,2
11,394,394,65,46,19,2,1
16,396,396,63,27,36,4,3
0,405,405,8,8,0,1,0
24,408,408,28,28,0,1,0
26,412,412,5,5,0,1,0
1,431,431,106,106,0,1,0
12,440,440,15,4,11,4,3
23,480,480,58,58,0,1,0
20,491,491,3,3,0,1,0

25,112,112,9,1,8,2,1
21,137,137,15,3,12,2,1
4,210,210,37,37,0,1,0
1,221,221,21,4,17,2,1
7,236,236,15,8,7,2,1
2,245,245,55,55,0,1,0
11,248,248,35,10,25,2,1
22,265,265,2,2,0,1,0
16,289,289,34,4,30,3,2
14,290,290,27,27,0,1,0
12,295,295,27,27,0,1,0
10,302,302,24,9,15,2,1
9,306,306,54,2,52,4,3
23,321,321,87,33,54,4,3
18,325,325,26,26,0,1,0
17,350,350,4,4,0,1,0
8,354,354,19,19,0,1,0
5,378,378,23,23,0,1,0
0,393,393,3,3,0,1,0
6,398,398,10,2,8,2,1
20,407,407,76,51,25,2,1
15,414,414,3,3,0,1,0
3,420,420,45,45,0,1,0
13,429,429,90,72,18,3,2
19,471,471,34,34,0,1,0
24,475,475,34,34,0,1,0

21,104,104,6,6,0,1,0
7,104,104,22,19,3,2,1
27,107,107,15,3,12,3,2
23,107,107,7,2,5,2,1
0,108,108,6,6,0,1,0
5,122,122,10,10,0,1,0
14,135,135,1,1,0,1,0
9,136,136,20,20,0,1,0
16,145,145,8,8,0,1,0
24,148,148,18,18,0,1,0
4,170,170,7,3,4,2,1
30,177,177,23,8,15,4,3
8,179,179,25,13,12,2,1
32,185,185,7,7,0,1,0
25,202,202,3,3,0,1,0
1,205,205,13,5,8,3,2
26,221,221,20,2,18,2,1
20,222,222,4,4,0,1,0
31,246,246,2,2,0,1,0
10,261,261,1,1,0,1,0
11,277,277,1,1,0,1,0
6,287,287,3,3,0,1,0
17,293,293,4,4,0,1,0
18,339,339,31,13,18,3,2
29,376,376,20,20,0,1,0
2,378,378,19,19,0,1,0
22,396,396,9,9,0,1,0
3,423,423,13,13,0,1,0
28,452,452,271,271,0,1,0
19,455,455,74,74,0,1,0
12,473,473,23,23,0,1,0
15,480,480,14,14,0,1,0
13,489,489,26,26,0,1,0

6,146,146,1,1,0,1,0
7,157,157,1,1,0,1,0
2,180,180,31,7,24,4,3
22,187,187,8,8,0,1,0
3,189,189,26,8,18,3,2
13,193,193,1,1,0,1,0
14,218,218,10,1,9,2,1
5,266,266,57,57,0,1,0
11,269,269,1,1,0,1,0
26,285,285,31,31,0,1,0
21,311,311,13,2,11,2,1
16,311,311,28,28,0,1,0
4,330,330,17,17,0,1,0
1,338,338,87,21,66,4,3
9,345,345,39,21,18,3,2
12,350,350,41,10,31,4,3
15,357,357,106,76,30,2,1
8,359,359,2,2,0,1,0
25,360,360,35,35,0,1,0
0,369,369,26,26,0,1,0
20,400,400,33,33,0,1,0
18,410,410,25,8,17,3,2
24,425,425,20,20,0,1,0
27,427,427,17,17,0,1,0
10,457,457,44,44,0,1,0
19,459,459,6,3,3,2,1
17,462,462,54,23,31,2,1
23,491,491,139,139,0,1,0

2,119,119,5,5,0,1,0
10,120,120,5,5,0,1,0
24,123,123,1,1,0,1,0
17,128,128,31,12,19,2,1
3,131,131,42,36,6,3,2
5,149,149,48,38,10,2,1
15,153,153,3,3,0,1,0
16,155,155,31,31,0,1,0
21,162,162,13,13,0,1,0
7,171,171,7,7,0,1,0
6,174,174,1,1,0,1,0
0,209,209,1,1,0,1,0
9,221,221,5,1,4,2,1
1,262,262,23,12,11,2,1
13,322,322,27,6,21,2,1
8,341,341,60,6,54,4,3
20,359,359,3,3,0,1,0
4,375,375,76,30,46,3,2
22,385,385,11,11,0,1,0
12,401,401,79,31,48,4,3
19,408,408,76,32,44,2,1
23,422,422,63,45,18,4,3
11,424,424,15,15,0,1,0
18,441,441,24,24,0,1,0
14,493,493,36,36,0,1,0

31,108,108,5,5,0,1,0
2,116,116,1,1,0,1,0
12,121,121,3,3,0,1,0
30,121,121,53,53,0,1,0
28,151,151,19,9,10,2,1
22,170,170,5,5,0,1,0
29,177,177,7,3,4,2,1
25,215,215,10,10,0,1,0
23,223,223,9,9,0,1,0
4,231,231,1,1,0,1,0
8,238,238,20,20,0,1,0
16,253,253,18,6,12,4,3
27,278,278,6,6,0,1,0
13,299,299,23,11,12,2,1
24,304,304,28,1,27,4,3
10,311,311,11,11,0,1,0
17,311,311,26,26,0,1,0
5,317,317,61,61,0,1,0
14,317,317,18,2,16,3,2
6,319,319,63,32,31,2,1
11,328,328,35,35,0,1,0
15,350,350,49,49,0,1,0
0,360,360,18,8,10,3,2
26,365,365,29,11,18,3,2
19,379,379,51,51,0,1,0
20,402,402,51,1,50,4,3
9,406,406,8,8,0,1,0
18,425,425,10,10,0,1,0
21,456,456,47,47,0,1,0
1,460,460,36,13,23,2,1
7,480,480,1,1,0,1,0
3,497,497,23,23,0,1,0

20,108,108,13,13,0,1,0
18,110,110,7,7,0,1,0
10,132,132,6,1,5,2,1
11,150,150,9,9,0,1,0
8,160,160,11,11,0,1,0
12,187,187,21,4,17,4,3
9,225,225,42,42,0,1,0
3,232,232,6,6,0,1,0
6,285,285,108,33,75,4,3
14,300,300,50,15,35,2,1
19,377,377,48,21,27,4,3
17,382,382,15,15,0,1,0
5,384,384,32,16,16,2,1
15,390,390,47,5,42,4,3
13,401,401,77,56,21,2,1
2,409,409,54,43,11,2,1
1,436,436,136,21,115,4,3
16,456,456,9,9,0,1,0
0,457,457,17,3,14,3,2
7,489,489,143,131,12,2,1
4,489,489,19,4,15,2,1

19,110,110,11,11,0,1,0
0,126,126,14,3,11,2,1
18,129,129,45,45,0,1,0
5,142,142,4,4,0,1,0
8,147,147,6,6,0,1,0
4,151,151,6,6,0,1,0
16,157,157,2,2,0,1,0
25,171,171,55,55,0,1,0
10,182,182,24,5,19,4,3
28,204,204,15,1,14,2,1
3,207,207,5,5,0,1,0
1,209,209,17,17,0,1,0
12,267,267,36,36,0,1,0
17,286,286,22,22,0,1,0
14,317,317,46,11,35,2,1
13,318,318,19,19,0,1,0
20,334,334,22,22,0,1,0
7,349,349,23,2,21,4,3
21,349,349,1,1,0,1,0
9,373,373,64,64,0,1,0
15,380,380,92,92,0,1,0
24,391,391,43,9,34,3,2
2,465,465,4,4,0,1,0
22,473,473,5,5,0,1,0
11,475,475,1,1,0,1,0
26,477,477,8,8,0,1,0
6,480,480,7,1,6,3,2
23,483,483,35,35,0,1,0
27,491,491,55,30,25,3,2

0,100,100,6,6,0,1,0
11,111,111,41,15,26,2,1
1,131,131,1,1,0,1,0
9,157,157,46,46,0,1,0
12,192,192,22,22,0,1,0
14,199,199,24,24,0,1,0
19,230,230,3,3,0,1,0
16,265,265,66,66,0,1,0
8,267,267,9,2,7,2,1
22,271,271,49,49,0,1,0
4,280,280,26,26,0,1,0
2,312,312,17,17,0,1,0
3,338,338,31,31,0,1,0
23,345,345,13,1,12,3,2
15,376,376,103,76,27,4,3
13,383,383,4,4,0,1,0
21,397,397,22,22,0,1,0
10,417,417,11,5,6,2,1
17,421,421,6,6,0,1,0
5,421,421,6,6,0,1,0
25,432,432,13,8,5,2,1
20,440,440,94,54,40,3,2
6,451,451,8,3,5,2,1
24,452,452,3,3,0,1,0
18,463,463,51,2,49,3,2
7,473,473,60,30,30,4,3

12,113,113,1,1,0,1,0
9,134,134,22,4,18,4,3
10,137,137,1,1,0,1,0
23,148,148,34,15,19,2,1
28,186,186,3,3,0,1,0
17,189,189,6,6,0,1,0
27,196,196,21,21,0,1,0
14,204,204,7,7,0,1,0
24,214,214,20,20,0,1,0
11,219,219,3,3,0,1,0
3,223,223,1,1,0,1,0
6,230,230,25,2,23,2,1
25,258,258,40,25,15,4,3
18,271,271,39,27,12,4,3
13,280,280,30,30,0,1,0
7,294,294,26,26,0,1,0
0,305,305,26,5,21,2,1
16,324,324,50,23,27,4,3
1,343,343,20,5,15,4,3
29,347,347,36,32,4,2,1
2,373,373,36,5,31,2,1
4,374,374,37,5,32,2,1
5,381,381,19,10,9,4,3
19,397,397,29,29,0,1,0
15,397,397,77,77,0,1,0
8,400,400,11,11,0,1,0
21,406,406,14,14,0,1,0
20,416,416,41,41,0,1,0
22,430,430,96,15,81,4,3
26,487,487,3,3,0,1,0

12,140,140,24,24,0,1,0
16,174,174,50,50,0,1,0
17,175,175,10,6,4,2,1
13,179,179,8,8,0,1,0
7,191,191,21,3,18,4,3
2,192,192,2,2,0,1,0
5,201,201,3,3,0,1,0
22,203,203,5,5,0,1,0
3,217,217,18,18,0,1,0
23,229,229,19,19,0,1,0
25,230,230,33,9,24,4,3
20,249,249,8,4,4,2,1
19,254,254,10,7,3,2,1
18,266,266,10,10,0,1,0
4,267,267,65,18,47,2,1
15,281,281,41,7,34,3,2
11,291,291,5,5,0,1,0
0,325,325,54,54,0,1,0
14,338,338,51,51,0,1,0
10,371,371,19,8,11,2,1
9,393,393,151,57,94,3,2
21,402,402,5,1,4,2,1
8,417,417,8,4,4,2,1
24,421,421,113,50,63,4,3
6,489,489,12,12,0,1,0
1,489,489,3,3,0,1,0

1,106,106,23,13,10,2,1
21,107,107,8,8,0,1,0
8,117,117,9,9,0,1,0
17,122,122,36,2,34,3,2
19,128,128,14,6,8,2,1
22,179,179,30,7,23,2,1
3,181,181,6,2,4,2,1
13,189,189,65,65,0,1,0
0,193,193,1,1,0,1,0
24,204,204,10,1,9,2,1
25,219,219,16,16,0,1,0
6,219,219,19,19,0,1,0
5,243,243,14,2,12,3,2
14,266,266,3,3,0,1,0
7,269,269,18,5,13,4,3
9,272,272,1,1,0,1,0
20,281,281,49,49,0,1,0
18,305,305,4,1,3,2,1
12,344,344,8,8,0,1,0
15,345,345,7,7,0,1,0
10,350,350,34,34,0,1,0
2,360,360,26,6,20,2,1
11,394,394,51,51,0,1,0
23,428,428,8,8,0,1,0
26,462,462,4,4,0,1,0
16,469,469,152,34,118,4,3
4,486,486,43,43,0,1,0

9,164,164,53,5,48,4,3
18,167,167,2,2,0,1,0
11,173,173,12,12,0,1,0
21,180,180,12,1,11,2,1
2,185,185,21,1,20,3,2
4,189,189,1,1,0,1,0
12,190,190,4,4,0,1,0
17,208,208,4,4,0,1,0
1,214,214,59,11,48,4,3
10,239,239,2,2,0,1,0
19,263,263,71,71,0,1,0
6,278,278,29,29,0,1,0
8,278,278,41,37,4,2,1
20,299,299,29,7,22,3,2
13,303,303,2,2,0,1,0
5,304,304,30,18,12,3,2
23,341,341,17,17,0,1,0
14,347,347,21,21,0,1,0
15,361,361,53,3,50,3,2
3,376,376,13,13,0,1,0
7,407,407,44,44,0,1,0
16,410,410,171,21,150,4,3
0,412,412,35,3,32,3,2
22,437,437,39,31,8,2,1

3,138,138,8,8,0,1,0
9,143,143,7,7,0,1,0
11,176,176,1,1,0,1,0
16,176,176,24,14,10,2,1
14,208,208,12,3,9,2,1
20,211,211,43,19,24,3,2
2,218,218,23,23,0,1,0
25,259,259,14,8,6,3,2
8,278,278,19,11,8,3,2
24,292,292,27,27,0,1,0
1,319,319,11,11,0,1,0
22,323,323,26,8,18,4,3
17,334,334,17,17,0,1,0
18,358,358,14,14,0,1,0
5,359,359,104,50,54,3,2
0,370,370,73,19,54,4,3
10,372,372,21,21,0,1,0
23,385,385,45,26,19,2,1
4,403,403,62,62,0,1,0
19,403,403,42,15,27,2,1
26,422,422,90,80,10,2,1
12,436,436,35,35,0,1,0
6,437,437,12,12,0,1,0
21,474,474,53,53,0,1,0
7,480,480,52,52,0,1,0
13,483,483,32,32,0,1,0
15,487,487,31,24,7,2,1

15,100,100,3,3,0,1,0
16,133,133,10,10,0,1,0
5,140,140,80,80,0,1,0
4,150,150,46,46,0,1,0
3,172,172,30,12,18,4,3
0,183,183,26,13,13,2,1
17,191,191,24,24,0,1,0
18,197,197,19,3,16,2,1
14,207,207,27,4,23,2,1
2,235,235,19,2,17,2,1
11,276,276,1,1,0,1,0
9,293,293,42,42,0,1,0
12,317,317,22,14,8,2,1
10,343,343,3,3,0,1,0
1,360,360,11,11,0,1,0
8,446,446,184,144,40,3,2
13,454,454,63,30,33,4,3
6,479,479,14,4,10,3,2
7,492,492,30,30,0,1,0

10,100,100,4,1,3,2,1
21,136,136,12,12,0,1,0
14,136,136,22,22,0,1,0
23,165,165,8,8,0,1,0
4,173,173,13,13,0,1,0
6,174,174,1,1,0,1,0
20,176,176,13,2,11,2,1
7,178,178,67,67,0,1,0
0,180,180,9,3,6,3,2
3,205,205,1,1,0,1,0
19,211,211,15,15,0,1,0
24,215,215,8,8,0,1,0
15,218,218,35,22,13,2,1
16,228,228,10,1,9,2,1
26,239,239,38,38,0,1,0
2,259,259,68,44,24,4,3
5,282,282,14,14,0,1,0
17,313,313,16,16,0,1,0
11,316,316,1,1,0,1,0
12,329,329,75,70,5,2,1
9,355,355,14,14,0,1,0
8,395,395,5,5,0,1,0
13,402,402,7,7,0,1,0
18,418,418,70,45,25,4,3
25,467,467,76,20,56,3,2
22,468,468,52,45,7,2,1
1,488,488,66,66,0,1,0

12,136,136,20,20,0,1,0
19,147,147,49,49,0,1,0
17,148,148,19,19,0,1,0
5,172,172,1,1,0,1,0
26,172,172,3,3,0,1,0
6,202,202,46,16,30,2,1
1,208,208,8,8,0,1,0
18,215,215,24,13,11,3,2
10,220,220,9,9,0,1,0
16,226,226,40,40,0,1,0
25,264,264,7,4,3,2,1
22,266,266,7,7,0,1,0
27,277,277,20,12,8,2,1
3,293,293,6,6,0,1,0
0,293,293,5,1,4,2,1
15,293,293,50,50,0,1,0
13,303,303,12,12,0,1,0
21,337,337,2,2,0,1,0
2,338,338,63,9,54,3,2
8,351,351,15,15,0,1,0
11,360,360,13,3,10,3,2
23,366,366,5,5,0,1,0
4,369,369,57,44,13,2,1
7,417,417,13,13,0,1,0
20,420,420,153,153,0,1,0
28,421,421,16,16,0,1,0
9,454,454,6,3,3,2,1
24,484,484,6,6,0,1,0
14,487,487,64,10,54,4,3

16,103,103,31,5,26,3,2
17,112,112,28,1,27,4,3
14,114,114,8,8,0,1,0
13,124,124,6,6,0,1,0
8,152,152,11,11,0,1,0
10,197,197,30,30,0,1,0
1,222,222,8,4,4,2,1
18,223,223,3,3,0,1,0
2,226,226,6,6,0,1,0
5,228,228,66,66,0,1,0
21,259,259,40,40,0,1,0
12,271,271,35,3,32,2,1
0,282,282,16,4,12,4,3
11,298,298,10,2,8,2,1
6,301,301,94,40,54,4,3
9,331,331,82,82,0,1,0
7,339,339,42,9,33,4,3
15,397,397,3,3,0,1,0
20,404,404,14,14,0,1,0
4,419,419,55,55,0,1,0
3,430,430,2,2,0,1,0
22,462,462,40,25,15,2,1
19,495,495,26,4,22,2,1

8,117,117,5,1,4,2,1
23,155,155,45,16,29,2,1
22,175,175,12,12,0,1,0
11,182,182,23,23,0,1,0
9,199,199,34,34,0,1,0
4,204,204,85,85,0,1,0
20,218,218,5,5,0,1,0
13,226,226,6,6,0,1,0
12,232,232,1,1,0,1,0
21,233,233,82,82,0,1,0
24,235,235,40,10,30,2,1
26,259,259,11,11,0,1,0
18,282,282,9,9,0,1,0
16,297,297,4,1,3,2,1
1,336,336,7,7,0,1,0
17,338,338,59,35,24,3,2
14,365,365,27,19,8,2,1
3,388,388,20,20,0,1,0
19,413,413,21,21,0,1,0
6,421,421,61,25,36,4,3
2,423,423,19,19,0,1,0
25,425,425,5,5,0,1,0
0,435,435,11,11,0,1,0
10,436,436,9,9,0,1,0
15,453,453,15,15,0,1,0
5,484,484,80,80,0,1,0
7,493,493,20,20,0,1,0

10,139,139,20,20,0,1,0
32,163,163,37,27,10,2,1
26,166,166,25,19,6,3,2
11,175,175,1,1,0,1,0
22,231,231,20,20,0,1,0
13,244,244,54,54,0,1,0
2,247,247,7,7,0,1,0
18,259,259,17,17,0,1,0
5,271,271,21,7,14,2,1
20,271,271,9,9,0,1,0
9,272,272,1,1,0,1,0
19,287,287,40,8,32,4,3
7,288,288,2,2,0,1,0
8,312,312,11,6,5,2,1
12,339,339,24,3,21,2,1
6,341,341,28,5,23,2,1
27,342,342,8,3,5,2,1
30,348,348,39,39,0,1,0
17,352,352,59,46,13,2,1
31,370,370,13,9,4,2,1
3,382,382,4,4,0,1,0
21,387,387,88,7,81,4,3
4,404,404,8,8,0,1,0
16,421,421,28,28,0,1,0
14,423,423,20,20,0,1,0
29,426,426,49,49,0,1,0
15,427,427,22,16,6,2,1
0,432,432,9,2,7,2,1
28,437,437,38,2,36,4,3
23,437,437,14,14,0,1,0
24,462,462,65,45,20,4,3
25,468,468,23,23,0,1,0
1,492,492,18,18,0,1,0

22,127,127,16,16,0,1,0
13,172,172,14,14,0,1,0
24,176,176,4,4,0,1,0
2,186,186,16,6,10,3,2
29,188,188,14,14,0,1,0
0,204,204,24,7,17,2,1
25,206,206,19,19,0,1,0
17,244,244,10,10,0,1,0
5,254,254,53,6,47,2,1
1,278,278,10,10,0,1,0
9,280,280,30,30,0,1,0
20,309,309,93,90,3,2,1
16,311,311,1,1,0,1,0
8,336,336,32,32,0,1,0
26,344,344,50,3,47,3,2
18,345,345,9,4,5,2,1
19,346,346,11,1,10,2,1
28,355,355,35,35,0,1,0
7,380,380,27,5,22,2,1
30,383,383,49,49,0,1,0
27,414,414,37,37,0,1,0
4,421,421,2,2,0,1,0
6,428,428,6,6,0,1,0
3,439,439,2,2,0,1,0
21,450,450,8,8,0,1,0
14,451,451,67,39,28,3,2
23,462,462,77,50,27,4,3
15,482,482,25,19,6,2,1
11,483,483,89,89,0,1,0
12,490,490,20,6,14,2,1
10,498,498,3,3,0,1,0

33,119,119,3,3,0,1,0
31,124,124,13,5,8,2,1
24,132,132,8,8,0,1,0
27,141,141,1,1,0,1,0
25,149,149,9,3,6,3,2
28,171,171,45,17,28,2,1
3,176,176,14,9,5,2,1
17,179,179,24,16,8,3,2
20,180,180,4,1,3,2,1
13,204,204,7,7,0,1,0
6,207,207,32,32,0,1,0
21,235,235,8,4,4,2,1
4,243,243,1,1,0,1,0
2,245,245,13,13,0,1,0
34,266,266,10,2,8,3,2
18,268,268,3,3,0,1,0
23,285,285,35,7,28,3,2
0,287,287,11,8,3,2,1
8,288,288,85,35,50,3,2
12,293,293,3,3,0,1,0
16,301,301,10,1,9,2,1
14,307,307,11,11,0,1,0
1,317,317,12,12,0,1,0
22,324,324,41,41,0,1,0
7,331,331,1,1,0,1,0
5,335,335,25,9,16,3,2
32,338,338,47,47,0,1,0
11,342,342,4,4,0,1,0
29,382,382,35,11,24,3,2
10,385,385,14,5,9,2,1
9,421,421,77,50,27,3,2
30,426,426,67,30,37,2,1
19,452,452,1,1,0,1,0
26,455,455,58,38,20,4,3
15,464,464,6,6,0,1,0

20,107,107,30,6,24,3,2
13,112,112,1,1,0,1,0
2,145,145,20,20,0,1,0
18,154,154,4,4,0,1,0
3,219,219,20,5,15,4,3
11,308,308,61,61,0,1,0
6,310,310,86,14,72,4,3
22,333,333,73,57,16,3,2
16,358,358,32,32,0,1,0
8,362,362,67,55,12,2,1
10,369,369,43,8,35,4,3
21,392,392,15,3,12,3,2
4,409,409,3,3,0,1,0
14,410,410,40,4,36,3,2
12,425,425,10,10,0,1,0
7,434,434,27,8,19,2,1
0,434,434,80,80,0,1,0
1,439,439,61,51,10,2,1
19,440,440,37,37,0,1,0
17,462,462,31,5,26,2,1
5,470,470,20,12,8,2,1
15,492,492,41,20,21,4,3
9,500,500,87,87,0,1,0

15,137,137,1,1,0,1,0
24,162,162,6,1,5,2,1
9,174,174,1,1,0,1,0
5,216,216,48,48,0,1,0
16,240,240,10,4,6,3,2
20,244,244,19,19,0,1,0
25,259,259,24,24,0,1,0
21,270,270,9,1,8,2,1
26,294,294,6,2,4,2,1
19,295,295,5,1,4,2,1
6,321,321,75,36,39,4,3
13,328,328,23,23,0,1,0
17,343,343,70,23,47,2,1
7,349,349,23,23,0,1,0
11,354,354,16,16,0,1,0
4,364,364,55,35,20,2,1
14,371,371,114,23,91,3,2
3,407,407,34,34,0,1,0
8,413,413,72,72,0,1,0
12,438,438,2,2,0,1,0
10,439,439,41,41,0,1,0
18,448,448,30,15,15,4,3
23,454,454,18,15,3,2,1
2,458,458,26,8,18,3,2
0,459,459,22,9,13,2,1
22,469,469,178,82,96,3,2
1,474,474,22,22,0,1,0

4,102,102,4,4,0,1,0
13,136,136,30,30,0,1,0
8,140,140,30,3,27,3,2
21,140,140,14,14,0,1,0
1,151,151,8,5,3,2,1
19,152,152,43,7,36,2,1
7,168,168,18,8,10,2,1
11,184,184,6,1,5,2,1
6,240,240,15,3,12,2,1
17,258,258,30,30,0,1,0
12,279,279,28,4,24,4,3
14,284,284,1,1,0,1,0
2,303,303,38,38,0,1,0
23,310,310,2,2,0,1,0
9,331,331,92,92,0,1,0
15,335,335,11,2,9,2,1
16,337,337,59,59,0,1,0
24,362,362,48,12,36,4,3
0,375,375,3,3,0,1,0
18,409,409,1,1,0,1,0
22,409,409,47,23,24,3,2
20,438,438,17,17,0,1,0
3,448,448,60,60,0,1,0
5,457,457,88,58,30,3,2
10,492,492,28,7,21,2,1

23,113,113,21,21,0,1,0
10,132,132,6,1,5,2,1
22,145,145,6,6,0,1,0
5,159,159,2,2,0,1,0
26,186,186,25,25,0,1,0
4,187,187,19,7,12,2,1
27,201,201,14,14,0,1,0
20,201,201,31,4,27,4,3
6,203,203,32,32,0,1,0
25,205,205,3,3,0,1,0
15,208,208,24,24,0,1,0
12,239,239,9,9,0,1,0
0,257,257,35,13,22,3,2
16,271,271,28,1,27,4,3
9,275,275,55,23,32,2,1
3,312,312,59,36,23,2,1
18,326,326,7,7,0,1,0
11,346,346,32,12,20,2,1
13,372,372,1,1,0,1,0
1,389,389,73,32,41,2,1
8,428,428,49,33,16,3,2
2,436,436,2,2,0,1,0
21,442,442,76,76,0,1,0
24,447,447,66,66,0,1,0
17,453,453,6,6,0,1,0
19,454,454,73,62,11,2,1
14,493,493,6,6,0,1,0
7,493,493,3,3,0,1,0

27,108,108,6,6,0,1,0
0,114,114,4,4,0,1,0
22,123,123,6,6,0,1,0
10,124,124,7,4,3,2,1
29,145,145,7,7,0,1,0
4,155,155,36,36,0,1,0
21,174,174,16,7,9,2,1
11,188,188,2,2,0,1,0
16,197,197,17,4,13,3,2
2,199,199,13,2,11,2,1
23,202,202,98,52,46,3,2
20,220,220,8,2,6,3,2
3,223,223,1,1,0,1,0
18,250,250,58,3,55,4,3
1,254,254,45,45,0,1,0
14,266,266,29,23,6,3,2
19,299,299,86,86,0,1,0
15,322,322,1,1,0,1,0
25,334,334,19,3,16,3,2
31,334,334,18,8,10,3,2
28,341,341,3,3,0,1,0
5,361,361,2,2,0,1,0
6,365,365,18,5,13,2,1
8,420,420,2,2,0,1,0
9,423,423,8,1,7,2,1
30,445,445,7,7,0,1,0
26,449,449,35,6,29,4,3
24,453,453,29,29,0,1,0
17,463,463,10,4,6,3,2
13,465,465,22,3,19,2,1
7,468,468,1,1,0,1,0
12,498,498,71,41,30,3,2

17,141,141,7,7,0,1,0
13,161,161,32,13,19,2,1
7,215,215,35,35,0,1,0
9,231,231,9,1,8,2,1
5,242,242,38,38,0,1,0
16,267,267,67,31,36,3,2
3,282,282,14,1,13,2,1
11,282,282,7,4,3,2,1
12,302,302,19,16,3,2,1
8,308,308,7,7,0,1,0
19,319,319,50,2,48,2,1
20,345,345,17,17,0,1,0
15,345,345,12,12,0,1,0
0,351,351,60,60,0,1,0
1,353,353,38,31,7,2,1
18,404,404,115,43,72,3,2
14,406,406,57,11,46,3,2
4,444,444,237,237,0,1,0
2,451,451,15,3,12,3,2
6,474,474,42,36,6,2,1
10,498,498,2,2,0,1,0

6,109,109,10,10,0,1,0
23,135,135,24,24,0,1,0
15,142,142,17,17,0,1,0
10,149,149,10,6,4,2,1
22,164,164,16,11,5,2,1
21,164,164,20,7,13,2,1
14,172,172,1,1,0,1,0
17,181,181,1,1,0,1,0
8,192,192,3,3,0,1,0
3,193,193,45,45,0,1,0
9,216,216,26,17,9,2,1
18,234,234,23,7,16,2,1
5,270,270,4,4,0,1,0
19,293,293,11,11,0,1,0
4,293,293,35,32,3,2,1
7,328,328,5,5,0,1,0
0,346,346,128,32,96,4,3
13,347,347,41,31,10,3,2
11,369,369,2,2,0,1,0
16,407,407,140,97,43,2,1
20,407,407,58,42,16,2,1
1,451,451,32,18,14,2,1
2,469,469,88,88,0,1,0
12,500,500,30,7,23,2,1

18,100,100,7,7,0,1,0
25,102,102,24,24,0,1,0
10,105,105,8,8,0,1,0
3,105,105,2,2,0,1,0
8,166,166,1,1,0,1,0
27,192,192,11,11,0,1,0
28,197,197,1,1,0,1,0
22,212,212,55,46,9,4,3
13,214,214,3,3,0,1,0
9,217,217,13,1,12,4,3
5,219,219,23,23,0,1,0
1,253,253,2,2,0,1,0
4,268,268,7,1,6,3,2
11,295,295,29,29,0,1,0
16,298,298,17,17,0,1,0
2,320,320,49,49,0,1,0
12,322,322,48,3,45,2,1
21,330,330,5,5,0,1,0
0,341,341,76,4,72,4,3
6,351,351,52,52,0,1,0
24,365,365,8,8,0,1,0
7,375,375,2,2,0,1,0
19,377,377,29,29,0,1,0
20,409,409,164,164,0,1,0
26,411,411,7,1,6,2,1
23,417,417,27,10,17,2,1
17,428,428,21,3,18,4,3
14,440,440,24,24,0,1,0
15,469,469,73,61,12,2,1

9,104,104,10,10,0,1,0
14,110,110,6,6,0,1,0
21,119,119,23,23,0,1,0
10,140,140,1,1,0,1,0
17,149,149,11,4,7,2,1
6,161,161,12,12,0,1,0
19,206,206,6,6,0,1,0
20,213,213,7,7,0,1,0
0,217,217,38,38,0,1,0
12,218,218,44,34,10,2,1
22,224,224,28,28,0,1,0
1,235,235,35,20,15,2,1
13,244,244,21,21,0,1,0
15,255,255,50,50,0,1,0
7,292,292,25,25,0,1,0
3,312,312,44,44,0,1,0
8,313,313,73,5,68,3,2
18,359,359,44,30,14,4,3
24,385,385,48,26,22,3,2
11,455,455,8,4,4,2,1
5,457,457,68,20,48,3,2
4,458,458,14,7,7,2,1
2,459,459,65,39,26,2,1
23,480,480,4,4,0,1,0
16,482,482,41,5,36,3,2

22,101,101,7,7,0,1,0
13,187,187,9,9,0,1,0
24,192,192,29,11,18,2,1
26,195,195,2,2,0,1,0
11,207,207,7,1,6,3,2
21,211,211,1,1,0,1,0
5,215,215,11,1,10,2,1
2,216,216,90,90,0,1,0
0,219,219,6,2,4,2,1
8,231,231,32,21,11,2,1
16,238,238,6,6,0,1,0
1,260,260,5,5,0,1,0
19,311,311,3,3,0,1,0
23,317,317,77,6,71,4,3
18,338,338,1,1,0,1,0
25,340,340,107,68,39,3,2
15,358,358,36,36,0,1,0
6,358,358,16,16,0,1,0
12,359,359,12,12,0,1,0
3,367,367,1,1,0,1,0
17,378,378,8,8,0,1,0
14,390,390,43,43,0,1,0
10,426,426,25,3,22,3,2
27,430,430,75,75,0,1,0
7,457,457,56,4,52,4,3
9,470,470,11,11,0,1,0
4,473,473,81,60,21,4,3
20,478,478,94,38,56,3,2

5,124,124,39,14,25,2,1
1,152,152,6,6,0,1,0
19,165,165,21,21,0,1,0
13,181,181,31,22,9,4,3
18,182,182,57,24,33,4,3
9,198,198,10,10,0,1,0
3,220,220,25,1,24,4,3
16,221,221,26,12,14,2,1
7,245,245,119,13,106,4,3
11,251,251,22,22,0,1,0
8,261,261,11,7,4,2,1
20,275,275,23,23,0,1,0
6,314,314,37,22,15,4,3
0,343,343,37,37,0,1,0
4,384,384,43,9,34,2,1
15,401,401,4,1,3,2,1
2,407,407,4,4,0,1,0
17,427,427,68,68,0,1,0
10,453,453,3,3,0,1,0
14,478,478,44,39,5,2,1
12,480,480,31,7,24,2,1

2,101,101,18,18,0,1,0
13,142,142,9,9,0,1,0
0,159,159,13,13,0,1,0
10,159,159,8,8,0,1,0
23,202,202,21,5,16,3,2
6,214,214,8,2,6,2,1
4,220,220,69,11,58,4,3
14,290,290,7,7,0,1,0
11,318,318,118,20,98,4,3
22,320,320,9,1,8,3,2
7,335,335,87,10,77,4,3
20,346,346,30,3,27,4,3
21,363,363,11,11,0,1,0
16,370,370,8,8,0,1,0
9,385,385,12,12,0,1,0
18,397,397,46,13,33,4,3
5,410,410,23,14,9,4,3
1,438,438,20,20,0,1,0
12,440,440,5,1,4,2,1
15,444,444,83,31,52,4,3
19,458,458,94,94,0,1,0
3,472,472,17,17,0,1,0
8,484,484,103,7,96,4,3
17,495,495,34,6,28,2,1

5,103,103,2,2,0,1,0
13,114,114,7,7,0,1,0
20,141,141,11,1,10,3,2
6,178,178,1,1,0,1,0
19,206,206,42,42,0,1,0
21,223,223,1,1,0,1,0
2,238,238,12,12,0,1,0
14,241,241,19,3,16,2,1
17,248,248,49,1,48,4,3
4,258,258,29,6,23,4,3
7,269,269,7,7,0,1,0
11,299,299,21,12,9,4,3
8,328,328,191,98,93,4,3
16,332,332,54,39,15,4,3
10,360,360,94,73,21,4,3
12,370,370,6,6,0,1,0
1,389,389,150,132,18,2,1
0,465,465,11,5,6,2,1
18,476,476,56,14,42,4,3
3,482,482,46,46,0,1,0
15,485,485,3,3,0,1,0
9,489,489,34,15,19,2,1

22,106,106,1,1,0,1,0
21,115,115,6,6,0,1,0
4,125,125,4,4,0,1,0
25,129,129,6,6,0,1,0
17,160,160,3,3,0,1,0
5,164,164,1,1,0,1,0
28,165,165,25,25,0,1,0
8,182,182,13,5,8,3,2
6,186,186,25,25,0,1,0
18,189,189,35,35,0,1,0
11,195,195,20,4,16,3,2
0,196,196,6,1,5,2,1
9,268,268,1,1,0,1,0
10,292,292,14,5,9,2,1
13,297,297,75,34,41,3,2
3,298,298,8,8,0,1,0
26,343,343,50,41,9,4,3
2,345,345,18,18,0,1,0
19,364,364,80,80,0,1,0
23,366,366,3,3,0,1,0
1,378,378,1,1,0,1,0
14,418,418,1,1,0,1,0
15,421,421,64,64,0,1,0
27,426,426,12,9,3,2,1
24,430,430,72,72,0,1,0
12,432,432,72,72,0,1,0
16,434,434,55,23,32,3,2
20,436,436,41,31,10,2,1
7,440,440,40,34,6,2,1
29,490,490,97,97,0,1,0

1,108,108,12,3,9,4,3
21,111,111,15,6,9,2,1
32,115,115,2,2,0,1,0
17,154,154,4,4,0,1,0
26,157,157,14,5,9,4,3
12,166,166,7,2,5,2,1
3,182,182,6,6,0,1,0
20,187,187,5,5,0,1,0
2,217,217,8,8,0,1,0
0,266,266,25,7,18,3,2
28,274,274,60,60,0,1,0
15,310,310,28,25,3,2,1
4,316,316,51,21,30,2,1
22,362,362,151,112,39,2,1
13,365,365,41,11,30,4,3
16,375,375,3,3,0,1,0
11,381,381,7,7,0,1,0
9,390,390,13,4,9,4,3
19,411,411,11,11,0,1,0
29,419,419,4,4,0,1,0
23,421,421,44,2,42,4,3
7,422,422,103,103,0,1,0
25,434,434,17,17,0,1,0
24,445,445,41,3,38,2,1
31,448,448,12,5,7,2,1
14,454,454,59,59,0,1,0
8,460,460,1,1,0,1,0
6,466,466,36,12,24,3,2
27,469,469,29,7,22,2,1
18,478,478,22,22,0,1,0
5,479,479,2,2,0,1,0
30,479,479,42,42,0,1,0
10,498,498,2,2,0,1,0

22,103,103,6,6,0,1,0
14,133,133,9,9,0,1,0
20,147,147,15,2,13,4,3
24,149,149,9,6,3,2,1
12,151,151,20,4,16,2,1
6,153,153,10,1,9,3,2
16,174,174,6,6,0,1,0
1,176,176,23,23,0,1,0
21,186,186,57,57,0,1,0
2,196,196,6,6,0,1,0
3,199,199,18,18,0,1,0
0,227,227,39,21,18,3,2
18,229,229,4,4,0,1,0
7,242,242,22,22,0,1,0
15,252,252,17,17,0,1,0
11,256,256,6,6,0,1,0
5,262,262,47,47,0,1,0
10,287,287,27,27,0,1,0
13,294,294,28,28,0,1,0
17,332,332,11,8,3,2,1
4,367,367,87,55,32,3,2
9,371,371,9,9,0,1,0
23,414,414,15,15,0,1,0
8,474,474,77,63,14,2,1
19,493,493,161,161,0,1,0

17,107,107,2,2,0,1,0
15,126,126,39,39,0,1,0
16,143,143,33,33,0,1,0
23,178,178,13,13,0,1,0
9,186,186,64,36,28,2,1
13,200,200,5,1,4,2,1
21,211,211,11,6,5,2,1
5,214,214,37,33,4,2,1
4,238,238,12,12,0,1,0
1,276,276,26,20,6,3,2
10,318,318,26,2,24,4,3
2,318,318,4,4,0,1,0
12,329,329,50,10,40,4,3
19,333,333,16,1,15,2,1
20,367,367,20,5,15,4,3
8,373,373,43,43,0,1,0
18,382,382,29,29,0,1,0
11,389,389,38,2,36,4,3
22,401,401,20,17,3,2,1
6,419,419,35,10,25,2,1
0,432,432,1,1,0,1,0
14,438,438,60,12,48,3,2
3,468,468,140,51,89,4,3
7,496,496,22,4,18,2,1

23,112,112,19,1,18,2,1
1,118,118,16,1,15,4,3
2,187,187,2,2,0,1,0
15,203,203,1,1,0,1,0
9,207,207,2,2,0,1,0
7,209,209,18,12,6,2,1
0,210,210,11,2,9,2,1
19,224,224,10,10,0,1,0
10,242,242,127,127,0,1,0
13,242,242,54,17,37,4,3
22,260,260,14,14,0,1,0
6,271,271,29,24,5,2,1
5,284,284,31,13,18,3,2
12,294,294,3,3,0,1,0
17,304,304,15,3,12,3,2
18,312,312,62,32,30,2,1
16,349,349,32,2,30,3,2
8,380,380,17,11,6,3,2
11,387,387,156,156,0,1,0
14,392,392,17,17,0,1,0
4,421,421,23,23,0,1,0
21,480,480,6,2,4,2,1
3,489,489,82,61,21,4,3
20,498,498,11,11,0,1,0

7,121,121,17,17,0,1,0
4,123,123,98,81,17,2,1
1,162,162,2,2,0,1,0
3,185,185,3,3,0,1,0
2,199,199,39,39,0,1,0
9,206,206,28,23,5,2,1
6,232,232,2,2,0,1,0
19,239,239,43,16,27,4,3
12,253,253,58,58,0,1,0
15,308,308,6,6,0,1,0
8,308,308,11,1,10,3,2
20,375,375,68,19,49,4,3
11,377,377,42,42,0,1,0
10,384,384,37,37,0,1,0
16,407,407,11,11,0,1,0
0,424,424,55,55,0,1,0
14,425,425,50,5,45,4,3
5,431,431,2,2,0,1,0
18,485,485,6,6,0,1,0
13,490,490,40,29,11,2,1
17,498,498,46,46,0,1,0

9,117,117,13,5,8,2,1
18,119,119,2,2,0,1,0
15,127,127,29,24,5,2,1
11,135,135,14,14,0,1,0
5,139,139,7,7,0,1,0
8,140,140,4,4,0,1,0
3,168,168,1,1,0,1,0
25,182,182,6,6,0,1,0
4,186,186,46,33,13,4,3
6,186,186,12,1,11,2,1
24,202,202,53,23,30,4,3
21,207,207,3,3,0,1,0
0,208,208,3,3,0,1,0
13,227,227,54,29,25,2,1
16,233,233,4,4,0,1,0
17,262,262,23,15,8,2,1
12,291,291,52,52,0,1,0
26,295,295,1,1,0,1,0
14,296,296,5,5,0,1,0
2,309,309,27,27,0,1,0
10,315,315,19,19,0,1,0
23,337,337,73,3,70,3,2
7,347,347,22,10,12,2,1
22,392,392,10,1,9,4,3
20,398,398,133,133,0,1,0
1,429,429,13,5,8,3,2
19,483,483,7,7,0,1,0
27,490,490,33,27,6,3,2

21,105,105,6,6,0,1,0
22,143,143,7,2,5,2,1
20,191,191,39,1,38,3,2
13,196,196,7,3,4,2,1
4,205,205,7,3,4,2,1
3,222,222,24,3,21,4,3
16,242,242,90,90,0,1,0
19,265,265,21,21,0,1,0
24,277,277,11,11,0,1,0
12,292,292,59,26,33,4,3
0,333,333,162,115,47,2,1
5,347,347,13,13,0,1,0
25,350,350,32,32,0,1,0
14,355,355,62,53,9,4,3
15,359,359,36,36,0,1,0
7,375,375,2,2,0,1,0
2,393,393,11,11,0,1,0
9,399,399,3,3,0,1,0
1,410,410,30,30,0,1,0
8,428,428,24,24,0,1,0
23,435,435,32,32,0,1,0
17,441,441,21,6,15,2,1
10,447,447,9,5,4,2,1
18,481,481,2,2,0,1,0
6,495,495,1,1,0,1,0
11,497,497,120,98,22,2,1

17,118,118,13,13,0,1,0
21,121,121,7,2,5,2,1
9,123,123,5,5,0,1,0
5,149,149,4,4,0,1,0
15,172,172,8,8,0,1,0
4,199,199,5,5,0,1,0
23,215,215,23,15,8,2,1
0,232,232,9,9,0,1,0
19,236,236,18,2,16,3,2
8,260,260,18,18,0,1,0
16,262,262,9,9,0,1,0
10,265,265,3,3,0,1,0
22,281,281,71,20,51,4,3
12,285,285,72,58,14,3,2
2,291,291,72,50,22,2,1
24,308,308,21,21,0,1,0
25,320,320,57,25,32,2,1
18,333,333,7,7,0,1,0
7,340,340,5,2,3,2,1
3,374,374,196,196,0,1,0
11,385,385,11,11,0,1,0
6,390,390,6,6,0,1,0
1,436,436,3,3,0,1,0
14,466,466,56,35,21,2,1
20,468,468,16,16,0,1,0
13,470,470,100,57,43,4,3

6,106,106,8,8,0,1,0
3,165,165,9,1,8,3,2
24,172,172,17,13,4,2,1
7,180,180,5,5,0,1,0
1,184,184,8,2,6,2,1
5,195,195,32,32,0,1,0
18,196,196,35,35,0,1,0
9,205,205,34,34,0,1,0
2,220,220,37,27,10,3,2
10,222,222,17,17,0,1,0
25,254,254,38,38,0,1,0
4,257,257,1,1,0,1,0
12,258,258,46,46,0,1,0
22,275,275,10,10,0,1,0
11,278,278,72,63,9,2,1
8,314,314,26,16,10,3,2
19,333,333,2,2,0,1,0
16,334,334,52,52,0,1,0
0,335,335,1,1,0,1,0
13,357,357,35,35,0,1,0
15,361,361,8,8,0,1,0
21,385,385,32,14,18,4,3
23,415,415,99,56,43,4,3
17,445,445,3,3,0,1,0
14,453,453,3,3,0,1,0
20,493,493,117,40,77,4,3

28,102,102,10,2,8,3,2
8,120,120,3,3,0,1,0
4,130,130,7,1,6,3,2
17,132,132,9,1,8,2,1
15,147,147,7,7,0,1,0
9,154,154,2,2,0,1,0
5,187,187,1,1,0,1,0
12,191,191,1,1,0,1,0
29,200,200,6,6,0,1,0
16,210,210,19,5,14,3,2
31,212,212,10,10,0,1,0
27,251,251,9,9,0,1,0
10,253,253,12,9,3,2,1
3,255,255,22,22,0,1,0
19,267,267,6,6,0,1,0
32,269,269,138,138,0,1,0
11,276,276,26,26,0,1,0
6,298,298,14,14,0,1,0
2,299,299,22,22,0,1,0
7,309,309,1,1,0,1,0
33,335,335,107,48,59,4,3
23,335,335,40,40,0,1,0
26,344,344,24,24,0,1,0
25,347,347,11,2,9,2,1
34,355,355,3,3,0,1,0
0,374,374,3,3,0,1,0
30,380,380,4,4,0,1,0
20,400,400,41,41,0,1,0
22,412,412,12,12,0,1,0
1,417,417,4,4,0,1,0
18,455,455,10,10,0,1,0
24,462,462,2,2,0,1,0
14,462,462,85,85,0,1,0
13,478,478,54,45,9,2,1
21,484,484,87,87,0,1,0

5,132,132,11,11,0,1,0
3,133,133,10,10,0,1,0
10,148,148,12,12,0,1,0
16,160,160,3,3,0,1,0
27,175,175,15,15,0,1,0
32,179,179,6,1,5,2,1
23,185,185,33,33,0,1,0
11,190,190,15,15,0,1,0
15,201,201,24,6,18,2,1
6,201,201,2,2,0,1,0
14,201,201,21,8,13,2,1
4,232,232,4,4,0,1,0
31,243,243,27,1,26,3,2
33,245,245,34,34,0,1,0
22,250,250,102,46,56,3,2
18,261,261,5,5,0,1,0
20,263,263,1,1,0,1,0
12,279,279,7,7,0,1,0
1,290,290,10,10,0,1,0
28,292,292,30,7,23,4,3
30,294,294,23,23,0,1,0
2,300,300,16,16,0,1,0
0,317,317,4,4,0,1,0
25,346,346,4,4,0,1,0
21,366,366,97,97,0,1,0
17,374,374,9,9,0,1,0
9,377,377,6,6,0,1,0
13,393,393,7,7,0,1,0
24,400,400,13,13,0,1,0
7,410,410,38,10,28,4,3
34,414,414,32,32,0,1,0
8,415,415,28,6,22,3,2
26,430,430,16,16,0,1,0
29,473,473,15,15,0,1,0
19,498,498,40,16,24,3,2

11,103,103,2,2,0,1,0
4,114,114,5,5,0,1,0
3,115,115,11,2,9,4,3
2,124,124,9,9,0,1,0
0,145,145,21,21,0,1,0
21,189,189,36,30,6,3,2
7,210,210,17,5,12,3,2
23,214,214,59,25,34,2,1
18,289,289,19,1,18,4,3
13,301,301,47,6,41,2,1
10,308,308,1,1,0,1,0
9,344,344,64,6,58,4,3
26,353,353,29,29,0,1,0
22,354,354,71,1,70,3,2
8,367,367,32,32,0,1,0
19,373,373,25,4,21,2,1
12,376,376,8,8,0,1,0
6,383,383,28,28,0,1,0
24,391,391,28,15,13,2,1
25,401,401,17,5,12,3,2
15,414,414,5,2,3,2,1
20,424,424,10,3,7,2,1
17,428,428,43,43,0,1,0
14,459,459,30,3,27,4,3
16,469,469,60,10,50,3,2
5,469,469,100,49,51,4,3
1,496,496,52,52,0,1,0

8,132,132,56,8,48,4,3
4,181,181,37,31,6,3,2
0,188,188,4,4,0,1,0
16,188,188,3,3,0,1,0
20,202,202,69,42,27,4,3
17,239,239,7,7,0,1,0
11,240,240,50,50,0,1,0
5,247,247,29,10,19,2,1
3,266,266,34,10,24,2,1
21,285,285,26,26,0,1,0
2,287,287,43,3,40,4,3
14,291,291,7,7,0,1,0
10,311,311,14,6,8,3,2
18,327,327,47,17,30,2,1
6,355,355,68,32,36,4,3
1,361,361,12,8,4,2,1
9,403,403,22,1,21,2,1
7,427,427,15,15,0,1,0
19,439,439,46,2,44,3,2
15,441,441,61,31,30,2,1
13,457,457,17,8,9,4,3
12,473,473,42,42,0,1,0

4,106,106,11,5,6,3,2
19,112,112,7,7,0,1,0
20,114,114,15,15,0,1,0
1,129,129,19,19,0,1,0
15,137,137,1,1,0,1,0
2,149,149,8,8,0,1,0
12,164,164,2,2,0,1,0
28,204,204,19,19,0,1,0
23,220,220,18,4,14,2,1
17,225,225,57,57,0,1,0
29,231,231,11,1,10,3,2
21,246,246,59,49,10,2,1
26,249,249,10,10,0,1,0
22,265,265,1,1,0,1,0
16,274,274,2,2,0,1,0
25,275,275,79,40,39,4,3
7,278,278,7,7,0,1,0
6,289,289,64,64,0,1,0
0,292,292,6,6,0,1,0
18,301,301,10,1,9,4,3
9,331,331,3,3,0,1,0
3,350,350,5,5,0,1,0
13,366,366,116,82,34,3,2
11,407,407,79,79,0,1,0
14,428,428,20,20,0,1,0
8,438,438,23,23,0,1,0
5,445,445,7,1,6,2,1
24,469,469,8,8,0,1,0
10,476,476,25,7,18,3,2
27,481,481,20,6,14,3,2

6,124,124,2,2,0,1,0
12,145,145,10,4,6,3,2
9,166,166,2,2,0,1,0
16,167,167,2,2,0,1,0
11,176,176,42,32,10,3,2
8,182,182,30,18,12,4,3
7,184,184,39,19,20,2,1
0,184,184,36,9,27,4,3
21,217,217,40,10,30,2,1
14,222,222,9,9,0,1,0
3,233,233,2,2,0,1,0
18,249,249,5,5,0,1,0
10,249,249,19,14,5,2,1
2,270,270,85,39,46,2,1
17,323,323,15,15,0,1,0
20,336,336,23,6,17,2,1
19,374,374,87,33,54,4,3
22,389,389,40,34,6,2,1
4,399,399,23,23,0,1,0
15,443,443,40,40,0,1,0
1,447,447,68,20,48,4,3
13,465,465,66,66,0,1,0
5,471,471,80,80,0,1,0

16,107,107,9,2,7,2,1
2,109,109,11,11,0,1,0
6,140,140,1,1,0,1,0
15,152,152,62,50,12,4,3
25,158,158,26,14,12,2,1
18,197,197,37,17,20,3,2
9,200,200,27,27,0,1,0
14,200,200,6,6,0,1,0
20,202,202,21,21,0,1,0
23,225,225,38,38,0,1,0
10,243,243,50,50,0,1,0
7,247,247,1,1,0,1,0
27,293,293,6,6,0,1,0
22,313,313,49,49,0,1,0
28,317,317,38,38,0,1,0
8,366,366,20,20,0,1,0
13,401,401,9,6,3,2,1
4,403,403,32,20,12,2,1
26,427,427,67,28,39,3,2
11,432,432,23,23,0,1,0
1,433,433,8,4,4,2,1
17,444,444,15,15,0,1,0
24,446,446,18,6,12,4,3
12,448,448,6,6,0,1,0
5,458,458,2,2,0,1,0
19,464,464,34,34,0,1,0
3,475,475,32,4,28,3,2
0,476,476,46,46,0,1,0
21,499,499,8,8,0,1,0

3,116,116,12,12,0,1,0
28,138,138,11,11,0,1,0
25,145,145,14,2,12,2,1
24,152,152,27,27,0,1,0
27,187,187,13,4,9,2,1
6,219,219,55,9,46,4,3
2,220,220,3,3,0,1,0
23,224,224,23,23,0,1,0
4,252,252,3,3,0,1,0
19,252,252,28,7,21,2,1
7,255,255,15,15,0,1,0
5,278,278,9,9,0,1,0
16,295,295,29,10,19,2,1
30,296,296,92,67,25,2,1
17,315,315,20,20,0,1,0
8,330,330,6,1,5,2,1
22,333,333,19,19,0,1,0
12,333,333,8,8,0,1,0
20,358,358,64,27,37,2,1
29,360,360,20,20,0,1,0
11,369,369,4,4,0,1,0
14,380,380,65,56,9,4,3
10,391,391,10,7,3,2,1
13,400,400,2,2,0,1,0
9,408,408,2,2,0,1,0
0,411,411,24,7,17,2,1
21,439,439,23,5,18,3,2
26,448,448,5,5,0,1,0
18,450,450,9,9,0,1,0
15,474,474,37,1,36,2,1
1,476,476,129,123,6,3,2

0,105,105,1,1,0,1,0
23,111,111,4,4,0,1,0
14,129,129,2,2,0,1,0
8,152,152,22,9,13,2,1
13,170,170,28,7,21,4,3
19,184,184,3,3,0,1,0
16,189,189,18,3,15,2,1
9,203,203,1,1,0,1,0
11,210,210,74,35,39,4,3
15,214,214,2,2,0,1,0
1,247,247,34,18,16,3,2
3,280,280,6,1,5,2,1
22,311,311,18,18,0,1,0
24,313,313,115,89,26,3,2
18,383,383,53,53,0,1,0
17,389,389,61,61,0,1,0
10,404,404,10,10,0,1,0
21,414,414,42,42,0,1,0
12,419,419,19,2,17,4,3
5,457,457,34,22,12,4,3
20,464,464,59,59,0,1,0
7,471,471,155,155,0,1,0
6,482,482,47,8,39,4,3
2,485,485,41,20,21,2,1
4,494,494,10,10,0,1,0

25,100,100,7,7,0,1,0
26,107,107,1,1,0,1,0
5,111,111,19,19,0,1,0
2,114,114,5,5,0,1,0
24,120,120,4,4,0,1,0
3,128,128,8,8,0,1,0
12,137,137,7,7,0,1,0
8,160,160,15,15,0,1,0
7,182,182,15,15,0,1,0
0,195,195,3,3,0,1,0
6,206,206,12,3,9,2,1
9,254,254,22,22,0,1,0
22,255,255,16,6,10,3,2
13,278,278,21,6,15,4,3
15,281,281,3,3,0,1,0
21,285,285,5,1,4,2,1
29,291,291,45,10,35,4,3
16,301,301,23,15,8,2,1
28,342,342,10,10,0,1,0
30,344,344,20,4,16,3,2
1,349,349,34,6,28,3,2
20,367,367,36,36,0,1,0
27,370,370,20,6,14,2,1
19,379,379,140,107,33,2,1
10,389,389,32,28,4,2,1
17,394,394,49,29,20,3,2
11,398,398,10,10,0,1,0
23,430,430,67,67,0,1,0
18,469,469,98,98,0,1,0
4,485,485,40,40,0,1,0
14,493,493,30,30,0,1,0

23,100,100,6,6,0,1,0
0,112,112,3,3,0,1,0
6,115,115,15,15,0,1,0
11,124,124,16,16,0,1,0
22,133,133,7,7,0,1,0
4,158,158,4,4,0,1,0
5,176,176,6,6,0,1,0
2,187,187,25,25,0,1,0
12,209,209,10,10,0,1,0
26,212,212,53,53,0,1,0
9,228,228,1,1,0,1,0
19,251,251,24,6,18,4,3
24,253,253,57,57,0,1,0
13,269,269,49,9,40,2,1
25,270,270,19,19,0,1,0
15,272,272,6,6,0,1,0
27,279,279,36,24,12,4,3
1,283,283,12,6,6,3,2
21,319,319,28,28,0,1,0
18,325,325,52,35,17,2,1
20,352,352,29,18,11,2,1
17,408,408,4,4,0,1,0
8,442,442,76,70,6,2,1
10,458,458,77,67,10,2,1
7,474,474,12,12,0,1,0
3,474,474,58,58,0,1,0
14,493,493,28,28,0,1,0
16,500,500,46,17,29,3,2

9,118,118,26,8,18,4,3
1,129,129,20,6,14,3,2
12,137,137,4,4,0,1,0
16,156,156,9,9,0,1,0
21,168,168,24,3,21,3,2
24,183,183,41,11,30,4,3
10,201,201,23,11,12,4,3
17,215,215,32,4,28,3,2
20,251,251,18,6,12,2,1
18,251,251,9,9,0,1,0
14,279,279,25,5,20,2,1
3,296,296,48,13,35,2,1
27,323,323,11,5,6,3,2
28,333,333,41,32,9,2,1
2,338,338,1,1,0,1,0
23,341,341,24,12,12,3,2
7,347,347,11,6,5,2,1
6,364,364,1,1,0,1,0
4,374,374,19,1,18,3,2
11,381,381,42,4,38,2,1
25,397,397,5,5,0,1,0
13,400,400,3,3,0,1,0
26,402,402,56,46,10,2,1
22,420,420,54,8,46,4,3
15,421,421,87,27,60,3,2
8,439,439,2,2,0,1,0
0,489,489,25,13,12,3,2
5,499,499,31,31,0,1,0
19,499,499,66,30,36,3,2

4,122,122,10,10,0,1,0
2,131,131,7,7,0,1,0
11,136,136,14,14,0,1,0
14,144,144,24,24,0,1,0
3,154,154,29,17,12,3,2
21,177,177,8,8,0,1,0
18,210,210,1,1,0,1,0
9,210,210,17,17,0,1,0
19,225,225,24,24,0,1,0
6,231,231,20,20,0,1,0
13,250,250,34,34,0,1,0
0,295,295,6,6,0,1,0
7,344,344,47,27,20,2,1
22,364,364,22,22,0,1,0
15,384,384,25,5,20,2,1
20,396,396,43,1,42,4,3
1,397,397,240,240,0,1,0
12,421,421,14,5,9,2,1
17,431,431,61,7,54,4,3
16,435,435,111,42,69,4,3
10,445,445,45,45,0,1,0
8,449,449,11,11,0,1,0
5,496,496,13,13,0,1,0

19,113,113,7,4,3,2,1
14,125,125,4,4,0,1,0
13,190,190,5,5,0,1,0
3,193,193,15,15,0,1,0
11,196,196,50,29,21,2,1
20,197,197,33,33,0,1,0
8,198,198,29,5,24,4,3
7,206,206,28,28,0,1,0
9,222,222,30,24,6,3,2
18,254,254,38,29,9,4,3
21,257,257,23,23,0,1,0
17,283,283,4,4,0,1,0
5,304,304,26,7,19,4,3
15,332,332,15,15,0,1,0
16,338,338,59,59,0,1,0
4,339,339,47,20,27,4,3
2,347,347,74,74,0,1,0
22,399,399,1,1,0,1,0
0,443,443,76,28,48,3,2
6,457,457,39,39,0,1,0
10,467,467,63,63,0,1,0
1,475,475,53,9,44,2,1
12,492,492,91,3,88,3,2

10,101,101,4,1,3,2,1
13,120,120,16,4,12,3,2
3,165,165,9,9,0,1,0
4,167,167,8,1,7,3,2
16,182,182,7,7,0,1,0
22,187,187,15,1,14,2,1
11,194,194,34,34,0,1,0
14,196,196,14,8,6,3,2
24,196,196,40,40,0,1,0
26,214,214,25,25,0,1,0
12,215,215,16,16,0,1,0
25,217,217,13,13,0,1,0
0,236,236,9,6,3,2,1
23,289,289,4,4,0,1,0
21,290,290,21,6,15,4,3
1,304,304,17,17,0,1,0
9,330,330,63,26,37,2,1
6,356,356,75,3,72,3,2
18,375,375,7,7,0,1,0
5,376,376,6,3,3,2,1
2,387,387,8,2,6,2,1
20,394,394,35,11,24,3,2
7,397,397,7,2,5,2,1
8,442,442,69,38,31,2,1
17,446,446,58,6,52,3,2
19,461,461,74,10,64,3,2
15,471,471,86,3,83,4,3
27,474,474,75,75,0,1,0

0,106,106,3,3,0,1,0
9,115,115,9,3,6,3,2
27,128,128,3,3,0,1,0
3,139,139,2,2,0,1,0
23,143,143,5,5,0,1,0
12,156,156,6,6,0,1,0
18,160,160,15,15,0,1,0
20,252,252,8,2,6,2,1
10,263,263,15,15,0,1,0
4,266,266,1,1,0,1,0
24,282,282,32,32,0,1,0
28,282,282,6,6,0,1,0
13,284,284,64,52,12,4,3
26,293,293,5,5,0,1,0
5,301,301,44,6,38,3,2
2,313,313,26,12,14,2,1
1,320,320,2,2,0,1,0
22,339,339,19,7,12,3,2
21,340,340,76,76,0,1,0
8,342,342,3,3,0,1,0
14,368,368,10,4,6,2,1
11,392,392,32,23,9,2,1
15,416,416,42,10,32,2,1
16,431,431,70,19,51,4,3
19,443,443,104,52,52,3,2
29,447,447,82,61,21,4,3
25,460,460,79,79,0,1,0
17,473,473,49,10,39,2,1
7,478,478,22,22,0,1,0
6,487,487,44,35,9,4,3
30,494,494,59,45,14,2,1

0,120,120,22,22,0,1,0
6,121,121,25,25,0,1,0
15,124,124,34,34,0,1,0
18,132,132,5,5,0,1,0
25,169,169,24,24,0,1,0
2,173,173,3,3,0,1,0
20,176,176,18,18,0,1,0
17,238,238,1,1,0,1,0
23,239,239,2,2,0,1,0
19,253,253,29,17,12,4,3
9,259,259,39,9,30,4,3
4,261,261,7,7,0,1,0
8,275,275,16,4,12,4,3
22,300,300,3,3,0,1,0
5,311,311,16,16,0,1,0
7,325,325,15,6,9,4,3
12,334,334,27,22,5,2,1
21,345,345,65,38,27,2,1
11,395,395,2,2,0,1,0
16,419,419,66,66,0,1,0
1,432,432,60,51,9,4,3
26,437,437,46,24,22,3,2
13,442,442,3,3,0,1,0
14,466,466,71,41,30,4,3
24,467,467,44,12,32,2,1
3,476,476,15,11,4,2,1
10,484,484,70,67,3,2,1
27,495,495,44,2,42,4,3

0,133,133,27,27,0,1,0
22,142,142,17,11,6,3,2
15,177,177,2,2,0,1,0
9,191,191,17,17,0,1,0
27,191,191,4,4,0,1,0
3,212,212,16,3,13,2,1
8,212,212,64,64,0,1,0
6,218,218,8,8,0,1,0
21,248,248,124,46,78,4,3
7,251,251,11,3,8,3,2
24,283,283,19,10,9,2,1
13,292,292,16,16,0,1,0
10,304,304,28,12,16,3,2
16,306,306,5,5,0,1,0
26,316,316,12,12,0,1,0
4,317,317,2,2,0,1,0
23,327,327,31,31,0,1,0
1,334,334,4,4,0,1,0
11,337,337,63,63,0,1,0
28,394,394,53,5,48,4,3
19,414,414,27,27,0,1,0
20,423,423,18,10,8,3,2
12,427,427,24,24,0,1,0
5,437,437,21,21,0,1,0
18,452,452,19,13,6,2,1
29,458,458,28,4,24,3,2
2,459,459,12,5,7,2,1
17,463,463,51,51,0,1,0
25,487,487,13,13,0,1,0
14,495,495,21,21,0,1,0

24,103,103,1,1,0,1,0
23,117,117,10,2,8,3,2
12,191,191,5,5,0,1,0
10,201,201,16,10,6,2,1
20,215,215,50,2,48,4,3
18,257,257,12,7,5,2,1
21,264,264,38,38,0,1,0
13,271,271,85,1,84,4,3
16,273,273,26,14,12,4,3
17,279,279,68,68,0,1,0
19,288,288,5,2,3,2,1
3,294,294,14,14,0,1,0
1,294,294,27,27,0,1,0
5,346,346,84,84,0,1,0
14,355,355,12,7,5,2,1
9,390,390,87,65,22,2,1
4,394,394,28,18,10,3,2
8,407,407,12,12,0,1,0
22,413,413,16,1,15,3,2
11,422,422,37,37,0,1,0
15,424,424,16,2,14,3,2
2,465,465,91,15,76,3,2
6,480,480,67,39,28,2,1
0,487,487,32,32,0,1,0
7,493,493,13,13,0,1,0

3,106,106,11,11,0,1,0
22,106,106,4,4,0,1,0
16,114,114,13,13,0,1,0
10,122,122,18,1,17,4,3
23,132,132,12,12,0,1,0
0,190,190,50,19,31,2,1
12,220,220,14,11,3,2,1
2,245,245,5,5,0,1,0
18,248,248,68,51,17,2,1
5,261,261,57,19,38,3,2
11,269,269,42,26,16,3,2
4,273,273,53,53,0,1,0
13,307,307,6,6,0,1,0
14,318,318,9,2,7,2,1
15,337,337,122,76,46,2,1
24,346,346,16,4,12,4,3
25,365,365,28,28,0,1,0
9,374,374,6,3,3,2,1
1,385,385,1,1,0,1,0
7,388,388,23,13,10,4,3
19,396,396,29,29,0,1,0
6,397,397,11,11,0,1,0
21,406,406,29,2,27,4,3
8,445,445,13,13,0,1,0
17,467,467,31,25,6,2,1
20,486,486,30,30,0,1,0

17,130,130,11,1,10,3,2
2,143,143,12,12,0,1,0
1,152,152,6,2,4,2,1
3,166,166,5,5,0,1,0
16,197,197,26,26,0,1,0
4,209,209,2,2,0,1,0
9,209,209,89,89,0,1,0
23,223,223,11,1,10,2,1
14,248,248,43,43,0,1,0
20,279,279,24,5,19,4,3
5,289,289,46,40,6,2,1
0,297,297,1,1,0,1,0
13,346,346,2,2,0,1,0
22,356,356,24,24,0,1,0
11,360,360,42,42,0,1,0
15,360,360,16,16,0,1,0
12,375,375,97,97,0,1,0
8,378,378,26,26,0,1,0
18,384,384,5,5,0,1,0
10,405,405,106,82,24,2,1
7,407,407,30,9,21,4,3
6,424,424,62,62,0,1,0
19,434,434,64,19,45,4,3
21,435,435,62,62,0,1,0

19,114,114,43,43,0,1,0
7,117,117,9,9,0,1,0
5,134,134,13,5,8,3,2
21,147,147,3,3,0,1,0
0,149,149,28,6,22,3,2
23,156,156,1,1,0,1,0
1,184,184,3,3,0,1,0
14,208,208,3,3,0,1,0
17,214,214,9,9,0,1,0
9,220,220,24,12,12,4,3
16,239,239,14,6,8,2,1
26,242,242,33,1,32,2,1
18,250,250,6,1,5,2,1
6,289,289,7,7,0,1,0
10,293,293,14,14,0,1,0
4,315,315,21,3,18,3,2
22,327,327,21,21,0,1,0
25,383,383,25,25,0,1,0
11,393,393,8,8,0,1,0
13,397,397,71,36,35,2,1
12,402,402,79,3,76,3,2
2,432,432,1,1,0,1,0
15,438,438,95,78,17,2,1
20,467,467,89,89,0,1,0
8,480,480,100,70,30,4,3
24,491,491,57,11,46,3,2
3,493,493,34,18,16,3,2

32,107,107,26,3,23,3,2
18,108,108,3,3,0,1,0
22,112,112,5,1,4,2,1
26,134,134,3,3,0,1,0
2,141,141,1,1,0,1,0
1,142,142,11,11,0,1,0
3,144,144,1,1,0,1,0
29,145,145,17,5,12,2,1
23,148,148,43,4,39,2,1
28,164,164,7,4,3,2,1
15,172,172,12,12,0,1,0
10,177,177,2,2,0,1,0
4,178,178,3,3,0,1,0
14,210,210,50,50,0,1,0
11,218,218,5,5,0,1,0
12,220,220,22,22,0,1,0
20,226,226,2,2,0,1,0
6,238,238,7,2,5,2,1
21,241,241,2,2,0,1,0
24,257,257,3,3,0,1,0
9,282,282,52,52,0,1,0
0,283,283,13,3,10,3,2
17,317,317,9,4,5,2,1
31,361,361,123,60,63,4,3
7,365,365,36,36,0,1,0
16,371,371,52,52,0,1,0
30,372,372,8,3,5,2,1
25,383,383,56,19,37,2,1
19,422,422,13,13,0,1,0
27,435,435,14,8,6,2,1
5,450,450,6,6,0,1,0
8,469,469,3,3,0,1,0
13,484,484,70,70,0,1,0

19,109,109,7,1,6,3,2
21,118,118,2,2,0,1,0
16,119,119,1,1,0,1,0
2,164,164,7,7,0,1,0
14,177,177,5,5,0,1,0
15,186,186,15,15,0,1,0
10,212,212,17,17,0,1,0
13,214,214,12,5,7,2,1
7,294,294,15,7,8,3,2
22,329,329,14,4,10,2,1
4,347,347,1,1,0,1,0
11,358,358,11,11,0,1,0
18,367,367,38,38,0,1,0
25,372,372,52,43,9,4,3
23,390,390,103,55,48,4,3
9,397,397,24,24,0,1,0
20,411,411,129,117,12,3,2
24,413,413,45,45,0,1,0
1,419,419,11,6,5,2,1
5,443,443,87,35,52,3,2
8,447,447,22,22,0,1,0
12,452,452,23,23,0,1,0
3,483,483,66,12,54,4,3
17,492,492,48,3,45,2,1
6,492,492,272,177,95,4,3
0,494,494,10,10,0,1,0

13,148,148,10,10,0,1,0
14,156,156,4,4,0,1,0
30,159,159,60,6,54,3,2
8,176,176,40,4,36,2,1
19,182,182,8,8,0,1,0
5,187,187,2,2,0,1,0
17,199,199,7,7,0,1,0
15,199,199,1,1,0,1,0
20,201,201,14,14,0,1,0
23,213,213,47,23,24,4,3
11,232,232,8,8,0,1,0
3,237,237,7,7,0,1,0
21,247,247,3,3,0,1,0
25,257,257,4,4,0,1,0
0,265,265,19,19,0,1,0
7,266,266,4,4,0,1,0
18,271,271,102,60,42,4,3
26,293,293,39,39,0,1,0
24,302,302,37,19,18,2,1
9,334,334,20,3,17,2,1
31,356,356,3,3,0,1,0
22,368,368,60,60,0,1,0
2,368,368,29,19,10,3,2
28,379,379,3,3,0,1,0
27,389,389,3,3,0,1,0
12,403,403,51,51,0,1,0
16,421,421,47,26,21,2,1
10,421,421,1,1,0,1,0
4,479,479,4,4,0,1,0
1,486,486,6,6,0,1,0
29,489,489,71,71,0,1,0
6,491,491,1,1,0,1,0

12,108,108,5,5,0,1,0
13,115,115,2,2,0,1,0
23,125,125,9,9,0,1,0
4,187,187,28,28,0,1,0
20,199,199,51,45,6,3,2
21,214,214,76,30,46,3,2
22,215,215,1,1,0,1,0
18,223,223,29,14,15,2,1
10,245,245,10,10,0,1,0
6,251,251,12,12,0,1,0
15,280,280,21,1,20,2,1
8,307,307,46,5,41,2,1
0,312,312,5,5,0,1,0
1,313,313,13,10,3,2,1
14,323,323,22,22,0,1,0
2,327,327,60,60,0,1,0
17,352,352,41,32,9,2,1
5,354,354,107,80,27,4,3
19,359,359,13,13,0,1,0
7,387,387,64,18,46,3,2
24,394,394,34,34,0,1,0
16,400,400,24,24,0,1,0
3,457,457,9,3,6,2,1
11,475,475,84,58,26,2,1
9,498,498,4,4,0,1,0

2,123,123,22,22,0,1,0
25,124,124,14,14,0,1,0
17,126,126,8,8,0,1,0
21,128,128,1,1,0,1,0
10,158,158,2,2,0,1,0
1,187,187,6,6,0,1,0
7,227,227,5,2,3,2,1
4,232,232,42,42,0,1,0
19,240,240,39,5,34,3,2
0,256,256,27,18,9,4,3
14,263,263,53,26,27,4,3
16,282,282,16,3,13,2,1
22,326,326,77,77,0,1,0
8,327,327,6,2,4,2,1
11,339,339,37,16,21,2,1
9,378,378,15,15,0,1,0
13,385,385,5,5,0,1,0
6,421,421,147,147,0,1,0
26,424,424,7,7,0,1,0
20,436,436,135,27,108,4,3
12,448,448,22,22,0,1,0
15,452,452,7,2,5,2,1
3,463,463,30,13,17,2,1
18,473,473,36,36,0,1,0
24,482,482,24,24,0,1,0
5,484,484,61,33,28,3,2
23,495,495,10,10,0,1,0

15,121,121,2,2,0,1,0
20,156,156,9,2,7,2,1
13,181,181,2,2,0,1,0
9,186,186,82,60,22,2,1
7,195,195,6,6,0,1,0
12,231,231,65,8,57,4,3
14,243,243,5,5,0,1,0
1,246,246,10,5,5,2,1
19,278,278,17,11,6,3,2
18,297,297,5,5,0,1,0
11,317,317,11,11,0,1,0
2,320,320,22,22,0,1,0
21,325,325,21,1,20,2,1
6,344,344,122,53,69,4,3
5,354,354,39,6,33,4,3
4,355,355,94,42,52,4,3
3,360,360,9,9,0,1,0
10,369,369,74,60,14,2,1
17,398,398,25,25,0,1,0
16,399,399,21,1,20,3,2
8,404,404,85,85,0,1,0
0,435,435,85,66,19,2,1

12,134,134,33,23,10,4,3
5,143,143,2,2,0,1,0
2,154,154,5,2,3,2,1
15,166,166,23,23,0,1,0
22,173,173,26,26,0,1,0
17,177,177,1,1,0,1,0
1,189,189,4,4,0,1,0
6,219,219,1,1,0,1,0
18,220,220,18,3,15,2,1
9,237,237,54,6,48,4,3
8,254,254,1,1,0,1,0
19,272,272,22,22,0,1,0
24,274,274,4,4,0,1,0
10,276,276,11,11,0,1,0
16,307,307,88,60,28,3,2
13,326,326,10,3,7,2,1
3,368,368,36,36,0,1,0
4,387,387,38,28,10,3,2
11,406,406,107,107,0,1,0
20,421,421,9,1,8,3,2
21,437,437,22,8,14,3,2
26,440,440,162,102,60,4,3
0,446,446,10,2,8,2,1
14,452,452,14,10,4,2,1
25,462,462,9,4,5,2,1
23,472,472,35,35,0,1,0
7,491,491,98,26,72,3,2

25,102,102,1,1,0,1,0
2,111,111,12,4,8,2,1
21,125,125,14,14,0,1,0
6,129,129,8,8,0,1,0
22,138,138,37,33,4,2,1
1,144,144,1,1,0,1,0
10,194,194,7,7,0,1,0
0,227,227,39,33,6,2,1
19,234,234,17,3,14,2,1
5,246,246,2,2,0,1,0
15,248,248,37,13,24,4,3
28,260,260,7,2,5,2,1
14,296,296,62,18,44,3,2
23,299,299,33,33,0,1,0
27,309,309,13,7,6,3,2
3,339,339,23,23,0,1,0
4,340,340,9,9,0,1,0
12,344,344,2,2,0,1,0
26,350,350,153,99,54,4,3
8,357,357,11,5,6,3,2
17,372,372,9,9,0,1,0
20,392,392,4,1,3,2,1
18,397,397,4,1,3,2,1
9,409,409,139,103,36,4,3
7,431,431,5,5,0,1,0
24,433,433,29,29,0,1,0
16,433,433,53,30,23,2,1
13,454,454,18,18,0,1,0
11,478,478,14,14,0,1,0

11,140,140,26,26,0,1,0
2,160,160,29,14,15,4,3
0,163,163,1,1,0,1,0
29,189,189,23,2,21,4,3
20,199,199,2,2,0,1,0
21,204,204,9,2,7,3,2
4,208,208,7,7,0,1,0
9,231,231,10,5,5,2,1
19,263,263,37,37,0,1,0
3,279,279,28,28,0,1,0
27,283,283,29,1,28,2,1
13,286,286,6,2,4,2,1
17,292,292,11,11,0,1,0
14,295,295,22,22,0,1,0
15,315,315,7,7,0,1,0
25,325,325,23,23,0,1,0
28,332,332,77,11,66,3,2
7,338,338,40,7,33,4,3
10,345,345,6,2,4,2,1
6,349,349,49,49,0,1,0
26,351,351,49,31,18,3,2
32,356,356,30,30,0,1,0
1,375,375,7,4,3,2,1
31,383,383,67,25,42,2,1
5,384,384,19,11,8,2,1
24,398,398,72,72,0,1,0
12,401,401,15,1,14,3,2
22,415,415,20,20,0,1,0
30,431,431,31,31,0,1,0
23,473,473,20,14,6,2,1
18,477,477,12,2,10,3,2
16,494,494,3,3,0,1,0
8,500,500,22,22,0,1,0

2,111,111,18,3,15,4,3
0,120,120,12,12,0,1,0
1,124,124,3,3,0,1,0
17,142,142,2,2,0,1,0
13,163,163,19,19,0,1,0
5,170,170,1,1,0,1,0
18,191,191,36,23,13,2,1
24,193,193,5,5,0,1,0
10,197,197,17,7,10,3,2
7,211,211,11,11,0,1,0
23,248,248,1,1,0,1,0
22,275,275,71,30,41,4,3
8,280,280,62,32,30,4,3
14,281,281,12,9,3,2,1
6,334,334,16,16,0,1,0
15,347,347,9,9,0,1,0
3,359,359,11,11,0,1,0
4,368,368,41,41,0,1,0
21,368,368,52,33,19,2,1
11,372,372,170,170,0,1,0
19,402,402,3,3,0,1,0
12,432,432,100,70,30,2,1
16,446,446,120,15,105,4,3
20,454,454,3,3,0,1,0
9,489,489,1,1,0,1,0

6,100,100,20,20,0,1,0
21,146,146,2,2,0,1,0
3,151,151,1,1,0,1,0
22,151,151,25,4,21,4,3
9,154,154,74,7,67,4,3
18,197,197,12,3,9,2,1
13,214,214,7,7,0,1,0
4,228,228,27,27,0,1,0
14,272,272,13,2,11,2,1
15,277,277,104,80,24,2,1
2,285,285,5,5,0,1,0
0,323,323,15,15,0,1,0
23,350,350,16,16,0,1,0
20,365,365,61,6,55,3,2
19,366,366,20,5,15,4,3
17,371,371,69,53,16,3,2
1,372,372,17,17,0,1,0
10,416,416,51,51,0,1,0
7,417,417,81,41,40,3,2
8,450,450,1,1,0,1,0
11,457,457,39,39,0,1,0
12,481,481,5,5,0,1,0
16,489,489,35,20,15,4,3
5,496,496,33,8,25,2,1

10,101,101,1,1,0,1,0
2,105,105,10,10,0,1,0
22,122,122,8,8,0,1,0
4,144,144,10,1,9,2,1
29,169,169,18,18,0,1,0
15,185,185,61,61,0,1,0
27,190,190,25,13,12,4,3
23,201,201,28,7,21,4,3
18,209,209,53,53,0,1,0
19,213,213,16,4,12,3,2
28,233,233,5,5,0,1,0
3,246,246,11,2,9,2,1
6,264,264,35,35,0,1,0
12,282,282,5,5,0,1,0
8,283,283,6,6,0,1,0
13,286,286,3,3,0,1,0
20,288,288,11,1,10,2,1
0,300,300,14,8,6,3,2
9,316,316,38,38,0,1,0
17,354,354,11,4,7,2,1
14,356,356,54,39,15,4,3
11,371,371,24,24,0,1,0
25,378,378,118,118,0,1,0
21,392,392,44,39,5,2,1
16,455,455,22,22,0,1,0
24,461,461,3,3,0,1,0
5,469,469,25,15,10,3,2
1,474,474,4,4,0,1,0
7,485,485,37,37,0,1,0
26,492,492,15,4,11,3,2

14,116,116,13,13,0,1,0
4,157,157,50,50,0,1,0
2,161,161,1,1,0,1,0
21,162,162,21,9,12,3,2
0,170,170,22,2,20,3,2
19,208,208,49,49,0,1,0
15,208,208,5,5,0,1,0
9,216,216,48,48,0,1,0
3,236,236,8,8,0,1,0
5,265,265,52,12,40,4,3
8,266,266,77,43,34,2,1
20,305,305,36,36,0,1,0
12,307,307,10,4,6,2,1
13,311,311,30,30,0,1,0
17,327,327,36,26,10,3,2
11,352,352,7,7,0,1,0
7,356,356,19,1,18,4,3
10,387,387,27,2,25,2,1
18,407,407,57,29,28,2,1
1,441,441,2,2,0,1,0
6,449,449,121,58,63,4,3
16,461,461,11,3,8,2,1

18,109,109,22,22,0,1,0
7,124,124,13,13,0,1,0
28,142,142,7,7,0,1,0
1,161,161,1,1,0,1,0
22,163,163,2,2,0,1,0
17,163,163,16,4,12,3,2
12,167,167,17,17,0,1,0
16,175,175,54,9,45,4,3
20,196,196,31,18,13,2,1
25,208,208,13,13,0,1,0
14,222,222,1,1,0,1,0
6,260,260,36,36,0,1,0
4,260,260,14,5,9,4,3
15,279,279,28,10,18,4,3
0,311,311,16,2,14,2,1
10,314,314,42,42,0,1,0
24,363,363,50,50,0,1,0
2,395,395,23,23,0,1,0
23,403,403,16,13,3,2,1
26,410,410,83,39,44,3,2
8,415,415,34,34,0,1,0
9,428,428,43,26,17,2,1
3,432,432,70,20,50,3,2
21,435,435,1,1,0,1,0
27,435,435,10,10,0,1,0
5,456,456,9,9,0,1,0
19,458,458,16,16,0,1,0
11,482,482,75,75,0,1,0
13,485,485,14,11,3,2,1

3,105,105,1,1,0,1,0
16,106,106,12,12,0,1,0
26,128,128,25,25,0,1,0
15,188,188,5,5,0,1,0
20,191,191,16,10,6,3,2
8,195,195,44,44,0,1,0
23,238,238,9,9,0,1,0
22,239,239,8,2,6,2,1
21,246,246,13,5,8,3,2
4,253,253,51,51,0,1,0
13,266,266,1,1,0,1,0
1,267,267,16,4,12,3,2
25,294,294,26,26,0,1,0
19,295,295,86,50,36,4,3
14,300,300,20,10,10,3,2
17,363,363,6,6,0,1,0
2,377,377,9,3,6,2,1
18,382,382,80,6,74,3,2
11,387,387,2,2,0,1,0
5,397,397,9,3,6,3,2
24,413,413,51,48,3,2,1
7,418,418,33,33,0,1,0
0,439,439,7,7,0,1,0
6,462,462,5,5,0,1,0
10,465,465,185,124,61,4,3
27,471,471,29,9,20,3,2
12,474,474,51,51,0,1,0
9,488,488,35,31,4,2,1

24,106,106,21,21,0,1,0
27,110,110,14,7,7,2,1
19,121,121,23,1,22,3,2
8,132,132,7,1,6,2,1
15,150,150,3,3,0,1,0
6,171,171,63,47,16,3,2
23,173,173,4,4,0,1,0
5,186,186,36,33,3,2,1
26,189,189,6,6,0,1,0
29,220,220,11,1,10,2,1
2,220,220,4,4,0,1,0
20,224,224,79,79,0,1,0
10,256,256,9,9,0,1,0
12,257,257,8,2,6,3,2
25,288,288,11,1,10,2,1
16,289,289,10,10,0,1,0
4,290,290,36,24,12,3,2
17,317,317,14,4,10,3,2
11,329,329,6,2,4,2,1
28,344,344,15,15,0,1,0
7,352,352,31,21,10,2,1
18,356,356,63,63,0,1,0
0,367,367,6,6,0,1,0
3,396,396,3,3,0,1,0
13,402,402,8,8,0,1,0
1,424,424,19,19,0,1,0
21,426,426,12,3,9,2,1
22,445,445,15,15,0,1,0
14,452,452,31,31,0,1,0
9,473,473,76,32,44,3,2

21,136,136,4,4,0,1,0
3,182,182,1,1,0,1,0
19,206,206,33,3,30,3,2
27,214,214,15,15,0,1,0
14,216,216,21,17,4,2,1
2,253,253,49,19,30,4,3
10,256,256,2,2,0,1,0
17,260,260,94,67,27,2,1
16,298,298,28,2,26,2,1
5,330,330,36,36,0,1,0
24,333,333,42,18,24,2,1
9,349,349,10,1,9,4,3
0,358,358,1,1,0,1,0
28,361,361,9,6,3,2,1
22,362,362,24,24,0,1,0
15,378,378,66,26,40,2,1
8,380,380,2,2,0,1,0
26,382,382,11,11,0,1,0
4,393,393,21,21,0,1,0
12,412,412,97,35,62,3,2
23,416,416,2,2,0,1,0
1,424,424,36,36,0,1,0
20,430,430,49,4,45,2,1
7,447,447,112,49,63,4,3
18,449,449,53,53,0,1,0
6,458,458,16,9,7,2,1
25,485,485,58,58,0,1,0
13,490,490,6,6,0,1,0
11,493,493,3,3,0,1,0

15,113,113,10,10,0,1,0
10,141,141,2,2,0,1,0
9,142,142,4,4,0,1,0
5,166,166,12,12,0,1,0
24,192,192,97,61,36,4,3
23,193,193,4,4,0,1,0
25,206,206,43,35,8,3,2
14,262,262,13,5,8,2,1
19,277,277,3,3,0,1,0
20,293,293,11,11,0,1,0
6,294,294,1,1,0,1,0
11,296,296,20,11,9,2,1
17,296,296,12,12,0,1,0
1,305,305,42,13,29,2,1
3,306,306,50,28,22,3,2
21,313,313,2,2,0,1,0
18,314,314,68,68,0,1,0
4,352,352,166,102,64,3,2
7,358,358,14,14,0,1,0
22,373,373,2,2,0,1,0
0,378,378,70,29,41,2,1
13,413,413,29,3,26,3,2
12,427,427,20,10,10,2,1
2,480,480,31,31,0,1,0
16,486,486,30,8,22,2,1
8,500,500,4,4,0,1,0

4,140,140,1,1,0,1,0
20,148,148,14,5,9,4,3
2,149,149,14,4,10,3,2
11,162,162,22,13,9,4,3
23,174,174,30,30,0,1,0
15,175,175,5,1,4,2,1
1,191,191,7,7,0,1,0
9,233,233,59,33,26,4,3
5,237,237,15,3,12,2,1
16,246,246,54,54,0,1,0
13,253,253,22,10,12,3,2
14,256,256,9,9,0,1,0
8,260,260,13,13,0,1,0
12,288,288,5,5,0,1,0
22,297,297,37,37,0,1,0
24,321,321,39,39,0,1,0
0,340,340,2,2,0,1,0
18,364,364,67,27,40,2,1
17,381,381,25,25,0,1,0
7,428,428,190,43,147,4,3
6,439,439,43,21,22,3,2
21,447,447,34,8,26,2,1
3,473,473,15,2,13,2,1
10,474,474,39,5,34,2,1
19,486,486,47,47,0,1,0

0,147,147,133,43,90,4,3
6,154,154,20,20,0,1,0
5,155,155,18,8,10,2,1
19,235,235,6,6,0,1,0
7,253,253,10,10,0,1,0
15,253,253,14,1,13,4,3
8,259,259,11,11,0,1,0
1,270,270,6,1,5,2,1
14,272,272,101,72,29,4,3
16,275,275,48,48,0,1,0
12,280,280,22,11,11,2,1
4,289,289,23,11,12,4,3
11,300,300,58,58,0,1,0
9,304,304,15,8,7,2,1
10,328,328,1,1,0,1,0
13,351,351,17,3,14,3,2
3,387,387,1,1,0,1,0
18,401,401,14,14,0,1,0
17,405,405,16,16,0,1,0
20,449,449,96,36,60,4,3
2,454,454,3,3,0,1,0

3,110,110,31,12,19,2,1
2,127,127,11,11,0,1,0
20,128,128,18,18,0,1,0
9,131,131,10,10,0,1,0
12,166,166,3,3,0,1,0
11,184,184,11,11,0,1,0
4,202,202,56,56,0,1,0
6,224,224,12,12,0,1,0
8,234,234,34,8,26,3,2
16,250,250,22,22,0,1,0
13,254,254,31,21,10,3,2
7,267,267,32,32,0,1,0
5,282,282,12,12,0,1,0
15,294,294,86,46,40,3,2
14,296,296,7,7,0,1,0
22,298,298,36,36,0,1,0
19,309,309,19,19,0,1,0
18,323,323,88,26,62,3,2
23,340,340,8,8,0,1,0
21,351,351,5,2,3,2,1
1,361,361,21,21,0,1,0
10,387,387,10,10,0,1,0
0,469,469,63,8,55,3,2
17,473,473,41,41,0,1,0

24,127,127,10,10,0,1,0
6,136,136,17,3,14,2,1
0,177,177,11,11,0,1,0
20,180,180,20,10,10,3,2
4,182,182,48,10,38,3,2
16,182,182,18,3,15,4,3
11,188,188,18,18,0,1,0
13,195,195,17,17,0,1,0
10,196,196,7,1,6,3,2
12,200,200,2,2,0,1,0
9,215,215,2,2,0,1,0
1,219,219,43,20,23,2,1
3,219,219,29,5,24,3,2
7,242,242,22,6,16,2,1
14,288,288,13,3,10,2,1
22,307,307,18,18,0,1,0
17,311,311,75,75,0,1,0
15,328,328,4,4,0,1,0
5,328,328,15,15,0,1,0
25,348,348,51,39,12,4,3
8,376,376,11,11,0,1,0
18,392,392,96,25,71,3,2
19,392,392,39,39,0,1,0
2,401,401,83,7,76,3,2
21,472,472,31,31,0,1,0
23,487,487,19,13,6,2,1

15,104,104,1,1,0,1,0
11,142,142,17,3,14,3,2
12,183,183,26,26,0,1,0
1,190,190,11,1,10,3,2
18,204,204,33,33,0,1,0
23,211,211,5,5,0,1,0
21,213,213,1,1,0,1,0
0,229,229,33,14,19,2,1
2,239,239,1,1,0,1,0
20,245,245,6,1,5,2,1
17,263,263,21,9,12,4,3
4,265,265,4,4,0,1,0
7,265,265,15,15,0,1,0
3,277,277,16,16,0,1,0
26,285,285,51,51,0,1,0
14,300,300,121,57,64,3,2
10,307,307,24,10,14,2,1
22,310,310,27,3,24,4,3
24,322,322,7,7,0,1,0
13,348,348,55,15,40,2,1
5,361,361,33,33,0,1,0
8,363,363,71,55,16,2,1
9,364,364,40,34,6,2,1
6,375,375,27,27,0,1,0
25,459,459,66,9,57,3,2
19,473,473,23,23,0,1,0
16,499,499,69,22,47,2,1

32,103,103,11,3,8,3,2
21,110,110,32,32,0,1,0
22,113,113,24,5,19,2,1
28,120,120,2,2,0,1,0
3,132,132,37,18,19,2,1
16,138,138,1,1,0,1,0
20,149,149,15,15,0,1,0
18,158,158,23,23,0,1,0
6,194,194,24,5,19,2,1
4,220,220,1,1,0,1,0
12,229,229,7,2,5,2,1
2,272,272,2,2,0,1,0
30,281,281,16,16,0,1,0
24,291,291,50,12,38,3,2
8,296,296,15,11,4,2,1
26,300,300,33,13,20,4,3
14,300,300,4,4,0,1,0
0,300,300,19,19,0,1,0
1,315,315,3,3,0,1,0
27,317,317,28,28,0,1,0
15,325,325,63,41,22,4,3
9,352,352,12,1,11,2,1
13,376,376,25,25,0,1,0
31,377,377,4,4,0,1,0
17,382,382,6,6,0,1,0
10,385,385,1,1,0,1,0
25,386,386,42,42,0,1,0
19,414,414,33,33,0,1,0
23,426,426,6,6,0,1,0
29,427,427,21,13,8,3,2
11,460,460,3,3,0,1,0
7,466,466,10,1,9,4,3
5,494,494,71,71,0,1,0

7,116,116,21,21,0,1,0
6,120,120,4,4,0,1,0
22,131,131,10,10,0,1,0
5,143,143,17,17,0,1,0
21,206,206,37,30,7,2,1
18,233,233,1,1,0,1,0
23,236,236,15,15,0,1,0
1,272,272,23,11,12,4,3
2,288,288,29,29,0,1,0
9,296,296,25,25,0,1,0
16,304,304,47,47,0,1,0
11,311,311,11,3,8,3,2
20,327,327,30,3,27,4,3
24,336,336,55,23,32,2,1
0,363,363,51,1,50,3,2
3,389,389,13,13,0,1,0
4,415,415,151,146,5,2,1
8,417,417,42,4,38,3,2
10,443,443,11,11,0,1,0
12,448,448,45,29,16,3,2
13,452,452,49,49,0,1,0
15,460,460,4,4,0,1,0
19,484,484,155,155,0,1,0
14,491,491,7,7,0,1,0
17,498,498,17,4,13,2,1

28,109,109,4,4,0,1,0
16,121,121,26,3,23,2,1
5,127,127,12,4,8,3,2
2,131,131,15,15,0,1,0
24,143,143,10,7,3,2,1
22,157,157,16,7,9,2,1
21,165,165,10,10,0,1,0
17,175,175,5,5,0,1,0
7,238,238,59,17,42,3,2
26,243,243,40,4,36,3,2
14,248,248,6,6,0,1,0
19,251,251,26,11,15,2,1
3,254,254,20,20,0,1,0
13,283,283,1,1,0,1,0
12,302,302,39,39,0,1,0
11,342,342,22,6,16,3,2
8,348,348,52,25,27,3,2
23,363,363,2,2,0,1,0
6,373,373,35,35,0,1,0
0,383,383,12,12,0,1,0
25,408,408,53,21,32,2,1
18,423,423,40,14,26,2,1
9,442,442,9,9,0,1,0
15,444,444,19,19,0,1,0
4,454,454,42,24,18,2,1
20,464,464,25,25,0,1,0
27,471,471,125,33,92,3,2
10,486,486,9,9,0,1,0
1,499,499,48,2,46,2,1

0,100,100,5,5,0,1,0
15,116,116,3,3,0,1,0
26,116,116,14,14,0,1,0
14,142,142,5,5,0,1,0
19,148,148,15,8,7,2,1
31,149,149,5,5,0,1,0
6,158,158,5,5,0,1,0
22,159,159,29,29,0,1,0
3,161,161,20,20,0,1,0
1,172,172,14,6,8,3,2
23,183,183,37,37,0,1,0
28,195,195,3,3,0,1,0
25,210,210,6,3,3,2,1
5,219,219,2,2,0,1,0
20,220,220,7,7,0,1,0
32,221,221,33,1,32,4,3
30,233,233,31,18,13,2,1
16,241,241,8,5,3,2,1
17,251,251,1,1,0,1,0
9,253,253,4,4,0,1,0
11,256,256,7,7,0,1,0
4,263,263,7,1,6,3,2
21,272,272,2,2,0,1,0
8,281,281,46,1,45,2,1
13,287,287,8,8,0,1,0
27,296,296,4,4,0,1,0
2,300,300,5,5,0,1,0
18,354,354,42,33,9,4,3
24,362,362,92,92,0,1,0
7,386,386,33,11,22,2,1
29,388,388,58,58,0,1,0
12,418,418,30,26,4,2,1
10,453,453,115,73,42,4,3

4,114,114,15,6,9,4,3
3,156,156,4,4,0,1,0
19,178,178,35,26,9,2,1
21,186,186,22,22,0,1,0
18,190,190,9,9,0,1,0
11,192,192,5,5,0,1,0
17,213,213,6,6,0,1,0
7,242,242,26,6,20,2,1
6,249,249,9,9,0,1,0
1,300,300,71,27,44,3,2
12,327,327,9,1,8,3,2
8,345,345,177,177,0,1,0
9,347,347,37,37,0,1,0
16,392,392,60,38,22,3,2
13,405,405,103,73,30,3,2
0,407,407,5,1,4,2,1
2,466,466,41,41,0,1,0
15,480,480,88,45,43,4,3
14,482,482,10,6,4,2,1
20,486,486,76,76,0,1,0
10,487,487,4,1,3,2,1
5,487,487,74,74,0,1,0

25,102,102,9,9,0,1,0
0,107,107,11,5,6,2,1
28,134,134,17,14,3,2,1
2,158,158,6,6,0,1,0
7,200,200,3,3,0,1,0
27,206,206,1,1,0,1,0
26,207,207,87,87,0,1,0
8,242,242,5,5,0,1,0
13,248,248,1,1,0,1,0
22,249,249,1,1,0,1,0
17,255,255,71,20,51,4,3
24,266,266,45,32,13,2,1
19,286,286,43,7,36,4,3
6,300,300,16,3,13,2,1
29,314,314,3,3,0,1,0
1,319,319,9,9,0,1,0
11,321,321,1,1,0,1,0
20,340,340,31,24,7,2,1
16,363,363,16,16,0,1,0
14,368,368,11,8,3,2,1
5,379,379,54,54,0,1,0
4,399,399,53,19,34,3,2
21,404,404,11,3,8,2,1
23,404,404,5,5,0,1,0
15,406,406,20,20,0,1,0
18,413,413,9,3,6,3,2
10,415,415,2,2,0,1,0
30,421,421,87,87,0,1,0
9,436,436,6,3,3,2,1
3,449,449,124,100,24,2,1
12,472,472,30,30,0,1,0

6,115,115,1,1,0,1,0
18,122,122,36,20,16,3,2
8,148,148,13,7,6,3,2
10,157,157,33,33,0,1,0
16,171,171,7,1,6,2,1
22,190,190,2,2,0,1,0
9,193,193,1,1,0,1,0
3,204,204,35,35,0,1,0
11,225,225,36,36,0,1,0
12,230,230,33,33,0,1,0
19,251,251,40,4,36,2,1
25,262,262,7,7,0,1,0
15,272,272,4,4,0,1,0
23,328,328,50,17,33,4,3
2,344,344,61,61,0,1,0
24,369,369,88,88,0,1,0
21,383,383,16,16,0,1,0
26,413,413,4,4,0,1,0
1,416,416,28,19,9,4,3
14,417,417,53,11,42,4,3
13,430,430,12,12,0,1,0
5,430,430,3,3,0,1,0
17,433,433,60,20,40,4,3
4,443,443,8,5,3,2,1
7,489,489,65,5,60,4,3
20,498,498,34,13,21,2,1
0,499,499,42,12,30,4,3

18,110,110,6,6,0,1,0
23,126,126,17,2,15,2,1
11,140,140,16,16,0,1,0
6,144,144,12,12,0,1,0
20,165,165,9,9,0,1,0
12,176,176,5,5,0,1,0
25,196,196,2,2,0,1,0
14,203,203,26,26,0,1,0
13,204,204,24,18,6,3,2
0,208,208,29,29,0,1,0
16,209,209,48,36,12,2,1
7,211,211,14,14,0,1,0
24,212,212,8,2,6,2,1
4,218,218,9,1,8,3,2
2,242,242,6,3,3,2,1
1,277,277,36,36,0,1,0
27,303,303,39,39,0,1,0
22,311,311,107,83,24,4,3
28,322,322,16,16,0,1,0
3,371,371,42,36,6,3,2
17,407,407,11,11,0,1,0
19,422,422,10,7,3,2,1
10,450,450,72,32,40,2,1
8,461,461,42,12,30,2,1
5,461,461,14,14,0,1,0
21,463,463,40,28,12,2,1
15,463,463,4,4,0,1,0
26,465,465,69,69,0,1,0
9,496,496,12,12,0,1,0

14,102,102,4,4,0,1,0
8,104,104,14,2,12,4,3
13,111,111,14,14,0,1,0
25,122,122,22,22,0,1,0
0,148,148,1,1,0,1,0
28,150,150,29,29,0,1,0
5,214,214,1,1,0,1,0
2,221,221,45,32,13,2,1
22,232,232,17,5,12,3,2
4,257,257,7,7,0,1,0
12,289,289,24,20,4,2,1
11,303,303,69,54,15,2,1
18,323,323,2,2,0,1,0
1,340,340,46,9,37,2,1
17,341,341,47,3,44,2,1
27,346,346,7,1,6,3,2
16,347,347,13,13,0,1,0
9,355,355,23,23,0,1,0
21,387,387,21,21,0,1,0
3,396,396,56,5,51,3,2
19,399,399,35,35,0,1,0
23,407,407,123,52,71,4,3
26,411,411,11,6,5,2,1
7,413,413,25,5,20,4,3
6,420,420,16,8,8,2,1
20,445,445,89,89,0,1,0
15,465,465,3,3,0,1,0
24,486,486,2,2,0,1,0
10,488,488,1,1,0,1,0

20,103,103,20,2,18,3,2
3,127,127,1,1,0,1,0
12,142,142,2,2,0,1,0
0,154,154,21,1,20,3,2
8,158,158,8,8,0,1,0
1,174,174,61,61,0,1,0
17,178,178,45,45,0,1,0
13,190,190,10,10,0,1,0
21,199,199,27,27,0,1,0
6,208,208,1,1,0,1,0
14,242,242,42,27,15,2,1
16,254,254,18,18,0,1,0
7,266,266,18,6,12,2,1
2,317,317,119,119,0,1,0
22,326,326,19,19,0,1,0
11,344,344,2,2,0,1,0
5,356,356,12,12,0,1,0
15,395,395,2,2,0,1,0
19,411,411,34,28,6,3,2
18,440,440,58,58,0,1,0
10,458,458,71,53,18,3,2
4,467,467,126,126,0,1,0
9,473,473,2,2,0,1,0

20,103,103,2,2,0,1,0
9,133,133,4,4,0,1,0
21,141,141,1,1,0,1,0
14,157,157,5,5,0,1,0
12,187,187,26,4,22,4,3
16,189,189,52,28,24,4,3
6,191,191,3,3,0,1,0
5,206,206,3,3,0,1,0
19,209,209,29,7,22,3,2
23,236,236,8,2,6,2,1
15,278,278,7,7,0,1,0
10,284,284,28,28,0,1,0
11,299,299,57,27,30,4,3
4,302,302,102,102,0,1,0
13,322,322,8,2,6,3,2
18,322,322,60,60,0,1,0
3,352,352,72,72,0,1,0
2,364,364,3,3,0,1,0
1,389,389,145,145,0,1,0
0,411,411,73,73,0,1,0
7,486,486,14,6,8,2,1
8,488,488,7,2,5,2,1
17,495,495,14,14,0,1,0
22,500,500,120,120,0,1,0

18,111,111,2,2,0,1,0
9,144,144,14,14,0,1,0
1,146,146,7,7,0,1,0
6,147,147,7,2,5,2,1
7,163,163,31,31,0,1,0
10,187,187,73,39,34,3,2
24,196,196,20,10,10,3,2
20,216,216,41,5,36,4,3
15,230,230,13,13,0,1,0
5,248,248,35,14,21,4,3
11,273,273,12,2,10,2,1
16,286,286,16,16,0,1,0
13,292,292,49,49,0,1,0
12,302,302,11,11,0,1,0
8,315,315,7,7,0,1,0
0,323,323,20,20,0,1,0
4,365,365,37,34,3,2,1
14,372,372,16,2,14,3,2
21,401,401,81,81,0,1,0
25,411,411,67,57,10,3,2
23,414,414,45,19,26,2,1
3,419,419,50,50,0,1,0
22,424,424,2,2,0,1,0
19,437,437,24,18,6,2,1
17,454,454,70,32,38,3,2
2,477,477,1,1,0,1,0

22,122,122,1,1,0,1,0
28,140,140,15,15,0,1,0
8,156,156,14,3,11,2,1
5,163,163,13,13,0,1,0
0,168,168,32,32,0,1,0
19,171,171,21,9,12,3,2
20,184,184,8,8,0,1,0
13,194,194,65,38,27,4,3
15,211,211,1,1,0,1,0
25,220,220,55,26,29,2,1
27,222,222,29,29,0,1,0
23,225,225,15,8,7,2,1
9,236,236,6,6,0,1,0
3,249,249,42,42,0,1,0
12,255,255,8,4,4,2,1
7,305,305,1,1,0,1,0
26,326,326,25,3,22,2,1
24,339,339,2,2,0,1,0
4,348,348,64,64,0,1,0
14,381,381,14,3,11,4,3
10,384,384,15,3,12,3,2
17,419,419,47,47,0,1,0
18,422,422,91,91,0,1,0
2,427,427,5,5,0,1,0
11,443,443,14,14,0,1,0
6,449,449,3,3,0,1,0
21,470,470,47,47,0,1,0
16,477,477,39,32,7,2,1
1,480,480,30,24,6,2,1

23,116,116,24,9,15,4,3
7,118,118,1,1,0,1,0
1,183,183,19,19,0,1,0
3,183,183,21,7,14,3,2
6,211,211,12,3,9,2,1
24,237,237,2,2,0,1,0
11,263,263,19,19,0,1,0
13,266,266,23,11,12,2,1
25,273,273,16,16,0,1,0
4,289,289,29,18,11,2,1
10,318,318,9,2,7,2,1
15,320,320,17,17,0,1,0
12,333,333,6,1,5,2,1
9,344,344,56,23,33,4,3
27,353,353,27,27,0,1,0
5,357,357,51,11,40,2,1
16,361,361,20,14,6,2,1
14,365,365,48,16,32,2,1
2,371,371,87,87,0,1,0
22,395,395,21,3,18,4,3
8,398,398,3,3,0,1,0
26,405,405,22,4,18,3,2
18,410,410,3,3,0,1,0
21,410,410,18,6,12,2,1
20,436,436,218,218,0,1,0
0,447,447,15,15,0,1,0
17,463,463,76,76,0,1,0
19,484,484,17,17,0,1,0

11,109,109,1,1,0,1,0
16,115,115,15,15,0,1,0
19,116,116,3,3,0,1,0
6,127,127,26,13,13,4,3
18,128,128,3,3,0,1,0
5,139,139,13,13,0,1,0
7,156,156,9,9,0,1,0
9,166,166,40,11,29,2,1
14,193,193,32,3,29,2,1
1,200,200,21,21,0,1,0
15,229,229,27,27,0,1,0
10,238,238,6,6,0,1,0
2,261,261,51,41,10,2,1
3,286,286,151,59,92,3,2
17,428,428,85,10,75,4,3
4,438,438,20,20,0,1,0
13,458,458,19,19,0,1,0
12,465,465,22,3,19,2,1
8,472,472,57,57,0,1,0
20,476,476,88,88,0,1,0
0,483,483,35,16,19,2,1

15,111,111,28,15,13,2,1
10,168,168,4,4,0,1,0
14,171,171,16,4,12,2,1
1,179,179,1,1,0,1,0
18,179,179,43,3,40,3,2
17,188,188,20,20,0,1,0
3,209,209,24,24,0,1,0
21,215,215,18,8,10,4,3
23,245,245,19,19,0,1,0
26,250,250,8,8,0,1,0
27,251,251,6,6,0,1,0
25,256,256,14,14,0,1,0
5,267,267,4,4,0,1,0
9,271,271,5,5,0,1,0
7,298,298,67,41,26,3,2
12,301,301,43,43,0,1,0
22,358,358,72,44,28,4,3
28,364,364,12,12,0,1,0
20,370,370,55,11,44,2,1
13,379,379,53,44,9,4,3
4,387,387,8,8,0,1,0
24,395,395,6,6,0,1,0
19,418,418,60,38,22,3,2
2,447,447,23,23,0,1,0
6,457,457,6,6,0,1,0
0,462,462,24,1,23,2,1
16,464,464,72,6,66,3,2
11,496,496,45,36,9,2,1
8,500,500,25,25,0,1,0

15,117,117,8,8,0,1,0
11,135,135,8,8,0,1,0
3,150,150,6,6,0,1,0
0,166,166,13,4,9,4,3
9,178,178,18,8,10,2,1
7,195,195,1,1,0,1,0
23,201,201,10,5,5,2,1
12,219,219,39,31,8,3,2
21,237,237,35,8,27,4,3
22,254,254,29,29,0,1,0
17,275,275,10,10,0,1,0
13,285,285,7,7,0,1,0
10,285,285,43,43,0,1,0
14,305,305,11,11,0,1,0
1,327,327,11,11,0,1,0
2,343,343,82,51,31,3,2
4,377,377,7,7,0,1,0
5,389,389,3,3,0,1,0
8,400,400,123,17,106,4,3
20,439,439,1,1,0,1,0
19,452,452,54,54,0,1,0
16,477,477,174,174,0,1,0
18,482,482,63,18,45,2,1
6,490,490,157,60,97,4,3

29,102,102,2,2,0,1,0
7,108,108,4,4,0,1,0
15,109,109,7,4,3,2,1
23,109,109,2,2,0,1,0
8,130,130,1,1,0,1,0
3,133,133,5,5,0,1,0
18,136,136,2,2,0,1,0
4,168,168,28,16,12,4,3
20,183,183,32,13,19,2,1
12,185,185,6,6,0,1,0
11,195,195,4,4,0,1,0
14,237,237,7,7,0,1,0
5,240,240,9,9,0,1,0
10,241,241,11,11,0,1,0
21,241,241,2,2,0,1,0
1,273,273,11,1,10,2,1
30,281,281,35,35,0,1,0
16,290,290,14,14,0,1,0
17,312,312,18,18,0,1,0
19,327,327,31,31,0,1,0
25,349,349,32,32,0,1,0
13,355,355,52,48,4,2,1
24,382,382,166,65,101,4,3
0,384,384,39,39,0,1,0
26,393,393,8,4,4,2,1
6,396,396,25,15,10,2,1
2,408,408,125,125,0,1,0
9,418,418,25,8,17,2,1
22,421,421,92,17,75,4,3
28,463,463,23,23,0,1,0
27,465,465,22,10,12,2,1

14,118,118,4,1,3,2,1
5,139,139,5,5,0,1,0
12,167,167,6,6,0,1,0
3,189,189,47,47,0,1,0
2,192,192,5,5,0,1,0
16,235,235,43,28,15,2,1
17,241,241,35,35,0,1,0
18,244,244,20,11,9,4,3
8,253,253,27,14,13,2,1
6,272,272,28,28,0,1,0
13,282,282,62,40,22,4,3
4,285,285,61,18,43,2,1
21,301,301,15,15,0,1,0
15,310,310,49,29,20,2,1
22,331,331,15,9,6,3,2
19,335,335,51,51,0,1,0
1,355,355,130,72,58,3,2
11,378,378,6,6,0,1,0
20,406,406,65,40,25,2,1
9,429,429,51,29,22,2,1
7,438,438,12,12,0,1,0
0,481,481,26,10,16,3,2
10,497,497,24,9,15,4,3

21,125,125,10,3,7,2,1
17,127,127,20,5,15,4,3
5,141,141,39,23,16,3,2
18,166,166,20,20,0,1,0
11,183,183,37,25,12,2,1
8,191,191,7,7,0,1,0
6,202,202,19,9,10,2,1
16,270,270,1,1,0,1,0
10,302,302,45,45,0,1,0
14,302,302,12,12,0,1,0
20,312,312,3,3,0,1,0
19,315,315,75,75,0,1,0
12,370,370,35,8,27,3,2
7,391,391,35,35,0,1,0
0,409,409,95,15,80,4,3
4,413,413,65,65,0,1,0
2,413,413,99,99,0,1,0
1,414,414,52,52,0,1,0
9,421,421,38,38,0,1,0
3,425,425,22,22,0,1,0
13,469,469,4,4,0,1,0
15,477,477,60,12,48,3,2

0,131,131,5,5,0,1,0
12,137,137,9,9,0,1,0
26,138,138,29,29,0,1,0
9,141,141,2,2,0,1,0
24,150,150,14,4,10,3,2
1,152,152,1,1,0,1,0
13,162,162,1,1,0,1,0
29,172,172,19,7,12,4,3
25,193,193,34,34,0,1,0
18,196,196,14,2,12,3,2
23,198,198,11,5,6,3,2
17,211,211,12,12,0,1,0
19,222,222,13,2,11,2,1
27,228,228,2,2,0,1,0
14,230,230,5,1,4,2,1
28,239,239,66,27,39,2,1
16,245,245,23,15,8,2,1
10,262,262,6,6,0,1,0
2,273,273,1,1,0,1,0
22,306,306,5,1,4,2,1
30,307,307,59,29,30,4,3
3,311,311,121,121,0,1,0
15,313,313,22,10,12,3,2
4,321,321,66,66,0,1,0
8,346,346,19,19,0,1,0
5,354,354,10,10,0,1,0
11,369,369,40,40,0,1,0
7,369,369,18,8,10,2,1
21,372,372,1,1,0,1,0
20,374,374,23,1,22,4,3
6,466,466,31,31,0,1,0

19,108,108,8,8,0,1,0
20,124,124,7,1,6,2,1
14,127,127,14,2,12,2,1
17,130,130,2,2,0,1,0
18,132,132,19,19,0,1,0
16,155,155,27,27,0,1,0
10,162,162,48,5,43,2,1
7,190,190,30,18,12,2,1
11,203,203,10,10,0,1,0
4,211,211,1,1,0,1,0
8,211,211,9,9,0,1,0
13,220,220,11,11,0,1,0
23,265,265,40,40,0,1,0
15,282,282,57,9,48,3,2
5,345,345,20,20,0,1,0
2,346,346,17,1,16,2,1
0,357,357,38,12,26,3,2
6,381,381,90,90,0,1,0
1,405,405,7,1,6,3,2
3,417,417,79,68,11,2,1
22,432,432,53,53,0,1,0
9,446,446,64,2,62,4,3
12,468,468,84,16,68,3,2
21,488,488,1,1,0,1,0

5,133,133,45,45,0,1,0
1,187,187,49,19,30,3,2
2,198,198,2,2,0,1,0
15,219,219,49,49,0,1,0
23,228,228,5,2,3,2,1
17,229,229,35,35,0,1,0
21,257,257,7,1,6,3,2
7,289,289,26,26,0,1,0
22,306,306,1,1,0,1,0
10,307,307,26,10,16,2,1
18,310,310,6,6,0,1,0
0,333,333,26,26,0,1,0
16,358,358,47,14,33,4,3
13,364,364,67,12,55,4,3
12,382,382,38,2,36,3,2
14,429,429,10,10,0,1,0
11,439,439,7,7,0,1,0
19,445,445,112,34,78,4,3
4,454,454,47,32,15,4,3
20,459,459,74,15,59,3,2
3,463,463,16,2,14,3,2
9,473,473,52,41,11,2,1
6,491,491,69,69,0,1,0
8,496,496,25,25,0,1,0

13,102,102,4,4,0,1,0
16,105,105,9,1,8,3,2
5,129,129,13,13,0,1,0
21,131,131,3,3,0,1,0
0,138,138,4,4,0,1,0
11,163,163,26,20,6,2,1
17,164,164,27,4,23,2,1
3,189,189,1,1,0,1,0
18,194,194,60,18,42,4,3
10,198,198,18,18,0,1,0
22,199,199,1,1,0,1,0
15,234,234,17,6,11,2,1
1,256,256,23,23,0,1,0
9,268,268,116,14,102,4,3
12,287,287,22,1,21,4,3
7,325,325,33,33,0,1,0
6,353,353,31,26,5,2,1
4,353,353,4,4,0,1,0
20,377,377,23,1,22,2,1
14,387,387,52,52,0,1,0
19,414,414,48,48,0,1,0
8,464,464,183,183,0,1,0
2,489,489,24,13,11,2,1

7,111,111,8,8,0,1,0
28,136,136,28,13,15,2,1
30,167,167,5,2,3,2,1
6,178,178,35,11,24,2,1
21,186,186,2,2,0,1,0
14,238,238,34,19,15,4,3
29,238,238,7,7,0,1,0
0,266,266,33,33,0,1,0
13,276,276,17,17,0,1,0
2,288,288,16,1,15,4,3
25,297,297,23,7,16,3,2
9,299,299,8,8,0,1,0
5,313,313,6,6,0,1,0
17,317,317,8,8,0,1,0
27,329,329,20,20,0,1,0
4,359,359,2,2,0,1,0
1,373,373,93,93,0,1,0
23,400,400,85,85,0,1,0
11,416,416,40,40,0,1,0
24,430,430,29,29,0,1,0
19,432,432,134,134,0,1,0
3,447,447,2,2,0,1,0
26,452,452,21,21,0,1,0
12,452,452,56,12,44,3,2
18,464,464,23,23,0,1,0
10,468,468,6,6,0,1,0
15,475,475,13,2,11,2,1
20,477,477,79,10,69,4,3
8,482,482,17,11,6,2,1
16,483,483,11,11,0,1,0
22,493,493,28,13,15,4,3

6,107,107,16,1,15,3,2
19,115,115,19,2,17,2,1
7,126,126,10,10,0,1,0
20,143,143,1,1,0,1,0
10,170,170,12,3,9,4,3
18,186,186,19,7,12,3,2
3,193,193,9,9,0,1,0
21,209,209,66,66,0,1,0
2,255,255,7,2,5,2,1
11,311,311,42,39,3,2,1
22,325,325,9,2,7,2,1
12,325,325,81,15,66,4,3
8,350,350,68,64,4,2,1
17,357,357,32,32,0,1,0
5,371,371,9,9,0,1,0
16,386,386,19,19,0,1,0
14,402,402,18,18,0,1,0
15,408,408,24,24,0,1,0
13,410,410,6,3,3,2,1
1,434,434,1,1,0,1,0
0,434,434,115,37,78,4,3
9,441,441,210,102,108,4,3
4,468,468,17,9,8,3,2

9,132,132,15,6,9,4,3
21,151,151,3,3,0,1,0
15,200,200,41,41,0,1,0
18,207,207,37,13,24,3,2
19,210,210,33,33,0,1,0
8,219,219,9,9,0,1,0
10,279,279,5,2,3,2,1
11,283,283,5,5,0,1,0
3,313,313,69,69,0,1,0
23,318,318,7,7,0,1,0
14,325,325,63,51,12,2,1
5,331,331,97,97,0,1,0
0,358,358,16,5,11,2,1
22,360,360,59,59,0,1,0
24,363,363,29,29,0,1,0
4,370,370,54,54,0,1,0
17,375,375,12,1,11,2,1
7,379,379,39,2,37,2,1
1,413,413,4,1,3,2,1
6,421,421,63,63,0,1,0
2,436,436,63,63,0,1,0
13,440,440,22,22,0,1,0
16,440,440,53,41,12,4,3
20,482,482,43,8,35,2,1
12,494,494,5,5,0,1,0

26,107,107,22,22,0,1,0
5,126,126,18,9,9,2,1
12,148,148,22,22,0,1,0
13,158,158,13,7,6,2,1
18,173,173,27,19,8,3,2
9,174,174,36,25,11,2,1
7,177,177,4,4,0,1,0
2,189,189,8,8,0,1,0
24,191,191,3,3,0,1,0
17,198,198,17,5,12,3,2
3,200,200,7,7,0,1,0
16,200,200,1,1,0,1,0
4,217,217,14,14,0,1,0
19,218,218,4,4,0,1,0
0,235,235,6,6,0,1,0
6,235,235,8,2,6,3,2
1,315,315,2,2,0,1,0
15,336,336,10,10,0,1,0
21,354,354,90,90,0,1,0
8,356,356,77,46,31,2,1
20,361,361,70,70,0,1,0
23,376,376,31,24,7,2,1
25,381,381,16,16,0,1,0
22,407,407,52,35,17,2,1
10,469,469,16,16,0,1,0
11,474,474,115,115,0,1,0
14,476,476,50,2,48,3,2

15,115,115,9,9,0,1,0
17,132,132,1,1,0,1,0
23,138,138,15,15,0,1,0
10,174,174,6,6,0,1,0
8,185,185,21,15,6,3,2
14,186,186,1,1,0,1,0
19,187,187,18,18,0,1,0
9,189,189,5,5,0,1,0
13,192,192,9,9,0,1,0
6,196,196,38,28,10,2,1
3,204,204,11,11,0,1,0
25,245,245,146,62,84,4,3
12,332,332,20,5,15,2,1
0,381,381,20,20,0,1,0
16,395,395,51,16,35,2,1
5,400,400,33,23,10,2,1
7,402,402,33,28,5,2,1
11,408,408,72,72,0,1,0
18,411,411,12,2,10,3,2
20,414,414,24,1,23,2,1
22,418,418,61,30,31,2,1
24,428,428,1,1,0,1,0
1,472,472,6,6,0,1,0
2,477,477,35,8,27,2,1
21,487,487,12,12,0,1,0
4,494,494,167,143,24,3,2

23,100,100,29,20,9,4,3
8,102,102,12,12,0,1,0
9,116,116,5,5,0,1,0
11,117,117,9,9,0,1,0
17,120,120,22,22,0,1,0
22,125,125,27,27,0,1,0
1,162,162,1,1,0,1,0
19,169,169,7,7,0,1,0
15,170,170,3,3,0,1,0
13,171,171,1,1,0,1,0
7,182,182,13,4,9,4,3
5,197,197,1,1,0,1,0
0,217,217,60,60,0,1,0
12,247,247,7,7,0,1,0
10,295,295,6,6,0,1,0
3,310,310,30,25,5,2,1
6,335,335,23,23,0,1,0
21,354,354,7,7,0,1,0
2,364,364,25,25,0,1,0
20,365,365,52,52,0,1,0
18,389,389,8,8,0,1,0
4,390,390,205,205,0,1,0
16,397,397,54,14,40,2,1
14,474,474,72,9,63,4,3

14,127,127,12,2,10,3,2
26,129,129,25,25,0,1,0
16,138,138,3,3,0,1,0
23,150,150,38,7,31,4,3
1,159,159,8,8,0,1,0
8,202,202,25,25,0,1,0
27,203,203,10,10,0,1,0
11,233,233,24,15,9,4,3
15,236,236,33,33,0,1,0
18,239,239,30,14,16,2,1
12,247,247,1,1,0,1,0
20,270,270,6,6,0,1,0
4,274,274,15,15,0,1,0
6,277,277,24,24,0,1,0
24,293,293,3,3,0,1,0
9,322,322,14,14,0,1,0
10,351,351,67,67,0,1,0
25,360,360,121,43,78,4,3
22,361,361,15,3,12,4,3
3,374,374,38,27,11,2,1
7,389,389,37,3,34,3,2
2,408,408,15,1,14,3,2
13,418,418,30,14,16,2,1
19,422,422,30,20,10,3,2
5,432,432,56,56,0,1,0
17,449,449,7,1,6,2,1
21,489,489,25,12,13,2,1
0,497,497,58,58,0,1,0

7,115,115,4,4,0,1,0
17,128,128,1,1,0,1,0
1,143,143,1,1,0,1,0
2,163,163,1,1,0,1,0
0,164,164,10,10,0,1,0
9,179,179,108,11,97,4,3
4,188,188,36,6,30,2,1
19,190,190,37,16,21,2,1
24,194,194,9,9,0,1,0
22,203,203,32,2,30,3,2
21,223,223,82,32,50,3,2
15,228,228,4,4,0,1,0
20,252,252,14,1,13,2,1
14,256,256,17,17,0,1,0
10,269,269,17,2,15,4,3
5,313,313,20,20,0,1,0
3,333,333,6,6,0,1,0
23,343,343,19,19,0,1,0
13,386,386,20,20,0,1,0
16,396,396,30,10,20,2,1
6,401,401,69,69,0,1,0
11,413,413,28,28,0,1,0
8,432,432,5,2,3,2,1
18,435,435,3,3,0,1,0
12,460,460,101,101,0,1,0

13,100,100,10,10,0,1,0
21,103,103,1,1,0,1,0
3,116,116,32,6,26,3,2
15,129,129,5,2,3,2,1
1,132,132,17,17,0,1,0
16,141,141,19,13,6,3,2
20,153,153,35,7,28,3,2
10,173,173,6,6,0,1,0
12,182,182,5,1,4,2,1
17,189,189,46,46,0,1,0
6,220,220,11,11,0,1,0
19,225,225,6,6,0,1,0
9,249,249,6,6,0,1,0
4,298,298,12,9,3,2,1
2,304,304,47,14,33,4,3
11,311,311,16,3,13,2,1
14,349,349,119,93,26,2,1
18,369,369,19,1,18,2,1
7,371,371,74,10,64,3,2
22,396,396,23,23,0,1,0
8,419,419,80,80,0,1,0
5,423,423,99,88,11,2,1
0,491,491,1,1,0,1,0

21,101,101,28,28,0,1,0
5,105,105,10,10,0,1,0
0,105,105,1,1,0,1,0
20,158,158,37,37,0,1,0
22,161,161,2,2,0,1,0
9,163,163,80,80,0,1,0
19,176,176,60,60,0,1,0
4,189,189,14,14,0,1,0
16,190,190,2,2,0,1,0
12,212,212,2,2,0,1,0
3,222,222,33,33,0,1,0
14,225,225,25,25,0,1,0
2,228,228,4,4,0,1,0
23,230,230,5,5,0,1,0
10,257,257,6,6,0,1,0
1,278,278,4,4,0,1,0
24,278,278,22,12,10,2,1
7,309,309,28,12,16,3,2
8,341,341,1,1,0,1,0
25,377,377,35,35,0,1,0
18,379,379,15,15,0,1,0
17,388,388,10,2,8,2,1
15,435,435,2,2,0,1,0
11,449,449,16,7,9,4,3
6,452,452,132,49,83,4,3
13,477,477,41,31,10,2,1

3,136,136,25,25,0,1,0
5,139,139,1,1,0,1,0
29,142,142,5,5,0,1,0
1,160,160,2,2,0,1,0
27,183,183,12,12,0,1,0
6,205,205,8,8,0,1,0
20,215,215,3,3,0,1,0
23,228,228,12,12,0,1,0
11,229,229,9,1,8,3,2
7,231,231,4,4,0,1,0
24,255,255,8,8,0,1,0
35,292,292,59,59,0,1,0
13,305,305,4,4,0,1,0
8,313,313,29,29,0,1,0
9,316,316,11,3,8,2,1
14,316,316,10,10,0,1,0
34,317,317,70,67,3,2,1
22,332,332,9,9,0,1,0
30,335,335,123,123,0,1,0
4,358,358,87,87,0,1,0
28,358,358,3,3,0,1,0
17,383,383,21,21,0,1,0
12,394,394,14,14,0,1,0
32,397,397,22,5,17,2,1
10,403,403,34,21,13,2,1
0,409,409,6,6,0,1,0
21,409,409,25,16,9,4,3
18,409,409,13,6,7,2,1
2,410,410,42,34,8,3,2
16,422,422,12,12,0,1,0
26,424,424,31,31,0,1,0
31,429,429,1,1,0,1,0
19,434,434,39,39,0,1,0
25,457,457,63,63,0,1,0
15,477,477,21,21,0,1,0
33,500,500,35,35,0,1,0

14,104,104,5,5,0,1,0
19,112,112,12,1,11,2,1
18,123,123,1,1,0,1,0
6,134,134,36,15,21,2,1
9,145,145,21,13,8,3,2
11,154,154,4,4,0,1,0
5,191,191,17,17,0,1,0
2,211,211,7,1,6,3,2
1,228,228,6,6,0,1,0
8,276,276,11,11,0,1,0
20,277,277,13,3,10,2,1
10,279,279,1,1,0,1,0
22,280,280,8,8,0,1,0
23,297,297,15,15,0,1,0
3,325,325,3,3,0,1,0
16,334,334,14,14,0,1,0
21,365,365,15,11,4,2,1
7,370,370,59,59,0,1,0
12,371,371,164,127,37,2,1
0,373,373,36,36,0,1,0
13,379,379,57,43,14,3,2
17,415,415,103,103,0,1,0
4,419,419,180,100,80,3,2
15,461,461,44,44,0,1,0

3,103,103,3,3,0,1,0
14,114,114,1,1,0,1,0
6,120,120,7,7,0,1,0
2,133,133,2,2,0,1,0
16,135,135,8,1,7,2,1
4,138,138,49,20,29,3,2
10,140,140,3,3,0,1,0
9,147,147,5,2,3,2,1
12,154,154,4,4,0,1,0
5,155,155,10,6,4,2,1
18,164,164,34,2,32,2,1
24,178,178,17,1,16,2,1
13,207,207,58,28,30,4,3
17,260,260,4,4,0,1,0
11,262,262,18,18,0,1,0
19,272,272,90,66,24,2,1
8,280,280,14,14,0,1,0
20,321,321,33,20,13,2,1
22,328,328,21,9,12,4,3
23,380,380,42,18,24,3,2
0,401,401,15,1,14,2,1
21,437,437,2,2,0,1,0
15,474,474,15,15,0,1,0
7,487,487,54,32,22,2,1
1,493,493,226,198,28,2,1

15,118,118,4,4,0,1,0
0,147,147,33,24,9,4,3
12,161,161,57,57,0,1,0
16,169,169,26,8,18,3,2
4,179,179,13,13,0,1,0
6,223,223,72,27,45,4,3
11,248,248,59,20,39,4,3
13,276,276,14,14,0,1,0
18,284,284,5,5,0,1,0
7,307,307,7,7,0,1,0
9,329,329,16,16,0,1,0
5,378,378,25,1,24,3,2
2,412,412,96,96,0,1,0
3,428,428,19,19,0,1,0
1,437,437,112,36,76,4,3
14,439,439,41,25,16,3,2
17,444,444,66,18,48,2,1
8,455,455,27,5,22,2,1
10,462,462,76,76,0,1,0
20,476,476,1,1,0,1,0
21,483,483,7,7,0,1,0
19,490,490,2,2,0,1,0

18,106,106,16,16,0,1,0
1,117,117,22,14,8,2,1
12,121,121,28,28,0,1,0
15,132,132,12,3,9,2,1
11,137,137,4,4,0,1,0
21,141,141,9,3,6,2,1
9,179,179,4,4,0,1,0
2,185,185,7,7,0,1,0
22,189,189,8,8,0,1,0
0,192,192,7,2,5,2,1
17,248,248,11,11,0,1,0
20,278,278,49,10,39,2,1
6,311,311,54,54,0,1,0
3,318,318,2,2,0,1,0
13,329,329,15,15,0,1,0
16,334,334,93,29,64,3,2
10,342,342,111,23,88,3,2
4,361,361,6,2,4,2,1
5,395,395,51,51,0,1,0
23,407,407,6,1,5,2,1
14,414,414,16,16,0,1,0
7,424,424,97,97,0,1,0
19,480,480,59,54,5,2,1
8,500,500,69,69,0,1,0

9,166,166,55,31,24,4,3
3,176,176,21,8,13,2,1
8,180,180,38,38,0,1,0
0,191,191,68,68,0,1,0
11,198,198,17,5,12,2,1
16,203,203,5,5,0,1,0
20,235,235,30,30,0,1,0
2,239,239,9,9,0,1,0
6,261,261,2,2,0,1,0
15,264,264,23,5,18,4,3
13,303,303,19,19,0,1,0
1,325,325,2,2,0,1,0
7,330,330,15,15,0,1,0
18,361,361,61,21,40,2,1
5,368,368,1,1,0,1,0
12,369,369,9,9,0,1,0
23,399,399,71,71,0,1,0
14,406,406,5,5,0,1,0
4,406,406,40,40,0,1,0
22,423,423,202,169,33,4,3
19,425,425,20,20,0,1,0
10,446,446,38,22,16,2,1
17,478,478,10,10,0,1,0
21,495,495,2,2,0,1,0

19,136,136,20,17,3,2,1
10,139,139,2,2,0,1,0
23,146,146,4,4,0,1,0
2,157,157,1,1,0,1,0
21,194,194,18,4,14,2,1
14,197,197,81,7,74,3,2
7,218,218,17,17,0,1,0
4,233,233,27,27,0,1,0
0,263,263,52,19,33,4,3
9,281,281,17,1,16,2,1
15,287,287,9,9,0,1,0
17,289,289,51,51,0,1,0
22,305,305,39,29,10,2,1
18,367,367,2,2,0,1,0
1,370,370,99,99,0,1,0
20,382,382,71,22,49,3,2
16,391,391,1,1,0,1,0
3,401,401,90,75,15,4,3
13,416,416,14,6,8,2,1
8,421,421,45,4,41,4,3
6,426,426,29,29,0,1,0
12,438,438,4,4,0,1,0
5,455,455,76,54,22,2,1
11,496,496,34,6,28,3,2

18,173,173,10,10,0,1,0
2,186,186,3,3,0,1,0
22,190,190,14,14,0,1,0
24,196,196,6,6,0,1,0
0,204,204,20,20,0,1,0
3,216,216,41,2,39,4,3
4,225,225,23,5,18,2,1
5,236,236,64,20,44,2,1
25,238,238,31,27,4,2,1
17,242,242,39,12,27,4,3
1,248,248,28,7,21,2,1
11,262,262,44,6,38,2,1
6,290,290,27,15,12,3,2
21,311,311,92,9,83,4,3
14,323,323,34,34,0,1,0
8,333,333,17,7,10,3,2
19,352,352,22,22,0,1,0
16,359,359,24,3,21,2,1
23,360,360,2,2,0,1,0
20,367,367,34,8,26,3,2
12,374,374,5,5,0,1,0
15,388,388,84,15,69,3,2
13,423,423,12,12,0,1,0
7,460,460,28,10,18,2,1
10,464,464,40,40,0,1,0
9,482,482,18,18,0,1,0

14,131,131,1,1,0,1,0
7,138,138,18,18,0,1,0
8,158,158,1,1,0,1,0
21,180,180,10,10,0,1,0
3,205,205,37,17,20,2,1
9,214,214,21,13,8,3,2
19,217,217,73,47,26,3,2
16,226,226,14,14,0,1,0
6,228,228,3,3,0,1,0
18,243,243,26,26,0,1,0
10,294,294,4,4,0,1,0
17,298,298,22,2,20,3,2
4,331,331,107,20,87,4,3
2,344,344,15,15,0,1,0
1,347,347,49,5,44,2,1
11,350,350,50,6,44,4,3
20,358,358,2,2,0,1,0
23,395,395,16,16,0,1,0
13,405,405,3,3,0,1,0
5,420,420,38,38,0,1,0
12,434,434,184,142,42,3,2
22,437,437,17,7,10,2,1
15,443,443,9,9,0,1,0
0,478,478,124,56,68,3,2

11,108,108,1,1,0,1,0
2,112,112,14,14,0,1,0
1,113,113,15,9,6,2,1
22,115,115,19,19,0,1,0
10,126,126,24,24,0,1,0
21,147,147,21,3,18,2,1
25,153,153,13,13,0,1,0
6,172,172,1,1,0,1,0
23,202,202,30,30,0,1,0
7,202,202,53,53,0,1,0
0,205,205,7,2,5,2,1
5,264,264,8,8,0,1,0
3,269,269,3,3,0,1,0
19,284,284,12,12,0,1,0
15,289,289,14,14,0,1,0
4,305,305,6,6,0,1,0
9,335,335,14,10,4,2,1
24,386,386,5,5,0,1,0
18,399,399,9,9,0,1,0
17,418,418,15,15,0,1,0
13,419,419,68,65,3,2,1
8,424,424,184,50,134,4,3
12,425,425,2,2,0,1,0
20,429,429,9,6,3,2,1
14,438,438,11,5,6,3,2
16,500,500,208,61,147,4,3

4,113,113,8,8,0,1,0
0,117,117,1,1,0,1,0
9,125,125,12,5,7,2,1
15,130,130,1,1,0,1,0
10,136,136,5,1,4,2,1
16,167,167,13,1,12,3,2
17,179,179,19,19,0,1,0
14,189,189,62,30,32,2,1
6,190,190,29,2,27,4,3
19,192,192,34,16,18,2,1
2,196,196,8,3,5,2,1
13,197,197,2,2,0,1,0
1,220,220,78,24,54,3,2
21,227,227,8,8,0,1,0
24,236,236,4,1,3,2,1
8,302,302,28,13,15,4,3
20,305,305,24,5,19,3,2
22,351,351,4,1,3,2,1
11,422,422,52,49,3,2,1
18,423,423,4,4,0,1,0
23,428,428,30,30,0,1,0
12,442,442,175,175,0,1,0
3,454,454,25,9,16,3,2
7,456,456,66,66,0,1,0
5,467,467,58,24,34,2,1

8,124,124,11,6,5,2,1
12,133,133,1,1,0,1,0
6,155,155,2,2,0,1,0
18,157,157,6,6,0,1,0
5,169,169,55,55,0,1,0
16,205,205,24,12,12,4,3
13,242,242,47,47,0,1,0
10,252,252,4,4,0,1,0
1,257,257,1,1,0,1,0
17,259,259,3,3,0,1,0
7,265,265,44,44,0,1,0
0,277,277,16,4,12,4,3
3,286,286,27,27,0,1,0
14,309,309,10,10,0,1,0
4,322,322,77,47,30,3,2
9,346,346,73,73,0,1,0
2,358,358,37,37,0,1,0
21,398,398,5,5,0,1,0
15,429,429,33,7,26,3,2
19,429,429,106,42,64,3,2
20,475,475,109,97,12,4,3
11,490,490,154,58,96,4,3
22,491,491,12,7,5,2,1

4,100,100,11,11,0,1,0
12,131,131,5,5,0,1,0
7,145,145,41,6,35,3,2
20,151,151,10,10,0,1,0
16,187,187,10,10,0,1,0
21,202,202,35,13,22,3,2
22,231,231,53,41,12,4,3
17,250,250,3,3,0,1,0
15,255,255,43,43,0,1,0
8,261,261,23,11,12,4,3
14,265,265,58,58,0,1,0
1,268,268,11,11,0,1,0
5,273,273,1,1,0,1,0
2,310,310,95,92,3,2,1
19,325,325,3,3,0,1,0
13,344,344,2,2,0,1,0
3,390,390,96,72,24,2,1
18,422,422,2,2,0,1,0
9,425,425,9,9,0,1,0
10,447,447,149,140,9,4,3
11,473,473,7,7,0,1,0
0,485,485,51,48,3,2,1
6,499,499,48,8,40,3,2

2,109,109,5,2,3,2,1
14,114,114,1,1,0,1,0
25,127,127,1,1,0,1,0
8,134,134,12,12,0,1,0
17,134,134,10,1,9,2,1
19,163,163,11,11,0,1,0
27,176,176,13,13,0,1,0
6,207,207,1,1,0,1,0
11,240,240,3,3,0,1,0
16,258,258,16,2,14,3,2
23,261,261,7,7,0,1,0
7,282,282,2,2,0,1,0
18,289,289,81,21,60,4,3
1,291,291,18,18,0,1,0
20,297,297,14,5,9,2,1
26,308,308,103,60,43,2,1
28,333,333,2,2,0,1,0
10,347,347,46,2,44,2,1
9,361,361,3,3,0,1,0
12,385,385,25,25,0,1,0
21,386,386,7,7,0,1,0
3,396,396,8,5,3,2,1
0,411,411,31,31,0,1,0
22,452,452,145,141,4,2,1
13,476,476,25,4,21,4,3
15,483,483,289,247,42,4,3
4,486,486,53,17,36,2,1
24,495,495,5,5,0,1,0
5,498,498,5,1,4,2,1

8,107,107,1,1,0,1,0
26,114,114,8,2,6,3,2
20,114,114,3,3,0,1,0
4,131,131,20,20,0,1,0
16,131,131,8,5,3,2,1
27,132,132,14,2,12,3,2
19,138,138,11,11,0,1,0
25,158,158,4,4,0,1,0
14,163,163,22,22,0,1,0
15,187,187,18,18,0,1,0
21,245,245,40,40,0,1,0
23,253,253,11,11,0,1,0
5,314,314,39,39,0,1,0
22,344,344,98,98,0,1,0
11,348,348,37,16,21,2,1
18,380,380,4,4,0,1,0
10,388,388,45,45,0,1,0
13,389,389,49,49,0,1,0
7,404,404,9,9,0,1,0
2,410,410,30,30,0,1,0
6,411,411,65,65,0,1,0
24,425,425,90,38,52,4,3
17,441,441,68,68,0,1,0
1,441,441,8,8,0,1,0
3,451,451,12,12,0,1,0
9,452,452,34,34,0,1,0
12,458,458,45,18,27,4,3
0,474,474,30,14,16,3,2

14,110,110,13,13,0,1,0
13,199,199,20,20,0,1,0
20,214,214,1,1,0,1,0
10,215,215,6,6,0,1,0
4,274,274,43,43,0,1,0
16,284,284,13,13,0,1,0
3,315,315,39,12,27,2,1
12,315,315,5,2,3,2,1
0,318,318,35,21,14,3,2
6,346,346,54,54,0,1,0
1,354,354,30,30,0,1,0
17,368,368,26,26,0,1,0
5,371,371,83,83,0,1,0
18,385,385,3,3,0,1,0
8,399,399,36,36,0,1,0
22,415,415,7,7,0,1,0
19,447,447,80,56,24,4,3
21,452,452,70,58,12,2,1
11,468,468,178,163,15,4,3
15,482,482,95,45,50,2,1
2,486,486,1,1,0,1,0
9,487,487,45,45,0,1,0
7,492,492,128,74,54,4,3

13,115,115,18,18,0,1,0
2,124,124,17,12,5,2,1
6,201,201,2,2,0,1,0
1,209,209,23,23,0,1,0
10,223,223,6,2,4,2,1
11,239,239,14,14,0,1,0
0,252,252,54,7,47,2,1
19,262,262,7,1,6,2,1
4,293,293,15,4,11,2,1
3,315,315,245,193,52,3,2
17,346,346,84,13,71,4,3
18,363,363,90,8,82,3,2
7,384,384,35,14,21,2,1
15,398,398,18,18,0,1,0
9,418,418,86,86,0,1,0
8,442,442,61,61,0,1,0
14,459,459,10,10,0,1,0
5,484,484,2,2,0,1,0
16,488,488,25,25,0,1,0
12,498,498,4,4,0,1,0

10,102,102,7,7,0,1,0
19,122,122,2,2,0,1,0
17,124,124,50,50,0,1,0
0,165,165,69,32,37,2,1
21,186,186,1,1,0,1,0
7,206,206,1,1,0,1,0
5,209,209,6,6,0,1,0
8,221,221,15,3,12,2,1
20,233,233,16,16,0,1,0
11,236,236,33,18,15,2,1
15,263,263,1,1,0,1,0
14,274,274,5,5,0,1,0
4,308,308,53,48,5,2,1
2,331,331,62,6,56,3,2
12,337,337,60,60,0,1,0
3,338,338,83,26,57,4,3
16,346,346,28,10,18,4,3
9,362,362,118,88,30,3,2
18,381,381,8,8,0,1,0
6,401,401,58,58,0,1,0
13,404,404,3,3,0,1,0
1,427,427,14,14,0,1,0

5,101,101,1,1,0,1,0
11,116,116,17,17,0,1,0
6,145,145,4,4,0,1,0
9,178,178,54,54,0,1,0
17,190,190,18,1,17,2,1
28,211,211,64,52,12,2,1
8,226,226,9,9,0,1,0
20,232,232,82,10,72,4,3
7,269,269,7,7,0,1,0
1,277,277,7,2,5,2,1
19,299,299,2,2,0,1,0
4,300,300,1,1,0,1,0
21,315,315,10,2,8,2,1
16,320,320,2,2,0,1,0
25,328,328,78,33,45,2,1
10,332,332,24,24,0,1,0
29,334,334,8,8,0,1,0
0,341,341,42,42,0,1,0
26,362,362,4,4,0,1,0
12,373,373,1,1,0,1,0
15,374,374,37,30,7,2,1
22,381,381,9,9,0,1,0
14,384,384,20,20,0,1,0
24,414,414,16,12,4,2,1
27,433,433,12,12,0,1,0
2,436,436,78,52,26,2,1
18,449,449,3,3,0,1,0
3,451,451,54,54,0,1,0
23,456,456,75,75,0,1,0
13,464,464,30,30,0,1,0

1,124,124,11,11,0,1,0
22,126,126,3,3,0,1,0
0,150,150,12,2,10,3,2
26,163,163,3,3,0,1,0
5,171,171,27,27,0,1,0
25,173,173,33,33,0,1,0
4,176,176,21,21,0,1,0
13,189,189,25,6,19,4,3
24,209,209,53,53,0,1,0
23,230,230,25,25,0,1,0
21,241,241,8,8,0,1,0
2,247,247,2,2,0,1,0
19,285,285,3,3,0,1,0
10,292,292,1,1,0,1,0
17,303,303,41,41,0,1,0
27,312,312,9,2,7,2,1
16,318,318,44,44,0,1,0
7,318,318,38,18,20,2,1
3,320,320,16,16,0,1,0
20,338,338,93,73,20,2,1
18,347,347,5,5,0,1,0
14,403,403,57,14,43,4,3
9,405,405,45,45,0,1,0
12,422,422,55,22,33,4,3
6,452,452,20,6,14,3,2
15,469,469,47,11,36,2,1
8,471,471,16,16,0,1,0
11,487,487,39,10,29,2,1

14,137,137,6,6,0,1,0
18,143,143,2,2,0,1,0
12,144,144,7,7,0,1,0
23,151,151,19,2,17,2,1
7,183,183,10,10,0,1,0
24,186,186,6,2,4,2,1
19,187,187,25,25,0,1,0
22,229,229,3,3,0,1,0
1,244,244,18,18,0,1,0
9,251,251,42,20,22,3,2
16,273,273,1,1,0,1,0
0,293,293,38,11,27,4,3
11,305,305,106,37,69,4,3
20,320,320,3,3,0,1,0
15,331,331,79,66,13,2,1
5,334,334,48,48,0,1,0
26,365,365,59,59,0,1,0
2,367,367,5,5,0,1,0
6,386,386,7,7,0,1,0
3,404,404,54,9,45,2,1
21,407,407,101,101,0,1,0
4,446,446,1,1,0,1,0
8,450,450,11,11,0,1,0
17,470,470,45,12,33,2,1
25,483,483,106,6,100,3,2
10,491,491,52,52,0,1,0
13,493,493,19,1,18,4,3

1,150,150,4,4,0,1,0
19,158,158,26,13,13,2,1
5,198,198,19,19,0,1,0
26,199,199,23,6,17,2,1
20,253,253,5,5,0,1,0
7,256,256,11,11,0,1,0
17,270,270,14,14,0,1,0
23,272,272,8,1,7,2,1
3,274,274,10,10,0,1,0
14,284,284,33,33,0,1,0
22,311,311,12,12,0,1,0
18,320,320,28,22,6,3,2
12,332,332,24,12,12,3,2
25,334,334,108,47,61,4,3
11,360,360,30,9,21,2,1
0,363,363,106,92,14,3,2
8,381,381,41,41,0,1,0
16,383,383,24,24,0,1,0
15,396,396,65,29,36,4,3
13,396,396,12,12,0,1,0
2,418,418,21,5,16,3,2
6,438,438,27,27,0,1,0
21,447,447,41,41,0,1,0
9,466,466,56,56,0,1,0
10,475,475,14,9,5,2,1
24,481,481,28,13,15,4,3
4,491,491,124,56,68,4,3

5,136,136,2,2,0,1,0
21,169,169,24,19,5,2,1
29,177,177,9,5,4,2,1
30,189,189,36,36,0,1,0
23,205,205,5,1,4,2,1
13,212,212,1,1,0,1,0
3,228,228,10,10,0,1,0
22,237,237,14,14,0,1,0
19,249,249,27,27,0,1,0
32,255,255,7,4,3,2,1
27,284,284,30,30,0,1,0
28,317,317,6,6,0,1,0
8,326,326,10,3,7,2,1
11,330,330,13,13,0,1,0
17,340,340,19,1,18,3,2
9,353,353,1,1,0,1,0
15,365,365,6,6,0,1,0
34,372,372,32,32,0,1,0
1,380,380,7,1,6,2,1
12,387,387,21,6,15,4,3
31,393,393,133,124,9,2,1
6,394,394,2,2,0,1,0
7,395,395,54,54,0,1,0
2,401,401,97,32,65,4,3
33,405,405,39,39,0,1,0
4,406,406,5,5,0,1,0
10,416,416,3,3,0,1,0
20,420,420,60,60,0,1,0
18,421,421,17,11,6,3,2
14,428,428,13,13,0,1,0
0,435,435,16,1,15,4,3
26,439,439,4,4,0,1,0
35,449,449,2,2,0,1,0
24,459,459,149,69,80,3,2
25,482,482,22,22,0,1,0
16,499,499,29,29,0,1,0

24,103,103,15,15,0,1,0
30,126,126,12,12,0,1,0
7,128,128,31,31,0,1,0
10,137,137,1,1,0,1,0
4,165,165,15,6,9,2,1
26,174,174,7,2,5,2,1
28,213,213,17,14,3,2,1
25,219,219,6,6,0,1,0
0,221,221,11,7,4,2,1
21,235,235,54,54,0,1,0
2,237,237,3,3,0,1,0
23,244,244,27,27,0,1,0
14,265,265,5,5,0,1,0
1,267,267,16,6,10,3,2
29,270,270,21,21,0,1,0
6,274,274,5,5,0,1,0
18,287,287,6,6,0,1,0
27,304,304,3,3,0,1,0
20,312,312,38,1,37,3,2
13,325,325,80,47,33,4,3
9,329,329,28,28,0,1,0
8,333,333,34,16,18,2,1
19,351,351,27,27,0,1,0
17,381,381,10,10,0,1,0
12,398,398,19,19,0,1,0
16,411,411,54,32,22,2,1
5,442,442,19,19,0,1,0
3,471,471,30,30,0,1,0
15,479,479,9,9,0,1,0
11,499,499,18,2,16,3,2
22,500,500,147,9,138,4,3

31,100,100,8,8,0,1,0
17,122,122,6,6,0,1,0
6,123,123,7,1,6,2,1
5,135,135,9,9,0,1,0
25,154,154,22,22,0,1,0
23,157,157,38,38,0,1,0
10,170,170,30,27,3,2,1
13,187,187,9,9,0,1,0
28,190,190,20,17,3,2,1
24,190,190,12,2,10,3,2
20,210,210,1,1,0,1,0
27,213,213,4,4,0,1,0
26,213,213,53,53,0,1,0
19,236,236,8,8,0,1,0
9,255,255,11,11,0,1,0
30,264,264,16,16,0,1,0
18,276,276,13,13,0,1,0
14,297,297,4,4,0,1,0
16,297,297,19,19,0,1,0
8,305,305,7,3,4,2,1
7,344,344,49,9,40,4,3
1,346,346,24,24,0,1,0
22,347,347,69,40,29,2,1
2,353,353,16,4,12,4,3
29,382,382,7,7,0,1,0
12,415,415,17,8,9,4,3
21,418,418,48,48,0,1,0
15,419,419,32,32,0,1,0
0,455,455,128,105,23,2,1
11,472,472,6,6,0,1,0
4,473,473,3,3,0,1,0
3,488,488,19,19,0,1,0

22,100,100,1,1,0,1,0
19,102,102,4,4,0,1,0
16,144,144,18,18,0,1,0
6,155,155,20,20,0,1,0
7,174,174,4,4,0,1,0
9,189,189,2,2,0,1,0
24,212,212,9,6,3,2,1
21,216,216,33,33,0,1,0
23,244,244,10,10,0,1,0
26,252,252,5,1,4,2,1
1,254,254,13,13,0,1,0
13,265,265,4,1,3,2,1
27,292,292,1,1,0,1,0
12,315,315,1,1,0,1,0
5,321,321,12,8,4,2,1
14,324,324,83,83,0,1,0
0,354,354,2,2,0,1,0
20,364,364,44,44,0,1,0
8,365,365,24,6,18,2,1
2,382,382,26,23,3,2,1
10,385,385,4,4,0,1,0
15,391,391,11,11,0,1,0
4,410,410,90,60,30,2,1
25,422,422,263,236,27,2,1
18,423,423,24,24,0,1,0
3,429,429,139,139,0,1,0
17,453,453,35,4,31,4,3
11,495,495,41,41,0,1,0

25,149,149,47,2,45,4,3
22,153,153,4,4,0,1,0
29,177,177,8,8,0,1,0
16,179,179,7,1,6,3,2
26,184,184,7,3,4,2,1
9,196,196,9,9,0,1,0
27,209,209,2,2,0,1,0
1,211,211,3,3,0,1,0
21,217,217,43,7,36,4,3
18,267,267,3,3,0,1,0
7,272,272,1,1,0,1,0
19,279,279,9,5,4,2,1
10,305,305,77,77,0,1,0
14,313,313,19,5,14,3,2
28,331,331,1,1,0,1,0
4,339,339,8,8,0,1,0
23,342,342,39,39,0,1,0
8,364,364,1,1,0,1,0
11,374,374,6,1,5,2,1
3,382,382,1,1,0,1,0
12,402,402,18,18,0,1,0
17,417,417,62,62,0,1,0
20,425,425,102,15,87,4,3
5,442,442,95,20,75,4,3
6,455,455,9,3,6,2,1
0,458,458,47,28,19,2,1
13,464,464,90,75,15,2,1
15,476,476,101,101,0,1,0
2,486,486,26,26,0,1,0
24,494,494,73,73,0,1,0

16,115,115,3,3,0,1,0
1,125,125,3,3,0,1,0
12,182,182,16,16,0,1,0
17,190,190,6,6,0,1,0
15,190,190,12,6,6,3,2
0,197,197,8,8,0,1,0
19,198,198,10,10,0,1,0
4,201,201,2,2,0,1,0
13,223,223,1,1,0,1,0
3,227,227,6,3,3,2,1
20,254,254,17,5,12,4,3
2,281,281,36,36,0,1,0
21,283,283,6,6,0,1,0
6,285,285,13,4,9,2,1
24,291,291,51,51,0,1,0
7,294,294,69,35,34,2,1
11,295,295,72,72,0,1,0
26,308,308,17,17,0,1,0
23,309,309,6,6,0,1,0
18,320,320,71,71,0,1,0
9,321,321,38,3,35,4,3
25,322,322,5,5,0,1,0
22,365,365,65,1,64,3,2
27,372,372,149,57,92,4,3
10,375,375,13,13,0,1,0
5,383,383,24,3,21,4,3
8,387,387,55,3,52,3,2
14,462,462,45,15,30,2,1

21,101,101,2,2,0,1,0
10,109,109,18,9,9,4,3
3,138,138,3,3,0,1,0
6,144,144,2,2,0,1,0
20,164,164,58,58,0,1,0
19,172,172,6,1,5,2,1
4,185,185,18,2,16,2,1
12,191,191,3,3,0,1,0
17,210,210,34,34,0,1,0
18,229,229,13,13,0,1,0
15,237,237,74,25,49,4,3
7,263,263,21,21,0,1,0
1,280,280,30,30,0,1,0
13,325,325,12,12,0,1,0
9,371,371,11,11,0,1,0
2,386,386,51,51,0,1,0
16,411,411,41,41,0,1,0
0,413,413,26,11,15,4,3
11,464,464,18,6,12,3,2
14,475,475,4,4,0,1,0
5,487,487,142,7,135,4,3
8,493,493,244,176,68,4,3

11,113,113,37,37,0,1,0
10,117,117,15,6,9,2,1
21,145,145,5,5,0,1,0
22,162,162,17,17,0,1,0
2,164,164,8,2,6,2,1
17,203,203,18,6,12,2,1
6,208,208,25,25,0,1,0
20,223,223,15,15,0,1,0
5,226,226,18,3,15,4,3
16,245,245,46,46,0,1,0
0,256,256,24,24,0,1,0
13,256,256,3,3,0,1,0
3,269,269,9,9,0,1,0
7,272,272,26,14,12,4,3
15,275,275,71,71,0,1,0
23,276,276,26,8,18,4,3
18,288,288,40,30,10,2,1
9,297,297,36,36,0,1,0
19,314,314,36,36,0,1,0
12,359,359,44,44,0,1,0
24,364,364,27,27,0,1,0
14,392,392,9,9,0,1,0
8,407,407,81,81,0,1,0
1,446,446,3,3,0,1,0
4,448,448,24,24,0,1,0

13,105,105,5,2,3,2,1
19,129,129,19,19,0,1,0
18,132,132,27,21,6,2,1
9,168,168,16,2,14,4,3
15,169,169,20,20,0,1,0
1,170,170,6,6,0,1,0
5,183,183,15,15,0,1,0
8,205,205,3,3,0,1,0
14,205,205,20,20,0,1,0
17,227,227,16,4,12,4,3
2,285,285,8,8,0,1,0
0,329,329,127,127,0,1,0
24,352,352,28,21,7,2,1
7,359,359,71,25,46,3,2
16,369,369,24,24,0,1,0
10,370,370,89,89,0,1,0
22,380,380,73,31,42,3,2
20,404,404,1,1,0,1,0
23,404,404,68,68,0,1,0
12,440,440,2,2,0,1,0
4,478,478,2,2,0,1,0
6,483,483,6,2,4,2,1
21,483,483,64,34,30,2,1
3,486,486,18,18,0,1,0
11,493,493,83,48,35,2,1

25,111,111,6,6,0,1,0
21,128,128,1,1,0,1,0
17,135,135,25,11,14,3,2
26,143,143,5,5,0,1,0
9,148,148,17,17,0,1,0
0,181,181,5,5,0,1,0
6,196,196,1,1,0,1,0
12,201,201,26,15,11,2,1
19,254,254,63,33,30,4,3
10,256,256,57,57,0,1,0
22,269,269,10,1,9,2,1
3,279,279,20,4,16,3,2
13,300,300,25,25,0,1,0
23,301,301,5,2,3,2,1
2,304,304,31,22,9,4,3
24,320,320,19,15,4,2,1
16,320,320,92,50,42,2,1
8,337,337,30,30,0,1,0
14,340,340,22,7,15,4,3
27,347,347,23,3,20,2,1
20,373,373,41,12,29,2,1
5,378,378,13,13,0,1,0
4,384,384,7,7,0,1,0
7,417,417,94,44,50,2,1
15,427,427,63,54,9,4,3
11,434,434,34,9,25,2,1
18,459,459,39,15,24,3,2
1,467,467,16,2,14,2,1

9,114,114,15,15,0,1,0
18,128,128,5,5,0,1,0
13,133,133,1,1,0,1,0
10,149,149,13,2,11,4,3
5,152,152,6,6,0,1,0
16,176,176,31,31,0,1,0
12,184,184,23,1,22,3,2
4,218,218,1,1,0,1,0
7,226,226,34,34,0,1,0
6,241,241,96,42,54,4,3
3,253,253,29,29,0,1,0
8,256,256,43,23,20,3,2
14,270,270,32,22,10,3,2
17,274,274,3,3,0,1,0
11,294,294,15,6,9,2,1
21,317,317,26,26,0,1,0
15,333,333,68,68,0,1,0
19,335,335,19,19,0,1,0
2,354,354,19,8,11,2,1
1,359,359,25,25,0,1,0
22,403,403,4,4,0,1,0
0,432,432,74,74,0,1,0
20,479,479,173,141,32,2,1

26,120,120,8,8,0,1,0
27,127,127,12,12,0,1,0
2,143,143,30,30,0,1,0
0,156,156,9,9,0,1,0
16,162,162,11,11,0,1,0
19,169,169,41,41,0,1,0
28,209,209,39,39,0,1,0
20,216,216,15,1,14,2,1
15,219,219,7,7,0,1,0
1,249,249,42,19,23,4,3
25,250,250,9,9,0,1,0
6,271,271,1,1,0,1,0
22,276,276,8,8,0,1,0
10,277,277,13,10,3,2,1
8,279,279,3,3,0,1,0
9,287,287,1,1,0,1,0
13,292,292,60,28,32,3,2
11,320,320,24,3,21,4,3
24,347,347,58,58,0,1,0
5,364,364,7,7,0,1,0
14,384,384,85,85,0,1,0
17,438,438,72,10,62,3,2
23,443,443,18,18,0,1,0
7,447,447,18,14,4,2,1
12,454,454,6,6,0,1,0
4,465,465,41,10,31,2,1
18,474,474,11,11,0,1,0
21,490,490,69,69,0,1,0
3,496,496,53,39,14,3,2

15,111,111,23,7,16,3,2
17,147,147,13,4,9,4,3
8,154,154,2,2,0,1,0
24,164,164,1,1,0,1,0
4,165,165,43,15,28,2,1
1,170,170,36,36,0,1,0
18,183,183,16,16,0,1,0
5,214,214,1,1,0,1,0
19,254,254,24,24,0,1,0
13,291,291,13,13,0,1,0
11,312,312,12,12,0,1,0
2,326,326,25,16,9,4,3
0,329,329,20,20,0,1,0
20,341,341,63,63,0,1,0
9,399,399,29,29,0,1,0
12,411,411,39,39,0,1,0
23,412,412,55,55,0,1,0
21,415,415,23,6,17,2,1
16,422,422,87,21,66,4,3
14,434,434,36,36,0,1,0
6,439,439,44,44,0,1,0
22,447,447,21,3,18,4,3
3,454,454,46,46,0,1,0
10,481,481,132,132,0,1,0
7,481,481,42,38,4,2,1

2,123,123,1,1,0,1,0
13,126,126,3,3,0,1,0
25,133,133,15,6,9,2,1
9,159,159,44,18,26,3,2
19,161,161,8,1,7,2,1
7,177,177,2,2,0,1,0
1,178,178,13,13,0,1,0
21,212,212,7,3,4,2,1
5,215,215,1,1,0,1,0
8,215,215,10,10,0,1,0
27,217,217,44,9,35,2,1
10,245,245,19,19,0,1,0
22,245,245,55,48,7,2,1
11,251,251,1,1,0,1,0
23,261,261,3,3,0,1,0
17,288,288,14,14,0,1,0
3,292,292,37,7,30,4,3
20,316,316,3,3,0,1,0
18,344,344,9,9,0,1,0
0,357,357,12,9,3,2,1
6,391,391,46,46,0,1,0
24,413,413,47,3,44,2,1
4,425,425,121,58,63,4,3
14,434,434,71,35,36,3,2
12,447,447,22,16,6,2,1
26,454,454,95,11,84,3,2
16,455,455,5,5,0,1,0
15,478,478,131,113,18,4,3

5,101,101,13,13,0,1,0
13,104,104,21,6,15,4,3
23,111,111,3,3,0,1,0
7,138,138,11,11,0,1,0
22,143,143,28,28,0,1,0
18,143,143,3,3,0,1,0
25,183,183,27,27,0,1,0
17,186,186,5,5,0,1,0
10,219,219,79,43,36,2,1
3,284,284,60,60,0,1,0
1,289,289,6,6,0,1,0
11,326,326,42,2,40,2,1
21,341,341,38,6,32,2,1
6,346,346,5,2,3,2,1
20,359,359,71,71,0,1,0
12,384,384,52,23,29,2,1
15,397,397,24,24,0,1,0
19,414,414,42,12,30,4,3
9,416,416,14,5,9,2,1
8,432,432,18,18,0,1,0
14,438,438,49,49,0,1,0
2,439,439,6,2,4,2,1
24,462,462,45,45,0,1,0
4,468,468,8,2,6,2,1
0,473,473,54,47,7,2,1
16,484,484,17,17,0,1,0

29,120,120,2,2,0,1,0
15,132,132,8,8,0,1,0
21,138,138,1,1,0,1,0
28,152,152,11,5,6,2,1
16,200,200,4,1,3,2,1
4,204,204,6,6,0,1,0
7,261,261,9,6,3,2,1
19,268,268,29,7,22,2,1
0,274,274,91,2,89,4,3
6,278,278,5,5,0,1,0
14,289,289,3,3,0,1,0
25,290,290,2,2,0,1,0
24,297,297,25,25,0,1,0
30,305,305,18,18,0,1,0
17,311,311,55,55,0,1,0
18,319,319,41,17,24,3,2
13,320,320,15,1,14,3,2
2,323,323,6,6,0,1,0
27,328,328,43,43,0,1,0
8,332,332,53,53,0,1,0
22,350,350,73,15,58,3,2
12,355,355,11,11,0,1,0
5,376,376,5,5,0,1,0
10,408,408,18,18,0,1,0
11,415,415,2,2,0,1,0
20,423,423,136,50,86,3,2
3,428,428,28,28,0,1,0
26,432,432,31,31,0,1,0
1,447,447,22,22,0,1,0
23,492,492,53,53,0,1,0
9,499,499,93,19,74,3,2

0,113,113,31,20,11,3,2
15,118,118,53,9,44,2,1
19,125,125,1,1,0,1,0
1,130,130,15,2,13,3,2
20,148,148,1,1,0,1,0
9,157,157,27,27,0,1,0
18,235,235,34,20,14,3,2
16,269,269,2,2,0,1,0
7,276,276,38,13,25,3,2
12,277,277,34,16,18,2,1
8,286,286,107,107,0,1,0
11,298,298,2,2,0,1,0
13,339,339,5,2,3,2,1
23,351,351,109,94,15,4,3
6,358,358,35,35,0,1,0
17,361,361,15,15,0,1,0
2,363,363,8,8,0,1,0
10,389,389,20,20,0,1,0
21,425,425,1,1,0,1,0
5,428,428,6,6,0,1,0
4,437,437,2,2,0,1,0
22,473,473,84,38,46,3,2
3,474,474,18,18,0,1,0
14,495,495,20,8,12,3,2

2,104,104,3,3,0,1,0
10,110,110,15,3,12,2,1
19,115,115,13,13,0,1,0
0,192,192,6,6,0,1,0
8,194,194,15,15,0,1,0
13,207,207,13,13,0,1,0
22,225,225,7,7,0,1,0
7,250,250,37,37,0,1,0
15,255,255,58,2,56,3,2
5,264,264,41,41,0,1,0
21,264,264,8,8,0,1,0
6,300,300,8,3,5,2,1
20,312,312,18,6,12,4,3
3,328,328,135,36,99,4,3
1,358,358,3,3,0,1,0
12,400,400,138,37,101,4,3
18,400,400,41,41,0,1,0
11,460,460,4,1,3,2,1
14,475,475,41,3,38,2,1
9,477,477,109,3,106,4,3
17,488,488,10,10,0,1,0
4,490,490,91,91,0,1,0
16,500,500,51,35,16,2,1

21,109,109,4,1,3,2,1
16,139,139,11,8,3,2,1
3,144,144,3,3,0,1,0
11,144,144,8,4,4,2,1
2,155,155,25,25,0,1,0
25,189,189,26,9,17,2,1
14,209,209,2,2,0,1,0
0,210,210,3,3,0,1,0
10,210,210,19,19,0,1,0
24,214,214,38,38,0,1,0
20,223,223,24,24,0,1,0
12,226,226,12,12,0,1,0
18,257,257,24,2,22,2,1
22,279,279,4,1,3,2,1
1,336,336,52,52,0,1,0
6,344,344,64,64,0,1,0
19,397,397,41,32,9,4,3
5,399,399,65,12,53,4,3
4,405,405,54,54,0,1,0
15,423,423,40,40,0,1,0
8,435,435,52,52,0,1,0
26,436,436,28,4,24,2,1
13,459,459,47,5,42,3,2
23,474,474,5,5,0,1,0
7,475,475,12,12,0,1,0
9,476,476,10,4,6,2,1
17,496,496,197,131,66,3,2

7,118,118,5,5,0,1,0
9,146,146,1,1,0,1,0
13,152,152,4,4,0,1,0
12,206,206,4,4,0,1,0
19,214,214,14,4,10,3,2
21,228,228,32,1,31,2,1
11,244,244,70,28,42,3,2
4,252,252,32,32,0,1,0
10,254,254,17,17,0,1,0
6,268,268,25,7,18,4,3
2,270,270,6,6,0,1,0
20,300,300,28,28,0,1,0
3,339,339,51,51,0,1,0
1,369,369,164,151,13,4,3
18,411,411,34,27,7,2,1
8,414,414,23,23,0,1,0
16,445,445,54,54,0,1,0
0,447,447,66,37,29,2,1
23,452,452,14,10,4,2,1
15,462,462,4,4,0,1,0
5,462,462,67,67,0,1,0
14,468,468,190,167,23,2,1
17,473,473,7,7,0,1,0
22,481,481,13,3,10,3,2

14,139,139,6,6,0,1,0
27,143,143,30,6,24,3,2
18,159,159,30,30,0,1,0
15,197,197,5,1,4,2,1
11,227,227,19,19,0,1,0
24,237,237,35,7,28,2,1
22,264,264,42,6,36,2,1
23,271,271,59,59,0,1,0
7,281,281,18,9,9,4,3
9,289,289,9,4,5,2,1
6,295,295,3,3,0,1,0
1,300,300,40,9,31,4,3
10,315,315,15,8,7,2,1
0,325,325,82,44,38,4,3
21,350,350,43,40,3,2,1
19,353,353,10,10,0,1,0
20,355,355,26,26,0,1,0
13,419,419,73,29,44,3,2
25,426,426,3,3,0,1,0
26,436,436,23,5,18,3,2
2,442,442,52,52,0,1,0
4,444,444,20,20,0,1,0
8,452,452,93,93,0,1,0
3,458,458,13,7,6,2,1
16,466,466,20,20,0,1,0
17,468,468,11,3,8,3,2
12,469,469,11,11,0,1,0
28,475,475,22,5,17,2,1
5,479,479,8,8,0,1,0

30,100,100,27,9,18,3,2
26,116,116,5,5,0,1,0
11,123,123,9,9,0,1,0
34,134,134,11,11,0,1,0
18,138,138,5,5,0,1,0
32,155,155,1,1,0,1,0
36,157,157,8,8,0,1,0
20,160,160,21,13,8,2,1
15,163,163,1,1,0,1,0
35,164,164,13,13,0,1,0
6,180,180,12,1,11,2,1
37,214,214,44,44,0,1,0
10,231,231,14,14,0,1,0
7,240,240,10,10,0,1,0
21,260,260,17,6,11,2,1
38,282,282,71,71,0,1,0
9,313,313,1,1,0,1,0
0,320,320,23,23,0,1,0
33,345,345,22,12,10,3,2
4,348,348,5,5,0,1,0
29,356,356,22,22,0,1,0
16,366,366,15,11,4,2,1
25,379,379,28,28,0,1,0
31,381,381,3,3,0,1,0
2,395,395,6,6,0,1,0
3,400,400,9,6,3,2,1
14,421,421,1,1,0,1,0
8,446,446,38,15,23,2,1
12,461,461,22,22,0,1,0
13,464,464,105,105,0,1,0
28,465,465,28,3,25,3,2
1,473,473,14,8,6,2,1
27,474,474,69,50,19,2,1
22,479,479,6,6,0,1,0
24,488,488,5,5,0,1,0
17,494,494,1,1,0,1,0
5,498,498,5,5,0,1,0
19,498,498,54,12,42,3,2
23,500,500,22,7,15,4,3

13,102,102,20,6,14,3,2
12,137,137,20,20,0,1,0
10,168,168,1,1,0,1,0
5,193,193,18,18,0,1,0
21,205,205,9,9,0,1,0
14,209,209,13,4,9,4,3
20,241,241,18,18,0,1,0
19,256,256,27,27,0,1,0
22,278,278,37,25,12,4,3
18,279,279,40,9,31,2,1
3,307,307,22,22,0,1,0
7,322,322,78,36,42,2,1
24,351,351,2,2,0,1,0
6,355,355,33,2,31,3,2
25,366,366,36,15,21,4,3
15,367,367,97,1,96,4,3
4,369,369,15,9,6,3,2
2,386,386,30,30,0,1,0
17,391,391,2,2,0,1,0
0,391,391,21,21,0,1,0
16,396,396,46,2,44,2,1
9,396,396,82,82,0,1,0
23,413,413,28,28,0,1,0
1,420,420,27,18,9,4,3
8,454,454,94,59,35,2,1
11,484,484,1,1,0,1,0

21,120,120,9,4,5,2,1
8,177,177,18,3,15,2,1
12,182,182,25,5,20,3,2
25,185,185,4,4,0,1,0
9,189,189,5,2,3,2,1
17,224,224,5,2,3,2,1
23,226,226,62,36,26,2,1
26,234,234,57,28,29,2,1
14,238,238,11,3,8,3,2
0,243,243,55,19,36,3,2
11,243,243,81,8,73,4,3
18,253,253,16,16,0,1,0
22,261,261,28,28,0,1,0
7,277,277,7,7,0,1,0
3,303,303,67,67,0,1,0
5,321,321,1,1,0,1,0
19,324,324,96,96,0,1,0
16,348,348,22,22,0,1,0
15,351,351,9,9,0,1,0
1,352,352,12,5,7,2,1
4,377,377,18,9,9,4,3
13,418,418,7,7,0,1,0
2,425,425,1,1,0,1,0
20,443,443,24,6,18,4,3
10,451,451,48,15,33,2,1
24,487,487,19,2,17,3,2
6,500,500,9,1,8,3,2

17,127,127,3,3,0,1,0
7,129,129,48,23,25,2,1
4,144,144,14,5,9,4,3
1,156,156,84,3,81,4,3
10,187,187,17,11,6,2,1
2,188,188,13,13,0,1,0
8,259,259,7,7,0,1,0
16,262,262,21,9,12,4,3
11,277,277,57,47,10,3,2
0,310,310,3,3,0,1,0
3,316,316,4,4,0,1,0
15,316,316,26,19,7,2,1
6,349,349,19,10,9,4,3
9,370,370,30,12,18,3,2
20,373,373,25,13,12,4,3
5,415,415,51,44,7,2,1
18,441,441,18,18,0,1,0
14,447,447,215,130,85,4,3
12,453,453,8,8,0,1,0
19,459,459,25,25,0,1,0
21,473,473,33,12,21,2,1
13,499,499,13,13,0,1,0

5,103,103,1,1,0,1,0
25,111,111,3,3,0,1,0
30,123,123,1,1,0,1,0
20,129,129,5,5,0,1,0
7,176,176,10,2,8,3,2
2,192,192,1,1,0,1,0
0,195,195,23,2,21,2,1
8,226,226,1,1,0,1,0
13,233,233,24,9,15,3,2
10,239,239,22,22,0,1,0
9,247,247,52,52,0,1,0
16,260,260,37,16,21,4,3
19,263,263,91,19,72,4,3
6,264,264,7,7,0,1,0
22,265,265,24,24,0,1,0
27,274,274,3,3,0,1,0
3,281,281,5,5,0,1,0
26,284,284,60,60,0,1,0
21,289,289,35,3,32,3,2
28,297,297,59,15,44,2,1
23,323,323,14,4,10,2,1
15,325,325,7,7,0,1,0
17,336,336,20,20,0,1,0
12,369,369,15,15,0,1,0
24,370,370,55,7,48,2,1
29,384,384,27,1,26,2,1
14,386,386,91,73,18,4,3
4,418,418,44,44,0,1,0
18,446,446,6,6,0,1,0
1,446,446,3,3,0,1,0
11,492,492,23,23,0,1,0

2,129,129,20,12,8,2,1
3,138,138,1,1,0,1,0
6,148,148,7,7,0,1,0
23,148,148,3,3,0,1,0
7,152,152,25,7,18,2,1
5,154,154,20,20,0,1,0
4,176,176,15,15,0,1,0
11,185,185,9,9,0,1,0
16,208,208,8,8,0,1,0
13,237,237,36,6,30,3,2
21,251,251,55,55,0,1,0
19,259,259,38,38,0,1,0
9,278,278,2,2,0,1,0
22,279,279,23,23,0,1,0
10,280,280,14,2,12,4,3
0,300,300,50,50,0,1,0
20,310,310,15,15,0,1,0
12,315,315,8,8,0,1,0
17,324,324,66,14,52,3,2
8,348,348,56,56,0,1,0
24,422,422,25,25,0,1,0
1,435,435,123,97,26,3,2
14,450,450,51,51,0,1,0
18,478,478,80,20,60,3,2
15,481,481,19,7,12,4,3

5,107,107,3,3,0,1,0
7,143,143,26,26,0,1,0
27,153,153,17,17,0,1,0
4,157,157,15,4,11,2,1
23,174,174,1,1,0,1,0
6,178,178,16,16,0,1,0
25,189,189,28,22,6,2,1
17,192,192,53,53,0,1,0
10,194,194,12,12,0,1,0
18,200,200,16,5,11,2,1
8,223,223,3,3,0,1,0
29,236,236,3,3,0,1,0
24,243,243,25,25,0,1,0
16,262,262,12,6,6,3,2
19,270,270,13,13,0,1,0
1,283,283,59,48,11,2,1
28,339,339,65,8,57,3,2
20,364,364,72,30,42,4,3
9,370,370,31,31,0,1,0
12,370,370,1,1,0,1,0
3,398,398,29,29,0,1,0
14,412,412,28,28,0,1,0
26,414,414,26,8,18,2,1
13,419,419,1,1,0,1,0
21,421,421,33,33,0,1,0
22,422,422,1,1,0,1,0
15,432,432,112,76,36,3,2
2,449,449,1,1,0,1,0
11,481,481,4,4,0,1,0
0,486,486,37,22,15,2,1

18,108,108,12,3,9,2,1
13,113,113,1,1,0,1,0
1,141,141,10,2,8,2,1
26,142,142,10,10,0,1,0
9,155,155,74,74,0,1,0
21,185,185,2,2,0,1,0
2,186,186,25,3,22,2,1
14,196,196,18,18,0,1,0
8,206,206,4,4,0,1,0
10,212,212,6,6,0,1,0
15,215,215,57,24,33,4,3
22,221,221,34,25,9,4,3
12,261,261,6,1,5,2,1
7,263,263,44,38,6,3,2
0,270,270,4,4,0,1,0
3,293,293,8,2,6,3,2
27,313,313,41,41,0,1,0
4,316,316,14,14,0,1,0
11,338,338,3,3,0,1,0
20,344,344,21,21,0,1,0
6,357,357,32,32,0,1,0
19,370,370,32,21,11,2,1
17,371,371,11,11,0,1,0
25,440,440,46,8,38,3,2
5,459,459,43,43,0,1,0
16,473,473,6,3,3,2,1
23,487,487,111,55,56,3,2
24,498,498,31,8,23,4,3

22,107,107,17,1,16,4,3
7,132,132,17,2,15,2,1
18,136,136,16,1,15,4,3
19,147,147,1,1,0,1,0
3,153,153,4,1,3,2,1
11,165,165,8,8,0,1,0
13,190,190,8,8,0,1,0
1,226,226,20,20,0,1,0
23,249,249,12,12,0,1,0
5,271,271,77,55,22,3,2
10,282,282,41,32,9,3,2
4,287,287,1,1,0,1,0
21,295,295,62,51,11,2,1
0,347,347,154,58,96,4,3
12,358,358,11,11,0,1,0
8,369,369,11,5,6,2,1
15,375,375,108,57,51,4,3
20,394,394,53,53,0,1,0
9,396,396,3,3,0,1,0
6,414,414,44,44,0,1,0
17,414,414,18,18,0,1,0
2,459,459,18,9,9,4,3
14,496,496,85,27,58,3,2
16,500,500,16,6,10,2,1

1,110,110,4,4,0,1,0
5,113,113,10,10,0,1,0
17,119,119,13,1,12,3,2
7,162,162,19,19,0,1,0
20,168,168,38,2,36,2,1
11,183,183,19,1,18,4,3
23,193,193,3,3,0,1,0
6,193,193,31,21,10,3,2
19,206,206,16,1,15,4,3
13,248,248,3,3,0,1,0
18,253,253,57,28,29,2,1
0,332,332,42,42,0,1,0
14,339,339,1,1,0,1,0
4,364,364,72,72,0,1,0
22,375,375,46,46,0,1,0
16,381,381,131,131,0,1,0
24,420,420,5,1,4,2,1
8,425,425,22,10,12,4,3
3,436,436,8,4,4,2,1
15,447,447,31,17,14,3,2
12,469,469,18,18,0,1,0
9,476,476,103,79,24,2,1
21,481,481,34,29,5,2,1
10,484,484,78,78,0,1,0
2,490,490,13,13,0,1,0

19,115,115,1,1,0,1,0
5,119,119,7,7,0,1,0
24,155,155,8,8,0,1,0
27,178,178,31,6,25,2,1
20,180,180,12,8,4,2,1
18,220,220,5,5,0,1,0
22,221,221,69,33,36,4,3
13,222,222,20,20,0,1,0
21,226,226,27,27,0,1,0
25,237,237,33,6,27,2,1
14,271,271,14,14,0,1,0
3,272,272,5,5,0,1,0
28,275,275,4,4,0,1,0
7,308,308,15,15,0,1,0
23,314,314,62,38,24,4,3
11,319,319,39,21,18,4,3
10,324,324,6,1,5,2,1
15,333,333,31,31,0,1,0
6,356,356,11,11,0,1,0
1,376,376,4,1,3,2,1
4,393,393,92,92,0,1,0
8,400,400,35,2,33,4,3
12,407,407,26,26,0,1,0
17,409,409,34,11,23,2,1
26,425,425,37,37,0,1,0
9,452,452,5,5,0,1,0
2,473,473,123,81,42,4,3
16,474,474,26,10,16,3,2
0,494,494,51,27,24,2,1

24,105,105,5,5,0,1,0
7,106,106,18,18,0,1,0
2,109,109,9,9,0,1,0
21,175,175,10,4,6,3,2
11,240,240,23,7,16,2,1
10,248,248,10,1,9,4,3
25,279,279,7,7,0,1,0
0,304,304,38,38,0,1,0
22,308,308,58,58,0,1,0
17,309,309,6,6,0,1,0
6,329,329,8,8,0,1,0
9,345,345,53,25,28,4,3
18,345,345,31,3,28,3,2
14,352,352,5,5,0,1,0
3,367,367,53,53,0,1,0
13,369,369,30,30,0,1,0
12,376,376,28,22,6,2,1
20,384,384,67,67,0,1,0
5,402,402,3,3,0,1,0
1,425,425,45,45,0,1,0
4,426,426,8,8,0,1,0
16,435,435,150,131,19,3,2
19,445,445,32,32,0,1,0
8,474,474,123,123,0,1,0
15,492,492,69,69,0,1,0
23,493,493,33,33,0,1,0

17,105,105,16,16,0,1,0
13,126,126,18,1,17,3,2
16,141,141,22,22,0,1,0
11,144,144,5,2,3,2,1
15,165,165,4,4,0,1,0
23,173,173,16,16,0,1,0
25,185,185,29,5,24,4,3
14,188,188,9,5,4,2,1
7,203,203,4,4,0,1,0
0,205,205,17,17,0,1,0
2,246,246,6,3,3,2,1
26,248,248,20,20,0,1,0
18,253,253,31,31,0,1,0
1,254,254,5,5,0,1,0
12,254,254,1,1,0,1,0
10,255,255,28,28,0,1,0
3,272,272,137,80,57,4,3
20,280,280,39,6,33,4,3
4,284,284,27,27,0,1,0
27,285,285,1,1,0,1,0
19,331,331,8,4,4,2,1
24,340,340,68,47,21,4,3
21,349,349,16,4,12,4,3
6,393,393,10,10,0,1,0
8,417,417,32,14,18,4,3
9,426,426,2,2,0,1,0
28,438,438,26,2,24,4,3
5,492,492,42,18,24,4,3
22,493,493,49,49,0,1,0

6,102,102,15,15,0,1,0
2,109,109,16,12,4,2,1
24,116,116,12,12,0,1,0
10,122,122,1,1,0,1,0
12,131,131,3,3,0,1,0
22,144,144,25,25,0,1,0
25,150,150,18,3,15,4,3
5,166,166,4,4,0,1,0
16,196,196,3,3,0,1,0
23,219,219,24,24,0,1,0
4,223,223,16,16,0,1,0
13,230,230,51,2,49,2,1
0,253,253,10,10,0,1,0
9,294,294,66,27,39,2,1
17,301,301,114,76,38,2,1
20,304,304,3,3,0,1,0
11,323,323,63,29,34,2,1
1,351,351,47,47,0,1,0
8,373,373,70,10,60,3,2
18,389,389,15,15,0,1,0
7,389,389,15,9,6,3,2
15,396,396,29,29,0,1,0
19,403,403,5,5,0,1,0
21,447,447,10,10,0,1,0
14,478,478,24,24,0,1,0
3,482,482,29,10,19,2,1

6,162,162,3,3,0,1,0
19,186,186,5,1,4,2,1
1,188,188,31,31,0,1,0
10,202,202,1,1,0,1,0
13,219,219,10,10,0,1,0
18,239,239,19,5,14,3,2
15,244,244,32,2,30,4,3
17,246,246,29,8,21,4,3
0,247,247,64,64,0,1,0
11,259,259,23,12,11,3,2
14,273,273,61,24,37,4,3
24,295,295,4,4,0,1,0
22,302,302,51,44,7,2,1
5,319,319,29,29,0,1,0
12,323,323,59,21,38,3,2
27,333,333,8,8,0,1,0
23,348,348,46,46,0,1,0
2,348,348,6,6,0,1,0
25,376,376,82,82,0,1,0
4,380,380,18,18,0,1,0
21,420,420,63,35,28,2,1
7,423,423,5,1,4,2,1
9,437,437,14,14,0,1,0
16,447,447,49,49,0,1,0
3,458,458,44,44,0,1,0
20,458,458,48,48,0,1,0
26,486,486,23,23,0,1,0
8,487,487,9,9,0,1,0

1,121,121,4,4,0,1,0
22,140,140,4,4,0,1,0
3,145,145,11,5,6,3,2
26,145,145,11,3,8,2,1
18,148,148,1,1,0,1,0
30,157,157,1,1,0,1,0
4,175,175,8,8,0,1,0
27,178,178,72,50,22,2,1
5,185,185,5,5,0,1,0
6,187,187,44,8,36,4,3
9,201,201,6,6,0,1,0
14,220,220,13,13,0,1,0
28,252,252,1,1,0,1,0
2,274,274,13,4,9,4,3
19,311,311,20,14,6,2,1
10,321,321,7,7,0,1,0
11,327,327,36,36,0,1,0
20,331,331,126,96,30,4,3
12,332,332,70,28,42,3,2
0,374,374,1,1,0,1,0
23,378,378,17,9,8,2,1
29,385,385,1,1,0,1,0
17,391,391,19,10,9,4,3
15,394,394,67,53,14,2,1
31,399,399,46,46,0,1,0
7,400,400,6,6,0,1,0
21,422,422,2,2,0,1,0
24,426,426,6,2,4,2,1
25,428,428,74,74,0,1,0
8,452,452,33,33,0,1,0
16,457,457,13,13,0,1,0
13,459,459,28,28,0,1,0

26,100,100,11,11,0,1,0
13,145,145,37,2,35,2,1
17,167,167,16,8,8,2,1
25,170,170,44,9,35,3,2
3,171,171,5,5,0,1,0
21,199,199,2,2,0,1,0
7,210,210,26,20,6,3,2
15,215,215,30,30,0,1,0
9,221,221,1,1,0,1,0
20,256,256,24,20,4,2,1
18,259,259,36,36,0,1,0
22,274,274,13,13,0,1,0
2,297,297,66,24,42,3,2
10,298,298,25,13,12,2,1
6,308,308,4,4,0,1,0
24,314,314,10,10,0,1,0
12,318,318,11,11,0,1,0
0,333,333,23,14,9,2,1
14,350,350,66,66,0,1,0
5,361,361,6,6,0,1,0
8,381,381,9,1,8,2,1
4,405,405,98,98,0,1,0
19,412,412,68,42,26,2,1
11,429,429,71,45,26,4,3
23,453,453,17,17,0,1,0
1,475,475,8,8,0,1,0
16,500,500,3,3,0,1,0

7,113,113,13,13,0,1,0
18,120,120,7,7,0,1,0
3,136,136,17,4,13,2,1
5,170,170,1,1,0,1,0
0,190,190,57,57,0,1,0
1,226,226,106,97,9,4,3
14,256,256,4,4,0,1,0
13,315,315,93,42,51,4,3
4,341,341,88,65,23,2,1
16,349,349,30,14,16,2,1
12,361,361,60,20,40,3,2
2,366,366,10,10,0,1,0
8,366,366,28,7,21,2,1
11,368,368,3,3,0,1,0
19,373,373,2,2,0,1,0
6,394,394,46,34,12,3,2
9,403,403,18,10,8,2,1
15,414,414,79,79,0,1,0
10,414,414,31,7,24,2,1
17,445,445,82,39,43,4,3

16,146,146,9,5,4,2,1
5,152,152,7,1,6,2,1
19,166,166,44,44,0,1,0
1,187,187,26,17,9,2,1
3,187,187,65,46,19,2,1
10,211,211,3,3,0,1,0
22,215,215,22,16,6,3,2
18,234,234,14,14,0,1,0
14,241,241,2,2,0,1,0
9,242,242,14,14,0,1,0
2,254,254,20,12,8,3,2
4,269,269,107,107,0,1,0
6,276,276,29,12,17,2,1
20,276,276,17,17,0,1,0
8,294,294,3,3,0,1,0
12,325,325,74,56,18,4,3
11,348,348,31,10,21,4,3
0,384,384,12,8,4,2,1
7,393,393,35,35,0,1,0
15,424,424,119,119,0,1,0
21,425,425,34,34,0,1,0
13,445,445,17,17,0,1,0
17,473,473,16,16,0,1,0

8,111,111,1,1,0,1,0
3,120,120,2,2,0,1,0
24,143,143,19,6,13,2,1
2,155,155,2,2,0,1,0
16,175,175,38,32,6,2,1
19,185,185,23,2,21,4,3
20,193,193,3,3,0,1,0
26,200,200,29,10,19,2,1
22,206,206,3,3,0,1,0
12,229,229,11,11,0,1,0
25,235,235,1,1,0,1,0
11,236,236,27,11,16,2,1
0,238,238,10,10,0,1,0
21,246,246,2,2,0,1,0
10,249,249,54,20,34,2,1
15,256,256,4,4,0,1,0
9,326,326,59,59,0,1,0
18,336,336,96,21,75,4,3
5,341,341,49,49,0,1,0
13,343,343,72,21,51,4,3
7,353,353,66,66,0,1,0
23,363,363,55,11,44,3,2
1,383,383,18,8,10,3,2
6,399,399,26,16,10,3,2
4,423,423,3,3,0,1,0
14,432,432,57,57,0,1,0
17,448,448,36,22,14,2,1

15,105,105,10,10,0,1,0
17,126,126,1,1,0,1,0
18,152,152,12,12,0,1,0
20,155,155,6,6,0,1,0
0,189,189,40,6,34,2,1
23,213,213,1,1,0,1,0
7,231,231,50,50,0,1,0
3,237,237,29,29,0,1,0
22,273,273,17,17,0,1,0
5,277,277,5,5,0,1,0
16,280,280,31,5,26,2,1
10,292,292,26,8,18,2,1
24,296,296,27,15,12,4,3
13,305,305,68,35,33,2,1
14,312,312,20,20,0,1,0
11,324,324,28,28,0,1,0
12,379,379,46,46,0,1,0
19,380,380,103,45,58,3,2
9,399,399,33,15,18,4,3
2,440,440,37,23,14,3,2
6,458,458,45,45,0,1,0
8,462,462,92,58,34,2,1
1,465,465,26,26,0,1,0
4,494,494,19,19,0,1,0
21,496,496,77,47,30,4,3

5,118,118,42,13,29,2,1
23,125,125,10,2,8,2,1
13,162,162,22,22,0,1,0
21,168,168,48,17,31,2,1
3,215,215,12,12,0,1,0
22,241,241,14,14,0,1,0
9,254,254,26,2,24,4,3
18,263,263,11,11,0,1,0
11,276,276,73,73,0,1,0
15,282,282,4,4,0,1,0
16,283,283,4,4,0,1,0
7,288,288,20,9,11,2,1
1,288,288,36,30,6,3,2
2,338,338,90,90,0,1,0
17,341,341,25,25,0,1,0
14,360,360,29,23,6,3,2
12,368,368,67,51,16,2,1
8,375,375,11,11,0,1,0
0,422,422,32,32,0,1,0
19,426,426,1,1,0,1,0
10,426,426,7,1,6,2,1
4,461,461,75,21,54,4,3
20,463,463,39,33,6,2,1
6,469,469,20,13,7,2,1

17,125,125,33,18,15,4,3
22,168,168,20,2,18,3,2
0,215,215,54,13,41,4,3
20,230,230,10,10,0,1,0
7,278,278,9,2,7,2,1
23,294,294,8,8,0,1,0
15,318,318,55,19,36,2,1
2,331,331,31,31,0,1,0
1,332,332,44,44,0,1,0
16,333,333,27,10,17,4,3
12,342,342,7,4,3,2,1
21,345,345,27,27,0,1,0
19,354,354,5,2,3,2,1
18,358,358,19,19,0,1,0
6,376,376,109,109,0,1,0
4,406,406,29,11,18,3,2
5,434,434,29,20,9,2,1
3,451,451,76,50,26,2,1
10,453,453,36,36,0,1,0
14,463,463,12,12,0,1,0
9,471,471,42,16,26,3,2
13,484,484,135,135,0,1,0
8,493,493,13,13,0,1,0
11,494,494,71,71,0,1,0

25,122,122,2,2,0,1,0
11,124,124,1,1,0,1,0
7,143,143,13,3,10,3,2
27,147,147,32,16,16,3,2
10,172,172,15,15,0,1,0
24,177,177,25,5,20,2,1
14,202,202,7,4,3,2,1
0,206,206,25,25,0,1,0
28,237,237,11,11,0,1,0
23,240,240,62,8,54,4,3
21,258,258,14,14,0,1,0
17,273,273,5,5,0,1,0
19,288,288,37,37,0,1,0
6,318,318,45,24,21,4,3
3,320,320,1,1,0,1,0
18,321,321,32,32,0,1,0
26,344,344,12,12,0,1,0
20,355,355,1,1,0,1,0
4,358,358,37,37,0,1,0
8,375,375,10,3,7,2,1
13,419,419,18,18,0,1,0
22,427,427,120,103,17,2,1
2,431,431,3,3,0,1,0
16,436,436,10,10,0,1,0
29,464,464,11,7,4,2,1
12,467,467,14,2,12,2,1
9,470,470,75,75,0,1,0
15,491,491,57,38,19,2,1
1,496,496,17,5,12,3,2
5,500,500,136,79,57,4,3

3,109,109,28,28,0,1,0
19,123,123,5,5,0,1,0
21,138,138,11,2,9,2,1
15,147,147,26,26,0,1,0
22,150,150,32,12,20,2,1
23,159,159,12,5,7,2,1
1,170,170,6,6,0,1,0
5,173,173,1,1,0,1,0
16,185,185,60,15,45,4,3
11,198,198,7,1,6,3,2
17,204,204,12,12,0,1,0
4,272,272,39,39,0,1,0
12,282,282,10,10,0,1,0
7,292,292,50,50,0,1,0
10,293,293,53,53,0,1,0
9,316,316,50,19,31,3,2
8,318,318,69,69,0,1,0
24,318,318,6,6,0,1,0
6,320,320,28,2,26,3,2
13,326,326,14,5,9,2,1
20,333,333,47,21,26,3,2
0,385,385,4,1,3,2,1
14,427,427,17,17,0,1,0
18,439,439,36,27,9,2,1
2,451,451,1,1,0,1,0

29,110,110,19,19,0,1,0
17,113,113,1,1,0,1,0
31,120,120,22,7,15,4,3
26,123,123,23,5,18,3,2
0,129,129,17,17,0,1,0
1,143,143,5,5,0,1,0
2,148,148,10,2,8,3,2
28,174,174,14,14,0,1,0
18,215,215,10,3,7,2,1
5,219,219,14,2,12,4,3
10,236,236,1,1,0,1,0
25,259,259,6,2,4,2,1
4,277,277,22,6,16,3,2
21,299,299,25,25,0,1,0
24,320,320,40,2,38,3,2
3,330,330,13,13,0,1,0
12,339,339,18,3,15,4,3
15,340,340,1,1,0,1,0
23,355,355,75,75,0,1,0
13,366,366,38,5,33,4,3
19,393,393,7,1,6,2,1
9,400,400,9,9,0,1,0
22,406,406,31,19,12,2,1
14,465,465,42,12,30,2,1
8,468,468,29,29,0,1,0
6,469,469,37,16,21,4,3
30,472,472,10,10,0,1,0
27,476,476,4,4,0,1,0
16,478,478,22,7,15,4,3
11,489,489,70,24,46,3,2
20,494,494,69,21,48,3,2
7,498,498,111,111,0,1,0

0,116,116,9,1,8,2,1
25,121,121,2,2,0,1,0
5,134,134,45,37,8,3,2
15,141,141,16,16,0,1,0
9,164,164,4,4,0,1,0
17,175,175,31,11,20,3,2
3,205,205,7,7,0,1,0
26,220,220,3,3,0,1,0
27,222,222,3,3,0,1,0
24,225,225,7,1,6,3,2
1,226,226,1,1,0,1,0
12,239,239,8,2,6,2,1
19,268,268,44,44,0,1,0
18,272,272,15,15,0,1,0
11,273,273,10,10,0,1,0
2,280,280,52,52,0,1,0
28,294,294,66,24,42,4,3
6,296,296,12,12,0,1,0
14,319,319,6,6,0,1,0
23,341,341,23,6,17,4,3
4,347,347,10,10,0,1,0
16,367,367,40,40,0,1,0
20,388,388,100,4,96,3,2
10,410,410,114,114,0,1,0
13,428,428,8,8,0,1,0
21,431,431,59,59,0,1,0
8,439,439,12,1,11,2,1
22,484,484,30,30,0,1,0
7,498,498,24,3,21,4,3

22,100,100,2,2,0,1,0
5,111,111,5,5,0,1,0
9,127,127,6,6,0,1,0
13,158,158,20,8,12,2,1
4,163,163,18,18,0,1,0
19,172,172,9,2,7,2,1
7,178,178,7,7,0,1,0
12,187,187,5,5,0,1,0
1,215,215,23,23,0,1,0
0,218,218,16,5,11,2,1
10,236,236,53,9,44,3,2
24,253,253,8,8,0,1,0
14,262,262,22,2,20,2,1
21,272,272,68,29,39,4,3
8,273,273,18,18,0,1,0
16,312,312,61,61,0,1,0
17,322,322,46,12,34,4,3
20,373,373,22,4,18,4,3
18,377,377,8,8,0,1,0
2,395,395,44,44,0,1,0
15,399,399,112,75,37,2,1
11,423,423,12,12,0,1,0
23,435,435,14,14,0,1,0
3,437,437,78,78,0,1,0
6,499,499,135,135,0,1,0

21,103,103,37,37,0,1,0
12,119,119,15,6,9,4,3
4,126,126,22,1,21,2,1
25,145,145,8,8,0,1,0
17,174,174,3,3,0,1,0
22,188,188,49,49,0,1,0
2,203,203,1,1,0,1,0
15,211,211,3,3,0,1,0
3,228,228,11,11,0,1,0
24,243,243,8,1,7,3,2
6,244,244,5,5,0,1,0
8,244,244,6,6,0,1,0
1,281,281,13,1,12,4,3
16,343,343,91,91,0,1,0
20,347,347,18,14,4,2,1
13,353,353,108,108,0,1,0
18,388,388,12,12,0,1,0
9,394,394,55,55,0,1,0
5,401,401,65,53,12,4,3
7,408,408,25,25,0,1,0
26,422,422,27,8,19,4,3
10,432,432,37,11,26,3,2
19,437,437,4,4,0,1,0
23,448,448,52,29,23,4,3
14,460,460,29,23,6,3,2
27,462,462,25,25,0,1,0
11,495,495,16,13,3,2,1
0,497,497,3,3,0,1,0

16,141,141,7,1,6,3,2
24,149,149,2,2,0,1,0
11,170,170,2,2,0,1,0
4,181,181,18,6,12,2,1
13,233,233,11,11,0,1,0
20,241,241,51,45,6,2,1
17,257,257,70,1,69,4,3
5,265,265,7,7,0,1,0
10,266,266,22,12,10,3,2
12,276,276,53,14,39,4,3
18,291,291,53,5,48,4,3
9,304,304,76,76,0,1,0
19,325,325,9,9,0,1,0
8,328,328,19,19,0,1,0
7,341,341,19,6,13,2,1
23,354,354,67,67,0,1,0
15,361,361,22,22,0,1,0
2,374,374,122,76,46,3,2
22,402,402,40,4,36,2,1
0,420,420,9,9,0,1,0
14,430,430,23,23,0,1,0
6,455,455,26,6,20,2,1
25,473,473,25,25,0,1,0
3,477,477,4,4,0,1,0
1,482,482,55,35,20,3,2
21,495,495,31,31,0,1,0

22,102,102,11,11,0,1,0
11,139,139,3,3,0,1,0
15,149,149,1,1,0,1,0
16,157,157,30,22,8,3,2
20,177,177,6,3,3,2,1
25,182,182,12,5,7,2,1
5,199,199,5,5,0,1,0
21,208,208,8,8,0,1,0
6,214,214,44,44,0,1,0
26,238,238,3,3,0,1,0
17,250,250,14,6,8,3,2
27,281,281,8,8,0,1,0
23,292,292,7,7,0,1,0
18,301,301,7,7,0,1,0
9,310,310,44,44,0,1,0
28,311,311,111,111,0,1,0
0,321,321,1,1,0,1,0
30,322,322,35,19,16,3,2
12,392,392,52,19,33,4,3
7,396,396,28,1,27,4,3
19,402,402,50,50,0,1,0
14,411,411,17,17,0,1,0
24,418,418,55,55,0,1,0
4,424,424,24,24,0,1,0
3,427,427,21,21,0,1,0
10,428,428,32,32,0,1,0
8,434,434,10,1,9,2,1
1,437,437,46,14,32,3,2
13,477,477,20,2,18,3,2
29,477,477,131,99,32,2,1
2,482,482,26,18,8,2,1

6,129,129,13,2,11,2,1
7,131,131,2,2,0,1,0
3,135,135,6,6,0,1,0
16,149,149,44,8,36,3,2
0,201,201,19,5,14,3,2
8,208,208,1,1,0,1,0
5,217,217,6,6,0,1,0
15,281,281,17,6,11,2,1
17,287,287,36,36,0,1,0
24,288,288,16,2,14,3,2
2,300,300,116,88,28,2,1
4,313,313,17,17,0,1,0
14,314,314,73,73,0,1,0
13,321,321,46,7,39,4,3
10,323,323,71,43,28,2,1
18,335,335,2,2,0,1,0
22,367,367,4,4,0,1,0
19,377,377,6,6,0,1,0
21,382,382,31,7,24,4,3
11,397,397,49,12,37,2,1
23,398,398,96,30,66,4,3
9,412,412,30,30,0,1,0
12,422,422,12,5,7,3,2
20,447,447,12,4,8,3,2
1,488,488,77,77,0,1,0

10,111,111,8,2,6,3,2
11,127,127,8,8,0,1,0
22,127,127,25,1,24,3,2
15,135,135,3,3,0,1,0
0,147,147,11,11,0,1,0
4,165,165,4,4,0,1,0
27,167,167,25,18,7,2,1
1,172,172,5,5,0,1,0
6,189,189,1,1,0,1,0
25,226,226,27,27,0,1,0
8,239,239,8,8,0,1,0
13,265,265,2,2,0,1,0
24,269,269,8,3,5,2,1
30,287,287,8,8,0,1,0
12,287,287,33,24,9,2,1
5,301,301,17,5,12,4,3
2,308,308,4,4,0,1,0
18,314,314,28,16,12,4,3
28,318,318,53,53,0,1,0
20,322,322,43,43,0,1,0
3,341,341,16,16,0,1,0
16,372,372,17,5,12,2,1
19,375,375,37,37,0,1,0
14,413,413,185,126,59,4,3
31,417,417,25,25,0,1,0
26,429,429,14,5,9,2,1
7,444,444,19,19,0,1,0
17,451,451,3,3,0,1,0
9,464,464,49,49,0,1,0
21,490,490,68,8,60,3,2
23,493,493,39,6,33,4,3
29,499,499,44,44,0,1,0

12,110,110,13,13,0,1,0
15,129,129,9,4,5,2,1
19,131,131,5,2,3,2,1
1,134,134,16,16,0,1,0
24,140,140,19,19,0,1,0
3,143,143,10,10,0,1,0
4,166,166,1,1,0,1,0
5,170,170,1,1,0,1,0
8,247,247,75,28,47,2,1
7,255,255,48,21,27,4,3
16,294,294,21,7,14,2,1
21,302,302,34,22,12,3,2
20,316,316,76,76,0,1,0
2,344,344,36,17,19,2,1
22,383,383,38,38,0,1,0
23,392,392,71,63,8,2,1
10,398,398,52,2,50,3,2
9,400,400,18,3,15,2,1
17,407,407,11,11,0,1,0
25,421,421,12,12,0,1,0
6,423,423,47,47,0,1,0
14,427,427,78,63,15,4,3
18,473,473,47,17,30,3,2
13,476,476,19,19,0,1,0
11,477,477,18,18,0,1,0
0,484,484,29,20,9,4,3

25,100,100,10,5,5,2,1
23,135,135,36,23,13,3,2
6,143,143,2,2,0,1,0
26,166,166,20,20,0,1,0
3,175,175,21,1,20,3,2
13,184,184,9,9,0,1,0
8,194,194,8,8,0,1,0
14,224,224,7,7,0,1,0
30,231,231,12,12,0,1,0
21,245,245,3,3,0,1,0
15,248,248,40,40,0,1,0
24,277,277,40,36,4,2,1
1,283,283,50,50,0,1,0
2,283,283,54,54,0,1,0
27,290,290,49,49,0,1,0
22,298,298,16,16,0,1,0
16,318,318,36,36,0,1,0
7,337,337,15,4,11,2,1
28,340,340,10,1,9,4,3
20,351,351,12,6,6,3,2
9,358,358,19,4,15,4,3
18,381,381,51,25,26,2,1
11,385,385,13,13,0,1,0
12,388,388,3,3,0,1,0
19,403,403,11,11,0,1,0
17,413,413,38,38,0,1,0
0,420,420,12,3,9,2,1
10,420,420,17,17,0,1,0
29,453,453,87,75,12,3,2
4,474,474,18,18,0,1,0
5,496,496,33,21,12,2,1

21,122,122,7,7,0,1,0
26,129,129,11,2,9,4,3
3,136,136,2,2,0,1,0
23,151,151,19,19,0,1,0
27,155,155,2,2,0,1,0
13,160,160,3,3,0,1,0
14,185,185,24,6,18,3,2
2,187,187,35,35,0,1,0
32,201,201,10,2,8,2,1
18,203,203,11,11,0,1,0
29,235,235,16,7,9,2,1
5,238,238,40,9,31,3,2
31,248,248,18,18,0,1,0
8,256,256,7,3,4,2,1
17,260,260,11,1,10,2,1
22,280,280,84,18,66,3,2
9,284,284,10,10,0,1,0
12,292,292,1,1,0,1,0
4,302,302,24,24,0,1,0
20,309,309,32,32,0,1,0
11,313,313,7,7,0,1,0
10,318,318,35,11,24,2,1
7,338,338,6,6,0,1,0
25,343,343,11,1,10,2,1
0,359,359,19,19,0,1,0
6,361,361,24,24,0,1,0
24,429,429,2,2,0,1,0
30,437,437,84,54,30,2,1
1,451,451,59,59,0,1,0
28,464,464,103,103,0,1,0
16,481,481,23,6,17,2,1
19,496,496,36,6,30,3,2
15,497,497,10,4,6,2,1

18,117,117,13,13,0,1,0
10,122,122,13,13,0,1,0
2,125,125,9,9,0,1,0
9,127,127,2,2,0,1,0
19,149,149,2,2,0,1,0
0,159,159,10,10,0,1,0
15,162,162,44,26,18,2,1
23,174,174,5,2,3,2,1
25,187,187,45,45,0,1,0
17,199,199,46,1,45,4,3
27,201,201,3,3,0,1,0
26,252,252,41,41,0,1,0
14,258,258,15,4,11,4,3
29,277,277,37,37,0,1,0
13,290,290,35,35,0,1,0
5,294,294,18,18,0,1,0
1,317,317,26,18,8,2,1
20,322,322,51,9,42,3,2
6,341,341,14,14,0,1,0
4,367,367,16,4,12,2,1
11,373,373,61,61,0,1,0
16,385,385,15,15,0,1,0
24,392,392,11,5,6,2,1
8,402,402,17,17,0,1,0
22,425,425,17,10,7,2,1
7,440,440,39,39,0,1,0
3,454,454,14,8,6,2,1
12,456,456,1,1,0,1,0
28,459,459,46,46,0,1,0
21,460,460,29,29,0,1,0

5,137,137,10,10,0,1,0
0,146,146,6,6,0,1,0
18,155,155,8,8,0,1,0
28,161,161,30,13,17,2,1
8,170,170,23,12,11,2,1
19,222,222,1,1,0,1,0
6,224,224,21,21,0,1,0
20,236,236,9,1,8,3,2
17,261,261,35,35,0,1,0
14,262,262,83,59,24,3,2
3,265,265,15,15,0,1,0
25,268,268,3,3,0,1,0
13,274,274,28,20,8,3,2
29,287,287,33,33,0,1,0
11,308,308,2,2,0,1,0
16,313,313,39,39,0,1,0
4,318,318,14,14,0,1,0
26,340,340,33,33,0,1,0
12,344,344,11,11,0,1,0
23,350,350,38,21,17,2,1
27,351,351,13,13,0,1,0
24,359,359,2,2,0,1,0
21,365,365,169,142,27,2,1
22,374,374,29,29,0,1,0
15,397,397,8,1,7,2,1
9,445,445,22,8,14,2,1
1,455,455,43,29,14,2,1
2,462,462,31,16,15,2,1
10,464,464,1,1,0,1,0
7,489,489,21,21,0,1,0

16,133,133,2,2,0,1,0
17,178,178,13,13,0,1,0
23,180,180,14,14,0,1,0
13,180,180,13,13,0,1,0
2,186,186,23,23,0,1,0
19,194,194,61,49,12,3,2
8,212,212,7,7,0,1,0
9,213,213,56,30,26,4,3
20,231,231,10,10,0,1,0
22,263,263,108,64,44,2,1
12,280,280,16,16,0,1,0
10,312,312,13,13,0,1,0
1,312,312,135,135,0,1,0
15,334,334,13,13,0,1,0
18,343,343,32,16,16,3,2
6,353,353,53,53,0,1,0
7,412,412,8,8,0,1,0
21,418,418,15,15,0,1,0
0,436,436,7,4,3,2,1
14,456,456,6,6,0,1,0
4,480,480,19,19,0,1,0
3,482,482,68,68,0,1,0
11,488,488,39,39,0,1,0
5,489,489,21,3,18,2,1

10,107,107,20,15,5,2,1
16,162,162,2,2,0,1,0
7,173,173,84,20,64,3,2
13,175,175,16,16,0,1,0
2,208,208,4,4,0,1,0
22,237,237,55,48,7,2,1
6,242,242,27,11,16,2,1
17,258,258,47,37,10,2,1
23,280,280,15,4,11,2,1
21,294,294,69,1,68,3,2
11,297,297,13,5,8,3,2
12,301,301,41,34,7,2,1
19,310,310,42,42,0,1,0
0,346,346,11,4,7,2,1
14,358,358,16,16,0,1,0
4,373,373,43,35,8,3,2
8,380,380,2,2,0,1,0
15,389,389,12,12,0,1,0
1,400,400,36,26,10,2,1
24,405,405,23,2,21,4,3
18,408,408,32,32,0,1,0
5,464,464,60,60,0,1,0
20,467,467,18,3,15,4,3
9,470,470,1,1,0,1,0
3,470,470,38,11,27,3,2

9,123,123,4,4,0,1,0
18,186,186,4,4,0,1,0
16,235,235,25,15,10,3,2
13,253,253,34,34,0,1,0
8,262,262,6,6,0,1,0
5,279,279,79,14,65,4,3
19,315,315,6,6,0,1,0
10,321,321,20,3,17,2,1
0,323,323,36,14,22,2,1
15,337,337,39,25,14,3,2
3,349,349,130,88,42,4,3
12,350,350,7,7,0,1,0
17,361,361,31,5,26,3,2
6,377,377,17,17,0,1,0
11,388,388,110,65,45,4,3
1,454,454,176,176,0,1,0
14,460,460,57,17,40,2,1
2,468,468,6,6,0,1,0
7,481,481,143,136,7,2,1
4,492,492,43,5,38,2,1

15,102,102,6,3,3,2,1
1,115,115,13,3,10,2,1
12,124,124,7,1,6,3,2
3,135,135,4,4,0,1,0
20,141,141,23,12,11,2,1
19,145,145,2,2,0,1,0
14,175,175,11,11,0,1,0
2,209,209,1,1,0,1,0
6,276,276,93,93,0,1,0
5,281,281,69,42,27,4,3
18,282,282,116,32,84,4,3
21,300,300,4,4,0,1,0
8,309,309,10,10,0,1,0
7,344,344,40,40,0,1,0
13,346,346,24,24,0,1,0
22,375,375,85,45,40,2,1
10,389,389,37,37,0,1,0
9,392,392,42,18,24,4,3
4,421,421,73,23,50,2,1
11,427,427,51,51,0,1,0
23,468,468,40,14,26,2,1
17,472,472,10,10,0,1,0
0,486,486,23,17,6,2,1
16,495,495,18,18,0,1,0

18,100,100,9,9,0,1,0
26,109,109,27,15,12,3,2
1,126,126,63,63,0,1,0
15,126,126,5,1,4,2,1
17,146,146,20,2,18,4,3
23,152,152,2,2,0,1,0
5,154,154,22,22,0,1,0
8,154,154,6,2,4,2,1
13,177,177,5,2,3,2,1
2,196,196,4,4,0,1,0
25,203,203,1,1,0,1,0
7,244,244,39,6,33,2,1
21,263,263,6,6,0,1,0
11,272,272,4,1,3,2,1
19,295,295,14,2,12,2,1
22,302,302,20,11,9,2,1
12,333,333,48,12,36,2,1
0,366,366,1,1,0,1,0
24,389,389,37,9,28,2,1
4,409,409,9,9,0,1,0
10,410,410,4,4,0,1,0
20,411,411,57,57,0,1,0
6,415,415,4,4,0,1,0
9,428,428,48,19,29,3,2
16,431,431,66,21,45,4,3
14,469,469,128,128,0,1,0
3,497,497,49,49,0,1,0

25,100,100,7,7,0,1,0
14,101,101,10,3,7,2,1
2,108,108,21,7,14,2,1
16,109,109,7,1,6,2,1
22,127,127,13,13,0,1,0
7,135,135,10,10,0,1,0
24,147,147,10,4,6,2,1
1,157,157,23,5,18,2,1
10,191,191,26,26,0,1,0
0,191,191,64,64,0,1,0
5,210,210,19,19,0,1,0
9,258,258,17,10,7,2,1
8,263,263,31,16,15,4,3
12,278,278,4,4,0,1,0
17,284,284,28,5,23,3,2
19,287,287,88,88,0,1,0
21,298,298,6,6,0,1,0
11,322,322,3,3,0,1,0
4,325,325,18,18,0,1,0
15,327,327,35,17,18,4,3
20,379,379,5,5,0,1,0
3,391,391,14,14,0,1,0
18,453,453,36,36,0,1,0
23,460,460,38,5,33,4,3
6,461,461,12,12,0,1,0
13,473,473,111,37,74,3,2

14,113,113,9,2,7,2,1
9,145,145,25,25,0,1,0
25,156,156,31,31,0,1,0
8,169,169,4,4,0,1,0
21,173,173,14,8,6,3,2
26,188,188,9,9,0,1,0
17,208,208,45,45,0,1,0
24,220,220,17,3,14,3,2
0,227,227,2,2,0,1,0
23,229,229,6,6,0,1,0
2,232,232,22,15,7,2,1
19,238,238,11,11,0,1,0
5,249,249,3,3,0,1,0
7,249,249,10,10,0,1,0
12,254,254,31,11,20,4,3
10,254,254,29,7,22,3,2
4,254,254,1,1,0,1,0
6,317,317,77,9,68,3,2
3,353,353,14,5,9,4,3
20,354,354,4,4,0,1,0
15,380,380,16,16,0,1,0
13,382,382,105,33,72,3,2
22,389,389,35,8,27,4,3
18,410,410,42,24,18,2,1
27,418,418,94,67,27,2,1
16,440,440,70,15,55,4,3
1,446,446,33,33,0,1,0
11,479,479,2,2,0,1,0

21,103,103,4,4,0,1,0
14,115,115,22,14,8,2,1
4,129,129,4,1,3,2,1
10,159,159,14,14,0,1,0
9,176,176,9,9,0,1,0
19,178,178,5,5,0,1,0
25,189,189,13,13,0,1,0
26,190,190,1,1,0,1,0
7,202,202,22,4,18,3,2
13,203,203,10,4,6,3,2
27,209,209,14,14,0,1,0
2,262,262,3,3,0,1,0
12,262,262,2,2,0,1,0
11,296,296,33,33,0,1,0
17,325,325,2,2,0,1,0
8,326,326,19,11,8,3,2
6,332,332,22,16,6,2,1
20,371,371,39,39,0,1,0
5,394,394,87,59,28,3,2
0,396,396,59,13,46,4,3
22,425,425,7,7,0,1,0
3,433,433,67,67,0,1,0
15,441,441,154,28,126,4,3
24,441,441,30,30,0,1,0
16,457,457,38,17,21,3,2
1,460,460,4,4,0,1,0
23,466,466,17,4,13,2,1
18,479,479,212,212,0,1,0

16,113,113,4,1,3,2,1
27,128,128,4,1,3,2,1
11,156,156,28,28,0,1,0
0,181,181,26,26,0,1,0
2,185,185,3,3,0,1,0
17,203,203,12,12,0,1,0
23,207,207,47,3,44,3,2
6,216,216,1,1,0,1,0
14,217,217,24,13,11,2,1
9,238,238,3,3,0,1,0
13,261,261,4,4,0,1,0
26,278,278,44,1,43,3,2
3,289,289,18,18,0,1,0
19,301,301,70,39,31,2,1
7,302,302,10,1,9,2,1
12,317,317,4,4,0,1,0
5,332,332,109,37,72,4,3
25,343,343,11,11,0,1,0
30,351,351,49,31,18,4,3
28,354,354,40,40,0,1,0
15,388,388,59,50,9,2,1
24,392,392,26,19,7,2,1
21,408,408,42,42,0,1,0
29,421,421,24,14,10,3,2
1,422,422,34,22,12,3,2
18,440,440,38,2,36,4,3
20,440,440,17,2,15,4,3
22,461,461,16,3,13,2,1
10,464,464,10,10,0,1,0
8,494,494,8,8,0,1,0
4,499,499,9,9,0,1,0

4,139,139,13,6,7,2,1
20,141,141,32,32,0,1,0
13,179,179,2,2,0,1,0
19,184,184,41,18,23,2,1
16,216,216,18,18,0,1,0
11,274,274,11,11,0,1,0
27,275,275,1,1,0,1,0
17,279,279,7,7,0,1,0
21,283,283,40,14,26,4,3
0,298,298,97,4,93,3,2
2,308,308,5,5,0,1,0
1,319,319,58,58,0,1,0
9,324,324,50,50,0,1,0
24,349,349,6,2,4,2,1
22,350,350,3,3,0,1,0
14,366,366,29,8,21,2,1
18,394,394,21,4,17,2,1
6,398,398,3,3,0,1,0
23,411,411,67,67,0,1,0
10,445,445,12,12,0,1,0
8,456,456,39,2,37,2,1
25,458,458,3,3,0,1,0
12,472,472,34,16,18,3,2
5,475,475,2,2,0,1,0
26,479,479,89,89,0,1,0
3,480,480,18,3,15,2,1
7,492,492,81,81,0,1,0
15,496,496,93,44,49,2,1

27,101,101,6,6,0,1,0
11,120,120,7,1,6,2,1
24,130,130,1,1,0,1,0
21,143,143,1,1,0,1,0
6,152,152,52,52,0,1,0
2,169,169,6,6,0,1,0
23,193,193,6,3,3,2,1
9,197,197,47,44,3,2,1
14,214,214,3,3,0,1,0
17,216,216,31,31,0,1,0
18,230,230,75,75,0,1,0
1,238,238,39,3,36,3,2
15,253,253,23,4,19,2,1
22,259,259,73,73,0,1,0
13,266,266,2,2,0,1,0
3,326,326,38,11,27,2,1
10,339,339,1,1,0,1,0
25,364,364,8,2,6,3,2
20,367,367,41,1,40,3,2
4,376,376,15,15,0,1,0
12,392,392,3,3,0,1,0
5,396,396,30,15,15,4,3
7,416,416,4,4,0,1,0
16,441,441,23,23,0,1,0
26,476,476,81,75,6,2,1
0,480,480,30,17,13,2,1
19,483,483,32,32,0,1,0
8,495,495,18,3,15,4,3
28,500,500,24,17,7,2,1

7,103,103,20,9,11,2,1
24,113,113,13,7,6,2,1
14,114,114,5,2,3,2,1
4,150,150,3,3,0,1,0
10,156,156,9,9,0,1,0
13,157,157,20,20,0,1,0
6,189,189,1,1,0,1,0
16,190,190,10,10,0,1,0
3,204,204,5,5,0,1,0
18,207,207,56,56,0,1,0
8,218,218,91,35,56,3,2
2,227,227,40,40,0,1,0
11,245,245,37,37,0,1,0
12,254,254,22,10,12,4,3
20,258,258,59,59,0,1,0
5,303,303,29,11,18,4,3
15,360,360,27,27,0,1,0
23,362,362,5,5,0,1,0
19,389,389,56,56,0,1,0
0,426,426,4,4,0,1,0
1,429,429,2,2,0,1,0
21,434,434,11,11,0,1,0
25,457,457,49,30,19,2,1
17,458,458,13,13,0,1,0
9,462,462,28,13,15,2,1
22,469,469,46,4,42,3,2

25,114,114,3,3,0,1,0
26,115,115,6,6,0,1,0
3,148,148,6,6,0,1,0
15,151,151,17,17,0,1,0
13,153,153,21,21,0,1,0
21,161,161,17,17,0,1,0
18,162,162,72,72,0,1,0
6,199,199,17,1,16,2,1
2,201,201,6,3,3,2,1
11,216,216,18,18,0,1,0
17,218,218,2,2,0,1,0
10,224,224,1,1,0,1,0
23,231,231,23,23,0,1,0
5,232,232,8,8,0,1,0
9,244,244,47,47,0,1,0
1,251,251,14,14,0,1,0
7,256,256,21,2,19,2,1
8,296,296,14,1,13,4,3
19,362,362,10,10,0,1,0
12,370,370,111,19,92,3,2
22,377,377,6,6,0,1,0
4,390,390,14,5,9,2,1
14,415,415,68,41,27,2,1
20,429,429,35,8,27,4,3
16,430,430,57,20,37,2,1
0,456,456,78,26,52,3,2
24,491,491,32,17,15,4,3

1,103,103,3,3,0,1,0
8,107,107,5,5,0,1,0
19,107,107,11,11,0,1,0
17,144,144,3,3,0,1,0
28,168,168,25,19,6,2,1
22,180,180,1,1,0,1,0
2,184,184,24,24,0,1,0
3,186,186,8,8,0,1,0
20,189,189,36,14,22,3,2
11,192,192,5,5,0,1,0
15,202,202,70,4,66,4,3
5,220,220,25,25,0,1,0
24,262,262,34,30,4,2,1
16,274,274,57,9,48,2,1
4,290,290,24,24,0,1,0
10,317,317,29,26,3,2,1
7,319,319,1,1,0,1,0
13,324,324,19,7,12,2,1
23,331,331,8,8,0,1,0
6,357,357,5,5,0,1,0
26,362,362,21,21,0,1,0
12,405,405,68,68,0,1,0
25,423,423,45,8,37,2,1
0,448,448,3,3,0,1,0
27,460,460,97,50,47,2,1
18,474,474,13,13,0,1,0
14,478,478,26,26,0,1,0
9,481,481,42,18,24,3,2
21,492,492,50,16,34,2,1

24,112,112,29,7,22,3,2
13,113,113,1,1,0,1,0
7,134,134,10,2,8,3,2
27,144,144,22,11,11,2,1
19,148,148,21,3,18,2,1
4,185,185,16,16,0,1,0
12,207,207,37,13,24,2,1
15,247,247,7,7,0,1,0
25,255,255,43,43,0,1,0
22,257,257,27,16,11,2,1
21,275,275,6,6,0,1,0
16,279,279,7,7,0,1,0
10,283,283,4,4,0,1,0
9,285,285,46,46,0,1,0
1,313,313,3,3,0,1,0
6,330,330,22,22,0,1,0
11,336,336,39,39,0,1,0
26,338,338,9,1,8,2,1
14,339,339,6,6,0,1,0
17,361,361,24,24,0,1,0
0,378,378,9,9,0,1,0
20,383,383,12,4,8,2,1
23,401,401,84,63,21,2,1
8,453,453,23,1,22,2,1
3,456,456,45,45,0,1,0
2,466,466,27,9,18,3,2
18,481,481,42,39,3,2,1
5,499,499,168,124,44,3,2

0,101,101,44,14,30,2,1
13,113,113,42,42,0,1,0
20,137,137,17,17,0,1,0
14,148,148,7,7,0,1,0
15,166,166,8,8,0,1,0
21,183,183,1,1,0,1,0
12,191,191,15,15,0,1,0
2,196,196,7,7,0,1,0
5,202,202,36,7,29,2,1
4,273,273,17,17,0,1,0
19,305,305,3,3,0,1,0
24,306,306,3,3,0,1,0
23,319,319,19,7,12,4,3
18,320,320,31,31,0,1,0
11,325,325,58,58,0,1,0
16,360,360,9,4,5,2,1
6,367,367,9,9,0,1,0
17,369,369,58,58,0,1,0
8,401,401,42,42,0,1,0
9,434,434,30,30,0,1,0
10,436,436,46,46,0,1,0
7,454,454,12,9,3,2,1
1,483,483,29,10,19,2,1
22,498,498,145,46,99,4,3
3,499,499,10,10,0,1,0

7,100,100,43,29,14,4,3
16,110,110,19,5,14,2,1
10,130,130,2,2,0,1,0
3,142,142,8,8,0,1,0
0,143,143,17,17,0,1,0
13,168,168,25,13,12,4,3
12,203,203,2,2,0,1,0
15,207,207,2,2,0,1,0
8,220,220,42,42,0,1,0
17,224,224,1,1,0,1,0
18,350,350,149,44,105,4,3
6,356,356,1,1,0,1,0
11,358,358,9,3,6,3,2
14,359,359,29,29,0,1,0
19,370,370,27,27,0,1,0
5,371,371,129,3,126,4,3
1,377,377,25,5,20,4,3
9,404,404,11,1,10,3,2
2,420,420,62,62,0,1,0
4,484,484,67,67,0,1,0
20,500,500,77,37,40,3,2

1,102,102,15,15,0,1,0
21,103,103,13,13,0,1,0
15,107,107,15,1,14,3,2
9,110,110,4,4,0,1,0
13,112,112,6,6,0,1,0
20,115,115,2,2,0,1,0
26,125,125,34,17,17,2,1
11,129,129,10,10,0,1,0
6,155,155,1,1,0,1,0
7,157,157,16,16,0,1,0
22,160,160,13,13,0,1,0
28,179,179,24,24,0,1,0
24,193,193,36,25,11,2,1
18,209,209,19,11,8,2,1
3,213,213,1,1,0,1,0
27,229,229,6,3,3,2,1
19,242,242,35,21,14,2,1
25,270,270,4,4,0,1,0
14,318,318,26,26,0,1,0
16,323,323,13,5,8,2,1
17,352,352,10,7,3,2,1
2,355,355,57,57,0,1,0
5,448,448,17,11,6,2,1
8,452,452,2,2,0,1,0
10,471,471,30,30,0,1,0
4,478,478,9,9,0,1,0
12,481,481,123,90,33,4,3
23,483,483,80,38,42,2,1
0,499,499,55,16,39,4,3

0,106,106,6,6,0,1,0
16,118,118,34,11,23,2,1
15,151,151,4,4,0,1,0
4,176,176,27,1,26,4,3
5,180,180,11,11,0,1,0
3,190,190,1,1,0,1,0
21,224,224,3,3,0,1,0
14,226,226,7,7,0,1,0
9,240,240,4,1,3,2,1
7,262,262,8,8,0,1,0
18,273,273,3,3,0,1,0
10,285,285,87,12,75,4,3
1,303,303,77,77,0,1,0
22,308,308,11,5,6,2,1
13,327,327,20,5,15,4,3
19,332,332,2,2,0,1,0
8,336,336,71,71,0,1,0
12,367,367,23,23,0,1,0
11,383,383,120,47,73,4,3
6,454,454,165,81,84,3,2
20,474,474,70,34,36,4,3
2,494,494,73,73,0,1,0
17,500,500,15,15,0,1,0

15,103,103,23,4,19,2,1
13,106,106,23,23,0,1,0
20,125,125,3,3,0,1,0
21,166,166,27,7,20,3,2
0,168,168,3,3,0,1,0
6,179,179,15,15,0,1,0
14,189,189,56,53,3,2,1
3,203,203,48,7,41,2,1
16,212,212,1,1,0,1,0
8,238,238,3,3,0,1,0
1,250,250,117,109,8,2,1
22,260,260,9,5,4,2,1
10,262,262,2,2,0,1,0
11,293,293,2,2,0,1,0
2,296,296,1,1,0,1,0
4,309,309,26,26,0,1,0
18,322,322,29,2,27,4,3
19,369,369,11,5,6,2,1
7,396,396,29,29,0,1,0
5,417,417,44,44,0,1,0
9,450,450,97,28,69,4,3
17,464,464,47,15,32,3,2
12,475,475,64,19,45,2,1

17,102,102,5,5,0,1,0
21,114,114,26,26,0,1,0
30,129,129,16,16,0,1,0
26,143,143,3,3,0,1,0
7,157,157,1,1,0,1,0
15,161,161,8,8,0,1,0
33,186,186,17,5,12,4,3
2,205,205,3,3,0,1,0
18,216,216,1,1,0,1,0
14,222,222,13,13,0,1,0
24,238,238,9,9,0,1,0
28,246,246,54,33,21,4,3
0,253,253,35,35,0,1,0
3,254,254,6,6,0,1,0
34,262,262,44,39,5,2,1
16,269,269,6,6,0,1,0
1,271,271,20,8,12,3,2
12,278,278,1,1,0,1,0
19,283,283,54,54,0,1,0
9,328,328,19,19,0,1,0
13,330,330,10,10,0,1,0
11,336,336,17,8,9,4,3
23,340,340,3,3,0,1,0
5,350,350,13,13,0,1,0
20,355,355,10,5,5,2,1
6,390,390,25,25,0,1,0
32,413,413,7,1,6,3,2
31,415,415,112,112,0,1,0
10,434,434,34,1,33,2,1
35,451,451,51,46,5,2,1
27,458,458,19,19,0,1,0
4,459,459,3,3,0,1,0
25,474,474,36,36,0,1,0
22,491,491,33,27,6,2,1
29,492,492,68,24,44,2,1
8,494,494,9,6,3,2,1

9,102,102,10,2,8,2,1
18,103,103,16,10,6,3,2
8,112,112,12,8,4,2,1
22,129,129,12,9,3,2,1
2,133,133,4,4,0,1,0
16,143,143,29,29,0,1,0
10,160,160,24,24,0,1,0
0,169,169,1,1,0,1,0
14,195,195,3,3,0,1,0
12,198,198,4,4,0,1,0
5,201,201,10,2,8,2,1
19,219,219,24,24,0,1,0
17,232,232,2,2,0,1,0
25,242,242,47,27,20,3,2
24,276,276,11,11,0,1,0
1,291,291,10,10,0,1,0
3,296,296,86,86,0,1,0
26,305,305,32,32,0,1,0
11,330,330,38,38,0,1,0
20,341,341,15,9,6,3,2
7,342,342,23,7,16,2,1
4,346,346,2,2,0,1,0
6,358,358,25,13,12,2,1
21,419,419,106,106,0,1,0
23,423,423,15,9,6,3,2
15,465,465,35,12,23,2,1
13,490,490,126,34,92,4,3

8,118,118,1,1,0,1,0
17,119,119,15,5,10,3,2
6,120,120,21,21,0,1,0
27,134,134,22,22,0,1,0
19,149,149,8,8,0,1,0
7,162,162,6,6,0,1,0
11,173,173,24,2,22,3,2
0,187,187,18,6,12,2,1
22,191,191,32,32,0,1,0
20,194,194,13,13,0,1,0
26,201,201,6,1,5,2,1
2,215,215,3,3,0,1,0
24,220,220,65,65,0,1,0
12,248,248,5,5,0,1,0
3,268,268,20,20,0,1,0
1,275,275,15,15,0,1,0
21,327,327,8,8,0,1,0
23,332,332,19,16,3,2,1
15,336,336,31,8,23,3,2
28,345,345,14,14,0,1,0
9,353,353,18,18,0,1,0
25,357,357,20,9,11,3,2
13,395,395,119,35,84,4,3
29,413,413,14,14,0,1,0
14,418,418,2,2,0,1,0
18,422,422,90,12,78,4,3
16,436,436,33,33,0,1,0
5,436,436,3,3,0,1,0
10,454,454,38,38,0,1,0
4,464,464,31,23,8,2,1

10,126,126,5,5,0,1,0
3,136,136,25,9,16,3,2
13,155,155,14,14,0,1,0
21,161,161,48,48,0,1,0
17,190,190,16,7,9,2,1
1,210,210,54,54,0,1,0
4,224,224,62,62,0,1,0
9,265,265,62,19,43,4,3
0,299,299,42,42,0,1,0
18,300,300,3,3,0,1,0
11,320,320,29,15,14,3,2
23,324,324,17,5,12,4,3
14,365,365,26,26,0,1,0
20,385,385,101,23,78,4,3
22,385,385,30,30,0,1,0
12,391,391,65,57,8,3,2
16,391,391,22,22,0,1,0
15,401,401,11,11,0,1,0
7,414,414,8,8,0,1,0
5,414,414,25,25,0,1,0
8,462,462,13,9,4,2,1
6,469,469,5,5,0,1,0
2,477,477,25,3,22,3,2
19,485,485,20,20,0,1,0

9,116,116,37,4,33,4,3
22,132,132,2,2,0,1,0
24,142,142,32,23,9,4,3
3,161,161,5,5,0,1,0
16,180,180,3,3,0,1,0
13,196,196,55,55,0,1,0
18,219,219,3,3,0,1,0
2,222,222,14,14,0,1,0
25,232,232,20,20,0,1,0
12,258,258,1,1,0,1,0
1,278,278,36,16,20,3,2
27,279,279,3,3,0,1,0
7,284,284,4,4,0,1,0
21,303,303,40,40,0,1,0
5,316,316,11,3,8,2,1
0,355,355,64,41,23,2,1
17,358,358,47,5,42,3,2
29,359,359,28,20,8,3,2
6,370,370,14,14,0,1,0
28,379,379,38,25,13,2,1
14,390,390,1,1,0,1,0
4,393,393,8,8,0,1,0
19,405,405,45,24,21,4,3
11,412,412,34,10,24,3,2
15,418,418,4,4,0,1,0
23,448,448,6,1,5,2,1
10,464,464,13,13,0,1,0
26,477,477,9,1,8,3,2
8,481,481,24,14,10,2,1
20,485,485,186,151,35,2,1

11,101,101,14,14,0,1,0
8,118,118,18,18,0,1,0
18,121,121,8,1,7,2,1
26,155,155,5,5,0,1,0
3,159,159,5,5,0,1,0
25,163,163,24,7,17,2,1
10,164,164,1,1,0,1,0
30,175,175,5,5,0,1,0
23,178,178,3,3,0,1,0
5,191,191,5,2,3,2,1
0,198,198,1,1,0,1,0
32,223,223,21,15,6,3,2
34,242,242,24,3,21,2,1
4,273,273,33,33,0,1,0
21,288,288,1,1,0,1,0
19,292,292,2,2,0,1,0
28,294,294,34,34,0,1,0
29,351,351,62,26,36,2,1
15,378,378,51,51,0,1,0
9,379,379,17,1,16,4,3
13,387,387,7,1,6,3,2
6,399,399,12,12,0,1,0
7,403,403,45,10,35,2,1
17,420,420,2,2,0,1,0
24,424,424,25,13,12,2,1
33,424,424,121,22,99,4,3
27,433,433,87,87,0,1,0
2,434,434,29,8,21,4,3
16,439,439,2,2,0,1,0
14,445,445,13,13,0,1,0
1,448,448,7,7,0,1,0
20,461,461,90,90,0,1,0
22,465,465,4,4,0,1,0
12,470,470,41,3,38,3,2
31,477,477,29,15,14,3,2

10,103,103,3,3,0,1,0
7,129,129,8,8,0,1,0
8,134,134,28,28,0,1,0
6,145,145,48,48,0,1,0
16,159,159,46,7,39,2,1
1,173,173,6,1,5,2,1
14,208,208,24,24,0,1,0
3,223,223,14,14,0,1,0
17,238,238,6,6,0,1,0
2,270,270,4,4,0,1,0
20,272,272,22,22,0,1,0
11,276,276,6,6,0,1,0
0,310,310,42,42,0,1,0
18,317,317,4,4,0,1,0
21,406,406,158,83,75,4,3
4,423,423,67,44,23,2,1
13,433,433,76,1,75,4,3
15,441,441,43,43,0,1,0
19,457,457,15,15,0,1,0
9,464,464,5,5,0,1,0
12,482,482,26,2,24,2,1
5,486,486,145,114,31,2,1

2,129,129,9,9,0,1,0
10,130,130,2,2,0,1,0
5,152,152,17,17,0,1,0
14,175,175,20,20,0,1,0
9,196,196,8,8,0,1,0
3,207,207,76,76,0,1,0
1,259,259,51,31,20,3,2
13,274,274,70,70,0,1,0
6,312,312,118,109,9,4,3
18,316,316,4,4,0,1,0
11,327,327,3,3,0,1,0
16,395,395,55,19,36,4,3
0,399,399,17,17,0,1,0
7,406,406,91,91,0,1,0
19,408,408,21,21,0,1,0
8,414,414,2,2,0,1,0
12,418,418,58,16,42,4,3
15,424,424,94,47,47,3,2
4,429,429,58,58,0,1,0
17,439,439,38,16,22,3,2

6,113,113,6,6,0,1,0
25,132,132,3,3,0,1,0
8,149,149,53,5,48,2,1
16,158,158,9,4,5,2,1
18,188,188,6,6,0,1,0
0,209,209,5,5,0,1,0
11,235,235,11,3,8,3,2
23,236,236,80,80,0,1,0
17,238,238,5,5,0,1,0
15,244,244,4,4,0,1,0
5,257,257,18,10,8,2,1
20,289,289,56,42,14,2,1
9,300,300,56,31,25,2,1
22,302,302,92,17,75,4,3
21,314,314,30,30,0,1,0
24,386,386,17,8,9,2,1
2,415,415,50,50,0,1,0
7,420,420,29,29,0,1,0
4,424,424,23,3,20,2,1
3,424,424,7,2,5,2,1
19,425,425,5,1,4,2,1
13,427,427,4,4,0,1,0
12,431,431,88,32,56,4,3
14,440,440,5,5,0,1,0
10,478,478,1,1,0,1,0
1,488,488,43,23,20,3,2
26,498,498,90,45,45,2,1

19,108,108,13,13,0,1,0
9,139,139,32,32,0,1,0
11,152,152,4,4,0,1,0
10,184,184,9,4,5,2,1
5,192,192,22,10,12,3,2
18,193,193,25,25,0,1,0
16,218,218,1,1,0,1,0
7,248,248,6,2,4,2,1
1,303,303,17,7,10,3,2
17,308,308,12,12,0,1,0
0,354,354,59,59,0,1,0
13,385,385,10,10,0,1,0
22,391,391,47,47,0,1,0
14,391,391,68,68,0,1,0
12,406,406,88,76,12,4,3
24,422,422,1,1,0,1,0
23,433,433,17,17,0,1,0
2,438,438,10,10,0,1,0
3,442,442,9,9,0,1,0
8,449,449,91,49,42,4,3
15,450,450,23,1,22,2,1
21,450,450,112,112,0,1,0
4,472,472,169,152,17,2,1
20,487,487,74,74,0,1,0
6,492,492,15,5,10,3,2

14,142,142,5,5,0,1,0
0,145,145,5,1,4,2,1
15,166,166,1,1,0,1,0
8,168,168,80,80,0,1,0
4,169,169,24,2,22,3,2
19,184,184,15,2,13,2,1
10,189,189,10,1,9,2,1
5,192,192,1,1,0,1,0
22,249,249,31,31,0,1,0
12,251,251,21,9,12,3,2
21,268,268,14,14,0,1,0
16,299,299,29,29,0,1,0
9,309,309,18,9,9,4,3
24,313,313,50,35,15,2,1
26,319,319,34,8,26,2,1
20,324,324,27,27,0,1,0
7,349,349,71,32,39,4,3
18,357,357,94,35,59,4,3
13,358,358,10,10,0,1,0
1,361,361,10,1,9,2,1
6,375,375,8,8,0,1,0
23,391,391,86,70,16,3,2
25,397,397,1,1,0,1,0
17,407,407,37,37,0,1,0
3,458,458,22,6,16,3,2
11,484,484,5,5,0,1,0
2,494,494,54,18,36,3,2

6,106,106,9,2,7,2,1
13,106,106,8,8,0,1,0
10,125,125,27,13,14,3,2
12,131,131,3,3,0,1,0
20,156,156,2,2,0,1,0
21,158,158,33,18,15,4,3
18,159,159,24,24,0,1,0
16,194,194,2,2,0,1,0
7,220,220,58,14,44,3,2
2,226,226,87,24,63,4,3
5,284,284,33,33,0,1,0
3,288,288,13,1,12,2,1
8,296,296,19,16,3,2,1
14,298,298,11,1,10,3,2
0,299,299,8,1,7,2,1
1,308,308,7,7,0,1,0
22,322,322,28,1,27,3,2
17,359,359,59,59,0,1,0
15,364,364,109,25,84,4,3
23,402,402,20,20,0,1,0
19,418,418,88,64,24,3,2
11,427,427,1,1,0,1,0
9,437,437,29,11,18,3,2
4,459,459,5,5,0,1,0

9,107,107,1,1,0,1,0
7,113,113,4,4,0,1,0
13,114,114,2,2,0,1,0
10,177,177,1,1,0,1,0
21,194,194,38,7,31,2,1
23,198,198,27,7,20,3,2
22,200,200,38,22,16,3,2
2,233,233,29,21,8,2,1
24,266,266,28,28,0,1,0
0,273,273,12,1,11,2,1
19,284,284,16,16,0,1,0
12,286,286,121,100,21,4,3
25,308,308,64,64,0,1,0
5,351,351,53,53,0,1,0
1,359,359,21,21,0,1,0
17,364,364,9,9,0,1,0
8,365,365,50,50,0,1,0
16,380,380,63,41,22,3,2
20,388,388,23,23,0,1,0
4,395,395,10,1,9,2,1
11,405,405,7,7,0,1,0
18,409,409,4,1,3,2,1
3,429,429,43,35,8,2,1
14,430,430,22,2,20,2,1
6,448,448,76,76,0,1,0
15,450,450,49,31,18,4,3

5,101,101,3,3,0,1,0
14,108,108,16,16,0,1,0
0,113,113,13,4,9,2,1
10,145,145,37,1,36,4,3
18,151,151,3,3,0,1,0
9,154,154,24,24,0,1,0
21,169,169,7,2,5,2,1
13,169,169,8,8,0,1,0
11,181,181,19,19,0,1,0
23,187,187,6,6,0,1,0
20,187,187,26,14,12,3,2
17,276,276,54,19,35,2,1
3,282,282,14,14,0,1,0
24,297,297,100,56,44,2,1
8,310,310,7,1,6,2,1
12,311,311,22,9,13,2,1
1,312,312,56,56,0,1,0
15,317,317,37,37,0,1,0
19,330,330,12,12,0,1,0
4,330,330,69,51,18,4,3
2,409,409,47,47,0,1,0
16,427,427,3,3,0,1,0
22,473,473,61,61,0,1,0
6,477,477,23,14,9,4,3
7,487,487,8,2,6,3,2

3,102,102,4,4,0,1,0
14,117,117,18,18,0,1,0
26,126,126,7,7,0,1,0
7,138,138,5,2,3,2,1
12,162,162,7,3,4,2,1
4,167,167,7,4,3,2,1
16,169,169,11,2,9,2,1
25,177,177,4,4,0,1,0
20,177,177,5,2,3,2,1
18,211,211,34,34,0,1,0
15,233,233,3,3,0,1,0
11,234,234,20,9,11,2,1
17,261,261,1,1,0,1,0
9,271,271,56,56,0,1,0
2,313,313,7,1,6,3,2
13,346,346,68,68,0,1,0
21,350,350,69,55,14,2,1
10,367,367,3,3,0,1,0
5,370,370,13,1,12,3,2
0,375,375,8,8,0,1,0
8,391,391,74,26,48,3,2
6,409,409,138,138,0,1,0
1,429,429,17,17,0,1,0
19,448,448,163,103,60,4,3
24,454,454,43,1,42,3,2
22,464,464,80,80,0,1,0
23,481,481,4,1,3,2,1

21,117,117,21,21,0,1,0
5,140,140,4,4,0,1,0
2,142,142,1,1,0,1,0
13,172,172,29,9,20,3,2
1,178,178,1,1,0,1,0
25,190,190,6,3,3,2,1
16,201,201,27,19,8,3,2
26,206,206,21,1,20,2,1
19,236,236,41,41,0,1,0
23,237,237,11,11,0,1,0
17,256,256,25,20,5,2,1
4,260,260,50,50,0,1,0
9,286,286,2,2,0,1,0
18,295,295,11,11,0,1,0
10,311,311,32,32,0,1,0
20,314,314,11,11,0,1,0
8,317,317,101,101,0,1,0
0,321,321,44,9,35,2,1
15,360,360,82,34,48,2,1
12,360,360,43,43,0,1,0
11,374,374,38,11,27,2,1
22,377,377,1,1,0,1,0
7,423,423,33,1,32,4,3
3,463,463,12,6,6,3,2
14,469,469,99,60,39,2,1
24,480,480,27,27,0,1,0
6,498,498,6,6,0,1,0

21,132,132,22,22,0,1,0
29,142,142,7,7,0,1,0
20,153,153,3,3,0,1,0
3,161,161,2,2,0,1,0
24,173,173,14,1,13,3,2
8,183,183,6,6,0,1,0
25,190,190,4,4,0,1,0
30,193,193,8,2,6,3,2
23,202,202,89,32,57,4,3
22,217,217,7,1,6,3,2
0,228,228,1,1,0,1,0
7,241,241,57,3,54,4,3
16,252,252,21,3,18,3,2
17,277,277,13,1,12,3,2
9,286,286,62,17,45,2,1
12,295,295,20,8,12,4,3
26,302,302,9,9,0,1,0
18,302,302,6,6,0,1,0
10,336,336,1,1,0,1,0
1,352,352,6,2,4,2,1
11,356,356,53,29,24,3,2
27,371,371,53,53,0,1,0
19,377,377,37,37,0,1,0
15,380,380,21,21,0,1,0
4,404,404,29,29,0,1,0
14,413,413,2,2,0,1,0
2,441,441,63,63,0,1,0
28,445,445,84,36,48,2,1
5,460,460,21,21,0,1,0
6,471,471,17,17,0,1,0
13,497,497,37,37,0,1,0

12,123,123,3,3,0,1,0
3,134,134,7,7,0,1,0
18,138,138,19,1,18,2,1
23,177,177,29,11,18,4,3
4,184,184,17,1,16,3,2
9,192,192,11,11,0,1,0
5,211,211,5,5,0,1,0
11,215,215,11,2,9,2,1
13,218,218,18,18,0,1,0
16,237,237,28,9,19,2,1
0,242,242,12,6,6,2,1
19,245,245,11,11,0,1,0
14,287,287,30,30,0,1,0
21,317,317,29,15,14,2,1
8,340,340,20,3,17,2,1
6,348,348,90,90,0,1,0
24,358,358,124,76,48,2,1
15,383,383,16,1,15,4,3
1,429,429,87,79,8,3,2
17,443,443,11,11,0,1,0
7,447,447,22,22,0,1,0
20,455,455,25,4,21,2,1
22,455,455,43,43,0,1,0
10,482,482,4,1,3,2,1
2,490,490,194,52,142,4,3

18,111,111,10,10,0,1,0
12,112,112,15,15,0,1,0
1,127,127,7,7,0,1,0
19,130,130,9,6,3,2,1
20,153,153,15,15,0,1,0
21,154,154,6,6,0,1,0
22,166,166,5,5,0,1,0
7,176,176,11,5,6,2,1
25,177,177,36,36,0,1,0
14,181,181,25,5,20,2,1
6,181,181,3,3,0,1,0
24,188,188,10,10,0,1,0
5,193,193,14,14,0,1,0
15,199,199,80,24,56,3,2
11,238,238,1,1,0,1,0
10,263,263,22,9,13,2,1
16,295,295,26,26,0,1,0
17,302,302,15,15,0,1,0
3,307,307,4,1,3,2,1
9,340,340,72,62,10,2,1
27,374,374,25,25,0,1,0
23,418,418,2,2,0,1,0
26,435,435,61,43,18,4,3
0,443,443,73,61,12,2,1
2,450,450,52,52,0,1,0
4,454,454,78,33,45,4,3
13,455,455,5,5,0,1,0
8,476,476,23,12,11,2,1

17,104,104,11,11,0,1,0
13,123,123,25,1,24,4,3
15,130,130,11,1,10,2,1
19,143,143,19,19,0,1,0
4,180,180,18,14,4,2,1
5,204,204,11,11,0,1,0
24,204,204,7,7,0,1,0
22,212,212,9,9,0,1,0
6,229,229,38,38,0,1,0
12,260,260,40,9,31,2,1
21,267,267,15,6,9,4,3
8,274,274,66,19,47,2,1
16,299,299,22,13,9,4,3
20,321,321,61,61,0,1,0
3,335,335,57,31,26,2,1
2,354,354,15,15,0,1,0
0,382,382,26,5,21,2,1
9,383,383,28,28,0,1,0
7,414,414,88,88,0,1,0
18,432,432,17,17,0,1,0
10,437,437,12,3,9,2,1
14,451,451,36,36,0,1,0
11,459,459,24,12,12,4,3
1,466,466,44,44,0,1,0
23,490,490,68,47,21,2,1

12,114,114,6,6,0,1,0
23,122,122,3,3,0,1,0
11,129,129,7,2,5,2,1
7,163,163,1,1,0,1,0
18,170,170,4,4,0,1,0
22,186,186,29,29,0,1,0
3,188,188,9,9,0,1,0
13,193,193,8,8,0,1,0
15,194,194,24,24,0,1,0
0,206,206,2,2,0,1,0
6,219,219,28,28,0,1,0
19,247,247,22,2,20,3,2
2,263,263,8,8,0,1,0
27,286,286,18,7,11,2,1
5,287,287,103,103,0,1,0
4,293,293,6,1,5,2,1
16,310,310,48,48,0,1,0
24,314,314,116,1,115,4,3
9,321,321,8,3,5,2,1
29,322,322,26,20,6,2,1
26,325,325,51,38,13,2,1
1,325,325,1,1,0,1,0
20,350,350,2,2,0,1,0
14,372,372,13,13,0,1,0
25,373,373,1,1,0,1,0
17,398,398,46,46,0,1,0
28,417,417,92,57,35,2,1
8,424,424,77,17,60,4,3
21,446,446,8,1,7,2,1
10,481,481,14,2,12,3,2

9,111,111,1,1,0,1,0
1,127,127,6,2,4,2,1
11,130,130,28,28,0,1,0
16,133,133,12,12,0,1,0
7,148,148,10,4,6,2,1
5,177,177,7,7,0,1,0
20,180,180,15,4,11,2,1
19,182,182,16,3,13,2,1
22,188,188,23,23,0,1,0
15,237,237,25,25,0,1,0
10,250,250,95,12,83,4,3
3,254,254,4,4,0,1,0
6,255,255,18,18,0,1,0
2,262,262,110,110,0,1,0
21,265,265,35,35,0,1,0
12,304,304,14,5,9,4,3
18,310,310,16,4,12,4,3
23,375,375,11,3,8,3,2
8,381,381,10,10,0,1,0
17,390,390,4,1,3,2,1
14,402,402,48,48,0,1,0
4,404,404,49,49,0,1,0
0,425,425,45,45,0,1,0
13,499,499,112,112,0,1,0

1,164,164,18,10,8,3,2
5,164,164,78,60,18,3,2
3,178,178,21,3,18,3,2
7,214,214,73,48,25,2,1
4,231,231,1,1,0,1,0
9,233,233,26,6,20,2,1
15,265,265,6,6,0,1,0
0,280,280,10,10,0,1,0
10,286,286,37,7,30,4,3
19,318,318,6,2,4,2,1
6,322,322,51,51,0,1,0
8,327,327,37,15,22,2,1
20,346,346,8,8,0,1,0
11,347,347,15,9,6,3,2
17,397,397,97,48,49,2,1
13,440,440,83,83,0,1,0
12,464,464,45,45,0,1,0
14,467,467,39,27,12,4,3
2,480,480,29,29,0,1,0
18,484,484,77,77,0,1,0
16,485,485,41,41,0,1,0

18,121,121,26,26,0,1,0
19,139,139,14,8,6,2,1
9,155,155,19,19,0,1,0
4,168,168,8,8,0,1,0
13,186,186,4,1,3,2,1
2,187,187,20,20,0,1,0
25,195,195,7,7,0,1,0
5,197,197,14,14,0,1,0
15,198,198,12,1,11,4,3
21,200,200,55,28,27,4,3
6,202,202,6,6,0,1,0
28,203,203,27,3,24,3,2
23,218,218,11,7,4,2,1
10,249,249,8,8,0,1,0
27,253,253,4,4,0,1,0
17,254,254,11,11,0,1,0
22,258,258,17,12,5,2,1
26,286,286,41,41,0,1,0
0,286,286,21,21,0,1,0
14,297,297,126,126,0,1,0
3,303,303,21,21,0,1,0
8,340,340,17,11,6,2,1
24,353,353,43,43,0,1,0
11,361,361,34,29,5,2,1
12,396,396,9,9,0,1,0
1,442,442,30,30,0,1,0
16,451,451,34,34,0,1,0
7,451,451,5,5,0,1,0
20,478,478,24,20,4,2,1

21,107,107,2,2,0,1,0
3,112,112,5,5,0,1,0
20,145,145,63,63,0,1,0
18,179,179,42,15,27,4,3
2,200,200,1,1,0,1,0
19,216,216,8,8,0,1,0
24,229,229,2,2,0,1,0
7,241,241,18,18,0,1,0
5,263,263,8,8,0,1,0
16,276,276,27,6,21,4,3
26,299,299,107,84,23,2,1
23,301,301,2,2,0,1,0
22,314,314,23,23,0,1,0
12,329,329,8,3,5,2,1
1,332,332,11,3,8,3,2
28,334,334,12,12,0,1,0
6,353,353,15,15,0,1,0
15,354,354,37,37,0,1,0
8,358,358,42,42,0,1,0
4,360,360,22,10,12,4,3
25,371,371,9,9,0,1,0
10,377,377,75,16,59,4,3
29,400,400,4,4,0,1,0
11,426,426,80,57,23,2,1
17,470,470,23,23,0,1,0
14,479,479,53,53,0,1,0
0,483,483,41,9,32,3,2
27,483,483,14,14,0,1,0
9,484,484,31,4,27,2,1
13,488,488,10,10,0,1,0

8,122,122,33,33,0,1,0
10,131,131,2,2,0,1,0
20,144,144,16,7,9,4,3
17,150,150,36,36,0,1,0
24,167,167,40,9,31,4,3
22,187,187,33,33,0,1,0
3,205,205,7,7,0,1,0
18,207,207,16,9,7,2,1
1,221,221,13,13,0,1,0
15,228,228,3,3,0,1,0
19,230,230,11,2,9,2,1
5,254,254,21,21,0,1,0
11,308,308,20,5,15,4,3
23,324,324,58,58,0,1,0
16,334,334,10,10,0,1,0
4,358,358,35,21,14,2,1
13,363,363,7,7,0,1,0
25,399,399,4,4,0,1,0
9,406,406,33,33,0,1,0
7,408,408,92,92,0,1,0
21,416,416,47,21,26,2,1
12,435,435,71,53,18,3,2
0,445,445,50,50,0,1,0
14,458,458,33,27,6,2,1
2,461,461,22,22,0,1,0
6,493,493,23,23,0,1,0

28,127,127,16,16,0,1,0
20,137,137,9,9,0,1,0
19,139,139,2,2,0,1,0
23,139,139,2,2,0,1,0
29,139,139,19,14,5,2,1
10,182,182,7,3,4,2,1
18,198,198,11,11,0,1,0
25,204,204,89,80,9,4,3
27,217,217,11,11,0,1,0
33,219,219,2,2,0,1,0
9,223,223,33,33,0,1,0
21,257,257,6,6,0,1,0
17,277,277,2,2,0,1,0
30,290,290,58,46,12,2,1
7,303,303,25,25,0,1,0
22,325,325,2,2,0,1,0
2,332,332,4,4,0,1,0
14,334,334,2,2,0,1,0
34,365,365,15,15,0,1,0
11,372,372,5,5,0,1,0
13,377,377,5,5,0,1,0
8,392,392,9,9,0,1,0
5,403,403,4,4,0,1,0
15,411,411,27,27,0,1,0
31,411,411,23,4,19,2,1
16,412,412,33,33,0,1,0
6,432,432,30,15,15,2,1
32,435,435,42,42,0,1,0
26,454,454,41,26,15,2,1
3,458,458,22,22,0,1,0
24,464,464,31,31,0,1,0
1,488,488,141,141,0,1,0
4,491,491,14,14,0,1,0
0,492,492,15,9,6,2,1
12,497,497,88,29,59,4,3

18,114,114,8,8,0,1,0
22,124,124,20,7,13,2,1
23,125,125,10,7,3,2,1
1,164,164,9,9,0,1,0
8,175,175,17,17,0,1,0
6,198,198,3,3,0,1,0
3,203,203,39,12,27,4,3
7,213,213,1,1,0,1,0
21,220,220,19,19,0,1,0
9,231,231,13,13,0,1,0
14,237,237,18,12,6,3,2
15,241,241,27,27,0,1,0
5,272,272,46,46,0,1,0
2,281,281,2,2,0,1,0
13,302,302,39,21,18,3,2
0,305,305,17,4,13,2,1
10,308,308,37,37,0,1,0
19,311,311,18,3,15,2,1
24,312,312,67,67,0,1,0
11,345,345,118,93,25,2,1
12,374,374,21,21,0,1,0
4,378,378,1,1,0,1,0
26,417,417,55,55,0,1,0
17,465,465,74,36,38,3,2
20,470,470,40,40,0,1,0
25,480,480,35,35,0,1,0
16,492,492,7,3,4,2,1

1,102,102,4,4,0,1,0
11,148,148,10,10,0,1,0
8,150,150,11,11,0,1,0
17,177,177,57,57,0,1,0
16,177,177,27,27,0,1,0
7,182,182,49,29,20,3,2
4,187,187,12,12,0,1,0
20,194,194,15,7,8,3,2
9,206,206,2,2,0,1,0
14,265,265,11,1,10,2,1
19,274,274,12,4,8,2,1
6,278,278,105,105,0,1,0
0,282,282,2,2,0,1,0
10,320,320,14,4,10,3,2
12,322,322,11,11,0,1,0
5,329,329,76,48,28,3,2
2,347,347,1,1,0,1,0
21,388,388,47,47,0,1,0
18,435,435,151,56,95,4,3
15,440,440,14,14,0,1,0
3,448,448,106,106,0,1,0
13,468,468,14,14,0,1,0

26,103,103,5,2,3,2,1
24,126,126,6,6,0,1,0
19,133,133,8,8,0,1,0
6,153,153,36,11,25,2,1
18,170,170,13,2,11,2,1
7,219,219,40,14,26,2,1
11,258,258,10,10,0,1,0
13,266,266,3,3,0,1,0
12,297,297,10,10,0,1,0
10,331,331,43,43,0,1,0
8,343,343,46,2,44,2,1
25,377,377,23,9,14,2,1
17,377,377,11,11,0,1,0
16,395,395,108,9,99,4,3
20,396,396,30,18,12,4,3
15,398,398,82,82,0,1,0
4,401,401,32,32,0,1,0
22,404,404,96,6,90,3,2
14,415,415,37,1,36,2,1
5,447,447,49,49,0,1,0
3,454,454,20,3,17,2,1
1,467,467,1,1,0,1,0
0,470,470,122,50,72,4,3
2,480,480,18,18,0,1,0
23,494,494,35,3,32,3,2
9,499,499,2,2,0,1,0
21,499,499,25,19,6,2,1

18,104,104,13,13,0,1,0
9,120,120,26,10,16,3,2
23,120,120,6,6,0,1,0
0,140,140,26,12,14,3,2
16,150,150,9,9,0,1,0
11,153,153,7,7,0,1,0
25,157,157,24,24,0,1,0
7,175,175,8,8,0,1,0
2,195,195,4,4,0,1,0
5,223,223,43,9,34,3,2
15,278,278,12,12,0,1,0
30,283,283,43,43,0,1,0
6,298,298,18,18,0,1,0
3,314,314,29,13,16,2,1
19,314,314,29,18,11,2,1
21,331,331,32,12,20,2,1
8,358,358,16,4,12,2,1
1,376,376,36,36,0,1,0
14,396,396,8,8,0,1,0
24,400,400,2,2,0,1,0
4,416,416,17,7,10,3,2
13,419,419,12,12,0,1,0
27,422,422,56,47,9,4,3
28,427,427,13,13,0,1,0
22,429,429,5,1,4,2,1
20,430,430,125,120,5,2,1
29,454,454,49,49,0,1,0
10,471,471,13,1,12,3,2
26,472,472,37,37,0,1,0
17,482,482,19,19,0,1,0
12,485,485,20,16,4,2,1

23,180,180,17,11,6,2,1
0,196,196,26,2,24,4,3
2,200,200,4,4,0,1,0
7,231,231,10,10,0,1,0
1,296,296,105,45,60,4,3
4,303,303,30,30,0,1,0
8,305,305,68,2,66,3,2
20,316,316,7,7,0,1,0
6,320,320,62,62,0,1,0
12,320,320,42,23,19,2,1
19,333,333,10,1,9,4,3
21,341,341,20,20,0,1,0
5,343,343,7,7,0,1,0
14,346,346,33,26,7,2,1
22,371,371,14,2,12,3,2
10,399,399,17,9,8,3,2
9,408,408,8,8,0,1,0
18,423,423,24,3,21,4,3
17,427,427,13,4,9,4,3
13,432,432,128,65,63,4,3
16,443,443,146,29,117,4,3
11,460,460,12,12,0,1,0
15,479,479,52,52,0,1,0
3,480,480,73,52,21,4,3

22,100,100,8,8,0,1,0
0,106,106,7,7,0,1,0
19,130,130,2,2,0,1,0
7,132,132,1,1,0,1,0
16,135,135,10,10,0,1,0
3,164,164,4,4,0,1,0
23,204,204,98,69,29,2,1
4,205,205,1,1,0,1,0
5,209,209,12,12,0,1,0
8,239,239,7,7,0,1,0
13,252,252,2,2,0,1,0
2,255,255,7,7,0,1,0
15,274,274,41,41,0,1,0
11,343,343,31,21,10,3,2
10,343,343,26,26,0,1,0
28,350,350,24,5,19,2,1
9,360,360,14,14,0,1,0
6,360,360,12,4,8,3,2
21,370,370,64,17,47,2,1
26,374,374,17,17,0,1,0
14,387,387,75,57,18,4,3
1,388,388,105,17,88,4,3
27,402,402,21,6,15,2,1
12,410,410,92,5,87,3,2
20,416,416,27,27,0,1,0
25,423,423,21,21,0,1,0
24,424,424,81,59,22,2,1
17,427,427,2,2,0,1,0
18,453,453,11,6,5,2,1

4,105,105,3,3,0,1,0
24,122,122,10,4,6,2,1
15,126,126,7,7,0,1,0
5,137,137,15,15,0,1,0
22,138,138,2,2,0,1,0
16,188,188,19,19,0,1,0
17,200,200,79,34,45,2,1
13,202,202,43,13,30,4,3
6,209,209,16,16,0,1,0
25,213,213,51,13,38,3,2
27,216,216,53,10,43,4,3
10,252,252,8,2,6,2,1
1,255,255,27,27,0,1,0
0,261,261,1,1,0,1,0
9,278,278,29,29,0,1,0
20,279,279,36,36,0,1,0
18,281,281,7,7,0,1,0
2,297,297,20,20,0,1,0
8,320,320,63,60,3,2,1
7,324,324,13,13,0,1,0
23,349,349,18,13,5,2,1
28,353,353,12,2,10,2,1
26,364,364,3,3,0,1,0
3,405,405,33,33,0,1,0
11,407,407,11,8,3,2,1
21,421,421,1,1,0,1,0
12,447,447,3,3,0,1,0
19,463,463,2,2,0,1,0
14,499,499,77,68,9,2,1

2,110,110,11,3,8,2,1
4,115,115,4,4,0,1,0
12,148,148,28,28,0,1,0
3,154,154,17,17,0,1,0
0,162,162,26,4,22,3,2
11,171,171,9,6,3,2,1
17,183,183,7,7,0,1,0
26,188,188,34,34,0,1,0
22,200,200,20,14,6,2,1
6,205,205,24,9,15,4,3
1,223,223,21,9,12,4,3
7,247,247,6,6,0,1,0
19,249,249,8,8,0,1,0
13,269,269,38,38,0,1,0
15,276,276,26,17,9,2,1
14,295,295,78,78,0,1,0
24,320,320,40,40,0,1,0
16,321,321,43,43,0,1,0
10,328,328,54,43,11,2,1
20,340,340,30,30,0,1,0
8,379,379,18,18,0,1,0
5,410,410,3,3,0,1,0
23,437,437,8,8,0,1,0
9,454,454,27,27,0,1,0
18,490,490,24,24,0,1,0
21,495,495,49,23,26,2,1
25,497,497,51,7,44,2,1

5,106,106,2,2,0,1,0
2,122,122,10,10,0,1,0
13,126,126,9,9,0,1,0
25,147,147,16,8,8,3,2
26,152,152,10,6,4,2,1
12,155,155,1,1,0,1,0
8,166,166,16,8,8,3,2
28,170,170,2,2,0,1,0
17,188,188,4,4,0,1,0
1,193,193,48,48,0,1,0
32,203,203,20,20,0,1,0
19,204,204,1,1,0,1,0
0,223,223,1,1,0,1,0
4,237,237,26,10,16,2,1
33,252,252,66,28,38,4,3
16,272,272,23,15,8,3,2
31,274,274,34,30,4,2,1
14,275,275,35,35,0,1,0
10,330,330,22,22,0,1,0
15,332,332,8,8,0,1,0
18,347,347,27,23,4,2,1
24,374,374,31,19,12,4,3
27,377,377,23,23,0,1,0
22,382,382,4,4,0,1,0
20,392,392,1,1,0,1,0
9,401,401,1,1,0,1,0
30,403,403,3,3,0,1,0
6,414,414,18,13,5,2,1
21,423,423,5,5,0,1,0
7,424,424,9,9,0,1,0
3,434,434,75,75,0,1,0
29,437,437,18,18,0,1,0
11,461,461,1,1,0,1,0
23,476,476,47,47,0,1,0
34,483,483,173,173,0,1,0

13,111,111,12,4,8,2,1
19,130,130,10,1,9,2,1
20,132,132,17,10,7,2,1
24,156,156,9,9,0,1,0
10,165,165,1,1,0,1,0
22,166,166,6,6,0,1,0
12,190,190,48,48,0,1,0
23,206,206,29,3,26,3,2
7,206,206,2,2,0,1,0
11,267,267,31,31,0,1,0
0,282,282,4,4,0,1,0
15,309,309,12,3,9,4,3
9,310,310,52,36,16,3,2
6,315,315,26,26,0,1,0
1,343,343,10,10,0,1,0
5,347,347,10,10,0,1,0
2,350,350,18,9,9,4,3
3,369,369,57,27,30,2,1
16,378,378,50,50,0,1,0
21,398,398,9,1,8,3,2
17,400,400,17,10,7,2,1
18,415,415,20,20,0,1,0
14,427,427,172,128,44,2,1
8,434,434,70,42,28,4,3
25,450,450,18,18,0,1,0
26,464,464,76,34,42,2,1
4,496,496,59,59,0,1,0

16,129,129,30,30,0,1,0
18,143,143,1,1,0,1,0
9,146,146,18,3,15,2,1
8,161,161,3,3,0,1,0
19,212,212,36,18,18,4,3
15,220,220,9,3,6,3,2
21,230,230,31,31,0,1,0
2,240,240,9,9,0,1,0
4,248,248,30,15,15,3,2
20,250,250,36,36,0,1,0
5,254,254,19,19,0,1,0
17,268,268,15,15,0,1,0
3,283,283,78,78,0,1,0
0,319,319,28,28,0,1,0
1,320,320,38,38,0,1,0
22,331,331,7,4,3,2,1
6,362,362,132,58,74,3,2
14,368,368,56,45,11,2,1
23,431,431,32,32,0,1,0
11,449,449,7,4,3,2,1
7,452,452,27,12,15,4,3
24,458,458,34,34,0,1,0
12,482,482,72,72,0,1,0
13,489,489,34,22,12,2,1
10,500,500,2,2,0,1,0

15,109,109,22,2,20,3,2
23,115,115,17,8,9,2,1
2,157,157,2,2,0,1,0
3,181,181,63,51,12,4,3
7,199,199,3,3,0,1,0
9,218,218,67,28,39,4,3
11,246,246,12,8,4,2,1
5,254,254,9,5,4,2,1
17,259,259,71,56,15,4,3
0,265,265,39,39,0,1,0
1,284,284,21,21,0,1,0
24,323,323,10,10,0,1,0
4,333,333,31,27,4,2,1
18,353,353,6,6,0,1,0
16,356,356,14,14,0,1,0
20,368,368,23,15,8,3,2
19,386,386,75,32,43,2,1
12,391,391,36,17,19,3,2
8,426,426,43,35,8,2,1
13,431,431,13,7,6,3,2
6,442,442,19,19,0,1,0
22,446,446,23,2,21,4,3
21,465,465,3,3,0,1,0
10,493,493,37,28,9,2,1
14,496,496,84,57,27,4,3

1,122,122,7,7,0,1,0
23,127,127,13,4,9,4,3
15,147,147,28,4,24,3,2
10,153,153,2,2,0,1,0
7,177,177,20,20,0,1,0
14,178,178,30,19,11,2,1
20,209,209,1,1,0,1,0
0,215,215,54,36,18,4,3
11,218,218,12,6,6,3,2
12,265,265,7,1,6,3,2
24,268,268,9,9,0,1,0
17,326,326,26,26,0,1,0
22,332,332,48,1,47,2,1
5,338,338,68,16,52,3,2
9,353,353,27,27,0,1,0
3,358,358,98,34,64,3,2
8,365,365,3,3,0,1,0
16,369,369,21,21,0,1,0
4,370,370,18,18,0,1,0
18,374,374,45,1,44,3,2
2,385,385,15,8,7,2,1
21,411,411,4,4,0,1,0
19,423,423,53,47,6,2,1
25,429,429,58,58,0,1,0
13,447,447,66,39,27,2,1
6,477,477,67,21,46,2,1

24,128,128,5,5,0,1,0
17,148,148,21,21,0,1,0
2,162,162,28,4,24,4,3
14,164,164,6,6,0,1,0
9,170,170,1,1,0,1,0
13,174,174,19,3,16,2,1
6,185,185,11,11,0,1,0
16,232,232,46,46,0,1,0
11,233,233,8,5,3,2,1
0,236,236,1,1,0,1,0
18,260,260,79,79,0,1,0
20,271,271,35,2,33,2,1
3,278,278,27,5,22,3,2
8,280,280,26,26,0,1,0
21,283,283,25,18,7,2,1
23,291,291,13,13,0,1,0
10,330,330,32,32,0,1,0
25,356,356,5,5,0,1,0
22,389,389,16,16,0,1,0
4,423,423,28,28,0,1,0
1,430,430,40,9,31,4,3
19,432,432,73,61,12,2,1
12,434,434,42,12,30,4,3
5,441,441,125,109,16,2,1
7,455,455,40,40,0,1,0
26,473,473,39,11,28,3,2
15,484,484,19,19,0,1,0

10,115,115,1,1,0,1,0
29,127,127,19,19,0,1,0
15,129,129,25,25,0,1,0
2,135,135,1,1,0,1,0
23,140,140,8,1,7,2,1
26,151,151,7,4,3,2,1
13,158,158,13,3,10,3,2
1,165,165,1,1,0,1,0
9,166,166,28,28,0,1,0
11,180,180,8,8,0,1,0
30,190,190,51,3,48,2,1
19,205,205,19,7,12,4,3
17,209,209,1,1,0,1,0
27,210,210,29,8,21,4,3
16,214,214,90,36,54,4,3
5,229,229,16,7,9,2,1
4,271,271,2,2,0,1,0
14,275,275,10,4,6,3,2
28,282,282,35,11,24,3,2
25,285,285,23,5,18,4,3
6,333,333,19,19,0,1,0
20,335,335,9,5,4,2,1
8,343,343,9,9,0,1,0
22,373,373,15,4,11,2,1
7,374,374,6,2,4,2,1
24,402,402,43,25,18,2,1
0,403,403,13,13,0,1,0
12,421,421,23,5,18,4,3
3,461,461,30,30,0,1,0
21,477,477,58,13,45,4,3
18,494,494,42,30,12,3,2

17,143,143,1,1,0,1,0
18,163,163,4,4,0,1,0
23,166,166,9,9,0,1,0
16,168,168,37,25,12,3,2
13,197,197,17,5,12,4,3
14,231,231,25,25,0,1,0
9,234,234,11,2,9,3,2
22,249,249,64,20,44,3,2
27,258,258,8,8,0,1,0
8,277,277,22,22,0,1,0
11,281,281,12,12,0,1,0
21,283,283,37,37,0,1,0
24,285,285,32,26,6,3,2
26,320,320,43,43,0,1,0
5,338,338,58,58,0,1,0
4,343,343,19,13,6,2,1
12,350,350,40,40,0,1,0
25,351,351,46,1,45,4,3
15,379,379,17,17,0,1,0
0,385,385,9,1,8,2,1
6,386,386,16,7,9,4,3
1,399,399,38,3,35,4,3
19,409,409,27,27,0,1,0
10,411,411,43,35,8,3,2
20,424,424,51,51,0,1,0
3,432,432,110,110,0,1,0
7,472,472,34,2,32,3,2
2,476,476,3,3,0,1,0

14,106,106,2,2,0,1,0
11,109,109,5,5,0,1,0
5,120,120,5,5,0,1,0
4,135,135,1,1,0,1,0
13,141,141,1,1,0,1,0
15,153,153,30,17,13,4,3
24,174,174,1,1,0,1,0
25,181,181,13,4,9,4,3
18,183,183,3,3,0,1,0
21,184,184,19,10,9,4,3
20,186,186,75,75,0,1,0
12,209,209,11,11,0,1,0
27,213,213,10,10,0,1,0
22,214,214,4,4,0,1,0
26,248,248,2,2,0,1,0
17,251,251,7,7,0,1,0
7,261,261,28,28,0,1,0
3,267,267,1,1,0,1,0
16,279,279,6,6,0,1,0
1,284,284,16,16,0,1,0
0,334,334,3,3,0,1,0
9,382,382,35,35,0,1,0
2,384,384,15,15,0,1,0
19,408,408,54,54,0,1,0
6,419,419,19,12,7,2,1
8,429,429,152,79,73,4,3
23,434,434,109,76,33,4,3
28,475,475,103,10,93,4,3
10,486,486,110,63,47,2,1

5,103,103,5,5,0,1,0
13,116,116,2,2,0,1,0
21,146,146,5,5,0,1,0
15,204,204,18,18,0,1,0
8,206,206,36,2,34,3,2
18,232,232,54,45,9,2,1
9,235,235,58,58,0,1,0
6,236,236,12,12,0,1,0
0,261,261,10,10,0,1,0
4,295,295,43,31,12,3,2
16,336,336,15,15,0,1,0
25,349,349,21,21,0,1,0
7,352,352,49,49,0,1,0
2,375,375,74,57,17,2,1
19,381,381,68,68,0,1,0
10,390,390,7,4,3,2,1
20,405,405,8,3,5,2,1
24,412,412,37,37,0,1,0
11,420,420,30,30,0,1,0
23,436,436,3,3,0,1,0
1,464,464,22,19,3,2,1
17,465,465,80,24,56,3,2
12,478,478,10,10,0,1,0
22,481,481,132,132,0,1,0
3,486,486,49,49,0,1,0
14,500,500,53,53,0,1,0

22,118,118,5,2,3,2,1
16,126,126,15,4,11,2,1
2,159,159,4,4,0,1,0
7,173,173,19,19,0,1,0
10,180,180,9,6,3,2,1
20,194,194,4,1,3,2,1
4,209,209,22,10,12,3,2
6,244,244,20,20,0,1,0
12,271,271,17,2,15,4,3
14,281,281,1,1,0,1,0
8,286,286,40,40,0,1,0
24,300,300,72,1,71,4,3
9,333,333,51,39,12,2,1
17,344,344,109,97,12,3,2
21,354,354,22,22,0,1,0
18,375,375,94,94,0,1,0
11,382,382,18,9,9,2,1
3,382,382,62,62,0,1,0
0,409,409,83,68,15,4,3
15,415,415,17,8,9,2,1
5,426,426,12,12,0,1,0
1,426,426,57,57,0,1,0
23,453,453,50,23,27,2,1
19,456,456,21,11,10,3,2
25,461,461,20,20,0,1,0
13,483,483,13,1,12,4,3

6,100,100,1,1,0,1,0
1,101,101,2,2,0,1,0
18,103,103,4,4,0,1,0
4,143,143,25,1,24,2,1
27,172,172,37,29,8,3,2
17,174,174,11,11,0,1,0
26,179,179,5,5,0,1,0
12,200,200,2,2,0,1,0
23,208,208,31,31,0,1,0
19,210,210,8,8,0,1,0
15,219,219,21,18,3,2,1
14,240,240,32,32,0,1,0
25,246,246,29,29,0,1,0
16,255,255,49,29,20,2,1
11,288,288,17,17,0,1,0
0,301,301,61,61,0,1,0
8,302,302,46,46,0,1,0
13,308,308,12,4,8,2,1
22,336,336,6,6,0,1,0
20,363,363,74,26,48,2,1
5,396,396,2,2,0,1,0
10,402,402,12,12,0,1,0
7,406,406,33,33,0,1,0
3,406,406,12,12,0,1,0
24,419,419,4,1,3,2,1
21,427,427,68,50,18,4,3
9,444,444,89,89,0,1,0
2,480,480,74,26,48,4,3

15,102,102,50,50,0,1,0
5,104,104,40,40,0,1,0
13,129,129,13,13,0,1,0
21,138,138,18,18,0,1,0
22,172,172,13,7,6,2,1
9,197,197,28,10,18,2,1
0,213,213,48,48,0,1,0
1,219,219,6,6,0,1,0
7,231,231,6,6,0,1,0
11,247,247,9,1,8,2,1
23,248,248,22,22,0,1,0
4,276,276,7,1,6,2,1
6,278,278,57,53,4,2,1
20,287,287,4,4,0,1,0
14,354,354,3,3,0,1,0
3,400,400,22,12,10,2,1
17,404,404,30,27,3,2,1
8,425,425,77,41,36,4,3
12,439,439,8,5,3,2,1
19,452,452,57,57,0,1,0
2,469,469,4,4,0,1,0
18,476,476,37,37,0,1,0
10,480,480,10,10,0,1,0
16,489,489,42,42,0,1,0

5,107,107,6,3,3,2,1
12,117,117,6,6,0,1,0
27,150,150,31,31,0,1,0
11,171,171,4,4,0,1,0
18,214,214,2,2,0,1,0
15,225,225,17,2,15,2,1
17,231,231,2,2,0,1,0
19,234,234,10,10,0,1,0
7,237,237,2,2,0,1,0
2,250,250,4,1,3,2,1
28,255,255,44,23,21,2,1
21,260,260,25,8,17,4,3
22,274,274,14,14,0,1,0
8,282,282,36,36,0,1,0
20,283,283,2,2,0,1,0
14,299,299,16,11,5,2,1
9,302,302,18,18,0,1,0
23,329,329,1,1,0,1,0
25,337,337,127,63,64,4,3
4,349,349,19,19,0,1,0
26,366,366,21,9,12,2,1
10,388,388,92,92,0,1,0
1,404,404,41,41,0,1,0
0,410,410,54,18,36,3,2
24,431,431,34,22,12,2,1
6,438,438,47,43,4,2,1
13,442,442,64,43,21,3,2
3,482,482,27,6,21,4,3
16,491,491,103,103,0,1,0

16,111,111,6,6,0,1,0
14,117,117,11,2,9,4,3
6,131,131,15,8,7,2,1
26,138,138,6,2,4,2,1
1,163,163,18,18,0,1,0
17,170,170,48,48,0,1,0
10,180,180,7,7,0,1,0
15,233,233,73,41,32,3,2
8,240,240,1,1,0,1,0
7,251,251,2,2,0,1,0
0,258,258,11,11,0,1,0
9,286,286,29,29,0,1,0
27,294,294,8,8,0,1,0
11,306,306,19,6,13,2,1
20,320,320,23,13,10,2,1
22,325,325,5,5,0,1,0
2,349,349,26,18,8,3,2
3,350,350,6,3,3,2,1
21,360,360,116,68,48,3,2
19,370,370,40,40,0,1,0
12,382,382,25,11,14,2,1
5,385,385,32,20,12,3,2
23,397,397,35,21,14,3,2
4,416,416,19,19,0,1,0
25,429,429,33,33,0,1,0
24,446,446,55,10,45,4,3
18,452,452,13,13,0,1,0
13,458,458,59,12,47,2,1
28,461,461,35,35,0,1,0

12,103,103,9,9,0,1,0
27,109,109,7,2,5,2,1
3,116,116,1,1,0,1,0
11,125,125,19,4,15,4,3
4,140,140,21,16,5,2,1
19,147,147,3,3,0,1,0
5,148,148,10,3,7,2,1
25,178,178,10,10,0,1,0
26,181,181,17,9,8,3,2
18,189,189,21,21,0,1,0
23,213,213,37,10,27,4,3
2,215,215,2,2,0,1,0
21,227,227,39,15,24,2,1
24,230,230,20,20,0,1,0
20,231,231,5,5,0,1,0
7,262,262,16,4,12,4,3
15,282,282,21,6,15,2,1
8,283,283,2,2,0,1,0
17,312,312,90,90,0,1,0
1,324,324,30,8,22,3,2
16,326,326,26,26,0,1,0
22,375,375,37,28,9,2,1
6,389,389,49,49,0,1,0
13,402,402,79,79,0,1,0
10,437,437,1,1,0,1,0
14,465,465,3,3,0,1,0
0,475,475,33,33,0,1,0
9,498,498,132,68,64,3,2

17,103,103,4,1,3,2,1
11,124,124,1,1,0,1,0
27,134,134,17,17,0,1,0
26,145,145,8,8,0,1,0
25,164,164,2,2,0,1,0
19,164,164,9,1,8,2,1
12,184,184,19,19,0,1,0
16,191,191,4,4,0,1,0
9,224,224,1,1,0,1,0
20,240,240,15,15,0,1,0
2,252,252,2,2,0,1,0
24,256,256,5,5,0,1,0
7,257,257,36,7,29,2,1
5,258,258,54,54,0,1,0
15,262,262,32,26,6,3,2
29,271,271,57,57,0,1,0
10,282,282,47,39,8,2,1
0,294,294,16,13,3,2,1
21,313,313,2,2,0,1,0
28,315,315,43,43,0,1,0
8,316,316,1,1,0,1,0
22,325,325,28,28,0,1,0
1,337,337,60,60,0,1,0
14,363,363,1,1,0,1,0
18,382,382,97,93,4,2,1
30,395,395,26,26,0,1,0
13,401,401,55,13,42,2,1
23,418,418,101,13,88,4,3
6,423,423,3,3,0,1,0
4,439,439,15,5,10,3,2
3,495,495,31,31,0,1,0

20,108,108,1,1,0,1,0
13,128,128,17,17,0,1,0
19,134,134,3,3,0,1,0
17,134,134,6,6,0,1,0
5,138,138,7,1,6,3,2
8,187,187,4,4,0,1,0
11,216,216,35,23,12,4,3
24,230,230,37,37,0,1,0
23,258,258,73,73,0,1,0
2,278,278,20,5,15,4,3
4,302,302,11,11,0,1,0
1,307,307,18,18,0,1,0
7,318,318,49,49,0,1,0
9,327,327,18,18,0,1,0
10,341,341,97,97,0,1,0
14,344,344,14,14,0,1,0
12,345,345,85,85,0,1,0
3,383,383,55,55,0,1,0
22,391,391,30,20,10,3,2
16,398,398,54,54,0,1,0
18,409,409,15,6,9,4,3
21,409,409,43,43,0,1,0
15,425,425,19,19,0,1,0
6,426,426,20,20,0,1,0
0,433,433,93,64,29,2,1

6,108,108,9,4,5,2,1
7,113,113,1,1,0,1,0
15,143,143,28,28,0,1,0
13,195,195,17,17,0,1,0
0,204,204,11,5,6,3,2
20,217,217,3,3,0,1,0
21,231,231,19,19,0,1,0
14,240,240,10,2,8,2,1
8,244,244,3,3,0,1,0
18,248,248,5,1,4,2,1
3,250,250,62,47,15,3,2
22,285,285,85,85,0,1,0
12,290,290,23,1,22,3,2
23,298,298,1,1,0,1,0
19,325,325,16,16,0,1,0
16,340,340,96,96,0,1,0
5,345,345,70,22,48,3,2
17,368,368,6,3,3,2,1
4,383,383,27,27,0,1,0
9,400,400,93,93,0,1,0
11,406,406,60,60,0,1,0
1,416,416,103,56,47,2,1
2,470,470,60,9,51,3,2
10,482,482,7,1,6,2,1

20,116,116,3,3,0,1,0
3,148,148,6,6,0,1,0
26,159,159,16,16,0,1,0
17,217,217,65,5,60,3,2
21,235,235,41,41,0,1,0
18,238,238,10,3,7,2,1
5,252,252,50,2,48,3,2
12,259,259,1,1,0,1,0
15,295,295,42,6,36,3,2
22,306,306,30,9,21,2,1
19,340,340,2,2,0,1,0
8,342,342,29,29,0,1,0
14,342,342,26,26,0,1,0
4,349,349,3,3,0,1,0
2,352,352,1,1,0,1,0
27,356,356,57,57,0,1,0
13,358,358,9,9,0,1,0
16,364,364,53,11,42,3,2
1,375,375,120,120,0,1,0
0,381,381,13,1,12,3,2
9,417,417,92,71,21,4,3
6,430,430,22,4,18,3,2
23,440,440,17,14,3,2,1
10,470,470,67,67,0,1,0
24,471,471,6,1,5,2,1
25,474,474,40,40,0,1,0
11,481,481,1,1,0,1,0
7,498,498,45,5,40,2,1

10,101,101,29,1,28,2,1
19,120,120,1,1,0,1,0
11,125,125,1,1,0,1,0
3,127,127,12,6,6,3,2
5,156,156,29,29,0,1,0
13,215,215,46,46,0,1,0
6,218,218,27,27,0,1,0
17,234,234,14,14,0,1,0
20,240,240,3,3,0,1,0
2,253,253,32,32,0,1,0
18,269,269,15,15,0,1,0
8,269,269,60,60,0,1,0
15,275,275,9,9,0,1,0
1,303,303,104,35,69,4,3
12,313,313,99,60,39,2,1
9,368,368,28,24,4,2,1
21,433,433,42,27,15,4,3
7,474,474,66,36,30,2,1
16,480,480,44,14,30,2,1
0,481,481,2,2,0,1,0
14,483,483,36,36,0,1,0
4,495,495,30,11,19,2,1

2,121,121,9,4,5,2,1
13,142,142,1,1,0,1,0
11,151,151,45,2,43,2,1
14,153,153,6,6,0,1,0
6,164,164,13,13,0,1,0
1,168,168,10,4,6,2,1
19,178,178,11,11,0,1,0
12,202,202,31,31,0,1,0
10,214,214,8,8,0,1,0
5,245,245,12,12,0,1,0
22,258,258,101,48,53,4,3
9,263,263,14,6,8,2,1
18,270,270,18,6,12,3,2
4,272,272,2,2,0,1,0
7,274,274,61,61,0,1,0
23,290,290,13,4,9,2,1
21,312,312,32,4,28,3,2
17,315,315,14,14,0,1,0
0,354,354,65,28,37,2,1
3,357,357,71,71,0,1,0
8,369,369,14,14,0,1,0
16,439,439,12,2,10,3,2
15,447,447,101,101,0,1,0
20,467,467,42,42,0,1,0
24,474,474,36,12,24,4,3

4,102,102,7,7,0,1,0
8,120,120,2,2,0,1,0
6,124,124,3,3,0,1,0
2,127,127,6,6,0,1,0
9,138,138,7,7,0,1,0
17,153,153,20,2,18,4,3
15,168,168,27,6,21,2,1
28,168,168,22,22,0,1,0
3,191,191,38,10,28,2,1
5,195,195,11,3,8,3,2
19,198,198,3,3,0,1,0
0,201,201,9,9,0,1,0
18,201,201,12,3,9,4,3
14,202,202,19,4,15,4,3
27,215,215,32,18,14,2,1
11,223,223,4,4,0,1,0
10,230,230,11,3,8,3,2
16,240,240,37,5,32,3,2
13,242,242,5,5,0,1,0
23,315,315,27,18,9,2,1
24,326,326,48,48,0,1,0
25,360,360,15,15,0,1,0
26,362,362,79,3,76,3,2
22,371,371,95,83,12,4,3
21,373,373,10,10,0,1,0
20,403,403,22,22,0,1,0
7,427,427,19,1,18,2,1
1,449,449,98,98,0,1,0
12,453,453,17,5,12,4,3
29,474,474,7,7,0,1,0

11,135,135,5,1,4,2,1
15,162,162,6,1,5,2,1
12,168,168,11,11,0,1,0
23,181,181,5,1,4,2,1
14,194,194,53,39,14,3,2
24,204,204,10,2,8,3,2
22,231,231,13,13,0,1,0
4,242,242,1,1,0,1,0
5,245,245,2,2,0,1,0
21,251,251,12,12,0,1,0
3,255,255,4,4,0,1,0
0,266,266,37,1,36,2,1
2,277,277,40,21,19,2,1
25,279,279,15,5,10,3,2
16,282,282,4,4,0,1,0
20,282,282,38,7,31,2,1
9,299,299,18,18,0,1,0
10,306,306,67,21,46,3,2
18,349,349,76,38,38,4,3
17,361,361,68,7,61,4,3
7,374,374,1,1,0,1,0
8,377,377,9,9,0,1,0
19,386,386,49,49,0,1,0
13,398,398,38,15,23,2,1
1,450,450,222,180,42,2,1
6,475,475,42,10,32,3,2

17,100,100,3,3,0,1,0
2,112,112,10,10,0,1,0
5,130,130,3,3,0,1,0
8,134,134,19,13,6,3,2
7,140,140,3,3,0,1,0
15,152,152,25,25,0,1,0
28,157,157,4,4,0,1,0
21,157,157,9,4,5,2,1
20,183,183,3,3,0,1,0
16,183,183,8,1,7,2,1
27,219,219,32,32,0,1,0
9,234,234,7,1,6,2,1
24,238,238,40,11,29,2,1
25,269,269,73,31,42,3,2
26,276,276,16,2,14,4,3
13,301,301,64,31,33,4,3
3,309,309,3,3,0,1,0
4,310,310,4,4,0,1,0
18,312,312,5,5,0,1,0
10,336,336,31,31,0,1,0
19,374,374,77,77,0,1,0
12,424,424,65,65,0,1,0
23,434,434,15,8,7,3,2
11,466,466,32,4,28,3,2
1,474,474,39,39,0,1,0
14,477,477,43,43,0,1,0
6,491,491,34,34,0,1,0
22,495,495,128,96,32,3,2
0,496,496,20,20,0,1,0

12,107,107,17,17,0,1,0
10,108,108,10,10,0,1,0
0,124,124,2,2,0,1,0
5,127,127,6,2,4,2,1
17,129,129,7,4,3,2,1
7,150,150,18,18,0,1,0
19,153,153,1,1,0,1,0
3,155,155,11,11,0,1,0
1,158,158,2,2,0,1,0
28,173,173,20,20,0,1,0
8,178,178,67,67,0,1,0
9,228,228,24,15,9,4,3
25,242,242,19,15,4,2,1
4,267,267,5,5,0,1,0
13,271,271,3,3,0,1,0
21,293,293,10,10,0,1,0
18,294,294,4,4,0,1,0
26,296,296,17,13,4,2,1
20,316,316,6,3,3,2,1
6,317,317,9,6,3,2,1
27,349,349,31,6,25,2,1
22,363,363,16,9,7,2,1
15,365,365,26,17,9,2,1
2,367,367,25,25,0,1,0
23,387,387,54,27,27,4,3
11,398,398,26,26,0,1,0
24,458,458,170,170,0,1,0
29,464,464,139,127,12,2,1
16,472,472,12,12,0,1,0
14,496,496,6,6,0,1,0

17,105,105,3,3,0,1,0
14,108,108,1,1,0,1,0
31,115,115,9,9,0,1,0
20,124,124,27,6,21,4,3
32,144,144,7,7,0,1,0
5,183,183,11,11,0,1,0
10,187,187,11,11,0,1,0
24,191,191,29,29,0,1,0
21,213,213,2,2,0,1,0
33,214,214,39,39,0,1,0
7,218,218,1,1,0,1,0
23,227,227,11,3,8,3,2
8,244,244,29,29,0,1,0
16,250,250,8,8,0,1,0
25,275,275,22,10,12,4,3
29,290,290,24,1,23,4,3
11,293,293,7,7,0,1,0
22,300,300,73,73,0,1,0
15,311,311,7,4,3,2,1
2,336,336,17,17,0,1,0
4,340,340,11,8,3,2,1
9,346,346,27,9,18,4,3
18,352,352,1,1,0,1,0
13,375,375,19,4,15,2,1
27,389,389,21,13,8,2,1
1,401,401,127,73,54,3,2
12,401,401,3,3,0,1,0
30,403,403,14,3,11,2,1
19,413,413,1,1,0,1,0
6,415,415,42,42,0,1,0
26,450,450,31,14,17,2,1
3,476,476,5,5,0,1,0
28,480,480,116,58,58,3,2
0,488,488,36,28,8,2,1

3,108,108,12,1,11,4,3
8,118,118,11,3,8,2,1
15,159,159,32,7,25,4,3
13,180,180,18,18,0,1,0
2,185,185,3,3,0,1,0
1,187,187,14,1,13,2,1
24,188,188,1,1,0,1,0
21,214,214,11,11,0,1,0
6,230,230,14,14,0,1,0
19,266,266,5,1,4,2,1
20,272,272,4,4,0,1,0
16,298,298,25,18,7,2,1
10,326,326,20,20,0,1,0
17,334,334,75,72,3,2,1
14,343,343,2,2,0,1,0
5,351,351,8,5,3,2,1
18,360,360,54,54,0,1,0
7,383,383,8,8,0,1,0
22,384,384,53,27,26,3,2
4,390,390,93,28,65,4,3
0,427,427,44,8,36,4,3
23,446,446,56,18,38,2,1
12,461,461,95,71,24,3,2
9,468,468,62,14,48,2,1
11,474,474,173,173,0,1,0

21,115,115,4,4,0,1,0
16,174,174,3,3,0,1,0
4,175,175,28,28,0,1,0
11,180,180,20,16,4,2,1
17,205,205,21,21,0,1,0
14,205,205,24,12,12,3,2
1,225,225,29,29,0,1,0
23,230,230,7,7,0,1,0
12,239,239,8,8,0,1,0
5,292,292,29,14,15,2,1
3,313,313,57,57,0,1,0
22,323,323,67,67,0,1,0
2,368,368,7,7,0,1,0
20,374,374,12,12,0,1,0
8,405,405,81,81,0,1,0
13,406,406,8,8,0,1,0
24,415,415,220,202,18,4,3
6,424,424,21,21,0,1,0
18,426,426,50,36,14,2,1
9,429,429,20,11,9,4,3
15,433,433,9,6,3,2,1
10,446,446,51,5,46,3,2
19,458,458,30,27,3,2,1
7,483,483,1,1,0,1,0
0,489,489,94,94,0,1,0

27,109,109,21,21,0,1,0
23,126,126,4,1,3,2,1
8,129,129,10,4,6,2,1
19,142,142,28,28,0,1,0
22,147,147,2,2,0,1,0
28,162,162,1,1,0,1,0
5,197,197,37,2,35,2,1
25,206,206,37,37,0,1,0
14,208,208,8,3,5,2,1
17,220,220,12,4,8,2,1
21,225,225,3,3,0,1,0
2,235,235,69,43,26,2,1
0,236,236,3,3,0,1,0
9,251,251,10,10,0,1,0
15,264,264,14,4,10,2,1
11,276,276,44,24,20,2,1
12,293,293,35,35,0,1,0
1,325,325,21,1,20,2,1
3,329,329,7,7,0,1,0
10,357,357,5,2,3,2,1
16,377,377,157,34,123,4,3
24,384,384,7,4,3,2,1
6,398,398,1,1,0,1,0
4,400,400,17,17,0,1,0
20,403,403,17,12,5,2,1
13,422,422,21,21,0,1,0
18,455,455,32,18,14,3,2
26,463,463,47,44,3,2,1
7,481,481,60,4,56,4,3

23,121,121,2,2,0,1,0
4,129,129,1,1,0,1,0
26,145,145,3,3,0,1,0
10,152,152,1,1,0,1,0
3,156,156,19,9,10,2,1
2,175,175,10,4,6,3,2
25,188,188,50,47,3,2,1
1,197,197,7,2,5,2,1
12,213,213,3,3,0,1,0
11,232,232,2,2,0,1,0
27,237,237,11,2,9,2,1
6,254,254,59,59,0,1,0
8,264,264,31,4,27,4,3
5,271,271,4,4,0,1,0
0,287,287,11,11,0,1,0
20,289,289,103,5,98,4,3
9,295,295,15,15,0,1,0
19,298,298,40,40,0,1,0
21,308,308,12,9,3,2,1
29,331,331,31,8,23,2,1
22,346,346,15,15,0,1,0
24,354,354,73,73,0,1,0
18,377,377,4,4,0,1,0
16,382,382,12,2,10,2,1
14,401,401,47,47,0,1,0
7,413,413,40,19,21,4,3
28,430,430,30,6,24,2,1
15,453,453,85,34,51,4,3
13,479,479,78,38,40,2,1
17,500,500,12,12,0,1,0

32,110,110,50,7,43,3,2
9,117,117,5,2,3,2,1
2,118,118,22,22,0,1,0
5,141,141,2,2,0,1,0
28,153,153,6,6,0,1,0
21,190,190,48,48,0,1,0
12,201,201,13,8,5,2,1
29,205,205,5,5,0,1,0
24,208,208,2,2,0,1,0
10,210,210,11,11,0,1,0
30,258,258,53,9,44,3,2
31,268,268,25,9,16,2,1
33,290,290,3,3,0,1,0
20,296,296,19,19,0,1,0
8,308,308,22,19,3,2,1
14,315,315,1,1,0,1,0
19,333,333,26,9,17,2,1
15,339,339,5,5,0,1,0
17,352,352,11,7,4,2,1
1,378,378,78,78,0,1,0
0,391,391,48,48,0,1,0
22,392,392,35,12,23,2,1
11,411,411,22,7,15,2,1
3,423,423,23,5,18,2,1
27,435,435,15,3,12,3,2
23,437,437,30,9,21,3,2
16,443,443,1,1,0,1,0
13,451,451,3,3,0,1,0
4,463,463,28,28,0,1,0
25,467,467,3,3,0,1,0
7,479,479,3,3,0,1,0
26,486,486,21,21,0,1,0
18,495,495,58,35,23,2,1
6,499,499,25,25,0,1,0

24,149,149,5,5,0,1,0
22,157,157,41,7,34,3,2
12,172,172,27,27,0,1,0
10,174,174,4,1,3,2,1
2,179,179,4,4,0,1,0
17,179,179,27,11,16,3,2
14,223,223,4,4,0,1,0
13,225,225,29,29,0,1,0
9,233,233,59,59,0,1,0
16,242,242,10,10,0,1,0
18,250,250,26,12,14,3,2
7,264,264,17,2,15,4,3
11,299,299,18,14,4,2,1
1,328,328,9,9,0,1,0
23,333,333,16,16,0,1,0
20,339,339,29,1,28,3,2
5,366,366,24,2,22,2,1
15,377,377,119,23,96,3,2
21,391,391,31,31,0,1,0
3,393,393,32,32,0,1,0
25,395,395,16,16,0,1,0
0,396,396,24,24,0,1,0
8,425,425,122,24,98,4,3
19,464,464,9,9,0,1,0
6,466,466,18,5,13,2,1
4,466,466,76,44,32,2,1

2,107,107,1,1,0,1,0
11,161,161,2,2,0,1,0
1,181,181,49,49,0,1,0
0,223,223,82,25,57,4,3
22,228,228,1,1,0,1,0
8,251,251,22,12,10,2,1
9,279,279,10,1,9,4,3
14,321,321,16,9,7,2,1
10,326,326,18,14,4,2,1
12,326,326,4,1,3,2,1
3,330,330,70,9,61,3,2
17,343,343,85,85,0,1,0
18,346,346,50,32,18,2,1
5,348,348,24,24,0,1,0
6,364,364,79,9,70,4,3
19,400,400,30,10,20,2,1
15,401,401,18,8,10,3,2
13,408,408,187,160,27,4,3
20,410,410,7,7,0,1,0
16,420,420,3,3,0,1,0
21,425,425,80,32,48,4,3
4,447,447,1,1,0,1,0
7,492,492,15,3,12,3,2

17,111,111,10,1,9,4,3
2,125,125,2,2,0,1,0
14,146,146,35,35,0,1,0
12,173,173,11,11,0,1,0
1,174,174,9,3,6,2,1
22,179,179,8,2,6,2,1
4,212,212,37,37,0,1,0
6,218,218,1,1,0,1,0
3,239,239,93,93,0,1,0
11,242,242,35,3,32,2,1
19,243,243,13,3,10,3,2
5,268,268,27,1,26,2,1
21,288,288,18,18,0,1,0
7,296,296,129,51,78,3,2
18,325,325,100,38,62,4,3
16,355,355,49,32,17,2,1
0,356,356,16,16,0,1,0
15,392,392,34,18,16,2,1
8,398,398,20,20,0,1,0
13,433,433,2,2,0,1,0
9,442,442,15,6,9,2,1
10,442,442,39,7,32,3,2
20,461,461,5,5,0,1,0

10,109,109,29,29,0,1,0
1,123,123,19,1,18,2,1
11,169,169,5,5,0,1,0
17,183,183,36,10,26,2,1
13,242,242,8,8,0,1,0
3,254,254,58,58,0,1,0
14,269,269,4,4,0,1,0
6,273,273,15,3,12,2,1
15,274,274,38,23,15,2,1
8,287,287,19,19,0,1,0
16,295,295,56,56,0,1,0
5,311,311,24,24,0,1,0
4,332,332,31,31,0,1,0
7,335,335,38,38,0,1,0
2,339,339,21,21,0,1,0
0,355,355,271,177,94,3,2
12,409,409,29,29,0,1,0
9,432,432,34,9,25,2,1

5,123,123,1,1,0,1,0
16,156,156,28,28,0,1,0
3,165,165,4,4,0,1,0
10,192,192,25,5,20,3,2
12,204,204,6,6,0,1,0
2,217,217,8,4,4,2,1
18,218,218,15,15,0,1,0
22,231,231,25,12,13,2,1
14,238,238,9,9,0,1,0
21,242,242,4,4,0,1,0
25,247,247,29,2,27,2,1
19,270,270,62,62,0,1,0
20,319,319,44,16,28,2,1
17,328,328,12,12,0,1,0
13,339,339,26,26,0,1,0
7,348,348,5,2,3,2,1
11,361,361,76,76,0,1,0
0,365,365,128,118,10,4,3
9,377,377,2,2,0,1,0
23,377,377,5,5,0,1,0
6,434,434,98,11,87,4,3
8,452,452,4,4,0,1,0
15,461,461,112,100,12,4,3
1,467,467,102,49,53,4,3
4,470,470,18,4,14,2,1
24,491,491,32,32,0,1,0

17,113,113,22,22,0,1,0
25,168,168,5,1,4,2,1
22,169,169,25,25,0,1,0
16,196,196,12,12,0,1,0
14,198,198,14,10,4,2,1
21,215,215,16,16,0,1,0
7,228,228,3,3,0,1,0
13,247,247,59,10,49,4,3
8,275,275,45,45,0,1,0
20,280,280,60,1,59,4,3
0,285,285,5,5,0,1,0
11,285,285,3,3,0,1,0
12,288,288,75,75,0,1,0
10,319,319,8,8,0,1,0
5,332,332,22,22,0,1,0
6,333,333,21,2,19,4,3
18,348,348,15,11,4,2,1
3,365,365,3,3,0,1,0
2,368,368,90,54,36,2,1
23,381,381,24,3,21,2,1
1,387,387,75,35,40,4,3
19,404,404,12,12,0,1,0
15,420,420,31,31,0,1,0
9,456,456,45,45,0,1,0
4,466,466,64,41,23,3,2
24,481,481,44,1,43,4,3

26,101,101,4,4,0,1,0
18,109,109,13,4,9,2,1
22,110,110,19,10,9,2,1
24,119,119,12,3,9,4,3
17,134,134,23,23,0,1,0
3,169,169,2,2,0,1,0
2,190,190,19,9,10,2,1
32,198,198,8,1,7,2,1
20,205,205,29,29,0,1,0
31,216,216,13,1,12,4,3
27,236,236,2,2,0,1,0
25,240,240,30,30,0,1,0
14,261,261,2,2,0,1,0
9,272,272,17,7,10,3,2
11,276,276,3,3,0,1,0
4,304,304,48,14,34,3,2
7,325,325,8,5,3,2,1
15,326,326,6,6,0,1,0
0,330,330,1,1,0,1,0
28,338,338,18,18,0,1,0
12,349,349,10,6,4,2,1
29,375,375,63,45,18,4,3
13,388,388,21,1,20,2,1
19,390,390,50,35,15,2,1
16,396,396,26,18,8,3,2
5,440,440,31,1,30,4,3
10,443,443,92,92,0,1,0
6,462,462,11,11,0,1,0
23,470,470,23,23,0,1,0
30,477,477,45,35,10,2,1
21,478,478,129,129,0,1,0
8,489,489,14,9,5,2,1
1,497,497,3,3,0,1,0

20,123,123,8,5,3,2,1
10,128,128,4,1,3,2,1
0,139,139,5,5,0,1,0
24,168,168,4,4,0,1,0
11,171,171,16,16,0,1,0
15,195,195,42,11,31,2,1
13,242,242,19,19,0,1,0
17,250,250,7,7,0,1,0
21,260,260,14,14,0,1,0
6,261,261,51,41,10,3,2
8,274,274,18,3,15,2,1
18,277,277,12,4,8,3,2
7,336,336,57,29,28,2,1
5,350,350,52,16,36,2,1
23,362,362,23,23,0,1,0
2,364,364,38,30,8,3,2
4,369,369,10,4,6,2,1
9,373,373,14,14,0,1,0
14,375,375,151,151,0,1,0
12,388,388,55,43,12,4,3
16,391,391,37,30,7,2,1
22,464,464,2,2,0,1,0
1,471,471,55,55,0,1,0
3,489,489,136,94,42,4,3
19,499,499,53,53,0,1,0

6,102,102,12,3,9,2,1
5,125,125,10,10,0,1,0
16,133,133,4,1,3,2,1
26,165,165,10,6,4,2,1
22,169,169,6,1,5,2,1
25,171,171,19,7,12,4,3
14,176,176,9,9,0,1,0
8,198,198,1,1,0,1,0
19,199,199,1,1,0,1,0
23,222,222,64,64,0,1,0
4,250,250,4,4,0,1,0
9,251,251,10,10,0,1,0
7,259,259,52,52,0,1,0
28,263,263,4,4,0,1,0
0,264,264,15,15,0,1,0
11,299,299,7,7,0,1,0
13,300,300,4,1,3,2,1
21,327,327,63,54,9,2,1
1,335,335,27,27,0,1,0
17,350,350,5,5,0,1,0
10,357,357,20,4,16,2,1
15,378,378,38,38,0,1,0
2,378,378,62,27,35,4,3
27,441,441,52,52,0,1,0
24,461,461,15,15,0,1,0
3,481,481,141,57,84,3,2
20,485,485,103,103,0,1,0
12,492,492,2,2,0,1,0
18,496,496,105,17,88,4,3

3,139,139,7,7,0,1,0
17,168,168,28,15,13,2,1
14,192,192,21,2,19,2,1
29,193,193,5,5,0,1,0
8,208,208,17,5,12,4,3
19,210,210,89,23,66,3,2
24,212,212,17,17,0,1,0
28,227,227,8,8,0,1,0
18,228,228,10,10,0,1,0
4,233,233,11,11,0,1,0
11,234,234,1,1,0,1,0
25,238,238,25,25,0,1,0
20,249,249,20,5,15,4,3
5,249,249,5,5,0,1,0
15,272,272,59,38,21,4,3
23,284,284,59,59,0,1,0
0,305,305,17,11,6,2,1
27,335,335,14,14,0,1,0
16,369,369,18,18,0,1,0
6,382,382,14,14,0,1,0
26,386,386,11,11,0,1,0
22,387,387,21,21,0,1,0
12,394,394,36,36,0,1,0
7,416,416,13,13,0,1,0
9,419,419,13,1,12,3,2
13,443,443,113,93,20,2,1
1,461,461,20,10,10,3,2
10,465,465,63,33,30,2,1
2,486,486,21,9,12,4,3
21,494,494,11,1,10,3,2

25,101,101,6,6,0,1,0
18,134,134,10,1,9,2,1
21,137,137,22,4,18,2,1
8,161,161,8,8,0,1,0
5,177,177,3,3,0,1,0
16,182,182,6,6,0,1,0
26,210,210,9,9,0,1,0
23,211,211,2,2,0,1,0
12,219,219,40,7,33,2,1
15,225,225,13,13,0,1,0
27,241,241,37,37,0,1,0
20,242,242,29,5,24,4,3
14,265,265,4,4,0,1,0
32,275,275,69,65,4,2,1
9,275,275,8,8,0,1,0
1,285,285,33,7,26,3,2
17,288,288,7,7,0,1,0
11,291,291,6,6,0,1,0
10,298,298,8,8,0,1,0
19,304,304,5,2,3,2,1
6,306,306,16,4,12,4,3
3,362,362,46,13,33,2,1
31,365,365,72,34,38,2,1
4,369,369,65,9,56,3,2
0,369,369,29,29,0,1,0
24,379,379,29,20,9,2,1
7,391,391,31,31,0,1,0
13,443,443,26,26,0,1,0
28,449,449,4,4,0,1,0
22,455,455,45,39,6,2,1
30,474,474,25,25,0,1,0
29,481,481,44,24,20,2,1
2,485,485,32,1,31,4,3

25,117,117,2,2,0,1,0
15,118,118,7,1,6,3,2
1,184,184,19,19,0,1,0
18,184,184,24,24,0,1,0
8,199,199,52,52,0,1,0
11,220,220,3,3,0,1,0
2,235,235,21,21,0,1,0
10,238,238,1,1,0,1,0
22,255,255,2,2,0,1,0
24,260,260,6,6,0,1,0
17,267,267,19,11,8,2,1
9,282,282,39,39,0,1,0
5,290,290,29,16,13,2,1
12,301,301,18,18,0,1,0
20,306,306,70,54,16,2,1
26,330,330,73,19,54,3,2
6,342,342,41,41,0,1,0
14,369,369,88,26,62,3,2
7,394,394,83,40,43,2,1
0,412,412,20,11,9,4,3
13,426,426,23,23,0,1,0
4,437,437,34,34,0,1,0
21,439,439,74,74,0,1,0
23,468,468,53,53,0,1,0
16,472,472,4,4,0,1,0
3,479,479,10,10,0,1,0
19,499,499,24,24,0,1,0

1,112,112,19,19,0,1,0
5,134,134,1,1,0,1,0
6,144,144,7,1,6,2,1
18,153,153,12,12,0,1,0
4,197,197,18,18,0,1,0
0,234,234,95,71,24,2,1
3,257,257,30,30,0,1,0
20,263,263,23,1,22,2,1
17,291,291,27,13,14,2,1
12,296,296,86,86,0,1,0
7,306,306,59,43,16,3,2
19,319,319,25,19,6,2,1
16,327,327,3,3,0,1,0
8,329,329,16,16,0,1,0
9,351,351,21,21,0,1,0
10,363,363,31,31,0,1,0
15,372,372,4,4,0,1,0
13,406,406,27,7,20,3,2
11,426,426,127,103,24,4,3
22,427,427,8,1,7,2,1
2,452,452,73,1,72,3,2
14,496,496,85,40,45,3,2
21,500,500,16,16,0,1,0

5,115,115,15,4,11,2,1
20,132,132,3,3,0,1,0
4,134,134,32,5,27,4,3
8,135,135,36,18,18,2,1
21,147,147,31,3,28,2,1
13,154,154,5,5,0,1,0
0,169,169,2,2,0,1,0
22,179,179,36,36,0,1,0
2,187,187,25,4,21,4,3
16,188,188,28,28,0,1,0
24,199,199,28,19,9,4,3
14,199,199,34,34,0,1,0
1,222,222,1,1,0,1,0
7,235,235,6,2,4,2,1
9,243,243,16,5,11,2,1
18,252,252,9,9,0,1,0
3,278,278,24,24,0,1,0
19,319,319,12,12,0,1,0
6,330,330,12,12,0,1,0
15,377,377,44,44,0,1,0
23,424,424,17,17,0,1,0
10,449,449,24,12,12,4,3
12,453,453,51,39,12,4,3
17,482,482,29,12,17,2,1
11,483,483,120,36,84,3,2

14,101,101,8,3,5,2,1
2,121,121,17,17,0,1,0
7,124,124,1,1,0,1,0
16,266,266,62,36,26,3,2
17,276,276,15,15,0,1,0
21,277,277,61,23,38,2,1
8,291,291,40,40,0,1,0
18,296,296,5,5,0,1,0
10,306,306,63,63,0,1,0
5,349,349,30,10,20,2,1
23,359,359,45,3,42,3,2
11,376,376,3,3,0,1,0
19,377,377,29,1,28,2,1
12,378,378,25,1,24,3,2
13,380,380,27,27,0,1,0
15,385,385,26,2,24,3,2
9,397,397,27,27,0,1,0
20,403,403,7,7,0,1,0
25,416,416,36,15,21,2,1
6,418,418,49,13,36,2,1
1,424,424,17,17,0,1,0
22,427,427,23,23,0,1,0
3,430,430,56,51,5,2,1
0,433,433,63,41,22,3,2
4,457,457,68,44,24,3,2
24,497,497,111,78,33,4,3

10,104,104,11,11,0,1,0
25,127,127,15,15,0,1,0
3,153,153,11,11,0,1,0
4,195,195,39,2,37,4,3
26,207,207,9,3,6,2,1
1,267,267,25,1,24,2,1
11,267,267,3,3,0,1,0
0,289,289,8,8,0,1,0
21,303,303,39,27,12,2,1
6,308,308,17,11,6,2,1
7,309,309,9,9,0,1,0
20,367,367,47,47,0,1,0
16,380,380,81,77,4,2,1
14,385,385,13,6,7,2,1
27,399,399,2,2,0,1,0
24,412,412,125,51,74,3,2
28,431,431,8,1,7,2,1
22,433,433,39,39,0,1,0
17,434,434,70,70,0,1,0
5,436,436,112,112,0,1,0
9,437,437,17,17,0,1,0
2,447,447,20,1,19,2,1
12,448,448,10,10,0,1,0
15,455,455,10,5,5,2,1
13,461,461,28,8,20,3,2
29,468,468,37,7,30,3,2
19,471,471,51,51,0,1,0
23,478,478,65,1,64,3,2
18,484,484,3,3,0,1,0
8,487,487,7,7,0,1,0

33,125,125,4,1,3,2,1
20,131,131,1,1,0,1,0
8,134,134,9,2,7,2,1
6,157,157,5,5,0,1,0
14,169,169,15,7,8,3,2
17,174,174,32,32,0,1,0
24,180,180,10,10,0,1,0
19,213,213,38,38,0,1,0
3,240,240,27,27,0,1,0
23,261,261,43,6,37,2,1
28,276,276,9,9,0,1,0
12,285,285,7,4,3,2,1
26,290,290,16,16,0,1,0
4,295,295,4,4,0,1,0
27,296,296,120,18,102,4,3
10,335,335,11,1,10,2,1
2,335,335,9,4,5,2,1
30,352,352,46,21,25,4,3
11,365,365,1,1,0,1,0
32,367,367,32,23,9,4,3
31,371,371,26,26,0,1,0
0,409,409,54,54,0,1,0
16,410,410,10,10,0,1,0
22,417,417,5,2,3,2,1
25,431,431,94,52,42,2,1
5,446,446,19,14,5,2,1
18,448,448,18,12,6,2,1
21,458,458,22,22,0,1,0
7,459,459,24,24,0,1,0
13,463,463,36,36,0,1,0
15,469,469,1,1,0,1,0
1,472,472,73,32,41,2,1
29,486,486,7,7,0,1,0
9,488,488,4,4,0,1,0

29,113,113,17,17,0,1,0
25,115,115,22,3,19,3,2
27,127,127,9,9,0,1,0
23,128,128,7,7,0,1,0
7,134,134,15,15,0,1,0
16,135,135,24,12,12,3,2
5,147,147,5,2,3,2,1
11,162,162,1,1,0,1,0
13,176,176,9,9,0,1,0
6,204,204,10,10,0,1,0
22,228,228,25,18,7,2,1
21,234,234,14,14,0,1,0
3,247,247,1,1,0,1,0
14,326,326,9,9,0,1,0
4,327,327,10,10,0,1,0
26,333,333,24,4,20,3,2
8,335,335,18,18,0,1,0
17,359,359,10,4,6,3,2
20,378,378,18,8,10,4,3
2,388,388,92,92,0,1,0
19,395,395,80,60,20,3,2
9,398,398,108,100,8,2,1
0,409,409,54,54,0,1,0
18,424,424,28,22,6,2,1
1,429,429,17,5,12,2,1
28,447,447,78,78,0,1,0
12,462,462,6,6,0,1,0
24,468,468,45,1,44,3,2
10,481,481,27,27,0,1,0
15,492,492,4,1,3,2,1

7,113,113,7,1,6,2,1
14,153,153,4,4,0,1,0
3,154,154,5,5,0,1,0
1,218,218,31,31,0,1,0
9,219,219,11,11,0,1,0
27,222,222,7,7,0,1,0
24,226,226,15,15,0,1,0
17,233,233,12,12,0,1,0
6,234,234,7,7,0,1,0
15,238,238,13,10,3,2,1
22,239,239,24,24,0,1,0
13,257,257,114,36,78,4,3
12,260,260,5,5,0,1,0
25,281,281,24,10,14,3,2
10,290,290,41,41,0,1,0
5,329,329,10,10,0,1,0
20,345,345,13,8,5,2,1
26,355,355,45,45,0,1,0
4,375,375,29,7,22,3,2
19,386,386,51,51,0,1,0
8,400,400,6,6,0,1,0
21,402,402,111,29,82,3,2
18,407,407,51,51,0,1,0
16,417,417,7,7,0,1,0
11,418,418,12,12,0,1,0
23,464,464,102,93,9,4,3
2,476,476,17,17,0,1,0
0,489,489,82,35,47,2,1

5,148,148,5,2,3,2,1
4,158,158,12,12,0,1,0
8,164,164,33,33,0,1,0
2,166,166,4,4,0,1,0
0,170,170,13,13,0,1,0
18,179,179,9,9,0,1,0
23,197,197,9,1,8,2,1
15,208,208,1,1,0,1,0
6,210,210,36,36,0,1,0
24,222,222,52,14,38,2,1
14,231,231,5,5,0,1,0
1,234,234,28,28,0,1,0
28,255,255,4,4,0,1,0
26,281,281,9,3,6,2,1
30,285,285,20,20,0,1,0
3,306,306,24,24,0,1,0
25,320,320,71,3,68,4,3
27,371,371,13,13,0,1,0
19,373,373,4,4,0,1,0
20,383,383,152,92,60,4,3
16,401,401,7,1,6,3,2
12,403,403,41,31,10,3,2
13,405,405,44,44,0,1,0
17,406,406,9,9,0,1,0
9,420,420,21,2,19,2,1
10,422,422,1,1,0,1,0
22,437,437,3,3,0,1,0
11,483,483,90,24,66,3,2
21,485,485,47,47,0,1,0
29,489,489,49,49,0,1,0
7,496,496,3,3,0,1,0

4,111,111,1,1,0,1,0
21,133,133,9,9,0,1,0
14,135,135,38,38,0,1,0
11,206,206,6,6,0,1,0
18,213,213,19,19,0,1,0
8,275,275,62,62,0,1,0
5,287,287,7,7,0,1,0
15,292,292,97,55,42,3,2
20,308,308,19,8,11,2,1
9,312,312,129,89,40,3,2
12,316,316,33,33,0,1,0
2,354,354,65,21,44,2,1
17,354,354,20,20,0,1,0
6,385,385,12,12,0,1,0
10,388,388,12,12,0,1,0
19,391,391,23,23,0,1,0
1,396,396,43,43,0,1,0
16,398,398,48,48,0,1,0
22,409,409,25,20,5,2,1
3,421,421,75,51,24,2,1
13,439,439,15,15,0,1,0
0,467,467,14,2,12,2,1
7,489,489,32,2,30,4,3
23,492,492,13,5,8,3,2

10,129,129,4,4,0,1,0
9,145,145,3,3,0,1,0
2,157,157,23,23,0,1,0
14,173,173,11,1,10,3,2
6,184,184,21,21,0,1,0
0,195,195,40,18,22,2,1
7,207,207,6,6,0,1,0
18,218,218,1,1,0,1,0
21,230,230,3,3,0,1,0
8,254,254,63,40,23,2,1
19,258,258,8,8,0,1,0
20,259,259,38,38,0,1,0
22,299,299,118,83,35,2,1
13,304,304,13,13,0,1,0
4,313,313,8,8,0,1,0
1,314,314,5,2,3,2,1
3,348,348,35,35,0,1,0
12,364,364,96,96,0,1,0
5,366,366,145,37,108,4,3
15,394,394,5,5,0,1,0
17,454,454,68,68,0,1,0
11,476,476,71,71,0,1,0
16,495,495,10,1,9,2,1

18,111,111,4,1,3,2,1
2,128,128,15,6,9,4,3
27,128,128,1,1,0,1,0
0,128,128,24,24,0,1,0
20,132,132,23,23,0,1,0
15,144,144,2,2,0,1,0
8,156,156,13,10,3,2,1
22,174,174,11,11,0,1,0
12,196,196,2,2,0,1,0
10,205,205,6,6,0,1,0
31,207,207,27,27,0,1,0
30,209,209,1,1,0,1,0
19,248,248,1,1,0,1,0
16,260,260,15,15,0,1,0
28,262,262,42,28,14,3,2
4,313,313,77,77,0,1,0
24,336,336,12,12,0,1,0
17,342,342,18,3,15,2,1
5,353,353,2,2,0,1,0
21,355,355,5,1,4,2,1
3,358,358,20,17,3,2,1
11,373,373,1,1,0,1,0
14,376,376,6,6,0,1,0
13,402,402,47,47,0,1,0
23,409,409,52,19,33,4,3
26,410,410,42,42,0,1,0
9,436,436,28,13,15,2,1
25,465,465,230,230,0,1,0
6,475,475,66,66,0,1,0
1,477,477,7,7,0,1,0
29,487,487,4,4,0,1,0
7,500,500,27,1,26,2,1

13,120,120,19,12,7,2,1
9,127,127,46,42,4,2,1
8,180,180,7,2,5,2,1
18,271,271,19,6,13,2,1
2,294,294,127,127,0,1,0
15,302,302,39,39,0,1,0
1,306,306,21,7,14,3,2
16,317,317,5,5,0,1,0
19,332,332,38,11,27,2,1
7,341,341,6,6,0,1,0
6,366,366,21,3,18,4,3
4,368,368,43,43,0,1,0
21,377,377,67,67,0,1,0
11,390,390,67,48,19,2,1
0,404,404,60,33,27,2,1
12,416,416,68,6,62,3,2
17,420,420,12,12,0,1,0
3,423,423,20,3,17,4,3
14,430,430,20,14,6,3,2
22,430,430,21,9,12,3,2
5,434,434,5,5,0,1,0
10,460,460,49,1,48,3,2
20,468,468,45,45,0,1,0

23,114,114,37,37,0,1,0
1,117,117,7,7,0,1,0
24,157,157,9,9,0,1,0
10,179,179,29,15,14,2,1
26,187,187,22,22,0,1,0
14,201,201,7,7,0,1,0
8,205,205,79,17,62,4,3
13,205,205,19,19,0,1,0
5,214,214,2,2,0,1,0
4,222,222,30,6,24,4,3
21,225,225,10,6,4,2,1
7,246,246,4,4,0,1,0
12,250,250,1,1,0,1,0
27,260,260,2,2,0,1,0
3,261,261,26,12,14,3,2
28,268,268,50,26,24,3,2
25,270,270,6,6,0,1,0
20,274,274,22,22,0,1,0
16,275,275,26,26,0,1,0
9,277,277,24,24,0,1,0
6,279,279,4,4,0,1,0
2,293,293,27,12,15,2,1
22,309,309,6,3,3,2,1
0,332,332,4,4,0,1,0
15,380,380,21,3,18,4,3
18,391,391,94,52,42,4,3
11,425,425,18,7,11,2,1
17,432,432,15,5,10,2,1
19,482,482,46,46,0,1,0

19,101,101,7,2,5,2,1
15,135,135,3,3,0,1,0
6,143,143,29,29,0,1,0
7,150,150,19,19,0,1,0
20,159,159,24,1,23,4,3
12,199,199,19,19,0,1,0
18,210,210,5,5,0,1,0
21,229,229,13,13,0,1,0
22,268,268,56,7,49,2,1
0,313,313,19,5,14,3,2
1,338,338,69,69,0,1,0
16,342,342,168,168,0,1,0
13,367,367,10,10,0,1,0
25,367,367,4,4,0,1,0
27,375,375,33,15,18,3,2
4,389,389,1,1,0,1,0
14,418,418,99,1,98,3,2
8,418,418,36,36,0,1,0
26,427,427,2,2,0,1,0
9,436,436,25,25,0,1,0
23,448,448,67,61,6,2,1
17,453,453,2,2,0,1,0
3,454,454,16,16,0,1,0
10,461,461,3,3,0,1,0
24,466,466,22,22,0,1,0
5,478,478,10,4,6,3,2
11,493,493,14,14,0,1,0
2,497,497,55,55,0,1,0

5,103,103,6,6,0,1,0
27,128,128,5,1,4,2,1
26,132,132,41,41,0,1,0
31,135,135,4,4,0,1,0
21,180,180,5,5,0,1,0
9,226,226,1,1,0,1,0
23,230,230,15,1,14,3,2
24,239,239,70,70,0,1,0
6,255,255,42,23,19,2,1
19,258,258,3,3,0,1,0
29,263,263,28,28,0,1,0
7,274,274,3,3,0,1,0
11,288,288,12,4,8,3,2
16,294,294,26,2,24,2,1
4,295,295,8,3,5,2,1
14,310,310,3,3,0,1,0
12,341,341,23,17,6,2,1
17,350,350,31,9,22,3,2
0,365,365,1,1,0,1,0
1,379,379,86,86,0,1,0
20,392,392,119,12,107,4,3
10,398,398,30,30,0,1,0
3,405,405,57,57,0,1,0
30,419,419,9,1,8,2,1
22,420,420,9,2,7,3,2
25,437,437,9,1,8,2,1
8,446,446,25,8,17,3,2
15,453,453,2,2,0,1,0
28,455,455,31,31,0,1,0
18,467,467,31,31,0,1,0
13,469,469,69,47,22,3,2
2,500,500,10,1,9,3,2

13,111,111,16,1,15,2,1
21,135,135,31,26,5,2,1
9,145,145,2,2,0,1,0
18,145,145,9,3,6,2,1
23,154,154,13,13,0,1,0
15,201,201,16,16,0,1,0
22,201,201,6,6,0,1,0
29,222,222,26,26,0,1,0
11,233,233,4,4,0,1,0
27,237,237,48,30,18,2,1
14,237,237,11,2,9,4,3
6,254,254,19,9,10,2,1
19,270,270,1,1,0,1,0
10,276,276,26,26,0,1,0
8,277,277,1,1,0,1,0
26,281,281,51,51,0,1,0
25,290,290,51,51,0,1,0
7,301,301,1,1,0,1,0
5,310,310,58,43,15,2,1
16,380,380,13,13,0,1,0
20,409,409,26,5,21,4,3
3,419,419,32,3,29,2,1
12,435,435,35,35,0,1,0
24,438,438,13,4,9,4,3
2,445,445,21,5,16,2,1
4,451,451,27,12,15,4,3
1,469,469,99,72,27,4,3
0,477,477,61,37,24,3,2
28,479,479,48,32,16,2,1
17,494,494,21,17,4,2,1

15,120,120,24,17,7,2,1
7,130,130,7,4,3,2,1
9,151,151,14,3,11,2,1
28,157,157,28,5,23,2,1
29,161,161,26,7,19,2,1
26,179,179,3,3,0,1,0
21,195,195,10,10,0,1,0
3,202,202,6,6,0,1,0
1,206,206,25,11,14,2,1
31,207,207,9,3,6,3,2
2,229,229,4,1,3,2,1
22,258,258,53,23,30,4,3
6,286,286,3,3,0,1,0
11,295,295,14,14,0,1,0
25,302,302,35,23,12,3,2
30,318,318,44,44,0,1,0
24,329,329,20,11,9,4,3
23,343,343,16,16,0,1,0
20,343,343,12,12,0,1,0
0,363,363,26,7,19,4,3
5,389,389,5,5,0,1,0
4,390,390,30,21,9,4,3
32,424,424,99,99,0,1,0
12,430,430,5,5,0,1,0
27,431,431,11,11,0,1,0
17,435,435,28,28,0,1,0
8,437,437,1,1,0,1,0
13,438,438,36,5,31,4,3
14,454,454,42,42,0,1,0
18,466,466,3,3,0,1,0
19,472,472,58,20,38,2,1
33,479,479,25,3,22,3,2
10,487,487,35,6,29,2,1
16,495,495,39,39,0,1,0

34,109,109,14,14,0,1,0
13,115,115,4,1,3,2,1
16,127,127,1,1,0,1,0
2,144,144,1,1,0,1,0
9,149,149,8,8,0,1,0
22,169,169,25,11,14,2,1
30,191,191,4,4,0,1,0
14,201,201,36,27,9,4,3
3,214,214,8,8,0,1,0
32,226,226,14,14,0,1,0
10,236,236,44,44,0,1,0
33,249,249,5,5,0,1,0
17,250,250,5,5,0,1,0
4,252,252,8,8,0,1,0
27,254,254,15,7,8,2,1
21,256,256,11,1,10,3,2
12,281,281,29,14,15,2,1
5,285,285,15,7,8,3,2
1,289,289,25,6,19,2,1
26,303,303,35,16,19,3,2
15,330,330,13,4,9,2,1
19,349,349,1,1,0,1,0
25,361,361,165,165,0,1,0
11,375,375,18,6,12,2,1
29,406,406,13,13,0,1,0
6,427,427,4,4,0,1,0
31,435,435,17,5,12,2,1
23,436,436,46,46,0,1,0
28,451,451,57,38,19,2,1
7,458,458,8,5,3,2,1
0,468,468,46,43,3,2,1
20,471,471,15,15,0,1,0
8,475,475,68,44,24,3,2
24,481,481,6,2,4,2,1
18,486,486,34,34,0,1,0

0,104,104,30,30,0,1,0
4,134,134,6,6,0,1,0
14,142,142,4,4,0,1,0
1,146,146,48,24,24,3,2
3,180,180,47,5,42,2,1
17,191,191,1,1,0,1,0
8,236,236,31,31,0,1,0
11,260,260,71,7,64,4,3
16,262,262,21,21,0,1,0
10,269,269,12,12,0,1,0
13,362,362,11,11,0,1,0
12,385,385,17,3,14,2,1
15,425,425,21,21,0,1,0
7,432,432,185,167,18,4,3
5,433,433,123,89,34,4,3
9,443,443,21,13,8,2,1
2,470,470,44,12,32,3,2
6,492,492,56,56,0,1,0
18,498,498,21,21,0,1,0

16,106,106,19,19,0,1,0
8,125,125,1,1,0,1,0
10,130,130,1,1,0,1,0
11,131,131,9,9,0,1,0
25,140,140,25,13,12,3,2
13,155,155,1,1,0,1,0
28,157,157,27,27,0,1,0
3,162,162,10,10,0,1,0
19,168,168,7,7,0,1,0
2,184,184,2,2,0,1,0
1,205,205,1,1,0,1,0
29,231,231,21,21,0,1,0
23,234,234,19,19,0,1,0
4,239,239,15,15,0,1,0
5,255,255,29,20,9,4,3
7,259,259,76,10,66,3,2
12,275,275,26,2,24,3,2
21,278,278,31,2,29,2,1
24,306,306,3,3,0,1,0
6,312,312,20,20,0,1,0
17,313,313,32,1,31,2,1
26,313,313,20,20,0,1,0
27,345,345,4,4,0,1,0
14,366,366,25,19,6,3,2
20,427,427,145,58,87,4,3
15,434,434,28,2,26,4,3
0,452,452,4,4,0,1,0
22,460,460,88,28,60,3,2
9,470,470,39,30,9,4,3
18,492,492,7,3,4,2,1
30,494,494,7,3,4,2,1

15,105,105,13,13,0,1,0
13,115,115,6,6,0,1,0
17,142,142,1,1,0,1,0
26,148,148,44,19,25,2,1
8,201,201,17,13,4,2,1
11,203,203,35,14,21,4,3
18,206,206,24,8,16,2,1
12,209,209,6,6,0,1,0
5,214,214,5,5,0,1,0
1,219,219,9,9,0,1,0
0,233,233,35,35,0,1,0
22,249,249,1,1,0,1,0
25,253,253,25,15,10,3,2
4,280,280,5,5,0,1,0
14,280,280,21,7,14,3,2
6,313,313,13,13,0,1,0
3,325,325,1,1,0,1,0
23,357,357,22,22,0,1,0
2,381,381,42,42,0,1,0
20,400,400,109,95,14,2,1
19,428,428,14,14,0,1,0
27,432,432,4,1,3,2,1
24,433,433,80,80,0,1,0
21,437,437,33,33,0,1,0
10,439,439,171,171,0,1,0
9,449,449,16,16,0,1,0
16,451,451,20,20,0,1,0
7,452,452,35,6,29,3,2

15,109,109,7,7,0,1,0
6,139,139,17,5,12,2,1
10,142,142,7,7,0,1,0
8,143,143,22,8,14,4,3
3,225,225,21,21,0,1,0
11,231,231,22,4,18,3,2
9,237,237,6,6,0,1,0
21,264,264,112,2,110,4,3
23,279,279,26,6,20,2,1
5,288,288,16,16,0,1,0
16,312,312,100,100,0,1,0
24,325,325,17,2,15,3,2
1,338,338,12,12,0,1,0
13,356,356,13,13,0,1,0
19,356,356,26,8,18,2,1
4,370,370,134,86,48,2,1
14,387,387,10,3,7,2,1
7,412,412,21,8,13,2,1
20,418,418,3,3,0,1,0
0,432,432,110,110,0,1,0
2,433,433,1,1,0,1,0
12,440,440,6,6,0,1,0
22,462,462,37,37,0,1,0
17,465,465,47,8,39,2,1
18,478,478,12,6,6,3,2

2,113,113,5,5,0,1,0
5,129,129,5,2,3,2,1
24,145,145,7,2,5,2,1
12,155,155,8,4,4,2,1
27,161,161,22,22,0,1,0
4,161,161,1,1,0,1,0
17,168,168,1,1,0,1,0
0,171,171,5,5,0,1,0
3,173,173,51,21,30,3,2
16,205,205,10,10,0,1,0
7,224,224,7,3,4,2,1
22,246,246,14,5,9,4,3
20,252,252,19,3,16,3,2
19,270,270,2,2,0,1,0
26,270,270,57,57,0,1,0
29,271,271,6,2,4,2,1
15,284,284,23,23,0,1,0
30,285,285,18,3,15,4,3
6,286,286,16,16,0,1,0
9,303,303,31,13,18,3,2
18,308,308,25,25,0,1,0
11,315,315,9,9,0,1,0
28,324,324,6,6,0,1,0
13,332,332,45,45,0,1,0
1,333,333,1,1,0,1,0
25,377,377,18,3,15,2,1
14,381,381,32,23,9,4,3
8,390,390,35,7,28,2,1
23,407,407,90,90,0,1,0
32,413,413,73,4,69,4,3
10,445,445,36,36,0,1,0
21,486,486,64,64,0,1,0
31,498,498,58,52,6,2,1

4,109,109,28,28,0,1,0
14,125,125,13,13,0,1,0
18,148,148,64,14,50,2,1
16,149,149,2,2,0,1,0
13,168,168,13,13,0,1,0
22,223,223,3,3,0,1,0
20,227,227,8,2,6,2,1
6,231,231,47,47,0,1,0
8,239,239,34,34,0,1,0
12,273,273,20,11,9,2,1
2,278,278,32,32,0,1,0
19,281,281,22,22,0,1,0
3,311,311,19,19,0,1,0
21,358,358,4,4,0,1,0
5,365,365,42,12,30,4,3
11,366,366,54,54,0,1,0
9,366,366,78,78,0,1,0
1,398,398,25,15,10,3,2
0,413,413,53,53,0,1,0
15,414,414,100,27,73,4,3
10,470,470,40,40,0,1,0
17,473,473,8,2,6,3,2
7,474,474,1,1,0,1,0

20,133,133,8,3,5,2,1
10,158,158,1,1,0,1,0
24,158,158,4,4,0,1,0
23,158,158,11,11,0,1,0
13,160,160,2,2,0,1,0
7,185,185,19,8,11,2,1
16,191,191,15,15,0,1,0
29,205,205,28,4,24,2,1
22,218,218,12,12,0,1,0
19,226,226,50,45,5,2,1
18,226,226,23,16,7,2,1
28,259,259,18,18,0,1,0
27,285,285,18,18,0,1,0
6,287,287,34,34,0,1,0
8,288,288,3,3,0,1,0
11,291,291,77,36,41,2,1
17,294,294,53,14,39,4,3
26,302,302,71,2,69,4,3
2,303,303,6,3,3,2,1
3,317,317,7,1,6,3,2
0,344,344,9,5,4,2,1
9,352,352,84,42,42,3,2
5,352,352,10,10,0,1,0
21,388,388,11,11,0,1,0
15,392,392,27,3,24,3,2
12,405,405,65,65,0,1,0
4,423,423,7,1,6,2,1
25,444,444,37,31,6,3,2
14,468,468,13,13,0,1,0
1,499,499,51,51,0,1,0

24,100,100,2,2,0,1,0
5,111,111,8,2,6,2,1
18,120,120,1,1,0,1,0
14,130,130,21,1,20,3,2
16,183,183,14,4,10,2,1
8,195,195,46,46,0,1,0
6,204,204,1,1,0,1,0
13,245,245,55,31,24,4,3
7,247,247,27,27,0,1,0
2,251,251,1,1,0,1,0
19,260,260,35,12,23,2,1
1,274,274,82,73,9,4,3
23,313,313,11,11,0,1,0
0,336,336,50,30,20,2,1
10,357,357,7,7,0,1,0
22,362,362,15,3,12,3,2
17,379,379,22,12,10,3,2
3,391,391,15,9,6,3,2
9,403,403,8,8,0,1,0
15,410,410,139,139,0,1,0
11,430,430,45,45,0,1,0
20,438,438,2,2,0,1,0
4,440,440,20,15,5,2,1
25,451,451,24,24,0,1,0
12,470,470,93,20,73,3,2
21,492,492,80,61,19,2,1

9,132,132,2,2,0,1,0
18,138,138,5,5,0,1,0
0,147,147,18,3,15,4,3
11,166,166,39,39,0,1,0
4,174,174,1,1,0,1,0
5,200,200,1,1,0,1,0
23,209,209,52,20,32,3,2
19,210,210,12,12,0,1,0
1,267,267,110,79,31,2,1
16,269,269,34,34,0,1,0
15,270,270,15,3,12,3,2
12,280,280,28,24,4,2,1
3,299,299,21,3,18,4,3
2,317,317,16,16,0,1,0
21,320,320,78,78,0,1,0
8,325,325,13,1,12,4,3
24,329,329,4,4,0,1,0
10,341,341,19,12,7,2,1
22,352,352,1,1,0,1,0
6,369,369,56,56,0,1,0
20,376,376,111,111,0,1,0
14,383,383,44,44,0,1,0
25,389,389,10,3,7,2,1
7,390,390,15,15,0,1,0
17,398,398,5,5,0,1,0
13,434,434,40,40,0,1,0

1,102,102,1,1,0,1,0
23,117,117,17,7,10,2,1
9,138,138,28,13,15,4,3
13,141,141,12,12,0,1,0
12,154,154,27,27,0,1,0
0,159,159,15,15,0,1,0
6,159,159,23,17,6,2,1
4,183,183,1,1,0,1,0
21,187,187,18,18,0,1,0
27,193,193,19,19,0,1,0
18,215,215,82,82,0,1,0
19,246,246,26,26,0,1,0
7,251,251,5,5,0,1,0
17,251,251,1,1,0,1,0
28,255,255,5,5,0,1,0
16,263,263,37,6,31,2,1
22,279,279,27,7,20,2,1
10,300,300,34,34,0,1,0
11,329,329,61,53,8,2,1
24,339,339,63,63,0,1,0
15,340,340,21,6,15,2,1
8,363,363,18,18,0,1,0
14,373,373,27,27,0,1,0
5,419,419,27,19,8,3,2
20,431,431,8,8,0,1,0
2,460,460,1,1,0,1,0
3,461,461,7,7,0,1,0
26,473,473,7,7,0,1,0
25,476,476,12,12,0,1,0

21,103,103,10,10,0,1,0
11,134,134,1,1,0,1,0
24,164,164,7,7,0,1,0
0,203,203,12,12,0,1,0
9,206,206,8,8,0,1,0
18,234,234,55,37,18,4,3
1,248,248,6,6,0,1,0
10,255,255,54,54,0,1,0
17,255,255,4,4,0,1,0
6,259,259,30,9,21,3,2
15,269,269,65,65,0,1,0
19,287,287,1,1,0,1,0
13,296,296,34,19,15,4,3
8,340,340,7,7,0,1,0
5,365,365,89,48,41,2,1
20,370,370,10,10,0,1,0
7,384,384,11,11,0,1,0
25,390,390,35,15,20,3,2
14,398,398,30,8,22,3,2
2,409,409,140,101,39,4,3
16,427,427,4,4,0,1,0
22,430,430,94,22,72,3,2
4,442,442,4,4,0,1,0
3,465,465,57,24,33,4,3
23,478,478,72,5,67,4,3
12,494,494,38,7,31,3,2

10,103,103,2,2,0,1,0
15,105,105,9,3,6,3,2
25,125,125,21,21,0,1,0
3,127,127,6,3,3,2,1
0,129,129,9,2,7,2,1
4,156,156,10,10,0,1,0
21,208,208,53,23,30,4,3
1,226,226,2,2,0,1,0
8,228,228,35,1,34,3,2
20,232,232,15,15,0,1,0
22,289,289,39,39,0,1,0
12,293,293,98,24,74,3,2
17,299,299,36,5,31,4,3
11,307,307,38,38,0,1,0
14,315,315,7,7,0,1,0
16,337,337,40,40,0,1,0
24,361,361,35,7,28,3,2
9,361,361,12,12,0,1,0
2,405,405,104,23,81,4,3
23,407,407,1,1,0,1,0
18,409,409,49,49,0,1,0
19,460,460,30,6,24,3,2
13,463,463,32,32,0,1,0
6,464,464,5,1,4,2,1
7,484,484,77,41,36,4,3
5,494,494,11,11,0,1,0

15,145,145,16,3,13,2,1
23,154,154,2,2,0,1,0
19,176,176,1,1,0,1,0
1,188,188,16,16,0,1,0
0,249,249,4,4,0,1,0
14,259,259,10,10,0,1,0
6,265,265,45,33,12,3,2
21,275,275,43,31,12,4,3
16,277,277,29,9,20,3,2
9,283,283,111,71,40,2,1
22,290,290,25,11,14,2,1
12,295,295,37,10,27,2,1
17,306,306,25,25,0,1,0
7,318,318,12,12,0,1,0
10,318,318,3,3,0,1,0
3,319,319,1,1,0,1,0
5,333,333,83,53,30,4,3
11,334,334,36,13,23,2,1
18,347,347,106,69,37,2,1
25,353,353,11,2,9,2,1
13,358,358,47,26,21,4,3
8,373,373,11,11,0,1,0
20,429,429,20,4,16,3,2
2,460,460,23,9,14,2,1
4,479,479,12,12,0,1,0
24,489,489,105,90,15,4,3

19,137,137,12,4,8,3,2
15,139,139,31,31,0,1,0
9,199,199,17,3,14,2,1
17,205,205,32,32,0,1,0
3,206,206,20,20,0,1,0
5,220,220,6,6,0,1,0
22,244,244,16,16,0,1,0
0,252,252,41,41,0,1,0
6,257,257,21,4,17,2,1
2,267,267,36,36,0,1,0
23,290,290,12,12,0,1,0
13,307,307,5,5,0,1,0
16,311,311,76,73,3,2,1
10,314,314,107,59,48,4,3
18,329,329,11,11,0,1,0
8,379,379,22,22,0,1,0
12,387,387,90,7,83,4,3
7,394,394,40,40,0,1,0
14,398,398,12,12,0,1,0
4,416,416,36,36,0,1,0
20,435,435,49,44,5,2,1
11,444,444,18,18,0,1,0
21,453,453,18,4,14,3,2
1,454,454,57,57,0,1,0

0,105,105,1,1,0,1,0
19,119,119,13,13,0,1,0
3,171,171,4,4,0,1,0
11,171,171,12,12,0,1,0
4,182,182,23,4,19,2,1
10,182,182,13,3,10,3,2
21,186,186,14,14,0,1,0
23,198,198,9,9,0,1,0
20,202,202,15,15,0,1,0
26,237,237,7,7,0,1,0
22,254,254,121,105,16,2,1
27,255,255,11,11,0,1,0
17,256,256,11,5,6,3,2
7,259,259,12,12,0,1,0
8,263,263,6,6,0,1,0
29,274,274,20,20,0,1,0
6,315,315,4,4,0,1,0
13,320,320,85,31,54,4,3
12,321,321,38,14,24,3,2
14,359,359,6,2,4,2,1
15,374,374,53,16,37,2,1
2,402,402,49,13,36,2,1
16,408,408,9,1,8,3,2
5,419,419,1,1,0,1,0
1,444,444,18,2,16,2,1
9,453,453,86,86,0,1,0
24,464,464,20,20,0,1,0
18,465,465,54,8,46,3,2
28,473,473,60,12,48,4,3
25,483,483,33,33,0,1,0

10,102,102,11,11,0,1,0
11,124,124,1,1,0,1,0
0,139,139,12,12,0,1,0
17,142,142,39,39,0,1,0
8,143,143,43,5,38,2,1
20,163,163,55,55,0,1,0
12,186,186,35,14,21,4,3
9,238,238,48,6,42,4,3
13,250,250,15,15,0,1,0
18,250,250,28,9,19,2,1
22,256,256,8,8,0,1,0
19,257,257,4,1,3,2,1
6,275,275,23,14,9,2,1
15,285,285,3,3,0,1,0
21,323,323,14,14,0,1,0
4,350,350,2,2,0,1,0
5,367,367,42,33,9,4,3
16,367,367,18,18,0,1,0
2,398,398,117,117,0,1,0
7,428,428,33,15,18,2,1
14,439,439,39,39,0,1,0
1,441,441,27,27,0,1,0
3,500,500,39,39,0,1,0

2,110,110,4,4,0,1,0
7,130,130,31,19,12,4,3
12,171,171,1,1,0,1,0
17,172,172,13,13,0,1,0
11,178,178,2,2,0,1,0
3,186,186,1,1,0,1,0
1,189,189,11,11,0,1,0
27,196,196,44,5,39,2,1
8,201,201,13,13,0,1,0
21,213,213,1,1,0,1,0
18,226,226,19,19,0,1,0
10,232,232,31,15,16,3,2
4,246,246,30,16,14,3,2
28,262,262,90,46,44,3,2
5,306,306,18,18,0,1,0
20,313,313,6,6,0,1,0
0,350,350,90,90,0,1,0
19,355,355,19,19,0,1,0
6,357,357,48,48,0,1,0
9,360,360,2,2,0,1,0
25,366,366,38,38,0,1,0
26,370,370,38,26,12,4,3
14,398,398,6,6,0,1,0
22,407,407,33,33,0,1,0
16,439,439,20,7,13,2,1
13,448,448,43,36,7,2,1
15,475,475,28,4,24,3,2
23,475,475,7,1,6,3,2
24,484,484,79,21,58,3,2

13,102,102,1,1,0,1,0
14,113,113,3,3,0,1,0
17,139,139,2,2,0,1,0
26,140,140,2,2,0,1,0
20,169,169,30,15,15,4,3
8,177,177,45,15,30,3,2
6,202,202,1,1,0,1,0
11,246,246,7,2,5,2,1
21,264,264,28,28,0,1,0
3,268,268,3,3,0,1,0
1,282,282,79,79,0,1,0
7,284,284,41,41,0,1,0
23,288,288,76,38,38,2,1
9,294,294,24,4,20,3,2
12,326,326,37,37,0,1,0
22,334,334,16,1,15,4,3
18,339,339,32,32,0,1,0
10,343,343,19,19,0,1,0
0,361,361,18,18,0,1,0
5,370,370,2,2,0,1,0
24,375,375,37,37,0,1,0
15,408,408,27,5,22,3,2
25,448,448,36,36,0,1,0
27,449,449,49,15,34,3,2
16,469,469,66,66,0,1,0
4,477,477,33,15,18,4,3
19,478,478,56,36,20,3,2
2,480,480,82,82,0,1,0

0,127,127,48,8,40,3,2
23,132,132,29,14,15,4,3
3,183,183,11,11,0,1,0
17,200,200,1,1,0,1,0
2,225,225,67,67,0,1,0
4,233,233,24,16,8,3,2
19,253,253,33,21,12,3,2
10,254,254,21,2,19,2,1
1,282,282,5,5,0,1,0
15,283,283,10,4,6,3,2
24,288,288,47,14,33,2,1
13,303,303,44,12,32,3,2
5,324,324,1,1,0,1,0
14,334,334,111,108,3,2,1
22,353,353,15,15,0,1,0
16,359,359,5,5,0,1,0
9,363,363,10,2,8,3,2
11,382,382,23,5,18,4,3
7,383,383,28,7,21,2,1
21,387,387,25,1,24,3,2
20,395,395,11,11,0,1,0
8,399,399,32,8,24,2,1
18,403,403,31,21,10,3,2
12,465,465,29,29,0,1,0
6,489,489,58,16,42,4,3

15,111,111,1,1,0,1,0
12,130,130,3,3,0,1,0
21,143,143,34,19,15,2,1
29,199,199,10,10,0,1,0
16,208,208,1,1,0,1,0
19,212,212,9,3,6,3,2
24,228,228,13,5,8,3,2
18,254,254,62,22,40,3,2
23,263,263,16,1,15,4,3
13,268,268,4,4,0,1,0
17,281,281,31,31,0,1,0
22,285,285,44,44,0,1,0
11,298,298,6,6,0,1,0
20,308,308,3,3,0,1,0
14,324,324,4,4,0,1,0
8,324,324,3,3,0,1,0
3,334,334,21,17,4,2,1
7,348,348,185,80,105,4,3
0,356,356,6,1,5,2,1
2,365,365,16,16,0,1,0
4,378,378,6,3,3,2,1
5,393,393,46,46,0,1,0
27,397,397,44,44,0,1,0
1,400,400,5,1,4,2,1
10,402,402,21,21,0,1,0
26,410,410,68,58,10,2,1
25,431,431,21,21,0,1,0
9,459,459,66,55,11,2,1
6,461,461,97,97,0,1,0
28,480,480,15,1,14,3,2

15,138,138,4,4,0,1,0
31,150,150,2,2,0,1,0
28,156,156,2,2,0,1,0
6,164,164,58,10,48,4,3
22,172,172,18,4,14,3,2
26,173,173,44,44,0,1,0
12,181,181,13,13,0,1,0
23,248,248,35,35,0,1,0
13,250,250,29,14,15,4,3
19,253,253,22,2,20,2,1
17,254,254,17,17,0,1,0
2,259,259,9,4,5,2,1
4,259,259,10,2,8,3,2
7,265,265,12,7,5,2,1
0,274,274,41,41,0,1,0
11,290,290,1,1,0,1,0
30,307,307,104,88,16,3,2
9,319,319,3,3,0,1,0
27,321,321,24,18,6,2,1
21,342,342,7,7,0,1,0
14,367,367,13,13,0,1,0
18,375,375,1,1,0,1,0
16,377,377,45,30,15,4,3
3,398,398,4,4,0,1,0
24,403,403,2,2,0,1,0
5,434,434,9,9,0,1,0
10,439,439,5,1,4,2,1
25,444,444,66,25,41,2,1
1,472,472,13,4,9,2,1
29,472,472,30,25,5,2,1
8,479,479,74,16,58,4,3
20,495,495,30,6,24,2,1

19,116,116,33,33,0,1,0
16,128,128,2,2,0,1,0
5,134,134,3,3,0,1,0
13,136,136,10,10,0,1,0
12,166,166,52,19,33,4,3
10,216,216,31,31,0,1,0
23,249,249,79,79,0,1,0
6,268,268,7,3,4,2,1
7,277,277,1,1,0,1,0
1,285,285,37,29,8,3,2
21,301,301,80,62,18,4,3
24,304,304,8,8,0,1,0
4,313,313,88,85,3,2,1
11,324,324,26,26,0,1,0
15,350,350,17,11,6,3,2
20,351,351,9,9,0,1,0
14,357,357,29,13,16,3,2
0,358,358,8,8,0,1,0
2,392,392,87,48,39,4,3
9,433,433,8,8,0,1,0
3,458,458,7,7,0,1,0
17,462,462,19,7,12,4,3
8,473,473,13,13,0,1,0
22,477,477,4,4,0,1,0
25,477,477,46,2,44,2,1
18,489,489,21,1,20,3,2

21,104,104,6,6,0,1,0
19,111,111,17,9,8,3,2
27,113,113,33,9,24,3,2
4,113,113,17,17,0,1,0
29,116,116,14,11,3,2,1
28,132,132,5,5,0,1,0
20,153,153,12,6,6,2,1
12,153,153,3,3,0,1,0
33,159,159,6,6,0,1,0
15,173,173,9,9,0,1,0
32,180,180,21,21,0,1,0
35,189,189,11,11,0,1,0
3,227,227,14,2,12,4,3
7,257,257,13,13,0,1,0
1,263,263,18,18,0,1,0
22,267,267,8,1,7,2,1
24,289,289,67,67,0,1,0
2,296,296,17,4,13,2,1
18,297,297,1,1,0,1,0
25,308,308,4,4,0,1,0
10,339,339,1,1,0,1,0
8,341,341,43,3,40,2,1
9,344,344,24,6,18,4,3
14,349,349,4,4,0,1,0
0,376,376,30,30,0,1,0
5,385,385,3,3,0,1,0
13,399,399,30,30,0,1,0
11,400,400,31,31,0,1,0
34,405,405,78,15,63,4,3
16,430,430,1,1,0,1,0
26,433,433,17,12,5,2,1
23,439,439,24,15,9,4,3
17,458,458,3,3,0,1,0
31,460,460,29,29,0,1,0
6,488,488,29,29,0,1,0
30,489,489,35,6,29,4,3

16,107,107,3,3,0,1,0
19,150,150,26,7,19,4,3
14,150,150,8,8,0,1,0
17,164,164,25,5,20,2,1
12,168,168,27,27,0,1,0
5,174,174,35,35,0,1,0
6,189,189,10,2,8,3,2
11,207,207,5,5,0,1,0
13,213,213,17,17,0,1,0
24,219,219,13,1,12,3,2
9,219,219,1,1,0,1,0
18,233,233,8,8,0,1,0
4,242,242,2,2,0,1,0
2,246,246,38,26,12,4,3
15,250,250,27,15,12,3,2
23,257,257,24,24,0,1,0
8,273,273,24,24,0,1,0
22,342,342,63,63,0,1,0
3,346,346,36,36,0,1,0
10,354,354,63,63,0,1,0
25,367,367,2,2,0,1,0
1,442,442,36,20,16,2,1
21,460,460,136,52,84,4,3
0,466,466,46,46,0,1,0
20,485,485,28,22,6,3,2
7,499,499,73,24,49,2,1

16,119,119,8,2,6,2,1
28,124,124,21,12,9,4,3
3,164,164,6,6,0,1,0
2,180,180,13,4,9,4,3
5,195,195,16,13,3,2,1
19,195,195,8,8,0,1,0
27,203,203,29,29,0,1,0
1,217,217,4,1,3,2,1
21,226,226,14,2,12,4,3
11,229,229,16,1,15,4,3
30,244,244,13,13,0,1,0
9,249,249,17,7,10,2,1
26,286,286,8,8,0,1,0
23,300,300,47,37,10,3,2
18,307,307,69,3,66,4,3
12,326,326,28,28,0,1,0
17,339,339,6,6,0,1,0
24,339,339,59,59,0,1,0
29,349,349,30,30,0,1,0
0,353,353,42,17,25,2,1
13,353,353,51,51,0,1,0
4,356,356,14,2,12,3,2
15,369,369,51,4,47,3,2
25,395,395,21,21,0,1,0
22,409,409,35,35,0,1,0
6,426,426,13,1,12,3,2
8,428,428,57,15,42,2,1
7,428,428,1,1,0,1,0
14,479,479,64,64,0,1,0
20,488,488,24,6,18,4,3
10,499,499,21,21,0,1,0

6,115,115,4,4,0,1,0
19,123,123,17,4,13,2,1
24,155,155,6,3,3,2,1
4,164,164,6,6,0,1,0
15,182,182,22,17,5,2,1
0,183,183,3,3,0,1,0
9,187,187,18,18,0,1,0
25,199,199,17,17,0,1,0
5,207,207,10,10,0,1,0
8,221,221,46,8,38,2,1
7,223,223,9,1,8,3,2
14,235,235,20,20,0,1,0
23,248,248,12,3,9,2,1
10,250,250,33,33,0,1,0
18,255,255,2,2,0,1,0
13,264,264,21,21,0,1,0
3,279,279,36,27,9,4,3
1,286,286,22,15,7,2,1
2,341,341,27,12,15,2,1
11,348,348,23,15,8,3,2
26,391,391,8,8,0,1,0
22,404,404,16,9,7,2,1
12,435,435,75,75,0,1,0
17,435,435,143,94,49,3,2
21,451,451,69,69,0,1,0
16,457,457,24,6,18,3,2
27,462,462,42,42,0,1,0
20,476,476,98,67,31,2,1

5,101,101,53,1,52,4,3
2,151,151,1,1,0,1,0
10,155,155,4,1,3,2,1
3,177,177,19,6,13,2,1
12,184,184,4,4,0,1,0
9,222,222,23,8,15,2,1
6,227,227,1,1,0,1,0
13,235,235,8,8,0,1,0
20,255,255,27,27,0,1,0
14,257,257,48,48,0,1,0
11,280,280,24,24,0,1,0
22,288,288,67,67,0,1,0
16,313,313,7,1,6,3,2
21,331,331,39,16,23,2,1
7,336,336,8,8,0,1,0
19,368,368,38,38,0,1,0
4,370,370,48,48,0,1,0
17,373,373,14,14,0,1,0
8,408,408,110,110,0,1,0
0,409,409,25,25,0,1,0
18,429,429,77,39,38,2,1
15,444,444,75,75,0,1,0
1,490,490,36,36,0,1,0

20,142,142,3,3,0,1,0
19,142,142,1,1,0,1,0
22,172,172,34,12,22,3,2
4,190,190,2,2,0,1,0
18,193,193,4,4,0,1,0
25,207,207,4,4,0,1,0
2,228,228,17,17,0,1,0
23,253,253,5,5,0,1,0
1,274,274,8,8,0,1,0
7,277,277,24,24,0,1,0
11,278,278,44,44,0,1,0
10,280,280,12,12,0,1,0
12,288,288,35,35,0,1,0
0,329,329,83,83,0,1,0
13,340,340,91,18,73,4,3
8,349,349,24,24,0,1,0
5,351,351,15,6,9,4,3
14,366,366,24,24,0,1,0
3,370,370,14,4,10,2,1
26,371,371,161,155,6,3,2
15,376,376,14,5,9,2,1
24,410,410,28,21,7,2,1
17,456,456,69,69,0,1,0
6,457,457,28,28,0,1,0
21,461,461,52,52,0,1,0
16,464,464,79,33,46,3,2
9,497,497,23,23,0,1,0

2,108,108,20,20,0,1,0
4,112,112,7,4,3,2,1
14,131,131,20,16,4,2,1
6,141,141,4,4,0,1,0
3,144,144,39,21,18,2,1
16,149,149,11,11,0,1,0
12,152,152,48,4,44,3,2
15,152,152,2,2,0,1,0
1,171,171,61,22,39,2,1
23,183,183,14,14,0,1,0
20,192,192,12,2,10,3,2
5,209,209,16,16,0,1,0
17,222,222,100,100,0,1,0
19,224,224,2,2,0,1,0
13,270,270,8,8,0,1,0
11,313,313,3,3,0,1,0
9,320,320,46,46,0,1,0
22,326,326,6,6,0,1,0
8,360,360,30,30,0,1,0
10,376,376,27,27,0,1,0
21,424,424,2,2,0,1,0
0,434,434,4,1,3,2,1
18,439,439,49,17,32,2,1
7,487,487,7,7,0,1,0

25,120,120,15,15,0,1,0
1,121,121,24,24,0,1,0
9,137,137,20,20,0,1,0
3,165,165,2,2,0,1,0
17,177,177,33,33,0,1,0
23,178,178,11,11,0,1,0
12,210,210,25,13,12,2,1
20,223,223,6,1,5,2,1
10,235,235,21,21,0,1,0
13,242,242,23,13,10,2,1
11,250,250,4,4,0,1,0
4,272,272,7,7,0,1,0
18,283,283,44,44,0,1,0
6,283,283,17,17,0,1,0
2,314,314,119,92,27,2,1
16,321,321,73,9,64,3,2
5,328,328,49,49,0,1,0
7,350,350,21,17,4,2,1
8,359,359,9,9,0,1,0
21,413,413,70,54,16,2,1
19,426,426,1,1,0,1,0
15,435,435,19,19,0,1,0
0,448,448,11,11,0,1,0
22,450,450,17,17,0,1,0
14,474,474,64,64,0,1,0
24,497,497,31,4,27,4,3

10,100,100,1,1,0,1,0
15,121,121,11,11,0,1,0
23,144,144,2,2,0,1,0
21,201,201,97,88,9,4,3
17,204,204,7,7,0,1,0
25,222,222,8,8,0,1,0
5,242,242,17,12,5,2,1
24,252,252,19,19,0,1,0
20,296,296,11,8,3,2,1
18,303,303,22,22,0,1,0
22,304,304,5,5,0,1,0
11,306,306,40,1,39,2,1
2,310,310,20,20,0,1,0
9,340,340,11,3,8,2,1
19,362,362,68,26,42,3,2
12,386,386,52,4,48,4,3
3,389,389,11,11,0,1,0
4,393,393,36,36,0,1,0
13,394,394,74,74,0,1,0
14,413,413,9,9,0,1,0
8,426,426,54,54,0,1,0
16,436,436,32,32,0,1,0
1,446,446,176,94,82,4,3
0,451,451,40,3,37,2,1
6,458,458,23,16,7,2,1
7,475,475,37,11,26,2,1

3,110,110,6,6,0,1,0
5,110,110,4,4,0,1,0
6,120,120,7,7,0,1,0
2,160,160,17,17,0,1,0
21,161,161,21,9,12,3,2
25,176,176,9,2,7,2,1
10,186,186,30,30,0,1,0
0,205,205,6,6,0,1,0
4,212,212,33,10,23,2,1
23,222,222,30,30,0,1,0
9,257,257,37,37,0,1,0
11,270,270,10,10,0,1,0
17,278,278,48,34,14,2,1
8,292,292,15,1,14,2,1
24,311,311,26,1,25,2,1
14,351,351,98,11,87,4,3
16,351,351,1,1,0,1,0
7,363,363,43,43,0,1,0
13,368,368,45,39,6,2,1
1,371,371,46,46,0,1,0
26,391,391,38,38,0,1,0
22,392,392,9,9,0,1,0
12,412,412,42,42,0,1,0
19,423,423,17,3,14,3,2
18,441,441,43,20,23,2,1
20,496,496,96,28,68,3,2
15,497,497,7,7,0,1,0

27,112,112,8,8,0,1,0
5,120,120,15,15,0,1,0
24,123,123,1,1,0,1,0
7,135,135,3,3,0,1,0
1,145,145,4,4,0,1,0
11,162,162,4,4,0,1,0
2,175,175,1,1,0,1,0
8,209,209,3,3,0,1,0
4,211,211,16,6,10,3,2
15,211,211,7,2,5,2,1
28,212,212,20,20,0,1,0
16,233,233,31,31,0,1,0
18,248,248,60,60,0,1,0
14,275,275,16,1,15,2,1
30,279,279,19,19,0,1,0
31,284,284,8,8,0,1,0
20,295,295,40,15,25,2,1
3,300,300,19,19,0,1,0
13,310,310,11,11,0,1,0
9,330,330,17,11,6,2,1
22,352,352,33,30,3,2,1
19,354,354,65,24,41,2,1
6,361,361,23,23,0,1,0
0,375,375,12,7,5,2,1
12,383,383,11,2,9,4,3
26,405,405,23,18,5,2,1
21,435,435,2,2,0,1,0
17,447,447,25,25,0,1,0
23,458,458,74,21,53,3,2
10,461,461,96,60,36,3,2
29,474,474,111,55,56,3,2
25,484,484,89,41,48,2,1

11,109,109,5,5,0,1,0
20,135,135,1,1,0,1,0
19,143,143,28,28,0,1,0
21,182,182,8,2,6,2,1
16,188,188,23,23,0,1,0
22,198,198,18,18,0,1,0
3,215,215,17,4,13,2,1
4,250,250,8,2,6,3,2
2,270,270,46,46,0,1,0
7,273,273,31,20,11,2,1
1,276,276,13,7,6,2,1
15,295,295,51,51,0,1,0
9,305,305,51,45,6,3,2
0,313,313,52,30,22,3,2
12,337,337,65,5,60,4,3
10,345,345,31,10,21,2,1
13,362,362,34,12,22,3,2
5,408,408,75,43,32,2,1
6,443,443,92,68,24,4,3
18,462,462,26,12,14,3,2
8,463,463,62,14,48,4,3
17,498,498,103,64,39,2,1
14,499,499,4,4,0,1,0

19,102,102,2,2,0,1,0
21,107,107,4,1,3,2,1
17,126,126,5,5,0,1,0
9,127,127,16,5,11,2,1
1,150,150,33,15,18,3,2
20,162,162,15,15,0,1,0
5,170,170,7,7,0,1,0
0,195,195,5,5,0,1,0
13,234,234,24,24,0,1,0
3,248,248,31,4,27,4,3
18,250,250,18,6,12,2,1
10,257,257,9,1,8,2,1
14,299,299,21,21,0,1,0
4,318,318,38,13,25,2,1
16,328,328,3,3,0,1,0
8,330,330,37,6,31,2,1
6,330,330,18,15,3,2,1
23,337,337,3,3,0,1,0
12,364,364,249,149,100,3,2
11,396,396,7,7,0,1,0
22,426,426,37,19,18,2,1
24,427,427,4,4,0,1,0
2,431,431,94,94,0,1,0
7,447,447,92,44,48,4,3
15,448,448,45,1,44,3,2

23,149,149,5,5,0,1,0
25,171,171,6,6,0,1,0
18,184,184,8,2,6,2,1
7,185,185,9,9,0,1,0
24,193,193,32,32,0,1,0
9,196,196,58,58,0,1,0
10,210,210,41,41,0,1,0
14,214,214,35,11,24,3,2
12,220,220,2,2,0,1,0
4,245,245,3,3,0,1,0
13,249,249,49,49,0,1,0
5,255,255,9,2,7,2,1
22,271,271,10,10,0,1,0
3,287,287,10,1,9,4,3
0,315,315,23,23,0,1,0
21,323,323,13,13,0,1,0
15,334,334,10,10,0,1,0
20,368,368,20,20,0,1,0
8,386,386,10,10,0,1,0
2,389,389,81,81,0,1,0
6,427,427,15,15,0,1,0
1,445,445,144,3,141,4,3
19,454,454,40,40,0,1,0
11,465,465,3,3,0,1,0
16,480,480,1,1,0,1,0
17,485,485,215,215,0,1,0

2,115,115,2,2,0,1,0
1,120,120,29,5,24,3,2
14,123,123,11,2,9,2,1
19,142,142,27,27,0,1,0
5,151,151,14,14,0,1,0
4,153,153,8,8,0,1,0
26,164,164,15,3,12,4,3
11,176,176,16,11,5,2,1
24,261,261,26,4,22,3,2
9,268,268,24,6,18,3,2
3,278,278,21,21,0,1,0
13,281,281,53,53,0,1,0
18,295,295,1,1,0,1,0
16,296,296,17,17,0,1,0
6,307,307,50,30,20,3,2
20,311,311,66,16,50,2,1
21,313,313,19,1,18,3,2
8,330,330,36,8,28,3,2
22,332,332,4,4,0,1,0
25,340,340,95,95,0,1,0
12,354,354,34,7,27,2,1
15,355,355,20,17,3,2,1
17,417,417,55,55,0,1,0
7,421,421,23,5,18,3,2
0,445,445,5,5,0,1,0
10,481,481,10,10,0,1,0
23,496,496,22,8,14,3,2

0,109,109,4,4,0,1,0
27,121,121,12,4,8,3,2
17,124,124,6,6,0,1,0
5,141,141,13,1,12,2,1
30,166,166,23,23,0,1,0
23,169,169,38,29,9,2,1
18,174,174,32,32,0,1,0
26,187,187,26,26,0,1,0
24,197,197,24,24,0,1,0
2,202,202,11,11,0,1,0
16,209,209,10,10,0,1,0
8,218,218,1,1,0,1,0
31,224,224,17,17,0,1,0
12,224,224,4,1,3,2,1
7,232,232,5,5,0,1,0
28,254,254,17,4,13,3,2
14,277,277,51,25,26,3,2
3,309,309,2,2,0,1,0
6,321,321,29,11,18,3,2
10,334,334,49,36,13,2,1
29,339,339,73,73,0,1,0
9,351,351,28,28,0,1,0
19,352,352,21,7,14,3,2
22,366,366,8,8,0,1,0
11,408,408,44,25,19,2,1
20,418,418,56,49,7,2,1
15,430,430,4,4,0,1,0
25,444,444,9,9,0,1,0
4,461,461,6,6,0,1,0
1,468,468,23,23,0,1,0
13,484,484,53,53,0,1,0
21,499,499,8,5,3,2,1

7,102,102,1,1,0,1,0
4,131,131,6,6,0,1,0
21,143,143,15,15,0,1,0
5,156,156,39,39,0,1,0
14,203,203,40,21,19,2,1
3,204,204,77,13,64,3,2
12,220,220,17,2,15,4,3
18,221,221,13,13,0,1,0
15,232,232,32,15,17,4,3
10,240,240,13,13,0,1,0
13,265,265,38,38,0,1,0
11,273,273,7,1,6,2,1
9,308,308,14,4,10,2,1
8,310,310,6,6,0,1,0
0,332,332,17,8,9,2,1
24,332,332,106,40,66,4,3
1,366,366,9,9,0,1,0
2,382,382,38,38,0,1,0
19,396,396,28,28,0,1,0
20,397,397,7,2,5,2,1
23,403,403,39,27,12,4,3
17,410,410,1,1,0,1,0
22,410,410,19,19,0,1,0
6,411,411,123,65,58,3,2
16,499,499,24,24,0,1,0

25,103,103,23,19,4,2,1
20,105,105,31,5,26,4,3
27,126,126,14,11,3,2,1
21,129,129,2,2,0,1,0
23,134,134,9,4,5,2,1
22,139,139,4,4,0,1,0
9,145,145,18,9,9,2,1
16,171,171,6,6,0,1,0
14,173,173,1,1,0,1,0
10,198,198,4,4,0,1,0
2,208,208,15,15,0,1,0
7,228,228,12,2,10,2,1
24,242,242,3,3,0,1,0
17,245,245,65,43,22,3,2
11,295,295,34,12,22,2,1
15,327,327,35,35,0,1,0
6,333,333,17,9,8,3,2
13,366,366,21,21,0,1,0
4,388,388,9,9,0,1,0
18,433,433,5,5,0,1,0
1,434,434,147,147,0,1,0
8,439,439,10,10,0,1,0
0,441,441,3,3,0,1,0
3,456,456,1,1,0,1,0
5,464,464,8,2,6,3,2
19,471,471,39,6,33,2,1
26,482,482,39,10,29,2,1
12,496,496,195,195,0,1,0

2,110,110,6,6,0,1,0
5,110,110,15,15,0,1,0
0,147,147,14,1,13,2,1
4,160,160,7,7,0,1,0
19,164,164,9,9,0,1,0
20,179,179,21,21,0,1,0
11,191,191,5,5,0,1,0
21,195,195,4,1,3,2,1
23,244,244,23,23,0,1,0
15,256,256,37,37,0,1,0
10,278,278,23,23,0,1,0
13,283,283,39,21,18,3,2
6,290,290,111,50,61,4,3
12,295,295,43,9,34,2,1
17,299,299,14,2,12,4,3
22,305,305,29,13,16,3,2
24,338,338,61,15,46,4,3
14,353,353,56,56,0,1,0
8,359,359,78,21,57,4,3
1,370,370,8,5,3,2,1
3,381,381,39,39,0,1,0
18,387,387,31,31,0,1,0
9,412,412,13,8,5,2,1
7,470,470,52,52,0,1,0
16,500,500,22,22,0,1,0

4,103,103,31,31,0,1,0
0,135,135,4,4,0,1,0
18,138,138,45,45,0,1,0
10,146,146,44,16,28,2,1
3,148,148,16,16,0,1,0
2,155,155,18,18,0,1,0
14,170,170,14,7,7,2,1
7,178,178,10,10,0,1,0
1,180,180,8,4,4,2,1
9,221,221,9,1,8,3,2
26,222,222,9,9,0,1,0
15,253,253,25,25,0,1,0
11,264,264,1,1,0,1,0
23,285,285,33,3,30,4,3
5,291,291,9,9,0,1,0
6,294,294,20,20,0,1,0
22,296,296,43,11,32,4,3
25,323,323,33,26,7,2,1
19,331,331,1,1,0,1,0
21,335,335,4,4,0,1,0
20,366,366,50,38,12,3,2
16,410,410,40,10,30,4,3
12,416,416,5,5,0,1,0
17,438,438,31,22,9,4,3
8,443,443,26,26,0,1,0
13,494,494,64,49,15,2,1
24,496,496,50,23,27,4,3

17,118,118,6,6,0,1,0
9,123,123,14,14,0,1,0
4,136,136,5,5,0,1,0
5,136,136,6,6,0,1,0
23,148,148,1,1,0,1,0
1,157,157,3,3,0,1,0
13,162,162,6,6,0,1,0
22,167,167,2,2,0,1,0
24,171,171,14,14,0,1,0
12,189,189,20,11,9,2,1
21,196,196,22,1,21,2,1
26,203,203,20,11,9,4,3
16,231,231,57,57,0,1,0
2,243,243,1,1,0,1,0
3,268,268,13,2,11,2,1
20,271,271,2,2,0,1,0
14,271,271,32,14,18,2,1
7,282,282,11,11,0,1,0
6,288,288,30,30,0,1,0
27,315,315,155,155,0,1,0
8,319,319,17,3,14,2,1
15,359,359,6,3,3,2,1
0,426,426,41,41,0,1,0
25,442,442,46,29,17,4,3
11,461,461,102,33,69,4,3
10,467,467,121,70,51,4,3
19,471,471,20,14,6,3,2
18,479,479,30,12,18,4,3

16,110,110,4,1,3,2,1
4,115,115,1,1,0,1,0
22,133,133,7,1,6,2,1
10,144,144,14,14,0,1,0
8,151,151,12,6,6,2,1
6,170,170,3,3,0,1,0
11,182,182,14,14,0,1,0
3,188,188,52,6,46,3,2
19,234,234,18,8,10,2,1
17,246,246,28,28,0,1,0
5,283,283,33,33,0,1,0
7,287,287,61,58,3,2,1
1,291,291,4,1,3,2,1
2,306,306,11,3,8,3,2
14,314,314,32,3,29,2,1
13,353,353,30,17,13,2,1
0,363,363,61,45,16,3,2
23,397,397,84,84,0,1,0
24,455,455,66,66,0,1,0
15,459,459,30,30,0,1,0
12,460,460,20,20,0,1,0
18,470,470,52,52,0,1,0
20,471,471,131,26,105,4,3
9,478,478,96,74,22,2,1
21,500,500,4,4,0,1,0

4,106,106,6,6,0,1,0
6,127,127,32,10,22,3,2
5,128,128,1,1,0,1,0
23,137,137,12,2,10,3,2
1,144,144,3,3,0,1,0
14,181,181,3,3,0,1,0
9,199,199,1,1,0,1,0
10,205,205,56,8,48,3,2
18,230,230,58,58,0,1,0
16,252,252,44,23,21,2,1
11,253,253,1,1,0,1,0
2,265,265,107,58,49,2,1
3,304,304,12,12,0,1,0
12,304,304,62,42,20,3,2
22,314,314,22,22,0,1,0
24,324,324,19,1,18,3,2
19,328,328,82,82,0,1,0
7,344,344,1,1,0,1,0
21,356,356,32,32,0,1,0
13,381,381,32,32,0,1,0
8,381,381,9,9,0,1,0
25,412,412,19,19,0,1,0
0,415,415,4,4,0,1,0
15,432,432,39,7,32,2,1
20,462,462,23,23,0,1,0
17,470,470,27,27,0,1,0

12,140,140,8,8,0,1,0
6,162,162,17,17,0,1,0
1,179,179,31,31,0,1,0
14,191,191,11,3,8,2,1
10,191,191,16,16,0,1,0
7,220,220,30,30,0,1,0
0,248,248,24,16,8,2,1
23,259,259,9,5,4,2,1
15,267,267,19,11,8,3,2
21,278,278,47,47,0,1,0
9,281,281,2,2,0,1,0
11,284,284,26,26,0,1,0
19,287,287,21,21,0,1,0
5,296,296,77,15,62,4,3
17,327,327,16,8,8,2,1
13,329,329,8,8,0,1,0
4,331,331,23,23,0,1,0
20,331,331,41,41,0,1,0
16,348,348,116,116,0,1,0
18,354,354,64,24,40,4,3
3,435,435,11,3,8,2,1
8,478,478,66,66,0,1,0
2,484,484,101,65,36,4,3
22,486,486,29,2,27,4,3

4,128,128,21,3,18,2,1
8,147,147,6,6,0,1,0
21,168,168,2,2,0,1,0
0,175,175,40,24,16,3,2
20,178,178,10,4,6,3,2
7,182,182,24,24,0,1,0
17,214,214,7,3,4,2,1
6,228,228,1,1,0,1,0
18,243,243,2,2,0,1,0
12,268,268,31,10,21,2,1
16,274,274,35,5,30,2,1
19,277,277,22,22,0,1,0
11,298,298,32,12,20,2,1
23,310,310,45,20,25,2,1
15,317,317,23,23,0,1,0
2,319,319,7,7,0,1,0
1,319,319,53,53,0,1,0
14,330,330,65,53,12,4,3
5,349,349,12,12,0,1,0
3,352,352,7,1,6,2,1
22,416,416,21,6,15,4,3
10,420,420,99,99,0,1,0
24,431,431,138,138,0,1,0
9,446,446,66,48,18,2,1
13,488,488,53,53,0,1,0

4,138,138,1,1,0,1,0
5,149,149,72,28,44,3,2
1,150,150,2,2,0,1,0
21,173,173,29,22,7,2,1
11,196,196,11,11,0,1,0
18,209,209,2,2,0,1,0
2,214,214,1,1,0,1,0
13,221,221,7,7,0,1,0
22,264,264,25,25,0,1,0
7,266,266,33,21,12,3,2
8,281,281,21,21,0,1,0
6,290,290,33,17,16,3,2
16,302,302,9,9,0,1,0
12,304,304,29,18,11,4,3
15,324,324,104,77,27,2,1
0,334,334,31,31,0,1,0
17,349,349,5,2,3,2,1
9,351,351,50,23,27,4,3
10,353,353,34,28,6,2,1
3,360,360,88,64,24,2,1
19,382,382,95,11,84,3,2
14,464,464,47,24,23,3,2
20,470,470,26,26,0,1,0

6,118,118,16,16,0,1,0
22,120,120,1,1,0,1,0
17,134,134,29,8,21,2,1
11,140,140,17,2,15,2,1
12,147,147,3,3,0,1,0
0,181,181,4,1,3,2,1
18,194,194,21,21,0,1,0
1,216,216,2,2,0,1,0
3,266,266,12,12,0,1,0
24,266,266,8,4,4,2,1
14,279,279,27,9,18,2,1
25,295,295,10,10,0,1,0
5,303,303,49,49,0,1,0
16,319,319,23,23,0,1,0
13,327,327,13,1,12,4,3
20,340,340,22,22,0,1,0
15,387,387,82,82,0,1,0
10,407,407,90,90,0,1,0
19,415,415,121,121,0,1,0
2,447,447,17,13,4,2,1
8,454,454,63,63,0,1,0
4,460,460,49,49,0,1,0
9,465,465,21,21,0,1,0
23,466,466,57,57,0,1,0
7,469,469,112,59,53,4,3
21,481,481,16,16,0,1,0

11,100,100,9,9,0,1,0
20,104,104,11,6,5,2,1
22,107,107,6,6,0,1,0
21,135,135,10,10,0,1,0
12,140,140,19,13,6,2,1
10,161,161,2,2,0,1,0
16,164,164,34,34,0,1,0
13,172,172,15,15,0,1,0
17,208,208,22,22,0,1,0
14,219,219,11,3,8,2,1
15,243,243,26,26,0,1,0
3,246,246,46,30,16,3,2
23,246,246,2,2,0,1,0
7,261,261,1,1,0,1,0
2,265,265,35,35,0,1,0
24,274,274,19,9,10,3,2
0,313,313,129,84,45,2,1
5,321,321,18,18,0,1,0
26,326,326,9,9,0,1,0
18,361,361,93,93,0,1,0
9,381,381,8,8,0,1,0
6,398,398,7,3,4,2,1
25,399,399,63,63,0,1,0
4,440,440,21,21,0,1,0
1,477,477,46,46,0,1,0
8,482,482,1,1,0,1,0
19,487,487,49,49,0,1,0

9,125,125,9,9,0,1,0
13,134,134,4,4,0,1,0
12,145,145,16,16,0,1,0
27,147,147,20,20,0,1,0
11,177,177,3,3,0,1,0
24,185,185,55,21,34,3,2
7,203,203,3,3,0,1,0
3,206,206,4,4,0,1,0
4,211,211,38,1,37,3,2
6,222,222,1,1,0,1,0
5,239,239,9,9,0,1,0
2,241,241,2,2,0,1,0
19,242,242,57,57,0,1,0
1,248,248,49,22,27,3,2
17,268,268,2,2,0,1,0
14,288,288,66,66,0,1,0
25,293,293,11,11,0,1,0
26,299,299,14,4,10,2,1
21,354,354,34,34,0,1,0
22,366,366,28,28,0,1,0
23,413,413,102,36,66,3,2
10,415,415,61,43,18,4,3
8,420,420,22,22,0,1,0
16,436,436,32,32,0,1,0
0,455,455,82,70,12,2,1
20,477,477,3,3,0,1,0
18,490,490,3,3,0,1,0
15,499,499,29,29,0,1,0

25,128,128,9,9,0,1,0
4,137,137,16,16,0,1,0
11,151,151,6,6,0,1,0
14,172,172,1,1,0,1,0
6,178,178,22,22,0,1,0
20,182,182,9,1,8,3,2
30,186,186,6,6,0,1,0
31,187,187,30,24,6,2,1
7,189,189,5,5,0,1,0
5,203,203,5,5,0,1,0
8,205,205,7,7,0,1,0
21,214,214,16,16,0,1,0
2,233,233,14,14,0,1,0
12,244,244,22,4,18,2,1
26,255,255,7,4,3,2,1
28,259,259,56,17,39,4,3
22,261,261,50,5,45,2,1
18,275,275,17,5,12,3,2
0,315,315,13,6,7,2,1
13,320,320,22,22,0,1,0
3,325,325,118,118,0,1,0
10,342,342,9,9,0,1,0
1,349,349,4,4,0,1,0
24,375,375,110,38,72,4,3
19,380,380,9,9,0,1,0
16,410,410,48,48,0,1,0
9,434,434,21,8,13,4,3
15,447,447,1,1,0,1,0
29,466,466,37,3,34,3,2
17,467,467,18,18,0,1,0
23,487,487,15,15,0,1,0
27,498,498,38,27,11,2,1

18,117,117,2,2,0,1,0
19,142,142,11,5,6,3,2
17,186,186,1,1,0,1,0
5,191,191,4,4,0,1,0
6,195,195,4,4,0,1,0
12,211,211,2,2,0,1,0
0,213,213,134,107,27,4,3
11,224,224,27,27,0,1,0
16,226,226,1,1,0,1,0
10,237,237,13,7,6,2,1
21,246,246,111,78,33,3,2
4,266,266,1,1,0,1,0
13,282,282,21,15,6,3,2
1,287,287,26,26,0,1,0
8,306,306,23,23,0,1,0
23,344,344,15,15,0,1,0
3,376,376,34,3,31,2,1
9,390,390,17,1,16,4,3
7,403,403,54,54,0,1,0
20,438,438,4,4,0,1,0
14,447,447,107,107,0,1,0
2,473,473,65,65,0,1,0
22,486,486,11,11,0,1,0
15,498,498,124,94,30,4,3

0,100,100,1,1,0,1,0
5,140,140,13,13,0,1,0
15,142,142,8,8,0,1,0
20,150,150,26,12,14,2,1
11,172,172,1,1,0,1,0
21,200,200,13,1,12,2,1
19,221,221,36,36,0,1,0
3,229,229,27,27,0,1,0
8,230,230,1,1,0,1,0
17,240,240,34,34,0,1,0
16,252,252,48,16,32,2,1
9,335,335,23,7,16,3,2
7,353,353,25,25,0,1,0
23,361,361,45,45,0,1,0
2,388,388,23,11,12,2,1
12,393,393,19,8,11,2,1
18,407,407,16,3,13,2,1
1,419,419,204,204,0,1,0
10,428,428,11,11,0,1,0
6,431,431,148,138,10,2,1
13,461,461,26,26,0,1,0
22,463,463,38,4,34,3,2
14,490,490,89,89,0,1,0
4,495,495,10,6,4,2,1

25,136,136,21,21,0,1,0
12,154,154,8,8,0,1,0
10,164,164,2,2,0,1,0
14,179,179,29,3,26,3,2
5,199,199,27,6,21,4,3
23,215,215,20,3,17,2,1
3,220,220,63,63,0,1,0
2,224,224,22,1,21,4,3
7,226,226,12,1,11,2,1
20,227,227,1,1,0,1,0
9,238,238,1,1,0,1,0
17,254,254,66,42,24,3,2
8,262,262,38,14,24,2,1
18,265,265,5,2,3,2,1
11,283,283,31,8,23,2,1
4,305,305,9,6,3,2,1
0,314,314,58,58,0,1,0
22,327,327,15,15,0,1,0
21,328,328,35,12,23,2,1
13,330,330,58,49,9,2,1
1,377,377,46,26,20,2,1
15,379,379,31,16,15,4,3
19,403,403,50,8,42,2,1
16,441,441,19,19,0,1,0
6,480,480,34,34,0,1,0
24,490,490,23,23,0,1,0

1,104,104,6,6,0,1,0
12,120,120,1,1,0,1,0
23,121,121,18,13,5,2,1
10,133,133,27,27,0,1,0
20,159,159,22,10,12,4,3
18,162,162,4,4,0,1,0
13,182,182,33,33,0,1,0
19,213,213,30,11,19,2,1
4,223,223,12,5,7,2,1
14,256,256,36,36,0,1,0
7,276,276,25,25,0,1,0
5,283,283,3,3,0,1,0
24,321,321,1,1,0,1,0
0,324,324,41,8,33,2,1
2,330,330,89,17,72,3,2
22,334,334,38,13,25,3,2
6,339,339,8,3,5,2,1
15,349,349,46,46,0,1,0
17,364,364,15,6,9,4,3
11,376,376,65,33,32,3,2
8,384,384,25,9,16,2,1
9,396,396,1,1,0,1,0
16,479,479,50,28,22,3,2
21,486,486,78,54,24,3,2
3,498,498,112,80,32,3,2

0,108,108,20,9,11,2,1
21,115,115,25,25,0,1,0
7,123,123,1,1,0,1,0
18,138,138,3,3,0,1,0
6,149,149,2,2,0,1,0
9,154,154,9,3,6,3,2
30,155,155,43,31,12,4,3
28,167,167,19,19,0,1,0
29,188,188,11,5,6,2,1
10,189,189,3,3,0,1,0
24,203,203,3,3,0,1,0
19,220,220,11,2,9,2,1
26,232,232,47,47,0,1,0
16,235,235,5,5,0,1,0
5,235,235,28,28,0,1,0
11,275,275,1,1,0,1,0
15,279,279,40,40,0,1,0
2,319,319,8,3,5,2,1
8,321,321,7,7,0,1,0
25,361,361,10,6,4,2,1
4,362,362,28,12,16,2,1
14,363,363,12,12,0,1,0
12,371,371,60,34,26,3,2
27,372,372,7,7,0,1,0
17,373,373,8,8,0,1,0
13,410,410,9,9,0,1,0
20,415,415,119,53,66,4,3
23,441,441,15,15,0,1,0
1,442,442,13,3,10,3,2
22,457,457,6,1,5,2,1
3,460,460,157,56,101,4,3

20,105,105,5,5,0,1,0
11,127,127,2,2,0,1,0
26,139,139,3,3,0,1,0
16,165,165,1,1,0,1,0
4,220,220,9,9,0,1,0
24,249,249,36,24,12,3,2
5,254,254,4,4,0,1,0
6,263,263,43,22,21,4,3
8,276,276,13,1,12,2,1
18,293,293,22,16,6,2,1
2,296,296,4,1,3,2,1
17,297,297,92,41,51,4,3
25,313,313,59,59,0,1,0
10,345,345,66,66,0,1,0
9,362,362,103,43,60,3,2
1,365,365,14,9,5,2,1
0,367,367,32,32,0,1,0
22,381,381,97,64,33,4,3
12,391,391,5,2,3,2,1
19,410,410,3,3,0,1,0
7,430,430,8,8,0,1,0
23,438,438,41,41,0,1,0
13,443,443,154,154,0,1,0
3,445,445,11,8,3,2,1
15,462,462,15,15,0,1,0
14,472,472,29,7,22,2,1
21,474,474,39,7,32,4,3

1,106,106,3,3,0,1,0
11,106,106,13,13,0,1,0
10,124,124,21,4,17,2,1
14,142,142,17,13,4,2,1
7,143,143,3,3,0,1,0
13,182,182,21,14,7,2,1
8,229,229,15,15,0,1,0
12,236,236,2,2,0,1,0
20,272,272,8,2,6,2,1
9,290,290,3,3,0,1,0
18,299,299,103,103,0,1,0
28,306,306,51,51,0,1,0
19,340,340,44,44,0,1,0
23,343,343,7,7,0,1,0
27,343,343,58,17,41,2,1
26,365,365,10,10,0,1,0
21,379,379,54,34,20,2,1
25,384,384,20,20,0,1,0
16,407,407,33,33,0,1,0
4,426,426,49,49,0,1,0
15,440,440,132,42,90,4,3
6,443,443,11,11,0,1,0
5,448,448,14,3,11,3,2
0,450,450,46,46,0,1,0
2,465,465,11,11,0,1,0
24,496,496,21,9,12,2,1
3,496,496,21,21,0,1,0
22,497,497,35,35,0,1,0
17,497,497,20,8,12,4,3

1,126,126,21,21,0,1,0
16,140,140,11,5,6,3,2
13,157,157,3,3,0,1,0
11,184,184,67,67,0,1,0
14,207,207,30,30,0,1,0
8,231,231,21,9,12,4,3
19,235,235,11,11,0,1,0
4,238,238,20,5,15,2,1
17,262,262,1,1,0,1,0
3,292,292,32,18,14,2,1
7,315,315,46,46,0,1,0
20,320,320,30,5,25,2,1
0,351,351,79,22,57,4,3
15,363,363,10,1,9,4,3
6,369,369,11,11,0,1,0
18,385,385,24,24,0,1,0
12,393,393,36,36,0,1,0
10,406,406,65,7,58,4,3
9,413,413,59,47,12,3,2
2,453,453,84,55,29,3,2
5,480,480,170,114,56,4,3

6,115,115,15,15,0,1,0
1,116,116,9,1,8,3,2
7,122,122,1,1,0,1,0
10,138,138,4,4,0,1,0
14,142,142,16,6,10,3,2
9,157,157,13,13,0,1,0
3,167,167,1,1,0,1,0
18,194,194,4,1,3,2,1
5,197,197,4,4,0,1,0
21,205,205,29,29,0,1,0
15,225,225,3,3,0,1,0
19,245,245,61,49,12,2,1
11,253,253,3,3,0,1,0
23,259,259,35,5,30,2,1
20,271,271,4,4,0,1,0
25,288,288,8,8,0,1,0
0,305,305,99,64,35,2,1
16,312,312,3,3,0,1,0
2,325,325,28,28,0,1,0
12,347,347,112,76,36,4,3
26,352,352,53,53,0,1,0
17,366,366,40,40,0,1,0
27,443,443,121,40,81,4,3
22,453,453,62,62,0,1,0
24,458,458,18,18,0,1,0
8,471,471,4,4,0,1,0
13,474,474,23,4,19,2,1
4,479,479,18,18,0,1,0

4,112,112,8,8,0,1,0
19,139,139,26,26,0,1,0
17,220,220,25,16,9,4,3
21,226,226,34,14,20,3,2
11,242,242,42,19,23,2,1
3,246,246,71,71,0,1,0
16,339,339,20,8,12,3,2
15,369,369,59,59,0,1,0
22,372,372,4,4,0,1,0
5,378,378,12,12,0,1,0
20,378,378,3,3,0,1,0
12,384,384,29,29,0,1,0
9,389,389,23,9,14,4,3
7,391,391,180,129,51,4,3
2,394,394,11,11,0,1,0
6,399,399,16,16,0,1,0
14,417,417,9,3,6,2,1
10,440,440,24,20,4,2,1
23,459,459,7,7,0,1,0
1,462,462,7,7,0,1,0
8,469,469,103,103,0,1,0
18,473,473,6,6,0,1,0
13,474,474,160,160,0,1,0
0,492,492,16,16,0,1,0

17,104,104,8,8,0,1,0
25,122,122,16,16,0,1,0
11,124,124,7,7,0,1,0
9,135,135,10,10,0,1,0
19,189,189,5,2,3,2,1
22,208,208,42,7,35,2,1
6,214,214,7,7,0,1,0
0,215,215,37,37,0,1,0
8,218,218,13,4,9,4,3
27,229,229,68,68,0,1,0
4,231,231,1,1,0,1,0
26,234,234,45,17,28,2,1
21,240,240,8,4,4,2,1
23,247,247,8,2,6,3,2
10,267,267,82,82,0,1,0
3,269,269,23,14,9,2,1
5,273,273,28,20,8,3,2
1,306,306,2,2,0,1,0
2,315,315,1,1,0,1,0
18,338,338,12,5,7,2,1
12,340,340,4,4,0,1,0
16,352,352,47,47,0,1,0
20,357,357,13,1,12,2,1
24,379,379,26,26,0,1,0
14,418,418,38,10,28,2,1
15,444,444,27,27,0,1,0
13,449,449,123,92,31,2,1
7,470,470,10,10,0,1,0

16,113,113,1,1,0,1,0
21,122,122,22,22,0,1,0
22,131,131,6,1,5,2,1
20,163,163,5,5,0,1,0
15,174,174,7,7,0,1,0
23,184,184,6,1,5,2,1
12,190,190,1,1,0,1,0
4,211,211,30,8,22,3,2
3,221,221,20,3,17,3,2
18,247,247,40,19,21,2,1
6,258,258,1,1,0,1,0
8,264,264,2,2,0,1,0
2,271,271,5,5,0,1,0
0,275,275,9,9,0,1,0
19,299,299,24,12,12,2,1
26,309,309,3,3,0,1,0
5,313,313,18,14,4,2,1
1,326,326,35,5,30,4,3
7,331,331,54,54,0,1,0
9,363,363,12,12,0,1,0
25,366,366,52,8,44,3,2
30,383,383,15,6,9,4,3
27,412,412,68,29,39,2,1
17,416,416,37,9,28,2,1
28,421,421,110,41,69,4,3
29,444,444,49,49,0,1,0
10,450,450,34,9,25,2,1
13,467,467,91,65,26,2,1
11,468,468,1,1,0,1,0
31,486,486,38,22,16,2,1
24,497,497,78,78,0,1,0
14,499,499,34,16,18,2,1

16,103,103,26,22,4,2,1
21,116,116,5,1,4,2,1
4,131,131,3,3,0,1,0
30,136,136,18,18,0,1,0
28,158,158,4,4,0,1,0
14,163,163,10,6,4,2,1
3,179,179,6,6,0,1,0
24,195,195,7,1,6,2,1
23,212,212,15,15,0,1,0
25,224,224,10,1,9,2,1
26,259,259,69,69,0,1,0
15,289,289,15,15,0,1,0
2,301,301,77,20,57,4,3
19,317,317,18,4,14,3,2
6,326,326,24,6,18,4,3
7,340,340,37,27,10,3,2
11,341,341,13,13,0,1,0
17,355,355,1,1,0,1,0
10,357,357,55,55,0,1,0
13,391,391,4,1,3,2,1
20,407,407,25,25,0,1,0
27,413,413,3,3,0,1,0
8,441,441,22,22,0,1,0
22,443,443,16,10,6,2,1
29,453,453,165,165,0,1,0
12,455,455,12,12,0,1,0
18,462,462,86,86,0,1,0
1,485,485,15,8,7,2,1
9,490,490,7,7,0,1,0
0,492,492,39,15,24,2,1
5,492,492,17,17,0,1,0

22,100,100,1,1,0,1,0
21,112,112,11,11,0,1,0
19,134,134,9,6,3,2,1
7,134,134,3,3,0,1,0
13,142,142,8,8,0,1,0
20,178,178,6,6,0,1,0
17,210,210,15,2,13,2,1
8,210,210,27,7,20,3,2
9,222,222,21,7,14,3,2
15,230,230,28,28,0,1,0
14,269,269,60,13,47,2,1
18,269,269,25,25,0,1,0
6,276,276,80,71,9,4,3
2,279,279,14,14,0,1,0
11,280,280,15,15,0,1,0
5,287,287,59,7,52,3,2
10,330,330,67,33,34,3,2
4,335,335,7,2,5,2,1
3,344,344,10,10,0,1,0
16,393,393,88,81,7,2,1
23,407,407,34,34,0,1,0
12,462,462,90,3,87,4,3
0,482,482,42,18,24,4,3
1,486,486,82,82,0,1,0

29,106,106,29,29,0,1,0
4,133,133,7,7,0,1,0
12,151,151,14,14,0,1,0
8,152,152,1,1,0,1,0
18,153,153,29,1,28,4,3
6,191,191,1,1,0,1,0
5,194,194,26,26,0,1,0
0,215,215,36,36,0,1,0
10,233,233,25,19,6,2,1
20,240,240,62,38,24,4,3
15,253,253,25,25,0,1,0
17,268,268,5,5,0,1,0
24,272,272,2,2,0,1,0
21,273,273,19,4,15,2,1
13,286,286,4,4,0,1,0
2,293,293,33,28,5,2,1
28,317,317,10,2,8,2,1
22,324,324,11,8,3,2,1
31,326,326,101,101,0,1,0
30,337,337,12,12,0,1,0
19,369,369,29,29,0,1,0
1,410,410,14,14,0,1,0
16,424,424,29,2,27,4,3
11,425,425,6,1,5,2,1
7,430,430,36,18,18,3,2
25,431,431,16,16,0,1,0
14,462,462,5,5,0,1,0
27,468,468,37,26,11,2,1
23,480,480,21,21,0,1,0
26,482,482,31,31,0,1,0
3,490,490,21,3,18,2,1
9,494,494,26,10,16,2,1

11,114,114,5,2,3,2,1
8,133,133,1,1,0,1,0
1,134,134,7,1,6,2,1
22,142,142,37,37,0,1,0
20,142,142,11,2,9,2,1
2,145,145,25,16,9,4,3
18,163,163,15,15,0,1,0
0,198,198,4,4,0,1,0
14,210,210,3,3,0,1,0
4,215,215,27,20,7,2,1
24,223,223,13,2,11,2,1
12,234,234,13,13,0,1,0
6,249,249,2,2,0,1,0
3,255,255,5,5,0,1,0
10,288,288,5,2,3,2,1
27,294,294,17,12,5,2,1
15,300,300,15,15,0,1,0
19,323,323,36,13,23,2,1
7,336,336,5,5,0,1,0
9,353,353,47,47,0,1,0
28,359,359,8,4,4,2,1
16,364,364,16,16,0,1,0
21,365,365,57,30,27,4,3
30,373,373,7,7,0,1,0
29,376,376,28,28,0,1,0
25,417,417,74,23,51,4,3
26,421,421,34,4,30,4,3
17,423,423,54,22,32,2,1
13,471,471,183,183,0,1,0
5,482,482,3,3,0,1,0
23,495,495,66,36,30,4,3

31,115,115,5,5,0,1,0
11,115,115,4,4,0,1,0
12,117,117,5,2,3,2,1
33,121,121,24,19,5,2,1
30,136,136,14,1,13,2,1
8,147,147,7,7,0,1,0
23,155,155,10,10,0,1,0
4,188,188,1,1,0,1,0
21,196,196,14,14,0,1,0
20,202,202,64,13,51,4,3
7,206,206,5,5,0,1,0
27,218,218,6,2,4,2,1
29,221,221,17,17,0,1,0
10,255,255,21,21,0,1,0
18,282,282,13,13,0,1,0
13,286,286,2,2,0,1,0
24,306,306,97,31,66,4,3
28,311,311,4,1,3,2,1
15,318,318,83,39,44,3,2
0,320,320,9,9,0,1,0
2,321,321,5,5,0,1,0
16,325,325,1,1,0,1,0
26,328,328,31,31,0,1,0
6,353,353,2,2,0,1,0
34,370,370,62,62,0,1,0
14,373,373,17,17,0,1,0
1,377,377,32,25,7,2,1
22,383,383,2,2,0,1,0
25,389,389,25,25,0,1,0
9,397,397,23,8,15,2,1
5,406,406,7,7,0,1,0
3,418,418,14,11,3,2,1
32,425,425,64,64,0,1,0
19,460,460,1,1,0,1,0
17,478,478,32,32,0,1,0

9,101,101,1,1,0,1,0
8,127,127,2,2,0,1,0
7,137,137,3,3,0,1,0
23,173,173,20,20,0,1,0
17,174,174,24,24,0,1,0
2,185,185,13,13,0,1,0
22,185,185,5,5,0,1,0
12,193,193,12,1,11,2,1
1,206,206,38,38,0,1,0
16,211,211,58,58,0,1,0
21,226,226,17,17,0,1,0
25,233,233,4,4,0,1,0
26,243,243,17,17,0,1,0
13,249,249,24,19,5,2,1
18,250,250,32,16,16,3,2
4,271,271,1,1,0,1,0
10,291,291,67,67,0,1,0
28,294,294,2,2,0,1,0
14,311,311,17,1,16,3,2
19,334,334,14,14,0,1,0
11,363,363,19,19,0,1,0
15,381,381,8,2,6,3,2
6,403,403,79,79,0,1,0
27,409,409,84,84,0,1,0
20,412,412,42,28,14,2,1
0,419,419,40,40,0,1,0
24,430,430,54,17,37,4,3
5,443,443,52,52,0,1,0
3,480,480,33,8,25,2,1

22,105,105,27,14,13,2,1
13,111,111,9,9,0,1,0
23,118,118,10,3,7,2,1
4,128,128,5,5,0,1,0
0,136,136,1,1,0,1,0
16,143,143,10,6,4,2,1
24,153,153,3,3,0,1,0
8,187,187,10,2,8,3,2
3,212,212,3,3,0,1,0
17,244,244,9,4,5,2,1
15,246,246,70,6,64,3,2
10,252,252,58,58,0,1,0
20,262,262,1,1,0,1,0
6,271,271,6,6,0,1,0
14,275,275,34,10,24,3,2
25,278,278,8,8,0,1,0
27,289,289,34,10,24,4,3
26,290,290,38,38,0,1,0
1,360,360,7,7,0,1,0
2,390,390,10,1,9,2,1
21,391,391,35,35,0,1,0
12,403,403,7,7,0,1,0
11,433,433,100,100,0,1,0
9,437,437,104,13,91,4,3
7,449,449,87,20,67,4,3
18,481,481,37,37,0,1,0
5,485,485,2,2,0,1,0
19,485,485,57,11,46,3,2

3,109,109,1,1,0,1,0
26,139,139,2,2,0,1,0
2,154,154,36,36,0,1,0
11,174,174,27,27,0,1,0
15,188,188,4,4,0,1,0
8,190,190,14,14,0,1,0
0,195,195,7,7,0,1,0
20,203,203,55,16,39,2,1
30,204,204,25,1,24,4,3
13,215,215,18,18,0,1,0
18,238,238,19,19,0,1,0
24,241,241,27,21,6,2,1
28,250,250,11,3,8,2,1
9,275,275,15,5,10,2,1
27,275,275,7,7,0,1,0
12,286,286,4,1,3,2,1
17,293,293,6,6,0,1,0
31,311,311,54,26,28,3,2
14,333,333,41,41,0,1,0
21,341,341,25,4,21,4,3
25,367,367,24,11,13,2,1
16,367,367,8,8,0,1,0
5,373,373,11,1,10,3,2
19,378,378,140,64,76,4,3
10,388,388,15,15,0,1,0
22,403,403,5,5,0,1,0
23,429,429,16,10,6,2,1
1,435,435,10,10,0,1,0
29,444,444,1,1,0,1,0
6,446,446,67,67,0,1,0
4,460,460,30,8,22,3,2
7,495,495,35,35,0,1,0

13,102,102,19,5,14,2,1
21,103,103,4,4,0,1,0
6,109,109,1,1,0,1,0
22,122,122,11,11,0,1,0
4,137,137,6,1,5,2,1
5,154,154,28,28,0,1,0
16,172,172,30,20,10,3,2
20,219,219,4,4,0,1,0
19,219,219,34,34,0,1,0
18,239,239,20,20,0,1,0
11,243,243,39,39,0,1,0
0,250,250,85,11,74,3,2
10,267,267,9,9,0,1,0
24,269,269,29,19,10,2,1
23,294,294,24,16,8,2,1
3,301,301,1,1,0,1,0
7,325,325,15,12,3,2,1
1,332,332,15,15,0,1,0
12,376,376,86,86,0,1,0
17,380,380,22,22,0,1,0
9,418,418,16,10,6,3,2
14,421,421,18,18,0,1,0
8,453,453,12,5,7,2,1
15,465,465,29,5,24,2,1
2,478,478,179,167,12,4,3

25,103,103,5,5,0,1,0
19,123,123,3,3,0,1,0
3,136,136,46,38,8,2,1
17,137,137,2,2,0,1,0
12,172,172,8,2,6,3,2
16,173,173,41,41,0,1,0
13,182,182,4,4,0,1,0
2,185,185,5,5,0,1,0
20,205,205,31,31,0,1,0
11,208,208,4,1,3,2,1
1,251,251,102,102,0,1,0
21,269,269,4,4,0,1,0
10,272,272,27,27,0,1,0
18,280,280,16,16,0,1,0
22,285,285,50,4,46,3,2
15,288,288,18,11,7,2,1
9,300,300,34,34,0,1,0
4,302,302,5,5,0,1,0
6,358,358,12,12,0,1,0
7,376,376,5,5,0,1,0
0,396,396,30,12,18,2,1
23,417,417,10,10,0,1,0
24,430,430,183,150,33,4,3
14,475,475,37,37,0,1,0
5,481,481,12,12,0,1,0
8,482,482,43,43,0,1,0

25,122,122,2,2,0,1,0
26,149,149,20,20,0,1,0
17,152,152,21,6,15,4,3
19,162,162,5,2,3,2,1
14,165,165,54,49,5,2,1
0,193,193,24,24,0,1,0
3,209,209,9,9,0,1,0
20,225,225,17,17,0,1,0
23,234,234,2,2,0,1,0
18,235,235,11,11,0,1,0
15,239,239,27,4,23,2,1
16,266,266,8,8,0,1,0
7,273,273,21,14,7,2,1
6,301,301,8,8,0,1,0
5,314,314,24,17,7,2,1
12,345,345,6,6,0,1,0
21,396,396,48,48,0,1,0
1,402,402,7,4,3,2,1
9,412,412,5,5,0,1,0
8,435,435,59,14,45,4,3
11,438,438,228,209,19,2,1
22,449,449,28,28,0,1,0
2,458,458,1,1,0,1,0
13,465,465,31,11,20,2,1
10,484,484,28,9,19,2,1
4,489,489,61,61,0,1,0
24,497,497,111,11,100,4,3

22,118,118,6,6,0,1,0
0,168,168,3,3,0,1,0
4,217,217,28,28,0,1,0
3,219,219,23,16,7,2,1
9,229,229,4,4,0,1,0
23,243,243,25,13,12,4,3
17,244,244,25,22,3,2,1
5,262,262,10,1,9,2,1
6,267,267,7,7,0,1,0
11,310,310,18,2,16,2,1
20,356,356,44,30,14,2,1
2,374,374,135,135,0,1,0
13,375,375,29,18,11,2,1
1,388,388,47,31,16,3,2
16,391,391,68,30,38,3,2
19,411,411,130,130,0,1,0
10,414,414,69,21,48,4,3
12,444,444,44,38,6,2,1
18,444,444,20,8,12,4,3
7,458,458,118,97,21,4,3
8,469,469,29,15,14,2,1
21,476,476,25,14,11,2,1
15,485,485,16,8,8,2,1
14,491,491,43,9,34,2,1

8,100,100,1,1,0,1,0
18,105,105,1,1,0,1,0
11,113,113,18,18,0,1,0
24,120,120,5,5,0,1,0
26,164,164,22,3,19,2,1
7,170,170,21,21,0,1,0
14,178,178,6,6,0,1,0
20,216,216,19,6,13,2,1
23,266,266,7,7,0,1,0
0,271,271,26,18,8,3,2
6,276,276,3,3,0,1,0
9,279,279,18,15,3,2,1
15,286,286,52,52,0,1,0
21,295,295,39,39,0,1,0
1,340,340,7,7,0,1,0
3,344,344,15,15,0,1,0
28,345,345,91,91,0,1,0
29,355,355,38,32,6,3,2
19,359,359,42,42,0,1,0
5,377,377,34,34,0,1,0
12,388,388,40,40,0,1,0
16,423,423,10,4,6,3,2
17,436,436,24,24,0,1,0
13,444,444,36,36,0,1,0
27,448,448,47,20,27,4,3
31,454,454,16,16,0,1,0
10,463,463,22,2,20,3,2
22,477,477,51,15,36,3,2
25,487,487,10,10,0,1,0
30,488,488,70,11,59,4,3
4,490,490,56,42,14,2,1
2,491,491,16,16,0,1,0

25,118,118,20,16,4,2,1
19,132,132,4,4,0,1,0
10,144,144,4,4,0,1,0
7,173,173,4,4,0,1,0
21,189,189,39,33,6,2,1
28,191,191,13,4,9,2,1
4,195,195,5,5,0,1,0
16,209,209,20,5,15,3,2
18,226,226,2,2,0,1,0
29,228,228,6,6,0,1,0
23,253,253,56,56,0,1,0
1,256,256,23,3,20,4,3
3,258,258,14,14,0,1,0
22,289,289,31,31,0,1,0
13,304,304,9,9,0,1,0
20,313,313,79,28,51,4,3
15,317,317,12,2,10,3,2
6,341,341,2,2,0,1,0
17,362,362,2,2,0,1,0
0,386,386,50,9,41,2,1
14,405,405,49,49,0,1,0
8,408,408,124,35,89,3,2
27,433,433,12,12,0,1,0
11,446,446,51,27,24,4,3
5,449,449,78,78,0,1,0
24,468,468,27,27,0,1,0
2,483,483,16,16,0,1,0
9,483,483,7,7,0,1,0
12,486,486,11,11,0,1,0
26,495,495,70,22,48,3,2

22,107,107,25,25,0,1,0
15,119,119,4,4,0,1,0
16,135,135,52,2,50,2,1
4,145,145,6,6,0,1,0
14,167,167,13,6,7,2,1
6,177,177,72,9,63,4,3
7,192,192,4,1,3,2,1
3,229,229,16,4,12,4,3
0,237,237,56,32,24,4,3
20,280,280,7,2,5,2,1
5,305,305,64,64,0,1,0
21,311,311,5,1,4,2,1
1,312,312,5,2,3,2,1
11,351,351,46,46,0,1,0
19,353,353,73,73,0,1,0
10,354,354,13,13,0,1,0
23,376,376,17,17,0,1,0
18,377,377,3,3,0,1,0
17,396,396,2,2,0,1,0
8,397,397,35,35,0,1,0
13,398,398,57,57,0,1,0
9,436,436,35,23,12,4,3
2,475,475,45,45,0,1,0
12,479,479,4,4,0,1,0

24,153,153,8,8,0,1,0
19,186,186,8,8,0,1,0
5,206,206,3,3,0,1,0
14,209,209,14,8,6,2,1
15,228,228,12,12,0,1,0
23,236,236,39,9,30,3,2
4,237,237,4,4,0,1,0
18,241,241,2,2,0,1,0
16,242,242,28,28,0,1,0
3,287,287,91,57,34,3,2
1,290,290,69,42,27,4,3
6,305,305,6,6,0,1,0
17,324,324,9,1,8,3,2
7,330,330,75,57,18,2,1
21,341,341,116,37,79,4,3
13,346,346,29,9,20,2,1
9,357,357,3,3,0,1,0
12,361,361,10,5,5,2,1
22,371,371,93,58,35,2,1
10,401,401,11,11,0,1,0
11,409,409,61,61,0,1,0
8,410,410,21,21,0,1,0
0,425,425,37,31,6,2,1
20,448,448,42,42,0,1,0
2,467,467,68,18,50,3,2

20,126,126,8,1,7,2,1
19,142,142,5,5,0,1,0
10,150,150,32,5,27,4,3
13,213,213,1,1,0,1,0
8,219,219,15,15,0,1,0
0,277,277,9,1,8,2,1
2,277,277,83,38,45,4,3
7,282,282,39,39,0,1,0
24,294,294,3,3,0,1,0
16,304,304,22,10,12,4,3
6,316,316,14,14,0,1,0
18,322,322,2,2,0,1,0
15,326,326,83,65,18,4,3
1,338,338,35,7,28,3,2
23,350,350,40,26,14,3,2
11,367,367,59,59,0,1,0
22,373,373,36,36,0,1,0
12,381,381,38,27,11,2,1
3,384,384,21,21,0,1,0
9,399,399,2,2,0,1,0
4,407,407,6,6,0,1,0
17,448,448,97,83,14,2,1
21,448,448,75,75,0,1,0
14,472,472,88,52,36,4,3
5,477,477,79,61,18,2,1

16,153,153,13,13,0,1,0
18,164,164,23,23,0,1,0
22,167,167,12,12,0,1,0
3,177,177,17,11,6,3,2
0,182,182,8,8,0,1,0
5,183,183,11,11,0,1,0
8,194,194,7,7,0,1,0
11,197,197,1,1,0,1,0
4,237,237,22,6,16,2,1
13,265,265,30,14,16,2,1
7,265,265,46,46,0,1,0
15,275,275,30,21,9,2,1
25,283,283,27,17,10,3,2
1,302,302,41,1,40,3,2
14,310,310,3,3,0,1,0
24,334,334,38,38,0,1,0
12,366,366,4,4,0,1,0
10,375,375,47,16,31,4,3
6,396,396,53,53,0,1,0
9,411,411,133,94,39,4,3
2,417,417,27,3,24,3,2
23,440,440,32,32,0,1,0
19,446,446,116,46,70,4,3
20,458,458,44,11,33,4,3
21,475,475,6,6,0,1,0
17,498,498,72,72,0,1,0

11,118,118,1,1,0,1,0
8,120,120,9,9,0,1,0
18,135,135,8,5,3,2,1
15,142,142,6,6,0,1,0
21,161,161,8,8,0,1,0
23,185,185,12,12,0,1,0
10,219,219,15,6,9,2,1
6,233,233,9,3,6,2,1
12,263,263,15,15,0,1,0
20,301,301,26,17,9,2,1
1,311,311,9,3,6,3,2
14,314,314,91,22,69,4,3
17,336,336,36,36,0,1,0
4,354,354,2,2,0,1,0
24,356,356,17,17,0,1,0
22,359,359,7,7,0,1,0
13,382,382,41,41,0,1,0
2,386,386,4,4,0,1,0
7,404,404,22,1,21,2,1
5,420,420,76,76,0,1,0
16,421,421,205,160,45,4,3
19,454,454,11,11,0,1,0
0,456,456,30,17,13,4,3
26,460,460,5,5,0,1,0
9,461,461,31,31,0,1,0
3,461,461,112,66,46,4,3
27,470,470,122,59,63,4,3
25,471,471,28,28,0,1,0

19,108,108,6,6,0,1,0
15,128,128,15,15,0,1,0
10,215,215,1,1,0,1,0
5,268,268,70,70,0,1,0
6,293,293,4,4,0,1,0
17,332,332,7,4,3,2,1
2,334,334,76,6,70,3,2
1,337,337,88,84,4,2,1
8,343,343,28,28,0,1,0
7,350,350,18,18,0,1,0
14,352,352,17,2,15,2,1
11,357,357,4,4,0,1,0
13,369,369,183,33,150,4,3
0,422,422,36,5,31,2,1
16,438,438,75,49,26,4,3
3,453,453,47,47,0,1,0
12,457,457,53,53,0,1,0
9,469,469,13,6,7,2,1
18,476,476,58,34,24,4,3
4,494,494,172,123,49,2,1

21,102,102,19,19,0,1,0
0,107,107,5,5,0,1,0
11,127,127,12,4,8,3,2
19,144,144,4,4,0,1,0
4,145,145,2,2,0,1,0
8,220,220,23,23,0,1,0
13,225,225,13,7,6,3,2
24,233,233,60,60,0,1,0
1,240,240,7,1,6,3,2
16,241,241,4,4,0,1,0
14,252,252,20,20,0,1,0
27,263,263,18,18,0,1,0
17,268,268,34,3,31,4,3
23,274,274,7,7,0,1,0
26,281,281,1,1,0,1,0
18,293,293,18,9,9,4,3
6,301,301,28,28,0,1,0
10,314,314,1,1,0,1,0
7,322,322,10,10,0,1,0
22,325,325,30,21,9,4,3
9,332,332,8,8,0,1,0
25,376,376,33,22,11,2,1
29,389,389,106,106,0,1,0
28,399,399,41,41,0,1,0
20,406,406,6,6,0,1,0
3,418,418,27,27,0,1,0
15,430,430,16,6,10,3,2
12,464,464,2,2,0,1,0
2,492,492,82,15,67,4,3
5,496,496,215,203,12,4,3

15,100,100,3,3,0,1,0
17,160,160,14,9,5,2,1
22,167,167,16,11,5,2,1
18,202,202,37,37,0,1,0
8,217,217,15,9,6,3,2
5,218,218,22,2,20,4,3
14,229,229,8,8,0,1,0
19,239,239,15,5,10,3,2
3,245,245,48,48,0,1,0
21,265,265,11,7,4,2,1
0,285,285,115,41,74,4,3
13,304,304,35,15,20,2,1
20,312,312,90,14,76,3,2
6,317,317,58,58,0,1,0
7,332,332,32,10,22,3,2
11,353,353,59,59,0,1,0
9,378,378,31,25,6,2,1
1,399,399,30,3,27,2,1
12,406,406,64,46,18,4,3
16,406,406,22,18,4,2,1
2,428,428,20,20,0,1,0
10,456,456,6,6,0,1,0
4,457,457,22,10,12,3,2

8,100,100,4,4,0,1,0
21,112,112,2,2,0,1,0
28,119,119,47,2,45,2,1
15,123,123,22,4,18,3,2
9,125,125,2,2,0,1,0
20,149,149,10,1,9,4,3
12,154,154,1,1,0,1,0
25,162,162,9,9,0,1,0
23,185,185,18,6,12,3,2
2,247,247,3,3,0,1,0
5,253,253,5,2,3,2,1
7,283,283,1,1,0,1,0
3,290,290,6,6,0,1,0
27,291,291,14,7,7,2,1
1,357,357,84,32,52,4,3
11,358,358,162,118,44,2,1
0,360,360,43,43,0,1,0
4,370,370,8,8,0,1,0
6,370,370,1,1,0,1,0
26,406,406,21,21,0,1,0
19,426,426,73,44,29,2,1
14,427,427,3,3,0,1,0
18,441,441,11,3,8,3,2
17,457,457,45,23,22,2,1
13,464,464,48,41,7,2,1
22,466,466,18,18,0,1,0
10,466,466,30,18,12,4,3
16,469,469,8,8,0,1,0
24,484,484,119,28,91,4,3

15,122,122,21,6,15,2,1
21,129,129,33,33,0,1,0
18,144,144,55,55,0,1,0
7,165,165,7,7,0,1,0
1,173,173,6,6,0,1,0
20,173,173,2,2,0,1,0
11,195,195,11,11,0,1,0
12,197,197,1,1,0,1,0
4,208,208,42,30,12,4,3
2,240,240,63,63,0,1,0
5,265,265,24,9,15,4,3
16,280,280,24,15,9,4,3
14,300,300,52,16,36,2,1
22,328,328,4,4,0,1,0
25,331,331,19,12,7,2,1
6,387,387,9,1,8,3,2
17,392,392,9,9,0,1,0
0,402,402,114,63,51,4,3
9,406,406,2,2,0,1,0
10,423,423,24,2,22,3,2
26,426,426,24,10,14,3,2
27,431,431,9,1,8,2,1
8,473,473,5,5,0,1,0
3,473,473,10,10,0,1,0
13,476,476,16,9,7,2,1
24,479,479,46,46,0,1,0
23,486,486,64,54,10,2,1
19,500,500,9,9,0,1,0

16,114,114,21,9,12,3,2
1,131,131,2,2,0,1,0
6,134,134,1,1,0,1,0
13,143,143,15,15,0,1,0
18,161,161,7,7,0,1,0
19,183,183,3,3,0,1,0
14,198,198,42,27,15,2,1
10,204,204,8,8,0,1,0
3,206,206,6,1,5,2,1
4,211,211,8,8,0,1,0
17,214,214,10,3,7,2,1
20,243,243,67,67,0,1,0
0,265,265,24,24,0,1,0
27,292,292,6,6,0,1,0
15,296,296,4,4,0,1,0
25,307,307,27,8,19,2,1
8,320,320,1,1,0,1,0
2,343,343,15,7,8,3,2
21,346,346,48,3,45,2,1
11,349,349,129,121,8,2,1
12,391,391,3,3,0,1,0
9,392,392,63,40,23,2,1
24,439,439,112,112,0,1,0
7,444,444,30,30,0,1,0
22,449,449,4,1,3,2,1
23,476,476,65,42,23,4,3
5,484,484,55,15,40,3,2
26,498,498,47,15,32,2,1

16,106,106,17,5,12,3,2
26,115,115,11,11,0,1,0
17,124,124,8,8,0,1,0
4,139,139,6,6,0,1,0
20,161,161,9,9,0,1,0
7,162,162,16,16,0,1,0
2,181,181,4,4,0,1,0
23,203,203,1,1,0,1,0
10,207,207,21,21,0,1,0
15,208,208,1,1,0,1,0
9,209,209,10,5,5,2,1
19,219,219,34,34,0,1,0
22,231,231,40,4,36,2,1
24,264,264,31,31,0,1,0
6,266,266,40,40,0,1,0
25,266,266,54,54,0,1,0
12,302,302,19,4,15,4,3
21,309,309,21,3,18,4,3
1,318,318,7,7,0,1,0
18,323,323,56,14,42,4,3
11,330,330,110,95,15,4,3
14,334,334,23,23,0,1,0
0,335,335,46,46,0,1,0
5,338,338,43,7,36,3,2
13,420,420,40,40,0,1,0
3,438,438,5,1,4,2,1
8,466,466,22,10,12,4,3

30,101,101,12,12,0,1,0
32,128,128,29,13,16,3,2
16,132,132,3,3,0,1,0
29,134,134,3,3,0,1,0
17,140,140,3,3,0,1,0
3,143,143,1,1,0,1,0
23,164,164,24,19,5,2,1
5,175,175,1,1,0,1,0
20,193,193,1,1,0,1,0
9,200,200,3,3,0,1,0
1,213,213,13,4,9,4,3
6,215,215,22,10,12,2,1
2,243,243,1,1,0,1,0
27,246,246,2,2,0,1,0
4,257,257,1,1,0,1,0
14,273,273,2,2,0,1,0
0,280,280,27,5,22,3,2
10,295,295,18,18,0,1,0
18,313,313,51,12,39,4,3
13,343,343,2,2,0,1,0
25,350,350,92,58,34,2,1
7,367,367,94,94,0,1,0
26,382,382,17,5,12,2,1
22,383,383,30,13,17,2,1
12,406,406,12,12,0,1,0
8,424,424,8,8,0,1,0
31,426,426,32,26,6,2,1
24,443,443,90,90,0,1,0
11,445,445,157,115,42,4,3
19,467,467,23,23,0,1,0
21,477,477,8,8,0,1,0
28,478,478,58,19,39,3,2
15,496,496,9,9,0,1,0

2,107,107,31,16,15,2,1
18,119,119,17,8,9,4,3
11,125,125,1,1,0,1,0
3,138,138,22,12,10,4,3
17,155,155,37,4,33,4,3
14,167,167,17,4,13,2,1
16,181,181,22,22,0,1,0
10,212,212,12,12,0,1,0
4,220,220,33,12,21,4,3
13,226,226,26,26,0,1,0
6,274,274,49,22,27,4,3
19,280,280,28,28,0,1,0
9,310,310,19,19,0,1,0
20,327,327,12,6,6,2,1
12,369,369,21,2,19,2,1
0,404,404,81,38,43,2,1
8,409,409,18,18,0,1,0
5,429,429,12,12,0,1,0
15,450,450,109,109,0,1,0
7,485,485,73,31,42,2,1
1,499,499,72,66,6,2,1

14,110,110,1,1,0,1,0
25,115,115,5,5,0,1,0
23,154,154,18,6,12,2,1
11,161,161,26,26,0,1,0
27,169,169,34,34,0,1,0
0,214,214,3,3,0,1,0
7,224,224,13,13,0,1,0
24,225,225,8,8,0,1,0
21,232,232,31,4,27,4,3
29,266,266,3,3,0,1,0
8,273,273,33,15,18,2,1
5,293,293,32,32,0,1,0
30,295,295,19,19,0,1,0
28,321,321,28,6,22,3,2
20,343,343,21,21,0,1,0
33,349,349,69,6,63,4,3
19,374,374,8,8,0,1,0
2,389,389,46,25,21,2,1
9,395,395,20,2,18,2,1
15,399,399,41,41,0,1,0
26,405,405,10,1,9,4,3
13,406,406,1,1,0,1,0
1,407,407,35,13,22,3,2
32,411,411,17,17,0,1,0
31,420,420,81,81,0,1,0
4,427,427,10,10,0,1,0
18,430,430,3,3,0,1,0
22,430,430,77,45,32,3,2
12,440,440,1,1,0,1,0
10,445,445,43,43,0,1,0
17,458,458,35,19,16,2,1
3,462,462,4,4,0,1,0
16,470,470,64,64,0,1,0
6,470,470,17,12,5,2,1

13,146,146,20,20,0,1,0
8,197,197,4,4,0,1,0
21,209,209,49,49,0,1,0
1,213,213,19,11,8,3,2
3,241,241,11,11,0,1,0
2,256,256,6,2,4,2,1
5,263,263,10,1,9,4,3
15,264,264,2,2,0,1,0
4,271,271,38,14,24,4,3
16,275,275,8,8,0,1,0
22,316,316,8,3,5,2,1
18,348,348,58,19,39,3,2
20,379,379,6,6,0,1,0
19,384,384,9,9,0,1,0
14,388,388,74,74,0,1,0
17,390,390,92,70,22,3,2
11,394,394,6,6,0,1,0
23,399,399,36,19,17,2,1
10,415,415,235,155,80,4,3
0,442,442,15,15,0,1,0
9,451,451,106,106,0,1,0
6,454,454,15,15,0,1,0
7,479,479,37,37,0,1,0
12,490,490,73,73,0,1,0

12,152,152,37,37,0,1,0
9,161,161,2,2,0,1,0
14,162,162,12,12,0,1,0
5,165,165,6,6,0,1,0
17,183,183,11,11,0,1,0
16,190,190,5,5,0,1,0
19,208,208,1,1,0,1,0
8,261,261,13,13,0,1,0
18,261,261,71,71,0,1,0
7,267,267,17,17,0,1,0
15,284,284,26,8,18,3,2
2,301,301,129,43,86,3,2
6,324,324,95,95,0,1,0
1,340,340,22,6,16,3,2
4,344,344,68,12,56,3,2
3,353,353,8,8,0,1,0
10,409,409,28,28,0,1,0
20,429,429,119,119,0,1,0
0,433,433,84,36,48,2,1
13,450,450,39,39,0,1,0
11,468,468,31,31,0,1,0

17,104,104,17,7,10,2,1
8,110,110,1,1,0,1,0
10,122,122,5,1,4,2,1
21,129,129,11,6,5,2,1
3,161,161,44,44,0,1,0
7,173,173,10,4,6,3,2
0,229,229,15,15,0,1,0
11,250,250,36,36,0,1,0
15,255,255,52,6,46,2,1
20,258,258,18,18,0,1,0
2,267,267,2,2,0,1,0
24,268,268,42,42,0,1,0
4,269,269,16,8,8,3,2
22,285,285,45,45,0,1,0
12,287,287,36,17,19,2,1
1,301,301,24,3,21,4,3
9,306,306,111,28,83,4,3
14,336,336,35,35,0,1,0
25,337,337,18,18,0,1,0
18,338,338,2,2,0,1,0
6,366,366,5,5,0,1,0
19,420,420,84,84,0,1,0
23,421,421,44,44,0,1,0
13,459,459,2,2,0,1,0
5,469,469,29,14,15,2,1
16,493,493,8,8,0,1,0

11,110,110,12,2,10,2,1
4,113,113,8,2,6,2,1
5,133,133,1,1,0,1,0
22,136,136,21,3,18,4,3
9,164,164,19,19,0,1,0
27,170,170,3,3,0,1,0
13,182,182,1,1,0,1,0
19,231,231,1,1,0,1,0
25,239,239,1,1,0,1,0
18,246,246,5,5,0,1,0
17,268,268,4,4,0,1,0
31,282,282,6,1,5,2,1
16,284,284,6,6,0,1,0
1,293,293,1,1,0,1,0
29,295,295,127,56,71,4,3
10,296,296,33,6,27,4,3
14,297,297,8,8,0,1,0
3,318,318,56,56,0,1,0
6,343,343,15,15,0,1,0
0,354,354,23,23,0,1,0
2,354,354,21,21,0,1,0
24,357,357,67,13,54,3,2
21,358,358,39,39,0,1,0
30,371,371,21,21,0,1,0
15,389,389,1,1,0,1,0
23,390,390,68,68,0,1,0
7,425,425,89,89,0,1,0
12,435,435,82,6,76,3,2
20,462,462,8,8,0,1,0
28,465,465,1,1,0,1,0
8,493,493,25,7,18,3,2
26,495,495,73,55,18,4,3

19,110,110,1,1,0,1,0
6,111,111,1,1,0,1,0
12,138,138,2,2,0,1,0
24,147,147,8,8,0,1,0
7,196,196,127,111,16,3,2
17,197,197,46,39,7,2,1
21,209,209,7,7,0,1,0
20,211,211,2,2,0,1,0
4,217,217,21,21,0,1,0
13,217,217,2,2,0,1,0
14,245,245,49,49,0,1,0
15,247,247,6,3,3,2,1
3,256,256,12,3,9,2,1
0,291,291,29,29,0,1,0
10,299,299,14,6,8,2,1
11,346,346,1,1,0,1,0
18,367,367,23,23,0,1,0
8,368,368,26,6,20,2,1
2,391,391,26,11,15,4,3
22,393,393,97,75,22,2,1
9,404,404,43,43,0,1,0
23,410,410,4,4,0,1,0
1,431,431,46,46,0,1,0
5,448,448,1,1,0,1,0
16,474,474,208,103,105,4,3

6,112,112,3,3,0,1,0
15,113,113,21,11,10,3,2
17,130,130,1,1,0,1,0
1,157,157,12,6,6,3,2
14,158,158,3,3,0,1,0
22,167,167,15,15,0,1,0
12,192,192,23,9,14,3,2
31,193,193,10,3,7,2,1
27,196,196,3,3,0,1,0
0,199,199,14,11,3,2,1
10,208,208,2,2,0,1,0
4,211,211,8,5,3,2,1
13,213,213,21,21,0,1,0
5,216,216,18,12,6,3,2
20,228,228,19,1,18,4,3
2,229,229,5,5,0,1,0
18,243,243,49,11,38,2,1
19,245,245,26,4,22,2,1
7,258,258,7,7,0,1,0
28,281,281,10,2,8,3,2
30,286,286,7,7,0,1,0
24,342,342,35,35,0,1,0
25,346,346,35,35,0,1,0
29,357,357,17,6,11,2,1
32,367,367,152,121,31,4,3
9,367,367,13,9,4,2,1
16,375,375,19,3,16,3,2
23,389,389,55,28,27,2,1
11,402,402,2,2,0,1,0
8,407,407,31,3,28,2,1
21,431,431,38,38,0,1,0
3,434,434,19,19,0,1,0
26,448,448,54,3,51,4,3

0,118,118,32,12,20,2,1
5,120,120,4,4,0,1,0
2,132,132,11,3,8,3,2
11,144,144,3,3,0,1,0
19,161,161,38,20,18,3,2
10,173,173,1,1,0,1,0
6,207,207,30,17,13,2,1
8,214,214,1,1,0,1,0
9,290,290,16,16,0,1,0
22,298,298,55,55,0,1,0
21,298,298,35,35,0,1,0
3,340,340,18,18,0,1,0
4,348,348,81,77,4,2,1
7,366,366,89,43,46,2,1
13,383,383,30,30,0,1,0
20,414,414,60,42,18,2,1
18,456,456,31,4,27,2,1
16,458,458,82,82,0,1,0
1,461,461,83,35,48,4,3
12,476,476,33,18,15,4,3
15,487,487,19,19,0,1,0
17,488,488,41,15,26,3,2
14,495,495,45,5,40,3,2

10,125,125,5,5,0,1,0
14,126,126,5,2,3,2,1
8,140,140,2,2,0,1,0
24,150,150,1,1,0,1,0
0,158,158,6,6,0,1,0
3,189,189,17,17,0,1,0
9,196,196,1,1,0,1,0
22,228,228,18,18,0,1,0
27,237,237,44,44,0,1,0
12,239,239,19,19,0,1,0
5,247,247,46,37,9,4,3
15,259,259,54,4,50,3,2
4,260,260,45,45,0,1,0
18,271,271,21,21,0,1,0
7,273,273,36,36,0,1,0
16,281,281,9,3,6,2,1
6,289,289,3,3,0,1,0
25,305,305,31,31,0,1,0
20,329,329,19,1,18,2,1
17,400,400,53,37,16,3,2
1,402,402,19,19,0,1,0
13,402,402,42,25,17,4,3
11,406,406,54,54,0,1,0
19,411,411,43,38,5,2,1
28,416,416,14,14,0,1,0
21,424,424,130,130,0,1,0
2,426,426,1,1,0,1,0
26,431,431,64,64,0,1,0
23,480,480,26,26,0,1,0

13,128,128,2,2,0,1,0
10,131,131,3,3,0,1,0
2,143,143,32,32,0,1,0
8,147,147,17,1,16,3,2
21,150,150,1,1,0,1,0
11,169,169,24,8,16,3,2
9,178,178,13,8,5,2,1
19,213,213,4,4,0,1,0
4,220,220,7,2,5,2,1
15,267,267,14,14,0,1,0
18,311,311,31,31,0,1,0
6,322,322,38,38,0,1,0
1,329,329,36,20,16,3,2
5,345,345,44,22,22,3,2
7,360,360,61,61,0,1,0
14,405,405,82,82,0,1,0
17,410,410,113,113,0,1,0
22,428,428,51,18,33,4,3
0,436,436,67,10,57,4,3
20,442,442,52,52,0,1,0
12,445,445,13,8,5,2,1
16,461,461,100,94,6,2,1
3,494,494,89,51,38,3,2

10,101,101,2,2,0,1,0
9,133,133,1,1,0,1,0
19,140,140,20,20,0,1,0
3,165,165,1,1,0,1,0
6,165,165,1,1,0,1,0
8,167,167,6,6,0,1,0
21,185,185,18,18,0,1,0
5,194,194,15,7,8,2,1
20,200,200,15,9,6,3,2
0,228,228,1,1,0,1,0
4,232,232,29,29,0,1,0
17,243,243,27,27,0,1,0
16,288,288,8,8,0,1,0
24,297,297,10,2,8,2,1
25,305,305,39,39,0,1,0
11,345,345,4,1,3,2,1
22,348,348,13,3,10,2,1
18,361,361,97,23,74,3,2
14,368,368,38,38,0,1,0
12,378,378,174,30,144,4,3
23,429,429,22,6,16,4,3
15,432,432,55,38,17,2,1
13,445,445,55,9,46,3,2
1,454,454,56,12,44,2,1
7,457,457,88,37,51,4,3
2,485,485,112,62,50,3,2

7,108,108,6,6,0,1,0
17,134,134,1,1,0,1,0
13,148,148,1,1,0,1,0
27,167,167,37,37,0,1,0
15,190,190,11,2,9,2,1
3,240,240,17,17,0,1,0
20,281,281,10,1,9,4,3
18,286,286,66,30,36,4,3
10,288,288,38,38,0,1,0
8,303,303,21,21,0,1,0
5,311,311,21,10,11,2,1
23,317,317,67,67,0,1,0
19,330,330,10,1,9,2,1
14,338,338,16,16,0,1,0
16,352,352,4,4,0,1,0
29,372,372,11,5,6,3,2
22,388,388,29,29,0,1,0
1,396,396,4,4,0,1,0
28,397,397,22,22,0,1,0
12,407,407,39,39,0,1,0
30,413,413,15,9,6,3,2
6,414,414,26,26,0,1,0
26,418,418,42,42,0,1,0
25,431,431,7,7,0,1,0
2,434,434,6,6,0,1,0
11,443,443,123,123,0,1,0
4,448,448,53,53,0,1,0
21,480,480,84,45,39,4,3
9,487,487,18,18,0,1,0
0,490,490,78,78,0,1,0
24,492,492,49,21,28,2,1

21,100,100,4,4,0,1,0
24,128,128,4,4,0,1,0
4,129,129,14,14,0,1,0
7,147,147,1,1,0,1,0
5,150,150,39,24,15,4,3
25,210,210,14,6,8,2,1
2,218,218,32,32,0,1,0
15,221,221,3,3,0,1,0
3,224,224,5,5,0,1,0
0,249,249,53,23,30,4,3
16,318,318,71,71,0,1,0
8,337,337,11,11,0,1,0
9,338,338,30,30,0,1,0
20,350,350,13,13,0,1,0
17,360,360,270,270,0,1,0
12,363,363,9,6,3,2,1
1,386,386,6,6,0,1,0
18,393,393,37,37,0,1,0
11,402,402,13,8,5,2,1
22,426,426,4,4,0,1,0
13,430,430,21,21,0,1,0
23,436,436,2,2,0,1,0
14,447,447,20,20,0,1,0
10,453,453,123,71,52,3,2
19,453,453,1,1,0,1,0
6,467,467,14,8,6,2,1
26,485,485,2,2,0,1,0

27,109,109,2,2,0,1,0
0,119,119,2,2,0,1,0
14,122,122,7,7,0,1,0
33,130,130,23,23,0,1,0
13,130,130,5,5,0,1,0
17,140,140,13,3,10,3,2
31,141,141,27,27,0,1,0
6,152,152,8,5,3,2,1
7,156,156,17,5,12,2,1
30,158,158,39,39,0,1,0
12,160,160,3,3,0,1,0
2,176,176,1,1,0,1,0
4,186,186,3,3,0,1,0
20,188,188,13,13,0,1,0
19,196,196,2,2,0,1,0
22,216,216,7,7,0,1,0
26,217,217,24,16,8,3,2
5,245,245,13,10,3,2,1
11,252,252,28,28,0,1,0
29,259,259,21,17,4,2,1
8,273,273,4,4,0,1,0
10,288,288,3,3,0,1,0
16,290,290,16,16,0,1,0
32,315,315,26,14,12,2,1
23,317,317,29,7,22,2,1
1,329,329,3,3,0,1,0
28,361,361,2,2,0,1,0
15,371,371,80,74,6,3,2
21,399,399,16,4,12,3,2
25,464,464,33,33,0,1,0
24,467,467,84,48,36,3,2
9,467,467,71,30,41,2,1
18,475,475,92,6,86,3,2
3,499,499,1,1,0,1,0

13,103,103,5,5,0,1,0
23,157,157,2,2,0,1,0
1,172,172,14,14,0,1,0
19,196,196,29,29,0,1,0
8,221,221,29,11,18,4,3
4,229,229,31,15,16,2,1
14,255,255,3,3,0,1,0
3,260,260,38,38,0,1,0
7,263,263,18,18,0,1,0
11,266,266,37,37,0,1,0
5,274,274,127,127,0,1,0
2,286,286,28,22,6,3,2
15,287,287,77,37,40,4,3
17,287,287,22,7,15,4,3
18,311,311,91,91,0,1,0
6,316,316,1,1,0,1,0
22,380,380,29,13,16,3,2
21,429,429,3,3,0,1,0
10,454,454,5,2,3,2,1
9,461,461,31,1,30,4,3
12,473,473,44,12,32,2,1
16,483,483,57,32,25,3,2
20,486,486,18,18,0,1,0
0,488,488,47,1,46,3,2

4,106,106,1,1,0,1,0
10,116,116,27,13,14,2,1
3,128,128,32,8,24,4,3
23,141,141,27,27,0,1,0
14,151,151,18,6,12,2,1
15,218,218,20,20,0,1,0
13,243,243,18,18,0,1,0
7,246,246,3,3,0,1,0
8,254,254,32,32,0,1,0
16,254,254,5,5,0,1,0
21,259,259,10,10,0,1,0
6,269,269,35,9,26,3,2
20,276,276,1,1,0,1,0
19,285,285,55,40,15,4,3
22,286,286,63,63,0,1,0
18,294,294,27,15,12,4,3
0,300,300,17,17,0,1,0
17,305,305,60,60,0,1,0
11,342,342,52,52,0,1,0
9,403,403,15,12,3,2,1
24,408,408,5,5,0,1,0
12,470,470,36,23,13,2,1
5,474,474,21,6,15,2,1
1,478,478,25,9,16,2,1
2,479,479,95,12,83,4,3

10,108,108,1,1,0,1,0
15,138,138,1,1,0,1,0
6,142,142,35,12,23,2,1
16,146,146,10,10,0,1,0
26,171,171,5,5,0,1,0
19,200,200,46,17,29,4,3
8,220,220,15,1,14,2,1
28,223,223,9,9,0,1,0
9,248,248,10,10,0,1,0
1,255,255,49,35,14,3,2
11,258,258,2,2,0,1,0
20,259,259,55,31,24,2,1
17,276,276,19,7,12,2,1
21,283,283,15,15,0,1,0
24,283,283,105,92,13,2,1
14,283,283,51,51,0,1,0
23,293,293,25,12,13,2,1
29,319,319,14,14,0,1,0
2,320,320,32,23,9,2,1
18,324,324,5,5,0,1,0
4,333,333,14,5,9,2,1
22,334,334,41,41,0,1,0
3,352,352,43,43,0,1,0
13,353,353,1,1,0,1,0
25,355,355,12,3,9,3,2
12,374,374,14,14,0,1,0
5,380,380,36,27,9,2,1
7,409,409,25,4,21,4,3
27,427,427,6,1,5,2,1
0,438,438,10,10,0,1,0

13,102,102,7,1,6,3,2
9,105,105,4,4,0,1,0
25,105,105,4,4,0,1,0
2,134,134,17,17,0,1,0
23,152,152,10,4,6,3,2
19,163,163,25,3,22,2,1
0,177,177,33,17,16,3,2
6,183,183,6,6,0,1,0
14,198,198,6,6,0,1,0
7,201,201,37,37,0,1,0
3,201,201,41,41,0,1,0
20,201,201,8,5,3,2,1
1,206,206,1,1,0,1,0
15,219,219,37,37,0,1,0
18,262,262,32,22,10,2,1
21,302,302,10,10,0,1,0
17,304,304,1,1,0,1,0
11,322,322,45,45,0,1,0
22,366,366,73,34,39,2,1
10,378,378,6,6,0,1,0
16,388,388,53,1,52,4,3
5,396,396,58,26,32,2,1
26,400,400,35,35,0,1,0
8,412,412,1,1,0,1,0
4,449,449,63,63,0,1,0
12,456,456,7,7,0,1,0
24,464,464,120,72,48,2,1

28,108,108,15,3,12,3,2
9,119,119,1,1,0,1,0
23,123,123,2,2,0,1,0
20,129,129,11,1,10,2,1
22,169,169,13,13,0,1,0
10,196,196,7,7,0,1,0
8,212,212,11,11,0,1,0
13,214,214,16,8,8,2,1
16,218,218,6,6,0,1,0
24,246,246,9,3,6,3,2
21,261,261,35,35,0,1,0
19,279,279,2,2,0,1,0
15,279,279,16,1,15,2,1
27,286,286,45,2,43,2,1
11,293,293,69,69,0,1,0
7,296,296,23,6,17,3,2
3,303,303,10,10,0,1,0
4,314,314,37,37,0,1,0
12,332,332,44,34,10,2,1
17,335,335,10,10,0,1,0
0,338,338,13,3,10,3,2
5,338,338,6,3,3,2,1
6,346,346,27,14,13,2,1
25,394,394,46,46,0,1,0
14,398,398,83,37,46,3,2
1,404,404,10,4,6,2,1
18,410,410,31,4,27,4,3
26,414,414,165,99,66,3,2
29,427,427,28,19,9,4,3
2,435,435,36,36,0,1,0

1,103,103,2,2,0,1,0
10,120,120,41,21,20,2,1
7,137,137,1,1,0,1,0
17,161,161,11,2,9,3,2
8,194,194,10,10,0,1,0
5,200,200,9,9,0,1,0
3,218,218,47,1,46,2,1
0,222,222,8,4,4,2,1
12,234,234,23,23,0,1,0
18,244,244,18,12,6,3,2
16,272,272,11,5,6,3,2
9,275,275,19,19,0,1,0
4,297,297,41,5,36,4,3
13,321,321,11,11,0,1,0
15,322,322,120,48,72,4,3
6,356,356,221,116,105,4,3
19,363,363,3,3,0,1,0
14,381,381,16,12,4,2,1
2,413,413,93,81,12,4,3
11,458,458,56,2,54,3,2

15,152,152,4,4,0,1,0
1,153,153,52,20,32,3,2
6,172,172,37,37,0,1,0
12,178,178,1,1,0,1,0
8,200,200,7,7,0,1,0
5,242,242,2,2,0,1,0
22,264,264,68,41,27,2,1
7,269,269,12,12,0,1,0
13,318,318,53,13,40,2,1
9,329,329,26,7,19,2,1
16,333,333,73,73,0,1,0
0,338,338,20,20,0,1,0
17,346,346,19,16,3,2,1
19,357,357,49,49,0,1,0
20,360,360,24,24,0,1,0
24,366,366,3,3,0,1,0
23,370,370,92,14,78,4,3
3,377,377,75,75,0,1,0
14,380,380,16,16,0,1,0
25,396,396,8,8,0,1,0
2,401,401,14,6,8,2,1
21,402,402,5,5,0,1,0
10,403,403,5,5,0,1,0
4,433,433,83,83,0,1,0
18,500,500,34,4,30,2,1
11,500,500,40,16,24,2,1

7,105,105,12,6,6,3,2
13,148,148,13,6,7,2,1
17,152,152,2,2,0,1,0
3,157,157,25,5,20,3,2
25,167,167,18,2,16,2,1
0,173,173,11,11,0,1,0
20,173,173,21,21,0,1,0
21,179,179,6,6,0,1,0
15,196,196,2,2,0,1,0
24,207,207,33,33,0,1,0
5,223,223,3,3,0,1,0
26,245,245,24,24,0,1,0
1,267,267,16,2,14,3,2
8,278,278,65,42,23,2,1
18,297,297,86,86,0,1,0
12,322,322,3,3,0,1,0
2,325,325,17,17,0,1,0
16,345,345,7,1,6,3,2
14,372,372,4,4,0,1,0
9,398,398,14,14,0,1,0
23,415,415,108,92,16,2,1
10,436,436,14,5,9,2,1
11,455,455,59,11,48,3,2
6,459,459,58,5,53,4,3
22,477,477,74,74,0,1,0
4,495,495,92,82,10,2,1
19,496,496,24,11,13,2,1

20,118,118,26,7,19,2,1
8,123,123,7,3,4,2,1
13,132,132,4,4,0,1,0
21,143,143,9,9,0,1,0
12,196,196,13,13,0,1,0
16,199,199,4,4,0,1,0
10,203,203,8,8,0,1,0
0,241,241,21,13,8,2,1
18,250,250,37,37,0,1,0
6,280,280,10,10,0,1,0
7,326,326,59,51,8,3,2
1,352,352,51,51,0,1,0
14,377,377,39,39,0,1,0
3,378,378,121,78,43,2,1
4,387,387,40,30,10,2,1
17,393,393,7,7,0,1,0
22,413,413,49,49,0,1,0
2,423,423,69,59,10,3,2
5,434,434,48,1,47,2,1
15,449,449,74,58,16,2,1
19,472,472,61,14,47,2,1
11,485,485,104,52,52,4,3
9,497,497,49,9,40,4,3

16,105,105,6,1,5,2,1
25,107,107,24,11,13,2,1
1,113,113,1,1,0,1,0
7,117,117,10,3,7,2,1
4,177,177,27,27,0,1,0
24,196,196,1,1,0,1,0
6,241,241,1,1,0,1,0
20,247,247,48,1,47,2,1
14,257,257,18,2,16,2,1
22,271,271,23,23,0,1,0
15,272,272,60,60,0,1,0
0,277,277,43,4,39,3,2
13,306,306,33,33,0,1,0
10,308,308,30,2,28,3,2
18,334,334,19,2,17,2,1
12,335,335,5,1,4,2,1
5,378,378,13,13,0,1,0
2,379,379,25,25,0,1,0
8,411,411,38,38,0,1,0
9,413,413,119,10,109,4,3
19,429,429,23,23,0,1,0
17,430,430,1,1,0,1,0
11,431,431,91,91,0,1,0
23,448,448,28,4,24,3,2
21,486,486,86,32,54,4,3
3,499,499,46,46,0,1,0

16,113,113,30,3,27,4,3
4,118,118,6,6,0,1,0
22,149,149,14,4,10,2,1
13,173,173,5,5,0,1,0
15,178,178,4,4,0,1,0
17,184,184,6,3,3,2,1
5,188,188,13,5,8,3,2
19,235,235,4,4,0,1,0
12,246,246,19,12,7,2,1
20,246,246,38,38,0,1,0
2,264,264,19,1,18,2,1
0,266,266,76,53,23,3,2
3,296,296,12,3,9,4,3
14,328,328,21,11,10,3,2
6,329,329,18,18,0,1,0
23,352,352,56,56,0,1,0
7,362,362,73,73,0,1,0
18,364,364,103,103,0,1,0
10,388,388,36,8,28,3,2
21,388,388,3,3,0,1,0
1,394,394,68,2,66,3,2
11,413,413,24,9,15,2,1
24,413,413,58,12,46,2,1
8,423,423,52,52,0,1,0
25,439,439,23,1,22,2,1
9,477,477,1,1,0,1,0

19,104,104,5,5,0,1,0
14,105,105,2,2,0,1,0
5,120,120,21,13,8,2,1
9,130,130,5,1,4,2,1
20,169,169,10,10,0,1,0
0,187,187,13,13,0,1,0
18,191,191,43,7,36,3,2
7,205,205,3,3,0,1,0
4,221,221,48,38,10,2,1
8,230,230,5,5,0,1,0
12,251,251,2,2,0,1,0
17,276,276,56,56,0,1,0
3,298,298,102,102,0,1,0
10,323,323,7,7,0,1,0
1,330,330,80,67,13,2,1
13,352,352,10,4,6,2,1
15,370,370,75,53,22,4,3
16,370,370,161,77,84,4,3
11,433,433,6,6,0,1,0
6,467,467,99,99,0,1,0
2,481,481,15,15,0,1,0

0,100,100,8,3,5,2,1
17,104,104,12,12,0,1,0
27,114,114,14,9,5,2,1
13,116,116,19,3,16,2,1
1,148,148,1,1,0,1,0
21,166,166,16,6,10,2,1
20,167,167,14,4,10,3,2
3,170,170,21,9,12,3,2
5,188,188,6,6,0,1,0
10,191,191,21,6,15,4,3
26,216,216,15,15,0,1,0
12,229,229,8,1,7,2,1
25,239,239,57,57,0,1,0
2,297,297,33,11,22,4,3
23,301,301,43,43,0,1,0
14,308,308,38,13,25,2,1
8,311,311,41,41,0,1,0
4,327,327,5,5,0,1,0
19,341,341,14,10,4,2,1
16,356,356,39,2,37,2,1
24,365,365,15,2,13,2,1
9,395,395,1,1,0,1,0
22,413,413,71,20,51,4,3
6,416,416,17,17,0,1,0
15,439,439,29,29,0,1,0
18,475,475,14,14,0,1,0
7,487,487,158,132,26,3,2
11,491,491,1,1,0,1,0

0,112,112,37,6,31,4,3
11,122,122,32,18,14,2,1
18,135,135,24,14,10,3,2
5,159,159,4,4,0,1,0
9,162,162,19,19,0,1,0
1,170,170,31,31,0,1,0
16,179,179,10,1,9,4,3
15,183,183,38,19,19,3,2
17,222,222,29,13,16,3,2
13,235,235,7,4,3,2,1
8,237,237,7,3,4,2,1
4,265,265,35,35,0,1,0
20,275,275,45,45,0,1,0
6,286,286,2,2,0,1,0
10,319,319,9,9,0,1,0
2,334,334,58,58,0,1,0
14,343,343,37,37,0,1,0
12,370,370,32,32,0,1,0
3,373,373,25,19,6,2,1
21,409,409,10,5,5,2,1
7,422,422,101,25,76,3,2
19,445,445,7,7,0,1,0
22,496,496,17,10,7,2,1

14,101,101,2,2,0,1,0
17,105,105,19,7,12,3,2
9,147,147,2,2,0,1,0
5,156,156,10,4,6,2,1
0,169,169,66,6,60,3,2
1,217,217,9,6,3,2,1
15,266,266,5,2,3,2,1
2,293,293,49,49,0,1,0
3,297,297,30,30,0,1,0
7,304,304,4,4,0,1,0
19,308,308,49,22,27,4,3
13,308,308,2,2,0,1,0
8,327,327,11,11,0,1,0
4,327,327,115,115,0,1,0
18,347,347,54,54,0,1,0
16,350,350,35,25,10,2,1
12,391,391,178,171,7,2,1
11,419,419,9,3,6,3,2
6,489,489,90,82,8,2,1
10,496,496,74,74,0,1,0

0,156,156,16,10,6,2,1
18,169,169,48,12,36,2,1
1,195,195,5,5,0,1,0
20,199,199,15,15,0,1,0
21,224,224,6,6,0,1,0
14,226,226,18,6,12,4,3
13,246,246,35,35,0,1,0
24,247,247,11,11,0,1,0
10,263,263,15,7,8,3,2
17,263,263,38,10,28,2,1
4,266,266,14,8,6,2,1
22,271,271,11,11,0,1,0
8,272,272,41,6,35,2,1
5,279,279,10,5,5,2,1
12,296,296,38,2,36,3,2
7,366,366,59,41,18,2,1
3,372,372,69,20,49,2,1
6,392,392,10,10,0,1,0
2,398,398,23,23,0,1,0
19,405,405,43,43,0,1,0
11,408,408,59,8,51,3,2
9,414,414,125,47,78,4,3
15,420,420,43,43,0,1,0
23,442,442,44,16,28,3,2
16,450,450,19,4,15,2,1

22,106,106,16,10,6,2,1
9,113,113,2,2,0,1,0
29,116,116,22,22,0,1,0
10,131,131,1,1,0,1,0
21,135,135,35,2,33,3,2
12,145,145,1,1,0,1,0
26,147,147,4,4,0,1,0
5,148,148,8,2,6,3,2
18,149,149,22,14,8,2,1
8,151,151,18,18,0,1,0
1,153,153,8,8,0,1,0
30,153,153,3,3,0,1,0
24,170,170,2,2,0,1,0
27,192,192,39,21,18,4,3
15,252,252,1,1,0,1,0
20,258,258,93,5,88,3,2
0,267,267,13,1,12,2,1
28,273,273,8,8,0,1,0
4,281,281,1,1,0,1,0
31,313,313,3,3,0,1,0
14,319,319,77,21,56,3,2
25,321,321,15,15,0,1,0
6,325,325,8,8,0,1,0
16,352,352,12,1,11,2,1
17,353,353,4,4,0,1,0
11,353,353,20,2,18,2,1
13,372,372,88,16,72,4,3
3,374,374,60,45,15,4,3
19,391,391,6,6,0,1,0
7,397,397,12,12,0,1,0
2,470,470,21,21,0,1,0
23,483,483,6,6,0,1,0

17,121,121,6,6,0,1,0
10,132,132,17,5,12,4,3
12,138,138,12,12,0,1,0
0,141,141,24,18,6,3,2
15,152,152,15,15,0,1,0
4,170,170,16,13,3,2,1
11,195,195,18,2,16,2,1
5,233,233,100,80,20,3,2
7,257,257,6,6,0,1,0
9,264,264,6,6,0,1,0
16,264,264,30,30,0,1,0
23,271,271,5,5,0,1,0
3,288,288,15,15,0,1,0
8,292,292,5,2,3,2,1
6,343,343,20,20,0,1,0
2,369,369,24,11,13,2,1
22,385,385,125,65,60,3,2
18,391,391,5,5,0,1,0
14,398,398,33,33,0,1,0
19,403,403,24,24,0,1,0
21,456,456,90,90,0,1,0
20,472,472,9,9,0,1,0
1,488,488,117,84,33,4,3
13,498,498,89,32,57,4,3

13,117,117,33,6,27,4,3
10,135,135,20,13,7,2,1
8,139,139,2,2,0,1,0
20,141,141,1,1,0,1,0
24,150,150,13,7,6,2,1
15,182,182,5,5,0,1,0
11,198,198,6,6,0,1,0
17,214,214,11,3,8,3,2
22,221,221,14,14,0,1,0
3,223,223,2,2,0,1,0
9,224,224,28,28,0,1,0
19,236,236,38,38,0,1,0
5,344,344,45,30,15,4,3
16,355,355,49,49,0,1,0
14,382,382,21,1,20,2,1
21,385,385,35,21,14,2,1
0,386,386,29,7,22,3,2
4,404,404,20,10,10,2,1
12,427,427,42,42,0,1,0
2,428,428,120,112,8,2,1
18,435,435,96,15,81,4,3
7,443,443,81,40,41,2,1
1,447,447,59,59,0,1,0
25,464,464,51,24,27,4,3
23,468,468,14,6,8,3,2
6,492,492,13,13,0,1,0

23,104,104,11,8,3,2,1
31,109,109,24,24,0,1,0
15,135,135,12,6,6,3,2
20,136,136,1,1,0,1,0
32,149,149,30,6,24,3,2
21,162,162,13,5,8,2,1
11,165,165,5,5,0,1,0
2,166,166,5,5,0,1,0
25,182,182,5,1,4,2,1
9,186,186,7,7,0,1,0
16,201,201,15,3,12,2,1
4,209,209,33,33,0,1,0
28,218,218,9,9,0,1,0
8,222,222,16,2,14,2,1
29,231,231,47,47,0,1,0
24,239,239,32,32,0,1,0
27,250,250,7,7,0,1,0
22,263,263,7,7,0,1,0
0,292,292,13,1,12,2,1
17,293,293,17,7,10,2,1
12,304,304,41,5,36,2,1
3,312,312,54,54,0,1,0
14,317,317,1,1,0,1,0
30,323,323,3,3,0,1,0
1,336,336,4,4,0,1,0
13,371,371,38,38,0,1,0
10,380,380,9,3,6,3,2
34,394,394,14,14,0,1,0
5,397,397,10,10,0,1,0
26,424,424,92,92,0,1,0
6,436,436,32,1,31,2,1
33,442,442,34,34,0,1,0
7,455,455,4,4,0,1,0
18,465,465,24,3,21,4,3
19,488,488,7,7,0,1,0

21,124,124,9,3,6,2,1
14,125,125,7,7,0,1,0
12,129,129,36,22,14,3,2
7,141,141,3,3,0,1,0
5,143,143,56,30,26,2,1
15,169,169,24,11,13,3,2
3,179,179,21,21,0,1,0
2,184,184,20,20,0,1,0
10,193,193,1,1,0,1,0
16,211,211,27,16,11,2,1
0,213,213,40,7,33,4,3
8,220,220,9,9,0,1,0
13,226,226,36,5,31,2,1
6,228,228,56,56,0,1,0
20,229,229,39,8,31,2,1
22,244,244,40,22,18,4,3
4,279,279,8,8,0,1,0
1,279,279,31,5,26,4,3
17,297,297,1,1,0,1,0
23,319,319,11,5,6,2,1
11,326,326,3,3,0,1,0
9,344,344,15,15,0,1,0
18,392,392,43,11,32,2,1
19,407,407,5,5,0,1,0

13,137,137,18,18,0,1,0
22,149,149,20,8,12,4,3
25,168,168,29,29,0,1,0
6,180,180,11,11,0,1,0
5,195,195,1,1,0,1,0
18,199,199,56,56,0,1,0
23,200,200,11,7,4,2,1
3,220,220,90,90,0,1,0
8,243,243,14,14,0,1,0
1,251,251,8,2,6,2,1
17,269,269,48,12,36,3,2
15,273,273,17,17,0,1,0
9,277,277,62,11,51,3,2
0,293,293,41,9,32,3,2
16,328,328,31,31,0,1,0
2,356,356,54,54,0,1,0
7,360,360,6,6,0,1,0
21,361,361,3,3,0,1,0
4,374,374,19,1,18,4,3
11,386,386,36,36,0,1,0
24,390,390,15,3,12,2,1
12,398,398,22,22,0,1,0
10,426,426,2,2,0,1,0
14,437,437,5,5,0,1,0
19,467,467,6,2,4,2,1
20,473,473,67,63,4,2,1

8,115,115,19,1,18,2,1
3,125,125,6,6,0,1,0
11,129,129,12,12,0,1,0
13,182,182,12,8,4,2,1
12,200,200,42,16,26,2,1
1,220,220,34,2,32,3,2
20,226,226,11,11,0,1,0
4,261,261,22,7,15,2,1
23,303,303,64,28,36,3,2
17,306,306,6,6,0,1,0
16,318,318,27,9,18,3,2
6,318,318,109,75,34,3,2
5,328,328,62,62,0,1,0
0,334,334,55,28,27,2,1
22,335,335,51,27,24,2,1
10,355,355,32,13,19,4,3
2,375,375,2,2,0,1,0
18,397,397,63,63,0,1,0
21,408,408,18,2,16,3,2
19,424,424,42,2,40,2,1
14,466,466,21,5,16,3,2
7,474,474,3,3,0,1,0
9,493,493,25,2,23,2,1
15,500,500,45,9,36,4,3

23,105,105,11,1,10,2,1
8,109,109,23,1,22,2,1
15,116,116,11,11,0,1,0
13,141,141,2,2,0,1,0
14,145,145,1,1,0,1,0
12,148,148,31,5,26,3,2
7,150,150,4,4,0,1,0
2,174,174,46,14,32,3,2
5,177,177,21,12,9,2,1
6,196,196,1,1,0,1,0
0,265,265,42,42,0,1,0
11,275,275,45,4,41,2,1
20,292,292,26,26,0,1,0
10,321,321,52,20,32,2,1
18,323,323,15,15,0,1,0
17,336,336,92,92,0,1,0
3,346,346,5,5,0,1,0
9,348,348,71,71,0,1,0
21,383,383,61,40,21,2,1
1,390,390,32,15,17,4,3
19,392,392,10,10,0,1,0
22,407,407,52,52,0,1,0
4,445,445,24,24,0,1,0
16,477,477,7,4,3,2,1

16,107,107,27,27,0,1,0
1,115,115,13,9,4,2,1
5,117,117,1,1,0,1,0
17,143,143,14,14,0,1,0
20,146,146,2,2,0,1,0
27,148,148,3,3,0,1,0
13,151,151,3,3,0,1,0
7,158,158,5,5,0,1,0
12,161,161,3,3,0,1,0
10,185,185,5,5,0,1,0
22,202,202,6,6,0,1,0
2,231,231,4,4,0,1,0
14,236,236,8,8,0,1,0
0,237,237,5,5,0,1,0
6,260,260,2,2,0,1,0
19,274,274,17,1,16,3,2
26,278,278,3,3,0,1,0
29,304,304,22,22,0,1,0
25,352,352,53,11,42,3,2
8,356,356,1,1,0,1,0
18,361,361,6,6,0,1,0
28,377,377,27,27,0,1,0
24,389,389,39,21,18,4,3
32,396,396,10,10,0,1,0
30,415,415,84,67,17,2,1
21,419,419,134,63,71,4,3
3,420,420,3,3,0,1,0
15,436,436,182,158,24,4,3
23,442,442,78,15,63,4,3
9,471,471,4,4,0,1,0
11,489,489,61,41,20,3,2
4,493,493,6,6,0,1,0
31,494,494,66,19,47,4,3

23,101,101,12,12,0,1,0
32,114,114,3,3,0,1,0
29,150,150,2,2,0,1,0
6,160,160,3,3,0,1,0
30,167,167,7,7,0,1,0
24,199,199,11,2,9,4,3
9,208,208,6,6,0,1,0
10,210,210,40,40,0,1,0
12,224,224,1,1,0,1,0
3,230,230,2,2,0,1,0
8,232,232,1,1,0,1,0
25,263,263,11,11,0,1,0
5,280,280,3,3,0,1,0
1,297,297,5,5,0,1,0
14,355,355,31,31,0,1,0
31,356,356,12,12,0,1,0
0,356,356,3,3,0,1,0
27,365,365,86,44,42,2,1
7,369,369,58,58,0,1,0
28,379,379,18,2,16,3,2
21,381,381,28,16,12,4,3
26,384,384,178,121,57,3,2
15,391,391,12,1,11,4,3
13,395,395,16,7,9,4,3
17,398,398,24,24,0,1,0
20,411,411,49,11,38,2,1
22,414,414,23,20,3,2,1
4,416,416,18,2,16,2,1
11,432,432,21,21,0,1,0
16,434,434,146,26,120,4,3
18,473,473,29,29,0,1,0
19,486,486,16,16,0,1,0
2,498,498,55,55,0,1,0

3,101,101,3,3,0,1,0
16,139,139,4,4,0,1,0
10,144,144,67,67,0,1,0
24,151,151,85,69,16,2,1
28,159,159,3,3,0,1,0
22,175,175,26,23,3,2,1
18,182,182,35,7,28,2,1
7,208,208,18,3,15,2,1
1,209,209,1,1,0,1,0
0,213,213,14,14,0,1,0
27,216,216,2,2,0,1,0
9,228,228,2,2,0,1,0
20,280,280,2,2,0,1,0
8,297,297,3,3,0,1,0
5,301,301,10,10,0,1,0
15,342,342,4,4,0,1,0
17,370,370,4,4,0,1,0
13,372,372,36,36,0,1,0
23,373,373,16,16,0,1,0
12,429,429,1,1,0,1,0
2,438,438,115,7,108,4,3
25,445,445,5,5,0,1,0
11,465,465,22,18,4,2,1
14,475,475,42,25,17,2,1
26,483,483,40,1,39,3,2
4,488,488,28,18,10,2,1
19,489,489,96,62,34,3,2
21,489,489,7,1,6,2,1
6,490,490,15,6,9,4,3

16,108,108,14,14,0,1,0
5,114,114,1,1,0,1,0
21,124,124,1,1,0,1,0
9,160,160,55,55,0,1,0
20,208,208,5,1,4,2,1
10,219,219,23,6,17,2,1
14,248,248,1,1,0,1,0
23,256,256,17,9,8,2,1
8,274,274,18,4,14,3,2
13,279,279,42,14,28,3,2
22,323,323,51,51,0,1,0
2,326,326,53,11,42,4,3
24,344,344,48,48,0,1,0
18,392,392,84,43,41,2,1
0,393,393,49,49,0,1,0
4,399,399,5,5,0,1,0
12,400,400,60,18,42,3,2
15,400,400,100,59,41,4,3
11,400,400,98,11,87,4,3
3,402,402,12,12,0,1,0
6,418,418,17,1,16,3,2
1,430,430,65,5,60,3,2
17,462,462,16,16,0,1,0
7,484,484,5,1,4,2,1
19,494,494,5,5,0,1,0

15,109,109,31,31,0,1,0
13,112,112,12,12,0,1,0
8,116,116,6,1,5,2,1
1,125,125,25,1,24,3,2
16,146,146,18,18,0,1,0
18,147,147,18,18,0,1,0
23,159,159,11,11,0,1,0
2,173,173,12,4,8,2,1
12,176,176,16,6,10,3,2
21,199,199,49,15,34,3,2
0,216,216,2,2,0,1,0
3,232,232,5,1,4,2,1
5,239,239,45,9,36,4,3
25,251,251,7,2,5,2,1
14,265,265,9,9,0,1,0
11,268,268,47,8,39,4,3
19,272,272,10,2,8,3,2
7,279,279,49,5,44,3,2
24,285,285,16,1,15,4,3
26,298,298,41,29,12,3,2
4,323,323,2,2,0,1,0
20,339,339,20,20,0,1,0
10,364,364,25,25,0,1,0
9,404,404,20,8,12,3,2
17,423,423,32,12,20,2,1
22,444,444,26,16,10,4,3
6,489,489,46,46,0,1,0

21,119,119,8,8,0,1,0
3,123,123,4,4,0,1,0
12,175,175,6,6,0,1,0
22,190,190,6,6,0,1,0
25,203,203,4,4,0,1,0
4,230,230,1,1,0,1,0
14,236,236,91,27,64,4,3
16,285,285,2,2,0,1,0
8,290,290,10,4,6,2,1
11,290,290,19,19,0,1,0
15,317,317,4,4,0,1,0
13,324,324,10,6,4,2,1
5,342,342,34,5,29,3,2
20,359,359,22,6,16,2,1
7,385,385,233,157,76,4,3
19,396,396,45,45,0,1,0
23,396,396,11,5,6,3,2
2,404,404,6,6,0,1,0
24,407,407,114,114,0,1,0
1,416,416,32,32,0,1,0
10,418,418,5,5,0,1,0
17,424,424,48,48,0,1,0
6,434,434,6,6,0,1,0
9,450,450,26,26,0,1,0
0,454,454,113,68,45,4,3
18,494,494,88,24,64,3,2

10,137,137,4,4,0,1,0
19,143,143,10,10,0,1,0
4,145,145,13,13,0,1,0
14,146,146,1,1,0,1,0
12,174,174,11,11,0,1,0
21,178,178,9,9,0,1,0
8,178,178,6,6,0,1,0
11,199,199,45,5,40,3,2
5,223,223,69,25,44,2,1
1,231,231,14,1,13,2,1
0,258,258,21,6,15,4,3
18,258,258,44,44,0,1,0
3,287,287,70,70,0,1,0
16,301,301,50,20,30,3,2
23,319,319,24,5,19,2,1
2,330,330,47,3,44,3,2
13,341,341,68,68,0,1,0
15,373,373,44,23,21,2,1
20,386,386,29,29,0,1,0
17,415,415,30,20,10,3,2
9,443,443,1,1,0,1,0
6,458,458,75,75,0,1,0
7,471,471,69,69,0,1,0
22,474,474,21,8,13,3,2

12,114,114,11,7,4,2,1
10,156,156,6,1,5,2,1
0,162,162,1,1,0,1,0
24,175,175,23,12,11,2,1
17,183,183,61,61,0,1,0
5,189,189,17,9,8,2,1
9,203,203,44,20,24,4,3
16,203,203,21,21,0,1,0
22,204,204,21,6,15,4,3
4,208,208,5,5,0,1,0
11,216,216,14,14,0,1,0
21,291,291,11,3,8,3,2
8,295,295,15,15,0,1,0
7,312,312,123,81,42,2,1
1,343,343,32,32,0,1,0
3,416,416,74,42,32,2,1
15,425,425,110,110,0,1,0
6,429,429,39,5,34,2,1
14,438,438,47,44,3,2,1
20,451,451,5,5,0,1,0
2,462,462,26,5,21,4,3
18,462,462,8,8,0,1,0
23,482,482,19,3,16,2,1
13,486,486,34,34,0,1,0
19,500,500,6,6,0,1,0

15,127,127,34,9,25,3,2
4,157,157,13,3,10,2,1
1,167,167,17,17,0,1,0
24,185,185,53,53,0,1,0
14,187,187,12,5,7,2,1
6,191,191,2,2,0,1,0
10,205,205,8,1,7,2,1
28,218,218,15,15,0,1,0
32,237,237,29,1,28,3,2
33,241,241,10,10,0,1,0
17,245,245,4,4,0,1,0
29,255,255,1,1,0,1,0
16,275,275,36,20,16,4,3
12,279,279,5,5,0,1,0
7,338,338,28,28,0,1,0
19,353,353,5,5,0,1,0
30,360,360,10,5,5,2,1
9,365,365,17,17,0,1,0
23,383,383,41,41,0,1,0
21,392,392,48,48,0,1,0
5,395,395,23,23,0,1,0
0,401,401,21,6,15,2,1
27,406,406,35,35,0,1,0
11,418,418,9,4,5,2,1
26,428,428,114,60,54,3,2
18,431,431,9,9,0,1,0
3,431,431,42,6,36,3,2
22,453,453,58,58,0,1,0
8,456,456,12,12,0,1,0
31,463,463,18,15,3,2,1
25,481,481,12,12,0,1,0
2,487,487,10,10,0,1,0
13,493,493,53,13,40,3,2
20,497,497,11,3,8,2,1

0,108,108,5,2,3,2,1
21,122,122,1,1,0,1,0
10,136,136,15,2,13,2,1
29,148,148,28,24,4,2,1
16,156,156,6,6,0,1,0
19,161,161,12,12,0,1,0
17,179,179,42,42,0,1,0
8,188,188,14,14,0,1,0
18,197,197,20,1,19,3,2
20,207,207,11,11,0,1,0
2,267,267,25,25,0,1,0
3,280,280,11,11,0,1,0
15,319,319,17,17,0,1,0
26,348,348,11,4,7,3,2
4,361,361,3,3,0,1,0
13,371,371,19,1,18,4,3
23,377,377,18,15,3,2,1
22,381,381,5,5,0,1,0
24,401,401,7,7,0,1,0
11,412,412,26,26,0,1,0
1,416,416,6,6,0,1,0
30,420,420,2,2,0,1,0
14,426,426,39,39,0,1,0
6,435,435,16,7,9,4,3
27,438,438,169,92,77,4,3
25,454,454,98,53,45,2,1
12,469,469,133,34,99,4,3
28,475,475,85,85,0,1,0
7,487,487,19,19,0,1,0
5,489,489,5,2,3,2,1
9,499,499,7,7,0,1,0

8,106,106,4,1,3,2,1
7,118,118,11,11,0,1,0
0,141,141,20,13,7,2,1
9,142,142,7,4,3,2,1
19,150,150,1,1,0,1,0
18,160,160,2,2,0,1,0
27,208,208,6,6,0,1,0
15,231,231,17,17,0,1,0
23,241,241,1,1,0,1,0
1,259,259,53,13,40,2,1
17,295,295,3,3,0,1,0
21,298,298,74,74,0,1,0
14,305,305,47,23,24,4,3
24,354,354,64,16,48,4,3
25,359,359,61,19,42,3,2
4,360,360,4,4,0,1,0
10,364,364,1,1,0,1,0
22,371,371,128,128,0,1,0
5,380,380,9,9,0,1,0
16,380,380,4,4,0,1,0
11,388,388,21,21,0,1,0
2,393,393,115,115,0,1,0
26,407,407,82,66,16,3,2
3,419,419,12,12,0,1,0
12,430,430,3,3,0,1,0
20,484,484,15,15,0,1,0
6,497,497,6,6,0,1,0
13,500,500,95,47,48,4,3

3,100,100,7,3,4,2,1
26,122,122,9,9,0,1,0
29,134,134,21,21,0,1,0
9,142,142,2,2,0,1,0
19,154,154,6,3,3,2,1
5,164,164,32,16,16,2,1
24,178,178,29,29,0,1,0
11,191,191,9,5,4,2,1
0,196,196,4,4,0,1,0
22,197,197,37,13,24,4,3
15,202,202,6,1,5,2,1
12,206,206,7,7,0,1,0
21,209,209,26,26,0,1,0
2,216,216,11,11,0,1,0
8,229,229,6,1,5,2,1
14,241,241,5,5,0,1,0
23,262,262,7,1,6,3,2
25,275,275,8,8,0,1,0
7,283,283,33,6,27,4,3
10,286,286,34,28,6,3,2
6,304,304,43,43,0,1,0
13,335,335,74,74,0,1,0
16,338,338,9,9,0,1,0
28,344,344,31,31,0,1,0
17,351,351,6,6,0,1,0
4,390,390,63,27,36,3,2
18,391,391,14,2,12,3,2
20,415,415,12,8,4,2,1
1,423,423,3,3,0,1,0
27,475,475,171,66,105,4,3

25,135,135,15,15,0,1,0
16,136,136,16,10,6,2,1
20,137,137,24,11,13,2,1
4,150,150,16,7,9,4,3
24,165,165,15,15,0,1,0
10,194,194,38,22,16,3,2
9,241,241,1,1,0,1,0
17,257,257,21,1,20,2,1
8,274,274,16,16,0,1,0
18,276,276,32,32,0,1,0
14,279,279,22,22,0,1,0
7,295,295,64,34,30,2,1
15,310,310,8,4,4,2,1
13,319,319,27,27,0,1,0
5,341,341,48,48,0,1,0
23,357,357,31,31,0,1,0
2,358,358,17,3,14,2,1
1,405,405,59,59,0,1,0
12,422,422,123,62,61,4,3
6,426,426,3,3,0,1,0
3,448,448,1,1,0,1,0
19,471,471,105,31,74,3,2
21,476,476,25,14,11,2,1
22,477,477,42,7,35,3,2
0,480,480,22,22,0,1,0
11,500,500,19,13,6,3,2

10,105,105,1,1,0,1,0
12,120,120,2,2,0,1,0
18,130,130,7,7,0,1,0
9,140,140,22,22,0,1,0
15,164,164,33,33,0,1,0
17,168,168,59,59,0,1,0
16,179,179,41,41,0,1,0
6,182,182,47,47,0,1,0
21,197,197,4,4,0,1,0
19,202,202,11,3,8,3,2
22,230,230,3,3,0,1,0
14,263,263,5,5,0,1,0
3,263,263,11,11,0,1,0
11,280,280,49,49,0,1,0
4,323,323,6,6,0,1,0
13,365,365,34,34,0,1,0
2,366,366,21,7,14,2,1
1,371,371,10,10,0,1,0
8,383,383,41,41,0,1,0
5,397,397,124,124,0,1,0
7,413,413,44,2,42,3,2
20,437,437,44,44,0,1,0
0,448,448,96,8,88,4,3

2,100,100,1,1,0,1,0
24,136,136,22,22,0,1,0
13,151,151,10,10,0,1,0
20,157,157,20,20,0,1,0
14,158,158,12,3,9,2,1
21,165,165,2,2,0,1,0
33,182,182,1,1,0,1,0
19,205,205,2,2,0,1,0
25,213,213,20,20,0,1,0
5,216,216,30,30,0,1,0
31,216,216,10,10,0,1,0
15,220,220,1,1,0,1,0
1,223,223,36,7,29,3,2
7,233,233,1,1,0,1,0
11,255,255,26,26,0,1,0
23,261,261,14,5,9,2,1
3,269,269,9,9,0,1,0
0,306,306,10,1,9,4,3
34,312,312,87,87,0,1,0
10,314,314,3,3,0,1,0
22,317,317,63,8,55,4,3
6,321,321,3,3,0,1,0
17,324,324,17,1,16,2,1
26,331,331,48,48,0,1,0
28,340,340,9,9,0,1,0
27,364,364,13,1,12,4,3
12,378,378,15,15,0,1,0
9,395,395,34,21,13,2,1
32,403,403,12,12,0,1,0
18,413,413,1,1,0,1,0
4,414,414,34,34,0,1,0
29,438,438,61,61,0,1,0
16,458,458,33,3,30,4,3
8,478,478,81,81,0,1,0
30,498,498,54,33,21,2,1

18,101,101,7,3,4,2,1
16,119,119,51,51,0,1,0
21,126,126,15,5,10,3,2
23,153,153,14,14,0,1,0
20,157,157,2,2,0,1,0
7,162,162,6,6,0,1,0
12,192,192,57,57,0,1,0
13,198,198,26,11,15,4,3
25,218,218,1,1,0,1,0
15,244,244,41,41,0,1,0
6,246,246,5,5,0,1,0
10,262,262,19,19,0,1,0
14,270,270,19,19,0,1,0
11,291,291,20,14,6,3,2
22,315,315,5,5,0,1,0
19,315,315,22,22,0,1,0
24,330,330,17,17,0,1,0
4,347,347,12,4,8,2,1
5,356,356,1,1,0,1,0
8,367,367,14,4,10,2,1
9,392,392,52,14,38,3,2
0,397,397,109,97,12,4,3
1,421,421,75,29,46,4,3
3,431,431,6,6,0,1,0
17,491,491,46,26,20,3,2
2,499,499,67,67,0,1,0

25,102,102,1,1,0,1,0
14,114,114,9,9,0,1,0
13,118,118,1,1,0,1,0
20,127,127,1,1,0,1,0
11,131,131,63,54,9,2,1
28,167,167,40,28,12,3,2
15,170,170,4,4,0,1,0
5,197,197,19,19,0,1,0
6,201,201,31,22,9,2,1
3,232,232,23,23,0,1,0
26,235,235,31,17,14,2,1
4,248,248,1,1,0,1,0
12,297,297,20,8,12,2,1
22,322,322,15,3,12,3,2
1,341,341,49,49,0,1,0
27,352,352,37,12,25,3,2
21,358,358,35,7,28,2,1
10,377,377,15,15,0,1,0
24,386,386,36,36,0,1,0
2,400,400,1,1,0,1,0
7,407,407,1,1,0,1,0
18,419,419,94,94,0,1,0
8,423,423,1,1,0,1,0
16,432,432,24,4,20,3,2
19,432,432,27,18,9,4,3
9,454,454,4,4,0,1,0
0,459,459,15,15,0,1,0
29,470,470,3,3,0,1,0
23,471,471,48,48,0,1,0
17,493,493,97,25,72,4,3

20,113,113,3,3,0,1,0
17,127,127,4,4,0,1,0
22,129,129,4,4,0,1,0
27,130,130,27,27,0,1,0
2,147,147,8,4,4,2,1
6,174,174,1,1,0,1,0
18,179,179,39,39,0,1,0
14,185,185,4,4,0,1,0
11,190,190,1,1,0,1,0
3,200,200,4,4,0,1,0
32,202,202,16,16,0,1,0
33,206,206,9,3,6,3,2
5,213,213,19,5,14,3,2
31,221,221,15,9,6,2,1
16,247,247,6,6,0,1,0
25,250,250,12,12,0,1,0
24,303,303,1,1,0,1,0
23,303,303,1,1,0,1,0
10,312,312,8,1,7,2,1
29,329,329,5,5,0,1,0
12,332,332,32,32,0,1,0
7,350,350,58,27,31,2,1
1,352,352,35,15,20,2,1
13,353,353,2,2,0,1,0
0,356,356,3,3,0,1,0
8,366,366,10,10,0,1,0
4,406,406,56,23,33,2,1
28,419,419,15,6,9,4,3
30,426,426,37,18,19,2,1
19,433,433,99,77,22,3,2
9,444,444,2,2,0,1,0
21,471,471,33,33,0,1,0
26,482,482,305,305,0,1,0
15,484,484,2,2,0,1,0

21,111,111,1,1,0,1,0
1,128,128,2,2,0,1,0
13,132,132,27,12,15,4,3
2,138,138,14,3,11,2,1
18,146,146,14,14,0,1,0
20,226,226,25,21,4,2,1
15,235,235,20,7,13,2,1
9,250,250,98,65,33,4,3
3,266,266,58,14,44,2,1
10,271,271,29,5,24,3,2
11,277,277,24,24,0,1,0
17,281,281,12,12,0,1,0
12,284,284,76,65,11,2,1
5,317,317,30,30,0,1,0
16,348,348,51,42,9,2,1
4,376,376,83,29,54,3,2
8,399,399,3,3,0,1,0
14,400,400,58,37,21,4,3
19,421,421,12,9,3,2,1
22,422,422,4,4,0,1,0
6,447,447,7,7,0,1,0
0,469,469,21,21,0,1,0
7,481,481,92,92,0,1,0

20,128,128,7,7,0,1,0
9,167,167,11,11,0,1,0
4,182,182,19,7,12,3,2
13,187,187,7,4,3,2,1
5,207,207,50,11,39,4,3
2,213,213,33,33,0,1,0
22,222,222,28,15,13,2,1
18,234,234,19,8,11,2,1
6,236,236,8,8,0,1,0
8,252,252,26,6,20,2,1
17,257,257,98,98,0,1,0
3,260,260,3,3,0,1,0
1,266,266,3,3,0,1,0
10,286,286,1,1,0,1,0
23,343,343,18,13,5,2,1
7,344,344,22,22,0,1,0
26,355,355,21,4,17,3,2
12,387,387,82,82,0,1,0
0,400,400,45,45,0,1,0
21,403,403,30,30,0,1,0
14,407,407,94,87,7,2,1
15,410,410,24,5,19,3,2
11,438,438,64,64,0,1,0
16,441,441,21,11,10,2,1
24,478,478,41,41,0,1,0
25,495,495,5,5,0,1,0
19,499,499,29,15,14,2,1

9,105,105,2,2,0,1,0
0,114,114,3,3,0,1,0
26,119,119,4,4,0,1,0
19,134,134,13,13,0,1,0
3,175,175,1,1,0,1,0
7,181,181,7,7,0,1,0
11,185,185,11,11,0,1,0
4,187,187,7,7,0,1,0
2,195,195,48,48,0,1,0
15,225,225,1,1,0,1,0
23,238,238,1,1,0,1,0
6,249,249,33,33,0,1,0
25,263,263,114,114,0,1,0
12,265,265,4,4,0,1,0
16,302,302,11,1,10,2,1
8,320,320,26,13,13,2,1
20,352,352,16,3,13,2,1
18,364,364,80,80,0,1,0
13,384,384,80,26,54,4,3
1,389,389,14,14,0,1,0
22,392,392,30,30,0,1,0
10,412,412,73,73,0,1,0
27,424,424,48,48,0,1,0
5,433,433,48,3,45,4,3
24,438,438,37,2,35,2,1
17,442,442,62,28,34,3,2
14,444,444,48,48,0,1,0
21,483,483,19,19,0,1,0

4,119,119,30,30,0,1,0
13,119,119,14,14,0,1,0
14,133,133,10,4,6,3,2
19,137,137,42,37,5,2,1
17,139,139,7,1,6,2,1
11,145,145,9,9,0,1,0
8,147,147,12,2,10,3,2
24,148,148,24,13,11,2,1
16,148,148,2,2,0,1,0
20,170,170,8,8,0,1,0
6,190,190,12,5,7,2,1
5,238,238,2,2,0,1,0
2,239,239,44,23,21,2,1
25,239,239,24,24,0,1,0
15,257,257,5,5,0,1,0
7,261,261,30,30,0,1,0
10,264,264,23,1,22,3,2
27,291,291,5,5,0,1,0
12,294,294,6,6,0,1,0
21,307,307,36,36,0,1,0
1,339,339,29,29,0,1,0
3,353,353,1,1,0,1,0
0,383,383,28,28,0,1,0
26,447,447,77,1,76,3,2
22,464,464,57,57,0,1,0
18,482,482,69,69,0,1,0
9,486,486,36,36,0,1,0
23,499,499,27,27,0,1,0

6,107,107,9,1,8,3,2
13,111,111,10,7,3,2,1
19,121,121,1,1,0,1,0
26,137,137,2,2,0,1,0
2,149,149,2,2,0,1,0
20,152,152,33,2,31,2,1
11,218,218,27,7,20,3,2
5,223,223,34,18,16,2,1
21,249,249,38,12,26,2,1
7,268,268,5,5,0,1,0
22,279,279,17,17,0,1,0
23,287,287,29,29,0,1,0
10,292,292,29,29,0,1,0
15,303,303,32,8,24,4,3
16,307,307,15,15,0,1,0
17,344,344,33,28,5,2,1
4,351,351,119,112,7,2,1
12,352,352,26,26,0,1,0
3,370,370,51,33,18,4,3
14,379,379,78,34,44,2,1
0,382,382,12,3,9,4,3
9,390,390,2,2,0,1,0
1,401,401,29,7,22,2,1
25,432,432,42,42,0,1,0
24,464,464,7,7,0,1,0
8,479,479,31,31,0,1,0
18,488,488,99,57,42,4,3

21,108,108,1,1,0,1,0
0,110,110,6,1,5,2,1
8,114,114,2,2,0,1,0
27,137,137,15,15,0,1,0
30,161,161,26,26,0,1,0
20,187,187,20,20,0,1,0
6,197,197,43,15,28,3,2
29,277,277,11,11,0,1,0
28,277,277,51,51,0,1,0
25,307,307,54,54,0,1,0
9,308,308,18,18,0,1,0
16,313,313,33,11,22,3,2
14,314,314,15,15,0,1,0
5,329,329,36,14,22,4,3
15,334,334,21,21,0,1,0
13,336,336,12,12,0,1,0
31,354,354,12,6,6,3,2
26,371,371,60,48,12,4,3
22,380,380,13,13,0,1,0
19,384,384,25,25,0,1,0
32,393,393,118,76,42,4,3
2,407,407,15,4,11,2,1
18,417,417,9,9,0,1,0
3,434,434,44,6,38,3,2
12,444,444,22,22,0,1,0
17,458,458,1,1,0,1,0
24,464,464,1,1,0,1,0
11,468,468,72,63,9,4,3
4,471,471,10,1,9,4,3
10,482,482,28,28,0,1,0
7,484,484,35,4,31,2,1
1,490,490,5,5,0,1,0
23,492,492,2,2,0,1,0

13,116,116,4,4,0,1,0
14,155,155,34,22,12,3,2
8,158,158,1,1,0,1,0
12,163,163,18,18,0,1,0
7,245,245,80,45,35,2,1
17,289,289,33,9,24,4,3
3,301,301,4,4,0,1,0
1,305,305,9,1,8,2,1
20,309,309,71,71,0,1,0
2,328,328,56,56,0,1,0
15,361,361,39,2,37,2,1
19,376,376,26,9,17,2,1
11,394,394,38,22,16,3,2
16,400,400,42,42,0,1,0
9,401,401,69,69,0,1,0
10,418,418,23,23,0,1,0
4,426,426,27,19,8,2,1
0,447,447,47,40,7,3,2
5,460,460,41,41,0,1,0
18,479,479,2,2,0,1,0
6,489,489,247,244,3,2,1

9,114,114,19,7,12,3,2
15,140,140,5,5,0,1,0
7,182,182,1,1,0,1,0
8,183,183,15,1,14,2,1
1,190,190,14,14,0,1,0
18,236,236,50,50,0,1,0
2,244,244,17,3,14,3,2
24,246,246,16,3,13,3,2
14,257,257,1,1,0,1,0
23,289,289,85,43,42,3,2
20,302,302,60,19,41,2,1
3,325,325,16,16,0,1,0
21,331,331,39,39,0,1,0
16,334,334,44,44,0,1,0
17,351,351,27,27,0,1,0
19,352,352,22,22,0,1,0
10,353,353,94,31,63,4,3
12,370,370,8,8,0,1,0
13,374,374,10,10,0,1,0
22,382,382,29,22,7,2,1
5,400,400,63,25,38,2,1
6,459,459,105,5,100,3,2
11,461,461,12,12,0,1,0
0,468,468,27,16,11,2,1
4,483,483,57,33,24,3,2

8,107,107,17,17,0,1,0
4,112,112,37,37,0,1,0
7,131,131,2,2,0,1,0
20,150,150,15,15,0,1,0
12,180,180,18,13,5,2,1
6,194,194,23,23,0,1,0
2,216,216,35,35,0,1,0
1,229,229,8,8,0,1,0
5,256,256,23,23,0,1,0
10,275,275,30,30,0,1,0
17,279,279,3,3,0,1,0
14,294,294,29,2,27,3,2
11,305,305,12,2,10,3,2
16,338,338,1,1,0,1,0
21,377,377,19,5,14,2,1
3,382,382,59,11,48,2,1
13,390,390,13,8,5,2,1
18,446,446,154,141,13,2,1
0,455,455,109,54,55,4,3
19,461,461,10,10,0,1,0
9,481,481,10,10,0,1,0
15,493,493,191,123,68,4,3

28,128,128,57,57,0,1,0
22,139,139,10,10,0,1,0
23,172,172,10,1,9,4,3
16,175,175,1,1,0,1,0
25,198,198,38,38,0,1,0
3,215,215,18,18,0,1,0
20,230,230,9,3,6,3,2
11,240,240,3,3,0,1,0
13,248,248,3,3,0,1,0
6,249,249,32,32,0,1,0
19,274,274,24,24,0,1,0
26,275,275,25,7,18,4,3
14,311,311,73,29,44,2,1
12,361,361,20,5,15,4,3
24,374,374,41,41,0,1,0
0,374,374,24,2,22,2,1
17,385,385,5,2,3,2,1
7,392,392,8,8,0,1,0
9,398,398,16,12,4,2,1
8,401,401,11,5,6,2,1
4,404,404,82,37,45,2,1
5,429,429,1,1,0,1,0
18,430,430,13,13,0,1,0
10,438,438,24,15,9,2,1
21,445,445,77,77,0,1,0
2,451,451,3,3,0,1,0
27,467,467,6,6,0,1,0
15,471,471,81,81,0,1,0
1,497,497,91,42,49,2,1

1,113,113,5,5,0,1,0
5,127,127,1,1,0,1,0
4,141,141,2,2,0,1,0
21,151,151,59,59,0,1,0
30,164,164,1,1,0,1,0
3,191,191,61,30,31,2,1
6,200,200,2,2,0,1,0
28,228,228,12,7,5,2,1
11,240,240,27,9,18,3,2
2,255,255,18,6,12,2,1
29,256,256,3,3,0,1,0
20,278,278,25,4,21,4,3
15,287,287,34,22,12,3,2
26,309,309,51,51,0,1,0
25,312,312,3,3,0,1,0
17,315,315,24,18,6,2,1
13,319,319,1,1,0,1,0
8,328,328,8,2,6,3,2
23,345,345,20,8,12,4,3
16,354,354,51,51,0,1,0
10,360,360,15,2,13,2,1
19,367,367,5,5,0,1,0
22,385,385,66,66,0,1,0
9,389,389,32,32,0,1,0
18,414,414,95,74,21,4,3
24,423,423,13,13,0,1,0
7,424,424,48,48,0,1,0
27,430,430,40,40,0,1,0
12,432,432,14,4,10,3,2
14,442,442,18,18,0,1,0
0,480,480,22,22,0,1,0

16,123,123,22,22,0,1,0
18,183,183,8,8,0,1,0
11,217,217,8,1,7,3,2
14,218,218,19,4,15,2,1
1,227,227,39,6,33,4,3
8,232,232,6,6,0,1,0
2,242,242,9,9,0,1,0
13,260,260,6,1,5,2,1
21,275,275,55,5,50,2,1
17,281,281,8,8,0,1,0
15,282,282,54,38,16,3,2
9,308,308,34,34,0,1,0
12,319,319,37,28,9,4,3
20,349,349,21,21,0,1,0
4,360,360,20,20,0,1,0
22,374,374,60,28,32,3,2
19,400,400,41,27,14,2,1
3,410,410,120,57,63,4,3
0,413,413,165,100,65,4,3
10,418,418,38,38,0,1,0
7,429,429,50,8,42,2,1
5,433,433,28,2,26,2,1
6,496,496,14,3,11,2,1

4,117,117,20,1,19,2,1
5,120,120,12,12,0,1,0
16,142,142,7,7,0,1,0
10,147,147,32,22,10,2,1
19,182,182,60,60,0,1,0
6,224,224,2,2,0,1,0
22,233,233,24,24,0,1,0
25,242,242,3,3,0,1,0
2,301,301,43,35,8,2,1
24,309,309,19,4,15,4,3
3,310,310,45,2,43,2,1
17,312,312,19,19,0,1,0
12,321,321,3,3,0,1,0
23,324,324,41,41,0,1,0
11,326,326,13,8,5,2,1
8,364,364,2,2,0,1,0
15,381,381,60,60,0,1,0
21,390,390,23,17,6,3,2
9,398,398,17,17,0,1,0
0,413,413,8,8,0,1,0
1,424,424,41,41,0,1,0
7,434,434,131,131,0,1,0
14,435,435,39,39,0,1,0
18,469,469,21,11,10,2,1
20,487,487,97,73,24,4,3
13,488,488,11,1,10,3,2

4,101,101,24,24,0,1,0
21,102,102,3,3,0,1,0
0,127,127,5,5,0,1,0
5,127,127,4,1,3,2,1
9,172,172,14,14,0,1,0
15,178,178,24,14,10,2,1
10,189,189,36,18,18,2,1
14,193,193,23,3,20,3,2
23,209,209,11,11,0,1,0
19,218,218,62,29,33,2,1
8,248,248,45,45,0,1,0
24,260,260,29,3,26,3,2
6,272,272,9,9,0,1,0
12,286,286,7,7,0,1,0
20,313,313,17,17,0,1,0
17,331,331,61,1,60,3,2
22,366,366,38,38,0,1,0
1,383,383,14,6,8,3,2
7,396,396,103,38,65,4,3
16,397,397,31,4,27,4,3
11,400,400,49,49,0,1,0
2,402,402,31,19,12,2,1
18,408,408,21,21,0,1,0
13,447,447,44,44,0,1,0
3,449,449,5,5,0,1,0

24,100,100,8,8,0,1,0
4,114,114,4,4,0,1,0
17,153,153,3,3,0,1,0
22,160,160,11,11,0,1,0
1,186,186,23,19,4,2,1
12,199,199,17,9,8,3,2
23,204,204,27,27,0,1,0
25,209,209,54,40,14,2,1
21,228,228,13,13,0,1,0
5,229,229,29,29,0,1,0
11,242,242,7,2,5,2,1
0,265,265,76,64,12,4,3
2,279,279,6,6,0,1,0
9,284,284,79,79,0,1,0
15,314,314,10,7,3,2,1
10,320,320,18,14,4,2,1
14,339,339,42,42,0,1,0
19,354,354,37,16,21,2,1
16,367,367,58,48,10,3,2
20,381,381,5,1,4,2,1
6,386,386,39,12,27,2,1
13,400,400,3,3,0,1,0
7,446,446,36,36,0,1,0
26,455,455,93,46,47,2,1
3,455,455,21,7,14,3,2
18,467,467,33,33,0,1,0
8,489,489,11,5,6,2,1

16,117,117,17,17,0,1,0
17,132,132,6,1,5,2,1
23,142,142,1,1,0,1,0
1,161,161,4,4,0,1,0
5,175,175,5,5,0,1,0
26,206,206,11,2,9,4,3
18,210,210,2,2,0,1,0
22,237,237,26,2,24,4,3
3,245,245,39,39,0,1,0
4,252,252,32,14,18,4,3
13,288,288,77,8,69,4,3
19,288,288,37,5,32,3,2
11,295,295,14,14,0,1,0
0,301,301,1,1,0,1,0
7,304,304,15,15,0,1,0
9,322,322,9,9,0,1,0
25,340,340,1,1,0,1,0
6,378,378,1,1,0,1,0
21,403,403,19,13,6,2,1
14,404,404,13,13,0,1,0
30,407,407,17,17,0,1,0
12,412,412,60,39,21,3,2
20,415,415,14,7,7,2,1
2,426,426,34,10,24,3,2
8,434,434,11,6,5,2,1
29,440,440,116,104,12,4,3
24,443,443,102,36,66,4,3
27,443,443,29,1,28,3,2
10,454,454,15,15,0,1,0
15,483,483,28,28,0,1,0
28,488,488,162,162,0,1,0

6,175,175,2,2,0,1,0
17,205,205,1,1,0,1,0
14,237,237,13,13,0,1,0
20,249,249,3,3,0,1,0
15,264,264,3,3,0,1,0
3,272,272,38,38,0,1,0
8,293,293,56,20,36,3,2
1,310,310,4,4,0,1,0
7,321,321,1,1,0,1,0
21,332,332,38,38,0,1,0
22,334,334,234,192,42,4,3
4,335,335,14,14,0,1,0
24,337,337,38,38,0,1,0
9,338,338,4,4,0,1,0
18,342,342,61,42,19,2,1
16,348,348,16,16,0,1,0
27,362,362,2,2,0,1,0
25,367,367,28,10,18,3,2
5,383,383,13,5,8,2,1
0,395,395,86,55,31,4,3
11,411,411,69,69,0,1,0
13,416,416,26,26,0,1,0
19,430,430,4,4,0,1,0
26,430,430,20,20,0,1,0
2,444,444,59,5,54,4,3
10,462,462,54,20,34,2,1
12,480,480,50,35,15,4,3
23,500,500,4,1,3,2,1

1,100,100,1,1,0,1,0
19,102,102,9,3,6,2,1
26,129,129,2,2,0,1,0
11,155,155,11,2,9,4,3
6,177,177,9,6,3,2,1
17,186,186,15,15,0,1,0
0,197,197,2,2,0,1,0
14,224,224,5,5,0,1,0
4,230,230,15,15,0,1,0
21,235,235,16,16,0,1,0
28,236,236,5,5,0,1,0
5,237,237,28,28,0,1,0
13,247,247,31,31,0,1,0
23,311,311,46,46,0,1,0
12,340,340,54,18,36,2,1
2,366,366,22,22,0,1,0
24,380,380,84,84,0,1,0
15,409,409,80,80,0,1,0
3,417,417,25,13,12,2,1
29,429,429,112,94,18,2,1
25,444,444,16,16,0,1,0
9,445,445,47,47,0,1,0
7,446,446,1,1,0,1,0
20,450,450,50,22,28,3,2
10,455,455,11,11,0,1,0
18,458,458,10,10,0,1,0
16,471,471,51,45,6,3,2
22,475,475,9,9,0,1,0
8,491,491,56,56,0,1,0
27,496,496,117,56,61,4,3

13,117,117,12,3,9,4,3
8,142,142,10,10,0,1,0
10,154,154,7,7,0,1,0
20,158,158,3,3,0,1,0
1,159,159,5,2,3,2,1
0,167,167,7,7,0,1,0
28,187,187,52,10,42,4,3
15,207,207,7,7,0,1,0
22,222,222,18,2,16,3,2
7,236,236,1,1,0,1,0
23,239,239,4,4,0,1,0
19,239,239,29,29,0,1,0
4,287,287,11,11,0,1,0
17,316,316,16,16,0,1,0
2,325,325,6,6,0,1,0
24,326,326,58,43,15,4,3
26,326,326,43,25,18,3,2
6,334,334,17,17,0,1,0
12,349,349,3,3,0,1,0
21,378,378,25,25,0,1,0
16,397,397,9,9,0,1,0
11,412,412,27,17,10,3,2
14,425,425,148,104,44,2,1
5,428,428,29,15,14,3,2
18,441,441,10,2,8,3,2
3,443,443,118,112,6,2,1
9,478,478,51,47,4,2,1
27,479,479,7,7,0,1,0
25,500,500,162,162,0,1,0

18,122,122,20,8,12,4,3
14,169,169,52,52,0,1,0
10,172,172,22,22,0,1,0
20,182,182,28,28,0,1,0
2,198,198,11,2,9,3,2
7,201,201,24,24,0,1,0
22,224,224,8,4,4,2,1
13,273,273,24,9,15,4,3
3,275,275,105,56,49,2,1
0,289,289,4,4,0,1,0
6,294,294,29,29,0,1,0
17,305,305,4,4,0,1,0
9,326,326,54,54,0,1,0
23,333,333,20,20,0,1,0
5,349,349,51,31,20,2,1
8,362,362,19,19,0,1,0
4,363,363,1,1,0,1,0
12,387,387,75,75,0,1,0
21,400,400,17,17,0,1,0
1,401,401,56,27,29,2,1
19,430,430,66,18,48,4,3
16,445,445,18,18,0,1,0
15,468,468,23,23,0,1,0
11,472,472,10,1,9,4,3

9,168,168,18,18,0,1,0
25,201,201,1,1,0,1,0
23,211,211,8,8,0,1,0
16,217,217,1,1,0,1,0
13,219,219,24,24,0,1,0
8,221,221,24,24,0,1,0
7,227,227,10,10,0,1,0
1,231,231,22,22,0,1,0
6,233,233,19,19,0,1,0
2,238,238,6,2,4,2,1
31,242,242,40,4,36,3,2
10,258,258,32,32,0,1,0
30,273,273,38,38,0,1,0
29,279,279,8,8,0,1,0
33,293,293,85,85,0,1,0
14,311,311,45,18,27,4,3
3,312,312,8,8,0,1,0
24,317,317,29,5,24,2,1
5,318,318,7,2,5,2,1
17,336,336,4,1,3,2,1
12,340,340,19,4,15,4,3
19,353,353,23,23,0,1,0
18,370,370,12,3,9,2,1
22,400,400,23,17,6,2,1
26,401,401,49,43,6,3,2
20,403,403,27,27,0,1,0
0,411,411,9,9,0,1,0
28,423,423,13,13,0,1,0
11,441,441,53,10,43,3,2
15,441,441,13,13,0,1,0
21,445,445,27,27,0,1,0
4,446,446,2,2,0,1,0
27,475,475,101,56,45,4,3
32,496,496,40,40,0,1,0

30,124,124,22,22,0,1,0
27,125,125,14,5,9,2,1
21,133,133,10,1,9,2,1
7,148,148,7,7,0,1,0
12,156,156,6,6,0,1,0
32,164,164,3,3,0,1,0
28,173,173,8,8,0,1,0
15,181,181,8,8,0,1,0
6,197,197,14,4,10,3,2
0,204,204,26,10,16,2,1
1,208,208,61,61,0,1,0
8,260,260,11,11,0,1,0
20,287,287,121,100,21,2,1
4,295,295,41,1,40,3,2
5,307,307,11,11,0,1,0
23,325,325,29,29,0,1,0
2,334,334,14,10,4,2,1
11,335,335,9,1,8,3,2
3,344,344,22,10,12,3,2
26,352,352,20,20,0,1,0
13,354,354,1,1,0,1,0
31,369,369,83,83,0,1,0
10,369,369,2,2,0,1,0
25,381,381,1,1,0,1,0
16,386,386,13,13,0,1,0
24,386,386,24,12,12,4,3
17,388,388,1,1,0,1,0
29,404,404,12,12,0,1,0
19,408,408,26,20,6,3,2
9,442,442,21,21,0,1,0
18,470,470,18,18,0,1,0
22,486,486,3,3,0,1,0
14,499,499,68,53,15,4,3

6,110,110,5,5,0,1,0
15,134,134,24,11,13,4,3
21,156,156,22,4,18,4,3
17,190,190,45,1,44,2,1
5,201,201,11,3,8,3,2
9,240,240,15,15,0,1,0
26,251,251,49,49,0,1,0
19,280,280,42,42,0,1,0
0,282,282,17,11,6,3,2
18,282,282,37,6,31,2,1
16,284,284,5,1,4,2,1
20,300,300,36,36,0,1,0
23,308,308,4,4,0,1,0
12,331,331,56,56,0,1,0
7,346,346,20,17,3,2,1
3,348,348,12,12,0,1,0
2,353,353,41,41,0,1,0
14,372,372,4,4,0,1,0
8,396,396,52,34,18,2,1
1,403,403,1,1,0,1,0
25,437,437,15,5,10,3,2
10,442,442,2,2,0,1,0
13,449,449,141,53,88,4,3
27,451,451,4,4,0,1,0
24,469,469,8,2,6,3,2
11,474,474,75,61,14,2,1
4,491,491,39,39,0,1,0
22,493,493,41,41,0,1,0

10,113,113,34,19,15,4,3
19,114,114,4,4,0,1,0
2,126,126,13,8,5,2,1
1,136,136,2,2,0,1,0
15,138,138,41,41,0,1,0
13,152,152,5,1,4,2,1
26,178,178,8,8,0,1,0
7,181,181,29,29,0,1,0
20,185,185,41,19,22,2,1
5,218,218,1,1,0,1,0
8,224,224,8,8,0,1,0
12,225,225,61,37,24,2,1
0,242,242,5,2,3,2,1
25,264,264,10,1,9,4,3
16,273,273,11,11,0,1,0
17,276,276,3,3,0,1,0
21,278,278,36,36,0,1,0
4,293,293,4,4,0,1,0
18,355,355,88,37,51,4,3
3,379,379,3,3,0,1,0
14,388,388,3,3,0,1,0
6,413,413,38,2,36,2,1
22,418,418,21,18,3,2,1
9,443,443,59,59,0,1,0
24,446,446,25,14,11,2,1
23,454,454,32,20,12,4,3
11,490,490,51,51,0,1,0
27,496,496,43,43,0,1,0

3,101,101,19,6,13,2,1
16,103,103,37,18,19,2,1
12,105,105,11,11,0,1,0
14,143,143,29,29,0,1,0
11,196,196,8,8,0,1,0
15,200,200,1,1,0,1,0
8,220,220,30,18,12,4,3
17,229,229,10,10,0,1,0
0,231,231,29,19,10,2,1
7,236,236,7,7,0,1,0
13,275,275,7,7,0,1,0
10,311,311,69,69,0,1,0
2,325,325,21,21,0,1,0
20,329,329,5,5,0,1,0
21,350,350,14,14,0,1,0
19,396,396,19,10,9,4,3
5,400,400,178,62,116,4,3
6,415,415,67,55,12,4,3
1,434,434,28,16,12,3,2
4,466,466,41,41,0,1,0
18,472,472,22,22,0,1,0
9,480,480,80,80,0,1,0

34,133,133,3,3,0,1,0
21,140,140,4,4,0,1,0
17,150,150,10,10,0,1,0
15,169,169,7,7,0,1,0
0,174,174,5,5,0,1,0
24,175,175,29,29,0,1,0
26,189,189,4,4,0,1,0
22,203,203,6,1,5,2,1
14,205,205,40,16,24,2,1
32,206,206,24,13,11,2,1
7,207,207,7,7,0,1,0
6,227,227,3,3,0,1,0
10,250,250,13,8,5,2,1
11,252,252,12,12,0,1,0
35,266,266,4,4,0,1,0
16,313,313,1,1,0,1,0
29,319,319,193,193,0,1,0
19,321,321,13,13,0,1,0
1,331,331,20,20,0,1,0
33,335,335,27,18,9,4,3
23,365,365,33,29,4,2,1
5,387,387,35,35,0,1,0
31,391,391,1,1,0,1,0
27,394,394,35,2,33,4,3
8,395,395,62,62,0,1,0
13,399,399,3,3,0,1,0
2,404,404,25,25,0,1,0
4,405,405,18,18,0,1,0
12,410,410,11,6,5,2,1
28,422,422,3,3,0,1,0
9,425,425,1,1,0,1,0
25,434,434,31,9,22,3,2
18,455,455,5,5,0,1,0
30,464,464,18,9,9,4,3
3,487,487,28,9,19,2,1
20,496,496,100,1,99,4,3

16,141,141,21,21,0,1,0
7,172,172,13,1,12,2,1
19,195,195,68,19,49,2,1
13,223,223,2,2,0,1,0
9,240,240,28,28,0,1,0
8,253,253,56,56,0,1,0
3,274,274,26,11,15,4,3
1,285,285,30,30,0,1,0
23,296,296,35,12,23,3,2
15,309,309,34,16,18,4,3
4,314,314,23,17,6,2,1
11,319,319,14,14,0,1,0
0,322,322,24,24,0,1,0
24,342,342,13,13,0,1,0
20,367,367,62,62,0,1,0
10,368,368,3,3,0,1,0
17,376,376,4,1,3,2,1
5,377,377,97,49,48,3,2
2,385,385,4,1,3,2,1
6,390,390,86,86,0,1,0
14,393,393,11,11,0,1,0
18,429,429,8,3,5,2,1
21,438,438,1,1,0,1,0
12,452,452,40,2,38,2,1
22,457,457,109,87,22,2,1

3,126,126,7,7,0,1,0
14,127,127,1,1,0,1,0
31,133,133,9,9,0,1,0
8,134,134,3,3,0,1,0
10,153,153,8,8,0,1,0
19,156,156,7,7,0,1,0
17,161,161,16,16,0,1,0
5,182,182,23,5,18,3,2
21,197,197,30,20,10,3,2
27,199,199,11,11,0,1,0
0,233,233,34,16,18,3,2
26,257,257,44,44,0,1,0
6,274,274,6,6,0,1,0
11,288,288,2,2,0,1,0
4,297,297,2,2,0,1,0
7,302,302,28,28,0,1,0
22,325,325,6,6,0,1,0
13,339,339,6,6,0,1,0
29,342,342,75,33,42,4,3
23,347,347,39,14,25,2,1
28,373,373,20,20,0,1,0
25,376,376,38,17,21,4,3
20,380,380,38,24,14,2,1
1,383,383,4,4,0,1,0
16,396,396,44,44,0,1,0
24,416,416,15,15,0,1,0
15,435,435,74,74,0,1,0
32,439,439,82,74,8,3,2
12,446,446,16,5,11,2,1
18,456,456,22,15,7,2,1
30,471,471,22,22,0,1,0
9,486,486,39,21,18,4,3
2,489,489,72,36,36,2,1

21,111,111,1,1,0,1,0
5,126,126,3,3,0,1,0
8,128,128,1,1,0,1,0
33,130,130,8,8,0,1,0
11,138,138,3,3,0,1,0
17,158,158,15,15,0,1,0
10,180,180,3,3,0,1,0
1,181,181,9,9,0,1,0
7,191,191,6,6,0,1,0
36,255,255,24,5,19,2,1
19,260,260,29,29,0,1,0
29,270,270,24,8,16,2,1
15,285,285,3,3,0,1,0
25,300,300,73,38,35,4,3
35,307,307,2,2,0,1,0
14,309,309,51,51,0,1,0
4,327,327,8,8,0,1,0
13,347,347,44,44,0,1,0
12,364,364,6,1,5,2,1
6,367,367,8,8,0,1,0
3,370,370,74,74,0,1,0
0,375,375,1,1,0,1,0
30,391,391,6,6,0,1,0
31,398,398,81,63,18,4,3
34,409,409,148,148,0,1,0
28,409,409,2,2,0,1,0
23,416,416,30,30,0,1,0
9,426,426,45,45,0,1,0
26,434,434,10,10,0,1,0
24,437,437,3,3,0,1,0
27,451,451,17,9,8,3,2
16,454,454,3,3,0,1,0
18,461,461,49,49,0,1,0
22,469,469,21,21,0,1,0
20,479,479,11,11,0,1,0
32,482,482,80,80,0,1,0
2,498,498,4,4,0,1,0

5,125,125,1,1,0,1,0
14,137,137,33,3,30,2,1
27,174,174,3,3,0,1,0
18,175,175,32,32,0,1,0
3,180,180,1,1,0,1,0
22,196,196,32,13,19,2,1
19,211,211,26,26,0,1,0
2,236,236,17,17,0,1,0
24,241,241,5,5,0,1,0
21,250,250,54,54,0,1,0
15,278,278,27,27,0,1,0
20,285,285,69,45,24,2,1
9,305,305,22,3,19,2,1
26,312,312,37,25,12,4,3
11,324,324,19,1,18,3,2
16,335,335,1,1,0,1,0
0,342,342,26,26,0,1,0
17,358,358,15,9,6,3,2
8,366,366,14,14,0,1,0
4,367,367,60,60,0,1,0
12,368,368,54,48,6,3,2
10,370,370,12,12,0,1,0
1,426,426,81,81,0,1,0
6,448,448,5,5,0,1,0
23,451,451,36,24,12,3,2
13,463,463,79,79,0,1,0
7,469,469,9,9,0,1,0
25,491,491,10,4,6,2,1

8,120,120,31,9,22,3,2
19,153,153,3,3,0,1,0
22,180,180,17,17,0,1,0
16,180,180,7,3,4,2,1
7,196,196,55,55,0,1,0
13,213,213,28,9,19,2,1
12,221,221,11,8,3,2,1
15,228,228,26,26,0,1,0
10,246,246,26,6,20,3,2
4,249,249,26,6,20,3,2
6,283,283,37,1,36,4,3
0,289,289,7,7,0,1,0
20,300,300,46,46,0,1,0
14,305,305,6,6,0,1,0
3,307,307,42,33,9,2,1
21,327,327,33,33,0,1,0
18,329,329,75,60,15,4,3
1,334,334,2,2,0,1,0
17,334,334,18,18,0,1,0
11,380,380,26,26,0,1,0
2,437,437,22,14,8,2,1
5,473,473,40,40,0,1,0
9,483,483,58,58,0,1,0
23,492,492,123,77,46,4,3

7,121,121,20,20,0,1,0
5,127,127,50,24,26,4,3
13,129,129,11,11,0,1,0
21,155,155,3,3,0,1,0
3,163,163,25,6,19,4,3
16,164,164,7,4,3,2,1
17,173,173,18,5,13,2,1
9,221,221,6,6,0,1,0
19,227,227,3,3,0,1,0
2,279,279,36,14,22,2,1
8,332,332,46,46,0,1,0
6,340,340,63,19,44,4,3
10,344,344,87,1,86,4,3
0,345,345,2,2,0,1,0
20,369,369,62,62,0,1,0
14,382,382,99,55,44,2,1
4,418,418,6,6,0,1,0
1,420,420,37,3,34,3,2
22,442,442,81,75,6,2,1
11,454,454,36,8,28,3,2
18,456,456,2,2,0,1,0
12,457,457,45,33,12,3,2
15,475,475,9,9,0,1,0

7,119,119,10,6,4,2,1
17,133,133,16,16,0,1,0
26,148,148,9,9,0,1,0
11,149,149,3,3,0,1,0
0,158,158,1,1,0,1,0
16,210,210,10,10,0,1,0
10,215,215,11,11,0,1,0
1,236,236,3,3,0,1,0
3,240,240,16,16,0,1,0
13,276,276,1,1,0,1,0
22,279,279,17,17,0,1,0
9,290,290,3,3,0,1,0
2,334,334,12,12,0,1,0
29,356,356,8,5,3,2,1
25,374,374,108,108,0,1,0
15,390,390,97,97,0,1,0
20,391,391,2,2,0,1,0
18,392,392,86,86,0,1,0
5,395,395,55,55,0,1,0
27,400,400,6,6,0,1,0
6,410,410,11,11,0,1,0
28,425,425,50,50,0,1,0
23,464,464,41,41,0,1,0
24,468,468,110,110,0,1,0
19,471,471,17,7,10,3,2
12,476,476,59,47,12,2,1
4,476,476,37,37,0,1,0
8,480,480,43,22,21,4,3
14,483,483,124,36,88,3,2
21,483,483,26,26,0,1,0

15,134,134,5,5,0,1,0
0,137,137,7,1,6,3,2
11,151,151,7,7,0,1,0
1,154,154,35,20,15,2,1
14,157,157,29,15,14,3,2
3,179,179,3,3,0,1,0
16,181,181,15,15,0,1,0
27,183,183,4,4,0,1,0
6,184,184,1,1,0,1,0
18,186,186,2,2,0,1,0
28,194,194,24,5,19,2,1
29,212,212,66,9,57,3,2
19,212,212,18,5,13,3,2
20,218,218,23,14,9,2,1
21,221,221,7,4,3,2,1
8,226,226,2,2,0,1,0
30,255,255,23,6,17,2,1
12,268,268,5,5,0,1,0
26,283,283,37,37,0,1,0
23,306,306,22,22,0,1,0
10,314,314,8,3,5,2,1
9,321,321,5,2,3,2,1
4,327,327,18,18,0,1,0
13,331,331,20,13,7,2,1
2,373,373,23,23,0,1,0
5,391,391,37,37,0,1,0
24,394,394,19,4,15,2,1
25,395,395,3,3,0,1,0
17,399,399,64,40,24,2,1
7,444,444,66,18,48,2,1
22,474,474,132,111,21,4,3

26,103,103,5,5,0,1,0
7,103,103,1,1,0,1,0
11,106,106,8,8,0,1,0
18,118,118,14,14,0,1,0
15,123,123,1,1,0,1,0
20,166,166,1,1,0,1,0
22,167,167,24,5,19,2,1
23,177,177,18,4,14,2,1
3,240,240,4,4,0,1,0
4,277,277,13,4,9,2,1
12,279,279,23,23,0,1,0
2,284,284,36,36,0,1,0
5,332,332,104,89,15,2,1
25,341,341,87,25,62,3,2
24,346,346,18,8,10,2,1
16,348,348,16,16,0,1,0
8,359,359,18,7,11,2,1
19,379,379,77,59,18,4,3
10,386,386,26,18,8,3,2
21,395,395,23,23,0,1,0
0,415,415,103,7,96,3,2
9,439,439,45,21,24,4,3
17,445,445,34,34,0,1,0
6,445,445,50,50,0,1,0
14,449,449,89,89,0,1,0
13,451,451,20,4,16,2,1
1,495,495,3,3,0,1,0

10,113,113,7,3,4,2,1
9,118,118,13,13,0,1,0
21,141,141,26,26,0,1,0
18,149,149,22,22,0,1,0
17,160,160,9,9,0,1,0
25,194,194,8,8,0,1,0
11,218,218,50,50,0,1,0
27,231,231,1,1,0,1,0
2,235,235,35,35,0,1,0
12,241,241,23,8,15,4,3
15,265,265,4,4,0,1,0
23,265,265,4,4,0,1,0
24,289,289,9,9,0,1,0
22,339,339,49,5,44,3,2
26,345,345,10,2,8,2,1
19,349,349,106,106,0,1,0
0,385,385,6,1,5,2,1
16,390,390,5,1,4,2,1
13,391,391,22,19,3,2,1
4,402,402,12,12,0,1,0
1,414,414,45,45,0,1,0
8,429,429,38,20,18,2,1
6,439,439,59,59,0,1,0
20,446,446,69,47,22,3,2
28,459,459,11,11,0,1,0
14,465,465,15,15,0,1,0
29,479,479,91,55,36,2,1
5,481,481,36,31,5,2,1
7,492,492,9,2,7,2,1
3,498,498,34,17,17,2,1

11,115,115,13,13,0,1,0
23,125,125,8,2,6,2,1
8,128,128,2,2,0,1,0
21,149,149,6,3,3,2,1
29,150,150,1,1,0,1,0
17,151,151,21,16,5,2,1
12,162,162,12,12,0,1,0
16,165,165,5,5,0,1,0
28,198,198,4,4,0,1,0
7,225,225,40,18,22,2,1
26,233,233,6,3,3,2,1
0,258,258,4,1,3,2,1
5,259,259,34,13,21,4,3
25,282,282,8,8,0,1,0
6,284,284,22,22,0,1,0
4,323,323,29,29,0,1,0
22,323,323,5,5,0,1,0
15,336,336,10,1,9,2,1
9,339,339,67,67,0,1,0
14,353,353,9,9,0,1,0
3,361,361,12,12,0,1,0
2,373,373,9,1,8,2,1
18,386,386,85,47,38,3,2
20,391,391,132,52,80,4,3
10,396,396,58,47,11,2,1
19,408,408,78,29,49,2,1
27,442,442,90,27,63,4,3
24,480,480,19,19,0,1,0
13,489,489,14,10,4,2,1
1,494,494,47,19,28,2,1

21,127,127,1,1,0,1,0
18,130,130,7,7,0,1,0
17,137,137,2,2,0,1,0
15,140,140,25,22,3,2,1
1,145,145,58,46,12,3,2
11,156,156,27,27,0,1,0
4,189,189,38,38,0,1,0
19,198,198,8,8,0,1,0
12,226,226,4,4,0,1,0
22,254,254,10,10,0,1,0
14,267,267,9,9,0,1,0
2,268,268,1,1,0,1,0
6,271,271,38,4,34,3,2
16,272,272,44,44,0,1,0
7,290,290,39,19,20,2,1
8,293,293,38,16,22,3,2
10,310,310,91,91,0,1,0
0,341,341,20,20,0,1,0
5,352,352,36,2,34,2,1
9,378,378,14,14,0,1,0
20,411,411,92,80,12,3,2
13,495,495,46,46,0,1,0
3,496,496,47,47,0,1,0

24,109,109,1,1,0,1,0
13,154,154,3,3,0,1,0
6,156,156,30,15,15,4,3
4,187,187,4,4,0,1,0
15,199,199,2,2,0,1,0
22,226,226,33,15,18,4,3
17,228,228,46,46,0,1,0
5,255,255,2,2,0,1,0
25,294,294,18,7,11,2,1
16,307,307,22,17,5,2,1
12,318,318,17,10,7,2,1
2,337,337,96,96,0,1,0
10,363,363,47,1,46,3,2
1,368,368,9,9,0,1,0
18,369,369,110,74,36,4,3
21,374,374,25,25,0,1,0
27,384,384,31,16,15,2,1
23,388,388,6,6,0,1,0
20,392,392,23,23,0,1,0
11,393,393,13,6,7,2,1
0,410,410,37,5,32,3,2
14,421,421,2,2,0,1,0
7,426,426,38,20,18,4,3
3,435,435,78,33,45,2,1
26,445,445,127,13,114,4,3
8,452,452,77,73,4,2,1
19,462,462,11,3,8,2,1
9,496,496,1,1,0,1,0

13,119,119,17,17,0,1,0
15,137,137,4,4,0,1,0
23,154,154,7,7,0,1,0
16,159,159,3,3,0,1,0
20,204,204,35,11,24,2,1
25,221,221,42,3,39,4,3
5,226,226,47,29,18,2,1
10,240,240,6,6,0,1,0
11,271,271,21,21,0,1,0
7,278,278,20,15,5,2,1
21,312,312,45,45,0,1,0
17,321,321,17,17,0,1,0
18,333,333,16,11,5,2,1
0,335,335,80,28,52,3,2
4,339,339,61,61,0,1,0
22,347,347,10,1,9,2,1
8,365,365,7,7,0,1,0
24,389,389,67,58,9,4,3
1,393,393,16,16,0,1,0
2,409,409,29,29,0,1,0
19,421,421,58,40,18,4,3
9,426,426,10,2,8,3,2
14,447,447,64,64,0,1,0
3,457,457,103,62,41,2,1
12,471,471,56,27,29,2,1
6,494,494,1,1,0,1,0

16,102,102,2,2,0,1,0
17,114,114,21,21,0,1,0
5,183,183,4,4,0,1,0
23,191,191,31,3,28,2,1
13,197,197,26,18,8,3,2
10,215,215,55,40,15,4,3
14,232,232,18,18,0,1,0
19,234,234,22,10,12,4,3
0,235,235,74,6,68,3,2
22,274,274,17,1,16,2,1
7,299,299,40,8,32,2,1
6,310,310,10,6,4,2,1
18,357,357,56,56,0,1,0
2,358,358,56,56,0,1,0
15,363,363,2,2,0,1,0
21,378,378,44,44,0,1,0
3,406,406,97,49,48,4,3
4,417,417,12,3,9,4,3
20,441,441,28,28,0,1,0
8,449,449,1,1,0,1,0
11,454,454,112,66,46,4,3
1,484,484,29,12,17,3,2
12,489,489,1,1,0,1,0
9,493,493,29,29,0,1,0

11,112,112,1,1,0,1,0
1,113,113,3,3,0,1,0
19,134,134,13,8,5,2,1
0,139,139,9,9,0,1,0
18,163,163,60,60,0,1,0
7,164,164,1,1,0,1,0
21,186,186,19,7,12,3,2
15,190,190,8,1,7,2,1
22,191,191,14,8,6,2,1
12,213,213,52,52,0,1,0
10,237,237,88,88,0,1,0
23,248,248,55,37,18,2,1
4,269,269,26,16,10,2,1
20,285,285,6,6,0,1,0
5,289,289,11,3,8,3,2
17,295,295,31,31,0,1,0
6,300,300,96,96,0,1,0
9,342,342,10,10,0,1,0
13,376,376,66,1,65,4,3
2,403,403,1,1,0,1,0
25,425,425,18,10,8,3,2
3,427,427,13,13,0,1,0
14,434,434,2,2,0,1,0
16,446,446,3,3,0,1,0
8,456,456,30,30,0,1,0
24,488,488,36,36,0,1,0

14,109,109,28,28,0,1,0
8,144,144,3,3,0,1,0
2,146,146,19,19,0,1,0
0,161,161,106,16,90,3,2
11,161,161,13,13,0,1,0
1,169,169,4,4,0,1,0
17,172,172,21,21,0,1,0
19,185,185,10,3,7,2,1
15,192,192,13,13,0,1,0
23,208,208,3,3,0,1,0
10,262,262,13,13,0,1,0
9,282,282,10,10,0,1,0
12,286,286,21,10,11,2,1
4,288,288,23,23,0,1,0
21,359,359,57,13,44,4,3
5,381,381,3,3,0,1,0
16,398,398,33,1,32,3,2
20,415,415,7,4,3,2,1
22,432,432,8,8,0,1,0
3,433,433,11,11,0,1,0
13,436,436,104,30,74,3,2
24,438,438,61,36,25,2,1
6,440,440,80,80,0,1,0
7,459,459,4,4,0,1,0
18,477,477,38,22,16,3,2

15,105,105,5,1,4,2,1
10,117,117,10,4,6,3,2
4,129,129,22,22,0,1,0
16,130,130,81,81,0,1,0
5,187,187,40,40,0,1,0
1,253,253,6,2,4,2,1
9,278,278,12,4,8,3,2
11,282,282,7,1,6,2,1
2,285,285,209,155,54,4,3
18,357,357,7,7,0,1,0
17,359,359,64,64,0,1,0
6,381,381,5,5,0,1,0
3,401,401,23,23,0,1,0
12,417,417,6,1,5,2,1
0,462,462,48,48,0,1,0
8,470,470,41,1,40,3,2
13,470,470,74,74,0,1,0
7,477,477,11,5,6,3,2
14,497,497,4,1,3,2,1

15,112,112,1,1,0,1,0
19,139,139,5,2,3,2,1
23,161,161,38,38,0,1,0
12,172,172,5,5,0,1,0
16,174,174,4,4,0,1,0
4,177,177,2,2,0,1,0
26,194,194,30,18,12,3,2
24,196,196,4,4,0,1,0
11,206,206,88,52,36,4,3
28,221,221,28,28,0,1,0
14,233,233,37,3,34,3,2
1,249,249,26,26,0,1,0
17,253,253,34,34,0,1,0
10,325,325,1,1,0,1,0
8,338,338,11,11,0,1,0
0,354,354,17,17,0,1,0
25,359,359,24,24,0,1,0
27,385,385,6,6,0,1,0
3,387,387,12,3,9,4,3
5,397,397,30,30,0,1,0
13,410,410,67,67,0,1,0
22,414,414,119,25,94,4,3
7,421,421,32,4,28,4,3
6,429,429,13,13,0,1,0
18,442,442,28,11,17,2,1
2,443,443,4,4,0,1,0
20,472,472,41,25,16,3,2
21,478,478,36,36,0,1,0
9,480,480,47,12,35,2,1

20,109,109,20,1,19,2,1
24,123,123,1,1,0,1,0
13,136,136,12,8,4,2,1
8,141,141,15,15,0,1,0
3,145,145,7,4,3,2,1
0,169,169,13,13,0,1,0
10,191,191,15,15,0,1,0
25,213,213,13,13,0,1,0
18,234,234,40,25,15,4,3
4,237,237,26,23,3,2,1
14,259,259,1,1,0,1,0
6,274,274,39,29,10,3,2
2,280,280,98,86,12,2,1
15,289,289,14,4,10,2,1
17,298,298,49,19,30,2,1
11,339,339,14,6,8,2,1
12,348,348,7,7,0,1,0
16,359,359,128,86,42,3,2
23,391,391,3,3,0,1,0
26,408,408,24,20,4,2,1
21,417,417,63,63,0,1,0
5,434,434,6,2,4,2,1
19,442,442,12,2,10,3,2
22,444,444,36,36,0,1,0
1,445,445,22,8,14,2,1
7,454,454,31,31,0,1,0
9,463,463,51,51,0,1,0

20,127,127,26,26,0,1,0
22,145,145,11,11,0,1,0
9,156,156,16,16,0,1,0
19,178,178,8,2,6,3,2
16,184,184,8,8,0,1,0
17,186,186,33,17,16,2,1
11,211,211,27,27,0,1,0
21,214,214,36,36,0,1,0
12,219,219,2,2,0,1,0
10,219,219,61,61,0,1,0
5,224,224,18,8,10,3,2
24,242,242,4,4,0,1,0
1,264,264,35,20,15,2,1
2,268,268,3,3,0,1,0
15,292,292,25,25,0,1,0
23,297,297,6,6,0,1,0
18,319,319,59,59,0,1,0
14,335,335,73,26,47,2,1
0,341,341,2,2,0,1,0
4,369,369,51,6,45,2,1
13,382,382,27,7,20,2,1
3,404,404,77,74,3,2,1
6,415,415,41,10,31,2,1
7,435,435,59,47,12,4,3
8,488,488,1,1,0,1,0

13,115,115,19,19,0,1,0
9,137,137,13,13,0,1,0
8,157,157,36,10,26,3,2
16,178,178,20,20,0,1,0
7,205,205,6,6,0,1,0
1,207,207,12,12,0,1,0
22,214,214,37,3,34,3,2
14,224,224,13,13,0,1,0
11,227,227,18,18,0,1,0
21,233,233,33,1,32,2,1
2,244,244,30,30,0,1,0
23,282,282,32,10,22,4,3
18,287,287,25,4,21,2,1
15,303,303,44,44,0,1,0
10,368,368,2,2,0,1,0
0,375,375,14,14,0,1,0
19,390,390,31,31,0,1,0
5,398,398,74,64,10,3,2
17,404,404,26,2,24,2,1
4,414,414,25,25,0,1,0
12,422,422,10,10,0,1,0
20,433,433,34,34,0,1,0
6,454,454,149,139,10,4,3
3,462,462,69,17,52,3,2

15,140,140,1,1,0,1,0
0,145,145,88,88,0,1,0
7,282,282,63,35,28,3,2
9,299,299,3,3,0,1,0
6,319,319,10,10,0,1,0
3,321,321,73,7,66,4,3
1,343,343,98,23,75,4,3
13,349,349,141,141,0,1,0
4,395,395,14,14,0,1,0
8,408,408,1,1,0,1,0
12,410,410,7,1,6,3,2
2,416,416,75,19,56,4,3
14,427,427,13,2,11,2,1
16,436,436,32,32,0,1,0
5,444,444,59,59,0,1,0
10,474,474,81,21,60,3,2
11,489,489,90,70,20,2,1

17,102,102,3,3,0,1,0
3,159,159,25,25,0,1,0
14,164,164,39,9,30,4,3
20,178,178,18,18,0,1,0
2,179,179,26,26,0,1,0
10,217,217,3,3,0,1,0
8,230,230,75,75,0,1,0
0,232,232,6,6,0,1,0
13,238,238,1,1,0,1,0
4,240,240,5,5,0,1,0
15,242,242,9,1,8,2,1
6,268,268,60,14,46,3,2
11,270,270,45,20,25,3,2
12,273,273,52,52,0,1,0
22,276,276,25,25,0,1,0
21,288,288,44,1,43,2,1
7,311,311,11,11,0,1,0
18,323,323,22,22,0,1,0
9,336,336,4,4,0,1,0
16,337,337,29,29,0,1,0
5,374,374,24,24,0,1,0
23,394,394,40,37,3,2,1
19,408,408,24,24,0,1,0
1,459,459,127,34,93,4,3

5,123,123,22,22,0,1,0
11,148,148,19,19,0,1,0
17,155,155,2,2,0,1,0
13,163,163,1,1,0,1,0
2,178,178,20,20,0,1,0
7,203,203,3,3,0,1,0
10,204,204,6,6,0,1,0
20,209,209,12,12,0,1,0
19,231,231,29,29,0,1,0
6,236,236,30,30,0,1,0
18,238,238,28,28,0,1,0
23,250,250,54,40,14,2,1
21,330,330,97,61,36,3,2
12,336,336,61,61,0,1,0
22,336,336,12,12,0,1,0
16,373,373,44,26,18,2,1
1,381,381,27,27,0,1,0
3,407,407,129,53,76,3,2
9,423,423,24,24,0,1,0
0,423,423,111,111,0,1,0
15,475,475,10,10,0,1,0
4,483,483,24,9,15,2,1
14,487,487,4,4,0,1,0
8,498,498,41,41,0,1,0

19,101,101,10,10,0,1,0
16,113,113,2,2,0,1,0
21,128,128,16,16,0,1,0
14,141,141,15,15,0,1,0
6,160,160,11,11,0,1,0
18,177,177,37,37,0,1,0
28,197,197,23,23,0,1,0
1,200,200,1,1,0,1,0
25,214,214,13,1,12,3,2
27,232,232,9,9,0,1,0
5,257,257,15,4,11,2,1
10,271,271,10,7,3,2,1
7,291,291,38,11,27,4,3
12,297,297,26,6,20,3,2
2,298,298,25,19,6,3,2
26,312,312,26,4,22,3,2
22,338,338,29,26,3,2,1
23,352,352,9,9,0,1,0
4,356,356,1,1,0,1,0
11,419,419,89,1,88,3,2
8,421,421,42,42,0,1,0
20,421,421,13,1,12,2,1
24,423,423,96,72,24,3,2
9,444,444,1,1,0,1,0
17,449,449,64,46,18,4,3
13,454,454,63,60,3,2,1
15,470,470,33,33,0,1,0
29,477,477,39,39,0,1,0
0,482,482,51,29,22,3,2
3,493,493,38,38,0,1,0

27,123,123,22,22,0,1,0
10,131,131,8,8,0,1,0
5,131,131,9,9,0,1,0
12,140,140,7,4,3,2,1
0,141,141,9,6,3,2,1
19,149,149,19,6,13,2,1
8,169,169,16,10,6,2,1
24,172,172,29,4,25,2,1
17,208,208,16,16,0,1,0
11,220,220,23,23,0,1,0
21,267,267,32,32,0,1,0
18,286,286,55,6,49,3,2
7,287,287,40,32,8,2,1
20,318,318,9,9,0,1,0
13,324,324,12,7,5,2,1
3,325,325,12,12,0,1,0
23,340,340,47,47,0,1,0
22,348,348,8,4,4,2,1
14,357,357,2,2,0,1,0
9,389,389,45,20,25,2,1
6,426,426,4,4,0,1,0
16,439,439,56,22,34,3,2
26,469,469,13,4,9,2,1
4,473,473,8,2,6,3,2
1,473,473,118,118,0,1,0
25,483,483,8,8,0,1,0
15,484,484,51,31,20,3,2
2,486,486,121,107,14,3,2

29,102,102,4,4,0,1,0
10,106,106,3,3,0,1,0
23,133,133,23,11,12,3,2
21,139,139,11,5,6,3,2
4,151,151,36,36,0,1,0
9,161,161,9,9,0,1,0
1,181,181,55,55,0,1,0
18,188,188,5,5,0,1,0
22,192,192,3,3,0,1,0
8,193,193,7,7,0,1,0
15,194,194,1,1,0,1,0
0,196,196,4,4,0,1,0
16,196,196,8,8,0,1,0
19,212,212,10,10,0,1,0
13,214,214,24,14,10,3,2
3,215,215,35,5,30,4,3
14,219,219,9,9,0,1,0
17,221,221,37,37,0,1,0
28,252,252,10,1,9,3,2
2,276,276,17,8,9,4,3
20,278,278,15,15,0,1,0
25,333,333,35,35,0,1,0
12,352,352,37,37,0,1,0
27,362,362,8,8,0,1,0
11,368,368,1,1,0,1,0
24,379,379,14,14,0,1,0
5,415,415,20,2,18,2,1
26,434,434,227,156,71,4,3
6,444,444,1,1,0,1,0
7,490,490,18,12,6,2,1

12,120,120,21,21,0,1,0
17,202,202,36,36,0,1,0
4,224,224,16,16,0,1,0
21,228,228,3,3,0,1,0
18,228,228,7,7,0,1,0
7,235,235,20,7,13,2,1
2,293,293,36,36,0,1,0
1,300,300,41,41,0,1,0
14,312,312,15,8,7,2,1
0,318,318,24,21,3,2,1
16,357,357,148,82,66,4,3
8,365,365,59,15,44,2,1
13,377,377,21,12,9,4,3
19,402,402,64,10,54,3,2
10,414,414,31,12,19,2,1
15,415,415,18,12,6,2,1
5,416,416,17,9,8,3,2
3,451,451,229,201,28,2,1
6,460,460,46,39,7,2,1
20,465,465,3,3,0,1,0
11,468,468,14,4,10,2,1
9,482,482,46,35,11,4,3

19,121,121,24,1,23,2,1
20,133,133,11,11,0,1,0
12,133,133,4,4,0,1,0
16,156,156,13,13,0,1,0
7,158,158,29,6,23,2,1
4,160,160,23,11,12,4,3
11,194,194,3,3,0,1,0
6,220,220,3,3,0,1,0
14,226,226,10,10,0,1,0
21,241,241,42,42,0,1,0
2,251,251,11,7,4,2,1
18,253,253,67,67,0,1,0
5,281,281,7,7,0,1,0
15,301,301,51,7,44,2,1
0,312,312,70,6,64,3,2
8,325,325,83,83,0,1,0
9,358,358,47,15,32,2,1
22,377,377,29,21,8,2,1
1,379,379,63,63,0,1,0
17,395,395,5,5,0,1,0
10,396,396,18,18,0,1,0
24,438,438,58,58,0,1,0
3,444,444,25,7,18,3,2
23,476,476,3,3,0,1,0
13,487,487,28,28,0,1,0

2,128,128,3,3,0,1,0
12,149,149,3,3,0,1,0
14,176,176,1,1,0,1,0
13,196,196,14,14,0,1,0
25,202,202,8,3,5,2,1
15,216,216,17,17,0,1,0
16,269,269,50,50,0,1,0
6,271,271,35,23,12,3,2
0,290,290,1,1,0,1,0
17,311,311,18,1,17,2,1
28,325,325,110,14,96,4,3
11,326,326,1,1,0,1,0
1,332,332,57,39,18,3,2
7,365,365,105,45,60,3,2
5,370,370,2,2,0,1,0
10,386,386,25,25,0,1,0
22,392,392,7,7,0,1,0
4,398,398,52,52,0,1,0
3,408,408,65,48,17,2,1
18,418,418,3,3,0,1,0
26,418,418,16,16,0,1,0
23,419,419,8,8,0,1,0
19,430,430,27,16,11,2,1
21,430,430,66,66,0,1,0
27,446,446,48,5,43,4,3
9,454,454,57,12,45,4,3
8,472,472,10,10,0,1,0
20,474,474,92,92,0,1,0
24,489,489,46,46,0,1,0

24,117,117,26,26,0,1,0
9,165,165,4,4,0,1,0
20,170,170,1,1,0,1,0
10,173,173,70,4,66,4,3
8,181,181,4,4,0,1,0
18,188,188,18,18,0,1,0
5,210,210,14,14,0,1,0
23,279,279,80,64,16,2,1
21,279,279,2,2,0,1,0
22,283,283,36,36,0,1,0
7,310,310,9,9,0,1,0
1,314,314,22,22,0,1,0
0,332,332,14,14,0,1,0
15,337,337,2,2,0,1,0
17,345,345,36,2,34,2,1
6,367,367,21,21,0,1,0
11,391,391,17,3,14,3,2
2,393,393,38,38,0,1,0
13,394,394,30,30,0,1,0
14,395,395,48,2,46,3,2
4,416,416,19,19,0,1,0
12,466,466,5,5,0,1,0
3,472,472,189,189,0,1,0
16,492,492,87,87,0,1,0
19,492,492,43,43,0,1,0

18,102,102,4,4,0,1,0
19,108,108,15,15,0,1,0
2,119,119,10,6,4,2,1
9,142,142,17,14,3,2,1
0,154,154,4,4,0,1,0
11,192,192,35,15,20,3,2
21,204,204,17,7,10,2,1
22,209,209,4,4,0,1,0
1,210,210,36,36,0,1,0
20,221,221,29,29,0,1,0
13,253,253,4,4,0,1,0
10,259,259,111,111,0,1,0
7,261,261,16,13,3,2,1
3,272,272,15,2,13,2,1
6,272,272,1,1,0,1,0
4,286,286,58,19,39,4,3
5,317,317,21,3,18,2,1
8,341,341,28,28,0,1,0
12,343,343,30,30,0,1,0
16,351,351,51,24,27,4,3
17,411,411,25,25,0,1,0
14,445,445,118,109,9,4,3
15,473,473,75,75,0,1,0
23,495,495,1,1,0,1,0

7,101,101,1,1,0,1,0
20,121,121,9,9,0,1,0
22,127,127,15,15,0,1,0
16,137,137,9,2,7,2,1
17,155,155,10,10,0,1,0
9,174,174,1,1,0,1,0
21,174,174,22,10,12,4,3
19,197,197,45,45,0,1,0
1,206,206,24,24,0,1,0
2,210,210,4,4,0,1,0
14,243,243,2,2,0,1,0
18,252,252,46,46,0,1,0
0,253,253,44,44,0,1,0
5,262,262,6,6,0,1,0
23,284,284,39,39,0,1,0
26,302,302,73,7,66,4,3
6,309,309,22,2,20,2,1
12,348,348,6,2,4,2,1
15,407,407,20,16,4,2,1
10,413,413,110,110,0,1,0
11,426,426,5,5,0,1,0
25,430,430,13,9,4,2,1
4,433,433,135,75,60,4,3
8,448,448,11,11,0,1,0
13,450,450,75,15,60,4,3
24,463,463,3,3,0,1,0
3,493,493,41,41,0,1,0

3,113,113,1,1,0,1,0
19,169,169,8,8,0,1,0
1,174,174,22,3,19,4,3
8,218,218,26,6,20,3,2
9,223,223,1,1,0,1,0
15,232,232,50,50,0,1,0
14,250,250,26,10,16,3,2
23,257,257,29,19,10,3,2
24,259,259,3,3,0,1,0
22,283,283,29,29,0,1,0
25,306,306,4,4,0,1,0
27,307,307,12,2,10,2,1
2,308,308,7,7,0,1,0
11,316,316,20,20,0,1,0
26,337,337,59,59,0,1,0
20,352,352,91,91,0,1,0
5,365,365,6,6,0,1,0
21,375,375,27,1,26,4,3
7,375,375,16,3,13,2,1
0,378,378,27,3,24,3,2
13,408,408,104,104,0,1,0
4,427,427,34,24,10,2,1
10,436,436,18,5,13,2,1
17,442,442,36,2,34,2,1
6,452,452,3,3,0,1,0
12,463,463,157,123,34,2,1
16,479,479,89,89,0,1,0
18,479,479,3,3,0,1,0

2,101,101,9,9,0,1,0
28,119,119,1,1,0,1,0
3,120,120,20,2,18,2,1
23,129,129,7,7,0,1,0
20,136,136,14,14,0,1,0
16,160,160,2,2,0,1,0
19,174,174,7,2,5,2,1
29,180,180,36,2,34,2,1
30,213,213,16,16,0,1,0
22,241,241,84,48,36,3,2
1,267,267,52,52,0,1,0
17,275,275,4,4,0,1,0
0,278,278,3,3,0,1,0
21,282,282,42,6,36,2,1
24,306,306,12,6,6,3,2
32,311,311,40,1,39,4,3
5,313,313,7,2,5,2,1
9,315,315,19,12,7,2,1
11,319,319,22,22,0,1,0
8,320,320,12,12,0,1,0
27,327,327,12,8,4,2,1
13,354,354,4,1,3,2,1
18,365,365,63,63,0,1,0
12,372,372,20,20,0,1,0
10,378,378,45,31,14,2,1
6,425,425,1,1,0,1,0
25,431,431,102,32,70,3,2
14,445,445,37,37,0,1,0
33,457,457,7,7,0,1,0
15,464,464,1,1,0,1,0
31,472,472,7,4,3,2,1
4,479,479,10,1,9,4,3
26,494,494,10,10,0,1,0
7,495,495,9,9,0,1,0

2,113,113,6,6,0,1,0
18,128,128,11,11,0,1,0
17,162,162,1,1,0,1,0
22,168,168,36,36,0,1,0
16,178,178,30,7,23,4,3
10,183,183,19,10,9,2,1
8,194,194,1,1,0,1,0
26,219,219,2,2,0,1,0
12,238,238,15,15,0,1,0
23,239,239,31,15,16,3,2
24,242,242,47,47,0,1,0
5,243,243,16,7,9,4,3
32,256,256,11,11,0,1,0
4,271,271,7,1,6,2,1
7,276,276,48,7,41,4,3
13,289,289,11,11,0,1,0
28,291,291,6,3,3,2,1
1,300,300,1,1,0,1,0
30,332,332,5,5,0,1,0
21,336,336,16,11,5,2,1
14,344,344,27,2,25,4,3
11,349,349,6,6,0,1,0
25,378,378,96,2,94,3,2
31,383,383,56,56,0,1,0
0,390,390,14,14,0,1,0
3,397,397,9,3,6,3,2
33,399,399,8,8,0,1,0
27,421,421,76,76,0,1,0
9,428,428,72,72,0,1,0
20,435,435,35,6,29,2,1
19,452,452,7,7,0,1,0
15,462,462,11,11,0,1,0
29,474,474,24,24,0,1,0
6,491,491,33,33,0,1,0

1,107,107,1,1,0,1,0
6,138,138,1,1,0,1,0
12,150,150,19,19,0,1,0
0,168,168,24,24,0,1,0
23,245,245,104,104,0,1,0
19,258,258,22,22,0,1,0
21,267,267,6,6,0,1,0
9,272,272,63,35,28,3,2
11,278,278,3,3,0,1,0
22,288,288,4,4,0,1,0
20,332,332,23,23,0,1,0
14,338,338,64,12,52,4,3
5,342,342,37,13,24,4,3
16,354,354,47,47,0,1,0
2,354,354,54,21,33,4,3
3,367,367,13,3,10,3,2
17,379,379,40,40,0,1,0
7,413,413,1,1,0,1,0
10,419,419,13,10,3,2,1
8,425,425,48,36,12,4,3
13,435,435,30,30,0,1,0
18,448,448,9,9,0,1,0
15,472,472,21,18,3,2,1
4,480,480,225,191,34,4,3

11,122,122,7,7,0,1,0
16,133,133,8,2,6,3,2
14,140,140,6,6,0,1,0
25,162,162,28,11,17,2,1
7,167,167,3,3,0,1,0
24,169,169,13,1,12,3,2
2,181,181,3,3,0,1,0
6,195,195,1,1,0,1,0
26,196,196,6,6,0,1,0
10,202,202,71,7,64,3,2
15,226,226,15,3,12,4,3
1,243,243,28,14,14,3,2
9,244,244,23,23,0,1,0
23,259,259,10,2,8,3,2
19,274,274,60,14,46,3,2
12,298,298,18,18,0,1,0
17,318,318,16,16,0,1,0
18,322,322,27,27,0,1,0
3,328,328,7,3,4,2,1
8,335,335,5,5,0,1,0
20,351,351,62,23,39,4,3
13,365,365,34,34,0,1,0
0,382,382,41,14,27,4,3
21,385,385,74,74,0,1,0
22,425,425,51,5,46,4,3
4,471,471,121,94,27,4,3
5,493,493,44,44,0,1,0

15,111,111,33,17,16,2,1
6,128,128,1,1,0,1,0
18,142,142,13,3,10,4,3
20,151,151,15,1,14,2,1
9,155,155,1,1,0,1,0
5,159,159,12,12,0,1,0
8,188,188,12,12,0,1,0
26,195,195,14,3,11,2,1
13,213,213,13,3,10,3,2
11,218,218,36,36,0,1,0
24,226,226,1,1,0,1,0
17,235,235,11,6,5,2,1
25,237,237,24,11,13,2,1
2,250,250,1,1,0,1,0
23,256,256,30,14,16,3,2
27,267,267,3,3,0,1,0
1,306,306,46,46,0,1,0
22,314,314,84,12,72,4,3
0,314,314,93,65,28,4,3
19,326,326,62,2,60,3,2
7,330,330,49,19,30,3,2
16,357,357,12,6,6,3,2
3,376,376,38,38,0,1,0
21,393,393,3,3,0,1,0
12,427,427,22,8,14,4,3
4,439,439,5,5,0,1,0
14,463,463,13,5,8,3,2
10,490,490,64,64,0,1,0

11,105,105,1,1,0,1,0
9,106,106,22,22,0,1,0
3,109,109,1,1,0,1,0
4,111,111,13,13,0,1,0
19,114,114,8,3,5,2,1
8,121,121,7,7,0,1,0
20,122,122,10,10,0,1,0
16,129,129,6,6,0,1,0
28,132,132,5,5,0,1,0
24,138,138,7,1,6,2,1
18,171,171,14,14,0,1,0
10,195,195,2,2,0,1,0
14,199,199,22,1,21,4,3
25,218,218,29,29,0,1,0
12,240,240,7,7,0,1,0
6,268,268,10,4,6,2,1
17,272,272,20,20,0,1,0
33,272,272,23,23,0,1,0
32,272,272,36,36,0,1,0
30,293,293,24,24,0,1,0
2,296,296,18,18,0,1,0
26,300,300,26,3,23,4,3
5,316,316,4,4,0,1,0
13,319,319,40,40,0,1,0
7,336,336,1,1,0,1,0
1,344,344,3,3,0,1,0
27,346,346,43,43,0,1,0
23,365,365,44,18,26,2,1
22,386,386,51,51,0,1,0
21,406,406,63,63,0,1,0
0,425,425,32,32,0,1,0
31,459,459,51,46,5,2,1
29,462,462,30,30,0,1,0
15,498,498,37,29,8,2,1

6,104,104,2,2,0,1,0
9,126,126,20,2,18,2,1
17,141,141,2,2,0,1,0
11,150,150,4,4,0,1,0
10,160,160,12,12,0,1,0
18,207,207,49,24,25,4,3
26,209,209,37,37,0,1,0
0,236,236,2,2,0,1,0
3,242,242,8,4,4,2,1
5,250,250,2,2,0,1,0
25,269,269,23,23,0,1,0
7,297,297,77,51,26,2,1
12,316,316,32,26,6,2,1
24,325,325,11,3,8,2,1
21,348,348,25,25,0,1,0
13,355,355,32,11,21,2,1
1,359,359,60,60,0,1,0
14,360,360,22,19,3,2,1
23,385,385,19,19,0,1,0
2,385,385,19,1,18,4,3
20,389,389,53,53,0,1,0
16,392,392,92,43,49,2,1
4,396,396,5,2,3,2,1
8,412,412,121,93,28,3,2
19,440,440,6,6,0,1,0
15,474,474,41,5,36,3,2
22,480,480,58,8,50,2,1

15,105,105,21,9,12,4,3
2,143,143,8,8,0,1,0
18,149,149,3,3,0,1,0
12,155,155,7,7,0,1,0
24,158,158,18,2,16,4,3
25,181,181,26,26,0,1,0
10,202,202,3,3,0,1,0
5,231,231,10,10,0,1,0
23,263,263,43,9,34,2,1
6,267,267,1,1,0,1,0
26,271,271,11,11,0,1,0
19,290,290,18,18,0,1,0
14,298,298,66,66,0,1,0
16,299,299,8,2,6,3,2
8,310,310,27,9,18,4,3
22,336,336,13,13,0,1,0
7,344,344,28,28,0,1,0
1,346,346,17,9,8,2,1
21,351,351,33,33,0,1,0
3,351,351,8,2,6,3,2
20,353,353,35,35,0,1,0
0,390,390,37,22,15,4,3
17,425,425,46,7,39,2,1
11,442,442,61,15,46,4,3
9,445,445,195,156,39,3,2
4,455,455,53,53,0,1,0
13,492,492,54,18,36,4,3

9,105,105,25,25,0,1,0
19,108,108,3,3,0,1,0
1,127,127,11,11,0,1,0
2,138,138,10,3,7,2,1
0,153,153,7,7,0,1,0
23,158,158,15,15,0,1,0
11,167,167,11,11,0,1,0
12,178,178,6,6,0,1,0
18,184,184,40,40,0,1,0
7,206,206,32,32,0,1,0
3,209,209,32,32,0,1,0
5,217,217,3,3,0,1,0
15,221,221,24,24,0,1,0
24,224,224,2,2,0,1,0
6,227,227,15,5,10,3,2
22,235,235,66,66,0,1,0
4,259,259,29,20,9,2,1
21,296,296,33,25,8,3,2
25,304,304,2,2,0,1,0
8,326,326,9,9,0,1,0
17,375,375,4,4,0,1,0
13,382,382,1,1,0,1,0
26,428,428,42,42,0,1,0
14,428,428,12,9,3,2,1
16,431,431,62,62,0,1,0
10,436,436,99,45,54,4,3
20,483,483,95,48,47,3,2

10,118,118,21,3,18,4,3
9,187,187,5,2,3,2,1
5,202,202,71,71,0,1,0
6,203,203,35,20,15,3,2
13,210,210,17,7,10,3,2
12,215,215,90,90,0,1,0
22,225,225,21,1,20,3,2
3,235,235,10,3,7,2,1
23,247,247,8,8,0,1,0
21,247,247,67,41,26,2,1
2,249,249,1,1,0,1,0
20,256,256,9,9,0,1,0
18,279,279,22,9,13,3,2
19,312,312,22,22,0,1,0
0,330,330,52,52,0,1,0
4,345,345,20,8,12,4,3
1,366,366,11,11,0,1,0
14,441,441,15,15,0,1,0
17,442,442,3,3,0,1,0
7,446,446,60,60,0,1,0
11,453,453,31,16,15,2,1
8,463,463,68,68,0,1,0
15,477,477,20,6,14,3,2
16,497,497,44,44,0,1,0

12,113,113,33,6,27,4,3
21,137,137,18,18,0,1,0
19,142,142,18,18,0,1,0
6,180,180,6,6,0,1,0
20,181,181,43,43,0,1,0
1,187,187,9,9,0,1,0
28,193,193,12,1,11,3,2
26,193,193,4,4,0,1,0
27,220,220,43,21,22,3,2
22,222,222,22,15,7,2,1
18,233,233,1,1,0,1,0
8,239,239,4,1,3,2,1
17,241,241,6,6,0,1,0
31,244,244,1,1,0,1,0
29,273,273,54,27,27,2,1
30,281,281,18,4,14,2,1
10,283,283,1,1,0,1,0
24,362,362,3,3,0,1,0
7,370,370,1,1,0,1,0
0,370,370,61,55,6,3,2
14,373,373,22,22,0,1,0
11,382,382,8,8,0,1,0
9,382,382,14,2,12,3,2
23,401,401,59,34,25,2,1
3,434,434,14,14,0,1,0
13,434,434,9,5,4,2,1
4,458,458,112,68,44,3,2
25,461,461,17,17,0,1,0
5,471,471,33,22,11,2,1
15,475,475,23,11,12,4,3
16,482,482,48,4,44,4,3
2,483,483,38,38,0,1,0

21,100,100,2,2,0,1,0
6,105,105,22,22,0,1,0
4,144,144,2,2,0,1,0
20,149,149,8,8,0,1,0
12,153,153,17,17,0,1,0
24,157,157,19,1,18,3,2
22,165,165,12,12,0,1,0
25,166,166,43,43,0,1,0
18,172,172,19,8,11,2,1
7,185,185,24,24,0,1,0
11,198,198,12,12,0,1,0
30,199,199,4,4,0,1,0
10,201,201,2,2,0,1,0
17,203,203,5,5,0,1,0
1,222,222,1,1,0,1,0
28,230,230,4,1,3,2,1
26,288,288,128,95,33,4,3
13,312,312,1,1,0,1,0
5,315,315,6,6,0,1,0
2,344,344,86,17,69,4,3
14,357,357,5,5,0,1,0
3,384,384,9,9,0,1,0
0,403,403,8,8,0,1,0
23,410,410,41,11,30,3,2
27,451,451,2,2,0,1,0
16,465,465,19,3,16,3,2
15,466,466,136,40,96,4,3
9,471,471,32,5,27,2,1
29,484,484,31,31,0,1,0
19,491,491,22,1,21,4,3
8,500,500,3,3,0,1,0

18,118,118,2,2,0,1,0
0,118,118,9,2,7,2,1
13,123,123,17,17,0,1,0
10,125,125,22,15,7,2,1
23,135,135,1,1,0,1,0
8,157,157,1,1,0,1,0
11,180,180,11,11,0,1,0
17,191,191,27,27,0,1,0
1,198,198,6,6,0,1,0
5,198,198,16,16,0,1,0
24,207,207,9,9,0,1,0
29,210,210,6,6,0,1,0
6,219,219,7,3,4,2,1
16,226,226,3,3,0,1,0
7,237,237,2,2,0,1,0
30,239,239,4,4,0,1,0
3,276,276,7,7,0,1,0
4,280,280,27,27,0,1,0
25,291,291,125,110,15,2,1
19,297,297,44,44,0,1,0
27,310,310,55,55,0,1,0
14,316,316,10,10,0,1,0
26,324,324,7,7,0,1,0
20,332,332,33,33,0,1,0
22,367,367,103,31,72,4,3
21,415,415,22,12,10,3,2
2,426,426,15,6,9,2,1
28,427,427,1,1,0,1,0
15,459,459,75,48,27,4,3
12,470,470,54,5,49,4,3
9,475,475,34,34,0,1,0

8,151,151,27,10,17,2,1
17,154,154,35,35,0,1,0
2,194,194,7,7,0,1,0
14,196,196,18,2,16,3,2
0,221,221,12,12,0,1,0
23,233,233,3,3,0,1,0
16,264,264,7,7,0,1,0
9,270,270,1,1,0,1,0
19,319,319,64,51,13,2,1
13,320,320,15,10,5,2,1
22,322,322,50,50,0,1,0
10,322,322,83,49,34,2,1
21,340,340,22,5,17,2,1
7,341,341,28,13,15,2,1
5,348,348,30,10,20,2,1
20,359,359,38,38,0,1,0
12,377,377,3,3,0,1,0
1,384,384,50,44,6,2,1
6,393,393,33,33,0,1,0
11,395,395,38,38,0,1,0
15,405,405,13,7,6,3,2
24,428,428,100,100,0,1,0
3,447,447,44,44,0,1,0
25,451,451,3,3,0,1,0
18,463,463,55,25,30,3,2
4,472,472,87,3,84,4,3

7,112,112,10,10,0,1,0
11,130,130,17,7,10,2,1
18,132,132,1,1,0,1,0
25,135,135,30,30,0,1,0
2,150,150,18,18,0,1,0
13,164,164,2,2,0,1,0
9,173,173,12,12,0,1,0
17,187,187,27,12,15,4,3
6,201,201,16,3,13,2,1
3,208,208,53,21,32,2,1
8,210,210,16,1,15,4,3
22,223,223,12,12,0,1,0
14,241,241,54,54,0,1,0
20,281,281,20,20,0,1,0
16,287,287,20,15,5,2,1
19,292,292,9,9,0,1,0
5,319,319,43,43,0,1,0
21,324,324,5,5,0,1,0
26,332,332,13,13,0,1,0
1,367,367,19,19,0,1,0
4,371,371,6,6,0,1,0
23,387,387,89,89,0,1,0
10,404,404,88,24,64,4,3
0,428,428,13,1,12,2,1
12,464,464,9,4,5,2,1
24,476,476,65,14,51,4,3
15,479,479,40,22,18,2,1

9,105,105,17,8,9,2,1
17,107,107,1,1,0,1,0
18,115,115,1,1,0,1,0
11,178,178,13,13,0,1,0
16,182,182,5,5,0,1,0
20,184,184,4,4,0,1,0
25,200,200,45,45,0,1,0
14,201,201,2,2,0,1,0
4,234,234,2,2,0,1,0
22,251,251,31,31,0,1,0
19,265,265,17,17,0,1,0
26,270,270,46,22,24,2,1
2,281,281,3,3,0,1,0
28,290,290,32,32,0,1,0
1,294,294,24,5,19,2,1
27,317,317,16,12,4,2,1
23,320,320,58,13,45,4,3
24,336,336,13,7,6,3,2
10,363,363,65,5,60,4,3
6,364,364,45,45,0,1,0
5,369,369,67,48,19,2,1
29,397,397,11,11,0,1,0
30,418,418,63,30,33,4,3
13,427,427,32,32,0,1,0
15,430,430,1,1,0,1,0
12,440,440,78,6,72,4,3
0,442,442,16,2,14,3,2
21,443,443,29,29,0,1,0
7,446,446,9,1,8,3,2
8,448,448,27,27,0,1,0
3,495,495,27,3,24,2,1
31,495,495,45,36,9,4,3

12,101,101,13,4,9,4,3
7,103,103,15,12,3,2,1
16,129,129,9,1,8,3,2
14,142,142,4,1,3,2,1
11,153,153,47,47,0,1,0
6,158,158,15,15,0,1,0
0,169,169,83,47,36,4,3
9,186,186,14,14,0,1,0
10,189,189,6,6,0,1,0
18,192,192,10,10,0,1,0
1,194,194,12,1,11,2,1
15,200,200,21,21,0,1,0
5,222,222,52,12,40,3,2
2,250,250,61,21,40,2,1
4,272,272,32,9,23,2,1
3,272,272,42,42,0,1,0
8,297,297,26,14,12,2,1
17,322,322,14,14,0,1,0
13,435,435,75,75,0,1,0

11,121,121,1,1,0,1,0
1,129,129,45,45,0,1,0
17,144,144,21,21,0,1,0
9,148,148,12,4,8,2,1
18,238,238,6,6,0,1,0
20,239,239,24,7,17,2,1
12,260,260,62,47,15,2,1
0,267,267,17,17,0,1,0
2,269,269,43,43,0,1,0
19,283,283,11,7,4,2,1
21,319,319,41,12,29,2,1
5,327,327,87,87,0,1,0
13,333,333,32,32,0,1,0
7,333,333,2,2,0,1,0
6,391,391,24,24,0,1,0
15,393,393,136,35,101,4,3
4,407,407,79,79,0,1,0
8,412,412,24,12,12,3,2
3,421,421,60,18,42,2,1
16,463,463,32,11,21,2,1
14,474,474,16,16,0,1,0
10,482,482,9,9,0,1,0

14,121,121,1,1,0,1,0
4,146,146,3,3,0,1,0
17,158,158,6,6,0,1,0
13,164,164,5,1,4,2,1
27,250,250,16,1,15,4,3
7,259,259,6,6,0,1,0
24,260,260,29,19,10,3,2
5,262,262,14,5,9,4,3
3,275,275,14,14,0,1,0
10,275,275,112,94,18,3,2
1,294,294,2,2,0,1,0
6,314,314,1,1,0,1,0
15,315,315,51,35,16,3,2
23,316,316,68,28,40,3,2
26,323,323,62,9,53,3,2
22,324,324,13,13,0,1,0
0,337,337,61,61,0,1,0
8,339,339,61,10,51,4,3
2,365,365,20,10,10,2,1
19,374,374,44,8,36,2,1
12,386,386,9,1,8,3,2
11,389,389,1,1,0,1,0
25,400,400,11,11,0,1,0
28,426,426,17,5,12,2,1
9,454,454,42,42,0,1,0
20,471,471,94,40,54,3,2
16,481,481,12,1,11,4,3
21,490,490,86,86,0,1,0
18,495,495,37,14,23,2,1

9,113,113,15,15,0,1,0
20,116,116,5,5,0,1,0
18,129,129,22,15,7,2,1
19,131,131,4,4,0,1,0
8,146,146,95,43,52,4,3
22,163,163,29,8,21,2,1
13,199,199,21,9,12,3,2
2,211,211,6,6,0,1,0
16,213,213,1,1,0,1,0
17,225,225,9,9,0,1,0
3,240,240,5,5,0,1,0
7,261,261,3,3,0,1,0
1,277,277,20,20,0,1,0
15,310,310,96,61,35,2,1
11,328,328,47,11,36,4,3
6,331,331,20,5,15,4,3
0,342,342,40,40,0,1,0
12,345,345,20,6,14,2,1
21,372,372,13,5,8,2,1
4,400,400,21,9,12,4,3
14,447,447,17,14,3,2,1
10,469,469,84,51,33,2,1
5,488,488,76,45,31,2,1

25,102,102,9,6,3,2,1
8,121,121,28,18,10,2,1
16,126,126,2,2,0,1,0
24,155,155,1,1,0,1,0
4,180,180,1,1,0,1,0
22,180,180,59,10,49,2,1
5,181,181,12,12,0,1,0
26,182,182,13,5,8,3,2
10,212,212,2,2,0,1,0
23,213,213,5,5,0,1,0
30,218,218,21,5,16,2,1
14,228,228,25,1,24,3,2
17,233,233,12,4,8,2,1
9,261,261,24,6,18,3,2
7,284,284,5,2,3,2,1
29,301,301,24,24,0,1,0
2,341,341,11,3,8,2,1
20,344,344,37,37,0,1,0
12,345,345,12,4,8,3,2
15,355,355,1,1,0,1,0
13,377,377,19,19,0,1,0
0,399,399,51,7,44,3,2
6,400,400,19,19,0,1,0
28,414,414,15,15,0,1,0
19,417,417,101,101,0,1,0
3,425,425,37,37,0,1,0
18,441,441,14,14,0,1,0
21,453,453,14,6,8,3,2
27,455,455,82,31,51,4,3
1,480,480,137,137,0,1,0
11,492,492,17,13,4,2,1

25,107,107,3,3,0,1,0
6,109,109,1,1,0,1,0
18,142,142,18,12,6,2,1
5,153,153,1,1,0,1,0
23,165,165,84,56,28,3,2
15,226,226,39,3,36,3,2
24,228,228,9,9,0,1,0
1,236,236,12,12,0,1,0
21,240,240,10,10,0,1,0
11,251,251,1,1,0,1,0
20,255,255,14,14,0,1,0
8,262,262,19,3,16,2,1
14,267,267,4,4,0,1,0
22,305,305,1,1,0,1,0
19,320,320,28,5,23,2,1
2,322,322,87,79,8,3,2
9,352,352,30,18,12,2,1
26,379,379,21,21,0,1,0
7,383,383,15,15,0,1,0
3,384,384,29,17,12,3,2
12,389,389,11,11,0,1,0
4,389,389,91,91,0,1,0
0,420,420,84,78,6,2,1
17,454,454,46,16,30,3,2
28,455,455,24,24,0,1,0
27,482,482,23,3,20,3,2
13,485,485,1,1,0,1,0
16,491,491,88,20,68,3,2
10,495,495,18,6,12,4,3

21,105,105,15,15,0,1,0
0,155,155,4,1,3,2,1
25,163,163,3,3,0,1,0
17,173,173,22,22,0,1,0
8,187,187,2,2,0,1,0
9,187,187,3,3,0,1,0
24,216,216,18,18,0,1,0
1,225,225,28,28,0,1,0
23,242,242,26,10,16,2,1
13,257,257,13,9,4,2,1
18,270,270,43,43,0,1,0
5,272,272,25,25,0,1,0
2,295,295,51,15,36,4,3
15,298,298,7,7,0,1,0
10,312,312,17,17,0,1,0
19,349,349,5,5,0,1,0
16,362,362,59,35,24,3,2
3,364,364,15,4,11,2,1
6,375,375,15,15,0,1,0
14,389,389,25,13,12,4,3
20,398,398,123,75,48,3,2
11,401,401,19,19,0,1,0
22,409,409,25,25,0,1,0
12,422,422,28,7,21,4,3
4,483,483,75,75,0,1,0
7,484,484,220,220,0,1,0

16,132,132,12,12,0,1,0
14,135,135,30,30,0,1,0
20,141,141,12,12,0,1,0
23,151,151,18,2,16,2,1
11,167,167,44,16,28,3,2
8,173,173,1,1,0,1,0
13,195,195,30,14,16,3,2
22,205,205,13,13,0,1,0
4,233,233,10,10,0,1,0
17,233,233,3,3,0,1,0
7,248,248,4,4,0,1,0
10,256,256,34,34,0,1,0
24,259,259,43,23,20,2,1
5,268,268,30,22,8,2,1
2,269,269,33,3,30,4,3
21,358,358,83,78,5,2,1
15,382,382,14,14,0,1,0
3,384,384,13,13,0,1,0
1,385,385,56,8,48,2,1
6,438,438,19,7,12,2,1
19,457,457,24,24,0,1,0
12,472,472,28,28,0,1,0
18,478,478,14,14,0,1,0
0,482,482,72,72,0,1,0
9,495,495,115,115,0,1,0

5,116,116,3,3,0,1,0
13,134,134,1,1,0,1,0
2,137,137,1,1,0,1,0
27,143,143,32,32,0,1,0
0,144,144,17,11,6,2,1
29,160,160,2,2,0,1,0
17,162,162,39,19,20,2,1
25,165,165,4,4,0,1,0
8,179,179,5,5,0,1,0
15,199,199,18,5,13,2,1
11,207,207,49,33,16,4,3
4,248,248,8,8,0,1,0
18,261,261,20,20,0,1,0
6,266,266,57,57,0,1,0
19,284,284,51,51,0,1,0
28,297,297,8,8,0,1,0
12,297,297,1,1,0,1,0
22,304,304,28,28,0,1,0
1,309,309,19,5,14,3,2
10,317,317,24,24,0,1,0
21,327,327,2,2,0,1,0
14,334,334,42,6,36,4,3
9,367,367,2,2,0,1,0
7,410,410,70,42,28,3,2
24,431,431,124,45,79,3,2
23,439,439,14,8,6,2,1
3,439,439,15,1,14,3,2
26,449,449,1,1,0,1,0
16,458,458,29,11,18,3,2
20,471,471,56,18,38,2,1

7,127,127,12,2,10,3,2
4,146,146,15,15,0,1,0
2,187,187,67,67,0,1,0
23,227,227,13,13,0,1,0
26,231,231,17,17,0,1,0
13,240,240,13,13,0,1,0
11,245,245,1,1,0,1,0
18,258,258,15,15,0,1,0
1,261,261,7,1,6,3,2
12,300,300,3,3,0,1,0
25,302,302,65,54,11,2,1
29,307,307,18,18,0,1,0
21,325,325,20,4,16,3,2
8,333,333,15,15,0,1,0
15,354,354,12,2,10,2,1
17,363,363,67,67,0,1,0
16,376,376,39,18,21,4,3
28,382,382,56,56,0,1,0
24,389,389,16,1,15,2,1
19,392,392,4,4,0,1,0
6,407,407,1,1,0,1,0
0,407,407,38,38,0,1,0
10,413,413,1,1,0,1,0
27,426,426,91,91,0,1,0
5,441,441,50,50,0,1,0
3,455,455,14,2,12,2,1
9,460,460,80,54,26,3,2
22,484,484,70,8,62,4,3
14,489,489,25,9,16,2,1
20,500,500,27,15,12,4,3

3,101,101,13,1,12,3,2
18,102,102,1,1,0,1,0
4,110,110,2,2,0,1,0
5,119,119,30,30,0,1,0
7,137,137,20,8,12,2,1
25,150,150,15,7,8,3,2
22,153,153,3,3,0,1,0
20,232,232,43,35,8,3,2
21,282,282,39,39,0,1,0
0,285,285,55,55,0,1,0
6,318,318,10,10,0,1,0
19,325,325,54,22,32,3,2
11,339,339,29,29,0,1,0
23,357,357,57,57,0,1,0
9,383,383,4,4,0,1,0
14,384,384,54,19,35,2,1
13,384,384,30,8,22,2,1
17,385,385,60,16,44,2,1
15,408,408,27,15,12,3,2
1,425,425,74,38,36,4,3
8,428,428,15,3,12,3,2
10,439,439,51,16,35,4,3
16,461,461,8,3,5,2,1
12,463,463,18,3,15,2,1
2,464,464,33,33,0,1,0
24,466,466,40,15,25,2,1

6,103,103,4,4,0,1,0
22,132,132,6,6,0,1,0
12,190,190,2,2,0,1,0
7,218,218,7,7,0,1,0
19,227,227,21,21,0,1,0
16,229,229,2,2,0,1,0
23,237,237,46,46,0,1,0
0,243,243,17,17,0,1,0
14,284,284,11,11,0,1,0
21,290,290,22,22,0,1,0
24,304,304,118,118,0,1,0
20,318,318,44,44,0,1,0
17,339,339,27,6,21,2,1
8,341,341,15,15,0,1,0
2,354,354,14,4,10,3,2
3,378,378,111,18,93,4,3
1,381,381,52,52,0,1,0
18,392,392,14,14,0,1,0
9,417,417,19,9,10,3,2
15,427,427,47,18,29,2,1
5,443,443,15,1,14,2,1
4,448,448,101,101,0,1,0
10,459,459,152,86,66,4,3
11,488,488,5,5,0,1,0
13,496,496,53,22,31,2,1

1,150,150,2,2,0,1,0
16,159,159,42,35,7,2,1
4,167,167,27,8,19,4,3
14,168,168,19,1,18,2,1
17,181,181,11,4,7,2,1
11,251,251,69,34,35,2,1
18,260,260,11,11,0,1,0
9,267,267,6,6,0,1,0
10,273,273,53,53,0,1,0
12,324,324,17,17,0,1,0
7,370,370,19,3,16,2,1
8,374,374,73,73,0,1,0
21,418,418,36,36,0,1,0
2,419,419,9,2,7,2,1
3,424,424,31,9,22,3,2
23,434,434,66,66,0,1,0
0,444,444,60,17,43,4,3
20,447,447,47,47,0,1,0
15,451,451,11,2,9,4,3
22,452,452,73,73,0,1,0
5,470,470,56,56,0,1,0
24,480,480,42,4,38,2,1
6,481,481,19,1,18,3,2
13,496,496,82,7,75,4,3
19,498,498,6,6,0,1,0

27,122,122,4,1,3,2,1
9,126,126,8,8,0,1,0
0,149,149,5,5,0,1,0
14,149,149,1,1,0,1,0
23,150,150,4,1,3,2,1
25,165,165,15,15,0,1,0
19,174,174,12,8,4,2,1
7,198,198,21,10,11,2,1
21,206,206,48,8,40,2,1
5,230,230,36,36,0,1,0
6,243,243,1,1,0,1,0
24,257,257,11,1,10,3,2
8,261,261,12,12,0,1,0
13,264,264,8,8,0,1,0
3,266,266,14,4,10,2,1
22,271,271,11,6,5,2,1
30,280,280,67,1,66,3,2
29,293,293,75,75,0,1,0
26,309,309,48,24,24,4,3
31,310,310,51,51,0,1,0
11,311,311,3,3,0,1,0
17,329,329,6,6,0,1,0
10,330,330,14,14,0,1,0
12,347,347,15,3,12,4,3
15,351,351,52,52,0,1,0
4,361,361,45,45,0,1,0
1,361,361,6,6,0,1,0
32,406,406,6,1,5,2,1
2,433,433,22,22,0,1,0
28,435,435,7,7,0,1,0
18,438,438,69,47,22,3,2
20,483,483,50,8,42,3,2
33,487,487,5,1,4,2,1
16,500,500,9,9,0,1,0

9,109,109,3,3,0,1,0
11,119,119,7,7,0,1,0
8,120,120,1,1,0,1,0
26,127,127,17,5,12,4,3
21,163,163,10,2,8,3,2
23,167,167,6,6,0,1,0
31,172,172,28,16,12,2,1
13,183,183,6,6,0,1,0
32,193,193,14,2,12,3,2
16,214,214,23,4,19,2,1
33,219,219,19,19,0,1,0
2,241,241,35,8,27,4,3
27,250,250,7,4,3,2,1
14,270,270,1,1,0,1,0
17,279,279,11,11,0,1,0
29,287,287,20,20,0,1,0
22,291,291,2,2,0,1,0
6,320,320,16,1,15,4,3
3,323,323,8,8,0,1,0
24,344,344,16,16,0,1,0
25,351,351,157,64,93,4,3
19,359,359,3,3,0,1,0
20,382,382,23,23,0,1,0
28,387,387,36,11,25,2,1
12,389,389,33,21,12,2,1
5,434,434,11,11,0,1,0
30,444,444,35,35,0,1,0
7,444,444,60,60,0,1,0
15,449,449,24,24,0,1,0
1,458,458,50,50,0,1,0
18,475,475,1,1,0,1,0
0,481,481,82,37,45,4,3
4,482,482,59,56,3,2,1
10,490,490,16,7,9,2,1

1,103,103,9,9,0,1,0
14,111,111,7,7,0,1,0
21,117,117,3,3,0,1,0
13,122,122,6,6,0,1,0
19,141,141,15,1,14,3,2
0,167,167,1,1,0,1,0
9,186,186,7,7,0,1,0
12,191,191,2,2,0,1,0
18,206,206,45,37,8,3,2
20,216,216,20,11,9,4,3
5,222,222,30,23,7,2,1
16,245,245,12,12,0,1,0
15,283,283,61,16,45,2,1
2,300,300,52,22,30,4,3
24,344,344,1,1,0,1,0
22,345,345,8,8,0,1,0
23,380,380,12,12,0,1,0
3,385,385,23,23,0,1,0
6,388,388,25,2,23,3,2
17,408,408,70,70,0,1,0
7,415,415,89,63,26,3,2
10,440,440,29,10,19,2,1
8,465,465,196,113,83,3,2
25,487,487,138,126,12,4,3
4,492,492,9,9,0,1,0
11,495,495,4,1,3,2,1

21,113,113,9,9,0,1,0
17,132,132,32,32,0,1,0
0,151,151,1,1,0,1,0
2,182,182,36,12,24,4,3
26,182,182,30,19,11,2,1
19,186,186,2,2,0,1,0
16,206,206,7,4,3,2,1
1,209,209,6,6,0,1,0
24,228,228,16,2,14,2,1
20,242,242,37,37,0,1,0
7,252,252,10,10,0,1,0
4,283,283,17,17,0,1,0
23,318,318,37,29,8,3,2
11,330,330,4,4,0,1,0
8,363,363,29,29,0,1,0
25,371,371,8,3,5,2,1
12,375,375,48,16,32,2,1
6,378,378,75,75,0,1,0
9,384,384,2,2,0,1,0
3,387,387,112,83,29,4,3
13,396,396,23,23,0,1,0
22,409,409,8,8,0,1,0
18,416,416,117,82,35,2,1
10,421,421,62,29,33,4,3
15,430,430,31,31,0,1,0
14,436,436,31,31,0,1,0
5,492,492,25,25,0,1,0

20,109,109,3,3,0,1,0
14,114,114,15,1,14,3,2
12,155,155,15,2,13,2,1
9,170,170,3,3,0,1,0
2,172,172,15,15,0,1,0
16,209,209,32,32,0,1,0
22,243,243,20,20,0,1,0
15,276,276,6,6,0,1,0
5,277,277,4,4,0,1,0
19,287,287,28,28,0,1,0
0,332,332,54,1,53,4,3
3,333,333,6,6,0,1,0
17,376,376,1,1,0,1,0
1,378,378,12,12,0,1,0
24,401,401,2,2,0,1,0
6,403,403,57,57,0,1,0
23,437,437,169,139,30,4,3
21,437,437,77,77,0,1,0
18,468,468,1,1,0,1,0
7,469,469,97,60,37,2,1
11,471,471,54,54,0,1,0
10,484,484,31,31,0,1,0
25,487,487,40,29,11,2,1
4,487,487,149,50,99,4,3
8,489,489,20,20,0,1,0
13,499,499,79,79,0,1,0

20,109,109,9,3,6,3,2
19,129,129,10,10,0,1,0
1,132,132,22,22,0,1,0
17,143,143,25,22,3,2,1
9,160,160,34,16,18,2,1
4,195,195,1,1,0,1,0
2,208,208,1,1,0,1,0
0,211,211,70,66,4,2,1
16,213,213,3,3,0,1,0
18,247,247,58,9,49,2,1
12,257,257,31,8,23,2,1
24,268,268,13,13,0,1,0
13,270,270,8,8,0,1,0
5,313,313,66,48,18,3,2
14,333,333,134,60,74,3,2
22,335,335,23,23,0,1,0
6,340,340,25,25,0,1,0
3,344,344,43,25,18,4,3
10,348,348,27,27,0,1,0
15,352,352,12,12,0,1,0
7,370,370,14,9,5,2,1
21,431,431,4,4,0,1,0
23,465,465,14,8,6,2,1
8,484,484,6,6,0,1,0
11,492,492,21,21,0,1,0

17,110,110,38,25,13,2,1
2,137,137,13,4,9,4,3
3,146,146,18,18,0,1,0
11,168,168,12,12,0,1,0
7,170,170,7,1,6,3,2
5,185,185,27,19,8,3,2
24,188,188,51,51,0,1,0
1,201,201,35,15,20,2,1
25,213,213,11,11,0,1,0
14,224,224,3,3,0,1,0
10,237,237,23,23,0,1,0
16,247,247,13,13,0,1,0
15,259,259,16,1,15,4,3
12,292,292,19,12,7,2,1
21,301,301,25,1,24,4,3
19,316,316,13,13,0,1,0
8,330,330,12,12,0,1,0
23,351,351,73,57,16,2,1
20,358,358,12,12,0,1,0
22,368,368,33,33,0,1,0
18,377,377,22,15,7,2,1
4,379,379,97,46,51,3,2
0,380,380,37,22,15,2,1
6,393,393,11,6,5,2,1
13,401,401,8,8,0,1,0
9,435,435,31,31,0,1,0

19,103,103,8,8,0,1,0
6,105,105,4,4,0,1,0
18,112,112,3,3,0,1,0
12,117,117,8,5,3,2,1
22,171,171,23,6,17,2,1
16,183,183,9,2,7,3,2
14,203,203,34,34,0,1,0
21,209,209,27,15,12,2,1
0,258,258,17,17,0,1,0
1,270,270,38,8,30,2,1
23,271,271,50,20,30,3,2
2,305,305,28,4,24,4,3
8,335,335,57,29,28,3,2
5,361,361,72,58,14,3,2
17,369,369,54,28,26,3,2
3,405,405,8,8,0,1,0
20,419,419,31,31,0,1,0
11,433,433,65,65,0,1,0
13,434,434,50,50,0,1,0
4,452,452,56,42,14,2,1
15,454,454,4,4,0,1,0
7,479,479,105,105,0,1,0
10,482,482,31,14,17,2,1
9,490,490,82,34,48,2,1

10,113,113,14,14,0,1,0
0,119,119,1,1,0,1,0
13,135,135,10,10,0,1,0
7,154,154,30,30,0,1,0
11,155,155,5,5,0,1,0
8,167,167,37,7,30,2,1
6,179,179,1,1,0,1,0
19,205,205,1,1,0,1,0
4,221,221,3,3,0,1,0
22,241,241,81,53,28,2,1
20,253,253,20,6,14,2,1
25,255,255,1,1,0,1,0
21,259,259,2,2,0,1,0
23,280,280,47,47,0,1,0
18,318,318,11,11,0,1,0
16,322,322,21,21,0,1,0
3,335,335,9,9,0,1,0
17,340,340,94,78,16,2,1
15,360,360,39,16,23,3,2
1,364,364,46,24,22,2,1
24,374,374,23,3,20,2,1
9,382,382,94,94,0,1,0
12,408,408,22,22,0,1,0
14,433,433,44,17,27,2,1
5,454,454,77,77,0,1,0
2,479,479,37,37,0,1,0

9,101,101,8,8,0,1,0
19,152,152,11,2,9,4,3
0,155,155,26,11,15,2,1
4,197,197,20,20,0,1,0
14,242,242,66,20,46,2,1
6,270,270,28,28,0,1,0
8,273,273,24,12,12,2,1
20,282,282,8,3,5,2,1
18,295,295,56,56,0,1,0
3,310,310,4,4,0,1,0
12,329,329,31,2,29,3,2
16,337,337,24,24,0,1,0
17,339,339,23,23,0,1,0
15,354,354,60,60,0,1,0
2,389,389,20,20,0,1,0
11,393,393,50,14,36,3,2
7,411,411,40,9,31,4,3
10,416,416,5,5,0,1,0
5,443,443,152,80,72,4,3
13,448,448,39,5,34,4,3
21,462,462,24,24,0,1,0
1,498,498,168,168,0,1,0

1,105,105,1,1,0,1,0
18,108,108,47,47,0,1,0
6,119,119,22,2,20,2,1
2,129,129,17,17,0,1,0
14,143,143,1,1,0,1,0
23,158,158,25,13,12,4,3
8,159,159,18,12,6,3,2
19,167,167,20,4,16,3,2
26,170,170,18,18,0,1,0
0,172,172,14,14,0,1,0
25,173,173,2,2,0,1,0
10,177,177,1,1,0,1,0
4,199,199,11,11,0,1,0
3,205,205,65,21,44,4,3
28,206,206,11,11,0,1,0
21,213,213,2,2,0,1,0
7,249,249,32,32,0,1,0
27,250,250,5,5,0,1,0
29,289,289,5,5,0,1,0
13,300,300,25,25,0,1,0
15,323,323,7,3,4,2,1
20,326,326,53,53,0,1,0
22,367,367,3,3,0,1,0
9,370,370,10,10,0,1,0
5,386,386,13,13,0,1,0
11,401,401,10,4,6,2,1
24,422,422,23,15,8,2,1
12,425,425,27,27,0,1,0
16,427,427,5,5,0,1,0
17,490,490,86,74,12,3,2

23,140,140,17,17,0,1,0
19,144,144,14,2,12,4,3
14,157,157,70,33,37,2,1
21,187,187,22,13,9,4,3
2,206,206,73,37,36,3,2
4,219,219,4,4,0,1,0
15,219,219,25,25,0,1,0
7,229,229,24,24,0,1,0
1,258,258,38,16,22,3,2
9,259,259,45,45,0,1,0
11,274,274,23,23,0,1,0
0,292,292,23,23,0,1,0
6,299,299,21,21,0,1,0
22,351,351,4,1,3,2,1
18,363,363,10,2,8,2,1
17,372,372,5,2,3,2,1
10,395,395,52,2,50,2,1
24,396,396,49,49,0,1,0
20,409,409,16,16,0,1,0
12,422,422,14,2,12,2,1
16,433,433,62,62,0,1,0
13,442,442,18,15,3,2,1
5,466,466,47,7,40,2,1
8,470,470,9,3,6,2,1
3,495,495,10,10,0,1,0

0,107,107,11,3,8,2,1
14,112,112,15,7,8,3,2
15,132,132,6,6,0,1,0
2,150,150,23,23,0,1,0
17,168,168,14,4,10,2,1
12,175,175,7,7,0,1,0
18,189,189,4,4,0,1,0
19,208,208,4,4,0,1,0
11,229,229,3,3,0,1,0
10,235,235,20,20,0,1,0
1,250,250,95,95,0,1,0
3,272,272,64,64,0,1,0
16,279,279,20,17,3,2,1
13,280,280,20,20,0,1,0
5,337,337,34,13,21,2,1
20,354,354,101,37,64,3,2
8,387,387,1,1,0,1,0
4,399,399,29,13,16,2,1
21,412,412,177,177,0,1,0
22,421,421,14,4,10,2,1
9,424,424,37,26,11,2,1
7,472,472,6,6,0,1,0
6,494,494,76,5,71,4,3

1,103,103,39,21,18,2,1
17,105,105,14,14,0,1,0
19,112,112,4,1,3,2,1
9,132,132,1,1,0,1,0
3,210,210,1,1,0,1,0
16,241,241,35,17,18,4,3
13,242,242,15,15,0,1,0
14,248,248,2,2,0,1,0
20,284,284,20,5,15,4,3
21,285,285,28,28,0,1,0
8,292,292,78,28,50,3,2
18,298,298,15,15,0,1,0
7,313,313,30,22,8,2,1
4,321,321,54,20,34,3,2
15,324,324,161,38,123,4,3
6,344,344,18,18,0,1,0
10,370,370,35,35,0,1,0
2,371,371,78,60,18,4,3
0,378,378,2,2,0,1,0
22,415,415,6,6,0,1,0
5,443,443,51,5,46,2,1
12,446,446,41,11,30,4,3
11,488,488,17,17,0,1,0

16,138,138,25,12,13,2,1
5,148,148,11,5,6,2,1
20,150,150,13,4,9,2,1
10,153,153,11,5,6,2,1
17,157,157,11,8,3,2,1
15,158,158,19,13,6,2,1
19,269,269,2,2,0,1,0
3,275,275,9,9,0,1,0
14,291,291,75,48,27,4,3
1,302,302,101,81,20,3,2
13,329,329,52,16,36,2,1
12,334,334,4,4,0,1,0
18,345,345,1,1,0,1,0
2,348,348,73,61,12,2,1
0,369,369,49,49,0,1,0
8,389,389,78,78,0,1,0
9,410,410,46,46,0,1,0
11,420,420,90,72,18,3,2
7,426,426,40,40,0,1,0
21,432,432,15,15,0,1,0
6,434,434,16,5,11,2,1
4,469,469,87,13,74,3,2

6,112,112,13,13,0,1,0
19,152,152,41,4,37,2,1
14,158,158,13,13,0,1,0
1,162,162,5,1,4,2,1
5,171,171,18,6,12,4,3
25,172,172,18,18,0,1,0
23,176,176,26,16,10,2,1
9,185,185,9,9,0,1,0
22,198,198,15,15,0,1,0
17,205,205,18,4,14,2,1
3,239,239,11,8,3,2,1
7,267,267,30,12,18,4,3
13,270,270,19,4,15,4,3
2,278,278,1,1,0,1,0
4,283,283,41,41,0,1,0
20,310,310,41,20,21,2,1
12,315,315,7,1,6,2,1
18,328,328,82,82,0,1,0
16,387,387,18,18,0,1,0
15,397,397,21,6,15,4,3
11,405,405,13,13,0,1,0
0,408,408,208,174,34,3,2
8,436,436,4,4,0,1,0
21,458,458,16,6,10,2,1
26,468,468,10,10,0,1,0
24,472,472,8,8,0,1,0
10,490,490,24,24,0,1,0

15,112,112,13,6,7,3,2
23,151,151,17,17,0,1,0
3,170,170,1,1,0,1,0
24,171,171,11,2,9,4,3
26,183,183,10,7,3,2,1
4,189,189,41,29,12,2,1
0,198,198,2,2,0,1,0
27,207,207,4,4,0,1,0
7,219,219,54,54,0,1,0
9,242,242,24,7,17,2,1
1,252,252,48,35,13,2,1
12,254,254,2,2,0,1,0
5,255,255,1,1,0,1,0
18,325,325,12,12,0,1,0
2,326,326,9,9,0,1,0
19,343,343,41,41,0,1,0
17,354,354,46,15,31,2,1
11,383,383,22,16,6,2,1
10,384,384,50,20,30,4,3
20,396,396,32,32,0,1,0
13,398,398,9,9,0,1,0
22,418,418,77,77,0,1,0
28,424,424,18,18,0,1,0
8,440,440,58,49,9,2,1
14,451,451,6,2,4,2,1
25,460,460,91,91,0,1,0
6,485,485,13,4,9,4,3
16,492,492,112,112,0,1,0
21,500,500,27,27,0,1,0

15,118,118,3,3,0,1,0
4,125,125,9,6,3,2,1
5,170,170,1,1,0,1,0
13,175,175,25,1,24,4,3
23,182,182,18,6,12,2,1
8,225,225,39,39,0,1,0
0,236,236,10,10,0,1,0
9,238,238,16,7,9,3,2
3,240,240,4,4,0,1,0
6,264,264,7,7,0,1,0
25,309,309,25,25,0,1,0
1,313,313,6,6,0,1,0
19,320,320,2,2,0,1,0
16,321,321,22,22,0,1,0
26,347,347,52,52,0,1,0
2,348,348,87,87,0,1,0
14,354,354,2,2,0,1,0
10,358,358,59,38,21,4,3
22,361,361,23,1,22,4,3
21,367,367,114,114,0,1,0
11,391,391,27,15,12,2,1
20,412,412,111,63,48,4,3
24,426,426,59,59,0,1,0
18,427,427,32,32,0,1,0
7,451,451,77,47,30,3,2
12,455,455,38,28,10,3,2
17,494,494,13,13,0,1,0

14,125,125,10,10,0,1,0
12,141,141,4,4,0,1,0
19,148,148,36,36,0,1,0
9,159,159,26,26,0,1,0
21,164,164,10,1,9,2,1
5,166,166,13,13,0,1,0
7,187,187,8,8,0,1,0
10,196,196,9,3,6,3,2
17,226,226,44,44,0,1,0
20,300,300,61,1,60,4,3
0,325,325,7,2,5,2,1
4,331,331,15,5,10,3,2
23,397,397,20,4,16,3,2
22,424,424,14,2,12,3,2
8,425,425,4,4,0,1,0
18,436,436,49,49,0,1,0
3,457,457,100,64,36,2,1
1,460,460,63,55,8,3,2
11,470,470,7,7,0,1,0
16,473,473,22,9,13,2,1
13,474,474,40,4,36,3,2
6,489,489,247,247,0,1,0
2,493,493,18,18,0,1,0
15,496,496,81,73,8,3,2

14,110,110,8,8,0,1,0
8,120,120,37,37,0,1,0
5,122,122,10,2,8,3,2
20,125,125,13,13,0,1,0
16,127,127,3,3,0,1,0
23,142,142,34,19,15,2,1
4,148,148,6,6,0,1,0
21,156,156,30,18,12,4,3
1,187,187,28,28,0,1,0
12,217,217,51,51,0,1,0
10,224,224,14,2,12,4,3
13,234,234,13,6,7,2,1
7,235,235,1,1,0,1,0
22,238,238,40,1,39,4,3
11,289,289,2,2,0,1,0
3,296,296,9,1,8,2,1
18,302,302,8,8,0,1,0
19,302,302,51,22,29,2,1
6,321,321,8,8,0,1,0
0,384,384,92,45,47,4,3
2,395,395,24,24,0,1,0
24,426,426,80,80,0,1,0
15,444,444,21,15,6,2,1
25,447,447,15,4,11,2,1
17,472,472,6,6,0,1,0
9,489,489,29,9,20,3,2

21,102,102,1,1,0,1,0
16,109,109,20,3,17,2,1
14,115,115,16,16,0,1,0
3,150,150,8,8,0,1,0
15,151,151,9,9,0,1,0
2,174,174,10,10,0,1,0
22,180,180,28,4,24,3,2
13,181,181,19,1,18,2,1
7,192,192,6,6,0,1,0
24,202,202,57,43,14,3,2
26,209,209,12,5,7,2,1
25,215,215,7,7,0,1,0
1,243,243,4,1,3,2,1
23,255,255,1,1,0,1,0
0,280,280,7,7,0,1,0
18,289,289,1,1,0,1,0
4,298,298,42,26,16,3,2
20,305,305,63,63,0,1,0
8,309,309,25,19,6,2,1
6,310,310,11,11,0,1,0
19,324,324,20,14,6,3,2
27,329,329,64,16,48,3,2
17,333,333,5,2,3,2,1
11,351,351,18,4,14,3,2
28,398,398,52,52,0,1,0
5,400,400,59,59,0,1,0
10,401,401,63,63,0,1,0
9,413,413,46,46,0,1,0
12,464,464,41,3,38,3,2

7,108,108,25,25,0,1,0
0,130,130,2,2,0,1,0
11,139,139,6,2,4,2,1
2,140,140,30,30,0,1,0
18,155,155,3,3,0,1,0
1,156,156,13,10,3,2,1
16,166,166,8,8,0,1,0
4,180,180,51,30,21,4,3
20,181,181,34,10,24,3,2
17,187,187,14,14,0,1,0
15,229,229,36,28,8,3,2
3,238,238,75,75,0,1,0
5,247,247,8,2,6,3,2
22,267,267,18,2,16,2,1
10,273,273,27,18,9,2,1
8,274,274,13,4,9,2,1
21,302,302,21,21,0,1,0
19,320,320,40,17,23,2,1
14,377,377,104,2,102,4,3
6,427,427,4,4,0,1,0
13,438,438,60,60,0,1,0
12,449,449,6,6,0,1,0
9,486,486,33,26,7,2,1

0,101,101,1,1,0,1,0
13,124,124,3,3,0,1,0
3,135,135,38,20,18,3,2
12,164,164,14,14,0,1,0
17,170,170,9,3,6,2,1
5,172,172,10,4,6,3,2
21,180,180,4,4,0,1,0
20,190,190,1,1,0,1,0
9,197,197,36,10,26,4,3
8,200,200,1,1,0,1,0
6,204,204,9,9,0,1,0
7,210,210,57,57,0,1,0
16,233,233,49,10,39,4,3
11,242,242,44,44,0,1,0
10,263,263,5,5,0,1,0
18,286,286,33,3,30,2,1
2,313,313,6,6,0,1,0
4,322,322,101,38,63,4,3
22,369,369,36,32,4,2,1
19,370,370,79,79,0,1,0
15,378,378,18,18,0,1,0
14,445,445,114,74,40,3,2
1,456,456,53,44,9,2,1

23,118,118,3,3,0,1,0
3,123,123,12,9,3,2,1
19,140,140,12,12,0,1,0
1,143,143,10,10,0,1,0
4,191,191,6,6,0,1,0
7,199,199,16,16,0,1,0
11,224,224,28,1,27,2,1
20,284,284,1,1,0,1,0
0,292,292,45,31,14,2,1
10,324,324,60,30,30,4,3
22,326,326,67,19,48,4,3
15,335,335,83,31,52,3,2
18,342,342,18,9,9,3,2
17,386,386,43,9,34,3,2
6,416,416,43,21,22,3,2
16,430,430,22,5,17,2,1
14,443,443,136,115,21,4,3
2,449,449,70,70,0,1,0
9,450,450,74,74,0,1,0
13,457,457,8,8,0,1,0
5,458,458,12,12,0,1,0
21,468,468,31,7,24,4,3
12,474,474,9,9,0,1,0
8,496,496,115,51,64,3,2

5,117,117,3,3,0,1,0
30,126,126,16,16,0,1,0
0,158,158,21,21,0,1,0
21,179,179,7,1,6,3,2
14,180,180,8,8,0,1,0
27,181,181,64,64,0,1,0
3,190,190,3,3,0,1,0
4,191,191,39,39,0,1,0
28,196,196,13,13,0,1,0
22,224,224,32,32,0,1,0
20,239,239,34,1,33,4,3
11,271,271,22,22,0,1,0
25,279,279,4,1,3,2,1
10,284,284,3,3,0,1,0
16,287,287,13,13,0,1,0
12,332,332,7,7,0,1,0
7,347,347,3,3,0,1,0
13,362,362,1,1,0,1,0
15,365,365,111,111,0,1,0
18,396,396,48,14,34,3,2
2,403,403,1,1,0,1,0
9,410,410,82,26,56,3,2
1,412,412,41,41,0,1,0
17,414,414,6,6,0,1,0
8,430,430,24,15,9,2,1
24,440,440,39,39,0,1,0
6,453,453,15,15,0,1,0
19,460,460,47,47,0,1,0
29,487,487,2,2,0,1,0
23,490,490,36,36,0,1,0
26,492,492,24,24,0,1,0

23,111,111,13,3,10,3,2
19,113,113,3,3,0,1,0
0,117,117,2,2,0,1,0
18,124,124,14,14,0,1,0
10,148,148,5,5,0,1,0
12,177,177,17,17,0,1,0
13,186,186,9,9,0,1,0
2,190,190,34,5,29,2,1
14,209,209,28,28,0,1,0
15,212,212,103,103,0,1,0
7,293,293,21,5,16,3,2
4,304,304,9,9,0,1,0
17,323,323,24,8,16,3,2
3,343,343,51,18,33,4,3
5,378,378,22,14,8,2,1
24,378,378,91,73,18,2,1
1,379,379,60,31,29,4,3
25,386,386,13,13,0,1,0
20,386,386,7,7,0,1,0
16,416,416,5,5,0,1,0
9,434,434,94,94,0,1,0
6,442,442,24,24,0,1,0
21,454,454,2,2,0,1,0
11,462,462,9,1,8,2,1
8,476,476,104,104,0,1,0
22,479,479,5,5,0,1,0

12,116,116,10,10,0,1,0
18,133,133,10,10,0,1,0
19,158,158,17,17,0,1,0
21,182,182,55,16,39,2,1
9,211,211,37,37,0,1,0
7,317,317,6,1,5,2,1
14,324,324,23,23,0,1,0
2,328,328,13,1,12,4,3
11,333,333,66,9,57,4,3
3,358,358,26,26,0,1,0
20,366,366,43,43,0,1,0
10,373,373,58,18,40,3,2
6,376,376,20,14,6,2,1
8,379,379,5,5,0,1,0
23,387,387,8,8,0,1,0
1,390,390,76,44,32,2,1
22,396,396,10,10,0,1,0
0,432,432,13,7,6,2,1
13,435,435,46,37,9,4,3
4,439,439,33,25,8,2,1
5,457,457,216,186,30,3,2
17,460,460,33,33,0,1,0
16,465,465,47,35,12,2,1
15,470,470,21,11,10,2,1

17,105,105,2,2,0,1,0
24,107,107,2,2,0,1,0
4,124,124,6,6,0,1,0
16,132,132,3,3,0,1,0
10,140,140,10,10,0,1,0
23,142,142,15,15,0,1,0
6,264,264,24,24,0,1,0
9,296,296,45,10,35,2,1
13,305,305,17,17,0,1,0
3,327,327,16,7,9,4,3
12,347,347,8,1,7,2,1
7,367,367,22,22,0,1,0
14,376,376,81,36,45,3,2
11,381,381,13,4,9,3,2
20,387,387,8,8,0,1,0
18,389,389,9,2,7,2,1
5,390,390,30,30,0,1,0
15,413,413,65,60,5,2,1
22,415,415,24,24,0,1,0
1,415,415,75,75,0,1,0
21,437,437,188,150,38,3,2
8,441,441,154,67,87,4,3
0,451,451,42,7,35,2,1
2,485,485,46,23,23,2,1
19,492,492,86,86,0,1,0

20,111,111,8,1,7,2,1
2,127,127,18,18,0,1,0
15,131,131,11,11,0,1,0
10,152,152,2,2,0,1,0
13,173,173,44,28,16,4,3
23,184,184,16,16,0,1,0
6,195,195,11,6,5,2,1
14,199,199,5,5,0,1,0
16,200,200,2,2,0,1,0
3,280,280,70,44,26,2,1
11,303,303,22,22,0,1,0
26,306,306,61,24,37,2,1
12,329,329,8,8,0,1,0
21,345,345,36,36,0,1,0
7,357,357,29,29,0,1,0
9,377,377,9,9,0,1,0
18,398,398,17,17,0,1,0
24,403,403,19,19,0,1,0
0,417,417,55,35,20,2,1
17,432,432,87,87,0,1,0
5,434,434,24,24,0,1,0
8,447,447,26,12,14,3,2
1,450,450,53,53,0,1,0
4,461,461,11,1,10,2,1
22,462,462,35,35,0,1,0
25,468,468,77,41,36,4,3
19,487,487,101,12,89,4,3

0,109,109,8,8,0,1,0
19,189,189,6,6,0,1,0
2,201,201,22,18,4,2,1
13,250,250,66,66,0,1,0
17,257,257,58,14,44,3,2
1,274,274,58,13,45,2,1
3,278,278,37,25,12,4,3
22,300,300,5,1,4,2,1
6,310,310,31,19,12,3,2
7,328,328,55,26,29,2,1
9,338,338,91,39,52,4,3
18,373,373,8,8,0,1,0
14,374,374,38,20,18,3,2
15,379,379,16,5,11,3,2
10,380,380,51,23,28,3,2
21,399,399,76,76,0,1,0
11,405,405,8,1,7,2,1
4,423,423,44,37,7,2,1
20,446,446,55,55,0,1,0
5,453,453,4,4,0,1,0
12,457,457,12,12,0,1,0
8,458,458,57,19,38,3,2
16,477,477,59,8,51,4,3

24,104,104,1,1,0,1,0
25,120,120,13,5,8,2,1
7,166,166,4,4,0,1,0
17,179,179,28,28,0,1,0
16,179,179,2,2,0,1,0
3,198,198,20,20,0,1,0
0,206,206,20,9,11,2,1
12,219,219,8,4,4,2,1
9,236,236,3,3,0,1,0
22,255,255,10,10,0,1,0
21,265,265,15,6,9,4,3
19,279,279,26,11,15,2,1
23,299,299,149,47,102,4,3
1,304,304,46,46,0,1,0
26,318,318,40,40,0,1,0
15,326,326,18,4,14,3,2
11,368,368,1,1,0,1,0
18,397,397,9,3,6,2,1
10,400,400,39,20,19,2,1
14,405,405,45,45,0,1,0
6,418,418,115,79,36,3,2
20,424,424,18,18,0,1,0
8,427,427,25,6,19,2,1
5,432,432,65,28,37,2,1
2,448,448,41,41,0,1,0
13,451,451,2,2,0,1,0
4,479,479,95,78,17,3,2

12,105,105,1,1,0,1,0
18,134,134,26,26,0,1,0
5,140,140,12,6,6,3,2
20,152,152,2,2,0,1,0
9,163,163,19,19,0,1,0
2,169,169,20,8,12,4,3
6,172,172,29,23,6,2,1
19,204,204,7,1,6,3,2
15,209,209,1,1,0,1,0
8,215,215,87,7,80,3,2
14,218,218,50,50,0,1,0
13,231,231,14,14,0,1,0
7,241,241,87,61,26,2,1
11,306,306,33,33,0,1,0
3,307,307,112,35,77,3,2
17,314,314,1,1,0,1,0
10,341,341,2,2,0,1,0
0,368,368,10,10,0,1,0
4,385,385,46,15,31,3,2
1,406,406,23,23,0,1,0
16,415,415,60,57,3,2,1

9,120,120,18,18,0,1,0
20,135,135,2,2,0,1,0
15,138,138,60,54,6,2,1
22,144,144,19,8,11,3,2
13,155,155,2,2,0,1,0
17,157,157,10,4,6,2,1
1,186,186,2,2,0,1,0
25,189,189,2,2,0,1,0
24,195,195,5,5,0,1,0
0,199,199,6,3,3,2,1
18,222,222,19,10,9,4,3
14,224,224,14,6,8,2,1
16,228,228,39,39,0,1,0
10,230,230,24,24,0,1,0
4,240,240,14,14,0,1,0
12,255,255,62,62,0,1,0
21,256,256,10,10,0,1,0
8,258,258,31,5,26,2,1
23,263,263,10,3,7,2,1
19,269,269,67,28,39,2,1
3,293,293,17,2,15,2,1
7,298,298,12,12,0,1,0
6,321,321,42,42,0,1,0
11,362,362,38,38,0,1,0
5,387,387,44,44,0,1,0
2,418,418,57,57,0,1,0

0,105,105,4,4,0,1,0
21,123,123,32,32,0,1,0
7,129,129,2,2,0,1,0
11,139,139,10,10,0,1,0
13,180,180,46,46,0,1,0
26,183,183,4,4,0,1,0
19,189,189,10,10,0,1,0
22,200,200,36,6,30,2,1
2,218,218,9,9,0,1,0
5,234,234,7,1,6,3,2
9,242,242,12,4,8,3,2
15,261,261,19,19,0,1,0
1,268,268,6,6,0,1,0
8,271,271,37,37,0,1,0
6,288,288,2,2,0,1,0
23,321,321,43,43,0,1,0
20,322,322,62,9,53,3,2
14,324,324,10,10,0,1,0
17,354,354,43,43,0,1,0
24,356,356,2,2,0,1,0
12,367,367,157,49,108,4,3
27,369,369,40,19,21,2,1
16,386,386,8,8,0,1,0
3,394,394,13,3,10,2,1
18,401,401,12,1,11,3,2
10,430,430,17,17,0,1,0
25,467,467,55,55,0,1,0
4,476,476,49,41,8,3,2

8,104,104,1,1,0,1,0
11,108,108,10,10,0,1,0
12,114,114,1,1,0,1,0
1,120,120,27,27,0,1,0
23,140,140,22,6,16,3,2
15,142,142,6,1,5,2,1
5,186,186,8,5,3,2,1
17,190,190,11,11,0,1,0
4,208,208,3,3,0,1,0
21,214,214,36,36,0,1,0
29,218,218,1,1,0,1,0
28,236,236,31,15,16,2,1
2,247,247,16,16,0,1,0
25,260,260,18,10,8,2,1
3,272,272,63,63,0,1,0
24,308,308,53,53,0,1,0
7,315,315,21,21,0,1,0
9,335,335,19,19,0,1,0
14,336,336,25,7,18,3,2
6,339,339,13,13,0,1,0
30,353,353,22,10,12,2,1
20,387,387,16,16,0,1,0
22,394,394,79,4,75,4,3
18,394,394,9,9,0,1,0
13,404,404,27,27,0,1,0
0,422,422,14,14,0,1,0
10,440,440,6,3,3,2,1
16,455,455,75,20,55,3,2
19,469,469,43,43,0,1,0
26,490,490,58,24,34,3,2
27,495,495,40,40,0,1,0

26,112,112,4,4,0,1,0
5,124,124,11,11,0,1,0
12,133,133,1,1,0,1,0
7,137,137,19,3,16,2,1
28,147,147,1,1,0,1,0
27,148,148,19,13,6,3,2
22,149,149,2,2,0,1,0
10,161,161,17,10,7,2,1
13,184,184,11,11,0,1,0
1,187,187,3,3,0,1,0
18,189,189,29,29,0,1,0
15,263,263,23,7,16,3,2
14,267,267,12,12,0,1,0
6,270,270,8,2,6,3,2
16,295,295,29,1,28,2,1
0,307,307,1,1,0,1,0
4,328,328,44,4,40,4,3
9,336,336,1,1,0,1,0
24,339,339,75,28,47,3,2
20,368,368,4,4,0,1,0
2,370,370,29,29,0,1,0
19,373,373,44,44,0,1,0
23,375,375,32,8,24,4,3
25,386,386,23,23,0,1,0
3,446,446,34,34,0,1,0
17,456,456,158,125,33,4,3
11,456,456,30,6,24,4,3
8,459,459,167,95,72,3,2
21,463,463,23,23,0,1,0

28,108,108,1,1,0,1,0
12,117,117,1,1,0,1,0
3,117,117,4,4,0,1,0
22,130,130,6,1,5,2,1
16,145,145,5,5,0,1,0
8,148,148,6,6,0,1,0
25,165,165,9,9,0,1,0
38,167,167,1,1,0,1,0
20,170,170,8,8,0,1,0
19,173,173,19,14,5,2,1
10,176,176,4,4,0,1,0
24,189,189,7,7,0,1,0
2,220,220,9,9,0,1,0
33,220,220,8,8,0,1,0
27,261,261,23,11,12,2,1
15,262,262,4,4,0,1,0
34,280,280,31,31,0,1,0
29,284,284,60,43,17,2,1
5,287,287,4,4,0,1,0
14,289,289,5,5,0,1,0
13,290,290,20,20,0,1,0
36,322,322,8,1,7,2,1
35,332,332,26,2,24,3,2
18,332,332,2,2,0,1,0
23,340,340,16,2,14,3,2
1,358,358,18,18,0,1,0
26,379,379,23,23,0,1,0
31,381,381,40,40,0,1,0
11,388,388,1,1,0,1,0
6,390,390,60,52,8,2,1
32,425,425,95,95,0,1,0
0,433,433,106,66,40,3,2
4,442,442,14,1,13,2,1
17,455,455,37,11,26,3,2
30,478,478,74,74,0,1,0
37,482,482,106,13,93,4,3
7,488,488,4,4,0,1,0
9,489,489,31,6,25,2,1
21,491,491,10,10,0,1,0

24,137,137,1,1,0,1,0
13,147,147,21,3,18,2,1
10,160,160,1,1,0,1,0
15,190,190,5,5,0,1,0
18,196,196,26,18,8,2,1
6,197,197,15,6,9,2,1
22,199,199,49,49,0,1,0
7,223,223,1,1,0,1,0
1,234,234,35,16,19,2,1
17,275,275,8,2,6,2,1
19,277,277,28,28,0,1,0
0,309,309,21,21,0,1,0
14,313,313,28,28,0,1,0
2,320,320,102,16,86,3,2
16,325,325,70,18,52,3,2
21,359,359,7,4,3,2,1
23,364,364,36,36,0,1,0
11,372,372,22,1,21,2,1
4,380,380,32,32,0,1,0
5,390,390,97,15,82,3,2
25,393,393,25,16,9,2,1
3,417,417,1,1,0,1,0
8,418,418,62,58,4,2,1
9,424,424,47,47,0,1,0
20,442,442,68,59,9,4,3
12,451,451,11,5,6,2,1

9,103,103,7,7,0,1,0
20,105,105,26,26,0,1,0
18,118,118,26,4,22,2,1
7,126,126,5,5,0,1,0
13,136,136,7,7,0,1,0
10,156,156,24,24,0,1,0
14,167,167,3,3,0,1,0
19,174,174,9,4,5,2,1
8,207,207,10,2,8,2,1
5,210,210,1,1,0,1,0
6,252,252,72,21,51,4,3
24,256,256,10,1,9,2,1
0,290,290,39,21,18,3,2
23,296,296,34,34,0,1,0
26,326,326,19,19,0,1,0
2,328,328,37,37,0,1,0
17,343,343,103,55,48,4,3
27,369,369,23,23,0,1,0
16,371,371,12,3,9,4,3
25,373,373,12,4,8,2,1
4,384,384,53,41,12,2,1
3,412,412,60,23,37,2,1
22,417,417,24,24,0,1,0
21,432,432,17,11,6,2,1
29,452,452,30,21,9,2,1
28,453,453,17,17,0,1,0
11,458,458,25,10,15,4,3
1,485,485,2,2,0,1,0
12,489,489,4,4,0,1,0
15,490,490,1,1,0,1,0

2,132,132,8,5,3,2,1
17,139,139,2,2,0,1,0
14,156,156,48,48,0,1,0
12,168,168,14,3,11,2,1
25,178,178,53,28,25,3,2
22,185,185,19,3,16,3,2
3,195,195,22,5,17,3,2
20,199,199,17,17,0,1,0
8,204,204,3,3,0,1,0
11,214,214,4,4,0,1,0
7,221,221,1,1,0,1,0
30,237,237,17,17,0,1,0
1,253,253,4,4,0,1,0
0,253,253,44,44,0,1,0
16,284,284,33,2,31,4,3
18,301,301,11,11,0,1,0
4,313,313,7,7,0,1,0
21,342,342,48,36,12,2,1
27,344,344,100,62,38,3,2
10,347,347,27,13,14,2,1
28,360,360,16,8,8,2,1
15,375,375,2,2,0,1,0
9,397,397,3,3,0,1,0
29,404,404,17,3,14,3,2
5,416,416,46,46,0,1,0
19,419,419,27,17,10,2,1
23,436,436,32,22,10,2,1
13,443,443,32,14,18,4,3
6,448,448,38,12,26,3,2
26,448,448,22,4,18,3,2
24,457,457,10,10,0,1,0

6,105,105,15,15,0,1,0
19,123,123,3,3,0,1,0
10,156,156,13,5,8,2,1
12,178,178,31,31,0,1,0
23,247,247,72,72,0,1,0
15,271,271,59,27,32,3,2
3,281,281,45,8,37,2,1
0,299,299,4,4,0,1,0
17,303,303,9,9,0,1,0
13,315,315,29,11,18,2,1
8,317,317,16,16,0,1,0
9,318,318,1,1,0,1,0
22,321,321,2,2,0,1,0
18,332,332,33,21,12,4,3
16,351,351,19,9,10,3,2
7,375,375,17,6,11,3,2
2,403,403,70,25,45,4,3
11,405,405,17,13,4,2,1
21,409,409,88,88,0,1,0
5,440,440,14,14,0,1,0
20,476,476,25,25,0,1,0
1,477,477,17,17,0,1,0
14,491,491,12,12,0,1,0
4,495,495,279,129,150,4,3

33,101,101,2,2,0,1,0
13,109,109,8,2,6,2,1
10,116,116,4,4,0,1,0
9,122,122,1,1,0,1,0
12,122,122,6,6,0,1,0
11,126,126,1,1,0,1,0
2,134,134,7,7,0,1,0
18,147,147,4,4,0,1,0
30,210,210,5,5,0,1,0
24,254,254,2,2,0,1,0
15,256,256,7,3,4,2,1
14,275,275,10,1,9,4,3
3,279,279,23,3,20,2,1
20,300,300,29,5,24,3,2
1,302,302,4,4,0,1,0
0,307,307,23,9,14,3,2
4,323,323,11,1,10,3,2
6,325,325,15,15,0,1,0
8,329,329,26,26,0,1,0
32,339,339,9,5,4,2,1
26,342,342,86,35,51,4,3
22,343,343,4,4,0,1,0
17,362,362,51,30,21,4,3
21,373,373,9,9,0,1,0
5,378,378,58,10,48,3,2
19,395,395,54,5,49,2,1
25,403,403,82,34,48,3,2
16,427,427,38,27,11,2,1
27,447,447,134,39,95,4,3
29,448,448,31,7,24,4,3
31,448,448,53,5,48,2,1
23,484,484,93,75,18,3,2
28,484,484,39,39,0,1,0
7,484,484,18,18,0,1,0

8,102,102,1,1,0,1,0
16,112,112,10,10,0,1,0
4,125,125,19,19,0,1,0
5,138,138,15,15,0,1,0
22,145,145,18,18,0,1,0
25,149,149,37,37,0,1,0
19,171,171,25,4,21,2,1
15,183,183,1,1,0,1,0
14,207,207,13,1,12,4,3
12,225,225,39,39,0,1,0
24,227,227,18,18,0,1,0
2,234,234,27,7,20,2,1
21,243,243,25,11,14,2,1
7,260,260,7,7,0,1,0
0,269,269,62,44,18,2,1
9,278,278,14,4,10,3,2
10,281,281,24,24,0,1,0
3,354,354,3,3,0,1,0
17,373,373,68,68,0,1,0
23,388,388,30,15,15,2,1
20,401,401,14,14,0,1,0
6,421,421,19,5,14,4,3
1,423,423,66,21,45,4,3
11,424,424,59,9,50,4,3
18,439,439,29,11,18,4,3
13,445,445,49,49,0,1,0

21,133,133,1,1,0,1,0
4,140,140,4,4,0,1,0
3,143,143,9,5,4,2,1
19,148,148,26,26,0,1,0
1,153,153,32,32,0,1,0
13,155,155,57,57,0,1,0
22,165,165,16,16,0,1,0
17,218,218,8,2,6,2,1
18,223,223,47,47,0,1,0
5,226,226,4,4,0,1,0
6,229,229,62,11,51,4,3
2,245,245,1,1,0,1,0
0,256,256,17,11,6,3,2
10,260,260,36,20,16,2,1
16,261,261,9,3,6,2,1
12,288,288,29,5,24,2,1
9,297,297,89,89,0,1,0
8,416,416,30,30,0,1,0
23,426,426,4,4,0,1,0
14,433,433,4,4,0,1,0
11,450,450,19,7,12,4,3
24,464,464,39,9,30,4,3
7,488,488,43,31,12,2,1
20,492,492,32,21,11,2,1
15,496,496,66,66,0,1,0

18,111,111,13,13,0,1,0
1,116,116,13,5,8,2,1
4,122,122,6,6,0,1,0
11,122,122,1,1,0,1,0
8,155,155,3,3,0,1,0
5,163,163,29,3,26,3,2
15,176,176,8,2,6,3,2
6,197,197,30,7,23,2,1
9,204,204,22,22,0,1,0
12,228,228,6,3,3,2,1
7,233,233,12,8,4,2,1
0,254,254,35,18,17,2,1
14,292,292,66,2,64,3,2
17,323,323,130,130,0,1,0
16,343,343,60,60,0,1,0
3,360,360,242,242,0,1,0
10,385,385,5,1,4,2,1
2,385,385,1,1,0,1,0
13,391,391,45,40,5,2,1
19,437,437,10,1,9,4,3

9,117,117,36,22,14,3,2
14,118,118,27,4,23,2,1
6,119,119,8,3,5,2,1
22,147,147,9,3,6,3,2
23,179,179,2,2,0,1,0
15,180,180,26,2,24,2,1
7,188,188,15,1,14,2,1
11,195,195,2,2,0,1,0
0,197,197,25,21,4,2,1
8,233,233,5,1,4,2,1
12,237,237,16,16,0,1,0
2,240,240,47,47,0,1,0
16,248,248,53,53,0,1,0
18,298,298,1,1,0,1,0
21,312,312,25,7,18,4,3
10,329,329,10,2,8,2,1
1,329,329,55,55,0,1,0
4,340,340,23,23,0,1,0
24,344,344,12,4,8,3,2
3,353,353,8,8,0,1,0
13,375,375,13,13,0,1,0
5,401,401,82,16,66,3,2
19,403,403,132,78,54,4,3
20,412,412,21,21,0,1,0
17,465,465,33,25,8,3,2

2,106,106,14,14,0,1,0
22,107,107,2,2,0,1,0
9,127,127,17,17,0,1,0
11,151,151,20,20,0,1,0
1,167,167,3,3,0,1,0
12,177,177,17,8,9,2,1
21,182,182,11,5,6,2,1
15,192,192,21,5,16,3,2
6,205,205,8,8,0,1,0
5,206,206,32,2,30,4,3
17,208,208,4,4,0,1,0
20,232,232,44,7,37,2,1
4,278,278,118,68,50,2,1
3,290,290,100,12,88,4,3
19,297,297,4,4,0,1,0
16,324,324,38,38,0,1,0
0,330,330,4,4,0,1,0
18,342,342,110,110,0,1,0
7,354,354,16,16,0,1,0
8,404,404,1,1,0,1,0
10,406,406,43,20,23,2,1
13,433,433,16,6,10,4,3
14,497,497,50,50,0,1,0

7,100,100,6,6,0,1,0
12,104,104,8,2,6,2,1
9,130,130,4,4,0,1,0
15,134,134,9,3,6,3,2
30,144,144,4,4,0,1,0
21,155,155,22,7,15,4,3
20,182,182,42,4,38,3,2
27,184,184,5,5,0,1,0
17,192,192,7,7,0,1,0
32,197,197,41,41,0,1,0
3,207,207,25,25,0,1,0
11,210,210,11,11,0,1,0
8,211,211,40,40,0,1,0
2,219,219,21,10,11,2,1
4,253,253,6,6,0,1,0
25,274,274,33,3,30,3,2
10,295,295,3,3,0,1,0
18,308,308,4,1,3,2,1
1,320,320,7,1,6,3,2
19,321,321,1,1,0,1,0
5,343,343,8,8,0,1,0
23,344,344,14,6,8,2,1
31,345,345,28,28,0,1,0
22,348,348,26,17,9,2,1
13,348,348,24,24,0,1,0
26,361,361,27,5,22,3,2
0,370,370,23,23,0,1,0
14,445,445,108,45,63,4,3
16,456,456,1,1,0,1,0
6,472,472,48,48,0,1,0
28,487,487,112,112,0,1,0
24,488,488,27,12,15,2,1
29,500,500,7,7,0,1,0

24,106,106,7,7,0,1,0
25,107,107,25,19,6,2,1
17,129,129,10,10,0,1,0
1,159,159,7,1,6,3,2
11,174,174,5,5,0,1,0
18,179,179,41,41,0,1,0
22,223,223,14,14,0,1,0
10,231,231,9,9,0,1,0
9,257,257,9,9,0,1,0
0,263,263,20,20,0,1,0
15,268,268,19,4,15,4,3
12,285,285,82,82,0,1,0
19,312,312,6,6,0,1,0
20,318,318,31,3,28,2,1
8,320,320,10,10,0,1,0
23,347,347,9,9,0,1,0
14,352,352,72,72,0,1,0
7,359,359,125,41,84,4,3
21,387,387,1,1,0,1,0
6,414,414,13,13,0,1,0
13,431,431,62,62,0,1,0
3,455,455,11,5,6,3,2
16,473,473,47,47,0,1,0
4,476,476,98,34,64,3,2
5,491,491,41,41,0,1,0
2,499,499,33,26,7,2,1

27,108,108,20,4,16,2,1
6,115,115,4,1,3,2,1
16,125,125,15,15,0,1,0
3,134,134,1,1,0,1,0
21,146,146,11,11,0,1,0
19,147,147,25,11,14,2,1
0,221,221,31,31,0,1,0
25,225,225,7,1,6,3,2
20,227,227,29,6,23,2,1
11,255,255,21,7,14,2,1
24,262,262,26,8,18,4,3
17,303,303,2,2,0,1,0
22,312,312,43,43,0,1,0
13,338,338,142,52,90,4,3
9,339,339,3,3,0,1,0
8,343,343,39,39,0,1,0
2,346,346,63,63,0,1,0
28,376,376,43,43,0,1,0
1,378,378,1,1,0,1,0
23,397,397,22,22,0,1,0
10,407,407,1,1,0,1,0
15,415,415,25,25,0,1,0
7,418,418,6,6,0,1,0
18,425,425,20,10,10,2,1
26,447,447,74,50,24,3,2
14,459,459,9,9,0,1,0
12,464,464,70,70,0,1,0
4,468,468,10,5,5,2,1
5,476,476,19,19,0,1,0

23,108,108,4,4,0,1,0
10,120,120,44,3,41,2,1
24,124,124,3,3,0,1,0
12,129,129,23,2,21,2,1
7,130,130,15,15,0,1,0
20,133,133,1,1,0,1,0
18,148,148,30,10,20,2,1
13,154,154,32,11,21,2,1
16,163,163,74,74,0,1,0
0,186,186,1,1,0,1,0
9,201,201,30,30,0,1,0
19,205,205,12,12,0,1,0
6,214,214,10,10,0,1,0
15,215,215,19,19,0,1,0
1,258,258,45,18,27,3,2
8,262,262,3,3,0,1,0
21,266,266,9,1,8,3,2
2,306,306,7,1,6,3,2
5,342,342,100,55,45,2,1
4,375,375,5,5,0,1,0
22,394,394,8,8,0,1,0
14,410,410,8,8,0,1,0
3,414,414,25,25,0,1,0
11,478,478,20,20,0,1,0
17,498,498,2,2,0,1,0

29,101,101,7,7,0,1,0
4,120,120,15,15,0,1,0
12,123,123,3,3,0,1,0
16,134,134,20,20,0,1,0
10,161,161,1,1,0,1,0
7,163,163,16,10,6,2,1
11,169,169,3,3,0,1,0
23,194,194,53,29,24,3,2
1,199,199,29,29,0,1,0
3,218,218,29,24,5,2,1
5,261,261,11,11,0,1,0
33,266,266,5,5,0,1,0
9,277,277,25,25,0,1,0
28,290,290,19,19,0,1,0
19,292,292,35,28,7,2,1
0,295,295,15,12,3,2,1
22,300,300,4,4,0,1,0
13,322,322,16,16,0,1,0
8,332,332,13,13,0,1,0
14,334,334,10,10,0,1,0
20,366,366,13,13,0,1,0
31,390,390,10,4,6,3,2
6,395,395,6,1,5,2,1
30,395,395,2,2,0,1,0
15,397,397,13,9,4,2,1
27,410,410,89,71,18,4,3
24,414,414,55,55,0,1,0
32,414,414,79,48,31,2,1
21,419,419,32,32,0,1,0
25,438,438,77,77,0,1,0
17,457,457,1,1,0,1,0
26,482,482,29,29,0,1,0
18,485,485,1,1,0,1,0
2,494,494,45,45,0,1,0

16,111,111,1,1,0,1,0
11,118,118,2,2,0,1,0
8,136,136,10,6,4,2,1
7,147,147,6,3,3,2,1
30,175,175,4,4,0,1,0
6,193,193,14,11,3,2,1
9,236,236,18,14,4,2,1
17,249,249,42,42,0,1,0
15,261,261,31,16,15,4,3
25,264,264,14,10,4,2,1
23,264,264,11,3,8,3,2
20,270,270,96,96,0,1,0
27,279,279,32,26,6,3,2
3,284,284,5,2,3,2,1
22,293,293,4,4,0,1,0
1,329,329,29,13,16,2,1
2,331,331,126,12,114,4,3
28,335,335,19,19,0,1,0
18,372,372,6,6,0,1,0
19,381,381,62,62,0,1,0
12,383,383,28,28,0,1,0
4,394,394,10,1,9,2,1
14,424,424,1,1,0,1,0
5,447,447,25,25,0,1,0
29,448,448,33,33,0,1,0
0,458,458,33,18,15,4,3
26,459,459,89,61,28,3,2
10,465,465,1,1,0,1,0
24,470,470,84,36,48,2,1
13,486,486,3,3,0,1,0
21,494,494,16,16,0,1,0

13,115,115,13,13,0,1,0
23,116,116,30,30,0,1,0
1,132,132,4,4,0,1,0
7,142,142,8,8,0,1,0
24,175,175,15,15,0,1,0
5,178,178,1,1,0,1,0
10,189,189,21,17,4,2,1
18,200,200,6,6,0,1,0
2,214,214,34,34,0,1,0
14,221,221,45,45,0,1,0
19,227,227,44,32,12,4,3
4,262,262,12,12,0,1,0
11,270,270,5,5,0,1,0
9,295,295,5,5,0,1,0
26,322,322,10,10,0,1,0
17,331,331,40,16,24,4,3
21,333,333,48,41,7,2,1
20,337,337,60,32,28,3,2
12,338,338,5,5,0,1,0
6,358,358,40,40,0,1,0
22,361,361,30,10,20,3,2
0,397,397,39,17,22,2,1
16,402,402,2,2,0,1,0
3,414,414,108,103,5,2,1
8,443,443,26,26,0,1,0
27,451,451,59,20,39,4,3
15,489,489,6,6,0,1,0
25,497,497,27,5,22,3,2

3,101,101,12,12,0,1,0
6,105,105,4,4,0,1,0
17,132,132,3,3,0,1,0
14,132,132,38,38,0,1,0
21,141,141,28,12,16,3,2
9,147,147,6,1,5,2,1
8,197,197,53,53,0,1,0
19,221,221,24,7,17,2,1
23,225,225,2,2,0,1,0
11,250,250,11,11,0,1,0
2,266,266,1,1,0,1,0
10,284,284,107,85,22,3,2
0,289,289,3,3,0,1,0
15,297,297,23,23,0,1,0
7,327,327,16,16,0,1,0
13,335,335,21,21,0,1,0
5,336,336,77,38,39,4,3
12,367,367,41,26,15,2,1
18,374,374,60,18,42,4,3
4,390,390,49,49,0,1,0
1,412,412,17,11,6,2,1
20,430,430,65,65,0,1,0
22,471,471,36,5,31,2,1
16,492,492,8,8,0,1,0

20,102,102,7,7,0,1,0
26,119,119,34,34,0,1,0
9,124,124,5,2,3,2,1
23,128,128,6,6,0,1,0
17,142,142,26,3,23,2,1
0,151,151,16,16,0,1,0
7,154,154,34,22,12,4,3
5,167,167,4,4,0,1,0
8,199,199,34,34,0,1,0
6,205,205,6,6,0,1,0
22,208,208,6,6,0,1,0
4,210,210,1,1,0,1,0
12,259,259,10,6,4,2,1
13,270,270,1,1,0,1,0
25,319,319,10,10,0,1,0
11,324,324,9,6,3,2,1
3,338,338,5,5,0,1,0
15,350,350,14,14,0,1,0
10,367,367,42,34,8,2,1
1,374,374,37,23,14,2,1
19,374,374,64,64,0,1,0
18,399,399,67,58,9,4,3
24,400,400,20,20,0,1,0
27,422,422,11,11,0,1,0
16,426,426,37,37,0,1,0
2,428,428,36,21,15,4,3
28,435,435,8,8,0,1,0
21,448,448,17,14,3,2,1
14,454,454,89,89,0,1,0
29,495,495,109,109,0,1,0

5,112,112,10,1,9,2,1
8,121,121,2,2,0,1,0
19,123,123,7,7,0,1,0
15,145,145,2,2,0,1,0
14,158,158,2,2,0,1,0
0,159,159,44,44,0,1,0
11,160,160,9,9,0,1,0
21,168,168,33,33,0,1,0
17,196,196,26,26,0,1,0
3,208,208,28,11,17,2,1
12,223,223,28,28,0,1,0
6,223,223,19,8,11,2,1
4,236,236,11,11,0,1,0
18,249,249,1,1,0,1,0
2,256,256,1,1,0,1,0
26,272,272,2,2,0,1,0
23,293,293,17,17,0,1,0
9,295,295,3,3,0,1,0
25,305,305,24,7,17,2,1
13,327,327,43,4,39,3,2
20,334,334,3,3,0,1,0
29,346,346,28,16,12,4,3
27,347,347,66,66,0,1,0
10,407,407,18,4,14,2,1
16,412,412,39,39,0,1,0
28,429,429,64,25,39,4,3
7,460,460,69,9,60,3,2
22,477,477,116,116,0,1,0
24,491,491,62,62,0,1,0
1,498,498,5,5,0,1,0

0,112,112,24,21,3,2,1
23,122,122,14,14,0,1,0
9,129,129,8,8,0,1,0
8,133,133,1,1,0,1,0
24,137,137,14,9,5,2,1
16,166,166,1,1,0,1,0
6,209,209,33,11,22,2,1
25,209,209,1,1,0,1,0
26,211,211,11,11,0,1,0
1,226,226,4,4,0,1,0
14,245,245,35,35,0,1,0
12,252,252,7,7,0,1,0
27,264,264,71,71,0,1,0
2,275,275,11,3,8,3,2
10,288,288,11,1,10,4,3
13,324,324,24,1,23,2,1
7,349,349,11,6,5,2,1
5,356,356,26,26,0,1,0
4,368,368,7,1,6,3,2
20,381,381,3,3,0,1,0
22,391,391,128,128,0,1,0
21,433,433,37,37,0,1,0
19,442,442,4,4,0,1,0
3,448,448,57,57,0,1,0
17,455,455,131,83,48,3,2
18,484,484,23,1,22,3,2
15,488,488,6,6,0,1,0
11,497,497,134,134,0,1,0

6,105,105,3,3,0,1,0
15,111,111,22,16,6,3,2
21,114,114,4,4,0,1,0
24,124,124,23,23,0,1,0
23,140,140,10,4,6,3,2
25,144,144,20,20,0,1,0
10,155,155,48,48,0,1,0
5,172,172,14,14,0,1,0
18,180,180,7,1,6,3,2
19,209,209,23,6,17,2,1
9,235,235,2,2,0,1,0
1,240,240,16,16,0,1,0
2,250,250,32,32,0,1,0
12,273,273,46,5,41,4,3
22,278,278,9,9,0,1,0
17,296,296,8,8,0,1,0
16,310,310,90,72,18,2,1
0,326,326,1,1,0,1,0
7,355,355,61,10,51,4,3
13,416,416,71,25,46,3,2
20,454,454,41,41,0,1,0
26,456,456,8,8,0,1,0
3,470,470,6,6,0,1,0
8,471,471,31,31,0,1,0
4,472,472,4,4,0,1,0
11,494,494,38,38,0,1,0
14,497,497,50,1,49,2,1

12,123,123,2,2,0,1,0
2,134,134,28,28,0,1,0
8,138,138,21,9,12,2,1
15,143,143,46,8,38,2,1
7,233,233,49,36,13,2,1
11,255,255,8,8,0,1,0
21,261,261,9,6,3,2,1
20,263,263,38,38,0,1,0
9,267,267,19,14,5,2,1
14,276,276,6,3,3,2,1
19,318,318,4,4,0,1,0
1,322,322,2,2,0,1,0
5,348,348,46,46,0,1,0
6,382,382,157,142,15,4,3
17,390,390,134,76,58,3,2
4,407,407,2,2,0,1,0
18,407,407,21,16,5,2,1
16,425,425,4,1,3,2,1
13,431,431,89,41,48,4,3
3,473,473,35,35,0,1,0
10,478,478,25,17,8,3,2
0,490,490,52,18,34,2,1

2,137,137,11,6,5,2,1
24,154,154,14,5,9,4,3
9,159,159,2,2,0,1,0
6,160,160,3,3,0,1,0
0,170,170,1,1,0,1,0
14,201,201,3,3,0,1,0
18,258,258,12,3,9,2,1
10,272,272,33,22,11,2,1
5,279,279,19,10,9,4,3
16,318,318,18,11,7,2,1
1,322,322,168,155,13,2,1
23,370,370,3,3,0,1,0
20,376,376,95,95,0,1,0
3,384,384,26,26,0,1,0
15,397,397,13,3,10,2,1
11,420,420,10,10,0,1,0
25,424,424,51,51,0,1,0
22,441,441,146,102,44,3,2
4,446,446,22,4,18,4,3
17,447,447,78,78,0,1,0
12,451,451,41,41,0,1,0
13,453,453,11,1,10,3,2
7,475,475,23,4,19,3,2
19,481,481,28,28,0,1,0
8,488,488,94,1,93,4,3
21,492,492,52,38,14,3,2

12,111,111,4,4,0,1,0
9,116,116,6,6,0,1,0
17,119,119,11,11,0,1,0
0,125,125,1,1,0,1,0
16,127,127,8,8,0,1,0
11,142,142,10,10,0,1,0
20,144,144,19,19,0,1,0
3,145,145,26,22,4,2,1
14,153,153,5,5,0,1,0
26,170,170,7,4,3,2,1
21,178,178,3,3,0,1,0
15,192,192,49,49,0,1,0
23,208,208,40,16,24,2,1
19,211,211,25,25,0,1,0
22,243,243,23,10,13,2,1
25,284,284,13,13,0,1,0
24,297,297,23,13,10,2,1
8,299,299,41,29,12,4,3
13,300,300,23,23,0,1,0
6,317,317,14,5,9,2,1
4,341,341,12,12,0,1,0
18,386,386,66,66,0,1,0
7,412,412,13,13,0,1,0
2,420,420,87,87,0,1,0
10,429,429,67,60,7,2,1
5,434,434,86,62,24,4,3
1,440,440,31,15,16,3,2

25,104,104,7,7,0,1,0
23,134,134,15,15,0,1,0
4,149,149,12,12,0,1,0
19,168,168,5,5,0,1,0
9,174,174,34,34,0,1,0
21,183,183,13,13,0,1,0
6,253,253,10,6,4,2,1
12,256,256,35,35,0,1,0
16,265,265,81,81,0,1,0
2,289,289,16,1,15,4,3
7,303,303,4,4,0,1,0
13,311,311,11,11,0,1,0
11,322,322,63,1,62,4,3
17,327,327,55,55,0,1,0
22,336,336,18,18,0,1,0
1,345,345,86,86,0,1,0
24,363,363,26,26,0,1,0
15,373,373,6,6,0,1,0
3,383,383,10,10,0,1,0
14,402,402,84,3,81,4,3
18,402,402,50,50,0,1,0
0,412,412,13,5,8,3,2
5,428,428,63,63,0,1,0
10,451,451,20,1,19,2,1
20,452,452,26,18,8,3,2
8,491,491,43,43,0,1,0

14,110,110,20,20,0,1,0
0,115,115,13,13,0,1,0
8,137,137,1,1,0,1,0
10,145,145,10,10,0,1,0
24,182,182,29,29,0,1,0
26,201,201,12,12,0,1,0
19,223,223,47,47,0,1,0
27,230,230,35,35,0,1,0
6,238,238,3,3,0,1,0
13,248,248,33,7,26,4,3
25,273,273,8,8,0,1,0
4,280,280,18,2,16,2,1
7,283,283,26,26,0,1,0
20,316,316,9,9,0,1,0
5,317,317,2,2,0,1,0
22,320,320,10,3,7,2,1
11,325,325,13,13,0,1,0
12,341,341,69,69,0,1,0
15,347,347,23,23,0,1,0
18,358,358,69,48,21,4,3
9,368,368,10,5,5,2,1
3,372,372,99,36,63,4,3
16,430,430,57,57,0,1,0
23,435,435,74,28,46,3,2
1,467,467,39,1,38,4,3
21,486,486,32,32,0,1,0
17,494,494,11,11,0,1,0
2,500,500,1,1,0,1,0

20,112,112,8,8,0,1,0
24,113,113,6,6,0,1,0
19,134,134,5,5,0,1,0
23,158,158,36,36,0,1,0
27,165,165,8,1,7,2,1
26,170,170,36,4,32,3,2
10,172,172,2,2,0,1,0
6,174,174,11,5,6,2,1
9,185,185,18,18,0,1,0
13,191,191,5,5,0,1,0
3,195,195,1,1,0,1,0
8,222,222,62,4,58,4,3
5,228,228,30,10,20,2,1
28,254,254,36,36,0,1,0
14,261,261,2,2,0,1,0
22,272,272,66,22,44,3,2
7,318,318,72,72,0,1,0
4,319,319,30,14,16,2,1
12,335,335,1,1,0,1,0
11,343,343,37,37,0,1,0
18,386,386,23,23,0,1,0
17,393,393,43,27,16,3,2
21,400,400,2,2,0,1,0
25,408,408,22,8,14,2,1
15,410,410,3,3,0,1,0
1,435,435,36,4,32,2,1
0,455,455,39,39,0,1,0
16,487,487,29,29,0,1,0
2,495,495,36,36,0,1,0

21,119,119,1,1,0,1,0
17,132,132,12,6,6,3,2
2,135,135,16,16,0,1,0
20,136,136,18,2,16,2,1
12,138,138,9,6,3,2,1
7,142,142,6,1,5,2,1
6,166,166,42,24,18,4,3
28,186,186,46,14,32,3,2
27,222,222,25,19,6,3,2
14,232,232,12,12,0,1,0
23,252,252,23,13,10,3,2
5,257,257,6,6,0,1,0
15,257,257,22,4,18,3,2
19,264,264,9,6,3,2,1
22,303,303,66,22,44,2,1
16,313,313,56,17,39,2,1
25,314,314,9,9,0,1,0
24,322,322,49,13,36,2,1
3,347,347,14,14,0,1,0
1,350,350,44,28,16,3,2
18,357,357,2,2,0,1,0
0,362,362,33,33,0,1,0
4,397,397,18,18,0,1,0
10,399,399,28,28,0,1,0
26,422,422,16,1,15,4,3
9,425,425,73,73,0,1,0
13,428,428,12,12,0,1,0
11,471,471,41,41,0,1,0
8,485,485,1,1,0,1,0

0,106,106,9,6,3,2,1
17,106,106,3,3,0,1,0
8,120,120,31,11,20,3,2
25,134,134,26,26,0,1,0
13,146,146,1,1,0,1,0
2,160,160,11,11,0,1,0
5,165,165,20,2,18,2,1
14,174,174,8,8,0,1,0
6,180,180,1,1,0,1,0
21,191,191,1,1,0,1,0
18,196,196,52,52,0,1,0
16,217,217,64,13,51,4,3
22,243,243,9,5,4,2,1
12,263,263,3,3,0,1,0
11,267,267,50,10,40,3,2
7,267,267,89,82,7,2,1
4,267,267,6,1,5,2,1
3,275,275,18,18,0,1,0
20,288,288,6,6,0,1,0
19,334,334,94,63,31,4,3
15,346,346,21,12,9,3,2
1,423,423,17,9,8,3,2
23,435,435,12,7,5,2,1
10,436,436,11,11,0,1,0
26,456,456,12,12,0,1,0
9,486,486,35,21,14,3,2
24,491,491,19,19,0,1,0

1,102,102,21,21,0,1,0
8,110,110,1,1,0,1,0
13,115,115,4,4,0,1,0
21,140,140,2,2,0,1,0
12,151,151,12,12,0,1,0
3,176,176,52,2,50,2,1
20,222,222,11,5,6,2,1
18,230,230,26,26,0,1,0
10,233,233,119,119,0,1,0
9,234,234,49,49,0,1,0
7,236,236,25,18,7,2,1
5,253,253,38,30,8,2,1
17,257,257,1,1,0,1,0
2,275,275,40,31,9,2,1
11,332,332,22,19,3,2,1
6,332,332,1,1,0,1,0
15,357,357,31,11,20,3,2
19,369,369,100,100,0,1,0
16,397,397,11,5,6,2,1
22,431,431,12,12,0,1,0
0,475,475,2,2,0,1,0
14,492,492,24,24,0,1,0
4,497,497,87,87,0,1,0

22,110,110,4,4,0,1,0
20,124,124,1,1,0,1,0
10,165,165,9,9,0,1,0
2,170,170,83,83,0,1,0
3,171,171,17,1,16,3,2
0,172,172,1,1,0,1,0
9,193,193,13,13,0,1,0
17,205,205,3,3,0,1,0
7,207,207,5,5,0,1,0
21,212,212,10,5,5,2,1
13,240,240,73,24,49,2,1
18,242,242,2,2,0,1,0
5,307,307,1,1,0,1,0
6,329,329,77,56,21,4,3
4,350,350,4,4,0,1,0
24,364,364,2,2,0,1,0
23,399,399,84,5,79,4,3
14,401,401,61,18,43,2,1
8,409,409,39,1,38,3,2
11,456,456,35,35,0,1,0
1,456,456,64,64,0,1,0
15,465,465,19,4,15,2,1
19,468,468,30,8,22,2,1
12,470,470,93,66,27,4,3
16,490,490,115,70,45,4,3

18,105,105,1,1,0,1,0
19,146,146,15,15,0,1,0
16,165,165,12,12,0,1,0
7,189,189,19,7,12,3,2
5,217,217,100,53,47,3,2
3,241,241,6,6,0,1,0
17,244,244,10,10,0,1,0
10,265,265,79,49,30,2,1
9,272,272,43,17,26,3,2
15,273,273,69,7,62,3,2
11,280,280,17,17,0,1,0
2,311,311,28,28,0,1,0
0,377,377,56,56,0,1,0
20,424,424,65,42,23,2,1
12,458,458,12,6,6,2,1
6,465,465,159,145,14,3,2
14,472,472,45,10,35,2,1
8,475,475,5,5,0,1,0
4,476,476,53,44,9,4,3
13,477,477,19,19,0,1,0
1,491,491,11,1,10,2,1

6,119,119,5,5,0,1,0
5,139,139,14,14,0,1,0
15,139,139,3,3,0,1,0
17,152,152,2,2,0,1,0
0,155,155,33,33,0,1,0
4,159,159,25,7,18,4,3
18,195,195,50,2,48,3,2
1,272,272,23,3,20,2,1
16,282,282,48,36,12,3,2
2,286,286,22,9,13,2,1
20,296,296,12,3,9,3,2
19,351,351,4,4,0,1,0
13,384,384,18,8,10,3,2
12,401,401,42,9,33,4,3
3,411,411,208,142,66,4,3
10,415,415,28,6,22,3,2
7,427,427,52,3,49,2,1
9,466,466,85,81,4,2,1
11,472,472,105,74,31,2,1
14,474,474,29,29,0,1,0
8,480,480,60,60,0,1,0

13,137,137,23,1,22,3,2
19,154,154,8,2,6,2,1
23,168,168,15,15,0,1,0
10,228,228,9,2,7,2,1
1,238,238,4,1,3,2,1
8,247,247,14,14,0,1,0
11,267,267,66,66,0,1,0
3,267,267,163,149,14,3,2
22,282,282,25,20,5,2,1
20,300,300,21,9,12,3,2
21,324,324,28,10,18,3,2
18,371,371,62,30,32,4,3
4,378,378,48,22,26,3,2
2,383,383,38,4,34,2,1
15,391,391,67,67,0,1,0
5,394,394,37,28,9,4,3
17,423,423,55,55,0,1,0
14,434,434,10,10,0,1,0
6,436,436,10,10,0,1,0
7,441,441,57,33,24,2,1
0,446,446,26,26,0,1,0
12,451,451,10,10,0,1,0
9,458,458,22,22,0,1,0
16,499,499,3,3,0,1,0

16,105,105,2,2,0,1,0
0,111,111,5,5,0,1,0
9,127,127,28,28,0,1,0
19,152,152,1,1,0,1,0
20,184,184,15,15,0,1,0
4,192,192,17,17,0,1,0
7,214,214,5,5,0,1,0
17,228,228,13,3,10,2,1
5,239,239,43,43,0,1,0
14,243,243,12,5,7,2,1
11,271,271,89,53,36,2,1
21,282,282,75,27,48,4,3
2,295,295,68,32,36,2,1
1,309,309,24,24,0,1,0
8,310,310,52,52,0,1,0
10,324,324,11,11,0,1,0
15,329,329,17,17,0,1,0
18,339,339,47,47,0,1,0
6,374,374,99,99,0,1,0
22,379,379,18,18,0,1,0
12,403,403,9,3,6,3,2
3,421,421,4,4,0,1,0
13,479,479,110,36,74,3,2

22,102,102,1,1,0,1,0
31,105,105,18,10,8,3,2
9,108,108,1,1,0,1,0
30,113,113,24,8,16,2,1
16,115,115,24,24,0,1,0
14,116,116,1,1,0,1,0
26,118,118,24,24,0,1,0
18,124,124,1,1,0,1,0
24,128,128,10,1,9,4,3
21,142,142,1,1,0,1,0
33,152,152,39,3,36,3,2
15,153,153,2,2,0,1,0
1,180,180,7,7,0,1,0
20,187,187,14,14,0,1,0
29,205,205,18,14,4,2,1
13,228,228,4,4,0,1,0
3,289,289,5,5,0,1,0
32,290,290,38,32,6,2,1
28,295,295,16,16,0,1,0
10,296,296,8,1,7,2,1
27,299,299,10,10,0,1,0
19,309,309,11,1,10,2,1
12,318,318,1,1,0,1,0
23,344,344,23,23,0,1,0
5,351,351,22,22,0,1,0
2,375,375,45,30,15,4,3
4,384,384,12,12,0,1,0
7,404,404,32,23,9,2,1
34,405,405,6,6,0,1,0
6,416,416,6,6,0,1,0
25,450,450,5,2,3,2,1
35,464,464,6,6,0,1,0
0,469,469,158,119,39,2,1
11,481,481,33,17,16,3,2
17,494,494,33,30,3,2,1
8,496,496,24,18,6,3,2

10,128,128,23,5,18,4,3
25,131,131,17,17,0,1,0
6,149,149,2,2,0,1,0
28,167,167,2,2,0,1,0
5,169,169,8,8,0,1,0
19,175,175,15,6,9,2,1
2,186,186,19,19,0,1,0
26,196,196,6,6,0,1,0
3,213,213,28,28,0,1,0
14,229,229,13,13,0,1,0
11,230,230,8,8,0,1,0
24,265,265,30,12,18,4,3
16,270,270,22,10,12,4,3
22,290,290,5,5,0,1,0
13,294,294,12,12,0,1,0
18,305,305,6,1,5,2,1
7,338,338,13,7,6,2,1
21,348,348,45,45,0,1,0
0,365,365,65,17,48,4,3
20,370,370,144,102,42,3,2
1,371,371,1,1,0,1,0
4,401,401,24,7,17,2,1
8,403,403,19,9,10,3,2
27,407,407,12,12,0,1,0
30,443,443,49,5,44,3,2
29,447,447,20,13,7,2,1
17,451,451,14,4,10,2,1
31,455,455,26,12,14,3,2
9,456,456,10,2,8,2,1
12,466,466,48,9,39,2,1
15,494,494,56,56,0,1,0
23,499,499,86,4,82,3,2

9,104,104,23,5,18,4,3
25,105,105,16,10,6,3,2
12,118,118,8,8,0,1,0
21,118,118,14,6,8,3,2
6,153,153,21,21,0,1,0
11,156,156,1,1,0,1,0
8,201,201,14,4,10,2,1
16,201,201,20,20,0,1,0
1,204,204,28,12,16,2,1
5,204,204,30,10,20,2,1
17,212,212,27,27,0,1,0
24,225,225,5,5,0,1,0
2,248,248,62,62,0,1,0
23,249,249,7,2,5,2,1
20,255,255,2,2,0,1,0
15,258,258,1,1,0,1,0
0,279,279,2,2,0,1,0
13,291,291,9,9,0,1,0
18,370,370,83,45,38,4,3
4,395,395,4,4,0,1,0
26,397,397,4,4,0,1,0
10,404,404,3,3,0,1,0
3,423,423,71,17,54,4,3
22,476,476,21,21,0,1,0
14,483,483,130,130,0,1,0
19,485,485,109,33,76,3,2
7,496,496,20,11,9,4,3

12,106,106,19,3,16,3,2
6,120,120,6,3,3,2,1
0,133,133,14,10,4,2,1
19,136,136,6,6,0,1,0
3,152,152,11,7,4,2,1
18,207,207,14,2,12,3,2
15,210,210,25,13,12,2,1
2,214,214,66,60,6,3,2
20,241,241,19,15,4,2,1
1,241,241,28,14,14,2,1
16,324,324,20,8,12,3,2
11,336,336,103,94,9,4,3
8,349,349,11,1,10,2,1
5,358,358,186,147,39,4,3
10,369,369,11,5,6,3,2
14,385,385,14,14,0,1,0
17,391,391,75,30,45,4,3
9,423,423,20,20,0,1,0
4,454,454,8,8,0,1,0
7,467,467,52,52,0,1,0
13,494,494,64,36,28,2,1

6,108,108,19,19,0,1,0
19,109,109,7,7,0,1,0
2,110,110,22,5,17,4,3
17,148,148,15,6,9,4,3
12,150,150,8,8,0,1,0
15,153,153,12,12,0,1,0
14,197,197,14,8,6,2,1
10,209,209,18,18,0,1,0
4,234,234,56,56,0,1,0
3,245,245,2,2,0,1,0
20,258,258,5,5,0,1,0
9,282,282,35,35,0,1,0
22,293,293,18,18,0,1,0
7,309,309,56,56,0,1,0
23,313,313,79,67,12,4,3
0,314,314,25,18,7,2,1
1,335,335,61,23,38,3,2
16,344,344,2,2,0,1,0
13,384,384,17,8,9,4,3
5,385,385,1,1,0,1,0
11,393,393,50,50,0,1,0
8,409,409,10,1,9,3,2
21,419,419,132,52,80,3,2
18,462,462,66,22,44,2,1

8,119,119,56,8,48,4,3
2,125,125,5,5,0,1,0
20,157,157,4,4,0,1,0
10,159,159,23,5,18,4,3
0,161,161,9,9,0,1,0
21,176,176,31,16,15,4,3
1,237,237,26,10,16,3,2
9,247,247,18,6,12,3,2
4,247,247,19,10,9,2,1
17,259,259,50,50,0,1,0
5,284,284,11,11,0,1,0
6,319,319,103,70,33,2,1
11,321,321,31,3,28,2,1
7,323,323,5,5,0,1,0
15,327,327,27,27,0,1,0
12,334,334,13,1,12,4,3
3,394,394,69,62,7,2,1
13,402,402,42,21,21,2,1
19,432,432,77,72,5,2,1
14,445,445,4,4,0,1,0
18,494,494,57,57,0,1,0
16,496,496,43,32,11,2,1

11,101,101,7,7,0,1,0
13,111,111,6,6,0,1,0
15,133,133,32,32,0,1,0
14,164,164,3,3,0,1,0
1,197,197,141,141,0,1,0
9,263,263,16,6,10,2,1
3,345,345,112,112,0,1,0
0,346,346,27,27,0,1,0
12,358,358,2,2,0,1,0
17,377,377,15,15,0,1,0
2,390,390,12,12,0,1,0
6,392,392,80,80,0,1,0
7,447,447,9,4,5,2,1
8,451,451,9,9,0,1,0
10,480,480,10,4,6,3,2
16,480,480,86,4,82,3,2
5,484,484,192,120,72,4,3
4,499,499,76,76,0,1,0

23,111,111,15,15,0,1,0
12,128,128,16,16,0,1,0
1,134,134,20,1,19,2,1
7,143,143,4,4,0,1,0
10,159,159,17,9,8,3,2
16,163,163,4,4,0,1,0
0,172,172,8,8,0,1,0
13,199,199,7,7,0,1,0
21,221,221,9,5,4,2,1
2,235,235,19,8,11,2,1
6,263,263,1,1,0,1,0
24,273,273,13,13,0,1,0
19,282,282,7,2,5,2,1
22,291,291,82,82,0,1,0
17,301,301,2,2,0,1,0
5,303,303,10,1,9,4,3
15,308,308,77,49,28,4,3
9,314,314,29,29,0,1,0
14,332,332,13,13,0,1,0
18,370,370,64,64,0,1,0
11,377,377,76,42,34,3,2
20,389,389,34,20,14,2,1
4,430,430,61,23,38,2,1
3,446,446,20,20,0,1,0
25,453,453,65,65,0,1,0
27,467,467,16,16,0,1,0
26,473,473,36,33,3,2,1
8,473,473,82,45,37,4,3

1,101,101,5,5,0,1,0
5,112,112,14,10,4,2,1
15,114,114,4,4,0,1,0
14,127,127,22,19,3,2,1
19,136,136,8,8,0,1,0
17,168,168,59,7,52,3,2
4,177,177,62,62,0,1,0
7,190,190,11,11,0,1,0
16,194,194,13,13,0,1,0
22,197,197,34,4,30,4,3
8,206,206,1,1,0,1,0
10,207,207,8,8,0,1,0
25,211,211,7,2,5,2,1
13,216,216,12,8,4,2,1
0,249,249,38,38,0,1,0
24,259,259,21,9,12,2,1
6,262,262,18,18,0,1,0
3,283,283,12,3,9,2,1
9,284,284,17,3,14,2,1
12,304,304,24,24,0,1,0
18,333,333,18,12,6,2,1
21,335,335,19,5,14,2,1
11,364,364,69,63,6,3,2
2,385,385,32,17,15,2,1
23,389,389,62,62,0,1,0
20,450,450,16,10,6,2,1

23,114,114,6,6,0,1,0
2,145,145,54,7,47,2,1
14,151,151,9,9,0,1,0
1,161,161,23,23,0,1,0
20,242,242,25,25,0,1,0
13,242,242,18,15,3,2,1
6,245,245,52,43,9,2,1
5,257,257,1,1,0,1,0
11,268,268,2,2,0,1,0
9,300,300,61,61,0,1,0
18,306,306,29,29,0,1,0
4,314,314,4,4,0,1,0
17,333,333,1,1,0,1,0
7,337,337,41,28,13,2,1
19,352,352,82,1,81,4,3
21,357,357,78,50,28,3,2
16,358,358,1,1,0,1,0
8,365,365,12,9,3,2,1
10,372,372,30,10,20,2,1
12,399,399,10,6,4,2,1
0,406,406,14,14,0,1,0
3,467,467,39,6,33,4,3
15,477,477,155,82,73,4,3
22,493,493,61,53,8,3,2

5,103,103,1,1,0,1,0
10,115,115,1,1,0,1,0
17,134,134,32,16,16,2,1
20,182,182,17,17,0,1,0
26,203,203,8,8,0,1,0
28,236,236,11,11,0,1,0
9,267,267,64,1,63,3,2
12,267,267,21,17,4,2,1
16,267,267,7,7,0,1,0
11,280,280,11,11,0,1,0
2,311,311,33,29,4,2,1
21,328,328,73,27,46,2,1
0,339,339,8,8,0,1,0
14,347,347,31,31,0,1,0
24,359,359,41,17,24,4,3
19,372,372,34,13,21,4,3
25,379,379,25,19,6,2,1
15,381,381,20,5,15,2,1
3,387,387,109,46,63,4,3
27,395,395,41,21,20,2,1
7,400,400,6,6,0,1,0
22,404,404,55,28,27,4,3
1,408,408,1,1,0,1,0
8,408,408,34,34,0,1,0
23,414,414,28,28,0,1,0
4,432,432,6,2,4,2,1
6,472,472,105,78,27,2,1
13,474,474,16,16,0,1,0
18,480,480,34,8,26,2,1

23,128,128,8,2,6,3,2
7,139,139,3,3,0,1,0
16,143,143,23,23,0,1,0
19,153,153,30,30,0,1,0
26,168,168,17,11,6,3,2
17,176,176,8,8,0,1,0
8,219,219,25,25,0,1,0
22,236,236,44,35,9,2,1
13,260,260,8,8,0,1,0
20,273,273,11,11,0,1,0
29,282,282,25,25,0,1,0
10,299,299,4,4,0,1,0
2,301,301,8,8,0,1,0
6,310,310,28,8,20,2,1
24,312,312,5,5,0,1,0
1,333,333,31,2,29,2,1
27,338,338,43,43,0,1,0
0,339,339,22,22,0,1,0
5,364,364,1,1,0,1,0
21,369,369,9,9,0,1,0
25,370,370,63,63,0,1,0
4,389,389,36,2,34,3,2
15,408,408,12,3,9,4,3
12,435,435,48,11,37,2,1
9,435,435,17,5,12,3,2
14,453,453,139,111,28,3,2
3,466,466,20,4,16,3,2
11,481,481,30,30,0,1,0
28,487,487,24,2,22,3,2
18,498,498,110,110,0,1,0

3,112,112,14,11,3,2,1
16,116,116,1,1,0,1,0
6,127,127,13,13,0,1,0
9,129,129,9,4,5,2,1
18,151,151,5,5,0,1,0
8,165,165,3,3,0,1,0
15,172,172,56,56,0,1,0
2,173,173,1,1,0,1,0
5,193,193,11,3,8,3,2
10,201,201,31,21,10,2,1
14,202,202,11,1,10,2,1
20,282,282,27,27,0,1,0
11,328,328,134,134,0,1,0
12,340,340,1,1,0,1,0
0,343,343,112,88,24,2,1
7,345,345,153,141,12,3,2
21,380,380,1,1,0,1,0
17,381,381,39,19,20,3,2
13,383,383,3,3,0,1,0
19,412,412,25,6,19,2,1
4,426,426,88,88,0,1,0
1,445,445,7,7,0,1,0

17,100,100,19,6,13,2,1
10,107,107,3,3,0,1,0
29,114,114,3,3,0,1,0
16,128,128,9,9,0,1,0
9,161,161,1,1,0,1,0
22,179,179,32,16,16,3,2
4,239,239,20,2,18,2,1
24,254,254,21,3,18,2,1
21,268,268,51,51,0,1,0
13,281,281,2,2,0,1,0
6,284,284,1,1,0,1,0
3,293,293,17,2,15,2,1
11,293,293,2,2,0,1,0
25,301,301,5,5,0,1,0
23,306,306,7,7,0,1,0
19,307,307,8,8,0,1,0
18,310,310,2,2,0,1,0
12,310,310,18,18,0,1,0
15,335,335,83,83,0,1,0
27,355,355,117,21,96,4,3
0,362,362,60,60,0,1,0
1,369,369,70,15,55,3,2
28,370,370,18,18,0,1,0
8,387,387,12,12,0,1,0
14,397,397,85,85,0,1,0
2,416,416,23,7,16,3,2
20,422,422,14,14,0,1,0
7,429,429,1,1,0,1,0
26,438,438,81,44,37,3,2
5,446,446,34,34,0,1,0

4,114,114,50,50,0,1,0
23,153,153,10,10,0,1,0
0,163,163,3,3,0,1,0
7,165,165,11,5,6,2,1
1,177,177,10,3,7,2,1
18,178,178,3,3,0,1,0
20,186,186,17,17,0,1,0
5,206,206,5,5,0,1,0
16,213,213,8,8,0,1,0
22,238,238,27,18,9,4,3
12,275,275,19,1,18,3,2
8,277,277,2,2,0,1,0
6,310,310,2,2,0,1,0
17,311,311,56,3,53,4,3
3,312,312,75,66,9,4,3
14,314,314,43,43,0,1,0
24,315,315,119,26,93,4,3
25,368,368,25,25,0,1,0
21,371,371,20,20,0,1,0
15,417,417,58,58,0,1,0
26,444,444,8,8,0,1,0
27,446,446,32,32,0,1,0
19,446,446,39,11,28,3,2
13,466,466,30,16,14,2,1
2,473,473,3,3,0,1,0
9,481,481,49,49,0,1,0
11,490,490,29,29,0,1,0
10,493,493,3,3,0,1,0

5,117,117,2,2,0,1,0
12,118,118,19,19,0,1,0
22,122,122,34,15,19,2,1
25,141,141,5,5,0,1,0
15,145,145,16,16,0,1,0
24,183,183,3,3,0,1,0
9,191,191,3,3,0,1,0
4,192,192,72,72,0,1,0
17,238,238,34,34,0,1,0
19,239,239,10,10,0,1,0
20,249,249,2,2,0,1,0
18,290,290,1,1,0,1,0
6,293,293,28,4,24,2,1
3,295,295,1,1,0,1,0
8,295,295,5,5,0,1,0
7,329,329,33,4,29,4,3
13,341,341,97,97,0,1,0
1,343,343,27,13,14,3,2
16,366,366,124,50,74,4,3
10,404,404,32,24,8,2,1
11,405,405,126,18,108,4,3
14,418,418,13,1,12,2,1
2,436,436,5,5,0,1,0
23,438,438,11,11,0,1,0
21,450,450,5,2,3,2,1
0,461,461,16,13,3,2,1

11,152,152,5,5,0,1,0
13,162,162,10,10,0,1,0
10,163,163,37,37,0,1,0
27,189,189,27,6,21,4,3
4,195,195,11,5,6,3,2
12,205,205,1,1,0,1,0
20,216,216,63,15,48,4,3
17,225,225,11,11,0,1,0
22,241,241,13,5,8,3,2
28,252,252,15,15,0,1,0
5,259,259,53,53,0,1,0
24,273,273,23,7,16,2,1
8,275,275,38,29,9,4,3
2,281,281,7,7,0,1,0
14,285,285,1,1,0,1,0
23,335,335,5,5,0,1,0
3,336,336,31,31,0,1,0
21,337,337,25,1,24,2,1
0,392,392,38,38,0,1,0
18,397,397,56,56,0,1,0
6,400,400,7,1,6,3,2
25,400,400,49,49,0,1,0
1,404,404,1,1,0,1,0
9,431,431,32,2,30,4,3
19,438,438,24,1,23,2,1
16,438,438,58,8,50,2,1
15,440,440,62,62,0,1,0
7,475,475,58,42,16,3,2
26,491,491,49,11,38,3,2

6,132,132,1,1,0,1,0
14,173,173,5,5,0,1,0
12,217,217,2,2,0,1,0
1,250,250,40,15,25,2,1
15,258,258,87,87,0,1,0
13,259,259,19,3,16,2,1
20,263,263,3,3,0,1,0
21,300,300,3,3,0,1,0
7,305,305,41,41,0,1,0
0,318,318,64,60,4,2,1
9,323,323,18,18,0,1,0
22,350,350,6,1,5,2,1
10,354,354,89,89,0,1,0
16,359,359,39,18,21,4,3
2,377,377,16,11,5,2,1
11,382,382,29,29,0,1,0
25,386,386,88,10,78,4,3
23,387,387,61,4,57,3,2
24,389,389,36,36,0,1,0
3,408,408,7,4,3,2,1
4,420,420,66,66,0,1,0
5,427,427,1,1,0,1,0
19,441,441,18,18,0,1,0
8,443,443,84,21,63,4,3
17,457,457,2,2,0,1,0
18,483,483,102,8,94,4,3

22,103,103,33,19,14,2,1
20,116,116,13,13,0,1,0
15,145,145,6,6,0,1,0
8,146,146,27,27,0,1,0
13,155,155,30,30,0,1,0
24,159,159,8,8,0,1,0
7,197,197,1,1,0,1,0
0,258,258,54,5,49,3,2
3,258,258,12,5,7,2,1
25,270,270,2,2,0,1,0
16,280,280,3,3,0,1,0
19,289,289,25,5,20,2,1
2,329,329,10,6,4,2,1
10,362,362,59,59,0,1,0
23,381,381,157,131,26,3,2
5,384,384,17,9,8,2,1
11,388,388,11,2,9,4,3
17,415,415,13,13,0,1,0
4,415,415,24,17,7,2,1
18,434,434,8,8,0,1,0
6,439,439,63,19,44,4,3
14,441,441,7,7,0,1,0
21,445,445,12,8,4,2,1
12,479,479,53,21,32,3,2
9,482,482,2,2,0,1,0
1,494,494,135,44,91,3,2

5,106,106,14,14,0,1,0
19,154,154,23,5,18,2,1
6,184,184,18,18,0,1,0
2,191,191,32,6,26,2,1
8,211,211,45,16,29,2,1
17,213,213,11,3,8,2,1
1,214,214,2,2,0,1,0
3,225,225,23,19,4,2,1
22,232,232,16,10,6,2,1
11,239,239,10,10,0,1,0
4,243,243,23,23,0,1,0
7,247,247,9,3,6,3,2
0,254,254,49,22,27,4,3
15,260,260,9,9,0,1,0
13,270,270,38,10,28,4,3
9,275,275,11,11,0,1,0
18,309,309,55,15,40,4,3
23,319,319,55,55,0,1,0
21,321,321,11,1,10,3,2
26,327,327,40,36,4,2,1
16,328,328,28,10,18,3,2
10,330,330,10,10,0,1,0
12,358,358,1,1,0,1,0
24,359,359,19,19,0,1,0
25,365,365,42,42,0,1,0
20,445,445,19,19,0,1,0
14,476,476,102,90,12,2,1

24,103,103,3,3,0,1,0
27,118,118,15,15,0,1,0
17,134,134,9,9,0,1,0
11,144,144,12,6,6,2,1
0,146,146,4,4,0,1,0
23,155,155,38,22,16,3,2
19,159,159,5,5,0,1,0
10,166,166,26,8,18,2,1
21,168,168,7,7,0,1,0
3,173,173,38,38,0,1,0
4,175,175,3,3,0,1,0
26,178,178,13,13,0,1,0
2,197,197,12,12,0,1,0
5,243,243,13,13,0,1,0
28,274,274,64,44,20,2,1
22,301,301,4,1,3,2,1
1,301,301,47,47,0,1,0
7,327,327,26,7,19,2,1
25,366,366,19,13,6,3,2
12,383,383,47,22,25,2,1
6,393,393,11,11,0,1,0
20,394,394,26,11,15,4,3
8,398,398,17,17,0,1,0
9,434,434,24,1,23,2,1
18,439,439,33,6,27,2,1
13,476,476,24,24,0,1,0
15,482,482,64,19,45,2,1
16,488,488,136,119,17,2,1
14,500,500,7,7,0,1,0

1,109,109,1,1,0,1,0
6,145,145,26,8,18,2,1
10,167,167,9,9,0,1,0
16,206,206,30,3,27,4,3
20,227,227,28,22,6,3,2
17,232,232,6,1,5,2,1
18,233,233,71,23,48,4,3
5,253,253,31,31,0,1,0
21,261,261,2,2,0,1,0
11,274,274,20,13,7,3,2
19,285,285,27,7,20,2,1
15,304,304,42,42,0,1,0
14,323,323,8,2,6,3,2
12,324,324,27,27,0,1,0
0,354,354,133,133,0,1,0
13,371,371,32,14,18,3,2
4,376,376,2,2,0,1,0
23,388,388,4,4,0,1,0
22,390,390,82,56,26,2,1
8,391,391,55,28,27,4,3
7,452,452,26,26,0,1,0
2,477,477,88,22,66,3,2
3,482,482,3,3,0,1,0
9,500,500,85,58,27,3,2

24,116,116,8,8,0,1,0
0,141,141,6,1,5,2,1
29,157,157,2,2,0,1,0
9,159,159,27,11,16,2,1
6,172,172,17,17,0,1,0
22,175,175,51,51,0,1,0
26,186,186,28,28,0,1,0
2,189,189,1,1,0,1,0
8,234,234,6,6,0,1,0
12,244,244,29,29,0,1,0
25,244,244,33,9,24,4,3
1,257,257,13,4,9,2,1
16,264,264,11,8,3,2,1
5,268,268,17,2,15,4,3
28,281,281,6,6,0,1,0
3,282,282,30,20,10,3,2
18,337,337,4,1,3,2,1
11,340,340,8,5,3,2,1
21,343,343,68,68,0,1,0
7,344,344,54,33,21,4,3
20,351,351,31,9,22,2,1
10,360,360,15,6,9,2,1
23,373,373,9,9,0,1,0
31,380,380,37,37,0,1,0
13,392,392,12,9,3,2,1
15,446,446,45,14,31,2,1
17,454,454,9,9,0,1,0
4,458,458,35,17,18,4,3
30,478,478,102,45,57,3,2
27,491,491,1,1,0,1,0
19,497,497,12,12,0,1,0
14,497,497,58,58,0,1,0

9,104,104,4,4,0,1,0
7,121,121,28,28,0,1,0
22,132,132,39,39,0,1,0
3,140,140,15,2,13,2,1
5,152,152,1,1,0,1,0
15,168,168,19,3,16,3,2
19,182,182,33,33,0,1,0
26,195,195,12,3,9,4,3
23,202,202,13,13,0,1,0
12,217,217,6,6,0,1,0
6,225,225,2,2,0,1,0
4,251,251,30,30,0,1,0
0,261,261,43,29,14,3,2
18,276,276,51,51,0,1,0
2,287,287,1,1,0,1,0
14,296,296,7,7,0,1,0
25,320,320,27,6,21,4,3
20,331,331,23,23,0,1,0
11,332,332,1,1,0,1,0
16,380,380,44,44,0,1,0
24,404,404,37,32,5,2,1
21,408,408,1,1,0,1,0
8,422,422,155,5,150,4,3
10,459,459,40,40,0,1,0
13,476,476,1,1,0,1,0
1,485,485,65,21,44,3,2
17,488,488,18,2,16,3,2

14,100,100,1,1,0,1,0
21,116,116,5,5,0,1,0
32,117,117,16,2,14,2,1
22,119,119,6,6,0,1,0
29,120,120,2,2,0,1,0
28,137,137,13,3,10,2,1
6,149,149,18,14,4,2,1
13,168,168,21,21,0,1,0
17,183,183,12,12,0,1,0
31,198,198,5,5,0,1,0
1,225,225,2,2,0,1,0
19,228,228,32,32,0,1,0
12,231,231,5,5,0,1,0
7,232,232,3,3,0,1,0
20,251,251,123,123,0,1,0
16,260,260,4,4,0,1,0
26,267,267,1,1,0,1,0
15,278,278,14,8,6,3,2
5,284,284,6,6,0,1,0
30,348,348,14,14,0,1,0
10,351,351,67,67,0,1,0
3,355,355,43,3,40,3,2
25,362,362,31,31,0,1,0
0,376,376,12,6,6,2,1
11,378,378,1,1,0,1,0
23,387,387,36,11,25,2,1
2,399,399,4,1,3,2,1
4,410,410,69,36,33,4,3
18,422,422,52,46,6,3,2
27,424,424,15,15,0,1,0
8,440,440,25,25,0,1,0
9,445,445,2,2,0,1,0
24,488,488,109,67,42,4,3

7,117,117,31,31,0,1,0
13,148,148,7,7,0,1,0
18,175,175,13,13,0,1,0
11,198,198,26,26,0,1,0
20,224,224,12,12,0,1,0
6,242,242,1,1,0,1,0
14,242,242,160,31,129,4,3
0,253,253,30,30,0,1,0
8,264,264,17,4,13,2,1
9,266,266,1,1,0,1,0
3,270,270,39,26,13,2,1
16,272,272,7,7,0,1,0
22,275,275,41,41,0,1,0
4,284,284,6,6,0,1,0
23,305,305,4,4,0,1,0
15,329,329,2,2,0,1,0
1,334,334,59,3,56,4,3
17,338,338,4,4,0,1,0
19,361,361,35,3,32,3,2
10,386,386,37,4,33,2,1
2,392,392,92,92,0,1,0
12,397,397,19,19,0,1,0
5,409,409,18,10,8,2,1
21,421,421,55,55,0,1,0
24,492,492,4,1,3,2,1

2,104,104,7,7,0,1,0
0,116,116,8,4,4,2,1
4,128,128,47,47,0,1,0
7,167,167,36,4,32,2,1
14,181,181,12,12,0,1,0
9,199,199,3,3,0,1,0
5,223,223,9,6,3,2,1
3,225,225,13,13,0,1,0
18,296,296,12,6,6,3,2
16,319,319,23,23,0,1,0
17,337,337,83,49,34,3,2
19,362,362,27,3,24,2,1
6,376,376,4,4,0,1,0
22,378,378,5,2,3,2,1
20,386,386,8,2,6,3,2
11,397,397,84,26,58,3,2
13,402,402,77,34,43,2,1
12,421,421,125,116,9,4,3
1,424,424,139,80,59,4,3
15,426,426,3,3,0,1,0
8,446,446,25,7,18,2,1
10,450,450,33,1,32,3,2
21,462,462,30,30,0,1,0
23,473,473,7,7,0,1,0

6,108,108,4,4,0,1,0
12,136,136,15,5,10,3,2
9,139,139,38,32,6,3,2
2,170,170,8,8,0,1,0
24,211,211,41,41,0,1,0
4,223,223,23,9,14,3,2
17,228,228,28,28,0,1,0
7,236,236,27,27,0,1,0
1,245,245,3,3,0,1,0
5,249,249,10,5,5,2,1
21,292,292,33,33,0,1,0
11,351,351,1,1,0,1,0
3,359,359,45,45,0,1,0
18,364,364,57,15,42,3,2
19,370,370,58,58,0,1,0
20,383,383,62,26,36,2,1
22,394,394,1,1,0,1,0
13,406,406,6,3,3,2,1
25,418,418,15,3,12,4,3
15,421,421,31,9,22,2,1
10,445,445,46,46,0,1,0
0,468,468,23,3,20,2,1
8,472,472,134,134,0,1,0
16,473,473,51,51,0,1,0
23,473,473,3,3,0,1,0
14,477,477,84,57,27,4,3

7,112,112,9,9,0,1,0
0,137,137,8,4,4,2,1
21,137,137,16,7,9,2,1
14,143,143,1,1,0,1,0
8,156,156,64,55,9,2,1
4,165,165,20,20,0,1,0
13,168,168,19,19,0,1,0
6,204,204,5,5,0,1,0
10,215,215,3,3,0,1,0
1,232,232,36,36,0,1,0
5,262,262,2,2,0,1,0
20,264,264,10,10,0,1,0
2,265,265,17,12,5,2,1
3,323,323,15,15,0,1,0
17,356,356,41,41,0,1,0
18,368,368,8,8,0,1,0
15,387,387,58,44,14,2,1
12,389,389,110,110,0,1,0
22,396,396,14,14,0,1,0
16,399,399,32,13,19,4,3
19,422,422,85,76,9,4,3
11,474,474,73,20,53,3,2
9,486,486,162,162,0,1,0

0,115,115,7,7,0,1,0
4,119,119,44,10,34,3,2
18,130,130,4,1,3,2,1
14,151,151,24,24,0,1,0
9,172,172,34,13,21,4,3
23,174,174,39,39,0,1,0
17,174,174,26,26,0,1,0
20,176,176,11,3,8,3,2
7,191,191,21,21,0,1,0
21,194,194,14,5,9,4,3
2,194,194,16,16,0,1,0
11,205,205,19,2,17,2,1
6,206,206,23,11,12,2,1
13,259,259,28,28,0,1,0
3,283,283,34,25,9,2,1
16,287,287,18,18,0,1,0
15,291,291,18,15,3,2,1
19,311,311,57,57,0,1,0
1,362,362,28,28,0,1,0
12,394,394,23,17,6,2,1
22,454,454,30,22,8,3,2
10,472,472,33,4,29,4,3
8,497,497,14,14,0,1,0
5,500,500,37,37,0,1,0

25,114,114,33,20,13,2,1
12,118,118,12,5,7,2,1
5,142,142,21,21,0,1,0
21,154,154,10,2,8,2,1
1,158,158,4,4,0,1,0
14,197,197,4,1,3,2,1
24,222,222,27,27,0,1,0
8,232,232,22,9,13,2,1
3,234,234,5,2,3,2,1
6,240,240,49,17,32,4,3
17,244,244,9,9,0,1,0
7,274,274,6,6,0,1,0
22,285,285,27,27,0,1,0
15,317,317,17,17,0,1,0
9,344,344,47,47,0,1,0
0,359,359,96,48,48,3,2
10,374,374,70,16,54,4,3
20,403,403,62,37,25,4,3
2,411,411,19,15,4,2,1
23,411,411,21,21,0,1,0
13,415,415,11,11,0,1,0
4,416,416,11,2,9,4,3
16,483,483,91,58,33,2,1
18,487,487,37,31,6,3,2
19,489,489,73,52,21,2,1
11,494,494,10,10,0,1,0

14,123,123,29,29,0,1,0
30,130,130,4,4,0,1,0
7,140,140,15,15,0,1,0
6,149,149,1,1,0,1,0
20,172,172,25,16,9,2,1
17,178,178,1,1,0,1,0
24,181,181,2,2,0,1,0
4,202,202,1,1,0,1,0
16,205,205,67,34,33,2,1
12,219,219,1,1,0,1,0
18,229,229,2,2,0,1,0
27,243,243,36,36,0,1,0
1,249,249,6,2,4,2,1
3,263,263,7,7,0,1,0
15,272,272,12,3,9,4,3
2,298,298,30,30,0,1,0
0,305,305,46,46,0,1,0
28,317,317,36,30,6,3,2
11,318,318,1,1,0,1,0
9,325,325,1,1,0,1,0
19,334,334,76,8,68,4,3
5,340,340,11,11,0,1,0
25,369,369,85,57,28,2,1
8,380,380,8,3,5,2,1
23,389,389,21,21,0,1,0
29,397,397,10,10,0,1,0
10,397,397,55,55,0,1,0
22,407,407,16,16,0,1,0
13,408,408,23,11,12,2,1
31,424,424,44,5,39,2,1
26,472,472,24,10,14,3,2
21,496,496,72,72,0,1,0

7,100,100,10,1,9,2,1
26,101,101,1,1,0,1,0
27,129,129,6,6,0,1,0
21,138,138,38,29,9,2,1
1,179,179,46,46,0,1,0
24,193,193,18,18,0,1,0
8,199,199,6,6,0,1,0
25,199,199,10,7,3,2,1
11,215,215,2,2,0,1,0
18,219,219,10,1,9,2,1
10,223,223,18,18,0,1,0
6,230,230,34,34,0,1,0
15,231,231,79,79,0,1,0
0,232,232,41,41,0,1,0
20,246,246,81,81,0,1,0
22,253,253,14,6,8,3,2
2,284,284,19,13,6,2,1
5,287,287,19,19,0,1,0
9,327,327,5,5,0,1,0
13,353,353,3,3,0,1,0
17,358,358,14,6,8,2,1
12,424,424,35,35,0,1,0
4,440,440,93,85,8,3,2
23,442,442,4,4,0,1,0
3,447,447,14,14,0,1,0
19,469,469,15,9,6,2,1
16,479,479,4,4,0,1,0
14,487,487,8,5,3,2,1

24,139,139,10,6,4,2,1
2,149,149,15,15,0,1,0
10,164,164,17,1,16,3,2
19,180,180,27,3,24,3,2
21,201,201,10,2,8,3,2
11,208,208,12,3,9,4,3
14,226,226,1,1,0,1,0
22,244,244,22,4,18,3,2
18,255,255,45,45,0,1,0
28,269,269,19,7,12,3,2
0,288,288,13,13,0,1,0
16,299,299,6,6,0,1,0
25,300,300,21,21,0,1,0
23,310,310,74,74,0,1,0
6,325,325,27,27,0,1,0
5,333,333,38,38,0,1,0
1,352,352,98,98,0,1,0
12,376,376,1,1,0,1,0
3,385,385,53,53,0,1,0
17,400,400,61,16,45,4,3
15,418,418,60,60,0,1,0
4,418,418,12,4,8,2,1
8,423,423,19,19,0,1,0
20,426,426,38,18,20,2,1
13,430,430,13,7,6,3,2
29,440,440,1,1,0,1,0
9,444,444,46,4,42,3,2
26,447,447,57,3,54,4,3
27,473,473,16,1,15,2,1
7,499,499,1,1,0,1,0

1,107,107,1,1,0,1,0
5,110,110,10,10,0,1,0
13,118,118,20,17,3,2,1
17,137,137,1,1,0,1,0
22,140,140,11,11,0,1,0
12,196,196,8,2,6,3,2
23,218,218,2,2,0,1,0
2,227,227,30,9,21,2,1
11,228,228,35,35,0,1,0
14,242,242,69,69,0,1,0
8,249,249,63,37,26,4,3
20,289,289,49,21,28,4,3
10,324,324,31,8,23,2,1
4,342,342,2,2,0,1,0
3,347,347,56,56,0,1,0
0,351,351,63,63,0,1,0
19,365,365,4,4,0,1,0
6,395,395,61,43,18,2,1
7,437,437,5,1,4,2,1
15,453,453,44,44,0,1,0
18,456,456,66,30,36,3,2
21,465,465,22,22,0,1,0
9,480,480,100,100,0,1,0
16,493,493,58,58,0,1,0

2,114,114,3,3,0,1,0
5,140,140,37,17,20,2,1
14,153,153,6,6,0,1,0
22,155,155,27,27,0,1,0
8,157,157,15,15,0,1,0
3,157,157,21,13,8,2,1
0,176,176,6,6,0,1,0
11,190,190,29,5,24,2,1
25,197,197,9,6,3,2,1
20,244,244,9,1,8,3,2
4,250,250,1,1,0,1,0
19,251,251,2,2,0,1,0
12,279,279,39,39,0,1,0
13,298,298,14,14,0,1,0
10,305,305,65,65,0,1,0
21,311,311,78,66,12,4,3
17,342,342,3,3,0,1,0
15,393,393,41,41,0,1,0
16,397,397,183,147,36,4,3
18,422,422,38,16,22,4,3
7,437,437,20,7,13,2,1
6,443,443,18,18,0,1,0
24,443,443,20,20,0,1,0
26,472,472,13,13,0,1,0
23,485,485,17,17,0,1,0
1,490,490,40,40,0,1,0
9,498,498,12,12,0,1,0

29,100,100,10,10,0,1,0
13,109,109,4,4,0,1,0
15,133,133,25,2,23,2,1
25,146,146,6,6,0,1,0
20,155,155,24,7,17,2,1
23,172,172,15,3,12,2,1
10,187,187,1,1,0,1,0
24,189,189,6,2,4,2,1
4,195,195,39,5,34,3,2
28,205,205,5,5,0,1,0
8,219,219,5,5,0,1,0
17,271,271,4,4,0,1,0
1,291,291,27,2,25,4,3
14,311,311,19,4,15,2,1
26,344,344,57,50,7,2,1
18,352,352,2,2,0,1,0
7,354,354,30,12,18,3,2
16,363,363,15,3,12,3,2
9,370,370,4,4,0,1,0
21,371,371,91,58,33,2,1
12,377,377,7,7,0,1,0
6,382,382,3,3,0,1,0
2,394,394,59,9,50,4,3
3,404,404,9,9,0,1,0
27,418,418,9,9,0,1,0
19,425,425,65,58,7,2,1
22,433,433,122,50,72,4,3
11,469,469,59,34,25,2,1
5,481,481,44,11,33,2,1
0,491,491,70,30,40,3,2

14,101,101,9,3,6,2,1
11,108,108,3,3,0,1,0
6,129,129,5,5,0,1,0
16,135,135,39,13,26,3,2
13,137,137,11,11,0,1,0
17,138,138,3,3,0,1,0
27,142,142,7,1,6,3,2
4,157,157,32,17,15,4,3
19,161,161,25,25,0,1,0
7,170,170,10,2,8,3,2
3,171,171,10,4,6,3,2
9,187,187,7,1,6,3,2
23,197,197,6,6,0,1,0
18,247,247,25,25,0,1,0
1,270,270,31,31,0,1,0
2,280,280,75,75,0,1,0
12,288,288,5,5,0,1,0
26,323,323,45,45,0,1,0
10,352,352,28,28,0,1,0
21,358,358,22,22,0,1,0
24,364,364,67,25,42,4,3
20,364,364,8,8,0,1,0
0,384,384,6,6,0,1,0
25,388,388,41,9,32,2,1
8,427,427,1,1,0,1,0
15,439,439,65,65,0,1,0
28,482,482,76,32,44,3,2
5,484,484,30,30,0,1,0
22,496,496,4,4,0,1,0

18,113,113,1,1,0,1,0
15,119,119,31,31,0,1,0
8,121,121,5,5,0,1,0
9,122,122,16,9,7,2,1
22,124,124,22,22,0,1,0
6,150,150,11,7,4,2,1
1,155,155,9,9,0,1,0
14,160,160,16,16,0,1,0
11,166,166,24,10,14,2,1
21,194,194,62,62,0,1,0
13,199,199,1,1,0,1,0
2,221,221,2,2,0,1,0
17,244,244,15,6,9,4,3
28,251,251,32,32,0,1,0
16,274,274,1,1,0,1,0
4,288,288,1,1,0,1,0
19,300,300,29,10,19,2,1
7,306,306,58,38,20,2,1
27,310,310,21,21,0,1,0
23,320,320,11,5,6,2,1
24,372,372,32,32,0,1,0
3,416,416,28,19,9,4,3
26,433,433,25,25,0,1,0
10,446,446,38,20,18,2,1
5,449,449,37,37,0,1,0
25,450,450,54,54,0,1,0
20,454,454,75,63,12,2,1
0,457,457,4,1,3,2,1
12,495,495,23,15,8,3,2

34,100,100,20,20,0,1,0
37,106,106,13,1,12,2,1
24,117,117,1,1,0,1,0
13,138,138,3,3,0,1,0
15,143,143,1,1,0,1,0
22,147,147,15,15,0,1,0
31,159,159,25,25,0,1,0
1,167,167,4,4,0,1,0
20,172,172,14,14,0,1,0
5,181,181,2,2,0,1,0
36,182,182,14,4,10,2,1
11,187,187,1,1,0,1,0
23,189,189,12,12,0,1,0
19,195,195,1,1,0,1,0
28,195,195,67,67,0,1,0
16,199,199,23,15,8,3,2
6,202,202,11,11,0,1,0
25,202,202,4,4,0,1,0
18,207,207,2,2,0,1,0
27,209,209,22,10,12,4,3
12,223,223,3,3,0,1,0
2,232,232,47,44,3,2,1
30,260,260,11,11,0,1,0
4,267,267,3,3,0,1,0
3,280,280,9,9,0,1,0
9,301,301,6,6,0,1,0
17,308,308,38,34,4,2,1
33,314,314,3,3,0,1,0
29,350,350,20,20,0,1,0
7,362,362,3,3,0,1,0
35,364,364,4,4,0,1,0
8,364,364,21,21,0,1,0
32,407,407,15,15,0,1,0
10,410,410,38,38,0,1,0
21,413,413,21,21,0,1,0
38,432,432,41,23,18,3,2
14,450,450,62,40,22,2,1
26,469,469,33,2,31,4,3
0,482,482,12,12,0,1,0

12,127,127,39,21,18,3,2
17,161,161,1,1,0,1,0
3,164,164,14,14,0,1,0
19,174,174,18,2,16,3,2
11,214,214,7,7,0,1,0
15,218,218,15,15,0,1,0
22,247,247,26,20,6,3,2
5,253,253,12,12,0,1,0
20,254,254,45,10,35,2,1
6,259,259,10,10,0,1,0
14,267,267,60,60,0,1,0
1,277,277,13,1,12,3,2
0,281,281,12,12,0,1,0
27,288,288,63,7,56,4,3
9,298,298,1,1,0,1,0
18,305,305,25,25,0,1,0
23,311,311,5,1,4,2,1
2,312,312,11,11,0,1,0
10,321,321,34,34,0,1,0
21,349,349,58,58,0,1,0
30,396,396,69,38,31,2,1
7,418,418,11,11,0,1,0
31,422,422,90,54,36,2,1
29,422,422,34,34,0,1,0
16,429,429,4,4,0,1,0
13,448,448,1,1,0,1,0
28,449,449,2,2,0,1,0
32,452,452,7,2,5,2,1
26,456,456,4,4,0,1,0
4,462,462,1,1,0,1,0
8,478,478,16,16,0,1,0
24,479,479,58,58,0,1,0
25,495,495,8,2,6,2,1

1,152,152,12,12,0,1,0
6,174,174,16,16,0,1,0
19,179,179,35,35,0,1,0
16,191,191,30,4,26,3,2
8,202,202,1,1,0,1,0
24,206,206,5,5,0,1,0
5,232,232,12,12,0,1,0
14,257,257,28,7,21,4,3
2,258,258,53,16,37,4,3
12,265,265,9,9,0,1,0
7,287,287,19,12,7,2,1
0,292,292,17,17,0,1,0
18,294,294,31,7,24,3,2
25,311,311,12,7,5,2,1
4,354,354,1,1,0,1,0
11,359,359,160,160,0,1,0
21,389,389,97,16,81,4,3
23,409,409,3,3,0,1,0
3,413,413,20,9,11,2,1
15,430,430,3,3,0,1,0
10,444,444,57,57,0,1,0
22,461,461,113,38,75,4,3
17,465,465,43,43,0,1,0
13,482,482,15,15,0,1,0
9,486,486,41,17,24,4,3
20,494,494,29,3,26,3,2

4,100,100,15,11,4,2,1
0,111,111,21,21,0,1,0
13,120,120,8,8,0,1,0
1,135,135,22,7,15,4,3
14,139,139,40,40,0,1,0
12,165,165,4,4,0,1,0
9,208,208,1,1,0,1,0
11,216,216,28,28,0,1,0
2,230,230,3,3,0,1,0
10,267,267,25,25,0,1,0
6,270,270,31,23,8,3,2
3,274,274,63,63,0,1,0
16,286,286,19,9,10,3,2
23,290,290,112,67,45,4,3
17,292,292,50,30,20,3,2
15,299,299,1,1,0,1,0
18,305,305,20,20,0,1,0
20,315,315,12,12,0,1,0
21,331,331,1,1,0,1,0
24,365,365,8,2,6,3,2
19,398,398,60,2,58,3,2
5,450,450,26,26,0,1,0
8,463,463,18,18,0,1,0
22,493,493,18,18,0,1,0
7,494,494,57,57,0,1,0

0,101,101,1,1,0,1,0
18,102,102,6,6,0,1,0
5,104,104,4,1,3,2,1
3,113,113,21,6,15,4,3
24,119,119,1,1,0,1,0
25,214,214,6,6,0,1,0
10,233,233,6,6,0,1,0
22,238,238,2,2,0,1,0
27,255,255,109,47,62,4,3
19,259,259,27,27,0,1,0
12,269,269,1,1,0,1,0
17,275,275,25,25,0,1,0
8,276,276,56,23,33,4,3
6,282,282,47,26,21,4,3
20,321,321,22,22,0,1,0
13,329,329,30,9,21,4,3
23,336,336,20,20,0,1,0
30,376,376,13,13,0,1,0
26,386,386,31,31,0,1,0
14,406,406,57,30,27,4,3
15,415,415,33,7,26,3,2
21,416,416,70,32,38,4,3
28,423,423,6,6,0,1,0
7,430,430,10,10,0,1,0
4,430,430,1,1,0,1,0
31,432,432,43,5,38,4,3
16,433,433,9,9,0,1,0
1,436,436,6,3,3,2,1
2,446,446,3,3,0,1,0
11,461,461,4,4,0,1,0
29,469,469,101,74,27,4,3
9,499,499,67,67,0,1,0

28,106,106,4,4,0,1,0
4,106,106,1,1,0,1,0
17,108,108,18,3,15,4,3
22,159,159,6,3,3,2,1
7,166,166,51,34,17,2,1
8,168,168,3,3,0,1,0
18,191,191,20,6,14,3,2
27,194,194,11,11,0,1,0
23,197,197,22,22,0,1,0
10,202,202,11,11,0,1,0
1,211,211,18,10,8,3,2
12,230,230,1,1,0,1,0
25,250,250,6,6,0,1,0
16,265,265,98,83,15,4,3
15,300,300,89,5,84,3,2
6,309,309,7,1,6,2,1
21,317,317,13,13,0,1,0
2,327,327,11,2,9,4,3
3,335,335,23,23,0,1,0
24,341,341,20,20,0,1,0
20,345,345,25,25,0,1,0
5,364,364,21,11,10,3,2
13,369,369,52,3,49,4,3
26,375,375,60,2,58,4,3
14,419,419,5,5,0,1,0
11,420,420,15,9,6,3,2
9,429,429,5,5,0,1,0
19,435,435,40,40,0,1,0
0,444,444,63,48,15,2,1

23,110,110,6,6,0,1,0
13,116,116,6,1,5,2,1
9,117,117,1,1,0,1,0
15,117,117,3,3,0,1,0
24,120,120,4,4,0,1,0
3,147,147,59,32,27,4,3
10,149,149,11,11,0,1,0
21,192,192,9,9,0,1,0
20,197,197,15,15,0,1,0
14,207,207,5,5,0,1,0
16,211,211,96,80,16,2,1
7,221,221,4,4,0,1,0
2,238,238,8,8,0,1,0
18,244,244,6,3,3,2,1
5,252,252,4,4,0,1,0
11,257,257,82,82,0,1,0
12,264,264,38,38,0,1,0
6,301,301,15,8,7,2,1
25,354,354,19,19,0,1,0
8,358,358,55,25,30,4,3
4,372,372,2,2,0,1,0
17,380,380,100,58,42,4,3
22,394,394,58,58,0,1,0
1,461,461,14,3,11,3,2
19,464,464,36,36,0,1,0
0,471,471,22,22,0,1,0

6,109,109,9,9,0,1,0
14,113,113,9,1,8,2,1
11,130,130,8,8,0,1,0
20,152,152,5,5,0,1,0
0,162,162,4,4,0,1,0
12,163,163,14,8,6,3,2
24,178,178,5,5,0,1,0
19,209,209,18,3,15,2,1
10,216,216,4,4,0,1,0
15,249,249,31,31,0,1,0
21,279,279,124,106,18,2,1
22,279,279,1,1,0,1,0
18,305,305,33,30,3,2,1
16,317,317,55,25,30,3,2
7,325,325,43,43,0,1,0
17,350,350,26,26,0,1,0
4,361,361,37,22,15,4,3
13,363,363,28,16,12,4,3
3,369,369,61,61,0,1,0
2,400,400,23,3,20,3,2
8,401,401,139,14,125,4,3
1,436,436,38,20,18,3,2
5,443,443,77,59,18,2,1
9,451,451,23,23,0,1,0
23,475,475,3,3,0,1,0

20,128,128,52,10,42,3,2
11,139,139,2,2,0,1,0
2,142,142,8,8,0,1,0
10,151,151,22,22,0,1,0
22,170,170,7,7,0,1,0
6,183,183,48,22,26,2,1
14,196,196,6,3,3,2,1
21,231,231,8,3,5,2,1
4,263,263,76,76,0,1,0
1,292,292,11,11,0,1,0
16,328,328,35,35,0,1,0
15,342,342,56,56,0,1,0
12,346,346,21,21,0,1,0
23,376,376,3,3,0,1,0
19,382,382,31,31,0,1,0
3,382,382,22,6,16,2,1
0,383,383,40,40,0,1,0
17,405,405,16,16,0,1,0
9,408,408,22,16,6,3,2
7,414,414,21,21,0,1,0
13,433,433,122,122,0,1,0
18,438,438,29,12,17,2,1
8,474,474,96,9,87,4,3
5,477,477,20,20,0,1,0

12,113,113,2,2,0,1,0
14,153,153,12,12,0,1,0
21,178,178,3,3,0,1,0
15,192,192,14,2,12,4,3
16,193,193,55,29,26,2,1
1,196,196,1,1,0,1,0
8,197,197,82,82,0,1,0
6,207,207,21,6,15,2,1
22,224,224,5,5,0,1,0
18,261,261,25,14,11,2,1
23,282,282,26,8,18,2,1
10,290,290,5,1,4,2,1
19,315,315,30,30,0,1,0
0,321,321,9,9,0,1,0
13,322,322,74,32,42,4,3
3,325,325,51,51,0,1,0
9,326,326,10,10,0,1,0
4,339,339,30,30,0,1,0
20,373,373,40,16,24,4,3
2,447,447,198,166,32,3,2
7,463,463,5,5,0,1,0
11,466,466,12,12,0,1,0
5,482,482,2,2,0,1,0
17,492,492,93,80,13,2,1

13,103,103,1,1,0,1,0
12,118,118,7,3,4,2,1
16,126,126,43,7,36,2,1
18,129,129,18,12,6,3,2
3,182,182,3,3,0,1,0
2,188,188,21,1,20,2,1
4,192,192,4,4,0,1,0
1,204,204,23,23,0,1,0
17,209,209,27,5,22,3,2
21,210,210,12,12,0,1,0
23,213,213,14,1,13,2,1
9,277,277,98,5,93,4,3
11,291,291,19,19,0,1,0
15,300,300,6,6,0,1,0
6,304,304,46,26,20,2,1
14,306,306,32,32,0,1,0
0,317,317,19,3,16,2,1
7,324,324,30,14,16,2,1
5,417,417,44,9,35,4,3
8,418,418,86,86,0,1,0
10,420,420,3,3,0,1,0
19,427,427,86,58,28,3,2
22,432,432,65,24,41,2,1
24,434,434,3,3,0,1,0
20,456,456,21,7,14,3,2

18,103,103,5,5,0,1,0
13,105,105,17,17,0,1,0
1,128,128,9,9,0,1,0
22,178,178,28,4,24,3,2
24,200,200,19,3,16,3,2
16,218,218,30,30,0,1,0
7,247,247,6,6,0,1,0
6,261,261,69,21,48,2,1
27,285,285,1,1,0,1,0
20,291,291,30,15,15,4,3
4,299,299,1,1,0,1,0
19,306,306,2,2,0,1,0
17,310,310,8,5,3,2,1
2,312,312,21,21,0,1,0
0,345,345,61,61,0,1,0
8,390,390,47,47,0,1,0
9,392,392,9,6,3,2,1
5,412,412,8,8,0,1,0
10,432,432,12,12,0,1,0
23,434,434,46,10,36,4,3
3,434,434,5,5,0,1,0
21,442,442,183,117,66,3,2
25,453,453,29,17,12,3,2
14,460,460,120,109,11,2,1
11,460,460,22,22,0,1,0
26,462,462,67,67,0,1,0
12,468,468,10,7,3,2,1
15,490,490,9,3,6,2,1

16,132,132,22,1,21,2,1
0,141,141,68,8,60,3,2
8,152,152,22,7,15,4,3
17,175,175,64,45,19,2,1
9,183,183,13,7,6,2,1
6,214,214,61,16,45,4,3
4,265,265,1,1,0,1,0
14,280,280,17,5,12,3,2
15,295,295,16,8,8,3,2
1,298,298,44,44,0,1,0
10,300,300,35,35,0,1,0
3,304,304,1,1,0,1,0
11,311,311,10,2,8,3,2
2,320,320,91,91,0,1,0
19,324,324,17,17,0,1,0
13,412,412,30,10,20,3,2
18,434,434,16,16,0,1,0
12,449,449,48,48,0,1,0
5,466,466,44,2,42,3,2
7,498,498,18,18,0,1,0

26,139,139,8,2,6,3,2
20,140,140,10,10,0,1,0
1,151,151,6,3,3,2,1
7,155,155,15,15,0,1,0
16,170,170,6,6,0,1,0
27,188,188,1,1,0,1,0
19,197,197,16,16,0,1,0
0,200,200,1,1,0,1,0
8,206,206,8,8,0,1,0
10,206,206,24,18,6,3,2
6,232,232,56,45,11,2,1
4,252,252,31,7,24,4,3
2,253,253,10,10,0,1,0
11,266,266,24,6,18,2,1
14,278,278,40,28,12,2,1
9,296,296,31,5,26,3,2
23,327,327,64,17,47,3,2
12,328,328,5,5,0,1,0
25,332,332,37,17,20,2,1
5,344,344,4,4,0,1,0
17,356,356,4,4,0,1,0
13,392,392,49,49,0,1,0
3,394,394,43,43,0,1,0
18,404,404,21,5,16,2,1
24,453,453,31,31,0,1,0
21,486,486,98,80,18,3,2
15,494,494,12,12,0,1,0
22,497,497,202,202,0,1,0

18,100,100,3,3,0,1,0
7,125,125,1,1,0,1,0
12,127,127,11,11,0,1,0
13,135,135,34,16,18,3,2
1,153,153,32,25,7,2,1
4,194,194,41,9,32,2,1
2,207,207,50,50,0,1,0
6,207,207,32,32,0,1,0
21,218,218,2,2,0,1,0
3,226,226,12,7,5,2,1
19,255,255,11,11,0,1,0
20,274,274,9,1,8,3,2
8,302,302,58,48,10,3,2
16,312,312,54,24,30,3,2
11,316,316,112,61,51,4,3
14,333,333,75,48,27,4,3
10,375,375,18,6,12,4,3
17,400,400,19,19,0,1,0
15,413,413,8,8,0,1,0
0,446,446,21,21,0,1,0
22,451,451,2,2,0,1,0
9,478,478,86,80,6,2,1
5,494,494,2,2,0,1,0

0,106,106,31,19,12,2,1
8,135,135,6,6,0,1,0
17,140,140,1,1,0,1,0
4,172,172,18,1,17,4,3
7,187,187,1,1,0,1,0
13,193,193,7,1,6,2,1
1,226,226,2,2,0,1,0
15,228,228,26,2,24,2,1
16,268,268,4,4,0,1,0
21,283,283,12,12,0,1,0
12,293,293,40,40,0,1,0
5,303,303,49,49,0,1,0
11,316,316,16,4,12,3,2
6,345,345,128,28,100,3,2
10,370,370,34,34,0,1,0
20,373,373,112,112,0,1,0
3,408,408,70,14,56,3,2
2,430,430,63,63,0,1,0
18,440,440,32,32,0,1,0
19,462,462,166,166,0,1,0
14,472,472,6,6,0,1,0
9,480,480,43,11,32,3,2

16,111,111,7,7,0,1,0
23,169,169,17,14,3,2,1
29,170,170,20,20,0,1,0
1,192,192,19,19,0,1,0
4,209,209,12,3,9,4,3
18,217,217,37,37,0,1,0
17,224,224,62,37,25,2,1
19,239,239,2,2,0,1,0
14,264,264,11,5,6,2,1
8,265,265,1,1,0,1,0
6,275,275,1,1,0,1,0
12,293,293,17,5,12,2,1
21,298,298,6,6,0,1,0
3,301,301,48,48,0,1,0
25,303,303,12,3,9,4,3
5,325,325,17,17,0,1,0
10,325,325,3,3,0,1,0
20,350,350,17,2,15,2,1
26,372,372,62,17,45,4,3
9,378,378,14,14,0,1,0
11,391,391,106,106,0,1,0
27,394,394,81,81,0,1,0
15,426,426,5,2,3,2,1
22,436,436,13,10,3,2,1
0,450,450,100,100,0,1,0
7,453,453,49,49,0,1,0
13,457,457,49,49,0,1,0
24,488,488,30,13,17,2,1
28,489,489,39,16,23,2,1
2,494,494,1,1,0,1,0

25,100,100,2,2,0,1,0
6,121,121,15,15,0,1,0
10,126,126,2,2,0,1,0
5,170,170,1,1,0,1,0
21,170,170,1,1,0,1,0
24,215,215,43,14,29,2,1
3,223,223,5,5,0,1,0
1,237,237,33,12,21,4,3
19,251,251,14,14,0,1,0
12,255,255,3,3,0,1,0
27,279,279,3,3,0,1,0
11,279,279,21,7,14,3,2
8,281,281,24,3,21,2,1
4,282,282,31,13,18,4,3
23,292,292,17,17,0,1,0
22,293,293,5,5,0,1,0
14,302,302,50,50,0,1,0
9,319,319,15,5,10,2,1
17,327,327,20,20,0,1,0
7,357,357,45,33,12,4,3
26,361,361,17,4,13,2,1
20,395,395,103,103,0,1,0
15,416,416,91,91,0,1,0
18,418,418,95,95,0,1,0
0,443,443,98,80,18,2,1
2,470,470,61,61,0,1,0
16,482,482,71,35,36,4,3
13,487,487,11,11,0,1,0

4,109,109,12,2,10,2,1
9,132,132,30,30,0,1,0
8,137,137,24,24,0,1,0
3,143,143,7,3,4,2,1
2,190,190,56,44,12,3,2
10,213,213,49,49,0,1,0
1,214,214,11,2,9,2,1
14,226,226,41,41,0,1,0
11,230,230,16,4,12,3,2
21,235,235,12,4,8,3,2
20,237,237,17,11,6,3,2
18,293,293,93,30,63,4,3
0,301,301,7,1,6,2,1
6,341,341,11,11,0,1,0
22,366,366,22,13,9,4,3
17,387,387,13,13,0,1,0
15,400,400,16,10,6,3,2
7,414,414,53,4,49,4,3
19,428,428,23,17,6,2,1
5,454,454,95,95,0,1,0
13,472,472,32,32,0,1,0
12,473,473,26,8,18,3,2
16,478,478,44,35,9,4,3

16,102,102,29,15,14,3,2
13,111,111,6,6,0,1,0
23,138,138,13,13,0,1,0
12,139,139,36,36,0,1,0
17,150,150,3,3,0,1,0
24,155,155,24,24,0,1,0
18,173,173,5,5,0,1,0
2,228,228,32,17,15,4,3
21,238,238,23,14,9,4,3
0,242,242,1,1,0,1,0
3,242,242,13,13,0,1,0
8,260,260,91,31,60,4,3
6,268,268,1,1,0,1,0
27,282,282,27,27,0,1,0
19,284,284,16,16,0,1,0
4,289,289,3,3,0,1,0
5,304,304,20,8,12,4,3
10,305,305,2,2,0,1,0
9,325,325,71,67,4,2,1
20,329,329,44,44,0,1,0
25,331,331,7,1,6,3,2
11,347,347,6,6,0,1,0
22,370,370,99,17,82,3,2
1,375,375,10,2,8,2,1
15,396,396,17,17,0,1,0
7,415,415,9,9,0,1,0
26,431,431,19,4,15,4,3
14,477,477,33,3,30,4,3

6,105,105,8,2,6,2,1
19,109,109,19,16,3,2,1
16,138,138,24,24,0,1,0
21,149,149,5,5,0,1,0
13,151,151,8,8,0,1,0
17,156,156,25,15,10,2,1
12,205,205,1,1,0,1,0
7,270,270,37,37,0,1,0
9,304,304,45,23,22,2,1
2,306,306,2,2,0,1,0
10,319,319,102,102,0,1,0
0,322,322,15,15,0,1,0
4,337,337,2,2,0,1,0
8,353,353,25,11,14,3,2
3,373,373,65,65,0,1,0
20,380,380,38,23,15,2,1
15,387,387,75,54,21,4,3
1,406,406,53,27,26,3,2
5,412,412,76,66,10,2,1
23,413,413,27,27,0,1,0
22,446,446,43,43,0,1,0
11,465,465,43,43,0,1,0
14,470,470,57,57,0,1,0
18,487,487,30,16,14,2,1

3,123,123,6,6,0,1,0
16,136,136,15,1,14,3,2
14,137,137,11,5,6,2,1
21,183,183,5,5,0,1,0
4,218,218,20,20,0,1,0
6,239,239,20,16,4,2,1
11,242,242,47,47,0,1,0
7,246,246,100,53,47,2,1
8,249,249,27,27,0,1,0
5,287,287,11,11,0,1,0
19,287,287,8,1,7,2,1
17,308,308,83,46,37,3,2
9,310,310,66,18,48,4,3
0,335,335,1,1,0,1,0
2,346,346,17,17,0,1,0
22,349,349,2,2,0,1,0
18,349,349,27,11,16,4,3
12,427,427,11,11,0,1,0
23,433,433,67,13,54,3,2
10,469,469,96,96,0,1,0
15,479,479,118,88,30,2,1
13,480,480,37,37,0,1,0
1,492,492,27,27,0,1,0
20,496,496,17,17,0,1,0

20,107,107,26,23,3,2,1
2,110,110,30,30,0,1,0
10,110,110,26,2,24,3,2
7,133,133,31,10,21,4,3
11,146,146,19,4,15,2,1
13,162,162,3,3,0,1,0
9,168,168,15,15,0,1,0
8,169,169,3,3,0,1,0
4,239,239,17,14,3,2,1
15,269,269,21,21,0,1,0
6,298,298,1,1,0,1,0
1,306,306,4,4,0,1,0
21,311,311,39,18,21,4,3
17,317,317,38,8,30,4,3
18,318,318,6,6,0,1,0
22,327,327,54,19,35,2,1
5,334,334,100,10,90,3,2
16,346,346,7,7,0,1,0
14,346,346,47,47,0,1,0
3,349,349,18,18,0,1,0
19,431,431,6,3,3,2,1
0,477,477,119,92,27,4,3
12,484,484,11,1,10,2,1

17,106,106,18,12,6,2,1
2,114,114,3,3,0,1,0
4,118,118,3,3,0,1,0
26,118,118,24,10,14,3,2
15,147,147,17,9,8,3,2
24,160,160,33,33,0,1,0
19,181,181,11,11,0,1,0
12,188,188,38,38,0,1,0
9,196,196,13,13,0,1,0
13,198,198,21,21,0,1,0
18,204,204,6,6,0,1,0
22,208,208,43,1,42,3,2
0,216,216,25,5,20,3,2
10,251,251,10,10,0,1,0
28,295,295,45,45,0,1,0
3,302,302,26,17,9,2,1
1,316,316,7,7,0,1,0
6,321,321,70,30,40,3,2
14,334,334,26,26,0,1,0
5,334,334,22,22,0,1,0
25,336,336,13,13,0,1,0
7,353,353,21,21,0,1,0
20,389,389,41,30,11,2,1
23,393,393,38,38,0,1,0
8,398,398,26,26,0,1,0
27,407,407,5,5,0,1,0
21,409,409,16,8,8,3,2
16,450,450,5,2,3,2,1
11,499,499,5,5,0,1,0

8,118,118,3,3,0,1,0
24,122,122,33,33,0,1,0
11,124,124,13,4,9,4,3
12,136,136,4,4,0,1,0
20,139,139,17,17,0,1,0
3,156,156,12,12,0,1,0
9,158,158,6,6,0,1,0
4,177,177,13,9,4,2,1
10,186,186,55,3,52,4,3
6,193,193,38,12,26,2,1
22,195,195,63,63,0,1,0
26,199,199,4,4,0,1,0
16,204,204,1,1,0,1,0
21,247,247,5,5,0,1,0
17,280,280,1,1,0,1,0
2,283,283,22,22,0,1,0
18,288,288,13,3,10,3,2
14,289,289,47,47,0,1,0
23,298,298,47,47,0,1,0
13,330,330,54,54,0,1,0
7,355,355,1,1,0,1,0
15,405,405,7,7,0,1,0
1,416,416,48,22,26,3,2
25,438,438,6,6,0,1,0
0,460,460,46,46,0,1,0
5,460,460,1,1,0,1,0
19,497,497,81,18,63,4,3

22,102,102,8,2,6,3,2
14,120,120,1,1,0,1,0
13,144,144,21,7,14,3,2
4,151,151,20,5,15,4,3
19,155,155,26,8,18,2,1
27,184,184,3,3,0,1,0
18,206,206,8,8,0,1,0
6,208,208,14,5,9,4,3
10,221,221,57,57,0,1,0
1,249,249,8,8,0,1,0
16,254,254,5,5,0,1,0
23,275,275,8,8,0,1,0
20,301,301,112,112,0,1,0
3,322,322,18,18,0,1,0
21,323,323,3,3,0,1,0
26,343,343,5,1,4,2,1
28,347,347,41,29,12,2,1
15,350,350,1,1,0,1,0
9,359,359,64,20,44,4,3
11,366,366,32,20,12,2,1
7,372,372,24,24,0,1,0
5,405,405,1,1,0,1,0
24,410,410,68,68,0,1,0
8,439,439,5,1,4,2,1
12,453,453,12,12,0,1,0
2,459,459,61,56,5,2,1
0,469,469,44,40,4,2,1
25,491,491,28,14,14,3,2
17,498,498,116,77,39,2,1

2,103,103,14,14,0,1,0
19,129,129,3,3,0,1,0
4,220,220,30,30,0,1,0
16,242,242,24,4,20,2,1
8,253,253,33,33,0,1,0
6,255,255,15,1,14,3,2
13,269,269,24,20,4,2,1
0,283,283,13,9,4,2,1
22,293,293,2,2,0,1,0
17,314,314,11,4,7,2,1
5,316,316,55,28,27,2,1
1,333,333,12,12,0,1,0
20,347,347,5,1,4,2,1
11,371,371,81,60,21,4,3
23,384,384,9,5,4,2,1
18,387,387,5,5,0,1,0
14,395,395,70,15,55,4,3
21,406,406,13,7,6,2,1
15,410,410,47,47,0,1,0
12,436,436,206,206,0,1,0
10,461,461,87,76,11,2,1
3,476,476,5,5,0,1,0
7,489,489,58,19,39,4,3
9,498,498,132,9,123,4,3

15,107,107,14,8,6,2,1
16,147,147,13,5,8,3,2
21,181,181,1,1,0,1,0
19,184,184,26,26,0,1,0
13,199,199,13,13,0,1,0
4,203,203,11,11,0,1,0
12,209,209,2,2,0,1,0
20,234,234,53,21,32,3,2
1,248,248,2,2,0,1,0
7,251,251,16,2,14,4,3
10,277,277,103,13,90,4,3
0,318,318,19,19,0,1,0
8,321,321,14,14,0,1,0
14,342,342,9,2,7,2,1
22,357,357,79,39,40,4,3
6,359,359,63,33,30,3,2
18,378,378,3,3,0,1,0
11,392,392,14,14,0,1,0
17,423,423,1,1,0,1,0
24,424,424,124,108,16,3,2
2,442,442,55,55,0,1,0
23,443,443,52,52,0,1,0
5,477,477,51,17,34,3,2
3,495,495,122,20,102,4,3
9,495,495,6,6,0,1,0

23,101,101,15,7,8,2,1
1,103,103,11,11,0,1,0
19,121,121,12,12,0,1,0
14,129,129,8,8,0,1,0
12,136,136,20,20,0,1,0
16,138,138,8,8,0,1,0
3,151,151,3,3,0,1,0
26,161,161,2,2,0,1,0
22,181,181,41,9,32,2,1
18,181,181,13,1,12,4,3
10,198,198,12,12,0,1,0
15,223,223,50,50,0,1,0
2,241,241,14,14,0,1,0
25,251,251,37,37,0,1,0
7,254,254,2,2,0,1,0
8,274,274,49,4,45,4,3
5,291,291,110,97,13,3,2
21,298,298,14,11,3,2,1
13,329,329,23,9,14,2,1
24,335,335,67,32,35,2,1
6,345,345,3,3,0,1,0
4,414,414,66,39,27,2,1
9,431,431,20,5,15,4,3
11,433,433,16,1,15,4,3
17,473,473,7,7,0,1,0
20,484,484,11,3,8,2,1
0,492,492,12,12,0,1,0

18,138,138,2,2,0,1,0
13,143,143,7,7,0,1,0
16,145,145,4,4,0,1,0
21,160,160,14,5,9,4,3
3,165,165,3,3,0,1,0
1,181,181,33,17,16,3,2
17,206,206,36,8,28,4,3
12,228,228,6,6,0,1,0
14,262,262,1,1,0,1,0
11,274,274,1,1,0,1,0
29,289,289,22,19,3,2,1
15,298,298,34,34,0,1,0
24,306,306,59,5,54,4,3
6,319,319,49,49,0,1,0
4,326,326,9,9,0,1,0
27,335,335,18,18,0,1,0
20,347,347,13,5,8,2,1
9,349,349,19,19,0,1,0
23,359,359,3,3,0,1,0
28,360,360,22,17,5,2,1
19,363,363,17,17,0,1,0
26,391,391,33,33,0,1,0
10,401,401,19,19,0,1,0
8,409,409,4,4,0,1,0
7,412,412,29,4,25,2,1
22,433,433,104,16,88,3,2
0,436,436,61,61,0,1,0
2,445,445,136,108,28,3,2
25,489,489,118,49,69,4,3
5,494,494,35,19,16,3,2

24,135,135,19,19,0,1,0
16,140,140,9,4,5,2,1
20,141,141,15,3,12,4,3
7,219,219,27,27,0,1,0
23,223,223,9,1,8,3,2
0,230,230,114,75,39,4,3
11,250,250,2,2,0,1,0
5,290,290,33,33,0,1,0
4,298,298,11,11,0,1,0
8,306,306,55,29,26,2,1
12,328,328,3,3,0,1,0
19,350,350,44,25,19,4,3
6,356,356,14,14,0,1,0
3,357,357,19,19,0,1,0
18,370,370,10,3,7,3,2
10,370,370,21,21,0,1,0
14,374,374,82,82,0,1,0
21,375,375,19,3,16,2,1
17,441,441,48,28,20,3,2
9,444,444,8,2,6,2,1
15,452,452,10,10,0,1,0
13,459,459,92,71,21,2,1
1,463,463,74,32,42,4,3
22,482,482,101,17,84,3,2
2,498,498,8,8,0,1,0

8,130,130,11,5,6,3,2
6,130,130,27,11,16,2,1
7,138,138,4,4,0,1,0
15,151,151,3,3,0,1,0
22,154,154,6,6,0,1,0
18,166,166,34,13,21,4,3
12,173,173,8,8,0,1,0
16,186,186,46,46,0,1,0
2,187,187,23,7,16,3,2
0,207,207,17,17,0,1,0
24,208,208,27,27,0,1,0
14,243,243,9,3,6,3,2
13,296,296,45,15,30,3,2
25,301,301,2,2,0,1,0
11,314,314,19,19,0,1,0
20,317,317,59,59,0,1,0
9,329,329,7,7,0,1,0
1,339,339,1,1,0,1,0
17,344,344,32,17,15,2,1
28,388,388,35,35,0,1,0
29,398,398,35,13,22,2,1
19,405,405,42,20,22,2,1
10,411,411,12,12,0,1,0
21,414,414,49,49,0,1,0
26,428,428,58,58,0,1,0
3,474,474,5,5,0,1,0
23,484,484,24,24,0,1,0
5,485,485,50,3,47,2,1
27,485,485,34,1,33,4,3
4,499,499,23,23,0,1,0

4,110,110,26,26,0,1,0
10,117,117,2,2,0,1,0
18,117,117,14,3,11,4,3
12,128,128,5,1,4,2,1
16,134,134,23,23,0,1,0
1,136,136,10,4,6,2,1
21,156,156,16,16,0,1,0
8,175,175,1,1,0,1,0
2,209,209,5,5,0,1,0
23,220,220,19,19,0,1,0
9,223,223,35,3,32,3,2
0,308,308,12,12,0,1,0
13,331,331,5,5,0,1,0
22,342,342,3,3,0,1,0
3,360,360,28,5,23,2,1
11,366,366,51,51,0,1,0
7,374,374,19,19,0,1,0
14,379,379,88,88,0,1,0
17,401,401,90,90,0,1,0
20,407,407,24,24,0,1,0
5,409,409,59,59,0,1,0
19,431,431,28,13,15,2,1
6,462,462,223,209,14,2,1
15,484,484,33,33,0,1,0

25,105,105,6,6,0,1,0
12,134,134,28,4,24,2,1
33,142,142,22,22,0,1,0
13,146,146,15,15,0,1,0
0,151,151,7,2,5,2,1
21,154,154,57,47,10,2,1
23,159,159,27,27,0,1,0
16,184,184,1,1,0,1,0
4,186,186,18,4,14,2,1
15,198,198,1,1,0,1,0
10,217,217,6,6,0,1,0
2,249,249,1,1,0,1,0
17,269,269,2,2,0,1,0
22,278,278,79,79,0,1,0
28,280,280,1,1,0,1,0
19,307,307,6,6,0,1,0
18,313,313,67,67,0,1,0
30,315,315,11,8,3,2,1
14,321,321,18,18,0,1,0
11,330,330,21,6,15,4,3
32,331,331,14,5,9,4,3
7,340,340,49,49,0,1,0
6,344,344,3,3,0,1,0
27,345,345,21,6,15,2,1
26,351,351,13,7,6,3,2
5,356,356,21,21,0,1,0
8,394,394,9,9,0,1,0
20,405,405,17,17,0,1,0
29,408,408,28,1,27,4,3
24,420,420,8,8,0,1,0
3,441,441,13,4,9,2,1
31,444,444,11,11,0,1,0
1,454,454,41,34,7,2,1
9,473,473,22,22,0,1,0

26,100,100,13,1,12,2,1
13,100,100,7,7,0,1,0
0,106,106,8,2,6,2,1
25,107,107,9,9,0,1,0
19,108,108,8,8,0,1,0
15,123,123,4,4,0,1,0
21,160,160,23,23,0,1,0
28,161,161,13,4,9,4,3
27,161,161,67,67,0,1,0
4,179,179,6,3,3,2,1
18,209,209,10,10,0,1,0
11,216,216,32,5,27,4,3
7,241,241,29,1,28,3,2
16,250,250,35,3,32,4,3
24,282,282,1,1,0,1,0
3,285,285,52,7,45,2,1
12,346,346,12,12,0,1,0
17,357,357,12,12,0,1,0
22,361,361,21,21,0,1,0
9,372,372,38,38,0,1,0
1,400,400,150,114,36,2,1
14,406,406,2,2,0,1,0
2,427,427,10,10,0,1,0
6,428,428,8,8,0,1,0
23,478,478,38,38,0,1,0
5,490,490,8,8,0,1,0
20,494,494,25,25,0,1,0
8,495,495,10,7,3,2,1
10,497,497,21,3,18,3,2

5,101,101,6,3,3,2,1
19,103,103,5,5,0,1,0
6,138,138,8,4,4,2,1
8,143,143,21,21,0,1,0
18,193,193,50,35,15,2,1
4,204,204,67,10,57,4,3
17,218,218,18,18,0,1,0
9,230,230,11,2,9,2,1
3,268,268,1,1,0,1,0
13,270,270,30,30,0,1,0
20,291,291,33,33,0,1,0
16,320,320,20,15,5,2,1
22,367,367,30,30,0,1,0
12,368,368,27,9,18,2,1
0,378,378,79,79,0,1,0
10,397,397,11,2,9,4,3
1,453,453,177,138,39,3,2
11,454,454,71,71,0,1,0
7,461,461,18,18,0,1,0
2,461,461,8,3,5,2,1
14,481,481,51,29,22,4,3
15,486,486,69,31,38,2,1
21,487,487,31,19,12,3,2

28,102,102,9,3,6,2,1
20,134,134,10,4,6,2,1
11,140,140,18,7,11,4,3
13,165,165,6,6,0,1,0
17,172,172,6,6,0,1,0
18,183,183,37,25,12,2,1
7,188,188,18,18,0,1,0
22,194,194,26,5,21,2,1
25,202,202,2,2,0,1,0
21,227,227,28,28,0,1,0
2,239,239,10,10,0,1,0
8,252,252,8,3,5,2,1
19,267,267,14,8,6,2,1
24,269,269,28,28,0,1,0
0,270,270,21,21,0,1,0
14,274,274,35,35,0,1,0
16,283,283,3,3,0,1,0
10,306,306,45,45,0,1,0
4,314,314,2,2,0,1,0
3,326,326,42,42,0,1,0
5,345,345,48,48,0,1,0
12,351,351,1,1,0,1,0
9,388,388,8,8,0,1,0
27,428,428,22,9,13,2,1
15,449,449,83,83,0,1,0
29,452,452,110,80,30,4,3
6,458,458,41,5,36,4,3
26,460,460,39,39,0,1,0
1,485,485,15,15,0,1,0
23,493,493,62,17,45,4,3

3,101,101,1,1,0,1,0
4,103,103,4,4,0,1,0
1,113,113,52,15,37,3,2
22,114,114,4,4,0,1,0
14,122,122,19,19,0,1,0
6,137,137,1,1,0,1,0
0,141,141,17,17,0,1,0
9,184,184,2,2,0,1,0
16,201,201,19,14,5,2,1
11,215,215,7,7,0,1,0
15,253,253,10,10,0,1,0
7,258,258,45,3,42,2,1
17,259,259,37,37,0,1,0
5,285,285,6,6,0,1,0
8,294,294,84,60,24,2,1
12,331,331,78,78,0,1,0
18,353,353,10,10,0,1,0
20,366,366,4,4,0,1,0
2,393,393,20,16,4,2,1
21,426,426,52,31,21,4,3
10,442,442,54,54,0,1,0
23,465,465,6,3,3,2,1
19,476,476,57,36,21,2,1
13,481,481,141,33,108,4,3

26,122,122,2,2,0,1,0
22,138,138,7,7,0,1,0
5,149,149,15,3,12,2,1
11,167,167,13,3,10,2,1
30,169,169,34,34,0,1,0
24,175,175,6,2,4,2,1
7,179,179,1,1,0,1,0
13,181,181,15,15,0,1,0
4,195,195,21,21,0,1,0
16,218,218,13,13,0,1,0
9,230,230,10,1,9,2,1
28,237,237,21,1,20,3,2
20,244,244,42,2,40,2,1
1,267,267,10,10,0,1,0
21,269,269,3,3,0,1,0
29,284,284,100,39,61,3,2
8,300,300,14,14,0,1,0
12,311,311,1,1,0,1,0
25,329,329,7,2,5,2,1
15,351,351,42,35,7,2,1
2,380,380,1,1,0,1,0
6,395,395,10,10,0,1,0
27,411,411,26,1,25,2,1
10,412,412,19,5,14,2,1
14,418,418,37,23,14,2,1
17,420,420,57,15,42,4,3
19,421,421,113,23,90,3,2
0,428,428,7,7,0,1,0
23,474,474,10,2,8,2,1
3,492,492,149,149,0,1,0
18,500,500,12,5,7,2,1

1,111,111,4,4,0,1,0
4,115,115,6,6,0,1,0
20,128,128,17,7,10,3,2
23,136,136,3,3,0,1,0
25,141,141,4,4,0,1,0
16,155,155,5,5,0,1,0
26,168,168,15,15,0,1,0
11,172,172,1,1,0,1,0
14,172,172,92,38,54,4,3
6,184,184,19,19,0,1,0
9,186,186,38,14,24,4,3
24,230,230,1,1,0,1,0
3,233,233,9,3,6,2,1
10,251,251,61,61,0,1,0
17,275,275,41,18,23,2,1
5,291,291,22,22,0,1,0
12,307,307,26,5,21,2,1
7,313,313,21,13,8,3,2
18,351,351,10,10,0,1,0
0,351,351,1,1,0,1,0
19,371,371,85,38,47,2,1
22,389,389,10,10,0,1,0
13,460,460,76,60,16,2,1
2,465,465,12,12,0,1,0
21,477,477,14,3,11,2,1
15,481,481,10,5,5,2,1
8,486,486,96,56,40,3,2

21,105,105,27,27,0,1,0
2,176,176,37,37,0,1,0
10,199,199,39,23,16,3,2
18,200,200,41,35,6,2,1
20,206,206,1,1,0,1,0
12,230,230,24,19,5,2,1
19,240,240,24,10,14,3,2
13,259,259,18,18,0,1,0
25,283,283,8,2,6,2,1
3,294,294,10,10,0,1,0
15,305,305,50,50,0,1,0
9,330,330,18,18,0,1,0
23,335,335,3,3,0,1,0
26,343,343,8,8,0,1,0
7,349,349,8,4,4,2,1
5,365,365,11,11,0,1,0
8,368,368,7,7,0,1,0
1,389,389,80,13,67,4,3
17,393,393,89,89,0,1,0
16,397,397,40,40,0,1,0
22,425,425,14,14,0,1,0
0,445,445,45,45,0,1,0
14,449,449,23,23,0,1,0
4,452,452,1,1,0,1,0
11,469,469,61,33,28,2,1
6,494,494,60,36,24,2,1
24,498,498,62,62,0,1,0

25,110,110,13,4,9,2,1
11,113,113,1,1,0,1,0
14,144,144,4,4,0,1,0
18,187,187,35,24,11,2,1
12,211,211,2,2,0,1,0
7,219,219,43,1,42,2,1
19,250,250,1,1,0,1,0
8,256,256,12,12,0,1,0
13,261,261,37,37,0,1,0
3,269,269,23,11,12,3,2
23,287,287,59,59,0,1,0
22,290,290,45,9,36,2,1
16,305,305,24,11,13,2,1
9,317,317,53,27,26,2,1
5,338,338,1,1,0,1,0
21,339,339,72,40,32,2,1
2,358,358,23,23,0,1,0
28,365,365,20,20,0,1,0
1,366,366,15,1,14,3,2
26,387,387,1,1,0,1,0
27,403,403,22,22,0,1,0
15,406,406,59,17,42,3,2
10,406,406,35,35,0,1,0
24,416,416,60,42,18,4,3
6,464,464,3,3,0,1,0
4,464,464,91,37,54,4,3
0,470,470,35,17,18,3,2
17,485,485,44,44,0,1,0
20,494,494,5,5,0,1,0

26,102,102,9,6,3,2,1
17,111,111,5,5,0,1,0
6,111,111,5,5,0,1,0
7,121,121,11,2,9,4,3
22,131,131,17,7,10,3,2
29,142,142,14,14,0,1,0
3,165,165,2,2,0,1,0
15,172,172,3,3,0,1,0
20,174,174,7,7,0,1,0
28,196,196,39,32,7,2,1
0,214,214,13,4,9,4,3
14,237,237,6,3,3,2,1
27,255,255,10,5,5,2,1
12,267,267,18,18,0,1,0
19,267,267,4,4,0,1,0
5,280,280,16,16,0,1,0
1,283,283,41,41,0,1,0
16,287,287,29,29,0,1,0
8,289,289,17,17,0,1,0
2,291,291,36,24,12,4,3
32,328,328,17,10,7,2,1
31,329,329,18,18,0,1,0
11,333,333,47,47,0,1,0
25,340,340,3,3,0,1,0
30,347,347,52,52,0,1,0
21,348,348,22,22,0,1,0
24,356,356,106,59,47,2,1
18,360,360,2,2,0,1,0
9,406,406,18,18,0,1,0
4,428,428,23,23,0,1,0
23,429,429,41,29,12,3,2
33,439,439,22,2,20,2,1
13,457,457,65,41,24,3,2
10,482,482,5,5,0,1,0

11,105,105,6,6,0,1,0
4,115,115,1,1,0,1,0
2,151,151,91,42,49,3,2
22,157,157,11,1,10,3,2
19,191,191,21,21,0,1,0
17,194,194,10,10,0,1,0
16,197,197,3,3,0,1,0
15,216,216,14,14,0,1,0
20,232,232,25,15,10,3,2
24,259,259,21,21,0,1,0
5,265,265,2,2,0,1,0
12,275,275,20,7,13,2,1
9,290,290,34,10,24,3,2
23,296,296,15,8,7,2,1
10,329,329,2,2,0,1,0
3,350,350,57,57,0,1,0
13,355,355,12,12,0,1,0
6,359,359,35,35,0,1,0
1,382,382,15,2,13,4,3
28,390,390,48,23,25,2,1
8,412,412,1,1,0,1,0
7,414,414,4,4,0,1,0
14,419,419,5,5,0,1,0
18,429,429,4,4,0,1,0
0,451,451,3,3,0,1,0
21,455,455,191,111,80,3,2
26,455,455,20,20,0,1,0
27,464,464,28,28,0,1,0
25,476,476,81,47,34,3,2

3,129,129,5,5,0,1,0
15,132,132,2,2,0,1,0
27,152,152,13,13,0,1,0
2,154,154,2,2,0,1,0
25,160,160,30,30,0,1,0
11,162,162,1,1,0,1,0
9,165,165,3,3,0,1,0
6,189,189,3,3,0,1,0
13,218,218,89,89,0,1,0
1,319,319,14,5,9,2,1
26,321,321,8,1,7,2,1
28,346,346,58,15,43,2,1
19,346,346,45,8,37,3,2
4,348,348,12,12,0,1,0
5,349,349,34,34,0,1,0
22,359,359,20,20,0,1,0
17,366,366,17,14,3,2,1
18,378,378,5,5,0,1,0
16,387,387,10,5,5,2,1
0,402,402,1,1,0,1,0
10,403,403,54,3,51,4,3
23,411,411,23,23,0,1,0
21,430,430,20,7,13,3,2
14,439,439,53,53,0,1,0
7,459,459,131,131,0,1,0
8,477,477,28,28,0,1,0
12,488,488,6,6,0,1,0
24,489,489,80,75,5,2,1
20,499,499,159,97,62,4,3

3,119,119,8,1,7,2,1
13,119,119,1,1,0,1,0
0,127,127,9,9,0,1,0
4,141,141,4,4,0,1,0
19,162,162,21,7,14,2,1
17,195,195,17,1,16,2,1
27,217,217,17,17,0,1,0
12,252,252,35,35,0,1,0
24,271,271,31,31,0,1,0
6,273,273,11,11,0,1,0
21,295,295,31,5,26,3,2
11,313,313,20,20,0,1,0
10,336,336,93,15,78,4,3
16,341,341,25,10,15,4,3
25,341,341,8,2,6,3,2
1,342,342,6,6,0,1,0
20,351,351,38,12,26,3,2
5,367,367,24,24,0,1,0
14,369,369,15,15,0,1,0
2,383,383,14,14,0,1,0
29,397,397,102,79,23,2,1
15,408,408,52,52,0,1,0
8,426,426,41,7,34,2,1
18,438,438,47,7,40,3,2
7,441,441,15,9,6,2,1
26,444,444,19,5,14,3,2
22,461,461,52,15,37,2,1
9,470,470,55,7,48,4,3
28,470,470,49,42,7,2,1
23,478,478,24,24,0,1,0

25,110,110,26,13,13,2,1
7,134,134,1,1,0,1,0
8,139,139,1,1,0,1,0
10,156,156,11,4,7,2,1
19,173,173,24,9,15,2,1
14,204,204,19,19,0,1,0
13,207,207,8,8,0,1,0
1,209,209,35,35,0,1,0
18,221,221,25,25,0,1,0
2,224,224,15,9,6,3,2
0,234,234,18,18,0,1,0
26,245,245,5,5,0,1,0
21,255,255,16,16,0,1,0
11,256,256,15,5,10,3,2
28,296,296,25,25,0,1,0
5,313,313,10,10,0,1,0
9,321,321,37,37,0,1,0
6,321,321,97,15,82,3,2
22,350,350,6,6,0,1,0
20,367,367,26,14,12,3,2
12,371,371,13,7,6,3,2
3,391,391,46,7,39,2,1
27,391,391,91,91,0,1,0
17,396,396,41,27,14,3,2
23,429,429,71,14,57,4,3
24,430,430,23,1,22,4,3
16,455,455,13,4,9,2,1
15,469,469,21,21,0,1,0
4,481,481,32,32,0,1,0

1,110,110,7,7,0,1,0
6,135,135,7,4,3,2,1
26,139,139,5,5,0,1,0
13,158,158,13,13,0,1,0
19,159,159,17,13,4,2,1
2,168,168,2,2,0,1,0
0,186,186,11,3,8,3,2
29,195,195,76,76,0,1,0
22,200,200,30,22,8,3,2
4,206,206,25,4,21,4,3
16,221,221,32,12,20,2,1
25,228,228,15,6,9,2,1
9,231,231,9,9,0,1,0
28,236,236,24,17,7,2,1
23,245,245,15,15,0,1,0
21,253,253,1,1,0,1,0
17,275,275,32,32,0,1,0
11,284,284,1,1,0,1,0
10,287,287,4,4,0,1,0
15,303,303,26,26,0,1,0
3,355,355,27,27,0,1,0
14,371,371,13,9,4,2,1
27,382,382,35,35,0,1,0
7,396,396,114,76,38,3,2
8,403,403,1,1,0,1,0
5,413,413,42,38,4,2,1
18,427,427,42,16,26,3,2
20,439,439,25,25,0,1,0
12,440,440,53,35,18,2,1
24,492,492,22,1,21,2,1

9,102,102,1,1,0,1,0
5,123,123,37,37,0,1,0
16,134,134,3,3,0,1,0
8,136,136,10,3,7,2,1
25,160,160,26,26,0,1,0
10,167,167,32,32,0,1,0
22,201,201,41,41,0,1,0
3,214,214,18,2,16,3,2
15,232,232,3,3,0,1,0
18,237,237,38,28,10,2,1
11,249,249,50,50,0,1,0
4,260,260,10,10,0,1,0
14,273,273,21,21,0,1,0
24,293,293,46,34,12,4,3
19,308,308,15,1,14,2,1
7,309,309,10,3,7,2,1
23,319,319,23,9,14,3,2
17,322,322,68,50,18,3,2
6,325,325,10,10,0,1,0
1,358,358,14,5,9,4,3
20,360,360,47,47,0,1,0
12,393,393,15,15,0,1,0
13,426,426,22,2,20,3,2
21,439,439,8,8,0,1,0
2,473,473,93,54,39,2,1
0,485,485,31,19,12,4,3

25,141,141,4,1,3,2,1
13,143,143,12,12,0,1,0
22,161,161,7,1,6,3,2
14,161,161,26,26,0,1,0
19,176,176,11,11,0,1,0
24,198,198,21,21,0,1,0
6,198,198,30,30,0,1,0
2,200,200,15,1,14,3,2
21,200,200,1,1,0,1,0
0,213,213,1,1,0,1,0
17,217,217,20,2,18,2,1
15,217,217,17,10,7,3,2
5,253,253,21,21,0,1,0
9,275,275,94,94,0,1,0
12,283,283,14,3,11,2,1
10,297,297,15,11,4,2,1
1,308,308,18,3,15,4,3
18,319,319,3,3,0,1,0
16,376,376,161,79,82,3,2
3,390,390,4,4,0,1,0
20,429,429,95,47,48,4,3
23,433,433,1,1,0,1,0
8,434,434,109,20,89,4,3
7,480,480,22,8,14,3,2
4,485,485,83,35,48,4,3
11,491,491,4,4,0,1,0

3,109,109,12,12,0,1,0
31,120,120,19,16,3,2,1
13,156,156,16,6,10,2,1
19,156,156,25,25,0,1,0
18,198,198,4,1,3,2,1
30,201,201,21,3,18,2,1
9,205,205,7,2,5,2,1
17,209,209,20,20,0,1,0
12,223,223,21,18,3,2,1
23,262,262,13,3,10,3,2
16,268,268,5,5,0,1,0
4,298,298,4,1,3,2,1
22,326,326,35,21,14,3,2
27,362,362,96,44,52,3,2
14,364,364,40,40,0,1,0
5,366,366,41,8,33,2,1
11,373,373,3,3,0,1,0
25,375,375,39,39,0,1,0
0,375,375,42,2,40,2,1
8,381,381,39,39,0,1,0
20,382,382,31,3,28,3,2
7,385,385,55,13,42,3,2
10,392,392,19,19,0,1,0
29,416,416,85,85,0,1,0
15,426,426,45,45,0,1,0
21,431,431,2,2,0,1,0
2,432,432,1,1,0,1,0
1,435,435,2,2,0,1,0
26,437,437,6,3,3,2,1
28,448,448,3,3,0,1,0
24,460,460,31,31,0,1,0
6,500,500,33,33,0,1,0

4,100,100,1,1,0,1,0
20,121,121,15,3,12,2,1
2,140,140,27,27,0,1,0
15,142,142,1,1,0,1,0
7,166,166,4,4,0,1,0
23,170,170,38,38,0,1,0
11,171,171,15,15,0,1,0
6,177,177,66,66,0,1,0
22,202,202,26,26,0,1,0
12,205,205,11,11,0,1,0
21,227,227,37,32,5,2,1
3,235,235,21,8,13,2,1
17,240,240,45,21,24,4,3
1,265,265,39,23,16,2,1
13,279,279,11,11,0,1,0
8,288,288,10,10,0,1,0
10,322,322,30,30,0,1,0
5,324,324,39,39,0,1,0
16,333,333,28,28,0,1,0
19,333,333,10,2,8,2,1
9,365,365,35,18,17,2,1
18,418,418,60,4,56,3,2
0,478,478,58,58,0,1,0
14,497,497,31,31,0,1,0

14,104,104,1,1,0,1,0
27,135,135,23,2,21,2,1
6,144,144,1,1,0,1,0
7,161,161,52,19,33,4,3
25,206,206,1,1,0,1,0
15,212,212,2,2,0,1,0
12,216,216,3,3,0,1,0
21,239,239,14,14,0,1,0
1,250,250,28,28,0,1,0
5,273,273,12,12,0,1,0
29,277,277,42,42,0,1,0
3,291,291,20,20,0,1,0
9,305,305,22,10,12,4,3
10,306,306,18,2,16,3,2
17,336,336,91,91,0,1,0
19,343,343,58,58,0,1,0
28,353,353,2,2,0,1,0
24,355,355,118,22,96,4,3
4,358,358,31,19,12,4,3
13,364,364,91,37,54,3,2
23,376,376,6,6,0,1,0
18,379,379,1,1,0,1,0
16,401,401,11,11,0,1,0
20,442,442,6,2,4,2,1
8,442,442,17,6,11,2,1
0,451,451,38,38,0,1,0
26,452,452,50,40,10,2,1
11,457,457,3,3,0,1,0
22,470,470,7,7,0,1,0
2,478,478,43,7,36,3,2

8,108,108,2,2,0,1,0
18,123,123,9,9,0,1,0
4,142,142,4,4,0,1,0
16,184,184,15,5,10,2,1
21,192,192,50,50,0,1,0
17,200,200,23,11,12,4,3
26,273,273,6,6,0,1,0
0,288,288,6,1,5,2,1
1,302,302,11,5,6,2,1
15,334,334,15,15,0,1,0
2,345,345,42,24,18,3,2
24,355,355,42,28,14,3,2
19,355,355,14,14,0,1,0
25,358,358,39,33,6,3,2
10,361,361,63,54,9,4,3
12,377,377,112,112,0,1,0
20,381,381,61,56,5,2,1
6,395,395,18,18,0,1,0
5,400,400,39,39,0,1,0
9,404,404,63,25,38,2,1
7,408,408,18,6,12,3,2
11,412,412,20,20,0,1,0
23,416,416,45,45,0,1,0
14,436,436,19,7,12,4,3
3,441,441,8,3,5,2,1
13,479,479,93,70,23,4,3
22,481,481,71,31,40,3,2

11,123,123,14,4,10,3,2
16,129,129,13,13,0,1,0
18,151,151,18,18,0,1,0
14,172,172,10,10,0,1,0
8,194,194,88,55,33,4,3
12,253,253,16,16,0,1,0
19,255,255,80,80,0,1,0
20,260,260,53,53,0,1,0
10,268,268,11,1,10,2,1
13,287,287,69,15,54,3,2
21,335,335,4,4,0,1,0
2,339,339,13,13,0,1,0
3,349,349,8,3,5,2,1
5,351,351,2,2,0,1,0
0,352,352,106,15,91,4,3
1,383,383,15,5,10,2,1
22,388,388,18,15,3,2,1
9,394,394,15,15,0,1,0
23,425,425,3,3,0,1,0
17,427,427,6,6,0,1,0
6,443,443,54,45,9,2,1
4,470,470,28,10,18,3,2
7,472,472,85,7,78,4,3
15,477,477,18,3,15,2,1

16,105,105,1,1,0,1,0
12,126,126,17,5,12,2,1
7,150,150,5,5,0,1,0
30,173,173,1,1,0,1,0
15,184,184,1,1,0,1,0
13,201,201,9,9,0,1,0
18,209,209,15,15,0,1,0
8,232,232,20,6,14,3,2
22,261,261,3,3,0,1,0
4,262,262,6,6,0,1,0
6,285,285,6,6,0,1,0
11,289,289,19,19,0,1,0
21,294,294,2,2,0,1,0
26,295,295,79,79,0,1,0
20,297,297,30,12,18,4,3
27,314,314,47,47,0,1,0
10,319,319,6,6,0,1,0
3,320,320,12,12,0,1,0
25,323,323,6,6,0,1,0
19,334,334,77,41,36,3,2
9,341,341,11,2,9,2,1
28,357,357,4,4,0,1,0
29,368,368,75,7,68,3,2
31,378,378,23,23,0,1,0
1,383,383,29,20,9,4,3
2,415,415,27,27,0,1,0
14,418,418,18,18,0,1,0
5,424,424,26,26,0,1,0
24,427,427,42,42,0,1,0
0,452,452,186,137,49,2,1
17,493,493,30,18,12,4,3
23,499,499,80,46,34,3,2

6,100,100,5,1,4,2,1
24,121,121,20,6,14,3,2
21,160,160,3,3,0,1,0
26,161,161,11,2,9,4,3
30,161,161,5,5,0,1,0
28,166,166,13,13,0,1,0
22,171,171,4,1,3,2,1
12,186,186,1,1,0,1,0
4,197,197,15,6,9,2,1
27,209,209,10,10,0,1,0
16,231,231,10,4,6,2,1
13,245,245,35,35,0,1,0
7,247,247,13,6,7,2,1
3,289,289,98,98,0,1,0
15,294,294,41,41,0,1,0
9,305,305,2,2,0,1,0
10,346,346,31,1,30,2,1
20,350,350,3,3,0,1,0
25,350,350,80,76,4,2,1
14,366,366,14,4,10,3,2
5,406,406,3,3,0,1,0
0,408,408,5,5,0,1,0
29,421,421,25,25,0,1,0
1,426,426,12,9,3,2,1
2,427,427,44,44,0,1,0
19,431,431,10,7,3,2,1
17,432,432,1,1,0,1,0
18,436,436,12,12,0,1,0
11,447,447,43,43,0,1,0
32,454,454,24,8,16,3,2
8,458,458,8,8,0,1,0
31,459,459,199,103,96,4,3
23,474,474,54,54,0,1,0

16,127,127,7,2,5,2,1
13,151,151,13,13,0,1,0
17,168,168,15,5,10,2,1
2,172,172,11,11,0,1,0
5,177,177,18,18,0,1,0
10,178,178,6,6,0,1,0
20,197,197,15,7,8,3,2
25,199,199,7,7,0,1,0
18,235,235,33,23,10,2,1
7,247,247,22,14,8,3,2
23,255,255,34,2,32,4,3
6,256,256,51,51,0,1,0
19,295,295,81,81,0,1,0
15,296,296,84,34,50,2,1
22,308,308,8,8,0,1,0
0,346,346,46,37,9,4,3
26,354,354,20,20,0,1,0
9,380,380,6,6,0,1,0
12,394,394,7,4,3,2,1
8,399,399,31,31,0,1,0
1,416,416,82,39,43,2,1
27,443,443,3,3,0,1,0
3,449,449,84,54,30,4,3
14,453,453,19,10,9,4,3
11,457,457,10,3,7,2,1
24,471,471,49,42,7,2,1
4,493,493,17,1,16,3,2
21,499,499,21,21,0,1,0

4,105,105,33,33,0,1,0
22,118,118,24,24,0,1,0
14,118,118,1,1,0,1,0
18,133,133,22,22,0,1,0
8,140,140,60,37,23,2,1
16,148,148,24,24,0,1,0
6,167,167,2,2,0,1,0
19,212,212,43,23,20,2,1
2,281,281,26,7,19,3,2
10,305,305,57,57,0,1,0
15,329,329,35,23,12,2,1
0,351,351,1,1,0,1,0
21,352,352,20,2,18,2,1
23,362,362,49,2,47,3,2
20,366,366,28,11,17,4,3
5,384,384,10,3,7,2,1
9,393,393,20,7,13,2,1
13,395,395,5,5,0,1,0
11,410,410,4,4,0,1,0
7,420,420,30,27,3,2,1
17,422,422,19,4,15,4,3
3,435,435,32,6,26,2,1
1,438,438,19,19,0,1,0
12,459,459,65,53,12,2,1

13,101,101,6,6,0,1,0
18,138,138,2,2,0,1,0
9,142,142,1,1,0,1,0
3,180,180,34,1,33,2,1
20,209,209,25,1,24,3,2
1,250,250,10,10,0,1,0
22,251,251,37,4,33,4,3
4,255,255,10,4,6,3,2
2,256,256,10,1,9,4,3
0,267,267,73,52,21,4,3
15,267,267,40,40,0,1,0
5,289,289,78,66,12,3,2
10,307,307,56,56,0,1,0
21,311,311,101,40,61,4,3
23,329,329,8,5,3,2,1
19,331,331,6,1,5,2,1
8,364,364,4,4,0,1,0
11,388,388,56,56,0,1,0
7,413,413,73,59,14,2,1
12,415,415,3,3,0,1,0
6,440,440,33,8,25,2,1
14,467,467,104,104,0,1,0
17,481,481,18,6,12,4,3
16,497,497,26,5,21,4,3

10,105,105,2,2,0,1,0
25,119,119,20,20,0,1,0
14,171,171,34,30,4,2,1
6,174,174,3,3,0,1,0
19,245,245,20,7,13,2,1
9,254,254,10,4,6,3,2
20,266,266,17,8,9,2,1
1,272,272,5,5,0,1,0
24,274,274,48,48,0,1,0
17,308,308,24,24,0,1,0
12,317,317,29,4,25,2,1
8,318,318,65,23,42,4,3
28,343,343,15,5,10,2,1
16,344,344,109,45,64,3,2
22,363,363,3,3,0,1,0
18,365,365,62,62,0,1,0
27,366,366,39,39,0,1,0
7,369,369,42,42,0,1,0
15,405,405,1,1,0,1,0
5,413,413,29,8,21,2,1
21,425,425,42,42,0,1,0
4,430,430,25,25,0,1,0
0,447,447,50,21,29,2,1
2,470,470,5,5,0,1,0
26,472,472,2,2,0,1,0
11,479,479,36,25,11,2,1
13,493,493,85,7,78,4,3
3,495,495,48,48,0,1,0
23,500,500,2,2,0,1,0

17,119,119,6,2,4,2,1
5,147,147,14,6,8,3,2
8,158,158,27,21,6,2,1
6,182,182,5,5,0,1,0
20,188,188,13,13,0,1,0
13,199,199,22,22,0,1,0
0,203,203,44,44,0,1,0
12,209,209,23,6,17,4,3
11,234,234,5,5,0,1,0
15,246,246,46,46,0,1,0
19,266,266,95,3,92,4,3
21,277,277,78,78,0,1,0
10,281,281,8,2,6,2,1
7,291,291,84,26,58,3,2
9,296,296,8,8,0,1,0
3,308,308,6,6,0,1,0
16,360,360,11,11,0,1,0
1,384,384,88,76,12,3,2
14,442,442,15,7,8,2,1
2,477,477,61,61,0,1,0
18,491,491,8,8,0,1,0
4,493,493,63,63,0,1,0

6,103,103,1,1,0,1,0
2,104,104,16,16,0,1,0
10,107,107,7,3,4,2,1
25,116,116,1,1,0,1,0
5,157,157,23,13,10,3,2
18,160,160,7,7,0,1,0
24,173,173,12,12,0,1,0
23,176,176,27,27,0,1,0
0,194,194,2,2,0,1,0
1,229,229,22,13,9,2,1
17,249,249,3,3,0,1,0
12,264,264,48,15,33,2,1
26,269,269,6,6,0,1,0
4,276,276,7,2,5,2,1
8,303,303,30,12,18,3,2
7,321,321,14,14,0,1,0
13,336,336,30,30,0,1,0
19,351,351,6,6,0,1,0
15,364,364,24,24,0,1,0
21,377,377,35,35,0,1,0
9,383,383,64,57,7,2,1
3,405,405,48,48,0,1,0
11,416,416,40,21,19,2,1
22,442,442,26,7,19,2,1
14,444,444,94,78,16,3,2
16,444,444,234,127,107,4,3
20,474,474,17,2,15,3,2

10,120,120,5,5,0,1,0
18,146,146,5,5,0,1,0
11,158,158,19,10,9,2,1
4,187,187,37,37,0,1,0
12,192,192,5,2,3,2,1
15,194,194,4,4,0,1,0
1,200,200,41,41,0,1,0
14,204,204,44,44,0,1,0
6,235,235,7,7,0,1,0
16,293,293,28,28,0,1,0
3,316,316,137,137,0,1,0
2,327,327,18,2,16,2,1
0,353,353,14,8,6,2,1
19,355,355,7,1,6,2,1
5,357,357,102,102,0,1,0
8,385,385,79,79,0,1,0
7,419,419,23,23,0,1,0
17,427,427,1,1,0,1,0
9,432,432,15,15,0,1,0
20,433,433,64,28,36,4,3
13,438,438,161,161,0,1,0

20,103,103,27,8,19,2,1
19,108,108,9,3,6,3,2
18,130,130,6,6,0,1,0
28,135,135,30,8,22,3,2
12,151,151,4,1,3,2,1
7,159,159,31,1,30,3,2
29,165,165,25,20,5,2,1
11,166,166,10,10,0,1,0
21,168,168,6,6,0,1,0
30,177,177,4,4,0,1,0
15,193,193,1,1,0,1,0
24,237,237,2,2,0,1,0
1,238,238,10,10,0,1,0
5,261,261,13,8,5,2,1
6,275,275,12,9,3,2,1
8,298,298,17,17,0,1,0
3,314,314,23,20,3,2,1
14,322,322,51,51,0,1,0
22,328,328,1,1,0,1,0
25,357,357,25,1,24,3,2
17,369,369,2,2,0,1,0
23,382,382,87,87,0,1,0
2,400,400,13,2,11,2,1
10,401,401,31,7,24,3,2
16,420,420,60,18,42,4,3
13,432,432,25,25,0,1,0
9,445,445,72,60,12,4,3
0,460,460,46,12,34,3,2
26,463,463,79,64,15,2,1
27,483,483,12,2,10,2,1
4,487,487,6,1,5,2,1

13,106,106,2,2,0,1,0
7,114,114,5,5,0,1,0
20,152,152,37,20,17,3,2
17,171,171,3,3,0,1,0
25,174,174,1,1,0,1,0
5,254,254,21,5,16,2,1
12,259,259,1,1,0,1,0
2,284,284,48,48,0,1,0
21,287,287,8,8,0,1,0
14,319,319,4,1,3,2,1
15,330,330,117,12,105,4,3
16,344,344,4,4,0,1,0
8,350,350,39,31,8,3,2
23,368,368,10,6,4,2,1
22,391,391,50,50,0,1,0
9,396,396,81,35,46,2,1
4,402,402,42,42,0,1,0
6,403,403,113,51,62,3,2
18,427,427,56,56,0,1,0
0,435,435,19,19,0,1,0
19,437,437,145,107,38,2,1
11,441,441,1,1,0,1,0
24,452,452,8,8,0,1,0
10,479,479,95,95,0,1,0
1,487,487,22,22,0,1,0
3,491,491,6,6,0,1,0

6,107,107,11,7,4,2,1
21,124,124,15,1,14,3,2
16,128,128,1,1,0,1,0
18,131,131,7,3,4,2,1
15,138,138,1,1,0,1,0
29,152,152,38,38,0,1,0
1,176,176,44,6,38,3,2
3,184,184,19,4,15,2,1
17,199,199,1,1,0,1,0
13,210,210,61,39,22,3,2
22,225,225,14,11,3,2,1
0,229,229,25,12,13,3,2
9,243,243,3,3,0,1,0
31,244,244,4,4,0,1,0
12,245,245,7,1,6,2,1
5,280,280,6,1,5,2,1
4,284,284,19,1,18,4,3
27,286,286,67,67,0,1,0
8,300,300,5,5,0,1,0
19,311,311,4,4,0,1,0
10,314,314,30,30,0,1,0
24,330,330,56,12,44,3,2
2,331,331,27,11,16,2,1
14,361,361,5,5,0,1,0
23,362,362,17,1,16,3,2
11,362,362,2,2,0,1,0
7,368,368,11,11,0,1,0
28,410,410,10,1,9,2,1
25,430,430,47,1,46,4,3
20,435,435,27,15,12,3,2
30,480,480,19,19,0,1,0
26,492,492,90,90,0,1,0

18,101,101,8,8,0,1,0
1,110,110,1,1,0,1,0
13,125,125,12,12,0,1,0
9,129,129,13,13,0,1,0
27,158,158,48,16,32,2,1
23,164,164,1,1,0,1,0
5,193,193,19,19,0,1,0
8,196,196,16,16,0,1,0
25,210,210,25,25,0,1,0
26,211,211,3,3,0,1,0
14,240,240,15,15,0,1,0
22,266,266,27,8,19,2,1
11,273,273,66,66,0,1,0
0,288,288,49,49,0,1,0
7,302,302,18,2,16,4,3
3,304,304,8,8,0,1,0
28,311,311,2,2,0,1,0
17,312,312,9,9,0,1,0
10,342,342,15,2,13,2,1
20,352,352,41,41,0,1,0
21,357,357,28,6,22,2,1
2,372,372,17,17,0,1,0
12,378,378,61,61,0,1,0
19,379,379,24,16,8,2,1
4,397,397,19,16,3,2,1
15,409,409,9,1,8,3,2
16,415,415,152,66,86,4,3
24,463,463,16,16,0,1,0
6,493,493,17,17,0,1,0

11,111,111,1,1,0,1,0
17,122,122,23,23,0,1,0
18,159,159,14,8,6,3,2
5,163,163,1,1,0,1,0
3,176,176,19,19,0,1,0
13,189,189,16,16,0,1,0
19,201,201,35,35,0,1,0
20,208,208,28,28,0,1,0
30,219,219,61,35,26,3,2
1,231,231,35,35,0,1,0
0,237,237,6,2,4,2,1
14,240,240,9,3,6,3,2
15,253,253,1,1,0,1,0
27,278,278,84,84,0,1,0
24,286,286,32,32,0,1,0
22,304,304,8,8,0,1,0
10,334,334,3,3,0,1,0
28,345,345,8,8,0,1,0
9,350,350,36,36,0,1,0
6,355,355,7,7,0,1,0
23,364,364,23,11,12,4,3
2,389,389,42,7,35,2,1
7,400,400,21,12,9,2,1
8,403,403,101,67,34,3,2
16,404,404,22,22,0,1,0
29,422,422,21,1,20,3,2
26,423,423,9,9,0,1,0
21,429,429,14,14,0,1,0
25,436,436,5,5,0,1,0
4,452,452,28,28,0,1,0
12,497,497,14,14,0,1,0

2,100,100,17,17,0,1,0
9,118,118,3,3,0,1,0
27,118,118,6,6,0,1,0
25,119,119,10,5,5,2,1
24,136,136,3,3,0,1,0
15,140,140,6,2,4,2,1
7,140,140,1,1,0,1,0
4,143,143,14,14,0,1,0
10,154,154,1,1,0,1,0
12,192,192,26,26,0,1,0
21,208,208,16,7,9,4,3
0,216,216,74,74,0,1,0
20,284,284,69,4,65,4,3
19,301,301,45,45,0,1,0
28,310,310,6,6,0,1,0
14,311,311,19,19,0,1,0
5,330,330,31,31,0,1,0
8,341,341,5,5,0,1,0
13,368,368,14,14,0,1,0
1,368,368,31,31,0,1,0
3,401,401,17,17,0,1,0
6,402,402,9,9,0,1,0
18,420,420,57,44,13,2,1
23,421,421,23,3,20,3,2
22,427,427,68,18,50,2,1
11,461,461,13,7,6,3,2
26,463,463,14,14,0,1,0
29,472,472,127,76,51,4,3
17,475,475,14,14,0,1,0
16,487,487,43,27,16,2,1

9,132,132,23,5,18,3,2
7,143,143,3,3,0,1,0
17,157,157,8,8,0,1,0
27,164,164,18,18,0,1,0
28,179,179,27,6,21,4,3
2,201,201,20,2,18,3,2
14,201,201,3,3,0,1,0
15,218,218,8,8,0,1,0
24,220,220,33,12,21,4,3
20,235,235,7,7,0,1,0
11,247,247,8,8,0,1,0
21,257,257,2,2,0,1,0
16,263,263,1,1,0,1,0
3,267,267,6,6,0,1,0
18,270,270,26,26,0,1,0
26,270,270,4,4,0,1,0
30,289,289,23,10,13,2,1
10,312,312,24,13,11,2,1
6,321,321,9,1,8,3,2
12,329,329,11,7,4,2,1
25,335,335,6,6,0,1,0
23,343,343,89,68,21,4,3
4,346,346,45,12,33,2,1
19,359,359,85,52,33,4,3
29,377,377,50,50,0,1,0
8,417,417,17,9,8,2,1
0,425,425,17,10,7,2,1
22,450,450,17,5,12,3,2
1,462,462,3,3,0,1,0
5,479,479,71,71,0,1,0
13,488,488,167,167,0,1,0

16,146,146,24,6,18,4,3
13,158,158,37,37,0,1,0
19,171,171,9,3,6,2,1
2,235,235,7,1,6,2,1
17,249,249,44,44,0,1,0
14,348,348,90,85,5,2,1
10,350,350,22,22,0,1,0
7,350,350,12,12,0,1,0
3,394,394,28,28,0,1,0
1,399,399,166,38,128,4,3
11,402,402,29,29,0,1,0
18,426,426,26,12,14,3,2
6,429,429,55,24,31,2,1
4,432,432,106,74,32,3,2
5,435,435,130,118,12,2,1
9,443,443,39,29,10,3,2
12,444,444,12,12,0,1,0
0,448,448,50,50,0,1,0
15,465,465,35,10,25,2,1
8,483,483,7,7,0,1,0

6,105,105,2,2,0,1,0
18,114,114,1,1,0,1,0
5,135,135,4,1,3,2,1
22,138,138,30,23,7,2,1
19,143,143,16,11,5,2,1
3,167,167,25,25,0,1,0
16,205,205,19,19,0,1,0
17,211,211,7,7,0,1,0
1,213,213,52,52,0,1,0
23,239,239,34,13,21,4,3
11,244,244,16,16,0,1,0
26,288,288,16,16,0,1,0
2,296,296,58,40,18,2,1
20,333,333,32,32,0,1,0
10,339,339,59,8,51,4,3
8,346,346,6,6,0,1,0
25,352,352,28,28,0,1,0
14,359,359,36,2,34,4,3
4,369,369,21,9,12,3,2
27,410,410,116,25,91,3,2
21,421,421,36,36,0,1,0
13,427,427,10,10,0,1,0
24,435,435,56,56,0,1,0
15,442,442,1,1,0,1,0
7,446,446,41,41,0,1,0
9,455,455,23,23,0,1,0
12,478,478,29,29,0,1,0
0,498,498,11,6,5,2,1

16,102,102,5,1,4,2,1
11,112,112,17,6,11,2,1
15,122,122,6,2,4,2,1
6,123,123,46,28,18,3,2
13,130,130,11,11,0,1,0
4,132,132,5,5,0,1,0
1,152,152,28,17,11,2,1
17,165,165,23,4,19,2,1
7,168,168,19,19,0,1,0
5,211,211,49,16,33,4,3
12,221,221,5,5,0,1,0
14,310,310,19,2,17,2,1
19,327,327,36,36,0,1,0
3,369,369,91,52,39,4,3
2,379,379,24,5,19,2,1
9,402,402,23,23,0,1,0
18,421,421,116,116,0,1,0
20,468,468,14,14,0,1,0
0,470,470,24,8,16,3,2
10,484,484,70,70,0,1,0
8,499,499,75,40,35,2,1

22,103,103,14,14,0,1,0
18,150,150,15,15,0,1,0
1,158,158,4,1,3,2,1
13,178,178,16,16,0,1,0
25,179,179,5,5,0,1,0
19,191,191,7,7,0,1,0
8,208,208,2,2,0,1,0
28,256,256,31,31,0,1,0
6,262,262,26,26,0,1,0
20,272,272,66,66,0,1,0
16,286,286,30,12,18,2,1
10,292,292,23,23,0,1,0
2,311,311,1,1,0,1,0
14,315,315,15,15,0,1,0
3,316,316,44,12,32,2,1
5,336,336,85,85,0,1,0
23,341,341,41,41,0,1,0
27,367,367,55,35,20,2,1
29,385,385,20,20,0,1,0
4,417,417,26,26,0,1,0
26,421,421,58,58,0,1,0
7,428,428,1,1,0,1,0
21,434,434,19,10,9,2,1
11,438,438,67,67,0,1,0
12,461,461,10,5,5,2,1
15,465,465,46,46,0,1,0
9,474,474,27,27,0,1,0
0,490,490,27,27,0,1,0
24,494,494,27,27,0,1,0
17,496,496,53,6,47,2,1

1,111,111,9,9,0,1,0
2,156,156,17,17,0,1,0
27,180,180,4,1,3,2,1
10,210,210,13,7,6,3,2
28,213,213,9,9,0,1,0
14,218,218,6,6,0,1,0
5,247,247,11,6,5,2,1
21,255,255,20,7,13,2,1
9,262,262,43,43,0,1,0
23,262,262,54,7,47,2,1
3,266,266,32,6,26,2,1
7,268,268,23,8,15,4,3
26,268,268,34,31,3,2,1
24,268,268,3,3,0,1,0
19,276,276,16,13,3,2,1
16,284,284,15,15,0,1,0
0,301,301,10,10,0,1,0
6,321,321,62,62,0,1,0
12,329,329,37,33,4,2,1
18,369,369,81,70,11,2,1
11,370,370,2,2,0,1,0
4,385,385,7,7,0,1,0
15,409,409,36,36,0,1,0
22,415,415,29,21,8,2,1
20,435,435,4,4,0,1,0
13,451,451,9,4,5,2,1
8,454,454,62,55,7,2,1
25,480,480,135,79,56,3,2
17,496,496,71,71,0,1,0

17,111,111,7,7,0,1,0
6,121,121,1,1,0,1,0
18,139,139,6,3,3,2,1
2,141,141,1,1,0,1,0
27,172,172,38,26,12,3,2
29,182,182,13,13,0,1,0
25,193,193,2,2,0,1,0
26,197,197,5,5,0,1,0
23,203,203,67,67,0,1,0
24,206,206,10,10,0,1,0
14,213,213,19,19,0,1,0
1,232,232,16,16,0,1,0
12,289,289,7,7,0,1,0
28,307,307,31,31,0,1,0
21,315,315,35,22,13,2,1
3,316,316,20,6,14,3,2
19,318,318,28,18,10,2,1
9,321,321,4,4,0,1,0
10,324,324,42,11,31,2,1
4,327,327,1,1,0,1,0
16,332,332,28,16,12,3,2
22,351,351,50,20,30,4,3
7,373,373,20,4,16,2,1
20,376,376,25,25,0,1,0
13,381,381,21,21,0,1,0
0,419,419,52,52,0,1,0
5,465,465,108,63,45,4,3
11,477,477,137,47,90,4,3
8,480,480,18,18,0,1,0
15,490,490,10,10,0,1,0

13,102,102,3,3,0,1,0
27,112,112,1,1,0,1,0
2,128,128,14,1,13,2,1
28,128,128,30,17,13,2,1
22,141,141,2,2,0,1,0
0,142,142,1,1,0,1,0
31,147,147,3,3,0,1,0
18,166,166,2,2,0,1,0
6,190,190,3,3,0,1,0
29,218,218,24,24,0,1,0
32,227,227,62,26,36,3,2
5,229,229,1,1,0,1,0
23,245,245,26,26,0,1,0
26,289,289,80,80,0,1,0
16,294,294,6,6,0,1,0
17,297,297,40,3,37,4,3
11,319,319,11,5,6,2,1
7,328,328,36,36,0,1,0
25,328,328,17,17,0,1,0
4,329,329,28,28,0,1,0
24,353,353,5,5,0,1,0
3,370,370,5,5,0,1,0
12,382,382,61,61,0,1,0
9,407,407,1,1,0,1,0
15,419,419,2,2,0,1,0
8,437,437,33,33,0,1,0
20,442,442,11,1,10,3,2
21,453,453,75,45,30,3,2
1,456,456,93,4,89,4,3
14,476,476,43,17,26,3,2
19,489,489,51,51,0,1,0
10,494,494,42,42,0,1,0
30,500,500,18,6,12,4,3

11,145,145,22,22,0,1,0
3,153,153,3,3,0,1,0
5,184,184,29,1,28,2,1
22,187,187,12,3,9,2,1
7,189,189,13,13,0,1,0
17,206,206,5,5,0,1,0
13,207,207,26,26,0,1,0
2,222,222,15,2,13,2,1
25,246,246,11,11,0,1,0
26,284,284,137,60,77,4,3
18,313,313,27,3,24,3,2
19,333,333,3,3,0,1,0
15,343,343,3,3,0,1,0
6,358,358,6,2,4,2,1
9,370,370,1,1,0,1,0
16,374,374,10,10,0,1,0
23,398,398,2,2,0,1,0
12,399,399,51,39,12,4,3
0,399,399,10,2,8,3,2
21,415,415,74,26,48,4,3
14,422,422,18,18,0,1,0
4,427,427,63,21,42,2,1
24,445,445,33,33,0,1,0
1,469,469,55,55,0,1,0
20,471,471,130,99,31,2,1
10,482,482,88,30,58,3,2
8,496,496,45,45,0,1,0

20,118,118,15,15,0,1,0
17,134,134,1,1,0,1,0
10,136,136,1,1,0,1,0
6,142,142,45,45,0,1,0
16,150,150,3,3,0,1,0
24,157,157,50,50,0,1,0
22,201,201,26,4,22,4,3
26,204,204,21,3,18,3,2
12,256,256,20,12,8,3,2
14,256,256,20,20,0,1,0
4,275,275,18,12,6,2,1
27,294,294,9,1,8,3,2
3,308,308,1,1,0,1,0
1,325,325,15,2,13,4,3
19,332,332,24,24,0,1,0
25,337,337,16,16,0,1,0
9,342,342,47,29,18,2,1
7,370,370,59,59,0,1,0
0,372,372,24,24,0,1,0
5,422,422,60,20,40,2,1
23,422,422,22,22,0,1,0
13,441,441,19,5,14,4,3
11,444,444,19,13,6,2,1
2,476,476,27,27,0,1,0
18,484,484,30,24,6,2,1
8,491,491,29,29,0,1,0
15,493,493,53,27,26,2,1
21,499,499,125,83,42,4,3

13,115,115,4,4,0,1,0
9,118,118,1,1,0,1,0
17,142,142,16,16,0,1,0
6,145,145,2,2,0,1,0
12,146,146,4,4,0,1,0
14,147,147,22,10,12,3,2
8,161,161,22,22,0,1,0
7,161,161,28,28,0,1,0
0,187,187,78,78,0,1,0
1,218,218,15,9,6,2,1
24,243,243,14,7,7,2,1
23,253,253,10,2,8,3,2
20,273,273,37,22,15,4,3
25,275,275,7,3,4,2,1
4,302,302,17,11,6,3,2
3,335,335,31,31,0,1,0
16,337,337,24,24,0,1,0
21,391,391,11,8,3,2,1
22,391,391,162,98,64,4,3
10,395,395,48,39,9,4,3
18,419,419,7,2,5,2,1
5,432,432,7,7,0,1,0
15,456,456,102,10,92,3,2
19,469,469,8,3,5,2,1
2,478,478,25,11,14,3,2
11,488,488,59,42,17,2,1

10,151,151,7,1,6,2,1
2,166,166,78,20,58,3,2
5,170,170,20,8,12,4,3
11,172,172,30,22,8,3,2
13,194,194,67,29,38,3,2
15,201,201,12,2,10,4,3
9,257,257,1,1,0,1,0
14,316,316,3,3,0,1,0
16,320,320,109,34,75,4,3
20,321,321,38,24,14,3,2
3,322,322,94,94,0,1,0
4,333,333,43,22,21,2,1
6,345,345,24,24,0,1,0
8,369,369,19,19,0,1,0
18,396,396,3,3,0,1,0
7,422,422,12,12,0,1,0
12,428,428,1,1,0,1,0
17,432,432,2,2,0,1,0
19,442,442,68,29,39,4,3
0,451,451,67,3,64,3,2
1,490,490,23,23,0,1,0

24,101,101,5,5,0,1,0
20,114,114,15,15,0,1,0
11,136,136,4,4,0,1,0
16,161,161,4,4,0,1,0
10,176,176,36,36,0,1,0
23,177,177,6,6,0,1,0
9,195,195,39,24,15,4,3
5,203,203,5,5,0,1,0
8,235,235,26,26,0,1,0
27,247,247,21,1,20,3,2
7,274,274,44,44,0,1,0
4,282,282,39,39,0,1,0
3,286,286,6,6,0,1,0
13,300,300,24,24,0,1,0
25,340,340,11,11,0,1,0
6,345,345,5,5,0,1,0
2,353,353,71,71,0,1,0
19,354,354,62,62,0,1,0
14,364,364,3,3,0,1,0
21,373,373,6,6,0,1,0
0,404,404,11,11,0,1,0
22,427,427,113,86,27,2,1
15,429,429,55,38,17,2,1
18,430,430,98,28,70,3,2
17,434,434,51,11,40,3,2
1,444,444,20,3,17,3,2
12,500,500,18,18,0,1,0
26,500,500,19,7,12,4,3

10,107,107,12,8,4,2,1
6,114,114,1,1,0,1,0
17,169,169,1,1,0,1,0
11,198,198,13,13,0,1,0
18,202,202,24,24,0,1,0
19,218,218,7,4,3,2,1
5,250,250,93,76,17,2,1
21,265,265,12,12,0,1,0
2,267,267,5,5,0,1,0
15,277,277,16,2,14,2,1
7,292,292,129,108,21,4,3
8,293,293,29,11,18,4,3
0,323,323,21,21,0,1,0
1,340,340,1,1,0,1,0
14,352,352,18,14,4,2,1
9,383,383,23,10,13,2,1
4,394,394,21,3,18,2,1
13,408,408,44,44,0,1,0
23,419,419,149,38,111,4,3
3,431,431,32,18,14,3,2
20,434,434,30,30,0,1,0
12,440,440,70,70,0,1,0
22,450,450,66,10,56,3,2
16,499,499,55,3,52,4,3

14,120,120,11,11,0,1,0
15,125,125,9,9,0,1,0
0,133,133,16,1,15,4,3
22,144,144,1,1,0,1,0
17,164,164,12,12,0,1,0
20,165,165,8,8,0,1,0
16,184,184,53,7,46,4,3
6,196,196,35,35,0,1,0
10,219,219,2,2,0,1,0
1,227,227,26,8,18,4,3
12,242,242,38,14,24,2,1
5,295,295,38,38,0,1,0
4,302,302,30,30,0,1,0
18,302,302,24,24,0,1,0
19,324,324,72,72,0,1,0
11,376,376,37,37,0,1,0
13,392,392,24,24,0,1,0
9,421,421,32,32,0,1,0
8,456,456,130,43,87,4,3
2,463,463,24,1,23,2,1
7,473,473,50,50,0,1,0
3,486,486,68,68,0,1,0
21,500,500,66,66,0,1,0

15,141,141,21,21,0,1,0
13,153,153,8,8,0,1,0
11,172,172,9,6,3,2,1
21,172,172,4,4,0,1,0
6,192,192,14,14,0,1,0
9,205,205,31,31,0,1,0
8,227,227,11,11,0,1,0
3,270,270,4,4,0,1,0
16,273,273,49,37,12,2,1
1,302,302,74,62,12,4,3
5,332,332,54,54,0,1,0
18,336,336,7,7,0,1,0
4,340,340,38,38,0,1,0
23,343,343,58,58,0,1,0
14,346,346,73,73,0,1,0
0,353,353,1,1,0,1,0
20,362,362,4,4,0,1,0
10,364,364,16,16,0,1,0
22,370,370,7,7,0,1,0
24,393,393,10,10,0,1,0
12,405,405,35,35,0,1,0
19,418,418,71,11,60,4,3
17,422,422,35,35,0,1,0
25,441,441,93,42,51,4,3
26,462,462,20,3,17,2,1
2,473,473,80,46,34,2,1
7,498,498,43,1,42,4,3

5,102,102,9,9,0,1,0
14,110,110,2,2,0,1,0
16,134,134,2,2,0,1,0
7,143,143,29,29,0,1,0
1,160,160,95,73,22,2,1
15,184,184,8,3,5,2,1
12,249,249,7,7,0,1,0
17,267,267,30,30,0,1,0
11,296,296,29,29,0,1,0
4,299,299,48,48,0,1,0
6,336,336,39,34,5,2,1
8,362,362,88,88,0,1,0
2,381,381,108,82,26,3,2
10,385,385,35,35,0,1,0
0,385,385,1,1,0,1,0
13,386,386,92,81,11,2,1
9,426,426,16,12,4,2,1
3,430,430,113,56,57,3,2

12,102,102,16,16,0,1,0
26,140,140,3,3,0,1,0
6,163,163,13,10,3,2,1
19,193,193,16,16,0,1,0
24,202,202,7,7,0,1,0
13,208,208,1,1,0,1,0
16,217,217,17,2,15,4,3
14,251,251,6,3,3,2,1
15,264,264,12,12,0,1,0
27,268,268,14,14,0,1,0
11,274,274,48,28,20,3,2
22,283,283,27,19,8,2,1
23,284,284,11,2,9,2,1
20,292,292,28,28,0,1,0
5,313,313,14,14,0,1,0
28,334,334,54,54,0,1,0
8,343,343,23,9,14,2,1
21,348,348,28,7,21,3,2
18,353,353,89,72,17,2,1
9,355,355,60,57,3,2,1
25,382,382,96,36,60,4,3
7,389,389,5,5,0,1,0
3,407,407,1,1,0,1,0
4,409,409,4,1,3,2,1
10,429,429,88,34,54,4,3
17,440,440,38,38,0,1,0
1,451,451,84,84,0,1,0
2,462,462,6,6,0,1,0
0,470,470,49,43,6,2,1

3,103,103,1,1,0,1,0
6,131,131,4,4,0,1,0
18,132,132,22,22,0,1,0
22,153,153,16,2,14,2,1
25,157,157,13,13,0,1,0
21,164,164,1,1,0,1,0
0,179,179,2,2,0,1,0
7,192,192,19,4,15,2,1
23,196,196,31,8,23,2,1
24,207,207,17,17,0,1,0
17,225,225,1,1,0,1,0
20,254,254,31,28,3,2,1
2,264,264,2,2,0,1,0
11,275,275,106,58,48,4,3
12,284,284,82,37,45,2,1
10,291,291,45,3,42,2,1
4,299,299,16,7,9,4,3
5,330,330,12,12,0,1,0
19,345,345,29,7,22,3,2
1,363,363,17,17,0,1,0
9,382,382,62,45,17,2,1
15,386,386,62,24,38,2,1
16,409,409,66,30,36,3,2
14,456,456,62,16,46,3,2
8,487,487,7,2,5,2,1
13,488,488,27,27,0,1,0

18,106,106,30,8,22,3,2
27,106,106,21,4,17,2,1
5,108,108,7,7,0,1,0
3,111,111,20,20,0,1,0
25,139,139,16,8,8,3,2
17,147,147,1,1,0,1,0
7,149,149,8,8,0,1,0
23,183,183,16,16,0,1,0
26,193,193,5,5,0,1,0
12,206,206,1,1,0,1,0
16,217,217,3,3,0,1,0
28,223,223,15,15,0,1,0
21,230,230,24,6,18,2,1
29,255,255,11,11,0,1,0
11,255,255,53,53,0,1,0
13,270,270,10,4,6,3,2
19,272,272,24,12,12,2,1
24,290,290,2,2,0,1,0
14,315,315,41,1,40,3,2
20,325,325,7,3,4,2,1
9,326,326,5,2,3,2,1
2,329,329,5,2,3,2,1
6,360,360,2,2,0,1,0
1,385,385,23,23,0,1,0
4,407,407,59,16,43,3,2
8,423,423,70,44,26,3,2
0,429,429,4,4,0,1,0
10,481,481,5,5,0,1,0
15,482,482,88,49,39,4,3
22,499,499,141,132,9,2,1

0,103,103,22,22,0,1,0
12,117,117,3,3,0,1,0
27,119,119,19,2,17,2,1
13,121,121,2,2,0,1,0
20,160,160,2,2,0,1,0
6,167,167,10,10,0,1,0
3,186,186,1,1,0,1,0
21,196,196,36,8,28,2,1
5,198,198,16,16,0,1,0
19,203,203,18,3,15,4,3
24,213,213,4,4,0,1,0
1,215,215,1,1,0,1,0
8,227,227,5,5,0,1,0
7,278,278,17,1,16,2,1
26,298,298,19,19,0,1,0
2,331,331,38,26,12,2,1
23,343,343,78,22,56,4,3
10,349,349,8,8,0,1,0
4,385,385,38,32,6,2,1
25,406,406,6,6,0,1,0
18,429,429,3,3,0,1,0
9,442,442,173,113,60,4,3
11,452,452,42,16,26,3,2
15,470,470,37,37,0,1,0
16,481,481,144,140,4,2,1
22,490,490,38,11,27,4,3
14,492,492,45,45,0,1,0
17,499,499,47,35,12,4,3

23,109,109,10,7,3,2,1
21,110,110,9,3,6,2,1
25,134,134,8,2,6,3,2
14,139,139,15,7,8,3,2
8,150,150,1,1,0,1,0
13,163,163,4,4,0,1,0
10,182,182,1,1,0,1,0
26,192,192,8,4,4,2,1
31,204,204,25,25,0,1,0
9,216,216,21,5,16,3,2
11,237,237,12,12,0,1,0
19,240,240,1,1,0,1,0
30,252,252,25,25,0,1,0
4,266,266,12,12,0,1,0
17,267,267,46,46,0,1,0
20,280,280,11,3,8,2,1
32,314,314,72,38,34,2,1
27,326,326,60,60,0,1,0
24,328,328,16,5,11,3,2
28,330,330,46,5,41,2,1
6,331,331,9,3,6,3,2
5,344,344,29,29,0,1,0
16,360,360,25,25,0,1,0
3,369,369,14,14,0,1,0
7,392,392,6,6,0,1,0
1,398,398,51,18,33,2,1
0,404,404,10,1,9,2,1
2,407,407,10,10,0,1,0
22,441,441,54,50,4,2,1
29,441,441,30,22,8,2,1
12,461,461,3,3,0,1,0
18,491,491,117,86,31,2,1
15,494,494,64,64,0,1,0

19,104,104,4,4,0,1,0
10,115,115,8,3,5,2,1
23,158,158,7,7,0,1,0
3,181,181,2,2,0,1,0
17,187,187,29,29,0,1,0
7,198,198,1,1,0,1,0
13,245,245,22,11,11,2,1
8,270,270,59,59,0,1,0
0,275,275,44,44,0,1,0
6,279,279,60,60,0,1,0
4,288,288,8,8,0,1,0
20,302,302,52,16,36,4,3
21,303,303,31,31,0,1,0
11,323,323,109,87,22,3,2
16,327,327,4,4,0,1,0
18,328,328,8,2,6,2,1
5,330,330,25,25,0,1,0
2,336,336,34,34,0,1,0
1,356,356,14,2,12,4,3
15,389,389,13,13,0,1,0
9,397,397,16,1,15,2,1
22,400,400,26,5,21,4,3
24,422,422,58,24,34,3,2
12,427,427,166,166,0,1,0
14,436,436,25,13,12,2,1

11,101,101,1,1,0,1,0
3,102,102,2,2,0,1,0
7,177,177,5,5,0,1,0
29,193,193,9,9,0,1,0
22,225,225,8,2,6,2,1
14,228,228,48,17,31,2,1
10,241,241,53,29,24,3,2
13,252,252,4,4,0,1,0
16,266,266,4,4,0,1,0
23,268,268,19,19,0,1,0
21,271,271,16,3,13,2,1
20,294,294,13,7,6,3,2
5,298,298,5,1,4,2,1
2,301,301,40,20,20,2,1
26,304,304,32,32,0,1,0
1,307,307,14,14,0,1,0
27,312,312,27,27,0,1,0
28,323,323,23,23,0,1,0
0,348,348,12,12,0,1,0
8,348,348,4,4,0,1,0
18,352,352,26,5,21,2,1
12,357,357,7,7,0,1,0
25,373,373,14,4,10,3,2
19,428,428,103,103,0,1,0
15,435,435,12,12,0,1,0
17,441,441,185,154,31,4,3
24,447,447,13,13,0,1,0
4,477,477,25,25,0,1,0
6,477,477,34,34,0,1,0
9,487,487,180,180,0,1,0

17,100,100,23,20,3,2,1
3,120,120,13,13,0,1,0
29,121,121,6,2,4,2,1
23,134,134,8,5,3,2,1
5,148,148,9,9,0,1,0
2,174,174,1,1,0,1,0
14,175,175,10,10,0,1,0
19,182,182,12,4,8,3,2
6,194,194,12,12,0,1,0
28,225,225,23,23,0,1,0
7,240,240,6,6,0,1,0
20,243,243,3,3,0,1,0
12,260,260,6,1,5,2,1
22,307,307,30,30,0,1,0
4,336,336,1,1,0,1,0
24,337,337,38,1,37,2,1
9,351,351,68,60,8,2,1
10,379,379,17,7,10,2,1
18,381,381,52,13,39,2,1
21,398,398,166,156,10,3,2
16,403,403,35,35,0,1,0
25,408,408,1,1,0,1,0
26,420,420,5,2,3,2,1
15,431,431,23,23,0,1,0
0,431,431,154,65,89,4,3
8,433,433,5,5,0,1,0
11,449,449,67,20,47,2,1
13,455,455,4,4,0,1,0
27,476,476,14,14,0,1,0
1,478,478,24,18,6,2,1

2,102,102,6,6,0,1,0
18,119,119,1,1,0,1,0
12,152,152,4,1,3,2,1
10,177,177,35,35,0,1,0
20,179,179,39,39,0,1,0
13,197,197,16,4,12,2,1
0,202,202,9,9,0,1,0
4,205,205,22,22,0,1,0
17,205,205,3,3,0,1,0
6,227,227,35,35,0,1,0
19,252,252,21,21,0,1,0
1,262,262,1,1,0,1,0
15,279,279,60,44,16,2,1
21,338,338,51,6,45,2,1
22,348,348,10,10,0,1,0
8,355,355,29,3,26,2,1
3,356,356,128,128,0,1,0
14,361,361,8,2,6,3,2
5,398,398,63,63,0,1,0
7,400,400,24,12,12,2,1
9,426,426,32,25,7,2,1
16,430,430,1,1,0,1,0
11,455,455,23,23,0,1,0
23,498,498,215,116,99,4,3

12,108,108,5,1,4,2,1
17,118,118,30,3,27,4,3
18,120,120,33,33,0,1,0
20,153,153,2,2,0,1,0
27,164,164,8,8,0,1,0
1,180,180,22,22,0,1,0
7,188,188,2,2,0,1,0
14,209,209,45,27,18,2,1
3,212,212,43,1,42,4,3
23,226,226,34,14,20,2,1
2,229,229,41,41,0,1,0
9,252,252,11,6,5,2,1
25,256,256,23,5,18,2,1
24,277,277,26,26,0,1,0
10,313,313,2,2,0,1,0
6,320,320,18,6,12,3,2
21,325,325,17,2,15,2,1
19,332,332,2,2,0,1,0
26,352,352,15,15,0,1,0
22,374,374,23,8,15,2,1
5,384,384,19,13,6,3,2
0,400,400,5,5,0,1,0
8,406,406,5,5,0,1,0
4,426,426,25,3,22,3,2
13,429,429,68,68,0,1,0
15,432,432,36,13,23,4,3
16,442,442,70,70,0,1,0
11,468,468,61,61,0,1,0

17,105,105,7,7,0,1,0
7,109,109,5,2,3,2,1
20,112,112,7,1,6,3,2
22,119,119,1,1,0,1,0
8,142,142,33,33,0,1,0
3,186,186,12,4,8,2,1
15,189,189,15,15,0,1,0
10,212,212,14,2,12,3,2
9,251,251,24,6,18,2,1
6,266,266,12,12,0,1,0
18,284,284,18,2,16,2,1
1,308,308,21,15,6,2,1
2,318,318,110,23,87,4,3
4,369,369,98,2,96,4,3
19,382,382,7,7,0,1,0
5,398,398,28,28,0,1,0
16,402,402,78,28,50,2,1
11,412,412,41,41,0,1,0
21,419,419,36,8,28,4,3
0,446,446,30,4,26,3,2
13,473,473,23,7,16,2,1
14,474,474,207,170,37,4,3
12,496,496,54,45,9,4,3

10,128,128,63,63,0,1,0
3,138,138,1,1,0,1,0
4,159,159,4,4,0,1,0
16,161,161,20,20,0,1,0
23,167,167,15,15,0,1,0
24,168,168,16,5,11,2,1
14,168,168,19,19,0,1,0
11,197,197,9,9,0,1,0
9,206,206,22,22,0,1,0
26,211,211,8,8,0,1,0
7,224,224,71,12,59,4,3
13,230,230,1,1,0,1,0
8,238,238,15,3,12,2,1
17,253,253,14,14,0,1,0
25,258,258,13,13,0,1,0
1,268,268,5,1,4,2,1
0,331,331,9,9,0,1,0
22,333,333,98,98,0,1,0
20,363,363,91,53,38,4,3
18,394,394,8,8,0,1,0
19,396,396,53,53,0,1,0
6,400,400,26,26,0,1,0
5,406,406,8,8,0,1,0
2,437,437,43,13,30,4,3
12,455,455,6,6,0,1,0
15,456,456,8,8,0,1,0
21,477,477,21,16,5,2,1

15,111,111,3,3,0,1,0
24,199,199,38,9,29,2,1
5,218,218,26,26,0,1,0
16,251,251,11,3,8,3,2
4,257,257,21,2,19,3,2
11,257,257,12,1,11,2,1
23,268,268,11,11,0,1,0
14,314,314,10,2,8,3,2
21,321,321,22,22,0,1,0
10,324,324,20,20,0,1,0
18,344,344,26,6,20,2,1
22,348,348,157,125,32,3,2
3,349,349,71,48,23,2,1
0,356,356,31,16,15,4,3
19,367,367,17,2,15,4,3
7,369,369,7,7,0,1,0
1,378,378,3,3,0,1,0
12,395,395,50,35,15,2,1
20,402,402,33,9,24,3,2
13,410,410,50,50,0,1,0
8,418,418,1,1,0,1,0
9,425,425,14,14,0,1,0
2,429,429,103,33,70,3,2
17,497,497,7,7,0,1,0
6,498,498,199,199,0,1,0

4,117,117,18,18,0,1,0
25,129,129,17,9,8,2,1
6,142,142,13,13,0,1,0
21,146,146,23,23,0,1,0
20,200,200,8,8,0,1,0
15,210,210,7,7,0,1,0
13,220,220,16,16,0,1,0
3,226,226,4,4,0,1,0
16,240,240,56,56,0,1,0
9,285,285,23,23,0,1,0
22,299,299,43,20,23,3,2
19,305,305,22,22,0,1,0
24,339,339,85,85,0,1,0
8,341,341,59,42,17,3,2
11,343,343,13,13,0,1,0
0,350,350,83,23,60,4,3
18,355,355,10,10,0,1,0
5,359,359,21,8,13,2,1
10,369,369,50,50,0,1,0
17,376,376,32,32,0,1,0
23,399,399,4,4,0,1,0
2,411,411,74,74,0,1,0
1,412,412,15,15,0,1,0
14,431,431,26,14,12,2,1
7,448,448,32,32,0,1,0
12,474,474,13,13,0,1,0

19,119,119,3,3,0,1,0
20,152,152,2,2,0,1,0
17,156,156,51,51,0,1,0
1,197,197,33,7,26,2,1
21,224,224,3,3,0,1,0
2,225,225,54,6,48,4,3
6,226,226,9,9,0,1,0
18,236,236,8,1,7,2,1
23,258,258,5,5,0,1,0
3,272,272,34,3,31,3,2
22,288,288,115,115,0,1,0
5,289,289,13,13,0,1,0
11,312,312,58,25,33,2,1
8,315,315,21,9,12,4,3
15,323,323,11,11,0,1,0
0,350,350,24,4,20,2,1
14,359,359,24,24,0,1,0
12,364,364,3,3,0,1,0
10,372,372,129,129,0,1,0
13,427,427,38,38,0,1,0
7,438,438,14,14,0,1,0
16,441,441,51,31,20,2,1
4,489,489,81,81,0,1,0
9,498,498,2,2,0,1,0

2,119,119,3,3,0,1,0
12,138,138,1,1,0,1,0
23,175,175,13,5,8,2,1
16,177,177,1,1,0,1,0
18,198,198,3,3,0,1,0
15,206,206,7,7,0,1,0
10,208,208,3,3,0,1,0
26,211,211,33,17,16,3,2
5,216,216,2,2,0,1,0
17,220,220,50,26,24,4,3
27,233,233,21,21,0,1,0
22,251,251,1,1,0,1,0
24,264,264,32,32,0,1,0
21,286,286,4,4,0,1,0
6,325,325,19,19,0,1,0
0,349,349,10,1,9,4,3
4,366,366,128,100,28,2,1
14,381,381,22,22,0,1,0
1,384,384,1,1,0,1,0
9,407,407,53,53,0,1,0
20,417,417,114,20,94,4,3
8,422,422,78,78,0,1,0
19,425,425,126,117,9,4,3
25,432,432,8,8,0,1,0
11,471,471,58,58,0,1,0
3,485,485,10,2,8,2,1
13,498,498,129,97,32,3,2
7,500,500,15,15,0,1,0

10,108,108,13,4,9,2,1
4,132,132,1,1,0,1,0
9,136,136,4,4,0,1,0
24,138,138,3,3,0,1,0
20,170,170,4,4,0,1,0
22,174,174,30,8,22,2,1
17,182,182,40,31,9,4,3
11,245,245,42,8,34,2,1
13,250,250,5,5,0,1,0
26,259,259,48,22,26,2,1
25,262,262,11,11,0,1,0
8,265,265,10,10,0,1,0
16,268,268,48,48,0,1,0
23,293,293,1,1,0,1,0
12,301,301,10,10,0,1,0
18,323,323,34,34,0,1,0
3,323,323,20,20,0,1,0
14,328,328,45,45,0,1,0
1,337,337,16,16,0,1,0
0,416,416,4,1,3,2,1
5,416,416,76,10,66,4,3
2,418,418,29,29,0,1,0
15,431,431,12,12,0,1,0
19,442,442,50,27,23,2,1
21,443,443,43,43,0,1,0
7,461,461,31,31,0,1,0
6,484,484,214,120,94,4,3

12,140,140,24,11,13,2,1
13,147,147,18,3,15,4,3
9,153,153,2,2,0,1,0
5,160,160,7,4,3,2,1
0,166,166,11,3,8,2,1
17,170,170,14,14,0,1,0
23,178,178,29,5,24,3,2
11,185,185,7,7,0,1,0
18,190,190,2,2,0,1,0
20,196,196,47,29,18,3,2
21,199,199,36,25,11,2,1
6,246,246,66,14,52,3,2
3,255,255,23,7,16,2,1
1,268,268,77,77,0,1,0
22,270,270,16,16,0,1,0
16,285,285,26,11,15,4,3
15,308,308,16,2,14,3,2
10,348,348,63,63,0,1,0
4,359,359,82,82,0,1,0
2,359,359,25,25,0,1,0
7,441,441,20,20,0,1,0
19,455,455,31,22,9,2,1
8,483,483,4,4,0,1,0
14,499,499,31,31,0,1,0

27,101,101,1,1,0,1,0
17,103,103,13,7,6,2,1
0,112,112,8,8,0,1,0
19,124,124,10,2,8,2,1
18,129,129,8,8,0,1,0
21,133,133,7,7,0,1,0
14,145,145,4,4,0,1,0
32,164,164,16,16,0,1,0
13,193,193,1,1,0,1,0
10,214,214,22,9,13,2,1
9,235,235,20,20,0,1,0
23,237,237,12,6,6,3,2
16,244,244,23,5,18,2,1
5,246,246,24,24,0,1,0
30,252,252,40,5,35,2,1
20,253,253,3,3,0,1,0
25,256,256,1,1,0,1,0
8,275,275,16,16,0,1,0
28,277,277,12,6,6,2,1
24,285,285,87,60,27,2,1
22,295,295,33,33,0,1,0
3,300,300,8,4,4,2,1
29,314,314,35,35,0,1,0
33,319,319,8,8,0,1,0
2,320,320,7,1,6,2,1
7,321,321,4,4,0,1,0
1,322,322,62,34,28,2,1
26,328,328,37,37,0,1,0
12,349,349,12,12,0,1,0
11,360,360,2,2,0,1,0
31,387,387,96,18,78,4,3
6,414,414,1,1,0,1,0
4,425,425,60,60,0,1,0
15,472,472,19,4,15,2,1

6,131,131,4,1,3,2,1
7,185,185,25,25,0,1,0
4,197,197,1,1,0,1,0
18,217,217,29,12,17,4,3
9,255,255,79,67,12,4,3
15,256,256,9,9,0,1,0
5,313,313,97,22,75,4,3
22,315,315,41,3,38,3,2
8,325,325,12,5,7,3,2
0,328,328,2,2,0,1,0
2,333,333,57,27,30,2,1
11,339,339,44,44,0,1,0
20,345,345,6,2,4,2,1
19,387,387,3,3,0,1,0
21,388,388,47,38,9,4,3
1,400,400,91,31,60,4,3
16,431,431,135,135,0,1,0
14,447,447,5,5,0,1,0
10,455,455,25,25,0,1,0
12,469,469,80,18,62,3,2
13,474,474,48,36,12,2,1
3,492,492,35,35,0,1,0
17,493,493,42,42,0,1,0

27,109,109,8,8,0,1,0
16,119,119,5,1,4,2,1
10,137,137,4,4,0,1,0
0,152,152,15,15,0,1,0
26,154,154,26,26,0,1,0
11,156,156,2,2,0,1,0
12,204,204,27,27,0,1,0
17,228,228,36,36,0,1,0
8,230,230,8,2,6,2,1
23,256,256,8,8,0,1,0
19,260,260,4,4,0,1,0
28,267,267,6,6,0,1,0
6,275,275,4,4,0,1,0
14,281,281,19,19,0,1,0
1,294,294,28,16,12,2,1
21,297,297,76,76,0,1,0
7,305,305,20,20,0,1,0
13,308,308,84,32,52,3,2
5,321,321,38,38,0,1,0
3,321,321,16,4,12,2,1
2,337,337,28,28,0,1,0
22,381,381,62,8,54,3,2
9,402,402,36,1,35,2,1
18,425,425,39,29,10,2,1
4,430,430,25,15,10,3,2
25,440,440,49,6,43,2,1
20,446,446,41,41,0,1,0
15,479,479,38,2,36,4,3
24,492,492,52,52,0,1,0

5,111,111,3,3,0,1,0
20,154,154,55,18,37,2,1
9,187,187,96,87,9,4,3
10,227,227,9,9,0,1,0
22,239,239,20,1,19,2,1
2,245,245,19,5,14,3,2
13,281,281,4,4,0,1,0
14,311,311,4,4,0,1,0
11,322,322,13,13,0,1,0
4,323,323,54,42,12,2,1
8,329,329,20,11,9,4,3
15,332,332,65,41,24,4,3
3,342,342,4,1,3,2,1
17,366,366,10,2,8,3,2
7,381,381,29,3,26,3,2
19,384,384,57,36,21,3,2
12,390,390,51,51,0,1,0
18,432,432,13,13,0,1,0
16,433,433,43,2,41,4,3
0,439,439,65,65,0,1,0
6,449,449,48,1,47,2,1
1,453,453,52,52,0,1,0
21,462,462,65,32,33,2,1

22,107,107,34,22,12,4,3
31,141,141,21,1,20,3,2
3,165,165,22,7,15,3,2
15,169,169,40,1,39,2,1
21,178,178,12,3,9,4,3
20,179,179,41,20,21,4,3
4,183,183,1,1,0,1,0
29,196,196,5,5,0,1,0
0,205,205,2,2,0,1,0
25,208,208,20,20,0,1,0
18,233,233,6,6,0,1,0
2,257,257,22,12,10,3,2
9,258,258,7,7,0,1,0
14,270,270,15,15,0,1,0
17,275,275,1,1,0,1,0
30,278,278,33,33,0,1,0
10,299,299,1,1,0,1,0
13,303,303,7,7,0,1,0
24,318,318,1,1,0,1,0
11,326,326,6,1,5,2,1
26,331,331,14,5,9,3,2
8,337,337,19,3,16,2,1
28,353,353,8,8,0,1,0
23,358,358,69,69,0,1,0
5,364,364,25,16,9,4,3
16,382,382,45,8,37,2,1
12,404,404,18,7,11,2,1
1,414,414,126,36,90,4,3
27,438,438,20,10,10,3,2
19,445,445,11,11,0,1,0
7,466,466,6,6,0,1,0
6,497,497,34,9,25,3,2

23,108,108,8,4,4,2,1
18,114,114,7,7,0,1,0
12,118,118,6,2,4,2,1
11,118,118,49,7,42,4,3
15,158,158,6,6,0,1,0
8,175,175,15,15,0,1,0
13,183,183,38,26,12,4,3
9,268,268,27,6,21,4,3
4,281,281,6,6,0,1,0
21,328,328,40,40,0,1,0
5,330,330,14,6,8,2,1
22,332,332,3,3,0,1,0
14,350,350,66,66,0,1,0
19,356,356,19,19,0,1,0
1,369,369,103,50,53,3,2
20,376,376,21,21,0,1,0
6,386,386,30,15,15,2,1
16,392,392,21,21,0,1,0
17,405,405,7,1,6,3,2
2,406,406,19,2,17,2,1
7,451,451,43,43,0,1,0
3,454,454,122,88,34,3,2
10,458,458,48,48,0,1,0
0,482,482,86,86,0,1,0

22,123,123,1,1,0,1,0
12,137,137,2,2,0,1,0
27,141,141,19,19,0,1,0
24,145,145,14,14,0,1,0
16,150,150,7,7,0,1,0
30,159,159,14,7,7,2,1
11,182,182,2,2,0,1,0
17,194,194,79,79,0,1,0
2,203,203,13,8,5,2,1
13,210,210,4,4,0,1,0
7,216,216,2,2,0,1,0
8,217,217,7,7,0,1,0
31,254,254,43,43,0,1,0
23,254,254,1,1,0,1,0
28,296,296,52,45,7,2,1
3,304,304,18,3,15,2,1
10,305,305,1,1,0,1,0
20,320,320,8,8,0,1,0
26,321,321,38,14,24,4,3
15,341,341,71,39,32,2,1
0,357,357,1,1,0,1,0
14,365,365,19,1,18,3,2
6,384,384,3,3,0,1,0
18,400,400,27,14,13,2,1
5,413,413,4,4,0,1,0
29,423,423,111,45,66,4,3
4,432,432,83,23,60,4,3
19,439,439,78,9,69,3,2
25,454,454,3,3,0,1,0
1,485,485,43,43,0,1,0
9,497,497,3,3,0,1,0
21,498,498,27,27,0,1,0

0,120,120,19,19,0,1,0
8,133,133,27,10,17,2,1
22,139,139,7,7,0,1,0
5,139,139,8,8,0,1,0
3,150,150,34,23,11,2,1
14,167,167,49,31,18,3,2
21,171,171,3,3,0,1,0
12,232,232,34,34,0,1,0
13,235,235,20,2,18,3,2
20,266,266,5,5,0,1,0
19,286,286,28,2,26,2,1
2,305,305,36,16,20,2,1
10,312,312,99,99,0,1,0
18,312,312,6,6,0,1,0
15,315,315,18,18,0,1,0
7,344,344,3,3,0,1,0
9,345,345,96,87,9,4,3
11,349,349,34,34,0,1,0
1,436,436,4,4,0,1,0
6,438,438,91,77,14,3,2
17,438,438,34,8,26,3,2
16,472,472,20,20,0,1,0
4,492,492,16,2,14,3,2

17,134,134,5,5,0,1,0
27,149,149,25,25,0,1,0
8,165,165,7,7,0,1,0
5,171,171,8,8,0,1,0
24,182,182,16,8,8,3,2
4,187,187,2,2,0,1,0
10,200,200,62,49,13,2,1
15,224,224,8,8,0,1,0
21,232,232,46,10,36,2,1
11,232,232,25,9,16,2,1
19,250,250,21,11,10,3,2
16,265,265,17,17,0,1,0
13,281,281,57,57,0,1,0
18,297,297,16,4,12,3,2
3,302,302,1,1,0,1,0
0,313,313,22,22,0,1,0
6,344,344,14,14,0,1,0
26,345,345,16,16,0,1,0
23,348,348,5,1,4,2,1
22,357,357,110,80,30,3,2
9,378,378,29,29,0,1,0
14,381,381,61,15,46,3,2
20,381,381,61,61,0,1,0
2,417,417,47,47,0,1,0
1,418,418,16,4,12,2,1
25,438,438,32,24,8,2,1
7,449,449,4,4,0,1,0
12,483,483,34,12,22,2,1

28,102,102,3,3,0,1,0
21,132,132,7,7,0,1,0
1,134,134,12,4,8,3,2
8,153,153,16,10,6,2,1
7,157,157,20,9,11,2,1
2,158,158,18,9,9,4,3
23,163,163,8,8,0,1,0
17,164,164,4,4,0,1,0
16,178,178,14,9,5,2,1
3,180,180,22,22,0,1,0
12,192,192,14,14,0,1,0
25,213,213,47,47,0,1,0
6,214,214,3,3,0,1,0
22,225,225,2,2,0,1,0
4,276,276,2,2,0,1,0
26,281,281,24,12,12,2,1
0,283,283,23,5,18,2,1
9,284,284,58,13,45,2,1
10,288,288,15,15,0,1,0
14,290,290,1,1,0,1,0
11,317,317,27,1,26,3,2
27,335,335,24,9,15,4,3
20,339,339,10,2,8,3,2
5,375,375,4,4,0,1,0
19,380,380,190,190,0,1,0
18,387,387,69,54,15,4,3
13,464,464,16,4,12,3,2
15,483,483,86,86,0,1,0
24,489,489,4,4,0,1,0

14,134,134,1,1,0,1,0
23,145,145,6,6,0,1,0
10,146,146,21,13,8,3,2
15,156,156,1,1,0,1,0
28,178,178,14,14,0,1,0
2,193,193,2,2,0,1,0
4,203,203,12,12,0,1,0
22,229,229,5,1,4,2,1
13,250,250,1,1,0,1,0
12,256,256,9,9,0,1,0
16,269,269,33,33,0,1,0
9,282,282,115,78,37,2,1
11,286,286,18,18,0,1,0
17,287,287,24,4,20,3,2
26,287,287,11,11,0,1,0
27,291,291,51,33,18,4,3
0,295,295,32,21,11,2,1
24,311,311,12,12,0,1,0
20,313,313,76,76,0,1,0
3,315,315,2,2,0,1,0
8,325,325,13,13,0,1,0
5,373,373,14,1,13,2,1
1,379,379,36,36,0,1,0
6,394,394,22,22,0,1,0
25,405,405,23,15,8,3,2
18,415,415,76,76,0,1,0
19,460,460,84,72,12,2,1
7,469,469,104,78,26,3,2
21,472,472,28,28,0,1,0

11,108,108,5,5,0,1,0
0,118,118,12,3,9,2,1
12,145,145,1,1,0,1,0
7,179,179,30,15,15,2,1
24,183,183,12,12,0,1,0
16,185,185,3,3,0,1,0
27,194,194,2,2,0,1,0
13,194,194,1,1,0,1,0
21,203,203,20,1,19,2,1
26,238,238,12,12,0,1,0
15,238,238,58,40,18,2,1
25,244,244,8,8,0,1,0
3,248,248,50,50,0,1,0
6,255,255,26,26,0,1,0
9,267,267,3,3,0,1,0
4,281,281,1,1,0,1,0
8,294,294,138,90,48,4,3
2,301,301,10,10,0,1,0
23,318,318,117,117,0,1,0
18,327,327,14,10,4,2,1
5,351,351,16,16,0,1,0
19,354,354,40,25,15,4,3
17,383,383,33,33,0,1,0
10,387,387,9,9,0,1,0
22,430,430,46,46,0,1,0
20,456,456,40,40,0,1,0
14,465,465,22,22,0,1,0
1,470,470,17,5,12,3,2

2,112,112,23,6,17,2,1
14,182,182,18,14,4,2,1
4,190,190,5,5,0,1,0
0,194,194,40,40,0,1,0
17,210,210,1,1,0,1,0
1,213,213,24,1,23,2,1
6,227,227,66,66,0,1,0
18,239,239,85,85,0,1,0
11,245,245,10,7,3,2,1
7,248,248,17,5,12,4,3
3,265,265,20,20,0,1,0
21,278,278,51,51,0,1,0
10,301,301,3,3,0,1,0
19,316,316,87,21,66,4,3
5,339,339,66,30,36,3,2
9,344,344,7,7,0,1,0
16,351,351,33,1,32,2,1
13,379,379,3,3,0,1,0
22,386,386,3,3,0,1,0
20,397,397,37,14,23,2,1
23,420,420,8,8,0,1,0
12,438,438,42,9,33,2,1
15,461,461,19,19,0,1,0
8,465,465,43,43,0,1,0

2,128,128,1,1,0,1,0
7,132,132,15,15,0,1,0
0,133,133,10,1,9,2,1
12,185,185,31,31,0,1,0
13,200,200,17,17,0,1,0
20,218,218,10,10,0,1,0
10,223,223,3,3,0,1,0
17,244,244,10,10,0,1,0
5,248,248,24,24,0,1,0
24,251,251,12,2,10,2,1
14,258,258,45,45,0,1,0
21,268,268,29,1,28,2,1
11,287,287,42,4,38,3,2
9,299,299,1,1,0,1,0
18,317,317,55,55,0,1,0
8,318,318,95,95,0,1,0
4,332,332,71,23,48,2,1
23,358,358,82,82,0,1,0
19,361,361,22,8,14,3,2
22,361,361,3,3,0,1,0
16,368,368,90,90,0,1,0
1,376,376,10,10,0,1,0
3,378,378,21,21,0,1,0
15,440,440,30,30,0,1,0
6,484,484,40,8,32,2,1
25,487,487,16,3,13,2,1

0,100,100,9,9,0,1,0
6,110,110,16,4,12,3,2
9,122,122,17,11,6,3,2
5,129,129,18,1,17,2,1
27,130,130,1,1,0,1,0
17,131,131,17,17,0,1,0
14,141,141,6,6,0,1,0
12,143,143,1,1,0,1,0
22,157,157,12,12,0,1,0
2,166,166,52,12,40,2,1
23,174,174,11,4,7,2,1
4,191,191,9,9,0,1,0
18,202,202,20,17,3,2,1
20,208,208,31,9,22,3,2
13,217,217,3,3,0,1,0
19,224,224,65,56,9,4,3
24,236,236,18,18,0,1,0
11,287,287,8,8,0,1,0
25,301,301,8,8,0,1,0
1,334,334,1,1,0,1,0
26,376,376,82,42,40,4,3
7,411,411,5,5,0,1,0
8,416,416,10,10,0,1,0
21,422,422,2,2,0,1,0
3,463,463,64,64,0,1,0
15,467,467,85,85,0,1,0
16,486,486,7,7,0,1,0
10,498,498,78,30,48,3,2

7,106,106,7,7,0,1,0
11,111,111,10,10,0,1,0
9,120,120,32,32,0,1,0
10,132,132,18,4,14,3,2
3,136,136,55,3,52,3,2
22,158,158,18,3,15,2,1
1,173,173,7,7,0,1,0
2,184,184,26,4,22,3,2
23,211,211,14,11,3,2,1
5,248,248,17,17,0,1,0
14,251,251,26,1,25,2,1
21,286,286,46,46,0,1,0
18,324,324,107,107,0,1,0
12,339,339,16,16,0,1,0
17,354,354,55,55,0,1,0
4,373,373,26,26,0,1,0
15,377,377,4,4,0,1,0
0,383,383,33,9,24,4,3
19,399,399,38,38,0,1,0
6,414,414,8,8,0,1,0
13,430,430,26,8,18,2,1
8,451,451,1,1,0,1,0
16,491,491,20,4,16,3,2
20,497,497,24,6,18,2,1

15,132,132,7,4,3,2,1
26,157,157,7,7,0,1,0
18,176,176,4,4,0,1,0
3,180,180,12,12,0,1,0
5,191,191,28,28,0,1,0
22,191,191,4,4,0,1,0
14,236,236,16,16,0,1,0
28,237,237,19,11,8,3,2
10,241,241,54,54,0,1,0
13,246,246,1,1,0,1,0
19,247,247,14,14,0,1,0
12,258,258,67,67,0,1,0
24,321,321,75,27,48,4,3
17,341,341,26,26,0,1,0
1,352,352,7,7,0,1,0
25,384,384,151,151,0,1,0
16,396,396,1,1,0,1,0
0,427,427,25,25,0,1,0
23,431,431,48,39,9,2,1
7,434,434,35,35,0,1,0
8,438,438,24,24,0,1,0
21,439,439,13,13,0,1,0
4,451,451,1,1,0,1,0
20,458,458,87,87,0,1,0
9,475,475,3,3,0,1,0
6,479,479,87,29,58,3,2
2,483,483,4,4,0,1,0
11,491,491,33,2,31,2,1
27,498,498,31,19,12,4,3

9,105,105,6,2,4,2,1
24,120,120,18,18,0,1,0
11,122,122,3,3,0,1,0
5,129,129,2,2,0,1,0
0,152,152,7,7,0,1,0
27,159,159,57,57,0,1,0
7,192,192,10,1,9,4,3
6,194,194,25,13,12,2,1
10,205,205,9,9,0,1,0
21,206,206,21,21,0,1,0
13,225,225,19,19,0,1,0
22,241,241,14,14,0,1,0
8,262,262,64,35,29,2,1
20,265,265,6,6,0,1,0
18,291,291,22,10,12,4,3
1,374,374,40,19,21,2,1
19,377,377,3,3,0,1,0
15,380,380,30,15,15,4,3
4,381,381,22,4,18,4,3
25,394,394,36,36,0,1,0
14,405,405,63,3,60,4,3
26,414,414,105,105,0,1,0
23,420,420,37,37,0,1,0
3,432,432,35,22,13,2,1
12,465,465,12,5,7,2,1
16,465,465,20,20,0,1,0
28,472,472,34,34,0,1,0
17,479,479,2,2,0,1,0
2,492,492,48,1,47,2,1

6,101,101,18,2,16,3,2
20,111,111,8,5,3,2,1
14,130,130,21,21,0,1,0
3,161,161,25,1,24,2,1
8,170,170,21,6,15,4,3
12,174,174,27,27,0,1,0
24,179,179,4,4,0,1,0
4,180,180,3,3,0,1,0
15,182,182,27,27,0,1,0
19,201,201,27,27,0,1,0
25,209,209,18,18,0,1,0
23,219,219,15,15,0,1,0
7,239,239,41,25,16,3,2
11,241,241,16,10,6,3,2
1,249,249,19,9,10,3,2
16,271,271,49,49,0,1,0
18,287,287,42,24,18,4,3
9,310,310,46,46,0,1,0
21,340,340,6,6,0,1,0
5,342,342,21,9,12,2,1
10,350,350,5,2,3,2,1
13,358,358,43,6,37,2,1
17,406,406,14,14,0,1,0
0,423,423,31,23,8,3,2
2,450,450,29,29,0,1,0
22,480,480,66,66,0,1,0

5,105,105,2,2,0,1,0
11,143,143,12,3,9,4,3
25,150,150,23,23,0,1,0
17,151,151,9,3,6,3,2
38,179,179,5,2,3,2,1
23,179,179,3,3,0,1,0
16,197,197,5,5,0,1,0
28,197,197,25,21,4,2,1
18,201,201,9,9,0,1,0
34,203,203,6,2,4,2,1
35,206,206,5,5,0,1,0
4,209,209,35,17,18,2,1
2,213,213,1,1,0,1,0
6,217,217,15,15,0,1,0
20,234,234,4,4,0,1,0
7,260,260,16,2,14,3,2
24,261,261,1,1,0,1,0
10,282,282,20,20,0,1,0
1,287,287,9,9,0,1,0
22,291,291,4,4,0,1,0
26,292,292,107,44,63,4,3
36,295,295,21,21,0,1,0
27,302,302,11,3,8,3,2
33,314,314,53,53,0,1,0
21,324,324,23,23,0,1,0
13,329,329,33,33,0,1,0
19,362,362,6,6,0,1,0
9,377,377,10,7,3,2,1
8,380,380,10,10,0,1,0
15,386,386,47,47,0,1,0
0,397,397,1,1,0,1,0
29,406,406,28,13,15,4,3
31,411,411,75,57,18,3,2
3,415,415,12,12,0,1,0
30,422,422,74,74,0,1,0
32,424,424,4,4,0,1,0
37,435,435,17,17,0,1,0
12,444,444,13,1,12,2,1
14,473,473,19,19,0,1,0

19,127,127,8,8,0,1,0
13,131,131,2,2,0,1,0
25,143,143,39,12,27,4,3
17,148,148,9,5,4,2,1
20,156,156,15,1,14,2,1
7,168,168,3,3,0,1,0
12,199,199,23,15,8,2,1
21,233,233,28,28,0,1,0
15,241,241,26,3,23,2,1
26,242,242,21,21,0,1,0
8,242,242,3,3,0,1,0
16,273,273,11,1,10,3,2
24,277,277,16,16,0,1,0
2,299,299,31,23,8,3,2
3,324,324,21,9,12,3,2
4,346,346,45,12,33,4,3
22,351,351,20,20,0,1,0
0,368,368,1,1,0,1,0
14,385,385,13,13,0,1,0
23,398,398,103,52,51,4,3
9,405,405,31,31,0,1,0
1,422,422,1,1,0,1,0
18,442,442,33,33,0,1,0
11,467,467,34,2,32,3,2
6,472,472,69,69,0,1,0
5,495,495,252,248,4,2,1
10,500,500,19,19,0,1,0

14,101,101,7,4,3,2,1
23,106,106,2,2,0,1,0
19,170,170,2,2,0,1,0
5,181,181,81,68,13,2,1
1,183,183,10,2,8,2,1
0,238,238,10,7,3,2,1
8,241,241,23,23,0,1,0
9,241,241,4,4,0,1,0
24,244,244,21,12,9,4,3
25,248,248,24,16,8,2,1
12,254,254,2,2,0,1,0
20,268,268,16,3,13,2,1
3,273,273,5,5,0,1,0
6,304,304,43,19,24,4,3
15,306,306,44,2,42,3,2
2,330,330,41,1,40,3,2
13,341,341,7,7,0,1,0
22,342,342,138,138,0,1,0
21,370,370,8,8,0,1,0
17,384,384,20,20,0,1,0
11,387,387,17,17,0,1,0
26,430,430,37,30,7,2,1
18,430,430,24,21,3,2,1
4,450,450,60,42,18,4,3
10,478,478,56,56,0,1,0
7,486,486,19,7,12,3,2
16,498,498,107,83,24,3,2

24,101,101,19,10,9,4,3
11,104,104,1,1,0,1,0
7,120,120,4,4,0,1,0
21,132,132,19,19,0,1,0
4,141,141,30,3,27,4,3
5,162,162,8,8,0,1,0
14,182,182,46,23,23,2,1
3,183,183,1,1,0,1,0
19,207,207,2,2,0,1,0
1,249,249,16,2,14,4,3
0,252,252,8,8,0,1,0
13,303,303,1,1,0,1,0
26,305,305,42,8,34,3,2
20,309,309,6,6,0,1,0
10,321,321,97,97,0,1,0
27,324,324,29,29,0,1,0
17,333,333,66,26,40,3,2
23,344,344,67,27,40,3,2
18,373,373,6,6,0,1,0
15,376,376,7,7,0,1,0
16,394,394,87,29,58,3,2
6,413,413,6,6,0,1,0
2,422,422,24,24,0,1,0
8,428,428,6,3,3,2,1
12,430,430,28,28,0,1,0
25,441,441,20,8,12,4,3
22,467,467,18,18,0,1,0
9,484,484,90,15,75,4,3

20,101,101,4,1,3,2,1
4,123,123,2,2,0,1,0
15,169,169,39,31,8,2,1
2,185,185,9,9,0,1,0
21,186,186,2,2,0,1,0
16,218,218,30,30,0,1,0
17,227,227,49,12,37,2,1
19,230,230,3,3,0,1,0
14,247,247,20,9,11,2,1
13,265,265,25,16,9,4,3
23,269,269,8,2,6,2,1
22,299,299,61,22,39,2,1
6,300,300,38,38,0,1,0
1,327,327,10,10,0,1,0
24,354,354,31,31,0,1,0
11,360,360,4,4,0,1,0
3,366,366,85,85,0,1,0
8,385,385,63,29,34,3,2
5,437,437,96,46,50,2,1
0,446,446,82,46,36,2,1
10,450,450,18,18,0,1,0
7,454,454,29,29,0,1,0
18,459,459,62,62,0,1,0
9,463,463,76,76,0,1,0
12,499,499,26,11,15,2,1

17,132,132,1,1,0,1,0
7,154,154,21,14,7,2,1
14,172,172,10,10,0,1,0
0,193,193,10,10,0,1,0
16,217,217,4,4,0,1,0
18,232,232,24,24,0,1,0
9,239,239,8,2,6,3,2
11,261,261,3,3,0,1,0
6,286,286,3,3,0,1,0
5,302,302,49,4,45,4,3
3,317,317,173,153,20,3,2
15,322,322,15,2,13,2,1
4,328,328,73,73,0,1,0
13,352,352,74,74,0,1,0
12,377,377,6,2,4,2,1
19,381,381,63,63,0,1,0
10,389,389,26,26,0,1,0
20,401,401,16,8,8,2,1
1,424,424,57,57,0,1,0
2,451,451,17,9,8,3,2
8,492,492,268,193,75,3,2

6,120,120,3,3,0,1,0
24,153,153,32,4,28,2,1
0,169,169,17,17,0,1,0
21,175,175,36,36,0,1,0
8,214,214,4,4,0,1,0
19,218,218,6,6,0,1,0
11,223,223,38,38,0,1,0
1,229,229,16,10,6,3,2
23,236,236,2,2,0,1,0
7,262,262,109,109,0,1,0
17,273,273,12,12,0,1,0
12,282,282,11,5,6,3,2
20,286,286,18,4,14,2,1
3,304,304,44,44,0,1,0
10,320,320,13,13,0,1,0
5,323,323,9,9,0,1,0
14,334,334,49,43,6,2,1
15,350,350,6,6,0,1,0
13,363,363,61,61,0,1,0
16,369,369,9,1,8,3,2
9,375,375,15,5,10,2,1
18,387,387,135,33,102,4,3
4,409,409,78,78,0,1,0
2,438,438,25,25,0,1,0
22,447,447,9,1,8,3,2

5,138,138,13,3,10,2,1
34,146,146,12,5,7,3,2
35,147,147,4,4,0,1,0
17,165,165,16,6,10,3,2
11,184,184,1,1,0,1,0
29,184,184,50,50,0,1,0
30,186,186,16,16,0,1,0
20,192,192,4,4,0,1,0
14,195,195,1,1,0,1,0
7,203,203,2,2,0,1,0
0,209,209,6,6,0,1,0
1,212,212,27,5,22,2,1
18,237,237,11,11,0,1,0
13,241,241,31,8,23,2,1
19,254,254,2,2,0,1,0
2,265,265,33,33,0,1,0
8,281,281,34,4,30,3,2
25,295,295,98,77,21,4,3
23,309,309,22,10,12,3,2
33,311,311,7,7,0,1,0
15,318,318,1,1,0,1,0
28,318,318,33,33,0,1,0
21,336,336,12,12,0,1,0
10,349,349,1,1,0,1,0
24,374,374,16,16,0,1,0
22,381,381,14,14,0,1,0
3,385,385,9,6,3,2,1
6,414,414,11,11,0,1,0
31,428,428,5,2,3,2,1
27,447,447,12,5,7,2,1
16,462,462,18,18,0,1,0
32,464,464,43,9,34,3,2
12,468,468,77,77,0,1,0
4,476,476,53,41,12,2,1
26,494,494,72,38,34,4,3
9,494,494,20,20,0,1,0

17,103,103,12,2,10,3,2
9,103,103,46,46,0,1,0
21,106,106,6,6,0,1,0
0,114,114,1,1,0,1,0
6,128,128,2,2,0,1,0
18,161,161,21,21,0,1,0
2,164,164,1,1,0,1,0
19,170,170,29,13,16,3,2
28,178,178,2,2,0,1,0
10,183,183,15,1,14,3,2
4,190,190,3,3,0,1,0
12,205,205,10,10,0,1,0
15,211,211,40,40,0,1,0
23,223,223,33,20,13,2,1
16,237,237,6,6,0,1,0
13,239,239,8,8,0,1,0
11,251,251,15,6,9,2,1
25,252,252,38,29,9,2,1
1,277,277,10,10,0,1,0
3,320,320,53,17,36,2,1
27,331,331,27,14,13,3,2
20,379,379,61,9,52,4,3
5,396,396,41,13,28,3,2
26,407,407,49,7,42,3,2
24,421,421,34,14,20,3,2
14,429,429,1,1,0,1,0
8,440,440,34,26,8,3,2
7,462,462,6,2,4,2,1
22,499,499,37,4,33,2,1

29,106,106,14,2,12,4,3
18,109,109,3,3,0,1,0
28,173,173,2,2,0,1,0
9,174,174,8,8,0,1,0
13,179,179,4,4,0,1,0
30,214,214,15,15,0,1,0
20,240,240,12,12,0,1,0
32,276,276,22,22,0,1,0
26,278,278,22,22,0,1,0
21,287,287,52,32,20,3,2
17,302,302,10,2,8,2,1
22,313,313,29,9,20,2,1
3,315,315,26,26,0,1,0
11,315,315,7,1,6,3,2
14,318,318,69,11,58,4,3
15,320,320,34,34,0,1,0
5,328,328,20,4,16,2,1
4,334,334,40,40,0,1,0
27,344,344,40,40,0,1,0
16,358,358,37,2,35,2,1
12,358,358,1,1,0,1,0
25,367,367,12,5,7,2,1
2,395,395,9,1,8,3,2
8,398,398,1,1,0,1,0
1,404,404,11,11,0,1,0
10,435,435,28,25,3,2,1
7,436,436,19,19,0,1,0
31,472,472,108,87,21,4,3
6,474,474,4,4,0,1,0
24,483,483,78,28,50,2,1
19,484,484,134,35,99,4,3
23,490,490,44,44,0,1,0
0,494,494,6,3,3,2,1

18,110,110,18,18,0,1,0
1,116,116,5,5,0,1,0
5,139,139,1,1,0,1,0
15,160,160,29,29,0,1,0
3,164,164,1,1,0,1,0
7,188,188,16,16,0,1,0
11,195,195,6,6,0,1,0
4,201,201,12,12,0,1,0
8,208,208,5,5,0,1,0
13,216,216,35,11,24,4,3
6,256,256,1,1,0,1,0
26,266,266,37,37,0,1,0
29,268,268,5,5,0,1,0
27,279,279,10,1,9,4,3
9,287,287,24,21,3,2,1
2,292,292,3,3,0,1,0
19,297,297,29,21,8,2,1
20,299,299,31,31,0,1,0
24,318,318,29,29,0,1,0
12,343,343,5,5,0,1,0
0,347,347,64,38,26,2,1
10,370,370,81,51,30,4,3
28,373,373,20,20,0,1,0
21,382,382,84,69,15,4,3
14,400,400,57,57,0,1,0
17,431,431,50,43,7,2,1
22,436,436,73,13,60,3,2
25,439,439,23,1,22,2,1
16,450,450,20,20,0,1,0
23,491,491,31,31,0,1,0

16,128,128,8,8,0,1,0
9,134,134,3,3,0,1,0
23,136,136,5,5,0,1,0
24,145,145,27,27,0,1,0
20,147,147,9,3,6,3,2
26,159,159,1,1,0,1,0
13,181,181,8,8,0,1,0
0,189,189,13,13,0,1,0
21,206,206,40,40,0,1,0
27,230,230,10,10,0,1,0
25,239,239,73,27,46,3,2
10,270,270,19,7,12,4,3
6,289,289,47,3,44,2,1
11,309,309,8,8,0,1,0
1,332,332,19,8,11,2,1
3,371,371,38,2,36,4,3
19,373,373,27,27,0,1,0
22,397,397,59,59,0,1,0
17,407,407,45,3,42,3,2
2,422,422,77,77,0,1,0
18,436,436,45,25,20,3,2
12,458,458,3,3,0,1,0
7,464,464,1,1,0,1,0
15,468,468,1,1,0,1,0
8,469,469,87,18,69,3,2
14,478,478,63,63,0,1,0
4,493,493,12,8,4,2,1
5,494,494,106,106,0,1,0

16,115,115,18,1,17,2,1
9,116,116,6,6,0,1,0
18,120,120,3,3,0,1,0
26,121,121,3,3,0,1,0
3,123,123,15,15,0,1,0
13,133,133,15,1,14,3,2
12,176,176,1,1,0,1,0
22,204,204,7,7,0,1,0
10,209,209,24,8,16,2,1
25,215,215,12,12,0,1,0
23,279,279,28,4,24,3,2
5,286,286,12,12,0,1,0
15,292,292,51,51,0,1,0
6,305,305,48,48,0,1,0
1,306,306,26,26,0,1,0
4,326,326,4,4,0,1,0
24,337,337,12,7,5,2,1
21,338,338,43,43,0,1,0
8,340,340,82,65,17,4,3
7,351,351,30,2,28,4,3
2,403,403,1,1,0,1,0
0,413,413,109,20,89,3,2
17,421,421,2,2,0,1,0
19,448,448,23,9,14,2,1
20,453,453,44,44,0,1,0
11,454,454,3,3,0,1,0
14,496,496,217,175,42,4,3

7,180,180,5,1,4,2,1
24,201,201,12,2,10,3,2
10,204,204,2,2,0,1,0
16,219,219,8,8,0,1,0
21,227,227,105,15,90,3,2
6,233,233,16,16,0,1,0
8,242,242,6,6,0,1,0
13,261,261,18,18,0,1,0
18,275,275,12,2,10,3,2
20,301,301,37,23,14,3,2
12,317,317,26,22,4,2,1
5,321,321,70,70,0,1,0
4,331,331,56,56,0,1,0
26,344,344,15,15,0,1,0
9,358,358,54,54,0,1,0
25,372,372,13,13,0,1,0
11,399,399,31,24,7,2,1
17,418,418,6,2,4,2,1
14,420,420,92,81,11,2,1
3,425,425,52,52,0,1,0
2,426,426,72,57,15,4,3
23,436,436,16,16,0,1,0
19,445,445,95,95,0,1,0
15,457,457,4,1,3,2,1
1,480,480,52,30,22,3,2
0,487,487,2,2,0,1,0
22,487,487,11,11,0,1,0

7,109,109,6,6,0,1,0
9,127,127,1,1,0,1,0
17,133,133,17,13,4,2,1
19,152,152,18,1,17,2,1
22,158,158,40,40,0,1,0
24,166,166,25,19,6,3,2
0,206,206,18,10,8,2,1
15,244,244,20,8,12,4,3
2,261,261,25,12,13,2,1
8,265,265,85,49,36,4,3
25,268,268,3,3,0,1,0
6,297,297,19,19,0,1,0
3,301,301,9,4,5,2,1
11,317,317,3,3,0,1,0
20,321,321,39,28,11,2,1
18,376,376,35,3,32,3,2
23,392,392,18,10,8,3,2
16,402,402,37,37,0,1,0
13,405,405,13,13,0,1,0
4,412,412,42,22,20,3,2
1,429,429,68,30,38,2,1
27,442,442,21,21,0,1,0
10,457,457,67,67,0,1,0
26,459,459,71,16,55,4,3
14,490,490,8,8,0,1,0
21,491,491,16,16,0,1,0
5,492,492,38,7,31,2,1
12,494,494,48,48,0,1,0

0,116,116,1,1,0,1,0
3,124,124,8,8,0,1,0
5,132,132,3,3,0,1,0
9,134,134,14,3,11,2,1
20,146,146,7,7,0,1,0
7,158,158,63,21,42,3,2
19,171,171,27,6,21,4,3
4,181,181,28,28,0,1,0
8,199,199,1,1,0,1,0
12,251,251,16,16,0,1,0
6,252,252,36,36,0,1,0
14,260,260,68,68,0,1,0
1,279,279,49,1,48,2,1
24,286,286,1,1,0,1,0
10,306,306,30,26,4,2,1
23,312,312,7,7,0,1,0
11,325,325,33,33,0,1,0
2,335,335,8,2,6,3,2
18,337,337,51,51,0,1,0
21,348,348,31,31,0,1,0
22,376,376,40,40,0,1,0
17,382,382,22,22,0,1,0
13,383,383,27,27,0,1,0
16,424,424,58,2,56,3,2
15,491,491,72,35,37,2,1

9,106,106,5,5,0,1,0
4,111,111,3,3,0,1,0
6,132,132,6,2,4,2,1
19,136,136,3,3,0,1,0
20,139,139,15,15,0,1,0
14,144,144,2,2,0,1,0
16,162,162,16,7,9,2,1
22,176,176,33,17,16,2,1
24,181,181,14,14,0,1,0
28,204,204,5,5,0,1,0
7,204,204,6,6,0,1,0
26,205,205,13,2,11,2,1
15,230,230,37,20,17,2,1
10,241,241,19,4,15,2,1
13,247,247,7,7,0,1,0
27,273,273,90,90,0,1,0
21,274,274,32,32,0,1,0
0,280,280,4,4,0,1,0
11,281,281,7,4,3,2,1
25,313,313,6,2,4,2,1
17,356,356,56,32,24,3,2
18,390,390,18,18,0,1,0
5,409,409,52,43,9,2,1
3,427,427,103,103,0,1,0
2,429,429,114,105,9,4,3
8,437,437,62,34,28,2,1
1,458,458,1,1,0,1,0
12,492,492,27,4,23,4,3
23,497,497,41,11,30,4,3

6,115,115,19,19,0,1,0
12,135,135,6,6,0,1,0
3,136,136,67,41,26,3,2
22,138,138,4,4,0,1,0
2,158,158,15,15,0,1,0
15,178,178,9,2,7,3,2
4,197,197,6,6,0,1,0
11,197,197,26,26,0,1,0
21,217,217,23,23,0,1,0
16,227,227,22,11,11,2,1
7,265,265,17,7,10,3,2
1,284,284,4,4,0,1,0
5,304,304,88,70,18,3,2
19,308,308,27,27,0,1,0
14,370,370,2,2,0,1,0
20,384,384,25,1,24,2,1
0,404,404,4,1,3,2,1
10,418,418,22,22,0,1,0
18,429,429,14,6,8,3,2
17,454,454,260,248,12,2,1
9,471,471,34,34,0,1,0
8,489,489,33,33,0,1,0
13,490,490,23,12,11,2,1

12,112,112,8,8,0,1,0
23,130,130,3,3,0,1,0
9,131,131,11,11,0,1,0
0,133,133,5,2,3,2,1
13,140,140,7,4,3,2,1
4,157,157,1,1,0,1,0
5,159,159,1,1,0,1,0
18,160,160,7,2,5,2,1
1,162,162,41,4,37,4,3
11,182,182,8,8,0,1,0
2,196,196,66,24,42,3,2
16,227,227,3,3,0,1,0
7,230,230,1,1,0,1,0
14,272,272,30,18,12,3,2
8,282,282,94,94,0,1,0
25,290,290,35,35,0,1,0
20,317,317,109,37,72,4,3
22,339,339,39,11,28,3,2
3,343,343,1,1,0,1,0
24,389,389,71,71,0,1,0
17,425,425,64,64,0,1,0
15,430,430,29,24,5,2,1
6,449,449,21,21,0,1,0
21,456,456,45,45,0,1,0
10,467,467,35,11,24,3,2
19,493,493,2,2,0,1,0

16,106,106,20,4,16,3,2
22,125,125,8,8,0,1,0
23,171,171,30,2,28,3,2
6,183,183,38,6,32,4,3
1,183,183,6,6,0,1,0
3,184,184,18,8,10,2,1
4,208,208,42,8,34,3,2
24,234,234,2,2,0,1,0
0,237,237,1,1,0,1,0
7,238,238,53,53,0,1,0
18,271,271,63,9,54,3,2
11,277,277,34,1,33,2,1
20,278,278,60,60,0,1,0
9,280,280,62,20,42,2,1
19,307,307,18,8,10,2,1
10,321,321,17,4,13,2,1
12,338,338,1,1,0,1,0
14,343,343,52,10,42,3,2
15,349,349,12,1,11,3,2
17,394,394,5,5,0,1,0
25,411,411,20,5,15,2,1
13,430,430,31,31,0,1,0
21,451,451,28,19,9,4,3
5,451,451,1,1,0,1,0
2,473,473,21,11,10,3,2
8,478,478,42,42,0,1,0

17,111,111,23,23,0,1,0
11,114,114,5,5,0,1,0
6,126,126,50,50,0,1,0
4,155,155,36,36,0,1,0
20,197,197,29,3,26,2,1
16,203,203,4,4,0,1,0
7,219,219,5,1,4,2,1
13,225,225,10,5,5,2,1
5,233,233,4,4,0,1,0
1,261,261,54,39,15,4,3
15,281,281,21,3,18,3,2
21,284,284,16,7,9,2,1
10,297,297,52,11,41,3,2
0,307,307,29,29,0,1,0
8,323,323,82,69,13,2,1
19,327,327,92,20,72,4,3
2,340,340,13,13,0,1,0
9,341,341,33,33,0,1,0
12,391,391,1,1,0,1,0
18,409,409,59,52,7,2,1
3,422,422,16,3,13,2,1
14,453,453,17,7,10,3,2

20,107,107,6,6,0,1,0
3,138,138,2,2,0,1,0
6,159,159,2,2,0,1,0
2,177,177,14,2,12,4,3
16,184,184,18,2,16,4,3
17,198,198,27,10,17,3,2
21,212,212,14,14,0,1,0
10,236,236,10,2,8,3,2
4,250,250,6,6,0,1,0
23,250,250,64,16,48,3,2
7,263,263,56,56,0,1,0
25,287,287,2,2,0,1,0
0,289,289,36,36,0,1,0
15,290,290,10,10,0,1,0
14,291,291,8,8,0,1,0
9,298,298,36,6,30,3,2
18,302,302,30,30,0,1,0
8,313,313,78,36,42,3,2
5,335,335,38,32,6,3,2
13,356,356,27,27,0,1,0
11,366,366,13,13,0,1,0
12,370,370,100,22,78,3,2
22,394,394,21,21,0,1,0
24,439,439,112,62,50,2,1
1,460,460,1,1,0,1,0
19,477,477,76,76,0,1,0

8,117,117,1,1,0,1,0
3,131,131,5,1,4,2,1
19,137,137,1,1,0,1,0
11,139,139,6,6,0,1,0
29,157,157,4,4,0,1,0
30,184,184,2,2,0,1,0
26,214,214,61,42,19,2,1
15,225,225,1,1,0,1,0
7,232,232,12,9,3,2,1
2,246,246,67,47,20,2,1
12,254,254,18,18,0,1,0
5,255,255,7,1,6,2,1
10,256,256,19,19,0,1,0
21,262,262,3,3,0,1,0
31,269,269,5,5,0,1,0
32,273,273,5,5,0,1,0
13,274,274,23,23,0,1,0
1,286,286,31,31,0,1,0
18,290,290,10,10,0,1,0
24,291,291,122,32,90,3,2
6,309,309,43,5,38,3,2
16,311,311,3,3,0,1,0
17,314,314,9,6,3,2,1
0,314,314,4,4,0,1,0
23,345,345,90,36,54,4,3
22,372,372,3,3,0,1,0
20,403,403,11,11,0,1,0
14,405,405,11,11,0,1,0
4,414,414,26,26,0,1,0
28,415,415,24,24,0,1,0
9,435,435,73,28,45,4,3
27,440,440,35,35,0,1,0
25,458,458,5,5,0,1,0
33,489,489,59,25,34,3,2

11,120,120,1,1,0,1,0
30,121,121,35,35,0,1,0
26,143,143,3,3,0,1,0
5,154,154,6,3,3,2,1
6,163,163,8,1,7,2,1
8,172,172,1,1,0,1,0
9,176,176,23,2,21,4,3
1,182,182,6,6,0,1,0
16,188,188,4,4,0,1,0
19,191,191,14,14,0,1,0
14,223,223,8,8,0,1,0
21,305,305,87,18,69,4,3
24,316,316,8,5,3,2,1
25,327,327,1,1,0,1,0
18,345,345,26,26,0,1,0
29,352,352,29,20,9,4,3
15,353,353,61,61,0,1,0
31,359,359,8,8,0,1,0
2,361,361,18,18,0,1,0
28,365,365,10,10,0,1,0
0,367,367,67,26,41,4,3
3,372,372,9,9,0,1,0
33,375,375,36,36,0,1,0
17,383,383,6,1,5,2,1
32,386,386,20,20,0,1,0
20,392,392,40,40,0,1,0
23,397,397,50,50,0,1,0
10,436,436,16,3,13,2,1
7,439,439,12,12,0,1,0
27,444,444,71,5,66,3,2
22,448,448,60,60,0,1,0
13,467,467,1,1,0,1,0
4,471,471,67,67,0,1,0
12,488,488,36,15,21,4,3

4,115,115,4,4,0,1,0
14,118,118,23,23,0,1,0
17,130,130,2,2,0,1,0
18,149,149,14,11,3,2,1
9,151,151,9,5,4,2,1
21,167,167,1,1,0,1,0
24,178,178,30,2,28,2,1
19,206,206,27,27,0,1,0
15,210,210,28,8,20,2,1
3,239,239,14,4,10,2,1
5,245,245,10,10,0,1,0
12,262,262,25,25,0,1,0
6,272,272,4,4,0,1,0
8,295,295,58,16,42,3,2
10,328,328,4,4,0,1,0
11,342,342,81,81,0,1,0
2,354,354,23,23,0,1,0
22,361,361,12,8,4,2,1
16,371,371,48,48,0,1,0
0,393,393,148,87,61,4,3
7,432,432,4,4,0,1,0
1,445,445,88,25,63,4,3
20,452,452,53,53,0,1,0
13,464,464,79,22,57,4,3
23,496,496,22,9,13,2,1

10,131,131,5,5,0,1,0
1,141,141,47,47,0,1,0
0,149,149,14,14,0,1,0
5,165,165,66,37,29,2,1
16,213,213,7,7,0,1,0
19,229,229,31,31,0,1,0
14,237,237,17,17,0,1,0
3,259,259,50,26,24,4,3
2,262,262,65,24,41,2,1
12,311,311,9,9,0,1,0
18,319,319,6,6,0,1,0
6,328,328,7,7,0,1,0
11,352,352,2,2,0,1,0
15,359,359,20,20,0,1,0
4,362,362,4,4,0,1,0
8,364,364,30,6,24,3,2
17,391,391,258,207,51,4,3
7,439,439,11,11,0,1,0
13,465,465,3,3,0,1,0
9,492,492,80,16,64,3,2

13,109,109,1,1,0,1,0
2,126,126,36,8,28,3,2
15,186,186,43,9,34,2,1
12,217,217,32,32,0,1,0
4,272,272,124,16,108,4,3
17,274,274,33,18,15,2,1
7,317,317,1,1,0,1,0
14,329,329,1,1,0,1,0
5,348,348,55,24,31,2,1
9,350,350,14,6,8,3,2
0,350,350,6,6,0,1,0
6,359,359,26,21,5,2,1
1,365,365,178,157,21,2,1
10,397,397,2,2,0,1,0
11,436,436,202,190,12,2,1
3,471,471,26,11,15,4,3
16,476,476,1,1,0,1,0
8,481,481,30,15,15,2,1

4,120,120,5,5,0,1,0
0,149,149,46,25,21,2,1
6,152,152,3,3,0,1,0
10,156,156,48,12,36,2,1
17,177,177,16,2,14,2,1
1,200,200,28,28,0,1,0
19,203,203,11,11,0,1,0
8,205,205,2,2,0,1,0
2,231,231,21,15,6,3,2
3,235,235,33,18,15,4,3
20,241,241,4,4,0,1,0
13,241,241,14,14,0,1,0
5,266,266,36,2,34,3,2
15,285,285,68,8,60,3,2
22,296,296,27,27,0,1,0
18,322,322,24,6,18,2,1
14,323,323,72,36,36,4,3
16,389,389,19,19,0,1,0
21,406,406,91,91,0,1,0
11,422,422,15,6,9,2,1
23,430,430,38,38,0,1,0
9,437,437,15,1,14,2,1
7,447,447,32,17,15,2,1
12,455,455,36,36,0,1,0

5,113,113,2,2,0,1,0
23,143,143,10,4,6,3,2
4,147,147,13,13,0,1,0
18,165,165,40,12,28,2,1
8,184,184,5,5,0,1,0
17,198,198,25,3,22,4,3
15,229,229,21,21,0,1,0
16,231,231,18,18,0,1,0
19,237,237,21,21,0,1,0
2,245,245,35,5,30,4,3
14,256,256,12,12,0,1,0
12,259,259,43,43,0,1,0
10,300,300,52,4,48,2,1
13,302,302,29,17,12,3,2
22,314,314,6,6,0,1,0
28,320,320,16,16,0,1,0
0,327,327,17,17,0,1,0
7,365,365,20,20,0,1,0
24,365,365,78,58,20,2,1
1,404,404,73,1,72,4,3
11,410,410,33,2,31,2,1
6,413,413,7,7,0,1,0
3,424,424,7,4,3,2,1
27,432,432,51,16,35,2,1
25,452,452,54,54,0,1,0
20,478,478,9,1,8,2,1
26,489,489,25,25,0,1,0
9,491,491,25,25,0,1,0
21,497,497,68,68,0,1,0

12,105,105,6,3,3,2,1
27,124,124,2,2,0,1,0
5,125,125,1,1,0,1,0
19,148,148,2,2,0,1,0
17,148,148,40,11,29,2,1
22,185,185,2,2,0,1,0
24,195,195,2,2,0,1,0
28,206,206,32,32,0,1,0
4,217,217,28,28,0,1,0
13,223,223,11,3,8,3,2
23,273,273,8,8,0,1,0
0,275,275,5,5,0,1,0
10,278,278,23,5,18,4,3
16,303,303,1,1,0,1,0
1,334,334,2,2,0,1,0
7,355,355,19,10,9,2,1
18,372,372,12,3,9,4,3
20,390,390,1,1,0,1,0
14,393,393,22,22,0,1,0
21,413,413,17,17,0,1,0
9,417,417,8,8,0,1,0
2,418,418,79,76,3,2,1
15,427,427,15,4,11,2,1
6,431,431,5,1,4,2,1
29,441,441,53,7,46,3,2
8,443,443,154,102,52,3,2
3,453,453,100,100,0,1,0
26,464,464,12,6,6,3,2
25,479,479,285,195,90,3,2
11,485,485,7,7,0,1,0

18,104,104,7,7,0,1,0
23,133,133,4,4,0,1,0
20,149,149,2,2,0,1,0
6,162,162,16,2,14,2,1
10,165,165,25,2,23,3,2
0,179,179,34,34,0,1,0
1,189,189,2,2,0,1,0
7,206,206,121,121,0,1,0
4,227,227,1,1,0,1,0
16,271,271,4,1,3,2,1
2,281,281,3,3,0,1,0
19,298,298,85,61,24,4,3
8,302,302,29,29,0,1,0
17,315,315,5,2,3,2,1
15,339,339,102,3,99,4,3
21,339,339,53,11,42,3,2
11,346,346,8,8,0,1,0
5,357,357,27,27,0,1,0
13,420,420,125,125,0,1,0
3,421,421,11,11,0,1,0
9,427,427,22,22,0,1,0
14,440,440,11,4,7,2,1
22,450,450,36,28,8,2,1
12,467,467,8,4,4,2,1

9,112,112,1,1,0,1,0
19,116,116,2,2,0,1,0
10,119,119,9,9,0,1,0
22,126,126,16,16,0,1,0
20,131,131,7,1,6,3,2
17,172,172,5,5,0,1,0
11,198,198,14,14,0,1,0
28,207,207,42,12,30,3,2
1,221,221,9,9,0,1,0
6,227,227,35,3,32,3,2
3,238,238,33,4,29,2,1
2,249,249,11,6,5,2,1
0,260,260,5,5,0,1,0
25,260,260,49,4,45,4,3
29,262,262,18,11,7,2,1
21,263,263,29,23,6,3,2
7,268,268,27,9,18,3,2
26,294,294,53,53,0,1,0
27,318,318,36,20,16,3,2
4,340,340,2,2,0,1,0
18,357,357,18,18,0,1,0
13,366,366,8,8,0,1,0
31,377,377,15,15,0,1,0
23,377,377,78,78,0,1,0
30,385,385,1,1,0,1,0
8,396,396,50,17,33,4,3
5,411,411,22,22,0,1,0
16,412,412,44,20,24,4,3
14,443,443,10,10,0,1,0
24,459,459,9,9,0,1,0
12,475,475,37,37,0,1,0
15,477,477,73,31,42,2,1

9,113,113,3,3,0,1,0
4,116,116,1,1,0,1,0
6,122,122,9,9,0,1,0
7,161,161,27,9,18,4,3
13,164,164,35,35,0,1,0
23,166,166,2,2,0,1,0
20,180,180,4,4,0,1,0
22,183,183,9,1,8,3,2
11,183,183,24,3,21,4,3
19,192,192,2,2,0,1,0
12,220,220,3,3,0,1,0
2,234,234,42,38,4,2,1
3,257,257,4,4,0,1,0
8,258,258,44,17,27,4,3
10,259,259,48,30,18,4,3
18,321,321,113,64,49,3,2
1,331,331,56,12,44,3,2
21,380,380,2,2,0,1,0
15,393,393,21,21,0,1,0
0,407,407,32,32,0,1,0
14,437,437,23,23,0,1,0
5,440,440,36,36,0,1,0
24,442,442,140,120,20,2,1
17,465,465,33,13,20,2,1
16,484,484,21,14,7,2,1
25,499,499,65,26,39,4,3

2,124,124,7,7,0,1,0
11,124,124,1,1,0,1,0
3,131,131,40,10,30,2,1
16,132,132,2,2,0,1,0
5,154,154,7,3,4,2,1
14,170,170,1,1,0,1,0
12,183,183,11,2,9,4,3
1,194,194,31,7,24,4,3
8,199,199,38,38,0,1,0
30,249,249,5,5,0,1,0
20,281,281,41,41,0,1,0
22,288,288,27,27,0,1,0
0,293,293,13,5,8,3,2
27,302,302,4,1,3,2,1
31,304,304,6,6,0,1,0
24,324,324,15,9,6,3,2
19,329,329,2,2,0,1,0
7,338,338,3,3,0,1,0
23,340,340,128,38,90,4,3
18,385,385,12,12,0,1,0
26,403,403,24,4,20,3,2
28,418,418,93,71,22,3,2
6,420,420,18,18,0,1,0
17,426,426,1,1,0,1,0
10,430,430,3,3,0,1,0
25,430,430,35,23,12,3,2
9,432,432,34,34,0,1,0
4,461,461,20,20,0,1,0
15,464,464,47,47,0,1,0
29,498,498,61,24,37,2,1
13,499,499,47,41,6,2,1
21,499,499,57,6,51,4,3

24,110,110,2,2,0,1,0
19,121,121,10,10,0,1,0
15,124,124,41,41,0,1,0
5,127,127,13,5,8,2,1
22,134,134,28,28,0,1,0
0,142,142,1,1,0,1,0
29,159,159,11,11,0,1,0
20,164,164,70,70,0,1,0
27,184,184,26,6,20,2,1
9,200,200,5,5,0,1,0
16,220,220,21,21,0,1,0
4,227,227,39,39,0,1,0
30,239,239,5,5,0,1,0
18,240,240,33,33,0,1,0
25,242,242,24,24,0,1,0
1,245,245,12,12,0,1,0
12,259,259,28,11,17,2,1
3,291,291,20,20,0,1,0
11,305,305,7,7,0,1,0
23,307,307,10,5,5,2,1
7,335,335,11,11,0,1,0
21,343,343,19,19,0,1,0
17,367,367,33,13,20,2,1
2,368,368,7,1,6,2,1
8,379,379,10,10,0,1,0
6,383,383,2,2,0,1,0
10,399,399,18,9,9,2,1
14,431,431,13,5,8,2,1
26,462,462,13,13,0,1,0
13,472,472,34,34,0,1,0
28,472,472,7,4,3,2,1

1,105,105,5,5,0,1,0
10,115,115,7,7,0,1,0
26,120,120,20,12,8,2,1
7,122,122,18,18,0,1,0
17,139,139,14,5,9,2,1
28,140,140,24,14,10,3,2
25,160,160,2,2,0,1,0
23,168,168,12,12,0,1,0
2,182,182,1,1,0,1,0
27,185,185,2,2,0,1,0
24,207,207,51,7,44,4,3
4,230,230,5,5,0,1,0
11,230,230,1,1,0,1,0
14,238,238,27,17,10,3,2
29,247,247,16,2,14,3,2
22,276,276,67,67,0,1,0
30,291,291,5,5,0,1,0
16,347,347,8,4,4,2,1
15,368,368,4,4,0,1,0
6,371,371,21,6,15,4,3
8,382,382,55,55,0,1,0
21,387,387,2,2,0,1,0
19,398,398,68,54,14,2,1
13,399,399,14,10,4,2,1
0,400,400,13,13,0,1,0
3,440,440,65,26,39,2,1
12,457,457,69,69,0,1,0
20,460,460,12,12,0,1,0
9,460,460,11,11,0,1,0
5,478,478,86,37,49,2,1
18,485,485,62,62,0,1,0

4,111,111,1,1,0,1,0
3,115,115,24,9,15,2,1
30,115,115,33,18,15,4,3
29,147,147,2,2,0,1,0
13,161,161,7,3,4,2,1
7,169,169,6,6,0,1,0
16,174,174,12,12,0,1,0
8,176,176,1,1,0,1,0
18,182,182,19,13,6,3,2
2,188,188,3,3,0,1,0
12,195,195,38,32,6,3,2
25,195,195,17,17,0,1,0
17,198,198,5,5,0,1,0
1,211,211,6,1,5,2,1
19,211,211,12,12,0,1,0
20,251,251,10,10,0,1,0
6,271,271,3,3,0,1,0
10,274,274,89,80,9,4,3
14,304,304,19,4,15,4,3
9,387,387,44,44,0,1,0
22,389,389,73,53,20,3,2
26,428,428,9,3,6,2,1
24,436,436,2,2,0,1,0
0,440,440,23,13,10,2,1
11,450,450,26,11,15,4,3
5,452,452,9,9,0,1,0
27,452,452,96,96,0,1,0
23,455,455,85,2,83,3,2
15,467,467,12,12,0,1,0
21,481,481,7,3,4,2,1
28,489,489,55,39,16,2,1

17,109,109,20,20,0,1,0
1,135,135,4,1,3,2,1
19,156,156,8,2,6,3,2
16,191,191,22,10,12,2,1
22,214,214,12,12,0,1,0
15,240,240,1,1,0,1,0
25,246,246,14,14,0,1,0
7,249,249,15,15,0,1,0
20,259,259,10,4,6,2,1
11,275,275,24,24,0,1,0
21,310,310,176,136,40,3,2
10,311,311,14,14,0,1,0
18,321,321,19,13,6,3,2
6,339,339,26,2,24,4,3
12,369,369,1,1,0,1,0
5,388,388,28,28,0,1,0
23,388,388,3,3,0,1,0
0,389,389,10,2,8,3,2
4,398,398,35,5,30,2,1
26,404,404,33,26,7,2,1
2,412,412,19,19,0,1,0
9,446,446,10,4,6,2,1
3,448,448,25,1,24,4,3
8,462,462,154,66,88,4,3
14,464,464,24,24,0,1,0
13,467,467,166,147,19,2,1
24,472,472,21,11,10,3,2

7,100,100,5,5,0,1,0
14,110,110,25,11,14,2,1
8,118,118,13,6,7,2,1
10,165,165,18,12,6,2,1
12,177,177,9,9,0,1,0
4,185,185,16,16,0,1,0
13,218,218,100,34,66,4,3
16,221,221,12,2,10,3,2
1,282,282,22,16,6,2,1
2,306,306,31,31,0,1,0
3,351,351,226,226,0,1,0
6,355,355,40,40,0,1,0
5,356,356,13,5,8,2,1
18,380,380,58,28,30,2,1
19,396,396,3,3,0,1,0
11,401,401,17,10,7,2,1
17,403,403,13,13,0,1,0
20,406,406,13,4,9,4,3
0,458,458,38,14,24,2,1
15,475,475,3,3,0,1,0
9,481,481,11,11,0,1,0
21,498,498,66,4,62,3,2

5,105,105,17,17,0,1,0
18,115,115,9,4,5,2,1
15,115,115,6,6,0,1,0
3,119,119,4,4,0,1,0
0,139,139,28,15,13,4,3
11,144,144,7,1,6,3,2
22,153,153,22,3,19,2,1
12,155,155,14,14,0,1,0
26,167,167,22,13,9,4,3
27,174,174,16,16,0,1,0
20,176,176,23,3,20,3,2
16,181,181,5,1,4,2,1
2,185,185,9,9,0,1,0
6,202,202,47,47,0,1,0
13,205,205,3,3,0,1,0
17,218,218,42,42,0,1,0
19,258,258,6,1,5,2,1
1,281,281,12,4,8,3,2
14,310,310,25,19,6,3,2
10,323,323,49,41,8,2,1
9,328,328,1,1,0,1,0
8,366,366,67,34,33,4,3
23,401,401,86,36,50,4,3
7,402,402,2,2,0,1,0
24,443,443,57,57,0,1,0
4,452,452,1,1,0,1,0
21,474,474,41,41,0,1,0
25,497,497,16,16,0,1,0

0,106,106,30,8,22,2,1
14,122,122,7,3,4,2,1
10,174,174,26,26,0,1,0
1,193,193,1,1,0,1,0
8,206,206,55,3,52,3,2
18,212,212,27,27,0,1,0
4,215,215,65,17,48,3,2
11,243,243,21,7,14,3,2
20,259,259,18,18,0,1,0
2,263,263,29,12,17,2,1
15,265,265,27,27,0,1,0
13,313,313,55,22,33,2,1
16,320,320,21,7,14,2,1
19,359,359,11,11,0,1,0
6,364,364,41,41,0,1,0
9,366,366,15,2,13,4,3
17,403,403,75,75,0,1,0
21,433,433,84,84,0,1,0
12,436,436,14,6,8,2,1
7,446,446,22,8,14,2,1
3,470,470,60,50,10,3,2
5,489,489,22,16,6,2,1

29,108,108,3,3,0,1,0
20,128,128,4,4,0,1,0
19,150,150,6,3,3,2,1
6,150,150,51,51,0,1,0
1,158,158,16,16,0,1,0
24,158,158,18,3,15,3,2
10,165,165,5,5,0,1,0
2,174,174,3,3,0,1,0
12,202,202,29,8,21,4,3
0,206,206,4,4,0,1,0
25,215,215,20,20,0,1,0
26,220,220,43,7,36,3,2
22,238,238,8,8,0,1,0
4,268,268,7,7,0,1,0
15,302,302,26,20,6,2,1
7,328,328,3,3,0,1,0
30,347,347,63,63,0,1,0
16,383,383,18,7,11,4,3
3,388,388,23,23,0,1,0
17,412,412,9,3,6,2,1
23,414,414,11,11,0,1,0
27,438,438,42,12,30,4,3
14,447,447,12,12,0,1,0
18,448,448,11,11,0,1,0
13,451,451,22,2,20,4,3
9,455,455,55,41,14,4,3
28,459,459,98,61,37,2,1
21,464,464,22,4,18,2,1
8,465,465,5,5,0,1,0
11,469,469,54,9,45,4,3
5,478,478,25,16,9,2,1
31,492,492,114,102,12,4,3

18,110,110,16,1,15,4,3
14,131,131,5,5,0,1,0
19,169,169,8,8,0,1,0
12,175,175,2,2,0,1,0
13,188,188,41,1,40,2,1
9,246,246,71,29,42,4,3
17,250,250,42,26,16,2,1
6,291,291,112,112,0,1,0
15,323,323,40,7,33,4,3
20,350,350,39,39,0,1,0
0,362,362,74,48,26,2,1
2,372,372,118,75,43,4,3
5,412,412,24,5,19,2,1
16,418,418,5,5,0,1,0
3,447,447,2,2,0,1,0
11,449,449,24,24,0,1,0
4,467,467,12,3,9,2,1
21,468,468,26,3,23,3,2
8,478,478,103,103,0,1,0
1,486,486,10,1,9,2,1
10,487,487,29,1,28,4,3
7,495,495,35,35,0,1,0

17,123,123,8,8,0,1,0
15,128,128,3,3,0,1,0
8,134,134,2,2,0,1,0
20,147,147,4,4,0,1,0
18,177,177,32,32,0,1,0
23,183,183,57,19,38,2,1
1,199,199,25,5,20,3,2
12,246,246,31,31,0,1,0
9,263,263,2,2,0,1,0
0,266,266,23,23,0,1,0
3,285,285,1,1,0,1,0
22,312,312,56,56,0,1,0
21,331,331,1,1,0,1,0
4,375,375,43,43,0,1,0
11,380,380,24,5,19,2,1
7,386,386,68,68,0,1,0
24,387,387,13,13,0,1,0
2,396,396,3,3,0,1,0
10,399,399,66,66,0,1,0
16,416,416,63,56,7,2,1
6,427,427,127,100,27,4,3
5,451,451,52,24,28,4,3
13,454,454,17,2,15,4,3
14,454,454,25,20,5,2,1
25,458,458,107,80,27,2,1
19,494,494,14,14,0,1,0

21,119,119,2,2,0,1,0
10,124,124,3,3,0,1,0
7,149,149,26,26,0,1,0
19,154,154,30,19,11,2,1
5,158,158,11,8,3,2,1
17,229,229,12,3,9,4,3
1,268,268,9,4,5,2,1
0,269,269,6,2,4,2,1
6,281,281,61,61,0,1,0
8,290,290,57,48,9,4,3
22,319,319,14,14,0,1,0
18,361,361,6,3,3,2,1
12,362,362,87,87,0,1,0
16,383,383,53,17,36,2,1
3,392,392,116,58,58,3,2
2,392,392,57,12,45,4,3
4,431,431,53,29,24,4,3
14,438,438,99,5,94,3,2
11,440,440,48,48,0,1,0
13,460,460,63,36,27,2,1
9,460,460,11,11,0,1,0
15,481,481,49,49,0,1,0
20,488,488,10,10,0,1,0

2,100,100,3,3,0,1,0
14,163,163,26,10,16,2,1
3,165,165,29,29,0,1,0
20,231,231,2,2,0,1,0
10,233,233,8,2,6,3,2
5,242,242,92,92,0,1,0
4,261,261,7,7,0,1,0
17,343,343,60,60,0,1,0
12,359,359,62,62,0,1,0
11,370,370,37,37,0,1,0
0,377,377,5,5,0,1,0
1,388,388,7,7,0,1,0
21,393,393,47,47,0,1,0
22,396,396,26,9,17,2,1
7,402,402,62,14,48,4,3
15,409,409,1,1,0,1,0
8,446,446,72,43,29,3,2
23,451,451,5,5,0,1,0
6,455,455,73,73,0,1,0
9,466,466,69,22,47,4,3
19,468,468,33,33,0,1,0
16,473,473,6,6,0,1,0
18,483,483,137,137,0,1,0
13,486,486,66,14,52,3,2

0,100,100,6,6,0,1,0
3,120,120,19,19,0,1,0
24,127,127,18,18,0,1,0
20,137,137,31,31,0,1,0
19,176,176,5,5,0,1,0
5,195,195,6,2,4,2,1
14,206,206,25,1,24,4,3
10,212,212,70,56,14,3,2
4,219,219,29,11,18,4,3
22,220,220,6,6,0,1,0
25,244,244,45,45,0,1,0
17,282,282,35,35,0,1,0
18,282,282,15,15,0,1,0
23,297,297,16,16,0,1,0
7,319,319,77,77,0,1,0
1,342,342,21,1,20,3,2
15,343,343,60,60,0,1,0
6,368,368,1,1,0,1,0
12,393,393,9,9,0,1,0
2,410,410,31,15,16,3,2
11,412,412,17,8,9,4,3
21,438,438,42,18,24,4,3
13,461,461,35,35,0,1,0
9,465,465,28,23,5,2,1
8,469,469,39,39,0,1,0
16,498,498,10,10,0,1,0

19,131,131,3,3,0,1,0
29,131,131,16,2,14,3,2
15,157,157,1,1,0,1,0
1,162,162,10,7,3,2,1
17,184,184,83,15,68,4,3
8,185,185,1,1,0,1,0
22,185,185,6,1,5,2,1
9,186,186,46,46,0,1,0
6,193,193,4,4,0,1,0
25,195,195,29,29,0,1,0
10,219,219,6,1,5,2,1
11,224,224,35,35,0,1,0
16,239,239,3,3,0,1,0
23,241,241,19,19,0,1,0
20,247,247,23,23,0,1,0
14,256,256,22,22,0,1,0
21,280,280,19,12,7,2,1
3,286,286,2,2,0,1,0
18,296,296,10,10,0,1,0
28,329,329,5,1,4,2,1
24,336,336,17,13,4,2,1
12,376,376,19,7,12,4,3
2,382,382,8,8,0,1,0
0,399,399,111,75,36,2,1
5,417,417,3,3,0,1,0
4,435,435,13,10,3,2,1
26,455,455,76,8,68,3,2
7,457,457,105,72,33,4,3
13,477,477,27,27,0,1,0
27,490,490,24,17,7,2,1

18,101,101,5,5,0,1,0
3,108,108,3,3,0,1,0
15,111,111,6,2,4,2,1
11,141,141,11,8,3,2,1
9,192,192,68,68,0,1,0
17,195,195,3,3,0,1,0
22,206,206,1,1,0,1,0
21,238,238,6,6,0,1,0
8,244,244,19,19,0,1,0
10,269,269,42,3,39,3,2
7,269,269,18,2,16,4,3
1,298,298,42,20,22,2,1
0,321,321,28,28,0,1,0
2,335,335,85,28,57,4,3
19,353,353,155,122,33,2,1
13,367,367,9,9,0,1,0
6,374,374,9,9,0,1,0
24,381,381,23,3,20,3,2
23,388,388,25,25,0,1,0
16,404,404,157,157,0,1,0
20,415,415,44,44,0,1,0
5,461,461,6,6,0,1,0
12,469,469,42,42,0,1,0
14,489,489,4,4,0,1,0
4,489,489,11,5,6,3,2

26,109,109,24,24,0,1,0
12,113,113,3,3,0,1,0
21,122,122,6,6,0,1,0
22,130,130,27,3,24,4,3
10,135,135,1,1,0,1,0
20,136,136,11,11,0,1,0
5,170,170,1,1,0,1,0
9,175,175,16,2,14,2,1
2,176,176,17,17,0,1,0
17,208,208,13,13,0,1,0
0,212,212,17,17,0,1,0
29,224,224,21,21,0,1,0
6,265,265,10,1,9,2,1
11,267,267,46,13,33,4,3
13,311,311,25,25,0,1,0
19,311,311,39,39,0,1,0
23,345,345,28,12,16,3,2
18,351,351,2,2,0,1,0
28,358,358,10,10,0,1,0
1,359,359,41,41,0,1,0
16,363,363,18,18,0,1,0
7,380,380,18,18,0,1,0
8,391,391,24,13,11,3,2
25,391,391,37,30,7,2,1
24,393,393,22,12,10,3,2
14,401,401,59,23,36,3,2
30,418,418,97,47,50,3,2
15,433,433,6,6,0,1,0
27,438,438,27,11,16,3,2
4,497,497,66,33,33,3,2
3,500,500,38,38,0,1,0

0,105,105,8,1,7,2,1
15,110,110,15,5,10,3,2
7,152,152,14,4,10,3,2
10,172,172,11,1,10,3,2
11,183,183,38,17,21,4,3
14,187,187,14,14,0,1,0
1,189,189,63,63,0,1,0
12,228,228,15,1,14,3,2
6,232,232,1,1,0,1,0
9,264,264,79,5,74,3,2
5,323,323,23,23,0,1,0
8,362,362,28,19,9,2,1
3,366,366,109,37,72,3,2
17,366,366,39,11,28,3,2
4,377,377,110,56,54,4,3
13,396,396,10,10,0,1,0
16,400,400,41,23,18,4,3
2,452,452,137,127,10,2,1

18,110,110,8,8,0,1,0
16,128,128,37,5,32,4,3
3,135,135,34,34,0,1,0
10,161,161,3,3,0,1,0
2,164,164,23,23,0,1,0
14,169,169,4,4,0,1,0
23,186,186,27,17,10,3,2
13,190,190,12,9,3,2,1
22,209,209,5,5,0,1,0
9,213,213,9,9,0,1,0
17,214,214,17,13,4,2,1
5,221,221,10,10,0,1,0
26,237,237,4,4,0,1,0
15,259,259,64,33,31,4,3
27,260,260,5,5,0,1,0
0,332,332,54,36,18,2,1
24,341,341,18,8,10,3,2
1,361,361,45,45,0,1,0
7,364,364,7,1,6,3,2
25,373,373,1,1,0,1,0
19,397,397,77,17,60,3,2
11,414,414,49,49,0,1,0
21,429,429,67,67,0,1,0
4,432,432,45,6,39,2,1
6,436,436,2,2,0,1,0
20,468,468,16,7,9,3,2
8,472,472,6,6,0,1,0
12,483,483,82,82,0,1,0

7,141,141,26,26,0,1,0
9,155,155,6,2,4,2,1
6,165,165,5,5,0,1,0
12,191,191,49,4,45,4,3
16,204,204,6,6,0,1,0
1,276,276,2,2,0,1,0
15,290,290,29,2,27,2,1
5,330,330,15,3,12,4,3
10,342,342,7,2,5,2,1
18,359,359,8,3,5,2,1
13,361,361,3,3,0,1,0
2,394,394,11,8,3,2,1
0,394,394,386,257,129,4,3
14,397,397,18,9,9,4,3
11,426,426,147,99,48,3,2
3,443,443,4,4,0,1,0
8,444,444,40,40,0,1,0
4,480,480,112,25,87,4,3
17,487,487,74,65,9,4,3

0,100,100,15,15,0,1,0
21,101,101,19,5,14,2,1
14,106,106,2,2,0,1,0
10,107,107,20,14,6,2,1
24,113,113,8,8,0,1,0
13,132,132,9,9,0,1,0
26,169,169,6,6,0,1,0
19,201,201,7,2,5,2,1
5,256,256,72,59,13,2,1
20,259,259,12,7,5,2,1
8,271,271,13,13,0,1,0
17,298,298,29,29,0,1,0
12,306,306,8,8,0,1,0
22,312,312,29,29,0,1,0
7,317,317,44,15,29,2,1
16,317,317,102,28,74,3,2
3,319,319,33,21,12,2,1
15,324,324,63,48,15,4,3
4,345,345,17,4,13,2,1
2,345,345,23,23,0,1,0
18,360,360,4,4,0,1,0
11,370,370,11,3,8,3,2
25,392,392,55,34,21,4,3
6,440,440,32,32,0,1,0
1,469,469,33,33,0,1,0
23,470,470,36,33,3,2,1
9,500,500,7,7,0,1,0

10,105,105,10,1,9,4,3
24,127,127,3,3,0,1,0
31,130,130,3,3,0,1,0
11,132,132,18,3,15,4,3
27,143,143,25,13,12,2,1
8,164,164,13,13,0,1,0
15,165,165,20,20,0,1,0
4,216,216,1,1,0,1,0
3,232,232,15,15,0,1,0
30,234,234,45,45,0,1,0
6,236,236,21,21,0,1,0
13,281,281,8,2,6,3,2
32,282,282,19,13,6,2,1
12,285,285,18,6,12,3,2
29,299,299,36,32,4,2,1
23,303,303,9,9,0,1,0
28,321,321,51,8,43,2,1
0,322,322,34,19,15,4,3
19,325,325,18,18,0,1,0
20,339,339,104,104,0,1,0
2,367,367,1,1,0,1,0
1,373,373,23,23,0,1,0
22,404,404,30,6,24,2,1
14,410,410,20,20,0,1,0
16,431,431,21,21,0,1,0
26,443,443,34,12,22,2,1
9,454,454,13,13,0,1,0
18,457,457,1,1,0,1,0
5,462,462,8,8,0,1,0
17,480,480,60,60,0,1,0
7,482,482,59,39,20,2,1
25,487,487,32,32,0,1,0
21,499,499,6,6,0,1,0

10,117,117,8,2,6,3,2
21,125,125,10,10,0,1,0
16,143,143,1,1,0,1,0
15,191,191,18,18,0,1,0
18,203,203,9,4,5,2,1
3,207,207,47,26,21,4,3
13,217,217,30,30,0,1,0
8,227,227,59,42,17,2,1
17,252,252,115,115,0,1,0
1,255,255,18,8,10,2,1
7,266,266,39,21,18,2,1
19,280,280,5,5,0,1,0
20,333,333,48,34,14,3,2
14,345,345,10,3,7,2,1
6,346,346,8,8,0,1,0
0,368,368,61,49,12,2,1
4,384,384,128,45,83,4,3
5,406,406,13,10,3,2,1
9,447,447,46,46,0,1,0
2,452,452,19,19,0,1,0
12,472,472,67,10,57,4,3
11,474,474,6,6,0,1,0

14,101,101,12,12,0,1,0
28,104,104,20,6,14,3,2
18,109,109,5,5,0,1,0
30,143,143,12,12,0,1,0
15,182,182,32,27,5,2,1
2,182,182,1,1,0,1,0
4,185,185,21,21,0,1,0
29,191,191,1,1,0,1,0
25,202,202,6,6,0,1,0
31,203,203,25,13,12,3,2
21,234,234,7,1,6,2,1
1,249,249,7,7,0,1,0
8,256,256,38,38,0,1,0
5,272,272,5,2,3,2,1
22,305,305,13,13,0,1,0
32,309,309,7,7,0,1,0
16,312,312,3,3,0,1,0
24,326,326,31,7,24,3,2
33,344,344,148,86,62,4,3
11,351,351,4,4,0,1,0
0,413,413,8,8,0,1,0
13,414,414,11,11,0,1,0
27,421,421,56,56,0,1,0
3,430,430,71,66,5,2,1
20,434,434,17,2,15,2,1
7,440,440,37,37,0,1,0
9,448,448,3,3,0,1,0
10,450,450,23,23,0,1,0
23,453,453,6,6,0,1,0
12,476,476,56,13,43,4,3
17,479,479,21,21,0,1,0
6,483,483,12,12,0,1,0
26,483,483,62,17,45,2,1
19,497,497,24,24,0,1,0

21,108,108,5,5,0,1,0
3,110,110,3,3,0,1,0
23,139,139,4,4,0,1,0
28,150,150,11,2,9,2,1
30,160,160,11,2,9,4,3
4,179,179,18,18,0,1,0
5,182,182,6,6,0,1,0
14,190,190,3,3,0,1,0
22,258,258,13,13,0,1,0
8,265,265,6,3,3,2,1
2,286,286,28,10,18,2,1
26,289,289,8,5,3,2,1
17,293,293,14,14,0,1,0
0,304,304,13,13,0,1,0
12,305,305,26,26,0,1,0
29,316,316,70,55,15,2,1
6,328,328,1,1,0,1,0
31,335,335,97,88,9,4,3
7,364,364,56,28,28,3,2
9,382,382,100,100,0,1,0
20,392,392,12,12,0,1,0
25,419,419,80,80,0,1,0
27,421,421,2,2,0,1,0
15,437,437,9,9,0,1,0
16,440,440,22,22,0,1,0
10,441,441,4,4,0,1,0
18,453,453,29,2,27,4,3
19,463,463,111,62,49,4,3
11,466,466,14,14,0,1,0
24,473,473,29,29,0,1,0
1,485,485,71,42,29,4,3
13,494,494,44,15,29,2,1

14,154,154,16,16,0,1,0
5,193,193,4,4,0,1,0
7,201,201,19,5,14,3,2
15,205,205,31,1,30,4,3
9,233,233,21,21,0,1,0
19,244,244,8,3,5,2,1
10,262,262,64,64,0,1,0
16,264,264,82,82,0,1,0
2,267,267,11,11,0,1,0
6,276,276,133,78,55,4,3
11,284,284,9,9,0,1,0
12,293,293,7,7,0,1,0
0,303,303,1,1,0,1,0
3,356,356,20,2,18,4,3
18,367,367,12,7,5,2,1
17,372,372,5,1,4,2,1
4,387,387,217,153,64,3,2
1,400,400,55,9,46,2,1
13,411,411,32,32,0,1,0
8,478,478,58,58,0,1,0

11,106,106,1,1,0,1,0
29,108,108,31,7,24,2,1
15,126,126,10,7,3,2,1
22,127,127,1,1,0,1,0
26,130,130,30,13,17,3,2
30,143,143,9,5,4,2,1
24,150,150,1,1,0,1,0
5,178,178,1,1,0,1,0
21,182,182,17,13,4,2,1
13,212,212,9,9,0,1,0
6,220,220,11,5,6,3,2
17,281,281,10,7,3,2,1
0,310,310,34,16,18,3,2
2,327,327,53,53,0,1,0
25,350,350,39,28,11,2,1
10,358,358,2,2,0,1,0
28,359,359,29,3,26,4,3
23,365,365,73,16,57,4,3
3,370,370,3,3,0,1,0
14,371,371,9,9,0,1,0
8,376,376,44,44,0,1,0
7,400,400,1,1,0,1,0
9,408,408,74,35,39,4,3
27,424,424,10,10,0,1,0
20,427,427,9,9,0,1,0
16,436,436,87,87,0,1,0
4,468,468,36,28,8,3,2
12,469,469,57,57,0,1,0
19,469,469,88,16,72,3,2
1,481,481,13,13,0,1,0
31,492,492,7,7,0,1,0
18,496,496,21,21,0,1,0

21,125,125,37,18,19,2,1
10,138,138,6,6,0,1,0
12,156,156,2,2,0,1,0
2,168,168,11,11,0,1,0
4,171,171,26,26,0,1,0
24,173,173,4,4,0,1,0
17,212,212,25,1,24,3,2
3,259,259,26,3,23,2,1
7,287,287,47,21,26,3,2
25,300,300,19,7,12,3,2
18,302,302,7,7,0,1,0
6,322,322,19,19,0,1,0
14,331,331,12,2,10,2,1
11,373,373,12,6,6,3,2
8,392,392,63,21,42,4,3
9,417,417,35,35,0,1,0
22,449,449,18,18,0,1,0
0,451,451,75,30,45,4,3
23,453,453,11,11,0,1,0
26,459,459,11,1,10,2,1
16,459,459,207,147,60,4,3
15,468,468,46,6,40,2,1
19,472,472,6,2,4,2,1
20,475,475,52,52,0,1,0
5,484,484,24,24,0,1,0
13,499,499,67,67,0,1,0
1,500,500,39,34,5,2,1

28,102,102,9,9,0,1,0
31,116,116,38,2,36,2,1
22,120,120,8,4,4,2,1
21,133,133,9,9,0,1,0
8,171,171,3,3,0,1,0
6,173,173,29,24,5,2,1
15,178,178,1,1,0,1,0
16,200,200,20,20,0,1,0
24,227,227,47,32,15,4,3
0,239,239,2,2,0,1,0
18,282,282,7,3,4,2,1
11,284,284,20,20,0,1,0
5,290,290,37,37,0,1,0
26,293,293,14,14,0,1,0
30,300,300,11,11,0,1,0
29,301,301,20,6,14,2,1
20,305,305,72,72,0,1,0
14,309,309,39,39,0,1,0
25,351,351,2,2,0,1,0
27,365,365,19,2,17,2,1
12,392,392,32,2,30,2,1
9,394,394,9,9,0,1,0
4,397,397,32,4,28,2,1
3,398,398,1,1,0,1,0
7,404,404,4,4,0,1,0
23,429,429,19,19,0,1,0
10,429,429,10,10,0,1,0
2,441,441,40,29,11,2,1
19,464,464,40,10,30,4,3
17,465,465,103,94,9,4,3
13,479,479,56,33,23,2,1
1,500,500,1,1,0,1,0

20,116,116,8,8,0,1,0
13,120,120,1,1,0,1,0
3,121,121,24,6,18,4,3
17,176,176,29,29,0,1,0
5,221,221,11,11,0,1,0
16,222,222,37,1,36,4,3
2,224,224,45,9,36,4,3
19,248,248,66,54,12,2,1
9,251,251,11,1,10,3,2
11,254,254,29,16,13,2,1
4,302,302,27,18,9,4,3
12,314,314,22,16,6,2,1
1,334,334,14,1,13,3,2
7,335,335,21,2,19,2,1
0,341,341,42,42,0,1,0
15,361,361,38,13,25,2,1
23,422,422,25,7,18,3,2
14,426,426,14,14,0,1,0
8,444,444,123,111,12,3,2
10,453,453,46,4,42,3,2
6,454,454,51,6,45,2,1
18,455,455,2,2,0,1,0
22,472,472,33,33,0,1,0
21,494,494,98,98,0,1,0

3,108,108,38,27,11,2,1
0,118,118,1,1,0,1,0
9,146,146,3,3,0,1,0
5,168,168,3,3,0,1,0
22,170,170,12,4,8,2,1
24,179,179,37,18,19,4,3
16,182,182,12,12,0,1,0
2,247,247,42,42,0,1,0
12,250,250,26,15,11,2,1
17,273,273,6,6,0,1,0
20,276,276,29,29,0,1,0
11,303,303,3,3,0,1,0
25,310,310,6,6,0,1,0
13,313,313,14,14,0,1,0
7,318,318,62,62,0,1,0
19,331,331,11,11,0,1,0
23,341,341,25,25,0,1,0
14,347,347,27,4,23,2,1
8,359,359,6,6,0,1,0
6,362,362,60,24,36,2,1
1,384,384,21,8,13,3,2
4,386,386,16,6,10,2,1
18,386,386,97,61,36,2,1
21,394,394,61,61,0,1,0
10,397,397,40,22,18,3,2
26,425,425,46,46,0,1,0
15,435,435,59,43,16,3,2

5,133,133,19,10,9,4,3
21,134,134,14,14,0,1,0
15,150,150,8,2,6,2,1
20,180,180,17,17,0,1,0
22,201,201,13,13,0,1,0
7,216,216,12,1,11,2,1
11,220,220,7,7,0,1,0
1,223,223,23,23,0,1,0
10,252,252,13,3,10,3,2
3,252,252,44,28,16,4,3
13,297,297,47,47,0,1,0
24,308,308,71,7,64,3,2
0,310,310,25,25,0,1,0
25,314,314,16,16,0,1,0
23,320,320,35,27,8,2,1
4,324,324,60,22,38,2,1
6,325,325,14,4,10,3,2
8,327,327,16,16,0,1,0
27,330,330,19,19,0,1,0
2,351,351,12,12,0,1,0
26,397,397,53,3,50,3,2
17,408,408,127,127,0,1,0
16,416,416,9,9,0,1,0
18,421,421,13,13,0,1,0
9,441,441,31,13,18,3,2
14,442,442,11,11,0,1,0
19,456,456,28,10,18,3,2
12,462,462,44,44,0,1,0

18,101,101,4,4,0,1,0
21,166,166,9,9,0,1,0
4,204,204,37,37,0,1,0
13,225,225,33,33,0,1,0
20,279,279,3,3,0,1,0
8,284,284,149,144,5,2,1
15,301,301,37,37,0,1,0
6,302,302,1,1,0,1,0
9,321,321,6,6,0,1,0
5,338,338,14,6,8,2,1
0,342,342,90,63,27,2,1
11,348,348,76,13,63,4,3
17,358,358,27,9,18,2,1
10,365,365,77,77,0,1,0
7,373,373,5,5,0,1,0
1,393,393,1,1,0,1,0
14,393,393,23,20,3,2,1
12,399,399,28,2,26,3,2
2,402,402,10,5,5,2,1
16,430,430,15,15,0,1,0
19,485,485,77,77,0,1,0
22,486,486,30,11,19,2,1
23,488,488,130,45,85,4,3
3,499,499,8,8,0,1,0

2,120,120,17,2,15,4,3
10,155,155,18,7,11,2,1
3,164,164,32,32,0,1,0
7,179,179,22,8,14,3,2
19,208,208,14,14,0,1,0
17,222,222,32,22,10,2,1
9,262,262,32,17,15,4,3
25,265,265,1,1,0,1,0
24,270,270,105,93,12,4,3
21,270,270,11,11,0,1,0
23,287,287,5,1,4,2,1
20,297,297,18,18,0,1,0
5,307,307,5,5,0,1,0
14,352,352,13,13,0,1,0
0,382,382,25,25,0,1,0
4,390,390,18,18,0,1,0
6,392,392,8,2,6,2,1
15,392,392,24,24,0,1,0
8,401,401,49,22,27,3,2
1,417,417,115,102,13,2,1
13,425,425,101,101,0,1,0
12,453,453,15,3,12,3,2
18,469,469,24,24,0,1,0
11,470,470,11,11,0,1,0
22,478,478,70,20,50,2,1
16,482,482,29,3,26,3,2

17,100,100,15,15,0,1,0
11,106,106,29,2,27,4,3
10,112,112,14,14,0,1,0
20,141,141,6,6,0,1,0
22,183,183,22,22,0,1,0
8,226,226,61,49,12,2,1
3,263,263,52,28,24,4,3
13,268,268,23,23,0,1,0
0,285,285,39,39,0,1,0
19,289,289,7,3,4,2,1
7,293,293,33,33,0,1,0
21,294,294,4,4,0,1,0
18,341,341,45,30,15,2,1
4,348,348,68,59,9,4,3
6,373,373,14,5,9,4,3
9,375,375,20,20,0,1,0
12,384,384,18,18,0,1,0
15,433,433,120,81,39,4,3
14,433,433,15,2,13,2,1
16,443,443,1,1,0,1,0
5,450,450,28,5,23,2,1
2,473,473,69,49,20,2,1
1,473,473,42,36,6,3,2

7,103,103,8,8,0,1,0
23,122,122,10,10,0,1,0
12,133,133,33,18,15,2,1
21,146,146,25,25,0,1,0
22,174,174,1,1,0,1,0
16,193,193,7,3,4,2,1
5,209,209,35,5,30,4,3
17,226,226,20,13,7,2,1
9,227,227,14,14,0,1,0
24,236,236,51,1,50,3,2
10,250,250,1,1,0,1,0
4,266,266,19,19,0,1,0
3,273,273,22,2,20,4,3
0,282,282,4,4,0,1,0
13,289,289,30,8,22,3,2
14,345,345,33,33,0,1,0
1,382,382,26,26,0,1,0
20,387,387,21,3,18,4,3
2,409,409,10,4,6,2,1
8,417,417,18,18,0,1,0
6,418,418,153,11,142,4,3
11,434,434,32,22,10,3,2
25,442,442,2,2,0,1,0
18,472,472,3,3,0,1,0
19,474,474,149,111,38,3,2
15,493,493,75,75,0,1,0

2,145,145,4,4,0,1,0
23,159,159,11,11,0,1,0
20,166,166,6,1,5,2,1
12,219,219,10,10,0,1,0
19,247,247,72,68,4,2,1
4,249,249,3,3,0,1,0
11,260,260,32,15,17,4,3
16,281,281,48,3,45,4,3
24,287,287,69,69,0,1,0
7,313,313,6,6,0,1,0
9,322,322,70,70,0,1,0
21,323,323,23,23,0,1,0
5,335,335,21,21,0,1,0
17,337,337,23,14,9,2,1
18,339,339,11,11,0,1,0
8,340,340,69,20,49,2,1
3,347,347,9,5,4,2,1
14,355,355,39,26,13,2,1
13,370,370,9,4,5,2,1
6,409,409,91,19,72,4,3
22,410,410,4,4,0,1,0
0,411,411,59,25,34,3,2
10,434,434,8,8,0,1,0
1,444,444,100,100,0,1,0
15,458,458,72,14,58,4,3

31,100,100,6,6,0,1,0
24,113,113,5,5,0,1,0
6,121,121,1,1,0,1,0
8,154,154,24,5,19,3,2
25,177,177,7,7,0,1,0
17,195,195,1,1,0,1,0
16,223,223,44,44,0,1,0
26,266,266,43,18,25,4,3
20,275,275,64,37,27,4,3
10,277,277,21,21,0,1,0
29,287,287,4,1,3,2,1
1,297,297,7,7,0,1,0
22,306,306,108,24,84,4,3
13,326,326,15,3,12,3,2
4,340,340,12,12,0,1,0
0,346,346,24,24,0,1,0
7,358,358,1,1,0,1,0
19,358,358,26,26,0,1,0
30,367,367,22,22,0,1,0
12,384,384,30,22,8,3,2
5,392,392,38,38,0,1,0
23,398,398,16,2,14,3,2
15,407,407,8,2,6,2,1
2,411,411,15,7,8,3,2
18,420,420,36,4,32,3,2
27,436,436,28,28,0,1,0
14,439,439,75,25,50,3,2
9,440,440,27,5,22,2,1
3,452,452,6,6,0,1,0
28,460,460,52,28,24,4,3
11,476,476,23,8,15,2,1
32,488,488,20,20,0,1,0
21,491,491,50,35,15,4,3

11,103,103,8,2,6,3,2
3,127,127,4,4,0,1,0
20,142,142,19,19,0,1,0
17,158,158,24,24,0,1,0
16,168,168,8,4,4,2,1
23,180,180,2,2,0,1,0
22,228,228,9,9,0,1,0
21,251,251,20,20,0,1,0
24,289,289,46,18,28,2,1
2,296,296,24,18,6,2,1
18,305,305,23,3,20,2,1
8,306,306,56,30,26,3,2
0,337,337,113,109,4,2,1
13,350,350,21,21,0,1,0
10,368,368,29,29,0,1,0
7,395,395,3,3,0,1,0
14,398,398,33,33,0,1,0
19,407,407,49,49,0,1,0
6,416,416,60,12,48,4,3
1,423,423,6,1,5,2,1
4,439,439,10,10,0,1,0
15,455,455,139,121,18,4,3
9,461,461,9,9,0,1,0
12,491,491,28,7,21,4,3
5,495,495,153,127,26,2,1

22,136,136,15,15,0,1,0
32,142,142,1,1,0,1,0
17,142,142,1,1,0,1,0
19,154,154,15,15,0,1,0
15,182,182,8,8,0,1,0
6,197,197,8,8,0,1,0
24,207,207,19,11,8,3,2
1,207,207,4,4,0,1,0
21,208,208,57,22,35,2,1
9,209,209,1,1,0,1,0
14,245,245,27,27,0,1,0
3,247,247,28,28,0,1,0
4,259,259,3,3,0,1,0
5,266,266,5,5,0,1,0
23,270,270,104,104,0,1,0
12,274,274,38,38,0,1,0
18,289,289,28,3,25,3,2
11,302,302,42,31,11,2,1
27,314,314,29,13,16,2,1
13,326,326,4,4,0,1,0
28,327,327,51,35,16,2,1
26,329,329,10,10,0,1,0
2,342,342,1,1,0,1,0
30,352,352,7,7,0,1,0
33,363,363,13,13,0,1,0
29,366,366,20,3,17,2,1
20,371,371,30,6,24,2,1
25,391,391,17,4,13,3,2
0,396,396,57,21,36,2,1
16,398,398,34,7,27,2,1
8,423,423,1,1,0,1,0
31,432,432,9,9,0,1,0
10,450,450,37,4,33,4,3
7,482,482,24,24,0,1,0

17,103,103,9,3,6,2,1
21,110,110,19,19,0,1,0
9,124,124,1,1,0,1,0
25,125,125,32,4,28,3,2
10,135,135,9,5,4,2,1
13,139,139,7,7,0,1,0
5,141,141,25,13,12,2,1
14,151,151,14,14,0,1,0
26,161,161,27,27,0,1,0
4,172,172,4,4,0,1,0
29,177,177,1,1,0,1,0
12,233,233,8,8,0,1,0
20,245,245,1,1,0,1,0
23,250,250,16,16,0,1,0
31,260,260,30,19,11,2,1
15,268,268,5,5,0,1,0
7,297,297,8,8,0,1,0
6,301,301,20,16,4,2,1
28,318,318,38,15,23,3,2
30,322,322,8,3,5,2,1
8,324,324,17,7,10,3,2
0,339,339,50,16,34,2,1
3,346,346,20,20,0,1,0
24,358,358,32,32,0,1,0
16,360,360,4,4,0,1,0
11,373,373,3,3,0,1,0
27,379,379,33,26,7,2,1
19,410,410,70,18,52,3,2
18,464,464,85,85,0,1,0
22,468,468,27,27,0,1,0
2,472,472,25,17,8,2,1
1,492,492,67,2,65,3,2

18,107,107,27,15,12,4,3
21,142,142,3,3,0,1,0
6,148,148,6,6,0,1,0
12,153,153,42,27,15,4,3
13,160,160,8,2,6,3,2
9,169,169,51,11,40,4,3
10,171,171,8,8,0,1,0
25,194,194,22,8,14,3,2
24,194,194,33,5,28,3,2
11,216,216,6,1,5,2,1
2,217,217,26,8,18,4,3
7,254,254,12,2,10,3,2
22,260,260,4,4,0,1,0
27,263,263,25,1,24,3,2
20,267,267,46,31,15,4,3
8,301,301,26,6,20,3,2
17,323,323,7,7,0,1,0
15,378,378,14,14,0,1,0
1,396,396,7,7,0,1,0
4,401,401,17,17,0,1,0
3,424,424,43,43,0,1,0
5,442,442,42,28,14,2,1
16,445,445,21,11,10,3,2
14,446,446,4,1,3,2,1
26,453,453,55,55,0,1,0
23,478,478,2,2,0,1,0
0,492,492,20,11,9,2,1
19,497,497,130,16,114,4,3

15,112,112,7,1,6,3,2
8,177,177,31,7,24,2,1
13,189,189,6,6,0,1,0
23,196,196,9,9,0,1,0
10,216,216,2,2,0,1,0
14,259,259,65,65,0,1,0
2,262,262,51,6,45,4,3
18,262,262,12,12,0,1,0
21,308,308,25,25,0,1,0
11,331,331,17,17,0,1,0
17,342,342,11,11,0,1,0
16,359,359,10,5,5,2,1
20,364,364,107,103,4,2,1
1,380,380,18,18,0,1,0
22,385,385,90,90,0,1,0
25,391,391,47,47,0,1,0
7,393,393,58,58,0,1,0
12,402,402,77,55,22,2,1
6,406,406,34,34,0,1,0
24,420,420,13,3,10,2,1
19,435,435,30,13,17,4,3
9,451,451,11,11,0,1,0
0,453,453,25,25,0,1,0
5,465,465,94,76,18,4,3
3,478,478,51,51,0,1,0
4,489,489,6,6,0,1,0

12,100,100,4,4,0,1,0
5,104,104,4,4,0,1,0
1,106,106,10,10,0,1,0
30,108,108,17,17,0,1,0
23,114,114,18,6,12,2,1
24,123,123,19,19,0,1,0
28,132,132,13,4,9,2,1
15,145,145,1,1,0,1,0
10,153,153,1,1,0,1,0
22,166,166,2,2,0,1,0
16,170,170,11,11,0,1,0
6,170,170,8,5,3,2,1
13,172,172,31,21,10,3,2
3,173,173,13,3,10,3,2
20,175,175,48,44,4,2,1
11,180,180,1,1,0,1,0
14,209,209,1,1,0,1,0
9,247,247,6,1,5,2,1
21,252,252,11,11,0,1,0
4,259,259,36,36,0,1,0
27,260,260,8,8,0,1,0
7,299,299,131,83,48,4,3
26,305,305,43,18,25,2,1
17,318,318,11,3,8,2,1
2,353,353,8,8,0,1,0
25,396,396,17,17,0,1,0
0,411,411,2,2,0,1,0
18,427,427,1,1,0,1,0
29,439,439,70,12,58,3,2
19,455,455,33,33,0,1,0
8,494,494,37,37,0,1,0

5,101,101,24,12,12,4,3
22,113,113,6,1,5,2,1
24,123,123,11,11,0,1,0
23,135,135,26,26,0,1,0
25,148,148,19,10,9,2,1
6,182,182,12,1,11,2,1
9,184,184,5,5,0,1,0
0,196,196,1,1,0,1,0
17,209,209,4,4,0,1,0
21,222,222,26,26,0,1,0
7,228,228,18,18,0,1,0
3,261,261,53,32,21,2,1
11,275,275,1,1,0,1,0
18,303,303,71,45,26,3,2
26,308,308,17,17,0,1,0
8,313,313,22,22,0,1,0
14,323,323,9,5,4,2,1
10,326,326,12,2,10,2,1
12,368,368,31,21,10,3,2
15,380,380,2,2,0,1,0
19,410,410,8,8,0,1,0
13,424,424,132,120,12,4,3
27,432,432,57,57,0,1,0
20,432,432,103,50,53,4,3
1,432,432,17,7,10,3,2
2,444,444,25,9,16,3,2
4,478,478,26,26,0,1,0
16,496,496,26,26,0,1,0

30,106,106,8,8,0,1,0
9,110,110,11,4,7,2,1
14,119,119,16,2,14,2,1
8,123,123,3,3,0,1,0
3,177,177,26,14,12,3,2
21,204,204,4,4,0,1,0
7,207,207,12,12,0,1,0
15,253,253,12,12,0,1,0
31,258,258,115,71,44,3,2
12,268,268,29,1,28,4,3
25,270,270,23,17,6,3,2
13,290,290,25,25,0,1,0
22,309,309,10,3,7,2,1
28,317,317,10,10,0,1,0
27,319,319,28,7,21,2,1
16,324,324,3,3,0,1,0
1,325,325,29,29,0,1,0
19,329,329,23,23,0,1,0
6,343,343,2,2,0,1,0
4,366,366,3,3,0,1,0
17,370,370,41,41,0,1,0
23,389,389,18,7,11,2,1
20,395,395,14,2,12,4,3
10,397,397,1,1,0,1,0
18,399,399,50,45,5,2,1
0,418,418,8,8,0,1,0
5,420,420,43,21,22,4,3
26,426,426,27,15,12,3,2
11,429,429,37,37,0,1,0
2,449,449,17,9,8,3,2
24,462,462,61,61,0,1,0
29,472,472,98,98,0,1,0

16,144,144,43,7,36,3,2
4,144,144,14,4,10,3,2
5,181,181,10,5,5,2,1
24,181,181,9,5,4,2,1
12,182,182,35,35,0,1,0
18,193,193,25,25,0,1,0
21,229,229,68,20,48,3,2
20,229,229,10,10,0,1,0
17,272,272,52,4,48,3,2
10,282,282,26,26,0,1,0
6,284,284,19,11,8,2,1
22,315,315,22,16,6,3,2
15,327,327,1,1,0,1,0
8,331,331,17,17,0,1,0
25,333,333,8,8,0,1,0
13,338,338,9,2,7,2,1
11,346,346,4,4,0,1,0
23,359,359,29,7,22,2,1
19,411,411,4,4,0,1,0
7,424,424,140,140,0,1,0
14,428,428,41,41,0,1,0
3,434,434,1,1,0,1,0
1,442,442,26,7,19,4,3
9,461,461,101,13,88,3,2
0,491,491,32,32,0,1,0
2,496,496,30,30,0,1,0

16,105,105,3,3,0,1,0
21,133,133,2,2,0,1,0
2,148,148,1,1,0,1,0
13,149,149,15,15,0,1,0
12,170,170,2,2,0,1,0
11,171,171,2,2,0,1,0
26,175,175,11,11,0,1,0
25,175,175,19,19,0,1,0
18,187,187,54,54,0,1,0
22,216,216,3,3,0,1,0
6,241,241,5,1,4,2,1
24,256,256,13,13,0,1,0
0,276,276,45,31,14,3,2
9,299,299,48,48,0,1,0
17,305,305,51,18,33,2,1
1,311,311,14,2,12,2,1
15,320,320,4,1,3,2,1
5,331,331,10,10,0,1,0
20,336,336,24,2,22,2,1
4,375,375,34,34,0,1,0
8,375,375,38,14,24,3,2
23,399,399,141,46,95,4,3
10,409,409,52,52,0,1,0
14,425,425,1,1,0,1,0
19,439,439,12,12,0,1,0
3,439,439,50,50,0,1,0
27,444,444,57,12,45,4,3
7,466,466,147,89,58,3,2

4,104,104,32,32,0,1,0
11,105,105,22,22,0,1,0
9,127,127,8,8,0,1,0
19,134,134,10,5,5,2,1
12,144,144,31,13,18,4,3
5,146,146,15,8,7,2,1
15,181,181,14,10,4,2,1
7,189,189,3,3,0,1,0
14,212,212,27,27,0,1,0
2,224,224,18,18,0,1,0
13,224,224,3,3,0,1,0
1,228,228,55,31,24,4,3
16,235,235,30,20,10,2,1
6,275,275,10,2,8,3,2
3,319,319,166,116,50,2,1
17,332,332,14,14,0,1,0
8,439,439,59,37,22,3,2
10,446,446,76,76,0,1,0
18,479,479,30,8,22,2,1
0,493,493,6,3,3,2,1

12,104,104,10,2,8,2,1
4,111,111,17,17,0,1,0
21,134,134,8,2,6,2,1
9,135,135,7,7,0,1,0
16,153,153,7,1,6,3,2
19,190,190,14,14,0,1,0
10,193,193,13,13,0,1,0
18,196,196,34,25,9,2,1
26,200,200,6,6,0,1,0
20,219,219,54,54,0,1,0
29,258,258,17,2,15,4,3
23,261,261,63,27,36,4,3
1,268,268,9,9,0,1,0
22,275,275,6,6,0,1,0
14,293,293,10,1,9,4,3
2,293,293,1,1,0,1,0
8,310,310,29,29,0,1,0
0,331,331,9,2,7,2,1
27,358,358,63,63,0,1,0
5,376,376,14,3,11,2,1
6,378,378,57,57,0,1,0
13,382,382,53,8,45,4,3
25,386,386,10,2,8,3,2
15,399,399,3,3,0,1,0
7,412,412,19,19,0,1,0
11,428,428,25,25,0,1,0
17,441,441,35,11,24,3,2
3,461,461,120,58,62,3,2
24,477,477,44,44,0,1,0
28,491,491,21,21,0,1,0

21,101,101,2,2,0,1,0
10,125,125,4,4,0,1,0
22,138,138,6,6,0,1,0
5,147,147,1,1,0,1,0
12,161,161,1,1,0,1,0
11,180,180,10,1,9,2,1
7,195,195,6,6,0,1,0
14,199,199,7,3,4,2,1
0,204,204,22,12,10,3,2
17,212,212,8,8,0,1,0
27,217,217,45,45,0,1,0
13,232,232,9,6,3,2,1
3,240,240,40,35,5,2,1
16,246,246,4,4,0,1,0
28,257,257,15,10,5,2,1
9,272,272,4,1,3,2,1
18,282,282,20,20,0,1,0
26,339,339,8,2,6,2,1
6,341,341,6,6,0,1,0
31,364,364,14,14,0,1,0
1,383,383,42,42,0,1,0
2,399,399,59,59,0,1,0
30,411,411,32,20,12,2,1
15,414,414,76,56,20,4,3
25,433,433,56,56,0,1,0
23,433,433,78,10,68,3,2
8,441,441,71,20,51,4,3
20,445,445,79,79,0,1,0
32,452,452,36,3,33,4,3
24,460,460,67,25,42,4,3
19,467,467,15,15,0,1,0
4,475,475,14,14,0,1,0
29,479,479,65,38,27,4,3

29,115,115,1,1,0,1,0
12,126,126,5,5,0,1,0
19,141,141,6,6,0,1,0
8,146,146,1,1,0,1,0
27,148,148,2,2,0,1,0
18,172,172,11,11,0,1,0
6,175,175,1,1,0,1,0
20,185,185,18,7,11,2,1
16,206,206,20,20,0,1,0
24,232,232,13,13,0,1,0
15,241,241,27,27,0,1,0
26,253,253,23,23,0,1,0
0,256,256,1,1,0,1,0
9,302,302,15,15,0,1,0
13,345,345,15,12,3,2,1
7,350,350,80,80,0,1,0
5,377,377,13,5,8,2,1
3,378,378,1,1,0,1,0
17,379,379,53,10,43,2,1
4,385,385,4,4,0,1,0
21,391,391,19,12,7,2,1
23,397,397,203,147,56,3,2
25,399,399,16,16,0,1,0
14,419,419,32,11,21,2,1
22,424,424,86,76,10,3,2
11,438,438,21,21,0,1,0
1,440,440,121,74,47,2,1
28,463,463,2,2,0,1,0
2,480,480,107,51,56,3,2
10,482,482,22,3,19,2,1

4,103,103,1,1,0,1,0
14,113,113,5,5,0,1,0
15,115,115,16,16,0,1,0
16,136,136,13,13,0,1,0
0,167,167,3,3,0,1,0
21,167,167,9,3,6,3,2
6,169,169,21,21,0,1,0
3,171,171,36,36,0,1,0
11,185,185,38,38,0,1,0
8,202,202,85,31,54,3,2
18,252,252,10,10,0,1,0
2,294,294,51,28,23,4,3
10,330,330,33,33,0,1,0
17,332,332,37,7,30,2,1
19,376,376,76,76,0,1,0
13,387,387,13,1,12,3,2
9,419,419,48,4,44,2,1
1,437,437,17,1,16,3,2
7,441,441,17,10,7,2,1
22,474,474,21,1,20,3,2
5,480,480,73,73,0,1,0
20,483,483,20,16,4,2,1
12,498,498,109,52,57,3,2

15,109,109,11,1,10,2,1
22,155,155,32,4,28,2,1
1,156,156,5,5,0,1,0
12,167,167,11,6,5,2,1
3,179,179,37,37,0,1,0
6,184,184,21,21,0,1,0
25,185,185,27,20,7,2,1
7,185,185,6,1,5,2,1
23,219,219,3,3,0,1,0
0,219,219,8,8,0,1,0
17,224,224,22,9,13,2,1
13,238,238,16,4,12,3,2
11,261,261,16,16,0,1,0
4,296,296,21,21,0,1,0
20,324,324,5,5,0,1,0
9,351,351,1,1,0,1,0
10,353,353,10,10,0,1,0
2,404,404,77,3,74,4,3
16,408,408,68,68,0,1,0
14,423,423,68,32,36,4,3
19,424,424,73,73,0,1,0
24,440,440,2,2,0,1,0
8,441,441,105,13,92,3,2
21,451,451,13,5,8,2,1
5,480,480,106,34,72,3,2
18,496,496,68,68,0,1,0

27,104,104,3,3,0,1,0
22,108,108,4,1,3,2,1
26,129,129,5,5,0,1,0
13,140,140,27,27,0,1,0
8,162,162,7,2,5,2,1
19,171,171,50,7,43,2,1
15,175,175,28,4,24,3,2
14,208,208,3,3,0,1,0
4,209,209,3,3,0,1,0
9,209,209,14,14,0,1,0
16,228,228,32,32,0,1,0
6,230,230,6,6,0,1,0
7,233,233,40,40,0,1,0
0,235,235,12,5,7,2,1
21,273,273,23,11,12,2,1
23,291,291,47,47,0,1,0
24,314,314,25,5,20,3,2
18,319,319,6,6,0,1,0
3,340,340,10,2,8,3,2
10,349,349,15,1,14,2,1
20,354,354,42,42,0,1,0
2,362,362,1,1,0,1,0
25,379,379,33,33,0,1,0
17,394,394,36,36,0,1,0
12,424,424,56,9,47,2,1
11,433,433,1,1,0,1,0
1,479,479,19,7,12,2,1
5,493,493,232,232,0,1,0

8,102,102,9,9,0,1,0
1,105,105,2,2,0,1,0
15,112,112,5,5,0,1,0
27,151,151,3,3,0,1,0
25,185,185,1,1,0,1,0
14,217,217,15,5,10,3,2
6,242,242,1,1,0,1,0
17,268,268,58,58,0,1,0
5,274,274,98,41,57,4,3
11,276,276,1,1,0,1,0
13,286,286,39,26,13,2,1
3,299,299,11,1,10,3,2
30,312,312,3,3,0,1,0
9,322,322,12,12,0,1,0
12,328,328,17,17,0,1,0
26,339,339,83,59,24,2,1
0,348,348,1,1,0,1,0
20,356,356,9,9,0,1,0
19,358,358,20,20,0,1,0
22,374,374,131,64,67,3,2
28,383,383,49,8,41,2,1
21,392,392,11,11,0,1,0
29,392,392,10,1,9,4,3
4,409,409,2,2,0,1,0
18,426,426,62,3,59,4,3
23,431,431,56,56,0,1,0
24,439,439,67,24,43,2,1
10,440,440,43,22,21,3,2
2,472,472,15,15,0,1,0
16,474,474,5,5,0,1,0
7,494,494,44,44,0,1,0

0,100,100,6,6,0,1,0
20,111,111,1,1,0,1,0
18,142,142,4,4,0,1,0
2,143,143,5,5,0,1,0
10,153,153,16,1,15,4,3
4,166,166,2,2,0,1,0
25,178,178,12,12,0,1,0
23,181,181,10,5,5,2,1
5,195,195,12,12,0,1,0
15,227,227,167,140,27,4,3
9,229,229,1,1,0,1,0
6,237,237,5,5,0,1,0
7,256,256,33,33,0,1,0
21,257,257,9,9,0,1,0
16,284,284,10,10,0,1,0
8,309,309,120,54,66,4,3
12,353,353,45,8,37,2,1
26,354,354,6,6,0,1,0
14,377,377,9,3,6,2,1
13,420,420,35,35,0,1,0
17,437,437,20,12,8,2,1
24,444,444,30,30,0,1,0
22,477,477,51,51,0,1,0
3,480,480,37,20,17,2,1
19,481,481,44,44,0,1,0
1,487,487,73,73,0,1,0
11,496,496,23,2,21,2,1

5,114,114,1,1,0,1,0
17,119,119,3,3,0,1,0
0,136,136,1,1,0,1,0
10,150,150,4,4,0,1,0
14,154,154,13,1,12,2,1
21,156,156,1,1,0,1,0
24,210,210,2,2,0,1,0
3,213,213,22,4,18,4,3
18,231,231,26,10,16,4,3
6,275,275,24,1,23,4,3
15,280,280,42,42,0,1,0
16,288,288,8,4,4,2,1
8,291,291,93,10,83,4,3
13,309,309,37,37,0,1,0
7,336,336,45,24,21,2,1
9,346,346,67,67,0,1,0
4,365,365,21,11,10,3,2
12,366,366,72,40,32,2,1
19,366,366,61,61,0,1,0
23,417,417,15,15,0,1,0
25,438,438,94,22,72,4,3
26,446,446,80,80,0,1,0
1,448,448,1,1,0,1,0
20,452,452,1,1,0,1,0
11,463,463,6,6,0,1,0
22,464,464,144,123,21,2,1
2,483,483,16,16,0,1,0

2,123,123,31,31,0,1,0
17,132,132,8,3,5,2,1
22,182,182,61,61,0,1,0
9,193,193,7,4,3,2,1
19,202,202,21,5,16,3,2
21,215,215,42,3,39,3,2
18,226,226,17,1,16,3,2
7,231,231,11,5,6,3,2
13,252,252,23,23,0,1,0
4,255,255,1,1,0,1,0
8,285,285,67,67,0,1,0
14,317,317,11,11,0,1,0
20,359,359,13,10,3,2,1
3,366,366,1,1,0,1,0
5,375,375,106,31,75,4,3
1,376,376,67,67,0,1,0
16,394,394,9,9,0,1,0
12,399,399,4,4,0,1,0
0,415,415,23,5,18,4,3
15,427,427,55,55,0,1,0
11,474,474,57,57,0,1,0
6,483,483,102,6,96,3,2
10,491,491,56,56,0,1,0

6,102,102,1,1,0,1,0
21,124,124,9,9,0,1,0
26,166,166,9,2,7,2,1
1,171,171,19,7,12,3,2
8,176,176,2,2,0,1,0
19,179,179,8,8,0,1,0
12,200,200,3,3,0,1,0
16,254,254,9,5,4,2,1
28,257,257,16,16,0,1,0
25,260,260,1,1,0,1,0
29,269,269,6,6,0,1,0
2,276,276,15,15,0,1,0
9,285,285,19,19,0,1,0
15,299,299,47,47,0,1,0
7,326,326,26,8,18,3,2
18,331,331,133,43,90,4,3
11,347,347,16,16,0,1,0
13,359,359,8,8,0,1,0
23,363,363,12,12,0,1,0
17,370,370,128,104,24,2,1
3,424,424,24,24,0,1,0
4,426,426,10,10,0,1,0
24,426,426,16,1,15,4,3
14,429,429,71,50,21,2,1
27,433,433,47,47,0,1,0
20,457,457,42,18,24,3,2
22,468,468,20,20,0,1,0
5,469,469,95,2,93,4,3
0,471,471,37,15,22,2,1
10,474,474,79,4,75,4,3

24,103,103,18,18,0,1,0
9,107,107,12,4,8,3,2
2,146,146,14,7,7,2,1
11,156,156,3,3,0,1,0
1,180,180,19,19,0,1,0
22,207,207,11,3,8,2,1
10,246,246,67,67,0,1,0
6,247,247,5,5,0,1,0
19,248,248,31,31,0,1,0
5,260,260,14,3,11,2,1
20,271,271,1,1,0,1,0
4,284,284,16,16,0,1,0
18,298,298,13,13,0,1,0
15,313,313,6,6,0,1,0
0,332,332,13,13,0,1,0
12,365,365,9,9,0,1,0
7,365,365,77,31,46,3,2
16,368,368,13,13,0,1,0
23,393,393,34,34,0,1,0
13,431,431,80,59,21,3,2
21,476,476,62,62,0,1,0
8,483,483,95,17,78,4,3
17,496,496,122,62,60,3,2
14,497,497,98,85,13,2,1
3,497,497,60,60,0,1,0

1,110,110,12,4,8,3,2
0,125,125,19,19,0,1,0
12,128,128,9,9,0,1,0
15,131,131,22,10,12,3,2
9,160,160,10,1,9,4,3
23,182,182,37,37,0,1,0
16,188,188,20,14,6,3,2
22,210,210,16,1,15,4,3
19,213,213,44,44,0,1,0
27,247,247,33,33,0,1,0
3,263,263,8,1,7,2,1
26,283,283,10,5,5,2,1
8,304,304,3,3,0,1,0
18,313,313,22,22,0,1,0
13,316,316,51,51,0,1,0
4,318,318,76,4,72,4,3
11,337,337,14,1,13,4,3
10,338,338,29,29,0,1,0
5,345,345,15,6,9,2,1
6,365,365,9,2,7,2,1
7,377,377,30,3,27,2,1
14,378,378,14,14,0,1,0
21,389,389,50,27,23,2,1
20,397,397,5,5,0,1,0
24,411,411,32,32,0,1,0
25,420,420,40,32,8,3,2
2,443,443,69,49,20,3,2
17,449,449,7,7,0,1,0

5,100,100,1,1,0,1,0
22,111,111,2,2,0,1,0
25,135,135,2,2,0,1,0
2,150,150,4,4,0,1,0
19,184,184,23,23,0,1,0
26,195,195,18,18,0,1,0
11,197,197,4,4,0,1,0
14,203,203,8,8,0,1,0
12,224,224,7,3,4,2,1
15,244,244,53,53,0,1,0
0,268,268,9,9,0,1,0
1,270,270,2,2,0,1,0
9,277,277,25,2,23,2,1
24,288,288,5,5,0,1,0
13,308,308,75,24,51,4,3
6,324,324,13,7,6,3,2
21,329,329,12,12,0,1,0
4,330,330,8,4,4,2,1
3,340,340,4,4,0,1,0
8,412,412,19,19,0,1,0
18,412,412,78,78,0,1,0
7,412,412,26,26,0,1,0
30,416,416,84,84,0,1,0
17,425,425,49,22,27,2,1
23,435,435,48,48,0,1,0
28,473,473,14,14,0,1,0
10,476,476,56,14,42,4,3
16,481,481,79,53,26,3,2
29,482,482,37,37,0,1,0
27,488,488,130,16,114,4,3
20,499,499,70,70,0,1,0

25,100,100,7,2,5,2,1
2,103,103,2,2,0,1,0
29,128,128,7,7,0,1,0
11,143,143,4,4,0,1,0
19,184,184,9,9,0,1,0
0,196,196,1,1,0,1,0
24,197,197,6,1,5,2,1
7,216,216,3,3,0,1,0
12,220,220,2,2,0,1,0
17,221,221,45,45,0,1,0
20,237,237,57,22,35,4,3
13,248,248,71,29,42,4,3
6,250,250,8,8,0,1,0
22,260,260,25,11,14,3,2
5,268,268,32,32,0,1,0
21,283,283,12,2,10,3,2
14,296,296,16,16,0,1,0
28,326,326,47,17,30,3,2
4,328,328,72,72,0,1,0
15,332,332,43,10,33,3,2
16,343,343,4,4,0,1,0
1,357,357,23,23,0,1,0
10,364,364,7,7,0,1,0
27,371,371,66,30,36,4,3
8,383,383,20,20,0,1,0
9,390,390,65,65,0,1,0
23,395,395,21,21,0,1,0
26,446,446,62,62,0,1,0
3,471,471,33,16,17,3,2
18,480,480,11,11,0,1,0

18,112,112,3,3,0,1,0
2,142,142,7,7,0,1,0
20,159,159,5,5,0,1,0
6,170,170,23,8,15,4,3
9,175,175,8,8,0,1,0
0,200,200,27,7,20,2,1
4,205,205,34,10,24,3,2
25,232,232,86,37,49,2,1
5,233,233,55,6,49,2,1
16,246,246,8,2,6,3,2
17,247,247,13,5,8,2,1
8,254,254,9,1,8,3,2
22,287,287,65,48,17,2,1
21,296,296,10,6,4,2,1
1,297,297,5,1,4,2,1
26,304,304,38,38,0,1,0
19,350,350,11,5,6,3,2
7,395,395,23,3,20,3,2
12,397,397,13,13,0,1,0
13,409,409,13,13,0,1,0
14,429,429,14,5,9,2,1
24,438,438,97,37,60,4,3
15,467,467,54,54,0,1,0
23,478,478,15,15,0,1,0
10,479,479,11,11,0,1,0
3,488,488,25,6,19,2,1
11,493,493,141,138,3,2,1

7,138,138,5,5,0,1,0
13,169,169,8,1,7,2,1
15,202,202,36,36,0,1,0
9,203,203,21,21,0,1,0
5,284,284,51,35,16,3,2
23,295,295,28,16,12,4,3
22,315,315,10,10,0,1,0
2,319,319,12,3,9,2,1
11,322,322,3,3,0,1,0
8,330,330,31,31,0,1,0
4,361,361,30,30,0,1,0
12,370,370,17,17,0,1,0
10,372,372,1,1,0,1,0
14,377,377,46,34,12,4,3
1,394,394,31,31,0,1,0
16,395,395,33,33,0,1,0
21,407,407,131,131,0,1,0
18,412,412,8,8,0,1,0
19,423,423,30,11,19,3,2
24,426,426,80,80,0,1,0
6,458,458,214,214,0,1,0
0,461,461,1,1,0,1,0
20,463,463,19,19,0,1,0
3,465,465,97,97,0,1,0
17,491,491,39,39,0,1,0

5,112,112,1,1,0,1,0
14,134,134,10,10,0,1,0
24,149,149,2,2,0,1,0
11,150,150,8,2,6,3,2
9,156,156,39,39,0,1,0
10,168,168,6,6,0,1,0
22,180,180,42,2,40,2,1
8,202,202,26,17,9,4,3
18,216,216,6,6,0,1,0
21,236,236,18,10,8,3,2
4,262,262,10,2,8,3,2
6,272,272,10,1,9,4,3
0,277,277,2,2,0,1,0
29,277,277,26,9,17,4,3
30,283,283,23,9,14,3,2
27,293,293,61,61,0,1,0
25,296,296,96,64,32,3,2
17,298,298,58,58,0,1,0
23,304,304,17,17,0,1,0
2,350,350,1,1,0,1,0
1,354,354,5,5,0,1,0
15,358,358,44,37,7,2,1
28,365,365,43,43,0,1,0
19,374,374,26,5,21,4,3
13,379,379,1,1,0,1,0
12,380,380,21,21,0,1,0
3,381,381,16,16,0,1,0
7,384,384,30,30,0,1,0
31,405,405,9,9,0,1,0
20,411,411,4,4,0,1,0
16,457,457,58,12,46,2,1
26,478,478,7,7,0,1,0

27,118,118,50,50,0,1,0
9,153,153,4,4,0,1,0
2,163,163,1,1,0,1,0
22,174,174,10,10,0,1,0
5,193,193,25,25,0,1,0
24,195,195,15,15,0,1,0
13,204,204,20,20,0,1,0
0,205,205,74,74,0,1,0
18,207,207,7,1,6,3,2
28,219,219,5,5,0,1,0
29,234,234,69,36,33,4,3
1,235,235,23,5,18,4,3
12,264,264,7,7,0,1,0
6,266,266,11,3,8,2,1
21,282,282,24,21,3,2,1
23,307,307,41,41,0,1,0
26,319,319,7,7,0,1,0
3,358,358,5,1,4,2,1
10,358,358,1,1,0,1,0
19,362,362,23,12,11,2,1
20,408,408,2,2,0,1,0
15,416,416,36,30,6,3,2
14,420,420,45,45,0,1,0
7,425,425,52,28,24,3,2
17,428,428,26,26,0,1,0
4,431,431,15,15,0,1,0
11,434,434,4,4,0,1,0
25,437,437,22,22,0,1,0
16,461,461,63,15,48,4,3
8,471,471,1,1,0,1,0

7,111,111,5,2,3,2,1
16,119,119,21,14,7,2,1
18,122,122,14,1,13,2,1
5,133,133,2,2,0,1,0
10,149,149,31,31,0,1,0
9,195,195,14,2,12,4,3
20,201,201,12,6,6,2,1
19,210,210,22,22,0,1,0
23,225,225,22,22,0,1,0
0,233,233,39,39,0,1,0
4,233,233,7,4,3,2,1
22,240,240,13,9,4,2,1
3,246,246,81,81,0,1,0
24,277,277,76,44,32,3,2
11,292,292,45,19,26,3,2
17,296,296,8,8,0,1,0
15,310,310,18,12,6,2,1
12,311,311,74,74,0,1,0
8,328,328,37,4,33,4,3
6,329,329,1,1,0,1,0
1,397,397,44,44,0,1,0
2,419,419,23,15,8,2,1
14,451,451,20,20,0,1,0
13,462,462,15,6,9,2,1
21,479,479,22,9,13,3,2

10,107,107,7,7,0,1,0
7,139,139,8,8,0,1,0
9,153,153,13,4,9,2,1
5,181,181,13,1,12,3,2
21,209,209,2,2,0,1,0
14,221,221,27,4,23,2,1
8,238,238,2,2,0,1,0
13,256,256,4,4,0,1,0
1,266,266,38,38,0,1,0
22,284,284,61,54,7,2,1
0,308,308,160,67,93,4,3
17,322,322,33,17,16,2,1
4,343,343,31,19,12,3,2
19,346,346,22,22,0,1,0
16,348,348,154,126,28,3,2
12,367,367,7,4,3,2,1
11,373,373,4,1,3,2,1
2,424,424,94,94,0,1,0
3,427,427,10,10,0,1,0
20,431,431,46,35,11,2,1
18,438,438,34,34,0,1,0
6,449,449,37,37,0,1,0
15,453,453,34,4,30,4,3

7,113,113,1,1,0,1,0
1,124,124,1,1,0,1,0
9,129,129,30,14,16,2,1
22,156,156,50,50,0,1,0
25,162,162,10,2,8,3,2
3,167,167,14,14,0,1,0
24,180,180,8,8,0,1,0
5,194,194,21,10,11,2,1
4,213,213,4,4,0,1,0
10,235,235,34,5,29,2,1
11,249,249,56,11,45,4,3
21,255,255,6,6,0,1,0
17,258,258,19,1,18,3,2
20,263,263,14,14,0,1,0
26,276,276,46,46,0,1,0
18,305,305,6,6,0,1,0
13,370,370,17,17,0,1,0
19,372,372,21,6,15,2,1
2,397,397,12,12,0,1,0
16,399,399,68,50,18,3,2
27,402,402,37,37,0,1,0
8,424,424,11,11,0,1,0
12,452,452,9,9,0,1,0
6,483,483,6,6,0,1,0
14,491,491,120,120,0,1,0
15,495,495,8,8,0,1,0
0,500,500,46,46,0,1,0
23,500,500,111,111,0,1,0

18,105,105,8,8,0,1,0
11,118,118,1,1,0,1,0
13,122,122,15,6,9,4,3
26,134,134,2,2,0,1,0
12,146,146,5,5,0,1,0
14,166,166,30,4,26,2,1
9,170,170,16,16,0,1,0
20,176,176,10,10,0,1,0
6,193,193,2,2,0,1,0
5,196,196,4,4,0,1,0
3,210,210,7,4,3,2,1
17,231,231,15,6,9,2,1
7,237,237,28,28,0,1,0
1,240,240,1,1,0,1,0
21,255,255,144,123,21,4,3
22,274,274,32,20,12,4,3
19,277,277,30,30,0,1,0
25,291,291,28,10,18,4,3
16,332,332,1,1,0,1,0
10,343,343,17,17,0,1,0
0,375,375,48,14,34,3,2
8,404,404,28,28,0,1,0
2,422,422,37,23,14,2,1
27,429,429,67,28,39,4,3
24,435,435,21,21,0,1,0
4,444,444,151,1,150,4,3
23,463,463,2,2,0,1,0
15,464,464,8,5,3,2,1

12,111,111,10,10,0,1,0
24,115,115,1,1,0,1,0
1,199,199,26,26,0,1,0
10,199,199,1,1,0,1,0
3,204,204,4,4,0,1,0
22,218,218,3,3,0,1,0
11,219,219,30,1,29,2,1
6,226,226,29,8,21,4,3
23,226,226,2,2,0,1,0
19,231,231,60,60,0,1,0
21,234,234,15,15,0,1,0
15,245,245,21,9,12,2,1
14,259,259,17,17,0,1,0
4,264,264,16,16,0,1,0
17,286,286,12,4,8,2,1
7,314,314,15,8,7,2,1
0,320,320,57,13,44,3,2
16,322,322,107,107,0,1,0
5,323,323,5,1,4,2,1
26,357,357,38,6,32,2,1
25,363,363,74,10,64,4,3
9,384,384,8,8,0,1,0
13,408,408,54,7,47,2,1
8,422,422,15,15,0,1,0
20,446,446,30,30,0,1,0
2,454,454,136,68,68,3,2
18,485,485,35,26,9,3,2

18,100,100,20,8,12,3,2
2,116,116,10,10,0,1,0
4,124,124,1,1,0,1,0
13,136,136,1,1,0,1,0
26,139,139,22,12,10,2,1
11,144,144,5,5,0,1,0
24,145,145,1,1,0,1,0
7,179,179,4,4,0,1,0
12,182,182,12,12,0,1,0
20,205,205,58,48,10,3,2
23,211,211,6,6,0,1,0
17,238,238,2,2,0,1,0
19,258,258,3,3,0,1,0
15,274,274,24,24,0,1,0
21,293,293,4,4,0,1,0
14,304,304,3,3,0,1,0
6,308,308,4,4,0,1,0
0,315,315,55,29,26,2,1
16,321,321,26,26,0,1,0
22,337,337,81,57,24,3,2
1,371,371,3,3,0,1,0
9,403,403,38,38,0,1,0
5,423,423,6,6,0,1,0
25,436,436,85,43,42,2,1
10,445,445,185,35,150,4,3
3,448,448,53,53,0,1,0
8,466,466,112,112,0,1,0

15,107,107,26,5,21,4,3
5,111,111,26,2,24,2,1
17,121,121,5,2,3,2,1
3,141,141,46,8,38,3,2
12,180,180,7,7,0,1,0
4,189,189,121,104,17,2,1
8,245,245,13,13,0,1,0
14,245,245,44,44,0,1,0
13,247,247,28,3,25,4,3
9,253,253,15,6,9,2,1
0,261,261,42,13,29,2,1
7,373,373,12,4,8,3,2
10,400,400,46,3,43,2,1
2,410,410,4,4,0,1,0
11,430,430,7,7,0,1,0
16,433,433,55,36,19,2,1
6,450,450,33,33,0,1,0
1,455,455,75,75,0,1,0

17,166,166,6,6,0,1,0
14,171,171,18,5,13,2,1
3,174,174,17,2,15,4,3
23,174,174,4,1,3,2,1
19,201,201,12,12,0,1,0
6,228,228,15,7,8,3,2
8,239,239,49,8,41,2,1
11,249,249,5,1,4,2,1
12,250,250,16,1,15,4,3
20,270,270,26,26,0,1,0
2,316,316,13,13,0,1,0
13,317,317,30,30,0,1,0
18,319,319,11,11,0,1,0
5,321,321,40,4,36,4,3
21,322,322,16,16,0,1,0
0,341,341,67,25,42,2,1
1,342,342,36,30,6,3,2
22,360,360,212,98,114,4,3
16,388,388,19,3,16,3,2
4,448,448,13,4,9,4,3
10,452,452,179,80,99,4,3
15,457,457,44,44,0,1,0
7,473,473,1,1,0,1,0
9,497,497,19,5,14,2,1

1,138,138,29,5,24,4,3
9,146,146,2,2,0,1,0
13,167,167,4,4,0,1,0
4,191,191,11,11,0,1,0
21,206,206,18,18,0,1,0
6,234,234,7,7,0,1,0
2,239,239,20,20,0,1,0
15,247,247,18,2,16,3,2
16,259,259,40,40,0,1,0
5,293,293,15,1,14,3,2
11,293,293,24,24,0,1,0
7,299,299,34,18,16,2,1
3,306,306,71,11,60,4,3
0,330,330,151,4,147,4,3
20,335,335,4,4,0,1,0
14,344,344,130,76,54,3,2
10,365,365,25,7,18,3,2
8,398,398,26,21,5,2,1
19,400,400,75,75,0,1,0
12,433,433,14,11,3,2,1
18,445,445,69,22,47,3,2
17,451,451,25,6,19,2,1

30,100,100,18,18,0,1,0
2,101,101,19,11,8,3,2
17,103,103,1,1,0,1,0
28,110,110,8,2,6,2,1
12,111,111,16,16,0,1,0
14,133,133,21,6,15,4,3
4,183,183,9,9,0,1,0
32,184,184,6,6,0,1,0
8,202,202,7,1,6,2,1
1,209,209,30,21,9,4,3
21,213,213,26,26,0,1,0
13,219,219,1,1,0,1,0
29,219,219,29,29,0,1,0
16,223,223,8,2,6,3,2
11,227,227,7,7,0,1,0
23,231,231,5,5,0,1,0
6,248,248,3,3,0,1,0
5,253,253,3,3,0,1,0
20,255,255,25,25,0,1,0
27,258,258,17,17,0,1,0
19,266,266,2,2,0,1,0
34,281,281,19,19,0,1,0
3,284,284,20,20,0,1,0
31,291,291,6,6,0,1,0
25,305,305,54,18,36,3,2
26,320,320,100,70,30,3,2
15,327,327,2,2,0,1,0
10,332,332,8,4,4,2,1
7,332,332,2,2,0,1,0
9,402,402,6,3,3,2,1
0,405,405,42,42,0,1,0
33,429,429,8,8,0,1,0
24,438,438,27,3,24,2,1
22,455,455,74,60,14,2,1
18,467,467,12,6,6,3,2

20,108,108,13,13,0,1,0
16,135,135,8,1,7,2,1
3,149,149,7,4,3,2,1
24,150,150,1,1,0,1,0
28,159,159,4,4,0,1,0
15,161,161,6,6,0,1,0
10,167,167,7,7,0,1,0
4,170,170,19,19,0,1,0
22,184,184,12,3,9,4,3
7,229,229,45,34,11,2,1
11,229,229,10,1,9,2,1
8,231,231,29,29,0,1,0
2,258,258,21,21,0,1,0
0,260,260,4,4,0,1,0
18,270,270,3,3,0,1,0
13,279,279,19,19,0,1,0
14,285,285,43,43,0,1,0
25,294,294,75,64,11,2,1
27,299,299,11,11,0,1,0
21,300,300,7,1,6,2,1
17,307,307,51,51,0,1,0
9,344,344,31,14,17,2,1
5,375,375,49,25,24,2,1
1,396,396,25,10,15,2,1
6,417,417,31,31,0,1,0
12,443,443,12,9,3,2,1
26,455,455,109,28,81,4,3
23,480,480,100,59,41,4,3
19,485,485,53,53,0,1,0

4,125,125,64,64,0,1,0
7,131,131,2,2,0,1,0
12,150,150,40,40,0,1,0
3,161,161,44,44,0,1,0
1,176,176,61,31,30,2,1
17,184,184,40,7,33,4,3
13,211,211,5,2,3,2,1
14,224,224,22,22,0,1,0
10,228,228,33,18,15,4,3
15,240,240,1,1,0,1,0
16,261,261,9,9,0,1,0
11,325,325,20,20,0,1,0
2,352,352,43,30,13,2,1
0,382,382,18,18,0,1,0
8,414,414,73,49,24,2,1
6,425,425,13,13,0,1,0
9,429,429,43,15,28,4,3
5,477,477,68,68,0,1,0

17,123,123,6,1,5,2,1
27,141,141,56,56,0,1,0
16,147,147,26,26,0,1,0
3,164,164,21,3,18,3,2
4,171,171,10,3,7,2,1
7,171,171,9,1,8,2,1
8,186,186,3,3,0,1,0
23,203,203,11,11,0,1,0
10,220,220,84,84,0,1,0
6,237,237,20,20,0,1,0
22,250,250,22,22,0,1,0
5,251,251,1,1,0,1,0
13,278,278,47,47,0,1,0
9,290,290,31,7,24,2,1
20,309,309,33,33,0,1,0
0,315,315,14,5,9,4,3
12,323,323,1,1,0,1,0
24,345,345,45,3,42,3,2
26,352,352,45,45,0,1,0
15,400,400,6,6,0,1,0
21,414,414,54,24,30,3,2
11,422,422,15,11,4,2,1
25,434,434,9,9,0,1,0
2,445,445,3,3,0,1,0
14,450,450,62,62,0,1,0
18,482,482,7,7,0,1,0
1,488,488,35,8,27,4,3
19,489,489,7,7,0,1,0

19,100,100,34,34,0,1,0
25,101,101,1,1,0,1,0
1,114,114,31,16,15,2,1
21,120,120,7,7,0,1,0
26,142,142,1,1,0,1,0
2,154,154,22,1,21,2,1
6,159,159,1,1,0,1,0
9,160,160,35,19,16,2,1
15,202,202,2,2,0,1,0
23,220,220,60,30,30,3,2
0,269,269,24,24,0,1,0
14,273,273,25,25,0,1,0
27,276,276,18,4,14,3,2
13,294,294,7,7,0,1,0
17,296,296,7,7,0,1,0
18,304,304,11,11,0,1,0
16,314,314,7,7,0,1,0
20,343,343,154,130,24,2,1
4,344,344,1,1,0,1,0
3,345,345,11,3,8,3,2
12,346,346,39,39,0,1,0
7,351,351,5,5,0,1,0
24,361,361,6,6,0,1,0
29,406,406,3,3,0,1,0
22,408,408,7,1,6,3,2
28,417,417,10,10,0,1,0
11,419,419,16,16,0,1,0
10,429,429,52,34,18,2,1
8,467,467,3,3,0,1,0
5,472,472,46,46,0,1,0

21,114,114,7,7,0,1,0
16,118,118,9,9,0,1,0
12,131,131,15,9,6,3,2
10,139,139,16,9,7,2,1
25,160,160,2,2,0,1,0
19,168,168,8,8,0,1,0
9,169,169,15,3,12,4,3
2,183,183,29,17,12,2,1
20,186,186,15,2,13,2,1
1,239,239,12,1,11,2,1
4,257,257,29,29,0,1,0
0,269,269,2,2,0,1,0
24,282,282,155,75,80,4,3
15,287,287,26,26,0,1,0
8,287,287,48,18,30,3,2
6,292,292,18,18,0,1,0
3,305,305,5,5,0,1,0
7,321,321,16,16,0,1,0
14,335,335,67,67,0,1,0
22,340,340,15,3,12,4,3
18,351,351,8,4,4,2,1
23,374,374,24,7,17,2,1
13,395,395,28,28,0,1,0
17,413,413,3,3,0,1,0
5,457,457,21,21,0,1,0
11,486,486,153,114,39,4,3

21,106,106,1,1,0,1,0
2,109,109,1,1,0,1,0
19,143,143,2,2,0,1,0
22,149,149,27,3,24,2,1
6,159,159,67,28,39,4,3
0,187,187,12,12,0,1,0
16,211,211,3,3,0,1,0
14,224,224,23,8,15,4,3
12,225,225,24,24,0,1,0
15,240,240,34,34,0,1,0
3,243,243,21,1,20,3,2
10,265,265,58,22,36,4,3
18,283,283,46,46,0,1,0
5,326,326,9,3,6,2,1
8,344,344,68,68,0,1,0
17,366,366,5,5,0,1,0
11,367,367,23,6,17,2,1
9,377,377,69,69,0,1,0
13,415,415,30,27,3,2,1
7,418,418,37,17,20,2,1
4,453,453,76,76,0,1,0
20,474,474,108,66,42,4,3
1,476,476,27,27,0,1,0

7,100,100,8,8,0,1,0
28,113,113,18,2,16,2,1
4,137,137,8,8,0,1,0
0,186,186,1,1,0,1,0
1,191,191,2,2,0,1,0
29,203,203,5,2,3,2,1
2,211,211,4,4,0,1,0
26,213,213,10,2,8,2,1
23,214,214,11,11,0,1,0
20,216,216,66,60,6,2,1
11,219,219,44,8,36,3,2
13,242,242,50,4,46,3,2
19,249,249,63,63,0,1,0
3,262,262,1,1,0,1,0
8,284,284,12,12,0,1,0
10,288,288,1,1,0,1,0
6,289,289,1,1,0,1,0
25,290,290,6,6,0,1,0
5,293,293,3,3,0,1,0
14,310,310,4,4,0,1,0
12,361,361,60,13,47,3,2
18,369,369,3,3,0,1,0
17,373,373,12,7,5,2,1
16,391,391,44,44,0,1,0
15,398,398,52,28,24,2,1
9,406,406,95,83,12,2,1
27,410,410,48,9,39,4,3
21,450,450,7,7,0,1,0
22,468,468,83,83,0,1,0
24,490,490,56,56,0,1,0

20,107,107,20,20,0,1,0
13,109,109,11,11,0,1,0
2,116,116,1,1,0,1,0
1,155,155,6,6,0,1,0
6,178,178,10,10,0,1,0
0,178,178,32,32,0,1,0
15,190,190,1,1,0,1,0
10,202,202,2,2,0,1,0
12,222,222,10,5,5,2,1
9,228,228,10,7,3,2,1
24,276,276,7,7,0,1,0
17,281,281,6,1,5,2,1
14,294,294,12,1,11,2,1
5,308,308,1,1,0,1,0
25,308,308,81,3,78,4,3
3,311,311,44,44,0,1,0
27,325,325,3,3,0,1,0
7,342,342,80,80,0,1,0
30,351,351,14,14,0,1,0
19,384,384,16,4,12,2,1
26,387,387,69,69,0,1,0
16,390,390,52,9,43,2,1
4,391,391,13,13,0,1,0
22,410,410,99,99,0,1,0
23,433,433,27,27,0,1,0
29,443,443,60,60,0,1,0
18,444,444,1,1,0,1,0
11,452,452,26,7,19,2,1
21,461,461,45,45,0,1,0
8,475,475,70,30,40,2,1
28,491,491,21,21,0,1,0

7,114,114,2,2,0,1,0
15,117,117,2,2,0,1,0
24,132,132,29,29,0,1,0
17,140,140,13,13,0,1,0
9,155,155,3,3,0,1,0
3,175,175,79,79,0,1,0
2,176,176,1,1,0,1,0
12,192,192,10,10,0,1,0
10,195,195,2,2,0,1,0
16,200,200,22,4,18,3,2
22,205,205,40,16,24,3,2
18,207,207,7,2,5,2,1
6,238,238,13,1,12,3,2
19,262,262,43,13,30,2,1
23,283,283,1,1,0,1,0
5,289,289,21,21,0,1,0
20,303,303,8,8,0,1,0
21,383,383,42,7,35,3,2
4,386,386,178,178,0,1,0
8,398,398,8,4,4,2,1
13,401,401,102,51,51,4,3
11,420,420,35,35,0,1,0
1,426,426,1,1,0,1,0
14,472,472,26,26,0,1,0
0,498,498,51,43,8,3,2

8,114,114,13,4,9,4,3
6,118,118,2,2,0,1,0
24,131,131,13,9,4,2,1
2,167,167,13,5,8,3,2
0,196,196,8,8,0,1,0
21,197,197,1,1,0,1,0
19,219,219,11,3,8,2,1
5,231,231,9,9,0,1,0
9,233,233,40,14,26,3,2
4,235,235,61,18,43,4,3
7,265,265,12,12,0,1,0
15,267,267,142,114,28,4,3
1,281,281,19,1,18,2,1
10,306,306,37,37,0,1,0
18,324,324,30,5,25,4,3
17,346,346,9,1,8,3,2
16,359,359,37,37,0,1,0
13,361,361,1,1,0,1,0
20,414,414,21,21,0,1,0
14,415,415,80,80,0,1,0
22,441,441,20,12,8,3,2
11,446,446,103,40,63,4,3
12,464,464,46,46,0,1,0
23,464,464,11,11,0,1,0
3,467,467,54,16,38,2,1

17,106,106,7,1,6,3,2
10,136,136,20,5,15,4,3
24,151,151,22,13,9,4,3
23,168,168,27,7,20,4,3
2,171,171,19,19,0,1,0
11,175,175,4,4,0,1,0
9,197,197,67,61,6,2,1
18,246,246,9,9,0,1,0
16,262,262,21,21,0,1,0
1,277,277,80,42,38,3,2
12,293,293,1,1,0,1,0
15,295,295,12,12,0,1,0
22,306,306,3,3,0,1,0
26,319,319,38,8,30,2,1
4,330,330,26,19,7,2,1
3,343,343,1,1,0,1,0
20,360,360,27,1,26,4,3
0,377,377,18,18,0,1,0
19,380,380,27,27,0,1,0
8,389,389,29,29,0,1,0
6,422,422,33,33,0,1,0
5,425,425,18,18,0,1,0
21,425,425,93,93,0,1,0
13,431,431,4,4,0,1,0
25,442,442,43,9,34,4,3
7,451,451,24,6,18,2,1
14,500,500,104,19,85,4,3

3,131,131,10,2,8,2,1
13,140,140,20,20,0,1,0
12,145,145,6,6,0,1,0
6,217,217,51,51,0,1,0
2,222,222,5,5,0,1,0
17,228,228,1,1,0,1,0
5,236,236,2,2,0,1,0
20,269,269,28,5,23,2,1
10,277,277,27,27,0,1,0
0,301,301,32,7,25,2,1
14,301,301,73,34,39,4,3
11,326,326,15,15,0,1,0
8,341,341,96,62,34,2,1
21,365,365,29,9,20,2,1
19,368,368,14,14,0,1,0
7,380,380,88,88,0,1,0
9,388,388,40,40,0,1,0
18,396,396,22,22,0,1,0
4,411,411,46,2,44,2,1
22,425,425,28,28,0,1,0
15,428,428,47,25,22,2,1
1,442,442,12,12,0,1,0
23,458,458,54,40,14,3,2
16,474,474,128,128,0,1,0

5,144,144,40,40,0,1,0
18,165,165,17,17,0,1,0
12,176,176,3,3,0,1,0
11,177,177,1,1,0,1,0
14,180,180,18,18,0,1,0
23,208,208,47,10,37,2,1
20,226,226,17,17,0,1,0
25,255,255,16,16,0,1,0
21,260,260,3,3,0,1,0
7,279,279,17,17,0,1,0
0,283,283,17,12,5,2,1
22,288,288,61,61,0,1,0
10,317,317,29,1,28,2,1
15,340,340,44,19,25,2,1
4,344,344,21,21,0,1,0
9,351,351,86,86,0,1,0
8,360,360,2,2,0,1,0
17,363,363,7,1,6,3,2
16,376,376,44,44,0,1,0
13,386,386,54,54,0,1,0
3,394,394,47,5,42,3,2
19,417,417,39,31,8,3,2
24,426,426,15,15,0,1,0
6,429,429,64,64,0,1,0
1,446,446,6,6,0,1,0
2,463,463,90,90,0,1,0

7,107,107,13,13,0,1,0
14,113,113,1,1,0,1,0
12,127,127,9,9,0,1,0
13,127,127,5,5,0,1,0
24,127,127,2,2,0,1,0
21,143,143,5,5,0,1,0
11,151,151,11,11,0,1,0
22,157,157,55,22,33,2,1
30,171,171,1,1,0,1,0
10,172,172,19,13,6,3,2
3,175,175,1,1,0,1,0
25,176,176,20,2,18,4,3
2,189,189,22,14,8,3,2
18,201,201,12,6,6,3,2
8,206,206,3,3,0,1,0
9,211,211,22,22,0,1,0
15,230,230,39,24,15,4,3
20,242,242,43,15,28,3,2
0,263,263,7,4,3,2,1
29,270,270,4,4,0,1,0
28,341,341,4,4,0,1,0
4,378,378,1,1,0,1,0
5,389,389,26,11,15,4,3
19,396,396,70,27,43,4,3
17,417,417,27,11,16,2,1
27,422,422,77,77,0,1,0
26,434,434,15,5,10,3,2
1,436,436,119,91,28,2,1
16,447,447,9,9,0,1,0
6,462,462,6,3,3,2,1
23,463,463,65,50,15,4,3

3,104,104,9,9,0,1,0
24,105,105,5,5,0,1,0
11,107,107,3,3,0,1,0
4,130,130,3,3,0,1,0
20,155,155,24,3,21,4,3
14,200,200,23,23,0,1,0
16,218,218,32,32,0,1,0
1,227,227,2,2,0,1,0
15,247,247,17,3,14,2,1
10,291,291,144,144,0,1,0
7,295,295,19,19,0,1,0
2,297,297,17,11,6,2,1
23,308,308,2,2,0,1,0
8,311,311,39,29,10,2,1
21,345,345,44,11,33,2,1
12,354,354,4,4,0,1,0
13,393,393,41,1,40,3,2
6,421,421,38,8,30,3,2
25,424,424,74,11,63,4,3
9,431,431,12,4,8,2,1
0,437,437,77,70,7,2,1
17,446,446,63,63,0,1,0
5,449,449,1,1,0,1,0
18,459,459,10,4,6,2,1
26,476,476,76,76,0,1,0
19,479,479,48,48,0,1,0
22,495,495,30,30,0,1,0

8,117,117,13,7,6,2,1
20,125,125,23,1,22,2,1
14,130,130,17,5,12,3,2
5,165,165,5,5,0,1,0
17,171,171,19,19,0,1,0
19,205,205,23,23,0,1,0
16,211,211,29,29,0,1,0
6,232,232,59,31,28,2,1
11,238,238,1,1,0,1,0
15,245,245,21,21,0,1,0
4,247,247,26,11,15,4,3
12,257,257,14,14,0,1,0
13,266,266,17,7,10,2,1
1,289,289,9,1,8,3,2
2,299,299,88,25,63,4,3
22,324,324,12,12,0,1,0
3,326,326,45,45,0,1,0
7,331,331,1,1,0,1,0
0,371,371,36,23,13,2,1
21,390,390,56,56,0,1,0
9,391,391,93,83,10,2,1
10,435,435,44,3,41,2,1
18,448,448,70,70,0,1,0

19,118,118,8,2,6,3,2
13,129,129,5,5,0,1,0
15,165,165,16,16,0,1,0
14,186,186,10,2,8,3,2
27,206,206,36,21,15,4,3
24,208,208,11,5,6,2,1
20,216,216,1,1,0,1,0
28,224,224,26,26,0,1,0
17,237,237,24,2,22,2,1
5,247,247,5,5,0,1,0
25,262,262,33,33,0,1,0
12,267,267,103,87,16,2,1
10,311,311,1,1,0,1,0
11,313,313,12,6,6,3,2
8,335,335,17,17,0,1,0
7,348,348,2,2,0,1,0
23,361,361,22,2,20,3,2
9,390,390,11,11,0,1,0
2,398,398,51,51,0,1,0
0,419,419,31,17,14,3,2
26,424,424,33,33,0,1,0
16,439,439,53,50,3,2,1
4,452,452,35,35,0,1,0
21,453,453,46,7,39,2,1
22,453,453,12,12,0,1,0
6,467,467,17,3,14,3,2
18,482,482,143,53,90,4,3
3,484,484,87,87,0,1,0
1,487,487,41,41,0,1,0

17,118,118,22,22,0,1,0
1,121,121,6,6,0,1,0
18,150,150,14,11,3,2,1
0,206,206,32,14,18,2,1
16,280,280,80,48,32,3,2
7,295,295,210,148,62,3,2
15,299,299,29,29,0,1,0
14,323,323,17,1,16,2,1
13,337,337,74,62,12,4,3
3,338,338,88,73,15,4,3
8,342,342,13,2,11,2,1
19,368,368,20,20,0,1,0
9,370,370,11,11,0,1,0
20,413,413,20,1,19,2,1
12,436,436,60,60,0,1,0
5,440,440,10,10,0,1,0
11,447,447,16,10,6,3,2
10,452,452,20,20,0,1,0
2,453,453,19,19,0,1,0
4,475,475,19,19,0,1,0
6,476,476,10,3,7,2,1

7,100,100,10,6,4,2,1
15,108,108,27,18,9,4,3
9,129,129,6,6,0,1,0
8,131,131,23,23,0,1,0
10,136,136,13,3,10,3,2
6,154,154,53,53,0,1,0
0,165,165,8,1,7,2,1
22,179,179,12,12,0,1,0
11,200,200,31,25,6,2,1
13,265,265,19,19,0,1,0
12,267,267,10,10,0,1,0
16,275,275,72,72,0,1,0
2,282,282,13,13,0,1,0
17,310,310,27,27,0,1,0
3,332,332,18,18,0,1,0
23,403,403,36,2,34,4,3
4,416,416,126,126,0,1,0
21,462,462,57,57,0,1,0
14,469,469,23,14,9,4,3
5,470,470,33,33,0,1,0
19,473,473,7,7,0,1,0
20,485,485,9,9,0,1,0
1,486,486,8,4,4,2,1
18,494,494,49,35,14,3,2

13,136,136,17,17,0,1,0
18,137,137,18,18,0,1,0
0,149,149,1,1,0,1,0
26,162,162,36,6,30,2,1
31,175,175,19,16,3,2,1
1,177,177,11,1,10,3,2
16,177,177,22,19,3,2,1
8,184,184,13,8,5,2,1
25,196,196,58,11,47,2,1
27,207,207,15,15,0,1,0
23,230,230,22,22,0,1,0
15,275,275,35,35,0,1,0
2,296,296,16,11,5,2,1
12,301,301,35,7,28,3,2
10,302,302,5,2,3,2,1
19,314,314,20,11,9,4,3
9,339,339,24,15,9,4,3
17,351,351,1,1,0,1,0
4,356,356,42,42,0,1,0
20,357,357,37,37,0,1,0
3,361,361,16,13,3,2,1
14,371,371,12,6,6,2,1
24,373,373,4,4,0,1,0
5,379,379,8,4,4,2,1
11,386,386,22,14,8,2,1
22,398,398,79,79,0,1,0
28,454,454,2,2,0,1,0
7,479,479,39,39,0,1,0
30,480,480,38,28,10,2,1
6,487,487,19,19,0,1,0
21,488,488,32,32,0,1,0
29,497,497,1,1,0,1,0

13,102,102,11,6,5,2,1
15,144,144,12,12,0,1,0
17,169,169,5,1,4,2,1
10,192,192,2,2,0,1,0
5,208,208,14,14,0,1,0
14,213,213,38,38,0,1,0
3,221,221,1,1,0,1,0
23,224,224,20,1,19,2,1
20,230,230,1,1,0,1,0
18,260,260,22,4,18,4,3
11,265,265,69,60,9,4,3
22,270,270,68,42,26,3,2
4,284,284,6,6,0,1,0
24,289,289,9,9,0,1,0
19,304,304,30,12,18,4,3
2,305,305,36,36,0,1,0
9,309,309,19,19,0,1,0
0,327,327,27,9,18,3,2
6,349,349,114,69,45,4,3
12,434,434,33,33,0,1,0
21,444,444,19,19,0,1,0
1,445,445,67,67,0,1,0
8,450,450,12,2,10,3,2
16,451,451,120,120,0,1,0
7,454,454,79,79,0,1,0

1,105,105,7,2,5,2,1
7,109,109,7,7,0,1,0
18,115,115,21,21,0,1,0
13,130,130,1,1,0,1,0
15,137,137,4,1,3,2,1
8,189,189,2,2,0,1,0
4,213,213,17,17,0,1,0
21,219,219,2,2,0,1,0
11,226,226,5,5,0,1,0
9,253,253,1,1,0,1,0
25,268,268,18,2,16,3,2
17,269,269,6,6,0,1,0
12,274,274,12,3,9,2,1
10,292,292,18,2,16,3,2
5,313,313,163,28,135,4,3
0,319,319,22,6,16,2,1
3,323,323,50,9,41,2,1
19,323,323,61,61,0,1,0
6,340,340,7,7,0,1,0
22,385,385,90,90,0,1,0
2,418,418,77,34,43,2,1
20,432,432,4,4,0,1,0
16,438,438,24,24,0,1,0
24,459,459,140,140,0,1,0
23,471,471,89,50,39,4,3
14,482,482,14,14,0,1,0

23,102,102,8,1,7,2,1
13,110,110,27,5,22,2,1
0,119,119,5,5,0,1,0
14,122,122,8,8,0,1,0
17,128,128,28,28,0,1,0
10,139,139,8,8,0,1,0
5,165,165,50,50,0,1,0
6,171,171,39,27,12,3,2
9,211,211,15,15,0,1,0
18,226,226,2,2,0,1,0
2,231,231,26,26,0,1,0
15,237,237,24,12,12,3,2
25,266,266,33,8,25,2,1
16,281,281,9,9,0,1,0
7,316,316,22,4,18,2,1
12,324,324,51,51,0,1,0
22,331,331,99,11,88,3,2
3,353,353,20,20,0,1,0
8,355,355,20,11,9,4,3
11,369,369,9,2,7,2,1
1,384,384,31,31,0,1,0
21,396,396,21,21,0,1,0
19,402,402,12,12,0,1,0
24,450,450,23,23,0,1,0
4,487,487,20,20,0,1,0
20,492,492,6,3,3,2,1

10,136,136,39,7,32,3,2
3,149,149,11,5,6,2,1
1,161,161,1,1,0,1,0
22,201,201,34,34,0,1,0
4,203,203,43,43,0,1,0
14,205,205,21,21,0,1,0
21,215,215,5,2,3,2,1
17,232,232,40,40,0,1,0
0,234,234,6,6,0,1,0
27,243,243,9,1,8,2,1
9,245,245,4,4,0,1,0
12,273,273,20,20,0,1,0
2,277,277,11,11,0,1,0
5,280,280,1,1,0,1,0
25,315,315,66,39,27,4,3
6,322,322,26,26,0,1,0
13,343,343,26,26,0,1,0
7,344,344,57,57,0,1,0
26,346,346,39,39,0,1,0
11,381,381,37,37,0,1,0
19,399,399,44,44,0,1,0
8,430,430,18,1,17,2,1
18,437,437,13,13,0,1,0
24,460,460,56,31,25,2,1
16,468,468,27,27,0,1,0
23,486,486,63,63,0,1,0
20,494,494,62,18,44,3,2
15,500,500,8,8,0,1,0

17,110,110,10,10,0,1,0
29,121,121,9,9,0,1,0
18,122,122,6,6,0,1,0
1,131,131,11,11,0,1,0
7,183,183,11,3,8,3,2
24,185,185,3,3,0,1,0
12,196,196,1,1,0,1,0
15,208,208,11,3,8,2,1
32,209,209,4,1,3,2,1
33,218,218,91,69,22,2,1
19,224,224,11,5,6,3,2
31,226,226,42,42,0,1,0
5,230,230,21,6,15,4,3
6,242,242,7,7,0,1,0
0,277,277,1,1,0,1,0
9,294,294,42,42,0,1,0
8,320,320,39,13,26,2,1
2,331,331,33,1,32,2,1
13,355,355,5,5,0,1,0
21,363,363,30,17,13,2,1
10,364,364,7,7,0,1,0
23,367,367,30,2,28,3,2
22,368,368,8,4,4,2,1
25,377,377,40,22,18,3,2
30,384,384,40,40,0,1,0
20,387,387,11,5,6,2,1
4,442,442,6,6,0,1,0
11,444,444,57,18,39,2,1
27,445,445,65,34,31,2,1
16,453,453,74,28,46,3,2
28,467,467,17,17,0,1,0
26,496,496,19,5,14,2,1
14,497,497,5,1,4,2,1
3,499,499,22,22,0,1,0

19,110,110,13,1,12,3,2
13,128,128,15,6,9,4,3
10,155,155,1,1,0,1,0
22,173,173,5,5,0,1,0
7,179,179,28,8,20,3,2
24,179,179,22,22,0,1,0
16,182,182,9,9,0,1,0
18,184,184,2,2,0,1,0
8,205,205,5,5,0,1,0
4,236,236,22,22,0,1,0
14,261,261,20,20,0,1,0
1,298,298,18,18,0,1,0
15,303,303,21,21,0,1,0
23,304,304,89,18,71,4,3
25,319,319,56,56,0,1,0
2,323,323,84,63,21,2,1
3,348,348,37,37,0,1,0
11,357,357,92,33,59,4,3
20,376,376,20,20,0,1,0
6,382,382,1,1,0,1,0
0,388,388,1,1,0,1,0
17,399,399,54,54,0,1,0
9,414,414,15,5,10,2,1
12,450,450,17,1,16,2,1
5,464,464,119,119,0,1,0
21,473,473,39,39,0,1,0

10,130,130,20,8,12,4,3
2,130,130,28,2,26,2,1
12,196,196,21,5,16,4,3
11,197,197,23,23,0,1,0
18,220,220,1,1,0,1,0
16,227,227,8,3,5,2,1
21,242,242,51,51,0,1,0
1,245,245,31,13,18,2,1
5,287,287,129,70,59,4,3
9,298,298,17,6,11,2,1
6,300,300,83,83,0,1,0
3,307,307,1,1,0,1,0
8,346,346,13,2,11,3,2
19,376,376,44,4,40,4,3
15,384,384,43,43,0,1,0
20,402,402,122,98,24,4,3
7,403,403,16,6,10,3,2
14,427,427,12,9,3,2,1
17,431,431,28,28,0,1,0
4,455,455,68,46,22,2,1
0,477,477,1,1,0,1,0
13,486,486,8,8,0,1,0

4,107,107,2,2,0,1,0
28,118,118,15,11,4,2,1
22,131,131,25,25,0,1,0
29,136,136,2,2,0,1,0
20,138,138,9,9,0,1,0
12,161,161,6,6,0,1,0
2,172,172,38,38,0,1,0
32,176,176,28,28,0,1,0
0,202,202,6,3,3,2,1
23,202,202,14,4,10,3,2
27,252,252,10,10,0,1,0
31,254,254,6,6,0,1,0
6,272,272,79,79,0,1,0
15,282,282,17,10,7,2,1
25,294,294,17,17,0,1,0
5,316,316,1,1,0,1,0
7,318,318,24,24,0,1,0
18,361,361,1,1,0,1,0
13,366,366,5,2,3,2,1
30,368,368,85,85,0,1,0
3,385,385,27,9,18,4,3
19,389,389,25,7,18,2,1
14,409,409,40,12,28,3,2
24,418,418,108,41,67,4,3
16,442,442,30,6,24,4,3
11,443,443,5,1,4,2,1
21,448,448,39,39,0,1,0
10,449,449,14,14,0,1,0
1,460,460,11,11,0,1,0
8,490,490,40,21,19,2,1
26,490,490,10,10,0,1,0
17,498,498,7,1,6,3,2
9,499,499,43,1,42,3,2

19,101,101,10,2,8,2,1
22,120,120,1,1,0,1,0
3,126,126,11,5,6,2,1
14,195,195,27,17,10,2,1
10,217,217,19,3,16,2,1
20,234,234,26,10,16,2,1
1,257,257,18,18,0,1,0
17,301,301,55,5,50,4,3
7,340,340,47,10,37,2,1
21,346,346,37,37,0,1,0
4,348,348,38,2,36,3,2
11,348,348,12,6,6,3,2
5,362,362,5,5,0,1,0
23,369,369,68,65,3,2,1
2,377,377,4,4,0,1,0
8,381,381,90,18,72,3,2
6,390,390,16,16,0,1,0
12,406,406,8,4,4,2,1
15,414,414,19,19,0,1,0
9,452,452,4,4,0,1,0
13,453,453,41,41,0,1,0
0,468,468,234,194,40,3,2
18,485,485,55,55,0,1,0
16,488,488,95,3,92,4,3

9,100,100,39,7,32,3,2
13,120,120,6,2,4,2,1
14,132,132,1,1,0,1,0
10,149,149,45,9,36,2,1
2,151,151,43,43,0,1,0
16,159,159,5,5,0,1,0
5,173,173,1,1,0,1,0
0,175,175,11,1,10,3,2
8,182,182,7,7,0,1,0
21,184,184,39,39,0,1,0
3,203,203,27,27,0,1,0
1,241,241,28,28,0,1,0
17,254,254,3,3,0,1,0
20,282,282,64,5,59,4,3
6,295,295,6,6,0,1,0
4,334,334,2,2,0,1,0
7,346,346,86,86,0,1,0
19,359,359,6,6,0,1,0
15,379,379,50,50,0,1,0
22,390,390,43,43,0,1,0
18,428,428,12,3,9,4,3
11,447,447,54,54,0,1,0
12,472,472,40,24,16,3,2

27,101,101,1,1,0,1,0
11,116,116,36,22,14,2,1
16,145,145,18,7,11,2,1
7,167,167,28,22,6,2,1
24,178,178,39,39,0,1,0
1,179,179,3,3,0,1,0
17,191,191,5,5,0,1,0
18,205,205,1,1,0,1,0
19,208,208,27,12,15,2,1
15,233,233,67,67,0,1,0
0,267,267,11,3,8,2,1
25,267,267,50,50,0,1,0
6,277,277,19,12,7,2,1
14,278,278,19,19,0,1,0
21,278,278,40,40,0,1,0
20,286,286,12,12,0,1,0
3,290,290,48,48,0,1,0
9,376,376,32,11,21,2,1
23,386,386,10,10,0,1,0
2,388,388,45,34,11,3,2
13,417,417,3,3,0,1,0
8,426,426,5,2,3,2,1
22,446,446,4,4,0,1,0
12,470,470,3,3,0,1,0
5,476,476,4,4,0,1,0
10,476,476,50,6,44,2,1
4,487,487,61,61,0,1,0
26,498,498,63,12,51,4,3

7,105,105,21,11,10,3,2
9,114,114,5,5,0,1,0
10,126,126,2,2,0,1,0
13,172,172,19,19,0,1,0
21,205,205,15,1,14,4,3
11,214,214,36,36,0,1,0
1,223,223,7,7,0,1,0
4,238,238,32,13,19,2,1
18,265,265,16,2,14,2,1
0,286,286,13,3,10,3,2
15,302,302,24,5,19,2,1
14,303,303,5,1,4,2,1
12,322,322,4,4,0,1,0
5,329,329,9,5,4,2,1
24,339,339,6,6,0,1,0
8,364,364,7,7,0,1,0
2,390,390,121,114,7,2,1
19,393,393,63,63,0,1,0
3,410,410,45,45,0,1,0
26,424,424,13,10,3,2,1
20,437,437,73,73,0,1,0
6,458,458,26,26,0,1,0
25,461,461,7,3,4,2,1
23,472,472,41,13,28,3,2
17,484,484,111,111,0,1,0
22,489,489,50,8,42,3,2
27,491,491,72,48,24,2,1
16,497,497,74,22,52,4,3

2,104,104,8,8,0,1,0
19,119,119,5,5,0,1,0
11,151,151,7,7,0,1,0
6,174,174,64,64,0,1,0
0,230,230,25,4,21,2,1
15,248,248,65,65,0,1,0
12,251,251,3,3,0,1,0
16,268,268,41,11,30,3,2
3,278,278,38,38,0,1,0
4,279,279,62,33,29,2,1
13,283,283,7,7,0,1,0
14,310,310,55,17,38,3,2
8,322,322,11,11,0,1,0
5,360,360,96,24,72,3,2
17,363,363,17,7,10,3,2
9,374,374,66,40,26,3,2
7,444,444,5,5,0,1,0
10,458,458,64,28,36,3,2
1,468,468,57,57,0,1,0
18,488,488,99,55,44,3,2

8,133,133,1,1,0,1,0
0,146,146,11,11,0,1,0
12,167,167,15,15,0,1,0
13,177,177,3,3,0,1,0
16,197,197,9,1,8,2,1
10,215,215,26,4,22,2,1
3,241,241,26,18,8,2,1
22,253,253,24,9,15,4,3
17,327,327,8,8,0,1,0
4,336,336,43,38,5,2,1
5,343,343,40,40,0,1,0
20,366,366,23,17,6,2,1
2,370,370,70,70,0,1,0
11,378,378,106,44,62,3,2
9,393,393,53,8,45,3,2
1,398,398,37,6,31,4,3
21,399,399,8,8,0,1,0
6,408,408,174,126,48,4,3
15,409,409,90,90,0,1,0
14,416,416,38,10,28,3,2
18,423,423,56,56,0,1,0
19,447,447,53,53,0,1,0
7,494,494,11,11,0,1,0

20,149,149,5,5,0,1,0
27,153,153,9,9,0,1,0
6,162,162,9,9,0,1,0
16,180,180,36,14,22,3,2
14,202,202,25,25,0,1,0
8,206,206,1,1,0,1,0
3,223,223,8,2,6,3,2
1,236,236,65,65,0,1,0
18,236,236,10,3,7,2,1
22,252,252,7,7,0,1,0
4,268,268,1,1,0,1,0
26,272,272,116,89,27,4,3
12,281,281,17,17,0,1,0
9,292,292,3,3,0,1,0
25,314,314,5,5,0,1,0
7,320,320,23,3,20,4,3
5,326,326,43,37,6,3,2
23,335,335,12,12,0,1,0
13,356,356,11,11,0,1,0
21,374,374,56,5,51,4,3
0,381,381,63,63,0,1,0
17,399,399,38,23,15,4,3
11,419,419,11,3,8,3,2
19,454,454,72,72,0,1,0
2,458,458,11,4,7,2,1
10,471,471,133,103,30,3,2
15,474,474,22,22,0,1,0
24,498,498,15,15,0,1,0

14,105,105,2,2,0,1,0
17,107,107,5,5,0,1,0
1,126,126,6,1,5,2,1
13,137,137,21,21,0,1,0
28,155,155,12,12,0,1,0
10,205,205,6,6,0,1,0
21,221,221,22,11,11,2,1
25,227,227,23,23,0,1,0
7,266,266,66,2,64,4,3
26,282,282,10,10,0,1,0
16,287,287,28,10,18,4,3
12,322,322,8,8,0,1,0
6,327,327,41,41,0,1,0
3,344,344,2,2,0,1,0
18,350,350,57,40,17,2,1
15,356,356,4,4,0,1,0
29,371,371,8,8,0,1,0
2,380,380,32,32,0,1,0
8,382,382,25,25,0,1,0
11,399,399,33,33,0,1,0
27,402,402,4,1,3,2,1
20,422,422,106,106,0,1,0
19,439,439,38,29,9,4,3
4,450,450,54,47,7,2,1
30,454,454,12,12,0,1,0
9,455,455,13,13,0,1,0
23,456,456,19,11,8,3,2
22,457,457,39,39,0,1,0
24,465,465,149,70,79,4,3
0,475,475,22,2,20,4,3
5,492,492,32,8,24,4,3

8,104,104,3,3,0,1,0
26,123,123,12,12,0,1,0
5,124,124,16,4,12,3,2
12,147,147,1,1,0,1,0
21,156,156,15,15,0,1,0
14,171,171,1,1,0,1,0
22,178,178,7,7,0,1,0
20,203,203,2,2,0,1,0
25,209,209,95,56,39,4,3
19,222,222,20,2,18,2,1
16,238,238,32,23,9,2,1
28,251,251,8,8,0,1,0
17,259,259,1,1,0,1,0
0,262,262,31,31,0,1,0
7,270,270,19,19,0,1,0
6,271,271,47,20,27,4,3
15,278,278,14,14,0,1,0
24,332,332,49,49,0,1,0
29,333,333,22,8,14,4,3
1,352,352,35,25,10,3,2
3,356,356,43,43,0,1,0
4,367,367,32,32,0,1,0
27,372,372,20,20,0,1,0
13,381,381,7,1,6,2,1
18,387,387,91,64,27,2,1
11,403,403,19,19,0,1,0
9,423,423,51,22,29,4,3
2,435,435,24,24,0,1,0
10,437,437,16,16,0,1,0
23,455,455,2,2,0,1,0

14,122,122,30,15,15,2,1
2,127,127,18,18,0,1,0
17,140,140,5,5,0,1,0
16,197,197,55,55,0,1,0
15,207,207,17,5,12,2,1
8,215,215,25,25,0,1,0
21,229,229,7,7,0,1,0
22,240,240,1,1,0,1,0
23,240,240,21,7,14,2,1
24,246,246,20,3,17,2,1
10,263,263,12,2,10,3,2
20,275,275,8,8,0,1,0
0,317,317,52,52,0,1,0
3,354,354,18,4,14,3,2
19,358,358,74,74,0,1,0
5,363,363,1,1,0,1,0
18,374,374,34,13,21,4,3
13,377,377,48,48,0,1,0
9,380,380,4,1,3,2,1
4,385,385,12,7,5,2,1
26,394,394,24,24,0,1,0
25,399,399,38,38,0,1,0
27,416,416,64,17,47,2,1
12,448,448,11,11,0,1,0
7,450,450,2,2,0,1,0
1,460,460,63,52,11,2,1
6,464,464,27,27,0,1,0
28,487,487,83,83,0,1,0
11,497,497,30,3,27,4,3

19,120,120,3,3,0,1,0
10,137,137,3,3,0,1,0
30,140,140,8,3,5,2,1
24,145,145,6,6,0,1,0
4,163,163,10,10,0,1,0
1,172,172,9,9,0,1,0
2,185,185,11,11,0,1,0
23,213,213,17,17,0,1,0
11,227,227,6,6,0,1,0
15,231,231,14,7,7,2,1
18,237,237,17,17,0,1,0
26,242,242,61,50,11,2,1
17,273,273,8,8,0,1,0
20,276,276,22,17,5,2,1
21,283,283,18,18,0,1,0
25,312,312,48,14,34,2,1
7,330,330,80,80,0,1,0
14,337,337,1,1,0,1,0
27,341,341,5,5,0,1,0
8,343,343,29,4,25,2,1
13,350,350,27,27,0,1,0
6,376,376,21,2,19,2,1
9,383,383,22,1,21,2,1
22,402,402,82,43,39,4,3
5,408,408,74,74,0,1,0
3,420,420,64,64,0,1,0
29,436,436,29,29,0,1,0
16,458,458,23,11,12,3,2
0,463,463,12,5,7,2,1
12,466,466,28,28,0,1,0
28,491,491,110,11,99,4,3

