6,115,115,11,1,10,3,2
5,128,128,30,30,0,1,0
17,186,186,6,3,3,2,1
29,199,199,12,2,10,3,2
7,201,201,15,3,12,3,2
1,214,214,14,8,6,3,2
8,232,232,68,36,32,2,1
23,270,270,64,14,50,4,3
20,272,272,50,30,20,2,1
11,273,273,14,14,0,1,0
31,276,276,59,39,20,3,2
13,292,292,18,18,0,1,0
10,294,294,24,4,20,4,3
19,301,301,7,7,0,1,0
27,308,308,40,40,0,1,0
21,319,319,32,32,0,1,0
12,323,323,34,34,0,1,0
22,341,341,26,6,20,4,3
2,363,363,16,7,9,4,3
16,369,369,17,6,11,2,1
0,379,379,36,23,13,2,1
32,392,392,4,4,0,1,0
25,398,398,61,61,0,1,0
24,402,402,84,84,0,1,0
26,406,406,23,23,0,1,0
18,410,410,14,14,0,1,0
15,410,410,53,53,0,1,0
3,410,410,7,7,0,1,0
28,420,420,8,4,4,2,1
9,427,427,47,29,18,2,1
4,427,427,66,8,58,3,2
14,476,476,42,42,0,1,0
30,492,492,68,68,0,1,0

19,101,101,46,46,0,1,0
27,102,102,3,3,0,1,0
3,103,103,1,1,0,1,0
22,110,110,17,17,0,1,0
6,153,153,6,6,0,1,0
16,166,166,3,3,0,1,0
35,176,176,16,2,14,3,2
10,180,180,1,1,0,1,0
13,189,189,14,3,11,4,3
29,192,192,4,4,0,1,0
8,194,194,11,11,0,1,0
20,194,194,16,5,11,3,2
24,229,229,89,31,58,4,3
23,229,229,13,13,0,1,0
18,230,230,21,21,0,1,0
30,236,236,3,3,0,1,0
17,248,248,54,54,0,1,0
34,259,259,44,44,0,1,0
2,269,269,5,5,0,1,0
1,281,281,70,33,37,2,1
21,288,288,1,1,0,1,0
14,294,294,45,30,15,2,1
33,295,295,13,13,0,1,0
25,296,296,7,7,0,1,0
32,314,314,1,1,0,1,0
11,338,338,38,38,0,1,0
12,370,370,40,15,25,2,1
15,396,396,24,24,0,1,0
31,435,435,10,10,0,1,0
26,437,437,53,53,0,1,0
4,440,440,1,1,0,1,0
5,441,441,14,14,0,1,0
28,457,457,25,22,3,2,1
0,469,469,152,101,51,4,3
7,493,493,27,27,0,1,0
9,493,493,36,36,0,1,0

31,120,120,2,2,0,1,0
6,132,132,4,4,0,1,0
11,149,149,2,2,0,1,0
0,157,157,26,5,21,4,3
32,157,157,12,12,0,1,0
13,162,162,3,3,0,1,0
30,165,165,12,12,0,1,0
17,192,192,67,50,17,2,1
21,192,192,25,11,14,3,2
19,194,194,25,10,15,2,1
9,206,206,14,9,5,2,1
26,215,215,1,1,0,1,0
15,226,226,2,2,0,1,0
34,252,252,21,5,16,2,1
29,252,252,10,4,6,3,2
4,260,260,6,6,0,1,0
3,262,262,17,7,10,3,2
24,267,267,55,34,21,3,2
1,269,269,2,2,0,1,0
25,275,275,44,11,33,4,3
28,284,284,5,5,0,1,0
5,284,284,11,11,0,1,0
7,300,300,135,37,98,3,2
12,316,316,20,20,0,1,0
23,331,331,56,56,0,1,0
2,364,364,13,13,0,1,0
33,365,365,67,67,0,1,0
8,396,396,33,33,0,1,0
20,400,400,73,55,18,2,1
22,434,434,63,44,19,4,3
18,441,441,27,11,16,3,2
10,447,447,13,4,9,4,3
16,469,469,56,28,28,2,1
27,482,482,25,1,24,3,2
14,484,484,66,14,52,4,3

25,127,127,7,7,0,1,0
12,163,163,2,2,0,1,0
18,187,187,14,4,10,3,2
37,189,189,4,1,3,2,1
42,198,198,49,45,4,2,1
23,202,202,3,3,0,1,0
28,221,221,32,32,0,1,0
0,230,230,11,11,0,1,0
39,263,263,25,25,0,1,0
34,264,264,47,47,0,1,0
36,271,271,23,5,18,3,2
20,273,273,2,2,0,1,0
21,281,281,143,107,36,4,3
7,283,283,12,12,0,1,0
14,306,306,44,6,38,2,1
9,307,307,29,4,25,2,1
41,309,309,6,1,5,2,1
29,320,320,33,3,30,2,1
3,321,321,11,2,9,2,1
15,323,323,1,1,0,1,0
4,342,342,47,47,0,1,0
1,344,344,29,29,0,1,0
27,348,348,28,28,0,1,0
8,359,359,21,21,0,1,0
30,360,360,9,9,0,1,0
38,361,361,15,15,0,1,0
43,377,377,105,105,0,1,0
16,386,386,34,34,0,1,0
40,388,388,59,59,0,1,0
2,394,394,11,4,7,2,1
10,403,403,14,14,0,1,0
33,404,404,49,49,0,1,0
31,413,413,12,1,11,2,1
19,425,425,1,1,0,1,0
22,444,444,34,34,0,1,0
17,447,447,2,2,0,1,0
26,449,449,9,9,0,1,0
6,455,455,6,6,0,1,0
11,470,470,10,10,0,1,0
24,475,475,14,14,0,1,0
32,480,480,18,1,17,2,1
35,484,484,31,31,0,1,0
5,484,484,4,1,3,2,1
13,488,488,27,27,0,1,0

12,109,109,12,12,0,1,0
6,122,122,1,1,0,1,0
20,134,134,7,7,0,1,0
18,150,150,81,18,63,4,3
32,152,152,25,15,10,2,1
11,168,168,9,9,0,1,0
3,180,180,53,32,21,2,1
13,210,210,137,137,0,1,0
2,231,231,11,2,9,2,1
30,232,232,7,7,0,1,0
24,255,255,13,13,0,1,0
8,274,274,9,9,0,1,0
16,276,276,26,26,0,1,0
28,277,277,11,7,4,2,1
17,289,289,9,9,0,1,0
0,302,302,15,15,0,1,0
19,332,332,24,24,0,1,0
4,340,340,16,16,0,1,0
27,349,349,39,27,12,4,3
21,363,363,42,42,0,1,0
25,394,394,18,18,0,1,0
9,395,395,31,31,0,1,0
15,403,403,2,2,0,1,0
29,413,413,35,6,29,2,1
10,428,428,17,13,4,2,1
14,431,431,9,4,5,2,1
23,446,446,9,1,8,2,1
22,448,448,30,30,0,1,0
26,473,473,99,21,78,4,3
31,481,481,2,2,0,1,0
1,482,482,43,43,0,1,0
7,483,483,51,9,42,2,1
5,492,492,33,19,14,3,2

37,103,103,2,2,0,1,0
17,113,113,9,9,0,1,0
0,128,128,22,10,12,2,1
24,130,130,10,10,0,1,0
27,165,165,9,9,0,1,0
9,190,190,5,5,0,1,0
26,210,210,25,25,0,1,0
5,217,217,1,1,0,1,0
32,232,232,27,27,0,1,0
14,238,238,11,5,6,3,2
25,244,244,66,20,46,2,1
15,244,244,20,20,0,1,0
39,248,248,30,3,27,4,3
3,265,265,9,9,0,1,0
31,276,276,35,35,0,1,0
35,287,287,29,29,0,1,0
22,297,297,14,5,9,2,1
33,297,297,5,1,4,2,1
16,311,311,17,3,14,2,1
18,315,315,21,21,0,1,0
13,319,319,74,22,52,3,2
23,337,337,14,14,0,1,0
28,342,342,20,6,14,2,1
8,354,354,13,13,0,1,0
30,354,354,6,1,5,2,1
38,363,363,30,30,0,1,0
7,365,365,33,14,19,2,1
6,373,373,2,2,0,1,0
4,391,391,20,20,0,1,0
2,393,393,26,2,24,3,2
19,393,393,34,34,0,1,0
1,402,402,68,17,51,4,3
11,406,406,3,3,0,1,0
12,444,444,76,14,62,4,3
20,448,448,31,31,0,1,0
36,454,454,48,48,0,1,0
21,456,456,5,2,3,2,1
29,479,479,114,78,36,4,3
10,491,491,46,46,0,1,0
34,497,497,80,80,0,1,0

16,142,142,21,8,13,2,1
4,159,159,12,8,4,2,1
1,163,163,5,5,0,1,0
28,171,171,30,30,0,1,0
5,179,179,25,6,19,2,1
8,182,182,8,3,5,2,1
13,187,187,36,36,0,1,0
15,188,188,4,1,3,2,1
14,200,200,13,13,0,1,0
35,204,204,46,14,32,4,3
2,219,219,13,13,0,1,0
23,232,232,4,4,0,1,0
36,233,233,5,5,0,1,0
11,266,266,15,15,0,1,0
12,267,267,24,24,0,1,0
33,287,287,3,3,0,1,0
26,289,289,12,12,0,1,0
6,291,291,17,17,0,1,0
0,292,292,10,6,4,2,1
38,330,330,8,8,0,1,0
18,333,333,6,1,5,2,1
10,337,337,68,68,0,1,0
7,346,346,17,5,12,4,3
32,350,350,98,92,6,2,1
24,353,353,20,2,18,2,1
31,353,353,54,15,39,2,1
25,366,366,63,25,38,2,1
17,378,378,7,7,0,1,0
21,396,396,19,19,0,1,0
3,402,402,83,60,23,2,1
29,410,410,12,12,0,1,0
20,413,413,23,23,0,1,0
9,421,421,13,1,12,2,1
34,423,423,14,14,0,1,0
22,426,426,107,63,44,3,2
30,437,437,63,63,0,1,0
27,438,438,14,14,0,1,0
37,482,482,28,28,0,1,0
19,490,490,29,23,6,2,1

9,101,101,10,4,6,2,1
6,118,118,9,6,3,2,1
11,119,119,5,5,0,1,0
24,120,120,13,8,5,2,1
15,128,128,22,22,0,1,0
23,135,135,14,14,0,1,0
0,147,147,1,1,0,1,0
7,148,148,9,9,0,1,0
35,166,166,3,3,0,1,0
20,178,178,96,36,60,4,3
16,186,186,9,1,8,2,1
4,189,189,3,3,0,1,0
13,212,212,39,39,0,1,0
19,212,212,21,13,8,3,2
10,227,227,12,2,10,3,2
8,261,261,31,31,0,1,0
33,267,267,3,3,0,1,0
26,276,276,2,2,0,1,0
18,283,283,53,34,19,3,2
1,286,286,30,30,0,1,0
5,305,305,9,9,0,1,0
28,305,305,74,34,40,2,1
27,307,307,2,2,0,1,0
36,352,352,14,14,0,1,0
2,355,355,1,1,0,1,0
17,358,358,2,2,0,1,0
21,366,366,2,2,0,1,0
31,402,402,76,76,0,1,0
34,404,404,10,4,6,2,1
3,408,408,115,115,0,1,0
14,414,414,3,3,0,1,0
29,419,419,24,24,0,1,0
12,429,429,47,2,45,2,1
25,459,459,19,5,14,3,2
32,485,485,43,12,31,2,1
30,492,492,82,27,55,4,3
22,500,500,43,16,27,4,3

11,100,100,1,1,0,1,0
23,103,103,11,11,0,1,0
13,120,120,1,1,0,1,0
5,124,124,11,11,0,1,0
32,137,137,1,1,0,1,0
2,144,144,1,1,0,1,0
38,146,146,7,7,0,1,0
12,152,152,17,17,0,1,0
42,163,163,1,1,0,1,0
19,168,168,3,3,0,1,0
21,181,181,14,14,0,1,0
26,189,189,3,3,0,1,0
37,195,195,44,4,40,2,1
3,199,199,10,1,9,4,3
33,221,221,10,10,0,1,0
40,233,233,38,38,0,1,0
6,238,238,9,1,8,2,1
16,243,243,9,9,0,1,0
41,243,243,11,11,0,1,0
14,245,245,12,5,7,2,1
4,250,250,7,7,0,1,0
9,280,280,18,4,14,3,2
34,281,281,73,21,52,4,3
27,291,291,25,25,0,1,0
43,300,300,2,2,0,1,0
0,304,304,35,35,0,1,0
7,318,318,23,4,19,4,3
29,324,324,10,2,8,3,2
30,336,336,71,15,56,3,2
39,347,347,22,22,0,1,0
22,348,348,16,4,12,4,3
25,355,355,25,16,9,2,1
24,368,368,5,5,0,1,0
10,390,390,104,104,0,1,0
20,404,404,50,50,0,1,0
17,407,407,10,10,0,1,0
35,411,411,50,50,0,1,0
31,459,459,19,19,0,1,0
18,469,469,34,34,0,1,0
15,476,476,8,2,6,3,2
1,486,486,9,9,0,1,0
36,495,495,35,35,0,1,0
8,495,495,75,24,51,4,3
28,500,500,152,152,0,1,0

26,110,110,4,4,0,1,0
28,151,151,10,10,0,1,0
8,161,161,54,54,0,1,0
19,187,187,22,22,0,1,0
12,197,197,12,12,0,1,0
10,201,201,29,20,9,4,3
33,214,214,31,31,0,1,0
27,215,215,20,7,13,2,1
13,230,230,6,1,5,2,1
9,237,237,2,2,0,1,0
25,241,241,37,34,3,2,1
21,251,251,10,10,0,1,0
31,253,253,8,2,6,3,2
0,274,274,32,8,24,2,1
15,284,284,48,20,28,3,2
20,295,295,31,8,23,2,1
6,303,303,32,32,0,1,0
29,335,335,61,13,48,4,3
23,338,338,12,5,7,2,1
3,361,361,12,9,3,2,1
1,362,362,4,1,3,2,1
5,377,377,51,42,9,4,3
24,378,378,31,31,0,1,0
17,398,398,36,36,0,1,0
30,401,401,24,13,11,2,1
2,458,458,85,85,0,1,0
18,458,458,79,79,0,1,0
22,464,464,73,73,0,1,0
14,466,466,13,5,8,3,2
16,470,470,16,12,4,2,1
4,477,477,69,69,0,1,0
11,478,478,22,22,0,1,0
7,481,481,56,20,36,2,1
32,495,495,81,81,0,1,0

28,115,115,16,4,12,2,1
10,119,119,10,10,0,1,0
31,122,122,14,14,0,1,0
26,128,128,27,15,12,3,2
34,150,150,12,12,0,1,0
35,154,154,43,43,0,1,0
25,162,162,22,16,6,2,1
21,163,163,2,2,0,1,0
13,206,206,7,7,0,1,0
9,218,218,2,2,0,1,0
14,220,220,1,1,0,1,0
33,231,231,18,10,8,2,1
6,273,273,75,75,0,1,0
15,274,274,9,9,0,1,0
29,280,280,5,5,0,1,0
24,280,280,10,10,0,1,0
19,284,284,2,2,0,1,0
3,290,290,41,41,0,1,0
22,295,295,9,9,0,1,0
18,296,296,47,47,0,1,0
1,305,305,9,9,0,1,0
36,307,307,9,2,7,3,2
5,322,322,1,1,0,1,0
16,329,329,3,3,0,1,0
11,331,331,63,63,0,1,0
0,333,333,3,3,0,1,0
8,344,344,4,4,0,1,0
23,367,367,35,7,28,2,1
30,367,367,31,31,0,1,0
7,379,379,121,121,0,1,0
20,394,394,81,48,33,2,1
27,408,408,115,115,0,1,0
12,411,411,43,43,0,1,0
17,434,434,4,4,0,1,0
4,436,436,12,9,3,2,1
32,439,439,4,4,0,1,0
38,456,456,29,8,21,2,1
37,487,487,24,15,9,4,3
2,492,492,11,11,0,1,0

12,105,105,1,1,0,1,0
34,107,107,1,1,0,1,0
22,129,129,4,4,0,1,0
36,155,155,29,29,0,1,0
0,211,211,1,1,0,1,0
25,224,224,98,79,19,2,1
11,225,225,5,2,3,2,1
5,226,226,13,13,0,1,0
7,236,236,1,1,0,1,0
35,240,240,6,6,0,1,0
15,241,241,9,9,0,1,0
13,247,247,4,1,3,2,1
19,252,252,51,51,0,1,0
37,259,259,7,1,6,3,2
10,270,270,37,37,0,1,0
14,275,275,20,20,0,1,0
28,280,280,33,11,22,3,2
6,281,281,77,31,46,2,1
31,281,281,9,9,0,1,0
1,285,285,44,8,36,4,3
4,293,293,36,36,0,1,0
38,305,305,5,2,3,2,1
24,323,323,98,98,0,1,0
3,330,330,33,1,32,2,1
29,353,353,91,91,0,1,0
21,354,354,79,63,16,3,2
2,375,375,8,8,0,1,0
32,377,377,49,12,37,2,1
9,393,393,2,2,0,1,0
26,396,396,8,3,5,2,1
17,398,398,56,20,36,4,3
8,406,406,2,2,0,1,0
23,412,412,6,1,5,2,1
16,421,421,15,15,0,1,0
33,440,440,1,1,0,1,0
27,464,464,30,30,0,1,0
30,469,469,27,27,0,1,0
18,485,485,18,10,8,3,2
20,492,492,9,9,0,1,0

11,120,120,12,12,0,1,0
13,129,129,12,12,0,1,0
35,160,160,47,47,0,1,0
18,174,174,4,4,0,1,0
9,177,177,1,1,0,1,0
22,187,187,25,1,24,2,1
38,191,191,4,4,0,1,0
2,200,200,2,2,0,1,0
29,209,209,27,27,0,1,0
12,217,217,16,10,6,3,2
19,234,234,28,12,16,3,2
21,251,251,1,1,0,1,0
0,258,258,19,3,16,3,2
14,261,261,25,25,0,1,0
4,266,266,16,5,11,4,3
26,282,282,1,1,0,1,0
15,283,283,14,14,0,1,0
27,283,283,27,3,24,2,1
3,285,285,37,37,0,1,0
24,286,286,17,3,14,3,2
1,294,294,13,5,8,2,1
39,296,296,50,50,0,1,0
25,308,308,5,5,0,1,0
28,309,309,14,14,0,1,0
31,312,312,62,24,38,3,2
36,323,323,61,61,0,1,0
8,384,384,27,9,18,2,1
20,387,387,81,54,27,4,3
34,396,396,33,9,24,3,2
37,404,404,12,12,0,1,0
7,405,405,39,36,3,2,1
16,419,419,15,2,13,4,3
10,419,419,4,4,0,1,0
32,422,422,69,56,13,2,1
6,452,452,21,21,0,1,0
17,455,455,55,1,54,4,3
23,455,455,1,1,0,1,0
5,458,458,46,46,0,1,0
33,464,464,5,2,3,2,1
30,476,476,102,32,70,3,2

10,106,106,17,17,0,1,0
24,116,116,11,11,0,1,0
8,120,120,1,1,0,1,0
26,122,122,19,7,12,4,3
31,157,157,9,9,0,1,0
7,164,164,18,5,13,2,1
13,166,166,36,8,28,3,2
18,168,168,4,4,0,1,0
11,188,188,18,18,0,1,0
22,196,196,23,18,5,2,1
23,217,217,25,2,23,3,2
14,218,218,48,30,18,2,1
30,276,276,32,15,17,2,1
28,284,284,22,6,16,2,1
27,297,297,47,16,31,2,1
15,300,300,3,3,0,1,0
0,308,308,25,25,0,1,0
21,318,318,32,32,0,1,0
29,321,321,2,2,0,1,0
25,329,329,62,14,48,3,2
6,335,335,2,2,0,1,0
12,359,359,67,20,47,4,3
5,376,376,32,32,0,1,0
17,379,379,47,27,20,3,2
2,391,391,71,1,70,4,3
19,395,395,76,21,55,3,2
16,407,407,12,12,0,1,0
20,412,412,36,36,0,1,0
32,423,423,40,1,39,4,3
4,434,434,16,16,0,1,0
9,495,495,49,13,36,2,1
1,498,498,95,11,84,3,2
3,500,500,6,6,0,1,0

23,117,117,1,1,0,1,0
22,122,122,7,7,0,1,0
27,140,140,11,11,0,1,0
12,143,143,2,2,0,1,0
37,158,158,7,2,5,2,1
10,161,161,3,3,0,1,0
25,167,167,9,9,0,1,0
0,168,168,13,5,8,2,1
5,169,169,5,5,0,1,0
8,172,172,1,1,0,1,0
11,188,188,3,3,0,1,0
29,194,194,73,57,16,3,2
21,201,201,13,13,0,1,0
1,206,206,1,1,0,1,0
7,217,217,1,1,0,1,0
20,217,217,1,1,0,1,0
28,222,222,21,6,15,2,1
16,226,226,20,20,0,1,0
9,226,226,2,2,0,1,0
3,226,226,73,73,0,1,0
38,234,234,3,3,0,1,0
15,251,251,39,18,21,2,1
19,264,264,2,2,0,1,0
17,265,265,92,60,32,4,3
2,282,282,16,12,4,2,1
35,313,313,50,14,36,4,3
6,330,330,16,16,0,1,0
14,332,332,57,20,37,2,1
26,341,341,63,63,0,1,0
32,345,345,6,1,5,2,1
18,353,353,14,4,10,2,1
24,361,361,15,8,7,2,1
34,381,381,85,64,21,2,1
33,385,385,3,3,0,1,0
13,405,405,33,7,26,2,1
31,416,416,123,30,93,4,3
4,417,417,55,17,38,3,2
36,432,432,16,6,10,3,2
30,487,487,24,4,20,3,2

32,101,101,9,9,0,1,0
2,106,106,5,2,3,2,1
5,122,122,17,8,9,4,3
19,130,130,4,4,0,1,0
27,139,139,6,6,0,1,0
16,142,142,4,1,3,2,1
13,155,155,2,2,0,1,0
15,167,167,37,37,0,1,0
6,167,167,18,18,0,1,0
20,185,185,17,1,16,2,1
29,188,188,45,19,26,2,1
28,193,193,2,2,0,1,0
14,213,213,2,2,0,1,0
9,221,221,1,1,0,1,0
1,226,226,45,45,0,1,0
4,255,255,37,23,14,3,2
26,256,256,21,21,0,1,0
18,262,262,20,20,0,1,0
22,273,273,18,18,0,1,0
30,278,278,15,2,13,4,3
7,279,279,69,69,0,1,0
0,300,300,85,85,0,1,0
11,307,307,24,24,0,1,0
21,322,322,4,4,0,1,0
8,347,347,5,5,0,1,0
17,349,349,18,18,0,1,0
12,353,353,45,45,0,1,0
3,394,394,4,4,0,1,0
10,398,398,23,23,0,1,0
24,409,409,36,3,33,2,1
23,453,453,210,174,36,2,1
25,462,462,62,62,0,1,0
31,482,482,82,51,31,2,1

41,107,107,9,9,0,1,0
0,131,131,9,3,6,3,2
28,138,138,12,12,0,1,0
13,140,140,6,1,5,2,1
26,146,146,6,2,4,2,1
40,153,153,27,27,0,1,0
35,157,157,1,1,0,1,0
5,168,168,1,1,0,1,0
38,210,210,27,1,26,3,2
43,212,212,55,10,45,4,3
8,223,223,15,15,0,1,0
37,225,225,4,4,0,1,0
16,239,239,2,2,0,1,0
36,241,241,34,34,0,1,0
24,252,252,14,2,12,3,2
17,259,259,8,8,0,1,0
12,260,260,15,15,0,1,0
25,274,274,3,3,0,1,0
45,282,282,72,26,46,3,2
9,286,286,12,12,0,1,0
42,299,299,21,10,11,2,1
29,301,301,18,18,0,1,0
3,302,302,17,3,14,3,2
20,303,303,69,33,36,4,3
15,309,309,12,6,6,2,1
32,310,310,3,3,0,1,0
2,310,310,18,18,0,1,0
11,323,323,7,3,4,2,1
7,327,327,105,105,0,1,0
21,334,334,8,8,0,1,0
31,348,348,95,95,0,1,0
19,356,356,9,9,0,1,0
10,358,358,16,6,10,2,1
30,362,362,32,32,0,1,0
27,387,387,5,5,0,1,0
39,406,406,15,3,12,2,1
6,408,408,24,24,0,1,0
34,409,409,10,5,5,2,1
22,413,413,14,3,11,2,1
33,450,450,4,4,0,1,0
14,462,462,32,32,0,1,0
1,470,470,48,48,0,1,0
23,471,471,3,3,0,1,0
18,485,485,11,11,0,1,0
4,494,494,31,31,0,1,0
44,497,497,45,21,24,4,3

28,104,104,20,17,3,2,1
30,112,112,4,1,3,2,1
33,119,119,8,5,3,2,1
10,125,125,4,4,0,1,0
13,127,127,7,7,0,1,0
9,157,157,2,2,0,1,0
27,187,187,9,9,0,1,0
26,199,199,6,3,3,2,1
3,207,207,17,17,0,1,0
20,218,218,13,3,10,2,1
1,236,236,15,15,0,1,0
15,255,255,5,1,4,2,1
2,256,256,5,5,0,1,0
7,267,267,22,22,0,1,0
29,282,282,2,2,0,1,0
31,309,309,60,60,0,1,0
23,327,327,7,7,0,1,0
0,329,329,50,11,39,4,3
22,349,349,18,9,9,4,3
6,362,362,201,201,0,1,0
17,370,370,73,52,21,2,1
18,374,374,6,6,0,1,0
16,376,376,14,14,0,1,0
32,385,385,25,25,0,1,0
21,386,386,13,2,11,2,1
24,427,427,273,273,0,1,0
5,428,428,141,141,0,1,0
11,437,437,13,1,12,4,3
25,451,451,13,1,12,3,2
12,451,451,37,37,0,1,0
19,452,452,23,2,21,2,1
14,469,469,19,7,12,4,3
4,473,473,21,21,0,1,0
8,489,489,31,31,0,1,0

29,101,101,7,7,0,1,0
14,109,109,4,4,0,1,0
22,120,120,15,15,0,1,0
15,134,134,1,1,0,1,0
21,135,135,5,5,0,1,0
33,137,137,3,3,0,1,0
23,164,164,5,5,0,1,0
10,173,173,14,14,0,1,0
24,209,209,1,1,0,1,0
27,217,217,25,14,11,2,1
25,225,225,38,22,16,2,1
28,250,250,6,6,0,1,0
5,255,255,43,43,0,1,0
9,259,259,9,9,0,1,0
37,271,271,2,2,0,1,0
11,274,274,70,21,49,4,3
12,291,291,68,40,28,3,2
26,292,292,32,32,0,1,0
34,292,292,10,10,0,1,0
13,299,299,2,2,0,1,0
1,302,302,10,10,0,1,0
35,305,305,1,1,0,1,0
32,315,315,64,52,12,3,2
0,324,324,14,14,0,1,0
31,325,325,21,1,20,3,2
36,327,327,76,38,38,2,1
19,334,334,13,13,0,1,0
18,341,341,9,9,0,1,0
7,343,343,1,1,0,1,0
6,346,346,9,1,8,2,1
3,370,370,24,4,20,2,1
20,393,393,74,8,66,3,2
4,422,422,115,41,74,3,2
8,424,424,22,22,0,1,0
16,434,434,15,9,6,2,1
2,453,453,37,37,0,1,0
30,484,484,240,186,54,3,2
17,494,494,6,6,0,1,0

17,110,110,1,1,0,1,0
27,120,120,12,12,0,1,0
29,136,136,41,36,5,2,1
12,143,143,7,1,6,3,2
11,144,144,1,1,0,1,0
24,145,145,3,3,0,1,0
25,159,159,22,7,15,2,1
23,161,161,3,3,0,1,0
33,170,170,42,42,0,1,0
0,171,171,1,1,0,1,0
37,174,174,23,23,0,1,0
22,187,187,16,1,15,2,1
16,194,194,26,13,13,2,1
30,205,205,10,10,0,1,0
2,234,234,21,21,0,1,0
26,235,235,20,20,0,1,0
34,247,247,5,5,0,1,0
20,260,260,8,8,0,1,0
15,261,261,1,1,0,1,0
4,265,265,34,4,30,2,1
10,266,266,3,3,0,1,0
9,273,273,1,1,0,1,0
21,294,294,51,9,42,4,3
36,300,300,6,6,0,1,0
6,308,308,8,8,0,1,0
28,328,328,66,17,49,2,1
8,333,333,2,2,0,1,0
13,368,368,79,34,45,4,3
19,377,377,195,186,9,4,3
18,382,382,6,3,3,2,1
35,406,406,6,6,0,1,0
32,408,408,35,35,0,1,0
31,410,410,19,19,0,1,0
1,412,412,87,87,0,1,0
7,413,413,27,15,12,3,2
3,413,413,57,57,0,1,0
5,492,492,2,2,0,1,0
14,497,497,16,16,0,1,0

27,101,101,2,2,0,1,0
5,105,105,2,2,0,1,0
20,108,108,12,12,0,1,0
12,129,129,5,2,3,2,1
1,135,135,8,8,0,1,0
31,164,164,3,3,0,1,0
24,182,182,5,5,0,1,0
30,183,183,2,2,0,1,0
7,209,209,7,1,6,3,2
28,219,219,19,19,0,1,0
9,227,227,28,18,10,3,2
34,230,230,93,54,39,2,1
19,242,242,9,9,0,1,0
4,243,243,32,5,27,2,1
10,244,244,7,1,6,2,1
8,247,247,21,2,19,2,1
11,256,256,1,1,0,1,0
14,261,261,16,16,0,1,0
2,267,267,1,1,0,1,0
32,278,278,44,44,0,1,0
0,279,279,59,59,0,1,0
21,283,283,8,4,4,2,1
22,284,284,28,28,0,1,0
26,288,288,49,40,9,4,3
29,307,307,79,48,31,4,3
18,335,335,28,18,10,2,1
37,344,344,5,5,0,1,0
13,367,367,46,1,45,2,1
16,395,395,14,7,7,2,1
3,410,410,93,71,22,3,2
6,431,431,12,12,0,1,0
15,442,442,6,1,5,2,1
17,448,448,109,109,0,1,0
23,452,452,30,30,0,1,0
25,455,455,6,1,5,2,1
35,470,470,88,67,21,4,3
33,474,474,40,40,0,1,0
36,486,486,44,44,0,1,0

16,123,123,2,2,0,1,0
20,137,137,8,8,0,1,0
25,143,143,7,7,0,1,0
26,148,148,5,2,3,2,1
23,163,163,21,2,19,3,2
29,196,196,6,6,0,1,0
14,202,202,37,11,26,3,2
2,202,202,37,22,15,4,3
6,226,226,7,7,0,1,0
7,232,232,1,1,0,1,0
8,244,244,1,1,0,1,0
1,261,261,17,17,0,1,0
4,320,320,130,130,0,1,0
9,322,322,32,32,0,1,0
31,322,322,20,14,6,3,2
24,343,343,152,146,6,2,1
22,381,381,2,2,0,1,0
5,383,383,64,64,0,1,0
15,393,393,4,4,0,1,0
30,394,394,161,161,0,1,0
12,406,406,62,62,0,1,0
19,410,410,8,8,0,1,0
0,417,417,37,19,18,4,3
28,421,421,40,40,0,1,0
21,424,424,42,2,40,3,2
17,427,427,29,29,0,1,0
13,431,431,3,3,0,1,0
3,444,444,49,9,40,2,1
18,473,473,39,18,21,4,3
27,476,476,63,63,0,1,0
11,489,489,75,75,0,1,0
10,491,491,22,22,0,1,0

24,107,107,16,8,8,2,1
11,164,164,20,20,0,1,0
10,199,199,22,22,0,1,0
22,201,201,3,3,0,1,0
13,210,210,34,18,16,2,1
27,223,223,6,3,3,2,1
26,260,260,1,1,0,1,0
6,279,279,4,4,0,1,0
4,283,283,44,44,0,1,0
17,284,284,8,8,0,1,0
33,291,291,8,8,0,1,0
2,296,296,23,23,0,1,0
1,298,298,19,19,0,1,0
7,305,305,4,4,0,1,0
28,307,307,83,8,75,4,3
16,311,311,20,20,0,1,0
3,318,318,28,28,0,1,0
20,321,321,108,94,14,2,1
8,328,328,57,57,0,1,0
18,341,341,10,10,0,1,0
12,347,347,26,2,24,3,2
25,349,349,71,71,0,1,0
31,350,350,9,9,0,1,0
9,350,350,42,8,34,2,1
15,397,397,16,3,13,4,3
29,428,428,2,2,0,1,0
14,446,446,45,45,0,1,0
5,456,456,111,13,98,3,2
23,457,457,38,12,26,2,1
34,463,463,181,153,28,2,1
21,463,463,20,20,0,1,0
19,487,487,4,4,0,1,0
32,492,492,25,5,20,2,1
0,496,496,25,19,6,3,2
30,497,497,28,2,26,3,2

27,102,102,2,2,0,1,0
25,103,103,3,3,0,1,0
31,106,106,8,2,6,3,2
33,109,109,4,4,0,1,0
3,112,112,4,4,0,1,0
22,122,122,8,8,0,1,0
11,163,163,1,1,0,1,0
32,164,164,10,10,0,1,0
37,166,166,9,9,0,1,0
7,166,166,1,1,0,1,0
30,175,175,13,1,12,4,3
38,176,176,4,4,0,1,0
39,203,203,121,18,103,4,3
21,209,209,3,3,0,1,0
20,215,215,8,5,3,2,1
10,219,219,26,9,17,2,1
29,229,229,5,2,3,2,1
42,234,234,48,48,0,1,0
19,235,235,2,2,0,1,0
23,251,251,4,4,0,1,0
12,257,257,46,6,40,3,2
5,263,263,9,9,0,1,0
4,263,263,41,5,36,3,2
15,267,267,16,2,14,3,2
16,269,269,4,4,0,1,0
17,277,277,55,55,0,1,0
34,302,302,23,20,3,2,1
1,323,323,3,3,0,1,0
28,336,336,14,6,8,3,2
43,340,340,13,13,0,1,0
14,358,358,7,7,0,1,0
6,375,375,16,16,0,1,0
35,383,383,85,52,33,3,2
2,393,393,22,8,14,2,1
41,398,398,12,12,0,1,0
9,407,407,25,25,0,1,0
0,411,411,12,4,8,3,2
36,412,412,36,14,22,2,1
44,417,417,29,29,0,1,0
8,432,432,7,7,0,1,0
40,439,439,8,8,0,1,0
13,449,449,3,3,0,1,0
18,449,449,1,1,0,1,0
24,453,453,75,75,0,1,0
26,488,488,144,34,110,4,3

4,101,101,11,6,5,2,1
7,108,108,5,5,0,1,0
19,130,130,7,7,0,1,0
18,136,136,10,1,9,2,1
11,137,137,1,1,0,1,0
24,174,174,18,6,12,3,2
5,202,202,126,126,0,1,0
20,206,206,16,16,0,1,0
13,207,207,1,1,0,1,0
23,219,219,10,10,0,1,0
3,237,237,19,19,0,1,0
16,258,258,61,17,44,2,1
14,259,259,77,40,37,2,1
29,273,273,49,49,0,1,0
8,285,285,32,11,21,2,1
26,298,298,73,48,25,2,1
6,315,315,18,18,0,1,0
1,351,351,6,6,0,1,0
9,355,355,22,22,0,1,0
0,391,391,56,56,0,1,0
17,392,392,4,4,0,1,0
12,404,404,22,22,0,1,0
10,408,408,153,93,60,3,2
15,413,413,56,56,0,1,0
25,413,413,34,34,0,1,0
22,429,429,27,1,26,4,3
2,439,439,6,6,0,1,0
28,441,441,10,10,0,1,0
21,447,447,14,14,0,1,0
27,486,486,35,35,0,1,0

32,109,109,3,3,0,1,0
0,117,117,1,1,0,1,0
12,119,119,4,1,3,2,1
26,120,120,6,6,0,1,0
2,128,128,9,9,0,1,0
31,136,136,2,2,0,1,0
37,143,143,22,22,0,1,0
24,149,149,3,3,0,1,0
10,164,164,12,12,0,1,0
23,185,185,10,10,0,1,0
9,186,186,16,16,0,1,0
33,203,203,11,2,9,2,1
36,208,208,8,8,0,1,0
14,212,212,14,14,0,1,0
28,214,214,9,9,0,1,0
5,223,223,19,19,0,1,0
11,226,226,3,3,0,1,0
30,243,243,103,33,70,4,3
35,256,256,58,9,49,2,1
34,264,264,34,2,32,2,1
18,271,271,34,28,6,2,1
6,276,276,29,16,13,2,1
4,307,307,46,46,0,1,0
22,317,317,106,19,87,4,3
3,322,322,53,53,0,1,0
29,337,337,1,1,0,1,0
20,339,339,7,3,4,2,1
15,367,367,62,62,0,1,0
17,372,372,43,43,0,1,0
19,373,373,36,3,33,2,1
8,388,388,6,2,4,2,1
27,408,408,13,9,4,2,1
25,431,431,12,2,10,3,2
7,434,434,46,46,0,1,0
21,445,445,54,54,0,1,0
16,455,455,53,3,50,3,2
13,461,461,25,16,9,2,1
1,483,483,13,13,0,1,0

1,117,117,1,1,0,1,0
16,143,143,23,23,0,1,0
3,148,148,4,4,0,1,0
25,150,150,2,2,0,1,0
9,153,153,6,6,0,1,0
17,164,164,18,18,0,1,0
22,169,169,36,36,0,1,0
2,180,180,23,8,15,4,3
23,237,237,46,10,36,3,2
19,244,244,101,84,17,4,3
15,253,253,1,1,0,1,0
12,269,269,51,22,29,2,1
6,293,293,11,11,0,1,0
31,295,295,8,2,6,3,2
13,304,304,1,1,0,1,0
18,310,310,1,1,0,1,0
11,322,322,22,4,18,4,3
4,336,336,38,38,0,1,0
20,342,342,1,1,0,1,0
0,368,368,77,77,0,1,0
5,373,373,57,40,17,2,1
7,374,374,79,13,66,4,3
30,378,378,6,6,0,1,0
8,388,388,39,13,26,4,3
10,391,391,63,30,33,4,3
24,400,400,52,14,38,4,3
21,414,414,25,3,22,2,1
29,416,416,86,86,0,1,0
28,448,448,37,37,0,1,0
27,489,489,32,32,0,1,0
14,491,491,124,49,75,4,3
26,491,491,15,15,0,1,0

15,122,122,2,2,0,1,0
14,124,124,20,2,18,3,2
12,130,130,30,21,9,4,3
9,161,161,7,7,0,1,0
13,187,187,7,7,0,1,0
4,190,190,23,13,10,3,2
21,193,193,2,2,0,1,0
8,194,194,29,9,20,2,1
6,196,196,25,7,18,2,1
16,199,199,5,5,0,1,0
2,222,222,31,31,0,1,0
3,224,224,28,3,25,2,1
22,226,226,11,1,10,2,1
17,236,236,35,3,32,2,1
0,246,246,17,17,0,1,0
20,253,253,9,1,8,2,1
7,264,264,19,13,6,3,2
18,264,264,11,11,0,1,0
1,278,278,4,4,0,1,0
26,301,301,39,39,0,1,0
24,307,307,22,22,0,1,0
11,357,357,39,39,0,1,0
25,404,404,69,43,26,3,2
19,411,411,23,2,21,3,2
23,414,414,22,8,14,2,1
28,437,437,104,75,29,4,3
27,459,459,120,77,43,2,1
5,466,466,81,59,22,3,2
10,491,491,273,210,63,4,3

15,129,129,5,5,0,1,0
14,131,131,36,15,21,4,3
10,149,149,33,18,15,4,3
26,150,150,6,6,0,1,0
19,152,152,17,17,0,1,0
25,165,165,36,36,0,1,0
20,166,166,17,11,6,2,1
31,176,176,15,4,11,2,1
24,179,179,28,28,0,1,0
29,182,182,17,5,12,4,3
1,186,186,8,8,0,1,0
8,218,218,4,4,0,1,0
16,279,279,34,30,4,2,1
3,285,285,20,1,19,4,3
33,305,305,26,6,20,2,1
21,308,308,83,45,38,3,2
32,360,360,14,14,0,1,0
22,369,369,14,4,10,3,2
23,383,383,23,23,0,1,0
2,385,385,4,4,0,1,0
12,391,391,2,2,0,1,0
30,396,396,51,51,0,1,0
4,408,408,51,51,0,1,0
18,418,418,71,2,69,4,3
34,432,432,4,4,0,1,0
0,438,438,97,16,81,4,3
6,443,443,66,11,55,3,2
17,448,448,4,4,0,1,0
27,450,450,44,34,10,2,1
9,454,454,3,3,0,1,0
11,458,458,57,57,0,1,0
7,481,481,68,52,16,2,1
28,482,482,18,9,9,2,1
13,486,486,51,51,0,1,0
5,494,494,8,1,7,2,1

10,139,139,10,2,8,3,2
4,168,168,30,27,3,2,1
18,177,177,41,37,4,2,1
24,184,184,9,5,4,2,1
16,191,191,27,3,24,3,2
30,197,197,8,5,3,2,1
1,217,217,9,9,0,1,0
29,247,247,31,23,8,3,2
2,254,254,54,33,21,2,1
17,259,259,18,6,12,3,2
27,259,259,60,60,0,1,0
8,295,295,8,8,0,1,0
7,297,297,7,1,6,2,1
5,305,305,33,33,0,1,0
14,305,305,33,33,0,1,0
19,310,310,43,34,9,4,3
31,323,323,12,12,0,1,0
13,333,333,16,16,0,1,0
15,344,344,46,46,0,1,0
6,363,363,40,31,9,2,1
11,367,367,1,1,0,1,0
33,373,373,67,23,44,2,1
23,388,388,29,1,28,3,2
22,392,392,19,8,11,2,1
3,392,392,33,4,29,2,1
20,408,408,64,41,23,2,1
9,413,413,131,55,76,3,2
26,415,415,21,21,0,1,0
12,433,433,9,9,0,1,0
32,440,440,2,2,0,1,0
21,441,441,52,9,43,4,3
25,463,463,62,14,48,4,3
28,471,471,17,17,0,1,0
0,498,498,36,8,28,3,2

20,107,107,1,1,0,1,0
38,160,160,9,9,0,1,0
9,168,168,6,6,0,1,0
11,173,173,101,101,0,1,0
19,177,177,1,1,0,1,0
28,180,180,21,11,10,3,2
2,186,186,10,10,0,1,0
32,202,202,55,55,0,1,0
15,225,225,1,1,0,1,0
3,235,235,21,1,20,3,2
4,244,244,19,19,0,1,0
14,248,248,13,13,0,1,0
18,253,253,9,9,0,1,0
29,258,258,2,2,0,1,0
30,262,262,26,26,0,1,0
23,283,283,42,42,0,1,0
25,291,291,12,12,0,1,0
36,300,300,10,10,0,1,0
35,303,303,97,73,24,3,2
17,305,305,8,2,6,2,1
27,309,309,28,16,12,3,2
0,324,324,3,3,0,1,0
21,335,335,78,42,36,2,1
6,336,336,28,28,0,1,0
31,370,370,46,10,36,2,1
34,373,373,3,3,0,1,0
12,381,381,7,7,0,1,0
22,384,384,59,59,0,1,0
5,407,407,10,10,0,1,0
24,418,418,73,73,0,1,0
37,419,419,16,4,12,4,3
1,420,420,3,3,0,1,0
16,423,423,60,60,0,1,0
33,429,429,6,2,4,2,1
10,449,449,43,26,17,2,1
13,456,456,12,12,0,1,0
7,471,471,18,18,0,1,0
26,490,490,16,16,0,1,0
8,495,495,24,9,15,2,1

23,120,120,5,5,0,1,0
16,148,148,8,4,4,2,1
10,176,176,8,8,0,1,0
12,178,178,15,5,10,3,2
14,180,180,43,43,0,1,0
20,211,211,10,4,6,2,1
31,221,221,39,39,0,1,0
25,242,242,23,23,0,1,0
13,245,245,23,23,0,1,0
17,261,261,6,2,4,2,1
4,262,262,34,34,0,1,0
1,286,286,14,8,6,3,2
2,294,294,6,6,0,1,0
0,299,299,85,51,34,2,1
9,309,309,1,1,0,1,0
15,310,310,53,53,0,1,0
26,317,317,4,4,0,1,0
33,324,324,49,37,12,2,1
6,328,328,56,56,0,1,0
29,370,370,91,71,20,3,2
28,377,377,76,13,63,3,2
32,389,389,40,16,24,2,1
18,392,392,15,15,0,1,0
5,403,403,35,35,0,1,0
24,410,410,4,1,3,2,1
21,423,423,133,94,39,2,1
30,428,428,28,2,26,3,2
22,432,432,8,1,7,2,1
7,436,436,11,11,0,1,0
11,441,441,72,8,64,4,3
8,441,441,32,21,11,2,1
27,473,473,39,39,0,1,0
3,480,480,5,5,0,1,0
19,488,488,50,50,0,1,0

30,101,101,23,3,20,3,2
15,106,106,10,4,6,2,1
6,122,122,23,1,22,3,2
21,125,125,14,2,12,4,3
24,126,126,8,8,0,1,0
20,132,132,3,3,0,1,0
14,138,138,2,2,0,1,0
0,160,160,27,27,0,1,0
32,166,166,2,2,0,1,0
17,167,167,59,59,0,1,0
23,177,177,7,1,6,3,2
12,189,189,3,3,0,1,0
13,207,207,13,13,0,1,0
28,250,250,33,33,0,1,0
19,256,256,7,7,0,1,0
9,260,260,14,6,8,3,2
26,261,261,27,3,24,3,2
18,268,268,20,20,0,1,0
2,276,276,67,67,0,1,0
31,279,279,13,3,10,2,1
25,281,281,47,34,13,2,1
27,287,287,5,5,0,1,0
3,317,317,10,5,5,2,1
29,327,327,14,14,0,1,0
16,332,332,78,78,0,1,0
1,364,364,36,31,5,2,1
7,369,369,18,18,0,1,0
33,373,373,102,66,36,3,2
4,392,392,47,47,0,1,0
5,393,393,19,4,15,4,3
22,461,461,16,16,0,1,0
11,473,473,44,44,0,1,0
10,488,488,9,6,3,2,1
8,490,490,81,76,5,2,1

5,106,106,1,1,0,1,0
8,111,111,19,9,10,2,1
0,113,113,5,5,0,1,0
21,114,114,9,5,4,2,1
22,118,118,18,18,0,1,0
3,132,132,36,10,26,2,1
15,158,158,4,1,3,2,1
20,162,162,8,8,0,1,0
11,170,170,24,24,0,1,0
25,186,186,72,72,0,1,0
26,188,188,14,9,5,2,1
4,208,208,38,15,23,4,3
13,225,225,13,13,0,1,0
16,229,229,8,8,0,1,0
10,229,229,5,5,0,1,0
12,230,230,19,3,16,2,1
18,243,243,6,6,0,1,0
28,266,266,37,24,13,2,1
2,287,287,36,6,30,3,2
19,373,373,12,12,0,1,0
24,379,379,13,13,0,1,0
9,389,389,18,18,0,1,0
7,401,401,112,48,64,3,2
23,424,424,33,7,26,3,2
6,438,438,108,108,0,1,0
1,455,455,73,3,70,4,3
17,482,482,118,118,0,1,0
14,483,483,93,44,49,2,1
27,486,486,29,29,0,1,0

21,118,118,7,1,6,3,2
16,133,133,13,1,12,4,3
20,144,144,9,4,5,2,1
3,160,160,15,6,9,4,3
25,182,182,9,9,0,1,0
13,209,209,38,1,37,2,1
23,211,211,33,11,22,3,2
11,230,230,8,1,7,2,1
6,240,240,8,5,3,2,1
2,247,247,104,104,0,1,0
29,248,248,11,2,9,4,3
26,258,258,37,23,14,2,1
12,295,295,32,32,0,1,0
24,312,312,20,2,18,4,3
28,322,322,60,60,0,1,0
0,328,328,25,25,0,1,0
22,356,356,26,26,0,1,0
18,367,367,25,4,21,2,1
14,372,372,3,3,0,1,0
1,382,382,46,46,0,1,0
15,410,410,33,16,17,2,1
17,412,412,38,32,6,3,2
19,419,419,60,60,0,1,0
9,422,422,222,222,0,1,0
7,423,423,28,28,0,1,0
5,438,438,43,25,18,2,1
10,446,446,30,30,0,1,0
8,460,460,11,11,0,1,0
4,476,476,15,15,0,1,0
27,486,486,109,91,18,3,2

25,120,120,1,1,0,1,0
0,170,170,4,4,0,1,0
32,178,178,39,22,17,4,3
29,184,184,1,1,0,1,0
21,194,194,51,43,8,3,2
11,196,196,13,9,4,2,1
17,215,215,41,13,28,3,2
13,227,227,154,139,15,2,1
9,232,232,23,2,21,4,3
31,239,239,33,33,0,1,0
10,239,239,10,1,9,2,1
5,247,247,33,26,7,2,1
14,259,259,3,3,0,1,0
30,264,264,22,12,10,2,1
12,268,268,7,2,5,2,1
27,272,272,29,3,26,2,1
8,273,273,22,7,15,2,1
3,276,276,10,10,0,1,0
7,278,278,6,6,0,1,0
2,316,316,52,22,30,4,3
19,325,325,41,41,0,1,0
24,330,330,16,16,0,1,0
16,336,336,28,28,0,1,0
23,360,360,18,18,0,1,0
20,391,391,51,17,34,3,2
18,402,402,19,19,0,1,0
4,430,430,67,67,0,1,0
22,442,442,67,55,12,4,3
28,446,446,4,4,0,1,0
26,459,459,36,36,0,1,0
15,469,469,4,4,0,1,0
6,473,473,3,3,0,1,0
1,477,477,70,8,62,3,2

26,101,101,2,2,0,1,0
1,106,106,12,2,10,3,2
33,112,112,7,7,0,1,0
13,120,120,21,21,0,1,0
3,122,122,5,5,0,1,0
12,133,133,4,1,3,2,1
21,140,140,16,10,6,2,1
35,143,143,6,6,0,1,0
9,144,144,30,2,28,3,2
0,149,149,8,8,0,1,0
14,154,154,4,4,0,1,0
15,155,155,1,1,0,1,0
4,158,158,14,5,9,4,3
2,159,159,26,22,4,2,1
22,183,183,1,1,0,1,0
6,193,193,22,22,0,1,0
17,194,194,22,8,14,2,1
29,198,198,9,9,0,1,0
37,200,200,5,5,0,1,0
23,208,208,53,11,42,4,3
11,209,209,3,3,0,1,0
16,228,228,23,3,20,4,3
7,240,240,5,5,0,1,0
30,245,245,7,7,0,1,0
28,248,248,19,14,5,2,1
24,274,274,42,25,17,2,1
36,310,310,12,12,0,1,0
34,312,312,150,123,27,4,3
25,340,340,14,14,0,1,0
32,348,348,64,64,0,1,0
38,355,355,12,12,0,1,0
27,400,400,22,22,0,1,0
20,411,411,17,17,0,1,0
18,419,419,54,5,49,2,1
31,428,428,80,80,0,1,0
5,437,437,36,36,0,1,0
10,480,480,10,10,0,1,0
19,486,486,21,16,5,2,1
8,492,492,3,3,0,1,0

27,110,110,15,6,9,2,1
12,126,126,13,1,12,4,3
30,139,139,39,23,16,4,3
24,144,144,4,1,3,2,1
36,158,158,11,3,8,3,2
17,195,195,31,31,0,1,0
16,202,202,10,10,0,1,0
6,209,209,56,56,0,1,0
13,228,228,19,13,6,3,2
21,242,242,2,2,0,1,0
4,247,247,23,23,0,1,0
33,253,253,19,4,15,2,1
1,253,253,1,1,0,1,0
31,260,260,6,6,0,1,0
23,281,281,3,3,0,1,0
2,296,296,29,29,0,1,0
19,298,298,28,8,20,3,2
3,324,324,61,21,40,2,1
5,325,325,30,30,0,1,0
32,334,334,155,146,9,4,3
8,343,343,10,4,6,2,1
29,364,364,43,7,36,3,2
0,388,388,32,32,0,1,0
20,395,395,1,1,0,1,0
7,407,407,55,55,0,1,0
28,412,412,16,1,15,4,3
35,416,416,17,17,0,1,0
34,423,423,18,18,0,1,0
14,443,443,4,4,0,1,0
18,448,448,15,6,9,4,3
26,449,449,2,2,0,1,0
11,456,456,55,19,36,4,3
10,476,476,14,14,0,1,0
25,479,479,37,3,34,2,1
15,480,480,1,1,0,1,0
9,488,488,14,14,0,1,0
22,491,491,148,34,114,4,3

31,102,102,10,10,0,1,0
9,110,110,2,2,0,1,0
30,121,121,22,9,13,2,1
15,146,146,30,30,0,1,0
12,149,149,11,1,10,3,2
11,153,153,8,8,0,1,0
24,164,164,20,3,17,2,1
7,172,172,30,30,0,1,0
17,173,173,10,10,0,1,0
19,192,192,1,1,0,1,0
1,212,212,18,7,11,2,1
3,230,230,2,2,0,1,0
6,230,230,44,30,14,2,1
29,269,269,12,3,9,4,3
14,277,277,54,37,17,3,2
21,279,279,50,14,36,3,2
0,289,289,9,9,0,1,0
10,292,292,7,7,0,1,0
5,294,294,67,53,14,3,2
25,299,299,13,8,5,2,1
4,314,314,26,26,0,1,0
26,325,325,46,30,16,2,1
27,330,330,52,52,0,1,0
18,336,336,25,25,0,1,0
34,350,350,27,27,0,1,0
2,376,376,45,25,20,3,2
13,378,378,20,6,14,2,1
20,385,385,45,45,0,1,0
8,396,396,23,6,17,2,1
23,418,418,25,6,19,2,1
32,418,418,30,30,0,1,0
22,448,448,141,86,55,4,3
33,468,468,17,17,0,1,0
28,477,477,3,3,0,1,0
16,492,492,22,22,0,1,0

9,117,117,4,1,3,2,1
29,126,126,8,8,0,1,0
36,140,140,54,54,0,1,0
32,146,146,9,9,0,1,0
25,149,149,1,1,0,1,0
8,150,150,34,13,21,4,3
12,163,163,10,1,9,4,3
27,173,173,6,6,0,1,0
20,187,187,14,14,0,1,0
24,188,188,16,6,10,3,2
11,198,198,9,9,0,1,0
28,206,206,25,2,23,2,1
13,210,210,15,15,0,1,0
4,222,222,33,30,3,2,1
10,241,241,12,2,10,3,2
37,243,243,9,9,0,1,0
15,266,266,3,3,0,1,0
33,268,268,4,4,0,1,0
22,298,298,36,36,0,1,0
6,305,305,24,11,13,2,1
30,307,307,35,11,24,4,3
34,321,321,24,24,0,1,0
5,327,327,2,2,0,1,0
42,334,334,10,10,0,1,0
17,342,342,34,5,29,4,3
38,357,357,1,1,0,1,0
31,362,362,180,180,0,1,0
41,366,366,43,23,20,3,2
18,370,370,12,3,9,2,1
7,381,381,28,28,0,1,0
16,390,390,14,2,12,3,2
40,395,395,25,25,0,1,0
1,403,403,24,20,4,2,1
26,408,408,29,29,0,1,0
23,410,410,7,4,3,2,1
35,413,413,5,5,0,1,0
39,418,418,11,2,9,4,3
3,441,441,69,69,0,1,0
14,479,479,27,3,24,3,2
21,484,484,20,5,15,2,1
19,485,485,11,8,3,2,1
0,493,493,6,6,0,1,0
2,493,493,38,38,0,1,0

26,121,121,1,1,0,1,0
9,124,124,52,8,44,2,1
18,124,124,20,6,14,3,2
4,125,125,1,1,0,1,0
7,125,125,15,15,0,1,0
13,145,145,1,1,0,1,0
6,171,171,19,19,0,1,0
20,192,192,9,5,4,2,1
16,192,192,4,4,0,1,0
14,205,205,33,33,0,1,0
19,211,211,18,18,0,1,0
3,226,226,90,50,40,4,3
12,230,230,14,2,12,2,1
22,247,247,4,4,0,1,0
29,250,250,5,5,0,1,0
27,259,259,18,2,16,2,1
10,267,267,2,2,0,1,0
11,271,271,1,1,0,1,0
5,293,293,1,1,0,1,0
28,305,305,1,1,0,1,0
25,324,324,67,40,27,4,3
15,353,353,64,36,28,3,2
1,371,371,27,21,6,2,1
24,391,391,94,94,0,1,0
23,411,411,28,5,23,4,3
2,425,425,11,11,0,1,0
0,425,425,149,79,70,4,3
8,452,452,54,2,52,3,2
17,455,455,151,151,0,1,0
21,455,455,55,55,0,1,0

19,108,108,4,4,0,1,0
16,109,109,3,3,0,1,0
17,117,117,17,17,0,1,0
1,122,122,32,32,0,1,0
14,125,125,22,2,20,2,1
4,133,133,17,14,3,2,1
12,134,134,7,3,4,2,1
18,135,135,24,24,0,1,0
15,142,142,50,50,0,1,0
28,155,155,1,1,0,1,0
30,187,187,3,3,0,1,0
3,212,212,12,2,10,3,2
22,313,313,11,5,6,3,2
6,323,323,50,50,0,1,0
2,353,353,22,7,15,2,1
23,355,355,83,37,46,3,2
26,360,360,16,16,0,1,0
25,361,361,7,3,4,2,1
11,366,366,22,12,10,3,2
20,373,373,6,6,0,1,0
8,377,377,86,63,23,3,2
5,386,386,22,22,0,1,0
29,402,402,52,39,13,2,1
13,424,424,109,20,89,4,3
9,432,432,17,17,0,1,0
24,446,446,1,1,0,1,0
27,452,452,57,57,0,1,0
21,458,458,85,85,0,1,0
0,459,459,11,11,0,1,0
7,473,473,79,28,51,4,3
10,497,497,76,38,38,2,1

22,113,113,7,7,0,1,0
7,124,124,14,14,0,1,0
36,126,126,1,1,0,1,0
30,130,130,53,53,0,1,0
6,142,142,1,1,0,1,0
21,151,151,19,7,12,3,2
35,155,155,16,11,5,2,1
9,160,160,1,1,0,1,0
11,170,170,12,4,8,3,2
27,172,172,10,10,0,1,0
5,191,191,42,38,4,2,1
3,196,196,5,5,0,1,0
19,198,198,16,16,0,1,0
38,258,258,73,1,72,3,2
12,258,258,61,5,56,3,2
16,259,259,42,42,0,1,0
15,268,268,37,37,0,1,0
28,274,274,2,2,0,1,0
0,277,277,22,19,3,2,1
32,278,278,42,18,24,3,2
4,280,280,2,2,0,1,0
34,280,280,16,2,14,2,1
17,282,282,29,29,0,1,0
18,307,307,4,4,0,1,0
26,309,309,44,44,0,1,0
29,310,310,8,8,0,1,0
10,334,334,11,3,8,3,2
13,336,336,26,5,21,2,1
1,339,339,36,36,0,1,0
24,341,341,5,5,0,1,0
23,351,351,38,38,0,1,0
8,360,360,6,6,0,1,0
37,364,364,23,23,0,1,0
2,397,397,18,18,0,1,0
20,399,399,1,1,0,1,0
25,430,430,50,50,0,1,0
14,473,473,15,3,12,4,3
31,479,479,54,32,22,2,1
33,486,486,10,10,0,1,0

16,101,101,31,11,20,2,1
12,126,126,5,5,0,1,0
4,128,128,1,1,0,1,0
10,131,131,31,15,16,2,1
21,133,133,4,4,0,1,0
27,136,136,20,20,0,1,0
30,152,152,1,1,0,1,0
6,158,158,12,12,0,1,0
26,168,168,12,5,7,2,1
14,180,180,12,1,11,2,1
25,220,220,36,13,23,2,1
23,245,245,46,46,0,1,0
9,258,258,4,1,3,2,1
17,296,296,21,11,10,3,2
0,306,306,5,2,3,2,1
11,327,327,156,156,0,1,0
19,330,330,15,15,0,1,0
13,336,336,31,10,21,2,1
1,350,350,32,20,12,2,1
3,353,353,84,65,19,2,1
20,359,359,42,30,12,4,3
18,381,381,54,54,0,1,0
29,385,385,1,1,0,1,0
8,398,398,40,40,0,1,0
5,413,413,7,7,0,1,0
24,433,433,70,28,42,2,1
7,441,441,81,81,0,1,0
15,444,444,36,12,24,2,1
22,459,459,19,19,0,1,0
2,480,480,53,38,15,4,3
28,482,482,40,28,12,3,2

5,100,100,3,3,0,1,0
10,118,118,6,6,0,1,0
31,120,120,16,16,0,1,0
9,124,124,5,5,0,1,0
12,129,129,8,8,0,1,0
24,155,155,17,17,0,1,0
11,158,158,40,4,36,4,3
23,164,164,1,1,0,1,0
17,171,171,11,11,0,1,0
16,193,193,4,4,0,1,0
34,197,197,14,14,0,1,0
32,202,202,14,14,0,1,0
33,220,220,26,26,0,1,0
6,222,222,18,18,0,1,0
25,236,236,15,15,0,1,0
18,246,246,33,33,0,1,0
19,255,255,42,42,0,1,0
21,261,261,26,26,0,1,0
20,312,312,33,33,0,1,0
26,332,332,15,12,3,2,1
14,348,348,5,5,0,1,0
13,355,355,130,65,65,4,3
1,356,356,71,71,0,1,0
3,372,372,20,11,9,2,1
29,383,383,102,102,0,1,0
15,422,422,6,6,0,1,0
27,430,430,18,1,17,4,3
7,440,440,40,40,0,1,0
4,445,445,9,1,8,3,2
28,458,458,4,4,0,1,0
8,463,463,123,119,4,2,1
30,464,464,122,122,0,1,0
0,485,485,7,7,0,1,0
22,495,495,18,18,0,1,0
2,498,498,31,31,0,1,0

9,106,106,6,6,0,1,0
26,112,112,15,9,6,3,2
4,113,113,1,1,0,1,0
10,117,117,1,1,0,1,0
32,141,141,11,6,5,2,1
17,161,161,10,10,0,1,0
16,170,170,16,16,0,1,0
0,177,177,34,34,0,1,0
38,177,177,4,4,0,1,0
19,185,185,7,1,6,2,1
3,209,209,54,54,0,1,0
8,209,209,8,8,0,1,0
28,210,210,8,8,0,1,0
6,215,215,3,3,0,1,0
15,217,217,3,3,0,1,0
31,227,227,86,58,28,3,2
2,239,239,31,31,0,1,0
14,240,240,6,6,0,1,0
1,269,269,1,1,0,1,0
27,274,274,51,51,0,1,0
30,274,274,5,1,4,2,1
35,283,283,13,13,0,1,0
13,308,308,21,5,16,3,2
39,312,312,4,4,0,1,0
29,317,317,7,4,3,2,1
23,319,319,35,35,0,1,0
34,319,319,16,5,11,4,3
18,322,322,26,16,10,4,3
11,363,363,5,5,0,1,0
22,385,385,73,3,70,3,2
20,392,392,38,38,0,1,0
33,397,397,56,53,3,2,1
37,400,400,5,5,0,1,0
25,427,427,9,4,5,2,1
24,431,431,126,9,117,4,3
5,438,438,66,45,21,2,1
36,445,445,72,6,66,4,3
12,452,452,18,1,17,4,3
7,453,453,7,7,0,1,0
21,465,465,48,29,19,2,1

15,115,115,1,1,0,1,0
19,119,119,1,1,0,1,0
0,126,126,8,8,0,1,0
5,131,131,1,1,0,1,0
22,141,141,8,8,0,1,0
32,146,146,3,3,0,1,0
3,146,146,7,7,0,1,0
7,151,151,30,30,0,1,0
39,205,205,11,11,0,1,0
36,212,212,23,13,10,3,2
26,250,250,52,5,47,3,2
20,261,261,1,1,0,1,0
14,263,263,68,59,9,4,3
21,275,275,13,13,0,1,0
28,276,276,12,5,7,2,1
9,288,288,32,17,15,2,1
34,293,293,5,5,0,1,0
24,297,297,46,46,0,1,0
6,315,315,7,7,0,1,0
11,318,318,9,9,0,1,0
29,321,321,1,1,0,1,0
40,326,326,15,15,0,1,0
38,330,330,74,12,62,3,2
31,330,330,74,74,0,1,0
30,358,358,12,12,0,1,0
18,367,367,25,7,18,2,1
1,369,369,41,41,0,1,0
8,372,372,7,7,0,1,0
17,397,397,40,40,0,1,0
33,405,405,54,15,39,4,3
12,420,420,45,25,20,3,2
25,429,429,100,100,0,1,0
16,438,438,11,11,0,1,0
2,443,443,28,28,0,1,0
4,450,450,6,6,0,1,0
27,450,450,45,15,30,4,3
23,460,460,20,20,0,1,0
10,468,468,120,9,111,4,3
37,472,472,45,45,0,1,0
13,477,477,15,15,0,1,0
35,478,478,15,15,0,1,0

19,102,102,18,18,0,1,0
34,107,107,8,8,0,1,0
27,117,117,2,2,0,1,0
31,118,118,16,16,0,1,0
28,124,124,27,27,0,1,0
36,130,130,8,8,0,1,0
30,130,130,24,5,19,2,1
24,131,131,28,28,0,1,0
5,138,138,9,3,6,3,2
23,147,147,2,2,0,1,0
25,156,156,29,29,0,1,0
21,173,173,13,3,10,2,1
26,196,196,8,8,0,1,0
4,206,206,2,2,0,1,0
0,212,212,5,5,0,1,0
33,237,237,4,4,0,1,0
12,238,238,1,1,0,1,0
1,259,259,28,2,26,4,3
9,267,267,4,4,0,1,0
2,271,271,11,11,0,1,0
7,284,284,12,12,0,1,0
14,295,295,30,30,0,1,0
8,300,300,34,34,0,1,0
20,314,314,104,45,59,3,2
11,325,325,1,1,0,1,0
10,335,335,1,1,0,1,0
35,358,358,18,18,0,1,0
13,398,398,5,5,0,1,0
3,404,404,83,56,27,4,3
32,433,433,23,14,9,4,3
17,437,437,25,25,0,1,0
29,450,450,71,71,0,1,0
22,461,461,71,71,0,1,0
6,472,472,20,6,14,3,2
18,479,479,125,9,116,4,3
16,483,483,24,24,0,1,0
37,486,486,50,50,0,1,0
15,490,490,17,17,0,1,0

21,114,114,20,10,10,2,1
6,125,125,1,1,0,1,0
10,129,129,36,10,26,3,2
14,135,135,9,9,0,1,0
33,135,135,20,3,17,4,3
4,154,154,7,2,5,2,1
2,177,177,3,3,0,1,0
3,179,179,11,11,0,1,0
8,179,179,8,8,0,1,0
27,187,187,21,17,4,2,1
20,205,205,12,12,0,1,0
32,223,223,9,5,4,2,1
24,226,226,9,9,0,1,0
34,252,252,72,72,0,1,0
9,255,255,13,5,8,3,2
25,268,268,32,1,31,4,3
35,270,270,33,15,18,3,2
0,274,274,35,29,6,3,2
30,289,289,1,1,0,1,0
13,327,327,29,29,0,1,0
12,335,335,17,17,0,1,0
7,343,343,70,38,32,2,1
1,359,359,19,3,16,4,3
37,366,366,6,6,0,1,0
26,383,383,20,20,0,1,0
22,393,393,6,6,0,1,0
28,407,407,83,56,27,4,3
29,422,422,17,17,0,1,0
5,431,431,31,31,0,1,0
16,445,445,48,48,0,1,0
31,450,450,95,5,90,3,2
17,453,453,120,60,60,4,3
11,458,458,13,1,12,4,3
19,460,460,15,15,0,1,0
23,467,467,29,1,28,2,1
18,476,476,18,6,12,4,3
36,482,482,38,26,12,4,3
15,488,488,2,2,0,1,0

16,107,107,11,2,9,4,3
17,120,120,2,2,0,1,0
34,122,122,13,7,6,3,2
3,133,133,8,8,0,1,0
0,134,134,6,6,0,1,0
6,153,153,43,35,8,3,2
25,158,158,10,10,0,1,0
1,166,166,1,1,0,1,0
29,186,186,3,3,0,1,0
7,203,203,71,59,12,3,2
28,215,215,27,13,14,3,2
8,269,269,1,1,0,1,0
30,276,276,11,11,0,1,0
20,278,278,124,19,105,4,3
31,283,283,52,52,0,1,0
27,299,299,20,17,3,2,1
32,317,317,55,10,45,4,3
33,324,324,52,52,0,1,0
22,324,324,2,2,0,1,0
11,336,336,23,23,0,1,0
19,352,352,5,5,0,1,0
10,358,358,13,2,11,2,1
26,383,383,8,8,0,1,0
18,385,385,1,1,0,1,0
12,386,386,20,14,6,2,1
4,405,405,2,2,0,1,0
21,414,414,7,3,4,2,1
14,431,431,31,31,0,1,0
15,434,434,7,7,0,1,0
2,440,440,12,5,7,2,1
23,447,447,66,36,30,4,3
13,465,465,17,10,7,2,1
5,478,478,227,113,114,4,3
9,482,482,26,6,20,2,1
24,485,485,68,34,34,2,1

23,104,104,19,2,17,3,2
3,105,105,1,1,0,1,0
31,114,114,1,1,0,1,0
32,142,142,2,2,0,1,0
29,187,187,52,52,0,1,0
12,202,202,23,23,0,1,0
25,203,203,7,7,0,1,0
20,215,215,1,1,0,1,0
15,232,232,33,29,4,2,1
22,244,244,19,19,0,1,0
2,253,253,21,21,0,1,0
0,254,254,10,1,9,2,1
8,261,261,23,1,22,3,2
21,292,292,8,5,3,2,1
30,298,298,6,6,0,1,0
5,319,319,53,19,34,3,2
18,325,325,23,23,0,1,0
19,337,337,39,39,0,1,0
28,337,337,108,108,0,1,0
27,352,352,25,25,0,1,0
13,352,352,63,63,0,1,0
16,359,359,33,33,0,1,0
17,378,378,56,5,51,4,3
14,394,394,48,48,0,1,0
9,394,394,11,2,9,2,1
11,395,395,4,4,0,1,0
24,403,403,76,7,69,4,3
1,408,408,27,9,18,4,3
26,419,419,34,10,24,3,2
7,442,442,149,29,120,4,3
6,455,455,74,74,0,1,0
10,486,486,66,39,27,4,3
4,496,496,9,1,8,3,2

35,112,112,20,5,15,4,3
8,124,124,12,7,5,2,1
12,130,130,8,8,0,1,0
16,157,157,8,8,0,1,0
5,163,163,29,6,23,2,1
14,178,178,5,5,0,1,0
37,182,182,24,6,18,2,1
24,184,184,8,1,7,2,1
17,206,206,24,12,12,2,1
10,231,231,12,12,0,1,0
9,237,237,13,4,9,2,1
15,238,238,1,1,0,1,0
7,239,239,7,7,0,1,0
34,246,246,4,4,0,1,0
0,251,251,19,19,0,1,0
2,257,257,8,8,0,1,0
33,258,258,6,6,0,1,0
3,268,268,5,5,0,1,0
27,274,274,9,3,6,2,1
18,275,275,35,2,33,4,3
23,278,278,28,16,12,4,3
25,282,282,46,46,0,1,0
38,286,286,45,45,0,1,0
6,301,301,24,24,0,1,0
21,303,303,9,9,0,1,0
36,305,305,57,57,0,1,0
30,316,316,18,7,11,2,1
39,352,352,12,9,3,2,1
22,353,353,97,60,37,3,2
20,366,366,32,4,28,3,2
31,368,368,101,63,38,3,2
32,396,396,13,3,10,3,2
19,397,397,51,19,32,2,1
28,406,406,53,53,0,1,0
1,434,434,9,9,0,1,0
29,469,469,54,47,7,2,1
13,478,478,16,2,14,3,2
4,479,479,1,1,0,1,0
26,484,484,28,28,0,1,0
11,496,496,60,54,6,2,1

14,100,100,15,10,5,2,1
7,118,118,15,15,0,1,0
15,120,120,10,10,0,1,0
4,131,131,5,2,3,2,1
0,148,148,30,24,6,2,1
25,160,160,11,3,8,3,2
32,161,161,5,5,0,1,0
2,181,181,3,3,0,1,0
29,186,186,13,2,11,4,3
27,197,197,3,3,0,1,0
12,203,203,1,1,0,1,0
16,206,206,84,76,8,2,1
5,228,228,21,21,0,1,0
20,236,236,3,3,0,1,0
23,288,288,14,14,0,1,0
11,290,290,4,4,0,1,0
3,360,360,13,7,6,3,2
19,362,362,6,6,0,1,0
13,363,363,2,2,0,1,0
33,369,369,68,19,49,2,1
21,373,373,26,26,0,1,0
31,379,379,71,36,35,2,1
24,388,388,1,1,0,1,0
17,391,391,109,109,0,1,0
22,392,392,28,2,26,3,2
6,394,394,20,20,0,1,0
1,400,400,59,17,42,2,1
28,431,431,110,47,63,3,2
9,445,445,21,21,0,1,0
10,449,449,97,35,62,4,3
26,455,455,53,9,44,2,1
30,472,472,32,11,21,2,1
8,476,476,31,18,13,2,1
18,482,482,115,115,0,1,0

3,102,102,13,13,0,1,0
2,103,103,2,2,0,1,0
22,109,109,5,5,0,1,0
32,126,126,8,2,6,3,2
0,145,145,15,15,0,1,0
38,147,147,32,2,30,3,2
11,152,152,1,1,0,1,0
26,155,155,11,11,0,1,0
15,157,157,5,5,0,1,0
40,162,162,33,21,12,4,3
12,186,186,34,14,20,3,2
19,201,201,18,18,0,1,0
18,220,220,13,13,0,1,0
27,223,223,19,19,0,1,0
34,233,233,19,19,0,1,0
37,235,235,11,11,0,1,0
17,240,240,11,11,0,1,0
23,246,246,38,38,0,1,0
24,263,263,3,3,0,1,0
1,273,273,6,6,0,1,0
13,276,276,54,21,33,4,3
31,288,288,5,5,0,1,0
20,299,299,28,19,9,2,1
8,301,301,1,1,0,1,0
35,305,305,49,49,0,1,0
6,313,313,1,1,0,1,0
25,324,324,28,3,25,2,1
30,351,351,19,13,6,2,1
9,365,365,71,71,0,1,0
10,380,380,27,27,0,1,0
39,385,385,23,6,17,4,3
4,385,385,40,40,0,1,0
21,392,392,25,25,0,1,0
29,418,418,81,25,56,4,3
36,432,432,89,89,0,1,0
41,435,435,52,18,34,2,1
5,435,435,12,5,7,2,1
33,447,447,22,8,14,2,1
28,468,468,8,8,0,1,0
7,473,473,9,9,0,1,0
16,480,480,3,3,0,1,0
14,498,498,11,3,8,2,1

14,125,125,18,2,16,3,2
22,134,134,16,16,0,1,0
7,135,135,1,1,0,1,0
32,141,141,9,5,4,2,1
8,144,144,46,22,24,2,1
29,164,164,3,3,0,1,0
20,187,187,2,2,0,1,0
9,226,226,20,20,0,1,0
5,236,236,17,7,10,2,1
0,238,238,4,1,3,2,1
3,325,325,9,1,8,3,2
12,330,330,76,37,39,2,1
16,335,335,17,17,0,1,0
21,336,336,19,1,18,4,3
15,344,344,33,33,0,1,0
2,356,356,3,3,0,1,0
6,364,364,90,84,6,2,1
33,374,374,4,4,0,1,0
19,394,394,40,40,0,1,0
10,397,397,48,9,39,2,1
31,398,398,6,6,0,1,0
17,401,401,41,2,39,4,3
18,412,412,3,3,0,1,0
30,421,421,51,15,36,2,1
23,430,430,6,2,4,2,1
24,432,432,17,12,5,2,1
27,440,440,147,42,105,4,3
1,456,456,6,1,5,2,1
13,469,469,46,37,9,2,1
11,472,472,12,12,0,1,0
25,476,476,38,38,0,1,0
4,477,477,65,65,0,1,0
26,484,484,252,186,66,4,3
28,487,487,55,9,46,2,1

34,105,105,2,2,0,1,0
39,116,116,9,1,8,3,2
44,125,125,1,1,0,1,0
18,144,144,2,2,0,1,0
38,165,165,1,1,0,1,0
5,167,167,12,4,8,3,2
43,173,173,17,14,3,2,1
2,183,183,34,34,0,1,0
14,192,192,7,3,4,2,1
26,212,212,9,4,5,2,1
11,213,213,6,3,3,2,1
6,219,219,4,4,0,1,0
27,221,221,18,18,0,1,0
17,233,233,10,10,0,1,0
31,233,233,6,6,0,1,0
3,244,244,4,1,3,2,1
7,249,249,4,4,0,1,0
15,251,251,63,27,36,2,1
19,278,278,24,24,0,1,0
16,292,292,20,6,14,3,2
29,293,293,28,22,6,2,1
40,296,296,36,25,11,2,1
25,302,302,2,2,0,1,0
9,309,309,43,43,0,1,0
0,315,315,5,2,3,2,1
35,317,317,9,6,3,2,1
20,338,338,13,4,9,2,1
32,338,338,54,54,0,1,0
37,345,345,56,23,33,2,1
22,363,363,10,1,9,4,3
10,367,367,17,7,10,3,2
12,394,394,91,31,60,3,2
23,408,408,4,1,3,2,1
4,429,429,11,11,0,1,0
36,433,433,254,254,0,1,0
33,440,440,20,20,0,1,0
28,440,440,19,3,16,2,1
13,443,443,27,27,0,1,0
42,445,445,33,33,0,1,0
30,462,462,25,13,12,3,2
21,462,462,40,40,0,1,0
41,467,467,61,61,0,1,0
1,486,486,1,1,0,1,0
8,488,488,19,5,14,2,1
24,499,499,7,7,0,1,0

17,104,104,2,2,0,1,0
22,109,109,3,3,0,1,0
18,110,110,20,1,19,4,3
4,111,111,8,8,0,1,0
35,128,128,5,5,0,1,0
13,144,144,4,4,0,1,0
31,149,149,8,8,0,1,0
1,157,157,10,10,0,1,0
9,169,169,28,28,0,1,0
23,187,187,1,1,0,1,0
2,196,196,8,8,0,1,0
29,206,206,6,2,4,2,1
15,211,211,5,5,0,1,0
12,212,212,12,12,0,1,0
32,219,219,43,43,0,1,0
36,220,220,42,8,34,2,1
33,233,233,6,6,0,1,0
25,237,237,52,30,22,3,2
14,256,256,35,35,0,1,0
30,269,269,94,16,78,4,3
7,269,269,41,41,0,1,0
24,273,273,4,4,0,1,0
28,293,293,11,11,0,1,0
6,323,323,36,36,0,1,0
27,348,348,34,34,0,1,0
3,351,351,23,16,7,2,1
21,357,357,4,1,3,2,1
26,403,403,9,1,8,3,2
11,413,413,10,10,0,1,0
0,417,417,8,5,3,2,1
16,441,441,11,5,6,2,1
8,457,457,34,34,0,1,0
5,460,460,123,123,0,1,0
20,468,468,110,59,51,4,3
34,470,470,89,23,66,4,3
19,480,480,9,1,8,3,2
10,495,495,77,77,0,1,0

21,103,103,1,1,0,1,0
24,120,120,7,7,0,1,0
18,121,121,5,5,0,1,0
5,122,122,9,9,0,1,0
38,135,135,3,3,0,1,0
12,144,144,31,31,0,1,0
40,149,149,28,28,0,1,0
22,164,164,1,1,0,1,0
36,166,166,13,2,11,2,1
15,171,171,3,3,0,1,0
25,174,174,1,1,0,1,0
26,181,181,9,6,3,2,1
4,186,186,26,2,24,4,3
7,187,187,1,1,0,1,0
23,193,193,33,24,9,2,1
37,204,204,11,11,0,1,0
44,214,214,15,15,0,1,0
6,216,216,12,12,0,1,0
9,219,219,1,1,0,1,0
16,238,238,1,1,0,1,0
33,238,238,3,3,0,1,0
32,243,243,11,1,10,3,2
0,245,245,4,4,0,1,0
28,258,258,42,28,14,3,2
2,270,270,4,1,3,2,1
19,287,287,9,3,6,3,2
30,291,291,14,2,12,2,1
29,303,303,31,8,23,4,3
3,315,315,8,8,0,1,0
45,322,322,33,3,30,3,2
43,325,325,43,43,0,1,0
31,339,339,99,61,38,3,2
11,347,347,5,5,0,1,0
17,361,361,35,11,24,3,2
8,368,368,17,17,0,1,0
20,370,370,1,1,0,1,0
41,388,388,82,82,0,1,0
14,389,389,48,4,44,4,3
10,394,394,40,40,0,1,0
42,397,397,55,28,27,4,3
39,398,398,64,25,39,4,3
27,408,408,33,33,0,1,0
34,439,439,23,23,0,1,0
35,439,439,15,5,10,3,2
13,467,467,13,13,0,1,0
1,490,490,48,11,37,4,3

8,101,101,1,1,0,1,0
12,102,102,2,2,0,1,0
21,138,138,16,4,12,4,3
29,145,145,34,22,12,4,3
28,150,150,2,2,0,1,0
25,159,159,5,5,0,1,0
2,170,170,57,1,56,3,2
18,171,171,29,17,12,3,2
14,178,178,27,27,0,1,0
30,193,193,4,4,0,1,0
23,194,194,15,15,0,1,0
1,201,201,14,14,0,1,0
20,207,207,1,1,0,1,0
17,210,210,29,29,0,1,0
31,215,215,19,11,8,2,1
3,222,222,31,31,0,1,0
15,224,224,35,35,0,1,0
0,232,232,3,3,0,1,0
16,243,243,27,27,0,1,0
11,272,272,61,6,55,4,3
5,284,284,1,1,0,1,0
6,337,337,9,9,0,1,0
19,340,340,22,10,12,3,2
4,349,349,16,13,3,2,1
9,358,358,47,47,0,1,0
26,376,376,121,121,0,1,0
27,388,388,22,22,0,1,0
13,401,401,56,28,28,2,1
24,411,411,2,2,0,1,0
7,411,411,7,4,3,2,1
10,431,431,161,161,0,1,0
22,500,500,65,3,62,3,2

19,104,104,9,9,0,1,0
23,119,119,12,12,0,1,0
4,122,122,15,5,10,2,1
21,127,127,4,4,0,1,0
16,146,146,52,52,0,1,0
5,153,153,10,2,8,2,1
14,157,157,3,3,0,1,0
0,182,182,1,1,0,1,0
22,232,232,41,41,0,1,0
30,258,258,22,3,19,2,1
9,258,258,123,120,3,2,1
13,264,264,21,21,0,1,0
26,269,269,13,9,4,2,1
29,278,278,24,24,0,1,0
28,287,287,7,7,0,1,0
20,297,297,7,7,0,1,0
18,297,297,28,28,0,1,0
17,299,299,39,39,0,1,0
12,314,314,44,44,0,1,0
10,333,333,18,18,0,1,0
15,337,337,124,124,0,1,0
8,377,377,16,2,14,2,1
2,402,402,7,7,0,1,0
27,415,415,31,19,12,2,1
1,419,419,32,32,0,1,0
3,429,429,32,32,0,1,0
11,436,436,47,47,0,1,0
24,456,456,7,1,6,2,1
25,460,460,12,12,0,1,0
7,461,461,201,81,120,4,3
6,475,475,2,2,0,1,0

29,109,109,3,3,0,1,0
7,141,141,6,6,0,1,0
14,148,148,5,5,0,1,0
17,152,152,11,11,0,1,0
35,154,154,16,16,0,1,0
4,165,165,16,16,0,1,0
39,169,169,3,3,0,1,0
6,206,206,10,3,7,2,1
11,226,226,5,5,0,1,0
2,234,234,12,8,4,2,1
24,239,239,28,20,8,3,2
37,248,248,44,44,0,1,0
3,249,249,7,7,0,1,0
10,250,250,22,16,6,2,1
41,261,261,8,8,0,1,0
23,261,261,5,5,0,1,0
16,281,281,28,9,19,2,1
33,289,289,87,39,48,3,2
27,291,291,2,2,0,1,0
19,295,295,20,20,0,1,0
31,301,301,14,4,10,2,1
36,308,308,18,6,12,4,3
22,313,313,92,56,36,2,1
38,358,358,17,4,13,4,3
5,363,363,72,38,34,4,3
25,372,372,10,10,0,1,0
9,377,377,1,1,0,1,0
8,387,387,16,11,5,2,1
34,389,389,105,21,84,4,3
0,393,393,13,5,8,3,2
30,402,402,58,58,0,1,0
18,402,402,17,8,9,2,1
1,408,408,14,14,0,1,0
20,410,410,33,6,27,2,1
28,411,411,32,1,31,2,1
32,432,432,1,1,0,1,0
21,434,434,9,3,6,3,2
15,447,447,1,1,0,1,0
13,460,460,71,67,4,2,1
12,469,469,5,5,0,1,0
26,473,473,65,65,0,1,0
40,486,486,127,119,8,3,2

29,102,102,1,1,0,1,0
8,109,109,2,2,0,1,0
4,109,109,4,1,3,2,1
19,120,120,19,19,0,1,0
34,120,120,31,7,24,2,1
32,130,130,4,4,0,1,0
31,130,130,18,18,0,1,0
40,152,152,36,25,11,2,1
39,175,175,8,3,5,2,1
14,223,223,23,23,0,1,0
30,228,228,45,3,42,2,1
37,239,239,15,15,0,1,0
18,245,245,22,4,18,2,1
28,252,252,22,22,0,1,0
1,261,261,22,22,0,1,0
23,279,279,17,11,6,2,1
26,279,279,22,4,18,4,3
15,283,283,19,19,0,1,0
17,295,295,8,8,0,1,0
21,296,296,18,18,0,1,0
2,309,309,16,16,0,1,0
33,312,312,29,8,21,4,3
27,312,312,35,35,0,1,0
0,314,314,16,16,0,1,0
24,320,320,66,9,57,3,2
3,351,351,20,5,15,4,3
38,355,355,21,21,0,1,0
20,365,365,16,16,0,1,0
36,371,371,40,40,0,1,0
11,387,387,12,6,6,3,2
22,401,401,3,3,0,1,0
12,415,415,29,29,0,1,0
13,418,418,14,14,0,1,0
10,437,437,7,1,6,2,1
25,441,441,3,3,0,1,0
35,445,445,3,3,0,1,0
9,467,467,32,24,8,3,2
6,470,470,45,45,0,1,0
5,476,476,125,125,0,1,0
16,483,483,83,71,12,2,1
7,489,489,18,10,8,2,1

29,100,100,6,3,3,2,1
2,106,106,10,10,0,1,0
23,142,142,45,45,0,1,0
12,168,168,11,11,0,1,0
22,168,168,27,27,0,1,0
6,176,176,6,6,0,1,0
19,177,177,9,9,0,1,0
24,183,183,15,8,7,2,1
3,196,196,34,34,0,1,0
20,210,210,40,40,0,1,0
25,213,213,17,17,0,1,0
5,220,220,81,64,17,2,1
8,237,237,23,17,6,2,1
27,249,249,40,40,0,1,0
30,271,271,26,10,16,3,2
1,271,271,49,23,26,3,2
7,279,279,7,1,6,2,1
26,314,314,33,18,15,4,3
11,323,323,7,7,0,1,0
9,328,328,4,4,0,1,0
0,334,334,32,32,0,1,0
15,337,337,6,6,0,1,0
4,389,389,38,11,27,2,1
14,408,408,41,41,0,1,0
31,430,430,3,3,0,1,0
28,432,432,17,8,9,4,3
10,437,437,30,30,0,1,0
33,441,441,23,3,20,3,2
13,461,461,30,30,0,1,0
18,481,481,67,67,0,1,0
21,486,486,59,59,0,1,0
32,487,487,17,1,16,2,1
16,498,498,91,86,5,2,1
17,499,499,13,13,0,1,0

8,119,119,1,1,0,1,0
24,130,130,11,7,4,2,1
33,137,137,15,15,0,1,0
15,140,140,1,1,0,1,0
23,148,148,9,9,0,1,0
38,154,154,2,2,0,1,0
37,162,162,9,1,8,3,2
0,165,165,3,3,0,1,0
35,175,175,3,3,0,1,0
29,177,177,21,21,0,1,0
32,205,205,7,1,6,2,1
6,208,208,18,10,8,2,1
30,210,210,12,12,0,1,0
27,216,216,11,6,5,2,1
13,233,233,63,58,5,2,1
36,240,240,22,7,15,2,1
26,244,244,5,5,0,1,0
7,262,262,6,6,0,1,0
16,273,273,40,40,0,1,0
5,274,274,13,13,0,1,0
1,284,284,1,1,0,1,0
34,287,287,100,68,32,2,1
22,308,308,56,22,34,2,1
4,321,321,51,1,50,2,1
11,330,330,11,2,9,3,2
28,352,352,81,34,47,4,3
17,380,380,4,4,0,1,0
12,397,397,134,73,61,4,3
20,407,407,26,17,9,4,3
21,412,412,42,4,38,2,1
9,418,418,24,9,15,2,1
18,431,431,55,19,36,4,3
2,434,434,26,26,0,1,0
19,451,451,18,1,17,2,1
25,476,476,96,96,0,1,0
14,481,481,12,12,0,1,0
10,482,482,11,2,9,4,3
3,495,495,26,26,0,1,0
31,499,499,32,3,29,4,3

7,102,102,18,14,4,2,1
17,104,104,20,20,0,1,0
32,114,114,3,3,0,1,0
5,123,123,19,4,15,2,1
13,180,180,13,13,0,1,0
10,190,190,33,33,0,1,0
28,194,194,29,16,13,2,1
33,195,195,39,13,26,3,2
34,218,218,16,16,0,1,0
8,224,224,1,1,0,1,0
31,229,229,11,3,8,3,2
23,248,248,30,10,20,2,1
19,253,253,44,44,0,1,0
30,283,283,41,5,36,2,1
20,285,285,5,5,0,1,0
11,300,300,86,4,82,3,2
12,308,308,64,19,45,4,3
25,309,309,41,41,0,1,0
14,311,311,3,3,0,1,0
1,359,359,12,4,8,2,1
24,368,368,46,37,9,4,3
22,377,377,85,85,0,1,0
29,382,382,5,1,4,2,1
15,391,391,8,4,4,2,1
27,392,392,18,18,0,1,0
16,395,395,21,21,0,1,0
2,403,403,3,3,0,1,0
9,403,403,12,12,0,1,0
0,429,429,84,84,0,1,0
4,448,448,5,5,0,1,0
3,461,461,15,5,10,3,2
21,475,475,1,1,0,1,0
26,489,489,101,101,0,1,0
6,491,491,22,22,0,1,0
18,497,497,16,16,0,1,0

16,127,127,12,3,9,4,3
3,145,145,4,4,0,1,0
30,147,147,29,26,3,2,1
0,151,151,12,2,10,2,1
13,154,154,20,17,3,2,1
26,172,172,26,8,18,3,2
7,183,183,3,3,0,1,0
22,186,186,12,12,0,1,0
27,206,206,55,55,0,1,0
2,207,207,34,20,14,2,1
12,241,241,38,38,0,1,0
14,251,251,1,1,0,1,0
28,275,275,32,32,0,1,0
5,275,275,53,11,42,4,3
20,278,278,6,2,4,2,1
19,287,287,3,3,0,1,0
4,294,294,12,3,9,4,3
17,300,300,100,36,64,3,2
11,311,311,37,7,30,2,1
15,315,315,29,11,18,4,3
25,348,348,8,1,7,2,1
21,395,395,3,3,0,1,0
6,401,401,78,45,33,2,1
18,403,403,19,19,0,1,0
24,412,412,14,14,0,1,0
23,413,413,21,8,13,2,1
31,429,429,13,4,9,2,1
10,436,436,19,19,0,1,0
8,440,440,170,170,0,1,0
1,447,447,29,10,19,4,3
29,469,469,91,91,0,1,0
9,497,497,41,17,24,2,1

13,107,107,2,2,0,1,0
2,111,111,1,1,0,1,0
24,114,114,5,1,4,2,1
3,125,125,16,16,0,1,0
21,134,134,4,4,0,1,0
11,136,136,3,3,0,1,0
4,138,138,27,27,0,1,0
28,170,170,1,1,0,1,0
17,174,174,6,6,0,1,0
14,199,199,35,35,0,1,0
15,228,228,39,4,35,3,2
7,232,232,18,18,0,1,0
8,240,240,5,5,0,1,0
23,260,260,126,126,0,1,0
18,288,288,73,22,51,4,3
9,317,317,39,39,0,1,0
29,320,320,5,5,0,1,0
0,325,325,22,22,0,1,0
20,345,345,16,16,0,1,0
16,389,389,5,5,0,1,0
26,424,424,4,4,0,1,0
19,427,427,3,3,0,1,0
25,468,468,27,16,11,2,1
5,470,470,119,55,64,3,2
12,473,473,261,181,80,3,2
1,479,479,46,25,21,4,3
22,480,480,78,42,36,4,3
6,490,490,65,49,16,3,2
27,490,490,46,46,0,1,0
30,492,492,63,63,0,1,0
10,499,499,5,5,0,1,0

31,119,119,2,2,0,1,0
33,120,120,6,6,0,1,0
24,132,132,9,1,8,3,2
26,140,140,9,3,6,3,2
12,147,147,12,12,0,1,0
1,152,152,2,2,0,1,0
2,165,165,12,12,0,1,0
34,169,169,8,8,0,1,0
0,173,173,23,6,17,2,1
9,177,177,8,8,0,1,0
7,188,188,1,1,0,1,0
6,195,195,2,2,0,1,0
30,204,204,96,81,15,4,3
13,206,206,11,11,0,1,0
25,207,207,2,2,0,1,0
5,221,221,19,19,0,1,0
14,229,229,15,15,0,1,0
27,234,234,16,16,0,1,0
29,268,268,1,1,0,1,0
4,273,273,90,73,17,2,1
32,280,280,54,16,38,2,1
20,304,304,17,3,14,2,1
10,317,317,27,8,19,4,3
15,351,351,81,41,40,3,2
22,354,354,67,67,0,1,0
3,372,372,2,2,0,1,0
21,376,376,20,6,14,2,1
23,408,408,48,48,0,1,0
17,411,411,36,6,30,4,3
28,427,427,5,5,0,1,0
18,433,433,91,91,0,1,0
19,466,466,51,51,0,1,0
16,477,477,58,40,18,4,3
8,487,487,131,88,43,4,3
11,489,489,3,3,0,1,0

11,103,103,1,1,0,1,0
4,123,123,23,11,12,2,1
0,146,146,27,27,0,1,0
1,150,150,7,1,6,3,2
8,166,166,27,18,9,2,1
10,171,171,32,16,16,3,2
20,172,172,2,2,0,1,0
2,220,220,15,4,11,2,1
33,223,223,2,2,0,1,0
12,231,231,1,1,0,1,0
31,248,248,13,8,5,2,1
26,248,248,9,9,0,1,0
13,251,251,26,8,18,3,2
15,254,254,1,1,0,1,0
7,263,263,36,11,25,4,3
3,270,270,26,26,0,1,0
9,273,273,19,19,0,1,0
22,281,281,118,118,0,1,0
30,304,304,9,9,0,1,0
35,315,315,64,64,0,1,0
29,315,315,127,65,62,3,2
6,344,344,22,4,18,2,1
34,348,348,15,3,12,3,2
28,355,355,9,2,7,2,1
5,358,358,20,2,18,4,3
16,371,371,12,12,0,1,0
27,385,385,26,5,21,4,3
19,386,386,23,23,0,1,0
25,390,390,7,7,0,1,0
21,392,392,70,32,38,2,1
23,408,408,13,13,0,1,0
14,423,423,77,77,0,1,0
18,429,429,45,4,41,3,2
17,437,437,1,1,0,1,0
32,473,473,10,10,0,1,0
24,499,499,60,40,20,3,2

21,103,103,5,5,0,1,0
25,106,106,4,4,0,1,0
2,120,120,1,1,0,1,0
29,121,121,18,18,0,1,0
31,122,122,12,12,0,1,0
22,126,126,32,7,25,2,1
9,156,156,98,66,32,3,2
7,159,159,11,3,8,2,1
34,170,170,4,4,0,1,0
23,188,188,3,3,0,1,0
12,208,208,13,13,0,1,0
5,224,224,37,10,27,3,2
33,251,251,4,4,0,1,0
1,254,254,26,26,0,1,0
24,268,268,7,3,4,2,1
3,276,276,8,8,0,1,0
15,281,281,21,2,19,2,1
18,301,301,67,43,24,4,3
19,302,302,11,11,0,1,0
8,307,307,25,11,14,3,2
17,321,321,16,16,0,1,0
14,337,337,1,1,0,1,0
6,341,341,13,13,0,1,0
11,361,361,11,11,0,1,0
32,375,375,174,158,16,3,2
16,378,378,11,11,0,1,0
28,388,388,11,3,8,2,1
20,391,391,11,11,0,1,0
13,393,393,53,7,46,2,1
26,413,413,79,79,0,1,0
0,424,424,41,41,0,1,0
30,427,427,8,8,0,1,0
10,440,440,9,1,8,3,2
27,442,442,35,7,28,3,2
4,444,444,34,34,0,1,0

2,105,105,22,7,15,2,1
10,123,123,5,5,0,1,0
9,143,143,4,4,0,1,0
3,152,152,6,1,5,2,1
17,154,154,3,3,0,1,0
0,162,162,14,10,4,2,1
4,169,169,23,23,0,1,0
29,195,195,14,10,4,2,1
13,213,213,32,17,15,4,3
31,219,219,46,31,15,4,3
8,231,231,1,1,0,1,0
32,235,235,5,1,4,2,1
23,246,246,9,9,0,1,0
20,248,248,37,10,27,4,3
22,251,251,103,83,20,3,2
28,268,268,25,25,0,1,0
25,273,273,57,29,28,2,1
33,304,304,3,3,0,1,0
18,314,314,8,8,0,1,0
5,318,318,21,3,18,2,1
26,321,321,8,2,6,3,2
19,327,327,27,27,0,1,0
14,340,340,77,48,29,2,1
27,357,357,57,50,7,2,1
15,359,359,12,12,0,1,0
12,376,376,74,74,0,1,0
21,409,409,11,11,0,1,0
1,422,422,30,30,0,1,0
30,425,425,46,2,44,3,2
24,435,435,28,3,25,2,1
11,439,439,100,6,94,4,3
6,450,450,32,24,8,3,2
16,453,453,2,2,0,1,0
7,470,470,51,51,0,1,0

14,125,125,8,8,0,1,0
5,130,130,18,18,0,1,0
25,145,145,5,1,4,2,1
30,161,161,12,12,0,1,0
9,168,168,15,15,0,1,0
10,195,195,2,2,0,1,0
34,201,201,8,8,0,1,0
21,204,204,17,17,0,1,0
19,218,218,61,11,50,2,1
27,265,265,3,3,0,1,0
7,278,278,22,22,0,1,0
6,282,282,62,22,40,3,2
12,286,286,31,21,10,3,2
24,299,299,2,2,0,1,0
11,305,305,28,22,6,2,1
29,307,307,4,4,0,1,0
3,308,308,94,94,0,1,0
20,311,311,71,38,33,2,1
22,315,315,51,24,27,4,3
0,342,342,3,3,0,1,0
8,346,346,18,18,0,1,0
33,378,378,46,37,9,4,3
31,395,395,10,2,8,2,1
15,404,404,35,12,23,2,1
18,414,414,111,111,0,1,0
1,430,430,83,1,82,3,2
23,436,436,55,17,38,3,2
16,439,439,1,1,0,1,0
28,455,455,9,9,0,1,0
2,460,460,14,2,12,4,3
26,479,479,36,36,0,1,0
13,481,481,30,30,0,1,0
32,483,483,77,26,51,4,3
4,486,486,62,26,36,2,1
17,496,496,16,7,9,2,1

20,104,104,3,3,0,1,0
9,111,111,5,5,0,1,0
25,117,117,3,3,0,1,0
5,118,118,1,1,0,1,0
29,118,118,10,3,7,2,1
7,142,142,3,3,0,1,0
13,144,144,14,14,0,1,0
27,158,158,14,14,0,1,0
21,196,196,7,1,6,3,2
4,208,208,21,21,0,1,0
14,219,219,9,2,7,2,1
2,223,223,36,36,0,1,0
15,228,228,21,21,0,1,0
16,233,233,43,43,0,1,0
12,236,236,2,2,0,1,0
22,251,251,31,9,22,2,1
23,256,256,4,4,0,1,0
17,273,273,23,16,7,2,1
8,285,285,36,14,22,2,1
18,326,326,34,7,27,2,1
24,382,382,54,20,34,2,1
1,393,393,35,35,0,1,0
26,394,394,135,122,13,2,1
30,394,394,54,54,0,1,0
19,406,406,8,3,5,2,1
31,421,421,46,46,0,1,0
11,431,431,29,29,0,1,0
10,440,440,6,6,0,1,0
3,451,451,31,22,9,2,1
32,465,465,66,50,16,3,2
28,488,488,32,32,0,1,0
0,497,497,138,97,41,3,2
6,498,498,240,189,51,3,2

4,110,110,29,2,27,4,3
19,119,119,1,1,0,1,0
3,150,150,35,18,17,3,2
17,161,161,22,14,8,3,2
8,170,170,2,2,0,1,0
25,188,188,7,7,0,1,0
10,194,194,39,13,26,2,1
23,198,198,56,5,51,4,3
28,217,217,3,3,0,1,0
9,227,227,13,1,12,4,3
22,236,236,9,9,0,1,0
20,255,255,12,6,6,2,1
15,278,278,32,17,15,4,3
16,280,280,42,18,24,3,2
30,281,281,2,2,0,1,0
6,330,330,1,1,0,1,0
12,345,345,31,13,18,4,3
7,345,345,44,44,0,1,0
29,359,359,30,23,7,2,1
18,376,376,86,86,0,1,0
13,376,376,88,88,0,1,0
11,384,384,16,16,0,1,0
1,387,387,24,8,16,2,1
31,391,391,120,120,0,1,0
14,396,396,21,5,16,3,2
32,425,425,9,9,0,1,0
26,443,443,22,1,21,2,1
21,446,446,26,26,0,1,0
2,449,449,43,43,0,1,0
0,453,453,10,2,8,3,2
24,468,468,68,32,36,3,2
5,484,484,43,43,0,1,0
27,489,489,58,55,3,2,1

37,102,102,14,14,0,1,0
29,103,103,1,1,0,1,0
32,108,108,23,23,0,1,0
24,117,117,4,4,0,1,0
12,119,119,21,13,8,2,1
16,127,127,3,3,0,1,0
10,156,156,3,3,0,1,0
7,179,179,28,28,0,1,0
23,181,181,11,1,10,3,2
11,189,189,1,1,0,1,0
2,190,190,9,9,0,1,0
17,229,229,1,1,0,1,0
31,251,251,13,13,0,1,0
20,254,254,1,1,0,1,0
21,255,255,44,24,20,2,1
36,266,266,11,8,3,2,1
3,269,269,1,1,0,1,0
27,283,283,22,7,15,4,3
33,287,287,51,51,0,1,0
5,296,296,75,58,17,2,1
35,312,312,29,29,0,1,0
22,317,317,18,6,12,3,2
13,318,318,70,25,45,2,1
15,344,344,7,7,0,1,0
4,354,354,29,29,0,1,0
6,382,382,47,5,42,4,3
30,382,382,60,60,0,1,0
9,384,384,38,35,3,2,1
1,386,386,8,4,4,2,1
19,405,405,78,78,0,1,0
14,411,411,19,10,9,4,3
0,415,415,42,21,21,4,3
25,437,437,10,10,0,1,0
28,469,469,52,52,0,1,0
8,471,471,7,4,3,2,1
18,486,486,42,42,0,1,0
34,488,488,111,65,46,3,2
26,496,496,48,34,14,3,2

32,106,106,26,21,5,2,1
16,110,110,2,2,0,1,0
17,111,111,12,5,7,2,1
27,141,141,17,17,0,1,0
14,162,162,5,5,0,1,0
8,168,168,6,6,0,1,0
13,169,169,13,10,3,2,1
24,169,169,16,16,0,1,0
26,199,199,21,5,16,3,2
3,209,209,8,8,0,1,0
15,221,221,4,4,0,1,0
25,232,232,22,22,0,1,0
11,257,257,1,1,0,1,0
6,264,264,160,90,70,3,2
29,281,281,35,35,0,1,0
5,286,286,13,7,6,3,2
12,317,317,7,2,5,2,1
23,323,323,8,1,7,2,1
10,329,329,22,10,12,2,1
30,330,330,47,22,25,2,1
9,331,331,24,4,20,3,2
28,331,331,69,69,0,1,0
4,335,335,90,90,0,1,0
0,345,345,7,7,0,1,0
7,359,359,18,18,0,1,0
20,371,371,11,4,7,2,1
22,379,379,2,2,0,1,0
18,379,379,9,4,5,2,1
31,394,394,25,25,0,1,0
19,398,398,129,51,78,4,3
2,426,426,116,70,46,3,2
33,461,461,3,3,0,1,0
21,474,474,10,4,6,3,2
1,477,477,29,20,9,4,3

28,140,140,2,2,0,1,0
7,147,147,3,3,0,1,0
17,160,160,7,7,0,1,0
4,172,172,10,7,3,2,1
23,176,176,9,1,8,2,1
0,177,177,25,7,18,4,3
21,192,192,41,31,10,2,1
12,214,214,7,7,0,1,0
14,238,238,34,24,10,2,1
16,240,240,65,9,56,3,2
13,250,250,109,85,24,3,2
10,272,272,21,17,4,2,1
31,284,284,33,26,7,2,1
2,286,286,30,30,0,1,0
20,329,329,16,7,9,2,1
5,330,330,27,12,15,2,1
27,333,333,17,2,15,4,3
6,335,335,6,6,0,1,0
9,341,341,29,3,26,2,1
19,351,351,50,50,0,1,0
25,358,358,14,14,0,1,0
18,367,367,6,3,3,2,1
26,367,367,140,29,111,4,3
3,374,374,11,11,0,1,0
29,424,424,19,5,14,2,1
11,461,461,64,46,18,3,2
24,472,472,4,4,0,1,0
15,477,477,44,44,0,1,0
22,478,478,20,20,0,1,0
8,495,495,77,77,0,1,0
30,496,496,79,28,51,3,2
1,496,496,90,42,48,2,1

33,101,101,6,1,5,2,1
25,107,107,19,1,18,4,3
11,117,117,1,1,0,1,0
4,128,128,12,12,0,1,0
0,156,156,7,4,3,2,1
28,158,158,8,2,6,3,2
10,186,186,38,38,0,1,0
29,186,186,5,5,0,1,0
38,190,190,36,36,0,1,0
1,205,205,7,7,0,1,0
26,213,213,20,15,5,2,1
13,223,223,1,1,0,1,0
6,226,226,39,11,28,2,1
14,235,235,15,15,0,1,0
31,237,237,62,14,48,3,2
3,246,246,15,6,9,2,1
22,247,247,3,3,0,1,0
15,251,251,1,1,0,1,0
7,264,264,8,8,0,1,0
30,270,270,29,29,0,1,0
8,286,286,23,20,3,2,1
12,310,310,28,12,16,3,2
34,317,317,8,2,6,2,1
20,323,323,13,9,4,2,1
2,348,348,33,33,0,1,0
21,365,365,47,47,0,1,0
37,371,371,32,32,0,1,0
27,379,379,5,1,4,2,1
40,381,381,75,35,40,3,2
23,402,402,29,29,0,1,0
39,403,403,30,10,20,2,1
32,404,404,38,8,30,2,1
17,410,410,17,11,6,2,1
19,412,412,9,1,8,3,2
9,435,435,128,44,84,3,2
5,444,444,37,19,18,4,3
35,460,460,6,3,3,2,1
24,469,469,83,68,15,4,3
16,485,485,7,7,0,1,0
18,489,489,2,2,0,1,0
36,498,498,44,44,0,1,0

26,119,119,16,11,5,2,1
1,129,129,14,9,5,2,1
5,133,133,8,8,0,1,0
37,148,148,44,16,28,2,1
3,150,150,4,4,0,1,0
14,172,172,25,25,0,1,0
30,203,203,47,14,33,2,1
21,204,204,6,6,0,1,0
38,209,209,6,3,3,2,1
28,216,216,7,7,0,1,0
25,218,218,14,14,0,1,0
36,267,267,7,3,4,2,1
0,275,275,1,1,0,1,0
35,280,280,120,28,92,3,2
39,284,284,3,3,0,1,0
24,285,285,7,7,0,1,0
29,301,301,41,29,12,3,2
17,316,316,12,12,0,1,0
13,331,331,40,22,18,2,1
33,343,343,12,7,5,2,1
34,348,348,26,3,23,3,2
16,362,362,6,6,0,1,0
32,381,381,12,12,0,1,0
31,386,386,3,3,0,1,0
27,389,389,31,31,0,1,0
6,393,393,80,49,31,2,1
9,396,396,115,101,14,2,1
15,400,400,33,33,0,1,0
2,407,407,11,6,5,2,1
19,418,418,11,11,0,1,0
18,418,418,42,19,23,2,1
22,437,437,45,2,43,2,1
4,459,459,37,37,0,1,0
11,466,466,3,3,0,1,0
12,476,476,1,1,0,1,0
7,480,480,2,2,0,1,0
23,486,486,48,48,0,1,0
20,494,494,1,1,0,1,0
10,494,494,9,9,0,1,0
8,495,495,102,102,0,1,0

5,100,100,10,10,0,1,0
2,111,111,12,2,10,3,2
13,126,126,8,8,0,1,0
24,147,147,10,10,0,1,0
1,165,165,1,1,0,1,0
10,168,168,5,5,0,1,0
19,191,191,20,1,19,4,3
31,195,195,6,6,0,1,0
23,199,199,12,12,0,1,0
27,229,229,43,43,0,1,0
4,238,238,29,29,0,1,0
12,245,245,7,7,0,1,0
16,256,256,4,4,0,1,0
22,271,271,21,13,8,2,1
32,275,275,4,4,0,1,0
9,296,296,17,17,0,1,0
30,298,298,48,48,0,1,0
11,313,313,30,30,0,1,0
28,320,320,42,42,0,1,0
17,325,325,28,1,27,2,1
18,328,328,45,45,0,1,0
8,333,333,16,16,0,1,0
14,339,339,217,129,88,3,2
21,345,345,30,30,0,1,0
7,383,383,6,2,4,2,1
3,388,388,2,2,0,1,0
0,392,392,61,61,0,1,0
26,431,431,25,25,0,1,0
15,435,435,70,25,45,4,3
6,451,451,29,29,0,1,0
25,467,467,45,22,23,2,1
20,469,469,159,159,0,1,0
29,472,472,34,34,0,1,0

25,111,111,3,3,0,1,0
9,129,129,19,11,8,3,2
21,136,136,10,6,4,2,1
33,160,160,31,31,0,1,0
20,160,160,15,3,12,3,2
7,165,165,36,36,0,1,0
32,166,166,20,20,0,1,0
34,196,196,57,10,47,3,2
15,213,213,2,2,0,1,0
12,227,227,14,3,11,2,1
0,238,238,14,14,0,1,0
5,240,240,6,6,0,1,0
19,240,240,21,21,0,1,0
29,251,251,77,43,34,3,2
23,256,256,20,6,14,2,1
8,274,274,44,44,0,1,0
16,278,278,39,27,12,4,3
10,288,288,40,40,0,1,0
27,297,297,6,6,0,1,0
31,306,306,26,26,0,1,0
4,337,337,17,1,16,2,1
22,349,349,59,5,54,4,3
11,368,368,16,4,12,4,3
30,368,368,16,16,0,1,0
24,369,369,17,5,12,2,1
1,405,405,62,62,0,1,0
2,406,406,51,51,0,1,0
28,409,409,8,5,3,2,1
17,414,414,45,45,0,1,0
13,431,431,3,3,0,1,0
18,457,457,5,5,0,1,0
6,458,458,35,17,18,4,3
14,478,478,1,1,0,1,0
3,479,479,84,68,16,3,2
26,485,485,35,35,0,1,0

28,115,115,8,5,3,2,1
21,117,117,15,15,0,1,0
7,133,133,3,3,0,1,0
31,138,138,13,13,0,1,0
29,152,152,36,36,0,1,0
22,155,155,5,5,0,1,0
26,169,169,19,19,0,1,0
1,186,186,1,1,0,1,0
27,194,194,1,1,0,1,0
2,197,197,46,46,0,1,0
23,205,205,32,32,0,1,0
32,223,223,25,2,23,2,1
30,247,247,5,5,0,1,0
4,252,252,24,24,0,1,0
25,256,256,14,14,0,1,0
34,258,258,19,19,0,1,0
8,260,260,10,3,7,2,1
3,261,261,70,70,0,1,0
13,271,271,50,50,0,1,0
5,282,282,2,2,0,1,0
24,290,290,23,23,0,1,0
35,308,308,47,17,30,3,2
10,315,315,5,5,0,1,0
16,316,316,2,2,0,1,0
18,318,318,11,11,0,1,0
11,320,320,5,5,0,1,0
14,323,323,11,5,6,3,2
20,337,337,9,1,8,2,1
19,342,342,12,4,8,3,2
38,348,348,21,7,14,3,2
37,355,355,26,8,18,2,1
17,361,361,34,34,0,1,0
6,362,362,38,14,24,2,1
33,405,405,137,81,56,3,2
15,453,453,88,85,3,2,1
36,474,474,29,13,16,2,1
12,477,477,37,34,3,2,1
0,479,479,6,6,0,1,0
9,486,486,34,25,9,4,3

31,127,127,16,8,8,3,2
22,145,145,33,20,13,3,2
2,157,157,7,2,5,2,1
12,172,172,39,15,24,4,3
0,173,173,6,6,0,1,0
4,178,178,24,24,0,1,0
23,198,198,2,2,0,1,0
10,207,207,11,11,0,1,0
6,227,227,29,4,25,2,1
32,248,248,15,15,0,1,0
17,257,257,9,9,0,1,0
27,267,267,10,6,4,2,1
13,272,272,11,3,8,3,2
20,277,277,23,23,0,1,0
1,306,306,1,1,0,1,0
11,310,310,46,13,33,3,2
30,323,323,48,4,44,2,1
9,333,333,31,31,0,1,0
5,337,337,38,38,0,1,0
15,342,342,25,25,0,1,0
25,343,343,62,48,14,3,2
16,350,350,27,27,0,1,0
26,369,369,11,1,10,3,2
7,370,370,59,41,18,4,3
21,402,402,46,46,0,1,0
24,405,405,82,58,24,4,3
14,425,425,36,36,0,1,0
29,427,427,4,4,0,1,0
8,446,446,126,3,123,4,3
18,461,461,43,3,40,2,1
19,468,468,129,55,74,3,2
3,474,474,39,26,13,2,1
28,498,498,4,4,0,1,0

15,106,106,1,1,0,1,0
26,117,117,2,2,0,1,0
0,157,157,2,2,0,1,0
9,160,160,14,14,0,1,0
17,179,179,10,10,0,1,0
7,202,202,29,29,0,1,0
23,212,212,33,33,0,1,0
14,223,223,13,7,6,3,2
25,240,240,4,4,0,1,0
19,242,242,82,68,14,3,2
12,265,265,9,1,8,2,1
4,289,289,40,40,0,1,0
13,295,295,24,24,0,1,0
11,301,301,31,8,23,2,1
18,303,303,5,5,0,1,0
27,315,315,32,32,0,1,0
1,350,350,14,6,8,3,2
6,358,358,14,14,0,1,0
3,385,385,7,4,3,2,1
21,399,399,14,14,0,1,0
28,399,399,5,5,0,1,0
20,414,414,65,27,38,3,2
10,427,427,44,44,0,1,0
31,433,433,42,42,0,1,0
29,441,441,17,17,0,1,0
5,448,448,145,19,126,4,3
30,451,451,4,4,0,1,0
2,462,462,54,54,0,1,0
24,464,464,56,5,51,4,3
33,464,464,157,16,141,4,3
16,464,464,47,17,30,4,3
22,469,469,33,33,0,1,0
32,485,485,40,40,0,1,0
8,488,488,115,104,11,2,1
34,500,500,61,25,36,4,3

19,132,132,2,2,0,1,0
32,146,146,16,16,0,1,0
28,152,152,2,2,0,1,0
14,154,154,3,3,0,1,0
8,155,155,27,27,0,1,0
24,190,190,11,11,0,1,0
31,205,205,3,3,0,1,0
29,211,211,6,6,0,1,0
20,248,248,4,1,3,2,1
2,250,250,8,8,0,1,0
5,273,273,41,41,0,1,0
12,274,274,23,6,17,2,1
4,298,298,12,6,6,2,1
0,315,315,9,9,0,1,0
26,328,328,101,9,92,3,2
18,337,337,26,26,0,1,0
3,345,345,45,45,0,1,0
30,361,361,35,35,0,1,0
17,380,380,3,3,0,1,0
16,386,386,33,9,24,4,3
23,387,387,15,3,12,2,1
9,407,407,27,14,13,3,2
13,410,410,71,71,0,1,0
7,418,418,27,27,0,1,0
15,420,420,68,56,12,2,1
27,438,438,35,8,27,3,2
21,439,439,292,237,55,4,3
11,449,449,48,36,12,3,2
10,450,450,25,11,14,3,2
1,459,459,148,134,14,3,2
6,465,465,42,42,0,1,0
25,468,468,46,46,0,1,0
22,486,486,8,8,0,1,0

33,102,102,1,1,0,1,0
0,110,110,6,6,0,1,0
7,115,115,7,3,4,2,1
38,117,117,10,10,0,1,0
1,132,132,1,1,0,1,0
30,155,155,1,1,0,1,0
20,173,173,2,2,0,1,0
21,201,201,55,47,8,2,1
29,201,201,11,2,9,2,1
8,233,233,6,6,0,1,0
36,240,240,2,2,0,1,0
19,245,245,17,17,0,1,0
27,273,273,9,9,0,1,0
16,278,278,28,28,0,1,0
28,279,279,16,16,0,1,0
35,295,295,98,57,41,2,1
37,313,313,64,64,0,1,0
6,321,321,63,27,36,4,3
10,339,339,2,2,0,1,0
25,343,343,87,30,57,4,3
12,352,352,43,43,0,1,0
9,358,358,59,59,0,1,0
31,368,368,7,7,0,1,0
26,372,372,66,66,0,1,0
13,392,392,44,31,13,2,1
17,397,397,1,1,0,1,0
3,415,415,4,4,0,1,0
24,416,416,45,45,0,1,0
5,419,419,35,5,30,4,3
15,420,420,12,8,4,2,1
34,428,428,9,9,0,1,0
14,441,441,36,36,0,1,0
11,452,452,13,9,4,2,1
18,454,454,69,8,61,4,3
23,454,454,72,72,0,1,0
2,457,457,15,15,0,1,0
32,469,469,2,2,0,1,0
22,474,474,92,92,0,1,0
4,479,479,38,12,26,3,2

18,101,101,8,8,0,1,0
11,134,134,17,1,16,3,2
1,140,140,81,15,66,4,3
4,145,145,4,4,0,1,0
16,148,148,2,2,0,1,0
5,162,162,24,15,9,4,3
15,173,173,15,3,12,2,1
24,179,179,47,35,12,3,2
25,198,198,11,1,10,2,1
26,257,257,22,14,8,2,1
0,259,259,15,15,0,1,0
27,260,260,4,4,0,1,0
6,272,272,17,8,9,4,3
13,305,305,7,7,0,1,0
9,305,305,45,45,0,1,0
19,336,336,9,9,0,1,0
2,349,349,75,26,49,3,2
23,355,355,11,6,5,2,1
12,371,371,20,20,0,1,0
21,374,374,11,7,4,2,1
8,392,392,3,3,0,1,0
20,404,404,3,3,0,1,0
7,405,405,39,23,16,2,1
14,423,423,5,5,0,1,0
17,428,428,107,51,56,3,2
28,433,433,152,105,47,4,3
10,454,454,65,6,59,4,3
22,462,462,11,11,0,1,0
29,476,476,17,17,0,1,0
30,484,484,180,104,76,3,2
3,493,493,7,7,0,1,0

3,116,116,2,2,0,1,0
8,137,137,19,4,15,2,1
13,151,151,21,21,0,1,0
4,159,159,20,20,0,1,0
10,160,160,40,40,0,1,0
25,202,202,19,19,0,1,0
17,216,216,2,2,0,1,0
27,220,220,51,51,0,1,0
2,249,249,4,4,0,1,0
26,265,265,97,4,93,4,3
14,275,275,55,55,0,1,0
23,282,282,16,16,0,1,0
21,292,292,15,1,14,2,1
18,310,310,16,16,0,1,0
22,314,314,10,10,0,1,0
0,323,323,38,8,30,2,1
12,350,350,85,85,0,1,0
5,355,355,52,25,27,2,1
28,380,380,9,9,0,1,0
29,395,395,98,34,64,4,3
19,418,418,6,6,0,1,0
1,421,421,54,33,21,4,3
7,425,425,6,6,0,1,0
9,440,440,109,78,31,2,1
15,446,446,43,8,35,4,3
16,465,465,16,4,12,2,1
24,473,473,9,6,3,2,1
20,477,477,24,16,8,2,1
11,479,479,38,19,19,2,1
30,482,482,72,21,51,4,3
6,491,491,21,9,12,4,3

19,109,109,12,7,5,2,1
0,110,110,8,4,4,2,1
20,111,111,8,8,0,1,0
25,119,119,30,30,0,1,0
4,121,121,4,4,0,1,0
21,121,121,11,11,0,1,0
11,122,122,8,5,3,2,1
35,149,149,10,3,7,2,1
27,158,158,1,1,0,1,0
3,164,164,1,1,0,1,0
31,164,164,65,29,36,4,3
30,166,166,32,32,0,1,0
36,167,167,2,2,0,1,0
34,173,173,13,13,0,1,0
1,177,177,10,1,9,4,3
7,178,178,7,4,3,2,1
5,183,183,37,37,0,1,0
29,191,191,7,7,0,1,0
10,193,193,19,8,11,4,3
8,213,213,12,12,0,1,0
22,238,238,3,3,0,1,0
33,238,238,31,4,27,4,3
2,239,239,16,7,9,4,3
24,268,268,13,13,0,1,0
18,272,272,7,3,4,2,1
38,281,281,30,30,0,1,0
28,306,306,21,16,5,2,1
12,344,344,47,7,40,2,1
14,350,350,22,10,12,4,3
13,365,365,60,28,32,3,2
26,372,372,18,9,9,4,3
6,401,401,41,41,0,1,0
32,403,403,29,13,16,2,1
17,415,415,37,37,0,1,0
37,433,433,83,83,0,1,0
15,434,434,14,6,8,2,1
9,436,436,49,11,38,3,2
16,459,459,5,2,3,2,1
23,465,465,9,9,0,1,0

23,122,122,50,14,36,3,2
24,129,129,6,1,5,2,1
30,135,135,15,7,8,2,1
22,141,141,8,8,0,1,0
7,149,149,13,1,12,3,2
25,152,152,35,15,20,3,2
8,166,166,45,45,0,1,0
19,175,175,17,8,9,4,3
2,175,175,34,34,0,1,0
1,189,189,7,7,0,1,0
0,192,192,22,1,21,2,1
29,234,234,23,23,0,1,0
21,254,254,17,17,0,1,0
27,264,264,5,5,0,1,0
6,282,282,25,25,0,1,0
20,307,307,6,2,4,2,1
18,315,315,55,55,0,1,0
26,354,354,94,57,37,2,1
10,357,357,10,10,0,1,0
9,364,364,14,14,0,1,0
12,376,376,12,12,0,1,0
3,383,383,68,68,0,1,0
31,386,386,7,2,5,2,1
11,391,391,25,13,12,2,1
14,407,407,183,183,0,1,0
13,416,416,17,17,0,1,0
15,443,443,8,2,6,3,2
5,450,450,11,11,0,1,0
28,462,462,5,5,0,1,0
16,468,468,36,9,27,2,1
17,472,472,6,6,0,1,0
4,486,486,26,3,23,2,1

17,112,112,2,2,0,1,0
29,112,112,5,5,0,1,0
27,118,118,39,12,27,3,2
9,122,122,13,5,8,2,1
4,141,141,15,6,9,2,1
21,141,141,14,14,0,1,0
19,170,170,49,9,40,3,2
26,179,179,45,34,11,2,1
24,199,199,27,3,24,2,1
16,201,201,5,5,0,1,0
18,216,216,1,1,0,1,0
6,233,233,10,10,0,1,0
8,235,235,35,35,0,1,0
23,255,255,6,6,0,1,0
30,261,261,5,5,0,1,0
14,299,299,23,9,14,2,1
15,306,306,12,12,0,1,0
32,312,312,25,25,0,1,0
28,313,313,16,16,0,1,0
1,317,317,1,1,0,1,0
0,318,318,70,10,60,3,2
31,360,360,38,38,0,1,0
25,369,369,2,2,0,1,0
7,381,381,73,12,61,4,3
13,388,388,44,44,0,1,0
2,396,396,30,30,0,1,0
11,408,408,1,1,0,1,0
20,426,426,15,6,9,2,1
3,431,431,86,36,50,2,1
10,478,478,142,90,52,3,2
5,479,479,22,22,0,1,0
12,483,483,16,16,0,1,0
22,487,487,110,71,39,4,3

27,105,105,1,1,0,1,0
25,106,106,2,2,0,1,0
21,107,107,9,9,0,1,0
24,125,125,7,3,4,2,1
31,131,131,17,17,0,1,0
23,145,145,1,1,0,1,0
1,159,159,22,22,0,1,0
12,206,206,28,28,0,1,0
22,209,209,62,29,33,4,3
16,228,228,23,23,0,1,0
20,236,236,17,17,0,1,0
28,239,239,77,77,0,1,0
26,243,243,29,29,0,1,0
11,245,245,2,2,0,1,0
0,249,249,29,2,27,2,1
9,311,311,100,100,0,1,0
8,325,325,44,44,0,1,0
2,329,329,41,41,0,1,0
15,370,370,47,47,0,1,0
29,374,374,12,12,0,1,0
7,375,375,76,76,0,1,0
5,387,387,13,1,12,4,3
3,417,417,74,74,0,1,0
4,421,421,79,71,8,3,2
14,434,434,12,12,0,1,0
17,439,439,5,2,3,2,1
30,447,447,116,111,5,2,1
10,451,451,7,7,0,1,0
19,453,453,33,9,24,3,2
18,463,463,19,19,0,1,0
13,486,486,29,4,25,2,1
6,495,495,8,8,0,1,0

9,111,111,2,2,0,1,0
20,127,127,21,4,17,2,1
19,131,131,6,6,0,1,0
10,141,141,10,1,9,2,1
29,148,148,30,30,0,1,0
18,167,167,6,3,3,2,1
6,172,172,1,1,0,1,0
17,185,185,10,10,0,1,0
30,202,202,29,29,0,1,0
21,204,204,26,8,18,4,3
24,209,209,31,31,0,1,0
32,221,221,2,2,0,1,0
12,225,225,3,3,0,1,0
0,230,230,14,4,10,3,2
15,245,245,12,12,0,1,0
2,273,273,30,30,0,1,0
5,275,275,3,3,0,1,0
23,299,299,37,22,15,4,3
33,307,307,3,3,0,1,0
27,327,327,9,9,0,1,0
1,329,329,7,7,0,1,0
34,337,337,30,12,18,4,3
3,396,396,18,4,14,3,2
25,425,425,61,61,0,1,0
16,426,426,5,5,0,1,0
7,432,432,135,97,38,2,1
13,439,439,288,288,0,1,0
11,443,443,7,1,6,3,2
28,450,450,57,11,46,2,1
4,451,451,54,54,0,1,0
22,454,454,11,11,0,1,0
8,461,461,23,5,18,4,3
14,469,469,37,37,0,1,0
31,478,478,75,75,0,1,0
26,493,493,76,45,31,2,1

26,101,101,1,1,0,1,0
18,102,102,7,7,0,1,0
37,105,105,15,5,10,3,2
40,106,106,14,6,8,2,1
8,111,111,6,6,0,1,0
23,113,113,10,10,0,1,0
11,125,125,5,5,0,1,0
9,136,136,1,1,0,1,0
10,146,146,29,20,9,2,1
17,148,148,31,5,26,3,2
43,152,152,7,7,0,1,0
1,158,158,4,4,0,1,0
44,168,168,3,3,0,1,0
27,177,177,35,35,0,1,0
33,177,177,18,18,0,1,0
2,181,181,25,1,24,2,1
38,185,185,7,2,5,2,1
24,186,186,3,3,0,1,0
19,195,195,4,4,0,1,0
29,196,196,18,18,0,1,0
36,196,196,17,7,10,3,2
21,202,202,2,2,0,1,0
31,227,227,40,40,0,1,0
30,241,241,3,3,0,1,0
3,246,246,1,1,0,1,0
42,267,267,35,35,0,1,0
22,284,284,3,3,0,1,0
16,299,299,3,3,0,1,0
13,302,302,20,20,0,1,0
34,313,313,56,56,0,1,0
32,317,317,8,2,6,3,2
0,350,350,6,6,0,1,0
14,369,369,4,4,0,1,0
4,379,379,43,29,14,2,1
7,384,384,13,13,0,1,0
25,417,417,6,6,0,1,0
5,417,417,10,10,0,1,0
15,421,421,44,44,0,1,0
28,424,424,96,21,75,4,3
20,428,428,15,1,14,2,1
41,438,438,52,27,25,4,3
35,456,456,2,2,0,1,0
12,462,462,59,43,16,3,2
39,480,480,99,63,36,2,1
6,496,496,22,22,0,1,0

12,128,128,3,3,0,1,0
23,131,131,3,3,0,1,0
3,151,151,24,13,11,2,1
25,153,153,4,1,3,2,1
11,157,157,13,13,0,1,0
9,167,167,58,51,7,2,1
15,174,174,8,8,0,1,0
14,179,179,44,44,0,1,0
22,189,189,3,3,0,1,0
6,195,195,26,26,0,1,0
8,195,195,24,3,21,2,1
17,200,200,3,3,0,1,0
26,203,203,66,66,0,1,0
5,208,208,1,1,0,1,0
21,228,228,11,1,10,4,3
13,233,233,50,24,26,2,1
20,246,246,11,11,0,1,0
19,270,270,25,17,8,3,2
7,320,320,69,24,45,4,3
24,347,347,41,41,0,1,0
16,384,384,102,102,0,1,0
4,392,392,126,42,84,4,3
18,424,424,40,40,0,1,0
1,439,439,5,5,0,1,0
10,486,486,103,40,63,4,3
2,489,489,58,46,12,4,3
27,497,497,29,29,0,1,0
0,498,498,27,5,22,3,2

29,100,100,12,1,11,2,1
18,126,126,1,1,0,1,0
5,158,158,8,8,0,1,0
42,175,175,1,1,0,1,0
27,177,177,29,29,0,1,0
32,206,206,40,6,34,2,1
7,231,231,6,6,0,1,0
16,232,232,1,1,0,1,0
9,238,238,26,4,22,2,1
15,245,245,1,1,0,1,0
4,252,252,3,3,0,1,0
20,257,257,11,11,0,1,0
8,258,258,24,24,0,1,0
25,285,285,43,10,33,2,1
6,291,291,52,52,0,1,0
21,300,300,2,2,0,1,0
13,326,326,12,12,0,1,0
2,330,330,2,2,0,1,0
17,331,331,10,10,0,1,0
23,332,332,16,16,0,1,0
10,334,334,49,49,0,1,0
35,335,335,12,12,0,1,0
31,339,339,10,1,9,4,3
34,342,342,92,29,63,4,3
12,348,348,11,11,0,1,0
33,349,349,7,7,0,1,0
44,354,354,1,1,0,1,0
28,357,357,11,11,0,1,0
3,358,358,48,48,0,1,0
19,369,369,65,56,9,4,3
0,376,376,4,1,3,2,1
41,378,378,81,81,0,1,0
38,391,391,4,4,0,1,0
1,398,398,13,9,4,2,1
36,408,408,21,21,0,1,0
11,409,409,17,17,0,1,0
14,409,409,11,11,0,1,0
22,417,417,12,12,0,1,0
30,430,430,8,8,0,1,0
37,441,441,49,49,0,1,0
40,449,449,73,73,0,1,0
26,452,452,2,2,0,1,0
39,484,484,178,94,84,3,2
24,490,490,47,25,22,3,2
43,492,492,42,42,0,1,0

14,101,101,1,1,0,1,0
36,101,101,12,4,8,3,2
33,105,105,2,2,0,1,0
3,109,109,6,6,0,1,0
13,127,127,11,11,0,1,0
28,146,146,1,1,0,1,0
22,154,154,21,21,0,1,0
15,175,175,15,15,0,1,0
37,186,186,8,8,0,1,0
30,192,192,56,40,16,2,1
2,204,204,13,13,0,1,0
27,207,207,8,3,5,2,1
19,215,215,21,21,0,1,0
17,236,236,7,1,6,2,1
32,253,253,23,23,0,1,0
0,271,271,28,28,0,1,0
26,276,276,75,66,9,2,1
25,297,297,72,35,37,2,1
16,299,299,21,21,0,1,0
12,300,300,60,16,44,3,2
11,306,306,35,35,0,1,0
20,317,317,19,15,4,2,1
35,342,342,8,2,6,2,1
21,343,343,2,2,0,1,0
18,358,358,10,6,4,2,1
6,368,368,17,17,0,1,0
23,373,373,87,30,57,3,2
1,375,375,32,32,0,1,0
38,383,383,45,9,36,2,1
31,392,392,17,8,9,4,3
34,407,407,12,6,6,2,1
5,408,408,30,17,13,4,3
4,435,435,58,58,0,1,0
24,448,448,9,9,0,1,0
9,453,453,7,3,4,2,1
10,461,461,12,12,0,1,0
7,472,472,39,24,15,2,1
29,481,481,6,6,0,1,0
8,489,489,112,112,0,1,0

5,101,101,3,3,0,1,0
9,108,108,1,1,0,1,0
13,110,110,17,17,0,1,0
31,116,116,3,3,0,1,0
4,134,134,21,21,0,1,0
6,149,149,1,1,0,1,0
32,149,149,13,4,9,2,1
23,151,151,5,1,4,2,1
12,170,170,1,1,0,1,0
27,185,185,46,4,42,4,3
7,211,211,29,2,27,4,3
33,219,219,7,7,0,1,0
29,235,235,40,26,14,2,1
15,243,243,11,7,4,2,1
11,244,244,32,16,16,4,3
2,247,247,68,20,48,2,1
18,277,277,21,3,18,2,1
19,280,280,5,5,0,1,0
26,284,284,37,34,3,2,1
16,330,330,69,1,68,4,3
24,346,346,103,33,70,3,2
28,351,351,51,51,0,1,0
21,386,386,6,6,0,1,0
25,391,391,1,1,0,1,0
22,403,403,20,8,12,3,2
8,409,409,51,3,48,4,3
14,414,414,8,4,4,2,1
30,420,420,65,38,27,2,1
34,424,424,26,26,0,1,0
20,457,457,84,46,38,2,1
1,469,469,38,38,0,1,0
0,475,475,110,64,46,3,2
10,480,480,13,2,11,2,1
17,489,489,4,4,0,1,0
3,499,499,24,24,0,1,0

1,111,111,4,4,0,1,0
35,128,128,12,12,0,1,0
32,130,130,4,4,0,1,0
29,148,148,30,30,0,1,0
8,149,149,6,2,4,2,1
33,150,150,13,5,8,3,2
21,171,171,4,4,0,1,0
37,171,171,58,58,0,1,0
10,172,172,15,15,0,1,0
15,173,173,28,20,8,3,2
13,176,176,19,13,6,3,2
4,188,188,19,13,6,2,1
25,196,196,3,3,0,1,0
17,228,228,21,6,15,4,3
36,232,232,1,1,0,1,0
14,236,236,20,20,0,1,0
22,244,244,2,2,0,1,0
12,250,250,3,3,0,1,0
7,268,268,27,1,26,3,2
27,290,290,9,3,6,3,2
11,316,316,12,6,6,3,2
30,328,328,23,23,0,1,0
16,348,348,28,28,0,1,0
23,354,354,43,43,0,1,0
18,355,355,1,1,0,1,0
5,365,365,9,9,0,1,0
40,370,370,46,46,0,1,0
26,372,372,16,3,13,3,2
3,374,374,35,29,6,3,2
6,376,376,16,6,10,3,2
38,377,377,11,11,0,1,0
20,394,394,4,4,0,1,0
19,400,400,21,21,0,1,0
31,405,405,47,47,0,1,0
9,407,407,28,28,0,1,0
24,417,417,101,101,0,1,0
0,424,424,13,7,6,3,2
34,430,430,136,136,0,1,0
28,435,435,48,21,27,4,3
41,453,453,9,9,0,1,0
2,457,457,17,17,0,1,0
39,485,485,49,49,0,1,0

18,109,109,12,12,0,1,0
24,124,124,4,4,0,1,0
31,133,133,6,6,0,1,0
33,157,157,5,5,0,1,0
21,168,168,9,9,0,1,0
22,183,183,48,48,0,1,0
0,184,184,26,26,0,1,0
10,188,188,30,30,0,1,0
15,191,191,14,6,8,2,1
4,214,214,23,1,22,2,1
12,224,224,1,1,0,1,0
34,225,225,63,14,49,4,3
14,230,230,14,14,0,1,0
11,232,232,1,1,0,1,0
1,240,240,37,10,27,4,3
2,250,250,54,54,0,1,0
16,250,250,2,2,0,1,0
5,255,255,3,3,0,1,0
27,265,265,19,13,6,2,1
23,278,278,32,16,16,3,2
6,284,284,102,59,43,4,3
25,344,344,17,11,6,3,2
28,350,350,54,18,36,4,3
20,368,368,29,7,22,2,1
7,382,382,73,16,57,4,3
9,404,404,2,2,0,1,0
19,409,409,35,17,18,2,1
8,443,443,16,16,0,1,0
26,446,446,7,7,0,1,0
3,447,447,46,46,0,1,0
30,471,471,87,72,15,2,1
17,475,475,29,8,21,4,3
29,484,484,75,60,15,2,1
13,489,489,2,2,0,1,0
32,489,489,7,7,0,1,0

26,147,147,2,2,0,1,0
12,151,151,21,21,0,1,0
16,168,168,16,16,0,1,0
10,168,168,6,6,0,1,0
20,174,174,1,1,0,1,0
22,191,191,5,1,4,2,1
34,194,194,10,4,6,2,1
41,194,194,29,3,26,2,1
27,198,198,18,14,4,2,1
14,199,199,61,61,0,1,0
9,199,199,12,2,10,3,2
35,211,211,13,13,0,1,0
40,213,213,5,5,0,1,0
32,220,220,45,6,39,2,1
3,232,232,2,2,0,1,0
29,238,238,7,7,0,1,0
2,239,239,1,1,0,1,0
11,240,240,2,2,0,1,0
8,241,241,1,1,0,1,0
7,246,246,15,15,0,1,0
37,253,253,17,13,4,2,1
21,268,268,31,3,28,4,3
25,271,271,22,10,12,2,1
36,278,278,8,8,0,1,0
13,298,298,5,5,0,1,0
30,306,306,73,73,0,1,0
42,320,320,98,98,0,1,0
19,320,320,11,11,0,1,0
31,322,322,50,50,0,1,0
15,322,322,56,3,53,3,2
23,323,323,1,1,0,1,0
18,335,335,6,2,4,2,1
17,344,344,3,3,0,1,0
28,349,349,13,13,0,1,0
1,354,354,18,18,0,1,0
38,365,365,83,83,0,1,0
6,382,382,20,2,18,4,3
33,386,386,11,3,8,2,1
4,391,391,47,13,34,3,2
24,422,422,38,5,33,4,3
0,424,424,58,1,57,4,3
5,444,444,20,20,0,1,0
39,484,484,9,9,0,1,0

3,110,110,12,1,11,2,1
30,124,124,3,3,0,1,0
26,124,124,1,1,0,1,0
27,125,125,6,6,0,1,0
13,133,133,31,3,28,2,1
25,143,143,8,2,6,2,1
6,179,179,3,3,0,1,0
15,181,181,33,19,14,2,1
16,183,183,33,5,28,3,2
10,205,205,5,5,0,1,0
29,233,233,1,1,0,1,0
24,248,248,23,23,0,1,0
21,260,260,16,4,12,2,1
22,271,271,9,2,7,3,2
5,273,273,12,5,7,2,1
7,278,278,2,2,0,1,0
8,282,282,1,1,0,1,0
18,299,299,43,19,24,2,1
19,304,304,55,6,49,2,1
4,330,330,87,13,74,4,3
9,346,346,20,14,6,3,2
31,353,353,53,53,0,1,0
2,402,402,45,45,0,1,0
20,406,406,1,1,0,1,0
1,414,414,63,63,0,1,0
0,421,421,22,6,16,2,1
23,426,426,128,70,58,3,2
14,434,434,164,116,48,3,2
28,447,447,107,64,43,2,1
17,483,483,15,15,0,1,0
11,490,490,59,26,33,4,3
12,492,492,63,9,54,4,3

1,110,110,16,16,0,1,0
3,122,122,1,1,0,1,0
7,128,128,7,7,0,1,0
28,131,131,1,1,0,1,0
14,135,135,11,6,5,2,1
4,156,156,4,4,0,1,0
11,165,165,18,18,0,1,0
2,173,173,1,1,0,1,0
26,174,174,48,14,34,3,2
25,192,192,20,20,0,1,0
8,203,203,6,1,5,2,1
22,204,204,14,14,0,1,0
10,222,222,44,6,38,2,1
18,229,229,5,5,0,1,0
32,249,249,4,4,0,1,0
29,260,260,31,31,0,1,0
24,271,271,9,9,0,1,0
34,296,296,2,2,0,1,0
12,305,305,13,3,10,3,2
23,308,308,26,6,20,3,2
5,319,319,7,7,0,1,0
17,334,334,22,12,10,3,2
9,334,334,27,3,24,4,3
16,340,340,87,7,80,3,2
20,351,351,33,15,18,4,3
30,357,357,1,1,0,1,0
15,369,369,36,24,12,4,3
0,395,395,90,9,81,4,3
27,398,398,50,50,0,1,0
31,427,427,51,10,41,3,2
21,431,431,70,52,18,4,3
13,450,450,22,22,0,1,0
33,455,455,71,14,57,4,3
19,472,472,156,108,48,4,3
6,483,483,98,80,18,4,3

20,122,122,9,9,0,1,0
25,128,128,10,1,9,2,1
4,130,130,8,8,0,1,0
8,136,136,32,14,18,3,2
9,138,138,1,1,0,1,0
2,179,179,1,1,0,1,0
1,185,185,16,16,0,1,0
24,194,194,19,19,0,1,0
27,197,197,16,3,13,2,1
17,215,215,32,32,0,1,0
12,253,253,48,21,27,4,3
11,293,293,32,32,0,1,0
22,295,295,37,31,6,3,2
5,307,307,82,57,25,2,1
0,309,309,3,3,0,1,0
21,329,329,37,15,22,2,1
23,340,340,18,18,0,1,0
13,344,344,30,30,0,1,0
7,346,346,18,18,0,1,0
14,349,349,4,4,0,1,0
15,363,363,67,11,56,3,2
3,370,370,116,81,35,2,1
19,407,407,45,45,0,1,0
26,418,418,138,16,122,4,3
28,419,419,43,43,0,1,0
16,430,430,17,17,0,1,0
29,437,437,18,8,10,3,2
30,449,449,43,2,41,4,3
18,466,466,17,17,0,1,0
10,469,469,60,40,20,2,1
6,482,482,72,34,38,3,2

32,127,127,13,13,0,1,0
13,132,132,2,2,0,1,0
26,139,139,12,8,4,2,1
11,143,143,14,14,0,1,0
3,175,175,42,42,0,1,0
36,179,179,36,1,35,2,1
34,185,185,16,2,14,4,3
29,210,210,1,1,0,1,0
27,216,216,7,7,0,1,0
8,245,245,4,4,0,1,0
18,246,246,19,19,0,1,0
12,250,250,22,22,0,1,0
17,253,253,1,1,0,1,0
10,261,261,11,11,0,1,0
22,276,276,4,4,0,1,0
35,293,293,38,26,12,3,2
31,302,302,5,5,0,1,0
24,303,303,5,5,0,1,0
16,310,310,7,7,0,1,0
4,317,317,28,28,0,1,0
23,322,322,116,67,49,2,1
20,328,328,35,35,0,1,0
33,331,331,15,5,10,3,2
37,334,334,17,17,0,1,0
5,334,334,7,7,0,1,0
7,352,352,12,4,8,3,2
2,359,359,18,6,12,4,3
19,364,364,120,74,46,2,1
15,367,367,57,57,0,1,0
14,371,371,41,35,6,2,1
0,372,372,7,4,3,2,1
25,374,374,74,74,0,1,0
28,379,379,86,86,0,1,0
21,392,392,28,10,18,4,3
6,424,424,19,10,9,4,3
1,461,461,41,30,11,2,1
30,465,465,41,5,36,2,1
9,467,467,24,24,0,1,0

10,137,137,43,43,0,1,0
11,140,140,22,22,0,1,0
7,170,170,23,23,0,1,0
2,192,192,4,1,3,2,1
8,253,253,24,24,0,1,0
14,254,254,48,39,9,4,3
3,263,263,22,22,0,1,0
28,266,266,22,15,7,2,1
12,267,267,30,11,19,2,1
13,282,282,9,9,0,1,0
4,303,303,27,12,15,2,1
24,305,305,95,95,0,1,0
19,317,317,10,10,0,1,0
18,319,319,22,22,0,1,0
0,353,353,2,2,0,1,0
1,353,353,110,110,0,1,0
6,358,358,148,13,135,4,3
27,360,360,100,26,74,3,2
22,369,369,25,25,0,1,0
23,380,380,30,16,14,3,2
21,388,388,7,1,6,2,1
9,393,393,20,20,0,1,0
5,408,408,10,4,6,3,2
20,417,417,15,15,0,1,0
15,471,471,57,24,33,2,1
25,474,474,37,27,10,3,2
17,484,484,22,6,16,2,1
26,489,489,7,1,6,3,2
16,500,500,77,25,52,3,2

17,100,100,35,25,10,3,2
28,102,102,7,7,0,1,0
12,104,104,6,6,0,1,0
3,104,104,9,9,0,1,0
25,108,108,17,5,12,3,2
2,120,120,7,7,0,1,0
1,130,130,5,5,0,1,0
11,132,132,1,1,0,1,0
18,139,139,18,3,15,4,3
16,171,171,5,5,0,1,0
14,173,173,83,60,23,2,1
13,178,178,2,2,0,1,0
7,207,207,47,5,42,4,3
15,233,233,1,1,0,1,0
24,235,235,53,44,9,2,1
27,237,237,69,69,0,1,0
26,252,252,26,11,15,3,2
0,277,277,134,63,71,4,3
10,291,291,2,2,0,1,0
30,297,297,25,25,0,1,0
29,300,300,30,30,0,1,0
19,309,309,14,14,0,1,0
22,309,309,11,11,0,1,0
20,310,310,19,5,14,2,1
6,322,322,19,19,0,1,0
4,366,366,14,14,0,1,0
23,386,386,2,2,0,1,0
8,396,396,50,50,0,1,0
31,415,415,1,1,0,1,0
9,438,438,8,8,0,1,0
5,478,478,1,1,0,1,0
21,483,483,24,6,18,2,1

32,105,105,3,3,0,1,0
29,110,110,1,1,0,1,0
24,124,124,12,7,5,2,1
10,162,162,39,20,19,2,1
15,177,177,8,8,0,1,0
8,196,196,3,3,0,1,0
20,203,203,5,5,0,1,0
23,205,205,3,3,0,1,0
18,213,213,4,4,0,1,0
28,229,229,46,46,0,1,0
21,234,234,16,7,9,4,3
0,240,240,1,1,0,1,0
13,262,262,16,5,11,2,1
3,293,293,20,20,0,1,0
5,307,307,25,25,0,1,0
26,320,320,62,62,0,1,0
30,321,321,89,77,12,4,3
4,322,322,13,13,0,1,0
11,335,335,24,24,0,1,0
27,341,341,42,42,0,1,0
34,351,351,72,18,54,4,3
9,351,351,33,4,29,2,1
19,360,360,25,16,9,2,1
2,363,363,22,22,0,1,0
12,367,367,52,52,0,1,0
33,378,378,1,1,0,1,0
35,381,381,7,7,0,1,0
16,385,385,20,20,0,1,0
31,418,418,35,35,0,1,0
1,421,421,7,7,0,1,0
17,427,427,80,80,0,1,0
7,445,445,149,149,0,1,0
14,485,485,39,39,0,1,0
22,491,491,141,53,88,3,2
6,499,499,45,45,0,1,0
25,500,500,18,10,8,3,2

24,103,103,15,15,0,1,0
3,105,105,21,21,0,1,0
4,111,111,5,5,0,1,0
1,119,119,6,6,0,1,0
32,127,127,22,7,15,2,1
20,164,164,18,10,8,2,1
28,202,202,19,5,14,2,1
33,207,207,9,9,0,1,0
13,212,212,14,10,4,2,1
7,212,212,13,13,0,1,0
23,220,220,50,50,0,1,0
25,221,221,21,8,13,2,1
14,227,227,3,3,0,1,0
21,235,235,8,8,0,1,0
19,236,236,3,3,0,1,0
16,258,258,58,28,30,2,1
26,267,267,65,49,16,3,2
18,270,270,10,10,0,1,0
15,279,279,8,2,6,3,2
27,285,285,9,9,0,1,0
30,288,288,35,35,0,1,0
10,316,316,2,2,0,1,0
17,323,323,6,6,0,1,0
11,324,324,96,46,50,3,2
8,350,350,59,11,48,2,1
22,355,355,24,2,22,2,1
29,391,391,32,32,0,1,0
0,402,402,39,39,0,1,0
9,407,407,83,19,64,3,2
31,408,408,82,43,39,4,3
5,417,417,60,60,0,1,0
6,427,427,17,9,8,2,1
2,493,493,16,8,8,3,2
12,500,500,12,12,0,1,0

16,136,136,2,2,0,1,0
29,150,150,5,5,0,1,0
7,151,151,30,30,0,1,0
20,151,151,4,4,0,1,0
1,180,180,10,10,0,1,0
10,183,183,7,3,4,2,1
28,189,189,8,8,0,1,0
5,204,204,13,3,10,3,2
21,205,205,7,7,0,1,0
24,217,217,11,5,6,2,1
9,229,229,19,9,10,3,2
11,248,248,3,3,0,1,0
33,249,249,40,10,30,3,2
36,254,254,35,5,30,4,3
0,259,259,16,10,6,3,2
18,280,280,12,12,0,1,0
26,286,286,40,40,0,1,0
15,288,288,27,16,11,3,2
30,293,293,39,39,0,1,0
3,312,312,16,1,15,4,3
27,335,335,205,92,113,4,3
6,348,348,40,40,0,1,0
35,348,348,3,3,0,1,0
32,352,352,50,50,0,1,0
13,357,357,66,12,54,3,2
34,372,372,16,4,12,4,3
17,375,375,17,2,15,2,1
31,391,391,32,22,10,2,1
19,409,409,60,33,27,2,1
2,415,415,66,26,40,2,1
22,416,416,19,13,6,2,1
8,423,423,64,46,18,2,1
12,426,426,27,6,21,4,3
25,447,447,9,9,0,1,0
4,454,454,37,4,33,4,3
37,461,461,3,3,0,1,0
14,464,464,6,6,0,1,0
23,497,497,15,15,0,1,0

24,102,102,10,4,6,2,1
22,108,108,16,6,10,2,1
21,114,114,4,1,3,2,1
1,143,143,52,52,0,1,0
28,153,153,5,5,0,1,0
9,157,157,24,14,10,2,1
18,178,178,12,12,0,1,0
30,180,180,36,36,0,1,0
19,192,192,11,1,10,3,2
3,201,201,69,57,12,3,2
26,252,252,13,13,0,1,0
29,263,263,2,2,0,1,0
17,274,274,80,22,58,3,2
2,284,284,5,2,3,2,1
5,296,296,45,45,0,1,0
13,298,298,20,20,0,1,0
10,314,314,23,23,0,1,0
4,328,328,51,51,0,1,0
20,334,334,9,2,7,2,1
6,344,344,25,7,18,4,3
23,383,383,48,48,0,1,0
11,385,385,5,5,0,1,0
7,401,401,33,15,18,3,2
15,404,404,29,17,12,3,2
8,418,418,35,35,0,1,0
27,443,443,101,35,66,3,2
0,466,466,31,31,0,1,0
16,476,476,48,3,45,2,1
25,484,484,64,45,19,2,1
14,488,488,28,2,26,3,2
12,491,491,29,29,0,1,0

35,102,102,11,3,8,2,1
10,104,104,2,2,0,1,0
12,107,107,28,6,22,3,2
7,121,121,5,5,0,1,0
29,124,124,11,3,8,3,2
22,134,134,27,27,0,1,0
19,160,160,10,10,0,1,0
24,161,161,71,9,62,3,2
33,162,162,22,22,0,1,0
4,177,177,33,21,12,2,1
3,189,189,39,1,38,3,2
16,197,197,12,12,0,1,0
18,216,216,11,11,0,1,0
25,225,225,12,4,8,3,2
13,241,241,1,1,0,1,0
27,242,242,13,13,0,1,0
20,243,243,18,18,0,1,0
31,248,248,3,3,0,1,0
17,313,313,35,9,26,4,3
11,317,317,2,2,0,1,0
8,349,349,8,8,0,1,0
21,355,355,31,31,0,1,0
32,358,358,24,24,0,1,0
1,373,373,30,30,0,1,0
23,378,378,19,7,12,3,2
30,380,380,8,8,0,1,0
15,396,396,5,5,0,1,0
0,397,397,21,21,0,1,0
14,407,407,34,8,26,4,3
5,421,421,61,35,26,3,2
34,426,426,15,4,11,2,1
9,439,439,57,45,12,2,1
6,444,444,48,4,44,3,2
2,449,449,53,53,0,1,0
26,493,493,30,30,0,1,0
28,496,496,89,89,0,1,0

18,109,109,21,21,0,1,0
9,116,116,7,4,3,2,1
30,122,122,14,1,13,2,1
6,145,145,18,18,0,1,0
7,147,147,8,1,7,2,1
19,158,158,7,7,0,1,0
4,159,159,16,9,7,2,1
24,173,173,16,1,15,4,3
21,189,189,14,14,0,1,0
8,199,199,2,2,0,1,0
2,200,200,1,1,0,1,0
12,213,213,14,14,0,1,0
20,220,220,2,2,0,1,0
25,221,221,4,4,0,1,0
26,229,229,24,24,0,1,0
28,235,235,2,2,0,1,0
16,256,256,28,28,0,1,0
29,265,265,11,5,6,2,1
1,281,281,4,1,3,2,1
13,291,291,60,60,0,1,0
34,300,300,28,28,0,1,0
35,306,306,34,1,33,4,3
3,311,311,9,9,0,1,0
10,322,322,3,3,0,1,0
11,327,327,32,23,9,2,1
15,331,331,24,10,14,3,2
32,338,338,91,91,0,1,0
22,342,342,83,83,0,1,0
33,354,354,86,77,9,4,3
14,381,381,31,12,19,2,1
0,384,384,43,37,6,2,1
31,428,428,41,5,36,2,1
5,429,429,151,13,138,4,3
27,448,448,13,5,8,2,1
23,465,465,66,66,0,1,0
17,490,490,6,6,0,1,0

14,100,100,15,15,0,1,0
4,102,102,9,9,0,1,0
15,129,129,14,11,3,2,1
11,140,140,10,10,0,1,0
22,141,141,13,4,9,4,3
9,146,146,10,2,8,3,2
18,166,166,9,9,0,1,0
12,181,181,10,6,4,2,1
10,213,213,5,5,0,1,0
21,215,215,13,13,0,1,0
26,227,227,7,2,5,2,1
17,238,238,101,79,22,2,1
0,245,245,34,34,0,1,0
3,282,282,55,18,37,2,1
7,302,302,37,29,8,2,1
8,316,316,215,166,49,3,2
25,328,328,10,4,6,3,2
2,332,332,41,41,0,1,0
20,332,332,14,14,0,1,0
16,339,339,41,41,0,1,0
6,365,365,3,3,0,1,0
23,396,396,20,3,17,2,1
1,410,410,48,14,34,3,2
24,410,410,28,28,0,1,0
5,431,431,69,9,60,4,3
19,438,438,50,50,0,1,0
13,479,479,117,93,24,3,2

30,136,136,8,2,6,2,1
5,158,158,31,31,0,1,0
20,159,159,26,26,0,1,0
8,160,160,7,7,0,1,0
4,231,231,5,5,0,1,0
18,239,239,27,27,0,1,0
9,247,247,3,3,0,1,0
29,259,259,15,8,7,2,1
14,262,262,11,3,8,3,2
21,264,264,20,4,16,3,2
3,280,280,5,5,0,1,0
27,283,283,56,33,23,2,1
7,291,291,56,10,46,3,2
2,334,334,67,67,0,1,0
10,346,346,47,18,29,2,1
15,376,376,95,95,0,1,0
17,389,389,70,44,26,3,2
13,392,392,45,45,0,1,0
23,393,393,3,3,0,1,0
1,396,396,42,42,0,1,0
22,413,413,4,4,0,1,0
28,414,414,54,40,14,3,2
25,424,424,33,33,0,1,0
26,443,443,9,5,4,2,1
16,446,446,6,2,4,2,1
0,467,467,126,126,0,1,0
24,476,476,44,44,0,1,0
19,482,482,113,71,42,4,3
6,483,483,87,71,16,3,2
12,483,483,1,1,0,1,0
11,493,493,102,90,12,4,3

7,111,111,41,41,0,1,0
35,116,116,7,7,0,1,0
26,118,118,15,15,0,1,0
29,119,119,27,14,13,2,1
23,120,120,55,55,0,1,0
15,143,143,32,6,26,3,2
32,149,149,1,1,0,1,0
0,158,158,1,1,0,1,0
24,160,160,8,8,0,1,0
14,178,178,1,1,0,1,0
6,186,186,1,1,0,1,0
11,207,207,51,4,47,2,1
1,208,208,18,9,9,4,3
16,210,210,8,8,0,1,0
9,226,226,3,3,0,1,0
3,227,227,64,36,28,3,2
20,231,231,17,17,0,1,0
28,234,234,1,1,0,1,0
17,238,238,1,1,0,1,0
33,263,263,46,46,0,1,0
5,264,264,25,2,23,4,3
34,268,268,12,8,4,2,1
2,288,288,11,4,7,3,2
21,302,302,21,7,14,3,2
19,303,303,12,12,0,1,0
18,304,304,11,11,0,1,0
12,313,313,8,2,6,2,1
25,398,398,59,51,8,2,1
13,402,402,27,27,0,1,0
27,413,413,6,6,0,1,0
31,427,427,24,5,19,2,1
30,450,450,57,57,0,1,0
22,451,451,29,29,0,1,0
4,462,462,11,11,0,1,0
8,491,491,33,25,8,2,1
10,496,496,34,34,0,1,0

9,105,105,2,2,0,1,0
18,114,114,18,18,0,1,0
35,132,132,30,30,0,1,0
5,134,134,11,5,6,2,1
17,137,137,8,8,0,1,0
28,141,141,19,8,11,2,1
11,153,153,2,2,0,1,0
33,177,177,13,13,0,1,0
8,185,185,16,16,0,1,0
16,188,188,21,21,0,1,0
2,202,202,8,8,0,1,0
19,237,237,1,1,0,1,0
4,246,246,28,28,0,1,0
24,248,248,1,1,0,1,0
30,255,255,73,7,66,3,2
12,261,261,9,5,4,2,1
14,272,272,35,35,0,1,0
27,277,277,14,4,10,2,1
6,286,286,2,2,0,1,0
32,291,291,28,28,0,1,0
3,319,319,7,1,6,3,2
34,324,324,80,80,0,1,0
22,340,340,29,8,21,4,3
7,341,341,50,8,42,2,1
29,343,343,60,60,0,1,0
26,367,367,23,13,10,3,2
23,367,367,8,3,5,2,1
21,379,379,2,2,0,1,0
13,392,392,84,84,0,1,0
1,419,419,62,30,32,2,1
31,420,420,28,1,27,4,3
25,427,427,5,5,0,1,0
20,446,446,78,78,0,1,0
0,457,457,20,20,0,1,0
15,469,469,90,42,48,4,3
10,491,491,41,4,37,2,1

2,102,102,5,1,4,2,1
7,105,105,10,10,0,1,0
6,128,128,1,1,0,1,0
3,193,193,5,5,0,1,0
11,208,208,14,2,12,3,2
20,208,208,13,1,12,3,2
21,213,213,8,8,0,1,0
36,223,223,46,46,0,1,0
31,225,225,48,48,0,1,0
29,226,226,22,22,0,1,0
24,228,228,7,1,6,2,1
28,232,232,46,38,8,3,2
9,251,251,8,8,0,1,0
1,254,254,16,16,0,1,0
18,263,263,42,42,0,1,0
27,286,286,88,88,0,1,0
35,309,309,1,1,0,1,0
17,312,312,49,2,47,4,3
32,320,320,12,2,10,2,1
23,320,320,33,19,14,2,1
26,323,323,9,9,0,1,0
15,328,328,1,1,0,1,0
12,333,333,43,9,34,3,2
25,341,341,13,3,10,2,1
33,345,345,94,80,14,2,1
5,349,349,22,22,0,1,0
10,369,369,44,21,23,2,1
34,372,372,10,10,0,1,0
4,385,385,53,29,24,3,2
8,398,398,15,5,10,3,2
14,422,422,1,1,0,1,0
13,431,431,120,36,84,3,2
19,433,433,3,3,0,1,0
30,433,433,13,5,8,3,2
22,459,459,18,8,10,2,1
16,482,482,122,77,45,4,3
0,495,495,7,7,0,1,0

2,113,113,20,16,4,2,1
20,114,114,6,6,0,1,0
25,115,115,2,2,0,1,0
16,171,171,10,1,9,2,1
4,184,184,10,10,0,1,0
27,198,198,44,30,14,2,1
29,224,224,1,1,0,1,0
0,226,226,18,18,0,1,0
19,239,239,5,5,0,1,0
17,246,246,72,72,0,1,0
7,261,261,107,85,22,3,2
9,283,283,78,36,42,4,3
18,296,296,120,120,0,1,0
12,309,309,1,1,0,1,0
23,313,313,12,1,11,2,1
11,325,325,41,41,0,1,0
28,334,334,4,4,0,1,0
5,345,345,11,11,0,1,0
26,367,367,23,3,20,2,1
22,378,378,104,47,57,4,3
13,384,384,4,1,3,2,1
32,386,386,16,16,0,1,0
15,400,400,71,25,46,3,2
14,402,402,44,44,0,1,0
3,417,417,40,40,0,1,0
1,420,420,1,1,0,1,0
8,439,439,4,4,0,1,0
31,452,452,22,13,9,4,3
21,463,463,8,8,0,1,0
30,464,464,45,15,30,3,2
24,469,469,32,32,0,1,0
10,472,472,60,50,10,2,1
6,478,478,6,6,0,1,0

0,125,125,1,1,0,1,0
5,135,135,2,2,0,1,0
9,136,136,12,12,0,1,0
19,156,156,66,66,0,1,0
8,157,157,1,1,0,1,0
12,166,166,19,19,0,1,0
27,182,182,13,2,11,2,1
33,183,183,2,2,0,1,0
15,212,212,19,11,8,2,1
29,233,233,15,15,0,1,0
6,243,243,5,5,0,1,0
17,246,246,2,2,0,1,0
22,268,268,62,29,33,4,3
16,278,278,57,13,44,3,2
13,284,284,13,13,0,1,0
24,307,307,53,53,0,1,0
21,311,311,40,40,0,1,0
3,314,314,171,144,27,2,1
23,334,334,50,50,0,1,0
10,348,348,12,12,0,1,0
25,374,374,18,18,0,1,0
30,394,394,50,50,0,1,0
28,395,395,6,2,4,2,1
31,395,395,49,37,12,3,2
18,401,401,28,28,0,1,0
32,421,421,16,16,0,1,0
26,424,424,4,1,3,2,1
20,442,442,16,16,0,1,0
11,444,444,37,2,35,2,1
14,452,452,2,2,0,1,0
2,468,468,119,63,56,4,3
1,476,476,22,7,15,2,1
4,478,478,54,54,0,1,0
7,495,495,15,15,0,1,0

6,103,103,5,5,0,1,0
39,105,105,5,1,4,2,1
31,115,115,27,27,0,1,0
14,143,143,4,4,0,1,0
8,143,143,15,15,0,1,0
38,145,145,11,11,0,1,0
1,147,147,20,1,19,2,1
3,155,155,3,3,0,1,0
22,159,159,1,1,0,1,0
33,172,172,9,1,8,3,2
26,183,183,28,28,0,1,0
36,184,184,33,17,16,3,2
20,187,187,14,4,10,2,1
9,188,188,22,22,0,1,0
11,189,189,9,9,0,1,0
21,196,196,47,30,17,2,1
0,215,215,4,4,0,1,0
29,222,222,28,2,26,3,2
15,233,233,41,9,32,3,2
25,241,241,14,14,0,1,0
24,274,274,100,18,82,4,3
34,277,277,15,1,14,2,1
10,287,287,18,18,0,1,0
18,298,298,5,2,3,2,1
7,349,349,9,9,0,1,0
37,355,355,12,2,10,2,1
40,360,360,7,4,3,2,1
17,361,361,4,4,0,1,0
5,361,361,6,6,0,1,0
2,366,366,12,8,4,2,1
13,386,386,93,75,18,4,3
35,408,408,6,6,0,1,0
28,415,415,23,17,6,3,2
4,420,420,25,16,9,2,1
30,433,433,4,1,3,2,1
12,434,434,25,25,0,1,0
16,442,442,51,29,22,3,2
27,469,469,33,33,0,1,0
19,474,474,13,1,12,4,3
32,486,486,83,34,49,3,2
23,488,488,8,8,0,1,0

2,107,107,3,3,0,1,0
18,109,109,1,1,0,1,0
4,113,113,27,1,26,3,2
1,114,114,3,3,0,1,0
28,120,120,21,2,19,3,2
21,142,142,4,4,0,1,0
13,158,158,18,6,12,4,3
29,161,161,17,8,9,2,1
15,168,168,22,5,17,3,2
22,174,174,13,13,0,1,0
26,198,198,15,3,12,4,3
19,205,205,1,1,0,1,0
20,207,207,9,9,0,1,0
5,216,216,57,21,36,3,2
31,225,225,16,16,0,1,0
16,250,250,12,12,0,1,0
25,262,262,32,32,0,1,0
9,291,291,30,30,0,1,0
8,295,295,43,43,0,1,0
23,315,315,14,6,8,2,1
33,315,315,35,35,0,1,0
14,331,331,17,17,0,1,0
6,341,341,16,9,7,2,1
0,348,348,44,15,29,2,1
30,360,360,32,32,0,1,0
7,367,367,7,7,0,1,0
34,370,370,105,105,0,1,0
11,373,373,15,4,11,2,1
32,385,385,102,69,33,4,3
3,408,408,42,10,32,3,2
35,420,420,12,12,0,1,0
27,458,458,5,5,0,1,0
17,458,458,39,39,0,1,0
24,465,465,89,25,64,3,2
10,477,477,39,39,0,1,0
12,494,494,19,19,0,1,0

9,105,105,6,3,3,2,1
4,110,110,4,4,0,1,0
18,126,126,5,5,0,1,0
24,159,159,5,5,0,1,0
8,184,184,15,3,12,3,2
32,207,207,6,6,0,1,0
6,230,230,27,21,6,3,2
22,254,254,51,36,15,2,1
30,265,265,6,6,0,1,0
27,272,272,97,97,0,1,0
15,276,276,25,25,0,1,0
0,285,285,40,40,0,1,0
17,293,293,63,18,45,4,3
33,298,298,15,15,0,1,0
5,304,304,55,55,0,1,0
25,311,311,23,23,0,1,0
1,332,332,21,21,0,1,0
2,358,358,84,84,0,1,0
11,360,360,33,24,9,4,3
12,372,372,12,12,0,1,0
16,409,409,24,13,11,2,1
3,425,425,4,1,3,2,1
13,437,437,1,1,0,1,0
20,453,453,38,38,0,1,0
21,458,458,86,86,0,1,0
14,462,462,65,65,0,1,0
28,467,467,17,17,0,1,0
31,472,472,20,20,0,1,0
10,476,476,34,28,6,2,1
19,478,478,28,3,25,2,1
23,479,479,52,52,0,1,0
26,488,488,37,9,28,3,2
29,491,491,58,3,55,3,2
7,491,491,144,144,0,1,0

19,128,128,3,3,0,1,0
28,154,154,4,4,0,1,0
6,158,158,2,2,0,1,0
7,162,162,8,8,0,1,0
18,174,174,7,1,6,3,2
11,179,179,5,5,0,1,0
16,191,191,6,6,0,1,0
22,194,194,60,43,17,4,3
1,216,216,1,1,0,1,0
9,221,221,48,48,0,1,0
17,233,233,15,3,12,3,2
20,253,253,12,12,0,1,0
26,261,261,12,2,10,2,1
27,263,263,5,5,0,1,0
4,283,283,32,5,27,4,3
13,294,294,47,7,40,3,2
14,296,296,22,22,0,1,0
10,315,315,5,5,0,1,0
31,337,337,17,5,12,2,1
15,340,340,54,54,0,1,0
0,340,340,36,14,22,2,1
12,353,353,104,18,86,3,2
32,397,397,9,2,7,2,1
24,404,404,27,15,12,3,2
25,416,416,2,2,0,1,0
3,420,420,38,38,0,1,0
8,422,422,26,8,18,4,3
5,434,434,96,60,36,3,2
30,435,435,34,34,0,1,0
2,470,470,44,2,42,3,2
23,474,474,80,80,0,1,0
21,478,478,288,259,29,2,1
29,493,493,65,5,60,4,3

25,113,113,4,4,0,1,0
11,135,135,5,2,3,2,1
17,145,145,25,25,0,1,0
21,153,153,5,5,0,1,0
4,159,159,7,7,0,1,0
22,159,159,1,1,0,1,0
1,169,169,20,20,0,1,0
12,176,176,53,53,0,1,0
31,181,181,10,10,0,1,0
14,207,207,27,27,0,1,0
19,215,215,1,1,0,1,0
3,216,216,11,11,0,1,0
26,251,251,41,41,0,1,0
29,263,263,9,9,0,1,0
27,266,266,18,7,11,2,1
16,274,274,71,5,66,4,3
30,276,276,139,64,75,4,3
8,280,280,10,2,8,3,2
18,286,286,1,1,0,1,0
9,310,310,9,9,0,1,0
20,332,332,1,1,0,1,0
15,336,336,90,90,0,1,0
10,338,338,19,19,0,1,0
32,362,362,45,9,36,2,1
33,365,365,30,7,23,3,2
2,389,389,20,20,0,1,0
6,401,401,8,8,0,1,0
5,402,402,23,23,0,1,0
7,409,409,55,55,0,1,0
23,461,461,152,103,49,3,2
28,477,477,42,6,36,3,2
13,482,482,36,31,5,2,1
0,487,487,16,6,10,3,2
24,499,499,17,17,0,1,0

0,106,106,7,1,6,3,2
24,146,146,3,3,0,1,0
20,150,150,8,2,6,2,1
26,156,156,16,16,0,1,0
10,160,160,15,7,8,3,2
28,182,182,44,44,0,1,0
19,185,185,10,10,0,1,0
33,190,190,34,34,0,1,0
11,193,193,38,26,12,3,2
30,195,195,15,15,0,1,0
12,213,213,10,10,0,1,0
13,228,228,47,38,9,2,1
3,251,251,12,6,6,2,1
17,278,278,24,11,13,2,1
22,279,279,29,5,24,4,3
31,300,300,48,28,20,2,1
29,305,305,30,30,0,1,0
15,315,315,13,4,9,2,1
18,320,320,3,3,0,1,0
4,344,344,97,97,0,1,0
2,349,349,24,24,0,1,0
1,351,351,4,1,3,2,1
21,354,354,1,1,0,1,0
7,365,365,9,6,3,2,1
27,372,372,19,10,9,2,1
5,373,373,29,29,0,1,0
6,383,383,2,2,0,1,0
23,393,393,123,81,42,3,2
8,399,399,63,3,60,3,2
16,403,403,95,95,0,1,0
32,405,405,6,6,0,1,0
14,426,426,23,15,8,3,2
25,448,448,71,71,0,1,0
9,494,494,42,9,33,4,3

28,103,103,5,5,0,1,0
26,110,110,1,1,0,1,0
25,118,118,4,4,0,1,0
20,122,122,1,1,0,1,0
15,128,128,15,7,8,3,2
1,137,137,1,1,0,1,0
9,139,139,21,21,0,1,0
35,158,158,21,21,0,1,0
17,172,172,9,9,0,1,0
36,183,183,36,36,0,1,0
12,187,187,7,7,0,1,0
32,188,188,34,34,0,1,0
27,202,202,13,9,4,2,1
5,216,216,2,2,0,1,0
4,227,227,6,6,0,1,0
14,228,228,19,19,0,1,0
38,230,230,26,26,0,1,0
0,232,232,18,18,0,1,0
13,243,243,45,3,42,4,3
30,248,248,4,1,3,2,1
10,275,275,33,3,30,4,3
39,283,283,5,5,0,1,0
23,306,306,16,16,0,1,0
37,324,324,81,17,64,4,3
34,324,324,54,54,0,1,0
29,335,335,70,12,58,3,2
24,390,390,95,70,25,2,1
11,404,404,65,12,53,3,2
16,414,414,34,34,0,1,0
19,430,430,121,121,0,1,0
3,437,437,4,4,0,1,0
18,438,438,30,23,7,2,1
33,460,460,2,2,0,1,0
2,465,465,4,4,0,1,0
7,465,465,20,5,15,2,1
31,472,472,2,2,0,1,0
8,474,474,39,39,0,1,0
21,474,474,1,1,0,1,0
22,478,478,32,32,0,1,0
6,487,487,10,10,0,1,0

30,119,119,16,12,4,2,1
4,127,127,15,3,12,3,2
0,149,149,3,3,0,1,0
9,149,149,3,3,0,1,0
17,160,160,20,12,8,3,2
13,165,165,8,4,4,2,1
2,168,168,28,28,0,1,0
28,207,207,7,4,3,2,1
12,232,232,42,11,31,2,1
22,254,254,11,11,0,1,0
27,290,290,6,6,0,1,0
23,298,298,78,63,15,2,1
11,299,299,14,8,6,2,1
10,315,315,10,5,5,2,1
15,337,337,45,30,15,4,3
6,355,355,5,5,0,1,0
5,362,362,20,20,0,1,0
33,389,389,26,26,0,1,0
25,389,389,53,47,6,2,1
1,399,399,71,71,0,1,0
32,416,416,64,64,0,1,0
31,418,418,107,60,47,2,1
16,419,419,4,4,0,1,0
7,426,426,119,119,0,1,0
21,434,434,16,16,0,1,0
14,434,434,75,26,49,4,3
29,434,434,25,25,0,1,0
3,436,436,88,88,0,1,0
20,446,446,62,36,26,3,2
24,456,456,1,1,0,1,0
18,459,459,18,18,0,1,0
8,473,473,11,11,0,1,0
26,474,474,97,14,83,4,3
19,486,486,7,7,0,1,0

3,125,125,12,12,0,1,0
25,132,132,3,3,0,1,0
1,153,153,8,8,0,1,0
8,162,162,8,8,0,1,0
10,176,176,20,20,0,1,0
2,177,177,5,5,0,1,0
35,204,204,33,1,32,2,1
27,216,216,9,9,0,1,0
20,223,223,18,18,0,1,0
24,229,229,11,11,0,1,0
7,231,231,11,11,0,1,0
34,241,241,73,24,49,2,1
26,246,246,14,14,0,1,0
6,247,247,9,1,8,3,2
30,255,255,4,4,0,1,0
28,265,265,7,1,6,2,1
11,278,278,63,19,44,2,1
18,295,295,35,5,30,4,3
15,296,296,24,24,0,1,0
32,296,296,15,15,0,1,0
23,298,298,37,37,0,1,0
33,330,330,106,100,6,2,1
16,343,343,3,3,0,1,0
5,366,366,16,5,11,2,1
12,370,370,34,34,0,1,0
9,407,407,82,74,8,2,1
4,412,412,22,1,21,4,3
29,413,413,56,20,36,2,1
19,422,422,10,7,3,2,1
13,435,435,37,22,15,4,3
21,441,441,43,43,0,1,0
22,442,442,47,47,0,1,0
31,464,464,52,28,24,3,2
17,468,468,85,73,12,3,2
0,484,484,35,35,0,1,0
14,490,490,55,55,0,1,0

19,104,104,1,1,0,1,0
22,110,110,2,2,0,1,0
20,112,112,6,6,0,1,0
29,115,115,13,4,9,4,3
17,118,118,24,18,6,3,2
4,121,121,11,6,5,2,1
30,132,132,14,14,0,1,0
15,138,138,13,6,7,2,1
10,160,160,4,4,0,1,0
16,172,172,25,17,8,3,2
7,182,182,14,14,0,1,0
14,193,193,3,3,0,1,0
1,198,198,11,11,0,1,0
32,198,198,33,33,0,1,0
35,226,226,14,9,5,2,1
5,232,232,2,2,0,1,0
6,237,237,11,11,0,1,0
23,242,242,14,11,3,2,1
36,259,259,16,1,15,2,1
3,292,292,1,1,0,1,0
11,292,292,25,3,22,2,1
33,304,304,21,21,0,1,0
34,307,307,36,36,0,1,0
37,319,319,13,1,12,4,3
12,332,332,32,32,0,1,0
25,364,364,122,114,8,3,2
8,393,393,10,6,4,2,1
18,402,402,62,50,12,3,2
24,422,422,34,34,0,1,0
31,427,427,13,13,0,1,0
28,436,436,148,131,17,2,1
2,438,438,76,66,10,3,2
0,442,442,75,24,51,4,3
27,444,444,42,42,0,1,0
21,455,455,25,9,16,3,2
38,459,459,2,2,0,1,0
9,469,469,43,43,0,1,0
13,481,481,10,10,0,1,0
26,490,490,16,7,9,4,3

10,122,122,29,29,0,1,0
23,125,125,9,2,7,2,1
5,151,151,3,3,0,1,0
11,166,166,2,2,0,1,0
16,167,167,21,12,9,2,1
1,180,180,27,12,15,4,3
29,181,181,10,10,0,1,0
27,193,193,45,45,0,1,0
25,203,203,25,25,0,1,0
15,212,212,13,3,10,2,1
20,233,233,35,1,34,2,1
21,235,235,9,1,8,2,1
12,257,257,44,44,0,1,0
24,263,263,28,2,26,2,1
26,290,290,11,11,0,1,0
3,307,307,38,38,0,1,0
14,317,317,16,16,0,1,0
7,348,348,3,3,0,1,0
13,357,357,15,15,0,1,0
4,358,358,1,1,0,1,0
19,360,360,76,76,0,1,0
22,392,392,53,53,0,1,0
18,412,412,10,10,0,1,0
8,413,413,5,5,0,1,0
9,416,416,55,55,0,1,0
2,420,420,132,123,9,2,1
30,431,431,6,6,0,1,0
6,440,440,130,81,49,2,1
28,450,450,31,31,0,1,0
17,468,468,101,79,22,2,1
0,476,476,86,79,7,2,1

30,102,102,11,8,3,2,1
17,122,122,21,6,15,2,1
15,123,123,3,3,0,1,0
32,137,137,1,1,0,1,0
13,206,206,58,58,0,1,0
21,216,216,22,22,0,1,0
28,219,219,2,2,0,1,0
1,222,222,1,1,0,1,0
8,229,229,10,4,6,3,2
31,231,231,9,9,0,1,0
19,239,239,114,102,12,2,1
5,250,250,3,3,0,1,0
26,257,257,6,3,3,2,1
22,265,265,12,12,0,1,0
20,278,278,36,36,0,1,0
3,284,284,32,5,27,4,3
11,285,285,28,28,0,1,0
24,286,286,5,5,0,1,0
0,288,288,5,5,0,1,0
6,291,291,36,36,0,1,0
25,302,302,9,9,0,1,0
7,322,322,3,3,0,1,0
9,342,342,65,8,57,4,3
33,357,357,49,49,0,1,0
27,376,376,54,22,32,3,2
4,384,384,8,8,0,1,0
29,401,401,74,35,39,2,1
16,409,409,10,1,9,2,1
14,425,425,14,14,0,1,0
2,429,429,89,9,80,4,3
23,430,430,11,8,3,2,1
18,471,471,45,21,24,4,3
10,496,496,141,96,45,4,3
12,498,498,106,90,16,3,2

24,103,103,5,5,0,1,0
30,124,124,34,15,19,2,1
12,131,131,3,3,0,1,0
36,147,147,26,26,0,1,0
5,154,154,22,7,15,4,3
6,177,177,13,1,12,4,3
0,180,180,3,3,0,1,0
21,183,183,23,12,11,2,1
37,191,191,7,7,0,1,0
14,196,196,4,4,0,1,0
8,218,218,14,14,0,1,0
15,221,221,45,27,18,2,1
4,233,233,12,4,8,3,2
35,236,236,11,11,0,1,0
29,255,255,35,35,0,1,0
22,256,256,18,3,15,4,3
2,272,272,5,5,0,1,0
26,297,297,21,3,18,3,2
27,300,300,52,12,40,2,1
28,309,309,8,8,0,1,0
9,313,313,45,17,28,2,1
31,328,328,22,22,0,1,0
23,342,342,20,20,0,1,0
10,375,375,21,9,12,2,1
7,376,376,22,4,18,2,1
18,378,378,14,14,0,1,0
33,402,402,39,39,0,1,0
1,405,405,1,1,0,1,0
16,410,410,10,10,0,1,0
25,424,424,88,70,18,3,2
17,433,433,67,67,0,1,0
3,435,435,1,1,0,1,0
11,440,440,54,54,0,1,0
20,462,462,86,20,66,4,3
19,469,469,6,3,3,2,1
34,478,478,29,20,9,2,1
32,486,486,43,43,0,1,0
13,492,492,80,15,65,4,3
38,493,493,43,31,12,3,2

23,117,117,40,9,31,2,1
35,125,125,12,1,11,4,3
2,133,133,6,6,0,1,0
9,158,158,2,2,0,1,0
1,169,169,10,1,9,4,3
24,178,178,10,2,8,2,1
5,190,190,18,18,0,1,0
19,198,198,40,30,10,2,1
31,202,202,38,6,32,2,1
16,226,226,26,4,22,2,1
7,228,228,46,46,0,1,0
11,228,228,6,6,0,1,0
13,250,250,3,3,0,1,0
30,250,250,10,4,6,2,1
28,261,261,15,15,0,1,0
29,267,267,29,29,0,1,0
33,284,284,8,3,5,2,1
25,290,290,20,3,17,3,2
22,296,296,8,8,0,1,0
20,305,305,18,18,0,1,0
21,319,319,35,19,16,2,1
10,333,333,18,18,0,1,0
18,334,334,38,38,0,1,0
27,355,355,99,34,65,4,3
12,358,358,51,19,32,2,1
3,364,364,46,16,30,2,1
15,369,369,40,31,9,4,3
32,383,383,1,1,0,1,0
8,390,390,35,26,9,4,3
0,418,418,88,54,34,2,1
26,433,433,26,7,19,2,1
17,441,441,85,42,43,2,1
34,444,444,7,1,6,3,2
4,448,448,16,4,12,2,1
6,464,464,11,5,6,3,2
14,477,477,18,8,10,3,2

8,103,103,26,26,0,1,0
22,119,119,5,5,0,1,0
27,123,123,11,7,4,2,1
16,146,146,3,3,0,1,0
30,180,180,34,22,12,4,3
21,193,193,5,2,3,2,1
28,211,211,22,7,15,2,1
20,213,213,13,6,7,2,1
15,214,214,56,35,21,2,1
14,218,218,11,11,0,1,0
31,219,219,6,6,0,1,0
2,224,224,18,18,0,1,0
23,225,225,25,25,0,1,0
17,229,229,6,2,4,2,1
12,230,230,8,8,0,1,0
26,245,245,23,5,18,3,2
19,264,264,79,79,0,1,0
29,293,293,19,2,17,2,1
32,296,296,40,40,0,1,0
13,328,328,32,8,24,4,3
10,344,344,23,14,9,4,3
4,356,356,46,46,0,1,0
6,359,359,98,91,7,2,1
33,375,375,28,28,0,1,0
25,383,383,79,79,0,1,0
18,393,393,3,3,0,1,0
3,415,415,8,2,6,2,1
9,416,416,13,13,0,1,0
24,443,443,81,27,54,4,3
7,443,443,40,40,0,1,0
0,452,452,1,1,0,1,0
11,461,461,29,2,27,4,3
5,468,468,16,16,0,1,0
1,493,493,97,27,70,4,3

11,121,121,15,15,0,1,0
1,122,122,2,2,0,1,0
4,130,130,5,5,0,1,0
21,132,132,16,13,3,2,1
6,183,183,49,37,12,2,1
14,187,187,17,11,6,2,1
34,189,189,16,1,15,2,1
32,190,190,7,1,6,3,2
16,210,210,44,2,42,2,1
27,210,210,14,14,0,1,0
36,212,212,8,1,7,2,1
5,238,238,1,1,0,1,0
8,243,243,11,2,9,2,1
2,260,260,8,2,6,3,2
26,261,261,29,1,28,2,1
13,280,280,1,1,0,1,0
9,284,284,41,14,27,4,3
7,287,287,2,2,0,1,0
31,304,304,25,25,0,1,0
28,317,317,40,4,36,2,1
29,337,337,64,35,29,2,1
19,338,338,1,1,0,1,0
10,347,347,29,5,24,4,3
15,349,349,28,28,0,1,0
3,350,350,26,26,0,1,0
35,352,352,17,17,0,1,0
30,359,359,16,16,0,1,0
33,374,374,52,16,36,4,3
12,397,397,53,53,0,1,0
20,397,397,27,27,0,1,0
37,410,410,14,1,13,2,1
25,413,413,53,37,16,2,1
18,421,421,66,37,29,2,1
0,430,430,32,32,0,1,0
24,435,435,75,31,44,2,1
17,444,444,20,1,19,2,1
23,453,453,48,11,37,3,2
22,463,463,95,7,88,4,3

10,107,107,6,6,0,1,0
12,132,132,5,5,0,1,0
32,136,136,23,2,21,4,3
24,146,146,50,31,19,4,3
26,149,149,2,2,0,1,0
6,159,159,7,7,0,1,0
14,163,163,13,4,9,4,3
36,169,169,23,11,12,4,3
18,193,193,37,25,12,2,1
5,241,241,19,6,13,2,1
27,251,251,74,74,0,1,0
11,262,262,47,47,0,1,0
3,268,268,11,11,0,1,0
20,271,271,32,32,0,1,0
13,273,273,4,4,0,1,0
15,279,279,43,43,0,1,0
23,288,288,12,12,0,1,0
30,299,299,35,17,18,4,3
17,304,304,40,22,18,4,3
0,305,305,56,5,51,4,3
22,312,312,6,6,0,1,0
35,319,319,25,25,0,1,0
21,320,320,57,23,34,3,2
28,368,368,4,4,0,1,0
4,379,379,11,11,0,1,0
33,383,383,10,4,6,2,1
34,393,393,25,1,24,4,3
31,410,410,1,1,0,1,0
9,416,416,48,27,21,4,3
16,417,417,2,2,0,1,0
19,433,433,29,8,21,2,1
1,441,441,52,52,0,1,0
7,457,457,15,1,14,3,2
2,474,474,11,5,6,3,2
8,484,484,57,16,41,2,1
29,494,494,28,16,12,3,2
25,496,496,33,30,3,2,1

10,129,129,1,1,0,1,0
18,132,132,7,7,0,1,0
3,136,136,1,1,0,1,0
0,179,179,55,21,34,2,1
19,180,180,12,12,0,1,0
15,181,181,59,9,50,4,3
36,182,182,31,31,0,1,0
20,196,196,1,1,0,1,0
33,213,213,4,4,0,1,0
23,231,231,53,33,20,2,1
7,242,242,1,1,0,1,0
1,246,246,1,1,0,1,0
35,256,256,18,18,0,1,0
31,258,258,2,2,0,1,0
8,259,259,32,19,13,2,1
21,263,263,48,48,0,1,0
37,264,264,50,50,0,1,0
13,276,276,17,17,0,1,0
32,279,279,12,12,0,1,0
9,295,295,23,23,0,1,0
28,300,300,53,53,0,1,0
25,310,310,21,21,0,1,0
2,326,326,7,7,0,1,0
34,337,337,2,2,0,1,0
11,351,351,5,1,4,2,1
26,366,366,23,23,0,1,0
14,369,369,13,1,12,2,1
27,374,374,115,94,21,2,1
4,386,386,102,3,99,4,3
30,391,391,12,5,7,2,1
6,395,395,47,47,0,1,0
5,422,422,49,49,0,1,0
12,427,427,22,22,0,1,0
29,440,440,20,20,0,1,0
16,448,448,6,6,0,1,0
24,456,456,44,3,41,4,3
17,467,467,10,2,8,2,1
22,469,469,10,3,7,2,1

22,108,108,6,6,0,1,0
31,118,118,10,10,0,1,0
20,125,125,29,29,0,1,0
38,150,150,8,8,0,1,0
37,151,151,7,7,0,1,0
15,165,165,23,23,0,1,0
6,174,174,5,5,0,1,0
28,175,175,26,1,25,2,1
5,184,184,2,2,0,1,0
29,209,209,1,1,0,1,0
42,227,227,7,1,6,2,1
40,228,228,34,34,0,1,0
25,234,234,17,17,0,1,0
1,242,242,1,1,0,1,0
33,246,246,6,1,5,2,1
35,250,250,35,35,0,1,0
30,254,254,19,10,9,4,3
24,260,260,25,25,0,1,0
36,260,260,26,20,6,2,1
4,268,268,27,27,0,1,0
17,293,293,1,1,0,1,0
3,303,303,26,26,0,1,0
14,305,305,5,5,0,1,0
12,308,308,9,9,0,1,0
39,308,308,1,1,0,1,0
7,311,311,3,3,0,1,0
10,320,320,32,32,0,1,0
32,321,321,43,43,0,1,0
34,326,326,16,16,0,1,0
0,330,330,13,13,0,1,0
11,334,334,11,6,5,2,1
27,358,358,94,73,21,3,2
8,363,363,25,25,0,1,0
2,372,372,20,11,9,2,1
41,372,372,92,87,5,2,1
23,403,403,63,63,0,1,0
21,406,406,30,18,12,4,3
9,411,411,6,2,4,2,1
26,444,444,80,8,72,3,2
18,464,464,85,17,68,3,2
16,477,477,14,14,0,1,0
13,485,485,25,22,3,2,1
19,490,490,6,3,3,2,1

9,111,111,1,1,0,1,0
6,122,122,2,2,0,1,0
1,138,138,3,3,0,1,0
26,144,144,5,5,0,1,0
0,150,150,40,12,28,2,1
24,155,155,2,2,0,1,0
34,159,159,6,6,0,1,0
28,175,175,6,3,3,2,1
18,187,187,10,10,0,1,0
25,187,187,35,14,21,4,3
35,194,194,35,35,0,1,0
5,211,211,27,3,24,3,2
32,215,215,72,30,42,4,3
7,230,230,4,4,0,1,0
31,235,235,5,2,3,2,1
19,235,235,48,36,12,3,2
3,302,302,17,17,0,1,0
11,322,322,30,30,0,1,0
17,325,325,14,14,0,1,0
10,327,327,51,51,0,1,0
16,363,363,9,1,8,3,2
23,366,366,27,20,7,2,1
29,382,382,13,13,0,1,0
33,397,397,1,1,0,1,0
14,408,408,16,16,0,1,0
30,411,411,11,1,10,4,3
2,433,433,103,79,24,4,3
8,434,434,77,56,21,4,3
27,439,439,38,38,0,1,0
13,450,450,113,113,0,1,0
4,458,458,14,1,13,3,2
20,469,469,29,21,8,3,2
22,475,475,58,58,0,1,0
21,485,485,135,39,96,4,3
12,485,485,35,8,27,4,3
15,495,495,3,3,0,1,0

20,113,113,7,7,0,1,0
12,126,126,14,9,5,2,1
27,132,132,13,3,10,3,2
14,134,134,2,2,0,1,0
0,142,142,19,19,0,1,0
4,143,143,29,8,21,4,3
2,147,147,9,9,0,1,0
23,180,180,37,37,0,1,0
25,204,204,2,2,0,1,0
22,209,209,22,22,0,1,0
13,234,234,16,1,15,4,3
33,235,235,148,94,54,4,3
7,253,253,53,53,0,1,0
28,263,263,31,22,9,2,1
32,286,286,8,8,0,1,0
15,286,286,52,6,46,3,2
24,286,286,6,6,0,1,0
29,297,297,13,13,0,1,0
8,301,301,4,4,0,1,0
3,303,303,4,4,0,1,0
31,318,318,59,41,18,3,2
17,327,327,13,1,12,4,3
11,336,336,8,2,6,2,1
21,336,336,42,18,24,4,3
9,336,336,75,3,72,3,2
5,341,341,24,24,0,1,0
16,346,346,45,45,0,1,0
6,362,362,18,1,17,2,1
26,364,364,1,1,0,1,0
18,385,385,13,13,0,1,0
10,388,388,64,15,49,2,1
30,412,412,13,13,0,1,0
1,441,441,13,13,0,1,0
19,468,468,2,2,0,1,0

12,101,101,5,1,4,2,1
3,105,105,2,2,0,1,0
32,125,125,23,15,8,2,1
19,140,140,4,4,0,1,0
7,147,147,28,28,0,1,0
1,164,164,11,11,0,1,0
9,187,187,19,19,0,1,0
20,193,193,21,21,0,1,0
14,195,195,42,2,40,2,1
11,211,211,18,18,0,1,0
31,215,215,40,40,0,1,0
22,217,217,23,23,0,1,0
28,225,225,78,78,0,1,0
5,258,258,33,8,25,2,1
17,260,260,8,2,6,2,1
15,280,280,28,28,0,1,0
30,284,284,45,19,26,3,2
10,290,290,53,29,24,4,3
21,303,303,5,5,0,1,0
23,309,309,7,2,5,2,1
27,340,340,46,30,16,3,2
0,383,383,2,2,0,1,0
8,396,396,65,17,48,2,1
18,397,397,2,2,0,1,0
4,405,405,41,24,17,2,1
6,419,419,49,49,0,1,0
2,421,421,17,4,13,2,1
26,449,449,78,18,60,4,3
24,454,454,24,24,0,1,0
16,466,466,32,32,0,1,0
25,468,468,19,19,0,1,0
13,491,491,66,38,28,3,2
29,498,498,31,31,0,1,0

35,107,107,2,2,0,1,0
5,122,122,14,14,0,1,0
24,136,136,8,2,6,3,2
37,139,139,9,9,0,1,0
18,164,164,6,6,0,1,0
34,169,169,7,4,3,2,1
11,179,179,6,2,4,2,1
28,188,188,20,7,13,2,1
40,195,195,26,26,0,1,0
1,195,195,3,3,0,1,0
15,212,212,1,1,0,1,0
4,215,215,20,20,0,1,0
21,218,218,7,7,0,1,0
9,225,225,22,22,0,1,0
38,248,248,27,1,26,2,1
10,255,255,64,27,37,2,1
27,259,259,15,4,11,2,1
0,272,272,1,1,0,1,0
23,276,276,1,1,0,1,0
29,277,277,1,1,0,1,0
31,281,281,103,19,84,4,3
6,288,288,21,21,0,1,0
17,288,288,11,11,0,1,0
22,290,290,14,2,12,3,2
8,297,297,45,45,0,1,0
12,306,306,30,18,12,4,3
26,308,308,35,35,0,1,0
7,316,316,21,5,16,2,1
30,323,323,61,61,0,1,0
32,362,362,14,8,6,3,2
14,374,374,71,71,0,1,0
19,377,377,19,5,14,3,2
20,387,387,57,57,0,1,0
36,410,410,10,10,0,1,0
13,419,419,31,25,6,3,2
2,452,452,4,4,0,1,0
25,470,470,74,28,46,4,3
16,474,474,5,5,0,1,0
3,476,476,28,28,0,1,0
33,478,478,28,28,0,1,0
39,491,491,97,67,30,3,2

28,123,123,4,4,0,1,0
5,128,128,9,9,0,1,0
15,128,128,4,4,0,1,0
35,137,137,33,15,18,4,3
30,139,139,13,4,9,4,3
13,149,149,29,29,0,1,0
36,153,153,11,6,5,2,1
25,159,159,22,6,16,4,3
14,163,163,1,1,0,1,0
9,189,189,5,2,3,2,1
31,210,210,1,1,0,1,0
17,215,215,16,1,15,2,1
7,217,217,12,12,0,1,0
32,220,220,14,14,0,1,0
6,223,223,39,39,0,1,0
22,237,237,21,21,0,1,0
27,238,238,44,44,0,1,0
29,244,244,32,32,0,1,0
26,254,254,5,5,0,1,0
0,256,256,53,53,0,1,0
34,265,265,30,8,22,2,1
20,268,268,8,8,0,1,0
18,287,287,13,13,0,1,0
10,287,287,1,1,0,1,0
1,311,311,12,12,0,1,0
33,329,329,28,7,21,2,1
3,348,348,54,4,50,2,1
8,353,353,19,19,0,1,0
16,363,363,12,12,0,1,0
24,372,372,3,3,0,1,0
4,373,373,42,30,12,2,1
2,389,389,80,80,0,1,0
11,405,405,45,17,28,2,1
21,437,437,14,14,0,1,0
12,472,472,4,4,0,1,0
23,474,474,192,69,123,4,3
19,478,478,45,45,0,1,0

14,102,102,17,8,9,2,1
25,108,108,4,4,0,1,0
23,133,133,5,5,0,1,0
32,143,143,22,13,9,4,3
2,179,179,10,10,0,1,0
5,188,188,1,1,0,1,0
29,193,193,4,4,0,1,0
6,209,209,9,6,3,2,1
21,211,211,17,5,12,2,1
0,238,238,33,33,0,1,0
27,239,239,10,1,9,4,3
28,240,240,62,6,56,3,2
24,248,248,38,32,6,2,1
17,255,255,19,19,0,1,0
1,278,278,24,24,0,1,0
31,279,279,5,5,0,1,0
8,298,298,21,21,0,1,0
7,308,308,113,56,57,4,3
19,328,328,2,2,0,1,0
4,329,329,21,6,15,2,1
33,330,330,57,26,31,3,2
9,332,332,99,56,43,2,1
20,350,350,13,13,0,1,0
30,365,365,75,75,0,1,0
13,369,369,7,7,0,1,0
15,376,376,3,3,0,1,0
10,408,408,31,31,0,1,0
16,444,444,57,5,52,3,2
18,458,458,60,26,34,2,1
26,478,478,108,50,58,3,2
22,484,484,40,22,18,3,2
3,487,487,59,59,0,1,0
11,491,491,18,1,17,2,1
12,498,498,8,8,0,1,0

33,113,113,3,3,0,1,0
15,122,122,17,4,13,2,1
10,125,125,2,2,0,1,0
5,126,126,15,4,11,2,1
29,135,135,17,17,0,1,0
9,142,142,9,9,0,1,0
25,144,144,56,56,0,1,0
26,145,145,16,2,14,2,1
32,153,153,12,6,6,3,2
7,158,158,10,10,0,1,0
2,173,173,10,3,7,2,1
24,176,176,14,14,0,1,0
28,202,202,4,1,3,2,1
19,228,228,6,6,0,1,0
11,230,230,13,2,11,2,1
3,238,238,9,5,4,2,1
35,244,244,11,11,0,1,0
13,263,263,70,19,51,4,3
12,277,277,22,7,15,4,3
22,285,285,29,29,0,1,0
17,297,297,8,8,0,1,0
18,299,299,16,8,8,3,2
16,303,303,20,20,0,1,0
8,339,339,60,19,41,4,3
23,342,342,127,101,26,2,1
1,344,344,92,62,30,4,3
4,352,352,29,29,0,1,0
0,366,366,38,7,31,4,3
6,368,368,9,9,0,1,0
34,381,381,16,16,0,1,0
14,392,392,1,1,0,1,0
27,395,395,10,10,0,1,0
31,406,406,18,1,17,2,1
30,429,429,66,4,62,3,2
21,440,440,33,33,0,1,0
20,499,499,10,10,0,1,0

1,134,134,6,6,0,1,0
32,136,136,27,27,0,1,0
23,149,149,7,1,6,2,1
18,160,160,17,5,12,3,2
5,165,165,10,1,9,2,1
17,165,165,2,2,0,1,0
27,167,167,17,17,0,1,0
21,167,167,15,15,0,1,0
33,169,169,19,19,0,1,0
30,185,185,19,19,0,1,0
16,204,204,13,8,5,2,1
0,204,204,38,38,0,1,0
3,209,209,3,3,0,1,0
22,211,211,3,3,0,1,0
19,253,253,37,9,28,2,1
24,257,257,10,6,4,2,1
2,259,259,2,2,0,1,0
11,299,299,2,2,0,1,0
20,301,301,64,64,0,1,0
29,302,302,13,13,0,1,0
12,305,305,43,43,0,1,0
8,306,306,5,5,0,1,0
6,306,306,46,46,0,1,0
26,320,320,32,32,0,1,0
25,335,335,1,1,0,1,0
14,348,348,3,3,0,1,0
13,373,373,179,163,16,2,1
31,381,381,120,71,49,2,1
28,412,412,38,38,0,1,0
7,417,417,40,2,38,3,2
4,421,421,51,51,0,1,0
10,426,426,50,30,20,3,2
9,436,436,39,19,20,4,3
15,447,447,45,45,0,1,0

23,106,106,22,12,10,2,1
19,124,124,3,3,0,1,0
0,129,129,4,4,0,1,0
21,130,130,7,7,0,1,0
25,144,144,13,13,0,1,0
28,159,159,15,11,4,2,1
3,162,162,6,2,4,2,1
20,165,165,7,1,6,2,1
8,165,165,28,14,14,3,2
16,167,167,14,1,13,2,1
15,179,179,45,29,16,3,2
18,196,196,24,6,18,3,2
9,198,198,4,4,0,1,0
12,208,208,67,67,0,1,0
10,214,214,7,7,0,1,0
4,214,214,7,2,5,2,1
14,229,229,1,1,0,1,0
7,232,232,21,21,0,1,0
27,241,241,22,22,0,1,0
29,242,242,20,20,0,1,0
1,252,252,28,28,0,1,0
11,262,262,9,1,8,2,1
22,280,280,45,33,12,3,2
6,299,299,64,64,0,1,0
35,308,308,96,48,48,2,1
36,316,316,10,10,0,1,0
37,324,324,6,3,3,2,1
34,326,326,1,1,0,1,0
32,332,332,6,6,0,1,0
31,338,338,20,20,0,1,0
24,344,344,2,2,0,1,0
17,373,373,18,8,10,2,1
30,392,392,172,172,0,1,0
2,401,401,1,1,0,1,0
26,407,407,25,11,14,2,1
5,423,423,3,3,0,1,0
13,455,455,10,10,0,1,0
33,489,489,6,6,0,1,0

20,108,108,2,2,0,1,0
26,117,117,26,26,0,1,0
5,120,120,13,3,10,3,2
32,131,131,44,44,0,1,0
3,132,132,19,11,8,2,1
2,138,138,3,3,0,1,0
8,147,147,1,1,0,1,0
36,154,154,25,25,0,1,0
21,154,154,14,3,11,3,2
37,173,173,2,2,0,1,0
17,213,213,5,5,0,1,0
10,213,213,9,9,0,1,0
35,223,223,2,2,0,1,0
30,232,232,16,11,5,2,1
34,276,276,16,10,6,3,2
1,278,278,38,8,30,4,3
0,288,288,8,4,4,2,1
16,300,300,1,1,0,1,0
33,303,303,9,4,5,2,1
19,308,308,54,18,36,4,3
4,323,323,20,20,0,1,0
12,349,349,7,7,0,1,0
6,353,353,36,1,35,2,1
13,360,360,81,39,42,4,3
25,381,381,65,65,0,1,0
27,384,384,8,5,3,2,1
28,385,385,81,60,21,2,1
11,400,400,44,44,0,1,0
22,402,402,11,6,5,2,1
18,412,412,36,36,0,1,0
23,412,412,6,6,0,1,0
14,427,427,2,2,0,1,0
29,434,434,44,31,13,4,3
9,438,438,30,3,27,4,3
31,453,453,10,10,0,1,0
15,484,484,43,13,30,3,2
7,488,488,112,60,52,3,2
24,491,491,91,51,40,4,3

3,106,106,1,1,0,1,0
30,121,121,10,7,3,2,1
34,129,129,8,5,3,2,1
7,153,153,1,1,0,1,0
27,156,156,36,36,0,1,0
36,157,157,48,48,0,1,0
22,170,170,7,3,4,2,1
14,184,184,18,3,15,4,3
20,188,188,4,4,0,1,0
6,190,190,1,1,0,1,0
33,192,192,37,26,11,2,1
2,195,195,1,1,0,1,0
12,196,196,27,27,0,1,0
0,200,200,1,1,0,1,0
15,216,216,1,1,0,1,0
16,224,224,8,4,4,2,1
13,228,228,43,38,5,2,1
37,235,235,11,11,0,1,0
19,241,241,14,14,0,1,0
11,252,252,18,18,0,1,0
38,268,268,57,57,0,1,0
8,272,272,31,31,0,1,0
40,275,275,15,15,0,1,0
4,314,314,27,11,16,2,1
28,315,315,19,15,4,2,1
31,315,315,23,1,22,2,1
23,319,319,3,3,0,1,0
21,322,322,2,2,0,1,0
17,351,351,6,6,0,1,0
9,368,368,50,41,9,4,3
41,380,380,11,11,0,1,0
32,383,383,8,4,4,2,1
24,395,395,44,35,9,4,3
29,399,399,8,1,7,2,1
10,400,400,66,22,44,3,2
35,427,427,68,68,0,1,0
25,431,431,74,74,0,1,0
26,458,458,2,2,0,1,0
39,460,460,6,6,0,1,0
1,475,475,19,10,9,4,3
5,478,478,22,4,18,2,1
18,480,480,135,30,105,4,3

1,120,120,12,12,0,1,0
23,125,125,34,34,0,1,0
25,133,133,27,6,21,4,3
16,150,150,2,2,0,1,0
3,165,165,19,19,0,1,0
31,171,171,2,2,0,1,0
26,190,190,13,2,11,3,2
33,197,197,4,4,0,1,0
4,198,198,6,3,3,2,1
30,218,218,2,2,0,1,0
2,235,235,2,2,0,1,0
7,246,246,1,1,0,1,0
17,258,258,11,8,3,2,1
6,284,284,23,7,16,3,2
8,292,292,36,36,0,1,0
27,312,312,20,4,16,3,2
13,357,357,26,26,0,1,0
14,362,362,109,102,7,2,1
29,366,366,19,1,18,2,1
32,379,379,56,17,39,2,1
22,383,383,92,92,0,1,0
0,389,389,47,47,0,1,0
28,391,391,17,17,0,1,0
11,415,415,42,22,20,3,2
24,422,422,33,21,12,2,1
5,426,426,96,10,86,3,2
15,435,435,58,38,20,3,2
10,440,440,36,36,0,1,0
9,453,453,75,57,18,4,3
21,472,472,142,142,0,1,0
20,475,475,10,10,0,1,0
12,478,478,12,12,0,1,0
19,490,490,42,42,0,1,0
18,496,496,32,32,0,1,0

33,118,118,13,13,0,1,0
3,125,125,26,20,6,2,1
8,128,128,20,20,0,1,0
23,138,138,5,5,0,1,0
13,155,155,27,17,10,2,1
10,166,166,3,3,0,1,0
11,194,194,30,30,0,1,0
29,195,195,3,3,0,1,0
18,202,202,33,33,0,1,0
25,232,232,18,14,4,2,1
5,234,234,26,16,10,2,1
9,237,237,14,4,10,3,2
30,249,249,51,51,0,1,0
4,250,250,6,6,0,1,0
7,257,257,13,13,0,1,0
27,272,272,13,1,12,3,2
20,292,292,25,25,0,1,0
14,292,292,27,27,0,1,0
12,295,295,28,10,18,3,2
15,310,310,33,9,24,2,1
16,317,317,16,4,12,2,1
22,336,336,29,14,15,4,3
1,354,354,84,27,57,3,2
24,385,385,1,1,0,1,0
26,396,396,147,97,50,3,2
6,398,398,10,1,9,2,1
31,412,412,37,24,13,2,1
21,413,413,8,8,0,1,0
19,418,418,33,28,5,2,1
28,463,463,70,52,18,3,2
32,469,469,43,43,0,1,0
2,480,480,2,2,0,1,0
17,486,486,50,50,0,1,0
0,495,495,66,66,0,1,0

28,119,119,13,3,10,2,1
3,123,123,4,4,0,1,0
21,124,124,28,2,26,2,1
27,143,143,23,23,0,1,0
19,148,148,9,9,0,1,0
7,150,150,5,5,0,1,0
4,165,165,25,25,0,1,0
18,166,166,5,1,4,2,1
34,173,173,6,3,3,2,1
2,198,198,56,56,0,1,0
9,230,230,16,16,0,1,0
15,235,235,20,20,0,1,0
12,244,244,11,11,0,1,0
20,272,272,28,12,16,2,1
0,282,282,36,29,7,2,1
13,286,286,69,9,60,3,2
23,290,290,10,10,0,1,0
8,296,296,12,12,0,1,0
11,300,300,2,2,0,1,0
22,312,312,58,15,43,2,1
31,318,318,18,18,0,1,0
30,323,323,18,6,12,3,2
10,369,369,60,60,0,1,0
29,374,374,86,86,0,1,0
33,391,391,73,73,0,1,0
6,398,398,15,15,0,1,0
5,404,404,38,22,16,2,1
17,418,418,44,44,0,1,0
32,418,418,14,14,0,1,0
14,427,427,7,7,0,1,0
24,427,427,40,40,0,1,0
1,437,437,1,1,0,1,0
26,460,460,43,43,0,1,0
25,494,494,19,9,10,3,2
16,500,500,84,27,57,4,3

27,106,106,2,2,0,1,0
26,112,112,10,1,9,4,3
16,127,127,13,10,3,2,1
5,141,141,1,1,0,1,0
34,145,145,6,6,0,1,0
20,159,159,10,10,0,1,0
2,162,162,4,4,0,1,0
39,165,165,10,10,0,1,0
29,167,167,27,27,0,1,0
4,172,172,36,10,26,3,2
28,174,174,41,41,0,1,0
1,178,178,12,2,10,2,1
35,189,189,9,9,0,1,0
21,195,195,11,4,7,2,1
33,197,197,56,42,14,2,1
32,198,198,33,33,0,1,0
9,243,243,19,19,0,1,0
37,246,246,55,21,34,3,2
15,278,278,20,20,0,1,0
13,283,283,37,1,36,3,2
31,289,289,1,1,0,1,0
36,309,309,61,61,0,1,0
22,323,323,1,1,0,1,0
8,344,344,12,12,0,1,0
0,346,346,68,32,36,2,1
3,349,349,7,7,0,1,0
23,357,357,19,13,6,2,1
17,364,364,78,33,45,4,3
7,372,372,22,7,15,2,1
6,373,373,1,1,0,1,0
18,378,378,6,1,5,2,1
12,381,381,14,14,0,1,0
30,382,382,14,14,0,1,0
10,383,383,2,2,0,1,0
14,395,395,8,8,0,1,0
11,410,410,15,2,13,2,1
24,413,413,15,15,0,1,0
40,455,455,25,15,10,2,1
25,469,469,30,30,0,1,0
19,477,477,91,91,0,1,0
38,497,497,15,15,0,1,0

16,108,108,6,6,0,1,0
4,109,109,2,2,0,1,0
7,111,111,1,1,0,1,0
6,142,142,17,17,0,1,0
8,180,180,1,1,0,1,0
3,192,192,30,30,0,1,0
10,197,197,99,99,0,1,0
14,203,203,8,8,0,1,0
9,206,206,6,6,0,1,0
27,211,211,20,12,8,2,1
21,214,214,23,23,0,1,0
17,242,242,191,191,0,1,0
5,258,258,64,64,0,1,0
25,265,265,10,10,0,1,0
24,283,283,5,5,0,1,0
15,292,292,25,25,0,1,0
23,315,315,19,10,9,4,3
2,316,316,40,16,24,4,3
22,316,316,27,13,14,3,2
28,334,334,28,2,26,2,1
18,357,357,24,3,21,2,1
0,365,365,112,62,50,2,1
12,384,384,21,21,0,1,0
11,424,424,71,36,35,2,1
1,432,432,5,5,0,1,0
13,461,461,12,2,10,3,2
26,473,473,39,39,0,1,0
20,477,477,2,2,0,1,0
19,491,491,19,11,8,3,2

10,100,100,18,18,0,1,0
26,127,127,2,2,0,1,0
3,141,141,2,2,0,1,0
19,169,169,5,5,0,1,0
29,186,186,1,1,0,1,0
18,186,186,59,28,31,2,1
16,202,202,36,24,12,4,3
2,203,203,27,27,0,1,0
6,203,203,5,5,0,1,0
32,255,255,87,37,50,2,1
27,269,269,16,16,0,1,0
31,284,284,108,86,22,3,2
20,285,285,2,2,0,1,0
21,298,298,46,41,5,2,1
12,324,324,8,8,0,1,0
5,324,324,81,81,0,1,0
28,334,334,3,3,0,1,0
24,339,339,13,13,0,1,0
22,343,343,35,32,3,2,1
23,352,352,21,6,15,2,1
17,357,357,3,3,0,1,0
4,362,362,81,27,54,4,3
25,369,369,1,1,0,1,0
11,383,383,41,41,0,1,0
1,385,385,19,19,0,1,0
14,387,387,50,32,18,4,3
30,407,407,9,1,8,3,2
8,413,413,92,64,28,2,1
0,433,433,34,19,15,4,3
13,442,442,36,14,22,3,2
9,451,451,8,8,0,1,0
15,469,469,24,12,12,3,2
7,492,492,56,41,15,2,1

5,111,111,1,1,0,1,0
10,116,116,11,5,6,2,1
14,130,130,15,5,10,2,1
31,131,131,17,17,0,1,0
0,136,136,3,3,0,1,0
17,137,137,12,12,0,1,0
35,147,147,20,4,16,2,1
12,161,161,2,2,0,1,0
24,174,174,2,2,0,1,0
1,183,183,8,8,0,1,0
39,188,188,15,4,11,2,1
33,191,191,27,27,0,1,0
23,215,215,36,36,0,1,0
19,234,234,1,1,0,1,0
21,246,246,10,6,4,2,1
30,257,257,17,5,12,4,3
8,262,262,29,29,0,1,0
22,282,282,16,1,15,2,1
2,300,300,56,6,50,3,2
15,301,301,34,34,0,1,0
36,304,304,14,10,4,2,1
7,312,312,15,15,0,1,0
13,318,318,3,3,0,1,0
37,319,319,10,10,0,1,0
27,325,325,5,2,3,2,1
40,328,328,66,66,0,1,0
20,345,345,31,3,28,3,2
9,346,346,1,1,0,1,0
41,357,357,13,3,10,3,2
16,357,357,7,7,0,1,0
4,357,357,73,1,72,4,3
28,358,358,3,3,0,1,0
6,379,379,24,6,18,3,2
32,382,382,157,127,30,4,3
29,385,385,1,1,0,1,0
26,401,401,19,2,17,3,2
18,422,422,28,28,0,1,0
25,435,435,3,3,0,1,0
34,444,444,123,60,63,4,3
3,450,450,26,26,0,1,0
11,480,480,30,30,0,1,0
38,491,491,48,21,27,4,3

32,101,101,15,15,0,1,0
6,117,117,42,6,36,2,1
31,119,119,6,6,0,1,0
8,128,128,7,7,0,1,0
17,135,135,21,21,0,1,0
15,137,137,1,1,0,1,0
4,147,147,8,8,0,1,0
13,157,157,8,8,0,1,0
26,179,179,12,12,0,1,0
35,207,207,6,2,4,2,1
16,216,216,25,5,20,3,2
25,217,217,35,35,0,1,0
20,223,223,24,24,0,1,0
19,242,242,2,2,0,1,0
28,249,249,10,10,0,1,0
11,264,264,27,27,0,1,0
12,282,282,43,43,0,1,0
0,283,283,57,3,54,4,3
9,295,295,5,1,4,2,1
23,295,295,68,29,39,4,3
29,325,325,14,2,12,2,1
14,342,342,12,12,0,1,0
22,350,350,21,21,0,1,0
2,355,355,2,2,0,1,0
34,360,360,53,32,21,4,3
36,373,373,35,35,0,1,0
24,378,378,67,28,39,4,3
27,403,403,1,1,0,1,0
21,408,408,54,54,0,1,0
5,412,412,52,52,0,1,0
30,425,425,80,80,0,1,0
1,429,429,31,31,0,1,0
18,449,449,1,1,0,1,0
33,482,482,26,26,0,1,0
10,484,484,20,20,0,1,0
3,495,495,33,33,0,1,0
7,498,498,36,8,28,2,1

17,109,109,3,3,0,1,0
4,115,115,11,1,10,3,2
19,128,128,34,25,9,4,3
32,141,141,30,30,0,1,0
24,144,144,17,17,0,1,0
14,178,178,37,13,24,4,3
27,182,182,7,4,3,2,1
31,193,193,1,1,0,1,0
9,210,210,7,7,0,1,0
12,215,215,1,1,0,1,0
1,217,217,45,29,16,4,3
11,228,228,4,1,3,2,1
34,239,239,36,4,32,2,1
33,251,251,26,26,0,1,0
13,267,267,3,3,0,1,0
22,298,298,56,56,0,1,0
3,300,300,5,5,0,1,0
25,301,301,40,5,35,2,1
16,309,309,2,2,0,1,0
20,313,313,4,4,0,1,0
30,321,321,16,2,14,2,1
6,333,333,57,48,9,4,3
8,340,340,23,12,11,2,1
15,357,357,25,25,0,1,0
5,372,372,35,8,27,4,3
2,383,383,4,4,0,1,0
26,397,397,37,13,24,3,2
35,404,404,25,10,15,2,1
0,405,405,1,1,0,1,0
10,447,447,42,42,0,1,0
28,458,458,44,44,0,1,0
18,465,465,121,121,0,1,0
7,478,478,145,70,75,4,3
23,481,481,99,75,24,3,2
21,482,482,2,2,0,1,0
29,483,483,1,1,0,1,0

29,101,101,10,4,6,2,1
24,109,109,4,4,0,1,0
31,156,156,2,2,0,1,0
20,156,156,13,13,0,1,0
19,157,157,11,11,0,1,0
26,165,165,52,18,34,3,2
23,236,236,13,13,0,1,0
12,255,255,53,40,13,2,1
9,256,256,21,14,7,2,1
4,262,262,6,1,5,2,1
3,268,268,3,3,0,1,0
17,283,283,62,14,48,2,1
21,290,290,46,46,0,1,0
11,295,295,16,16,0,1,0
5,307,307,80,66,14,2,1
8,318,318,58,42,16,2,1
10,353,353,109,76,33,4,3
7,357,357,83,41,42,3,2
14,360,360,42,42,0,1,0
15,383,383,3,3,0,1,0
6,398,398,21,5,16,3,2
25,400,400,132,52,80,3,2
2,415,415,12,3,9,4,3
13,416,416,17,17,0,1,0
1,432,432,3,3,0,1,0
16,439,439,17,17,0,1,0
0,458,458,42,42,0,1,0
28,465,465,26,6,20,2,1
30,468,468,24,5,19,2,1
27,469,469,14,10,4,2,1
18,478,478,65,8,57,4,3
22,493,493,19,7,12,2,1

9,100,100,1,1,0,1,0
35,102,102,18,18,0,1,0
16,116,116,38,2,36,2,1
33,149,149,7,2,5,2,1
21,161,161,14,14,0,1,0
10,166,166,9,9,0,1,0
8,167,167,5,5,0,1,0
26,172,172,1,1,0,1,0
20,184,184,3,3,0,1,0
32,189,189,36,36,0,1,0
18,193,193,3,3,0,1,0
3,208,208,37,28,9,2,1
1,274,274,16,16,0,1,0
22,275,275,7,2,5,2,1
4,276,276,26,10,16,2,1
14,279,279,10,10,0,1,0
29,292,292,16,4,12,2,1
19,293,293,5,5,0,1,0
17,306,306,16,16,0,1,0
13,316,316,1,1,0,1,0
6,334,334,11,6,5,2,1
0,352,352,115,28,87,4,3
27,379,379,7,7,0,1,0
11,382,382,7,1,6,3,2
15,392,392,32,12,20,3,2
37,400,400,42,22,20,2,1
31,413,413,33,33,0,1,0
34,413,413,67,36,31,2,1
5,414,414,12,3,9,4,3
36,418,418,109,51,58,4,3
24,441,441,3,3,0,1,0
12,441,441,32,5,27,2,1
30,443,443,71,65,6,2,1
2,486,486,90,45,45,4,3
23,492,492,26,26,0,1,0
7,494,494,31,2,29,2,1
28,496,496,85,76,9,2,1
25,500,500,65,35,30,4,3

34,103,103,6,6,0,1,0
16,134,134,4,1,3,2,1
0,147,147,16,16,0,1,0
31,155,155,47,47,0,1,0
9,156,156,45,3,42,4,3
12,168,168,1,1,0,1,0
26,170,170,10,10,0,1,0
27,171,171,19,6,13,2,1
15,184,184,9,4,5,2,1
25,219,219,5,5,0,1,0
13,251,251,5,2,3,2,1
33,251,251,12,12,0,1,0
29,265,265,1,1,0,1,0
17,270,270,45,45,0,1,0
21,271,271,6,6,0,1,0
8,274,274,14,14,0,1,0
2,293,293,5,5,0,1,0
32,311,311,24,24,0,1,0
7,317,317,3,3,0,1,0
14,334,334,13,13,0,1,0
5,342,342,22,4,18,4,3
36,365,365,82,82,0,1,0
19,379,379,117,76,41,2,1
22,382,382,16,2,14,3,2
18,391,391,17,17,0,1,0
35,392,392,58,36,22,2,1
11,394,394,102,102,0,1,0
30,406,406,45,16,29,2,1
20,422,422,94,94,0,1,0
6,425,425,9,9,0,1,0
10,443,443,17,4,13,4,3
24,445,445,49,39,10,2,1
28,457,457,51,51,0,1,0
3,460,460,12,12,0,1,0
4,464,464,43,34,9,2,1
23,473,473,28,25,3,2,1
1,474,474,29,29,0,1,0

18,126,126,1,1,0,1,0
29,133,133,45,45,0,1,0
0,153,153,9,5,4,2,1
20,162,162,3,3,0,1,0
36,166,166,125,20,105,4,3
11,173,173,35,35,0,1,0
32,188,188,1,1,0,1,0
33,201,201,4,4,0,1,0
23,202,202,3,3,0,1,0
31,209,209,1,1,0,1,0
14,212,212,11,11,0,1,0
4,222,222,3,3,0,1,0
12,223,223,41,2,39,2,1
3,227,227,3,3,0,1,0
26,254,254,8,8,0,1,0
19,272,272,9,1,8,2,1
10,276,276,37,37,0,1,0
28,279,279,28,28,0,1,0
5,281,281,6,3,3,2,1
24,289,289,31,20,11,2,1
22,301,301,39,11,28,2,1
7,308,308,25,9,16,3,2
25,337,337,28,28,0,1,0
35,340,340,6,2,4,2,1
16,343,343,42,42,0,1,0
1,346,346,40,26,14,2,1
37,348,348,8,8,0,1,0
34,350,350,5,5,0,1,0
17,356,356,31,28,3,2,1
27,367,367,16,16,0,1,0
13,394,394,30,3,27,4,3
15,403,403,5,5,0,1,0
38,405,405,4,4,0,1,0
30,406,406,14,8,6,2,1
21,412,412,2,2,0,1,0
6,419,419,5,2,3,2,1
2,453,453,72,36,36,3,2
8,476,476,79,1,78,4,3
9,489,489,62,54,8,2,1

29,103,103,3,3,0,1,0
8,121,121,16,16,0,1,0
30,123,123,2,2,0,1,0
7,151,151,17,17,0,1,0
4,153,153,1,1,0,1,0
23,167,167,5,1,4,2,1
6,175,175,28,28,0,1,0
16,179,179,7,7,0,1,0
17,185,185,8,1,7,2,1
31,204,204,32,2,30,3,2
11,215,215,1,1,0,1,0
28,221,221,21,5,16,2,1
2,230,230,70,25,45,4,3
21,248,248,44,44,0,1,0
5,264,264,1,1,0,1,0
26,266,266,33,4,29,4,3
19,315,315,4,4,0,1,0
0,335,335,25,12,13,2,1
27,339,339,51,10,41,2,1
24,347,347,25,1,24,3,2
1,353,353,45,8,37,2,1
20,355,355,51,15,36,3,2
3,355,355,124,58,66,3,2
14,372,372,1,1,0,1,0
9,381,381,6,6,0,1,0
25,382,382,123,96,27,4,3
10,392,392,51,51,0,1,0
15,442,442,123,123,0,1,0
12,462,462,90,87,3,2,1
13,479,479,39,14,25,2,1
22,492,492,13,13,0,1,0
18,495,495,7,7,0,1,0

22,114,114,10,4,6,3,2
23,116,116,9,1,8,2,1
9,127,127,36,36,0,1,0
27,128,128,3,3,0,1,0
1,130,130,37,19,18,3,2
0,137,137,1,1,0,1,0
4,149,149,12,7,5,2,1
25,165,165,33,33,0,1,0
7,203,203,14,14,0,1,0
6,204,204,42,42,0,1,0
11,239,239,37,14,23,2,1
19,263,263,42,42,0,1,0
26,276,276,19,19,0,1,0
10,282,282,12,12,0,1,0
8,292,292,44,33,11,2,1
21,306,306,111,65,46,2,1
3,316,316,24,12,12,2,1
16,331,331,4,1,3,2,1
18,355,355,63,63,0,1,0
2,379,379,63,23,40,3,2
5,390,390,53,53,0,1,0
15,403,403,37,37,0,1,0
12,414,414,18,13,5,2,1
17,430,430,43,43,0,1,0
24,453,453,113,59,54,4,3
13,456,456,24,10,14,2,1
28,463,463,6,6,0,1,0
29,485,485,9,9,0,1,0
14,490,490,12,6,6,3,2
20,492,492,3,3,0,1,0

0,136,136,18,18,0,1,0
7,149,149,1,1,0,1,0
29,157,157,32,12,20,2,1
17,164,164,9,9,0,1,0
11,168,168,37,37,0,1,0
2,189,189,8,8,0,1,0
27,194,194,54,4,50,2,1
14,228,228,24,5,19,4,3
15,234,234,8,2,6,3,2
4,248,248,62,23,39,4,3
22,255,255,3,3,0,1,0
16,259,259,5,5,0,1,0
25,280,280,13,13,0,1,0
21,284,284,4,4,0,1,0
18,305,305,19,10,9,2,1
19,319,319,7,7,0,1,0
31,320,320,5,5,0,1,0
13,334,334,32,32,0,1,0
8,354,354,67,67,0,1,0
3,365,365,104,74,30,2,1
24,386,386,80,80,0,1,0
10,393,393,42,34,8,2,1
12,395,395,16,16,0,1,0
23,409,409,57,57,0,1,0
30,421,421,63,63,0,1,0
26,422,422,113,31,82,3,2
1,424,424,46,20,26,4,3
20,443,443,80,80,0,1,0
6,458,458,37,13,24,4,3
28,462,462,9,9,0,1,0
5,484,484,4,4,0,1,0
9,491,491,15,7,8,2,1

15,125,125,8,8,0,1,0
9,125,125,11,11,0,1,0
14,127,127,2,2,0,1,0
6,129,129,2,2,0,1,0
26,165,165,6,2,4,2,1
3,177,177,24,6,18,4,3
25,181,181,3,3,0,1,0
16,182,182,24,6,18,2,1
27,182,182,18,6,12,2,1
12,191,191,31,31,0,1,0
29,201,201,34,34,0,1,0
7,202,202,11,2,9,4,3
24,217,217,21,21,0,1,0
18,247,247,1,1,0,1,0
0,253,253,33,12,21,4,3
2,272,272,76,19,57,4,3
11,307,307,8,8,0,1,0
1,320,320,6,6,0,1,0
23,330,330,52,52,0,1,0
10,341,341,12,12,0,1,0
31,348,348,18,18,0,1,0
4,365,365,17,17,0,1,0
5,379,379,32,12,20,3,2
17,398,398,13,1,12,2,1
22,426,426,130,100,30,4,3
21,428,428,15,8,7,2,1
19,434,434,28,28,0,1,0
30,437,437,8,8,0,1,0
20,438,438,142,85,57,4,3
13,455,455,121,91,30,2,1
28,468,468,59,59,0,1,0
8,496,496,171,126,45,4,3

9,131,131,19,9,10,3,2
16,145,145,12,12,0,1,0
23,158,158,8,2,6,3,2
13,220,220,18,18,0,1,0
14,229,229,19,19,0,1,0
4,242,242,10,10,0,1,0
7,244,244,3,3,0,1,0
19,245,245,25,25,0,1,0
22,250,250,64,37,27,4,3
25,256,256,32,32,0,1,0
26,288,288,16,16,0,1,0
2,312,312,25,25,0,1,0
1,314,314,26,26,0,1,0
3,320,320,178,178,0,1,0
8,327,327,78,40,38,2,1
24,330,330,10,10,0,1,0
17,335,335,74,74,0,1,0
10,363,363,25,13,12,3,2
0,365,365,84,57,27,4,3
18,378,378,7,7,0,1,0
15,385,385,35,35,0,1,0
21,385,385,30,30,0,1,0
20,393,393,66,66,0,1,0
11,395,395,30,30,0,1,0
6,405,405,47,47,0,1,0
12,461,461,51,51,0,1,0
27,465,465,48,48,0,1,0
5,494,494,64,26,38,2,1

35,104,104,31,27,4,2,1
12,105,105,3,3,0,1,0
15,134,134,4,4,0,1,0
21,136,136,17,4,13,2,1
36,142,142,5,5,0,1,0
31,144,144,6,6,0,1,0
8,150,150,1,1,0,1,0
13,151,151,45,1,44,3,2
34,162,162,6,6,0,1,0
20,169,169,12,12,0,1,0
7,169,169,10,6,4,2,1
28,183,183,10,10,0,1,0
29,222,222,18,18,0,1,0
24,232,232,5,2,3,2,1
18,243,243,21,15,6,2,1
4,271,271,3,3,0,1,0
17,279,279,5,2,3,2,1
16,283,283,45,12,33,4,3
23,294,294,49,49,0,1,0
5,296,296,13,10,3,2,1
19,330,330,41,1,40,2,1
3,353,353,33,33,0,1,0
30,365,365,52,19,33,4,3
26,374,374,4,4,0,1,0
11,377,377,5,5,0,1,0
2,385,385,51,51,0,1,0
10,392,392,56,56,0,1,0
22,395,395,4,4,0,1,0
1,397,397,94,94,0,1,0
14,407,407,10,1,9,4,3
0,428,428,56,56,0,1,0
32,448,448,111,111,0,1,0
25,450,450,31,3,28,3,2
9,463,463,19,16,3,2,1
33,476,476,87,87,0,1,0
6,482,482,10,10,0,1,0
27,485,485,68,30,38,2,1

28,102,102,18,10,8,3,2
24,115,115,2,2,0,1,0
21,129,129,15,4,11,2,1
29,130,130,12,3,9,4,3
27,179,179,5,5,0,1,0
18,194,194,29,29,0,1,0
8,214,214,71,21,50,4,3
23,216,216,39,39,0,1,0
0,231,231,25,3,22,3,2
4,241,241,29,29,0,1,0
5,243,243,11,1,10,2,1
25,253,253,18,18,0,1,0
15,263,263,52,52,0,1,0
10,303,303,16,16,0,1,0
12,303,303,96,60,36,2,1
20,339,339,19,19,0,1,0
13,340,340,34,34,0,1,0
19,347,347,42,42,0,1,0
9,352,352,68,68,0,1,0
2,354,354,18,5,13,2,1
30,390,390,77,77,0,1,0
3,415,415,19,19,0,1,0
6,438,438,1,1,0,1,0
7,442,442,10,10,0,1,0
11,448,448,136,2,134,4,3
17,448,448,1,1,0,1,0
14,460,460,17,2,15,2,1
22,472,472,71,47,24,2,1
16,483,483,14,14,0,1,0
1,485,485,4,4,0,1,0
26,495,495,56,56,0,1,0

12,128,128,8,8,0,1,0
14,138,138,8,8,0,1,0
8,149,149,1,1,0,1,0
17,161,161,14,10,4,2,1
11,174,174,16,16,0,1,0
23,178,178,45,45,0,1,0
1,183,183,4,4,0,1,0
32,186,186,3,3,0,1,0
15,191,191,49,49,0,1,0
7,258,258,25,11,14,2,1
21,271,271,8,8,0,1,0
6,275,275,5,5,0,1,0
0,285,285,16,16,0,1,0
29,334,334,8,8,0,1,0
27,342,342,46,28,18,3,2
16,349,349,42,42,0,1,0
13,366,366,36,22,14,3,2
2,369,369,64,64,0,1,0
24,372,372,102,47,55,3,2
22,393,393,31,31,0,1,0
26,419,419,16,8,8,3,2
19,434,434,122,68,54,4,3
28,445,445,11,7,4,2,1
9,448,448,104,65,39,4,3
4,452,452,104,68,36,4,3
3,456,456,20,4,16,3,2
20,459,459,19,14,5,2,1
18,473,473,34,34,0,1,0
10,481,481,94,94,0,1,0
31,482,482,32,32,0,1,0
30,489,489,64,64,0,1,0
5,490,490,30,17,13,3,2
25,500,500,31,19,12,3,2

37,122,122,3,3,0,1,0
28,128,128,8,8,0,1,0
8,133,133,14,14,0,1,0
31,136,136,8,8,0,1,0
27,153,153,22,22,0,1,0
24,182,182,5,5,0,1,0
25,187,187,46,46,0,1,0
21,212,212,48,32,16,2,1
35,215,215,2,2,0,1,0
15,236,236,42,24,18,3,2
30,243,243,56,23,33,4,3
3,250,250,3,3,0,1,0
1,259,259,22,1,21,2,1
22,265,265,113,113,0,1,0
11,272,272,2,2,0,1,0
26,276,276,4,4,0,1,0
36,288,288,16,16,0,1,0
33,290,290,8,8,0,1,0
7,290,290,26,26,0,1,0
5,297,297,23,23,0,1,0
23,307,307,52,44,8,2,1
38,307,307,11,1,10,4,3
10,314,314,1,1,0,1,0
34,363,363,50,4,46,4,3
12,370,370,49,15,34,3,2
29,375,375,21,21,0,1,0
2,380,380,54,18,36,4,3
18,395,395,28,7,21,4,3
14,404,404,2,2,0,1,0
4,421,421,22,22,0,1,0
32,438,438,8,8,0,1,0
0,445,445,16,16,0,1,0
13,458,458,1,1,0,1,0
6,459,459,52,52,0,1,0
9,463,463,152,152,0,1,0
16,486,486,3,3,0,1,0
19,486,486,8,8,0,1,0
20,489,489,6,6,0,1,0
17,498,498,1,1,0,1,0

4,116,116,23,23,0,1,0
24,118,118,10,10,0,1,0
31,127,127,16,13,3,2,1
15,128,128,2,2,0,1,0
29,131,131,8,8,0,1,0
7,131,131,7,2,5,2,1
11,132,132,1,1,0,1,0
8,154,154,1,1,0,1,0
36,175,175,9,9,0,1,0
19,185,185,11,1,10,3,2
10,197,197,4,4,0,1,0
12,222,222,2,2,0,1,0
9,224,224,16,1,15,4,3
5,234,234,22,10,12,3,2
25,234,234,22,14,8,3,2
26,243,243,65,65,0,1,0
6,246,246,25,3,22,3,2
32,252,252,13,13,0,1,0
17,284,284,43,43,0,1,0
35,287,287,15,12,3,2,1
34,290,290,9,6,3,2,1
2,330,330,20,4,16,2,1
27,334,334,40,2,38,3,2
28,343,343,32,32,0,1,0
3,346,346,8,8,0,1,0
14,359,359,49,49,0,1,0
16,361,361,20,11,9,4,3
1,364,364,21,3,18,3,2
21,368,368,21,21,0,1,0
30,368,368,16,10,6,2,1
37,381,381,10,1,9,2,1
18,391,391,34,34,0,1,0
33,391,391,12,6,6,2,1
38,394,394,56,46,10,3,2
13,402,402,93,90,3,2,1
23,445,445,17,17,0,1,0
20,453,453,36,36,0,1,0
22,456,456,190,139,51,3,2
0,462,462,57,27,30,3,2

0,101,101,16,10,6,3,2
6,111,111,3,3,0,1,0
14,120,120,1,1,0,1,0
22,129,129,1,1,0,1,0
24,147,147,9,9,0,1,0
7,158,158,1,1,0,1,0
29,175,175,2,2,0,1,0
25,180,180,10,10,0,1,0
20,187,187,37,14,23,2,1
13,196,196,34,6,28,3,2
16,198,198,4,4,0,1,0
19,205,205,24,24,0,1,0
34,228,228,16,16,0,1,0
2,237,237,22,16,6,2,1
10,238,238,1,1,0,1,0
18,253,253,8,1,7,2,1
17,261,261,93,6,87,4,3
28,272,272,11,11,0,1,0
5,324,324,9,1,8,3,2
1,327,327,78,6,72,3,2
32,366,366,5,5,0,1,0
9,407,407,14,14,0,1,0
15,412,412,3,3,0,1,0
11,427,427,61,61,0,1,0
21,429,429,136,63,73,4,3
30,435,435,3,3,0,1,0
26,440,440,10,10,0,1,0
4,441,441,2,2,0,1,0
35,457,457,213,78,135,4,3
12,460,460,1,1,0,1,0
8,462,462,111,64,47,2,1
23,465,465,80,56,24,4,3
33,476,476,33,19,14,3,2
3,480,480,60,28,32,2,1
27,487,487,9,3,6,3,2
31,492,492,41,41,0,1,0

25,142,142,2,2,0,1,0
18,175,175,5,5,0,1,0
9,192,192,30,30,0,1,0
7,217,217,27,27,0,1,0
4,223,223,13,10,3,2,1
14,235,235,27,27,0,1,0
23,246,246,5,5,0,1,0
6,263,263,40,40,0,1,0
2,271,271,40,7,33,4,3
22,282,282,4,4,0,1,0
8,300,300,61,17,44,3,2
5,306,306,43,43,0,1,0
24,311,311,22,7,15,2,1
10,321,321,3,3,0,1,0
20,326,326,24,7,17,3,2
27,364,364,57,57,0,1,0
15,367,367,44,44,0,1,0
28,389,389,157,113,44,2,1
29,401,401,3,3,0,1,0
19,405,405,25,16,9,4,3
17,417,417,12,3,9,4,3
12,424,424,27,27,0,1,0
1,459,459,87,18,69,4,3
13,466,466,183,171,12,2,1
21,472,472,53,28,25,2,1
11,479,479,18,3,15,4,3
3,481,481,51,51,0,1,0
26,483,483,26,11,15,4,3
16,488,488,24,24,0,1,0
0,490,490,153,153,0,1,0

29,123,123,13,13,0,1,0
7,138,138,27,27,0,1,0
26,140,140,14,14,0,1,0
30,159,159,26,26,0,1,0
8,168,168,7,7,0,1,0
0,213,213,11,11,0,1,0
11,215,215,36,36,0,1,0
14,219,219,23,23,0,1,0
3,242,242,35,12,23,2,1
4,253,253,13,5,8,3,2
24,262,262,48,4,44,3,2
27,275,275,8,8,0,1,0
19,284,284,33,5,28,3,2
1,298,298,46,34,12,2,1
21,299,299,3,3,0,1,0
20,332,332,50,34,16,3,2
12,359,359,80,29,51,4,3
2,368,368,4,4,0,1,0
10,370,370,52,10,42,4,3
13,370,370,47,15,32,3,2
15,371,371,82,36,46,3,2
9,381,381,40,6,34,3,2
17,382,382,57,57,0,1,0
6,387,387,62,62,0,1,0
23,416,416,28,3,25,2,1
18,424,424,4,1,3,2,1
28,449,449,10,1,9,2,1
25,465,465,3,3,0,1,0
22,477,477,113,87,26,3,2
16,477,477,26,4,22,3,2
5,497,497,63,60,3,2,1

26,100,100,5,5,0,1,0
20,107,107,2,2,0,1,0
7,108,108,25,25,0,1,0
19,121,121,2,2,0,1,0
35,124,124,12,12,0,1,0
30,126,126,31,31,0,1,0
6,144,144,1,1,0,1,0
14,162,162,24,11,13,2,1
36,171,171,37,18,19,4,3
15,205,205,15,15,0,1,0
22,207,207,6,6,0,1,0
21,233,233,5,5,0,1,0
2,239,239,27,27,0,1,0
25,261,261,5,2,3,2,1
34,262,262,6,3,3,2,1
18,268,268,10,5,5,2,1
28,274,274,73,73,0,1,0
27,293,293,50,50,0,1,0
0,294,294,17,2,15,2,1
31,302,302,45,31,14,3,2
32,308,308,15,3,12,4,3
3,316,316,108,90,18,3,2
10,328,328,19,19,0,1,0
12,346,346,25,7,18,4,3
29,353,353,55,55,0,1,0
33,353,353,26,15,11,2,1
11,385,385,16,6,10,3,2
1,418,418,10,6,4,2,1
9,419,419,9,5,4,2,1
8,431,431,16,16,0,1,0
23,432,432,68,68,0,1,0
4,443,443,2,2,0,1,0
13,455,455,95,33,62,3,2
5,456,456,7,1,6,2,1
16,461,461,27,7,20,3,2
24,478,478,1,1,0,1,0
17,483,483,66,22,44,2,1

31,103,103,8,8,0,1,0
22,116,116,9,9,0,1,0
13,117,117,12,12,0,1,0
10,122,122,7,3,4,2,1
11,145,145,1,1,0,1,0
6,163,163,5,5,0,1,0
33,167,167,8,8,0,1,0
21,180,180,13,13,0,1,0
19,189,189,32,14,18,3,2
36,190,190,26,13,13,2,1
27,199,199,6,6,0,1,0
1,217,217,12,1,11,3,2
35,217,217,6,2,4,2,1
18,220,220,17,17,0,1,0
12,220,220,12,9,3,2,1
37,220,220,14,2,12,3,2
2,222,222,29,29,0,1,0
16,232,232,21,21,0,1,0
5,249,249,46,43,3,2,1
23,258,258,61,43,18,3,2
8,262,262,35,8,27,2,1
29,263,263,36,36,0,1,0
24,270,270,58,58,0,1,0
28,270,270,76,76,0,1,0
4,275,275,83,83,0,1,0
20,286,286,9,6,3,2,1
14,306,306,9,9,0,1,0
39,318,318,8,2,6,2,1
3,333,333,7,7,0,1,0
0,335,335,1,1,0,1,0
38,337,337,26,26,0,1,0
26,382,382,34,34,0,1,0
9,400,400,10,10,0,1,0
34,417,417,16,1,15,4,3
15,418,418,4,4,0,1,0
17,419,419,1,1,0,1,0
7,441,441,17,2,15,3,2
25,451,451,38,32,6,2,1
32,451,451,22,4,18,4,3
30,488,488,57,27,30,2,1

32,115,115,2,2,0,1,0
21,150,150,11,11,0,1,0
17,151,151,14,9,5,2,1
23,155,155,13,13,0,1,0
5,159,159,18,4,14,2,1
26,205,205,16,16,0,1,0
19,228,228,29,23,6,2,1
35,239,239,29,13,16,3,2
9,245,245,3,3,0,1,0
24,265,265,52,37,15,2,1
15,265,265,20,4,16,3,2
27,277,277,26,26,0,1,0
11,280,280,20,20,0,1,0
14,288,288,6,6,0,1,0
1,289,289,81,75,6,2,1
31,295,295,57,29,28,2,1
33,304,304,29,29,0,1,0
0,305,305,47,37,10,2,1
4,308,308,6,6,0,1,0
10,312,312,2,2,0,1,0
30,313,313,1,1,0,1,0
12,326,326,4,1,3,2,1
6,335,335,3,3,0,1,0
8,349,349,27,11,16,3,2
28,350,350,20,10,10,2,1
2,359,359,42,42,0,1,0
7,359,359,5,5,0,1,0
18,360,360,126,68,58,4,3
29,374,374,92,92,0,1,0
13,380,380,44,44,0,1,0
3,390,390,11,11,0,1,0
34,406,406,5,5,0,1,0
36,443,443,135,53,82,3,2
25,466,466,37,37,0,1,0
22,478,478,9,9,0,1,0
20,484,484,30,30,0,1,0
16,488,488,2,2,0,1,0

6,109,109,9,9,0,1,0
4,123,123,1,1,0,1,0
15,123,123,18,4,14,2,1
28,130,130,3,3,0,1,0
26,131,131,7,1,6,3,2
29,137,137,1,1,0,1,0
19,143,143,18,18,0,1,0
22,165,165,20,20,0,1,0
1,166,166,41,41,0,1,0
12,169,169,6,6,0,1,0
7,194,194,5,5,0,1,0
5,201,201,17,8,9,4,3
10,202,202,18,18,0,1,0
21,220,220,14,14,0,1,0
8,226,226,21,5,16,3,2
2,248,248,58,18,40,4,3
24,261,261,54,39,15,4,3
18,275,275,43,43,0,1,0
9,276,276,61,61,0,1,0
0,299,299,112,112,0,1,0
14,332,332,1,1,0,1,0
27,359,359,11,3,8,3,2
11,360,360,74,74,0,1,0
17,391,391,106,106,0,1,0
3,403,403,2,2,0,1,0
13,415,415,23,23,0,1,0
16,418,418,6,6,0,1,0
23,464,464,19,19,0,1,0
20,464,464,66,4,62,3,2
25,472,472,130,46,84,3,2

16,105,105,4,4,0,1,0
14,108,108,2,2,0,1,0
21,131,131,2,2,0,1,0
38,157,157,39,19,20,2,1
2,170,170,5,5,0,1,0
5,173,173,6,6,0,1,0
28,180,180,37,37,0,1,0
34,188,188,25,2,23,4,3
26,188,188,9,6,3,2,1
27,189,189,5,5,0,1,0
17,192,192,17,7,10,3,2
4,196,196,11,11,0,1,0
39,196,196,3,3,0,1,0
49,222,222,5,5,0,1,0
48,235,235,14,14,0,1,0
31,243,243,10,6,4,2,1
3,246,246,9,3,6,3,2
13,249,249,9,6,3,2,1
37,261,261,13,10,3,2,1
23,268,268,1,1,0,1,0
15,271,271,10,10,0,1,0
1,276,276,16,4,12,3,2
46,283,283,19,19,0,1,0
45,284,284,18,18,0,1,0
11,295,295,4,4,0,1,0
8,319,319,17,6,11,2,1
33,330,330,14,14,0,1,0
20,349,349,65,13,52,3,2
24,353,353,17,17,0,1,0
36,357,357,112,24,88,3,2
43,362,362,130,36,94,3,2
50,368,368,8,8,0,1,0
22,368,368,19,8,11,2,1
10,385,385,15,5,10,3,2
47,388,388,7,7,0,1,0
35,394,394,27,17,10,4,3
9,399,399,42,2,40,2,1
25,423,423,8,8,0,1,0
44,425,425,4,4,0,1,0
32,433,433,1,1,0,1,0
6,438,438,35,35,0,1,0
30,441,441,37,9,28,2,1
40,441,441,58,58,0,1,0
18,455,455,15,7,8,2,1
29,460,460,22,22,0,1,0
7,460,460,5,2,3,2,1
19,462,462,23,23,0,1,0
42,466,466,66,14,52,4,3
0,467,467,7,7,0,1,0
12,477,477,23,7,16,2,1
41,491,491,3,3,0,1,0

0,103,103,6,6,0,1,0
20,153,153,1,1,0,1,0
10,160,160,1,1,0,1,0
1,205,205,37,37,0,1,0
7,205,205,1,1,0,1,0
16,218,218,19,13,6,2,1
8,228,228,28,10,18,3,2
6,235,235,22,10,12,4,3
21,238,238,11,11,0,1,0
3,248,248,118,50,68,3,2
19,254,254,6,6,0,1,0
15,255,255,21,21,0,1,0
14,269,269,5,5,0,1,0
22,273,273,14,14,0,1,0
2,278,278,16,16,0,1,0
24,282,282,34,2,32,2,1
17,306,306,18,5,13,2,1
13,307,307,20,10,10,2,1
11,377,377,28,21,7,2,1
4,396,396,188,148,40,3,2
25,396,396,260,222,38,3,2
9,428,428,11,11,0,1,0
5,447,447,93,76,17,2,1
26,465,465,77,77,0,1,0
23,473,473,30,15,15,4,3
12,490,490,88,24,64,3,2
18,491,491,12,12,0,1,0

31,106,106,21,6,15,4,3
6,143,143,8,2,6,3,2
2,151,151,6,6,0,1,0
5,162,162,9,4,5,2,1
36,174,174,10,10,0,1,0
13,192,192,10,3,7,3,2
7,203,203,13,9,4,2,1
11,215,215,19,19,0,1,0
18,217,217,55,28,27,2,1
35,229,229,26,26,0,1,0
0,237,237,15,9,6,3,2
14,239,239,12,12,0,1,0
32,241,241,27,27,0,1,0
28,249,249,40,13,27,4,3
21,254,254,6,6,0,1,0
15,257,257,30,10,20,2,1
10,259,259,18,18,0,1,0
8,264,264,19,11,8,2,1
4,269,269,1,1,0,1,0
1,271,271,8,8,0,1,0
22,281,281,74,74,0,1,0
17,283,283,50,50,0,1,0
20,324,324,3,3,0,1,0
3,327,327,5,5,0,1,0
26,336,336,7,4,3,2,1
24,341,341,10,10,0,1,0
9,343,343,37,37,0,1,0
27,357,357,23,9,14,2,1
23,368,368,24,24,0,1,0
25,370,370,13,9,4,2,1
16,378,378,11,5,6,3,2
30,382,382,139,75,64,3,2
33,410,410,16,5,11,4,3
19,422,422,108,69,39,2,1
34,441,441,8,2,6,2,1
29,479,479,76,76,0,1,0
12,485,485,50,50,0,1,0

36,100,100,2,2,0,1,0
8,104,104,23,12,11,4,3
41,130,130,31,31,0,1,0
24,142,142,2,2,0,1,0
32,164,164,27,27,0,1,0
13,169,169,2,2,0,1,0
15,171,171,4,1,3,2,1
34,182,182,18,2,16,2,1
38,198,198,1,1,0,1,0
9,235,235,7,1,6,2,1
17,236,236,10,2,8,3,2
44,247,247,18,14,4,2,1
5,248,248,10,10,0,1,0
40,248,248,10,10,0,1,0
30,251,251,38,38,0,1,0
25,266,266,5,5,0,1,0
31,267,267,12,12,0,1,0
11,271,271,47,32,15,2,1
37,271,271,29,29,0,1,0
12,272,272,24,2,22,2,1
28,281,281,9,9,0,1,0
19,295,295,37,29,8,3,2
2,298,298,5,5,0,1,0
1,305,305,12,4,8,3,2
22,307,307,16,16,0,1,0
4,308,308,41,41,0,1,0
23,318,318,7,7,0,1,0
18,319,319,5,5,0,1,0
6,328,328,1,1,0,1,0
3,333,333,9,9,0,1,0
42,363,363,4,4,0,1,0
29,378,378,83,62,21,4,3
43,380,380,14,1,13,2,1
0,414,414,27,13,14,3,2
16,417,417,68,33,35,2,1
27,420,420,14,14,0,1,0
7,436,436,8,8,0,1,0
33,444,444,60,23,37,2,1
10,450,450,53,53,0,1,0
39,452,452,90,71,19,4,3
35,459,459,76,76,0,1,0
26,468,468,21,3,18,2,1
20,482,482,19,5,14,2,1
14,489,489,18,13,5,2,1
21,494,494,42,42,0,1,0

17,134,134,24,6,18,2,1
4,134,134,1,1,0,1,0
35,143,143,8,2,6,2,1
25,152,152,17,17,0,1,0
36,153,153,11,1,10,2,1
34,153,153,15,15,0,1,0
9,184,184,12,12,0,1,0
19,193,193,2,2,0,1,0
30,210,210,32,25,7,2,1
1,219,219,61,61,0,1,0
12,227,227,44,44,0,1,0
2,242,242,5,5,0,1,0
27,246,246,29,29,0,1,0
31,264,264,61,11,50,3,2
14,274,274,4,4,0,1,0
28,293,293,7,7,0,1,0
8,295,295,40,40,0,1,0
29,298,298,3,3,0,1,0
13,308,308,3,3,0,1,0
18,308,308,9,9,0,1,0
20,332,332,10,10,0,1,0
21,351,351,29,13,16,2,1
33,370,370,40,30,10,3,2
6,372,372,63,24,39,4,3
24,376,376,67,40,27,4,3
23,386,386,37,37,0,1,0
3,389,389,34,7,27,2,1
5,392,392,18,18,0,1,0
11,398,398,15,9,6,2,1
22,412,412,6,6,0,1,0
0,419,419,98,98,0,1,0
16,420,420,22,5,17,2,1
26,424,424,19,5,14,3,2
10,447,447,17,5,12,4,3
32,461,461,139,25,114,4,3
7,472,472,10,10,0,1,0
15,481,481,34,34,0,1,0

15,114,114,25,7,18,4,3
11,143,143,58,55,3,2,1
16,148,148,26,11,15,4,3
7,149,149,36,23,13,2,1
13,188,188,45,7,38,3,2
21,216,216,19,5,14,3,2
23,223,223,4,1,3,2,1
25,230,230,3,3,0,1,0
19,231,231,10,10,0,1,0
14,234,234,19,19,0,1,0
8,238,238,22,11,11,2,1
4,239,239,7,7,0,1,0
2,251,251,5,5,0,1,0
30,252,252,26,6,20,2,1
27,253,253,12,6,6,2,1
22,264,264,13,13,0,1,0
9,276,276,7,2,5,2,1
29,291,291,23,23,0,1,0
3,300,300,56,49,7,2,1
26,305,305,64,47,17,2,1
1,331,331,88,10,78,4,3
10,335,335,4,1,3,2,1
17,343,343,77,51,26,2,1
24,357,357,66,66,0,1,0
5,360,360,11,2,9,2,1
6,360,360,24,24,0,1,0
20,452,452,30,30,0,1,0
0,480,480,6,6,0,1,0
28,482,482,20,20,0,1,0
18,487,487,43,43,0,1,0
12,492,492,38,17,21,4,3

18,103,103,2,2,0,1,0
22,104,104,4,4,0,1,0
11,107,107,11,11,0,1,0
17,113,113,32,20,12,4,3
23,144,144,29,12,17,3,2
7,172,172,14,14,0,1,0
12,172,172,1,1,0,1,0
10,172,172,21,21,0,1,0
20,199,199,10,2,8,3,2
9,200,200,2,2,0,1,0
8,202,202,15,6,9,4,3
5,224,224,12,12,0,1,0
19,242,242,22,22,0,1,0
21,246,246,1,1,0,1,0
16,255,255,28,28,0,1,0
29,272,272,5,5,0,1,0
4,286,286,22,22,0,1,0
6,322,322,29,29,0,1,0
13,341,341,41,41,0,1,0
27,358,358,56,56,0,1,0
3,362,362,37,37,0,1,0
28,382,382,136,136,0,1,0
1,391,391,41,41,0,1,0
24,392,392,33,33,0,1,0
0,400,400,84,84,0,1,0
14,419,419,32,9,23,2,1
25,422,422,14,14,0,1,0
30,424,424,89,18,71,3,2
2,445,445,243,210,33,2,1
26,448,448,2,2,0,1,0
15,469,469,3,3,0,1,0

31,102,102,3,3,0,1,0
8,105,105,1,1,0,1,0
21,105,105,21,1,20,2,1
5,109,109,7,7,0,1,0
10,124,124,30,23,7,2,1
16,130,130,1,1,0,1,0
33,137,137,9,2,7,2,1
19,140,140,2,2,0,1,0
7,178,178,49,49,0,1,0
13,180,180,20,8,12,4,3
29,190,190,3,3,0,1,0
9,191,191,5,5,0,1,0
34,192,192,1,1,0,1,0
6,216,216,13,13,0,1,0
23,242,242,59,18,41,2,1
38,244,244,2,2,0,1,0
11,244,244,48,48,0,1,0
32,270,270,28,28,0,1,0
20,311,311,9,9,0,1,0
24,314,314,24,6,18,3,2
15,316,316,21,11,10,2,1
4,317,317,14,14,0,1,0
25,324,324,6,2,4,2,1
35,326,326,119,80,39,4,3
3,333,333,9,9,0,1,0
1,338,338,3,3,0,1,0
36,341,341,10,10,0,1,0
27,365,365,30,30,0,1,0
22,366,366,110,26,84,3,2
17,369,369,32,26,6,3,2
30,375,375,67,63,4,2,1
26,390,390,47,47,0,1,0
0,399,399,40,5,35,2,1
12,413,413,13,13,0,1,0
2,421,421,14,14,0,1,0
37,442,442,16,12,4,2,1
14,460,460,24,24,0,1,0
18,495,495,7,2,5,2,1
28,497,497,26,26,0,1,0

0,104,104,26,26,0,1,0
36,127,127,16,16,0,1,0
10,143,143,14,14,0,1,0
20,143,143,10,10,0,1,0
4,160,160,11,11,0,1,0
6,160,160,1,1,0,1,0
14,163,163,13,13,0,1,0
38,167,167,10,2,8,3,2
34,178,178,3,3,0,1,0
28,190,190,9,2,7,2,1
12,197,197,10,10,0,1,0
30,199,199,2,2,0,1,0
31,205,205,12,12,0,1,0
9,219,219,3,3,0,1,0
40,223,223,26,26,0,1,0
17,235,235,26,26,0,1,0
1,257,257,133,99,34,3,2
26,284,284,18,3,15,4,3
15,285,285,2,2,0,1,0
5,298,298,1,1,0,1,0
27,318,318,44,20,24,4,3
25,321,321,112,112,0,1,0
23,325,325,23,23,0,1,0
19,337,337,1,1,0,1,0
18,337,337,16,4,12,3,2
37,343,343,40,40,0,1,0
3,361,361,8,8,0,1,0
35,364,364,12,12,0,1,0
24,366,366,15,15,0,1,0
32,367,367,16,16,0,1,0
21,379,379,7,7,0,1,0
2,395,395,4,4,0,1,0
33,401,401,26,26,0,1,0
11,409,409,14,14,0,1,0
13,411,411,49,4,45,2,1
29,433,433,60,60,0,1,0
22,452,452,39,39,0,1,0
8,457,457,1,1,0,1,0
16,473,473,4,4,0,1,0
7,478,478,2,2,0,1,0
39,480,480,149,130,19,2,1

9,108,108,16,2,14,3,2
21,115,115,2,2,0,1,0
24,117,117,2,2,0,1,0
18,122,122,2,2,0,1,0
0,124,124,3,3,0,1,0
31,125,125,9,9,0,1,0
27,126,126,21,21,0,1,0
40,140,140,29,29,0,1,0
30,167,167,9,9,0,1,0
20,168,168,23,23,0,1,0
7,172,172,4,4,0,1,0
13,190,190,61,61,0,1,0
25,198,198,60,60,0,1,0
22,219,219,32,10,22,3,2
36,220,220,8,8,0,1,0
11,221,221,4,4,0,1,0
6,232,232,5,5,0,1,0
39,253,253,8,1,7,2,1
16,262,262,9,9,0,1,0
15,281,281,35,35,0,1,0
1,284,284,38,38,0,1,0
8,296,296,27,27,0,1,0
23,313,313,52,52,0,1,0
38,326,326,9,9,0,1,0
35,326,326,21,21,0,1,0
33,367,367,85,31,54,4,3
14,379,379,21,8,13,3,2
28,385,385,34,24,10,3,2
2,401,401,2,2,0,1,0
19,429,429,8,1,7,2,1
37,434,434,3,3,0,1,0
34,437,437,43,4,39,3,2
26,453,453,6,6,0,1,0
12,455,455,8,3,5,2,1
17,461,461,1,1,0,1,0
10,477,477,39,10,29,2,1
3,485,485,9,2,7,2,1
5,491,491,1,1,0,1,0
29,492,492,98,79,19,2,1
32,496,496,64,4,60,3,2
4,498,498,39,3,36,2,1

17,100,100,21,13,8,2,1
3,114,114,13,13,0,1,0
10,114,114,7,7,0,1,0
29,127,127,40,22,18,4,3
27,154,154,4,4,0,1,0
6,158,158,5,5,0,1,0
32,168,168,23,23,0,1,0
21,184,184,28,28,0,1,0
31,192,192,12,12,0,1,0
14,194,194,24,3,21,4,3
4,196,196,1,1,0,1,0
13,199,199,8,8,0,1,0
15,201,201,29,13,16,3,2
8,201,201,12,12,0,1,0
28,205,205,21,21,0,1,0
11,226,226,1,1,0,1,0
20,253,253,30,30,0,1,0
0,263,263,30,30,0,1,0
26,280,280,9,9,0,1,0
18,287,287,99,22,77,3,2
34,290,290,10,2,8,2,1
22,292,292,46,15,31,2,1
5,323,323,4,4,0,1,0
1,324,324,16,16,0,1,0
25,337,337,1,1,0,1,0
7,352,352,19,19,0,1,0
2,368,368,9,9,0,1,0
23,374,374,16,1,15,4,3
33,376,376,17,6,11,2,1
30,378,378,25,7,18,2,1
19,380,380,8,1,7,2,1
24,392,392,30,30,0,1,0
9,411,411,74,74,0,1,0
16,454,454,69,69,0,1,0
12,497,497,159,159,0,1,0

9,107,107,3,3,0,1,0
22,111,111,10,4,6,3,2
0,120,120,2,2,0,1,0
28,130,130,6,6,0,1,0
5,141,141,38,8,30,4,3
2,153,153,1,1,0,1,0
10,158,158,20,14,6,3,2
19,161,161,30,30,0,1,0
27,178,178,30,6,24,2,1
8,191,191,75,63,12,2,1
12,191,191,85,69,16,3,2
6,209,209,7,7,0,1,0
11,209,209,6,1,5,2,1
1,210,210,3,3,0,1,0
31,215,215,7,7,0,1,0
14,217,217,21,21,0,1,0
26,235,235,15,5,10,3,2
25,236,236,17,17,0,1,0
13,247,247,3,3,0,1,0
18,248,248,52,18,34,2,1
20,300,300,23,11,12,4,3
15,302,302,21,21,0,1,0
17,306,306,9,9,0,1,0
23,307,307,59,33,26,2,1
24,394,394,73,5,68,3,2
29,410,410,2,2,0,1,0
21,426,426,3,3,0,1,0
30,428,428,105,68,37,2,1
16,453,453,22,10,12,2,1
3,462,462,63,17,46,3,2
7,485,485,18,18,0,1,0
4,486,486,29,29,0,1,0

3,114,114,47,8,39,4,3
15,117,117,14,2,12,3,2
30,119,119,21,21,0,1,0
5,138,138,2,2,0,1,0
11,157,157,6,6,0,1,0
10,170,170,15,15,0,1,0
12,187,187,3,3,0,1,0
1,200,200,62,31,31,2,1
16,200,200,19,19,0,1,0
29,227,227,13,2,11,3,2
28,262,262,92,28,64,3,2
24,264,264,52,52,0,1,0
9,271,271,4,1,3,2,1
27,277,277,31,31,0,1,0
6,307,307,2,2,0,1,0
23,317,317,14,1,13,4,3
21,321,321,49,1,48,3,2
32,349,349,32,8,24,2,1
25,385,385,4,4,0,1,0
13,388,388,39,8,31,3,2
7,394,394,54,9,45,2,1
33,396,396,5,1,4,2,1
19,403,403,27,27,0,1,0
22,423,423,16,16,0,1,0
26,424,424,14,7,7,2,1
31,428,428,60,60,0,1,0
8,434,434,32,32,0,1,0
4,435,435,5,2,3,2,1
2,454,454,12,12,0,1,0
18,480,480,8,8,0,1,0
0,481,481,82,64,18,2,1
20,482,482,43,43,0,1,0
17,495,495,67,3,64,4,3
14,497,497,33,23,10,3,2

7,103,103,15,9,6,3,2
2,168,168,9,9,0,1,0
3,198,198,36,7,29,2,1
19,200,200,39,3,36,2,1
13,219,219,50,50,0,1,0
14,250,250,29,29,0,1,0
24,290,290,18,18,0,1,0
22,291,291,9,9,0,1,0
28,291,291,33,15,18,4,3
11,301,301,35,11,24,2,1
9,310,310,28,16,12,2,1
8,314,314,9,9,0,1,0
25,316,316,19,19,0,1,0
23,320,320,6,6,0,1,0
5,327,327,117,84,33,2,1
18,332,332,72,27,45,4,3
20,345,345,87,87,0,1,0
17,350,350,9,4,5,2,1
26,362,362,38,38,0,1,0
1,371,371,31,31,0,1,0
6,378,378,34,34,0,1,0
4,392,392,18,4,14,2,1
29,403,403,8,4,4,2,1
10,421,421,82,82,0,1,0
0,450,450,20,8,12,3,2
16,457,457,72,72,0,1,0
15,459,459,4,1,3,2,1
12,471,471,126,126,0,1,0
21,490,490,29,17,12,2,1
27,490,490,28,1,27,2,1

11,113,113,2,2,0,1,0
28,118,118,2,2,0,1,0
16,128,128,29,12,17,2,1
0,139,139,3,3,0,1,0
3,142,142,20,20,0,1,0
2,162,162,80,80,0,1,0
23,217,217,21,21,0,1,0
27,222,222,36,20,16,3,2
9,224,224,9,3,6,3,2
1,238,238,11,2,9,2,1
12,243,243,38,7,31,2,1
17,250,250,6,3,3,2,1
21,280,280,18,18,0,1,0
4,294,294,1,1,0,1,0
10,305,305,4,4,0,1,0
6,306,306,30,6,24,2,1
13,310,310,26,26,0,1,0
8,324,324,126,108,18,3,2
18,340,340,2,2,0,1,0
29,347,347,60,60,0,1,0
7,351,351,90,2,88,3,2
15,353,353,48,48,0,1,0
5,375,375,10,1,9,2,1
25,382,382,66,12,54,3,2
14,405,405,65,43,22,3,2
24,424,424,48,48,0,1,0
22,469,469,34,27,7,2,1
26,480,480,13,13,0,1,0
20,482,482,70,70,0,1,0
19,484,484,25,25,0,1,0

19,101,101,13,1,12,3,2
21,102,102,7,1,6,3,2
18,107,107,3,3,0,1,0
11,117,117,29,4,25,2,1
30,121,121,4,1,3,2,1
24,133,133,12,12,0,1,0
31,139,139,17,8,9,4,3
2,148,148,22,8,14,2,1
1,161,161,1,1,0,1,0
3,164,164,21,21,0,1,0
28,184,184,9,9,0,1,0
13,218,218,43,29,14,3,2
4,223,223,4,1,3,2,1
5,228,228,77,77,0,1,0
25,230,230,8,8,0,1,0
16,265,265,94,85,9,4,3
26,267,267,13,1,12,3,2
12,271,271,7,7,0,1,0
27,274,274,65,44,21,2,1
22,278,278,69,55,14,2,1
23,351,351,51,41,10,3,2
0,368,368,102,12,90,3,2
17,372,372,3,3,0,1,0
8,379,379,31,31,0,1,0
7,400,400,14,2,12,2,1
14,415,415,6,1,5,2,1
29,432,432,36,3,33,2,1
9,434,434,4,4,0,1,0
10,448,448,36,5,31,2,1
6,479,479,45,45,0,1,0
20,492,492,7,2,5,2,1
15,496,496,22,9,13,3,2

12,107,107,9,9,0,1,0
17,122,122,1,1,0,1,0
4,128,128,8,8,0,1,0
19,133,133,9,6,3,2,1
6,136,136,8,2,6,3,2
9,160,160,36,11,25,2,1
13,171,171,10,10,0,1,0
28,171,171,6,6,0,1,0
23,178,178,39,9,30,3,2
30,178,178,15,6,9,4,3
34,183,183,2,2,0,1,0
35,219,219,17,13,4,2,1
31,234,234,11,4,7,2,1
11,238,238,16,7,9,2,1
5,250,250,43,43,0,1,0
26,261,261,49,49,0,1,0
29,274,274,1,1,0,1,0
8,288,288,53,53,0,1,0
22,306,306,123,48,75,4,3
33,345,345,75,65,10,2,1
7,346,346,23,23,0,1,0
37,364,364,5,5,0,1,0
14,382,382,25,25,0,1,0
24,388,388,5,5,0,1,0
32,394,394,76,24,52,4,3
16,404,404,2,2,0,1,0
3,412,412,42,26,16,2,1
1,416,416,39,7,32,3,2
18,430,430,9,9,0,1,0
15,431,431,39,30,9,2,1
25,446,446,4,4,0,1,0
10,449,449,39,39,0,1,0
38,455,455,40,19,21,4,3
0,455,455,20,20,0,1,0
27,458,458,50,34,16,2,1
21,462,462,6,6,0,1,0
2,468,468,9,9,0,1,0
20,489,489,52,43,9,2,1
36,497,497,9,9,0,1,0

20,119,119,7,2,5,2,1
21,127,127,23,23,0,1,0
33,129,129,28,21,7,2,1
8,138,138,3,3,0,1,0
27,156,156,26,4,22,3,2
13,169,169,15,9,6,3,2
12,169,169,13,13,0,1,0
26,182,182,3,3,0,1,0
23,182,182,10,2,8,2,1
31,202,202,6,6,0,1,0
17,215,215,22,16,6,2,1
15,245,245,21,21,0,1,0
1,253,253,1,1,0,1,0
10,255,255,11,1,10,3,2
3,256,256,27,12,15,2,1
14,270,270,1,1,0,1,0
16,274,274,24,10,14,3,2
0,278,278,9,1,8,3,2
29,291,291,33,33,0,1,0
11,304,304,27,27,0,1,0
19,323,323,5,5,0,1,0
9,332,332,47,47,0,1,0
5,338,338,21,7,14,2,1
7,357,357,48,16,32,3,2
18,361,361,37,5,32,3,2
32,399,399,11,2,9,4,3
25,406,406,106,106,0,1,0
22,434,434,108,17,91,4,3
4,438,438,106,100,6,2,1
30,453,453,4,1,3,2,1
34,455,455,40,40,0,1,0
6,456,456,119,90,29,3,2
28,464,464,66,66,0,1,0
2,472,472,58,58,0,1,0
24,490,490,3,3,0,1,0

12,139,139,21,10,11,2,1
4,145,145,27,4,23,2,1
22,146,146,10,4,6,2,1
11,153,153,4,4,0,1,0
16,185,185,3,3,0,1,0
3,192,192,7,7,0,1,0
23,204,204,7,4,3,2,1
20,204,204,6,6,0,1,0
24,219,219,36,36,0,1,0
6,226,226,22,22,0,1,0
2,232,232,21,21,0,1,0
9,232,232,4,1,3,2,1
15,242,242,10,1,9,4,3
32,255,255,12,7,5,2,1
14,269,269,4,4,0,1,0
29,270,270,10,10,0,1,0
7,278,278,67,67,0,1,0
18,285,285,13,13,0,1,0
34,285,285,11,11,0,1,0
17,286,286,1,1,0,1,0
28,290,290,82,64,18,4,3
30,303,303,4,1,3,2,1
5,322,322,23,14,9,2,1
19,328,328,13,13,0,1,0
13,336,336,63,23,40,2,1
25,338,338,56,6,50,3,2
10,341,341,7,7,0,1,0
33,346,346,29,3,26,3,2
1,362,362,29,29,0,1,0
0,382,382,10,5,5,2,1
21,403,403,58,10,48,3,2
27,407,407,119,92,27,4,3
26,472,472,13,5,8,3,2
31,477,477,58,58,0,1,0
35,484,484,68,29,39,4,3
8,498,498,174,174,0,1,0

3,100,100,8,8,0,1,0
14,101,101,6,6,0,1,0
11,103,103,12,12,0,1,0
12,117,117,9,1,8,3,2
30,125,125,12,12,0,1,0
23,127,127,12,12,0,1,0
13,143,143,29,29,0,1,0
9,145,145,29,29,0,1,0
7,183,183,5,1,4,2,1
31,190,190,55,11,44,2,1
29,193,193,13,13,0,1,0
16,198,198,6,6,0,1,0
0,202,202,20,12,8,2,1
8,206,206,33,3,30,3,2
4,210,210,12,12,0,1,0
24,227,227,8,8,0,1,0
19,231,231,13,13,0,1,0
6,247,247,17,17,0,1,0
20,260,260,22,13,9,4,3
5,274,274,56,56,0,1,0
26,288,288,3,3,0,1,0
21,289,289,45,45,0,1,0
27,293,293,34,34,0,1,0
2,333,333,64,64,0,1,0
1,345,345,11,5,6,2,1
17,346,346,37,17,20,2,1
25,360,360,3,3,0,1,0
28,367,367,99,68,31,3,2
18,389,389,57,5,52,3,2
22,415,415,19,19,0,1,0
15,423,423,50,25,25,2,1
10,453,453,58,31,27,2,1

33,100,100,15,3,12,4,3
19,103,103,3,3,0,1,0
29,110,110,34,6,28,2,1
3,128,128,1,1,0,1,0
0,153,153,17,17,0,1,0
10,162,162,3,3,0,1,0
34,178,178,3,3,0,1,0
21,184,184,7,7,0,1,0
1,187,187,20,12,8,2,1
16,193,193,22,22,0,1,0
30,202,202,11,11,0,1,0
27,206,206,23,13,10,2,1
22,213,213,10,10,0,1,0
20,220,220,28,28,0,1,0
31,230,230,25,5,20,2,1
26,230,230,25,16,9,2,1
15,233,233,13,6,7,2,1
7,238,238,5,5,0,1,0
11,241,241,98,98,0,1,0
24,249,249,5,5,0,1,0
18,254,254,57,57,0,1,0
25,259,259,48,27,21,2,1
4,265,265,19,19,0,1,0
5,299,299,86,17,69,4,3
28,302,302,9,9,0,1,0
14,311,311,10,10,0,1,0
13,319,319,34,34,0,1,0
6,319,319,9,9,0,1,0
9,321,321,71,3,68,3,2
17,326,326,23,23,0,1,0
32,351,351,57,28,29,2,1
8,454,454,6,6,0,1,0
12,460,460,6,6,0,1,0
23,471,471,10,7,3,2,1
2,482,482,7,7,0,1,0

29,102,102,30,30,0,1,0
7,132,132,18,4,14,3,2
1,158,158,27,27,0,1,0
13,176,176,10,3,7,2,1
3,178,178,5,5,0,1,0
5,195,195,109,19,90,4,3
20,196,196,3,3,0,1,0
28,212,212,31,9,22,2,1
18,223,223,44,20,24,3,2
15,229,229,6,3,3,2,1
21,239,239,9,9,0,1,0
23,241,241,97,29,68,3,2
14,263,263,2,2,0,1,0
25,268,268,8,2,6,3,2
33,280,280,6,6,0,1,0
31,287,287,11,1,10,2,1
22,306,306,8,1,7,2,1
0,313,313,12,1,11,2,1
34,328,328,5,2,3,2,1
27,329,329,65,62,3,2,1
4,339,339,21,2,19,2,1
6,382,382,51,7,44,2,1
9,392,392,1,1,0,1,0
2,400,400,23,9,14,3,2
32,404,404,5,5,0,1,0
26,407,407,24,24,0,1,0
17,409,409,9,9,0,1,0
24,417,417,11,1,10,2,1
10,419,419,5,5,0,1,0
8,426,426,40,40,0,1,0
30,435,435,72,72,0,1,0
12,449,449,27,27,0,1,0
19,475,475,24,24,0,1,0
11,499,499,97,97,0,1,0
16,500,500,20,20,0,1,0

29,117,117,9,2,7,2,1
10,119,119,28,14,14,2,1
31,140,140,13,2,11,2,1
7,154,154,19,10,9,4,3
19,178,178,7,3,4,2,1
22,183,183,93,15,78,4,3
27,189,189,78,48,30,4,3
5,205,205,46,46,0,1,0
16,217,217,43,43,0,1,0
34,224,224,12,6,6,2,1
11,226,226,1,1,0,1,0
0,234,234,2,2,0,1,0
4,242,242,33,33,0,1,0
9,243,243,42,13,29,4,3
28,294,294,5,2,3,2,1
20,318,318,3,3,0,1,0
3,320,320,6,6,0,1,0
1,330,330,33,33,0,1,0
30,330,330,33,9,24,2,1
6,339,339,88,46,42,4,3
12,357,357,4,1,3,2,1
26,375,375,29,18,11,2,1
24,375,375,23,23,0,1,0
8,378,378,23,23,0,1,0
33,393,393,19,19,0,1,0
13,401,401,8,2,6,3,2
17,405,405,19,1,18,2,1
2,410,410,2,2,0,1,0
14,450,450,7,4,3,2,1
25,454,454,43,3,40,3,2
18,454,454,3,3,0,1,0
21,461,461,7,7,0,1,0
23,467,467,1,1,0,1,0
15,474,474,28,28,0,1,0
32,477,477,56,6,50,3,2

32,105,105,7,7,0,1,0
33,109,109,8,8,0,1,0
19,115,115,17,17,0,1,0
11,151,151,5,5,0,1,0
30,173,173,5,5,0,1,0
9,179,179,16,7,9,2,1
21,179,179,18,18,0,1,0
23,181,181,1,1,0,1,0
13,193,193,32,20,12,2,1
4,195,195,24,18,6,3,2
29,195,195,10,10,0,1,0
8,200,200,16,4,12,3,2
27,215,215,8,8,0,1,0
14,218,218,18,13,5,2,1
24,222,222,30,30,0,1,0
31,245,245,35,35,0,1,0
2,260,260,34,16,18,3,2
22,263,263,115,55,60,4,3
12,266,266,32,14,18,4,3
26,291,291,34,34,0,1,0
3,314,314,10,10,0,1,0
28,318,318,12,12,0,1,0
1,320,320,9,9,0,1,0
16,341,341,62,62,0,1,0
10,370,370,26,26,0,1,0
18,376,376,6,2,4,2,1
25,383,383,4,4,0,1,0
0,390,390,13,1,12,2,1
20,393,393,43,43,0,1,0
6,414,414,1,1,0,1,0
5,428,428,23,13,10,2,1
7,437,437,197,142,55,4,3
15,458,458,11,11,0,1,0
17,497,497,112,36,76,3,2

18,112,112,2,2,0,1,0
4,124,124,10,10,0,1,0
0,137,137,1,1,0,1,0
23,137,137,15,15,0,1,0
7,141,141,48,17,31,4,3
17,149,149,4,4,0,1,0
19,153,153,5,5,0,1,0
27,163,163,54,42,12,2,1
11,196,196,25,25,0,1,0
13,210,210,64,18,46,2,1
1,231,231,13,9,4,2,1
10,247,247,7,7,0,1,0
8,260,260,14,14,0,1,0
14,261,261,6,6,0,1,0
24,266,266,69,45,24,3,2
5,270,270,76,76,0,1,0
16,280,280,9,6,3,2,1
15,283,283,10,1,9,4,3
2,293,293,11,11,0,1,0
20,299,299,77,7,70,3,2
26,314,314,9,3,6,2,1
29,315,315,60,9,51,4,3
28,353,353,46,46,0,1,0
30,353,353,31,31,0,1,0
21,369,369,10,10,0,1,0
9,407,407,42,17,25,3,2
25,432,432,67,67,0,1,0
22,454,454,2,2,0,1,0
6,459,459,49,49,0,1,0
3,488,488,6,6,0,1,0
12,497,497,81,54,27,4,3

14,102,102,8,8,0,1,0
13,103,103,1,1,0,1,0
30,105,105,33,4,29,2,1
25,107,107,5,5,0,1,0
15,111,111,6,6,0,1,0
4,135,135,34,14,20,2,1
6,145,145,7,7,0,1,0
0,153,153,9,6,3,2,1
34,153,153,31,31,0,1,0
3,170,170,67,52,15,2,1
17,173,173,1,1,0,1,0
9,176,176,6,6,0,1,0
2,197,197,10,10,0,1,0
24,227,227,14,1,13,2,1
12,242,242,5,5,0,1,0
31,247,247,40,25,15,2,1
16,251,251,19,3,16,3,2
19,254,254,22,22,0,1,0
5,262,262,4,4,0,1,0
33,265,265,13,8,5,2,1
27,272,272,14,5,9,2,1
35,287,287,39,39,0,1,0
28,343,343,34,34,0,1,0
26,349,349,93,93,0,1,0
10,369,369,83,8,75,4,3
32,379,379,21,21,0,1,0
20,387,387,19,12,7,2,1
8,397,397,31,8,23,2,1
23,402,402,11,3,8,2,1
7,444,444,68,1,67,4,3
22,446,446,33,33,0,1,0
29,451,451,17,17,0,1,0
11,451,451,6,1,5,2,1
21,472,472,8,8,0,1,0
1,475,475,22,22,0,1,0
18,494,494,43,43,0,1,0

10,109,109,1,1,0,1,0
14,120,120,4,4,0,1,0
13,122,122,2,2,0,1,0
25,123,123,4,4,0,1,0
40,126,126,1,1,0,1,0
41,135,135,26,26,0,1,0
16,145,145,7,7,0,1,0
1,153,153,3,3,0,1,0
29,157,157,40,40,0,1,0
18,157,157,10,10,0,1,0
8,168,168,19,19,0,1,0
37,172,172,4,4,0,1,0
12,180,180,7,1,6,2,1
2,204,204,41,41,0,1,0
33,216,216,6,6,0,1,0
3,256,256,10,10,0,1,0
19,259,259,45,1,44,3,2
42,263,263,54,48,6,3,2
4,272,272,7,7,0,1,0
21,274,274,1,1,0,1,0
23,283,283,23,3,20,2,1
28,290,290,20,8,12,4,3
7,293,293,15,15,0,1,0
35,309,309,65,34,31,2,1
38,312,312,44,44,0,1,0
30,313,313,17,12,5,2,1
22,314,314,28,7,21,4,3
0,320,320,44,6,38,3,2
36,321,321,43,43,0,1,0
45,323,323,13,13,0,1,0
11,335,335,23,23,0,1,0
27,349,349,25,25,0,1,0
9,351,351,21,21,0,1,0
44,392,392,41,35,6,2,1
39,401,401,80,56,24,3,2
15,412,412,30,30,0,1,0
26,425,425,19,19,0,1,0
31,430,430,8,1,7,2,1
32,436,436,13,13,0,1,0
17,445,445,1,1,0,1,0
5,452,452,10,10,0,1,0
6,456,456,7,4,3,2,1
43,458,458,1,1,0,1,0
20,469,469,20,3,17,4,3
34,486,486,40,16,24,4,3
24,496,496,27,1,26,3,2

15,107,107,21,5,16,3,2
28,133,133,25,7,18,4,3
4,139,139,4,1,3,2,1
5,152,152,5,5,0,1,0
16,164,164,18,8,10,3,2
25,188,188,6,6,0,1,0
18,202,202,3,3,0,1,0
7,252,252,43,11,32,3,2
10,252,252,27,27,0,1,0
1,272,272,35,35,0,1,0
27,273,273,49,49,0,1,0
3,281,281,45,2,43,2,1
30,285,285,5,1,4,2,1
9,316,316,71,44,27,4,3
26,321,321,17,17,0,1,0
2,367,367,36,21,15,4,3
23,378,378,12,12,0,1,0
12,390,390,17,14,3,2,1
19,396,396,39,39,0,1,0
20,404,404,15,4,11,2,1
6,418,418,90,58,32,2,1
11,424,424,20,20,0,1,0
13,439,439,119,6,113,4,3
14,442,442,35,35,0,1,0
17,450,450,94,30,64,3,2
8,450,450,66,4,62,3,2
0,453,453,12,2,10,2,1
22,461,461,3,3,0,1,0
24,464,464,171,171,0,1,0
21,476,476,7,3,4,2,1
29,485,485,46,46,0,1,0

29,107,107,20,20,0,1,0
0,112,112,1,1,0,1,0
23,119,119,1,1,0,1,0
30,130,130,11,6,5,2,1
4,142,142,17,17,0,1,0
31,143,143,58,28,30,2,1
28,160,160,3,3,0,1,0
15,198,198,37,37,0,1,0
21,198,198,2,2,0,1,0
22,207,207,47,2,45,3,2
3,208,208,1,1,0,1,0
9,223,223,38,38,0,1,0
20,234,234,2,2,0,1,0
10,263,263,2,2,0,1,0
5,265,265,12,1,11,2,1
1,290,290,52,32,20,4,3
8,294,294,28,7,21,4,3
18,301,301,28,28,0,1,0
32,333,333,3,3,0,1,0
26,379,379,31,31,0,1,0
19,380,380,43,18,25,2,1
16,387,387,6,6,0,1,0
27,387,387,2,2,0,1,0
25,423,423,142,73,69,4,3
13,442,442,148,139,9,2,1
6,452,452,56,31,25,2,1
17,457,457,35,35,0,1,0
14,459,459,89,89,0,1,0
11,461,461,56,56,0,1,0
12,473,473,1,1,0,1,0
7,473,473,28,28,0,1,0
2,477,477,24,12,12,3,2
24,499,499,27,19,8,3,2

25,107,107,19,19,0,1,0
5,109,109,8,2,6,3,2
10,117,117,42,3,39,4,3
29,122,122,25,25,0,1,0
6,129,129,1,1,0,1,0
0,130,130,6,3,3,2,1
11,152,152,1,1,0,1,0
2,178,178,17,8,9,4,3
19,179,179,33,11,22,2,1
4,199,199,2,2,0,1,0
17,204,204,2,2,0,1,0
15,234,234,9,9,0,1,0
20,234,234,5,1,4,2,1
3,245,245,115,86,29,2,1
32,250,250,14,14,0,1,0
13,262,262,14,5,9,2,1
22,263,263,38,22,16,3,2
8,294,294,66,47,19,2,1
7,299,299,23,7,16,3,2
12,307,307,2,2,0,1,0
16,336,336,20,20,0,1,0
26,359,359,25,25,0,1,0
21,365,365,67,67,0,1,0
30,376,376,30,30,0,1,0
14,406,406,38,38,0,1,0
31,407,407,41,7,34,2,1
24,427,427,38,38,0,1,0
9,446,446,23,23,0,1,0
1,447,447,13,3,10,3,2
23,456,456,3,3,0,1,0
18,462,462,3,3,0,1,0
33,485,485,24,24,0,1,0
28,486,486,36,36,0,1,0
27,495,495,135,89,46,2,1

3,109,109,9,9,0,1,0
29,122,122,9,9,0,1,0
21,129,129,2,2,0,1,0
7,159,159,17,5,12,2,1
6,182,182,31,16,15,4,3
11,198,198,7,1,6,3,2
14,211,211,5,5,0,1,0
8,216,216,1,1,0,1,0
33,227,227,12,4,8,3,2
28,235,235,2,2,0,1,0
16,246,246,6,6,0,1,0
20,268,268,12,12,0,1,0
12,290,290,1,1,0,1,0
23,293,293,5,5,0,1,0
15,321,321,60,60,0,1,0
32,332,332,3,3,0,1,0
30,346,346,105,87,18,3,2
10,353,353,23,23,0,1,0
26,364,364,127,46,81,4,3
5,374,374,13,13,0,1,0
1,374,374,112,93,19,2,1
18,386,386,4,4,0,1,0
17,386,386,37,37,0,1,0
2,410,410,71,23,48,4,3
34,426,426,181,123,58,4,3
9,426,426,37,26,11,4,3
0,430,430,69,9,60,4,3
24,439,439,4,4,0,1,0
31,453,453,78,69,9,4,3
22,458,458,49,49,0,1,0
19,458,458,18,18,0,1,0
27,477,477,37,37,0,1,0
13,482,482,62,47,15,2,1
4,483,483,9,9,0,1,0
25,500,500,10,10,0,1,0

8,118,118,28,7,21,4,3
2,158,158,14,9,5,2,1
9,174,174,6,6,0,1,0
22,186,186,1,1,0,1,0
25,199,199,5,5,0,1,0
31,214,214,40,10,30,4,3
36,219,219,17,11,6,2,1
14,229,229,33,33,0,1,0
33,236,236,9,9,0,1,0
5,244,244,2,2,0,1,0
28,249,249,7,7,0,1,0
27,258,258,29,19,10,3,2
42,258,258,15,15,0,1,0
30,275,275,28,4,24,3,2
18,282,282,14,14,0,1,0
17,286,286,58,32,26,2,1
7,289,289,1,1,0,1,0
12,289,289,9,9,0,1,0
11,294,294,33,33,0,1,0
29,315,315,30,30,0,1,0
21,326,326,7,7,0,1,0
35,341,341,10,10,0,1,0
16,356,356,1,1,0,1,0
32,404,404,100,7,93,4,3
20,406,406,5,5,0,1,0
41,437,437,1,1,0,1,0
1,437,437,7,2,5,2,1
26,438,438,6,6,0,1,0
19,438,438,1,1,0,1,0
39,443,443,56,56,0,1,0
34,447,447,45,31,14,2,1
3,448,448,27,27,0,1,0
10,448,448,57,7,50,3,2
6,451,451,21,21,0,1,0
38,459,459,85,79,6,2,1
15,472,472,13,13,0,1,0
37,479,479,83,41,42,4,3
4,479,479,99,87,12,3,2
13,482,482,7,1,6,3,2
0,492,492,63,14,49,3,2
23,496,496,35,35,0,1,0
24,497,497,13,13,0,1,0
40,500,500,77,30,47,3,2

23,132,132,7,7,0,1,0
21,151,151,11,8,3,2,1
1,151,151,90,69,21,4,3
2,166,166,6,2,4,2,1
25,187,187,63,54,9,4,3
14,217,217,3,3,0,1,0
9,230,230,50,38,12,4,3
3,231,231,6,6,0,1,0
13,236,236,31,31,0,1,0
4,244,244,4,4,0,1,0
15,249,249,13,7,6,2,1
11,264,264,1,1,0,1,0
22,265,265,40,24,16,3,2
10,271,271,64,64,0,1,0
27,278,278,52,2,50,3,2
7,286,286,14,14,0,1,0
19,305,305,46,46,0,1,0
26,314,314,1,1,0,1,0
12,320,320,48,3,45,4,3
0,322,322,33,33,0,1,0
6,347,347,14,14,0,1,0
18,354,354,17,5,12,2,1
24,371,371,3,3,0,1,0
16,389,389,13,13,0,1,0
20,397,397,67,6,61,4,3
17,456,456,77,72,5,2,1
5,457,457,162,162,0,1,0
8,458,458,13,7,6,2,1

24,121,121,23,23,0,1,0
11,125,125,15,15,0,1,0
25,142,142,3,3,0,1,0
21,152,152,29,18,11,2,1
0,173,173,6,6,0,1,0
1,175,175,1,1,0,1,0
6,181,181,3,3,0,1,0
34,187,187,14,2,12,3,2
8,226,226,6,6,0,1,0
13,229,229,51,21,30,2,1
4,235,235,16,5,11,2,1
22,239,239,2,2,0,1,0
7,247,247,35,35,0,1,0
31,280,280,6,6,0,1,0
12,284,284,6,2,4,2,1
26,292,292,23,19,4,2,1
30,322,322,15,4,11,2,1
28,328,328,2,2,0,1,0
20,334,334,20,2,18,3,2
23,337,337,26,26,0,1,0
36,349,349,115,31,84,4,3
15,352,352,75,57,18,4,3
3,354,354,3,3,0,1,0
33,355,355,83,74,9,4,3
35,370,370,39,3,36,2,1
14,374,374,47,13,34,3,2
2,374,374,47,21,26,3,2
5,385,385,43,38,5,2,1
9,386,386,31,31,0,1,0
18,390,390,25,25,0,1,0
19,419,419,99,83,16,2,1
29,424,424,13,13,0,1,0
27,457,457,89,22,67,4,3
16,471,471,13,13,0,1,0
32,484,484,31,10,21,4,3
17,488,488,17,17,0,1,0
10,494,494,8,8,0,1,0

26,113,113,13,13,0,1,0
27,126,126,16,16,0,1,0
16,129,129,4,4,0,1,0
5,145,145,3,3,0,1,0
11,156,156,24,24,0,1,0
18,167,167,19,19,0,1,0
21,188,188,5,5,0,1,0
20,224,224,34,34,0,1,0
28,232,232,43,7,36,3,2
3,234,234,67,34,33,4,3
12,241,241,7,7,0,1,0
29,261,261,22,22,0,1,0
13,264,264,6,6,0,1,0
19,298,298,2,2,0,1,0
9,304,304,77,20,57,4,3
24,311,311,60,48,12,2,1
6,331,331,8,5,3,2,1
4,333,333,79,17,62,3,2
23,357,357,39,16,23,2,1
10,364,364,6,6,0,1,0
15,406,406,43,43,0,1,0
1,408,408,76,30,46,3,2
2,418,418,77,46,31,3,2
8,438,438,31,25,6,2,1
22,449,449,98,98,0,1,0
0,450,450,95,95,0,1,0
25,451,451,34,34,0,1,0
7,473,473,14,2,12,4,3
14,481,481,37,37,0,1,0
17,496,496,49,40,9,2,1

6,130,130,1,1,0,1,0
12,137,137,15,15,0,1,0
0,141,141,1,1,0,1,0
28,164,164,8,1,7,2,1
11,165,165,23,23,0,1,0
17,177,177,22,22,0,1,0
24,213,213,9,6,3,2,1
14,225,225,103,83,20,2,1
5,238,238,26,8,18,4,3
15,243,243,19,19,0,1,0
20,245,245,7,7,0,1,0
1,263,263,77,77,0,1,0
26,267,267,4,4,0,1,0
7,267,267,53,14,39,2,1
4,272,272,7,7,0,1,0
8,293,293,120,38,82,4,3
25,301,301,76,28,48,3,2
30,307,307,18,18,0,1,0
27,318,318,49,49,0,1,0
18,320,320,17,17,0,1,0
16,353,353,3,3,0,1,0
19,360,360,39,11,28,2,1
13,393,393,15,15,0,1,0
2,405,405,1,1,0,1,0
9,416,416,30,4,26,3,2
3,420,420,116,116,0,1,0
29,457,457,22,22,0,1,0
21,473,473,75,57,18,4,3
23,479,479,40,28,12,4,3
22,492,492,7,1,6,3,2
10,499,499,7,7,0,1,0

11,112,112,11,3,8,3,2
13,130,130,24,24,0,1,0
17,137,137,17,1,16,3,2
7,173,173,15,15,0,1,0
9,176,176,4,4,0,1,0
1,202,202,13,2,11,2,1
10,238,238,11,11,0,1,0
4,263,263,8,8,0,1,0
6,275,275,31,31,0,1,0
5,277,277,39,23,16,2,1
22,301,301,17,17,0,1,0
30,322,322,57,18,39,4,3
23,331,331,20,20,0,1,0
28,332,332,15,15,0,1,0
15,336,336,75,25,50,2,1
26,342,342,38,7,31,3,2
31,347,347,6,1,5,2,1
24,348,348,20,20,0,1,0
14,349,349,43,43,0,1,0
27,359,359,67,67,0,1,0
19,367,367,41,8,33,2,1
21,368,368,3,3,0,1,0
2,394,394,36,36,0,1,0
25,411,411,29,1,28,3,2
8,434,434,149,109,40,3,2
12,455,455,61,61,0,1,0
20,467,467,93,12,81,4,3
18,469,469,41,25,16,2,1
29,473,473,17,17,0,1,0
16,480,480,71,47,24,3,2
0,490,490,69,60,9,4,3
3,492,492,40,40,0,1,0

18,106,106,7,1,6,2,1
4,135,135,25,11,14,2,1
0,157,157,3,3,0,1,0
21,160,160,10,10,0,1,0
23,190,190,36,36,0,1,0
24,228,228,9,9,0,1,0
12,235,235,10,10,0,1,0
27,244,244,10,7,3,2,1
26,247,247,31,15,16,2,1
11,255,255,2,2,0,1,0
31,271,271,5,2,3,2,1
29,280,280,34,24,10,3,2
33,289,289,40,20,20,2,1
9,293,293,11,11,0,1,0
19,301,301,13,7,6,2,1
13,306,306,18,18,0,1,0
20,327,327,22,16,6,3,2
2,339,339,11,11,0,1,0
15,353,353,53,53,0,1,0
3,365,365,62,62,0,1,0
10,367,367,2,2,0,1,0
22,374,374,12,4,8,3,2
6,377,377,46,26,20,2,1
8,382,382,33,33,0,1,0
5,420,420,28,8,20,2,1
7,426,426,43,43,0,1,0
14,427,427,82,44,38,2,1
30,433,433,67,45,22,4,3
1,440,440,11,11,0,1,0
16,454,454,181,94,87,4,3
32,461,461,52,52,0,1,0
17,471,471,154,132,22,3,2
28,482,482,33,11,22,3,2
25,495,495,62,18,44,3,2

17,103,103,15,15,0,1,0
2,104,104,25,25,0,1,0
19,122,122,17,17,0,1,0
34,129,129,26,26,0,1,0
18,138,138,26,5,21,4,3
10,156,156,10,10,0,1,0
1,166,166,2,2,0,1,0
26,169,169,29,5,24,4,3
23,188,188,25,1,24,3,2
4,207,207,8,8,0,1,0
30,214,214,5,5,0,1,0
14,217,217,18,14,4,2,1
5,218,218,80,32,48,2,1
35,255,255,17,17,0,1,0
11,260,260,15,15,0,1,0
29,263,263,46,15,31,2,1
16,268,268,9,4,5,2,1
21,300,300,34,19,15,4,3
0,309,309,2,2,0,1,0
15,317,317,42,42,0,1,0
12,318,318,23,19,4,2,1
28,362,362,15,15,0,1,0
20,363,363,7,1,6,2,1
25,367,367,1,1,0,1,0
33,386,386,22,22,0,1,0
8,395,395,4,4,0,1,0
13,397,397,11,11,0,1,0
7,402,402,38,22,16,2,1
24,409,409,54,27,27,4,3
32,414,414,45,45,0,1,0
31,423,423,33,33,0,1,0
9,424,424,19,19,0,1,0
22,426,426,72,72,0,1,0
6,437,437,6,6,0,1,0
27,457,457,43,43,0,1,0
3,489,489,35,5,30,4,3

19,105,105,12,3,9,4,3
16,105,105,10,10,0,1,0
33,123,123,5,5,0,1,0
18,143,143,3,3,0,1,0
23,158,158,17,11,6,2,1
14,161,161,9,9,0,1,0
29,164,164,7,1,6,3,2
17,166,166,34,34,0,1,0
30,169,169,24,24,0,1,0
10,213,213,3,3,0,1,0
27,249,249,12,12,0,1,0
32,268,268,17,2,15,4,3
5,276,276,84,37,47,4,3
22,287,287,41,11,30,4,3
11,316,316,63,63,0,1,0
28,330,330,39,39,0,1,0
8,352,352,7,7,0,1,0
7,358,358,16,4,12,3,2
31,366,366,21,21,0,1,0
2,367,367,74,37,37,2,1
26,374,374,63,63,0,1,0
12,384,384,16,16,0,1,0
20,389,389,79,35,44,3,2
1,407,407,80,54,26,4,3
4,409,409,18,8,10,2,1
24,412,412,78,78,0,1,0
21,419,419,21,10,11,2,1
25,426,426,10,10,0,1,0
3,431,431,3,3,0,1,0
13,462,462,1,1,0,1,0
9,462,462,43,35,8,2,1
15,463,463,4,1,3,2,1
0,486,486,41,17,24,4,3
6,498,498,146,112,34,2,1

30,100,100,5,5,0,1,0
3,104,104,1,1,0,1,0
0,113,113,34,34,0,1,0
28,157,157,2,2,0,1,0
26,161,161,3,3,0,1,0
14,174,174,29,29,0,1,0
5,190,190,1,1,0,1,0
16,200,200,24,24,0,1,0
33,211,211,26,26,0,1,0
12,226,226,14,14,0,1,0
2,226,226,18,10,8,2,1
22,240,240,39,6,33,4,3
25,244,244,6,6,0,1,0
13,260,260,73,73,0,1,0
7,285,285,3,3,0,1,0
11,288,288,5,5,0,1,0
32,299,299,13,1,12,2,1
1,304,304,1,1,0,1,0
21,324,324,93,21,72,4,3
34,331,331,20,20,0,1,0
36,356,356,17,3,14,3,2
10,360,360,84,56,28,3,2
35,382,382,79,37,42,4,3
17,397,397,13,13,0,1,0
6,406,406,48,10,38,2,1
15,411,411,19,19,0,1,0
31,430,430,14,14,0,1,0
20,434,434,20,20,0,1,0
8,439,439,34,1,33,4,3
23,439,439,4,4,0,1,0
4,441,441,18,18,0,1,0
37,446,446,129,59,70,3,2
19,446,446,17,17,0,1,0
9,446,446,4,4,0,1,0
24,455,455,11,1,10,3,2
18,478,478,1,1,0,1,0
29,495,495,92,51,41,2,1
27,500,500,82,82,0,1,0

0,109,109,7,7,0,1,0
8,110,110,32,32,0,1,0
2,114,114,1,1,0,1,0
25,151,151,4,4,0,1,0
17,167,167,9,9,0,1,0
20,188,188,5,5,0,1,0
23,191,191,21,21,0,1,0
29,211,211,9,9,0,1,0
7,220,220,67,67,0,1,0
14,235,235,22,22,0,1,0
1,237,237,30,4,26,3,2
4,268,268,22,10,12,2,1
13,273,273,13,1,12,3,2
12,308,308,4,4,0,1,0
3,312,312,61,31,30,2,1
10,317,317,36,33,3,2,1
11,326,326,1,1,0,1,0
9,332,332,3,3,0,1,0
19,354,354,101,47,54,4,3
24,380,380,55,19,36,4,3
6,393,393,46,46,0,1,0
30,414,414,11,11,0,1,0
5,431,431,141,91,50,3,2
22,444,444,58,16,42,3,2
28,449,449,7,7,0,1,0
26,451,451,29,14,15,4,3
15,462,462,17,17,0,1,0
16,468,468,34,34,0,1,0
27,472,472,211,199,12,4,3
21,495,495,69,33,36,2,1
18,495,495,8,8,0,1,0

2,104,104,36,2,34,2,1
8,127,127,15,15,0,1,0
3,143,143,36,36,0,1,0
6,144,144,27,2,25,3,2
17,147,147,4,4,0,1,0
14,170,170,10,10,0,1,0
29,172,172,7,7,0,1,0
26,178,178,30,12,18,4,3
22,212,212,102,42,60,4,3
28,218,218,5,1,4,2,1
13,243,243,24,24,0,1,0
1,246,246,18,18,0,1,0
16,277,277,22,22,0,1,0
18,307,307,33,33,0,1,0
19,310,310,13,13,0,1,0
30,310,310,27,1,26,3,2
12,329,329,18,18,0,1,0
5,349,349,27,9,18,4,3
23,359,359,63,7,56,3,2
25,371,371,66,17,49,2,1
24,394,394,11,5,6,3,2
9,399,399,6,6,0,1,0
11,400,400,5,5,0,1,0
27,419,419,6,6,0,1,0
20,423,423,16,2,14,2,1
21,425,425,55,29,26,2,1
7,442,442,75,75,0,1,0
4,454,454,57,24,33,4,3
10,465,465,59,2,57,4,3
15,467,467,25,17,8,3,2
0,472,472,21,21,0,1,0

28,103,103,3,3,0,1,0
32,124,124,4,4,0,1,0
8,125,125,1,1,0,1,0
30,130,130,2,2,0,1,0
9,134,134,1,1,0,1,0
34,139,139,16,16,0,1,0
14,140,140,1,1,0,1,0
19,141,141,1,1,0,1,0
3,153,153,26,2,24,3,2
15,168,168,15,4,11,2,1
16,171,171,21,7,14,3,2
24,177,177,2,2,0,1,0
31,180,180,24,8,16,3,2
4,183,183,18,10,8,2,1
11,200,200,11,5,6,3,2
29,249,249,9,1,8,3,2
35,257,257,21,21,0,1,0
33,263,263,16,16,0,1,0
1,267,267,44,23,21,4,3
6,272,272,30,30,0,1,0
10,275,275,4,4,0,1,0
12,282,282,42,42,0,1,0
21,296,296,8,8,0,1,0
2,299,299,4,4,0,1,0
20,319,319,23,5,18,3,2
36,319,319,16,9,7,2,1
17,346,346,11,1,10,2,1
26,348,348,52,32,20,3,2
37,389,389,38,8,30,2,1
18,403,403,47,42,5,2,1
23,420,420,15,2,13,2,1
38,420,420,20,5,15,4,3
22,456,456,11,7,4,2,1
0,456,456,3,3,0,1,0
5,462,462,67,67,0,1,0
27,471,471,261,246,15,2,1
13,471,471,76,76,0,1,0
25,476,476,17,3,14,2,1
39,483,483,121,43,78,4,3
7,494,494,49,8,41,2,1

14,100,100,5,5,0,1,0
29,119,119,5,5,0,1,0
20,125,125,7,1,6,3,2
12,140,140,1,1,0,1,0
9,145,145,8,2,6,3,2
4,151,151,4,4,0,1,0
5,174,174,3,3,0,1,0
7,181,181,4,1,3,2,1
17,200,200,29,6,23,2,1
1,207,207,22,10,12,4,3
8,234,234,17,3,14,3,2
31,237,237,19,19,0,1,0
11,244,244,1,1,0,1,0
36,247,247,22,22,0,1,0
34,258,258,7,2,5,2,1
23,261,261,23,23,0,1,0
27,269,269,15,15,0,1,0
6,296,296,4,4,0,1,0
32,307,307,27,27,0,1,0
19,308,308,48,38,10,3,2
18,308,308,24,24,0,1,0
15,318,318,50,26,24,3,2
25,332,332,20,11,9,4,3
21,345,345,2,2,0,1,0
2,357,357,29,29,0,1,0
28,363,363,66,66,0,1,0
16,384,384,127,98,29,2,1
26,395,395,46,25,21,4,3
10,408,408,40,40,0,1,0
0,410,410,48,13,35,2,1
37,433,433,45,21,24,2,1
13,434,434,14,8,6,2,1
3,445,445,34,34,0,1,0
35,449,449,6,6,0,1,0
30,457,457,11,3,8,3,2
33,472,472,93,24,69,4,3
24,479,479,102,91,11,2,1
22,491,491,167,167,0,1,0

29,112,112,33,25,8,2,1
18,114,114,2,2,0,1,0
16,126,126,8,8,0,1,0
23,138,138,12,12,0,1,0
34,153,153,8,8,0,1,0
0,154,154,9,4,5,2,1
26,179,179,4,4,0,1,0
31,180,180,23,23,0,1,0
35,212,212,20,20,0,1,0
32,213,213,64,64,0,1,0
8,217,217,13,13,0,1,0
7,223,223,10,1,9,4,3
5,233,233,19,19,0,1,0
20,264,264,27,19,8,3,2
12,265,265,14,14,0,1,0
9,278,278,81,81,0,1,0
19,282,282,15,12,3,2,1
21,296,296,81,81,0,1,0
10,302,302,21,3,18,3,2
6,317,317,63,63,0,1,0
2,329,329,42,34,8,2,1
4,345,345,1,1,0,1,0
15,352,352,9,9,0,1,0
22,394,394,2,2,0,1,0
33,394,394,24,8,16,2,1
30,400,400,8,8,0,1,0
13,402,402,1,1,0,1,0
27,408,408,25,5,20,3,2
14,420,420,29,29,0,1,0
11,424,424,94,94,0,1,0
17,433,433,7,7,0,1,0
24,475,475,34,34,0,1,0
1,485,485,76,22,54,4,3
3,486,486,71,41,30,3,2
25,486,486,46,10,36,3,2
28,500,500,9,9,0,1,0

28,125,125,6,6,0,1,0
19,136,136,7,7,0,1,0
11,138,138,13,1,12,2,1
16,148,148,17,1,16,2,1
2,152,152,4,1,3,2,1
3,153,153,18,5,13,2,1
24,155,155,31,31,0,1,0
7,160,160,3,3,0,1,0
21,169,169,3,3,0,1,0
13,188,188,49,11,38,3,2
20,209,209,18,18,0,1,0
25,214,214,16,3,13,2,1
14,220,220,7,1,6,3,2
0,226,226,35,21,14,3,2
4,282,282,7,7,0,1,0
6,282,282,55,55,0,1,0
1,296,296,16,10,6,2,1
26,304,304,55,12,43,4,3
22,307,307,37,3,34,2,1
8,309,309,109,11,98,4,3
10,311,311,35,11,24,4,3
17,336,336,98,19,79,3,2
27,366,366,111,87,24,4,3
12,383,383,3,3,0,1,0
23,402,402,5,2,3,2,1
15,406,406,7,7,0,1,0
30,415,415,39,39,0,1,0
18,418,418,21,3,18,2,1
9,431,431,71,17,54,4,3
5,435,435,52,3,49,2,1
29,447,447,21,21,0,1,0

14,101,101,2,2,0,1,0
22,107,107,3,3,0,1,0
1,112,112,18,18,0,1,0
7,150,150,11,3,8,3,2
18,164,164,19,19,0,1,0
13,171,171,5,5,0,1,0
24,175,175,13,13,0,1,0
12,181,181,24,24,0,1,0
8,200,200,20,11,9,4,3
30,212,212,14,14,0,1,0
9,275,275,15,1,14,2,1
17,284,284,30,2,28,3,2
11,290,290,42,42,0,1,0
16,307,307,16,7,9,4,3
29,312,312,12,12,0,1,0
27,314,314,21,3,18,3,2
28,344,344,9,4,5,2,1
0,346,346,48,48,0,1,0
31,373,373,90,60,30,4,3
23,388,388,19,19,0,1,0
2,393,393,14,4,10,2,1
26,396,396,54,54,0,1,0
3,407,407,4,4,0,1,0
19,413,413,121,94,27,4,3
20,416,416,3,3,0,1,0
5,420,420,82,20,62,3,2
6,427,427,49,10,39,2,1
10,447,447,9,9,0,1,0
21,448,448,87,11,76,3,2
4,465,465,221,174,47,2,1
15,469,469,54,54,0,1,0
25,492,492,58,58,0,1,0

3,107,107,6,6,0,1,0
1,119,119,44,44,0,1,0
7,161,161,17,17,0,1,0
4,168,168,14,7,7,2,1
22,168,168,9,5,4,2,1
26,187,187,3,3,0,1,0
23,208,208,40,8,32,3,2
24,214,214,7,7,0,1,0
10,216,216,37,4,33,3,2
5,235,235,3,3,0,1,0
13,245,245,2,2,0,1,0
11,249,249,52,52,0,1,0
8,251,251,103,41,62,3,2
15,282,282,24,24,0,1,0
16,298,298,97,97,0,1,0
14,303,303,2,2,0,1,0
9,328,328,76,76,0,1,0
0,341,341,5,2,3,2,1
6,360,360,45,45,0,1,0
12,381,381,134,100,34,3,2
17,395,395,5,5,0,1,0
19,396,396,4,4,0,1,0
20,434,434,24,17,7,2,1
21,436,436,14,14,0,1,0
25,436,436,66,9,57,4,3
2,470,470,138,104,34,2,1
18,478,478,11,11,0,1,0

5,110,110,27,19,8,3,2
26,140,140,40,40,0,1,0
16,170,170,7,7,0,1,0
13,171,171,2,2,0,1,0
18,189,189,4,1,3,2,1
29,195,195,10,10,0,1,0
2,223,223,13,13,0,1,0
1,248,248,132,128,4,2,1
19,248,248,20,6,14,2,1
23,267,267,8,2,6,3,2
3,284,284,17,6,11,2,1
9,288,288,16,16,0,1,0
0,294,294,16,16,0,1,0
6,299,299,20,20,0,1,0
11,310,310,35,20,15,4,3
12,334,334,25,4,21,4,3
10,341,341,10,10,0,1,0
21,357,357,137,122,15,4,3
27,364,364,89,44,45,2,1
8,366,366,115,83,32,2,1
24,382,382,1,1,0,1,0
28,397,397,5,2,3,2,1
4,427,427,3,3,0,1,0
17,441,441,36,36,0,1,0
20,444,444,89,40,49,2,1
25,449,449,63,48,15,2,1
22,469,469,60,60,0,1,0
15,471,471,5,5,0,1,0
7,481,481,43,15,28,2,1
14,497,497,7,2,5,2,1

2,101,101,8,8,0,1,0
15,107,107,3,3,0,1,0
24,113,113,3,3,0,1,0
21,125,125,7,7,0,1,0
19,134,134,4,1,3,2,1
14,136,136,24,24,0,1,0
13,140,140,13,13,0,1,0
20,151,151,10,10,0,1,0
30,173,173,36,25,11,2,1
10,178,178,13,3,10,3,2
11,183,183,2,2,0,1,0
33,183,183,27,9,18,4,3
3,203,203,9,9,0,1,0
16,204,204,1,1,0,1,0
17,215,215,50,50,0,1,0
8,257,257,23,23,0,1,0
25,262,262,10,4,6,3,2
35,273,273,107,26,81,4,3
4,280,280,1,1,0,1,0
1,290,290,26,26,0,1,0
23,297,297,28,14,14,3,2
34,301,301,7,7,0,1,0
28,306,306,31,17,14,2,1
36,349,349,2,2,0,1,0
6,350,350,45,45,0,1,0
9,357,357,54,54,0,1,0
26,375,375,7,7,0,1,0
31,394,394,73,49,24,2,1
32,397,397,31,17,14,2,1
18,428,428,74,74,0,1,0
5,429,429,33,8,25,2,1
27,450,450,95,17,78,3,2
7,457,457,31,31,0,1,0
22,458,458,10,4,6,3,2
12,467,467,47,32,15,4,3
0,477,477,25,8,17,2,1
29,493,493,31,31,0,1,0

19,104,104,26,26,0,1,0
14,105,105,2,2,0,1,0
16,123,123,3,3,0,1,0
3,163,163,6,6,0,1,0
22,167,167,2,2,0,1,0
1,182,182,34,34,0,1,0
15,207,207,19,19,0,1,0
31,210,210,1,1,0,1,0
13,211,211,6,6,0,1,0
34,223,223,11,6,5,2,1
25,230,230,23,11,12,3,2
9,233,233,116,116,0,1,0
8,243,243,12,12,0,1,0
7,247,247,18,4,14,3,2
28,253,253,14,14,0,1,0
17,274,274,26,10,16,4,3
10,280,280,11,1,10,3,2
11,328,328,12,2,10,3,2
21,331,331,18,18,0,1,0
27,335,335,95,95,0,1,0
18,349,349,57,11,46,3,2
20,361,361,2,2,0,1,0
32,376,376,44,18,26,3,2
6,394,394,13,13,0,1,0
5,400,400,56,56,0,1,0
0,401,401,2,2,0,1,0
4,418,418,49,20,29,2,1
2,432,432,24,6,18,4,3
26,435,435,117,107,10,2,1
30,436,436,20,20,0,1,0
12,448,448,4,4,0,1,0
29,452,452,23,23,0,1,0
35,469,469,4,4,0,1,0
24,470,470,63,23,40,3,2
23,495,495,76,76,0,1,0
33,497,497,70,70,0,1,0

19,116,116,2,2,0,1,0
29,117,117,2,2,0,1,0
18,127,127,1,1,0,1,0
9,128,128,2,2,0,1,0
21,132,132,28,8,20,3,2
10,139,139,26,26,0,1,0
16,139,139,12,12,0,1,0
6,143,143,27,27,0,1,0
15,166,166,3,3,0,1,0
2,186,186,19,19,0,1,0
13,198,198,21,21,0,1,0
20,213,213,30,30,0,1,0
3,218,218,4,1,3,2,1
33,227,227,5,5,0,1,0
17,237,237,9,9,0,1,0
14,239,239,30,10,20,3,2
12,265,265,5,5,0,1,0
22,276,276,11,11,0,1,0
32,279,279,20,1,19,2,1
28,294,294,23,14,9,4,3
31,303,303,4,4,0,1,0
24,308,308,79,37,42,4,3
1,308,308,57,19,38,3,2
0,334,334,56,56,0,1,0
11,341,341,58,58,0,1,0
35,365,365,85,85,0,1,0
25,375,375,75,75,0,1,0
23,384,384,77,17,60,4,3
36,384,384,23,23,0,1,0
30,386,386,19,7,12,2,1
8,391,391,26,10,16,2,1
7,399,399,26,9,17,2,1
27,400,400,16,11,5,2,1
5,430,430,23,13,10,2,1
4,459,459,32,32,0,1,0
26,478,478,36,36,0,1,0
34,494,494,12,12,0,1,0

31,107,107,4,4,0,1,0
8,113,113,55,55,0,1,0
32,121,121,39,3,36,2,1
26,137,137,5,5,0,1,0
17,155,155,29,29,0,1,0
0,166,166,30,30,0,1,0
28,167,167,6,2,4,2,1
12,170,170,16,16,0,1,0
1,208,208,14,2,12,2,1
3,221,221,1,1,0,1,0
13,232,232,1,1,0,1,0
29,240,240,50,20,30,2,1
27,245,245,39,27,12,3,2
25,262,262,6,6,0,1,0
23,273,273,8,8,0,1,0
10,295,295,21,21,0,1,0
7,328,328,38,12,26,2,1
21,348,348,39,10,29,2,1
4,359,359,25,1,24,4,3
15,361,361,36,4,32,3,2
9,391,391,27,27,0,1,0
20,394,394,17,9,8,3,2
19,399,399,25,7,18,4,3
6,408,408,19,14,5,2,1
30,411,411,51,5,46,3,2
2,412,412,30,30,0,1,0
16,444,444,1,1,0,1,0
18,461,461,86,12,74,3,2
22,483,483,1,1,0,1,0
24,483,483,77,61,16,3,2
11,487,487,28,28,0,1,0
5,492,492,24,6,18,2,1
14,496,496,106,79,27,2,1

12,117,117,6,6,0,1,0
25,123,123,21,5,16,3,2
19,126,126,2,2,0,1,0
1,132,132,69,42,27,2,1
13,151,151,3,3,0,1,0
20,200,200,8,8,0,1,0
28,215,215,17,17,0,1,0
5,224,224,11,4,7,2,1
7,237,237,38,38,0,1,0
0,249,249,20,20,0,1,0
26,260,260,3,3,0,1,0
24,266,266,17,9,8,3,2
2,272,272,17,2,15,2,1
15,288,288,39,10,29,2,1
8,296,296,6,3,3,2,1
27,297,297,33,1,32,2,1
10,297,297,89,57,32,2,1
23,318,318,16,5,11,2,1
9,347,347,1,1,0,1,0
14,361,361,42,42,0,1,0
17,386,386,17,5,12,3,2
4,396,396,56,11,45,2,1
6,433,433,38,25,13,2,1
16,448,448,153,96,57,4,3
22,449,449,20,20,0,1,0
11,484,484,39,39,0,1,0
3,485,485,94,94,0,1,0
21,492,492,123,123,0,1,0
18,493,493,90,72,18,3,2

22,120,120,6,6,0,1,0
28,139,139,12,4,8,2,1
10,161,161,10,6,4,2,1
13,165,165,6,3,3,2,1
33,178,178,41,41,0,1,0
24,191,191,20,20,0,1,0
23,194,194,11,5,6,2,1
31,203,203,39,13,26,2,1
27,217,217,58,35,23,2,1
12,228,228,1,1,0,1,0
25,254,254,42,42,0,1,0
18,254,254,2,2,0,1,0
17,261,261,8,8,0,1,0
21,278,278,1,1,0,1,0
30,279,279,49,49,0,1,0
5,283,283,1,1,0,1,0
15,287,287,16,16,0,1,0
20,289,289,17,17,0,1,0
32,292,292,14,14,0,1,0
29,295,295,10,10,0,1,0
9,306,306,37,1,36,3,2
16,308,308,1,1,0,1,0
1,345,345,14,14,0,1,0
14,349,349,137,113,24,4,3
3,353,353,25,25,0,1,0
6,361,361,13,13,0,1,0
26,363,363,5,5,0,1,0
11,372,372,85,66,19,2,1
34,380,380,28,16,12,2,1
4,392,392,10,10,0,1,0
0,396,396,61,26,35,2,1
7,415,415,56,38,18,4,3
8,442,442,10,7,3,2,1
19,467,467,79,79,0,1,0
2,494,494,138,138,0,1,0

6,100,100,14,14,0,1,0
29,107,107,11,3,8,2,1
23,112,112,16,6,10,2,1
17,127,127,23,2,21,2,1
26,129,129,1,1,0,1,0
14,169,169,10,6,4,2,1
25,184,184,8,1,7,2,1
7,190,190,2,2,0,1,0
5,195,195,1,1,0,1,0
9,227,227,86,22,64,4,3
0,241,241,69,69,0,1,0
13,257,257,39,4,35,4,3
28,259,259,16,6,10,2,1
2,268,268,28,13,15,3,2
31,277,277,20,8,12,3,2
8,283,283,15,1,14,2,1
27,302,302,17,6,11,2,1
3,350,350,32,16,16,2,1
30,363,363,40,34,6,3,2
21,374,374,7,7,0,1,0
12,387,387,11,11,0,1,0
11,390,390,30,1,29,2,1
24,397,397,8,8,0,1,0
1,417,417,90,36,54,3,2
20,424,424,21,12,9,2,1
10,441,441,9,9,0,1,0
22,449,449,39,36,3,2,1
4,452,452,33,33,0,1,0
32,467,467,25,4,21,4,3
16,475,475,36,36,0,1,0
18,479,479,27,15,12,2,1
19,485,485,288,279,9,2,1
15,498,498,3,3,0,1,0

17,108,108,28,6,22,3,2
20,124,124,8,5,3,2,1
0,138,138,2,2,0,1,0
31,148,148,21,21,0,1,0
15,148,148,1,1,0,1,0
6,151,151,32,32,0,1,0
26,151,151,9,9,0,1,0
8,173,173,9,2,7,2,1
2,178,178,51,27,24,4,3
18,217,217,14,5,9,2,1
4,219,219,28,28,0,1,0
9,231,231,15,10,5,2,1
29,232,232,5,5,0,1,0
28,250,250,27,2,25,4,3
24,266,266,8,8,0,1,0
22,266,266,10,10,0,1,0
25,286,286,7,7,0,1,0
19,292,292,21,21,0,1,0
21,295,295,6,6,0,1,0
13,300,300,71,31,40,3,2
5,307,307,44,12,32,2,1
14,309,309,46,46,0,1,0
7,340,340,5,5,0,1,0
23,374,374,141,39,102,4,3
30,375,375,121,81,40,3,2
10,398,398,37,37,0,1,0
11,423,423,79,16,63,4,3
12,433,433,1,1,0,1,0
27,434,434,11,4,7,2,1
16,463,463,47,39,8,3,2
3,480,480,52,25,27,3,2
1,480,480,5,5,0,1,0

20,111,111,5,1,4,2,1
42,113,113,4,4,0,1,0
31,125,125,9,9,0,1,0
25,126,126,6,6,0,1,0
7,128,128,1,1,0,1,0
14,133,133,43,43,0,1,0
39,147,147,9,9,0,1,0
4,153,153,3,3,0,1,0
26,155,155,2,2,0,1,0
30,156,156,1,1,0,1,0
38,172,172,36,23,13,2,1
29,174,174,5,5,0,1,0
17,178,178,1,1,0,1,0
8,186,186,9,1,8,2,1
13,193,193,2,2,0,1,0
24,200,200,5,5,0,1,0
19,202,202,5,2,3,2,1
45,210,210,3,3,0,1,0
40,223,223,1,1,0,1,0
22,228,228,1,1,0,1,0
12,243,243,16,7,9,2,1
1,248,248,4,1,3,2,1
5,276,276,1,1,0,1,0
9,278,278,45,40,5,2,1
3,288,288,87,87,0,1,0
32,288,288,40,40,0,1,0
35,288,288,24,7,17,2,1
0,319,319,1,1,0,1,0
47,326,326,67,8,59,4,3
2,330,330,18,7,11,2,1
6,338,338,1,1,0,1,0
27,341,341,1,1,0,1,0
15,372,372,29,29,0,1,0
46,386,386,60,60,0,1,0
23,386,386,33,2,31,2,1
28,388,388,31,1,30,3,2
43,390,390,19,19,0,1,0
37,396,396,111,84,27,4,3
41,405,405,2,2,0,1,0
16,412,412,25,13,12,2,1
11,422,422,3,3,0,1,0
10,431,431,10,1,9,2,1
18,442,442,38,38,0,1,0
34,448,448,2,2,0,1,0
33,470,470,32,5,27,4,3
36,479,479,23,6,17,2,1
21,483,483,28,25,3,2,1
44,487,487,148,121,27,4,3

10,112,112,6,6,0,1,0
13,124,124,24,24,0,1,0
27,128,128,3,3,0,1,0
31,139,139,8,2,6,2,1
4,149,149,17,17,0,1,0
24,152,152,5,1,4,2,1
19,179,179,56,56,0,1,0
34,209,209,57,57,0,1,0
16,215,215,7,1,6,2,1
33,215,215,25,25,0,1,0
23,216,216,36,5,31,4,3
2,236,236,2,2,0,1,0
22,240,240,7,7,0,1,0
5,245,245,28,4,24,4,3
8,248,248,1,1,0,1,0
7,264,264,10,10,0,1,0
6,275,275,23,23,0,1,0
26,302,302,13,1,12,4,3
18,323,323,20,20,0,1,0
25,337,337,4,1,3,2,1
30,345,345,76,76,0,1,0
3,351,351,31,31,0,1,0
1,355,355,36,36,0,1,0
21,357,357,47,27,20,2,1
14,361,361,87,87,0,1,0
35,362,362,96,60,36,4,3
29,369,369,26,22,4,2,1
20,384,384,1,1,0,1,0
9,390,390,19,19,0,1,0
28,390,390,14,14,0,1,0
36,391,391,67,67,0,1,0
12,393,393,8,8,0,1,0
15,470,470,40,40,0,1,0
11,470,470,6,6,0,1,0
17,480,480,6,2,4,2,1
0,491,491,38,38,0,1,0
32,494,494,43,30,13,2,1

6,109,109,12,4,8,3,2
22,114,114,7,7,0,1,0
5,126,126,7,7,0,1,0
23,128,128,6,6,0,1,0
9,136,136,1,1,0,1,0
10,152,152,40,24,16,2,1
4,173,173,17,9,8,2,1
20,186,186,51,51,0,1,0
18,198,198,15,6,9,4,3
32,203,203,15,4,11,2,1
13,204,204,15,15,0,1,0
12,209,209,32,32,0,1,0
14,214,214,17,17,0,1,0
1,241,241,43,25,18,2,1
2,245,245,58,21,37,2,1
31,247,247,41,32,9,4,3
29,272,272,56,56,0,1,0
17,284,284,1,1,0,1,0
26,322,322,21,12,9,4,3
16,346,346,69,18,51,4,3
19,361,361,38,2,36,3,2
8,399,399,26,26,0,1,0
7,417,417,61,34,27,3,2
28,420,420,15,15,0,1,0
24,422,422,13,8,5,2,1
3,427,427,2,2,0,1,0
11,433,433,15,15,0,1,0
21,436,436,84,43,41,2,1
30,492,492,4,1,3,2,1
0,494,494,13,4,9,4,3
27,497,497,83,83,0,1,0
25,498,498,13,13,0,1,0
15,500,500,84,84,0,1,0

13,110,110,16,11,5,2,1
0,112,112,1,1,0,1,0
24,121,121,37,29,8,3,2
1,131,131,1,1,0,1,0
28,134,134,36,18,18,4,3
31,135,135,40,40,0,1,0
20,156,156,19,19,0,1,0
3,161,161,22,13,9,3,2
6,171,171,5,5,0,1,0
2,190,190,22,14,8,2,1
17,209,209,1,1,0,1,0
5,211,211,26,26,0,1,0
12,218,218,23,11,12,4,3
14,238,238,1,1,0,1,0
30,250,250,19,19,0,1,0
26,261,261,3,3,0,1,0
22,281,281,11,11,0,1,0
34,296,296,11,11,0,1,0
21,311,311,83,36,47,2,1
23,316,316,13,13,0,1,0
29,329,329,9,4,5,2,1
4,342,342,61,46,15,4,3
18,358,358,1,1,0,1,0
9,366,366,33,21,12,3,2
8,376,376,157,107,50,2,1
32,378,378,22,22,0,1,0
7,398,398,75,43,32,3,2
19,404,404,4,4,0,1,0
10,406,406,3,3,0,1,0
16,410,410,17,17,0,1,0
15,415,415,23,23,0,1,0
27,420,420,4,1,3,2,1
33,431,431,37,32,5,2,1
25,462,462,34,34,0,1,0
11,490,490,20,8,12,2,1

15,119,119,1,1,0,1,0
5,150,150,14,8,6,3,2
14,173,173,29,23,6,3,2
21,175,175,80,80,0,1,0
0,193,193,1,1,0,1,0
17,194,194,10,10,0,1,0
34,202,202,2,2,0,1,0
25,236,236,26,26,0,1,0
8,238,238,10,10,0,1,0
22,238,238,7,7,0,1,0
19,243,243,20,20,0,1,0
7,273,273,16,4,12,3,2
1,273,273,60,60,0,1,0
20,281,281,13,13,0,1,0
26,304,304,44,39,5,2,1
24,305,305,27,22,5,2,1
36,323,323,47,47,0,1,0
33,332,332,19,13,6,3,2
16,336,336,5,5,0,1,0
2,340,340,60,60,0,1,0
4,347,347,39,39,0,1,0
27,350,350,14,14,0,1,0
11,350,350,37,37,0,1,0
35,352,352,21,21,0,1,0
31,358,358,46,46,0,1,0
9,369,369,17,6,11,2,1
12,376,376,36,8,28,4,3
13,423,423,34,24,10,3,2
3,430,430,24,24,0,1,0
28,442,442,7,7,0,1,0
29,453,453,37,13,24,2,1
30,462,462,105,54,51,4,3
18,467,467,8,2,6,3,2
6,476,476,37,18,19,2,1
32,477,477,14,9,5,2,1
23,483,483,30,30,0,1,0
10,489,489,93,28,65,4,3

22,102,102,2,2,0,1,0
23,111,111,7,1,6,3,2
9,117,117,5,5,0,1,0
8,140,140,18,5,13,3,2
12,141,141,25,25,0,1,0
24,149,149,9,3,6,3,2
37,152,152,10,10,0,1,0
18,152,152,1,1,0,1,0
4,159,159,3,3,0,1,0
17,162,162,14,14,0,1,0
11,183,183,7,7,0,1,0
36,184,184,1,1,0,1,0
21,196,196,6,1,5,2,1
15,212,212,2,2,0,1,0
29,269,269,16,16,0,1,0
26,270,270,65,23,42,4,3
30,272,272,59,21,38,2,1
13,277,277,24,24,0,1,0
1,279,279,5,5,0,1,0
14,284,284,6,6,0,1,0
7,298,298,16,10,6,3,2
25,300,300,36,36,0,1,0
28,301,301,15,15,0,1,0
40,305,305,70,25,45,4,3
6,320,320,29,2,27,4,3
38,322,322,66,66,0,1,0
10,328,328,70,51,19,2,1
35,334,334,60,53,7,2,1
41,335,335,33,11,22,2,1
33,340,340,2,2,0,1,0
27,353,353,6,6,0,1,0
42,383,383,15,7,8,3,2
0,389,389,2,2,0,1,0
39,394,394,10,10,0,1,0
31,420,420,15,2,13,2,1
3,429,429,30,30,0,1,0
16,432,432,13,13,0,1,0
34,451,451,24,5,19,2,1
19,455,455,23,23,0,1,0
32,459,459,94,94,0,1,0
5,474,474,52,22,30,2,1
20,479,479,14,14,0,1,0
2,496,496,60,60,0,1,0

18,124,124,43,7,36,2,1
6,126,126,72,72,0,1,0
2,138,138,1,1,0,1,0
8,153,153,5,2,3,2,1
16,159,159,1,1,0,1,0
12,184,184,14,14,0,1,0
20,191,191,1,1,0,1,0
15,204,204,25,1,24,4,3
22,206,206,31,31,0,1,0
14,214,214,41,26,15,2,1
21,241,241,3,3,0,1,0
0,259,259,137,128,9,4,3
23,267,267,58,58,0,1,0
10,272,272,4,4,0,1,0
5,280,280,11,11,0,1,0
9,313,313,27,27,0,1,0
7,314,314,19,19,0,1,0
3,347,347,16,7,9,2,1
19,385,385,95,95,0,1,0
17,391,391,13,13,0,1,0
13,402,402,10,2,8,2,1
11,410,410,46,3,43,4,3
1,440,440,151,31,120,4,3
4,480,480,81,60,21,2,1

15,105,105,13,13,0,1,0
25,118,118,13,13,0,1,0
23,125,125,17,5,12,4,3
7,134,134,10,2,8,3,2
12,150,150,5,1,4,2,1
2,156,156,7,4,3,2,1
10,164,164,20,20,0,1,0
0,169,169,2,2,0,1,0
1,193,193,16,16,0,1,0
35,195,195,23,8,15,4,3
31,216,216,4,4,0,1,0
21,230,230,22,22,0,1,0
18,267,267,48,20,28,4,3
24,274,274,10,4,6,3,2
4,281,281,12,12,0,1,0
22,311,311,27,27,0,1,0
3,318,318,5,1,4,2,1
32,318,318,12,12,0,1,0
30,349,349,81,81,0,1,0
11,349,349,25,25,0,1,0
34,351,351,19,19,0,1,0
13,359,359,143,23,120,4,3
19,368,368,6,6,0,1,0
14,373,373,5,1,4,2,1
9,374,374,21,21,0,1,0
5,384,384,33,20,13,2,1
20,384,384,1,1,0,1,0
16,408,408,91,91,0,1,0
28,419,419,36,26,10,2,1
29,439,439,63,63,0,1,0
26,445,445,149,149,0,1,0
17,457,457,4,4,0,1,0
27,467,467,88,55,33,2,1
6,468,468,9,9,0,1,0
33,488,488,16,16,0,1,0
8,493,493,46,46,0,1,0

32,101,101,39,39,0,1,0
16,105,105,7,4,3,2,1
23,113,113,28,8,20,2,1
28,114,114,4,4,0,1,0
24,120,120,23,5,18,3,2
37,122,122,3,3,0,1,0
1,159,159,6,2,4,2,1
27,165,165,6,6,0,1,0
18,165,165,12,1,11,2,1
22,170,170,7,7,0,1,0
6,171,171,15,15,0,1,0
25,184,184,1,1,0,1,0
30,187,187,30,30,0,1,0
9,189,189,3,3,0,1,0
7,193,193,16,7,9,2,1
38,198,198,3,3,0,1,0
34,214,214,42,42,0,1,0
5,227,227,4,4,0,1,0
26,249,249,11,11,0,1,0
13,260,260,9,5,4,2,1
36,263,263,3,3,0,1,0
19,270,270,6,6,0,1,0
20,271,271,14,14,0,1,0
29,302,302,29,3,26,3,2
10,330,330,21,21,0,1,0
33,331,331,41,27,14,2,1
12,347,347,12,4,8,3,2
21,348,348,33,14,19,3,2
3,348,348,37,37,0,1,0
8,370,370,3,3,0,1,0
4,370,370,40,18,22,4,3
17,372,372,10,2,8,3,2
2,378,378,31,31,0,1,0
35,395,395,10,10,0,1,0
39,400,400,28,28,0,1,0
14,409,409,70,31,39,2,1
15,420,420,1,1,0,1,0
0,459,459,136,40,96,4,3
31,478,478,34,14,20,2,1
11,486,486,85,27,58,4,3

3,106,106,4,4,0,1,0
30,126,126,26,5,21,4,3
25,134,134,36,8,28,4,3
2,136,136,5,5,0,1,0
24,145,145,21,1,20,4,3
35,150,150,13,13,0,1,0
27,164,164,25,1,24,4,3
29,181,181,5,5,0,1,0
22,208,208,16,16,0,1,0
10,238,238,10,2,8,2,1
15,243,243,63,63,0,1,0
5,243,243,39,7,32,2,1
20,288,288,3,3,0,1,0
1,307,307,58,58,0,1,0
14,313,313,2,2,0,1,0
31,349,349,45,45,0,1,0
6,357,357,3,3,0,1,0
21,361,361,6,6,0,1,0
11,362,362,110,37,73,3,2
12,368,368,1,1,0,1,0
18,375,375,61,61,0,1,0
9,382,382,11,2,9,4,3
13,383,383,27,27,0,1,0
19,385,385,31,31,0,1,0
33,396,396,15,9,6,2,1
4,396,396,2,2,0,1,0
17,402,402,119,92,27,4,3
8,404,404,22,22,0,1,0
7,433,433,12,12,0,1,0
28,454,454,37,37,0,1,0
26,461,461,56,24,32,2,1
23,465,465,7,7,0,1,0
32,476,476,109,109,0,1,0
0,480,480,3,3,0,1,0
16,489,489,1,1,0,1,0
34,496,496,22,22,0,1,0

19,116,116,4,4,0,1,0
0,124,124,4,4,0,1,0
26,124,124,3,3,0,1,0
28,144,144,2,2,0,1,0
24,183,183,3,3,0,1,0
36,190,190,1,1,0,1,0
35,231,231,26,26,0,1,0
23,233,233,25,25,0,1,0
20,246,246,15,15,0,1,0
4,262,262,19,10,9,4,3
21,267,267,38,21,17,3,2
3,267,267,10,10,0,1,0
12,268,268,16,2,14,3,2
10,271,271,34,21,13,2,1
11,273,273,4,4,0,1,0
38,275,275,3,3,0,1,0
34,292,292,42,15,27,4,3
13,307,307,4,4,0,1,0
15,315,315,4,4,0,1,0
29,318,318,52,10,42,2,1
1,324,324,45,45,0,1,0
16,329,329,25,13,12,3,2
9,373,373,84,39,45,2,1
27,382,382,103,80,23,2,1
33,384,384,20,20,0,1,0
32,396,396,13,5,8,2,1
17,419,419,1,1,0,1,0
22,420,420,1,1,0,1,0
5,432,432,48,39,9,2,1
6,433,433,26,15,11,2,1
39,437,437,260,228,32,3,2
30,440,440,31,2,29,2,1
7,443,443,52,27,25,2,1
14,445,445,46,41,5,2,1
8,454,454,16,2,14,3,2
25,457,457,20,20,0,1,0
37,462,462,2,2,0,1,0
18,475,475,64,64,0,1,0
31,479,479,29,5,24,4,3
2,495,495,44,31,13,2,1

19,102,102,18,8,10,3,2
18,177,177,13,10,3,2,1
8,184,184,14,14,0,1,0
4,190,190,10,10,0,1,0
22,205,205,8,5,3,2,1
7,206,206,30,30,0,1,0
27,227,227,31,31,0,1,0
29,236,236,1,1,0,1,0
15,249,249,41,41,0,1,0
2,249,249,37,37,0,1,0
6,250,250,10,10,0,1,0
24,274,274,29,29,0,1,0
17,274,274,8,1,7,2,1
3,279,279,13,1,12,4,3
9,280,280,2,2,0,1,0
11,283,283,6,3,3,2,1
5,293,293,1,1,0,1,0
21,323,323,43,39,4,2,1
12,328,328,16,10,6,3,2
10,331,331,129,117,12,4,3
28,368,368,106,85,21,4,3
13,373,373,4,4,0,1,0
20,380,380,38,19,19,2,1
23,389,389,41,41,0,1,0
25,393,393,19,1,18,3,2
1,443,443,274,142,132,4,3
30,448,448,19,8,11,2,1
0,465,465,43,43,0,1,0
16,478,478,17,5,12,3,2
26,480,480,8,8,0,1,0
14,495,495,115,100,15,2,1

21,107,107,52,12,40,4,3
29,111,111,13,13,0,1,0
14,131,131,14,10,4,2,1
24,139,139,6,1,5,2,1
23,145,145,7,7,0,1,0
7,165,165,6,3,3,2,1
1,191,191,15,15,0,1,0
15,198,198,49,8,41,2,1
2,214,214,4,4,0,1,0
0,222,222,28,19,9,4,3
6,248,248,30,30,0,1,0
11,249,249,36,36,0,1,0
18,260,260,1,1,0,1,0
27,264,264,1,1,0,1,0
10,274,274,4,4,0,1,0
31,289,289,44,44,0,1,0
13,301,301,16,16,0,1,0
17,317,317,12,12,0,1,0
3,334,334,62,8,54,3,2
22,341,341,25,5,20,3,2
9,343,343,18,18,0,1,0
26,370,370,7,7,0,1,0
16,375,375,5,5,0,1,0
28,414,414,14,14,0,1,0
8,434,434,84,46,38,4,3
5,442,442,86,59,27,4,3
32,450,450,45,45,0,1,0
19,463,463,26,23,3,2,1
25,463,463,54,10,44,3,2
12,473,473,50,50,0,1,0
4,479,479,12,12,0,1,0
30,481,481,112,22,90,3,2
20,485,485,95,27,68,3,2

23,103,103,11,3,8,3,2
27,115,115,15,3,12,2,1
17,126,126,10,10,0,1,0
36,133,133,8,8,0,1,0
9,144,144,13,3,10,3,2
29,151,151,21,14,7,2,1
10,166,166,1,1,0,1,0
0,171,171,1,1,0,1,0
14,174,174,8,8,0,1,0
30,179,179,26,16,10,3,2
3,187,187,4,1,3,2,1
2,204,204,44,44,0,1,0
6,221,221,2,2,0,1,0
25,222,222,16,16,0,1,0
26,232,232,3,3,0,1,0
19,238,238,42,42,0,1,0
8,273,273,11,2,9,3,2
34,276,276,19,7,12,4,3
20,302,302,54,54,0,1,0
11,306,306,40,36,4,2,1
16,319,319,1,1,0,1,0
13,344,344,13,2,11,2,1
15,351,351,8,3,5,2,1
33,358,358,26,4,22,2,1
35,393,393,16,16,0,1,0
5,398,398,30,14,16,3,2
21,401,401,13,7,6,3,2
28,401,401,65,34,31,2,1
1,411,411,50,50,0,1,0
22,416,416,9,9,0,1,0
32,417,417,15,15,0,1,0
4,420,420,7,7,0,1,0
37,427,427,141,75,66,4,3
18,440,440,65,65,0,1,0
12,459,459,65,20,45,3,2
24,467,467,141,111,30,3,2
7,481,481,65,65,0,1,0
31,482,482,2,2,0,1,0

25,113,113,15,15,0,1,0
8,128,128,8,8,0,1,0
12,135,135,9,9,0,1,0
20,161,161,14,14,0,1,0
19,171,171,39,7,32,2,1
28,172,172,4,4,0,1,0
1,187,187,6,6,0,1,0
7,189,189,17,4,13,2,1
11,209,209,64,64,0,1,0
16,252,252,7,7,0,1,0
0,264,264,35,35,0,1,0
32,271,271,6,3,3,2,1
21,282,282,59,17,42,3,2
15,294,294,21,21,0,1,0
29,302,302,22,22,0,1,0
17,315,315,9,9,0,1,0
13,320,320,23,23,0,1,0
27,333,333,15,6,9,2,1
6,338,338,5,5,0,1,0
24,348,348,2,2,0,1,0
3,354,354,9,9,0,1,0
30,375,375,73,58,15,4,3
18,383,383,49,49,0,1,0
4,395,395,58,26,32,3,2
14,404,404,1,1,0,1,0
23,414,414,67,56,11,2,1
31,415,415,6,6,0,1,0
26,441,441,44,44,0,1,0
9,450,450,51,51,0,1,0
2,460,460,12,12,0,1,0
5,480,480,76,72,4,2,1
22,488,488,122,106,16,3,2
10,497,497,189,76,113,4,3

25,120,120,17,17,0,1,0
23,127,127,18,18,0,1,0
3,148,148,24,8,16,2,1
22,162,162,4,1,3,2,1
1,166,166,16,2,14,3,2
16,169,169,16,16,0,1,0
19,175,175,8,2,6,2,1
21,178,178,2,2,0,1,0
31,185,185,11,7,4,2,1
10,191,191,36,36,0,1,0
7,200,200,24,24,0,1,0
13,208,208,11,11,0,1,0
5,216,216,33,33,0,1,0
27,222,222,26,26,0,1,0
12,240,240,3,3,0,1,0
28,242,242,2,2,0,1,0
11,282,282,32,10,22,4,3
8,295,295,17,5,12,3,2
17,302,302,11,11,0,1,0
9,317,317,43,11,32,3,2
20,319,319,4,4,0,1,0
26,334,334,67,7,60,3,2
6,334,334,72,30,42,4,3
32,344,344,94,39,55,4,3
29,373,373,18,10,8,3,2
30,398,398,77,35,42,2,1
0,399,399,12,5,7,2,1
18,442,442,33,24,9,2,1
14,450,450,78,24,54,3,2
24,457,457,110,110,0,1,0
2,468,468,2,2,0,1,0
4,482,482,6,6,0,1,0
33,491,491,47,47,0,1,0
15,492,492,41,41,0,1,0

11,104,104,15,2,13,2,1
32,112,112,16,16,0,1,0
27,145,145,10,5,5,2,1
6,164,164,5,5,0,1,0
5,169,169,37,37,0,1,0
24,170,170,9,9,0,1,0
4,175,175,11,11,0,1,0
15,181,181,2,2,0,1,0
28,189,189,48,18,30,4,3
7,197,197,14,14,0,1,0
0,216,216,84,84,0,1,0
9,222,222,53,7,46,3,2
21,224,224,48,48,0,1,0
16,225,225,9,6,3,2,1
29,248,248,4,1,3,2,1
17,261,261,64,64,0,1,0
26,264,264,7,7,0,1,0
31,274,274,4,4,0,1,0
20,284,284,42,42,0,1,0
10,293,293,19,5,14,3,2
22,310,310,5,5,0,1,0
2,340,340,21,5,16,3,2
23,344,344,3,3,0,1,0
30,369,369,60,24,36,4,3
18,399,399,69,69,0,1,0
1,409,409,33,13,20,2,1
19,452,452,37,37,0,1,0
12,466,466,7,4,3,2,1
8,470,470,34,34,0,1,0
14,483,483,38,38,0,1,0
13,484,484,42,42,0,1,0
25,486,486,37,37,0,1,0
3,487,487,38,38,0,1,0

1,107,107,10,6,4,2,1
11,123,123,1,1,0,1,0
4,128,128,1,1,0,1,0
32,134,134,11,11,0,1,0
17,143,143,14,14,0,1,0
38,149,149,18,18,0,1,0
12,150,150,13,13,0,1,0
19,159,159,10,10,0,1,0
33,166,166,21,13,8,3,2
34,180,180,16,8,8,2,1
39,189,189,32,23,9,4,3
22,189,189,12,12,0,1,0
23,222,222,11,2,9,2,1
36,227,227,8,8,0,1,0
2,241,241,1,1,0,1,0
18,283,283,15,3,12,2,1
13,292,292,15,12,3,2,1
40,308,308,24,24,0,1,0
31,325,325,4,1,3,2,1
14,326,326,10,5,5,2,1
7,334,334,37,28,9,2,1
24,340,340,42,42,0,1,0
6,364,364,27,27,0,1,0
20,364,364,27,10,17,4,3
28,366,366,33,28,5,2,1
26,375,375,43,4,39,2,1
9,379,379,152,80,72,3,2
29,395,395,152,50,102,4,3
0,416,416,2,2,0,1,0
16,425,425,48,48,0,1,0
25,425,425,21,21,0,1,0
35,439,439,49,49,0,1,0
30,459,459,27,27,0,1,0
10,471,471,10,4,6,2,1
21,478,478,4,4,0,1,0
5,480,480,1,1,0,1,0
3,482,482,28,28,0,1,0
15,483,483,31,28,3,2,1
27,493,493,2,2,0,1,0
41,495,495,46,1,45,2,1
8,496,496,19,2,17,2,1
37,500,500,58,58,0,1,0

19,125,125,9,9,0,1,0
28,132,132,11,11,0,1,0
8,161,161,1,1,0,1,0
27,163,163,58,13,45,2,1
1,166,166,26,6,20,3,2
20,169,169,17,17,0,1,0
3,171,171,3,3,0,1,0
4,173,173,24,3,21,2,1
2,182,182,19,19,0,1,0
15,187,187,4,4,0,1,0
34,203,203,32,1,31,4,3
14,241,241,1,1,0,1,0
16,274,274,1,1,0,1,0
30,277,277,66,66,0,1,0
29,292,292,18,13,5,2,1
31,308,308,8,8,0,1,0
18,319,319,91,22,69,4,3
37,327,327,34,1,33,3,2
22,350,350,24,7,17,2,1
13,353,353,21,5,16,3,2
23,353,353,3,3,0,1,0
17,366,366,41,25,16,2,1
33,367,367,11,11,0,1,0
25,369,369,9,3,6,2,1
12,376,376,40,7,33,2,1
5,377,377,30,30,0,1,0
26,399,399,55,39,16,3,2
7,407,407,84,32,52,4,3
24,410,410,81,63,18,2,1
11,411,411,13,10,3,2,1
10,411,411,20,8,12,4,3
32,414,414,66,36,30,3,2
0,420,420,3,3,0,1,0
21,433,433,14,8,6,3,2
6,454,454,55,13,42,2,1
9,463,463,9,9,0,1,0
36,484,484,15,5,10,2,1
35,494,494,7,7,0,1,0

5,120,120,2,2,0,1,0
28,129,129,1,1,0,1,0
25,129,129,13,3,10,3,2
10,134,134,1,1,0,1,0
40,141,141,11,11,0,1,0
17,145,145,1,1,0,1,0
39,159,159,8,8,0,1,0
20,163,163,3,3,0,1,0
30,186,186,24,24,0,1,0
14,198,198,2,2,0,1,0
22,201,201,17,17,0,1,0
27,203,203,14,14,0,1,0
24,211,211,6,3,3,2,1
6,242,242,9,9,0,1,0
33,268,268,2,2,0,1,0
0,269,269,116,106,10,3,2
37,271,271,5,2,3,2,1
4,273,273,24,10,14,3,2
19,277,277,27,27,0,1,0
32,294,294,5,2,3,2,1
21,295,295,47,29,18,4,3
36,297,297,94,54,40,2,1
9,319,319,33,33,0,1,0
29,331,331,110,70,40,3,2
31,340,340,10,2,8,2,1
35,345,345,73,73,0,1,0
26,351,351,58,58,0,1,0
11,372,372,4,4,0,1,0
13,373,373,13,13,0,1,0
41,385,385,1,1,0,1,0
15,392,392,3,3,0,1,0
3,401,401,49,49,0,1,0
34,401,401,1,1,0,1,0
2,403,403,3,3,0,1,0
23,405,405,88,84,4,2,1
7,407,407,19,1,18,3,2
16,420,420,3,3,0,1,0
1,444,444,40,40,0,1,0
18,457,457,15,1,14,3,2
8,465,465,15,15,0,1,0
12,490,490,2,2,0,1,0
38,491,491,101,101,0,1,0

20,112,112,15,15,0,1,0
33,112,112,2,2,0,1,0
16,115,115,7,7,0,1,0
38,134,134,10,10,0,1,0
10,152,152,20,20,0,1,0
7,155,155,1,1,0,1,0
13,168,168,25,25,0,1,0
0,172,172,11,3,8,3,2
35,196,196,13,8,5,2,1
6,224,224,13,13,0,1,0
26,228,228,3,3,0,1,0
17,278,278,35,35,0,1,0
27,293,293,7,1,6,2,1
14,295,295,4,4,0,1,0
25,305,305,35,35,0,1,0
34,319,319,49,49,0,1,0
9,319,319,2,2,0,1,0
1,327,327,19,19,0,1,0
8,328,328,17,17,0,1,0
18,347,347,44,44,0,1,0
15,351,351,7,1,6,2,1
23,358,358,36,36,0,1,0
11,374,374,23,5,18,2,1
28,378,378,114,114,0,1,0
30,391,391,94,48,46,2,1
3,410,410,1,1,0,1,0
22,413,413,28,6,22,3,2
19,416,416,50,50,0,1,0
4,434,434,10,4,6,2,1
29,435,435,26,26,0,1,0
39,437,437,5,5,0,1,0
32,445,445,6,1,5,2,1
36,446,446,59,24,35,4,3
40,460,460,86,70,16,2,1
12,464,464,28,10,18,4,3
21,471,471,55,55,0,1,0
24,485,485,135,135,0,1,0
37,488,488,5,2,3,2,1
5,489,489,49,49,0,1,0
31,498,498,14,11,3,2,1
2,498,498,21,7,14,3,2

31,100,100,2,2,0,1,0
23,107,107,12,12,0,1,0
18,120,120,16,16,0,1,0
20,125,125,2,2,0,1,0
8,128,128,2,2,0,1,0
25,146,146,5,5,0,1,0
19,152,152,28,28,0,1,0
11,205,205,15,8,7,2,1
4,218,218,27,27,0,1,0
1,221,221,35,35,0,1,0
10,224,224,5,5,0,1,0
16,242,242,69,69,0,1,0
26,256,256,26,26,0,1,0
13,276,276,39,15,24,3,2
29,278,278,18,18,0,1,0
22,285,285,43,17,26,4,3
5,309,309,18,7,11,2,1
2,309,309,36,3,33,2,1
27,318,318,33,21,12,2,1
17,320,320,51,35,16,2,1
28,355,355,11,5,6,2,1
3,357,357,64,64,0,1,0
24,411,411,4,4,0,1,0
30,416,416,32,17,15,4,3
0,420,420,46,15,31,2,1
6,424,424,107,104,3,2,1
14,434,434,55,55,0,1,0
9,454,454,40,40,0,1,0
21,475,475,95,33,62,3,2
15,478,478,30,14,16,3,2
12,494,494,106,23,83,4,3
7,498,498,11,11,0,1,0

30,107,107,4,1,3,2,1
14,113,113,26,10,16,2,1
11,117,117,17,17,0,1,0
25,119,119,30,2,28,3,2
4,166,166,12,12,0,1,0
20,167,167,11,11,0,1,0
0,168,168,5,5,0,1,0
2,186,186,26,26,0,1,0
16,190,190,10,1,9,4,3
1,191,191,24,24,0,1,0
5,198,198,38,38,0,1,0
21,212,212,24,7,17,4,3
24,215,215,15,15,0,1,0
13,219,219,4,4,0,1,0
27,236,236,9,9,0,1,0
6,255,255,12,12,0,1,0
26,265,265,92,49,43,2,1
17,273,273,9,9,0,1,0
7,274,274,14,14,0,1,0
22,279,279,9,9,0,1,0
15,283,283,19,4,15,4,3
12,302,302,71,15,56,3,2
29,334,334,27,27,0,1,0
31,387,387,58,16,42,3,2
8,394,394,40,40,0,1,0
18,395,395,49,37,12,3,2
23,396,396,70,31,39,3,2
28,417,417,36,36,0,1,0
3,428,428,54,26,28,3,2
9,465,465,2,2,0,1,0
19,480,480,3,3,0,1,0
10,496,496,93,77,16,3,2

17,109,109,5,5,0,1,0
4,118,118,9,1,8,3,2
7,124,124,24,7,17,4,3
32,124,124,27,27,0,1,0
31,139,139,53,16,37,4,3
20,144,144,22,9,13,2,1
23,149,149,24,18,6,2,1
2,156,156,28,28,0,1,0
10,166,166,9,9,0,1,0
27,179,179,1,1,0,1,0
22,210,210,22,22,0,1,0
1,212,212,35,1,34,2,1
18,213,213,60,31,29,2,1
25,220,220,3,3,0,1,0
9,228,228,10,10,0,1,0
6,230,230,16,16,0,1,0
5,241,241,43,43,0,1,0
16,265,265,37,24,13,2,1
8,289,289,68,10,58,4,3
28,291,291,27,3,24,4,3
12,307,307,26,4,22,2,1
26,312,312,4,4,0,1,0
13,329,329,4,4,0,1,0
33,333,333,1,1,0,1,0
14,349,349,10,10,0,1,0
30,381,381,16,16,0,1,0
15,392,392,15,15,0,1,0
29,406,406,2,2,0,1,0
0,432,432,1,1,0,1,0
3,465,465,72,60,12,3,2
19,471,471,56,56,0,1,0
24,485,485,31,4,27,3,2
11,494,494,23,14,9,4,3
21,500,500,19,5,14,3,2

14,102,102,19,1,18,3,2
12,103,103,13,13,0,1,0
10,144,144,7,7,0,1,0
2,152,152,22,16,6,2,1
5,191,191,97,94,3,2,1
8,206,206,19,19,0,1,0
0,221,221,8,1,7,2,1
1,222,222,8,3,5,2,1
17,222,222,31,31,0,1,0
20,238,238,45,3,42,4,3
15,247,247,3,3,0,1,0
29,254,254,48,48,0,1,0
13,264,264,5,5,0,1,0
11,289,289,10,10,0,1,0
7,313,313,32,32,0,1,0
25,389,389,147,45,102,4,3
24,394,394,39,39,0,1,0
16,399,399,10,5,5,2,1
28,401,401,1,1,0,1,0
26,404,404,19,19,0,1,0
6,416,416,28,10,18,3,2
9,420,420,31,24,7,2,1
3,431,431,47,18,29,4,3
23,432,432,53,20,33,4,3
18,436,436,28,9,19,2,1
19,442,442,48,15,33,2,1
27,445,445,3,3,0,1,0
4,454,454,146,146,0,1,0
21,493,493,52,47,5,2,1
22,496,496,15,3,12,3,2

10,110,110,1,1,0,1,0
3,113,113,5,1,4,2,1
15,123,123,1,1,0,1,0
6,123,123,1,1,0,1,0
14,127,127,21,21,0,1,0
29,137,137,10,10,0,1,0
8,149,149,5,5,0,1,0
32,162,162,7,3,4,2,1
17,174,174,4,4,0,1,0
7,179,179,8,2,6,2,1
9,190,190,38,38,0,1,0
26,195,195,7,7,0,1,0
31,207,207,15,15,0,1,0
4,209,209,17,17,0,1,0
24,212,212,40,28,12,3,2
18,213,213,35,16,19,2,1
21,227,227,14,14,0,1,0
20,246,246,9,9,0,1,0
1,248,248,40,23,17,2,1
16,249,249,38,38,0,1,0
22,252,252,90,40,50,2,1
33,254,254,76,32,44,2,1
2,273,273,88,25,63,4,3
30,290,290,44,44,0,1,0
0,313,313,22,22,0,1,0
12,336,336,18,18,0,1,0
34,338,338,4,4,0,1,0
23,354,354,37,37,0,1,0
19,388,388,16,16,0,1,0
11,388,388,20,20,0,1,0
25,397,397,32,32,0,1,0
27,403,403,2,2,0,1,0
28,421,421,4,1,3,2,1
13,439,439,63,17,46,3,2
5,451,451,60,48,12,4,3

15,104,104,19,19,0,1,0
20,106,106,16,2,14,3,2
8,114,114,6,6,0,1,0
1,155,155,10,10,0,1,0
13,161,161,18,18,0,1,0
21,167,167,4,4,0,1,0
0,172,172,17,3,14,2,1
23,177,177,28,28,0,1,0
6,209,209,14,6,8,2,1
11,230,230,38,2,36,3,2
4,250,250,13,13,0,1,0
14,264,264,38,38,0,1,0
24,272,272,15,1,14,3,2
31,285,285,67,36,31,2,1
3,289,289,23,23,0,1,0
16,295,295,11,2,9,2,1
2,311,311,41,5,36,2,1
12,321,321,3,3,0,1,0
18,346,346,38,7,31,2,1
5,349,349,24,24,0,1,0
9,356,356,13,13,0,1,0
28,377,377,2,2,0,1,0
7,379,379,144,144,0,1,0
29,387,387,9,1,8,3,2
30,407,407,7,7,0,1,0
17,418,418,81,14,67,4,3
19,418,418,21,9,12,3,2
32,419,419,90,45,45,4,3
25,446,446,34,34,0,1,0
10,463,463,30,30,0,1,0
27,473,473,39,39,0,1,0
22,488,488,105,96,9,2,1
26,495,495,43,13,30,2,1

32,104,104,8,8,0,1,0
1,139,139,3,3,0,1,0
11,140,140,3,3,0,1,0
2,141,141,18,18,0,1,0
18,141,141,6,6,0,1,0
5,142,142,9,9,0,1,0
16,149,149,9,2,7,2,1
29,152,152,8,2,6,3,2
27,158,158,36,8,28,2,1
20,164,164,5,2,3,2,1
14,183,183,20,20,0,1,0
17,192,192,25,5,20,2,1
10,194,194,13,4,9,2,1
24,203,203,45,13,32,2,1
31,240,240,2,2,0,1,0
33,257,257,6,6,0,1,0
15,259,259,50,50,0,1,0
26,295,295,48,6,42,2,1
7,299,299,6,6,0,1,0
21,305,305,39,39,0,1,0
13,316,316,1,1,0,1,0
6,329,329,36,36,0,1,0
0,333,333,27,27,0,1,0
8,342,342,35,35,0,1,0
28,343,343,44,44,0,1,0
34,352,352,47,39,8,2,1
23,367,367,42,37,5,2,1
4,374,374,22,11,11,2,1
3,385,385,142,57,85,4,3
22,401,401,37,9,28,2,1
19,425,425,24,15,9,2,1
30,432,432,31,13,18,3,2
12,434,434,12,2,10,3,2
9,466,466,65,38,27,2,1
25,494,494,78,78,0,1,0

19,101,101,11,8,3,2,1
6,109,109,8,8,0,1,0
1,110,110,20,20,0,1,0
4,169,169,1,1,0,1,0
30,173,173,19,19,0,1,0
12,200,200,1,1,0,1,0
22,233,233,8,8,0,1,0
27,239,239,16,16,0,1,0
18,254,254,40,8,32,3,2
10,267,267,15,15,0,1,0
21,268,268,76,60,16,2,1
17,290,290,19,11,8,2,1
0,293,293,2,2,0,1,0
28,296,296,1,1,0,1,0
2,315,315,29,2,27,4,3
13,315,315,31,31,0,1,0
25,319,319,39,26,13,2,1
29,328,328,74,74,0,1,0
15,336,336,2,2,0,1,0
3,346,346,21,1,20,2,1
14,360,360,98,98,0,1,0
11,360,360,20,6,14,2,1
7,367,367,138,138,0,1,0
16,378,378,41,24,17,2,1
20,387,387,13,1,12,3,2
26,390,390,117,117,0,1,0
24,394,394,30,18,12,4,3
23,419,419,6,2,4,2,1
9,440,440,102,40,62,3,2
8,445,445,7,7,0,1,0
31,445,445,10,10,0,1,0
5,446,446,76,76,0,1,0

10,105,105,17,17,0,1,0
30,106,106,14,4,10,2,1
35,141,141,11,2,9,4,3
21,148,148,8,8,0,1,0
29,164,164,40,19,21,4,3
8,173,173,45,21,24,3,2
1,177,177,17,17,0,1,0
7,178,178,2,2,0,1,0
3,181,181,22,22,0,1,0
25,195,195,6,6,0,1,0
6,199,199,17,17,0,1,0
0,201,201,11,5,6,3,2
33,230,230,21,21,0,1,0
27,232,232,25,25,0,1,0
22,235,235,16,6,10,2,1
31,241,241,22,22,0,1,0
17,249,249,11,11,0,1,0
15,254,254,42,2,40,4,3
13,267,267,9,9,0,1,0
4,272,272,22,4,18,4,3
18,277,277,2,2,0,1,0
16,280,280,12,3,9,4,3
36,294,294,42,1,41,4,3
24,304,304,42,42,0,1,0
28,339,339,45,45,0,1,0
12,349,349,17,17,0,1,0
11,367,367,14,14,0,1,0
9,370,370,24,24,0,1,0
2,391,391,15,6,9,4,3
32,395,395,3,3,0,1,0
34,411,411,17,5,12,4,3
19,465,465,47,20,27,4,3
5,477,477,116,116,0,1,0
20,483,483,39,39,0,1,0
23,493,493,25,6,19,4,3
14,497,497,1,1,0,1,0
26,500,500,121,4,117,4,3

28,107,107,3,3,0,1,0
0,110,110,19,19,0,1,0
9,115,115,26,26,0,1,0
17,123,123,15,15,0,1,0
29,126,126,1,1,0,1,0
1,143,143,1,1,0,1,0
2,145,145,17,17,0,1,0
14,206,206,5,5,0,1,0
27,207,207,67,55,12,2,1
19,209,209,3,3,0,1,0
30,230,230,14,14,0,1,0
8,240,240,3,3,0,1,0
18,258,258,18,1,17,3,2
10,264,264,71,71,0,1,0
16,266,266,4,4,0,1,0
5,284,284,21,4,17,2,1
4,288,288,124,68,56,3,2
23,291,291,68,28,40,3,2
25,302,302,20,20,0,1,0
3,311,311,11,7,4,2,1
11,321,321,36,17,19,2,1
13,325,325,21,21,0,1,0
26,326,326,70,39,31,2,1
21,327,327,85,52,33,4,3
24,359,359,26,14,12,2,1
7,379,379,38,16,22,3,2
20,429,429,1,1,0,1,0
12,447,447,18,18,0,1,0
22,478,478,86,86,0,1,0
15,489,489,23,23,0,1,0
6,489,489,19,19,0,1,0

16,146,146,32,32,0,1,0
31,152,152,1,1,0,1,0
5,160,160,72,35,37,2,1
0,172,172,10,10,0,1,0
6,176,176,23,5,18,4,3
14,186,186,6,6,0,1,0
13,192,192,9,9,0,1,0
18,195,195,61,50,11,2,1
4,196,196,12,5,7,2,1
24,201,201,29,23,6,2,1
17,205,205,14,4,10,2,1
28,229,229,9,9,0,1,0
11,238,238,12,12,0,1,0
15,239,239,10,10,0,1,0
26,241,241,4,4,0,1,0
2,259,259,2,2,0,1,0
9,270,270,12,12,0,1,0
20,285,285,14,8,6,2,1
30,286,286,65,65,0,1,0
19,294,294,9,9,0,1,0
1,311,311,32,17,15,4,3
21,329,329,4,1,3,2,1
27,333,333,83,83,0,1,0
8,334,334,29,29,0,1,0
10,344,344,140,76,64,3,2
3,363,363,18,6,12,2,1
25,392,392,24,24,0,1,0
29,403,403,14,14,0,1,0
23,424,424,18,18,0,1,0
12,436,436,66,66,0,1,0
22,458,458,86,86,0,1,0
7,475,475,10,6,4,2,1

2,113,113,6,6,0,1,0
7,113,113,6,6,0,1,0
24,113,113,2,2,0,1,0
32,122,122,4,4,0,1,0
4,145,145,24,7,17,2,1
20,155,155,14,14,0,1,0
35,156,156,12,6,6,2,1
36,197,197,39,20,19,2,1
6,207,207,10,10,0,1,0
31,234,234,5,5,0,1,0
27,238,238,16,16,0,1,0
0,263,263,64,22,42,3,2
14,269,269,37,25,12,3,2
28,274,274,61,43,18,3,2
22,284,284,4,4,0,1,0
19,294,294,8,8,0,1,0
25,309,309,109,87,22,4,3
30,309,309,50,4,46,3,2
15,316,316,3,3,0,1,0
29,342,342,21,12,9,4,3
33,356,356,10,10,0,1,0
11,373,373,10,10,0,1,0
3,376,376,36,26,10,3,2
13,381,381,66,66,0,1,0
12,384,384,23,23,0,1,0
21,388,388,16,7,9,2,1
34,394,394,19,19,0,1,0
1,400,400,39,39,0,1,0
5,407,407,30,30,0,1,0
18,418,418,1,1,0,1,0
26,428,428,82,64,18,3,2
16,429,429,46,8,38,3,2
8,441,441,22,22,0,1,0
17,449,449,4,1,3,2,1
23,494,494,53,3,50,3,2
10,494,494,90,49,41,2,1
9,500,500,44,44,0,1,0

15,105,105,2,2,0,1,0
29,120,120,1,1,0,1,0
30,132,132,28,22,6,3,2
23,145,145,13,13,0,1,0
24,150,150,12,12,0,1,0
22,179,179,2,2,0,1,0
8,190,190,21,21,0,1,0
20,206,206,13,7,6,3,2
19,236,236,42,42,0,1,0
16,241,241,9,4,5,2,1
26,243,243,8,8,0,1,0
10,257,257,78,68,10,2,1
1,265,265,36,36,0,1,0
4,277,277,16,4,12,4,3
12,287,287,7,7,0,1,0
25,295,295,104,80,24,4,3
31,313,313,64,20,44,3,2
33,323,323,9,9,0,1,0
27,326,326,85,85,0,1,0
6,332,332,35,35,0,1,0
17,358,358,11,2,9,4,3
14,363,363,7,7,0,1,0
2,364,364,8,8,0,1,0
18,365,365,6,6,0,1,0
21,389,389,17,4,13,2,1
3,390,390,1,1,0,1,0
11,391,391,71,28,43,2,1
28,393,393,6,6,0,1,0
32,407,407,45,30,15,2,1
0,456,456,2,2,0,1,0
9,479,479,149,84,65,4,3
5,493,493,18,18,0,1,0
13,494,494,46,46,0,1,0
7,499,499,119,119,0,1,0

17,124,124,3,3,0,1,0
20,131,131,17,17,0,1,0
14,139,139,2,2,0,1,0
28,144,144,7,7,0,1,0
22,144,144,6,6,0,1,0
24,147,147,1,1,0,1,0
29,166,166,13,13,0,1,0
10,173,173,8,8,0,1,0
5,174,174,40,40,0,1,0
7,190,190,10,10,0,1,0
15,204,204,9,1,8,2,1
21,209,209,50,32,18,2,1
11,238,238,19,5,14,2,1
23,261,261,70,70,0,1,0
4,265,265,45,45,0,1,0
25,290,290,53,6,47,2,1
19,294,294,3,3,0,1,0
1,299,299,36,36,0,1,0
2,307,307,16,2,14,2,1
26,315,315,115,81,34,3,2
8,326,326,6,6,0,1,0
0,367,367,25,25,0,1,0
12,388,388,30,19,11,4,3
6,392,392,156,27,129,4,3
9,402,402,53,37,16,4,3
3,420,420,27,27,0,1,0
13,421,421,81,81,0,1,0
18,456,456,6,1,5,2,1
27,476,476,2,2,0,1,0
30,476,476,112,64,48,3,2
16,487,487,14,14,0,1,0

4,102,102,5,5,0,1,0
9,112,112,12,12,0,1,0
11,134,134,3,3,0,1,0
14,150,150,10,3,7,2,1
10,169,169,2,2,0,1,0
8,202,202,45,45,0,1,0
32,208,208,62,28,34,3,2
6,241,241,51,51,0,1,0
18,243,243,21,9,12,4,3
23,260,260,44,12,32,2,1
12,272,272,6,6,0,1,0
3,273,273,27,19,8,2,1
5,276,276,55,4,51,4,3
16,279,279,16,7,9,3,2
26,285,285,33,12,21,4,3
31,287,287,3,3,0,1,0
33,287,287,36,36,0,1,0
25,291,291,3,3,0,1,0
28,294,294,3,3,0,1,0
22,301,301,100,100,0,1,0
30,311,311,10,10,0,1,0
0,321,321,4,1,3,2,1
21,338,338,47,42,5,2,1
13,338,338,46,9,37,2,1
7,344,344,70,70,0,1,0
2,345,345,85,60,25,2,1
17,348,348,16,16,0,1,0
29,365,365,20,1,19,2,1
27,380,380,22,22,0,1,0
15,392,392,3,3,0,1,0
24,409,409,17,17,0,1,0
19,436,436,14,9,5,2,1
1,450,450,12,2,10,2,1
20,460,460,79,60,19,4,3

22,101,101,7,7,0,1,0
27,102,102,24,9,15,2,1
35,114,114,3,3,0,1,0
29,117,117,3,3,0,1,0
2,120,120,34,28,6,2,1
38,139,139,15,8,7,2,1
13,143,143,5,5,0,1,0
7,167,167,23,23,0,1,0
6,172,172,12,3,9,4,3
1,187,187,13,8,5,2,1
9,203,203,8,8,0,1,0
26,251,251,7,4,3,2,1
4,268,268,2,2,0,1,0
11,268,268,1,1,0,1,0
32,282,282,13,13,0,1,0
0,288,288,12,12,0,1,0
12,294,294,1,1,0,1,0
36,320,320,66,6,60,3,2
5,331,331,19,19,0,1,0
30,344,344,110,110,0,1,0
37,360,360,55,13,42,3,2
16,383,383,9,1,8,2,1
21,389,389,78,78,0,1,0
10,401,401,46,46,0,1,0
18,403,403,91,16,75,4,3
20,409,409,17,17,0,1,0
28,414,414,2,2,0,1,0
14,418,418,18,11,7,2,1
15,424,424,36,15,21,2,1
25,428,428,11,11,0,1,0
34,444,444,36,36,0,1,0
8,450,450,12,8,4,2,1
33,463,463,21,21,0,1,0
19,472,472,12,12,0,1,0
31,475,475,72,72,0,1,0
17,476,476,31,31,0,1,0
23,481,481,65,30,35,2,1
24,486,486,36,36,0,1,0
3,495,495,50,32,18,3,2

20,110,110,4,4,0,1,0
6,119,119,3,3,0,1,0
11,120,120,7,4,3,2,1
18,120,120,41,24,17,2,1
22,128,128,10,3,7,2,1
2,128,128,10,10,0,1,0
9,145,145,1,1,0,1,0
17,153,153,8,5,3,2,1
23,174,174,7,7,0,1,0
0,176,176,22,5,17,2,1
14,192,192,10,10,0,1,0
15,212,212,13,4,9,4,3
8,230,230,10,10,0,1,0
25,244,244,6,6,0,1,0
1,245,245,13,13,0,1,0
27,247,247,7,7,0,1,0
3,256,256,21,21,0,1,0
31,282,282,57,14,43,2,1
24,302,302,7,4,3,2,1
7,327,327,50,45,5,2,1
28,329,329,15,15,0,1,0
30,334,334,156,156,0,1,0
10,340,340,23,23,0,1,0
19,346,346,5,1,4,2,1
12,347,347,27,8,19,2,1
26,355,355,31,31,0,1,0
16,384,384,41,41,0,1,0
13,405,405,193,145,48,4,3
29,430,430,36,10,26,2,1
5,435,435,8,8,0,1,0
4,439,439,170,170,0,1,0
21,439,439,19,3,16,2,1

14,116,116,6,6,0,1,0
17,130,130,4,4,0,1,0
18,131,131,2,2,0,1,0
32,137,137,5,5,0,1,0
7,138,138,55,22,33,4,3
29,147,147,2,2,0,1,0
13,161,161,5,5,0,1,0
19,165,165,2,2,0,1,0
11,177,177,6,1,5,2,1
30,179,179,47,25,22,2,1
1,191,191,45,29,16,3,2
6,193,193,31,6,25,4,3
0,215,215,6,3,3,2,1
12,216,216,12,12,0,1,0
26,235,235,65,65,0,1,0
16,243,243,10,10,0,1,0
33,270,270,19,6,13,2,1
23,270,270,31,31,0,1,0
22,282,282,83,63,20,3,2
31,282,282,30,30,0,1,0
2,309,309,4,4,0,1,0
5,309,309,4,4,0,1,0
24,317,317,7,7,0,1,0
9,318,318,35,17,18,4,3
20,329,329,18,4,14,3,2
8,348,348,67,58,9,3,2
15,353,353,24,19,5,2,1
28,375,375,34,34,0,1,0
25,376,376,15,15,0,1,0
10,376,376,60,60,0,1,0
3,400,400,1,1,0,1,0
4,403,403,43,43,0,1,0
27,407,407,65,65,0,1,0
21,489,489,71,51,20,2,1

27,106,106,7,7,0,1,0
14,120,120,35,8,27,2,1
10,140,140,20,20,0,1,0
26,147,147,12,12,0,1,0
28,149,149,10,10,0,1,0
6,180,180,43,23,20,2,1
9,183,183,11,2,9,4,3
5,189,189,14,14,0,1,0
17,219,219,13,13,0,1,0
2,225,225,28,1,27,4,3
24,240,240,46,21,25,2,1
22,251,251,4,4,0,1,0
4,274,274,26,2,24,4,3
8,331,331,34,9,25,2,1
16,348,348,2,2,0,1,0
15,356,356,55,28,27,4,3
13,361,361,123,123,0,1,0
29,373,373,17,17,0,1,0
7,377,377,14,2,12,2,1
0,379,379,18,18,0,1,0
1,393,393,74,74,0,1,0
20,395,395,9,9,0,1,0
19,446,446,74,74,0,1,0
25,449,449,37,1,36,3,2
12,452,452,4,1,3,2,1
3,458,458,81,39,42,4,3
11,460,460,29,12,17,2,1
21,465,465,102,90,12,3,2
30,466,466,1,1,0,1,0
18,486,486,63,63,0,1,0
23,492,492,67,23,44,3,2

18,101,101,1,1,0,1,0
0,122,122,5,1,4,2,1
25,126,126,7,7,0,1,0
20,139,139,12,12,0,1,0
15,141,141,1,1,0,1,0
8,150,150,21,21,0,1,0
5,155,155,28,13,15,2,1
1,175,175,19,7,12,3,2
26,176,176,16,4,12,3,2
12,215,215,1,1,0,1,0
23,221,221,17,13,4,2,1
14,243,243,51,51,0,1,0
17,243,243,25,5,20,2,1
6,247,247,31,19,12,2,1
22,267,267,45,6,39,2,1
21,294,294,12,12,0,1,0
10,307,307,42,42,0,1,0
7,320,320,28,20,8,3,2
27,320,320,69,17,52,4,3
4,333,333,26,2,24,3,2
13,335,335,41,41,0,1,0
2,339,339,8,8,0,1,0
9,345,345,248,212,36,4,3
16,360,360,48,48,0,1,0
24,388,388,23,5,18,2,1
3,406,406,25,11,14,3,2
11,470,470,81,6,75,4,3
19,489,489,87,57,30,4,3

32,140,140,14,6,8,2,1
24,172,172,4,4,0,1,0
27,207,207,65,65,0,1,0
30,217,217,26,26,0,1,0
29,229,229,18,18,0,1,0
11,241,241,25,25,0,1,0
35,249,249,14,10,4,2,1
6,265,265,1,1,0,1,0
8,278,278,12,3,9,2,1
40,278,278,14,14,0,1,0
12,279,279,37,37,0,1,0
0,282,282,12,12,0,1,0
9,289,289,12,12,0,1,0
17,291,291,21,21,0,1,0
26,294,294,5,5,0,1,0
4,295,295,1,1,0,1,0
20,297,297,11,11,0,1,0
16,314,314,47,2,45,2,1
41,315,315,3,3,0,1,0
5,317,317,8,8,0,1,0
37,323,323,17,17,0,1,0
10,328,328,36,9,27,4,3
42,338,338,7,1,6,3,2
38,340,340,103,80,23,2,1
34,346,346,9,4,5,2,1
25,351,351,28,10,18,3,2
15,385,385,20,3,17,4,3
1,389,389,4,4,0,1,0
13,407,407,35,20,15,2,1
18,413,413,4,4,0,1,0
3,422,422,42,3,39,3,2
28,425,425,19,6,13,2,1
2,430,430,70,24,46,3,2
7,438,438,9,9,0,1,0
31,442,442,14,14,0,1,0
14,446,446,17,9,8,3,2
23,447,447,77,77,0,1,0
21,470,470,23,23,0,1,0
39,479,479,139,83,56,3,2
22,493,493,34,4,30,2,1
36,494,494,18,3,15,4,3
19,499,499,33,27,6,2,1
33,500,500,94,64,30,4,3

0,103,103,4,1,3,2,1
11,113,113,6,3,3,2,1
23,126,126,1,1,0,1,0
28,135,135,36,14,22,2,1
2,137,137,37,37,0,1,0
4,148,148,10,2,8,3,2
8,154,154,1,1,0,1,0
20,155,155,12,12,0,1,0
21,157,157,1,1,0,1,0
14,161,161,10,1,9,4,3
1,163,163,12,12,0,1,0
13,175,175,72,42,30,3,2
29,186,186,7,1,6,2,1
15,200,200,7,7,0,1,0
26,207,207,35,15,20,2,1
16,211,211,31,17,14,2,1
6,252,252,1,1,0,1,0
17,261,261,13,13,0,1,0
5,267,267,3,3,0,1,0
27,268,268,45,45,0,1,0
32,273,273,2,2,0,1,0
10,281,281,55,55,0,1,0
31,348,348,35,35,0,1,0
30,409,409,24,24,0,1,0
12,422,422,60,60,0,1,0
9,441,441,62,35,27,4,3
7,455,455,59,59,0,1,0
25,456,456,69,69,0,1,0
3,457,457,28,28,0,1,0
24,465,465,28,4,24,4,3
22,473,473,157,109,48,4,3
19,477,477,20,13,7,2,1
18,495,495,24,24,0,1,0

1,102,102,45,15,30,2,1
31,119,119,2,2,0,1,0
12,147,147,1,1,0,1,0
18,151,151,17,4,13,2,1
23,163,163,21,18,3,2,1
0,166,166,4,4,0,1,0
20,176,176,10,4,6,3,2
11,185,185,38,8,30,2,1
27,190,190,31,17,14,3,2
9,195,195,22,8,14,2,1
10,207,207,35,35,0,1,0
15,208,208,76,62,14,2,1
25,225,225,4,1,3,2,1
26,239,239,13,13,0,1,0
3,240,240,10,2,8,2,1
16,249,249,20,7,13,2,1
21,252,252,6,6,0,1,0
14,254,254,14,3,11,2,1
19,271,271,3,3,0,1,0
8,290,290,34,34,0,1,0
30,308,308,8,8,0,1,0
29,310,310,3,3,0,1,0
28,336,336,59,59,0,1,0
4,360,360,57,14,43,2,1
6,370,370,12,4,8,3,2
22,374,374,16,9,7,2,1
2,383,383,43,39,4,2,1
13,392,392,53,53,0,1,0
7,394,394,21,21,0,1,0
5,401,401,15,15,0,1,0
24,414,414,46,4,42,2,1
17,418,418,140,128,12,4,3

9,100,100,6,6,0,1,0
0,117,117,1,1,0,1,0
5,126,126,3,3,0,1,0
4,128,128,1,1,0,1,0
32,132,132,11,2,9,4,3
33,135,135,71,71,0,1,0
20,179,179,29,29,0,1,0
6,182,182,12,1,11,2,1
10,199,199,18,18,0,1,0
36,207,207,52,52,0,1,0
23,211,211,5,5,0,1,0
11,219,219,41,41,0,1,0
21,226,226,3,3,0,1,0
28,236,236,21,3,18,2,1
31,248,248,7,7,0,1,0
8,253,253,2,2,0,1,0
22,286,286,25,7,18,3,2
34,291,291,7,7,0,1,0
18,303,303,5,5,0,1,0
30,309,309,4,4,0,1,0
3,327,327,16,16,0,1,0
16,327,327,7,7,0,1,0
27,346,346,8,8,0,1,0
12,348,348,17,17,0,1,0
26,352,352,70,25,45,4,3
15,386,386,2,2,0,1,0
1,390,390,89,71,18,4,3
25,403,403,42,5,37,4,3
7,403,403,9,9,0,1,0
24,420,420,7,7,0,1,0
13,427,427,122,67,55,4,3
29,428,428,31,19,12,2,1
14,447,447,35,35,0,1,0
35,451,451,21,3,18,2,1
2,452,452,28,28,0,1,0
17,454,454,118,118,0,1,0
19,483,483,7,4,3,2,1
37,493,493,68,17,51,4,3

29,104,104,12,8,4,2,1
14,108,108,11,11,0,1,0
5,121,121,7,4,3,2,1
13,124,124,3,3,0,1,0
32,133,133,1,1,0,1,0
19,145,145,6,6,0,1,0
8,151,151,7,7,0,1,0
25,153,153,5,5,0,1,0
24,162,162,6,6,0,1,0
21,169,169,18,6,12,3,2
26,195,195,15,3,12,3,2
16,200,200,14,14,0,1,0
20,217,217,79,19,60,3,2
31,248,248,11,2,9,4,3
7,266,266,111,111,0,1,0
0,271,271,14,14,0,1,0
17,272,272,42,18,24,2,1
11,279,279,52,39,13,2,1
30,297,297,7,7,0,1,0
28,304,304,11,11,0,1,0
3,311,311,23,13,10,3,2
2,323,323,15,6,9,4,3
6,348,348,27,11,16,3,2
10,372,372,7,1,6,3,2
4,379,379,19,19,0,1,0
22,400,400,36,26,10,2,1
1,405,405,51,51,0,1,0
9,407,407,7,1,6,3,2
23,438,438,109,83,26,2,1
27,454,454,47,47,0,1,0
12,488,488,18,18,0,1,0
15,495,495,182,71,111,4,3
18,500,500,98,98,0,1,0

10,107,107,1,1,0,1,0
23,108,108,13,4,9,2,1
30,145,145,6,6,0,1,0
4,151,151,3,3,0,1,0
12,151,151,22,4,18,3,2
18,176,176,63,63,0,1,0
17,197,197,6,6,0,1,0
6,206,206,11,6,5,2,1
36,215,215,2,2,0,1,0
35,224,224,33,23,10,3,2
37,233,233,94,66,28,2,1
0,240,240,7,7,0,1,0
2,249,249,57,57,0,1,0
7,252,252,7,1,6,2,1
20,263,263,51,51,0,1,0
33,264,264,53,53,0,1,0
22,266,266,15,15,0,1,0
5,271,271,3,3,0,1,0
14,271,271,9,5,4,2,1
8,272,272,13,1,12,3,2
34,276,276,21,21,0,1,0
24,282,282,9,3,6,3,2
28,283,283,23,11,12,4,3
3,301,301,3,3,0,1,0
32,310,310,28,10,18,2,1
29,312,312,18,4,14,4,3
15,329,329,5,5,0,1,0
19,332,332,19,19,0,1,0
13,339,339,5,5,0,1,0
26,342,342,90,48,42,4,3
1,348,348,106,35,71,4,3
21,360,360,28,16,12,2,1
31,382,382,15,15,0,1,0
9,399,399,25,25,0,1,0
11,429,429,14,14,0,1,0
16,471,471,7,7,0,1,0
27,472,472,13,1,12,3,2
25,489,489,6,2,4,2,1

14,126,126,5,5,0,1,0
13,159,159,11,7,4,2,1
20,172,172,8,8,0,1,0
4,186,186,13,5,8,2,1
6,190,190,36,36,0,1,0
2,200,200,35,2,33,2,1
28,207,207,27,12,15,2,1
0,227,227,35,35,0,1,0
17,237,237,41,32,9,4,3
12,241,241,81,81,0,1,0
8,260,260,20,20,0,1,0
16,285,285,32,23,9,4,3
18,288,288,13,13,0,1,0
30,330,330,16,6,10,3,2
29,332,332,30,30,0,1,0
15,336,336,4,4,0,1,0
24,342,342,36,36,0,1,0
19,342,342,105,105,0,1,0
21,346,346,13,4,9,4,3
23,357,357,16,8,8,2,1
5,360,360,60,60,0,1,0
3,378,378,32,32,0,1,0
10,382,382,17,17,0,1,0
27,409,409,21,21,0,1,0
26,420,420,83,48,35,2,1
1,438,438,57,1,56,3,2
11,448,448,6,3,3,2,1
7,454,454,26,26,0,1,0
9,468,468,63,63,0,1,0
25,470,470,124,118,6,3,2
22,492,492,18,18,0,1,0

23,107,107,5,5,0,1,0
17,119,119,2,2,0,1,0
27,130,130,41,3,38,2,1
9,135,135,4,4,0,1,0
21,137,137,5,5,0,1,0
0,142,142,10,10,0,1,0
28,153,153,4,4,0,1,0
15,174,174,15,15,0,1,0
32,178,178,36,33,3,2,1
11,181,181,36,36,0,1,0
1,194,194,8,8,0,1,0
26,195,195,38,8,30,3,2
18,200,200,50,43,7,2,1
31,219,219,7,1,6,3,2
2,221,221,49,49,0,1,0
7,223,223,11,2,9,2,1
4,237,237,10,10,0,1,0
5,255,255,14,5,9,4,3
30,266,266,41,23,18,3,2
3,267,267,26,11,15,4,3
14,288,288,3,3,0,1,0
29,289,289,7,4,3,2,1
24,303,303,11,11,0,1,0
20,317,317,25,17,8,2,1
6,318,318,24,10,14,2,1
33,325,325,33,33,0,1,0
13,333,333,16,16,0,1,0
12,413,413,50,50,0,1,0
22,424,424,18,3,15,2,1
10,428,428,32,14,18,4,3
19,477,477,74,74,0,1,0
25,482,482,16,4,12,3,2
8,486,486,75,75,0,1,0
16,498,498,162,90,72,3,2

30,140,140,20,20,0,1,0
11,166,166,31,31,0,1,0
4,184,184,20,2,18,2,1
31,186,186,20,8,12,3,2
20,205,205,1,1,0,1,0
23,208,208,13,13,0,1,0
22,220,220,2,2,0,1,0
2,228,228,38,38,0,1,0
3,229,229,4,4,0,1,0
24,237,237,9,9,0,1,0
10,238,238,2,2,0,1,0
25,245,245,114,114,0,1,0
19,251,251,16,5,11,2,1
27,255,255,33,33,0,1,0
14,273,273,21,13,8,2,1
15,277,277,33,33,0,1,0
18,285,285,19,19,0,1,0
6,288,288,71,71,0,1,0
7,293,293,151,118,33,2,1
9,355,355,14,9,5,2,1
8,359,359,18,3,15,2,1
16,363,363,75,58,17,2,1
12,386,386,6,2,4,2,1
13,399,399,21,1,20,3,2
26,405,405,8,1,7,2,1
28,413,413,50,50,0,1,0
1,429,429,44,38,6,3,2
29,431,431,10,6,4,2,1
0,435,435,33,27,6,3,2
5,455,455,18,3,15,2,1
21,465,465,21,7,14,2,1
17,483,483,47,47,0,1,0

33,118,118,12,12,0,1,0
3,133,133,2,2,0,1,0
24,152,152,2,2,0,1,0
7,157,157,43,43,0,1,0
4,159,159,10,10,0,1,0
14,164,164,10,10,0,1,0
25,175,175,7,7,0,1,0
29,185,185,7,7,0,1,0
31,187,187,11,1,10,3,2
15,213,213,20,20,0,1,0
6,238,238,7,7,0,1,0
13,248,248,1,1,0,1,0
28,252,252,67,55,12,3,2
12,265,265,4,4,0,1,0
17,271,271,19,10,9,2,1
27,286,286,29,29,0,1,0
22,290,290,6,6,0,1,0
11,310,310,92,89,3,2,1
10,332,332,38,38,0,1,0
8,338,338,95,55,40,4,3
16,354,354,66,66,0,1,0
32,361,361,33,33,0,1,0
23,361,361,130,87,43,4,3
20,384,384,48,6,42,3,2
18,403,403,99,72,27,2,1
19,403,403,41,41,0,1,0
9,404,404,29,29,0,1,0
2,409,409,23,23,0,1,0
30,413,413,15,3,12,4,3
1,417,417,26,7,19,2,1
26,472,472,15,1,14,3,2
0,476,476,27,27,0,1,0
21,477,477,15,3,12,4,3
5,496,496,10,7,3,2,1

32,105,105,32,11,21,2,1
4,109,109,1,1,0,1,0
36,114,114,10,10,0,1,0
19,120,120,1,1,0,1,0
29,124,124,6,6,0,1,0
37,131,131,16,16,0,1,0
5,137,137,10,10,0,1,0
18,147,147,1,1,0,1,0
8,165,165,2,2,0,1,0
25,172,172,3,3,0,1,0
1,185,185,30,30,0,1,0
34,215,215,9,2,7,2,1
17,227,227,29,20,9,2,1
27,236,236,25,25,0,1,0
24,242,242,47,47,0,1,0
20,247,247,20,6,14,2,1
26,247,247,14,5,9,4,3
16,270,270,30,27,3,2,1
13,286,286,33,17,16,2,1
14,313,313,2,2,0,1,0
0,313,313,29,8,21,4,3
30,323,323,33,33,0,1,0
15,343,343,60,52,8,3,2
7,349,349,4,4,0,1,0
23,360,360,4,4,0,1,0
6,364,364,9,9,0,1,0
10,365,365,4,4,0,1,0
33,390,390,34,34,0,1,0
9,400,400,95,27,68,3,2
3,407,407,13,13,0,1,0
2,407,407,36,36,0,1,0
21,418,418,30,30,0,1,0
22,433,433,97,32,65,3,2
11,458,458,29,25,4,2,1
12,461,461,117,117,0,1,0
28,473,473,97,10,87,4,3
31,477,477,31,25,6,2,1
35,478,478,3,3,0,1,0

5,104,104,2,2,0,1,0
28,126,126,1,1,0,1,0
20,193,193,47,47,0,1,0
19,210,210,1,1,0,1,0
18,224,224,10,1,9,4,3
10,226,226,31,31,0,1,0
15,246,246,5,5,0,1,0
25,257,257,17,17,0,1,0
27,271,271,130,102,28,4,3
3,275,275,4,4,0,1,0
11,275,275,45,45,0,1,0
7,286,286,213,138,75,3,2
16,292,292,24,24,0,1,0
9,333,333,50,32,18,4,3
2,341,341,15,6,9,2,1
21,361,361,6,6,0,1,0
17,375,375,45,35,10,2,1
4,384,384,37,37,0,1,0
8,392,392,82,58,24,4,3
23,393,393,6,1,5,2,1
13,402,402,51,19,32,2,1
29,416,416,30,30,0,1,0
14,419,419,114,9,105,4,3
24,459,459,12,12,0,1,0
1,459,459,7,3,4,2,1
6,471,471,10,10,0,1,0
0,472,472,26,26,0,1,0
22,473,473,22,6,16,3,2
26,486,486,39,39,0,1,0
12,492,492,15,15,0,1,0

37,139,139,46,46,0,1,0
4,156,156,11,11,0,1,0
15,164,164,1,1,0,1,0
32,174,174,7,3,4,2,1
7,188,188,9,9,0,1,0
20,197,197,8,2,6,2,1
10,197,197,25,25,0,1,0
38,198,198,45,12,33,2,1
29,212,212,6,6,0,1,0
9,214,214,18,6,12,3,2
24,223,223,12,12,0,1,0
25,231,231,4,4,0,1,0
34,233,233,2,2,0,1,0
18,235,235,23,23,0,1,0
12,244,244,42,42,0,1,0
3,259,259,55,24,31,4,3
26,270,270,9,2,7,2,1
22,288,288,29,29,0,1,0
23,293,293,26,26,0,1,0
13,302,302,3,3,0,1,0
14,303,303,58,10,48,2,1
31,314,314,147,63,84,4,3
21,314,314,1,1,0,1,0
5,326,326,1,1,0,1,0
40,377,377,57,57,0,1,0
17,378,378,10,10,0,1,0
0,379,379,17,11,6,2,1
30,383,383,11,1,10,2,1
2,389,389,10,2,8,3,2
33,390,390,19,19,0,1,0
28,391,391,7,1,6,3,2
35,395,395,28,10,18,4,3
1,399,399,33,19,14,2,1
19,422,422,20,1,19,2,1
27,428,428,5,1,4,2,1
8,431,431,8,8,0,1,0
16,439,439,40,2,38,3,2
6,444,444,38,38,0,1,0
11,447,447,10,6,4,2,1
39,451,451,83,36,47,2,1
36,465,465,4,4,0,1,0

14,107,107,2,2,0,1,0
29,110,110,1,1,0,1,0
5,113,113,2,2,0,1,0
6,128,128,17,7,10,3,2
0,141,141,1,1,0,1,0
21,141,141,23,23,0,1,0
31,154,154,6,6,0,1,0
4,169,169,64,64,0,1,0
22,186,186,22,22,0,1,0
10,190,190,1,1,0,1,0
33,211,211,2,2,0,1,0
30,231,231,89,89,0,1,0
1,264,264,1,1,0,1,0
19,285,285,27,5,22,4,3
8,293,293,1,1,0,1,0
11,312,312,36,4,32,2,1
24,320,320,35,35,0,1,0
15,322,322,58,45,13,2,1
27,322,322,41,41,0,1,0
7,328,328,81,40,41,2,1
26,338,338,74,52,22,3,2
9,353,353,10,1,9,2,1
32,368,368,10,10,0,1,0
17,399,399,1,1,0,1,0
18,410,410,15,15,0,1,0
3,414,414,9,9,0,1,0
12,426,426,67,54,13,2,1
28,473,473,52,34,18,4,3
23,478,478,2,2,0,1,0
25,479,479,95,95,0,1,0
16,486,486,54,25,29,2,1
13,487,487,47,47,0,1,0
2,493,493,87,27,60,3,2
20,497,497,38,17,21,4,3

6,106,106,23,23,0,1,0
22,125,125,32,32,0,1,0
11,140,140,5,5,0,1,0
7,148,148,41,23,18,2,1
21,161,161,27,27,0,1,0
33,183,183,32,32,0,1,0
31,214,214,8,8,0,1,0
5,234,234,6,6,0,1,0
34,245,245,9,9,0,1,0
20,251,251,77,37,40,3,2
27,259,259,89,89,0,1,0
18,260,260,39,36,3,2,1
25,268,268,8,8,0,1,0
8,288,288,12,12,0,1,0
32,296,296,6,6,0,1,0
23,307,307,11,1,10,4,3
28,321,321,4,1,3,2,1
4,338,338,69,6,63,4,3
29,339,339,36,11,25,4,3
3,356,356,66,66,0,1,0
0,361,361,1,1,0,1,0
1,382,382,24,24,0,1,0
10,395,395,1,1,0,1,0
12,396,396,24,24,0,1,0
16,398,398,61,61,0,1,0
2,402,402,5,1,4,2,1
13,406,406,5,2,3,2,1
24,411,411,3,3,0,1,0
17,435,435,11,11,0,1,0
19,463,463,3,3,0,1,0
9,464,464,86,5,81,4,3
26,475,475,1,1,0,1,0
30,482,482,19,6,13,2,1
15,489,489,41,32,9,2,1
14,498,498,56,29,27,2,1

16,102,102,5,5,0,1,0
25,134,134,4,1,3,2,1
18,139,139,8,1,7,2,1
27,157,157,22,22,0,1,0
23,176,176,37,19,18,4,3
28,181,181,47,43,4,2,1
20,199,199,11,11,0,1,0
17,199,199,23,23,0,1,0
6,241,241,39,39,0,1,0
19,248,248,5,1,4,2,1
24,249,249,23,9,14,2,1
31,280,280,29,29,0,1,0
22,296,296,3,3,0,1,0
4,300,300,12,9,3,2,1
0,319,319,73,31,42,4,3
14,324,324,51,23,28,2,1
26,324,324,25,7,18,4,3
3,335,335,13,13,0,1,0
9,351,351,57,20,37,4,3
8,360,360,18,18,0,1,0
2,364,364,8,8,0,1,0
11,378,378,30,30,0,1,0
13,387,387,2,2,0,1,0
1,389,389,17,8,9,4,3
21,420,420,68,32,36,3,2
29,431,431,59,30,29,4,3
7,432,432,34,34,0,1,0
30,453,453,79,46,33,2,1
15,468,468,27,6,21,4,3
10,471,471,164,164,0,1,0
12,491,491,43,15,28,2,1
5,495,495,98,14,84,3,2

28,118,118,6,6,0,1,0
12,118,118,4,4,0,1,0
26,126,126,6,1,5,2,1
29,135,135,14,14,0,1,0
11,143,143,13,10,3,2,1
17,150,150,16,10,6,2,1
13,162,162,12,3,9,2,1
23,164,164,62,62,0,1,0
2,179,179,8,8,0,1,0
24,195,195,1,1,0,1,0
6,222,222,2,2,0,1,0
3,249,249,64,64,0,1,0
4,257,257,59,59,0,1,0
14,260,260,4,4,0,1,0
8,268,268,4,1,3,2,1
0,279,279,46,12,34,2,1
15,288,288,67,67,0,1,0
5,329,329,6,6,0,1,0
10,333,333,54,54,0,1,0
19,338,338,40,32,8,2,1
22,350,350,3,3,0,1,0
25,351,351,4,4,0,1,0
21,354,354,44,44,0,1,0
1,355,355,92,29,63,4,3
18,369,369,33,33,0,1,0
27,439,439,143,38,105,4,3
7,450,450,6,6,0,1,0
16,452,452,1,1,0,1,0
9,454,454,185,131,54,4,3
20,492,492,23,11,12,4,3

7,114,114,26,26,0,1,0
0,132,132,2,2,0,1,0
23,156,156,7,7,0,1,0
22,161,161,2,2,0,1,0
26,164,164,36,27,9,4,3
5,167,167,16,1,15,4,3
30,171,171,14,10,4,2,1
16,182,182,33,33,0,1,0
1,184,184,38,38,0,1,0
11,193,193,14,14,0,1,0
33,204,204,20,4,16,4,3
21,206,206,1,1,0,1,0
19,228,228,6,3,3,2,1
32,244,244,84,74,10,3,2
15,262,262,39,11,28,3,2
28,269,269,1,1,0,1,0
29,279,279,29,13,16,2,1
2,281,281,19,16,3,2,1
27,296,296,12,1,11,3,2
8,327,327,19,13,6,3,2
9,350,350,53,53,0,1,0
20,353,353,130,34,96,4,3
31,358,358,38,14,24,3,2
25,378,378,1,1,0,1,0
14,379,379,5,5,0,1,0
24,380,380,39,39,0,1,0
34,383,383,61,61,0,1,0
3,394,394,43,43,0,1,0
13,394,394,2,2,0,1,0
12,397,397,55,55,0,1,0
10,398,398,10,10,0,1,0
18,421,421,6,6,0,1,0
17,433,433,23,23,0,1,0
4,467,467,15,3,12,4,3
6,497,497,49,49,0,1,0

18,103,103,9,3,6,3,2
3,126,126,9,3,6,2,1
13,128,128,5,5,0,1,0
32,135,135,23,8,15,2,1
30,139,139,27,11,16,3,2
28,142,142,17,5,12,2,1
34,144,144,1,1,0,1,0
16,157,157,12,4,8,3,2
25,199,199,69,69,0,1,0
17,202,202,25,3,22,3,2
14,208,208,20,20,0,1,0
0,219,219,5,5,0,1,0
1,220,220,49,7,42,2,1
4,243,243,22,14,8,2,1
33,265,265,14,2,12,2,1
20,265,265,68,68,0,1,0
19,273,273,15,15,0,1,0
21,287,287,8,8,0,1,0
5,298,298,1,1,0,1,0
23,311,311,58,58,0,1,0
27,328,328,4,4,0,1,0
11,336,336,72,72,0,1,0
15,337,337,11,11,0,1,0
8,345,345,37,37,0,1,0
9,352,352,21,21,0,1,0
6,362,362,14,8,6,3,2
26,371,371,2,2,0,1,0
31,380,380,4,4,0,1,0
7,401,401,5,5,0,1,0
35,404,404,17,17,0,1,0
22,408,408,14,14,0,1,0
10,421,421,104,32,72,4,3
12,448,448,24,24,0,1,0
2,452,452,22,22,0,1,0
36,459,459,21,21,0,1,0
24,466,466,96,84,12,3,2
29,489,489,10,10,0,1,0

2,103,103,2,2,0,1,0
40,116,116,31,31,0,1,0
33,124,124,13,5,8,2,1
20,126,126,3,3,0,1,0
26,126,126,10,2,8,3,2
36,130,130,5,5,0,1,0
38,142,142,5,1,4,2,1
11,143,143,16,16,0,1,0
13,156,156,16,6,10,3,2
5,159,159,6,6,0,1,0
15,163,163,2,2,0,1,0
14,165,165,1,1,0,1,0
34,169,169,2,2,0,1,0
4,170,170,2,2,0,1,0
22,227,227,8,2,6,2,1
39,249,249,1,1,0,1,0
32,274,274,56,21,35,2,1
8,276,276,18,4,14,2,1
1,277,277,65,21,44,2,1
9,279,279,48,48,0,1,0
21,337,337,15,15,0,1,0
12,338,338,40,34,6,2,1
6,342,342,13,8,5,2,1
41,344,344,26,26,0,1,0
16,345,345,20,7,13,2,1
23,354,354,18,18,0,1,0
30,356,356,40,20,20,2,1
10,368,368,159,159,0,1,0
19,373,373,17,17,0,1,0
3,379,379,1,1,0,1,0
0,393,393,5,5,0,1,0
25,395,395,67,67,0,1,0
28,455,455,100,95,5,2,1
27,459,459,4,4,0,1,0
24,467,467,12,12,0,1,0
18,473,473,11,7,4,2,1
31,481,481,36,26,10,2,1
35,486,486,84,12,72,4,3
37,486,486,15,15,0,1,0
29,489,489,58,32,26,2,1
7,489,489,6,1,5,2,1
17,495,495,2,2,0,1,0

14,101,101,8,8,0,1,0
5,107,107,4,1,3,2,1
24,136,136,2,2,0,1,0
28,142,142,8,8,0,1,0
0,161,161,22,10,12,4,3
27,180,180,6,6,0,1,0
3,194,194,3,3,0,1,0
25,200,200,13,13,0,1,0
2,204,204,89,89,0,1,0
13,208,208,91,65,26,2,1
15,225,225,42,20,22,2,1
23,241,241,5,5,0,1,0
20,262,262,7,7,0,1,0
22,267,267,13,8,5,2,1
16,276,276,17,17,0,1,0
8,279,279,42,42,0,1,0
29,291,291,36,12,24,3,2
11,326,326,26,6,20,3,2
17,343,343,64,40,24,3,2
4,347,347,49,37,12,2,1
21,348,348,41,19,22,2,1
26,362,362,28,28,0,1,0
19,381,381,66,35,31,2,1
9,387,387,13,13,0,1,0
1,391,391,20,6,14,3,2
10,426,426,14,14,0,1,0
6,448,448,4,1,3,2,1
12,450,450,58,58,0,1,0
7,456,456,6,6,0,1,0
30,459,459,208,129,79,4,3
18,485,485,4,4,0,1,0

28,109,109,5,5,0,1,0
24,111,111,24,7,17,2,1
22,132,132,9,9,0,1,0
8,140,140,4,4,0,1,0
29,155,155,15,15,0,1,0
0,158,158,13,13,0,1,0
31,178,178,17,3,14,3,2
16,181,181,14,2,12,4,3
6,187,187,10,10,0,1,0
26,195,195,34,22,12,4,3
2,203,203,17,17,0,1,0
18,217,217,21,21,0,1,0
20,229,229,8,8,0,1,0
10,251,251,4,1,3,2,1
9,267,267,25,25,0,1,0
7,271,271,81,5,76,4,3
23,277,277,59,31,28,2,1
4,300,300,40,40,0,1,0
25,302,302,40,40,0,1,0
27,318,318,56,56,0,1,0
19,332,332,26,14,12,3,2
15,337,337,8,8,0,1,0
12,343,343,65,65,0,1,0
32,387,387,25,25,0,1,0
21,406,406,2,2,0,1,0
11,411,411,151,113,38,2,1
17,437,437,50,42,8,2,1
3,438,438,5,2,3,2,1
30,442,442,26,26,0,1,0
1,452,452,30,9,21,2,1
13,454,454,28,17,11,3,2
5,471,471,47,47,0,1,0
14,492,492,45,45,0,1,0

8,132,132,10,10,0,1,0
6,147,147,31,7,24,4,3
21,161,161,46,14,32,2,1
19,176,176,15,15,0,1,0
25,183,183,15,6,9,4,3
9,192,192,5,5,0,1,0
3,210,210,16,3,13,2,1
26,213,213,3,3,0,1,0
20,223,223,42,24,18,3,2
27,233,233,83,83,0,1,0
0,250,250,71,3,68,3,2
22,261,261,15,15,0,1,0
4,268,268,84,84,0,1,0
11,270,270,20,20,0,1,0
16,272,272,4,4,0,1,0
1,291,291,37,11,26,2,1
2,298,298,128,118,10,2,1
24,315,315,14,14,0,1,0
18,317,317,7,4,3,2,1
12,322,322,8,8,0,1,0
23,326,326,36,36,0,1,0
5,332,332,36,17,19,2,1
13,347,347,37,7,30,4,3
14,385,385,55,5,50,3,2
17,386,386,12,6,6,3,2
15,421,421,39,15,24,2,1
7,465,465,17,11,6,3,2
10,466,466,6,6,0,1,0

23,119,119,27,15,12,3,2
18,128,128,3,3,0,1,0
13,149,149,21,21,0,1,0
1,164,164,4,4,0,1,0
32,209,209,5,5,0,1,0
10,210,210,18,12,6,2,1
24,233,233,30,30,0,1,0
25,238,238,7,1,6,3,2
2,244,244,35,35,0,1,0
16,244,244,74,21,53,4,3
22,261,261,13,13,0,1,0
19,263,263,2,2,0,1,0
5,267,267,46,46,0,1,0
6,286,286,23,23,0,1,0
21,304,304,2,2,0,1,0
31,308,308,1,1,0,1,0
17,320,320,48,48,0,1,0
3,332,332,1,1,0,1,0
4,366,366,68,40,28,3,2
12,372,372,25,19,6,3,2
8,379,379,18,18,0,1,0
27,382,382,40,10,30,4,3
11,386,386,64,64,0,1,0
26,391,391,107,20,87,4,3
0,400,400,106,54,52,3,2
9,402,402,41,41,0,1,0
14,414,414,66,66,0,1,0
29,422,422,104,56,48,2,1
30,445,445,15,15,0,1,0
20,475,475,43,43,0,1,0
28,477,477,13,13,0,1,0
7,477,477,20,20,0,1,0
15,488,488,8,8,0,1,0

6,121,121,28,28,0,1,0
23,128,128,43,7,36,3,2
25,148,148,2,2,0,1,0
0,157,157,45,45,0,1,0
17,206,206,16,6,10,3,2
1,215,215,3,3,0,1,0
13,225,225,14,11,3,2,1
11,230,230,19,19,0,1,0
14,244,244,10,10,0,1,0
3,248,248,3,3,0,1,0
8,276,276,19,7,12,4,3
18,283,283,47,47,0,1,0
2,290,290,90,6,84,3,2
12,294,294,21,21,0,1,0
15,311,311,10,3,7,2,1
21,359,359,40,23,17,2,1
22,372,372,48,48,0,1,0
5,379,379,1,1,0,1,0
24,385,385,27,2,25,2,1
7,393,393,205,126,79,3,2
9,404,404,1,1,0,1,0
4,412,412,104,26,78,4,3
20,433,433,92,92,0,1,0
26,441,441,5,5,0,1,0
10,485,485,5,5,0,1,0
16,487,487,47,47,0,1,0
19,497,497,106,61,45,4,3

18,107,107,26,26,0,1,0
19,112,112,11,11,0,1,0
17,135,135,6,6,0,1,0
11,163,163,3,3,0,1,0
1,165,165,66,66,0,1,0
2,185,185,78,29,49,3,2
16,218,218,4,1,3,2,1
5,225,225,40,40,0,1,0
21,251,251,95,81,14,2,1
14,277,277,1,1,0,1,0
7,317,317,49,38,11,2,1
3,328,328,125,2,123,4,3
10,343,343,7,7,0,1,0
4,365,365,160,133,27,4,3
9,388,388,46,46,0,1,0
8,416,416,56,56,0,1,0
20,417,417,8,8,0,1,0
12,464,464,63,42,21,4,3
6,465,465,4,4,0,1,0
0,468,468,28,17,11,2,1
15,482,482,50,50,0,1,0
13,499,499,30,15,15,4,3

14,103,103,4,4,0,1,0
21,106,106,5,5,0,1,0
33,114,114,12,6,6,3,2
6,122,122,4,4,0,1,0
34,124,124,4,4,0,1,0
43,130,130,2,2,0,1,0
44,130,130,2,2,0,1,0
20,133,133,11,11,0,1,0
29,134,134,9,9,0,1,0
2,136,136,5,5,0,1,0
13,140,140,7,7,0,1,0
41,178,178,14,14,0,1,0
25,182,182,26,17,9,4,3
30,186,186,7,1,6,2,1
7,191,191,7,2,5,2,1
36,191,191,23,5,18,4,3
32,196,196,20,11,9,4,3
15,220,220,12,6,6,3,2
0,263,263,28,28,0,1,0
10,274,274,13,5,8,3,2
5,283,283,29,29,0,1,0
35,288,288,125,125,0,1,0
27,293,293,1,1,0,1,0
3,309,309,10,2,8,3,2
38,319,319,24,12,12,4,3
22,337,337,1,1,0,1,0
19,338,338,13,13,0,1,0
40,366,366,80,32,48,4,3
26,368,368,13,13,0,1,0
16,382,382,6,6,0,1,0
31,394,394,5,5,0,1,0
1,401,401,40,10,30,2,1
39,419,419,84,42,42,4,3
17,422,422,1,1,0,1,0
45,438,438,33,13,20,3,2
9,446,446,23,11,12,2,1
28,452,452,100,10,90,3,2
12,458,458,12,12,0,1,0
23,474,474,15,4,11,4,3
37,476,476,50,50,0,1,0
42,476,476,26,14,12,3,2
11,479,479,71,59,12,3,2
18,479,479,8,2,6,2,1
4,482,482,10,4,6,3,2
24,491,491,63,3,60,4,3
8,498,498,24,24,0,1,0

4,129,129,1,1,0,1,0
21,147,147,4,4,0,1,0
9,161,161,20,5,15,2,1
2,200,200,15,5,10,2,1
17,222,222,16,16,0,1,0
31,230,230,4,4,0,1,0
16,231,231,5,5,0,1,0
13,239,239,14,14,0,1,0
30,260,260,23,23,0,1,0
24,281,281,13,13,0,1,0
29,295,295,14,14,0,1,0
11,315,315,14,4,10,2,1
0,324,324,56,39,17,2,1
15,331,331,39,11,28,2,1
22,337,337,157,102,55,4,3
28,347,347,20,6,14,2,1
6,352,352,22,10,12,2,1
10,370,370,23,6,17,2,1
26,393,393,32,32,0,1,0
1,409,409,8,4,4,2,1
14,410,410,31,31,0,1,0
33,430,430,20,11,9,4,3
8,437,437,45,45,0,1,0
20,440,440,25,2,23,3,2
12,440,440,143,56,87,4,3
19,447,447,28,20,8,2,1
3,447,447,18,18,0,1,0
5,452,452,123,111,12,4,3
18,466,466,61,19,42,3,2
7,466,466,55,55,0,1,0
27,468,468,132,49,83,4,3
32,474,474,51,51,0,1,0
23,490,490,12,9,3,2,1
25,491,491,53,53,0,1,0

12,107,107,9,9,0,1,0
1,125,125,7,2,5,2,1
29,138,138,13,3,10,3,2
34,138,138,19,19,0,1,0
38,146,146,9,9,0,1,0
4,151,151,5,2,3,2,1
0,154,154,7,1,6,3,2
3,195,195,17,17,0,1,0
8,196,196,1,1,0,1,0
11,199,199,11,11,0,1,0
6,200,200,1,1,0,1,0
31,205,205,8,8,0,1,0
36,209,209,34,34,0,1,0
42,218,218,51,33,18,4,3
26,228,228,18,13,5,2,1
5,232,232,25,25,0,1,0
24,240,240,27,14,13,2,1
19,245,245,52,52,0,1,0
22,247,247,11,11,0,1,0
23,256,256,1,1,0,1,0
16,261,261,3,3,0,1,0
39,275,275,61,37,24,4,3
37,279,279,28,28,0,1,0
35,292,292,40,40,0,1,0
7,311,311,9,9,0,1,0
2,313,313,8,8,0,1,0
27,328,328,35,35,0,1,0
21,330,330,23,23,0,1,0
25,335,335,14,14,0,1,0
17,346,346,9,9,0,1,0
30,352,352,3,3,0,1,0
13,370,370,21,1,20,3,2
9,372,372,15,6,9,2,1
15,372,372,25,8,17,2,1
20,379,379,80,80,0,1,0
40,385,385,8,8,0,1,0
41,390,390,9,9,0,1,0
32,397,397,72,72,0,1,0
33,405,405,3,3,0,1,0
18,436,436,32,2,30,2,1
14,452,452,33,33,0,1,0
10,467,467,58,29,29,2,1
28,491,491,62,51,11,4,3

10,129,129,11,11,0,1,0
0,144,144,1,1,0,1,0
6,145,145,2,2,0,1,0
11,151,151,21,21,0,1,0
34,153,153,3,3,0,1,0
27,155,155,6,6,0,1,0
17,158,158,2,2,0,1,0
22,161,161,23,23,0,1,0
29,172,172,5,5,0,1,0
20,174,174,8,8,0,1,0
8,175,175,1,1,0,1,0
7,196,196,48,48,0,1,0
18,200,200,25,1,24,3,2
21,209,209,12,8,4,2,1
2,226,226,57,57,0,1,0
12,228,228,19,19,0,1,0
32,249,249,55,55,0,1,0
24,252,252,69,69,0,1,0
33,258,258,10,10,0,1,0
36,265,265,58,1,57,4,3
26,358,358,6,3,3,2,1
28,381,381,4,4,0,1,0
19,386,386,21,9,12,2,1
31,406,406,53,8,45,4,3
25,409,409,79,13,66,4,3
3,413,413,54,30,24,4,3
38,416,416,83,83,0,1,0
16,421,421,52,52,0,1,0
30,432,432,34,26,8,3,2
9,438,438,16,16,0,1,0
23,445,445,24,24,0,1,0
14,449,449,9,9,0,1,0
13,463,463,7,7,0,1,0
37,466,466,16,16,0,1,0
35,471,471,16,6,10,3,2
5,487,487,20,20,0,1,0
4,491,491,38,8,30,3,2
1,495,495,13,7,6,3,2
15,498,498,52,52,0,1,0

29,101,101,2,2,0,1,0
34,102,102,2,2,0,1,0
10,124,124,16,8,8,3,2
4,125,125,14,14,0,1,0
18,130,130,12,12,0,1,0
35,145,145,47,47,0,1,0
6,156,156,5,5,0,1,0
3,183,183,2,2,0,1,0
21,187,187,9,6,3,2,1
25,197,197,4,4,0,1,0
19,221,221,2,2,0,1,0
31,224,224,14,4,10,3,2
37,226,226,8,4,4,2,1
8,229,229,7,7,0,1,0
1,246,246,24,24,0,1,0
26,264,264,1,1,0,1,0
32,273,273,46,6,40,2,1
2,275,275,75,72,3,2,1
13,280,280,2,2,0,1,0
14,294,294,57,34,23,2,1
38,295,295,36,36,0,1,0
0,301,301,8,8,0,1,0
36,327,327,76,27,49,2,1
9,332,332,93,59,34,3,2
16,335,335,7,1,6,2,1
24,340,340,13,2,11,2,1
15,341,341,11,3,8,3,2
33,377,377,27,27,0,1,0
11,385,385,31,12,19,2,1
27,400,400,22,3,19,3,2
7,425,425,71,32,39,4,3
20,426,426,1,1,0,1,0
22,435,435,24,9,15,4,3
17,439,439,15,15,0,1,0
12,442,442,3,3,0,1,0
30,459,459,19,5,14,3,2
28,478,478,7,7,0,1,0
23,478,478,214,97,117,4,3
5,490,490,8,8,0,1,0

21,104,104,3,3,0,1,0
33,115,115,14,4,10,3,2
26,129,129,73,24,49,2,1
28,139,139,7,3,4,2,1
24,215,215,33,33,0,1,0
6,219,219,6,3,3,2,1
12,228,228,53,53,0,1,0
14,229,229,6,2,4,2,1
34,230,230,22,1,21,2,1
27,241,241,18,18,0,1,0
4,246,246,9,9,0,1,0
15,257,257,1,1,0,1,0
17,259,259,5,5,0,1,0
3,265,265,43,1,42,2,1
9,274,274,13,13,0,1,0
22,276,276,4,1,3,2,1
30,287,287,4,4,0,1,0
0,292,292,10,10,0,1,0
40,327,327,33,33,0,1,0
1,329,329,88,88,0,1,0
36,353,353,35,16,19,4,3
35,358,358,8,3,5,2,1
20,383,383,56,40,16,2,1
2,388,388,15,15,0,1,0
16,391,391,24,24,0,1,0
7,393,393,5,5,0,1,0
19,399,399,25,25,0,1,0
5,403,403,15,5,10,2,1
31,419,419,44,44,0,1,0
8,428,428,10,10,0,1,0
29,434,434,15,3,12,4,3
41,439,439,33,33,0,1,0
10,440,440,6,6,0,1,0
13,448,448,12,12,0,1,0
25,449,449,79,47,32,2,1
38,464,464,14,14,0,1,0
37,471,471,32,32,0,1,0
32,473,473,18,15,3,2,1
18,474,474,12,12,0,1,0
11,483,483,56,22,34,2,1
23,492,492,42,42,0,1,0
39,494,494,33,33,0,1,0

28,100,100,7,7,0,1,0
22,119,119,16,13,3,2,1
23,123,123,12,4,8,3,2
13,145,145,16,11,5,2,1
12,150,150,4,1,3,2,1
2,153,153,15,15,0,1,0
25,167,167,7,7,0,1,0
29,183,183,1,1,0,1,0
4,202,202,22,22,0,1,0
33,202,202,6,2,4,2,1
10,211,211,15,1,14,2,1
9,215,215,31,31,0,1,0
32,217,217,4,1,3,2,1
34,219,219,12,5,7,2,1
26,227,227,44,44,0,1,0
31,236,236,8,8,0,1,0
8,289,289,21,21,0,1,0
15,294,294,21,9,12,2,1
21,302,302,39,39,0,1,0
1,350,350,40,40,0,1,0
27,364,364,12,4,8,3,2
24,369,369,152,107,45,4,3
16,396,396,34,2,32,2,1
18,406,406,78,78,0,1,0
6,406,406,6,3,3,2,1
17,416,416,6,6,0,1,0
3,427,427,14,14,0,1,0
14,449,449,9,9,0,1,0
11,454,454,51,27,24,4,3
5,457,457,22,19,3,2,1
36,458,458,18,6,12,3,2
35,462,462,102,88,14,2,1
7,470,470,114,34,80,3,2
20,478,478,20,1,19,2,1
30,489,489,90,56,34,3,2
19,495,495,16,4,12,3,2
0,496,496,44,44,0,1,0

20,130,130,24,12,12,2,1
15,142,142,12,2,10,2,1
13,153,153,2,2,0,1,0
3,162,162,20,6,14,2,1
19,176,176,13,8,5,2,1
18,193,193,11,2,9,2,1
22,205,205,20,20,0,1,0
0,230,230,28,4,24,4,3
25,236,236,29,5,24,2,1
14,242,242,19,19,0,1,0
21,253,253,4,4,0,1,0
6,257,257,27,27,0,1,0
12,264,264,27,1,26,3,2
24,272,272,73,17,56,3,2
11,295,295,102,102,0,1,0
23,315,315,10,10,0,1,0
8,318,318,15,15,0,1,0
26,349,349,22,4,18,2,1
17,371,371,39,39,0,1,0
16,378,378,31,31,0,1,0
5,409,409,103,103,0,1,0
9,418,418,170,167,3,2,1
1,451,451,73,33,40,3,2
2,471,471,32,32,0,1,0
4,475,475,78,78,0,1,0
10,477,477,8,8,0,1,0
7,486,486,122,29,93,4,3

30,100,100,12,12,0,1,0
9,105,105,4,4,0,1,0
31,109,109,16,16,0,1,0
28,113,113,4,4,0,1,0
13,120,120,1,1,0,1,0
3,121,121,22,22,0,1,0
26,123,123,18,11,7,2,1
17,128,128,39,2,37,2,1
27,152,152,12,12,0,1,0
5,163,163,7,7,0,1,0
23,183,183,32,32,0,1,0
11,187,187,37,18,19,2,1
4,187,187,11,11,0,1,0
8,191,191,11,11,0,1,0
18,206,206,33,33,0,1,0
21,238,238,23,23,0,1,0
2,241,241,26,14,12,4,3
14,243,243,58,32,26,3,2
10,255,255,23,2,21,4,3
0,325,325,33,33,0,1,0
12,359,359,42,20,22,2,1
6,371,371,6,6,0,1,0
20,373,373,11,5,6,3,2
15,382,382,10,4,6,2,1
22,393,393,2,2,0,1,0
16,394,394,30,30,0,1,0
24,401,401,18,3,15,4,3
19,417,417,53,53,0,1,0
25,428,428,3,3,0,1,0
1,447,447,192,119,73,4,3
7,462,462,8,8,0,1,0
29,467,467,73,19,54,3,2

17,128,128,2,2,0,1,0
1,132,132,7,7,0,1,0
21,136,136,24,3,21,4,3
12,154,154,10,4,6,3,2
11,180,180,7,3,4,2,1
18,197,197,30,30,0,1,0
2,210,210,126,126,0,1,0
8,211,211,34,34,0,1,0
14,227,227,5,1,4,2,1
3,247,247,7,3,4,2,1
5,261,261,38,8,30,2,1
20,273,273,4,1,3,2,1
13,300,300,55,50,5,2,1
4,320,320,44,44,0,1,0
7,326,326,26,16,10,2,1
27,339,339,5,5,0,1,0
10,382,382,44,10,34,2,1
9,396,396,43,3,40,3,2
22,411,411,143,143,0,1,0
26,418,418,4,4,0,1,0
19,435,435,76,76,0,1,0
23,446,446,126,126,0,1,0
24,446,446,29,8,21,4,3
25,451,451,16,16,0,1,0
0,467,467,88,16,72,3,2
6,471,471,39,39,0,1,0
16,478,478,23,23,0,1,0
15,478,478,44,44,0,1,0

7,103,103,1,1,0,1,0
39,118,118,5,5,0,1,0
24,119,119,10,10,0,1,0
38,121,121,15,1,14,2,1
21,129,129,13,13,0,1,0
12,149,149,8,4,4,2,1
2,165,165,5,5,0,1,0
19,178,178,25,25,0,1,0
17,186,186,4,1,3,2,1
15,200,200,39,31,8,2,1
33,205,205,13,13,0,1,0
16,205,205,4,4,0,1,0
20,209,209,2,2,0,1,0
4,214,214,3,3,0,1,0
37,233,233,11,11,0,1,0
29,235,235,5,1,4,2,1
11,235,235,33,33,0,1,0
35,278,278,20,20,0,1,0
25,285,285,11,11,0,1,0
34,291,291,22,22,0,1,0
9,301,301,126,126,0,1,0
31,330,330,10,10,0,1,0
14,330,330,13,1,12,4,3
36,345,345,189,170,19,2,1
10,395,395,35,35,0,1,0
30,396,396,85,53,32,3,2
23,399,399,9,9,0,1,0
32,402,402,2,2,0,1,0
28,403,403,38,2,36,2,1
13,411,411,8,8,0,1,0
8,417,417,13,13,0,1,0
18,421,421,4,4,0,1,0
27,431,431,82,23,59,4,3
3,431,431,21,21,0,1,0
1,438,438,48,18,30,3,2
5,439,439,16,16,0,1,0
6,440,440,1,1,0,1,0
0,471,471,71,25,46,4,3
26,483,483,33,19,14,2,1
22,487,487,6,6,0,1,0

26,108,108,12,1,11,2,1
27,130,130,44,12,32,2,1
20,132,132,2,2,0,1,0
28,133,133,11,11,0,1,0
34,138,138,1,1,0,1,0
10,153,153,29,4,25,2,1
14,168,168,22,22,0,1,0
9,209,209,27,1,26,3,2
4,221,221,10,10,0,1,0
1,225,225,34,34,0,1,0
18,229,229,22,22,0,1,0
17,231,231,19,19,0,1,0
30,245,245,34,22,12,4,3
33,246,246,21,21,0,1,0
3,247,247,28,28,0,1,0
13,248,248,18,18,0,1,0
11,258,258,19,5,14,2,1
22,285,285,49,49,0,1,0
31,294,294,4,1,3,2,1
5,303,303,21,21,0,1,0
8,310,310,19,4,15,2,1
2,344,344,59,59,0,1,0
16,346,346,32,28,4,2,1
0,352,352,7,7,0,1,0
32,380,380,65,65,0,1,0
15,384,384,19,19,0,1,0
7,390,390,50,6,44,3,2
23,394,394,35,20,15,4,3
24,411,411,58,52,6,2,1
12,421,421,45,3,42,4,3
21,438,438,9,9,0,1,0
6,440,440,6,3,3,2,1
19,442,442,46,46,0,1,0
29,470,470,33,33,0,1,0
25,500,500,41,41,0,1,0

0,103,103,4,4,0,1,0
18,133,133,9,9,0,1,0
19,139,139,2,2,0,1,0
23,141,141,26,5,21,4,3
27,154,154,11,6,5,2,1
14,183,183,3,3,0,1,0
8,188,188,9,6,3,2,1
5,212,212,16,16,0,1,0
16,220,220,5,5,0,1,0
13,250,250,30,5,25,2,1
12,277,277,20,2,18,4,3
17,277,277,36,3,33,2,1
29,329,329,45,45,0,1,0
15,330,330,7,1,6,3,2
4,332,332,52,52,0,1,0
9,339,339,124,124,0,1,0
10,357,357,60,60,0,1,0
26,363,363,72,50,22,2,1
21,387,387,43,15,28,3,2
7,406,406,8,8,0,1,0
28,415,415,126,54,72,4,3
2,430,430,45,45,0,1,0
24,431,431,21,21,0,1,0
1,443,443,26,1,25,2,1
25,453,453,7,3,4,2,1
20,471,471,30,30,0,1,0
11,474,474,132,132,0,1,0
6,478,478,56,56,0,1,0
22,487,487,104,40,64,3,2
3,492,492,98,11,87,4,3

6,113,113,30,15,15,3,2
27,126,126,9,9,0,1,0
12,126,126,19,19,0,1,0
28,145,145,16,7,9,2,1
25,146,146,11,5,6,3,2
1,153,153,15,5,10,2,1
24,173,173,34,34,0,1,0
15,183,183,1,1,0,1,0
8,193,193,37,37,0,1,0
11,200,200,48,48,0,1,0
13,203,203,38,18,20,3,2
10,299,299,56,14,42,4,3
17,335,335,50,16,34,3,2
4,335,335,30,30,0,1,0
20,336,336,39,28,11,2,1
19,339,339,4,4,0,1,0
7,360,360,67,67,0,1,0
3,371,371,23,13,10,2,1
21,377,377,72,39,33,2,1
26,384,384,20,2,18,2,1
0,402,402,37,21,16,3,2
2,406,406,40,34,6,2,1
14,431,431,4,4,0,1,0
16,449,449,78,78,0,1,0
5,453,453,5,1,4,2,1
23,454,454,52,49,3,2,1
18,468,468,27,6,21,3,2
9,471,471,84,18,66,4,3
22,493,493,30,18,12,2,1

10,100,100,6,6,0,1,0
5,151,151,3,3,0,1,0
0,160,160,32,26,6,3,2
9,175,175,19,19,0,1,0
19,177,177,5,5,0,1,0
24,195,195,20,20,0,1,0
11,222,222,1,1,0,1,0
38,234,234,15,7,8,3,2
21,239,239,2,2,0,1,0
31,245,245,3,3,0,1,0
2,256,256,17,10,7,2,1
30,264,264,11,11,0,1,0
32,276,276,7,2,5,2,1
12,297,297,12,12,0,1,0
17,303,303,45,45,0,1,0
8,303,303,30,9,21,2,1
7,310,310,27,24,3,2,1
22,310,310,17,4,13,2,1
14,314,314,1,1,0,1,0
34,321,321,60,60,0,1,0
35,328,328,1,1,0,1,0
23,338,338,173,97,76,3,2
20,345,345,2,2,0,1,0
15,385,385,12,12,0,1,0
1,395,395,106,34,72,4,3
3,396,396,75,75,0,1,0
36,398,398,13,2,11,2,1
37,418,418,16,16,0,1,0
18,419,419,22,22,0,1,0
33,444,444,65,41,24,4,3
29,445,445,35,2,33,2,1
4,446,446,12,6,6,3,2
13,463,463,12,12,0,1,0
25,463,463,11,11,0,1,0
39,466,466,42,30,12,3,2
27,472,472,32,12,20,2,1
26,472,472,45,21,24,4,3
28,474,474,96,96,0,1,0
16,483,483,39,39,0,1,0
6,498,498,46,4,42,3,2

11,103,103,6,6,0,1,0
25,107,107,10,4,6,2,1
1,115,115,28,21,7,3,2
14,120,120,6,3,3,2,1
10,127,127,20,2,18,3,2
3,134,134,1,1,0,1,0
18,138,138,7,7,0,1,0
21,138,138,5,5,0,1,0
20,166,166,1,1,0,1,0
2,167,167,3,3,0,1,0
16,223,223,8,2,6,2,1
7,223,223,6,6,0,1,0
30,233,233,9,4,5,2,1
29,238,238,25,10,15,4,3
23,246,246,9,9,0,1,0
26,274,274,54,54,0,1,0
5,294,294,3,3,0,1,0
4,300,300,5,2,3,2,1
12,302,302,40,29,11,2,1
36,310,310,52,19,33,4,3
13,319,319,57,19,38,2,1
8,339,339,9,9,0,1,0
28,342,342,82,40,42,3,2
37,365,365,8,4,4,2,1
34,367,367,43,37,6,2,1
15,370,370,44,44,0,1,0
0,371,371,48,48,0,1,0
24,377,377,1,1,0,1,0
19,400,400,27,1,26,2,1
9,410,410,5,5,0,1,0
33,455,455,71,40,31,2,1
17,461,461,118,76,42,4,3
27,472,472,16,3,13,2,1
31,489,489,64,20,44,4,3
35,492,492,94,94,0,1,0
22,493,493,30,6,24,2,1
6,497,497,49,49,0,1,0
32,498,498,53,43,10,2,1

8,100,100,9,9,0,1,0
9,111,111,4,4,0,1,0
5,144,144,2,2,0,1,0
27,156,156,16,2,14,2,1
22,157,157,5,5,0,1,0
18,173,173,17,2,15,2,1
20,174,174,5,5,0,1,0
1,209,209,1,1,0,1,0
4,211,211,36,36,0,1,0
11,225,225,36,12,24,2,1
6,237,237,14,14,0,1,0
31,247,247,4,1,3,2,1
25,255,255,61,28,33,4,3
0,261,261,45,20,25,2,1
28,282,282,111,102,9,4,3
3,284,284,8,8,0,1,0
21,286,286,15,12,3,2,1
12,296,296,8,8,0,1,0
35,311,311,14,5,9,4,3
26,315,315,53,53,0,1,0
15,321,321,83,62,21,4,3
29,324,324,21,21,0,1,0
30,342,342,36,36,0,1,0
14,344,344,1,1,0,1,0
10,347,347,15,5,10,3,2
17,348,348,22,22,0,1,0
34,364,364,16,16,0,1,0
32,384,384,65,65,0,1,0
23,392,392,49,49,0,1,0
16,404,404,66,66,0,1,0
24,429,429,2,2,0,1,0
7,454,454,64,23,41,2,1
13,454,454,16,8,8,2,1
19,458,458,48,48,0,1,0
33,467,467,17,10,7,2,1
2,487,487,66,66,0,1,0

6,101,101,11,7,4,2,1
18,139,139,23,13,10,3,2
8,140,140,7,4,3,2,1
11,160,160,4,4,0,1,0
9,164,164,6,6,0,1,0
35,196,196,14,14,0,1,0
16,214,214,12,12,0,1,0
27,215,215,6,3,3,2,1
12,223,223,11,2,9,2,1
2,231,231,14,5,9,4,3
0,238,238,15,12,3,2,1
17,248,248,15,3,12,4,3
36,255,255,8,8,0,1,0
31,278,278,42,42,0,1,0
1,300,300,22,22,0,1,0
22,310,310,46,46,0,1,0
34,324,324,17,17,0,1,0
19,336,336,70,70,0,1,0
10,339,339,40,2,38,2,1
13,343,343,26,8,18,3,2
4,344,344,25,6,19,4,3
28,351,351,57,30,27,2,1
25,358,358,89,89,0,1,0
33,360,360,13,6,7,2,1
29,362,362,42,42,0,1,0
37,364,364,98,98,0,1,0
38,366,366,14,14,0,1,0
20,368,368,25,12,13,2,1
24,374,374,26,14,12,3,2
5,385,385,14,2,12,3,2
15,385,385,30,30,0,1,0
14,394,394,12,8,4,2,1
7,395,395,4,4,0,1,0
21,409,409,91,58,33,2,1
30,411,411,7,4,3,2,1
3,466,466,15,15,0,1,0
23,472,472,51,25,26,3,2
26,477,477,26,17,9,2,1
32,481,481,57,1,56,3,2

15,109,109,23,23,0,1,0
29,111,111,21,21,0,1,0
12,118,118,4,4,0,1,0
1,125,125,5,1,4,2,1
5,131,131,70,70,0,1,0
32,132,132,24,24,0,1,0
24,149,149,5,5,0,1,0
18,172,172,8,8,0,1,0
26,176,176,15,15,0,1,0
4,194,194,4,4,0,1,0
9,197,197,15,2,13,2,1
3,206,206,10,7,3,2,1
19,210,210,46,16,30,4,3
16,217,217,21,21,0,1,0
20,236,236,29,10,19,2,1
28,256,256,19,9,10,2,1
7,256,256,26,13,13,2,1
17,265,265,9,3,6,3,2
0,284,284,10,3,7,2,1
30,295,295,16,3,13,2,1
8,329,329,14,8,6,2,1
27,333,333,6,6,0,1,0
34,344,344,51,15,36,3,2
2,345,345,19,19,0,1,0
21,377,377,5,5,0,1,0
23,383,383,22,22,0,1,0
13,386,386,41,41,0,1,0
10,395,395,24,24,0,1,0
33,402,402,12,12,0,1,0
11,415,415,5,5,0,1,0
6,425,425,22,10,12,4,3
22,444,444,130,61,69,4,3
35,448,448,54,54,0,1,0
31,454,454,15,15,0,1,0
14,472,472,45,45,0,1,0
25,474,474,26,26,0,1,0

6,101,101,1,1,0,1,0
17,103,103,1,1,0,1,0
9,104,104,8,1,7,2,1
2,107,107,14,4,10,3,2
22,107,107,11,11,0,1,0
0,123,123,21,2,19,2,1
20,126,126,16,2,14,2,1
3,127,127,34,22,12,3,2
7,133,133,4,1,3,2,1
8,151,151,29,23,6,3,2
28,157,157,13,13,0,1,0
1,175,175,1,1,0,1,0
14,194,194,36,36,0,1,0
35,198,198,3,3,0,1,0
24,198,198,27,27,0,1,0
4,215,215,13,13,0,1,0
18,245,245,9,3,6,2,1
29,265,265,5,5,0,1,0
33,271,271,18,11,7,2,1
34,281,281,38,19,19,2,1
31,290,290,4,4,0,1,0
26,300,300,9,9,0,1,0
10,316,316,3,3,0,1,0
23,319,319,117,33,84,4,3
11,327,327,16,16,0,1,0
21,337,337,13,1,12,3,2
5,337,337,25,7,18,4,3
27,357,357,3,3,0,1,0
15,381,381,9,9,0,1,0
32,382,382,25,25,0,1,0
25,397,397,59,13,46,3,2
36,404,404,114,42,72,4,3
30,425,425,38,18,20,3,2
13,448,448,1,1,0,1,0
12,452,452,3,3,0,1,0
19,478,478,44,12,32,3,2
16,500,500,134,106,28,2,1

13,116,116,9,9,0,1,0
17,120,120,5,2,3,2,1
16,155,155,27,12,15,4,3
7,160,160,7,7,0,1,0
15,171,171,19,8,11,2,1
23,176,176,3,3,0,1,0
34,188,188,15,6,9,2,1
20,195,195,16,12,4,2,1
1,199,199,1,1,0,1,0
8,199,199,14,14,0,1,0
6,204,204,18,18,0,1,0
21,211,211,4,4,0,1,0
5,229,229,13,1,12,3,2
19,229,229,2,2,0,1,0
4,239,239,4,4,0,1,0
10,268,268,43,40,3,2,1
2,285,285,110,92,18,3,2
32,293,293,28,7,21,2,1
25,308,308,15,6,9,4,3
12,309,309,39,31,8,2,1
18,327,327,14,14,0,1,0
27,352,352,130,62,68,3,2
28,357,357,58,25,33,2,1
9,379,379,26,26,0,1,0
26,383,383,23,12,11,2,1
29,385,385,40,27,13,2,1
11,387,387,22,22,0,1,0
30,418,418,2,2,0,1,0
24,434,434,19,10,9,2,1
3,435,435,2,2,0,1,0
14,450,450,3,3,0,1,0
31,459,459,45,27,18,4,3
0,464,464,97,41,56,4,3
33,478,478,51,51,0,1,0
22,484,484,188,173,15,2,1

19,102,102,7,7,0,1,0
31,108,108,11,2,9,4,3
30,124,124,20,2,18,2,1
3,126,126,23,23,0,1,0
23,143,143,20,1,19,2,1
26,144,144,14,14,0,1,0
15,152,152,1,1,0,1,0
24,158,158,29,6,23,2,1
28,160,160,5,5,0,1,0
33,180,180,31,5,26,4,3
5,200,200,12,12,0,1,0
10,200,200,44,44,0,1,0
21,205,205,29,9,20,2,1
17,208,208,50,50,0,1,0
4,236,236,12,12,0,1,0
0,237,237,4,1,3,2,1
11,252,252,1,1,0,1,0
36,273,273,50,41,9,2,1
20,275,275,6,1,5,2,1
9,321,321,58,33,25,2,1
8,323,323,50,50,0,1,0
14,337,337,13,13,0,1,0
35,341,341,68,8,60,3,2
12,343,343,7,7,0,1,0
16,358,358,20,20,0,1,0
7,371,371,46,46,0,1,0
18,388,388,1,1,0,1,0
1,392,392,3,3,0,1,0
29,396,396,8,8,0,1,0
27,398,398,16,7,9,2,1
34,430,430,33,33,0,1,0
2,439,439,25,4,21,2,1
13,445,445,66,66,0,1,0
6,464,464,29,7,22,3,2
22,482,482,59,59,0,1,0
32,484,484,13,3,10,3,2
25,495,495,13,1,12,2,1

7,108,108,30,6,24,4,3
9,111,111,33,33,0,1,0
21,119,119,2,2,0,1,0
14,147,147,24,5,19,2,1
13,163,163,1,1,0,1,0
18,166,166,57,57,0,1,0
26,170,170,7,7,0,1,0
24,185,185,8,8,0,1,0
0,189,189,5,5,0,1,0
17,210,210,1,1,0,1,0
19,236,236,27,13,14,2,1
6,241,241,1,1,0,1,0
23,250,250,8,5,3,2,1
29,260,260,51,51,0,1,0
15,264,264,32,2,30,3,2
22,279,279,28,28,0,1,0
12,301,301,26,21,5,2,1
2,327,327,3,3,0,1,0
31,333,333,29,29,0,1,0
20,335,335,6,6,0,1,0
27,338,338,17,6,11,2,1
8,341,341,95,53,42,2,1
1,378,378,35,18,17,2,1
30,405,405,78,12,66,4,3
32,417,417,124,124,0,1,0
11,424,424,5,2,3,2,1
3,428,428,33,6,27,2,1
16,462,462,39,21,18,2,1
10,472,472,108,108,0,1,0
28,481,481,49,49,0,1,0
5,481,481,1,1,0,1,0
25,496,496,1,1,0,1,0
4,498,498,10,4,6,3,2

4,102,102,8,8,0,1,0
1,108,108,3,3,0,1,0
8,117,117,9,9,0,1,0
20,124,124,44,44,0,1,0
11,148,148,4,4,0,1,0
10,158,158,27,19,8,2,1
6,196,196,1,1,0,1,0
23,199,199,34,4,30,3,2
30,200,200,4,4,0,1,0
19,208,208,9,5,4,2,1
18,218,218,9,9,0,1,0
0,225,225,6,6,0,1,0
21,235,235,21,16,5,2,1
31,237,237,5,5,0,1,0
22,242,242,20,7,13,2,1
13,243,243,8,8,0,1,0
27,250,250,2,2,0,1,0
7,267,267,1,1,0,1,0
9,321,321,165,165,0,1,0
26,325,325,37,37,0,1,0
12,358,358,32,32,0,1,0
3,383,383,18,18,0,1,0
14,393,393,71,25,46,2,1
25,420,420,47,28,19,2,1
29,427,427,61,35,26,4,3
5,428,428,33,12,21,4,3
2,447,447,154,145,9,4,3
28,457,457,71,71,0,1,0
16,465,465,130,44,86,3,2
24,466,466,24,21,3,2,1
15,483,483,14,14,0,1,0
17,491,491,4,4,0,1,0

30,158,158,14,5,9,2,1
17,190,190,43,43,0,1,0
10,191,191,13,13,0,1,0
0,200,200,2,2,0,1,0
9,204,204,65,7,58,4,3
27,225,225,31,31,0,1,0
5,227,227,33,13,20,3,2
19,251,251,23,23,0,1,0
22,253,253,2,2,0,1,0
20,253,253,12,12,0,1,0
18,255,255,21,21,0,1,0
16,272,272,8,4,4,2,1
2,276,276,49,49,0,1,0
13,283,283,5,5,0,1,0
1,331,331,7,7,0,1,0
23,338,338,3,3,0,1,0
12,345,345,101,93,8,2,1
4,355,355,57,22,35,4,3
24,370,370,78,53,25,3,2
28,370,370,106,46,60,4,3
15,370,370,46,22,24,2,1
11,373,373,26,4,22,3,2
7,393,393,44,8,36,4,3
29,393,393,55,51,4,2,1
6,417,417,4,1,3,2,1
3,423,423,6,6,0,1,0
21,447,447,19,3,16,2,1
26,469,469,43,16,27,2,1
25,470,470,33,33,0,1,0
8,473,473,135,135,0,1,0
14,492,492,21,21,0,1,0

8,132,132,19,4,15,4,3
27,134,134,53,53,0,1,0
12,135,135,12,12,0,1,0
14,136,136,12,1,11,2,1
15,143,143,6,6,0,1,0
10,144,144,14,14,0,1,0
5,148,148,58,40,18,2,1
2,164,164,9,9,0,1,0
9,176,176,9,9,0,1,0
23,177,177,19,13,6,2,1
18,185,185,1,1,0,1,0
22,227,227,9,1,8,3,2
21,240,240,15,5,10,2,1
20,264,264,29,23,6,3,2
0,270,270,55,45,10,2,1
13,299,299,11,11,0,1,0
26,305,305,48,38,10,2,1
11,313,313,46,21,25,2,1
6,318,318,14,14,0,1,0
28,333,333,46,46,0,1,0
1,343,343,51,51,0,1,0
17,347,347,11,11,0,1,0
19,371,371,25,25,0,1,0
25,407,407,71,52,19,2,1
24,426,426,39,16,23,2,1
3,468,468,84,33,51,4,3
4,472,472,8,8,0,1,0
7,473,473,105,99,6,3,2
16,475,475,43,43,0,1,0

16,101,101,2,2,0,1,0
20,110,110,10,10,0,1,0
9,114,114,27,27,0,1,0
11,121,121,24,3,21,3,2
24,145,145,30,30,0,1,0
5,177,177,1,1,0,1,0
1,178,178,66,66,0,1,0
2,200,200,1,1,0,1,0
21,201,201,47,39,8,2,1
23,204,204,29,29,0,1,0
31,214,214,33,4,29,2,1
13,225,225,18,18,0,1,0
4,242,242,4,4,0,1,0
6,256,256,37,37,0,1,0
27,261,261,44,16,28,3,2
28,266,266,38,38,0,1,0
14,300,300,1,1,0,1,0
8,321,321,137,86,51,4,3
18,330,330,22,13,9,4,3
15,337,337,20,2,18,3,2
12,349,349,3,3,0,1,0
26,351,351,4,4,0,1,0
25,364,364,24,24,0,1,0
0,381,381,49,49,0,1,0
10,402,402,21,21,0,1,0
7,413,413,1,1,0,1,0
30,421,421,91,43,48,4,3
19,460,460,18,2,16,4,3
17,471,471,30,1,29,2,1
3,475,475,10,10,0,1,0
29,487,487,24,20,4,2,1
22,490,490,1,1,0,1,0

24,102,102,6,3,3,2,1
2,115,115,2,2,0,1,0
8,121,121,3,3,0,1,0
32,126,126,9,9,0,1,0
12,127,127,84,84,0,1,0
30,132,132,13,13,0,1,0
15,138,138,1,1,0,1,0
11,148,148,9,4,5,2,1
0,154,154,1,1,0,1,0
20,206,206,40,4,36,3,2
29,210,210,15,8,7,2,1
3,212,212,26,2,24,2,1
10,220,220,23,1,22,3,2
27,226,226,19,19,0,1,0
4,251,251,1,1,0,1,0
26,275,275,14,14,0,1,0
14,294,294,14,14,0,1,0
16,304,304,64,36,28,2,1
31,306,306,46,46,0,1,0
22,309,309,3,3,0,1,0
23,323,323,29,29,0,1,0
21,327,327,27,27,0,1,0
1,329,329,10,10,0,1,0
13,358,358,9,9,0,1,0
18,386,386,49,13,36,4,3
9,400,400,107,95,12,3,2
5,424,424,57,57,0,1,0
28,442,442,125,52,73,3,2
19,455,455,17,17,0,1,0
25,469,469,28,2,26,3,2
17,472,472,27,8,19,2,1
7,476,476,58,23,35,4,3
6,495,495,34,34,0,1,0

18,102,102,19,7,12,2,1
4,115,115,1,1,0,1,0
6,118,118,7,3,4,2,1
7,153,153,27,27,0,1,0
17,153,153,14,4,10,3,2
34,156,156,1,1,0,1,0
41,169,169,38,3,35,2,1
40,169,169,7,3,4,2,1
23,171,171,1,1,0,1,0
29,173,173,25,25,0,1,0
33,237,237,43,43,0,1,0
28,254,254,14,14,0,1,0
5,264,264,20,5,15,2,1
11,268,268,7,1,6,3,2
1,268,268,15,6,9,4,3
12,270,270,44,14,30,4,3
37,292,292,1,1,0,1,0
27,299,299,35,15,20,3,2
0,305,305,8,8,0,1,0
19,312,312,4,4,0,1,0
8,318,318,51,51,0,1,0
9,331,331,7,7,0,1,0
31,336,336,13,13,0,1,0
16,340,340,4,4,0,1,0
10,353,353,33,9,24,2,1
25,356,356,53,53,0,1,0
15,359,359,29,6,23,2,1
30,365,365,52,17,35,4,3
38,385,385,10,2,8,3,2
36,385,385,67,67,0,1,0
35,405,405,24,24,0,1,0
22,408,408,88,8,80,4,3
21,411,411,13,9,4,2,1
24,415,415,2,2,0,1,0
39,415,415,82,43,39,3,2
13,437,437,8,8,0,1,0
32,463,463,40,25,15,4,3
2,464,464,1,1,0,1,0
26,468,468,38,30,8,3,2
14,484,484,49,49,0,1,0
20,485,485,24,15,9,4,3
3,489,489,11,11,0,1,0

27,102,102,3,3,0,1,0
13,112,112,2,2,0,1,0
15,120,120,9,9,0,1,0
23,128,128,1,1,0,1,0
0,134,134,11,11,0,1,0
1,142,142,3,3,0,1,0
21,146,146,10,10,0,1,0
6,163,163,19,1,18,4,3
14,186,186,29,29,0,1,0
12,191,191,13,3,10,2,1
20,198,198,17,12,5,2,1
8,199,199,11,2,9,2,1
33,220,220,7,1,6,3,2
10,231,231,20,20,0,1,0
11,244,244,16,11,5,2,1
16,251,251,23,23,0,1,0
3,252,252,9,3,6,3,2
26,265,265,40,27,13,2,1
9,283,283,11,11,0,1,0
2,286,286,79,79,0,1,0
7,292,292,8,5,3,2,1
34,306,306,28,28,0,1,0
28,324,324,75,21,54,4,3
19,324,324,1,1,0,1,0
32,343,343,78,39,39,4,3
29,347,347,21,9,12,4,3
31,349,349,16,7,9,4,3
30,359,359,11,11,0,1,0
35,363,363,58,44,14,2,1
5,368,368,72,72,0,1,0
22,371,371,25,25,0,1,0
24,394,394,22,6,16,2,1
25,404,404,53,3,50,3,2
4,426,426,13,13,0,1,0
17,441,441,11,11,0,1,0
36,489,489,122,34,88,3,2
18,491,491,114,114,0,1,0

28,115,115,6,6,0,1,0
20,138,138,16,3,13,2,1
1,153,153,12,12,0,1,0
2,159,159,1,1,0,1,0
15,181,181,10,5,5,2,1
18,201,201,14,14,0,1,0
4,214,214,71,29,42,4,3
6,226,226,33,14,19,2,1
24,228,228,39,39,0,1,0
21,242,242,26,20,6,3,2
14,255,255,17,17,0,1,0
9,256,256,46,46,0,1,0
13,264,264,13,3,10,3,2
23,267,267,2,2,0,1,0
5,293,293,35,23,12,2,1
12,299,299,1,1,0,1,0
22,313,313,26,22,4,2,1
32,318,318,18,18,0,1,0
29,327,327,14,5,9,4,3
31,338,338,98,98,0,1,0
30,343,343,28,6,22,3,2
10,353,353,15,3,12,4,3
25,374,374,19,5,14,3,2
7,386,386,22,22,0,1,0
16,410,410,30,30,0,1,0
8,438,438,73,44,29,2,1
27,443,443,37,16,21,2,1
3,452,452,28,12,16,2,1
11,456,456,58,58,0,1,0
0,458,458,98,98,0,1,0
17,459,459,27,10,17,2,1
19,487,487,119,63,56,4,3
26,496,496,72,45,27,4,3

4,106,106,20,20,0,1,0
22,123,123,20,20,0,1,0
11,135,135,1,1,0,1,0
30,140,140,11,11,0,1,0
12,161,161,3,3,0,1,0
27,163,163,24,24,0,1,0
14,167,167,16,16,0,1,0
0,172,172,64,64,0,1,0
5,175,175,6,3,3,2,1
19,205,205,13,13,0,1,0
3,209,209,35,35,0,1,0
20,211,211,1,1,0,1,0
26,214,214,2,2,0,1,0
29,220,220,60,16,44,3,2
15,233,233,17,17,0,1,0
24,236,236,8,8,0,1,0
6,262,262,19,7,12,3,2
9,270,270,65,25,40,3,2
28,289,289,50,32,18,4,3
10,293,293,3,3,0,1,0
2,309,309,73,73,0,1,0
17,332,332,4,4,0,1,0
25,337,337,130,43,87,4,3
23,367,367,7,7,0,1,0
18,378,378,55,25,30,4,3
7,379,379,25,9,16,3,2
8,418,418,20,15,5,2,1
21,455,455,6,6,0,1,0
1,487,487,9,9,0,1,0
16,494,494,21,21,0,1,0
13,497,497,110,59,51,4,3

20,100,100,29,4,25,2,1
11,104,104,11,11,0,1,0
25,120,120,8,8,0,1,0
7,120,120,2,2,0,1,0
16,122,122,14,14,0,1,0
8,165,165,4,4,0,1,0
21,175,175,7,7,0,1,0
26,186,186,13,13,0,1,0
28,203,203,8,2,6,3,2
3,203,203,14,3,11,2,1
27,204,204,10,10,0,1,0
15,212,212,8,8,0,1,0
30,221,221,26,26,0,1,0
18,229,229,99,58,41,2,1
29,237,237,28,1,27,4,3
13,240,240,1,1,0,1,0
17,246,246,8,8,0,1,0
32,260,260,8,5,3,2,1
12,261,261,17,14,3,2,1
24,272,272,23,20,3,2,1
36,296,296,7,1,6,2,1
5,343,343,15,15,0,1,0
19,355,355,38,38,0,1,0
1,356,356,1,1,0,1,0
4,369,369,45,45,0,1,0
10,373,373,9,9,0,1,0
22,377,377,61,61,0,1,0
0,383,383,15,15,0,1,0
33,388,388,49,19,30,4,3
14,411,411,29,29,0,1,0
35,427,427,84,84,0,1,0
34,428,428,59,59,0,1,0
31,429,429,67,19,48,3,2
23,436,436,13,4,9,4,3
9,437,437,45,25,20,2,1
2,440,440,103,58,45,2,1
6,498,498,26,17,9,2,1

27,100,100,7,3,4,2,1
3,116,116,1,1,0,1,0
1,123,123,14,14,0,1,0
25,128,128,10,10,0,1,0
16,138,138,18,1,17,2,1
26,141,141,30,30,0,1,0
24,149,149,15,3,12,4,3
10,159,159,3,3,0,1,0
6,190,190,14,14,0,1,0
23,213,213,1,1,0,1,0
14,265,265,45,5,40,3,2
9,281,281,68,68,0,1,0
28,323,323,6,1,5,2,1
19,323,323,15,5,10,4,3
21,325,325,90,90,0,1,0
33,335,335,15,5,10,3,2
12,341,341,65,15,50,2,1
15,351,351,12,12,0,1,0
7,360,360,19,19,0,1,0
4,385,385,35,20,15,4,3
17,388,388,33,33,0,1,0
30,389,389,13,4,9,2,1
29,410,410,70,70,0,1,0
18,417,417,62,13,49,2,1
20,431,431,109,109,0,1,0
5,438,438,6,6,0,1,0
0,441,441,16,16,0,1,0
8,442,442,18,18,0,1,0
2,452,452,154,98,56,3,2
31,456,456,25,1,24,3,2
13,459,459,59,59,0,1,0
22,463,463,30,30,0,1,0
32,482,482,34,6,28,2,1
11,482,482,9,9,0,1,0

28,101,101,10,10,0,1,0
24,102,102,8,8,0,1,0
32,113,113,11,11,0,1,0
25,113,113,8,1,7,2,1
17,115,115,7,7,0,1,0
34,118,118,20,4,16,2,1
21,140,140,1,1,0,1,0
8,152,152,9,5,4,2,1
29,154,154,3,3,0,1,0
36,175,175,8,8,0,1,0
13,178,178,16,12,4,2,1
15,184,184,28,28,0,1,0
10,193,193,22,22,0,1,0
7,209,209,14,14,0,1,0
31,223,223,31,9,22,3,2
18,230,230,4,4,0,1,0
5,233,233,11,6,5,2,1
4,251,251,8,4,4,2,1
16,252,252,19,19,0,1,0
9,268,268,17,17,0,1,0
33,277,277,8,5,3,2,1
14,283,283,11,3,8,2,1
35,313,313,12,12,0,1,0
6,326,326,6,6,0,1,0
1,338,338,99,10,89,4,3
37,351,351,30,6,24,2,1
19,360,360,10,10,0,1,0
27,372,372,131,83,48,3,2
30,386,386,5,5,0,1,0
2,411,411,20,20,0,1,0
11,412,412,134,44,90,3,2
23,415,415,42,12,30,3,2
26,423,423,40,16,24,3,2
38,430,430,62,62,0,1,0
12,436,436,11,11,0,1,0
0,447,447,13,3,10,2,1
22,481,481,72,72,0,1,0
20,487,487,50,50,0,1,0
3,487,487,5,2,3,2,1

17,110,110,18,18,0,1,0
8,110,110,7,7,0,1,0
0,136,136,7,2,5,2,1
5,139,139,1,1,0,1,0
31,151,151,22,9,13,2,1
21,163,163,5,5,0,1,0
7,193,193,12,12,0,1,0
35,200,200,23,11,12,4,3
29,211,211,16,9,7,2,1
12,213,213,1,1,0,1,0
28,234,234,5,5,0,1,0
32,256,256,7,1,6,2,1
6,273,273,67,27,40,4,3
10,273,273,26,5,21,2,1
9,283,283,40,21,19,2,1
34,327,327,71,3,68,4,3
2,349,349,7,7,0,1,0
14,370,370,15,8,7,2,1
36,373,373,26,3,23,2,1
24,382,382,43,1,42,2,1
18,385,385,1,1,0,1,0
15,385,385,14,1,13,2,1
20,388,388,13,5,8,2,1
33,397,397,52,4,48,2,1
26,400,400,45,19,26,3,2
22,413,413,6,6,0,1,0
11,419,419,13,5,8,2,1
19,429,429,83,20,63,4,3
25,434,434,23,23,0,1,0
30,438,438,22,22,0,1,0
3,445,445,16,16,0,1,0
16,449,449,65,47,18,4,3
1,453,453,70,52,18,4,3
4,461,461,60,4,56,3,2
23,469,469,56,56,0,1,0
13,476,476,37,13,24,3,2
27,496,496,201,201,0,1,0

27,109,109,3,3,0,1,0
23,112,112,20,10,10,3,2
30,114,114,48,1,47,2,1
20,131,131,37,25,12,4,3
0,139,139,18,18,0,1,0
2,147,147,24,6,18,3,2
5,153,153,16,3,13,2,1
24,164,164,14,14,0,1,0
21,184,184,24,17,7,2,1
33,196,196,1,1,0,1,0
3,232,232,22,13,9,4,3
10,258,258,20,8,12,3,2
4,263,263,57,57,0,1,0
6,275,275,4,4,0,1,0
22,276,276,27,6,21,2,1
26,295,295,7,7,0,1,0
8,297,297,31,31,0,1,0
18,297,297,11,11,0,1,0
14,312,312,31,31,0,1,0
31,314,314,65,65,0,1,0
32,320,320,21,8,13,4,3
13,361,361,94,73,21,2,1
15,370,370,6,6,0,1,0
1,377,377,36,11,25,2,1
7,381,381,35,35,0,1,0
12,384,384,14,14,0,1,0
19,387,387,2,2,0,1,0
9,406,406,9,9,0,1,0
29,412,412,10,10,0,1,0
17,417,417,49,49,0,1,0
11,448,448,3,3,0,1,0
28,458,458,4,4,0,1,0
16,466,466,23,23,0,1,0
34,477,477,62,62,0,1,0
25,491,491,7,7,0,1,0

5,118,118,31,13,18,4,3
22,131,131,19,19,0,1,0
2,144,144,18,18,0,1,0
7,169,169,16,4,12,3,2
30,211,211,9,3,6,2,1
12,220,220,20,20,0,1,0
8,230,230,3,3,0,1,0
17,233,233,1,1,0,1,0
1,244,244,45,45,0,1,0
25,244,244,15,5,10,2,1
27,246,246,3,3,0,1,0
33,251,251,1,1,0,1,0
23,261,261,183,60,123,4,3
19,288,288,48,48,0,1,0
21,295,295,18,12,6,2,1
29,297,297,2,2,0,1,0
6,302,302,54,40,14,2,1
0,305,305,28,16,12,3,2
26,331,331,4,4,0,1,0
31,346,346,22,14,8,2,1
16,363,363,15,15,0,1,0
13,368,368,3,3,0,1,0
10,372,372,36,36,0,1,0
24,377,377,7,7,0,1,0
20,389,389,28,28,0,1,0
18,418,418,15,15,0,1,0
15,421,421,13,1,12,4,3
11,428,428,14,14,0,1,0
32,431,431,128,8,120,4,3
4,440,440,106,106,0,1,0
28,441,441,10,10,0,1,0
14,441,441,4,4,0,1,0
3,459,459,24,9,15,2,1
9,483,483,71,71,0,1,0

24,113,113,27,3,24,3,2
8,117,117,8,8,0,1,0
11,120,120,6,6,0,1,0
22,126,126,3,3,0,1,0
14,128,128,18,6,12,4,3
26,139,139,27,27,0,1,0
16,153,153,7,7,0,1,0
7,168,168,8,5,3,2,1
13,170,170,2,2,0,1,0
0,213,213,10,10,0,1,0
4,222,222,38,6,32,2,1
20,253,253,51,51,0,1,0
28,256,256,1,1,0,1,0
21,287,287,86,86,0,1,0
3,294,294,153,104,49,3,2
1,295,295,3,3,0,1,0
18,296,296,36,14,22,2,1
12,328,328,43,43,0,1,0
2,365,365,53,53,0,1,0
23,394,394,32,3,29,2,1
19,402,402,10,10,0,1,0
10,413,413,62,48,14,3,2
17,428,428,6,6,0,1,0
15,433,433,46,46,0,1,0
5,449,449,1,1,0,1,0
6,485,485,222,222,0,1,0
9,487,487,17,5,12,2,1
25,489,489,5,2,3,2,1
27,492,492,40,40,0,1,0

2,121,121,5,1,4,2,1
26,131,131,3,3,0,1,0
44,134,134,10,10,0,1,0
22,141,141,2,2,0,1,0
43,145,145,3,3,0,1,0
17,150,150,6,6,0,1,0
15,155,155,1,1,0,1,0
4,195,195,13,13,0,1,0
3,207,207,8,8,0,1,0
16,210,210,39,39,0,1,0
41,210,210,7,7,0,1,0
23,216,216,13,13,0,1,0
29,221,221,10,10,0,1,0
40,232,232,50,50,0,1,0
48,244,244,9,9,0,1,0
45,244,244,64,31,33,4,3
19,244,244,2,2,0,1,0
42,249,249,24,24,0,1,0
21,253,253,15,5,10,2,1
11,262,262,32,13,19,2,1
28,291,291,3,3,0,1,0
5,305,305,16,6,10,3,2
36,316,316,47,11,36,2,1
47,321,321,58,34,24,4,3
31,337,337,8,8,0,1,0
35,338,338,4,1,3,2,1
30,338,338,32,14,18,3,2
0,340,340,6,6,0,1,0
37,342,342,33,33,0,1,0
8,366,366,17,4,13,2,1
27,376,376,30,17,13,2,1
1,387,387,7,1,6,2,1
25,389,389,11,11,0,1,0
6,393,393,13,13,0,1,0
32,395,395,3,3,0,1,0
10,406,406,42,42,0,1,0
39,413,413,25,25,0,1,0
24,415,415,1,1,0,1,0
9,432,432,7,2,5,2,1
14,436,436,17,1,16,3,2
38,467,467,157,70,87,4,3
18,470,470,16,16,0,1,0
7,474,474,34,12,22,3,2
12,475,475,80,80,0,1,0
20,479,479,4,4,0,1,0
34,481,481,49,49,0,1,0
13,483,483,69,6,63,4,3
46,493,493,3,3,0,1,0
33,494,494,23,18,5,2,1

9,115,115,4,4,0,1,0
4,128,128,23,23,0,1,0
19,135,135,7,7,0,1,0
14,140,140,17,17,0,1,0
27,172,172,29,19,10,2,1
17,184,184,10,10,0,1,0
28,197,197,5,5,0,1,0
7,198,198,63,63,0,1,0
0,201,201,18,18,0,1,0
31,208,208,52,16,36,3,2
20,208,208,11,3,8,2,1
21,218,218,14,2,12,2,1
26,234,234,49,49,0,1,0
1,235,235,63,31,32,2,1
10,238,238,28,28,0,1,0
6,257,257,13,13,0,1,0
3,292,292,46,46,0,1,0
25,310,310,6,6,0,1,0
8,317,317,36,36,0,1,0
29,322,322,20,20,0,1,0
5,323,323,18,8,10,2,1
18,330,330,34,14,20,2,1
30,334,334,14,5,9,4,3
12,341,341,17,5,12,4,3
22,347,347,1,1,0,1,0
13,351,351,7,7,0,1,0
23,373,373,2,2,0,1,0
11,421,421,52,52,0,1,0
24,447,447,105,105,0,1,0
15,471,471,149,71,78,4,3
2,481,481,2,2,0,1,0
16,496,496,36,36,0,1,0

7,131,131,6,6,0,1,0
33,159,159,11,11,0,1,0
2,172,172,9,9,0,1,0
31,182,182,1,1,0,1,0
13,184,184,32,2,30,3,2
20,192,192,18,18,0,1,0
18,194,194,3,3,0,1,0
29,200,200,14,14,0,1,0
35,217,217,3,3,0,1,0
5,236,236,34,2,32,2,1
25,238,238,10,1,9,2,1
22,243,243,75,75,0,1,0
37,258,258,14,14,0,1,0
9,271,271,10,10,0,1,0
11,271,271,35,35,0,1,0
24,305,305,22,1,21,4,3
27,314,314,42,42,0,1,0
28,323,323,44,44,0,1,0
26,327,327,43,17,26,2,1
12,337,337,126,126,0,1,0
23,340,340,5,5,0,1,0
17,348,348,41,18,23,2,1
14,354,354,1,1,0,1,0
36,361,361,26,26,0,1,0
30,367,367,51,2,49,2,1
6,382,382,1,1,0,1,0
16,417,417,68,59,9,4,3
19,419,419,18,4,14,2,1
8,427,427,9,9,0,1,0
3,430,430,10,5,5,2,1
0,439,439,31,17,14,2,1
15,442,442,32,20,12,2,1
1,449,449,42,42,0,1,0
10,463,463,9,9,0,1,0
4,469,469,3,3,0,1,0
34,479,479,100,38,62,3,2
21,489,489,5,5,0,1,0
32,493,493,122,122,0,1,0

16,103,103,28,28,0,1,0
1,107,107,31,31,0,1,0
25,156,156,45,26,19,4,3
22,165,165,3,3,0,1,0
29,190,190,12,7,5,2,1
14,214,214,12,1,11,2,1
27,216,216,2,2,0,1,0
3,217,217,13,1,12,4,3
12,235,235,13,7,6,3,2
15,235,235,24,16,8,2,1
26,238,238,4,4,0,1,0
0,255,255,20,8,12,2,1
20,255,255,7,7,0,1,0
23,269,269,72,72,0,1,0
2,278,278,7,7,0,1,0
10,285,285,8,3,5,2,1
7,289,289,5,5,0,1,0
21,315,315,43,28,15,2,1
18,317,317,45,45,0,1,0
24,401,401,9,9,0,1,0
9,414,414,16,16,0,1,0
28,424,424,6,6,0,1,0
17,429,429,6,6,0,1,0
5,445,445,43,43,0,1,0
19,466,466,69,10,59,4,3
8,470,470,262,234,28,2,1
11,476,476,49,13,36,2,1
13,482,482,66,66,0,1,0
6,486,486,16,16,0,1,0
4,496,496,158,85,73,4,3

17,114,114,19,19,0,1,0
1,122,122,2,2,0,1,0
5,126,126,34,13,21,4,3
20,135,135,48,48,0,1,0
19,153,153,7,7,0,1,0
0,159,159,9,9,0,1,0
2,159,159,1,1,0,1,0
8,159,159,24,24,0,1,0
13,167,167,4,4,0,1,0
32,172,172,22,22,0,1,0
18,172,172,3,3,0,1,0
15,220,220,3,3,0,1,0
25,265,265,13,3,10,3,2
24,298,298,44,44,0,1,0
12,327,327,39,39,0,1,0
26,338,338,4,4,0,1,0
14,364,364,33,9,24,3,2
23,391,391,19,19,0,1,0
22,407,407,3,3,0,1,0
31,415,415,69,59,10,2,1
10,423,423,23,7,16,3,2
21,433,433,15,15,0,1,0
30,441,441,65,65,0,1,0
16,451,451,26,26,0,1,0
11,456,456,60,10,50,3,2
28,457,457,5,5,0,1,0
7,459,459,142,89,53,4,3
3,462,462,46,46,0,1,0
27,467,467,105,9,96,4,3
29,468,468,57,57,0,1,0
6,473,473,67,31,36,3,2
9,483,483,81,3,78,3,2
4,498,498,26,26,0,1,0

3,106,106,3,3,0,1,0
24,106,106,3,3,0,1,0
32,111,111,4,4,0,1,0
27,115,115,21,21,0,1,0
14,130,130,1,1,0,1,0
34,138,138,4,4,0,1,0
18,139,139,13,13,0,1,0
7,141,141,10,10,0,1,0
19,162,162,1,1,0,1,0
2,168,168,10,10,0,1,0
29,188,188,9,3,6,2,1
4,196,196,30,30,0,1,0
23,197,197,3,3,0,1,0
5,219,219,8,4,4,2,1
26,232,232,4,4,0,1,0
15,234,234,62,62,0,1,0
35,237,237,21,11,10,2,1
25,258,258,4,4,0,1,0
13,267,267,6,6,0,1,0
8,269,269,7,7,0,1,0
30,271,271,25,25,0,1,0
1,289,289,30,14,16,2,1
16,302,302,29,9,20,2,1
28,319,319,41,41,0,1,0
31,344,344,70,70,0,1,0
21,346,346,111,111,0,1,0
12,356,356,13,13,0,1,0
0,378,378,3,3,0,1,0
36,380,380,74,26,48,4,3
9,391,391,16,16,0,1,0
11,405,405,58,58,0,1,0
20,410,410,63,63,0,1,0
10,428,428,63,63,0,1,0
37,433,433,24,24,0,1,0
6,434,434,81,40,41,2,1
33,468,468,47,4,43,2,1
22,488,488,95,23,72,4,3
17,499,499,8,8,0,1,0

8,101,101,10,10,0,1,0
25,103,103,28,28,0,1,0
27,111,111,15,3,12,2,1
5,123,123,2,2,0,1,0
26,133,133,15,7,8,2,1
10,149,149,28,6,22,3,2
22,177,177,4,1,3,2,1
13,188,188,11,11,0,1,0
17,226,226,21,2,19,2,1
29,238,238,25,25,0,1,0
1,253,253,18,18,0,1,0
30,254,254,35,35,0,1,0
3,273,273,6,6,0,1,0
2,282,282,72,72,0,1,0
15,294,294,9,9,0,1,0
7,303,303,47,47,0,1,0
21,314,314,11,11,0,1,0
14,321,321,51,51,0,1,0
4,324,324,102,102,0,1,0
31,329,329,26,26,0,1,0
9,353,353,47,21,26,3,2
0,364,364,28,28,0,1,0
18,369,369,13,13,0,1,0
11,402,402,45,17,28,2,1
6,445,445,11,4,7,2,1
28,445,445,61,11,50,3,2
12,469,469,7,7,0,1,0
19,470,470,106,106,0,1,0
16,481,481,22,8,14,2,1
24,487,487,36,36,0,1,0
23,494,494,63,63,0,1,0
20,499,499,34,26,8,3,2

11,101,101,1,1,0,1,0
23,102,102,5,2,3,2,1
8,109,109,1,1,0,1,0
6,115,115,16,16,0,1,0
28,118,118,1,1,0,1,0
5,137,137,6,6,0,1,0
4,152,152,2,2,0,1,0
30,167,167,42,12,30,4,3
9,172,172,14,14,0,1,0
14,186,186,5,5,0,1,0
26,220,220,1,1,0,1,0
12,223,223,8,8,0,1,0
2,235,235,3,3,0,1,0
10,239,239,8,2,6,3,2
15,240,240,42,37,5,2,1
27,251,251,89,31,58,3,2
19,270,270,3,3,0,1,0
13,282,282,55,55,0,1,0
21,290,290,1,1,0,1,0
25,302,302,8,2,6,3,2
20,308,308,99,28,71,4,3
17,322,322,8,1,7,2,1
18,326,326,44,23,21,4,3
31,335,335,27,27,0,1,0
16,422,422,12,3,9,4,3
3,430,430,33,27,6,3,2
24,435,435,27,18,9,4,3
22,449,449,44,19,25,2,1
7,452,452,121,121,0,1,0
1,464,464,213,185,28,4,3
0,467,467,140,140,0,1,0
29,467,467,45,45,0,1,0

35,107,107,17,17,0,1,0
28,141,141,16,8,8,2,1
6,175,175,1,1,0,1,0
32,176,176,60,60,0,1,0
21,179,179,33,33,0,1,0
33,185,185,2,2,0,1,0
15,186,186,18,13,5,2,1
4,199,199,26,26,0,1,0
27,199,199,11,11,0,1,0
36,204,204,1,1,0,1,0
18,205,205,7,3,4,2,1
9,209,209,34,16,18,4,3
12,215,215,19,13,6,2,1
31,216,216,5,2,3,2,1
7,239,239,12,12,0,1,0
22,249,249,22,1,21,2,1
23,281,281,19,6,13,2,1
34,302,302,4,4,0,1,0
10,305,305,37,37,0,1,0
26,323,323,16,16,0,1,0
14,327,327,4,4,0,1,0
25,344,344,32,32,0,1,0
16,345,345,35,2,33,3,2
5,347,347,15,15,0,1,0
20,355,355,9,9,0,1,0
39,368,368,70,2,68,4,3
11,387,387,25,5,20,2,1
17,390,390,3,3,0,1,0
13,393,393,27,27,0,1,0
19,397,397,43,43,0,1,0
1,419,419,25,5,20,2,1
2,423,423,41,41,0,1,0
38,438,438,66,66,0,1,0
8,444,444,36,36,0,1,0
0,465,465,18,10,8,2,1
30,465,465,142,35,107,4,3
29,466,466,41,41,0,1,0
24,476,476,2,2,0,1,0
3,483,483,15,3,12,4,3
37,493,493,37,37,0,1,0

18,107,107,2,2,0,1,0
28,135,135,2,2,0,1,0
10,164,164,2,2,0,1,0
20,165,165,26,18,8,2,1
0,189,189,1,1,0,1,0
30,192,192,49,12,37,2,1
4,196,196,5,5,0,1,0
33,213,213,21,21,0,1,0
8,251,251,16,16,0,1,0
29,263,263,11,11,0,1,0
16,283,283,6,6,0,1,0
27,291,291,46,19,27,4,3
5,302,302,71,52,19,4,3
22,305,305,10,4,6,3,2
23,323,323,41,41,0,1,0
32,324,324,44,44,0,1,0
25,329,329,45,23,22,3,2
12,334,334,17,9,8,2,1
1,334,334,40,2,38,2,1
15,348,348,8,5,3,2,1
31,366,366,23,23,0,1,0
37,367,367,91,48,43,2,1
14,369,369,76,45,31,4,3
38,371,371,54,54,0,1,0
3,373,373,13,13,0,1,0
11,387,387,33,29,4,2,1
2,390,390,16,9,7,2,1
35,395,395,26,26,0,1,0
34,400,400,13,3,10,2,1
6,428,428,103,49,54,4,3
17,428,428,72,72,0,1,0
36,431,431,9,5,4,2,1
7,437,437,11,2,9,2,1
26,439,439,7,4,3,2,1
13,466,466,19,9,10,2,1
24,468,468,62,19,43,2,1
9,472,472,6,6,0,1,0
21,479,479,10,10,0,1,0
19,489,489,45,7,38,3,2

31,104,104,6,6,0,1,0
22,105,105,16,16,0,1,0
13,111,111,2,2,0,1,0
9,125,125,12,12,0,1,0
6,128,128,3,3,0,1,0
2,134,134,5,5,0,1,0
3,136,136,35,14,21,4,3
15,156,156,3,3,0,1,0
33,159,159,3,3,0,1,0
7,165,165,1,1,0,1,0
19,169,169,2,2,0,1,0
28,172,172,13,3,10,3,2
30,199,199,23,5,18,3,2
8,212,212,41,41,0,1,0
16,217,217,24,24,0,1,0
21,227,227,36,12,24,2,1
14,239,239,11,1,10,2,1
29,243,243,19,1,18,4,3
25,250,250,17,17,0,1,0
23,254,254,12,7,5,2,1
36,265,265,1,1,0,1,0
18,284,284,27,27,0,1,0
10,297,297,8,2,6,2,1
12,315,315,49,49,0,1,0
26,342,342,25,25,0,1,0
34,365,365,90,90,0,1,0
35,384,384,44,6,38,3,2
0,385,385,13,1,12,4,3
20,402,402,194,194,0,1,0
17,406,406,48,48,0,1,0
4,408,408,48,48,0,1,0
27,410,410,3,3,0,1,0
24,421,421,11,5,6,3,2
11,426,426,46,46,0,1,0
5,435,435,61,1,60,3,2
32,466,466,8,2,6,2,1
1,496,496,43,1,42,3,2

7,123,123,13,13,0,1,0
17,138,138,3,3,0,1,0
26,140,140,11,11,0,1,0
12,144,144,45,39,6,3,2
3,150,150,32,32,0,1,0
23,151,151,11,2,9,2,1
18,158,158,24,24,0,1,0
5,171,171,1,1,0,1,0
16,179,179,3,3,0,1,0
4,181,181,25,25,0,1,0
22,213,213,20,10,10,2,1
6,244,244,5,5,0,1,0
27,257,257,11,11,0,1,0
8,257,257,22,22,0,1,0
15,258,258,23,2,21,2,1
2,260,260,19,1,18,3,2
31,265,265,79,65,14,3,2
24,296,296,58,6,52,3,2
30,317,317,44,44,0,1,0
9,318,318,18,2,16,2,1
10,350,350,22,7,15,4,3
25,358,358,45,45,0,1,0
1,361,361,43,1,42,3,2
28,369,369,72,6,66,3,2
11,370,370,105,95,10,3,2
20,375,375,26,26,0,1,0
14,389,389,1,1,0,1,0
29,400,400,9,9,0,1,0
13,409,409,82,43,39,2,1
19,412,412,33,33,0,1,0
0,450,450,10,2,8,2,1
21,481,481,20,20,0,1,0

7,112,112,1,1,0,1,0
1,113,113,10,10,0,1,0
15,117,117,2,2,0,1,0
32,124,124,9,9,0,1,0
14,137,137,9,1,8,3,2
5,143,143,1,1,0,1,0
20,158,158,10,2,8,2,1
33,165,165,16,16,0,1,0
38,166,166,31,7,24,3,2
22,174,174,24,24,0,1,0
30,185,185,23,23,0,1,0
17,229,229,2,2,0,1,0
4,229,229,10,10,0,1,0
21,233,233,22,22,0,1,0
28,249,249,1,1,0,1,0
2,266,266,104,104,0,1,0
25,274,274,24,6,18,3,2
6,279,279,24,24,0,1,0
13,289,289,9,9,0,1,0
11,292,292,6,6,0,1,0
26,297,297,57,4,53,4,3
9,308,308,48,48,0,1,0
36,333,333,50,50,0,1,0
37,335,335,55,19,36,4,3
27,345,345,49,49,0,1,0
34,347,347,51,51,0,1,0
12,359,359,22,22,0,1,0
31,362,362,22,7,15,2,1
23,364,364,8,5,3,2,1
18,368,368,22,22,0,1,0
29,388,388,40,31,9,4,3
35,393,393,13,13,0,1,0
16,399,399,91,91,0,1,0
24,401,401,3,3,0,1,0
3,404,404,29,29,0,1,0
10,428,428,4,4,0,1,0
19,456,456,36,13,23,2,1
0,457,457,20,7,13,2,1
8,469,469,31,31,0,1,0

2,116,116,12,12,0,1,0
9,122,122,1,1,0,1,0
29,146,146,8,8,0,1,0
12,151,151,5,1,4,2,1
4,153,153,13,13,0,1,0
1,180,180,10,10,0,1,0
10,206,206,4,4,0,1,0
30,211,211,7,7,0,1,0
0,214,214,3,3,0,1,0
37,265,265,42,42,0,1,0
6,272,272,19,19,0,1,0
15,273,273,74,74,0,1,0
19,276,276,12,3,9,3,2
28,283,283,19,13,6,2,1
17,290,290,54,2,52,3,2
3,290,290,35,35,0,1,0
32,307,307,29,2,27,2,1
36,320,320,5,5,0,1,0
25,321,321,102,96,6,3,2
27,327,327,12,12,0,1,0
23,328,328,27,27,0,1,0
34,337,337,37,14,23,2,1
11,337,337,35,35,0,1,0
13,361,361,12,7,5,2,1
26,362,362,26,10,16,3,2
31,366,366,14,14,0,1,0
14,376,376,40,22,18,4,3
5,379,379,15,15,0,1,0
18,404,404,30,18,12,4,3
22,404,404,66,10,56,3,2
7,410,410,63,47,16,3,2
35,422,422,1,1,0,1,0
8,430,430,69,69,0,1,0
33,441,441,2,2,0,1,0
20,471,471,2,2,0,1,0
16,476,476,7,7,0,1,0
24,477,477,136,124,12,4,3
21,481,481,93,51,42,3,2

26,105,105,7,7,0,1,0
15,114,114,8,2,6,2,1
27,119,119,10,2,8,2,1
21,126,126,14,14,0,1,0
1,127,127,1,1,0,1,0
23,142,142,1,1,0,1,0
5,165,165,41,2,39,4,3
7,166,166,11,11,0,1,0
2,177,177,85,85,0,1,0
0,190,190,22,13,9,4,3
24,206,206,5,5,0,1,0
8,222,222,9,6,3,2,1
6,228,228,14,14,0,1,0
16,250,250,60,17,43,2,1
9,257,257,33,6,27,4,3
11,257,257,4,4,0,1,0
22,286,286,33,1,32,2,1
12,291,291,17,17,0,1,0
19,353,353,35,1,34,2,1
14,355,355,82,82,0,1,0
18,368,368,67,62,5,2,1
4,405,405,18,5,13,3,2
25,406,406,34,15,19,2,1
3,415,415,187,121,66,3,2
13,423,423,107,31,76,3,2
10,434,434,25,1,24,4,3
17,450,450,32,20,12,3,2
20,460,460,8,4,4,2,1

24,102,102,14,6,8,3,2
20,108,108,14,2,12,2,1
12,109,109,14,2,12,2,1
21,112,112,5,5,0,1,0
31,118,118,22,8,14,3,2
5,137,137,7,7,0,1,0
18,148,148,25,3,22,3,2
3,149,149,1,1,0,1,0
27,160,160,13,3,10,3,2
30,173,173,27,3,24,2,1
9,175,175,9,1,8,3,2
32,185,185,14,14,0,1,0
0,190,190,30,30,0,1,0
8,198,198,2,2,0,1,0
33,200,200,26,26,0,1,0
16,215,215,93,50,43,2,1
13,228,228,8,8,0,1,0
25,253,253,11,5,6,3,2
2,288,288,8,8,0,1,0
11,296,296,105,12,93,4,3
14,318,318,11,11,0,1,0
1,347,347,24,12,12,4,3
29,347,347,22,22,0,1,0
19,349,349,54,20,34,3,2
15,400,400,2,2,0,1,0
28,428,428,25,13,12,2,1
17,439,439,21,15,6,2,1
22,447,447,10,10,0,1,0
26,451,451,66,46,20,2,1
10,477,477,69,69,0,1,0
7,479,479,35,35,0,1,0
4,480,480,8,8,0,1,0
6,482,482,49,49,0,1,0
23,497,497,51,51,0,1,0

26,106,106,13,13,0,1,0
35,145,145,6,1,5,2,1
0,147,147,76,30,46,2,1
36,158,158,26,19,7,2,1
4,165,165,10,10,0,1,0
9,172,172,7,7,0,1,0
30,178,178,27,27,0,1,0
39,181,181,6,6,0,1,0
33,193,193,22,22,0,1,0
24,193,193,1,1,0,1,0
40,213,213,39,39,0,1,0
11,226,226,7,1,6,2,1
23,232,232,3,3,0,1,0
5,232,232,4,4,0,1,0
27,242,242,37,37,0,1,0
38,247,247,13,4,9,4,3
28,253,253,1,1,0,1,0
16,257,257,1,1,0,1,0
8,269,269,34,34,0,1,0
17,289,289,20,20,0,1,0
7,320,320,22,15,7,2,1
3,327,327,42,12,30,4,3
13,337,337,3,3,0,1,0
10,342,342,27,14,13,4,3
1,351,351,4,1,3,2,1
14,351,351,14,14,0,1,0
32,352,352,39,39,0,1,0
20,365,365,68,68,0,1,0
22,375,375,3,3,0,1,0
18,380,380,3,3,0,1,0
6,394,394,2,2,0,1,0
34,402,402,92,53,39,4,3
19,417,417,24,24,0,1,0
37,421,421,13,5,8,2,1
29,421,421,13,13,0,1,0
31,422,422,72,54,18,2,1
12,437,437,14,7,7,2,1
2,443,443,2,2,0,1,0
15,481,481,59,50,9,4,3
25,482,482,64,22,42,3,2
21,498,498,31,12,19,4,3

33,107,107,18,18,0,1,0
15,111,111,13,10,3,2,1
0,112,112,3,3,0,1,0
17,115,115,14,14,0,1,0
12,123,123,3,3,0,1,0
14,128,128,1,1,0,1,0
5,135,135,13,1,12,4,3
27,166,166,15,3,12,3,2
2,167,167,32,32,0,1,0
28,169,169,15,10,5,2,1
25,181,181,16,16,0,1,0
10,202,202,37,12,25,2,1
6,210,210,4,4,0,1,0
21,230,230,14,14,0,1,0
9,231,231,10,4,6,3,2
13,244,244,7,7,0,1,0
3,257,257,23,23,0,1,0
29,265,265,17,9,8,2,1
34,267,267,2,2,0,1,0
35,309,309,13,13,0,1,0
18,316,316,7,7,0,1,0
31,324,324,122,22,100,4,3
8,336,336,44,44,0,1,0
36,350,350,17,17,0,1,0
22,352,352,25,19,6,3,2
4,356,356,11,3,8,3,2
24,367,367,55,45,10,2,1
1,377,377,36,30,6,3,2
32,394,394,51,7,44,3,2
26,415,415,30,13,17,2,1
19,419,419,4,4,0,1,0
30,463,463,9,9,0,1,0
7,473,473,5,5,0,1,0
20,483,483,109,37,72,4,3
11,487,487,124,124,0,1,0
23,489,489,17,4,13,4,3
16,493,493,97,65,32,2,1

6,108,108,7,7,0,1,0
20,151,151,3,3,0,1,0
34,152,152,12,9,3,2,1
0,154,154,4,4,0,1,0
37,186,186,7,7,0,1,0
48,192,192,48,5,43,3,2
16,195,195,9,9,0,1,0
44,201,201,2,2,0,1,0
40,211,211,8,2,6,2,1
30,236,236,4,4,0,1,0
14,236,236,5,5,0,1,0
19,241,241,20,20,0,1,0
45,243,243,29,5,24,4,3
38,249,249,3,3,0,1,0
28,257,257,13,8,5,2,1
18,258,258,2,2,0,1,0
24,260,260,37,37,0,1,0
35,264,264,3,3,0,1,0
33,265,265,25,12,13,3,2
41,277,277,48,1,47,2,1
21,278,278,5,5,0,1,0
36,278,278,58,58,0,1,0
3,280,280,15,5,10,2,1
10,280,280,28,28,0,1,0
29,280,280,7,7,0,1,0
46,297,297,20,20,0,1,0
25,321,321,9,9,0,1,0
26,333,333,2,2,0,1,0
15,334,334,75,54,21,4,3
32,357,357,31,31,0,1,0
1,366,366,1,1,0,1,0
31,367,367,106,28,78,3,2
12,380,380,9,9,0,1,0
8,390,390,11,11,0,1,0
42,391,391,96,22,74,4,3
5,392,392,1,1,0,1,0
11,395,395,25,16,9,4,3
39,397,397,13,1,12,4,3
47,399,399,50,6,44,2,1
2,400,400,22,22,0,1,0
23,418,418,7,7,0,1,0
43,432,432,64,40,24,2,1
17,437,437,2,2,0,1,0
9,452,452,1,1,0,1,0
13,463,463,15,15,0,1,0
4,466,466,50,50,0,1,0
7,477,477,1,1,0,1,0
22,478,478,13,7,6,3,2
27,493,493,55,6,49,2,1

13,102,102,2,2,0,1,0
31,107,107,10,7,3,2,1
4,114,114,41,41,0,1,0
11,119,119,19,19,0,1,0
24,122,122,20,16,4,2,1
27,146,146,4,4,0,1,0
21,160,160,26,26,0,1,0
15,176,176,67,67,0,1,0
2,198,198,16,4,12,4,3
30,201,201,26,26,0,1,0
7,212,212,10,2,8,2,1
0,217,217,14,14,0,1,0
17,222,222,46,46,0,1,0
19,227,227,5,1,4,2,1
23,241,241,39,39,0,1,0
3,271,271,7,7,0,1,0
29,306,306,27,9,18,3,2
8,312,312,18,1,17,3,2
25,335,335,41,20,21,4,3
5,335,335,30,6,24,4,3
16,336,336,11,11,0,1,0
18,339,339,4,4,0,1,0
20,342,342,19,19,0,1,0
1,352,352,75,18,57,4,3
14,417,417,151,151,0,1,0
22,440,440,12,3,9,2,1
12,449,449,17,17,0,1,0
10,451,451,9,9,0,1,0
9,451,451,69,39,30,4,3
6,452,452,5,5,0,1,0
28,454,454,9,9,0,1,0
26,475,475,16,16,0,1,0

0,100,100,16,4,12,4,3
8,102,102,10,10,0,1,0
28,126,126,2,2,0,1,0
11,128,128,1,1,0,1,0
21,144,144,4,4,0,1,0
5,163,163,14,14,0,1,0
18,164,164,10,10,0,1,0
9,169,169,8,8,0,1,0
6,180,180,3,3,0,1,0
23,194,194,48,15,33,2,1
26,198,198,41,11,30,3,2
22,202,202,4,4,0,1,0
31,242,242,27,24,3,2,1
32,252,252,2,2,0,1,0
10,259,259,12,12,0,1,0
3,302,302,5,1,4,2,1
7,303,303,8,2,6,3,2
4,305,305,42,42,0,1,0
24,326,326,1,1,0,1,0
27,332,332,2,2,0,1,0
16,333,333,20,20,0,1,0
17,338,338,21,21,0,1,0
15,353,353,2,2,0,1,0
25,365,365,4,4,0,1,0
19,366,366,14,2,12,4,3
33,389,389,138,81,57,4,3
20,412,412,71,71,0,1,0
13,414,414,116,116,0,1,0
29,424,424,54,54,0,1,0
35,456,456,89,89,0,1,0
1,461,461,29,29,0,1,0
14,481,481,70,25,45,4,3
12,488,488,31,31,0,1,0
30,495,495,88,88,0,1,0
34,497,497,6,6,0,1,0
2,498,498,158,158,0,1,0

1,105,105,1,1,0,1,0
29,105,105,18,18,0,1,0
12,129,129,10,10,0,1,0
9,132,132,4,4,0,1,0
31,148,148,6,6,0,1,0
24,158,158,9,9,0,1,0
15,171,171,9,6,3,2,1
14,183,183,15,1,14,3,2
16,188,188,8,4,4,2,1
4,205,205,78,22,56,3,2
17,208,208,11,11,0,1,0
23,214,214,31,31,0,1,0
19,231,231,14,14,0,1,0
32,235,235,8,8,0,1,0
2,237,237,42,10,32,3,2
11,262,262,7,7,0,1,0
26,270,270,45,45,0,1,0
30,290,290,75,15,60,4,3
22,300,300,22,22,0,1,0
5,303,303,40,40,0,1,0
27,321,321,6,6,0,1,0
33,322,322,12,12,0,1,0
25,326,326,12,12,0,1,0
20,357,357,19,15,4,2,1
21,359,359,59,19,40,2,1
0,365,365,30,3,27,2,1
8,394,394,36,36,0,1,0
7,412,412,6,3,3,2,1
3,418,418,112,36,76,3,2
13,429,429,54,54,0,1,0
18,463,463,48,33,15,2,1
6,482,482,31,10,21,4,3
10,486,486,23,23,0,1,0
28,492,492,129,129,0,1,0

33,123,123,13,1,12,4,3
18,135,135,14,14,0,1,0
24,138,138,50,29,21,4,3
14,140,140,28,4,24,3,2
19,150,150,2,2,0,1,0
13,186,186,1,1,0,1,0
30,191,191,34,3,31,2,1
34,203,203,54,54,0,1,0
1,231,231,3,3,0,1,0
36,233,233,30,30,0,1,0
4,235,235,26,18,8,2,1
25,237,237,3,3,0,1,0
16,270,270,27,1,26,3,2
11,275,275,88,72,16,3,2
21,282,282,12,3,9,2,1
8,310,310,31,12,19,2,1
6,318,318,7,7,0,1,0
29,323,323,28,28,0,1,0
5,323,323,56,7,49,2,1
17,334,334,54,37,17,2,1
10,343,343,4,4,0,1,0
20,353,353,52,32,20,4,3
2,357,357,1,1,0,1,0
12,364,364,59,17,42,3,2
3,365,365,17,5,12,3,2
23,384,384,36,36,0,1,0
27,414,414,13,13,0,1,0
7,417,417,35,15,20,3,2
26,426,426,10,10,0,1,0
32,447,447,24,24,0,1,0
0,450,450,1,1,0,1,0
28,452,452,6,6,0,1,0
15,453,453,7,7,0,1,0
35,456,456,22,22,0,1,0
31,465,465,36,36,0,1,0
22,475,475,28,28,0,1,0
9,478,478,25,4,21,2,1

27,108,108,22,22,0,1,0
31,112,112,5,5,0,1,0
34,113,113,17,4,13,2,1
2,193,193,14,14,0,1,0
16,209,209,10,1,9,3,2
36,240,240,18,7,11,2,1
29,249,249,1,1,0,1,0
25,249,249,4,1,3,2,1
5,250,250,6,6,0,1,0
6,251,251,12,12,0,1,0
0,255,255,9,6,3,2,1
11,262,262,2,2,0,1,0
9,271,271,71,31,40,2,1
33,276,276,1,1,0,1,0
37,288,288,35,1,34,3,2
7,317,317,54,54,0,1,0
8,352,352,2,2,0,1,0
18,354,354,16,16,0,1,0
4,355,355,9,9,0,1,0
32,368,368,108,81,27,2,1
3,372,372,113,113,0,1,0
19,382,382,12,12,0,1,0
10,391,391,59,59,0,1,0
24,392,392,15,15,0,1,0
23,393,393,3,3,0,1,0
20,397,397,27,27,0,1,0
14,416,416,4,4,0,1,0
13,417,417,43,16,27,2,1
30,417,417,126,126,0,1,0
26,422,422,60,18,42,2,1
15,436,436,6,6,0,1,0
28,441,441,13,5,8,3,2
21,443,443,7,1,6,3,2
35,478,478,44,44,0,1,0
22,483,483,93,93,0,1,0
12,490,490,6,6,0,1,0
17,493,493,50,42,8,3,2
1,495,495,81,81,0,1,0

7,120,120,4,4,0,1,0
26,132,132,7,7,0,1,0
30,133,133,16,16,0,1,0
10,140,140,26,8,18,3,2
21,152,152,16,16,0,1,0
17,157,157,6,6,0,1,0
3,158,158,17,6,11,2,1
28,174,174,7,1,6,2,1
19,175,175,7,4,3,2,1
25,178,178,4,4,0,1,0
16,181,181,6,6,0,1,0
8,218,218,51,30,21,4,3
12,242,242,38,38,0,1,0
27,248,248,47,47,0,1,0
2,291,291,17,17,0,1,0
14,291,291,17,17,0,1,0
11,303,303,62,54,8,2,1
5,326,326,21,21,0,1,0
22,351,351,13,13,0,1,0
18,362,362,6,6,0,1,0
29,364,364,18,7,11,2,1
20,370,370,30,24,6,3,2
0,370,370,6,6,0,1,0
9,378,378,1,1,0,1,0
1,409,409,4,4,0,1,0
15,413,413,237,135,102,4,3
24,419,419,11,6,5,2,1
23,432,432,112,74,38,3,2
13,440,440,35,35,0,1,0
4,486,486,228,228,0,1,0
31,486,486,27,15,12,3,2
6,499,499,11,11,0,1,0

27,105,105,7,7,0,1,0
12,145,145,16,16,0,1,0
15,175,175,4,4,0,1,0
21,197,197,9,6,3,2,1
9,201,201,33,33,0,1,0
2,207,207,8,8,0,1,0
11,211,211,15,2,13,2,1
5,257,257,23,5,18,2,1
18,268,268,28,28,0,1,0
24,269,269,65,65,0,1,0
19,271,271,7,7,0,1,0
17,285,285,39,15,24,3,2
13,309,309,25,22,3,2,1
28,312,312,26,21,5,2,1
3,318,318,71,71,0,1,0
20,327,327,21,6,15,2,1
7,334,334,42,5,37,2,1
4,340,340,73,3,70,3,2
10,344,344,22,22,0,1,0
6,356,356,52,52,0,1,0
8,360,360,74,66,8,3,2
14,371,371,16,16,0,1,0
22,388,388,17,17,0,1,0
1,392,392,114,99,15,2,1
26,420,420,150,30,120,4,3
0,430,430,30,24,6,2,1
25,441,441,32,8,24,4,3
23,446,446,103,103,0,1,0
16,460,460,1,1,0,1,0

7,100,100,1,1,0,1,0
8,137,137,36,36,0,1,0
14,137,137,4,4,0,1,0
26,152,152,2,2,0,1,0
30,158,158,9,5,4,2,1
11,169,169,20,6,14,2,1
16,175,175,26,2,24,3,2
6,180,180,13,13,0,1,0
20,182,182,14,14,0,1,0
5,190,190,33,21,12,2,1
2,227,227,12,12,0,1,0
31,242,242,20,20,0,1,0
22,252,252,56,56,0,1,0
24,258,258,34,16,18,2,1
4,259,259,14,14,0,1,0
3,260,260,4,4,0,1,0
28,264,264,55,55,0,1,0
33,319,319,20,20,0,1,0
19,327,327,59,41,18,3,2
17,359,359,9,9,0,1,0
10,361,361,171,171,0,1,0
9,367,367,14,6,8,2,1
0,371,371,3,3,0,1,0
1,417,417,44,44,0,1,0
25,422,422,44,44,0,1,0
34,427,427,66,66,0,1,0
23,436,436,5,2,3,2,1
15,441,441,26,14,12,3,2
21,449,449,95,5,90,4,3
18,449,449,15,6,9,4,3
13,466,466,1,1,0,1,0
27,477,477,51,51,0,1,0
32,479,479,12,12,0,1,0
12,481,481,26,26,0,1,0
29,487,487,23,4,19,3,2

25,105,105,6,6,0,1,0
7,109,109,9,9,0,1,0
23,123,123,11,11,0,1,0
3,153,153,5,5,0,1,0
20,153,153,57,34,23,2,1
19,172,172,20,13,7,2,1
24,190,190,1,1,0,1,0
0,190,190,13,5,8,3,2
11,195,195,5,5,0,1,0
34,200,200,4,4,0,1,0
28,201,201,18,3,15,2,1
2,202,202,22,22,0,1,0
29,223,223,17,2,15,2,1
17,225,225,5,5,0,1,0
10,254,254,67,49,18,2,1
6,262,262,20,7,13,2,1
26,274,274,17,3,14,3,2
9,279,279,10,4,6,3,2
35,279,279,9,9,0,1,0
14,284,284,3,3,0,1,0
21,286,286,64,64,0,1,0
13,301,301,2,2,0,1,0
27,317,317,14,14,0,1,0
8,320,320,10,10,0,1,0
18,330,330,173,98,75,4,3
15,343,343,30,13,17,3,2
5,343,343,6,2,4,2,1
16,344,344,59,59,0,1,0
12,395,395,2,2,0,1,0
33,404,404,27,27,0,1,0
32,423,423,46,46,0,1,0
31,433,433,1,1,0,1,0
22,445,445,150,97,53,4,3
1,458,458,32,32,0,1,0
30,466,466,12,12,0,1,0
4,480,480,29,2,27,4,3

34,124,124,5,5,0,1,0
20,125,125,22,18,4,2,1
27,128,128,65,65,0,1,0
19,156,156,28,28,0,1,0
4,186,186,17,5,12,4,3
35,187,187,6,6,0,1,0
16,217,217,9,3,6,3,2
8,220,220,37,37,0,1,0
32,226,226,7,1,6,2,1
23,229,229,11,11,0,1,0
18,247,247,5,5,0,1,0
25,287,287,79,19,60,3,2
21,293,293,11,11,0,1,0
29,298,298,4,4,0,1,0
6,301,301,38,2,36,2,1
5,302,302,51,51,0,1,0
33,307,307,4,4,0,1,0
7,309,309,18,18,0,1,0
30,310,310,30,20,10,3,2
24,324,324,9,4,5,2,1
9,335,335,4,4,0,1,0
13,348,348,22,7,15,2,1
10,360,360,6,6,0,1,0
28,363,363,51,51,0,1,0
36,375,375,14,14,0,1,0
15,375,375,74,74,0,1,0
3,385,385,43,43,0,1,0
12,397,397,14,8,6,3,2
26,420,420,8,8,0,1,0
1,421,421,3,3,0,1,0
0,432,432,93,35,58,4,3
31,435,435,81,74,7,2,1
14,441,441,10,10,0,1,0
2,463,463,8,8,0,1,0
22,465,465,24,24,0,1,0
11,468,468,68,13,55,4,3
17,470,470,3,3,0,1,0

10,102,102,38,26,12,3,2
9,105,105,10,10,0,1,0
0,123,123,13,13,0,1,0
11,128,128,3,3,0,1,0
4,135,135,1,1,0,1,0
1,138,138,19,1,18,3,2
27,138,138,1,1,0,1,0
20,140,140,1,1,0,1,0
14,156,156,11,11,0,1,0
7,176,176,48,48,0,1,0
25,190,190,29,29,0,1,0
3,232,232,5,1,4,2,1
23,260,260,30,2,28,3,2
15,277,277,35,13,22,2,1
19,280,280,9,3,6,3,2
30,290,290,19,3,16,3,2
31,293,293,18,18,0,1,0
13,295,295,10,10,0,1,0
21,305,305,44,26,18,4,3
6,312,312,2,2,0,1,0
17,315,315,66,2,64,3,2
24,330,330,2,2,0,1,0
26,343,343,26,16,10,2,1
18,354,354,54,40,14,2,1
5,358,358,23,23,0,1,0
16,366,366,109,109,0,1,0
2,368,368,47,15,32,3,2
28,411,411,11,11,0,1,0
12,435,435,147,32,115,4,3
29,469,469,59,43,16,2,1
22,479,479,60,60,0,1,0
8,495,495,12,7,5,2,1

17,107,107,1,1,0,1,0
6,119,119,18,3,15,2,1
19,129,129,12,12,0,1,0
2,154,154,114,104,10,2,1
3,159,159,13,13,0,1,0
26,182,182,25,25,0,1,0
24,216,216,9,9,0,1,0
23,217,217,5,5,0,1,0
22,252,252,34,34,0,1,0
14,252,252,29,29,0,1,0
1,287,287,5,5,0,1,0
9,292,292,33,9,24,4,3
18,303,303,119,49,70,4,3
0,306,306,15,15,0,1,0
11,355,355,20,20,0,1,0
4,357,357,85,85,0,1,0
7,359,359,98,48,50,4,3
12,370,370,5,5,0,1,0
25,384,384,45,25,20,2,1
20,387,387,37,37,0,1,0
13,398,398,25,5,20,3,2
15,399,399,39,39,0,1,0
8,413,413,12,12,0,1,0
5,419,419,4,4,0,1,0
16,461,461,75,39,36,2,1
21,479,479,49,49,0,1,0
10,495,495,37,37,0,1,0

22,101,101,10,10,0,1,0
26,111,111,34,34,0,1,0
1,127,127,3,3,0,1,0
19,153,153,6,6,0,1,0
21,157,157,19,19,0,1,0
40,172,172,4,4,0,1,0
20,180,180,12,3,9,2,1
0,199,199,44,18,26,3,2
23,214,214,2,2,0,1,0
38,223,223,39,27,12,4,3
6,231,231,27,24,3,2,1
34,251,251,2,2,0,1,0
17,262,262,6,6,0,1,0
15,281,281,5,5,0,1,0
36,288,288,3,3,0,1,0
13,302,302,30,30,0,1,0
27,306,306,53,27,26,2,1
10,324,324,28,16,12,3,2
2,343,343,1,1,0,1,0
37,345,345,98,64,34,4,3
39,356,356,58,34,24,2,1
24,365,365,35,8,27,4,3
9,368,368,23,3,20,2,1
7,377,377,17,17,0,1,0
41,381,381,20,5,15,4,3
29,383,383,2,2,0,1,0
33,403,403,5,1,4,2,1
31,403,403,54,54,0,1,0
3,404,404,1,1,0,1,0
30,405,405,28,3,25,4,3
5,419,419,41,7,34,2,1
14,426,426,34,34,0,1,0
35,429,429,69,69,0,1,0
28,430,430,10,10,0,1,0
18,441,441,13,5,8,2,1
12,442,442,7,1,6,2,1
25,451,451,37,37,0,1,0
4,455,455,23,3,20,3,2
11,458,458,65,65,0,1,0
16,458,458,20,2,18,4,3
8,477,477,52,52,0,1,0
32,480,480,21,21,0,1,0

1,106,106,2,2,0,1,0
29,126,126,13,13,0,1,0
20,128,128,4,1,3,2,1
26,137,137,2,2,0,1,0
9,149,149,3,3,0,1,0
31,162,162,16,16,0,1,0
25,165,165,11,11,0,1,0
7,192,192,20,20,0,1,0
15,207,207,9,9,0,1,0
4,213,213,31,16,15,4,3
24,217,217,43,43,0,1,0
32,227,227,3,3,0,1,0
5,230,230,26,26,0,1,0
28,240,240,9,9,0,1,0
36,242,242,2,2,0,1,0
10,274,274,52,17,35,2,1
13,299,299,4,4,0,1,0
34,303,303,27,7,20,3,2
35,327,327,40,40,0,1,0
8,341,341,85,25,60,4,3
0,346,346,10,10,0,1,0
16,364,364,84,84,0,1,0
17,366,366,17,14,3,2,1
19,366,366,8,2,6,3,2
22,369,369,56,5,51,4,3
14,384,384,43,5,38,4,3
3,419,419,31,31,0,1,0
11,422,422,1,1,0,1,0
33,426,426,21,7,14,2,1
18,440,440,25,12,13,2,1
21,444,444,125,125,0,1,0
23,446,446,146,104,42,4,3
27,456,456,60,23,37,2,1
12,464,464,1,1,0,1,0
6,472,472,12,6,6,2,1
2,475,475,97,97,0,1,0
30,497,497,6,6,0,1,0

1,114,114,37,1,36,3,2
6,114,114,8,8,0,1,0
24,135,135,12,12,0,1,0
20,155,155,40,28,12,2,1
9,156,156,51,42,9,2,1
27,163,163,10,10,0,1,0
17,179,179,6,6,0,1,0
0,190,190,15,10,5,2,1
10,204,204,7,3,4,2,1
19,221,221,35,23,12,3,2
3,224,224,10,10,0,1,0
12,228,228,25,25,0,1,0
5,235,235,60,60,0,1,0
7,239,239,32,3,29,2,1
29,269,269,12,9,3,2,1
11,282,282,17,9,8,2,1
23,283,283,6,3,3,2,1
2,283,283,35,11,24,2,1
4,322,322,26,16,10,3,2
26,325,325,4,4,0,1,0
21,343,343,97,97,0,1,0
8,374,374,22,18,4,2,1
28,377,377,142,142,0,1,0
25,387,387,15,1,14,2,1
22,413,413,13,13,0,1,0
13,429,429,10,2,8,3,2
18,431,431,63,21,42,4,3
15,444,444,38,38,0,1,0
16,466,466,19,19,0,1,0
14,477,477,13,3,10,2,1

12,109,109,22,10,12,4,3
8,148,148,9,2,7,2,1
11,151,151,29,29,0,1,0
9,173,173,5,2,3,2,1
0,188,188,9,2,7,2,1
16,194,194,10,10,0,1,0
25,197,197,40,13,27,4,3
2,232,232,121,99,22,3,2
27,269,269,45,45,0,1,0
22,272,272,10,10,0,1,0
18,276,276,41,41,0,1,0
1,285,285,16,4,12,2,1
3,289,289,38,38,0,1,0
19,290,290,28,11,17,2,1
23,298,298,8,8,0,1,0
15,317,317,28,21,7,2,1
4,339,339,7,3,4,2,1
24,341,341,98,48,50,2,1
29,355,355,20,8,12,4,3
21,360,360,32,14,18,3,2
20,382,382,7,7,0,1,0
13,388,388,113,41,72,3,2
14,398,398,21,7,14,3,2
17,399,399,2,2,0,1,0
28,402,402,35,13,22,2,1
10,435,435,15,15,0,1,0
26,458,458,8,2,6,2,1
6,471,471,8,8,0,1,0
7,478,478,63,36,27,2,1
5,500,500,128,102,26,3,2

11,107,107,2,2,0,1,0
29,114,114,8,8,0,1,0
25,119,119,6,6,0,1,0
1,131,131,21,4,17,2,1
36,140,140,19,5,14,3,2
2,151,151,4,1,3,2,1
33,159,159,7,1,6,2,1
8,177,177,8,8,0,1,0
5,184,184,17,17,0,1,0
15,199,199,5,5,0,1,0
17,200,200,20,11,9,4,3
40,207,207,18,10,8,3,2
35,222,222,71,71,0,1,0
38,229,229,1,1,0,1,0
0,235,235,2,2,0,1,0
4,245,245,5,5,0,1,0
24,250,250,16,16,0,1,0
34,275,275,27,27,0,1,0
23,290,290,25,17,8,3,2
7,291,291,2,2,0,1,0
10,293,293,9,9,0,1,0
32,294,294,5,5,0,1,0
31,298,298,84,55,29,2,1
28,301,301,3,3,0,1,0
16,304,304,1,1,0,1,0
3,317,317,46,46,0,1,0
30,321,321,19,10,9,4,3
18,323,323,31,31,0,1,0
20,329,329,91,61,30,4,3
22,340,340,32,26,6,2,1
19,354,354,8,8,0,1,0
6,355,355,21,2,19,4,3
26,360,360,74,18,56,4,3
9,364,364,2,2,0,1,0
27,378,378,12,2,10,3,2
39,438,438,47,20,27,4,3
12,441,441,55,39,16,2,1
14,461,461,52,35,17,2,1
21,466,466,57,57,0,1,0
13,468,468,8,3,5,2,1
37,474,474,73,34,39,4,3

16,100,100,3,3,0,1,0
23,118,118,13,13,0,1,0
8,127,127,6,6,0,1,0
22,127,127,29,29,0,1,0
17,163,163,21,21,0,1,0
2,192,192,1,1,0,1,0
25,199,199,9,9,0,1,0
24,227,227,5,5,0,1,0
27,228,228,100,46,54,3,2
1,233,233,2,2,0,1,0
13,251,251,1,1,0,1,0
20,261,261,1,1,0,1,0
9,277,277,4,1,3,2,1
19,282,282,34,13,21,2,1
15,292,292,35,35,0,1,0
26,305,305,9,9,0,1,0
0,307,307,48,48,0,1,0
7,341,341,90,90,0,1,0
14,348,348,39,39,0,1,0
5,352,352,13,4,9,4,3
18,368,368,78,38,40,3,2
10,405,405,224,74,150,4,3
3,412,412,80,80,0,1,0
11,438,438,7,7,0,1,0
21,449,449,24,24,0,1,0
4,452,452,5,5,0,1,0
12,481,481,28,28,0,1,0
6,497,497,204,204,0,1,0

21,100,100,21,21,0,1,0
26,116,116,5,1,4,2,1
33,139,139,16,16,0,1,0
7,144,144,11,11,0,1,0
22,145,145,3,3,0,1,0
15,147,147,14,14,0,1,0
29,149,149,5,5,0,1,0
1,156,156,1,1,0,1,0
10,180,180,1,1,0,1,0
19,187,187,23,11,12,3,2
16,197,197,8,8,0,1,0
32,209,209,10,6,4,2,1
5,216,216,13,13,0,1,0
12,234,234,71,67,4,2,1
25,240,240,22,22,0,1,0
3,256,256,32,32,0,1,0
20,281,281,100,68,32,4,3
11,316,316,1,1,0,1,0
8,341,341,47,10,37,3,2
6,344,344,104,63,41,4,3
24,344,344,3,3,0,1,0
27,352,352,14,2,12,2,1
2,360,360,72,68,4,2,1
17,367,367,24,9,15,3,2
31,382,382,6,6,0,1,0
0,418,418,43,13,30,4,3
13,422,422,29,2,27,4,3
28,439,439,3,3,0,1,0
9,446,446,27,27,0,1,0
4,456,456,19,4,15,3,2
30,456,456,118,106,12,4,3
18,487,487,50,8,42,3,2
23,491,491,95,23,72,3,2
14,493,493,36,36,0,1,0

27,104,104,15,8,7,2,1
0,112,112,10,10,0,1,0
22,135,135,22,22,0,1,0
11,138,138,1,1,0,1,0
8,183,183,5,1,4,2,1
14,185,185,28,19,9,4,3
13,189,189,33,27,6,2,1
33,203,203,1,1,0,1,0
32,229,229,8,8,0,1,0
6,232,232,4,4,0,1,0
10,239,239,8,8,0,1,0
9,247,247,6,6,0,1,0
5,248,248,20,20,0,1,0
19,255,255,1,1,0,1,0
15,267,267,2,2,0,1,0
4,294,294,70,70,0,1,0
26,298,298,50,50,0,1,0
24,328,328,51,9,42,3,2
20,335,335,5,5,0,1,0
7,335,335,79,35,44,3,2
23,336,336,1,1,0,1,0
16,338,338,48,42,6,2,1
12,340,340,95,31,64,4,3
17,348,348,12,12,0,1,0
29,359,359,2,2,0,1,0
2,359,359,2,2,0,1,0
31,360,360,21,12,9,2,1
3,377,377,46,38,8,3,2
18,380,380,175,52,123,4,3
21,403,403,26,13,13,2,1
1,432,432,14,14,0,1,0
34,449,449,70,19,51,4,3
25,456,456,50,50,0,1,0
28,481,481,23,23,0,1,0
30,483,483,62,62,0,1,0

29,111,111,23,18,5,2,1
33,115,115,7,7,0,1,0
6,121,121,18,18,0,1,0
23,128,128,1,1,0,1,0
13,150,150,23,1,22,2,1
12,179,179,14,14,0,1,0
32,185,185,12,6,6,3,2
28,193,193,2,2,0,1,0
7,201,201,1,1,0,1,0
27,220,220,49,29,20,3,2
24,224,224,91,91,0,1,0
25,246,246,17,17,0,1,0
11,246,246,13,13,0,1,0
26,249,249,12,7,5,2,1
22,254,254,2,2,0,1,0
5,260,260,12,1,11,2,1
4,268,268,12,12,0,1,0
3,277,277,7,7,0,1,0
2,279,279,1,1,0,1,0
30,285,285,64,22,42,4,3
19,292,292,51,51,0,1,0
34,298,298,8,2,6,2,1
35,320,320,15,15,0,1,0
21,365,365,13,13,0,1,0
17,427,427,2,2,0,1,0
14,438,438,57,57,0,1,0
15,443,443,34,8,26,2,1
31,445,445,28,4,24,4,3
1,445,445,123,59,64,4,3
18,448,448,17,8,9,4,3
20,454,454,27,27,0,1,0
10,457,457,47,41,6,3,2
0,466,466,10,10,0,1,0
16,470,470,40,3,37,2,1
8,484,484,50,7,43,2,1
9,494,494,150,30,120,4,3

21,103,103,9,9,0,1,0
20,104,104,36,22,14,3,2
0,112,112,25,25,0,1,0
11,113,113,6,1,5,2,1
14,123,123,4,4,0,1,0
12,132,132,3,3,0,1,0
26,132,132,7,7,0,1,0
2,136,136,33,5,28,2,1
19,148,148,11,11,0,1,0
23,150,150,4,4,0,1,0
17,153,153,8,8,0,1,0
1,160,160,21,13,8,3,2
29,178,178,3,3,0,1,0
5,220,220,1,1,0,1,0
8,221,221,79,79,0,1,0
24,249,249,21,21,0,1,0
10,275,275,46,6,40,3,2
27,277,277,37,37,0,1,0
15,289,289,39,12,27,4,3
3,304,304,11,11,0,1,0
25,313,313,13,13,0,1,0
16,343,343,63,37,26,2,1
30,353,353,106,52,54,4,3
28,359,359,38,38,0,1,0
4,381,381,27,24,3,2,1
22,393,393,23,23,0,1,0
13,434,434,27,27,0,1,0
9,453,453,68,22,46,4,3
7,453,453,68,47,21,4,3
6,457,457,13,13,0,1,0
18,477,477,6,6,0,1,0

28,109,109,23,15,8,3,2
21,127,127,13,13,0,1,0
15,133,133,1,1,0,1,0
37,158,158,9,4,5,2,1
25,172,172,7,7,0,1,0
26,176,176,6,6,0,1,0
35,179,179,57,14,43,2,1
23,186,186,31,17,14,3,2
36,189,189,30,30,0,1,0
14,193,193,54,54,0,1,0
20,193,193,4,4,0,1,0
8,203,203,21,21,0,1,0
0,222,222,32,6,26,3,2
30,225,225,50,11,39,4,3
19,226,226,25,25,0,1,0
24,233,233,2,2,0,1,0
31,240,240,4,4,0,1,0
34,242,242,25,25,0,1,0
22,244,244,8,8,0,1,0
12,249,249,8,8,0,1,0
6,256,256,5,5,0,1,0
38,265,265,4,4,0,1,0
29,293,293,22,11,11,2,1
13,294,294,13,3,10,2,1
3,301,301,7,1,6,3,2
32,314,314,3,3,0,1,0
27,318,318,55,47,8,3,2
2,330,330,47,47,0,1,0
11,338,338,74,25,49,2,1
18,349,349,8,8,0,1,0
5,359,359,10,1,9,2,1
1,362,362,3,3,0,1,0
33,371,371,32,2,30,2,1
9,382,382,17,4,13,3,2
7,418,418,61,14,47,4,3
4,420,420,40,40,0,1,0
10,449,449,16,16,0,1,0
17,449,449,31,31,0,1,0
16,469,469,2,2,0,1,0

22,114,114,22,15,7,2,1
2,119,119,8,2,6,2,1
21,141,141,7,3,4,2,1
12,146,146,30,30,0,1,0
24,149,149,17,8,9,2,1
19,157,157,53,10,43,2,1
27,169,169,9,9,0,1,0
3,216,216,19,19,0,1,0
33,216,216,12,12,0,1,0
30,221,221,4,4,0,1,0
5,242,242,10,4,6,3,2
9,243,243,12,12,0,1,0
11,249,249,5,5,0,1,0
16,262,262,47,47,0,1,0
25,268,268,19,6,13,2,1
31,271,271,6,3,3,2,1
7,278,278,13,1,12,2,1
26,292,292,66,32,34,3,2
32,310,310,5,5,0,1,0
6,324,324,4,4,0,1,0
17,329,329,52,14,38,4,3
36,340,340,34,10,24,4,3
34,349,349,26,26,0,1,0
28,357,357,3,3,0,1,0
4,359,359,27,27,0,1,0
29,406,406,60,35,25,2,1
1,421,421,26,5,21,2,1
35,438,438,227,183,44,3,2
23,443,443,13,1,12,3,2
20,451,451,20,20,0,1,0
14,458,458,13,8,5,2,1
8,472,472,1,1,0,1,0
13,472,472,87,6,81,4,3
10,473,473,4,4,0,1,0
18,475,475,10,10,0,1,0
15,475,475,8,8,0,1,0
0,500,500,50,40,10,3,2

30,120,120,5,5,0,1,0
33,141,141,2,2,0,1,0
16,155,155,11,1,10,3,2
2,168,168,44,44,0,1,0
14,174,174,27,7,20,3,2
12,192,192,22,22,0,1,0
24,198,198,2,2,0,1,0
18,201,201,21,1,20,2,1
15,211,211,1,1,0,1,0
11,221,221,9,9,0,1,0
10,222,222,14,2,12,4,3
20,226,226,14,5,9,2,1
8,243,243,25,8,17,2,1
5,253,253,26,4,22,4,3
28,267,267,17,17,0,1,0
25,287,287,45,45,0,1,0
26,297,297,57,12,45,4,3
23,302,302,35,5,30,3,2
27,307,307,61,47,14,2,1
0,315,315,49,4,45,4,3
19,318,318,2,2,0,1,0
3,348,348,15,10,5,2,1
9,355,355,40,40,0,1,0
21,367,367,78,32,46,3,2
29,369,369,22,22,0,1,0
6,370,370,26,12,14,3,2
7,377,377,39,39,0,1,0
22,396,396,24,15,9,2,1
17,407,407,43,43,0,1,0
1,409,409,29,29,0,1,0
4,455,455,63,63,0,1,0
13,477,477,44,38,6,3,2
32,485,485,87,55,32,3,2
31,491,491,76,76,0,1,0

37,107,107,20,20,0,1,0
11,114,114,12,12,0,1,0
21,148,148,31,19,12,3,2
25,149,149,10,10,0,1,0
3,158,158,2,2,0,1,0
30,158,158,26,23,3,2,1
23,169,169,2,2,0,1,0
15,173,173,3,3,0,1,0
33,188,188,16,16,0,1,0
20,191,191,1,1,0,1,0
38,198,198,32,32,0,1,0
40,200,200,8,3,5,2,1
19,218,218,28,17,11,2,1
35,226,226,71,59,12,4,3
31,239,239,12,12,0,1,0
0,277,277,22,22,0,1,0
14,287,287,49,49,0,1,0
17,296,296,3,3,0,1,0
4,306,306,20,20,0,1,0
13,306,306,33,11,22,3,2
39,320,320,43,43,0,1,0
28,322,322,46,1,45,4,3
22,322,322,9,9,0,1,0
6,327,327,31,31,0,1,0
29,329,329,22,8,14,3,2
27,351,351,2,2,0,1,0
1,353,353,9,9,0,1,0
10,360,360,5,5,0,1,0
34,360,360,19,11,8,2,1
9,373,373,9,1,8,3,2
32,383,383,34,2,32,3,2
24,414,414,21,21,0,1,0
5,426,426,116,116,0,1,0
18,432,432,17,17,0,1,0
12,446,446,31,31,0,1,0
2,457,457,44,44,0,1,0
36,458,458,37,37,0,1,0
7,467,467,6,6,0,1,0
16,484,484,15,15,0,1,0
26,484,484,16,1,15,4,3
8,500,500,35,15,20,2,1

28,119,119,28,21,7,2,1
6,122,122,7,7,0,1,0
30,125,125,5,5,0,1,0
29,151,151,13,5,8,2,1
32,169,169,15,7,8,3,2
22,171,171,8,8,0,1,0
8,178,178,20,2,18,2,1
12,182,182,38,32,6,2,1
17,184,184,23,23,0,1,0
26,201,201,22,22,0,1,0
31,210,210,43,43,0,1,0
4,216,216,6,6,0,1,0
27,228,228,19,13,6,3,2
16,232,232,53,44,9,4,3
21,244,244,6,3,3,2,1
9,251,251,78,78,0,1,0
18,270,270,5,5,0,1,0
20,279,279,20,20,0,1,0
15,295,295,1,1,0,1,0
3,304,304,6,6,0,1,0
7,311,311,25,25,0,1,0
35,332,332,41,41,0,1,0
19,348,348,25,16,9,4,3
1,352,352,10,10,0,1,0
24,354,354,33,8,25,2,1
23,357,357,4,4,0,1,0
34,357,357,48,48,0,1,0
11,386,386,8,8,0,1,0
10,390,390,39,29,10,2,1
13,394,394,30,24,6,3,2
25,398,398,36,36,0,1,0
0,407,407,25,25,0,1,0
5,418,418,18,10,8,2,1
2,422,422,40,8,32,3,2
33,436,436,98,98,0,1,0
14,484,484,41,25,16,3,2

20,118,118,11,11,0,1,0
27,119,119,17,17,0,1,0
1,127,127,18,13,5,2,1
13,131,131,8,8,0,1,0
19,144,144,12,12,0,1,0
5,170,170,17,17,0,1,0
11,204,204,4,4,0,1,0
14,216,216,3,3,0,1,0
22,220,220,8,1,7,3,2
2,224,224,27,9,18,4,3
16,254,254,7,7,0,1,0
25,276,276,4,1,3,2,1
18,284,284,43,29,14,3,2
15,285,285,33,33,0,1,0
17,285,285,12,12,0,1,0
12,289,289,60,60,0,1,0
28,331,331,51,12,39,4,3
4,347,347,20,20,0,1,0
8,359,359,6,6,0,1,0
24,405,405,30,30,0,1,0
7,408,408,6,6,0,1,0
0,418,418,87,60,27,2,1
3,421,421,69,17,52,3,2
10,431,431,61,1,60,3,2
29,433,433,47,47,0,1,0
9,455,455,200,200,0,1,0
26,455,455,33,33,0,1,0
23,458,458,133,133,0,1,0
21,481,481,127,127,0,1,0
6,491,491,35,35,0,1,0

27,109,109,17,17,0,1,0
1,157,157,1,1,0,1,0
24,160,160,19,19,0,1,0
28,163,163,7,7,0,1,0
23,171,171,8,8,0,1,0
10,186,186,5,5,0,1,0
11,194,194,62,62,0,1,0
0,203,203,6,6,0,1,0
18,211,211,5,5,0,1,0
22,216,216,18,8,10,3,2
15,229,229,4,4,0,1,0
26,286,286,82,82,0,1,0
16,290,290,9,3,6,3,2
3,300,300,72,72,0,1,0
33,309,309,87,35,52,4,3
2,311,311,90,11,79,4,3
14,336,336,45,4,41,2,1
9,352,352,1,1,0,1,0
5,356,356,3,3,0,1,0
6,360,360,27,27,0,1,0
13,360,360,17,3,14,2,1
29,366,366,1,1,0,1,0
19,388,388,24,17,7,2,1
17,392,392,25,25,0,1,0
12,416,416,4,4,0,1,0
34,419,419,41,3,38,3,2
8,422,422,60,60,0,1,0
7,448,448,1,1,0,1,0
21,449,449,32,32,0,1,0
32,461,461,64,64,0,1,0
31,465,465,1,1,0,1,0
20,481,481,90,41,49,2,1
4,485,485,124,42,82,3,2
25,491,491,15,15,0,1,0
30,496,496,50,50,0,1,0

4,117,117,29,5,24,3,2
2,121,121,1,1,0,1,0
31,123,123,2,2,0,1,0
22,133,133,3,3,0,1,0
12,136,136,2,2,0,1,0
15,139,139,13,13,0,1,0
27,171,171,2,2,0,1,0
0,174,174,10,10,0,1,0
26,184,184,1,1,0,1,0
19,209,209,2,2,0,1,0
6,218,218,15,5,10,3,2
18,268,268,121,100,21,2,1
20,277,277,8,8,0,1,0
5,278,278,87,35,52,3,2
30,289,289,12,12,0,1,0
14,290,290,1,1,0,1,0
13,293,293,30,7,23,3,2
29,301,301,40,40,0,1,0
16,320,320,109,109,0,1,0
9,325,325,51,25,26,2,1
24,337,337,7,7,0,1,0
32,339,339,21,21,0,1,0
1,371,371,3,3,0,1,0
3,375,375,2,2,0,1,0
21,387,387,55,12,43,2,1
28,387,387,117,29,88,4,3
10,399,399,193,154,39,2,1
7,402,402,20,11,9,2,1
8,421,421,22,22,0,1,0
11,436,436,17,12,5,2,1
23,453,453,13,5,8,3,2
25,463,463,52,23,29,2,1
17,489,489,3,3,0,1,0

33,105,105,15,3,12,4,3
21,117,117,3,3,0,1,0
31,123,123,4,4,0,1,0
11,136,136,1,1,0,1,0
36,138,138,11,11,0,1,0
3,142,142,3,3,0,1,0
27,143,143,7,3,4,2,1
12,144,144,4,4,0,1,0
16,173,173,16,1,15,4,3
26,196,196,6,6,0,1,0
4,198,198,30,30,0,1,0
17,203,203,13,13,0,1,0
15,211,211,12,12,0,1,0
2,223,223,15,6,9,2,1
23,225,225,30,11,19,2,1
25,228,228,27,2,25,3,2
9,235,235,41,41,0,1,0
24,241,241,41,41,0,1,0
1,252,252,12,12,0,1,0
28,261,261,6,2,4,2,1
5,290,290,8,8,0,1,0
22,301,301,3,3,0,1,0
18,306,306,6,6,0,1,0
40,312,312,22,4,18,3,2
35,322,322,178,142,36,4,3
0,342,342,16,2,14,3,2
13,353,353,15,5,10,3,2
6,360,360,1,1,0,1,0
29,368,368,27,27,0,1,0
7,372,372,35,35,0,1,0
32,392,392,98,98,0,1,0
14,401,401,41,17,24,4,3
37,434,434,47,47,0,1,0
19,437,437,13,7,6,3,2
8,442,442,18,18,0,1,0
30,447,447,5,5,0,1,0
39,450,450,3,3,0,1,0
34,452,452,1,1,0,1,0
10,460,460,44,7,37,4,3
20,471,471,151,78,73,3,2
38,489,489,6,2,4,2,1

30,109,109,16,16,0,1,0
12,121,121,3,3,0,1,0
10,125,125,12,4,8,2,1
33,150,150,25,8,17,3,2
14,154,154,12,12,0,1,0
36,155,155,60,60,0,1,0
27,178,178,4,4,0,1,0
34,178,178,7,7,0,1,0
28,195,195,11,8,3,2,1
31,229,229,10,10,0,1,0
16,236,236,15,15,0,1,0
7,250,250,55,55,0,1,0
11,251,251,6,6,0,1,0
6,266,266,41,13,28,3,2
23,267,267,3,3,0,1,0
1,269,269,35,22,13,2,1
0,276,276,57,57,0,1,0
8,276,276,3,3,0,1,0
32,279,279,17,8,9,2,1
13,286,286,26,8,18,3,2
37,295,295,72,32,40,4,3
25,317,317,16,16,0,1,0
9,328,328,13,13,0,1,0
3,330,330,9,9,0,1,0
22,331,331,27,27,0,1,0
15,331,331,56,8,48,4,3
21,335,335,35,35,0,1,0
35,353,353,42,20,22,2,1
24,379,379,22,4,18,3,2
26,388,388,35,21,14,2,1
29,409,409,23,23,0,1,0
20,414,414,17,17,0,1,0
2,416,416,25,21,4,2,1
19,423,423,4,4,0,1,0
18,441,441,11,11,0,1,0
4,452,452,20,17,3,2,1
5,453,453,27,3,24,3,2
17,480,480,61,61,0,1,0

21,109,109,3,3,0,1,0
11,120,120,26,12,14,3,2
15,121,121,14,14,0,1,0
32,125,125,76,69,7,2,1
20,137,137,10,10,0,1,0
29,139,139,6,6,0,1,0
7,151,151,17,17,0,1,0
18,173,173,5,5,0,1,0
0,175,175,12,12,0,1,0
13,185,185,6,6,0,1,0
26,194,194,19,19,0,1,0
4,217,217,18,18,0,1,0
14,218,218,20,20,0,1,0
22,223,223,5,5,0,1,0
25,229,229,37,37,0,1,0
12,248,248,14,14,0,1,0
24,291,291,2,2,0,1,0
3,302,302,2,2,0,1,0
1,306,306,20,20,0,1,0
23,310,310,25,25,0,1,0
30,329,329,1,1,0,1,0
9,331,331,93,93,0,1,0
6,332,332,29,29,0,1,0
31,345,345,36,20,16,2,1
28,346,346,12,4,8,3,2
10,358,358,25,25,0,1,0
17,426,426,18,18,0,1,0
16,426,426,55,55,0,1,0
27,434,434,61,11,50,2,1
5,441,441,38,38,0,1,0
8,481,481,132,132,0,1,0
2,491,491,28,2,26,3,2
19,494,494,67,36,31,2,1

39,101,101,28,28,0,1,0
6,107,107,18,2,16,2,1
28,111,111,5,5,0,1,0
17,113,113,8,8,0,1,0
14,116,116,1,1,0,1,0
21,119,119,4,4,0,1,0
3,129,129,8,8,0,1,0
32,133,133,8,4,4,2,1
12,136,136,16,16,0,1,0
26,146,146,23,23,0,1,0
25,150,150,2,2,0,1,0
5,153,153,2,2,0,1,0
33,164,164,5,5,0,1,0
15,173,173,8,8,0,1,0
37,176,176,8,8,0,1,0
1,176,176,5,2,3,2,1
23,181,181,36,3,33,4,3
18,190,190,2,2,0,1,0
24,231,231,15,15,0,1,0
20,240,240,1,1,0,1,0
2,241,241,11,3,8,2,1
8,264,264,110,55,55,4,3
7,275,275,17,17,0,1,0
11,295,295,18,18,0,1,0
16,299,299,4,1,3,2,1
30,306,306,65,39,26,2,1
0,313,313,9,3,6,3,2
29,322,322,44,5,39,2,1
10,342,342,15,15,0,1,0
31,348,348,8,8,0,1,0
19,369,369,21,21,0,1,0
38,378,378,8,4,4,2,1
9,381,381,15,15,0,1,0
27,383,383,28,4,24,2,1
34,396,396,125,125,0,1,0
35,396,396,22,2,20,3,2
13,422,422,80,35,45,4,3
22,439,439,47,47,0,1,0
4,445,445,33,19,14,2,1
36,466,466,4,1,3,2,1

6,115,115,14,10,4,2,1
18,136,136,15,15,0,1,0
21,164,164,29,29,0,1,0
4,181,181,37,10,27,2,1
16,182,182,32,26,6,3,2
19,184,184,12,12,0,1,0
8,200,200,8,8,0,1,0
27,203,203,43,36,7,2,1
12,220,220,24,8,16,2,1
7,234,234,43,15,28,3,2
22,236,236,1,1,0,1,0
9,244,244,15,4,11,2,1
0,285,285,12,12,0,1,0
15,316,316,8,8,0,1,0
11,318,318,20,20,0,1,0
1,368,368,12,9,3,2,1
20,369,369,5,5,0,1,0
26,382,382,17,17,0,1,0
14,388,388,52,52,0,1,0
25,393,393,71,71,0,1,0
5,403,403,173,103,70,3,2
10,404,404,139,107,32,3,2
23,407,407,2,2,0,1,0
28,458,458,77,38,39,4,3
29,464,464,80,80,0,1,0
13,469,469,18,12,6,2,1
17,486,486,6,3,3,2,1
3,489,489,6,6,0,1,0
30,493,493,92,92,0,1,0
2,495,495,9,3,6,3,2
24,499,499,18,8,10,3,2

34,100,100,9,5,4,2,1
29,100,100,3,3,0,1,0
12,121,121,2,2,0,1,0
2,126,126,1,1,0,1,0
18,134,134,38,38,0,1,0
14,149,149,1,1,0,1,0
24,155,155,29,20,9,4,3
3,170,170,1,1,0,1,0
16,180,180,5,1,4,2,1
6,195,195,11,11,0,1,0
9,208,208,37,25,12,4,3
17,212,212,21,4,17,4,3
28,224,224,27,2,25,2,1
20,226,226,34,6,28,3,2
1,231,231,50,31,19,2,1
0,246,246,20,14,6,2,1
19,257,257,19,19,0,1,0
11,275,275,20,20,0,1,0
30,305,305,82,39,43,2,1
32,305,305,19,19,0,1,0
21,317,317,9,3,6,2,1
35,346,346,10,1,9,2,1
15,348,348,13,9,4,2,1
22,354,354,5,5,0,1,0
13,366,366,41,11,30,3,2
31,388,388,65,65,0,1,0
33,392,392,35,35,0,1,0
4,393,393,29,29,0,1,0
8,414,414,71,17,54,4,3
27,426,426,43,26,17,2,1
25,431,431,11,11,0,1,0
10,432,432,103,89,14,3,2
5,439,439,2,2,0,1,0
26,452,452,22,22,0,1,0
7,475,475,6,6,0,1,0
23,485,485,125,125,0,1,0

1,100,100,2,2,0,1,0
27,105,105,15,9,6,2,1
28,112,112,8,3,5,2,1
25,118,118,35,15,20,2,1
19,129,129,31,31,0,1,0
26,133,133,3,3,0,1,0
10,145,145,32,6,26,3,2
4,157,157,8,8,0,1,0
18,176,176,7,7,0,1,0
8,183,183,4,4,0,1,0
16,188,188,1,1,0,1,0
20,207,207,47,8,39,4,3
13,213,213,16,1,15,4,3
15,219,219,5,2,3,2,1
11,227,227,69,69,0,1,0
21,237,237,28,14,14,4,3
0,264,264,4,4,0,1,0
12,289,289,4,4,0,1,0
9,300,300,39,39,0,1,0
6,311,311,88,1,87,4,3
24,333,333,11,11,0,1,0
23,365,365,5,5,0,1,0
22,376,376,65,65,0,1,0
5,405,405,29,9,20,2,1
17,423,423,61,61,0,1,0
2,427,427,45,21,24,3,2
7,453,453,133,133,0,1,0
14,473,473,48,48,0,1,0
3,495,495,93,70,23,3,2

26,103,103,1,1,0,1,0
3,112,112,12,3,9,3,2
12,132,132,9,9,0,1,0
25,132,132,2,2,0,1,0
19,136,136,10,10,0,1,0
4,146,146,25,21,4,2,1
15,165,165,43,43,0,1,0
13,171,171,16,11,5,2,1
0,197,197,31,31,0,1,0
9,223,223,1,1,0,1,0
7,253,253,5,5,0,1,0
20,258,258,34,34,0,1,0
17,263,263,8,8,0,1,0
10,274,274,2,2,0,1,0
6,277,277,61,61,0,1,0
14,277,277,14,2,12,4,3
21,313,313,24,24,0,1,0
30,314,314,111,84,27,2,1
24,345,345,39,7,32,3,2
11,354,354,45,18,27,4,3
8,356,356,18,18,0,1,0
28,359,359,31,31,0,1,0
32,373,373,54,31,23,2,1
1,379,379,16,16,0,1,0
2,380,380,57,33,24,4,3
27,393,393,19,19,0,1,0
29,420,420,115,115,0,1,0
33,435,435,9,9,0,1,0
18,440,440,32,27,5,2,1
31,446,446,7,7,0,1,0
5,460,460,24,1,23,2,1
16,466,466,55,55,0,1,0
23,468,468,90,90,0,1,0
22,468,468,32,32,0,1,0

5,114,114,15,1,14,2,1
21,119,119,14,2,12,4,3
29,122,122,42,42,0,1,0
34,138,138,9,9,0,1,0
25,148,148,5,2,3,2,1
20,148,148,4,4,0,1,0
15,158,158,7,7,0,1,0
33,189,189,37,37,0,1,0
28,210,210,21,3,18,2,1
30,211,211,36,36,0,1,0
4,223,223,30,30,0,1,0
9,225,225,65,65,0,1,0
26,230,230,10,4,6,3,2
12,230,230,48,22,26,3,2
8,236,236,53,42,11,2,1
13,239,239,7,1,6,3,2
0,248,248,20,5,15,2,1
32,252,252,20,20,0,1,0
2,265,265,24,8,16,2,1
3,266,266,6,1,5,2,1
11,266,266,25,25,0,1,0
14,271,271,6,6,0,1,0
17,303,303,5,5,0,1,0
1,310,310,11,6,5,2,1
16,355,355,27,6,21,3,2
7,384,384,18,18,0,1,0
19,401,401,44,44,0,1,0
23,402,402,52,52,0,1,0
22,463,463,15,15,0,1,0
6,464,464,23,7,16,2,1
27,473,473,84,84,0,1,0
31,480,480,18,18,0,1,0
24,485,485,24,24,0,1,0
18,493,493,11,11,0,1,0
10,498,498,53,8,45,4,3

21,105,105,5,5,0,1,0
1,113,113,12,12,0,1,0
27,125,125,16,16,0,1,0
7,134,134,11,8,3,2,1
29,158,158,4,4,0,1,0
35,176,176,25,25,0,1,0
10,176,176,27,27,0,1,0
28,193,193,3,3,0,1,0
14,198,198,14,4,10,4,3
32,217,217,17,17,0,1,0
4,218,218,1,1,0,1,0
6,221,221,29,29,0,1,0
12,235,235,12,12,0,1,0
5,238,238,2,2,0,1,0
13,240,240,30,30,0,1,0
33,241,241,39,39,0,1,0
20,243,243,6,6,0,1,0
18,264,264,35,21,14,2,1
15,275,275,17,14,3,2,1
22,276,276,45,45,0,1,0
16,276,276,7,7,0,1,0
8,295,295,7,7,0,1,0
23,304,304,15,6,9,4,3
11,327,327,99,27,72,3,2
19,333,333,89,89,0,1,0
34,334,334,36,36,0,1,0
3,336,336,46,27,19,2,1
24,346,346,30,30,0,1,0
25,346,346,32,32,0,1,0
26,391,391,88,88,0,1,0
30,391,391,8,8,0,1,0
9,422,422,67,52,15,4,3
0,447,447,42,9,33,2,1
31,463,463,45,45,0,1,0
2,464,464,14,14,0,1,0
17,487,487,2,2,0,1,0

6,101,101,10,10,0,1,0
29,116,116,4,4,0,1,0
11,124,124,35,35,0,1,0
4,128,128,1,1,0,1,0
19,137,137,16,2,14,3,2
14,164,164,5,5,0,1,0
9,185,185,5,2,3,2,1
1,206,206,28,4,24,2,1
35,213,213,41,41,0,1,0
31,216,216,10,10,0,1,0
8,222,222,27,27,0,1,0
32,233,233,4,4,0,1,0
23,239,239,47,47,0,1,0
7,247,247,7,7,0,1,0
28,254,254,56,34,22,2,1
5,269,269,22,22,0,1,0
15,271,271,32,17,15,4,3
24,276,276,15,4,11,2,1
13,292,292,11,11,0,1,0
17,295,295,22,22,0,1,0
16,323,323,22,22,0,1,0
2,340,340,17,3,14,2,1
37,352,352,36,22,14,3,2
33,359,359,2,2,0,1,0
12,359,359,35,17,18,2,1
26,366,366,13,13,0,1,0
36,378,378,68,19,49,3,2
22,399,399,17,17,0,1,0
27,422,422,54,54,0,1,0
30,443,443,27,17,10,3,2
0,450,450,13,7,6,3,2
25,456,456,134,134,0,1,0
10,466,466,21,12,9,3,2
20,468,468,39,27,12,3,2
18,468,468,29,13,16,3,2
3,479,479,50,10,40,3,2
34,483,483,24,1,23,2,1
21,489,489,34,34,0,1,0

12,100,100,2,2,0,1,0
9,100,100,5,5,0,1,0
3,102,102,24,5,19,3,2
25,111,111,13,5,8,2,1
10,119,119,12,5,7,2,1
19,123,123,22,22,0,1,0
23,125,125,20,1,19,2,1
31,127,127,7,1,6,3,2
6,140,140,1,1,0,1,0
21,141,141,32,26,6,3,2
30,145,145,48,21,27,4,3
1,147,147,5,5,0,1,0
27,152,152,10,5,5,2,1
2,165,165,51,25,26,3,2
16,175,175,9,9,0,1,0
24,184,184,1,1,0,1,0
5,249,249,2,2,0,1,0
26,250,250,15,10,5,2,1
22,274,274,65,36,29,2,1
28,286,286,8,5,3,2,1
15,303,303,55,21,34,3,2
11,325,325,34,9,25,2,1
0,329,329,23,14,9,4,3
8,329,329,12,12,0,1,0
33,336,336,1,1,0,1,0
7,368,368,58,16,42,3,2
13,372,372,18,18,0,1,0
32,385,385,14,14,0,1,0
17,401,401,24,9,15,2,1
18,409,409,28,7,21,4,3
29,413,413,19,19,0,1,0
4,413,413,115,115,0,1,0
14,443,443,4,4,0,1,0
20,457,457,25,17,8,3,2

0,102,102,2,2,0,1,0
1,112,112,48,48,0,1,0
26,131,131,16,16,0,1,0
5,134,134,4,4,0,1,0
30,147,147,12,12,0,1,0
22,163,163,10,10,0,1,0
18,174,174,37,22,15,4,3
19,194,194,9,9,0,1,0
8,219,219,56,56,0,1,0
27,221,221,1,1,0,1,0
15,262,262,49,49,0,1,0
3,271,271,10,10,0,1,0
25,305,305,19,19,0,1,0
20,313,313,83,73,10,2,1
14,327,327,8,8,0,1,0
7,331,331,5,1,4,2,1
24,362,362,42,8,34,2,1
23,363,363,35,35,0,1,0
29,364,364,37,37,0,1,0
9,374,374,1,1,0,1,0
2,386,386,11,1,10,2,1
28,400,400,53,13,40,2,1
12,407,407,37,1,36,2,1
17,415,415,16,1,15,2,1
13,421,421,86,48,38,3,2
11,436,436,136,87,49,2,1
4,438,438,14,11,3,2,1
10,482,482,63,53,10,2,1
16,484,484,5,5,0,1,0
6,492,492,56,9,47,2,1
21,499,499,87,29,58,3,2

18,104,104,10,1,9,2,1
26,106,106,22,22,0,1,0
38,143,143,4,4,0,1,0
7,144,144,1,1,0,1,0
2,146,146,3,3,0,1,0
8,147,147,1,1,0,1,0
36,158,158,13,3,10,2,1
35,174,174,4,1,3,2,1
23,175,175,11,1,10,2,1
9,175,175,3,3,0,1,0
0,182,182,25,20,5,2,1
32,189,189,21,3,18,4,3
27,200,200,4,1,3,2,1
30,201,201,33,2,31,2,1
5,223,223,17,8,9,4,3
24,238,238,24,24,0,1,0
1,238,238,34,10,24,2,1
15,253,253,26,17,9,4,3
20,259,259,1,1,0,1,0
31,271,271,41,41,0,1,0
3,272,272,83,43,40,3,2
14,272,272,12,2,10,2,1
22,289,289,4,4,0,1,0
33,304,304,18,13,5,2,1
4,308,308,21,21,0,1,0
19,323,323,107,94,13,3,2
37,324,324,1,1,0,1,0
16,342,342,15,15,0,1,0
11,346,346,1,1,0,1,0
39,354,354,17,11,6,2,1
29,371,371,24,4,20,3,2
34,387,387,113,62,51,4,3
40,399,399,115,57,58,4,3
28,417,417,9,9,0,1,0
6,420,420,19,4,15,2,1
21,421,421,2,2,0,1,0
12,431,431,13,13,0,1,0
10,431,431,5,5,0,1,0
13,469,469,32,32,0,1,0
25,491,491,34,7,27,4,3
17,494,494,29,5,24,3,2

21,113,113,11,11,0,1,0
12,113,113,1,1,0,1,0
25,114,114,1,1,0,1,0
27,122,122,47,19,28,2,1
7,124,124,6,6,0,1,0
9,171,171,99,24,75,4,3
3,184,184,81,70,11,2,1
17,204,204,10,10,0,1,0
11,222,222,10,7,3,2,1
10,224,224,1,1,0,1,0
19,231,231,17,17,0,1,0
13,236,236,39,13,26,2,1
20,236,236,9,9,0,1,0
0,298,298,46,3,43,2,1
5,299,299,10,10,0,1,0
4,301,301,26,6,20,2,1
28,322,322,8,8,0,1,0
22,329,329,6,6,0,1,0
15,333,333,29,11,18,2,1
26,339,339,25,6,19,2,1
16,343,343,28,1,27,4,3
18,364,364,133,133,0,1,0
6,370,370,15,9,6,3,2
24,399,399,20,20,0,1,0
2,403,403,60,4,56,3,2
23,405,405,58,2,56,3,2
1,412,412,30,30,0,1,0
29,486,486,35,35,0,1,0
8,497,497,20,20,0,1,0
14,500,500,1,1,0,1,0

39,121,121,12,6,6,2,1
29,121,121,25,3,22,2,1
34,122,122,16,8,8,2,1
23,123,123,3,3,0,1,0
25,137,137,3,3,0,1,0
32,149,149,27,27,0,1,0
9,154,154,29,29,0,1,0
10,163,163,7,1,6,3,2
42,176,176,3,3,0,1,0
27,186,186,21,21,0,1,0
37,190,190,9,9,0,1,0
4,216,216,1,1,0,1,0
13,219,219,40,12,28,2,1
24,232,232,1,1,0,1,0
41,235,235,1,1,0,1,0
20,243,243,22,22,0,1,0
28,258,258,10,10,0,1,0
33,294,294,4,4,0,1,0
22,297,297,76,34,42,2,1
6,307,307,4,4,0,1,0
11,310,310,12,5,7,2,1
7,311,311,11,2,9,2,1
8,312,312,1,1,0,1,0
16,323,323,35,35,0,1,0
18,333,333,22,22,0,1,0
31,360,360,11,11,0,1,0
3,371,371,8,3,5,2,1
40,373,373,55,19,36,3,2
19,382,382,4,1,3,2,1
5,404,404,45,11,34,3,2
15,405,405,87,51,36,2,1
17,409,409,9,2,7,2,1
26,419,419,53,21,32,2,1
30,421,421,113,113,0,1,0
43,424,424,38,38,0,1,0
35,432,432,38,38,0,1,0
38,446,446,71,23,48,2,1
21,450,450,7,1,6,3,2
14,451,451,10,10,0,1,0
36,463,463,47,34,13,2,1
0,463,463,30,13,17,2,1
2,463,463,3,3,0,1,0
1,464,464,1,1,0,1,0
12,474,474,1,1,0,1,0

13,101,101,11,2,9,4,3
27,107,107,27,27,0,1,0
11,115,115,7,7,0,1,0
14,117,117,2,2,0,1,0
26,118,118,2,2,0,1,0
21,123,123,2,2,0,1,0
24,132,132,3,3,0,1,0
19,134,134,15,15,0,1,0
29,135,135,59,59,0,1,0
32,152,152,7,7,0,1,0
16,178,178,1,1,0,1,0
4,182,182,59,36,23,2,1
20,183,183,3,3,0,1,0
8,195,195,77,16,61,4,3
5,256,256,75,33,42,3,2
6,265,265,30,6,24,2,1
30,274,274,63,40,23,2,1
18,288,288,79,79,0,1,0
1,317,317,6,6,0,1,0
9,328,328,41,2,39,4,3
2,352,352,6,2,4,2,1
3,353,353,1,1,0,1,0
17,355,355,9,3,6,2,1
28,377,377,28,8,20,3,2
25,391,391,22,22,0,1,0
15,392,392,2,2,0,1,0
12,396,396,10,1,9,4,3
7,396,396,39,15,24,2,1
31,423,423,48,15,33,2,1
22,428,428,17,9,8,2,1
10,471,471,5,5,0,1,0
23,472,472,2,2,0,1,0
0,476,476,41,41,0,1,0

11,123,123,3,3,0,1,0
4,130,130,1,1,0,1,0
3,156,156,6,6,0,1,0
26,182,182,12,4,8,2,1
17,191,191,11,2,9,4,3
6,193,193,26,26,0,1,0
8,201,201,3,3,0,1,0
13,218,218,54,54,0,1,0
15,252,252,7,4,3,2,1
20,263,263,77,37,40,3,2
25,268,268,23,23,0,1,0
27,272,272,20,7,13,2,1
7,304,304,63,14,49,4,3
2,305,305,15,1,14,2,1
19,330,330,35,35,0,1,0
24,334,334,93,93,0,1,0
10,348,348,112,9,103,4,3
14,355,355,17,17,0,1,0
12,363,363,117,52,65,4,3
23,379,379,3,3,0,1,0
16,387,387,14,6,8,2,1
21,408,408,6,6,0,1,0
0,425,425,256,121,135,4,3
1,433,433,53,29,24,4,3
9,441,441,85,23,62,4,3
5,452,452,5,5,0,1,0
22,484,484,16,1,15,4,3
18,490,490,5,5,0,1,0

30,108,108,5,2,3,2,1
13,125,125,5,5,0,1,0
1,128,128,7,4,3,2,1
37,141,141,11,11,0,1,0
7,153,153,5,5,0,1,0
14,162,162,14,8,6,2,1
21,163,163,8,8,0,1,0
11,166,166,31,25,6,2,1
8,168,168,1,1,0,1,0
25,186,186,29,29,0,1,0
17,192,192,8,8,0,1,0
32,200,200,43,1,42,4,3
18,206,206,60,60,0,1,0
0,210,210,13,5,8,3,2
22,226,226,115,52,63,4,3
31,231,231,6,6,0,1,0
2,244,244,3,3,0,1,0
4,258,258,52,52,0,1,0
27,262,262,7,7,0,1,0
12,269,269,24,24,0,1,0
36,278,278,27,27,0,1,0
19,281,281,13,7,6,3,2
5,319,319,15,5,10,2,1
15,324,324,17,17,0,1,0
23,343,343,6,6,0,1,0
24,345,345,26,26,0,1,0
16,351,351,11,11,0,1,0
3,356,356,7,7,0,1,0
28,372,372,15,6,9,4,3
20,381,381,22,4,18,4,3
26,399,399,3,3,0,1,0
33,413,413,13,6,7,2,1
6,414,414,33,33,0,1,0
9,424,424,2,2,0,1,0
29,482,482,16,16,0,1,0
34,485,485,56,13,43,2,1
35,493,493,104,53,51,4,3
10,494,494,127,73,54,4,3

7,157,157,15,15,0,1,0
29,165,165,18,3,15,4,3
24,168,168,5,5,0,1,0
10,172,172,2,2,0,1,0
25,181,181,9,9,0,1,0
9,184,184,2,2,0,1,0
18,195,195,11,2,9,4,3
21,211,211,27,18,9,2,1
8,223,223,3,3,0,1,0
16,247,247,36,28,8,2,1
19,257,257,13,5,8,3,2
5,258,258,19,2,17,2,1
28,262,262,73,16,57,4,3
11,266,266,5,5,0,1,0
13,275,275,58,58,0,1,0
12,276,276,3,3,0,1,0
3,281,281,31,7,24,4,3
1,284,284,94,63,31,2,1
23,304,304,14,5,9,4,3
20,310,310,6,2,4,2,1
22,335,335,34,10,24,3,2
14,346,346,29,13,16,2,1
17,357,357,14,14,0,1,0
30,361,361,45,33,12,4,3
2,361,361,13,13,0,1,0
4,381,381,59,59,0,1,0
27,411,411,124,124,0,1,0
0,437,437,75,75,0,1,0
15,438,438,61,61,0,1,0
6,470,470,213,118,95,4,3
26,497,497,15,9,6,3,2

20,101,101,9,9,0,1,0
12,110,110,1,1,0,1,0
16,116,116,2,2,0,1,0
15,120,120,1,1,0,1,0
30,129,129,14,14,0,1,0
13,130,130,7,7,0,1,0
17,131,131,10,7,3,2,1
10,134,134,32,32,0,1,0
22,136,136,10,10,0,1,0
5,150,150,24,8,16,3,2
28,159,159,6,6,0,1,0
21,168,168,26,26,0,1,0
0,177,177,20,16,4,2,1
33,180,180,12,12,0,1,0
14,202,202,10,2,8,3,2
7,204,204,27,5,22,3,2
3,240,240,1,1,0,1,0
18,248,248,17,5,12,3,2
8,250,250,11,8,3,2,1
19,256,256,21,21,0,1,0
26,269,269,14,3,11,2,1
24,322,322,64,49,15,4,3
29,331,331,25,25,0,1,0
25,337,337,68,17,51,4,3
32,381,381,35,15,20,2,1
6,383,383,1,1,0,1,0
23,386,386,71,20,51,4,3
4,387,387,123,88,35,2,1
31,422,422,43,38,5,2,1
27,457,457,35,32,3,2,1
2,477,477,43,3,40,3,2
9,478,478,115,53,62,3,2
1,498,498,85,85,0,1,0
11,500,500,27,14,13,4,3

32,111,111,8,8,0,1,0
40,119,119,9,9,0,1,0
29,122,122,2,2,0,1,0
33,129,129,27,27,0,1,0
6,132,132,26,14,12,3,2
19,157,157,1,1,0,1,0
8,166,166,2,2,0,1,0
11,177,177,2,2,0,1,0
37,181,181,10,10,0,1,0
7,187,187,15,1,14,2,1
39,188,188,20,20,0,1,0
13,195,195,4,4,0,1,0
2,207,207,15,15,0,1,0
38,214,214,1,1,0,1,0
28,218,218,29,29,0,1,0
0,242,242,48,37,11,2,1
20,246,246,40,40,0,1,0
31,264,264,45,28,17,2,1
36,299,299,57,16,41,2,1
17,306,306,14,14,0,1,0
1,308,308,8,2,6,3,2
41,321,321,53,53,0,1,0
23,343,343,2,2,0,1,0
21,345,345,21,14,7,2,1
5,346,346,23,23,0,1,0
10,358,358,31,10,21,2,1
25,368,368,46,37,9,4,3
30,372,372,36,36,0,1,0
27,373,373,57,57,0,1,0
26,375,375,42,42,0,1,0
24,382,382,28,19,9,2,1
35,385,385,5,1,4,2,1
22,386,386,34,34,0,1,0
14,389,389,11,11,0,1,0
18,411,411,5,5,0,1,0
4,415,415,45,45,0,1,0
34,419,419,13,5,8,3,2
3,437,437,43,43,0,1,0
16,454,454,50,50,0,1,0
9,464,464,7,1,6,2,1
15,482,482,47,27,20,3,2
12,485,485,9,9,0,1,0

28,100,100,12,7,5,2,1
21,103,103,13,13,0,1,0
14,117,117,5,2,3,2,1
7,143,143,6,1,5,2,1
5,151,151,3,3,0,1,0
12,188,188,73,73,0,1,0
32,215,215,20,4,16,3,2
29,221,221,1,1,0,1,0
8,229,229,41,4,37,2,1
10,235,235,20,2,18,4,3
30,237,237,3,3,0,1,0
36,243,243,6,6,0,1,0
24,256,256,45,37,8,2,1
0,269,269,9,9,0,1,0
9,295,295,13,4,9,2,1
16,303,303,19,19,0,1,0
1,308,308,5,5,0,1,0
26,325,325,45,45,0,1,0
2,329,329,1,1,0,1,0
31,331,331,28,28,0,1,0
35,357,357,10,10,0,1,0
13,360,360,24,24,0,1,0
6,373,373,13,7,6,3,2
11,395,395,21,21,0,1,0
34,396,396,56,56,0,1,0
3,400,400,4,4,0,1,0
20,408,408,47,14,33,4,3
25,421,421,106,16,90,4,3
22,439,439,128,128,0,1,0
33,440,440,9,9,0,1,0
37,446,446,85,48,37,2,1
17,448,448,48,48,0,1,0
4,456,456,57,51,6,2,1
18,461,461,92,45,47,2,1
23,479,479,14,14,0,1,0
19,484,484,2,2,0,1,0
27,496,496,2,2,0,1,0
15,500,500,34,24,10,2,1

32,116,116,42,10,32,3,2
23,120,120,3,3,0,1,0
31,130,130,28,28,0,1,0
4,153,153,35,23,12,3,2
3,153,153,5,5,0,1,0
25,178,178,6,6,0,1,0
0,183,183,5,2,3,2,1
20,187,187,6,6,0,1,0
11,205,205,8,8,0,1,0
7,209,209,22,22,0,1,0
29,224,224,20,20,0,1,0
14,238,238,69,3,66,4,3
1,241,241,3,3,0,1,0
16,243,243,46,28,18,2,1
13,264,264,38,38,0,1,0
21,269,269,2,2,0,1,0
19,287,287,3,3,0,1,0
9,298,298,23,8,15,4,3
12,306,306,34,25,9,4,3
5,308,308,47,47,0,1,0
27,324,324,54,54,0,1,0
6,330,330,16,16,0,1,0
10,337,337,43,10,33,4,3
28,369,369,24,12,12,3,2
8,398,398,81,81,0,1,0
26,400,400,6,2,4,2,1
15,406,406,5,1,4,2,1
30,436,436,15,12,3,2,1
2,436,436,39,39,0,1,0
18,439,439,34,10,24,4,3
17,451,451,12,12,0,1,0
22,474,474,176,70,106,4,3
24,486,486,6,2,4,2,1

26,109,109,11,11,0,1,0
4,112,112,10,10,0,1,0
27,136,136,3,3,0,1,0
10,137,137,6,6,0,1,0
22,148,148,17,14,3,2,1
11,149,149,6,6,0,1,0
7,159,159,23,5,18,3,2
3,168,168,1,1,0,1,0
19,181,181,11,2,9,4,3
12,183,183,6,6,0,1,0
28,185,185,2,2,0,1,0
21,198,198,9,9,0,1,0
16,226,226,4,4,0,1,0
15,234,234,8,1,7,2,1
6,245,245,13,7,6,3,2
1,249,249,21,21,0,1,0
32,259,259,51,15,36,4,3
13,261,261,66,22,44,3,2
29,270,270,2,2,0,1,0
14,309,309,21,1,20,4,3
35,312,312,124,70,54,3,2
25,313,313,18,11,7,2,1
2,346,346,3,3,0,1,0
8,371,371,105,105,0,1,0
0,394,394,24,8,16,2,1
33,396,396,14,14,0,1,0
34,399,399,26,26,0,1,0
24,402,402,23,9,14,3,2
18,402,402,97,85,12,3,2
20,428,428,21,9,12,3,2
5,442,442,58,22,36,2,1
17,443,443,4,4,0,1,0
31,448,448,92,74,18,4,3
9,457,457,46,46,0,1,0
30,469,469,110,45,65,4,3
23,481,481,32,32,0,1,0

12,107,107,10,6,4,2,1
19,135,135,4,1,3,2,1
20,152,152,27,27,0,1,0
11,160,160,7,7,0,1,0
9,175,175,22,22,0,1,0
15,183,183,32,19,13,2,1
7,191,191,38,25,13,2,1
6,226,226,68,52,16,3,2
22,227,227,9,9,0,1,0
14,269,269,5,5,0,1,0
21,271,271,36,14,22,2,1
3,294,294,26,4,22,2,1
10,304,304,22,1,21,2,1
24,355,355,142,37,105,4,3
2,355,355,39,39,0,1,0
5,365,365,24,4,20,4,3
26,407,407,30,6,24,3,2
8,410,410,133,71,62,3,2
16,428,428,23,23,0,1,0
4,431,431,9,9,0,1,0
1,433,433,195,134,61,3,2
18,458,458,86,45,41,2,1
17,459,459,12,8,4,2,1
0,482,482,8,2,6,3,2
25,482,482,43,43,0,1,0
13,487,487,32,32,0,1,0
23,495,495,27,15,12,4,3

11,129,129,21,15,6,3,2
3,130,130,46,20,26,3,2
7,180,180,8,8,0,1,0
27,189,189,1,1,0,1,0
22,193,193,21,21,0,1,0
2,208,208,2,2,0,1,0
6,210,210,1,1,0,1,0
29,245,245,4,4,0,1,0
12,256,256,18,9,9,4,3
21,258,258,24,4,20,3,2
0,262,262,59,32,27,2,1
23,280,280,33,11,22,2,1
14,296,296,13,9,4,2,1
13,309,309,19,19,0,1,0
25,315,315,16,16,0,1,0
16,320,320,4,4,0,1,0
5,333,333,128,11,117,4,3
28,336,336,18,5,13,2,1
19,344,344,14,6,8,3,2
9,363,363,6,3,3,2,1
10,381,381,17,2,15,4,3
1,397,397,2,2,0,1,0
26,405,405,109,109,0,1,0
4,412,412,156,156,0,1,0
24,421,421,11,11,0,1,0
8,428,428,1,1,0,1,0
18,434,434,9,9,0,1,0
20,448,448,220,220,0,1,0
15,458,458,112,112,0,1,0
17,494,494,33,33,0,1,0

4,103,103,2,2,0,1,0
3,118,118,18,18,0,1,0
1,128,128,21,21,0,1,0
20,134,134,3,3,0,1,0
35,141,141,12,12,0,1,0
2,146,146,5,5,0,1,0
15,162,162,25,11,14,2,1
25,181,181,2,2,0,1,0
8,184,184,20,6,14,2,1
22,185,185,11,11,0,1,0
0,186,186,1,1,0,1,0
9,216,216,51,51,0,1,0
36,245,245,25,25,0,1,0
19,275,275,17,17,0,1,0
14,295,295,9,9,0,1,0
30,299,299,18,9,9,2,1
17,312,312,43,43,0,1,0
29,312,312,138,64,74,4,3
11,316,316,38,20,18,2,1
18,319,319,15,15,0,1,0
31,319,319,26,26,0,1,0
6,325,325,2,2,0,1,0
21,332,332,10,10,0,1,0
27,333,333,37,1,36,2,1
16,346,346,26,20,6,3,2
12,348,348,24,3,21,4,3
23,350,350,4,1,3,2,1
10,353,353,48,48,0,1,0
33,358,358,42,35,7,2,1
7,373,373,13,4,9,4,3
37,377,377,19,19,0,1,0
34,395,395,38,38,0,1,0
24,395,395,31,3,28,2,1
28,415,415,11,11,0,1,0
13,433,433,23,8,15,4,3
5,443,443,17,17,0,1,0
32,466,466,6,6,0,1,0
26,479,479,172,22,150,4,3

12,113,113,13,5,8,2,1
13,138,138,4,4,0,1,0
3,158,158,4,4,0,1,0
17,163,163,44,44,0,1,0
15,171,171,21,7,14,2,1
20,202,202,19,10,9,4,3
23,202,202,8,5,3,2,1
18,208,208,36,15,21,2,1
29,209,209,16,16,0,1,0
16,220,220,1,1,0,1,0
36,238,238,6,6,0,1,0
11,239,239,19,1,18,4,3
8,240,240,15,15,0,1,0
38,246,246,32,32,0,1,0
14,249,249,3,3,0,1,0
27,255,255,11,11,0,1,0
37,257,257,16,6,10,3,2
21,257,257,6,6,0,1,0
19,270,270,15,15,0,1,0
35,271,271,8,8,0,1,0
25,277,277,62,62,0,1,0
0,280,280,16,12,4,2,1
28,281,281,70,70,0,1,0
10,289,289,6,6,0,1,0
9,295,295,30,30,0,1,0
34,302,302,10,10,0,1,0
26,315,315,72,4,68,3,2
7,339,339,34,34,0,1,0
4,345,345,23,3,20,3,2
22,348,348,11,11,0,1,0
24,361,361,26,26,0,1,0
5,380,380,1,1,0,1,0
30,405,405,5,1,4,2,1
2,418,418,18,3,15,2,1
33,430,430,12,4,8,2,1
6,449,449,100,16,84,4,3
32,455,455,34,4,30,2,1
31,457,457,166,46,120,4,3
1,486,486,10,10,0,1,0

22,121,121,8,2,6,2,1
31,138,138,3,3,0,1,0
21,201,201,38,38,0,1,0
32,216,216,41,29,12,3,2
14,231,231,20,20,0,1,0
11,234,234,70,70,0,1,0
12,240,240,5,5,0,1,0
26,244,244,2,2,0,1,0
13,246,246,17,6,11,2,1
18,249,249,5,5,0,1,0
24,249,249,22,22,0,1,0
33,257,257,33,29,4,2,1
30,260,260,49,13,36,4,3
15,261,261,11,11,0,1,0
19,266,266,8,8,0,1,0
7,276,276,16,4,12,3,2
27,279,279,19,14,5,2,1
6,299,299,21,9,12,4,3
16,306,306,57,9,48,4,3
28,314,314,6,1,5,2,1
17,340,340,22,22,0,1,0
3,354,354,78,78,0,1,0
9,371,371,11,11,0,1,0
2,375,375,4,4,0,1,0
4,381,381,21,21,0,1,0
34,384,384,3,3,0,1,0
23,386,386,62,62,0,1,0
5,389,389,31,20,11,2,1
36,410,410,40,40,0,1,0
25,413,413,49,49,0,1,0
35,448,448,141,75,66,3,2
29,466,466,17,17,0,1,0
8,467,467,51,23,28,2,1
10,469,469,80,53,27,4,3
20,470,470,10,10,0,1,0
0,491,491,1,1,0,1,0
1,500,500,28,28,0,1,0
37,500,500,15,15,0,1,0

27,106,106,6,6,0,1,0
14,112,112,8,2,6,2,1
7,114,114,45,39,6,2,1
25,116,116,20,10,10,3,2
22,133,133,1,1,0,1,0
8,162,162,31,31,0,1,0
3,164,164,13,13,0,1,0
5,168,168,42,16,26,3,2
4,182,182,12,6,6,3,2
6,190,190,3,3,0,1,0
1,211,211,33,25,8,2,1
20,222,222,12,12,0,1,0
23,248,248,20,20,0,1,0
19,254,254,75,23,52,3,2
9,271,271,52,4,48,3,2
28,289,289,2,2,0,1,0
29,295,295,67,67,0,1,0
30,320,320,11,11,0,1,0
2,320,320,10,10,0,1,0
21,333,333,72,12,60,4,3
13,351,351,69,33,36,4,3
16,356,356,12,3,9,2,1
17,364,364,42,42,0,1,0
26,385,385,14,11,3,2,1
24,405,405,47,47,0,1,0
15,406,406,43,43,0,1,0
10,457,457,19,3,16,2,1
11,460,460,15,15,0,1,0
0,470,470,9,9,0,1,0
12,478,478,16,8,8,3,2
18,496,496,53,31,22,3,2

20,103,103,17,17,0,1,0
12,111,111,8,8,0,1,0
24,132,132,3,3,0,1,0
21,136,136,6,2,4,2,1
6,141,141,9,9,0,1,0
27,163,163,4,4,0,1,0
16,175,175,11,1,10,2,1
28,175,175,15,15,0,1,0
32,186,186,33,33,0,1,0
9,188,188,40,40,0,1,0
15,199,199,48,48,0,1,0
25,200,200,41,26,15,2,1
8,203,203,2,2,0,1,0
0,216,216,22,13,9,2,1
2,245,245,3,3,0,1,0
3,253,253,70,70,0,1,0
10,326,326,41,41,0,1,0
22,341,341,11,11,0,1,0
4,345,345,17,6,11,2,1
18,353,353,91,79,12,2,1
7,353,353,1,1,0,1,0
29,353,353,22,4,18,3,2
30,354,354,2,2,0,1,0
17,362,362,20,8,12,3,2
1,365,365,88,88,0,1,0
11,381,381,12,12,0,1,0
31,381,381,61,44,17,2,1
19,407,407,106,78,28,3,2
23,414,414,21,12,9,4,3
14,431,431,76,31,45,2,1
13,458,458,19,4,15,4,3
26,459,459,33,33,0,1,0
5,490,490,22,9,13,2,1

5,103,103,14,6,8,2,1
13,113,113,31,31,0,1,0
2,123,123,2,2,0,1,0
6,140,140,5,1,4,2,1
28,151,151,61,22,39,4,3
7,158,158,24,24,0,1,0
3,161,161,31,17,14,2,1
18,164,164,11,11,0,1,0
23,173,173,17,2,15,2,1
24,207,207,36,36,0,1,0
29,213,213,40,29,11,3,2
19,257,257,5,2,3,2,1
12,260,260,41,12,29,2,1
17,263,263,55,55,0,1,0
26,296,296,9,2,7,2,1
25,304,304,9,9,0,1,0
10,309,309,78,45,33,2,1
4,310,310,12,2,10,3,2
0,316,316,2,2,0,1,0
31,323,323,9,9,0,1,0
20,348,348,7,7,0,1,0
30,358,358,6,6,0,1,0
11,385,385,14,6,8,2,1
8,386,386,16,8,8,3,2
9,394,394,83,83,0,1,0
15,422,422,9,2,7,2,1
14,441,441,66,57,9,4,3
21,443,443,71,22,49,4,3
1,444,444,1,1,0,1,0
16,477,477,59,23,36,4,3
27,482,482,60,12,48,3,2
22,485,485,9,9,0,1,0

19,130,130,1,1,0,1,0
17,131,131,31,16,15,2,1
6,135,135,16,6,10,3,2
2,141,141,2,2,0,1,0
14,183,183,1,1,0,1,0
28,186,186,11,11,0,1,0
13,216,216,79,57,22,2,1
7,216,216,22,22,0,1,0
26,224,224,13,4,9,4,3
4,319,319,6,6,0,1,0
24,319,319,24,24,0,1,0
29,326,326,2,2,0,1,0
30,328,328,32,20,12,4,3
8,344,344,15,15,0,1,0
27,347,347,4,4,0,1,0
20,365,365,107,107,0,1,0
22,367,367,30,14,16,3,2
3,371,371,18,3,15,2,1
0,392,392,2,2,0,1,0
15,394,394,165,93,72,3,2
11,399,399,4,4,0,1,0
21,403,403,50,44,6,3,2
10,412,412,31,31,0,1,0
32,435,435,62,23,39,2,1
12,435,435,36,36,0,1,0
5,436,436,29,19,10,2,1
31,444,444,34,22,12,4,3
9,455,455,59,21,38,2,1
23,470,470,36,24,12,3,2
1,475,475,93,61,32,4,3
25,481,481,13,13,0,1,0
16,482,482,152,94,58,4,3
18,490,490,19,2,17,2,1

17,101,101,4,4,0,1,0
9,117,117,6,6,0,1,0
34,119,119,12,7,5,2,1
30,125,125,8,4,4,2,1
4,129,129,6,6,0,1,0
33,136,136,18,18,0,1,0
0,143,143,1,1,0,1,0
26,147,147,11,11,0,1,0
25,148,148,1,1,0,1,0
11,151,151,51,4,47,2,1
18,152,152,43,21,22,2,1
22,153,153,11,11,0,1,0
40,159,159,5,5,0,1,0
15,161,161,15,15,0,1,0
13,175,175,3,3,0,1,0
38,183,183,25,25,0,1,0
31,205,205,14,3,11,2,1
37,217,217,40,40,0,1,0
23,219,219,12,1,11,2,1
20,233,233,23,7,16,3,2
14,239,239,3,3,0,1,0
19,242,242,3,3,0,1,0
24,247,247,1,1,0,1,0
16,251,251,33,25,8,3,2
35,264,264,34,15,19,2,1
7,287,287,19,4,15,4,3
21,289,289,26,3,23,4,3
27,291,291,28,2,26,3,2
41,293,293,100,67,33,4,3
29,315,315,18,18,0,1,0
12,329,329,5,5,0,1,0
1,330,330,1,1,0,1,0
8,335,335,15,15,0,1,0
28,386,386,100,67,33,4,3
39,393,393,7,7,0,1,0
5,397,397,29,10,19,2,1
10,399,399,10,5,5,2,1
36,402,402,6,6,0,1,0
32,426,426,8,8,0,1,0
6,426,426,21,21,0,1,0
2,437,437,12,3,9,4,3
3,476,476,23,23,0,1,0

22,137,137,28,28,0,1,0
26,148,148,36,10,26,2,1
20,185,185,9,9,0,1,0
6,186,186,18,3,15,2,1
2,186,186,26,26,0,1,0
10,188,188,36,12,24,4,3
29,202,202,54,8,46,2,1
3,207,207,28,28,0,1,0
9,232,232,3,3,0,1,0
11,258,258,23,17,6,2,1
1,265,265,14,14,0,1,0
18,266,266,21,13,8,2,1
14,286,286,14,3,11,2,1
21,308,308,83,83,0,1,0
27,319,319,29,11,18,3,2
0,332,332,70,70,0,1,0
23,336,336,42,35,7,2,1
31,345,345,26,26,0,1,0
34,352,352,9,2,7,2,1
4,357,357,88,88,0,1,0
12,369,369,64,64,0,1,0
7,382,382,1,1,0,1,0
16,390,390,9,9,0,1,0
15,425,425,15,5,10,3,2
24,426,426,15,15,0,1,0
13,432,432,46,6,40,2,1
30,452,452,42,4,38,2,1
19,453,453,8,8,0,1,0
5,460,460,16,5,11,2,1
17,463,463,1,1,0,1,0
32,469,469,54,54,0,1,0
8,471,471,9,9,0,1,0
33,478,478,18,3,15,2,1
35,491,491,32,16,16,3,2
28,497,497,1,1,0,1,0
25,497,497,10,10,0,1,0

5,114,114,13,3,10,3,2
21,117,117,5,5,0,1,0
31,177,177,7,7,0,1,0
17,181,181,50,50,0,1,0
22,193,193,19,19,0,1,0
29,201,201,10,10,0,1,0
0,201,201,7,7,0,1,0
4,205,205,3,3,0,1,0
11,215,215,8,8,0,1,0
12,223,223,1,1,0,1,0
34,226,226,3,3,0,1,0
19,228,228,21,21,0,1,0
27,258,258,14,3,11,2,1
24,262,262,22,22,0,1,0
33,278,278,16,16,0,1,0
8,291,291,32,32,0,1,0
3,291,291,20,20,0,1,0
9,308,308,4,4,0,1,0
30,336,336,19,19,0,1,0
35,344,344,268,268,0,1,0
28,345,345,8,8,0,1,0
18,360,360,57,57,0,1,0
14,368,368,53,53,0,1,0
36,409,409,33,33,0,1,0
32,414,414,21,4,17,2,1
25,418,418,40,23,17,2,1
20,422,422,20,20,0,1,0
10,432,432,39,39,0,1,0
1,435,435,21,21,0,1,0
26,440,440,30,21,9,4,3
2,447,447,107,68,39,4,3
7,447,447,24,24,0,1,0
6,464,464,28,8,20,2,1
15,481,481,51,51,0,1,0
23,487,487,43,1,42,4,3
13,495,495,10,1,9,2,1
16,497,497,9,4,5,2,1

0,106,106,7,7,0,1,0
29,107,107,2,2,0,1,0
26,117,117,11,11,0,1,0
17,126,126,11,11,0,1,0
25,127,127,6,6,0,1,0
10,128,128,19,19,0,1,0
11,137,137,2,2,0,1,0
14,161,161,6,6,0,1,0
23,180,180,42,18,24,2,1
19,210,210,26,18,8,2,1
16,220,220,5,5,0,1,0
6,221,221,24,12,12,2,1
21,225,225,17,5,12,3,2
12,242,242,33,33,0,1,0
9,253,253,47,47,0,1,0
22,253,253,45,7,38,3,2
13,307,307,26,26,0,1,0
32,308,308,6,6,0,1,0
28,308,308,5,5,0,1,0
27,316,316,56,22,34,2,1
30,317,317,60,42,18,4,3
8,328,328,150,150,0,1,0
2,342,342,21,7,14,2,1
18,378,378,21,6,15,2,1
15,384,384,47,30,17,2,1
20,397,397,5,5,0,1,0
24,433,433,20,8,12,2,1
31,434,434,146,76,70,4,3
5,443,443,19,19,0,1,0
7,450,450,57,57,0,1,0
1,454,454,23,4,19,2,1
3,470,470,1,1,0,1,0
4,475,475,27,15,12,4,3

18,116,116,18,2,16,2,1
11,119,119,1,1,0,1,0
25,125,125,6,6,0,1,0
7,129,129,31,3,28,2,1
5,131,131,4,4,0,1,0
0,134,134,7,7,0,1,0
24,140,140,19,19,0,1,0
31,142,142,4,4,0,1,0
2,157,157,55,55,0,1,0
17,196,196,6,2,4,2,1
12,221,221,4,4,0,1,0
23,224,224,17,17,0,1,0
10,245,245,10,10,0,1,0
20,253,253,88,25,63,4,3
6,263,263,66,32,34,2,1
19,265,265,22,7,15,4,3
1,278,278,52,52,0,1,0
8,290,290,79,79,0,1,0
13,295,295,2,2,0,1,0
21,302,302,10,3,7,3,2
32,304,304,56,56,0,1,0
22,308,308,43,29,14,2,1
14,318,318,10,1,9,2,1
3,367,367,20,20,0,1,0
27,374,374,6,6,0,1,0
33,391,391,20,20,0,1,0
9,403,403,15,15,0,1,0
15,424,424,20,20,0,1,0
4,427,427,16,16,0,1,0
28,441,441,17,5,12,3,2
29,450,450,2,2,0,1,0
26,480,480,32,32,0,1,0
16,484,484,17,17,0,1,0
30,497,497,147,116,31,2,1

0,113,113,1,1,0,1,0
39,122,122,16,4,12,2,1
8,155,155,1,1,0,1,0
29,157,157,4,4,0,1,0
35,162,162,8,8,0,1,0
3,163,163,30,3,27,4,3
10,165,165,15,3,12,2,1
34,168,168,4,4,0,1,0
38,195,195,15,3,12,4,3
15,196,196,17,17,0,1,0
16,209,209,31,4,27,2,1
37,222,222,26,18,8,3,2
14,229,229,22,4,18,4,3
24,248,248,35,35,0,1,0
12,264,264,6,6,0,1,0
25,269,269,4,4,0,1,0
22,278,278,12,2,10,3,2
19,283,283,55,17,38,3,2
28,290,290,2,2,0,1,0
4,296,296,11,5,6,3,2
33,299,299,103,38,65,4,3
11,311,311,1,1,0,1,0
5,315,315,53,26,27,4,3
1,316,316,26,26,0,1,0
21,349,349,5,5,0,1,0
18,361,361,12,12,0,1,0
6,362,362,9,4,5,2,1
32,365,365,60,60,0,1,0
17,373,373,4,4,0,1,0
20,376,376,1,1,0,1,0
13,377,377,16,16,0,1,0
26,379,379,82,82,0,1,0
27,384,384,12,12,0,1,0
7,414,414,19,1,18,4,3
40,421,421,31,3,28,3,2
23,428,428,84,73,11,2,1
31,443,443,34,5,29,3,2
30,450,450,46,46,0,1,0
36,492,492,72,37,35,2,1
9,494,494,18,18,0,1,0
2,499,499,61,27,34,3,2

11,134,134,7,7,0,1,0
39,149,149,18,14,4,2,1
10,157,157,6,1,5,2,1
28,163,163,3,3,0,1,0
16,173,173,6,6,0,1,0
14,185,185,18,3,15,2,1
6,189,189,24,12,12,3,2
38,191,191,3,3,0,1,0
24,193,193,4,4,0,1,0
7,201,201,25,25,0,1,0
36,227,227,52,28,24,3,2
34,235,235,19,7,12,2,1
2,257,257,17,17,0,1,0
19,261,261,10,10,0,1,0
37,263,263,16,10,6,2,1
0,278,278,8,8,0,1,0
12,279,279,13,3,10,2,1
1,280,280,29,11,18,4,3
5,287,287,12,12,0,1,0
26,289,289,23,23,0,1,0
15,297,297,2,2,0,1,0
30,317,317,11,11,0,1,0
21,322,322,10,10,0,1,0
3,339,339,23,23,0,1,0
29,348,348,7,7,0,1,0
8,363,363,1,1,0,1,0
9,366,366,44,44,0,1,0
22,368,368,9,1,8,3,2
27,370,370,11,4,7,2,1
23,375,375,92,92,0,1,0
35,395,395,41,35,6,2,1
25,398,398,51,51,0,1,0
31,406,406,40,40,0,1,0
32,418,418,214,83,131,4,3
4,423,423,6,1,5,2,1
13,424,424,22,7,15,2,1
33,424,424,22,8,14,2,1
20,464,464,129,129,0,1,0
18,465,465,13,3,10,3,2
17,475,475,15,15,0,1,0
40,475,475,64,64,0,1,0

18,119,119,11,11,0,1,0
10,119,119,1,1,0,1,0
29,133,133,12,12,0,1,0
28,147,147,47,47,0,1,0
17,151,151,3,3,0,1,0
0,169,169,19,19,0,1,0
3,170,170,16,1,15,4,3
22,199,199,5,5,0,1,0
6,200,200,28,10,18,4,3
12,214,214,1,1,0,1,0
9,215,215,45,45,0,1,0
36,219,219,15,15,0,1,0
33,231,231,13,13,0,1,0
13,233,233,6,2,4,2,1
24,237,237,17,7,10,2,1
35,241,241,9,9,0,1,0
8,244,244,29,29,0,1,0
1,254,254,2,2,0,1,0
15,259,259,9,1,8,2,1
11,265,265,33,33,0,1,0
5,267,267,33,33,0,1,0
23,273,273,73,28,45,4,3
26,281,281,9,3,6,3,2
25,328,328,5,5,0,1,0
20,352,352,39,39,0,1,0
27,382,382,18,2,16,3,2
34,398,398,4,4,0,1,0
7,405,405,6,6,0,1,0
4,409,409,46,6,40,3,2
16,434,434,59,59,0,1,0
2,439,439,45,45,0,1,0
32,442,442,54,54,0,1,0
19,456,456,48,48,0,1,0
21,464,464,23,23,0,1,0
14,469,469,1,1,0,1,0
37,473,473,57,30,27,2,1
30,489,489,90,44,46,4,3
31,499,499,106,73,33,2,1

33,113,113,9,9,0,1,0
2,122,122,3,3,0,1,0
7,138,138,55,55,0,1,0
21,149,149,1,1,0,1,0
6,164,164,1,1,0,1,0
12,166,166,7,2,5,2,1
37,186,186,1,1,0,1,0
9,197,197,49,49,0,1,0
1,210,210,6,2,4,2,1
36,210,210,1,1,0,1,0
35,218,218,8,1,7,3,2
26,225,225,36,16,20,3,2
19,226,226,7,1,6,2,1
10,229,229,7,7,0,1,0
29,231,231,4,4,0,1,0
38,234,234,30,15,15,2,1
3,239,239,14,14,0,1,0
14,278,278,8,2,6,2,1
28,280,280,22,22,0,1,0
13,282,282,23,23,0,1,0
23,294,294,12,12,0,1,0
17,334,334,1,1,0,1,0
30,351,351,16,12,4,2,1
0,353,353,14,14,0,1,0
4,365,365,44,29,15,2,1
31,367,367,67,31,36,2,1
11,383,383,18,4,14,4,3
34,390,390,75,75,0,1,0
5,393,393,7,7,0,1,0
18,403,403,47,47,0,1,0
22,409,409,33,5,28,3,2
8,435,435,40,24,16,3,2
20,439,439,77,77,0,1,0
15,439,439,16,4,12,4,3
16,446,446,30,15,15,2,1
32,469,469,65,29,36,4,3
27,473,473,165,165,0,1,0
25,478,478,57,57,0,1,0
24,494,494,38,38,0,1,0

9,107,107,2,2,0,1,0
29,113,113,8,2,6,2,1
3,114,114,20,17,3,2,1
7,148,148,16,10,6,2,1
16,149,149,27,27,0,1,0
30,163,163,43,43,0,1,0
20,163,163,24,24,0,1,0
11,170,170,52,52,0,1,0
36,171,171,12,12,0,1,0
23,174,174,50,50,0,1,0
31,184,184,9,9,0,1,0
17,187,187,1,1,0,1,0
5,195,195,12,3,9,2,1
14,199,199,12,12,0,1,0
15,199,199,21,11,10,3,2
13,229,229,28,28,0,1,0
26,234,234,18,9,9,4,3
24,256,256,11,3,8,3,2
19,260,260,33,33,0,1,0
18,275,275,7,7,0,1,0
28,307,307,50,50,0,1,0
8,325,325,27,12,15,4,3
6,325,325,7,7,0,1,0
27,331,331,8,8,0,1,0
21,356,356,18,11,7,2,1
32,366,366,14,14,0,1,0
35,382,382,53,49,4,2,1
12,389,389,1,1,0,1,0
2,393,393,5,5,0,1,0
33,401,401,58,4,54,4,3
4,417,417,30,30,0,1,0
25,419,419,11,11,0,1,0
10,423,423,28,14,14,3,2
34,437,437,7,7,0,1,0
0,469,469,31,31,0,1,0
22,476,476,58,58,0,1,0
1,489,489,40,40,0,1,0

15,101,101,6,3,3,2,1
37,116,116,5,5,0,1,0
23,128,128,2,2,0,1,0
17,130,130,9,9,0,1,0
0,138,138,4,4,0,1,0
27,153,153,28,14,14,2,1
8,157,157,18,6,12,2,1
26,163,163,24,21,3,2,1
38,170,170,21,5,16,3,2
33,171,171,58,58,0,1,0
24,178,178,3,3,0,1,0
7,221,221,39,39,0,1,0
6,258,258,38,38,0,1,0
12,272,272,1,1,0,1,0
29,276,276,7,7,0,1,0
18,277,277,1,1,0,1,0
25,291,291,23,7,16,2,1
16,296,296,76,49,27,4,3
1,302,302,15,5,10,3,2
22,311,311,97,19,78,3,2
36,321,321,9,9,0,1,0
4,327,327,4,4,0,1,0
11,332,332,1,1,0,1,0
34,336,336,59,31,28,4,3
39,350,350,41,41,0,1,0
5,353,353,57,35,22,2,1
14,356,356,15,3,12,3,2
19,361,361,25,17,8,2,1
30,366,366,70,40,30,3,2
20,377,377,29,29,0,1,0
28,378,378,2,2,0,1,0
31,385,385,18,18,0,1,0
3,426,426,4,4,0,1,0
32,436,436,55,31,24,4,3
9,452,452,11,5,6,3,2
35,458,458,36,36,0,1,0
21,470,470,3,3,0,1,0
2,481,481,10,10,0,1,0
10,486,486,15,3,12,3,2
13,490,490,11,11,0,1,0

17,106,106,21,21,0,1,0
20,136,136,1,1,0,1,0
8,148,148,20,2,18,2,1
7,151,151,40,17,23,4,3
26,169,169,12,9,3,2,1
0,185,185,32,4,28,3,2
27,199,199,3,3,0,1,0
19,220,220,22,10,12,2,1
6,228,228,15,15,0,1,0
9,239,239,1,1,0,1,0
28,248,248,30,30,0,1,0
25,254,254,16,12,4,2,1
15,265,265,17,2,15,2,1
30,275,275,4,4,0,1,0
24,289,289,57,54,3,2,1
4,308,308,73,28,45,3,2
12,318,318,23,2,21,2,1
2,327,327,7,7,0,1,0
5,327,327,37,37,0,1,0
14,353,353,23,23,0,1,0
23,369,369,1,1,0,1,0
10,395,395,80,4,76,3,2
11,398,398,46,46,0,1,0
29,423,423,60,37,23,3,2
22,433,433,48,48,0,1,0
18,442,442,98,52,46,2,1
16,457,457,20,1,19,2,1
13,458,458,20,5,15,4,3
3,459,459,102,66,36,4,3
21,461,461,138,102,36,2,1
1,486,486,15,1,14,3,2

20,123,123,18,9,9,4,3
7,132,132,11,11,0,1,0
4,132,132,5,2,3,2,1
21,134,134,2,2,0,1,0
26,136,136,9,9,0,1,0
32,144,144,1,1,0,1,0
12,147,147,3,3,0,1,0
34,164,164,4,4,0,1,0
35,167,167,9,9,0,1,0
25,175,175,29,1,28,3,2
15,180,180,12,4,8,3,2
13,180,180,11,3,8,2,1
1,189,189,16,12,4,2,1
3,246,246,12,12,0,1,0
5,254,254,9,9,0,1,0
29,260,260,20,20,0,1,0
24,275,275,40,40,0,1,0
6,284,284,5,5,0,1,0
23,287,287,36,22,14,3,2
2,289,289,69,34,35,2,1
16,295,295,29,22,7,2,1
9,337,337,7,1,6,3,2
14,350,350,43,43,0,1,0
0,355,355,35,21,14,2,1
31,359,359,52,1,51,4,3
36,377,377,30,30,0,1,0
28,387,387,4,4,0,1,0
17,394,394,82,82,0,1,0
19,398,398,60,60,0,1,0
11,427,427,18,18,0,1,0
27,439,439,77,77,0,1,0
30,441,441,73,73,0,1,0
33,447,447,90,87,3,2,1
22,453,453,58,58,0,1,0
8,455,455,11,8,3,2,1
18,455,455,26,26,0,1,0
10,482,482,89,72,17,2,1

14,111,111,4,4,0,1,0
19,119,119,3,3,0,1,0
27,126,126,12,12,0,1,0
15,126,126,4,1,3,2,1
30,146,146,8,4,4,2,1
26,157,157,3,3,0,1,0
1,159,159,41,23,18,4,3
7,177,177,4,4,0,1,0
28,178,178,37,13,24,4,3
16,231,231,66,66,0,1,0
5,238,238,4,4,0,1,0
22,243,243,13,1,12,2,1
13,277,277,10,10,0,1,0
12,299,299,5,2,3,2,1
31,322,322,45,15,30,4,3
3,322,322,21,21,0,1,0
11,325,325,56,10,46,2,1
0,325,325,71,71,0,1,0
17,332,332,13,13,0,1,0
24,349,349,25,11,14,2,1
2,354,354,19,19,0,1,0
23,360,360,68,68,0,1,0
29,407,407,28,5,23,2,1
10,414,414,81,9,72,4,3
9,430,430,56,2,54,4,3
4,431,431,89,49,40,3,2
18,464,464,44,44,0,1,0
25,477,477,131,115,16,2,1
8,480,480,26,20,6,2,1
21,489,489,43,31,12,4,3
6,490,490,108,108,0,1,0
20,499,499,1,1,0,1,0

16,100,100,25,13,12,3,2
9,102,102,6,6,0,1,0
17,103,103,19,3,16,3,2
19,113,113,1,1,0,1,0
20,154,154,16,4,12,2,1
28,171,171,27,9,18,3,2
10,182,182,17,17,0,1,0
1,231,231,29,29,0,1,0
27,247,247,25,25,0,1,0
6,254,254,122,50,72,4,3
18,256,256,8,8,0,1,0
22,267,267,17,4,13,2,1
7,273,273,35,35,0,1,0
0,295,295,25,20,5,2,1
2,311,311,5,5,0,1,0
8,319,319,14,14,0,1,0
11,359,359,12,12,0,1,0
24,364,364,33,18,15,2,1
12,376,376,16,16,0,1,0
25,391,391,78,78,0,1,0
14,392,392,15,15,0,1,0
21,410,410,49,21,28,2,1
23,415,415,12,12,0,1,0
26,440,440,12,12,0,1,0
15,443,443,96,34,62,3,2
3,453,453,9,6,3,2,1
4,466,466,272,196,76,4,3
5,496,496,16,16,0,1,0
13,497,497,34,34,0,1,0

4,102,102,40,40,0,1,0
7,119,119,11,11,0,1,0
17,157,157,20,20,0,1,0
23,160,160,23,23,0,1,0
10,182,182,4,4,0,1,0
27,223,223,51,51,0,1,0
8,226,226,5,5,0,1,0
22,227,227,15,15,0,1,0
16,227,227,25,9,16,2,1
24,264,264,3,3,0,1,0
9,286,286,1,1,0,1,0
3,295,295,203,164,39,4,3
19,296,296,10,10,0,1,0
0,324,324,1,1,0,1,0
20,330,330,100,66,34,3,2
13,348,348,140,93,47,4,3
6,353,353,14,10,4,2,1
14,375,375,12,12,0,1,0
11,416,416,18,2,16,3,2
25,432,432,17,4,13,2,1
18,435,435,12,5,7,2,1
26,457,457,46,46,0,1,0
21,459,459,5,5,0,1,0
12,465,465,3,3,0,1,0
5,467,467,77,33,44,3,2
2,477,477,108,108,0,1,0
15,482,482,20,15,5,2,1
1,495,495,24,10,14,2,1

21,111,111,31,1,30,4,3
24,111,111,6,6,0,1,0
29,119,119,17,8,9,2,1
6,123,123,23,23,0,1,0
11,133,133,5,2,3,2,1
3,147,147,2,2,0,1,0
14,147,147,28,28,0,1,0
18,151,151,48,48,0,1,0
9,156,156,1,1,0,1,0
7,183,183,7,1,6,3,2
4,187,187,4,4,0,1,0
26,211,211,15,11,4,2,1
1,229,229,25,25,0,1,0
10,239,239,38,38,0,1,0
20,255,255,56,10,46,2,1
16,265,265,13,13,0,1,0
19,271,271,6,6,0,1,0
0,295,295,129,105,24,4,3
23,309,309,9,5,4,2,1
27,315,315,1,1,0,1,0
15,330,330,51,51,0,1,0
5,340,340,38,38,0,1,0
25,344,344,31,23,8,3,2
28,364,364,28,15,13,3,2
30,372,372,5,2,3,2,1
32,409,409,40,10,30,4,3
12,411,411,1,1,0,1,0
13,418,418,49,49,0,1,0
8,421,421,29,29,0,1,0
22,427,427,34,20,14,3,2
2,428,428,20,15,5,2,1
17,434,434,23,2,21,4,3
31,495,495,67,67,0,1,0

21,117,117,1,1,0,1,0
28,131,131,2,2,0,1,0
15,153,153,7,7,0,1,0
4,157,157,45,45,0,1,0
6,172,172,1,1,0,1,0
23,174,174,1,1,0,1,0
10,183,183,31,21,10,3,2
11,233,233,10,10,0,1,0
25,234,234,14,14,0,1,0
40,258,258,6,6,0,1,0
2,263,263,48,24,24,2,1
5,269,269,7,7,0,1,0
31,273,273,3,3,0,1,0
24,287,287,67,3,64,3,2
36,295,295,9,9,0,1,0
26,297,297,14,1,13,3,2
3,307,307,42,4,38,2,1
12,308,308,23,23,0,1,0
1,309,309,2,2,0,1,0
17,327,327,56,8,48,2,1
37,346,346,45,35,10,3,2
39,351,351,52,52,0,1,0
8,359,359,22,22,0,1,0
35,366,366,132,45,87,4,3
20,378,378,6,3,3,2,1
30,379,379,9,4,5,2,1
18,383,383,79,17,62,4,3
32,392,392,37,29,8,3,2
7,400,400,3,3,0,1,0
34,401,401,30,14,16,2,1
33,403,403,49,8,41,2,1
22,406,406,16,16,0,1,0
29,420,420,87,87,0,1,0
27,451,451,38,38,0,1,0
16,474,474,4,4,0,1,0
38,483,483,31,14,17,2,1
9,491,491,46,46,0,1,0
14,493,493,11,11,0,1,0
0,494,494,29,29,0,1,0
19,495,495,4,4,0,1,0
13,497,497,8,8,0,1,0

32,103,103,1,1,0,1,0
23,105,105,3,3,0,1,0
5,127,127,16,16,0,1,0
1,129,129,1,1,0,1,0
24,138,138,46,46,0,1,0
17,140,140,26,26,0,1,0
10,141,141,21,5,16,3,2
37,145,145,10,1,9,2,1
27,151,151,15,15,0,1,0
33,159,159,45,45,0,1,0
26,160,160,16,16,0,1,0
9,183,183,19,13,6,3,2
25,197,197,14,4,10,3,2
2,198,198,35,3,32,3,2
34,221,221,5,1,4,2,1
0,222,222,26,12,14,3,2
14,245,245,9,9,0,1,0
21,249,249,10,3,7,2,1
3,258,258,34,34,0,1,0
18,279,279,4,4,0,1,0
36,286,286,58,22,36,2,1
35,305,305,38,38,0,1,0
11,317,317,4,4,0,1,0
29,330,330,15,8,7,2,1
4,360,360,56,56,0,1,0
12,364,364,18,3,15,4,3
16,369,369,71,71,0,1,0
6,379,379,9,3,6,3,2
22,379,379,16,16,0,1,0
7,401,401,13,2,11,2,1
20,413,413,22,6,16,2,1
19,419,419,18,9,9,4,3
8,445,445,15,5,10,2,1
15,446,446,20,15,5,2,1
31,469,469,31,3,28,2,1
13,470,470,5,5,0,1,0
30,471,471,85,85,0,1,0
28,494,494,4,4,0,1,0

14,100,100,34,34,0,1,0
28,121,121,1,1,0,1,0
9,122,122,27,6,21,2,1
23,126,126,20,20,0,1,0
22,131,131,16,8,8,3,2
2,135,135,1,1,0,1,0
3,137,137,10,5,5,2,1
24,165,165,21,21,0,1,0
4,166,166,27,27,0,1,0
21,177,177,19,10,9,2,1
8,182,182,4,4,0,1,0
18,211,211,20,20,0,1,0
13,230,230,22,22,0,1,0
11,235,235,27,27,0,1,0
20,237,237,54,54,0,1,0
26,238,238,5,5,0,1,0
0,239,239,18,18,0,1,0
33,252,252,66,16,50,2,1
30,260,260,33,3,30,4,3
10,277,277,11,11,0,1,0
17,280,280,34,7,27,4,3
32,280,280,2,2,0,1,0
12,372,372,15,15,0,1,0
27,377,377,5,2,3,2,1
19,381,381,16,4,12,4,3
1,404,404,3,3,0,1,0
29,406,406,62,26,36,3,2
31,434,434,41,41,0,1,0
6,459,459,86,26,60,3,2
25,480,480,24,1,23,2,1
7,484,484,41,41,0,1,0
15,487,487,96,77,19,3,2
16,489,489,6,6,0,1,0
5,489,489,10,6,4,2,1

19,108,108,5,5,0,1,0
21,119,119,2,2,0,1,0
0,119,119,9,1,8,3,2
30,124,124,5,2,3,2,1
5,129,129,4,4,0,1,0
33,153,153,47,23,24,2,1
36,155,155,2,2,0,1,0
27,163,163,2,2,0,1,0
35,171,171,21,21,0,1,0
37,173,173,1,1,0,1,0
6,174,174,13,13,0,1,0
14,186,186,4,4,0,1,0
31,204,204,69,69,0,1,0
16,209,209,23,5,18,3,2
12,210,210,14,2,12,2,1
22,230,230,9,9,0,1,0
15,255,255,16,7,9,4,3
26,257,257,31,31,0,1,0
23,259,259,36,36,0,1,0
34,259,259,10,10,0,1,0
20,265,265,25,25,0,1,0
13,276,276,3,3,0,1,0
9,287,287,7,7,0,1,0
17,295,295,38,38,0,1,0
8,307,307,4,4,0,1,0
38,338,338,18,18,0,1,0
25,340,340,44,20,24,3,2
32,380,380,2,2,0,1,0
28,403,403,1,1,0,1,0
18,411,411,101,101,0,1,0
11,431,431,36,36,0,1,0
4,444,444,61,61,0,1,0
7,450,450,104,18,86,3,2
2,471,471,40,40,0,1,0
24,472,472,141,100,41,4,3
29,474,474,35,20,15,2,1
10,486,486,14,14,0,1,0
3,487,487,45,7,38,2,1
1,491,491,12,12,0,1,0

14,116,116,4,4,0,1,0
20,120,120,8,8,0,1,0
13,122,122,4,4,0,1,0
8,134,134,2,2,0,1,0
24,152,152,13,13,0,1,0
22,156,156,24,24,0,1,0
9,168,168,1,1,0,1,0
28,209,209,16,16,0,1,0
7,218,218,12,12,0,1,0
23,221,221,55,55,0,1,0
19,223,223,1,1,0,1,0
16,223,223,27,10,17,2,1
18,234,234,71,71,0,1,0
27,248,248,19,14,5,2,1
15,257,257,15,4,11,2,1
2,267,267,169,144,25,2,1
3,279,279,156,45,111,4,3
12,314,314,2,2,0,1,0
17,326,326,5,5,0,1,0
26,332,332,57,42,15,2,1
1,334,334,5,5,0,1,0
11,339,339,2,2,0,1,0
5,342,342,37,37,0,1,0
10,357,357,26,12,14,3,2
6,382,382,10,6,4,2,1
25,410,410,32,5,27,4,3
4,430,430,1,1,0,1,0
0,490,490,99,99,0,1,0
21,500,500,101,92,9,2,1

23,117,117,19,19,0,1,0
18,117,117,2,2,0,1,0
22,118,118,13,1,12,3,2
9,119,119,26,15,11,2,1
20,121,121,5,5,0,1,0
24,124,124,1,1,0,1,0
32,131,131,25,10,15,4,3
17,141,141,2,2,0,1,0
15,145,145,18,15,3,2,1
31,180,180,4,4,0,1,0
35,180,180,17,17,0,1,0
16,187,187,12,1,11,2,1
13,224,224,61,5,56,3,2
30,288,288,30,30,0,1,0
27,292,292,6,6,0,1,0
10,298,298,2,2,0,1,0
2,311,311,14,11,3,2,1
3,318,318,8,8,0,1,0
26,321,321,67,31,36,4,3
33,333,333,1,1,0,1,0
28,340,340,114,38,76,4,3
34,344,344,22,17,5,2,1
25,347,347,35,35,0,1,0
14,348,348,46,46,0,1,0
29,359,359,5,5,0,1,0
12,361,361,20,15,5,2,1
7,378,378,56,9,47,2,1
36,387,387,3,3,0,1,0
19,404,404,68,68,0,1,0
11,406,406,4,4,0,1,0
0,413,413,25,3,22,3,2
6,414,414,10,10,0,1,0
1,420,420,23,19,4,2,1
38,423,423,27,8,19,4,3
8,442,442,23,23,0,1,0
37,467,467,107,83,24,4,3
5,480,480,67,59,8,3,2
21,493,493,2,2,0,1,0
4,498,498,12,2,10,2,1

5,101,101,7,7,0,1,0
0,107,107,2,2,0,1,0
10,109,109,7,7,0,1,0
2,115,115,13,1,12,3,2
3,117,117,16,16,0,1,0
16,119,119,12,2,10,3,2
8,122,122,18,4,14,2,1
7,123,123,21,13,8,3,2
6,128,128,2,2,0,1,0
20,128,128,48,13,35,2,1
23,155,155,17,1,16,3,2
18,155,155,30,30,0,1,0
1,159,159,1,1,0,1,0
9,160,160,87,46,41,2,1
29,192,192,17,3,14,3,2
14,224,224,24,24,0,1,0
30,227,227,45,28,17,2,1
15,229,229,7,7,0,1,0
26,253,253,2,2,0,1,0
19,254,254,20,10,10,3,2
11,281,281,28,28,0,1,0
21,294,294,9,9,0,1,0
17,347,347,21,3,18,2,1
13,351,351,24,3,21,2,1
28,367,367,40,6,34,2,1
12,406,406,39,39,0,1,0
27,418,418,20,8,12,4,3
22,426,426,14,2,12,3,2
25,441,441,31,12,19,4,3
24,487,487,48,36,12,3,2
4,500,500,75,39,36,4,3

3,109,109,5,2,3,2,1
24,109,109,14,8,6,2,1
5,111,111,4,4,0,1,0
4,124,124,6,1,5,2,1
22,135,135,48,40,8,2,1
2,142,142,36,17,19,2,1
9,160,160,4,4,0,1,0
25,174,174,2,2,0,1,0
23,180,180,92,92,0,1,0
13,182,182,9,9,0,1,0
17,215,215,8,1,7,2,1
7,224,224,42,19,23,2,1
12,226,226,4,4,0,1,0
29,230,230,14,14,0,1,0
21,239,239,3,3,0,1,0
27,251,251,20,20,0,1,0
16,256,256,46,25,21,2,1
20,271,271,39,16,23,2,1
32,276,276,1,1,0,1,0
19,278,278,7,7,0,1,0
11,286,286,1,1,0,1,0
15,291,291,46,24,22,2,1
0,297,297,9,5,4,2,1
36,297,297,5,5,0,1,0
18,310,310,22,22,0,1,0
8,315,315,29,17,12,2,1
14,324,324,1,1,0,1,0
26,325,325,6,1,5,2,1
10,330,330,34,34,0,1,0
1,346,346,18,2,16,2,1
28,353,353,18,18,0,1,0
6,358,358,46,46,0,1,0
31,407,407,17,17,0,1,0
38,443,443,55,16,39,4,3
33,468,468,15,3,12,4,3
30,469,469,37,37,0,1,0
37,493,493,22,1,21,2,1
34,494,494,82,40,42,3,2
35,496,496,4,1,3,2,1

32,112,112,20,20,0,1,0
7,144,144,15,7,8,2,1
16,150,150,46,46,0,1,0
3,176,176,3,3,0,1,0
1,188,188,3,3,0,1,0
38,204,204,7,7,0,1,0
23,208,208,28,14,14,3,2
28,209,209,15,3,12,4,3
29,213,213,27,7,20,2,1
24,213,213,26,26,0,1,0
18,225,225,21,1,20,2,1
20,237,237,11,8,3,2,1
19,252,252,2,2,0,1,0
6,287,287,17,3,14,2,1
37,289,289,59,59,0,1,0
36,292,292,4,1,3,2,1
9,299,299,8,5,3,2,1
15,306,306,2,2,0,1,0
27,307,307,10,2,8,2,1
8,356,356,21,21,0,1,0
26,356,356,56,14,42,3,2
14,365,365,52,21,31,2,1
25,379,379,10,10,0,1,0
10,385,385,90,90,0,1,0
21,396,396,3,3,0,1,0
30,401,401,4,4,0,1,0
39,405,405,69,69,0,1,0
17,408,408,13,13,0,1,0
4,420,420,11,11,0,1,0
22,425,425,58,58,0,1,0
0,435,435,48,48,0,1,0
5,460,460,10,7,3,2,1
12,460,460,101,75,26,3,2
33,467,467,16,6,10,2,1
11,477,477,2,2,0,1,0
34,480,480,115,115,0,1,0
13,484,484,10,10,0,1,0
35,487,487,41,41,0,1,0
31,492,492,40,33,7,2,1
2,494,494,2,2,0,1,0

15,109,109,16,9,7,2,1
20,112,112,53,14,39,4,3
6,122,122,3,3,0,1,0
12,147,147,3,3,0,1,0
23,169,169,15,6,9,4,3
14,192,192,33,33,0,1,0
18,202,202,31,7,24,2,1
13,219,219,36,36,0,1,0
10,223,223,8,8,0,1,0
16,227,227,9,9,0,1,0
28,234,234,30,30,0,1,0
7,245,245,6,3,3,2,1
1,277,277,30,23,7,2,1
8,284,284,32,21,11,4,3
25,296,296,12,12,0,1,0
2,301,301,20,10,10,2,1
19,308,308,20,7,13,4,3
21,310,310,58,58,0,1,0
24,329,329,17,11,6,3,2
5,339,339,45,45,0,1,0
26,347,347,17,10,7,2,1
30,347,347,12,4,8,3,2
17,360,360,1,1,0,1,0
9,402,402,49,2,47,3,2
3,408,408,4,4,0,1,0
27,411,411,17,17,0,1,0
22,434,434,13,7,6,3,2
11,435,435,241,219,22,3,2
29,442,442,14,4,10,2,1
4,455,455,31,5,26,2,1
0,470,470,121,27,94,3,2

4,109,109,1,1,0,1,0
7,119,119,9,9,0,1,0
22,130,130,9,6,3,2,1
17,135,135,6,6,0,1,0
28,140,140,16,4,12,2,1
14,168,168,30,30,0,1,0
20,169,169,17,17,0,1,0
5,171,171,21,5,16,2,1
31,172,172,3,3,0,1,0
8,218,218,1,1,0,1,0
19,223,223,24,24,0,1,0
23,232,232,19,13,6,3,2
15,255,255,33,33,0,1,0
0,263,263,25,3,22,2,1
18,276,276,106,19,87,4,3
11,288,288,135,50,85,4,3
6,291,291,30,2,28,2,1
9,299,299,25,12,13,2,1
16,309,309,11,2,9,2,1
25,310,310,53,13,40,2,1
26,316,316,25,5,20,2,1
33,324,324,89,10,79,4,3
24,361,361,42,22,20,2,1
1,362,362,11,11,0,1,0
3,369,369,14,14,0,1,0
10,394,394,71,25,46,4,3
29,397,397,8,8,0,1,0
21,409,409,1,1,0,1,0
27,411,411,19,4,15,2,1
30,441,441,7,3,4,2,1
32,444,444,35,8,27,2,1
12,461,461,43,43,0,1,0
13,466,466,1,1,0,1,0
2,476,476,25,5,20,2,1

24,117,117,11,3,8,3,2
19,129,129,10,10,0,1,0
4,132,132,3,3,0,1,0
25,156,156,11,7,4,2,1
2,180,180,41,41,0,1,0
12,200,200,10,10,0,1,0
1,204,204,17,3,14,3,2
5,213,213,36,11,25,3,2
17,250,250,14,8,6,2,1
18,262,262,1,1,0,1,0
30,266,266,37,3,34,3,2
16,268,268,14,14,0,1,0
9,271,271,25,3,22,2,1
29,274,274,44,23,21,2,1
28,294,294,10,10,0,1,0
26,295,295,47,47,0,1,0
22,310,310,56,50,6,2,1
21,313,313,41,14,27,2,1
3,314,314,47,29,18,3,2
7,343,343,1,1,0,1,0
13,346,346,17,17,0,1,0
10,380,380,17,17,0,1,0
23,382,382,123,63,60,4,3
15,387,387,4,4,0,1,0
11,389,389,77,66,11,2,1
0,393,393,16,6,10,2,1
14,402,402,38,20,18,4,3
20,423,423,48,18,30,3,2
8,452,452,213,127,86,4,3
6,464,464,46,13,33,4,3
27,472,472,15,15,0,1,0

20,104,104,6,6,0,1,0
7,119,119,4,4,0,1,0
8,147,147,23,23,0,1,0
13,184,184,17,17,0,1,0
25,191,191,6,6,0,1,0
11,232,232,51,51,0,1,0
29,243,243,20,2,18,2,1
28,276,276,48,48,0,1,0
4,278,278,14,2,12,4,3
9,280,280,34,15,19,2,1
22,280,280,31,17,14,2,1
3,320,320,47,23,24,4,3
12,342,342,5,1,4,2,1
16,346,346,13,2,11,2,1
17,352,352,30,30,0,1,0
18,352,352,18,9,9,2,1
15,363,363,110,60,50,3,2
21,363,363,38,38,0,1,0
5,364,364,132,132,0,1,0
26,370,370,50,16,34,3,2
27,371,371,7,7,0,1,0
2,380,380,44,5,39,4,3
24,417,417,125,71,54,4,3
14,424,424,24,15,9,2,1
10,430,430,20,20,0,1,0
0,446,446,128,38,90,4,3
6,453,453,20,8,12,4,3
23,455,455,40,2,38,3,2
1,481,481,49,3,46,2,1
19,487,487,2,2,0,1,0

15,103,103,1,1,0,1,0
12,111,111,19,10,9,2,1
34,111,111,14,2,12,4,3
0,118,118,5,5,0,1,0
17,119,119,1,1,0,1,0
30,122,122,9,9,0,1,0
26,127,127,15,10,5,2,1
32,127,127,25,19,6,2,1
39,149,149,21,21,0,1,0
23,163,163,2,2,0,1,0
19,176,176,3,3,0,1,0
10,179,179,18,13,5,2,1
21,187,187,14,14,0,1,0
24,189,189,50,2,48,3,2
1,201,201,1,1,0,1,0
16,203,203,34,34,0,1,0
27,206,206,57,57,0,1,0
7,209,209,24,24,0,1,0
11,214,214,2,2,0,1,0
5,224,224,43,43,0,1,0
33,238,238,12,12,0,1,0
18,250,250,1,1,0,1,0
8,251,251,6,6,0,1,0
35,251,251,20,20,0,1,0
14,253,253,16,16,0,1,0
40,276,276,18,18,0,1,0
3,285,285,5,5,0,1,0
37,301,301,16,16,0,1,0
36,309,309,4,4,0,1,0
2,312,312,44,10,34,2,1
29,341,341,26,7,19,2,1
22,376,376,33,5,28,4,3
4,383,383,99,31,68,4,3
28,390,390,6,6,0,1,0
9,391,391,4,1,3,2,1
13,404,404,16,1,15,4,3
6,410,410,12,9,3,2,1
31,432,432,33,16,17,2,1
38,436,436,22,1,21,4,3
20,487,487,49,49,0,1,0
25,493,493,28,20,8,2,1

2,104,104,1,1,0,1,0
4,104,104,11,3,8,3,2
33,104,104,6,3,3,2,1
21,121,121,6,6,0,1,0
8,140,140,12,4,8,3,2
20,158,158,1,1,0,1,0
6,171,171,11,11,0,1,0
34,191,191,2,2,0,1,0
23,213,213,16,16,0,1,0
13,228,228,24,24,0,1,0
5,229,229,10,1,9,4,3
24,240,240,13,5,8,2,1
0,252,252,21,21,0,1,0
3,254,254,38,17,21,4,3
14,274,274,3,3,0,1,0
7,275,275,1,1,0,1,0
18,275,275,61,4,57,4,3
17,276,276,94,48,46,3,2
22,279,279,61,4,57,3,2
15,311,311,1,1,0,1,0
16,323,323,23,23,0,1,0
32,323,323,44,22,22,3,2
29,324,324,2,2,0,1,0
19,325,325,27,22,5,2,1
12,342,342,82,16,66,3,2
31,344,344,111,99,12,2,1
25,347,347,39,22,17,4,3
28,347,347,98,98,0,1,0
27,353,353,21,21,0,1,0
26,364,364,1,1,0,1,0
9,393,393,29,10,19,2,1
11,406,406,10,10,0,1,0
30,449,449,17,2,15,2,1
1,457,457,77,77,0,1,0
10,470,470,56,52,4,2,1

25,111,111,12,12,0,1,0
23,111,111,3,3,0,1,0
7,126,126,22,22,0,1,0
15,146,146,17,17,0,1,0
3,151,151,4,4,0,1,0
18,182,182,15,15,0,1,0
26,182,182,2,2,0,1,0
1,182,182,26,26,0,1,0
20,189,189,7,1,6,2,1
16,195,195,48,48,0,1,0
29,216,216,13,2,11,2,1
2,232,232,9,9,0,1,0
32,233,233,37,37,0,1,0
8,243,243,7,7,0,1,0
28,250,250,14,9,5,2,1
36,262,262,26,26,0,1,0
0,270,270,8,4,4,2,1
17,281,281,2,2,0,1,0
27,285,285,60,60,0,1,0
4,300,300,53,53,0,1,0
38,301,301,3,3,0,1,0
34,310,310,50,50,0,1,0
33,312,312,28,17,11,2,1
24,322,322,102,102,0,1,0
30,325,325,25,25,0,1,0
5,332,332,27,7,20,3,2
22,333,333,2,2,0,1,0
13,342,342,6,6,0,1,0
35,347,347,7,7,0,1,0
31,347,347,62,62,0,1,0
10,349,349,10,10,0,1,0
19,363,363,28,14,14,2,1
11,385,385,2,2,0,1,0
21,389,389,1,1,0,1,0
14,396,396,70,44,26,3,2
9,421,421,14,2,12,3,2
6,426,426,66,30,36,3,2
37,429,429,57,37,20,2,1
12,453,453,8,5,3,2,1

8,101,101,2,2,0,1,0
38,132,132,3,3,0,1,0
10,142,142,6,2,4,2,1
37,147,147,7,7,0,1,0
22,150,150,19,19,0,1,0
23,166,166,12,12,0,1,0
31,180,180,9,2,7,2,1
1,200,200,13,13,0,1,0
13,210,210,15,9,6,2,1
26,211,211,13,13,0,1,0
14,217,217,6,6,0,1,0
35,225,225,74,74,0,1,0
2,232,232,33,33,0,1,0
32,242,242,8,8,0,1,0
15,278,278,23,9,14,3,2
29,287,287,4,4,0,1,0
28,288,288,47,12,35,4,3
36,290,290,2,2,0,1,0
27,292,292,19,19,0,1,0
11,297,297,76,49,27,4,3
4,310,310,42,42,0,1,0
17,311,311,16,16,0,1,0
0,318,318,1,1,0,1,0
20,328,328,35,8,27,2,1
5,328,328,26,16,10,3,2
19,334,334,38,38,0,1,0
16,345,345,30,2,28,2,1
9,349,349,8,8,0,1,0
6,361,361,1,1,0,1,0
3,369,369,39,17,22,2,1
21,398,398,4,4,0,1,0
18,400,400,54,54,0,1,0
34,421,421,4,1,3,2,1
33,422,422,73,30,43,2,1
30,433,433,108,108,0,1,0
7,443,443,13,13,0,1,0
24,449,449,60,60,0,1,0
25,467,467,86,38,48,4,3
12,487,487,55,55,0,1,0

39,103,103,14,14,0,1,0
23,111,111,2,2,0,1,0
33,119,119,7,4,3,2,1
30,129,129,10,1,9,2,1
1,131,131,15,9,6,3,2
5,141,141,28,7,21,4,3
36,155,155,9,9,0,1,0
40,157,157,2,2,0,1,0
29,160,160,17,17,0,1,0
31,162,162,29,3,26,2,1
14,182,182,1,1,0,1,0
27,200,200,51,51,0,1,0
38,201,201,15,15,0,1,0
10,220,220,13,13,0,1,0
15,231,231,4,4,0,1,0
28,234,234,20,20,0,1,0
41,248,248,39,39,0,1,0
12,249,249,37,37,0,1,0
0,252,252,29,29,0,1,0
24,257,257,5,5,0,1,0
21,258,258,5,2,3,2,1
25,276,276,15,1,14,3,2
42,284,284,30,20,10,2,1
18,287,287,13,3,10,3,2
17,292,292,9,9,0,1,0
26,298,298,25,20,5,2,1
35,301,301,5,1,4,2,1
20,387,387,5,5,0,1,0
7,415,415,17,13,4,2,1
32,423,423,51,51,0,1,0
22,426,426,91,6,85,4,3
11,434,434,48,48,0,1,0
19,437,437,32,14,18,3,2
16,438,438,12,12,0,1,0
13,461,461,1,1,0,1,0
8,461,461,2,2,0,1,0
9,463,463,7,7,0,1,0
6,464,464,2,2,0,1,0
37,466,466,15,15,0,1,0
3,469,469,65,35,30,2,1
2,479,479,78,78,0,1,0
34,493,493,88,88,0,1,0
4,499,499,24,24,0,1,0

1,125,125,1,1,0,1,0
14,131,131,1,1,0,1,0
25,131,131,23,18,5,2,1
17,137,137,19,19,0,1,0
13,155,155,8,8,0,1,0
4,156,156,26,26,0,1,0
6,171,171,7,7,0,1,0
36,183,183,3,3,0,1,0
19,186,186,7,1,6,3,2
24,187,187,33,33,0,1,0
21,187,187,5,5,0,1,0
3,191,191,4,4,0,1,0
34,227,227,35,35,0,1,0
32,232,232,37,27,10,3,2
30,233,233,42,18,24,4,3
5,234,234,34,27,7,2,1
7,237,237,5,5,0,1,0
8,253,253,23,1,22,3,2
9,269,269,11,11,0,1,0
12,271,271,10,2,8,3,2
23,279,279,37,37,0,1,0
10,305,305,7,7,0,1,0
11,313,313,89,83,6,2,1
35,316,316,12,8,4,2,1
0,327,327,56,56,0,1,0
20,342,342,2,2,0,1,0
15,363,363,24,24,0,1,0
2,392,392,4,4,0,1,0
37,418,418,86,86,0,1,0
31,430,430,5,5,0,1,0
29,447,447,55,55,0,1,0
22,448,448,16,6,10,2,1
33,484,484,22,5,17,2,1
28,487,487,54,30,24,4,3
18,488,488,3,3,0,1,0
27,491,491,34,34,0,1,0
16,496,496,163,76,87,4,3
26,497,497,31,25,6,2,1

18,111,111,10,10,0,1,0
20,112,112,2,2,0,1,0
0,130,130,14,6,8,2,1
24,132,132,3,3,0,1,0
30,138,138,13,13,0,1,0
4,147,147,9,9,0,1,0
16,161,161,4,4,0,1,0
26,189,189,36,33,3,2,1
27,202,202,15,11,4,2,1
6,222,222,65,17,48,4,3
10,223,223,14,14,0,1,0
7,238,238,1,1,0,1,0
8,255,255,61,61,0,1,0
19,259,259,16,11,5,2,1
13,283,283,4,4,0,1,0
14,314,314,12,4,8,3,2
15,324,324,36,15,21,2,1
3,329,329,71,59,12,2,1
29,331,331,39,24,15,4,3
11,334,334,20,20,0,1,0
21,359,359,77,77,0,1,0
12,359,359,68,56,12,4,3
22,379,379,35,8,27,4,3
28,389,389,5,5,0,1,0
2,393,393,1,1,0,1,0
17,418,418,52,28,24,4,3
1,433,433,48,48,0,1,0
23,446,446,100,85,15,4,3
5,447,447,34,34,0,1,0
25,462,462,109,46,63,4,3
9,491,491,112,90,22,2,1
31,497,497,11,11,0,1,0

15,120,120,35,35,0,1,0
2,124,124,8,4,4,2,1
33,133,133,16,16,0,1,0
34,139,139,1,1,0,1,0
28,145,145,4,1,3,2,1
20,201,201,66,50,16,3,2
3,203,203,27,18,9,4,3
36,204,204,2,2,0,1,0
25,231,231,20,20,0,1,0
19,232,232,1,1,0,1,0
17,265,265,36,19,17,2,1
9,280,280,12,12,0,1,0
1,289,289,1,1,0,1,0
8,291,291,54,18,36,2,1
13,297,297,1,1,0,1,0
26,306,306,17,17,0,1,0
18,318,318,16,16,0,1,0
4,319,319,53,53,0,1,0
35,333,333,27,2,25,2,1
10,334,334,45,21,24,4,3
7,344,344,48,48,0,1,0
5,352,352,40,29,11,2,1
27,359,359,11,11,0,1,0
6,364,364,13,13,0,1,0
29,365,365,1,1,0,1,0
24,390,390,20,20,0,1,0
23,403,403,18,8,10,3,2
32,411,411,136,80,56,3,2
16,413,413,13,2,11,3,2
0,414,414,44,44,0,1,0
30,421,421,27,5,22,3,2
22,430,430,56,43,13,2,1
21,442,442,52,52,0,1,0
11,451,451,12,12,0,1,0
12,471,471,5,2,3,2,1
14,484,484,10,10,0,1,0
31,491,491,119,80,39,2,1

38,120,120,12,12,0,1,0
5,127,127,54,54,0,1,0
34,151,151,17,6,11,2,1
23,175,175,8,1,7,2,1
25,185,185,4,1,3,2,1
10,220,220,6,6,0,1,0
2,231,231,6,1,5,2,1
35,244,244,100,76,24,4,3
15,260,260,7,7,0,1,0
0,262,262,27,7,20,2,1
3,266,266,17,2,15,4,3
28,272,272,5,5,0,1,0
32,282,282,4,4,0,1,0
18,286,286,20,6,14,3,2
11,291,291,2,2,0,1,0
19,296,296,30,30,0,1,0
37,307,307,31,31,0,1,0
14,312,312,3,3,0,1,0
30,332,332,14,14,0,1,0
29,332,332,2,2,0,1,0
4,335,335,8,8,0,1,0
27,366,366,79,79,0,1,0
24,369,369,7,7,0,1,0
33,373,373,9,9,0,1,0
16,385,385,7,7,0,1,0
1,388,388,49,22,27,4,3
22,407,407,15,15,0,1,0
8,414,414,38,23,15,4,3
20,419,419,19,7,12,2,1
13,419,419,42,18,24,4,3
6,421,421,12,12,0,1,0
36,422,422,149,29,120,4,3
17,435,435,17,17,0,1,0
9,447,447,73,73,0,1,0
39,464,464,26,17,9,4,3
12,476,476,45,6,39,2,1
26,492,492,16,16,0,1,0
21,492,492,28,13,15,4,3
7,497,497,8,8,0,1,0
31,500,500,83,63,20,3,2

27,121,121,15,2,13,2,1
6,122,122,20,3,17,2,1
16,128,128,2,2,0,1,0
3,134,134,14,8,6,2,1
1,139,139,1,1,0,1,0
9,139,139,4,1,3,2,1
29,146,146,4,4,0,1,0
5,149,149,8,8,0,1,0
0,156,156,10,3,7,2,1
25,198,198,29,17,12,4,3
8,206,206,7,1,6,3,2
15,213,213,15,3,12,3,2
18,223,223,70,70,0,1,0
34,251,251,9,9,0,1,0
35,263,263,52,38,14,3,2
26,287,287,2,2,0,1,0
2,303,303,30,6,24,4,3
13,319,319,53,29,24,4,3
33,319,319,52,13,39,4,3
32,320,320,21,3,18,4,3
7,325,325,27,9,18,3,2
31,337,337,89,64,25,2,1
12,352,352,21,15,6,2,1
4,357,357,41,41,0,1,0
17,360,360,10,10,0,1,0
11,361,361,58,28,30,2,1
22,390,390,21,1,20,4,3
21,411,411,9,6,3,2,1
28,451,451,84,42,42,2,1
14,453,453,6,3,3,2,1
36,455,455,9,9,0,1,0
24,455,455,15,8,7,2,1
30,458,458,70,70,0,1,0
19,462,462,11,11,0,1,0
23,463,463,97,85,12,3,2
20,480,480,7,7,0,1,0
10,493,493,48,30,18,4,3

40,101,101,13,1,12,3,2
21,125,125,1,1,0,1,0
19,140,140,1,1,0,1,0
34,147,147,3,3,0,1,0
25,185,185,91,91,0,1,0
10,187,187,6,6,0,1,0
29,187,187,13,13,0,1,0
2,198,198,8,8,0,1,0
24,203,203,30,14,16,2,1
6,206,206,1,1,0,1,0
5,214,214,24,24,0,1,0
9,218,218,6,6,0,1,0
31,219,219,9,6,3,2,1
38,227,227,38,38,0,1,0
28,241,241,13,1,12,3,2
23,264,264,14,2,12,2,1
4,266,266,7,7,0,1,0
16,274,274,3,3,0,1,0
37,276,276,25,25,0,1,0
13,277,277,11,11,0,1,0
36,278,278,10,10,0,1,0
12,295,295,51,33,18,3,2
18,316,316,17,17,0,1,0
7,329,329,33,12,21,2,1
17,335,335,40,40,0,1,0
15,349,349,8,8,0,1,0
26,349,349,17,3,14,2,1
35,388,388,29,29,0,1,0
39,397,397,34,34,0,1,0
27,400,400,14,2,12,4,3
0,409,409,18,4,14,3,2
1,415,415,1,1,0,1,0
32,427,427,34,34,0,1,0
22,432,432,70,22,48,2,1
3,445,445,99,58,41,3,2
11,451,451,40,2,38,2,1
8,459,459,60,60,0,1,0
30,462,462,70,8,62,4,3
33,470,470,7,7,0,1,0
14,473,473,41,32,9,4,3
20,485,485,65,65,0,1,0

4,106,106,7,7,0,1,0
7,110,110,14,14,0,1,0
15,111,111,4,4,0,1,0
19,139,139,4,4,0,1,0
8,139,139,7,7,0,1,0
13,142,142,6,6,0,1,0
27,146,146,13,13,0,1,0
9,150,150,3,3,0,1,0
2,153,153,4,1,3,2,1
31,171,171,5,5,0,1,0
22,195,195,16,1,15,4,3
23,198,198,5,2,3,2,1
36,199,199,37,37,0,1,0
0,211,211,17,5,12,3,2
37,237,237,65,65,0,1,0
1,257,257,20,20,0,1,0
10,269,269,7,7,0,1,0
26,287,287,9,9,0,1,0
24,302,302,38,32,6,2,1
33,305,305,55,19,36,3,2
21,319,319,37,37,0,1,0
34,329,329,5,5,0,1,0
6,332,332,16,16,0,1,0
29,343,343,76,1,75,4,3
30,354,354,41,4,37,2,1
16,357,357,7,2,5,2,1
3,366,366,14,2,12,4,3
18,369,369,32,32,0,1,0
38,381,381,13,13,0,1,0
17,405,405,1,1,0,1,0
28,407,407,33,22,11,2,1
35,417,417,46,46,0,1,0
39,420,420,59,59,0,1,0
14,472,472,2,2,0,1,0
25,480,480,7,7,0,1,0
11,481,481,4,4,0,1,0
32,487,487,27,27,0,1,0
20,487,487,87,72,15,4,3
5,487,487,2,2,0,1,0
12,491,491,261,139,122,4,3

16,110,110,2,2,0,1,0
2,116,116,18,5,13,2,1
30,116,116,16,9,7,2,1
24,116,116,4,4,0,1,0
17,126,126,12,12,0,1,0
23,148,148,11,4,7,2,1
7,172,172,2,2,0,1,0
6,199,199,25,25,0,1,0
10,209,209,59,59,0,1,0
20,217,217,30,30,0,1,0
5,221,221,35,35,0,1,0
8,222,222,6,6,0,1,0
4,231,231,12,12,0,1,0
9,234,234,32,3,29,2,1
26,250,250,62,5,57,3,2
12,257,257,97,52,45,2,1
15,260,260,39,11,28,3,2
13,270,270,24,24,0,1,0
27,288,288,17,1,16,2,1
3,353,353,3,3,0,1,0
1,359,359,44,1,43,4,3
11,364,364,43,43,0,1,0
18,371,371,11,11,0,1,0
25,382,382,64,64,0,1,0
28,392,392,8,8,0,1,0
19,424,424,16,16,0,1,0
14,458,458,90,90,0,1,0
22,466,466,90,10,80,3,2
0,473,473,18,12,6,3,2
21,474,474,6,6,0,1,0
29,483,483,56,41,15,4,3

1,101,101,14,5,9,2,1
31,113,113,3,3,0,1,0
10,115,115,18,18,0,1,0
33,144,144,3,3,0,1,0
28,164,164,69,54,15,4,3
8,184,184,2,2,0,1,0
6,190,190,13,6,7,2,1
9,231,231,18,18,0,1,0
0,240,240,17,17,0,1,0
5,243,243,8,8,0,1,0
22,253,253,9,9,0,1,0
34,255,255,16,16,0,1,0
7,259,259,24,11,13,2,1
30,287,287,5,5,0,1,0
11,294,294,1,1,0,1,0
12,294,294,13,3,10,2,1
17,296,296,10,10,0,1,0
23,303,303,78,31,47,2,1
16,303,303,28,28,0,1,0
2,303,303,26,19,7,2,1
13,303,303,73,73,0,1,0
29,313,313,139,39,100,3,2
26,316,316,20,20,0,1,0
24,319,319,11,3,8,3,2
18,328,328,12,12,0,1,0
4,371,371,53,39,14,2,1
15,393,393,18,7,11,2,1
27,422,422,25,25,0,1,0
14,438,438,90,21,69,4,3
32,449,449,9,9,0,1,0
21,454,454,1,1,0,1,0
20,458,458,46,46,0,1,0
3,464,464,74,41,33,2,1
25,483,483,59,1,58,3,2
19,493,493,6,6,0,1,0

27,105,105,28,2,26,2,1
34,133,133,5,5,0,1,0
23,137,137,2,2,0,1,0
8,142,142,1,1,0,1,0
17,153,153,11,7,4,2,1
35,153,153,28,28,0,1,0
13,162,162,29,29,0,1,0
28,164,164,40,9,31,2,1
18,166,166,53,44,9,2,1
15,168,168,5,5,0,1,0
38,168,168,2,2,0,1,0
16,189,189,5,5,0,1,0
29,194,194,30,2,28,3,2
24,217,217,26,11,15,2,1
3,224,224,1,1,0,1,0
30,237,237,11,11,0,1,0
9,257,257,1,1,0,1,0
20,267,267,14,2,12,2,1
25,270,270,26,26,0,1,0
32,270,270,3,3,0,1,0
37,285,285,16,12,4,2,1
6,288,288,29,2,27,2,1
31,289,289,18,12,6,2,1
21,314,314,30,4,26,2,1
10,315,315,15,11,4,2,1
11,325,325,8,2,6,2,1
33,341,341,27,27,0,1,0
12,364,364,9,9,0,1,0
26,365,365,100,100,0,1,0
14,385,385,22,4,18,4,3
19,392,392,1,1,0,1,0
1,400,400,11,11,0,1,0
4,400,400,57,57,0,1,0
36,407,407,22,16,6,2,1
2,411,411,28,28,0,1,0
22,416,416,13,13,0,1,0
0,422,422,99,41,58,3,2
5,445,445,30,30,0,1,0
7,458,458,53,53,0,1,0

17,116,116,8,8,0,1,0
16,117,117,11,8,3,2,1
15,157,157,17,17,0,1,0
1,159,159,29,29,0,1,0
21,171,171,6,2,4,2,1
0,207,207,49,49,0,1,0
8,209,209,45,41,4,2,1
20,236,236,116,116,0,1,0
19,276,276,9,9,0,1,0
11,287,287,19,19,0,1,0
23,308,308,21,13,8,2,1
12,322,322,12,2,10,2,1
3,330,330,68,15,53,4,3
18,341,341,70,52,18,4,3
7,349,349,16,16,0,1,0
22,360,360,2,2,0,1,0
25,363,363,39,39,0,1,0
10,370,370,16,5,11,3,2
24,391,391,12,12,0,1,0
2,402,402,145,145,0,1,0
6,426,426,10,1,9,3,2
5,429,429,18,9,9,2,1
13,438,438,10,10,0,1,0
9,482,482,96,96,0,1,0
14,495,495,60,60,0,1,0
4,499,499,194,194,0,1,0

7,115,115,7,7,0,1,0
9,121,121,3,3,0,1,0
18,127,127,8,8,0,1,0
38,132,132,4,4,0,1,0
23,135,135,12,12,0,1,0
12,136,136,8,5,3,2,1
3,138,138,5,5,0,1,0
30,159,159,11,2,9,2,1
1,188,188,20,20,0,1,0
17,200,200,1,1,0,1,0
20,212,212,19,19,0,1,0
22,230,230,9,9,0,1,0
14,241,241,12,1,11,2,1
25,245,245,10,2,8,3,2
11,254,254,26,26,0,1,0
0,268,268,4,4,0,1,0
27,276,276,15,15,0,1,0
6,281,281,20,20,0,1,0
36,282,282,33,18,15,4,3
40,298,298,18,18,0,1,0
26,303,303,39,39,0,1,0
10,304,304,1,1,0,1,0
13,316,316,39,22,17,2,1
4,317,317,138,125,13,2,1
15,318,318,36,36,0,1,0
29,320,320,37,37,0,1,0
31,336,336,53,53,0,1,0
16,338,338,11,5,6,2,1
19,350,350,12,12,0,1,0
37,356,356,2,2,0,1,0
28,377,377,10,2,8,3,2
34,378,378,54,54,0,1,0
5,386,386,4,1,3,2,1
35,392,392,10,10,0,1,0
24,401,401,61,61,0,1,0
32,419,419,14,2,12,2,1
21,436,436,34,27,7,2,1
2,458,458,6,6,0,1,0
8,489,489,25,25,0,1,0
33,494,494,155,131,24,3,2
39,497,497,120,84,36,4,3

22,103,103,41,41,0,1,0
8,104,104,1,1,0,1,0
13,112,112,1,1,0,1,0
27,126,126,1,1,0,1,0
14,145,145,5,5,0,1,0
0,161,161,2,2,0,1,0
25,170,170,33,11,22,3,2
26,171,171,12,2,10,2,1
30,195,195,13,13,0,1,0
7,210,210,15,15,0,1,0
24,215,215,10,3,7,2,1
12,227,227,6,6,0,1,0
6,234,234,1,1,0,1,0
2,246,246,62,62,0,1,0
5,269,269,60,60,0,1,0
17,270,270,62,62,0,1,0
1,278,278,1,1,0,1,0
33,291,291,28,28,0,1,0
32,317,317,9,9,0,1,0
11,318,318,12,8,4,2,1
20,326,326,8,4,4,2,1
15,326,326,25,17,8,3,2
29,337,337,3,3,0,1,0
18,338,338,13,2,11,2,1
23,350,350,6,6,0,1,0
16,361,361,34,10,24,2,1
21,366,366,39,39,0,1,0
19,369,369,54,46,8,3,2
4,410,410,17,1,16,3,2
3,414,414,35,3,32,3,2
31,419,419,41,26,15,4,3
9,458,458,24,24,0,1,0
10,474,474,208,67,141,4,3
28,486,486,177,107,70,4,3
34,495,495,15,15,0,1,0

5,106,106,1,1,0,1,0
8,109,109,17,17,0,1,0
1,117,117,43,43,0,1,0
3,119,119,4,4,0,1,0
24,134,134,4,1,3,2,1
2,155,155,15,5,10,2,1
14,172,172,6,6,0,1,0
18,200,200,6,6,0,1,0
31,209,209,10,10,0,1,0
7,219,219,14,2,12,4,3
16,236,236,2,2,0,1,0
30,272,272,17,1,16,3,2
29,308,308,118,118,0,1,0
26,312,312,36,3,33,4,3
11,313,313,8,8,0,1,0
12,318,318,6,1,5,2,1
13,322,322,61,61,0,1,0
0,343,343,90,63,27,4,3
6,345,345,36,15,21,2,1
20,347,347,25,25,0,1,0
10,351,351,30,8,22,2,1
25,357,357,17,17,0,1,0
22,360,360,20,20,0,1,0
21,376,376,19,15,4,2,1
28,378,378,5,5,0,1,0
27,389,389,58,47,11,2,1
23,394,394,27,27,0,1,0
4,423,423,81,33,48,3,2
15,440,440,17,17,0,1,0
19,481,481,67,31,36,4,3
17,485,485,205,142,63,4,3
9,496,496,31,31,0,1,0

4,102,102,1,1,0,1,0
12,104,104,8,8,0,1,0
15,116,116,9,5,4,2,1
31,118,118,20,20,0,1,0
3,123,123,17,17,0,1,0
11,134,134,19,19,0,1,0
32,157,157,8,4,4,2,1
17,159,159,1,1,0,1,0
16,172,172,2,2,0,1,0
19,176,176,9,1,8,3,2
28,195,195,57,45,12,2,1
21,202,202,28,28,0,1,0
18,203,203,3,3,0,1,0
1,204,204,16,16,0,1,0
34,212,212,43,43,0,1,0
9,236,236,2,2,0,1,0
0,238,238,56,56,0,1,0
13,259,259,46,46,0,1,0
26,269,269,49,18,31,3,2
10,272,272,44,18,26,3,2
2,289,289,4,4,0,1,0
35,313,313,1,1,0,1,0
27,328,328,52,10,42,3,2
6,330,330,55,55,0,1,0
23,337,337,11,11,0,1,0
22,345,345,30,1,29,2,1
14,353,353,45,9,36,2,1
20,368,368,15,15,0,1,0
25,386,386,84,81,3,2,1
7,389,389,2,2,0,1,0
8,391,391,1,1,0,1,0
5,400,400,99,41,58,3,2
33,426,426,11,11,0,1,0
24,435,435,2,2,0,1,0
29,456,456,21,21,0,1,0
30,499,499,15,5,10,2,1

6,108,108,25,1,24,4,3
29,129,129,19,7,12,4,3
31,140,140,6,6,0,1,0
5,145,145,3,3,0,1,0
18,156,156,19,2,17,4,3
28,157,157,19,19,0,1,0
1,158,158,6,6,0,1,0
32,172,172,21,21,0,1,0
2,174,174,9,3,6,3,2
25,194,194,6,1,5,2,1
15,210,210,80,80,0,1,0
12,231,231,1,1,0,1,0
10,240,240,10,10,0,1,0
8,245,245,12,8,4,2,1
17,258,258,36,15,21,4,3
21,262,262,4,1,3,2,1
9,281,281,52,3,49,2,1
22,322,322,18,3,15,4,3
7,326,326,19,19,0,1,0
26,331,331,2,2,0,1,0
33,341,341,45,45,0,1,0
14,343,343,56,36,20,2,1
19,347,347,60,54,6,2,1
0,358,358,28,15,13,2,1
3,361,361,19,4,15,4,3
16,364,364,16,1,15,2,1
34,365,365,10,10,0,1,0
4,372,372,1,1,0,1,0
13,373,373,37,37,0,1,0
24,395,395,51,39,12,4,3
23,404,404,123,27,96,3,2
11,450,450,28,28,0,1,0
20,462,462,1,1,0,1,0
27,478,478,104,104,0,1,0
30,479,479,42,21,21,2,1

11,130,130,2,2,0,1,0
14,136,136,1,1,0,1,0
33,159,159,32,7,25,2,1
17,164,164,2,2,0,1,0
8,209,209,21,14,7,2,1
21,211,211,6,1,5,2,1
2,229,229,35,5,30,2,1
20,230,230,16,16,0,1,0
23,237,237,1,1,0,1,0
0,275,275,9,9,0,1,0
34,276,276,5,5,0,1,0
13,282,282,6,6,0,1,0
26,285,285,20,1,19,4,3
16,290,290,83,39,44,3,2
25,295,295,31,25,6,3,2
4,298,298,39,39,0,1,0
35,302,302,30,30,0,1,0
28,302,302,152,29,123,4,3
27,307,307,17,2,15,4,3
31,314,314,38,17,21,4,3
7,320,320,9,9,0,1,0
6,325,325,70,4,66,3,2
5,332,332,34,34,0,1,0
24,355,355,27,27,0,1,0
18,367,367,14,14,0,1,0
10,368,368,10,10,0,1,0
1,380,380,26,26,0,1,0
12,383,383,9,1,8,3,2
19,393,393,15,6,9,4,3
32,409,409,40,2,38,3,2
29,420,420,58,32,26,3,2
15,421,421,78,78,0,1,0
3,426,426,76,19,57,4,3
30,431,431,40,31,9,4,3
9,432,432,32,32,0,1,0
22,441,441,3,3,0,1,0

28,109,109,15,6,9,4,3
32,117,117,9,1,8,2,1
6,126,126,17,17,0,1,0
27,127,127,11,8,3,2,1
17,135,135,2,2,0,1,0
25,141,141,4,4,0,1,0
30,146,146,3,3,0,1,0
2,149,149,8,4,4,2,1
4,152,152,4,4,0,1,0
7,161,161,1,1,0,1,0
11,163,163,28,28,0,1,0
33,165,165,22,22,0,1,0
34,175,175,17,1,16,2,1
0,180,180,9,4,5,2,1
14,194,194,10,10,0,1,0
5,234,234,54,9,45,4,3
12,242,242,35,26,9,2,1
24,260,260,15,9,6,2,1
21,265,265,19,19,0,1,0
16,276,276,3,3,0,1,0
36,295,295,14,2,12,2,1
3,312,312,26,1,25,2,1
19,330,330,74,74,0,1,0
15,331,331,4,4,0,1,0
31,362,362,18,18,0,1,0
13,370,370,6,6,0,1,0
22,385,385,78,78,0,1,0
10,390,390,103,103,0,1,0
35,411,411,98,47,51,4,3
8,421,421,56,56,0,1,0
23,435,435,140,61,79,4,3
20,437,437,40,40,0,1,0
18,452,452,11,8,3,2,1
29,455,455,4,1,3,2,1
9,459,459,21,6,15,4,3
26,474,474,34,34,0,1,0
1,499,499,1,1,0,1,0

21,109,109,2,2,0,1,0
27,116,116,7,7,0,1,0
3,124,124,65,3,62,4,3
20,125,125,7,3,4,2,1
29,130,130,19,1,18,2,1
2,142,142,1,1,0,1,0
13,145,145,1,1,0,1,0
23,148,148,18,18,0,1,0
12,148,148,1,1,0,1,0
18,154,154,26,11,15,4,3
5,183,183,8,8,0,1,0
9,222,222,3,3,0,1,0
22,229,229,31,6,25,4,3
4,230,230,9,2,7,2,1
10,238,238,4,4,0,1,0
31,268,268,13,13,0,1,0
25,272,272,5,5,0,1,0
26,273,273,25,1,24,2,1
17,335,335,16,1,15,2,1
7,340,340,9,9,0,1,0
0,344,344,47,18,29,2,1
28,349,349,25,1,24,3,2
1,378,378,116,65,51,4,3
15,396,396,40,8,32,3,2
32,410,410,174,81,93,4,3
33,453,453,10,7,3,2,1
16,459,459,29,6,23,2,1
11,467,467,37,37,0,1,0
19,473,473,72,72,0,1,0
6,477,477,100,57,43,4,3
14,482,482,52,52,0,1,0
24,483,483,64,1,63,4,3
30,490,490,10,10,0,1,0
8,500,500,6,6,0,1,0

25,103,103,1,1,0,1,0
33,103,103,13,4,9,4,3
9,104,104,3,3,0,1,0
6,123,123,3,3,0,1,0
10,124,124,6,6,0,1,0
7,125,125,1,1,0,1,0
18,129,129,17,17,0,1,0
36,134,134,14,8,6,3,2
14,136,136,6,6,0,1,0
16,145,145,10,10,0,1,0
17,146,146,9,1,8,3,2
0,147,147,4,4,0,1,0
5,188,188,1,1,0,1,0
37,189,189,39,3,36,3,2
34,190,190,12,12,0,1,0
29,195,195,11,5,6,2,1
23,212,212,32,32,0,1,0
31,222,222,20,5,15,2,1
4,224,224,107,107,0,1,0
20,250,250,42,42,0,1,0
13,256,256,5,2,3,2,1
11,265,265,9,9,0,1,0
32,267,267,61,5,56,4,3
21,272,272,1,1,0,1,0
35,282,282,3,3,0,1,0
12,284,284,11,2,9,4,3
30,286,286,26,10,16,2,1
24,311,311,8,8,0,1,0
3,317,317,17,17,0,1,0
27,320,320,49,31,18,4,3
1,335,335,13,4,9,2,1
22,363,363,46,4,42,2,1
26,374,374,17,17,0,1,0
19,381,381,59,59,0,1,0
8,381,381,12,1,11,2,1
28,386,386,89,76,13,2,1
15,459,459,45,1,44,2,1
38,480,480,9,9,0,1,0
2,483,483,65,18,47,2,1

9,103,103,14,2,12,4,3
6,110,110,2,2,0,1,0
24,135,135,5,5,0,1,0
22,157,157,20,20,0,1,0
21,165,165,29,21,8,3,2
7,167,167,23,23,0,1,0
2,181,181,15,9,6,2,1
29,202,202,7,7,0,1,0
30,204,204,56,28,28,3,2
4,207,207,11,5,6,2,1
33,223,223,21,5,16,2,1
12,239,239,26,14,12,3,2
8,241,241,9,9,0,1,0
28,253,253,15,15,0,1,0
34,321,321,8,8,0,1,0
14,322,322,18,8,10,3,2
3,333,333,5,5,0,1,0
17,334,334,34,25,9,2,1
5,341,341,1,1,0,1,0
18,342,342,1,1,0,1,0
16,347,347,75,64,11,2,1
11,356,356,1,1,0,1,0
32,361,361,50,50,0,1,0
19,372,372,88,88,0,1,0
27,379,379,2,2,0,1,0
31,394,394,18,10,8,3,2
10,396,396,93,93,0,1,0
26,401,401,12,8,4,2,1
23,413,413,180,72,108,4,3
20,431,431,3,3,0,1,0
13,438,438,7,2,5,2,1
25,446,446,1,1,0,1,0
15,462,462,115,14,101,4,3
0,463,463,82,13,69,4,3
1,493,493,27,27,0,1,0

6,105,105,2,2,0,1,0
3,116,116,3,3,0,1,0
13,128,128,22,1,21,2,1
25,130,130,17,17,0,1,0
26,137,137,8,8,0,1,0
12,143,143,62,53,9,4,3
1,192,192,15,7,8,3,2
18,208,208,64,64,0,1,0
19,222,222,2,2,0,1,0
29,223,223,12,12,0,1,0
24,256,256,7,7,0,1,0
14,264,264,51,16,35,2,1
11,293,293,56,56,0,1,0
15,296,296,24,24,0,1,0
0,297,297,33,33,0,1,0
9,332,332,5,5,0,1,0
2,353,353,4,1,3,2,1
7,370,370,81,81,0,1,0
16,371,371,21,21,0,1,0
27,373,373,69,69,0,1,0
17,407,407,25,25,0,1,0
20,421,421,13,4,9,2,1
23,423,423,49,49,0,1,0
28,429,429,12,12,0,1,0
8,435,435,131,21,110,4,3
21,447,447,46,46,0,1,0
5,477,477,4,4,0,1,0
4,480,480,21,11,10,2,1
22,494,494,58,16,42,2,1
10,497,497,124,124,0,1,0

15,101,101,26,5,21,4,3
19,111,111,1,1,0,1,0
27,119,119,11,1,10,3,2
29,129,129,1,1,0,1,0
13,143,143,1,1,0,1,0
18,155,155,26,14,12,4,3
34,165,165,15,15,0,1,0
7,169,169,10,10,0,1,0
28,202,202,24,14,10,3,2
32,221,221,6,6,0,1,0
9,235,235,62,62,0,1,0
23,264,264,43,43,0,1,0
10,270,270,13,7,6,2,1
20,284,284,71,26,45,2,1
1,295,295,32,32,0,1,0
2,298,298,23,23,0,1,0
22,306,306,17,17,0,1,0
21,315,315,20,20,0,1,0
30,320,320,9,9,0,1,0
24,336,336,26,26,0,1,0
4,356,356,48,18,30,4,3
0,368,368,47,12,35,2,1
14,398,398,50,50,0,1,0
33,401,401,164,23,141,4,3
12,405,405,36,21,15,2,1
3,407,407,70,62,8,2,1
5,417,417,1,1,0,1,0
31,428,428,13,7,6,2,1
17,430,430,12,6,6,2,1
8,443,443,39,39,0,1,0
25,445,445,15,3,12,3,2
6,487,487,12,7,5,2,1
16,490,490,10,10,0,1,0
26,495,495,56,56,0,1,0
11,497,497,33,15,18,2,1

11,118,118,40,40,0,1,0
17,142,142,8,4,4,2,1
3,149,149,25,25,0,1,0
24,168,168,2,2,0,1,0
5,172,172,28,28,0,1,0
23,243,243,19,16,3,2,1
13,248,248,3,3,0,1,0
6,251,251,20,20,0,1,0
22,263,263,104,104,0,1,0
10,269,269,11,11,0,1,0
9,311,311,49,49,0,1,0
29,315,315,62,62,0,1,0
21,333,333,2,2,0,1,0
0,335,335,5,5,0,1,0
2,355,355,37,3,34,3,2
20,358,358,42,42,0,1,0
15,390,390,1,1,0,1,0
27,390,390,179,139,40,3,2
4,391,391,64,44,20,3,2
18,406,406,2,2,0,1,0
8,408,408,52,7,45,2,1
16,422,422,25,2,23,2,1
12,423,423,49,49,0,1,0
28,425,425,29,17,12,3,2
26,440,440,15,9,6,2,1
19,462,462,31,31,0,1,0
7,465,465,62,1,61,4,3
1,467,467,44,1,43,4,3
25,470,470,6,6,0,1,0
14,497,497,73,46,27,4,3

20,103,103,1,1,0,1,0
27,111,111,35,35,0,1,0
12,123,123,5,5,0,1,0
17,159,159,1,1,0,1,0
32,172,172,13,10,3,2,1
39,174,174,1,1,0,1,0
37,196,196,15,11,4,2,1
33,199,199,15,7,8,3,2
25,215,215,75,75,0,1,0
23,222,222,7,7,0,1,0
16,223,223,24,20,4,2,1
30,225,225,5,2,3,2,1
28,234,234,12,12,0,1,0
14,239,239,9,1,8,2,1
18,245,245,67,67,0,1,0
2,251,251,3,3,0,1,0
9,262,262,7,1,6,2,1
3,273,273,20,20,0,1,0
1,279,279,11,2,9,2,1
15,279,279,1,1,0,1,0
22,288,288,17,17,0,1,0
35,289,289,8,2,6,2,1
8,307,307,8,8,0,1,0
31,307,307,11,11,0,1,0
24,312,312,60,36,24,2,1
10,315,315,12,12,0,1,0
5,315,315,14,8,6,3,2
19,315,315,26,8,18,3,2
11,324,324,21,17,4,2,1
0,335,335,19,14,5,2,1
6,368,368,12,1,11,2,1
26,373,373,22,22,0,1,0
21,375,375,115,17,98,4,3
4,386,386,1,1,0,1,0
38,428,428,24,12,12,2,1
7,450,450,27,27,0,1,0
34,458,458,29,7,22,3,2
13,466,466,139,139,0,1,0
29,467,467,111,85,26,2,1
36,481,481,26,17,9,2,1

20,102,102,4,4,0,1,0
24,104,104,36,36,0,1,0
13,140,140,23,11,12,2,1
30,163,163,17,17,0,1,0
29,165,165,17,17,0,1,0
25,168,168,2,2,0,1,0
22,177,177,26,26,0,1,0
16,177,177,57,57,0,1,0
9,182,182,3,3,0,1,0
15,206,206,46,24,22,3,2
28,212,212,19,19,0,1,0
23,224,224,5,2,3,2,1
4,238,238,5,5,0,1,0
32,249,249,55,23,32,3,2
17,261,261,15,1,14,4,3
11,269,269,32,3,29,2,1
27,278,278,1,1,0,1,0
34,279,279,10,10,0,1,0
2,284,284,12,12,0,1,0
31,294,294,14,14,0,1,0
12,296,296,16,16,0,1,0
3,296,296,3,3,0,1,0
33,311,311,26,26,0,1,0
0,326,326,18,6,12,3,2
10,374,374,16,16,0,1,0
26,376,376,80,80,0,1,0
5,384,384,1,1,0,1,0
19,401,401,23,1,22,2,1
6,415,415,8,5,3,2,1
7,449,449,11,2,9,2,1
8,458,458,38,11,27,2,1
1,465,465,82,35,47,4,3
21,470,470,33,30,3,2,1
14,475,475,127,114,13,2,1
18,496,496,72,43,29,4,3

23,123,123,12,12,0,1,0
26,123,123,7,7,0,1,0
38,131,131,15,3,12,2,1
14,139,139,7,7,0,1,0
27,145,145,7,1,6,2,1
36,159,159,30,9,21,2,1
9,160,160,14,2,12,3,2
31,182,182,3,3,0,1,0
13,185,185,3,3,0,1,0
10,189,189,13,5,8,3,2
12,198,198,4,4,0,1,0
7,203,203,1,1,0,1,0
35,208,208,27,7,20,3,2
4,216,216,16,16,0,1,0
18,219,219,3,3,0,1,0
22,227,227,33,33,0,1,0
8,229,229,28,28,0,1,0
11,233,233,15,5,10,3,2
15,233,233,46,22,24,2,1
3,248,248,19,19,0,1,0
17,260,260,4,4,0,1,0
42,260,260,15,3,12,3,2
37,261,261,87,40,47,3,2
30,265,265,2,2,0,1,0
24,273,273,5,5,0,1,0
6,274,274,12,5,7,2,1
32,296,296,16,16,0,1,0
1,304,304,36,36,0,1,0
5,306,306,17,8,9,4,3
20,318,318,18,13,5,2,1
19,342,342,35,19,16,2,1
0,343,343,27,4,23,2,1
28,353,353,6,6,0,1,0
41,362,362,37,37,0,1,0
25,383,383,1,1,0,1,0
33,392,392,19,19,0,1,0
40,438,438,39,18,21,3,2
2,445,445,29,14,15,2,1
34,446,446,108,54,54,4,3
16,452,452,3,3,0,1,0
21,469,469,46,46,0,1,0
39,470,470,63,19,44,3,2
29,483,483,47,47,0,1,0

25,121,121,7,7,0,1,0
1,124,124,27,27,0,1,0
3,134,134,3,3,0,1,0
29,138,138,20,6,14,2,1
30,144,144,1,1,0,1,0
24,173,173,5,2,3,2,1
22,184,184,3,3,0,1,0
11,191,191,23,23,0,1,0
10,198,198,9,9,0,1,0
13,205,205,23,7,16,2,1
26,208,208,11,11,0,1,0
8,221,221,28,4,24,3,2
31,221,221,26,26,0,1,0
2,231,231,10,10,0,1,0
16,234,234,27,27,0,1,0
18,234,234,50,50,0,1,0
23,260,260,35,14,21,4,3
20,261,261,21,21,0,1,0
15,261,261,3,3,0,1,0
33,262,262,59,17,42,2,1
34,270,270,1,1,0,1,0
7,270,270,45,45,0,1,0
21,276,276,75,25,50,4,3
9,287,287,24,18,6,3,2
14,321,321,16,16,0,1,0
19,338,338,1,1,0,1,0
17,349,349,9,9,0,1,0
0,352,352,95,82,13,2,1
27,372,372,73,73,0,1,0
32,374,374,43,43,0,1,0
6,413,413,38,23,15,4,3
5,414,414,57,41,16,2,1
4,452,452,26,26,0,1,0
28,468,468,38,38,0,1,0
12,475,475,1,1,0,1,0

27,111,111,13,13,0,1,0
11,117,117,3,3,0,1,0
6,145,145,17,17,0,1,0
0,154,154,6,6,0,1,0
3,159,159,27,27,0,1,0
9,168,168,50,8,42,4,3
13,178,178,76,42,34,3,2
12,184,184,2,2,0,1,0
15,225,225,4,4,0,1,0
7,235,235,64,4,60,4,3
18,247,247,21,21,0,1,0
22,259,259,22,16,6,2,1
4,274,274,48,48,0,1,0
8,306,306,36,7,29,2,1
2,319,319,31,24,7,2,1
23,329,329,10,5,5,2,1
17,373,373,25,25,0,1,0
14,383,383,18,18,0,1,0
24,392,392,32,10,22,2,1
1,393,393,3,3,0,1,0
16,396,396,67,51,16,2,1
5,451,451,88,50,38,4,3
25,462,462,14,14,0,1,0
26,462,462,23,2,21,4,3
19,479,479,165,129,36,3,2
10,493,493,105,105,0,1,0
20,493,493,4,4,0,1,0
21,497,497,68,68,0,1,0

19,121,121,30,30,0,1,0
30,130,130,1,1,0,1,0
6,138,138,3,3,0,1,0
24,149,149,3,3,0,1,0
17,158,158,2,2,0,1,0
3,169,169,36,36,0,1,0
7,172,172,15,15,0,1,0
2,176,176,21,8,13,2,1
21,179,179,1,1,0,1,0
29,197,197,38,34,4,2,1
0,199,199,16,16,0,1,0
10,230,230,19,19,0,1,0
9,235,235,89,38,51,4,3
18,238,238,44,12,32,3,2
13,250,250,2,2,0,1,0
11,261,261,12,3,9,2,1
1,265,265,2,2,0,1,0
27,280,280,1,1,0,1,0
12,282,282,17,17,0,1,0
20,291,291,31,1,30,4,3
26,304,304,72,6,66,4,3
16,311,311,19,19,0,1,0
8,334,334,77,53,24,3,2
25,335,335,1,1,0,1,0
33,354,354,3,3,0,1,0
28,387,387,72,68,4,2,1
15,391,391,55,55,0,1,0
32,401,401,19,12,7,2,1
4,401,401,33,33,0,1,0
23,407,407,44,26,18,3,2
22,416,416,80,80,0,1,0
31,425,425,46,46,0,1,0
34,428,428,31,31,0,1,0
5,442,442,3,3,0,1,0
14,487,487,31,31,0,1,0

33,109,109,17,17,0,1,0
34,138,138,10,5,5,2,1
35,180,180,33,6,27,2,1
2,181,181,38,26,12,2,1
25,184,184,6,6,0,1,0
5,209,209,13,13,0,1,0
11,219,219,17,5,12,4,3
22,219,219,37,37,0,1,0
7,246,246,57,57,0,1,0
14,257,257,34,1,33,2,1
16,275,275,10,1,9,3,2
10,281,281,30,12,18,4,3
21,284,284,51,51,0,1,0
4,291,291,6,6,0,1,0
13,299,299,3,3,0,1,0
1,307,307,90,90,0,1,0
20,307,307,5,5,0,1,0
17,308,308,27,1,26,2,1
0,329,329,1,1,0,1,0
8,350,350,40,27,13,2,1
32,356,356,74,48,26,3,2
31,359,359,10,10,0,1,0
18,363,363,58,58,0,1,0
23,387,387,51,51,0,1,0
28,395,395,24,24,0,1,0
6,399,399,14,14,0,1,0
15,402,402,2,2,0,1,0
19,402,402,4,4,0,1,0
24,406,406,9,9,0,1,0
26,408,408,4,4,0,1,0
3,415,415,43,43,0,1,0
29,430,430,2,2,0,1,0
30,438,438,146,109,37,3,2
9,439,439,3,3,0,1,0
27,440,440,48,34,14,2,1
12,451,451,3,3,0,1,0

2,106,106,4,1,3,2,1
21,107,107,1,1,0,1,0
31,110,110,20,20,0,1,0
6,113,113,2,2,0,1,0
3,121,121,1,1,0,1,0
24,132,132,11,8,3,2,1
11,136,136,4,4,0,1,0
33,153,153,4,4,0,1,0
18,161,161,18,18,0,1,0
30,166,166,2,2,0,1,0
4,167,167,13,13,0,1,0
26,193,193,36,20,16,2,1
28,195,195,15,15,0,1,0
22,232,232,27,27,0,1,0
13,240,240,5,5,0,1,0
25,242,242,5,5,0,1,0
37,293,293,9,9,0,1,0
36,301,301,14,14,0,1,0
20,326,326,1,1,0,1,0
14,331,331,18,1,17,2,1
32,339,339,6,6,0,1,0
0,353,353,51,37,14,3,2
23,361,361,5,5,0,1,0
27,361,361,32,32,0,1,0
12,383,383,6,1,5,2,1
35,385,385,90,90,0,1,0
38,396,396,44,26,18,2,1
5,402,402,23,7,16,3,2
34,408,408,144,108,36,2,1
17,412,412,20,13,7,2,1
9,416,416,3,3,0,1,0
1,429,429,56,30,26,3,2
8,449,449,31,31,0,1,0
7,454,454,90,50,40,3,2
39,462,462,111,28,83,4,3
19,468,468,113,71,42,3,2
29,476,476,3,3,0,1,0
10,477,477,90,90,0,1,0
16,482,482,16,16,0,1,0
15,488,488,39,39,0,1,0

3,116,116,1,1,0,1,0
17,119,119,1,1,0,1,0
30,147,147,35,35,0,1,0
27,174,174,1,1,0,1,0
4,189,189,33,33,0,1,0
0,196,196,20,20,0,1,0
35,207,207,7,7,0,1,0
18,230,230,3,3,0,1,0
12,259,259,16,16,0,1,0
1,261,261,14,14,0,1,0
13,269,269,15,12,3,2,1
25,289,289,17,17,0,1,0
21,292,292,4,4,0,1,0
11,313,313,21,6,15,4,3
23,318,318,13,6,7,2,1
32,321,321,54,35,19,2,1
2,332,332,2,2,0,1,0
29,332,332,57,37,20,2,1
20,360,360,11,4,7,2,1
5,370,370,1,1,0,1,0
26,371,371,76,34,42,2,1
24,377,377,110,16,94,3,2
16,377,377,69,69,0,1,0
34,382,382,13,4,9,4,3
6,387,387,175,49,126,4,3
31,393,393,45,11,34,2,1
22,394,394,32,32,0,1,0
10,396,396,18,18,0,1,0
9,411,411,53,53,0,1,0
14,440,440,21,8,13,2,1
33,447,447,32,32,0,1,0
7,461,461,36,20,16,3,2
8,469,469,98,80,18,4,3
28,479,479,41,4,37,2,1
19,480,480,40,30,10,3,2
15,497,497,3,3,0,1,0

4,113,113,8,8,0,1,0
3,144,144,21,11,10,2,1
9,146,146,4,1,3,2,1
12,150,150,19,3,16,2,1
17,176,176,31,19,12,2,1
20,187,187,15,15,0,1,0
29,192,192,3,3,0,1,0
22,211,211,28,28,0,1,0
5,217,217,45,36,9,4,3
16,218,218,15,10,5,2,1
24,223,223,8,5,3,2,1
15,225,225,6,3,3,2,1
30,226,226,10,4,6,3,2
13,236,236,5,5,0,1,0
32,239,239,100,100,0,1,0
33,243,243,16,16,0,1,0
18,278,278,7,2,5,2,1
28,293,293,2,2,0,1,0
23,332,332,19,9,10,3,2
27,346,346,34,14,20,2,1
1,349,349,19,1,18,4,3
6,352,352,68,68,0,1,0
2,374,374,15,15,0,1,0
21,379,379,64,64,0,1,0
14,380,380,50,2,48,3,2
31,385,385,51,51,0,1,0
34,390,390,15,15,0,1,0
8,405,405,37,13,24,2,1
26,412,412,14,1,13,2,1
19,420,420,127,81,46,4,3
10,436,436,50,50,0,1,0
25,447,447,30,30,0,1,0
0,466,466,5,5,0,1,0
11,466,466,1,1,0,1,0
7,484,484,95,95,0,1,0

18,120,120,4,4,0,1,0
4,123,123,1,1,0,1,0
34,125,125,2,2,0,1,0
2,140,140,23,23,0,1,0
1,144,144,17,17,0,1,0
8,146,146,3,3,0,1,0
27,156,156,2,2,0,1,0
37,168,168,7,7,0,1,0
3,179,179,11,4,7,2,1
24,194,194,6,6,0,1,0
15,212,212,5,1,4,2,1
36,215,215,14,14,0,1,0
20,231,231,3,3,0,1,0
28,247,247,13,13,0,1,0
11,262,262,26,7,19,2,1
14,263,263,26,17,9,4,3
30,272,272,14,7,7,2,1
6,276,276,6,6,0,1,0
13,301,301,15,15,0,1,0
33,309,309,16,16,0,1,0
12,317,317,55,5,50,3,2
38,321,321,56,23,33,4,3
21,323,323,40,40,0,1,0
26,327,327,88,60,28,2,1
17,344,344,109,85,24,4,3
32,347,347,47,19,28,3,2
35,353,353,5,2,3,2,1
7,357,357,21,21,0,1,0
31,357,357,29,6,23,3,2
23,393,393,48,48,0,1,0
9,407,407,1,1,0,1,0
5,420,420,56,3,53,3,2
10,420,420,19,2,17,2,1
29,433,433,71,34,37,2,1
25,434,434,41,41,0,1,0
16,439,439,12,12,0,1,0
22,455,455,163,66,97,4,3
19,463,463,32,5,27,4,3
0,465,465,18,4,14,3,2

27,130,130,3,3,0,1,0
12,145,145,1,1,0,1,0
34,150,150,2,2,0,1,0
14,155,155,1,1,0,1,0
11,158,158,11,11,0,1,0
3,161,161,8,4,4,2,1
28,163,163,14,7,7,2,1
32,168,168,26,26,0,1,0
25,195,195,29,3,26,3,2
30,207,207,11,11,0,1,0
21,219,219,6,6,0,1,0
17,228,228,18,2,16,2,1
0,230,230,1,1,0,1,0
4,234,234,10,3,7,2,1
5,267,267,34,14,20,3,2
31,278,278,10,1,9,4,3
23,289,289,10,10,0,1,0
15,291,291,8,3,5,2,1
20,298,298,82,82,0,1,0
18,304,304,3,3,0,1,0
9,306,306,21,6,15,2,1
19,357,357,107,107,0,1,0
10,362,362,47,47,0,1,0
13,372,372,39,1,38,2,1
8,385,385,52,49,3,2,1
29,396,396,16,10,6,3,2
16,397,397,152,84,68,4,3
24,402,402,52,10,42,3,2
7,406,406,12,12,0,1,0
6,434,434,163,82,81,4,3
22,450,450,84,56,28,3,2
1,453,453,1,1,0,1,0
26,481,481,16,16,0,1,0
33,482,482,88,22,66,4,3
2,491,491,29,4,25,2,1

24,102,102,1,1,0,1,0
23,107,107,5,5,0,1,0
3,129,129,8,8,0,1,0
11,132,132,1,1,0,1,0
35,151,151,22,22,0,1,0
14,167,167,14,14,0,1,0
38,194,194,7,3,4,2,1
15,195,195,1,1,0,1,0
18,201,201,85,85,0,1,0
26,203,203,42,17,25,2,1
28,206,206,108,75,33,2,1
1,209,209,2,2,0,1,0
4,228,228,1,1,0,1,0
25,241,241,75,39,36,3,2
34,279,279,1,1,0,1,0
0,293,293,16,1,15,4,3
19,309,309,22,8,14,3,2
31,311,311,27,19,8,3,2
33,333,333,4,4,0,1,0
6,340,340,4,4,0,1,0
13,349,349,34,24,10,2,1
22,365,365,71,2,69,4,3
36,367,367,3,3,0,1,0
10,408,408,5,5,0,1,0
5,408,408,20,2,18,3,2
12,413,413,13,13,0,1,0
2,418,418,3,3,0,1,0
9,423,423,11,8,3,2,1
16,435,435,12,12,0,1,0
21,437,437,68,25,43,3,2
8,452,452,53,45,8,2,1
32,457,457,14,5,9,2,1
30,459,459,2,2,0,1,0
20,461,461,82,82,0,1,0
7,464,464,78,31,47,3,2
17,469,469,46,46,0,1,0
37,473,473,3,3,0,1,0
27,486,486,45,45,0,1,0
29,486,486,12,7,5,2,1

20,109,109,2,2,0,1,0
5,129,129,9,9,0,1,0
31,129,129,2,2,0,1,0
26,150,150,1,1,0,1,0
8,152,152,21,21,0,1,0
28,172,172,24,24,0,1,0
9,174,174,6,6,0,1,0
2,180,180,5,2,3,2,1
21,218,218,2,2,0,1,0
27,236,236,1,1,0,1,0
32,263,263,18,8,10,3,2
1,270,270,25,25,0,1,0
11,270,270,1,1,0,1,0
30,275,275,12,7,5,2,1
15,286,286,46,46,0,1,0
13,294,294,1,1,0,1,0
10,299,299,13,4,9,2,1
36,299,299,7,3,4,2,1
18,310,310,11,3,8,2,1
3,320,320,5,1,4,2,1
39,329,329,26,1,25,2,1
24,333,333,27,27,0,1,0
0,337,337,59,9,50,3,2
37,344,344,7,7,0,1,0
17,344,344,67,28,39,2,1
19,365,365,139,24,115,4,3
33,382,382,198,87,111,4,3
35,392,392,41,13,28,3,2
16,393,393,9,5,4,2,1
14,394,394,1,1,0,1,0
4,399,399,9,9,0,1,0
7,402,402,16,16,0,1,0
23,410,410,10,10,0,1,0
34,422,422,154,137,17,2,1
38,430,430,32,32,0,1,0
25,433,433,63,46,17,2,1
22,443,443,11,2,9,4,3
6,444,444,37,37,0,1,0
29,449,449,5,1,4,2,1
12,470,470,48,48,0,1,0

21,118,118,4,4,0,1,0
11,121,121,4,4,0,1,0
8,148,148,7,7,0,1,0
19,155,155,28,28,0,1,0
25,160,160,12,7,5,2,1
31,182,182,9,9,0,1,0
1,184,184,5,5,0,1,0
15,190,190,32,5,27,4,3
4,200,200,21,21,0,1,0
18,222,222,67,49,18,3,2
3,228,228,31,2,29,2,1
0,257,257,43,18,25,2,1
10,269,269,27,27,0,1,0
26,281,281,37,37,0,1,0
2,285,285,126,9,117,4,3
14,292,292,5,5,0,1,0
29,314,314,19,8,11,2,1
16,346,346,28,4,24,2,1
23,348,348,19,19,0,1,0
28,353,353,6,6,0,1,0
30,373,373,30,30,0,1,0
32,389,389,37,37,0,1,0
24,392,392,73,27,46,3,2
20,406,406,74,14,60,3,2
7,409,409,8,2,6,3,2
5,410,410,95,67,28,2,1
12,416,416,44,16,28,2,1
17,438,438,37,29,8,3,2
22,450,450,47,47,0,1,0
13,456,456,44,30,14,3,2
27,464,464,7,7,0,1,0
9,470,470,1,1,0,1,0
6,496,496,1,1,0,1,0

15,101,101,13,5,8,3,2
14,111,111,22,22,0,1,0
13,133,133,4,1,3,2,1
35,169,169,6,6,0,1,0
20,182,182,5,5,0,1,0
29,213,213,49,49,0,1,0
11,215,215,2,2,0,1,0
19,239,239,69,69,0,1,0
30,252,252,12,12,0,1,0
18,260,260,4,4,0,1,0
26,266,266,39,39,0,1,0
22,270,270,40,10,30,3,2
27,292,292,38,38,0,1,0
5,296,296,39,17,22,3,2
32,329,329,12,12,0,1,0
1,335,335,35,7,28,3,2
6,351,351,1,1,0,1,0
17,354,354,24,24,0,1,0
0,357,357,5,5,0,1,0
31,373,373,15,15,0,1,0
36,374,374,3,3,0,1,0
21,384,384,68,14,54,4,3
10,388,388,38,19,19,2,1
9,389,389,1,1,0,1,0
24,392,392,75,55,20,3,2
2,392,392,29,11,18,4,3
28,425,425,58,2,56,3,2
7,434,434,41,2,39,2,1
16,436,436,14,14,0,1,0
23,442,442,20,8,12,4,3
8,442,442,47,5,42,4,3
4,449,449,38,34,4,2,1
12,452,452,75,9,66,4,3
34,464,464,13,4,9,2,1
3,476,476,25,25,0,1,0
25,494,494,60,50,10,2,1
33,498,498,85,85,0,1,0

2,134,134,1,1,0,1,0
11,135,135,1,1,0,1,0
20,136,136,19,19,0,1,0
26,138,138,1,1,0,1,0
16,142,142,10,3,7,2,1
21,165,165,49,49,0,1,0
4,193,193,70,70,0,1,0
7,205,205,37,37,0,1,0
22,219,219,2,2,0,1,0
5,253,253,18,18,0,1,0
19,265,265,25,25,0,1,0
1,270,270,46,16,30,3,2
15,294,294,11,6,5,2,1
17,312,312,53,53,0,1,0
12,319,319,12,12,0,1,0
8,346,346,98,23,75,3,2
23,351,351,3,3,0,1,0
14,362,362,58,24,34,3,2
24,366,366,80,80,0,1,0
10,370,370,56,56,0,1,0
6,410,410,19,7,12,4,3
0,438,438,24,13,11,4,3
3,438,438,156,156,0,1,0
9,453,453,76,28,48,4,3
25,455,455,15,15,0,1,0
18,477,477,29,29,0,1,0
13,492,492,115,14,101,4,3

16,110,110,37,37,0,1,0
7,129,129,14,14,0,1,0
14,130,130,59,59,0,1,0
8,135,135,11,5,6,3,2
10,153,153,12,12,0,1,0
3,157,157,9,3,6,3,2
15,184,184,36,24,12,3,2
23,210,210,53,10,43,4,3
2,211,211,1,1,0,1,0
9,219,219,9,9,0,1,0
26,240,240,35,35,0,1,0
21,249,249,95,59,36,4,3
30,250,250,19,12,7,2,1
22,264,264,5,5,0,1,0
6,265,265,2,2,0,1,0
17,280,280,4,4,0,1,0
0,312,312,75,46,29,2,1
25,313,313,11,11,0,1,0
4,324,324,35,35,0,1,0
28,328,328,1,1,0,1,0
20,329,329,49,49,0,1,0
18,348,348,8,8,0,1,0
11,367,367,16,9,7,2,1
13,383,383,1,1,0,1,0
31,396,396,13,13,0,1,0
19,442,442,17,17,0,1,0
29,449,449,3,3,0,1,0
24,450,450,18,18,0,1,0
27,457,457,37,37,0,1,0
32,464,464,43,43,0,1,0
5,478,478,3,3,0,1,0
12,495,495,127,77,50,2,1
1,498,498,7,4,3,2,1

8,109,109,18,6,12,3,2
4,118,118,8,3,5,2,1
9,133,133,2,2,0,1,0
28,145,145,7,7,0,1,0
19,149,149,9,1,8,3,2
25,151,151,39,27,12,2,1
20,153,153,8,3,5,2,1
29,159,159,39,1,38,2,1
23,177,177,23,5,18,2,1
18,181,181,19,16,3,2,1
22,201,201,28,28,0,1,0
7,234,234,7,7,0,1,0
2,239,239,74,74,0,1,0
0,247,247,24,24,0,1,0
17,249,249,1,1,0,1,0
21,268,268,32,32,0,1,0
34,290,290,13,13,0,1,0
32,300,300,73,25,48,2,1
27,318,318,25,25,0,1,0
16,333,333,1,1,0,1,0
31,335,335,23,1,22,3,2
33,350,350,8,8,0,1,0
26,351,351,10,10,0,1,0
1,357,357,39,39,0,1,0
13,357,357,97,97,0,1,0
10,358,358,11,11,0,1,0
24,359,359,15,15,0,1,0
6,363,363,1,1,0,1,0
14,395,395,38,11,27,2,1
3,419,419,13,1,12,3,2
30,458,458,25,1,24,2,1
11,476,476,54,54,0,1,0
15,478,478,55,55,0,1,0
12,487,487,24,18,6,3,2
5,497,497,95,43,52,3,2

10,119,119,13,13,0,1,0
26,127,127,5,5,0,1,0
13,132,132,21,3,18,2,1
9,138,138,36,10,26,3,2
12,145,145,13,9,4,2,1
14,152,152,5,2,3,2,1
29,164,164,53,19,34,2,1
18,198,198,31,31,0,1,0
2,211,211,13,13,0,1,0
4,228,228,17,4,13,2,1
0,232,232,2,2,0,1,0
32,237,237,10,10,0,1,0
39,241,241,80,38,42,2,1
16,250,250,16,16,0,1,0
5,256,256,21,8,13,2,1
8,261,261,59,59,0,1,0
25,273,273,11,5,6,2,1
19,311,311,6,6,0,1,0
3,314,314,3,3,0,1,0
33,323,323,25,1,24,4,3
30,334,334,36,18,18,3,2
27,335,335,6,1,5,2,1
34,361,361,11,11,0,1,0
17,374,374,17,5,12,4,3
21,378,378,4,4,0,1,0
35,382,382,17,3,14,3,2
6,390,390,16,9,7,2,1
23,391,391,31,31,0,1,0
31,393,393,12,12,0,1,0
28,399,399,7,7,0,1,0
7,408,408,24,10,14,3,2
22,419,419,33,33,0,1,0
24,442,442,193,193,0,1,0
36,453,453,3,3,0,1,0
38,453,453,29,29,0,1,0
37,464,464,16,1,15,2,1
1,469,469,12,4,8,2,1
20,477,477,17,12,5,2,1
11,483,483,24,18,6,2,1
15,483,483,1,1,0,1,0

16,107,107,13,1,12,4,3
37,116,116,7,7,0,1,0
11,123,123,20,20,0,1,0
35,125,125,4,4,0,1,0
34,129,129,12,12,0,1,0
1,138,138,22,12,10,3,2
8,141,141,5,5,0,1,0
15,149,149,5,5,0,1,0
36,164,164,5,5,0,1,0
22,171,171,1,1,0,1,0
9,186,186,1,1,0,1,0
5,195,195,1,1,0,1,0
31,197,197,1,1,0,1,0
3,198,198,4,4,0,1,0
10,207,207,15,15,0,1,0
32,212,212,4,4,0,1,0
13,224,224,39,35,4,2,1
28,230,230,17,1,16,2,1
30,250,250,5,5,0,1,0
25,254,254,14,14,0,1,0
17,263,263,41,29,12,3,2
4,290,290,11,6,5,2,1
7,301,301,45,38,7,2,1
26,327,327,42,6,36,3,2
14,334,334,68,47,21,4,3
20,339,339,6,6,0,1,0
0,340,340,8,3,5,2,1
24,350,350,28,6,22,3,2
21,381,381,162,135,27,2,1
33,402,402,93,43,50,3,2
18,414,414,42,6,36,3,2
23,415,415,59,59,0,1,0
2,420,420,10,5,5,2,1
27,425,425,85,85,0,1,0
6,443,443,7,3,4,2,1
29,476,476,69,29,40,3,2
19,485,485,85,85,0,1,0
12,490,490,3,3,0,1,0

10,104,104,17,5,12,4,3
30,104,104,19,1,18,2,1
17,110,110,1,1,0,1,0
15,115,115,3,3,0,1,0
20,121,121,1,1,0,1,0
27,132,132,48,8,40,4,3
3,146,146,13,1,12,2,1
32,152,152,30,22,8,2,1
5,154,154,8,4,4,2,1
34,154,154,24,24,0,1,0
6,170,170,24,6,18,2,1
37,176,176,5,1,4,2,1
2,207,207,3,3,0,1,0
35,212,212,38,6,32,2,1
14,224,224,16,6,10,2,1
26,242,242,5,5,0,1,0
33,255,255,31,31,0,1,0
13,260,260,29,4,25,2,1
28,262,262,26,14,12,3,2
38,262,262,41,21,20,2,1
7,265,265,4,4,0,1,0
24,266,266,4,4,0,1,0
4,278,278,78,47,31,2,1
22,289,289,14,14,0,1,0
16,289,289,1,1,0,1,0
23,312,312,9,9,0,1,0
19,327,327,31,28,3,2,1
25,344,344,2,2,0,1,0
31,362,362,23,23,0,1,0
36,362,362,19,10,9,4,3
1,366,366,106,18,88,3,2
8,374,374,24,24,0,1,0
21,378,378,20,5,15,4,3
12,404,404,16,8,8,3,2
18,418,418,4,1,3,2,1
29,434,434,12,12,0,1,0
0,441,441,8,8,0,1,0
9,490,490,30,15,15,4,3
11,491,491,42,12,30,4,3

30,103,103,13,13,0,1,0
22,134,134,40,40,0,1,0
15,136,136,5,5,0,1,0
5,138,138,8,8,0,1,0
4,145,145,10,6,4,2,1
27,166,166,16,16,0,1,0
26,180,180,23,23,0,1,0
1,198,198,18,18,0,1,0
14,202,202,8,2,6,2,1
37,202,202,1,1,0,1,0
13,206,206,7,7,0,1,0
11,226,226,4,4,0,1,0
21,227,227,38,17,21,2,1
38,250,250,15,2,13,2,1
40,259,259,31,18,13,2,1
2,261,261,21,21,0,1,0
36,295,295,58,30,28,3,2
20,300,300,7,7,0,1,0
16,300,300,5,5,0,1,0
32,304,304,21,1,20,3,2
7,310,310,38,38,0,1,0
23,313,313,17,17,0,1,0
17,315,315,35,35,0,1,0
6,328,328,3,3,0,1,0
31,352,352,83,47,36,4,3
34,367,367,22,1,21,2,1
25,390,390,69,13,56,3,2
33,392,392,21,21,0,1,0
0,394,394,26,6,20,2,1
19,400,400,53,53,0,1,0
9,424,424,25,19,6,3,2
18,428,428,27,4,23,2,1
10,434,434,34,34,0,1,0
28,437,437,39,10,29,3,2
12,440,440,11,11,0,1,0
24,448,448,24,18,6,2,1
8,453,453,18,1,17,4,3
29,460,460,10,4,6,3,2
39,466,466,41,8,33,4,3
35,475,475,74,74,0,1,0
3,485,485,4,1,3,2,1

8,116,116,3,3,0,1,0
25,127,127,4,4,0,1,0
14,135,135,3,3,0,1,0
3,153,153,3,3,0,1,0
11,162,162,19,19,0,1,0
23,209,209,29,29,0,1,0
20,210,210,14,14,0,1,0
1,219,219,7,7,0,1,0
6,226,226,72,72,0,1,0
24,246,246,25,1,24,3,2
26,269,269,31,31,0,1,0
21,269,269,180,180,0,1,0
12,277,277,11,11,0,1,0
22,277,277,18,12,6,3,2
13,286,286,80,80,0,1,0
28,317,317,29,1,28,2,1
19,346,346,3,3,0,1,0
16,378,378,25,25,0,1,0
17,382,382,3,3,0,1,0
2,385,385,33,33,0,1,0
30,387,387,23,23,0,1,0
7,398,398,102,102,0,1,0
5,399,399,14,14,0,1,0
27,407,407,22,22,0,1,0
15,420,420,43,43,0,1,0
10,442,442,106,13,93,4,3
0,447,447,22,8,14,2,1
29,452,452,37,37,0,1,0
9,455,455,85,57,28,3,2
4,459,459,8,8,0,1,0
18,492,492,23,8,15,2,1

13,102,102,1,1,0,1,0
3,103,103,2,2,0,1,0
31,107,107,30,12,18,2,1
33,150,150,11,11,0,1,0
17,150,150,33,33,0,1,0
14,151,151,19,4,15,2,1
11,151,151,4,1,3,2,1
8,200,200,3,3,0,1,0
19,201,201,10,10,0,1,0
24,210,210,7,7,0,1,0
15,231,231,40,40,0,1,0
25,248,248,5,5,0,1,0
18,248,248,18,18,0,1,0
23,265,265,32,32,0,1,0
0,270,270,6,6,0,1,0
7,272,272,3,3,0,1,0
30,308,308,16,16,0,1,0
27,312,312,28,28,0,1,0
26,317,317,46,11,35,2,1
21,325,325,7,4,3,2,1
20,337,337,33,33,0,1,0
29,338,338,79,79,0,1,0
2,398,398,14,2,12,4,3
16,404,404,102,99,3,2,1
4,411,411,11,11,0,1,0
28,412,412,21,21,0,1,0
9,415,415,28,28,0,1,0
10,419,419,67,30,37,3,2
1,432,432,136,136,0,1,0
5,436,436,55,2,53,4,3
22,458,458,55,45,10,4,3
6,483,483,139,18,121,4,3
12,485,485,13,13,0,1,0
32,493,493,25,25,0,1,0

18,101,101,19,19,0,1,0
24,104,104,8,8,0,1,0
12,133,133,3,3,0,1,0
30,133,133,7,2,5,2,1
33,138,138,30,30,0,1,0
25,141,141,16,16,0,1,0
13,145,145,26,26,0,1,0
31,147,147,4,4,0,1,0
15,148,148,14,14,0,1,0
26,158,158,26,26,0,1,0
14,183,183,14,3,11,2,1
10,205,205,10,10,0,1,0
0,223,223,9,3,6,2,1
7,224,224,3,3,0,1,0
4,225,225,88,22,66,3,2
23,228,228,8,8,0,1,0
5,229,229,5,5,0,1,0
20,233,233,11,2,9,2,1
35,233,233,14,4,10,2,1
28,239,239,5,5,0,1,0
1,240,240,9,3,6,2,1
17,256,256,1,1,0,1,0
8,274,274,10,3,7,2,1
19,277,277,22,22,0,1,0
27,282,282,92,92,0,1,0
11,308,308,30,30,0,1,0
34,314,314,31,31,0,1,0
22,320,320,7,7,0,1,0
6,339,339,71,71,0,1,0
2,345,345,47,42,5,2,1
21,375,375,32,32,0,1,0
3,400,400,24,24,0,1,0
29,417,417,70,70,0,1,0
32,425,425,60,24,36,2,1
9,437,437,12,12,0,1,0
16,482,482,10,5,5,2,1

14,101,101,4,4,0,1,0
26,103,103,3,3,0,1,0
27,118,118,27,27,0,1,0
3,144,144,32,12,20,3,2
25,151,151,30,30,0,1,0
24,167,167,77,77,0,1,0
6,174,174,17,3,14,2,1
12,176,176,16,16,0,1,0
8,200,200,7,7,0,1,0
21,204,204,21,11,10,3,2
4,214,214,17,17,0,1,0
9,222,222,5,5,0,1,0
18,233,233,13,13,0,1,0
13,244,244,45,45,0,1,0
17,247,247,13,13,0,1,0
16,249,249,8,8,0,1,0
0,249,249,11,11,0,1,0
1,257,257,126,92,34,2,1
10,262,262,10,10,0,1,0
15,310,310,5,5,0,1,0
7,318,318,22,5,17,2,1
2,330,330,113,62,51,4,3
19,336,336,5,5,0,1,0
11,350,350,20,8,12,3,2
22,380,380,19,1,18,4,3
20,390,390,25,25,0,1,0
5,465,465,122,41,81,4,3
23,499,499,28,28,0,1,0

21,102,102,15,15,0,1,0
31,107,107,5,5,0,1,0
3,112,112,5,5,0,1,0
20,116,116,8,8,0,1,0
33,118,118,8,1,7,2,1
39,139,139,19,8,11,2,1
0,149,149,20,12,8,2,1
12,187,187,1,1,0,1,0
2,191,191,2,2,0,1,0
5,192,192,15,15,0,1,0
26,212,212,37,37,0,1,0
1,240,240,1,1,0,1,0
15,252,252,3,3,0,1,0
9,254,254,4,4,0,1,0
24,260,260,9,1,8,2,1
17,274,274,8,8,0,1,0
41,278,278,14,14,0,1,0
16,296,296,3,3,0,1,0
22,313,313,2,2,0,1,0
32,316,316,25,9,16,2,1
4,319,319,25,7,18,2,1
29,321,321,12,12,0,1,0
10,334,334,18,18,0,1,0
11,352,352,1,1,0,1,0
38,352,352,7,3,4,2,1
7,368,368,12,3,9,3,2
37,374,374,66,28,38,3,2
6,378,378,19,2,17,2,1
23,378,378,109,40,69,4,3
34,400,400,77,32,45,4,3
27,410,410,140,140,0,1,0
25,416,416,1,1,0,1,0
35,418,418,63,35,28,2,1
14,422,422,21,21,0,1,0
18,436,436,53,53,0,1,0
13,447,447,1,1,0,1,0
36,455,455,34,34,0,1,0
19,455,455,183,90,93,4,3
28,463,463,13,2,11,4,3
30,480,480,54,54,0,1,0
40,495,495,17,17,0,1,0
8,498,498,10,6,4,2,1

20,144,144,16,16,0,1,0
14,157,157,19,15,4,2,1
18,192,192,9,9,0,1,0
26,196,196,26,26,0,1,0
17,209,209,43,43,0,1,0
7,221,221,92,38,54,4,3
2,227,227,21,16,5,2,1
27,235,235,12,4,8,2,1
0,259,259,85,85,0,1,0
4,265,265,75,23,52,3,2
6,279,279,16,16,0,1,0
12,294,294,1,1,0,1,0
13,312,312,70,70,0,1,0
21,312,312,21,14,7,2,1
19,317,317,49,49,0,1,0
22,321,321,27,27,0,1,0
15,325,325,16,16,0,1,0
25,343,343,30,3,27,4,3
9,346,346,44,1,43,2,1
23,347,347,40,14,26,2,1
3,357,357,41,41,0,1,0
1,374,374,24,16,8,3,2
10,386,386,24,24,0,1,0
16,421,421,79,43,36,4,3
11,421,421,2,2,0,1,0
8,460,460,68,33,35,2,1
24,481,481,43,16,27,4,3
5,485,485,4,1,3,2,1

20,156,156,52,30,22,3,2
8,168,168,8,5,3,2,1
2,179,179,40,40,0,1,0
9,183,183,6,6,0,1,0
0,193,193,17,17,0,1,0
7,197,197,32,32,0,1,0
29,197,197,69,69,0,1,0
30,208,208,2,2,0,1,0
12,219,219,21,9,12,4,3
14,224,224,10,10,0,1,0
22,241,241,1,1,0,1,0
13,245,245,45,45,0,1,0
21,255,255,18,18,0,1,0
27,269,269,11,11,0,1,0
4,269,269,109,79,30,2,1
6,290,290,59,59,0,1,0
17,299,299,2,2,0,1,0
19,379,379,1,1,0,1,0
23,392,392,55,55,0,1,0
18,404,404,63,30,33,4,3
26,404,404,20,20,0,1,0
24,405,405,11,6,5,2,1
28,409,409,166,84,82,3,2
5,410,410,32,32,0,1,0
10,429,429,1,1,0,1,0
25,431,431,36,17,19,2,1
16,432,432,4,4,0,1,0
11,453,453,6,1,5,2,1
15,455,455,1,1,0,1,0
1,461,461,66,66,0,1,0
3,465,465,10,10,0,1,0

2,104,104,1,1,0,1,0
19,119,119,32,32,0,1,0
1,145,145,3,3,0,1,0
30,153,153,1,1,0,1,0
13,154,154,23,23,0,1,0
9,157,157,11,6,5,2,1
26,161,161,16,16,0,1,0
22,183,183,20,3,17,2,1
4,200,200,10,10,0,1,0
38,213,213,9,9,0,1,0
14,219,219,6,6,0,1,0
28,224,224,2,2,0,1,0
0,230,230,2,2,0,1,0
21,231,231,3,3,0,1,0
35,231,231,54,38,16,3,2
34,232,232,24,24,0,1,0
3,244,244,51,51,0,1,0
20,253,253,1,1,0,1,0
40,255,255,5,5,0,1,0
24,255,255,39,39,0,1,0
31,274,274,13,1,12,2,1
29,280,280,12,4,8,3,2
6,283,283,9,9,0,1,0
18,286,286,7,7,0,1,0
36,288,288,8,8,0,1,0
32,296,296,47,9,38,2,1
27,305,305,12,12,0,1,0
11,307,307,17,17,0,1,0
33,310,310,33,33,0,1,0
16,321,321,61,9,52,3,2
12,342,342,32,8,24,3,2
8,372,372,28,12,16,2,1
23,388,388,21,21,0,1,0
25,400,400,139,139,0,1,0
15,401,401,15,10,5,2,1
7,418,418,13,7,6,2,1
10,419,419,21,21,0,1,0
37,439,439,74,35,39,2,1
39,452,452,59,32,27,3,2
5,469,469,30,30,0,1,0
17,489,489,27,15,12,3,2

15,115,115,16,3,13,2,1
7,124,124,1,1,0,1,0
22,124,124,14,4,10,3,2
14,131,131,6,2,4,2,1
12,131,131,13,13,0,1,0
34,138,138,1,1,0,1,0
17,144,144,4,4,0,1,0
21,161,161,1,1,0,1,0
9,162,162,30,30,0,1,0
3,193,193,23,1,22,3,2
27,195,195,1,1,0,1,0
28,222,222,92,37,55,4,3
31,255,255,4,4,0,1,0
23,272,272,4,4,0,1,0
6,277,277,91,91,0,1,0
24,289,289,34,9,25,4,3
19,311,311,2,2,0,1,0
16,312,312,3,3,0,1,0
32,313,313,21,9,12,4,3
1,321,321,6,6,0,1,0
5,329,329,5,5,0,1,0
18,331,331,18,18,0,1,0
20,356,356,17,17,0,1,0
13,357,357,14,9,5,2,1
30,359,359,11,11,0,1,0
8,366,366,13,1,12,3,2
11,372,372,23,23,0,1,0
25,379,379,31,22,9,2,1
33,397,397,94,94,0,1,0
2,419,419,81,81,0,1,0
29,447,447,135,135,0,1,0
10,449,449,27,27,0,1,0
0,467,467,102,20,82,4,3
4,483,483,21,21,0,1,0
26,486,486,82,82,0,1,0
35,497,497,47,47,0,1,0

14,103,103,18,18,0,1,0
9,103,103,4,4,0,1,0
2,108,108,4,4,0,1,0
23,114,114,4,4,0,1,0
30,116,116,21,11,10,2,1
28,121,121,18,18,0,1,0
31,122,122,12,9,3,2,1
15,131,131,44,2,42,3,2
17,132,132,4,4,0,1,0
11,133,133,15,15,0,1,0
10,151,151,34,34,0,1,0
24,171,171,22,22,0,1,0
3,179,179,6,6,0,1,0
13,200,200,21,21,0,1,0
21,244,244,2,2,0,1,0
25,245,245,56,18,38,3,2
1,249,249,31,31,0,1,0
0,253,253,21,8,13,2,1
8,254,254,14,14,0,1,0
16,273,273,33,33,0,1,0
4,276,276,9,9,0,1,0
32,337,337,5,5,0,1,0
20,346,346,48,27,21,4,3
18,351,351,6,6,0,1,0
27,353,353,17,17,0,1,0
29,382,382,16,8,8,2,1
19,401,401,149,119,30,4,3
7,415,415,14,14,0,1,0
26,420,420,39,39,0,1,0
33,440,440,30,8,22,2,1
12,451,451,47,47,0,1,0
6,461,461,17,17,0,1,0
22,485,485,37,7,30,2,1
5,497,497,24,24,0,1,0

27,127,127,22,22,0,1,0
13,129,129,1,1,0,1,0
31,138,138,1,1,0,1,0
2,142,142,4,1,3,2,1
11,142,142,14,14,0,1,0
34,164,164,12,12,0,1,0
7,189,189,44,22,22,2,1
1,193,193,6,6,0,1,0
0,207,207,13,13,0,1,0
5,212,212,38,27,11,2,1
16,215,215,20,1,19,3,2
25,224,224,30,30,0,1,0
24,225,225,35,35,0,1,0
23,232,232,10,10,0,1,0
30,235,235,102,102,0,1,0
28,265,265,7,7,0,1,0
9,276,276,34,34,0,1,0
6,278,278,54,54,0,1,0
33,286,286,12,12,0,1,0
20,287,287,7,3,4,2,1
15,288,288,4,4,0,1,0
8,290,290,13,13,0,1,0
14,315,315,12,12,0,1,0
3,316,316,35,9,26,2,1
10,350,350,7,7,0,1,0
22,360,360,43,43,0,1,0
35,371,371,16,1,15,2,1
19,374,374,37,20,17,2,1
18,387,387,8,2,6,2,1
4,405,405,32,32,0,1,0
12,409,409,43,34,9,3,2
17,409,409,49,11,38,3,2
29,415,415,1,1,0,1,0
21,449,449,67,19,48,3,2
26,480,480,73,73,0,1,0
32,481,481,14,8,6,2,1
36,490,490,60,60,0,1,0

9,101,101,16,4,12,4,3
22,106,106,15,4,11,2,1
0,115,115,6,6,0,1,0
29,119,119,1,1,0,1,0
30,145,145,16,7,9,4,3
23,146,146,25,25,0,1,0
16,161,161,10,4,6,2,1
8,184,184,9,9,0,1,0
26,184,184,29,29,0,1,0
19,185,185,6,6,0,1,0
6,186,186,56,56,0,1,0
1,190,190,10,4,6,2,1
5,245,245,11,6,5,2,1
21,296,296,22,2,20,2,1
24,297,297,28,24,4,2,1
27,299,299,3,3,0,1,0
10,300,300,54,16,38,3,2
28,317,317,12,12,0,1,0
4,321,321,24,1,23,2,1
7,335,335,7,7,0,1,0
25,382,382,41,13,28,3,2
2,382,382,17,17,0,1,0
12,414,414,35,21,14,3,2
18,428,428,132,132,0,1,0
11,447,447,63,15,48,2,1
17,452,452,31,31,0,1,0
3,463,463,177,125,52,3,2
20,467,467,32,32,0,1,0
15,469,469,35,15,20,3,2
13,469,469,54,16,38,2,1
14,494,494,106,16,90,4,3

4,107,107,34,34,0,1,0
24,110,110,8,8,0,1,0
8,111,111,1,1,0,1,0
1,112,112,12,3,9,2,1
2,148,148,4,4,0,1,0
25,164,164,13,4,9,4,3
11,174,174,4,4,0,1,0
17,188,188,30,2,28,3,2
0,198,198,10,1,9,4,3
20,233,233,10,4,6,3,2
3,238,238,5,5,0,1,0
26,249,249,44,44,0,1,0
29,258,258,7,7,0,1,0
23,267,267,15,6,9,2,1
13,275,275,3,3,0,1,0
30,286,286,3,3,0,1,0
5,297,297,7,7,0,1,0
22,303,303,36,10,26,3,2
31,313,313,9,9,0,1,0
34,323,323,188,188,0,1,0
19,334,334,2,2,0,1,0
7,350,350,85,85,0,1,0
12,357,357,21,8,13,2,1
15,369,369,19,15,4,2,1
6,384,384,35,30,5,2,1
27,389,389,3,3,0,1,0
10,390,390,9,3,6,3,2
28,405,405,13,4,9,2,1
9,412,412,31,31,0,1,0
16,429,429,12,12,0,1,0
32,445,445,122,82,40,3,2
21,461,461,34,34,0,1,0
33,480,480,22,22,0,1,0
14,488,488,187,148,39,4,3
18,497,497,52,5,47,2,1

7,147,147,3,3,0,1,0
1,165,165,5,1,4,2,1
0,166,166,78,37,41,4,3
25,174,174,8,8,0,1,0
10,179,179,1,1,0,1,0
6,191,191,38,29,9,4,3
20,192,192,19,19,0,1,0
8,200,200,10,10,0,1,0
4,219,219,23,23,0,1,0
30,223,223,10,2,8,2,1
22,230,230,34,34,0,1,0
31,239,239,11,5,6,3,2
9,261,261,6,6,0,1,0
5,303,303,10,1,9,4,3
27,315,315,1,1,0,1,0
16,337,337,73,43,30,2,1
19,342,342,4,1,3,2,1
21,345,345,2,2,0,1,0
18,353,353,152,28,124,4,3
14,371,371,27,27,0,1,0
15,391,391,12,12,0,1,0
29,392,392,39,39,0,1,0
3,405,405,104,20,84,3,2
11,410,410,66,66,0,1,0
13,412,412,6,6,0,1,0
23,434,434,1,1,0,1,0
26,437,437,56,12,44,3,2
17,457,457,52,6,46,4,3
24,469,469,96,16,80,3,2
28,477,477,46,9,37,2,1
2,489,489,21,21,0,1,0
12,495,495,108,73,35,4,3

10,104,104,8,8,0,1,0
11,113,113,9,9,0,1,0
21,114,114,4,4,0,1,0
27,126,126,3,3,0,1,0
1,132,132,8,8,0,1,0
12,144,144,6,6,0,1,0
30,146,146,10,10,0,1,0
29,151,151,3,3,0,1,0
4,153,153,17,17,0,1,0
19,160,160,2,2,0,1,0
26,178,178,29,5,24,3,2
7,185,185,7,7,0,1,0
8,195,195,24,24,0,1,0
23,223,223,11,11,0,1,0
9,224,224,54,54,0,1,0
25,229,229,96,96,0,1,0
2,230,230,106,35,71,4,3
13,236,236,29,22,7,2,1
5,241,241,3,3,0,1,0
18,252,252,16,16,0,1,0
15,317,317,15,15,0,1,0
28,351,351,80,80,0,1,0
0,370,370,88,88,0,1,0
3,374,374,23,23,0,1,0
17,380,380,17,17,0,1,0
20,401,401,22,6,16,3,2
6,453,453,15,7,8,2,1
24,457,457,49,49,0,1,0
14,461,461,100,100,0,1,0
22,469,469,48,15,33,4,3
16,498,498,44,44,0,1,0

14,102,102,5,5,0,1,0
3,105,105,2,2,0,1,0
23,113,113,16,16,0,1,0
11,121,121,21,21,0,1,0
21,140,140,9,9,0,1,0
4,158,158,9,9,0,1,0
34,204,204,73,73,0,1,0
20,224,224,18,18,0,1,0
32,230,230,18,18,0,1,0
35,255,255,7,7,0,1,0
29,256,256,9,9,0,1,0
24,258,258,40,40,0,1,0
13,259,259,24,8,16,2,1
7,278,278,1,1,0,1,0
8,284,284,2,2,0,1,0
33,301,301,8,8,0,1,0
31,307,307,41,22,19,2,1
0,311,311,23,9,14,2,1
12,323,323,5,5,0,1,0
30,350,350,122,11,111,4,3
10,357,357,10,3,7,2,1
6,376,376,46,46,0,1,0
2,378,378,54,37,17,2,1
28,380,380,15,3,12,3,2
19,384,384,6,2,4,2,1
1,392,392,143,57,86,3,2
15,393,393,47,47,0,1,0
26,394,394,35,35,0,1,0
27,400,400,33,33,0,1,0
18,405,405,52,46,6,3,2
9,422,422,68,26,42,4,3
25,422,422,14,14,0,1,0
17,439,439,28,16,12,3,2
22,452,452,17,17,0,1,0
16,460,460,20,16,4,2,1
5,470,470,9,2,7,2,1
36,491,491,5,2,3,2,1

14,122,122,27,27,0,1,0
8,123,123,56,56,0,1,0
20,127,127,6,6,0,1,0
11,142,142,1,1,0,1,0
26,156,156,11,11,0,1,0
18,160,160,4,4,0,1,0
23,170,170,5,5,0,1,0
30,263,263,58,58,0,1,0
5,279,279,13,1,12,2,1
12,286,286,10,10,0,1,0
19,297,297,10,10,0,1,0
25,313,313,18,18,0,1,0
3,323,323,1,1,0,1,0
29,332,332,61,61,0,1,0
1,353,353,11,11,0,1,0
24,355,355,98,90,8,3,2
7,359,359,22,13,9,4,3
17,361,361,17,17,0,1,0
4,362,362,11,4,7,2,1
27,365,365,8,1,7,2,1
6,368,368,3,3,0,1,0
2,374,374,1,1,0,1,0
28,420,420,34,34,0,1,0
13,423,423,7,3,4,2,1
15,429,429,59,59,0,1,0
10,440,440,250,178,72,3,2
9,441,441,172,172,0,1,0
16,451,451,30,30,0,1,0
22,453,453,2,2,0,1,0
21,466,466,103,36,67,4,3
0,476,476,22,12,10,3,2

2,102,102,7,7,0,1,0
34,103,103,2,2,0,1,0
37,110,110,40,40,0,1,0
32,117,117,11,5,6,2,1
5,133,133,1,1,0,1,0
28,144,144,11,5,6,3,2
24,153,153,8,8,0,1,0
40,154,154,10,10,0,1,0
25,159,159,9,9,0,1,0
30,167,167,14,14,0,1,0
38,174,174,25,20,5,2,1
35,194,194,12,2,10,4,3
23,198,198,3,3,0,1,0
14,203,203,1,1,0,1,0
16,234,234,27,2,25,3,2
19,238,238,18,18,0,1,0
18,252,252,1,1,0,1,0
0,258,258,20,15,5,2,1
41,274,274,49,49,0,1,0
10,278,278,85,3,82,3,2
42,283,283,10,2,8,3,2
6,300,300,24,24,0,1,0
15,302,302,19,1,18,2,1
31,303,303,2,2,0,1,0
21,323,323,7,7,0,1,0
27,330,330,27,27,0,1,0
7,342,342,11,11,0,1,0
39,373,373,8,8,0,1,0
29,375,375,104,56,48,4,3
9,379,379,42,42,0,1,0
8,382,382,2,2,0,1,0
36,391,391,8,8,0,1,0
12,396,396,69,37,32,3,2
1,400,400,20,4,16,3,2
20,408,408,12,3,9,2,1
17,417,417,27,11,16,3,2
22,423,423,19,10,9,2,1
3,423,423,29,29,0,1,0
33,449,449,15,7,8,3,2
26,452,452,81,15,66,3,2
13,453,453,3,3,0,1,0
11,458,458,9,9,0,1,0
4,490,490,72,72,0,1,0

26,101,101,17,17,0,1,0
29,121,121,5,2,3,2,1
13,136,136,10,1,9,4,3
16,137,137,3,3,0,1,0
19,141,141,31,21,10,2,1
17,152,152,6,6,0,1,0
27,161,161,35,5,30,3,2
31,171,171,1,1,0,1,0
14,189,189,23,23,0,1,0
5,193,193,7,7,0,1,0
25,199,199,3,3,0,1,0
30,209,209,22,22,0,1,0
24,219,219,32,26,6,3,2
2,220,220,41,33,8,3,2
28,227,227,38,16,22,4,3
12,276,276,107,19,88,3,2
0,296,296,1,1,0,1,0
18,301,301,57,57,0,1,0
7,312,312,4,4,0,1,0
32,315,315,46,8,38,3,2
11,332,332,45,45,0,1,0
22,332,332,1,1,0,1,0
1,360,360,41,16,25,2,1
8,367,367,24,16,8,2,1
9,371,371,7,7,0,1,0
3,376,376,18,18,0,1,0
23,382,382,39,22,17,2,1
20,391,391,3,3,0,1,0
10,399,399,78,35,43,3,2
6,419,419,33,12,21,4,3
21,436,436,70,49,21,4,3
15,451,451,68,14,54,4,3
4,478,478,35,29,6,2,1

27,109,109,5,1,4,2,1
11,120,120,15,15,0,1,0
29,126,126,4,4,0,1,0
21,129,129,4,4,0,1,0
17,133,133,32,24,8,3,2
7,149,149,11,11,0,1,0
20,158,158,14,8,6,2,1
5,177,177,31,16,15,3,2
28,190,190,8,8,0,1,0
31,195,195,17,5,12,4,3
23,238,238,4,4,0,1,0
18,239,239,7,7,0,1,0
19,239,239,94,94,0,1,0
0,264,264,43,30,13,2,1
15,270,270,6,6,0,1,0
16,274,274,6,6,0,1,0
3,277,277,67,34,33,2,1
2,297,297,38,38,0,1,0
14,303,303,26,26,0,1,0
9,305,305,56,12,44,3,2
1,327,327,18,2,16,2,1
22,330,330,7,1,6,2,1
25,380,380,144,100,44,3,2
30,393,393,16,16,0,1,0
10,398,398,43,6,37,4,3
8,417,417,106,36,70,3,2
6,435,435,20,20,0,1,0
4,437,437,14,14,0,1,0
12,457,457,6,6,0,1,0
24,470,470,19,19,0,1,0
26,487,487,104,104,0,1,0
13,489,489,9,4,5,2,1

28,100,100,6,6,0,1,0
30,107,107,13,13,0,1,0
19,135,135,13,13,0,1,0
2,138,138,7,7,0,1,0
23,149,149,3,3,0,1,0
26,150,150,42,42,0,1,0
9,161,161,4,4,0,1,0
12,162,162,25,10,15,4,3
24,195,195,8,2,6,2,1
3,204,204,3,3,0,1,0
35,213,213,6,6,0,1,0
20,229,229,10,10,0,1,0
32,232,232,22,10,12,2,1
6,281,281,7,7,0,1,0
18,294,294,10,10,0,1,0
29,295,295,36,36,0,1,0
27,298,298,55,55,0,1,0
10,303,303,55,55,0,1,0
11,304,304,8,8,0,1,0
5,306,306,50,40,10,2,1
4,328,328,6,6,0,1,0
33,328,328,6,6,0,1,0
21,333,333,3,3,0,1,0
0,342,342,68,68,0,1,0
8,359,359,30,30,0,1,0
25,362,362,55,29,26,3,2
16,374,374,73,73,0,1,0
1,379,379,2,2,0,1,0
13,395,395,20,20,0,1,0
22,397,397,42,42,0,1,0
31,446,446,17,10,7,2,1
15,452,452,49,25,24,3,2
14,465,465,102,63,39,4,3
17,466,466,25,25,0,1,0
34,483,483,163,163,0,1,0
7,495,495,46,27,19,2,1

18,118,118,6,6,0,1,0
26,140,140,55,23,32,2,1
0,148,148,8,8,0,1,0
15,162,162,19,19,0,1,0
22,185,185,8,8,0,1,0
24,190,190,11,1,10,2,1
14,199,199,7,4,3,2,1
21,202,202,11,1,10,3,2
30,203,203,11,1,10,3,2
28,222,222,26,5,21,4,3
13,231,231,7,7,0,1,0
16,233,233,16,16,0,1,0
27,238,238,12,4,8,2,1
17,248,248,9,9,0,1,0
1,252,252,52,52,0,1,0
7,287,287,10,4,6,2,1
19,296,296,24,24,0,1,0
12,302,302,22,22,0,1,0
10,307,307,2,2,0,1,0
3,327,327,68,14,54,4,3
5,351,351,196,146,50,2,1
2,353,353,3,3,0,1,0
6,371,371,44,12,32,2,1
8,376,376,119,29,90,3,2
23,382,382,19,11,8,2,1
25,388,388,101,44,57,3,2
9,399,399,12,12,0,1,0
20,441,441,80,29,51,4,3
4,482,482,24,2,22,2,1
11,483,483,4,1,3,2,1
29,496,496,42,42,0,1,0

5,132,132,24,24,0,1,0
26,141,141,1,1,0,1,0
1,159,159,12,12,0,1,0
2,172,172,1,1,0,1,0
11,173,173,5,2,3,2,1
16,188,188,22,22,0,1,0
29,244,244,35,35,0,1,0
20,248,248,2,2,0,1,0
9,260,260,21,9,12,2,1
8,267,267,70,62,8,3,2
12,271,271,17,17,0,1,0
21,273,273,3,3,0,1,0
4,288,288,13,7,6,2,1
23,290,290,4,4,0,1,0
25,296,296,5,5,0,1,0
17,316,316,34,34,0,1,0
0,317,317,24,24,0,1,0
10,321,321,45,4,41,4,3
3,359,359,26,13,13,2,1
13,360,360,1,1,0,1,0
15,399,399,5,5,0,1,0
19,401,401,80,58,22,3,2
27,409,409,126,126,0,1,0
7,431,431,95,95,0,1,0
24,452,452,1,1,0,1,0
22,458,458,178,64,114,4,3
18,481,481,51,51,0,1,0
14,484,484,130,130,0,1,0
6,496,496,224,111,113,4,3
28,500,500,6,2,4,2,1

29,106,106,10,10,0,1,0
25,108,108,16,16,0,1,0
35,109,109,2,2,0,1,0
0,112,112,1,1,0,1,0
21,136,136,2,2,0,1,0
28,149,149,2,2,0,1,0
13,186,186,18,18,0,1,0
26,191,191,40,40,0,1,0
12,220,220,6,1,5,2,1
24,230,230,18,4,14,2,1
34,231,231,20,20,0,1,0
30,250,250,7,7,0,1,0
38,266,266,5,5,0,1,0
9,300,300,18,18,0,1,0
1,310,310,22,22,0,1,0
6,313,313,61,39,22,2,1
3,313,313,19,13,6,3,2
10,329,329,52,52,0,1,0
14,333,333,40,40,0,1,0
22,343,343,40,40,0,1,0
7,345,345,3,3,0,1,0
2,346,346,20,20,0,1,0
17,360,360,61,47,14,3,2
27,369,369,29,29,0,1,0
15,376,376,126,50,76,3,2
23,377,377,3,3,0,1,0
31,383,383,35,35,0,1,0
33,404,404,63,39,24,3,2
20,410,410,32,32,0,1,0
37,413,413,60,29,31,2,1
16,418,418,13,6,7,2,1
32,429,429,36,8,28,3,2
36,453,453,164,122,42,2,1
5,459,459,22,4,18,3,2
19,467,467,38,24,14,3,2
4,479,479,4,4,0,1,0
8,481,481,2,2,0,1,0
11,489,489,23,11,12,2,1
18,495,495,10,2,8,2,1

6,100,100,8,2,6,3,2
22,112,112,22,22,0,1,0
27,122,122,2,2,0,1,0
7,178,178,33,11,22,2,1
31,180,180,18,18,0,1,0
11,186,186,1,1,0,1,0
10,224,224,39,13,26,2,1
20,232,232,22,22,0,1,0
35,254,254,45,45,0,1,0
16,260,260,31,5,26,4,3
26,269,269,57,57,0,1,0
5,295,295,20,10,10,3,2
34,312,312,25,9,16,3,2
23,318,318,63,7,56,3,2
0,318,318,9,9,0,1,0
28,319,319,2,2,0,1,0
8,327,327,42,32,10,2,1
18,328,328,79,79,0,1,0
2,345,345,6,3,3,2,1
17,352,352,3,3,0,1,0
24,352,352,71,47,24,4,3
33,356,356,7,4,3,2,1
1,370,370,24,9,15,2,1
32,389,389,7,7,0,1,0
29,401,401,49,35,14,3,2
36,416,416,7,1,6,3,2
3,416,416,9,9,0,1,0
12,424,424,48,29,19,2,1
4,426,426,19,9,10,3,2
30,432,432,100,83,17,3,2
19,454,454,52,19,33,2,1
9,458,458,33,26,7,2,1
14,458,458,21,13,8,3,2
13,466,466,1,1,0,1,0
15,486,486,81,81,0,1,0
21,490,490,15,2,13,4,3
25,499,499,4,4,0,1,0

37,130,130,3,3,0,1,0
24,150,150,4,4,0,1,0
16,167,167,7,4,3,2,1
4,170,170,5,1,4,2,1
5,204,204,1,1,0,1,0
0,209,209,12,2,10,2,1
3,213,213,11,6,5,2,1
26,241,241,39,17,22,3,2
28,243,243,66,27,39,2,1
17,257,257,29,3,26,3,2
7,273,273,27,11,16,4,3
14,280,280,21,6,15,2,1
21,284,284,23,19,4,2,1
11,290,290,20,12,8,3,2
25,308,308,26,26,0,1,0
22,315,315,8,8,0,1,0
10,318,318,27,27,0,1,0
31,318,318,51,51,0,1,0
15,320,320,29,5,24,2,1
8,334,334,32,32,0,1,0
33,349,349,10,10,0,1,0
32,373,373,44,22,22,2,1
6,373,373,37,2,35,2,1
9,381,381,42,36,6,2,1
13,382,382,16,16,0,1,0
18,385,385,164,29,135,4,3
23,401,401,33,33,0,1,0
30,422,422,16,6,10,3,2
27,426,426,102,36,66,3,2
29,430,430,21,2,19,2,1
19,440,440,41,23,18,4,3
1,441,441,3,3,0,1,0
2,445,445,1,1,0,1,0
12,466,466,24,24,0,1,0
34,467,467,9,9,0,1,0
20,472,472,27,27,0,1,0
36,477,477,138,91,47,3,2
35,480,480,12,4,8,2,1

12,110,110,10,10,0,1,0
6,111,111,1,1,0,1,0
13,120,120,8,3,5,2,1
9,195,195,15,2,13,2,1
31,201,201,45,45,0,1,0
4,225,225,24,18,6,3,2
10,225,225,2,2,0,1,0
29,229,229,2,2,0,1,0
24,237,237,40,40,0,1,0
11,245,245,7,1,6,2,1
1,247,247,1,1,0,1,0
0,251,251,12,3,9,2,1
21,269,269,20,20,0,1,0
32,271,271,80,62,18,2,1
23,279,279,9,9,0,1,0
20,283,283,7,4,3,2,1
28,289,289,12,12,0,1,0
22,289,289,29,13,16,3,2
17,292,292,42,42,0,1,0
15,296,296,50,50,0,1,0
26,349,349,22,2,20,3,2
7,367,367,26,11,15,4,3
19,379,379,29,1,28,4,3
16,382,382,73,37,36,4,3
25,384,384,39,27,12,2,1
33,389,389,122,122,0,1,0
30,397,397,2,2,0,1,0
18,419,419,6,6,0,1,0
14,425,425,71,31,40,4,3
5,430,430,73,38,35,3,2
3,439,439,75,75,0,1,0
27,477,477,20,12,8,2,1
8,483,483,123,123,0,1,0
2,488,488,34,34,0,1,0

27,113,113,17,9,8,2,1
3,115,115,21,21,0,1,0
5,118,118,22,3,19,2,1
26,162,162,13,10,3,2,1
16,173,173,8,8,0,1,0
7,180,180,16,16,0,1,0
25,184,184,38,5,33,4,3
2,195,195,7,3,4,2,1
23,220,220,35,7,28,2,1
10,222,222,73,25,48,2,1
19,231,231,4,4,0,1,0
18,239,239,22,7,15,4,3
24,272,272,44,44,0,1,0
28,281,281,29,29,0,1,0
4,314,314,110,38,72,4,3
15,335,335,29,26,3,2,1
11,346,346,45,15,30,3,2
1,349,349,40,4,36,2,1
0,364,364,18,6,12,2,1
8,401,401,51,6,45,2,1
9,402,402,34,13,21,2,1
14,408,408,22,22,0,1,0
6,422,422,10,3,7,3,2
17,424,424,34,34,0,1,0
13,449,449,26,14,12,2,1
12,454,454,25,25,0,1,0
21,455,455,99,60,39,2,1
20,482,482,53,29,24,3,2
22,486,486,26,3,23,2,1

32,113,113,2,2,0,1,0
5,122,122,2,2,0,1,0
1,125,125,15,12,3,2,1
28,135,135,3,3,0,1,0
0,145,145,12,1,11,2,1
14,187,187,8,1,7,2,1
6,201,201,4,4,0,1,0
17,224,224,51,9,42,3,2
3,242,242,42,42,0,1,0
8,246,246,33,33,0,1,0
2,257,257,79,46,33,4,3
9,273,273,5,2,3,2,1
11,330,330,59,59,0,1,0
7,334,334,11,11,0,1,0
16,349,349,24,24,0,1,0
10,349,349,54,54,0,1,0
13,357,357,82,10,72,4,3
21,375,375,30,30,0,1,0
26,380,380,11,5,6,3,2
22,381,381,27,10,17,2,1
18,395,395,129,120,9,4,3
25,406,406,31,5,26,3,2
12,411,411,13,13,0,1,0
30,418,418,54,54,0,1,0
23,425,425,60,60,0,1,0
24,433,433,50,50,0,1,0
4,436,436,47,11,36,4,3
19,450,450,27,27,0,1,0
29,457,457,44,6,38,3,2
31,459,459,60,6,54,4,3
27,473,473,20,20,0,1,0
15,482,482,24,5,19,4,3
20,490,490,46,41,5,2,1

14,121,121,10,5,5,2,1
30,124,124,20,15,5,2,1
32,146,146,17,17,0,1,0
21,154,154,9,6,3,2,1
24,164,164,1,1,0,1,0
23,170,170,3,3,0,1,0
25,170,170,9,9,0,1,0
11,176,176,19,19,0,1,0
16,180,180,48,41,7,2,1
17,183,183,3,3,0,1,0
7,196,196,19,19,0,1,0
31,205,205,1,1,0,1,0
28,219,219,15,3,12,4,3
2,226,226,20,20,0,1,0
29,233,233,5,1,4,2,1
15,275,275,3,3,0,1,0
13,281,281,1,1,0,1,0
9,303,303,8,8,0,1,0
12,325,325,12,12,0,1,0
18,342,342,20,10,10,2,1
33,348,348,98,43,55,4,3
34,348,348,35,18,17,2,1
22,348,348,61,61,0,1,0
27,352,352,13,7,6,2,1
5,357,357,7,7,0,1,0
10,369,369,27,3,24,3,2
8,372,372,175,58,117,4,3
4,376,376,27,27,0,1,0
20,383,383,25,25,0,1,0
26,398,398,197,86,111,4,3
19,405,405,6,3,3,2,1
0,427,427,7,7,0,1,0
1,436,436,46,34,12,4,3
6,438,438,21,6,15,4,3
3,484,484,79,49,30,2,1

7,110,110,5,5,0,1,0
31,112,112,2,2,0,1,0
17,119,119,7,1,6,3,2
26,129,129,18,2,16,3,2
5,138,138,16,16,0,1,0
14,150,150,8,8,0,1,0
12,166,166,3,3,0,1,0
27,169,169,9,9,0,1,0
23,182,182,5,5,0,1,0
4,191,191,15,9,6,2,1
0,193,193,106,31,75,4,3
24,227,227,3,3,0,1,0
13,235,235,24,24,0,1,0
11,252,252,23,8,15,4,3
21,262,262,32,7,25,2,1
19,279,279,34,13,21,4,3
8,282,282,10,10,0,1,0
3,323,323,35,28,7,2,1
20,330,330,1,1,0,1,0
25,380,380,63,63,0,1,0
29,388,388,14,9,5,2,1
16,437,437,12,12,0,1,0
30,442,442,68,19,49,4,3
28,448,448,112,112,0,1,0
2,452,452,84,38,46,3,2
9,454,454,5,5,0,1,0
6,456,456,32,11,21,2,1
15,465,465,6,2,4,2,1
1,466,466,65,54,11,2,1
10,481,481,47,47,0,1,0
22,485,485,9,4,5,2,1
18,486,486,247,103,144,4,3

21,102,102,3,3,0,1,0
18,117,117,4,4,0,1,0
38,118,118,3,3,0,1,0
28,124,124,30,1,29,4,3
6,126,126,8,8,0,1,0
22,136,136,19,19,0,1,0
31,143,143,4,4,0,1,0
7,150,150,2,2,0,1,0
8,164,164,16,3,13,2,1
36,167,167,3,3,0,1,0
19,168,168,15,15,0,1,0
17,183,183,1,1,0,1,0
29,197,197,4,4,0,1,0
4,211,211,12,12,0,1,0
1,220,220,12,12,0,1,0
0,238,238,25,7,18,4,3
34,241,241,8,8,0,1,0
15,249,249,1,1,0,1,0
12,249,249,24,24,0,1,0
5,270,270,48,37,11,2,1
40,294,294,47,17,30,3,2
27,297,297,9,5,4,2,1
39,300,300,19,19,0,1,0
14,311,311,1,1,0,1,0
23,316,316,8,8,0,1,0
20,317,317,21,21,0,1,0
13,323,323,18,18,0,1,0
16,325,325,33,33,0,1,0
9,340,340,34,8,26,3,2
2,346,346,3,3,0,1,0
3,348,348,41,3,38,3,2
24,357,357,5,5,0,1,0
11,373,373,29,29,0,1,0
25,375,375,4,4,0,1,0
33,433,433,149,122,27,4,3
30,438,438,86,35,51,4,3
35,458,458,89,51,38,4,3
26,461,461,64,37,27,2,1
32,465,465,59,56,3,2,1
37,484,484,41,41,0,1,0
10,490,490,87,57,30,4,3

2,114,114,2,2,0,1,0
8,118,118,4,1,3,2,1
31,130,130,4,4,0,1,0
16,158,158,7,2,5,2,1
28,163,163,5,5,0,1,0
5,166,166,9,9,0,1,0
19,166,166,6,6,0,1,0
39,202,202,15,2,13,4,3
4,211,211,39,29,10,2,1
38,215,215,17,2,15,2,1
23,222,222,13,6,7,2,1
35,246,246,86,86,0,1,0
27,250,250,8,5,3,2,1
25,262,262,24,16,8,2,1
30,272,272,13,13,0,1,0
22,276,276,38,38,0,1,0
1,286,286,17,17,0,1,0
36,292,292,14,1,13,2,1
0,297,297,5,5,0,1,0
40,307,307,13,3,10,2,1
32,322,322,40,40,0,1,0
18,334,334,19,6,13,4,3
10,336,336,32,32,0,1,0
7,340,340,1,1,0,1,0
15,342,342,52,26,26,2,1
33,348,348,122,32,90,4,3
11,356,356,49,49,0,1,0
34,389,389,6,6,0,1,0
3,396,396,31,31,0,1,0
26,413,413,1,1,0,1,0
29,427,427,59,51,8,3,2
6,442,442,4,4,0,1,0
17,452,452,3,3,0,1,0
13,453,453,17,14,3,2,1
24,464,464,69,69,0,1,0
14,466,466,11,1,10,3,2
12,474,474,156,39,117,4,3
21,474,474,1,1,0,1,0
37,478,478,66,36,30,3,2
9,487,487,41,21,20,3,2
20,495,495,21,21,0,1,0

11,110,110,18,9,9,2,1
18,111,111,4,4,0,1,0
12,116,116,10,10,0,1,0
25,120,120,11,5,6,3,2
21,122,122,5,5,0,1,0
6,144,144,1,1,0,1,0
38,167,167,6,6,0,1,0
22,173,173,46,28,18,3,2
13,177,177,24,24,0,1,0
10,192,192,19,9,10,2,1
26,199,199,12,12,0,1,0
27,208,208,30,13,17,2,1
32,213,213,15,6,9,2,1
28,247,247,10,2,8,2,1
2,248,248,6,1,5,2,1
5,278,278,13,13,0,1,0
33,280,280,18,18,0,1,0
23,288,288,33,33,0,1,0
24,291,291,3,3,0,1,0
9,298,298,33,33,0,1,0
3,300,300,32,32,0,1,0
17,301,301,26,26,0,1,0
8,309,309,4,4,0,1,0
16,312,312,23,11,12,4,3
0,313,313,6,6,0,1,0
1,320,320,4,4,0,1,0
31,331,331,28,28,0,1,0
29,332,332,31,7,24,2,1
30,332,332,78,42,36,4,3
4,335,335,19,6,13,2,1
37,366,366,2,2,0,1,0
34,370,370,30,30,0,1,0
15,370,370,87,66,21,4,3
35,394,394,109,48,61,4,3
36,400,400,20,11,9,4,3
7,420,420,32,32,0,1,0
20,460,460,23,2,21,4,3
14,464,464,9,3,6,3,2
19,489,489,99,99,0,1,0

6,110,110,18,18,0,1,0
33,115,115,13,2,11,2,1
24,125,125,4,4,0,1,0
5,159,159,1,1,0,1,0
10,161,161,13,5,8,3,2
31,161,161,82,82,0,1,0
16,174,174,5,1,4,2,1
0,175,175,15,1,14,2,1
29,190,190,2,2,0,1,0
28,198,198,1,1,0,1,0
3,201,201,4,4,0,1,0
14,210,210,21,10,11,2,1
9,211,211,16,4,12,4,3
7,218,218,7,7,0,1,0
2,229,229,27,27,0,1,0
30,238,238,5,5,0,1,0
23,240,240,11,11,0,1,0
20,248,248,18,6,12,3,2
19,251,251,14,9,5,2,1
21,306,306,45,45,0,1,0
35,307,307,7,7,0,1,0
34,316,316,24,24,0,1,0
4,330,330,29,29,0,1,0
27,361,361,74,2,72,4,3
13,387,387,1,1,0,1,0
18,401,401,47,34,13,2,1
8,405,405,35,35,0,1,0
36,443,443,20,20,0,1,0
26,457,457,56,10,46,3,2
1,458,458,100,100,0,1,0
22,460,460,101,88,13,2,1
17,472,472,18,18,0,1,0
32,478,478,31,16,15,4,3
11,480,480,95,67,28,2,1
25,484,484,12,12,0,1,0
15,486,486,46,40,6,3,2
12,497,497,45,18,27,4,3

8,115,115,22,12,10,3,2
13,123,123,22,5,17,2,1
21,132,132,11,11,0,1,0
32,150,150,25,25,0,1,0
33,191,191,48,48,0,1,0
26,194,194,3,3,0,1,0
17,204,204,8,2,6,2,1
34,210,210,14,14,0,1,0
2,220,220,17,17,0,1,0
7,225,225,1,1,0,1,0
35,231,231,47,47,0,1,0
20,236,236,39,21,18,4,3
9,239,239,40,11,29,2,1
16,258,258,83,44,39,3,2
4,275,275,8,2,6,2,1
0,283,283,2,2,0,1,0
6,293,293,36,36,0,1,0
19,301,301,23,23,0,1,0
18,304,304,52,36,16,2,1
10,304,304,1,1,0,1,0
15,308,308,5,5,0,1,0
30,309,309,17,7,10,2,1
31,336,336,28,28,0,1,0
28,353,353,36,21,15,2,1
36,359,359,24,2,22,3,2
29,362,362,62,30,32,2,1
1,364,364,5,5,0,1,0
11,398,398,43,5,38,2,1
5,404,404,5,2,3,2,1
3,405,405,21,11,10,2,1
27,412,412,33,6,27,2,1
24,443,443,8,8,0,1,0
12,465,465,15,4,11,2,1
23,469,469,45,45,0,1,0
22,473,473,5,5,0,1,0
25,476,476,44,44,0,1,0
14,493,493,38,14,24,4,3

21,130,130,29,5,24,3,2
13,138,138,10,1,9,4,3
7,139,139,1,1,0,1,0
18,151,151,13,2,11,2,1
23,206,206,24,24,0,1,0
14,207,207,11,11,0,1,0
31,209,209,26,26,0,1,0
20,214,214,7,7,0,1,0
8,235,235,2,2,0,1,0
22,238,238,22,7,15,4,3
5,249,249,8,8,0,1,0
17,258,258,5,5,0,1,0
6,264,264,31,15,16,3,2
36,266,266,41,41,0,1,0
34,267,267,15,15,0,1,0
4,271,271,28,28,0,1,0
32,276,276,3,3,0,1,0
26,280,280,63,63,0,1,0
2,298,298,34,34,0,1,0
24,309,309,25,6,19,2,1
33,310,310,9,9,0,1,0
28,331,331,6,6,0,1,0
30,332,332,17,17,0,1,0
16,347,347,1,1,0,1,0
0,358,358,11,11,0,1,0
1,358,358,81,81,0,1,0
12,364,364,37,15,22,3,2
15,374,374,43,25,18,4,3
35,384,384,86,6,80,3,2
25,389,389,53,17,36,3,2
10,401,401,70,53,17,2,1
3,405,405,54,50,4,2,1
9,425,425,64,22,42,4,3
29,444,444,16,11,5,2,1
27,455,455,58,58,0,1,0
11,469,469,14,5,9,4,3
19,499,499,61,17,44,3,2

21,116,116,3,3,0,1,0
5,131,131,39,39,0,1,0
18,147,147,4,4,0,1,0
16,151,151,4,4,0,1,0
2,152,152,31,7,24,2,1
23,162,162,30,12,18,2,1
8,205,205,26,5,21,4,3
0,224,224,90,46,44,4,3
26,229,229,55,41,14,4,3
25,238,238,6,6,0,1,0
12,239,239,24,10,14,3,2
7,249,249,28,7,21,2,1
10,250,250,18,18,0,1,0
22,262,262,14,14,0,1,0
4,314,314,1,1,0,1,0
24,322,322,78,78,0,1,0
14,332,332,46,46,0,1,0
3,337,337,46,32,14,2,1
1,363,363,56,56,0,1,0
15,367,367,132,25,107,4,3
19,378,378,16,16,0,1,0
17,384,384,35,35,0,1,0
11,389,389,15,6,9,4,3
20,411,411,13,8,5,2,1
9,435,435,41,41,0,1,0
27,446,446,29,29,0,1,0
13,467,467,18,18,0,1,0
6,479,479,47,9,38,3,2

25,123,123,5,5,0,1,0
19,132,132,21,21,0,1,0
32,162,162,7,7,0,1,0
22,166,166,10,1,9,2,1
12,179,179,19,19,0,1,0
13,190,190,15,9,6,3,2
23,196,196,12,12,0,1,0
0,210,210,7,1,6,3,2
24,216,216,4,4,0,1,0
1,229,229,13,3,10,2,1
3,229,229,13,13,0,1,0
6,231,231,110,19,91,4,3
31,259,259,120,120,0,1,0
21,262,262,8,8,0,1,0
18,274,274,7,1,6,2,1
5,302,302,25,4,21,4,3
26,322,322,11,11,0,1,0
7,336,336,61,61,0,1,0
28,370,370,114,52,62,3,2
10,375,375,11,11,0,1,0
27,380,380,13,7,6,3,2
30,382,382,7,7,0,1,0
16,394,394,34,18,16,3,2
14,399,399,11,3,8,2,1
9,400,400,21,8,13,2,1
29,408,408,11,11,0,1,0
17,412,412,133,133,0,1,0
11,445,445,89,50,39,4,3
4,450,450,81,45,36,4,3
8,461,461,7,7,0,1,0
2,462,462,37,37,0,1,0
15,468,468,21,21,0,1,0
20,474,474,1,1,0,1,0

15,115,115,6,3,3,2,1
18,123,123,9,5,4,2,1
7,124,124,1,1,0,1,0
26,147,147,4,4,0,1,0
10,151,151,19,3,16,2,1
29,152,152,16,16,0,1,0
28,168,168,31,1,30,2,1
3,170,170,50,20,30,4,3
23,198,198,16,7,9,2,1
2,204,204,20,2,18,2,1
12,212,212,1,1,0,1,0
8,221,221,17,10,7,2,1
4,222,222,4,4,0,1,0
11,228,228,14,14,0,1,0
5,235,235,13,1,12,3,2
27,238,238,26,23,3,2,1
6,243,243,45,15,30,4,3
20,244,244,68,10,58,4,3
31,270,270,39,1,38,3,2
21,293,293,28,25,3,2,1
22,302,302,1,1,0,1,0
1,323,323,4,1,3,2,1
16,328,328,14,14,0,1,0
24,348,348,55,46,9,4,3
25,365,365,67,67,0,1,0
17,407,407,34,34,0,1,0
19,445,445,40,12,28,2,1
9,447,447,57,57,0,1,0
13,454,454,245,245,0,1,0
14,464,464,19,19,0,1,0
30,474,474,12,12,0,1,0
0,492,492,26,26,0,1,0

11,107,107,3,3,0,1,0
29,108,108,5,2,3,2,1
7,130,130,4,4,0,1,0
26,130,130,57,57,0,1,0
23,139,139,3,3,0,1,0
14,141,141,51,25,26,3,2
9,151,151,54,24,30,3,2
28,209,209,15,8,7,2,1
20,216,216,22,9,13,2,1
27,219,219,19,10,9,4,3
16,240,240,3,3,0,1,0
10,240,240,11,1,10,2,1
6,243,243,22,22,0,1,0
17,259,259,1,1,0,1,0
30,278,278,22,22,0,1,0
15,283,283,2,2,0,1,0
19,287,287,5,5,0,1,0
34,302,302,8,4,4,2,1
1,324,324,7,7,0,1,0
24,326,326,13,1,12,2,1
33,361,361,54,12,42,3,2
5,374,374,11,11,0,1,0
13,385,385,15,15,0,1,0
12,395,395,86,86,0,1,0
22,398,398,18,18,0,1,0
0,399,399,3,3,0,1,0
3,401,401,113,113,0,1,0
32,417,417,63,63,0,1,0
25,420,420,2,2,0,1,0
8,435,435,59,59,0,1,0
21,457,457,121,121,0,1,0
2,465,465,14,14,0,1,0
4,478,478,1,1,0,1,0
18,482,482,68,54,14,2,1
31,497,497,23,7,16,3,2

17,110,110,5,5,0,1,0
32,113,113,32,23,9,4,3
4,129,129,18,3,15,3,2
1,145,145,8,1,7,2,1
26,146,146,13,4,9,2,1
48,148,148,8,2,6,2,1
36,155,155,34,10,24,3,2
15,162,162,12,12,0,1,0
19,164,164,35,27,8,2,1
22,186,186,6,6,0,1,0
23,207,207,7,7,0,1,0
2,217,217,44,44,0,1,0
24,230,230,1,1,0,1,0
39,232,232,52,22,30,4,3
10,236,236,4,4,0,1,0
5,236,236,25,1,24,3,2
20,241,241,1,1,0,1,0
3,243,243,11,3,8,2,1
34,255,255,2,2,0,1,0
41,260,260,28,28,0,1,0
28,264,264,49,35,14,2,1
13,268,268,12,12,0,1,0
42,269,269,42,33,9,2,1
33,273,273,4,4,0,1,0
31,283,283,6,6,0,1,0
25,295,295,4,1,3,2,1
7,301,301,3,3,0,1,0
40,302,302,1,1,0,1,0
21,318,318,1,1,0,1,0
46,321,321,15,15,0,1,0
11,331,331,10,10,0,1,0
8,334,334,10,10,0,1,0
12,335,335,1,1,0,1,0
0,338,338,16,16,0,1,0
9,344,344,10,10,0,1,0
35,350,350,3,3,0,1,0
47,351,351,34,34,0,1,0
37,376,376,106,95,11,2,1
45,386,386,26,26,0,1,0
30,394,394,20,20,0,1,0
38,417,417,14,2,12,4,3
16,430,430,25,25,0,1,0
6,449,449,13,3,10,3,2
18,450,450,4,4,0,1,0
44,456,456,1,1,0,1,0
43,484,484,59,18,41,2,1
29,497,497,18,18,0,1,0
27,497,497,5,5,0,1,0
14,498,498,14,1,13,3,2

27,118,118,3,3,0,1,0
0,119,119,28,28,0,1,0
17,121,121,14,14,0,1,0
9,122,122,29,29,0,1,0
18,154,154,6,6,0,1,0
12,157,157,1,1,0,1,0
15,173,173,2,2,0,1,0
24,178,178,21,7,14,2,1
26,184,184,10,6,4,2,1
22,188,188,55,55,0,1,0
7,193,193,1,1,0,1,0
25,204,204,15,15,0,1,0
1,212,212,24,12,12,3,2
21,234,234,24,7,17,2,1
10,234,234,1,1,0,1,0
28,307,307,3,3,0,1,0
29,334,334,58,34,24,2,1
6,338,338,22,8,14,2,1
16,352,352,66,2,64,4,3
2,352,352,56,56,0,1,0
20,358,358,31,28,3,2,1
19,392,392,35,35,0,1,0
14,418,418,32,32,0,1,0
23,431,431,111,96,15,4,3
8,441,441,27,27,0,1,0
11,444,444,103,11,92,3,2
13,447,447,55,55,0,1,0
4,461,461,53,27,26,3,2
30,478,478,15,15,0,1,0
5,484,484,140,74,66,3,2
3,489,489,27,12,15,4,3

25,100,100,2,2,0,1,0
26,116,116,9,4,5,2,1
28,143,143,24,4,20,2,1
5,145,145,25,25,0,1,0
1,150,150,2,2,0,1,0
14,158,158,12,12,0,1,0
22,192,192,79,79,0,1,0
3,205,205,38,21,17,2,1
7,216,216,7,7,0,1,0
24,226,226,25,1,24,2,1
21,227,227,4,4,0,1,0
11,236,236,31,24,7,2,1
13,237,237,5,5,0,1,0
17,278,278,1,1,0,1,0
27,288,288,9,1,8,3,2
19,291,291,11,11,0,1,0
32,303,303,44,7,37,2,1
10,306,306,40,40,0,1,0
34,310,310,33,15,18,4,3
0,314,314,43,31,12,3,2
30,315,315,50,50,0,1,0
8,317,317,6,6,0,1,0
33,341,341,2,2,0,1,0
23,343,343,45,45,0,1,0
29,343,343,59,59,0,1,0
6,358,358,59,49,10,2,1
20,368,368,13,13,0,1,0
31,381,381,12,7,5,2,1
2,383,383,61,8,53,3,2
12,387,387,29,8,21,4,3
9,404,404,54,54,0,1,0
16,420,420,24,12,12,2,1
18,441,441,37,37,0,1,0
15,447,447,35,3,32,4,3
35,482,482,35,35,0,1,0
4,500,500,14,14,0,1,0

2,106,106,12,8,4,2,1
14,116,116,6,6,0,1,0
12,124,124,3,3,0,1,0
32,129,129,6,6,0,1,0
23,147,147,2,2,0,1,0
25,159,159,14,1,13,3,2
0,164,164,1,1,0,1,0
1,167,167,28,28,0,1,0
4,189,189,20,9,11,2,1
19,196,196,20,2,18,3,2
31,211,211,10,10,0,1,0
7,253,253,1,1,0,1,0
8,263,263,9,9,0,1,0
5,282,282,4,4,0,1,0
29,288,288,3,3,0,1,0
6,290,290,6,6,0,1,0
34,292,292,23,23,0,1,0
15,295,295,19,19,0,1,0
22,305,305,22,22,0,1,0
13,317,317,1,1,0,1,0
27,321,321,30,24,6,3,2
18,326,326,47,47,0,1,0
11,331,331,40,40,0,1,0
17,337,337,86,86,0,1,0
26,379,379,4,1,3,2,1
33,389,389,24,24,0,1,0
3,414,414,11,11,0,1,0
21,424,424,103,103,0,1,0
10,438,438,16,4,12,4,3
24,440,440,1,1,0,1,0
20,442,442,16,16,0,1,0
16,474,474,206,126,80,4,3
28,476,476,147,85,62,4,3
9,487,487,107,11,96,4,3
30,490,490,183,183,0,1,0

14,104,104,3,3,0,1,0
18,130,130,19,19,0,1,0
19,136,136,27,2,25,2,1
27,155,155,26,26,0,1,0
31,158,158,9,9,0,1,0
25,159,159,7,7,0,1,0
7,176,176,2,2,0,1,0
17,184,184,2,2,0,1,0
28,194,194,9,9,0,1,0
26,223,223,2,2,0,1,0
9,236,236,17,17,0,1,0
20,241,241,17,17,0,1,0
23,256,256,15,15,0,1,0
11,263,263,12,12,0,1,0
5,272,272,27,27,0,1,0
13,296,296,19,7,12,2,1
3,296,296,50,50,0,1,0
24,309,309,10,7,3,2,1
15,313,313,76,3,73,4,3
29,331,331,4,4,0,1,0
10,334,334,12,4,8,3,2
1,366,366,6,6,0,1,0
21,375,375,49,20,29,3,2
0,397,397,202,61,141,4,3
6,410,410,52,32,20,2,1
8,414,414,7,7,0,1,0
22,414,414,36,36,0,1,0
2,424,424,4,4,0,1,0
32,444,444,277,272,5,2,1
12,448,448,90,68,22,3,2
4,448,448,24,24,0,1,0
30,471,471,16,3,13,3,2
16,478,478,5,5,0,1,0

5,101,101,4,4,0,1,0
1,109,109,2,2,0,1,0
9,109,109,10,10,0,1,0
11,124,124,15,15,0,1,0
8,140,140,1,1,0,1,0
21,140,140,4,4,0,1,0
13,142,142,60,60,0,1,0
29,155,155,40,14,26,2,1
23,178,178,1,1,0,1,0
26,184,184,41,41,0,1,0
31,192,192,6,1,5,2,1
30,201,201,24,12,12,4,3
10,215,215,1,1,0,1,0
15,220,220,4,4,0,1,0
33,241,241,10,10,0,1,0
27,252,252,30,1,29,2,1
0,260,260,13,13,0,1,0
2,268,268,54,30,24,3,2
24,276,276,10,3,7,2,1
18,282,282,69,69,0,1,0
3,296,296,2,2,0,1,0
16,317,317,17,17,0,1,0
6,334,334,17,17,0,1,0
25,362,362,40,40,0,1,0
4,368,368,28,16,12,3,2
32,373,373,77,27,50,3,2
20,376,376,13,8,5,2,1
34,389,389,52,7,45,2,1
12,399,399,11,3,8,2,1
7,405,405,8,3,5,2,1
22,418,418,42,21,21,4,3
14,441,441,145,32,113,4,3
17,443,443,72,29,43,3,2
19,458,458,5,5,0,1,0
28,483,483,14,5,9,2,1

12,106,106,22,8,14,3,2
4,121,121,2,2,0,1,0
27,124,124,3,3,0,1,0
7,127,127,20,20,0,1,0
6,139,139,23,3,20,3,2
13,143,143,10,1,9,4,3
30,146,146,10,10,0,1,0
20,162,162,25,25,0,1,0
9,168,168,3,3,0,1,0
17,203,203,24,1,23,2,1
10,222,222,54,14,40,3,2
1,222,222,4,4,0,1,0
2,263,263,53,35,18,4,3
21,267,267,1,1,0,1,0
15,280,280,78,24,54,4,3
11,287,287,2,2,0,1,0
0,303,303,58,58,0,1,0
3,307,307,9,9,0,1,0
28,310,310,16,7,9,2,1
16,315,315,9,9,0,1,0
26,325,325,66,16,50,3,2
23,356,356,3,3,0,1,0
8,378,378,70,38,32,2,1
29,387,387,14,14,0,1,0
22,420,420,44,2,42,2,1
18,439,439,143,124,19,3,2
14,469,469,17,5,12,4,3
19,481,481,58,58,0,1,0
25,494,494,37,16,21,4,3
5,495,495,94,82,12,2,1
24,499,499,46,41,5,2,1

15,120,120,3,3,0,1,0
19,132,132,15,10,5,2,1
37,132,132,14,7,7,2,1
20,146,146,22,22,0,1,0
27,157,157,21,8,13,2,1
22,158,158,7,1,6,3,2
36,166,166,22,1,21,2,1
38,167,167,15,5,10,3,2
7,172,172,3,3,0,1,0
4,208,208,10,4,6,2,1
17,243,243,53,53,0,1,0
31,260,260,34,34,0,1,0
23,267,267,7,7,0,1,0
21,271,271,19,7,12,4,3
3,276,276,67,23,44,2,1
10,283,283,5,5,0,1,0
0,295,295,4,4,0,1,0
6,302,302,14,3,11,2,1
32,302,302,10,10,0,1,0
2,325,325,8,4,4,2,1
1,327,327,8,1,7,2,1
30,335,335,2,2,0,1,0
16,336,336,24,24,0,1,0
14,339,339,1,1,0,1,0
33,367,367,43,5,38,2,1
12,369,369,15,15,0,1,0
9,370,370,68,9,59,3,2
29,372,372,48,48,0,1,0
34,374,374,5,5,0,1,0
26,386,386,87,87,0,1,0
11,403,403,14,5,9,4,3
35,415,415,118,38,80,4,3
18,420,420,85,55,30,2,1
25,429,429,11,11,0,1,0
24,449,449,26,26,0,1,0
8,453,453,33,18,15,2,1
28,464,464,82,82,0,1,0
5,483,483,1,1,0,1,0
13,489,489,39,25,14,3,2

11,133,133,11,2,9,2,1
15,153,153,24,11,13,2,1
17,179,179,4,4,0,1,0
28,188,188,37,18,19,2,1
14,193,193,54,7,47,2,1
5,195,195,2,2,0,1,0
3,196,196,24,24,0,1,0
26,196,196,11,11,0,1,0
22,215,215,12,12,0,1,0
4,223,223,41,3,38,3,2
0,233,233,31,31,0,1,0
20,284,284,42,42,0,1,0
27,289,289,12,12,0,1,0
21,295,295,32,32,0,1,0
19,332,332,32,8,24,2,1
2,339,339,12,12,0,1,0
18,342,342,90,80,10,3,2
23,361,361,62,55,7,2,1
8,362,362,27,6,21,3,2
24,363,363,9,5,4,2,1
30,379,379,17,11,6,3,2
10,424,424,13,13,0,1,0
29,429,429,6,6,0,1,0
25,430,430,1,1,0,1,0
12,475,475,5,5,0,1,0
9,486,486,84,52,32,3,2
16,492,492,24,24,0,1,0
13,493,493,48,48,0,1,0
1,493,493,201,149,52,4,3
7,495,495,11,11,0,1,0
6,495,495,157,157,0,1,0

10,101,101,16,8,8,2,1
27,113,113,2,2,0,1,0
33,118,118,23,17,6,2,1
14,118,118,17,7,10,2,1
23,128,128,32,20,12,3,2
26,165,165,2,2,0,1,0
6,167,167,18,18,0,1,0
38,168,168,10,7,3,2,1
24,176,176,27,19,8,3,2
5,189,189,2,2,0,1,0
15,212,212,18,15,3,2,1
20,216,216,5,2,3,2,1
12,217,217,6,2,4,2,1
34,219,219,6,6,0,1,0
2,251,251,36,36,0,1,0
25,258,258,26,2,24,4,3
4,265,265,13,13,0,1,0
1,268,268,17,14,3,2,1
37,278,278,8,8,0,1,0
29,288,288,21,9,12,4,3
30,292,292,23,23,0,1,0
36,338,338,10,10,0,1,0
19,354,354,8,1,7,2,1
35,355,355,25,3,22,3,2
7,379,379,21,21,0,1,0
0,386,386,40,40,0,1,0
28,388,388,9,4,5,2,1
22,389,389,71,71,0,1,0
9,393,393,9,2,7,2,1
16,398,398,13,5,8,2,1
17,413,413,1,1,0,1,0
21,415,415,39,39,0,1,0
39,417,417,11,6,5,2,1
11,431,431,43,30,13,2,1
18,435,435,34,22,12,3,2
8,455,455,25,25,0,1,0
31,458,458,172,126,46,4,3
3,470,470,27,6,21,4,3
32,489,489,106,73,33,3,2
13,500,500,41,38,3,2,1

20,116,116,2,2,0,1,0
8,129,129,5,5,0,1,0
4,129,129,31,31,0,1,0
2,134,134,25,9,16,3,2
10,146,146,20,10,10,2,1
11,204,204,12,12,0,1,0
25,208,208,11,1,10,3,2
31,211,211,77,77,0,1,0
27,216,216,8,8,0,1,0
1,222,222,38,12,26,4,3
22,222,222,31,31,0,1,0
18,247,247,26,1,25,2,1
30,248,248,7,7,0,1,0
26,259,259,13,13,0,1,0
32,265,265,1,1,0,1,0
24,275,275,57,30,27,4,3
23,300,300,47,19,28,3,2
19,374,374,49,29,20,2,1
9,378,378,12,12,0,1,0
14,378,378,39,39,0,1,0
29,379,379,54,16,38,3,2
17,400,400,3,3,0,1,0
16,414,414,38,38,0,1,0
13,417,417,26,26,0,1,0
3,435,435,23,18,5,2,1
28,448,448,46,7,39,3,2
5,456,456,11,8,3,2,1
7,465,465,41,41,0,1,0
21,474,474,46,8,38,2,1
6,475,475,23,23,0,1,0
15,488,488,15,15,0,1,0
12,499,499,100,82,18,3,2
0,500,500,113,81,32,3,2

17,106,106,1,1,0,1,0
25,115,115,25,14,11,4,3
24,116,116,1,1,0,1,0
1,122,122,2,2,0,1,0
31,132,132,6,1,5,2,1
13,141,141,13,13,0,1,0
22,141,141,7,4,3,2,1
2,152,152,20,12,8,3,2
10,160,160,21,5,16,2,1
21,164,164,28,19,9,4,3
16,178,178,1,1,0,1,0
20,194,194,15,5,10,3,2
43,199,199,32,4,28,2,1
42,200,200,34,34,0,1,0
14,206,206,1,1,0,1,0
41,209,209,5,5,0,1,0
4,216,216,7,7,0,1,0
11,228,228,14,14,0,1,0
9,232,232,12,12,0,1,0
6,245,245,33,15,18,3,2
32,258,258,8,8,0,1,0
3,265,265,1,1,0,1,0
27,285,285,8,8,0,1,0
18,308,308,18,18,0,1,0
8,331,331,4,4,0,1,0
35,334,334,10,4,6,3,2
5,343,343,18,6,12,2,1
0,353,353,12,9,3,2,1
7,359,359,23,3,20,2,1
23,360,360,31,25,6,2,1
29,380,380,24,6,18,2,1
34,388,388,28,6,22,2,1
19,388,388,30,30,0,1,0
36,393,393,16,4,12,3,2
40,400,400,18,18,0,1,0
15,407,407,25,11,14,3,2
12,409,409,10,5,5,2,1
38,429,429,219,155,64,4,3
28,447,447,38,38,0,1,0
39,462,462,3,3,0,1,0
26,480,480,15,4,11,2,1
30,484,484,11,8,3,2,1
37,485,485,137,79,58,3,2
33,494,494,55,34,21,2,1

32,118,118,3,3,0,1,0
22,145,145,10,5,5,2,1
8,145,145,33,1,32,3,2
9,154,154,8,2,6,2,1
19,161,161,12,6,6,3,2
23,199,199,16,16,0,1,0
24,209,209,16,7,9,2,1
18,222,222,14,1,13,2,1
26,243,243,3,3,0,1,0
27,248,248,81,2,79,4,3
14,249,249,23,23,0,1,0
11,267,267,40,4,36,4,3
0,285,285,29,29,0,1,0
5,299,299,18,18,0,1,0
28,303,303,22,2,20,3,2
1,339,339,48,33,15,4,3
3,341,341,14,11,3,2,1
29,358,358,24,24,0,1,0
30,367,367,48,24,24,4,3
2,367,367,17,9,8,2,1
10,383,383,61,61,0,1,0
33,391,391,61,25,36,4,3
7,396,396,31,14,17,2,1
31,416,416,63,55,8,2,1
12,417,417,62,62,0,1,0
13,420,420,4,4,0,1,0
6,423,423,1,1,0,1,0
16,431,431,73,10,63,4,3
25,449,449,13,13,0,1,0
4,454,454,94,94,0,1,0
21,463,463,7,3,4,2,1
20,470,470,161,126,35,2,1
15,484,484,7,7,0,1,0
17,489,489,21,7,14,2,1

22,101,101,1,1,0,1,0
12,103,103,12,12,0,1,0
31,107,107,10,2,8,2,1
23,109,109,6,6,0,1,0
0,122,122,10,10,0,1,0
4,124,124,9,9,0,1,0
13,145,145,11,11,0,1,0
35,148,148,7,7,0,1,0
25,153,153,28,28,0,1,0
29,200,200,1,1,0,1,0
9,204,204,20,20,0,1,0
34,217,217,29,26,3,2,1
1,224,224,18,11,7,2,1
27,230,230,5,5,0,1,0
32,237,237,9,1,8,2,1
2,254,254,2,2,0,1,0
8,258,258,41,11,30,4,3
10,266,266,22,6,16,2,1
30,266,266,113,86,27,4,3
6,287,287,15,15,0,1,0
17,293,293,5,5,0,1,0
3,296,296,16,16,0,1,0
33,311,311,43,43,0,1,0
18,342,342,16,2,14,3,2
7,346,346,4,4,0,1,0
16,361,361,8,8,0,1,0
24,393,393,40,26,14,2,1
14,402,402,178,160,18,4,3
19,426,426,90,90,0,1,0
21,436,436,31,8,23,2,1
11,449,449,37,25,12,3,2
28,458,458,18,18,0,1,0
20,459,459,19,19,0,1,0
5,494,494,29,29,0,1,0
26,495,495,62,11,51,4,3
15,500,500,69,21,48,2,1

22,125,125,18,6,12,2,1
12,133,133,1,1,0,1,0
34,149,149,5,5,0,1,0
32,160,160,45,6,39,4,3
14,178,178,4,4,0,1,0
1,180,180,7,7,0,1,0
25,184,184,34,9,25,2,1
17,212,212,7,7,0,1,0
33,213,213,3,3,0,1,0
11,213,213,24,12,12,4,3
26,228,228,14,14,0,1,0
19,234,234,54,54,0,1,0
28,247,247,41,16,25,2,1
23,256,256,30,30,0,1,0
10,277,277,88,27,61,3,2
0,283,283,19,14,5,2,1
15,286,286,8,8,0,1,0
5,289,289,49,27,22,4,3
2,318,318,7,7,0,1,0
31,354,354,19,4,15,4,3
7,368,368,23,23,0,1,0
18,378,378,69,6,63,4,3
3,395,395,85,30,55,3,2
27,404,404,9,4,5,2,1
9,413,413,82,82,0,1,0
24,416,416,7,1,6,3,2
21,419,419,12,4,8,2,1
20,420,420,59,59,0,1,0
16,433,433,31,10,21,2,1
8,437,437,30,30,0,1,0
6,447,447,69,69,0,1,0
30,477,477,5,5,0,1,0
29,489,489,23,23,0,1,0
13,497,497,8,1,7,2,1
4,498,498,48,40,8,2,1

26,112,112,34,34,0,1,0
30,119,119,21,14,7,2,1
19,130,130,1,1,0,1,0
17,131,131,1,1,0,1,0
2,132,132,1,1,0,1,0
14,135,135,8,8,0,1,0
6,148,148,1,1,0,1,0
18,151,151,4,4,0,1,0
22,157,157,9,9,0,1,0
10,173,173,35,35,0,1,0
32,175,175,14,6,8,2,1
8,189,189,1,1,0,1,0
24,195,195,24,2,22,3,2
16,205,205,2,2,0,1,0
4,215,215,7,7,0,1,0
0,236,236,51,51,0,1,0
28,268,268,10,10,0,1,0
33,272,272,20,20,0,1,0
9,276,276,66,23,43,3,2
5,277,277,1,1,0,1,0
11,277,277,12,12,0,1,0
27,289,289,6,6,0,1,0
25,294,294,39,39,0,1,0
15,314,314,45,45,0,1,0
23,324,324,28,28,0,1,0
7,352,352,118,118,0,1,0
13,370,370,25,11,14,4,3
31,389,389,7,7,0,1,0
21,392,392,91,31,60,3,2
3,413,413,32,32,0,1,0
12,458,458,40,33,7,2,1
29,472,472,62,24,38,2,1
34,475,475,41,41,0,1,0
20,493,493,76,76,0,1,0
1,496,496,81,51,30,4,3

31,132,132,1,1,0,1,0
11,143,143,1,1,0,1,0
30,148,148,45,19,26,2,1
5,150,150,2,2,0,1,0
22,161,161,46,46,0,1,0
34,162,162,12,3,9,4,3
15,173,173,5,5,0,1,0
12,174,174,2,2,0,1,0
9,180,180,9,9,0,1,0
14,184,184,52,52,0,1,0
19,189,189,13,9,4,2,1
25,191,191,31,7,24,3,2
33,232,232,14,9,5,2,1
6,289,289,1,1,0,1,0
26,303,303,73,73,0,1,0
10,312,312,65,53,12,3,2
8,316,316,37,23,14,2,1
32,322,322,23,15,8,3,2
1,327,327,35,17,18,4,3
21,335,335,16,1,15,2,1
27,355,355,13,1,12,4,3
17,374,374,20,20,0,1,0
4,375,375,37,37,0,1,0
18,388,388,129,120,9,4,3
13,396,396,13,13,0,1,0
7,402,402,27,10,17,2,1
20,404,404,28,9,19,2,1
3,423,423,52,52,0,1,0
29,435,435,31,31,0,1,0
24,442,442,7,3,4,2,1
23,453,453,10,6,4,2,1
35,469,469,49,49,0,1,0
0,470,470,11,8,3,2,1
2,476,476,47,33,14,3,2
28,485,485,43,43,0,1,0
16,498,498,21,21,0,1,0

30,121,121,2,2,0,1,0
18,124,124,5,5,0,1,0
23,148,148,11,11,0,1,0
34,154,154,5,5,0,1,0
10,157,157,5,5,0,1,0
20,195,195,11,11,0,1,0
13,219,219,3,3,0,1,0
28,224,224,52,37,15,4,3
35,232,232,67,57,10,2,1
31,232,232,30,17,13,2,1
3,246,246,44,36,8,3,2
8,261,261,49,4,45,4,3
7,283,283,22,17,5,2,1
12,299,299,1,1,0,1,0
26,299,299,65,25,40,2,1
21,320,320,24,24,0,1,0
36,324,324,34,34,0,1,0
29,324,324,21,21,0,1,0
14,337,337,47,11,36,2,1
5,338,338,6,6,0,1,0
37,351,351,1,1,0,1,0
27,361,361,14,3,11,4,3
11,375,375,1,1,0,1,0
6,379,379,1,1,0,1,0
24,379,379,21,5,16,3,2
2,395,395,62,15,47,2,1
16,397,397,88,88,0,1,0
1,405,405,14,3,11,2,1
0,413,413,48,48,0,1,0
32,413,413,30,30,0,1,0
9,414,414,72,10,62,4,3
33,420,420,78,78,0,1,0
22,420,420,47,13,34,4,3
17,433,433,5,5,0,1,0
19,443,443,34,23,11,2,1
4,481,481,12,12,0,1,0
15,487,487,64,12,52,4,3
25,496,496,15,15,0,1,0

24,120,120,8,1,7,3,2
15,128,128,4,4,0,1,0
19,137,137,20,20,0,1,0
1,151,151,11,3,8,3,2
10,153,153,13,5,8,2,1
23,159,159,15,15,0,1,0
32,173,173,13,13,0,1,0
27,184,184,13,13,0,1,0
16,188,188,29,29,0,1,0
6,191,191,10,1,9,4,3
14,206,206,7,7,0,1,0
9,210,210,123,85,38,3,2
31,219,219,25,25,0,1,0
7,232,232,16,16,0,1,0
4,236,236,12,12,0,1,0
11,276,276,22,12,10,2,1
18,312,312,10,2,8,3,2
0,349,349,24,24,0,1,0
3,362,362,1,1,0,1,0
5,368,368,43,43,0,1,0
26,368,368,23,5,18,2,1
13,371,371,16,3,13,2,1
2,379,379,77,77,0,1,0
20,389,389,10,5,5,2,1
25,400,400,75,75,0,1,0
30,404,404,5,5,0,1,0
17,409,409,31,12,19,2,1
28,422,422,52,26,26,2,1
29,428,428,15,15,0,1,0
8,462,462,20,2,18,2,1
22,464,464,113,78,35,2,1
21,464,464,102,9,93,4,3
12,468,468,78,78,0,1,0

37,100,100,9,2,7,3,2
30,103,103,9,9,0,1,0
17,111,111,22,4,18,2,1
6,113,113,5,1,4,2,1
2,117,117,1,1,0,1,0
32,140,140,1,1,0,1,0
35,143,143,1,1,0,1,0
10,144,144,20,14,6,2,1
21,160,160,3,3,0,1,0
4,163,163,2,2,0,1,0
28,164,164,54,54,0,1,0
33,170,170,9,9,0,1,0
31,178,178,18,18,0,1,0
27,181,181,33,18,15,3,2
24,194,194,3,3,0,1,0
11,203,203,23,23,0,1,0
5,224,224,44,44,0,1,0
36,258,258,15,15,0,1,0
29,259,259,46,5,41,4,3
9,267,267,2,2,0,1,0
25,294,294,14,9,5,2,1
13,298,298,26,26,0,1,0
38,315,315,4,4,0,1,0
14,320,320,12,12,0,1,0
23,336,336,1,1,0,1,0
3,337,337,79,37,42,4,3
12,344,344,3,3,0,1,0
7,349,349,17,17,0,1,0
19,358,358,14,14,0,1,0
18,368,368,7,7,0,1,0
1,389,389,1,1,0,1,0
26,414,414,53,24,29,2,1
39,414,414,143,122,21,4,3
40,444,444,29,29,0,1,0
22,448,448,4,1,3,2,1
15,455,455,101,101,0,1,0
20,461,461,26,26,0,1,0
8,478,478,15,15,0,1,0
0,487,487,11,11,0,1,0
16,491,491,69,36,33,4,3
34,494,494,17,17,0,1,0

18,102,102,12,9,3,2,1
21,121,121,1,1,0,1,0
13,184,184,15,15,0,1,0
6,195,195,1,1,0,1,0
15,202,202,17,3,14,3,2
28,210,210,45,45,0,1,0
26,218,218,32,24,8,3,2
10,222,222,18,1,17,4,3
14,225,225,7,7,0,1,0
23,238,238,15,11,4,2,1
3,250,250,27,27,0,1,0
16,260,260,23,23,0,1,0
1,263,263,36,14,22,2,1
8,265,265,32,32,0,1,0
24,267,267,82,82,0,1,0
22,284,284,23,23,0,1,0
9,295,295,24,2,22,3,2
17,324,324,30,30,0,1,0
25,360,360,5,5,0,1,0
2,378,378,189,189,0,1,0
20,378,378,47,5,42,2,1
29,392,392,60,36,24,4,3
0,403,403,71,17,54,3,2
4,425,425,59,9,50,2,1
5,437,437,40,40,0,1,0
11,439,439,46,46,0,1,0
12,460,460,27,27,0,1,0
7,461,461,45,20,25,2,1
19,471,471,9,9,0,1,0
27,493,493,52,52,0,1,0

18,109,109,2,2,0,1,0
25,117,117,15,15,0,1,0
14,125,125,9,9,0,1,0
12,127,127,3,3,0,1,0
8,169,169,60,38,22,3,2
5,177,177,3,3,0,1,0
15,194,194,37,37,0,1,0
30,195,195,26,14,12,2,1
9,216,216,5,5,0,1,0
20,245,245,21,5,16,2,1
32,254,254,21,21,0,1,0
1,260,260,37,12,25,2,1
27,262,262,122,83,39,4,3
10,268,268,40,18,22,2,1
2,270,270,11,11,0,1,0
19,276,276,22,22,0,1,0
0,279,279,77,44,33,4,3
13,284,284,6,6,0,1,0
24,286,286,21,21,0,1,0
16,303,303,13,13,0,1,0
29,351,351,5,5,0,1,0
21,353,353,21,21,0,1,0
7,353,353,28,8,20,3,2
22,354,354,25,25,0,1,0
26,378,378,24,24,0,1,0
6,390,390,1,1,0,1,0
11,425,425,25,25,0,1,0
28,429,429,50,10,40,3,2
23,437,437,13,6,7,2,1
3,443,443,61,29,32,3,2
17,465,465,37,37,0,1,0
31,465,465,88,88,0,1,0
4,495,495,56,32,24,2,1

23,121,121,3,3,0,1,0
16,130,130,8,8,0,1,0
3,133,133,16,16,0,1,0
25,153,153,13,13,0,1,0
20,159,159,3,3,0,1,0
30,161,161,1,1,0,1,0
19,161,161,24,24,0,1,0
29,192,192,1,1,0,1,0
7,194,194,10,10,0,1,0
0,206,206,44,44,0,1,0
26,209,209,48,16,32,4,3
1,210,210,86,86,0,1,0
5,219,219,9,9,0,1,0
11,233,233,9,9,0,1,0
31,250,250,9,2,7,2,1
15,281,281,24,6,18,4,3
4,283,283,9,2,7,2,1
8,300,300,41,34,7,2,1
9,302,302,19,14,5,2,1
12,331,331,51,21,30,3,2
28,339,339,83,42,41,2,1
24,349,349,23,14,9,3,2
18,365,365,39,27,12,2,1
21,380,380,44,20,24,3,2
17,396,396,9,9,0,1,0
27,411,411,122,122,0,1,0
10,418,418,7,3,4,2,1
2,449,449,61,37,24,4,3
13,455,455,78,36,42,2,1
22,473,473,85,85,0,1,0
14,478,478,4,1,3,2,1
6,478,478,52,52,0,1,0

4,103,103,2,2,0,1,0
17,113,113,15,15,0,1,0
35,118,118,4,1,3,2,1
1,121,121,2,2,0,1,0
26,122,122,3,3,0,1,0
25,140,140,3,3,0,1,0
16,150,150,1,1,0,1,0
27,156,156,10,5,5,2,1
6,158,158,2,2,0,1,0
8,178,178,19,13,6,2,1
41,180,180,4,4,0,1,0
9,191,191,6,6,0,1,0
36,199,199,1,1,0,1,0
30,202,202,15,3,12,2,1
34,211,211,13,9,4,2,1
20,214,214,28,20,8,3,2
0,214,214,3,3,0,1,0
39,220,220,12,12,0,1,0
12,235,235,9,1,8,2,1
18,240,240,27,21,6,2,1
7,246,246,8,8,0,1,0
31,259,259,80,66,14,2,1
21,260,260,9,9,0,1,0
32,262,262,71,71,0,1,0
43,268,268,3,3,0,1,0
24,277,277,34,34,0,1,0
44,280,280,5,5,0,1,0
13,288,288,12,3,9,2,1
29,301,301,22,12,10,3,2
5,305,305,10,4,6,3,2
37,309,309,5,5,0,1,0
15,318,318,52,52,0,1,0
38,334,334,23,23,0,1,0
11,339,339,33,33,0,1,0
33,343,343,27,4,23,2,1
2,349,349,38,16,22,4,3
3,359,359,29,29,0,1,0
23,361,361,35,26,9,3,2
19,382,382,14,14,0,1,0
22,382,382,28,28,0,1,0
42,390,390,16,16,0,1,0
28,437,437,91,91,0,1,0
40,452,452,175,175,0,1,0
10,462,462,2,2,0,1,0
14,466,466,20,5,15,4,3

3,100,100,1,1,0,1,0
13,105,105,22,7,15,2,1
25,122,122,1,1,0,1,0
9,142,142,7,7,0,1,0
14,147,147,23,13,10,2,1
1,173,173,26,26,0,1,0
18,191,191,1,1,0,1,0
6,204,204,2,2,0,1,0
24,208,208,22,7,15,4,3
4,230,230,28,28,0,1,0
28,233,233,94,17,77,4,3
8,253,253,67,45,22,3,2
2,285,285,172,130,42,2,1
19,302,302,12,4,8,3,2
21,305,305,50,50,0,1,0
10,314,314,43,10,33,4,3
23,316,316,16,16,0,1,0
7,322,322,65,65,0,1,0
12,340,340,7,7,0,1,0
0,357,357,41,41,0,1,0
22,362,362,47,47,0,1,0
17,373,373,33,12,21,4,3
27,391,391,55,46,9,4,3
15,426,426,2,2,0,1,0
20,426,426,89,13,76,3,2
5,437,437,5,5,0,1,0
11,445,445,12,3,9,2,1
16,459,459,2,2,0,1,0
26,499,499,2,2,0,1,0

27,119,119,7,4,3,2,1
1,121,121,6,6,0,1,0
26,123,123,12,12,0,1,0
6,138,138,6,6,0,1,0
3,140,140,22,2,20,2,1
29,140,140,17,17,0,1,0
18,168,168,13,13,0,1,0
7,170,170,8,8,0,1,0
10,178,178,4,4,0,1,0
17,180,180,7,7,0,1,0
14,190,190,33,11,22,2,1
12,199,199,1,1,0,1,0
8,209,209,53,53,0,1,0
0,216,216,58,58,0,1,0
11,220,220,2,2,0,1,0
30,243,243,16,1,15,2,1
22,268,268,1,1,0,1,0
25,310,310,48,6,42,4,3
20,318,318,14,10,4,2,1
16,320,320,51,39,12,2,1
31,343,343,5,5,0,1,0
23,354,354,85,67,18,3,2
21,361,361,40,2,38,2,1
13,382,382,31,31,0,1,0
15,431,431,26,19,7,2,1
4,433,433,53,53,0,1,0
28,442,442,144,21,123,4,3
9,444,444,58,58,0,1,0
2,445,445,131,131,0,1,0
19,450,450,47,26,21,4,3
24,465,465,25,1,24,4,3
5,477,477,21,3,18,3,2

31,101,101,3,3,0,1,0
2,122,122,4,4,0,1,0
32,129,129,16,16,0,1,0
17,132,132,4,4,0,1,0
27,148,148,40,30,10,3,2
29,160,160,2,2,0,1,0
4,170,170,5,5,0,1,0
7,173,173,3,3,0,1,0
21,174,174,14,14,0,1,0
26,175,175,8,8,0,1,0
25,183,183,8,1,7,2,1
0,199,199,1,1,0,1,0
30,223,223,31,13,18,4,3
13,231,231,13,13,0,1,0
5,231,231,9,3,6,2,1
33,236,236,3,3,0,1,0
15,241,241,19,19,0,1,0
12,264,264,9,9,0,1,0
36,281,281,58,58,0,1,0
11,297,297,7,7,0,1,0
10,299,299,107,55,52,3,2
6,302,302,7,7,0,1,0
8,322,322,96,9,87,4,3
34,335,335,32,32,0,1,0
20,339,339,13,13,0,1,0
37,351,351,39,39,0,1,0
28,360,360,12,12,0,1,0
19,362,362,5,5,0,1,0
24,440,440,36,36,0,1,0
35,449,449,96,74,22,4,3
22,462,462,60,24,36,3,2
23,463,463,55,55,0,1,0
1,464,464,5,5,0,1,0
18,466,466,17,17,0,1,0
9,470,470,73,46,27,4,3
14,477,477,92,92,0,1,0
3,486,486,48,44,4,2,1
16,499,499,65,39,26,3,2

14,110,110,1,1,0,1,0
36,120,120,8,8,0,1,0
23,131,131,15,15,0,1,0
11,133,133,8,8,0,1,0
26,139,139,13,13,0,1,0
17,148,148,4,4,0,1,0
27,154,154,12,4,8,2,1
10,187,187,3,3,0,1,0
21,188,188,8,8,0,1,0
37,198,198,1,1,0,1,0
34,202,202,22,22,0,1,0
8,204,204,49,49,0,1,0
2,206,206,17,17,0,1,0
32,218,218,17,3,14,2,1
40,219,219,61,1,60,4,3
7,219,219,3,3,0,1,0
6,222,222,10,6,4,2,1
20,229,229,7,7,0,1,0
4,242,242,20,11,9,4,3
33,250,250,8,8,0,1,0
19,265,265,9,9,0,1,0
13,295,295,31,13,18,4,3
15,305,305,12,4,8,2,1
39,317,317,41,41,0,1,0
24,318,318,67,42,25,2,1
12,330,330,13,4,9,2,1
5,352,352,31,31,0,1,0
35,353,353,24,1,23,2,1
1,374,374,13,4,9,2,1
29,377,377,26,5,21,2,1
18,379,379,60,60,0,1,0
30,424,424,1,1,0,1,0
22,466,466,2,2,0,1,0
0,467,467,67,18,49,4,3
28,468,468,109,109,0,1,0
31,472,472,64,25,39,4,3
25,478,478,1,1,0,1,0
16,482,482,104,72,32,2,1
9,490,490,1,1,0,1,0
38,498,498,75,46,29,2,1
3,500,500,38,38,0,1,0

10,109,109,1,1,0,1,0
8,120,120,1,1,0,1,0
13,134,134,1,1,0,1,0
36,146,146,7,7,0,1,0
29,154,154,2,2,0,1,0
0,161,161,3,3,0,1,0
22,177,177,20,2,18,3,2
30,196,196,16,6,10,2,1
23,224,224,3,3,0,1,0
14,225,225,27,27,0,1,0
24,227,227,42,2,40,3,2
20,228,228,5,2,3,2,1
21,237,237,20,6,14,2,1
16,246,246,12,4,8,2,1
28,252,252,17,17,0,1,0
11,255,255,23,23,0,1,0
26,258,258,6,6,0,1,0
7,272,272,70,58,12,4,3
15,280,280,47,2,45,4,3
35,301,301,38,19,19,2,1
12,333,333,15,15,0,1,0
9,345,345,22,22,0,1,0
17,348,348,36,8,28,2,1
19,349,349,41,6,35,2,1
32,354,354,21,21,0,1,0
5,361,361,25,20,5,2,1
1,366,366,3,3,0,1,0
31,393,393,188,130,58,3,2
6,400,400,27,27,0,1,0
34,408,408,27,3,24,4,3
2,436,436,85,85,0,1,0
33,458,458,36,36,0,1,0
27,459,459,11,11,0,1,0
3,463,463,57,14,43,3,2
4,491,491,46,46,0,1,0
18,491,491,43,19,24,4,3
25,497,497,126,96,30,4,3

6,112,112,2,2,0,1,0
7,122,122,9,9,0,1,0
24,130,130,11,3,8,2,1
32,137,137,9,9,0,1,0
26,152,152,14,3,11,2,1
1,155,155,25,25,0,1,0
12,156,156,15,5,10,2,1
28,159,159,41,15,26,3,2
5,161,161,33,20,13,2,1
13,163,163,8,5,3,2,1
3,173,173,21,4,17,2,1
31,175,175,3,3,0,1,0
19,181,181,60,42,18,2,1
9,197,197,42,15,27,2,1
23,204,204,7,7,0,1,0
0,213,213,22,16,6,2,1
22,216,216,17,8,9,4,3
18,233,233,25,25,0,1,0
20,240,240,6,1,5,2,1
17,272,272,23,11,12,2,1
16,283,283,56,19,37,2,1
11,294,294,10,10,0,1,0
2,318,318,27,3,24,2,1
4,325,325,4,4,0,1,0
30,326,326,3,3,0,1,0
10,340,340,61,61,0,1,0
21,350,350,31,21,10,3,2
8,354,354,41,17,24,2,1
29,366,366,22,9,13,2,1
25,436,436,18,10,8,2,1
14,445,445,31,27,4,2,1
15,500,500,82,54,28,2,1
27,500,500,81,36,45,2,1

0,105,105,9,9,0,1,0
29,110,110,8,8,0,1,0
1,132,132,3,3,0,1,0
32,136,136,27,27,0,1,0
13,153,153,8,8,0,1,0
11,158,158,2,2,0,1,0
8,160,160,1,1,0,1,0
7,168,168,21,13,8,2,1
41,177,177,2,2,0,1,0
23,179,179,7,1,6,3,2
37,181,181,24,14,10,2,1
5,192,192,9,9,0,1,0
28,204,204,20,20,0,1,0
6,224,224,4,4,0,1,0
38,226,226,2,2,0,1,0
18,228,228,46,46,0,1,0
30,238,238,24,16,8,3,2
27,255,255,11,11,0,1,0
17,266,266,6,6,0,1,0
9,266,266,10,2,8,3,2
42,291,291,65,43,22,4,3
4,292,292,4,4,0,1,0
16,295,295,43,1,42,2,1
39,299,299,16,3,13,3,2
31,301,301,50,50,0,1,0
3,311,311,67,43,24,2,1
20,330,330,95,4,91,4,3
12,334,334,9,9,0,1,0
34,344,344,10,10,0,1,0
40,352,352,49,49,0,1,0
19,367,367,19,10,9,4,3
25,378,378,9,2,7,2,1
10,396,396,8,8,0,1,0
15,448,448,15,6,9,3,2
14,455,455,14,14,0,1,0
26,459,459,54,54,0,1,0
24,465,465,19,10,9,2,1
35,474,474,13,13,0,1,0
21,478,478,4,1,3,2,1
33,485,485,57,39,18,2,1
2,487,487,34,13,21,4,3
36,493,493,99,59,40,3,2
22,496,496,31,31,0,1,0

39,105,105,1,1,0,1,0
12,117,117,18,18,0,1,0
3,123,123,1,1,0,1,0
14,130,130,14,10,4,2,1
9,133,133,6,2,4,2,1
18,151,151,12,12,0,1,0
23,155,155,5,2,3,2,1
22,165,165,18,18,0,1,0
7,166,166,13,13,0,1,0
40,179,179,22,22,0,1,0
33,179,179,27,7,20,4,3
29,187,187,4,4,0,1,0
19,189,189,38,34,4,2,1
21,209,209,27,27,0,1,0
8,215,215,21,21,0,1,0
26,223,223,42,6,36,4,3
35,237,237,12,12,0,1,0
15,250,250,10,4,6,2,1
5,261,261,11,1,10,2,1
2,263,263,22,18,4,2,1
34,274,274,25,12,13,2,1
30,285,285,35,26,9,4,3
24,322,322,60,38,22,2,1
27,322,322,66,28,38,3,2
6,332,332,17,17,0,1,0
38,335,335,3,3,0,1,0
1,336,336,34,19,15,2,1
0,339,339,1,1,0,1,0
16,361,361,43,43,0,1,0
20,361,361,15,15,0,1,0
32,376,376,76,64,12,2,1
17,377,377,5,5,0,1,0
25,398,398,28,7,21,4,3
37,406,406,11,8,3,2,1
28,409,409,8,3,5,2,1
11,411,411,7,7,0,1,0
36,418,418,74,32,42,3,2
13,424,424,19,19,0,1,0
4,456,456,1,1,0,1,0
31,470,470,40,22,18,4,3
10,496,496,51,51,0,1,0

11,106,106,18,18,0,1,0
31,111,111,10,4,6,3,2
18,119,119,20,7,13,2,1
1,120,120,1,1,0,1,0
16,124,124,3,3,0,1,0
6,151,151,1,1,0,1,0
28,168,168,46,6,40,3,2
35,176,176,8,8,0,1,0
7,184,184,30,30,0,1,0
34,187,187,27,27,0,1,0
36,193,193,3,3,0,1,0
2,219,219,14,14,0,1,0
8,225,225,13,13,0,1,0
24,234,234,38,38,0,1,0
3,239,239,7,1,6,3,2
29,252,252,15,15,0,1,0
15,253,253,23,10,13,2,1
33,266,266,55,55,0,1,0
20,277,277,3,3,0,1,0
25,299,299,24,24,0,1,0
27,303,303,20,8,12,3,2
5,309,309,42,30,12,3,2
4,312,312,5,1,4,2,1
13,313,313,2,2,0,1,0
10,345,345,66,19,47,2,1
21,347,347,34,28,6,3,2
30,348,348,17,11,6,3,2
0,363,363,32,3,29,2,1
26,395,395,15,11,4,2,1
32,406,406,74,52,22,3,2
23,421,421,24,21,3,2,1
14,434,434,3,3,0,1,0
17,456,456,74,74,0,1,0
22,467,467,69,69,0,1,0
9,481,481,78,10,68,4,3
12,488,488,68,35,33,4,3
19,497,497,5,5,0,1,0

26,114,114,4,4,0,1,0
3,117,117,31,22,9,4,3
13,120,120,12,4,8,3,2
1,122,122,30,30,0,1,0
17,125,125,6,2,4,2,1
22,141,141,5,5,0,1,0
28,183,183,19,19,0,1,0
18,189,189,6,6,0,1,0
25,202,202,24,24,0,1,0
20,219,219,19,1,18,2,1
9,231,231,2,2,0,1,0
7,236,236,6,6,0,1,0
6,237,237,68,29,39,4,3
10,262,262,3,3,0,1,0
16,277,277,1,1,0,1,0
0,330,330,68,68,0,1,0
27,337,337,72,29,43,2,1
21,339,339,69,59,10,2,1
4,380,380,6,6,0,1,0
23,380,380,18,3,15,4,3
15,395,395,56,56,0,1,0
5,403,403,18,18,0,1,0
24,405,405,77,25,52,3,2
12,408,408,1,1,0,1,0
8,422,422,71,71,0,1,0
2,441,441,141,54,87,4,3
19,447,447,39,39,0,1,0
14,473,473,130,130,0,1,0
11,500,500,52,14,38,2,1

25,105,105,6,6,0,1,0
36,109,109,11,11,0,1,0
12,114,114,8,8,0,1,0
7,120,120,2,2,0,1,0
37,126,126,22,22,0,1,0
4,132,132,6,6,0,1,0
27,151,151,24,14,10,3,2
30,153,153,26,1,25,2,1
32,163,163,6,6,0,1,0
38,181,181,14,6,8,2,1
23,186,186,11,11,0,1,0
29,197,197,6,6,0,1,0
2,198,198,35,1,34,2,1
0,226,226,42,42,0,1,0
3,245,245,18,18,0,1,0
5,254,254,10,2,8,3,2
8,269,269,4,4,0,1,0
33,277,277,47,2,45,2,1
1,279,279,27,27,0,1,0
11,280,280,23,23,0,1,0
6,305,305,9,9,0,1,0
13,305,305,1,1,0,1,0
14,315,315,22,8,14,3,2
34,321,321,19,19,0,1,0
28,334,334,56,56,0,1,0
35,344,344,41,41,0,1,0
20,345,345,8,8,0,1,0
17,346,346,71,46,25,4,3
26,351,351,7,7,0,1,0
18,361,361,77,77,0,1,0
22,379,379,21,9,12,3,2
9,395,395,20,11,9,2,1
24,417,417,69,69,0,1,0
31,418,418,46,46,0,1,0
19,429,429,37,37,0,1,0
15,435,435,3,3,0,1,0
21,469,469,38,38,0,1,0
10,483,483,20,20,0,1,0
16,496,496,44,44,0,1,0

11,108,108,1,1,0,1,0
16,113,113,22,12,10,3,2
26,130,130,19,19,0,1,0
13,150,150,5,5,0,1,0
21,176,176,7,7,0,1,0
30,204,204,3,3,0,1,0
5,205,205,1,1,0,1,0
15,222,222,21,18,3,2,1
29,242,242,41,41,0,1,0
8,248,248,10,7,3,2,1
20,255,255,31,19,12,2,1
34,258,258,12,6,6,2,1
17,278,278,29,11,18,4,3
12,283,283,39,39,0,1,0
36,318,318,27,27,0,1,0
33,321,321,8,8,0,1,0
35,324,324,50,10,40,4,3
24,328,328,22,2,20,3,2
28,341,341,121,85,36,2,1
19,343,343,88,88,0,1,0
1,343,343,12,1,11,2,1
6,349,349,23,23,0,1,0
2,362,362,47,29,18,4,3
7,369,369,33,9,24,4,3
14,373,373,5,5,0,1,0
25,374,374,33,33,0,1,0
10,392,392,6,6,0,1,0
32,403,403,31,1,30,4,3
22,413,413,57,57,0,1,0
9,433,433,68,29,39,4,3
27,439,439,32,17,15,4,3
23,441,441,55,12,43,4,3
0,445,445,9,5,4,2,1
18,445,445,117,102,15,4,3
31,481,481,4,4,0,1,0
3,499,499,4,4,0,1,0
4,500,500,15,15,0,1,0

36,114,114,13,13,0,1,0
33,120,120,20,20,0,1,0
32,134,134,6,6,0,1,0
23,140,140,6,3,3,2,1
18,161,161,1,1,0,1,0
5,167,167,1,1,0,1,0
16,168,168,17,17,0,1,0
7,179,179,30,13,17,2,1
26,194,194,27,9,18,3,2
14,196,196,15,7,8,3,2
20,198,198,31,10,21,4,3
19,199,199,22,22,0,1,0
31,212,212,27,27,0,1,0
10,251,251,1,1,0,1,0
22,265,265,101,101,0,1,0
12,282,282,24,4,20,3,2
1,289,289,27,4,23,3,2
2,302,302,132,42,90,4,3
29,314,314,9,9,0,1,0
17,342,342,9,3,6,2,1
3,345,345,16,1,15,4,3
30,349,349,23,23,0,1,0
24,349,349,20,20,0,1,0
4,361,361,20,20,0,1,0
9,388,388,44,20,24,4,3
35,394,394,25,16,9,4,3
0,400,400,34,28,6,3,2
28,400,400,62,26,36,4,3
34,402,402,1,1,0,1,0
13,417,417,20,7,13,2,1
21,432,432,10,4,6,3,2
15,441,441,2,2,0,1,0
11,441,441,1,1,0,1,0
8,455,455,25,25,0,1,0
25,465,465,115,47,68,4,3
6,470,470,11,8,3,2,1
27,490,490,15,15,0,1,0
37,500,500,23,1,22,2,1

18,126,126,6,6,0,1,0
31,128,128,5,5,0,1,0
21,152,152,2,2,0,1,0
1,158,158,11,4,7,2,1
26,171,171,2,2,0,1,0
22,174,174,18,4,14,4,3
2,180,180,10,10,0,1,0
27,183,183,12,4,8,3,2
8,197,197,31,31,0,1,0
19,202,202,40,40,0,1,0
14,206,206,5,5,0,1,0
11,224,224,5,5,0,1,0
33,225,225,37,33,4,2,1
20,257,257,88,17,71,3,2
4,259,259,51,35,16,3,2
6,288,288,1,1,0,1,0
0,290,290,1,1,0,1,0
24,300,300,6,6,0,1,0
3,302,302,6,6,0,1,0
12,314,314,36,36,0,1,0
13,314,314,49,30,19,2,1
16,327,327,20,2,18,2,1
23,399,399,132,41,91,4,3
32,406,406,12,3,9,2,1
9,416,416,48,48,0,1,0
29,420,420,21,6,15,4,3
7,420,420,73,4,69,4,3
10,431,431,34,7,27,2,1
30,436,436,27,27,0,1,0
25,449,449,74,74,0,1,0
34,464,464,21,21,0,1,0
15,476,476,41,11,30,2,1
17,497,497,128,56,72,3,2
28,498,498,25,25,0,1,0
5,499,499,52,32,20,3,2

0,116,116,1,1,0,1,0
41,128,128,9,9,0,1,0
36,137,137,18,18,0,1,0
3,142,142,14,7,7,2,1
22,145,145,1,1,0,1,0
4,157,157,15,1,14,3,2
1,159,159,20,12,8,2,1
8,160,160,13,13,0,1,0
25,167,167,7,7,0,1,0
6,188,188,1,1,0,1,0
37,197,197,31,25,6,3,2
32,217,217,11,11,0,1,0
12,240,240,6,6,0,1,0
30,264,264,16,16,0,1,0
11,269,269,30,14,16,3,2
21,277,277,20,20,0,1,0
5,282,282,5,5,0,1,0
40,282,282,14,14,0,1,0
15,335,335,4,4,0,1,0
10,346,346,43,43,0,1,0
7,350,350,30,30,0,1,0
20,368,368,4,4,0,1,0
26,368,368,59,15,44,3,2
16,376,376,145,145,0,1,0
34,376,376,63,63,0,1,0
2,386,386,21,4,17,2,1
39,397,397,17,5,12,4,3
27,403,403,60,20,40,2,1
18,407,407,13,13,0,1,0
38,411,411,28,28,0,1,0
17,412,412,10,10,0,1,0
23,415,415,18,18,0,1,0
13,424,424,17,17,0,1,0
14,436,436,13,3,10,3,2
24,442,442,68,68,0,1,0
29,443,443,10,4,6,3,2
33,450,450,45,45,0,1,0
35,466,466,44,8,36,3,2
19,468,468,25,2,23,2,1
28,475,475,100,86,14,2,1
31,476,476,68,53,15,4,3
9,497,497,1,1,0,1,0

1,108,108,6,6,0,1,0
32,113,113,10,10,0,1,0
5,132,132,11,2,9,4,3
19,150,150,30,30,0,1,0
38,154,154,2,2,0,1,0
0,155,155,4,4,0,1,0
2,159,159,1,1,0,1,0
37,161,161,2,2,0,1,0
30,168,168,2,2,0,1,0
17,177,177,10,10,0,1,0
14,260,260,6,3,3,2,1
9,263,263,3,3,0,1,0
7,267,267,19,4,15,4,3
8,277,277,48,48,0,1,0
26,291,291,38,38,0,1,0
13,313,313,12,2,10,3,2
25,319,319,28,8,20,3,2
4,320,320,70,70,0,1,0
16,349,349,25,25,0,1,0
18,350,350,1,1,0,1,0
31,351,351,154,154,0,1,0
36,352,352,35,5,30,4,3
35,357,357,33,33,0,1,0
10,358,358,10,10,0,1,0
29,374,374,6,1,5,2,1
33,386,386,5,5,0,1,0
23,397,397,39,4,35,3,2
6,410,410,26,26,0,1,0
12,434,434,41,41,0,1,0
24,444,444,28,11,17,2,1
28,455,455,20,13,7,2,1
22,459,459,47,47,0,1,0
34,464,464,67,46,21,2,1
15,466,466,2,2,0,1,0
21,476,476,80,80,0,1,0
20,478,478,54,54,0,1,0
3,480,480,65,65,0,1,0
11,480,480,27,2,25,2,1
27,487,487,132,98,34,2,1

18,110,110,2,2,0,1,0
31,111,111,4,4,0,1,0
5,148,148,1,1,0,1,0
4,155,155,1,1,0,1,0
24,161,161,22,22,0,1,0
28,168,168,9,2,7,2,1
6,178,178,1,1,0,1,0
19,192,192,10,2,8,2,1
35,199,199,24,20,4,2,1
30,201,201,16,3,13,2,1
11,217,217,1,1,0,1,0
25,234,234,23,10,13,2,1
7,235,235,13,2,11,2,1
27,252,252,4,4,0,1,0
20,268,268,40,40,0,1,0
29,280,280,12,12,0,1,0
1,311,311,12,12,0,1,0
3,314,314,66,13,53,3,2
26,317,317,11,6,5,2,1
21,321,321,6,6,0,1,0
34,322,322,36,10,26,3,2
10,337,337,3,3,0,1,0
12,342,342,19,7,12,2,1
8,349,349,22,22,0,1,0
33,390,390,6,6,0,1,0
14,392,392,83,83,0,1,0
9,396,396,16,5,11,2,1
16,420,420,99,47,52,4,3
0,424,424,10,6,4,2,1
23,430,430,195,131,64,3,2
15,439,439,6,2,4,2,1
22,444,444,53,53,0,1,0
13,444,444,41,5,36,4,3
32,467,467,93,45,48,4,3
17,479,479,66,28,38,3,2
2,499,499,239,239,0,1,0

4,129,129,15,5,10,2,1
28,151,151,64,14,50,2,1
23,170,170,9,3,6,3,2
21,180,180,3,3,0,1,0
18,202,202,19,19,0,1,0
6,209,209,1,1,0,1,0
22,226,226,4,4,0,1,0
7,238,238,63,45,18,4,3
12,245,245,19,19,0,1,0
8,256,256,78,8,70,3,2
16,262,262,20,2,18,3,2
10,266,266,1,1,0,1,0
1,271,271,20,20,0,1,0
17,291,291,41,41,0,1,0
0,304,304,4,4,0,1,0
13,314,314,49,49,0,1,0
24,349,349,2,2,0,1,0
9,352,352,9,2,7,2,1
2,362,362,182,116,66,4,3
11,365,365,6,6,0,1,0
25,387,387,12,6,6,3,2
20,388,388,63,19,44,2,1
26,389,389,34,29,5,2,1
29,399,399,85,51,34,2,1
19,416,416,18,18,0,1,0
5,429,429,53,53,0,1,0
3,444,444,77,67,10,2,1
27,448,448,28,6,22,3,2
15,461,461,11,11,0,1,0
14,461,461,56,32,24,4,3

9,127,127,5,2,3,2,1
20,130,130,1,1,0,1,0
33,150,150,21,3,18,4,3
5,160,160,2,2,0,1,0
8,163,163,4,4,0,1,0
30,168,168,13,13,0,1,0
23,230,230,54,54,0,1,0
22,234,234,15,3,12,4,3
35,246,246,6,6,0,1,0
4,253,253,7,7,0,1,0
25,264,264,6,6,0,1,0
15,270,270,10,4,6,2,1
38,273,273,93,2,91,4,3
13,292,292,13,13,0,1,0
26,298,298,105,105,0,1,0
37,307,307,36,18,18,2,1
28,322,322,35,35,0,1,0
14,325,325,24,24,0,1,0
17,332,332,25,4,21,4,3
0,336,336,1,1,0,1,0
34,337,337,76,76,0,1,0
2,351,351,17,5,12,4,3
27,364,364,3,3,0,1,0
16,369,369,13,13,0,1,0
41,371,371,21,21,0,1,0
6,375,375,71,23,48,3,2
3,379,379,2,2,0,1,0
36,391,391,7,1,6,3,2
1,408,408,63,45,18,3,2
7,409,409,13,13,0,1,0
19,420,420,32,32,0,1,0
31,423,423,8,8,0,1,0
40,435,435,26,26,0,1,0
18,436,436,9,6,3,2,1
24,439,439,9,9,0,1,0
10,439,439,47,5,42,4,3
12,445,445,21,1,20,3,2
29,456,456,1,1,0,1,0
11,458,458,12,4,8,2,1
21,460,460,135,108,27,4,3
32,462,462,66,66,0,1,0
39,499,499,5,5,0,1,0

27,120,120,12,2,10,2,1
15,157,157,1,1,0,1,0
0,166,166,13,13,0,1,0
12,177,177,49,17,32,3,2
24,188,188,14,14,0,1,0
29,205,205,3,3,0,1,0
19,232,232,36,36,0,1,0
1,237,237,10,10,0,1,0
25,238,238,2,2,0,1,0
26,243,243,18,18,0,1,0
22,269,269,26,26,0,1,0
6,277,277,55,55,0,1,0
9,301,301,29,29,0,1,0
2,318,318,24,24,0,1,0
11,321,321,25,25,0,1,0
5,328,328,1,1,0,1,0
17,344,344,90,4,86,3,2
23,347,347,12,7,5,2,1
28,356,356,28,8,20,2,1
16,384,384,6,6,0,1,0
3,389,389,29,29,0,1,0
14,393,393,69,69,0,1,0
18,394,394,83,83,0,1,0
21,408,408,79,79,0,1,0
13,417,417,74,49,25,3,2
7,439,439,154,154,0,1,0
4,475,475,38,38,0,1,0
20,483,483,27,23,4,2,1
10,484,484,168,96,72,3,2
8,488,488,1,1,0,1,0

14,109,109,2,2,0,1,0
40,109,109,2,2,0,1,0
7,120,120,5,5,0,1,0
30,134,134,27,5,22,2,1
9,135,135,14,4,10,2,1
32,156,156,10,6,4,2,1
19,164,164,12,12,0,1,0
41,188,188,46,16,30,3,2
2,191,191,23,23,0,1,0
11,195,195,22,22,0,1,0
42,204,204,1,1,0,1,0
34,216,216,13,13,0,1,0
39,220,220,45,45,0,1,0
36,229,229,26,26,0,1,0
38,230,230,27,15,12,2,1
35,231,231,2,2,0,1,0
10,235,235,1,1,0,1,0
33,247,247,18,18,0,1,0
21,284,284,4,4,0,1,0
37,284,284,30,6,24,2,1
29,298,298,43,10,33,2,1
13,301,301,1,1,0,1,0
6,309,309,1,1,0,1,0
20,310,310,14,4,10,2,1
0,314,314,11,11,0,1,0
17,321,321,15,15,0,1,0
16,324,324,29,8,21,2,1
18,339,339,61,61,0,1,0
26,342,342,2,2,0,1,0
25,364,364,88,88,0,1,0
8,364,364,8,8,0,1,0
4,369,369,1,1,0,1,0
1,374,374,22,16,6,2,1
27,381,381,37,2,35,4,3
23,419,419,40,40,0,1,0
31,419,419,65,65,0,1,0
43,424,424,3,3,0,1,0
5,429,429,3,3,0,1,0
3,433,433,9,9,0,1,0
22,444,444,79,79,0,1,0
12,446,446,45,45,0,1,0
28,451,451,54,36,18,4,3
15,466,466,14,14,0,1,0
24,467,467,22,1,21,4,3

15,100,100,12,6,6,2,1
6,101,101,27,27,0,1,0
20,118,118,11,11,0,1,0
14,133,133,3,3,0,1,0
24,146,146,16,2,14,3,2
3,151,151,5,5,0,1,0
8,163,163,1,1,0,1,0
31,180,180,18,18,0,1,0
4,197,197,1,1,0,1,0
29,212,212,1,1,0,1,0
27,213,213,7,1,6,3,2
11,218,218,34,34,0,1,0
2,237,237,14,5,9,4,3
17,247,247,4,4,0,1,0
10,254,254,1,1,0,1,0
22,269,269,75,3,72,4,3
12,283,283,9,4,5,2,1
0,289,289,34,34,0,1,0
19,301,301,9,9,0,1,0
7,302,302,46,36,10,2,1
16,304,304,18,18,0,1,0
9,312,312,25,10,15,2,1
32,325,325,111,73,38,3,2
5,329,329,5,1,4,2,1
21,348,348,13,13,0,1,0
26,350,350,43,3,40,2,1
30,356,356,20,20,0,1,0
1,364,364,69,69,0,1,0
18,388,388,66,29,37,2,1
28,389,389,10,1,9,2,1
13,403,403,181,171,10,3,2
25,476,476,109,109,0,1,0
23,478,478,15,15,0,1,0

9,110,110,15,6,9,4,3
4,114,114,1,1,0,1,0
37,123,123,10,10,0,1,0
0,128,128,24,10,14,2,1
25,131,131,33,30,3,2,1
22,133,133,3,3,0,1,0
20,138,138,13,9,4,2,1
33,140,140,2,2,0,1,0
10,144,144,3,3,0,1,0
24,203,203,9,9,0,1,0
21,204,204,15,15,0,1,0
28,221,221,21,7,14,2,1
31,225,225,22,22,0,1,0
27,228,228,2,2,0,1,0
11,254,254,1,1,0,1,0
6,266,266,115,41,74,4,3
32,282,282,4,4,0,1,0
36,287,287,36,29,7,2,1
30,289,289,7,7,0,1,0
13,324,324,13,13,0,1,0
23,327,327,48,10,38,2,1
1,335,335,32,32,0,1,0
16,353,353,13,13,0,1,0
5,379,379,27,27,0,1,0
26,386,386,59,47,12,4,3
18,389,389,25,14,11,2,1
34,390,390,138,78,60,3,2
35,390,390,49,46,3,2,1
29,398,398,43,43,0,1,0
15,414,414,53,18,35,4,3
7,414,414,27,27,0,1,0
3,418,418,30,24,6,2,1
14,438,438,9,9,0,1,0
17,440,440,4,4,0,1,0
12,451,451,20,20,0,1,0
8,457,457,48,48,0,1,0
19,468,468,7,3,4,2,1
2,499,499,25,25,0,1,0

6,151,151,32,32,0,1,0
0,153,153,30,30,0,1,0
7,172,172,49,2,47,2,1
18,173,173,2,2,0,1,0
33,186,186,45,33,12,4,3
20,198,198,17,17,0,1,0
15,199,199,7,7,0,1,0
28,220,220,60,60,0,1,0
19,234,234,57,4,53,4,3
4,242,242,29,29,0,1,0
21,247,247,33,6,27,2,1
13,263,263,21,21,0,1,0
14,268,268,23,23,0,1,0
11,305,305,46,46,0,1,0
25,305,305,11,11,0,1,0
24,310,310,13,13,0,1,0
29,312,312,23,4,19,4,3
30,319,319,8,4,4,2,1
16,327,327,16,4,12,2,1
23,348,348,35,35,0,1,0
9,352,352,38,38,0,1,0
2,394,394,9,4,5,2,1
32,394,394,61,61,0,1,0
26,419,419,13,13,0,1,0
31,423,423,3,3,0,1,0
27,427,427,41,2,39,4,3
5,430,430,75,75,0,1,0
3,433,433,4,4,0,1,0
17,442,442,35,7,28,2,1
22,460,460,7,7,0,1,0
12,464,464,16,16,0,1,0
1,477,477,13,13,0,1,0
34,479,479,76,43,33,4,3
10,490,490,15,15,0,1,0
8,491,491,1,1,0,1,0

7,100,100,4,4,0,1,0
31,144,144,33,33,0,1,0
26,156,156,9,1,8,3,2
14,164,164,22,22,0,1,0
1,195,195,8,8,0,1,0
4,220,220,4,4,0,1,0
22,223,223,29,14,15,2,1
11,223,223,12,2,10,3,2
3,238,238,87,6,81,4,3
13,241,241,18,18,0,1,0
23,261,261,37,37,0,1,0
16,262,262,23,23,0,1,0
30,283,283,33,33,0,1,0
28,298,298,7,1,6,3,2
5,318,318,44,10,34,3,2
12,319,319,11,4,7,2,1
15,320,320,18,4,14,2,1
29,322,322,31,31,0,1,0
10,333,333,43,18,25,2,1
9,357,357,30,2,28,3,2
17,376,376,54,51,3,2,1
8,386,386,71,71,0,1,0
18,391,391,10,5,5,2,1
6,399,399,19,19,0,1,0
20,407,407,26,6,20,2,1
2,408,408,57,57,0,1,0
27,437,437,8,8,0,1,0
21,442,442,33,33,0,1,0
24,449,449,24,18,6,3,2
32,465,465,32,5,27,3,2
25,470,470,40,40,0,1,0
0,479,479,35,35,0,1,0
33,481,481,113,113,0,1,0
19,494,494,86,86,0,1,0

20,111,111,16,1,15,2,1
13,123,123,23,23,0,1,0
9,124,124,12,7,5,2,1
21,160,160,33,33,0,1,0
10,166,166,19,19,0,1,0
8,174,174,18,18,0,1,0
7,179,179,1,1,0,1,0
24,180,180,16,4,12,3,2
3,187,187,10,10,0,1,0
23,191,191,51,51,0,1,0
2,203,203,27,27,0,1,0
5,216,216,7,7,0,1,0
12,219,219,27,27,0,1,0
27,220,220,26,14,12,2,1
31,239,239,15,15,0,1,0
22,243,243,27,27,0,1,0
6,260,260,71,41,30,3,2
0,270,270,5,2,3,2,1
14,277,277,48,48,0,1,0
4,308,308,10,10,0,1,0
25,327,327,24,1,23,2,1
32,329,329,7,2,5,2,1
30,366,366,13,13,0,1,0
18,393,393,4,4,0,1,0
28,394,394,51,42,9,2,1
29,406,406,30,13,17,2,1
11,421,421,24,24,0,1,0
15,424,424,13,13,0,1,0
16,432,432,35,35,0,1,0
26,435,435,15,3,12,4,3
1,476,476,127,69,58,3,2
17,478,478,75,33,42,2,1
19,497,497,60,34,26,2,1

22,119,119,4,4,0,1,0
15,120,120,12,4,8,3,2
3,135,135,11,4,7,2,1
4,149,149,27,24,3,2,1
28,149,149,16,16,0,1,0
33,162,162,25,1,24,3,2
27,164,164,64,64,0,1,0
24,192,192,15,15,0,1,0
29,205,205,36,27,9,4,3
19,219,219,6,6,0,1,0
21,266,266,31,19,12,3,2
18,270,270,25,12,13,2,1
9,295,295,12,3,9,2,1
23,296,296,13,10,3,2,1
12,309,309,43,43,0,1,0
16,318,318,14,10,4,2,1
5,321,321,22,22,0,1,0
17,322,322,27,11,16,2,1
13,323,323,72,28,44,4,3
7,332,332,42,18,24,4,3
11,341,341,16,2,14,2,1
6,344,344,1,1,0,1,0
14,360,360,70,50,20,3,2
25,369,369,13,7,6,3,2
31,370,370,56,35,21,2,1
0,387,387,32,26,6,2,1
30,408,408,69,27,42,2,1
32,414,414,14,2,12,2,1
2,417,417,53,53,0,1,0
1,430,430,68,68,0,1,0
20,455,455,13,4,9,4,3
8,457,457,9,9,0,1,0
10,479,479,31,31,0,1,0
26,483,483,6,3,3,2,1

21,130,130,28,28,0,1,0
19,143,143,1,1,0,1,0
15,168,168,16,16,0,1,0
9,178,178,37,28,9,4,3
28,197,197,5,5,0,1,0
31,198,198,2,2,0,1,0
32,204,204,25,14,11,2,1
20,208,208,8,1,7,2,1
2,246,246,18,8,10,3,2
25,281,281,3,3,0,1,0
17,288,288,70,21,49,3,2
24,304,304,57,21,36,2,1
10,306,306,104,12,92,3,2
34,308,308,189,69,120,4,3
11,310,310,31,15,16,3,2
23,320,320,8,8,0,1,0
1,357,357,23,23,0,1,0
33,360,360,38,11,27,4,3
26,367,367,29,2,27,4,3
14,380,380,9,9,0,1,0
7,404,404,2,2,0,1,0
5,405,405,7,7,0,1,0
12,408,408,16,16,0,1,0
29,410,410,15,15,0,1,0
22,416,416,12,1,11,3,2
13,416,416,33,33,0,1,0
27,420,420,2,2,0,1,0
3,422,422,1,1,0,1,0
4,436,436,80,71,9,4,3
0,456,456,25,25,0,1,0
6,462,462,31,16,15,3,2
16,464,464,29,4,25,2,1
8,472,472,20,20,0,1,0
18,493,493,3,3,0,1,0
30,500,500,108,36,72,4,3

16,119,119,5,5,0,1,0
15,150,150,1,1,0,1,0
7,152,152,5,2,3,2,1
18,165,165,3,3,0,1,0
33,176,176,3,3,0,1,0
42,180,180,4,4,0,1,0
27,182,182,12,12,0,1,0
21,183,183,6,6,0,1,0
38,191,191,13,13,0,1,0
40,199,199,1,1,0,1,0
28,207,207,46,46,0,1,0
39,214,214,20,20,0,1,0
4,217,217,11,2,9,2,1
30,220,220,54,54,0,1,0
36,229,229,3,3,0,1,0
0,233,233,8,8,0,1,0
32,235,235,8,3,5,2,1
17,246,246,35,27,8,2,1
5,248,248,16,5,11,2,1
6,251,251,11,11,0,1,0
23,273,273,24,24,0,1,0
25,292,292,7,7,0,1,0
26,297,297,37,37,0,1,0
3,308,308,20,20,0,1,0
31,308,308,11,2,9,4,3
13,309,309,16,10,6,3,2
19,313,313,34,34,0,1,0
41,318,318,5,5,0,1,0
34,331,331,176,138,38,2,1
8,344,344,38,38,0,1,0
29,360,360,66,4,62,4,3
1,389,389,11,11,0,1,0
2,390,390,6,3,3,2,1
37,397,397,11,5,6,3,2
12,413,413,18,9,9,2,1
20,414,414,24,4,20,3,2
35,415,415,12,12,0,1,0
24,422,422,28,28,0,1,0
22,439,439,172,142,30,4,3
9,443,443,2,2,0,1,0
10,474,474,38,14,24,3,2
11,484,484,38,23,15,3,2
14,484,484,10,5,5,2,1

9,114,114,9,9,0,1,0
27,129,129,3,3,0,1,0
5,136,136,4,4,0,1,0
29,140,140,2,2,0,1,0
33,150,150,1,1,0,1,0
11,151,151,1,1,0,1,0
8,160,160,29,29,0,1,0
10,176,176,1,1,0,1,0
0,188,188,5,5,0,1,0
18,232,232,34,34,0,1,0
13,239,239,51,51,0,1,0
26,252,252,19,11,8,3,2
4,266,266,4,4,0,1,0
1,271,271,14,14,0,1,0
7,292,292,123,42,81,4,3
24,294,294,11,8,3,2,1
25,311,311,12,12,0,1,0
31,338,338,22,13,9,4,3
34,341,341,7,7,0,1,0
14,343,343,36,8,28,2,1
2,350,350,4,4,0,1,0
16,350,350,8,4,4,2,1
36,353,353,144,144,0,1,0
17,355,355,24,4,20,3,2
32,359,359,24,8,16,2,1
21,363,363,88,66,22,2,1
35,377,377,75,27,48,2,1
3,406,406,23,23,0,1,0
15,418,418,33,33,0,1,0
30,427,427,11,2,9,2,1
19,434,434,9,1,8,2,1
12,439,439,24,11,13,2,1
22,442,442,94,67,27,4,3
20,473,473,102,102,0,1,0
23,479,479,18,18,0,1,0
6,491,491,52,13,39,4,3
28,497,497,17,8,9,2,1

29,104,104,4,1,3,2,1
8,123,123,33,12,21,2,1
32,151,151,15,7,8,3,2
17,154,154,2,2,0,1,0
0,157,157,1,1,0,1,0
30,179,179,4,1,3,2,1
22,181,181,44,6,38,3,2
24,186,186,43,43,0,1,0
20,189,189,20,20,0,1,0
15,222,222,23,23,0,1,0
23,227,227,12,6,6,3,2
25,235,235,12,12,0,1,0
12,241,241,15,12,3,2,1
21,247,247,59,59,0,1,0
19,276,276,115,79,36,4,3
18,276,276,2,2,0,1,0
5,277,277,1,1,0,1,0
9,279,279,71,56,15,4,3
27,361,361,11,3,8,3,2
4,365,365,44,44,0,1,0
16,388,388,20,20,0,1,0
26,397,397,31,17,14,2,1
1,403,403,23,8,15,2,1
7,404,404,4,4,0,1,0
11,411,411,89,84,5,2,1
14,415,415,14,2,12,2,1
13,429,429,71,26,45,4,3
3,439,439,112,112,0,1,0
28,444,444,21,21,0,1,0
10,453,453,5,5,0,1,0
31,469,469,3,3,0,1,0
6,484,484,41,41,0,1,0
2,485,485,25,9,16,3,2

19,104,104,1,1,0,1,0
38,113,113,9,9,0,1,0
29,137,137,10,2,8,3,2
31,140,140,16,16,0,1,0
0,152,152,14,14,0,1,0
9,154,154,4,4,0,1,0
18,161,161,1,1,0,1,0
1,165,165,42,1,41,2,1
32,171,171,42,32,10,3,2
10,172,172,4,4,0,1,0
25,180,180,11,1,10,2,1
21,196,196,15,3,12,4,3
27,196,196,22,22,0,1,0
3,197,197,15,9,6,3,2
26,206,206,24,24,0,1,0
24,222,222,8,5,3,2,1
23,257,257,23,16,7,2,1
28,262,262,18,6,12,2,1
7,273,273,18,18,0,1,0
2,275,275,10,10,0,1,0
12,281,281,5,5,0,1,0
13,306,306,9,9,0,1,0
36,308,308,22,16,6,2,1
37,311,311,7,7,0,1,0
34,328,328,22,14,8,2,1
17,335,335,41,3,38,3,2
4,361,361,80,16,64,3,2
11,377,377,2,2,0,1,0
16,377,377,16,6,10,2,1
30,391,391,122,47,75,4,3
20,397,397,52,52,0,1,0
8,397,397,27,27,0,1,0
22,403,403,20,20,0,1,0
35,404,404,57,17,40,4,3
33,408,408,32,1,31,2,1
14,414,414,55,55,0,1,0
6,427,427,59,37,22,3,2
15,491,491,8,8,0,1,0
5,498,498,55,55,0,1,0

19,105,105,14,14,0,1,0
6,107,107,5,5,0,1,0
32,110,110,5,5,0,1,0
22,121,121,17,7,10,3,2
31,144,144,8,8,0,1,0
0,147,147,10,10,0,1,0
2,159,159,6,1,5,2,1
15,177,177,41,41,0,1,0
18,178,178,24,24,0,1,0
16,191,191,14,14,0,1,0
34,198,198,5,5,0,1,0
24,205,205,24,24,0,1,0
5,216,216,6,6,0,1,0
11,223,223,4,4,0,1,0
9,230,230,32,32,0,1,0
3,231,231,12,12,0,1,0
8,244,244,50,30,20,2,1
20,282,282,27,27,0,1,0
28,298,298,6,6,0,1,0
10,310,310,64,4,60,3,2
25,325,325,12,4,8,2,1
33,343,343,6,6,0,1,0
26,380,380,2,2,0,1,0
21,399,399,58,58,0,1,0
4,407,407,3,3,0,1,0
23,411,411,97,97,0,1,0
27,422,422,27,11,16,4,3
14,424,424,39,27,12,4,3
13,445,445,10,10,0,1,0
17,448,448,23,4,19,2,1
30,461,461,4,4,0,1,0
12,465,465,89,64,25,3,2
1,473,473,68,5,63,4,3
7,483,483,42,9,33,4,3
29,492,492,224,175,49,2,1

25,101,101,13,13,0,1,0
0,105,105,23,9,14,4,3
8,126,126,5,5,0,1,0
11,133,133,11,1,10,3,2
4,142,142,14,4,10,3,2
2,147,147,1,1,0,1,0
21,153,153,6,6,0,1,0
33,163,163,22,7,15,4,3
18,168,168,7,7,0,1,0
6,176,176,15,15,0,1,0
30,187,187,35,23,12,2,1
7,213,213,26,26,0,1,0
28,223,223,18,9,9,4,3
16,243,243,17,4,13,3,2
31,254,254,90,29,61,4,3
23,260,260,2,2,0,1,0
3,275,275,3,3,0,1,0
20,288,288,20,20,0,1,0
35,302,302,39,24,15,4,3
5,316,316,8,8,0,1,0
36,325,325,42,42,0,1,0
24,360,360,4,4,0,1,0
27,372,372,29,26,3,2,1
10,379,379,37,13,24,3,2
13,385,385,40,20,20,2,1
22,404,404,10,10,0,1,0
32,414,414,38,2,36,4,3
34,415,415,27,8,19,2,1
26,431,431,29,12,17,2,1
15,434,434,87,19,68,3,2
17,438,438,12,12,0,1,0
19,448,448,11,11,0,1,0
12,453,453,19,6,13,2,1
9,455,455,144,73,71,3,2
1,459,459,4,4,0,1,0
29,464,464,65,27,38,3,2
14,481,481,38,4,34,4,3

5,110,110,3,3,0,1,0
24,118,118,8,8,0,1,0
27,120,120,13,10,3,2,1
13,143,143,5,5,0,1,0
29,148,148,3,3,0,1,0
21,160,160,63,43,20,2,1
15,183,183,40,40,0,1,0
26,191,191,2,2,0,1,0
1,196,196,8,8,0,1,0
18,244,244,5,5,0,1,0
28,264,264,61,61,0,1,0
9,270,270,49,14,35,2,1
30,278,278,21,5,16,2,1
25,294,294,16,3,13,4,3
17,299,299,26,4,22,3,2
12,310,310,4,4,0,1,0
2,317,317,123,87,36,4,3
6,317,317,10,2,8,2,1
19,324,324,1,1,0,1,0
14,370,370,22,1,21,2,1
32,378,378,29,29,0,1,0
16,395,395,94,94,0,1,0
20,426,426,12,12,0,1,0
3,429,429,90,2,88,4,3
10,431,431,20,14,6,2,1
0,435,435,15,5,10,2,1
4,438,438,23,2,21,4,3
22,439,439,121,39,82,3,2
8,439,439,20,20,0,1,0
31,442,442,16,11,5,2,1
11,458,458,27,3,24,4,3
7,462,462,119,77,42,2,1
23,492,492,2,2,0,1,0

24,112,112,5,5,0,1,0
0,128,128,3,3,0,1,0
16,136,136,18,10,8,2,1
7,142,142,4,1,3,2,1
6,150,150,15,15,0,1,0
8,160,160,8,8,0,1,0
17,175,175,1,1,0,1,0
29,185,185,1,1,0,1,0
27,207,207,27,27,0,1,0
1,214,214,13,1,12,4,3
14,230,230,59,59,0,1,0
30,236,236,23,23,0,1,0
19,247,247,47,25,22,2,1
35,260,260,43,6,37,2,1
5,261,261,10,6,4,2,1
2,278,278,8,8,0,1,0
32,298,298,13,1,12,2,1
9,300,300,83,83,0,1,0
11,331,331,4,4,0,1,0
18,331,331,67,67,0,1,0
12,337,337,5,1,4,2,1
31,346,346,45,45,0,1,0
33,348,348,49,18,31,2,1
34,349,349,41,27,14,3,2
10,349,349,45,9,36,4,3
26,350,350,62,49,13,2,1
25,354,354,45,45,0,1,0
23,384,384,36,36,0,1,0
21,422,422,32,32,0,1,0
20,426,426,20,14,6,2,1
3,432,432,15,6,9,4,3
22,438,438,5,5,0,1,0
28,446,446,59,24,35,2,1
4,446,446,3,3,0,1,0
15,450,450,70,45,25,2,1
13,483,483,70,70,0,1,0

19,114,114,3,3,0,1,0
9,120,120,33,33,0,1,0
1,121,121,45,3,42,3,2
28,135,135,2,2,0,1,0
16,135,135,23,17,6,2,1
23,143,143,68,19,49,3,2
3,158,158,6,6,0,1,0
8,187,187,28,28,0,1,0
14,194,194,5,5,0,1,0
4,209,209,36,36,0,1,0
18,229,229,67,64,3,2,1
11,246,246,8,3,5,2,1
6,256,256,16,1,15,2,1
13,279,279,33,19,14,3,2
17,286,286,36,36,0,1,0
27,287,287,1,1,0,1,0
24,304,304,9,9,0,1,0
22,332,332,16,1,15,4,3
20,336,336,1,1,0,1,0
25,341,341,58,58,0,1,0
10,344,344,8,8,0,1,0
12,363,363,63,18,45,4,3
26,375,375,9,5,4,2,1
0,397,397,1,1,0,1,0
5,416,416,121,48,73,3,2
21,443,443,9,3,6,3,2
7,446,446,59,39,20,2,1
15,458,458,4,1,3,2,1
2,494,494,74,32,42,2,1

8,103,103,9,1,8,3,2
20,118,118,5,5,0,1,0
17,122,122,4,1,3,2,1
24,151,151,11,11,0,1,0
1,185,185,2,2,0,1,0
15,195,195,2,2,0,1,0
26,198,198,59,51,8,2,1
22,220,220,36,36,0,1,0
7,229,229,37,21,16,3,2
19,241,241,24,2,22,3,2
25,249,249,29,29,0,1,0
16,266,266,54,18,36,4,3
12,280,280,74,16,58,3,2
18,290,290,22,22,0,1,0
0,302,302,8,8,0,1,0
21,314,314,4,4,0,1,0
2,323,323,59,59,0,1,0
23,344,344,12,3,9,4,3
27,352,352,37,4,33,4,3
5,361,361,46,2,44,2,1
14,375,375,26,17,9,2,1
11,389,389,45,9,36,4,3
3,411,411,98,98,0,1,0
13,414,414,3,3,0,1,0
10,417,417,35,6,29,2,1
9,425,425,198,163,35,3,2
28,428,428,57,15,42,3,2
6,457,457,73,63,10,2,1
4,473,473,19,19,0,1,0

0,102,102,28,28,0,1,0
13,110,110,15,11,4,2,1
11,111,111,3,3,0,1,0
29,118,118,15,9,6,2,1
25,123,123,11,11,0,1,0
15,129,129,9,4,5,2,1
24,141,141,13,13,0,1,0
23,145,145,16,16,0,1,0
4,175,175,30,30,0,1,0
18,176,176,4,4,0,1,0
1,196,196,10,10,0,1,0
2,196,196,28,28,0,1,0
32,232,232,13,13,0,1,0
7,234,234,28,28,0,1,0
12,259,259,2,2,0,1,0
6,283,283,46,37,9,4,3
16,292,292,27,27,0,1,0
8,293,293,37,28,9,2,1
3,302,302,4,1,3,2,1
22,303,303,11,1,10,3,2
36,314,314,68,60,8,3,2
34,349,349,27,2,25,2,1
28,359,359,25,13,12,3,2
27,365,365,64,64,0,1,0
9,386,386,10,2,8,3,2
31,389,389,105,79,26,4,3
33,391,391,6,6,0,1,0
35,397,397,31,31,0,1,0
5,402,402,10,10,0,1,0
21,426,426,4,4,0,1,0
20,438,438,66,8,58,3,2
10,465,465,35,35,0,1,0
26,476,476,40,26,14,2,1
17,485,485,10,7,3,2,1
30,487,487,39,15,24,4,3
14,489,489,46,24,22,4,3
19,499,499,21,21,0,1,0

13,103,103,6,6,0,1,0
8,167,167,70,70,0,1,0
4,173,173,21,3,18,4,3
23,179,179,11,11,0,1,0
14,182,182,10,10,0,1,0
3,205,205,58,10,48,2,1
7,228,228,45,21,24,3,2
21,228,228,10,3,7,2,1
18,247,247,6,6,0,1,0
11,274,274,13,7,6,3,2
10,284,284,21,12,9,4,3
22,293,293,43,15,28,2,1
19,293,293,32,11,21,4,3
26,310,310,22,22,0,1,0
16,310,310,26,26,0,1,0
0,313,313,9,9,0,1,0
2,331,331,8,8,0,1,0
5,341,341,28,5,23,2,1
15,356,356,40,40,0,1,0
6,396,396,30,30,0,1,0
25,435,435,71,71,0,1,0
20,466,466,11,1,10,3,2
1,470,470,37,23,14,3,2
12,473,473,101,82,19,2,1
17,480,480,101,25,76,3,2
9,493,493,193,59,134,4,3
24,499,499,116,69,47,2,1

8,102,102,6,6,0,1,0
13,104,104,16,11,5,2,1
5,124,124,8,8,0,1,0
9,127,127,3,3,0,1,0
22,144,144,19,10,9,4,3
23,147,147,2,2,0,1,0
20,161,161,6,3,3,2,1
26,168,168,46,22,24,2,1
18,195,195,5,5,0,1,0
29,199,199,8,1,7,2,1
6,208,208,18,10,8,2,1
21,213,213,19,3,16,3,2
15,220,220,8,8,0,1,0
2,232,232,62,22,40,3,2
10,232,232,23,11,12,3,2
40,237,237,37,27,10,2,1
24,239,239,47,47,0,1,0
37,241,241,14,14,0,1,0
31,252,252,6,6,0,1,0
27,260,260,21,3,18,2,1
28,267,267,25,10,15,4,3
1,267,267,1,1,0,1,0
4,269,269,18,18,0,1,0
35,294,294,3,3,0,1,0
14,303,303,18,18,0,1,0
33,304,304,32,32,0,1,0
7,324,324,3,3,0,1,0
30,327,327,69,69,0,1,0
39,335,335,2,2,0,1,0
38,362,362,36,36,0,1,0
3,368,368,1,1,0,1,0
0,375,375,4,4,0,1,0
16,408,408,24,6,18,3,2
25,411,411,90,68,22,3,2
11,426,426,28,28,0,1,0
12,453,453,36,36,0,1,0
36,461,461,36,9,27,2,1
19,468,468,97,52,45,4,3
17,487,487,26,7,19,2,1
32,492,492,3,3,0,1,0
34,498,498,33,33,0,1,0

11,106,106,5,5,0,1,0
30,111,111,7,7,0,1,0
6,127,127,10,1,9,4,3
23,141,141,9,9,0,1,0
22,144,144,8,2,6,3,2
3,149,149,2,2,0,1,0
7,167,167,1,1,0,1,0
33,179,179,21,21,0,1,0
25,201,201,9,3,6,3,2
10,240,240,66,20,46,3,2
8,253,253,41,21,20,3,2
27,253,253,36,24,12,4,3
32,274,274,63,63,0,1,0
21,276,276,23,2,21,4,3
20,283,283,44,2,42,3,2
17,284,284,1,1,0,1,0
2,304,304,9,5,4,2,1
0,317,317,80,80,0,1,0
15,319,319,27,27,0,1,0
9,323,323,69,69,0,1,0
28,335,335,18,12,6,2,1
26,340,340,30,2,28,2,1
13,344,344,14,2,12,3,2
19,348,348,14,2,12,3,2
24,380,380,85,11,74,3,2
1,384,384,15,7,8,3,2
16,400,400,48,7,41,4,3
31,404,404,41,15,26,3,2
18,410,410,12,1,11,2,1
29,423,423,103,41,62,4,3
4,428,428,58,53,5,2,1
5,475,475,54,54,0,1,0
14,482,482,7,7,0,1,0
12,485,485,37,16,21,4,3

11,143,143,1,1,0,1,0
38,149,149,13,13,0,1,0
31,149,149,12,7,5,2,1
18,150,150,20,20,0,1,0
10,158,158,1,1,0,1,0
12,168,168,5,5,0,1,0
23,172,172,33,8,25,2,1
20,176,176,6,6,0,1,0
24,176,176,5,5,0,1,0
36,178,178,3,3,0,1,0
32,179,179,29,24,5,2,1
9,186,186,27,27,0,1,0
0,193,193,2,2,0,1,0
15,195,195,1,1,0,1,0
21,211,211,3,3,0,1,0
4,216,216,4,4,0,1,0
26,221,221,14,14,0,1,0
16,244,244,22,10,12,3,2
2,254,254,8,8,0,1,0
5,276,276,97,97,0,1,0
22,281,281,54,54,0,1,0
7,282,282,2,2,0,1,0
1,299,299,123,33,90,3,2
29,328,328,129,79,50,2,1
34,347,347,32,15,17,2,1
14,362,362,22,22,0,1,0
37,374,374,29,22,7,2,1
8,392,392,11,11,0,1,0
6,417,417,23,13,10,2,1
35,422,422,34,34,0,1,0
25,423,423,13,1,12,4,3
17,435,435,4,1,3,2,1
27,443,443,9,9,0,1,0
33,447,447,38,28,10,2,1
28,448,448,5,5,0,1,0
3,451,451,15,15,0,1,0
13,454,454,3,3,0,1,0
30,484,484,61,30,31,2,1
19,487,487,105,9,96,3,2

18,108,108,12,12,0,1,0
9,121,121,81,3,78,4,3
14,151,151,9,9,0,1,0
21,163,163,63,63,0,1,0
10,171,171,5,5,0,1,0
8,212,212,26,8,18,4,3
22,223,223,5,5,0,1,0
11,228,228,17,9,8,2,1
28,232,232,43,43,0,1,0
4,240,240,40,40,0,1,0
20,244,244,11,11,0,1,0
27,250,250,14,14,0,1,0
23,264,264,2,2,0,1,0
6,275,275,5,5,0,1,0
1,277,277,3,3,0,1,0
15,280,280,53,21,32,2,1
26,282,282,27,27,0,1,0
3,286,286,19,1,18,4,3
12,288,288,35,32,3,2,1
2,327,327,76,76,0,1,0
25,346,346,20,1,19,2,1
19,374,374,95,62,33,2,1
16,431,431,24,9,15,2,1
0,433,433,12,12,0,1,0
24,440,440,32,32,0,1,0
17,441,441,8,8,0,1,0
7,447,447,34,34,0,1,0
29,463,463,34,23,11,2,1
5,480,480,42,8,34,3,2
13,485,485,22,17,5,2,1

8,101,101,1,1,0,1,0
28,104,104,7,7,0,1,0
3,113,113,3,3,0,1,0
14,124,124,12,12,0,1,0
15,134,134,2,2,0,1,0
19,135,135,7,7,0,1,0
18,152,152,2,2,0,1,0
2,184,184,6,6,0,1,0
21,184,184,35,35,0,1,0
4,197,197,30,24,6,2,1
11,215,215,24,3,21,4,3
10,218,218,78,78,0,1,0
17,240,240,30,2,28,3,2
13,241,241,95,95,0,1,0
29,243,243,53,53,0,1,0
12,291,291,62,62,0,1,0
20,301,301,39,39,0,1,0
0,312,312,28,13,15,2,1
16,324,324,24,24,0,1,0
27,333,333,23,14,9,4,3
26,340,340,35,35,0,1,0
25,365,365,10,10,0,1,0
1,378,378,111,111,0,1,0
9,388,388,24,6,18,3,2
22,392,392,30,11,19,2,1
7,404,404,57,57,0,1,0
24,437,437,6,6,0,1,0
6,463,463,3,3,0,1,0
23,482,482,40,4,36,2,1
5,499,499,103,16,87,4,3

25,102,102,14,7,7,2,1
20,117,117,21,21,0,1,0
12,119,119,33,12,21,2,1
3,130,130,36,36,0,1,0
21,133,133,5,5,0,1,0
2,142,142,11,11,0,1,0
8,148,148,2,2,0,1,0
9,159,159,16,16,0,1,0
6,187,187,6,1,5,2,1
18,198,198,4,4,0,1,0
30,200,200,3,3,0,1,0
4,208,208,61,61,0,1,0
27,218,218,18,14,4,2,1
15,219,219,2,2,0,1,0
24,241,241,22,22,0,1,0
5,248,248,40,40,0,1,0
26,250,250,9,4,5,2,1
22,253,253,40,18,22,3,2
31,274,274,13,13,0,1,0
11,317,317,21,4,17,2,1
16,326,326,37,16,21,2,1
23,362,362,114,61,53,4,3
19,390,390,26,7,19,2,1
10,402,402,43,43,0,1,0
7,407,407,13,9,4,2,1
32,407,407,118,42,76,4,3
17,423,423,17,17,0,1,0
0,426,426,14,14,0,1,0
13,440,440,31,25,6,2,1
14,447,447,6,6,0,1,0
1,452,452,62,41,21,4,3
29,457,457,1,1,0,1,0
28,462,462,46,28,18,3,2

37,104,104,20,20,0,1,0
8,116,116,19,19,0,1,0
29,121,121,1,1,0,1,0
20,131,131,6,6,0,1,0
25,135,135,11,11,0,1,0
23,149,149,9,3,6,3,2
5,176,176,3,3,0,1,0
9,183,183,2,2,0,1,0
28,184,184,24,14,10,3,2
30,185,185,14,2,12,4,3
24,189,189,24,24,0,1,0
1,198,198,5,5,0,1,0
18,210,210,7,3,4,2,1
17,211,211,9,9,0,1,0
0,215,215,29,29,0,1,0
3,230,230,28,22,6,3,2
32,235,235,75,75,0,1,0
21,245,245,26,26,0,1,0
15,263,263,53,27,26,4,3
27,269,269,10,10,0,1,0
11,284,284,32,11,21,4,3
12,307,307,1,1,0,1,0
26,311,311,14,3,11,2,1
35,331,331,6,6,0,1,0
7,332,332,8,8,0,1,0
6,368,368,5,5,0,1,0
10,369,369,106,67,39,2,1
34,387,387,7,7,0,1,0
22,388,388,31,31,0,1,0
33,406,406,55,55,0,1,0
14,409,409,12,3,9,2,1
16,413,413,14,9,5,2,1
13,432,432,18,18,0,1,0
31,439,439,50,50,0,1,0
38,466,466,55,7,48,2,1
36,470,470,80,57,23,2,1
4,482,482,33,2,31,3,2
19,489,489,84,40,44,3,2
2,494,494,6,3,3,2,1

19,108,108,9,9,0,1,0
8,116,116,9,9,0,1,0
18,121,121,13,4,9,4,3
1,128,128,27,11,16,2,1
20,133,133,4,4,0,1,0
7,148,148,13,7,6,3,2
2,170,170,84,84,0,1,0
24,191,191,36,24,12,3,2
21,199,199,8,8,0,1,0
13,201,201,24,6,18,2,1
4,229,229,12,12,0,1,0
0,234,234,2,2,0,1,0
5,246,246,1,1,0,1,0
9,252,252,12,12,0,1,0
25,258,258,17,17,0,1,0
23,265,265,24,2,22,3,2
26,285,285,11,3,8,3,2
17,322,322,27,6,21,4,3
15,343,343,33,33,0,1,0
3,366,366,143,89,54,3,2
22,381,381,12,6,6,2,1
14,384,384,1,1,0,1,0
6,390,390,65,23,42,2,1
27,402,402,87,43,44,2,1
11,412,412,48,48,0,1,0
16,428,428,43,43,0,1,0
12,460,460,151,151,0,1,0
10,486,486,78,78,0,1,0

10,103,103,2,2,0,1,0
15,104,104,1,1,0,1,0
29,111,111,33,33,0,1,0
11,116,116,12,12,0,1,0
33,116,116,2,2,0,1,0
30,132,132,37,6,31,2,1
34,158,158,24,24,0,1,0
17,170,170,9,3,6,3,2
14,171,171,15,11,4,2,1
35,184,184,5,1,4,2,1
28,192,192,16,3,13,2,1
20,199,199,9,1,8,2,1
24,202,202,15,4,11,2,1
4,212,212,10,10,0,1,0
12,212,212,36,36,0,1,0
19,212,212,7,2,5,2,1
7,224,224,43,9,34,4,3
31,226,226,35,13,22,3,2
23,228,228,15,15,0,1,0
32,238,238,42,27,15,2,1
25,257,257,30,8,22,3,2
22,261,261,15,12,3,2,1
18,303,303,9,3,6,2,1
9,308,308,89,64,25,2,1
2,322,322,46,46,0,1,0
3,365,365,35,1,34,2,1
1,386,386,9,4,5,2,1
13,386,386,3,3,0,1,0
6,388,388,26,26,0,1,0
21,414,414,25,9,16,2,1
16,444,444,36,36,0,1,0
27,456,456,44,24,20,2,1
5,458,458,49,21,28,4,3
26,464,464,4,4,0,1,0
0,467,467,74,74,0,1,0
8,479,479,8,8,0,1,0

27,102,102,3,3,0,1,0
25,151,151,5,5,0,1,0
2,196,196,4,4,0,1,0
12,206,206,11,2,9,4,3
16,215,215,2,2,0,1,0
15,241,241,94,56,38,3,2
9,280,280,13,5,8,2,1
23,292,292,7,7,0,1,0
7,296,296,4,4,0,1,0
26,338,338,2,2,0,1,0
13,360,360,18,2,16,3,2
11,365,365,29,29,0,1,0
4,372,372,36,22,14,2,1
1,372,372,45,45,0,1,0
10,377,377,49,49,0,1,0
14,380,380,31,20,11,2,1
8,381,381,65,53,12,2,1
28,391,391,49,42,7,2,1
0,424,424,225,225,0,1,0
5,426,426,9,6,3,2,1
21,427,427,31,11,20,3,2
3,432,432,6,6,0,1,0
29,438,438,143,29,114,4,3
24,448,448,41,41,0,1,0
20,452,452,122,22,100,3,2
6,454,454,184,174,10,3,2
19,470,470,59,59,0,1,0
17,470,470,25,25,0,1,0
22,473,473,15,15,0,1,0
18,482,482,7,7,0,1,0

22,107,107,18,10,8,3,2
13,108,108,9,2,7,2,1
14,109,109,2,2,0,1,0
8,110,110,32,32,0,1,0
11,120,120,1,1,0,1,0
19,127,127,12,12,0,1,0
9,133,133,27,7,20,2,1
4,137,137,69,69,0,1,0
27,174,174,7,2,5,2,1
21,175,175,1,1,0,1,0
25,175,175,3,3,0,1,0
6,222,222,30,14,16,2,1
18,275,275,126,30,96,3,2
5,286,286,6,6,0,1,0
12,300,300,81,81,0,1,0
3,324,324,25,25,0,1,0
28,348,348,9,9,0,1,0
29,373,373,1,1,0,1,0
26,392,392,88,88,0,1,0
16,399,399,84,58,26,3,2
20,414,414,24,24,0,1,0
2,422,422,14,2,12,2,1
17,427,427,8,8,0,1,0
7,429,429,9,9,0,1,0
15,432,432,4,4,0,1,0
1,449,449,20,20,0,1,0
24,475,475,99,19,80,3,2
0,486,486,32,32,0,1,0
10,490,490,13,13,0,1,0
23,491,491,46,46,0,1,0

0,106,106,6,1,5,2,1
29,110,110,24,12,12,4,3
4,116,116,27,27,0,1,0
18,143,143,14,10,4,2,1
24,150,150,13,7,6,3,2
21,154,154,11,1,10,3,2
33,167,167,3,3,0,1,0
13,198,198,15,15,0,1,0
5,244,244,33,9,24,4,3
7,253,253,8,2,6,2,1
25,254,254,38,35,3,2,1
12,257,257,12,12,0,1,0
15,259,259,16,16,0,1,0
9,262,262,27,27,0,1,0
22,265,265,46,46,0,1,0
27,266,266,2,2,0,1,0
2,291,291,8,8,0,1,0
6,299,299,53,53,0,1,0
28,317,317,83,83,0,1,0
3,327,327,50,24,26,3,2
20,341,341,14,14,0,1,0
26,350,350,2,2,0,1,0
32,359,359,18,18,0,1,0
34,381,381,29,8,21,2,1
10,390,390,1,1,0,1,0
14,397,397,3,3,0,1,0
1,400,400,67,54,13,2,1
19,404,404,15,15,0,1,0
8,404,404,52,25,27,4,3
30,408,408,18,8,10,3,2
23,417,417,79,16,63,4,3
31,417,417,62,62,0,1,0
17,434,434,14,14,0,1,0
35,436,436,66,6,60,4,3
11,461,461,32,8,24,3,2
16,468,468,46,46,0,1,0

1,112,112,39,3,36,3,2
26,112,112,11,11,0,1,0
28,125,125,2,2,0,1,0
3,129,129,18,18,0,1,0
32,146,146,21,21,0,1,0
10,146,146,8,5,3,2,1
8,151,151,10,10,0,1,0
22,151,151,8,8,0,1,0
14,177,177,5,2,3,2,1
2,177,177,4,4,0,1,0
31,183,183,65,24,41,4,3
12,200,200,17,17,0,1,0
30,207,207,8,8,0,1,0
7,215,215,8,8,0,1,0
29,231,231,1,1,0,1,0
35,236,236,71,71,0,1,0
17,240,240,9,3,6,3,2
27,242,242,15,10,5,2,1
13,300,300,14,2,12,4,3
16,307,307,9,1,8,2,1
15,345,345,12,12,0,1,0
23,358,358,78,74,4,2,1
5,360,360,40,14,26,3,2
19,364,364,75,34,41,2,1
25,389,389,41,25,16,2,1
9,398,398,26,3,23,2,1
6,406,406,26,7,19,2,1
21,411,411,1,1,0,1,0
11,430,430,13,13,0,1,0
0,432,432,102,102,0,1,0
20,434,434,26,11,15,4,3
33,476,476,4,4,0,1,0
36,482,482,10,10,0,1,0
24,484,484,48,34,14,3,2
18,493,493,10,10,0,1,0
4,494,494,19,7,12,3,2
34,500,500,74,74,0,1,0

6,122,122,2,2,0,1,0
1,125,125,5,5,0,1,0
14,138,138,8,2,6,3,2
10,158,158,6,6,0,1,0
4,161,161,11,1,10,2,1
27,165,165,11,11,0,1,0
25,193,193,2,2,0,1,0
9,214,214,5,5,0,1,0
32,231,231,47,47,0,1,0
8,237,237,13,4,9,4,3
18,277,277,11,11,0,1,0
30,291,291,10,10,0,1,0
23,295,295,27,27,0,1,0
22,307,307,51,51,0,1,0
34,327,327,51,51,0,1,0
28,333,333,6,6,0,1,0
31,338,338,48,48,0,1,0
21,363,363,17,2,15,4,3
2,373,373,1,1,0,1,0
19,375,375,7,1,6,2,1
16,383,383,41,41,0,1,0
0,405,405,1,1,0,1,0
5,410,410,70,70,0,1,0
15,411,411,161,161,0,1,0
11,430,430,80,5,75,4,3
17,432,432,45,18,27,2,1
33,435,435,39,15,24,3,2
3,439,439,95,1,94,3,2
12,440,440,18,18,0,1,0
29,457,457,10,2,8,2,1
24,460,460,70,48,22,2,1
13,477,477,18,10,8,3,2
26,499,499,105,72,33,4,3
7,499,499,71,23,48,3,2
20,500,500,132,132,0,1,0

14,120,120,18,10,8,3,2
19,121,121,7,7,0,1,0
7,141,141,17,10,7,2,1
13,145,145,32,32,0,1,0
22,153,153,2,2,0,1,0
31,168,168,29,3,26,2,1
15,173,173,4,1,3,2,1
20,201,201,9,6,3,2,1
0,202,202,10,3,7,2,1
2,228,228,6,6,0,1,0
12,231,231,24,24,0,1,0
29,234,234,2,2,0,1,0
30,250,250,9,9,0,1,0
25,259,259,36,36,0,1,0
10,271,271,7,7,0,1,0
24,276,276,48,18,30,4,3
27,278,278,72,22,50,3,2
23,279,279,27,27,0,1,0
1,301,301,1,1,0,1,0
16,323,323,12,12,0,1,0
26,328,328,38,38,0,1,0
28,330,330,77,77,0,1,0
17,331,331,13,13,0,1,0
6,331,331,63,55,8,2,1
11,335,335,3,3,0,1,0
21,357,357,82,82,0,1,0
9,361,361,24,24,0,1,0
3,363,363,26,26,0,1,0
8,378,378,50,11,39,2,1
18,402,402,25,25,0,1,0
5,432,432,223,163,60,4,3
4,474,474,10,10,0,1,0

26,111,111,34,16,18,2,1
0,118,118,15,15,0,1,0
12,154,154,15,7,8,3,2
1,175,175,1,1,0,1,0
19,199,199,36,36,0,1,0
6,216,216,15,15,0,1,0
15,223,223,17,11,6,3,2
7,229,229,38,38,0,1,0
24,240,240,11,11,0,1,0
23,291,291,21,21,0,1,0
14,294,294,61,61,0,1,0
29,298,298,8,8,0,1,0
3,300,300,33,33,0,1,0
2,317,317,1,1,0,1,0
30,323,323,42,27,15,2,1
20,325,325,6,3,3,2,1
9,329,329,44,27,17,2,1
4,348,348,24,8,16,2,1
25,363,363,2,2,0,1,0
21,367,367,5,5,0,1,0
13,380,380,3,3,0,1,0
22,417,417,39,30,9,2,1
17,423,423,7,7,0,1,0
10,434,434,13,13,0,1,0
27,434,434,19,4,15,2,1
31,439,439,145,49,96,4,3
5,457,457,108,108,0,1,0
28,459,459,4,4,0,1,0
11,470,470,56,43,13,2,1
32,477,477,16,9,7,2,1
18,495,495,73,56,17,2,1
8,495,495,121,121,0,1,0
16,499,499,125,64,61,3,2

24,111,111,5,5,0,1,0
34,113,113,5,5,0,1,0
29,132,132,16,16,0,1,0
16,146,146,8,2,6,3,2
12,158,158,11,11,0,1,0
20,164,164,38,38,0,1,0
25,170,170,6,2,4,2,1
3,195,195,4,4,0,1,0
11,196,196,1,1,0,1,0
0,199,199,26,26,0,1,0
10,201,201,1,1,0,1,0
14,202,202,12,3,9,2,1
27,203,203,31,2,29,2,1
40,240,240,39,22,17,2,1
7,253,253,11,2,9,2,1
30,270,270,20,11,9,2,1
37,281,281,10,10,0,1,0
5,284,284,9,9,0,1,0
8,292,292,18,18,0,1,0
21,308,308,1,1,0,1,0
35,314,314,140,140,0,1,0
13,320,320,24,24,0,1,0
19,322,322,15,15,0,1,0
2,329,329,1,1,0,1,0
4,352,352,46,5,41,3,2
33,364,364,15,12,3,2,1
31,377,377,5,5,0,1,0
39,389,389,62,10,52,3,2
32,407,407,30,1,29,2,1
15,409,409,15,15,0,1,0
18,418,418,20,10,10,3,2
36,426,426,4,4,0,1,0
41,430,430,22,8,14,3,2
17,434,434,24,24,0,1,0
1,449,449,33,23,10,3,2
22,456,456,57,5,52,4,3
6,458,458,53,53,0,1,0
38,458,458,86,15,71,4,3
28,467,467,3,3,0,1,0
26,469,469,57,7,50,3,2
9,479,479,34,18,16,2,1
23,491,491,80,26,54,3,2

23,108,108,5,5,0,1,0
18,111,111,9,1,8,3,2
10,128,128,4,4,0,1,0
8,130,130,9,6,3,2,1
29,146,146,8,8,0,1,0
28,157,157,23,14,9,2,1
15,165,165,20,20,0,1,0
32,186,186,31,31,0,1,0
13,196,196,7,7,0,1,0
30,197,197,15,15,0,1,0
2,198,198,8,8,0,1,0
26,199,199,28,7,21,4,3
1,207,207,33,33,0,1,0
9,216,216,10,3,7,2,1
17,219,219,12,12,0,1,0
5,239,239,51,6,45,2,1
6,259,259,46,46,0,1,0
7,259,259,10,10,0,1,0
37,261,261,1,1,0,1,0
22,279,279,2,2,0,1,0
4,293,293,11,5,6,2,1
3,319,319,15,15,0,1,0
27,319,319,22,22,0,1,0
38,335,335,7,7,0,1,0
31,338,338,95,83,12,3,2
0,349,349,10,5,5,2,1
36,361,361,44,22,22,2,1
12,362,362,11,11,0,1,0
25,368,368,37,37,0,1,0
33,390,390,6,6,0,1,0
34,396,396,91,33,58,3,2
21,397,397,37,3,34,2,1
16,401,401,4,4,0,1,0
19,435,435,23,1,22,2,1
14,435,435,11,11,0,1,0
24,454,454,61,37,24,4,3
20,457,457,21,21,0,1,0
11,488,488,128,8,120,4,3
35,497,497,63,63,0,1,0

11,103,103,8,8,0,1,0
18,112,112,5,5,0,1,0
1,118,118,12,6,6,2,1
6,125,125,24,10,14,2,1
9,177,177,1,1,0,1,0
33,180,180,9,9,0,1,0
26,182,182,28,28,0,1,0
16,206,206,9,3,6,2,1
3,209,209,1,1,0,1,0
34,210,210,71,19,52,3,2
30,211,211,22,22,0,1,0
4,222,222,10,10,0,1,0
5,232,232,22,22,0,1,0
37,234,234,4,4,0,1,0
13,245,245,31,3,28,3,2
32,283,283,19,11,8,2,1
22,288,288,22,22,0,1,0
28,290,290,20,11,9,4,3
14,297,297,12,4,8,2,1
12,304,304,21,6,15,4,3
17,313,313,42,5,37,2,1
31,313,313,44,44,0,1,0
10,314,314,10,5,5,2,1
21,321,321,3,3,0,1,0
36,328,328,45,35,10,4,3
35,335,335,10,10,0,1,0
15,338,338,47,47,0,1,0
19,351,351,19,19,0,1,0
24,364,364,51,51,0,1,0
25,370,370,28,5,23,2,1
2,384,384,71,71,0,1,0
0,391,391,8,8,0,1,0
20,416,416,26,26,0,1,0
23,419,419,105,105,0,1,0
7,420,420,60,18,42,2,1
8,422,422,36,17,19,2,1
27,435,435,8,2,6,3,2
29,485,485,27,27,0,1,0

1,111,111,2,2,0,1,0
0,113,113,8,1,7,2,1
11,130,130,1,1,0,1,0
14,137,137,5,5,0,1,0
35,143,143,11,2,9,2,1
13,148,148,18,18,0,1,0
21,150,150,17,9,8,3,2
6,165,165,8,8,0,1,0
15,166,166,15,15,0,1,0
39,168,168,5,5,0,1,0
23,175,175,35,13,22,3,2
10,202,202,33,33,0,1,0
24,202,202,50,9,41,4,3
19,219,219,32,32,0,1,0
3,221,221,36,36,0,1,0
27,231,231,21,21,0,1,0
37,255,255,27,27,0,1,0
33,256,256,9,1,8,3,2
31,260,260,20,10,10,3,2
28,279,279,28,16,12,2,1
8,284,284,17,17,0,1,0
32,285,285,10,3,7,2,1
22,286,286,7,3,4,2,1
34,295,295,54,26,28,3,2
12,305,305,12,4,8,2,1
16,313,313,4,4,0,1,0
17,319,319,27,27,0,1,0
4,322,322,11,11,0,1,0
20,339,339,5,2,3,2,1
26,361,361,15,8,7,2,1
38,381,381,5,5,0,1,0
18,385,385,67,67,0,1,0
9,407,407,17,17,0,1,0
29,407,407,87,23,64,4,3
25,408,408,56,8,48,2,1
30,434,434,60,39,21,4,3
2,444,444,18,5,13,2,1
7,471,471,66,24,42,3,2
5,488,488,27,27,0,1,0
36,490,490,1,1,0,1,0

5,109,109,9,9,0,1,0
19,113,113,10,1,9,2,1
11,115,115,1,1,0,1,0
34,144,144,6,6,0,1,0
31,152,152,47,47,0,1,0
37,171,171,11,11,0,1,0
10,194,194,12,1,11,2,1
6,203,203,28,4,24,2,1
26,209,209,55,7,48,3,2
1,214,214,19,15,4,2,1
8,230,230,3,3,0,1,0
13,248,248,30,30,0,1,0
14,261,261,43,28,15,4,3
24,264,264,24,2,22,3,2
15,264,264,15,15,0,1,0
18,271,271,57,57,0,1,0
2,276,276,9,9,0,1,0
25,281,281,5,1,4,2,1
21,300,300,9,9,0,1,0
16,301,301,8,8,0,1,0
9,305,305,21,21,0,1,0
38,306,306,10,10,0,1,0
0,321,321,25,25,0,1,0
30,328,328,25,7,18,3,2
12,340,340,36,36,0,1,0
29,357,357,13,4,9,2,1
20,396,396,2,2,0,1,0
35,396,396,58,28,30,2,1
33,419,419,15,2,13,2,1
4,430,430,23,17,6,2,1
28,439,439,30,18,12,2,1
27,450,450,13,13,0,1,0
32,456,456,31,22,9,2,1
22,461,461,153,153,0,1,0
3,462,462,38,25,13,2,1
36,474,474,22,22,0,1,0
17,477,477,5,5,0,1,0
7,482,482,84,16,68,3,2
23,487,487,33,3,30,2,1

27,106,106,1,1,0,1,0
9,120,120,17,4,13,2,1
17,121,121,3,3,0,1,0
3,134,134,134,78,56,3,2
10,135,135,1,1,0,1,0
16,170,170,29,21,8,3,2
8,172,172,1,1,0,1,0
6,194,194,13,1,12,3,2
11,229,229,6,6,0,1,0
14,229,229,6,6,0,1,0
1,244,244,15,15,0,1,0
23,246,246,8,8,0,1,0
15,256,256,4,1,3,2,1
26,288,288,34,2,32,2,1
29,292,292,57,57,0,1,0
5,305,305,2,2,0,1,0
22,313,313,36,36,0,1,0
28,328,328,64,10,54,4,3
20,343,343,151,69,82,3,2
19,348,348,19,19,0,1,0
12,375,375,31,18,13,2,1
0,394,394,24,24,0,1,0
18,427,427,57,19,38,4,3
24,428,428,41,41,0,1,0
13,431,431,13,4,9,2,1
25,436,436,10,10,0,1,0
7,453,453,41,41,0,1,0
4,471,471,22,22,0,1,0
21,496,496,26,26,0,1,0
2,496,496,52,52,0,1,0

25,101,101,7,7,0,1,0
9,113,113,3,3,0,1,0
27,115,115,17,17,0,1,0
1,138,138,4,4,0,1,0
36,153,153,6,6,0,1,0
24,153,153,17,1,16,3,2
10,159,159,19,19,0,1,0
4,184,184,4,4,0,1,0
21,211,211,10,2,8,3,2
2,220,220,1,1,0,1,0
16,228,228,21,13,8,2,1
35,231,231,68,62,6,2,1
33,238,238,2,2,0,1,0
17,242,242,12,12,0,1,0
23,247,247,8,8,0,1,0
6,250,250,35,23,12,2,1
28,277,277,2,2,0,1,0
15,281,281,35,32,3,2,1
14,287,287,9,2,7,2,1
3,311,311,19,12,7,2,1
12,323,323,27,27,0,1,0
18,334,334,31,31,0,1,0
31,345,345,30,22,8,3,2
8,388,388,26,26,0,1,0
26,393,393,25,13,12,4,3
7,401,401,37,8,29,2,1
29,409,409,91,5,86,3,2
32,417,417,20,2,18,4,3
11,430,430,1,1,0,1,0
19,432,432,21,12,9,2,1
22,436,436,91,70,21,2,1
20,460,460,11,11,0,1,0
5,467,467,198,189,9,4,3
0,468,468,33,18,15,4,3
13,470,470,56,56,0,1,0
34,481,481,114,114,0,1,0
30,494,494,42,42,0,1,0

16,106,106,14,2,12,4,3
26,111,111,17,8,9,4,3
11,121,121,10,10,0,1,0
34,124,124,11,11,0,1,0
30,157,157,26,10,16,3,2
21,160,160,6,2,4,2,1
7,166,166,38,38,0,1,0
29,182,182,3,3,0,1,0
8,193,193,45,45,0,1,0
0,208,208,2,2,0,1,0
18,217,217,6,3,3,2,1
14,221,221,15,15,0,1,0
28,221,221,7,7,0,1,0
9,225,225,20,5,15,4,3
5,232,232,37,16,21,2,1
2,254,254,2,2,0,1,0
13,257,257,4,4,0,1,0
4,279,279,13,1,12,4,3
6,288,288,36,15,21,4,3
3,292,292,25,7,18,3,2
10,318,318,7,7,0,1,0
31,319,319,8,8,0,1,0
1,320,320,73,73,0,1,0
12,322,322,34,16,18,4,3
23,336,336,21,21,0,1,0
22,357,357,156,106,50,3,2
20,366,366,69,69,0,1,0
27,378,378,10,10,0,1,0
15,386,386,3,3,0,1,0
24,454,454,47,17,30,3,2
19,461,461,28,19,9,4,3
32,464,464,114,114,0,1,0
33,474,474,2,2,0,1,0
17,487,487,26,26,0,1,0
25,489,489,31,19,12,3,2

23,126,126,1,1,0,1,0
28,131,131,32,32,0,1,0
10,134,134,15,3,12,4,3
35,140,140,15,15,0,1,0
20,141,141,1,1,0,1,0
30,143,143,17,7,10,3,2
5,161,161,12,12,0,1,0
27,164,164,19,1,18,2,1
13,172,172,1,1,0,1,0
26,182,182,36,12,24,3,2
34,195,195,8,8,0,1,0
16,196,196,1,1,0,1,0
21,216,216,13,13,0,1,0
33,229,229,29,29,0,1,0
2,235,235,9,6,3,2,1
9,248,248,5,5,0,1,0
25,258,258,16,4,12,3,2
1,267,267,1,1,0,1,0
7,268,268,85,69,16,3,2
22,271,271,41,41,0,1,0
4,280,280,96,3,93,4,3
18,335,335,1,1,0,1,0
32,348,348,54,27,27,2,1
8,351,351,30,30,0,1,0
0,360,360,28,6,22,3,2
11,384,384,130,90,40,2,1
17,390,390,29,29,0,1,0
31,393,393,1,1,0,1,0
12,398,398,24,24,0,1,0
29,402,402,44,44,0,1,0
24,424,424,51,33,18,4,3
3,426,426,32,32,0,1,0
19,433,433,48,48,0,1,0
6,438,438,23,2,21,2,1
14,442,442,5,1,4,2,1
15,485,485,1,1,0,1,0

25,140,140,7,7,0,1,0
7,144,144,39,17,22,3,2
33,145,145,3,3,0,1,0
16,160,160,8,4,4,2,1
23,172,172,75,28,47,2,1
21,176,176,2,2,0,1,0
32,186,186,27,9,18,4,3
8,209,209,24,24,0,1,0
2,214,214,39,36,3,2,1
34,241,241,3,3,0,1,0
14,257,257,27,27,0,1,0
28,261,261,8,2,6,2,1
29,267,267,95,95,0,1,0
19,278,278,1,1,0,1,0
6,283,283,4,4,0,1,0
4,283,283,14,6,8,2,1
37,299,299,65,17,48,2,1
27,299,299,8,8,0,1,0
12,299,299,4,4,0,1,0
0,307,307,48,48,0,1,0
22,311,311,8,8,0,1,0
9,319,319,12,12,0,1,0
18,323,323,9,4,5,2,1
15,324,324,4,4,0,1,0
35,346,346,16,16,0,1,0
38,348,348,53,53,0,1,0
13,358,358,12,12,0,1,0
3,378,378,55,55,0,1,0
31,380,380,15,3,12,3,2
17,384,384,51,51,0,1,0
30,390,390,8,8,0,1,0
20,411,411,57,57,0,1,0
5,416,416,58,58,0,1,0
24,438,438,13,13,0,1,0
11,442,442,1,1,0,1,0
1,444,444,11,6,5,2,1
10,455,455,16,9,7,2,1
26,471,471,37,18,19,2,1
36,473,473,17,17,0,1,0

2,117,117,22,4,18,2,1
11,121,121,5,2,3,2,1
13,123,123,2,2,0,1,0
30,124,124,8,2,6,2,1
26,133,133,37,10,27,4,3
12,134,134,9,1,8,2,1
20,138,138,11,4,7,2,1
1,143,143,1,1,0,1,0
3,167,167,3,3,0,1,0
9,182,182,11,11,0,1,0
10,197,197,5,5,0,1,0
28,199,199,44,30,14,3,2
41,209,209,1,1,0,1,0
5,212,212,9,9,0,1,0
25,213,213,11,11,0,1,0
24,253,253,2,2,0,1,0
29,272,272,35,15,20,3,2
31,287,287,43,14,29,2,1
7,288,288,21,21,0,1,0
17,292,292,10,10,0,1,0
19,305,305,1,1,0,1,0
35,314,314,11,11,0,1,0
18,329,329,110,110,0,1,0
16,341,341,35,14,21,4,3
6,342,342,56,56,0,1,0
8,345,345,33,11,22,2,1
15,357,357,17,17,0,1,0
40,365,365,69,37,32,3,2
21,366,366,1,1,0,1,0
27,367,367,115,22,93,4,3
34,375,375,20,13,7,2,1
33,398,398,14,9,5,2,1
22,421,421,28,13,15,4,3
0,425,425,1,1,0,1,0
4,429,429,55,55,0,1,0
36,433,433,4,4,0,1,0
39,464,464,15,3,12,3,2
14,465,465,35,24,11,2,1
23,473,473,8,8,0,1,0
37,486,486,11,11,0,1,0
38,500,500,49,49,0,1,0
32,500,500,22,22,0,1,0

33,109,109,8,8,0,1,0
2,120,120,22,14,8,2,1
32,129,129,3,3,0,1,0
27,140,140,20,17,3,2,1
18,145,145,1,1,0,1,0
3,172,172,15,9,6,2,1
17,189,189,12,7,5,2,1
34,196,196,9,9,0,1,0
13,206,206,17,17,0,1,0
15,207,207,7,7,0,1,0
38,227,227,38,14,24,4,3
37,243,243,29,5,24,2,1
31,250,250,6,1,5,2,1
29,253,253,34,34,0,1,0
28,272,272,18,18,0,1,0
9,275,275,12,12,0,1,0
30,278,278,51,51,0,1,0
35,293,293,14,14,0,1,0
25,303,303,89,61,28,3,2
19,304,304,80,80,0,1,0
5,306,306,96,1,95,4,3
23,315,315,46,35,11,2,1
26,324,324,5,5,0,1,0
24,340,340,22,22,0,1,0
6,347,347,16,16,0,1,0
21,348,348,35,11,24,2,1
22,367,367,14,14,0,1,0
10,370,370,3,3,0,1,0
1,382,382,13,4,9,4,3
39,405,405,21,5,16,3,2
20,416,416,5,1,4,2,1
7,421,421,37,37,0,1,0
36,433,433,60,60,0,1,0
14,437,437,44,25,19,2,1
11,450,450,7,1,6,2,1
0,454,454,42,28,14,3,2
12,460,460,1,1,0,1,0
4,466,466,1,1,0,1,0
8,495,495,14,14,0,1,0
16,499,499,28,9,19,2,1

27,118,118,16,1,15,4,3
8,120,120,31,24,7,2,1
30,122,122,22,2,20,2,1
3,130,130,47,15,32,3,2
13,154,154,3,3,0,1,0
5,155,155,12,12,0,1,0
34,167,167,1,1,0,1,0
2,174,174,8,2,6,2,1
19,185,185,34,34,0,1,0
31,212,212,40,40,0,1,0
26,215,215,9,1,8,3,2
4,242,242,2,2,0,1,0
24,258,258,20,20,0,1,0
20,266,266,12,1,11,2,1
16,268,268,21,9,12,4,3
10,285,285,1,1,0,1,0
6,298,298,52,27,25,2,1
32,320,320,22,22,0,1,0
28,345,345,59,24,35,3,2
14,360,360,21,7,14,2,1
21,386,386,17,17,0,1,0
15,391,391,16,16,0,1,0
9,398,398,30,30,0,1,0
33,407,407,40,40,0,1,0
29,415,415,6,6,0,1,0
11,416,416,16,6,10,2,1
12,420,420,53,53,0,1,0
1,443,443,27,27,0,1,0
25,444,444,27,3,24,4,3
7,456,456,69,34,35,2,1
0,464,464,9,5,4,2,1
18,478,478,20,6,14,2,1
23,483,483,167,113,54,3,2
22,495,495,15,7,8,3,2
17,496,496,51,24,27,2,1

28,133,133,30,7,23,2,1
22,136,136,7,7,0,1,0
29,137,137,8,8,0,1,0
32,151,151,1,1,0,1,0
4,155,155,4,4,0,1,0
15,166,166,8,8,0,1,0
18,190,190,37,2,35,2,1
19,201,201,6,6,0,1,0
26,228,228,13,13,0,1,0
16,247,247,13,13,0,1,0
5,252,252,35,35,0,1,0
6,282,282,16,16,0,1,0
12,294,294,10,10,0,1,0
0,336,336,22,17,5,2,1
1,340,340,66,2,64,4,3
7,342,342,24,24,0,1,0
20,347,347,30,22,8,3,2
24,358,358,38,38,0,1,0
3,360,360,28,28,0,1,0
21,363,363,125,125,0,1,0
9,395,395,3,3,0,1,0
31,403,403,62,62,0,1,0
33,404,404,23,23,0,1,0
14,424,424,32,4,28,3,2
11,426,426,32,32,0,1,0
25,428,428,1,1,0,1,0
8,428,428,220,117,103,4,3
17,445,445,29,29,0,1,0
2,459,459,19,6,13,2,1
23,461,461,71,21,50,2,1
30,468,468,36,15,21,2,1
13,469,469,6,2,4,2,1
10,483,483,103,103,0,1,0
27,487,487,31,13,18,3,2

3,100,100,7,2,5,2,1
6,101,101,40,40,0,1,0
2,109,109,19,12,7,2,1
12,115,115,3,3,0,1,0
15,118,118,13,10,3,2,1
16,147,147,7,7,0,1,0
19,194,194,42,1,41,2,1
23,199,199,1,1,0,1,0
24,200,200,8,5,3,2,1
10,203,203,31,13,18,3,2
13,213,213,2,2,0,1,0
27,223,223,77,56,21,2,1
11,223,223,2,2,0,1,0
25,250,250,20,5,15,2,1
28,251,251,18,6,12,4,3
4,292,292,3,3,0,1,0
9,297,297,35,32,3,2,1
14,315,315,49,17,32,3,2
20,315,315,53,31,22,3,2
17,324,324,4,1,3,2,1
5,324,324,2,2,0,1,0
18,329,329,9,9,0,1,0
1,344,344,27,27,0,1,0
22,348,348,58,24,34,4,3
21,362,362,31,7,24,4,3
7,384,384,51,51,0,1,0
26,411,411,24,4,20,2,1
8,427,427,159,78,81,4,3
29,434,434,57,57,0,1,0
0,496,496,77,77,0,1,0

7,135,135,8,8,0,1,0
36,136,136,20,20,0,1,0
5,144,144,38,38,0,1,0
1,147,147,6,3,3,2,1
23,153,153,14,6,8,3,2
28,156,156,42,30,12,4,3
16,160,160,17,17,0,1,0
21,180,180,10,10,0,1,0
10,197,197,15,2,13,2,1
29,207,207,13,8,5,2,1
3,218,218,3,3,0,1,0
12,242,242,37,37,0,1,0
6,244,244,1,1,0,1,0
31,256,256,50,50,0,1,0
20,257,257,12,12,0,1,0
22,265,265,3,3,0,1,0
18,283,283,2,2,0,1,0
26,306,306,4,4,0,1,0
0,308,308,10,10,0,1,0
19,314,314,16,2,14,3,2
32,320,320,15,15,0,1,0
14,320,320,49,8,41,4,3
15,325,325,1,1,0,1,0
30,344,344,29,24,5,2,1
39,357,357,10,2,8,2,1
25,361,361,11,11,0,1,0
11,378,378,5,1,4,2,1
33,388,388,22,22,0,1,0
35,404,404,106,26,80,3,2
34,419,419,54,54,0,1,0
27,420,420,3,3,0,1,0
38,423,423,103,70,33,2,1
2,427,427,35,35,0,1,0
4,430,430,22,22,0,1,0
24,436,436,9,9,0,1,0
17,465,465,38,24,14,3,2
37,466,466,20,11,9,4,3
13,468,468,41,37,4,2,1
9,493,493,130,73,57,4,3
8,498,498,23,23,0,1,0

30,113,113,43,43,0,1,0
4,133,133,3,3,0,1,0
25,137,137,8,8,0,1,0
7,143,143,44,44,0,1,0
17,147,147,9,9,0,1,0
19,167,167,32,32,0,1,0
9,170,170,55,55,0,1,0
2,180,180,38,38,0,1,0
14,191,191,12,6,6,2,1
23,194,194,32,32,0,1,0
32,202,202,23,7,16,3,2
26,204,204,4,4,0,1,0
5,215,215,21,12,9,2,1
12,236,236,13,4,9,2,1
8,247,247,4,4,0,1,0
11,262,262,13,13,0,1,0
29,270,270,30,21,9,2,1
28,277,277,18,18,0,1,0
10,287,287,1,1,0,1,0
0,313,313,48,48,0,1,0
18,322,322,7,7,0,1,0
13,329,329,11,6,5,2,1
3,334,334,9,2,7,2,1
1,372,372,38,38,0,1,0
24,373,373,24,24,0,1,0
33,381,381,12,12,0,1,0
20,430,430,60,60,0,1,0
27,439,439,13,5,8,2,1
16,453,453,21,21,0,1,0
31,455,455,12,12,0,1,0
21,475,475,75,75,0,1,0
15,479,479,57,45,12,4,3
22,493,493,49,3,46,4,3
6,499,499,35,14,21,4,3

0,106,106,9,1,8,3,2
27,129,129,15,9,6,3,2
24,135,135,10,2,8,3,2
17,153,153,51,30,21,4,3
18,162,162,4,4,0,1,0
26,184,184,11,11,0,1,0
28,193,193,6,6,0,1,0
6,220,220,70,52,18,2,1
19,248,248,45,15,30,2,1
13,276,276,57,57,0,1,0
2,293,293,18,5,13,2,1
9,295,295,5,2,3,2,1
7,305,305,54,48,6,2,1
14,307,307,54,9,45,4,3
10,308,308,24,24,0,1,0
23,317,317,25,25,0,1,0
5,332,332,44,25,19,2,1
29,346,346,8,2,6,2,1
25,352,352,5,5,0,1,0
8,361,361,2,2,0,1,0
20,376,376,64,64,0,1,0
22,376,376,58,26,32,2,1
11,388,388,26,26,0,1,0
21,415,415,14,14,0,1,0
15,420,420,1,1,0,1,0
1,421,421,16,16,0,1,0
16,435,435,24,24,0,1,0
4,447,447,53,29,24,2,1
12,459,459,64,57,7,2,1
3,498,498,231,137,94,3,2

9,117,117,6,6,0,1,0
14,127,127,4,4,0,1,0
18,135,135,3,3,0,1,0
30,136,136,2,2,0,1,0
12,140,140,13,10,3,2,1
27,163,163,29,29,0,1,0
37,189,189,2,2,0,1,0
32,197,197,18,10,8,2,1
28,210,210,44,44,0,1,0
31,215,215,36,19,17,2,1
1,216,216,21,8,13,2,1
8,216,216,1,1,0,1,0
4,238,238,10,10,0,1,0
10,243,243,52,13,39,4,3
25,281,281,33,33,0,1,0
6,286,286,12,9,3,2,1
19,288,288,4,4,0,1,0
33,298,298,37,8,29,2,1
29,302,302,38,38,0,1,0
11,302,302,25,25,0,1,0
35,326,326,11,11,0,1,0
5,326,326,96,57,39,4,3
17,336,336,22,8,14,2,1
24,345,345,6,6,0,1,0
38,371,371,61,61,0,1,0
16,374,374,21,1,20,2,1
36,387,387,3,3,0,1,0
15,387,387,6,2,4,2,1
0,394,394,79,23,56,3,2
23,399,399,136,102,34,2,1
2,400,400,17,17,0,1,0
20,401,401,77,77,0,1,0
7,408,408,17,2,15,4,3
21,411,411,15,15,0,1,0
26,416,416,24,24,0,1,0
34,446,446,29,29,0,1,0
13,449,449,25,19,6,2,1
22,460,460,2,2,0,1,0
3,469,469,3,3,0,1,0

10,100,100,1,1,0,1,0
5,107,107,25,1,24,2,1
15,114,114,11,7,4,2,1
18,141,141,3,3,0,1,0
12,153,153,7,7,0,1,0
0,190,190,1,1,0,1,0
19,201,201,23,6,17,2,1
4,207,207,56,56,0,1,0
2,224,224,39,9,30,2,1
7,231,231,20,8,12,3,2
27,233,233,71,62,9,2,1
32,237,237,31,31,0,1,0
16,239,239,7,2,5,2,1
29,241,241,4,1,3,2,1
3,246,246,8,4,4,2,1
6,277,277,87,57,30,2,1
28,281,281,22,15,7,2,1
21,283,283,41,10,31,2,1
9,284,284,52,7,45,2,1
20,298,298,55,55,0,1,0
13,308,308,9,9,0,1,0
11,310,310,12,12,0,1,0
8,314,314,20,20,0,1,0
23,325,325,22,13,9,4,3
1,360,360,10,4,6,2,1
30,372,372,3,3,0,1,0
14,375,375,35,35,0,1,0
31,382,382,35,35,0,1,0
24,392,392,16,2,14,3,2
17,431,431,40,20,20,3,2
22,434,434,14,2,12,3,2
26,478,478,10,1,9,2,1
25,495,495,174,28,146,4,3

13,101,101,3,3,0,1,0
24,104,104,12,12,0,1,0
38,122,122,32,5,27,4,3
3,127,127,1,1,0,1,0
29,150,150,40,12,28,2,1
34,170,170,14,14,0,1,0
10,193,193,10,6,4,2,1
17,198,198,19,6,13,2,1
37,209,209,4,4,0,1,0
33,222,222,17,4,13,2,1
4,228,228,40,12,28,2,1
26,238,238,1,1,0,1,0
15,267,267,7,7,0,1,0
11,268,268,3,3,0,1,0
5,268,268,19,5,14,3,2
7,282,282,11,11,0,1,0
1,286,286,25,2,23,4,3
9,295,295,18,1,17,2,1
6,295,295,19,19,0,1,0
27,300,300,1,1,0,1,0
16,304,304,32,21,11,2,1
28,305,305,40,8,32,2,1
40,308,308,95,34,61,4,3
25,334,334,12,12,0,1,0
2,342,342,84,84,0,1,0
0,365,365,32,32,0,1,0
23,366,366,6,2,4,2,1
14,376,376,67,22,45,4,3
31,385,385,10,5,5,2,1
18,390,390,4,4,0,1,0
22,411,411,1,1,0,1,0
8,412,412,25,25,0,1,0
19,419,419,31,31,0,1,0
35,421,421,54,32,22,3,2
32,428,428,7,7,0,1,0
30,441,441,69,69,0,1,0
21,441,441,75,13,62,3,2
12,471,471,1,1,0,1,0
36,475,475,27,15,12,2,1
39,480,480,18,18,0,1,0
20,487,487,14,14,0,1,0

15,117,117,11,8,3,2,1
22,153,153,1,1,0,1,0
20,169,169,16,16,0,1,0
8,173,173,1,1,0,1,0
4,189,189,6,1,5,2,1
6,215,215,16,16,0,1,0
29,218,218,59,4,55,3,2
1,225,225,1,1,0,1,0
14,236,236,7,1,6,3,2
21,236,236,33,9,24,4,3
17,242,242,13,13,0,1,0
28,246,246,9,9,0,1,0
3,249,249,6,6,0,1,0
25,255,255,47,47,0,1,0
9,258,258,16,16,0,1,0
7,267,267,1,1,0,1,0
30,278,278,8,8,0,1,0
35,282,282,10,10,0,1,0
12,284,284,26,3,23,4,3
32,287,287,34,34,0,1,0
16,315,315,31,31,0,1,0
26,324,324,18,5,13,2,1
0,331,331,99,75,24,2,1
37,393,393,39,33,6,2,1
13,393,393,28,6,22,2,1
18,394,394,13,13,0,1,0
24,396,396,50,50,0,1,0
34,402,402,46,24,22,3,2
2,415,415,93,27,66,3,2
23,418,418,120,117,3,2,1
36,419,419,65,65,0,1,0
33,425,425,21,21,0,1,0
11,426,426,22,15,7,2,1
5,433,433,59,50,9,2,1
31,442,442,3,3,0,1,0
10,454,454,51,51,0,1,0
19,479,479,50,50,0,1,0
27,496,496,9,9,0,1,0

34,107,107,2,2,0,1,0
0,111,111,11,8,3,2,1
10,117,117,1,1,0,1,0
11,121,121,2,2,0,1,0
23,130,130,8,2,6,2,1
24,135,135,19,19,0,1,0
15,140,140,17,7,10,3,2
20,143,143,16,16,0,1,0
35,146,146,6,6,0,1,0
32,151,151,5,5,0,1,0
22,159,159,1,1,0,1,0
28,173,173,4,4,0,1,0
40,182,182,49,40,9,2,1
18,219,219,71,22,49,2,1
33,230,230,10,10,0,1,0
12,232,232,6,6,0,1,0
16,232,232,1,1,0,1,0
21,242,242,6,1,5,2,1
4,243,243,89,19,70,3,2
38,245,245,40,31,9,2,1
27,274,274,7,7,0,1,0
26,295,295,11,11,0,1,0
2,321,321,24,24,0,1,0
31,325,325,4,4,0,1,0
3,329,329,4,4,0,1,0
36,337,337,1,1,0,1,0
30,337,337,27,27,0,1,0
17,338,338,62,44,18,4,3
14,376,376,16,16,0,1,0
37,383,383,99,51,48,3,2
8,395,395,2,2,0,1,0
7,396,396,40,22,18,4,3
5,398,398,11,11,0,1,0
19,443,443,13,5,8,3,2
39,444,444,57,40,17,2,1
9,450,450,1,1,0,1,0
6,460,460,8,8,0,1,0
29,465,465,105,27,78,3,2
13,480,480,5,5,0,1,0
1,483,483,13,13,0,1,0
25,488,488,115,115,0,1,0

35,119,119,51,8,43,2,1
28,120,120,16,16,0,1,0
17,144,144,17,17,0,1,0
11,146,146,1,1,0,1,0
36,146,146,3,3,0,1,0
39,171,171,34,30,4,2,1
24,183,183,42,42,0,1,0
31,212,212,6,6,0,1,0
30,225,225,44,30,14,2,1
26,240,240,6,3,3,2,1
20,241,241,6,6,0,1,0
37,245,245,6,6,0,1,0
12,253,253,13,13,0,1,0
4,262,262,9,3,6,2,1
5,273,273,23,23,0,1,0
25,284,284,15,15,0,1,0
2,307,307,31,22,9,4,3
14,308,308,7,2,5,2,1
1,311,311,3,3,0,1,0
32,317,317,46,6,40,2,1
29,317,317,3,3,0,1,0
15,323,323,8,1,7,2,1
34,331,331,24,24,0,1,0
23,336,336,3,3,0,1,0
21,341,341,1,1,0,1,0
42,350,350,90,6,84,3,2
0,355,355,1,1,0,1,0
16,378,378,26,2,24,2,1
10,389,389,64,64,0,1,0
19,413,413,9,9,0,1,0
8,422,422,120,120,0,1,0
3,428,428,83,73,10,2,1
18,455,455,11,11,0,1,0
33,460,460,14,14,0,1,0
40,462,462,5,5,0,1,0
7,469,469,27,4,23,2,1
38,471,471,57,57,0,1,0
6,475,475,18,18,0,1,0
9,482,482,14,14,0,1,0
13,483,483,5,5,0,1,0
27,489,489,10,10,0,1,0
41,496,496,9,9,0,1,0
22,500,500,18,2,16,2,1

16,100,100,31,22,9,2,1
19,106,106,25,9,16,2,1
17,113,113,4,1,3,2,1
5,116,116,1,1,0,1,0
36,119,119,25,17,8,2,1
31,132,132,9,2,7,3,2
13,138,138,27,27,0,1,0
6,147,147,11,8,3,2,1
10,150,150,8,8,0,1,0
9,153,153,7,7,0,1,0
22,163,163,32,4,28,3,2
34,170,170,50,50,0,1,0
27,172,172,2,2,0,1,0
24,181,181,7,3,4,2,1
4,192,192,9,2,7,2,1
35,196,196,17,17,0,1,0
12,197,197,1,1,0,1,0
20,200,200,22,19,3,2,1
29,205,205,19,19,0,1,0
28,206,206,3,3,0,1,0
30,210,210,8,2,6,3,2
33,249,249,41,13,28,2,1
21,250,250,35,6,29,2,1
23,253,253,4,4,0,1,0
18,294,294,2,2,0,1,0
32,304,304,51,13,38,2,1
0,326,326,5,5,0,1,0
15,375,375,13,7,6,2,1
25,379,379,33,33,0,1,0
2,387,387,4,1,3,2,1
26,392,392,18,18,0,1,0
11,393,393,42,42,0,1,0
37,404,404,57,57,0,1,0
8,412,412,27,27,0,1,0
7,442,442,6,6,0,1,0
38,456,456,26,26,0,1,0
3,473,473,26,26,0,1,0
14,474,474,4,4,0,1,0
1,480,480,60,24,36,4,3

39,108,108,12,12,0,1,0
32,125,125,38,5,33,4,3
10,129,129,1,1,0,1,0
21,132,132,9,5,4,2,1
33,132,132,32,13,19,3,2
26,148,148,35,20,15,4,3
20,150,150,11,11,0,1,0
9,214,214,3,3,0,1,0
31,225,225,5,5,0,1,0
0,227,227,2,2,0,1,0
27,239,239,22,4,18,3,2
30,242,242,18,18,0,1,0
23,252,252,4,4,0,1,0
18,260,260,14,14,0,1,0
36,268,268,15,3,12,3,2
13,269,269,15,1,14,3,2
11,278,278,18,2,16,2,1
35,278,278,49,49,0,1,0
24,283,283,4,4,0,1,0
7,292,292,28,20,8,2,1
8,307,307,37,37,0,1,0
4,318,318,34,34,0,1,0
2,319,319,33,33,0,1,0
19,350,350,43,18,25,2,1
37,355,355,30,25,5,2,1
34,360,360,24,24,0,1,0
17,391,391,69,52,17,2,1
25,400,400,12,6,6,2,1
6,428,428,18,18,0,1,0
12,438,438,23,11,12,2,1
14,445,445,66,66,0,1,0
28,448,448,7,1,6,3,2
5,449,449,19,19,0,1,0
38,451,451,1,1,0,1,0
3,453,453,22,4,18,4,3
29,458,458,85,63,22,4,3
22,460,460,24,24,0,1,0
15,463,463,27,21,6,3,2
1,496,496,11,7,4,2,1
16,497,497,81,5,76,3,2

28,111,111,6,2,4,2,1
4,116,116,8,8,0,1,0
26,128,128,2,2,0,1,0
12,140,140,4,4,0,1,0
17,166,166,7,7,0,1,0
32,173,173,9,6,3,2,1
34,196,196,27,27,0,1,0
23,198,198,36,36,0,1,0
30,202,202,31,31,0,1,0
19,211,211,5,5,0,1,0
15,222,222,20,20,0,1,0
11,222,222,8,8,0,1,0
16,224,224,1,1,0,1,0
20,242,242,33,17,16,4,3
6,245,245,43,25,18,2,1
10,250,250,4,4,0,1,0
36,261,261,1,1,0,1,0
2,265,265,7,7,0,1,0
1,277,277,37,19,18,4,3
3,298,298,8,3,5,2,1
29,335,335,40,40,0,1,0
8,343,343,37,37,0,1,0
14,358,358,7,2,5,2,1
7,359,359,29,29,0,1,0
5,362,362,7,7,0,1,0
33,370,370,46,13,33,2,1
0,373,373,229,196,33,4,3
9,377,377,27,27,0,1,0
21,383,383,137,55,82,4,3
24,399,399,39,24,15,2,1
31,428,428,39,39,0,1,0
27,438,438,1,1,0,1,0
35,443,443,44,24,20,2,1
18,445,445,21,21,0,1,0
22,451,451,9,3,6,2,1
25,463,463,39,39,0,1,0
13,478,478,33,15,18,2,1

30,101,101,5,5,0,1,0
20,105,105,1,1,0,1,0
1,131,131,2,2,0,1,0
15,135,135,13,13,0,1,0
37,139,139,1,1,0,1,0
38,152,152,23,23,0,1,0
40,156,156,26,26,0,1,0
18,168,168,1,1,0,1,0
0,179,179,4,4,0,1,0
22,193,193,7,1,6,3,2
14,193,193,36,9,27,2,1
13,197,197,10,1,9,4,3
9,205,205,2,2,0,1,0
7,206,206,25,25,0,1,0
8,235,235,41,41,0,1,0
39,236,236,35,6,29,4,3
27,237,237,33,33,0,1,0
5,248,248,18,4,14,2,1
24,270,270,1,1,0,1,0
26,279,279,10,3,7,2,1
10,280,280,19,19,0,1,0
3,294,294,12,8,4,2,1
41,298,298,62,43,19,4,3
12,299,299,10,10,0,1,0
32,328,328,33,33,0,1,0
17,347,347,60,5,55,4,3
2,352,352,39,11,28,3,2
16,356,356,8,1,7,2,1
35,357,357,31,7,24,3,2
28,376,376,21,11,10,2,1
23,380,380,1,1,0,1,0
29,406,406,14,14,0,1,0
31,411,411,58,58,0,1,0
11,413,413,20,20,0,1,0
33,436,436,34,34,0,1,0
21,446,446,35,5,30,3,2
42,447,447,39,39,0,1,0
36,452,452,87,39,48,3,2
25,452,452,66,32,34,3,2
4,454,454,21,1,20,3,2
19,455,455,46,9,37,3,2
34,474,474,26,26,0,1,0
6,492,492,12,5,7,2,1

2,111,111,14,3,11,2,1
25,113,113,2,2,0,1,0
5,118,118,1,1,0,1,0
27,127,127,26,4,22,2,1
30,138,138,1,1,0,1,0
7,158,158,2,2,0,1,0
6,160,160,2,2,0,1,0
13,168,168,76,30,46,3,2
28,173,173,12,12,0,1,0
0,175,175,26,4,22,3,2
26,179,179,4,4,0,1,0
23,200,200,5,5,0,1,0
32,213,213,18,18,0,1,0
1,217,217,84,84,0,1,0
12,222,222,11,5,6,2,1
18,261,261,102,102,0,1,0
20,270,270,46,2,44,2,1
19,271,271,24,2,22,3,2
24,288,288,7,7,0,1,0
16,289,289,6,2,4,2,1
31,298,298,38,30,8,2,1
22,323,323,10,10,0,1,0
29,350,350,44,44,0,1,0
11,399,399,18,18,0,1,0
15,415,415,43,17,26,2,1
10,424,424,1,1,0,1,0
3,436,436,24,24,0,1,0
21,448,448,12,3,9,2,1
8,455,455,14,14,0,1,0
14,456,456,46,13,33,2,1
17,457,457,140,14,126,4,3
9,466,466,49,13,36,3,2
4,477,477,20,20,0,1,0
33,500,500,8,8,0,1,0

26,108,108,12,12,0,1,0
2,112,112,2,2,0,1,0
0,130,130,1,1,0,1,0
6,147,147,2,2,0,1,0
23,158,158,51,51,0,1,0
34,160,160,9,9,0,1,0
19,171,171,3,3,0,1,0
20,173,173,8,8,0,1,0
9,174,174,11,2,9,3,2
21,193,193,1,1,0,1,0
13,194,194,4,4,0,1,0
11,194,194,6,6,0,1,0
33,212,212,35,35,0,1,0
36,219,219,10,3,7,2,1
32,228,228,8,8,0,1,0
17,238,238,11,1,10,4,3
14,259,259,7,3,4,2,1
25,267,267,53,37,16,2,1
18,284,284,25,25,0,1,0
12,301,301,14,14,0,1,0
29,310,310,18,18,0,1,0
7,321,321,2,2,0,1,0
10,331,331,20,20,0,1,0
22,333,333,9,9,0,1,0
4,372,372,24,24,0,1,0
39,403,403,18,10,8,3,2
30,406,406,23,17,6,3,2
24,412,412,3,3,0,1,0
8,413,413,21,12,9,4,3
1,438,438,151,77,74,4,3
35,454,454,35,7,28,3,2
15,461,461,155,137,18,2,1
16,463,463,60,60,0,1,0
31,465,465,34,13,21,2,1
28,474,474,34,10,24,2,1
5,474,474,30,12,18,2,1
27,480,480,49,16,33,4,3
38,480,480,119,115,4,2,1
3,491,491,92,2,90,4,3
37,497,497,27,27,0,1,0

14,116,116,11,11,0,1,0
10,131,131,6,6,0,1,0
16,132,132,9,9,0,1,0
36,134,134,14,14,0,1,0
17,157,157,1,1,0,1,0
31,163,163,2,2,0,1,0
15,172,172,5,1,4,2,1
9,174,174,1,1,0,1,0
24,175,175,34,4,30,2,1
2,194,194,4,1,3,2,1
37,203,203,61,16,45,2,1
34,205,205,26,26,0,1,0
30,206,206,30,30,0,1,0
26,207,207,43,9,34,3,2
38,208,208,10,6,4,2,1
33,208,208,8,8,0,1,0
1,222,222,23,23,0,1,0
27,223,223,21,21,0,1,0
13,230,230,11,11,0,1,0
8,243,243,34,34,0,1,0
5,263,263,5,5,0,1,0
4,285,285,5,1,4,2,1
12,311,311,14,14,0,1,0
6,317,317,1,1,0,1,0
20,323,323,35,35,0,1,0
29,337,337,4,4,0,1,0
11,341,341,76,40,36,3,2
7,342,342,7,1,6,3,2
23,387,387,30,30,0,1,0
32,391,391,5,5,0,1,0
39,406,406,102,6,96,3,2
28,412,412,25,12,13,2,1
21,430,430,106,106,0,1,0
19,461,461,37,37,0,1,0
25,465,465,1,1,0,1,0
35,474,474,27,27,0,1,0
22,476,476,24,24,0,1,0
18,483,483,36,10,26,2,1
0,493,493,82,59,23,2,1
3,498,498,42,38,4,2,1

21,109,109,26,14,12,3,2
16,118,118,15,15,0,1,0
17,127,127,27,18,9,4,3
10,133,133,3,3,0,1,0
33,139,139,2,2,0,1,0
31,147,147,3,3,0,1,0
6,159,159,5,1,4,2,1
8,186,186,15,15,0,1,0
2,190,190,64,61,3,2,1
18,192,192,27,8,19,2,1
20,195,195,34,34,0,1,0
7,201,201,53,53,0,1,0
22,210,210,33,33,0,1,0
13,214,214,5,2,3,2,1
27,218,218,7,2,5,2,1
23,220,220,8,4,4,2,1
9,233,233,5,1,4,2,1
4,251,251,27,18,9,4,3
32,257,257,35,35,0,1,0
25,292,292,13,8,5,2,1
0,294,294,5,5,0,1,0
12,299,299,43,4,39,2,1
19,308,308,81,60,21,4,3
30,340,340,22,22,0,1,0
29,345,345,15,15,0,1,0
15,369,369,73,73,0,1,0
5,382,382,59,13,46,2,1
3,398,398,28,28,0,1,0
11,419,419,23,23,0,1,0
24,429,429,45,45,0,1,0
14,464,464,6,2,4,2,1
26,488,488,6,6,0,1,0
28,499,499,23,9,14,3,2
1,500,500,20,10,10,3,2

28,100,100,9,9,0,1,0
9,103,103,4,4,0,1,0
27,107,107,17,17,0,1,0
25,123,123,8,8,0,1,0
19,160,160,9,2,7,2,1
11,166,166,3,3,0,1,0
23,170,170,1,1,0,1,0
29,178,178,6,1,5,2,1
0,181,181,7,7,0,1,0
7,243,243,36,13,23,3,2
22,251,251,19,19,0,1,0
5,254,254,76,76,0,1,0
17,258,258,49,7,42,3,2
30,270,270,89,81,8,3,2
12,274,274,13,5,8,2,1
18,285,285,55,55,0,1,0
33,298,298,7,7,0,1,0
14,303,303,64,52,12,4,3
20,316,316,7,3,4,2,1
2,342,342,1,1,0,1,0
31,346,346,4,4,0,1,0
26,350,350,19,19,0,1,0
4,353,353,38,25,13,2,1
3,357,357,30,30,0,1,0
16,361,361,22,22,0,1,0
13,376,376,21,18,3,2,1
24,419,419,3,3,0,1,0
8,435,435,70,70,0,1,0
1,463,463,6,6,0,1,0
32,465,465,15,15,0,1,0
6,467,467,16,16,0,1,0
21,487,487,193,86,107,4,3
15,490,490,87,75,12,2,1
10,491,491,99,19,80,3,2

0,102,102,2,2,0,1,0
6,111,111,28,3,25,3,2
20,120,120,9,9,0,1,0
1,123,123,6,6,0,1,0
18,123,123,4,4,0,1,0
21,125,125,16,2,14,3,2
7,154,154,8,8,0,1,0
9,166,166,12,4,8,3,2
5,168,168,24,24,0,1,0
28,175,175,11,3,8,3,2
14,202,202,18,9,9,2,1
13,203,203,14,4,10,3,2
11,206,206,22,9,13,4,3
3,206,206,80,80,0,1,0
26,212,212,128,51,77,4,3
24,219,219,72,72,0,1,0
10,243,243,14,14,0,1,0
25,264,264,7,7,0,1,0
19,271,271,1,1,0,1,0
2,298,298,37,37,0,1,0
8,310,310,43,28,15,2,1
23,311,311,12,12,0,1,0
22,331,331,15,15,0,1,0
12,345,345,102,3,99,4,3
16,367,367,14,14,0,1,0
4,372,372,1,1,0,1,0
27,401,401,15,5,10,3,2
17,426,426,40,40,0,1,0
15,492,492,28,28,0,1,0
29,496,496,4,4,0,1,0

9,105,105,4,4,0,1,0
8,107,107,42,14,28,2,1
21,107,107,5,5,0,1,0
0,110,110,1,1,0,1,0
22,111,111,2,2,0,1,0
29,121,121,2,2,0,1,0
7,137,137,6,6,0,1,0
18,156,156,29,11,18,2,1
1,172,172,4,1,3,2,1
16,173,173,33,18,15,4,3
15,183,183,6,6,0,1,0
32,183,183,30,14,16,2,1
13,187,187,6,6,0,1,0
23,212,212,13,3,10,2,1
35,218,218,36,2,34,2,1
5,244,244,12,12,0,1,0
17,249,249,1,1,0,1,0
27,261,261,23,14,9,2,1
34,275,275,4,4,0,1,0
26,278,278,13,13,0,1,0
25,283,283,58,4,54,3,2
12,322,322,13,13,0,1,0
20,324,324,2,2,0,1,0
3,355,355,2,2,0,1,0
2,363,363,80,38,42,2,1
6,368,368,73,6,67,4,3
31,378,378,231,187,44,2,1
28,397,397,58,16,42,3,2
33,420,420,4,4,0,1,0
24,422,422,14,6,8,2,1
19,445,445,17,4,13,2,1
11,452,452,12,12,0,1,0
10,459,459,28,28,0,1,0
30,468,468,38,38,0,1,0
4,483,483,25,16,9,4,3
14,485,485,46,16,30,4,3

10,109,109,14,11,3,2,1
15,110,110,45,45,0,1,0
23,113,113,1,1,0,1,0
7,142,142,11,11,0,1,0
19,151,151,5,5,0,1,0
5,193,193,8,8,0,1,0
8,194,194,48,18,30,3,2
11,213,213,17,17,0,1,0
16,213,213,3,3,0,1,0
22,232,232,7,7,0,1,0
29,235,235,7,7,0,1,0
4,260,260,46,26,20,4,3
18,285,285,53,53,0,1,0
17,286,286,5,5,0,1,0
6,298,298,125,81,44,2,1
0,307,307,19,3,16,3,2
28,326,326,34,34,0,1,0
26,338,338,49,49,0,1,0
20,338,338,4,4,0,1,0
21,377,377,190,63,127,4,3
3,387,387,17,17,0,1,0
2,420,420,152,2,150,4,3
12,422,422,8,1,7,3,2
27,436,436,7,7,0,1,0
1,439,439,1,1,0,1,0
14,441,441,75,75,0,1,0
13,444,444,13,13,0,1,0
24,449,449,8,8,0,1,0
25,455,455,6,3,3,2,1
9,478,478,20,20,0,1,0

7,113,113,4,4,0,1,0
32,115,115,9,9,0,1,0
22,115,115,14,14,0,1,0
19,141,141,3,3,0,1,0
28,146,146,13,9,4,2,1
10,179,179,12,12,0,1,0
11,191,191,1,1,0,1,0
34,196,196,18,8,10,3,2
21,201,201,48,48,0,1,0
4,201,201,42,42,0,1,0
0,207,207,20,20,0,1,0
5,211,211,11,11,0,1,0
16,224,224,2,2,0,1,0
14,231,231,25,25,0,1,0
1,240,240,35,18,17,2,1
17,251,251,11,7,4,2,1
25,254,254,32,32,0,1,0
27,259,259,2,2,0,1,0
20,264,264,23,17,6,3,2
30,293,293,35,35,0,1,0
6,303,303,3,3,0,1,0
31,330,330,38,38,0,1,0
15,335,335,90,51,39,4,3
12,353,353,44,44,0,1,0
33,367,367,27,27,0,1,0
13,389,389,11,11,0,1,0
29,409,409,1,1,0,1,0
3,414,414,19,19,0,1,0
26,426,426,66,66,0,1,0
2,448,448,78,39,39,4,3
8,450,450,18,6,12,4,3
9,454,454,108,101,7,2,1
23,461,461,117,117,0,1,0
24,466,466,20,20,0,1,0
18,471,471,51,43,8,2,1

37,104,104,5,5,0,1,0
25,108,108,1,1,0,1,0
6,130,130,13,13,0,1,0
21,133,133,35,35,0,1,0
27,136,136,16,16,0,1,0
16,143,143,1,1,0,1,0
4,148,148,26,26,0,1,0
32,166,166,31,31,0,1,0
1,167,167,24,15,9,2,1
26,168,168,9,1,8,3,2
23,177,177,31,31,0,1,0
34,183,183,33,11,22,2,1
10,186,186,11,11,0,1,0
17,190,190,4,4,0,1,0
19,194,194,2,2,0,1,0
12,207,207,1,1,0,1,0
11,211,211,43,43,0,1,0
29,224,224,4,4,0,1,0
0,231,231,11,11,0,1,0
7,232,232,15,11,4,2,1
31,233,233,7,7,0,1,0
33,235,235,33,33,0,1,0
18,235,235,13,13,0,1,0
20,249,249,51,41,10,3,2
28,254,254,7,3,4,2,1
2,261,261,11,2,9,2,1
13,282,282,39,39,0,1,0
36,328,328,17,2,15,2,1
14,357,357,9,9,0,1,0
24,362,362,6,6,0,1,0
35,369,369,19,19,0,1,0
15,379,379,1,1,0,1,0
3,393,393,10,5,5,2,1
5,405,405,14,14,0,1,0
30,414,414,72,52,20,2,1
9,430,430,20,20,0,1,0
22,462,462,131,69,62,3,2
8,472,472,14,7,7,2,1
38,490,490,89,71,18,4,3

21,109,109,2,2,0,1,0
20,128,128,16,16,0,1,0
13,159,159,4,4,0,1,0
17,176,176,6,1,5,2,1
7,185,185,7,7,0,1,0
27,190,190,25,3,22,3,2
19,209,209,41,20,21,4,3
1,223,223,14,11,3,2,1
4,230,230,52,44,8,3,2
25,243,243,45,27,18,3,2
16,276,276,42,42,0,1,0
3,294,294,97,31,66,4,3
11,296,296,27,12,15,2,1
22,302,302,7,1,6,2,1
2,310,310,29,29,0,1,0
14,316,316,3,3,0,1,0
18,330,330,28,1,27,4,3
26,340,340,74,12,62,4,3
9,344,344,106,106,0,1,0
24,352,352,55,55,0,1,0
10,365,365,106,4,102,4,3
8,374,374,26,8,18,2,1
15,384,384,36,22,14,3,2
0,386,386,51,16,35,4,3
5,401,401,21,21,0,1,0
6,446,446,44,12,32,2,1
12,464,464,66,66,0,1,0
23,468,468,23,12,11,2,1

13,102,102,3,3,0,1,0
2,116,116,18,3,15,2,1
29,139,139,14,8,6,3,2
8,160,160,46,18,28,3,2
34,167,167,14,14,0,1,0
16,171,171,29,14,15,4,3
22,203,203,62,23,39,4,3
28,209,209,20,10,10,3,2
6,212,212,5,1,4,2,1
3,227,227,26,17,9,4,3
12,228,228,29,29,0,1,0
1,252,252,13,6,7,2,1
25,256,256,82,82,0,1,0
31,260,260,4,4,0,1,0
14,261,261,6,6,0,1,0
27,285,285,37,37,0,1,0
20,291,291,16,8,8,3,2
23,297,297,7,2,5,2,1
18,326,326,13,10,3,2,1
10,330,330,8,1,7,2,1
4,348,348,13,13,0,1,0
19,357,357,3,3,0,1,0
0,371,371,37,37,0,1,0
9,385,385,30,2,28,2,1
15,386,386,21,9,12,4,3
11,386,386,59,59,0,1,0
24,400,400,33,33,0,1,0
5,417,417,52,52,0,1,0
30,423,423,54,54,0,1,0
21,428,428,65,20,45,4,3
17,435,435,28,2,26,2,1
7,463,463,39,39,0,1,0
32,480,480,57,39,18,4,3
33,480,480,19,19,0,1,0
26,492,492,18,18,0,1,0

25,107,107,17,3,14,3,2
15,120,120,6,6,0,1,0
18,124,124,7,4,3,2,1
12,125,125,6,6,0,1,0
27,130,130,1,1,0,1,0
9,133,133,44,18,26,3,2
8,143,143,1,1,0,1,0
14,156,156,26,26,0,1,0
10,158,158,2,2,0,1,0
3,168,168,50,50,0,1,0
22,178,178,24,24,0,1,0
2,192,192,10,2,8,3,2
30,205,205,64,64,0,1,0
1,212,212,32,32,0,1,0
13,226,226,24,24,0,1,0
32,233,233,2,2,0,1,0
21,247,247,3,3,0,1,0
24,256,256,3,3,0,1,0
20,258,258,53,5,48,2,1
11,261,261,12,12,0,1,0
0,266,266,36,36,0,1,0
28,268,268,9,9,0,1,0
16,278,278,25,1,24,2,1
7,303,303,3,3,0,1,0
6,304,304,79,79,0,1,0
23,328,328,50,50,0,1,0
17,329,329,85,57,28,2,1
19,334,334,11,5,6,3,2
4,388,388,11,2,9,2,1
5,390,390,2,2,0,1,0
31,398,398,7,7,0,1,0
29,472,472,38,26,12,2,1
26,492,492,80,56,24,3,2

31,105,105,24,24,0,1,0
2,121,121,8,8,0,1,0
24,121,121,2,2,0,1,0
32,123,123,5,5,0,1,0
15,133,133,12,12,0,1,0
1,142,142,19,7,12,4,3
20,154,154,17,5,12,3,2
11,158,158,3,3,0,1,0
17,186,186,41,41,0,1,0
7,199,199,21,21,0,1,0
34,223,223,15,15,0,1,0
0,230,230,3,3,0,1,0
16,231,231,3,3,0,1,0
25,232,232,5,5,0,1,0
21,232,232,1,1,0,1,0
12,239,239,7,7,0,1,0
8,244,244,3,3,0,1,0
26,258,258,4,4,0,1,0
39,277,277,47,19,28,4,3
3,279,279,37,9,28,3,2
30,293,293,27,14,13,2,1
4,332,332,29,3,26,2,1
19,334,334,34,34,0,1,0
38,356,356,74,74,0,1,0
14,359,359,1,1,0,1,0
37,383,383,107,107,0,1,0
40,393,393,9,9,0,1,0
13,403,403,43,43,0,1,0
5,405,405,3,3,0,1,0
36,409,409,94,94,0,1,0
18,416,416,51,51,0,1,0
27,425,425,58,58,0,1,0
6,430,430,81,32,49,2,1
33,444,444,22,22,0,1,0
9,447,447,13,4,9,2,1
22,449,449,1,1,0,1,0
28,453,453,61,3,58,3,2
29,455,455,2,2,0,1,0
23,464,464,43,43,0,1,0
35,487,487,10,10,0,1,0
10,491,491,5,5,0,1,0

15,101,101,8,8,0,1,0
7,110,110,8,8,0,1,0
2,112,112,13,4,9,3,2
25,126,126,4,4,0,1,0
28,146,146,1,1,0,1,0
0,147,147,12,12,0,1,0
16,158,158,12,12,0,1,0
3,161,161,4,4,0,1,0
8,172,172,4,4,0,1,0
29,187,187,27,27,0,1,0
19,192,192,4,1,3,2,1
11,198,198,15,15,0,1,0
24,201,201,12,12,0,1,0
35,209,209,31,13,18,4,3
18,246,246,51,12,39,3,2
17,251,251,38,38,0,1,0
32,263,263,4,4,0,1,0
14,269,269,11,11,0,1,0
26,278,278,21,3,18,4,3
27,306,306,7,7,0,1,0
39,319,319,35,15,20,2,1
34,323,323,23,23,0,1,0
22,326,326,5,5,0,1,0
41,340,340,8,8,0,1,0
13,340,340,1,1,0,1,0
40,360,360,14,5,9,2,1
1,360,360,1,1,0,1,0
38,389,389,40,40,0,1,0
5,389,389,14,1,13,2,1
6,400,400,36,36,0,1,0
20,402,402,14,14,0,1,0
9,437,437,15,15,0,1,0
36,452,452,50,23,27,4,3
4,458,458,7,7,0,1,0
31,460,460,42,36,6,2,1
33,463,463,90,42,48,3,2
21,466,466,60,60,0,1,0
23,472,472,13,3,10,2,1
10,474,474,74,20,54,4,3
30,478,478,220,136,84,3,2
12,496,496,63,63,0,1,0
37,500,500,40,28,12,4,3

9,103,103,1,1,0,1,0
4,111,111,8,4,4,2,1
15,115,115,13,13,0,1,0
32,120,120,8,8,0,1,0
19,122,122,22,8,14,3,2
3,131,131,1,1,0,1,0
29,143,143,16,11,5,2,1
34,167,167,15,9,6,3,2
16,173,173,19,2,17,4,3
6,175,175,4,4,0,1,0
0,216,216,21,13,8,2,1
28,217,217,1,1,0,1,0
31,218,218,13,13,0,1,0
20,232,232,7,7,0,1,0
35,234,234,38,20,18,4,3
27,248,248,7,7,0,1,0
2,256,256,5,5,0,1,0
37,258,258,8,3,5,2,1
14,260,260,37,37,0,1,0
25,262,262,54,54,0,1,0
8,268,268,86,86,0,1,0
10,285,285,5,5,0,1,0
17,291,291,10,4,6,2,1
11,306,306,29,13,16,2,1
12,309,309,18,18,0,1,0
22,312,312,49,49,0,1,0
24,313,313,5,5,0,1,0
5,357,357,73,53,20,3,2
36,367,367,58,58,0,1,0
30,374,374,14,5,9,4,3
23,390,390,39,27,12,4,3
13,408,408,18,11,7,2,1
26,419,419,74,74,0,1,0
7,424,424,13,13,0,1,0
21,427,427,45,24,21,2,1
33,469,469,105,15,90,4,3
18,469,469,24,24,0,1,0
1,496,496,20,20,0,1,0

26,100,100,1,1,0,1,0
9,103,103,36,36,0,1,0
27,134,134,3,3,0,1,0
22,174,174,8,8,0,1,0
29,215,215,1,1,0,1,0
18,242,242,29,13,16,2,1
13,248,248,45,45,0,1,0
10,260,260,14,14,0,1,0
0,261,261,28,28,0,1,0
8,262,262,56,26,30,4,3
30,275,275,20,10,10,3,2
1,277,277,58,58,0,1,0
25,279,279,34,6,28,2,1
21,288,288,5,5,0,1,0
28,294,294,12,12,0,1,0
4,296,296,19,16,3,2,1
17,313,313,13,13,0,1,0
15,314,314,118,40,78,3,2
23,316,316,106,102,4,2,1
5,340,340,22,1,21,4,3
12,343,343,8,8,0,1,0
14,354,354,61,61,0,1,0
11,389,389,3,3,0,1,0
7,390,390,64,10,54,3,2
6,396,396,7,7,0,1,0
16,397,397,28,28,0,1,0
24,406,406,65,65,0,1,0
20,412,412,4,4,0,1,0
3,439,439,65,18,47,2,1
19,471,471,52,52,0,1,0
2,485,485,48,12,36,2,1

36,109,109,7,7,0,1,0
11,122,122,1,1,0,1,0
33,134,134,37,37,0,1,0
4,138,138,7,1,6,3,2
27,139,139,29,3,26,2,1
28,140,140,6,1,5,2,1
25,143,143,20,20,0,1,0
37,168,168,7,7,0,1,0
18,171,171,13,13,0,1,0
22,209,209,1,1,0,1,0
6,220,220,1,1,0,1,0
12,224,224,22,1,21,4,3
34,233,233,2,2,0,1,0
26,241,241,30,30,0,1,0
10,244,244,23,10,13,2,1
24,253,253,10,10,0,1,0
32,257,257,33,33,0,1,0
7,261,261,1,1,0,1,0
0,262,262,55,9,46,3,2
14,265,265,2,2,0,1,0
2,266,266,33,33,0,1,0
31,294,294,33,3,30,3,2
15,295,295,4,4,0,1,0
30,300,300,13,13,0,1,0
19,303,303,8,8,0,1,0
5,348,348,78,39,39,4,3
38,355,355,13,8,5,2,1
16,366,366,47,23,24,4,3
35,370,370,7,1,6,3,2
3,374,374,14,14,0,1,0
20,394,394,25,25,0,1,0
9,401,401,13,13,0,1,0
29,405,405,73,73,0,1,0
21,416,416,10,10,0,1,0
23,465,465,124,60,64,4,3
8,466,466,20,20,0,1,0
17,481,481,133,103,30,4,3
1,488,488,8,8,0,1,0
13,497,497,69,36,33,2,1

0,105,105,2,2,0,1,0
4,109,109,21,21,0,1,0
1,150,150,1,1,0,1,0
13,156,156,12,12,0,1,0
32,159,159,6,6,0,1,0
27,163,163,36,14,22,2,1
36,176,176,7,1,6,2,1
30,190,190,55,55,0,1,0
28,195,195,4,4,0,1,0
5,217,217,1,1,0,1,0
2,218,218,6,6,0,1,0
10,235,235,10,10,0,1,0
22,241,241,1,1,0,1,0
11,244,244,65,21,44,3,2
19,247,247,1,1,0,1,0
35,258,258,25,25,0,1,0
26,264,264,2,2,0,1,0
9,267,267,19,5,14,3,2
38,267,267,2,2,0,1,0
15,278,278,6,6,0,1,0
33,280,280,4,4,0,1,0
25,285,285,48,21,27,4,3
21,293,293,17,10,7,2,1
18,295,295,10,10,0,1,0
39,304,304,20,20,0,1,0
37,331,331,66,66,0,1,0
17,368,368,13,1,12,3,2
7,373,373,54,11,43,2,1
23,382,382,6,2,4,2,1
24,387,387,26,26,0,1,0
3,400,400,32,32,0,1,0
34,414,414,58,10,48,2,1
12,433,433,38,1,37,2,1
6,451,451,53,53,0,1,0
14,472,472,46,46,0,1,0
8,474,474,32,9,23,2,1
16,478,478,30,30,0,1,0
31,480,480,160,135,25,2,1
20,485,485,87,13,74,3,2
29,485,485,6,6,0,1,0

24,103,103,6,6,0,1,0
3,105,105,6,6,0,1,0
9,120,120,1,1,0,1,0
22,132,132,4,4,0,1,0
2,152,152,33,33,0,1,0
31,154,154,5,5,0,1,0
27,156,156,18,18,0,1,0
21,162,162,10,10,0,1,0
16,178,178,34,34,0,1,0
28,185,185,13,13,0,1,0
32,191,191,51,51,0,1,0
7,201,201,22,22,0,1,0
20,210,210,50,46,4,2,1
4,211,211,24,15,9,2,1
6,222,222,15,15,0,1,0
12,234,234,6,6,0,1,0
10,243,243,15,15,0,1,0
29,254,254,7,1,6,3,2
8,327,327,37,19,18,2,1
11,334,334,63,63,0,1,0
15,365,365,61,31,30,4,3
25,372,372,47,3,44,3,2
1,375,375,23,10,13,2,1
26,380,380,96,51,45,4,3
0,400,400,85,52,33,4,3
18,408,408,22,4,18,3,2
19,424,424,33,15,18,3,2
30,450,450,12,12,0,1,0
14,451,451,44,44,0,1,0
5,453,453,73,7,66,3,2
23,478,478,3,3,0,1,0
17,482,482,54,54,0,1,0
13,487,487,19,11,8,3,2

22,101,101,4,1,3,2,1
10,115,115,3,3,0,1,0
8,126,126,7,7,0,1,0
5,137,137,5,2,3,2,1
13,180,180,52,7,45,2,1
27,198,198,9,9,0,1,0
18,200,200,3,3,0,1,0
34,204,204,46,46,0,1,0
21,204,204,19,19,0,1,0
17,237,237,5,2,3,2,1
30,241,241,35,35,0,1,0
35,264,264,2,2,0,1,0
2,279,279,17,17,0,1,0
4,285,285,38,16,22,3,2
14,290,290,46,46,0,1,0
9,290,290,29,25,4,2,1
28,303,303,76,24,52,4,3
33,307,307,3,3,0,1,0
23,313,313,3,3,0,1,0
29,329,329,45,7,38,3,2
0,347,347,90,40,50,4,3
1,351,351,1,1,0,1,0
16,372,372,7,7,0,1,0
32,395,395,7,7,0,1,0
26,398,398,27,27,0,1,0
19,428,428,92,64,28,2,1
25,433,433,121,34,87,4,3
31,436,436,30,22,8,2,1
24,436,436,33,5,28,3,2
12,447,447,53,53,0,1,0
11,450,450,36,1,35,2,1
3,468,468,29,29,0,1,0
15,469,469,58,8,50,3,2
20,474,474,17,17,0,1,0
7,484,484,40,40,0,1,0
6,488,488,29,8,21,4,3

36,116,116,4,4,0,1,0
15,127,127,8,4,4,2,1
16,129,129,25,25,0,1,0
32,137,137,5,1,4,2,1
10,144,144,8,8,0,1,0
25,148,148,21,21,0,1,0
23,153,153,21,21,0,1,0
30,162,162,23,23,0,1,0
21,164,164,10,10,0,1,0
27,170,170,3,3,0,1,0
34,182,182,30,9,21,2,1
1,191,191,19,15,4,2,1
8,199,199,16,7,9,4,3
3,201,201,20,12,8,3,2
26,233,233,17,17,0,1,0
0,251,251,1,1,0,1,0
12,254,254,34,34,0,1,0
2,266,266,5,5,0,1,0
7,324,324,45,45,0,1,0
19,350,350,128,45,83,4,3
35,353,353,49,14,35,2,1
33,360,360,20,3,17,3,2
29,368,368,19,19,0,1,0
31,384,384,21,21,0,1,0
20,388,388,9,9,0,1,0
22,389,389,69,3,66,4,3
24,398,398,101,67,34,2,1
18,411,411,6,6,0,1,0
9,420,420,18,12,6,2,1
11,436,436,9,9,0,1,0
6,437,437,12,1,11,2,1
37,442,442,50,50,0,1,0
5,444,444,23,23,0,1,0
28,457,457,35,1,34,3,2
13,464,464,12,9,3,2,1
4,465,465,35,1,34,3,2
17,477,477,11,5,6,3,2
14,492,492,71,22,49,2,1

13,101,101,10,2,8,3,2
31,107,107,1,1,0,1,0
15,111,111,15,15,0,1,0
16,111,111,1,1,0,1,0
22,129,129,28,16,12,3,2
30,137,137,10,10,0,1,0
35,172,172,7,4,3,2,1
0,178,178,37,37,0,1,0
3,193,193,13,13,0,1,0
33,206,206,21,21,0,1,0
6,217,217,29,29,0,1,0
25,219,219,41,41,0,1,0
20,220,220,19,19,0,1,0
9,226,226,4,4,0,1,0
14,231,231,13,5,8,2,1
19,231,231,9,3,6,3,2
18,247,247,47,47,0,1,0
24,256,256,50,50,0,1,0
12,275,275,37,19,18,3,2
29,294,294,61,61,0,1,0
5,306,306,8,2,6,3,2
32,306,306,26,5,21,2,1
2,312,312,45,45,0,1,0
17,339,339,36,13,23,2,1
27,348,348,60,60,0,1,0
11,349,349,15,7,8,2,1
1,352,352,23,6,17,2,1
28,355,355,19,5,14,2,1
4,362,362,11,3,8,2,1
8,364,364,4,4,0,1,0
7,384,384,1,1,0,1,0
26,396,396,80,10,70,3,2
10,409,409,91,49,42,2,1
21,448,448,8,2,6,3,2
23,469,469,1,1,0,1,0
34,488,488,23,23,0,1,0

9,123,123,9,9,0,1,0
6,124,124,8,8,0,1,0
8,136,136,3,3,0,1,0
12,151,151,5,5,0,1,0
31,174,174,19,15,4,2,1
3,199,199,66,37,29,4,3
25,227,227,23,14,9,2,1
21,238,238,12,3,9,2,1
14,241,241,24,24,0,1,0
11,250,250,25,25,0,1,0
13,255,255,37,37,0,1,0
20,256,256,53,53,0,1,0
30,259,259,44,44,0,1,0
27,281,281,8,8,0,1,0
2,290,290,7,7,0,1,0
26,304,304,34,1,33,4,3
28,324,324,1,1,0,1,0
10,326,326,52,12,40,3,2
17,328,328,41,19,22,3,2
5,345,345,19,12,7,2,1
16,363,363,28,28,0,1,0
29,380,380,11,1,10,2,1
19,392,392,42,2,40,2,1
18,399,399,58,58,0,1,0
24,399,399,33,6,27,2,1
23,402,402,40,9,31,2,1
15,402,402,93,1,92,3,2
1,411,411,131,50,81,4,3
7,462,462,18,12,6,3,2
22,483,483,23,5,18,4,3
4,485,485,65,65,0,1,0
0,500,500,52,52,0,1,0

14,103,103,4,4,0,1,0
27,109,109,7,7,0,1,0
35,109,109,8,8,0,1,0
18,133,133,20,20,0,1,0
30,136,136,9,2,7,2,1
28,145,145,13,13,0,1,0
12,147,147,1,1,0,1,0
4,162,162,7,1,6,3,2
3,168,168,10,10,0,1,0
29,174,174,2,2,0,1,0
22,188,188,14,14,0,1,0
6,193,193,20,6,14,2,1
15,197,197,21,14,7,2,1
19,200,200,12,1,11,2,1
10,202,202,13,2,11,2,1
8,209,209,30,20,10,2,1
32,223,223,3,3,0,1,0
20,252,252,39,7,32,2,1
25,266,266,9,9,0,1,0
13,274,274,21,9,12,4,3
31,280,280,60,13,47,2,1
16,282,282,9,9,0,1,0
1,303,303,23,15,8,2,1
34,306,306,94,28,66,4,3
24,327,327,46,46,0,1,0
9,353,353,109,109,0,1,0
36,368,368,27,27,0,1,0
21,368,368,18,9,9,2,1
33,375,375,26,26,0,1,0
17,376,376,37,3,34,3,2
23,385,385,43,13,30,2,1
7,437,437,9,9,0,1,0
5,442,442,96,68,28,2,1
0,448,448,17,17,0,1,0
2,455,455,23,23,0,1,0
26,473,473,93,38,55,3,2
11,495,495,5,5,0,1,0

11,105,105,1,1,0,1,0
7,124,124,13,13,0,1,0
17,126,126,15,12,3,2,1
0,154,154,20,8,12,2,1
9,157,157,15,7,8,3,2
6,167,167,1,1,0,1,0
23,176,176,52,1,51,4,3
27,177,177,5,5,0,1,0
19,186,186,45,17,28,3,2
24,202,202,24,2,22,4,3
8,237,237,7,7,0,1,0
20,241,241,15,15,0,1,0
12,249,249,64,5,59,4,3
21,250,250,16,16,0,1,0
13,253,253,66,66,0,1,0
5,254,254,76,76,0,1,0
30,259,259,19,19,0,1,0
16,281,281,47,41,6,3,2
18,294,294,5,5,0,1,0
4,311,311,28,28,0,1,0
14,316,316,35,6,29,3,2
1,323,323,21,3,18,2,1
22,327,327,3,3,0,1,0
28,350,350,6,2,4,2,1
26,375,375,71,71,0,1,0
29,393,393,28,28,0,1,0
25,417,417,17,17,0,1,0
10,431,431,91,59,32,2,1
2,466,466,49,36,13,2,1
3,480,480,19,9,10,2,1
15,494,494,55,10,45,4,3

6,104,104,5,5,0,1,0
18,118,118,14,4,10,2,1
17,122,122,10,1,9,4,3
12,125,125,9,3,6,3,2
10,129,129,5,2,3,2,1
21,146,146,1,1,0,1,0
39,155,155,10,10,0,1,0
33,162,162,5,5,0,1,0
7,176,176,3,3,0,1,0
5,180,180,52,52,0,1,0
19,196,196,25,22,3,2,1
1,203,203,11,2,9,4,3
15,206,206,10,10,0,1,0
28,209,209,22,6,16,2,1
13,215,215,8,4,4,2,1
36,247,247,24,12,12,4,3
32,255,255,17,17,0,1,0
35,260,260,24,24,0,1,0
26,282,282,8,1,7,2,1
25,293,293,6,6,0,1,0
23,307,307,104,96,8,2,1
34,320,320,54,5,49,2,1
38,324,324,56,11,45,4,3
11,329,329,14,8,6,2,1
27,333,333,17,7,10,2,1
9,338,338,31,14,17,2,1
31,363,363,66,66,0,1,0
30,366,366,1,1,0,1,0
24,375,375,93,28,65,4,3
8,376,376,6,1,5,2,1
37,385,385,21,6,15,4,3
14,398,398,21,21,0,1,0
4,400,400,50,50,0,1,0
20,412,412,6,1,5,2,1
3,434,434,20,17,3,2,1
16,458,458,87,41,46,2,1
22,460,460,20,20,0,1,0
0,468,468,60,27,33,2,1
2,479,479,5,5,0,1,0
29,496,496,2,2,0,1,0

14,111,111,15,8,7,2,1
31,126,126,5,2,3,2,1
10,157,157,7,2,5,2,1
12,161,161,39,20,19,2,1
0,177,177,1,1,0,1,0
13,181,181,12,12,0,1,0
5,189,189,33,33,0,1,0
27,192,192,24,24,0,1,0
17,210,210,8,8,0,1,0
23,225,225,14,14,0,1,0
25,231,231,1,1,0,1,0
20,247,247,7,7,0,1,0
16,260,260,13,4,9,2,1
3,261,261,22,8,14,2,1
4,263,263,1,1,0,1,0
19,309,309,47,40,7,2,1
18,310,310,61,61,0,1,0
8,314,314,7,7,0,1,0
1,326,326,55,37,18,2,1
22,332,332,68,29,39,4,3
28,334,334,34,34,0,1,0
26,342,342,38,24,14,2,1
30,347,347,14,14,0,1,0
15,355,355,78,42,36,2,1
24,363,363,1,1,0,1,0
11,396,396,41,35,6,3,2
2,418,418,159,150,9,4,3
9,449,449,48,48,0,1,0
7,460,460,3,3,0,1,0
6,470,470,73,73,0,1,0
29,483,483,87,41,46,3,2
21,486,486,83,33,50,4,3

25,105,105,1,1,0,1,0
0,111,111,1,1,0,1,0
22,120,120,24,24,0,1,0
34,127,127,19,13,6,2,1
28,148,148,17,2,15,2,1
12,151,151,5,5,0,1,0
17,169,169,16,16,0,1,0
10,173,173,14,14,0,1,0
15,181,181,2,2,0,1,0
11,193,193,2,2,0,1,0
1,202,202,4,4,0,1,0
20,203,203,17,17,0,1,0
24,211,211,32,32,0,1,0
36,214,214,22,22,0,1,0
23,217,217,5,2,3,2,1
19,232,232,31,31,0,1,0
14,233,233,6,3,3,2,1
32,234,234,26,26,0,1,0
26,239,239,99,93,6,2,1
33,264,264,20,20,0,1,0
30,268,268,31,31,0,1,0
7,274,274,30,3,27,4,3
6,276,276,6,6,0,1,0
29,284,284,48,33,15,2,1
5,294,294,8,8,0,1,0
39,303,303,40,40,0,1,0
4,309,309,7,7,0,1,0
31,328,328,1,1,0,1,0
27,340,340,2,2,0,1,0
38,346,346,12,5,7,2,1
9,381,381,31,31,0,1,0
16,395,395,77,27,50,2,1
3,415,415,55,17,38,2,1
35,450,450,23,23,0,1,0
37,454,454,32,2,30,3,2
2,456,456,12,9,3,2,1
13,464,464,44,14,30,2,1
8,477,477,48,27,21,4,3
21,478,478,55,55,0,1,0
18,486,486,37,5,32,3,2

5,103,103,9,1,8,2,1
11,135,135,18,7,11,2,1
18,137,137,3,3,0,1,0
23,148,148,29,11,18,2,1
2,149,149,7,7,0,1,0
0,163,163,30,30,0,1,0
28,173,173,25,3,22,4,3
17,180,180,17,17,0,1,0
1,185,185,12,12,0,1,0
7,195,195,7,2,5,2,1
14,201,201,10,1,9,2,1
19,215,215,30,6,24,4,3
32,229,229,17,17,0,1,0
10,237,237,7,1,6,3,2
9,240,240,23,23,0,1,0
20,243,243,3,3,0,1,0
15,244,244,35,5,30,2,1
6,246,246,15,15,0,1,0
21,262,262,9,5,4,2,1
31,291,291,27,11,16,3,2
12,308,308,37,34,3,2,1
4,329,329,21,21,0,1,0
25,345,345,7,3,4,2,1
24,359,359,38,2,36,4,3
26,362,362,23,15,8,2,1
29,377,377,25,4,21,4,3
16,383,383,73,21,52,3,2
8,394,394,56,28,28,4,3
27,401,401,14,14,0,1,0
33,402,402,196,196,0,1,0
22,409,409,5,1,4,2,1
3,429,429,42,42,0,1,0
13,436,436,27,27,0,1,0
30,473,473,90,47,43,4,3
34,492,492,18,18,0,1,0

7,111,111,15,15,0,1,0
28,127,127,7,7,0,1,0
29,133,133,17,17,0,1,0
27,136,136,9,9,0,1,0
37,138,138,15,15,0,1,0
13,140,140,25,20,5,2,1
25,141,141,3,3,0,1,0
35,163,163,2,2,0,1,0
32,192,192,2,2,0,1,0
5,211,211,35,11,24,3,2
18,221,221,1,1,0,1,0
17,228,228,7,1,6,3,2
23,240,240,71,23,48,2,1
20,265,265,2,2,0,1,0
12,275,275,16,16,0,1,0
8,276,276,13,1,12,3,2
11,284,284,9,9,0,1,0
9,293,293,35,1,34,3,2
34,302,302,26,8,18,3,2
14,306,306,12,12,0,1,0
24,314,314,14,14,0,1,0
21,326,326,11,7,4,2,1
6,348,348,55,55,0,1,0
31,351,351,31,4,27,4,3
0,360,360,52,52,0,1,0
4,364,364,31,31,0,1,0
16,365,365,10,10,0,1,0
2,367,367,14,14,0,1,0
33,371,371,16,4,12,3,2
22,376,376,23,23,0,1,0
26,394,394,240,195,45,4,3
30,404,404,1,1,0,1,0
19,405,405,46,24,22,3,2
15,434,434,19,16,3,2,1
3,438,438,13,1,12,4,3
36,465,465,32,14,18,3,2
1,466,466,92,42,50,2,1
10,468,468,21,21,0,1,0

36,102,102,6,6,0,1,0
22,110,110,2,2,0,1,0
33,115,115,12,12,0,1,0
2,127,127,48,6,42,2,1
25,138,138,4,1,3,2,1
16,140,140,12,12,0,1,0
35,145,145,3,3,0,1,0
23,162,162,35,1,34,2,1
0,174,174,6,3,3,2,1
7,177,177,1,1,0,1,0
13,192,192,2,2,0,1,0
34,195,195,20,20,0,1,0
6,204,204,11,11,0,1,0
11,208,208,24,15,9,2,1
32,208,208,17,17,0,1,0
4,244,244,1,1,0,1,0
26,259,259,17,5,12,2,1
20,267,267,47,42,5,2,1
17,281,281,23,6,17,2,1
8,288,288,4,1,3,2,1
31,294,294,16,16,0,1,0
12,373,373,37,37,0,1,0
24,388,388,30,30,0,1,0
28,392,392,136,57,79,4,3
10,405,405,22,22,0,1,0
19,405,405,19,7,12,4,3
3,406,406,41,41,0,1,0
30,418,418,28,28,0,1,0
14,427,427,3,3,0,1,0
5,443,443,24,11,13,2,1
18,447,447,32,32,0,1,0
29,453,453,28,15,13,4,3
27,463,463,39,39,0,1,0
9,473,473,50,8,42,2,1
15,473,473,44,44,0,1,0
21,476,476,89,29,60,4,3
1,492,492,140,11,129,4,3

31,116,116,28,7,21,4,3
17,117,117,1,1,0,1,0
26,125,125,12,12,0,1,0
20,142,142,29,29,0,1,0
6,189,189,60,50,10,2,1
12,201,201,6,6,0,1,0
21,241,241,7,4,3,2,1
4,245,245,20,4,16,3,2
25,248,248,35,31,4,2,1
24,254,254,41,34,7,2,1
23,257,257,10,2,8,3,2
0,269,269,21,21,0,1,0
14,285,285,37,21,16,2,1
38,291,291,5,1,4,2,1
9,292,292,24,14,10,2,1
2,293,293,13,13,0,1,0
3,317,317,20,7,13,2,1
29,320,320,10,4,6,2,1
35,324,324,23,23,0,1,0
10,326,326,15,3,12,4,3
37,336,336,47,47,0,1,0
13,338,338,16,8,8,3,2
19,347,347,1,1,0,1,0
34,357,357,119,8,111,4,3
16,371,371,63,27,36,4,3
32,386,386,2,2,0,1,0
15,389,389,3,3,0,1,0
28,394,394,30,30,0,1,0
18,399,399,17,17,0,1,0
36,407,407,9,1,8,3,2
39,415,415,18,6,12,2,1
8,417,417,26,8,18,4,3
40,421,421,28,28,0,1,0
22,430,430,41,41,0,1,0
33,431,431,63,63,0,1,0
11,458,458,8,8,0,1,0
1,461,461,16,16,0,1,0
30,462,462,38,38,0,1,0
27,464,464,25,25,0,1,0
7,485,485,22,22,0,1,0
5,486,486,11,5,6,3,2

29,101,101,7,7,0,1,0
19,116,116,59,59,0,1,0
8,134,134,22,22,0,1,0
23,154,154,7,1,6,3,2
25,183,183,21,21,0,1,0
21,184,184,29,29,0,1,0
30,198,198,1,1,0,1,0
12,208,208,1,1,0,1,0
14,212,212,21,5,16,3,2
0,214,214,12,12,0,1,0
4,214,214,64,64,0,1,0
2,227,227,13,3,10,2,1
17,245,245,50,50,0,1,0
13,295,295,32,10,22,2,1
24,305,305,7,7,0,1,0
5,326,326,14,4,10,2,1
7,340,340,12,12,0,1,0
3,357,357,35,35,0,1,0
11,359,359,41,5,36,3,2
15,374,374,9,9,0,1,0
22,405,405,12,2,10,2,1
16,414,414,33,33,0,1,0
20,430,430,49,13,36,4,3
9,432,432,1,1,0,1,0
27,448,448,67,13,54,3,2
1,451,451,152,44,108,4,3
26,463,463,25,25,0,1,0
6,472,472,112,31,81,3,2
28,477,477,24,18,6,3,2
18,498,498,4,1,3,2,1
10,498,498,72,72,0,1,0

14,103,103,2,2,0,1,0
32,112,112,19,10,9,4,3
33,123,123,2,2,0,1,0
5,129,129,13,9,4,2,1
9,144,144,20,8,12,2,1
38,144,144,1,1,0,1,0
13,149,149,1,1,0,1,0
2,170,170,1,1,0,1,0
11,171,171,23,23,0,1,0
4,172,172,8,8,0,1,0
39,179,179,9,2,7,2,1
8,181,181,11,7,4,2,1
17,234,234,6,6,0,1,0
24,235,235,5,5,0,1,0
6,242,242,19,19,0,1,0
25,243,243,28,1,27,4,3
31,250,250,20,20,0,1,0
36,251,251,30,15,15,3,2
26,262,262,69,11,58,4,3
19,271,271,54,15,39,4,3
29,277,277,69,69,0,1,0
12,288,288,20,6,14,2,1
0,294,294,1,1,0,1,0
27,306,306,39,12,27,2,1
34,319,319,42,29,13,2,1
41,353,353,18,3,15,2,1
1,353,353,7,7,0,1,0
21,366,366,62,23,39,2,1
30,368,368,1,1,0,1,0
18,374,374,52,52,0,1,0
37,379,379,35,7,28,2,1
3,393,393,18,18,0,1,0
23,393,393,1,1,0,1,0
28,407,407,14,14,0,1,0
22,408,408,22,22,0,1,0
10,432,432,5,5,0,1,0
42,467,467,33,33,0,1,0
40,470,470,113,12,101,4,3
7,476,476,40,20,20,2,1
16,477,477,38,23,15,3,2
20,486,486,31,23,8,3,2
35,488,488,15,15,0,1,0
15,489,489,4,4,0,1,0

8,116,116,26,26,0,1,0
4,127,127,10,10,0,1,0
14,131,131,10,1,9,2,1
29,135,135,14,6,8,3,2
1,136,136,12,12,0,1,0
30,167,167,1,1,0,1,0
10,172,172,36,10,26,3,2
26,180,180,31,31,0,1,0
19,231,231,12,12,0,1,0
18,234,234,29,8,21,2,1
7,251,251,4,4,0,1,0
27,251,251,3,3,0,1,0
5,278,278,47,47,0,1,0
24,281,281,97,16,81,4,3
28,288,288,21,13,8,3,2
17,295,295,29,23,6,2,1
20,300,300,38,34,4,2,1
15,309,309,13,5,8,3,2
12,325,325,6,6,0,1,0
21,364,364,15,15,0,1,0
13,381,381,61,61,0,1,0
22,394,394,40,2,38,3,2
6,400,400,57,31,26,2,1
11,404,404,27,20,7,2,1
0,410,410,30,25,5,2,1
25,414,414,22,7,15,4,3
2,428,428,46,29,17,2,1
16,449,449,23,5,18,3,2
9,475,475,140,101,39,3,2
23,476,476,122,53,69,4,3
3,499,499,26,6,20,2,1

17,115,115,4,4,0,1,0
11,122,122,22,22,0,1,0
30,125,125,3,3,0,1,0
23,149,149,13,13,0,1,0
36,151,151,22,3,19,2,1
13,167,167,5,5,0,1,0
10,173,173,3,3,0,1,0
6,179,179,4,4,0,1,0
9,186,186,15,15,0,1,0
31,197,197,37,8,29,2,1
4,198,198,1,1,0,1,0
14,213,213,15,6,9,2,1
5,215,215,47,39,8,2,1
3,226,226,2,2,0,1,0
37,240,240,1,1,0,1,0
0,254,254,40,40,0,1,0
33,261,261,63,63,0,1,0
21,263,263,32,24,8,2,1
12,271,271,37,37,0,1,0
26,272,272,13,13,0,1,0
24,277,277,13,13,0,1,0
20,314,314,24,7,17,2,1
35,333,333,1,1,0,1,0
2,342,342,2,2,0,1,0
25,346,346,16,16,0,1,0
7,356,356,24,2,22,2,1
38,371,371,25,25,0,1,0
34,401,401,10,5,5,2,1
15,401,401,26,26,0,1,0
1,430,430,25,22,3,2,1
27,436,436,136,123,13,2,1
19,436,436,1,1,0,1,0
16,436,436,104,80,24,4,3
8,444,444,27,3,24,2,1
28,450,450,115,64,51,3,2
22,464,464,40,10,30,3,2
18,472,472,21,21,0,1,0
32,498,498,18,18,0,1,0
29,500,500,56,56,0,1,0

17,109,109,25,4,21,4,3
11,124,124,12,1,11,2,1
3,144,144,20,2,18,3,2
2,178,178,61,61,0,1,0
26,197,197,65,53,12,4,3
12,219,219,4,4,0,1,0
13,237,237,52,52,0,1,0
25,261,261,43,32,11,2,1
0,291,291,99,91,8,3,2
6,312,312,22,2,20,3,2
8,314,314,11,11,0,1,0
10,321,321,2,2,0,1,0
21,326,326,7,7,0,1,0
5,326,326,51,51,0,1,0
7,338,338,8,5,3,2,1
15,345,345,24,24,0,1,0
23,376,376,46,21,25,3,2
22,386,386,16,4,12,3,2
19,389,389,59,59,0,1,0
14,406,406,1,1,0,1,0
4,414,414,113,113,0,1,0
24,422,422,65,65,0,1,0
20,444,444,15,15,0,1,0
1,448,448,65,29,36,3,2
9,469,469,82,82,0,1,0
16,484,484,11,5,6,2,1
18,500,500,23,3,20,3,2

16,120,120,9,3,6,2,1
8,125,125,25,12,13,2,1
15,125,125,16,16,0,1,0
7,131,131,2,2,0,1,0
26,137,137,2,2,0,1,0
34,140,140,25,25,0,1,0
10,156,156,1,1,0,1,0
20,169,169,6,1,5,2,1
37,171,171,20,20,0,1,0
17,172,172,18,18,0,1,0
31,175,175,10,3,7,2,1
3,191,191,3,3,0,1,0
22,199,199,1,1,0,1,0
21,201,201,1,1,0,1,0
14,224,224,31,10,21,2,1
18,245,245,20,20,0,1,0
9,249,249,10,3,7,2,1
27,255,255,17,9,8,2,1
30,287,287,14,3,11,2,1
38,314,314,10,10,0,1,0
19,318,318,49,4,45,3,2
12,330,330,61,61,0,1,0
6,335,335,21,11,10,3,2
2,338,338,7,4,3,2,1
33,348,348,5,5,0,1,0
32,349,349,42,24,18,2,1
11,360,360,17,11,6,3,2
25,383,383,9,6,3,2,1
4,405,405,21,3,18,3,2
23,415,415,7,7,0,1,0
36,418,418,55,55,0,1,0
29,429,429,19,11,8,3,2
1,435,435,17,17,0,1,0
28,464,464,17,17,0,1,0
35,468,468,72,72,0,1,0
13,471,471,7,7,0,1,0
5,478,478,9,6,3,2,1
0,486,486,127,7,120,4,3
24,495,495,331,259,72,4,3

29,113,113,4,4,0,1,0
8,124,124,1,1,0,1,0
12,137,137,11,11,0,1,0
3,142,142,27,5,22,2,1
13,159,159,1,1,0,1,0
0,168,168,14,3,11,4,3
30,184,184,12,9,3,2,1
27,192,192,37,37,0,1,0
19,230,230,7,1,6,3,2
18,272,272,29,29,0,1,0
2,275,275,8,8,0,1,0
6,275,275,177,123,54,4,3
16,289,289,57,6,51,4,3
17,303,303,74,74,0,1,0
31,308,308,10,10,0,1,0
21,308,308,24,24,0,1,0
9,329,329,50,50,0,1,0
5,372,372,19,9,10,2,1
10,381,381,8,2,6,2,1
32,388,388,23,2,21,4,3
28,393,393,9,9,0,1,0
1,403,403,14,7,7,2,1
23,406,406,26,26,0,1,0
11,419,419,30,1,29,2,1
15,445,445,64,64,0,1,0
22,448,448,30,30,0,1,0
25,452,452,1,1,0,1,0
26,456,456,127,118,9,2,1
4,460,460,12,12,0,1,0
20,474,474,100,100,0,1,0
14,489,489,11,11,0,1,0
24,491,491,19,19,0,1,0
7,498,498,69,69,0,1,0

13,109,109,3,3,0,1,0
17,111,111,4,4,0,1,0
14,112,112,1,1,0,1,0
0,128,128,14,14,0,1,0
10,145,145,9,4,5,2,1
23,151,151,10,1,9,4,3
26,161,161,37,37,0,1,0
12,207,207,49,23,26,2,1
3,210,210,1,1,0,1,0
25,213,213,39,39,0,1,0
27,230,230,7,7,0,1,0
2,239,239,19,11,8,3,2
11,264,264,55,55,0,1,0
28,304,304,4,4,0,1,0
24,304,304,85,85,0,1,0
18,325,325,111,111,0,1,0
29,382,382,6,1,5,2,1
22,385,385,61,41,20,3,2
9,389,389,3,3,0,1,0
8,389,389,60,36,24,2,1
31,394,394,11,11,0,1,0
19,395,395,9,9,0,1,0
7,397,397,39,39,0,1,0
4,400,400,134,126,8,3,2
30,439,439,27,20,7,2,1
15,446,446,12,12,0,1,0
20,459,459,28,7,21,4,3
21,461,461,40,10,30,4,3
16,469,469,72,6,66,3,2
6,475,475,18,3,15,4,3
33,479,479,30,16,14,3,2
32,481,481,25,25,0,1,0
1,488,488,66,19,47,2,1
5,494,494,7,7,0,1,0

23,101,101,30,30,0,1,0
34,101,101,5,5,0,1,0
17,104,104,2,2,0,1,0
15,122,122,18,18,0,1,0
22,128,128,2,2,0,1,0
26,132,132,31,18,13,2,1
10,139,139,7,7,0,1,0
7,141,141,37,37,0,1,0
12,161,161,2,2,0,1,0
9,196,196,23,5,18,3,2
18,205,205,8,3,5,2,1
27,212,212,38,38,0,1,0
13,213,213,12,12,0,1,0
25,223,223,21,21,0,1,0
21,236,236,2,2,0,1,0
6,238,238,1,1,0,1,0
5,260,260,49,13,36,4,3
20,291,291,15,15,0,1,0
2,305,305,1,1,0,1,0
19,308,308,6,6,0,1,0
0,319,319,37,16,21,4,3
8,341,341,21,3,18,3,2
3,355,355,14,7,7,2,1
31,376,376,19,19,0,1,0
4,393,393,55,46,9,2,1
29,393,393,20,6,14,3,2
36,397,397,15,15,0,1,0
28,400,400,21,21,0,1,0
35,412,412,1,1,0,1,0
37,430,430,10,10,0,1,0
33,438,438,55,43,12,2,1
30,448,448,48,30,18,2,1
1,450,450,67,61,6,2,1
24,459,459,3,3,0,1,0
14,459,459,22,22,0,1,0
11,459,459,73,73,0,1,0
16,475,475,8,8,0,1,0
32,482,482,197,197,0,1,0

8,142,142,2,2,0,1,0
17,146,146,1,1,0,1,0
14,148,148,38,23,15,4,3
21,175,175,18,8,10,2,1
10,198,198,22,2,20,3,2
23,238,238,84,38,46,3,2
6,244,244,61,61,0,1,0
18,257,257,10,3,7,2,1
3,279,279,46,46,0,1,0
20,282,282,42,42,0,1,0
7,312,312,93,21,72,4,3
16,316,316,37,25,12,3,2
19,324,324,6,6,0,1,0
12,328,328,11,1,10,2,1
24,338,338,62,20,42,3,2
5,346,346,18,4,14,2,1
22,350,350,25,10,15,2,1
15,377,377,23,3,20,3,2
11,378,378,43,43,0,1,0
25,408,408,15,15,0,1,0
0,416,416,94,94,0,1,0
4,421,421,104,28,76,3,2
1,423,423,41,41,0,1,0
13,441,441,26,26,0,1,0
2,455,455,160,160,0,1,0
9,495,495,15,15,0,1,0

23,124,124,40,26,14,3,2
7,143,143,15,15,0,1,0
22,182,182,1,1,0,1,0
8,183,183,3,3,0,1,0
14,196,196,26,26,0,1,0
15,214,214,2,2,0,1,0
29,214,214,22,22,0,1,0
5,224,224,8,5,3,2,1
16,230,230,1,1,0,1,0
9,246,246,29,29,0,1,0
20,248,248,19,11,8,2,1
0,252,252,76,76,0,1,0
18,257,257,2,2,0,1,0
2,265,265,84,84,0,1,0
6,266,266,21,16,5,2,1
19,268,268,37,17,20,3,2
33,275,275,51,51,0,1,0
32,277,277,9,9,0,1,0
27,279,279,12,12,0,1,0
4,297,297,1,1,0,1,0
31,299,299,98,12,86,3,2
10,315,315,44,44,0,1,0
12,325,325,39,3,36,4,3
30,347,347,6,6,0,1,0
1,355,355,1,1,0,1,0
24,362,362,3,3,0,1,0
21,364,364,61,3,58,3,2
11,374,374,32,15,17,2,1
3,405,405,73,73,0,1,0
25,414,414,45,41,4,2,1
28,433,433,70,70,0,1,0
26,446,446,3,3,0,1,0
13,455,455,23,2,21,2,1
17,499,499,7,7,0,1,0

22,110,110,2,2,0,1,0
18,122,122,33,22,11,2,1
3,181,181,43,9,34,2,1
10,214,214,18,18,0,1,0
15,215,215,6,6,0,1,0
2,228,228,16,16,0,1,0
11,239,239,18,18,0,1,0
14,242,242,18,8,10,2,1
30,254,254,49,8,41,3,2
7,262,262,60,48,12,4,3
8,269,269,36,14,22,3,2
25,283,283,22,22,0,1,0
16,289,289,92,92,0,1,0
28,295,295,11,8,3,2,1
19,295,295,3,3,0,1,0
13,302,302,1,1,0,1,0
20,310,310,47,41,6,2,1
5,312,312,31,2,29,2,1
17,320,320,6,2,4,2,1
29,343,343,53,3,50,2,1
0,358,358,7,3,4,2,1
1,360,360,33,1,32,3,2
26,371,371,13,13,0,1,0
21,373,373,8,8,0,1,0
6,401,401,96,59,37,4,3
12,441,441,53,53,0,1,0
4,449,449,42,7,35,2,1
24,451,451,83,83,0,1,0
27,465,465,28,28,0,1,0
23,467,467,39,9,30,4,3
9,493,493,101,21,80,3,2

4,110,110,9,9,0,1,0
13,129,129,3,3,0,1,0
9,131,131,15,15,0,1,0
2,132,132,65,57,8,3,2
25,167,167,37,37,0,1,0
21,173,173,12,12,0,1,0
28,183,183,58,58,0,1,0
17,189,189,3,3,0,1,0
12,206,206,33,33,0,1,0
27,209,209,4,4,0,1,0
15,213,213,8,8,0,1,0
10,236,236,44,44,0,1,0
11,241,241,1,1,0,1,0
26,279,279,34,22,12,4,3
6,280,280,29,29,0,1,0
14,305,305,1,1,0,1,0
5,314,314,60,60,0,1,0
31,327,327,55,11,44,2,1
22,329,329,40,10,30,2,1
30,335,335,3,3,0,1,0
23,361,361,49,24,25,2,1
19,369,369,18,2,16,3,2
16,403,403,73,53,20,3,2
1,415,415,16,16,0,1,0
20,425,425,68,59,9,2,1
18,426,426,27,9,18,2,1
3,439,439,22,11,11,2,1
7,440,440,98,6,92,3,2
24,465,465,7,7,0,1,0
29,470,470,14,14,0,1,0
8,484,484,11,3,8,3,2
0,500,500,3,3,0,1,0

6,105,105,7,1,6,2,1
10,122,122,18,7,11,2,1
35,128,128,27,27,0,1,0
21,132,132,6,6,0,1,0
32,141,141,18,6,12,4,3
5,169,169,3,3,0,1,0
24,171,171,24,24,0,1,0
19,177,177,4,4,0,1,0
8,186,186,6,3,3,2,1
18,191,191,32,1,31,2,1
27,209,209,17,9,8,3,2
17,214,214,43,43,0,1,0
25,227,227,75,41,34,3,2
3,251,251,6,1,5,2,1
12,287,287,70,24,46,2,1
14,299,299,99,67,32,3,2
28,299,299,16,16,0,1,0
1,304,304,1,1,0,1,0
16,314,314,42,42,0,1,0
36,323,323,30,23,7,2,1
4,331,331,41,26,15,4,3
0,333,333,23,2,21,4,3
34,345,345,9,2,7,3,2
13,351,351,11,11,0,1,0
2,358,358,11,1,10,3,2
31,368,368,10,10,0,1,0
33,402,402,22,22,0,1,0
29,403,403,7,2,5,2,1
7,403,403,2,2,0,1,0
23,415,415,33,23,10,2,1
30,421,421,53,41,12,3,2
22,425,425,45,45,0,1,0
26,435,435,80,80,0,1,0
20,443,443,13,13,0,1,0
9,481,481,22,6,16,2,1
11,483,483,2,2,0,1,0
15,485,485,1,1,0,1,0

25,103,103,32,32,0,1,0
4,126,126,9,3,6,2,1
16,126,126,2,2,0,1,0
26,141,141,40,18,22,3,2
3,146,146,32,10,22,2,1
9,159,159,14,7,7,2,1
15,167,167,13,13,0,1,0
24,170,170,56,28,28,3,2
27,171,171,19,16,3,2,1
6,172,172,56,2,54,4,3
21,259,259,2,2,0,1,0
0,287,287,38,32,6,3,2
1,290,290,33,21,12,4,3
17,296,296,22,12,10,3,2
18,304,304,23,5,18,4,3
28,307,307,15,6,9,4,3
5,320,320,7,7,0,1,0
19,335,335,18,2,16,4,3
7,367,367,54,12,42,4,3
23,385,385,47,47,0,1,0
8,387,387,99,99,0,1,0
11,437,437,118,78,40,4,3
10,449,449,21,21,0,1,0
13,452,452,8,8,0,1,0
14,453,453,18,18,0,1,0
20,456,456,16,3,13,2,1
2,464,464,4,1,3,2,1
22,477,477,41,41,0,1,0
12,481,481,21,21,0,1,0

7,115,115,10,1,9,2,1
25,120,120,35,35,0,1,0
3,144,144,2,2,0,1,0
6,151,151,18,13,5,2,1
17,186,186,28,28,0,1,0
14,193,193,5,1,4,2,1
20,215,215,10,10,0,1,0
33,217,217,3,3,0,1,0
8,226,226,21,21,0,1,0
28,284,284,21,21,0,1,0
5,292,292,37,2,35,2,1
32,298,298,11,1,10,4,3
1,299,299,94,54,40,3,2
18,301,301,11,1,10,3,2
11,313,313,5,5,0,1,0
26,343,343,1,1,0,1,0
30,351,351,8,8,0,1,0
21,366,366,95,68,27,3,2
31,367,367,30,30,0,1,0
13,373,373,88,37,51,4,3
19,373,373,17,17,0,1,0
27,376,376,11,1,10,2,1
29,393,393,124,124,0,1,0
2,398,398,10,6,4,2,1
24,423,423,92,92,0,1,0
23,437,437,28,2,26,3,2
12,437,437,5,5,0,1,0
10,440,440,153,46,107,4,3
22,452,452,16,4,12,4,3
16,453,453,29,29,0,1,0
9,475,475,33,33,0,1,0
15,487,487,7,7,0,1,0
0,489,489,52,20,32,2,1
4,494,494,15,9,6,2,1

15,107,107,8,4,4,2,1
29,113,113,2,2,0,1,0
12,128,128,18,10,8,2,1
23,167,167,22,1,21,2,1
20,174,174,10,10,0,1,0
10,217,217,8,8,0,1,0
0,222,222,77,57,20,3,2
28,241,241,16,16,0,1,0
3,261,261,49,44,5,2,1
21,274,274,8,8,0,1,0
4,275,275,25,25,0,1,0
26,278,278,8,8,0,1,0
18,281,281,21,7,14,2,1
6,286,286,1,1,0,1,0
2,306,306,45,7,38,3,2
13,306,306,79,79,0,1,0
1,312,312,69,59,10,2,1
16,332,332,46,46,0,1,0
25,334,334,122,122,0,1,0
27,407,407,93,93,0,1,0
17,410,410,19,10,9,4,3
11,441,441,53,14,39,2,1
9,446,446,3,3,0,1,0
22,450,450,35,35,0,1,0
7,460,460,24,24,0,1,0
5,466,466,148,108,40,4,3
8,470,470,14,14,0,1,0
24,472,472,40,40,0,1,0
14,482,482,26,26,0,1,0
19,483,483,2,2,0,1,0

15,102,102,3,3,0,1,0
18,120,120,9,9,0,1,0
11,122,122,2,2,0,1,0
2,139,139,10,10,0,1,0
1,150,150,5,5,0,1,0
29,163,163,13,13,0,1,0
17,176,176,3,3,0,1,0
24,182,182,27,27,0,1,0
22,184,184,29,5,24,3,2
0,193,193,23,23,0,1,0
32,196,196,26,26,0,1,0
3,204,204,18,18,0,1,0
4,242,242,12,12,0,1,0
27,242,242,2,2,0,1,0
34,249,249,65,65,0,1,0
21,277,277,12,12,0,1,0
31,294,294,19,19,0,1,0
19,313,313,1,1,0,1,0
10,340,340,37,37,0,1,0
20,343,343,13,7,6,2,1
13,367,367,76,24,52,3,2
12,368,368,64,16,48,2,1
9,379,379,78,34,44,2,1
6,381,381,10,1,9,4,3
7,398,398,19,19,0,1,0
8,399,399,142,142,0,1,0
16,411,411,13,13,0,1,0
14,419,419,28,28,0,1,0
30,438,438,83,55,28,3,2
23,455,455,37,37,0,1,0
5,459,459,24,6,18,4,3
26,463,463,47,30,17,2,1
28,480,480,102,102,0,1,0
25,480,480,59,56,3,2,1
33,495,495,6,6,0,1,0

32,149,149,14,4,10,3,2
19,153,153,21,21,0,1,0
4,176,176,4,1,3,2,1
6,177,177,16,10,6,3,2
31,179,179,20,10,10,2,1
24,195,195,2,2,0,1,0
14,207,207,41,15,26,3,2
0,211,211,2,2,0,1,0
25,211,211,18,6,12,3,2
5,269,269,44,32,12,2,1
29,272,272,1,1,0,1,0
18,278,278,12,3,9,4,3
27,278,278,10,10,0,1,0
37,336,336,21,13,8,2,1
11,337,337,25,4,21,2,1
21,343,343,18,5,13,2,1
26,350,350,38,32,6,2,1
35,359,359,56,56,0,1,0
3,360,360,40,25,15,2,1
13,360,360,14,10,4,2,1
8,362,362,32,14,18,4,3
38,380,380,96,50,46,3,2
2,391,391,16,6,10,2,1
22,392,392,64,64,0,1,0
10,394,394,51,3,48,3,2
36,408,408,80,80,0,1,0
12,417,417,12,4,8,2,1
30,422,422,82,42,40,2,1
28,442,442,23,23,0,1,0
17,445,445,27,11,16,3,2
33,458,458,52,25,27,4,3
7,459,459,19,13,6,3,2
9,464,464,22,7,15,2,1
34,470,470,43,43,0,1,0
16,472,472,3,3,0,1,0
15,476,476,26,20,6,3,2
20,478,478,48,32,16,3,2
1,481,481,78,25,53,4,3
23,488,488,1,1,0,1,0

23,111,111,6,1,5,2,1
41,133,133,6,6,0,1,0
3,161,161,5,5,0,1,0
33,163,163,21,7,14,2,1
31,164,164,4,4,0,1,0
7,168,168,18,18,0,1,0
9,176,176,12,12,0,1,0
5,182,182,6,6,0,1,0
40,200,200,13,8,5,2,1
29,206,206,24,24,0,1,0
26,220,220,48,13,35,2,1
10,239,239,7,7,0,1,0
19,256,256,7,1,6,2,1
28,263,263,22,22,0,1,0
8,273,273,25,25,0,1,0
24,275,275,23,2,21,2,1
14,278,278,8,8,0,1,0
18,288,288,130,130,0,1,0
36,291,291,50,26,24,4,3
0,297,297,1,1,0,1,0
1,309,309,8,1,7,2,1
16,347,347,50,50,0,1,0
25,352,352,16,2,14,3,2
4,352,352,30,6,24,2,1
20,363,363,5,5,0,1,0
27,371,371,54,54,0,1,0
6,386,386,63,63,0,1,0
34,394,394,15,15,0,1,0
22,397,397,2,2,0,1,0
30,404,404,14,10,4,2,1
35,405,405,53,29,24,4,3
37,405,405,1,1,0,1,0
17,405,405,1,1,0,1,0
11,423,423,13,13,0,1,0
32,429,429,54,32,22,2,1
13,445,445,12,12,0,1,0
2,452,452,17,17,0,1,0
21,461,461,35,35,0,1,0
15,468,468,13,10,3,2,1
12,487,487,26,12,14,3,2
39,490,490,108,48,60,4,3
38,492,492,68,68,0,1,0

21,117,117,21,21,0,1,0
31,118,118,14,10,4,2,1
6,137,137,44,44,0,1,0
18,155,155,18,10,8,3,2
17,163,163,26,16,10,3,2
26,166,166,11,11,0,1,0
25,167,167,26,26,0,1,0
23,178,178,1,1,0,1,0
14,180,180,16,10,6,2,1
19,187,187,15,15,0,1,0
9,196,196,16,4,12,4,3
4,211,211,36,36,0,1,0
11,212,212,69,69,0,1,0
22,213,213,13,13,0,1,0
2,243,243,62,62,0,1,0
30,248,248,18,3,15,2,1
32,253,253,1,1,0,1,0
10,262,262,32,18,14,2,1
8,312,312,20,20,0,1,0
27,329,329,7,7,0,1,0
7,363,363,24,16,8,2,1
15,368,368,4,4,0,1,0
28,372,372,33,33,0,1,0
0,379,379,9,5,4,2,1
24,403,403,91,91,0,1,0
5,405,405,2,2,0,1,0
16,411,411,51,51,0,1,0
12,420,420,17,5,12,2,1
20,453,453,46,3,43,2,1
13,460,460,21,21,0,1,0
1,475,475,22,22,0,1,0
29,476,476,72,4,68,3,2
3,490,490,17,17,0,1,0

0,108,108,10,10,0,1,0
2,110,110,1,1,0,1,0
25,117,117,7,7,0,1,0
12,129,129,1,1,0,1,0
32,132,132,14,14,0,1,0
8,143,143,47,47,0,1,0
27,160,160,13,13,0,1,0
24,184,184,32,14,18,2,1
4,192,192,59,59,0,1,0
33,203,203,12,12,0,1,0
30,213,213,33,27,6,2,1
18,241,241,37,37,0,1,0
6,247,247,5,5,0,1,0
11,252,252,62,62,0,1,0
9,272,272,1,1,0,1,0
20,289,289,41,41,0,1,0
29,295,295,6,6,0,1,0
13,301,301,12,12,0,1,0
17,315,315,9,9,0,1,0
15,320,320,16,10,6,2,1
26,324,324,35,35,0,1,0
7,348,348,26,26,0,1,0
22,353,353,45,45,0,1,0
28,370,370,50,32,18,4,3
14,386,386,54,12,42,2,1
19,390,390,69,69,0,1,0
23,399,399,23,23,0,1,0
5,405,405,47,2,45,4,3
3,406,406,39,39,0,1,0
21,407,407,4,4,0,1,0
34,433,433,52,52,0,1,0
1,462,462,47,33,14,2,1
31,481,481,23,23,0,1,0
16,495,495,17,2,15,4,3
10,499,499,2,2,0,1,0

35,101,101,4,4,0,1,0
18,104,104,12,12,0,1,0
15,105,105,10,10,0,1,0
24,114,114,1,1,0,1,0
3,121,121,3,3,0,1,0
29,137,137,7,1,6,2,1
7,143,143,24,24,0,1,0
30,158,158,23,5,18,3,2
0,178,178,8,8,0,1,0
19,180,180,16,16,0,1,0
27,192,192,6,2,4,2,1
6,217,217,7,7,0,1,0
20,243,243,33,33,0,1,0
9,252,252,15,6,9,4,3
2,261,261,7,7,0,1,0
1,294,294,18,8,10,2,1
32,309,309,48,18,30,3,2
28,319,319,13,3,10,3,2
22,329,329,50,50,0,1,0
17,330,330,79,79,0,1,0
23,330,330,2,2,0,1,0
16,344,344,25,25,0,1,0
11,366,366,16,2,14,3,2
14,371,371,45,45,0,1,0
12,374,374,4,4,0,1,0
13,377,377,36,13,23,3,2
4,386,386,6,1,5,2,1
36,389,389,13,3,10,3,2
34,392,392,41,15,26,2,1
26,400,400,211,189,22,2,1
10,406,406,11,2,9,2,1
25,411,411,71,71,0,1,0
21,425,425,5,1,4,2,1
31,432,432,36,14,22,2,1
5,455,455,13,13,0,1,0
33,458,458,16,10,6,2,1
8,485,485,160,94,66,4,3

23,105,105,19,16,3,2,1
2,107,107,24,3,21,4,3
30,111,111,32,32,0,1,0
14,125,125,10,7,3,2,1
26,146,146,2,2,0,1,0
18,161,161,18,8,10,2,1
9,165,165,10,2,8,2,1
13,169,169,1,1,0,1,0
0,170,170,12,12,0,1,0
12,171,171,1,1,0,1,0
34,193,193,9,2,7,2,1
39,197,197,9,9,0,1,0
5,204,204,4,4,0,1,0
36,245,245,55,55,0,1,0
16,268,268,16,16,0,1,0
38,269,269,4,4,0,1,0
6,291,291,38,27,11,2,1
25,300,300,8,8,0,1,0
33,308,308,60,30,30,3,2
21,311,311,5,5,0,1,0
27,317,317,19,9,10,3,2
15,321,321,17,17,0,1,0
8,325,325,9,3,6,3,2
28,342,342,10,10,0,1,0
32,342,342,5,5,0,1,0
7,352,352,15,15,0,1,0
37,384,384,45,31,14,3,2
11,392,392,9,9,0,1,0
4,397,397,32,18,14,2,1
19,397,397,2,2,0,1,0
20,413,413,3,3,0,1,0
35,418,418,2,2,0,1,0
17,419,419,49,11,38,2,1
3,420,420,109,1,108,4,3
24,435,435,28,9,19,2,1
22,436,436,55,12,43,2,1
10,444,444,46,46,0,1,0
31,450,450,55,55,0,1,0
29,456,456,133,71,62,3,2
1,473,473,34,34,0,1,0

26,108,108,36,36,0,1,0
17,114,114,15,9,6,2,1
22,129,129,18,11,7,2,1
31,145,145,9,5,4,2,1
11,150,150,64,64,0,1,0
15,158,158,2,2,0,1,0
24,158,158,43,17,26,3,2
0,158,158,5,5,0,1,0
14,163,163,2,2,0,1,0
33,223,223,3,3,0,1,0
5,224,224,20,20,0,1,0
9,225,225,6,6,0,1,0
21,227,227,13,4,9,2,1
6,243,243,14,14,0,1,0
19,258,258,3,3,0,1,0
2,275,275,3,3,0,1,0
16,275,275,22,2,20,3,2
7,301,301,2,2,0,1,0
32,307,307,2,2,0,1,0
28,314,314,1,1,0,1,0
3,314,314,107,107,0,1,0
8,317,317,11,11,0,1,0
23,332,332,35,23,12,2,1
1,337,337,44,11,33,3,2
25,341,341,53,33,20,2,1
20,341,341,17,7,10,2,1
4,354,354,86,80,6,3,2
18,379,379,19,12,7,2,1
29,387,387,5,5,0,1,0
27,391,391,73,43,30,4,3
13,409,409,6,6,0,1,0
12,410,410,34,34,0,1,0
10,423,423,43,28,15,2,1
30,471,471,73,73,0,1,0

29,124,124,6,6,0,1,0
24,128,128,19,19,0,1,0
0,131,131,9,9,0,1,0
19,133,133,7,7,0,1,0
9,151,151,1,1,0,1,0
34,154,154,23,2,21,4,3
27,159,159,15,15,0,1,0
35,178,178,26,26,0,1,0
15,188,188,13,2,11,2,1
5,202,202,1,1,0,1,0
17,228,228,103,103,0,1,0
30,240,240,105,105,0,1,0
32,260,260,1,1,0,1,0
3,263,263,45,45,0,1,0
23,283,283,17,9,8,3,2
8,295,295,10,4,6,3,2
31,307,307,9,9,0,1,0
2,309,309,5,5,0,1,0
14,312,312,26,26,0,1,0
6,312,312,4,4,0,1,0
10,313,313,39,12,27,4,3
13,314,314,9,9,0,1,0
33,325,325,42,12,30,3,2
1,326,326,47,47,0,1,0
28,333,333,14,14,0,1,0
22,335,335,17,6,11,2,1
18,342,342,101,55,46,4,3
21,359,359,2,2,0,1,0
20,377,377,53,43,10,3,2
12,382,382,9,9,0,1,0
16,393,393,5,5,0,1,0
7,399,399,20,20,0,1,0
11,408,408,30,30,0,1,0
26,415,415,8,2,6,2,1
4,487,487,15,15,0,1,0
25,499,499,81,51,30,2,1

26,128,128,14,2,12,3,2
6,133,133,2,2,0,1,0
2,145,145,4,4,0,1,0
31,152,152,23,23,0,1,0
32,183,183,22,22,0,1,0
18,196,196,48,48,0,1,0
30,207,207,7,1,6,2,1
10,215,215,7,3,4,2,1
5,227,227,97,34,63,4,3
13,228,228,15,1,14,3,2
14,240,240,19,10,9,4,3
4,241,241,10,10,0,1,0
20,247,247,3,3,0,1,0
1,248,248,7,7,0,1,0
7,267,267,27,27,0,1,0
21,284,284,16,6,10,2,1
15,324,324,14,14,0,1,0
22,329,329,7,1,6,2,1
28,352,352,16,16,0,1,0
25,365,365,29,20,9,4,3
24,374,374,32,20,12,4,3
8,405,405,67,48,19,2,1
19,425,425,5,5,0,1,0
27,438,438,84,68,16,3,2
29,443,443,34,34,0,1,0
11,444,444,118,74,44,4,3
33,447,447,58,58,0,1,0
3,457,457,12,12,0,1,0
12,460,460,53,8,45,3,2
16,463,463,3,3,0,1,0
23,470,470,45,21,24,3,2
9,470,470,69,25,44,3,2
17,486,486,127,70,57,4,3
0,497,497,56,16,40,3,2

9,111,111,2,2,0,1,0
16,129,129,3,3,0,1,0
18,130,130,3,3,0,1,0
24,142,142,10,10,0,1,0
7,153,153,14,14,0,1,0
35,181,181,3,3,0,1,0
26,189,189,2,2,0,1,0
22,205,205,40,40,0,1,0
10,216,216,61,61,0,1,0
12,224,224,2,2,0,1,0
32,240,240,13,13,0,1,0
14,251,251,2,2,0,1,0
27,269,269,27,27,0,1,0
28,283,283,20,8,12,2,1
30,287,287,53,53,0,1,0
23,292,292,19,19,0,1,0
33,308,308,11,11,0,1,0
17,310,310,22,22,0,1,0
20,325,325,19,19,0,1,0
34,328,328,111,17,94,3,2
1,333,333,31,31,0,1,0
29,333,333,19,19,0,1,0
15,356,356,43,5,38,2,1
3,374,374,6,3,3,2,1
21,377,377,8,2,6,3,2
0,408,408,44,37,7,2,1
8,422,422,121,98,23,4,3
2,436,436,5,5,0,1,0
5,449,449,54,18,36,3,2
25,464,464,14,11,3,2,1
19,465,465,111,83,28,2,1
13,466,466,14,14,0,1,0
6,472,472,37,29,8,2,1
11,490,490,137,104,33,3,2
31,496,496,97,77,20,3,2
4,499,499,16,5,11,2,1

28,111,111,10,10,0,1,0
24,122,122,4,4,0,1,0
15,153,153,1,1,0,1,0
20,161,161,34,7,27,4,3
32,184,184,11,6,5,2,1
0,206,206,2,2,0,1,0
30,225,225,9,1,8,3,2
2,235,235,16,6,10,2,1
27,254,254,1,1,0,1,0
13,269,269,41,11,30,3,2
7,278,278,32,32,0,1,0
1,292,292,1,1,0,1,0
11,298,298,12,7,5,2,1
17,299,299,25,1,24,4,3
5,307,307,26,26,0,1,0
12,311,311,28,20,8,2,1
23,312,312,76,76,0,1,0
22,312,312,74,23,51,4,3
21,327,327,52,34,18,2,1
31,328,328,27,3,24,4,3
16,340,340,11,11,0,1,0
9,375,375,48,48,0,1,0
29,377,377,10,10,0,1,0
25,392,392,8,2,6,3,2
6,394,394,122,110,12,4,3
4,394,394,27,21,6,3,2
8,403,403,70,17,53,4,3
10,424,424,68,27,41,2,1
26,437,437,36,3,33,4,3
19,439,439,62,24,38,4,3
33,440,440,12,3,9,4,3
18,451,451,86,86,0,1,0
3,456,456,108,81,27,4,3
14,498,498,11,11,0,1,0

23,104,104,20,2,18,2,1
7,116,116,57,12,45,3,2
21,124,124,2,2,0,1,0
28,125,125,23,13,10,2,1
16,126,126,25,25,0,1,0
29,145,145,10,5,5,2,1
12,155,155,49,49,0,1,0
1,165,165,8,8,0,1,0
25,170,170,10,4,6,2,1
24,173,173,1,1,0,1,0
13,195,195,18,12,6,2,1
14,207,207,7,3,4,2,1
2,225,225,8,8,0,1,0
19,248,248,78,50,28,2,1
26,264,264,2,2,0,1,0
5,267,267,22,22,0,1,0
27,273,273,22,14,8,3,2
22,279,279,78,57,21,4,3
18,318,318,58,58,0,1,0
11,327,327,26,4,22,3,2
20,341,341,10,10,0,1,0
30,357,357,29,4,25,2,1
4,358,358,35,35,0,1,0
3,360,360,34,34,0,1,0
9,410,410,12,12,0,1,0
6,441,441,58,58,0,1,0
0,457,457,41,1,40,3,2
10,458,458,13,13,0,1,0
15,462,462,1,1,0,1,0
8,463,463,39,39,0,1,0
17,491,491,2,2,0,1,0

9,122,122,17,17,0,1,0
18,130,130,13,7,6,2,1
23,170,170,39,39,0,1,0
25,181,181,8,1,7,2,1
19,199,199,40,40,0,1,0
11,202,202,21,21,0,1,0
2,204,204,25,25,0,1,0
16,215,215,2,2,0,1,0
24,218,218,2,2,0,1,0
7,224,224,11,2,9,4,3
5,231,231,31,20,11,2,1
32,283,283,19,19,0,1,0
28,292,292,5,2,3,2,1
20,296,296,26,26,0,1,0
15,310,310,55,55,0,1,0
26,315,315,17,17,0,1,0
8,336,336,112,60,52,3,2
27,342,342,6,6,0,1,0
14,354,354,4,4,0,1,0
29,357,357,5,2,3,2,1
3,370,370,2,2,0,1,0
21,378,378,35,3,32,2,1
17,388,388,126,86,40,3,2
0,398,398,10,4,6,2,1
6,398,398,1,1,0,1,0
22,401,401,8,8,0,1,0
4,420,420,14,4,10,2,1
30,448,448,85,85,0,1,0
31,456,456,113,113,0,1,0
10,465,465,27,27,0,1,0
12,472,472,4,4,0,1,0
1,476,476,154,80,74,4,3
13,494,494,86,86,0,1,0

24,111,111,3,3,0,1,0
3,112,112,53,13,40,2,1
23,113,113,17,17,0,1,0
11,128,128,40,40,0,1,0
12,132,132,4,1,3,2,1
20,161,161,24,24,0,1,0
21,170,170,2,2,0,1,0
16,171,171,10,2,8,3,2
17,172,172,67,55,12,3,2
6,189,189,25,12,13,4,3
19,216,216,19,19,0,1,0
18,220,220,3,3,0,1,0
31,224,224,2,2,0,1,0
5,235,235,4,4,0,1,0
32,254,254,28,28,0,1,0
13,270,270,21,21,0,1,0
28,282,282,20,9,11,2,1
0,308,308,4,4,0,1,0
14,326,326,7,3,4,2,1
8,336,336,6,6,0,1,0
33,345,345,80,80,0,1,0
27,358,358,64,64,0,1,0
22,359,359,3,3,0,1,0
15,374,374,74,5,69,4,3
7,376,376,1,1,0,1,0
10,389,389,38,38,0,1,0
4,402,402,23,23,0,1,0
1,430,430,77,11,66,4,3
29,436,436,3,3,0,1,0
30,449,449,6,3,3,2,1
25,450,450,66,28,38,3,2
2,452,452,4,1,3,2,1
26,459,459,59,59,0,1,0
9,500,500,2,2,0,1,0

12,109,109,4,1,3,2,1
21,122,122,8,8,0,1,0
8,146,146,1,1,0,1,0
24,155,155,22,22,0,1,0
29,167,167,7,7,0,1,0
0,168,168,6,6,0,1,0
31,171,171,22,22,0,1,0
16,190,190,7,7,0,1,0
26,199,199,35,35,0,1,0
22,208,208,11,11,0,1,0
11,210,210,47,12,35,2,1
19,211,211,7,1,6,3,2
14,224,224,3,3,0,1,0
32,225,225,32,32,0,1,0
4,225,225,59,49,10,3,2
23,233,233,35,35,0,1,0
6,244,244,11,11,0,1,0
27,259,259,33,33,0,1,0
13,285,285,21,21,0,1,0
2,296,296,28,3,25,4,3
25,307,307,77,4,73,4,3
30,318,318,29,29,0,1,0
1,321,321,38,38,0,1,0
28,327,327,2,2,0,1,0
18,339,339,72,35,37,2,1
17,347,347,6,6,0,1,0
7,353,353,4,4,0,1,0
10,386,386,38,29,9,4,3
20,411,411,26,4,22,2,1
3,416,416,62,62,0,1,0
15,427,427,11,11,0,1,0
9,455,455,146,119,27,4,3
5,468,468,87,59,28,3,2

35,119,119,1,1,0,1,0
5,133,133,1,1,0,1,0
31,144,144,18,8,10,2,1
39,156,156,11,8,3,2,1
22,168,168,11,11,0,1,0
34,187,187,15,15,0,1,0
40,205,205,14,14,0,1,0
7,211,211,7,7,0,1,0
37,213,213,18,7,11,2,1
38,224,224,11,1,10,3,2
26,226,226,43,43,0,1,0
3,226,226,15,15,0,1,0
14,226,226,4,1,3,2,1
20,231,231,3,3,0,1,0
32,234,234,23,23,0,1,0
1,235,235,11,2,9,3,2
8,268,268,47,18,29,2,1
42,283,283,23,11,12,4,3
33,304,304,88,88,0,1,0
6,313,313,1,1,0,1,0
10,317,317,32,32,0,1,0
21,326,326,27,16,11,2,1
17,328,328,13,13,0,1,0
13,328,328,26,20,6,2,1
15,346,346,46,46,0,1,0
24,359,359,43,31,12,2,1
28,361,361,11,11,0,1,0
18,374,374,22,22,0,1,0
30,383,383,8,4,4,2,1
12,386,386,28,28,0,1,0
29,391,391,78,54,24,2,1
4,391,391,2,2,0,1,0
11,413,413,21,21,0,1,0
0,423,423,8,4,4,2,1
27,430,430,68,68,0,1,0
16,437,437,3,3,0,1,0
41,438,438,35,35,0,1,0
19,450,450,60,60,0,1,0
2,460,460,96,36,60,4,3
9,460,460,23,2,21,2,1
23,477,477,44,26,18,3,2
36,488,488,50,32,18,2,1
25,490,490,10,10,0,1,0

33,139,139,23,14,9,4,3
16,145,145,39,39,0,1,0
18,183,183,25,25,0,1,0
21,185,185,18,18,0,1,0
0,187,187,6,3,3,2,1
31,204,204,27,16,11,4,3
20,206,206,9,9,0,1,0
32,206,206,54,15,39,4,3
13,216,216,1,1,0,1,0
5,238,238,1,1,0,1,0
12,249,249,44,44,0,1,0
30,266,266,1,1,0,1,0
25,266,266,18,18,0,1,0
2,279,279,10,10,0,1,0
27,292,292,18,4,14,2,1
35,309,309,70,22,48,4,3
3,312,312,13,13,0,1,0
4,329,329,12,12,0,1,0
26,351,351,23,23,0,1,0
7,363,363,21,17,4,2,1
29,366,366,13,13,0,1,0
36,375,375,36,29,7,2,1
6,399,399,12,12,0,1,0
22,439,439,4,1,3,2,1
1,446,446,18,18,0,1,0
23,448,448,34,34,0,1,0
17,459,459,64,64,0,1,0
24,462,462,143,53,90,4,3
34,463,463,32,32,0,1,0
11,466,466,47,47,0,1,0
14,474,474,10,7,3,2,1
8,474,474,25,25,0,1,0
28,476,476,6,6,0,1,0
19,477,477,11,11,0,1,0
15,478,478,4,4,0,1,0
10,481,481,218,164,54,4,3
9,484,484,18,13,5,2,1

32,102,102,4,4,0,1,0
11,103,103,27,27,0,1,0
8,109,109,9,9,0,1,0
6,109,109,5,5,0,1,0
15,123,123,1,1,0,1,0
13,150,150,8,5,3,2,1
29,150,150,18,18,0,1,0
31,150,150,27,21,6,3,2
30,164,164,42,42,0,1,0
33,167,167,31,21,10,2,1
18,198,198,24,21,3,2,1
28,219,219,47,47,0,1,0
19,220,220,28,28,0,1,0
2,254,254,4,4,0,1,0
4,264,264,21,21,0,1,0
20,273,273,18,10,8,3,2
17,290,290,24,15,9,2,1
12,300,300,48,4,44,3,2
26,302,302,4,4,0,1,0
22,331,331,3,3,0,1,0
5,339,339,62,18,44,2,1
25,358,358,8,8,0,1,0
7,361,361,30,21,9,2,1
3,370,370,12,12,0,1,0
1,389,389,49,45,4,2,1
34,392,392,4,1,3,2,1
16,392,392,42,42,0,1,0
24,406,406,20,20,0,1,0
14,410,410,76,76,0,1,0
23,430,430,140,11,129,4,3
0,438,438,6,6,0,1,0
27,461,461,8,8,0,1,0
35,466,466,22,4,18,3,2
10,469,469,1,1,0,1,0
21,482,482,29,8,21,4,3
9,494,494,29,29,0,1,0

14,100,100,15,7,8,2,1
27,102,102,17,17,0,1,0
11,152,152,16,2,14,3,2
15,158,158,5,5,0,1,0
26,193,193,27,19,8,3,2
19,209,209,59,59,0,1,0
24,223,223,15,15,0,1,0
18,243,243,8,8,0,1,0
5,255,255,32,32,0,1,0
16,286,286,3,3,0,1,0
13,287,287,31,31,0,1,0
20,291,291,26,17,9,2,1
12,294,294,8,5,3,2,1
22,341,341,91,86,5,2,1
25,344,344,31,7,24,3,2
6,347,347,117,117,0,1,0
8,361,361,8,8,0,1,0
0,364,364,65,65,0,1,0
28,376,376,6,1,5,2,1
1,385,385,128,23,105,4,3
4,395,395,14,14,0,1,0
17,401,401,3,3,0,1,0
3,402,402,12,12,0,1,0
7,408,408,37,37,0,1,0
10,416,416,8,8,0,1,0
23,435,435,22,6,16,3,2
21,473,473,92,14,78,3,2
2,482,482,10,10,0,1,0
9,488,488,199,64,135,4,3

4,133,133,5,2,3,2,1
22,138,138,2,2,0,1,0
12,149,149,59,23,36,4,3
28,204,204,13,13,0,1,0
16,211,211,8,5,3,2,1
26,215,215,22,22,0,1,0
18,216,216,3,3,0,1,0
24,225,225,4,1,3,2,1
14,232,232,50,50,0,1,0
9,246,246,6,6,0,1,0
21,252,252,8,3,5,2,1
15,265,265,19,19,0,1,0
1,271,271,1,1,0,1,0
0,283,283,8,2,6,2,1
34,288,288,5,5,0,1,0
10,298,298,25,7,18,4,3
27,302,302,63,33,30,4,3
17,303,303,62,5,57,4,3
30,309,309,18,18,0,1,0
29,319,319,45,45,0,1,0
8,329,329,42,14,28,2,1
31,335,335,14,14,0,1,0
20,342,342,62,50,12,4,3
2,345,345,21,21,0,1,0
3,346,346,32,2,30,3,2
36,354,354,19,19,0,1,0
5,354,354,8,8,0,1,0
6,391,391,35,30,5,2,1
19,416,416,59,25,34,3,2
25,423,423,11,11,0,1,0
11,427,427,14,2,12,2,1
33,442,442,36,20,16,2,1
35,461,461,262,214,48,3,2
32,478,478,22,19,3,2,1
23,480,480,35,35,0,1,0
7,485,485,1,1,0,1,0
13,499,499,7,1,6,3,2

15,103,103,1,1,0,1,0
14,103,103,5,5,0,1,0
12,107,107,2,2,0,1,0
3,114,114,22,22,0,1,0
1,120,120,1,1,0,1,0
0,120,120,1,1,0,1,0
5,125,125,4,4,0,1,0
24,142,142,9,5,4,2,1
6,156,156,1,1,0,1,0
32,157,157,10,3,7,2,1
25,165,165,25,25,0,1,0
20,206,206,33,33,0,1,0
31,210,210,57,9,48,2,1
38,223,223,33,2,31,2,1
26,254,254,20,7,13,2,1
18,266,266,12,12,0,1,0
21,272,272,18,18,0,1,0
4,273,273,29,29,0,1,0
36,277,277,25,25,0,1,0
10,281,281,47,2,45,4,3
29,294,294,24,6,18,4,3
33,305,305,29,5,24,3,2
23,327,327,1,1,0,1,0
28,330,330,2,2,0,1,0
22,333,333,79,79,0,1,0
37,338,338,36,3,33,4,3
39,363,363,49,39,10,3,2
9,370,370,30,30,0,1,0
8,371,371,29,2,27,2,1
13,394,394,13,13,0,1,0
2,434,434,37,37,0,1,0
16,434,434,5,5,0,1,0
19,443,443,17,17,0,1,0
7,450,450,60,13,47,2,1
11,450,450,27,8,19,4,3
30,458,458,49,8,41,2,1
27,465,465,29,1,28,3,2
35,478,478,55,43,12,3,2
34,479,479,71,2,69,4,3
17,493,493,36,5,31,2,1

13,102,102,1,1,0,1,0
10,105,105,5,1,4,2,1
29,109,109,6,6,0,1,0
26,113,113,13,13,0,1,0
22,121,121,5,5,0,1,0
20,122,122,2,2,0,1,0
32,152,152,47,47,0,1,0
0,165,165,13,3,10,2,1
21,193,193,8,8,0,1,0
12,210,210,1,1,0,1,0
3,213,213,3,3,0,1,0
2,236,236,18,18,0,1,0
31,240,240,5,5,0,1,0
19,252,252,82,28,54,4,3
30,255,255,87,41,46,3,2
33,259,259,1,1,0,1,0
16,278,278,20,20,0,1,0
8,288,288,85,59,26,3,2
27,300,300,3,3,0,1,0
4,327,327,31,2,29,2,1
1,338,338,4,4,0,1,0
17,342,342,40,8,32,3,2
5,345,345,12,12,0,1,0
23,359,359,66,66,0,1,0
28,360,360,8,8,0,1,0
24,377,377,18,18,0,1,0
7,392,392,64,13,51,4,3
35,419,419,22,22,0,1,0
25,438,438,45,17,28,3,2
18,440,440,99,69,30,4,3
6,448,448,8,1,7,2,1
9,471,471,79,45,34,3,2
14,478,478,87,36,51,4,3
15,480,480,41,41,0,1,0
11,486,486,2,2,0,1,0
34,500,500,32,23,9,4,3

17,140,140,28,9,19,3,2
13,143,143,8,8,0,1,0
11,146,146,3,3,0,1,0
29,149,149,6,6,0,1,0
20,152,152,4,1,3,2,1
12,162,162,21,21,0,1,0
18,164,164,17,17,0,1,0
32,206,206,8,1,7,2,1
7,226,226,23,15,8,2,1
15,234,234,17,17,0,1,0
30,282,282,13,13,0,1,0
24,289,289,1,1,0,1,0
19,298,298,52,52,0,1,0
25,306,306,9,5,4,2,1
21,308,308,18,18,0,1,0
23,313,313,2,2,0,1,0
28,323,323,56,9,47,4,3
31,339,339,1,1,0,1,0
0,351,351,35,11,24,2,1
14,357,357,46,14,32,3,2
2,361,361,6,6,0,1,0
3,362,362,44,23,21,2,1
4,375,375,14,14,0,1,0
9,387,387,105,105,0,1,0
1,406,406,39,7,32,2,1
27,433,433,89,89,0,1,0
6,438,438,50,50,0,1,0
16,449,449,61,23,38,3,2
10,451,451,4,1,3,2,1
26,460,460,115,115,0,1,0
22,461,461,111,13,98,3,2
5,483,483,39,25,14,2,1
8,491,491,170,80,90,4,3

23,102,102,5,1,4,2,1
15,109,109,3,3,0,1,0
14,112,112,29,13,16,3,2
3,117,117,8,3,5,2,1
2,134,134,36,1,35,4,3
24,134,134,18,4,14,3,2
10,165,165,41,8,33,4,3
18,168,168,10,10,0,1,0
26,178,178,32,32,0,1,0
1,188,188,16,16,0,1,0
22,202,202,2,2,0,1,0
13,215,215,7,7,0,1,0
20,217,217,32,10,22,3,2
33,234,234,1,1,0,1,0
34,242,242,2,2,0,1,0
7,243,243,20,14,6,3,2
31,244,244,25,25,0,1,0
28,262,262,30,30,0,1,0
9,266,266,12,12,0,1,0
8,267,267,13,4,9,2,1
25,274,274,108,76,32,3,2
0,296,296,21,15,6,3,2
12,299,299,1,1,0,1,0
16,321,321,39,24,15,2,1
29,324,324,37,37,0,1,0
17,345,345,3,3,0,1,0
30,362,362,80,80,0,1,0
5,364,364,38,26,12,3,2
6,398,398,14,14,0,1,0
21,406,406,27,12,15,2,1
27,412,412,37,37,0,1,0
32,420,420,3,3,0,1,0
19,435,435,17,9,8,3,2
11,448,448,16,16,0,1,0
4,465,465,72,72,0,1,0

25,101,101,17,7,10,3,2
5,121,121,24,19,5,2,1
27,156,156,29,29,0,1,0
1,174,174,1,1,0,1,0
3,180,180,2,2,0,1,0
2,196,196,49,49,0,1,0
15,205,205,44,23,21,4,3
18,227,227,22,10,12,3,2
6,257,257,77,31,46,2,1
14,270,270,28,28,0,1,0
17,277,277,10,10,0,1,0
12,296,296,4,4,0,1,0
10,316,316,69,7,62,3,2
8,320,320,22,16,6,3,2
16,343,343,27,13,14,2,1
11,357,357,43,7,36,4,3
22,368,368,4,4,0,1,0
7,378,378,60,48,12,2,1
4,383,383,90,33,57,4,3
13,385,385,25,1,24,3,2
23,390,390,68,23,45,2,1
20,394,394,13,13,0,1,0
0,415,415,28,19,9,4,3
24,417,417,15,6,9,2,1
28,417,417,25,5,20,2,1
19,430,430,31,5,26,2,1
21,483,483,123,79,44,4,3
9,488,488,26,26,0,1,0
26,488,488,16,7,9,4,3
29,498,498,53,53,0,1,0

10,121,121,3,3,0,1,0
30,130,130,23,23,0,1,0
32,137,137,11,11,0,1,0
24,150,150,6,6,0,1,0
19,156,156,20,8,12,2,1
1,161,161,15,15,0,1,0
26,167,167,12,12,0,1,0
16,175,175,7,1,6,3,2
41,193,193,69,37,32,2,1
2,211,211,7,7,0,1,0
40,213,213,14,14,0,1,0
23,216,216,11,11,0,1,0
9,220,220,4,1,3,2,1
21,221,221,57,30,27,4,3
14,227,227,13,13,0,1,0
0,236,236,1,1,0,1,0
35,245,245,40,12,28,3,2
37,261,261,1,1,0,1,0
29,273,273,10,1,9,4,3
31,286,286,37,37,0,1,0
25,309,309,5,5,0,1,0
28,311,311,32,32,0,1,0
18,314,314,23,23,0,1,0
20,317,317,43,1,42,3,2
17,326,326,10,10,0,1,0
15,330,330,39,39,0,1,0
7,342,342,53,44,9,2,1
36,346,346,1,1,0,1,0
33,383,383,10,1,9,4,3
11,384,384,7,3,4,2,1
42,390,390,45,41,4,2,1
34,394,394,44,44,0,1,0
3,440,440,1,1,0,1,0
6,443,443,7,4,3,2,1
4,450,450,1,1,0,1,0
39,466,466,92,5,87,4,3
5,478,478,38,28,10,3,2
22,478,478,94,47,47,3,2
38,486,486,29,1,28,3,2
27,487,487,11,11,0,1,0
8,489,489,12,6,6,2,1
13,494,494,35,35,0,1,0
12,495,495,7,7,0,1,0

7,106,106,2,2,0,1,0
13,112,112,14,14,0,1,0
6,130,130,28,28,0,1,0
14,145,145,23,23,0,1,0
25,163,163,8,4,4,2,1
24,165,165,26,26,0,1,0
8,201,201,1,1,0,1,0
1,213,213,25,13,12,4,3
5,223,223,1,1,0,1,0
19,235,235,2,2,0,1,0
22,238,238,41,17,24,3,2
18,241,241,23,9,14,3,2
17,242,242,12,12,0,1,0
2,242,242,39,6,33,4,3
0,257,257,32,2,30,4,3
33,272,272,6,6,0,1,0
27,277,277,59,59,0,1,0
30,281,281,31,31,0,1,0
31,287,287,101,101,0,1,0
20,315,315,25,25,0,1,0
9,327,327,1,1,0,1,0
11,328,328,3,3,0,1,0
32,334,334,10,2,8,3,2
3,338,338,30,30,0,1,0
29,338,338,3,3,0,1,0
28,389,389,51,51,0,1,0
23,398,398,33,3,30,2,1
10,435,435,53,53,0,1,0
16,455,455,25,25,0,1,0
12,456,456,119,119,0,1,0
21,459,459,10,10,0,1,0
4,460,460,66,40,26,3,2
26,496,496,69,69,0,1,0
15,498,498,44,44,0,1,0

1,100,100,12,4,8,2,1
0,104,104,12,2,10,3,2
15,114,114,13,13,0,1,0
8,142,142,3,3,0,1,0
5,157,157,19,19,0,1,0
16,159,159,5,5,0,1,0
6,206,206,8,8,0,1,0
14,225,225,26,26,0,1,0
2,232,232,21,16,5,2,1
23,248,248,46,19,27,4,3
3,254,254,1,1,0,1,0
22,262,262,111,111,0,1,0
4,279,279,25,3,22,2,1
17,303,303,23,23,0,1,0
25,306,306,6,1,5,2,1
7,311,311,37,9,28,4,3
27,331,331,1,1,0,1,0
19,348,348,35,11,24,4,3
12,386,386,11,4,7,2,1
9,399,399,100,100,0,1,0
24,406,406,22,22,0,1,0
13,417,417,39,13,26,4,3
18,448,448,75,17,58,4,3
26,455,455,79,16,63,4,3
21,458,458,37,1,36,2,1
10,460,460,336,336,0,1,0
20,464,464,15,15,0,1,0
11,468,468,13,2,11,2,1

22,100,100,4,4,0,1,0
5,108,108,7,4,3,2,1
26,152,152,6,6,0,1,0
18,154,154,1,1,0,1,0
20,162,162,59,5,54,4,3
17,185,185,3,3,0,1,0
31,191,191,13,13,0,1,0
13,216,216,5,5,0,1,0
30,231,231,7,7,0,1,0
6,248,248,17,17,0,1,0
2,257,257,35,35,0,1,0
16,263,263,11,3,8,2,1
27,272,272,33,26,7,2,1
7,278,278,44,34,10,3,2
11,283,283,32,10,22,3,2
21,289,289,10,10,0,1,0
29,310,310,27,1,26,3,2
28,342,342,33,11,22,2,1
4,364,364,45,45,0,1,0
3,365,365,1,1,0,1,0
25,379,379,13,13,0,1,0
8,396,396,15,15,0,1,0
1,413,413,80,80,0,1,0
24,430,430,25,11,14,3,2
32,443,443,81,33,48,2,1
19,443,443,71,47,24,2,1
15,443,443,28,28,0,1,0
23,453,453,157,76,81,4,3
9,454,454,88,52,36,2,1
14,455,455,118,118,0,1,0
0,474,474,107,107,0,1,0
10,484,484,6,3,3,2,1
12,492,492,12,4,8,3,2

3,118,118,20,17,3,2,1
32,128,128,4,1,3,2,1
19,132,132,17,10,7,2,1
7,136,136,23,23,0,1,0
12,144,144,9,9,0,1,0
22,149,149,2,2,0,1,0
30,162,162,4,4,0,1,0
17,165,165,7,7,0,1,0
25,171,171,34,34,0,1,0
14,177,177,2,2,0,1,0
1,182,182,27,27,0,1,0
33,197,197,3,3,0,1,0
18,206,206,42,42,0,1,0
24,225,225,64,64,0,1,0
10,225,225,24,9,15,4,3
28,233,233,11,11,0,1,0
27,234,234,5,2,3,2,1
9,280,280,67,67,0,1,0
21,293,293,83,54,29,4,3
6,327,327,11,3,8,2,1
26,331,331,64,64,0,1,0
15,332,332,31,13,18,4,3
13,336,336,1,1,0,1,0
31,340,340,37,27,10,3,2
5,385,385,24,9,15,4,3
8,411,411,5,5,0,1,0
16,417,417,81,69,12,4,3
20,420,420,12,12,0,1,0
23,464,464,16,16,0,1,0
11,479,479,114,114,0,1,0
0,482,482,55,55,0,1,0
2,484,484,3,3,0,1,0
4,485,485,18,2,16,2,1
29,494,494,39,2,37,2,1

22,110,110,49,42,7,2,1
17,153,153,4,4,0,1,0
7,166,166,53,15,38,2,1
18,166,166,28,28,0,1,0
20,183,183,7,7,0,1,0
26,188,188,55,25,30,2,1
31,194,194,2,2,0,1,0
23,198,198,9,1,8,2,1
12,209,209,14,2,12,3,2
0,232,232,7,7,0,1,0
3,246,246,26,8,18,2,1
16,284,284,3,3,0,1,0
24,294,294,36,2,34,4,3
28,300,300,2,2,0,1,0
32,330,330,15,7,8,3,2
6,332,332,32,32,0,1,0
11,333,333,12,12,0,1,0
19,340,340,9,9,0,1,0
21,346,346,1,1,0,1,0
5,347,347,92,92,0,1,0
25,364,364,59,17,42,4,3
10,371,371,3,3,0,1,0
8,373,373,24,24,0,1,0
15,374,374,1,1,0,1,0
4,388,388,18,18,0,1,0
2,401,401,91,67,24,2,1
29,415,415,32,32,0,1,0
13,418,418,16,16,0,1,0
34,437,437,1,1,0,1,0
14,441,441,22,14,8,2,1
30,449,449,141,141,0,1,0
1,476,476,18,18,0,1,0
27,479,479,4,4,0,1,0
33,488,488,30,30,0,1,0
35,496,496,33,33,0,1,0
9,496,496,51,42,9,2,1

27,105,105,2,2,0,1,0
3,112,112,1,1,0,1,0
15,120,120,1,1,0,1,0
7,164,164,1,1,0,1,0
28,171,171,7,2,5,2,1
12,176,176,3,3,0,1,0
13,182,182,31,3,28,3,2
6,186,186,8,5,3,2,1
2,190,190,4,4,0,1,0
24,193,193,1,1,0,1,0
35,202,202,14,14,0,1,0
1,229,229,9,5,4,2,1
20,241,241,29,29,0,1,0
39,252,252,12,4,8,2,1
19,259,259,60,60,0,1,0
17,268,268,22,22,0,1,0
38,268,268,72,72,0,1,0
9,268,268,12,2,10,3,2
8,280,280,19,19,0,1,0
21,280,280,15,2,13,2,1
32,281,281,54,54,0,1,0
14,301,301,1,1,0,1,0
18,351,351,2,2,0,1,0
37,353,353,52,52,0,1,0
5,354,354,55,1,54,4,3
10,365,365,47,28,19,2,1
30,370,370,64,15,49,2,1
26,373,373,1,1,0,1,0
22,386,386,19,1,18,4,3
31,389,389,16,4,12,4,3
4,401,401,36,2,34,3,2
29,411,411,1,1,0,1,0
25,428,428,24,24,0,1,0
11,440,440,17,14,3,2,1
34,441,441,64,64,0,1,0
40,452,452,24,24,0,1,0
33,467,467,155,26,129,4,3
0,467,467,95,49,46,3,2
23,469,469,10,1,9,4,3
16,478,478,44,44,0,1,0
36,492,492,68,68,0,1,0

1,105,105,6,6,0,1,0
6,164,164,1,1,0,1,0
8,168,168,5,5,0,1,0
28,178,178,14,1,13,2,1
19,193,193,11,11,0,1,0
18,203,203,3,3,0,1,0
0,220,220,19,15,4,2,1
10,235,235,17,17,0,1,0
7,242,242,8,8,0,1,0
15,251,251,23,23,0,1,0
26,253,253,5,2,3,2,1
4,258,258,103,103,0,1,0
3,270,270,2,2,0,1,0
33,273,273,69,27,42,4,3
34,288,288,33,16,17,2,1
29,300,300,97,97,0,1,0
12,301,301,13,13,0,1,0
20,337,337,1,1,0,1,0
36,340,340,2,2,0,1,0
24,349,349,47,47,0,1,0
32,367,367,14,14,0,1,0
16,373,373,37,20,17,2,1
9,393,393,90,7,83,4,3
13,397,397,4,4,0,1,0
22,398,398,36,36,0,1,0
31,408,408,45,30,15,4,3
23,411,411,46,46,0,1,0
35,415,415,10,10,0,1,0
21,432,432,18,15,3,2,1
2,437,437,78,48,30,3,2
5,448,448,35,35,0,1,0
27,451,451,13,13,0,1,0
14,452,452,7,7,0,1,0
11,454,454,85,85,0,1,0
30,472,472,42,18,24,3,2
25,480,480,124,124,0,1,0
17,492,492,4,4,0,1,0

16,110,110,5,5,0,1,0
2,122,122,3,3,0,1,0
6,136,136,20,20,0,1,0
18,177,177,9,9,0,1,0
17,198,198,4,4,0,1,0
15,208,208,1,1,0,1,0
1,225,225,91,16,75,4,3
27,230,230,13,13,0,1,0
22,257,257,4,4,0,1,0
9,296,296,14,5,9,2,1
14,297,297,44,32,12,3,2
7,316,316,38,38,0,1,0
13,321,321,23,23,0,1,0
4,321,321,95,51,44,3,2
20,323,323,7,7,0,1,0
0,328,328,42,42,0,1,0
21,355,355,71,38,33,4,3
23,366,366,102,76,26,2,1
26,368,368,7,7,0,1,0
29,378,378,9,9,0,1,0
30,382,382,178,178,0,1,0
25,384,384,19,19,0,1,0
8,401,401,11,11,0,1,0
10,410,410,18,18,0,1,0
19,416,416,20,20,0,1,0
31,420,420,51,5,46,3,2
28,427,427,59,30,29,3,2
24,438,438,67,34,33,4,3
12,462,462,6,6,0,1,0
3,468,468,6,6,0,1,0
11,469,469,20,15,5,2,1
32,476,476,12,12,0,1,0
5,496,496,85,75,10,3,2

3,106,106,28,28,0,1,0
12,168,168,4,1,3,2,1
26,172,172,6,3,3,2,1
6,192,192,30,30,0,1,0
0,210,210,67,37,30,3,2
18,221,221,34,6,28,2,1
14,222,222,4,4,0,1,0
11,234,234,2,2,0,1,0
28,243,243,21,21,0,1,0
13,249,249,45,45,0,1,0
25,254,254,30,30,0,1,0
9,285,285,2,2,0,1,0
23,298,298,11,1,10,3,2
17,314,314,30,18,12,2,1
1,320,320,1,1,0,1,0
20,329,329,9,9,0,1,0
4,334,334,72,52,20,2,1
2,343,343,23,13,10,2,1
21,353,353,11,11,0,1,0
27,363,363,1,1,0,1,0
19,363,363,49,2,47,2,1
30,375,375,11,4,7,2,1
5,386,386,11,11,0,1,0
32,388,388,3,3,0,1,0
31,400,400,39,39,0,1,0
7,420,420,85,49,36,2,1
10,421,421,21,10,11,2,1
8,438,438,60,52,8,3,2
24,448,448,134,53,81,3,2
15,452,452,9,9,0,1,0
29,462,462,121,121,0,1,0
16,480,480,2,2,0,1,0
22,488,488,150,111,39,2,1

5,115,115,43,29,14,3,2
27,117,117,27,19,8,2,1
25,145,145,1,1,0,1,0
31,158,158,10,10,0,1,0
26,181,181,16,16,0,1,0
22,189,189,8,8,0,1,0
9,194,194,24,24,0,1,0
15,228,228,4,4,0,1,0
18,268,268,22,22,0,1,0
17,276,276,7,3,4,2,1
20,288,288,3,3,0,1,0
4,296,296,59,59,0,1,0
23,303,303,11,2,9,4,3
30,305,305,25,25,0,1,0
1,305,305,13,10,3,2,1
19,312,312,86,86,0,1,0
29,316,316,51,39,12,4,3
24,345,345,75,75,0,1,0
10,346,346,23,23,0,1,0
12,356,356,62,62,0,1,0
16,367,367,102,102,0,1,0
3,369,369,5,2,3,2,1
0,395,395,7,7,0,1,0
14,404,404,29,29,0,1,0
13,411,411,29,29,0,1,0
28,415,415,6,6,0,1,0
8,421,421,10,10,0,1,0
7,428,428,1,1,0,1,0
6,430,430,59,59,0,1,0
32,432,432,34,5,29,2,1
2,456,456,37,37,0,1,0
21,466,466,14,14,0,1,0
11,479,479,137,26,111,4,3

37,107,107,34,17,17,2,1
41,127,127,20,11,9,3,2
23,147,147,4,4,0,1,0
8,158,158,14,4,10,2,1
3,170,170,5,5,0,1,0
32,177,177,11,1,10,3,2
31,179,179,10,10,0,1,0
7,198,198,6,1,5,2,1
17,220,220,18,7,11,2,1
18,220,220,8,8,0,1,0
30,239,239,40,3,37,3,2
10,261,261,7,7,0,1,0
22,267,267,39,39,0,1,0
13,272,272,27,27,0,1,0
4,276,276,103,103,0,1,0
29,279,279,72,72,0,1,0
0,297,297,18,6,12,2,1
26,304,304,44,6,38,3,2
12,309,309,6,3,3,2,1
27,310,310,12,7,5,2,1
25,327,327,41,41,0,1,0
14,328,328,1,1,0,1,0
21,340,340,14,14,0,1,0
24,340,340,6,6,0,1,0
16,361,361,30,30,0,1,0
5,378,378,23,23,0,1,0
38,383,383,6,6,0,1,0
36,384,384,20,20,0,1,0
6,389,389,51,15,36,3,2
19,393,393,8,8,0,1,0
1,395,395,24,9,15,2,1
9,397,397,24,24,0,1,0
39,408,408,25,9,16,2,1
33,424,424,64,64,0,1,0
20,427,427,26,5,21,2,1
28,457,457,42,42,0,1,0
40,467,467,6,6,0,1,0
11,470,470,56,56,0,1,0
2,474,474,9,9,0,1,0
15,476,476,2,2,0,1,0
35,498,498,4,4,0,1,0
34,499,499,5,5,0,1,0

32,104,104,9,9,0,1,0
6,104,104,1,1,0,1,0
33,107,107,17,17,0,1,0
27,107,107,15,15,0,1,0
22,119,119,10,10,0,1,0
13,120,120,2,2,0,1,0
21,126,126,2,2,0,1,0
5,172,172,1,1,0,1,0
14,178,178,3,3,0,1,0
17,182,182,2,2,0,1,0
30,188,188,63,63,0,1,0
31,249,249,4,1,3,2,1
16,259,259,26,18,8,2,1
23,263,263,43,43,0,1,0
29,264,264,18,14,4,2,1
3,277,277,31,2,29,2,1
24,283,283,20,13,7,2,1
26,297,297,48,12,36,4,3
28,308,308,65,65,0,1,0
19,309,309,6,6,0,1,0
7,337,337,29,29,0,1,0
11,341,341,48,7,41,2,1
10,368,368,40,40,0,1,0
4,377,377,24,24,0,1,0
8,384,384,2,2,0,1,0
1,397,397,31,6,25,2,1
25,403,403,34,34,0,1,0
18,414,414,25,25,0,1,0
12,439,439,243,243,0,1,0
2,446,446,52,4,48,4,3
20,453,453,28,28,0,1,0
9,457,457,54,54,0,1,0
0,463,463,33,33,0,1,0
15,493,493,48,22,26,3,2

3,148,148,18,6,12,4,3
6,157,157,13,13,0,1,0
16,172,172,20,2,18,4,3
21,185,185,1,1,0,1,0
12,197,197,13,7,6,3,2
8,200,200,14,10,4,2,1
27,207,207,57,57,0,1,0
7,236,236,7,7,0,1,0
28,268,268,14,3,11,2,1
19,268,268,6,6,0,1,0
14,291,291,31,4,27,4,3
18,299,299,13,13,0,1,0
9,325,325,75,75,0,1,0
4,339,339,38,38,0,1,0
17,351,351,158,41,117,4,3
13,365,365,51,51,0,1,0
20,373,373,53,53,0,1,0
22,391,391,76,76,0,1,0
10,392,392,10,10,0,1,0
15,395,395,9,9,0,1,0
23,397,397,11,3,8,2,1
26,407,407,14,2,12,3,2
0,417,417,69,39,30,2,1
24,421,421,13,1,12,4,3
1,444,444,107,107,0,1,0
2,448,448,20,7,13,2,1
25,457,457,1,1,0,1,0
11,478,478,94,4,90,3,2
5,495,495,189,150,39,2,1

14,107,107,2,2,0,1,0
9,119,119,3,3,0,1,0
0,126,126,32,18,14,2,1
3,136,136,45,45,0,1,0
18,139,139,3,3,0,1,0
25,140,140,4,4,0,1,0
17,142,142,5,5,0,1,0
31,146,146,19,19,0,1,0
5,182,182,3,3,0,1,0
15,223,223,60,21,39,4,3
1,236,236,9,9,0,1,0
12,240,240,39,39,0,1,0
20,245,245,4,1,3,2,1
30,274,274,52,32,20,2,1
21,277,277,8,8,0,1,0
7,285,285,52,9,43,2,1
22,291,291,12,12,0,1,0
11,318,318,19,19,0,1,0
16,356,356,16,7,9,2,1
6,359,359,41,41,0,1,0
33,360,360,25,25,0,1,0
19,379,379,7,2,5,2,1
4,382,382,18,8,10,2,1
8,393,393,8,8,0,1,0
13,401,401,21,21,0,1,0
10,430,430,10,10,0,1,0
26,442,442,62,48,14,2,1
29,451,451,20,13,7,2,1
28,458,458,27,11,16,3,2
32,479,479,65,33,32,3,2
23,493,493,56,8,48,2,1
34,496,496,88,88,0,1,0
2,498,498,4,1,3,2,1
27,500,500,98,40,58,3,2
24,500,500,160,86,74,3,2

27,116,116,4,4,0,1,0
26,118,118,17,12,5,2,1
13,122,122,1,1,0,1,0
41,124,124,7,7,0,1,0
33,135,135,16,1,15,2,1
24,150,150,1,1,0,1,0
11,152,152,19,19,0,1,0
39,158,158,11,11,0,1,0
9,184,184,6,6,0,1,0
7,197,197,1,1,0,1,0
32,209,209,17,17,0,1,0
6,221,221,8,4,4,2,1
14,231,231,10,2,8,3,2
18,264,264,5,5,0,1,0
31,274,274,74,74,0,1,0
3,282,282,1,1,0,1,0
28,303,303,82,82,0,1,0
10,306,306,32,7,25,4,3
21,309,309,24,10,14,2,1
38,318,318,5,5,0,1,0
35,318,318,24,2,22,2,1
37,337,337,17,17,0,1,0
30,337,337,18,18,0,1,0
15,351,351,74,6,68,3,2
20,353,353,16,8,8,3,2
12,356,356,8,8,0,1,0
29,373,373,3,3,0,1,0
19,381,381,62,3,59,3,2
17,383,383,56,2,54,4,3
5,383,383,2,2,0,1,0
2,385,385,20,10,10,3,2
8,388,388,30,17,13,2,1
1,407,407,59,19,40,2,1
25,440,440,13,1,12,3,2
16,455,455,54,54,0,1,0
40,458,458,22,13,9,4,3
34,462,462,141,24,117,4,3
36,478,478,54,54,0,1,0
23,484,484,45,9,36,4,3
0,487,487,49,4,45,2,1
4,492,492,20,20,0,1,0
22,499,499,11,11,0,1,0

0,123,123,18,15,3,2,1
23,172,172,12,12,0,1,0
20,181,181,6,6,0,1,0
26,186,186,6,1,5,2,1
27,188,188,72,32,40,3,2
10,204,204,117,68,49,2,1
30,229,229,6,6,0,1,0
7,252,252,40,40,0,1,0
19,254,254,41,2,39,4,3
22,259,259,11,2,9,4,3
6,290,290,1,1,0,1,0
14,291,291,14,8,6,3,2
12,297,297,18,18,0,1,0
8,299,299,1,1,0,1,0
2,310,310,104,104,0,1,0
29,321,321,94,94,0,1,0
28,325,325,20,20,0,1,0
13,334,334,36,24,12,3,2
3,335,335,20,20,0,1,0
5,363,363,1,1,0,1,0
15,378,378,14,2,12,4,3
21,393,393,5,5,0,1,0
17,402,402,32,32,0,1,0
4,409,409,6,6,0,1,0
31,418,418,48,48,0,1,0
24,447,447,75,64,11,2,1
16,451,451,6,6,0,1,0
25,455,455,81,33,48,2,1
18,466,466,6,6,0,1,0
1,466,466,25,2,23,4,3
9,467,467,50,50,0,1,0
11,481,481,13,13,0,1,0

31,110,110,37,30,7,2,1
2,111,111,11,4,7,2,1
24,116,116,21,3,18,2,1
35,136,136,2,2,0,1,0
11,184,184,6,6,0,1,0
28,218,218,17,17,0,1,0
15,231,231,46,46,0,1,0
17,265,265,76,68,8,2,1
10,270,270,22,2,20,3,2
7,278,278,2,2,0,1,0
23,285,285,39,25,14,3,2
33,290,290,31,22,9,2,1
18,292,292,37,37,0,1,0
29,300,300,90,33,57,4,3
16,309,309,3,3,0,1,0
14,312,312,10,10,0,1,0
27,327,327,30,30,0,1,0
20,328,328,24,8,16,2,1
9,335,335,22,22,0,1,0
34,355,355,24,9,15,4,3
6,366,366,22,22,0,1,0
22,368,368,14,14,0,1,0
4,383,383,11,1,10,3,2
5,389,389,20,20,0,1,0
21,402,402,23,1,22,2,1
30,402,402,31,31,0,1,0
32,405,405,15,3,12,2,1
3,409,409,52,52,0,1,0
1,412,412,46,46,0,1,0
8,436,436,91,41,50,4,3
25,445,445,38,29,9,4,3
12,451,451,1,1,0,1,0
0,472,472,65,65,0,1,0
13,482,482,17,17,0,1,0
19,483,483,7,2,5,2,1
26,493,493,20,7,13,2,1

18,100,100,8,8,0,1,0
16,132,132,11,11,0,1,0
25,164,164,5,5,0,1,0
24,166,166,1,1,0,1,0
26,172,172,21,8,13,2,1
6,179,179,25,3,22,3,2
10,182,182,3,3,0,1,0
23,209,209,35,1,34,2,1
30,237,237,7,1,6,3,2
1,264,264,41,41,0,1,0
8,292,292,7,2,5,2,1
11,293,293,3,3,0,1,0
22,295,295,14,14,0,1,0
15,309,309,21,21,0,1,0
5,310,310,4,4,0,1,0
17,322,322,32,32,0,1,0
4,332,332,1,1,0,1,0
2,346,346,58,58,0,1,0
0,350,350,8,8,0,1,0
19,351,351,2,2,0,1,0
29,358,358,174,30,144,4,3
21,362,362,63,40,23,2,1
3,365,365,63,63,0,1,0
20,372,372,13,13,0,1,0
14,381,381,35,35,0,1,0
9,388,388,99,85,14,2,1
31,403,403,30,12,18,2,1
27,438,438,78,9,69,4,3
13,443,443,104,104,0,1,0
28,468,468,30,21,9,4,3
7,478,478,2,2,0,1,0
12,487,487,190,190,0,1,0

6,110,110,5,5,0,1,0
14,120,120,8,2,6,3,2
11,133,133,3,3,0,1,0
7,136,136,6,6,0,1,0
35,150,150,4,4,0,1,0
4,152,152,2,2,0,1,0
24,161,161,6,6,0,1,0
31,166,166,9,9,0,1,0
27,173,173,25,25,0,1,0
17,174,174,18,4,14,3,2
18,179,179,24,8,16,2,1
26,187,187,6,6,0,1,0
8,195,195,75,53,22,3,2
36,201,201,12,12,0,1,0
1,231,231,7,7,0,1,0
10,242,242,2,2,0,1,0
30,244,244,6,3,3,2,1
20,245,245,42,6,36,2,1
28,247,247,56,23,33,4,3
25,255,255,19,19,0,1,0
32,258,258,38,5,33,4,3
33,267,267,132,35,97,4,3
0,285,285,49,44,5,2,1
23,286,286,12,3,9,4,3
19,307,307,5,5,0,1,0
34,316,316,12,12,0,1,0
12,327,327,24,24,0,1,0
21,340,340,4,4,0,1,0
16,373,373,25,9,16,3,2
5,382,382,10,7,3,2,1
9,384,384,57,39,18,3,2
13,448,448,29,15,14,2,1
3,462,462,98,76,22,3,2
15,482,482,22,22,0,1,0
22,485,485,61,32,29,4,3
2,488,488,12,12,0,1,0
29,500,500,9,6,3,2,1

31,114,114,55,44,11,2,1
35,116,116,3,3,0,1,0
24,138,138,16,16,0,1,0
19,147,147,33,33,0,1,0
34,150,150,23,11,12,3,2
1,166,166,35,6,29,2,1
30,198,198,8,8,0,1,0
14,213,213,28,28,0,1,0
6,227,227,11,2,9,2,1
9,236,236,37,37,0,1,0
22,238,238,27,23,4,2,1
12,253,253,7,7,0,1,0
16,260,260,4,4,0,1,0
26,269,269,25,25,0,1,0
28,280,280,25,11,14,3,2
15,294,294,34,1,33,2,1
18,302,302,8,3,5,2,1
25,315,315,94,75,19,2,1
7,348,348,63,63,0,1,0
37,358,358,4,4,0,1,0
36,368,368,6,6,0,1,0
10,370,370,33,33,0,1,0
33,370,370,3,3,0,1,0
3,372,372,24,16,8,3,2
27,376,376,10,10,0,1,0
20,395,395,23,5,18,3,2
29,427,427,27,27,0,1,0
2,428,428,1,1,0,1,0
0,430,430,6,6,0,1,0
23,431,431,48,6,42,3,2
5,431,431,8,8,0,1,0
8,436,436,28,28,0,1,0
11,441,441,16,2,14,2,1
21,449,449,1,1,0,1,0
17,450,450,13,9,4,2,1
32,464,464,9,9,0,1,0
4,479,479,22,22,0,1,0
13,480,480,66,42,24,4,3
38,499,499,36,36,0,1,0

13,135,135,22,6,16,3,2
9,139,139,4,1,3,2,1
14,163,163,2,2,0,1,0
22,163,163,20,12,8,3,2
4,172,172,5,5,0,1,0
29,195,195,1,1,0,1,0
5,199,199,9,6,3,2,1
24,204,204,3,3,0,1,0
3,205,205,2,2,0,1,0
23,207,207,4,4,0,1,0
34,211,211,7,1,6,3,2
32,212,212,23,23,0,1,0
38,218,218,5,5,0,1,0
6,227,227,51,51,0,1,0
8,235,235,20,20,0,1,0
1,237,237,2,2,0,1,0
21,260,260,13,10,3,2,1
27,268,268,20,14,6,3,2
20,300,300,1,1,0,1,0
10,300,300,19,1,18,4,3
25,304,304,40,4,36,2,1
37,306,306,105,52,53,3,2
35,315,315,83,83,0,1,0
2,319,319,39,39,0,1,0
19,327,327,5,5,0,1,0
18,327,327,23,23,0,1,0
16,333,333,7,4,3,2,1
33,344,344,39,39,0,1,0
17,347,347,49,49,0,1,0
31,354,354,102,3,99,4,3
30,381,381,19,19,0,1,0
7,417,417,20,8,12,2,1
36,425,425,48,48,0,1,0
15,428,428,50,14,36,3,2
39,433,433,22,13,9,2,1
26,447,447,34,17,17,4,3
11,461,461,4,4,0,1,0
0,464,464,105,64,41,4,3
28,472,472,12,4,8,2,1
12,475,475,42,42,0,1,0

5,104,104,24,15,9,4,3
6,141,141,1,1,0,1,0
17,153,153,4,4,0,1,0
7,162,162,1,1,0,1,0
1,163,163,14,5,9,4,3
12,180,180,68,19,49,2,1
23,194,194,9,9,0,1,0
4,204,204,31,31,0,1,0
0,267,267,19,19,0,1,0
16,272,272,1,1,0,1,0
25,273,273,13,13,0,1,0
8,275,275,114,94,20,3,2
21,296,296,10,10,0,1,0
9,301,301,87,69,18,3,2
28,302,302,115,74,41,2,1
22,306,306,7,4,3,2,1
26,318,318,45,45,0,1,0
2,319,319,24,24,0,1,0
18,323,323,35,35,0,1,0
15,329,329,19,7,12,3,2
24,349,349,35,17,18,4,3
13,353,353,13,13,0,1,0
3,355,355,8,8,0,1,0
27,356,356,4,4,0,1,0
11,395,395,77,77,0,1,0
14,402,402,60,35,25,2,1
19,434,434,11,11,0,1,0
10,443,443,67,67,0,1,0
20,445,445,70,70,0,1,0

30,105,105,4,4,0,1,0
38,110,110,2,2,0,1,0
16,121,121,14,14,0,1,0
28,128,128,2,2,0,1,0
7,135,135,9,9,0,1,0
35,145,145,3,3,0,1,0
3,149,149,3,3,0,1,0
37,157,157,3,3,0,1,0
24,197,197,13,1,12,3,2
0,198,198,39,39,0,1,0
9,211,211,1,1,0,1,0
18,216,216,19,11,8,2,1
32,241,241,15,15,0,1,0
23,260,260,26,26,0,1,0
14,264,264,21,21,0,1,0
8,271,271,15,4,11,2,1
40,272,272,142,82,60,4,3
25,280,280,79,79,0,1,0
12,282,282,2,2,0,1,0
13,282,282,66,16,50,3,2
20,286,286,31,31,0,1,0
29,309,309,16,16,0,1,0
15,315,315,19,5,14,2,1
34,317,317,8,8,0,1,0
31,318,318,30,12,18,2,1
5,318,318,34,1,33,4,3
10,329,329,59,59,0,1,0
17,345,345,8,8,0,1,0
26,350,350,7,1,6,2,1
1,375,375,2,2,0,1,0
27,379,379,11,1,10,3,2
36,384,384,119,21,98,3,2
39,396,396,48,5,43,2,1
33,409,409,19,19,0,1,0
22,417,417,7,7,0,1,0
4,419,419,3,3,0,1,0
19,443,443,6,6,0,1,0
21,453,453,66,66,0,1,0
11,456,456,26,26,0,1,0
6,472,472,1,1,0,1,0
2,486,486,4,1,3,2,1

1,105,105,17,7,10,3,2
19,120,120,53,53,0,1,0
10,126,126,2,2,0,1,0
14,130,130,6,6,0,1,0
0,132,132,6,3,3,2,1
20,165,165,2,2,0,1,0
7,197,197,34,22,12,3,2
17,200,200,1,1,0,1,0
24,234,234,12,12,0,1,0
13,246,246,13,1,12,3,2
4,268,268,55,27,28,4,3
5,269,269,25,19,6,2,1
9,315,315,101,12,89,4,3
2,329,329,72,30,42,2,1
26,346,346,86,82,4,2,1
18,357,357,42,1,41,4,3
12,421,421,4,1,3,2,1
8,427,427,147,62,85,3,2
16,433,433,5,5,0,1,0
6,444,444,10,10,0,1,0
21,446,446,14,2,12,2,1
15,448,448,31,26,5,2,1
3,452,452,53,53,0,1,0
22,467,467,36,36,0,1,0
23,467,467,21,21,0,1,0
25,470,470,17,17,0,1,0
11,479,479,220,70,150,4,3

24,121,121,11,11,0,1,0
21,121,121,9,9,0,1,0
6,129,129,13,3,10,3,2
22,140,140,40,1,39,4,3
2,148,148,5,5,0,1,0
35,162,162,16,16,0,1,0
25,170,170,38,7,31,3,2
7,172,172,37,12,25,2,1
9,176,176,3,3,0,1,0
10,183,183,1,1,0,1,0
26,200,200,9,1,8,2,1
29,205,205,25,22,3,2,1
31,216,216,26,13,13,2,1
33,218,218,6,6,0,1,0
20,219,219,12,6,6,3,2
23,243,243,29,6,23,2,1
8,251,251,64,36,28,3,2
34,252,252,17,17,0,1,0
28,262,262,29,17,12,4,3
36,268,268,16,16,0,1,0
32,269,269,14,14,0,1,0
5,284,284,8,8,0,1,0
30,307,307,47,20,27,4,3
18,308,308,29,5,24,3,2
14,356,356,36,36,0,1,0
12,386,386,46,2,44,2,1
4,407,407,23,3,20,2,1
13,412,412,42,35,7,2,1
15,415,415,36,2,34,3,2
19,419,419,29,29,0,1,0
11,419,419,35,35,0,1,0
16,433,433,82,33,49,3,2
0,434,434,9,3,6,3,2
3,448,448,35,11,24,4,3
1,451,451,8,1,7,2,1
27,477,477,19,19,0,1,0
17,493,493,13,10,3,2,1

20,107,107,8,2,6,3,2
34,121,121,8,5,3,2,1
16,123,123,1,1,0,1,0
30,131,131,7,7,0,1,0
24,149,149,8,8,0,1,0
25,179,179,21,13,8,3,2
19,184,184,17,17,0,1,0
11,191,191,14,14,0,1,0
28,197,197,11,6,5,2,1
27,229,229,1,1,0,1,0
4,231,231,23,23,0,1,0
29,232,232,37,25,12,4,3
12,238,238,21,15,6,2,1
18,245,245,38,38,0,1,0
6,245,245,20,20,0,1,0
14,252,252,39,4,35,2,1
13,303,303,1,1,0,1,0
9,304,304,6,6,0,1,0
22,313,313,20,4,16,2,1
8,315,315,1,1,0,1,0
0,320,320,60,54,6,2,1
2,343,343,21,6,15,4,3
7,346,346,30,30,0,1,0
15,400,400,56,56,0,1,0
26,400,400,156,70,86,3,2
31,403,403,35,35,0,1,0
1,407,407,86,86,0,1,0
35,421,421,8,5,3,2,1
32,431,431,113,5,108,4,3
21,438,438,6,6,0,1,0
33,454,454,72,54,18,4,3
3,455,455,14,14,0,1,0
23,459,459,26,2,24,4,3
5,465,465,107,102,5,2,1
17,481,481,24,24,0,1,0
10,482,482,9,9,0,1,0

16,101,101,11,11,0,1,0
17,106,106,9,9,0,1,0
10,108,108,4,4,0,1,0
31,111,111,14,2,12,3,2
22,117,117,24,9,15,2,1
11,140,140,19,19,0,1,0
1,144,144,10,10,0,1,0
24,156,156,8,8,0,1,0
29,170,170,8,8,0,1,0
30,171,171,2,2,0,1,0
23,173,173,4,4,0,1,0
0,181,181,20,15,5,2,1
4,203,203,1,1,0,1,0
20,207,207,10,10,0,1,0
14,214,214,23,13,10,2,1
6,217,217,25,25,0,1,0
3,220,220,8,8,0,1,0
25,246,246,31,31,0,1,0
32,248,248,11,11,0,1,0
34,255,255,78,30,48,2,1
13,259,259,4,4,0,1,0
21,267,267,3,3,0,1,0
12,308,308,69,30,39,4,3
15,327,327,6,6,0,1,0
37,329,329,4,4,0,1,0
33,335,335,43,43,0,1,0
19,341,341,40,11,29,2,1
28,356,356,96,96,0,1,0
35,357,357,31,31,0,1,0
36,363,363,46,2,44,2,1
2,381,381,27,27,0,1,0
7,382,382,20,14,6,2,1
8,403,403,33,7,26,2,1
27,436,436,50,10,40,2,1
5,461,461,56,28,28,2,1
26,469,469,21,21,0,1,0
9,476,476,3,3,0,1,0
18,495,495,68,35,33,2,1

2,132,132,2,2,0,1,0
26,140,140,24,19,5,2,1
5,160,160,9,9,0,1,0
30,162,162,36,9,27,2,1
14,209,209,5,5,0,1,0
33,221,221,1,1,0,1,0
22,222,222,13,13,0,1,0
18,225,225,52,27,25,2,1
15,231,231,33,2,31,2,1
4,256,256,5,1,4,2,1
0,262,262,20,8,12,4,3
35,267,267,46,6,40,2,1
17,287,287,5,5,0,1,0
10,287,287,23,12,11,2,1
25,287,287,47,1,46,3,2
29,290,290,5,5,0,1,0
6,317,317,32,29,3,2,1
20,323,323,14,2,12,3,2
13,358,358,4,1,3,2,1
19,364,364,166,128,38,3,2
24,368,368,21,11,10,3,2
36,375,375,25,5,20,3,2
7,388,388,13,4,9,2,1
16,388,388,1,1,0,1,0
11,388,388,1,1,0,1,0
28,413,413,12,6,6,2,1
21,416,416,40,40,0,1,0
1,426,426,34,18,16,2,1
9,434,434,39,15,24,3,2
8,454,454,44,44,0,1,0
12,460,460,28,28,0,1,0
3,466,466,48,21,27,4,3
23,467,467,6,6,0,1,0
27,467,467,49,49,0,1,0
32,478,478,80,80,0,1,0
31,484,484,34,34,0,1,0
34,491,491,137,137,0,1,0

15,109,109,4,4,0,1,0
28,126,126,10,10,0,1,0
2,140,140,6,6,0,1,0
17,142,142,1,1,0,1,0
12,142,142,8,8,0,1,0
25,162,162,2,2,0,1,0
11,193,193,13,13,0,1,0
23,203,203,1,1,0,1,0
6,215,215,1,1,0,1,0
13,226,226,8,8,0,1,0
32,242,242,86,46,40,4,3
30,270,270,16,16,0,1,0
20,277,277,34,22,12,2,1
8,285,285,19,19,0,1,0
19,296,296,7,3,4,2,1
16,301,301,35,35,0,1,0
3,308,308,7,1,6,3,2
4,324,324,17,11,6,2,1
27,348,348,7,7,0,1,0
26,351,351,68,24,44,3,2
10,390,390,15,2,13,2,1
7,425,425,23,23,0,1,0
33,438,438,6,2,4,2,1
18,438,438,169,169,0,1,0
0,439,439,7,2,5,2,1
29,443,443,84,84,0,1,0
5,455,455,63,54,9,4,3
31,458,458,55,38,17,2,1
1,473,473,142,38,104,4,3
24,474,474,7,2,5,2,1
21,481,481,44,44,0,1,0
14,484,484,191,133,58,3,2
9,486,486,125,86,39,4,3
22,498,498,18,18,0,1,0

6,102,102,33,13,20,2,1
16,158,158,16,8,8,3,2
0,192,192,12,9,3,2,1
15,199,199,11,11,0,1,0
23,201,201,32,2,30,3,2
12,204,204,1,1,0,1,0
3,228,228,62,62,0,1,0
28,236,236,26,26,0,1,0
32,238,238,26,15,11,2,1
31,240,240,17,17,0,1,0
24,248,248,30,2,28,2,1
21,248,248,13,1,12,3,2
10,299,299,3,3,0,1,0
11,309,309,9,5,4,2,1
5,310,310,3,3,0,1,0
17,313,313,32,26,6,3,2
14,319,319,1,1,0,1,0
9,349,349,1,1,0,1,0
20,377,377,9,9,0,1,0
8,399,399,45,21,24,3,2
22,423,423,35,3,32,3,2
18,428,428,1,1,0,1,0
2,428,428,82,82,0,1,0
26,450,450,39,39,0,1,0
25,451,451,61,45,16,2,1
27,458,458,55,55,0,1,0
4,464,464,28,28,0,1,0
29,467,467,58,11,47,2,1
1,471,471,29,29,0,1,0
13,480,480,181,160,21,2,1
19,489,489,89,73,16,3,2
30,489,489,71,35,36,2,1
7,491,491,63,29,34,2,1

19,107,107,14,14,0,1,0
28,112,112,6,6,0,1,0
22,117,117,3,3,0,1,0
9,119,119,1,1,0,1,0
1,123,123,1,1,0,1,0
29,143,143,29,1,28,2,1
35,153,153,26,26,0,1,0
3,168,168,19,13,6,3,2
17,168,168,13,13,0,1,0
4,173,173,14,10,4,2,1
36,174,174,27,5,22,2,1
21,188,188,4,4,0,1,0
6,195,195,11,11,0,1,0
31,198,198,15,11,4,2,1
8,199,199,21,15,6,2,1
13,206,206,5,5,0,1,0
26,209,209,31,31,0,1,0
18,210,210,43,43,0,1,0
2,244,244,1,1,0,1,0
5,276,276,11,1,10,2,1
10,281,281,25,1,24,4,3
38,286,286,55,55,0,1,0
27,293,293,35,35,0,1,0
0,304,304,52,34,18,2,1
16,306,306,4,4,0,1,0
33,343,343,14,2,12,2,1
20,345,345,31,31,0,1,0
37,353,353,24,9,15,2,1
32,360,360,82,20,62,4,3
24,361,361,2,2,0,1,0
7,368,368,51,31,20,3,2
30,381,381,7,7,0,1,0
15,426,426,29,29,0,1,0
23,430,430,11,11,0,1,0
25,445,445,40,40,0,1,0
12,460,460,18,18,0,1,0
39,477,477,15,15,0,1,0
14,480,480,32,32,0,1,0
34,492,492,55,55,0,1,0
11,500,500,64,32,32,2,1

6,101,101,7,7,0,1,0
34,102,102,3,3,0,1,0
16,115,115,13,13,0,1,0
15,119,119,20,20,0,1,0
30,133,133,26,11,15,4,3
5,147,147,3,3,0,1,0
25,159,159,36,30,6,3,2
22,164,164,29,2,27,2,1
2,178,178,26,3,23,4,3
10,183,183,26,26,0,1,0
35,220,220,13,13,0,1,0
21,223,223,39,39,0,1,0
7,232,232,21,8,13,2,1
12,250,250,32,6,26,2,1
1,254,254,32,4,28,4,3
29,269,269,11,2,9,4,3
23,289,289,4,1,3,2,1
9,298,298,14,14,0,1,0
28,301,301,6,6,0,1,0
11,308,308,8,1,7,2,1
8,322,322,37,12,25,2,1
19,328,328,34,34,0,1,0
14,337,337,10,10,0,1,0
17,346,346,17,9,8,2,1
18,379,379,40,16,24,3,2
27,383,383,49,23,26,3,2
20,385,385,17,17,0,1,0
26,388,388,4,4,0,1,0
3,402,402,1,1,0,1,0
0,428,428,66,22,44,3,2
36,455,455,14,1,13,4,3
32,476,476,40,1,39,4,3
33,478,478,47,31,16,2,1
13,480,480,14,14,0,1,0
31,485,485,5,5,0,1,0
4,485,485,18,18,0,1,0
24,497,497,196,174,22,2,1

4,108,108,12,12,0,1,0
11,116,116,8,8,0,1,0
24,120,120,3,3,0,1,0
8,126,126,6,6,0,1,0
29,131,131,44,44,0,1,0
34,154,154,1,1,0,1,0
10,162,162,16,7,9,2,1
32,164,164,2,2,0,1,0
0,172,172,41,41,0,1,0
19,183,183,29,13,16,2,1
9,186,186,18,8,10,3,2
35,189,189,27,27,0,1,0
26,215,215,4,4,0,1,0
36,234,234,8,8,0,1,0
28,235,235,11,5,6,2,1
14,239,239,14,14,0,1,0
25,254,254,12,2,10,3,2
13,260,260,32,9,23,3,2
27,266,266,38,27,11,2,1
12,268,268,17,5,12,2,1
33,290,290,16,16,0,1,0
1,290,290,1,1,0,1,0
16,297,297,53,45,8,2,1
31,301,301,59,59,0,1,0
23,325,325,48,3,45,2,1
6,347,347,6,2,4,2,1
30,349,349,9,9,0,1,0
20,373,373,46,16,30,2,1
2,376,376,58,9,49,2,1
5,377,377,13,5,8,3,2
18,391,391,6,6,0,1,0
3,400,400,72,72,0,1,0
17,432,432,1,1,0,1,0
15,452,452,18,18,0,1,0
21,483,483,121,95,26,2,1
7,487,487,5,1,4,2,1
22,497,497,64,48,16,2,1

1,110,110,24,24,0,1,0
24,121,121,1,1,0,1,0
8,127,127,4,1,3,2,1
32,138,138,10,10,0,1,0
16,158,158,4,4,0,1,0
13,162,162,32,12,20,3,2
21,162,162,7,3,4,2,1
0,177,177,15,15,0,1,0
15,177,177,48,30,18,4,3
29,181,181,11,11,0,1,0
7,193,193,4,4,0,1,0
33,202,202,11,3,8,2,1
30,217,217,19,6,13,3,2
27,221,221,83,65,18,4,3
19,232,232,47,47,0,1,0
20,239,239,27,7,20,3,2
22,241,241,33,33,0,1,0
11,317,317,10,1,9,2,1
26,325,325,13,13,0,1,0
31,335,335,15,15,0,1,0
17,336,336,43,43,0,1,0
12,343,343,27,27,0,1,0
28,347,347,72,40,32,2,1
4,372,372,10,2,8,3,2
14,386,386,39,39,0,1,0
23,408,408,14,2,12,2,1
3,414,414,34,5,29,3,2
25,416,416,52,5,47,4,3
5,441,441,11,11,0,1,0
18,451,451,2,2,0,1,0
10,451,451,91,32,59,3,2
2,456,456,4,4,0,1,0
6,471,471,38,38,0,1,0
9,474,474,102,91,11,2,1

12,104,104,9,3,6,3,2
35,106,106,13,13,0,1,0
22,118,118,7,7,0,1,0
15,144,144,5,5,0,1,0
8,158,158,29,29,0,1,0
26,204,204,25,13,12,3,2
17,208,208,10,10,0,1,0
18,217,217,26,26,0,1,0
1,220,220,31,31,0,1,0
30,220,220,23,23,0,1,0
19,229,229,6,6,0,1,0
36,230,230,49,26,23,4,3
5,244,244,86,86,0,1,0
4,249,249,2,2,0,1,0
23,251,251,7,7,0,1,0
33,258,258,16,6,10,2,1
6,258,258,10,5,5,2,1
13,297,297,29,11,18,4,3
31,327,327,68,53,15,4,3
34,329,329,72,72,0,1,0
28,356,356,23,14,9,4,3
29,360,360,3,3,0,1,0
2,361,361,7,7,0,1,0
21,363,363,50,50,0,1,0
16,371,371,36,9,27,2,1
14,398,398,6,2,4,2,1
25,412,412,21,9,12,4,3
20,416,416,10,10,0,1,0
27,421,421,25,25,0,1,0
32,425,425,35,35,0,1,0
7,427,427,9,3,6,3,2
24,442,442,18,18,0,1,0
10,442,442,84,52,32,3,2
37,452,452,72,18,54,4,3
11,453,453,2,2,0,1,0
0,456,456,52,52,0,1,0
3,494,494,33,33,0,1,0
9,496,496,6,6,0,1,0

17,113,113,21,18,3,2,1
7,118,118,6,6,0,1,0
12,120,120,4,4,0,1,0
27,121,121,33,21,12,3,2
24,131,131,10,10,0,1,0
18,139,139,5,5,0,1,0
4,169,169,10,10,0,1,0
16,180,180,10,10,0,1,0
0,198,198,14,14,0,1,0
9,212,212,51,51,0,1,0
5,253,253,39,39,0,1,0
3,259,259,11,5,6,3,2
22,262,262,13,13,0,1,0
6,266,266,12,6,6,3,2
26,322,322,44,44,0,1,0
28,329,329,6,6,0,1,0
13,335,335,32,32,0,1,0
10,343,343,62,47,15,4,3
11,362,362,84,84,0,1,0
8,374,374,13,4,9,4,3
15,395,395,31,31,0,1,0
23,401,401,82,8,74,3,2
25,403,403,8,8,0,1,0
29,409,409,7,2,5,2,1
21,412,412,19,15,4,2,1
2,418,418,51,51,0,1,0
19,454,454,131,77,54,3,2
20,461,461,31,19,12,4,3
14,462,462,34,29,5,2,1
1,475,475,207,119,88,4,3

21,104,104,2,2,0,1,0
30,139,139,5,2,3,2,1
4,139,139,5,5,0,1,0
14,152,152,6,2,4,2,1
1,155,155,58,17,41,2,1
6,161,161,7,7,0,1,0
3,190,190,2,2,0,1,0
29,192,192,3,3,0,1,0
13,203,203,13,13,0,1,0
34,203,203,18,12,6,3,2
25,214,214,6,1,5,2,1
27,223,223,30,30,0,1,0
33,228,228,31,6,25,3,2
28,247,247,17,13,4,2,1
22,281,281,25,4,21,2,1
32,284,284,54,54,0,1,0
23,284,284,103,103,0,1,0
12,286,286,17,10,7,2,1
35,295,295,6,6,0,1,0
11,299,299,7,7,0,1,0
2,307,307,4,4,0,1,0
18,317,317,1,1,0,1,0
20,329,329,64,1,63,3,2
9,330,330,4,4,0,1,0
7,344,344,28,28,0,1,0
0,349,349,6,6,0,1,0
19,363,363,17,17,0,1,0
15,363,363,2,2,0,1,0
26,374,374,16,16,0,1,0
31,394,394,68,68,0,1,0
8,430,430,47,47,0,1,0
16,452,452,44,44,0,1,0
10,468,468,113,53,60,4,3
24,491,491,44,44,0,1,0
17,498,498,52,34,18,2,1
5,500,500,183,122,61,4,3

28,106,106,4,4,0,1,0
33,115,115,35,35,0,1,0
12,122,122,4,1,3,2,1
4,124,124,1,1,0,1,0
24,125,125,3,3,0,1,0
27,154,154,54,48,6,2,1
21,158,158,8,8,0,1,0
25,160,160,52,52,0,1,0
31,189,189,11,11,0,1,0
16,196,196,23,8,15,2,1
34,196,196,53,53,0,1,0
29,202,202,11,1,10,2,1
5,208,208,3,3,0,1,0
38,235,235,1,1,0,1,0
13,240,240,5,5,0,1,0
35,243,243,29,29,0,1,0
6,244,244,79,79,0,1,0
0,246,246,1,1,0,1,0
23,248,248,1,1,0,1,0
32,255,255,1,1,0,1,0
7,268,268,13,3,10,3,2
10,272,272,5,1,4,2,1
37,278,278,22,22,0,1,0
26,291,291,4,4,0,1,0
20,326,326,31,31,0,1,0
18,339,339,5,5,0,1,0
17,354,354,3,3,0,1,0
1,364,364,15,6,9,4,3
30,374,374,15,15,0,1,0
2,386,386,21,7,14,2,1
8,390,390,48,48,0,1,0
14,428,428,66,66,0,1,0
3,432,432,2,2,0,1,0
22,449,449,5,5,0,1,0
19,462,462,46,46,0,1,0
9,463,463,13,1,12,4,3
11,474,474,62,62,0,1,0
36,476,476,15,15,0,1,0
15,492,492,154,103,51,4,3

9,115,115,1,1,0,1,0
8,129,129,3,3,0,1,0
17,142,142,15,8,7,2,1
14,143,143,36,36,0,1,0
13,167,167,11,11,0,1,0
21,171,171,5,5,0,1,0
31,180,180,8,8,0,1,0
5,187,187,21,17,4,2,1
19,196,196,11,11,0,1,0
26,200,200,41,41,0,1,0
35,216,216,13,13,0,1,0
12,233,233,35,35,0,1,0
28,256,256,33,8,25,2,1
4,262,262,5,5,0,1,0
18,264,264,6,6,0,1,0
10,268,268,28,14,14,3,2
25,278,278,46,2,44,2,1
23,300,300,11,11,0,1,0
6,306,306,6,3,3,2,1
0,307,307,1,1,0,1,0
7,318,318,10,10,0,1,0
30,319,319,64,64,0,1,0
32,336,336,44,44,0,1,0
27,360,360,3,3,0,1,0
16,368,368,19,10,9,2,1
3,403,403,49,49,0,1,0
34,415,415,62,32,30,4,3
1,419,419,110,85,25,2,1
11,427,427,13,13,0,1,0
15,448,448,139,139,0,1,0
22,453,453,181,37,144,4,3
24,458,458,4,4,0,1,0
2,464,464,4,4,0,1,0
29,465,465,25,14,11,4,3
20,479,479,15,2,13,2,1
33,493,493,12,12,0,1,0

22,123,123,15,15,0,1,0
10,131,131,17,17,0,1,0
21,131,131,15,1,14,2,1
20,133,133,7,7,0,1,0
14,161,161,25,25,0,1,0
27,162,162,30,8,22,2,1
12,185,185,8,8,0,1,0
26,197,197,9,9,0,1,0
6,203,203,58,25,33,4,3
13,216,216,23,23,0,1,0
23,217,217,37,10,27,4,3
1,222,222,1,1,0,1,0
3,260,260,89,89,0,1,0
0,277,277,9,6,3,2,1
11,303,303,52,14,38,2,1
24,310,310,3,3,0,1,0
18,324,324,41,41,0,1,0
19,346,346,76,33,43,4,3
17,369,369,1,1,0,1,0
15,375,375,36,8,28,2,1
9,393,393,8,8,0,1,0
5,405,405,33,33,0,1,0
4,419,419,30,11,19,2,1
7,430,430,56,17,39,4,3
8,441,441,118,118,0,1,0
16,467,467,16,4,12,4,3
2,469,469,159,83,76,4,3
25,492,492,42,17,25,2,1

27,108,108,5,5,0,1,0
6,110,110,5,1,4,2,1
34,115,115,1,1,0,1,0
21,119,119,30,30,0,1,0
15,128,128,2,2,0,1,0
30,140,140,27,19,8,3,2
0,152,152,45,41,4,2,1
31,160,160,49,49,0,1,0
20,163,163,4,4,0,1,0
16,183,183,1,1,0,1,0
13,195,195,3,3,0,1,0
12,218,218,19,19,0,1,0
23,221,221,56,56,0,1,0
29,245,245,42,42,0,1,0
1,257,257,17,9,8,3,2
8,265,265,74,64,10,3,2
10,296,296,56,29,27,4,3
18,308,308,52,16,36,2,1
9,313,313,6,3,3,2,1
24,334,334,3,3,0,1,0
4,351,351,27,2,25,2,1
25,351,351,3,3,0,1,0
11,355,355,66,66,0,1,0
26,398,398,18,15,3,2,1
28,403,403,9,9,0,1,0
17,410,410,7,7,0,1,0
32,426,426,13,4,9,4,3
19,432,432,33,3,30,2,1
2,441,441,39,39,0,1,0
14,444,444,33,8,25,2,1
33,454,454,25,7,18,2,1
5,455,455,19,3,16,3,2
3,464,464,6,2,4,2,1
7,475,475,88,31,57,4,3
22,493,493,31,31,0,1,0

2,102,102,5,5,0,1,0
17,107,107,5,1,4,2,1
5,120,120,4,1,3,2,1
23,182,182,7,7,0,1,0
19,191,191,12,12,0,1,0
9,203,203,60,60,0,1,0
11,210,210,47,11,36,3,2
16,223,223,8,5,3,2,1
18,225,225,23,3,20,2,1
7,228,228,30,1,29,2,1
8,233,233,22,22,0,1,0
6,252,252,198,178,20,2,1
12,254,254,17,10,7,2,1
20,255,255,49,27,22,2,1
0,287,287,23,23,0,1,0
24,287,287,31,31,0,1,0
14,319,319,13,13,0,1,0
22,378,378,16,16,0,1,0
21,387,387,45,45,0,1,0
10,410,410,63,63,0,1,0
15,438,438,13,13,0,1,0
4,439,439,30,6,24,3,2
25,440,440,83,10,73,4,3
1,448,448,35,15,20,3,2
3,462,462,39,39,0,1,0
26,464,464,52,14,38,4,3
13,500,500,82,18,64,3,2

33,106,106,37,37,0,1,0
1,122,122,6,6,0,1,0
12,131,131,1,1,0,1,0
38,140,140,6,6,0,1,0
27,141,141,17,17,0,1,0
16,147,147,46,12,34,3,2
14,147,147,7,7,0,1,0
22,150,150,15,6,9,4,3
36,151,151,50,34,16,2,1
32,162,162,18,18,0,1,0
3,176,176,2,2,0,1,0
25,177,177,2,2,0,1,0
35,195,195,12,3,9,4,3
31,205,205,38,38,0,1,0
4,207,207,13,13,0,1,0
13,227,227,1,1,0,1,0
28,231,231,10,4,6,2,1
5,251,251,5,5,0,1,0
9,251,251,48,16,32,4,3
24,261,261,6,6,0,1,0
17,284,284,57,18,39,4,3
30,286,286,42,3,39,4,3
34,300,300,21,21,0,1,0
29,301,301,11,2,9,4,3
26,304,304,17,1,16,2,1
15,317,317,15,5,10,2,1
2,323,323,4,4,0,1,0
37,354,354,48,48,0,1,0
7,355,355,41,1,40,3,2
20,366,366,5,5,0,1,0
39,379,379,1,1,0,1,0
19,391,391,3,3,0,1,0
0,418,418,13,13,0,1,0
8,426,426,12,12,0,1,0
11,431,431,10,10,0,1,0
18,433,433,6,3,3,2,1
23,442,442,118,46,72,4,3
40,448,448,9,9,0,1,0
6,452,452,30,30,0,1,0
21,457,457,23,23,0,1,0
10,485,485,8,1,7,2,1

17,131,131,15,15,0,1,0
15,139,139,8,8,0,1,0
19,148,148,31,31,0,1,0
16,154,154,12,6,6,3,2
25,178,178,46,31,15,2,1
6,179,179,22,22,0,1,0
13,205,205,4,4,0,1,0
8,245,245,41,41,0,1,0
10,249,249,5,5,0,1,0
18,261,261,11,1,10,4,3
21,280,280,65,65,0,1,0
11,281,281,4,4,0,1,0
9,281,281,44,44,0,1,0
7,287,287,13,1,12,3,2
32,287,287,21,21,0,1,0
23,287,287,30,30,0,1,0
31,301,301,18,4,14,2,1
0,322,322,29,29,0,1,0
4,336,336,5,5,0,1,0
29,359,359,39,26,13,2,1
27,360,360,43,43,0,1,0
33,379,379,4,1,3,2,1
14,412,412,45,45,0,1,0
30,415,415,5,5,0,1,0
5,425,425,38,38,0,1,0
2,442,442,174,174,0,1,0
26,449,449,49,49,0,1,0
34,457,457,6,3,3,2,1
28,463,463,31,19,12,3,2
22,470,470,5,5,0,1,0
3,478,478,89,48,41,2,1
20,485,485,120,96,24,3,2
24,491,491,25,1,24,3,2
12,493,493,10,10,0,1,0
1,496,496,2,2,0,1,0

1,119,119,18,9,9,4,3
22,135,135,7,3,4,2,1
27,165,165,5,2,3,2,1
3,181,181,40,40,0,1,0
16,189,189,23,23,0,1,0
9,209,209,1,1,0,1,0
17,217,217,31,31,0,1,0
28,229,229,10,7,3,2,1
0,235,235,1,1,0,1,0
15,237,237,2,2,0,1,0
7,237,237,64,33,31,2,1
13,240,240,15,15,0,1,0
20,241,241,79,40,39,2,1
25,241,241,19,19,0,1,0
8,248,248,3,3,0,1,0
26,265,265,15,15,0,1,0
21,283,283,13,4,9,4,3
11,358,358,120,120,0,1,0
14,372,372,58,58,0,1,0
12,401,401,73,46,27,2,1
19,411,411,28,14,14,2,1
18,415,415,4,4,0,1,0
2,418,418,6,6,0,1,0
6,429,429,25,25,0,1,0
5,433,433,16,2,14,4,3
10,455,455,123,63,60,3,2
23,491,491,100,100,0,1,0
29,492,492,90,90,0,1,0
24,493,493,69,1,68,3,2
4,498,498,70,42,28,2,1

18,113,113,13,3,10,2,1
33,115,115,25,9,16,4,3
3,116,116,5,5,0,1,0
25,119,119,6,6,0,1,0
19,121,121,4,4,0,1,0
1,155,155,1,1,0,1,0
34,175,175,54,54,0,1,0
13,191,191,40,24,16,3,2
20,212,212,35,21,14,3,2
8,213,213,29,2,27,2,1
10,219,219,3,3,0,1,0
7,225,225,3,3,0,1,0
17,235,235,83,11,72,4,3
22,237,237,2,2,0,1,0
31,240,240,44,12,32,3,2
30,255,255,22,3,19,2,1
26,287,287,30,30,0,1,0
5,305,305,8,1,7,2,1
24,307,307,36,36,0,1,0
2,311,311,7,7,0,1,0
21,315,315,12,12,0,1,0
9,328,328,33,12,21,4,3
14,332,332,4,4,0,1,0
4,338,338,32,32,0,1,0
27,339,339,60,60,0,1,0
16,344,344,24,6,18,2,1
11,349,349,3,3,0,1,0
32,372,372,30,30,0,1,0
35,387,387,2,2,0,1,0
23,387,387,4,4,0,1,0
6,402,402,11,1,10,3,2
28,404,404,37,37,0,1,0
29,422,422,28,24,4,2,1
15,449,449,78,78,0,1,0
12,465,465,5,5,0,1,0
0,479,479,129,69,60,4,3

26,126,126,11,11,0,1,0
10,149,149,5,5,0,1,0
0,182,182,40,40,0,1,0
5,183,183,67,18,49,4,3
8,191,191,23,4,19,3,2
25,196,196,41,41,0,1,0
19,218,218,12,12,0,1,0
13,228,228,17,17,0,1,0
6,229,229,16,16,0,1,0
28,235,235,52,44,8,3,2
30,260,260,80,58,22,2,1
27,264,264,50,50,0,1,0
18,281,281,2,2,0,1,0
24,286,286,6,6,0,1,0
21,289,289,84,58,26,2,1
11,295,295,26,5,21,2,1
20,298,298,2,2,0,1,0
15,305,305,5,5,0,1,0
29,316,316,22,22,0,1,0
2,330,330,2,2,0,1,0
23,352,352,4,4,0,1,0
3,354,354,19,10,9,4,3
16,369,369,32,32,0,1,0
9,391,391,40,1,39,4,3
17,401,401,10,3,7,2,1
7,407,407,70,6,64,3,2
4,419,419,34,21,13,2,1
14,473,473,32,32,0,1,0
22,475,475,29,24,5,2,1
12,480,480,150,102,48,2,1
1,485,485,2,2,0,1,0

7,111,111,5,2,3,2,1
4,115,115,1,1,0,1,0
19,140,140,31,25,6,2,1
25,145,145,9,1,8,2,1
11,163,163,9,9,0,1,0
29,166,166,22,22,0,1,0
5,169,169,112,51,61,3,2
21,180,180,10,10,0,1,0
13,189,189,23,23,0,1,0
14,241,241,30,30,0,1,0
26,244,244,29,29,0,1,0
2,253,253,43,21,22,3,2
1,275,275,44,44,0,1,0
3,294,294,27,27,0,1,0
9,301,301,12,12,0,1,0
20,319,319,7,7,0,1,0
22,329,329,3,3,0,1,0
15,330,330,26,5,21,2,1
8,336,336,14,14,0,1,0
6,336,336,41,27,14,3,2
27,342,342,35,35,0,1,0
28,347,347,25,25,0,1,0
18,368,368,49,49,0,1,0
17,389,389,39,39,0,1,0
10,392,392,15,15,0,1,0
16,404,404,57,57,0,1,0
23,411,411,8,8,0,1,0
24,456,456,101,9,92,4,3
12,458,458,12,3,9,4,3
0,466,466,112,24,88,3,2

9,108,108,58,37,21,4,3
18,139,139,4,4,0,1,0
1,174,174,47,13,34,2,1
11,180,180,3,3,0,1,0
6,185,185,60,40,20,3,2
14,206,206,15,15,0,1,0
20,206,206,19,19,0,1,0
13,226,226,31,7,24,3,2
28,245,245,10,10,0,1,0
15,252,252,13,13,0,1,0
12,267,267,69,27,42,4,3
5,271,271,22,14,8,2,1
4,272,272,29,11,18,3,2
23,279,279,16,4,12,3,2
8,332,332,17,3,14,4,3
0,350,350,26,26,0,1,0
10,361,361,10,10,0,1,0
25,368,368,18,18,0,1,0
7,369,369,8,8,0,1,0
22,386,386,69,1,68,3,2
2,404,404,69,35,34,2,1
26,405,405,48,48,0,1,0
3,422,422,8,4,4,2,1
17,457,457,28,21,7,2,1
21,459,459,133,133,0,1,0
19,467,467,47,23,24,2,1
27,478,478,19,7,12,4,3
24,481,481,1,1,0,1,0
16,498,498,73,73,0,1,0

2,112,112,18,2,16,3,2
14,141,141,6,6,0,1,0
5,157,157,1,1,0,1,0
21,158,158,10,10,0,1,0
25,168,168,6,6,0,1,0
16,176,176,3,3,0,1,0
28,197,197,17,17,0,1,0
27,198,198,31,31,0,1,0
15,228,228,3,3,0,1,0
13,232,232,69,26,43,2,1
26,237,237,45,45,0,1,0
3,246,246,18,18,0,1,0
17,267,267,48,48,0,1,0
23,275,275,32,22,10,2,1
18,275,275,49,39,10,2,1
0,277,277,44,44,0,1,0
7,280,280,16,16,0,1,0
19,294,294,5,5,0,1,0
4,314,314,49,5,44,2,1
20,316,316,5,5,0,1,0
29,325,325,16,16,0,1,0
24,343,343,42,42,0,1,0
10,365,365,66,4,62,4,3
8,384,384,13,5,8,2,1
22,389,389,60,60,0,1,0
6,412,412,59,19,40,3,2
12,414,414,70,70,0,1,0
11,422,422,31,17,14,3,2
1,456,456,94,94,0,1,0
9,500,500,141,141,0,1,0

1,118,118,50,50,0,1,0
3,125,125,5,5,0,1,0
22,129,129,8,8,0,1,0
21,138,138,28,28,0,1,0
4,173,173,6,6,0,1,0
2,180,180,39,12,27,4,3
18,197,197,38,27,11,3,2
16,214,214,1,1,0,1,0
5,221,221,44,20,24,3,2
17,242,242,6,1,5,2,1
6,247,247,37,37,0,1,0
7,256,256,41,41,0,1,0
24,258,258,13,9,4,2,1
15,259,259,84,30,54,4,3
8,296,296,16,16,0,1,0
0,351,351,168,120,48,3,2
10,359,359,10,4,6,3,2
14,365,365,8,8,0,1,0
9,377,377,44,44,0,1,0
19,393,393,20,17,3,2,1
13,395,395,1,1,0,1,0
20,410,410,89,34,55,3,2
12,425,425,23,23,0,1,0
23,427,427,88,46,42,4,3
11,465,465,56,56,0,1,0

28,113,113,3,3,0,1,0
23,117,117,3,3,0,1,0
31,130,130,2,2,0,1,0
30,131,131,14,4,10,3,2
4,131,131,18,9,9,4,3
39,134,134,1,1,0,1,0
38,136,136,2,2,0,1,0
16,147,147,2,2,0,1,0
19,156,156,10,1,9,4,3
40,157,157,18,5,13,4,3
0,159,159,3,3,0,1,0
36,162,162,2,2,0,1,0
15,179,179,14,14,0,1,0
5,182,182,6,6,0,1,0
46,194,194,2,2,0,1,0
24,199,199,4,1,3,2,1
10,216,216,2,2,0,1,0
20,233,233,4,4,0,1,0
44,238,238,49,49,0,1,0
6,238,238,1,1,0,1,0
32,255,255,71,31,40,3,2
48,256,256,68,23,45,2,1
8,263,263,26,26,0,1,0
34,276,276,64,23,41,2,1
13,289,289,2,2,0,1,0
33,304,304,28,28,0,1,0
14,312,312,9,1,8,3,2
43,321,321,1,1,0,1,0
12,322,322,15,15,0,1,0
25,331,331,22,8,14,3,2
29,337,337,29,5,24,3,2
21,340,340,6,6,0,1,0
9,353,353,10,10,0,1,0
27,370,370,50,42,8,2,1
11,396,396,16,4,12,4,3
1,407,407,133,65,68,4,3
17,412,412,22,22,0,1,0
3,415,415,4,4,0,1,0
35,429,429,30,15,15,4,3
45,434,434,7,4,3,2,1
47,443,443,18,8,10,2,1
42,450,450,29,18,11,2,1
41,454,454,73,73,0,1,0
7,457,457,16,16,0,1,0
22,457,457,21,6,15,2,1
2,461,461,38,38,0,1,0
37,483,483,68,25,43,2,1
26,499,499,12,9,3,2,1
18,500,500,2,2,0,1,0

0,107,107,2,2,0,1,0
26,108,108,24,24,0,1,0
11,129,129,20,6,14,2,1
32,139,139,2,2,0,1,0
20,147,147,9,5,4,2,1
18,147,147,1,1,0,1,0
1,169,169,7,7,0,1,0
6,170,170,1,1,0,1,0
12,176,176,3,3,0,1,0
35,183,183,9,9,0,1,0
3,200,200,30,1,29,3,2
29,205,205,25,25,0,1,0
14,231,231,1,1,0,1,0
33,246,246,17,4,13,2,1
28,251,251,5,2,3,2,1
10,260,260,15,15,0,1,0
24,293,293,44,44,0,1,0
19,296,296,33,33,0,1,0
23,318,318,15,3,12,3,2
21,321,321,13,3,10,3,2
13,339,339,1,1,0,1,0
36,341,341,7,7,0,1,0
4,354,354,4,4,0,1,0
15,369,369,15,15,0,1,0
34,369,369,2,2,0,1,0
5,369,369,34,17,17,2,1
2,374,374,27,1,26,2,1
16,382,382,4,4,0,1,0
8,410,410,250,230,20,3,2
27,412,412,84,10,74,4,3
25,426,426,201,65,136,4,3
22,427,427,58,41,17,2,1
31,431,431,37,23,14,3,2
17,433,433,16,16,0,1,0
7,436,436,88,88,0,1,0
9,465,465,26,5,21,2,1
30,491,491,9,5,4,2,1

24,105,105,3,3,0,1,0
33,106,106,2,2,0,1,0
6,114,114,10,6,4,2,1
13,123,123,10,5,5,2,1
19,136,136,5,5,0,1,0
8,137,137,1,1,0,1,0
17,142,142,3,3,0,1,0
10,155,155,1,1,0,1,0
20,163,163,10,5,5,2,1
14,171,171,6,3,3,2,1
31,173,173,26,15,11,4,3
25,183,183,104,79,25,3,2
28,192,192,7,7,0,1,0
22,201,201,19,12,7,2,1
36,219,219,28,10,18,4,3
15,219,219,7,4,3,2,1
9,253,253,17,12,5,2,1
35,265,265,7,4,3,2,1
2,273,273,48,48,0,1,0
23,283,283,53,11,42,4,3
21,293,293,39,39,0,1,0
32,302,302,5,1,4,2,1
7,305,305,25,25,0,1,0
18,314,314,14,10,4,2,1
5,336,336,13,13,0,1,0
1,372,372,3,3,0,1,0
16,372,372,175,112,63,4,3
4,396,396,30,5,25,2,1
0,409,409,27,11,16,4,3
29,427,427,54,8,46,3,2
27,431,431,5,2,3,2,1
34,448,448,27,27,0,1,0
26,464,464,13,13,0,1,0
3,464,464,21,21,0,1,0
11,467,467,21,4,17,4,3
12,474,474,132,110,22,3,2
30,485,485,27,27,0,1,0

10,101,101,8,2,6,2,1
27,126,126,13,9,4,2,1
28,139,139,59,59,0,1,0
7,155,155,1,1,0,1,0
32,160,160,21,21,0,1,0
14,173,173,1,1,0,1,0
19,179,179,24,24,0,1,0
6,187,187,19,19,0,1,0
4,220,220,5,5,0,1,0
25,228,228,8,4,4,2,1
20,230,230,22,22,0,1,0
16,246,246,10,10,0,1,0
26,267,267,3,3,0,1,0
1,275,275,17,17,0,1,0
31,278,278,21,9,12,3,2
21,283,283,2,2,0,1,0
2,286,286,20,20,0,1,0
22,291,291,2,2,0,1,0
23,291,291,36,36,0,1,0
30,310,310,49,9,40,3,2
29,313,313,34,10,24,4,3
17,315,315,178,139,39,4,3
5,318,318,2,2,0,1,0
24,318,318,42,42,0,1,0
18,363,363,6,6,0,1,0
0,367,367,86,86,0,1,0
11,369,369,8,8,0,1,0
3,391,391,47,32,15,2,1
13,411,411,24,24,0,1,0
9,417,417,2,2,0,1,0
15,420,420,23,23,0,1,0
12,439,439,67,63,4,2,1
33,443,443,34,34,0,1,0
8,457,457,44,29,15,4,3
34,491,491,50,7,43,2,1

13,120,120,8,8,0,1,0
3,125,125,2,2,0,1,0
0,149,149,72,38,34,2,1
19,154,154,20,20,0,1,0
20,168,168,1,1,0,1,0
1,199,199,25,7,18,2,1
8,206,206,41,41,0,1,0
18,217,217,36,36,0,1,0
26,225,225,19,12,7,2,1
22,258,258,35,23,12,4,3
6,265,265,89,27,62,3,2
15,288,288,8,8,0,1,0
7,320,320,51,33,18,4,3
2,327,327,8,8,0,1,0
16,328,328,60,60,0,1,0
4,353,353,33,33,0,1,0
12,358,358,16,16,0,1,0
10,367,367,6,6,0,1,0
25,371,371,14,14,0,1,0
27,374,374,32,32,0,1,0
5,387,387,13,13,0,1,0
21,396,396,16,10,6,2,1
11,399,399,1,1,0,1,0
14,400,400,97,23,74,3,2
9,415,415,89,50,39,3,2
24,440,440,122,122,0,1,0
17,449,449,83,32,51,4,3
23,473,473,8,8,0,1,0

1,112,112,16,7,9,4,3
26,158,158,5,5,0,1,0
0,160,160,36,36,0,1,0
18,163,163,45,13,32,3,2
6,169,169,22,14,8,3,2
20,171,171,48,48,0,1,0
3,178,178,1,1,0,1,0
15,186,186,3,3,0,1,0
33,208,208,8,8,0,1,0
32,229,229,12,3,9,2,1
27,245,245,37,37,0,1,0
25,248,248,11,11,0,1,0
19,249,249,8,2,6,2,1
17,276,276,2,2,0,1,0
11,282,282,3,3,0,1,0
10,282,282,7,7,0,1,0
24,289,289,75,11,64,3,2
12,295,295,66,16,50,3,2
31,319,319,6,6,0,1,0
23,321,321,17,17,0,1,0
14,337,337,66,26,40,2,1
30,359,359,32,6,26,2,1
7,361,361,69,69,0,1,0
8,362,362,71,29,42,4,3
13,364,364,17,8,9,2,1
5,368,368,17,17,0,1,0
4,391,391,33,33,0,1,0
9,392,392,8,4,4,2,1
16,406,406,17,14,3,2,1
2,423,423,39,39,0,1,0
29,429,429,74,74,0,1,0
21,463,463,20,20,0,1,0
34,471,471,40,14,26,2,1
22,481,481,31,12,19,2,1
28,483,483,21,3,18,3,2

4,103,103,3,3,0,1,0
29,106,106,16,6,10,3,2
28,110,110,8,8,0,1,0
41,128,128,21,21,0,1,0
23,152,152,20,20,0,1,0
25,168,168,15,15,0,1,0
39,173,173,16,16,0,1,0
26,175,175,28,28,0,1,0
16,175,175,1,1,0,1,0
34,179,179,14,14,0,1,0
36,197,197,13,5,8,3,2
14,219,219,12,7,5,2,1
40,220,220,23,23,0,1,0
0,233,233,11,11,0,1,0
37,233,233,9,1,8,2,1
18,234,234,38,2,36,4,3
19,253,253,3,3,0,1,0
21,257,257,2,2,0,1,0
30,258,258,2,2,0,1,0
47,260,260,4,1,3,2,1
20,264,264,12,12,0,1,0
24,265,265,20,4,16,2,1
32,271,271,21,6,15,2,1
7,275,275,4,4,0,1,0
22,278,278,28,28,0,1,0
6,299,299,12,5,7,2,1
27,299,299,21,1,20,3,2
46,300,300,6,6,0,1,0
9,301,301,44,30,14,4,3
12,303,303,14,3,11,2,1
11,308,308,1,1,0,1,0
10,315,315,10,10,0,1,0
42,343,343,8,4,4,2,1
44,357,357,126,32,94,4,3
8,358,358,10,10,0,1,0
2,385,385,10,10,0,1,0
5,396,396,9,9,0,1,0
45,400,400,9,3,6,2,1
35,406,406,10,10,0,1,0
38,408,408,71,51,20,2,1
43,429,429,15,15,0,1,0
3,445,445,5,1,4,2,1
17,448,448,30,24,6,3,2
13,468,468,15,15,0,1,0
15,469,469,1,1,0,1,0
33,473,473,168,118,50,3,2
1,489,489,4,1,3,2,1
31,495,495,41,41,0,1,0

23,102,102,12,12,0,1,0
6,104,104,15,5,10,2,1
10,118,118,30,16,14,2,1
37,119,119,4,4,0,1,0
24,122,122,7,1,6,3,2
36,137,137,13,3,10,4,3
27,160,160,3,3,0,1,0
30,168,168,23,23,0,1,0
31,174,174,27,27,0,1,0
32,175,175,21,12,9,4,3
16,187,187,10,10,0,1,0
35,195,195,7,7,0,1,0
11,199,199,6,1,5,2,1
2,206,206,5,5,0,1,0
0,250,250,3,3,0,1,0
9,262,262,1,1,0,1,0
13,263,263,8,2,6,2,1
15,288,288,32,8,24,4,3
25,303,303,53,53,0,1,0
21,305,305,20,3,17,2,1
20,306,306,1,1,0,1,0
8,315,315,67,20,47,4,3
26,319,319,17,2,15,4,3
5,336,336,15,15,0,1,0
33,349,349,6,6,0,1,0
7,350,350,1,1,0,1,0
18,359,359,38,38,0,1,0
29,379,379,26,8,18,2,1
19,383,383,155,151,4,2,1
17,384,384,1,1,0,1,0
34,385,385,80,80,0,1,0
14,389,389,7,7,0,1,0
1,391,391,24,24,0,1,0
38,438,438,113,75,38,3,2
4,458,458,29,14,15,4,3
3,463,463,1,1,0,1,0
12,466,466,24,24,0,1,0
22,469,469,81,81,0,1,0
28,499,499,9,9,0,1,0

5,108,108,15,7,8,2,1
7,126,126,5,5,0,1,0
1,136,136,34,30,4,2,1
0,137,137,7,7,0,1,0
4,152,152,58,10,48,3,2
20,154,154,10,10,0,1,0
24,187,187,13,4,9,3,2
23,189,189,46,46,0,1,0
14,227,227,39,39,0,1,0
12,230,230,16,16,0,1,0
25,269,269,3,3,0,1,0
16,277,277,10,10,0,1,0
2,304,304,11,11,0,1,0
22,308,308,71,71,0,1,0
17,339,339,40,13,27,4,3
26,359,359,44,44,0,1,0
11,371,371,38,38,0,1,0
15,375,375,29,29,0,1,0
18,411,411,36,36,0,1,0
8,422,422,169,169,0,1,0
9,424,424,49,49,0,1,0
13,428,428,75,9,66,4,3
6,430,430,113,38,75,4,3
19,441,441,16,7,9,2,1
10,443,443,8,8,0,1,0
21,445,445,42,6,36,2,1
3,490,490,12,3,9,2,1

31,128,128,25,25,0,1,0
7,141,141,2,2,0,1,0
13,163,163,17,17,0,1,0
33,180,180,8,8,0,1,0
22,185,185,4,4,0,1,0
11,203,203,2,2,0,1,0
5,226,226,22,6,16,4,3
21,243,243,9,9,0,1,0
0,243,243,75,75,0,1,0
12,252,252,5,2,3,2,1
8,272,272,41,13,28,3,2
25,273,273,53,41,12,3,2
29,276,276,5,5,0,1,0
9,288,288,21,3,18,2,1
4,290,290,44,44,0,1,0
1,293,293,10,1,9,2,1
26,299,299,36,15,21,2,1
14,302,302,14,14,0,1,0
17,302,302,47,27,20,3,2
3,309,309,7,7,0,1,0
24,328,328,29,29,0,1,0
34,329,329,39,9,30,4,3
23,350,350,23,23,0,1,0
32,360,360,27,27,0,1,0
27,377,377,143,143,0,1,0
15,385,385,47,25,22,2,1
19,413,413,41,41,0,1,0
18,414,414,34,34,0,1,0
28,414,414,22,22,0,1,0
2,429,429,40,3,37,2,1
6,433,433,97,97,0,1,0
30,442,442,11,11,0,1,0
16,445,445,20,15,5,2,1
10,473,473,13,6,7,2,1
20,500,500,62,25,37,4,3

3,101,101,1,1,0,1,0
13,101,101,1,1,0,1,0
37,103,103,11,11,0,1,0
7,117,117,26,16,10,2,1
36,139,139,3,3,0,1,0
18,144,144,23,1,22,3,2
10,157,157,3,3,0,1,0
2,162,162,3,3,0,1,0
19,164,164,7,7,0,1,0
16,172,172,9,9,0,1,0
0,187,187,6,6,0,1,0
17,193,193,20,11,9,4,3
26,224,224,62,7,55,3,2
6,226,226,40,40,0,1,0
28,245,245,21,21,0,1,0
31,257,257,67,29,38,3,2
20,267,267,32,32,0,1,0
29,274,274,16,16,0,1,0
23,277,277,3,3,0,1,0
4,277,277,21,15,6,2,1
33,279,279,10,7,3,2,1
9,297,297,25,25,0,1,0
34,304,304,33,33,0,1,0
1,331,331,14,6,8,3,2
15,339,339,12,12,0,1,0
24,349,349,86,28,58,4,3
21,353,353,101,101,0,1,0
32,355,355,5,5,0,1,0
25,357,357,3,3,0,1,0
8,361,361,2,2,0,1,0
12,380,380,105,78,27,3,2
5,390,390,21,2,19,4,3
14,443,443,44,16,28,2,1
27,447,447,5,1,4,2,1
35,454,454,37,7,30,3,2
11,461,461,28,20,8,3,2
30,482,482,36,36,0,1,0
22,500,500,20,14,6,3,2

18,142,142,6,6,0,1,0
15,151,151,8,8,0,1,0
26,157,157,33,25,8,3,2
3,169,169,16,16,0,1,0
1,170,170,8,5,3,2,1
4,191,191,5,5,0,1,0
20,194,194,10,10,0,1,0
14,204,204,1,1,0,1,0
27,212,212,19,19,0,1,0
29,260,260,10,3,7,2,1
11,272,272,50,50,0,1,0
6,301,301,1,1,0,1,0
0,312,312,25,25,0,1,0
19,317,317,30,30,0,1,0
13,319,319,93,93,0,1,0
30,328,328,12,1,11,2,1
8,336,336,22,22,0,1,0
31,341,341,7,2,5,2,1
23,355,355,60,60,0,1,0
12,361,361,42,42,0,1,0
17,369,369,150,116,34,3,2
7,419,419,46,46,0,1,0
10,424,424,17,17,0,1,0
32,429,429,39,14,25,2,1
16,439,439,67,67,0,1,0
9,441,441,22,8,14,3,2
2,442,442,105,71,34,2,1
22,444,444,52,52,0,1,0
21,444,444,28,28,0,1,0
5,452,452,136,34,102,4,3
28,481,481,17,7,10,2,1
25,483,483,27,27,0,1,0
24,500,500,25,25,0,1,0

17,125,125,22,5,17,2,1
20,130,130,3,3,0,1,0
0,137,137,86,38,48,4,3
1,147,147,12,12,0,1,0
10,162,162,14,6,8,2,1
4,168,168,8,8,0,1,0
8,175,175,16,16,0,1,0
7,186,186,4,4,0,1,0
23,199,199,17,5,12,4,3
3,252,252,60,60,0,1,0
24,263,263,91,91,0,1,0
6,266,266,4,1,3,2,1
15,278,278,8,8,0,1,0
12,283,283,14,10,4,2,1
18,305,305,62,62,0,1,0
11,314,314,86,86,0,1,0
27,314,314,13,3,10,2,1
14,353,353,65,15,50,2,1
9,388,388,21,21,0,1,0
25,400,400,70,6,64,4,3
5,402,402,52,52,0,1,0
26,417,417,37,37,0,1,0
2,419,419,15,9,6,3,2
16,429,429,42,42,0,1,0
22,463,463,23,23,0,1,0
19,464,464,16,16,0,1,0
13,473,473,8,1,7,2,1
21,484,484,39,39,0,1,0
28,494,494,24,24,0,1,0

33,143,143,22,22,0,1,0
29,145,145,13,13,0,1,0
23,145,145,1,1,0,1,0
13,164,164,28,7,21,4,3
36,164,164,25,3,22,2,1
14,177,177,9,1,8,3,2
22,178,178,16,7,9,2,1
12,180,180,3,3,0,1,0
38,182,182,14,6,8,2,1
39,194,194,19,12,7,2,1
18,200,200,25,11,14,2,1
6,204,204,2,2,0,1,0
35,220,220,4,4,0,1,0
32,234,234,23,11,12,3,2
1,245,245,15,15,0,1,0
8,256,256,6,6,0,1,0
2,274,274,11,2,9,4,3
11,284,284,38,38,0,1,0
31,285,285,14,8,6,2,1
30,288,288,22,8,14,2,1
16,299,299,3,3,0,1,0
15,328,328,61,5,56,4,3
34,332,332,73,73,0,1,0
5,334,334,23,23,0,1,0
19,371,371,9,9,0,1,0
25,372,372,45,45,0,1,0
37,381,381,52,18,34,2,1
27,406,406,15,11,4,2,1
0,412,412,46,46,0,1,0
26,416,416,101,96,5,2,1
7,447,447,66,30,36,4,3
4,460,460,3,3,0,1,0
17,471,471,48,48,0,1,0
10,474,474,31,31,0,1,0
9,475,475,16,16,0,1,0
21,475,475,44,26,18,2,1
20,480,480,48,9,39,4,3
28,490,490,40,6,34,3,2
24,491,491,36,36,0,1,0
3,493,493,16,16,0,1,0

3,101,101,6,3,3,2,1
20,129,129,26,26,0,1,0
27,138,138,12,12,0,1,0
35,143,143,8,3,5,2,1
1,156,156,17,13,4,2,1
19,157,157,1,1,0,1,0
21,158,158,4,4,0,1,0
33,188,188,1,1,0,1,0
37,190,190,38,38,0,1,0
29,197,197,2,2,0,1,0
6,212,212,11,2,9,4,3
30,219,219,4,4,0,1,0
8,230,230,43,43,0,1,0
11,257,257,41,41,0,1,0
23,259,259,64,52,12,4,3
9,259,259,1,1,0,1,0
4,267,267,42,24,18,4,3
26,268,268,1,1,0,1,0
32,277,277,44,44,0,1,0
17,292,292,65,65,0,1,0
12,306,306,16,16,0,1,0
18,308,308,25,25,0,1,0
39,312,312,4,1,3,2,1
38,321,321,13,3,10,3,2
15,328,328,1,1,0,1,0
22,333,333,26,26,0,1,0
28,346,346,6,2,4,2,1
2,386,386,20,20,0,1,0
0,409,409,35,4,31,2,1
13,413,413,5,5,0,1,0
31,429,429,115,110,5,2,1
24,429,429,57,27,30,4,3
36,429,429,2,2,0,1,0
34,434,434,101,101,0,1,0
14,450,450,9,1,8,3,2
10,452,452,27,22,5,2,1
5,452,452,12,6,6,2,1
16,474,474,19,8,11,2,1
7,483,483,3,3,0,1,0
25,499,499,118,118,0,1,0

0,118,118,6,1,5,2,1
6,118,118,22,22,0,1,0
21,132,132,18,11,7,2,1
19,132,132,29,29,0,1,0
24,143,143,19,1,18,2,1
9,149,149,4,4,0,1,0
10,165,165,17,13,4,2,1
28,166,166,52,43,9,4,3
15,167,167,11,4,7,2,1
14,192,192,1,1,0,1,0
8,224,224,15,15,0,1,0
23,244,244,36,36,0,1,0
33,246,246,6,6,0,1,0
38,251,251,106,51,55,4,3
4,253,253,63,63,0,1,0
3,257,257,8,8,0,1,0
2,271,271,4,4,0,1,0
29,276,276,12,12,0,1,0
37,282,282,11,1,10,2,1
34,300,300,11,11,0,1,0
25,305,305,15,15,0,1,0
20,308,308,14,14,0,1,0
32,344,344,107,107,0,1,0
7,347,347,14,14,0,1,0
5,352,352,30,30,0,1,0
36,366,366,15,15,0,1,0
13,379,379,76,40,36,2,1
35,380,380,19,5,14,3,2
30,385,385,5,5,0,1,0
31,394,394,5,1,4,2,1
18,394,394,2,2,0,1,0
16,408,408,10,1,9,2,1
12,425,425,9,9,0,1,0
26,427,427,30,21,9,4,3
1,445,445,21,21,0,1,0
22,450,450,1,1,0,1,0
11,458,458,34,2,32,2,1
17,459,459,2,2,0,1,0
27,466,466,9,3,6,3,2

31,101,101,3,3,0,1,0
35,102,102,16,6,10,2,1
26,115,115,3,3,0,1,0
10,136,136,7,7,0,1,0
25,144,144,2,2,0,1,0
2,167,167,14,14,0,1,0
24,167,167,6,6,0,1,0
0,178,178,39,39,0,1,0
4,186,186,1,1,0,1,0
5,192,192,41,5,36,2,1
22,197,197,27,5,22,3,2
20,203,203,21,21,0,1,0
32,207,207,7,1,6,3,2
11,210,210,10,10,0,1,0
34,226,226,29,3,26,3,2
28,255,255,40,17,23,2,1
14,279,279,18,18,0,1,0
9,282,282,47,47,0,1,0
13,288,288,16,11,5,2,1
6,293,293,3,3,0,1,0
1,301,301,13,13,0,1,0
12,323,323,12,12,0,1,0
30,324,324,61,25,36,2,1
15,330,330,20,20,0,1,0
33,339,339,13,4,9,2,1
7,353,353,19,19,0,1,0
23,379,379,173,133,40,2,1
16,422,422,3,3,0,1,0
29,434,434,13,4,9,2,1
3,438,438,26,26,0,1,0
27,440,440,76,35,41,3,2
21,449,449,19,19,0,1,0
19,459,459,1,1,0,1,0
17,463,463,192,126,66,4,3
18,489,489,3,3,0,1,0
8,495,495,50,50,0,1,0

7,104,104,2,2,0,1,0
14,134,134,14,9,5,2,1
2,144,144,10,1,9,2,1
21,155,155,4,4,0,1,0
23,163,163,1,1,0,1,0
27,176,176,35,35,0,1,0
30,191,191,13,13,0,1,0
8,205,205,1,1,0,1,0
18,212,212,9,9,0,1,0
24,218,218,77,77,0,1,0
13,226,226,16,16,0,1,0
28,235,235,26,26,0,1,0
17,243,243,19,13,6,2,1
16,246,246,14,14,0,1,0
22,269,269,20,20,0,1,0
12,277,277,21,21,0,1,0
10,295,295,19,7,12,3,2
6,298,298,25,19,6,3,2
1,308,308,61,47,14,2,1
26,312,312,22,8,14,2,1
32,313,313,8,8,0,1,0
0,332,332,14,14,0,1,0
29,342,342,48,48,0,1,0
11,343,343,8,8,0,1,0
20,345,345,17,17,0,1,0
9,352,352,90,90,0,1,0
15,400,400,55,35,20,3,2
31,426,426,66,66,0,1,0
25,453,453,100,20,80,4,3
3,455,455,7,7,0,1,0
5,479,479,193,165,28,3,2
19,484,484,30,26,4,2,1
4,497,497,66,32,34,3,2

19,101,101,1,1,0,1,0
13,108,108,2,2,0,1,0
26,118,118,6,3,3,2,1
25,128,128,3,3,0,1,0
4,133,133,1,1,0,1,0
34,140,140,2,2,0,1,0
10,161,161,28,10,18,4,3
28,161,161,3,3,0,1,0
22,167,167,21,3,18,3,2
32,185,185,31,4,27,2,1
8,193,193,18,18,0,1,0
17,216,216,7,2,5,2,1
12,225,225,11,1,10,2,1
39,231,231,39,39,0,1,0
38,236,236,26,26,0,1,0
6,242,242,2,2,0,1,0
14,261,261,25,25,0,1,0
5,280,280,8,8,0,1,0
35,300,300,34,30,4,2,1
20,313,313,9,9,0,1,0
36,313,313,22,22,0,1,0
3,321,321,134,134,0,1,0
11,333,333,38,7,31,2,1
16,335,335,5,5,0,1,0
37,335,335,64,28,36,2,1
33,404,404,27,14,13,2,1
15,428,428,6,6,0,1,0
9,430,430,21,21,0,1,0
29,437,437,45,15,30,3,2
7,437,437,39,14,25,2,1
31,441,441,8,8,0,1,0
30,443,443,111,111,0,1,0
18,453,453,53,11,42,3,2
27,454,454,68,16,52,3,2
2,456,456,34,34,0,1,0
23,464,464,93,34,59,4,3
24,470,470,8,8,0,1,0
21,470,470,38,14,24,2,1
0,485,485,24,24,0,1,0
1,491,491,6,2,4,2,1

25,118,118,2,2,0,1,0
29,157,157,19,6,13,2,1
16,159,159,2,2,0,1,0
1,161,161,3,3,0,1,0
32,177,177,9,9,0,1,0
22,182,182,19,6,13,2,1
7,188,188,53,53,0,1,0
40,188,188,2,2,0,1,0
20,196,196,2,2,0,1,0
14,198,198,8,8,0,1,0
0,209,209,39,29,10,3,2
39,214,214,7,7,0,1,0
42,218,218,10,4,6,2,1
13,229,229,22,2,20,2,1
8,234,234,8,5,3,2,1
28,237,237,16,4,12,4,3
23,245,245,32,32,0,1,0
38,254,254,32,2,30,3,2
19,265,265,18,18,0,1,0
6,273,273,7,1,6,3,2
35,277,277,8,8,0,1,0
11,281,281,22,22,0,1,0
31,297,297,55,28,27,4,3
18,300,300,24,3,21,4,3
24,303,303,8,1,7,2,1
34,305,305,11,4,7,2,1
9,310,310,42,29,13,2,1
26,311,311,68,68,0,1,0
33,333,333,46,36,10,3,2
4,334,334,2,2,0,1,0
37,349,349,80,44,36,2,1
2,351,351,28,19,9,4,3
5,360,360,14,14,0,1,0
17,361,361,7,7,0,1,0
15,372,372,10,10,0,1,0
27,379,379,93,93,0,1,0
30,381,381,13,10,3,2,1
41,382,382,53,53,0,1,0
36,403,403,13,13,0,1,0
21,408,408,18,1,17,4,3
10,414,414,11,11,0,1,0
3,442,442,15,15,0,1,0
12,488,488,42,3,39,4,3

3,123,123,8,8,0,1,0
29,139,139,15,8,7,2,1
9,156,156,27,27,0,1,0
18,160,160,1,1,0,1,0
5,180,180,5,1,4,2,1
10,194,194,58,36,22,3,2
34,200,200,5,5,0,1,0
28,205,205,30,30,0,1,0
19,211,211,9,1,8,3,2
6,212,212,8,8,0,1,0
15,231,231,3,3,0,1,0
21,235,235,59,59,0,1,0
13,237,237,52,52,0,1,0
25,243,243,5,5,0,1,0
8,246,246,8,8,0,1,0
20,249,249,8,8,0,1,0
0,266,266,12,12,0,1,0
17,270,270,17,1,16,2,1
35,275,275,12,12,0,1,0
32,282,282,6,3,3,2,1
16,293,293,1,1,0,1,0
1,320,320,123,38,85,4,3
4,332,332,38,12,26,3,2
27,335,335,12,12,0,1,0
7,360,360,15,10,5,2,1
12,374,374,3,3,0,1,0
22,388,388,24,17,7,2,1
24,392,392,91,21,70,3,2
26,397,397,89,62,27,4,3
11,404,404,49,49,0,1,0
23,424,424,1,1,0,1,0
33,439,439,113,69,44,3,2
2,466,466,22,22,0,1,0
14,473,473,1,1,0,1,0
30,480,480,76,17,59,4,3
31,489,489,30,30,0,1,0

25,104,104,13,13,0,1,0
18,112,112,4,1,3,2,1
28,114,114,8,8,0,1,0
21,147,147,33,33,0,1,0
12,169,169,61,22,39,2,1
31,180,180,7,7,0,1,0
15,201,201,16,16,0,1,0
2,227,227,22,22,0,1,0
22,252,252,52,52,0,1,0
9,256,256,8,8,0,1,0
30,267,267,53,20,33,4,3
24,295,295,63,45,18,4,3
11,298,298,3,3,0,1,0
19,298,298,3,3,0,1,0
27,306,306,50,26,24,4,3
8,311,311,50,11,39,4,3
29,322,322,5,5,0,1,0
5,354,354,20,20,0,1,0
3,367,367,84,52,32,3,2
10,378,378,15,3,12,3,2
7,404,404,3,3,0,1,0
1,419,419,17,13,4,2,1
13,422,422,117,60,57,4,3
26,425,425,43,43,0,1,0
6,440,440,71,71,0,1,0
23,443,443,65,8,57,4,3
20,465,465,10,4,6,2,1
14,483,483,25,5,20,3,2
0,483,483,43,1,42,4,3
16,485,485,19,1,18,3,2
4,493,493,44,2,42,3,2
17,500,500,29,29,0,1,0

28,122,122,7,2,5,2,1
30,123,123,14,3,11,2,1
37,126,126,7,7,0,1,0
18,129,129,3,3,0,1,0
13,141,141,1,1,0,1,0
35,161,161,51,51,0,1,0
26,171,171,8,2,6,2,1
0,172,172,14,4,10,2,1
12,183,183,1,1,0,1,0
1,185,185,6,6,0,1,0
14,193,193,17,17,0,1,0
17,198,198,10,3,7,2,1
3,238,238,6,1,5,2,1
36,251,251,5,5,0,1,0
27,274,274,14,14,0,1,0
10,278,278,24,16,8,3,2
19,281,281,16,4,12,2,1
2,292,292,46,46,0,1,0
22,293,293,2,2,0,1,0
23,300,300,68,50,18,4,3
16,319,319,59,23,36,3,2
24,324,324,7,7,0,1,0
21,333,333,37,37,0,1,0
9,340,340,2,2,0,1,0
6,349,349,31,8,23,2,1
31,349,349,43,25,18,4,3
4,369,369,32,32,0,1,0
8,374,374,1,1,0,1,0
15,377,377,33,33,0,1,0
39,388,388,16,16,0,1,0
33,389,389,43,9,34,2,1
38,391,391,22,3,19,2,1
34,397,397,35,35,0,1,0
7,402,402,5,5,0,1,0
20,420,420,7,7,0,1,0
29,441,441,12,12,0,1,0
11,451,451,130,130,0,1,0
5,461,461,90,90,0,1,0
32,479,479,19,4,15,4,3
25,497,497,165,127,38,3,2

5,101,101,16,2,14,3,2
1,114,114,26,26,0,1,0
23,118,118,2,2,0,1,0
6,145,145,4,4,0,1,0
15,167,167,10,10,0,1,0
21,175,175,41,41,0,1,0
8,176,176,2,2,0,1,0
7,202,202,32,25,7,2,1
31,208,208,69,43,26,3,2
2,224,224,13,1,12,3,2
20,244,244,10,10,0,1,0
11,247,247,37,10,27,2,1
16,273,273,22,22,0,1,0
22,281,281,8,3,5,2,1
24,287,287,5,5,0,1,0
18,294,294,28,28,0,1,0
12,311,311,103,25,78,3,2
25,314,314,62,47,15,4,3
9,334,334,37,16,21,2,1
27,351,351,19,19,0,1,0
28,359,359,80,36,44,2,1
26,369,369,36,9,27,4,3
29,378,378,15,11,4,2,1
30,409,409,8,8,0,1,0
19,426,426,36,36,0,1,0
13,438,438,8,4,4,2,1
0,464,464,38,25,13,2,1
32,471,471,39,39,0,1,0
14,471,471,57,18,39,2,1
3,477,477,35,35,0,1,0
10,487,487,53,17,36,3,2
4,494,494,4,4,0,1,0
17,500,500,44,44,0,1,0

5,109,109,1,1,0,1,0
6,111,111,21,7,14,3,2
1,124,124,2,2,0,1,0
23,133,133,1,1,0,1,0
21,133,133,33,33,0,1,0
10,155,155,2,2,0,1,0
14,157,157,107,18,89,4,3
29,166,166,11,7,4,2,1
22,176,176,2,2,0,1,0
3,188,188,44,3,41,3,2
28,188,188,6,6,0,1,0
7,189,189,2,2,0,1,0
26,208,208,15,7,8,2,1
30,210,210,41,30,11,2,1
15,219,219,29,29,0,1,0
18,267,267,27,13,14,2,1
31,268,268,6,6,0,1,0
12,279,279,10,10,0,1,0
20,324,324,23,7,16,4,3
11,331,331,39,39,0,1,0
19,339,339,31,16,15,2,1
2,370,370,20,20,0,1,0
24,375,375,3,3,0,1,0
27,378,378,15,1,14,3,2
9,384,384,4,4,0,1,0
32,401,401,31,12,19,2,1
8,404,404,5,1,4,2,1
16,430,430,107,89,18,3,2
13,448,448,45,45,0,1,0
0,459,459,11,11,0,1,0
17,489,489,142,119,23,2,1
4,490,490,29,11,18,3,2
25,498,498,74,74,0,1,0

19,130,130,7,2,5,2,1
10,146,146,6,6,0,1,0
4,161,161,4,4,0,1,0
8,163,163,24,24,0,1,0
28,179,179,6,6,0,1,0
27,185,185,3,3,0,1,0
30,207,207,1,1,0,1,0
24,244,244,42,6,36,2,1
5,247,247,30,9,21,2,1
34,261,261,7,7,0,1,0
13,273,273,20,8,12,4,3
2,284,284,46,46,0,1,0
0,288,288,6,6,0,1,0
9,288,288,1,1,0,1,0
25,290,290,6,6,0,1,0
32,295,295,32,32,0,1,0
21,299,299,2,2,0,1,0
31,314,314,10,1,9,2,1
26,325,325,9,4,5,2,1
16,336,336,9,9,0,1,0
11,347,347,28,14,14,2,1
12,350,350,36,7,29,4,3
18,365,365,36,8,28,3,2
6,378,378,16,2,14,3,2
29,386,386,168,57,111,4,3
33,390,390,51,51,0,1,0
3,424,424,22,22,0,1,0
22,446,446,131,131,0,1,0
7,448,448,27,27,0,1,0
23,456,456,116,104,12,3,2
1,459,459,118,92,26,3,2
20,480,480,7,7,0,1,0
14,482,482,36,12,24,2,1
17,491,491,14,14,0,1,0
15,491,491,187,64,123,4,3

10,150,150,11,4,7,2,1
2,162,162,35,17,18,2,1
18,181,181,2,2,0,1,0
27,188,188,1,1,0,1,0
6,194,194,11,11,0,1,0
20,196,196,15,15,0,1,0
15,204,204,36,9,27,2,1
21,217,217,1,1,0,1,0
36,227,227,5,1,4,2,1
4,231,231,2,2,0,1,0
26,241,241,10,10,0,1,0
23,256,256,13,6,7,2,1
30,261,261,2,2,0,1,0
1,275,275,50,14,36,4,3
9,275,275,11,11,0,1,0
24,305,305,10,10,0,1,0
12,309,309,1,1,0,1,0
13,313,313,25,25,0,1,0
25,317,317,53,14,39,2,1
11,320,320,29,29,0,1,0
8,344,344,3,3,0,1,0
14,344,344,14,14,0,1,0
28,350,350,9,9,0,1,0
16,361,361,9,9,0,1,0
35,370,370,22,22,0,1,0
38,374,374,11,11,0,1,0
19,397,397,46,46,0,1,0
22,403,403,45,45,0,1,0
31,411,411,140,74,66,4,3
5,437,437,21,1,20,3,2
39,443,443,138,118,20,2,1
17,444,444,27,9,18,2,1
29,453,453,84,72,12,3,2
3,466,466,15,15,0,1,0
37,466,466,92,22,70,3,2
0,466,466,109,109,0,1,0
33,470,470,34,18,16,2,1
34,470,470,78,28,50,2,1
32,473,473,6,6,0,1,0
7,488,488,3,3,0,1,0

5,102,102,8,2,6,2,1
0,110,110,10,10,0,1,0
7,127,127,9,9,0,1,0
6,134,134,37,37,0,1,0
12,146,146,7,7,0,1,0
2,175,175,10,10,0,1,0
8,193,193,24,24,0,1,0
27,196,196,1,1,0,1,0
3,202,202,13,13,0,1,0
13,213,213,13,13,0,1,0
10,227,227,5,5,0,1,0
22,250,250,3,3,0,1,0
21,258,258,10,10,0,1,0
16,274,274,7,7,0,1,0
23,311,311,12,3,9,4,3
4,315,315,211,166,45,3,2
26,325,325,9,9,0,1,0
11,356,356,83,74,9,4,3
1,366,366,41,41,0,1,0
15,375,375,22,2,20,2,1
9,376,376,51,39,12,3,2
14,387,387,1,1,0,1,0
18,398,398,78,78,0,1,0
17,402,402,105,105,0,1,0
25,433,433,1,1,0,1,0
20,455,455,94,34,60,3,2
24,455,455,176,104,72,4,3
19,471,471,60,48,12,2,1

33,100,100,14,5,9,4,3
32,161,161,5,5,0,1,0
9,161,161,21,9,12,2,1
3,163,163,7,7,0,1,0
26,164,164,60,60,0,1,0
12,170,170,1,1,0,1,0
5,188,188,1,1,0,1,0
15,192,192,30,14,16,3,2
1,214,214,14,14,0,1,0
25,218,218,9,9,0,1,0
24,227,227,1,1,0,1,0
27,229,229,18,9,9,4,3
2,233,233,19,7,12,2,1
21,250,250,114,114,0,1,0
0,261,261,21,21,0,1,0
18,274,274,4,4,0,1,0
10,278,278,42,35,7,2,1
17,282,282,59,59,0,1,0
16,307,307,12,9,3,2,1
13,332,332,49,37,12,2,1
30,339,339,46,20,26,2,1
20,343,343,60,16,44,2,1
34,349,349,40,25,15,2,1
6,349,349,21,21,0,1,0
8,355,355,33,33,0,1,0
4,356,356,3,3,0,1,0
29,369,369,9,9,0,1,0
19,386,386,5,5,0,1,0
28,406,406,11,1,10,3,2
23,412,412,35,11,24,4,3
22,440,440,13,13,0,1,0
7,451,451,31,16,15,4,3
31,477,477,1,1,0,1,0
14,487,487,156,156,0,1,0
11,494,494,17,7,10,2,1

12,104,104,29,29,0,1,0
14,106,106,55,55,0,1,0
27,110,110,8,8,0,1,0
4,113,113,1,1,0,1,0
26,136,136,9,9,0,1,0
24,154,154,26,26,0,1,0
16,158,158,8,8,0,1,0
8,168,168,21,21,0,1,0
17,186,186,35,9,26,3,2
33,189,189,1,1,0,1,0
25,195,195,14,14,0,1,0
5,205,205,17,14,3,2,1
15,219,219,2,2,0,1,0
6,220,220,1,1,0,1,0
10,230,230,18,10,8,3,2
0,236,236,2,2,0,1,0
2,244,244,11,5,6,3,2
31,256,256,13,1,12,3,2
28,265,265,68,59,9,4,3
18,271,271,82,74,8,3,2
3,278,278,5,5,0,1,0
7,298,298,10,10,0,1,0
30,301,301,6,6,0,1,0
34,309,309,56,31,25,2,1
32,326,326,52,52,0,1,0
20,355,355,63,63,0,1,0
21,356,356,3,3,0,1,0
11,362,362,6,6,0,1,0
19,363,363,9,9,0,1,0
23,372,372,12,12,0,1,0
9,404,404,13,13,0,1,0
22,424,424,41,29,12,2,1
29,455,455,19,7,12,2,1
13,463,463,69,69,0,1,0
1,476,476,27,5,22,2,1

4,110,110,2,2,0,1,0
25,112,112,22,22,0,1,0
5,134,134,16,6,10,2,1
14,136,136,1,1,0,1,0
26,136,136,10,10,0,1,0
3,152,152,43,43,0,1,0
15,152,152,28,28,0,1,0
19,172,172,11,6,5,2,1
24,173,173,6,6,0,1,0
29,178,178,11,11,0,1,0
18,182,182,24,24,0,1,0
22,209,209,18,18,0,1,0
12,226,226,2,2,0,1,0
2,237,237,13,13,0,1,0
8,247,247,40,37,3,2,1
9,249,249,41,10,31,4,3
28,263,263,33,33,0,1,0
23,278,278,13,13,0,1,0
16,284,284,79,22,57,3,2
6,322,322,37,37,0,1,0
10,324,324,21,1,20,2,1
27,336,336,21,21,0,1,0
1,357,357,8,8,0,1,0
31,357,357,23,23,0,1,0
7,361,361,42,2,40,2,1
32,392,392,8,3,5,2,1
11,418,418,83,49,34,2,1
30,424,424,50,3,47,2,1
13,435,435,62,48,14,2,1
21,439,439,94,48,46,2,1
20,450,450,44,44,0,1,0
17,471,471,23,10,13,2,1
0,492,492,21,21,0,1,0

16,105,105,12,4,8,2,1
18,133,133,7,3,4,2,1
0,135,135,34,34,0,1,0
13,135,135,38,28,10,3,2
4,161,161,9,3,6,3,2
12,190,190,5,2,3,2,1
3,193,193,57,37,20,2,1
9,220,220,33,11,22,3,2
19,241,241,15,9,6,3,2
24,243,243,2,2,0,1,0
10,264,264,10,10,0,1,0
15,275,275,84,84,0,1,0
11,294,294,100,25,75,4,3
6,311,311,22,1,21,4,3
27,327,327,5,5,0,1,0
14,331,331,33,33,0,1,0
25,345,345,34,34,0,1,0
2,370,370,55,49,6,3,2
21,408,408,8,8,0,1,0
17,415,415,45,20,25,2,1
1,437,437,72,6,66,4,3
23,446,446,28,28,0,1,0
22,447,447,7,2,5,2,1
5,457,457,62,30,32,2,1
8,472,472,169,165,4,2,1
20,477,477,33,33,0,1,0
26,495,495,25,25,0,1,0
7,496,496,16,16,0,1,0

7,107,107,8,4,4,2,1
6,113,113,3,3,0,1,0
8,140,140,4,4,0,1,0
2,143,143,4,4,0,1,0
20,145,145,23,9,14,2,1
24,165,165,22,22,0,1,0
22,180,180,18,11,7,2,1
26,196,196,9,9,0,1,0
30,203,203,3,3,0,1,0
5,210,210,17,4,13,2,1
12,223,223,140,113,27,4,3
17,236,236,1,1,0,1,0
1,237,237,43,43,0,1,0
0,251,251,22,2,20,3,2
27,265,265,49,49,0,1,0
18,268,268,38,18,20,3,2
31,268,268,25,25,0,1,0
32,283,283,29,3,26,2,1
9,292,292,29,11,18,3,2
21,322,322,26,26,0,1,0
13,380,380,5,5,0,1,0
4,402,402,36,27,9,2,1
19,434,434,23,23,0,1,0
11,439,439,36,36,0,1,0
16,441,441,102,66,36,4,3
14,461,461,7,7,0,1,0
15,471,471,63,63,0,1,0
3,475,475,48,48,0,1,0
10,481,481,15,8,7,3,2
29,482,482,89,15,74,4,3
25,484,484,10,10,0,1,0
28,486,486,46,33,13,2,1
23,499,499,41,41,0,1,0

22,162,162,4,4,0,1,0
24,164,164,1,1,0,1,0
2,174,174,11,11,0,1,0
28,182,182,3,3,0,1,0
29,183,183,61,3,58,3,2
13,198,198,22,6,16,2,1
10,212,212,22,22,0,1,0
31,218,218,4,4,0,1,0
21,224,224,5,5,0,1,0
25,230,230,3,3,0,1,0
17,236,236,36,36,0,1,0
9,238,238,29,20,9,2,1
0,239,239,33,5,28,2,1
20,241,241,39,39,0,1,0
11,241,241,3,3,0,1,0
14,242,242,2,2,0,1,0
16,245,245,13,4,9,2,1
15,251,251,93,60,33,4,3
4,271,271,69,69,0,1,0
3,293,293,19,19,0,1,0
26,344,344,6,6,0,1,0
5,357,357,107,74,33,4,3
6,359,359,61,61,0,1,0
8,360,360,40,35,5,2,1
30,407,407,29,21,8,3,2
19,429,429,12,1,11,3,2
23,430,430,4,4,0,1,0
18,450,450,77,31,46,2,1
12,474,474,48,22,26,3,2
27,476,476,121,113,8,3,2
7,478,478,16,16,0,1,0
1,500,500,55,45,10,3,2

8,100,100,5,5,0,1,0
0,104,104,14,14,0,1,0
20,106,106,14,10,4,2,1
11,114,114,48,6,42,4,3
14,125,125,2,2,0,1,0
6,127,127,10,10,0,1,0
27,142,142,40,26,14,2,1
9,167,167,1,1,0,1,0
16,183,183,1,1,0,1,0
4,191,191,1,1,0,1,0
22,198,198,13,5,8,2,1
18,200,200,44,4,40,3,2
3,226,226,52,52,0,1,0
15,244,244,14,14,0,1,0
25,275,275,21,7,14,2,1
23,280,280,4,4,0,1,0
1,292,292,49,8,41,2,1
19,296,296,66,5,61,3,2
5,317,317,22,22,0,1,0
7,322,322,152,112,40,3,2
17,328,328,4,1,3,2,1
28,329,329,85,85,0,1,0
13,364,364,15,15,0,1,0
26,384,384,62,25,37,2,1
2,424,424,21,15,6,2,1
21,442,442,32,32,0,1,0
10,443,443,7,7,0,1,0
24,446,446,23,23,0,1,0
12,458,458,20,20,0,1,0

4,124,124,1,1,0,1,0
32,160,160,4,4,0,1,0
35,162,162,4,1,3,2,1
19,176,176,34,34,0,1,0
29,185,185,8,8,0,1,0
0,197,197,11,11,0,1,0
28,203,203,26,26,0,1,0
26,218,218,1,1,0,1,0
2,229,229,10,1,9,2,1
27,230,230,59,13,46,2,1
21,250,250,50,50,0,1,0
13,269,269,7,7,0,1,0
30,275,275,1,1,0,1,0
18,275,275,15,3,12,4,3
1,281,281,119,105,14,2,1
17,284,284,19,13,6,3,2
34,286,286,100,100,0,1,0
24,321,321,5,1,4,2,1
8,323,323,4,4,0,1,0
7,328,328,12,3,9,2,1
15,331,331,10,10,0,1,0
9,348,348,98,50,48,3,2
12,360,360,9,9,0,1,0
3,383,383,17,17,0,1,0
14,387,387,14,2,12,4,3
20,392,392,18,18,0,1,0
6,398,398,16,16,0,1,0
5,399,399,24,21,3,2,1
22,409,409,8,5,3,2,1
11,417,417,1,1,0,1,0
16,425,425,96,78,18,3,2
33,432,432,67,61,6,3,2
25,443,443,68,68,0,1,0
31,484,484,30,30,0,1,0
10,485,485,110,110,0,1,0
23,492,492,27,27,0,1,0

16,111,111,7,4,3,2,1
5,121,121,24,24,0,1,0
17,129,129,18,18,0,1,0
4,139,139,2,2,0,1,0
9,139,139,2,2,0,1,0
10,160,160,12,12,0,1,0
18,176,176,1,1,0,1,0
25,189,189,14,10,4,2,1
8,199,199,14,8,6,3,2
21,209,209,5,5,0,1,0
29,213,213,1,1,0,1,0
28,216,216,28,28,0,1,0
22,218,218,18,18,0,1,0
31,231,231,29,29,0,1,0
30,266,266,21,21,0,1,0
3,280,280,43,43,0,1,0
7,284,284,66,18,48,3,2
24,311,311,5,5,0,1,0
23,312,312,69,50,19,2,1
13,328,328,15,15,0,1,0
2,340,340,54,54,0,1,0
15,352,352,68,58,10,3,2
19,356,356,132,120,12,3,2
6,413,413,10,4,6,3,2
0,441,441,49,9,40,2,1
11,442,442,9,9,0,1,0
26,446,446,1,1,0,1,0
12,457,457,172,142,30,4,3
27,458,458,18,18,0,1,0
20,496,496,82,16,66,4,3
1,496,496,87,13,74,3,2
14,497,497,15,15,0,1,0

9,116,116,7,7,0,1,0
20,172,172,62,62,0,1,0
2,173,173,31,24,7,2,1
12,179,179,6,6,0,1,0
8,191,191,10,10,0,1,0
11,236,236,12,7,5,2,1
1,245,245,79,21,58,3,2
10,254,254,47,47,0,1,0
18,257,257,77,77,0,1,0
24,264,264,24,24,0,1,0
4,271,271,10,10,0,1,0
17,279,279,9,6,3,2,1
16,307,307,1,1,0,1,0
3,311,311,140,86,54,3,2
23,331,331,21,1,20,3,2
15,335,335,11,5,6,2,1
19,346,346,22,13,9,3,2
7,375,375,8,8,0,1,0
14,410,410,9,9,0,1,0
5,446,446,12,12,0,1,0
21,448,448,93,51,42,4,3
13,473,473,15,7,8,2,1
25,477,477,43,36,7,2,1
0,487,487,101,50,51,4,3
22,489,489,53,53,0,1,0
6,498,498,202,61,141,4,3

17,104,104,12,2,10,2,1
5,104,104,4,4,0,1,0
36,115,115,2,2,0,1,0
1,122,122,16,12,4,2,1
2,126,126,2,2,0,1,0
12,157,157,6,6,0,1,0
7,159,159,6,6,0,1,0
41,178,178,32,7,25,2,1
0,185,185,4,4,0,1,0
9,191,191,7,7,0,1,0
8,196,196,6,1,5,2,1
19,217,217,17,8,9,4,3
11,217,217,19,11,8,3,2
6,227,227,24,24,0,1,0
26,232,232,103,103,0,1,0
16,234,234,15,15,0,1,0
4,235,235,79,21,58,3,2
28,245,245,6,6,0,1,0
34,257,257,16,16,0,1,0
39,285,285,14,14,0,1,0
29,296,296,5,5,0,1,0
21,300,300,9,9,0,1,0
13,304,304,14,14,0,1,0
30,314,314,24,16,8,3,2
27,324,324,49,16,33,4,3
25,336,336,13,13,0,1,0
37,347,347,13,13,0,1,0
38,352,352,19,14,5,2,1
32,354,354,78,78,0,1,0
23,355,355,33,4,29,2,1
15,358,358,16,16,0,1,0
10,376,376,23,9,14,3,2
33,382,382,8,8,0,1,0
24,397,397,34,34,0,1,0
40,409,409,13,13,0,1,0
3,424,424,22,22,0,1,0
18,427,427,9,9,0,1,0
20,431,431,22,19,3,2,1
14,434,434,33,33,0,1,0
22,462,462,1,1,0,1,0
31,465,465,73,73,0,1,0
35,480,480,72,72,0,1,0

18,113,113,33,33,0,1,0
12,136,136,4,4,0,1,0
13,142,142,11,11,0,1,0
11,144,144,14,8,6,3,2
7,149,149,43,43,0,1,0
9,165,165,15,15,0,1,0
29,166,166,52,8,44,2,1
4,173,173,49,7,42,4,3
19,185,185,31,28,3,2,1
6,186,186,1,1,0,1,0
17,197,197,10,10,0,1,0
28,203,203,3,3,0,1,0
27,206,206,11,11,0,1,0
22,218,218,12,7,5,2,1
21,243,243,1,1,0,1,0
1,254,254,39,39,0,1,0
26,309,309,1,1,0,1,0
15,312,312,52,17,35,2,1
3,324,324,27,27,0,1,0
2,324,324,40,2,38,2,1
16,328,328,12,2,10,2,1
10,347,347,8,3,5,2,1
25,349,349,5,5,0,1,0
8,380,380,32,2,30,3,2
5,426,426,44,44,0,1,0
23,431,431,25,25,0,1,0
14,464,464,41,13,28,3,2
24,479,479,146,32,114,4,3
20,484,484,17,17,0,1,0
0,492,492,167,164,3,2,1

13,103,103,5,5,0,1,0
26,118,118,10,2,8,3,2
15,122,122,1,1,0,1,0
7,132,132,43,33,10,2,1
1,157,157,9,4,5,2,1
23,157,157,2,2,0,1,0
27,177,177,38,5,33,4,3
4,199,199,38,38,0,1,0
24,202,202,52,11,41,2,1
34,204,204,26,26,0,1,0
9,210,210,10,10,0,1,0
21,230,230,31,31,0,1,0
6,273,273,9,9,0,1,0
14,275,275,15,15,0,1,0
5,280,280,21,6,15,2,1
25,282,282,13,13,0,1,0
35,291,291,20,1,19,3,2
10,307,307,79,79,0,1,0
19,318,318,3,3,0,1,0
33,324,324,9,9,0,1,0
20,330,330,10,10,0,1,0
12,333,333,74,70,4,2,1
30,333,333,17,9,8,3,2
28,351,351,47,47,0,1,0
22,356,356,64,64,0,1,0
17,366,366,23,10,13,2,1
8,380,380,17,17,0,1,0
31,388,388,74,74,0,1,0
16,395,395,19,6,13,2,1
18,400,400,5,2,3,2,1
3,417,417,36,36,0,1,0
2,460,460,7,7,0,1,0
29,475,475,55,55,0,1,0
32,477,477,23,3,20,2,1
11,486,486,46,21,25,2,1
0,499,499,8,8,0,1,0

3,145,145,8,8,0,1,0
20,182,182,13,1,12,4,3
19,198,198,27,27,0,1,0
10,201,201,117,103,14,2,1
12,208,208,24,1,23,2,1
27,211,211,7,7,0,1,0
6,233,233,37,37,0,1,0
17,233,233,40,32,8,3,2
32,235,235,32,32,0,1,0
9,237,237,26,21,5,2,1
0,251,251,19,19,0,1,0
2,262,262,4,1,3,2,1
25,269,269,9,9,0,1,0
5,299,299,29,1,28,3,2
15,299,299,7,7,0,1,0
1,316,316,12,12,0,1,0
28,321,321,34,34,0,1,0
8,328,328,4,4,0,1,0
11,335,335,64,16,48,3,2
22,343,343,73,73,0,1,0
13,356,356,3,3,0,1,0
24,368,368,33,33,0,1,0
23,388,388,5,5,0,1,0
21,393,393,27,27,0,1,0
30,396,396,92,14,78,4,3
31,401,401,43,43,0,1,0
29,402,402,33,18,15,4,3
16,409,409,20,20,0,1,0
4,427,427,64,40,24,4,3
7,437,437,1,1,0,1,0
14,469,469,31,1,30,2,1
18,472,472,78,78,0,1,0
26,482,482,9,9,0,1,0

23,103,103,11,11,0,1,0
29,116,116,1,1,0,1,0
0,126,126,2,2,0,1,0
7,149,149,35,27,8,3,2
31,174,174,20,20,0,1,0
16,179,179,15,15,0,1,0
15,190,190,8,8,0,1,0
21,197,197,34,7,27,2,1
13,203,203,7,4,3,2,1
20,206,206,34,34,0,1,0
12,213,213,39,39,0,1,0
1,230,230,35,4,31,2,1
14,270,270,5,5,0,1,0
30,280,280,2,2,0,1,0
26,294,294,79,68,11,2,1
17,301,301,30,6,24,2,1
8,311,311,48,48,0,1,0
5,322,322,36,36,0,1,0
27,328,328,13,1,12,4,3
3,330,330,32,1,31,2,1
18,369,369,26,26,0,1,0
25,371,371,46,46,0,1,0
19,381,381,11,3,8,3,2
24,404,404,23,23,0,1,0
28,417,417,113,14,99,4,3
4,420,420,9,9,0,1,0
6,423,423,122,50,72,4,3
9,433,433,16,4,12,2,1
10,435,435,123,17,106,4,3
11,449,449,5,5,0,1,0
2,452,452,26,26,0,1,0
22,474,474,35,35,0,1,0

15,105,105,18,18,0,1,0
26,108,108,13,13,0,1,0
27,126,126,20,17,3,2,1
7,127,127,5,5,0,1,0
8,131,131,2,2,0,1,0
12,145,145,3,3,0,1,0
32,154,154,3,3,0,1,0
0,163,163,14,14,0,1,0
11,170,170,9,9,0,1,0
14,185,185,2,2,0,1,0
3,188,188,16,16,0,1,0
21,188,188,104,95,9,4,3
28,190,190,7,7,0,1,0
13,207,207,15,15,0,1,0
20,208,208,7,7,0,1,0
18,209,209,51,51,0,1,0
6,215,215,92,82,10,3,2
25,218,218,9,5,4,2,1
1,258,258,56,56,0,1,0
10,273,273,35,5,30,3,2
17,295,295,20,20,0,1,0
4,296,296,18,18,0,1,0
19,315,315,23,23,0,1,0
24,328,328,14,2,12,3,2
16,335,335,28,22,6,2,1
9,370,370,9,9,0,1,0
29,383,383,24,7,17,2,1
5,390,390,11,11,0,1,0
2,403,403,71,31,40,2,1
33,417,417,49,8,41,4,3
22,447,447,23,11,12,3,2
30,473,473,8,2,6,3,2
23,477,477,18,4,14,2,1
31,495,495,27,27,0,1,0

20,107,107,6,6,0,1,0
22,112,112,17,9,8,3,2
12,141,141,3,3,0,1,0
2,145,145,14,4,10,2,1
11,151,151,28,28,0,1,0
29,153,153,19,19,0,1,0
7,160,160,36,25,11,2,1
31,160,160,30,30,0,1,0
25,169,169,5,5,0,1,0
26,171,171,41,21,20,2,1
17,174,174,19,10,9,2,1
28,181,181,22,13,9,3,2
3,206,206,16,16,0,1,0
13,213,213,5,5,0,1,0
4,215,215,29,11,18,4,3
32,218,218,19,2,17,2,1
27,252,252,19,1,18,3,2
5,260,260,19,7,12,4,3
30,264,264,18,18,0,1,0
0,289,289,53,53,0,1,0
14,295,295,50,4,46,3,2
15,352,352,36,19,17,2,1
16,358,358,77,74,3,2,1
18,362,362,11,1,10,3,2
19,370,370,20,20,0,1,0
10,425,425,46,46,0,1,0
23,432,432,15,5,10,3,2
8,456,456,94,46,48,4,3
6,457,457,13,1,12,4,3
9,466,466,15,15,0,1,0
21,477,477,38,38,0,1,0
1,489,489,17,2,15,2,1
24,499,499,42,19,23,2,1

2,118,118,16,10,6,2,1
34,125,125,20,20,0,1,0
8,143,143,23,23,0,1,0
9,146,146,11,2,9,2,1
29,151,151,11,11,0,1,0
23,160,160,10,4,6,3,2
24,176,176,1,1,0,1,0
5,185,185,6,6,0,1,0
0,199,199,22,17,5,2,1
27,230,230,7,7,0,1,0
28,248,248,7,7,0,1,0
6,260,260,53,9,44,3,2
1,281,281,44,35,9,4,3
12,290,290,108,21,87,4,3
22,296,296,33,9,24,3,2
10,300,300,8,8,0,1,0
3,304,304,10,10,0,1,0
4,307,307,7,7,0,1,0
21,307,307,19,19,0,1,0
13,308,308,1,1,0,1,0
33,311,311,123,105,18,3,2
15,314,314,37,6,31,2,1
11,331,331,9,9,0,1,0
17,336,336,14,14,0,1,0
25,351,351,18,14,4,2,1
31,356,356,6,1,5,2,1
26,369,369,6,1,5,2,1
7,400,400,21,21,0,1,0
32,405,405,2,2,0,1,0
19,409,409,133,133,0,1,0
16,417,417,19,1,18,3,2
20,423,423,70,28,42,3,2
18,475,475,70,70,0,1,0
30,484,484,39,36,3,2,1
14,487,487,40,40,0,1,0

16,109,109,11,11,0,1,0
22,110,110,10,4,6,3,2
25,112,112,20,20,0,1,0
31,124,124,47,47,0,1,0
17,124,124,3,3,0,1,0
4,126,126,1,1,0,1,0
19,131,131,6,6,0,1,0
26,155,155,25,25,0,1,0
14,156,156,33,21,12,3,2
7,168,168,16,7,9,4,3
20,170,170,16,16,0,1,0
27,181,181,3,3,0,1,0
15,221,221,27,18,9,4,3
28,229,229,7,7,0,1,0
5,243,243,6,6,0,1,0
13,254,254,140,87,53,4,3
12,259,259,2,2,0,1,0
29,269,269,1,1,0,1,0
24,283,283,24,24,0,1,0
2,290,290,6,6,0,1,0
30,309,309,14,3,11,4,3
23,317,317,3,3,0,1,0
8,340,340,11,11,0,1,0
0,358,358,54,13,41,2,1
11,361,361,68,26,42,4,3
18,370,370,118,20,98,4,3
1,382,382,8,8,0,1,0
3,395,395,71,71,0,1,0
6,403,403,9,9,0,1,0
21,434,434,16,16,0,1,0
9,465,465,65,3,62,3,2
10,486,486,25,4,21,2,1

20,106,106,25,1,24,2,1
14,112,112,24,8,16,3,2
29,125,125,30,30,0,1,0
23,138,138,17,17,0,1,0
21,166,166,13,13,0,1,0
13,170,170,5,2,3,2,1
27,175,175,4,4,0,1,0
24,188,188,6,1,5,2,1
11,188,188,3,3,0,1,0
30,205,205,9,9,0,1,0
31,208,208,6,6,0,1,0
9,209,209,20,7,13,2,1
8,218,218,3,3,0,1,0
10,251,251,2,2,0,1,0
15,251,251,23,23,0,1,0
18,290,290,2,2,0,1,0
28,307,307,34,24,10,3,2
3,317,317,100,52,48,3,2
2,322,322,11,2,9,3,2
32,329,329,5,5,0,1,0
22,333,333,68,28,40,2,1
25,334,334,53,53,0,1,0
1,351,351,44,36,8,2,1
26,370,370,45,45,0,1,0
12,378,378,69,69,0,1,0
6,397,397,12,3,9,4,3
33,419,419,5,5,0,1,0
7,422,422,21,21,0,1,0
4,431,431,62,15,47,2,1
19,449,449,49,16,33,4,3
17,475,475,92,92,0,1,0
0,481,481,36,6,30,3,2
5,492,492,92,85,7,2,1
16,499,499,44,17,27,4,3

1,112,112,3,3,0,1,0
38,123,123,13,13,0,1,0
14,134,134,7,4,3,2,1
7,136,136,4,4,0,1,0
4,149,149,14,14,0,1,0
16,154,154,24,12,12,2,1
17,159,159,5,5,0,1,0
8,167,167,67,67,0,1,0
20,168,168,22,12,10,2,1
3,184,184,22,22,0,1,0
0,194,194,5,5,0,1,0
25,201,201,7,7,0,1,0
35,204,204,3,3,0,1,0
31,205,205,5,5,0,1,0
10,230,230,26,1,25,3,2
27,240,240,24,24,0,1,0
30,251,251,57,21,36,3,2
2,289,289,12,12,0,1,0
21,294,294,18,4,14,4,3
23,310,310,14,14,0,1,0
13,319,319,7,7,0,1,0
5,381,381,7,7,0,1,0
19,383,383,8,4,4,2,1
32,391,391,42,42,0,1,0
33,396,396,63,39,24,3,2
29,397,397,6,3,3,2,1
12,405,405,16,16,0,1,0
9,412,412,38,22,16,2,1
37,415,415,124,110,14,2,1
15,434,434,22,22,0,1,0
18,453,453,7,4,3,2,1
36,458,458,20,20,0,1,0
11,458,458,22,22,0,1,0
26,461,461,141,141,0,1,0
28,464,464,46,46,0,1,0
24,477,477,47,13,34,2,1
34,483,483,3,3,0,1,0
22,483,483,26,26,0,1,0
6,487,487,55,55,0,1,0

23,108,108,15,15,0,1,0
10,108,108,1,1,0,1,0
27,109,109,20,1,19,4,3
28,113,113,16,4,12,2,1
5,118,118,6,2,4,2,1
22,120,120,2,2,0,1,0
24,139,139,1,1,0,1,0
15,152,152,38,8,30,3,2
26,165,165,15,3,12,3,2
14,182,182,8,8,0,1,0
11,223,223,33,33,0,1,0
12,240,240,14,14,0,1,0
0,249,249,29,13,16,3,2
2,252,252,155,109,46,2,1
7,264,264,4,4,0,1,0
8,288,288,13,13,0,1,0
1,325,325,49,49,0,1,0
25,338,338,10,10,0,1,0
21,345,345,6,6,0,1,0
19,375,375,73,64,9,2,1
20,379,379,79,73,6,3,2
16,387,387,62,62,0,1,0
18,391,391,40,32,8,3,2
6,414,414,91,19,72,4,3
3,414,414,4,4,0,1,0
4,442,442,7,7,0,1,0
13,443,443,5,5,0,1,0
9,477,477,147,114,33,4,3
17,480,480,39,39,0,1,0

13,109,109,14,14,0,1,0
9,112,112,42,42,0,1,0
33,112,112,3,3,0,1,0
34,114,114,25,25,0,1,0
37,129,129,6,6,0,1,0
5,185,185,1,1,0,1,0
0,191,191,30,30,0,1,0
18,194,194,16,7,9,4,3
24,194,194,9,9,0,1,0
28,210,210,64,34,30,4,3
22,211,211,45,45,0,1,0
15,214,214,8,8,0,1,0
20,219,219,16,6,10,2,1
6,226,226,13,13,0,1,0
30,229,229,10,10,0,1,0
12,244,244,31,15,16,3,2
2,252,252,7,7,0,1,0
8,252,252,15,15,0,1,0
29,276,276,61,33,28,3,2
31,282,282,3,3,0,1,0
10,282,282,29,29,0,1,0
7,297,297,45,45,0,1,0
23,304,304,22,6,16,2,1
3,308,308,11,2,9,4,3
1,338,338,2,2,0,1,0
27,363,363,17,2,15,3,2
21,369,369,2,2,0,1,0
35,384,384,4,4,0,1,0
17,393,393,29,29,0,1,0
25,393,393,23,23,0,1,0
11,420,420,12,12,0,1,0
36,432,432,28,24,4,2,1
14,433,433,1,1,0,1,0
26,434,434,134,134,0,1,0
4,444,444,50,50,0,1,0
32,453,453,15,15,0,1,0
19,454,454,9,9,0,1,0
16,487,487,18,8,10,3,2

16,112,112,8,8,0,1,0
21,121,121,11,11,0,1,0
19,135,135,10,10,0,1,0
18,143,143,22,22,0,1,0
10,161,161,10,10,0,1,0
17,188,188,5,2,3,2,1
30,203,203,41,9,32,2,1
32,204,204,17,17,0,1,0
28,204,204,38,38,0,1,0
23,213,213,64,64,0,1,0
27,219,219,37,37,0,1,0
25,228,228,13,3,10,3,2
14,236,236,31,31,0,1,0
20,238,238,13,13,0,1,0
3,241,241,23,23,0,1,0
12,245,245,35,9,26,2,1
29,299,299,26,26,0,1,0
9,309,309,1,1,0,1,0
13,322,322,1,1,0,1,0
15,336,336,1,1,0,1,0
11,376,376,121,121,0,1,0
5,397,397,62,62,0,1,0
31,399,399,9,9,0,1,0
26,400,400,10,10,0,1,0
22,418,418,54,54,0,1,0
0,422,422,89,89,0,1,0
7,429,429,5,5,0,1,0
6,455,455,125,125,0,1,0
24,467,467,5,5,0,1,0
8,476,476,66,66,0,1,0
2,488,488,28,12,16,3,2
1,496,496,4,1,3,2,1
4,499,499,40,40,0,1,0

6,120,120,10,10,0,1,0
28,121,121,2,2,0,1,0
25,180,180,58,58,0,1,0
8,182,182,5,5,0,1,0
21,182,182,47,19,28,2,1
9,186,186,1,1,0,1,0
19,192,192,2,2,0,1,0
3,195,195,14,14,0,1,0
31,202,202,8,1,7,3,2
24,214,214,22,22,0,1,0
2,224,224,2,2,0,1,0
27,266,266,16,11,5,2,1
18,270,270,70,65,5,2,1
7,287,287,50,50,0,1,0
17,287,287,3,3,0,1,0
13,292,292,10,10,0,1,0
22,294,294,4,4,0,1,0
14,295,295,31,3,28,4,3
15,315,315,15,5,10,3,2
5,321,321,6,1,5,2,1
0,335,335,111,67,44,3,2
16,350,350,7,2,5,2,1
26,370,370,4,1,3,2,1
29,382,382,23,23,0,1,0
10,389,389,1,1,0,1,0
20,403,403,70,70,0,1,0
1,410,410,101,35,66,3,2
4,415,415,186,51,135,4,3
11,433,433,29,11,18,4,3
12,449,449,35,35,0,1,0
23,455,455,7,7,0,1,0
30,494,494,153,95,58,3,2

17,115,115,33,33,0,1,0
4,129,129,18,18,0,1,0
19,131,131,1,1,0,1,0
0,152,152,1,1,0,1,0
10,184,184,31,15,16,4,3
15,202,202,13,6,7,2,1
18,204,204,15,15,0,1,0
23,205,205,9,9,0,1,0
28,208,208,29,5,24,4,3
31,213,213,11,11,0,1,0
24,217,217,12,12,0,1,0
1,228,228,19,19,0,1,0
14,240,240,18,18,0,1,0
13,242,242,65,57,8,2,1
6,243,243,30,30,0,1,0
7,258,258,6,2,4,2,1
27,264,264,45,45,0,1,0
34,295,295,61,21,40,3,2
9,297,297,74,74,0,1,0
26,300,300,22,16,6,3,2
29,334,334,30,30,0,1,0
3,375,375,16,16,0,1,0
32,377,377,18,4,14,3,2
12,395,395,9,1,8,3,2
33,395,395,220,184,36,3,2
21,418,418,47,47,0,1,0
5,424,424,10,10,0,1,0
25,432,432,5,5,0,1,0
22,439,439,23,23,0,1,0
16,443,443,22,12,10,2,1
11,462,462,6,2,4,2,1
20,463,463,17,3,14,2,1
2,484,484,15,15,0,1,0
30,492,492,1,1,0,1,0
8,498,498,18,2,16,2,1

17,132,132,8,5,3,2,1
9,134,134,15,4,11,2,1
7,145,145,1,1,0,1,0
11,156,156,38,17,21,2,1
13,162,162,2,2,0,1,0
24,185,185,12,12,0,1,0
20,196,196,7,1,6,2,1
12,222,222,1,1,0,1,0
29,222,222,10,4,6,3,2
3,236,236,10,10,0,1,0
19,257,257,16,16,0,1,0
2,284,284,8,8,0,1,0
23,290,290,24,24,0,1,0
16,293,293,37,37,0,1,0
14,305,305,74,35,39,4,3
18,320,320,29,29,0,1,0
31,323,323,2,2,0,1,0
1,342,342,23,23,0,1,0
27,344,344,117,117,0,1,0
21,347,347,32,24,8,2,1
22,365,365,19,7,12,4,3
0,375,375,39,39,0,1,0
25,385,385,76,32,44,3,2
15,433,433,12,12,0,1,0
33,435,435,66,43,23,2,1
28,448,448,3,3,0,1,0
5,457,457,71,61,10,3,2
8,474,474,37,2,35,2,1
4,474,474,10,6,4,2,1
30,484,484,54,54,0,1,0
10,489,489,136,50,86,3,2
6,490,490,75,75,0,1,0
26,495,495,67,40,27,2,1
32,497,497,98,65,33,4,3

9,147,147,19,19,0,1,0
0,153,153,12,9,3,2,1
1,164,164,4,4,0,1,0
24,180,180,6,6,0,1,0
8,189,189,44,8,36,4,3
2,198,198,1,1,0,1,0
18,205,205,39,23,16,3,2
3,211,211,21,9,12,4,3
19,220,220,11,11,0,1,0
23,229,229,2,2,0,1,0
20,239,239,34,6,28,3,2
26,250,250,33,33,0,1,0
4,288,288,1,1,0,1,0
14,292,292,22,1,21,4,3
5,293,293,33,33,0,1,0
17,294,294,20,11,9,2,1
13,304,304,77,69,8,2,1
27,304,304,19,19,0,1,0
22,312,312,8,8,0,1,0
30,320,320,22,1,21,2,1
11,321,321,47,47,0,1,0
7,336,336,29,10,19,4,3
6,366,366,15,15,0,1,0
10,370,370,66,29,37,2,1
16,371,371,57,11,46,3,2
12,412,412,24,18,6,2,1
15,417,417,74,33,41,2,1
25,424,424,37,37,0,1,0
21,442,442,80,80,0,1,0
32,454,454,110,61,49,4,3
28,460,460,32,32,0,1,0
29,466,466,28,10,18,4,3
31,480,480,75,75,0,1,0

31,102,102,6,6,0,1,0
15,120,120,17,5,12,4,3
18,126,126,14,14,0,1,0
23,133,133,6,6,0,1,0
7,160,160,25,16,9,4,3
29,162,162,6,6,0,1,0
8,188,188,27,1,26,3,2
4,190,190,2,2,0,1,0
20,227,227,13,13,0,1,0
5,247,247,1,1,0,1,0
26,305,305,31,27,4,2,1
25,331,331,26,10,16,2,1
9,340,340,52,52,0,1,0
11,344,344,140,74,66,3,2
3,348,348,7,7,0,1,0
1,353,353,1,1,0,1,0
30,360,360,13,13,0,1,0
28,376,376,83,83,0,1,0
27,379,379,6,6,0,1,0
10,404,404,123,123,0,1,0
21,421,421,83,83,0,1,0
19,433,433,86,64,22,2,1
14,435,435,1,1,0,1,0
24,438,438,91,65,26,2,1
0,451,451,3,3,0,1,0
16,465,465,46,46,0,1,0
6,470,470,108,108,0,1,0
2,474,474,41,24,17,4,3
22,482,482,2,2,0,1,0
17,482,482,60,5,55,4,3
12,482,482,63,63,0,1,0
13,496,496,22,22,0,1,0

48,100,100,21,21,0,1,0
42,107,107,12,12,0,1,0
36,114,114,15,15,0,1,0
27,139,139,5,5,0,1,0
22,141,141,2,2,0,1,0
33,143,143,22,4,18,4,3
12,150,150,4,4,0,1,0
19,161,161,7,1,6,2,1
45,165,165,2,2,0,1,0
35,173,173,13,13,0,1,0
37,185,185,13,4,9,3,2
7,193,193,32,32,0,1,0
5,212,212,2,2,0,1,0
43,214,214,22,22,0,1,0
38,225,225,17,17,0,1,0
3,227,227,11,1,10,3,2
39,232,232,3,3,0,1,0
40,232,232,24,24,0,1,0
24,239,239,11,11,0,1,0
28,242,242,4,4,0,1,0
9,243,243,7,7,0,1,0
6,244,244,18,10,8,2,1
41,261,261,89,31,58,4,3
20,274,274,33,15,18,4,3
31,283,283,13,13,0,1,0
15,285,285,16,16,0,1,0
47,310,310,44,44,0,1,0
21,317,317,50,50,0,1,0
25,330,330,49,7,42,2,1
46,349,349,53,21,32,4,3
11,349,349,21,18,3,2,1
34,362,362,9,9,0,1,0
17,370,370,12,12,0,1,0
16,372,372,17,17,0,1,0
44,378,378,11,11,0,1,0
14,392,392,25,25,0,1,0
8,396,396,6,1,5,2,1
13,397,397,10,7,3,2,1
32,405,405,26,10,16,3,2
4,410,410,27,21,6,2,1
29,423,423,32,3,29,2,1
2,432,432,6,3,3,2,1
18,437,437,30,30,0,1,0
49,447,447,1,1,0,1,0
23,449,449,9,4,5,2,1
1,452,452,40,18,22,3,2
30,452,452,2,2,0,1,0
0,470,470,1,1,0,1,0
10,478,478,3,3,0,1,0
26,485,485,6,1,5,2,1

23,116,116,7,7,0,1,0
17,145,145,1,1,0,1,0
4,154,154,21,12,9,2,1
22,180,180,13,13,0,1,0
19,184,184,9,9,0,1,0
29,205,205,20,8,12,4,3
9,226,226,3,3,0,1,0
12,227,227,16,8,8,3,2
3,229,229,8,8,0,1,0
11,231,231,5,5,0,1,0
16,250,250,14,14,0,1,0
28,270,270,49,4,45,4,3
15,277,277,22,14,8,3,2
5,302,302,102,102,0,1,0
18,333,333,105,9,96,3,2
2,335,335,67,50,17,2,1
8,373,373,9,9,0,1,0
25,381,381,20,3,17,2,1
27,385,385,25,25,0,1,0
14,405,405,38,17,21,2,1
1,405,405,3,3,0,1,0
26,406,406,79,34,45,4,3
6,410,410,159,159,0,1,0
0,415,415,69,16,53,4,3
20,452,452,38,26,12,4,3
7,457,457,87,62,25,2,1
10,473,473,53,9,44,3,2
21,475,475,111,111,0,1,0
24,482,482,16,13,3,2,1
13,483,483,28,12,16,3,2

30,111,111,5,1,4,2,1
3,117,117,1,1,0,1,0
38,140,140,38,38,0,1,0
37,145,145,4,4,0,1,0
23,166,166,2,2,0,1,0
18,167,167,4,4,0,1,0
25,169,169,11,11,0,1,0
34,170,170,14,6,8,3,2
17,171,171,13,7,6,3,2
0,183,183,13,4,9,4,3
32,189,189,29,11,18,2,1
26,195,195,13,13,0,1,0
7,206,206,10,10,0,1,0
15,208,208,19,4,15,4,3
19,209,209,4,4,0,1,0
35,210,210,4,4,0,1,0
14,262,262,24,24,0,1,0
36,267,267,35,29,6,2,1
20,270,270,27,7,20,2,1
24,296,296,92,56,36,4,3
16,308,308,37,37,0,1,0
33,323,323,10,10,0,1,0
2,324,324,33,5,28,4,3
22,327,327,7,4,3,2,1
21,337,337,6,6,0,1,0
1,343,343,11,11,0,1,0
28,364,364,20,20,0,1,0
8,391,391,52,40,12,2,1
29,397,397,107,15,92,3,2
9,402,402,13,13,0,1,0
5,421,421,15,15,0,1,0
12,423,423,130,130,0,1,0
13,430,430,29,11,18,3,2
31,431,431,1,1,0,1,0
4,431,431,9,9,0,1,0
6,433,433,1,1,0,1,0
27,461,461,84,31,53,3,2
10,471,471,46,32,14,3,2
11,498,498,101,73,28,4,3

12,121,121,14,14,0,1,0
29,133,133,49,22,27,4,3
31,165,165,3,3,0,1,0
7,167,167,15,15,0,1,0
25,173,173,16,2,14,3,2
3,179,179,41,11,30,2,1
4,187,187,10,4,6,2,1
41,188,188,21,21,0,1,0
16,198,198,10,10,0,1,0
40,207,207,36,14,22,2,1
22,220,220,3,3,0,1,0
0,224,224,6,6,0,1,0
20,227,227,36,24,12,2,1
19,228,228,17,5,12,3,2
37,234,234,38,38,0,1,0
35,237,237,1,1,0,1,0
15,246,246,10,10,0,1,0
28,266,266,14,5,9,2,1
23,286,286,28,28,0,1,0
33,311,311,19,4,15,2,1
13,312,312,10,1,9,4,3
38,316,316,28,4,24,3,2
8,327,327,40,40,0,1,0
27,331,331,34,10,24,4,3
14,334,334,49,49,0,1,0
11,340,340,3,3,0,1,0
34,344,344,96,51,45,4,3
2,347,347,1,1,0,1,0
26,357,357,11,2,9,4,3
17,369,369,1,1,0,1,0
21,381,381,27,24,3,2,1
6,397,397,11,2,9,4,3
9,405,405,47,47,0,1,0
30,408,408,2,2,0,1,0
18,423,423,37,37,0,1,0
24,434,434,33,3,30,2,1
5,437,437,3,3,0,1,0
10,446,446,4,4,0,1,0
39,447,447,25,25,0,1,0
36,449,449,11,11,0,1,0
1,499,499,21,13,8,3,2
32,499,499,54,29,25,2,1

1,104,104,26,26,0,1,0
9,119,119,69,69,0,1,0
10,132,132,6,2,4,2,1
5,168,168,34,34,0,1,0
20,173,173,18,18,0,1,0
13,177,177,5,5,0,1,0
24,232,232,32,32,0,1,0
3,269,269,1,1,0,1,0
25,305,305,11,11,0,1,0
17,333,333,3,3,0,1,0
16,346,346,26,4,22,3,2
4,352,352,23,23,0,1,0
7,357,357,58,42,16,3,2
14,361,361,40,40,0,1,0
18,370,370,38,35,3,2,1
26,377,377,161,101,60,3,2
11,378,378,31,31,0,1,0
15,389,389,27,27,0,1,0
0,393,393,36,36,0,1,0
22,395,395,55,55,0,1,0
12,398,398,5,1,4,2,1
2,428,428,1,1,0,1,0
23,429,429,8,8,0,1,0
21,445,445,84,84,0,1,0
8,447,447,26,26,0,1,0
19,466,466,67,67,0,1,0
6,489,489,143,131,12,2,1

6,115,115,23,5,18,2,1
15,117,117,19,19,0,1,0
23,123,123,6,2,4,2,1
22,135,135,6,6,0,1,0
16,136,136,20,20,0,1,0
3,142,142,2,2,0,1,0
25,151,151,1,1,0,1,0
27,167,167,10,10,0,1,0
30,180,180,5,1,4,2,1
1,190,190,82,32,50,2,1
13,200,200,1,1,0,1,0
5,218,218,3,3,0,1,0
12,237,237,9,9,0,1,0
9,250,250,5,5,0,1,0
4,265,265,4,4,0,1,0
10,302,302,58,31,27,4,3
11,319,319,16,7,9,2,1
33,325,325,51,16,35,2,1
19,331,331,79,71,8,3,2
21,331,331,62,2,60,3,2
14,349,349,36,36,0,1,0
17,354,354,8,8,0,1,0
26,361,361,30,30,0,1,0
24,363,363,117,109,8,2,1
7,381,381,54,21,33,2,1
20,404,404,39,9,30,2,1
28,406,406,66,1,65,4,3
0,412,412,36,36,0,1,0
8,418,418,27,27,0,1,0
32,418,418,36,2,34,3,2
29,430,430,2,2,0,1,0
31,433,433,65,33,32,3,2
18,437,437,16,16,0,1,0
2,472,472,10,10,0,1,0

22,125,125,20,2,18,4,3
8,134,134,3,3,0,1,0
24,138,138,19,5,14,4,3
33,150,150,32,32,0,1,0
26,156,156,4,1,3,2,1
25,169,169,1,1,0,1,0
10,173,173,7,7,0,1,0
15,195,195,38,38,0,1,0
2,200,200,43,22,21,2,1
27,222,222,31,31,0,1,0
29,264,264,46,28,18,2,1
19,282,282,30,30,0,1,0
14,285,285,2,2,0,1,0
17,288,288,60,60,0,1,0
21,304,304,42,30,12,4,3
5,311,311,16,8,8,2,1
11,318,318,56,48,8,2,1
32,319,319,1,1,0,1,0
7,342,342,6,6,0,1,0
4,350,350,6,6,0,1,0
12,350,350,15,15,0,1,0
9,359,359,4,4,0,1,0
6,359,359,89,33,56,3,2
23,363,363,4,4,0,1,0
0,374,374,12,12,0,1,0
30,376,376,82,16,66,4,3
16,386,386,43,43,0,1,0
31,388,388,4,4,0,1,0
3,393,393,36,15,21,4,3
20,395,395,15,2,13,2,1
1,396,396,84,84,0,1,0
18,433,433,32,18,14,2,1
13,468,468,98,51,47,2,1
28,487,487,34,3,31,2,1

1,100,100,8,8,0,1,0
13,116,116,17,6,11,2,1
9,116,116,1,1,0,1,0
15,118,118,8,8,0,1,0
28,118,118,9,4,5,2,1
37,122,122,1,1,0,1,0
36,123,123,4,4,0,1,0
34,145,145,5,5,0,1,0
35,154,154,21,21,0,1,0
43,155,155,3,3,0,1,0
30,155,155,26,26,0,1,0
24,170,170,3,3,0,1,0
10,182,182,45,19,26,4,3
21,190,190,31,23,8,2,1
19,199,199,11,2,9,2,1
41,200,200,14,14,0,1,0
7,200,200,25,4,21,4,3
31,201,201,59,47,12,4,3
6,206,206,7,7,0,1,0
18,218,218,2,2,0,1,0
25,235,235,9,3,6,2,1
3,240,240,5,1,4,2,1
8,244,244,20,20,0,1,0
2,249,249,10,5,5,2,1
27,263,263,54,39,15,2,1
26,297,297,13,13,0,1,0
12,314,314,9,9,0,1,0
11,315,315,14,7,7,2,1
22,333,333,30,6,24,2,1
40,333,333,28,28,0,1,0
16,351,351,15,1,14,3,2
14,353,353,9,1,8,3,2
0,367,367,30,13,17,2,1
20,375,375,1,1,0,1,0
38,377,377,27,27,0,1,0
42,389,389,17,1,16,4,3
32,408,408,88,13,75,4,3
29,419,419,42,42,0,1,0
4,425,425,18,6,12,4,3
5,429,429,54,26,28,3,2
17,432,432,9,3,6,2,1
33,453,453,14,14,0,1,0
39,456,456,73,73,0,1,0
23,499,499,8,8,0,1,0

6,112,112,6,6,0,1,0
16,144,144,13,8,5,2,1
10,163,163,6,2,4,2,1
2,211,211,32,32,0,1,0
21,244,244,10,10,0,1,0
13,273,273,1,1,0,1,0
20,283,283,22,22,0,1,0
4,303,303,76,62,14,4,3
26,315,315,17,17,0,1,0
1,319,319,197,133,64,4,3
15,320,320,48,48,0,1,0
27,338,338,4,4,0,1,0
8,355,355,4,4,0,1,0
14,356,356,42,12,30,3,2
25,380,380,26,8,18,3,2
12,387,387,65,65,0,1,0
30,395,395,70,12,58,3,2
7,412,412,32,32,0,1,0
11,427,427,11,5,6,3,2
5,436,436,41,1,40,2,1
28,437,437,53,20,33,2,1
29,443,443,35,35,0,1,0
0,446,446,21,21,0,1,0
3,451,451,38,23,15,2,1
18,452,452,106,65,41,2,1
17,454,454,44,44,0,1,0
19,457,457,11,11,0,1,0
22,476,476,11,5,6,3,2
9,480,480,39,20,19,2,1
24,490,490,18,6,12,3,2
23,497,497,162,162,0,1,0

13,109,109,41,6,35,2,1
22,112,112,20,5,15,2,1
2,113,113,3,3,0,1,0
15,125,125,16,16,0,1,0
7,128,128,1,1,0,1,0
19,129,129,3,3,0,1,0
17,134,134,3,3,0,1,0
1,189,189,9,9,0,1,0
18,193,193,23,23,0,1,0
3,194,194,45,9,36,4,3
4,199,199,9,5,4,2,1
6,206,206,5,5,0,1,0
30,217,217,43,43,0,1,0
21,237,237,17,17,0,1,0
5,269,269,79,79,0,1,0
24,279,279,4,4,0,1,0
12,287,287,26,26,0,1,0
28,297,297,9,9,0,1,0
8,300,300,97,77,20,2,1
10,370,370,11,11,0,1,0
23,372,372,77,77,0,1,0
27,380,380,19,19,0,1,0
14,384,384,40,10,30,3,2
16,389,389,62,20,42,4,3
26,402,402,43,43,0,1,0
0,433,433,26,26,0,1,0
25,464,464,50,11,39,4,3
11,465,465,18,2,16,2,1
9,469,469,1,1,0,1,0
29,474,474,100,38,62,3,2
20,494,494,45,14,31,4,3
31,500,500,10,10,0,1,0

30,100,100,17,11,6,2,1
17,105,105,21,9,12,2,1
23,127,127,1,1,0,1,0
41,138,138,13,2,11,2,1
35,151,151,4,4,0,1,0
29,154,154,15,15,0,1,0
2,172,172,1,1,0,1,0
9,186,186,12,2,10,3,2
20,194,194,20,20,0,1,0
34,201,201,16,8,8,3,2
13,218,218,3,3,0,1,0
26,221,221,2,2,0,1,0
21,229,229,21,11,10,3,2
14,234,234,6,2,4,2,1
33,241,241,94,89,5,2,1
27,261,261,1,1,0,1,0
32,263,263,76,19,57,4,3
0,265,265,34,16,18,3,2
6,265,265,6,6,0,1,0
19,287,287,1,1,0,1,0
3,287,287,9,9,0,1,0
36,295,295,19,19,0,1,0
4,295,295,29,7,22,4,3
12,296,296,5,5,0,1,0
31,304,304,8,8,0,1,0
1,310,310,7,3,4,2,1
18,316,316,2,2,0,1,0
25,320,320,36,3,33,3,2
8,320,320,5,5,0,1,0
22,324,324,10,10,0,1,0
28,368,368,11,2,9,2,1
39,371,371,55,55,0,1,0
24,371,371,16,8,8,2,1
40,398,398,52,52,0,1,0
15,399,399,33,33,0,1,0
10,403,403,29,5,24,2,1
7,435,435,26,26,0,1,0
38,442,442,21,8,13,2,1
16,445,445,156,56,100,3,2
11,458,458,62,62,0,1,0
5,467,467,32,13,19,2,1
37,482,482,12,3,9,4,3

29,105,105,6,6,0,1,0
31,107,107,5,1,4,2,1
12,137,137,25,10,15,2,1
15,145,145,1,1,0,1,0
20,149,149,25,1,24,2,1
27,159,159,57,37,20,2,1
4,172,172,22,22,0,1,0
23,177,177,23,5,18,2,1
2,183,183,6,6,0,1,0
24,196,196,11,5,6,3,2
10,210,210,47,47,0,1,0
9,222,222,19,19,0,1,0
1,224,224,7,7,0,1,0
25,233,233,14,14,0,1,0
18,242,242,4,4,0,1,0
19,245,245,52,52,0,1,0
0,256,256,7,1,6,3,2
11,279,279,59,59,0,1,0
5,285,285,4,4,0,1,0
16,311,311,8,3,5,2,1
35,311,311,17,17,0,1,0
28,329,329,13,1,12,4,3
17,341,341,3,3,0,1,0
3,345,345,12,2,10,2,1
21,360,360,26,23,3,2,1
13,365,365,9,2,7,2,1
32,398,398,25,25,0,1,0
34,408,408,40,40,0,1,0
33,418,418,59,59,0,1,0
6,428,428,46,46,0,1,0
22,448,448,4,4,0,1,0
26,464,464,65,65,0,1,0
14,471,471,34,18,16,2,1
30,481,481,10,10,0,1,0
8,494,494,113,113,0,1,0
7,500,500,119,23,96,3,2

14,101,101,1,1,0,1,0
13,102,102,2,2,0,1,0
2,116,116,13,13,0,1,0
37,123,123,31,13,18,3,2
29,129,129,24,24,0,1,0
16,131,131,16,2,14,2,1
35,135,135,5,5,0,1,0
34,138,138,1,1,0,1,0
9,141,141,5,1,4,2,1
5,154,154,36,28,8,2,1
22,159,159,7,7,0,1,0
33,168,168,5,5,0,1,0
36,180,180,43,43,0,1,0
10,191,191,1,1,0,1,0
18,212,212,26,26,0,1,0
21,227,227,32,3,29,2,1
28,233,233,20,11,9,4,3
26,244,244,13,13,0,1,0
32,248,248,16,1,15,2,1
31,248,248,16,7,9,3,2
41,251,251,27,1,26,3,2
3,265,265,5,5,0,1,0
12,270,270,45,14,31,2,1
40,274,274,8,8,0,1,0
11,281,281,3,3,0,1,0
0,283,283,11,11,0,1,0
1,294,294,7,1,6,3,2
8,296,296,6,3,3,2,1
24,306,306,16,1,15,3,2
20,307,307,39,3,36,2,1
25,309,309,18,18,0,1,0
15,380,380,11,11,0,1,0
7,383,383,15,15,0,1,0
6,440,440,74,74,0,1,0
27,447,447,174,174,0,1,0
38,455,455,26,26,0,1,0
39,463,463,19,15,4,2,1
17,465,465,3,3,0,1,0
4,469,469,37,4,33,4,3
19,489,489,23,1,22,3,2
23,491,491,14,5,9,2,1
30,498,498,24,10,14,4,3

5,100,100,17,11,6,2,1
12,116,116,6,6,0,1,0
15,150,150,1,1,0,1,0
7,176,176,35,8,27,4,3
28,183,183,16,7,9,4,3
8,195,195,43,43,0,1,0
22,196,196,64,64,0,1,0
13,197,197,3,3,0,1,0
14,220,220,48,48,0,1,0
20,229,229,5,5,0,1,0
0,244,244,21,4,17,2,1
10,245,245,63,63,0,1,0
26,246,246,52,52,0,1,0
19,285,285,10,10,0,1,0
2,313,313,15,15,0,1,0
16,325,325,47,47,0,1,0
23,351,351,57,57,0,1,0
17,352,352,30,8,22,3,2
21,366,366,55,3,52,3,2
11,370,370,37,6,31,2,1
3,386,386,8,2,6,2,1
27,390,390,57,3,54,4,3
9,426,426,28,9,19,2,1
25,439,439,16,4,12,2,1
1,450,450,1,1,0,1,0
6,473,473,1,1,0,1,0
24,477,477,1,1,0,1,0
18,494,494,14,2,12,2,1
4,500,500,265,145,120,4,3

18,113,113,1,1,0,1,0
12,114,114,19,19,0,1,0
29,119,119,4,1,3,2,1
4,120,120,11,11,0,1,0
32,121,121,5,5,0,1,0
2,130,130,8,8,0,1,0
25,140,140,19,19,0,1,0
7,161,161,12,5,7,2,1
10,201,201,1,1,0,1,0
1,212,212,9,9,0,1,0
23,223,223,27,27,0,1,0
19,240,240,31,13,18,4,3
5,276,276,54,11,43,3,2
20,283,283,5,5,0,1,0
30,284,284,2,2,0,1,0
35,288,288,49,19,30,2,1
22,290,290,25,25,0,1,0
21,293,293,164,164,0,1,0
31,301,301,27,21,6,2,1
27,333,333,19,19,0,1,0
11,334,334,12,12,0,1,0
8,343,343,32,12,20,3,2
14,382,382,16,16,0,1,0
24,382,382,14,14,0,1,0
13,384,384,68,12,56,3,2
3,407,407,42,42,0,1,0
26,411,411,44,14,30,2,1
6,419,419,39,7,32,2,1
0,429,429,21,11,10,2,1
16,435,435,1,1,0,1,0
15,450,450,67,19,48,2,1
34,470,470,1,1,0,1,0
28,471,471,22,4,18,3,2
17,475,475,66,66,0,1,0
9,480,480,85,35,50,3,2
33,485,485,49,22,27,2,1

12,102,102,4,4,0,1,0
19,119,119,23,10,13,2,1
4,147,147,7,4,3,2,1
3,155,155,10,4,6,2,1
23,163,163,6,6,0,1,0
21,164,164,17,17,0,1,0
25,179,179,15,15,0,1,0
32,184,184,16,16,0,1,0
37,188,188,3,3,0,1,0
11,196,196,22,22,0,1,0
5,202,202,8,8,0,1,0
33,209,209,19,19,0,1,0
9,215,215,32,12,20,3,2
31,217,217,6,6,0,1,0
17,220,220,6,6,0,1,0
7,225,225,27,27,0,1,0
36,226,226,31,31,0,1,0
27,254,254,3,3,0,1,0
20,255,255,2,2,0,1,0
26,261,261,53,15,38,2,1
13,263,263,11,11,0,1,0
29,284,284,94,94,0,1,0
16,288,288,46,12,34,3,2
14,299,299,7,1,6,3,2
30,306,306,21,9,12,4,3
10,314,314,13,13,0,1,0
15,327,327,4,4,0,1,0
6,341,341,67,28,39,4,3
34,345,345,23,23,0,1,0
35,349,349,19,19,0,1,0
2,353,353,30,30,0,1,0
18,381,381,26,2,24,4,3
1,407,407,61,22,39,2,1
22,415,415,51,51,0,1,0
8,432,432,25,25,0,1,0
28,436,436,10,10,0,1,0
0,461,461,31,31,0,1,0
24,495,495,136,82,54,3,2

15,102,102,12,4,8,2,1
2,129,129,6,6,0,1,0
30,131,131,9,9,0,1,0
27,138,138,27,7,20,2,1
5,140,140,7,7,0,1,0
16,154,154,1,1,0,1,0
29,189,189,36,36,0,1,0
6,198,198,7,1,6,2,1
0,206,206,40,8,32,2,1
19,213,213,14,14,0,1,0
8,218,218,3,3,0,1,0
21,219,219,35,20,15,4,3
17,224,224,1,1,0,1,0
26,226,226,23,5,18,2,1
20,229,229,5,5,0,1,0
9,231,231,17,1,16,2,1
24,233,233,14,14,0,1,0
11,238,238,24,24,0,1,0
3,271,271,10,10,0,1,0
4,272,272,51,51,0,1,0
14,275,275,16,16,0,1,0
25,279,279,42,42,0,1,0
32,299,299,11,2,9,4,3
34,363,363,20,20,0,1,0
7,389,389,149,77,72,3,2
35,398,398,26,4,22,2,1
10,405,405,51,51,0,1,0
31,408,408,154,154,0,1,0
23,411,411,17,17,0,1,0
18,423,423,17,17,0,1,0
33,425,425,3,3,0,1,0
13,438,438,24,24,0,1,0
12,443,443,40,40,0,1,0
1,458,458,37,23,14,3,2
22,467,467,7,3,4,2,1
28,490,490,58,32,26,3,2

3,100,100,8,8,0,1,0
20,111,111,2,2,0,1,0
22,116,116,8,8,0,1,0
28,118,118,6,6,0,1,0
29,120,120,2,2,0,1,0
19,130,130,54,54,0,1,0
5,146,146,7,7,0,1,0
31,158,158,6,3,3,2,1
24,159,159,2,2,0,1,0
23,165,165,11,11,0,1,0
18,178,178,21,6,15,4,3
1,180,180,8,8,0,1,0
17,194,194,9,9,0,1,0
12,200,200,22,4,18,4,3
32,212,212,33,33,0,1,0
13,221,221,63,45,18,3,2
21,235,235,70,70,0,1,0
25,256,256,35,2,33,2,1
2,291,291,29,5,24,4,3
14,293,293,102,102,0,1,0
0,343,343,57,9,48,2,1
30,349,349,28,28,0,1,0
11,358,358,1,1,0,1,0
10,359,359,11,11,0,1,0
26,359,359,14,14,0,1,0
15,379,379,2,2,0,1,0
6,391,391,26,4,22,3,2
4,404,404,42,14,28,3,2
27,415,415,44,16,28,2,1
16,454,454,38,23,15,4,3
7,456,456,45,3,42,2,1
8,461,461,41,3,38,3,2
9,463,463,57,57,0,1,0

32,100,100,17,2,15,3,2
5,113,113,5,5,0,1,0
30,114,114,6,6,0,1,0
26,142,142,18,2,16,2,1
1,179,179,1,1,0,1,0
36,193,193,24,24,0,1,0
25,208,208,2,2,0,1,0
29,212,212,63,22,41,2,1
13,215,215,1,1,0,1,0
2,228,228,21,21,0,1,0
0,239,239,1,1,0,1,0
12,242,242,13,3,10,3,2
27,253,253,14,14,0,1,0
35,269,269,64,64,0,1,0
9,280,280,23,23,0,1,0
21,292,292,90,90,0,1,0
16,301,301,9,1,8,3,2
6,311,311,8,2,6,3,2
15,312,312,1,1,0,1,0
33,318,318,45,2,43,2,1
34,327,327,12,3,9,4,3
20,339,339,12,12,0,1,0
17,354,354,4,1,3,2,1
14,358,358,1,1,0,1,0
18,383,383,175,95,80,3,2
22,385,385,14,1,13,2,1
23,403,403,17,17,0,1,0
37,407,407,48,10,38,3,2
31,412,412,1,1,0,1,0
8,430,430,15,15,0,1,0
7,438,438,105,86,19,2,1
24,458,458,44,44,0,1,0
19,466,466,13,13,0,1,0
4,468,468,20,4,16,2,1
11,470,470,55,18,37,2,1
3,474,474,15,3,12,2,1
38,474,474,56,56,0,1,0
10,477,477,22,22,0,1,0
28,478,478,39,39,0,1,0

7,105,105,1,1,0,1,0
11,115,115,9,5,4,2,1
5,128,128,9,9,0,1,0
18,131,131,24,15,9,4,3
16,132,132,2,2,0,1,0
4,141,141,15,9,6,2,1
9,148,148,13,7,6,3,2
32,160,160,51,51,0,1,0
35,174,174,4,4,0,1,0
31,179,179,28,21,7,2,1
26,184,184,9,9,0,1,0
19,199,199,26,17,9,3,2
34,246,246,7,7,0,1,0
1,248,248,20,20,0,1,0
22,260,260,5,5,0,1,0
21,263,263,9,9,0,1,0
0,281,281,158,68,90,4,3
29,288,288,12,4,8,2,1
24,290,290,37,37,0,1,0
25,291,291,42,30,12,3,2
10,304,304,16,7,9,2,1
17,315,315,31,15,16,2,1
12,315,315,23,7,16,2,1
6,317,317,5,5,0,1,0
2,319,319,1,1,0,1,0
13,329,329,1,1,0,1,0
23,332,332,33,33,0,1,0
36,373,373,71,71,0,1,0
27,380,380,36,36,0,1,0
8,385,385,15,15,0,1,0
14,394,394,19,7,12,2,1
28,447,447,29,4,25,2,1
30,447,447,94,26,68,3,2
3,451,451,15,15,0,1,0
20,463,463,28,28,0,1,0
33,474,474,30,6,24,2,1
15,492,492,6,6,0,1,0

21,101,101,7,7,0,1,0
10,124,124,6,3,3,2,1
13,130,130,6,3,3,2,1
27,150,150,3,3,0,1,0
9,158,158,1,1,0,1,0
28,161,161,21,21,0,1,0
3,180,180,73,73,0,1,0
6,192,192,5,5,0,1,0
12,195,195,28,28,0,1,0
32,219,219,34,1,33,4,3
7,233,233,109,74,35,2,1
5,234,234,12,5,7,2,1
24,241,241,59,27,32,2,1
4,257,257,40,26,14,2,1
0,263,263,1,1,0,1,0
19,267,267,51,51,0,1,0
11,276,276,2,2,0,1,0
2,279,279,1,1,0,1,0
20,289,289,4,4,0,1,0
29,326,326,14,2,12,3,2
25,337,337,23,3,20,3,2
14,338,338,2,2,0,1,0
15,339,339,69,48,21,4,3
26,340,340,101,9,92,3,2
30,346,346,9,6,3,2,1
23,368,368,15,7,8,3,2
31,383,383,35,17,18,4,3
8,389,389,25,6,19,2,1
16,402,402,39,25,14,3,2
18,405,405,25,1,24,3,2
22,407,407,40,40,0,1,0
17,425,425,40,40,0,1,0
1,458,458,29,3,26,3,2

12,102,102,26,10,16,4,3
0,103,103,10,10,0,1,0
15,129,129,1,1,0,1,0
10,134,134,17,1,16,2,1
16,147,147,4,4,0,1,0
5,163,163,5,5,0,1,0
11,166,166,13,5,8,3,2
23,168,168,14,14,0,1,0
17,180,180,3,3,0,1,0
6,184,184,33,33,0,1,0
1,206,206,89,42,47,2,1
4,211,211,12,12,0,1,0
2,214,214,2,2,0,1,0
14,216,216,3,3,0,1,0
13,258,258,13,13,0,1,0
9,261,261,81,6,75,4,3
24,278,278,14,14,0,1,0
18,317,317,39,12,27,4,3
7,326,326,36,36,0,1,0
26,351,351,91,41,50,2,1
25,390,390,4,4,0,1,0
21,429,429,108,84,24,3,2
28,440,440,37,11,26,2,1
19,448,448,53,53,0,1,0
3,449,449,9,9,0,1,0
8,461,461,115,105,10,3,2
20,470,470,2,2,0,1,0
27,495,495,8,8,0,1,0
22,500,500,185,48,137,4,3

6,100,100,5,2,3,2,1
32,103,103,21,21,0,1,0
43,118,118,7,7,0,1,0
35,120,120,19,19,0,1,0
10,135,135,45,45,0,1,0
17,147,147,10,10,0,1,0
25,148,148,4,4,0,1,0
5,178,178,1,1,0,1,0
44,186,186,41,41,0,1,0
22,210,210,8,5,3,2,1
13,220,220,7,7,0,1,0
23,221,221,1,1,0,1,0
41,228,228,49,49,0,1,0
28,232,232,6,6,0,1,0
30,233,233,3,3,0,1,0
24,248,248,13,13,0,1,0
42,254,254,26,2,24,2,1
26,260,260,1,1,0,1,0
7,290,290,11,11,0,1,0
34,293,293,21,21,0,1,0
11,313,313,22,7,15,2,1
14,313,313,35,35,0,1,0
33,313,313,25,25,0,1,0
21,328,328,3,3,0,1,0
3,331,331,10,10,0,1,0
1,337,337,25,25,0,1,0
40,339,339,41,19,22,2,1
37,343,343,50,22,28,3,2
12,361,361,1,1,0,1,0
4,365,365,60,60,0,1,0
20,380,380,42,42,0,1,0
2,388,388,1,1,0,1,0
15,403,403,13,8,5,2,1
16,409,409,2,2,0,1,0
19,422,422,18,18,0,1,0
29,433,433,51,5,46,2,1
0,433,433,40,40,0,1,0
31,435,435,13,13,0,1,0
9,437,437,1,1,0,1,0
36,443,443,12,12,0,1,0
18,443,443,59,59,0,1,0
38,456,456,44,44,0,1,0
8,460,460,55,21,34,4,3
39,485,485,20,7,13,2,1
27,488,488,9,9,0,1,0
45,495,495,15,4,11,2,1

34,113,113,8,8,0,1,0
10,132,132,1,1,0,1,0
30,135,135,7,7,0,1,0
4,137,137,2,2,0,1,0
33,139,139,21,18,3,2,1
13,145,145,7,7,0,1,0
14,146,146,2,2,0,1,0
9,147,147,22,4,18,4,3
25,173,173,8,8,0,1,0
16,174,174,13,3,10,3,2
35,179,179,32,11,21,2,1
27,186,186,4,1,3,2,1
7,188,188,2,2,0,1,0
17,191,191,39,39,0,1,0
21,212,212,39,39,0,1,0
26,219,219,16,11,5,2,1
37,227,227,18,18,0,1,0
15,234,234,39,39,0,1,0
29,235,235,55,46,9,2,1
19,241,241,36,36,0,1,0
28,246,246,20,1,19,4,3
31,249,249,1,1,0,1,0
1,263,263,13,13,0,1,0
24,290,290,45,33,12,4,3
18,296,296,26,10,16,4,3
0,322,322,17,2,15,2,1
36,335,335,35,7,28,2,1
12,340,340,61,61,0,1,0
2,347,347,32,32,0,1,0
20,389,389,20,6,14,3,2
11,395,395,24,24,0,1,0
22,413,413,81,25,56,3,2
23,419,419,39,17,22,2,1
6,451,451,28,28,0,1,0
32,457,457,4,4,0,1,0
8,465,465,39,21,18,2,1
5,468,468,23,23,0,1,0
3,495,495,46,13,33,2,1

2,100,100,10,10,0,1,0
1,111,111,2,2,0,1,0
29,115,115,37,28,9,4,3
17,123,123,15,15,0,1,0
0,131,131,5,5,0,1,0
25,147,147,33,11,22,2,1
15,211,211,4,4,0,1,0
26,220,220,17,11,6,2,1
31,254,254,24,24,0,1,0
12,267,267,6,6,0,1,0
23,274,274,11,3,8,2,1
27,302,302,36,18,18,3,2
3,303,303,23,9,14,2,1
28,309,309,9,4,5,2,1
13,315,315,89,62,27,4,3
22,319,319,31,31,0,1,0
20,323,323,11,5,6,3,2
18,336,336,58,27,31,2,1
30,351,351,51,51,0,1,0
19,353,353,23,15,8,2,1
21,356,356,7,4,3,2,1
6,386,386,1,1,0,1,0
7,406,406,85,85,0,1,0
8,426,426,58,2,56,3,2
4,434,434,71,17,54,3,2
24,436,436,1,1,0,1,0
16,439,439,63,21,42,4,3
5,448,448,66,10,56,4,3
10,466,466,31,31,0,1,0
9,468,468,13,13,0,1,0
14,473,473,62,56,6,3,2
11,480,480,134,134,0,1,0

0,102,102,9,2,7,2,1
28,130,130,9,1,8,3,2
20,156,156,14,14,0,1,0
9,161,161,7,7,0,1,0
17,162,162,10,10,0,1,0
5,185,185,16,16,0,1,0
8,199,199,85,58,27,4,3
11,216,216,14,14,0,1,0
13,246,246,5,5,0,1,0
18,250,250,5,5,0,1,0
1,260,260,57,57,0,1,0
33,272,272,6,3,3,2,1
12,282,282,12,12,0,1,0
3,286,286,6,2,4,2,1
10,287,287,2,2,0,1,0
2,292,292,21,21,0,1,0
32,294,294,6,6,0,1,0
21,297,297,59,59,0,1,0
30,301,301,25,25,0,1,0
16,308,308,11,11,0,1,0
19,310,310,31,31,0,1,0
4,339,339,132,72,60,4,3
29,340,340,87,6,81,4,3
23,347,347,91,91,0,1,0
7,367,367,4,4,0,1,0
22,389,389,65,27,38,2,1
31,418,418,39,39,0,1,0
26,434,434,51,51,0,1,0
25,453,453,35,7,28,3,2
14,467,467,23,23,0,1,0
24,475,475,43,25,18,3,2
27,476,476,1,1,0,1,0
6,480,480,21,8,13,2,1
15,494,494,40,40,0,1,0

0,111,111,1,1,0,1,0
31,118,118,4,4,0,1,0
15,128,128,9,2,7,2,1
10,130,130,2,2,0,1,0
1,137,137,34,30,4,2,1
28,156,156,24,20,4,2,1
24,156,156,20,2,18,4,3
17,191,191,6,6,0,1,0
7,193,193,17,17,0,1,0
16,209,209,6,6,0,1,0
26,214,214,16,7,9,4,3
29,220,220,21,21,0,1,0
25,230,230,16,7,9,4,3
9,261,261,27,5,22,2,1
14,263,263,28,28,0,1,0
3,267,267,51,30,21,2,1
8,275,275,1,1,0,1,0
13,281,281,17,17,0,1,0
20,316,316,8,8,0,1,0
33,325,325,2,2,0,1,0
32,328,328,62,17,45,3,2
6,350,350,8,8,0,1,0
27,351,351,27,2,25,2,1
12,351,351,33,33,0,1,0
5,352,352,62,35,27,2,1
21,364,364,30,30,0,1,0
30,369,369,30,18,12,4,3
22,377,377,98,59,39,2,1
19,384,384,43,43,0,1,0
2,392,392,34,34,0,1,0
11,416,416,19,12,7,2,1
18,447,447,18,3,15,4,3
23,452,452,122,122,0,1,0
4,467,467,165,165,0,1,0

4,130,130,17,17,0,1,0
26,135,135,37,37,0,1,0
15,140,140,8,8,0,1,0
0,201,201,28,16,12,2,1
13,203,203,8,8,0,1,0
21,230,230,18,4,14,2,1
33,232,232,4,1,3,2,1
23,236,236,29,8,21,2,1
29,243,243,16,8,8,2,1
27,253,253,9,3,6,3,2
24,253,253,8,2,6,3,2
30,257,257,16,16,0,1,0
20,272,272,16,16,0,1,0
1,281,281,42,6,36,3,2
7,286,286,4,4,0,1,0
32,290,290,21,21,0,1,0
25,291,291,106,106,0,1,0
31,292,292,46,1,45,2,1
19,309,309,66,66,0,1,0
9,314,314,53,4,49,2,1
28,317,317,54,54,0,1,0
18,333,333,6,1,5,2,1
10,338,338,11,11,0,1,0
36,353,353,48,28,20,2,1
34,357,357,6,2,4,2,1
35,358,358,1,1,0,1,0
17,368,368,30,30,0,1,0
22,381,381,32,25,7,2,1
16,383,383,46,34,12,4,3
5,388,388,1,1,0,1,0
12,393,393,23,6,17,2,1
37,396,396,12,2,10,2,1
3,406,406,1,1,0,1,0
11,408,408,32,7,25,2,1
6,412,412,9,9,0,1,0
14,490,490,46,46,0,1,0
8,498,498,81,31,50,2,1
2,500,500,29,6,23,2,1

19,115,115,1,1,0,1,0
4,121,121,1,1,0,1,0
7,122,122,10,10,0,1,0
27,134,134,6,6,0,1,0
22,136,136,7,7,0,1,0
21,141,141,13,13,0,1,0
6,157,157,37,37,0,1,0
18,162,162,9,9,0,1,0
9,187,187,2,2,0,1,0
28,202,202,17,17,0,1,0
5,209,209,53,26,27,4,3
20,223,223,3,3,0,1,0
29,226,226,39,14,25,2,1
3,251,251,35,17,18,4,3
17,271,271,116,116,0,1,0
2,306,306,22,4,18,2,1
0,307,307,28,18,10,3,2
25,322,322,17,2,15,4,3
1,375,375,1,1,0,1,0
16,387,387,62,35,27,4,3
8,392,392,131,95,36,4,3
10,403,403,74,42,32,4,3
12,444,444,44,44,0,1,0
15,448,448,71,28,43,2,1
26,462,462,49,49,0,1,0
23,463,463,37,37,0,1,0
24,473,473,49,49,0,1,0
14,476,476,37,34,3,2,1
11,498,498,94,62,32,2,1
13,499,499,21,1,20,2,1

25,100,100,5,5,0,1,0
17,101,101,6,6,0,1,0
23,104,104,20,8,12,2,1
20,115,115,18,18,0,1,0
11,142,142,12,12,0,1,0
1,145,145,28,28,0,1,0
16,162,162,14,14,0,1,0
6,203,203,18,6,12,2,1
14,226,226,78,78,0,1,0
21,257,257,1,1,0,1,0
12,260,260,14,5,9,2,1
8,267,267,23,23,0,1,0
22,274,274,35,7,28,2,1
7,281,281,57,43,14,2,1
24,296,296,81,9,72,3,2
10,305,305,31,6,25,4,3
5,325,325,18,18,0,1,0
2,326,326,36,14,22,2,1
3,355,355,14,14,0,1,0
4,368,368,82,16,66,4,3
18,380,380,33,9,24,4,3
26,406,406,11,1,10,3,2
19,414,414,12,3,9,4,3
0,431,431,177,136,41,4,3
13,441,441,57,57,0,1,0
9,451,451,86,5,81,4,3
27,471,471,7,7,0,1,0
15,477,477,11,7,4,2,1

16,103,103,10,10,0,1,0
3,108,108,8,8,0,1,0
24,114,114,4,1,3,2,1
6,127,127,23,1,22,2,1
28,145,145,18,9,9,4,3
5,151,151,2,2,0,1,0
12,157,157,11,11,0,1,0
11,164,164,3,3,0,1,0
22,179,179,11,11,0,1,0
7,201,201,3,3,0,1,0
8,208,208,18,6,12,2,1
19,208,208,61,14,47,4,3
25,227,227,27,3,24,3,2
1,235,235,21,5,16,3,2
4,259,259,1,1,0,1,0
23,308,308,93,29,64,3,2
13,318,318,163,117,46,3,2
10,330,330,14,14,0,1,0
2,341,341,27,27,0,1,0
0,391,391,36,36,0,1,0
18,394,394,79,49,30,2,1
20,398,398,17,17,0,1,0
32,408,408,26,3,23,2,1
14,416,416,4,4,0,1,0
21,425,425,5,5,0,1,0
30,428,428,41,41,0,1,0
9,452,452,174,113,61,4,3
27,461,461,35,35,0,1,0
31,463,463,9,6,3,2,1
26,472,472,22,22,0,1,0
15,486,486,14,14,0,1,0
29,489,489,44,44,0,1,0
17,494,494,33,33,0,1,0

26,120,120,20,20,0,1,0
33,133,133,28,28,0,1,0
8,155,155,4,4,0,1,0
3,159,159,49,49,0,1,0
32,168,168,27,27,0,1,0
17,173,173,1,1,0,1,0
29,189,189,19,2,17,2,1
30,212,212,3,3,0,1,0
5,224,224,38,38,0,1,0
6,229,229,37,10,27,2,1
28,235,235,1,1,0,1,0
10,252,252,12,12,0,1,0
1,254,254,72,4,68,3,2
11,266,266,39,30,9,4,3
21,287,287,21,9,12,3,2
15,290,290,16,16,0,1,0
20,322,322,41,41,0,1,0
31,340,340,22,22,0,1,0
22,347,347,31,31,0,1,0
23,377,377,58,36,22,2,1
18,395,395,90,90,0,1,0
25,407,407,14,11,3,2,1
16,412,412,29,29,0,1,0
0,424,424,80,29,51,4,3
24,429,429,70,46,24,3,2
14,439,439,12,12,0,1,0
7,442,442,8,1,7,2,1
4,445,445,15,15,0,1,0
2,458,458,3,3,0,1,0
13,458,458,16,16,0,1,0
27,463,463,28,10,18,4,3
9,470,470,39,39,0,1,0
19,481,481,39,5,34,2,1
12,500,500,20,20,0,1,0

36,105,105,1,1,0,1,0
13,132,132,7,7,0,1,0
33,136,136,19,7,12,4,3
17,143,143,4,4,0,1,0
5,179,179,9,1,8,3,2
14,192,192,9,4,5,2,1
20,199,199,5,5,0,1,0
37,200,200,21,1,20,3,2
1,208,208,9,1,8,2,1
29,210,210,36,36,0,1,0
24,214,214,5,5,0,1,0
7,242,242,39,30,9,4,3
39,259,259,18,12,6,3,2
35,261,261,29,29,0,1,0
41,268,268,95,53,42,3,2
2,279,279,6,6,0,1,0
38,287,287,33,19,14,3,2
11,296,296,7,7,0,1,0
6,299,299,23,5,18,2,1
22,300,300,19,19,0,1,0
21,300,300,31,1,30,4,3
3,309,309,1,1,0,1,0
0,318,318,5,1,4,2,1
18,318,318,21,21,0,1,0
25,343,343,3,3,0,1,0
32,354,354,9,9,0,1,0
40,356,356,4,4,0,1,0
19,358,358,74,74,0,1,0
42,373,373,29,15,14,3,2
23,384,384,36,11,25,3,2
12,389,389,60,60,0,1,0
4,394,394,23,7,16,3,2
8,404,404,24,7,17,2,1
27,412,412,42,42,0,1,0
31,416,416,11,11,0,1,0
10,430,430,27,27,0,1,0
16,448,448,1,1,0,1,0
34,452,452,140,23,117,4,3
26,457,457,10,3,7,2,1
28,484,484,19,19,0,1,0
30,484,484,20,11,9,4,3
9,486,486,65,65,0,1,0
15,489,489,57,57,0,1,0

24,100,100,3,3,0,1,0
10,102,102,5,5,0,1,0
27,115,115,5,5,0,1,0
18,136,136,7,3,4,2,1
19,141,141,6,6,0,1,0
6,156,156,43,43,0,1,0
28,161,161,1,1,0,1,0
29,169,169,59,24,35,2,1
7,173,173,6,2,4,2,1
26,191,191,34,26,8,3,2
3,200,200,11,5,6,3,2
2,214,214,13,13,0,1,0
17,229,229,3,3,0,1,0
13,247,247,3,3,0,1,0
14,250,250,26,3,23,2,1
9,251,251,28,28,0,1,0
1,262,262,65,65,0,1,0
31,264,264,7,7,0,1,0
16,271,271,5,5,0,1,0
33,294,294,97,80,17,2,1
11,300,300,59,59,0,1,0
20,303,303,77,47,30,2,1
12,310,310,31,3,28,2,1
22,337,337,1,1,0,1,0
30,349,349,5,5,0,1,0
8,406,406,99,99,0,1,0
32,410,410,30,30,0,1,0
4,415,415,12,12,0,1,0
5,428,428,45,45,0,1,0
21,432,432,23,23,0,1,0
15,437,437,3,3,0,1,0
23,471,471,75,56,19,2,1
25,480,480,49,3,46,4,3
0,484,484,25,25,0,1,0

10,115,115,2,2,0,1,0
13,132,132,5,1,4,2,1
12,137,137,6,3,3,2,1
16,162,162,13,13,0,1,0
11,164,164,12,12,0,1,0
20,176,176,4,4,0,1,0
19,197,197,19,19,0,1,0
22,200,200,4,4,0,1,0
2,202,202,27,27,0,1,0
18,221,221,40,40,0,1,0
3,259,259,73,50,23,4,3
7,268,268,120,36,84,4,3
0,269,269,26,26,0,1,0
1,271,271,14,14,0,1,0
4,273,273,146,128,18,3,2
9,274,274,20,4,16,3,2
6,296,296,17,2,15,2,1
5,332,332,33,16,17,4,3
15,343,343,3,3,0,1,0
23,354,354,78,78,0,1,0
14,411,411,116,56,60,4,3
24,429,429,209,209,0,1,0
17,437,437,28,28,0,1,0
21,447,447,10,7,3,2,1
8,484,484,1,1,0,1,0

19,100,100,2,2,0,1,0
26,101,101,18,13,5,2,1
18,108,108,10,10,0,1,0
23,119,119,13,13,0,1,0
7,123,123,42,42,0,1,0
0,131,131,33,21,12,2,1
24,136,136,8,8,0,1,0
1,137,137,24,15,9,2,1
8,142,142,3,3,0,1,0
13,143,143,23,8,15,2,1
6,170,170,18,5,13,2,1
2,183,183,14,14,0,1,0
14,190,190,28,13,15,4,3
15,227,227,4,4,0,1,0
17,256,256,5,5,0,1,0
11,268,268,18,15,3,2,1
12,287,287,41,41,0,1,0
29,288,288,61,61,0,1,0
10,296,296,7,4,3,2,1
25,311,311,17,17,0,1,0
16,319,319,4,4,0,1,0
21,335,335,35,35,0,1,0
5,340,340,52,52,0,1,0
28,374,374,38,38,0,1,0
20,438,438,72,72,0,1,0
27,459,459,126,82,44,2,1
4,482,482,52,49,3,2,1
22,496,496,8,8,0,1,0
9,497,497,27,8,19,2,1
3,499,499,91,79,12,3,2

7,103,103,5,5,0,1,0
34,106,106,2,2,0,1,0
14,107,107,7,4,3,2,1
6,108,108,12,12,0,1,0
11,111,111,13,13,0,1,0
10,145,145,13,5,8,3,2
29,148,148,24,24,0,1,0
27,150,150,13,13,0,1,0
38,156,156,43,10,33,2,1
30,190,190,12,12,0,1,0
17,193,193,2,2,0,1,0
39,195,195,66,34,32,3,2
9,196,196,4,4,0,1,0
0,199,199,20,1,19,3,2
32,214,214,5,5,0,1,0
16,232,232,23,4,19,2,1
13,235,235,14,14,0,1,0
35,260,260,23,1,22,2,1
37,283,283,27,12,15,2,1
22,287,287,65,60,5,2,1
12,291,291,3,3,0,1,0
28,293,293,22,3,19,2,1
3,304,304,36,33,3,2,1
26,316,316,56,56,0,1,0
31,364,364,26,26,0,1,0
25,372,372,10,6,4,2,1
1,372,372,26,26,0,1,0
4,372,372,18,9,9,4,3
19,383,383,11,2,9,4,3
23,404,404,38,38,0,1,0
36,413,413,4,4,0,1,0
8,426,426,64,46,18,4,3
5,437,437,6,6,0,1,0
15,439,439,1,1,0,1,0
21,465,465,47,1,46,4,3
33,469,469,15,3,12,2,1
18,482,482,17,17,0,1,0
24,485,485,44,44,0,1,0
2,485,485,29,7,22,3,2
20,490,490,57,12,45,2,1

19,100,100,16,4,12,4,3
15,108,108,6,6,0,1,0
16,120,120,12,8,4,2,1
1,128,128,8,8,0,1,0
27,136,136,5,2,3,2,1
23,185,185,13,6,7,2,1
26,187,187,5,5,0,1,0
29,205,205,55,11,44,4,3
17,209,209,15,15,0,1,0
31,212,212,91,91,0,1,0
21,224,224,11,11,0,1,0
5,234,234,2,2,0,1,0
20,244,244,2,2,0,1,0
30,255,255,22,22,0,1,0
28,259,259,13,13,0,1,0
6,271,271,24,9,15,4,3
9,286,286,4,4,0,1,0
8,327,327,58,46,12,4,3
2,343,343,18,6,12,3,2
25,356,356,31,10,21,4,3
0,384,384,46,46,0,1,0
3,409,409,111,93,18,4,3
18,418,418,62,13,49,2,1
32,423,423,35,35,0,1,0
13,426,426,4,1,3,2,1
10,432,432,1,1,0,1,0
12,440,440,96,83,13,2,1
22,441,441,27,6,21,2,1
7,451,451,103,103,0,1,0
4,458,458,48,12,36,3,2
24,469,469,1,1,0,1,0
11,472,472,20,4,16,3,2
14,490,490,120,94,26,2,1

34,101,101,22,22,0,1,0
2,106,106,1,1,0,1,0
17,108,108,12,5,7,2,1
27,109,109,3,3,0,1,0
24,144,144,4,4,0,1,0
16,155,155,5,2,3,2,1
10,161,161,2,2,0,1,0
13,165,165,22,22,0,1,0
29,166,166,22,22,0,1,0
33,166,166,6,6,0,1,0
3,193,193,49,49,0,1,0
0,205,205,13,4,9,4,3
18,212,212,28,13,15,3,2
4,218,218,1,1,0,1,0
25,222,222,25,25,0,1,0
11,224,224,4,4,0,1,0
12,242,242,16,1,15,4,3
9,246,246,2,2,0,1,0
32,247,247,44,44,0,1,0
15,253,253,66,66,0,1,0
6,269,269,22,1,21,2,1
22,278,278,25,4,21,3,2
19,292,292,80,36,44,3,2
14,304,304,7,7,0,1,0
28,337,337,5,5,0,1,0
31,341,341,6,6,0,1,0
30,361,361,21,12,9,4,3
1,376,376,8,8,0,1,0
21,388,388,53,53,0,1,0
35,397,397,14,6,8,2,1
26,431,431,47,17,30,2,1
8,458,458,64,64,0,1,0
20,466,466,46,46,0,1,0
23,477,477,83,83,0,1,0
7,480,480,150,138,12,2,1
5,488,488,9,9,0,1,0

23,110,110,19,19,0,1,0
1,113,113,10,7,3,2,1
21,131,131,17,9,8,2,1
25,143,143,17,10,7,2,1
22,153,153,4,4,0,1,0
17,195,195,62,2,60,4,3
26,199,199,6,6,0,1,0
7,224,224,15,5,10,3,2
5,234,234,33,19,14,3,2
6,239,239,31,31,0,1,0
16,244,244,5,5,0,1,0
24,246,246,4,4,0,1,0
27,262,262,15,15,0,1,0
18,282,282,25,25,0,1,0
12,292,292,19,7,12,3,2
29,301,301,55,6,49,2,1
20,305,305,31,31,0,1,0
11,347,347,12,12,0,1,0
19,355,355,87,30,57,4,3
30,368,368,36,12,24,3,2
28,376,376,44,44,0,1,0
10,395,395,143,131,12,4,3
0,408,408,12,12,0,1,0
8,417,417,35,35,0,1,0
2,419,419,41,41,0,1,0
14,423,423,8,5,3,2,1
15,435,435,2,2,0,1,0
3,453,453,1,1,0,1,0
13,458,458,83,3,80,4,3
4,472,472,111,111,0,1,0
9,487,487,89,89,0,1,0

31,105,105,4,4,0,1,0
13,124,124,9,9,0,1,0
1,132,132,32,32,0,1,0
22,133,133,23,23,0,1,0
26,162,162,13,6,7,2,1
28,166,166,14,8,6,3,2
18,189,189,24,4,20,3,2
20,195,195,33,18,15,4,3
15,196,196,15,5,10,2,1
6,208,208,34,2,32,2,1
9,209,209,39,39,0,1,0
11,215,215,20,20,0,1,0
30,216,216,13,13,0,1,0
12,220,220,22,19,3,2,1
17,225,225,8,8,0,1,0
2,235,235,9,9,0,1,0
8,240,240,12,12,0,1,0
0,240,240,41,41,0,1,0
10,285,285,35,35,0,1,0
7,299,299,58,58,0,1,0
5,360,360,15,6,9,4,3
19,363,363,177,162,15,4,3
27,379,379,29,2,27,3,2
3,383,383,32,32,0,1,0
14,384,384,8,1,7,2,1
24,385,385,9,9,0,1,0
32,391,391,3,3,0,1,0
29,408,408,47,29,18,4,3
4,409,409,19,7,12,4,3
25,434,434,75,41,34,2,1
16,449,449,30,30,0,1,0
23,453,453,3,3,0,1,0
21,493,493,3,3,0,1,0

0,107,107,10,10,0,1,0
16,112,112,8,8,0,1,0
26,120,120,6,3,3,2,1
17,135,135,1,1,0,1,0
8,139,139,2,2,0,1,0
12,164,164,33,33,0,1,0
19,182,182,46,46,0,1,0
3,203,203,19,11,8,3,2
14,209,209,54,12,42,3,2
23,229,229,3,3,0,1,0
11,253,253,119,20,99,4,3
20,275,275,6,6,0,1,0
27,284,284,18,18,0,1,0
1,325,325,13,7,6,2,1
4,354,354,27,15,12,3,2
21,360,360,22,22,0,1,0
6,376,376,89,32,57,4,3
5,376,376,9,2,7,3,2
28,380,380,6,6,0,1,0
22,395,395,26,8,18,4,3
2,399,399,16,1,15,2,1
15,412,412,1,1,0,1,0
10,412,412,107,35,72,4,3
29,420,420,40,40,0,1,0
7,432,432,44,44,0,1,0
25,437,437,189,113,76,3,2
24,455,455,57,52,5,2,1
13,472,472,24,4,20,2,1
9,485,485,24,15,9,2,1
18,494,494,72,30,42,2,1

21,113,113,17,17,0,1,0
22,122,122,3,3,0,1,0
33,134,134,7,7,0,1,0
32,166,166,2,2,0,1,0
37,169,169,15,15,0,1,0
24,183,183,34,16,18,3,2
31,187,187,5,5,0,1,0
8,196,196,19,19,0,1,0
11,198,198,19,7,12,4,3
34,202,202,41,41,0,1,0
1,206,206,23,3,20,3,2
3,208,208,10,1,9,4,3
28,215,215,10,6,4,2,1
19,234,234,44,44,0,1,0
35,248,248,19,19,0,1,0
27,265,265,9,5,4,2,1
4,282,282,2,2,0,1,0
23,284,284,4,4,0,1,0
14,303,303,1,1,0,1,0
5,305,305,12,2,10,2,1
9,318,318,7,7,0,1,0
16,344,344,10,10,0,1,0
36,345,345,9,9,0,1,0
26,368,368,180,180,0,1,0
7,370,370,11,11,0,1,0
18,377,377,16,16,0,1,0
20,383,383,4,4,0,1,0
15,400,400,53,53,0,1,0
12,404,404,14,14,0,1,0
29,419,419,24,19,5,2,1
30,419,419,52,52,0,1,0
2,420,420,145,145,0,1,0
17,453,453,16,6,10,3,2
0,455,455,130,108,22,3,2
13,455,455,1,1,0,1,0
25,495,495,64,57,7,2,1
6,495,495,18,2,16,2,1
10,498,498,52,10,42,4,3

21,115,115,24,24,0,1,0
28,116,116,3,3,0,1,0
30,120,120,7,7,0,1,0
24,123,123,14,2,12,3,2
17,125,125,5,5,0,1,0
1,126,126,16,4,12,3,2
6,131,131,3,3,0,1,0
23,136,136,15,15,0,1,0
13,150,150,18,13,5,2,1
19,171,171,42,42,0,1,0
25,191,191,12,12,0,1,0
9,194,194,8,8,0,1,0
12,202,202,20,20,0,1,0
11,292,292,82,31,51,4,3
10,294,294,24,24,0,1,0
15,294,294,22,22,0,1,0
5,308,308,49,13,36,2,1
4,311,311,11,5,6,2,1
16,330,330,18,3,15,2,1
27,333,333,1,1,0,1,0
3,335,335,15,15,0,1,0
20,357,357,9,9,0,1,0
14,362,362,57,44,13,2,1
26,396,396,133,16,117,4,3
7,399,399,71,71,0,1,0
29,405,405,54,54,0,1,0
22,416,416,9,9,0,1,0
0,437,437,52,20,32,3,2
18,470,470,37,23,14,3,2
8,474,474,134,28,106,4,3
2,494,494,54,54,0,1,0

8,101,101,1,1,0,1,0
23,112,112,18,1,17,2,1
12,119,119,23,17,6,2,1
32,131,131,11,3,8,2,1
13,150,150,7,7,0,1,0
28,164,164,7,7,0,1,0
29,166,166,20,20,0,1,0
11,168,168,51,36,15,2,1
0,195,195,14,14,0,1,0
4,203,203,2,2,0,1,0
9,204,204,24,4,20,3,2
10,217,217,8,2,6,3,2
17,236,236,21,21,0,1,0
7,242,242,9,9,0,1,0
15,259,259,9,9,0,1,0
16,260,260,53,53,0,1,0
21,295,295,73,73,0,1,0
33,301,301,13,1,12,4,3
26,315,315,3,3,0,1,0
30,353,353,26,26,0,1,0
24,355,355,3,3,0,1,0
2,387,387,47,47,0,1,0
14,398,398,108,4,104,4,3
22,405,405,29,29,0,1,0
1,417,417,52,52,0,1,0
31,424,424,29,29,0,1,0
19,440,440,14,5,9,4,3
6,456,456,4,4,0,1,0
20,478,478,55,36,19,2,1
5,478,478,6,6,0,1,0
34,481,481,163,22,141,4,3
18,481,481,74,50,24,2,1
25,486,486,33,3,30,3,2
3,493,493,4,1,3,2,1
27,495,495,46,21,25,2,1

17,100,100,17,17,0,1,0
18,104,104,14,14,0,1,0
0,105,105,45,45,0,1,0
23,116,116,2,2,0,1,0
26,118,118,46,46,0,1,0
5,139,139,8,8,0,1,0
4,173,173,21,1,20,3,2
21,176,176,33,16,17,2,1
16,215,215,37,37,0,1,0
20,220,220,1,1,0,1,0
14,236,236,9,9,0,1,0
10,251,251,10,10,0,1,0
9,280,280,13,13,0,1,0
19,283,283,2,2,0,1,0
6,284,284,35,35,0,1,0
30,294,294,9,9,0,1,0
3,297,297,107,80,27,2,1
13,304,304,30,30,0,1,0
31,325,325,41,41,0,1,0
24,369,369,7,7,0,1,0
15,382,382,12,12,0,1,0
25,385,385,10,4,6,3,2
2,394,394,76,38,38,3,2
8,400,400,1,1,0,1,0
27,405,405,76,64,12,4,3
12,427,427,2,2,0,1,0
28,433,433,21,13,8,2,1
11,434,434,5,5,0,1,0
22,438,438,36,7,29,3,2
1,464,464,31,31,0,1,0
7,483,483,52,52,0,1,0
29,488,488,46,10,36,3,2

4,101,101,4,4,0,1,0
28,123,123,2,2,0,1,0
16,125,125,1,1,0,1,0
40,126,126,26,26,0,1,0
14,162,162,15,11,4,2,1
24,162,162,17,10,7,2,1
7,164,164,1,1,0,1,0
9,195,195,20,20,0,1,0
1,220,220,19,12,7,2,1
23,236,236,3,3,0,1,0
41,244,244,29,29,0,1,0
6,258,258,55,30,25,2,1
11,267,267,2,2,0,1,0
37,273,273,27,3,24,4,3
17,279,279,9,9,0,1,0
33,284,284,19,19,0,1,0
15,309,309,28,28,0,1,0
39,315,315,22,14,8,3,2
21,317,317,20,20,0,1,0
10,334,334,113,39,74,3,2
26,337,337,155,109,46,2,1
27,340,340,8,8,0,1,0
34,341,341,37,37,0,1,0
3,344,344,12,3,9,2,1
35,356,356,14,3,11,2,1
5,362,362,27,27,0,1,0
38,373,373,25,25,0,1,0
42,375,375,12,12,0,1,0
2,375,375,19,19,0,1,0
13,383,383,1,1,0,1,0
29,390,390,85,23,62,3,2
18,393,393,5,1,4,2,1
22,400,400,4,4,0,1,0
0,406,406,5,5,0,1,0
19,424,424,13,8,5,2,1
20,426,426,5,1,4,2,1
25,442,442,69,64,5,2,1
36,447,447,28,12,16,2,1
12,461,461,20,4,16,2,1
8,478,478,30,30,0,1,0
30,481,481,38,38,0,1,0
31,482,482,1,1,0,1,0
32,488,488,30,30,0,1,0

13,103,103,15,6,9,4,3
14,103,103,9,1,8,2,1
31,117,117,9,9,0,1,0
22,133,133,23,19,4,2,1
17,144,144,19,19,0,1,0
1,146,146,6,6,0,1,0
19,176,176,5,5,0,1,0
3,184,184,26,4,22,2,1
24,189,189,17,17,0,1,0
9,213,213,1,1,0,1,0
21,219,219,3,3,0,1,0
26,240,240,36,8,28,2,1
12,259,259,11,7,4,2,1
0,260,260,14,14,0,1,0
7,294,294,12,12,0,1,0
23,297,297,76,76,0,1,0
16,300,300,11,2,9,2,1
30,316,316,47,35,12,2,1
15,359,359,4,4,0,1,0
27,368,368,44,40,4,2,1
8,378,378,64,64,0,1,0
5,381,381,64,10,54,4,3
6,384,384,3,3,0,1,0
10,395,395,25,25,0,1,0
28,403,403,3,3,0,1,0
29,424,424,16,4,12,3,2
25,432,432,27,7,20,3,2
2,443,443,101,62,39,4,3
18,483,483,66,60,6,2,1
11,483,483,132,36,96,3,2
20,485,485,123,37,86,3,2
4,490,490,118,81,37,2,1

32,105,105,15,15,0,1,0
9,109,109,5,5,0,1,0
22,116,116,10,4,6,3,2
17,140,140,20,12,8,3,2
33,142,142,35,35,0,1,0
18,149,149,5,2,3,2,1
35,152,152,32,4,28,3,2
21,160,160,9,9,0,1,0
8,205,205,7,7,0,1,0
25,205,205,9,9,0,1,0
20,207,207,27,7,20,4,3
31,217,217,51,12,39,4,3
7,219,219,26,4,22,2,1
26,222,222,36,36,0,1,0
0,225,225,10,10,0,1,0
15,228,228,4,4,0,1,0
5,244,244,36,6,30,2,1
13,245,245,20,20,0,1,0
24,252,252,4,4,0,1,0
3,274,274,15,5,10,2,1
27,274,274,12,12,0,1,0
2,292,292,47,28,19,2,1
28,301,301,24,18,6,2,1
10,311,311,10,10,0,1,0
19,332,332,12,4,8,3,2
14,335,335,32,20,12,2,1
12,337,337,100,100,0,1,0
1,338,338,82,82,0,1,0
4,345,345,8,8,0,1,0
29,346,346,22,22,0,1,0
34,377,377,14,2,12,2,1
30,380,380,25,25,0,1,0
23,431,431,35,23,12,4,3
11,436,436,24,3,21,4,3
6,441,441,6,6,0,1,0
16,467,467,29,29,0,1,0

17,117,117,2,2,0,1,0
21,132,132,16,6,10,3,2
18,161,161,6,6,0,1,0
3,161,161,5,5,0,1,0
35,162,162,4,4,0,1,0
19,196,196,21,21,0,1,0
11,208,208,16,6,10,3,2
7,217,217,52,33,19,2,1
23,227,227,20,20,0,1,0
4,230,230,46,38,8,2,1
25,234,234,44,22,22,3,2
0,238,238,20,1,19,2,1
32,238,238,22,4,18,4,3
22,268,268,8,1,7,2,1
16,279,279,2,2,0,1,0
26,280,280,16,16,0,1,0
33,330,330,3,3,0,1,0
15,335,335,70,70,0,1,0
2,361,361,13,13,0,1,0
1,365,365,26,14,12,3,2
13,398,398,9,1,8,3,2
30,404,404,71,51,20,2,1
10,406,406,44,12,32,3,2
5,412,412,30,30,0,1,0
24,414,414,22,22,0,1,0
34,417,417,66,34,32,2,1
20,424,424,29,29,0,1,0
14,425,425,3,3,0,1,0
6,429,429,55,9,46,4,3
28,439,439,7,7,0,1,0
29,448,448,4,1,3,2,1
9,457,457,28,19,9,4,3
8,480,480,37,3,34,3,2
27,482,482,120,120,0,1,0
12,485,485,105,63,42,4,3
31,499,499,144,75,69,4,3

21,107,107,13,13,0,1,0
18,123,123,19,7,12,4,3
28,137,137,13,1,12,2,1
5,177,177,2,2,0,1,0
32,191,191,10,3,7,2,1
27,194,194,28,23,5,2,1
4,204,204,1,1,0,1,0
16,210,210,36,27,9,4,3
8,220,220,5,5,0,1,0
6,228,228,34,12,22,3,2
38,232,232,115,64,51,3,2
14,239,239,1,1,0,1,0
20,243,243,14,3,11,2,1
35,245,245,15,15,0,1,0
2,265,265,47,47,0,1,0
0,274,274,7,7,0,1,0
10,277,277,2,2,0,1,0
17,290,290,97,3,94,3,2
34,309,309,130,90,40,2,1
13,310,310,22,22,0,1,0
22,318,318,2,2,0,1,0
37,320,320,2,2,0,1,0
1,328,328,40,28,12,4,3
11,346,346,12,12,0,1,0
31,348,348,23,5,18,3,2
30,367,367,56,56,0,1,0
29,368,368,27,27,0,1,0
36,369,369,11,11,0,1,0
24,385,385,17,17,0,1,0
26,391,391,4,4,0,1,0
25,409,409,7,7,0,1,0
33,410,410,18,18,0,1,0
3,415,415,52,10,42,3,2
7,417,417,17,17,0,1,0
12,419,419,9,1,8,2,1
15,427,427,4,1,3,2,1
23,430,430,5,5,0,1,0
19,459,459,9,9,0,1,0
9,489,489,11,11,0,1,0

5,103,103,11,11,0,1,0
28,129,129,2,2,0,1,0
20,160,160,21,15,6,3,2
29,161,161,1,1,0,1,0
19,169,169,25,25,0,1,0
23,181,181,6,1,5,2,1
11,186,186,1,1,0,1,0
17,191,191,46,16,30,2,1
0,209,209,19,19,0,1,0
9,228,228,9,9,0,1,0
10,234,234,18,18,0,1,0
7,238,238,65,19,46,2,1
2,241,241,42,42,0,1,0
24,244,244,22,22,0,1,0
27,256,256,17,11,6,2,1
26,299,299,36,8,28,2,1
25,320,320,28,20,8,2,1
18,328,328,2,2,0,1,0
8,333,333,29,22,7,2,1
30,340,340,78,3,75,4,3
21,351,351,66,18,48,3,2
16,356,356,80,43,37,2,1
22,372,372,6,6,0,1,0
6,383,383,62,18,44,2,1
1,387,387,86,86,0,1,0
14,390,390,15,15,0,1,0
3,443,443,163,123,40,3,2
12,448,448,9,9,0,1,0
13,468,468,32,32,0,1,0
4,490,490,3,3,0,1,0
15,499,499,45,30,15,2,1

21,107,107,30,30,0,1,0
16,112,112,16,16,0,1,0
27,120,120,11,6,5,2,1
25,144,144,3,3,0,1,0
14,160,160,20,15,5,2,1
13,166,166,19,1,18,3,2
3,176,176,4,4,0,1,0
12,182,182,18,3,15,4,3
23,185,185,1,1,0,1,0
11,213,213,45,30,15,4,3
26,214,214,9,2,7,2,1
29,224,224,2,2,0,1,0
4,254,254,18,18,0,1,0
20,254,254,3,3,0,1,0
2,273,273,5,2,3,2,1
6,299,299,15,15,0,1,0
30,300,300,6,3,3,2,1
17,347,347,156,138,18,2,1
22,364,364,24,24,0,1,0
0,377,377,25,3,22,3,2
24,388,388,94,94,0,1,0
10,398,398,16,16,0,1,0
5,404,404,82,40,42,3,2
15,416,416,23,12,11,2,1
9,416,416,18,2,16,3,2
8,422,422,131,77,54,4,3
7,432,432,174,119,55,4,3
28,443,443,60,60,0,1,0
1,472,472,24,24,0,1,0
19,491,491,10,10,0,1,0
18,496,496,11,2,9,2,1

21,102,102,15,15,0,1,0
11,105,105,49,19,30,2,1
22,116,116,16,16,0,1,0
2,122,122,7,7,0,1,0
32,137,137,20,20,0,1,0
24,149,149,7,1,6,3,2
25,171,171,3,3,0,1,0
20,190,190,18,18,0,1,0
4,219,219,1,1,0,1,0
8,225,225,13,13,0,1,0
29,228,228,29,3,26,2,1
19,251,251,12,12,0,1,0
13,253,253,22,15,7,2,1
14,269,269,20,20,0,1,0
18,278,278,34,2,32,2,1
7,294,294,19,11,8,3,2
12,298,298,30,26,4,2,1
0,304,304,48,48,0,1,0
27,311,311,86,48,38,4,3
26,313,313,6,2,4,2,1
23,326,326,29,4,25,4,3
6,327,327,24,24,0,1,0
5,337,337,11,2,9,2,1
31,369,369,55,34,21,2,1
10,375,375,22,22,0,1,0
28,392,392,10,10,0,1,0
9,395,395,18,8,10,2,1
1,405,405,73,3,70,4,3
3,406,406,15,3,12,4,3
15,424,424,20,6,14,3,2
30,450,450,59,9,50,4,3
33,458,458,20,20,0,1,0
16,464,464,71,71,0,1,0
17,469,469,1,1,0,1,0
34,470,470,54,24,30,4,3

4,100,100,7,4,3,2,1
33,102,102,15,15,0,1,0
35,109,109,2,2,0,1,0
13,115,115,5,5,0,1,0
22,129,129,12,3,9,4,3
26,136,136,10,1,9,4,3
29,142,142,8,8,0,1,0
3,147,147,16,16,0,1,0
9,151,151,4,4,0,1,0
6,162,162,8,2,6,2,1
27,163,163,16,16,0,1,0
7,170,170,9,6,3,2,1
28,182,182,6,6,0,1,0
0,196,196,6,6,0,1,0
37,198,198,11,4,7,2,1
12,199,199,14,6,8,2,1
11,217,217,41,41,0,1,0
18,220,220,2,2,0,1,0
30,248,248,2,2,0,1,0
16,256,256,13,13,0,1,0
5,257,257,33,12,21,4,3
36,260,260,16,1,15,2,1
19,268,268,6,6,0,1,0
23,277,277,120,113,7,2,1
1,289,289,59,15,44,3,2
20,290,290,95,68,27,2,1
24,300,300,25,2,23,4,3
21,313,313,49,49,0,1,0
25,342,342,29,29,0,1,0
34,344,344,3,3,0,1,0
2,353,353,12,2,10,2,1
10,406,406,33,5,28,3,2
14,424,424,1,1,0,1,0
32,433,433,107,99,8,3,2
17,457,457,20,20,0,1,0
15,467,467,26,4,22,3,2
8,493,493,50,50,0,1,0
31,498,498,37,1,36,2,1

29,106,106,3,3,0,1,0
28,111,111,11,11,0,1,0
22,118,118,27,6,21,4,3
3,128,128,4,4,0,1,0
7,173,173,16,4,12,2,1
11,176,176,25,5,20,3,2
25,184,184,8,3,5,2,1
17,185,185,7,1,6,2,1
33,196,196,14,14,0,1,0
26,215,215,1,1,0,1,0
6,247,247,26,17,9,2,1
13,282,282,20,20,0,1,0
34,310,310,39,39,0,1,0
12,315,315,38,26,12,3,2
4,318,318,58,4,54,3,2
15,343,343,26,5,21,4,3
16,355,355,13,1,12,2,1
21,376,376,16,12,4,2,1
23,378,378,47,28,19,2,1
27,382,382,16,9,7,2,1
20,390,390,42,42,0,1,0
2,390,390,37,20,17,2,1
9,406,406,8,2,6,3,2
1,418,418,88,88,0,1,0
5,422,422,20,20,0,1,0
35,434,434,110,99,11,2,1
30,438,438,114,6,108,4,3
14,439,439,15,11,4,2,1
0,445,445,29,29,0,1,0
8,447,447,37,29,8,3,2
10,457,457,76,76,0,1,0
18,463,463,39,39,0,1,0
24,464,464,6,6,0,1,0
31,466,466,84,84,0,1,0
32,467,467,43,31,12,4,3
19,483,483,15,15,0,1,0

33,111,111,27,1,26,2,1
24,115,115,10,7,3,2,1
10,123,123,7,7,0,1,0
17,132,132,4,4,0,1,0
9,136,136,8,2,6,2,1
19,140,140,22,13,9,4,3
32,144,144,2,2,0,1,0
37,147,147,13,9,4,2,1
11,168,168,1,1,0,1,0
27,169,169,19,11,8,3,2
14,173,173,21,7,14,2,1
4,182,182,33,20,13,2,1
6,203,203,28,10,18,4,3
31,208,208,5,5,0,1,0
34,209,209,25,1,24,4,3
5,210,210,1,1,0,1,0
0,211,211,11,4,7,2,1
12,215,215,32,6,26,2,1
15,224,224,36,6,30,4,3
2,227,227,16,16,0,1,0
20,261,261,5,2,3,2,1
22,278,278,8,8,0,1,0
13,281,281,13,13,0,1,0
35,298,298,16,16,0,1,0
3,305,305,33,33,0,1,0
7,312,312,7,7,0,1,0
25,318,318,17,1,16,3,2
36,323,323,43,43,0,1,0
29,332,332,42,42,0,1,0
1,348,348,34,34,0,1,0
8,349,349,9,6,3,2,1
21,357,357,33,33,0,1,0
30,369,369,12,12,0,1,0
26,370,370,57,57,0,1,0
28,372,372,81,81,0,1,0
38,374,374,2,2,0,1,0
16,377,377,35,11,24,3,2
18,391,391,4,4,0,1,0
23,425,425,105,66,39,2,1

15,105,105,2,2,0,1,0
26,109,109,26,26,0,1,0
2,118,118,1,1,0,1,0
4,124,124,33,21,12,3,2
9,139,139,17,3,14,3,2
14,143,143,6,6,0,1,0
0,161,161,20,20,0,1,0
33,166,166,30,13,17,2,1
10,193,193,12,12,0,1,0
21,205,205,19,4,15,2,1
20,239,239,8,8,0,1,0
25,242,242,8,8,0,1,0
24,251,251,71,71,0,1,0
17,271,271,45,8,37,2,1
6,289,289,24,11,13,2,1
19,299,299,36,7,29,4,3
7,328,328,35,35,0,1,0
34,329,329,21,18,3,2,1
5,329,329,19,9,10,2,1
8,332,332,3,3,0,1,0
23,335,335,13,13,0,1,0
32,343,343,31,31,0,1,0
28,354,354,15,9,6,2,1
13,355,355,6,6,0,1,0
29,372,372,30,30,0,1,0
31,388,388,1,1,0,1,0
18,405,405,32,11,21,2,1
22,406,406,25,25,0,1,0
1,411,411,9,9,0,1,0
16,427,427,57,57,0,1,0
12,449,449,42,18,24,2,1
35,470,470,7,7,0,1,0
27,480,480,136,136,0,1,0
3,488,488,20,8,12,2,1
11,493,493,122,22,100,3,2
30,498,498,38,38,0,1,0

2,103,103,14,14,0,1,0
31,104,104,7,7,0,1,0
4,132,132,12,2,10,2,1
27,135,135,5,2,3,2,1
17,150,150,1,1,0,1,0
8,151,151,2,2,0,1,0
5,164,164,45,45,0,1,0
19,164,164,17,17,0,1,0
25,184,184,43,13,30,3,2
26,191,191,1,1,0,1,0
32,206,206,4,4,0,1,0
3,207,207,12,7,5,2,1
9,240,240,38,38,0,1,0
10,246,246,22,16,6,2,1
15,249,249,19,19,0,1,0
1,251,251,7,7,0,1,0
11,253,253,17,3,14,2,1
30,299,299,51,51,0,1,0
21,318,318,66,66,0,1,0
13,321,321,47,47,0,1,0
6,322,322,4,4,0,1,0
18,343,343,41,41,0,1,0
29,347,347,6,6,0,1,0
28,398,398,93,13,80,3,2
16,413,413,25,25,0,1,0
20,414,414,29,9,20,2,1
7,426,426,33,15,18,3,2
14,431,431,84,84,0,1,0
22,434,434,86,86,0,1,0
12,435,435,44,24,20,3,2
24,451,451,3,3,0,1,0
23,473,473,88,44,44,2,1
0,483,483,86,16,70,3,2

10,102,102,1,1,0,1,0
27,107,107,3,3,0,1,0
25,108,108,2,2,0,1,0
16,109,109,20,6,14,3,2
17,111,111,4,4,0,1,0
0,126,126,7,7,0,1,0
3,147,147,30,30,0,1,0
23,152,152,3,3,0,1,0
22,155,155,7,7,0,1,0
28,171,171,43,23,20,2,1
7,181,181,1,1,0,1,0
4,183,183,38,17,21,2,1
33,185,185,14,6,8,3,2
24,201,201,2,2,0,1,0
37,226,226,103,73,30,4,3
21,234,234,8,8,0,1,0
26,237,237,30,30,0,1,0
2,257,257,46,46,0,1,0
36,270,270,25,25,0,1,0
40,276,276,14,4,10,2,1
30,278,278,49,17,32,3,2
1,300,300,7,7,0,1,0
12,301,301,15,15,0,1,0
5,309,309,7,4,3,2,1
34,328,328,16,16,0,1,0
13,331,331,1,1,0,1,0
15,372,372,40,40,0,1,0
6,395,395,7,7,0,1,0
18,397,397,34,27,7,2,1
41,407,407,12,12,0,1,0
9,416,416,62,62,0,1,0
31,433,433,13,13,0,1,0
8,442,442,6,6,0,1,0
32,447,447,9,9,0,1,0
35,451,451,7,7,0,1,0
14,452,452,1,1,0,1,0
38,453,453,68,25,43,4,3
19,459,459,23,4,19,2,1
20,463,463,77,21,56,3,2
39,463,463,46,46,0,1,0
11,484,484,11,1,10,2,1
29,488,488,32,24,8,3,2

6,102,102,13,13,0,1,0
18,112,112,13,5,8,3,2
7,118,118,16,16,0,1,0
22,124,124,8,8,0,1,0
4,151,151,4,4,0,1,0
20,158,158,22,6,16,3,2
17,161,161,26,19,7,2,1
24,197,197,13,3,10,2,1
11,204,204,9,9,0,1,0
13,220,220,42,20,22,2,1
19,223,223,4,1,3,2,1
21,230,230,10,4,6,3,2
12,230,230,46,10,36,2,1
10,250,250,49,9,40,3,2
2,261,261,91,27,64,3,2
14,274,274,1,1,0,1,0
8,276,276,6,6,0,1,0
5,321,321,14,6,8,2,1
26,327,327,147,100,47,4,3
16,333,333,5,5,0,1,0
15,339,339,21,7,14,3,2
1,355,355,142,54,88,4,3
27,379,379,17,8,9,4,3
3,405,405,75,75,0,1,0
23,488,488,28,28,0,1,0
9,494,494,89,9,80,4,3
0,495,495,19,19,0,1,0
25,495,495,32,4,28,2,1

35,111,111,19,5,14,2,1
41,114,114,15,15,0,1,0
30,116,116,1,1,0,1,0
39,138,138,4,4,0,1,0
23,140,140,7,3,4,2,1
34,147,147,24,3,21,4,3
24,154,154,14,1,13,2,1
36,178,178,19,7,12,2,1
40,194,194,42,24,18,3,2
21,203,203,2,2,0,1,0
7,218,218,41,41,0,1,0
11,233,233,39,39,0,1,0
0,237,237,7,7,0,1,0
31,242,242,1,1,0,1,0
5,270,270,1,1,0,1,0
38,271,271,36,12,24,2,1
8,272,272,7,7,0,1,0
6,282,282,32,28,4,2,1
37,309,309,85,85,0,1,0
2,312,312,46,4,42,4,3
10,322,322,21,21,0,1,0
26,329,329,98,74,24,3,2
22,342,342,17,6,11,2,1
20,349,349,35,35,0,1,0
14,358,358,23,14,9,2,1
9,363,363,4,4,0,1,0
17,364,364,17,5,12,2,1
1,374,374,10,10,0,1,0
3,381,381,41,19,22,3,2
18,402,402,32,2,30,2,1
32,418,418,39,39,0,1,0
29,419,419,2,2,0,1,0
13,425,425,7,7,0,1,0
19,443,443,1,1,0,1,0
33,447,447,3,3,0,1,0
27,450,450,2,2,0,1,0
28,452,452,7,3,4,2,1
25,452,452,36,23,13,2,1
16,454,454,35,20,15,2,1
15,455,455,54,11,43,2,1
4,470,470,36,36,0,1,0
12,473,473,15,15,0,1,0

11,102,102,2,2,0,1,0
7,113,113,7,7,0,1,0
30,152,152,3,3,0,1,0
31,154,154,6,6,0,1,0
26,167,167,25,5,20,3,2
28,170,170,19,15,4,2,1
5,186,186,23,18,5,2,1
23,189,189,31,7,24,3,2
35,189,189,82,13,69,4,3
34,204,204,24,4,20,3,2
9,208,208,16,16,0,1,0
36,219,219,8,8,0,1,0
16,227,227,1,1,0,1,0
4,240,240,53,53,0,1,0
24,249,249,9,3,6,2,1
1,255,255,22,9,13,3,2
22,267,267,19,19,0,1,0
21,271,271,11,3,8,3,2
12,278,278,29,22,7,2,1
32,300,300,47,47,0,1,0
6,305,305,1,1,0,1,0
20,339,339,30,30,0,1,0
8,339,339,30,30,0,1,0
27,339,339,16,16,0,1,0
10,340,340,40,17,23,2,1
3,346,346,24,24,0,1,0
2,347,347,39,28,11,2,1
33,363,363,52,52,0,1,0
13,370,370,5,5,0,1,0
15,372,372,30,10,20,2,1
38,400,400,23,23,0,1,0
18,421,421,70,19,51,4,3
19,423,423,22,15,7,2,1
0,423,423,17,17,0,1,0
37,433,433,1,1,0,1,0
17,447,447,1,1,0,1,0
25,449,449,1,1,0,1,0
14,454,454,59,59,0,1,0
29,493,493,72,53,19,2,1

17,105,105,1,1,0,1,0
9,110,110,16,16,0,1,0
5,113,113,11,11,0,1,0
20,133,133,14,14,0,1,0
29,172,172,43,12,31,3,2
30,226,226,11,11,0,1,0
13,235,235,16,1,15,2,1
15,266,266,5,5,0,1,0
8,272,272,11,11,0,1,0
25,288,288,12,3,9,4,3
1,298,298,21,21,0,1,0
2,304,304,4,4,0,1,0
11,306,306,45,45,0,1,0
16,311,311,17,4,13,2,1
6,312,312,2,2,0,1,0
28,340,340,2,2,0,1,0
18,348,348,168,149,19,2,1
4,350,350,2,2,0,1,0
22,369,369,23,11,12,3,2
3,376,376,53,23,30,2,1
19,379,379,23,23,0,1,0
0,388,388,3,3,0,1,0
23,410,410,46,46,0,1,0
10,413,413,58,58,0,1,0
24,419,419,41,41,0,1,0
7,428,428,31,10,21,3,2
21,431,431,29,29,0,1,0
14,432,432,122,71,51,4,3
12,474,474,220,124,96,3,2
26,482,482,20,11,9,4,3
27,497,497,39,30,9,4,3
31,499,499,95,52,43,4,3

10,112,112,16,16,0,1,0
16,123,123,6,6,0,1,0
23,128,128,20,20,0,1,0
24,129,129,2,2,0,1,0
2,135,135,1,1,0,1,0
21,174,174,5,5,0,1,0
22,185,185,13,2,11,2,1
25,196,196,17,17,0,1,0
13,196,196,11,11,0,1,0
26,214,214,21,21,0,1,0
8,234,234,8,4,4,2,1
17,256,256,21,21,0,1,0
4,263,263,6,6,0,1,0
18,296,296,1,1,0,1,0
7,369,369,98,89,9,2,1
1,369,369,292,292,0,1,0
0,383,383,30,30,0,1,0
27,386,386,62,62,0,1,0
3,401,401,2,2,0,1,0
9,415,415,19,19,0,1,0
12,438,438,139,139,0,1,0
6,440,440,101,98,3,2,1
5,450,450,38,38,0,1,0
19,459,459,135,135,0,1,0
14,461,461,6,3,3,2,1
11,485,485,27,27,0,1,0
20,488,488,94,94,0,1,0
15,492,492,30,14,16,3,2

26,127,127,42,7,35,4,3
2,130,130,5,5,0,1,0
4,132,132,2,2,0,1,0
9,134,134,23,23,0,1,0
29,146,146,8,1,7,2,1
24,156,156,11,11,0,1,0
5,185,185,2,2,0,1,0
1,193,193,2,2,0,1,0
13,193,193,1,1,0,1,0
27,194,194,10,10,0,1,0
21,196,196,22,22,0,1,0
34,220,220,46,46,0,1,0
3,221,221,56,56,0,1,0
10,228,228,1,1,0,1,0
16,244,244,9,2,7,2,1
23,248,248,18,18,0,1,0
18,258,258,10,10,0,1,0
19,262,262,21,21,0,1,0
37,269,269,50,50,0,1,0
30,287,287,41,5,36,3,2
15,298,298,26,26,0,1,0
0,298,298,5,2,3,2,1
17,302,302,36,16,20,2,1
11,323,323,2,2,0,1,0
25,333,333,25,11,14,2,1
36,337,337,13,13,0,1,0
31,342,342,58,45,13,2,1
28,363,363,19,5,14,2,1
35,391,391,12,12,0,1,0
14,401,401,10,10,0,1,0
7,418,418,42,14,28,3,2
8,424,424,71,71,0,1,0
6,431,431,151,88,63,4,3
22,443,443,24,24,0,1,0
32,446,446,18,2,16,2,1
20,470,470,33,9,24,4,3
33,484,484,19,11,8,3,2
12,485,485,45,45,0,1,0

9,100,100,9,9,0,1,0
15,119,119,1,1,0,1,0
8,147,147,69,1,68,3,2
14,187,187,7,3,4,2,1
22,204,204,44,10,34,3,2
25,221,221,42,26,16,2,1
21,238,238,2,2,0,1,0
30,242,242,31,4,27,2,1
28,247,247,1,1,0,1,0
11,259,259,2,2,0,1,0
4,260,260,11,11,0,1,0
0,261,261,53,53,0,1,0
24,267,267,5,5,0,1,0
35,268,268,23,23,0,1,0
31,275,275,15,2,13,3,2
5,299,299,3,3,0,1,0
6,299,299,13,4,9,2,1
19,301,301,48,39,9,2,1
34,316,316,51,5,46,3,2
16,339,339,13,13,0,1,0
17,355,355,106,91,15,2,1
26,355,355,72,61,11,2,1
13,371,371,13,2,11,2,1
12,373,373,14,14,0,1,0
1,385,385,72,72,0,1,0
29,390,390,9,9,0,1,0
10,403,403,25,9,16,2,1
32,413,413,115,37,78,3,2
33,418,418,30,30,0,1,0
18,428,428,29,29,0,1,0
20,437,437,22,22,0,1,0
3,439,439,3,3,0,1,0
27,481,481,29,29,0,1,0
23,485,485,7,7,0,1,0
7,488,488,25,25,0,1,0
2,498,498,2,2,0,1,0

0,108,108,29,29,0,1,0
5,124,124,46,11,35,3,2
2,130,130,15,10,5,2,1
6,135,135,4,4,0,1,0
21,139,139,18,6,12,2,1
24,167,167,24,24,0,1,0
16,174,174,3,3,0,1,0
32,181,181,13,4,9,2,1
22,191,191,3,3,0,1,0
19,191,191,37,37,0,1,0
4,193,193,2,2,0,1,0
31,205,205,19,10,9,2,1
3,220,220,4,4,0,1,0
7,243,243,7,7,0,1,0
17,262,262,14,2,12,4,3
10,272,272,10,10,0,1,0
11,275,275,24,24,0,1,0
20,278,278,20,20,0,1,0
1,282,282,10,10,0,1,0
27,297,297,87,45,42,4,3
14,313,313,50,23,27,4,3
18,367,367,27,27,0,1,0
8,370,370,34,16,18,4,3
28,370,370,25,25,0,1,0
26,386,386,7,7,0,1,0
12,405,405,6,6,0,1,0
29,410,410,24,14,10,2,1
13,424,424,8,8,0,1,0
9,424,424,106,106,0,1,0
23,430,430,22,8,14,3,2
25,459,459,157,107,50,3,2
30,469,469,21,21,0,1,0
15,471,471,77,20,57,4,3

4,100,100,5,5,0,1,0
9,117,117,24,24,0,1,0
35,143,143,16,16,0,1,0
8,145,145,11,5,6,2,1
0,152,152,21,21,0,1,0
22,171,171,50,50,0,1,0
26,174,174,15,15,0,1,0
34,175,175,19,19,0,1,0
24,177,177,41,26,15,4,3
30,184,184,20,6,14,3,2
12,187,187,5,2,3,2,1
18,193,193,10,10,0,1,0
3,201,201,30,2,28,2,1
5,203,203,4,4,0,1,0
21,211,211,31,31,0,1,0
6,256,256,41,29,12,4,3
33,260,260,47,38,9,2,1
27,267,267,9,9,0,1,0
13,270,270,33,33,0,1,0
19,278,278,4,4,0,1,0
23,300,300,1,1,0,1,0
14,305,305,43,19,24,4,3
1,307,307,22,22,0,1,0
29,325,325,3,3,0,1,0
25,364,364,36,36,0,1,0
20,381,381,36,36,0,1,0
7,392,392,51,2,49,4,3
17,392,392,54,48,6,3,2
32,409,409,19,14,5,2,1
2,421,421,52,43,9,4,3
15,430,430,7,7,0,1,0
31,430,430,52,10,42,4,3
28,441,441,16,12,4,2,1
11,457,457,1,1,0,1,0
16,468,468,27,27,0,1,0
10,492,492,11,1,10,2,1

27,117,117,26,26,0,1,0
8,136,136,7,7,0,1,0
14,144,144,2,2,0,1,0
13,151,151,41,32,9,2,1
5,154,154,13,1,12,4,3
17,162,162,6,3,3,2,1
28,163,163,47,13,34,3,2
7,167,167,12,4,8,3,2
15,168,168,4,4,0,1,0
4,224,224,43,31,12,4,3
22,243,243,4,4,0,1,0
18,256,256,9,9,0,1,0
6,266,266,8,8,0,1,0
20,279,279,4,4,0,1,0
11,285,285,41,13,28,3,2
2,298,298,171,69,102,4,3
0,304,304,5,5,0,1,0
29,306,306,37,7,30,4,3
12,320,320,25,25,0,1,0
30,359,359,28,28,0,1,0
26,363,363,24,24,0,1,0
16,367,367,87,87,0,1,0
19,404,404,43,43,0,1,0
25,427,427,15,7,8,3,2
9,447,447,36,36,0,1,0
24,450,450,139,103,36,2,1
21,455,455,50,2,48,4,3
23,460,460,8,8,0,1,0
10,460,460,17,3,14,3,2
1,483,483,22,19,3,2,1
3,494,494,12,12,0,1,0

23,102,102,9,9,0,1,0
25,116,116,1,1,0,1,0
7,126,126,4,4,0,1,0
21,128,128,18,18,0,1,0
12,143,143,22,3,19,2,1
28,167,167,2,2,0,1,0
16,181,181,4,1,3,2,1
8,214,214,1,1,0,1,0
26,227,227,7,2,5,2,1
5,247,247,18,18,0,1,0
22,264,264,3,3,0,1,0
9,269,269,12,12,0,1,0
13,273,273,17,1,16,2,1
31,282,282,9,9,0,1,0
4,287,287,16,10,6,2,1
20,317,317,148,148,0,1,0
2,353,353,22,5,17,2,1
24,353,353,85,17,68,3,2
30,365,365,16,13,3,2,1
18,367,367,57,39,18,3,2
27,379,379,7,7,0,1,0
3,399,399,74,46,28,3,2
32,400,400,53,53,0,1,0
10,414,414,3,3,0,1,0
15,414,414,58,58,0,1,0
11,416,416,17,9,8,2,1
17,420,420,23,9,14,3,2
19,423,423,81,13,68,3,2
14,436,436,86,35,51,4,3
33,440,440,25,25,0,1,0
29,484,484,24,12,12,4,3
1,484,484,92,92,0,1,0
6,485,485,69,69,0,1,0
0,497,497,144,51,93,4,3

21,132,132,26,26,0,1,0
2,133,133,7,7,0,1,0
13,152,152,13,13,0,1,0
1,173,173,1,1,0,1,0
25,186,186,24,6,18,2,1
35,217,217,14,14,0,1,0
34,235,235,9,5,4,2,1
37,239,239,8,8,0,1,0
7,264,264,9,2,7,2,1
22,266,266,78,78,0,1,0
26,267,267,21,18,3,2,1
17,269,269,40,2,38,3,2
16,283,283,34,14,20,2,1
9,296,296,14,6,8,2,1
28,301,301,44,34,10,3,2
36,307,307,14,2,12,2,1
14,316,316,58,58,0,1,0
8,323,323,27,10,17,2,1
33,330,330,7,1,6,3,2
10,335,335,32,7,25,2,1
15,353,353,5,5,0,1,0
24,357,357,22,12,10,2,1
12,358,358,1,1,0,1,0
3,364,364,25,25,0,1,0
23,376,376,59,59,0,1,0
29,384,384,29,29,0,1,0
32,402,402,76,23,53,3,2
20,410,410,105,73,32,3,2
31,417,417,25,2,23,4,3
18,427,427,18,3,15,4,3
0,438,438,71,71,0,1,0
6,442,442,43,31,12,4,3
11,447,447,21,21,0,1,0
19,447,447,25,10,15,4,3
4,449,449,10,10,0,1,0
27,450,450,39,19,20,2,1
5,467,467,36,36,0,1,0
30,495,495,27,1,26,2,1

12,100,100,31,31,0,1,0
2,121,121,1,1,0,1,0
31,138,138,7,7,0,1,0
28,168,168,6,6,0,1,0
14,189,189,1,1,0,1,0
9,196,196,21,21,0,1,0
0,201,201,3,3,0,1,0
10,212,212,12,12,0,1,0
26,219,219,93,93,0,1,0
8,228,228,13,13,0,1,0
30,237,237,27,27,0,1,0
3,262,262,87,36,51,4,3
6,265,265,1,1,0,1,0
32,281,281,46,20,26,2,1
17,291,291,82,82,0,1,0
22,298,298,27,27,0,1,0
24,302,302,35,22,13,2,1
5,318,318,10,10,0,1,0
21,331,331,13,9,4,2,1
33,347,347,3,3,0,1,0
25,349,349,3,3,0,1,0
1,349,349,71,71,0,1,0
13,368,368,8,8,0,1,0
23,375,375,37,37,0,1,0
27,381,381,15,3,12,3,2
4,391,391,70,70,0,1,0
15,398,398,5,5,0,1,0
7,414,414,29,17,12,3,2
19,419,419,30,6,24,2,1
11,420,420,94,56,38,2,1
20,447,447,7,2,5,2,1
18,458,458,60,60,0,1,0
29,482,482,18,18,0,1,0
16,493,493,31,31,0,1,0

16,102,102,22,11,11,2,1
21,141,141,4,4,0,1,0
31,144,144,5,5,0,1,0
7,164,164,61,17,44,3,2
30,175,175,1,1,0,1,0
27,187,187,53,7,46,3,2
12,187,187,1,1,0,1,0
15,200,200,14,4,10,2,1
13,216,216,27,27,0,1,0
6,227,227,6,6,0,1,0
29,230,230,20,20,0,1,0
11,256,256,23,23,0,1,0
28,259,259,7,7,0,1,0
8,271,271,73,73,0,1,0
18,278,278,78,78,0,1,0
23,282,282,28,7,21,4,3
24,283,283,12,12,0,1,0
0,289,289,6,1,5,2,1
10,338,338,26,4,22,3,2
25,352,352,2,2,0,1,0
4,361,361,13,2,11,3,2
2,365,365,65,65,0,1,0
3,368,368,42,27,15,2,1
26,370,370,11,11,0,1,0
20,381,381,62,62,0,1,0
9,417,417,15,15,0,1,0
22,439,439,46,10,36,4,3
5,453,453,85,85,0,1,0
17,467,467,18,13,5,2,1
19,468,468,103,81,22,3,2
1,479,479,20,20,0,1,0
14,497,497,61,61,0,1,0

21,161,161,4,4,0,1,0
2,164,164,24,24,0,1,0
14,166,166,22,22,0,1,0
10,207,207,16,16,0,1,0
8,212,212,79,53,26,3,2
32,231,231,13,1,12,3,2
16,237,237,8,8,0,1,0
12,242,242,1,1,0,1,0
22,248,248,13,13,0,1,0
13,257,257,35,7,28,3,2
30,274,274,8,8,0,1,0
1,285,285,28,15,13,2,1
7,286,286,22,22,0,1,0
9,296,296,3,3,0,1,0
6,301,301,46,18,28,3,2
23,315,315,26,26,0,1,0
3,322,322,7,1,6,2,1
28,322,322,142,64,78,4,3
26,324,324,76,76,0,1,0
29,355,355,16,16,0,1,0
25,366,366,51,43,8,3,2
0,373,373,88,40,48,3,2
5,390,390,1,1,0,1,0
31,400,400,53,12,41,2,1
19,401,401,23,20,3,2,1
24,420,420,47,47,0,1,0
15,441,441,25,5,20,3,2
20,449,449,30,20,10,2,1
11,461,461,26,17,9,3,2
27,463,463,34,14,20,3,2
18,469,469,4,4,0,1,0
17,475,475,65,65,0,1,0
4,478,478,58,52,6,3,2

33,123,123,9,3,6,3,2
8,141,141,17,17,0,1,0
18,141,141,1,1,0,1,0
3,160,160,9,9,0,1,0
29,164,164,3,3,0,1,0
35,165,165,55,55,0,1,0
21,166,166,12,12,0,1,0
22,183,183,47,13,34,3,2
26,190,190,1,1,0,1,0
2,190,190,4,4,0,1,0
15,192,192,9,9,0,1,0
17,194,194,30,15,15,2,1
13,206,206,35,35,0,1,0
10,219,219,39,20,19,2,1
16,219,219,19,19,0,1,0
24,222,222,78,78,0,1,0
6,232,232,17,12,5,2,1
4,305,305,22,22,0,1,0
5,321,321,29,29,0,1,0
1,328,328,8,2,6,3,2
28,331,331,19,19,0,1,0
32,332,332,7,7,0,1,0
11,342,342,88,88,0,1,0
20,353,353,1,1,0,1,0
23,360,360,5,5,0,1,0
36,362,362,64,2,62,4,3
31,389,389,19,1,18,3,2
19,436,436,12,1,11,2,1
7,442,442,1,1,0,1,0
14,443,443,47,47,0,1,0
12,452,452,70,27,43,2,1
30,459,459,2,2,0,1,0
27,470,470,20,20,0,1,0
0,471,471,15,15,0,1,0
34,473,473,38,38,0,1,0
25,478,478,84,84,0,1,0
9,488,488,10,5,5,2,1

11,103,103,7,1,6,3,2
3,121,121,1,1,0,1,0
32,124,124,14,14,0,1,0
7,145,145,23,23,0,1,0
18,161,161,1,1,0,1,0
19,162,162,12,12,0,1,0
29,175,175,7,1,6,2,1
5,181,181,2,2,0,1,0
12,190,190,2,2,0,1,0
24,205,205,26,26,0,1,0
37,210,210,11,11,0,1,0
17,222,222,7,7,0,1,0
2,228,228,30,12,18,2,1
23,261,261,7,7,0,1,0
34,264,264,26,12,14,2,1
8,274,274,4,4,0,1,0
40,277,277,18,10,8,2,1
38,282,282,58,21,37,2,1
30,299,299,26,26,0,1,0
16,307,307,20,20,0,1,0
6,317,317,89,89,0,1,0
21,328,328,30,3,27,4,3
28,344,344,30,30,0,1,0
1,344,344,42,42,0,1,0
25,351,351,6,6,0,1,0
39,366,366,18,18,0,1,0
0,369,369,1,1,0,1,0
35,375,375,33,27,6,2,1
13,382,382,18,18,0,1,0
4,398,398,9,1,8,3,2
31,404,404,77,24,53,4,3
26,413,413,76,64,12,3,2
41,429,429,97,79,18,4,3
14,431,431,1,1,0,1,0
22,442,442,18,6,12,4,3
10,443,443,16,6,10,2,1
20,468,468,2,2,0,1,0
33,471,471,78,46,32,2,1
36,473,473,19,19,0,1,0
27,475,475,12,12,0,1,0
15,475,475,76,16,60,4,3
9,500,500,80,80,0,1,0

25,120,120,10,10,0,1,0
23,128,128,1,1,0,1,0
2,129,129,3,3,0,1,0
34,135,135,25,20,5,2,1
11,143,143,40,25,15,2,1
31,144,144,8,8,0,1,0
33,144,144,6,6,0,1,0
9,164,164,5,1,4,2,1
15,166,166,1,1,0,1,0
30,173,173,6,3,3,2,1
4,183,183,11,7,4,2,1
18,186,186,57,57,0,1,0
17,219,219,24,3,21,2,1
39,225,225,3,3,0,1,0
0,227,227,28,7,21,2,1
22,252,252,1,1,0,1,0
21,273,273,4,4,0,1,0
38,275,275,98,2,96,4,3
35,295,295,16,16,0,1,0
5,297,297,6,6,0,1,0
7,304,304,16,16,0,1,0
26,307,307,20,20,0,1,0
8,327,327,1,1,0,1,0
40,331,331,49,27,22,2,1
12,349,349,4,4,0,1,0
3,350,350,7,7,0,1,0
6,371,371,36,29,7,2,1
32,380,380,27,18,9,2,1
1,382,382,36,17,19,2,1
24,409,409,49,49,0,1,0
13,419,419,15,15,0,1,0
20,423,423,27,5,22,4,3
29,444,444,141,47,94,3,2
28,451,451,37,17,20,3,2
27,454,454,16,16,0,1,0
10,462,462,52,52,0,1,0
16,472,472,1,1,0,1,0
36,474,474,35,6,29,2,1
14,480,480,16,10,6,3,2
19,484,484,94,82,12,4,3
37,499,499,2,2,0,1,0

33,103,103,5,5,0,1,0
3,104,104,3,3,0,1,0
21,113,113,6,6,0,1,0
14,118,118,1,1,0,1,0
25,143,143,1,1,0,1,0
15,164,164,1,1,0,1,0
11,196,196,2,2,0,1,0
13,228,228,23,23,0,1,0
2,228,228,7,4,3,2,1
12,229,229,10,10,0,1,0
31,259,259,1,1,0,1,0
29,261,261,25,15,10,2,1
35,274,274,2,2,0,1,0
4,279,279,14,4,10,3,2
16,281,281,41,14,27,2,1
18,300,300,33,33,0,1,0
20,302,302,11,2,9,2,1
8,348,348,45,45,0,1,0
30,354,354,95,89,6,2,1
32,355,355,35,35,0,1,0
10,376,376,8,8,0,1,0
23,377,377,40,40,0,1,0
24,383,383,40,40,0,1,0
7,395,395,23,23,0,1,0
27,396,396,19,19,0,1,0
17,407,407,32,10,22,3,2
38,408,408,8,8,0,1,0
19,418,418,1,1,0,1,0
37,422,422,50,2,48,3,2
0,426,426,12,4,8,2,1
5,432,432,152,83,69,4,3
36,439,439,138,66,72,3,2
28,440,440,157,101,56,3,2
9,440,440,79,40,39,4,3
1,458,458,47,15,32,4,3
34,472,472,9,9,0,1,0
26,478,478,38,38,0,1,0
22,480,480,14,14,0,1,0
6,481,481,60,60,0,1,0

22,103,103,25,5,20,3,2
15,110,110,1,1,0,1,0
11,111,111,1,1,0,1,0
2,132,132,5,5,0,1,0
40,132,132,2,2,0,1,0
23,142,142,2,2,0,1,0
30,152,152,33,17,16,2,1
16,161,161,1,1,0,1,0
18,173,173,1,1,0,1,0
41,177,177,32,10,22,2,1
36,182,182,16,16,0,1,0
14,183,183,1,1,0,1,0
38,190,190,8,8,0,1,0
13,194,194,4,4,0,1,0
39,203,203,1,1,0,1,0
9,206,206,10,10,0,1,0
33,215,215,32,24,8,3,2
28,220,220,29,29,0,1,0
43,240,240,31,31,0,1,0
29,260,260,18,8,10,2,1
3,280,280,34,1,33,4,3
0,283,283,34,34,0,1,0
24,290,290,19,19,0,1,0
7,292,292,20,20,0,1,0
37,319,319,12,4,8,2,1
5,321,321,18,18,0,1,0
32,324,324,13,2,11,4,3
27,361,361,22,22,0,1,0
20,361,361,29,29,0,1,0
26,376,376,32,12,20,2,1
42,380,380,27,3,24,4,3
4,393,393,1,1,0,1,0
25,406,406,10,4,6,3,2
34,415,415,11,11,0,1,0
8,415,415,39,11,28,2,1
10,418,418,59,59,0,1,0
6,419,419,41,18,23,2,1
31,451,451,131,131,0,1,0
17,458,458,62,24,38,2,1
12,479,479,2,2,0,1,0
19,480,480,1,1,0,1,0
21,481,481,4,4,0,1,0
35,493,493,88,22,66,4,3
1,495,495,97,82,15,4,3

19,110,110,9,1,8,2,1
27,115,115,7,7,0,1,0
11,141,141,11,11,0,1,0
31,142,142,21,21,0,1,0
0,143,143,5,5,0,1,0
21,143,143,3,3,0,1,0
25,155,155,4,4,0,1,0
7,167,167,1,1,0,1,0
22,167,167,2,2,0,1,0
28,239,239,9,9,0,1,0
9,242,242,65,23,42,4,3
10,244,244,14,14,0,1,0
6,257,257,16,4,12,4,3
17,259,259,1,1,0,1,0
26,275,275,121,49,72,3,2
15,276,276,72,40,32,2,1
4,302,302,1,1,0,1,0
3,343,343,104,104,0,1,0
16,349,349,45,30,15,4,3
14,361,361,6,6,0,1,0
20,370,370,36,36,0,1,0
2,370,370,21,21,0,1,0
12,373,373,86,86,0,1,0
29,402,402,15,15,0,1,0
23,405,405,6,6,0,1,0
33,406,406,170,121,49,2,1
13,417,417,1,1,0,1,0
24,420,420,61,30,31,2,1
1,433,433,19,8,11,2,1
32,438,438,66,42,24,4,3
5,444,444,57,29,28,3,2
30,482,482,17,13,4,2,1
18,483,483,9,9,0,1,0
8,487,487,10,10,0,1,0

9,110,110,11,11,0,1,0
33,139,139,3,3,0,1,0
14,145,145,9,9,0,1,0
21,163,163,34,34,0,1,0
29,183,183,33,33,0,1,0
11,200,200,6,6,0,1,0
22,200,200,28,11,17,2,1
27,202,202,2,2,0,1,0
8,212,212,18,18,0,1,0
15,219,219,35,1,34,2,1
20,220,220,60,37,23,2,1
13,232,232,11,6,5,2,1
24,243,243,2,2,0,1,0
28,251,251,24,3,21,4,3
35,257,257,6,6,0,1,0
34,261,261,26,26,0,1,0
32,275,275,5,5,0,1,0
26,300,300,35,35,0,1,0
0,307,307,37,37,0,1,0
2,308,308,31,22,9,2,1
17,320,320,110,14,96,3,2
12,343,343,25,25,0,1,0
7,357,357,6,2,4,2,1
6,359,359,46,46,0,1,0
18,364,364,6,6,0,1,0
1,396,396,74,34,40,2,1
23,403,403,12,12,0,1,0
19,404,404,40,30,10,2,1
25,416,416,30,14,16,2,1
30,416,416,141,27,114,4,3
10,418,418,17,17,0,1,0
4,451,451,28,12,16,2,1
5,457,457,46,46,0,1,0
3,472,472,5,5,0,1,0
31,487,487,3,3,0,1,0
16,490,490,8,8,0,1,0

15,106,106,3,3,0,1,0
14,120,120,4,1,3,2,1
33,120,120,32,14,18,4,3
10,147,147,12,12,0,1,0
18,160,160,16,10,6,3,2
31,164,164,8,8,0,1,0
23,176,176,3,3,0,1,0
21,187,187,6,3,3,2,1
12,190,190,85,85,0,1,0
9,192,192,4,4,0,1,0
1,202,202,26,26,0,1,0
24,241,241,16,4,12,2,1
29,262,262,41,9,32,4,3
25,297,297,81,81,0,1,0
6,315,315,14,7,7,2,1
2,317,317,20,20,0,1,0
35,324,324,83,83,0,1,0
22,329,329,9,9,0,1,0
11,332,332,4,4,0,1,0
26,336,336,1,1,0,1,0
37,336,336,26,26,0,1,0
28,336,336,1,1,0,1,0
32,336,336,30,3,27,4,3
4,337,337,17,17,0,1,0
34,338,338,121,35,86,4,3
19,345,345,11,4,7,2,1
30,349,349,3,3,0,1,0
20,367,367,17,8,9,4,3
36,392,392,2,2,0,1,0
5,393,393,17,17,0,1,0
7,407,407,20,20,0,1,0
27,410,410,14,14,0,1,0
8,418,418,37,37,0,1,0
16,439,439,29,29,0,1,0
13,466,466,79,79,0,1,0
0,471,471,20,8,12,4,3
17,476,476,7,7,0,1,0
3,500,500,69,69,0,1,0

30,101,101,21,21,0,1,0
17,108,108,18,18,0,1,0
10,116,116,18,18,0,1,0
14,139,139,9,1,8,3,2
13,141,141,15,15,0,1,0
11,148,148,31,31,0,1,0
1,165,165,5,5,0,1,0
2,170,170,12,12,0,1,0
15,177,177,1,1,0,1,0
35,186,186,3,3,0,1,0
3,193,193,25,13,12,2,1
36,214,214,5,5,0,1,0
23,215,215,19,19,0,1,0
22,216,216,7,7,0,1,0
19,224,224,1,1,0,1,0
12,243,243,2,2,0,1,0
21,255,255,6,6,0,1,0
34,263,263,12,12,0,1,0
20,287,287,44,44,0,1,0
31,290,290,45,9,36,2,1
27,292,292,52,52,0,1,0
0,317,317,1,1,0,1,0
29,334,334,29,13,16,2,1
8,351,351,8,2,6,3,2
32,383,383,58,43,15,4,3
26,388,388,12,1,11,2,1
6,397,397,15,10,5,2,1
9,402,402,84,84,0,1,0
25,411,411,62,20,42,4,3
16,412,412,7,7,0,1,0
4,427,427,1,1,0,1,0
5,448,448,45,39,6,3,2
7,449,449,93,93,0,1,0
28,465,465,81,43,38,2,1
24,468,468,88,67,21,4,3
18,493,493,75,67,8,2,1
33,498,498,10,10,0,1,0

9,122,122,7,2,5,2,1
4,127,127,23,23,0,1,0
5,131,131,2,2,0,1,0
24,181,181,54,16,38,3,2
0,187,187,86,64,22,3,2
12,229,229,4,4,0,1,0
1,249,249,17,17,0,1,0
14,257,257,3,3,0,1,0
13,260,260,18,18,0,1,0
22,268,268,43,31,12,3,2
17,276,276,9,2,7,2,1
18,279,279,14,14,0,1,0
3,282,282,62,20,42,4,3
11,297,297,11,11,0,1,0
21,306,306,6,3,3,2,1
20,307,307,40,40,0,1,0
27,313,313,27,27,0,1,0
16,345,345,33,33,0,1,0
15,351,351,18,18,0,1,0
28,353,353,30,30,0,1,0
10,354,354,31,16,15,4,3
7,364,364,137,109,28,2,1
23,397,397,15,15,0,1,0
26,402,402,152,152,0,1,0
2,411,411,64,47,17,2,1
29,413,413,5,2,3,2,1
6,465,465,3,3,0,1,0
25,477,477,64,64,0,1,0
19,492,492,37,1,36,3,2
8,498,498,9,1,8,3,2

2,100,100,3,3,0,1,0
25,108,108,56,1,55,3,2
20,116,116,32,8,24,2,1
1,117,117,1,1,0,1,0
29,119,119,1,1,0,1,0
7,129,129,31,31,0,1,0
27,131,131,2,2,0,1,0
18,150,150,8,8,0,1,0
24,152,152,5,5,0,1,0
13,164,164,5,5,0,1,0
17,166,166,13,13,0,1,0
11,184,184,20,20,0,1,0
5,199,199,11,11,0,1,0
32,250,250,5,5,0,1,0
15,255,255,52,52,0,1,0
12,255,255,27,16,11,2,1
0,260,260,13,13,0,1,0
26,265,265,49,12,37,2,1
34,269,269,17,17,0,1,0
4,285,285,1,1,0,1,0
22,291,291,35,35,0,1,0
35,312,312,25,8,17,3,2
16,335,335,87,78,9,4,3
8,338,338,47,17,30,4,3
28,356,356,13,13,0,1,0
23,357,357,26,26,0,1,0
21,363,363,37,10,27,4,3
10,377,377,42,42,0,1,0
6,414,414,75,63,12,3,2
9,430,430,9,3,6,3,2
14,454,454,1,1,0,1,0
3,464,464,9,9,0,1,0
30,465,465,49,49,0,1,0
33,472,472,29,24,5,2,1
31,475,475,4,4,0,1,0
19,493,493,11,11,0,1,0

0,104,104,9,9,0,1,0
26,132,132,22,18,4,2,1
1,155,155,2,2,0,1,0
23,184,184,34,34,0,1,0
15,200,200,3,3,0,1,0
37,210,210,38,38,0,1,0
20,212,212,28,28,0,1,0
27,222,222,2,2,0,1,0
5,241,241,16,8,8,2,1
30,250,250,39,39,0,1,0
25,258,258,56,56,0,1,0
14,261,261,66,6,60,3,2
11,262,262,23,23,0,1,0
8,272,272,6,1,5,2,1
19,281,281,1,1,0,1,0
3,283,283,27,16,11,2,1
31,290,290,70,42,28,3,2
24,294,294,17,17,0,1,0
33,300,300,18,12,6,3,2
6,301,301,50,27,23,2,1
18,309,309,52,18,34,2,1
36,312,312,2,2,0,1,0
12,334,334,16,16,0,1,0
29,342,342,12,12,0,1,0
39,342,342,39,39,0,1,0
9,348,348,2,2,0,1,0
4,367,367,27,27,0,1,0
16,379,379,4,1,3,2,1
28,387,387,39,6,33,4,3
21,397,397,34,16,18,4,3
2,407,407,16,1,15,4,3
22,423,423,71,71,0,1,0
10,426,426,39,31,8,3,2
32,433,433,7,4,3,2,1
38,440,440,11,11,0,1,0
34,445,445,50,50,0,1,0
13,449,449,9,9,0,1,0
17,458,458,6,6,0,1,0
35,459,459,24,9,15,4,3
7,488,488,18,3,15,2,1

37,101,101,5,5,0,1,0
3,124,124,37,37,0,1,0
25,128,128,10,2,8,3,2
28,128,128,21,8,13,2,1
1,140,140,12,12,0,1,0
11,140,140,7,2,5,2,1
4,142,142,1,1,0,1,0
17,164,164,31,31,0,1,0
35,190,190,8,8,0,1,0
16,197,197,2,2,0,1,0
22,199,199,27,27,0,1,0
18,205,205,4,4,0,1,0
39,207,207,4,4,0,1,0
5,214,214,13,6,7,2,1
32,233,233,52,40,12,2,1
8,237,237,32,32,0,1,0
33,237,237,19,19,0,1,0
6,245,245,5,5,0,1,0
19,254,254,5,1,4,2,1
38,276,276,142,142,0,1,0
2,290,290,1,1,0,1,0
24,291,291,19,19,0,1,0
9,314,314,5,5,0,1,0
15,321,321,36,23,13,2,1
29,323,323,32,22,10,3,2
31,353,353,5,5,0,1,0
21,362,362,5,5,0,1,0
26,362,362,7,7,0,1,0
40,371,371,40,1,39,2,1
13,384,384,4,4,0,1,0
34,392,392,2,2,0,1,0
27,413,413,10,1,9,2,1
0,418,418,6,1,5,2,1
23,422,422,16,16,0,1,0
36,425,425,10,10,0,1,0
41,450,450,98,64,34,3,2
12,458,458,32,32,0,1,0
10,460,460,8,8,0,1,0
20,474,474,63,3,60,4,3
14,474,474,76,34,42,2,1
7,488,488,8,3,5,2,1
30,492,492,29,29,0,1,0

20,108,108,18,18,0,1,0
31,113,113,7,7,0,1,0
15,120,120,9,1,8,2,1
14,121,121,12,5,7,2,1
22,122,122,10,10,0,1,0
24,132,132,10,10,0,1,0
2,220,220,9,6,3,2,1
21,229,229,52,52,0,1,0
26,244,244,9,9,0,1,0
19,246,246,14,2,12,2,1
27,261,261,16,4,12,4,3
8,264,264,21,13,8,3,2
0,269,269,108,91,17,2,1
29,299,299,74,10,64,3,2
6,317,317,3,3,0,1,0
17,323,323,42,42,0,1,0
4,332,332,4,4,0,1,0
9,345,345,13,7,6,2,1
18,349,349,46,46,0,1,0
23,360,360,12,12,0,1,0
30,385,385,4,4,0,1,0
11,423,423,6,6,0,1,0
25,427,427,83,83,0,1,0
28,432,432,3,3,0,1,0
3,433,433,165,134,31,2,1
7,440,440,16,6,10,3,2
1,483,483,8,8,0,1,0
10,485,485,86,34,52,3,2
13,489,489,4,4,0,1,0
16,493,493,74,65,9,2,1
12,494,494,58,30,28,2,1
5,500,500,136,112,24,3,2

29,121,121,6,6,0,1,0
24,124,124,3,3,0,1,0
25,141,141,2,2,0,1,0
26,154,154,3,3,0,1,0
7,197,197,21,21,0,1,0
9,201,201,4,4,0,1,0
6,206,206,23,23,0,1,0
8,215,215,19,3,16,2,1
3,224,224,58,26,32,3,2
28,235,235,6,6,0,1,0
20,243,243,44,29,15,4,3
14,249,249,14,7,7,2,1
5,266,266,22,22,0,1,0
2,279,279,86,12,74,3,2
1,285,285,22,8,14,3,2
15,285,285,75,45,30,4,3
16,286,286,66,66,0,1,0
10,302,302,44,44,0,1,0
18,309,309,48,27,21,2,1
4,333,333,32,32,0,1,0
17,364,364,24,14,10,3,2
21,377,377,46,46,0,1,0
19,399,399,17,17,0,1,0
27,403,403,65,55,10,3,2
30,404,404,48,48,0,1,0
23,414,414,62,62,0,1,0
13,467,467,60,49,11,2,1
11,468,468,9,9,0,1,0
12,473,473,94,85,9,4,3
0,477,477,28,28,0,1,0
22,485,485,29,29,0,1,0

1,110,110,7,7,0,1,0
9,121,121,1,1,0,1,0
15,121,121,2,2,0,1,0
27,128,128,4,4,0,1,0
31,129,129,2,2,0,1,0
32,136,136,19,19,0,1,0
2,151,151,23,16,7,2,1
13,159,159,8,5,3,2,1
10,166,166,4,4,0,1,0
23,171,171,1,1,0,1,0
11,176,176,13,1,12,2,1
6,225,225,49,49,0,1,0
24,229,229,18,18,0,1,0
14,238,238,1,1,0,1,0
19,246,246,106,106,0,1,0
5,263,263,31,31,0,1,0
18,279,279,16,7,9,2,1
20,282,282,89,35,54,3,2
28,308,308,8,5,3,2,1
30,314,314,15,15,0,1,0
4,315,315,19,19,0,1,0
29,322,322,33,33,0,1,0
16,326,326,11,1,10,2,1
25,340,340,6,6,0,1,0
22,360,360,79,79,0,1,0
12,372,372,53,53,0,1,0
8,373,373,19,10,9,2,1
17,377,377,26,15,11,2,1
21,402,402,24,21,3,2,1
0,403,403,81,81,0,1,0
26,440,440,36,2,34,3,2
7,457,457,175,131,44,3,2
3,471,471,66,66,0,1,0

0,100,100,1,1,0,1,0
27,108,108,1,1,0,1,0
32,116,116,4,4,0,1,0
36,122,122,5,1,4,2,1
10,147,147,1,1,0,1,0
25,149,149,39,29,10,2,1
33,152,152,12,12,0,1,0
12,158,158,13,13,0,1,0
28,170,170,32,24,8,2,1
3,178,178,23,14,9,4,3
30,178,178,2,2,0,1,0
7,188,188,42,42,0,1,0
38,193,193,6,2,4,2,1
37,196,196,18,8,10,3,2
4,226,226,14,14,0,1,0
17,227,227,1,1,0,1,0
15,250,250,6,2,4,2,1
23,266,266,11,11,0,1,0
26,274,274,25,13,12,4,3
18,290,290,21,21,0,1,0
5,291,291,3,3,0,1,0
9,322,322,49,49,0,1,0
21,327,327,41,14,27,2,1
16,331,331,9,3,6,3,2
29,334,334,40,40,0,1,0
20,338,338,22,6,16,2,1
24,347,347,52,52,0,1,0
11,348,348,1,1,0,1,0
22,386,386,145,43,102,4,3
8,407,407,40,40,0,1,0
1,411,411,68,68,0,1,0
13,423,423,5,5,0,1,0
2,431,431,53,17,36,3,2
34,450,450,72,72,0,1,0
19,459,459,103,2,101,4,3
14,461,461,7,7,0,1,0
31,465,465,4,4,0,1,0
6,475,475,31,18,13,2,1
35,498,498,30,30,0,1,0

12,110,110,50,6,44,3,2
4,131,131,3,3,0,1,0
25,133,133,13,9,4,2,1
10,141,141,2,2,0,1,0
2,151,151,38,13,25,2,1
5,159,159,4,1,3,2,1
11,161,161,39,39,0,1,0
31,172,172,58,18,40,3,2
20,176,176,37,21,16,3,2
29,183,183,13,3,10,3,2
14,200,200,5,1,4,2,1
18,206,206,2,2,0,1,0
1,245,245,4,4,0,1,0
16,263,263,13,13,0,1,0
7,268,268,23,16,7,2,1
21,286,286,2,2,0,1,0
3,297,297,7,7,0,1,0
13,317,317,15,12,3,2,1
22,338,338,6,3,3,2,1
27,365,365,3,3,0,1,0
6,416,416,42,4,38,3,2
8,419,419,18,5,13,2,1
0,431,431,146,146,0,1,0
15,439,439,8,4,4,2,1
19,450,450,39,39,0,1,0
24,461,461,164,19,145,4,3
28,478,478,16,16,0,1,0
9,488,488,6,3,3,2,1
26,491,491,56,56,0,1,0
17,494,494,65,11,54,3,2
30,497,497,46,46,0,1,0
23,499,499,43,1,42,3,2

14,117,117,10,1,9,2,1
12,133,133,12,3,9,2,1
25,142,142,11,7,4,2,1
19,143,143,26,14,12,4,3
7,146,146,44,44,0,1,0
10,159,159,44,44,0,1,0
11,168,168,24,12,12,2,1
31,173,173,30,30,0,1,0
21,195,195,14,14,0,1,0
33,202,202,2,2,0,1,0
9,207,207,2,2,0,1,0
29,220,220,80,80,0,1,0
8,230,230,3,3,0,1,0
6,233,233,3,3,0,1,0
2,252,252,6,6,0,1,0
17,270,270,33,6,27,4,3
18,271,271,23,10,13,2,1
26,277,277,6,6,0,1,0
0,295,295,1,1,0,1,0
23,304,304,3,3,0,1,0
3,305,305,3,3,0,1,0
32,315,315,13,13,0,1,0
22,323,323,48,48,0,1,0
20,332,332,10,1,9,4,3
16,350,350,1,1,0,1,0
27,359,359,10,10,0,1,0
28,398,398,2,2,0,1,0
5,412,412,2,2,0,1,0
1,417,417,52,14,38,2,1
30,420,420,18,18,0,1,0
4,423,423,15,2,13,2,1
15,432,432,97,59,38,3,2
24,453,453,146,76,70,3,2
13,455,455,154,48,106,4,3

1,100,100,7,4,3,2,1
7,102,102,1,1,0,1,0
10,103,103,18,7,11,2,1
15,109,109,6,6,0,1,0
13,115,115,2,2,0,1,0
24,120,120,28,28,0,1,0
20,143,143,15,9,6,2,1
28,144,144,14,14,0,1,0
0,148,148,8,8,0,1,0
34,148,148,4,4,0,1,0
32,161,161,29,29,0,1,0
11,193,193,8,8,0,1,0
31,212,212,2,2,0,1,0
19,227,227,11,3,8,3,2
22,233,233,67,67,0,1,0
29,252,252,9,9,0,1,0
2,265,265,15,9,6,2,1
8,265,265,28,17,11,2,1
12,268,268,13,1,12,2,1
27,283,283,64,43,21,2,1
6,301,301,62,46,16,3,2
17,310,310,3,3,0,1,0
30,311,311,25,25,0,1,0
18,320,320,77,14,63,4,3
35,350,350,18,18,0,1,0
16,359,359,26,26,0,1,0
21,365,365,1,1,0,1,0
26,369,369,8,8,0,1,0
3,370,370,2,2,0,1,0
4,371,371,159,60,99,4,3
14,375,375,3,3,0,1,0
9,375,375,3,3,0,1,0
25,418,418,48,48,0,1,0
5,449,449,19,19,0,1,0
23,457,457,17,17,0,1,0
36,459,459,34,34,0,1,0
33,463,463,74,29,45,4,3

10,108,108,7,4,3,2,1
26,128,128,19,3,16,2,1
18,154,154,16,16,0,1,0
32,158,158,1,1,0,1,0
16,166,166,1,1,0,1,0
7,166,166,37,11,26,3,2
12,174,174,3,3,0,1,0
1,179,179,13,1,12,3,2
23,185,185,2,2,0,1,0
20,199,199,16,1,15,2,1
13,212,212,3,3,0,1,0
28,213,213,38,38,0,1,0
9,218,218,40,40,0,1,0
4,219,219,31,31,0,1,0
15,227,227,6,6,0,1,0
25,261,261,38,38,0,1,0
11,271,271,20,20,0,1,0
27,277,277,6,1,5,2,1
14,286,286,5,5,0,1,0
29,287,287,36,36,0,1,0
22,291,291,19,2,17,2,1
33,295,295,163,130,33,4,3
6,322,322,13,2,11,2,1
2,330,330,102,49,53,4,3
21,382,382,31,31,0,1,0
31,399,399,2,2,0,1,0
8,402,402,48,26,22,3,2
3,405,405,1,1,0,1,0
0,412,412,129,33,96,4,3
30,456,456,2,2,0,1,0
17,465,465,16,16,0,1,0
24,495,495,36,29,7,2,1
5,495,495,39,21,18,3,2
19,498,498,50,44,6,2,1

2,108,108,6,6,0,1,0
9,167,167,117,105,12,3,2
23,170,170,22,22,0,1,0
19,172,172,68,68,0,1,0
7,174,174,3,3,0,1,0
11,181,181,1,1,0,1,0
29,212,212,4,4,0,1,0
4,213,213,15,15,0,1,0
18,227,227,7,7,0,1,0
1,248,248,22,22,0,1,0
3,255,255,1,1,0,1,0
27,275,275,47,47,0,1,0
32,294,294,5,5,0,1,0
22,295,295,60,36,24,4,3
28,298,298,5,5,0,1,0
20,300,300,21,17,4,2,1
17,302,302,24,24,0,1,0
16,315,315,27,3,24,3,2
13,315,315,25,4,21,2,1
21,316,316,38,1,37,2,1
10,316,316,29,29,0,1,0
14,321,321,25,2,23,4,3
33,325,325,1,1,0,1,0
12,325,325,29,29,0,1,0
25,345,345,6,6,0,1,0
6,362,362,45,45,0,1,0
26,367,367,94,82,12,3,2
15,380,380,1,1,0,1,0
24,392,392,15,3,12,4,3
5,402,402,20,20,0,1,0
30,415,415,54,54,0,1,0
31,428,428,10,10,0,1,0
0,437,437,1,1,0,1,0
8,457,457,71,27,44,3,2

25,103,103,8,8,0,1,0
30,107,107,13,8,5,2,1
29,107,107,33,33,0,1,0
10,108,108,1,1,0,1,0
35,110,110,24,6,18,3,2
8,145,145,9,9,0,1,0
12,146,146,9,9,0,1,0
28,156,156,7,7,0,1,0
31,166,166,13,13,0,1,0
27,167,167,6,6,0,1,0
22,228,228,2,2,0,1,0
34,229,229,29,29,0,1,0
7,230,230,2,2,0,1,0
9,249,249,36,14,22,2,1
0,251,251,4,4,0,1,0
23,255,255,28,28,0,1,0
20,265,265,27,27,0,1,0
26,268,268,20,14,6,2,1
33,269,269,21,3,18,4,3
6,292,292,40,2,38,2,1
24,308,308,9,2,7,2,1
5,337,337,86,27,59,4,3
13,347,347,6,6,0,1,0
14,347,347,34,11,23,2,1
2,372,372,54,22,32,3,2
15,391,391,45,45,0,1,0
4,396,396,6,6,0,1,0
18,433,433,16,16,0,1,0
17,440,440,72,45,27,4,3
32,441,441,90,70,20,3,2
3,446,446,87,79,8,3,2
1,448,448,46,10,36,3,2
21,451,451,58,58,0,1,0
11,463,463,7,1,6,2,1
16,480,480,49,49,0,1,0
19,491,491,3,3,0,1,0

18,108,108,11,5,6,3,2
28,113,113,4,4,0,1,0
25,137,137,14,14,0,1,0
19,162,162,1,1,0,1,0
7,169,169,2,2,0,1,0
13,176,176,5,5,0,1,0
4,182,182,18,18,0,1,0
17,220,220,21,21,0,1,0
14,228,228,17,17,0,1,0
9,235,235,23,23,0,1,0
29,247,247,33,33,0,1,0
16,253,253,71,71,0,1,0
21,263,263,8,2,6,3,2
31,278,278,20,9,11,2,1
1,282,282,21,21,0,1,0
24,285,285,48,48,0,1,0
3,288,288,13,2,11,4,3
5,298,298,6,6,0,1,0
10,321,321,21,21,0,1,0
23,335,335,64,64,0,1,0
30,346,346,44,9,35,2,1
22,353,353,26,16,10,3,2
26,354,354,90,16,74,4,3
2,382,382,27,27,0,1,0
12,383,383,20,13,7,2,1
27,389,389,8,8,0,1,0
33,409,409,80,80,0,1,0
20,422,422,29,9,20,3,2
0,439,439,13,13,0,1,0
15,465,465,1,1,0,1,0
11,479,479,33,33,0,1,0
32,485,485,33,33,0,1,0
6,487,487,38,25,13,4,3
8,489,489,295,212,83,4,3

8,109,109,8,3,5,2,1
30,140,140,2,2,0,1,0
15,152,152,5,5,0,1,0
32,153,153,18,18,0,1,0
3,158,158,3,3,0,1,0
34,175,175,16,4,12,4,3
38,182,182,22,22,0,1,0
5,198,198,23,4,19,4,3
9,205,205,7,7,0,1,0
29,227,227,14,14,0,1,0
4,233,233,10,10,0,1,0
35,253,253,7,7,0,1,0
33,256,256,22,22,0,1,0
26,278,278,124,64,60,4,3
21,290,290,33,5,28,2,1
37,312,312,15,15,0,1,0
24,341,341,23,2,21,3,2
10,345,345,1,1,0,1,0
22,347,347,56,31,25,2,1
28,358,358,41,41,0,1,0
19,360,360,128,62,66,3,2
12,363,363,7,7,0,1,0
18,364,364,2,2,0,1,0
2,368,368,89,89,0,1,0
7,372,372,38,38,0,1,0
13,373,373,31,31,0,1,0
14,378,378,11,1,10,2,1
11,383,383,68,8,60,3,2
16,398,398,2,2,0,1,0
31,403,403,65,44,21,2,1
27,403,403,54,54,0,1,0
23,410,410,1,1,0,1,0
1,413,413,14,14,0,1,0
25,429,429,12,9,3,2,1
0,442,442,56,34,22,2,1
20,447,447,28,28,0,1,0
36,447,447,20,5,15,2,1
17,453,453,2,2,0,1,0
6,463,463,9,9,0,1,0

13,123,123,12,12,0,1,0
6,132,132,9,9,0,1,0
24,134,134,15,3,12,3,2
27,139,139,1,1,0,1,0
21,153,153,28,5,23,3,2
32,167,167,3,3,0,1,0
25,175,175,10,10,0,1,0
11,184,184,3,3,0,1,0
31,185,185,8,8,0,1,0
23,186,186,64,64,0,1,0
19,187,187,7,2,5,2,1
12,190,190,5,5,0,1,0
28,206,206,48,48,0,1,0
7,221,221,16,9,7,2,1
16,222,222,42,42,0,1,0
0,222,222,25,25,0,1,0
26,251,251,14,14,0,1,0
15,251,251,18,18,0,1,0
17,255,255,10,10,0,1,0
5,266,266,60,11,49,2,1
30,270,270,14,14,0,1,0
22,285,285,35,23,12,4,3
10,315,315,6,6,0,1,0
14,350,350,8,8,0,1,0
3,373,373,22,13,9,2,1
8,402,402,91,54,37,3,2
9,417,417,38,38,0,1,0
18,437,437,29,7,22,2,1
29,458,458,48,12,36,3,2
4,460,460,176,150,26,2,1
20,490,490,35,35,0,1,0
2,491,491,18,18,0,1,0
1,494,494,86,86,0,1,0

12,113,113,36,36,0,1,0
1,126,126,7,7,0,1,0
17,128,128,15,3,12,4,3
14,135,135,4,4,0,1,0
18,141,141,7,7,0,1,0
16,149,149,4,4,0,1,0
19,162,162,3,3,0,1,0
15,188,188,20,20,0,1,0
5,201,201,7,7,0,1,0
22,210,210,4,4,0,1,0
9,213,213,18,6,12,3,2
26,235,235,2,2,0,1,0
27,262,262,88,88,0,1,0
0,263,263,1,1,0,1,0
10,283,283,21,21,0,1,0
21,284,284,22,22,0,1,0
8,285,285,115,83,32,3,2
23,311,311,33,18,15,3,2
4,317,317,28,13,15,4,3
25,345,345,25,4,21,4,3
20,389,389,6,6,0,1,0
2,392,392,114,114,0,1,0
24,429,429,77,50,27,2,1
13,432,432,66,66,0,1,0
11,433,433,46,7,39,2,1
6,434,434,9,4,5,2,1
7,487,487,187,187,0,1,0
3,496,496,130,130,0,1,0

1,122,122,1,1,0,1,0
2,125,125,3,3,0,1,0
11,150,150,37,37,0,1,0
3,161,161,12,12,0,1,0
23,169,169,12,4,8,3,2
5,173,173,14,14,0,1,0
6,192,192,22,18,4,2,1
9,195,195,22,4,18,2,1
26,199,199,7,7,0,1,0
19,238,238,4,4,0,1,0
25,258,258,48,48,0,1,0
33,269,269,54,54,0,1,0
14,277,277,17,5,12,4,3
29,308,308,14,10,4,2,1
15,310,310,17,17,0,1,0
24,327,327,33,9,24,4,3
35,339,339,59,32,27,4,3
12,344,344,29,29,0,1,0
7,351,351,6,6,0,1,0
21,356,356,25,5,20,2,1
8,374,374,5,5,0,1,0
31,380,380,12,12,0,1,0
16,400,400,34,34,0,1,0
32,411,411,13,5,8,3,2
20,413,413,177,75,102,4,3
22,421,421,10,3,7,2,1
10,422,422,11,11,0,1,0
34,423,423,16,16,0,1,0
13,430,430,169,141,28,2,1
30,434,434,29,26,3,2,1
17,447,447,1,1,0,1,0
36,450,450,31,31,0,1,0
4,471,471,39,23,16,3,2
27,473,473,61,61,0,1,0
28,491,491,10,10,0,1,0
0,495,495,27,16,11,2,1
18,499,499,74,63,11,2,1

13,117,117,3,3,0,1,0
21,125,125,16,2,14,3,2
1,139,139,10,3,7,2,1
33,143,143,5,1,4,2,1
24,145,145,4,4,0,1,0
6,152,152,4,4,0,1,0
10,154,154,11,11,0,1,0
9,157,157,37,8,29,2,1
18,163,163,24,15,9,3,2
29,164,164,1,1,0,1,0
28,170,170,12,6,6,2,1
20,171,171,3,3,0,1,0
32,202,202,29,2,27,4,3
2,208,208,6,6,0,1,0
27,259,259,44,25,19,2,1
11,263,263,28,11,17,3,2
4,271,271,39,27,12,2,1
3,276,276,4,1,3,2,1
34,279,279,94,94,0,1,0
17,299,299,2,2,0,1,0
8,317,317,30,7,23,2,1
38,328,328,41,25,16,2,1
19,333,333,26,26,0,1,0
23,342,342,6,6,0,1,0
22,345,345,6,6,0,1,0
5,354,354,30,19,11,2,1
15,355,355,1,1,0,1,0
7,355,355,5,5,0,1,0
31,365,365,35,30,5,2,1
30,380,380,53,7,46,2,1
12,381,381,71,71,0,1,0
35,389,389,18,18,0,1,0
26,391,391,12,2,10,2,1
37,409,409,136,136,0,1,0
36,410,410,36,36,0,1,0
0,445,445,71,60,11,2,1
16,459,459,22,22,0,1,0
25,479,479,25,1,24,4,3
14,500,500,7,7,0,1,0

20,107,107,12,12,0,1,0
25,113,113,13,7,6,2,1
12,129,129,5,5,0,1,0
21,140,140,9,9,0,1,0
24,141,141,2,2,0,1,0
10,148,148,25,15,10,3,2
30,149,149,2,2,0,1,0
31,155,155,13,13,0,1,0
26,184,184,60,60,0,1,0
22,190,190,20,2,18,3,2
33,208,208,4,4,0,1,0
28,233,233,52,10,42,3,2
7,235,235,7,7,0,1,0
27,240,240,9,9,0,1,0
6,249,249,16,6,10,2,1
4,250,250,3,3,0,1,0
23,253,253,56,56,0,1,0
0,283,283,70,62,8,2,1
29,287,287,19,19,0,1,0
17,298,298,37,21,16,2,1
19,309,309,13,3,10,2,1
8,330,330,2,2,0,1,0
15,330,330,3,3,0,1,0
32,341,341,22,22,0,1,0
13,361,361,3,3,0,1,0
3,402,402,2,2,0,1,0
11,435,435,187,76,111,4,3
2,438,438,98,53,45,4,3
5,447,447,1,1,0,1,0
18,450,450,53,22,31,4,3
9,463,463,79,70,9,4,3
14,484,484,50,10,40,4,3
16,487,487,68,10,58,4,3
1,493,493,21,9,12,4,3

4,137,137,1,1,0,1,0
1,142,142,16,16,0,1,0
7,148,148,1,1,0,1,0
6,149,149,13,13,0,1,0
34,170,170,1,1,0,1,0
29,189,189,6,6,0,1,0
8,192,192,35,35,0,1,0
18,209,209,46,46,0,1,0
12,215,215,6,3,3,2,1
15,220,220,19,19,0,1,0
14,225,225,15,9,6,2,1
17,228,228,3,3,0,1,0
33,230,230,21,3,18,4,3
11,237,237,63,55,8,3,2
32,246,246,27,15,12,4,3
30,247,247,27,17,10,3,2
22,248,248,12,12,0,1,0
24,270,270,23,23,0,1,0
3,277,277,5,5,0,1,0
16,334,334,1,1,0,1,0
2,366,366,1,1,0,1,0
31,375,375,145,141,4,2,1
27,388,388,49,28,21,4,3
35,391,391,12,2,10,2,1
20,391,391,5,5,0,1,0
13,392,392,1,1,0,1,0
9,421,421,68,25,43,2,1
19,424,424,45,45,0,1,0
5,438,438,54,18,36,4,3
0,446,446,131,88,43,2,1
21,453,453,174,83,91,4,3
10,479,479,11,11,0,1,0
28,480,480,51,51,0,1,0
23,485,485,11,1,10,3,2
25,486,486,27,11,16,3,2
26,490,490,10,10,0,1,0

29,101,101,27,6,21,4,3
32,103,103,3,3,0,1,0
18,104,104,8,8,0,1,0
19,150,150,28,28,0,1,0
20,185,185,21,21,0,1,0
13,189,189,8,8,0,1,0
27,203,203,3,3,0,1,0
30,206,206,40,40,0,1,0
6,227,227,99,93,6,3,2
7,252,252,23,23,0,1,0
23,258,258,31,9,22,3,2
3,266,266,3,3,0,1,0
21,284,284,12,12,0,1,0
17,294,294,2,2,0,1,0
16,295,295,11,4,7,2,1
12,302,302,86,39,47,2,1
10,311,311,4,4,0,1,0
11,316,316,62,22,40,4,3
5,324,324,28,22,6,2,1
34,326,326,35,35,0,1,0
9,350,350,19,9,10,2,1
24,365,365,25,25,0,1,0
28,378,378,47,35,12,4,3
2,382,382,2,2,0,1,0
15,392,392,63,47,16,2,1
26,396,396,71,7,64,4,3
8,397,397,2,2,0,1,0
1,398,398,20,6,14,3,2
4,410,410,54,21,33,4,3
14,411,411,12,6,6,3,2
25,412,412,8,3,5,2,1
33,427,427,23,23,0,1,0
22,438,438,45,45,0,1,0
31,438,438,16,3,13,2,1
0,444,444,26,9,17,2,1

22,101,101,3,3,0,1,0
2,116,116,1,1,0,1,0
5,129,129,14,14,0,1,0
1,138,138,29,29,0,1,0
12,140,140,21,21,0,1,0
21,162,162,34,25,9,4,3
11,168,168,60,2,58,3,2
14,173,173,16,16,0,1,0
16,194,194,6,6,0,1,0
15,202,202,3,3,0,1,0
8,203,203,5,1,4,2,1
27,218,218,20,20,0,1,0
24,243,243,12,6,6,2,1
6,246,246,23,23,0,1,0
3,261,261,2,2,0,1,0
23,290,290,25,25,0,1,0
18,313,313,61,51,10,2,1
28,326,326,7,7,0,1,0
17,331,331,45,11,34,2,1
7,370,370,34,34,0,1,0
31,390,390,76,10,66,3,2
30,390,390,78,54,24,3,2
26,393,393,35,31,4,2,1
25,395,395,43,28,15,2,1
0,399,399,17,17,0,1,0
29,415,415,87,9,78,3,2
10,435,435,21,21,0,1,0
20,436,436,14,14,0,1,0
19,476,476,24,24,0,1,0
13,477,477,109,13,96,4,3
4,498,498,20,20,0,1,0
9,500,500,99,86,13,4,3

5,103,103,21,9,12,3,2
17,104,104,14,5,9,2,1
0,124,124,1,1,0,1,0
18,127,127,19,19,0,1,0
11,128,128,10,10,0,1,0
9,147,147,15,6,9,2,1
10,149,149,24,24,0,1,0
29,162,162,18,18,0,1,0
20,178,178,41,41,0,1,0
12,186,186,3,3,0,1,0
8,189,189,27,27,0,1,0
2,196,196,17,17,0,1,0
30,204,204,14,14,0,1,0
19,208,208,11,11,0,1,0
4,226,226,24,24,0,1,0
3,233,233,54,54,0,1,0
1,237,237,5,5,0,1,0
27,305,305,22,22,0,1,0
25,315,315,38,3,35,3,2
7,318,318,3,3,0,1,0
16,323,323,11,11,0,1,0
28,331,331,11,11,0,1,0
14,333,333,15,15,0,1,0
6,334,334,13,13,0,1,0
24,353,353,59,59,0,1,0
15,365,365,50,26,24,3,2
26,372,372,46,23,23,3,2
22,384,384,3,3,0,1,0
21,407,407,57,37,20,2,1
23,423,423,47,47,0,1,0
13,467,467,231,138,93,4,3

14,113,113,1,1,0,1,0
28,121,121,21,21,0,1,0
23,124,124,2,2,0,1,0
6,126,126,3,3,0,1,0
5,133,133,4,4,0,1,0
15,144,144,5,2,3,2,1
26,152,152,15,9,6,3,2
17,185,185,24,24,0,1,0
3,189,189,39,30,9,2,1
22,197,197,33,33,0,1,0
4,206,206,20,2,18,3,2
18,210,210,11,4,7,2,1
30,211,211,19,19,0,1,0
34,234,234,46,12,34,2,1
0,242,242,3,3,0,1,0
31,250,250,13,13,0,1,0
33,257,257,6,6,0,1,0
32,285,285,12,12,0,1,0
21,289,289,17,17,0,1,0
10,290,290,20,11,9,4,3
20,295,295,7,7,0,1,0
25,297,297,37,9,28,2,1
8,329,329,15,15,0,1,0
19,360,360,118,94,24,4,3
27,366,366,42,2,40,2,1
9,391,391,1,1,0,1,0
2,395,395,9,9,0,1,0
7,423,423,176,167,9,4,3
24,425,425,48,3,45,4,3
13,436,436,13,13,0,1,0
11,442,442,71,71,0,1,0
12,451,451,121,34,87,4,3
16,456,456,36,6,30,4,3
35,457,457,13,13,0,1,0
29,485,485,38,14,24,4,3
1,492,492,6,6,0,1,0

1,111,111,5,5,0,1,0
0,126,126,1,1,0,1,0
11,139,139,4,1,3,2,1
27,170,170,43,19,24,4,3
3,170,170,15,15,0,1,0
25,180,180,23,3,20,3,2
2,203,203,3,3,0,1,0
26,207,207,50,50,0,1,0
10,213,213,11,11,0,1,0
5,239,239,9,2,7,2,1
16,253,253,37,37,0,1,0
18,256,256,101,84,17,4,3
8,285,285,56,56,0,1,0
21,300,300,4,4,0,1,0
4,304,304,83,83,0,1,0
20,331,331,10,10,0,1,0
7,347,347,237,187,50,3,2
9,363,363,19,8,11,2,1
17,371,371,1,1,0,1,0
22,374,374,20,11,9,4,3
12,377,377,40,14,26,3,2
28,445,445,31,10,21,2,1
19,453,453,21,5,16,3,2
14,456,456,12,12,0,1,0
24,456,456,76,38,38,3,2
6,472,472,55,55,0,1,0
23,477,477,7,7,0,1,0
15,479,479,10,10,0,1,0
13,481,481,38,26,12,3,2
29,489,489,17,17,0,1,0

10,108,108,7,7,0,1,0
9,116,116,10,4,6,3,2
12,116,116,4,1,3,2,1
25,123,123,10,10,0,1,0
27,149,149,17,17,0,1,0
39,153,153,7,1,6,2,1
17,163,163,9,9,0,1,0
31,165,165,4,1,3,2,1
3,166,166,11,11,0,1,0
34,168,168,3,3,0,1,0
30,172,172,14,2,12,2,1
16,182,182,2,2,0,1,0
19,195,195,9,9,0,1,0
0,210,210,25,25,0,1,0
4,222,222,2,2,0,1,0
23,241,241,8,8,0,1,0
1,243,243,20,11,9,2,1
18,245,245,24,24,0,1,0
32,253,253,12,6,6,2,1
2,267,267,16,16,0,1,0
33,267,267,10,10,0,1,0
37,293,293,12,12,0,1,0
15,302,302,6,6,0,1,0
42,302,302,117,72,45,4,3
29,320,320,21,7,14,3,2
36,326,326,37,37,0,1,0
40,344,344,9,3,6,3,2
28,349,349,36,8,28,2,1
11,351,351,50,50,0,1,0
20,355,355,10,10,0,1,0
7,356,356,1,1,0,1,0
26,364,364,112,112,0,1,0
8,370,370,21,1,20,2,1
24,377,377,3,3,0,1,0
22,380,380,54,34,20,2,1
35,384,384,37,11,26,3,2
5,415,415,105,93,12,2,1
14,417,417,41,41,0,1,0
38,421,421,62,46,16,2,1
6,448,448,18,5,13,3,2
41,454,454,35,16,19,3,2
21,455,455,16,16,0,1,0
13,460,460,15,15,0,1,0

37,100,100,5,5,0,1,0
16,104,104,1,1,0,1,0
15,113,113,5,5,0,1,0
29,127,127,20,20,0,1,0
13,133,133,6,6,0,1,0
30,145,145,8,2,6,3,2
9,151,151,1,1,0,1,0
3,159,159,7,1,6,2,1
6,162,162,39,39,0,1,0
14,169,169,1,1,0,1,0
0,170,170,5,5,0,1,0
33,191,191,17,7,10,3,2
34,225,225,14,1,13,2,1
1,230,230,4,4,0,1,0
4,250,250,55,55,0,1,0
7,272,272,22,22,0,1,0
17,280,280,41,41,0,1,0
11,283,283,45,45,0,1,0
35,291,291,20,8,12,3,2
36,301,301,24,24,0,1,0
2,311,311,24,10,14,3,2
23,332,332,134,29,105,4,3
22,345,345,9,9,0,1,0
31,376,376,4,4,0,1,0
5,384,384,12,12,0,1,0
21,391,391,45,45,0,1,0
24,395,395,21,21,0,1,0
18,412,412,81,59,22,3,2
32,422,422,23,23,0,1,0
20,433,433,39,19,20,3,2
12,456,456,2,2,0,1,0
10,460,460,95,68,27,4,3
25,462,462,64,7,57,4,3
27,465,465,7,7,0,1,0
26,467,467,108,36,72,4,3
19,471,471,13,6,7,2,1
28,491,491,62,26,36,4,3
8,492,492,9,9,0,1,0

19,111,111,16,4,12,4,3
23,144,144,4,1,3,2,1
9,178,178,11,1,10,3,2
26,178,178,25,25,0,1,0
16,193,193,6,6,0,1,0
13,198,198,4,4,0,1,0
25,199,199,60,4,56,4,3
0,201,201,16,16,0,1,0
28,213,213,6,6,0,1,0
20,221,221,8,8,0,1,0
6,222,222,58,38,20,3,2
22,223,223,13,4,9,2,1
12,228,228,1,1,0,1,0
31,233,233,32,32,0,1,0
3,251,251,1,1,0,1,0
4,263,263,38,28,10,2,1
30,264,264,40,40,0,1,0
2,275,275,35,15,20,3,2
32,284,284,8,3,5,2,1
27,293,293,5,2,3,2,1
29,307,307,1,1,0,1,0
24,333,333,22,13,9,2,1
10,334,334,128,25,103,4,3
5,365,365,4,1,3,2,1
14,384,384,41,31,10,3,2
15,391,391,68,48,20,3,2
11,412,412,61,51,10,2,1
8,413,413,1,1,0,1,0
17,438,438,35,35,0,1,0
7,475,475,70,49,21,4,3
21,481,481,204,162,42,4,3
1,495,495,13,4,9,2,1
18,497,497,29,19,10,3,2

18,148,148,1,1,0,1,0
12,156,156,5,5,0,1,0
27,169,169,2,2,0,1,0
3,171,171,2,2,0,1,0
7,180,180,22,1,21,4,3
1,189,189,10,7,3,2,1
0,199,199,2,2,0,1,0
24,200,200,11,6,5,2,1
34,202,202,67,55,12,3,2
19,205,205,11,11,0,1,0
30,207,207,2,2,0,1,0
38,208,208,7,1,6,3,2
37,218,218,15,5,10,3,2
41,225,225,32,22,10,3,2
9,239,239,14,2,12,3,2
23,251,251,26,26,0,1,0
26,251,251,2,2,0,1,0
21,260,260,25,25,0,1,0
32,267,267,11,8,3,2,1
13,275,275,34,21,13,2,1
6,276,276,24,24,0,1,0
35,281,281,32,32,0,1,0
40,313,313,21,21,0,1,0
8,329,329,64,46,18,3,2
10,330,330,109,92,17,2,1
5,336,336,14,1,13,2,1
31,346,346,43,43,0,1,0
36,349,349,20,20,0,1,0
15,365,365,1,1,0,1,0
11,377,377,21,21,0,1,0
29,383,383,77,77,0,1,0
4,383,383,8,4,4,2,1
39,399,399,173,144,29,4,3
16,404,404,6,6,0,1,0
25,414,414,25,9,16,2,1
28,427,427,4,4,0,1,0
33,430,430,6,6,0,1,0
17,442,442,2,2,0,1,0
22,447,447,76,42,34,2,1
2,465,465,5,5,0,1,0
14,469,469,20,11,9,4,3
20,475,475,1,1,0,1,0

18,108,108,31,17,14,2,1
2,132,132,1,1,0,1,0
17,134,134,20,14,6,3,2
28,136,136,4,4,0,1,0
23,147,147,18,18,0,1,0
19,171,171,21,21,0,1,0
1,180,180,1,1,0,1,0
27,181,181,101,101,0,1,0
34,209,209,31,6,25,2,1
30,217,217,8,2,6,3,2
15,237,237,64,64,0,1,0
6,269,269,19,2,17,2,1
31,272,272,24,24,0,1,0
8,277,277,30,30,0,1,0
13,307,307,42,21,21,4,3
5,322,322,5,5,0,1,0
20,327,327,33,11,22,3,2
11,333,333,25,14,11,2,1
29,358,358,35,5,30,4,3
35,362,362,6,6,0,1,0
0,372,372,1,1,0,1,0
33,374,374,18,4,14,2,1
26,383,383,49,34,15,4,3
32,385,385,16,10,6,3,2
22,387,387,4,4,0,1,0
14,389,389,87,27,60,4,3
10,391,391,17,6,11,4,3
36,396,396,32,32,0,1,0
12,402,402,2,2,0,1,0
9,404,404,9,9,0,1,0
25,444,444,4,4,0,1,0
24,452,452,91,91,0,1,0
3,464,464,6,3,3,2,1
4,468,468,10,2,8,3,2
16,471,471,27,27,0,1,0
21,485,485,6,6,0,1,0
7,491,491,31,7,24,3,2

10,103,103,10,10,0,1,0
4,106,106,3,3,0,1,0
20,113,113,1,1,0,1,0
21,124,124,1,1,0,1,0
9,133,133,2,2,0,1,0
24,140,140,35,15,20,3,2
18,147,147,6,6,0,1,0
25,147,147,1,1,0,1,0
31,151,151,19,19,0,1,0
19,151,151,17,14,3,2,1
34,155,155,6,3,3,2,1
11,160,160,3,3,0,1,0
37,162,162,6,6,0,1,0
7,162,162,1,1,0,1,0
12,182,182,1,1,0,1,0
39,200,200,26,18,8,2,1
23,206,206,9,3,6,2,1
38,232,232,22,22,0,1,0
8,234,234,7,7,0,1,0
29,242,242,7,1,6,2,1
47,244,244,57,57,0,1,0
46,245,245,48,48,0,1,0
0,252,252,1,1,0,1,0
41,295,295,6,6,0,1,0
30,303,303,16,9,7,2,1
14,311,311,6,6,0,1,0
28,311,311,25,16,9,2,1
42,311,311,97,97,0,1,0
5,314,314,2,2,0,1,0
27,334,334,11,11,0,1,0
33,336,336,5,1,4,2,1
44,337,337,19,6,13,2,1
32,346,346,43,43,0,1,0
35,364,364,33,24,9,4,3
1,377,377,22,22,0,1,0
40,382,382,24,6,18,2,1
17,382,382,7,4,3,2,1
13,397,397,13,4,9,2,1
26,400,400,44,44,0,1,0
22,411,411,3,3,0,1,0
36,419,419,1,1,0,1,0
43,459,459,45,45,0,1,0
6,461,461,3,3,0,1,0
45,475,475,42,7,35,3,2
15,479,479,153,84,69,4,3
16,484,484,46,1,45,4,3
2,485,485,5,1,4,2,1
3,496,496,73,53,20,2,1

6,106,106,6,6,0,1,0
20,126,126,20,20,0,1,0
5,129,129,1,1,0,1,0
21,129,129,23,17,6,2,1
10,138,138,3,3,0,1,0
14,140,140,35,17,18,2,1
11,147,147,5,5,0,1,0
19,155,155,2,2,0,1,0
30,176,176,6,6,0,1,0
22,176,176,1,1,0,1,0
29,190,190,18,12,6,2,1
23,197,197,33,33,0,1,0
7,200,200,31,31,0,1,0
18,208,208,12,6,6,2,1
0,215,215,8,2,6,2,1
32,239,239,4,4,0,1,0
12,274,274,38,1,37,4,3
24,280,280,5,1,4,2,1
13,302,302,112,90,22,4,3
15,318,318,25,17,8,2,1
25,322,322,107,107,0,1,0
2,326,326,23,23,0,1,0
16,331,331,51,8,43,4,3
28,332,332,65,65,0,1,0
1,334,334,12,12,0,1,0
31,341,341,18,18,0,1,0
17,342,342,34,34,0,1,0
26,346,346,51,51,0,1,0
8,442,442,161,128,33,2,1
3,444,444,7,7,0,1,0
27,456,456,9,9,0,1,0
9,462,462,16,16,0,1,0
4,495,495,15,15,0,1,0

29,101,101,23,8,15,4,3
24,104,104,9,5,4,2,1
19,127,127,8,8,0,1,0
4,137,137,22,1,21,4,3
25,143,143,20,20,0,1,0
13,154,154,8,2,6,3,2
11,166,166,118,17,101,4,3
2,175,175,12,5,7,2,1
28,181,181,15,15,0,1,0
17,202,202,16,10,6,2,1
3,233,233,3,3,0,1,0
26,249,249,33,33,0,1,0
18,256,256,22,8,14,3,2
6,262,262,53,53,0,1,0
8,277,277,51,30,21,4,3
7,281,281,38,38,0,1,0
1,300,300,6,1,5,2,1
20,307,307,64,64,0,1,0
12,352,352,47,47,0,1,0
23,386,386,8,8,0,1,0
27,387,387,14,14,0,1,0
21,403,403,37,10,27,3,2
5,406,406,10,10,0,1,0
15,421,421,55,55,0,1,0
9,462,462,8,8,0,1,0
0,465,465,13,10,3,2,1
16,479,479,94,39,55,4,3
14,486,486,12,12,0,1,0
22,491,491,40,1,39,4,3
10,497,497,2,2,0,1,0

11,114,114,2,2,0,1,0
14,124,124,9,9,0,1,0
13,128,128,1,1,0,1,0
5,139,139,12,4,8,2,1
8,142,142,8,5,3,2,1
34,167,167,6,2,4,2,1
3,167,167,8,8,0,1,0
18,172,172,18,18,0,1,0
9,181,181,1,1,0,1,0
0,197,197,33,33,0,1,0
24,199,199,30,26,4,2,1
17,218,218,41,41,0,1,0
23,228,228,20,15,5,2,1
15,232,232,8,5,3,2,1
12,248,248,39,39,0,1,0
10,251,251,6,1,5,2,1
21,252,252,9,2,7,2,1
16,268,268,29,29,0,1,0
22,275,275,22,13,9,4,3
4,324,324,27,27,0,1,0
1,343,343,147,36,111,4,3
6,361,361,13,13,0,1,0
31,374,374,7,2,5,2,1
20,376,376,209,164,45,2,1
27,381,381,13,2,11,2,1
28,391,391,21,5,16,2,1
33,397,397,5,5,0,1,0
25,406,406,33,29,4,2,1
32,406,406,71,71,0,1,0
2,423,423,26,10,16,2,1
29,444,444,1,1,0,1,0
26,454,454,91,35,56,3,2
30,455,455,21,21,0,1,0
19,455,455,25,25,0,1,0
7,471,471,56,4,52,3,2

7,102,102,13,13,0,1,0
19,113,113,19,19,0,1,0
31,120,120,14,14,0,1,0
2,122,122,2,2,0,1,0
27,135,135,6,6,0,1,0
29,139,139,10,4,6,3,2
10,151,151,2,2,0,1,0
26,184,184,4,4,0,1,0
34,194,194,29,9,20,3,2
22,197,197,48,6,42,2,1
18,198,198,12,2,10,3,2
20,200,200,6,6,0,1,0
8,235,235,29,16,13,2,1
17,243,243,20,14,6,2,1
15,270,270,10,7,3,2,1
0,296,296,8,2,6,2,1
11,302,302,4,4,0,1,0
33,307,307,74,74,0,1,0
25,319,319,20,20,0,1,0
9,347,347,28,5,23,2,1
24,361,361,76,76,0,1,0
30,369,369,1,1,0,1,0
3,389,389,50,2,48,4,3
16,411,411,44,44,0,1,0
36,414,414,36,25,11,2,1
6,417,417,21,18,3,2,1
12,429,429,26,17,9,4,3
5,429,429,5,2,3,2,1
28,431,431,26,26,0,1,0
14,440,440,165,95,70,4,3
13,456,456,37,23,14,2,1
23,457,457,50,22,28,2,1
21,462,462,17,4,13,2,1
1,470,470,22,22,0,1,0
32,474,474,103,73,30,3,2
4,481,481,44,14,30,3,2
35,482,482,17,5,12,4,3

15,104,104,15,15,0,1,0
22,106,106,5,5,0,1,0
9,110,110,1,1,0,1,0
20,131,131,5,5,0,1,0
24,132,132,4,1,3,2,1
10,146,146,22,22,0,1,0
14,183,183,12,6,6,2,1
27,185,185,3,3,0,1,0
4,187,187,16,16,0,1,0
1,200,200,63,15,48,4,3
29,200,200,2,2,0,1,0
8,235,235,9,9,0,1,0
19,243,243,49,49,0,1,0
13,265,265,2,2,0,1,0
11,284,284,1,1,0,1,0
7,297,297,10,10,0,1,0
31,305,305,85,10,75,4,3
33,308,308,7,7,0,1,0
28,317,317,30,30,0,1,0
2,323,323,26,8,18,2,1
32,327,327,23,23,0,1,0
23,352,352,15,9,6,3,2
17,367,367,63,63,0,1,0
0,367,367,32,32,0,1,0
18,371,371,39,2,37,2,1
12,384,384,53,5,48,4,3
6,413,413,5,5,0,1,0
21,419,419,135,75,60,3,2
26,420,420,79,79,0,1,0
25,431,431,41,6,35,2,1
30,457,457,3,3,0,1,0
5,460,460,35,35,0,1,0
3,461,461,129,98,31,2,1
16,472,472,82,14,68,3,2

30,112,112,20,20,0,1,0
35,130,130,1,1,0,1,0
37,142,142,1,1,0,1,0
1,153,153,26,2,24,4,3
10,160,160,6,6,0,1,0
9,163,163,11,1,10,3,2
31,170,170,16,16,0,1,0
21,181,181,2,2,0,1,0
29,188,188,9,9,0,1,0
4,195,195,11,11,0,1,0
15,209,209,15,1,14,3,2
16,220,220,18,18,0,1,0
8,233,233,66,24,42,4,3
17,235,235,1,1,0,1,0
7,241,241,1,1,0,1,0
11,268,268,7,7,0,1,0
24,280,280,82,58,24,4,3
25,283,283,8,8,0,1,0
12,298,298,17,17,0,1,0
19,313,313,29,29,0,1,0
0,328,328,21,21,0,1,0
20,328,328,91,5,86,3,2
32,344,344,46,46,0,1,0
3,353,353,8,8,0,1,0
26,370,370,88,52,36,2,1
5,385,385,9,9,0,1,0
13,385,385,1,1,0,1,0
23,387,387,50,50,0,1,0
2,395,395,28,3,25,2,1
27,398,398,12,12,0,1,0
22,398,398,34,2,32,3,2
33,406,406,54,48,6,2,1
18,446,446,75,45,30,3,2
14,452,452,51,3,48,3,2
28,471,471,93,81,12,4,3
6,483,483,4,4,0,1,0
36,486,486,21,17,4,2,1
34,491,491,34,34,0,1,0

23,100,100,5,5,0,1,0
18,100,100,15,2,13,4,3
36,134,134,17,17,0,1,0
6,137,137,11,4,7,2,1
0,139,139,32,32,0,1,0
7,149,149,7,3,4,2,1
20,208,208,34,28,6,2,1
8,208,208,28,1,27,4,3
35,210,210,14,14,0,1,0
15,216,216,2,2,0,1,0
25,220,220,22,3,19,2,1
2,226,226,12,12,0,1,0
37,235,235,1,1,0,1,0
17,241,241,31,31,0,1,0
11,244,244,1,1,0,1,0
28,248,248,11,11,0,1,0
3,250,250,10,10,0,1,0
13,268,268,11,3,8,3,2
5,288,288,10,2,8,3,2
27,294,294,55,55,0,1,0
14,323,323,56,15,41,4,3
34,329,329,7,1,6,3,2
4,336,336,6,6,0,1,0
30,360,360,29,29,0,1,0
29,364,364,70,41,29,2,1
22,368,368,39,39,0,1,0
19,378,378,10,4,6,2,1
12,385,385,17,7,10,2,1
24,393,393,123,123,0,1,0
21,398,398,14,1,13,2,1
9,401,401,9,9,0,1,0
32,410,410,16,16,0,1,0
1,415,415,44,38,6,2,1
33,431,431,49,49,0,1,0
10,432,432,58,17,41,4,3
16,438,438,11,5,6,2,1
31,446,446,34,34,0,1,0
26,455,455,47,26,21,2,1
38,493,493,57,7,50,4,3

12,113,113,10,3,7,2,1
35,133,133,5,5,0,1,0
16,140,140,3,3,0,1,0
11,145,145,6,2,4,2,1
7,150,150,1,1,0,1,0
22,154,154,12,12,0,1,0
34,157,157,5,5,0,1,0
24,158,158,7,7,0,1,0
0,164,164,3,3,0,1,0
38,174,174,37,7,30,3,2
14,198,198,35,24,11,2,1
29,225,225,10,2,8,3,2
10,232,232,9,5,4,2,1
30,234,234,11,11,0,1,0
4,235,235,4,4,0,1,0
28,239,239,19,5,14,2,1
1,241,241,5,5,0,1,0
26,256,256,14,3,11,4,3
33,290,290,60,60,0,1,0
32,292,292,8,8,0,1,0
23,295,295,29,29,0,1,0
15,310,310,109,48,61,4,3
36,316,316,13,13,0,1,0
13,317,317,4,1,3,2,1
8,322,322,1,1,0,1,0
6,330,330,15,15,0,1,0
39,334,334,64,64,0,1,0
18,353,353,18,18,0,1,0
27,353,353,38,38,0,1,0
21,382,382,11,11,0,1,0
5,384,384,10,1,9,4,3
31,397,397,114,105,9,4,3
17,402,402,89,89,0,1,0
25,405,405,29,18,11,2,1
40,414,414,86,86,0,1,0
20,415,415,46,46,0,1,0
3,425,425,31,3,28,2,1
37,442,442,17,8,9,4,3
19,445,445,70,27,43,4,3
9,494,494,6,1,5,2,1
2,495,495,1,1,0,1,0

21,100,100,13,13,0,1,0
23,128,128,5,5,0,1,0
26,130,130,26,26,0,1,0
31,131,131,3,3,0,1,0
5,133,133,6,1,5,2,1
17,163,163,23,23,0,1,0
15,192,192,11,11,0,1,0
9,196,196,1,1,0,1,0
0,228,228,14,4,10,3,2
32,233,233,8,8,0,1,0
2,263,263,10,6,4,2,1
28,289,289,21,7,14,3,2
16,303,303,61,61,0,1,0
33,315,315,136,105,31,4,3
12,324,324,14,14,0,1,0
19,337,337,11,11,0,1,0
8,344,344,17,5,12,2,1
24,354,354,79,12,67,4,3
10,374,374,15,3,12,4,3
13,380,380,8,2,6,3,2
14,388,388,73,43,30,4,3
27,388,388,67,46,21,2,1
11,395,395,15,10,5,2,1
34,406,406,6,6,0,1,0
1,407,407,38,38,0,1,0
30,409,409,9,4,5,2,1
35,415,415,14,14,0,1,0
18,433,433,24,24,0,1,0
20,450,450,2,2,0,1,0
3,464,464,23,23,0,1,0
22,470,470,65,48,17,2,1
6,473,473,11,2,9,4,3
29,475,475,41,36,5,2,1
25,485,485,32,6,26,3,2
7,486,486,11,11,0,1,0
4,492,492,260,212,48,3,2

7,119,119,10,4,6,3,2
15,121,121,10,10,0,1,0
24,123,123,38,28,10,2,1
4,135,135,33,6,27,4,3
14,146,146,5,5,0,1,0
11,158,158,33,33,0,1,0
9,166,166,9,9,0,1,0
1,173,173,4,4,0,1,0
20,189,189,4,4,0,1,0
17,203,203,26,23,3,2,1
19,213,213,23,5,18,2,1
12,224,224,75,41,34,3,2
23,230,230,24,24,0,1,0
21,245,245,14,14,0,1,0
26,278,278,9,9,0,1,0
25,311,311,35,35,0,1,0
2,338,338,39,39,0,1,0
8,345,345,91,48,43,4,3
22,402,402,3,3,0,1,0
0,415,415,197,177,20,3,2
5,430,430,2,2,0,1,0
13,436,436,6,1,5,2,1
18,444,444,40,40,0,1,0
10,472,472,38,1,37,2,1
3,485,485,145,51,94,3,2
16,492,492,7,2,5,2,1
6,493,493,69,58,11,2,1

9,108,108,1,1,0,1,0
30,118,118,4,4,0,1,0
1,138,138,11,11,0,1,0
19,141,141,31,31,0,1,0
23,181,181,2,2,0,1,0
16,181,181,27,27,0,1,0
7,186,186,3,3,0,1,0
21,190,190,25,17,8,2,1
26,210,210,1,1,0,1,0
14,222,222,12,12,0,1,0
29,225,225,9,9,0,1,0
28,225,225,2,2,0,1,0
25,236,236,92,92,0,1,0
5,274,274,47,34,13,2,1
11,286,286,17,8,9,4,3
12,319,319,118,118,0,1,0
22,329,329,32,32,0,1,0
18,338,338,95,42,53,4,3
24,338,338,36,15,21,2,1
4,346,346,23,23,0,1,0
17,388,388,51,51,0,1,0
15,395,395,13,5,8,2,1
20,401,401,12,12,0,1,0
2,425,425,60,18,42,4,3
10,426,426,70,46,24,4,3
0,445,445,110,58,52,3,2
6,458,458,91,23,68,3,2
3,458,458,47,2,45,4,3
13,471,471,15,10,5,2,1
8,486,486,21,21,0,1,0
27,491,491,4,4,0,1,0

2,129,129,11,8,3,2,1
24,144,144,24,3,21,2,1
23,153,153,1,1,0,1,0
13,180,180,10,10,0,1,0
21,181,181,15,1,14,2,1
29,184,184,6,6,0,1,0
9,193,193,2,2,0,1,0
8,202,202,18,12,6,2,1
5,210,210,15,15,0,1,0
19,224,224,18,18,0,1,0
22,226,226,28,28,0,1,0
17,233,233,45,21,24,4,3
1,242,242,4,4,0,1,0
31,255,255,20,20,0,1,0
3,257,257,98,98,0,1,0
15,265,265,7,2,5,2,1
14,265,265,41,16,25,3,2
7,275,275,6,2,4,2,1
10,286,286,32,32,0,1,0
18,290,290,29,29,0,1,0
27,301,301,68,68,0,1,0
30,302,302,51,51,0,1,0
32,345,345,45,23,22,2,1
20,351,351,40,4,36,4,3
12,361,361,6,6,0,1,0
28,383,383,42,42,0,1,0
11,398,398,28,23,5,2,1
6,398,398,129,94,35,2,1
33,409,409,1,1,0,1,0
4,429,429,41,41,0,1,0
25,448,448,14,14,0,1,0
26,476,476,38,14,24,3,2
16,499,499,73,7,66,4,3
0,500,500,12,8,4,2,1

17,105,105,8,8,0,1,0
6,116,116,7,7,0,1,0
19,131,131,28,28,0,1,0
10,134,134,1,1,0,1,0
29,141,141,10,4,6,3,2
25,192,192,42,42,0,1,0
3,219,219,17,9,8,3,2
12,225,225,28,14,14,2,1
21,254,254,47,47,0,1,0
30,258,258,16,3,13,2,1
11,307,307,35,23,12,2,1
8,319,319,57,57,0,1,0
24,324,324,22,1,21,4,3
18,325,325,10,10,0,1,0
20,333,333,14,14,0,1,0
26,351,351,4,1,3,2,1
28,351,351,49,49,0,1,0
16,354,354,35,6,29,4,3
22,363,363,113,19,94,4,3
14,409,409,17,11,6,2,1
9,410,410,65,27,38,3,2
2,413,413,150,75,75,4,3
0,413,413,61,22,39,4,3
15,426,426,18,6,12,4,3
5,428,428,77,77,0,1,0
1,475,475,55,55,0,1,0
27,475,475,34,1,33,4,3
23,478,478,21,11,10,3,2
13,480,480,25,25,0,1,0
4,490,490,4,4,0,1,0
7,499,499,56,56,0,1,0

1,109,109,12,12,0,1,0
12,112,112,5,5,0,1,0
2,116,116,16,7,9,4,3
20,119,119,18,18,0,1,0
6,128,128,2,2,0,1,0
10,157,157,10,10,0,1,0
27,161,161,6,3,3,2,1
31,166,166,3,3,0,1,0
5,179,179,22,22,0,1,0
17,183,183,14,14,0,1,0
3,202,202,8,8,0,1,0
18,235,235,4,4,0,1,0
4,254,254,4,1,3,2,1
7,272,272,40,19,21,4,3
29,274,274,41,41,0,1,0
21,286,286,17,5,12,2,1
25,286,286,62,16,46,3,2
11,290,290,61,43,18,4,3
15,296,296,104,7,97,4,3
8,303,303,18,18,0,1,0
22,338,338,13,13,0,1,0
0,369,369,64,64,0,1,0
19,376,376,2,2,0,1,0
9,380,380,88,40,48,4,3
23,402,402,47,47,0,1,0
26,405,405,49,49,0,1,0
30,411,411,26,10,16,2,1
28,432,432,47,47,0,1,0
14,439,439,13,8,5,2,1
16,459,459,84,84,0,1,0
24,494,494,13,4,9,2,1
13,496,496,149,149,0,1,0

6,108,108,1,1,0,1,0
17,111,111,12,5,7,3,2
7,120,120,1,1,0,1,0
31,128,128,18,2,16,2,1
33,129,129,6,1,5,2,1
15,132,132,31,31,0,1,0
16,161,161,24,24,0,1,0
2,163,163,14,3,11,2,1
9,163,163,14,2,12,2,1
12,169,169,3,3,0,1,0
27,201,201,10,10,0,1,0
18,204,204,4,4,0,1,0
10,208,208,32,32,0,1,0
24,217,217,37,37,0,1,0
19,235,235,7,2,5,2,1
1,250,250,6,6,0,1,0
14,267,267,34,34,0,1,0
0,276,276,6,6,0,1,0
23,285,285,14,11,3,2,1
25,339,339,39,31,8,2,1
11,352,352,83,37,46,2,1
32,353,353,167,161,6,2,1
20,365,365,25,9,16,3,2
5,377,377,25,20,5,2,1
30,384,384,22,4,18,2,1
3,400,400,70,70,0,1,0
29,415,415,111,111,0,1,0
8,420,420,44,10,34,3,2
28,432,432,3,3,0,1,0
4,445,445,23,23,0,1,0
22,465,465,16,16,0,1,0
13,473,473,71,71,0,1,0
21,489,489,33,33,0,1,0
26,491,491,15,15,0,1,0

20,119,119,1,1,0,1,0
27,124,124,11,11,0,1,0
28,137,137,30,10,20,3,2
32,139,139,30,30,0,1,0
35,146,146,22,1,21,4,3
38,146,146,27,1,26,3,2
25,178,178,9,9,0,1,0
18,189,189,15,3,12,3,2
30,193,193,30,30,0,1,0
3,214,214,1,1,0,1,0
7,218,218,1,1,0,1,0
6,222,222,18,4,14,3,2
22,227,227,11,7,4,2,1
24,228,228,11,8,3,2,1
8,251,251,4,4,0,1,0
11,252,252,12,12,0,1,0
33,260,260,42,28,14,2,1
34,270,270,18,18,0,1,0
29,281,281,4,4,0,1,0
31,288,288,18,6,12,3,2
9,305,305,6,2,4,2,1
10,335,335,1,1,0,1,0
14,338,338,54,11,43,2,1
40,370,370,16,16,0,1,0
4,393,393,57,57,0,1,0
2,397,397,37,19,18,2,1
1,398,398,5,5,0,1,0
23,402,402,10,10,0,1,0
21,407,407,30,30,0,1,0
19,422,422,54,54,0,1,0
0,425,425,176,131,45,4,3
5,434,434,20,20,0,1,0
36,441,441,27,27,0,1,0
17,444,444,30,8,22,2,1
15,447,447,42,42,0,1,0
37,448,448,24,24,0,1,0
16,450,450,22,22,0,1,0
12,457,457,24,13,11,2,1
26,479,479,63,9,54,3,2
39,491,491,19,19,0,1,0
13,497,497,14,14,0,1,0

26,100,100,8,3,5,2,1
1,102,102,6,6,0,1,0
9,126,126,7,7,0,1,0
21,133,133,22,3,19,3,2
24,136,136,6,2,4,2,1
11,139,139,10,10,0,1,0
38,139,139,5,1,4,2,1
0,152,152,7,7,0,1,0
18,155,155,18,18,0,1,0
14,158,158,17,17,0,1,0
13,174,174,14,14,0,1,0
12,199,199,2,2,0,1,0
39,200,200,61,61,0,1,0
22,225,225,4,4,0,1,0
17,242,242,68,68,0,1,0
30,278,278,16,16,0,1,0
20,280,280,50,42,8,3,2
23,297,297,4,4,0,1,0
3,312,312,67,19,48,3,2
28,315,315,4,1,3,2,1
10,317,317,6,6,0,1,0
27,349,349,44,6,38,3,2
36,359,359,63,31,32,3,2
37,360,360,2,2,0,1,0
25,373,373,50,50,0,1,0
40,382,382,54,54,0,1,0
19,396,396,2,2,0,1,0
15,396,396,11,3,8,3,2
16,400,400,12,12,0,1,0
5,414,414,20,8,12,2,1
31,415,415,59,59,0,1,0
2,416,416,4,1,3,2,1
8,422,422,22,22,0,1,0
4,428,428,11,2,9,2,1
32,450,450,1,1,0,1,0
33,453,453,61,61,0,1,0
34,454,454,18,18,0,1,0
29,469,469,46,1,45,4,3
7,492,492,14,14,0,1,0
6,494,494,19,19,0,1,0
35,495,495,95,95,0,1,0

27,130,130,24,16,8,2,1
3,132,132,50,50,0,1,0
13,178,178,10,1,9,4,3
24,178,178,1,1,0,1,0
29,194,194,14,8,6,2,1
7,218,218,25,25,0,1,0
8,219,219,29,11,18,2,1
30,244,244,10,5,5,2,1
15,249,249,21,21,0,1,0
16,302,302,35,35,0,1,0
2,315,315,48,3,45,4,3
11,322,322,4,4,0,1,0
4,327,327,27,7,20,2,1
25,331,331,13,13,0,1,0
18,353,353,4,1,3,2,1
28,366,366,101,53,48,2,1
17,371,371,10,10,0,1,0
10,376,376,175,175,0,1,0
21,384,384,76,70,6,3,2
22,385,385,51,51,0,1,0
12,386,386,38,38,0,1,0
14,387,387,17,17,0,1,0
20,398,398,41,34,7,2,1
5,407,407,7,7,0,1,0
19,409,409,4,4,0,1,0
6,433,433,4,4,0,1,0
23,459,459,49,11,38,2,1
26,469,469,127,94,33,4,3
9,485,485,25,25,0,1,0
0,488,488,2,2,0,1,0
1,493,493,62,14,48,3,2

16,119,119,1,1,0,1,0
5,136,136,10,10,0,1,0
12,136,136,11,5,6,3,2
20,140,140,28,17,11,4,3
4,154,154,4,1,3,2,1
19,162,162,2,2,0,1,0
13,173,173,42,17,25,2,1
31,178,178,13,13,0,1,0
17,181,181,31,19,12,3,2
27,184,184,41,23,18,3,2
7,184,184,27,27,0,1,0
11,193,193,1,1,0,1,0
28,204,204,8,5,3,2,1
10,207,207,11,11,0,1,0
9,216,216,39,39,0,1,0
2,225,225,37,13,24,3,2
14,248,248,9,9,0,1,0
15,269,269,44,44,0,1,0
24,269,269,20,5,15,3,2
26,279,279,13,13,0,1,0
3,282,282,18,3,15,4,3
22,295,295,29,1,28,3,2
6,302,302,38,14,24,4,3
18,317,317,12,12,0,1,0
8,317,317,30,12,18,2,1
32,318,318,62,62,0,1,0
33,318,318,66,66,0,1,0
0,363,363,47,47,0,1,0
25,377,377,14,7,7,2,1
29,386,386,80,40,40,3,2
30,397,397,9,3,6,3,2
23,425,425,30,8,22,3,2
21,445,445,5,2,3,2,1
1,460,460,52,16,36,4,3

21,105,105,18,18,0,1,0
39,116,116,13,3,10,2,1
9,165,165,1,1,0,1,0
37,180,180,2,2,0,1,0
32,181,181,25,2,23,4,3
2,182,182,52,33,19,2,1
30,188,188,8,8,0,1,0
40,195,195,32,25,7,2,1
6,212,212,36,6,30,3,2
34,212,212,94,50,44,3,2
4,217,217,34,13,21,3,2
18,230,230,4,1,3,2,1
35,231,231,24,24,0,1,0
19,247,247,41,41,0,1,0
33,264,264,15,15,0,1,0
16,271,271,1,1,0,1,0
20,280,280,3,3,0,1,0
10,281,281,8,8,0,1,0
5,288,288,14,14,0,1,0
24,300,300,32,32,0,1,0
13,305,305,1,1,0,1,0
38,312,312,66,66,0,1,0
17,318,318,5,5,0,1,0
7,322,322,5,5,0,1,0
12,334,334,38,38,0,1,0
36,342,342,21,21,0,1,0
14,342,342,10,10,0,1,0
22,355,355,13,13,0,1,0
15,358,358,2,2,0,1,0
11,379,379,86,77,9,2,1
27,386,386,16,6,10,3,2
29,390,390,6,2,4,2,1
28,402,402,17,2,15,4,3
26,416,416,16,7,9,4,3
8,425,425,9,6,3,2,1
1,444,444,1,1,0,1,0
31,462,462,13,4,9,4,3
25,464,464,51,51,0,1,0
0,465,465,7,7,0,1,0
3,465,465,57,24,33,2,1
23,478,478,14,14,0,1,0

18,106,106,8,8,0,1,0
15,107,107,3,3,0,1,0
14,140,140,23,1,22,4,3
13,160,160,30,30,0,1,0
2,180,180,7,7,0,1,0
9,184,184,1,1,0,1,0
21,195,195,10,6,4,2,1
30,208,208,3,3,0,1,0
11,209,209,22,22,0,1,0
4,222,222,56,56,0,1,0
29,253,253,74,14,60,3,2
1,256,256,24,24,0,1,0
3,259,259,43,1,42,2,1
24,260,260,32,32,0,1,0
28,265,265,73,73,0,1,0
10,278,278,6,6,0,1,0
26,300,300,7,7,0,1,0
5,321,321,3,3,0,1,0
0,328,328,3,3,0,1,0
25,335,335,25,1,24,4,3
12,346,346,51,39,12,3,2
7,346,346,148,37,111,4,3
31,352,352,13,3,10,2,1
16,385,385,19,19,0,1,0
22,390,390,5,5,0,1,0
6,402,402,9,3,6,3,2
8,408,408,9,3,6,2,1
19,414,414,44,26,18,4,3
20,432,432,51,7,44,2,1
23,462,462,69,64,5,2,1
17,477,477,77,77,0,1,0
27,478,478,15,15,0,1,0
32,480,480,65,65,0,1,0

9,100,100,1,1,0,1,0
21,104,104,21,2,19,2,1
1,107,107,1,1,0,1,0
20,126,126,1,1,0,1,0
26,127,127,12,12,0,1,0
19,159,159,13,13,0,1,0
11,168,168,10,10,0,1,0
33,191,191,1,1,0,1,0
2,192,192,14,14,0,1,0
28,218,218,16,16,0,1,0
38,220,220,17,14,3,2,1
39,225,225,32,6,26,3,2
31,244,244,2,2,0,1,0
29,245,245,71,71,0,1,0
22,251,251,9,9,0,1,0
34,267,267,69,31,38,2,1
3,276,276,18,18,0,1,0
16,282,282,8,2,6,2,1
13,286,286,11,4,7,2,1
17,299,299,47,47,0,1,0
30,301,301,4,1,3,2,1
23,305,305,1,1,0,1,0
35,309,309,22,6,16,3,2
32,332,332,19,19,0,1,0
24,346,346,21,4,17,2,1
18,355,355,22,2,20,2,1
36,368,368,22,22,0,1,0
12,399,399,5,2,3,2,1
8,420,420,44,44,0,1,0
6,425,425,49,18,31,3,2
0,430,430,27,27,0,1,0
15,431,431,48,48,0,1,0
27,440,440,117,73,44,2,1
40,450,450,28,11,17,2,1
10,454,454,12,12,0,1,0
25,482,482,62,46,16,2,1
7,483,483,17,17,0,1,0
14,483,483,164,164,0,1,0
5,487,487,13,13,0,1,0
37,492,492,33,33,0,1,0
4,499,499,17,12,5,2,1

9,107,107,9,1,8,2,1
34,109,109,3,3,0,1,0
27,110,110,11,11,0,1,0
29,118,118,16,16,0,1,0
31,143,143,2,2,0,1,0
32,163,163,4,4,0,1,0
15,172,172,18,18,0,1,0
30,176,176,4,4,0,1,0
23,190,190,54,54,0,1,0
4,195,195,10,10,0,1,0
26,206,206,1,1,0,1,0
17,212,212,5,5,0,1,0
19,215,215,15,15,0,1,0
11,220,220,51,13,38,2,1
33,227,227,27,16,11,2,1
24,238,238,67,67,0,1,0
35,254,254,17,6,11,2,1
14,258,258,5,5,0,1,0
2,261,261,38,26,12,4,3
7,268,268,10,3,7,2,1
21,283,283,23,23,0,1,0
10,284,284,3,3,0,1,0
6,305,305,1,1,0,1,0
20,331,331,33,15,18,4,3
0,332,332,16,9,7,2,1
22,334,334,39,39,0,1,0
3,342,342,31,31,0,1,0
36,343,343,65,16,49,3,2
28,372,372,22,22,0,1,0
8,379,379,8,8,0,1,0
12,383,383,72,52,20,2,1
1,394,394,60,60,0,1,0
18,401,401,96,53,43,2,1
16,406,406,22,22,0,1,0
25,449,449,56,56,0,1,0
13,473,473,1,1,0,1,0
5,474,474,59,11,48,3,2

2,101,101,12,12,0,1,0
26,102,102,1,1,0,1,0
18,133,133,29,29,0,1,0
5,138,138,36,36,0,1,0
19,142,142,24,24,0,1,0
25,148,148,4,4,0,1,0
17,153,153,3,3,0,1,0
3,159,159,1,1,0,1,0
23,161,161,12,3,9,3,2
28,193,193,3,3,0,1,0
12,205,205,8,8,0,1,0
13,206,206,3,3,0,1,0
27,210,210,40,1,39,4,3
24,230,230,66,19,47,4,3
1,236,236,65,65,0,1,0
29,243,243,60,1,59,3,2
14,262,262,1,1,0,1,0
22,296,296,19,13,6,3,2
0,310,310,64,64,0,1,0
11,367,367,17,11,6,3,2
30,380,380,9,9,0,1,0
21,409,409,13,13,0,1,0
7,425,425,69,49,20,2,1
15,434,434,111,87,24,2,1
20,435,435,31,31,0,1,0
16,443,443,14,14,0,1,0
4,445,445,39,13,26,2,1
9,447,447,9,1,8,2,1
8,460,460,7,1,6,3,2
6,467,467,23,23,0,1,0
10,485,485,195,195,0,1,0

27,133,133,3,3,0,1,0
34,134,134,14,14,0,1,0
26,147,147,13,8,5,2,1
2,151,151,10,10,0,1,0
29,165,165,5,1,4,2,1
19,214,214,12,6,6,2,1
20,228,228,3,3,0,1,0
13,241,241,3,3,0,1,0
23,258,258,10,6,4,2,1
16,266,266,50,43,7,2,1
9,277,277,12,12,0,1,0
30,278,278,4,1,3,2,1
14,290,290,1,1,0,1,0
24,290,290,27,15,12,3,2
3,296,296,2,2,0,1,0
35,309,309,62,47,15,2,1
31,322,322,33,33,0,1,0
0,337,337,28,28,0,1,0
6,344,344,73,15,58,3,2
21,354,354,85,28,57,3,2
10,360,360,8,8,0,1,0
33,362,362,109,77,32,3,2
18,387,387,2,2,0,1,0
11,387,387,8,8,0,1,0
22,388,388,12,12,0,1,0
25,390,390,41,41,0,1,0
5,415,415,20,11,9,4,3
28,418,418,104,65,39,4,3
17,462,462,40,40,0,1,0
7,467,467,74,74,0,1,0
15,471,471,89,47,42,4,3
1,475,475,83,83,0,1,0
32,486,486,22,22,0,1,0
4,487,487,70,70,0,1,0
8,495,495,18,18,0,1,0
12,498,498,100,22,78,4,3

26,113,113,37,37,0,1,0
1,115,115,10,1,9,2,1
12,118,118,7,3,4,2,1
11,122,122,2,2,0,1,0
9,131,131,11,1,10,2,1
15,137,137,42,42,0,1,0
5,145,145,43,31,12,4,3
17,146,146,4,1,3,2,1
6,153,153,31,17,14,2,1
0,186,186,25,25,0,1,0
24,237,237,46,13,33,2,1
14,265,265,36,36,0,1,0
20,300,300,68,68,0,1,0
30,318,318,19,19,0,1,0
32,329,329,2,2,0,1,0
4,358,358,3,3,0,1,0
2,358,358,5,5,0,1,0
21,361,361,30,9,21,3,2
18,364,364,122,122,0,1,0
29,375,375,18,7,11,2,1
7,389,389,28,17,11,2,1
28,414,414,2,2,0,1,0
19,418,418,1,1,0,1,0
25,430,430,26,3,23,2,1
10,433,433,41,32,9,4,3
3,442,442,15,15,0,1,0
31,445,445,33,33,0,1,0
23,478,478,7,7,0,1,0
16,481,481,83,22,61,4,3
27,484,484,8,8,0,1,0
22,486,486,39,3,36,4,3
8,493,493,1,1,0,1,0
13,498,498,76,76,0,1,0

17,120,120,8,8,0,1,0
0,135,135,35,31,4,2,1
11,145,145,2,2,0,1,0
5,181,181,4,4,0,1,0
18,204,204,3,3,0,1,0
24,206,206,4,4,0,1,0
3,212,212,54,28,26,3,2
6,216,216,3,3,0,1,0
27,225,225,35,35,0,1,0
21,228,228,3,3,0,1,0
8,242,242,12,12,0,1,0
23,251,251,42,42,0,1,0
30,282,282,99,21,78,4,3
7,290,290,39,19,20,2,1
15,293,293,28,28,0,1,0
4,300,300,20,11,9,2,1
9,304,304,47,47,0,1,0
20,310,310,12,12,0,1,0
16,326,326,2,2,0,1,0
25,328,328,4,4,0,1,0
26,377,377,14,8,6,2,1
2,381,381,12,12,0,1,0
29,386,386,110,22,88,3,2
31,394,394,12,8,4,2,1
19,400,400,35,35,0,1,0
14,404,404,65,65,0,1,0
1,457,457,46,46,0,1,0
10,462,462,8,8,0,1,0
13,469,469,19,7,12,2,1
28,471,471,92,92,0,1,0
22,472,472,75,47,28,2,1
12,473,473,180,180,0,1,0

0,103,103,16,3,13,2,1
11,119,119,1,1,0,1,0
12,124,124,8,2,6,3,2
9,146,146,1,1,0,1,0
5,207,207,13,9,4,2,1
29,214,214,3,3,0,1,0
32,219,219,43,6,37,2,1
31,223,223,9,9,0,1,0
6,233,233,27,3,24,3,2
28,256,256,7,2,5,2,1
7,261,261,47,47,0,1,0
25,268,268,21,21,0,1,0
2,289,289,26,9,17,2,1
3,300,300,46,30,16,2,1
17,303,303,59,59,0,1,0
21,313,313,48,48,0,1,0
22,325,325,16,3,13,2,1
10,335,335,5,5,0,1,0
33,358,358,1,1,0,1,0
27,366,366,18,15,3,2,1
13,381,381,19,19,0,1,0
15,387,387,12,12,0,1,0
20,395,395,29,1,28,3,2
16,402,402,63,1,62,3,2
1,418,418,45,6,39,4,3
8,426,426,52,10,42,3,2
24,429,429,85,85,0,1,0
4,434,434,87,87,0,1,0
23,439,439,58,58,0,1,0
18,454,454,43,35,8,3,2
19,467,467,138,24,114,4,3
14,470,470,85,13,72,3,2
26,476,476,1,1,0,1,0
30,489,489,58,14,44,2,1

19,101,101,11,11,0,1,0
25,105,105,44,27,17,4,3
13,127,127,11,11,0,1,0
2,151,151,54,48,6,2,1
5,155,155,23,23,0,1,0
26,183,183,31,31,0,1,0
24,185,185,11,3,8,2,1
31,194,194,13,2,11,2,1
12,201,201,1,1,0,1,0
36,204,204,27,20,7,2,1
17,209,209,3,3,0,1,0
6,215,215,6,6,0,1,0
9,224,224,11,11,0,1,0
29,242,242,1,1,0,1,0
33,243,243,54,8,46,3,2
32,251,251,20,8,12,2,1
21,264,264,24,3,21,2,1
3,269,269,9,2,7,2,1
8,282,282,41,5,36,3,2
37,286,286,34,7,27,2,1
40,295,295,50,14,36,4,3
28,296,296,1,1,0,1,0
20,312,312,27,27,0,1,0
0,353,353,21,12,9,2,1
1,358,358,21,21,0,1,0
35,361,361,7,1,6,3,2
18,383,383,25,6,19,4,3
23,384,384,28,28,0,1,0
16,392,392,30,22,8,2,1
34,399,399,4,4,0,1,0
22,408,408,1,1,0,1,0
38,419,419,36,36,0,1,0
10,421,421,52,10,42,2,1
11,433,433,14,5,9,2,1
14,461,461,8,2,6,3,2
27,471,471,60,60,0,1,0
15,474,474,7,4,3,2,1
7,478,478,10,10,0,1,0
4,483,483,1,1,0,1,0
39,485,485,12,4,8,2,1
30,494,494,11,5,6,3,2

19,110,110,1,1,0,1,0
9,110,110,4,1,3,2,1
15,112,112,3,3,0,1,0
6,115,115,6,6,0,1,0
26,118,118,16,16,0,1,0
2,123,123,50,46,4,2,1
21,144,144,1,1,0,1,0
22,149,149,4,4,0,1,0
18,151,151,24,2,22,2,1
17,164,164,23,23,0,1,0
7,178,178,21,21,0,1,0
0,217,217,76,76,0,1,0
29,222,222,50,50,0,1,0
28,234,234,43,13,30,2,1
20,249,249,7,7,0,1,0
1,288,288,37,17,20,2,1
25,298,298,2,2,0,1,0
14,336,336,25,1,24,3,2
30,350,350,2,2,0,1,0
4,379,379,1,1,0,1,0
13,385,385,18,12,6,2,1
23,417,417,67,29,38,3,2
3,420,420,15,2,13,2,1
24,423,423,72,9,63,4,3
27,434,434,82,82,0,1,0
5,450,450,107,107,0,1,0
11,455,455,9,9,0,1,0
16,457,457,87,78,9,4,3
8,463,463,21,21,0,1,0
12,482,482,96,96,0,1,0
10,487,487,11,1,10,3,2

33,101,101,49,49,0,1,0
26,106,106,14,8,6,2,1
24,106,106,4,4,0,1,0
15,108,108,2,2,0,1,0
29,108,108,16,16,0,1,0
10,109,109,5,5,0,1,0
6,117,117,12,12,0,1,0
16,119,119,16,2,14,2,1
13,130,130,6,6,0,1,0
7,132,132,11,11,0,1,0
8,138,138,7,3,4,2,1
18,154,154,16,8,8,2,1
2,155,155,26,26,0,1,0
9,164,164,13,13,0,1,0
30,168,168,18,18,0,1,0
14,183,183,5,5,0,1,0
12,191,191,66,7,59,4,3
17,200,200,4,4,0,1,0
20,214,214,48,48,0,1,0
27,234,234,6,6,0,1,0
28,272,272,51,51,0,1,0
31,301,301,5,1,4,2,1
5,315,315,53,53,0,1,0
3,353,353,16,16,0,1,0
4,359,359,34,16,18,3,2
22,361,361,31,3,28,2,1
0,397,397,43,43,0,1,0
23,418,418,5,1,4,2,1
19,434,434,56,4,52,3,2
21,441,441,2,2,0,1,0
25,473,473,4,4,0,1,0
11,476,476,6,6,0,1,0
32,488,488,3,3,0,1,0
1,494,494,84,6,78,4,3

31,105,105,7,7,0,1,0
0,108,108,20,1,19,3,2
29,115,115,31,23,8,2,1
24,118,118,13,1,12,4,3
22,122,122,2,2,0,1,0
21,180,180,8,2,6,3,2
15,186,186,18,1,17,4,3
14,193,193,12,12,0,1,0
34,200,200,5,2,3,2,1
7,208,208,20,9,11,2,1
5,211,211,13,13,0,1,0
30,225,225,20,20,0,1,0
26,264,264,6,6,0,1,0
35,282,282,4,4,0,1,0
19,287,287,16,1,15,2,1
32,291,291,10,2,8,3,2
1,296,296,76,25,51,4,3
16,296,296,22,22,0,1,0
13,305,305,85,85,0,1,0
6,307,307,42,42,0,1,0
3,307,307,33,27,6,2,1
4,324,324,36,25,11,2,1
25,330,330,78,11,67,3,2
8,334,334,14,14,0,1,0
9,358,358,3,3,0,1,0
10,359,359,43,43,0,1,0
27,396,396,4,4,0,1,0
18,415,415,12,2,10,2,1
20,423,423,153,116,37,2,1
33,429,429,5,5,0,1,0
23,432,432,1,1,0,1,0
2,439,439,1,1,0,1,0
11,449,449,4,4,0,1,0
12,460,460,5,5,0,1,0
28,469,469,178,128,50,3,2
17,499,499,7,3,4,2,1

21,101,101,23,23,0,1,0
35,115,115,7,1,6,2,1
9,149,149,7,7,0,1,0
27,162,162,7,7,0,1,0
1,177,177,14,14,0,1,0
36,182,182,2,2,0,1,0
2,188,188,1,1,0,1,0
6,203,203,48,4,44,3,2
3,204,204,53,11,42,2,1
10,211,211,15,1,14,2,1
23,219,219,45,45,0,1,0
0,225,225,11,5,6,3,2
20,234,234,13,13,0,1,0
29,246,246,20,20,0,1,0
30,251,251,22,10,12,4,3
12,262,262,1,1,0,1,0
5,284,284,19,9,10,3,2
14,295,295,8,2,6,2,1
7,303,303,5,1,4,2,1
26,309,309,56,56,0,1,0
11,313,313,51,45,6,3,2
8,351,351,1,1,0,1,0
24,362,362,38,38,0,1,0
19,391,391,24,10,14,2,1
18,403,403,31,31,0,1,0
34,406,406,24,20,4,2,1
15,409,409,27,27,0,1,0
31,413,413,48,5,43,2,1
32,427,427,45,19,26,2,1
17,446,446,29,5,24,3,2
16,458,458,55,55,0,1,0
33,458,458,14,2,12,3,2
4,469,469,70,31,39,4,3
25,478,478,22,22,0,1,0
22,486,486,7,7,0,1,0
13,493,493,67,62,5,2,1
28,498,498,154,40,114,4,3

7,129,129,1,1,0,1,0
1,134,134,1,1,0,1,0
21,139,139,20,1,19,4,3
14,191,191,80,18,62,3,2
18,197,197,14,14,0,1,0
19,199,199,35,35,0,1,0
8,219,219,48,48,0,1,0
3,222,222,66,66,0,1,0
13,231,231,12,12,0,1,0
29,249,249,3,3,0,1,0
31,253,253,23,23,0,1,0
2,264,264,7,7,0,1,0
24,295,295,35,35,0,1,0
12,313,313,3,3,0,1,0
0,316,316,92,41,51,4,3
26,321,321,73,42,31,2,1
27,324,324,16,9,7,2,1
28,357,357,52,52,0,1,0
20,359,359,10,6,4,2,1
11,362,362,1,1,0,1,0
5,367,367,11,1,10,2,1
6,372,372,1,1,0,1,0
9,373,373,34,34,0,1,0
30,380,380,51,51,0,1,0
25,385,385,28,11,17,2,1
15,388,388,16,12,4,2,1
16,405,405,17,17,0,1,0
17,417,417,29,6,23,2,1
23,418,418,66,66,0,1,0
32,449,449,35,35,0,1,0
22,458,458,4,4,0,1,0
4,470,470,70,70,0,1,0
33,477,477,70,40,30,4,3
10,480,480,6,2,4,2,1

31,113,113,16,1,15,2,1
29,120,120,19,13,6,3,2
27,124,124,22,22,0,1,0
12,140,140,6,6,0,1,0
19,142,142,5,5,0,1,0
33,147,147,50,50,0,1,0
7,175,175,15,3,12,3,2
13,186,186,3,3,0,1,0
20,198,198,5,2,3,2,1
3,215,215,27,27,0,1,0
0,216,216,1,1,0,1,0
22,217,217,34,31,3,2,1
15,253,253,1,1,0,1,0
6,260,260,34,10,24,2,1
24,261,261,8,2,6,3,2
16,286,286,144,144,0,1,0
30,323,323,26,17,9,4,3
9,326,326,60,60,0,1,0
5,335,335,20,20,0,1,0
18,339,339,19,19,0,1,0
26,348,348,18,18,0,1,0
1,362,362,4,4,0,1,0
21,365,365,53,50,3,2,1
10,381,381,34,18,16,2,1
14,382,382,87,63,24,4,3
23,392,392,27,27,0,1,0
8,403,403,29,23,6,3,2
4,411,411,5,5,0,1,0
11,440,440,8,2,6,2,1
17,466,466,36,26,10,2,1
32,468,468,34,5,29,2,1
34,472,472,5,5,0,1,0
25,474,474,90,54,36,4,3
2,485,485,18,18,0,1,0
28,491,491,1,1,0,1,0

15,118,118,2,2,0,1,0
25,135,135,20,1,19,2,1
11,154,154,10,1,9,2,1
23,154,154,3,3,0,1,0
28,175,175,31,11,20,3,2
20,197,197,24,24,0,1,0
16,209,209,6,6,0,1,0
0,215,215,11,11,0,1,0
6,240,240,36,31,5,2,1
17,253,253,1,1,0,1,0
18,256,256,43,21,22,2,1
4,263,263,55,55,0,1,0
10,314,314,78,58,20,3,2
22,327,327,27,27,0,1,0
7,330,330,3,3,0,1,0
26,349,349,26,16,10,3,2
2,363,363,22,22,0,1,0
19,363,363,92,92,0,1,0
27,365,365,13,8,5,2,1
30,377,377,76,39,37,3,2
8,419,419,68,27,41,3,2
9,423,423,55,5,50,2,1
3,424,424,6,6,0,1,0
14,426,426,35,14,21,4,3
24,429,429,52,28,24,3,2
29,449,449,51,39,12,2,1
13,453,453,27,27,0,1,0
5,455,455,127,78,49,3,2
1,469,469,46,46,0,1,0
21,476,476,41,41,0,1,0
12,476,476,78,12,66,3,2

36,101,101,18,1,17,4,3
24,109,109,20,20,0,1,0
6,115,115,5,1,4,2,1
1,151,151,5,5,0,1,0
5,161,161,10,4,6,2,1
18,184,184,15,11,4,2,1
7,188,188,8,8,0,1,0
23,192,192,43,43,0,1,0
14,213,213,16,4,12,4,3
15,214,214,12,4,8,3,2
37,231,231,18,6,12,3,2
8,248,248,1,1,0,1,0
10,253,253,50,5,45,4,3
12,256,256,18,18,0,1,0
9,281,281,52,52,0,1,0
17,289,289,3,3,0,1,0
19,290,290,18,2,16,3,2
16,298,298,5,5,0,1,0
38,315,315,51,51,0,1,0
11,317,317,43,19,24,2,1
22,349,349,100,100,0,1,0
13,352,352,144,18,126,4,3
28,354,354,14,10,4,2,1
27,357,357,21,9,12,4,3
32,383,383,33,33,0,1,0
35,385,385,7,7,0,1,0
21,392,392,17,12,5,2,1
20,395,395,5,5,0,1,0
0,423,423,2,2,0,1,0
29,433,433,5,2,3,2,1
2,435,435,6,1,5,2,1
31,442,442,34,34,0,1,0
25,449,449,40,19,21,4,3
26,466,466,7,3,4,2,1
4,470,470,51,51,0,1,0
30,476,476,54,54,0,1,0
34,484,484,10,3,7,2,1
3,495,495,16,16,0,1,0
33,499,499,44,28,16,2,1

21,114,114,15,3,12,3,2
1,118,118,1,1,0,1,0
8,126,126,22,22,0,1,0
29,127,127,47,47,0,1,0
12,127,127,26,26,0,1,0
14,148,148,7,1,6,2,1
2,160,160,3,3,0,1,0
17,175,175,18,18,0,1,0
0,175,175,2,2,0,1,0
30,212,212,13,9,4,2,1
22,217,217,2,2,0,1,0
26,233,233,55,55,0,1,0
27,251,251,15,7,8,2,1
35,263,263,8,8,0,1,0
31,274,274,42,42,0,1,0
11,279,279,25,25,0,1,0
10,312,312,62,53,9,2,1
34,328,328,12,12,0,1,0
6,330,330,42,42,0,1,0
18,333,333,42,32,10,3,2
3,337,337,11,5,6,2,1
5,338,338,4,4,0,1,0
13,340,340,28,28,0,1,0
20,352,352,3,3,0,1,0
23,372,372,47,9,38,2,1
4,415,415,5,5,0,1,0
32,423,423,45,45,0,1,0
7,427,427,63,12,51,4,3
16,433,433,85,7,78,3,2
37,445,445,8,8,0,1,0
19,458,458,22,12,10,2,1
33,461,461,4,4,0,1,0
25,464,464,46,16,30,2,1
28,469,469,19,9,10,3,2
24,481,481,110,92,18,3,2
15,486,486,10,10,0,1,0
9,489,489,16,16,0,1,0
36,492,492,10,10,0,1,0

12,120,120,1,1,0,1,0
7,122,122,1,1,0,1,0
32,129,129,11,5,6,3,2
15,133,133,4,1,3,2,1
3,136,136,39,39,0,1,0
2,139,139,10,3,7,2,1
10,140,140,1,1,0,1,0
17,164,164,75,49,26,2,1
22,208,208,3,3,0,1,0
1,211,211,6,6,0,1,0
9,225,225,3,3,0,1,0
4,225,225,5,5,0,1,0
21,229,229,5,5,0,1,0
11,234,234,4,4,0,1,0
13,239,239,3,3,0,1,0
8,240,240,14,14,0,1,0
34,246,246,5,5,0,1,0
27,266,266,28,6,22,2,1
0,273,273,12,2,10,2,1
19,310,310,60,60,0,1,0
23,311,311,17,17,0,1,0
6,321,321,39,39,0,1,0
28,321,321,29,29,0,1,0
5,330,330,44,44,0,1,0
36,343,343,70,22,48,3,2
35,354,354,25,1,24,3,2
16,361,361,42,30,12,3,2
33,390,390,86,86,0,1,0
31,391,391,34,34,0,1,0
18,400,400,14,14,0,1,0
25,408,408,9,6,3,2,1
24,409,409,32,32,0,1,0
29,417,417,29,29,0,1,0
20,423,423,69,54,15,4,3
30,439,439,110,100,10,3,2
26,481,481,84,72,12,2,1
14,500,500,18,5,13,2,1

10,112,112,5,1,4,2,1
8,140,140,25,25,0,1,0
23,141,141,7,7,0,1,0
7,144,144,1,1,0,1,0
3,177,177,1,1,0,1,0
0,187,187,14,14,0,1,0
2,194,194,27,27,0,1,0
9,234,234,20,3,17,2,1
14,248,248,2,2,0,1,0
5,267,267,32,32,0,1,0
24,270,270,131,131,0,1,0
4,278,278,50,34,16,2,1
12,305,305,10,10,0,1,0
18,310,310,8,8,0,1,0
6,317,317,63,27,36,2,1
15,327,327,13,13,0,1,0
16,327,327,29,26,3,2,1
17,328,328,4,1,3,2,1
21,342,342,15,3,12,4,3
11,343,343,57,57,0,1,0
19,350,350,25,17,8,3,2
29,368,368,34,34,0,1,0
27,396,396,8,8,0,1,0
13,407,407,116,116,0,1,0
30,435,435,152,152,0,1,0
28,442,442,39,39,0,1,0
22,443,443,12,12,0,1,0
26,446,446,77,69,8,3,2
1,463,463,85,85,0,1,0
25,474,474,23,1,22,3,2
20,500,500,54,20,34,2,1

8,101,101,26,8,18,2,1
17,104,104,24,8,16,2,1
16,136,136,9,9,0,1,0
10,149,149,3,3,0,1,0
2,151,151,9,9,0,1,0
9,153,153,25,3,22,3,2
21,171,171,32,2,30,3,2
19,179,179,9,9,0,1,0
11,185,185,13,7,6,2,1
27,216,216,27,22,5,2,1
1,230,230,59,59,0,1,0
0,257,257,3,3,0,1,0
30,260,260,30,30,0,1,0
13,279,279,12,3,9,4,3
26,291,291,4,4,0,1,0
23,293,293,48,48,0,1,0
14,305,305,4,4,0,1,0
3,306,306,26,10,16,2,1
28,313,313,76,76,0,1,0
32,320,320,35,35,0,1,0
4,327,327,3,3,0,1,0
7,359,359,71,1,70,3,2
15,363,363,62,37,25,2,1
12,379,379,110,56,54,4,3
6,409,409,21,21,0,1,0
22,428,428,9,9,0,1,0
18,440,440,3,3,0,1,0
24,449,449,22,22,0,1,0
31,455,455,25,9,16,3,2
5,460,460,1,1,0,1,0
29,470,470,39,39,0,1,0
20,497,497,15,6,9,4,3
25,499,499,94,45,49,4,3

23,103,103,2,2,0,1,0
9,103,103,1,1,0,1,0
27,123,123,25,7,18,4,3
3,141,141,7,3,4,2,1
33,141,141,26,26,0,1,0
26,146,146,17,9,8,2,1
24,146,146,14,14,0,1,0
16,152,152,1,1,0,1,0
28,164,164,13,1,12,4,3
22,181,181,6,1,5,2,1
19,187,187,2,2,0,1,0
10,224,224,26,26,0,1,0
29,258,258,6,3,3,2,1
31,269,269,14,2,12,2,1
12,290,290,30,30,0,1,0
15,320,320,43,43,0,1,0
20,321,321,1,1,0,1,0
30,324,324,11,11,0,1,0
25,325,325,44,18,26,2,1
21,330,330,92,11,81,4,3
18,344,344,146,71,75,4,3
14,345,345,54,45,9,4,3
5,360,360,38,5,33,3,2
7,404,404,109,109,0,1,0
13,409,409,87,18,69,4,3
8,422,422,49,40,9,2,1
4,434,434,70,70,0,1,0
6,438,438,19,19,0,1,0
0,472,472,18,18,0,1,0
11,487,487,29,29,0,1,0
32,487,487,13,7,6,3,2
1,492,492,4,4,0,1,0
2,492,492,54,54,0,1,0
17,496,496,9,9,0,1,0

21,114,114,6,6,0,1,0
16,138,138,10,7,3,2,1
24,139,139,10,4,6,2,1
18,143,143,19,6,13,4,3
27,156,156,13,7,6,2,1
35,165,165,12,1,11,2,1
34,185,185,4,4,0,1,0
33,193,193,12,12,0,1,0
13,200,200,18,2,16,2,1
25,208,208,14,14,0,1,0
29,209,209,10,10,0,1,0
6,212,212,24,21,3,2,1
10,218,218,5,5,0,1,0
17,233,233,9,9,0,1,0
4,241,241,2,2,0,1,0
22,246,246,95,95,0,1,0
14,253,253,22,2,20,4,3
32,263,263,2,2,0,1,0
26,268,268,14,14,0,1,0
3,270,270,1,1,0,1,0
30,278,278,40,16,24,4,3
20,279,279,40,26,14,3,2
1,303,303,74,23,51,4,3
36,310,310,20,20,0,1,0
12,327,327,14,14,0,1,0
11,349,349,23,11,12,4,3
31,351,351,38,38,0,1,0
9,367,367,29,29,0,1,0
2,384,384,6,3,3,2,1
28,390,390,15,15,0,1,0
19,403,403,77,5,72,3,2
8,418,418,4,4,0,1,0
15,423,423,73,3,70,3,2
23,452,452,141,65,76,4,3
0,489,489,14,14,0,1,0
5,498,498,93,55,38,2,1
7,499,499,48,48,0,1,0

18,121,121,3,3,0,1,0
33,136,136,33,33,0,1,0
14,139,139,12,12,0,1,0
17,139,139,14,14,0,1,0
8,152,152,9,1,8,3,2
20,154,154,23,9,14,2,1
23,167,167,5,5,0,1,0
4,185,185,27,27,0,1,0
35,194,194,7,7,0,1,0
22,194,194,15,15,0,1,0
29,201,201,15,15,0,1,0
21,204,204,7,7,0,1,0
32,208,208,73,5,68,3,2
13,219,219,33,5,28,3,2
16,226,226,6,6,0,1,0
15,228,228,31,31,0,1,0
26,232,232,10,5,5,2,1
11,247,247,50,16,34,3,2
10,263,263,13,13,0,1,0
3,267,267,28,20,8,2,1
25,275,275,6,6,0,1,0
27,294,294,70,28,42,3,2
2,303,303,12,12,0,1,0
1,306,306,59,59,0,1,0
30,320,320,8,8,0,1,0
19,325,325,81,15,66,4,3
9,369,369,10,4,6,2,1
12,391,391,38,38,0,1,0
34,395,395,10,10,0,1,0
7,408,408,9,9,0,1,0
28,423,423,39,39,0,1,0
0,425,425,17,9,8,2,1
6,450,450,88,88,0,1,0
31,451,451,19,19,0,1,0
24,498,498,3,3,0,1,0
5,498,498,3,3,0,1,0

12,101,101,5,5,0,1,0
24,102,102,6,2,4,2,1
21,113,113,43,43,0,1,0
32,144,144,7,7,0,1,0
31,156,156,42,7,35,2,1
15,159,159,24,12,12,3,2
26,183,183,7,7,0,1,0
13,183,183,3,3,0,1,0
2,184,184,13,13,0,1,0
8,188,188,18,18,0,1,0
23,213,213,9,6,3,2,1
18,219,219,3,3,0,1,0
11,228,228,10,10,0,1,0
7,228,228,13,1,12,4,3
9,231,231,63,63,0,1,0
6,242,242,1,1,0,1,0
30,251,251,3,3,0,1,0
25,293,293,29,29,0,1,0
17,302,302,25,19,6,3,2
14,309,309,11,11,0,1,0
1,341,341,120,120,0,1,0
4,373,373,11,11,0,1,0
3,377,377,37,7,30,4,3
19,389,389,17,2,15,4,3
10,405,405,27,1,26,3,2
33,413,413,13,7,6,3,2
16,429,429,27,21,6,3,2
22,430,430,134,110,24,4,3
29,432,432,7,1,6,2,1
27,441,441,43,9,34,3,2
0,459,459,100,65,35,2,1
20,477,477,32,32,0,1,0
28,493,493,62,2,60,3,2
5,497,497,39,27,12,3,2

3,116,116,8,8,0,1,0
9,133,133,19,1,18,2,1
35,159,159,7,7,0,1,0
8,160,160,9,6,3,2,1
2,181,181,4,4,0,1,0
22,181,181,50,1,49,2,1
26,189,189,9,9,0,1,0
5,192,192,47,14,33,2,1
37,192,192,7,7,0,1,0
7,197,197,17,11,6,3,2
6,223,223,1,1,0,1,0
10,224,224,9,9,0,1,0
33,224,224,16,16,0,1,0
38,229,229,4,1,3,2,1
12,235,235,1,1,0,1,0
19,236,236,27,10,17,2,1
15,276,276,34,27,7,2,1
34,279,279,5,5,0,1,0
18,305,305,1,1,0,1,0
20,313,313,33,18,15,2,1
32,332,332,10,10,0,1,0
17,347,347,2,2,0,1,0
31,347,347,155,92,63,4,3
11,362,362,55,4,51,4,3
1,362,362,75,36,39,2,1
29,371,371,1,1,0,1,0
0,379,379,41,22,19,2,1
24,381,381,26,26,0,1,0
21,390,390,1,1,0,1,0
36,399,399,1,1,0,1,0
25,400,400,33,6,27,4,3
4,413,413,37,37,0,1,0
28,430,430,114,114,0,1,0
16,430,430,8,8,0,1,0
14,436,436,20,20,0,1,0
30,449,449,55,3,52,3,2
27,462,462,33,13,20,3,2
23,463,463,59,59,0,1,0
13,473,473,26,8,18,4,3

4,109,109,53,2,51,4,3
10,111,111,20,8,12,3,2
12,111,111,5,5,0,1,0
16,117,117,2,2,0,1,0
23,124,124,7,1,6,3,2
2,131,131,1,1,0,1,0
18,135,135,2,2,0,1,0
11,144,144,27,11,16,2,1
6,159,159,12,12,0,1,0
22,163,163,17,17,0,1,0
0,238,238,9,3,6,2,1
27,248,248,3,3,0,1,0
24,264,264,9,9,0,1,0
17,274,274,1,1,0,1,0
13,282,282,58,58,0,1,0
20,310,310,5,5,0,1,0
15,310,310,62,62,0,1,0
14,313,313,78,78,0,1,0
19,350,350,64,64,0,1,0
26,361,361,14,14,0,1,0
28,372,372,181,156,25,2,1
21,376,376,2,2,0,1,0
5,431,431,39,9,30,2,1
1,432,432,147,106,41,2,1
3,449,449,76,55,21,2,1
7,471,471,21,2,19,2,1
9,479,479,12,8,4,2,1
8,486,486,27,15,12,4,3
25,496,496,33,27,6,2,1

20,120,120,9,9,0,1,0
23,126,126,18,3,15,4,3
6,137,137,15,15,0,1,0
19,142,142,20,20,0,1,0
28,143,143,23,23,0,1,0
35,149,149,1,1,0,1,0
26,149,149,16,4,12,3,2
2,176,176,1,1,0,1,0
12,192,192,7,7,0,1,0
21,204,204,11,11,0,1,0
11,207,207,35,15,20,3,2
7,224,224,10,10,0,1,0
0,261,261,3,3,0,1,0
4,263,263,64,12,52,3,2
8,266,266,4,4,0,1,0
18,267,267,6,6,0,1,0
22,333,333,16,1,15,3,2
30,338,338,88,88,0,1,0
31,352,352,7,7,0,1,0
14,354,354,3,3,0,1,0
3,358,358,42,10,32,2,1
15,365,365,8,2,6,3,2
9,374,374,24,24,0,1,0
29,374,374,8,1,7,2,1
24,381,381,58,35,23,3,2
5,382,382,143,75,68,4,3
33,383,383,45,45,0,1,0
32,386,386,1,1,0,1,0
17,390,390,49,49,0,1,0
34,396,396,4,4,0,1,0
16,400,400,96,96,0,1,0
27,409,409,73,8,65,3,2
25,436,436,106,20,86,3,2
10,444,444,3,3,0,1,0
1,461,461,1,1,0,1,0
13,481,481,41,41,0,1,0

4,102,102,2,2,0,1,0
3,114,114,3,3,0,1,0
18,130,130,28,28,0,1,0
12,161,161,21,7,14,2,1
31,169,169,72,55,17,2,1
22,174,174,41,41,0,1,0
2,190,190,51,51,0,1,0
21,195,195,34,13,21,4,3
28,218,218,8,8,0,1,0
16,251,251,4,4,0,1,0
9,259,259,12,3,9,4,3
25,261,261,12,12,0,1,0
30,264,264,8,2,6,3,2
26,287,287,51,18,33,2,1
11,303,303,1,1,0,1,0
7,322,322,48,38,10,3,2
29,324,324,20,8,12,4,3
5,342,342,20,17,3,2,1
10,345,345,17,1,16,2,1
0,372,372,150,140,10,3,2
19,382,382,43,43,0,1,0
1,384,384,31,31,0,1,0
6,401,401,34,34,0,1,0
27,409,409,6,6,0,1,0
15,421,421,4,4,0,1,0
13,422,422,99,12,87,4,3
24,450,450,31,31,0,1,0
8,452,452,53,53,0,1,0
14,454,454,13,13,0,1,0
23,458,458,31,31,0,1,0
17,462,462,8,8,0,1,0
20,494,494,9,9,0,1,0

6,130,130,4,4,0,1,0
31,137,137,9,9,0,1,0
32,142,142,28,28,0,1,0
26,145,145,11,11,0,1,0
12,151,151,8,1,7,2,1
15,156,156,1,1,0,1,0
20,168,168,3,3,0,1,0
22,172,172,20,20,0,1,0
21,177,177,11,11,0,1,0
17,178,178,14,14,0,1,0
4,187,187,8,2,6,3,2
0,200,200,80,65,15,4,3
34,233,233,21,15,6,3,2
24,240,240,13,4,9,3,2
7,243,243,2,2,0,1,0
19,254,254,130,4,126,4,3
29,259,259,4,4,0,1,0
3,264,264,1,1,0,1,0
14,280,280,17,2,15,2,1
13,287,287,43,26,17,2,1
11,291,291,1,1,0,1,0
28,304,304,24,24,0,1,0
5,306,306,10,10,0,1,0
30,315,315,22,13,9,2,1
9,318,318,11,7,4,2,1
23,319,319,61,15,46,2,1
35,341,341,33,24,9,4,3
16,375,375,41,32,9,2,1
25,377,377,13,13,0,1,0
27,389,389,9,9,0,1,0
2,417,417,39,30,9,4,3
8,429,429,29,20,9,2,1
1,455,455,89,89,0,1,0
10,462,462,144,62,82,3,2
18,491,491,9,9,0,1,0
33,494,494,17,17,0,1,0

35,105,105,4,4,0,1,0
17,110,110,19,19,0,1,0
24,111,111,2,2,0,1,0
40,124,124,5,5,0,1,0
10,130,130,2,2,0,1,0
7,153,153,10,10,0,1,0
3,204,204,16,2,14,2,1
26,226,226,35,20,15,2,1
2,231,231,1,1,0,1,0
31,242,242,1,1,0,1,0
37,244,244,8,2,6,2,1
25,245,245,68,8,60,3,2
1,252,252,36,22,14,3,2
33,269,269,11,1,10,3,2
15,273,273,21,3,18,3,2
13,281,281,27,6,21,4,3
34,281,281,32,6,26,3,2
5,282,282,32,32,0,1,0
27,287,287,88,28,60,3,2
16,288,288,1,1,0,1,0
39,289,289,39,39,0,1,0
19,297,297,4,4,0,1,0
23,315,315,58,58,0,1,0
8,354,354,1,1,0,1,0
21,367,367,2,2,0,1,0
4,394,394,27,5,22,3,2
9,394,394,15,3,12,2,1
20,397,397,51,51,0,1,0
28,409,409,114,37,77,4,3
30,417,417,7,3,4,2,1
36,419,419,32,18,14,3,2
29,427,427,27,27,0,1,0
12,430,430,52,17,35,2,1
32,457,457,45,45,0,1,0
0,464,464,22,14,8,2,1
18,469,469,17,17,0,1,0
22,473,473,22,10,12,2,1
6,473,473,14,14,0,1,0
14,478,478,46,22,24,3,2
38,494,494,17,4,13,2,1
11,500,500,58,58,0,1,0

29,111,111,27,27,0,1,0
26,137,137,7,4,3,2,1
22,139,139,14,14,0,1,0
0,140,140,18,18,0,1,0
5,143,143,34,34,0,1,0
3,153,153,6,6,0,1,0
4,162,162,18,18,0,1,0
30,180,180,9,9,0,1,0
21,184,184,16,4,12,4,3
14,193,193,17,5,12,2,1
12,221,221,100,85,15,4,3
13,227,227,19,19,0,1,0
20,248,248,21,21,0,1,0
8,273,273,12,3,9,4,3
27,281,281,7,7,0,1,0
17,293,293,14,3,11,2,1
11,297,297,25,25,0,1,0
7,302,302,19,7,12,2,1
18,303,303,9,9,0,1,0
2,311,311,33,33,0,1,0
19,318,318,10,2,8,3,2
15,320,320,68,68,0,1,0
16,335,335,25,7,18,3,2
25,338,338,5,5,0,1,0
9,372,372,3,3,0,1,0
1,387,387,39,21,18,2,1
23,397,397,48,48,0,1,0
28,411,411,23,23,0,1,0
6,450,450,85,6,79,4,3
10,469,469,25,12,13,2,1
24,489,489,206,104,102,4,3

31,102,102,10,10,0,1,0
24,108,108,2,2,0,1,0
26,109,109,10,10,0,1,0
18,120,120,9,9,0,1,0
6,127,127,8,8,0,1,0
16,130,130,24,24,0,1,0
15,132,132,46,46,0,1,0
23,153,153,21,21,0,1,0
9,163,163,41,41,0,1,0
13,179,179,4,1,3,2,1
8,187,187,2,2,0,1,0
20,208,208,27,27,0,1,0
7,228,228,5,2,3,2,1
29,251,251,9,9,0,1,0
12,277,277,108,108,0,1,0
1,277,277,10,2,8,3,2
17,280,280,19,7,12,3,2
27,287,287,3,3,0,1,0
22,307,307,29,20,9,2,1
4,327,327,6,2,4,2,1
30,338,338,45,45,0,1,0
10,338,338,96,49,47,2,1
32,352,352,9,3,6,3,2
2,370,370,33,11,22,3,2
0,378,378,14,14,0,1,0
28,387,387,100,12,88,4,3
3,398,398,18,6,12,4,3
14,419,419,13,7,6,3,2
21,426,426,1,1,0,1,0
11,459,459,7,7,0,1,0
5,461,461,20,2,18,3,2
19,496,496,137,60,77,4,3
25,497,497,49,49,0,1,0

5,111,111,6,2,4,2,1
13,129,129,7,7,0,1,0
26,131,131,8,8,0,1,0
15,140,140,14,14,0,1,0
24,144,144,16,1,15,2,1
8,147,147,5,5,0,1,0
4,165,165,37,37,0,1,0
21,174,174,21,15,6,3,2
9,217,217,28,28,0,1,0
18,220,220,26,26,0,1,0
12,225,225,5,5,0,1,0
25,246,246,5,2,3,2,1
22,258,258,120,15,105,4,3
28,295,295,55,55,0,1,0
10,316,316,47,31,16,3,2
1,368,368,52,52,0,1,0
14,375,375,54,54,0,1,0
6,387,387,59,59,0,1,0
11,387,387,61,61,0,1,0
16,390,390,3,3,0,1,0
19,413,413,27,7,20,3,2
2,419,419,94,52,42,2,1
29,429,429,7,2,5,2,1
0,437,437,42,18,24,3,2
23,440,440,31,31,0,1,0
17,441,441,8,5,3,2,1
20,451,451,55,43,12,2,1
3,455,455,48,48,0,1,0
7,499,499,107,59,48,2,1
27,500,500,28,3,25,2,1

30,116,116,2,2,0,1,0
11,120,120,1,1,0,1,0
10,148,148,1,1,0,1,0
26,185,185,37,37,0,1,0
1,195,195,33,33,0,1,0
6,200,200,105,98,7,2,1
20,205,205,25,6,19,2,1
23,212,212,5,5,0,1,0
28,222,222,16,16,0,1,0
8,240,240,60,10,50,2,1
9,242,242,31,31,0,1,0
12,251,251,23,9,14,3,2
14,253,253,51,51,0,1,0
21,258,258,10,4,6,3,2
22,263,263,6,6,0,1,0
27,290,290,73,61,12,4,3
7,305,305,50,20,30,4,3
19,309,309,3,3,0,1,0
25,321,321,30,30,0,1,0
5,342,342,13,6,7,2,1
18,358,358,16,16,0,1,0
2,363,363,13,1,12,4,3
24,375,375,13,4,9,2,1
0,409,409,9,9,0,1,0
16,421,421,75,75,0,1,0
4,425,425,11,11,0,1,0
17,441,441,77,77,0,1,0
15,443,443,51,51,0,1,0
29,443,443,58,58,0,1,0
13,451,451,12,12,0,1,0
3,478,478,100,14,86,3,2

7,106,106,5,5,0,1,0
19,109,109,11,11,0,1,0
1,116,116,1,1,0,1,0
20,133,133,11,11,0,1,0
22,139,139,42,42,0,1,0
9,140,140,1,1,0,1,0
2,156,156,35,31,4,2,1
17,161,161,6,6,0,1,0
8,181,181,16,16,0,1,0
21,206,206,2,2,0,1,0
28,210,210,45,31,14,3,2
24,222,222,4,4,0,1,0
26,233,233,7,7,0,1,0
5,277,277,7,4,3,2,1
23,277,277,18,12,6,3,2
6,281,281,43,19,24,3,2
13,283,283,124,82,42,4,3
0,299,299,20,2,18,2,1
10,329,329,50,50,0,1,0
16,353,353,45,15,30,2,1
3,380,380,107,72,35,2,1
18,383,383,122,122,0,1,0
11,394,394,39,39,0,1,0
12,400,400,12,3,9,4,3
15,401,401,7,1,6,2,1
14,418,418,17,17,0,1,0
25,423,423,19,19,0,1,0
27,470,470,43,43,0,1,0
29,484,484,50,26,24,4,3
4,494,494,39,14,25,3,2
30,496,496,62,54,8,3,2

4,106,106,4,4,0,1,0
17,110,110,8,3,5,2,1
37,112,112,2,2,0,1,0
39,120,120,6,6,0,1,0
35,130,130,6,1,5,2,1
24,130,130,41,41,0,1,0
12,141,141,8,8,0,1,0
15,150,150,17,17,0,1,0
33,167,167,3,3,0,1,0
29,178,178,14,14,0,1,0
26,183,183,8,8,0,1,0
34,195,195,6,6,0,1,0
27,197,197,12,12,0,1,0
18,198,198,10,10,0,1,0
30,209,209,2,2,0,1,0
5,211,211,60,18,42,2,1
3,215,215,27,1,26,3,2
31,221,221,16,6,10,2,1
20,265,265,24,5,19,2,1
11,272,272,7,1,6,2,1
14,302,302,39,39,0,1,0
9,315,315,4,4,0,1,0
21,319,319,2,2,0,1,0
16,319,319,6,6,0,1,0
13,325,325,38,20,18,2,1
28,349,349,10,10,0,1,0
2,354,354,7,4,3,2,1
23,383,383,118,84,34,2,1
1,414,414,47,8,39,4,3
10,415,415,46,46,0,1,0
38,421,421,116,116,0,1,0
36,428,428,38,4,34,2,1
32,441,441,13,13,0,1,0
8,449,449,27,18,9,4,3
0,452,452,4,4,0,1,0
6,454,454,30,10,20,3,2
25,465,465,117,117,0,1,0
7,470,470,25,25,0,1,0
22,483,483,61,61,0,1,0
19,489,489,1,1,0,1,0

6,105,105,23,23,0,1,0
34,140,140,7,7,0,1,0
16,154,154,29,29,0,1,0
32,183,183,2,2,0,1,0
19,204,204,29,14,15,4,3
27,208,208,13,6,7,2,1
10,210,210,3,3,0,1,0
33,214,214,16,2,14,3,2
24,234,234,53,38,15,4,3
30,237,237,2,2,0,1,0
31,245,245,8,8,0,1,0
14,250,250,65,31,34,3,2
22,255,255,40,31,9,2,1
18,257,257,1,1,0,1,0
26,258,258,7,7,0,1,0
17,259,259,17,7,10,3,2
1,298,298,69,69,0,1,0
4,317,317,48,13,35,2,1
25,318,318,103,43,60,4,3
9,333,333,55,15,40,2,1
21,371,371,92,92,0,1,0
5,377,377,9,9,0,1,0
23,383,383,55,55,0,1,0
20,388,388,13,13,0,1,0
8,410,410,12,12,0,1,0
2,422,422,51,24,27,4,3
0,425,425,1,1,0,1,0
7,429,429,9,9,0,1,0
29,433,433,49,35,14,3,2
3,445,445,23,5,18,2,1
11,452,452,23,23,0,1,0
15,468,468,2,2,0,1,0
28,470,470,32,27,5,2,1
13,479,479,34,19,15,2,1
12,486,486,16,1,15,4,3

28,101,101,6,6,0,1,0
22,128,128,21,17,4,2,1
24,141,141,14,14,0,1,0
0,145,145,1,1,0,1,0
3,155,155,30,30,0,1,0
27,156,156,22,17,5,2,1
29,187,187,10,10,0,1,0
13,187,187,28,24,4,2,1
4,194,194,25,25,0,1,0
19,216,216,12,6,6,3,2
8,219,219,11,11,0,1,0
21,226,226,4,4,0,1,0
14,228,228,11,11,0,1,0
7,231,231,85,85,0,1,0
30,248,248,44,44,0,1,0
11,260,260,11,11,0,1,0
5,263,263,16,2,14,2,1
15,289,289,26,26,0,1,0
25,291,291,60,2,58,4,3
6,292,292,4,1,3,2,1
17,308,308,41,29,12,3,2
12,310,310,31,31,0,1,0
23,319,319,6,3,3,2,1
2,332,332,59,59,0,1,0
31,333,333,13,2,11,2,1
26,334,334,49,49,0,1,0
9,366,366,66,24,42,2,1
10,374,374,31,31,0,1,0
18,410,410,11,11,0,1,0
20,419,419,93,93,0,1,0
1,451,451,45,45,0,1,0
16,498,498,42,42,0,1,0

30,107,107,11,1,10,2,1
0,140,140,23,4,19,2,1
15,150,150,9,3,6,2,1
26,155,155,25,25,0,1,0
25,163,163,12,3,9,4,3
27,169,169,15,3,12,2,1
8,188,188,14,7,7,2,1
4,193,193,5,5,0,1,0
18,211,211,9,9,0,1,0
16,215,215,6,6,0,1,0
21,231,231,16,8,8,3,2
10,236,236,12,12,0,1,0
3,242,242,10,10,0,1,0
5,264,264,9,9,0,1,0
19,265,265,31,31,0,1,0
20,273,273,21,5,16,3,2
23,294,294,16,16,0,1,0
28,310,310,64,64,0,1,0
6,323,323,150,119,31,2,1
24,345,345,10,10,0,1,0
7,349,349,30,30,0,1,0
2,353,353,6,6,0,1,0
29,367,367,15,6,9,2,1
12,381,381,141,87,54,3,2
17,392,392,15,4,11,2,1
1,395,395,63,33,30,4,3
22,452,452,35,35,0,1,0
11,455,455,10,1,9,2,1
13,467,467,85,22,63,4,3
14,469,469,218,110,108,4,3
9,500,500,5,1,4,2,1

12,108,108,1,1,0,1,0
23,145,145,6,6,0,1,0
7,149,149,32,9,23,4,3
33,150,150,16,16,0,1,0
10,180,180,23,6,17,2,1
28,184,184,8,8,0,1,0
1,188,188,11,11,0,1,0
20,193,193,1,1,0,1,0
11,206,206,7,1,6,2,1
3,210,210,56,56,0,1,0
29,230,230,34,34,0,1,0
18,249,249,5,5,0,1,0
24,261,261,36,3,33,4,3
21,265,265,1,1,0,1,0
19,277,277,1,1,0,1,0
36,282,282,60,25,35,2,1
2,283,283,2,2,0,1,0
32,317,317,2,2,0,1,0
30,317,317,22,22,0,1,0
5,331,331,27,27,0,1,0
27,332,332,40,40,0,1,0
9,335,335,12,2,10,2,1
14,340,340,14,4,10,3,2
39,342,342,8,1,7,2,1
34,363,363,54,25,29,2,1
8,368,368,6,6,0,1,0
4,374,374,1,1,0,1,0
22,377,377,19,1,18,3,2
17,378,378,16,11,5,2,1
31,380,380,76,39,37,2,1
26,408,408,32,13,19,4,3
40,443,443,10,1,9,2,1
13,453,453,91,19,72,3,2
38,454,454,45,37,8,2,1
16,458,458,63,39,24,4,3
0,463,463,52,52,0,1,0
25,466,466,24,24,0,1,0
37,475,475,104,104,0,1,0
15,484,484,50,6,44,3,2
35,490,490,23,23,0,1,0
6,494,494,44,44,0,1,0

13,106,106,7,7,0,1,0
22,107,107,23,3,20,3,2
3,110,110,1,1,0,1,0
9,122,122,40,40,0,1,0
1,149,149,1,1,0,1,0
14,152,152,1,1,0,1,0
6,160,160,40,40,0,1,0
4,199,199,9,9,0,1,0
11,200,200,65,35,30,2,1
2,212,212,55,48,7,2,1
7,212,212,89,26,63,4,3
20,214,214,9,9,0,1,0
17,217,217,21,21,0,1,0
26,237,237,36,36,0,1,0
23,243,243,4,4,0,1,0
5,272,272,57,57,0,1,0
0,278,278,25,8,17,2,1
25,282,282,8,2,6,2,1
21,308,308,54,16,38,2,1
15,336,336,28,18,10,2,1
8,354,354,30,9,21,2,1
18,371,371,38,38,0,1,0
16,374,374,22,15,7,2,1
12,385,385,12,12,0,1,0
19,405,405,24,24,0,1,0
10,419,419,106,9,97,4,3
24,491,491,12,1,11,2,1

27,116,116,6,6,0,1,0
1,151,151,1,1,0,1,0
12,172,172,8,1,7,2,1
6,186,186,47,47,0,1,0
14,192,192,31,31,0,1,0
9,215,215,7,7,0,1,0
22,237,237,8,3,5,2,1
25,240,240,11,11,0,1,0
32,250,250,44,8,36,4,3
19,264,264,35,35,0,1,0
18,266,266,1,1,0,1,0
35,309,309,9,5,4,2,1
31,311,311,2,2,0,1,0
15,348,348,80,80,0,1,0
8,357,357,5,5,0,1,0
34,367,367,72,72,0,1,0
37,371,371,200,115,85,4,3
0,380,380,76,48,28,2,1
28,380,380,3,3,0,1,0
36,390,390,14,8,6,2,1
30,390,390,4,1,3,2,1
11,394,394,17,17,0,1,0
20,397,397,31,31,0,1,0
4,409,409,59,59,0,1,0
5,414,414,1,1,0,1,0
26,423,423,83,27,56,3,2
16,441,441,28,28,0,1,0
2,444,444,96,19,77,3,2
10,445,445,3,3,0,1,0
17,448,448,7,7,0,1,0
29,453,453,9,9,0,1,0
3,460,460,3,3,0,1,0
24,472,472,17,17,0,1,0
33,477,477,15,1,14,2,1
23,487,487,2,2,0,1,0
21,489,489,152,152,0,1,0
13,497,497,15,8,7,2,1
7,499,499,7,2,5,2,1

21,111,111,20,20,0,1,0
3,127,127,58,15,43,2,1
8,150,150,1,1,0,1,0
19,161,161,2,2,0,1,0
18,178,178,8,2,6,3,2
14,179,179,21,8,13,2,1
5,208,208,57,1,56,3,2
0,209,209,1,1,0,1,0
25,217,217,3,3,0,1,0
23,226,226,25,11,14,4,3
16,250,250,7,7,0,1,0
4,301,301,30,13,17,2,1
11,302,302,5,5,0,1,0
24,306,306,2,2,0,1,0
9,319,319,1,1,0,1,0
7,333,333,14,14,0,1,0
13,346,346,46,4,42,4,3
1,361,361,5,5,0,1,0
12,371,371,3,3,0,1,0
26,407,407,99,99,0,1,0
17,431,431,4,4,0,1,0
6,450,450,23,2,21,4,3
15,455,455,117,117,0,1,0
20,459,459,1,1,0,1,0
2,470,470,353,271,82,3,2
22,486,486,95,95,0,1,0
10,495,495,177,135,42,4,3

11,110,110,6,2,4,2,1
24,115,115,11,11,0,1,0
20,125,125,6,6,0,1,0
28,138,138,9,9,0,1,0
2,141,141,19,13,6,3,2
8,172,172,10,4,6,3,2
27,181,181,9,1,8,2,1
31,182,182,18,10,8,3,2
0,190,190,7,7,0,1,0
6,190,190,11,11,0,1,0
25,191,191,28,28,0,1,0
18,229,229,49,9,40,3,2
10,232,232,7,3,4,2,1
7,238,238,14,8,6,3,2
23,239,239,4,4,0,1,0
19,249,249,13,7,6,3,2
16,255,255,72,72,0,1,0
35,271,271,59,55,4,2,1
34,285,285,99,66,33,4,3
9,308,308,4,1,3,2,1
5,326,326,26,2,24,3,2
33,328,328,41,38,3,2,1
17,338,338,115,43,72,4,3
15,338,338,15,15,0,1,0
26,380,380,6,6,0,1,0
1,403,403,34,3,31,2,1
3,403,403,17,17,0,1,0
22,408,408,43,19,24,3,2
12,412,412,2,2,0,1,0
21,423,423,6,6,0,1,0
13,443,443,28,28,0,1,0
29,445,445,43,43,0,1,0
30,458,458,52,52,0,1,0
32,465,465,61,9,52,3,2
4,465,465,34,34,0,1,0
14,479,479,15,15,0,1,0

13,114,114,7,7,0,1,0
33,136,136,12,6,6,3,2
25,137,137,2,2,0,1,0
31,149,149,13,8,5,2,1
10,154,154,5,5,0,1,0
28,183,183,79,13,66,3,2
37,192,192,53,33,20,3,2
16,204,204,51,51,0,1,0
7,210,210,13,9,4,2,1
18,218,218,10,7,3,2,1
23,220,220,7,7,0,1,0
0,226,226,12,2,10,2,1
22,227,227,1,1,0,1,0
11,242,242,31,31,0,1,0
19,246,246,1,1,0,1,0
6,270,270,2,2,0,1,0
29,289,289,21,16,5,2,1
1,299,299,21,3,18,4,3
38,311,311,19,19,0,1,0
36,321,321,10,10,0,1,0
3,329,329,37,37,0,1,0
24,330,330,35,35,0,1,0
26,331,331,7,7,0,1,0
17,358,358,5,5,0,1,0
14,368,368,8,8,0,1,0
5,372,372,29,29,0,1,0
34,381,381,16,6,10,2,1
30,381,381,58,58,0,1,0
35,410,410,87,35,52,3,2
15,420,420,47,47,0,1,0
20,435,435,48,14,34,2,1
4,460,460,124,49,75,4,3
9,463,463,1,1,0,1,0
27,466,466,13,13,0,1,0
12,470,470,34,16,18,2,1
32,471,471,39,30,9,4,3
21,482,482,27,27,0,1,0
2,486,486,31,13,18,4,3
8,498,498,37,37,0,1,0

42,132,132,19,2,17,2,1
30,139,139,4,4,0,1,0
23,155,155,16,16,0,1,0
15,165,165,16,16,0,1,0
4,174,174,41,41,0,1,0
35,178,178,8,8,0,1,0
6,183,183,1,1,0,1,0
36,193,193,18,13,5,2,1
9,195,195,57,57,0,1,0
31,201,201,7,7,0,1,0
13,202,202,1,1,0,1,0
33,206,206,58,30,28,2,1
26,212,212,20,5,15,4,3
40,225,225,14,11,3,2,1
8,233,233,1,1,0,1,0
20,235,235,13,13,0,1,0
27,263,263,4,4,0,1,0
12,266,266,2,2,0,1,0
28,272,272,17,17,0,1,0
37,281,281,66,60,6,3,2
16,313,313,17,17,0,1,0
18,316,316,32,32,0,1,0
29,317,317,17,17,0,1,0
32,318,318,129,88,41,2,1
39,322,322,4,4,0,1,0
19,328,328,12,8,4,2,1
38,336,336,18,18,0,1,0
7,356,356,13,13,0,1,0
3,357,357,48,29,19,2,1
17,371,371,33,11,22,2,1
14,401,401,18,2,16,3,2
10,416,416,6,6,0,1,0
0,425,425,4,4,0,1,0
24,431,431,20,1,19,2,1
11,432,432,25,17,8,2,1
21,446,446,3,3,0,1,0
25,450,450,1,1,0,1,0
34,451,451,40,4,36,2,1
1,454,454,3,3,0,1,0
2,461,461,47,11,36,2,1
22,474,474,67,67,0,1,0
5,490,490,6,6,0,1,0
41,494,494,16,16,0,1,0

31,115,115,9,4,5,2,1
5,115,115,1,1,0,1,0
16,116,116,14,5,9,4,3
17,125,125,10,10,0,1,0
26,143,143,3,3,0,1,0
19,145,145,49,49,0,1,0
27,146,146,17,3,14,3,2
14,190,190,19,4,15,2,1
34,195,195,37,37,0,1,0
25,213,213,7,2,5,2,1
10,231,231,1,1,0,1,0
3,258,258,30,1,29,4,3
30,296,296,55,55,0,1,0
1,305,305,11,11,0,1,0
32,307,307,2,2,0,1,0
33,309,309,5,5,0,1,0
20,310,310,39,17,22,3,2
12,311,311,37,7,30,2,1
15,333,333,7,7,0,1,0
28,336,336,17,1,16,3,2
0,336,336,100,100,0,1,0
22,348,348,84,75,9,4,3
13,350,350,22,8,14,3,2
23,360,360,3,3,0,1,0
7,366,366,9,5,4,2,1
29,372,372,44,36,8,2,1
4,377,377,170,74,96,4,3
11,424,424,1,1,0,1,0
9,431,431,17,17,0,1,0
24,436,436,26,7,19,2,1
21,437,437,26,2,24,3,2
6,438,438,26,26,0,1,0
2,453,453,38,5,33,4,3
18,478,478,41,2,39,2,1
8,491,491,39,39,0,1,0

0,108,108,1,1,0,1,0
11,111,111,1,1,0,1,0
21,112,112,14,4,10,3,2
9,134,134,18,18,0,1,0
17,144,144,9,9,0,1,0
20,157,157,23,23,0,1,0
34,162,162,32,27,5,2,1
13,196,196,1,1,0,1,0
36,231,231,3,3,0,1,0
28,267,267,53,11,42,4,3
10,280,280,23,7,16,3,2
6,283,283,39,39,0,1,0
37,286,286,13,13,0,1,0
12,294,294,32,32,0,1,0
19,294,294,7,7,0,1,0
18,308,308,10,1,9,4,3
23,313,313,32,32,0,1,0
14,320,320,30,30,0,1,0
30,341,341,5,5,0,1,0
38,366,366,90,90,0,1,0
8,368,368,39,25,14,2,1
31,374,374,14,14,0,1,0
3,386,386,12,12,0,1,0
15,391,391,54,40,14,2,1
35,393,393,1,1,0,1,0
29,398,398,33,33,0,1,0
33,405,405,7,7,0,1,0
22,412,412,37,37,0,1,0
1,427,427,38,14,24,3,2
27,428,428,107,107,0,1,0
32,458,458,83,27,56,4,3
7,462,462,19,10,9,4,3
5,464,464,61,16,45,2,1
4,469,469,10,10,0,1,0
2,476,476,28,22,6,3,2
24,490,490,6,6,0,1,0
16,490,490,57,21,36,3,2
25,491,491,31,31,0,1,0
26,497,497,81,81,0,1,0

27,103,103,6,2,4,2,1
30,109,109,15,15,0,1,0
4,117,117,34,34,0,1,0
18,120,120,1,1,0,1,0
9,124,124,14,14,0,1,0
26,154,154,18,18,0,1,0
20,168,168,6,6,0,1,0
31,170,170,2,2,0,1,0
6,177,177,4,4,0,1,0
25,203,203,14,14,0,1,0
16,213,213,18,18,0,1,0
7,236,236,1,1,0,1,0
2,240,240,3,3,0,1,0
29,253,253,9,1,8,3,2
37,255,255,74,74,0,1,0
35,262,262,11,11,0,1,0
1,269,269,70,53,17,2,1
10,270,270,10,3,7,2,1
15,279,279,12,12,0,1,0
17,280,280,11,11,0,1,0
0,286,286,16,4,12,3,2
3,299,299,8,8,0,1,0
21,325,325,57,4,53,4,3
32,326,326,2,2,0,1,0
24,348,348,15,15,0,1,0
38,354,354,14,14,0,1,0
12,357,357,10,6,4,2,1
8,364,364,25,12,13,2,1
5,366,366,10,10,0,1,0
11,374,374,2,2,0,1,0
14,380,380,57,17,40,4,3
34,389,389,53,5,48,3,2
36,410,410,188,180,8,2,1
13,417,417,10,10,0,1,0
19,430,430,81,45,36,2,1
28,434,434,14,14,0,1,0
22,447,447,34,34,0,1,0
33,466,466,10,10,0,1,0
23,489,489,80,5,75,4,3

29,104,104,11,11,0,1,0
11,123,123,23,23,0,1,0
24,137,137,28,20,8,3,2
5,140,140,1,1,0,1,0
19,150,150,32,10,22,3,2
2,159,159,1,1,0,1,0
16,162,162,4,4,0,1,0
12,166,166,13,13,0,1,0
31,178,178,25,9,16,3,2
8,198,198,16,1,15,2,1
32,200,200,24,24,0,1,0
22,211,211,2,2,0,1,0
23,212,212,5,5,0,1,0
7,219,219,6,1,5,2,1
30,223,223,47,47,0,1,0
0,234,234,47,47,0,1,0
9,242,242,30,25,5,2,1
13,242,242,58,58,0,1,0
1,258,258,7,7,0,1,0
10,301,301,29,15,14,3,2
4,309,309,12,12,0,1,0
26,312,312,42,10,32,3,2
6,323,323,1,1,0,1,0
33,325,325,5,5,0,1,0
28,326,326,33,33,0,1,0
3,339,339,67,67,0,1,0
15,340,340,39,23,16,3,2
27,378,378,21,21,0,1,0
20,393,393,31,31,0,1,0
17,410,410,14,14,0,1,0
21,436,436,36,36,0,1,0
25,461,461,40,40,0,1,0
14,473,473,117,50,67,4,3
18,492,492,60,60,0,1,0

10,119,119,4,4,0,1,0
23,150,150,18,8,10,3,2
12,187,187,23,23,0,1,0
25,214,214,13,13,0,1,0
18,219,219,4,4,0,1,0
19,239,239,71,5,66,4,3
7,314,314,44,16,28,3,2
4,320,320,63,36,27,2,1
6,321,321,115,115,0,1,0
8,322,322,64,64,0,1,0
20,331,331,36,2,34,3,2
3,341,341,131,4,127,4,3
22,349,349,92,92,0,1,0
5,369,369,15,15,0,1,0
16,379,379,19,19,0,1,0
1,385,385,66,6,60,3,2
0,397,397,49,49,0,1,0
26,400,400,63,18,45,4,3
2,421,421,7,7,0,1,0
15,422,422,32,11,21,2,1
13,435,435,5,5,0,1,0
24,435,435,109,109,0,1,0
9,436,436,31,31,0,1,0
14,448,448,8,8,0,1,0
21,473,473,15,15,0,1,0
11,475,475,46,1,45,4,3
17,500,500,7,7,0,1,0

23,120,120,19,19,0,1,0
17,126,126,7,7,0,1,0
29,144,144,5,5,0,1,0
33,146,146,9,9,0,1,0
15,148,148,10,5,5,2,1
32,152,152,13,4,9,2,1
28,160,160,30,4,26,3,2
8,164,164,24,24,0,1,0
10,199,199,98,56,42,4,3
24,206,206,29,21,8,2,1
20,213,213,30,30,0,1,0
12,217,217,2,2,0,1,0
27,239,239,7,7,0,1,0
19,246,246,70,19,51,4,3
11,252,252,16,16,0,1,0
1,262,262,4,4,0,1,0
25,279,279,7,7,0,1,0
9,283,283,8,8,0,1,0
4,292,292,70,35,35,2,1
6,300,300,1,1,0,1,0
16,328,328,27,27,0,1,0
0,341,341,3,3,0,1,0
31,348,348,1,1,0,1,0
30,350,350,26,11,15,2,1
3,376,376,13,13,0,1,0
5,379,379,15,5,10,2,1
18,380,380,106,106,0,1,0
21,435,435,51,6,45,2,1
14,436,436,1,1,0,1,0
26,459,459,14,6,8,3,2
2,461,461,101,83,18,2,1
13,466,466,92,92,0,1,0
7,472,472,25,1,24,4,3
22,488,488,13,7,6,2,1

6,100,100,1,1,0,1,0
17,109,109,13,1,12,3,2
0,118,118,12,12,0,1,0
23,133,133,9,9,0,1,0
34,192,192,2,2,0,1,0
20,195,195,48,25,23,2,1
24,219,219,43,23,20,3,2
22,227,227,18,5,13,2,1
19,231,231,55,55,0,1,0
11,241,241,13,1,12,3,2
8,272,272,7,7,0,1,0
7,274,274,1,1,0,1,0
18,274,274,12,4,8,2,1
31,289,289,12,12,0,1,0
29,290,290,67,19,48,4,3
3,327,327,25,25,0,1,0
15,328,328,1,1,0,1,0
9,334,334,88,41,47,4,3
28,346,346,19,5,14,3,2
10,355,355,29,18,11,2,1
25,357,357,3,3,0,1,0
14,362,362,42,42,0,1,0
32,364,364,14,14,0,1,0
26,376,376,20,20,0,1,0
27,389,389,78,60,18,3,2
12,390,390,49,49,0,1,0
4,393,393,135,118,17,2,1
2,403,403,21,6,15,4,3
33,412,412,41,37,4,2,1
1,422,422,41,41,0,1,0
16,427,427,49,28,21,4,3
30,461,461,47,47,0,1,0
21,466,466,9,2,7,2,1
5,466,466,23,23,0,1,0
13,492,492,31,13,18,2,1

9,117,117,5,5,0,1,0
21,121,121,1,1,0,1,0
18,125,125,16,16,0,1,0
10,127,127,22,22,0,1,0
8,130,130,30,30,0,1,0
14,190,190,49,12,37,3,2
6,218,218,80,80,0,1,0
4,232,232,46,20,26,2,1
12,258,258,73,73,0,1,0
28,265,265,21,6,15,2,1
20,302,302,78,78,0,1,0
25,307,307,9,9,0,1,0
17,312,312,66,24,42,4,3
3,330,330,20,6,14,3,2
2,338,338,15,15,0,1,0
27,343,343,11,6,5,2,1
16,344,344,46,46,0,1,0
13,374,374,27,8,19,3,2
7,393,393,1,1,0,1,0
11,396,396,62,44,18,3,2
0,401,401,1,1,0,1,0
26,407,407,101,101,0,1,0
22,432,432,19,3,16,3,2
23,441,441,8,2,6,2,1
24,456,456,6,6,0,1,0
5,477,477,30,18,12,3,2
15,478,478,17,5,12,3,2
29,480,480,11,11,0,1,0
19,485,485,66,50,16,3,2
1,497,497,39,24,15,4,3

26,121,121,29,13,16,2,1
35,124,124,8,3,5,2,1
5,139,139,14,14,0,1,0
28,149,149,4,4,0,1,0
23,150,150,8,8,0,1,0
22,167,167,6,6,0,1,0
18,175,175,7,7,0,1,0
2,184,184,7,7,0,1,0
14,189,189,9,9,0,1,0
30,195,195,21,21,0,1,0
7,220,220,41,41,0,1,0
33,228,228,35,35,0,1,0
0,235,235,1,1,0,1,0
11,252,252,9,9,0,1,0
15,257,257,10,10,0,1,0
24,259,259,13,13,0,1,0
9,277,277,28,28,0,1,0
29,298,298,54,54,0,1,0
34,301,301,17,9,8,3,2
36,306,306,4,4,0,1,0
4,317,317,29,29,0,1,0
25,322,322,1,1,0,1,0
3,327,327,3,3,0,1,0
32,332,332,83,2,81,4,3
1,345,345,8,8,0,1,0
6,363,363,14,14,0,1,0
16,376,376,9,9,0,1,0
27,381,381,99,51,48,4,3
31,392,392,30,12,18,3,2
13,396,396,32,32,0,1,0
12,434,434,170,78,92,3,2
8,448,448,47,47,0,1,0
21,460,460,64,8,56,3,2
10,464,464,13,13,0,1,0
17,467,467,16,16,0,1,0
19,485,485,137,46,91,4,3
20,491,491,13,13,0,1,0

22,103,103,2,2,0,1,0
17,127,127,10,1,9,2,1
21,135,135,17,11,6,2,1
24,161,161,77,62,15,2,1
9,184,184,9,9,0,1,0
7,195,195,72,16,56,3,2
19,209,209,3,3,0,1,0
20,222,222,8,8,0,1,0
16,222,222,15,5,10,3,2
13,225,225,33,33,0,1,0
0,231,231,32,26,6,3,2
8,259,259,18,6,12,4,3
15,296,296,13,1,12,2,1
12,315,315,17,17,0,1,0
2,326,326,64,25,39,2,1
11,356,356,32,1,31,2,1
3,365,365,18,7,11,2,1
1,366,366,125,65,60,4,3
18,388,388,64,4,60,3,2
5,392,392,173,125,48,4,3
6,413,413,18,9,9,4,3
25,432,432,22,10,12,3,2
26,440,440,115,96,19,3,2
4,442,442,2,2,0,1,0
10,461,461,8,3,5,2,1
14,480,480,12,12,0,1,0
23,486,486,32,5,27,4,3

25,102,102,6,3,3,2,1
22,106,106,4,4,0,1,0
0,157,157,24,24,0,1,0
19,166,166,1,1,0,1,0
21,166,166,8,8,0,1,0
29,188,188,29,29,0,1,0
4,188,188,4,4,0,1,0
26,197,197,2,2,0,1,0
23,211,211,26,26,0,1,0
14,213,213,1,1,0,1,0
3,219,219,7,7,0,1,0
2,225,225,4,4,0,1,0
5,233,233,2,2,0,1,0
31,245,245,37,3,34,3,2
13,256,256,6,1,5,2,1
15,260,260,7,7,0,1,0
17,260,260,94,22,72,4,3
10,301,301,52,47,5,2,1
24,301,301,4,1,3,2,1
32,307,307,99,72,27,2,1
20,307,307,15,15,0,1,0
6,310,310,47,3,44,2,1
9,320,320,29,29,0,1,0
27,324,324,58,58,0,1,0
16,327,327,6,6,0,1,0
30,333,333,2,2,0,1,0
1,340,340,48,32,16,2,1
36,354,354,81,81,0,1,0
35,373,373,29,20,9,4,3
28,408,408,67,67,0,1,0
11,409,409,28,28,0,1,0
7,420,420,72,3,69,4,3
33,420,420,8,8,0,1,0
18,430,430,31,31,0,1,0
12,473,473,14,8,6,3,2
37,474,474,55,55,0,1,0
34,490,490,20,2,18,4,3
8,498,498,40,24,16,3,2

8,103,103,1,1,0,1,0
36,108,108,2,2,0,1,0
1,110,110,6,1,5,2,1
31,128,128,9,9,0,1,0
34,132,132,12,12,0,1,0
13,139,139,14,14,0,1,0
11,140,140,6,6,0,1,0
18,182,182,21,21,0,1,0
24,188,188,34,4,30,2,1
17,189,189,2,2,0,1,0
29,196,196,65,65,0,1,0
7,210,210,37,15,22,3,2
14,235,235,31,11,20,4,3
22,235,235,9,9,0,1,0
23,245,245,24,20,4,2,1
25,256,256,2,2,0,1,0
16,274,274,1,1,0,1,0
26,286,286,9,9,0,1,0
27,287,287,5,2,3,2,1
20,326,326,8,5,3,2,1
2,351,351,8,8,0,1,0
28,353,353,76,76,0,1,0
10,356,356,13,1,12,2,1
19,366,366,29,3,26,2,1
32,378,378,16,7,9,2,1
35,382,382,14,14,0,1,0
30,393,393,133,115,18,3,2
5,401,401,32,32,0,1,0
0,411,411,8,8,0,1,0
6,416,416,51,51,0,1,0
3,431,431,89,89,0,1,0
4,433,433,3,3,0,1,0
12,451,451,68,68,0,1,0
33,457,457,47,47,0,1,0
37,461,461,36,36,0,1,0
15,463,463,122,80,42,3,2
21,469,469,16,7,9,4,3
9,496,496,21,8,13,2,1

1,110,110,6,6,0,1,0
36,132,132,47,26,21,4,3
8,145,145,12,3,9,2,1
29,174,174,8,8,0,1,0
28,178,178,2,2,0,1,0
23,185,185,19,19,0,1,0
37,192,192,27,7,20,3,2
9,212,212,7,7,0,1,0
30,231,231,11,11,0,1,0
34,239,239,38,38,0,1,0
4,244,244,37,16,21,2,1
6,246,246,3,3,0,1,0
15,249,249,19,19,0,1,0
27,249,249,2,2,0,1,0
20,252,252,10,2,8,3,2
2,257,257,4,4,0,1,0
11,258,258,32,32,0,1,0
7,280,280,8,8,0,1,0
21,284,284,7,7,0,1,0
3,285,285,51,51,0,1,0
31,292,292,87,56,31,2,1
33,294,294,2,2,0,1,0
24,329,329,13,5,8,2,1
19,355,355,16,6,10,2,1
13,366,366,27,1,26,3,2
16,392,392,41,9,32,3,2
5,411,411,55,55,0,1,0
18,413,413,22,22,0,1,0
32,433,433,18,18,0,1,0
26,438,438,5,5,0,1,0
0,445,445,76,24,52,3,2
22,454,454,134,134,0,1,0
14,455,455,8,8,0,1,0
10,458,458,54,54,0,1,0
12,463,463,73,73,0,1,0
25,465,465,39,14,25,2,1
17,477,477,14,14,0,1,0
35,485,485,30,2,28,3,2

9,102,102,9,5,4,2,1
39,113,113,14,14,0,1,0
3,116,116,5,5,0,1,0
23,123,123,3,3,0,1,0
32,153,153,76,56,20,2,1
30,168,168,37,37,0,1,0
21,169,169,6,6,0,1,0
29,170,170,20,20,0,1,0
11,177,177,12,12,0,1,0
10,183,183,13,13,0,1,0
26,192,192,2,2,0,1,0
24,208,208,3,3,0,1,0
12,210,210,9,2,7,2,1
6,221,221,21,21,0,1,0
35,225,225,4,4,0,1,0
36,255,255,2,2,0,1,0
25,265,265,17,17,0,1,0
15,268,268,8,3,5,2,1
16,271,271,12,12,0,1,0
18,277,277,4,4,0,1,0
19,300,300,28,28,0,1,0
27,323,323,9,9,0,1,0
20,336,336,4,4,0,1,0
4,347,347,7,1,6,3,2
38,347,347,10,3,7,2,1
22,349,349,60,60,0,1,0
31,372,372,2,2,0,1,0
7,374,374,8,2,6,3,2
17,375,375,32,15,17,2,1
37,392,392,45,45,0,1,0
5,397,397,17,7,10,2,1
40,401,401,49,49,0,1,0
1,407,407,5,5,0,1,0
13,438,438,16,11,5,2,1
34,446,446,4,4,0,1,0
0,448,448,125,92,33,4,3
33,451,451,28,13,15,2,1
8,456,456,65,54,11,2,1
2,465,465,2,2,0,1,0
14,494,494,112,112,0,1,0
28,495,495,144,56,88,3,2

29,105,105,3,3,0,1,0
33,120,120,1,1,0,1,0
0,123,123,5,5,0,1,0
32,154,154,6,6,0,1,0
2,158,158,4,1,3,2,1
5,159,159,10,10,0,1,0
9,168,168,2,2,0,1,0
25,172,172,3,3,0,1,0
22,173,173,21,4,17,2,1
28,180,180,6,2,4,2,1
3,181,181,30,30,0,1,0
11,217,217,17,17,0,1,0
17,260,260,5,5,0,1,0
14,285,285,21,15,6,3,2
20,303,303,45,3,42,4,3
4,318,318,6,6,0,1,0
13,327,327,49,3,46,3,2
27,328,328,2,2,0,1,0
26,337,337,137,105,32,2,1
35,339,339,4,1,3,2,1
18,352,352,58,36,22,2,1
30,358,358,31,7,24,4,3
15,366,366,29,13,16,2,1
12,371,371,26,26,0,1,0
31,383,383,25,22,3,2,1
10,389,389,76,76,0,1,0
8,405,405,62,62,0,1,0
34,415,415,125,110,15,4,3
23,418,418,1,1,0,1,0
21,428,428,58,48,10,2,1
24,434,434,80,57,23,2,1
6,441,441,9,6,3,2,1
7,460,460,4,4,0,1,0
19,464,464,69,53,16,2,1
16,467,467,62,12,50,3,2
1,496,496,114,88,26,2,1

17,120,120,21,21,0,1,0
3,120,120,1,1,0,1,0
23,141,141,24,24,0,1,0
2,161,161,25,11,14,2,1
9,181,181,29,11,18,2,1
13,183,183,4,4,0,1,0
31,211,211,50,50,0,1,0
16,217,217,7,7,0,1,0
6,222,222,46,46,0,1,0
18,233,233,33,33,0,1,0
24,240,240,27,27,0,1,0
27,241,241,24,24,0,1,0
20,242,242,6,6,0,1,0
12,267,267,20,6,14,2,1
0,268,268,12,12,0,1,0
30,300,300,44,17,27,3,2
28,352,352,23,23,0,1,0
25,355,355,18,8,10,2,1
7,362,362,34,29,5,2,1
8,387,387,4,4,0,1,0
4,404,404,60,55,5,2,1
14,406,406,80,36,44,3,2
21,410,410,2,2,0,1,0
10,413,413,60,60,0,1,0
29,419,419,16,12,4,2,1
26,422,422,4,4,0,1,0
19,428,428,18,13,5,2,1
11,428,428,121,121,0,1,0
22,446,446,36,36,0,1,0
1,448,448,14,14,0,1,0
15,454,454,133,119,14,2,1
5,472,472,56,29,27,2,1

35,100,100,9,1,8,3,2
33,115,115,18,13,5,2,1
4,120,120,10,10,0,1,0
23,174,174,1,1,0,1,0
20,179,179,12,12,0,1,0
5,180,180,2,2,0,1,0
25,194,194,8,8,0,1,0
22,195,195,13,10,3,2,1
15,210,210,4,4,0,1,0
0,218,218,16,16,0,1,0
21,235,235,18,8,10,3,2
18,244,244,9,9,0,1,0
3,251,251,44,44,0,1,0
1,270,270,2,2,0,1,0
7,272,272,65,65,0,1,0
34,275,275,88,85,3,2,1
24,289,289,9,9,0,1,0
28,299,299,39,29,10,3,2
16,304,304,28,28,0,1,0
32,315,315,4,1,3,2,1
2,330,330,1,1,0,1,0
14,334,334,39,35,4,2,1
13,336,336,29,29,0,1,0
10,340,340,14,14,0,1,0
6,346,346,15,15,0,1,0
12,358,358,70,7,63,4,3
19,369,369,29,29,0,1,0
31,370,370,34,34,0,1,0
27,375,375,77,5,72,4,3
8,415,415,9,3,6,3,2
36,422,422,41,41,0,1,0
29,463,463,32,32,0,1,0
26,464,464,104,6,98,3,2
11,465,465,36,6,30,4,3
17,484,484,137,117,20,2,1
9,491,491,8,8,0,1,0
30,492,492,28,28,0,1,0

26,105,105,6,6,0,1,0
8,128,128,7,7,0,1,0
23,147,147,6,6,0,1,0
20,175,175,5,5,0,1,0
7,180,180,2,2,0,1,0
32,182,182,6,6,0,1,0
28,187,187,7,7,0,1,0
4,233,233,15,15,0,1,0
31,259,259,71,24,47,3,2
11,274,274,9,5,4,2,1
21,282,282,1,1,0,1,0
3,287,287,3,3,0,1,0
30,316,316,47,9,38,3,2
18,324,324,20,5,15,4,3
5,334,334,30,30,0,1,0
14,344,344,133,133,0,1,0
10,365,365,16,16,0,1,0
16,375,375,3,3,0,1,0
1,380,380,93,93,0,1,0
2,404,404,33,33,0,1,0
17,423,423,126,41,85,4,3
19,428,428,21,11,10,2,1
9,428,428,71,32,39,2,1
24,430,430,54,10,44,4,3
15,432,432,43,20,23,3,2
22,446,446,129,117,12,2,1
0,456,456,27,15,12,2,1
25,464,464,8,8,0,1,0
13,470,470,46,46,0,1,0
12,476,476,12,6,6,2,1
27,479,479,108,108,0,1,0
29,484,484,16,4,12,4,3
6,500,500,117,19,98,3,2

1,108,108,19,19,0,1,0
15,127,127,26,26,0,1,0
28,141,141,1,1,0,1,0
17,189,189,25,25,0,1,0
22,207,207,20,20,0,1,0
18,221,221,22,11,11,2,1
14,221,221,86,42,44,3,2
30,235,235,64,47,17,2,1
5,236,236,17,17,0,1,0
21,236,236,27,27,0,1,0
9,252,252,63,27,36,3,2
0,253,253,9,9,0,1,0
13,271,271,20,9,11,2,1
8,272,272,27,1,26,3,2
26,275,275,8,2,6,2,1
23,300,300,34,34,0,1,0
19,302,302,5,5,0,1,0
4,307,307,54,4,50,4,3
2,310,310,8,8,0,1,0
25,326,326,15,10,5,2,1
3,336,336,43,35,8,3,2
12,344,344,100,50,50,2,1
10,355,355,3,3,0,1,0
16,382,382,31,10,21,2,1
20,387,387,8,8,0,1,0
29,403,403,7,2,5,2,1
24,411,411,26,8,18,2,1
7,435,435,26,26,0,1,0
27,439,439,14,7,7,2,1
11,451,451,55,55,0,1,0
6,451,451,83,83,0,1,0

30,103,103,1,1,0,1,0
1,136,136,16,16,0,1,0
20,151,151,13,4,9,2,1
6,156,156,11,3,8,2,1
31,162,162,15,15,0,1,0
27,166,166,3,3,0,1,0
3,170,170,22,6,16,4,3
32,170,170,11,2,9,4,3
19,182,182,28,4,24,2,1
16,214,214,17,17,0,1,0
13,226,226,47,11,36,2,1
29,235,235,7,7,0,1,0
5,251,251,48,48,0,1,0
25,258,258,16,8,8,3,2
33,268,268,37,30,7,2,1
12,278,278,1,1,0,1,0
18,295,295,22,15,7,3,2
14,342,342,60,60,0,1,0
11,353,353,16,16,0,1,0
15,374,374,87,47,40,3,2
8,382,382,8,8,0,1,0
10,395,395,40,24,16,3,2
0,399,399,10,3,7,2,1
2,410,410,53,4,49,2,1
28,422,422,63,57,6,2,1
23,423,423,159,159,0,1,0
7,425,425,40,11,29,2,1
26,466,466,67,67,0,1,0
9,472,472,27,27,0,1,0
4,474,474,9,9,0,1,0
17,476,476,15,15,0,1,0
21,480,480,1,1,0,1,0
24,482,482,137,119,18,4,3
22,484,484,9,3,6,2,1

24,109,109,3,3,0,1,0
14,118,118,12,12,0,1,0
16,148,148,25,1,24,3,2
7,151,151,14,9,5,2,1
9,169,169,32,32,0,1,0
18,191,191,7,7,0,1,0
8,195,195,1,1,0,1,0
6,225,225,12,6,6,3,2
17,226,226,2,2,0,1,0
28,231,231,46,46,0,1,0
10,238,238,27,27,0,1,0
2,262,262,27,27,0,1,0
0,312,312,33,15,18,3,2
19,322,322,32,32,0,1,0
1,325,325,27,27,0,1,0
5,392,392,7,4,3,2,1
21,398,398,44,44,0,1,0
22,410,410,29,13,16,4,3
13,412,412,25,13,12,3,2
4,417,417,178,58,120,4,3
11,418,418,26,10,16,2,1
29,419,419,82,82,0,1,0
12,430,430,21,21,0,1,0
3,440,440,176,92,84,4,3
23,443,443,2,2,0,1,0
26,463,463,25,25,0,1,0
15,474,474,68,20,48,3,2
20,490,490,2,2,0,1,0
25,497,497,55,15,40,3,2
27,498,498,165,54,111,4,3

0,112,112,1,1,0,1,0
20,122,122,1,1,0,1,0
33,126,126,14,14,0,1,0
36,132,132,22,13,9,4,3
11,143,143,7,7,0,1,0
26,144,144,11,3,8,3,2
4,145,145,16,16,0,1,0
17,149,149,3,3,0,1,0
14,157,157,25,25,0,1,0
21,178,178,18,18,0,1,0
1,180,180,24,2,22,3,2
34,186,186,11,11,0,1,0
5,199,199,12,2,10,3,2
3,208,208,26,26,0,1,0
10,240,240,60,6,54,3,2
2,256,256,60,60,0,1,0
15,265,265,8,8,0,1,0
13,268,268,5,2,3,2,1
6,270,270,37,37,0,1,0
28,276,276,2,2,0,1,0
16,281,281,8,8,0,1,0
29,302,302,25,9,16,3,2
7,303,303,25,25,0,1,0
30,321,321,3,3,0,1,0
18,326,326,2,2,0,1,0
9,329,329,38,2,36,3,2
25,332,332,31,31,0,1,0
32,388,388,16,2,14,3,2
35,395,395,55,47,8,3,2
8,408,408,35,23,12,2,1
19,417,417,11,11,0,1,0
23,435,435,45,28,17,2,1
22,436,436,165,165,0,1,0
31,436,436,14,5,9,2,1
27,449,449,101,47,54,3,2
12,449,449,9,9,0,1,0
24,469,469,46,46,0,1,0

0,103,103,17,17,0,1,0
32,115,115,2,2,0,1,0
19,128,128,3,3,0,1,0
26,131,131,1,1,0,1,0
34,140,140,2,2,0,1,0
11,147,147,10,10,0,1,0
22,153,153,9,3,6,2,1
2,157,157,48,48,0,1,0
3,168,168,11,5,6,3,2
20,168,168,4,4,0,1,0
9,183,183,23,20,3,2,1
29,194,194,5,1,4,2,1
10,196,196,14,14,0,1,0
35,197,197,42,42,0,1,0
12,218,218,21,21,0,1,0
24,234,234,6,6,0,1,0
1,254,254,8,8,0,1,0
31,263,263,34,2,32,3,2
17,273,273,11,11,0,1,0
8,282,282,20,4,16,3,2
16,284,284,18,18,0,1,0
28,308,308,5,5,0,1,0
37,351,351,19,19,0,1,0
13,363,363,23,23,0,1,0
36,365,365,60,29,31,2,1
23,367,367,40,40,0,1,0
21,401,401,127,104,23,2,1
33,432,432,39,20,19,4,3
5,444,444,45,7,38,2,1
7,450,450,11,11,0,1,0
30,460,460,96,96,0,1,0
27,466,466,7,7,0,1,0
4,468,468,91,91,0,1,0
15,472,472,11,11,0,1,0
6,476,476,10,10,0,1,0
18,477,477,54,54,0,1,0
25,479,479,132,132,0,1,0
14,481,481,5,5,0,1,0

37,145,145,10,10,0,1,0
29,148,148,10,10,0,1,0
16,155,155,4,1,3,2,1
25,162,162,36,10,26,2,1
17,166,166,30,30,0,1,0
19,201,201,15,6,9,4,3
36,214,214,11,3,8,3,2
8,230,230,11,2,9,4,3
10,231,231,25,25,0,1,0
2,258,258,1,1,0,1,0
12,260,260,9,1,8,2,1
35,264,264,16,1,15,4,3
31,291,291,22,22,0,1,0
24,297,297,17,8,9,2,1
5,299,299,11,6,5,2,1
21,311,311,33,33,0,1,0
18,323,323,6,6,0,1,0
0,325,325,1,1,0,1,0
20,339,339,118,43,75,4,3
30,344,344,22,19,3,2,1
11,346,346,25,25,0,1,0
1,347,347,15,15,0,1,0
9,363,363,35,35,0,1,0
22,366,366,92,92,0,1,0
3,370,370,16,16,0,1,0
33,371,371,45,45,0,1,0
34,372,372,15,3,12,3,2
26,378,378,41,41,0,1,0
32,378,378,87,31,56,3,2
27,385,385,22,22,0,1,0
7,392,392,11,11,0,1,0
23,414,414,24,24,0,1,0
15,414,414,66,66,0,1,0
14,439,439,9,2,7,2,1
28,446,446,41,8,33,4,3
4,447,447,35,35,0,1,0
13,460,460,39,11,28,2,1
6,464,464,89,47,42,4,3

10,101,101,1,1,0,1,0
22,112,112,17,17,0,1,0
21,128,128,8,8,0,1,0
29,143,143,45,2,43,4,3
23,146,146,6,6,0,1,0
4,152,152,8,3,5,2,1
0,161,161,26,20,6,2,1
5,174,174,12,1,11,3,2
12,191,191,39,6,33,2,1
18,203,203,48,48,0,1,0
8,244,244,12,12,0,1,0
14,265,265,65,22,43,2,1
13,276,276,24,16,8,3,2
9,295,295,1,1,0,1,0
20,317,317,1,1,0,1,0
11,319,319,43,43,0,1,0
24,323,323,39,39,0,1,0
28,340,340,4,4,0,1,0
16,341,341,36,36,0,1,0
25,347,347,15,15,0,1,0
27,347,347,51,51,0,1,0
32,360,360,44,44,0,1,0
1,380,380,100,48,52,3,2
31,395,395,78,44,34,2,1
17,402,402,3,3,0,1,0
3,406,406,2,2,0,1,0
2,409,409,19,14,5,2,1
6,424,424,124,124,0,1,0
26,424,424,25,25,0,1,0
19,432,432,16,16,0,1,0
30,454,454,32,32,0,1,0
15,460,460,18,4,14,2,1
7,494,494,19,19,0,1,0

33,108,108,27,27,0,1,0
20,115,115,1,1,0,1,0
34,127,127,1,1,0,1,0
13,127,127,9,9,0,1,0
17,130,130,14,14,0,1,0
15,133,133,8,8,0,1,0
18,139,139,10,10,0,1,0
0,175,175,28,16,12,4,3
29,206,206,19,7,12,4,3
21,220,220,11,11,0,1,0
22,235,235,2,2,0,1,0
2,267,267,1,1,0,1,0
12,277,277,26,26,0,1,0
31,334,334,80,26,54,4,3
9,341,341,7,4,3,2,1
16,342,342,3,3,0,1,0
6,342,342,23,8,15,2,1
30,354,354,125,100,25,2,1
4,354,354,54,54,0,1,0
3,358,358,6,6,0,1,0
8,362,362,46,12,34,3,2
32,397,397,134,134,0,1,0
28,398,398,16,8,8,3,2
25,399,399,26,19,7,2,1
11,406,406,86,47,39,4,3
19,408,408,13,13,0,1,0
5,409,409,38,38,0,1,0
35,427,427,36,12,24,2,1
27,429,429,2,2,0,1,0
7,435,435,14,14,0,1,0
24,437,437,16,16,0,1,0
1,444,444,153,130,23,4,3
23,448,448,20,6,14,2,1
14,468,468,29,29,0,1,0
26,472,472,40,40,0,1,0
10,476,476,1,1,0,1,0

21,101,101,3,3,0,1,0
3,101,101,6,6,0,1,0
26,105,105,17,3,14,3,2
25,109,109,2,2,0,1,0
28,161,161,15,6,9,4,3
38,168,168,3,3,0,1,0
18,174,174,8,8,0,1,0
33,179,179,16,5,11,2,1
10,190,190,24,24,0,1,0
30,198,198,30,18,12,4,3
24,221,221,11,11,0,1,0
36,223,223,35,2,33,4,3
7,241,241,14,6,8,3,2
11,243,243,37,23,14,3,2
29,255,255,8,8,0,1,0
32,259,259,1,1,0,1,0
17,263,263,9,9,0,1,0
19,267,267,10,10,0,1,0
13,278,278,14,14,0,1,0
1,288,288,20,20,0,1,0
2,290,290,4,1,3,2,1
9,294,294,1,1,0,1,0
37,302,302,129,63,66,4,3
4,311,311,2,2,0,1,0
14,318,318,25,25,0,1,0
12,344,344,46,15,31,4,3
31,358,358,7,3,4,2,1
22,360,360,13,9,4,2,1
15,370,370,33,5,28,3,2
0,370,370,28,28,0,1,0
6,378,378,84,21,63,4,3
23,383,383,14,14,0,1,0
16,395,395,48,48,0,1,0
20,408,408,62,20,42,2,1
34,413,413,163,111,52,3,2
5,447,447,41,26,15,4,3
35,459,459,23,5,18,3,2
27,460,460,4,4,0,1,0
8,460,460,25,25,0,1,0

30,124,124,42,42,0,1,0
27,126,126,1,1,0,1,0
25,129,129,8,8,0,1,0
18,133,133,40,40,0,1,0
29,135,135,16,10,6,2,1
0,141,141,1,1,0,1,0
33,143,143,32,13,19,2,1
7,147,147,13,9,4,2,1
11,148,148,16,2,14,3,2
12,150,150,9,9,0,1,0
10,165,165,32,12,20,2,1
28,167,167,22,4,18,4,3
4,178,178,22,10,12,4,3
32,188,188,3,3,0,1,0
5,189,189,85,41,44,3,2
20,200,200,25,25,0,1,0
26,203,203,11,11,0,1,0
19,223,223,8,2,6,3,2
31,235,235,2,2,0,1,0
9,257,257,71,59,12,2,1
23,261,261,30,30,0,1,0
17,275,275,8,8,0,1,0
14,277,277,3,3,0,1,0
22,279,279,12,6,6,2,1
3,295,295,14,4,10,3,2
6,321,321,27,27,0,1,0
15,337,337,3,3,0,1,0
2,357,357,5,5,0,1,0
8,422,422,1,1,0,1,0
16,432,432,10,10,0,1,0
13,448,448,16,16,0,1,0
1,451,451,76,57,19,3,2
24,466,466,37,3,34,3,2
21,497,497,27,27,0,1,0

8,114,114,12,7,5,2,1
6,142,142,36,36,0,1,0
19,151,151,4,1,3,2,1
14,167,167,35,35,0,1,0
4,168,168,3,3,0,1,0
29,174,174,13,2,11,2,1
16,180,180,15,10,5,2,1
9,181,181,2,2,0,1,0
11,182,182,15,15,0,1,0
17,238,238,27,27,0,1,0
1,241,241,8,1,7,2,1
15,264,264,7,1,6,3,2
25,273,273,10,10,0,1,0
30,276,276,6,6,0,1,0
27,278,278,36,5,31,2,1
13,285,285,21,7,14,3,2
18,290,290,10,7,3,2,1
21,303,303,11,11,0,1,0
23,314,314,70,63,7,2,1
5,321,321,7,2,5,2,1
7,328,328,47,47,0,1,0
26,346,346,40,40,0,1,0
33,357,357,95,41,54,4,3
0,359,359,93,48,45,4,3
3,429,429,18,18,0,1,0
2,432,432,48,5,43,3,2
22,448,448,19,19,0,1,0
28,449,449,53,31,22,2,1
24,463,463,126,87,39,4,3
31,465,465,15,15,0,1,0
32,473,473,72,1,71,3,2
20,474,474,17,17,0,1,0
10,477,477,76,76,0,1,0
12,481,481,34,34,0,1,0

15,106,106,2,2,0,1,0
18,134,134,11,11,0,1,0
5,184,184,26,26,0,1,0
32,197,197,59,47,12,3,2
7,203,203,14,9,5,2,1
13,214,214,3,3,0,1,0
26,228,228,6,2,4,2,1
8,233,233,34,34,0,1,0
31,236,236,3,3,0,1,0
29,252,252,9,3,6,3,2
0,288,288,58,29,29,4,3
24,291,291,61,9,52,4,3
17,299,299,81,27,54,4,3
25,323,323,18,7,11,2,1
14,333,333,11,11,0,1,0
20,343,343,12,12,0,1,0
16,346,346,10,10,0,1,0
11,370,370,43,23,20,2,1
19,381,381,24,24,0,1,0
28,386,386,15,2,13,2,1
2,401,401,40,40,0,1,0
21,402,402,65,65,0,1,0
22,403,403,1,1,0,1,0
12,421,421,25,19,6,3,2
9,425,425,6,6,0,1,0
30,433,433,41,19,22,2,1
1,434,434,117,106,11,2,1
23,447,447,69,57,12,3,2
3,447,447,65,9,56,3,2
27,448,448,73,40,33,4,3
10,471,471,132,113,19,4,3
4,474,474,43,25,18,4,3
6,482,482,1,1,0,1,0

11,106,106,22,22,0,1,0
13,110,110,18,18,0,1,0
15,122,122,3,3,0,1,0
36,129,129,2,2,0,1,0
20,135,135,9,1,8,2,1
5,137,137,18,18,0,1,0
17,139,139,1,1,0,1,0
32,140,140,11,11,0,1,0
31,157,157,6,6,0,1,0
0,168,168,19,3,16,3,2
18,172,172,2,2,0,1,0
12,177,177,14,14,0,1,0
35,182,182,11,11,0,1,0
9,233,233,93,24,69,4,3
3,246,246,7,7,0,1,0
33,256,256,85,85,0,1,0
8,280,280,20,11,9,4,3
34,292,292,6,6,0,1,0
7,303,303,6,1,5,2,1
1,310,310,3,3,0,1,0
28,344,344,67,7,60,4,3
22,348,348,24,19,5,2,1
23,352,352,33,33,0,1,0
19,366,366,17,17,0,1,0
25,366,366,67,32,35,2,1
4,368,368,14,14,0,1,0
6,370,370,4,4,0,1,0
26,371,371,7,7,0,1,0
27,386,386,32,23,9,4,3
30,415,415,34,34,0,1,0
24,424,424,26,26,0,1,0
29,427,427,146,146,0,1,0
21,434,434,1,1,0,1,0
14,441,441,14,14,0,1,0
16,462,462,83,6,77,4,3
10,463,463,10,6,4,2,1
2,486,486,52,6,46,3,2

8,101,101,3,3,0,1,0
22,103,103,4,4,0,1,0
37,107,107,4,1,3,2,1
33,108,108,1,1,0,1,0
13,116,116,1,1,0,1,0
27,166,166,30,30,0,1,0
23,168,168,12,5,7,2,1
31,171,171,48,11,37,2,1
3,172,172,21,17,4,2,1
2,176,176,17,17,0,1,0
10,197,197,6,6,0,1,0
32,198,198,32,23,9,4,3
7,210,210,46,15,31,2,1
26,213,213,20,13,7,2,1
15,217,217,12,6,6,3,2
25,259,259,69,17,52,3,2
19,263,263,1,1,0,1,0
11,278,278,17,17,0,1,0
29,282,282,27,27,0,1,0
1,308,308,14,14,0,1,0
24,309,309,24,13,11,2,1
9,317,317,6,3,3,2,1
12,320,320,60,16,44,3,2
28,324,324,35,31,4,2,1
21,336,336,5,5,0,1,0
20,346,346,25,4,21,2,1
34,350,350,5,1,4,2,1
30,356,356,9,9,0,1,0
4,374,374,20,17,3,2,1
38,382,382,50,50,0,1,0
36,383,383,25,10,15,4,3
35,412,412,34,16,18,3,2
14,422,422,131,131,0,1,0
0,425,425,10,10,0,1,0
6,426,426,16,16,0,1,0
16,446,446,23,23,0,1,0
18,451,451,2,2,0,1,0
17,475,475,72,5,67,3,2
5,496,496,51,19,32,2,1

10,106,106,11,6,5,2,1
4,111,111,19,1,18,2,1
17,119,119,21,9,12,2,1
5,121,121,2,2,0,1,0
2,134,134,13,13,0,1,0
8,146,146,11,4,7,3,2
21,160,160,16,6,10,3,2
6,164,164,5,5,0,1,0
7,194,194,19,19,0,1,0
27,203,203,3,3,0,1,0
14,207,207,17,4,13,2,1
16,208,208,9,1,8,2,1
1,219,219,28,28,0,1,0
28,250,250,13,3,10,3,2
22,264,264,26,26,0,1,0
25,266,266,14,14,0,1,0
33,328,328,1,1,0,1,0
9,344,344,1,1,0,1,0
12,381,381,178,61,117,4,3
29,388,388,97,3,94,3,2
18,393,393,30,15,15,2,1
34,397,397,77,13,64,3,2
20,405,405,17,3,14,3,2
13,412,412,27,27,0,1,0
26,441,441,37,37,0,1,0
15,447,447,11,6,5,2,1
0,451,451,5,5,0,1,0
30,454,454,65,65,0,1,0
32,460,460,109,27,82,3,2
23,468,468,94,31,63,4,3
3,472,472,2,2,0,1,0
31,481,481,1,1,0,1,0
11,486,486,52,4,48,3,2
24,489,489,4,4,0,1,0
19,499,499,82,82,0,1,0

12,107,107,32,26,6,2,1
4,115,115,4,4,0,1,0
25,129,129,4,4,0,1,0
9,133,133,1,1,0,1,0
10,145,145,2,2,0,1,0
27,155,155,29,14,15,2,1
20,157,157,19,19,0,1,0
17,166,166,10,10,0,1,0
13,170,170,23,23,0,1,0
8,171,171,107,95,12,2,1
30,177,177,7,7,0,1,0
2,192,192,16,2,14,2,1
6,286,286,8,8,0,1,0
23,303,303,4,4,0,1,0
31,307,307,47,47,0,1,0
24,323,323,2,2,0,1,0
0,350,350,4,4,0,1,0
22,354,354,86,29,57,4,3
16,372,372,99,57,42,4,3
3,380,380,26,6,20,4,3
1,413,413,39,10,29,2,1
18,431,431,9,6,3,2,1
19,461,461,85,31,54,3,2
14,471,471,8,8,0,1,0
7,472,472,76,10,66,4,3
11,473,473,17,1,16,3,2
28,473,473,35,9,26,2,1
26,480,480,51,21,30,3,2
15,480,480,40,10,30,3,2
21,488,488,9,3,6,3,2
5,495,495,42,42,0,1,0
29,500,500,63,13,50,4,3

22,103,103,6,2,4,2,1
3,122,122,3,3,0,1,0
17,123,123,16,10,6,3,2
15,134,134,14,7,7,2,1
33,136,136,16,1,15,3,2
12,188,188,36,36,0,1,0
19,202,202,29,21,8,2,1
4,224,224,11,11,0,1,0
10,236,236,12,3,9,2,1
11,238,238,58,58,0,1,0
18,253,253,6,6,0,1,0
24,258,258,53,14,39,2,1
28,258,258,24,24,0,1,0
2,286,286,6,6,0,1,0
23,308,308,29,29,0,1,0
7,318,318,5,5,0,1,0
29,326,326,28,28,0,1,0
1,352,352,21,2,19,3,2
0,354,354,2,2,0,1,0
26,361,361,40,14,26,3,2
16,363,363,80,32,48,4,3
6,381,381,6,6,0,1,0
21,391,391,60,35,25,4,3
8,404,404,110,98,12,4,3
20,413,413,1,1,0,1,0
27,416,416,56,24,32,4,3
13,423,423,6,6,0,1,0
9,426,426,57,57,0,1,0
32,428,428,6,6,0,1,0
30,430,430,39,39,0,1,0
31,440,440,5,5,0,1,0
34,472,472,89,50,39,3,2
5,485,485,13,13,0,1,0
25,486,486,102,40,62,4,3
14,490,490,63,30,33,4,3

14,104,104,6,6,0,1,0
8,105,105,1,1,0,1,0
12,108,108,3,3,0,1,0
26,122,122,5,5,0,1,0
16,137,137,11,1,10,4,3
11,143,143,30,2,28,2,1
0,146,146,7,1,6,3,2
22,165,165,10,10,0,1,0
18,174,174,3,3,0,1,0
4,179,179,84,84,0,1,0
7,225,225,6,1,5,2,1
10,237,237,5,5,0,1,0
15,244,244,96,58,38,2,1
17,252,252,3,3,0,1,0
3,269,269,64,28,36,4,3
19,291,291,2,2,0,1,0
6,306,306,105,6,99,4,3
5,352,352,50,19,31,2,1
13,352,352,9,9,0,1,0
23,369,369,101,101,0,1,0
21,377,377,43,43,0,1,0
20,393,393,9,9,0,1,0
1,399,399,23,23,0,1,0
25,416,416,20,12,8,3,2
2,420,420,120,81,39,2,1
9,469,469,29,4,25,2,1
27,478,478,30,30,0,1,0
24,499,499,145,115,30,4,3

34,111,111,34,3,31,2,1
14,121,121,3,3,0,1,0
20,125,125,1,1,0,1,0
38,130,130,16,16,0,1,0
2,132,132,10,2,8,3,2
29,136,136,7,7,0,1,0
30,177,177,1,1,0,1,0
27,177,177,41,25,16,2,1
19,188,188,6,6,0,1,0
6,199,199,23,23,0,1,0
0,199,199,31,31,0,1,0
32,199,199,9,1,8,2,1
1,235,235,24,24,0,1,0
17,246,246,3,3,0,1,0
13,248,248,1,1,0,1,0
21,261,261,8,8,0,1,0
15,282,282,2,2,0,1,0
8,292,292,11,2,9,4,3
26,301,301,22,8,14,2,1
22,304,304,3,3,0,1,0
4,319,319,40,34,6,2,1
7,342,342,37,16,21,3,2
35,359,359,26,26,0,1,0
5,366,366,6,6,0,1,0
16,369,369,29,5,24,4,3
10,373,373,103,103,0,1,0
37,381,381,14,14,0,1,0
25,383,383,99,59,40,2,1
33,402,402,15,11,4,2,1
9,413,413,98,70,28,2,1
3,416,416,7,7,0,1,0
28,416,416,107,74,33,2,1
11,426,426,47,47,0,1,0
36,450,450,35,13,22,3,2
18,457,457,9,3,6,3,2
12,466,466,45,4,41,2,1
31,467,467,14,14,0,1,0
24,490,490,38,26,12,3,2
23,490,490,10,10,0,1,0
39,493,493,14,14,0,1,0

31,100,100,5,1,4,2,1
34,100,100,9,1,8,2,1
23,102,102,7,7,0,1,0
37,124,124,5,2,3,2,1
26,124,124,65,65,0,1,0
30,133,133,5,5,0,1,0
3,153,153,16,16,0,1,0
2,158,158,17,5,12,4,3
38,173,173,12,12,0,1,0
6,177,177,8,8,0,1,0
32,208,208,26,8,18,4,3
10,219,219,7,7,0,1,0
21,221,221,29,29,0,1,0
1,257,257,20,15,5,2,1
20,262,262,13,13,0,1,0
0,272,272,20,20,0,1,0
13,301,301,1,1,0,1,0
4,302,302,1,1,0,1,0
18,321,321,20,5,15,4,3
12,323,323,48,36,12,2,1
5,335,335,54,6,48,2,1
8,344,344,44,29,15,2,1
22,348,348,29,12,17,2,1
11,353,353,8,8,0,1,0
27,374,374,24,24,0,1,0
19,377,377,32,32,0,1,0
7,380,380,74,74,0,1,0
15,387,387,1,1,0,1,0
36,389,389,18,5,13,2,1
29,396,396,4,4,0,1,0
35,423,423,5,5,0,1,0
14,430,430,1,1,0,1,0
17,444,444,19,19,0,1,0
9,460,460,60,9,51,4,3
33,471,471,25,25,0,1,0
16,481,481,44,44,0,1,0
24,494,494,21,21,0,1,0
28,499,499,13,13,0,1,0
25,500,500,196,196,0,1,0

28,106,106,9,9,0,1,0
23,126,126,41,35,6,3,2
35,134,134,7,4,3,2,1
5,152,152,15,15,0,1,0
33,158,158,1,1,0,1,0
21,168,168,9,9,0,1,0
17,177,177,5,2,3,2,1
27,194,194,12,12,0,1,0
30,196,196,7,1,6,3,2
3,226,226,1,1,0,1,0
4,231,231,25,25,0,1,0
24,232,232,1,1,0,1,0
1,246,246,31,11,20,3,2
11,247,247,1,1,0,1,0
16,282,282,15,15,0,1,0
15,301,301,7,7,0,1,0
34,314,314,39,12,27,2,1
9,317,317,19,19,0,1,0
7,319,319,6,6,0,1,0
19,335,335,26,26,0,1,0
36,342,342,14,4,10,2,1
12,374,374,35,35,0,1,0
10,374,374,1,1,0,1,0
22,379,379,77,11,66,3,2
18,381,381,53,3,50,2,1
29,385,385,13,3,10,2,1
37,399,399,3,3,0,1,0
8,400,400,44,40,4,2,1
14,410,410,146,35,111,4,3
6,435,435,28,28,0,1,0
2,442,442,1,1,0,1,0
32,453,453,47,12,35,2,1
0,461,461,30,10,20,3,2
31,472,472,173,146,27,4,3
25,475,475,90,63,27,2,1
26,491,491,21,14,7,2,1
20,493,493,58,29,29,2,1
13,494,494,73,34,39,3,2

8,111,111,1,1,0,1,0
34,141,141,10,7,3,2,1
28,155,155,7,7,0,1,0
3,167,167,4,4,0,1,0
22,184,184,13,13,0,1,0
23,185,185,3,3,0,1,0
21,188,188,4,4,0,1,0
19,209,209,9,9,0,1,0
27,211,211,3,3,0,1,0
16,216,216,41,34,7,2,1
32,221,221,80,57,23,2,1
4,225,225,54,10,44,2,1
2,226,226,1,1,0,1,0
12,235,235,20,20,0,1,0
33,266,266,14,9,5,2,1
17,267,267,6,6,0,1,0
20,276,276,76,29,47,2,1
25,315,315,7,4,3,2,1
15,321,321,43,1,42,2,1
11,326,326,53,42,11,2,1
13,352,352,24,24,0,1,0
7,353,353,15,4,11,2,1
35,355,355,18,1,17,4,3
29,368,368,10,10,0,1,0
26,370,370,14,14,0,1,0
24,371,371,36,36,0,1,0
36,374,374,2,2,0,1,0
1,375,375,19,16,3,2,1
6,390,390,1,1,0,1,0
37,394,394,44,35,9,4,3
30,397,397,76,28,48,3,2
10,406,406,14,5,9,4,3
38,424,424,72,27,45,2,1
5,427,427,37,8,29,3,2
18,441,441,2,2,0,1,0
31,455,455,175,31,144,4,3
9,461,461,1,1,0,1,0
14,468,468,36,18,18,4,3
0,482,482,59,9,50,4,3

7,112,112,22,10,12,4,3
15,119,119,19,10,9,4,3
19,127,127,16,16,0,1,0
10,135,135,6,6,0,1,0
16,172,172,6,6,0,1,0
20,175,175,6,6,0,1,0
11,230,230,29,29,0,1,0
23,233,233,18,15,3,2,1
3,234,234,52,8,44,2,1
28,287,287,146,5,141,4,3
27,292,292,31,3,28,3,2
5,305,305,35,26,9,4,3
18,316,316,1,1,0,1,0
1,320,320,19,6,13,2,1
8,333,333,27,15,12,4,3
14,358,358,20,20,0,1,0
13,374,374,5,5,0,1,0
26,375,375,6,1,5,2,1
9,408,408,5,5,0,1,0
22,411,411,2,2,0,1,0
25,420,420,21,18,3,2,1
24,424,424,27,12,15,2,1
17,443,443,4,4,0,1,0
6,450,450,59,59,0,1,0
12,451,451,186,174,12,4,3
2,469,469,37,21,16,2,1
0,480,480,127,31,96,4,3
21,485,485,27,27,0,1,0
4,487,487,181,160,21,2,1

43,104,104,6,3,3,2,1
20,117,117,5,5,0,1,0
30,124,124,13,13,0,1,0
36,150,150,15,15,0,1,0
34,155,155,8,8,0,1,0
1,168,168,3,3,0,1,0
12,174,174,1,1,0,1,0
31,207,207,17,4,13,2,1
10,227,227,7,1,6,3,2
16,235,235,7,7,0,1,0
26,244,244,38,38,0,1,0
44,259,259,47,47,0,1,0
39,260,260,10,10,0,1,0
33,268,268,26,26,0,1,0
41,274,274,2,2,0,1,0
19,275,275,16,12,4,2,1
0,283,283,12,12,0,1,0
35,307,307,21,16,5,2,1
22,307,307,83,83,0,1,0
6,314,314,1,1,0,1,0
42,320,320,29,29,0,1,0
11,326,326,6,6,0,1,0
18,329,329,2,2,0,1,0
17,336,336,8,8,0,1,0
4,340,340,11,7,4,2,1
3,342,342,37,9,28,3,2
15,358,358,20,20,0,1,0
25,363,363,13,6,7,2,1
7,373,373,16,7,9,4,3
23,377,377,9,9,0,1,0
45,395,395,42,42,0,1,0
28,396,396,61,14,47,3,2
9,403,403,32,17,15,4,3
2,426,426,65,65,0,1,0
27,427,427,19,12,7,2,1
8,433,433,6,3,3,2,1
14,434,434,8,8,0,1,0
21,436,436,25,25,0,1,0
37,443,443,26,26,0,1,0
5,448,448,40,40,0,1,0
40,452,452,55,1,54,4,3
13,462,462,8,8,0,1,0
24,467,467,33,33,0,1,0
38,467,467,120,15,105,4,3
32,493,493,82,82,0,1,0
29,494,494,74,46,28,2,1

11,112,112,7,1,6,2,1
29,114,114,8,3,5,2,1
1,144,144,7,1,6,2,1
15,170,170,43,7,36,2,1
27,172,172,39,29,10,2,1
22,181,181,21,9,12,2,1
25,190,190,3,3,0,1,0
4,197,197,1,1,0,1,0
24,203,203,21,21,0,1,0
12,206,206,18,9,9,2,1
2,241,241,20,8,12,4,3
10,242,242,82,20,62,3,2
6,252,252,10,10,0,1,0
14,252,252,7,7,0,1,0
16,256,256,45,18,27,4,3
19,262,262,15,15,0,1,0
8,274,274,55,5,50,2,1
9,287,287,53,29,24,3,2
23,294,294,2,2,0,1,0
31,330,330,1,1,0,1,0
21,343,343,7,7,0,1,0
20,353,353,72,72,0,1,0
26,361,361,4,4,0,1,0
30,377,377,8,8,0,1,0
13,379,379,47,29,18,2,1
28,385,385,117,53,64,3,2
3,394,394,5,5,0,1,0
0,402,402,49,28,21,4,3
17,435,435,3,3,0,1,0
18,465,465,61,61,0,1,0
5,466,466,140,140,0,1,0
7,494,494,32,32,0,1,0

30,114,114,3,3,0,1,0
35,122,122,12,7,5,2,1
27,122,122,1,1,0,1,0
16,153,153,1,1,0,1,0
31,154,154,12,1,11,2,1
19,160,160,4,1,3,2,1
9,171,171,18,18,0,1,0
14,182,182,46,4,42,4,3
4,211,211,6,6,0,1,0
8,214,214,2,2,0,1,0
5,226,226,32,32,0,1,0
24,231,231,111,21,90,4,3
0,235,235,31,31,0,1,0
32,239,239,2,2,0,1,0
11,241,241,10,10,0,1,0
23,249,249,7,7,0,1,0
25,255,255,37,37,0,1,0
17,261,261,20,5,15,4,3
22,266,266,47,10,37,4,3
21,278,278,105,105,0,1,0
26,286,286,6,6,0,1,0
20,294,294,2,2,0,1,0
13,299,299,64,22,42,4,3
7,302,302,13,13,0,1,0
10,322,322,73,52,21,4,3
6,358,358,1,1,0,1,0
18,378,378,15,1,14,4,3
28,385,385,8,8,0,1,0
12,395,395,104,104,0,1,0
33,405,405,59,59,0,1,0
1,442,442,6,6,0,1,0
3,447,447,30,30,0,1,0
34,448,448,1,1,0,1,0
2,454,454,8,8,0,1,0
29,484,484,51,31,20,2,1
15,494,494,10,5,5,2,1

9,110,110,1,1,0,1,0
10,116,116,1,1,0,1,0
4,133,133,15,3,12,2,1
20,137,137,1,1,0,1,0
16,137,137,6,6,0,1,0
22,147,147,9,9,0,1,0
25,152,152,15,15,0,1,0
3,153,153,3,3,0,1,0
17,205,205,24,6,18,4,3
24,230,230,36,12,24,2,1
13,251,251,36,4,32,3,2
11,264,264,4,4,0,1,0
2,294,294,38,38,0,1,0
21,299,299,127,34,93,4,3
5,327,327,7,7,0,1,0
8,328,328,171,153,18,3,2
19,333,333,47,29,18,4,3
26,343,343,12,5,7,2,1
12,345,345,6,1,5,2,1
28,370,370,67,31,36,4,3
15,375,375,10,4,6,2,1
27,376,376,36,36,0,1,0
6,387,387,22,10,12,2,1
18,398,398,47,47,0,1,0
23,438,438,15,4,11,2,1
0,442,442,26,16,10,3,2
14,444,444,12,1,11,4,3
7,452,452,31,31,0,1,0
1,490,490,334,275,59,3,2

23,132,132,10,10,0,1,0
34,135,135,26,26,0,1,0
32,150,150,21,15,6,3,2
18,165,165,3,3,0,1,0
14,167,167,50,37,13,2,1
3,177,177,11,11,0,1,0
20,197,197,10,10,0,1,0
28,205,205,2,2,0,1,0
10,207,207,5,5,0,1,0
30,237,237,57,20,37,2,1
19,250,250,33,3,30,4,3
26,253,253,39,24,15,2,1
0,255,255,7,2,5,2,1
25,260,260,50,2,48,3,2
33,262,262,20,15,5,2,1
22,269,269,5,5,0,1,0
15,277,277,8,2,6,3,2
21,279,279,18,18,0,1,0
31,284,284,52,30,22,2,1
2,286,286,19,19,0,1,0
13,302,302,21,9,12,3,2
24,305,305,21,21,0,1,0
6,305,305,55,22,33,4,3
4,311,311,6,6,0,1,0
9,318,318,3,3,0,1,0
7,360,360,40,40,0,1,0
27,365,365,43,30,13,2,1
29,369,369,4,4,0,1,0
11,371,371,11,4,7,2,1
5,382,382,198,163,35,4,3
1,390,390,34,34,0,1,0
8,436,436,7,4,3,2,1
16,440,440,19,2,17,4,3
17,488,488,10,1,9,2,1
12,492,492,43,5,38,2,1

20,112,112,6,6,0,1,0
34,115,115,15,15,0,1,0
16,125,125,10,2,8,3,2
43,129,129,4,4,0,1,0
17,131,131,22,22,0,1,0
40,154,154,10,10,0,1,0
13,173,173,12,12,0,1,0
9,178,178,12,5,7,2,1
30,195,195,4,4,0,1,0
1,196,196,3,3,0,1,0
25,198,198,5,5,0,1,0
8,214,214,1,1,0,1,0
42,215,215,24,24,0,1,0
6,220,220,14,14,0,1,0
23,224,224,12,12,0,1,0
31,230,230,23,2,21,4,3
27,237,237,14,10,4,2,1
38,243,243,55,55,0,1,0
39,261,261,5,5,0,1,0
10,262,262,2,2,0,1,0
0,273,273,57,57,0,1,0
41,279,279,114,38,76,4,3
5,284,284,1,1,0,1,0
2,289,289,24,4,20,2,1
4,307,307,35,2,33,2,1
19,335,335,65,65,0,1,0
24,337,337,4,4,0,1,0
15,359,359,11,11,0,1,0
12,365,365,5,5,0,1,0
33,373,373,27,27,0,1,0
7,377,377,7,1,6,2,1
14,384,384,1,1,0,1,0
3,386,386,9,9,0,1,0
32,390,390,81,81,0,1,0
28,396,396,30,30,0,1,0
22,398,398,1,1,0,1,0
11,399,399,60,41,19,2,1
21,403,403,68,68,0,1,0
26,408,408,4,1,3,2,1
18,426,426,24,14,10,3,2
37,450,450,5,1,4,2,1
29,471,471,77,23,54,3,2
35,474,474,10,10,0,1,0
36,485,485,9,1,8,3,2

23,116,116,8,1,7,2,1
26,120,120,4,1,3,2,1
29,125,125,20,20,0,1,0
32,140,140,5,5,0,1,0
1,141,141,11,11,0,1,0
2,152,152,16,16,0,1,0
4,152,152,1,1,0,1,0
12,172,172,23,6,17,2,1
5,180,180,18,18,0,1,0
3,187,187,7,7,0,1,0
21,189,189,81,81,0,1,0
14,197,197,1,1,0,1,0
16,205,205,19,19,0,1,0
6,212,212,11,11,0,1,0
15,213,213,15,15,0,1,0
8,222,222,33,33,0,1,0
18,223,223,12,12,0,1,0
20,239,239,7,7,0,1,0
9,240,240,13,13,0,1,0
11,250,250,13,2,11,3,2
24,287,287,35,21,14,3,2
27,291,291,15,3,12,3,2
10,296,296,1,1,0,1,0
30,304,304,7,2,5,2,1
13,309,309,8,8,0,1,0
31,330,330,12,12,0,1,0
36,340,340,70,60,10,2,1
25,377,377,42,42,0,1,0
33,390,390,41,41,0,1,0
34,395,395,2,2,0,1,0
22,403,403,38,4,34,3,2
17,437,437,39,39,0,1,0
35,439,439,48,33,15,4,3
19,476,476,131,69,62,3,2
28,484,484,56,17,39,4,3
7,486,486,107,86,21,2,1
0,496,496,48,6,42,4,3

29,108,108,14,14,0,1,0
13,124,124,21,21,0,1,0
19,126,126,20,4,16,2,1
22,144,144,6,6,0,1,0
15,156,156,12,12,0,1,0
11,166,166,30,8,22,3,2
28,189,189,15,15,0,1,0
6,195,195,1,1,0,1,0
31,198,198,2,2,0,1,0
16,222,222,4,4,0,1,0
5,235,235,5,5,0,1,0
12,240,240,13,5,8,3,2
3,272,272,15,6,9,2,1
18,277,277,154,28,126,4,3
21,295,295,33,7,26,3,2
9,295,295,38,1,37,2,1
7,299,299,7,7,0,1,0
4,321,321,32,16,16,2,1
23,327,327,29,8,21,4,3
30,378,378,4,4,0,1,0
10,391,391,60,39,21,4,3
26,393,393,1,1,0,1,0
14,412,412,11,4,7,2,1
2,415,415,106,65,41,4,3
8,418,418,87,87,0,1,0
1,444,444,85,61,24,2,1
24,450,450,55,50,5,2,1
20,456,456,13,9,4,2,1
25,463,463,46,46,0,1,0
17,465,465,11,2,9,2,1
0,469,469,25,25,0,1,0
32,471,471,49,13,36,4,3
27,490,490,69,69,0,1,0

1,140,140,9,9,0,1,0
33,145,145,23,23,0,1,0
31,148,148,1,1,0,1,0
7,148,148,9,3,6,2,1
37,176,176,11,11,0,1,0
12,177,177,5,5,0,1,0
21,179,179,28,28,0,1,0
14,179,179,1,1,0,1,0
5,190,190,11,11,0,1,0
6,204,204,24,24,0,1,0
36,205,205,20,20,0,1,0
8,207,207,20,20,0,1,0
27,212,212,21,12,9,4,3
2,215,215,20,20,0,1,0
4,218,218,1,1,0,1,0
20,257,257,20,10,10,2,1
23,267,267,11,11,0,1,0
9,306,306,1,1,0,1,0
3,308,308,1,1,0,1,0
24,314,314,35,35,0,1,0
17,315,315,49,33,16,2,1
35,322,322,22,8,14,2,1
38,328,328,6,6,0,1,0
0,334,334,27,27,0,1,0
16,339,339,31,27,4,2,1
30,343,343,62,62,0,1,0
10,343,343,41,11,30,3,2
11,349,349,56,4,52,3,2
26,354,354,3,3,0,1,0
32,367,367,53,25,28,2,1
22,377,377,2,2,0,1,0
34,415,415,34,34,0,1,0
19,418,418,31,6,25,2,1
28,423,423,143,143,0,1,0
18,428,428,57,57,0,1,0
25,454,454,81,81,0,1,0
13,461,461,38,38,0,1,0
15,470,470,18,5,13,3,2
29,476,476,59,12,47,4,3

7,102,102,8,2,6,2,1
19,109,109,10,10,0,1,0
12,115,115,9,1,8,2,1
2,126,126,1,1,0,1,0
18,128,128,1,1,0,1,0
5,143,143,2,2,0,1,0
1,173,173,12,6,6,3,2
32,174,174,26,26,0,1,0
0,176,176,9,9,0,1,0
36,176,176,1,1,0,1,0
35,180,180,19,13,6,3,2
37,183,183,3,3,0,1,0
23,190,190,70,70,0,1,0
22,198,198,8,4,4,2,1
15,199,199,23,6,17,2,1
16,199,199,1,1,0,1,0
27,207,207,4,4,0,1,0
17,213,213,3,3,0,1,0
4,216,216,7,3,4,2,1
20,219,219,6,6,0,1,0
43,234,234,86,37,49,2,1
11,234,234,7,7,0,1,0
38,236,236,89,25,64,4,3
31,255,255,2,2,0,1,0
26,255,255,41,41,0,1,0
34,280,280,9,5,4,2,1
3,294,294,7,1,6,2,1
40,327,327,54,4,50,4,3
9,329,329,13,13,0,1,0
29,333,333,10,10,0,1,0
21,342,342,10,5,5,2,1
30,348,348,57,46,11,2,1
6,374,374,8,8,0,1,0
8,376,376,53,25,28,3,2
10,382,382,7,7,0,1,0
28,392,392,32,32,0,1,0
25,432,432,35,35,0,1,0
14,445,445,14,14,0,1,0
39,447,447,45,19,26,3,2
13,448,448,31,25,6,2,1
41,458,458,43,43,0,1,0
42,473,473,7,7,0,1,0
24,491,491,27,13,14,2,1
33,498,498,2,2,0,1,0

1,102,102,29,29,0,1,0
19,136,136,1,1,0,1,0
36,142,142,12,12,0,1,0
30,146,146,17,17,0,1,0
17,147,147,6,6,0,1,0
32,151,151,5,5,0,1,0
22,157,157,14,14,0,1,0
24,204,204,34,34,0,1,0
31,211,211,23,23,0,1,0
29,223,223,15,15,0,1,0
35,229,229,68,68,0,1,0
10,243,243,1,1,0,1,0
14,268,268,28,13,15,4,3
26,270,270,49,1,48,3,2
5,280,280,9,9,0,1,0
18,284,284,18,18,0,1,0
2,288,288,45,45,0,1,0
33,302,302,17,11,6,3,2
15,327,327,2,2,0,1,0
21,337,337,49,49,0,1,0
20,339,339,2,2,0,1,0
8,349,349,62,62,0,1,0
25,350,350,16,6,10,3,2
4,364,364,64,57,7,2,1
6,367,367,20,20,0,1,0
23,380,380,1,1,0,1,0
27,393,393,39,39,0,1,0
16,401,401,4,4,0,1,0
13,402,402,42,2,40,3,2
3,417,417,21,1,20,2,1
9,448,448,65,65,0,1,0
34,465,465,8,8,0,1,0
12,469,469,34,9,25,2,1
7,476,476,84,40,44,2,1
11,479,479,17,17,0,1,0
28,493,493,103,16,87,4,3
0,493,493,2,2,0,1,0

20,101,101,2,2,0,1,0
11,111,111,17,5,12,3,2
4,129,129,21,21,0,1,0
6,171,171,3,3,0,1,0
8,174,174,5,5,0,1,0
1,199,199,6,6,0,1,0
29,202,202,18,18,0,1,0
9,221,221,5,2,3,2,1
12,229,229,38,17,21,4,3
30,229,229,6,6,0,1,0
3,234,234,2,2,0,1,0
24,256,256,75,75,0,1,0
31,257,257,28,19,9,4,3
19,289,289,4,4,0,1,0
22,289,289,15,15,0,1,0
23,329,329,56,22,34,2,1
25,346,346,11,3,8,3,2
27,348,348,44,44,0,1,0
32,354,354,48,48,0,1,0
13,389,389,114,114,0,1,0
7,397,397,1,1,0,1,0
17,401,401,123,123,0,1,0
2,433,433,133,133,0,1,0
28,434,434,90,48,42,4,3
33,437,437,9,1,8,3,2
16,439,439,41,33,8,2,1
21,446,446,1,1,0,1,0
10,461,461,59,59,0,1,0
18,465,465,36,36,0,1,0
15,466,466,22,1,21,2,1
14,466,466,40,17,23,4,3
26,476,476,27,27,0,1,0
5,486,486,39,39,0,1,0
0,487,487,36,36,0,1,0

5,120,120,12,12,0,1,0
14,129,129,16,16,0,1,0
11,135,135,1,1,0,1,0
17,157,157,38,5,33,4,3
13,167,167,5,1,4,2,1
18,172,172,3,3,0,1,0
9,178,178,2,2,0,1,0
21,203,203,29,29,0,1,0
6,207,207,18,18,0,1,0
1,211,211,10,10,0,1,0
24,232,232,30,4,26,2,1
22,237,237,7,7,0,1,0
7,276,276,38,38,0,1,0
27,283,283,34,34,0,1,0
0,285,285,17,3,14,2,1
35,304,304,26,16,10,2,1
34,317,317,47,7,40,3,2
30,321,321,34,34,0,1,0
12,337,337,62,21,41,2,1
15,344,344,104,104,0,1,0
4,366,366,80,46,34,2,1
19,391,391,25,5,20,2,1
23,399,399,20,20,0,1,0
10,404,404,1,1,0,1,0
26,415,415,15,15,0,1,0
20,427,427,5,5,0,1,0
28,434,434,64,46,18,3,2
2,439,439,9,1,8,3,2
29,445,445,6,1,5,2,1
33,448,448,60,27,33,2,1
16,449,449,43,43,0,1,0
31,453,453,105,17,88,3,2
3,463,463,5,5,0,1,0
32,478,478,20,20,0,1,0
25,487,487,113,113,0,1,0
8,494,494,1,1,0,1,0

1,109,109,1,1,0,1,0
8,110,110,11,1,10,2,1
33,147,147,32,32,0,1,0
26,164,164,3,3,0,1,0
19,168,168,4,4,0,1,0
11,170,170,4,4,0,1,0
32,183,183,19,19,0,1,0
7,205,205,46,28,18,4,3
23,219,219,9,9,0,1,0
27,222,222,43,18,25,2,1
28,229,229,14,5,9,4,3
31,230,230,52,48,4,2,1
25,233,233,71,53,18,3,2
16,256,256,39,3,36,3,2
3,261,261,9,9,0,1,0
18,265,265,4,4,0,1,0
14,299,299,5,5,0,1,0
20,315,315,41,4,37,2,1
9,316,316,9,9,0,1,0
22,335,335,5,2,3,2,1
0,348,348,97,17,80,3,2
2,372,372,7,7,0,1,0
4,373,373,1,1,0,1,0
29,384,384,20,2,18,2,1
10,398,398,6,6,0,1,0
17,399,399,23,3,20,3,2
21,400,400,4,4,0,1,0
24,405,405,18,3,15,4,3
15,413,413,75,38,37,2,1
13,414,414,57,48,9,3,2
5,440,440,49,27,22,2,1
12,443,443,61,52,9,2,1
6,487,487,111,31,80,3,2
30,489,489,109,109,0,1,0

20,100,100,4,4,0,1,0
14,112,112,7,7,0,1,0
34,137,137,7,7,0,1,0
12,146,146,35,16,19,3,2
16,162,162,45,45,0,1,0
22,174,174,13,13,0,1,0
17,211,211,39,11,28,3,2
8,215,215,16,16,0,1,0
9,224,224,6,6,0,1,0
35,229,229,25,7,18,3,2
4,237,237,5,5,0,1,0
27,237,237,9,1,8,2,1
18,240,240,8,3,5,2,1
1,250,250,40,40,0,1,0
28,256,256,112,112,0,1,0
36,259,259,35,26,9,2,1
13,281,281,8,8,0,1,0
0,286,286,4,1,3,2,1
29,304,304,51,51,0,1,0
31,308,308,1,1,0,1,0
6,308,308,5,5,0,1,0
26,321,321,51,51,0,1,0
33,321,321,1,1,0,1,0
2,326,326,1,1,0,1,0
25,357,357,63,63,0,1,0
15,365,365,21,21,0,1,0
19,368,368,57,57,0,1,0
21,398,398,21,21,0,1,0
5,408,408,4,4,0,1,0
24,428,428,50,50,0,1,0
11,429,429,46,31,15,2,1
32,430,430,34,18,16,3,2
23,431,431,37,37,0,1,0
10,433,433,35,35,0,1,0
7,451,451,43,43,0,1,0
3,476,476,26,26,0,1,0
30,492,492,2,2,0,1,0

11,140,140,3,3,0,1,0
27,150,150,14,10,4,2,1
4,152,152,25,16,9,4,3
18,172,172,2,2,0,1,0
13,175,175,2,2,0,1,0
20,185,185,56,33,23,3,2
1,190,190,3,3,0,1,0
29,196,196,38,38,0,1,0
17,202,202,12,12,0,1,0
10,205,205,6,6,0,1,0
7,231,231,71,20,51,4,3
23,264,264,16,16,0,1,0
22,285,285,34,17,17,2,1
19,290,290,12,9,3,2,1
16,302,302,54,54,0,1,0
14,305,305,25,25,0,1,0
8,308,308,4,4,0,1,0
6,316,316,61,11,50,2,1
24,317,317,11,11,0,1,0
26,327,327,98,33,65,4,3
12,334,334,66,66,0,1,0
15,338,338,22,13,9,4,3
0,338,338,10,7,3,2,1
28,377,377,37,3,34,4,3
2,384,384,40,26,14,2,1
5,397,397,201,144,57,4,3
25,398,398,26,12,14,4,3
9,438,438,51,14,37,4,3
21,447,447,8,4,4,2,1
3,491,491,2,2,0,1,0

12,118,118,6,6,0,1,0
36,120,120,1,1,0,1,0
26,121,121,18,4,14,3,2
44,122,122,2,2,0,1,0
24,141,141,1,1,0,1,0
6,148,148,20,4,16,3,2
30,149,149,5,5,0,1,0
32,154,154,10,10,0,1,0
45,156,156,6,6,0,1,0
43,179,179,4,4,0,1,0
3,194,194,19,10,9,4,3
9,195,195,16,7,9,4,3
2,206,206,8,5,3,2,1
14,216,216,3,3,0,1,0
8,229,229,10,10,0,1,0
25,229,229,27,7,20,2,1
4,237,237,1,1,0,1,0
22,248,248,10,2,8,2,1
18,259,259,11,11,0,1,0
31,262,262,6,6,0,1,0
39,264,264,12,12,0,1,0
28,285,285,7,7,0,1,0
34,295,295,28,28,0,1,0
7,301,301,32,20,12,2,1
11,302,302,1,1,0,1,0
35,312,312,66,39,27,2,1
13,321,321,40,7,33,2,1
16,346,346,11,1,10,3,2
42,349,349,87,72,15,4,3
41,353,353,15,15,0,1,0
21,356,356,9,3,6,2,1
19,362,362,11,1,10,2,1
17,380,380,21,3,18,3,2
37,387,387,66,33,33,2,1
40,394,394,156,156,0,1,0
10,394,394,3,3,0,1,0
15,396,396,40,40,0,1,0
1,400,400,14,14,0,1,0
0,426,426,36,36,0,1,0
33,428,428,37,37,0,1,0
27,437,437,25,25,0,1,0
20,450,450,22,16,6,2,1
23,453,453,19,19,0,1,0
29,468,468,12,12,0,1,0
5,475,475,48,48,0,1,0
38,487,487,101,19,82,3,2

12,102,102,11,11,0,1,0
5,115,115,5,5,0,1,0
3,132,132,5,5,0,1,0
0,136,136,4,4,0,1,0
7,136,136,8,5,3,2,1
29,140,140,32,32,0,1,0
24,153,153,17,17,0,1,0
23,155,155,5,5,0,1,0
11,191,191,23,8,15,4,3
30,200,200,12,12,0,1,0
27,209,209,36,3,33,2,1
2,223,223,4,4,0,1,0
16,231,231,9,9,0,1,0
13,238,238,4,4,0,1,0
21,248,248,46,25,21,4,3
22,256,256,40,40,0,1,0
28,269,269,53,31,22,2,1
20,300,300,21,21,0,1,0
15,311,311,14,6,8,3,2
25,318,318,19,19,0,1,0
1,322,322,14,14,0,1,0
10,348,348,213,135,78,3,2
8,354,354,123,123,0,1,0
26,371,371,21,9,12,4,3
19,389,389,23,1,22,2,1
9,407,407,63,63,0,1,0
17,411,411,29,3,26,4,3
4,439,439,48,48,0,1,0
6,466,466,1,1,0,1,0
18,473,473,37,37,0,1,0
14,485,485,57,57,0,1,0

20,115,115,2,2,0,1,0
6,139,139,10,10,0,1,0
22,141,141,6,6,0,1,0
17,156,156,23,23,0,1,0
32,164,164,14,14,0,1,0
11,171,171,4,4,0,1,0
0,180,180,8,1,7,2,1
18,190,190,3,3,0,1,0
5,199,199,22,22,0,1,0
24,214,214,21,21,0,1,0
10,218,218,45,45,0,1,0
31,241,241,31,31,0,1,0
14,269,269,1,1,0,1,0
23,279,279,32,32,0,1,0
15,290,290,14,14,0,1,0
27,295,295,4,1,3,2,1
16,302,302,37,37,0,1,0
28,316,316,43,31,12,4,3
30,317,317,132,21,111,4,3
8,353,353,89,49,40,2,1
7,357,357,40,20,20,3,2
19,361,361,31,31,0,1,0
4,361,361,26,2,24,4,3
2,363,363,14,2,12,4,3
13,364,364,43,4,39,4,3
26,401,401,17,17,0,1,0
3,414,414,24,24,0,1,0
1,415,415,144,144,0,1,0
12,425,425,10,1,9,4,3
25,451,451,13,5,8,2,1
29,462,462,51,7,44,2,1
9,494,494,85,31,54,4,3
21,497,497,60,60,0,1,0

11,123,123,5,5,0,1,0
25,164,164,8,8,0,1,0
18,168,168,60,60,0,1,0
26,181,181,10,10,0,1,0
22,189,189,9,9,0,1,0
10,194,194,13,13,0,1,0
1,196,196,91,47,44,3,2
27,221,221,42,16,26,3,2
2,229,229,18,2,16,2,1
20,244,244,70,70,0,1,0
7,255,255,74,53,21,2,1
8,257,257,42,24,18,2,1
21,280,280,12,12,0,1,0
13,290,290,26,8,18,4,3
9,302,302,29,29,0,1,0
29,304,304,14,14,0,1,0
15,304,304,29,29,0,1,0
14,318,318,19,19,0,1,0
12,345,345,15,15,0,1,0
5,349,349,4,4,0,1,0
0,359,359,84,84,0,1,0
17,378,378,42,42,0,1,0
23,379,379,4,4,0,1,0
24,381,381,55,38,17,2,1
16,385,385,12,6,6,3,2
19,387,387,25,25,0,1,0
4,391,391,12,12,0,1,0
28,412,412,21,6,15,4,3
6,432,432,37,37,0,1,0
3,433,433,41,41,0,1,0

34,128,128,5,5,0,1,0
10,130,130,21,21,0,1,0
24,131,131,21,21,0,1,0
20,132,132,16,16,0,1,0
28,138,138,8,8,0,1,0
35,163,163,16,7,9,4,3
17,169,169,6,3,3,2,1
25,171,171,22,22,0,1,0
29,185,185,3,3,0,1,0
32,188,188,29,29,0,1,0
27,207,207,3,3,0,1,0
5,215,215,12,2,10,3,2
22,242,242,11,11,0,1,0
21,248,248,3,3,0,1,0
33,267,267,105,105,0,1,0
4,280,280,22,8,14,2,1
23,307,307,89,3,86,4,3
15,324,324,23,23,0,1,0
7,325,325,7,7,0,1,0
30,327,327,9,1,8,3,2
0,328,328,48,23,25,2,1
2,368,368,25,25,0,1,0
13,382,382,23,23,0,1,0
8,382,382,13,1,12,4,3
6,385,385,29,11,18,4,3
11,392,392,28,28,0,1,0
26,398,398,20,20,0,1,0
12,412,412,68,2,66,4,3
9,422,422,6,6,0,1,0
3,437,437,163,97,66,4,3
16,449,449,36,36,0,1,0
18,455,455,8,8,0,1,0
36,467,467,3,3,0,1,0
1,481,481,29,3,26,3,2
14,489,489,25,25,0,1,0
19,493,493,30,30,0,1,0
31,496,496,64,16,48,3,2

32,109,109,30,19,11,2,1
35,121,121,16,16,0,1,0
7,123,123,5,5,0,1,0
9,143,143,2,2,0,1,0
23,164,164,7,1,6,3,2
4,168,168,51,51,0,1,0
8,187,187,2,2,0,1,0
36,190,190,23,8,15,4,3
2,221,221,81,81,0,1,0
3,251,251,30,30,0,1,0
31,257,257,2,2,0,1,0
30,261,261,6,6,0,1,0
21,263,263,2,2,0,1,0
18,271,271,23,23,0,1,0
28,279,279,1,1,0,1,0
14,296,296,91,79,12,4,3
0,301,301,8,3,5,2,1
16,320,320,4,4,0,1,0
5,337,337,2,2,0,1,0
1,340,340,13,4,9,2,1
26,367,367,8,8,0,1,0
29,369,369,22,7,15,4,3
22,373,373,215,215,0,1,0
17,382,382,1,1,0,1,0
11,385,385,30,30,0,1,0
13,397,397,39,1,38,2,1
25,402,402,32,32,0,1,0
6,407,407,15,12,3,2,1
20,425,425,48,48,0,1,0
10,437,437,60,14,46,4,3
24,440,440,45,45,0,1,0
15,441,441,1,1,0,1,0
33,443,443,29,14,15,2,1
19,446,446,6,6,0,1,0
34,454,454,31,31,0,1,0
27,462,462,17,3,14,3,2
12,500,500,1,1,0,1,0

22,119,119,5,5,0,1,0
31,127,127,2,2,0,1,0
26,127,127,1,1,0,1,0
11,140,140,5,5,0,1,0
34,145,145,28,28,0,1,0
23,145,145,6,6,0,1,0
18,154,154,4,4,0,1,0
13,168,168,12,9,3,2,1
24,178,178,30,7,23,2,1
27,199,199,11,4,7,2,1
17,203,203,43,43,0,1,0
29,212,212,55,37,18,2,1
14,218,218,2,2,0,1,0
12,221,221,16,4,12,3,2
21,234,234,20,20,0,1,0
19,234,234,25,8,17,2,1
3,235,235,8,8,0,1,0
32,256,256,29,5,24,2,1
0,267,267,54,54,0,1,0
28,284,284,35,5,30,2,1
35,309,309,12,12,0,1,0
16,323,323,23,10,13,2,1
30,326,326,77,23,54,3,2
2,326,326,17,17,0,1,0
20,332,332,34,10,24,2,1
8,361,361,72,72,0,1,0
1,366,366,64,44,20,2,1
10,399,399,47,47,0,1,0
4,423,423,13,6,7,2,1
15,423,423,45,45,0,1,0
33,451,451,65,45,20,3,2
5,478,478,54,12,42,3,2
9,480,480,18,8,10,3,2
25,484,484,6,6,0,1,0
6,489,489,10,4,6,2,1
7,492,492,59,14,45,2,1

14,106,106,25,9,16,3,2
8,117,117,15,2,13,2,1
5,136,136,18,18,0,1,0
13,146,146,16,3,13,2,1
31,196,196,10,10,0,1,0
6,201,201,24,24,0,1,0
2,211,211,15,12,3,2,1
25,214,214,2,2,0,1,0
28,219,219,20,20,0,1,0
22,220,220,13,8,5,2,1
12,222,222,6,6,0,1,0
10,231,231,42,42,0,1,0
27,265,265,24,4,20,3,2
20,270,270,15,15,0,1,0
21,276,276,125,83,42,4,3
11,296,296,15,5,10,3,2
3,297,297,22,22,0,1,0
19,307,307,12,12,0,1,0
30,311,311,33,27,6,2,1
7,353,353,64,64,0,1,0
1,378,378,24,7,17,2,1
24,407,407,49,19,30,2,1
26,410,410,67,13,54,4,3
15,411,411,13,13,0,1,0
0,413,413,67,53,14,4,3
23,414,414,58,58,0,1,0
4,415,415,39,6,33,4,3
17,425,425,35,35,0,1,0
29,438,438,23,3,20,2,1
16,448,448,48,39,9,4,3
9,451,451,17,17,0,1,0
18,459,459,4,4,0,1,0
32,499,499,50,2,48,3,2

34,117,117,5,5,0,1,0
32,140,140,6,1,5,2,1
17,140,140,10,10,0,1,0
1,156,156,1,1,0,1,0
27,159,159,14,11,3,2,1
28,164,164,12,12,0,1,0
35,165,165,20,13,7,2,1
19,167,167,32,6,26,2,1
10,176,176,18,1,17,4,3
12,177,177,20,20,0,1,0
4,180,180,5,5,0,1,0
23,188,188,13,13,0,1,0
3,193,193,15,15,0,1,0
8,204,204,2,2,0,1,0
36,233,233,5,5,0,1,0
14,263,263,4,1,3,2,1
16,278,278,30,30,0,1,0
25,289,289,57,57,0,1,0
22,310,310,3,3,0,1,0
38,310,310,54,54,0,1,0
5,329,329,22,1,21,4,3
9,339,339,43,11,32,2,1
15,340,340,51,17,34,2,1
21,341,341,43,15,28,3,2
18,370,370,25,10,15,4,3
11,384,384,12,2,10,3,2
2,399,399,25,21,4,2,1
13,399,399,9,9,0,1,0
31,411,411,2,2,0,1,0
24,411,411,63,45,18,4,3
0,416,416,6,1,5,2,1
7,451,451,23,9,14,3,2
33,455,455,103,19,84,3,2
30,478,478,178,34,144,4,3
20,480,480,13,1,12,3,2
29,481,481,23,23,0,1,0
37,483,483,38,38,0,1,0
26,485,485,1,1,0,1,0
6,490,490,113,67,46,3,2

12,101,101,7,7,0,1,0
20,102,102,16,16,0,1,0
28,107,107,4,4,0,1,0
8,109,109,8,8,0,1,0
9,115,115,23,2,21,4,3
0,125,125,1,1,0,1,0
31,149,149,12,2,10,2,1
24,157,157,1,1,0,1,0
18,168,168,3,3,0,1,0
15,175,175,2,2,0,1,0
33,186,186,15,15,0,1,0
2,212,212,49,49,0,1,0
26,252,252,62,8,54,4,3
23,269,269,18,18,0,1,0
27,270,270,1,1,0,1,0
25,284,284,43,43,0,1,0
4,303,303,38,38,0,1,0
22,315,315,53,15,38,2,1
7,327,327,10,3,7,2,1
5,327,327,6,6,0,1,0
6,331,331,1,1,0,1,0
14,339,339,77,29,48,3,2
29,358,358,4,4,0,1,0
17,359,359,42,42,0,1,0
30,378,378,6,6,0,1,0
21,379,379,111,111,0,1,0
10,379,379,111,85,26,3,2
32,382,382,3,3,0,1,0
11,384,384,2,2,0,1,0
16,387,387,38,6,32,4,3
3,392,392,20,17,3,2,1
19,397,397,111,96,15,4,3
13,401,401,99,99,0,1,0
1,442,442,4,4,0,1,0

13,107,107,4,4,0,1,0
20,120,120,2,2,0,1,0
26,121,121,13,3,10,2,1
21,144,144,3,3,0,1,0
0,158,158,16,3,13,2,1
18,188,188,38,38,0,1,0
9,201,201,11,11,0,1,0
4,213,213,15,15,0,1,0
1,214,214,19,5,14,3,2
8,215,215,9,9,0,1,0
5,245,245,119,77,42,2,1
16,261,261,19,12,7,2,1
22,276,276,27,10,17,2,1
3,306,306,47,47,0,1,0
23,309,309,55,33,22,3,2
10,310,310,102,102,0,1,0
24,339,339,27,11,16,2,1
19,371,371,31,10,21,2,1
12,387,387,24,15,9,2,1
27,389,389,82,64,18,2,1
15,412,412,56,20,36,4,3
25,415,415,35,35,0,1,0
17,442,442,98,64,34,4,3
14,457,457,26,8,18,4,3
2,457,457,99,99,0,1,0
7,478,478,48,48,0,1,0
6,483,483,28,10,18,2,1
11,487,487,37,8,29,2,1

21,104,104,2,2,0,1,0
6,112,112,14,1,13,2,1
33,120,120,11,11,0,1,0
13,143,143,2,2,0,1,0
5,153,153,37,23,14,2,1
14,155,155,21,12,9,2,1
10,156,156,21,21,0,1,0
2,174,174,5,5,0,1,0
31,181,181,39,12,27,2,1
11,190,190,13,13,0,1,0
4,211,211,10,10,0,1,0
12,228,228,32,11,21,2,1
30,249,249,34,34,0,1,0
0,257,257,18,18,0,1,0
22,261,261,30,30,0,1,0
26,264,264,4,4,0,1,0
15,269,269,2,2,0,1,0
23,269,269,24,24,0,1,0
20,269,269,37,37,0,1,0
19,272,272,31,13,18,2,1
34,278,278,7,3,4,2,1
29,284,284,35,35,0,1,0
9,288,288,39,39,0,1,0
32,290,290,3,3,0,1,0
8,311,311,17,7,10,3,2
27,328,328,78,78,0,1,0
24,360,360,11,11,0,1,0
1,364,364,69,69,0,1,0
28,378,378,2,2,0,1,0
17,388,388,23,23,0,1,0
7,389,389,4,4,0,1,0
18,409,409,45,15,30,2,1
3,425,425,22,14,8,3,2
25,456,456,117,75,42,4,3
16,468,468,88,78,10,2,1

22,102,102,4,4,0,1,0
4,109,109,1,1,0,1,0
29,110,110,1,1,0,1,0
13,116,116,1,1,0,1,0
6,141,141,2,2,0,1,0
7,145,145,33,33,0,1,0
18,149,149,1,1,0,1,0
12,162,162,25,5,20,2,1
31,175,175,1,1,0,1,0
2,200,200,15,15,0,1,0
32,216,216,23,23,0,1,0
34,230,230,72,25,47,2,1
27,242,242,7,7,0,1,0
30,262,262,17,8,9,4,3
15,279,279,20,20,0,1,0
33,288,288,20,8,12,2,1
14,303,303,39,17,22,4,3
25,311,311,30,4,26,2,1
19,330,330,29,29,0,1,0
10,342,342,93,51,42,4,3
1,350,350,28,28,0,1,0
21,357,357,16,16,0,1,0
5,391,391,13,13,0,1,0
20,392,392,98,63,35,4,3
23,395,395,173,81,92,3,2
17,401,401,66,29,37,2,1
0,407,407,42,42,0,1,0
9,410,410,45,15,30,2,1
3,417,417,42,22,20,2,1
8,424,424,3,3,0,1,0
24,451,451,10,10,0,1,0
26,467,467,8,1,7,3,2
11,468,468,35,35,0,1,0
28,481,481,66,31,35,2,1
16,486,486,32,32,0,1,0

3,111,111,17,17,0,1,0
13,123,123,5,5,0,1,0
27,143,143,1,1,0,1,0
1,148,148,30,30,0,1,0
14,169,169,11,4,7,2,1
21,180,180,2,2,0,1,0
24,190,190,25,25,0,1,0
25,196,196,16,16,0,1,0
26,197,197,15,15,0,1,0
15,224,224,17,5,12,2,1
19,232,232,29,29,0,1,0
10,272,272,123,18,105,4,3
16,287,287,2,2,0,1,0
17,293,293,33,9,24,4,3
18,301,301,67,67,0,1,0
4,327,327,14,8,6,3,2
11,337,337,42,1,41,2,1
22,342,342,127,85,42,3,2
7,367,367,81,81,0,1,0
12,379,379,7,7,0,1,0
20,384,384,66,28,38,3,2
9,405,405,8,5,3,2,1
2,430,430,8,2,6,2,1
8,436,436,77,41,36,3,2
6,448,448,51,51,0,1,0
0,482,482,143,101,42,4,3
23,487,487,47,12,35,2,1
5,494,494,3,3,0,1,0

24,110,110,8,8,0,1,0
6,123,123,2,2,0,1,0
11,125,125,4,1,3,2,1
10,127,127,31,8,23,2,1
23,146,146,12,12,0,1,0
19,151,151,8,2,6,3,2
29,171,171,13,4,9,4,3
5,175,175,23,23,0,1,0
13,193,193,8,2,6,3,2
14,201,201,16,16,0,1,0
33,212,212,14,14,0,1,0
9,237,237,7,1,6,3,2
21,247,247,27,24,3,2,1
20,252,252,112,102,10,3,2
1,254,254,1,1,0,1,0
28,257,257,5,2,3,2,1
18,259,259,13,13,0,1,0
8,339,339,33,27,6,2,1
2,344,344,2,2,0,1,0
27,362,362,66,66,0,1,0
32,376,376,35,35,0,1,0
16,398,398,34,24,10,3,2
7,422,422,23,23,0,1,0
31,425,425,14,11,3,2,1
22,428,428,36,10,26,2,1
0,438,438,1,1,0,1,0
25,440,440,82,28,54,4,3
26,442,442,20,14,6,3,2
3,457,457,50,18,32,2,1
30,466,466,4,4,0,1,0
17,468,468,61,61,0,1,0
4,479,479,296,249,47,2,1
12,484,484,28,14,14,2,1
15,496,496,46,46,0,1,0

31,105,105,13,13,0,1,0
13,110,110,2,2,0,1,0
33,116,116,7,2,5,2,1
23,119,119,2,2,0,1,0
0,144,144,7,7,0,1,0
38,151,151,20,20,0,1,0
40,152,152,20,20,0,1,0
9,155,155,31,4,27,2,1
11,160,160,10,10,0,1,0
17,161,161,11,5,6,3,2
2,166,166,3,3,0,1,0
18,167,167,3,3,0,1,0
15,177,177,14,14,0,1,0
24,178,178,12,12,0,1,0
6,186,186,29,9,20,4,3
20,190,190,9,9,0,1,0
25,203,203,3,3,0,1,0
35,204,204,14,14,0,1,0
34,219,219,62,62,0,1,0
10,219,219,10,10,0,1,0
32,227,227,67,50,17,2,1
27,250,250,23,23,0,1,0
19,288,288,24,24,0,1,0
39,290,290,15,3,12,3,2
1,301,301,64,64,0,1,0
5,333,333,28,6,22,4,3
16,335,335,3,3,0,1,0
7,338,338,30,23,7,2,1
29,342,342,3,3,0,1,0
12,350,350,3,3,0,1,0
28,362,362,41,41,0,1,0
26,373,373,7,1,6,3,2
8,374,374,85,70,15,2,1
21,388,388,1,1,0,1,0
3,395,395,41,41,0,1,0
4,405,405,1,1,0,1,0
30,407,407,39,39,0,1,0
14,429,429,14,14,0,1,0
41,435,435,38,14,24,4,3
22,446,446,1,1,0,1,0
37,466,466,76,44,32,4,3
36,490,490,2,2,0,1,0

14,103,103,15,2,13,2,1
23,161,161,4,4,0,1,0
10,173,173,6,6,0,1,0
26,184,184,20,7,13,4,3
3,193,193,2,2,0,1,0
32,205,205,2,2,0,1,0
8,214,214,126,86,40,2,1
20,223,223,51,11,40,3,2
25,229,229,112,112,0,1,0
15,230,230,20,20,0,1,0
1,233,233,29,16,13,2,1
19,234,234,16,4,12,4,3
9,290,290,12,12,0,1,0
0,299,299,15,4,11,2,1
6,307,307,99,34,65,3,2
13,308,308,9,9,0,1,0
29,317,317,48,39,9,2,1
7,321,321,41,29,12,4,3
17,331,331,9,9,0,1,0
27,333,333,1,1,0,1,0
5,345,345,16,11,5,2,1
2,360,360,1,1,0,1,0
18,367,367,5,2,3,2,1
4,370,370,1,1,0,1,0
11,381,381,20,11,9,2,1
31,391,391,22,22,0,1,0
28,406,406,21,13,8,2,1
33,411,411,89,89,0,1,0
16,413,413,3,3,0,1,0
12,428,428,1,1,0,1,0
34,438,438,4,4,0,1,0
21,440,440,66,38,28,3,2
24,457,457,26,26,0,1,0
30,484,484,25,5,20,2,1
22,493,493,23,23,0,1,0

22,121,121,5,5,0,1,0
21,135,135,5,2,3,2,1
29,146,146,2,2,0,1,0
25,157,157,29,20,9,2,1
23,157,157,5,5,0,1,0
13,161,161,23,4,19,2,1
31,170,170,28,28,0,1,0
15,171,171,17,5,12,4,3
2,220,220,7,7,0,1,0
33,226,226,22,13,9,2,1
28,227,227,7,1,6,2,1
4,244,244,7,7,0,1,0
5,270,270,15,5,10,2,1
8,271,271,64,22,42,3,2
17,316,316,44,44,0,1,0
10,341,341,20,20,0,1,0
27,347,347,42,42,0,1,0
0,350,350,6,6,0,1,0
12,357,357,10,10,0,1,0
18,359,359,109,91,18,4,3
20,371,371,19,8,11,3,2
11,375,375,26,26,0,1,0
7,387,387,49,49,0,1,0
9,397,397,76,37,39,2,1
16,405,405,91,71,20,2,1
19,414,414,80,34,46,2,1
24,439,439,40,40,0,1,0
6,439,439,12,2,10,3,2
3,446,446,25,25,0,1,0
32,451,451,37,37,0,1,0
30,454,454,41,36,5,2,1
14,466,466,78,78,0,1,0
26,473,473,26,17,9,4,3
1,482,482,67,67,0,1,0

2,118,118,1,1,0,1,0
9,119,119,32,32,0,1,0
6,122,122,7,4,3,2,1
23,160,160,63,63,0,1,0
13,172,172,1,1,0,1,0
29,182,182,20,9,11,2,1
27,190,190,1,1,0,1,0
19,190,190,34,34,0,1,0
1,202,202,44,44,0,1,0
17,214,214,1,1,0,1,0
8,231,231,5,5,0,1,0
26,251,251,20,12,8,3,2
24,254,254,11,3,8,3,2
12,258,258,40,3,37,3,2
28,260,260,12,6,6,3,2
18,285,285,23,7,16,3,2
0,305,305,32,14,18,3,2
14,322,322,12,4,8,3,2
7,333,333,92,92,0,1,0
21,337,337,54,54,0,1,0
25,339,339,15,15,0,1,0
15,352,352,21,12,9,4,3
4,352,352,49,37,12,4,3
3,364,364,43,22,21,2,1
22,423,423,98,29,69,4,3
10,423,423,83,35,48,4,3
16,469,469,5,5,0,1,0
5,476,476,28,28,0,1,0
11,481,481,38,38,0,1,0
20,495,495,120,66,54,4,3

1,111,111,4,4,0,1,0
32,112,112,10,10,0,1,0
25,113,113,1,1,0,1,0
21,114,114,8,4,4,2,1
31,115,115,33,33,0,1,0
15,149,149,1,1,0,1,0
17,154,154,12,12,0,1,0
33,168,168,11,1,10,3,2
23,175,175,21,21,0,1,0
29,176,176,32,3,29,2,1
26,192,192,3,3,0,1,0
28,193,193,15,15,0,1,0
20,206,206,16,13,3,2,1
38,236,236,3,3,0,1,0
11,238,238,7,2,5,2,1
8,241,241,2,2,0,1,0
22,249,249,4,1,3,2,1
41,292,292,31,31,0,1,0
30,295,295,7,7,0,1,0
27,302,302,71,71,0,1,0
3,306,306,36,19,17,2,1
37,308,308,23,6,17,2,1
16,313,313,14,8,6,2,1
24,319,319,21,5,16,2,1
6,336,336,4,4,0,1,0
5,342,342,38,14,24,2,1
34,343,343,52,52,0,1,0
2,345,345,17,1,16,4,3
13,348,348,79,1,78,4,3
18,359,359,25,25,0,1,0
9,401,401,49,49,0,1,0
35,407,407,36,36,0,1,0
36,420,420,1,1,0,1,0
12,423,423,79,54,25,2,1
19,433,433,19,19,0,1,0
40,435,435,12,12,0,1,0
10,447,447,22,16,6,3,2
7,480,480,49,23,26,2,1
14,481,481,11,11,0,1,0
39,482,482,53,11,42,2,1
42,488,488,22,22,0,1,0
0,492,492,3,3,0,1,0
4,494,494,2,2,0,1,0
43,496,496,81,51,30,2,1

2,108,108,23,1,22,3,2
34,111,111,5,2,3,2,1
6,121,121,6,6,0,1,0
24,124,124,3,3,0,1,0
1,126,126,6,6,0,1,0
30,151,151,3,3,0,1,0
8,153,153,6,6,0,1,0
33,158,158,20,20,0,1,0
7,172,172,22,16,6,2,1
20,228,228,39,39,0,1,0
3,230,230,8,8,0,1,0
25,232,232,18,18,0,1,0
11,234,234,24,24,0,1,0
22,237,237,7,3,4,2,1
21,264,264,20,7,13,2,1
12,264,264,23,11,12,2,1
10,267,267,2,2,0,1,0
28,296,296,22,14,8,2,1
31,296,296,12,12,0,1,0
17,298,298,15,5,10,2,1
16,299,299,17,1,16,2,1
32,304,304,74,6,68,3,2
5,306,306,82,54,28,2,1
4,318,318,27,12,15,4,3
23,322,322,2,2,0,1,0
15,330,330,68,68,0,1,0
29,357,357,30,1,29,2,1
13,366,366,1,1,0,1,0
35,426,426,139,139,0,1,0
0,432,432,2,2,0,1,0
18,436,436,9,9,0,1,0
14,451,451,21,7,14,3,2
27,454,454,47,47,0,1,0
36,457,457,56,38,18,4,3
19,482,482,102,102,0,1,0
26,485,485,83,62,21,4,3
9,491,491,19,19,0,1,0

5,114,114,7,3,4,2,1
20,116,116,1,1,0,1,0
11,124,124,12,12,0,1,0
17,149,149,18,18,0,1,0
13,155,155,59,36,23,2,1
25,155,155,19,19,0,1,0
29,161,161,27,15,12,4,3
2,173,173,39,39,0,1,0
4,174,174,5,5,0,1,0
15,200,200,18,7,11,2,1
12,206,206,7,1,6,2,1
19,231,231,2,2,0,1,0
1,241,241,93,30,63,4,3
3,265,265,7,7,0,1,0
14,268,268,15,2,13,2,1
30,268,268,9,9,0,1,0
16,272,272,32,8,24,4,3
21,282,282,32,14,18,3,2
26,313,313,50,35,15,4,3
8,326,326,37,37,0,1,0
27,333,333,12,8,4,2,1
6,335,335,1,1,0,1,0
9,376,376,99,45,54,4,3
23,393,393,54,16,38,2,1
0,395,395,23,3,20,2,1
24,405,405,90,90,0,1,0
22,406,406,27,5,22,3,2
28,424,424,98,49,49,4,3
7,455,455,4,1,3,2,1
10,458,458,7,4,3,2,1
18,473,473,24,24,0,1,0

20,108,108,26,5,21,4,3
23,113,113,38,38,0,1,0
27,130,130,1,1,0,1,0
19,143,143,10,6,4,2,1
34,154,154,34,25,9,4,3
11,165,165,46,46,0,1,0
9,181,181,15,3,12,3,2
17,193,193,2,2,0,1,0
6,228,228,16,16,0,1,0
14,237,237,11,5,6,3,2
22,250,250,15,11,4,2,1
18,261,261,5,1,4,2,1
32,285,285,29,29,0,1,0
16,310,310,6,1,5,2,1
28,316,316,11,11,0,1,0
3,316,316,58,58,0,1,0
24,322,322,44,44,0,1,0
2,342,342,31,31,0,1,0
10,345,345,48,48,0,1,0
12,375,375,43,43,0,1,0
26,387,387,8,8,0,1,0
31,387,387,11,11,0,1,0
1,390,390,5,2,3,2,1
5,402,402,5,5,0,1,0
15,442,442,24,18,6,2,1
8,464,464,25,25,0,1,0
29,466,466,41,41,0,1,0
21,468,468,24,24,0,1,0
30,472,472,17,1,16,2,1
0,476,476,125,98,27,2,1
7,478,478,54,54,0,1,0
25,478,478,71,71,0,1,0
4,483,483,27,27,0,1,0
13,495,495,50,5,45,4,3
33,498,498,66,66,0,1,0

8,112,112,2,2,0,1,0
4,121,121,4,4,0,1,0
3,124,124,7,7,0,1,0
16,138,138,10,10,0,1,0
33,174,174,28,28,0,1,0
9,179,179,10,10,0,1,0
31,180,180,17,1,16,2,1
13,191,191,3,3,0,1,0
22,204,204,13,8,5,2,1
17,219,219,1,1,0,1,0
14,228,228,3,3,0,1,0
21,229,229,26,5,21,2,1
15,267,267,52,43,9,2,1
18,291,291,7,1,6,2,1
5,299,299,2,2,0,1,0
12,304,304,37,37,0,1,0
34,321,321,6,6,0,1,0
23,325,325,85,42,43,2,1
0,332,332,7,1,6,2,1
7,340,340,82,49,33,4,3
1,343,343,6,6,0,1,0
2,367,367,19,19,0,1,0
25,376,376,11,3,8,3,2
20,388,388,23,2,21,2,1
32,397,397,142,82,60,3,2
26,400,400,11,11,0,1,0
6,401,401,3,3,0,1,0
11,403,403,74,29,45,4,3
27,403,403,79,49,30,3,2
35,414,414,44,44,0,1,0
29,427,427,64,25,39,2,1
24,433,433,26,9,17,2,1
19,438,438,5,5,0,1,0
10,455,455,256,202,54,3,2
30,491,491,2,2,0,1,0
28,497,497,6,6,0,1,0

35,113,113,23,20,3,2,1
5,125,125,21,21,0,1,0
24,127,127,10,10,0,1,0
34,128,128,2,2,0,1,0
12,140,140,2,2,0,1,0
36,143,143,11,11,0,1,0
17,144,144,6,1,5,2,1
18,168,168,4,4,0,1,0
31,169,169,22,22,0,1,0
7,172,172,25,6,19,2,1
37,174,174,1,1,0,1,0
33,206,206,24,24,0,1,0
30,211,211,6,3,3,2,1
28,211,211,5,2,3,2,1
32,218,218,66,66,0,1,0
27,226,226,19,19,0,1,0
0,240,240,21,21,0,1,0
11,258,258,34,34,0,1,0
14,259,259,1,1,0,1,0
25,263,263,36,36,0,1,0
23,265,265,2,2,0,1,0
13,276,276,23,10,13,4,3
29,276,276,64,64,0,1,0
15,293,293,71,71,0,1,0
20,296,296,38,11,27,3,2
6,300,300,8,8,0,1,0
8,310,310,23,6,17,2,1
1,337,337,32,18,14,3,2
16,344,344,6,6,0,1,0
22,381,381,20,20,0,1,0
2,384,384,73,73,0,1,0
21,391,391,84,35,49,2,1
26,426,426,12,3,9,4,3
9,429,429,33,11,22,3,2
10,438,438,51,51,0,1,0
19,439,439,10,2,8,3,2
4,439,439,1,1,0,1,0
3,466,466,5,1,4,2,1

5,101,101,56,24,32,4,3
30,102,102,2,2,0,1,0
1,122,122,7,7,0,1,0
10,152,152,13,13,0,1,0
7,164,164,38,38,0,1,0
24,164,164,75,75,0,1,0
29,165,165,20,20,0,1,0
22,168,168,17,17,0,1,0
23,180,180,10,10,0,1,0
32,188,188,11,11,0,1,0
16,191,191,3,3,0,1,0
21,195,195,7,7,0,1,0
25,216,216,14,1,13,2,1
31,221,221,63,1,62,4,3
18,238,238,52,52,0,1,0
11,241,241,14,14,0,1,0
34,243,243,17,5,12,4,3
3,249,249,39,15,24,3,2
33,255,255,8,8,0,1,0
15,260,260,1,1,0,1,0
14,270,270,9,9,0,1,0
13,290,290,2,2,0,1,0
35,302,302,18,18,0,1,0
20,306,306,43,2,41,2,1
4,322,322,5,5,0,1,0
12,326,326,11,5,6,2,1
26,327,327,30,18,12,4,3
27,333,333,3,3,0,1,0
0,333,333,3,3,0,1,0
28,337,337,18,18,0,1,0
8,342,342,29,29,0,1,0
2,358,358,16,2,14,3,2
19,372,372,30,30,0,1,0
6,393,393,11,2,9,2,1
17,462,462,18,18,0,1,0
9,471,471,11,11,0,1,0

28,100,100,7,7,0,1,0
36,104,104,11,11,0,1,0
1,108,108,1,1,0,1,0
30,110,110,3,3,0,1,0
13,130,130,17,17,0,1,0
32,132,132,23,23,0,1,0
6,141,141,6,6,0,1,0
26,153,153,59,34,25,2,1
9,164,164,10,10,0,1,0
16,170,170,20,20,0,1,0
35,178,178,8,8,0,1,0
11,197,197,33,33,0,1,0
27,220,220,9,3,6,2,1
29,225,225,33,33,0,1,0
14,229,229,1,1,0,1,0
7,243,243,67,67,0,1,0
0,250,250,22,12,10,2,1
23,254,254,18,18,0,1,0
4,259,259,35,35,0,1,0
25,270,270,58,22,36,4,3
12,272,272,13,13,0,1,0
10,276,276,1,1,0,1,0
8,304,304,45,45,0,1,0
24,305,305,3,3,0,1,0
21,308,308,47,44,3,2,1
20,320,320,13,13,0,1,0
19,335,335,29,21,8,3,2
22,339,339,7,1,6,3,2
5,369,369,14,14,0,1,0
15,384,384,66,66,0,1,0
33,436,436,12,5,7,2,1
34,451,451,75,61,14,3,2
3,470,470,27,18,9,2,1
17,474,474,3,3,0,1,0
31,485,485,14,14,0,1,0
18,486,486,15,15,0,1,0
2,486,486,38,24,14,2,1

25,103,103,11,11,0,1,0
2,136,136,6,3,3,2,1
19,161,161,7,7,0,1,0
9,168,168,2,2,0,1,0
30,171,171,17,17,0,1,0
34,189,189,31,31,0,1,0
14,190,190,4,4,0,1,0
33,201,201,34,20,14,2,1
28,201,201,3,3,0,1,0
10,215,215,12,2,10,2,1
18,230,230,3,3,0,1,0
22,242,242,2,2,0,1,0
0,251,251,10,1,9,4,3
32,258,258,6,3,3,2,1
1,271,271,67,5,62,4,3
31,285,285,104,104,0,1,0
27,297,297,45,45,0,1,0
11,317,317,60,48,12,2,1
20,321,321,37,37,0,1,0
13,324,324,66,66,0,1,0
23,339,339,17,1,16,3,2
12,359,359,50,50,0,1,0
24,378,378,46,46,0,1,0
17,416,416,27,27,0,1,0
21,426,426,79,41,38,2,1
29,431,431,18,6,12,3,2
3,440,440,48,48,0,1,0
4,451,451,55,23,32,2,1
6,456,456,15,7,8,3,2
26,473,473,26,5,21,3,2
16,477,477,57,57,0,1,0
8,479,479,24,21,3,2,1
7,489,489,67,48,19,2,1
15,491,491,32,32,0,1,0
5,497,497,24,24,0,1,0

19,116,116,3,3,0,1,0
18,121,121,5,2,3,2,1
10,128,128,1,1,0,1,0
23,153,153,6,6,0,1,0
16,180,180,2,2,0,1,0
28,186,186,8,8,0,1,0
6,189,189,14,14,0,1,0
8,196,196,1,1,0,1,0
9,201,201,11,8,3,2,1
15,209,209,1,1,0,1,0
26,209,209,12,12,0,1,0
17,220,220,77,22,55,3,2
12,227,227,27,3,24,4,3
33,230,230,13,13,0,1,0
30,236,236,16,16,0,1,0
31,242,242,10,10,0,1,0
37,246,246,43,43,0,1,0
14,247,247,1,1,0,1,0
25,260,260,10,10,0,1,0
24,268,268,5,1,4,2,1
7,284,284,2,2,0,1,0
20,286,286,4,4,0,1,0
3,296,296,137,89,48,3,2
22,310,310,33,14,19,2,1
4,315,315,10,10,0,1,0
5,356,356,74,46,28,3,2
34,367,367,25,1,24,2,1
2,381,381,29,1,28,2,1
11,387,387,33,33,0,1,0
13,392,392,23,11,12,3,2
1,393,393,16,16,0,1,0
29,397,397,178,178,0,1,0
0,410,410,8,8,0,1,0
35,411,411,39,27,12,4,3
21,426,426,38,38,0,1,0
32,434,434,29,17,12,4,3
36,462,462,40,3,37,2,1
27,471,471,111,5,106,4,3

12,101,101,26,26,0,1,0
27,110,110,34,13,21,4,3
10,124,124,9,9,0,1,0
14,134,134,1,1,0,1,0
8,157,157,1,1,0,1,0
25,160,160,15,3,12,3,2
3,169,169,53,22,31,3,2
0,169,169,1,1,0,1,0
32,170,170,6,6,0,1,0
4,186,186,19,19,0,1,0
5,198,198,13,13,0,1,0
28,214,214,2,2,0,1,0
21,214,214,14,14,0,1,0
7,216,216,16,2,14,3,2
2,236,236,23,3,20,3,2
30,242,242,4,1,3,2,1
31,272,272,52,3,49,2,1
16,279,279,7,7,0,1,0
20,285,285,30,21,9,4,3
34,293,293,28,10,18,4,3
15,312,312,2,2,0,1,0
23,344,344,2,2,0,1,0
11,351,351,12,12,0,1,0
6,354,354,38,38,0,1,0
18,367,367,20,20,0,1,0
9,378,378,33,33,0,1,0
33,408,408,58,10,48,2,1
1,411,411,22,22,0,1,0
26,418,418,16,16,0,1,0
17,433,433,106,56,50,2,1
24,433,433,66,21,45,4,3
35,439,439,32,8,24,2,1
13,439,439,38,38,0,1,0
22,449,449,85,46,39,4,3
19,468,468,53,53,0,1,0
29,496,496,47,9,38,4,3

25,110,110,16,16,0,1,0
13,120,120,34,12,22,2,1
12,121,121,1,1,0,1,0
8,123,123,50,50,0,1,0
16,129,129,4,4,0,1,0
10,135,135,2,2,0,1,0
11,175,175,1,1,0,1,0
35,189,189,33,33,0,1,0
22,195,195,11,6,5,2,1
27,204,204,1,1,0,1,0
33,205,205,72,28,44,2,1
24,215,215,41,2,39,4,3
31,217,217,17,17,0,1,0
15,227,227,4,1,3,2,1
32,227,227,29,9,20,3,2
34,241,241,17,3,14,2,1
30,272,272,1,1,0,1,0
18,273,273,8,8,0,1,0
28,273,273,25,25,0,1,0
20,293,293,41,41,0,1,0
21,301,301,23,11,12,4,3
5,306,306,2,2,0,1,0
4,307,307,65,65,0,1,0
9,319,319,24,24,0,1,0
17,359,359,8,8,0,1,0
23,363,363,31,31,0,1,0
7,366,366,108,70,38,3,2
29,371,371,20,20,0,1,0
0,393,393,30,30,0,1,0
6,409,409,37,37,0,1,0
19,429,429,21,8,13,2,1
14,437,437,1,1,0,1,0
2,457,457,8,8,0,1,0
3,474,474,1,1,0,1,0
26,475,475,21,1,20,2,1
1,496,496,52,28,24,2,1

27,124,124,5,5,0,1,0
30,144,144,30,2,28,3,2
6,187,187,16,2,14,2,1
0,193,193,6,6,0,1,0
8,213,213,8,8,0,1,0
4,215,215,25,9,16,3,2
34,221,221,57,5,52,4,3
12,239,239,9,1,8,3,2
14,239,239,27,5,22,2,1
1,253,253,2,2,0,1,0
29,262,262,1,1,0,1,0
10,272,272,45,45,0,1,0
22,278,278,57,33,24,3,2
25,296,296,91,7,84,4,3
5,310,310,18,18,0,1,0
19,311,311,2,2,0,1,0
20,315,315,13,13,0,1,0
33,329,329,7,7,0,1,0
3,333,333,121,76,45,3,2
31,336,336,46,46,0,1,0
24,339,339,61,16,45,2,1
21,349,349,7,7,0,1,0
2,360,360,71,35,36,3,2
16,371,371,20,20,0,1,0
11,392,392,41,13,28,3,2
13,400,400,12,1,11,2,1
7,412,412,18,18,0,1,0
23,417,417,24,24,0,1,0
28,422,422,1,1,0,1,0
9,434,434,86,86,0,1,0
17,461,461,1,1,0,1,0
26,473,473,44,44,0,1,0
15,474,474,26,26,0,1,0
32,481,481,66,9,57,3,2
18,488,488,6,2,4,2,1

21,110,110,2,2,0,1,0
33,111,111,4,1,3,2,1
15,166,166,2,2,0,1,0
26,167,167,6,6,0,1,0
0,199,199,13,8,5,2,1
17,234,234,5,5,0,1,0
4,236,236,68,30,38,2,1
13,243,243,1,1,0,1,0
14,244,244,11,11,0,1,0
10,266,266,27,27,0,1,0
16,266,266,43,20,23,2,1
30,283,283,104,104,0,1,0
18,283,283,28,6,22,4,3
28,294,294,29,15,14,3,2
2,294,294,69,69,0,1,0
9,313,313,47,47,0,1,0
20,313,313,15,15,0,1,0
25,318,318,29,29,0,1,0
7,319,319,14,7,7,2,1
8,325,325,11,2,9,2,1
6,333,333,76,49,27,2,1
5,337,337,16,16,0,1,0
27,349,349,33,33,0,1,0
3,352,352,29,16,13,2,1
12,358,358,48,48,0,1,0
1,398,398,24,24,0,1,0
11,413,413,4,4,0,1,0
32,421,421,21,1,20,3,2
23,422,422,23,23,0,1,0
29,431,431,39,39,0,1,0
22,441,441,103,25,78,3,2
31,449,449,116,80,36,4,3
24,454,454,7,7,0,1,0
19,479,479,53,53,0,1,0

26,100,100,3,3,0,1,0
30,116,116,5,5,0,1,0
18,121,121,19,19,0,1,0
35,126,126,2,2,0,1,0
34,137,137,19,19,0,1,0
3,161,161,2,2,0,1,0
8,172,172,41,31,10,3,2
15,187,187,4,4,0,1,0
22,195,195,11,8,3,2,1
29,201,201,6,3,3,2,1
20,211,211,13,13,0,1,0
1,212,212,6,6,0,1,0
24,224,224,11,11,0,1,0
7,242,242,32,6,26,2,1
16,273,273,28,28,0,1,0
10,287,287,53,23,30,4,3
11,296,296,35,22,13,2,1
27,306,306,60,23,37,2,1
4,306,306,1,1,0,1,0
17,307,307,45,45,0,1,0
32,335,335,1,1,0,1,0
6,343,343,17,1,16,2,1
19,345,345,78,56,22,2,1
25,357,357,227,89,138,4,3
28,383,383,13,3,10,3,2
21,384,384,27,1,26,2,1
5,405,405,55,37,18,4,3
0,409,409,23,23,0,1,0
2,425,425,7,7,0,1,0
23,429,429,6,6,0,1,0
33,429,429,17,8,9,4,3
31,430,430,43,43,0,1,0
14,435,435,28,22,6,2,1
12,459,459,49,49,0,1,0
13,496,496,50,13,37,2,1
9,496,496,15,9,6,3,2

29,106,106,22,22,0,1,0
15,112,112,7,4,3,2,1
21,112,112,12,12,0,1,0
5,113,113,8,2,6,3,2
20,136,136,1,1,0,1,0
33,137,137,15,8,7,2,1
8,137,137,2,2,0,1,0
1,147,147,9,1,8,3,2
10,183,183,1,1,0,1,0
11,187,187,20,8,12,4,3
19,241,241,19,19,0,1,0
7,254,254,4,1,3,2,1
16,257,257,32,32,0,1,0
4,263,263,39,39,0,1,0
26,293,293,12,12,0,1,0
9,295,295,33,13,20,3,2
18,297,297,18,18,0,1,0
25,301,301,12,12,0,1,0
32,304,304,4,4,0,1,0
24,307,307,104,104,0,1,0
14,319,319,17,8,9,2,1
30,325,325,4,1,3,2,1
28,327,327,71,71,0,1,0
13,349,349,2,2,0,1,0
3,358,358,19,19,0,1,0
27,372,372,9,2,7,3,2
22,408,408,22,22,0,1,0
12,452,452,64,52,12,4,3
6,487,487,72,37,35,2,1
2,489,489,60,51,9,2,1
0,490,490,224,152,72,4,3
31,492,492,97,11,86,3,2
17,493,493,109,109,0,1,0
23,500,500,3,3,0,1,0

7,107,107,6,6,0,1,0
21,117,117,1,1,0,1,0
29,123,123,36,36,0,1,0
9,127,127,10,6,4,2,1
23,133,133,28,20,8,2,1
2,134,134,26,15,11,2,1
13,140,140,18,14,4,2,1
5,147,147,21,6,15,4,3
16,159,159,39,39,0,1,0
32,173,173,13,13,0,1,0
14,220,220,26,26,0,1,0
8,246,246,32,32,0,1,0
1,257,257,16,3,13,2,1
26,273,273,2,2,0,1,0
10,283,283,29,29,0,1,0
28,292,292,34,26,8,3,2
27,307,307,72,72,0,1,0
11,318,318,40,40,0,1,0
22,325,325,3,3,0,1,0
6,331,331,20,5,15,2,1
25,331,331,9,1,8,2,1
12,333,333,29,29,0,1,0
0,377,377,24,9,15,2,1
3,388,388,11,2,9,4,3
4,388,388,44,7,37,2,1
31,396,396,2,2,0,1,0
17,413,413,70,39,31,2,1
30,452,452,12,4,8,3,2
24,455,455,10,10,0,1,0
18,458,458,57,57,0,1,0
20,460,460,1,1,0,1,0
15,465,465,97,50,47,4,3
19,468,468,76,76,0,1,0

11,110,110,31,31,0,1,0
17,114,114,3,3,0,1,0
2,132,132,5,5,0,1,0
20,139,139,19,12,7,2,1
15,145,145,3,3,0,1,0
27,151,151,26,26,0,1,0
24,182,182,5,5,0,1,0
13,203,203,11,3,8,2,1
5,208,208,9,9,0,1,0
23,236,236,31,28,3,2,1
14,251,251,40,40,0,1,0
7,274,274,53,53,0,1,0
10,311,311,77,77,0,1,0
6,313,313,62,16,46,4,3
9,321,321,12,2,10,2,1
0,321,321,8,8,0,1,0
21,391,391,63,9,54,4,3
18,415,415,44,9,35,2,1
8,416,416,47,15,32,3,2
16,424,424,47,47,0,1,0
28,434,434,24,24,0,1,0
3,441,441,21,11,10,3,2
29,443,443,152,113,39,4,3
1,448,448,8,8,0,1,0
12,454,454,100,48,52,3,2
19,473,473,75,75,0,1,0
22,473,473,18,18,0,1,0
25,474,474,14,14,0,1,0
4,477,477,114,6,108,4,3
26,491,491,3,3,0,1,0

27,104,104,1,1,0,1,0
2,122,122,11,5,6,3,2
23,130,130,29,29,0,1,0
0,141,141,8,8,0,1,0
13,151,151,7,7,0,1,0
38,160,160,16,16,0,1,0
9,172,172,2,2,0,1,0
34,185,185,2,2,0,1,0
36,190,190,13,1,12,2,1
19,205,205,10,10,0,1,0
25,207,207,108,15,93,4,3
16,207,207,12,12,0,1,0
11,208,208,44,44,0,1,0
39,231,231,2,2,0,1,0
14,232,232,8,2,6,2,1
21,236,236,1,1,0,1,0
4,239,239,20,20,0,1,0
6,254,254,12,3,9,4,3
31,255,255,12,2,10,2,1
37,276,276,11,4,7,2,1
18,276,276,1,1,0,1,0
10,319,319,27,10,17,3,2
5,323,323,2,2,0,1,0
12,333,333,140,66,74,3,2
1,340,340,27,12,15,4,3
33,357,357,34,34,0,1,0
8,365,365,2,2,0,1,0
7,375,375,2,2,0,1,0
24,379,379,52,6,46,3,2
22,381,381,23,6,17,2,1
28,382,382,8,8,0,1,0
17,389,389,11,8,3,2,1
29,398,398,24,6,18,4,3
20,407,407,4,1,3,2,1
32,407,407,21,21,0,1,0
30,409,409,70,70,0,1,0
3,426,426,60,60,0,1,0
26,444,444,71,41,30,3,2
15,478,478,78,78,0,1,0
35,490,490,1,1,0,1,0

0,105,105,2,2,0,1,0
32,118,118,5,1,4,2,1
4,125,125,4,1,3,2,1
14,126,126,7,7,0,1,0
12,128,128,3,3,0,1,0
20,137,137,1,1,0,1,0
23,144,144,44,7,37,3,2
6,151,151,4,1,3,2,1
39,153,153,5,5,0,1,0
37,174,174,61,61,0,1,0
34,199,199,3,3,0,1,0
2,222,222,19,3,16,4,3
28,229,229,2,2,0,1,0
18,233,233,22,16,6,2,1
16,234,234,1,1,0,1,0
19,235,235,28,4,24,3,2
33,237,237,5,2,3,2,1
7,238,238,13,13,0,1,0
40,242,242,1,1,0,1,0
11,252,252,2,2,0,1,0
3,253,253,2,2,0,1,0
31,267,267,6,6,0,1,0
22,279,279,18,18,0,1,0
9,289,289,8,1,7,2,1
1,306,306,9,2,7,2,1
24,312,312,61,61,0,1,0
29,321,321,30,4,26,2,1
10,326,326,2,2,0,1,0
38,336,336,33,3,30,4,3
15,339,339,50,50,0,1,0
13,354,354,69,21,48,4,3
36,364,364,103,85,18,2,1
30,366,366,12,7,5,2,1
35,370,370,1,1,0,1,0
8,371,371,1,1,0,1,0
41,372,372,91,91,0,1,0
17,379,379,51,51,0,1,0
27,387,387,81,5,76,4,3
26,388,388,44,44,0,1,0
5,404,404,22,22,0,1,0
21,452,452,1,1,0,1,0
25,471,471,76,63,13,2,1

8,102,102,1,1,0,1,0
1,106,106,44,16,28,3,2
24,136,136,4,4,0,1,0
25,157,157,4,1,3,2,1
3,177,177,1,1,0,1,0
16,194,194,18,10,8,3,2
12,229,229,46,46,0,1,0
20,255,255,2,2,0,1,0
23,256,256,88,88,0,1,0
10,259,259,54,54,0,1,0
14,278,278,12,2,10,3,2
29,284,284,18,18,0,1,0
7,296,296,35,35,0,1,0
6,310,310,14,14,0,1,0
0,323,323,5,2,3,2,1
5,325,325,46,33,13,2,1
13,326,326,10,4,6,3,2
17,329,329,35,35,0,1,0
26,353,353,89,89,0,1,0
19,366,366,105,6,99,4,3
11,368,368,68,37,31,2,1
4,369,369,16,7,9,4,3
9,389,389,6,6,0,1,0
28,400,400,68,50,18,2,1
18,422,422,25,25,0,1,0
15,439,439,13,10,3,2,1
2,440,440,132,99,33,4,3
27,441,441,4,1,3,2,1
22,457,457,51,30,21,4,3
21,464,464,30,12,18,4,3

31,100,100,7,7,0,1,0
36,100,100,36,36,0,1,0
4,101,101,2,2,0,1,0
25,116,116,19,19,0,1,0
21,136,136,6,6,0,1,0
26,158,158,14,14,0,1,0
35,172,172,10,4,6,3,2
29,191,191,33,33,0,1,0
32,195,195,54,54,0,1,0
12,211,211,53,32,21,4,3
2,211,211,12,4,8,2,1
0,223,223,37,4,33,2,1
22,239,239,2,2,0,1,0
27,245,245,3,3,0,1,0
16,250,250,17,17,0,1,0
8,264,264,28,28,0,1,0
14,270,270,25,7,18,4,3
5,272,272,42,8,34,2,1
30,296,296,34,1,33,4,3
28,307,307,5,5,0,1,0
7,311,311,67,19,48,3,2
33,329,329,69,29,40,2,1
13,339,339,12,12,0,1,0
20,340,340,11,11,0,1,0
19,376,376,23,23,0,1,0
24,379,379,40,40,0,1,0
6,388,388,5,1,4,2,1
18,393,393,2,2,0,1,0
1,394,394,39,39,0,1,0
15,400,400,70,70,0,1,0
34,401,401,2,2,0,1,0
23,416,416,1,1,0,1,0
11,453,453,22,22,0,1,0
3,455,455,16,16,0,1,0
10,465,465,6,6,0,1,0
9,490,490,25,25,0,1,0
17,499,499,17,8,9,2,1

30,145,145,10,10,0,1,0
28,152,152,9,9,0,1,0
33,155,155,56,28,28,3,2
26,158,158,31,17,14,2,1
0,173,173,29,2,27,2,1
17,182,182,18,4,14,2,1
25,186,186,7,7,0,1,0
7,193,193,23,18,5,2,1
29,196,196,9,2,7,2,1
6,216,216,25,25,0,1,0
35,220,220,41,11,30,2,1
9,229,229,2,2,0,1,0
1,244,244,19,4,15,4,3
22,256,256,5,5,0,1,0
21,266,266,2,2,0,1,0
32,274,274,8,5,3,2,1
18,290,290,23,2,21,4,3
12,307,307,9,5,4,2,1
4,324,324,35,35,0,1,0
11,328,328,67,48,19,2,1
16,340,340,15,15,0,1,0
3,348,348,51,51,0,1,0
20,349,349,89,43,46,4,3
19,353,353,11,6,5,2,1
14,359,359,41,41,0,1,0
15,371,371,56,16,40,2,1
5,380,380,1,1,0,1,0
31,383,383,14,14,0,1,0
10,395,395,24,5,19,2,1
24,430,430,32,32,0,1,0
27,441,441,50,50,0,1,0
34,452,452,5,2,3,2,1
23,458,458,94,58,36,2,1
13,478,478,22,22,0,1,0
8,485,485,4,1,3,2,1
2,491,491,59,59,0,1,0

24,100,100,16,16,0,1,0
12,112,112,6,6,0,1,0
9,135,135,15,15,0,1,0
32,138,138,9,9,0,1,0
2,149,149,6,2,4,2,1
22,165,165,12,9,3,2,1
15,184,184,38,14,24,4,3
8,196,196,13,5,8,2,1
27,204,204,2,2,0,1,0
0,211,211,2,2,0,1,0
31,212,212,10,10,0,1,0
26,224,224,70,70,0,1,0
13,226,226,26,2,24,2,1
30,226,226,27,9,18,3,2
17,229,229,35,35,0,1,0
1,241,241,59,59,0,1,0
18,244,244,8,8,0,1,0
21,249,249,19,4,15,2,1
5,251,251,8,8,0,1,0
23,282,282,2,2,0,1,0
19,289,289,53,53,0,1,0
10,299,299,83,78,5,2,1
7,305,305,6,6,0,1,0
25,306,306,9,1,8,2,1
14,320,320,23,23,0,1,0
20,352,352,19,13,6,3,2
16,365,365,81,81,0,1,0
3,376,376,50,50,0,1,0
6,390,390,23,23,0,1,0
11,438,438,28,21,7,2,1
29,478,478,60,29,31,2,1
4,482,482,95,95,0,1,0
28,499,499,35,35,0,1,0

22,102,102,15,15,0,1,0
11,121,121,12,12,0,1,0
38,124,124,13,13,0,1,0
35,129,129,8,8,0,1,0
13,131,131,32,8,24,3,2
14,157,157,32,32,0,1,0
24,174,174,19,19,0,1,0
6,186,186,4,1,3,2,1
16,193,193,5,5,0,1,0
41,195,195,30,6,24,4,3
2,196,196,7,4,3,2,1
31,207,207,32,32,0,1,0
5,233,233,22,11,11,2,1
33,236,236,2,2,0,1,0
21,254,254,5,5,0,1,0
20,257,257,14,14,0,1,0
8,274,274,4,4,0,1,0
37,278,278,49,49,0,1,0
43,282,282,27,3,24,3,2
28,282,282,107,79,28,3,2
10,285,285,26,26,0,1,0
4,286,286,13,2,11,2,1
23,296,296,1,1,0,1,0
34,301,301,44,44,0,1,0
19,304,304,11,11,0,1,0
12,306,306,33,33,0,1,0
42,317,317,6,6,0,1,0
30,328,328,19,10,9,4,3
39,340,340,19,1,18,4,3
25,342,342,14,14,0,1,0
27,348,348,30,30,0,1,0
3,348,348,1,1,0,1,0
36,350,350,19,19,0,1,0
40,385,385,40,22,18,2,1
0,392,392,16,16,0,1,0
17,405,405,6,3,3,2,1
7,409,409,46,46,0,1,0
1,451,451,15,15,0,1,0
9,470,470,21,9,12,2,1
18,472,472,5,5,0,1,0
15,476,476,4,4,0,1,0
32,478,478,36,36,0,1,0
29,483,483,2,2,0,1,0
26,490,490,19,10,9,3,2

17,126,126,10,7,3,2,1
3,152,152,10,10,0,1,0
0,153,153,9,9,0,1,0
25,169,169,17,10,7,2,1
10,172,172,40,40,0,1,0
22,186,186,4,4,0,1,0
1,191,191,2,2,0,1,0
29,194,194,23,23,0,1,0
16,209,209,11,3,8,2,1
19,216,216,5,5,0,1,0
30,227,227,22,22,0,1,0
21,249,249,102,58,44,2,1
31,250,250,2,2,0,1,0
18,256,256,9,9,0,1,0
20,282,282,15,15,0,1,0
12,284,284,6,6,0,1,0
24,284,284,24,24,0,1,0
4,289,289,57,19,38,2,1
14,308,308,9,1,8,3,2
23,311,311,68,68,0,1,0
8,337,337,104,104,0,1,0
26,371,371,23,23,0,1,0
15,395,395,3,3,0,1,0
2,426,426,1,1,0,1,0
6,435,435,2,2,0,1,0
7,445,445,50,50,0,1,0
5,445,445,200,173,27,3,2
33,447,447,5,1,4,2,1
9,459,459,24,24,0,1,0
28,466,466,87,33,54,3,2
27,471,471,79,79,0,1,0
32,495,495,29,29,0,1,0
13,496,496,2,2,0,1,0
11,498,498,46,46,0,1,0

24,110,110,9,9,0,1,0
6,126,126,11,11,0,1,0
16,143,143,1,1,0,1,0
32,147,147,7,1,6,3,2
34,148,148,1,1,0,1,0
36,170,170,17,11,6,2,1
4,191,191,33,33,0,1,0
9,199,199,50,30,20,2,1
13,207,207,5,5,0,1,0
18,208,208,11,11,0,1,0
20,231,231,1,1,0,1,0
35,233,233,40,40,0,1,0
33,233,233,5,5,0,1,0
27,235,235,68,37,31,3,2
2,240,240,4,4,0,1,0
28,264,264,1,1,0,1,0
21,272,272,22,22,0,1,0
8,275,275,18,18,0,1,0
10,283,283,53,7,46,2,1
19,285,285,6,6,0,1,0
29,288,288,43,43,0,1,0
15,290,290,33,33,0,1,0
12,294,294,1,1,0,1,0
30,300,300,49,13,36,4,3
5,317,317,9,9,0,1,0
11,338,338,28,28,0,1,0
31,343,343,29,7,22,3,2
26,344,344,59,59,0,1,0
0,387,387,24,24,0,1,0
1,422,422,27,27,0,1,0
7,424,424,36,8,28,2,1
22,431,431,18,11,7,2,1
3,454,454,11,11,0,1,0
23,458,458,143,47,96,4,3
25,473,473,1,1,0,1,0
14,473,473,153,137,16,2,1
17,492,492,14,5,9,2,1

33,102,102,6,2,4,2,1
13,117,117,8,8,0,1,0
26,136,136,10,10,0,1,0
2,138,138,9,9,0,1,0
9,141,141,1,1,0,1,0
29,172,172,14,8,6,2,1
34,175,175,10,7,3,2,1
5,177,177,10,10,0,1,0
17,180,180,27,27,0,1,0
27,192,192,11,2,9,2,1
1,226,226,20,20,0,1,0
15,238,238,1,1,0,1,0
28,241,241,27,27,0,1,0
19,249,249,7,7,0,1,0
12,250,250,1,1,0,1,0
8,250,250,11,11,0,1,0
37,258,258,25,25,0,1,0
21,260,260,11,11,0,1,0
7,275,275,61,61,0,1,0
25,289,289,5,2,3,2,1
32,290,290,27,27,0,1,0
4,295,295,16,6,10,3,2
23,302,302,68,68,0,1,0
3,316,316,11,11,0,1,0
10,323,323,31,31,0,1,0
0,380,380,37,37,0,1,0
16,393,393,107,69,38,2,1
22,400,400,22,22,0,1,0
39,419,419,60,24,36,4,3
24,424,424,9,3,6,2,1
38,428,428,22,17,5,2,1
14,430,430,19,19,0,1,0
30,433,433,163,163,0,1,0
36,433,433,17,3,14,3,2
20,436,436,8,8,0,1,0
11,465,465,67,40,27,4,3
18,475,475,1,1,0,1,0
35,486,486,35,35,0,1,0
31,494,494,78,78,0,1,0
6,495,495,51,51,0,1,0

0,105,105,2,2,0,1,0
15,110,110,1,1,0,1,0
1,117,117,5,5,0,1,0
3,120,120,15,15,0,1,0
25,162,162,9,9,0,1,0
21,178,178,28,28,0,1,0
7,185,185,71,17,54,3,2
2,201,201,55,55,0,1,0
26,279,279,22,2,20,3,2
10,292,292,3,3,0,1,0
23,294,294,1,1,0,1,0
13,301,301,118,46,72,4,3
17,305,305,31,31,0,1,0
18,319,319,17,17,0,1,0
16,321,321,10,5,5,2,1
9,331,331,8,1,7,3,2
22,332,332,76,76,0,1,0
4,341,341,26,8,18,3,2
14,352,352,16,16,0,1,0
5,383,383,46,46,0,1,0
12,384,384,53,13,40,3,2
24,385,385,31,31,0,1,0
29,386,386,65,41,24,3,2
6,423,423,68,68,0,1,0
28,433,433,4,4,0,1,0
8,449,449,1,1,0,1,0
20,468,468,83,83,0,1,0
19,494,494,4,4,0,1,0
11,495,495,161,161,0,1,0
27,500,500,65,65,0,1,0

22,110,110,1,1,0,1,0
27,124,124,5,5,0,1,0
32,138,138,3,3,0,1,0
20,148,148,26,4,22,2,1
5,158,158,6,6,0,1,0
4,163,163,3,3,0,1,0
11,177,177,20,15,5,2,1
31,190,190,25,25,0,1,0
29,192,192,5,5,0,1,0
8,198,198,2,2,0,1,0
13,206,206,30,13,17,2,1
2,213,213,1,1,0,1,0
12,219,219,4,4,0,1,0
17,221,221,35,35,0,1,0
21,233,233,39,4,35,3,2
33,243,243,89,74,15,4,3
6,256,256,5,5,0,1,0
25,264,264,3,3,0,1,0
9,293,293,113,59,54,3,2
1,297,297,19,19,0,1,0
7,325,325,76,69,7,2,1
3,328,328,17,8,9,4,3
28,328,328,28,10,18,3,2
0,363,363,5,1,4,2,1
19,393,393,26,26,0,1,0
10,415,415,148,100,48,4,3
14,426,426,11,11,0,1,0
15,435,435,61,61,0,1,0
16,436,436,27,2,25,2,1
24,441,441,3,3,0,1,0
18,443,443,12,12,0,1,0
30,447,447,105,55,50,2,1
26,449,449,49,8,41,2,1
23,474,474,48,1,47,2,1

32,134,134,18,18,0,1,0
12,135,135,4,4,0,1,0
28,147,147,3,3,0,1,0
7,169,169,17,17,0,1,0
20,183,183,31,31,0,1,0
27,186,186,36,15,21,4,3
4,228,228,14,14,0,1,0
22,238,238,16,16,0,1,0
31,260,260,13,1,12,3,2
11,311,311,8,8,0,1,0
6,316,316,20,5,15,4,3
2,327,327,1,1,0,1,0
21,343,343,67,21,46,3,2
17,362,362,65,11,54,4,3
5,386,386,66,63,3,2,1
30,388,388,26,14,12,2,1
16,389,389,17,12,5,2,1
26,389,389,88,88,0,1,0
18,391,391,28,28,0,1,0
25,392,392,27,27,0,1,0
13,399,399,115,52,63,4,3
19,400,400,52,37,15,2,1
0,402,402,15,15,0,1,0
23,405,405,11,4,7,2,1
9,411,411,55,55,0,1,0
15,419,419,173,144,29,2,1
24,441,441,19,19,0,1,0
8,466,466,80,2,78,3,2
1,466,466,22,22,0,1,0
14,482,482,51,15,36,3,2
3,482,482,1,1,0,1,0
29,485,485,20,20,0,1,0
10,489,489,23,7,16,3,2

31,104,104,31,31,0,1,0
11,106,106,11,2,9,4,3
35,108,108,1,1,0,1,0
4,110,110,7,7,0,1,0
1,117,117,12,3,9,4,3
27,129,129,18,18,0,1,0
26,140,140,18,2,16,3,2
29,147,147,4,1,3,2,1
13,154,154,8,2,6,2,1
6,167,167,26,26,0,1,0
34,182,182,26,2,24,3,2
12,190,190,16,1,15,2,1
20,196,196,24,24,0,1,0
30,197,197,2,2,0,1,0
16,222,222,6,6,0,1,0
32,228,228,5,1,4,2,1
24,254,254,30,30,0,1,0
37,257,257,71,25,46,3,2
0,266,266,23,23,0,1,0
3,272,272,12,9,3,2,1
23,282,282,29,29,0,1,0
21,309,309,69,55,14,3,2
25,321,321,26,7,19,2,1
33,321,321,10,10,0,1,0
19,335,335,24,14,10,2,1
8,356,356,20,20,0,1,0
10,367,367,29,29,0,1,0
5,372,372,3,3,0,1,0
9,394,394,1,1,0,1,0
22,412,412,1,1,0,1,0
2,412,412,6,6,0,1,0
14,437,437,16,16,0,1,0
7,455,455,40,40,0,1,0
28,463,463,35,18,17,2,1
17,463,463,117,32,85,3,2
18,480,480,69,39,30,2,1
15,485,485,52,52,0,1,0
36,496,496,31,14,17,2,1

6,101,101,9,9,0,1,0
3,127,127,14,14,0,1,0
14,127,127,16,16,0,1,0
36,149,149,47,47,0,1,0
19,158,158,2,2,0,1,0
20,167,167,15,6,9,2,1
15,167,167,5,5,0,1,0
25,175,175,26,15,11,4,3
17,180,180,1,1,0,1,0
4,192,192,35,27,8,2,1
1,200,200,11,5,6,2,1
30,219,219,26,6,20,2,1
13,227,227,8,8,0,1,0
29,238,238,3,3,0,1,0
5,240,240,10,10,0,1,0
33,253,253,1,1,0,1,0
2,267,267,7,7,0,1,0
28,274,274,93,5,88,3,2
23,281,281,1,1,0,1,0
22,283,283,78,20,58,4,3
11,294,294,90,90,0,1,0
16,294,294,15,15,0,1,0
8,324,324,3,3,0,1,0
9,327,327,1,1,0,1,0
35,332,332,39,39,0,1,0
12,346,346,80,46,34,3,2
26,351,351,23,23,0,1,0
0,360,360,51,21,30,3,2
7,394,394,40,40,0,1,0
10,395,395,57,57,0,1,0
18,404,404,1,1,0,1,0
31,429,429,10,10,0,1,0
27,438,438,20,20,0,1,0
32,443,443,22,1,21,2,1
21,481,481,3,3,0,1,0
24,483,483,4,1,3,2,1
34,483,483,53,14,39,4,3

36,121,121,9,9,0,1,0
15,136,136,11,11,0,1,0
32,143,143,5,1,4,2,1
8,175,175,6,2,4,2,1
23,176,176,30,3,27,2,1
3,183,183,4,1,3,2,1
21,201,201,11,7,4,2,1
28,211,211,36,36,0,1,0
7,229,229,22,4,18,4,3
14,248,248,4,4,0,1,0
6,251,251,1,1,0,1,0
11,252,252,6,6,0,1,0
12,282,282,41,41,0,1,0
34,282,282,29,29,0,1,0
24,294,294,52,52,0,1,0
5,309,309,21,15,6,3,2
10,314,314,12,1,11,2,1
19,321,321,7,1,6,3,2
22,335,335,36,36,0,1,0
27,338,338,29,14,15,2,1
26,345,345,38,28,10,2,1
37,358,358,27,27,0,1,0
29,363,363,24,24,0,1,0
4,375,375,51,51,0,1,0
33,376,376,51,51,0,1,0
20,389,389,50,30,20,2,1
16,390,390,94,94,0,1,0
35,391,391,5,5,0,1,0
25,393,393,61,18,43,2,1
9,408,408,2,2,0,1,0
38,417,417,34,6,28,2,1
2,420,420,68,32,36,3,2
30,430,430,22,22,0,1,0
0,435,435,12,12,0,1,0
1,442,442,38,26,12,2,1
17,448,448,109,85,24,4,3
13,457,457,22,9,13,2,1
18,459,459,9,2,7,2,1
31,461,461,53,16,37,2,1

4,103,103,3,3,0,1,0
26,104,104,2,2,0,1,0
10,110,110,6,6,0,1,0
28,114,114,8,8,0,1,0
29,116,116,20,13,7,2,1
11,132,132,1,1,0,1,0
27,135,135,17,17,0,1,0
9,147,147,1,1,0,1,0
17,151,151,36,36,0,1,0
0,198,198,9,9,0,1,0
33,209,209,9,9,0,1,0
36,215,215,40,16,24,4,3
31,216,216,1,1,0,1,0
30,238,238,14,14,0,1,0
21,240,240,20,4,16,3,2
32,256,256,53,53,0,1,0
1,263,263,2,2,0,1,0
25,272,272,13,13,0,1,0
8,277,277,13,8,5,2,1
5,279,279,1,1,0,1,0
19,286,286,11,11,0,1,0
35,322,322,13,13,0,1,0
37,326,326,10,4,6,2,1
13,333,333,51,40,11,2,1
23,336,336,132,132,0,1,0
20,352,352,20,1,19,4,3
14,356,356,15,15,0,1,0
7,363,363,6,6,0,1,0
12,369,369,43,43,0,1,0
15,370,370,3,3,0,1,0
16,402,402,49,49,0,1,0
24,414,414,23,23,0,1,0
6,416,416,24,1,23,2,1
3,445,445,44,22,22,2,1
18,451,451,65,19,46,4,3
22,466,466,2,2,0,1,0
34,469,469,76,76,0,1,0
38,473,473,55,55,0,1,0
2,479,479,156,44,112,4,3

33,103,103,4,4,0,1,0
32,127,127,4,4,0,1,0
5,140,140,6,2,4,2,1
11,149,149,1,1,0,1,0
29,154,154,13,1,12,3,2
34,178,178,12,4,8,3,2
19,189,189,22,7,15,3,2
24,190,190,17,17,0,1,0
17,196,196,37,37,0,1,0
18,216,216,21,13,8,3,2
6,222,222,9,6,3,2,1
20,228,228,31,22,9,2,1
25,251,251,45,45,0,1,0
27,270,270,15,5,10,2,1
12,270,270,22,22,0,1,0
10,273,273,25,25,0,1,0
3,289,289,13,3,10,2,1
13,291,291,14,10,4,2,1
16,291,291,18,11,7,2,1
1,314,314,2,2,0,1,0
22,329,329,23,15,8,2,1
35,337,337,12,2,10,2,1
21,343,343,2,2,0,1,0
2,358,358,1,1,0,1,0
7,359,359,21,21,0,1,0
23,371,371,129,129,0,1,0
31,389,389,17,7,10,3,2
36,392,392,17,17,0,1,0
9,394,394,15,6,9,2,1
14,401,401,62,62,0,1,0
28,431,431,54,54,0,1,0
4,434,434,157,79,78,3,2
26,441,441,21,21,0,1,0
30,454,454,153,57,96,4,3
8,464,464,103,31,72,4,3
0,496,496,12,12,0,1,0
15,500,500,8,8,0,1,0

13,106,106,10,10,0,1,0
22,109,109,7,7,0,1,0
17,158,158,19,1,18,4,3
8,180,180,5,5,0,1,0
26,199,199,39,16,23,2,1
24,204,204,16,13,3,2,1
11,212,212,5,1,4,2,1
0,215,215,3,3,0,1,0
19,229,229,21,21,0,1,0
6,241,241,7,1,6,2,1
20,241,241,1,1,0,1,0
1,258,258,47,31,16,2,1
7,264,264,38,38,0,1,0
21,279,279,7,7,0,1,0
14,282,282,3,3,0,1,0
25,286,286,138,99,39,4,3
4,306,306,174,36,138,4,3
23,317,317,8,8,0,1,0
28,363,363,14,14,0,1,0
29,364,364,16,16,0,1,0
2,367,367,29,14,15,4,3
15,382,382,64,39,25,2,1
9,389,389,38,11,27,4,3
18,399,399,38,38,0,1,0
16,420,420,31,31,0,1,0
10,425,425,63,45,18,4,3
27,441,441,53,24,29,2,1
3,453,453,55,55,0,1,0
12,461,461,78,59,19,2,1
5,462,462,45,45,0,1,0

27,110,110,2,2,0,1,0
10,122,122,1,1,0,1,0
21,156,156,1,1,0,1,0
19,173,173,6,3,3,2,1
33,201,201,17,17,0,1,0
3,205,205,38,22,16,2,1
29,206,206,4,4,0,1,0
30,221,221,75,1,74,3,2
31,222,222,13,6,7,2,1
9,224,224,9,9,0,1,0
8,233,233,8,8,0,1,0
15,237,237,13,13,0,1,0
5,249,249,72,72,0,1,0
28,262,262,46,46,0,1,0
14,269,269,1,1,0,1,0
22,288,288,6,6,0,1,0
34,288,288,62,62,0,1,0
24,296,296,47,15,32,2,1
26,304,304,1,1,0,1,0
6,307,307,7,7,0,1,0
4,347,347,56,10,46,3,2
13,353,353,21,21,0,1,0
32,356,356,57,41,16,4,3
20,370,370,39,17,22,3,2
18,383,383,11,3,8,3,2
11,384,384,37,37,0,1,0
1,388,388,28,7,21,4,3
35,397,397,53,53,0,1,0
12,404,404,95,11,84,4,3
25,426,426,84,53,31,2,1
2,457,457,38,38,0,1,0
0,469,469,15,15,0,1,0
16,470,470,26,12,14,2,1
7,477,477,108,74,34,3,2
17,479,479,6,2,4,2,1
23,481,481,4,4,0,1,0

27,115,115,3,3,0,1,0
19,122,122,30,30,0,1,0
34,145,145,49,22,27,2,1
4,149,149,1,1,0,1,0
26,154,154,10,10,0,1,0
35,160,160,63,63,0,1,0
17,167,167,7,2,5,2,1
2,180,180,7,7,0,1,0
7,206,206,45,31,14,3,2
15,222,222,2,2,0,1,0
16,232,232,15,15,0,1,0
11,246,246,6,6,0,1,0
24,268,268,2,2,0,1,0
36,277,277,12,12,0,1,0
18,285,285,56,44,12,2,1
22,289,289,37,5,32,3,2
23,306,306,3,3,0,1,0
29,318,318,23,23,0,1,0
1,322,322,1,1,0,1,0
21,323,323,5,5,0,1,0
28,330,330,18,12,6,2,1
8,332,332,17,17,0,1,0
37,344,344,18,5,13,2,1
25,388,388,59,59,0,1,0
13,392,392,1,1,0,1,0
0,397,397,17,17,0,1,0
9,400,400,28,28,0,1,0
30,406,406,64,33,31,2,1
3,419,419,115,115,0,1,0
14,431,431,16,16,0,1,0
32,433,433,43,25,18,3,2
20,436,436,1,1,0,1,0
12,449,449,32,2,30,4,3
33,451,451,27,27,0,1,0
10,452,452,4,4,0,1,0
38,462,462,7,7,0,1,0
5,490,490,128,128,0,1,0
31,492,492,25,7,18,4,3
6,495,495,7,7,0,1,0

3,100,100,5,5,0,1,0
13,102,102,33,33,0,1,0
0,112,112,5,2,3,2,1
17,112,112,5,2,3,2,1
19,121,121,10,7,3,2,1
6,122,122,1,1,0,1,0
4,130,130,1,1,0,1,0
12,133,133,42,42,0,1,0
18,159,159,3,3,0,1,0
31,164,164,59,41,18,3,2
9,177,177,40,40,0,1,0
26,179,179,19,19,0,1,0
28,190,190,21,4,17,2,1
20,224,224,5,5,0,1,0
29,228,228,32,3,29,2,1
7,253,253,7,7,0,1,0
25,271,271,37,37,0,1,0
5,279,279,1,1,0,1,0
2,287,287,10,10,0,1,0
21,301,301,28,2,26,4,3
24,335,335,68,68,0,1,0
22,338,338,36,4,32,2,1
15,356,356,32,20,12,2,1
8,396,396,133,126,7,2,1
14,408,408,2,2,0,1,0
1,416,416,2,2,0,1,0
10,441,441,23,23,0,1,0
27,443,443,23,23,0,1,0
11,473,473,81,81,0,1,0
23,476,476,9,9,0,1,0
16,490,490,99,26,73,4,3
32,493,493,10,10,0,1,0
30,497,497,12,12,0,1,0

3,112,112,20,20,0,1,0
14,129,129,26,16,10,3,2
7,133,133,2,2,0,1,0
18,136,136,7,7,0,1,0
21,137,137,11,7,4,2,1
5,144,144,6,1,5,2,1
4,150,150,10,10,0,1,0
30,159,159,10,10,0,1,0
17,165,165,2,2,0,1,0
26,179,179,39,11,28,3,2
6,191,191,2,2,0,1,0
25,216,216,2,2,0,1,0
27,225,225,59,45,14,3,2
24,231,231,19,19,0,1,0
31,235,235,64,64,0,1,0
0,280,280,28,28,0,1,0
9,281,281,14,14,0,1,0
19,288,288,11,11,0,1,0
10,292,292,30,30,0,1,0
29,304,304,17,1,16,4,3
2,314,314,61,61,0,1,0
32,318,318,29,29,0,1,0
16,321,321,84,67,17,2,1
22,322,322,37,37,0,1,0
23,363,363,17,10,7,2,1
13,397,397,69,21,48,2,1
8,421,421,10,10,0,1,0
28,435,435,18,18,0,1,0
1,436,436,9,9,0,1,0
12,461,461,61,61,0,1,0
20,484,484,15,15,0,1,0
15,487,487,28,28,0,1,0
11,496,496,165,111,54,4,3

4,103,103,5,5,0,1,0
24,116,116,9,9,0,1,0
15,117,117,12,12,0,1,0
27,128,128,11,11,0,1,0
21,132,132,13,1,12,4,3
1,152,152,9,1,8,3,2
9,173,173,8,8,0,1,0
13,180,180,13,13,0,1,0
23,181,181,1,1,0,1,0
28,214,214,41,27,14,2,1
18,214,214,41,41,0,1,0
6,217,217,19,5,14,3,2
20,222,222,60,60,0,1,0
29,224,224,19,19,0,1,0
8,240,240,24,24,0,1,0
12,257,257,30,18,12,3,2
14,263,263,2,2,0,1,0
16,296,296,85,73,12,4,3
2,327,327,84,16,68,3,2
30,336,336,39,39,0,1,0
22,363,363,46,10,36,2,1
32,365,365,32,3,29,2,1
3,378,378,64,52,12,3,2
17,382,382,18,18,0,1,0
19,386,386,4,4,0,1,0
10,393,393,82,26,56,3,2
33,394,394,79,40,39,4,3
0,404,404,30,8,22,3,2
5,435,435,3,3,0,1,0
25,438,438,8,8,0,1,0
7,455,455,19,19,0,1,0
31,465,465,34,34,0,1,0
26,466,466,23,23,0,1,0
11,493,493,8,8,0,1,0

35,106,106,6,6,0,1,0
27,124,124,2,2,0,1,0
24,127,127,4,4,0,1,0
12,128,128,33,33,0,1,0
28,138,138,6,6,0,1,0
22,152,152,7,7,0,1,0
8,157,157,1,1,0,1,0
7,160,160,1,1,0,1,0
37,222,222,4,4,0,1,0
29,240,240,8,8,0,1,0
14,243,243,12,12,0,1,0
23,272,272,30,30,0,1,0
30,273,273,11,11,0,1,0
15,280,280,6,6,0,1,0
9,289,289,30,30,0,1,0
1,309,309,3,3,0,1,0
17,312,312,69,36,33,4,3
19,313,313,78,52,26,2,1
32,317,317,16,4,12,3,2
34,332,332,32,2,30,4,3
38,335,335,266,266,0,1,0
16,340,340,23,5,18,4,3
13,355,355,5,5,0,1,0
39,356,356,15,15,0,1,0
36,362,362,3,3,0,1,0
20,380,380,20,8,12,4,3
11,410,410,2,2,0,1,0
31,421,421,98,80,18,4,3
0,432,432,15,1,14,2,1
10,434,434,69,69,0,1,0
26,441,441,22,22,0,1,0
33,446,446,33,17,16,2,1
2,448,448,1,1,0,1,0
5,476,476,23,3,20,3,2
21,482,482,11,11,0,1,0
18,485,485,42,11,31,2,1
6,488,488,81,50,31,4,3
4,490,490,15,8,7,2,1
25,495,495,20,15,5,2,1
3,496,496,21,8,13,4,3

17,122,122,11,11,0,1,0
25,122,122,34,3,31,2,1
24,171,171,1,1,0,1,0
31,172,172,3,3,0,1,0
9,175,175,12,2,10,2,1
22,193,193,19,19,0,1,0
32,200,200,14,2,12,3,2
19,210,210,14,14,0,1,0
7,229,229,7,4,3,2,1
0,235,235,57,57,0,1,0
16,238,238,53,19,34,3,2
15,251,251,1,1,0,1,0
21,286,286,3,3,0,1,0
2,302,302,45,16,29,2,1
6,303,303,15,15,0,1,0
11,309,309,6,6,0,1,0
33,325,325,7,7,0,1,0
29,329,329,42,5,37,2,1
23,348,348,97,97,0,1,0
5,351,351,93,93,0,1,0
8,363,363,12,12,0,1,0
3,371,371,11,1,10,3,2
4,375,375,21,8,13,2,1
18,376,376,53,53,0,1,0
13,379,379,30,30,0,1,0
30,380,380,48,48,0,1,0
27,387,387,48,48,0,1,0
1,394,394,1,1,0,1,0
10,430,430,92,20,72,3,2
14,442,442,1,1,0,1,0
26,445,445,6,6,0,1,0
28,447,447,14,14,0,1,0
12,468,468,110,59,51,4,3
20,474,474,112,45,67,4,3

7,110,110,1,1,0,1,0
10,115,115,3,3,0,1,0
4,118,118,1,1,0,1,0
31,123,123,19,19,0,1,0
11,136,136,8,5,3,2,1
20,166,166,1,1,0,1,0
18,181,181,12,12,0,1,0
24,193,193,24,24,0,1,0
30,215,215,61,16,45,3,2
27,233,233,19,19,0,1,0
15,254,254,1,1,0,1,0
29,267,267,4,4,0,1,0
0,271,271,60,19,41,3,2
23,282,282,11,11,0,1,0
19,297,297,14,14,0,1,0
2,311,311,20,20,0,1,0
3,321,321,31,31,0,1,0
17,338,338,20,20,0,1,0
1,338,338,52,52,0,1,0
21,348,348,7,7,0,1,0
28,370,370,21,11,10,3,2
25,376,376,85,85,0,1,0
12,391,391,15,15,0,1,0
22,395,395,98,85,13,2,1
33,416,416,77,77,0,1,0
16,423,423,20,11,9,2,1
32,428,428,18,5,13,2,1
6,429,429,25,25,0,1,0
13,431,431,81,81,0,1,0
5,449,449,171,70,101,4,3
26,475,475,41,22,19,2,1
8,488,488,119,47,72,4,3
9,495,495,1,1,0,1,0
14,497,497,50,50,0,1,0

26,101,101,2,2,0,1,0
9,112,112,1,1,0,1,0
6,120,120,35,32,3,2,1
27,124,124,26,8,18,4,3
22,132,132,12,12,0,1,0
24,167,167,20,14,6,2,1
11,191,191,9,9,0,1,0
17,200,200,17,17,0,1,0
2,206,206,14,14,0,1,0
0,209,209,48,38,10,2,1
14,218,218,4,4,0,1,0
28,221,221,8,8,0,1,0
32,323,323,8,8,0,1,0
7,325,325,64,64,0,1,0
23,358,358,34,18,16,2,1
30,360,360,110,60,50,2,1
8,375,375,40,40,0,1,0
13,375,375,9,9,0,1,0
25,388,388,11,2,9,2,1
20,388,388,48,48,0,1,0
29,391,391,39,39,0,1,0
34,396,396,20,13,7,2,1
33,402,402,141,69,72,4,3
35,417,417,24,24,0,1,0
31,435,435,21,2,19,4,3
21,441,441,27,27,0,1,0
12,446,446,1,1,0,1,0
19,452,452,6,3,3,2,1
18,459,459,85,41,44,2,1
10,472,472,18,18,0,1,0
16,473,473,52,27,25,2,1
3,474,474,12,12,0,1,0
15,476,476,30,30,0,1,0
1,490,490,18,18,0,1,0
4,494,494,1,1,0,1,0
5,498,498,81,81,0,1,0

11,108,108,2,2,0,1,0
20,116,116,5,5,0,1,0
0,117,117,6,6,0,1,0
7,128,128,13,7,6,2,1
36,134,134,1,1,0,1,0
25,155,155,40,9,31,4,3
21,155,155,51,51,0,1,0
4,168,168,8,8,0,1,0
2,177,177,14,2,12,4,3
28,189,189,7,7,0,1,0
16,190,190,2,2,0,1,0
5,191,191,7,1,6,3,2
10,215,215,1,1,0,1,0
8,228,228,1,1,0,1,0
23,231,231,22,22,0,1,0
17,237,237,39,39,0,1,0
3,242,242,50,50,0,1,0
14,259,259,27,27,0,1,0
34,265,265,44,2,42,2,1
6,265,265,67,67,0,1,0
13,282,282,1,1,0,1,0
12,295,295,5,5,0,1,0
18,333,333,34,34,0,1,0
32,335,335,35,35,0,1,0
22,356,356,27,3,24,3,2
9,359,359,6,2,4,2,1
30,365,365,32,11,21,2,1
26,382,382,18,18,0,1,0
31,405,405,30,30,0,1,0
19,407,407,103,3,100,4,3
35,410,410,27,27,0,1,0
29,431,431,12,8,4,2,1
33,438,438,50,22,28,3,2
1,442,442,32,12,20,2,1
24,474,474,72,27,45,4,3
15,482,482,74,28,46,3,2
27,484,484,27,27,0,1,0

30,127,127,1,1,0,1,0
36,138,138,14,14,0,1,0
18,158,158,2,2,0,1,0
14,161,161,8,8,0,1,0
4,165,165,15,15,0,1,0
24,173,173,17,17,0,1,0
25,180,180,15,15,0,1,0
23,180,180,36,36,0,1,0
17,183,183,7,1,6,2,1
7,189,189,6,6,0,1,0
12,217,217,3,3,0,1,0
19,233,233,20,20,0,1,0
34,235,235,35,20,15,4,3
1,251,251,15,15,0,1,0
27,252,252,28,13,15,2,1
35,260,260,1,1,0,1,0
5,265,265,12,2,10,3,2
6,276,276,92,44,48,3,2
13,280,280,67,9,58,3,2
0,281,281,25,3,22,2,1
29,296,296,42,10,32,3,2
21,303,303,14,6,8,3,2
31,334,334,1,1,0,1,0
9,339,339,10,10,0,1,0
26,344,344,35,35,0,1,0
8,350,350,50,50,0,1,0
11,351,351,56,56,0,1,0
22,357,357,11,11,0,1,0
2,363,363,6,6,0,1,0
3,401,401,21,8,13,3,2
15,418,418,16,16,0,1,0
20,420,420,34,34,0,1,0
10,431,431,19,3,16,3,2
32,439,439,78,38,40,3,2
28,449,449,112,18,94,3,2
16,452,452,59,59,0,1,0
33,485,485,70,20,50,2,1

13,101,101,1,1,0,1,0
29,115,115,7,7,0,1,0
0,122,122,8,8,0,1,0
7,143,143,1,1,0,1,0
34,158,158,2,2,0,1,0
31,167,167,2,2,0,1,0
5,169,169,1,1,0,1,0
18,207,207,95,52,43,4,3
12,223,223,57,57,0,1,0
25,228,228,32,14,18,2,1
6,229,229,29,14,15,4,3
15,252,252,5,2,3,2,1
4,258,258,1,1,0,1,0
20,261,261,47,26,21,4,3
11,263,263,7,2,5,2,1
33,268,268,52,34,18,2,1
9,273,273,12,12,0,1,0
32,311,311,45,15,30,3,2
1,320,320,1,1,0,1,0
26,327,327,22,22,0,1,0
23,353,353,51,51,0,1,0
30,374,374,74,14,60,3,2
17,390,390,50,14,36,4,3
21,401,401,7,7,0,1,0
3,413,413,75,67,8,2,1
27,414,414,27,4,23,3,2
10,427,427,48,28,20,3,2
22,430,430,21,3,18,4,3
2,431,431,2,2,0,1,0
16,450,450,5,1,4,2,1
28,455,455,29,13,16,3,2
19,456,456,99,63,36,4,3
24,467,467,8,8,0,1,0
14,484,484,104,80,24,3,2
35,485,485,67,67,0,1,0
8,499,499,11,11,0,1,0

12,114,114,16,16,0,1,0
2,126,126,4,1,3,2,1
18,146,146,32,2,30,4,3
6,156,156,2,2,0,1,0
19,159,159,10,10,0,1,0
15,167,167,2,2,0,1,0
27,177,177,30,1,29,2,1
17,181,181,2,2,0,1,0
4,192,192,15,15,0,1,0
14,200,200,55,23,32,2,1
3,205,205,33,1,32,3,2
0,207,207,8,8,0,1,0
8,208,208,4,4,0,1,0
28,209,209,9,9,0,1,0
21,245,245,20,10,10,3,2
26,247,247,1,1,0,1,0
36,250,250,13,1,12,3,2
24,262,262,21,17,4,2,1
10,286,286,51,51,0,1,0
23,308,308,11,11,0,1,0
29,324,324,8,8,0,1,0
35,324,324,71,71,0,1,0
34,339,339,46,46,0,1,0
13,341,341,27,27,0,1,0
38,342,342,80,14,66,3,2
22,359,359,32,17,15,4,3
9,364,364,28,2,26,2,1
25,385,385,57,35,22,2,1
1,392,392,1,1,0,1,0
31,405,405,40,30,10,2,1
32,405,405,37,37,0,1,0
16,406,406,6,2,4,2,1
20,443,443,25,13,12,4,3
33,466,466,77,5,72,3,2
30,476,476,28,20,8,2,1
37,480,480,35,35,0,1,0
5,481,481,47,1,46,3,2
7,483,483,23,23,0,1,0
11,499,499,3,3,0,1,0

29,103,103,2,2,0,1,0
21,120,120,1,1,0,1,0
7,121,121,10,10,0,1,0
36,137,137,23,23,0,1,0
10,145,145,8,2,6,2,1
38,151,151,14,6,8,2,1
0,156,156,1,1,0,1,0
5,172,172,4,4,0,1,0
24,184,184,62,62,0,1,0
40,188,188,11,11,0,1,0
11,191,191,9,6,3,2,1
8,194,194,50,50,0,1,0
26,202,202,6,6,0,1,0
30,210,210,4,4,0,1,0
17,217,217,32,32,0,1,0
32,217,217,31,31,0,1,0
27,223,223,12,12,0,1,0
28,230,230,34,34,0,1,0
18,244,244,1,1,0,1,0
2,261,261,32,32,0,1,0
4,264,264,21,21,0,1,0
9,280,280,10,6,4,2,1
14,287,287,40,40,0,1,0
34,300,300,35,2,33,4,3
25,321,321,25,2,23,4,3
13,328,328,28,28,0,1,0
39,332,332,3,3,0,1,0
33,388,388,33,21,12,2,1
12,390,390,35,8,27,4,3
22,397,397,8,8,0,1,0
3,411,411,13,13,0,1,0
6,416,416,9,9,0,1,0
1,424,424,92,92,0,1,0
23,430,430,17,17,0,1,0
31,443,443,13,13,0,1,0
16,456,456,42,42,0,1,0
19,460,460,19,7,12,3,2
15,462,462,6,6,0,1,0
35,469,469,48,48,0,1,0
20,488,488,20,8,12,4,3
37,494,494,120,69,51,4,3

13,114,114,31,31,0,1,0
26,116,116,11,11,0,1,0
15,129,129,14,5,9,2,1
0,135,135,1,1,0,1,0
28,147,147,2,2,0,1,0
20,196,196,11,11,0,1,0
23,201,201,8,8,0,1,0
14,208,208,8,8,0,1,0
3,211,211,43,43,0,1,0
8,227,227,31,3,28,3,2
19,238,238,15,15,0,1,0
33,248,248,3,3,0,1,0
1,253,253,33,33,0,1,0
21,254,254,15,15,0,1,0
16,266,266,5,5,0,1,0
6,272,272,2,2,0,1,0
17,284,284,88,88,0,1,0
7,303,303,39,39,0,1,0
31,304,304,10,10,0,1,0
11,327,327,14,2,12,4,3
10,352,352,42,42,0,1,0
22,368,368,43,37,6,3,2
5,368,368,2,2,0,1,0
2,376,376,1,1,0,1,0
12,378,378,6,6,0,1,0
27,394,394,4,1,3,2,1
4,398,398,36,6,30,3,2
29,410,410,294,228,66,4,3
32,417,417,17,4,13,2,1
9,422,422,158,144,14,3,2
18,464,464,16,16,0,1,0
24,467,467,5,5,0,1,0
30,482,482,30,9,21,4,3
25,491,491,33,21,12,2,1

23,147,147,16,16,0,1,0
7,182,182,16,1,15,3,2
3,189,189,13,13,0,1,0
24,191,191,23,23,0,1,0
10,196,196,27,24,3,2,1
8,239,239,21,17,4,2,1
26,287,287,19,19,0,1,0
12,301,301,82,37,45,4,3
1,308,308,45,45,0,1,0
18,326,326,45,45,0,1,0
2,347,347,37,12,25,2,1
22,356,356,78,9,69,4,3
27,357,357,28,10,18,4,3
30,358,358,2,2,0,1,0
5,380,380,56,56,0,1,0
25,393,393,30,24,6,2,1
19,401,401,65,65,0,1,0
20,401,401,69,49,20,2,1
13,418,418,29,29,0,1,0
31,420,420,38,38,0,1,0
29,426,426,59,59,0,1,0
15,427,427,73,34,39,2,1
17,429,429,31,31,0,1,0
14,441,441,45,12,33,4,3
0,441,441,3,3,0,1,0
16,447,447,27,27,0,1,0
11,457,457,31,31,0,1,0
9,466,466,28,10,18,4,3
4,471,471,61,21,40,2,1
6,475,475,19,19,0,1,0
28,475,475,44,2,42,2,1
21,490,490,9,4,5,2,1
32,496,496,54,32,22,3,2

18,127,127,27,17,10,2,1
30,134,134,8,2,6,2,1
11,153,153,1,1,0,1,0
0,155,155,15,15,0,1,0
22,163,163,15,3,12,2,1
20,183,183,3,3,0,1,0
14,185,185,2,2,0,1,0
29,197,197,6,6,0,1,0
28,199,199,21,6,15,2,1
21,215,215,58,58,0,1,0
25,215,215,78,49,29,2,1
3,230,230,22,3,19,2,1
7,232,232,1,1,0,1,0
12,243,243,25,13,12,4,3
23,254,254,68,68,0,1,0
32,262,262,4,4,0,1,0
15,284,284,7,1,6,2,1
5,295,295,19,3,16,2,1
33,314,314,45,28,17,2,1
35,319,319,3,3,0,1,0
4,330,330,77,77,0,1,0
17,342,342,41,41,0,1,0
10,347,347,16,16,0,1,0
27,351,351,23,23,0,1,0
16,364,364,68,59,9,4,3
19,369,369,22,6,16,3,2
31,383,383,3,3,0,1,0
34,387,387,66,66,0,1,0
6,394,394,47,7,40,2,1
24,395,395,6,6,0,1,0
2,428,428,50,17,33,4,3
9,441,441,51,22,29,2,1
8,446,446,10,4,6,3,2
26,455,455,19,5,14,3,2
13,475,475,42,42,0,1,0
1,492,492,19,19,0,1,0

25,106,106,36,36,0,1,0
10,112,112,1,1,0,1,0
11,152,152,20,4,16,3,2
3,183,183,2,2,0,1,0
17,185,185,2,2,0,1,0
4,188,188,17,17,0,1,0
23,195,195,28,28,0,1,0
18,199,199,33,33,0,1,0
28,210,210,6,6,0,1,0
21,223,223,10,1,9,4,3
12,242,242,28,7,21,4,3
14,256,256,28,16,12,2,1
0,260,260,20,20,0,1,0
1,262,262,37,27,10,3,2
7,278,278,11,2,9,2,1
27,284,284,12,12,0,1,0
24,300,300,27,27,0,1,0
16,316,316,32,3,29,2,1
8,377,377,174,160,14,2,1
6,381,381,17,9,8,3,2
26,400,400,116,116,0,1,0
19,405,405,41,41,0,1,0
5,409,409,192,180,12,3,2
22,423,423,22,22,0,1,0
2,446,446,21,21,0,1,0
15,454,454,1,1,0,1,0
9,479,479,88,54,34,3,2
20,493,493,5,1,4,2,1
13,493,493,43,43,0,1,0

32,101,101,8,2,6,2,1
18,110,110,32,12,20,3,2
12,112,112,12,5,7,2,1
4,114,114,1,1,0,1,0
19,124,124,41,4,37,4,3
6,131,131,7,7,0,1,0
13,131,131,23,8,15,2,1
3,143,143,8,8,0,1,0
31,143,143,1,1,0,1,0
0,145,145,6,6,0,1,0
25,151,151,5,5,0,1,0
5,178,178,24,3,21,2,1
24,185,185,10,1,9,4,3
29,222,222,13,13,0,1,0
15,223,223,9,9,0,1,0
33,236,236,3,3,0,1,0
11,244,244,42,42,0,1,0
16,246,246,10,2,8,2,1
30,251,251,18,6,12,2,1
10,285,285,31,24,7,2,1
26,289,289,20,7,13,4,3
28,296,296,10,10,0,1,0
8,312,312,141,15,126,4,3
17,346,346,25,25,0,1,0
2,349,349,11,11,0,1,0
34,368,368,13,3,10,3,2
7,384,384,6,6,0,1,0
14,394,394,19,19,0,1,0
21,405,405,7,7,0,1,0
20,420,420,102,102,0,1,0
27,439,439,44,29,15,4,3
9,460,460,65,65,0,1,0
22,480,480,100,90,10,2,1
23,488,488,41,15,26,2,1
1,493,493,1,1,0,1,0

28,100,100,10,10,0,1,0
27,102,102,5,1,4,2,1
18,113,113,25,2,23,4,3
34,158,158,16,16,0,1,0
1,174,174,13,13,0,1,0
20,177,177,2,2,0,1,0
29,182,182,16,16,0,1,0
16,209,209,7,4,3,2,1
6,217,217,35,35,0,1,0
7,239,239,16,16,0,1,0
17,258,258,20,20,0,1,0
13,260,260,28,10,18,2,1
10,269,269,22,22,0,1,0
8,275,275,21,21,0,1,0
0,286,286,52,24,28,3,2
4,300,300,85,48,37,3,2
12,314,314,11,11,0,1,0
24,314,314,56,3,53,4,3
31,333,333,75,75,0,1,0
33,333,333,3,3,0,1,0
21,339,339,17,5,12,3,2
23,342,342,18,18,0,1,0
15,370,370,5,5,0,1,0
26,383,383,115,14,101,4,3
11,395,395,5,5,0,1,0
2,397,397,14,14,0,1,0
19,398,398,15,15,0,1,0
32,405,405,3,3,0,1,0
35,416,416,5,5,0,1,0
5,421,421,10,1,9,2,1
14,422,422,13,13,0,1,0
22,433,433,136,136,0,1,0
3,441,441,50,50,0,1,0
30,455,455,59,23,36,4,3
25,462,462,38,38,0,1,0
9,471,471,15,15,0,1,0
36,495,495,10,10,0,1,0

27,112,112,4,4,0,1,0
26,131,131,41,11,30,2,1
1,141,141,1,1,0,1,0
15,179,179,8,2,6,3,2
6,181,181,2,2,0,1,0
11,184,184,15,15,0,1,0
2,191,191,2,2,0,1,0
17,204,204,17,12,5,2,1
21,219,219,51,51,0,1,0
30,224,224,3,3,0,1,0
19,225,225,11,2,9,4,3
9,233,233,16,7,9,2,1
29,252,252,14,4,10,3,2
18,315,315,3,3,0,1,0
5,319,319,8,8,0,1,0
10,338,338,17,4,13,2,1
22,348,348,36,33,3,2,1
3,357,357,52,21,31,4,3
4,365,365,39,39,0,1,0
12,378,378,94,28,66,4,3
23,384,384,86,23,63,4,3
31,388,388,106,106,0,1,0
8,396,396,32,32,0,1,0
24,398,398,15,7,8,3,2
14,414,414,38,38,0,1,0
20,424,424,20,20,0,1,0
7,442,442,91,91,0,1,0
0,463,463,73,73,0,1,0
25,470,470,25,25,0,1,0
13,470,470,192,174,18,2,1
28,478,478,38,38,0,1,0
16,496,496,37,11,26,2,1

2,101,101,13,13,0,1,0
14,127,127,4,4,0,1,0
27,136,136,8,8,0,1,0
12,143,143,27,27,0,1,0
33,188,188,13,2,11,2,1
17,199,199,43,43,0,1,0
4,200,200,9,9,0,1,0
21,211,211,11,11,0,1,0
6,216,216,2,2,0,1,0
29,231,231,4,4,0,1,0
15,233,233,16,16,0,1,0
3,240,240,19,1,18,3,2
35,253,253,50,37,13,2,1
11,271,271,15,15,0,1,0
16,286,286,1,1,0,1,0
25,286,286,4,4,0,1,0
28,288,288,150,49,101,4,3
36,307,307,35,1,34,3,2
10,307,307,41,17,24,3,2
8,314,314,7,7,0,1,0
32,324,324,33,33,0,1,0
24,338,338,61,61,0,1,0
34,344,344,3,3,0,1,0
13,357,357,54,15,39,4,3
7,369,369,8,8,0,1,0
30,377,377,74,61,13,2,1
18,388,388,90,7,83,4,3
26,388,388,26,26,0,1,0
38,390,390,27,27,0,1,0
22,401,401,17,17,0,1,0
37,419,419,6,3,3,2,1
0,432,432,26,5,21,2,1
20,445,445,11,5,6,3,2
31,449,449,15,5,10,2,1
1,451,451,29,29,0,1,0
9,456,456,3,3,0,1,0
5,463,463,37,33,4,2,1
19,477,477,13,13,0,1,0
23,481,481,11,11,0,1,0

20,101,101,21,21,0,1,0
13,118,118,14,14,0,1,0
19,119,119,1,1,0,1,0
9,134,134,11,1,10,2,1
24,135,135,30,18,12,2,1
2,150,150,14,7,7,2,1
7,194,194,2,2,0,1,0
12,208,208,13,4,9,2,1
27,213,213,13,4,9,2,1
11,217,217,3,3,0,1,0
17,262,262,44,44,0,1,0
1,279,279,7,7,0,1,0
22,286,286,14,11,3,2,1
15,293,293,2,2,0,1,0
10,304,304,34,7,27,2,1
0,306,306,148,88,60,3,2
28,307,307,54,54,0,1,0
4,311,311,48,48,0,1,0
16,318,318,71,71,0,1,0
5,332,332,12,4,8,2,1
3,335,335,12,12,0,1,0
14,345,345,40,40,0,1,0
6,394,394,13,5,8,2,1
25,407,407,18,18,0,1,0
23,442,442,52,9,43,2,1
21,475,475,39,22,17,2,1
18,482,482,5,5,0,1,0
26,487,487,30,21,9,2,1
8,498,498,311,311,0,1,0

24,129,129,3,3,0,1,0
3,137,137,42,2,40,3,2
21,140,140,4,1,3,2,1
23,141,141,28,28,0,1,0
22,205,205,3,3,0,1,0
8,210,210,25,2,23,2,1
30,212,212,24,17,7,2,1
16,221,221,2,2,0,1,0
10,227,227,1,1,0,1,0
29,231,231,34,3,31,3,2
13,233,233,5,5,0,1,0
0,260,260,7,7,0,1,0
14,262,262,13,3,10,2,1
18,266,266,91,41,50,2,1
11,268,268,61,61,0,1,0
31,274,274,1,1,0,1,0
19,297,297,35,35,0,1,0
17,304,304,4,4,0,1,0
9,318,318,4,1,3,2,1
2,321,321,11,11,0,1,0
28,326,326,5,5,0,1,0
6,327,327,23,9,14,2,1
5,335,335,121,28,93,4,3
15,358,358,91,91,0,1,0
12,363,363,4,4,0,1,0
26,367,367,85,52,33,2,1
20,432,432,37,37,0,1,0
27,450,450,53,53,0,1,0
1,452,452,52,52,0,1,0
7,455,455,4,4,0,1,0
25,483,483,19,1,18,3,2
4,490,490,38,28,10,2,1
32,500,500,113,113,0,1,0

31,114,114,16,16,0,1,0
25,114,114,11,11,0,1,0
27,121,121,2,2,0,1,0
19,127,127,27,27,0,1,0
12,147,147,14,14,0,1,0
16,149,149,32,32,0,1,0
15,161,161,13,13,0,1,0
3,162,162,7,7,0,1,0
10,172,172,22,22,0,1,0
8,175,175,7,7,0,1,0
2,204,204,1,1,0,1,0
30,226,226,12,12,0,1,0
18,229,229,8,8,0,1,0
23,238,238,63,11,52,3,2
11,245,245,18,8,10,3,2
7,268,268,1,1,0,1,0
6,307,307,44,44,0,1,0
14,311,311,114,22,92,3,2
17,314,314,12,12,0,1,0
20,317,317,23,23,0,1,0
33,321,321,60,32,28,3,2
4,333,333,17,17,0,1,0
22,340,340,50,50,0,1,0
0,367,367,8,8,0,1,0
21,381,381,35,16,19,2,1
5,390,390,49,25,24,3,2
32,413,413,28,13,15,4,3
13,416,416,14,14,0,1,0
26,431,431,23,14,9,4,3
28,444,444,30,20,10,3,2
29,452,452,35,35,0,1,0
9,475,475,77,39,38,2,1
1,476,476,56,56,0,1,0
24,491,491,56,2,54,4,3

25,102,102,6,2,4,2,1
17,106,106,11,5,6,3,2
7,120,120,1,1,0,1,0
10,175,175,44,8,36,4,3
23,216,216,21,21,0,1,0
2,218,218,10,7,3,2,1
20,219,219,9,9,0,1,0
6,242,242,36,36,0,1,0
29,259,259,9,4,5,2,1
15,277,277,45,45,0,1,0
12,282,282,22,22,0,1,0
0,285,285,2,2,0,1,0
19,291,291,19,19,0,1,0
18,296,296,61,61,0,1,0
16,314,314,25,3,22,2,1
27,317,317,10,6,4,2,1
5,345,345,278,230,48,3,2
3,365,365,22,4,18,4,3
4,369,369,74,61,13,2,1
24,374,374,18,14,4,2,1
9,403,403,9,9,0,1,0
1,410,410,12,4,8,2,1
14,426,426,3,3,0,1,0
13,444,444,157,157,0,1,0
11,447,447,7,7,0,1,0
26,456,456,33,33,0,1,0
8,458,458,13,13,0,1,0
28,480,480,61,61,0,1,0
22,481,481,45,23,22,3,2
21,487,487,73,63,10,3,2

29,102,102,12,3,9,4,3
7,130,130,10,10,0,1,0
24,137,137,7,7,0,1,0
36,144,144,18,10,8,2,1
21,175,175,11,11,0,1,0
34,188,188,6,6,0,1,0
1,206,206,5,5,0,1,0
0,216,216,1,1,0,1,0
28,220,220,11,5,6,3,2
38,231,231,7,1,6,3,2
12,233,233,33,13,20,2,1
22,234,234,22,22,0,1,0
2,236,236,25,16,9,4,3
11,238,238,4,1,3,2,1
30,254,254,8,8,0,1,0
27,277,277,10,2,8,2,1
9,284,284,17,13,4,2,1
25,293,293,4,4,0,1,0
31,301,301,22,10,12,3,2
41,309,309,18,18,0,1,0
13,313,313,57,57,0,1,0
32,325,325,28,16,12,3,2
6,359,359,46,37,9,4,3
39,366,366,208,124,84,4,3
19,370,370,19,12,7,2,1
14,371,371,4,4,0,1,0
4,382,382,5,5,0,1,0
15,388,388,10,7,3,2,1
18,396,396,20,20,0,1,0
33,403,403,41,5,36,4,3
37,404,404,92,58,34,3,2
40,404,404,24,6,18,3,2
5,415,415,59,59,0,1,0
20,416,416,26,26,0,1,0
10,434,434,28,28,0,1,0
16,440,440,23,2,21,4,3
35,449,449,45,30,15,2,1
17,455,455,7,7,0,1,0
3,463,463,6,6,0,1,0
26,464,464,7,7,0,1,0
23,465,465,98,94,4,2,1
8,476,476,21,21,0,1,0

14,111,111,6,6,0,1,0
12,115,115,13,13,0,1,0
16,139,139,21,21,0,1,0
29,152,152,19,19,0,1,0
0,158,158,5,5,0,1,0
28,158,158,4,4,0,1,0
17,200,200,12,1,11,2,1
21,210,210,13,13,0,1,0
23,212,212,13,13,0,1,0
5,217,217,71,71,0,1,0
26,229,229,2,2,0,1,0
24,236,236,99,99,0,1,0
7,250,250,73,73,0,1,0
2,276,276,20,20,0,1,0
15,277,277,22,14,8,3,2
11,300,300,36,16,20,2,1
22,331,331,51,51,0,1,0
10,353,353,61,13,48,3,2
4,364,364,9,9,0,1,0
13,369,369,45,45,0,1,0
9,372,372,35,4,31,3,2
6,392,392,3,3,0,1,0
25,416,416,12,12,0,1,0
19,424,424,126,92,34,2,1
27,426,426,8,2,6,3,2
20,428,428,15,15,0,1,0
1,446,446,45,36,9,2,1
3,455,455,137,127,10,2,1
8,466,466,20,20,0,1,0
18,484,484,14,4,10,2,1

22,109,109,11,11,0,1,0
34,117,117,2,2,0,1,0
6,120,120,40,33,7,2,1
3,123,123,26,20,6,2,1
13,123,123,21,6,15,4,3
19,179,179,8,2,6,3,2
2,201,201,1,1,0,1,0
30,201,201,26,26,0,1,0
32,216,216,38,11,27,4,3
9,232,232,35,11,24,3,2
29,247,247,2,2,0,1,0
24,253,253,57,57,0,1,0
0,261,261,8,8,0,1,0
11,265,265,8,8,0,1,0
8,266,266,38,2,36,3,2
16,266,266,1,1,0,1,0
7,267,267,37,14,23,2,1
26,275,275,28,28,0,1,0
12,275,275,32,11,21,4,3
17,285,285,10,10,0,1,0
18,288,288,5,5,0,1,0
33,294,294,46,46,0,1,0
5,308,308,42,42,0,1,0
10,342,342,7,1,6,3,2
27,371,371,51,51,0,1,0
25,373,373,11,5,6,2,1
15,379,379,1,1,0,1,0
31,397,397,15,15,0,1,0
20,408,408,100,24,76,3,2
4,418,418,8,8,0,1,0
14,420,420,54,54,0,1,0
35,424,424,39,18,21,2,1
23,424,424,21,21,0,1,0
28,445,445,22,4,18,2,1
21,453,453,60,60,0,1,0
1,495,495,4,4,0,1,0

12,109,109,17,17,0,1,0
1,128,128,1,1,0,1,0
14,131,131,30,30,0,1,0
11,133,133,1,1,0,1,0
20,154,154,58,58,0,1,0
17,157,157,4,1,3,2,1
25,168,168,4,4,0,1,0
28,172,172,17,3,14,3,2
22,178,178,16,1,15,2,1
10,182,182,26,26,0,1,0
29,196,196,1,1,0,1,0
3,214,214,11,5,6,2,1
26,226,226,10,1,9,2,1
13,237,237,8,8,0,1,0
8,248,248,21,21,0,1,0
23,251,251,54,35,19,2,1
4,262,262,8,8,0,1,0
21,272,272,1,1,0,1,0
2,290,290,25,18,7,2,1
6,292,292,19,7,12,4,3
5,314,314,112,93,19,2,1
19,315,315,27,27,0,1,0
16,330,330,45,45,0,1,0
27,330,330,38,3,35,4,3
7,332,332,37,5,32,4,3
24,338,338,10,5,5,2,1
30,347,347,42,10,32,2,1
9,352,352,22,22,0,1,0
31,373,373,115,115,0,1,0
32,373,373,6,6,0,1,0
18,451,451,20,20,0,1,0
0,460,460,34,1,33,3,2
15,478,478,96,29,67,4,3

14,131,131,1,1,0,1,0
24,132,132,15,15,0,1,0
29,134,134,14,2,12,4,3
28,135,135,1,1,0,1,0
5,153,153,39,39,0,1,0
2,156,156,15,2,13,2,1
1,158,158,3,3,0,1,0
18,160,160,4,4,0,1,0
17,163,163,18,2,16,3,2
10,174,174,48,30,18,4,3
0,174,174,47,36,11,2,1
13,204,204,1,1,0,1,0
19,225,225,43,43,0,1,0
4,234,234,7,7,0,1,0
34,255,255,9,4,5,2,1
15,260,260,19,10,9,2,1
25,273,273,66,28,38,2,1
26,280,280,17,8,9,2,1
20,282,282,3,3,0,1,0
27,286,286,6,6,0,1,0
38,309,309,14,9,5,2,1
35,318,318,26,14,12,4,3
7,323,323,17,8,9,4,3
32,331,331,8,3,5,2,1
22,333,333,67,45,22,3,2
9,339,339,9,9,0,1,0
36,346,346,19,19,0,1,0
3,360,360,4,1,3,2,1
16,361,361,50,34,16,3,2
8,365,365,5,5,0,1,0
12,403,403,5,1,4,2,1
33,410,410,24,24,0,1,0
30,411,411,92,68,24,4,3
31,413,413,55,19,36,4,3
21,418,418,16,1,15,4,3
37,446,446,35,35,0,1,0
23,465,465,117,117,0,1,0
11,468,468,1,1,0,1,0
6,479,479,18,18,0,1,0

1,105,105,3,3,0,1,0
26,132,132,11,5,6,3,2
29,144,144,22,22,0,1,0
3,165,165,2,2,0,1,0
12,183,183,1,1,0,1,0
14,193,193,1,1,0,1,0
2,203,203,5,5,0,1,0
30,215,215,2,2,0,1,0
13,229,229,33,3,30,3,2
4,240,240,25,17,8,3,2
38,246,246,13,13,0,1,0
31,260,260,47,4,43,4,3
33,267,267,41,20,21,2,1
17,272,272,36,6,30,4,3
19,279,279,1,1,0,1,0
37,287,287,46,6,40,3,2
21,299,299,7,7,0,1,0
10,300,300,11,11,0,1,0
28,305,305,20,20,0,1,0
8,334,334,59,59,0,1,0
23,344,344,24,24,0,1,0
27,347,347,7,7,0,1,0
18,349,349,48,7,41,2,1
22,350,350,1,1,0,1,0
15,358,358,176,138,38,3,2
0,365,365,21,2,19,2,1
9,374,374,1,1,0,1,0
36,397,397,95,37,58,3,2
16,399,399,10,10,0,1,0
39,406,406,62,62,0,1,0
5,407,407,16,8,8,3,2
24,420,420,12,12,0,1,0
25,430,430,64,20,44,2,1
32,447,447,16,7,9,4,3
35,450,450,3,3,0,1,0
34,458,458,76,76,0,1,0
11,463,463,9,9,0,1,0
7,473,473,35,9,26,2,1
20,482,482,27,12,15,2,1
6,486,486,48,48,0,1,0

29,102,102,27,10,17,3,2
3,109,109,4,4,0,1,0
20,114,114,27,12,15,4,3
13,115,115,2,2,0,1,0
34,124,124,1,1,0,1,0
4,130,130,13,4,9,2,1
26,160,160,9,6,3,2,1
5,163,163,10,10,0,1,0
9,164,164,14,2,12,3,2
11,166,166,32,28,4,2,1
7,181,181,1,1,0,1,0
31,182,182,4,4,0,1,0
12,189,189,60,60,0,1,0
17,192,192,21,1,20,3,2
0,195,195,5,5,0,1,0
18,203,203,7,7,0,1,0
33,217,217,13,13,0,1,0
35,248,248,13,7,6,2,1
14,282,282,57,57,0,1,0
19,307,307,28,10,18,3,2
21,331,331,16,8,8,3,2
32,334,334,17,12,5,2,1
8,335,335,48,48,0,1,0
28,336,336,26,21,5,2,1
16,344,344,6,6,0,1,0
10,368,368,40,25,15,4,3
23,380,380,34,34,0,1,0
27,386,386,60,60,0,1,0
1,405,405,3,3,0,1,0
2,406,406,46,28,18,2,1
15,429,429,30,2,28,3,2
25,436,436,129,72,57,4,3
24,456,456,44,38,6,2,1
30,465,465,8,8,0,1,0
6,466,466,26,26,0,1,0
22,481,481,54,54,0,1,0

16,128,128,2,2,0,1,0
22,134,134,15,15,0,1,0
2,135,135,12,12,0,1,0
24,152,152,13,10,3,2,1
21,155,155,18,18,0,1,0
10,172,172,33,3,30,4,3
9,194,194,36,21,15,4,3
13,208,208,17,2,15,2,1
25,257,257,28,20,8,2,1
26,258,258,42,42,0,1,0
12,262,262,43,43,0,1,0
18,286,286,36,36,0,1,0
0,313,313,26,26,0,1,0
19,340,340,87,87,0,1,0
7,342,342,91,74,17,4,3
20,364,364,3,3,0,1,0
23,370,370,25,3,22,4,3
6,380,380,11,11,0,1,0
27,413,413,30,3,27,4,3
8,415,415,2,2,0,1,0
4,432,432,23,17,6,2,1
11,444,444,260,155,105,4,3
14,453,453,151,135,16,3,2
28,464,464,9,5,4,2,1
17,466,466,18,12,6,2,1
1,470,470,1,1,0,1,0
3,474,474,5,5,0,1,0
29,476,476,32,32,0,1,0
15,488,488,29,29,0,1,0
5,491,491,19,9,10,3,2

24,113,113,1,1,0,1,0
0,128,128,15,3,12,3,2
22,140,140,15,15,0,1,0
21,144,144,8,2,6,3,2
2,146,146,22,13,9,2,1
29,149,149,9,2,7,2,1
17,160,160,10,10,0,1,0
15,235,235,10,2,8,3,2
26,249,249,21,14,7,2,1
1,279,279,40,40,0,1,0
5,281,281,17,5,12,2,1
12,284,284,7,7,0,1,0
8,288,288,11,11,0,1,0
11,292,292,113,113,0,1,0
20,297,297,54,25,29,2,1
7,306,306,25,25,0,1,0
25,321,321,16,10,6,3,2
32,326,326,2,2,0,1,0
4,355,355,13,3,10,3,2
9,357,357,23,23,0,1,0
33,362,362,22,22,0,1,0
18,364,364,1,1,0,1,0
30,377,377,49,49,0,1,0
23,377,377,108,62,46,2,1
6,379,379,15,15,0,1,0
3,382,382,20,11,9,2,1
35,391,391,55,55,0,1,0
14,402,402,7,7,0,1,0
16,403,403,13,3,10,3,2
28,416,416,152,122,30,3,2
10,432,432,123,72,51,4,3
13,443,443,28,9,19,2,1
27,458,458,33,25,8,3,2
19,465,465,20,20,0,1,0
34,475,475,34,34,0,1,0
31,479,479,7,7,0,1,0

29,103,103,7,3,4,2,1
15,110,110,1,1,0,1,0
22,111,111,9,9,0,1,0
25,112,112,14,14,0,1,0
18,114,114,13,5,8,2,1
30,115,115,2,2,0,1,0
37,127,127,77,68,9,4,3
36,134,134,6,6,0,1,0
27,136,136,3,3,0,1,0
23,141,141,5,5,0,1,0
1,147,147,4,4,0,1,0
12,159,159,7,7,0,1,0
19,160,160,15,15,0,1,0
33,209,209,20,20,0,1,0
8,215,215,1,1,0,1,0
21,223,223,7,7,0,1,0
24,229,229,12,12,0,1,0
13,247,247,63,63,0,1,0
34,247,247,14,5,9,2,1
32,260,260,13,8,5,2,1
11,314,314,65,65,0,1,0
9,336,336,15,2,13,2,1
31,336,336,21,21,0,1,0
35,337,337,10,2,8,2,1
2,346,346,54,54,0,1,0
14,347,347,6,6,0,1,0
6,362,362,12,12,0,1,0
3,362,362,31,31,0,1,0
0,363,363,48,48,0,1,0
26,372,372,109,17,92,3,2
28,373,373,30,10,20,3,2
4,408,408,6,2,4,2,1
17,424,424,60,12,48,2,1
5,429,429,55,43,12,4,3
20,431,431,49,6,43,3,2
7,469,469,13,13,0,1,0
16,479,479,8,8,0,1,0
10,490,490,17,17,0,1,0

13,104,104,7,4,3,2,1
32,108,108,10,2,8,3,2
23,115,115,16,16,0,1,0
1,118,118,2,2,0,1,0
24,120,120,26,26,0,1,0
37,121,121,9,9,0,1,0
3,124,124,1,1,0,1,0
17,147,147,9,6,3,2,1
14,157,157,29,14,15,4,3
0,159,159,10,3,7,2,1
16,167,167,16,16,0,1,0
8,178,178,3,3,0,1,0
29,194,194,40,17,23,2,1
26,205,205,2,2,0,1,0
38,211,211,18,18,0,1,0
33,226,226,29,29,0,1,0
20,234,234,11,11,0,1,0
4,254,254,83,51,32,2,1
21,271,271,7,7,0,1,0
19,279,279,39,15,24,3,2
9,290,290,2,2,0,1,0
12,291,291,83,26,57,4,3
22,296,296,1,1,0,1,0
36,310,310,34,13,21,4,3
11,334,334,20,2,18,4,3
35,339,339,23,11,12,2,1
18,355,355,18,10,8,3,2
31,372,372,6,6,0,1,0
25,374,374,63,63,0,1,0
15,386,386,18,6,12,3,2
28,392,392,79,79,0,1,0
5,396,396,1,1,0,1,0
39,397,397,23,23,0,1,0
2,397,397,13,1,12,2,1
7,399,399,3,3,0,1,0
30,416,416,1,1,0,1,0
27,444,444,45,4,41,4,3
6,449,449,68,8,60,4,3
34,471,471,33,33,0,1,0
10,491,491,1,1,0,1,0

11,100,100,11,11,0,1,0
5,104,104,1,1,0,1,0
7,112,112,8,8,0,1,0
8,113,113,4,4,0,1,0
13,121,121,17,17,0,1,0
39,124,124,12,5,7,2,1
2,130,130,16,16,0,1,0
19,136,136,2,2,0,1,0
9,137,137,19,19,0,1,0
18,143,143,33,19,14,2,1
12,189,189,3,3,0,1,0
15,192,192,14,14,0,1,0
14,213,213,3,3,0,1,0
26,219,219,12,1,11,4,3
33,226,226,1,1,0,1,0
31,229,229,14,8,6,2,1
16,240,240,15,15,0,1,0
34,267,267,5,2,3,2,1
28,268,268,4,1,3,2,1
38,313,313,57,15,42,4,3
35,317,317,58,14,44,3,2
23,327,327,8,8,0,1,0
29,340,340,17,17,0,1,0
10,341,341,25,15,10,3,2
3,350,350,12,3,9,2,1
21,366,366,10,10,0,1,0
30,386,386,41,41,0,1,0
22,386,386,40,18,22,3,2
27,392,392,59,59,0,1,0
6,396,396,57,47,10,3,2
32,422,422,98,36,62,4,3
17,422,422,1,1,0,1,0
25,442,442,57,36,21,4,3
36,446,446,68,68,0,1,0
1,457,457,14,1,13,3,2
0,459,459,60,51,9,2,1
37,463,463,105,105,0,1,0
4,470,470,49,2,47,4,3
20,472,472,5,5,0,1,0
24,500,500,19,19,0,1,0

6,110,110,1,1,0,1,0
32,139,139,15,15,0,1,0
3,147,147,22,22,0,1,0
4,153,153,1,1,0,1,0
17,173,173,5,5,0,1,0
15,174,174,2,2,0,1,0
22,175,175,26,26,0,1,0
16,203,203,50,14,36,3,2
18,210,210,15,15,0,1,0
20,215,215,27,27,0,1,0
33,224,224,21,21,0,1,0
13,239,239,1,1,0,1,0
7,261,261,3,3,0,1,0
5,264,264,38,10,28,3,2
25,277,277,12,12,0,1,0
35,312,312,52,52,0,1,0
1,313,313,1,1,0,1,0
31,331,331,32,32,0,1,0
8,357,357,9,4,5,2,1
29,362,362,77,17,60,4,3
2,369,369,28,10,18,4,3
19,389,389,126,126,0,1,0
24,397,397,11,3,8,2,1
10,400,400,59,59,0,1,0
27,415,415,6,6,0,1,0
28,435,435,9,9,0,1,0
0,446,446,140,114,26,2,1
26,459,459,47,47,0,1,0
30,461,461,20,20,0,1,0
12,463,463,44,44,0,1,0
23,470,470,11,11,0,1,0
21,476,476,38,38,0,1,0
14,477,477,58,36,22,2,1
9,483,483,43,8,35,2,1
34,485,485,50,23,27,4,3
11,498,498,74,11,63,4,3

3,101,101,12,12,0,1,0
1,114,114,7,7,0,1,0
11,114,114,1,1,0,1,0
26,115,115,11,11,0,1,0
32,138,138,40,40,0,1,0
6,150,150,15,15,0,1,0
28,152,152,8,2,6,3,2
21,154,154,31,31,0,1,0
9,171,171,29,7,22,3,2
14,177,177,42,42,0,1,0
4,184,184,26,26,0,1,0
2,240,240,13,4,9,2,1
7,269,269,45,31,14,2,1
18,298,298,25,25,0,1,0
16,301,301,37,13,24,3,2
0,306,306,14,6,8,2,1
10,311,311,35,5,30,4,3
8,314,314,55,55,0,1,0
25,317,317,43,43,0,1,0
19,326,326,31,31,0,1,0
22,333,333,33,33,0,1,0
24,361,361,21,2,19,4,3
30,374,374,54,12,42,3,2
15,382,382,37,10,27,4,3
17,397,397,42,42,0,1,0
12,409,409,17,17,0,1,0
23,426,426,13,10,3,2,1
31,429,429,5,5,0,1,0
27,443,443,14,2,12,3,2
20,454,454,65,65,0,1,0
5,477,477,53,45,8,3,2
13,480,480,29,14,15,4,3
29,482,482,18,1,17,2,1

31,101,101,18,18,0,1,0
41,102,102,9,9,0,1,0
37,108,108,23,23,0,1,0
39,110,110,7,7,0,1,0
16,128,128,7,3,4,2,1
29,132,132,14,5,9,4,3
30,140,140,2,2,0,1,0
25,141,141,4,4,0,1,0
22,147,147,12,5,7,3,2
8,148,148,1,1,0,1,0
18,166,166,6,6,0,1,0
35,176,176,28,5,23,3,2
21,183,183,3,3,0,1,0
34,183,183,1,1,0,1,0
6,186,186,4,4,0,1,0
20,190,190,1,1,0,1,0
17,196,196,15,15,0,1,0
24,222,222,13,7,6,3,2
28,229,229,38,38,0,1,0
10,234,234,10,10,0,1,0
43,240,240,11,7,4,2,1
27,246,246,15,15,0,1,0
7,255,255,4,4,0,1,0
9,267,267,2,2,0,1,0
1,274,274,18,18,0,1,0
38,294,294,46,46,0,1,0
11,300,300,12,12,0,1,0
12,308,308,65,65,0,1,0
42,329,329,5,2,3,2,1
23,362,362,4,4,0,1,0
0,364,364,49,25,24,4,3
33,383,383,27,12,15,4,3
2,384,384,24,24,0,1,0
14,394,394,17,2,15,2,1
36,402,402,14,10,4,2,1
5,404,404,40,6,34,2,1
4,404,404,20,20,0,1,0
3,442,442,11,5,6,3,2
19,443,443,82,82,0,1,0
26,445,445,30,22,8,3,2
15,455,455,90,6,84,4,3
32,484,484,15,15,0,1,0
13,488,488,28,2,26,4,3
40,488,488,163,69,94,4,3

27,100,100,9,3,6,3,2
11,103,103,18,18,0,1,0
18,117,117,10,10,0,1,0
13,121,121,3,3,0,1,0
15,125,125,9,5,4,2,1
9,143,143,16,16,0,1,0
28,166,166,37,37,0,1,0
17,172,172,8,8,0,1,0
24,183,183,20,2,18,3,2
35,202,202,7,4,3,2,1
1,206,206,1,1,0,1,0
12,217,217,7,1,6,3,2
31,220,220,28,10,18,2,1
7,228,228,6,6,0,1,0
5,244,244,29,17,12,2,1
3,248,248,9,9,0,1,0
29,258,258,9,2,7,2,1
6,264,264,1,1,0,1,0
32,270,270,22,8,14,2,1
19,277,277,7,1,6,2,1
14,285,285,28,3,25,2,1
16,290,290,37,17,20,3,2
30,322,322,12,2,10,3,2
0,324,324,44,6,38,2,1
33,341,341,43,43,0,1,0
25,341,341,123,29,94,3,2
36,360,360,43,43,0,1,0
2,360,360,1,1,0,1,0
37,380,380,27,6,21,4,3
23,389,389,11,6,5,2,1
21,398,398,62,31,31,2,1
8,416,416,33,9,24,3,2
34,417,417,18,18,0,1,0
4,421,421,31,21,10,3,2
26,461,461,21,9,12,3,2
22,473,473,20,20,0,1,0
20,491,491,150,48,102,4,3
10,494,494,57,15,42,3,2

2,114,114,7,7,0,1,0
34,128,128,5,5,0,1,0
10,133,133,1,1,0,1,0
27,164,164,15,15,0,1,0
17,168,168,22,10,12,3,2
22,172,172,2,2,0,1,0
44,200,200,7,7,0,1,0
30,206,206,5,5,0,1,0
8,216,216,1,1,0,1,0
18,224,224,16,3,13,3,2
14,233,233,4,4,0,1,0
36,240,240,12,2,10,3,2
29,241,241,44,44,0,1,0
7,252,252,4,1,3,2,1
28,265,265,93,93,0,1,0
24,277,277,28,5,23,2,1
26,300,300,38,20,18,3,2
35,315,315,38,11,27,4,3
4,315,315,21,6,15,2,1
31,343,343,30,19,11,2,1
32,346,346,55,28,27,2,1
39,349,349,21,21,0,1,0
33,355,355,34,34,0,1,0
12,371,371,9,9,0,1,0
23,372,372,54,54,0,1,0
16,375,375,19,19,0,1,0
21,376,376,18,18,0,1,0
42,382,382,8,8,0,1,0
5,386,386,2,2,0,1,0
3,387,387,6,6,0,1,0
6,388,388,3,3,0,1,0
15,411,411,9,1,8,2,1
19,413,413,21,21,0,1,0
20,416,416,3,3,0,1,0
1,419,419,30,30,0,1,0
37,423,423,24,19,5,2,1
41,437,437,40,13,27,4,3
40,445,445,18,2,16,4,3
13,463,463,4,1,3,2,1
9,483,483,87,19,68,4,3
25,484,484,149,104,45,2,1
0,485,485,8,3,5,2,1
11,486,486,16,1,15,4,3
43,487,487,17,3,14,3,2
38,495,495,138,138,0,1,0

3,129,129,13,13,0,1,0
34,133,133,25,4,21,4,3
36,139,139,24,15,9,2,1
27,154,154,24,24,0,1,0
0,155,155,10,10,0,1,0
5,160,160,3,3,0,1,0
2,162,162,51,51,0,1,0
7,176,176,1,1,0,1,0
16,181,181,1,1,0,1,0
26,183,183,17,8,9,4,3
21,186,186,4,4,0,1,0
10,207,207,15,15,0,1,0
22,207,207,1,1,0,1,0
14,236,236,1,1,0,1,0
37,238,238,2,2,0,1,0
29,242,242,22,22,0,1,0
12,245,245,33,33,0,1,0
6,290,290,2,2,0,1,0
8,293,293,94,94,0,1,0
24,297,297,35,35,0,1,0
20,300,300,15,15,0,1,0
18,325,325,6,6,0,1,0
28,345,345,57,57,0,1,0
17,355,355,8,1,7,2,1
19,380,380,37,37,0,1,0
32,386,386,25,9,16,2,1
4,388,388,22,14,8,2,1
15,389,389,14,2,12,2,1
11,405,405,73,73,0,1,0
33,416,416,3,3,0,1,0
23,419,419,36,8,28,4,3
31,432,432,120,28,92,3,2
9,433,433,14,1,13,2,1
1,444,444,4,4,0,1,0
30,465,465,2,2,0,1,0
35,465,465,71,11,60,3,2
25,466,466,57,57,0,1,0
13,487,487,73,73,0,1,0

25,112,112,38,2,36,4,3
5,133,133,21,21,0,1,0
17,142,142,2,2,0,1,0
12,168,168,1,1,0,1,0
23,196,196,12,12,0,1,0
11,220,220,18,11,7,3,2
3,224,224,6,6,0,1,0
4,231,231,10,1,9,2,1
24,265,265,27,6,21,2,1
27,271,271,71,40,31,3,2
7,286,286,80,53,27,2,1
10,298,298,20,20,0,1,0
13,298,298,27,11,16,3,2
14,302,302,70,70,0,1,0
19,310,310,41,32,9,4,3
31,319,319,30,1,29,2,1
9,325,325,140,140,0,1,0
16,331,331,4,4,0,1,0
29,333,333,9,9,0,1,0
15,339,339,50,12,38,2,1
6,356,356,8,8,0,1,0
20,369,369,7,7,0,1,0
21,373,373,107,54,53,4,3
8,398,398,5,5,0,1,0
0,424,424,74,74,0,1,0
28,434,434,19,19,0,1,0
1,446,446,10,10,0,1,0
22,466,466,25,25,0,1,0
18,472,472,10,10,0,1,0
26,473,473,46,33,13,2,1
30,476,476,11,11,0,1,0
2,491,491,26,13,13,2,1

34,100,100,6,6,0,1,0
22,128,128,1,1,0,1,0
15,132,132,3,3,0,1,0
33,146,146,4,4,0,1,0
35,152,152,49,49,0,1,0
18,157,157,2,2,0,1,0
11,169,169,2,2,0,1,0
19,174,174,18,18,0,1,0
40,181,181,1,1,0,1,0
32,181,181,28,24,4,2,1
16,198,198,23,7,16,3,2
4,205,205,4,1,3,2,1
39,223,223,9,4,5,2,1
29,250,250,92,65,27,4,3
10,257,257,11,11,0,1,0
21,274,274,34,34,0,1,0
26,278,278,17,1,16,2,1
14,281,281,4,4,0,1,0
2,282,282,24,3,21,4,3
23,290,290,7,7,0,1,0
1,290,290,109,7,102,4,3
9,295,295,6,6,0,1,0
3,313,313,1,1,0,1,0
13,322,322,31,31,0,1,0
36,331,331,47,47,0,1,0
17,351,351,2,2,0,1,0
37,360,360,18,18,0,1,0
38,366,366,2,2,0,1,0
30,367,367,42,42,0,1,0
7,369,369,10,2,8,2,1
12,385,385,96,46,50,3,2
27,386,386,25,9,16,3,2
0,390,390,12,6,6,2,1
8,396,396,1,1,0,1,0
31,421,421,100,100,0,1,0
6,448,448,7,7,0,1,0
20,472,472,95,38,57,4,3
24,486,486,19,9,10,2,1
5,487,487,44,23,21,4,3
28,497,497,8,8,0,1,0
25,499,499,14,14,0,1,0

10,106,106,8,8,0,1,0
16,131,131,12,12,0,1,0
33,135,135,38,21,17,2,1
8,169,169,9,9,0,1,0
22,177,177,28,28,0,1,0
0,194,194,38,4,34,2,1
6,205,205,29,12,17,2,1
29,215,215,4,4,0,1,0
19,223,223,22,22,0,1,0
2,227,227,1,1,0,1,0
1,239,239,18,11,7,2,1
18,244,244,4,4,0,1,0
11,247,247,3,3,0,1,0
17,256,256,17,2,15,2,1
9,263,263,1,1,0,1,0
12,278,278,9,9,0,1,0
14,288,288,39,15,24,2,1
15,288,288,22,2,20,3,2
28,295,295,60,20,40,2,1
3,318,318,18,18,0,1,0
5,341,341,9,9,0,1,0
7,347,347,90,90,0,1,0
31,352,352,29,22,7,2,1
21,365,365,75,11,64,4,3
13,370,370,18,8,10,2,1
26,377,377,30,23,7,2,1
27,377,377,3,3,0,1,0
23,398,398,16,5,11,3,2
4,408,408,168,168,0,1,0
24,418,418,74,64,10,2,1
32,441,441,34,22,12,3,2
25,447,447,61,40,21,4,3
20,450,450,11,1,10,2,1
30,474,474,25,15,10,2,1

21,102,102,3,3,0,1,0
30,112,112,29,29,0,1,0
27,113,113,1,1,0,1,0
16,116,116,22,13,9,2,1
5,123,123,21,21,0,1,0
8,123,123,22,5,17,2,1
25,137,137,1,1,0,1,0
10,144,144,1,1,0,1,0
26,157,157,3,3,0,1,0
12,158,158,6,3,3,2,1
20,172,172,53,8,45,4,3
23,181,181,21,21,0,1,0
4,198,198,8,8,0,1,0
22,211,211,7,7,0,1,0
0,212,212,7,7,0,1,0
17,218,218,20,6,14,2,1
32,238,238,1,1,0,1,0
18,262,262,103,103,0,1,0
1,287,287,57,20,37,4,3
13,306,306,17,4,13,2,1
15,321,321,25,9,16,3,2
7,334,334,25,22,3,2,1
9,335,335,9,2,7,2,1
3,347,347,47,38,9,4,3
6,368,368,10,10,0,1,0
2,369,369,90,90,0,1,0
14,370,370,17,12,5,2,1
28,383,383,1,1,0,1,0
24,392,392,38,10,28,3,2
29,395,395,34,12,22,2,1
11,423,423,29,29,0,1,0
19,447,447,2,2,0,1,0
34,451,451,23,23,0,1,0
31,491,491,89,89,0,1,0
33,498,498,70,70,0,1,0

37,103,103,5,2,3,2,1
0,103,103,1,1,0,1,0
29,116,116,20,20,0,1,0
24,131,131,14,4,10,3,2
34,160,160,1,1,0,1,0
35,162,162,17,17,0,1,0
3,179,179,5,5,0,1,0
26,180,180,29,29,0,1,0
21,182,182,3,3,0,1,0
2,183,183,1,1,0,1,0
15,184,184,36,20,16,3,2
20,187,187,10,10,0,1,0
33,190,190,5,5,0,1,0
31,213,213,8,8,0,1,0
8,214,214,2,2,0,1,0
17,233,233,10,10,0,1,0
16,265,265,1,1,0,1,0
30,279,279,126,126,0,1,0
27,296,296,20,20,0,1,0
1,307,307,49,49,0,1,0
6,308,308,8,2,6,3,2
9,334,334,9,9,0,1,0
13,339,339,66,46,20,3,2
7,343,343,74,70,4,2,1
23,354,354,18,5,13,2,1
4,361,361,36,36,0,1,0
32,369,369,25,13,12,4,3
19,370,370,4,4,0,1,0
5,371,371,74,55,19,2,1
12,384,384,5,5,0,1,0
38,427,427,3,3,0,1,0
11,427,427,112,49,63,4,3
28,448,448,17,11,6,2,1
14,453,453,2,2,0,1,0
22,469,469,12,12,0,1,0
10,475,475,50,3,47,3,2
36,475,475,111,71,40,3,2
25,485,485,63,40,23,2,1
18,495,495,10,2,8,3,2

27,126,126,11,11,0,1,0
19,142,142,10,10,0,1,0
4,172,172,17,5,12,2,1
6,176,176,19,19,0,1,0
33,200,200,13,3,10,4,3
24,212,212,3,3,0,1,0
34,235,235,7,7,0,1,0
1,237,237,35,35,0,1,0
15,240,240,1,1,0,1,0
12,249,249,9,2,7,2,1
9,255,255,33,15,18,3,2
21,282,282,24,24,0,1,0
32,289,289,8,8,0,1,0
22,296,296,12,2,10,3,2
30,339,339,52,52,0,1,0
28,350,350,114,46,68,3,2
23,351,351,61,61,0,1,0
3,370,370,21,21,0,1,0
20,373,373,109,109,0,1,0
14,380,380,2,2,0,1,0
26,383,383,98,98,0,1,0
11,386,386,2,2,0,1,0
7,406,406,112,93,19,2,1
29,415,415,14,11,3,2,1
5,424,424,8,8,0,1,0
18,435,435,4,4,0,1,0
8,437,437,97,73,24,3,2
17,454,454,11,2,9,2,1
10,457,457,55,55,0,1,0
25,458,458,21,21,0,1,0
2,458,458,45,45,0,1,0
0,460,460,24,6,18,2,1
31,477,477,9,9,0,1,0
13,487,487,11,1,10,2,1
16,491,491,135,125,10,2,1

0,115,115,36,36,0,1,0
13,142,142,7,7,0,1,0
31,165,165,26,4,22,2,1
3,174,174,26,26,0,1,0
15,187,187,28,23,5,2,1
22,188,188,59,20,39,4,3
26,191,191,22,22,0,1,0
24,214,214,12,12,0,1,0
29,218,218,36,36,0,1,0
6,235,235,8,5,3,2,1
23,256,256,6,6,0,1,0
20,259,259,30,4,26,3,2
10,261,261,18,6,12,4,3
9,265,265,19,19,0,1,0
8,271,271,118,118,0,1,0
12,283,283,27,27,0,1,0
5,306,306,5,5,0,1,0
28,311,311,1,1,0,1,0
27,339,339,35,2,33,3,2
18,345,345,51,51,0,1,0
11,353,353,34,5,29,2,1
1,373,373,51,15,36,3,2
19,373,373,41,1,40,3,2
4,381,381,27,27,0,1,0
25,391,391,25,25,0,1,0
16,398,398,10,10,0,1,0
7,404,404,11,1,10,3,2
21,427,427,40,14,26,3,2
14,436,436,3,3,0,1,0
30,467,467,22,22,0,1,0
2,474,474,61,61,0,1,0
17,487,487,19,19,0,1,0

8,109,109,5,2,3,2,1
22,114,114,28,28,0,1,0
19,121,121,14,14,0,1,0
25,133,133,17,3,14,3,2
15,140,140,3,3,0,1,0
31,181,181,17,5,12,2,1
28,194,194,17,17,0,1,0
0,201,201,1,1,0,1,0
30,223,223,4,4,0,1,0
1,234,234,24,24,0,1,0
2,236,236,1,1,0,1,0
32,239,239,15,2,13,2,1
14,258,258,3,3,0,1,0
26,268,268,21,21,0,1,0
17,284,284,10,10,0,1,0
18,306,306,33,12,21,2,1
4,311,311,7,1,6,2,1
27,316,316,9,3,6,3,2
29,318,318,51,51,0,1,0
16,365,365,83,83,0,1,0
6,373,373,6,6,0,1,0
13,375,375,1,1,0,1,0
23,398,398,10,10,0,1,0
21,408,408,79,79,0,1,0
20,409,409,49,8,41,2,1
3,409,409,62,1,61,4,3
9,414,414,102,9,93,4,3
7,416,416,141,21,120,4,3
12,444,444,122,122,0,1,0
10,451,451,71,71,0,1,0
5,471,471,77,77,0,1,0
24,478,478,7,7,0,1,0
11,483,483,67,67,0,1,0

19,125,125,7,7,0,1,0
28,128,128,3,3,0,1,0
7,148,148,6,6,0,1,0
22,162,162,26,17,9,2,1
13,178,178,34,34,0,1,0
16,189,189,7,2,5,2,1
14,194,194,1,1,0,1,0
17,206,206,36,36,0,1,0
8,229,229,12,2,10,3,2
9,229,229,9,9,0,1,0
15,235,235,23,23,0,1,0
35,255,255,1,1,0,1,0
12,262,262,16,16,0,1,0
0,268,268,57,33,24,4,3
5,290,290,15,4,11,2,1
1,309,309,28,13,15,2,1
30,313,313,130,55,75,4,3
6,319,319,16,16,0,1,0
20,324,324,15,3,12,2,1
24,342,342,34,34,0,1,0
32,343,343,11,11,0,1,0
27,352,352,7,7,0,1,0
3,357,357,70,40,30,2,1
21,359,359,40,36,4,2,1
29,380,380,71,47,24,4,3
18,403,403,14,14,0,1,0
25,404,404,3,3,0,1,0
26,432,432,71,36,35,2,1
31,433,433,32,32,0,1,0
23,437,437,83,65,18,3,2
11,444,444,15,15,0,1,0
33,449,449,14,4,10,2,1
2,454,454,98,50,48,3,2
4,471,471,18,18,0,1,0
10,491,491,38,38,0,1,0
34,496,496,55,44,11,2,1

24,102,102,19,19,0,1,0
20,148,148,3,3,0,1,0
18,151,151,33,33,0,1,0
16,153,153,15,15,0,1,0
3,168,168,3,3,0,1,0
23,181,181,3,3,0,1,0
7,199,199,7,7,0,1,0
12,202,202,20,20,0,1,0
13,203,203,7,7,0,1,0
22,217,217,11,4,7,2,1
29,219,219,6,6,0,1,0
28,228,228,2,2,0,1,0
0,258,258,35,18,17,2,1
17,270,270,7,7,0,1,0
10,286,286,1,1,0,1,0
30,294,294,2,2,0,1,0
5,295,295,39,20,19,2,1
25,302,302,44,44,0,1,0
27,317,317,52,17,35,2,1
9,332,332,2,2,0,1,0
32,333,333,25,1,24,2,1
19,347,347,69,69,0,1,0
1,352,352,33,33,0,1,0
15,374,374,22,22,0,1,0
11,382,382,135,135,0,1,0
8,402,402,17,17,0,1,0
34,409,409,157,128,29,4,3
6,409,409,86,86,0,1,0
26,411,411,9,3,6,3,2
2,414,414,97,64,33,2,1
21,420,420,37,10,27,2,1
33,426,426,42,34,8,2,1
31,436,436,12,12,0,1,0
14,437,437,44,20,24,4,3
4,462,462,10,4,6,2,1

28,132,132,4,4,0,1,0
13,145,145,11,6,5,2,1
32,158,158,11,3,8,2,1
3,166,166,8,8,0,1,0
25,166,166,32,32,0,1,0
7,175,175,27,27,0,1,0
9,201,201,40,40,0,1,0
6,203,203,29,13,16,3,2
33,224,224,3,3,0,1,0
12,238,238,3,3,0,1,0
2,242,242,3,3,0,1,0
17,253,253,14,10,4,2,1
16,272,272,4,4,0,1,0
24,297,297,1,1,0,1,0
29,300,300,85,24,61,4,3
10,301,301,75,75,0,1,0
26,313,313,23,23,0,1,0
1,335,335,73,34,39,3,2
18,341,341,9,9,0,1,0
8,355,355,8,5,3,2,1
22,355,355,16,16,0,1,0
4,360,360,6,6,0,1,0
21,369,369,24,15,9,2,1
15,385,385,57,57,0,1,0
0,401,401,19,1,18,2,1
11,435,435,1,1,0,1,0
14,437,437,74,40,34,2,1
27,448,448,98,38,60,4,3
23,449,449,111,84,27,2,1
19,450,450,14,14,0,1,0
5,450,450,76,65,11,2,1
31,450,450,42,12,30,2,1
20,453,453,45,27,18,2,1
30,482,482,87,36,51,4,3

25,105,105,10,10,0,1,0
8,120,120,24,6,18,2,1
0,120,120,32,1,31,2,1
18,132,132,5,5,0,1,0
20,154,154,9,9,0,1,0
12,162,162,18,5,13,2,1
28,162,162,5,5,0,1,0
5,180,180,10,10,0,1,0
29,184,184,58,58,0,1,0
26,202,202,6,6,0,1,0
13,224,224,44,44,0,1,0
2,226,226,7,3,4,2,1
30,230,230,12,12,0,1,0
4,231,231,64,46,18,2,1
21,244,244,4,1,3,2,1
6,247,247,8,8,0,1,0
1,251,251,2,2,0,1,0
9,256,256,80,80,0,1,0
14,270,270,26,18,8,3,2
23,302,302,10,1,9,4,3
10,365,365,37,37,0,1,0
22,374,374,74,4,70,3,2
11,387,387,1,1,0,1,0
19,388,388,262,199,63,4,3
16,396,396,6,6,0,1,0
3,441,441,38,5,33,4,3
24,441,441,1,1,0,1,0
27,451,451,15,15,0,1,0
7,470,470,10,4,6,2,1
17,477,477,7,7,0,1,0
15,481,481,15,8,7,2,1

17,110,110,1,1,0,1,0
35,129,129,12,12,0,1,0
28,132,132,16,16,0,1,0
6,139,139,19,2,17,2,1
5,177,177,12,5,7,2,1
10,196,196,9,9,0,1,0
15,197,197,39,33,6,2,1
19,201,201,42,12,30,3,2
7,207,207,9,3,6,2,1
3,210,210,8,1,7,2,1
36,232,232,9,9,0,1,0
8,252,252,36,9,27,2,1
24,261,261,84,56,28,4,3
31,266,266,23,23,0,1,0
16,268,268,50,50,0,1,0
33,275,275,25,25,0,1,0
1,280,280,46,46,0,1,0
9,284,284,18,6,12,3,2
23,293,293,2,2,0,1,0
34,303,303,47,47,0,1,0
13,306,306,11,11,0,1,0
30,312,312,30,30,0,1,0
29,320,320,55,10,45,4,3
2,337,337,20,11,9,2,1
27,340,340,11,1,10,3,2
12,361,361,33,25,8,3,2
25,367,367,41,5,36,3,2
0,374,374,17,17,0,1,0
20,401,401,40,26,14,3,2
18,403,403,15,15,0,1,0
32,405,405,52,6,46,3,2
26,409,409,24,24,0,1,0
22,421,421,18,18,0,1,0
14,442,442,10,2,8,2,1
4,446,446,12,6,6,3,2
11,470,470,38,12,26,3,2
21,485,485,40,40,0,1,0

16,111,111,1,1,0,1,0
0,122,122,6,6,0,1,0
37,126,126,3,3,0,1,0
36,132,132,27,27,0,1,0
10,140,140,12,12,0,1,0
13,142,142,10,10,0,1,0
11,150,150,2,2,0,1,0
17,151,151,15,15,0,1,0
27,166,166,44,44,0,1,0
28,175,175,56,32,24,4,3
3,176,176,32,32,0,1,0
29,183,183,1,1,0,1,0
30,198,198,18,18,0,1,0
15,210,210,5,5,0,1,0
23,245,245,1,1,0,1,0
20,256,256,43,32,11,2,1
21,260,260,8,8,0,1,0
32,264,264,6,2,4,2,1
9,286,286,9,9,0,1,0
26,291,291,8,8,0,1,0
6,304,304,4,4,0,1,0
1,317,317,63,63,0,1,0
25,319,319,16,16,0,1,0
38,319,319,17,17,0,1,0
18,337,337,12,4,8,2,1
31,351,351,142,127,15,2,1
33,360,360,16,4,12,3,2
35,369,369,49,1,48,4,3
5,374,374,44,10,34,2,1
14,382,382,12,6,6,2,1
19,395,395,69,69,0,1,0
12,399,399,46,46,0,1,0
2,422,422,41,32,9,2,1
4,425,425,13,1,12,4,3
22,452,452,23,23,0,1,0
8,456,456,1,1,0,1,0
24,477,477,11,11,0,1,0
34,478,478,4,4,0,1,0
7,499,499,62,62,0,1,0

19,108,108,14,4,10,2,1
4,110,110,9,9,0,1,0
16,126,126,9,9,0,1,0
35,134,134,16,8,8,2,1
15,137,137,12,12,0,1,0
33,138,138,9,9,0,1,0
32,148,148,1,1,0,1,0
23,163,163,14,14,0,1,0
0,193,193,28,28,0,1,0
7,195,195,31,31,0,1,0
29,202,202,13,13,0,1,0
2,215,215,1,1,0,1,0
9,238,238,2,2,0,1,0
34,247,247,37,25,12,2,1
12,261,261,10,10,0,1,0
24,262,262,7,7,0,1,0
6,268,268,25,25,0,1,0
25,269,269,3,3,0,1,0
22,289,289,2,2,0,1,0
8,313,313,57,7,50,4,3
10,314,314,16,16,0,1,0
3,329,329,32,5,27,3,2
20,334,334,4,4,0,1,0
11,346,346,61,61,0,1,0
26,357,357,113,68,45,2,1
28,379,379,26,26,0,1,0
1,413,413,143,143,0,1,0
17,443,443,10,4,6,2,1
18,446,446,1,1,0,1,0
21,454,454,1,1,0,1,0
14,465,465,32,1,31,2,1
13,469,469,14,4,10,2,1
5,472,472,17,14,3,2,1
30,486,486,39,39,0,1,0
27,489,489,94,69,25,3,2
31,498,498,201,188,13,2,1

6,102,102,11,2,9,4,3
0,106,106,21,21,0,1,0
18,120,120,15,15,0,1,0
20,122,122,2,2,0,1,0
7,129,129,3,3,0,1,0
10,131,131,6,6,0,1,0
14,164,164,23,23,0,1,0
19,181,181,26,4,22,4,3
27,187,187,17,17,0,1,0
26,197,197,27,27,0,1,0
11,197,197,113,49,64,4,3
29,202,202,3,3,0,1,0
4,209,209,4,4,0,1,0
13,226,226,12,12,0,1,0
8,241,241,1,1,0,1,0
2,260,260,48,48,0,1,0
21,284,284,36,20,16,3,2
24,308,308,93,55,38,3,2
5,312,312,6,6,0,1,0
16,325,325,20,20,0,1,0
1,340,340,15,15,0,1,0
3,357,357,23,4,19,3,2
15,362,362,23,23,0,1,0
12,404,404,90,58,32,2,1
17,405,405,20,20,0,1,0
23,433,433,27,27,0,1,0
9,436,436,62,62,0,1,0
22,450,450,141,104,37,2,1
28,465,465,19,19,0,1,0
25,472,472,13,13,0,1,0
30,486,486,8,2,6,2,1

16,110,110,2,2,0,1,0
21,118,118,14,14,0,1,0
11,119,119,11,11,0,1,0
27,126,126,7,4,3,2,1
10,131,131,8,8,0,1,0
24,138,138,14,1,13,3,2
13,139,139,25,5,20,3,2
12,163,163,6,6,0,1,0
34,186,186,13,13,0,1,0
30,200,200,11,5,6,3,2
15,210,210,2,2,0,1,0
8,218,218,11,2,9,2,1
14,218,218,17,17,0,1,0
6,222,222,1,1,0,1,0
5,230,230,26,16,10,2,1
2,253,253,6,6,0,1,0
4,289,289,7,1,6,3,2
25,304,304,86,86,0,1,0
17,313,313,9,9,0,1,0
18,315,315,5,5,0,1,0
33,319,319,3,3,0,1,0
22,323,323,48,48,0,1,0
32,345,345,29,16,13,2,1
3,351,351,44,20,24,2,1
29,362,362,50,50,0,1,0
9,366,366,35,35,0,1,0
35,370,370,24,9,15,2,1
26,385,385,64,64,0,1,0
19,397,397,209,131,78,4,3
7,402,402,7,7,0,1,0
0,411,411,74,13,61,3,2
20,425,425,41,41,0,1,0
28,432,432,3,3,0,1,0
36,436,436,17,17,0,1,0
23,443,443,31,11,20,2,1
31,472,472,107,88,19,2,1
1,484,484,10,1,9,4,3

14,136,136,31,31,0,1,0
32,152,152,11,11,0,1,0
28,157,157,3,3,0,1,0
17,176,176,44,36,8,2,1
5,181,181,16,7,9,4,3
6,210,210,18,18,0,1,0
24,262,262,77,77,0,1,0
21,264,264,3,3,0,1,0
18,275,275,41,41,0,1,0
23,277,277,3,3,0,1,0
26,280,280,8,8,0,1,0
9,282,282,1,1,0,1,0
16,304,304,5,2,3,2,1
22,305,305,27,6,21,2,1
7,314,314,9,9,0,1,0
31,332,332,48,36,12,3,2
25,342,342,95,5,90,4,3
19,353,353,20,20,0,1,0
1,366,366,38,11,27,3,2
20,384,384,6,6,0,1,0
29,385,385,19,19,0,1,0
27,391,391,3,3,0,1,0
4,405,405,7,7,0,1,0
10,408,408,52,12,40,3,2
11,420,420,23,11,12,4,3
2,422,422,162,96,66,3,2
15,430,430,10,10,0,1,0
3,436,436,139,119,20,3,2
13,445,445,12,12,0,1,0
33,459,459,47,29,18,4,3
12,465,465,50,37,13,4,3
30,480,480,76,76,0,1,0
0,494,494,10,10,0,1,0
8,495,495,33,33,0,1,0

29,103,103,3,3,0,1,0
6,107,107,3,3,0,1,0
7,115,115,1,1,0,1,0
27,134,134,30,30,0,1,0
19,137,137,21,10,11,2,1
11,140,140,14,14,0,1,0
2,163,163,9,6,3,2,1
4,177,177,24,24,0,1,0
9,180,180,2,2,0,1,0
30,186,186,18,18,0,1,0
25,200,200,62,29,33,4,3
13,221,221,21,21,0,1,0
3,224,224,1,1,0,1,0
17,230,230,31,3,28,3,2
28,232,232,2,2,0,1,0
16,233,233,6,6,0,1,0
0,241,241,38,38,0,1,0
22,248,248,46,10,36,2,1
1,252,252,7,3,4,2,1
31,264,264,8,3,5,2,1
26,265,265,8,8,0,1,0
21,268,268,27,18,9,4,3
35,277,277,11,11,0,1,0
34,306,306,38,3,35,2,1
33,307,307,14,1,13,2,1
10,309,309,58,58,0,1,0
32,316,316,15,15,0,1,0
24,358,358,33,33,0,1,0
15,358,358,74,6,68,3,2
20,362,362,45,15,30,4,3
5,406,406,38,38,0,1,0
8,417,417,96,96,0,1,0
23,419,419,37,20,17,2,1
14,432,432,49,7,42,4,3
12,443,443,10,6,4,2,1
18,448,448,28,28,0,1,0

23,106,106,14,5,9,2,1
30,110,110,7,7,0,1,0
9,116,116,23,1,22,2,1
20,144,144,5,2,3,2,1
3,145,145,5,5,0,1,0
33,158,158,4,4,0,1,0
2,197,197,4,4,0,1,0
29,213,213,20,20,0,1,0
24,221,221,41,8,33,4,3
22,229,229,40,40,0,1,0
0,230,230,28,28,0,1,0
1,235,235,64,31,33,2,1
27,237,237,15,1,14,4,3
34,245,245,20,20,0,1,0
31,257,257,2,2,0,1,0
21,262,262,85,15,70,3,2
17,271,271,1,1,0,1,0
18,284,284,51,7,44,3,2
11,296,296,48,48,0,1,0
25,304,304,13,13,0,1,0
16,330,330,29,29,0,1,0
15,331,331,1,1,0,1,0
13,335,335,32,32,0,1,0
19,347,347,29,11,18,4,3
8,349,349,85,85,0,1,0
10,361,361,8,8,0,1,0
32,385,385,32,32,0,1,0
4,389,389,19,19,0,1,0
14,392,392,11,11,0,1,0
26,412,412,39,39,0,1,0
5,414,414,64,64,0,1,0
28,423,423,32,32,0,1,0
7,434,434,11,1,10,3,2
12,467,467,47,47,0,1,0
6,476,476,37,37,0,1,0

32,117,117,2,2,0,1,0
35,138,138,5,5,0,1,0
6,161,161,1,1,0,1,0
31,165,165,18,2,16,3,2
22,175,175,21,11,10,3,2
33,180,180,2,2,0,1,0
27,188,188,39,33,6,3,2
21,190,190,38,35,3,2,1
7,195,195,40,40,0,1,0
2,235,235,4,4,0,1,0
1,238,238,46,46,0,1,0
12,241,241,16,5,11,2,1
14,243,243,6,2,4,2,1
16,261,261,9,3,6,2,1
15,271,271,47,10,37,3,2
20,271,271,12,12,0,1,0
29,274,274,102,90,12,3,2
18,287,287,50,37,13,2,1
25,291,291,1,1,0,1,0
8,299,299,13,13,0,1,0
19,313,313,25,25,0,1,0
17,325,325,48,8,40,3,2
4,341,341,18,3,15,4,3
0,343,343,13,13,0,1,0
9,347,347,9,1,8,3,2
3,347,347,69,29,40,3,2
13,358,358,2,2,0,1,0
34,377,377,60,12,48,4,3
11,381,381,15,15,0,1,0
28,415,415,42,42,0,1,0
24,431,431,31,23,8,3,2
23,431,431,27,27,0,1,0
10,448,448,35,35,0,1,0
26,475,475,18,4,14,3,2
30,480,480,52,43,9,2,1
5,485,485,86,86,0,1,0

31,105,105,1,1,0,1,0
30,114,114,26,11,15,4,3
14,120,120,20,9,11,2,1
11,135,135,23,9,14,3,2
1,160,160,3,3,0,1,0
20,175,175,23,23,0,1,0
2,205,205,52,52,0,1,0
0,223,223,7,7,0,1,0
13,227,227,54,54,0,1,0
26,227,227,20,20,0,1,0
27,233,233,2,2,0,1,0
4,238,238,51,51,0,1,0
10,258,258,1,1,0,1,0
16,284,284,15,9,6,3,2
18,306,306,1,1,0,1,0
25,309,309,5,5,0,1,0
9,313,313,18,2,16,2,1
21,328,328,16,16,0,1,0
8,329,329,13,13,0,1,0
23,331,331,64,21,43,4,3
5,349,349,68,68,0,1,0
24,364,364,68,68,0,1,0
19,377,377,90,39,51,4,3
12,387,387,3,3,0,1,0
17,398,398,117,39,78,4,3
7,416,416,77,77,0,1,0
29,418,418,45,45,0,1,0
3,451,451,35,35,0,1,0
22,452,452,18,18,0,1,0
28,458,458,2,2,0,1,0
6,471,471,23,23,0,1,0
15,481,481,42,42,0,1,0

30,112,112,26,7,19,2,1
16,113,113,3,3,0,1,0
35,115,115,9,9,0,1,0
0,145,145,2,2,0,1,0
24,151,151,21,3,18,4,3
22,172,172,52,25,27,4,3
23,185,185,4,4,0,1,0
20,207,207,2,2,0,1,0
10,221,221,22,22,0,1,0
32,223,223,17,2,15,4,3
15,227,227,37,22,15,4,3
12,237,237,22,22,0,1,0
25,237,237,1,1,0,1,0
36,261,261,35,35,0,1,0
13,271,271,104,8,96,3,2
11,271,271,37,9,28,3,2
2,298,298,27,27,0,1,0
5,299,299,8,8,0,1,0
3,312,312,11,6,5,2,1
26,319,319,3,3,0,1,0
28,337,337,2,2,0,1,0
34,348,348,91,91,0,1,0
33,355,355,64,45,19,2,1
27,368,368,1,1,0,1,0
7,370,370,84,28,56,3,2
8,378,378,5,2,3,2,1
19,433,433,56,33,23,4,3
17,439,439,27,5,22,3,2
29,453,453,42,26,16,3,2
31,453,453,58,58,0,1,0
21,461,461,19,19,0,1,0
14,469,469,15,6,9,2,1
6,474,474,26,26,0,1,0
9,479,479,16,16,0,1,0
4,480,480,2,2,0,1,0
18,484,484,36,28,8,2,1
1,486,486,1,1,0,1,0

27,112,112,4,4,0,1,0
18,121,121,18,14,4,2,1
28,130,130,9,5,4,2,1
16,140,140,3,3,0,1,0
24,149,149,28,7,21,2,1
17,161,161,1,1,0,1,0
15,165,165,11,2,9,4,3
11,169,169,35,35,0,1,0
10,169,169,27,22,5,2,1
26,172,172,54,54,0,1,0
0,176,176,1,1,0,1,0
29,184,184,79,17,62,3,2
1,187,187,21,5,16,2,1
13,193,193,3,3,0,1,0
25,203,203,17,17,0,1,0
7,272,272,60,6,54,4,3
4,286,286,13,13,0,1,0
12,291,291,11,7,4,2,1
14,329,329,65,1,64,3,2
22,334,334,8,8,0,1,0
6,352,352,3,3,0,1,0
31,371,371,12,12,0,1,0
5,374,374,48,10,38,3,2
9,382,382,13,1,12,4,3
21,406,406,18,5,13,2,1
20,412,412,12,6,6,3,2
3,415,415,14,14,0,1,0
8,421,421,158,44,114,4,3
30,441,441,88,32,56,3,2
19,474,474,11,6,5,2,1
23,486,486,13,13,0,1,0
2,487,487,58,16,42,4,3

19,103,103,13,8,5,2,1
33,119,119,24,18,6,2,1
2,122,122,10,10,0,1,0
15,123,123,1,1,0,1,0
4,139,139,52,52,0,1,0
8,143,143,2,2,0,1,0
17,165,165,8,8,0,1,0
21,168,168,7,1,6,3,2
23,180,180,3,3,0,1,0
5,196,196,27,27,0,1,0
6,201,201,4,4,0,1,0
11,210,210,1,1,0,1,0
9,234,234,13,6,7,2,1
16,247,247,8,5,3,2,1
28,249,249,5,5,0,1,0
22,283,283,16,12,4,2,1
18,284,284,64,22,42,3,2
24,285,285,54,31,23,2,1
12,294,294,23,23,0,1,0
10,309,309,39,39,0,1,0
36,330,330,9,9,0,1,0
13,331,331,60,32,28,2,1
1,361,361,2,2,0,1,0
20,366,366,34,12,22,3,2
3,371,371,1,1,0,1,0
14,399,399,26,5,21,2,1
34,400,400,17,8,9,4,3
26,412,412,30,30,0,1,0
25,412,412,1,1,0,1,0
7,413,413,10,1,9,4,3
27,413,413,39,39,0,1,0
30,420,420,28,28,0,1,0
32,430,430,200,114,86,4,3
31,461,461,9,2,7,2,1
0,477,477,43,8,35,2,1
29,477,477,108,97,11,2,1
35,488,488,47,13,34,2,1

6,106,106,1,1,0,1,0
4,113,113,16,16,0,1,0
19,154,154,5,5,0,1,0
5,160,160,8,1,7,2,1
15,174,174,12,2,10,2,1
3,188,188,10,10,0,1,0
32,193,193,20,20,0,1,0
0,198,198,4,4,0,1,0
35,209,209,3,3,0,1,0
23,217,217,38,10,28,2,1
8,223,223,5,5,0,1,0
21,224,224,1,1,0,1,0
20,227,227,2,2,0,1,0
2,233,233,18,18,0,1,0
13,236,236,1,1,0,1,0
30,252,252,1,1,0,1,0
10,256,256,42,36,6,2,1
14,277,277,32,32,0,1,0
16,316,316,23,14,9,4,3
17,322,322,42,42,0,1,0
18,330,330,36,8,28,3,2
28,335,335,14,4,10,2,1
12,338,338,21,21,0,1,0
11,364,364,35,2,33,4,3
7,395,395,134,108,26,4,3
31,396,396,3,3,0,1,0
9,397,397,37,4,33,2,1
25,410,410,83,11,72,4,3
34,418,418,2,2,0,1,0
26,424,424,49,49,0,1,0
22,428,428,42,24,18,3,2
37,436,436,62,62,0,1,0
36,439,439,86,86,0,1,0
24,440,440,30,30,0,1,0
33,451,451,8,8,0,1,0
1,454,454,15,7,8,2,1
29,475,475,130,90,40,4,3
27,477,477,122,122,0,1,0

20,170,170,36,36,0,1,0
15,170,170,3,3,0,1,0
24,171,171,17,17,0,1,0
11,174,174,34,3,31,3,2
4,188,188,4,4,0,1,0
23,240,240,6,6,0,1,0
30,242,242,6,6,0,1,0
26,242,242,1,1,0,1,0
18,246,246,15,15,0,1,0
32,247,247,4,4,0,1,0
2,247,247,44,44,0,1,0
0,260,260,4,1,3,2,1
17,265,265,24,10,14,2,1
31,279,279,27,27,0,1,0
25,286,286,21,10,11,2,1
9,293,293,15,15,0,1,0
13,299,299,6,2,4,2,1
3,334,334,72,72,0,1,0
22,353,353,64,64,0,1,0
7,368,368,67,67,0,1,0
14,373,373,62,62,0,1,0
12,373,373,13,13,0,1,0
10,375,375,11,11,0,1,0
1,387,387,69,26,43,2,1
8,389,389,25,12,13,2,1
5,402,402,105,105,0,1,0
21,407,407,50,42,8,2,1
6,422,422,31,25,6,2,1
29,423,423,103,75,28,2,1
28,427,427,4,4,0,1,0
27,443,443,106,90,16,4,3
19,455,455,33,12,21,4,3
16,465,465,72,45,27,4,3

28,101,101,21,2,19,4,3
20,106,106,4,1,3,2,1
27,108,108,1,1,0,1,0
31,114,114,16,16,0,1,0
2,122,122,19,19,0,1,0
4,127,127,6,3,3,2,1
16,133,133,51,15,36,2,1
19,145,145,14,5,9,4,3
30,147,147,2,2,0,1,0
29,191,191,24,24,0,1,0
35,198,198,1,1,0,1,0
10,199,199,14,14,0,1,0
8,209,209,29,9,20,3,2
14,219,219,6,6,0,1,0
5,232,232,1,1,0,1,0
32,237,237,13,13,0,1,0
22,241,241,37,37,0,1,0
33,243,243,3,3,0,1,0
36,267,267,52,4,48,4,3
9,275,275,13,4,9,2,1
6,305,305,17,9,8,3,2
13,344,344,14,2,12,3,2
25,345,345,84,51,33,4,3
18,348,348,19,9,10,2,1
0,355,355,7,4,3,2,1
39,358,358,48,30,18,4,3
7,363,363,1,1,0,1,0
21,368,368,5,5,0,1,0
12,402,402,21,21,0,1,0
15,419,419,16,16,0,1,0
38,421,421,16,16,0,1,0
3,432,432,5,5,0,1,0
26,434,434,13,13,0,1,0
11,451,451,23,3,20,2,1
34,462,462,7,7,0,1,0
23,464,464,202,168,34,2,1
37,474,474,23,8,15,2,1
1,480,480,23,23,0,1,0
24,486,486,18,9,9,4,3
17,499,499,75,75,0,1,0

20,101,101,3,3,0,1,0
34,103,103,14,4,10,2,1
15,109,109,1,1,0,1,0
10,124,124,9,9,0,1,0
4,134,134,66,18,48,3,2
17,148,148,20,20,0,1,0
6,163,163,18,8,10,2,1
28,163,163,1,1,0,1,0
31,178,178,3,3,0,1,0
12,186,186,8,8,0,1,0
25,186,186,5,5,0,1,0
16,190,190,8,8,0,1,0
18,200,200,16,1,15,3,2
23,205,205,30,30,0,1,0
32,207,207,9,9,0,1,0
21,210,210,5,5,0,1,0
26,306,306,75,30,45,4,3
2,321,321,34,26,8,2,1
14,323,323,53,53,0,1,0
30,331,331,63,21,42,2,1
8,343,343,2,2,0,1,0
33,345,345,11,11,0,1,0
22,356,356,85,75,10,2,1
3,357,357,19,8,11,2,1
0,361,361,71,71,0,1,0
19,370,370,29,29,0,1,0
7,379,379,11,11,0,1,0
9,389,389,11,3,8,2,1
27,390,390,14,14,0,1,0
13,391,391,14,14,0,1,0
29,393,393,27,9,18,4,3
1,425,425,25,25,0,1,0
24,435,435,144,97,47,2,1
5,456,456,14,2,12,2,1
11,460,460,42,2,40,3,2

3,100,100,25,5,20,3,2
4,112,112,27,27,0,1,0
23,117,117,15,15,0,1,0
24,127,127,7,7,0,1,0
18,174,174,31,22,9,2,1
20,190,190,26,26,0,1,0
25,199,199,7,7,0,1,0
21,215,215,43,39,4,2,1
22,226,226,4,4,0,1,0
0,235,235,22,13,9,2,1
1,245,245,49,49,0,1,0
16,252,252,2,2,0,1,0
8,290,290,76,1,75,4,3
6,292,292,49,17,32,3,2
13,295,295,37,37,0,1,0
14,394,394,19,5,14,3,2
10,396,396,15,8,7,2,1
19,397,397,67,21,46,3,2
11,398,398,5,1,4,2,1
7,415,415,52,40,12,4,3
17,416,416,193,193,0,1,0
5,419,419,8,5,3,2,1
2,419,419,37,13,24,3,2
26,425,425,17,12,5,2,1
27,425,425,25,25,0,1,0
9,440,440,90,90,0,1,0
12,477,477,5,5,0,1,0
15,479,479,5,5,0,1,0
28,485,485,27,1,26,3,2

13,109,109,9,9,0,1,0
11,112,112,26,26,0,1,0
20,112,112,6,6,0,1,0
17,117,117,18,2,16,3,2
30,127,127,1,1,0,1,0
5,128,128,1,1,0,1,0
1,139,139,34,8,26,2,1
15,141,141,11,11,0,1,0
0,159,159,1,1,0,1,0
18,181,181,12,12,0,1,0
19,202,202,40,14,26,2,1
14,219,219,73,73,0,1,0
3,231,231,6,6,0,1,0
7,242,242,21,21,0,1,0
25,253,253,12,5,7,3,2
24,272,272,60,12,48,4,3
9,277,277,56,25,31,2,1
22,290,290,8,3,5,2,1
10,296,296,47,7,40,2,1
27,297,297,1,1,0,1,0
4,318,318,35,35,0,1,0
16,345,345,7,7,0,1,0
21,356,356,67,38,29,2,1
26,363,363,5,5,0,1,0
23,373,373,9,2,7,2,1
12,374,374,1,1,0,1,0
6,374,374,9,3,6,2,1
29,381,381,125,125,0,1,0
2,408,408,20,20,0,1,0
32,409,409,14,14,0,1,0
31,425,425,145,130,15,2,1
8,442,442,27,1,26,3,2
28,460,460,2,2,0,1,0

3,104,104,1,1,0,1,0
30,121,121,5,5,0,1,0
7,127,127,6,6,0,1,0
11,136,136,36,1,35,2,1
32,161,161,10,10,0,1,0
31,177,177,25,25,0,1,0
25,186,186,62,18,44,3,2
0,193,193,23,23,0,1,0
2,195,195,19,5,14,2,1
4,241,241,45,3,42,4,3
29,242,242,14,8,6,3,2
26,256,256,11,11,0,1,0
23,257,257,22,4,18,4,3
22,274,274,24,16,8,2,1
24,300,300,13,13,0,1,0
10,319,319,16,4,12,4,3
6,328,328,38,23,15,4,3
27,332,332,2,2,0,1,0
12,338,338,41,29,12,2,1
17,343,343,5,5,0,1,0
16,359,359,20,20,0,1,0
13,370,370,42,42,0,1,0
28,393,393,117,39,78,3,2
14,393,393,7,7,0,1,0
21,399,399,19,5,14,2,1
5,418,418,65,14,51,4,3
20,419,419,80,80,0,1,0
8,436,436,15,3,12,2,1
19,461,461,6,2,4,2,1
18,468,468,50,50,0,1,0
33,468,468,73,1,72,3,2
15,470,470,15,6,9,4,3
9,473,473,25,25,0,1,0
1,475,475,108,57,51,4,3

10,102,102,1,1,0,1,0
1,104,104,20,20,0,1,0
30,135,135,11,7,4,2,1
27,141,141,5,1,4,2,1
3,149,149,11,5,6,3,2
21,167,167,6,6,0,1,0
14,167,167,5,5,0,1,0
5,192,192,51,51,0,1,0
22,200,200,33,33,0,1,0
8,201,201,7,7,0,1,0
15,205,205,10,5,5,2,1
29,233,233,5,5,0,1,0
13,238,238,11,3,8,2,1
2,254,254,20,20,0,1,0
11,278,278,54,54,0,1,0
9,279,279,17,17,0,1,0
16,292,292,25,25,0,1,0
19,305,305,7,7,0,1,0
23,310,310,125,11,114,4,3
28,329,329,29,5,24,4,3
25,330,330,75,75,0,1,0
26,352,352,38,21,17,4,3
0,373,373,72,48,24,4,3
20,412,412,31,5,26,3,2
24,423,423,33,11,22,2,1
12,443,443,131,68,63,4,3
6,450,450,28,15,13,2,1
4,456,456,8,5,3,2,1
7,465,465,83,83,0,1,0
17,483,483,74,74,0,1,0
18,498,498,39,39,0,1,0

13,119,119,1,1,0,1,0
29,152,152,13,13,0,1,0
10,160,160,5,5,0,1,0
15,172,172,6,6,0,1,0
28,185,185,47,25,22,2,1
27,199,199,27,27,0,1,0
1,205,205,88,17,71,4,3
22,207,207,1,1,0,1,0
3,208,208,5,5,0,1,0
12,208,208,66,32,34,3,2
17,219,219,12,7,5,2,1
14,229,229,5,2,3,2,1
6,249,249,14,7,7,2,1
19,255,255,31,19,12,2,1
4,256,256,5,5,0,1,0
16,261,261,4,4,0,1,0
24,280,280,65,35,30,4,3
26,297,297,124,48,76,4,3
0,314,314,30,16,14,2,1
32,334,334,22,14,8,3,2
9,365,365,13,9,4,2,1
23,375,375,25,4,21,4,3
5,383,383,133,129,4,2,1
25,388,388,3,3,0,1,0
8,391,391,8,8,0,1,0
30,404,404,28,28,0,1,0
21,410,410,30,15,15,4,3
11,423,423,19,6,13,2,1
2,430,430,22,22,0,1,0
31,430,430,5,5,0,1,0
33,448,448,3,3,0,1,0
18,458,458,52,52,0,1,0
20,483,483,5,2,3,2,1
7,491,491,73,58,15,4,3

14,116,116,1,1,0,1,0
30,126,126,3,3,0,1,0
25,126,126,11,11,0,1,0
38,150,150,6,6,0,1,0
37,154,154,21,21,0,1,0
35,166,166,15,15,0,1,0
7,181,181,1,1,0,1,0
34,185,185,4,4,0,1,0
36,193,193,22,3,19,3,2
16,203,203,39,24,15,2,1
24,220,220,33,33,0,1,0
32,220,220,52,8,44,3,2
4,221,221,26,26,0,1,0
39,222,222,60,60,0,1,0
21,252,252,5,5,0,1,0
0,253,253,2,2,0,1,0
15,271,271,16,10,6,2,1
12,283,283,8,4,4,2,1
17,287,287,15,15,0,1,0
19,293,293,12,12,0,1,0
20,301,301,34,34,0,1,0
27,307,307,19,1,18,3,2
8,315,315,93,5,88,3,2
5,316,316,1,1,0,1,0
10,320,320,8,2,6,3,2
31,327,327,7,7,0,1,0
26,330,330,3,3,0,1,0
22,333,333,8,8,0,1,0
9,333,333,44,39,5,2,1
2,356,356,10,10,0,1,0
33,359,359,90,6,84,4,3
29,366,366,13,13,0,1,0
11,400,400,30,15,15,4,3
13,417,417,65,65,0,1,0
1,420,420,72,72,0,1,0
18,420,420,8,8,0,1,0
3,427,427,26,26,0,1,0
23,435,435,52,52,0,1,0
6,483,483,32,14,18,2,1
28,489,489,31,13,18,4,3

28,131,131,1,1,0,1,0
29,135,135,1,1,0,1,0
4,148,148,20,4,16,3,2
21,150,150,21,21,0,1,0
32,178,178,40,37,3,2,1
13,197,197,17,17,0,1,0
25,221,221,10,10,0,1,0
20,227,227,2,2,0,1,0
15,235,235,9,9,0,1,0
30,245,245,1,1,0,1,0
14,285,285,12,12,0,1,0
7,287,287,72,66,6,3,2
1,290,290,16,6,10,2,1
5,298,298,11,8,3,2,1
22,299,299,81,76,5,2,1
18,336,336,8,8,0,1,0
16,336,336,60,13,47,3,2
11,338,338,12,12,0,1,0
31,339,339,101,101,0,1,0
12,341,341,47,38,9,2,1
33,351,351,19,11,8,3,2
10,353,353,17,2,15,4,3
3,354,354,12,9,3,2,1
26,357,357,2,2,0,1,0
17,360,360,10,3,7,2,1
2,383,383,37,23,14,3,2
6,390,390,30,22,8,3,2
19,394,394,31,31,0,1,0
0,397,397,95,46,49,2,1
34,410,410,1,1,0,1,0
23,413,413,1,1,0,1,0
8,416,416,43,12,31,2,1
35,429,429,69,21,48,4,3
27,437,437,14,6,8,3,2
9,447,447,24,2,22,4,3
24,479,479,189,143,46,2,1

3,101,101,1,1,0,1,0
31,125,125,17,17,0,1,0
10,127,127,1,1,0,1,0
14,140,140,12,12,0,1,0
30,144,144,12,12,0,1,0
7,152,152,33,9,24,2,1
13,174,174,10,10,0,1,0
9,226,226,37,13,24,2,1
29,239,239,5,5,0,1,0
25,245,245,16,16,0,1,0
27,247,247,100,34,66,4,3
22,265,265,3,3,0,1,0
16,287,287,12,12,0,1,0
4,293,293,36,16,20,2,1
21,319,319,8,8,0,1,0
19,325,325,68,35,33,2,1
2,357,357,45,12,33,4,3
8,378,378,9,3,6,2,1
18,383,383,10,6,4,2,1
32,384,384,11,4,7,2,1
6,400,400,124,124,0,1,0
12,403,403,4,4,0,1,0
17,418,418,36,36,0,1,0
15,420,420,30,2,28,3,2
11,429,429,32,11,21,4,3
28,439,439,3,3,0,1,0
24,446,446,59,21,38,4,3
0,453,453,99,99,0,1,0
5,455,455,68,68,0,1,0
1,459,459,6,1,5,2,1
33,468,468,60,3,57,4,3
26,471,471,23,17,6,2,1
23,473,473,103,103,0,1,0
20,480,480,52,44,8,3,2

31,103,103,1,1,0,1,0
14,116,116,8,8,0,1,0
38,119,119,32,32,0,1,0
10,123,123,20,20,0,1,0
4,125,125,1,1,0,1,0
37,134,134,46,8,38,2,1
8,144,144,11,7,4,2,1
12,148,148,1,1,0,1,0
34,163,163,3,3,0,1,0
33,164,164,41,22,19,2,1
24,196,196,20,20,0,1,0
15,197,197,11,11,0,1,0
28,208,208,24,6,18,2,1
36,224,224,12,12,0,1,0
6,226,226,10,3,7,2,1
27,228,228,1,1,0,1,0
18,240,240,35,35,0,1,0
32,248,248,7,7,0,1,0
30,260,260,6,1,5,2,1
23,273,273,76,56,20,2,1
26,274,274,41,41,0,1,0
5,287,287,25,7,18,3,2
21,295,295,19,1,18,3,2
2,315,315,33,9,24,4,3
13,332,332,53,23,30,4,3
11,333,333,34,26,8,3,2
20,355,355,20,20,0,1,0
1,365,365,35,35,0,1,0
3,378,378,27,27,0,1,0
7,386,386,13,13,0,1,0
0,418,418,29,7,22,4,3
22,422,422,4,4,0,1,0
9,446,446,32,32,0,1,0
17,450,450,10,10,0,1,0
16,468,468,47,47,0,1,0
35,482,482,19,13,6,2,1
19,492,492,47,29,18,3,2
25,493,493,12,12,0,1,0
29,493,493,11,11,0,1,0

20,100,100,3,3,0,1,0
27,108,108,3,3,0,1,0
23,115,115,4,4,0,1,0
15,141,141,17,4,13,2,1
30,163,163,5,5,0,1,0
12,193,193,15,15,0,1,0
6,204,204,21,21,0,1,0
14,212,212,12,12,0,1,0
4,214,214,52,52,0,1,0
25,222,222,45,45,0,1,0
10,232,232,4,4,0,1,0
28,248,248,5,5,0,1,0
13,261,261,13,13,0,1,0
3,275,275,44,44,0,1,0
0,285,285,29,11,18,3,2
21,310,310,6,6,0,1,0
26,332,332,1,1,0,1,0
5,337,337,93,83,10,3,2
22,359,359,93,28,65,3,2
11,389,389,30,2,28,3,2
8,404,404,85,61,24,4,3
17,407,407,73,69,4,2,1
7,408,408,42,24,18,4,3
1,412,412,99,87,12,4,3
2,415,415,6,6,0,1,0
16,416,416,98,41,57,4,3
29,418,418,31,31,0,1,0
19,474,474,89,89,0,1,0
24,477,477,102,29,73,4,3
18,486,486,21,15,6,3,2
9,488,488,13,13,0,1,0

2,109,109,7,7,0,1,0
23,114,114,15,15,0,1,0
18,117,117,9,2,7,2,1
19,120,120,13,4,9,4,3
15,130,130,4,4,0,1,0
12,160,160,1,1,0,1,0
14,197,197,8,8,0,1,0
5,200,200,1,1,0,1,0
13,205,205,16,16,0,1,0
9,247,247,3,3,0,1,0
16,247,247,23,13,10,2,1
24,262,262,36,4,32,3,2
0,275,275,7,7,0,1,0
6,292,292,48,48,0,1,0
10,304,304,10,10,0,1,0
11,347,347,31,31,0,1,0
8,355,355,55,31,24,2,1
21,374,374,16,16,0,1,0
28,381,381,42,42,0,1,0
4,409,409,147,147,0,1,0
26,410,410,69,45,24,2,1
1,419,419,74,46,28,3,2
17,430,430,6,6,0,1,0
30,441,441,34,34,0,1,0
27,442,442,172,124,48,4,3
22,446,446,130,61,69,4,3
29,460,460,10,2,8,3,2
20,461,461,4,1,3,2,1
3,479,479,67,58,9,2,1
7,481,481,190,148,42,2,1
25,489,489,1,1,0,1,0

23,138,138,57,27,30,3,2
20,169,169,8,2,6,3,2
30,179,179,17,17,0,1,0
17,183,183,9,9,0,1,0
2,196,196,29,7,22,4,3
13,221,221,23,4,19,3,2
10,254,254,60,36,24,4,3
3,277,277,76,76,0,1,0
7,280,280,40,6,34,3,2
6,285,285,75,22,53,4,3
31,297,297,1,1,0,1,0
8,322,322,20,20,0,1,0
12,324,324,4,4,0,1,0
14,339,339,4,4,0,1,0
0,343,343,8,2,6,3,2
18,348,348,15,15,0,1,0
21,364,364,32,32,0,1,0
5,369,369,2,2,0,1,0
9,375,375,30,30,0,1,0
24,379,379,79,9,70,3,2
22,399,399,52,52,0,1,0
15,412,412,57,15,42,3,2
16,413,413,2,2,0,1,0
28,433,433,21,21,0,1,0
34,441,441,3,3,0,1,0
11,442,442,20,20,0,1,0
25,448,448,20,20,0,1,0
26,469,469,18,18,0,1,0
27,471,471,72,20,52,3,2
19,473,473,110,25,85,4,3
4,478,478,22,10,12,3,2
1,485,485,27,21,6,2,1
32,497,497,41,41,0,1,0
33,497,497,2,2,0,1,0
29,498,498,48,9,39,4,3

6,116,116,2,2,0,1,0
36,119,119,4,4,0,1,0
0,122,122,21,2,19,2,1
14,133,133,23,23,0,1,0
31,146,146,19,19,0,1,0
35,146,146,3,3,0,1,0
34,163,163,17,7,10,2,1
11,176,176,14,14,0,1,0
8,179,179,4,4,0,1,0
33,182,182,28,28,0,1,0
27,191,191,17,17,0,1,0
25,196,196,10,4,6,2,1
9,196,196,19,5,14,3,2
7,233,233,18,18,0,1,0
12,237,237,2,2,0,1,0
18,240,240,23,23,0,1,0
3,271,271,12,12,0,1,0
23,285,285,8,8,0,1,0
22,285,285,42,30,12,4,3
5,298,298,43,43,0,1,0
28,307,307,58,58,0,1,0
13,325,325,4,4,0,1,0
37,332,332,102,23,79,4,3
21,338,338,40,10,30,4,3
29,341,341,1,1,0,1,0
4,342,342,21,3,18,3,2
20,351,351,20,20,0,1,0
32,358,358,40,40,0,1,0
17,362,362,43,15,28,2,1
19,378,378,142,97,45,4,3
24,395,395,27,27,0,1,0
30,402,402,60,60,0,1,0
10,405,405,4,4,0,1,0
1,424,424,9,3,6,3,2
16,434,434,9,9,0,1,0
2,467,467,11,11,0,1,0
26,469,469,14,8,6,3,2
15,497,497,35,12,23,2,1

32,105,105,15,6,9,2,1
19,112,112,2,2,0,1,0
17,116,116,29,29,0,1,0
26,127,127,12,4,8,2,1
34,133,133,35,35,0,1,0
11,161,161,34,34,0,1,0
15,166,166,29,29,0,1,0
23,167,167,18,2,16,2,1
21,169,169,16,16,0,1,0
4,179,179,1,1,0,1,0
7,181,181,25,15,10,2,1
22,188,188,18,2,16,3,2
14,265,265,10,3,7,2,1
29,267,267,24,14,10,3,2
6,272,272,12,12,0,1,0
25,275,275,49,49,0,1,0
24,284,284,34,4,30,2,1
5,287,287,21,8,13,2,1
10,288,288,7,2,5,2,1
16,291,291,44,44,0,1,0
9,299,299,30,30,0,1,0
31,313,313,8,8,0,1,0
2,322,322,55,55,0,1,0
18,323,323,4,4,0,1,0
1,342,342,15,15,0,1,0
3,349,349,6,6,0,1,0
0,391,391,17,3,14,3,2
12,401,401,34,34,0,1,0
8,407,407,45,13,32,3,2
30,409,409,55,4,51,4,3
28,432,432,29,26,3,2,1
27,433,433,63,7,56,3,2
20,442,442,13,4,9,4,3
13,444,444,9,9,0,1,0
33,487,487,52,46,6,3,2

26,103,103,1,1,0,1,0
20,106,106,8,8,0,1,0
0,115,115,6,1,5,2,1
6,127,127,1,1,0,1,0
7,169,169,1,1,0,1,0
13,203,203,9,1,8,3,2
4,216,216,3,3,0,1,0
9,227,227,1,1,0,1,0
10,272,272,51,3,48,4,3
27,274,274,81,54,27,4,3
19,298,298,1,1,0,1,0
24,309,309,26,21,5,2,1
5,310,310,47,14,33,3,2
14,318,318,175,91,84,4,3
21,331,331,47,16,31,4,3
3,343,343,22,22,0,1,0
25,345,345,73,49,24,2,1
16,350,350,30,30,0,1,0
15,371,371,22,15,7,2,1
11,373,373,23,23,0,1,0
12,382,382,21,21,0,1,0
17,406,406,30,13,17,2,1
8,421,421,103,103,0,1,0
30,434,434,90,90,0,1,0
29,444,444,53,40,13,2,1
2,449,449,6,6,0,1,0
1,472,472,115,39,76,4,3
23,474,474,21,21,0,1,0
31,475,475,65,65,0,1,0
22,484,484,1,1,0,1,0
18,489,489,42,42,0,1,0
28,494,494,46,46,0,1,0

28,101,101,3,3,0,1,0
18,104,104,1,1,0,1,0
30,105,105,2,2,0,1,0
29,113,113,26,26,0,1,0
23,125,125,2,2,0,1,0
31,160,160,21,7,14,2,1
32,162,162,14,14,0,1,0
21,181,181,14,2,12,2,1
24,204,204,16,2,14,3,2
35,232,232,36,13,23,2,1
11,235,235,19,19,0,1,0
2,252,252,62,62,0,1,0
6,257,257,1,1,0,1,0
9,257,257,59,5,54,3,2
4,275,275,46,28,18,4,3
19,275,275,16,2,14,2,1
26,277,277,4,4,0,1,0
33,279,279,20,2,18,4,3
5,280,280,8,8,0,1,0
8,291,291,1,1,0,1,0
14,298,298,53,53,0,1,0
15,305,305,72,36,36,3,2
0,312,312,12,12,0,1,0
1,314,314,19,19,0,1,0
3,314,314,7,7,0,1,0
22,321,321,102,55,47,2,1
25,333,333,113,113,0,1,0
17,344,344,21,17,4,2,1
36,345,345,36,36,0,1,0
20,378,378,4,4,0,1,0
16,388,388,1,1,0,1,0
12,404,404,17,6,11,2,1
13,425,425,9,4,5,2,1
34,426,426,9,3,6,2,1
10,433,433,69,36,33,4,3
27,439,439,20,20,0,1,0
7,464,464,24,24,0,1,0

11,106,106,3,3,0,1,0
24,112,112,18,14,4,2,1
4,118,118,8,8,0,1,0
8,126,126,8,2,6,3,2
19,142,142,12,12,0,1,0
3,149,149,3,3,0,1,0
28,166,166,26,26,0,1,0
14,170,170,20,20,0,1,0
9,189,189,1,1,0,1,0
12,192,192,2,2,0,1,0
0,208,208,2,2,0,1,0
20,215,215,38,19,19,2,1
27,224,224,4,4,0,1,0
30,226,226,10,10,0,1,0
32,288,288,18,18,0,1,0
34,305,305,21,15,6,2,1
25,308,308,6,6,0,1,0
33,311,311,52,52,0,1,0
23,335,335,67,17,50,3,2
29,345,345,55,50,5,2,1
26,346,346,14,14,0,1,0
2,349,349,159,115,44,4,3
10,357,357,2,2,0,1,0
15,382,382,41,41,0,1,0
31,398,398,141,43,98,3,2
5,403,403,12,12,0,1,0
18,408,408,25,9,16,3,2
13,417,417,67,58,9,4,3
1,423,423,13,13,0,1,0
7,425,425,15,7,8,3,2
21,425,425,9,5,4,2,1
17,429,429,13,13,0,1,0
36,439,439,41,11,30,2,1
35,440,440,31,24,7,2,1
37,444,444,30,17,13,2,1
6,461,461,1,1,0,1,0
22,464,464,11,11,0,1,0
16,467,467,94,32,62,3,2

2,131,131,10,1,9,2,1
24,134,134,11,4,7,2,1
6,137,137,28,10,18,4,3
1,171,171,13,13,0,1,0
18,184,184,11,11,0,1,0
16,188,188,3,3,0,1,0
21,193,193,2,2,0,1,0
11,218,218,33,17,16,2,1
25,240,240,92,77,15,4,3
5,241,241,10,6,4,2,1
10,256,256,57,9,48,4,3
4,256,256,13,1,12,2,1
26,257,257,38,14,24,2,1
29,259,259,4,1,3,2,1
0,263,263,50,8,42,2,1
20,279,279,1,1,0,1,0
8,294,294,44,22,22,3,2
3,312,312,44,31,13,2,1
9,314,314,29,20,9,2,1
28,323,323,9,9,0,1,0
7,351,351,34,2,32,2,1
15,356,356,4,1,3,2,1
12,364,364,54,45,9,2,1
13,394,394,24,24,0,1,0
14,396,396,66,66,0,1,0
19,408,408,118,72,46,3,2
17,422,422,12,12,0,1,0
23,424,424,52,27,25,2,1
30,438,438,13,13,0,1,0
22,489,489,66,28,38,3,2
27,496,496,100,100,0,1,0

33,113,113,6,6,0,1,0
27,115,115,50,40,10,3,2
7,121,121,4,4,0,1,0
21,132,132,13,1,12,2,1
22,140,140,10,10,0,1,0
37,156,156,27,12,15,4,3
15,205,205,28,4,24,4,3
12,207,207,5,5,0,1,0
32,216,216,2,2,0,1,0
34,234,234,20,2,18,4,3
3,246,246,14,14,0,1,0
9,277,277,8,2,6,3,2
0,289,289,5,5,0,1,0
23,304,304,2,2,0,1,0
35,309,309,9,9,0,1,0
28,310,310,7,1,6,2,1
20,313,313,28,2,26,2,1
29,320,320,16,16,0,1,0
10,324,324,22,13,9,4,3
36,327,327,12,1,11,2,1
8,331,331,4,4,0,1,0
19,331,331,48,44,4,2,1
2,337,337,21,6,15,2,1
18,377,377,109,35,74,3,2
6,387,387,2,2,0,1,0
5,402,402,34,16,18,4,3
38,414,414,3,3,0,1,0
26,417,417,58,23,35,2,1
24,422,422,171,81,90,4,3
11,425,425,26,26,0,1,0
4,434,434,22,22,0,1,0
30,434,434,25,25,0,1,0
39,443,443,11,2,9,4,3
31,443,443,26,26,0,1,0
17,450,450,1,1,0,1,0
13,460,460,1,1,0,1,0
14,483,483,134,14,120,4,3
1,495,495,19,9,10,2,1
25,498,498,66,24,42,4,3
16,499,499,23,23,0,1,0

26,100,100,11,11,0,1,0
21,112,112,1,1,0,1,0
16,125,125,4,4,0,1,0
3,135,135,19,7,12,4,3
22,136,136,15,1,14,2,1
2,145,145,2,2,0,1,0
39,153,153,19,19,0,1,0
0,173,173,6,6,0,1,0
12,174,174,13,13,0,1,0
23,180,180,47,47,0,1,0
38,190,190,10,1,9,2,1
19,194,194,18,2,16,3,2
29,195,195,1,1,0,1,0
34,199,199,21,21,0,1,0
24,200,200,1,1,0,1,0
31,202,202,34,34,0,1,0
7,209,209,9,2,7,2,1
33,237,237,72,54,18,2,1
15,246,246,30,30,0,1,0
32,259,259,22,11,11,2,1
9,281,281,17,3,14,3,2
1,282,282,7,7,0,1,0
20,328,328,12,12,0,1,0
11,333,333,28,3,25,3,2
27,344,344,112,78,34,4,3
37,352,352,28,10,18,4,3
5,368,368,2,2,0,1,0
25,385,385,9,2,7,3,2
30,386,386,69,45,24,4,3
36,407,407,1,1,0,1,0
8,409,409,2,2,0,1,0
6,424,424,30,9,21,4,3
10,431,431,111,18,93,4,3
14,445,445,2,2,0,1,0
18,454,454,23,11,12,2,1
40,456,456,10,4,6,2,1
28,457,457,51,24,27,4,3
13,464,464,7,7,0,1,0
35,477,477,19,19,0,1,0
17,489,489,31,31,0,1,0
4,500,500,45,5,40,3,2

5,137,137,15,15,0,1,0
7,138,138,10,2,8,2,1
19,154,154,37,7,30,3,2
1,157,157,31,15,16,3,2
13,157,157,15,5,10,3,2
24,167,167,16,16,0,1,0
25,170,170,1,1,0,1,0
2,172,172,23,23,0,1,0
28,173,173,20,20,0,1,0
30,193,193,2,2,0,1,0
22,206,206,36,6,30,2,1
17,211,211,29,13,16,2,1
20,219,219,54,54,0,1,0
16,219,219,3,3,0,1,0
0,268,268,88,88,0,1,0
4,284,284,15,15,0,1,0
23,322,322,1,1,0,1,0
26,354,354,84,18,66,3,2
9,360,360,6,2,4,2,1
29,375,375,47,7,40,2,1
10,395,395,119,68,51,4,3
6,406,406,25,4,21,4,3
14,417,417,44,44,0,1,0
8,420,420,50,50,0,1,0
27,421,421,16,13,3,2,1
11,430,430,46,46,0,1,0
18,447,447,33,6,27,2,1
3,448,448,32,32,0,1,0
12,451,451,15,15,0,1,0
21,464,464,45,8,37,4,3
15,465,465,8,4,4,2,1

3,101,101,4,1,3,2,1
8,108,108,1,1,0,1,0
28,110,110,25,25,0,1,0
25,115,115,5,5,0,1,0
9,126,126,8,8,0,1,0
26,146,146,9,3,6,3,2
27,160,160,2,2,0,1,0
12,161,161,2,2,0,1,0
29,178,178,1,1,0,1,0
2,180,180,29,29,0,1,0
0,206,206,18,9,9,2,1
19,207,207,56,56,0,1,0
11,219,219,19,19,0,1,0
10,225,225,30,18,12,2,1
4,239,239,55,22,33,2,1
20,273,273,41,41,0,1,0
13,276,276,4,4,0,1,0
23,303,303,7,3,4,2,1
30,314,314,14,5,9,2,1
31,347,347,91,39,52,4,3
32,348,348,71,71,0,1,0
16,351,351,23,11,12,3,2
7,355,355,33,33,0,1,0
5,362,362,14,14,0,1,0
22,383,383,17,17,0,1,0
1,414,414,91,3,88,3,2
6,432,432,164,164,0,1,0
15,458,458,52,22,30,2,1
24,462,462,37,37,0,1,0
17,466,466,38,38,0,1,0
14,467,467,9,6,3,2,1
18,486,486,53,24,29,2,1
21,491,491,26,26,0,1,0

29,115,115,36,14,22,2,1
35,115,115,3,3,0,1,0
31,122,122,4,4,0,1,0
14,124,124,5,1,4,2,1
17,125,125,1,1,0,1,0
18,133,133,5,5,0,1,0
27,161,161,5,5,0,1,0
16,173,173,7,1,6,2,1
11,182,182,15,7,8,2,1
25,182,182,5,5,0,1,0
23,185,185,31,31,0,1,0
34,187,187,4,4,0,1,0
33,195,195,37,20,17,4,3
30,248,248,28,28,0,1,0
2,252,252,1,1,0,1,0
12,268,268,29,26,3,2,1
24,275,275,14,14,0,1,0
0,282,282,17,17,0,1,0
8,290,290,40,40,0,1,0
19,301,301,61,61,0,1,0
9,313,313,95,79,16,2,1
20,330,330,6,6,0,1,0
15,340,340,6,6,0,1,0
22,344,344,36,6,30,4,3
32,352,352,13,13,0,1,0
26,362,362,10,2,8,3,2
4,365,365,48,48,0,1,0
10,383,383,15,9,6,2,1
21,396,396,37,37,0,1,0
1,398,398,4,4,0,1,0
5,416,416,177,57,120,4,3
3,454,454,56,1,55,3,2
6,470,470,49,49,0,1,0
28,475,475,135,65,70,3,2
13,483,483,6,6,0,1,0
7,495,495,10,4,6,3,2

32,101,101,4,4,0,1,0
23,111,111,20,2,18,4,3
9,113,113,2,2,0,1,0
14,121,121,5,2,3,2,1
36,124,124,21,1,20,3,2
2,148,148,15,15,0,1,0
8,148,148,49,37,12,2,1
37,166,166,19,14,5,2,1
29,177,177,35,35,0,1,0
33,179,179,43,25,18,2,1
16,198,198,24,13,11,2,1
7,207,207,7,4,3,2,1
18,225,225,24,24,0,1,0
17,226,226,36,3,33,3,2
15,241,241,15,15,0,1,0
5,246,246,8,2,6,3,2
20,256,256,48,2,46,2,1
1,277,277,37,2,35,2,1
28,278,278,12,1,11,4,3
19,293,293,2,2,0,1,0
27,298,298,9,9,0,1,0
6,307,307,4,4,0,1,0
31,321,321,27,27,0,1,0
26,326,326,1,1,0,1,0
3,333,333,10,2,8,2,1
10,347,347,45,33,12,2,1
0,358,358,8,8,0,1,0
12,365,365,58,31,27,4,3
25,373,373,36,20,16,3,2
13,407,407,2,2,0,1,0
24,461,461,62,22,40,2,1
22,461,461,74,50,24,4,3
30,472,472,20,20,0,1,0
34,472,472,27,27,0,1,0
4,479,479,3,3,0,1,0
11,480,480,1,1,0,1,0
35,480,480,46,46,0,1,0
21,497,497,21,21,0,1,0

23,100,100,22,19,3,2,1
7,105,105,3,3,0,1,0
9,119,119,8,1,7,2,1
16,120,120,19,11,8,3,2
18,154,154,4,4,0,1,0
27,158,158,34,18,16,4,3
13,163,163,8,8,0,1,0
29,175,175,11,3,8,2,1
24,185,185,23,23,0,1,0
33,197,197,5,5,0,1,0
30,206,206,14,14,0,1,0
6,211,211,1,1,0,1,0
31,222,222,2,2,0,1,0
22,245,245,25,16,9,4,3
32,275,275,47,47,0,1,0
15,275,275,12,6,6,3,2
20,292,292,43,43,0,1,0
21,295,295,7,7,0,1,0
0,297,297,29,29,0,1,0
19,303,303,26,26,0,1,0
2,304,304,90,66,24,2,1
5,309,309,3,3,0,1,0
26,320,320,43,17,26,2,1
1,322,322,2,2,0,1,0
14,343,343,82,42,40,4,3
17,347,347,31,31,0,1,0
3,349,349,38,38,0,1,0
12,357,357,6,6,0,1,0
25,370,370,70,70,0,1,0
4,379,379,81,81,0,1,0
8,385,385,17,17,0,1,0
28,392,392,18,18,0,1,0
11,450,450,145,77,68,3,2
10,487,487,1,1,0,1,0

16,108,108,4,4,0,1,0
32,127,127,6,1,5,2,1
23,134,134,13,7,6,2,1
24,152,152,22,14,8,2,1
10,159,159,29,29,0,1,0
12,186,186,29,29,0,1,0
26,206,206,10,10,0,1,0
18,237,237,1,1,0,1,0
2,239,239,14,5,9,4,3
33,245,245,29,29,0,1,0
6,262,262,1,1,0,1,0
29,302,302,67,27,40,3,2
25,305,305,1,1,0,1,0
28,322,322,56,13,43,2,1
20,323,323,2,2,0,1,0
21,331,331,11,11,0,1,0
0,338,338,96,25,71,4,3
4,351,351,87,43,44,2,1
17,357,357,2,2,0,1,0
5,379,379,42,28,14,3,2
31,413,413,76,26,50,3,2
30,413,413,127,94,33,2,1
22,415,415,75,75,0,1,0
15,420,420,128,73,55,4,3
7,421,421,10,10,0,1,0
14,433,433,6,6,0,1,0
11,435,435,49,49,0,1,0
1,436,436,1,1,0,1,0
19,440,440,42,42,0,1,0
9,441,441,1,1,0,1,0
27,461,461,31,19,12,2,1
3,466,466,1,1,0,1,0
13,475,475,17,17,0,1,0
8,481,481,61,11,50,3,2

15,106,106,6,3,3,2,1
13,121,121,1,1,0,1,0
6,134,134,14,14,0,1,0
22,136,136,32,13,19,4,3
18,138,138,12,12,0,1,0
29,143,143,7,2,5,2,1
20,154,154,10,10,0,1,0
8,199,199,5,5,0,1,0
2,208,208,6,6,0,1,0
26,210,210,1,1,0,1,0
11,237,237,31,31,0,1,0
0,241,241,22,8,14,3,2
21,243,243,60,38,22,2,1
28,247,247,1,1,0,1,0
4,248,248,51,51,0,1,0
31,259,259,90,35,55,4,3
27,291,291,17,17,0,1,0
5,306,306,57,9,48,3,2
3,317,317,29,29,0,1,0
1,332,332,104,15,89,4,3
23,339,339,33,27,6,3,2
32,349,349,2,2,0,1,0
9,369,369,36,9,27,4,3
33,396,396,2,2,0,1,0
7,397,397,13,13,0,1,0
14,402,402,65,44,21,2,1
24,414,414,85,1,84,3,2
12,421,421,36,18,18,3,2
34,476,476,46,46,0,1,0
17,478,478,19,9,10,3,2
30,485,485,60,60,0,1,0
25,486,486,49,49,0,1,0
19,490,490,3,3,0,1,0
16,493,493,19,19,0,1,0
10,497,497,2,2,0,1,0

13,108,108,31,5,26,3,2
29,163,163,1,1,0,1,0
28,192,192,62,12,50,3,2
7,195,195,7,7,0,1,0
26,202,202,22,22,0,1,0
17,203,203,6,6,0,1,0
2,230,230,5,5,0,1,0
1,244,244,23,23,0,1,0
18,267,267,1,1,0,1,0
5,273,273,41,15,26,3,2
27,279,279,31,31,0,1,0
4,288,288,4,4,0,1,0
16,295,295,18,18,0,1,0
22,302,302,31,31,0,1,0
0,309,309,52,52,0,1,0
30,340,340,37,37,0,1,0
6,343,343,11,11,0,1,0
21,372,372,4,4,0,1,0
23,400,400,26,11,15,4,3
25,400,400,41,12,29,2,1
9,400,400,6,6,0,1,0
3,400,400,23,6,17,2,1
11,402,402,13,2,11,2,1
15,427,427,56,27,29,2,1
20,436,436,33,19,14,3,2
19,440,440,115,115,0,1,0
24,440,440,85,85,0,1,0
8,441,441,18,11,7,2,1
12,443,443,155,155,0,1,0
31,457,457,11,11,0,1,0
10,471,471,57,57,0,1,0
14,487,487,137,137,0,1,0

35,115,115,32,26,6,3,2
17,117,117,6,6,0,1,0
9,124,124,1,1,0,1,0
10,130,130,16,16,0,1,0
40,133,133,13,13,0,1,0
13,144,144,2,2,0,1,0
22,168,168,1,1,0,1,0
19,171,171,47,13,34,3,2
14,178,178,1,1,0,1,0
32,187,187,31,31,0,1,0
36,194,194,14,14,0,1,0
8,196,196,32,32,0,1,0
33,198,198,12,12,0,1,0
2,206,206,10,10,0,1,0
25,231,231,9,5,4,2,1
21,266,266,5,5,0,1,0
42,267,267,14,5,9,4,3
24,270,270,29,1,28,2,1
11,272,272,43,16,27,3,2
28,276,276,38,18,20,3,2
30,280,280,27,27,0,1,0
29,282,282,20,6,14,3,2
37,300,300,11,11,0,1,0
41,307,307,39,39,0,1,0
1,312,312,9,1,8,3,2
0,321,321,12,6,6,3,2
27,324,324,19,14,5,2,1
34,338,338,18,18,0,1,0
5,339,339,2,2,0,1,0
3,345,345,27,27,0,1,0
39,359,359,34,28,6,3,2
26,361,361,3,3,0,1,0
15,361,361,4,4,0,1,0
16,369,369,61,61,0,1,0
4,392,392,1,1,0,1,0
38,416,416,101,101,0,1,0
23,427,427,15,15,0,1,0
7,462,462,1,1,0,1,0
20,464,464,51,51,0,1,0
12,465,465,47,36,11,2,1
18,468,468,14,14,0,1,0
6,469,469,32,32,0,1,0
31,478,478,11,7,4,2,1
43,482,482,35,24,11,2,1

14,114,114,9,9,0,1,0
11,128,128,11,11,0,1,0
15,132,132,38,24,14,2,1
27,136,136,30,30,0,1,0
4,137,137,58,16,42,4,3
18,144,144,1,1,0,1,0
25,188,188,26,26,0,1,0
22,251,251,10,10,0,1,0
10,254,254,25,25,0,1,0
23,257,257,1,1,0,1,0
13,257,257,16,16,0,1,0
21,274,274,14,14,0,1,0
26,277,277,6,6,0,1,0
16,293,293,23,23,0,1,0
3,299,299,48,33,15,2,1
5,309,309,40,13,27,4,3
0,339,339,79,79,0,1,0
6,339,339,9,9,0,1,0
1,373,373,53,53,0,1,0
9,376,376,27,3,24,2,1
8,398,398,1,1,0,1,0
7,400,400,118,118,0,1,0
2,426,426,50,39,11,2,1
17,449,449,10,10,0,1,0
24,449,449,11,4,7,2,1
20,453,453,169,169,0,1,0
12,480,480,8,2,6,3,2
19,481,481,107,100,7,2,1

31,142,142,27,27,0,1,0
26,143,143,8,8,0,1,0
7,154,154,21,6,15,2,1
23,158,158,2,2,0,1,0
13,163,163,1,1,0,1,0
30,178,178,11,11,0,1,0
8,181,181,86,20,66,4,3
10,199,199,3,3,0,1,0
24,203,203,5,5,0,1,0
3,258,258,17,11,6,3,2
25,283,283,76,76,0,1,0
12,298,298,26,12,14,3,2
0,304,304,9,9,0,1,0
20,304,304,61,4,57,4,3
15,312,312,21,21,0,1,0
1,313,313,13,13,0,1,0
5,322,322,59,59,0,1,0
22,324,324,34,34,0,1,0
28,345,345,20,1,19,2,1
14,346,346,61,28,33,3,2
17,376,376,9,9,0,1,0
27,384,384,37,37,0,1,0
11,399,399,109,16,93,4,3
18,405,405,22,2,20,3,2
4,429,429,1,1,0,1,0
2,430,430,20,5,15,2,1
19,433,433,21,18,3,2,1
29,434,434,11,1,10,2,1
9,449,449,58,13,45,2,1
6,490,490,17,17,0,1,0
16,493,493,59,59,0,1,0
21,499,499,157,94,63,4,3

7,115,115,2,2,0,1,0
17,126,126,21,16,5,2,1
15,144,144,2,2,0,1,0
10,146,146,16,2,14,3,2
36,148,148,6,1,5,2,1
21,157,157,12,12,0,1,0
1,161,161,7,7,0,1,0
3,177,177,13,5,8,2,1
27,177,177,20,6,14,2,1
19,181,181,11,3,8,3,2
25,181,181,13,4,9,2,1
30,183,183,5,5,0,1,0
32,226,226,4,4,0,1,0
9,251,251,1,1,0,1,0
35,252,252,14,14,0,1,0
0,259,259,11,11,0,1,0
20,260,260,33,33,0,1,0
8,272,272,17,10,7,2,1
13,274,274,43,34,9,2,1
29,299,299,45,6,39,4,3
34,328,328,8,8,0,1,0
23,349,349,39,33,6,3,2
28,361,361,57,12,45,3,2
33,366,366,78,78,0,1,0
26,386,386,73,62,11,2,1
31,387,387,11,11,0,1,0
18,390,390,4,4,0,1,0
6,404,404,114,114,0,1,0
12,418,418,73,38,35,2,1
11,431,431,83,37,46,4,3
4,438,438,24,12,12,2,1
22,440,440,45,20,25,2,1
5,455,455,20,20,0,1,0
16,458,458,2,2,0,1,0
24,488,488,109,109,0,1,0
14,494,494,34,34,0,1,0
2,496,496,60,40,20,2,1

0,118,118,5,5,0,1,0
6,127,127,59,59,0,1,0
20,130,130,27,27,0,1,0
21,130,130,7,7,0,1,0
24,134,134,10,10,0,1,0
1,140,140,18,10,8,2,1
23,155,155,8,5,3,2,1
13,160,160,9,9,0,1,0
5,161,161,1,1,0,1,0
8,167,167,2,2,0,1,0
12,170,170,1,1,0,1,0
7,215,215,1,1,0,1,0
31,230,230,25,25,0,1,0
22,238,238,3,3,0,1,0
27,243,243,5,5,0,1,0
17,246,246,27,16,11,2,1
30,255,255,14,2,12,2,1
3,297,297,62,2,60,4,3
32,301,301,21,9,12,3,2
16,308,308,42,42,0,1,0
14,324,324,62,25,37,4,3
15,329,329,9,3,6,2,1
9,359,359,13,3,10,3,2
11,368,368,31,31,0,1,0
26,385,385,87,9,78,3,2
19,412,412,70,70,0,1,0
4,414,414,33,33,0,1,0
10,418,418,58,58,0,1,0
18,420,420,13,13,0,1,0
25,429,429,101,101,0,1,0
28,453,453,27,27,0,1,0
29,467,467,48,27,21,2,1
2,468,468,101,19,82,3,2

21,117,117,3,3,0,1,0
7,124,124,14,6,8,3,2
2,127,127,65,32,33,4,3
8,129,129,1,1,0,1,0
24,132,132,4,4,0,1,0
18,134,134,39,39,0,1,0
19,143,143,2,2,0,1,0
6,148,148,16,1,15,4,3
20,149,149,21,21,0,1,0
23,157,157,15,15,0,1,0
12,159,159,18,5,13,2,1
25,180,180,3,3,0,1,0
13,180,180,21,3,18,3,2
15,202,202,37,37,0,1,0
3,205,205,8,8,0,1,0
9,215,215,41,41,0,1,0
4,282,282,94,52,42,2,1
1,320,320,12,12,0,1,0
5,335,335,24,24,0,1,0
11,338,338,48,48,0,1,0
14,366,366,17,17,0,1,0
16,366,366,6,3,3,2,1
10,396,396,108,57,51,4,3
26,409,409,4,4,0,1,0
17,422,422,15,15,0,1,0
22,427,427,186,84,102,4,3
27,466,466,15,15,0,1,0
0,475,475,8,8,0,1,0

7,111,111,20,11,9,4,3
25,111,111,20,2,18,4,3
22,127,127,32,32,0,1,0
0,131,131,1,1,0,1,0
28,134,134,3,3,0,1,0
27,143,143,52,52,0,1,0
9,161,161,10,1,9,4,3
32,162,162,3,3,0,1,0
8,167,167,25,25,0,1,0
29,173,173,5,5,0,1,0
2,181,181,20,2,18,3,2
17,194,194,34,34,0,1,0
33,196,196,4,4,0,1,0
20,218,218,10,10,0,1,0
19,219,219,3,3,0,1,0
14,230,230,9,4,5,2,1
3,243,243,68,68,0,1,0
24,244,244,5,1,4,2,1
15,247,247,19,10,9,4,3
26,247,247,33,33,0,1,0
23,248,248,26,26,0,1,0
10,279,279,58,58,0,1,0
30,301,301,83,9,74,4,3
5,308,308,24,24,0,1,0
18,311,311,17,3,14,2,1
6,317,317,48,5,43,3,2
4,339,339,4,4,0,1,0
31,340,340,2,2,0,1,0
1,376,376,2,2,0,1,0
13,381,381,41,41,0,1,0
16,402,402,6,1,5,2,1
11,425,425,83,83,0,1,0
21,485,485,10,10,0,1,0
12,498,498,12,9,3,2,1

21,101,101,2,2,0,1,0
1,102,102,37,37,0,1,0
24,118,118,26,7,19,2,1
26,120,120,6,2,4,2,1
4,122,122,1,1,0,1,0
18,147,147,3,3,0,1,0
25,158,158,2,2,0,1,0
14,173,173,6,6,0,1,0
2,177,177,18,18,0,1,0
20,213,213,110,110,0,1,0
6,220,220,53,5,48,4,3
23,240,240,13,8,5,2,1
29,241,241,6,6,0,1,0
30,261,261,24,24,0,1,0
19,273,273,14,4,10,2,1
8,274,274,21,21,0,1,0
10,280,280,4,4,0,1,0
13,287,287,9,3,6,2,1
28,295,295,17,17,0,1,0
16,296,296,34,34,0,1,0
17,304,304,8,5,3,2,1
12,304,304,11,11,0,1,0
22,315,315,52,32,20,3,2
5,317,317,43,6,37,2,1
15,329,329,8,8,0,1,0
11,347,347,7,3,4,2,1
31,351,351,22,7,15,2,1
9,363,363,34,28,6,2,1
0,374,374,45,16,29,2,1
7,387,387,94,32,62,3,2
3,389,389,71,20,51,4,3
27,441,441,101,101,0,1,0

13,104,104,12,2,10,3,2
26,113,113,22,12,10,2,1
11,126,126,17,17,0,1,0
14,143,143,2,2,0,1,0
4,155,155,18,9,9,4,3
34,162,162,28,13,15,3,2
19,167,167,5,1,4,2,1
17,176,176,7,7,0,1,0
16,189,189,6,6,0,1,0
30,197,197,13,2,11,2,1
28,206,206,1,1,0,1,0
7,207,207,2,2,0,1,0
5,227,227,5,5,0,1,0
10,234,234,63,9,54,4,3
29,306,306,30,30,0,1,0
1,316,316,15,3,12,4,3
33,319,319,2,2,0,1,0
12,320,320,56,56,0,1,0
18,323,323,6,6,0,1,0
27,323,323,9,9,0,1,0
24,330,330,23,23,0,1,0
2,332,332,49,18,31,2,1
22,334,334,64,39,25,2,1
20,336,336,18,18,0,1,0
6,344,344,118,118,0,1,0
32,349,349,21,21,0,1,0
8,353,353,7,7,0,1,0
21,378,378,44,44,0,1,0
36,393,393,96,96,0,1,0
25,394,394,55,55,0,1,0
3,423,423,22,22,0,1,0
35,433,433,9,3,6,2,1
0,440,440,25,25,0,1,0
9,463,463,24,6,18,2,1
23,475,475,25,25,0,1,0
31,475,475,103,103,0,1,0
15,496,496,5,5,0,1,0

2,103,103,1,1,0,1,0
1,107,107,7,7,0,1,0
27,109,109,39,19,20,2,1
12,127,127,9,9,0,1,0
16,143,143,7,2,5,2,1
13,147,147,27,27,0,1,0
26,152,152,23,4,19,2,1
11,169,169,3,3,0,1,0
31,204,204,31,18,13,2,1
21,204,204,24,10,14,2,1
3,231,231,1,1,0,1,0
10,236,236,5,5,0,1,0
4,244,244,7,4,3,2,1
8,250,250,16,10,6,2,1
17,257,257,18,10,8,3,2
9,273,273,165,134,31,2,1
18,279,279,11,11,0,1,0
29,288,288,5,5,0,1,0
6,315,315,65,65,0,1,0
23,344,344,2,2,0,1,0
30,350,350,33,33,0,1,0
15,355,355,66,66,0,1,0
0,366,366,70,70,0,1,0
20,407,407,22,22,0,1,0
25,409,409,38,3,35,2,1
22,429,429,63,41,22,3,2
24,435,435,27,27,0,1,0
28,458,458,49,49,0,1,0
5,488,488,74,74,0,1,0
19,490,490,14,4,10,2,1
14,496,496,27,14,13,4,3
7,500,500,14,10,4,2,1

34,116,116,15,7,8,3,2
2,117,117,3,3,0,1,0
21,123,123,13,1,12,4,3
11,126,126,4,4,0,1,0
22,129,129,4,4,0,1,0
12,132,132,1,1,0,1,0
37,150,150,61,34,27,2,1
27,184,184,7,7,0,1,0
0,190,190,20,8,12,2,1
5,191,191,10,3,7,3,2
7,194,194,36,36,0,1,0
24,197,197,3,3,0,1,0
4,228,228,8,8,0,1,0
15,235,235,12,3,9,2,1
10,236,236,24,24,0,1,0
28,242,242,90,81,9,4,3
26,243,243,2,2,0,1,0
3,245,245,28,28,0,1,0
29,268,268,32,32,0,1,0
35,285,285,5,1,4,2,1
33,305,305,17,2,15,3,2
20,311,311,25,2,23,2,1
17,317,317,22,22,0,1,0
14,319,319,3,3,0,1,0
38,321,321,11,1,10,3,2
13,321,321,4,1,3,2,1
36,337,337,49,49,0,1,0
25,350,350,16,16,0,1,0
18,354,354,7,3,4,2,1
19,362,362,77,77,0,1,0
8,367,367,1,1,0,1,0
39,373,373,25,25,0,1,0
1,399,399,25,13,12,2,1
31,408,408,11,11,0,1,0
16,413,413,46,46,0,1,0
6,424,424,8,8,0,1,0
30,441,441,27,12,15,2,1
9,458,458,117,117,0,1,0
23,477,477,37,37,0,1,0
32,480,480,53,53,0,1,0

15,115,115,6,1,5,2,1
32,116,116,24,24,0,1,0
13,118,118,1,1,0,1,0
4,123,123,4,4,0,1,0
17,148,148,4,4,0,1,0
14,154,154,10,1,9,2,1
21,161,161,22,22,0,1,0
12,176,176,1,1,0,1,0
6,183,183,31,31,0,1,0
11,201,201,8,8,0,1,0
0,222,222,2,2,0,1,0
7,232,232,10,1,9,2,1
37,243,243,20,20,0,1,0
1,251,251,17,17,0,1,0
20,252,252,10,10,0,1,0
24,258,258,6,2,4,2,1
36,272,272,24,17,7,2,1
16,282,282,3,3,0,1,0
28,314,314,28,19,9,2,1
26,319,319,31,5,26,2,1
38,322,322,107,100,7,2,1
5,330,330,64,64,0,1,0
34,334,334,103,85,18,4,3
33,340,340,21,21,0,1,0
25,381,381,39,11,28,4,3
2,383,383,43,43,0,1,0
8,392,392,25,6,19,4,3
18,395,395,31,31,0,1,0
3,403,403,2,2,0,1,0
39,406,406,34,10,24,4,3
22,411,411,20,20,0,1,0
30,412,412,34,3,31,3,2
27,414,414,41,11,30,4,3
19,418,418,20,3,17,2,1
9,419,419,16,9,7,2,1
35,431,431,2,2,0,1,0
31,452,452,19,19,0,1,0
23,478,478,27,9,18,4,3
29,483,483,6,1,5,2,1
40,491,491,5,5,0,1,0
10,497,497,174,138,36,4,3

38,107,107,29,29,0,1,0
12,129,129,9,9,0,1,0
34,132,132,20,16,4,2,1
4,135,135,17,5,12,2,1
29,135,135,10,6,4,2,1
14,146,146,7,7,0,1,0
5,152,152,6,6,0,1,0
9,155,155,1,1,0,1,0
39,163,163,15,3,12,2,1
42,174,174,7,1,6,3,2
31,177,177,6,2,4,2,1
7,181,181,18,18,0,1,0
16,185,185,7,7,0,1,0
25,209,209,3,3,0,1,0
6,214,214,5,5,0,1,0
18,215,215,7,7,0,1,0
41,216,216,3,3,0,1,0
11,229,229,13,13,0,1,0
35,235,235,6,6,0,1,0
43,235,235,39,8,31,2,1
26,235,235,10,10,0,1,0
17,242,242,8,8,0,1,0
37,265,265,23,17,6,3,2
33,271,271,16,11,5,2,1
13,279,279,4,4,0,1,0
36,302,302,9,9,0,1,0
19,334,334,10,2,8,2,1
32,351,351,69,69,0,1,0
22,351,351,2,2,0,1,0
3,370,370,36,36,0,1,0
40,371,371,19,19,0,1,0
24,381,381,100,80,20,2,1
10,381,381,29,17,12,4,3
1,383,383,34,34,0,1,0
27,392,392,67,67,0,1,0
8,428,428,16,11,5,2,1
20,431,431,11,2,9,4,3
30,443,443,67,45,22,2,1
2,453,453,38,38,0,1,0
23,459,459,26,26,0,1,0
0,479,479,29,29,0,1,0
21,483,483,9,9,0,1,0
28,484,484,64,64,0,1,0
15,486,486,104,93,11,2,1

30,119,119,23,23,0,1,0
8,120,120,8,8,0,1,0
29,142,142,19,19,0,1,0
3,144,144,21,12,9,4,3
5,150,150,22,6,16,2,1
22,151,151,20,20,0,1,0
37,155,155,3,3,0,1,0
36,184,184,17,9,8,2,1
13,194,194,60,21,39,4,3
32,207,207,33,33,0,1,0
35,234,234,4,4,0,1,0
16,249,249,19,4,15,4,3
34,263,263,3,3,0,1,0
11,280,280,14,14,0,1,0
23,288,288,10,10,0,1,0
17,290,290,13,3,10,2,1
28,294,294,4,4,0,1,0
19,313,313,7,2,5,2,1
9,315,315,49,40,9,4,3
24,329,329,39,39,0,1,0
4,335,335,1,1,0,1,0
33,363,363,18,7,11,2,1
12,366,366,1,1,0,1,0
25,392,392,70,24,46,4,3
27,396,396,135,135,0,1,0
0,397,397,29,7,22,3,2
15,413,413,82,82,0,1,0
20,432,432,5,5,0,1,0
26,441,441,46,46,0,1,0
18,442,442,11,3,8,3,2
2,454,454,23,23,0,1,0
1,470,470,45,45,0,1,0
21,471,471,56,24,32,2,1
14,482,482,39,13,26,2,1
7,491,491,56,50,6,2,1
31,500,500,7,7,0,1,0
6,500,500,11,11,0,1,0
10,500,500,3,3,0,1,0

8,106,106,2,2,0,1,0
5,118,118,19,6,13,2,1
3,134,134,17,17,0,1,0
29,139,139,16,16,0,1,0
11,153,153,6,2,4,2,1
20,160,160,1,1,0,1,0
7,162,162,33,5,28,4,3
6,163,163,11,11,0,1,0
2,182,182,16,16,0,1,0
25,182,182,9,9,0,1,0
26,198,198,1,1,0,1,0
27,205,205,6,6,0,1,0
4,210,210,40,10,30,2,1
24,214,214,74,47,27,2,1
30,247,247,39,39,0,1,0
19,247,247,54,54,0,1,0
14,249,249,46,46,0,1,0
0,264,264,9,9,0,1,0
28,285,285,32,23,9,4,3
16,291,291,14,4,10,4,3
34,295,295,13,13,0,1,0
15,311,311,22,16,6,3,2
31,321,321,12,2,10,3,2
35,326,326,2,2,0,1,0
33,349,349,138,138,0,1,0
13,389,389,31,13,18,3,2
9,413,413,6,1,5,2,1
1,415,415,73,1,72,3,2
17,422,422,21,3,18,2,1
10,425,425,30,9,21,2,1
32,431,431,18,18,0,1,0
23,438,438,5,5,0,1,0
21,445,445,6,6,0,1,0
12,458,458,9,9,0,1,0
22,461,461,69,69,0,1,0
18,489,489,28,28,0,1,0

38,100,100,4,1,3,2,1
8,109,109,1,1,0,1,0
15,119,119,1,1,0,1,0
14,122,122,3,3,0,1,0
25,130,130,33,9,24,2,1
9,146,146,7,7,0,1,0
41,155,155,1,1,0,1,0
13,164,164,17,2,15,2,1
21,177,177,11,11,0,1,0
26,188,188,8,2,6,2,1
5,192,192,20,8,12,2,1
6,196,196,9,4,5,2,1
34,197,197,29,11,18,3,2
10,203,203,10,4,6,3,2
2,206,206,7,7,0,1,0
30,210,210,20,2,18,4,3
1,225,225,53,47,6,3,2
36,234,234,6,2,4,2,1
3,241,241,24,6,18,3,2
29,244,244,44,5,39,2,1
18,245,245,26,26,0,1,0
11,265,265,5,5,0,1,0
35,275,275,15,15,0,1,0
37,283,283,34,34,0,1,0
27,288,288,1,1,0,1,0
19,295,295,36,36,0,1,0
17,297,297,52,16,36,4,3
24,318,318,3,3,0,1,0
33,330,330,1,1,0,1,0
22,335,335,8,8,0,1,0
4,344,344,10,1,9,2,1
28,352,352,91,91,0,1,0
31,361,361,22,7,15,2,1
16,370,370,6,6,0,1,0
12,396,396,6,6,0,1,0
32,428,428,25,1,24,4,3
0,449,449,25,9,16,3,2
39,452,452,122,18,104,4,3
20,460,460,41,8,33,2,1
23,477,477,100,84,16,3,2
40,482,482,58,58,0,1,0
7,487,487,3,3,0,1,0

19,103,103,1,1,0,1,0
27,112,112,8,8,0,1,0
9,138,138,6,3,3,2,1
0,142,142,4,4,0,1,0
3,156,156,28,12,16,2,1
23,156,156,46,6,40,2,1
31,175,175,37,37,0,1,0
24,196,196,1,1,0,1,0
16,198,198,4,4,0,1,0
38,217,217,9,3,6,3,2
4,231,231,12,12,0,1,0
34,250,250,106,57,49,2,1
25,250,250,5,2,3,2,1
2,257,257,23,17,6,3,2
17,275,275,22,5,17,2,1
15,275,275,103,79,24,3,2
1,276,276,14,14,0,1,0
32,277,277,24,12,12,2,1
30,286,286,18,6,12,3,2
33,303,303,27,27,0,1,0
7,309,309,10,7,3,2,1
37,310,310,2,2,0,1,0
28,322,322,41,41,0,1,0
6,323,323,18,18,0,1,0
22,327,327,46,21,25,2,1
29,327,327,11,4,7,2,1
13,329,329,10,10,0,1,0
20,332,332,38,38,0,1,0
26,336,336,20,9,11,2,1
35,337,337,3,3,0,1,0
14,345,345,2,2,0,1,0
8,354,354,2,2,0,1,0
11,373,373,31,31,0,1,0
21,376,376,18,18,0,1,0
5,398,398,96,47,49,2,1
18,413,413,16,16,0,1,0
36,458,458,27,19,8,2,1
10,460,460,15,15,0,1,0
12,494,494,42,42,0,1,0

3,110,110,2,2,0,1,0
17,122,122,4,4,0,1,0
19,135,135,20,7,13,2,1
34,152,152,3,3,0,1,0
24,164,164,27,27,0,1,0
0,172,172,3,3,0,1,0
32,172,172,1,1,0,1,0
4,204,204,16,2,14,2,1
7,211,211,19,10,9,4,3
5,223,223,3,3,0,1,0
23,229,229,31,31,0,1,0
15,236,236,3,3,0,1,0
10,262,262,43,22,21,4,3
18,264,264,29,29,0,1,0
8,289,289,14,14,0,1,0
31,305,305,6,6,0,1,0
28,306,306,37,37,0,1,0
25,307,307,9,9,0,1,0
33,312,312,99,91,8,3,2
20,334,334,1,1,0,1,0
27,335,335,25,14,11,2,1
21,336,336,36,21,15,4,3
2,336,336,24,3,21,2,1
22,338,338,14,14,0,1,0
29,342,342,41,41,0,1,0
30,346,346,13,6,7,2,1
11,355,355,12,3,9,4,3
16,361,361,15,15,0,1,0
13,371,371,21,21,0,1,0
14,390,390,28,13,15,2,1
1,405,405,20,20,0,1,0
6,424,424,127,82,45,4,3
12,436,436,166,97,69,4,3
9,452,452,102,92,10,2,1
26,470,470,132,116,16,2,1

26,122,122,6,6,0,1,0
27,125,125,7,7,0,1,0
9,143,143,36,6,30,4,3
25,143,143,7,4,3,2,1
17,146,146,59,35,24,2,1
14,197,197,5,5,0,1,0
19,203,203,5,5,0,1,0
5,205,205,54,29,25,2,1
20,208,208,4,4,0,1,0
28,224,224,5,5,0,1,0
10,227,227,111,87,24,4,3
4,240,240,15,9,6,3,2
0,253,253,1,1,0,1,0
6,297,297,10,10,0,1,0
24,316,316,44,44,0,1,0
16,334,334,38,38,0,1,0
15,357,357,124,103,21,4,3
1,357,357,2,2,0,1,0
3,364,364,20,4,16,2,1
12,400,400,121,121,0,1,0
11,423,423,20,20,0,1,0
23,443,443,12,12,0,1,0
18,448,448,79,79,0,1,0
22,449,449,17,7,10,3,2
2,457,457,49,19,30,3,2
13,458,458,51,51,0,1,0
8,460,460,1,1,0,1,0
7,474,474,37,37,0,1,0
29,495,495,41,6,35,2,1
21,498,498,31,31,0,1,0

16,110,110,13,13,0,1,0
21,111,111,12,12,0,1,0
10,130,130,1,1,0,1,0
13,133,133,14,14,0,1,0
3,148,148,9,3,6,2,1
34,151,151,5,5,0,1,0
31,158,158,52,32,20,2,1
26,166,166,25,8,17,2,1
22,194,194,1,1,0,1,0
28,198,198,61,30,31,2,1
35,210,210,7,7,0,1,0
11,213,213,37,4,33,3,2
19,231,231,7,7,0,1,0
6,245,245,27,1,26,2,1
5,246,246,1,1,0,1,0
7,255,255,4,4,0,1,0
0,274,274,35,35,0,1,0
17,302,302,37,25,12,4,3
8,315,315,15,9,6,2,1
20,337,337,1,1,0,1,0
15,337,337,44,15,29,2,1
25,339,339,63,25,38,4,3
24,349,349,15,15,0,1,0
1,366,366,12,12,0,1,0
14,380,380,17,4,13,4,3
27,383,383,34,19,15,4,3
12,392,392,9,3,6,3,2
2,395,395,72,72,0,1,0
18,396,396,17,4,13,2,1
30,403,403,14,14,0,1,0
9,410,410,29,29,0,1,0
32,424,424,25,25,0,1,0
23,440,440,21,21,0,1,0
33,446,446,113,92,21,2,1
4,493,493,138,45,93,4,3
29,500,500,10,2,8,3,2

24,100,100,12,12,0,1,0
14,107,107,22,8,14,3,2
12,120,120,6,6,0,1,0
5,155,155,5,5,0,1,0
26,168,168,21,21,0,1,0
38,184,184,13,13,0,1,0
20,192,192,2,2,0,1,0
30,202,202,7,7,0,1,0
9,204,204,80,11,69,4,3
23,214,214,26,20,6,2,1
15,218,218,1,1,0,1,0
11,221,221,30,12,18,2,1
8,237,237,5,5,0,1,0
25,243,243,40,1,39,4,3
28,259,259,12,12,0,1,0
33,265,265,40,40,0,1,0
27,268,268,48,29,19,2,1
31,270,270,25,25,0,1,0
19,277,277,19,2,17,3,2
3,305,305,1,1,0,1,0
13,310,310,2,2,0,1,0
29,312,312,27,21,6,2,1
36,330,330,27,12,15,2,1
32,341,341,32,16,16,3,2
34,344,344,3,3,0,1,0
6,357,357,57,39,18,2,1
22,361,361,35,35,0,1,0
2,368,368,22,10,12,3,2
0,370,370,29,29,0,1,0
17,391,391,6,6,0,1,0
4,399,399,4,4,0,1,0
1,403,403,21,21,0,1,0
10,407,407,16,16,0,1,0
21,415,415,1,1,0,1,0
18,430,430,23,23,0,1,0
16,463,463,113,113,0,1,0
7,467,467,26,26,0,1,0
35,469,469,99,99,0,1,0
37,485,485,24,24,0,1,0

12,103,103,2,2,0,1,0
18,108,108,37,23,14,3,2
30,109,109,22,22,0,1,0
28,121,121,7,7,0,1,0
22,134,134,7,7,0,1,0
29,139,139,29,29,0,1,0
8,142,142,2,2,0,1,0
7,145,145,33,14,19,2,1
9,156,156,44,2,42,3,2
24,163,163,9,9,0,1,0
27,166,166,8,2,6,2,1
16,190,190,3,3,0,1,0
10,194,194,7,7,0,1,0
34,195,195,6,2,4,2,1
2,215,215,33,33,0,1,0
14,221,221,19,7,12,2,1
17,223,223,36,4,32,3,2
11,240,240,12,12,0,1,0
5,242,242,61,27,34,3,2
33,256,256,30,30,0,1,0
3,282,282,18,18,0,1,0
25,292,292,12,12,0,1,0
13,336,336,37,37,0,1,0
0,361,361,26,19,7,2,1
32,373,373,37,4,33,4,3
6,378,378,34,34,0,1,0
1,391,391,9,9,0,1,0
15,392,392,14,14,0,1,0
19,406,406,22,12,10,3,2
20,413,413,14,7,7,2,1
21,422,422,42,42,0,1,0
26,437,437,96,93,3,2,1
23,459,459,2,2,0,1,0
4,476,476,5,5,0,1,0
31,484,484,38,38,0,1,0

19,100,100,10,10,0,1,0
31,109,109,12,12,0,1,0
4,109,109,36,24,12,4,3
29,119,119,1,1,0,1,0
10,130,130,26,5,21,2,1
14,135,135,1,1,0,1,0
12,146,146,7,7,0,1,0
1,147,147,17,17,0,1,0
9,166,166,22,5,17,2,1
18,180,180,16,16,0,1,0
7,194,194,54,7,47,2,1
27,210,210,31,3,28,2,1
30,212,212,5,5,0,1,0
2,220,220,10,10,0,1,0
23,234,234,21,21,0,1,0
5,235,235,10,2,8,2,1
3,239,239,17,17,0,1,0
6,289,289,8,2,6,2,1
24,292,292,4,4,0,1,0
22,293,293,117,117,0,1,0
28,299,299,61,61,0,1,0
11,301,301,28,28,0,1,0
21,327,327,11,11,0,1,0
0,362,362,9,9,0,1,0
26,399,399,51,22,29,4,3
15,403,403,64,16,48,2,1
17,413,413,43,7,36,3,2
25,447,447,5,5,0,1,0
32,473,473,19,13,6,2,1
13,473,473,41,21,20,3,2
20,484,484,82,82,0,1,0
16,485,485,30,2,28,2,1
8,485,485,19,4,15,4,3

4,123,123,2,2,0,1,0
2,162,162,11,11,0,1,0
24,181,181,1,1,0,1,0
7,183,183,13,13,0,1,0
9,186,186,2,2,0,1,0
29,187,187,24,24,0,1,0
15,191,191,28,28,0,1,0
16,204,204,1,1,0,1,0
35,208,208,56,29,27,4,3
34,208,208,19,3,16,2,1
26,212,212,7,7,0,1,0
14,223,223,13,13,0,1,0
28,249,249,14,14,0,1,0
33,256,256,11,4,7,2,1
20,268,268,11,1,10,2,1
25,273,273,11,2,9,4,3
18,276,276,4,4,0,1,0
22,278,278,107,107,0,1,0
27,279,279,111,111,0,1,0
36,283,283,31,31,0,1,0
19,297,297,75,23,52,3,2
13,307,307,6,2,4,2,1
17,307,307,20,20,0,1,0
5,317,317,9,9,0,1,0
32,326,326,21,9,12,3,2
38,337,337,11,11,0,1,0
6,337,337,56,56,0,1,0
37,340,340,16,7,9,4,3
3,345,345,51,51,0,1,0
10,380,380,35,5,30,3,2
11,386,386,11,11,0,1,0
0,391,391,5,5,0,1,0
39,394,394,71,25,46,3,2
23,404,404,19,19,0,1,0
8,409,409,1,1,0,1,0
30,427,427,33,7,26,3,2
12,439,439,5,5,0,1,0
31,454,454,45,45,0,1,0
1,478,478,23,8,15,2,1
21,488,488,6,6,0,1,0

25,104,104,7,4,3,2,1
12,131,131,1,1,0,1,0
31,138,138,1,1,0,1,0
19,185,185,5,5,0,1,0
10,191,191,23,23,0,1,0
13,203,203,27,27,0,1,0
23,208,208,55,55,0,1,0
5,235,235,75,20,55,3,2
15,238,238,8,8,0,1,0
14,247,247,12,12,0,1,0
0,248,248,4,4,0,1,0
20,252,252,58,52,6,2,1
8,270,270,51,51,0,1,0
9,291,291,23,23,0,1,0
26,303,303,31,19,12,2,1
11,303,303,23,9,14,3,2
3,325,325,1,1,0,1,0
22,332,332,12,8,4,2,1
17,332,332,13,13,0,1,0
29,364,364,50,18,32,3,2
1,380,380,29,17,12,2,1
21,416,416,134,104,30,2,1
16,416,416,122,122,0,1,0
30,423,423,21,21,0,1,0
7,429,429,51,51,0,1,0
24,436,436,5,5,0,1,0
6,456,456,117,117,0,1,0
2,465,465,74,74,0,1,0
27,470,470,14,6,8,2,1
18,471,471,13,7,6,3,2
4,476,476,47,10,37,2,1
28,496,496,26,9,17,2,1

26,103,103,14,14,0,1,0
37,106,106,25,10,15,2,1
22,110,110,7,1,6,3,2
24,110,110,23,11,12,3,2
12,114,114,8,8,0,1,0
7,115,115,13,7,6,3,2
34,147,147,6,3,3,2,1
16,170,170,8,8,0,1,0
3,179,179,35,15,20,3,2
8,182,182,22,22,0,1,0
36,187,187,5,1,4,2,1
32,198,198,25,25,0,1,0
15,237,237,7,7,0,1,0
2,238,238,47,20,27,2,1
5,247,247,7,7,0,1,0
21,251,251,19,1,18,4,3
9,266,266,4,1,3,2,1
35,270,270,3,3,0,1,0
31,270,270,36,14,22,3,2
17,272,272,46,10,36,2,1
20,298,298,3,3,0,1,0
19,303,303,10,3,7,2,1
11,307,307,7,7,0,1,0
27,309,309,49,1,48,2,1
18,338,338,12,12,0,1,0
1,338,338,22,22,0,1,0
30,339,339,78,78,0,1,0
0,364,364,38,38,0,1,0
10,367,367,11,11,0,1,0
25,368,368,7,4,3,2,1
28,377,377,42,42,0,1,0
4,402,402,89,5,84,4,3
6,404,404,11,11,0,1,0
23,446,446,21,17,4,2,1
13,455,455,55,1,54,4,3
14,461,461,21,17,4,2,1
29,488,488,14,14,0,1,0
33,489,489,45,45,0,1,0

7,112,112,1,1,0,1,0
21,115,115,4,4,0,1,0
10,147,147,2,2,0,1,0
3,148,148,10,4,6,3,2
1,154,154,4,4,0,1,0
14,165,165,2,2,0,1,0
31,188,188,29,4,25,2,1
11,188,188,31,3,28,2,1
24,190,190,13,10,3,2,1
4,199,199,69,43,26,2,1
30,207,207,8,8,0,1,0
27,207,207,107,18,89,4,3
29,229,229,8,4,4,2,1
22,255,255,31,31,0,1,0
5,271,271,9,9,0,1,0
9,271,271,41,41,0,1,0
17,289,289,63,14,49,2,1
16,300,300,30,24,6,2,1
0,303,303,35,26,9,4,3
25,308,308,6,6,0,1,0
6,311,311,20,20,0,1,0
26,340,340,25,1,24,4,3
23,377,377,28,4,24,4,3
2,392,392,13,5,8,3,2
32,398,398,9,3,6,2,1
13,399,399,47,25,22,3,2
20,409,409,13,6,7,2,1
19,426,426,67,31,36,4,3
18,448,448,25,13,12,4,3
28,458,458,5,5,0,1,0
8,482,482,77,13,64,4,3
12,498,498,25,25,0,1,0
15,499,499,168,153,15,4,3

29,104,104,6,2,4,2,1
19,108,108,7,7,0,1,0
22,114,114,7,7,0,1,0
15,115,115,1,1,0,1,0
34,119,119,25,25,0,1,0
6,120,120,1,1,0,1,0
31,132,132,5,5,0,1,0
25,135,135,6,6,0,1,0
18,136,136,19,19,0,1,0
4,142,142,30,30,0,1,0
17,147,147,5,2,3,2,1
26,153,153,49,43,6,3,2
36,153,153,25,16,9,3,2
16,156,156,4,1,3,2,1
37,159,159,51,12,39,3,2
23,160,160,1,1,0,1,0
12,192,192,2,2,0,1,0
24,197,197,2,2,0,1,0
20,205,205,5,5,0,1,0
5,238,238,39,39,0,1,0
13,249,249,28,10,18,3,2
30,283,283,26,8,18,3,2
7,285,285,4,4,0,1,0
14,288,288,28,28,0,1,0
9,320,320,19,13,6,2,1
0,322,322,11,11,0,1,0
8,337,337,33,9,24,2,1
38,342,342,13,13,0,1,0
11,347,347,40,17,23,2,1
3,398,398,29,29,0,1,0
27,412,412,35,5,30,2,1
35,438,438,39,39,0,1,0
2,441,441,10,10,0,1,0
10,456,456,50,50,0,1,0
1,460,460,42,42,0,1,0
33,461,461,4,1,3,2,1
28,468,468,33,33,0,1,0
32,485,485,60,8,52,3,2
21,488,488,89,11,78,4,3

23,131,131,5,5,0,1,0
34,137,137,2,2,0,1,0
24,138,138,43,25,18,3,2
0,153,153,22,10,12,2,1
4,154,154,29,26,3,2,1
17,162,162,8,1,7,2,1
21,170,170,16,6,10,3,2
13,182,182,30,30,0,1,0
33,183,183,17,5,12,3,2
11,190,190,16,16,0,1,0
10,205,205,1,1,0,1,0
16,216,216,5,5,0,1,0
35,228,228,11,11,0,1,0
27,251,251,2,2,0,1,0
2,258,258,19,6,13,2,1
25,289,289,31,3,28,3,2
31,297,297,40,10,30,3,2
1,306,306,17,17,0,1,0
9,311,311,35,35,0,1,0
28,318,318,9,3,6,3,2
22,322,322,47,22,25,4,3
14,325,325,20,5,15,2,1
32,333,333,56,56,0,1,0
20,351,351,22,13,9,2,1
18,356,356,42,14,28,2,1
30,356,356,28,6,22,2,1
3,361,361,38,38,0,1,0
6,398,398,4,4,0,1,0
29,414,414,114,30,84,4,3
26,433,433,41,26,15,4,3
7,439,439,19,15,4,2,1
8,451,451,80,10,70,4,3
12,472,472,28,10,18,3,2
5,477,477,80,51,29,3,2
15,484,484,28,9,19,3,2
19,490,490,16,1,15,4,3

18,113,113,14,14,0,1,0
16,118,118,1,1,0,1,0
5,126,126,2,2,0,1,0
31,129,129,16,16,0,1,0
27,151,151,18,18,0,1,0
8,155,155,39,12,27,2,1
4,182,182,6,6,0,1,0
30,184,184,7,4,3,2,1
21,187,187,19,9,10,2,1
23,188,188,23,23,0,1,0
2,197,197,22,22,0,1,0
26,208,208,9,6,3,2,1
11,221,221,3,3,0,1,0
6,248,248,68,68,0,1,0
20,271,271,14,14,0,1,0
7,286,286,60,24,36,4,3
14,287,287,35,35,0,1,0
9,290,290,11,11,0,1,0
17,304,304,36,36,0,1,0
34,306,306,42,37,5,2,1
32,332,332,57,57,0,1,0
19,336,336,21,15,6,2,1
10,339,339,34,5,29,2,1
24,340,340,39,39,0,1,0
15,359,359,39,17,22,2,1
33,371,371,54,32,22,2,1
12,388,388,38,20,18,2,1
22,407,407,41,2,39,3,2
1,410,410,38,8,30,4,3
13,421,421,16,16,0,1,0
3,447,447,13,13,0,1,0
0,448,448,18,14,4,2,1
25,465,465,4,4,0,1,0
28,487,487,55,55,0,1,0
29,490,490,76,21,55,4,3

7,139,139,9,9,0,1,0
5,144,144,19,7,12,4,3
17,195,195,2,2,0,1,0
16,195,195,11,4,7,2,1
4,221,221,43,40,3,2,1
34,225,225,66,35,31,2,1
6,230,230,70,70,0,1,0
30,243,243,21,8,13,4,3
2,253,253,11,11,0,1,0
32,267,267,10,6,4,2,1
28,268,268,25,25,0,1,0
1,271,271,42,8,34,3,2
23,271,271,8,8,0,1,0
11,274,274,10,10,0,1,0
9,307,307,8,8,0,1,0
3,315,315,15,15,0,1,0
18,325,325,89,23,66,4,3
21,326,326,14,14,0,1,0
15,347,347,11,11,0,1,0
33,360,360,8,3,5,2,1
22,364,364,1,1,0,1,0
0,364,364,10,10,0,1,0
29,374,374,11,11,0,1,0
12,397,397,30,21,9,2,1
19,402,402,14,14,0,1,0
27,405,405,38,38,0,1,0
10,407,407,40,35,5,2,1
24,420,420,21,21,0,1,0
26,446,446,13,13,0,1,0
14,454,454,113,105,8,3,2
25,456,456,49,15,34,2,1
31,459,459,143,74,69,4,3
20,463,463,88,39,49,2,1
13,472,472,22,22,0,1,0
8,476,476,49,49,0,1,0

17,106,106,1,1,0,1,0
28,110,110,1,1,0,1,0
2,113,113,31,31,0,1,0
25,146,146,14,1,13,4,3
7,151,151,38,38,0,1,0
0,165,165,12,12,0,1,0
31,177,177,1,1,0,1,0
18,214,214,12,12,0,1,0
12,215,215,12,12,0,1,0
6,217,217,1,1,0,1,0
4,222,222,61,61,0,1,0
14,233,233,23,12,11,2,1
13,262,262,4,1,3,2,1
22,279,279,16,16,0,1,0
32,297,297,99,83,16,4,3
23,301,301,13,3,10,2,1
9,307,307,36,36,0,1,0
15,310,310,13,13,0,1,0
29,315,315,49,8,41,3,2
35,319,319,6,6,0,1,0
19,332,332,9,9,0,1,0
3,336,336,4,4,0,1,0
30,342,342,13,13,0,1,0
27,381,381,25,25,0,1,0
5,390,390,30,18,12,2,1
24,390,390,50,8,42,4,3
20,403,403,99,84,15,2,1
26,411,411,2,2,0,1,0
21,414,414,1,1,0,1,0
33,451,451,102,20,82,4,3
16,458,458,18,12,6,2,1
11,462,462,80,11,69,4,3
10,468,468,19,9,10,3,2
36,472,472,16,16,0,1,0
8,478,478,22,8,14,2,1
34,497,497,129,129,0,1,0
1,500,500,7,7,0,1,0

8,106,106,7,7,0,1,0
23,117,117,6,6,0,1,0
7,157,157,23,23,0,1,0
9,212,212,5,2,3,2,1
20,221,221,34,34,0,1,0
1,226,226,44,39,5,2,1
4,232,232,101,11,90,3,2
22,235,235,24,12,12,2,1
3,242,242,32,32,0,1,0
17,251,251,107,8,99,4,3
19,270,270,17,1,16,2,1
21,271,271,1,1,0,1,0
0,289,289,103,103,0,1,0
5,321,321,68,54,14,3,2
10,343,343,3,3,0,1,0
15,348,348,25,4,21,2,1
6,354,354,42,30,12,4,3
24,371,371,59,59,0,1,0
16,374,374,87,19,68,3,2
12,376,376,37,37,0,1,0
13,388,388,58,45,13,2,1
14,397,397,9,9,0,1,0
2,429,429,47,23,24,4,3
18,441,441,11,11,0,1,0
11,442,442,32,18,14,3,2

20,101,101,6,6,0,1,0
4,108,108,11,11,0,1,0
11,122,122,15,15,0,1,0
23,123,123,43,35,8,3,2
3,160,160,56,4,52,3,2
25,164,164,14,14,0,1,0
29,174,174,26,4,22,3,2
2,176,176,30,15,15,4,3
22,180,180,26,4,22,2,1
0,217,217,1,1,0,1,0
5,218,218,45,31,14,2,1
26,225,225,32,32,0,1,0
9,228,228,15,15,0,1,0
18,284,284,9,9,0,1,0
27,317,317,10,10,0,1,0
7,331,331,8,1,7,2,1
1,369,369,20,12,8,3,2
13,373,373,23,23,0,1,0
24,379,379,8,8,0,1,0
28,381,381,37,37,0,1,0
19,382,382,85,34,51,4,3
21,416,416,104,98,6,2,1
8,419,419,32,32,0,1,0
10,427,427,146,119,27,2,1
17,439,439,24,24,0,1,0
16,466,466,12,2,10,2,1
12,472,472,14,9,5,2,1
15,480,480,5,5,0,1,0
14,491,491,3,3,0,1,0
6,499,499,76,76,0,1,0

0,110,110,9,6,3,2,1
3,113,113,15,3,12,3,2
16,123,123,14,11,3,2,1
25,129,129,10,10,0,1,0
8,134,134,9,9,0,1,0
27,149,149,4,4,0,1,0
14,193,193,1,1,0,1,0
7,201,201,6,2,4,2,1
21,220,220,20,10,10,2,1
23,226,226,18,2,16,3,2
10,249,249,83,17,66,3,2
28,253,253,11,6,5,2,1
13,261,261,12,6,6,2,1
5,279,279,16,7,9,4,3
9,289,289,65,4,61,4,3
6,291,291,51,51,0,1,0
24,298,298,68,19,49,2,1
1,306,306,6,6,0,1,0
15,312,312,81,81,0,1,0
19,341,341,17,17,0,1,0
4,342,342,24,24,0,1,0
31,384,384,45,45,0,1,0
2,395,395,11,11,0,1,0
26,400,400,13,13,0,1,0
30,416,416,3,3,0,1,0
22,417,417,42,42,0,1,0
29,420,420,78,78,0,1,0
11,444,444,13,1,12,3,2
32,450,450,10,7,3,2,1
17,452,452,22,22,0,1,0
18,473,473,131,55,76,3,2
12,494,494,70,70,0,1,0
20,496,496,116,17,99,4,3

28,123,123,2,2,0,1,0
2,127,127,28,3,25,2,1
9,130,130,1,1,0,1,0
18,132,132,1,1,0,1,0
33,150,150,8,8,0,1,0
5,153,153,4,4,0,1,0
8,164,164,5,5,0,1,0
21,180,180,6,6,0,1,0
35,208,208,83,43,40,2,1
17,209,209,9,9,0,1,0
13,209,209,8,2,6,3,2
34,216,216,11,3,8,3,2
31,233,233,47,47,0,1,0
3,269,269,8,8,0,1,0
27,287,287,9,9,0,1,0
6,295,295,1,1,0,1,0
7,314,314,171,163,8,3,2
25,318,318,5,5,0,1,0
32,325,325,16,16,0,1,0
29,329,329,22,22,0,1,0
12,362,362,7,7,0,1,0
30,376,376,59,54,5,2,1
1,377,377,38,10,28,3,2
4,392,392,45,3,42,4,3
22,397,397,39,24,15,2,1
0,400,400,47,22,25,2,1
11,403,403,52,6,46,2,1
15,412,412,68,43,25,2,1
24,416,416,83,53,30,2,1
20,428,428,20,20,0,1,0
16,442,442,6,2,4,2,1
26,450,450,43,1,42,3,2
19,470,470,70,40,30,3,2
23,473,473,36,22,14,3,2
14,491,491,44,3,41,2,1
10,495,495,1,1,0,1,0

9,102,102,9,9,0,1,0
13,120,120,2,2,0,1,0
8,141,141,15,3,12,4,3
5,151,151,75,75,0,1,0
3,158,158,32,26,6,2,1
0,175,175,35,7,28,3,2
11,201,201,86,86,0,1,0
6,206,206,1,1,0,1,0
19,209,209,53,6,47,3,2
10,241,241,22,22,0,1,0
24,252,252,38,38,0,1,0
14,255,255,30,14,16,2,1
22,278,278,40,24,16,3,2
2,294,294,74,74,0,1,0
27,299,299,21,21,0,1,0
20,303,303,47,47,0,1,0
21,319,319,13,2,11,2,1
16,324,324,3,3,0,1,0
1,339,339,6,6,0,1,0
17,350,350,21,2,19,3,2
4,366,366,81,77,4,2,1
23,378,378,2,2,0,1,0
25,432,432,14,8,6,3,2
15,451,451,12,4,8,2,1
7,453,453,9,5,4,2,1
26,453,453,5,5,0,1,0
18,464,464,8,8,0,1,0
12,480,480,94,94,0,1,0

14,102,102,16,16,0,1,0
7,108,108,4,4,0,1,0
29,109,109,24,24,0,1,0
6,125,125,3,3,0,1,0
5,129,129,17,17,0,1,0
21,161,161,12,12,0,1,0
10,174,174,12,12,0,1,0
31,186,186,11,4,7,2,1
36,192,192,24,24,0,1,0
0,198,198,13,13,0,1,0
27,213,213,21,3,18,3,2
33,237,237,10,10,0,1,0
12,239,239,3,3,0,1,0
20,264,264,2,2,0,1,0
15,266,266,26,26,0,1,0
34,267,267,31,31,0,1,0
22,272,272,33,33,0,1,0
13,279,279,1,1,0,1,0
11,285,285,44,19,25,2,1
16,310,310,2,2,0,1,0
28,316,316,45,45,0,1,0
8,344,344,22,22,0,1,0
1,356,356,2,2,0,1,0
17,358,358,35,35,0,1,0
3,370,370,59,59,0,1,0
19,379,379,38,2,36,3,2
35,396,396,63,63,0,1,0
30,402,402,28,19,9,4,3
23,427,427,9,5,4,2,1
18,431,431,2,2,0,1,0
4,451,451,21,21,0,1,0
24,453,453,52,52,0,1,0
26,466,466,23,23,0,1,0
9,471,471,201,201,0,1,0
25,475,475,80,64,16,2,1
2,485,485,18,18,0,1,0
32,495,495,71,71,0,1,0

8,113,113,1,1,0,1,0
20,122,122,9,9,0,1,0
21,146,146,51,11,40,3,2
24,148,148,16,16,0,1,0
26,156,156,2,2,0,1,0
22,159,159,2,2,0,1,0
25,161,161,1,1,0,1,0
28,186,186,37,21,16,3,2
16,194,194,10,1,9,4,3
4,197,197,10,10,0,1,0
29,202,202,30,30,0,1,0
17,207,207,24,24,0,1,0
32,214,214,18,18,0,1,0
19,225,225,12,6,6,3,2
10,227,227,37,17,20,3,2
36,237,237,39,3,36,3,2
11,247,247,9,5,4,2,1
0,249,249,1,1,0,1,0
15,258,258,71,71,0,1,0
31,284,284,1,1,0,1,0
7,287,287,6,6,0,1,0
30,296,296,28,28,0,1,0
12,301,301,41,41,0,1,0
23,305,305,66,16,50,2,1
2,314,314,112,36,76,3,2
5,338,338,16,2,14,2,1
9,339,339,1,1,0,1,0
34,366,366,8,8,0,1,0
35,382,382,59,31,28,2,1
1,397,397,3,3,0,1,0
27,414,414,4,1,3,2,1
14,414,414,19,19,0,1,0
37,439,439,40,11,29,2,1
13,451,451,1,1,0,1,0
18,462,462,67,62,5,2,1
6,476,476,24,24,0,1,0
33,495,495,33,13,20,3,2
3,495,495,26,5,21,2,1

24,105,105,9,3,6,2,1
26,166,166,8,8,0,1,0
27,189,189,16,9,7,2,1
2,198,198,19,3,16,3,2
5,208,208,54,54,0,1,0
19,235,235,19,19,0,1,0
18,249,249,7,7,0,1,0
6,274,274,8,8,0,1,0
8,292,292,2,2,0,1,0
11,314,314,79,79,0,1,0
20,321,321,30,30,0,1,0
10,333,333,41,41,0,1,0
16,351,351,6,3,3,2,1
9,357,357,19,9,10,4,3
4,360,360,68,47,21,2,1
3,367,367,291,253,38,2,1
23,379,379,21,12,9,4,3
13,380,380,77,77,0,1,0
21,383,383,41,36,5,2,1
17,394,394,58,35,23,4,3
0,411,411,36,6,30,4,3
12,420,420,145,79,66,4,3
25,422,422,17,14,3,2,1
22,437,437,28,6,22,2,1
1,441,441,27,5,22,3,2
7,455,455,1,1,0,1,0
15,466,466,31,4,27,2,1
14,476,476,9,4,5,2,1

5,120,120,4,4,0,1,0
30,154,154,9,4,5,2,1
2,158,158,4,4,0,1,0
3,168,168,1,1,0,1,0
0,170,170,52,11,41,2,1
9,175,175,1,1,0,1,0
18,199,199,18,18,0,1,0
13,202,202,1,1,0,1,0
6,206,206,1,1,0,1,0
15,219,219,58,34,24,2,1
35,228,228,12,12,0,1,0
32,243,243,27,4,23,2,1
33,249,249,1,1,0,1,0
27,254,254,17,2,15,4,3
39,263,263,31,5,26,2,1
34,275,275,32,16,16,3,2
1,275,275,31,31,0,1,0
36,276,276,52,5,47,4,3
10,284,284,11,2,9,4,3
20,295,295,1,1,0,1,0
19,296,296,2,2,0,1,0
40,304,304,28,20,8,3,2
7,309,309,25,25,0,1,0
31,318,318,9,3,6,2,1
37,318,318,92,49,43,4,3
17,321,321,9,9,0,1,0
4,331,331,3,3,0,1,0
16,344,344,19,8,11,4,3
26,345,345,5,2,3,2,1
11,370,370,1,1,0,1,0
12,370,370,28,18,10,2,1
25,377,377,65,43,22,2,1
21,389,389,52,3,49,2,1
28,409,409,27,24,3,2,1
29,411,411,110,90,20,4,3
14,422,422,24,4,20,3,2
24,430,430,1,1,0,1,0
38,434,434,35,5,30,3,2
8,465,465,29,20,9,2,1
22,477,477,130,94,36,2,1
23,481,481,10,10,0,1,0

18,111,111,12,6,6,2,1
34,113,113,22,6,16,2,1
40,134,134,7,2,5,2,1
25,141,141,5,2,3,2,1
0,149,149,12,12,0,1,0
13,196,196,2,2,0,1,0
39,202,202,21,3,18,2,1
10,237,237,10,10,0,1,0
12,237,237,38,26,12,2,1
16,258,258,31,31,0,1,0
26,277,277,12,2,10,2,1
2,296,296,20,20,0,1,0
27,307,307,95,84,11,2,1
1,309,309,12,1,11,2,1
4,314,314,18,4,14,3,2
14,316,316,31,19,12,2,1
20,322,322,44,44,0,1,0
35,322,322,9,9,0,1,0
17,342,342,26,26,0,1,0
9,344,344,44,44,0,1,0
3,348,348,21,21,0,1,0
5,352,352,65,15,50,2,1
28,352,352,43,1,42,4,3
19,353,353,7,7,0,1,0
33,366,366,97,49,48,3,2
42,373,373,29,14,15,2,1
23,383,383,14,14,0,1,0
29,390,390,39,39,0,1,0
37,404,404,29,5,24,3,2
32,409,409,2,2,0,1,0
31,416,416,3,3,0,1,0
43,423,423,22,2,20,2,1
6,434,434,1,1,0,1,0
11,442,442,32,32,0,1,0
41,446,446,42,42,0,1,0
30,451,451,72,42,30,4,3
36,453,453,22,4,18,2,1
24,464,464,11,11,0,1,0
21,478,478,3,3,0,1,0
22,486,486,12,12,0,1,0
7,487,487,7,4,3,2,1
8,490,490,16,16,0,1,0
15,498,498,11,6,5,2,1
38,500,500,18,18,0,1,0

5,109,109,1,1,0,1,0
4,121,121,2,2,0,1,0
14,125,125,1,1,0,1,0
33,133,133,6,6,0,1,0
32,162,162,30,23,7,2,1
31,165,165,8,8,0,1,0
0,180,180,11,11,0,1,0
39,182,182,2,2,0,1,0
18,182,182,21,21,0,1,0
25,185,185,28,28,0,1,0
37,197,197,25,16,9,4,3
16,241,241,13,13,0,1,0
6,257,257,28,28,0,1,0
19,264,264,78,78,0,1,0
15,271,271,8,8,0,1,0
26,291,291,5,5,0,1,0
7,298,298,8,8,0,1,0
11,312,312,2,2,0,1,0
9,323,323,5,5,0,1,0
24,337,337,3,3,0,1,0
36,355,355,24,18,6,3,2
40,364,364,56,41,15,2,1
23,381,381,15,15,0,1,0
10,383,383,8,8,0,1,0
28,384,384,66,34,32,3,2
8,394,394,4,4,0,1,0
2,399,399,13,13,0,1,0
17,408,408,91,7,84,3,2
29,416,416,40,40,0,1,0
1,420,420,11,11,0,1,0
34,425,425,123,34,89,3,2
30,427,427,1,1,0,1,0
38,437,437,131,88,43,3,2
13,465,465,99,42,57,4,3
21,468,468,59,59,0,1,0
22,470,470,78,30,48,4,3
12,482,482,1,1,0,1,0
20,483,483,16,16,0,1,0
27,488,488,5,1,4,2,1
3,492,492,30,30,0,1,0
35,496,496,27,27,0,1,0

13,103,103,17,5,12,3,2
26,117,117,7,4,3,2,1
2,121,121,10,10,0,1,0
9,148,148,51,51,0,1,0
29,168,168,11,11,0,1,0
20,170,170,38,20,18,3,2
10,171,171,9,9,0,1,0
8,187,187,2,2,0,1,0
14,206,206,1,1,0,1,0
6,216,216,7,7,0,1,0
27,225,225,4,4,0,1,0
15,231,231,1,1,0,1,0
24,259,259,37,23,14,3,2
11,274,274,34,34,0,1,0
31,278,278,122,11,111,4,3
16,280,280,2,2,0,1,0
17,281,281,11,11,0,1,0
23,286,286,27,15,12,2,1
32,290,290,22,16,6,3,2
21,295,295,29,29,0,1,0
28,300,300,55,55,0,1,0
1,351,351,52,52,0,1,0
3,356,356,21,21,0,1,0
4,358,358,77,39,38,2,1
22,361,361,11,11,0,1,0
19,373,373,7,7,0,1,0
7,394,394,19,13,6,2,1
12,412,412,32,32,0,1,0
0,427,427,41,34,7,2,1
5,437,437,103,103,0,1,0
18,443,443,15,15,0,1,0
30,456,456,15,9,6,3,2
25,457,457,79,79,0,1,0

25,110,110,2,2,0,1,0
28,111,111,3,3,0,1,0
29,116,116,2,2,0,1,0
5,128,128,40,21,19,2,1
22,167,167,10,1,9,4,3
11,172,172,6,3,3,2,1
9,178,178,90,90,0,1,0
12,184,184,5,1,4,2,1
30,194,194,2,2,0,1,0
19,231,231,25,16,9,2,1
23,232,232,37,28,9,4,3
17,234,234,50,21,29,2,1
18,246,246,20,20,0,1,0
24,280,280,10,10,0,1,0
26,282,282,37,24,13,2,1
8,290,290,30,24,6,2,1
1,293,293,7,7,0,1,0
10,295,295,42,7,35,2,1
2,298,298,1,1,0,1,0
27,307,307,37,37,0,1,0
15,315,315,71,71,0,1,0
13,318,318,20,14,6,2,1
14,322,322,28,7,21,4,3
7,327,327,3,3,0,1,0
4,365,365,51,51,0,1,0
32,374,374,91,91,0,1,0
6,383,383,1,1,0,1,0
3,385,385,4,4,0,1,0
20,409,409,118,22,96,4,3
0,410,410,4,4,0,1,0
21,433,433,33,10,23,2,1
16,436,436,60,2,58,3,2
31,455,455,5,2,3,2,1

17,100,100,3,3,0,1,0
11,116,116,7,7,0,1,0
28,127,127,26,26,0,1,0
4,132,132,11,11,0,1,0
32,134,134,17,1,16,2,1
19,137,137,8,5,3,2,1
13,152,152,37,21,16,3,2
18,154,154,3,3,0,1,0
14,155,155,11,11,0,1,0
37,166,166,16,16,0,1,0
9,168,168,3,3,0,1,0
29,186,186,22,22,0,1,0
40,197,197,4,4,0,1,0
7,198,198,34,7,27,4,3
16,211,211,7,7,0,1,0
25,220,220,10,10,0,1,0
27,224,224,11,11,0,1,0
33,224,224,35,35,0,1,0
24,255,255,20,9,11,2,1
36,262,262,22,22,0,1,0
26,267,267,12,12,0,1,0
20,278,278,64,41,23,2,1
2,324,324,20,11,9,2,1
3,330,330,1,1,0,1,0
39,337,337,36,1,35,2,1
8,346,346,10,10,0,1,0
31,347,347,146,146,0,1,0
38,361,361,4,4,0,1,0
6,361,361,58,58,0,1,0
41,362,362,24,24,0,1,0
12,378,378,24,24,0,1,0
5,384,384,1,1,0,1,0
30,385,385,8,8,0,1,0
34,406,406,52,35,17,2,1
42,430,430,9,9,0,1,0
21,438,438,6,6,0,1,0
22,460,460,3,3,0,1,0
10,468,468,2,2,0,1,0
0,479,479,27,9,18,3,2
15,485,485,27,27,0,1,0
1,492,492,18,4,14,3,2
35,493,493,25,25,0,1,0
23,500,500,34,10,24,4,3

6,145,145,31,20,11,2,1
17,158,158,9,9,0,1,0
14,171,171,5,5,0,1,0
13,201,201,15,15,0,1,0
18,210,210,3,3,0,1,0
0,222,222,134,80,54,4,3
8,248,248,58,10,48,2,1
16,274,274,25,25,0,1,0
9,276,276,16,5,11,3,2
11,286,286,14,14,0,1,0
22,290,290,29,29,0,1,0
4,299,299,30,30,0,1,0
7,301,301,32,32,0,1,0
15,307,307,15,15,0,1,0
20,311,311,10,3,7,2,1
27,321,321,54,34,20,3,2
1,324,324,26,26,0,1,0
24,357,357,105,69,36,3,2
26,373,373,87,87,0,1,0
5,379,379,21,21,0,1,0
19,412,412,114,54,60,4,3
12,415,415,3,3,0,1,0
23,415,415,47,22,25,2,1
10,429,429,60,4,56,3,2
28,453,453,21,12,9,2,1
25,477,477,62,40,22,2,1
2,483,483,24,24,0,1,0
21,485,485,2,2,0,1,0
3,498,498,6,6,0,1,0

5,103,103,1,1,0,1,0
25,111,111,1,1,0,1,0
0,112,112,10,10,0,1,0
10,118,118,4,1,3,2,1
9,121,121,35,35,0,1,0
4,137,137,1,1,0,1,0
22,139,139,1,1,0,1,0
15,144,144,24,6,18,4,3
17,157,157,14,5,9,2,1
30,161,161,22,4,18,4,3
3,173,173,14,8,6,2,1
21,179,179,4,4,0,1,0
8,193,193,8,8,0,1,0
32,260,260,30,27,3,2,1
12,264,264,8,4,4,2,1
31,272,272,2,2,0,1,0
27,297,297,60,60,0,1,0
26,305,305,24,2,22,3,2
18,315,315,25,13,12,2,1
16,327,327,16,16,0,1,0
33,347,347,33,14,19,2,1
13,364,364,97,97,0,1,0
11,369,369,4,4,0,1,0
14,372,372,124,6,118,4,3
7,381,381,17,17,0,1,0
6,390,390,38,38,0,1,0
34,391,391,53,53,0,1,0
2,392,392,17,17,0,1,0
28,396,396,169,169,0,1,0
1,405,405,8,8,0,1,0
23,419,419,3,3,0,1,0
20,420,420,5,5,0,1,0
29,445,445,7,7,0,1,0
19,464,464,52,52,0,1,0
24,491,491,130,130,0,1,0

20,110,110,15,15,0,1,0
5,117,117,9,9,0,1,0
19,135,135,14,2,12,4,3
30,142,142,26,8,18,2,1
7,144,144,8,8,0,1,0
11,146,146,17,17,0,1,0
21,176,176,56,56,0,1,0
33,195,195,7,7,0,1,0
4,200,200,1,1,0,1,0
8,232,232,4,1,3,2,1
34,245,245,9,3,6,3,2
15,246,246,1,1,0,1,0
16,281,281,53,41,12,2,1
3,284,284,53,7,46,3,2
12,286,286,14,14,0,1,0
13,297,297,11,4,7,2,1
1,299,299,59,33,26,3,2
2,312,312,36,6,30,3,2
9,314,314,26,19,7,2,1
29,322,322,57,1,56,3,2
17,349,349,66,37,29,2,1
14,357,357,23,23,0,1,0
24,365,365,49,12,37,2,1
23,389,389,52,52,0,1,0
0,402,402,27,3,24,2,1
27,406,406,9,6,3,2,1
25,412,412,10,4,6,3,2
26,418,418,37,17,20,2,1
28,429,429,35,4,31,3,2
22,430,430,65,65,0,1,0
6,435,435,44,44,0,1,0
31,456,456,5,5,0,1,0
18,459,459,36,36,0,1,0
35,483,483,6,6,0,1,0
32,490,490,38,9,29,2,1
10,491,491,34,7,27,2,1

22,118,118,12,12,0,1,0
7,129,129,28,8,20,2,1
12,129,129,45,45,0,1,0
32,140,140,5,2,3,2,1
21,145,145,6,2,4,2,1
16,151,151,12,2,10,3,2
8,161,161,31,25,6,2,1
18,183,183,24,24,0,1,0
33,184,184,28,4,24,2,1
28,197,197,22,22,0,1,0
31,198,198,44,44,0,1,0
20,228,228,18,18,0,1,0
10,241,241,71,71,0,1,0
26,269,269,24,4,20,4,3
11,284,284,20,20,0,1,0
25,285,285,21,21,0,1,0
14,285,285,4,4,0,1,0
24,321,321,19,19,0,1,0
27,327,327,22,4,18,4,3
30,337,337,34,34,0,1,0
19,339,339,87,87,0,1,0
29,344,344,49,49,0,1,0
23,361,361,16,16,0,1,0
5,376,376,23,23,0,1,0
3,396,396,26,4,22,2,1
15,403,403,1,1,0,1,0
2,412,412,1,1,0,1,0
9,419,419,54,32,22,3,2
17,426,426,14,6,8,2,1
1,426,426,7,1,6,2,1
6,453,453,3,3,0,1,0
4,458,458,19,12,7,2,1
13,489,489,11,11,0,1,0
0,493,493,70,70,0,1,0

25,114,114,1,1,0,1,0
7,114,114,12,3,9,4,3
4,121,121,2,2,0,1,0
6,128,128,19,19,0,1,0
22,140,140,21,21,0,1,0
26,157,157,7,7,0,1,0
0,172,172,1,1,0,1,0
34,193,193,1,1,0,1,0
36,206,206,1,1,0,1,0
8,211,211,8,8,0,1,0
16,239,239,17,6,11,2,1
21,248,248,40,34,6,2,1
17,267,267,19,1,18,3,2
29,275,275,19,9,10,3,2
27,275,275,36,36,0,1,0
19,282,282,29,29,0,1,0
10,297,297,1,1,0,1,0
5,299,299,6,1,5,2,1
2,301,301,6,6,0,1,0
35,301,301,27,3,24,4,3
1,303,303,6,6,0,1,0
3,320,320,4,4,0,1,0
11,325,325,16,16,0,1,0
18,331,331,19,19,0,1,0
13,349,349,209,209,0,1,0
31,351,351,32,32,0,1,0
24,361,361,11,11,0,1,0
28,387,387,35,23,12,4,3
33,397,397,44,44,0,1,0
9,418,418,26,26,0,1,0
23,420,420,88,64,24,2,1
12,456,456,97,28,69,4,3
30,467,467,27,13,14,2,1
15,469,469,16,16,0,1,0
20,477,477,187,85,102,4,3
14,486,486,25,13,12,4,3
32,497,497,44,7,37,2,1

4,111,111,16,11,5,2,1
7,146,146,27,12,15,2,1
8,147,147,21,21,0,1,0
15,155,155,41,41,0,1,0
13,160,160,3,3,0,1,0
25,160,160,25,25,0,1,0
20,162,162,14,14,0,1,0
26,163,163,9,9,0,1,0
19,185,185,11,11,0,1,0
12,195,195,32,32,0,1,0
24,220,220,5,5,0,1,0
17,243,243,43,43,0,1,0
27,256,256,39,39,0,1,0
33,265,265,18,15,3,2,1
1,280,280,9,2,7,2,1
29,307,307,29,29,0,1,0
0,311,311,20,12,8,2,1
32,351,351,30,17,13,2,1
22,358,358,15,15,0,1,0
18,369,369,1,1,0,1,0
6,390,390,14,14,0,1,0
9,404,404,73,16,57,3,2
14,413,413,8,8,0,1,0
28,417,417,11,11,0,1,0
23,418,418,20,20,0,1,0
31,418,418,23,23,0,1,0
2,421,421,86,60,26,2,1
21,435,435,89,74,15,2,1
3,446,446,25,13,12,2,1
16,471,471,52,14,38,3,2
5,475,475,19,2,17,4,3
10,478,478,8,8,0,1,0
11,479,479,10,4,6,2,1
30,493,493,194,182,12,3,2

3,103,103,13,13,0,1,0
16,121,121,2,2,0,1,0
21,122,122,19,19,0,1,0
26,129,129,11,2,9,2,1
18,141,141,3,3,0,1,0
19,153,153,1,1,0,1,0
28,177,177,7,3,4,2,1
32,196,196,10,6,4,2,1
24,198,198,11,11,0,1,0
23,203,203,2,2,0,1,0
17,220,220,2,2,0,1,0
33,238,238,47,47,0,1,0
8,246,246,39,20,19,4,3
4,266,266,23,13,10,3,2
6,271,271,9,1,8,2,1
22,272,272,30,6,24,3,2
30,287,287,63,14,49,2,1
1,293,293,5,1,4,2,1
5,303,303,31,31,0,1,0
14,309,309,81,24,57,4,3
29,311,311,49,49,0,1,0
15,315,315,3,3,0,1,0
0,327,327,3,3,0,1,0
2,338,338,70,70,0,1,0
20,347,347,33,12,21,2,1
31,351,351,15,15,0,1,0
25,352,352,156,104,52,3,2
10,360,360,60,60,0,1,0
9,362,362,11,11,0,1,0
7,400,400,39,39,0,1,0
13,461,461,26,26,0,1,0
12,474,474,28,28,0,1,0
11,475,475,127,43,84,4,3
27,500,500,20,4,16,2,1

4,107,107,12,3,9,2,1
24,120,120,13,13,0,1,0
13,127,127,20,20,0,1,0
20,139,139,1,1,0,1,0
21,151,151,31,16,15,2,1
7,154,154,1,1,0,1,0
10,180,180,27,21,6,2,1
0,193,193,5,5,0,1,0
9,210,210,17,17,0,1,0
18,213,213,5,5,0,1,0
26,217,217,2,2,0,1,0
8,252,252,82,38,44,2,1
22,255,255,38,14,24,4,3
11,273,273,29,29,0,1,0
27,288,288,39,3,36,2,1
2,289,289,26,20,6,3,2
23,296,296,4,4,0,1,0
12,305,305,9,9,0,1,0
5,354,354,92,54,38,2,1
14,379,379,89,15,74,3,2
17,401,401,39,39,0,1,0
6,411,411,144,107,37,3,2
3,416,416,42,7,35,3,2
15,426,426,8,8,0,1,0
25,438,438,12,12,0,1,0
16,448,448,43,11,32,3,2
19,460,460,146,146,0,1,0
1,463,463,94,49,45,4,3

30,131,131,8,4,4,2,1
34,142,142,20,20,0,1,0
19,146,146,21,13,8,3,2
5,153,153,4,4,0,1,0
17,161,161,4,4,0,1,0
22,194,194,12,5,7,2,1
28,199,199,18,12,6,2,1
3,200,200,1,1,0,1,0
12,205,205,3,3,0,1,0
15,219,219,7,7,0,1,0
7,268,268,13,13,0,1,0
18,278,278,81,67,14,2,1
26,279,279,14,6,8,2,1
27,281,281,25,25,0,1,0
8,287,287,23,7,16,2,1
14,287,287,52,19,33,2,1
6,319,319,4,1,3,2,1
10,331,331,8,2,6,3,2
16,340,340,118,94,24,2,1
21,341,341,44,44,0,1,0
32,349,349,157,154,3,2,1
24,371,371,10,10,0,1,0
29,374,374,5,5,0,1,0
20,397,397,21,5,16,3,2
4,403,403,21,4,17,2,1
9,404,404,93,18,75,4,3
31,407,407,21,6,15,2,1
33,417,417,12,12,0,1,0
0,425,425,100,65,35,4,3
2,435,435,36,36,0,1,0
1,454,454,25,25,0,1,0
23,478,478,4,1,3,2,1
11,481,481,112,7,105,4,3
13,491,491,8,8,0,1,0
25,496,496,24,24,0,1,0

31,100,100,14,14,0,1,0
29,115,115,16,16,0,1,0
11,137,137,17,17,0,1,0
3,151,151,17,17,0,1,0
19,167,167,5,5,0,1,0
14,171,171,2,2,0,1,0
1,176,176,32,16,16,3,2
22,195,195,10,4,6,3,2
16,220,220,41,41,0,1,0
21,232,232,10,10,0,1,0
7,244,244,5,5,0,1,0
8,251,251,58,58,0,1,0
30,269,269,16,16,0,1,0
18,271,271,57,57,0,1,0
9,292,292,1,1,0,1,0
10,298,298,12,12,0,1,0
12,300,300,4,4,0,1,0
2,318,318,96,43,53,3,2
24,318,318,10,10,0,1,0
20,348,348,5,5,0,1,0
4,365,365,6,1,5,2,1
26,369,369,69,24,45,4,3
17,373,373,20,20,0,1,0
27,383,383,12,12,0,1,0
23,406,406,3,3,0,1,0
15,408,408,3,3,0,1,0
32,413,413,208,98,110,4,3
13,434,434,1,1,0,1,0
28,454,454,4,4,0,1,0
0,454,454,201,60,141,4,3
25,460,460,15,15,0,1,0
6,487,487,89,84,5,2,1
5,488,488,4,1,3,2,1

1,107,107,14,7,7,2,1
32,114,114,20,6,14,2,1
29,142,142,3,3,0,1,0
15,148,148,31,7,24,2,1
27,168,168,9,3,6,3,2
24,192,192,3,3,0,1,0
28,212,212,22,22,0,1,0
22,229,229,7,7,0,1,0
31,230,230,10,10,0,1,0
18,232,232,55,55,0,1,0
16,245,245,108,48,60,3,2
21,270,270,50,26,24,4,3
9,276,276,38,38,0,1,0
20,292,292,4,1,3,2,1
0,294,294,24,3,21,2,1
8,317,317,17,17,0,1,0
23,317,317,9,5,4,2,1
14,350,350,10,10,0,1,0
4,363,363,118,82,36,2,1
11,371,371,103,22,81,4,3
19,374,374,13,5,8,3,2
3,376,376,16,7,9,4,3
26,406,406,17,17,0,1,0
5,420,420,4,4,0,1,0
2,434,434,19,3,16,2,1
12,443,443,42,18,24,4,3
17,453,453,56,12,44,2,1
25,475,475,7,3,4,2,1
13,482,482,23,7,16,2,1
6,487,487,64,64,0,1,0
7,496,496,16,16,0,1,0
10,498,498,28,28,0,1,0
30,499,499,87,20,67,3,2

23,104,104,23,23,0,1,0
25,104,104,23,23,0,1,0
37,112,112,4,4,0,1,0
1,120,120,3,3,0,1,0
33,123,123,24,24,0,1,0
27,134,134,2,2,0,1,0
35,140,140,22,22,0,1,0
11,151,151,1,1,0,1,0
12,154,154,51,23,28,4,3
24,169,169,2,2,0,1,0
7,176,176,6,6,0,1,0
34,179,179,14,6,8,3,2
4,217,217,11,4,7,2,1
8,229,229,11,5,6,2,1
32,256,256,17,17,0,1,0
9,257,257,33,17,16,2,1
3,276,276,9,9,0,1,0
15,299,299,14,14,0,1,0
18,309,309,11,11,0,1,0
6,337,337,6,6,0,1,0
20,339,339,9,4,5,2,1
10,343,343,46,19,27,4,3
5,353,353,2,2,0,1,0
21,356,356,121,11,110,4,3
36,360,360,20,20,0,1,0
38,367,367,109,55,54,4,3
16,372,372,13,13,0,1,0
14,375,375,8,8,0,1,0
26,387,387,31,12,19,2,1
29,389,389,18,3,15,4,3
30,391,391,51,43,8,2,1
17,403,403,17,17,0,1,0
0,418,418,47,47,0,1,0
22,455,455,27,5,22,3,2
13,463,463,30,30,0,1,0
31,490,490,8,1,7,2,1
2,491,491,40,40,0,1,0
19,499,499,40,4,36,3,2
28,500,500,28,28,0,1,0

12,124,124,23,23,0,1,0
33,144,144,6,6,0,1,0
8,152,152,3,3,0,1,0
5,155,155,16,7,9,2,1
31,162,162,13,4,9,4,3
6,163,163,21,6,15,4,3
0,198,198,2,2,0,1,0
16,237,237,4,1,3,2,1
2,240,240,18,6,12,4,3
29,243,243,16,4,12,3,2
4,245,245,40,12,28,2,1
20,249,249,7,4,3,2,1
1,261,261,20,11,9,2,1
26,291,291,23,13,10,2,1
30,302,302,24,15,9,4,3
32,310,310,10,2,8,3,2
7,310,310,15,7,8,3,2
21,314,314,2,2,0,1,0
28,319,319,28,18,10,3,2
3,327,327,26,19,7,2,1
9,330,330,1,1,0,1,0
11,333,333,41,41,0,1,0
24,336,336,18,18,0,1,0
23,343,343,31,31,0,1,0
22,346,346,74,46,28,2,1
10,349,349,18,9,9,2,1
35,386,386,54,54,0,1,0
34,396,396,211,172,39,4,3
17,396,396,53,53,0,1,0
13,415,415,108,108,0,1,0
19,420,420,67,67,0,1,0
18,432,432,7,7,0,1,0
27,442,442,12,12,0,1,0
15,459,459,83,83,0,1,0
14,497,497,12,3,9,2,1
25,499,499,8,8,0,1,0

21,112,112,3,3,0,1,0
19,137,137,8,3,5,2,1
2,145,145,7,3,4,2,1
1,149,149,5,5,0,1,0
29,176,176,14,4,10,3,2
26,197,197,20,10,10,2,1
16,202,202,4,1,3,2,1
6,212,212,3,3,0,1,0
15,219,219,2,2,0,1,0
4,227,227,8,8,0,1,0
30,234,234,32,32,0,1,0
14,238,238,30,8,22,2,1
9,240,240,5,2,3,2,1
28,255,255,9,1,8,2,1
8,261,261,12,12,0,1,0
22,263,263,40,40,0,1,0
23,265,265,12,12,0,1,0
7,268,268,27,19,8,2,1
17,275,275,137,49,88,3,2
27,296,296,4,1,3,2,1
20,334,334,66,66,0,1,0
18,344,344,32,22,10,4,3
10,348,348,83,68,15,2,1
24,356,356,31,31,0,1,0
3,370,370,32,9,23,2,1
13,384,384,9,1,8,2,1
12,392,392,69,38,31,2,1
11,434,434,154,154,0,1,0
0,474,474,132,111,21,2,1
5,488,488,119,3,116,4,3
25,491,491,26,26,0,1,0

15,100,100,4,4,0,1,0
31,104,104,11,11,0,1,0
21,104,104,12,12,0,1,0
4,113,113,3,3,0,1,0
6,148,148,23,13,10,3,2
13,153,153,11,3,8,2,1
1,165,165,19,19,0,1,0
9,183,183,15,15,0,1,0
7,193,193,74,8,66,3,2
2,202,202,7,7,0,1,0
28,227,227,1,1,0,1,0
23,227,227,3,3,0,1,0
26,250,250,2,2,0,1,0
16,260,260,51,51,0,1,0
19,274,274,65,13,52,3,2
8,275,275,36,36,0,1,0
10,304,304,38,28,10,3,2
11,353,353,25,25,0,1,0
3,356,356,5,5,0,1,0
29,373,373,2,2,0,1,0
30,399,399,8,8,0,1,0
18,407,407,35,17,18,3,2
20,410,410,43,43,0,1,0
22,418,418,182,110,72,4,3
12,423,423,76,76,0,1,0
17,441,441,25,25,0,1,0
24,450,450,4,1,3,2,1
25,461,461,24,24,0,1,0
0,465,465,95,79,16,2,1
27,468,468,115,41,74,3,2
5,479,479,14,7,7,2,1
14,493,493,38,5,33,4,3

16,139,139,10,10,0,1,0
15,142,142,6,2,4,2,1
27,146,146,25,7,18,3,2
0,175,175,27,3,24,2,1
11,180,180,1,1,0,1,0
20,188,188,17,17,0,1,0
23,191,191,30,30,0,1,0
26,200,200,3,3,0,1,0
33,203,203,14,14,0,1,0
18,205,205,1,1,0,1,0
37,211,211,31,7,24,3,2
29,246,246,34,34,0,1,0
13,253,253,1,1,0,1,0
12,256,256,6,6,0,1,0
1,273,273,21,1,20,3,2
9,276,276,24,24,0,1,0
36,277,277,6,6,0,1,0
32,277,277,1,1,0,1,0
8,298,298,32,32,0,1,0
5,311,311,61,61,0,1,0
21,316,316,1,1,0,1,0
4,319,319,22,9,13,2,1
2,321,321,59,59,0,1,0
22,322,322,4,4,0,1,0
31,333,333,9,9,0,1,0
19,336,336,13,13,0,1,0
38,342,342,13,13,0,1,0
3,349,349,44,35,9,4,3
17,350,350,18,3,15,2,1
30,351,351,38,38,0,1,0
14,357,357,1,1,0,1,0
39,370,370,120,51,69,4,3
10,370,370,94,38,56,4,3
7,371,371,22,22,0,1,0
28,393,393,107,94,13,2,1
35,426,426,54,54,0,1,0
6,441,441,16,16,0,1,0
25,464,464,22,22,0,1,0
34,482,482,13,13,0,1,0
24,495,495,18,10,8,3,2

2,116,116,1,1,0,1,0
4,124,124,19,19,0,1,0
29,135,135,15,11,4,2,1
1,212,212,11,11,0,1,0
6,230,230,159,127,32,4,3
26,241,241,6,6,0,1,0
12,273,273,28,20,8,3,2
13,313,313,26,26,0,1,0
23,318,318,69,69,0,1,0
14,324,324,49,49,0,1,0
20,344,344,38,33,5,2,1
9,345,345,63,5,58,3,2
28,347,347,19,2,17,2,1
24,347,347,79,51,28,3,2
16,365,365,9,9,0,1,0
15,380,380,54,54,0,1,0
17,390,390,59,59,0,1,0
11,391,391,20,20,0,1,0
19,393,393,74,41,33,2,1
25,397,397,10,10,0,1,0
0,418,418,3,3,0,1,0
27,429,429,6,6,0,1,0
22,433,433,36,27,9,2,1
8,435,435,1,1,0,1,0
3,443,443,33,20,13,2,1
21,447,447,40,9,31,2,1
5,447,447,7,7,0,1,0
18,453,453,11,11,0,1,0
10,481,481,144,59,85,4,3
7,498,498,31,25,6,2,1

12,123,123,1,1,0,1,0
16,137,137,6,6,0,1,0
40,145,145,7,1,6,2,1
30,149,149,30,12,18,3,2
36,156,156,5,5,0,1,0
33,170,170,9,9,0,1,0
5,180,180,69,38,31,4,3
32,181,181,2,2,0,1,0
14,182,182,3,3,0,1,0
18,190,190,3,3,0,1,0
11,193,193,13,13,0,1,0
7,194,194,12,12,0,1,0
24,200,200,32,2,30,3,2
26,208,208,29,29,0,1,0
38,222,222,9,1,8,2,1
35,224,224,24,3,21,4,3
27,271,271,3,3,0,1,0
21,281,281,5,5,0,1,0
8,315,315,15,5,10,3,2
31,323,323,16,7,9,2,1
23,329,329,18,18,0,1,0
28,336,336,73,52,21,4,3
0,338,338,15,15,0,1,0
29,345,345,66,28,38,3,2
20,355,355,9,9,0,1,0
1,369,369,31,13,18,3,2
15,373,373,17,17,0,1,0
10,378,378,83,83,0,1,0
39,378,378,111,96,15,4,3
17,380,380,56,42,14,2,1
6,394,394,1,1,0,1,0
25,396,396,18,9,9,2,1
2,397,397,6,6,0,1,0
3,403,403,26,26,0,1,0
9,407,407,6,1,5,2,1
34,408,408,48,48,0,1,0
22,415,415,61,22,39,2,1
4,421,421,38,23,15,2,1
19,445,445,26,14,12,4,3
13,448,448,12,2,10,2,1
37,453,453,9,1,8,2,1

26,124,124,38,38,0,1,0
3,178,178,7,4,3,2,1
15,182,182,1,1,0,1,0
4,192,192,18,18,0,1,0
16,197,197,12,12,0,1,0
14,197,197,34,25,9,2,1
9,199,199,39,39,0,1,0
21,211,211,14,14,0,1,0
30,224,224,55,55,0,1,0
13,231,231,16,1,15,4,3
28,233,233,2,2,0,1,0
8,256,256,3,3,0,1,0
6,277,277,100,100,0,1,0
2,290,290,19,15,4,2,1
25,290,290,10,10,0,1,0
17,294,294,37,13,24,2,1
18,317,317,8,8,0,1,0
29,317,317,75,27,48,2,1
12,318,318,7,7,0,1,0
23,325,325,6,6,0,1,0
7,347,347,42,42,0,1,0
22,383,383,39,34,5,2,1
20,402,402,15,3,12,3,2
5,408,408,17,17,0,1,0
31,439,439,10,4,6,2,1
10,444,444,88,55,33,2,1
27,465,465,87,57,30,3,2
24,469,469,1,1,0,1,0
19,472,472,116,116,0,1,0
1,476,476,90,22,68,4,3
11,484,484,39,6,33,2,1
0,492,492,19,6,13,2,1

21,114,114,14,2,12,4,3
31,121,121,5,5,0,1,0
26,130,130,23,23,0,1,0
3,136,136,20,20,0,1,0
30,156,156,14,3,11,2,1
13,157,157,4,4,0,1,0
29,157,157,51,5,46,2,1
34,171,171,30,13,17,2,1
10,188,188,70,47,23,2,1
16,223,223,21,5,16,2,1
18,226,226,8,2,6,2,1
4,240,240,1,1,0,1,0
28,242,242,24,24,0,1,0
6,272,272,5,5,0,1,0
27,272,272,3,3,0,1,0
2,274,274,18,18,0,1,0
15,281,281,15,15,0,1,0
8,282,282,19,19,0,1,0
24,286,286,62,62,0,1,0
12,289,289,35,17,18,4,3
19,309,309,60,60,0,1,0
5,315,315,28,8,20,3,2
9,355,355,36,22,14,3,2
0,364,364,46,36,10,3,2
14,389,389,13,4,9,4,3
35,430,430,32,32,0,1,0
7,432,432,11,8,3,2,1
17,436,436,16,3,13,2,1
33,451,451,36,36,0,1,0
25,459,459,19,3,16,3,2
11,465,465,5,5,0,1,0
36,480,480,3,3,0,1,0
32,483,483,29,18,11,2,1
20,484,484,24,12,12,2,1
23,486,486,34,26,8,3,2
1,487,487,39,27,12,4,3
22,496,496,50,6,44,2,1

2,109,109,11,11,0,1,0
8,131,131,1,1,0,1,0
29,139,139,1,1,0,1,0
24,140,140,24,24,0,1,0
21,150,150,17,9,8,3,2
23,152,152,11,11,0,1,0
19,155,155,12,4,8,2,1
13,181,181,29,29,0,1,0
26,214,214,11,11,0,1,0
31,219,219,9,5,4,2,1
36,240,240,3,3,0,1,0
17,250,250,7,3,4,2,1
9,251,251,7,2,5,2,1
12,255,255,23,4,19,2,1
15,261,261,30,7,23,2,1
25,269,269,24,24,0,1,0
7,276,276,25,25,0,1,0
1,278,278,2,2,0,1,0
4,281,281,21,21,0,1,0
37,291,291,31,23,8,3,2
22,298,298,74,7,67,3,2
3,308,308,34,34,0,1,0
6,311,311,11,1,10,3,2
14,314,314,3,3,0,1,0
5,324,324,59,59,0,1,0
33,331,331,1,1,0,1,0
11,334,334,19,7,12,3,2
35,336,336,36,2,34,2,1
28,343,343,20,20,0,1,0
16,357,357,7,7,0,1,0
30,362,362,38,27,11,2,1
34,399,399,29,29,0,1,0
0,402,402,42,12,30,2,1
32,425,425,50,50,0,1,0
18,440,440,42,12,30,3,2
27,450,450,163,163,0,1,0
10,463,463,82,48,34,2,1
20,491,491,64,64,0,1,0

19,107,107,3,3,0,1,0
5,129,129,8,2,6,2,1
18,154,154,30,30,0,1,0
2,158,158,1,1,0,1,0
21,163,163,11,11,0,1,0
7,174,174,48,48,0,1,0
28,185,185,24,18,6,2,1
14,187,187,60,60,0,1,0
1,255,255,52,34,18,4,3
11,263,263,18,18,0,1,0
16,265,265,49,49,0,1,0
23,272,272,20,20,0,1,0
25,295,295,23,13,10,2,1
24,298,298,121,121,0,1,0
20,303,303,5,1,4,2,1
31,316,316,16,1,15,2,1
30,318,318,1,1,0,1,0
27,333,333,40,8,32,4,3
26,367,367,3,3,0,1,0
15,373,373,54,54,0,1,0
12,400,400,53,53,0,1,0
3,404,404,91,91,0,1,0
29,409,409,39,19,20,3,2
13,441,441,13,7,6,2,1
6,444,444,34,34,0,1,0
9,453,453,7,7,0,1,0
4,453,453,55,16,39,2,1
17,459,459,33,33,0,1,0
10,461,461,7,3,4,2,1
22,477,477,30,15,15,2,1
8,480,480,61,50,11,2,1
0,497,497,11,2,9,2,1

13,105,105,7,7,0,1,0
8,111,111,2,2,0,1,0
21,125,125,9,9,0,1,0
18,126,126,18,18,0,1,0
1,127,127,5,5,0,1,0
15,163,163,4,4,0,1,0
2,174,174,30,5,25,2,1
20,174,174,1,1,0,1,0
30,181,181,3,3,0,1,0
16,214,214,38,38,0,1,0
10,222,222,10,10,0,1,0
6,264,264,13,10,3,2,1
29,266,266,98,94,4,2,1
14,285,285,21,21,0,1,0
22,287,287,42,42,0,1,0
12,330,330,49,4,45,4,3
31,332,332,3,3,0,1,0
26,355,355,59,36,23,2,1
27,357,357,26,26,0,1,0
23,357,357,1,1,0,1,0
7,373,373,67,34,33,4,3
19,387,387,161,161,0,1,0
32,395,395,4,1,3,2,1
17,399,399,22,3,19,2,1
5,403,403,30,15,15,4,3
3,411,411,13,13,0,1,0
25,433,433,7,7,0,1,0
11,445,445,48,6,42,4,3
4,448,448,237,224,13,4,3
9,455,455,19,10,9,2,1
24,459,459,21,21,0,1,0
28,464,464,6,6,0,1,0
0,497,497,49,31,18,2,1

23,100,100,5,5,0,1,0
7,105,105,11,1,10,2,1
5,118,118,4,1,3,2,1
12,137,137,2,2,0,1,0
35,160,160,4,4,0,1,0
10,169,169,8,2,6,3,2
0,178,178,2,2,0,1,0
21,192,192,58,38,20,2,1
25,209,209,37,28,9,4,3
32,213,213,11,2,9,2,1
24,217,217,1,1,0,1,0
30,219,219,14,1,13,2,1
36,229,229,16,16,0,1,0
6,233,233,8,8,0,1,0
40,243,243,36,16,20,2,1
4,253,253,6,3,3,2,1
29,259,259,41,25,16,2,1
18,280,280,23,9,14,3,2
14,299,299,83,34,49,2,1
34,308,308,12,12,0,1,0
37,323,323,119,97,22,3,2
2,338,338,14,14,0,1,0
28,341,341,77,77,0,1,0
11,343,343,1,1,0,1,0
26,345,345,27,3,24,4,3
9,354,354,5,1,4,2,1
20,358,358,1,1,0,1,0
13,372,372,30,7,23,2,1
41,376,376,22,22,0,1,0
27,383,383,14,14,0,1,0
19,392,392,36,36,0,1,0
1,402,402,1,1,0,1,0
38,414,414,68,4,64,3,2
31,424,424,30,30,0,1,0
3,432,432,42,42,0,1,0
15,437,437,3,3,0,1,0
39,440,440,17,17,0,1,0
22,444,444,32,4,28,2,1
8,461,461,7,2,5,2,1
17,465,465,33,33,0,1,0
42,482,482,40,40,0,1,0
33,489,489,20,10,10,3,2
16,492,492,21,3,18,2,1

29,117,117,46,10,36,2,1
7,121,121,8,8,0,1,0
15,141,141,31,1,30,2,1
2,156,156,20,20,0,1,0
8,157,157,15,6,9,4,3
3,167,167,9,9,0,1,0
10,211,211,17,8,9,2,1
26,212,212,24,4,20,3,2
24,215,215,40,14,26,3,2
4,216,216,92,29,63,4,3
1,255,255,17,2,15,4,3
6,265,265,12,12,0,1,0
23,273,273,4,4,0,1,0
20,306,306,34,16,18,2,1
25,309,309,3,3,0,1,0
5,316,316,18,18,0,1,0
12,322,322,11,11,0,1,0
17,326,326,5,5,0,1,0
19,326,326,24,8,16,2,1
13,339,339,60,34,26,3,2
31,348,348,13,13,0,1,0
18,349,349,2,2,0,1,0
32,356,356,121,114,7,2,1
0,374,374,24,24,0,1,0
9,383,383,35,35,0,1,0
28,399,399,80,24,56,4,3
22,420,420,21,12,9,4,3
16,421,421,11,11,0,1,0
27,440,440,7,7,0,1,0
14,442,442,8,4,4,2,1
33,469,469,38,38,0,1,0
30,475,475,11,11,0,1,0
21,488,488,33,33,0,1,0
11,496,496,26,12,14,4,3

6,101,101,8,8,0,1,0
1,107,107,1,1,0,1,0
30,108,108,15,1,14,3,2
23,112,112,31,31,0,1,0
20,122,122,12,4,8,3,2
12,123,123,1,1,0,1,0
19,129,129,11,11,0,1,0
18,139,139,28,28,0,1,0
32,140,140,3,3,0,1,0
15,158,158,37,37,0,1,0
34,174,174,11,6,5,2,1
7,194,194,1,1,0,1,0
4,195,195,11,11,0,1,0
9,199,199,3,3,0,1,0
28,212,212,8,2,6,2,1
29,239,239,29,29,0,1,0
5,240,240,32,32,0,1,0
17,257,257,2,2,0,1,0
25,262,262,6,6,0,1,0
22,268,268,8,8,0,1,0
10,270,270,75,59,16,3,2
16,335,335,4,1,3,2,1
2,353,353,12,12,0,1,0
14,360,360,68,68,0,1,0
35,367,367,68,8,60,4,3
3,367,367,11,5,6,2,1
8,373,373,6,6,0,1,0
11,377,377,83,83,0,1,0
31,381,381,49,49,0,1,0
13,396,396,66,66,0,1,0
0,408,408,3,3,0,1,0
33,414,414,65,57,8,2,1
24,422,422,73,73,0,1,0
21,464,464,24,24,0,1,0
27,474,474,66,16,50,2,1
26,492,492,4,1,3,2,1

10,114,114,2,2,0,1,0
15,123,123,4,1,3,2,1
23,138,138,13,1,12,4,3
32,177,177,30,10,20,2,1
13,194,194,8,8,0,1,0
29,210,210,22,22,0,1,0
9,219,219,1,1,0,1,0
5,221,221,18,3,15,4,3
26,226,226,7,7,0,1,0
1,243,243,52,52,0,1,0
6,243,243,26,17,9,2,1
12,245,245,61,55,6,2,1
25,248,248,17,17,0,1,0
14,257,257,16,16,0,1,0
34,275,275,38,20,18,4,3
16,288,288,25,5,20,2,1
19,303,303,23,8,15,2,1
33,311,311,37,37,0,1,0
0,320,320,11,3,8,2,1
28,322,322,10,3,7,2,1
27,337,337,7,7,0,1,0
11,354,354,67,67,0,1,0
24,361,361,14,6,8,3,2
8,367,367,16,16,0,1,0
36,368,368,36,23,13,2,1
30,387,387,15,15,0,1,0
7,399,399,10,7,3,2,1
3,403,403,15,15,0,1,0
20,410,410,57,19,38,3,2
35,410,410,78,6,72,4,3
4,424,424,114,14,100,3,2
18,435,435,36,36,0,1,0
17,435,435,6,1,5,2,1
22,451,451,67,67,0,1,0
21,486,486,74,74,0,1,0
31,491,491,70,1,69,4,3
2,498,498,17,1,16,2,1

22,104,104,2,2,0,1,0
8,110,110,12,3,9,4,3
32,127,127,15,10,5,2,1
28,141,141,20,11,9,2,1
9,150,150,1,1,0,1,0
10,153,153,16,16,0,1,0
5,158,158,23,23,0,1,0
23,160,160,9,9,0,1,0
6,165,165,12,2,10,2,1
19,166,166,32,32,0,1,0
27,184,184,13,13,0,1,0
3,184,184,4,4,0,1,0
13,194,194,4,4,0,1,0
12,207,207,37,25,12,4,3
4,242,242,62,62,0,1,0
15,267,267,1,1,0,1,0
31,301,301,51,51,0,1,0
30,314,314,29,29,0,1,0
34,323,323,5,2,3,2,1
11,355,355,13,13,0,1,0
17,361,361,3,3,0,1,0
14,389,389,32,12,20,3,2
21,391,391,70,28,42,3,2
16,391,391,103,103,0,1,0
33,398,398,78,78,0,1,0
29,400,400,75,53,22,3,2
2,403,403,14,14,0,1,0
18,406,406,12,12,0,1,0
24,426,426,14,14,0,1,0
26,432,432,1,1,0,1,0
0,437,437,5,5,0,1,0
25,465,465,38,16,22,3,2
7,467,467,47,47,0,1,0
1,477,477,117,73,44,2,1
20,484,484,74,74,0,1,0

17,104,104,1,1,0,1,0
21,120,120,26,17,9,2,1
37,120,120,14,14,0,1,0
8,121,121,11,11,0,1,0
27,127,127,14,6,8,2,1
18,130,130,1,1,0,1,0
25,136,136,3,3,0,1,0
16,137,137,24,24,0,1,0
0,172,172,27,27,0,1,0
34,179,179,27,27,0,1,0
19,184,184,14,14,0,1,0
10,240,240,19,13,6,2,1
35,248,248,31,31,0,1,0
15,257,257,10,10,0,1,0
4,299,299,13,13,0,1,0
14,300,300,7,7,0,1,0
2,309,309,10,10,0,1,0
30,311,311,52,22,30,2,1
23,324,324,3,3,0,1,0
31,330,330,48,48,0,1,0
11,333,333,7,7,0,1,0
1,353,353,58,58,0,1,0
38,356,356,47,47,0,1,0
36,356,356,46,5,41,2,1
7,358,358,32,27,5,2,1
6,364,364,33,33,0,1,0
40,369,369,54,24,30,4,3
39,372,372,33,12,21,2,1
13,398,398,9,6,3,2,1
26,412,412,29,19,10,2,1
33,414,414,6,6,0,1,0
3,423,423,21,21,0,1,0
20,424,424,23,20,3,2,1
5,425,425,79,41,38,3,2
12,441,441,1,1,0,1,0
24,451,451,74,74,0,1,0
29,463,463,9,9,0,1,0
28,475,475,2,2,0,1,0
9,475,475,26,26,0,1,0
22,483,483,4,1,3,2,1
32,491,491,63,63,0,1,0

32,103,103,6,6,0,1,0
8,106,106,9,9,0,1,0
0,112,112,30,8,22,2,1
24,158,158,3,3,0,1,0
26,161,161,9,9,0,1,0
31,188,188,46,25,21,4,3
19,208,208,8,1,7,2,1
18,226,226,26,15,11,2,1
33,248,248,32,32,0,1,0
14,260,260,47,1,46,3,2
28,264,264,4,4,0,1,0
25,284,284,7,7,0,1,0
2,288,288,5,5,0,1,0
12,302,302,4,4,0,1,0
20,336,336,37,14,23,2,1
30,344,344,27,27,0,1,0
9,344,344,121,51,70,4,3
27,348,348,22,22,0,1,0
23,354,354,23,5,18,4,3
13,370,370,9,1,8,3,2
7,371,371,10,4,6,3,2
11,372,372,36,23,13,2,1
21,374,374,143,82,61,4,3
16,380,380,29,29,0,1,0
4,382,382,44,44,0,1,0
3,388,388,81,57,24,3,2
10,416,416,9,3,6,3,2
17,419,419,33,17,16,2,1
15,423,423,3,3,0,1,0
22,426,426,6,6,0,1,0
1,443,443,38,38,0,1,0
29,445,445,105,7,98,3,2
6,451,451,8,8,0,1,0
5,452,452,47,47,0,1,0

9,115,115,5,2,3,2,1
30,119,119,39,17,22,2,1
15,125,125,2,2,0,1,0
20,127,127,2,2,0,1,0
2,158,158,4,4,0,1,0
24,167,167,12,12,0,1,0
10,170,170,4,4,0,1,0
29,174,174,10,4,6,2,1
19,175,175,24,24,0,1,0
1,182,182,32,32,0,1,0
39,186,186,28,16,12,3,2
37,186,186,4,4,0,1,0
35,199,199,18,18,0,1,0
34,203,203,15,15,0,1,0
0,215,215,8,3,5,2,1
14,252,252,2,2,0,1,0
27,256,256,63,3,60,3,2
3,265,265,21,1,20,2,1
41,268,268,32,19,13,2,1
6,283,283,5,5,0,1,0
17,293,293,4,4,0,1,0
4,296,296,18,6,12,2,1
5,305,305,3,3,0,1,0
8,320,320,13,13,0,1,0
7,334,334,33,14,19,2,1
32,341,341,64,14,50,3,2
25,342,342,2,2,0,1,0
31,342,342,26,18,8,2,1
28,343,343,21,21,0,1,0
16,347,347,117,84,33,4,3
33,361,361,43,12,31,2,1
13,385,385,27,27,0,1,0
38,387,387,10,6,4,2,1
23,395,395,65,65,0,1,0
18,418,418,5,1,4,2,1
36,424,424,39,22,17,2,1
40,438,438,9,9,0,1,0
26,439,439,25,25,0,1,0
22,445,445,40,4,36,3,2
12,462,462,20,4,16,2,1
21,466,466,47,22,25,2,1
11,493,493,4,4,0,1,0

8,104,104,21,21,0,1,0
36,129,129,9,9,0,1,0
6,139,139,11,7,4,2,1
5,152,152,8,8,0,1,0
19,162,162,9,9,0,1,0
31,166,166,22,22,0,1,0
33,168,168,10,2,8,2,1
10,180,180,25,9,16,3,2
27,186,186,1,1,0,1,0
35,189,189,24,4,20,3,2
16,189,189,39,25,14,2,1
12,195,195,39,39,0,1,0
21,198,198,3,3,0,1,0
29,213,213,6,3,3,2,1
9,223,223,7,1,6,2,1
15,236,236,1,1,0,1,0
1,248,248,3,3,0,1,0
22,254,254,66,57,9,4,3
20,283,283,5,5,0,1,0
14,293,293,2,2,0,1,0
25,312,312,122,81,41,3,2
30,315,315,13,13,0,1,0
34,320,320,4,1,3,2,1
24,348,348,16,16,0,1,0
2,364,364,7,1,6,2,1
23,367,367,38,14,24,2,1
3,375,375,40,19,21,4,3
0,378,378,53,53,0,1,0
32,386,386,52,52,0,1,0
13,408,408,24,24,0,1,0
18,412,412,12,3,9,4,3
4,412,412,49,7,42,2,1
26,419,419,32,3,29,2,1
28,435,435,57,57,0,1,0
7,436,436,55,12,43,2,1
37,455,455,44,44,0,1,0
17,471,471,37,37,0,1,0
11,495,495,8,8,0,1,0

16,109,109,13,13,0,1,0
20,112,112,1,1,0,1,0
3,113,113,4,4,0,1,0
7,118,118,3,3,0,1,0
10,122,122,7,7,0,1,0
9,144,144,10,10,0,1,0
25,170,170,9,4,5,2,1
17,177,177,13,13,0,1,0
8,179,179,7,7,0,1,0
19,181,181,39,23,16,2,1
30,183,183,43,43,0,1,0
24,210,210,11,11,0,1,0
2,218,218,10,2,8,3,2
38,225,225,19,3,16,2,1
33,229,229,25,2,23,4,3
34,234,234,51,31,20,2,1
12,243,243,55,20,35,3,2
35,291,291,33,24,9,4,3
27,292,292,15,15,0,1,0
23,297,297,2,2,0,1,0
1,306,306,26,26,0,1,0
39,328,328,11,11,0,1,0
31,339,339,50,50,0,1,0
37,344,344,33,1,32,3,2
0,347,347,58,34,24,2,1
5,375,375,14,5,9,3,2
4,385,385,25,25,0,1,0
28,409,409,69,5,64,3,2
11,415,415,35,20,15,2,1
36,426,426,62,62,0,1,0
26,434,434,11,11,0,1,0
29,438,438,10,4,6,2,1
15,455,455,1,1,0,1,0
18,461,461,84,84,0,1,0
14,478,478,26,26,0,1,0
32,479,479,82,82,0,1,0
13,480,480,6,6,0,1,0
21,483,483,6,6,0,1,0
22,495,495,15,15,0,1,0
6,496,496,26,2,24,4,3

7,102,102,12,12,0,1,0
27,103,103,4,1,3,2,1
23,114,114,43,7,36,4,3
25,118,118,18,7,11,2,1
20,126,126,6,6,0,1,0
18,128,128,7,7,0,1,0
21,140,140,1,1,0,1,0
6,176,176,8,8,0,1,0
10,209,209,22,6,16,3,2
1,214,214,13,13,0,1,0
28,235,235,2,2,0,1,0
0,237,237,10,6,4,2,1
24,238,238,11,8,3,2,1
9,239,239,24,20,4,2,1
12,247,247,23,18,5,2,1
5,274,274,15,15,0,1,0
14,317,317,23,23,0,1,0
15,318,318,120,64,56,4,3
13,324,324,43,43,0,1,0
4,350,350,228,165,63,4,3
26,355,355,5,5,0,1,0
17,361,361,8,5,3,2,1
16,368,368,24,24,0,1,0
3,374,374,49,49,0,1,0
29,389,389,24,24,0,1,0
8,394,394,48,2,46,2,1
19,436,436,35,35,0,1,0
11,439,439,67,22,45,2,1
2,443,443,12,3,9,4,3
22,497,497,90,90,0,1,0

7,169,169,22,22,0,1,0
30,170,170,22,22,0,1,0
25,177,177,35,9,26,2,1
18,178,178,2,2,0,1,0
20,182,182,5,5,0,1,0
1,184,184,33,19,14,2,1
3,190,190,18,18,0,1,0
28,190,190,44,44,0,1,0
16,217,217,27,27,0,1,0
9,222,222,34,34,0,1,0
17,229,229,41,41,0,1,0
23,232,232,12,1,11,2,1
11,239,239,19,7,12,3,2
14,246,246,25,15,10,3,2
4,292,292,1,1,0,1,0
8,331,331,63,63,0,1,0
2,340,340,4,4,0,1,0
6,345,345,107,87,20,2,1
13,371,371,3,3,0,1,0
19,378,378,30,21,9,4,3
10,388,388,37,5,32,3,2
22,390,390,7,1,6,3,2
21,395,395,29,5,24,2,1
24,399,399,53,29,24,4,3
0,419,419,94,61,33,4,3
26,429,429,95,10,85,4,3
27,452,452,3,3,0,1,0
15,461,461,3,3,0,1,0
12,471,471,18,13,5,2,1
5,482,482,88,24,64,3,2
29,487,487,71,71,0,1,0

28,108,108,31,31,0,1,0
30,118,118,16,8,8,2,1
6,127,127,2,2,0,1,0
19,134,134,7,7,0,1,0
38,142,142,9,1,8,3,2
7,147,147,1,1,0,1,0
39,150,150,14,14,0,1,0
26,188,188,30,12,18,2,1
15,195,195,7,3,4,2,1
21,198,198,37,34,3,2,1
2,217,217,22,7,15,4,3
14,219,219,9,9,0,1,0
9,269,269,1,1,0,1,0
24,278,278,15,15,0,1,0
33,285,285,6,6,0,1,0
23,310,310,3,3,0,1,0
35,310,310,34,34,0,1,0
34,312,312,7,7,0,1,0
20,315,315,31,28,3,2,1
4,317,317,6,1,5,2,1
0,333,333,12,8,4,2,1
12,334,334,11,11,0,1,0
37,339,339,35,9,26,3,2
25,348,348,19,5,14,4,3
11,350,350,21,14,7,2,1
18,377,377,1,1,0,1,0
32,377,377,35,9,26,2,1
22,379,379,7,7,0,1,0
13,387,387,1,1,0,1,0
36,400,400,78,78,0,1,0
1,401,401,43,28,15,4,3
16,402,402,49,49,0,1,0
17,413,413,14,2,12,3,2
3,443,443,1,1,0,1,0
31,460,460,12,12,0,1,0
29,461,461,122,89,33,4,3
5,463,463,4,4,0,1,0
10,466,466,136,84,52,3,2
27,484,484,22,6,16,2,1
8,492,492,207,207,0,1,0

9,101,101,7,7,0,1,0
10,103,103,1,1,0,1,0
36,104,104,7,7,0,1,0
14,107,107,6,6,0,1,0
17,135,135,7,7,0,1,0
33,139,139,16,16,0,1,0
24,167,167,7,7,0,1,0
34,174,174,11,11,0,1,0
22,226,226,62,62,0,1,0
37,230,230,14,8,6,3,2
1,232,232,3,3,0,1,0
29,238,238,57,57,0,1,0
23,269,269,4,4,0,1,0
7,270,270,30,30,0,1,0
8,278,278,9,6,3,2,1
6,284,284,1,1,0,1,0
21,293,293,43,43,0,1,0
35,308,308,50,3,47,4,3
15,313,313,1,1,0,1,0
30,320,320,2,2,0,1,0
2,324,324,5,5,0,1,0
0,327,327,78,24,54,4,3
18,330,330,10,4,6,2,1
12,335,335,14,2,12,2,1
31,353,353,11,11,0,1,0
26,354,354,29,11,18,4,3
25,355,355,39,7,32,3,2
28,356,356,36,36,0,1,0
4,391,391,34,34,0,1,0
19,393,393,17,17,0,1,0
13,395,395,75,75,0,1,0
3,413,413,46,1,45,3,2
27,442,442,29,13,16,2,1
16,453,453,59,59,0,1,0
20,460,460,65,20,45,2,1
5,461,461,12,1,11,2,1
38,462,462,22,1,21,4,3
11,479,479,72,21,51,4,3
32,485,485,120,79,41,2,1

25,105,105,8,4,4,2,1
16,123,123,46,46,0,1,0
2,132,132,2,2,0,1,0
15,144,144,2,2,0,1,0
0,146,146,10,10,0,1,0
6,159,159,1,1,0,1,0
19,160,160,54,11,43,4,3
14,167,167,2,2,0,1,0
8,179,179,43,43,0,1,0
32,186,186,2,2,0,1,0
22,195,195,8,4,4,2,1
33,204,204,25,25,0,1,0
5,205,205,5,5,0,1,0
34,212,212,34,34,0,1,0
26,238,238,6,6,0,1,0
30,259,259,36,36,0,1,0
18,265,265,8,8,0,1,0
4,269,269,1,1,0,1,0
1,298,298,67,67,0,1,0
31,329,329,53,53,0,1,0
27,331,331,5,5,0,1,0
11,353,353,51,39,12,3,2
20,361,361,6,6,0,1,0
12,365,365,8,8,0,1,0
23,366,366,4,4,0,1,0
7,371,371,2,2,0,1,0
24,410,410,16,16,0,1,0
10,422,422,82,82,0,1,0
29,423,423,2,2,0,1,0
35,424,424,10,1,9,2,1
3,439,439,58,36,22,2,1
13,450,450,38,38,0,1,0
9,457,457,4,4,0,1,0
21,472,472,10,10,0,1,0
17,474,474,47,16,31,4,3
28,495,495,262,262,0,1,0

25,112,112,1,1,0,1,0
3,119,119,6,6,0,1,0
2,122,122,1,1,0,1,0
19,124,124,17,17,0,1,0
34,127,127,3,3,0,1,0
1,131,131,2,2,0,1,0
41,136,136,27,27,0,1,0
23,147,147,27,11,16,3,2
8,151,151,4,4,0,1,0
43,163,163,14,14,0,1,0
40,181,181,24,2,22,3,2
33,190,190,3,3,0,1,0
7,198,198,2,2,0,1,0
14,206,206,8,8,0,1,0
10,229,229,14,5,9,4,3
35,232,232,47,43,4,2,1
32,233,233,88,88,0,1,0
26,237,237,25,13,12,2,1
5,272,272,25,25,0,1,0
36,280,280,3,3,0,1,0
9,284,284,43,4,39,4,3
24,286,286,3,3,0,1,0
12,298,298,7,7,0,1,0
11,309,309,18,18,0,1,0
42,337,337,6,6,0,1,0
27,342,342,15,15,0,1,0
18,348,348,59,59,0,1,0
13,360,360,16,1,15,4,3
0,360,360,30,20,10,3,2
31,379,379,20,2,18,3,2
30,389,389,25,25,0,1,0
4,392,392,28,16,12,3,2
22,395,395,6,6,0,1,0
29,405,405,53,48,5,2,1
39,408,408,4,4,0,1,0
21,413,413,1,1,0,1,0
16,413,413,14,14,0,1,0
15,415,415,6,6,0,1,0
28,429,429,141,69,72,4,3
38,429,429,1,1,0,1,0
20,435,435,38,38,0,1,0
17,440,440,8,8,0,1,0
6,484,484,87,87,0,1,0
37,491,491,15,5,10,3,2

7,105,105,12,12,0,1,0
19,134,134,8,8,0,1,0
10,139,139,16,16,0,1,0
0,155,155,31,22,9,4,3
15,164,164,31,31,0,1,0
25,164,164,7,7,0,1,0
3,173,173,20,7,13,2,1
16,175,175,33,33,0,1,0
30,196,196,9,9,0,1,0
13,199,199,20,12,8,2,1
12,201,201,5,5,0,1,0
27,231,231,17,17,0,1,0
24,235,235,12,12,0,1,0
18,246,246,60,60,0,1,0
21,253,253,30,30,0,1,0
29,287,287,28,28,0,1,0
22,293,293,147,68,79,4,3
8,300,300,40,14,26,3,2
4,307,307,12,2,10,2,1
6,308,308,22,7,15,4,3
28,328,328,5,1,4,2,1
20,338,338,21,21,0,1,0
1,346,346,46,3,43,2,1
14,377,377,26,26,0,1,0
5,383,383,41,41,0,1,0
2,407,407,17,17,0,1,0
17,448,448,4,4,0,1,0
26,451,451,28,13,15,4,3
23,455,455,106,10,96,4,3
9,473,473,9,9,0,1,0
32,488,488,29,3,26,2,1
11,492,492,19,1,18,4,3
31,495,495,16,16,0,1,0
33,499,499,11,11,0,1,0

13,101,101,3,3,0,1,0
37,110,110,11,8,3,2,1
6,111,111,27,27,0,1,0
22,118,118,3,3,0,1,0
36,118,118,12,1,11,2,1
5,119,119,12,12,0,1,0
35,131,131,8,8,0,1,0
2,136,136,1,1,0,1,0
21,143,143,22,19,3,2,1
12,167,167,2,2,0,1,0
32,172,172,6,6,0,1,0
18,179,179,1,1,0,1,0
31,191,191,10,1,9,4,3
8,193,193,11,4,7,2,1
24,200,200,12,12,0,1,0
3,203,203,27,27,0,1,0
10,211,211,2,2,0,1,0
14,222,222,16,3,13,2,1
4,228,228,32,32,0,1,0
39,251,251,48,48,0,1,0
15,252,252,4,4,0,1,0
23,252,252,1,1,0,1,0
1,259,259,15,15,0,1,0
16,276,276,15,15,0,1,0
42,277,277,56,33,23,3,2
33,282,282,52,52,0,1,0
7,316,316,31,9,22,2,1
25,325,325,47,3,44,2,1
9,333,333,1,1,0,1,0
34,338,338,40,10,30,2,1
29,349,349,2,2,0,1,0
26,351,351,3,3,0,1,0
17,355,355,14,4,10,2,1
40,367,367,39,10,29,3,2
20,385,385,10,2,8,2,1
41,388,388,104,52,52,3,2
27,389,389,66,42,24,2,1
38,399,399,2,2,0,1,0
11,409,409,10,10,0,1,0
30,437,437,44,39,5,2,1
0,439,439,51,3,48,4,3
19,482,482,32,18,14,3,2
28,487,487,12,4,8,2,1

2,105,105,12,12,0,1,0
10,123,123,24,20,4,2,1
3,129,129,6,2,4,2,1
25,129,129,6,6,0,1,0
0,142,142,11,11,0,1,0
8,152,152,26,26,0,1,0
7,160,160,26,26,0,1,0
12,176,176,28,28,0,1,0
27,176,176,17,10,7,2,1
18,180,180,10,10,0,1,0
1,194,194,32,32,0,1,0
15,200,200,17,3,14,3,2
19,229,229,3,3,0,1,0
11,236,236,36,4,32,3,2
21,261,261,1,1,0,1,0
4,273,273,52,52,0,1,0
28,282,282,98,56,42,2,1
17,288,288,9,9,0,1,0
9,289,289,23,8,15,4,3
16,347,347,32,17,15,2,1
20,347,347,9,9,0,1,0
23,347,347,7,1,6,2,1
26,370,370,8,8,0,1,0
6,378,378,75,43,32,3,2
13,409,409,74,59,15,4,3
24,462,462,115,7,108,4,3
5,475,475,70,58,12,4,3
14,481,481,123,58,65,3,2
22,481,481,30,30,0,1,0

9,100,100,10,10,0,1,0
27,120,120,9,9,0,1,0
22,128,128,40,22,18,3,2
15,141,141,24,24,0,1,0
3,151,151,9,9,0,1,0
32,164,164,10,10,0,1,0
7,164,164,48,4,44,2,1
5,170,170,12,12,0,1,0
23,176,176,6,6,0,1,0
20,234,234,4,4,0,1,0
25,254,254,5,5,0,1,0
29,268,268,32,32,0,1,0
26,277,277,16,16,0,1,0
1,277,277,31,23,8,2,1
17,282,282,47,47,0,1,0
0,316,316,11,11,0,1,0
30,321,321,72,16,56,3,2
24,329,329,3,3,0,1,0
21,370,370,30,30,0,1,0
12,371,371,44,44,0,1,0
16,371,371,4,4,0,1,0
2,395,395,44,12,32,3,2
18,397,397,12,12,0,1,0
4,401,401,26,5,21,2,1
11,405,405,4,4,0,1,0
14,415,415,18,7,11,2,1
13,421,421,137,137,0,1,0
8,429,429,18,18,0,1,0
31,432,432,13,13,0,1,0
6,458,458,61,61,0,1,0
19,462,462,73,49,24,4,3
28,463,463,151,77,74,4,3
10,486,486,6,2,4,2,1

18,112,112,23,14,9,4,3
29,118,118,5,5,0,1,0
14,122,122,4,4,0,1,0
3,131,131,24,2,22,2,1
11,164,164,1,1,0,1,0
13,172,172,41,22,19,3,2
30,192,192,15,1,14,3,2
4,192,192,51,51,0,1,0
21,196,196,15,15,0,1,0
22,216,216,42,36,6,3,2
7,225,225,3,3,0,1,0
19,247,247,20,3,17,4,3
26,255,255,10,10,0,1,0
6,270,270,24,15,9,2,1
9,300,300,35,35,0,1,0
23,329,329,1,1,0,1,0
27,333,333,11,11,0,1,0
10,338,338,59,59,0,1,0
8,338,338,48,18,30,4,3
2,343,343,6,6,0,1,0
1,374,374,13,13,0,1,0
20,381,381,59,59,0,1,0
25,391,391,127,86,41,2,1
17,400,400,23,23,0,1,0
24,408,408,27,27,0,1,0
16,413,413,27,27,0,1,0
12,429,429,86,78,8,2,1
5,452,452,15,1,14,2,1
0,454,454,86,86,0,1,0
28,470,470,122,19,103,4,3
15,500,500,12,12,0,1,0

6,102,102,3,3,0,1,0
24,126,126,10,10,0,1,0
13,130,130,2,2,0,1,0
3,138,138,1,1,0,1,0
20,141,141,1,1,0,1,0
12,175,175,21,3,18,2,1
2,228,228,2,2,0,1,0
14,239,239,14,2,12,4,3
7,244,244,13,13,0,1,0
8,246,246,18,18,0,1,0
38,266,266,57,57,0,1,0
34,267,267,8,4,4,2,1
32,276,276,2,2,0,1,0
29,276,276,3,3,0,1,0
4,281,281,2,2,0,1,0
35,282,282,12,12,0,1,0
1,285,285,52,52,0,1,0
17,293,293,15,15,0,1,0
26,314,314,42,19,23,2,1
28,345,345,5,2,3,2,1
0,367,367,32,9,23,2,1
36,374,374,123,123,0,1,0
37,389,389,72,63,9,4,3
18,390,390,80,80,0,1,0
33,394,394,42,16,26,3,2
30,407,407,38,24,14,3,2
16,413,413,49,49,0,1,0
22,416,416,51,51,0,1,0
9,424,424,61,61,0,1,0
25,438,438,23,20,3,2,1
11,439,439,60,60,0,1,0
19,444,444,10,6,4,2,1
23,447,447,79,79,0,1,0
15,463,463,93,50,43,2,1
27,473,473,30,12,18,3,2
10,489,489,16,16,0,1,0
31,489,489,32,8,24,4,3
5,495,495,54,15,39,4,3
21,496,496,15,15,0,1,0

17,123,123,6,1,5,2,1
7,146,146,26,6,20,3,2
28,150,150,24,24,0,1,0
10,160,160,10,10,0,1,0
14,160,160,10,10,0,1,0
16,169,169,17,9,8,3,2
8,170,170,12,12,0,1,0
11,179,179,32,32,0,1,0
15,186,186,14,14,0,1,0
5,191,191,1,1,0,1,0
1,202,202,2,2,0,1,0
31,223,223,3,3,0,1,0
9,248,248,67,67,0,1,0
12,269,269,81,48,33,3,2
23,281,281,7,4,3,2,1
29,311,311,41,41,0,1,0
30,315,315,4,4,0,1,0
27,320,320,12,12,0,1,0
0,328,328,13,13,0,1,0
18,330,330,28,19,9,2,1
22,337,337,65,9,56,4,3
6,362,362,21,3,18,3,2
21,390,390,138,75,63,4,3
3,408,408,14,5,9,4,3
26,415,415,47,47,0,1,0
25,459,459,1,1,0,1,0
2,460,460,52,2,50,4,3
4,464,464,6,6,0,1,0
24,469,469,117,107,10,2,1
13,481,481,147,36,111,4,3
19,485,485,46,34,12,4,3
20,490,490,19,4,15,4,3

20,113,113,3,3,0,1,0
2,147,147,11,11,0,1,0
3,157,157,31,24,7,2,1
8,180,180,4,4,0,1,0
28,194,194,5,5,0,1,0
29,210,210,57,57,0,1,0
22,218,218,28,28,0,1,0
30,223,223,11,11,0,1,0
18,225,225,4,4,0,1,0
17,226,226,20,12,8,2,1
13,235,235,20,8,12,2,1
12,240,240,74,74,0,1,0
4,244,244,2,2,0,1,0
19,245,245,7,7,0,1,0
10,263,263,7,7,0,1,0
27,275,275,41,23,18,2,1
16,283,283,13,13,0,1,0
6,308,308,35,8,27,3,2
11,310,310,69,47,22,3,2
1,317,317,23,23,0,1,0
24,321,321,69,15,54,4,3
25,379,379,67,67,0,1,0
9,382,382,27,15,12,2,1
7,389,389,67,6,61,4,3
0,390,390,22,22,0,1,0
26,393,393,17,17,0,1,0
5,407,407,10,10,0,1,0
23,414,414,1,1,0,1,0
32,414,414,35,35,0,1,0
31,441,441,119,59,60,3,2
21,449,449,47,20,27,4,3
15,465,465,81,70,11,2,1
14,483,483,34,34,0,1,0

17,131,131,27,2,25,2,1
5,145,145,3,3,0,1,0
35,145,145,10,3,7,3,2
6,150,150,5,5,0,1,0
13,165,165,36,11,25,3,2
2,177,177,8,2,6,2,1
25,193,193,36,11,25,3,2
30,198,198,21,7,14,2,1
29,262,262,4,1,3,2,1
8,263,263,45,23,22,3,2
37,270,270,19,13,6,3,2
31,278,278,27,9,18,2,1
18,289,289,30,30,0,1,0
11,290,290,12,7,5,2,1
28,300,300,71,8,63,4,3
24,307,307,63,63,0,1,0
0,307,307,18,18,0,1,0
26,310,310,29,29,0,1,0
23,314,314,45,45,0,1,0
10,316,316,2,2,0,1,0
32,321,321,21,4,17,4,3
36,322,322,25,25,0,1,0
1,323,323,1,1,0,1,0
3,335,335,79,3,76,3,2
27,348,348,11,11,0,1,0
16,349,349,25,2,23,2,1
9,351,351,25,13,12,3,2
19,352,352,19,11,8,2,1
4,353,353,4,4,0,1,0
7,369,369,16,2,14,2,1
15,415,415,41,41,0,1,0
34,424,424,10,10,0,1,0
22,430,430,64,40,24,3,2
14,438,438,55,55,0,1,0
21,465,465,70,70,0,1,0
33,469,469,2,2,0,1,0
12,476,476,12,12,0,1,0
20,493,493,28,28,0,1,0

1,102,102,6,6,0,1,0
21,103,103,2,2,0,1,0
19,105,105,1,1,0,1,0
2,129,129,6,6,0,1,0
0,176,176,18,2,16,2,1
16,178,178,15,15,0,1,0
33,179,179,6,6,0,1,0
29,182,182,2,2,0,1,0
17,183,183,29,29,0,1,0
15,186,186,33,33,0,1,0
20,189,189,6,6,0,1,0
10,195,195,1,1,0,1,0
5,199,199,31,31,0,1,0
35,203,203,13,13,0,1,0
32,208,208,56,24,32,2,1
8,213,213,16,8,8,2,1
11,226,226,17,7,10,3,2
14,232,232,28,12,16,2,1
13,235,235,25,13,12,4,3
37,239,239,26,12,14,3,2
25,246,246,26,26,0,1,0
23,257,257,10,10,0,1,0
6,273,273,13,3,10,3,2
30,275,275,17,17,0,1,0
34,282,282,45,16,29,2,1
18,298,298,18,6,12,3,2
7,329,329,8,8,0,1,0
27,347,347,73,73,0,1,0
3,351,351,35,11,24,4,3
24,365,365,7,7,0,1,0
31,381,381,109,70,39,4,3
12,393,393,83,5,78,3,2
22,428,428,10,1,9,2,1
26,457,457,57,23,34,3,2
36,460,460,67,67,0,1,0
4,471,471,4,4,0,1,0
9,474,474,20,20,0,1,0
28,478,478,26,9,17,2,1

19,106,106,20,4,16,2,1
5,113,113,8,8,0,1,0
35,121,121,7,7,0,1,0
15,126,126,29,29,0,1,0
33,141,141,16,16,0,1,0
27,149,149,15,15,0,1,0
22,160,160,27,3,24,3,2
7,166,166,41,41,0,1,0
12,181,181,32,18,14,2,1
23,191,191,16,16,0,1,0
1,227,227,12,3,9,2,1
0,229,229,21,21,0,1,0
16,233,233,12,12,0,1,0
4,240,240,24,24,0,1,0
2,245,245,9,9,0,1,0
10,253,253,15,15,0,1,0
20,257,257,22,22,0,1,0
21,272,272,21,3,18,4,3
28,274,274,20,13,7,2,1
11,275,275,24,24,0,1,0
8,305,305,45,45,0,1,0
25,306,306,40,40,0,1,0
3,335,335,10,10,0,1,0
29,383,383,15,15,0,1,0
24,386,386,65,47,18,4,3
34,387,387,35,11,24,4,3
17,394,394,27,27,0,1,0
32,419,419,90,90,0,1,0
13,420,420,7,7,0,1,0
14,422,422,7,7,0,1,0
18,454,454,4,4,0,1,0
26,456,456,115,23,92,3,2
9,467,467,6,3,3,2,1
6,471,471,4,4,0,1,0
31,473,473,17,10,7,2,1
30,473,473,3,3,0,1,0
36,475,475,17,17,0,1,0

4,113,113,4,4,0,1,0
14,119,119,21,21,0,1,0
0,134,134,1,1,0,1,0
6,134,134,12,3,9,4,3
13,179,179,5,5,0,1,0
15,191,191,4,4,0,1,0
24,205,205,13,13,0,1,0
23,211,211,9,9,0,1,0
26,217,217,2,2,0,1,0
25,257,257,23,11,12,4,3
3,276,276,31,7,24,2,1
17,284,284,58,10,48,2,1
12,313,313,24,4,20,3,2
9,315,315,121,67,54,3,2
30,341,341,83,27,56,3,2
8,344,344,38,38,0,1,0
10,373,373,187,162,25,2,1
20,380,380,4,1,3,2,1
2,381,381,14,2,12,2,1
29,414,414,61,35,26,2,1
28,438,438,8,8,0,1,0
27,440,440,13,13,0,1,0
19,446,446,90,70,20,3,2
1,463,463,30,3,27,3,2
22,466,466,19,2,17,2,1
11,471,471,10,10,0,1,0
21,474,474,24,4,20,3,2
7,481,481,104,6,98,3,2
16,485,485,185,59,126,4,3
5,489,489,8,8,0,1,0
18,495,495,4,4,0,1,0

13,103,103,19,1,18,2,1
8,129,129,7,7,0,1,0
35,131,131,4,1,3,2,1
14,148,148,1,1,0,1,0
37,149,149,6,6,0,1,0
24,169,169,15,7,8,2,1
9,175,175,3,3,0,1,0
12,185,185,8,8,0,1,0
6,214,214,5,5,0,1,0
25,216,216,3,3,0,1,0
34,232,232,42,42,0,1,0
17,242,242,1,1,0,1,0
3,254,254,32,12,20,3,2
28,263,263,23,5,18,4,3
36,278,278,22,7,15,4,3
15,292,292,23,23,0,1,0
29,312,312,15,15,0,1,0
30,314,314,32,23,9,4,3
32,325,325,31,31,0,1,0
18,337,337,13,13,0,1,0
1,337,337,18,18,0,1,0
2,339,339,32,32,0,1,0
23,342,342,8,4,4,2,1
0,361,361,51,51,0,1,0
4,367,367,8,8,0,1,0
7,385,385,76,19,57,4,3
16,386,386,34,28,6,3,2
22,389,389,49,49,0,1,0
5,438,438,123,123,0,1,0
31,448,448,102,47,55,4,3
33,449,449,25,25,0,1,0
27,456,456,159,111,48,4,3
21,459,459,45,45,0,1,0
11,477,477,3,3,0,1,0
19,481,481,30,10,20,2,1
26,481,481,40,40,0,1,0
10,489,489,24,9,15,2,1
20,491,491,64,64,0,1,0

23,105,105,1,1,0,1,0
41,108,108,7,7,0,1,0
3,115,115,17,17,0,1,0
5,116,116,4,4,0,1,0
6,130,130,6,6,0,1,0
9,159,159,16,3,13,3,2
20,160,160,3,3,0,1,0
28,181,181,32,32,0,1,0
16,220,220,13,4,9,2,1
32,242,242,9,9,0,1,0
17,252,252,1,1,0,1,0
11,257,257,25,5,20,2,1
38,280,280,36,13,23,2,1
33,285,285,15,3,12,3,2
12,286,286,12,6,6,3,2
24,289,289,3,3,0,1,0
10,291,291,2,2,0,1,0
27,304,304,82,14,68,4,3
15,321,321,3,3,0,1,0
0,338,338,15,15,0,1,0
36,347,347,23,8,15,2,1
34,362,362,25,25,0,1,0
19,366,366,66,33,33,4,3
21,375,375,23,4,19,2,1
8,378,378,26,16,10,2,1
13,384,384,9,1,8,2,1
2,397,397,54,54,0,1,0
35,402,402,8,8,0,1,0
1,423,423,6,3,3,2,1
31,430,430,3,3,0,1,0
18,432,432,134,134,0,1,0
30,441,441,21,21,0,1,0
4,445,445,20,20,0,1,0
7,445,445,97,97,0,1,0
14,447,447,5,5,0,1,0
26,453,453,20,20,0,1,0
37,474,474,46,34,12,2,1
29,486,486,79,79,0,1,0
25,488,488,71,71,0,1,0
22,493,493,1,1,0,1,0
40,499,499,119,99,20,2,1
39,500,500,50,50,0,1,0

0,122,122,15,15,0,1,0
3,137,137,30,19,11,2,1
19,142,142,14,14,0,1,0
31,153,153,17,5,12,2,1
25,171,171,41,2,39,2,1
30,184,184,19,1,18,4,3
22,215,215,16,4,12,4,3
2,254,254,5,5,0,1,0
13,259,259,1,1,0,1,0
20,265,265,50,50,0,1,0
12,267,267,12,2,10,2,1
21,268,268,53,53,0,1,0
14,270,270,35,35,0,1,0
18,324,324,7,1,6,2,1
24,325,325,31,31,0,1,0
10,329,329,135,61,74,4,3
11,349,349,14,2,12,3,2
26,356,356,11,5,6,2,1
5,356,356,11,11,0,1,0
27,359,359,4,1,3,2,1
9,361,361,24,24,0,1,0
23,371,371,22,19,3,2,1
28,388,388,43,17,26,4,3
16,395,395,37,37,0,1,0
15,413,413,19,19,0,1,0
17,418,418,40,40,0,1,0
4,419,419,8,8,0,1,0
8,437,437,29,29,0,1,0
7,439,439,105,105,0,1,0
1,467,467,92,92,0,1,0
6,471,471,43,43,0,1,0
29,490,490,77,77,0,1,0

7,123,123,1,1,0,1,0
3,165,165,6,6,0,1,0
23,166,166,30,21,9,4,3
9,203,203,7,7,0,1,0
26,242,242,38,38,0,1,0
16,246,246,51,2,49,2,1
10,256,256,5,5,0,1,0
22,268,268,44,32,12,4,3
12,314,314,157,93,64,3,2
11,325,325,20,20,0,1,0
28,326,326,2,2,0,1,0
31,337,337,31,31,0,1,0
30,340,340,10,10,0,1,0
0,341,341,39,17,22,3,2
18,362,362,52,34,18,3,2
14,379,379,10,5,5,2,1
1,390,390,25,25,0,1,0
20,396,396,9,9,0,1,0
5,401,401,29,5,24,4,3
29,406,406,41,8,33,2,1
21,418,418,31,24,7,2,1
6,421,421,1,1,0,1,0
13,430,430,62,5,57,4,3
25,440,440,12,3,9,4,3
4,461,461,1,1,0,1,0
27,473,473,58,40,18,4,3
17,474,474,32,2,30,4,3
15,478,478,99,51,48,4,3
19,484,484,21,11,10,2,1
24,484,484,36,18,18,2,1
8,485,485,50,50,0,1,0
2,497,497,254,118,136,4,3

28,105,105,3,3,0,1,0
31,107,107,6,6,0,1,0
17,110,110,12,12,0,1,0
7,115,115,15,15,0,1,0
5,138,138,6,6,0,1,0
4,150,150,1,1,0,1,0
13,173,173,22,12,10,2,1
34,173,173,35,15,20,3,2
26,177,177,39,27,12,4,3
22,190,190,7,3,4,2,1
12,191,191,21,9,12,3,2
29,209,209,5,1,4,2,1
19,210,210,17,17,0,1,0
1,213,213,16,10,6,2,1
3,215,215,40,40,0,1,0
6,220,220,6,6,0,1,0
9,220,220,10,1,9,4,3
35,238,238,17,5,12,2,1
32,248,248,2,2,0,1,0
24,254,254,29,29,0,1,0
20,311,311,27,10,17,2,1
2,341,341,6,6,0,1,0
15,370,370,29,17,12,4,3
10,372,372,9,9,0,1,0
14,394,394,1,1,0,1,0
30,394,394,16,16,0,1,0
0,402,402,15,1,14,3,2
16,433,433,11,6,5,2,1
25,435,435,118,4,114,4,3
18,436,436,94,94,0,1,0
27,453,453,98,66,32,3,2
36,462,462,44,44,0,1,0
21,474,474,16,16,0,1,0
33,485,485,37,13,24,3,2
11,487,487,91,91,0,1,0
8,489,489,84,19,65,4,3
23,498,498,81,5,76,3,2

1,104,104,13,13,0,1,0
21,109,109,12,12,0,1,0
30,133,133,3,3,0,1,0
12,136,136,11,11,0,1,0
34,139,139,9,9,0,1,0
8,139,139,30,30,0,1,0
27,164,164,4,4,0,1,0
16,178,178,7,7,0,1,0
29,190,190,21,21,0,1,0
10,199,199,33,33,0,1,0
5,201,201,7,7,0,1,0
19,201,201,58,58,0,1,0
9,206,206,1,1,0,1,0
6,210,210,6,6,0,1,0
25,218,218,11,4,7,2,1
7,223,223,2,2,0,1,0
11,256,256,46,25,21,4,3
33,259,259,10,1,9,4,3
28,274,274,53,43,10,2,1
3,306,306,15,4,11,2,1
15,319,319,32,32,0,1,0
17,340,340,2,2,0,1,0
13,366,366,25,25,0,1,0
31,368,368,49,27,22,2,1
22,402,402,38,8,30,3,2
14,424,424,33,15,18,4,3
4,427,427,86,86,0,1,0
32,428,428,7,7,0,1,0
0,433,433,1,1,0,1,0
23,435,435,98,14,84,3,2
20,445,445,80,80,0,1,0
24,447,447,3,3,0,1,0
2,453,453,142,63,79,4,3
26,462,462,13,13,0,1,0
18,463,463,69,28,41,2,1

13,116,116,44,18,26,2,1
0,122,122,13,13,0,1,0
31,160,160,14,14,0,1,0
28,183,183,12,12,0,1,0
21,187,187,23,23,0,1,0
20,187,187,9,9,0,1,0
33,236,236,7,4,3,2,1
27,257,257,13,13,0,1,0
16,262,262,4,4,0,1,0
14,267,267,30,10,20,3,2
8,283,283,3,3,0,1,0
35,288,288,60,36,24,4,3
30,294,294,5,5,0,1,0
24,295,295,42,15,27,4,3
2,306,306,61,21,40,2,1
1,313,313,77,41,36,4,3
32,329,329,17,17,0,1,0
23,338,338,7,7,0,1,0
22,366,366,70,58,12,2,1
6,368,368,15,15,0,1,0
17,384,384,1,1,0,1,0
34,390,390,16,12,4,2,1
10,395,395,9,3,6,3,2
11,400,400,37,17,20,3,2
29,401,401,33,33,0,1,0
18,403,403,22,19,3,2,1
25,423,423,107,107,0,1,0
15,428,428,5,1,4,2,1
7,436,436,34,34,0,1,0
3,446,446,11,3,8,3,2
5,458,458,5,2,3,2,1
4,459,459,8,8,0,1,0
9,463,463,40,40,0,1,0
19,466,466,19,2,17,2,1
12,466,466,88,88,0,1,0
26,471,471,130,27,103,4,3

29,103,103,2,2,0,1,0
26,104,104,5,1,4,2,1
8,110,110,1,1,0,1,0
7,115,115,10,10,0,1,0
23,120,120,9,9,0,1,0
1,139,139,1,1,0,1,0
15,144,144,11,8,3,2,1
16,169,169,16,16,0,1,0
33,170,170,2,2,0,1,0
12,170,170,4,1,3,2,1
21,183,183,10,10,0,1,0
28,211,211,54,54,0,1,0
6,228,228,10,1,9,4,3
11,235,235,1,1,0,1,0
13,276,276,2,2,0,1,0
3,278,278,32,32,0,1,0
17,292,292,118,80,38,3,2
20,292,292,61,61,0,1,0
31,311,311,14,14,0,1,0
9,314,314,111,41,70,4,3
19,320,320,40,40,0,1,0
27,322,322,31,31,0,1,0
35,327,327,75,75,0,1,0
5,352,352,19,19,0,1,0
14,365,365,22,22,0,1,0
30,368,368,12,12,0,1,0
10,390,390,35,14,21,4,3
25,390,390,46,14,32,2,1
2,403,403,19,1,18,2,1
4,422,422,21,21,0,1,0
18,445,445,33,33,0,1,0
22,448,448,38,38,0,1,0
32,453,453,39,16,23,2,1
24,456,456,65,25,40,2,1
0,467,467,47,47,0,1,0
34,493,493,56,6,50,3,2

9,103,103,3,3,0,1,0
35,109,109,2,2,0,1,0
19,116,116,16,16,0,1,0
34,119,119,15,15,0,1,0
18,136,136,1,1,0,1,0
27,140,140,32,32,0,1,0
12,177,177,4,1,3,2,1
28,183,183,28,12,16,3,2
32,191,191,4,4,0,1,0
21,198,198,8,2,6,3,2
13,220,220,49,49,0,1,0
8,220,220,6,6,0,1,0
24,233,233,9,2,7,3,2
23,261,261,5,5,0,1,0
29,308,308,5,1,4,2,1
2,325,325,93,66,27,2,1
14,327,327,21,3,18,4,3
26,345,345,15,15,0,1,0
17,350,350,48,48,0,1,0
33,357,357,55,15,40,2,1
7,359,359,19,19,0,1,0
20,364,364,145,145,0,1,0
4,376,376,38,38,0,1,0
0,383,383,22,1,21,2,1
16,387,387,25,25,0,1,0
36,391,391,16,5,11,2,1
30,403,403,59,12,47,2,1
6,405,405,28,14,14,3,2
15,409,409,17,17,0,1,0
3,412,412,5,5,0,1,0
11,428,428,1,1,0,1,0
31,439,439,21,14,7,2,1
1,441,441,24,17,7,2,1
25,460,460,105,68,37,4,3
10,469,469,67,32,35,2,1
22,477,477,12,8,4,2,1
5,482,482,84,60,24,3,2

33,101,101,2,2,0,1,0
7,104,104,10,10,0,1,0
10,110,110,25,25,0,1,0
36,113,113,36,19,17,4,3
21,115,115,15,15,0,1,0
8,143,143,16,16,0,1,0
37,145,145,50,34,16,2,1
4,146,146,30,25,5,2,1
0,163,163,1,1,0,1,0
24,163,163,43,43,0,1,0
6,168,168,10,10,0,1,0
25,174,174,12,2,10,3,2
3,175,175,17,13,4,2,1
32,179,179,9,9,0,1,0
17,194,194,7,7,0,1,0
28,198,198,28,25,3,2,1
27,201,201,6,6,0,1,0
9,202,202,15,15,0,1,0
1,203,203,2,2,0,1,0
29,204,204,14,14,0,1,0
14,205,205,15,10,5,2,1
26,217,217,11,11,0,1,0
13,254,254,17,17,0,1,0
35,257,257,2,2,0,1,0
18,299,299,1,1,0,1,0
19,317,317,1,1,0,1,0
11,342,342,29,7,22,3,2
30,351,351,24,8,16,3,2
23,352,352,23,2,21,4,3
2,362,362,58,17,41,3,2
5,365,365,53,9,44,2,1
12,379,379,53,46,7,2,1
22,410,410,32,21,11,2,1
16,428,428,10,10,0,1,0
15,435,435,28,3,25,2,1
20,471,471,6,3,3,2,1
31,486,486,6,6,0,1,0
34,496,496,15,15,0,1,0

26,111,111,30,30,0,1,0
27,132,132,11,11,0,1,0
6,134,134,2,2,0,1,0
24,141,141,13,13,0,1,0
19,141,141,9,1,8,3,2
23,157,157,19,19,0,1,0
21,179,179,19,19,0,1,0
8,195,195,4,4,0,1,0
30,197,197,16,16,0,1,0
15,207,207,3,3,0,1,0
10,219,219,57,57,0,1,0
1,222,222,28,28,0,1,0
17,224,224,88,88,0,1,0
14,250,250,6,6,0,1,0
3,271,271,10,10,0,1,0
18,288,288,3,3,0,1,0
16,291,291,17,2,15,4,3
29,309,309,3,3,0,1,0
7,322,322,9,9,0,1,0
2,366,366,96,96,0,1,0
12,367,367,68,4,64,3,2
20,390,390,51,2,49,2,1
9,403,403,20,8,12,3,2
5,425,425,102,77,25,2,1
22,434,434,37,37,0,1,0
25,440,440,71,25,46,2,1
13,440,440,33,33,0,1,0
28,444,444,17,6,11,2,1
11,447,447,146,77,69,3,2
0,461,461,30,16,14,3,2
4,492,492,5,5,0,1,0

19,100,100,6,3,3,2,1
38,101,101,4,4,0,1,0
12,121,121,18,18,0,1,0
8,138,138,11,11,0,1,0
35,152,152,10,10,0,1,0
5,158,158,16,16,0,1,0
2,160,160,15,15,0,1,0
6,160,160,9,6,3,2,1
0,162,162,1,1,0,1,0
29,172,172,15,5,10,3,2
10,192,192,5,5,0,1,0
14,198,198,22,22,0,1,0
9,204,204,11,5,6,2,1
26,206,206,5,2,3,2,1
22,215,215,13,13,0,1,0
24,217,217,30,27,3,2,1
18,218,218,24,24,0,1,0
15,227,227,2,2,0,1,0
33,248,248,3,3,0,1,0
36,262,262,7,7,0,1,0
16,284,284,48,42,6,2,1
13,288,288,32,5,27,4,3
25,293,293,59,59,0,1,0
11,293,293,22,4,18,4,3
17,303,303,10,10,0,1,0
3,306,306,5,5,0,1,0
4,343,343,20,1,19,4,3
27,375,375,45,45,0,1,0
30,375,375,9,9,0,1,0
31,401,401,74,5,69,4,3
39,405,405,139,79,60,4,3
34,412,412,88,64,24,2,1
37,412,412,14,14,0,1,0
32,417,417,28,18,10,2,1
23,418,418,50,50,0,1,0
28,434,434,14,14,0,1,0
20,477,477,17,8,9,2,1
7,489,489,68,68,0,1,0
1,491,491,69,41,28,3,2
21,493,493,3,3,0,1,0

2,150,150,22,22,0,1,0
32,163,163,15,11,4,2,1
3,167,167,1,1,0,1,0
31,174,174,4,1,3,2,1
9,182,182,2,2,0,1,0
6,188,188,1,1,0,1,0
16,193,193,8,8,0,1,0
21,199,199,5,5,0,1,0
11,209,209,41,41,0,1,0
26,209,209,14,10,4,2,1
13,222,222,18,18,0,1,0
1,232,232,11,3,8,3,2
22,233,233,21,7,14,3,2
10,250,250,8,8,0,1,0
19,259,259,2,2,0,1,0
29,264,264,36,30,6,2,1
17,274,274,1,1,0,1,0
7,275,275,25,5,20,3,2
14,280,280,44,44,0,1,0
18,318,318,6,6,0,1,0
27,320,320,16,16,0,1,0
24,323,323,98,74,24,3,2
23,344,344,2,2,0,1,0
4,347,347,22,22,0,1,0
8,353,353,12,9,3,2,1
30,362,362,90,39,51,4,3
33,389,389,14,6,8,2,1
28,396,396,46,46,0,1,0
12,411,411,25,25,0,1,0
20,411,411,61,61,0,1,0
15,420,420,10,4,6,3,2
25,429,429,155,149,6,2,1
0,431,431,38,29,9,4,3
5,486,486,301,301,0,1,0

1,100,100,3,3,0,1,0
20,124,124,28,13,15,4,3
4,139,139,19,19,0,1,0
27,144,144,3,3,0,1,0
10,148,148,4,4,0,1,0
8,148,148,4,4,0,1,0
26,163,163,5,5,0,1,0
9,166,166,23,23,0,1,0
29,167,167,16,1,15,3,2
21,175,175,22,8,14,3,2
24,181,181,56,56,0,1,0
36,201,201,1,1,0,1,0
18,215,215,18,9,9,4,3
34,237,237,62,26,36,2,1
13,247,247,3,3,0,1,0
17,263,263,13,13,0,1,0
5,264,264,6,6,0,1,0
25,264,264,23,23,0,1,0
22,276,276,1,1,0,1,0
0,287,287,32,32,0,1,0
6,287,287,13,7,6,2,1
14,290,290,31,16,15,4,3
16,296,296,4,4,0,1,0
2,301,301,29,29,0,1,0
11,329,329,40,35,5,2,1
15,334,334,46,46,0,1,0
7,360,360,27,27,0,1,0
28,372,372,91,55,36,4,3
12,380,380,18,4,14,3,2
23,394,394,19,19,0,1,0
33,404,404,7,1,6,2,1
32,421,421,68,12,56,3,2
3,431,431,126,126,0,1,0
19,442,442,56,36,20,3,2
30,444,444,8,8,0,1,0
35,462,462,14,14,0,1,0
31,468,468,23,23,0,1,0

35,116,116,18,12,6,3,2
9,125,125,8,1,7,2,1
36,135,135,15,15,0,1,0
14,138,138,8,8,0,1,0
24,148,148,4,4,0,1,0
18,165,165,5,5,0,1,0
38,174,174,16,16,0,1,0
20,183,183,1,1,0,1,0
16,187,187,1,1,0,1,0
30,188,188,33,4,29,4,3
7,200,200,1,1,0,1,0
10,204,204,3,3,0,1,0
31,211,211,6,6,0,1,0
15,218,218,20,20,0,1,0
11,225,225,17,17,0,1,0
19,251,251,43,43,0,1,0
27,251,251,40,22,18,2,1
26,264,264,1,1,0,1,0
34,270,270,104,16,88,3,2
37,272,272,18,2,16,3,2
6,276,276,20,20,0,1,0
0,300,300,8,8,0,1,0
8,320,320,59,53,6,2,1
39,325,325,2,2,0,1,0
25,346,346,12,12,0,1,0
21,356,356,48,24,24,2,1
28,357,357,27,27,0,1,0
22,357,357,24,2,22,3,2
2,374,374,44,44,0,1,0
13,375,375,37,13,24,4,3
1,378,378,25,19,6,3,2
23,397,397,51,13,38,2,1
29,410,410,64,64,0,1,0
33,410,410,15,15,0,1,0
12,411,411,57,35,22,2,1
5,416,416,3,3,0,1,0
3,420,420,15,6,9,2,1
17,449,449,33,33,0,1,0
32,483,483,46,17,29,3,2
4,488,488,77,77,0,1,0

16,148,148,18,1,17,2,1
8,157,157,7,1,6,2,1
27,164,164,14,11,3,2,1
20,191,191,35,5,30,2,1
33,197,197,18,8,10,2,1
24,203,203,28,28,0,1,0
29,227,227,19,19,0,1,0
34,239,239,18,15,3,2,1
22,254,254,18,1,17,2,1
19,254,254,11,2,9,2,1
7,259,259,1,1,0,1,0
11,259,259,14,14,0,1,0
5,264,264,16,16,0,1,0
25,271,271,34,22,12,2,1
1,272,272,2,2,0,1,0
30,283,283,9,9,0,1,0
13,290,290,17,17,0,1,0
23,292,292,4,4,0,1,0
12,298,298,57,57,0,1,0
2,299,299,53,39,14,2,1
32,304,304,85,85,0,1,0
31,315,315,60,60,0,1,0
4,322,322,18,18,0,1,0
28,322,322,50,41,9,4,3
14,367,367,6,6,0,1,0
17,368,368,35,35,0,1,0
3,384,384,43,19,24,3,2
6,411,411,51,51,0,1,0
9,427,427,36,36,0,1,0
10,438,438,48,48,0,1,0
35,453,453,42,26,16,3,2
21,466,466,26,12,14,3,2
0,480,480,123,57,66,3,2
18,484,484,15,15,0,1,0
15,485,485,47,29,18,2,1
26,491,491,9,9,0,1,0

21,106,106,39,19,20,2,1
23,115,115,3,3,0,1,0
13,116,116,2,2,0,1,0
11,119,119,11,11,0,1,0
24,119,119,2,2,0,1,0
34,121,121,15,15,0,1,0
1,123,123,37,37,0,1,0
6,155,155,5,5,0,1,0
14,163,163,17,4,13,2,1
25,183,183,42,15,27,4,3
12,214,214,9,9,0,1,0
30,237,237,40,40,0,1,0
31,251,251,12,5,7,2,1
16,267,267,3,3,0,1,0
2,272,272,14,14,0,1,0
0,272,272,42,42,0,1,0
19,291,291,13,13,0,1,0
32,302,302,45,36,9,4,3
3,311,311,26,26,0,1,0
15,357,357,34,34,0,1,0
29,361,361,16,16,0,1,0
27,365,365,42,24,18,2,1
22,370,370,5,1,4,2,1
7,374,374,6,1,5,2,1
33,376,376,66,17,49,3,2
5,390,390,106,106,0,1,0
4,405,405,32,3,29,2,1
9,418,418,91,83,8,3,2
18,419,419,16,16,0,1,0
26,430,430,43,9,34,3,2
10,437,437,32,32,0,1,0
20,444,444,21,12,9,4,3
28,464,464,15,15,0,1,0
17,472,472,20,14,6,3,2
8,479,479,8,8,0,1,0

10,100,100,2,2,0,1,0
5,104,104,11,11,0,1,0
9,113,113,8,3,5,2,1
34,115,115,9,9,0,1,0
3,119,119,17,17,0,1,0
22,119,119,8,2,6,2,1
20,132,132,5,1,4,2,1
23,133,133,17,3,14,3,2
21,137,137,3,3,0,1,0
29,146,146,28,28,0,1,0
15,154,154,16,16,0,1,0
13,161,161,3,3,0,1,0
36,180,180,3,3,0,1,0
11,206,206,14,14,0,1,0
37,208,208,42,42,0,1,0
32,225,225,4,4,0,1,0
35,266,266,14,2,12,2,1
1,277,277,44,44,0,1,0
25,292,292,44,44,0,1,0
27,319,319,55,55,0,1,0
4,320,320,35,10,25,2,1
31,320,320,7,7,0,1,0
8,321,321,1,1,0,1,0
14,338,338,71,71,0,1,0
0,345,345,82,82,0,1,0
33,370,370,7,1,6,3,2
24,378,378,60,60,0,1,0
6,389,389,42,42,0,1,0
30,412,412,16,7,9,2,1
17,417,417,30,9,21,4,3
18,421,421,56,56,0,1,0
19,438,438,17,17,0,1,0
16,445,445,7,1,6,3,2
12,465,465,2,2,0,1,0
28,466,466,138,138,0,1,0
2,477,477,5,5,0,1,0
26,478,478,53,29,24,4,3
7,481,481,15,15,0,1,0

35,105,105,27,11,16,3,2
1,132,132,8,8,0,1,0
3,140,140,19,1,18,3,2
36,146,146,6,2,4,2,1
7,190,190,5,1,4,2,1
31,199,199,19,3,16,2,1
24,226,226,6,3,3,2,1
30,227,227,27,16,11,2,1
4,229,229,18,5,13,2,1
39,237,237,41,41,0,1,0
2,244,244,52,52,0,1,0
8,261,261,29,8,21,2,1
15,262,262,39,7,32,4,3
19,275,275,18,18,0,1,0
9,281,281,1,1,0,1,0
40,292,292,38,14,24,2,1
37,297,297,44,24,20,2,1
17,303,303,8,8,0,1,0
38,316,316,38,38,0,1,0
27,330,330,2,2,0,1,0
18,331,331,51,30,21,4,3
42,342,342,15,7,8,3,2
32,358,358,12,12,0,1,0
11,359,359,1,1,0,1,0
12,363,363,28,4,24,4,3
21,377,377,11,11,0,1,0
25,379,379,32,21,11,2,1
13,380,380,9,9,0,1,0
22,388,388,12,3,9,4,3
5,396,396,11,11,0,1,0
14,398,398,39,21,18,4,3
28,406,406,4,4,0,1,0
6,413,413,29,11,18,2,1
34,428,428,83,46,37,3,2
0,448,448,14,3,11,2,1
41,451,451,95,67,28,3,2
33,451,451,17,17,0,1,0
20,469,469,16,6,10,3,2
16,472,472,12,1,11,4,3
26,475,475,39,17,22,4,3
23,476,476,39,39,0,1,0
10,485,485,16,16,0,1,0
29,496,496,17,17,0,1,0

21,105,105,6,6,0,1,0
22,114,114,5,5,0,1,0
28,133,133,30,30,0,1,0
7,155,155,18,12,6,3,2
15,165,165,12,12,0,1,0
27,172,172,20,17,3,2,1
0,230,230,10,3,7,2,1
32,233,233,2,2,0,1,0
36,235,235,18,18,0,1,0
24,236,236,8,8,0,1,0
5,278,278,1,1,0,1,0
8,282,282,9,5,4,2,1
13,290,290,26,10,16,3,2
29,292,292,35,35,0,1,0
26,292,292,56,56,0,1,0
18,304,304,83,83,0,1,0
23,306,306,10,10,0,1,0
30,311,311,50,21,29,2,1
31,325,325,5,5,0,1,0
33,327,327,53,53,0,1,0
6,329,329,19,3,16,2,1
11,351,351,26,4,22,2,1
20,365,365,46,4,42,4,3
25,370,370,11,2,9,4,3
10,376,376,7,7,0,1,0
34,377,377,9,9,0,1,0
16,378,378,62,62,0,1,0
35,384,384,121,65,56,3,2
19,404,404,20,14,6,2,1
3,414,414,50,2,48,3,2
17,432,432,73,23,50,3,2
9,466,466,53,44,9,2,1
1,472,472,62,62,0,1,0
2,482,482,8,3,5,2,1
14,483,483,52,41,11,2,1
12,487,487,16,10,6,2,1
4,489,489,7,7,0,1,0

27,101,101,1,1,0,1,0
10,156,156,9,9,0,1,0
31,164,164,8,8,0,1,0
17,170,170,11,2,9,2,1
24,171,171,23,9,14,3,2
25,185,185,37,29,8,2,1
5,238,238,1,1,0,1,0
14,243,243,11,11,0,1,0
0,253,253,13,1,12,2,1
30,254,254,36,7,29,4,3
16,272,272,17,10,7,2,1
20,284,284,41,41,0,1,0
11,286,286,66,66,0,1,0
15,295,295,34,18,16,3,2
13,301,301,159,159,0,1,0
2,313,313,50,50,0,1,0
29,323,323,4,1,3,2,1
18,358,358,11,11,0,1,0
22,366,366,18,18,0,1,0
12,370,370,3,3,0,1,0
28,374,374,74,29,45,2,1
7,384,384,23,5,18,2,1
23,396,396,123,123,0,1,0
6,403,403,39,39,0,1,0
26,404,404,4,4,0,1,0
9,426,426,133,4,129,4,3
4,428,428,6,6,0,1,0
21,431,431,82,82,0,1,0
3,474,474,11,11,0,1,0
8,487,487,46,22,24,4,3
19,490,490,7,7,0,1,0
1,495,495,7,7,0,1,0

38,107,107,7,4,3,2,1
12,126,126,7,1,6,3,2
31,142,142,4,4,0,1,0
6,162,162,11,11,0,1,0
17,167,167,5,5,0,1,0
23,190,190,23,8,15,2,1
29,195,195,15,15,0,1,0
35,212,212,42,42,0,1,0
5,214,214,2,2,0,1,0
39,230,230,3,3,0,1,0
22,230,230,2,2,0,1,0
3,249,249,25,21,4,2,1
28,249,249,12,12,0,1,0
30,270,270,26,26,0,1,0
19,274,274,6,6,0,1,0
26,276,276,1,1,0,1,0
1,280,280,8,2,6,2,1
32,282,282,80,14,66,4,3
24,297,297,16,16,0,1,0
15,318,318,19,4,15,4,3
33,329,329,9,9,0,1,0
4,334,334,26,26,0,1,0
14,345,345,10,10,0,1,0
0,352,352,45,45,0,1,0
9,360,360,213,213,0,1,0
11,367,367,7,7,0,1,0
13,370,370,1,1,0,1,0
7,384,384,25,11,14,3,2
8,384,384,32,23,9,4,3
27,406,406,108,65,43,2,1
21,409,409,1,1,0,1,0
2,409,409,1,1,0,1,0
36,410,410,76,53,23,2,1
10,427,427,41,41,0,1,0
18,431,431,11,11,0,1,0
20,444,444,60,43,17,2,1
37,462,462,73,73,0,1,0
34,466,466,42,12,30,3,2
25,485,485,7,7,0,1,0
16,486,486,30,22,8,2,1

15,111,111,1,1,0,1,0
20,122,122,6,6,0,1,0
32,129,129,6,2,4,2,1
29,151,151,42,42,0,1,0
30,154,154,15,3,12,4,3
1,156,156,19,15,4,2,1
9,192,192,11,5,6,2,1
11,207,207,12,1,11,2,1
26,217,217,7,7,0,1,0
12,250,250,25,7,18,3,2
17,272,272,18,10,8,3,2
24,273,273,1,1,0,1,0
16,302,302,75,21,54,3,2
8,304,304,69,69,0,1,0
7,357,357,31,31,0,1,0
14,364,364,174,146,28,3,2
19,376,376,60,57,3,2,1
5,391,391,28,20,8,3,2
23,399,399,34,22,12,2,1
4,408,408,85,2,83,4,3
31,409,409,11,3,8,2,1
13,411,411,5,5,0,1,0
0,415,415,15,15,0,1,0
3,445,445,20,5,15,2,1
21,452,452,13,13,0,1,0
25,453,453,8,8,0,1,0
22,455,455,106,73,33,4,3
6,455,455,63,63,0,1,0
28,466,466,140,136,4,2,1
2,469,469,20,20,0,1,0
27,471,471,20,20,0,1,0
18,479,479,8,8,0,1,0
10,483,483,7,1,6,3,2

9,172,172,13,13,0,1,0
3,174,174,11,11,0,1,0
4,176,176,13,13,0,1,0
14,180,180,4,4,0,1,0
27,181,181,5,5,0,1,0
6,186,186,8,8,0,1,0
12,200,200,8,1,7,2,1
11,203,203,2,2,0,1,0
1,204,204,36,9,27,2,1
21,209,209,8,8,0,1,0
17,216,216,54,13,41,2,1
16,218,218,3,3,0,1,0
29,224,224,36,20,16,2,1
28,227,227,7,7,0,1,0
31,229,229,16,1,15,4,3
18,235,235,18,18,0,1,0
22,242,242,19,19,0,1,0
32,247,247,45,45,0,1,0
19,267,267,44,44,0,1,0
33,273,273,18,2,16,2,1
24,289,289,2,2,0,1,0
13,289,289,21,13,8,2,1
2,303,303,30,16,14,3,2
20,312,312,6,6,0,1,0
26,314,314,63,63,0,1,0
10,350,350,144,97,47,4,3
7,375,375,45,45,0,1,0
5,376,376,19,19,0,1,0
30,377,377,10,3,7,2,1
25,381,381,60,60,0,1,0
23,394,394,31,26,5,2,1
0,414,414,2,2,0,1,0
15,470,470,21,21,0,1,0
8,491,491,26,16,10,2,1
34,500,500,148,73,75,4,3
35,500,500,62,62,0,1,0

30,111,111,9,3,6,3,2
31,115,115,15,15,0,1,0
15,117,117,4,4,0,1,0
9,140,140,24,24,0,1,0
32,164,164,8,8,0,1,0
16,184,184,43,13,30,3,2
20,198,198,6,6,0,1,0
6,201,201,14,14,0,1,0
33,224,224,23,1,22,3,2
24,228,228,47,35,12,3,2
27,237,237,10,1,9,2,1
19,237,237,16,16,0,1,0
29,282,282,86,5,81,4,3
2,287,287,35,35,0,1,0
4,293,293,13,10,3,2,1
23,318,318,15,6,9,2,1
8,336,336,20,20,0,1,0
18,351,351,32,2,30,4,3
13,352,352,13,13,0,1,0
14,352,352,25,13,12,4,3
1,361,361,61,61,0,1,0
28,362,362,49,19,30,4,3
3,366,366,80,41,39,2,1
25,371,371,27,27,0,1,0
12,381,381,1,1,0,1,0
5,385,385,17,8,9,4,3
7,385,385,69,21,48,2,1
22,394,394,71,71,0,1,0
11,410,410,45,45,0,1,0
0,415,415,16,2,14,2,1
10,421,421,42,27,15,4,3
26,445,445,9,9,0,1,0
21,451,451,57,57,0,1,0
17,474,474,23,10,13,2,1

41,104,104,3,3,0,1,0
2,107,107,3,3,0,1,0
30,110,110,14,14,0,1,0
42,112,112,4,1,3,2,1
26,114,114,1,1,0,1,0
27,125,125,2,2,0,1,0
21,128,128,6,6,0,1,0
31,138,138,30,6,24,3,2
6,139,139,3,3,0,1,0
15,139,139,12,3,9,4,3
34,145,145,12,12,0,1,0
20,184,184,18,3,15,4,3
5,190,190,1,1,0,1,0
9,194,194,29,19,10,2,1
29,222,222,27,9,18,4,3
28,229,229,33,12,21,4,3
22,229,229,27,27,0,1,0
45,282,282,43,6,37,2,1
43,288,288,3,3,0,1,0
8,292,292,40,40,0,1,0
38,294,294,1,1,0,1,0
4,301,301,12,12,0,1,0
13,302,302,4,4,0,1,0
32,302,302,55,21,34,2,1
37,310,310,39,39,0,1,0
17,321,321,1,1,0,1,0
25,329,329,64,64,0,1,0
33,333,333,12,12,0,1,0
3,338,338,5,5,0,1,0
11,341,341,26,14,12,2,1
16,344,344,23,23,0,1,0
19,351,351,12,12,0,1,0
35,385,385,22,22,0,1,0
10,404,404,1,1,0,1,0
7,408,408,18,18,0,1,0
40,414,414,115,99,16,2,1
12,424,424,30,30,0,1,0
36,432,432,58,28,30,4,3
18,436,436,11,2,9,2,1
0,443,443,13,9,4,2,1
1,453,453,14,2,12,2,1
14,471,471,47,5,42,2,1
24,479,479,24,16,8,3,2
44,483,483,51,51,0,1,0
23,485,485,23,23,0,1,0
39,489,489,23,23,0,1,0

38,105,105,9,5,4,2,1
36,114,114,25,25,0,1,0
41,168,168,27,27,0,1,0
10,174,174,8,8,0,1,0
24,176,176,3,3,0,1,0
46,177,177,1,1,0,1,0
26,179,179,10,10,0,1,0
42,189,189,15,15,0,1,0
2,190,190,22,22,0,1,0
0,209,209,4,4,0,1,0
45,227,227,11,3,8,2,1
23,235,235,9,9,0,1,0
16,246,246,21,16,5,2,1
43,277,277,69,31,38,3,2
17,279,279,19,1,18,2,1
3,288,288,19,1,18,2,1
44,289,289,12,8,4,2,1
18,293,293,11,11,0,1,0
20,298,298,4,4,0,1,0
34,302,302,32,32,0,1,0
8,308,308,5,5,0,1,0
1,312,312,46,2,44,2,1
28,314,314,25,3,22,3,2
4,325,325,7,7,0,1,0
32,334,334,46,46,0,1,0
13,334,334,15,8,7,2,1
11,348,348,35,35,0,1,0
40,349,349,32,32,0,1,0
9,365,365,67,40,27,4,3
31,377,377,23,23,0,1,0
5,380,380,11,11,0,1,0
6,384,384,10,10,0,1,0
37,430,430,56,37,19,2,1
35,436,436,4,4,0,1,0
21,450,450,15,3,12,3,2
22,452,452,17,17,0,1,0
27,465,465,2,2,0,1,0
30,469,469,85,57,28,2,1
19,477,477,31,3,28,3,2
14,479,479,19,7,12,4,3
7,481,481,10,2,8,2,1
29,494,494,19,5,14,3,2
33,495,495,46,46,0,1,0
12,495,495,103,46,57,4,3
39,496,496,20,1,19,2,1
25,497,497,4,4,0,1,0
15,498,498,17,17,0,1,0

33,103,103,3,3,0,1,0
31,106,106,23,23,0,1,0
19,134,134,51,18,33,2,1
8,135,135,24,16,8,2,1
9,139,139,3,3,0,1,0
25,155,155,48,36,12,4,3
0,160,160,17,17,0,1,0
7,162,162,2,2,0,1,0
4,171,171,11,11,0,1,0
26,186,186,4,1,3,2,1
11,191,191,5,5,0,1,0
3,216,216,3,3,0,1,0
28,218,218,6,6,0,1,0
23,220,220,8,8,0,1,0
17,228,228,27,9,18,3,2
27,232,232,20,8,12,4,3
30,234,234,41,41,0,1,0
13,253,253,26,6,20,2,1
5,268,268,13,13,0,1,0
10,275,275,39,39,0,1,0
32,326,326,12,12,0,1,0
18,346,346,12,6,6,3,2
14,358,358,48,30,18,4,3
6,365,365,8,4,4,2,1
24,372,372,45,27,18,4,3
16,377,377,97,3,94,3,2
1,381,381,17,17,0,1,0
2,406,406,87,87,0,1,0
15,451,451,97,81,16,3,2
12,456,456,45,45,0,1,0
29,461,461,1,1,0,1,0
21,465,465,34,16,18,3,2
22,477,477,20,6,14,4,3
20,498,498,9,9,0,1,0

29,110,110,3,3,0,1,0
12,119,119,5,5,0,1,0
8,122,122,15,15,0,1,0
27,127,127,7,7,0,1,0
30,132,132,22,3,19,4,3
13,149,149,2,2,0,1,0
15,173,173,33,33,0,1,0
6,188,188,9,9,0,1,0
37,203,203,6,1,5,2,1
4,219,219,10,10,0,1,0
36,230,230,4,4,0,1,0
7,236,236,21,21,0,1,0
21,239,239,4,4,0,1,0
34,260,260,101,79,22,3,2
16,275,275,21,7,14,3,2
0,290,290,15,15,0,1,0
23,303,303,54,54,0,1,0
17,308,308,17,1,16,3,2
24,308,308,21,21,0,1,0
2,316,316,3,3,0,1,0
33,317,317,69,69,0,1,0
19,321,321,7,2,5,2,1
11,335,335,58,58,0,1,0
3,344,344,28,7,21,2,1
22,359,359,26,18,8,3,2
10,365,365,40,40,0,1,0
9,369,369,1,1,0,1,0
1,376,376,54,54,0,1,0
32,379,379,29,29,0,1,0
18,409,409,53,11,42,2,1
26,422,422,17,5,12,3,2
20,428,428,116,24,92,3,2
25,441,441,3,3,0,1,0
5,441,441,5,2,3,2,1
28,456,456,3,3,0,1,0
35,485,485,154,10,144,4,3
14,488,488,6,6,0,1,0
31,499,499,25,25,0,1,0

3,110,110,5,5,0,1,0
10,142,142,7,7,0,1,0
8,166,166,41,31,10,3,2
9,199,199,12,5,7,2,1
13,212,212,33,9,24,3,2
6,214,214,2,2,0,1,0
27,244,244,19,19,0,1,0
18,251,251,2,2,0,1,0
7,266,266,53,23,30,2,1
16,267,267,28,3,25,2,1
31,269,269,15,15,0,1,0
12,283,283,165,165,0,1,0
2,295,295,30,30,0,1,0
22,300,300,25,25,0,1,0
30,311,311,6,1,5,2,1
21,318,318,22,7,15,4,3
24,319,319,11,3,8,2,1
1,320,320,3,3,0,1,0
19,321,321,8,8,0,1,0
25,323,323,131,45,86,4,3
29,340,340,8,5,3,2,1
23,349,349,16,16,0,1,0
28,358,358,90,45,45,4,3
4,375,375,6,6,0,1,0
17,384,384,4,1,3,2,1
15,389,389,34,19,15,3,2
14,399,399,5,2,3,2,1
5,399,399,7,7,0,1,0
11,401,401,37,37,0,1,0
0,437,437,45,13,32,2,1
26,466,466,101,101,0,1,0
20,473,473,102,102,0,1,0

22,116,116,13,3,10,3,2
5,133,133,16,7,9,2,1
4,139,139,12,12,0,1,0
13,158,158,16,16,0,1,0
3,160,160,15,12,3,2,1
17,193,193,7,7,0,1,0
7,206,206,2,2,0,1,0
15,214,214,8,8,0,1,0
6,223,223,60,60,0,1,0
24,227,227,4,4,0,1,0
11,256,256,9,9,0,1,0
2,262,262,27,7,20,2,1
18,280,280,16,2,14,4,3
9,295,295,6,6,0,1,0
8,323,323,61,61,0,1,0
12,326,326,2,2,0,1,0
1,332,332,13,1,12,4,3
21,357,357,74,41,33,4,3
0,371,371,364,282,82,3,2
16,400,400,12,4,8,3,2
10,405,405,80,80,0,1,0
20,450,450,71,71,0,1,0
23,455,455,88,76,12,4,3
19,475,475,48,11,37,4,3
14,494,494,116,72,44,2,1

2,101,101,12,12,0,1,0
1,118,118,4,4,0,1,0
32,126,126,23,4,19,4,3
33,151,151,12,12,0,1,0
26,158,158,67,67,0,1,0
19,176,176,16,3,13,2,1
17,177,177,2,2,0,1,0
15,183,183,39,39,0,1,0
12,184,184,4,4,0,1,0
20,204,204,1,1,0,1,0
30,212,212,38,2,36,4,3
10,227,227,4,4,0,1,0
37,229,229,3,3,0,1,0
13,237,237,30,15,15,4,3
35,241,241,2,2,0,1,0
22,254,254,51,28,23,2,1
0,274,274,12,12,0,1,0
16,284,284,19,19,0,1,0
8,289,289,37,22,15,2,1
11,297,297,43,3,40,3,2
21,300,300,2,2,0,1,0
9,315,315,14,8,6,3,2
7,335,335,1,1,0,1,0
14,338,338,109,10,99,4,3
18,343,343,14,14,0,1,0
34,353,353,14,8,6,2,1
29,358,358,61,61,0,1,0
36,370,370,46,46,0,1,0
23,389,389,1,1,0,1,0
4,391,391,5,5,0,1,0
38,399,399,29,29,0,1,0
27,436,436,14,14,0,1,0
3,447,447,40,40,0,1,0
25,453,453,14,2,12,3,2
5,456,456,20,8,12,4,3
6,470,470,55,55,0,1,0
31,481,481,13,13,0,1,0
24,496,496,50,23,27,2,1
28,497,497,21,4,17,2,1

17,127,127,10,10,0,1,0
11,135,135,13,13,0,1,0
18,141,141,13,13,0,1,0
3,153,153,13,13,0,1,0
37,183,183,4,4,0,1,0
8,185,185,20,5,15,3,2
27,189,189,37,37,0,1,0
5,194,194,6,2,4,2,1
31,202,202,13,5,8,2,1
19,210,210,3,3,0,1,0
20,232,232,15,15,0,1,0
12,235,235,6,3,3,2,1
33,266,266,45,45,0,1,0
13,278,278,50,26,24,3,2
9,291,291,3,3,0,1,0
30,292,292,91,91,0,1,0
32,307,307,1,1,0,1,0
4,329,329,29,15,14,3,2
21,329,329,71,28,43,2,1
24,331,331,93,53,40,3,2
14,332,332,13,3,10,3,2
2,337,337,17,2,15,4,3
28,340,340,7,7,0,1,0
34,350,350,17,1,16,2,1
16,351,351,68,39,29,2,1
25,362,362,25,13,12,2,1
15,395,395,101,55,46,2,1
23,397,397,18,9,9,2,1
1,413,413,31,31,0,1,0
35,414,414,13,13,0,1,0
26,422,422,3,3,0,1,0
22,444,444,11,11,0,1,0
29,444,444,95,2,93,4,3
7,464,464,37,37,0,1,0
10,474,474,8,8,0,1,0
6,476,476,21,15,6,2,1
36,479,479,1,1,0,1,0
0,484,484,35,23,12,3,2

18,136,136,16,13,3,2,1
12,163,163,2,2,0,1,0
0,164,164,2,2,0,1,0
33,173,173,12,7,5,2,1
1,190,190,18,9,9,4,3
23,196,196,8,8,0,1,0
26,209,209,31,31,0,1,0
13,210,210,3,3,0,1,0
4,214,214,30,22,8,3,2
34,249,249,49,49,0,1,0
9,272,272,6,6,0,1,0
21,295,295,60,40,20,3,2
22,304,304,89,41,48,2,1
17,304,304,56,56,0,1,0
20,308,308,2,2,0,1,0
10,312,312,1,1,0,1,0
15,314,314,23,23,0,1,0
29,333,333,9,9,0,1,0
19,340,340,10,10,0,1,0
14,343,343,60,30,30,3,2
25,356,356,3,3,0,1,0
5,370,370,73,16,57,3,2
24,378,378,93,51,42,4,3
32,381,381,16,16,0,1,0
31,387,387,45,10,35,2,1
30,390,390,59,59,0,1,0
11,392,392,3,3,0,1,0
6,406,406,167,157,10,3,2
16,439,439,12,12,0,1,0
28,452,452,3,3,0,1,0
8,460,460,64,21,43,4,3
3,464,464,2,2,0,1,0
27,466,466,12,12,0,1,0
7,475,475,77,14,63,4,3
2,478,478,10,1,9,2,1

0,137,137,18,2,16,3,2
15,137,137,8,2,6,3,2
41,142,142,11,1,10,3,2
21,144,144,18,4,14,3,2
16,151,151,11,11,0,1,0
38,151,151,46,46,0,1,0
18,158,158,1,1,0,1,0
13,158,158,25,25,0,1,0
22,166,166,14,14,0,1,0
2,173,173,1,1,0,1,0
29,188,188,18,8,10,3,2
6,211,211,1,1,0,1,0
30,212,212,11,11,0,1,0
40,213,213,35,20,15,4,3
10,213,213,14,10,4,2,1
25,220,220,19,3,16,2,1
19,225,225,2,2,0,1,0
17,245,245,20,20,0,1,0
37,249,249,7,7,0,1,0
32,250,250,8,8,0,1,0
39,264,264,37,20,17,2,1
27,271,271,36,36,0,1,0
12,279,279,11,4,7,2,1
35,284,284,44,34,10,2,1
36,341,341,6,6,0,1,0
42,345,345,14,5,9,4,3
20,350,350,16,4,12,3,2
23,361,361,22,22,0,1,0
1,382,382,12,12,0,1,0
3,383,383,5,5,0,1,0
31,384,384,13,4,9,4,3
28,398,398,1,1,0,1,0
4,414,414,6,3,3,2,1
24,419,419,5,5,0,1,0
44,429,429,82,41,41,4,3
7,441,441,10,7,3,2,1
14,441,441,1,1,0,1,0
9,447,447,21,21,0,1,0
34,476,476,14,14,0,1,0
8,476,476,41,11,30,4,3
11,477,477,29,23,6,3,2
33,481,481,107,69,38,2,1
43,485,485,51,51,0,1,0
45,490,490,16,16,0,1,0
26,495,495,27,14,13,2,1
5,497,497,92,36,56,3,2

29,109,109,7,7,0,1,0
8,112,112,8,3,5,2,1
19,125,125,1,1,0,1,0
27,145,145,5,5,0,1,0
35,154,154,2,2,0,1,0
16,160,160,5,5,0,1,0
30,164,164,1,1,0,1,0
45,167,167,47,8,39,2,1
9,171,171,13,2,11,4,3
33,183,183,3,3,0,1,0
14,185,185,3,3,0,1,0
21,210,210,3,3,0,1,0
20,227,227,11,11,0,1,0
39,246,246,16,16,0,1,0
28,254,254,18,12,6,2,1
10,261,261,61,10,51,3,2
4,265,265,29,29,0,1,0
15,272,272,1,1,0,1,0
26,307,307,1,1,0,1,0
12,312,312,1,1,0,1,0
18,326,326,9,9,0,1,0
43,327,327,43,19,24,3,2
44,328,328,42,18,24,4,3
34,330,330,18,4,14,3,2
25,330,330,24,24,0,1,0
46,332,332,59,55,4,2,1
41,341,341,49,49,0,1,0
40,347,347,33,33,0,1,0
7,354,354,16,16,0,1,0
13,363,363,16,6,10,2,1
47,367,367,1,1,0,1,0
11,368,368,29,13,16,3,2
37,374,374,145,145,0,1,0
38,374,374,3,3,0,1,0
6,382,382,24,4,20,3,2
0,391,391,12,3,9,4,3
1,392,392,21,21,0,1,0
3,394,394,3,3,0,1,0
23,400,400,27,10,17,3,2
32,404,404,17,3,14,3,2
24,404,404,17,17,0,1,0
42,448,448,2,2,0,1,0
36,452,452,38,6,32,3,2
5,460,460,43,43,0,1,0
31,465,465,41,41,0,1,0
22,472,472,31,31,0,1,0
2,496,496,16,16,0,1,0
17,496,496,90,39,51,3,2

6,130,130,41,23,18,4,3
21,135,135,2,2,0,1,0
2,145,145,4,4,0,1,0
24,148,148,6,6,0,1,0
16,167,167,7,1,6,3,2
23,180,180,11,11,0,1,0
18,182,182,16,13,3,2,1
12,191,191,1,1,0,1,0
29,243,243,82,82,0,1,0
1,245,245,32,20,12,4,3
4,254,254,64,64,0,1,0
15,257,257,54,46,8,3,2
10,270,270,11,3,8,3,2
28,294,294,15,9,6,2,1
25,307,307,5,5,0,1,0
8,323,323,8,8,0,1,0
13,328,328,42,34,8,3,2
22,328,328,8,4,4,2,1
9,348,348,48,48,0,1,0
19,366,366,92,92,0,1,0
14,396,396,41,28,13,2,1
30,427,427,3,3,0,1,0
7,434,434,43,3,40,4,3
26,435,435,41,17,24,2,1
20,456,456,29,1,28,3,2
0,459,459,100,100,0,1,0
17,467,467,66,66,0,1,0
5,482,482,6,6,0,1,0
11,484,484,144,144,0,1,0
3,489,489,6,1,5,2,1
27,499,499,90,48,42,3,2

17,101,101,3,3,0,1,0
10,110,110,4,4,0,1,0
24,117,117,16,16,0,1,0
28,125,125,9,2,7,2,1
5,151,151,33,18,15,4,3
23,152,152,32,32,0,1,0
16,160,160,2,2,0,1,0
0,204,204,2,2,0,1,0
8,204,204,6,3,3,2,1
11,211,211,56,56,0,1,0
25,238,238,1,1,0,1,0
18,244,244,32,32,0,1,0
9,253,253,70,70,0,1,0
4,254,254,35,35,0,1,0
3,290,290,36,28,8,3,2
7,320,320,118,78,40,3,2
19,323,323,44,23,21,4,3
20,351,351,5,5,0,1,0
6,361,361,22,22,0,1,0
13,368,368,7,1,6,2,1
15,384,384,226,198,28,2,1
14,411,411,47,47,0,1,0
1,425,425,3,3,0,1,0
12,455,455,19,3,16,3,2
27,468,468,14,6,8,3,2
2,480,480,80,36,44,3,2
22,486,486,8,8,0,1,0
21,487,487,40,40,0,1,0
26,498,498,47,47,0,1,0

13,108,108,11,5,6,3,2
20,109,109,31,31,0,1,0
11,115,115,4,4,0,1,0
22,123,123,4,4,0,1,0
15,151,151,22,14,8,3,2
6,162,162,22,22,0,1,0
17,209,209,4,1,3,2,1
8,219,219,101,101,0,1,0
21,220,220,42,26,16,2,1
4,227,227,30,30,0,1,0
1,236,236,24,24,0,1,0
5,270,270,3,3,0,1,0
27,288,288,47,20,27,2,1
9,300,300,15,15,0,1,0
24,307,307,27,7,20,3,2
0,341,341,129,129,0,1,0
23,352,352,19,13,6,2,1
19,358,358,6,3,3,2,1
7,379,379,2,2,0,1,0
14,405,405,5,5,0,1,0
18,416,416,66,18,48,3,2
2,424,424,33,9,24,4,3
3,430,430,43,10,33,2,1
12,450,450,5,5,0,1,0
26,451,451,27,27,0,1,0
10,454,454,112,112,0,1,0
16,461,461,88,72,16,2,1
25,478,478,80,1,79,3,2

7,109,109,7,7,0,1,0
11,112,112,11,3,8,3,2
30,112,112,18,18,0,1,0
13,131,131,21,10,11,2,1
27,145,145,21,21,0,1,0
2,169,169,7,1,6,3,2
29,246,246,22,22,0,1,0
25,246,246,40,3,37,2,1
10,261,261,5,2,3,2,1
28,265,265,7,7,0,1,0
9,283,283,2,2,0,1,0
8,292,292,13,3,10,3,2
15,304,304,12,12,0,1,0
4,310,310,114,15,99,4,3
6,323,323,18,4,14,3,2
23,338,338,22,1,21,4,3
12,341,341,1,1,0,1,0
17,343,343,31,15,16,2,1
0,358,358,86,45,41,4,3
5,360,360,76,67,9,4,3
26,360,360,4,4,0,1,0
20,378,378,25,25,0,1,0
24,385,385,42,42,0,1,0
21,397,397,26,26,0,1,0
19,433,433,174,120,54,4,3
14,442,442,12,12,0,1,0
22,446,446,15,4,11,2,1
1,456,456,76,76,0,1,0
32,465,465,84,66,18,4,3
34,473,473,69,69,0,1,0
18,475,475,23,5,18,3,2
3,483,483,26,11,15,3,2
16,490,490,6,6,0,1,0
31,499,499,3,3,0,1,0
33,500,500,7,7,0,1,0

33,102,102,3,3,0,1,0
15,124,124,1,1,0,1,0
10,125,125,4,4,0,1,0
9,134,134,3,3,0,1,0
37,137,137,4,4,0,1,0
12,147,147,1,1,0,1,0
0,161,161,5,1,4,2,1
19,162,162,2,2,0,1,0
7,163,163,18,18,0,1,0
23,170,170,23,8,15,2,1
29,177,177,9,9,0,1,0
3,186,186,37,37,0,1,0
20,192,192,12,12,0,1,0
6,222,222,45,15,30,2,1
22,223,223,1,1,0,1,0
13,254,254,52,52,0,1,0
21,291,291,20,20,0,1,0
25,303,303,38,38,0,1,0
1,305,305,18,9,9,2,1
11,327,327,9,9,0,1,0
36,337,337,69,9,60,3,2
8,342,342,16,6,10,2,1
31,351,351,23,23,0,1,0
17,353,353,45,45,0,1,0
30,357,357,96,96,0,1,0
16,358,358,51,51,0,1,0
38,360,360,50,50,0,1,0
5,367,367,28,1,27,4,3
28,369,369,12,4,8,2,1
32,391,391,64,54,10,3,2
2,394,394,2,2,0,1,0
26,441,441,26,26,0,1,0
18,462,462,1,1,0,1,0
27,466,466,18,7,11,2,1
4,470,470,13,13,0,1,0
35,482,482,8,8,0,1,0
40,485,485,62,62,0,1,0
34,486,486,5,2,3,2,1
24,490,490,162,128,34,3,2
14,494,494,43,43,0,1,0
39,496,496,14,5,9,2,1

23,133,133,5,5,0,1,0
11,146,146,22,11,11,2,1
21,154,154,27,27,0,1,0
18,155,155,20,8,12,2,1
0,156,156,31,31,0,1,0
7,156,156,37,37,0,1,0
10,174,174,23,7,16,3,2
26,179,179,28,4,24,4,3
4,198,198,6,6,0,1,0
27,199,199,2,2,0,1,0
22,232,232,35,17,18,4,3
15,236,236,8,2,6,3,2
3,244,244,8,8,0,1,0
30,249,249,8,3,5,2,1
24,263,263,8,8,0,1,0
9,285,285,6,6,0,1,0
25,326,326,62,62,0,1,0
14,363,363,113,65,48,3,2
13,368,368,94,12,82,4,3
5,380,380,1,1,0,1,0
20,399,399,47,47,0,1,0
12,411,411,43,43,0,1,0
1,431,431,19,19,0,1,0
19,435,435,37,3,34,2,1
8,439,439,110,77,33,2,1
6,454,454,81,81,0,1,0
16,454,454,10,3,7,2,1
28,475,475,45,1,44,3,2
17,484,484,42,42,0,1,0
29,489,489,31,22,9,4,3
2,497,497,31,31,0,1,0

7,127,127,1,1,0,1,0
31,168,168,19,4,15,4,3
28,173,173,2,2,0,1,0
4,178,178,6,6,0,1,0
24,180,180,12,7,5,2,1
11,202,202,31,27,4,2,1
8,208,208,1,1,0,1,0
9,219,219,9,9,0,1,0
5,251,251,23,11,12,3,2
15,260,260,47,47,0,1,0
2,274,274,1,1,0,1,0
20,287,287,10,1,9,4,3
22,289,289,47,17,30,4,3
25,295,295,88,42,46,2,1
3,301,301,12,12,0,1,0
30,320,320,6,6,0,1,0
26,323,323,56,56,0,1,0
0,338,338,16,16,0,1,0
17,349,349,29,7,22,3,2
27,349,349,9,9,0,1,0
13,351,351,71,20,51,4,3
23,360,360,1,1,0,1,0
21,372,372,46,16,30,2,1
16,387,387,94,6,88,3,2
10,427,427,122,26,96,3,2
18,449,449,13,4,9,4,3
29,450,450,7,7,0,1,0
32,454,454,144,24,120,4,3
19,455,455,1,1,0,1,0
1,473,473,140,81,59,4,3
14,479,479,24,24,0,1,0
12,480,480,9,1,8,3,2
6,487,487,120,38,82,3,2

10,149,149,30,3,27,4,3
3,186,186,3,3,0,1,0
12,195,195,36,19,17,2,1
13,196,196,4,4,0,1,0
8,211,211,36,10,26,2,1
5,216,216,152,152,0,1,0
0,224,224,40,4,36,2,1
22,241,241,76,44,32,2,1
18,278,278,42,34,8,3,2
20,312,312,10,10,0,1,0
17,313,313,3,3,0,1,0
9,326,326,25,3,22,3,2
11,327,327,29,12,17,2,1
16,331,331,14,14,0,1,0
21,343,343,12,4,8,2,1
15,351,351,15,15,0,1,0
6,369,369,12,4,8,2,1
7,386,386,31,31,0,1,0
4,386,386,60,60,0,1,0
2,415,415,153,153,0,1,0
14,415,415,21,21,0,1,0
19,433,433,88,88,0,1,0
1,454,454,126,82,44,4,3

28,102,102,31,31,0,1,0
1,121,121,18,6,12,3,2
30,138,138,7,7,0,1,0
7,153,153,10,1,9,2,1
24,154,154,49,31,18,3,2
4,166,166,22,14,8,2,1
3,169,169,17,17,0,1,0
22,171,171,9,1,8,3,2
10,172,172,6,3,3,2,1
29,182,182,28,28,0,1,0
26,226,226,17,6,11,2,1
13,243,243,11,11,0,1,0
33,254,254,5,5,0,1,0
27,263,263,7,7,0,1,0
32,269,269,15,7,8,2,1
35,279,279,3,3,0,1,0
36,288,288,10,6,4,2,1
2,291,291,8,8,0,1,0
19,306,306,50,50,0,1,0
20,308,308,2,2,0,1,0
31,323,323,1,1,0,1,0
12,324,324,12,12,0,1,0
6,340,340,45,29,16,3,2
8,347,347,37,19,18,2,1
21,352,352,84,62,22,2,1
14,361,361,27,17,10,3,2
23,362,362,30,30,0,1,0
25,374,374,61,11,50,2,1
18,383,383,24,16,8,2,1
34,389,389,56,40,16,3,2
11,390,390,58,58,0,1,0
5,404,404,4,4,0,1,0
15,429,429,55,41,14,3,2
0,432,432,19,19,0,1,0
17,438,438,16,16,0,1,0
16,473,473,92,60,32,2,1
9,476,476,4,1,3,2,1

13,118,118,5,5,0,1,0
34,126,126,4,1,3,2,1
12,135,135,2,2,0,1,0
10,140,140,1,1,0,1,0
28,143,143,12,12,0,1,0
22,148,148,5,5,0,1,0
26,160,160,25,25,0,1,0
27,169,169,17,9,8,3,2
0,177,177,2,2,0,1,0
9,184,184,35,12,23,2,1
29,185,185,15,9,6,3,2
17,196,196,1,1,0,1,0
18,204,204,11,11,0,1,0
31,220,220,1,1,0,1,0
4,232,232,19,1,18,4,3
3,252,252,1,1,0,1,0
14,252,252,23,23,0,1,0
15,256,256,39,39,0,1,0
21,259,259,3,3,0,1,0
7,263,263,36,27,9,2,1
30,272,272,24,24,0,1,0
16,275,275,76,22,54,4,3
5,282,282,40,40,0,1,0
19,289,289,26,26,0,1,0
1,320,320,16,16,0,1,0
23,340,340,37,33,4,2,1
24,349,349,68,33,35,2,1
6,366,366,80,80,0,1,0
11,400,400,45,30,15,4,3
8,402,402,36,33,3,2,1
2,409,409,32,32,0,1,0
25,414,414,102,32,70,3,2
32,442,442,42,14,28,2,1
20,480,480,109,109,0,1,0
33,485,485,65,65,0,1,0

4,135,135,1,1,0,1,0
13,151,151,15,6,9,2,1
26,152,152,11,1,10,2,1
35,161,161,47,43,4,2,1
32,163,163,15,15,0,1,0
8,169,169,16,16,0,1,0
28,182,182,13,5,8,3,2
34,183,183,42,42,0,1,0
22,197,197,12,3,9,2,1
23,205,205,25,3,22,2,1
31,214,214,6,6,0,1,0
7,218,218,13,13,0,1,0
9,221,221,11,1,10,3,2
38,240,240,19,7,12,2,1
27,244,244,18,1,17,2,1
29,245,245,14,2,12,2,1
30,249,249,41,11,30,3,2
39,250,250,5,5,0,1,0
6,264,264,20,6,14,4,3
1,265,265,7,7,0,1,0
36,267,267,23,23,0,1,0
21,276,276,38,21,17,2,1
25,288,288,1,1,0,1,0
16,310,310,18,18,0,1,0
10,317,317,34,34,0,1,0
24,325,325,16,16,0,1,0
18,338,338,48,17,31,2,1
37,339,339,41,26,15,2,1
17,356,356,36,16,20,3,2
20,362,362,17,3,14,2,1
12,378,378,1,1,0,1,0
3,401,401,8,8,0,1,0
0,433,433,63,9,54,4,3
2,449,449,96,96,0,1,0
14,456,456,2,2,0,1,0
15,456,456,4,4,0,1,0
5,465,465,56,56,0,1,0
33,482,482,82,31,51,4,3
19,491,491,38,17,21,2,1
11,498,498,22,10,12,3,2

0,106,106,3,3,0,1,0
20,111,111,26,26,0,1,0
14,118,118,4,1,3,2,1
19,120,120,26,13,13,2,1
29,146,146,3,3,0,1,0
17,147,147,13,13,0,1,0
1,155,155,6,6,0,1,0
28,165,165,45,45,0,1,0
12,167,167,9,9,0,1,0
32,169,169,19,16,3,2,1
24,179,179,41,41,0,1,0
13,215,215,4,4,0,1,0
18,258,258,21,3,18,3,2
21,271,271,14,11,3,2,1
3,275,275,4,1,3,2,1
22,283,283,5,1,4,2,1
9,292,292,61,20,41,4,3
7,308,308,72,72,0,1,0
4,320,320,31,31,0,1,0
31,333,333,12,2,10,3,2
8,335,335,44,44,0,1,0
33,338,338,5,1,4,2,1
27,342,342,2,2,0,1,0
2,342,342,12,6,6,2,1
23,350,350,5,5,0,1,0
6,363,363,40,40,0,1,0
30,385,385,12,12,0,1,0
15,386,386,5,5,0,1,0
25,393,393,10,10,0,1,0
11,402,402,59,49,10,2,1
5,406,406,51,51,0,1,0
26,423,423,118,118,0,1,0
16,436,436,146,111,35,2,1
10,499,499,38,38,0,1,0

1,145,145,6,6,0,1,0
5,150,150,7,7,0,1,0
7,152,152,18,3,15,4,3
16,162,162,28,16,12,3,2
33,163,163,17,17,0,1,0
20,200,200,16,4,12,2,1
12,201,201,5,1,4,2,1
8,203,203,2,2,0,1,0
28,208,208,12,12,0,1,0
32,220,220,12,12,0,1,0
27,257,257,19,19,0,1,0
15,259,259,30,30,0,1,0
25,267,267,49,18,31,2,1
3,277,277,93,27,66,4,3
14,295,295,48,48,0,1,0
30,309,309,24,18,6,3,2
26,322,322,52,37,15,2,1
23,339,339,26,26,0,1,0
17,355,355,30,21,9,2,1
4,371,371,27,27,0,1,0
6,373,373,36,1,35,2,1
18,376,376,1,1,0,1,0
31,383,383,46,20,26,2,1
29,390,390,33,13,20,3,2
0,400,400,34,34,0,1,0
22,404,404,72,12,60,4,3
10,408,408,30,30,0,1,0
9,417,417,49,37,12,2,1
2,424,424,80,80,0,1,0
24,428,428,79,43,36,4,3
13,434,434,16,10,6,3,2
21,446,446,19,11,8,2,1
19,449,449,71,71,0,1,0
11,485,485,1,1,0,1,0

15,103,103,17,7,10,3,2
19,114,114,3,3,0,1,0
31,122,122,15,6,9,4,3
36,123,123,10,3,7,2,1
18,140,140,1,1,0,1,0
30,140,140,3,3,0,1,0
40,141,141,44,44,0,1,0
37,153,153,11,11,0,1,0
21,155,155,7,7,0,1,0
41,180,180,16,16,0,1,0
16,200,200,6,6,0,1,0
34,201,201,19,1,18,4,3
12,205,205,27,19,8,2,1
24,226,226,14,14,0,1,0
23,234,234,4,4,0,1,0
45,256,256,123,123,0,1,0
17,267,267,11,11,0,1,0
27,278,278,4,4,0,1,0
35,283,283,4,1,3,2,1
6,287,287,37,3,34,2,1
3,293,293,1,1,0,1,0
28,297,297,26,2,24,4,3
5,315,315,17,17,0,1,0
38,326,326,13,13,0,1,0
42,328,328,5,5,0,1,0
7,329,329,12,6,6,2,1
44,332,332,37,9,28,2,1
2,341,341,7,1,6,3,2
11,357,357,20,20,0,1,0
9,364,364,38,38,0,1,0
22,370,370,3,3,0,1,0
33,375,375,56,42,14,2,1
20,377,377,34,6,28,2,1
4,379,379,3,3,0,1,0
1,384,384,9,9,0,1,0
43,385,385,3,3,0,1,0
25,394,394,49,49,0,1,0
8,412,412,8,8,0,1,0
10,433,433,14,10,4,2,1
32,438,438,9,9,0,1,0
39,441,441,41,41,0,1,0
26,441,441,67,67,0,1,0
14,448,448,10,3,7,2,1
29,470,470,9,2,7,2,1
0,479,479,87,87,0,1,0
13,479,479,5,5,0,1,0

30,129,129,41,41,0,1,0
2,135,135,6,6,0,1,0
8,167,167,27,27,0,1,0
0,218,218,5,5,0,1,0
7,221,221,62,62,0,1,0
1,226,226,19,19,0,1,0
18,233,233,23,23,0,1,0
4,245,245,40,7,33,4,3
3,249,249,27,16,11,2,1
23,250,250,50,50,0,1,0
25,260,260,8,2,6,3,2
6,287,287,67,34,33,4,3
17,305,305,11,5,6,3,2
27,309,309,11,3,8,3,2
15,313,313,17,17,0,1,0
5,316,316,3,3,0,1,0
9,323,323,33,33,0,1,0
28,367,367,129,46,83,4,3
10,370,370,88,88,0,1,0
13,371,371,14,6,8,2,1
26,383,383,35,35,0,1,0
19,417,417,1,1,0,1,0
29,418,418,38,38,0,1,0
16,441,441,17,4,13,2,1
12,445,445,41,29,12,4,3
14,463,463,60,13,47,4,3
22,469,469,12,1,11,2,1
24,469,469,45,27,18,3,2
21,485,485,10,3,7,2,1
20,490,490,54,35,19,2,1
11,490,490,60,60,0,1,0

7,100,100,2,2,0,1,0
5,127,127,28,28,0,1,0
32,146,146,11,11,0,1,0
14,147,147,4,4,0,1,0
0,154,154,1,1,0,1,0
33,155,155,22,22,0,1,0
25,166,166,22,22,0,1,0
28,204,204,22,22,0,1,0
24,210,210,20,9,11,2,1
8,215,215,9,3,6,2,1
22,224,224,23,16,7,2,1
10,235,235,3,3,0,1,0
20,245,245,13,1,12,4,3
16,253,253,1,1,0,1,0
3,267,267,43,33,10,2,1
15,274,274,7,7,0,1,0
39,302,302,41,5,36,3,2
12,307,307,29,6,23,3,2
18,313,313,26,26,0,1,0
29,323,323,4,4,0,1,0
2,338,338,1,1,0,1,0
17,348,348,24,9,15,2,1
36,355,355,24,24,0,1,0
35,360,360,167,150,17,2,1
27,365,365,1,1,0,1,0
23,390,390,19,19,0,1,0
31,391,391,55,31,24,3,2
11,400,400,36,24,12,4,3
30,421,421,22,22,0,1,0
13,424,424,44,26,18,2,1
19,440,440,103,47,56,4,3
37,450,450,23,23,0,1,0
38,450,450,24,24,0,1,0
1,451,451,64,64,0,1,0
4,467,467,11,11,0,1,0
6,478,478,30,25,5,2,1
9,486,486,41,7,34,3,2
26,491,491,25,25,0,1,0
34,492,492,48,33,15,2,1
21,493,493,19,19,0,1,0

38,100,100,5,5,0,1,0
10,111,111,2,2,0,1,0
14,125,125,12,12,0,1,0
9,153,153,2,2,0,1,0
13,157,157,3,3,0,1,0
16,159,159,23,23,0,1,0
31,162,162,19,11,8,3,2
4,184,184,5,5,0,1,0
39,187,187,26,26,0,1,0
34,192,192,5,2,3,2,1
28,195,195,6,2,4,2,1
15,217,217,47,20,27,3,2
30,217,217,77,15,62,3,2
21,234,234,9,1,8,2,1
17,238,238,22,22,0,1,0
25,270,270,1,1,0,1,0
24,272,272,53,41,12,3,2
1,287,287,27,27,0,1,0
27,289,289,101,101,0,1,0
29,293,293,5,5,0,1,0
2,316,316,3,3,0,1,0
37,316,316,3,3,0,1,0
19,318,318,47,47,0,1,0
3,321,321,22,22,0,1,0
32,341,341,42,42,0,1,0
7,368,368,65,65,0,1,0
6,395,395,28,28,0,1,0
12,403,403,3,3,0,1,0
20,405,405,50,27,23,2,1
35,420,420,13,9,4,2,1
26,420,420,78,35,43,2,1
36,432,432,11,11,0,1,0
8,438,438,8,1,7,2,1
0,444,444,3,3,0,1,0
11,446,446,5,5,0,1,0
22,455,455,21,4,17,2,1
5,462,462,19,14,5,2,1
33,478,478,8,8,0,1,0
18,498,498,106,16,90,4,3
23,500,500,32,16,16,3,2

29,122,122,8,8,0,1,0
8,149,149,37,30,7,2,1
16,156,156,39,26,13,2,1
1,159,159,17,1,16,3,2
3,164,164,13,13,0,1,0
14,173,173,24,24,0,1,0
25,181,181,16,16,0,1,0
18,185,185,29,10,19,2,1
10,207,207,12,6,6,2,1
12,226,226,20,3,17,4,3
24,279,279,3,3,0,1,0
22,279,279,37,22,15,4,3
21,279,279,19,19,0,1,0
4,286,286,131,80,51,4,3
6,314,314,1,1,0,1,0
15,331,331,33,33,0,1,0
9,353,353,61,61,0,1,0
26,353,353,129,73,56,3,2
13,364,364,15,4,11,2,1
11,368,368,61,4,57,4,3
20,373,373,21,4,17,2,1
19,394,394,67,46,21,2,1
28,396,396,4,1,3,2,1
17,418,418,2,2,0,1,0
7,427,427,42,6,36,3,2
23,471,471,23,14,9,4,3
5,472,472,31,5,26,3,2
0,491,491,27,6,21,2,1
2,495,495,50,50,0,1,0
27,499,499,12,12,0,1,0

15,124,124,19,19,0,1,0
4,126,126,4,4,0,1,0
39,142,142,3,3,0,1,0
9,147,147,1,1,0,1,0
2,150,150,1,1,0,1,0
32,151,151,4,1,3,2,1
0,153,153,15,15,0,1,0
14,154,154,52,9,43,4,3
19,154,154,4,4,0,1,0
30,171,171,37,12,25,2,1
18,173,173,26,26,0,1,0
16,191,191,6,6,0,1,0
6,199,199,27,6,21,2,1
26,202,202,62,22,40,2,1
25,212,212,7,7,0,1,0
12,220,220,6,6,0,1,0
20,226,226,11,5,6,2,1
33,226,226,6,2,4,2,1
10,238,238,6,3,3,2,1
24,246,246,11,11,0,1,0
38,248,248,1,1,0,1,0
3,261,261,6,6,0,1,0
23,269,269,11,11,0,1,0
35,283,283,21,15,6,3,2
27,283,283,10,2,8,2,1
28,295,295,39,11,28,2,1
37,298,298,57,36,21,3,2
17,300,300,7,4,3,2,1
34,313,313,23,2,21,2,1
5,341,341,14,14,0,1,0
40,358,358,20,20,0,1,0
42,372,372,25,10,15,4,3
11,391,391,8,3,5,2,1
1,391,391,13,13,0,1,0
36,398,398,43,4,39,2,1
22,402,402,42,6,36,2,1
21,409,409,1,1,0,1,0
13,420,420,88,60,28,2,1
31,427,427,79,79,0,1,0
7,432,432,13,7,6,3,2
8,452,452,8,5,3,2,1
29,463,463,16,16,0,1,0
41,471,471,80,60,20,3,2

20,107,107,4,4,0,1,0
34,110,110,9,9,0,1,0
21,113,113,1,1,0,1,0
16,115,115,3,3,0,1,0
25,122,122,11,7,4,2,1
22,125,125,7,7,0,1,0
17,129,129,7,7,0,1,0
4,145,145,23,15,8,3,2
32,179,179,39,39,0,1,0
23,196,196,36,36,0,1,0
1,208,208,5,5,0,1,0
28,209,209,23,23,0,1,0
6,216,216,7,7,0,1,0
3,235,235,1,1,0,1,0
15,240,240,12,12,0,1,0
7,254,254,30,30,0,1,0
30,259,259,18,18,0,1,0
27,266,266,61,17,44,2,1
26,271,271,50,44,6,2,1
8,282,282,23,2,21,4,3
33,297,297,41,41,0,1,0
12,299,299,48,48,0,1,0
31,323,323,43,43,0,1,0
29,324,324,4,4,0,1,0
13,344,344,28,28,0,1,0
5,351,351,84,22,62,3,2
14,402,402,34,34,0,1,0
24,402,402,7,7,0,1,0
0,403,403,5,5,0,1,0
11,416,416,126,19,107,4,3
10,440,440,7,1,6,2,1
19,442,442,68,68,0,1,0
18,468,468,21,9,12,4,3
35,477,477,10,10,0,1,0
9,484,484,5,1,4,2,1
2,487,487,97,93,4,2,1

32,110,110,3,3,0,1,0
33,112,112,4,4,0,1,0
35,121,121,8,8,0,1,0
9,124,124,26,26,0,1,0
23,142,142,8,2,6,3,2
14,143,143,15,15,0,1,0
13,152,152,5,5,0,1,0
41,160,160,17,7,10,2,1
25,172,172,7,7,0,1,0
17,172,172,4,4,0,1,0
20,197,197,13,13,0,1,0
4,216,216,5,5,0,1,0
6,219,219,6,6,0,1,0
40,221,221,43,43,0,1,0
12,235,235,1,1,0,1,0
24,268,268,16,4,12,4,3
5,268,268,21,2,19,3,2
26,279,279,85,16,69,4,3
36,279,279,18,18,0,1,0
37,282,282,18,13,5,2,1
27,293,293,8,2,6,3,2
1,305,305,4,4,0,1,0
2,317,317,62,46,16,2,1
7,329,329,10,10,0,1,0
22,333,333,6,2,4,2,1
15,334,334,8,1,7,2,1
11,338,338,10,10,0,1,0
3,339,339,9,9,0,1,0
8,352,352,5,5,0,1,0
16,368,368,41,33,8,3,2
0,370,370,38,28,10,3,2
28,383,383,46,46,0,1,0
18,390,390,2,2,0,1,0
39,406,406,101,2,99,4,3
31,437,437,58,45,13,4,3
19,448,448,41,31,10,3,2
38,457,457,65,9,56,3,2
30,459,459,49,49,0,1,0
21,461,461,131,77,54,4,3
34,473,473,27,27,0,1,0
29,476,476,4,4,0,1,0
10,497,497,35,13,22,2,1

35,115,115,3,3,0,1,0
2,123,123,1,1,0,1,0
18,142,142,1,1,0,1,0
28,148,148,28,28,0,1,0
9,160,160,31,25,6,3,2
34,161,161,6,3,3,2,1
11,172,172,4,4,0,1,0
6,174,174,13,7,6,3,2
14,182,182,13,5,8,2,1
19,189,189,43,1,42,4,3
8,193,193,19,19,0,1,0
24,216,216,3,3,0,1,0
3,217,217,11,3,8,2,1
7,244,244,38,13,25,4,3
4,295,295,6,2,4,2,1
5,307,307,62,62,0,1,0
31,312,312,1,1,0,1,0
16,330,330,15,6,9,4,3
29,359,359,53,53,0,1,0
23,364,364,7,7,0,1,0
33,367,367,43,43,0,1,0
26,368,368,19,19,0,1,0
30,369,369,112,94,18,4,3
20,394,394,125,125,0,1,0
0,395,395,132,132,0,1,0
22,397,397,55,46,9,4,3
10,424,424,9,9,0,1,0
15,428,428,57,57,0,1,0
21,438,438,6,6,0,1,0
13,445,445,40,13,27,2,1
1,452,452,12,6,6,3,2
12,453,453,46,46,0,1,0
25,460,460,12,12,0,1,0
27,476,476,5,1,4,2,1
32,477,477,43,43,0,1,0
17,486,486,22,6,16,2,1

29,101,101,3,3,0,1,0
13,108,108,5,5,0,1,0
25,124,124,7,7,0,1,0
34,132,132,8,8,0,1,0
10,142,142,10,2,8,3,2
7,149,149,1,1,0,1,0
21,166,166,10,10,0,1,0
33,170,170,43,2,41,3,2
5,172,172,20,8,12,4,3
11,174,174,8,4,4,2,1
9,179,179,25,25,0,1,0
1,191,191,21,9,12,3,2
30,193,193,55,55,0,1,0
14,197,197,17,17,0,1,0
16,198,198,8,8,0,1,0
20,217,217,81,81,0,1,0
19,227,227,8,1,7,2,1
3,239,239,27,13,14,2,1
8,239,239,2,2,0,1,0
18,258,258,74,74,0,1,0
0,262,262,17,1,16,2,1
27,264,264,12,2,10,2,1
22,281,281,19,3,16,2,1
28,284,284,11,2,9,4,3
12,285,285,52,26,26,3,2
2,288,288,17,17,0,1,0
23,301,301,7,2,5,2,1
24,319,319,8,8,0,1,0
15,327,327,28,4,24,2,1
26,346,346,26,12,14,2,1
31,363,363,67,21,46,3,2
6,373,373,36,36,0,1,0
17,407,407,45,20,25,2,1
32,412,412,40,9,31,4,3
35,427,427,9,9,0,1,0
4,483,483,16,16,0,1,0

7,127,127,25,25,0,1,0
14,131,131,23,23,0,1,0
22,158,158,3,3,0,1,0
17,163,163,2,2,0,1,0
28,185,185,8,8,0,1,0
10,191,191,41,5,36,4,3
15,219,219,30,30,0,1,0
12,254,254,73,73,0,1,0
1,265,265,56,14,42,3,2
25,279,279,12,12,0,1,0
21,283,283,18,18,0,1,0
20,287,287,4,4,0,1,0
18,330,330,91,4,87,4,3
6,334,334,53,49,4,2,1
26,338,338,101,51,50,2,1
23,339,339,11,11,0,1,0
16,380,380,12,8,4,2,1
0,388,388,57,36,21,4,3
19,404,404,126,87,39,4,3
2,418,418,1,1,0,1,0
13,420,420,46,46,0,1,0
24,425,425,3,3,0,1,0
8,425,425,7,4,3,2,1
27,433,433,19,19,0,1,0
5,439,439,20,20,0,1,0
9,446,446,32,5,27,3,2
11,449,449,3,3,0,1,0
29,475,475,51,39,12,3,2
4,484,484,63,63,0,1,0
3,492,492,105,18,87,4,3

19,102,102,7,7,0,1,0
18,113,113,1,1,0,1,0
31,120,120,11,11,0,1,0
10,120,120,11,11,0,1,0
13,129,129,1,1,0,1,0
7,142,142,3,3,0,1,0
4,155,155,16,16,0,1,0
17,158,158,29,19,10,2,1
32,160,160,13,4,9,4,3
12,161,161,2,2,0,1,0
6,175,175,1,1,0,1,0
26,178,178,28,28,0,1,0
33,206,206,50,27,23,2,1
11,214,214,9,4,5,2,1
36,229,229,14,2,12,2,1
40,231,231,37,37,0,1,0
2,233,233,3,3,0,1,0
1,261,261,1,1,0,1,0
39,280,280,11,11,0,1,0
42,284,284,109,73,36,4,3
27,287,287,17,17,0,1,0
22,291,291,1,1,0,1,0
23,308,308,14,14,0,1,0
43,320,320,73,17,56,3,2
41,327,327,13,1,12,3,2
14,330,330,53,53,0,1,0
37,334,334,4,4,0,1,0
21,347,347,88,40,48,3,2
9,357,357,6,2,4,2,1
25,358,358,9,1,8,3,2
5,381,381,34,34,0,1,0
35,393,393,28,6,22,2,1
16,404,404,2,2,0,1,0
38,406,406,3,3,0,1,0
0,418,418,35,35,0,1,0
8,425,425,48,48,0,1,0
24,430,430,21,3,18,3,2
30,433,433,32,20,12,3,2
28,452,452,27,27,0,1,0
20,460,460,58,32,26,2,1
34,462,462,2,2,0,1,0
15,463,463,4,4,0,1,0
3,475,475,1,1,0,1,0
29,481,481,56,56,0,1,0

16,121,121,1,1,0,1,0
29,125,125,34,34,0,1,0
24,128,128,22,22,0,1,0
26,161,161,8,8,0,1,0
35,161,161,23,23,0,1,0
33,165,165,9,9,0,1,0
17,170,170,1,1,0,1,0
15,177,177,10,6,4,2,1
11,180,180,1,1,0,1,0
27,195,195,1,1,0,1,0
36,207,207,50,11,39,4,3
3,220,220,18,18,0,1,0
22,230,230,15,6,9,2,1
4,233,233,33,33,0,1,0
0,239,239,12,12,0,1,0
5,250,250,8,2,6,3,2
34,257,257,2,2,0,1,0
28,274,274,23,15,8,3,2
19,283,283,1,1,0,1,0
10,284,284,41,41,0,1,0
18,302,302,9,9,0,1,0
12,312,312,4,4,0,1,0
1,318,318,44,7,37,2,1
37,325,325,20,20,0,1,0
32,345,345,9,9,0,1,0
20,371,371,13,3,10,3,2
38,373,373,4,1,3,2,1
7,384,384,25,12,13,2,1
25,389,389,49,49,0,1,0
9,404,404,1,1,0,1,0
14,414,414,24,1,23,2,1
30,417,417,81,49,32,3,2
8,433,433,12,12,0,1,0
2,440,440,82,21,61,4,3
23,449,449,35,6,29,2,1
31,449,449,67,7,60,4,3
13,479,479,64,25,39,2,1
6,483,483,141,135,6,3,2
21,490,490,93,1,92,3,2

6,102,102,14,14,0,1,0
33,112,112,6,6,0,1,0
18,113,113,9,9,0,1,0
2,124,124,1,1,0,1,0
35,127,127,13,13,0,1,0
5,133,133,12,3,9,4,3
21,148,148,1,1,0,1,0
20,176,176,9,1,8,2,1
22,190,190,13,1,12,3,2
23,196,196,7,7,0,1,0
0,232,232,25,25,0,1,0
32,255,255,35,10,25,2,1
14,256,256,24,18,6,2,1
10,257,257,57,57,0,1,0
38,262,262,11,11,0,1,0
19,262,262,14,14,0,1,0
25,266,266,22,12,10,3,2
11,274,274,1,1,0,1,0
28,280,280,2,2,0,1,0
29,282,282,10,10,0,1,0
17,324,324,23,23,0,1,0
27,325,325,32,4,28,2,1
24,345,345,44,41,3,2,1
3,346,346,1,1,0,1,0
36,348,348,30,17,13,2,1
7,369,369,7,7,0,1,0
37,373,373,83,22,61,4,3
13,375,375,4,4,0,1,0
4,398,398,16,16,0,1,0
9,404,404,30,30,0,1,0
8,410,410,86,56,30,2,1
26,417,417,100,88,12,4,3
12,423,423,29,29,0,1,0
34,440,440,112,17,95,4,3
1,453,453,12,8,4,2,1
15,464,464,90,50,40,2,1
31,466,466,3,3,0,1,0
16,467,467,63,37,26,2,1
30,478,478,66,26,40,2,1

6,152,152,3,3,0,1,0
3,177,177,2,2,0,1,0
13,188,188,7,2,5,2,1
29,188,188,7,7,0,1,0
17,197,197,13,5,8,2,1
15,201,201,6,6,0,1,0
14,206,206,42,42,0,1,0
33,206,206,66,9,57,4,3
12,220,220,16,16,0,1,0
32,220,220,3,3,0,1,0
4,228,228,28,28,0,1,0
18,232,232,3,3,0,1,0
26,244,244,58,58,0,1,0
2,250,250,14,2,12,2,1
9,250,250,9,1,8,2,1
1,280,280,1,1,0,1,0
19,316,316,12,12,0,1,0
8,323,323,16,16,0,1,0
21,323,323,21,12,9,4,3
16,328,328,15,15,0,1,0
5,339,339,153,61,92,3,2
7,341,341,9,2,7,2,1
34,350,350,64,22,42,2,1
28,351,351,39,33,6,2,1
25,364,364,7,7,0,1,0
11,371,371,5,5,0,1,0
24,383,383,22,22,0,1,0
30,395,395,33,10,23,4,3
0,398,398,94,94,0,1,0
20,416,416,13,5,8,2,1
27,422,422,25,11,14,2,1
31,424,424,35,35,0,1,0
23,437,437,144,144,0,1,0
22,447,447,19,9,10,3,2
10,467,467,104,63,41,2,1

26,107,107,2,2,0,1,0
35,110,110,11,7,4,2,1
13,138,138,5,5,0,1,0
34,144,144,10,2,8,2,1
17,159,159,15,15,0,1,0
18,192,192,35,4,31,2,1
5,195,195,32,18,14,3,2
31,202,202,64,38,26,3,2
7,215,215,5,5,0,1,0
2,216,216,5,2,3,2,1
27,217,217,5,5,0,1,0
11,222,222,40,40,0,1,0
32,225,225,7,1,6,3,2
16,229,229,3,3,0,1,0
21,237,237,9,9,0,1,0
15,239,239,15,15,0,1,0
20,242,242,9,9,0,1,0
1,253,253,38,38,0,1,0
12,275,275,15,5,10,3,2
22,276,276,8,2,6,2,1
10,280,280,36,36,0,1,0
0,281,281,7,2,5,2,1
3,316,316,30,1,29,2,1
6,326,326,22,9,13,4,3
29,336,336,50,35,15,3,2
23,351,351,61,13,48,2,1
14,363,363,6,6,0,1,0
36,364,364,2,2,0,1,0
33,364,364,36,14,22,3,2
9,366,366,31,21,10,2,1
28,381,381,94,49,45,3,2
30,397,397,37,1,36,3,2
37,402,402,10,2,8,3,2
4,405,405,31,31,0,1,0
39,409,409,18,18,0,1,0
24,457,457,4,1,3,2,1
8,464,464,19,19,0,1,0
38,480,480,139,139,0,1,0
25,488,488,20,5,15,4,3
19,488,488,39,7,32,3,2

30,105,105,10,10,0,1,0
18,108,108,1,1,0,1,0
23,128,128,12,12,0,1,0
22,132,132,23,23,0,1,0
5,140,140,5,5,0,1,0
25,199,199,26,26,0,1,0
13,206,206,36,36,0,1,0
6,219,219,27,14,13,2,1
31,226,226,23,23,0,1,0
7,238,238,1,1,0,1,0
29,239,239,17,17,0,1,0
12,261,261,41,26,15,2,1
17,276,276,51,26,25,4,3
2,292,292,54,8,46,3,2
0,310,310,28,10,18,4,3
4,320,320,1,1,0,1,0
21,323,323,78,44,34,2,1
8,341,341,9,9,0,1,0
9,342,342,19,2,17,2,1
15,344,344,50,50,0,1,0
1,355,355,25,25,0,1,0
26,365,365,38,22,16,2,1
24,378,378,2,2,0,1,0
32,380,380,45,25,20,2,1
11,382,382,19,11,8,3,2
33,383,383,9,9,0,1,0
19,391,391,19,19,0,1,0
14,410,410,104,104,0,1,0
3,451,451,12,2,10,3,2
16,452,452,28,14,14,2,1
10,461,461,23,17,6,3,2
27,471,471,4,4,0,1,0
34,475,475,48,12,36,2,1
28,483,483,121,61,60,3,2
20,483,483,43,43,0,1,0
35,495,495,35,30,5,2,1

30,101,101,30,30,0,1,0
32,195,195,4,4,0,1,0
3,203,203,4,4,0,1,0
23,210,210,23,23,0,1,0
28,228,228,18,18,0,1,0
7,237,237,8,4,4,2,1
35,243,243,12,1,11,2,1
10,284,284,1,1,0,1,0
20,286,286,3,3,0,1,0
29,289,289,2,2,0,1,0
26,291,291,15,15,0,1,0
12,293,293,35,35,0,1,0
36,298,298,7,7,0,1,0
6,302,302,12,12,0,1,0
14,303,303,17,17,0,1,0
9,306,306,9,1,8,2,1
27,311,311,28,18,10,3,2
5,311,311,12,12,0,1,0
4,312,312,4,4,0,1,0
21,338,338,5,5,0,1,0
31,353,353,13,3,10,2,1
17,353,353,12,4,8,3,2
16,361,361,72,6,66,3,2
11,363,363,12,12,0,1,0
24,370,370,177,144,33,4,3
19,372,372,16,16,0,1,0
22,407,407,140,76,64,3,2
13,410,410,89,89,0,1,0
33,422,422,39,2,37,3,2
15,429,429,4,4,0,1,0
0,433,433,161,78,83,4,3
18,458,458,15,15,0,1,0
34,460,460,3,3,0,1,0
2,467,467,79,20,59,4,3
8,478,478,21,3,18,4,3
1,480,480,94,94,0,1,0
25,490,490,11,11,0,1,0

3,123,123,11,11,0,1,0
30,138,138,21,11,10,3,2
22,147,147,1,1,0,1,0
4,160,160,2,2,0,1,0
9,165,165,41,30,11,2,1
0,174,174,8,8,0,1,0
27,176,176,17,5,12,4,3
33,180,180,5,2,3,2,1
23,186,186,49,21,28,2,1
25,197,197,38,32,6,3,2
11,214,214,41,41,0,1,0
14,216,216,8,5,3,2,1
17,224,224,47,47,0,1,0
28,229,229,8,1,7,2,1
29,250,250,4,4,0,1,0
18,251,251,28,28,0,1,0
24,253,253,2,2,0,1,0
8,294,294,102,90,12,3,2
7,298,298,3,3,0,1,0
21,313,313,36,7,29,2,1
10,325,325,24,12,12,3,2
2,332,332,7,2,5,2,1
5,362,362,7,7,0,1,0
19,390,390,37,37,0,1,0
31,392,392,40,40,0,1,0
6,393,393,99,99,0,1,0
26,436,436,7,7,0,1,0
1,457,457,39,24,15,2,1
20,465,465,44,44,0,1,0
32,466,466,93,22,71,4,3
16,471,471,59,59,0,1,0
13,472,472,62,62,0,1,0
12,481,481,4,4,0,1,0
15,490,490,1,1,0,1,0

16,100,100,9,9,0,1,0
0,104,104,3,3,0,1,0
27,126,126,1,1,0,1,0
8,132,132,6,6,0,1,0
23,160,160,18,18,0,1,0
25,161,161,3,3,0,1,0
12,182,182,23,4,19,3,2
10,224,224,9,9,0,1,0
7,232,232,1,1,0,1,0
31,235,235,44,1,43,2,1
29,235,235,12,12,0,1,0
21,248,248,67,67,0,1,0
30,251,251,5,5,0,1,0
1,271,271,37,22,15,4,3
9,305,305,11,11,0,1,0
20,307,307,2,2,0,1,0
4,319,319,3,3,0,1,0
32,326,326,3,3,0,1,0
18,333,333,5,5,0,1,0
5,349,349,55,1,54,4,3
24,352,352,3,3,0,1,0
17,358,358,29,19,10,2,1
2,397,397,16,16,0,1,0
28,407,407,129,93,36,3,2
22,418,418,170,146,24,3,2
6,434,434,94,12,82,3,2
14,442,442,44,28,16,2,1
15,460,460,4,4,0,1,0
11,463,463,265,265,0,1,0
13,468,468,14,7,7,2,1
19,478,478,10,10,0,1,0
3,500,500,74,74,0,1,0
26,500,500,56,56,0,1,0

8,112,112,4,4,0,1,0
4,115,115,2,2,0,1,0
23,134,134,1,1,0,1,0
9,147,147,4,4,0,1,0
19,199,199,2,2,0,1,0
15,209,209,5,5,0,1,0
36,217,217,25,13,12,2,1
6,219,219,61,43,18,3,2
17,227,227,24,24,0,1,0
35,232,232,13,13,0,1,0
12,245,245,13,13,0,1,0
3,245,245,36,22,14,2,1
37,251,251,61,61,0,1,0
29,260,260,38,16,22,2,1
28,266,266,12,12,0,1,0
25,279,279,44,44,0,1,0
33,280,280,11,11,0,1,0
27,318,318,4,4,0,1,0
20,319,319,23,23,0,1,0
2,338,338,90,90,0,1,0
31,339,339,20,20,0,1,0
11,340,340,38,38,0,1,0
34,355,355,2,2,0,1,0
14,381,381,11,1,10,3,2
13,381,381,5,5,0,1,0
24,386,386,32,32,0,1,0
7,397,397,21,5,16,3,2
5,397,397,73,32,41,2,1
1,401,401,3,3,0,1,0
10,412,412,60,41,19,2,1
18,414,414,14,14,0,1,0
0,429,429,30,30,0,1,0
16,435,435,8,8,0,1,0
32,449,449,49,13,36,4,3
22,479,479,72,72,0,1,0
21,487,487,163,136,27,4,3
30,495,495,5,5,0,1,0
26,495,495,79,43,36,3,2

14,104,104,16,16,0,1,0
28,138,138,1,1,0,1,0
4,152,152,19,19,0,1,0
11,172,172,2,2,0,1,0
30,181,181,37,25,12,2,1
10,182,182,58,34,24,4,3
26,209,209,66,36,30,2,1
31,223,223,4,4,0,1,0
7,224,224,1,1,0,1,0
2,233,233,4,4,0,1,0
8,255,255,28,28,0,1,0
13,269,269,25,25,0,1,0
6,273,273,22,22,0,1,0
20,284,284,19,13,6,2,1
29,296,296,21,1,20,3,2
32,305,305,4,1,3,2,1
18,310,310,7,2,5,2,1
16,322,322,69,21,48,3,2
23,326,326,79,79,0,1,0
9,329,329,38,38,0,1,0
27,337,337,19,5,14,2,1
1,343,343,83,83,0,1,0
24,347,347,25,25,0,1,0
22,378,378,76,76,0,1,0
15,400,400,8,8,0,1,0
21,404,404,32,5,27,4,3
12,413,413,47,1,46,3,2
19,438,438,57,22,35,2,1
0,446,446,118,10,108,4,3
17,449,449,4,1,3,2,1
3,461,461,13,9,4,2,1
5,463,463,2,2,0,1,0
25,481,481,4,4,0,1,0

28,122,122,8,1,7,2,1
30,130,130,5,5,0,1,0
20,137,137,18,2,16,2,1
11,140,140,3,3,0,1,0
6,142,142,1,1,0,1,0
33,149,149,12,3,9,2,1
3,163,163,1,1,0,1,0
9,171,171,12,4,8,2,1
15,183,183,6,6,0,1,0
8,186,186,47,1,46,2,1
1,200,200,1,1,0,1,0
21,211,211,29,19,10,2,1
29,220,220,33,7,26,2,1
4,240,240,1,1,0,1,0
0,251,251,72,43,29,2,1
18,267,267,30,30,0,1,0
22,276,276,47,47,0,1,0
17,280,280,1,1,0,1,0
5,283,283,63,15,48,3,2
24,310,310,21,17,4,2,1
26,321,321,18,18,0,1,0
32,327,327,15,15,0,1,0
35,339,339,24,24,0,1,0
27,352,352,31,31,0,1,0
7,386,386,1,1,0,1,0
12,407,407,134,99,35,2,1
10,415,415,7,1,6,2,1
23,420,420,17,5,12,3,2
16,445,445,30,4,26,3,2
34,461,461,2,2,0,1,0
14,467,467,13,10,3,2,1
19,473,473,88,88,0,1,0
31,477,477,67,10,57,4,3
2,485,485,105,105,0,1,0
13,486,486,8,8,0,1,0
25,498,498,136,136,0,1,0

12,105,105,11,5,6,3,2
6,126,126,11,2,9,3,2
10,130,130,7,4,3,2,1
2,142,142,29,29,0,1,0
3,144,144,14,14,0,1,0
8,154,154,1,1,0,1,0
18,189,189,19,19,0,1,0
4,195,195,30,30,0,1,0
26,203,203,25,25,0,1,0
1,218,218,85,58,27,4,3
23,242,242,21,21,0,1,0
13,249,249,49,49,0,1,0
19,253,253,5,5,0,1,0
11,276,276,25,25,0,1,0
25,302,302,6,6,0,1,0
29,304,304,100,90,10,2,1
30,313,313,19,19,0,1,0
14,318,318,10,1,9,2,1
21,319,319,47,36,11,2,1
16,400,400,10,1,9,2,1
22,403,403,19,19,0,1,0
20,408,408,44,44,0,1,0
9,416,416,71,56,15,4,3
27,420,420,32,9,23,4,3
17,426,426,13,8,5,2,1
24,441,441,8,8,0,1,0
15,473,473,53,53,0,1,0
31,473,473,196,196,0,1,0
7,477,477,3,3,0,1,0
0,487,487,50,50,0,1,0
28,499,499,7,4,3,2,1
5,500,500,2,2,0,1,0

26,120,120,3,3,0,1,0
15,142,142,14,7,7,2,1
13,149,149,6,6,0,1,0
1,152,152,5,5,0,1,0
4,157,157,9,1,8,3,2
12,169,169,2,2,0,1,0
3,176,176,7,1,6,3,2
22,181,181,12,12,0,1,0
2,189,189,12,12,0,1,0
28,190,190,11,11,0,1,0
20,198,198,10,10,0,1,0
8,204,204,1,1,0,1,0
7,256,256,87,87,0,1,0
33,259,259,29,29,0,1,0
10,298,298,9,9,0,1,0
0,304,304,1,1,0,1,0
19,305,305,65,65,0,1,0
35,306,306,7,4,3,2,1
14,330,330,19,10,9,2,1
18,334,334,49,5,44,2,1
23,336,336,123,123,0,1,0
9,341,341,39,39,0,1,0
27,353,353,4,4,0,1,0
6,356,356,9,9,0,1,0
29,363,363,80,23,57,4,3
25,363,363,34,34,0,1,0
32,366,366,73,65,8,3,2
31,377,377,7,7,0,1,0
37,416,416,27,27,0,1,0
36,424,424,46,35,11,2,1
30,426,426,11,4,7,2,1
21,426,426,33,28,5,2,1
16,447,447,94,94,0,1,0
17,455,455,35,35,0,1,0
24,461,461,106,20,86,3,2
11,462,462,20,20,0,1,0
34,476,476,14,11,3,2,1
5,495,495,20,20,0,1,0

9,102,102,1,1,0,1,0
12,106,106,5,5,0,1,0
2,120,120,27,12,15,2,1
32,128,128,17,17,0,1,0
27,134,134,6,3,3,2,1
4,151,151,13,13,0,1,0
11,153,153,13,6,7,2,1
36,167,167,25,12,13,2,1
8,183,183,6,6,0,1,0
10,183,183,2,2,0,1,0
26,210,210,7,7,0,1,0
16,233,233,7,7,0,1,0
5,234,234,1,1,0,1,0
24,245,245,5,5,0,1,0
7,253,253,28,28,0,1,0
25,300,300,93,72,21,4,3
21,327,327,15,9,6,2,1
1,329,329,34,21,13,2,1
6,334,334,2,2,0,1,0
23,352,352,11,2,9,2,1
22,364,364,12,6,6,2,1
14,369,369,46,46,0,1,0
31,370,370,52,40,12,3,2
13,387,387,33,6,27,4,3
0,389,389,69,49,20,2,1
38,390,390,34,4,30,2,1
29,391,391,57,7,50,3,2
33,393,393,23,1,22,3,2
3,403,403,15,6,9,2,1
30,403,403,75,33,42,3,2
15,405,405,1,1,0,1,0
37,422,422,4,4,0,1,0
34,424,424,61,61,0,1,0
19,437,437,42,42,0,1,0
17,445,445,1,1,0,1,0
28,448,448,60,60,0,1,0
35,474,474,32,3,29,2,1
20,481,481,55,31,24,2,1
18,490,490,130,130,0,1,0

17,103,103,22,22,0,1,0
4,109,109,1,1,0,1,0
9,116,116,17,3,14,2,1
3,135,135,9,9,0,1,0
0,138,138,26,26,0,1,0
8,159,159,27,1,26,3,2
20,170,170,3,3,0,1,0
6,192,192,18,12,6,2,1
7,204,204,55,9,46,4,3
26,211,211,92,83,9,4,3
15,221,221,5,2,3,2,1
18,232,232,14,8,6,2,1
23,233,233,16,5,11,2,1
13,242,242,17,17,0,1,0
16,274,274,25,25,0,1,0
31,303,303,7,7,0,1,0
19,314,314,23,5,18,4,3
11,316,316,13,13,0,1,0
30,332,332,11,11,0,1,0
12,339,339,45,36,9,4,3
22,354,354,12,9,3,2,1
1,358,358,1,1,0,1,0
27,360,360,65,42,23,3,2
2,385,385,29,29,0,1,0
5,406,406,153,153,0,1,0
24,423,423,15,3,12,4,3
21,433,433,65,53,12,2,1
10,436,436,20,20,0,1,0
25,444,444,31,26,5,2,1
14,467,467,6,3,3,2,1
28,470,470,6,3,3,2,1
29,476,476,100,74,26,3,2

0,113,113,3,3,0,1,0
22,121,121,15,15,0,1,0
15,128,128,23,23,0,1,0
13,156,156,12,12,0,1,0
26,163,163,20,20,0,1,0
5,181,181,32,21,11,2,1
23,191,191,25,25,0,1,0
2,193,193,9,9,0,1,0
14,193,193,18,18,0,1,0
6,204,204,21,5,16,3,2
18,211,211,48,48,0,1,0
20,214,214,32,12,20,2,1
25,242,242,13,4,9,2,1
3,248,248,47,42,5,2,1
12,291,291,21,4,17,2,1
16,313,313,27,27,0,1,0
27,331,331,69,24,45,2,1
29,337,337,11,11,0,1,0
24,348,348,11,11,0,1,0
11,351,351,4,4,0,1,0
8,352,352,47,47,0,1,0
21,432,432,18,18,0,1,0
28,432,432,9,9,0,1,0
4,438,438,13,13,0,1,0
1,446,446,301,301,0,1,0
7,455,455,74,74,0,1,0
10,473,473,31,7,24,4,3
17,481,481,7,7,0,1,0
19,498,498,69,25,44,2,1
9,500,500,4,4,0,1,0

34,106,106,1,1,0,1,0
2,106,106,6,6,0,1,0
9,136,136,18,18,0,1,0
43,140,140,30,30,0,1,0
15,142,142,12,3,9,4,3
38,166,166,26,7,19,2,1
10,170,170,16,16,0,1,0
6,181,181,2,2,0,1,0
40,187,187,7,4,3,2,1
29,208,208,2,2,0,1,0
23,218,218,1,1,0,1,0
14,224,224,23,23,0,1,0
39,235,235,22,5,17,2,1
0,236,236,22,22,0,1,0
17,240,240,82,34,48,4,3
33,241,241,2,2,0,1,0
13,246,246,6,1,5,2,1
4,263,263,1,1,0,1,0
8,264,264,15,15,0,1,0
31,265,265,13,4,9,4,3
26,268,268,25,25,0,1,0
37,276,276,5,2,3,2,1
11,284,284,12,9,3,2,1
42,291,291,49,40,9,2,1
20,292,292,2,2,0,1,0
25,293,293,12,3,9,2,1
18,312,312,10,10,0,1,0
22,315,315,41,10,31,2,1
16,325,325,13,8,5,2,1
24,332,332,2,2,0,1,0
30,337,337,24,24,0,1,0
44,339,339,14,2,12,4,3
35,347,347,79,7,72,3,2
12,360,360,6,6,0,1,0
28,360,360,3,3,0,1,0
19,362,362,1,1,0,1,0
21,390,390,22,14,8,3,2
5,396,396,15,15,0,1,0
36,408,408,34,22,12,2,1
27,409,409,11,3,8,2,1
3,414,414,5,5,0,1,0
41,421,421,177,165,12,2,1
1,423,423,40,27,13,2,1
7,427,427,24,24,0,1,0
32,449,449,51,51,0,1,0

31,100,100,7,7,0,1,0
34,101,101,10,6,4,2,1
29,110,110,11,11,0,1,0
7,125,125,1,1,0,1,0
24,125,125,1,1,0,1,0
18,131,131,2,2,0,1,0
9,159,159,1,1,0,1,0
5,187,187,18,4,14,3,2
1,188,188,13,13,0,1,0
33,206,206,31,18,13,2,1
25,263,263,27,27,0,1,0
11,269,269,26,26,0,1,0
23,283,283,6,6,0,1,0
3,294,294,96,96,0,1,0
17,294,294,1,1,0,1,0
0,308,308,35,2,33,4,3
16,319,319,25,25,0,1,0
26,338,338,13,5,8,2,1
10,342,342,1,1,0,1,0
22,345,345,2,2,0,1,0
28,354,354,7,4,3,2,1
27,365,365,88,64,24,2,1
8,365,365,38,32,6,3,2
13,378,378,5,5,0,1,0
21,379,379,13,5,8,3,2
6,380,380,14,14,0,1,0
12,381,381,47,47,0,1,0
14,395,395,14,4,10,3,2
15,396,396,67,19,48,3,2
32,396,396,8,8,0,1,0
4,398,398,60,60,0,1,0
2,404,404,108,90,18,2,1
30,411,411,144,87,57,4,3
20,436,436,176,128,48,2,1
19,465,465,34,3,31,4,3

32,102,102,1,1,0,1,0
27,116,116,2,2,0,1,0
12,126,126,2,2,0,1,0
30,141,141,24,24,0,1,0
22,146,146,5,5,0,1,0
18,152,152,33,3,30,4,3
6,154,154,14,10,4,2,1
2,158,158,52,52,0,1,0
15,159,159,56,41,15,4,3
3,162,162,10,2,8,2,1
33,171,171,36,2,34,2,1
7,210,210,58,44,14,2,1
5,211,211,1,1,0,1,0
20,244,244,9,9,0,1,0
26,249,249,9,1,8,3,2
8,278,278,9,1,8,3,2
29,324,324,95,95,0,1,0
1,330,330,5,5,0,1,0
10,357,357,41,41,0,1,0
11,360,360,1,1,0,1,0
25,368,368,8,8,0,1,0
16,374,374,26,26,0,1,0
23,374,374,4,4,0,1,0
13,377,377,22,10,12,4,3
4,379,379,28,28,0,1,0
14,385,385,39,39,0,1,0
17,404,404,2,2,0,1,0
31,414,414,149,20,129,4,3
24,428,428,29,29,0,1,0
9,434,434,42,30,12,3,2
0,435,435,2,2,0,1,0
28,435,435,35,35,0,1,0
21,474,474,68,68,0,1,0
19,488,488,6,2,4,2,1

19,111,111,6,6,0,1,0
1,111,111,5,1,4,2,1
20,113,113,18,4,14,3,2
14,154,154,7,7,0,1,0
16,155,155,20,20,0,1,0
24,156,156,12,12,0,1,0
21,171,171,10,1,9,4,3
27,182,182,28,28,0,1,0
4,197,197,24,24,0,1,0
17,199,199,1,1,0,1,0
23,200,200,26,16,10,2,1
9,212,212,71,43,28,3,2
8,234,234,23,23,0,1,0
15,235,235,6,6,0,1,0
6,253,253,2,2,0,1,0
22,258,258,31,15,16,3,2
3,307,307,57,7,50,2,1
12,355,355,7,2,5,2,1
25,365,365,70,24,46,3,2
5,371,371,8,8,0,1,0
13,401,401,84,72,12,2,1
2,411,411,50,50,0,1,0
7,423,423,41,14,27,4,3
10,433,433,17,17,0,1,0
0,438,438,275,251,24,4,3
26,449,449,76,76,0,1,0
18,461,461,10,10,0,1,0
11,479,479,83,67,16,2,1

28,115,115,2,2,0,1,0
23,122,122,7,7,0,1,0
26,123,123,13,13,0,1,0
2,127,127,16,8,8,3,2
34,131,131,23,23,0,1,0
9,140,140,1,1,0,1,0
7,143,143,1,1,0,1,0
8,146,146,16,4,12,3,2
13,147,147,8,3,5,2,1
14,152,152,17,17,0,1,0
19,169,169,7,7,0,1,0
30,193,193,4,4,0,1,0
4,198,198,10,10,0,1,0
27,203,203,12,12,0,1,0
22,239,239,39,39,0,1,0
29,250,250,68,30,38,3,2
21,255,255,3,3,0,1,0
18,278,278,20,20,0,1,0
38,281,281,6,6,0,1,0
6,293,293,1,1,0,1,0
15,298,298,4,4,0,1,0
42,298,298,9,9,0,1,0
31,306,306,75,52,23,2,1
24,316,316,22,22,0,1,0
32,331,331,31,31,0,1,0
25,335,335,2,2,0,1,0
10,346,346,29,29,0,1,0
35,364,364,8,8,0,1,0
39,366,366,48,48,0,1,0
17,371,371,22,2,20,2,1
12,375,375,105,93,12,4,3
40,391,391,64,64,0,1,0
16,410,410,39,39,0,1,0
20,412,412,5,5,0,1,0
11,422,422,27,13,14,3,2
33,429,429,5,2,3,2,1
41,430,430,77,45,32,2,1
1,446,446,26,13,13,2,1
5,452,452,8,8,0,1,0
0,470,470,57,21,36,4,3
36,473,473,24,24,0,1,0
37,474,474,63,39,24,3,2
3,491,491,2,2,0,1,0

24,120,120,4,4,0,1,0
19,124,124,18,18,0,1,0
25,137,137,25,14,11,2,1
7,153,153,24,24,0,1,0
0,154,154,3,3,0,1,0
4,163,163,30,30,0,1,0
3,177,177,19,9,10,2,1
13,192,192,5,2,3,2,1
17,202,202,9,9,0,1,0
27,213,213,2,2,0,1,0
29,247,247,51,51,0,1,0
15,264,264,1,1,0,1,0
26,270,270,33,33,0,1,0
20,271,271,25,25,0,1,0
1,278,278,2,2,0,1,0
23,287,287,60,60,0,1,0
18,311,311,34,34,0,1,0
16,314,314,24,24,0,1,0
10,336,336,45,45,0,1,0
14,381,381,108,46,62,4,3
6,397,397,7,7,0,1,0
8,403,403,132,132,0,1,0
11,415,415,24,24,0,1,0
5,420,420,130,91,39,4,3
9,429,429,34,20,14,2,1
22,455,455,3,3,0,1,0
21,459,459,48,48,0,1,0
12,477,477,80,10,70,3,2
2,481,481,64,64,0,1,0
28,489,489,33,33,0,1,0

8,129,129,22,18,4,2,1
12,131,131,1,1,0,1,0
23,138,138,15,15,0,1,0
4,154,154,16,16,0,1,0
15,198,198,16,16,0,1,0
22,206,206,11,8,3,2,1
16,208,208,28,12,16,3,2
19,216,216,27,27,0,1,0
17,225,225,33,33,0,1,0
26,268,268,1,1,0,1,0
21,268,268,8,8,0,1,0
2,270,270,31,31,0,1,0
18,277,277,47,47,0,1,0
1,339,339,122,26,96,3,2
14,347,347,11,6,5,2,1
11,356,356,41,17,24,2,1
24,375,375,44,44,0,1,0
9,379,379,26,14,12,4,3
3,383,383,102,21,81,3,2
0,389,389,3,3,0,1,0
13,392,392,14,14,0,1,0
7,418,418,67,49,18,4,3
20,439,439,11,11,0,1,0
6,448,448,184,147,37,4,3
5,461,461,18,18,0,1,0
10,470,470,84,2,82,3,2
25,478,478,179,74,105,4,3

22,110,110,9,9,0,1,0
1,125,125,5,5,0,1,0
6,144,144,2,2,0,1,0
21,169,169,45,33,12,4,3
27,174,174,71,71,0,1,0
18,193,193,23,18,5,2,1
11,197,197,4,1,3,2,1
33,217,217,12,12,0,1,0
36,218,218,2,2,0,1,0
3,227,227,30,30,0,1,0
25,241,241,19,6,13,2,1
34,256,256,6,6,0,1,0
35,281,281,40,22,18,4,3
16,284,284,6,6,0,1,0
20,290,290,48,48,0,1,0
10,293,293,5,5,0,1,0
14,305,305,12,9,3,2,1
2,306,306,4,4,0,1,0
38,326,326,20,5,15,2,1
30,334,334,77,77,0,1,0
0,339,339,105,9,96,4,3
24,344,344,22,22,0,1,0
9,350,350,23,11,12,3,2
8,352,352,35,14,21,2,1
4,368,368,19,5,14,2,1
5,377,377,2,2,0,1,0
29,383,383,60,44,16,2,1
37,384,384,17,12,5,2,1
32,388,388,53,40,13,2,1
12,392,392,25,25,0,1,0
19,394,394,1,1,0,1,0
7,397,397,14,5,9,2,1
26,411,411,2,2,0,1,0
28,432,432,74,74,0,1,0
23,432,432,7,7,0,1,0
17,463,463,2,2,0,1,0
13,486,486,2,2,0,1,0
31,489,489,19,19,0,1,0
15,499,499,106,40,66,3,2

6,106,106,9,9,0,1,0
8,135,135,5,5,0,1,0
18,173,173,5,5,0,1,0
22,214,214,4,4,0,1,0
23,223,223,58,34,24,3,2
19,231,231,24,24,0,1,0
3,258,258,46,28,18,3,2
10,272,272,30,24,6,2,1
0,281,281,55,39,16,2,1
26,285,285,77,77,0,1,0
12,286,286,23,20,3,2,1
4,314,314,63,17,46,4,3
14,321,321,10,10,0,1,0
13,335,335,19,15,4,2,1
21,340,340,18,18,0,1,0
1,345,345,176,42,134,4,3
5,369,369,43,43,0,1,0
16,384,384,1,1,0,1,0
25,384,384,10,10,0,1,0
9,391,391,6,6,0,1,0
27,397,397,26,26,0,1,0
15,411,411,22,22,0,1,0
20,421,421,86,58,28,4,3
7,424,424,95,95,0,1,0
11,461,461,68,8,60,4,3
24,471,471,146,80,66,4,3
17,478,478,9,9,0,1,0
2,495,495,15,15,0,1,0

33,110,110,3,3,0,1,0
2,114,114,14,14,0,1,0
32,134,134,37,9,28,3,2
12,159,159,49,39,10,3,2
34,160,160,5,5,0,1,0
25,178,178,28,2,26,4,3
28,184,184,24,24,0,1,0
39,191,191,63,41,22,2,1
10,194,194,3,3,0,1,0
8,198,198,9,9,0,1,0
30,208,208,9,9,0,1,0
36,219,219,13,13,0,1,0
3,230,230,9,3,6,2,1
6,232,232,7,1,6,2,1
16,237,237,12,12,0,1,0
14,240,240,13,3,10,3,2
31,240,240,4,4,0,1,0
9,245,245,11,11,0,1,0
19,266,266,23,10,13,2,1
20,271,271,10,10,0,1,0
18,298,298,6,6,0,1,0
5,332,332,1,1,0,1,0
22,337,337,14,6,8,2,1
11,340,340,63,50,13,3,2
0,370,370,80,24,56,3,2
15,377,377,26,26,0,1,0
40,383,383,15,15,0,1,0
35,392,392,48,43,5,2,1
23,401,401,26,2,24,4,3
27,408,408,64,64,0,1,0
1,408,408,72,37,35,3,2
21,421,421,8,8,0,1,0
13,434,434,4,1,3,2,1
37,440,440,65,65,0,1,0
4,445,445,3,3,0,1,0
24,447,447,12,8,4,2,1
17,448,448,24,24,0,1,0
29,455,455,47,27,20,2,1
7,473,473,1,1,0,1,0
26,492,492,2,2,0,1,0
38,492,492,30,30,0,1,0

15,102,102,12,8,4,2,1
0,104,104,12,12,0,1,0
10,108,108,10,10,0,1,0
1,117,117,24,24,0,1,0
16,124,124,4,1,3,2,1
18,134,134,8,8,0,1,0
13,138,138,19,19,0,1,0
21,140,140,7,7,0,1,0
23,187,187,29,29,0,1,0
4,188,188,15,15,0,1,0
9,192,192,1,1,0,1,0
20,193,193,19,15,4,2,1
5,197,197,38,38,0,1,0
3,199,199,1,1,0,1,0
11,207,207,35,30,5,2,1
22,237,237,61,47,14,2,1
7,282,282,2,2,0,1,0
14,297,297,27,27,0,1,0
12,327,327,94,4,90,3,2
2,336,336,41,5,36,2,1
24,341,341,27,27,0,1,0
27,356,356,43,43,0,1,0
19,383,383,76,76,0,1,0
17,387,387,65,50,15,2,1
31,403,403,28,6,22,2,1
8,404,404,1,1,0,1,0
25,414,414,33,12,21,2,1
28,416,416,1,1,0,1,0
26,421,421,13,13,0,1,0
30,422,422,28,28,0,1,0
6,479,479,91,91,0,1,0
29,484,484,75,43,32,2,1

19,104,104,1,1,0,1,0
25,131,131,9,9,0,1,0
18,139,139,13,4,9,4,3
9,140,140,1,1,0,1,0
0,148,148,12,12,0,1,0
21,186,186,39,27,12,2,1
16,217,217,44,2,42,4,3
23,219,219,37,37,0,1,0
5,238,238,2,2,0,1,0
6,240,240,1,1,0,1,0
17,250,250,2,2,0,1,0
20,261,261,50,50,0,1,0
8,270,270,54,50,4,2,1
10,294,294,152,8,144,4,3
28,313,313,46,46,0,1,0
13,334,334,17,17,0,1,0
22,336,336,2,2,0,1,0
3,348,348,32,11,21,3,2
24,351,351,34,34,0,1,0
11,354,354,88,57,31,4,3
14,357,357,9,9,0,1,0
27,359,359,42,37,5,2,1
4,362,362,57,57,0,1,0
15,398,398,59,25,34,2,1
26,413,413,56,56,0,1,0
2,418,418,74,71,3,2,1
12,431,431,20,10,10,3,2
1,454,454,1,1,0,1,0
7,496,496,102,102,0,1,0

27,100,100,3,3,0,1,0
11,138,138,1,1,0,1,0
9,142,142,8,8,0,1,0
16,167,167,9,4,5,2,1
20,180,180,49,24,25,2,1
13,182,182,2,2,0,1,0
35,207,207,22,22,0,1,0
5,209,209,11,11,0,1,0
39,215,215,58,52,6,2,1
33,224,224,46,46,0,1,0
23,244,244,23,3,20,2,1
15,249,249,7,7,0,1,0
7,261,261,9,9,0,1,0
37,262,262,3,3,0,1,0
2,264,264,24,4,20,2,1
22,267,267,18,4,14,3,2
17,270,270,4,4,0,1,0
25,284,284,3,3,0,1,0
21,292,292,10,10,0,1,0
12,293,293,41,20,21,2,1
10,314,314,71,71,0,1,0
42,317,317,11,11,0,1,0
0,317,317,42,42,0,1,0
18,320,320,13,13,0,1,0
3,359,359,13,3,10,2,1
36,361,361,66,20,46,2,1
19,363,363,11,11,0,1,0
30,375,375,22,22,0,1,0
28,381,381,42,8,34,2,1
1,387,387,14,3,11,2,1
26,409,409,23,15,8,2,1
24,416,416,2,2,0,1,0
41,418,418,94,52,42,2,1
14,423,423,24,4,20,3,2
38,432,432,55,43,12,3,2
6,444,444,39,39,0,1,0
4,446,446,34,3,31,4,3
8,446,446,3,3,0,1,0
29,449,449,48,13,35,4,3
40,453,453,11,6,5,2,1
31,463,463,28,6,22,4,3
32,491,491,33,33,0,1,0
34,495,495,25,15,10,2,1

31,108,108,26,26,0,1,0
5,124,124,7,2,5,2,1
2,127,127,4,4,0,1,0
14,142,142,3,3,0,1,0
38,167,167,46,22,24,4,3
19,167,167,10,10,0,1,0
7,179,179,2,2,0,1,0
27,205,205,35,28,7,2,1
32,217,217,2,2,0,1,0
34,231,231,1,1,0,1,0
0,268,268,13,6,7,2,1
12,271,271,15,3,12,3,2
30,291,291,68,43,25,2,1
36,301,301,9,9,0,1,0
29,302,302,23,2,21,4,3
26,302,302,14,4,10,2,1
21,306,306,2,2,0,1,0
40,310,310,5,5,0,1,0
37,320,320,3,3,0,1,0
8,350,350,5,5,0,1,0
23,350,350,22,22,0,1,0
10,359,359,2,2,0,1,0
9,373,373,110,32,78,4,3
6,376,376,16,4,12,2,1
1,379,379,4,4,0,1,0
35,401,401,25,25,0,1,0
20,425,425,38,22,16,2,1
16,436,436,45,45,0,1,0
4,438,438,26,10,16,3,2
28,443,443,13,13,0,1,0
24,444,444,17,17,0,1,0
25,451,451,100,48,52,4,3
33,460,460,56,50,6,2,1
18,461,461,48,23,25,2,1
13,462,462,42,16,26,3,2
3,466,466,9,3,6,2,1
11,470,470,1,1,0,1,0
15,471,471,39,15,24,2,1
22,480,480,178,160,18,4,3
17,486,486,28,17,11,2,1
39,488,488,73,73,0,1,0

5,121,121,1,1,0,1,0
2,129,129,15,8,7,2,1
17,133,133,1,1,0,1,0
33,144,144,26,26,0,1,0
10,150,150,6,3,3,2,1
14,158,158,6,6,0,1,0
7,172,172,9,3,6,3,2
8,190,190,33,10,23,2,1
20,193,193,5,5,0,1,0
19,196,196,29,29,0,1,0
23,198,198,26,8,18,4,3
21,198,198,20,20,0,1,0
24,215,215,33,13,20,2,1
1,228,228,2,2,0,1,0
13,237,237,16,16,0,1,0
16,245,245,2,2,0,1,0
9,253,253,10,2,8,3,2
28,265,265,4,4,0,1,0
0,268,268,71,71,0,1,0
31,273,273,2,2,0,1,0
32,276,276,24,2,22,2,1
30,283,283,25,3,22,3,2
25,320,320,6,6,0,1,0
18,323,323,43,43,0,1,0
4,383,383,19,19,0,1,0
3,402,402,69,69,0,1,0
26,407,407,133,82,51,4,3
6,420,420,136,25,111,4,3
11,443,443,89,89,0,1,0
12,474,474,19,5,14,3,2
27,480,480,9,9,0,1,0
29,486,486,47,17,30,2,1
15,494,494,48,48,0,1,0
22,497,497,98,98,0,1,0

13,116,116,24,24,0,1,0
3,125,125,2,2,0,1,0
31,126,126,34,34,0,1,0
27,130,130,11,11,0,1,0
5,131,131,32,1,31,4,3
1,143,143,9,9,0,1,0
17,144,144,39,39,0,1,0
12,154,154,41,23,18,3,2
26,160,160,4,4,0,1,0
6,162,162,44,24,20,2,1
14,169,169,16,2,14,4,3
29,178,178,8,8,0,1,0
19,198,198,20,20,0,1,0
7,207,207,3,3,0,1,0
32,220,220,23,23,0,1,0
0,242,242,3,3,0,1,0
30,288,288,31,5,26,3,2
28,293,293,30,8,22,4,3
33,301,301,4,4,0,1,0
2,310,310,65,65,0,1,0
4,327,327,35,17,18,3,2
8,358,358,12,12,0,1,0
18,400,400,92,23,69,4,3
10,414,414,1,1,0,1,0
23,419,419,30,30,0,1,0
25,425,425,5,5,0,1,0
9,437,437,2,2,0,1,0
20,438,438,28,28,0,1,0
24,438,438,9,9,0,1,0
16,440,440,4,4,0,1,0
15,472,472,27,15,12,2,1
11,481,481,42,42,0,1,0
22,485,485,70,28,42,4,3
21,487,487,36,8,28,4,3

11,111,111,7,7,0,1,0
29,120,120,13,13,0,1,0
5,141,141,1,1,0,1,0
22,142,142,12,5,7,2,1
10,148,148,15,2,13,4,3
14,149,149,23,23,0,1,0
17,159,159,2,2,0,1,0
26,175,175,5,5,0,1,0
15,211,211,11,11,0,1,0
18,213,213,5,5,0,1,0
13,229,229,38,5,33,4,3
6,262,262,22,5,17,2,1
0,268,268,4,4,0,1,0
19,271,271,2,2,0,1,0
23,274,274,50,6,44,2,1
4,281,281,132,132,0,1,0
28,296,296,96,70,26,4,3
20,315,315,6,6,0,1,0
7,364,364,39,1,38,2,1
1,378,378,3,3,0,1,0
27,380,380,75,18,57,4,3
12,404,404,1,1,0,1,0
9,427,427,106,24,82,3,2
21,429,429,104,54,50,2,1
8,432,432,144,144,0,1,0
2,437,437,93,83,10,2,1
3,450,450,22,1,21,2,1
16,464,464,16,16,0,1,0
24,470,470,10,10,0,1,0
25,490,490,40,40,0,1,0

10,111,111,9,5,4,2,1
1,119,119,19,7,12,3,2
19,121,121,15,15,0,1,0
30,134,134,6,6,0,1,0
25,144,144,21,12,9,4,3
11,152,152,10,10,0,1,0
28,156,156,7,3,4,2,1
14,187,187,20,12,8,2,1
2,190,190,17,3,14,3,2
37,203,203,2,2,0,1,0
5,210,210,10,10,0,1,0
6,219,219,21,11,10,2,1
12,226,226,3,3,0,1,0
13,256,256,1,1,0,1,0
35,259,259,17,9,8,2,1
33,291,291,31,17,14,3,2
4,300,300,4,4,0,1,0
17,331,331,20,20,0,1,0
20,345,345,14,14,0,1,0
15,365,365,48,48,0,1,0
31,372,372,66,66,0,1,0
3,373,373,9,1,8,3,2
26,378,378,16,16,0,1,0
24,382,382,20,7,13,2,1
7,406,406,29,4,25,3,2
18,409,409,65,42,23,2,1
8,431,431,62,62,0,1,0
32,434,434,76,56,20,2,1
16,435,435,63,15,48,3,2
29,440,440,48,48,0,1,0
23,453,453,26,26,0,1,0
36,464,464,77,23,54,3,2
21,475,475,43,43,0,1,0
34,480,480,60,60,0,1,0
0,492,492,50,50,0,1,0
22,497,497,81,21,60,4,3
27,499,499,78,15,63,4,3
9,499,499,11,3,8,3,2

16,102,102,3,3,0,1,0
12,133,133,6,6,0,1,0
17,139,139,17,7,10,3,2
28,140,140,12,12,0,1,0
22,147,147,12,12,0,1,0
7,151,151,1,1,0,1,0
32,156,156,25,5,20,3,2
0,162,162,1,1,0,1,0
25,170,170,13,1,12,2,1
30,187,187,10,10,0,1,0
14,198,198,38,27,11,2,1
20,208,208,19,10,9,4,3
5,209,209,6,6,0,1,0
19,213,213,12,12,0,1,0
2,248,248,6,6,0,1,0
9,250,250,1,1,0,1,0
1,261,261,3,3,0,1,0
6,262,262,29,29,0,1,0
23,279,279,47,26,21,4,3
10,289,289,6,1,5,2,1
29,293,293,20,14,6,3,2
11,317,317,45,3,42,2,1
18,323,323,13,13,0,1,0
13,345,345,144,60,84,4,3
35,345,345,23,6,17,2,1
34,357,357,27,11,16,2,1
27,380,380,30,1,29,2,1
3,415,415,44,2,42,3,2
31,416,416,50,26,24,4,3
4,427,427,10,10,0,1,0
26,436,436,24,14,10,3,2
21,444,444,45,12,33,4,3
8,452,452,138,138,0,1,0
15,455,455,5,5,0,1,0
24,467,467,15,15,0,1,0
33,477,477,151,105,46,2,1
36,497,497,52,52,0,1,0

31,111,111,10,5,5,2,1
34,158,158,35,21,14,3,2
18,161,161,10,10,0,1,0
28,176,176,9,9,0,1,0
24,180,180,27,27,0,1,0
15,189,189,18,18,0,1,0
38,197,197,15,15,0,1,0
4,197,197,6,6,0,1,0
13,223,223,11,11,0,1,0
33,225,225,57,5,52,3,2
16,233,233,4,1,3,2,1
14,235,235,21,21,0,1,0
19,245,245,28,10,18,3,2
20,248,248,6,6,0,1,0
25,266,266,9,2,7,2,1
3,270,270,18,6,12,4,3
22,290,290,4,1,3,2,1
21,294,294,16,1,15,4,3
12,301,301,15,15,0,1,0
27,307,307,4,1,3,2,1
1,308,308,59,45,14,2,1
26,318,318,17,17,0,1,0
0,325,325,2,2,0,1,0
10,329,329,88,21,67,4,3
29,330,330,57,8,49,2,1
32,332,332,39,39,0,1,0
35,335,335,21,15,6,2,1
8,343,343,27,16,11,2,1
5,359,359,5,2,3,2,1
6,390,390,32,32,0,1,0
2,393,393,54,10,44,2,1
11,418,418,19,19,0,1,0
30,427,427,36,36,0,1,0
36,442,442,74,10,64,4,3
23,454,454,41,41,0,1,0
37,462,462,2,2,0,1,0
39,470,470,47,47,0,1,0
7,473,473,54,45,9,4,3
9,487,487,34,34,0,1,0
17,488,488,14,5,9,4,3

17,109,109,1,1,0,1,0
7,144,144,10,10,0,1,0
26,146,146,11,3,8,3,2
0,146,146,10,10,0,1,0
28,151,151,6,6,0,1,0
31,157,157,47,8,39,3,2
9,162,162,9,3,6,3,2
3,173,173,60,36,24,2,1
1,207,207,1,1,0,1,0
21,213,213,28,28,0,1,0
36,217,217,12,12,0,1,0
15,222,222,56,26,30,2,1
24,226,226,12,12,0,1,0
19,271,271,16,16,0,1,0
18,271,271,14,14,0,1,0
13,271,271,7,7,0,1,0
22,276,276,61,61,0,1,0
5,290,290,8,8,0,1,0
14,312,312,55,55,0,1,0
6,314,314,60,60,0,1,0
25,325,325,12,3,9,2,1
29,328,328,19,5,14,2,1
2,335,335,50,50,0,1,0
35,340,340,17,17,0,1,0
27,362,362,33,4,29,2,1
23,366,366,9,1,8,2,1
33,366,366,36,6,30,4,3
4,387,387,7,7,0,1,0
20,394,394,108,108,0,1,0
30,400,400,5,5,0,1,0
34,431,431,30,30,0,1,0
10,444,444,17,5,12,2,1
11,450,450,5,5,0,1,0
16,478,478,32,32,0,1,0
8,480,480,1,1,0,1,0
12,481,481,37,37,0,1,0
32,484,484,67,61,6,2,1

1,133,133,2,2,0,1,0
22,137,137,7,7,0,1,0
37,140,140,10,10,0,1,0
6,140,140,3,3,0,1,0
8,146,146,12,8,4,2,1
4,151,151,21,21,0,1,0
31,157,157,2,2,0,1,0
33,177,177,9,4,5,2,1
32,188,188,35,8,27,2,1
3,191,191,22,22,0,1,0
11,213,213,5,5,0,1,0
7,226,226,24,24,0,1,0
13,236,236,1,1,0,1,0
9,242,242,69,69,0,1,0
18,263,263,5,2,3,2,1
30,264,264,18,4,14,3,2
14,272,272,9,9,0,1,0
27,280,280,45,19,26,4,3
34,288,288,15,15,0,1,0
15,289,289,53,53,0,1,0
28,289,289,58,58,0,1,0
35,311,311,42,12,30,2,1
21,332,332,14,14,0,1,0
23,343,343,43,17,26,3,2
24,352,352,24,24,0,1,0
10,375,375,40,40,0,1,0
38,380,380,78,10,68,3,2
2,384,384,11,11,0,1,0
20,402,402,20,20,0,1,0
26,408,408,3,3,0,1,0
5,412,412,27,16,11,2,1
12,414,414,75,75,0,1,0
17,420,420,5,5,0,1,0
25,466,466,30,30,0,1,0
29,473,473,73,21,52,3,2
16,475,475,3,3,0,1,0
0,475,475,26,2,24,4,3
36,476,476,59,50,9,4,3
19,493,493,62,12,50,3,2

15,109,109,12,12,0,1,0
17,112,112,3,3,0,1,0
25,120,120,36,22,14,3,2
3,159,159,14,6,8,3,2
2,167,167,1,1,0,1,0
5,176,176,20,20,0,1,0
35,181,181,43,43,0,1,0
36,184,184,2,2,0,1,0
31,186,186,35,5,30,4,3
24,201,201,14,14,0,1,0
26,222,222,2,2,0,1,0
28,228,228,5,5,0,1,0
29,229,229,51,16,35,2,1
12,255,255,33,33,0,1,0
16,256,256,19,19,0,1,0
7,293,293,39,8,31,2,1
18,301,301,22,16,6,2,1
4,307,307,8,2,6,3,2
10,311,311,12,4,8,3,2
1,313,313,11,3,8,2,1
9,315,315,28,10,18,4,3
32,326,326,75,41,34,3,2
20,343,343,23,23,0,1,0
0,345,345,65,65,0,1,0
13,361,361,100,52,48,4,3
19,391,391,45,45,0,1,0
23,399,399,41,23,18,3,2
22,426,426,9,9,0,1,0
33,435,435,13,3,10,2,1
8,435,435,1,1,0,1,0
30,437,437,17,17,0,1,0
27,453,453,28,28,0,1,0
11,458,458,35,35,0,1,0
6,469,469,19,9,10,2,1
34,483,483,31,24,7,2,1
21,488,488,30,22,8,3,2
14,494,494,29,5,24,2,1

7,117,117,15,5,10,3,2
3,140,140,10,10,0,1,0
0,186,186,53,3,50,3,2
23,186,186,30,30,0,1,0
15,189,189,19,9,10,2,1
10,190,190,10,10,0,1,0
8,204,204,26,1,25,2,1
9,211,211,2,2,0,1,0
24,270,270,19,19,0,1,0
18,278,278,27,5,22,2,1
16,281,281,22,2,20,3,2
13,296,296,20,20,0,1,0
5,308,308,45,16,29,4,3
26,319,319,2,2,0,1,0
6,345,345,65,65,0,1,0
22,348,348,8,8,0,1,0
2,363,363,25,7,18,4,3
21,373,373,119,119,0,1,0
14,393,393,69,6,63,4,3
25,410,410,1,1,0,1,0
4,413,413,194,116,78,3,2
1,467,467,97,29,68,4,3
20,468,468,149,134,15,2,1
11,474,474,45,22,23,4,3
12,477,477,10,3,7,2,1
19,479,479,12,12,0,1,0
17,488,488,55,9,46,2,1

12,128,128,10,10,0,1,0
22,135,135,19,5,14,3,2
24,148,148,7,7,0,1,0
34,156,156,5,5,0,1,0
7,159,159,4,4,0,1,0
25,170,170,10,7,3,2,1
26,178,178,12,1,11,2,1
4,210,210,7,7,0,1,0
19,217,217,27,3,24,2,1
0,221,221,58,10,48,3,2
13,233,233,64,33,31,3,2
23,274,274,34,34,0,1,0
27,285,285,62,62,0,1,0
20,297,297,46,22,24,4,3
11,299,299,41,41,0,1,0
31,305,305,72,72,0,1,0
18,320,320,13,13,0,1,0
33,328,328,15,1,14,3,2
14,330,330,6,3,3,2,1
10,334,334,1,1,0,1,0
5,340,340,54,54,0,1,0
30,355,355,3,3,0,1,0
29,376,376,105,59,46,4,3
16,376,376,28,28,0,1,0
2,378,378,11,3,8,2,1
3,379,379,3,3,0,1,0
9,404,404,6,6,0,1,0
1,414,414,21,9,12,3,2
17,420,420,38,24,14,3,2
32,427,427,6,6,0,1,0
8,432,432,31,18,13,2,1
6,458,458,118,94,24,4,3
15,462,462,52,15,37,2,1
28,471,471,40,40,0,1,0
21,481,481,24,20,4,2,1

1,103,103,10,10,0,1,0
21,107,107,27,21,6,3,2
3,124,124,2,2,0,1,0
20,128,128,7,2,5,2,1
32,152,152,5,5,0,1,0
5,174,174,13,7,6,3,2
9,190,190,1,1,0,1,0
26,208,208,11,2,9,4,3
11,213,213,8,8,0,1,0
24,228,228,24,24,0,1,0
29,259,259,28,28,0,1,0
12,263,263,11,11,0,1,0
8,271,271,38,8,30,4,3
6,282,282,13,13,0,1,0
30,288,288,3,3,0,1,0
16,320,320,7,2,5,2,1
0,335,335,16,16,0,1,0
10,335,335,63,9,54,4,3
15,336,336,94,64,30,4,3
13,340,340,52,6,46,3,2
31,342,342,68,68,0,1,0
25,348,348,62,46,16,2,1
28,368,368,50,17,33,4,3
18,381,381,2,2,0,1,0
17,393,393,18,18,0,1,0
19,408,408,43,43,0,1,0
34,410,410,54,6,48,4,3
7,416,416,28,28,0,1,0
35,426,426,47,6,41,2,1
23,438,438,16,16,0,1,0
22,444,444,31,31,0,1,0
14,447,447,53,14,39,4,3
2,475,475,48,12,36,3,2
27,479,479,58,11,47,2,1
33,496,496,14,14,0,1,0
4,498,498,107,35,72,3,2

21,105,105,4,1,3,2,1
12,109,109,1,1,0,1,0
1,127,127,13,4,9,2,1
24,149,149,12,12,0,1,0
17,171,171,8,2,6,3,2
2,191,191,5,1,4,2,1
15,193,193,16,16,0,1,0
25,207,207,37,37,0,1,0
18,207,207,12,12,0,1,0
16,207,207,2,2,0,1,0
3,209,209,42,42,0,1,0
33,236,236,25,25,0,1,0
26,240,240,20,2,18,4,3
22,245,245,33,18,15,4,3
5,246,246,5,2,3,2,1
4,280,280,47,39,8,3,2
30,282,282,68,53,15,4,3
20,302,302,37,13,24,2,1
0,327,327,27,27,0,1,0
31,344,344,40,16,24,2,1
29,353,353,6,6,0,1,0
23,378,378,14,14,0,1,0
11,391,391,89,89,0,1,0
28,397,397,9,2,7,2,1
14,410,410,139,92,47,4,3
7,420,420,3,3,0,1,0
6,421,421,1,1,0,1,0
9,421,421,31,7,24,3,2
27,428,428,59,59,0,1,0
19,435,435,17,11,6,3,2
13,435,435,51,51,0,1,0
8,439,439,29,29,0,1,0
10,442,442,74,74,0,1,0
32,459,459,127,21,106,4,3

29,123,123,7,1,6,2,1
8,136,136,14,4,10,2,1
17,138,138,9,5,4,2,1
1,164,164,1,1,0,1,0
31,167,167,25,1,24,4,3
15,170,170,17,8,9,4,3
5,177,177,3,3,0,1,0
7,197,197,24,5,19,2,1
18,203,203,21,21,0,1,0
20,218,218,56,56,0,1,0
30,230,230,11,11,0,1,0
11,232,232,5,5,0,1,0
28,255,255,8,2,6,3,2
25,258,258,16,10,6,3,2
4,262,262,75,75,0,1,0
3,289,289,34,34,0,1,0
21,305,305,23,3,20,2,1
13,310,310,1,1,0,1,0
12,316,316,33,33,0,1,0
16,319,319,92,92,0,1,0
27,324,324,35,22,13,2,1
23,333,333,39,18,21,4,3
22,367,367,21,9,12,2,1
9,372,372,68,56,12,4,3
14,375,375,7,7,0,1,0
6,385,385,27,17,10,3,2
0,413,413,23,8,15,2,1
2,417,417,242,140,102,4,3
19,429,429,22,22,0,1,0
26,444,444,14,1,13,2,1
10,445,445,6,6,0,1,0
24,480,480,65,65,0,1,0

4,133,133,1,1,0,1,0
17,161,161,1,1,0,1,0
14,182,182,14,14,0,1,0
27,194,194,30,30,0,1,0
8,207,207,17,3,14,2,1
2,217,217,55,55,0,1,0
20,228,228,24,1,23,4,3
11,234,234,68,50,18,4,3
21,252,252,5,5,0,1,0
26,254,254,74,74,0,1,0
1,261,261,57,57,0,1,0
9,270,270,35,11,24,3,2
3,285,285,29,29,0,1,0
22,307,307,28,25,3,2,1
24,318,318,5,5,0,1,0
23,334,334,24,6,18,3,2
16,354,354,6,6,0,1,0
12,371,371,57,57,0,1,0
13,390,390,19,13,6,3,2
25,396,396,74,74,0,1,0
5,415,415,9,9,0,1,0
15,431,431,49,16,33,2,1
10,433,433,76,37,39,4,3
28,457,457,81,53,28,3,2
18,468,468,86,74,12,4,3
7,480,480,42,9,33,4,3
6,485,485,71,71,0,1,0
19,490,490,8,4,4,2,1
0,499,499,94,34,60,4,3

4,119,119,1,1,0,1,0
15,122,122,1,1,0,1,0
29,128,128,11,1,10,3,2
13,131,131,4,1,3,2,1
8,134,134,4,4,0,1,0
38,135,135,13,2,11,2,1
27,161,161,11,7,4,2,1
19,172,172,24,21,3,2,1
37,200,200,2,2,0,1,0
35,226,226,15,15,0,1,0
17,227,227,14,2,12,3,2
23,230,230,92,77,15,4,3
30,234,234,13,13,0,1,0
21,242,242,19,19,0,1,0
5,245,245,42,14,28,3,2
18,253,253,27,27,0,1,0
22,261,261,52,52,0,1,0
25,264,264,25,25,0,1,0
0,276,276,5,1,4,2,1
20,288,288,3,3,0,1,0
24,289,289,22,8,14,3,2
11,303,303,71,71,0,1,0
9,307,307,60,42,18,4,3
34,318,318,51,51,0,1,0
28,344,344,58,58,0,1,0
2,356,356,8,8,0,1,0
31,367,367,27,27,0,1,0
3,377,377,1,1,0,1,0
36,386,386,15,2,13,2,1
6,407,407,16,16,0,1,0
7,439,439,18,18,0,1,0
33,445,445,23,23,0,1,0
16,446,446,19,1,18,2,1
1,448,448,129,129,0,1,0
12,450,450,32,14,18,3,2
32,470,470,6,6,0,1,0
14,475,475,1,1,0,1,0
10,484,484,49,11,38,2,1
26,486,486,31,31,0,1,0

37,118,118,2,2,0,1,0
28,129,129,11,11,0,1,0
10,133,133,7,7,0,1,0
26,142,142,38,13,25,2,1
20,145,145,1,1,0,1,0
22,152,152,1,1,0,1,0
18,159,159,4,1,3,2,1
24,160,160,12,12,0,1,0
30,172,172,3,3,0,1,0
31,185,185,16,16,0,1,0
0,186,186,1,1,0,1,0
29,186,186,51,12,39,4,3
27,229,229,24,24,0,1,0
15,242,242,26,26,0,1,0
33,244,244,98,11,87,4,3
8,263,263,2,2,0,1,0
25,272,272,23,3,20,2,1
34,275,275,8,8,0,1,0
13,279,279,94,67,27,4,3
11,303,303,25,3,22,3,2
16,307,307,8,1,7,2,1
4,321,321,1,1,0,1,0
6,324,324,11,11,0,1,0
36,332,332,22,8,14,2,1
7,335,335,19,19,0,1,0
14,339,339,62,62,0,1,0
35,351,351,32,23,9,4,3
9,366,366,91,31,60,4,3
3,387,387,92,92,0,1,0
5,391,391,29,4,25,3,2
12,413,413,7,7,0,1,0
23,427,427,6,6,0,1,0
21,441,441,21,4,17,2,1
32,452,452,33,2,31,2,1
1,457,457,37,37,0,1,0
2,497,497,18,18,0,1,0
19,498,498,35,29,6,3,2
17,499,499,4,4,0,1,0

18,100,100,8,8,0,1,0
13,103,103,1,1,0,1,0
24,123,123,2,2,0,1,0
31,133,133,20,6,14,3,2
15,138,138,2,2,0,1,0
27,148,148,7,7,0,1,0
3,161,161,3,3,0,1,0
19,179,179,51,15,36,4,3
1,184,184,8,8,0,1,0
23,192,192,5,1,4,2,1
0,196,196,25,5,20,2,1
14,199,199,40,4,36,3,2
10,231,231,4,4,0,1,0
22,237,237,60,60,0,1,0
20,247,247,5,5,0,1,0
7,257,257,5,2,3,2,1
9,258,258,9,9,0,1,0
12,275,275,49,49,0,1,0
5,282,282,28,8,20,3,2
29,284,284,42,42,0,1,0
33,314,314,7,7,0,1,0
8,325,325,109,81,28,2,1
4,327,327,13,4,9,2,1
21,330,330,33,12,21,2,1
17,351,351,56,56,0,1,0
25,366,366,89,63,26,4,3
6,373,373,65,65,0,1,0
34,383,383,31,31,0,1,0
16,396,396,39,8,31,2,1
28,406,406,3,3,0,1,0
26,440,440,82,22,60,4,3
30,440,440,24,11,13,2,1
11,440,440,8,8,0,1,0
2,453,453,51,14,37,4,3
32,469,469,6,6,0,1,0

13,106,106,9,9,0,1,0
29,111,111,2,2,0,1,0
23,122,122,19,1,18,2,1
11,135,135,12,8,4,2,1
5,154,154,2,2,0,1,0
12,164,164,4,4,0,1,0
10,174,174,7,7,0,1,0
9,175,175,35,16,19,2,1
0,178,178,15,6,9,4,3
16,199,199,19,9,10,3,2
14,213,213,1,1,0,1,0
30,220,220,25,25,0,1,0
6,224,224,9,3,6,2,1
7,246,246,47,47,0,1,0
22,248,248,8,8,0,1,0
18,261,261,2,2,0,1,0
1,264,264,106,79,27,4,3
28,283,283,30,15,15,2,1
2,284,284,13,13,0,1,0
20,330,330,1,1,0,1,0
19,338,338,45,41,4,2,1
8,352,352,38,38,0,1,0
21,378,378,10,10,0,1,0
26,397,397,5,5,0,1,0
32,415,415,135,45,90,4,3
4,420,420,101,101,0,1,0
24,425,425,37,31,6,2,1
25,433,433,62,52,10,2,1
27,470,470,18,10,8,2,1
3,471,471,23,23,0,1,0
31,473,473,119,56,63,4,3
17,481,481,89,89,0,1,0
15,494,494,42,42,0,1,0

18,107,107,2,2,0,1,0
6,123,123,14,4,10,3,2
8,155,155,1,1,0,1,0
14,159,159,11,2,9,4,3
37,162,162,15,15,0,1,0
24,175,175,4,4,0,1,0
39,176,176,8,3,5,2,1
17,176,176,10,10,0,1,0
26,200,200,12,12,0,1,0
11,206,206,22,22,0,1,0
9,220,220,1,1,0,1,0
30,232,232,43,43,0,1,0
21,234,234,72,72,0,1,0
13,239,239,1,1,0,1,0
10,241,241,10,3,7,3,2
0,246,246,4,4,0,1,0
19,269,269,8,8,0,1,0
5,272,272,21,21,0,1,0
34,273,273,5,5,0,1,0
22,275,275,10,10,0,1,0
27,284,284,60,60,0,1,0
20,302,302,3,3,0,1,0
25,332,332,51,1,50,3,2
4,341,341,36,36,0,1,0
38,365,365,26,2,24,3,2
16,368,368,84,53,31,2,1
23,391,391,5,5,0,1,0
29,394,394,20,20,0,1,0
1,395,395,31,31,0,1,0
33,405,405,24,24,0,1,0
7,406,406,57,57,0,1,0
35,409,409,105,96,9,4,3
15,411,411,37,14,23,2,1
36,413,413,128,66,62,3,2
28,415,415,33,33,0,1,0
3,440,440,3,3,0,1,0
32,452,452,12,12,0,1,0
12,453,453,51,12,39,4,3
2,474,474,20,20,0,1,0
31,480,480,37,37,0,1,0

14,101,101,4,4,0,1,0
9,102,102,11,11,0,1,0
25,108,108,1,1,0,1,0
8,129,129,2,2,0,1,0
30,136,136,6,1,5,2,1
5,138,138,7,1,6,3,2
28,161,161,54,30,24,4,3
11,176,176,13,13,0,1,0
10,181,181,31,10,21,4,3
15,194,194,1,1,0,1,0
27,213,213,4,1,3,2,1
23,220,220,51,51,0,1,0
19,257,257,19,5,14,3,2
6,257,257,2,2,0,1,0
38,262,262,1,1,0,1,0
22,264,264,30,30,0,1,0
34,268,268,3,3,0,1,0
7,276,276,1,1,0,1,0
17,285,285,14,14,0,1,0
31,290,290,30,30,0,1,0
0,299,299,15,11,4,2,1
32,308,308,23,23,0,1,0
1,317,317,86,6,80,3,2
33,324,324,19,8,11,2,1
2,336,336,79,49,30,2,1
20,337,337,22,22,0,1,0
16,354,354,19,19,0,1,0
3,355,355,15,9,6,3,2
29,357,357,3,3,0,1,0
13,379,379,1,1,0,1,0
36,384,384,90,57,33,4,3
35,385,385,106,63,43,2,1
24,390,390,14,11,3,2,1
37,397,397,22,2,20,2,1
26,399,399,47,47,0,1,0
12,399,399,13,13,0,1,0
4,425,425,8,2,6,2,1
21,470,470,144,144,0,1,0
18,474,474,12,12,0,1,0

12,106,106,25,25,0,1,0
4,107,107,6,6,0,1,0
17,111,111,2,2,0,1,0
29,131,131,4,1,3,2,1
14,165,165,9,2,7,2,1
1,195,195,29,29,0,1,0
15,209,209,21,6,15,3,2
2,221,221,15,15,0,1,0
7,226,226,10,10,0,1,0
16,230,230,38,24,14,3,2
22,242,242,62,29,33,2,1
11,257,257,56,17,39,3,2
8,257,257,33,9,24,2,1
21,258,258,57,57,0,1,0
30,269,269,51,7,44,2,1
20,270,270,43,43,0,1,0
23,283,283,20,15,5,2,1
26,312,312,3,3,0,1,0
10,333,333,4,4,0,1,0
27,336,336,102,32,70,4,3
13,341,341,28,28,0,1,0
18,355,355,11,5,6,3,2
25,391,391,3,3,0,1,0
6,400,400,83,46,37,2,1
3,412,412,79,21,58,4,3
5,419,419,20,15,5,2,1
9,430,430,1,1,0,1,0
28,438,438,1,1,0,1,0
24,439,439,28,4,24,4,3
0,442,442,115,67,48,4,3
19,450,450,23,23,0,1,0

21,103,103,9,1,8,3,2
24,106,106,15,15,0,1,0
19,123,123,14,11,3,2,1
34,129,129,7,7,0,1,0
31,147,147,8,8,0,1,0
14,180,180,13,13,0,1,0
13,182,182,2,2,0,1,0
27,188,188,6,6,0,1,0
2,200,200,17,11,6,2,1
18,211,211,44,44,0,1,0
5,213,213,26,26,0,1,0
36,218,218,28,1,27,3,2
20,225,225,30,30,0,1,0
25,248,248,12,12,0,1,0
17,252,252,43,43,0,1,0
6,268,268,3,3,0,1,0
33,285,285,20,6,14,3,2
10,290,290,20,2,18,3,2
15,308,308,19,9,10,2,1
16,314,314,3,3,0,1,0
0,342,342,53,53,0,1,0
32,354,354,25,10,15,4,3
23,379,379,83,83,0,1,0
7,394,394,18,9,9,4,3
12,399,399,22,22,0,1,0
8,400,400,21,21,0,1,0
29,408,408,23,23,0,1,0
9,416,416,80,80,0,1,0
1,421,421,42,8,34,2,1
22,423,423,57,25,32,3,2
30,427,427,152,140,12,4,3
3,446,446,9,9,0,1,0
4,457,457,35,35,0,1,0
26,457,457,46,46,0,1,0
35,464,464,6,6,0,1,0
28,471,471,18,10,8,2,1
11,491,491,36,36,0,1,0

25,100,100,16,4,12,2,1
27,118,118,26,12,14,3,2
28,135,135,26,15,11,2,1
32,140,140,5,5,0,1,0
33,181,181,6,1,5,2,1
31,185,185,2,2,0,1,0
10,245,245,40,40,0,1,0
9,260,260,9,9,0,1,0
8,262,262,57,57,0,1,0
15,284,284,29,29,0,1,0
34,295,295,2,2,0,1,0
35,305,305,13,6,7,2,1
14,328,328,90,66,24,4,3
24,329,329,93,93,0,1,0
17,347,347,7,7,0,1,0
1,350,350,7,7,0,1,0
20,364,364,27,3,24,4,3
2,379,379,22,22,0,1,0
16,403,403,115,43,72,4,3
6,403,403,8,2,6,2,1
11,406,406,24,8,16,2,1
4,410,410,8,8,0,1,0
3,417,417,44,11,33,4,3
26,425,425,123,96,27,4,3
29,439,439,5,5,0,1,0
13,442,442,12,3,9,4,3
19,446,446,33,11,22,2,1
22,454,454,47,47,0,1,0
21,459,459,15,10,5,2,1
12,460,460,26,26,0,1,0
36,461,461,28,28,0,1,0
7,469,469,43,11,32,2,1
30,472,472,36,26,10,3,2
23,472,472,51,51,0,1,0
5,476,476,1,1,0,1,0
0,481,481,6,2,4,2,1
18,484,484,28,28,0,1,0

1,139,139,1,1,0,1,0
5,163,163,13,13,0,1,0
28,176,176,1,1,0,1,0
0,180,180,1,1,0,1,0
27,204,204,1,1,0,1,0
15,236,236,5,5,0,1,0
4,269,269,6,6,0,1,0
19,271,271,38,22,16,3,2
23,273,273,19,19,0,1,0
17,306,306,42,2,40,3,2
8,307,307,87,15,72,3,2
31,322,322,83,83,0,1,0
14,326,326,44,30,14,2,1
2,326,326,68,6,62,4,3
10,341,341,15,5,10,2,1
29,346,346,14,14,0,1,0
24,366,366,70,70,0,1,0
26,369,369,15,15,0,1,0
16,377,377,56,29,27,2,1
11,390,390,92,74,18,3,2
25,398,398,27,9,18,3,2
20,407,407,119,35,84,4,3
21,412,412,20,20,0,1,0
7,413,413,10,10,0,1,0
9,415,415,128,128,0,1,0
12,446,446,15,9,6,3,2
30,458,458,23,23,0,1,0
6,472,472,7,7,0,1,0
22,473,473,47,47,0,1,0
3,474,474,61,48,13,2,1
13,477,477,72,72,0,1,0
18,491,491,1,1,0,1,0
32,497,497,67,67,0,1,0

17,101,101,6,6,0,1,0
19,106,106,6,6,0,1,0
32,111,111,28,16,12,3,2
24,119,119,1,1,0,1,0
0,129,129,22,10,12,2,1
5,130,130,21,5,16,2,1
27,138,138,16,8,8,3,2
29,157,157,18,13,5,2,1
31,161,161,14,8,6,2,1
7,187,187,7,7,0,1,0
42,191,191,13,1,12,4,3
21,195,195,1,1,0,1,0
14,211,211,37,37,0,1,0
10,212,212,26,17,9,2,1
33,232,232,28,28,0,1,0
23,241,241,19,14,5,2,1
13,246,246,9,9,0,1,0
4,259,259,1,1,0,1,0
37,271,271,30,30,0,1,0
8,280,280,10,10,0,1,0
12,281,281,2,2,0,1,0
35,288,288,31,23,8,3,2
6,303,303,4,4,0,1,0
41,304,304,9,9,0,1,0
26,307,307,6,6,0,1,0
38,326,326,74,2,72,3,2
3,330,330,29,5,24,4,3
2,344,344,49,7,42,4,3
1,344,344,17,17,0,1,0
20,349,349,2,2,0,1,0
16,350,350,50,11,39,3,2
39,361,361,2,2,0,1,0
11,366,366,24,17,7,2,1
25,367,367,11,1,10,3,2
9,370,370,32,8,24,3,2
28,372,372,50,11,39,4,3
15,378,378,32,13,19,2,1
34,380,380,48,3,45,4,3
30,409,409,12,12,0,1,0
22,412,412,7,7,0,1,0
18,419,419,7,7,0,1,0
36,438,438,27,27,0,1,0
40,457,457,54,54,0,1,0

21,104,104,12,6,6,2,1
9,148,148,13,13,0,1,0
4,158,158,18,3,15,4,3
24,174,174,28,28,0,1,0
15,213,213,6,6,0,1,0
8,218,218,9,2,7,2,1
33,238,238,41,41,0,1,0
7,257,257,5,5,0,1,0
16,300,300,9,9,0,1,0
6,322,322,43,1,42,4,3
29,334,334,47,35,12,4,3
18,339,339,40,6,34,3,2
14,344,344,14,14,0,1,0
2,358,358,34,34,0,1,0
26,364,364,17,6,11,2,1
5,389,389,54,14,40,3,2
23,392,392,25,17,8,2,1
12,394,394,12,2,10,2,1
27,401,401,57,57,0,1,0
10,401,401,63,63,0,1,0
0,403,403,113,8,105,4,3
31,404,404,53,11,42,3,2
17,407,407,59,20,39,4,3
3,427,427,24,24,0,1,0
13,431,431,9,9,0,1,0
32,438,438,12,6,6,3,2
34,442,442,13,13,0,1,0
1,445,445,13,9,4,2,1
25,456,456,11,6,5,2,1
30,469,469,5,5,0,1,0
11,472,472,120,88,32,2,1
19,476,476,3,3,0,1,0
28,479,479,85,39,46,3,2
22,480,480,164,115,49,4,3
20,480,480,8,2,6,3,2

7,100,100,1,1,0,1,0
5,122,122,14,8,6,3,2
11,122,122,44,44,0,1,0
31,141,141,7,1,6,3,2
25,151,151,22,13,9,4,3
1,164,164,1,1,0,1,0
4,166,166,16,16,0,1,0
20,167,167,1,1,0,1,0
33,182,182,17,17,0,1,0
23,195,195,30,23,7,2,1
28,208,208,4,4,0,1,0
34,228,228,7,1,6,2,1
19,247,247,37,13,24,4,3
13,248,248,10,10,0,1,0
0,279,279,16,16,0,1,0
26,286,286,18,2,16,2,1
17,293,293,5,5,0,1,0
8,300,300,10,1,9,4,3
6,341,341,67,67,0,1,0
3,365,365,1,1,0,1,0
21,368,368,48,48,0,1,0
2,374,374,75,75,0,1,0
18,375,375,83,47,36,4,3
30,376,376,111,33,78,3,2
24,378,378,44,32,12,4,3
12,385,385,66,35,31,2,1
14,407,407,11,5,6,3,2
16,411,411,19,1,18,4,3
29,425,425,52,14,38,3,2
9,426,426,31,16,15,4,3
15,452,452,29,29,0,1,0
22,465,465,22,22,0,1,0
10,465,465,86,86,0,1,0
27,475,475,26,11,15,2,1
32,495,495,17,5,12,3,2

4,106,106,9,9,0,1,0
28,107,107,10,7,3,2,1
22,109,109,8,8,0,1,0
13,131,131,14,14,0,1,0
11,136,136,10,1,9,4,3
9,172,172,14,1,13,3,2
27,203,203,8,8,0,1,0
10,205,205,28,2,26,3,2
1,212,212,20,20,0,1,0
3,213,213,88,88,0,1,0
2,214,214,28,28,0,1,0
16,220,220,35,1,34,2,1
6,231,231,7,7,0,1,0
12,258,258,6,2,4,2,1
19,258,258,6,6,0,1,0
15,274,274,14,14,0,1,0
25,284,284,10,10,0,1,0
20,294,294,3,3,0,1,0
31,298,298,33,33,0,1,0
21,298,298,89,63,26,3,2
14,343,343,40,40,0,1,0
8,347,347,45,45,0,1,0
7,363,363,15,15,0,1,0
29,391,391,69,69,0,1,0
18,419,419,88,27,61,3,2
0,425,425,48,48,0,1,0
17,437,437,19,8,11,2,1
23,439,439,38,38,0,1,0
24,456,456,5,1,4,2,1
30,457,457,127,43,84,4,3
26,464,464,36,36,0,1,0
5,487,487,37,1,36,4,3
32,494,494,6,6,0,1,0

27,100,100,9,9,0,1,0
5,102,102,6,6,0,1,0
12,109,109,2,2,0,1,0
28,112,112,10,10,0,1,0
21,126,126,38,38,0,1,0
19,143,143,18,18,0,1,0
26,146,146,19,19,0,1,0
9,157,157,1,1,0,1,0
33,161,161,17,3,14,3,2
30,188,188,26,11,15,2,1
29,200,200,2,2,0,1,0
25,214,214,6,1,5,2,1
4,239,239,68,18,50,3,2
13,279,279,22,22,0,1,0
23,302,302,90,90,0,1,0
11,312,312,27,27,0,1,0
3,329,329,12,12,0,1,0
0,339,339,32,32,0,1,0
1,342,342,7,4,3,2,1
24,353,353,28,28,0,1,0
16,380,380,6,6,0,1,0
17,381,381,1,1,0,1,0
32,387,387,17,17,0,1,0
14,391,391,66,10,56,3,2
6,404,404,14,10,4,2,1
22,406,406,72,72,0,1,0
31,417,417,26,26,0,1,0
18,418,418,3,3,0,1,0
15,439,439,76,27,49,4,3
8,470,470,94,53,41,4,3
7,489,489,26,26,0,1,0
10,489,489,95,32,63,4,3
20,496,496,27,27,0,1,0
2,498,498,88,88,0,1,0

30,115,115,14,14,0,1,0
29,116,116,2,2,0,1,0
14,123,123,2,2,0,1,0
3,124,124,2,2,0,1,0
18,125,125,49,49,0,1,0
8,143,143,1,1,0,1,0
5,175,175,2,2,0,1,0
4,180,180,22,22,0,1,0
22,229,229,13,1,12,4,3
23,232,232,5,5,0,1,0
27,236,236,12,12,0,1,0
17,249,249,3,3,0,1,0
11,283,283,53,53,0,1,0
33,297,297,41,25,16,3,2
13,301,301,19,19,0,1,0
0,325,325,60,60,0,1,0
6,333,333,115,30,85,4,3
20,345,345,50,29,21,2,1
16,358,358,4,4,0,1,0
32,362,362,14,14,0,1,0
15,386,386,1,1,0,1,0
25,396,396,7,1,6,3,2
12,397,397,87,87,0,1,0
24,398,398,88,34,54,4,3
7,404,404,1,1,0,1,0
9,404,404,108,36,72,4,3
19,405,405,25,21,4,2,1
1,415,415,12,12,0,1,0
10,444,444,3,3,0,1,0
28,445,445,43,14,29,4,3
21,450,450,46,46,0,1,0
34,452,452,13,13,0,1,0
2,465,465,93,41,52,3,2
31,475,475,60,60,0,1,0
26,481,481,50,50,0,1,0

3,107,107,1,1,0,1,0
7,107,107,9,9,0,1,0
30,109,109,16,10,6,2,1
4,109,109,7,7,0,1,0
26,110,110,17,14,3,2,1
16,116,116,5,5,0,1,0
22,121,121,9,9,0,1,0
5,125,125,42,42,0,1,0
17,141,141,6,3,3,2,1
19,158,158,7,7,0,1,0
25,188,188,23,23,0,1,0
29,201,201,29,29,0,1,0
8,201,201,14,6,8,2,1
34,205,205,8,8,0,1,0
33,252,252,22,17,5,2,1
20,257,257,23,1,22,2,1
28,258,258,32,32,0,1,0
18,267,267,14,14,0,1,0
24,273,273,25,25,0,1,0
35,282,282,97,97,0,1,0
31,286,286,10,10,0,1,0
15,286,286,71,29,42,4,3
0,287,287,58,58,0,1,0
13,352,352,13,13,0,1,0
9,362,362,5,5,0,1,0
32,367,367,3,3,0,1,0
10,372,372,23,9,14,2,1
1,408,408,23,23,0,1,0
36,416,416,44,44,0,1,0
12,417,417,79,79,0,1,0
2,419,419,3,3,0,1,0
6,438,438,5,5,0,1,0
14,444,444,26,26,0,1,0
11,457,457,33,24,9,4,3
21,460,460,62,62,0,1,0
23,468,468,15,1,14,2,1
27,484,484,2,2,0,1,0

16,116,116,9,9,0,1,0
8,119,119,39,21,18,4,3
6,137,137,3,3,0,1,0
29,143,143,18,18,0,1,0
17,143,143,26,6,20,3,2
12,171,171,3,3,0,1,0
3,175,175,10,2,8,2,1
4,176,176,90,90,0,1,0
24,197,197,2,2,0,1,0
9,212,212,5,5,0,1,0
10,221,221,1,1,0,1,0
13,254,254,52,4,48,3,2
1,254,254,6,6,0,1,0
11,282,282,73,19,54,4,3
19,291,291,19,19,0,1,0
7,307,307,16,11,5,2,1
5,315,315,13,13,0,1,0
21,340,340,4,4,0,1,0
18,351,351,138,110,28,2,1
23,362,362,2,2,0,1,0
22,365,365,7,7,0,1,0
26,374,374,59,23,36,2,1
2,382,382,7,7,0,1,0
31,386,386,1,1,0,1,0
30,405,405,89,74,15,2,1
14,437,437,60,60,0,1,0
28,439,439,29,29,0,1,0
0,440,440,1,1,0,1,0
27,449,449,36,24,12,2,1
20,456,456,123,53,70,4,3
15,461,461,5,1,4,2,1
25,489,489,16,16,0,1,0

25,109,109,23,1,22,2,1
23,114,114,11,1,10,2,1
26,127,127,38,28,10,3,2
1,129,129,7,1,6,2,1
21,133,133,4,4,0,1,0
5,136,136,16,16,0,1,0
22,138,138,6,6,0,1,0
18,185,185,8,8,0,1,0
33,192,192,6,6,0,1,0
14,209,209,1,1,0,1,0
32,219,219,75,3,72,3,2
20,221,221,6,6,0,1,0
12,237,237,38,38,0,1,0
8,276,276,63,63,0,1,0
31,279,279,23,23,0,1,0
0,284,284,20,20,0,1,0
11,285,285,15,15,0,1,0
9,291,291,75,75,0,1,0
7,303,303,20,11,9,2,1
10,309,309,3,3,0,1,0
13,311,311,8,8,0,1,0
34,320,320,14,14,0,1,0
29,374,374,43,5,38,3,2
19,378,378,32,2,30,3,2
15,401,401,106,106,0,1,0
28,408,408,74,57,17,2,1
3,415,415,17,17,0,1,0
24,439,439,4,4,0,1,0
27,457,457,26,26,0,1,0
30,461,461,25,25,0,1,0
2,462,462,35,35,0,1,0
17,463,463,74,23,51,4,3
4,472,472,8,4,4,2,1
6,489,489,46,46,0,1,0
16,495,495,1,1,0,1,0

31,102,102,5,5,0,1,0
2,113,113,29,1,28,2,1
16,130,130,25,25,0,1,0
20,152,152,9,9,0,1,0
15,155,155,22,22,0,1,0
11,166,166,14,14,0,1,0
24,181,181,14,2,12,3,2
27,195,195,7,7,0,1,0
0,201,201,3,3,0,1,0
14,206,206,30,2,28,4,3
13,217,217,31,2,29,2,1
12,217,217,13,4,9,4,3
25,233,233,74,74,0,1,0
26,250,250,60,40,20,2,1
1,251,251,58,58,0,1,0
5,256,256,13,13,0,1,0
30,260,260,14,2,12,2,1
28,284,284,3,3,0,1,0
21,287,287,47,23,24,2,1
23,293,293,2,2,0,1,0
17,326,326,18,18,0,1,0
18,344,344,12,6,6,3,2
6,346,346,18,18,0,1,0
9,362,362,4,4,0,1,0
3,413,413,26,26,0,1,0
8,420,420,20,11,9,4,3
19,422,422,13,13,0,1,0
10,430,430,19,19,0,1,0
32,453,453,171,60,111,4,3
4,460,460,46,46,0,1,0
7,464,464,120,120,0,1,0
29,476,476,2,2,0,1,0
22,498,498,17,17,0,1,0

21,117,117,3,3,0,1,0
15,121,121,1,1,0,1,0
24,132,132,27,27,0,1,0
22,153,153,31,31,0,1,0
18,156,156,1,1,0,1,0
8,167,167,1,1,0,1,0
20,198,198,31,11,20,3,2
11,202,202,4,4,0,1,0
6,202,202,3,3,0,1,0
26,203,203,3,3,0,1,0
3,216,216,27,27,0,1,0
27,216,216,18,18,0,1,0
31,233,233,21,12,9,2,1
29,236,236,2,2,0,1,0
25,250,250,10,3,7,2,1
1,265,265,32,16,16,3,2
2,269,269,22,10,12,4,3
14,269,269,2,2,0,1,0
12,278,278,34,6,28,2,1
7,279,279,26,26,0,1,0
30,280,280,13,4,9,4,3
9,314,314,9,9,0,1,0
19,331,331,35,27,8,2,1
17,333,333,9,9,0,1,0
13,367,367,53,47,6,3,2
16,380,380,42,42,0,1,0
28,387,387,14,6,8,3,2
5,425,425,43,28,15,2,1
33,427,427,137,137,0,1,0
0,428,428,63,63,0,1,0
10,453,453,206,206,0,1,0
4,453,453,52,52,0,1,0
23,456,456,11,11,0,1,0
32,496,496,172,92,80,3,2

11,116,116,17,17,0,1,0
1,119,119,18,2,16,2,1
26,120,120,1,1,0,1,0
4,133,133,27,24,3,2,1
23,144,144,9,9,0,1,0
12,172,172,1,1,0,1,0
20,176,176,23,23,0,1,0
22,176,176,4,4,0,1,0
2,185,185,59,40,19,3,2
5,213,213,3,3,0,1,0
6,245,245,9,9,0,1,0
16,246,246,101,101,0,1,0
9,256,256,47,47,0,1,0
19,261,261,84,57,27,2,1
10,272,272,52,52,0,1,0
8,315,315,31,31,0,1,0
13,334,334,7,2,5,2,1
25,344,344,35,9,26,3,2
30,344,344,21,3,18,4,3
29,352,352,6,6,0,1,0
14,375,375,16,16,0,1,0
15,398,398,20,20,0,1,0
27,401,401,88,88,0,1,0
0,407,407,7,2,5,2,1
7,424,424,88,54,34,4,3
3,427,427,45,24,21,2,1
28,429,429,2,2,0,1,0
24,430,430,65,65,0,1,0
18,439,439,6,6,0,1,0
21,470,470,5,2,3,2,1
17,487,487,50,50,0,1,0

28,122,122,5,2,3,2,1
8,125,125,6,6,0,1,0
9,127,127,15,3,12,2,1
16,131,131,22,2,20,2,1
18,139,139,40,6,34,2,1
30,144,144,10,4,6,2,1
5,144,144,1,1,0,1,0
3,148,148,39,4,35,2,1
29,159,159,19,5,14,3,2
23,179,179,5,5,0,1,0
4,184,184,30,30,0,1,0
13,199,199,56,48,8,2,1
27,203,203,1,1,0,1,0
14,207,207,74,34,40,3,2
11,209,209,4,4,0,1,0
20,219,219,58,18,40,2,1
24,226,226,1,1,0,1,0
31,241,241,6,6,0,1,0
7,248,248,6,6,0,1,0
15,304,304,27,27,0,1,0
22,305,305,78,5,73,3,2
25,311,311,54,54,0,1,0
0,321,321,52,36,16,2,1
17,342,342,41,11,30,4,3
21,346,346,19,13,6,3,2
10,375,375,4,4,0,1,0
2,407,407,15,15,0,1,0
12,409,409,25,25,0,1,0
1,413,413,3,3,0,1,0
26,444,444,3,3,0,1,0
6,470,470,67,67,0,1,0
19,489,489,13,1,12,2,1

21,111,111,1,1,0,1,0
17,117,117,7,7,0,1,0
8,133,133,7,3,4,2,1
1,154,154,19,19,0,1,0
28,165,165,8,2,6,2,1
19,165,165,63,28,35,3,2
3,177,177,6,6,0,1,0
5,189,189,11,2,9,2,1
23,195,195,34,34,0,1,0
20,218,218,7,7,0,1,0
15,223,223,12,12,0,1,0
31,229,229,14,14,0,1,0
0,258,258,39,39,0,1,0
26,270,270,99,84,15,4,3
11,300,300,70,70,0,1,0
9,306,306,92,44,48,4,3
30,315,315,27,3,24,2,1
14,316,316,158,158,0,1,0
22,322,322,25,25,0,1,0
4,342,342,1,1,0,1,0
6,352,352,13,13,0,1,0
29,357,357,75,32,43,2,1
25,363,363,21,21,0,1,0
10,369,369,14,14,0,1,0
7,372,372,18,18,0,1,0
16,403,403,4,4,0,1,0
2,409,409,28,10,18,4,3
18,454,454,23,23,0,1,0
24,466,466,12,12,0,1,0
27,468,468,16,4,12,3,2
13,478,478,23,23,0,1,0
12,485,485,2,2,0,1,0

9,100,100,10,10,0,1,0
8,110,110,3,3,0,1,0
19,126,126,6,2,4,2,1
27,131,131,1,1,0,1,0
17,143,143,12,12,0,1,0
12,148,148,27,24,3,2,1
14,152,152,27,19,8,3,2
31,158,158,9,2,7,2,1
20,159,159,22,4,18,3,2
22,160,160,6,6,0,1,0
0,170,170,1,1,0,1,0
26,178,178,41,17,24,3,2
28,179,179,29,23,6,2,1
18,179,179,36,36,0,1,0
13,185,185,2,2,0,1,0
10,188,188,16,16,0,1,0
25,224,224,4,4,0,1,0
1,240,240,7,2,5,2,1
2,257,257,6,6,0,1,0
5,262,262,8,8,0,1,0
30,281,281,38,38,0,1,0
6,344,344,111,105,6,2,1
24,365,365,28,23,5,2,1
16,375,375,72,66,6,2,1
23,389,389,40,1,39,2,1
3,413,413,17,9,8,2,1
15,426,426,68,30,38,3,2
29,444,444,24,24,0,1,0
21,464,464,18,1,17,2,1
7,469,469,84,84,0,1,0
11,487,487,108,24,84,4,3
4,492,492,131,131,0,1,0

6,113,113,1,1,0,1,0
24,128,128,8,3,5,2,1
1,136,136,49,7,42,2,1
22,136,136,1,1,0,1,0
26,147,147,4,4,0,1,0
31,185,185,8,3,5,2,1
2,208,208,19,19,0,1,0
20,215,215,62,62,0,1,0
8,224,224,8,8,0,1,0
30,232,232,4,4,0,1,0
7,232,232,134,101,33,4,3
23,241,241,10,10,0,1,0
13,247,247,9,9,0,1,0
27,250,250,13,13,0,1,0
12,258,258,8,8,0,1,0
16,267,267,3,3,0,1,0
14,275,275,26,16,10,3,2
19,294,294,53,53,0,1,0
0,300,300,24,24,0,1,0
3,318,318,5,2,3,2,1
21,344,344,22,4,18,2,1
9,350,350,8,3,5,2,1
17,365,365,26,14,12,2,1
15,373,373,22,4,18,4,3
5,376,376,15,15,0,1,0
29,401,401,73,52,21,2,1
10,403,403,1,1,0,1,0
4,420,420,1,1,0,1,0
18,441,441,11,11,0,1,0
25,443,443,176,133,43,4,3
11,445,445,135,117,18,3,2
28,459,459,96,74,22,2,1

20,116,116,4,4,0,1,0
9,127,127,5,5,0,1,0
36,132,132,11,1,10,2,1
35,135,135,3,3,0,1,0
22,143,143,46,46,0,1,0
3,147,147,1,1,0,1,0
11,153,153,9,9,0,1,0
17,153,153,12,2,10,2,1
27,189,189,43,24,19,2,1
5,192,192,6,2,4,2,1
10,196,196,29,29,0,1,0
2,249,249,4,4,0,1,0
32,253,253,16,16,0,1,0
13,292,292,22,22,0,1,0
26,302,302,24,24,0,1,0
34,306,306,29,17,12,3,2
16,317,317,5,5,0,1,0
38,325,325,27,3,24,3,2
21,325,325,47,7,40,3,2
1,334,334,38,38,0,1,0
23,354,354,14,14,0,1,0
30,363,363,12,5,7,2,1
29,363,363,16,1,15,4,3
15,364,364,68,68,0,1,0
28,367,367,54,54,0,1,0
12,372,372,26,16,10,2,1
37,378,378,59,39,20,2,1
8,391,391,84,84,0,1,0
7,396,396,18,5,13,2,1
18,396,396,6,2,4,2,1
24,412,412,63,63,0,1,0
0,446,446,91,91,0,1,0
6,458,458,6,6,0,1,0
14,460,460,2,2,0,1,0
19,465,465,37,3,34,4,3
25,466,466,22,22,0,1,0
33,472,472,24,14,10,3,2
31,473,473,42,42,0,1,0
4,487,487,51,51,0,1,0

12,115,115,1,1,0,1,0
33,138,138,27,6,21,2,1
17,140,140,13,13,0,1,0
21,145,145,2,2,0,1,0
31,145,145,18,18,0,1,0
19,150,150,38,38,0,1,0
28,171,171,6,2,4,2,1
13,180,180,67,54,13,2,1
6,190,190,11,11,0,1,0
16,206,206,80,80,0,1,0
8,212,212,5,5,0,1,0
0,224,224,15,15,0,1,0
9,230,230,27,2,25,4,3
14,236,236,8,5,3,2,1
23,262,262,25,25,0,1,0
30,264,264,54,54,0,1,0
2,267,267,5,5,0,1,0
15,270,270,4,4,0,1,0
34,283,283,10,10,0,1,0
5,289,289,17,11,6,2,1
11,304,304,29,29,0,1,0
24,305,305,2,2,0,1,0
20,316,316,69,21,48,2,1
27,319,319,19,1,18,2,1
29,360,360,5,5,0,1,0
25,367,367,3,3,0,1,0
32,370,370,53,9,44,2,1
3,387,387,14,14,0,1,0
18,388,388,5,2,3,2,1
4,404,404,38,20,18,3,2
1,420,420,1,1,0,1,0
22,436,436,23,23,0,1,0
10,450,450,5,5,0,1,0
26,461,461,121,12,109,4,3
7,498,498,104,104,0,1,0

36,103,103,3,3,0,1,0
20,108,108,53,50,3,2,1
24,132,132,4,4,0,1,0
16,133,133,28,22,6,2,1
22,138,138,8,8,0,1,0
35,150,150,10,7,3,2,1
3,159,159,5,5,0,1,0
10,160,160,4,4,0,1,0
14,161,161,43,43,0,1,0
17,171,171,3,3,0,1,0
4,199,199,40,40,0,1,0
29,202,202,12,2,10,2,1
25,211,211,31,31,0,1,0
7,234,234,10,1,9,4,3
30,250,250,28,28,0,1,0
15,255,255,33,8,25,2,1
33,274,274,4,4,0,1,0
28,279,279,20,20,0,1,0
19,282,282,18,18,0,1,0
0,309,309,45,10,35,2,1
8,315,315,23,23,0,1,0
2,315,315,1,1,0,1,0
5,321,321,14,14,0,1,0
18,332,332,8,8,0,1,0
32,340,340,27,27,0,1,0
34,347,347,13,13,0,1,0
13,352,352,40,20,20,3,2
21,365,365,3,3,0,1,0
9,379,379,12,3,9,2,1
31,408,408,59,22,37,2,1
26,423,423,1,1,0,1,0
11,431,431,41,41,0,1,0
1,450,450,7,7,0,1,0
27,458,458,174,72,102,4,3
23,471,471,5,5,0,1,0
12,479,479,48,48,0,1,0
6,482,482,33,5,28,3,2

20,132,132,47,47,0,1,0
21,151,151,12,12,0,1,0
13,162,162,10,10,0,1,0
22,188,188,2,2,0,1,0
17,207,207,14,14,0,1,0
7,251,251,34,34,0,1,0
1,281,281,46,46,0,1,0
14,299,299,33,19,14,2,1
5,319,319,93,78,15,2,1
6,324,324,61,61,0,1,0
19,336,336,18,2,16,3,2
8,355,355,27,11,16,3,2
9,357,357,5,5,0,1,0
12,371,371,70,70,0,1,0
24,380,380,32,16,16,3,2
11,391,391,78,78,0,1,0
18,394,394,65,65,0,1,0
4,400,400,107,107,0,1,0
16,405,405,25,3,22,2,1
3,419,419,101,79,22,3,2
2,426,426,135,135,0,1,0
23,434,434,17,17,0,1,0
10,464,464,22,22,0,1,0
0,467,467,10,10,0,1,0
15,487,487,2,2,0,1,0
25,496,496,90,65,25,3,2

34,105,105,8,8,0,1,0
28,111,111,42,35,7,2,1
16,114,114,28,28,0,1,0
5,119,119,6,6,0,1,0
25,121,121,2,2,0,1,0
18,129,129,13,8,5,2,1
6,142,142,36,21,15,2,1
19,160,160,40,40,0,1,0
0,167,167,3,3,0,1,0
31,233,233,28,28,0,1,0
7,236,236,54,42,12,4,3
27,238,238,1,1,0,1,0
4,247,247,3,3,0,1,0
17,258,258,7,7,0,1,0
33,264,264,47,35,12,4,3
12,273,273,9,3,6,3,2
13,278,278,9,6,3,2,1
8,287,287,16,16,0,1,0
1,325,325,28,28,0,1,0
20,335,335,4,4,0,1,0
14,336,336,11,6,5,2,1
3,375,375,1,1,0,1,0
9,375,375,71,9,62,4,3
32,384,384,10,1,9,4,3
29,389,389,47,8,39,2,1
10,390,390,116,95,21,2,1
11,407,407,12,2,10,3,2
23,412,412,23,23,0,1,0
21,413,413,79,64,15,2,1
22,433,433,17,17,0,1,0
26,436,436,2,2,0,1,0
2,476,476,10,10,0,1,0
30,481,481,57,57,0,1,0
15,484,484,41,37,4,2,1
24,488,488,21,12,9,4,3

16,103,103,16,16,0,1,0
8,113,113,4,4,0,1,0
31,121,121,12,5,7,2,1
9,139,139,5,5,0,1,0
35,159,159,23,23,0,1,0
11,184,184,30,6,24,4,3
32,188,188,22,22,0,1,0
23,199,199,8,8,0,1,0
12,200,200,3,3,0,1,0
2,213,213,13,2,11,2,1
28,218,218,12,4,8,3,2
1,227,227,71,71,0,1,0
0,237,237,24,24,0,1,0
17,248,248,3,3,0,1,0
19,250,250,7,7,0,1,0
26,260,260,8,8,0,1,0
27,266,266,24,5,19,4,3
5,271,271,1,1,0,1,0
14,281,281,15,15,0,1,0
24,297,297,29,7,22,3,2
20,335,335,43,43,0,1,0
4,362,362,5,5,0,1,0
29,384,384,26,26,0,1,0
10,386,386,6,6,0,1,0
22,389,389,18,18,0,1,0
13,394,394,69,35,34,2,1
33,408,408,16,8,8,2,1
6,409,409,51,41,10,3,2
21,421,421,2,2,0,1,0
25,428,428,52,52,0,1,0
18,430,430,13,4,9,4,3
3,437,437,112,93,19,2,1
30,455,455,268,240,28,2,1
15,473,473,10,10,0,1,0
7,479,479,55,47,8,2,1
34,492,492,18,6,12,4,3

9,104,104,20,4,16,3,2
17,154,154,13,13,0,1,0
14,155,155,39,19,20,2,1
27,160,160,9,9,0,1,0
25,170,170,16,9,7,2,1
18,177,177,25,25,0,1,0
32,184,184,38,12,26,2,1
22,186,186,48,48,0,1,0
6,230,230,2,2,0,1,0
20,240,240,12,12,0,1,0
10,249,249,3,3,0,1,0
15,251,251,1,1,0,1,0
11,253,253,13,13,0,1,0
21,259,259,9,3,6,2,1
13,323,323,6,2,4,2,1
31,333,333,18,1,17,2,1
26,344,344,10,4,6,2,1
29,389,389,41,21,20,2,1
8,390,390,37,37,0,1,0
4,409,409,72,28,44,2,1
16,409,409,17,11,6,2,1
30,412,412,125,116,9,2,1
3,421,421,17,17,0,1,0
24,429,429,6,6,0,1,0
0,432,432,53,53,0,1,0
2,441,441,92,89,3,2,1
12,452,452,132,54,78,4,3
1,455,455,37,37,0,1,0
23,458,458,10,4,6,3,2
19,470,470,102,36,66,4,3
28,473,473,10,10,0,1,0
5,484,484,19,19,0,1,0
7,492,492,53,43,10,2,1

20,141,141,10,10,0,1,0
39,141,141,10,10,0,1,0
32,148,148,16,1,15,4,3
4,150,150,8,8,0,1,0
38,157,157,11,11,0,1,0
25,160,160,7,4,3,2,1
26,161,161,6,6,0,1,0
24,166,166,5,5,0,1,0
34,180,180,31,10,21,4,3
36,185,185,24,24,0,1,0
7,223,223,20,1,19,2,1
19,223,223,9,4,5,2,1
16,224,224,2,2,0,1,0
14,239,239,47,16,31,2,1
28,242,242,1,1,0,1,0
8,266,266,11,8,3,2,1
21,272,272,20,20,0,1,0
1,275,275,57,34,23,2,1
17,278,278,1,1,0,1,0
6,289,289,31,31,0,1,0
18,299,299,17,14,3,2,1
41,307,307,21,21,0,1,0
2,317,317,11,11,0,1,0
13,326,326,41,29,12,3,2
22,333,333,10,10,0,1,0
12,334,334,18,3,15,2,1
3,336,336,36,36,0,1,0
10,339,339,1,1,0,1,0
30,342,342,107,14,93,4,3
37,351,351,47,47,0,1,0
27,360,360,74,74,0,1,0
35,369,369,5,5,0,1,0
40,371,371,69,21,48,4,3
31,377,377,34,24,10,3,2
33,412,412,15,15,0,1,0
23,414,414,22,22,0,1,0
9,416,416,29,29,0,1,0
29,420,420,39,39,0,1,0
0,454,454,45,45,0,1,0
15,468,468,24,16,8,3,2
11,469,469,17,17,0,1,0
42,484,484,6,3,3,2,1
5,496,496,9,5,4,2,1

3,110,110,14,11,3,2,1
33,111,111,10,10,0,1,0
8,119,119,6,6,0,1,0
40,138,138,6,6,0,1,0
30,140,140,31,31,0,1,0
1,146,146,3,3,0,1,0
0,148,148,4,1,3,2,1
2,186,186,3,3,0,1,0
21,191,191,3,3,0,1,0
4,193,193,14,14,0,1,0
38,198,198,22,22,0,1,0
28,210,210,75,25,50,4,3
27,214,214,1,1,0,1,0
9,222,222,7,7,0,1,0
42,225,225,24,24,0,1,0
7,248,248,17,17,0,1,0
29,249,249,13,5,8,2,1
23,251,251,9,2,7,3,2
37,251,251,35,2,33,4,3
34,263,263,7,7,0,1,0
19,269,269,1,1,0,1,0
5,274,274,8,8,0,1,0
25,282,282,18,18,0,1,0
11,285,285,33,33,0,1,0
18,287,287,31,31,0,1,0
20,290,290,24,1,23,2,1
41,297,297,40,13,27,4,3
35,303,303,28,6,22,2,1
17,310,310,1,1,0,1,0
26,325,325,55,39,16,3,2
6,338,338,6,3,3,2,1
14,363,363,41,35,6,2,1
13,389,389,24,7,17,3,2
16,394,394,24,24,0,1,0
15,397,397,10,10,0,1,0
12,405,405,53,53,0,1,0
39,415,415,44,44,0,1,0
10,424,424,64,64,0,1,0
32,426,426,4,1,3,2,1
24,436,436,44,44,0,1,0
22,469,469,79,10,69,4,3
36,472,472,11,2,9,2,1
31,488,488,21,5,16,3,2

17,101,101,5,5,0,1,0
0,115,115,12,3,9,4,3
30,122,122,5,5,0,1,0
29,123,123,3,3,0,1,0
27,125,125,4,4,0,1,0
23,129,129,1,1,0,1,0
26,133,133,23,23,0,1,0
7,166,166,3,3,0,1,0
20,175,175,22,5,17,2,1
11,182,182,27,27,0,1,0
32,215,215,26,18,8,3,2
1,217,217,9,9,0,1,0
2,231,231,31,16,15,4,3
4,233,233,16,7,9,4,3
21,241,241,4,4,0,1,0
31,245,245,51,31,20,3,2
5,248,248,15,9,6,2,1
3,261,261,28,7,21,2,1
24,272,272,82,20,62,3,2
13,311,311,21,13,8,2,1
28,324,324,47,18,29,2,1
9,377,377,39,14,25,2,1
12,381,381,11,4,7,2,1
16,382,382,53,53,0,1,0
35,383,383,9,9,0,1,0
22,384,384,38,14,24,3,2
33,387,387,104,104,0,1,0
15,388,388,31,31,0,1,0
18,419,419,4,1,3,2,1
19,420,420,35,11,24,2,1
8,422,422,53,53,0,1,0
25,424,424,6,6,0,1,0
34,426,426,36,1,35,2,1
6,435,435,31,31,0,1,0
14,476,476,16,16,0,1,0
36,496,496,26,5,21,4,3
10,498,498,113,29,84,4,3

19,119,119,30,30,0,1,0
28,149,149,40,12,28,4,3
23,151,151,6,6,0,1,0
26,169,169,9,9,0,1,0
13,196,196,1,1,0,1,0
2,204,204,26,12,14,4,3
31,208,208,3,3,0,1,0
8,228,228,7,2,5,2,1
30,230,230,18,18,0,1,0
10,245,245,11,11,0,1,0
6,263,263,3,3,0,1,0
24,269,269,37,18,19,2,1
1,270,270,14,14,0,1,0
21,275,275,3,3,0,1,0
0,286,286,50,50,0,1,0
3,292,292,1,1,0,1,0
5,300,300,5,5,0,1,0
20,308,308,36,36,0,1,0
25,320,320,24,2,22,4,3
14,323,323,82,82,0,1,0
4,335,335,52,52,0,1,0
22,335,335,3,3,0,1,0
15,360,360,74,74,0,1,0
9,378,378,8,8,0,1,0
18,411,411,118,61,57,3,2
29,438,438,30,7,23,4,3
16,439,439,123,7,116,4,3
12,445,445,111,69,42,3,2
32,453,453,1,1,0,1,0
11,460,460,73,73,0,1,0
7,471,471,90,90,0,1,0
17,478,478,2,2,0,1,0
27,487,487,18,10,8,3,2

19,103,103,1,1,0,1,0
13,111,111,4,1,3,2,1
23,129,129,17,17,0,1,0
38,172,172,16,16,0,1,0
16,177,177,13,8,5,2,1
31,179,179,19,3,16,2,1
4,191,191,21,21,0,1,0
30,206,206,5,5,0,1,0
22,215,215,14,10,4,2,1
10,217,217,6,6,0,1,0
21,226,226,17,13,4,2,1
5,234,234,2,2,0,1,0
36,235,235,9,4,5,2,1
11,250,250,11,11,0,1,0
8,269,269,21,21,0,1,0
35,272,272,18,6,12,4,3
20,297,297,28,28,0,1,0
2,303,303,21,21,0,1,0
26,340,340,24,12,12,4,3
33,347,347,62,62,0,1,0
6,365,365,48,1,47,2,1
17,367,367,19,3,16,3,2
29,371,371,23,10,13,2,1
7,378,378,18,5,13,2,1
24,390,390,81,81,0,1,0
0,401,401,71,71,0,1,0
9,425,425,52,9,43,2,1
37,436,436,31,18,13,2,1
25,441,441,62,49,13,2,1
34,449,449,107,55,52,3,2
1,449,449,6,6,0,1,0
3,467,467,38,8,30,2,1
28,469,469,1,1,0,1,0
15,489,489,80,71,9,4,3
32,490,490,80,42,38,4,3
12,491,491,34,34,0,1,0
18,494,494,13,3,10,2,1
14,496,496,96,74,22,4,3
27,498,498,39,39,0,1,0

29,110,110,5,5,0,1,0
9,116,116,33,33,0,1,0
23,130,130,34,11,23,4,3
20,148,148,6,3,3,2,1
21,153,153,3,3,0,1,0
19,157,157,39,12,27,4,3
15,157,157,25,25,0,1,0
18,178,178,20,20,0,1,0
5,179,179,19,4,15,3,2
24,183,183,9,9,0,1,0
17,197,197,7,1,6,2,1
6,204,204,1,1,0,1,0
14,207,207,13,13,0,1,0
0,214,214,1,1,0,1,0
3,225,225,6,6,0,1,0
13,230,230,74,74,0,1,0
27,233,233,18,18,0,1,0
22,249,249,24,17,7,2,1
12,263,263,4,1,3,2,1
25,306,306,36,3,33,4,3
1,358,358,19,7,12,4,3
4,362,362,13,13,0,1,0
26,406,406,15,4,11,2,1
10,417,417,156,102,54,3,2
31,429,429,107,5,102,4,3
7,459,459,37,37,0,1,0
11,472,472,43,43,0,1,0
28,475,475,72,72,0,1,0
16,485,485,14,14,0,1,0
2,487,487,93,93,0,1,0
30,488,488,4,4,0,1,0
8,490,490,24,24,0,1,0

24,103,103,9,9,0,1,0
16,137,137,45,18,27,4,3
19,147,147,21,21,0,1,0
18,164,164,21,6,15,4,3
8,167,167,26,26,0,1,0
3,177,177,1,1,0,1,0
11,194,194,4,1,3,2,1
14,195,195,14,14,0,1,0
21,200,200,3,3,0,1,0
25,222,222,28,28,0,1,0
10,232,232,32,12,20,3,2
2,239,239,13,3,10,2,1
30,252,252,9,9,0,1,0
15,261,261,61,15,46,3,2
32,273,273,30,9,21,4,3
7,275,275,34,16,18,2,1
20,293,293,27,11,16,3,2
5,296,296,4,4,0,1,0
17,314,314,9,9,0,1,0
6,316,316,14,14,0,1,0
13,321,321,27,27,0,1,0
9,334,334,17,17,0,1,0
22,341,341,73,73,0,1,0
27,356,356,18,18,0,1,0
33,361,361,36,36,0,1,0
4,371,371,30,30,0,1,0
0,381,381,43,9,34,3,2
31,403,403,36,36,0,1,0
1,416,416,9,4,5,2,1
23,427,427,11,11,0,1,0
34,434,434,5,5,0,1,0
12,455,455,61,61,0,1,0
29,467,467,95,16,79,4,3
26,468,468,34,28,6,2,1
28,483,483,111,29,82,3,2

6,100,100,2,2,0,1,0
19,100,100,3,3,0,1,0
23,121,121,20,6,14,3,2
30,129,129,12,1,11,2,1
3,145,145,7,7,0,1,0
20,154,154,14,14,0,1,0
29,155,155,34,34,0,1,0
21,184,184,30,30,0,1,0
17,191,191,3,3,0,1,0
0,204,204,9,9,0,1,0
25,244,244,49,49,0,1,0
27,247,247,8,8,0,1,0
28,271,271,7,3,4,2,1
26,279,279,5,2,3,2,1
5,280,280,2,2,0,1,0
11,289,289,9,9,0,1,0
12,298,298,35,14,21,4,3
18,305,305,50,50,0,1,0
13,330,330,11,11,0,1,0
10,333,333,11,11,0,1,0
16,335,335,28,17,11,2,1
31,359,359,26,26,0,1,0
2,378,378,138,117,21,4,3
22,390,390,24,24,0,1,0
34,391,391,32,32,0,1,0
9,393,393,59,49,10,2,1
24,412,412,43,34,9,2,1
32,414,414,87,87,0,1,0
7,427,427,36,36,0,1,0
4,448,448,46,16,30,3,2
14,450,450,172,110,62,4,3
33,464,464,5,5,0,1,0
8,470,470,25,13,12,4,3
1,491,491,33,33,0,1,0
15,499,499,31,31,0,1,0

27,112,112,17,9,8,2,1
36,128,128,5,5,0,1,0
16,129,129,2,2,0,1,0
23,153,153,4,4,0,1,0
6,164,164,7,7,0,1,0
26,164,164,50,50,0,1,0
15,175,175,25,25,0,1,0
20,184,184,12,12,0,1,0
31,195,195,31,31,0,1,0
17,212,212,1,1,0,1,0
28,227,227,23,14,9,4,3
33,243,243,1,1,0,1,0
3,257,257,10,1,9,2,1
1,259,259,49,5,44,2,1
18,289,289,17,1,16,3,2
34,291,291,19,19,0,1,0
12,292,292,1,1,0,1,0
19,298,298,29,29,0,1,0
7,307,307,2,2,0,1,0
25,311,311,5,5,0,1,0
13,312,312,3,3,0,1,0
0,314,314,76,26,50,3,2
35,321,321,53,53,0,1,0
21,334,334,18,12,6,3,2
11,344,344,20,16,4,2,1
10,369,369,60,60,0,1,0
8,376,376,27,21,6,2,1
9,387,387,81,5,76,4,3
32,389,389,78,78,0,1,0
2,392,392,27,27,0,1,0
4,413,413,28,5,23,3,2
24,413,413,78,78,0,1,0
30,417,417,6,6,0,1,0
22,432,432,50,50,0,1,0
14,438,438,56,56,0,1,0
29,465,465,33,9,24,3,2
5,475,475,39,39,0,1,0

1,109,109,17,17,0,1,0
16,109,109,6,3,3,2,1
4,119,119,15,15,0,1,0
23,133,133,6,6,0,1,0
13,138,138,18,5,13,2,1
29,149,149,20,4,16,2,1
14,150,150,12,6,6,3,2
3,161,161,60,60,0,1,0
6,169,169,6,1,5,2,1
20,169,169,5,5,0,1,0
31,178,178,8,8,0,1,0
9,205,205,1,1,0,1,0
7,243,243,7,7,0,1,0
17,283,283,28,7,21,4,3
18,289,289,7,7,0,1,0
0,294,294,40,40,0,1,0
28,298,298,18,18,0,1,0
19,306,306,7,1,6,3,2
35,327,327,108,64,44,3,2
25,329,329,13,3,10,3,2
33,356,356,33,33,0,1,0
30,369,369,58,11,47,3,2
26,371,371,30,6,24,2,1
8,376,376,23,23,0,1,0
24,378,378,7,7,0,1,0
2,388,388,16,16,0,1,0
15,394,394,4,1,3,2,1
27,413,413,91,41,50,3,2
12,462,462,39,39,0,1,0
11,466,466,27,27,0,1,0
34,471,471,89,68,21,4,3
32,472,472,87,48,39,2,1
21,479,479,12,12,0,1,0
22,495,495,28,28,0,1,0
5,497,497,37,37,0,1,0
10,498,498,62,14,48,4,3

2,120,120,11,7,4,2,1
14,121,121,2,2,0,1,0
7,142,142,31,31,0,1,0
6,152,152,5,1,4,2,1
3,158,158,18,4,14,2,1
22,177,177,72,72,0,1,0
24,200,200,7,7,0,1,0
4,218,218,17,17,0,1,0
17,220,220,13,13,0,1,0
20,222,222,24,9,15,2,1
25,250,250,10,10,0,1,0
23,279,279,35,35,0,1,0
26,289,289,5,5,0,1,0
13,293,293,3,3,0,1,0
5,305,305,24,6,18,3,2
15,308,308,23,23,0,1,0
21,351,351,6,6,0,1,0
9,363,363,45,30,15,4,3
16,370,370,38,30,8,2,1
10,376,376,96,8,88,3,2
8,383,383,138,114,24,2,1
12,403,403,59,47,12,2,1
0,410,410,131,131,0,1,0
19,411,411,29,17,12,4,3
27,414,414,38,38,0,1,0
11,422,422,103,103,0,1,0
1,447,447,13,8,5,2,1
18,459,459,77,14,63,4,3

16,100,100,2,2,0,1,0
23,118,118,24,9,15,4,3
12,125,125,1,1,0,1,0
22,127,127,10,7,3,2,1
4,136,136,1,1,0,1,0
11,140,140,16,16,0,1,0
37,147,147,15,15,0,1,0
10,152,152,18,18,0,1,0
20,156,156,7,7,0,1,0
19,160,160,14,14,0,1,0
7,160,160,13,7,6,3,2
38,164,164,28,28,0,1,0
14,175,175,8,8,0,1,0
1,179,179,43,43,0,1,0
13,179,179,19,1,18,4,3
31,198,198,20,20,0,1,0
18,203,203,5,5,0,1,0
6,203,203,24,24,0,1,0
30,211,211,3,3,0,1,0
34,213,213,1,1,0,1,0
29,222,222,5,5,0,1,0
5,232,232,12,12,0,1,0
28,257,257,46,12,34,3,2
15,278,278,19,2,17,2,1
21,286,286,45,6,39,4,3
32,317,317,11,3,8,3,2
9,336,336,22,12,10,2,1
3,338,338,25,19,6,2,1
25,343,343,49,49,0,1,0
24,359,359,40,10,30,4,3
26,362,362,24,7,17,2,1
2,373,373,16,7,9,3,2
8,390,390,31,31,0,1,0
36,429,429,1,1,0,1,0
33,440,440,41,41,0,1,0
35,444,444,176,134,42,4,3
0,459,459,18,3,15,2,1
17,465,465,50,50,0,1,0
27,476,476,4,4,0,1,0

24,106,106,4,4,0,1,0
6,107,107,2,2,0,1,0
29,117,117,13,13,0,1,0
7,120,120,12,4,8,2,1
12,131,131,11,3,8,3,2
28,136,136,16,11,5,2,1
20,142,142,8,8,0,1,0
34,153,153,3,3,0,1,0
15,162,162,26,11,15,4,3
1,169,169,28,19,9,4,3
8,169,169,4,4,0,1,0
11,197,197,3,3,0,1,0
36,212,212,9,9,0,1,0
4,229,229,5,5,0,1,0
25,239,239,56,20,36,2,1
17,261,261,15,15,0,1,0
35,308,308,60,60,0,1,0
37,313,313,77,77,0,1,0
18,313,313,62,31,31,2,1
13,317,317,24,24,0,1,0
16,321,321,25,25,0,1,0
26,349,349,3,3,0,1,0
22,358,358,25,25,0,1,0
32,358,358,6,1,5,2,1
10,364,364,76,76,0,1,0
21,386,386,6,6,0,1,0
30,393,393,82,82,0,1,0
27,413,413,10,10,0,1,0
23,418,418,18,18,0,1,0
33,438,438,46,8,38,3,2
31,450,450,109,64,45,4,3
14,460,460,11,11,0,1,0
9,467,467,24,24,0,1,0
19,469,469,13,10,3,2,1
2,480,480,4,4,0,1,0
0,482,482,112,106,6,3,2
3,494,494,8,1,7,2,1
5,496,496,39,24,15,2,1

26,101,101,2,2,0,1,0
11,109,109,9,3,6,2,1
3,110,110,16,16,0,1,0
19,115,115,1,1,0,1,0
17,124,124,1,1,0,1,0
24,129,129,3,3,0,1,0
22,137,137,13,9,4,2,1
9,142,142,4,4,0,1,0
14,156,156,4,1,3,2,1
20,178,178,28,28,0,1,0
29,180,180,14,14,0,1,0
15,210,210,8,5,3,2,1
34,248,248,22,1,21,4,3
0,248,248,19,9,10,2,1
16,262,262,38,38,0,1,0
30,263,263,17,7,10,2,1
1,283,283,33,13,20,2,1
4,305,305,47,11,36,3,2
12,309,309,102,39,63,4,3
7,318,318,47,47,0,1,0
10,323,323,6,6,0,1,0
6,328,328,9,1,8,2,1
33,339,339,57,57,0,1,0
25,339,339,11,5,6,2,1
13,358,358,15,5,10,2,1
31,375,375,150,135,15,2,1
5,381,381,96,60,36,3,2
8,392,392,6,6,0,1,0
21,412,412,14,14,0,1,0
23,420,420,43,11,32,3,2
18,429,429,57,57,0,1,0
28,440,440,90,62,28,3,2
27,461,461,24,15,9,2,1
2,464,464,22,2,20,3,2
32,471,471,42,12,30,4,3

30,103,103,5,1,4,2,1
28,103,103,5,5,0,1,0
13,117,117,2,2,0,1,0
27,123,123,16,16,0,1,0
22,144,144,26,16,10,2,1
9,168,168,14,2,12,4,3
29,171,171,25,10,15,2,1
26,195,195,11,11,0,1,0
21,205,205,1,1,0,1,0
1,206,206,10,10,0,1,0
8,208,208,10,10,0,1,0
33,213,213,81,13,68,3,2
11,220,220,2,2,0,1,0
6,253,253,17,5,12,2,1
19,265,265,48,8,40,4,3
12,272,272,7,7,0,1,0
10,288,288,17,2,15,2,1
7,304,304,10,4,6,2,1
16,307,307,83,36,47,2,1
20,315,315,62,62,0,1,0
25,318,318,5,5,0,1,0
2,337,337,121,61,60,4,3
18,340,340,13,13,0,1,0
14,340,340,77,9,68,3,2
0,340,340,24,24,0,1,0
23,364,364,19,19,0,1,0
24,367,367,2,2,0,1,0
15,387,387,17,5,12,4,3
34,396,396,86,86,0,1,0
17,431,431,40,23,17,2,1
3,437,437,23,7,16,3,2
32,464,464,3,3,0,1,0
5,469,469,55,55,0,1,0
4,497,497,38,20,18,3,2
31,500,500,10,10,0,1,0

26,104,104,4,4,0,1,0
29,132,132,5,5,0,1,0
17,133,133,6,6,0,1,0
0,144,144,3,3,0,1,0
31,152,152,21,21,0,1,0
33,167,167,6,6,0,1,0
9,169,169,23,23,0,1,0
15,172,172,1,1,0,1,0
21,191,191,49,49,0,1,0
1,197,197,35,35,0,1,0
2,205,205,31,31,0,1,0
3,206,206,16,16,0,1,0
10,229,229,1,1,0,1,0
4,259,259,110,101,9,2,1
23,272,272,85,85,0,1,0
7,277,277,82,82,0,1,0
16,303,303,9,9,0,1,0
22,326,326,36,18,18,4,3
32,328,328,71,24,47,2,1
19,331,331,22,3,19,2,1
6,336,336,26,26,0,1,0
18,368,368,26,26,0,1,0
14,372,372,5,5,0,1,0
12,374,374,32,32,0,1,0
24,377,377,44,44,0,1,0
11,381,381,11,11,0,1,0
8,393,393,1,1,0,1,0
25,395,395,13,13,0,1,0
27,421,421,55,55,0,1,0
13,445,445,10,10,0,1,0
5,452,452,67,67,0,1,0
28,454,454,23,16,7,2,1
30,461,461,1,1,0,1,0
20,495,495,37,7,30,2,1

29,107,107,8,5,3,2,1
36,123,123,5,5,0,1,0
5,132,132,3,3,0,1,0
3,139,139,7,7,0,1,0
31,147,147,1,1,0,1,0
4,148,148,14,4,10,2,1
22,157,157,19,19,0,1,0
16,166,166,5,5,0,1,0
14,180,180,20,20,0,1,0
9,181,181,5,2,3,2,1
17,187,187,42,42,0,1,0
20,191,191,34,22,12,4,3
21,205,205,9,9,0,1,0
6,222,222,17,8,9,4,3
12,222,222,6,6,0,1,0
30,224,224,21,21,0,1,0
15,227,227,39,39,0,1,0
0,245,245,16,8,8,2,1
11,281,281,88,88,0,1,0
27,291,291,38,13,25,4,3
1,295,295,9,1,8,3,2
24,298,298,5,5,0,1,0
18,338,338,92,92,0,1,0
19,355,355,4,4,0,1,0
23,375,375,19,1,18,3,2
2,403,403,19,19,0,1,0
7,408,408,28,28,0,1,0
8,413,413,21,14,7,3,2
35,423,423,103,49,54,4,3
32,423,423,44,22,22,2,1
13,424,424,2,2,0,1,0
10,436,436,1,1,0,1,0
25,452,452,33,33,0,1,0
34,458,458,88,88,0,1,0
28,464,464,31,31,0,1,0
33,465,465,81,81,0,1,0
26,490,490,61,61,0,1,0

25,105,105,18,6,12,4,3
22,127,127,5,1,4,2,1
16,145,145,13,9,4,2,1
12,151,151,60,60,0,1,0
28,152,152,3,3,0,1,0
13,186,186,8,3,5,2,1
7,188,188,4,4,0,1,0
31,200,200,14,14,0,1,0
19,206,206,1,1,0,1,0
0,207,207,8,4,4,2,1
8,212,212,28,28,0,1,0
33,213,213,15,5,10,2,1
23,214,214,4,4,0,1,0
26,216,216,20,20,0,1,0
15,223,223,10,10,0,1,0
24,263,263,65,65,0,1,0
1,279,279,43,27,16,2,1
10,293,293,59,59,0,1,0
4,323,323,7,7,0,1,0
18,326,326,46,28,18,4,3
5,332,332,9,9,0,1,0
21,347,347,64,16,48,2,1
9,367,367,1,1,0,1,0
3,398,398,4,1,3,2,1
6,403,403,106,54,52,4,3
11,404,404,1,1,0,1,0
32,408,408,51,34,17,2,1
14,411,411,39,39,0,1,0
29,449,449,144,129,15,2,1
27,461,461,19,13,6,3,2
20,481,481,38,38,0,1,0
30,482,482,9,1,8,2,1
2,489,489,78,27,51,4,3
17,499,499,43,24,19,2,1

15,110,110,4,4,0,1,0
10,142,142,15,3,12,3,2
1,142,142,57,57,0,1,0
18,150,150,13,13,0,1,0
16,155,155,13,2,11,2,1
29,159,159,17,17,0,1,0
13,173,173,7,7,0,1,0
26,175,175,48,18,30,3,2
22,178,178,17,17,0,1,0
5,183,183,13,13,0,1,0
31,198,198,36,11,25,3,2
9,210,210,60,38,22,3,2
14,214,214,6,6,0,1,0
21,217,217,27,3,24,3,2
27,250,250,13,3,10,3,2
28,252,252,5,5,0,1,0
7,261,261,49,49,0,1,0
11,267,267,3,3,0,1,0
17,288,288,10,1,9,4,3
19,316,316,16,16,0,1,0
30,319,319,81,27,54,4,3
2,333,333,24,24,0,1,0
23,337,337,32,8,24,3,2
4,352,352,6,1,5,2,1
8,381,381,29,15,14,2,1
25,397,397,56,30,26,3,2
24,404,404,6,1,5,2,1
20,416,416,32,17,15,2,1
3,426,426,15,8,7,2,1
6,440,440,47,11,36,2,1
0,447,447,105,12,93,4,3
12,448,448,12,12,0,1,0

28,108,108,1,1,0,1,0
20,111,111,9,3,6,3,2
16,113,113,37,37,0,1,0
7,115,115,1,1,0,1,0
17,119,119,1,1,0,1,0
29,127,127,14,14,0,1,0
11,140,140,8,2,6,2,1
33,143,143,7,7,0,1,0
27,149,149,23,23,0,1,0
12,186,186,44,7,37,2,1
2,207,207,13,2,11,2,1
35,215,215,20,20,0,1,0
6,231,231,1,1,0,1,0
31,231,231,4,4,0,1,0
32,235,235,6,6,0,1,0
5,242,242,7,1,6,3,2
19,269,269,63,15,48,3,2
15,270,270,10,10,0,1,0
30,272,272,22,6,16,2,1
13,272,272,33,3,30,4,3
4,275,275,13,2,11,2,1
9,290,290,34,34,0,1,0
23,309,309,76,10,66,3,2
1,325,325,36,36,0,1,0
18,339,339,85,85,0,1,0
14,345,345,36,24,12,3,2
3,353,353,34,17,17,4,3
8,362,362,8,8,0,1,0
25,368,368,23,23,0,1,0
22,375,375,129,80,49,2,1
10,382,382,5,5,0,1,0
24,427,427,3,3,0,1,0
34,427,427,20,5,15,2,1
0,452,452,21,21,0,1,0
21,454,454,27,7,20,2,1
26,469,469,53,53,0,1,0

1,119,119,12,12,0,1,0
6,130,130,26,6,20,3,2
16,134,134,1,1,0,1,0
24,134,134,15,15,0,1,0
11,138,138,36,10,26,2,1
22,144,144,18,15,3,2,1
14,146,146,23,3,20,3,2
26,171,171,20,1,19,2,1
10,181,181,17,1,16,3,2
37,195,195,23,18,5,2,1
20,210,210,3,3,0,1,0
5,211,211,24,14,10,3,2
36,218,218,7,1,6,2,1
18,221,221,19,19,0,1,0
7,226,226,16,16,0,1,0
27,233,233,7,1,6,3,2
0,236,236,1,1,0,1,0
19,239,239,1,1,0,1,0
8,292,292,28,28,0,1,0
15,303,303,2,2,0,1,0
21,306,306,2,2,0,1,0
13,308,308,3,3,0,1,0
32,309,309,13,13,0,1,0
38,318,318,63,57,6,3,2
12,321,321,5,2,3,2,1
9,323,323,1,1,0,1,0
23,343,343,17,17,0,1,0
30,365,365,29,1,28,3,2
17,378,378,75,75,0,1,0
29,379,379,75,38,37,4,3
4,396,396,52,25,27,2,1
25,416,416,37,37,0,1,0
31,416,416,34,2,32,2,1
34,422,422,25,19,6,2,1
35,463,463,49,49,0,1,0
28,467,467,43,43,0,1,0
33,469,469,97,97,0,1,0
2,479,479,1,1,0,1,0
3,492,492,58,43,15,4,3

36,105,105,13,5,8,2,1
38,108,108,15,15,0,1,0
15,110,110,2,2,0,1,0
30,115,115,1,1,0,1,0
16,123,123,5,5,0,1,0
33,143,143,10,10,0,1,0
24,166,166,1,1,0,1,0
17,169,169,1,1,0,1,0
31,172,172,29,1,28,2,1
27,178,178,24,6,18,4,3
26,181,181,32,32,0,1,0
9,183,183,16,1,15,2,1
3,194,194,6,6,0,1,0
21,208,208,55,13,42,2,1
11,213,213,10,10,0,1,0
6,235,235,9,1,8,3,2
41,239,239,1,1,0,1,0
40,246,246,31,21,10,3,2
2,259,259,2,2,0,1,0
7,264,264,13,13,0,1,0
37,265,265,25,25,0,1,0
28,281,281,58,58,0,1,0
35,290,290,50,37,13,2,1
20,291,291,4,4,0,1,0
12,292,292,18,18,0,1,0
1,296,296,19,19,0,1,0
19,302,302,36,12,24,3,2
8,333,333,20,20,0,1,0
18,348,348,32,32,0,1,0
34,377,377,32,32,0,1,0
0,384,384,11,4,7,2,1
32,387,387,24,24,0,1,0
14,405,405,54,54,0,1,0
22,407,407,39,21,18,4,3
4,417,417,22,22,0,1,0
10,429,429,28,28,0,1,0
29,431,431,31,31,0,1,0
25,432,432,37,1,36,4,3
5,456,456,62,50,12,2,1
39,461,461,7,3,4,2,1
13,469,469,37,13,24,2,1
23,497,497,52,52,0,1,0

34,104,104,1,1,0,1,0
26,111,111,18,18,0,1,0
20,111,111,25,5,20,2,1
32,116,116,6,6,0,1,0
18,142,142,5,5,0,1,0
33,161,161,37,37,0,1,0
1,173,173,21,16,5,2,1
25,185,185,9,4,5,2,1
0,201,201,4,4,0,1,0
6,204,204,5,5,0,1,0
23,205,205,1,1,0,1,0
12,205,205,52,37,15,2,1
8,205,205,6,1,5,2,1
15,205,205,45,45,0,1,0
19,225,225,43,13,30,4,3
14,232,232,9,3,6,3,2
17,245,245,27,27,0,1,0
27,264,264,72,33,39,3,2
10,281,281,21,21,0,1,0
24,289,289,12,12,0,1,0
21,311,311,46,46,0,1,0
3,311,311,55,15,40,3,2
5,313,313,13,13,0,1,0
7,321,321,18,18,0,1,0
30,328,328,24,17,7,2,1
36,328,328,31,22,9,4,3
4,384,384,20,20,0,1,0
2,385,385,17,17,0,1,0
13,399,399,8,8,0,1,0
11,431,431,20,20,0,1,0
22,440,440,16,1,15,2,1
16,469,469,21,1,20,2,1
29,471,471,78,78,0,1,0
35,472,472,13,13,0,1,0
31,478,478,45,45,0,1,0
9,484,484,49,36,13,2,1
28,484,484,29,5,24,2,1

