20,103,103,52,15,37,4,3
13,107,107,2,2,0,1,0
18,122,122,12,2,10,2,1
3,131,131,5,1,4,2,1
7,145,145,5,5,0,1,0
16,189,189,11,11,0,1,0
9,210,210,23,8,15,2,1
12,267,267,72,72,0,1,0
2,302,302,73,73,0,1,0
5,320,320,4,1,3,2,1
4,322,322,26,26,0,1,0
1,322,322,26,26,0,1,0
15,347,347,23,23,0,1,0
21,353,353,6,6,0,1,0
0,374,374,32,22,10,3,2
11,391,391,127,123,4,2,1
14,431,431,9,9,0,1,0
19,440,440,16,16,0,1,0
10,458,458,9,6,3,2,1
8,472,472,18,18,0,1,0
17,473,473,15,15,0,1,0
6,474,474,17,5,12,4,3

11,126,126,13,13,0,1,0
20,129,129,4,4,0,1,0
24,137,137,13,6,7,2,1
4,163,163,34,10,24,2,1
13,171,171,5,2,3,2,1
8,183,183,12,1,11,2,1
18,190,190,11,11,0,1,0
7,191,191,5,1,4,2,1
5,228,228,12,4,8,2,1
22,234,234,63,22,41,4,3
23,244,244,15,15,0,1,0
19,284,284,1,1,0,1,0
3,295,295,8,2,6,3,2
2,304,304,34,2,32,2,1
15,361,361,56,56,0,1,0
16,366,366,64,64,0,1,0
17,367,367,16,16,0,1,0
21,396,396,58,58,0,1,0
10,443,443,17,17,0,1,0
14,455,455,23,23,0,1,0
12,461,461,10,4,6,3,2
0,462,462,28,28,0,1,0
9,468,468,10,10,0,1,0
25,470,470,112,112,0,1,0
1,484,484,26,11,15,3,2
6,496,496,38,6,32,3,2

14,125,125,1,1,0,1,0
2,153,153,11,1,10,3,2
19,153,153,35,35,0,1,0
3,178,178,1,1,0,1,0
5,212,212,7,1,6,2,1
9,214,214,28,18,10,2,1
20,224,224,6,6,0,1,0
4,234,234,92,92,0,1,0
6,279,279,22,22,0,1,0
8,296,296,2,2,0,1,0
15,325,325,22,10,12,4,3
10,345,345,89,89,0,1,0
7,374,374,5,5,0,1,0
11,382,382,15,15,0,1,0
16,388,388,58,36,22,2,1
12,401,401,57,57,0,1,0
17,408,408,3,3,0,1,0
0,440,440,20,20,0,1,0
18,448,448,125,125,0,1,0
13,458,458,79,17,62,3,2
1,486,486,32,32,0,1,0

19,125,125,24,24,0,1,0
24,148,148,46,46,0,1,0
5,156,156,26,16,10,2,1
22,165,165,21,9,12,4,3
8,193,193,43,26,17,2,1
13,198,198,2,2,0,1,0
10,229,229,18,18,0,1,0
0,241,241,13,13,0,1,0
4,255,255,1,1,0,1,0
6,270,270,2,2,0,1,0
12,275,275,2,2,0,1,0
18,287,287,3,3,0,1,0
16,332,332,16,3,13,2,1
23,336,336,26,26,0,1,0
15,347,347,86,31,55,4,3
17,370,370,2,2,0,1,0
1,372,372,3,3,0,1,0
7,377,377,14,4,10,2,1
20,379,379,2,2,0,1,0
21,423,423,39,15,24,4,3
2,431,431,1,1,0,1,0
14,433,433,4,1,3,2,1
3,434,434,69,36,33,4,3
9,474,474,79,37,42,2,1
11,482,482,81,43,38,3,2

11,149,149,10,7,3,2,1
5,151,151,12,12,0,1,0
1,161,161,1,1,0,1,0
2,161,161,15,8,7,2,1
12,198,198,16,9,7,2,1
17,201,201,8,8,0,1,0
19,205,205,27,15,12,4,3
4,208,208,38,3,35,2,1
13,258,258,9,9,0,1,0
7,270,270,14,14,0,1,0
15,270,270,22,2,20,2,1
0,273,273,31,2,29,2,1
20,282,282,73,1,72,3,2
3,369,369,5,2,3,2,1
21,387,387,10,3,7,2,1
6,452,452,109,100,9,2,1
10,464,464,40,29,11,2,1
8,468,468,2,2,0,1,0
9,477,477,79,22,57,4,3
18,481,481,40,4,36,2,1
16,493,493,16,16,0,1,0
14,500,500,175,148,27,2,1

8,118,118,19,19,0,1,0
15,128,128,16,16,0,1,0
11,153,153,14,14,0,1,0
10,163,163,4,4,0,1,0
6,185,185,1,1,0,1,0
7,194,194,1,1,0,1,0
2,218,218,83,47,36,3,2
14,223,223,115,107,8,3,2
1,250,250,62,62,0,1,0
17,264,264,9,9,0,1,0
18,313,313,21,3,18,3,2
3,337,337,35,3,32,3,2
16,351,351,20,20,0,1,0
12,372,372,44,6,38,4,3
5,372,372,12,12,0,1,0
4,375,375,30,30,0,1,0
0,430,430,36,1,35,4,3
9,440,440,15,4,11,2,1
13,445,445,23,23,0,1,0

8,114,114,2,2,0,1,0
5,124,124,14,8,6,2,1
13,126,126,4,4,0,1,0
18,128,128,11,11,0,1,0
21,129,129,4,4,0,1,0
24,156,156,13,13,0,1,0
14,161,161,7,1,6,3,2
9,171,171,37,37,0,1,0
19,179,179,7,7,0,1,0
11,200,200,8,5,3,2,1
4,204,204,9,1,8,2,1
10,207,207,7,7,0,1,0
26,230,230,43,4,39,4,3
16,262,262,1,1,0,1,0
25,292,292,22,3,19,2,1
23,298,298,24,24,0,1,0
1,305,305,3,3,0,1,0
22,314,314,1,1,0,1,0
7,329,329,10,2,8,3,2
12,361,361,15,15,0,1,0
2,363,363,40,40,0,1,0
15,367,367,33,24,9,2,1
3,370,370,67,58,9,4,3
0,383,383,12,1,11,4,3
20,401,401,201,201,0,1,0
17,437,437,19,19,0,1,0
6,481,481,31,7,24,3,2

16,103,103,2,2,0,1,0
8,164,164,44,44,0,1,0
0,170,170,1,1,0,1,0
11,212,212,19,19,0,1,0
5,227,227,37,37,0,1,0
7,228,228,11,2,9,4,3
6,230,230,68,68,0,1,0
2,259,259,41,41,0,1,0
13,334,334,32,32,0,1,0
17,335,335,22,7,15,3,2
15,336,336,101,101,0,1,0
14,352,352,41,41,0,1,0
3,409,409,13,13,0,1,0
10,428,428,46,20,26,4,3
1,460,460,86,65,21,4,3
9,465,465,14,14,0,1,0
4,468,468,99,91,8,2,1
12,494,494,14,4,10,2,1

10,131,131,11,11,0,1,0
19,136,136,59,13,46,3,2
2,188,188,13,5,8,3,2
18,200,200,47,43,4,2,1
1,204,204,41,20,21,4,3
11,223,223,14,10,4,2,1
12,239,239,2,2,0,1,0
13,285,285,20,20,0,1,0
9,302,302,67,67,0,1,0
15,302,302,8,8,0,1,0
6,337,337,38,21,17,2,1
0,396,396,14,14,0,1,0
3,400,400,88,6,82,4,3
17,410,410,20,20,0,1,0
5,421,421,4,4,0,1,0
8,442,442,11,11,0,1,0
7,443,443,58,58,0,1,0
4,450,450,35,35,0,1,0
16,457,457,46,17,29,2,1
14,497,497,26,26,0,1,0

15,139,139,4,4,0,1,0
5,179,179,9,2,7,2,1
13,181,181,5,5,0,1,0
14,202,202,42,42,0,1,0
11,230,230,2,2,0,1,0
3,258,258,40,18,22,3,2
0,294,294,98,10,88,4,3
2,314,314,39,15,24,2,1
12,325,325,16,16,0,1,0
9,334,334,48,8,40,3,2
8,408,408,118,25,93,4,3
10,422,422,13,1,12,2,1
6,426,426,63,63,0,1,0
4,435,435,162,27,135,4,3
1,461,461,32,32,0,1,0
7,479,479,93,93,0,1,0

14,106,106,1,1,0,1,0
19,108,108,12,12,0,1,0
17,127,127,5,5,0,1,0
4,144,144,7,7,0,1,0
1,197,197,1,1,0,1,0
3,198,198,21,6,15,2,1
6,201,201,4,4,0,1,0
22,225,225,1,1,0,1,0
12,243,243,138,138,0,1,0
13,271,271,43,28,15,4,3
18,277,277,63,63,0,1,0
23,288,288,26,26,0,1,0
16,291,291,75,15,60,4,3
15,300,300,27,7,20,4,3
11,329,329,2,2,0,1,0
9,349,349,12,2,10,3,2
0,368,368,1,1,0,1,0
5,405,405,1,1,0,1,0
10,423,423,11,11,0,1,0
2,430,430,3,3,0,1,0
7,449,449,2,2,0,1,0
21,450,450,42,42,0,1,0
8,457,457,51,51,0,1,0
20,464,464,98,68,30,2,1

2,101,101,1,1,0,1,0
19,101,101,9,9,0,1,0
4,117,117,27,27,0,1,0
14,186,186,9,9,0,1,0
3,193,193,1,1,0,1,0
10,204,204,51,28,23,2,1
16,204,204,23,23,0,1,0
9,207,207,13,13,0,1,0
11,209,209,6,6,0,1,0
17,210,210,72,28,44,3,2
18,221,221,34,3,31,2,1
21,250,250,23,15,8,2,1
7,268,268,8,5,3,2,1
1,278,278,10,10,0,1,0
15,303,303,17,17,0,1,0
5,321,321,42,4,38,4,3
6,350,350,18,18,0,1,0
0,401,401,5,2,3,2,1
8,418,418,1,1,0,1,0
13,428,428,53,53,0,1,0
23,468,468,27,27,0,1,0
20,471,471,62,7,55,4,3
22,478,478,19,19,0,1,0
12,488,488,62,36,26,2,1

15,101,101,9,9,0,1,0
0,102,102,28,28,0,1,0
3,116,116,3,3,0,1,0
5,148,148,2,2,0,1,0
19,148,148,5,5,0,1,0
1,177,177,12,12,0,1,0
9,195,195,4,4,0,1,0
20,202,202,28,23,5,2,1
7,224,224,9,3,6,3,2
14,238,238,19,19,0,1,0
6,281,281,47,2,45,2,1
22,301,301,7,7,0,1,0
17,313,313,110,2,108,4,3
21,322,322,11,2,9,2,1
8,333,333,8,2,6,3,2
10,365,365,5,5,0,1,0
4,396,396,19,9,10,3,2
16,427,427,21,21,0,1,0
13,435,435,21,21,0,1,0
2,446,446,109,37,72,3,2
12,471,471,49,25,24,2,1
11,471,471,27,3,24,4,3
18,489,489,129,129,0,1,0

19,122,122,2,2,0,1,0
11,133,133,6,1,5,2,1
5,144,144,21,16,5,2,1
3,157,157,27,27,0,1,0
18,158,158,19,10,9,2,1
23,168,168,13,13,0,1,0
10,185,185,8,8,0,1,0
20,191,191,2,2,0,1,0
22,295,295,97,65,32,4,3
16,296,296,34,20,14,3,2
17,307,307,40,40,0,1,0
15,310,310,17,2,15,2,1
8,311,311,52,52,0,1,0
7,332,332,31,5,26,4,3
1,343,343,7,7,0,1,0
21,388,388,56,2,54,4,3
0,410,410,11,2,9,4,3
13,460,460,19,19,0,1,0
14,465,465,57,57,0,1,0
4,465,465,11,5,6,3,2
6,472,472,7,4,3,2,1
9,484,484,76,17,59,4,3
2,487,487,27,27,0,1,0
12,499,499,47,47,0,1,0

10,113,113,26,26,0,1,0
3,166,166,25,25,0,1,0
7,177,177,75,33,42,4,3
18,184,184,35,10,25,2,1
16,188,188,2,2,0,1,0
17,190,190,26,11,15,2,1
8,199,199,18,6,12,3,2
11,215,215,3,3,0,1,0
1,228,228,2,2,0,1,0
13,228,228,41,41,0,1,0
6,280,280,3,3,0,1,0
12,323,323,26,26,0,1,0
19,342,342,44,8,36,2,1
15,355,355,51,51,0,1,0
4,378,378,11,11,0,1,0
0,399,399,8,8,0,1,0
9,429,429,73,73,0,1,0
5,453,453,8,8,0,1,0
14,468,468,5,5,0,1,0
2,472,472,85,45,40,2,1

17,114,114,6,6,0,1,0
9,136,136,35,35,0,1,0
15,158,158,33,33,0,1,0
4,175,175,84,16,68,3,2
14,213,213,35,5,30,4,3
3,228,228,49,49,0,1,0
6,288,288,6,6,0,1,0
10,335,335,44,23,21,4,3
8,344,344,6,6,0,1,0
11,347,347,21,5,16,2,1
18,357,357,20,14,6,2,1
1,358,358,62,62,0,1,0
7,373,373,37,25,12,4,3
13,402,402,72,14,58,3,2
0,425,425,17,17,0,1,0
5,437,437,3,3,0,1,0
2,441,441,21,11,10,3,2
12,446,446,1,1,0,1,0
16,500,500,4,1,3,2,1

16,119,119,18,18,0,1,0
2,146,146,11,5,6,2,1
6,203,203,7,7,0,1,0
8,212,212,37,17,20,2,1
5,241,241,15,1,14,2,1
21,251,251,89,89,0,1,0
7,259,259,3,3,0,1,0
11,271,271,6,6,0,1,0
14,286,286,13,7,6,3,2
20,305,305,50,15,35,4,3
15,370,370,72,43,29,3,2
13,379,379,12,4,8,3,2
10,401,401,106,52,54,3,2
12,406,406,23,8,15,2,1
3,436,436,3,3,0,1,0
17,441,441,8,8,0,1,0
19,450,450,24,24,0,1,0
9,453,453,84,84,0,1,0
18,456,456,41,41,0,1,0
22,461,461,7,7,0,1,0
4,472,472,18,9,9,4,3
0,474,474,68,68,0,1,0
1,475,475,12,1,11,4,3

1,101,101,1,1,0,1,0
20,121,121,21,21,0,1,0
0,165,165,13,13,0,1,0
4,184,184,1,1,0,1,0
9,196,196,61,23,38,2,1
11,196,196,38,38,0,1,0
3,201,201,8,3,5,2,1
8,207,207,5,5,0,1,0
10,213,213,14,14,0,1,0
15,238,238,6,6,0,1,0
19,264,264,4,4,0,1,0
17,334,334,24,24,0,1,0
16,337,337,12,12,0,1,0
18,338,338,65,65,0,1,0
21,340,340,82,64,18,3,2
6,363,363,56,56,0,1,0
7,370,370,6,6,0,1,0
12,382,382,53,53,0,1,0
2,481,481,1,1,0,1,0
14,487,487,57,49,8,3,2
5,493,493,99,99,0,1,0
13,497,497,50,11,39,2,1

15,197,197,12,12,0,1,0
5,200,200,134,91,43,2,1
3,256,256,5,5,0,1,0
8,273,273,28,28,0,1,0
6,314,314,20,20,0,1,0
13,320,320,13,13,0,1,0
4,340,340,25,18,7,2,1
9,354,354,6,6,0,1,0
12,365,365,82,82,0,1,0
11,371,371,40,40,0,1,0
1,374,374,14,5,9,2,1
14,395,395,49,19,30,4,3
7,396,396,17,1,16,2,1
0,400,400,16,16,0,1,0
10,478,478,159,71,88,3,2
2,492,492,128,94,34,3,2

3,106,106,5,1,4,2,1
16,110,110,5,5,0,1,0
10,120,120,12,12,0,1,0
1,150,150,9,1,8,2,1
18,165,165,25,9,16,2,1
17,189,189,21,21,0,1,0
13,227,227,12,12,0,1,0
0,255,255,6,6,0,1,0
12,277,277,73,10,63,4,3
15,304,304,45,45,0,1,0
4,313,313,16,7,9,4,3
9,365,365,54,54,0,1,0
7,380,380,49,49,0,1,0
2,395,395,130,70,60,4,3
6,410,410,25,4,21,4,3
14,434,434,5,2,3,2,1
11,452,452,45,35,10,2,1
8,453,453,110,102,8,3,2
5,487,487,77,64,13,2,1

15,122,122,4,4,0,1,0
0,133,133,23,5,18,2,1
18,148,148,3,3,0,1,0
10,159,159,31,31,0,1,0
20,171,171,34,34,0,1,0
12,195,195,52,5,47,2,1
2,195,195,30,3,27,4,3
5,208,208,8,4,4,2,1
6,214,214,35,35,0,1,0
7,246,246,16,16,0,1,0
19,364,364,3,3,0,1,0
16,401,401,23,23,0,1,0
9,436,436,24,8,16,3,2
1,438,438,12,12,0,1,0
17,438,438,8,1,7,2,1
8,446,446,87,75,12,4,3
11,446,446,33,33,0,1,0
3,461,461,2,2,0,1,0
13,468,468,172,145,27,2,1
14,478,478,39,39,0,1,0
4,498,498,15,15,0,1,0

24,103,103,17,1,16,2,1
11,105,105,10,10,0,1,0
25,130,130,10,10,0,1,0
1,138,138,1,1,0,1,0
16,179,179,13,13,0,1,0
20,184,184,31,31,0,1,0
2,189,189,1,1,0,1,0
4,211,211,1,1,0,1,0
9,251,251,2,2,0,1,0
7,257,257,14,1,13,2,1
10,261,261,16,16,0,1,0
0,285,285,44,44,0,1,0
17,313,313,14,8,6,3,2
5,329,329,45,45,0,1,0
12,347,347,40,18,22,3,2
8,377,377,26,12,14,2,1
26,382,382,92,23,69,4,3
19,383,383,11,11,0,1,0
14,406,406,3,3,0,1,0
21,433,433,21,21,0,1,0
15,436,436,45,19,26,3,2
23,444,444,51,51,0,1,0
13,452,452,72,9,63,4,3
3,467,467,19,15,4,2,1
6,471,471,3,3,0,1,0
18,491,491,99,99,0,1,0
22,495,495,15,15,0,1,0

10,106,106,4,1,3,2,1
3,107,107,10,10,0,1,0
13,133,133,14,14,0,1,0
7,187,187,36,36,0,1,0
11,223,223,62,62,0,1,0
2,264,264,38,15,23,2,1
5,266,266,41,16,25,2,1
16,284,284,80,80,0,1,0
8,333,333,13,13,0,1,0
1,365,365,93,54,39,2,1
6,372,372,4,4,0,1,0
15,415,415,21,21,0,1,0
0,473,473,154,154,0,1,0
9,481,481,9,3,6,3,2
14,483,483,41,41,0,1,0
4,486,486,58,33,25,2,1
12,493,493,13,10,3,2,1

7,106,106,10,10,0,1,0
4,149,149,59,59,0,1,0
15,159,159,22,22,0,1,0
1,164,164,12,12,0,1,0
10,179,179,16,16,0,1,0
5,182,182,6,2,4,2,1
8,187,187,16,8,8,3,2
11,194,194,1,1,0,1,0
3,236,236,13,1,12,2,1
6,263,263,60,17,43,3,2
12,287,287,78,62,16,2,1
13,308,308,78,78,0,1,0
2,309,309,56,56,0,1,0
17,322,322,13,13,0,1,0
9,405,405,19,4,15,2,1
16,446,446,14,2,12,4,3
14,469,469,70,7,63,3,2
0,469,469,22,10,12,2,1

21,103,103,7,1,6,2,1
22,106,106,6,6,0,1,0
17,112,112,11,11,0,1,0
15,117,117,1,1,0,1,0
27,120,120,7,4,3,2,1
16,120,120,2,2,0,1,0
24,152,152,3,3,0,1,0
18,164,164,13,10,3,2,1
19,179,179,36,1,35,2,1
14,203,203,5,5,0,1,0
8,206,206,30,21,9,4,3
10,254,254,20,20,0,1,0
7,291,291,28,7,21,2,1
20,295,295,28,12,16,3,2
26,304,304,106,73,33,4,3
13,350,350,1,1,0,1,0
9,364,364,62,44,18,2,1
2,381,381,8,8,0,1,0
3,388,388,42,9,33,2,1
23,395,395,49,10,39,2,1
12,440,440,7,7,0,1,0
11,461,461,53,19,34,2,1
1,481,481,47,24,23,2,1
0,488,488,22,22,0,1,0
6,491,491,16,3,13,2,1
5,494,494,3,3,0,1,0
25,496,496,37,19,18,4,3
4,500,500,12,9,3,2,1

19,102,102,21,5,16,3,2
13,119,119,8,8,0,1,0
4,121,121,2,2,0,1,0
8,188,188,1,1,0,1,0
18,235,235,18,4,14,3,2
0,257,257,33,33,0,1,0
17,261,261,58,38,20,2,1
9,263,263,4,4,0,1,0
10,276,276,82,64,18,4,3
7,304,304,22,22,0,1,0
12,306,306,19,1,18,3,2
14,306,306,18,18,0,1,0
5,308,308,16,7,9,2,1
11,319,319,19,19,0,1,0
1,351,351,2,2,0,1,0
3,368,368,71,57,14,3,2
16,394,394,36,36,0,1,0
15,403,403,90,41,49,2,1
6,427,427,10,7,3,2,1
20,428,428,26,12,14,2,1
2,498,498,145,145,0,1,0

10,154,154,27,27,0,1,0
14,161,161,6,6,0,1,0
7,180,180,8,2,6,3,2
0,195,195,51,51,0,1,0
3,195,195,25,4,21,2,1
4,234,234,43,21,22,3,2
6,251,251,7,3,4,2,1
5,351,351,77,32,45,4,3
11,362,362,7,1,6,2,1
9,365,365,18,18,0,1,0
13,377,377,18,4,14,2,1
2,392,392,73,26,47,3,2
12,395,395,60,60,0,1,0
8,418,418,51,24,27,4,3
1,424,424,52,4,48,3,2
15,472,472,208,165,43,2,1

8,112,112,5,1,4,2,1
10,121,121,6,6,0,1,0
1,170,170,3,3,0,1,0
5,170,170,39,39,0,1,0
22,185,185,21,21,0,1,0
15,198,198,2,2,0,1,0
20,204,204,37,14,23,2,1
13,208,208,21,2,19,2,1
17,225,225,2,2,0,1,0
9,234,234,7,7,0,1,0
6,239,239,50,38,12,4,3
0,248,248,15,7,8,3,2
18,252,252,109,89,20,4,3
19,304,304,5,5,0,1,0
16,347,347,32,32,0,1,0
11,359,359,19,19,0,1,0
2,368,368,26,26,0,1,0
3,394,394,35,7,28,2,1
12,436,436,11,7,4,2,1
14,449,449,26,26,0,1,0
4,451,451,62,62,0,1,0
7,453,453,39,8,31,2,1
21,466,466,51,37,14,2,1

13,129,129,10,10,0,1,0
8,138,138,11,11,0,1,0
21,149,149,17,4,13,2,1
17,159,159,18,2,16,3,2
0,192,192,4,1,3,2,1
3,221,221,10,10,0,1,0
1,235,235,5,2,3,2,1
24,259,259,59,59,0,1,0
23,270,270,96,58,38,2,1
22,271,271,9,3,6,3,2
7,302,302,48,1,47,3,2
18,302,302,13,13,0,1,0
12,308,308,30,30,0,1,0
19,345,345,19,19,0,1,0
9,352,352,12,3,9,2,1
4,363,363,20,20,0,1,0
5,389,389,28,28,0,1,0
11,402,402,39,39,0,1,0
16,419,419,23,5,18,4,3
15,426,426,1,1,0,1,0
2,444,444,30,6,24,4,3
10,445,445,41,41,0,1,0
6,456,456,37,37,0,1,0
14,478,478,48,48,0,1,0
20,485,485,57,39,18,3,2

7,151,151,26,4,22,3,2
11,171,171,23,23,0,1,0
16,185,185,1,1,0,1,0
12,226,226,44,44,0,1,0
9,235,235,3,3,0,1,0
20,255,255,12,9,3,2,1
17,258,258,5,5,0,1,0
6,266,266,21,9,12,3,2
2,286,286,7,1,6,3,2
5,295,295,19,19,0,1,0
4,307,307,23,23,0,1,0
10,351,351,45,45,0,1,0
19,369,369,40,40,0,1,0
18,403,403,91,91,0,1,0
15,470,470,143,119,24,4,3
1,481,481,147,138,9,4,3
0,485,485,18,18,0,1,0
14,492,492,31,7,24,4,3
3,496,496,19,19,0,1,0
13,497,497,6,6,0,1,0
8,500,500,82,31,51,3,2

15,139,139,18,1,17,2,1
16,155,155,18,5,13,2,1
8,160,160,1,1,0,1,0
21,203,203,24,3,21,2,1
2,205,205,15,15,0,1,0
7,226,226,15,15,0,1,0
5,236,236,11,11,0,1,0
13,237,237,35,16,19,2,1
12,252,252,40,40,0,1,0
4,261,261,2,2,0,1,0
0,271,271,40,40,0,1,0
9,277,277,14,14,0,1,0
6,290,290,6,6,0,1,0
18,298,298,40,1,39,4,3
14,363,363,30,30,0,1,0
20,401,401,3,3,0,1,0
23,402,402,42,42,0,1,0
22,411,411,63,7,56,3,2
11,419,419,11,11,0,1,0
10,423,423,81,45,36,4,3
3,423,423,20,14,6,2,1
1,461,461,52,52,0,1,0
19,480,480,90,90,0,1,0
17,482,482,40,8,32,3,2

2,100,100,1,1,0,1,0
14,127,127,3,3,0,1,0
7,130,130,3,3,0,1,0
25,154,154,51,51,0,1,0
5,161,161,9,9,0,1,0
12,168,168,22,19,3,2,1
16,204,204,2,2,0,1,0
0,205,205,1,1,0,1,0
6,221,221,26,5,21,4,3
20,231,231,10,10,0,1,0
15,254,254,20,13,7,2,1
10,261,261,4,4,0,1,0
23,268,268,6,6,0,1,0
4,276,276,5,5,0,1,0
1,284,284,3,3,0,1,0
22,311,311,38,20,18,3,2
19,385,385,26,23,3,2,1
11,391,391,148,148,0,1,0
8,426,426,14,14,0,1,0
27,433,433,14,5,9,2,1
13,440,440,61,18,43,2,1
26,443,443,1,1,0,1,0
9,446,446,1,1,0,1,0
24,448,448,117,16,101,4,3
17,462,462,22,1,21,3,2
21,477,477,50,22,28,2,1
3,479,479,1,1,0,1,0
18,496,496,65,65,0,1,0

4,113,113,3,3,0,1,0
0,114,114,23,23,0,1,0
9,119,119,42,42,0,1,0
20,147,147,7,7,0,1,0
6,150,150,12,3,9,4,3
3,174,174,4,4,0,1,0
7,210,210,21,4,17,3,2
19,232,232,88,70,18,4,3
18,250,250,5,5,0,1,0
13,281,281,31,1,30,4,3
1,308,308,68,68,0,1,0
12,311,311,79,47,32,3,2
15,325,325,2,2,0,1,0
8,359,359,8,8,0,1,0
14,377,377,22,10,12,4,3
11,415,415,3,3,0,1,0
5,431,431,24,14,10,3,2
2,452,452,7,7,0,1,0
16,460,460,6,3,3,2,1
17,478,478,105,42,63,4,3
10,497,497,1,1,0,1,0

18,117,117,3,3,0,1,0
9,194,194,6,2,4,2,1
8,205,205,75,57,18,3,2
16,211,211,40,22,18,4,3
15,217,217,19,9,10,3,2
5,228,228,12,3,9,2,1
17,262,262,6,3,3,2,1
13,296,296,55,43,12,3,2
0,306,306,27,2,25,2,1
1,309,309,1,1,0,1,0
3,331,331,39,39,0,1,0
7,339,339,53,53,0,1,0
19,357,357,12,12,0,1,0
6,363,363,45,3,42,4,3
2,401,401,52,40,12,3,2
4,409,409,13,13,0,1,0
12,442,442,98,73,25,4,3
10,457,457,24,4,20,4,3
14,458,458,57,28,29,2,1
11,484,484,84,18,66,4,3

11,116,116,8,8,0,1,0
19,120,120,3,3,0,1,0
10,121,121,4,4,0,1,0
12,134,134,8,4,4,2,1
1,156,156,30,6,24,4,3
5,168,168,16,7,9,2,1
3,173,173,2,2,0,1,0
8,180,180,11,11,0,1,0
22,201,201,18,2,16,3,2
27,203,203,11,3,8,3,2
14,227,227,23,9,14,3,2
18,232,232,17,17,0,1,0
23,244,244,36,21,15,4,3
6,259,259,7,1,6,2,1
17,260,260,10,10,0,1,0
15,264,264,6,6,0,1,0
26,283,283,1,1,0,1,0
4,287,287,1,1,0,1,0
7,342,342,5,5,0,1,0
0,380,380,28,28,0,1,0
13,424,424,2,2,0,1,0
16,430,430,4,4,0,1,0
2,449,449,40,3,37,2,1
28,475,475,4,4,0,1,0
24,481,481,149,142,7,2,1
20,486,486,10,10,0,1,0
9,491,491,49,49,0,1,0
25,495,495,119,77,42,4,3
29,498,498,78,54,24,2,1
21,499,499,42,33,9,2,1

2,107,107,21,21,0,1,0
0,108,108,5,5,0,1,0
4,146,146,38,11,27,4,3
6,149,149,7,7,0,1,0
19,165,165,67,67,0,1,0
18,190,190,24,11,13,2,1
11,229,229,48,4,44,2,1
3,239,239,21,21,0,1,0
9,249,249,17,17,0,1,0
17,253,253,9,9,0,1,0
13,285,285,18,6,12,3,2
10,361,361,9,9,0,1,0
5,379,379,40,29,11,2,1
1,399,399,68,56,12,2,1
12,406,406,36,36,0,1,0
15,420,420,9,1,8,3,2
7,440,440,35,31,4,2,1
8,454,454,18,18,0,1,0
16,461,461,59,25,34,2,1
14,482,482,8,8,0,1,0

15,125,125,15,15,0,1,0
13,126,126,45,45,0,1,0
11,146,146,1,1,0,1,0
12,152,152,29,29,0,1,0
20,167,167,15,15,0,1,0
8,191,191,10,10,0,1,0
21,193,193,20,20,0,1,0
6,204,204,21,3,18,3,2
5,207,207,26,10,16,2,1
22,217,217,2,2,0,1,0
1,219,219,16,7,9,4,3
0,222,222,2,2,0,1,0
7,234,234,43,43,0,1,0
10,289,289,28,13,15,2,1
3,346,346,1,1,0,1,0
2,351,351,14,11,3,2,1
9,363,363,28,4,24,2,1
4,393,393,57,57,0,1,0
14,408,408,30,30,0,1,0
18,411,411,25,25,0,1,0
19,418,418,21,21,0,1,0
17,442,442,9,9,0,1,0
16,460,460,106,16,90,4,3

16,102,102,1,1,0,1,0
9,118,118,17,17,0,1,0
15,125,125,35,35,0,1,0
5,148,148,33,33,0,1,0
3,225,225,15,2,13,2,1
10,237,237,2,2,0,1,0
13,241,241,17,17,0,1,0
18,274,274,56,56,0,1,0
11,277,277,26,26,0,1,0
4,282,282,17,17,0,1,0
7,294,294,39,39,0,1,0
0,296,296,21,21,0,1,0
6,304,304,25,15,10,2,1
8,318,318,78,78,0,1,0
14,354,354,25,25,0,1,0
12,356,356,24,24,0,1,0
2,389,389,61,61,0,1,0
1,419,419,27,23,4,2,1
17,471,471,86,14,72,3,2

8,120,120,2,2,0,1,0
16,131,131,26,26,0,1,0
15,174,174,38,33,5,2,1
12,219,219,4,4,0,1,0
10,245,245,21,21,0,1,0
0,271,271,18,5,13,2,1
7,272,272,51,51,0,1,0
4,281,281,22,22,0,1,0
17,285,285,50,5,45,3,2
1,312,312,18,18,0,1,0
14,326,326,4,4,0,1,0
13,340,340,12,12,0,1,0
5,358,358,23,23,0,1,0
9,384,384,124,117,7,2,1
3,389,389,6,3,3,2,1
6,393,393,141,126,15,4,3
11,436,436,18,18,0,1,0
2,474,474,129,89,40,3,2

1,121,121,23,19,4,2,1
7,174,174,6,6,0,1,0
8,183,183,4,4,0,1,0
2,192,192,4,4,0,1,0
19,228,228,3,3,0,1,0
20,230,230,12,12,0,1,0
10,250,250,4,1,3,2,1
9,257,257,10,2,8,3,2
5,278,278,2,2,0,1,0
11,291,291,17,17,0,1,0
4,302,302,8,2,6,3,2
12,309,309,69,69,0,1,0
21,310,310,9,9,0,1,0
0,338,338,93,42,51,4,3
16,340,340,60,60,0,1,0
14,344,344,15,7,8,2,1
15,352,352,64,9,55,4,3
3,356,356,13,1,12,4,3
17,390,390,104,44,60,3,2
18,423,423,86,59,27,2,1
6,425,425,65,7,58,4,3
22,442,442,52,52,0,1,0
13,479,479,15,10,5,2,1

2,108,108,1,1,0,1,0
15,174,174,61,61,0,1,0
9,189,189,11,8,3,2,1
18,192,192,13,13,0,1,0
17,196,196,2,2,0,1,0
20,218,218,61,61,0,1,0
4,232,232,6,6,0,1,0
14,250,250,56,10,46,2,1
13,267,267,13,9,4,2,1
16,324,324,13,13,0,1,0
11,345,345,5,5,0,1,0
10,358,358,23,23,0,1,0
8,382,382,36,32,4,2,1
6,389,389,60,24,36,2,1
5,392,392,55,55,0,1,0
3,417,417,64,64,0,1,0
1,428,428,67,20,47,4,3
12,460,460,22,22,0,1,0
0,469,469,57,22,35,2,1
19,482,482,17,17,0,1,0
7,483,483,59,59,0,1,0

25,120,120,7,3,4,2,1
12,167,167,3,3,0,1,0
2,182,182,32,14,18,3,2
23,212,212,13,1,12,2,1
0,213,213,4,1,3,2,1
14,215,215,4,4,0,1,0
15,230,230,43,5,38,2,1
10,249,249,48,48,0,1,0
24,275,275,8,3,5,2,1
6,290,290,13,13,0,1,0
7,299,299,25,3,22,3,2
9,300,300,27,24,3,2,1
17,313,313,2,2,0,1,0
21,320,320,88,67,21,4,3
8,329,329,3,3,0,1,0
11,333,333,2,2,0,1,0
26,336,336,4,1,3,2,1
4,358,358,19,16,3,2,1
18,373,373,33,22,11,2,1
19,374,374,107,23,84,4,3
5,393,393,11,11,0,1,0
1,402,402,2,2,0,1,0
27,403,403,19,9,10,3,2
3,415,415,21,21,0,1,0
22,429,429,5,5,0,1,0
20,456,456,112,112,0,1,0
16,486,486,39,23,16,3,2
13,490,490,17,3,14,2,1

3,118,118,5,5,0,1,0
11,129,129,19,19,0,1,0
16,147,147,16,16,0,1,0
7,150,150,1,1,0,1,0
5,167,167,34,10,24,3,2
19,193,193,37,37,0,1,0
17,229,229,2,2,0,1,0
4,283,283,8,4,4,2,1
20,297,297,80,80,0,1,0
0,309,309,12,12,0,1,0
18,314,314,18,18,0,1,0
21,345,345,64,64,0,1,0
2,365,365,40,40,0,1,0
14,375,375,88,60,28,3,2
10,378,378,25,25,0,1,0
13,379,379,1,1,0,1,0
12,380,380,13,4,9,2,1
1,387,387,22,22,0,1,0
8,419,419,42,42,0,1,0
15,431,431,12,12,0,1,0
6,433,433,43,23,20,3,2
9,446,446,92,92,0,1,0

0,139,139,1,1,0,1,0
5,145,145,3,3,0,1,0
1,149,149,7,1,6,3,2
22,160,160,1,1,0,1,0
7,177,177,11,11,0,1,0
18,192,192,1,1,0,1,0
3,216,216,20,1,19,2,1
21,225,225,17,1,16,3,2
8,233,233,1,1,0,1,0
12,259,259,21,21,0,1,0
16,276,276,3,3,0,1,0
24,286,286,71,32,39,2,1
17,300,300,5,5,0,1,0
25,305,305,5,5,0,1,0
20,320,320,4,4,0,1,0
19,344,344,66,66,0,1,0
14,348,348,83,77,6,3,2
23,352,352,105,79,26,2,1
10,367,367,3,3,0,1,0
26,381,381,20,6,14,3,2
9,383,383,6,6,0,1,0
2,394,394,4,1,3,2,1
11,398,398,1,1,0,1,0
6,403,403,41,32,9,2,1
13,416,416,14,14,0,1,0
15,423,423,29,13,16,3,2
4,462,462,129,89,40,3,2
27,484,484,106,106,0,1,0

22,101,101,10,2,8,2,1
27,107,107,4,4,0,1,0
23,112,112,26,26,0,1,0
8,113,113,5,5,0,1,0
25,126,126,8,8,0,1,0
19,131,131,7,7,0,1,0
16,137,137,1,1,0,1,0
12,139,139,8,8,0,1,0
17,149,149,1,1,0,1,0
15,154,154,20,7,13,2,1
21,166,166,8,2,6,2,1
14,188,188,31,11,20,2,1
3,192,192,5,5,0,1,0
11,228,228,1,1,0,1,0
0,252,252,13,13,0,1,0
26,295,295,81,81,0,1,0
18,301,301,17,17,0,1,0
9,306,306,29,14,15,4,3
6,309,309,9,5,4,2,1
7,339,339,2,2,0,1,0
1,340,340,6,6,0,1,0
5,355,355,29,7,22,2,1
24,358,358,83,83,0,1,0
10,379,379,6,6,0,1,0
2,394,394,52,1,51,3,2
13,429,429,52,5,47,2,1
20,457,457,17,17,0,1,0
4,467,467,53,34,19,2,1

13,106,106,1,1,0,1,0
5,117,117,8,8,0,1,0
22,118,118,26,26,0,1,0
14,126,126,11,11,0,1,0
19,137,137,19,7,12,3,2
11,163,163,2,2,0,1,0
4,169,169,7,4,3,2,1
2,173,173,5,1,4,2,1
8,192,192,19,19,0,1,0
15,207,207,8,8,0,1,0
0,215,215,15,15,0,1,0
7,234,234,64,64,0,1,0
12,240,240,15,15,0,1,0
16,258,258,21,21,0,1,0
20,271,271,35,35,0,1,0
1,299,299,17,17,0,1,0
10,342,342,14,14,0,1,0
21,355,355,6,1,5,2,1
17,400,400,160,66,94,4,3
6,430,430,63,63,0,1,0
3,434,434,75,75,0,1,0
9,449,449,14,14,0,1,0
18,498,498,4,4,0,1,0

6,129,129,14,14,0,1,0
12,143,143,4,4,0,1,0
8,160,160,9,3,6,2,1
10,170,170,32,5,27,2,1
14,181,181,5,5,0,1,0
7,185,185,14,1,13,2,1
1,190,190,6,6,0,1,0
21,246,246,19,9,10,2,1
19,251,251,37,37,0,1,0
15,286,286,79,1,78,4,3
9,302,302,53,18,35,2,1
3,320,320,3,3,0,1,0
0,328,328,18,7,11,2,1
16,346,346,55,55,0,1,0
2,356,356,4,4,0,1,0
4,358,358,4,1,3,2,1
5,360,360,92,92,0,1,0
17,416,416,7,4,3,2,1
22,430,430,18,5,13,2,1
20,438,438,119,119,0,1,0
13,454,454,22,22,0,1,0
18,475,475,23,17,6,2,1
11,475,475,46,46,0,1,0

11,124,124,7,7,0,1,0
3,201,201,2,2,0,1,0
17,203,203,56,10,46,3,2
18,245,245,13,13,0,1,0
0,270,270,4,4,0,1,0
13,270,270,14,14,0,1,0
7,274,274,1,1,0,1,0
16,281,281,11,11,0,1,0
10,301,301,116,77,39,4,3
4,303,303,11,11,0,1,0
20,310,310,46,46,0,1,0
9,363,363,49,49,0,1,0
15,387,387,10,10,0,1,0
14,388,388,7,7,0,1,0
2,395,395,31,10,21,4,3
5,398,398,30,6,24,2,1
12,418,418,169,91,78,4,3
6,435,435,78,78,0,1,0
1,460,460,31,1,30,4,3
19,471,471,22,22,0,1,0
8,498,498,58,58,0,1,0

20,120,120,4,4,0,1,0
3,132,132,24,24,0,1,0
5,141,141,4,4,0,1,0
2,163,163,20,20,0,1,0
12,171,171,12,12,0,1,0
9,210,210,37,37,0,1,0
18,211,211,56,56,0,1,0
17,217,217,13,4,9,4,3
16,218,218,1,1,0,1,0
10,221,221,3,3,0,1,0
8,222,222,29,11,18,2,1
1,242,242,39,39,0,1,0
6,265,265,36,7,29,2,1
11,331,331,189,105,84,4,3
14,331,331,12,12,0,1,0
0,343,343,9,9,0,1,0
19,353,353,9,9,0,1,0
4,371,371,1,1,0,1,0
13,374,374,6,3,3,2,1
7,471,471,58,22,36,4,3
15,480,480,16,16,0,1,0

9,127,127,32,25,7,2,1
21,128,128,10,5,5,2,1
19,141,141,16,6,10,3,2
3,148,148,12,8,4,2,1
0,150,150,13,13,0,1,0
12,163,163,90,48,42,3,2
13,222,222,12,12,0,1,0
7,224,224,18,18,0,1,0
8,227,227,39,6,33,3,2
14,253,253,5,5,0,1,0
17,253,253,11,11,0,1,0
1,274,274,5,5,0,1,0
20,276,276,14,14,0,1,0
5,348,348,92,92,0,1,0
11,354,354,22,22,0,1,0
18,372,372,7,1,6,2,1
2,410,410,7,7,0,1,0
6,411,411,3,3,0,1,0
10,419,419,12,12,0,1,0
15,437,437,53,53,0,1,0
4,496,496,16,16,0,1,0
16,496,496,36,36,0,1,0

12,117,117,27,27,0,1,0
18,130,130,66,9,57,4,3
10,134,134,8,8,0,1,0
7,145,145,2,2,0,1,0
0,164,164,23,23,0,1,0
21,164,164,1,1,0,1,0
9,165,165,34,16,18,2,1
20,169,169,24,24,0,1,0
15,191,191,3,3,0,1,0
3,202,202,18,18,0,1,0
22,232,232,23,23,0,1,0
2,277,277,45,16,29,2,1
4,296,296,1,1,0,1,0
19,308,308,12,1,11,2,1
11,339,339,14,14,0,1,0
14,359,359,2,2,0,1,0
13,372,372,70,58,12,3,2
8,408,408,7,3,4,2,1
17,410,410,3,3,0,1,0
6,412,412,2,2,0,1,0
16,415,415,48,13,35,4,3
5,423,423,6,6,0,1,0
1,437,437,52,52,0,1,0

0,159,159,6,6,0,1,0
14,162,162,49,9,40,3,2
17,191,191,21,11,10,2,1
7,206,206,1,1,0,1,0
10,206,206,20,20,0,1,0
4,260,260,5,1,4,2,1
21,280,280,1,1,0,1,0
11,281,281,29,29,0,1,0
18,281,281,10,10,0,1,0
13,281,281,76,76,0,1,0
6,317,317,3,3,0,1,0
3,319,319,104,20,84,3,2
19,325,325,28,10,18,4,3
22,333,333,18,18,0,1,0
20,346,346,49,49,0,1,0
8,361,361,49,49,0,1,0
12,368,368,47,47,0,1,0
5,396,396,5,5,0,1,0
16,435,435,28,1,27,2,1
9,438,438,4,4,0,1,0
2,477,477,50,50,0,1,0
1,495,495,56,56,0,1,0
15,500,500,26,26,0,1,0

20,115,115,13,3,10,3,2
7,116,116,1,1,0,1,0
11,134,134,14,14,0,1,0
18,149,149,17,17,0,1,0
9,175,175,14,14,0,1,0
10,195,195,22,11,11,2,1
1,196,196,29,11,18,4,3
0,212,212,4,4,0,1,0
15,217,217,3,3,0,1,0
22,223,223,11,3,8,3,2
6,240,240,86,78,8,2,1
8,254,254,1,1,0,1,0
21,260,260,27,27,0,1,0
17,261,261,59,59,0,1,0
5,266,266,13,13,0,1,0
14,283,283,41,1,40,2,1
4,324,324,1,1,0,1,0
2,377,377,42,30,12,4,3
12,380,380,3,3,0,1,0
13,381,381,14,14,0,1,0
16,427,427,62,9,53,3,2
3,447,447,43,43,0,1,0
19,466,466,86,86,0,1,0

2,114,114,2,2,0,1,0
10,120,120,1,1,0,1,0
14,166,166,2,2,0,1,0
7,174,174,13,13,0,1,0
19,193,193,5,5,0,1,0
4,214,214,2,2,0,1,0
18,230,230,21,21,0,1,0
20,245,245,15,7,8,2,1
16,254,254,32,32,0,1,0
23,288,288,12,12,0,1,0
15,291,291,50,50,0,1,0
1,309,309,28,28,0,1,0
5,313,313,43,5,38,3,2
9,343,343,5,5,0,1,0
22,352,352,66,66,0,1,0
25,355,355,19,3,16,4,3
12,370,370,13,2,11,4,3
13,374,374,8,2,6,3,2
11,395,395,30,30,0,1,0
24,447,447,68,26,42,3,2
21,462,462,99,99,0,1,0
6,463,463,11,11,0,1,0
8,484,484,120,28,92,3,2
3,486,486,9,1,8,3,2
0,490,490,70,26,44,2,1
17,499,499,82,64,18,3,2

19,115,115,6,6,0,1,0
15,123,123,1,1,0,1,0
11,125,125,7,7,0,1,0
7,157,157,9,1,8,3,2
13,171,171,1,1,0,1,0
17,222,222,58,8,50,3,2
24,230,230,2,2,0,1,0
16,248,248,14,11,3,2,1
10,256,256,72,39,33,4,3
3,273,273,15,6,9,4,3
26,284,284,22,3,19,2,1
27,307,307,29,29,0,1,0
12,345,345,7,7,0,1,0
0,359,359,1,1,0,1,0
9,363,363,14,14,0,1,0
22,365,365,23,23,0,1,0
25,374,374,63,33,30,2,1
8,403,403,13,4,9,2,1
2,408,408,10,3,7,2,1
21,418,418,70,70,0,1,0
14,437,437,13,13,0,1,0
6,457,457,16,16,0,1,0
20,460,460,134,30,104,4,3
4,472,472,2,2,0,1,0
5,474,474,13,9,4,2,1
1,479,479,50,50,0,1,0
18,484,484,86,79,7,2,1
23,493,493,6,6,0,1,0

13,101,101,1,1,0,1,0
9,125,125,4,1,3,2,1
4,163,163,16,7,9,2,1
3,198,198,11,11,0,1,0
12,220,220,38,38,0,1,0
1,230,230,10,3,7,2,1
5,232,232,56,2,54,3,2
11,240,240,49,23,26,2,1
19,245,245,19,2,17,2,1
10,251,251,5,5,0,1,0
8,380,380,9,9,0,1,0
6,381,381,91,61,30,4,3
17,387,387,115,115,0,1,0
16,396,396,31,31,0,1,0
0,440,440,35,28,7,2,1
18,442,442,14,9,5,2,1
14,465,465,84,84,0,1,0
7,479,479,23,8,15,2,1
2,483,483,116,116,0,1,0
15,500,500,20,20,0,1,0

12,117,117,30,30,0,1,0
14,148,148,1,1,0,1,0
10,148,148,7,1,6,3,2
7,149,149,3,3,0,1,0
11,150,150,1,1,0,1,0
17,157,157,45,45,0,1,0
9,208,208,16,8,8,2,1
1,222,222,46,46,0,1,0
16,254,254,5,5,0,1,0
5,298,298,12,12,0,1,0
6,326,326,74,74,0,1,0
4,330,330,60,10,50,2,1
3,356,356,92,92,0,1,0
0,387,387,48,6,42,3,2
2,426,426,19,14,5,2,1
8,472,472,56,56,0,1,0
13,478,478,107,29,78,3,2
15,482,482,41,41,0,1,0

13,119,119,4,4,0,1,0
12,155,155,3,3,0,1,0
10,194,194,1,1,0,1,0
0,197,197,3,3,0,1,0
2,233,233,63,9,54,4,3
3,245,245,8,5,3,2,1
22,258,258,13,8,5,2,1
20,261,261,9,9,0,1,0
14,309,309,16,11,5,2,1
16,326,326,42,15,27,2,1
18,329,329,34,34,0,1,0
7,370,370,8,1,7,3,2
5,393,393,54,16,38,3,2
15,395,395,77,17,60,3,2
17,406,406,186,132,54,4,3
1,420,420,56,44,12,3,2
9,455,455,4,4,0,1,0
8,461,461,32,32,0,1,0
4,469,469,85,85,0,1,0
19,481,481,27,27,0,1,0
6,485,485,49,3,46,2,1
21,494,494,1,1,0,1,0
11,497,497,55,10,45,4,3

3,111,111,23,23,0,1,0
1,126,126,15,15,0,1,0
6,128,128,13,13,0,1,0
0,144,144,48,4,44,3,2
7,145,145,3,3,0,1,0
15,159,159,32,8,24,3,2
4,217,217,17,1,16,2,1
2,220,220,5,5,0,1,0
9,248,248,7,1,6,2,1
18,262,262,22,22,0,1,0
5,307,307,38,14,24,3,2
14,316,316,122,81,41,3,2
13,324,324,23,23,0,1,0
17,348,348,48,7,41,2,1
8,408,408,39,3,36,4,3
10,408,408,3,3,0,1,0
16,452,452,36,36,0,1,0
11,464,464,15,15,0,1,0
12,492,492,44,29,15,2,1

20,107,107,21,21,0,1,0
2,116,116,16,16,0,1,0
21,150,150,2,2,0,1,0
22,152,152,6,1,5,2,1
1,158,158,1,1,0,1,0
15,177,177,3,3,0,1,0
0,190,190,1,1,0,1,0
11,235,235,2,2,0,1,0
6,283,283,12,3,9,4,3
18,333,333,108,14,94,4,3
4,348,348,2,2,0,1,0
7,369,369,77,29,48,4,3
5,374,374,5,5,0,1,0
19,395,395,48,48,0,1,0
12,401,401,1,1,0,1,0
17,405,405,79,13,66,4,3
10,408,408,67,67,0,1,0
16,420,420,37,14,23,2,1
8,428,428,66,16,50,2,1
9,431,431,86,74,12,4,3
13,439,439,41,27,14,2,1
14,498,498,13,1,12,3,2
3,500,500,76,45,31,2,1

3,100,100,1,1,0,1,0
1,101,101,6,6,0,1,0
26,111,111,13,3,10,2,1
0,150,150,26,13,13,2,1
7,181,181,9,4,5,2,1
12,184,184,4,4,0,1,0
8,205,205,12,12,0,1,0
20,213,213,52,52,0,1,0
21,228,228,33,33,0,1,0
2,240,240,8,5,3,2,1
18,240,240,45,34,11,2,1
25,255,255,2,2,0,1,0
23,268,268,22,4,18,2,1
11,289,289,15,7,8,3,2
10,292,292,10,5,5,2,1
19,355,355,9,1,8,3,2
6,386,386,27,27,0,1,0
24,414,414,89,89,0,1,0
9,415,415,38,23,15,4,3
5,415,415,18,18,0,1,0
4,424,424,34,6,28,2,1
22,424,424,16,3,13,2,1
15,457,457,40,40,0,1,0
16,460,460,5,5,0,1,0
14,461,461,20,20,0,1,0
17,461,461,22,10,12,4,3
13,475,475,86,86,0,1,0

5,112,112,7,7,0,1,0
11,125,125,25,25,0,1,0
1,128,128,37,10,27,4,3
17,139,139,40,1,39,2,1
20,166,166,20,20,0,1,0
16,168,168,7,7,0,1,0
21,170,170,13,2,11,2,1
6,185,185,13,13,0,1,0
15,197,197,26,18,8,3,2
10,206,206,3,3,0,1,0
8,220,220,31,4,27,4,3
0,228,228,7,2,5,2,1
13,244,244,65,65,0,1,0
4,275,275,2,2,0,1,0
12,318,318,9,9,0,1,0
19,330,330,6,1,5,2,1
18,335,335,14,14,0,1,0
9,375,375,20,6,14,3,2
14,397,397,45,45,0,1,0
3,445,445,45,45,0,1,0
2,497,497,11,11,0,1,0
7,497,497,56,56,0,1,0

19,131,131,23,23,0,1,0
12,134,134,1,1,0,1,0
23,163,163,42,42,0,1,0
21,234,234,23,23,0,1,0
9,247,247,5,5,0,1,0
4,269,269,21,15,6,2,1
16,306,306,42,1,41,2,1
3,309,309,12,9,3,2,1
8,317,317,7,2,5,2,1
15,319,319,18,18,0,1,0
24,323,323,6,6,0,1,0
1,326,326,21,13,8,2,1
18,357,357,56,56,0,1,0
20,378,378,2,2,0,1,0
22,402,402,26,26,0,1,0
11,411,411,30,30,0,1,0
17,412,412,60,60,0,1,0
5,421,421,61,41,20,3,2
14,424,424,184,79,105,4,3
6,430,430,41,14,27,4,3
7,434,434,7,7,0,1,0
10,441,441,4,4,0,1,0
0,465,465,28,18,10,3,2
13,482,482,16,16,0,1,0
2,496,496,2,2,0,1,0

20,118,118,6,6,0,1,0
9,145,145,18,18,0,1,0
2,157,157,9,9,0,1,0
23,185,185,9,2,7,2,1
19,189,189,3,3,0,1,0
6,193,193,26,26,0,1,0
22,225,225,27,27,0,1,0
15,228,228,42,21,21,4,3
21,246,246,100,100,0,1,0
17,247,247,24,24,0,1,0
10,248,248,11,2,9,4,3
0,256,256,41,41,0,1,0
3,267,267,35,35,0,1,0
14,272,272,38,38,0,1,0
7,291,291,1,1,0,1,0
5,295,295,5,5,0,1,0
4,318,318,12,12,0,1,0
11,331,331,51,51,0,1,0
1,348,348,5,5,0,1,0
24,364,364,37,4,33,2,1
18,371,371,26,26,0,1,0
13,393,393,14,14,0,1,0
16,442,442,11,11,0,1,0
12,463,463,4,4,0,1,0
8,469,469,18,4,14,3,2

18,121,121,35,1,34,3,2
0,173,173,14,14,0,1,0
8,200,200,16,16,0,1,0
13,204,204,18,4,14,2,1
4,208,208,11,11,0,1,0
6,269,269,8,8,0,1,0
20,278,278,13,13,0,1,0
16,301,301,16,16,0,1,0
10,308,308,14,6,8,2,1
14,308,308,43,16,27,2,1
11,310,310,21,21,0,1,0
15,334,334,28,28,0,1,0
5,340,340,46,23,23,2,1
9,346,346,48,7,41,2,1
1,357,357,29,21,8,3,2
12,362,362,21,8,13,2,1
22,374,374,1,1,0,1,0
3,380,380,23,23,0,1,0
19,401,401,110,5,105,4,3
2,406,406,2,2,0,1,0
21,420,420,13,13,0,1,0
7,422,422,112,97,15,2,1
17,456,456,53,53,0,1,0

5,131,131,7,7,0,1,0
20,166,166,29,29,0,1,0
11,168,168,6,6,0,1,0
18,197,197,28,1,27,2,1
14,211,211,19,19,0,1,0
24,229,229,13,13,0,1,0
3,235,235,2,2,0,1,0
13,279,279,11,11,0,1,0
22,285,285,5,2,3,2,1
10,294,294,3,3,0,1,0
16,307,307,14,14,0,1,0
21,318,318,36,27,9,2,1
6,351,351,40,27,13,2,1
4,373,373,15,15,0,1,0
15,382,382,40,40,0,1,0
9,386,386,32,32,0,1,0
0,396,396,14,14,0,1,0
2,400,400,34,34,0,1,0
8,408,408,15,15,0,1,0
19,416,416,11,11,0,1,0
17,431,431,55,5,50,2,1
26,438,438,104,104,0,1,0
25,439,439,48,28,20,3,2
27,439,439,6,2,4,2,1
7,459,459,52,7,45,3,2
12,471,471,4,4,0,1,0
1,474,474,33,33,0,1,0
23,484,484,110,71,39,4,3

1,116,116,8,8,0,1,0
18,130,130,55,55,0,1,0
7,205,205,1,1,0,1,0
10,212,212,62,62,0,1,0
12,215,215,34,34,0,1,0
0,234,234,36,16,20,2,1
5,263,263,13,13,0,1,0
20,263,263,19,19,0,1,0
6,267,267,11,11,0,1,0
11,276,276,26,4,22,2,1
16,277,277,7,1,6,3,2
21,314,314,75,75,0,1,0
4,354,354,1,1,0,1,0
14,394,394,11,11,0,1,0
2,411,411,100,58,42,4,3
19,424,424,26,26,0,1,0
3,444,444,31,19,12,4,3
15,453,453,21,6,15,4,3
13,463,463,16,16,0,1,0
17,471,471,14,14,0,1,0
9,489,489,22,7,15,2,1
8,492,492,18,9,9,2,1

7,110,110,1,1,0,1,0
3,119,119,39,33,6,2,1
17,126,126,5,5,0,1,0
14,134,134,6,1,5,2,1
20,153,153,22,22,0,1,0
12,172,172,8,5,3,2,1
19,187,187,78,78,0,1,0
0,194,194,18,15,3,2,1
13,239,239,15,15,0,1,0
6,275,275,14,14,0,1,0
15,314,314,23,2,21,2,1
5,324,324,6,1,5,2,1
16,332,332,5,2,3,2,1
4,339,339,81,46,35,2,1
9,356,356,11,2,9,4,3
1,371,371,2,2,0,1,0
8,383,383,76,76,0,1,0
18,394,394,95,11,84,4,3
10,433,433,4,4,0,1,0
2,442,442,53,53,0,1,0
11,499,499,18,18,0,1,0

2,109,109,27,6,21,2,1
11,121,121,41,41,0,1,0
16,156,156,1,1,0,1,0
14,176,176,3,3,0,1,0
4,208,208,22,22,0,1,0
10,224,224,11,5,6,3,2
13,225,225,45,12,33,2,1
8,241,241,6,6,0,1,0
12,266,266,22,10,12,3,2
9,277,277,10,5,5,2,1
17,321,321,9,9,0,1,0
0,326,326,41,41,0,1,0
18,376,376,61,37,24,4,3
6,386,386,24,6,18,2,1
3,396,396,78,46,32,2,1
15,415,415,83,83,0,1,0
7,419,419,21,21,0,1,0
1,432,432,15,6,9,4,3
5,467,467,119,26,93,4,3

20,114,114,3,3,0,1,0
5,124,124,2,2,0,1,0
10,142,142,2,2,0,1,0
4,144,144,10,10,0,1,0
6,205,205,41,11,30,4,3
19,230,230,28,7,21,4,3
13,234,234,42,42,0,1,0
15,235,235,35,26,9,2,1
9,278,278,73,64,9,4,3
14,283,283,3,3,0,1,0
0,319,319,15,15,0,1,0
1,364,364,5,5,0,1,0
16,381,381,96,67,29,2,1
12,405,405,52,26,26,3,2
7,407,407,79,54,25,2,1
18,420,420,87,1,86,4,3
11,443,443,3,3,0,1,0
2,474,474,39,39,0,1,0
3,477,477,2,2,0,1,0
8,498,498,98,9,89,4,3
17,498,498,20,20,0,1,0

10,111,111,9,9,0,1,0
11,113,113,1,1,0,1,0
13,148,148,5,5,0,1,0
18,201,201,31,31,0,1,0
1,222,222,14,5,9,4,3
7,266,266,1,1,0,1,0
25,270,270,90,90,0,1,0
2,274,274,15,15,0,1,0
5,328,328,86,70,16,3,2
14,342,342,7,4,3,2,1
3,350,350,38,38,0,1,0
16,385,385,21,21,0,1,0
22,386,386,72,72,0,1,0
6,388,388,11,11,0,1,0
17,390,390,26,5,21,4,3
23,392,392,32,32,0,1,0
20,402,402,17,5,12,3,2
9,407,407,47,47,0,1,0
21,407,407,14,14,0,1,0
12,416,416,19,19,0,1,0
15,421,421,22,22,0,1,0
0,425,425,10,10,0,1,0
8,426,426,9,9,0,1,0
19,437,437,21,5,16,2,1
4,440,440,78,38,40,2,1
24,471,471,55,55,0,1,0

7,138,138,3,3,0,1,0
11,157,157,36,8,28,2,1
6,161,161,24,24,0,1,0
10,168,168,33,33,0,1,0
12,184,184,8,8,0,1,0
16,211,211,5,2,3,2,1
9,234,234,2,2,0,1,0
15,234,234,78,53,25,2,1
0,259,259,36,22,14,4,3
2,343,343,11,11,0,1,0
1,344,344,14,4,10,2,1
3,360,360,45,21,24,3,2
17,398,398,23,3,20,3,2
18,410,410,5,5,0,1,0
5,414,414,101,50,51,4,3
19,421,421,72,5,67,4,3
14,450,450,19,13,6,3,2
13,455,455,3,3,0,1,0
4,479,479,149,11,138,4,3
8,497,497,15,5,10,2,1

6,157,157,6,6,0,1,0
12,182,182,31,3,28,2,1
14,185,185,11,5,6,2,1
15,213,213,41,41,0,1,0
9,235,235,44,12,32,2,1
4,252,252,29,10,19,2,1
8,266,266,44,44,0,1,0
7,278,278,38,38,0,1,0
10,295,295,30,30,0,1,0
3,313,313,4,4,0,1,0
13,345,345,7,7,0,1,0
16,345,345,26,26,0,1,0
2,373,373,24,24,0,1,0
0,418,418,50,26,24,2,1
11,419,419,3,3,0,1,0
5,438,438,238,220,18,2,1
1,473,473,99,87,12,4,3

4,106,106,14,4,10,3,2
13,111,111,6,6,0,1,0
9,115,115,14,4,10,2,1
12,178,178,1,1,0,1,0
15,217,217,2,2,0,1,0
8,224,224,14,5,9,4,3
16,242,242,66,48,18,2,1
18,250,250,6,6,0,1,0
17,261,261,18,18,0,1,0
3,263,263,3,3,0,1,0
6,279,279,34,10,24,4,3
10,301,301,88,37,51,4,3
5,361,361,170,77,93,4,3
7,397,397,28,28,0,1,0
19,417,417,72,34,38,2,1
2,421,421,19,1,18,4,3
0,433,433,17,10,7,2,1
11,463,463,8,8,0,1,0
14,465,465,94,32,62,3,2
1,469,469,13,13,0,1,0

2,112,112,7,3,4,2,1
4,117,117,35,17,18,3,2
15,126,126,5,5,0,1,0
10,128,128,11,7,4,2,1
19,175,175,11,6,5,2,1
1,181,181,63,63,0,1,0
6,186,186,22,22,0,1,0
18,266,266,1,1,0,1,0
16,270,270,13,6,7,2,1
0,284,284,15,6,9,2,1
12,294,294,19,19,0,1,0
8,308,308,11,11,0,1,0
17,318,318,212,95,117,4,3
14,335,335,5,5,0,1,0
13,385,385,45,21,24,4,3
5,406,406,22,4,18,2,1
9,420,420,41,31,10,3,2
3,430,430,12,5,7,2,1
11,453,453,8,2,6,3,2
7,458,458,2,2,0,1,0

14,130,130,15,15,0,1,0
13,151,151,20,20,0,1,0
2,162,162,14,11,3,2,1
0,237,237,127,89,38,2,1
1,250,250,41,35,6,3,2
12,295,295,50,20,30,4,3
4,303,303,54,14,40,3,2
3,354,354,49,49,0,1,0
7,362,362,84,84,0,1,0
10,379,379,17,17,0,1,0
8,403,403,17,3,14,2,1
9,416,416,23,13,10,3,2
11,444,444,70,54,16,2,1
5,481,481,82,51,31,4,3
6,488,488,1,1,0,1,0

12,117,117,9,9,0,1,0
1,120,120,1,1,0,1,0
5,141,141,8,1,7,2,1
3,142,142,28,2,26,3,2
15,162,162,24,4,20,2,1
11,166,166,7,7,0,1,0
0,186,186,8,8,0,1,0
7,273,273,81,81,0,1,0
8,281,281,17,17,0,1,0
14,291,291,24,6,18,4,3
17,307,307,18,18,0,1,0
16,334,334,19,16,3,2,1
18,340,340,37,37,0,1,0
9,359,359,20,5,15,2,1
2,371,371,5,5,0,1,0
19,401,401,59,59,0,1,0
6,417,417,30,30,0,1,0
13,455,455,21,15,6,2,1
10,481,481,171,171,0,1,0
4,497,497,148,148,0,1,0

1,109,109,5,5,0,1,0
6,120,120,4,4,0,1,0
9,139,139,1,1,0,1,0
18,140,140,9,9,0,1,0
14,150,150,24,15,9,4,3
17,183,183,10,2,8,3,2
11,201,201,7,7,0,1,0
21,226,226,15,15,0,1,0
20,231,231,14,1,13,2,1
3,241,241,1,1,0,1,0
16,243,243,9,5,4,2,1
12,255,255,2,2,0,1,0
13,290,290,94,6,88,4,3
24,293,293,40,40,0,1,0
5,294,294,13,13,0,1,0
26,295,295,3,3,0,1,0
29,301,301,48,48,0,1,0
23,305,305,13,13,0,1,0
7,343,343,9,9,0,1,0
15,354,354,25,25,0,1,0
27,354,354,21,21,0,1,0
0,375,375,20,4,16,2,1
28,383,383,198,75,123,4,3
2,383,383,3,3,0,1,0
19,386,386,5,5,0,1,0
22,406,406,4,4,0,1,0
25,413,413,32,32,0,1,0
8,414,414,9,9,0,1,0
30,429,429,14,3,11,2,1
10,484,484,11,3,8,3,2
4,492,492,4,4,0,1,0

6,112,112,2,2,0,1,0
22,123,123,16,16,0,1,0
2,127,127,1,1,0,1,0
20,135,135,4,4,0,1,0
3,145,145,9,3,6,2,1
4,158,158,17,17,0,1,0
19,164,164,1,1,0,1,0
7,169,169,21,21,0,1,0
0,187,187,28,19,9,4,3
13,191,191,1,1,0,1,0
9,204,204,13,13,0,1,0
21,223,223,58,12,46,3,2
25,233,233,23,23,0,1,0
8,242,242,40,3,37,2,1
24,249,249,32,23,9,4,3
23,252,252,37,13,24,3,2
11,259,259,5,2,3,2,1
10,315,315,1,1,0,1,0
27,316,316,17,17,0,1,0
26,331,331,12,3,9,4,3
16,333,333,2,2,0,1,0
12,355,355,4,4,0,1,0
17,365,365,23,23,0,1,0
18,374,374,88,88,0,1,0
15,377,377,8,8,0,1,0
5,396,396,38,38,0,1,0
14,421,421,68,30,38,3,2
1,450,450,7,7,0,1,0

3,152,152,6,6,0,1,0
19,167,167,13,4,9,4,3
9,196,196,6,6,0,1,0
8,230,230,31,31,0,1,0
20,233,233,24,5,19,2,1
16,263,263,6,3,3,2,1
17,273,273,66,15,51,4,3
4,279,279,3,3,0,1,0
13,325,325,10,10,0,1,0
0,337,337,25,14,11,2,1
1,341,341,20,12,8,3,2
7,395,395,124,16,108,4,3
21,399,399,104,56,48,4,3
11,413,413,63,45,18,2,1
6,416,416,22,22,0,1,0
18,454,454,84,52,32,4,3
12,459,459,20,4,16,3,2
10,461,461,24,24,0,1,0
5,477,477,86,86,0,1,0
2,481,481,1,1,0,1,0
15,483,483,71,71,0,1,0
14,500,500,3,3,0,1,0

16,105,105,14,5,9,2,1
8,163,163,26,17,9,4,3
3,234,234,1,1,0,1,0
19,234,234,12,12,0,1,0
6,259,259,19,19,0,1,0
17,267,267,16,3,13,3,2
13,270,270,35,5,30,3,2
10,275,275,20,20,0,1,0
1,288,288,19,4,15,2,1
18,300,300,76,76,0,1,0
9,336,336,60,60,0,1,0
23,348,348,42,32,10,3,2
2,368,368,45,45,0,1,0
7,370,370,21,6,15,4,3
14,400,400,26,1,25,2,1
20,411,411,51,39,12,4,3
0,417,417,7,7,0,1,0
4,428,428,14,14,0,1,0
15,440,440,25,25,0,1,0
21,465,465,103,91,12,4,3
5,477,477,34,34,0,1,0
11,486,486,51,7,44,3,2
12,492,492,6,2,4,2,1
22,499,499,14,5,9,2,1

14,103,103,2,2,0,1,0
17,136,136,1,1,0,1,0
21,196,196,44,44,0,1,0
9,215,215,23,23,0,1,0
16,217,217,3,3,0,1,0
18,234,234,64,42,22,2,1
7,239,239,14,4,10,2,1
5,241,241,2,2,0,1,0
4,243,243,1,1,0,1,0
20,248,248,5,5,0,1,0
22,250,250,50,24,26,3,2
24,268,268,27,27,0,1,0
11,274,274,42,21,21,4,3
23,295,295,24,19,5,2,1
25,329,329,29,29,0,1,0
12,329,329,31,31,0,1,0
1,342,342,2,2,0,1,0
2,381,381,39,39,0,1,0
15,385,385,28,28,0,1,0
19,396,396,44,14,30,2,1
0,411,411,32,32,0,1,0
3,413,413,45,17,28,3,2
8,435,435,58,25,33,2,1
6,460,460,28,28,0,1,0
10,462,462,36,36,0,1,0
13,469,469,8,8,0,1,0

12,101,101,15,2,13,4,3
4,112,112,7,1,6,3,2
9,116,116,29,16,13,2,1
14,138,138,11,11,0,1,0
15,138,138,4,4,0,1,0
13,157,157,31,6,25,2,1
10,168,168,3,3,0,1,0
3,179,179,41,41,0,1,0
7,240,240,67,53,14,2,1
1,266,266,6,6,0,1,0
6,317,317,17,5,12,4,3
11,365,365,21,12,9,4,3
0,382,382,162,162,0,1,0
8,396,396,11,5,6,2,1
5,401,401,10,10,0,1,0
2,459,459,155,155,0,1,0

16,102,102,10,4,6,3,2
11,136,136,25,25,0,1,0
19,192,192,24,3,21,4,3
20,203,203,43,27,16,3,2
18,209,209,1,1,0,1,0
1,215,215,12,12,0,1,0
0,223,223,5,5,0,1,0
15,236,236,12,6,6,3,2
9,236,236,16,16,0,1,0
8,301,301,49,49,0,1,0
4,342,342,33,8,25,2,1
7,349,349,43,19,24,2,1
13,352,352,67,28,39,2,1
5,385,385,38,38,0,1,0
3,397,397,130,130,0,1,0
6,408,408,23,23,0,1,0
10,417,417,15,5,10,3,2
14,423,423,33,33,0,1,0
17,454,454,19,4,15,3,2
2,470,470,25,25,0,1,0
12,471,471,67,67,0,1,0

17,115,115,3,3,0,1,0
15,124,124,6,1,5,2,1
10,129,129,21,11,10,2,1
9,145,145,25,25,0,1,0
6,161,161,1,1,0,1,0
4,162,162,70,14,56,3,2
8,170,170,1,1,0,1,0
13,197,197,89,67,22,3,2
16,216,216,5,1,4,2,1
1,219,219,78,46,32,2,1
2,248,248,19,19,0,1,0
11,269,269,14,2,12,2,1
12,331,331,35,35,0,1,0
7,337,337,3,3,0,1,0
0,434,434,27,27,0,1,0
3,445,445,36,12,24,2,1
14,469,469,36,4,32,3,2
5,489,489,39,28,11,2,1

3,117,117,6,6,0,1,0
10,120,120,1,1,0,1,0
14,143,143,1,1,0,1,0
19,156,156,1,1,0,1,0
21,164,164,17,17,0,1,0
5,179,179,18,1,17,2,1
7,181,181,14,1,13,3,2
17,185,185,22,22,0,1,0
15,236,236,56,56,0,1,0
8,244,244,11,1,10,3,2
1,252,252,30,30,0,1,0
20,259,259,17,17,0,1,0
13,340,340,85,60,25,2,1
0,343,343,30,30,0,1,0
11,353,353,20,4,16,3,2
12,361,361,9,9,0,1,0
4,383,383,21,11,10,3,2
6,387,387,66,66,0,1,0
18,397,397,27,2,25,2,1
16,399,399,16,16,0,1,0
2,416,416,83,83,0,1,0
9,475,475,50,18,32,2,1
22,479,479,105,105,0,1,0

1,125,125,25,1,24,4,3
8,155,155,43,43,0,1,0
7,169,169,3,3,0,1,0
11,209,209,26,22,4,2,1
16,211,211,13,8,5,2,1
19,231,231,80,6,74,3,2
18,254,254,25,5,20,2,1
12,279,279,1,1,0,1,0
5,287,287,16,4,12,3,2
10,329,329,48,48,0,1,0
4,334,334,23,23,0,1,0
14,363,363,15,15,0,1,0
0,388,388,17,17,0,1,0
6,392,392,23,8,15,4,3
2,423,423,135,45,90,3,2
13,458,458,60,60,0,1,0
15,481,481,63,63,0,1,0
17,495,495,13,1,12,4,3
9,496,496,16,6,10,2,1
3,499,499,14,14,0,1,0

26,114,114,6,6,0,1,0
23,118,118,10,10,0,1,0
27,118,118,3,3,0,1,0
18,132,132,1,1,0,1,0
20,134,134,4,4,0,1,0
3,170,170,32,14,18,4,3
9,189,189,5,5,0,1,0
10,214,214,8,4,4,2,1
7,236,236,1,1,0,1,0
12,243,243,29,8,21,4,3
30,254,254,18,18,0,1,0
22,260,260,10,10,0,1,0
8,273,273,9,9,0,1,0
29,278,278,58,58,0,1,0
24,280,280,2,2,0,1,0
28,282,282,76,46,30,4,3
1,292,292,15,15,0,1,0
31,307,307,103,14,89,4,3
16,319,319,39,12,27,4,3
19,323,323,2,2,0,1,0
6,336,336,7,7,0,1,0
25,344,344,11,11,0,1,0
13,344,344,3,3,0,1,0
5,345,345,1,1,0,1,0
15,349,349,13,13,0,1,0
14,359,359,5,5,0,1,0
0,372,372,29,29,0,1,0
11,385,385,22,22,0,1,0
17,440,440,62,22,40,2,1
2,447,447,39,39,0,1,0
4,466,466,12,12,0,1,0
21,479,479,1,1,0,1,0

15,115,115,19,5,14,2,1
24,125,125,6,6,0,1,0
6,143,143,10,2,8,3,2
21,143,143,6,1,5,2,1
17,198,198,2,2,0,1,0
13,219,219,2,2,0,1,0
23,251,251,91,91,0,1,0
3,283,283,23,5,18,4,3
10,338,338,8,8,0,1,0
9,343,343,42,12,30,2,1
1,362,362,38,38,0,1,0
0,364,364,1,1,0,1,0
19,377,377,23,23,0,1,0
18,383,383,38,38,0,1,0
5,394,394,33,19,14,3,2
16,418,418,14,1,13,2,1
8,452,452,38,38,0,1,0
7,453,453,34,10,24,2,1
20,457,457,27,9,18,4,3
2,458,458,117,99,18,4,3
14,459,459,61,61,0,1,0
22,461,461,110,20,90,3,2
4,476,476,8,8,0,1,0
11,480,480,17,17,0,1,0
12,488,488,2,2,0,1,0

15,109,109,3,3,0,1,0
20,109,109,13,13,0,1,0
21,149,149,34,34,0,1,0
19,161,161,7,7,0,1,0
11,163,163,8,8,0,1,0
5,166,166,42,33,9,4,3
1,167,167,5,1,4,2,1
9,169,169,66,3,63,4,3
10,221,221,23,5,18,4,3
14,235,235,38,25,13,2,1
18,290,290,40,30,10,3,2
13,305,305,25,19,6,2,1
6,323,323,14,5,9,4,3
17,353,353,31,10,21,4,3
7,387,387,16,13,3,2,1
3,389,389,32,32,0,1,0
4,409,409,24,24,0,1,0
16,412,412,88,88,0,1,0
8,416,416,9,3,6,3,2
0,457,457,6,6,0,1,0
12,487,487,6,6,0,1,0
2,489,489,9,3,6,3,2

8,146,146,32,32,0,1,0
26,148,148,16,13,3,2,1
6,154,154,3,3,0,1,0
20,156,156,2,2,0,1,0
12,173,173,11,2,9,2,1
13,187,187,6,1,5,2,1
9,224,224,17,17,0,1,0
25,230,230,36,24,12,2,1
19,237,237,28,28,0,1,0
10,246,246,9,9,0,1,0
24,275,275,27,27,0,1,0
3,278,278,2,2,0,1,0
23,283,283,41,41,0,1,0
0,293,293,1,1,0,1,0
4,298,298,45,15,30,4,3
2,322,322,1,1,0,1,0
7,324,324,37,37,0,1,0
5,339,339,1,1,0,1,0
17,349,349,9,9,0,1,0
15,390,390,35,35,0,1,0
27,395,395,10,1,9,2,1
14,410,410,81,81,0,1,0
11,425,425,21,21,0,1,0
21,429,429,14,14,0,1,0
1,441,441,3,3,0,1,0
18,447,447,153,44,109,4,3
22,460,460,39,39,0,1,0
16,485,485,1,1,0,1,0

26,107,107,14,14,0,1,0
19,123,123,13,13,0,1,0
3,133,133,7,7,0,1,0
4,150,150,2,2,0,1,0
24,198,198,37,37,0,1,0
16,209,209,10,3,7,2,1
12,212,212,1,1,0,1,0
15,227,227,1,1,0,1,0
6,251,251,3,3,0,1,0
9,254,254,21,21,0,1,0
8,270,270,26,26,0,1,0
18,297,297,43,19,24,3,2
5,303,303,44,8,36,4,3
25,320,320,2,2,0,1,0
1,321,321,1,1,0,1,0
10,324,324,42,42,0,1,0
14,342,342,46,19,27,2,1
11,348,348,23,13,10,3,2
7,354,354,19,8,11,4,3
13,356,356,42,20,22,3,2
21,386,386,13,13,0,1,0
22,403,403,26,8,18,3,2
17,409,409,4,4,0,1,0
20,411,411,61,61,0,1,0
0,442,442,36,12,24,4,3
27,454,454,15,15,0,1,0
23,477,477,128,128,0,1,0
2,490,490,22,22,0,1,0

1,105,105,9,9,0,1,0
9,105,105,12,12,0,1,0
3,127,127,39,39,0,1,0
4,130,130,4,4,0,1,0
0,135,135,1,1,0,1,0
18,164,164,95,75,20,3,2
15,175,175,3,3,0,1,0
10,183,183,20,20,0,1,0
5,195,195,11,5,6,2,1
14,248,248,4,4,0,1,0
19,251,251,20,20,0,1,0
2,274,274,1,1,0,1,0
6,283,283,87,87,0,1,0
7,291,291,54,4,50,3,2
12,293,293,36,36,0,1,0
11,306,306,9,1,8,2,1
16,311,311,7,7,0,1,0
8,396,396,2,2,0,1,0
13,456,456,17,17,0,1,0
17,471,471,48,16,32,3,2

3,164,164,15,2,13,2,1
17,167,167,16,10,6,2,1
5,204,204,40,2,38,4,3
16,241,241,4,1,3,2,1
7,247,247,23,15,8,3,2
10,256,256,2,2,0,1,0
6,288,288,9,9,0,1,0
11,305,305,14,8,6,3,2
14,319,319,1,1,0,1,0
1,321,321,89,89,0,1,0
8,324,324,9,9,0,1,0
0,336,336,79,79,0,1,0
2,358,358,38,38,0,1,0
12,383,383,12,12,0,1,0
4,402,402,17,17,0,1,0
13,403,403,130,7,123,4,3
15,422,422,68,35,33,2,1
9,441,441,189,189,0,1,0
18,497,497,4,4,0,1,0

3,101,101,3,3,0,1,0
14,118,118,1,1,0,1,0
16,152,152,27,9,18,4,3
5,188,188,28,28,0,1,0
10,188,188,4,4,0,1,0
9,194,194,7,2,5,2,1
0,209,209,70,41,29,2,1
2,219,219,13,1,12,3,2
6,308,308,19,2,17,2,1
18,317,317,31,8,23,2,1
8,327,327,27,21,6,3,2
4,345,345,17,17,0,1,0
20,355,355,86,55,31,2,1
21,363,363,29,29,0,1,0
7,388,388,7,1,6,2,1
19,393,393,30,12,18,4,3
1,416,416,106,106,0,1,0
13,417,417,88,88,0,1,0
15,434,434,45,45,0,1,0
11,437,437,2,2,0,1,0
17,478,478,36,36,0,1,0
12,485,485,24,24,0,1,0

17,103,103,23,4,19,2,1
2,126,126,1,1,0,1,0
8,147,147,42,18,24,3,2
14,150,150,5,5,0,1,0
7,153,153,21,21,0,1,0
5,183,183,53,41,12,4,3
4,202,202,13,9,4,2,1
9,242,242,37,25,12,4,3
16,261,261,37,29,8,2,1
0,300,300,45,45,0,1,0
15,302,302,20,20,0,1,0
1,384,384,9,9,0,1,0
3,420,420,38,8,30,4,3
12,440,440,49,49,0,1,0
11,456,456,73,73,0,1,0
18,456,456,35,35,0,1,0
6,462,462,24,24,0,1,0
13,464,464,22,22,0,1,0
10,485,485,51,9,42,2,1

16,117,117,19,4,15,4,3
5,141,141,5,5,0,1,0
21,169,169,18,6,12,3,2
22,195,195,27,27,0,1,0
15,200,200,3,3,0,1,0
12,222,222,1,1,0,1,0
4,227,227,6,6,0,1,0
13,266,266,8,3,5,2,1
10,324,324,40,1,39,4,3
2,344,344,7,7,0,1,0
19,358,358,118,82,36,4,3
11,381,381,96,45,51,4,3
9,387,387,6,2,4,2,1
17,426,426,14,14,0,1,0
18,432,432,32,4,28,2,1
8,434,434,1,1,0,1,0
20,435,435,18,18,0,1,0
1,438,438,66,20,46,2,1
3,443,443,25,25,0,1,0
6,463,463,89,53,36,3,2
7,471,471,90,66,24,4,3
0,483,483,16,16,0,1,0
14,492,492,90,40,50,2,1

12,117,117,9,9,0,1,0
3,144,144,5,5,0,1,0
6,149,149,13,13,0,1,0
16,155,155,3,3,0,1,0
10,164,164,1,1,0,1,0
19,177,177,2,2,0,1,0
24,183,183,36,6,30,3,2
5,189,189,1,1,0,1,0
26,204,204,46,1,45,4,3
21,215,215,21,21,0,1,0
11,222,222,19,13,6,2,1
22,222,222,15,9,6,3,2
1,273,273,22,22,0,1,0
25,287,287,3,3,0,1,0
0,292,292,46,21,25,2,1
18,295,295,34,8,26,2,1
7,299,299,10,10,0,1,0
17,336,336,49,49,0,1,0
8,342,342,27,27,0,1,0
14,361,361,66,66,0,1,0
13,367,367,42,42,0,1,0
23,372,372,27,5,22,3,2
4,416,416,13,13,0,1,0
9,488,488,15,7,8,3,2
2,493,493,8,5,3,2,1
20,495,495,87,11,76,3,2
15,498,498,30,30,0,1,0

4,100,100,13,7,6,3,2
13,100,100,1,1,0,1,0
11,114,114,10,10,0,1,0
8,140,140,16,2,14,2,1
3,142,142,10,10,0,1,0
10,142,142,4,4,0,1,0
0,181,181,11,11,0,1,0
5,195,195,6,2,4,2,1
21,196,196,22,1,21,2,1
23,219,219,30,23,7,2,1
19,222,222,26,11,15,4,3
1,304,304,37,13,24,3,2
18,307,307,2,2,0,1,0
7,339,339,24,24,0,1,0
9,342,342,1,1,0,1,0
20,353,353,29,29,0,1,0
2,364,364,89,62,27,4,3
6,368,368,34,1,33,3,2
15,371,371,110,110,0,1,0
12,387,387,15,15,0,1,0
14,420,420,125,47,78,3,2
16,424,424,15,15,0,1,0
22,485,485,3,3,0,1,0
17,487,487,14,14,0,1,0

1,115,115,23,17,6,2,1
13,117,117,20,12,8,3,2
4,126,126,15,3,12,2,1
8,141,141,1,1,0,1,0
14,149,149,7,3,4,2,1
3,162,162,3,3,0,1,0
11,212,212,30,1,29,2,1
2,224,224,2,2,0,1,0
10,241,241,56,41,15,4,3
15,246,246,1,1,0,1,0
16,282,282,22,7,15,4,3
12,286,286,70,46,24,2,1
0,287,287,52,13,39,4,3
20,388,388,22,22,0,1,0
5,389,389,4,1,3,2,1
19,429,429,5,1,4,2,1
7,436,436,3,3,0,1,0
9,453,453,77,62,15,4,3
6,471,471,70,70,0,1,0
18,483,483,17,17,0,1,0
17,485,485,160,145,15,2,1

0,126,126,36,15,21,4,3
5,184,184,3,3,0,1,0
6,194,194,1,1,0,1,0
7,196,196,48,6,42,2,1
15,221,221,44,44,0,1,0
8,229,229,4,1,3,2,1
4,244,244,118,118,0,1,0
14,280,280,61,54,7,2,1
9,284,284,6,6,0,1,0
12,318,318,16,1,15,4,3
1,321,321,76,76,0,1,0
3,367,367,29,23,6,3,2
11,387,387,6,6,0,1,0
10,462,462,11,4,7,2,1
13,464,464,151,139,12,2,1
2,496,496,1,1,0,1,0

0,112,112,1,1,0,1,0
5,173,173,1,1,0,1,0
16,203,203,4,4,0,1,0
7,204,204,13,13,0,1,0
11,204,204,34,34,0,1,0
22,210,210,39,4,35,2,1
19,212,212,9,1,8,3,2
17,219,219,9,9,0,1,0
18,226,226,41,41,0,1,0
8,233,233,23,11,12,4,3
20,236,236,31,15,16,3,2
15,248,248,53,53,0,1,0
25,263,263,20,3,17,2,1
24,282,282,9,9,0,1,0
12,297,297,11,5,6,2,1
2,311,311,7,7,0,1,0
9,327,327,23,23,0,1,0
26,328,328,53,46,7,2,1
27,353,353,14,6,8,2,1
13,366,366,41,41,0,1,0
10,368,368,29,5,24,4,3
4,393,393,19,19,0,1,0
23,398,398,79,28,51,4,3
1,400,400,14,14,0,1,0
14,426,426,23,23,0,1,0
3,480,480,1,1,0,1,0
6,494,494,11,11,0,1,0
21,500,500,34,8,26,3,2

15,126,126,31,10,21,2,1
21,133,133,3,3,0,1,0
10,171,171,15,15,0,1,0
16,221,221,2,2,0,1,0
4,251,251,4,4,0,1,0
2,265,265,10,10,0,1,0
13,291,291,6,6,0,1,0
19,302,302,130,130,0,1,0
20,324,324,30,8,22,3,2
5,340,340,12,2,10,2,1
14,357,357,44,44,0,1,0
0,366,366,52,35,17,4,3
12,371,371,12,12,0,1,0
6,379,379,189,189,0,1,0
7,382,382,27,27,0,1,0
3,403,403,9,3,6,3,2
1,414,414,42,42,0,1,0
17,435,435,11,1,10,2,1
8,436,436,33,10,23,2,1
9,446,446,3,3,0,1,0
11,449,449,3,3,0,1,0
18,480,480,56,56,0,1,0

17,116,116,2,2,0,1,0
9,122,122,9,9,0,1,0
8,138,138,26,17,9,2,1
0,147,147,1,1,0,1,0
13,161,161,8,1,7,2,1
4,191,191,8,8,0,1,0
6,207,207,65,65,0,1,0
16,225,225,10,4,6,2,1
19,242,242,34,34,0,1,0
7,255,255,5,5,0,1,0
20,258,258,21,21,0,1,0
10,293,293,51,51,0,1,0
14,311,311,106,47,59,4,3
2,335,335,2,2,0,1,0
12,371,371,22,22,0,1,0
1,414,414,26,26,0,1,0
18,414,414,69,69,0,1,0
3,417,417,13,3,10,3,2
15,433,433,67,9,58,4,3
5,445,445,2,2,0,1,0
11,485,485,86,82,4,2,1
21,490,490,33,17,16,2,1

0,101,101,8,3,5,2,1
19,122,122,7,2,5,2,1
3,141,141,4,4,0,1,0
5,147,147,6,6,0,1,0
22,164,164,28,28,0,1,0
7,215,215,2,2,0,1,0
18,230,230,38,38,0,1,0
26,243,243,5,1,4,2,1
4,244,244,10,10,0,1,0
17,249,249,28,1,27,3,2
15,272,272,12,12,0,1,0
25,281,281,27,17,10,2,1
23,284,284,23,23,0,1,0
21,333,333,8,8,0,1,0
8,333,333,13,13,0,1,0
10,335,335,74,26,48,2,1
14,337,337,45,13,32,2,1
16,366,366,18,18,0,1,0
9,369,369,76,76,0,1,0
20,374,374,121,121,0,1,0
6,402,402,46,46,0,1,0
11,404,404,7,1,6,2,1
12,408,408,8,8,0,1,0
24,435,435,29,25,4,2,1
1,452,452,12,12,0,1,0
2,459,459,5,5,0,1,0
13,466,466,10,10,0,1,0

10,100,100,1,1,0,1,0
14,118,118,4,1,3,2,1
9,128,128,59,59,0,1,0
17,141,141,15,6,9,2,1
6,167,167,1,1,0,1,0
11,200,200,8,8,0,1,0
15,202,202,26,26,0,1,0
18,208,208,14,14,0,1,0
23,210,210,15,15,0,1,0
20,210,210,44,44,0,1,0
8,247,247,3,3,0,1,0
24,250,250,12,3,9,4,3
21,253,253,39,7,32,3,2
19,281,281,19,19,0,1,0
16,288,288,65,30,35,2,1
12,288,288,1,1,0,1,0
3,304,304,82,72,10,3,2
2,313,313,53,53,0,1,0
4,316,316,11,11,0,1,0
1,352,352,1,1,0,1,0
22,354,354,16,16,0,1,0
13,357,357,7,7,0,1,0
5,359,359,4,4,0,1,0
0,459,459,9,1,8,3,2
7,478,478,7,3,4,2,1

18,113,113,4,4,0,1,0
19,114,114,12,12,0,1,0
14,135,135,9,9,0,1,0
22,136,136,9,6,3,2,1
1,174,174,13,4,9,4,3
21,192,192,47,47,0,1,0
25,194,194,19,19,0,1,0
24,208,208,63,12,51,4,3
2,209,209,27,27,0,1,0
8,226,226,19,4,15,2,1
7,238,238,15,1,14,2,1
11,285,285,22,10,12,4,3
16,291,291,19,19,0,1,0
12,304,304,7,7,0,1,0
10,313,313,9,9,0,1,0
4,321,321,9,9,0,1,0
15,326,326,27,27,0,1,0
0,334,334,50,20,30,2,1
5,362,362,52,52,0,1,0
20,367,367,3,3,0,1,0
6,415,415,45,17,28,2,1
17,442,442,46,34,12,3,2
23,484,484,47,20,27,4,3
3,491,491,1,1,0,1,0
9,491,491,4,4,0,1,0
13,495,495,16,12,4,2,1

9,105,105,13,13,0,1,0
6,114,114,1,1,0,1,0
4,129,129,1,1,0,1,0
14,160,160,4,4,0,1,0
12,171,171,49,8,41,4,3
2,179,179,26,26,0,1,0
0,198,198,22,22,0,1,0
8,213,213,2,2,0,1,0
10,239,239,22,10,12,3,2
11,243,243,3,3,0,1,0
7,285,285,14,14,0,1,0
17,293,293,38,9,29,2,1
18,301,301,112,104,8,2,1
13,384,384,22,13,9,2,1
3,405,405,34,34,0,1,0
1,420,420,210,210,0,1,0
15,421,421,7,7,0,1,0
5,442,442,83,68,15,4,3
16,454,454,4,4,0,1,0

19,104,104,30,30,0,1,0
2,132,132,1,1,0,1,0
23,136,136,1,1,0,1,0
25,141,141,40,40,0,1,0
21,141,141,2,2,0,1,0
20,170,170,19,7,12,2,1
4,186,186,4,4,0,1,0
5,190,190,7,7,0,1,0
12,224,224,1,1,0,1,0
17,250,250,24,4,20,3,2
18,256,256,26,3,23,2,1
10,270,270,19,1,18,2,1
22,281,281,30,6,24,4,3
13,310,310,3,3,0,1,0
24,343,343,35,35,0,1,0
9,359,359,6,6,0,1,0
8,378,378,141,69,72,4,3
16,386,386,6,6,0,1,0
14,417,417,13,1,12,4,3
7,417,417,36,36,0,1,0
1,419,419,49,6,43,2,1
0,430,430,10,5,5,2,1
15,433,433,8,1,7,2,1
11,456,456,20,15,5,2,1
6,477,477,28,28,0,1,0
3,480,480,88,88,0,1,0

15,117,117,9,9,0,1,0
12,129,129,33,33,0,1,0
5,143,143,27,27,0,1,0
9,148,148,41,21,20,2,1
0,165,165,8,8,0,1,0
6,197,197,52,10,42,2,1
13,220,220,6,6,0,1,0
14,232,232,32,32,0,1,0
4,323,323,47,47,0,1,0
7,325,325,112,112,0,1,0
17,336,336,6,6,0,1,0
16,342,342,24,16,8,2,1
10,373,373,43,7,36,3,2
2,394,394,9,9,0,1,0
8,420,420,29,29,0,1,0
3,435,435,4,4,0,1,0
1,457,457,35,35,0,1,0
11,477,477,35,12,23,2,1

5,107,107,3,3,0,1,0
16,182,182,9,1,8,2,1
22,188,188,13,1,12,4,3
3,198,198,11,7,4,2,1
19,213,213,6,1,5,2,1
7,220,220,47,47,0,1,0
6,226,226,9,9,0,1,0
15,233,233,32,19,13,2,1
14,250,250,5,5,0,1,0
23,273,273,50,30,20,3,2
9,276,276,5,2,3,2,1
0,280,280,24,10,14,2,1
4,280,280,66,35,31,2,1
8,289,289,1,1,0,1,0
20,315,315,99,41,58,3,2
13,358,358,15,15,0,1,0
18,358,358,16,6,10,2,1
17,364,364,59,59,0,1,0
10,371,371,37,20,17,2,1
21,375,375,41,41,0,1,0
11,393,393,8,8,0,1,0
12,400,400,44,37,7,2,1
1,424,424,60,60,0,1,0
2,462,462,4,1,3,2,1

6,110,110,3,3,0,1,0
12,121,121,5,5,0,1,0
7,161,161,28,28,0,1,0
13,161,161,49,1,48,3,2
3,170,170,17,17,0,1,0
16,173,173,24,2,22,2,1
8,182,182,9,9,0,1,0
4,187,187,7,7,0,1,0
10,212,212,8,8,0,1,0
2,225,225,33,33,0,1,0
14,245,245,10,10,0,1,0
15,272,272,15,15,0,1,0
5,295,295,115,93,22,2,1
9,298,298,93,27,66,4,3
11,312,312,5,5,0,1,0
0,331,331,55,55,0,1,0
17,431,431,55,55,0,1,0
1,446,446,28,8,20,3,2

14,105,105,23,23,0,1,0
17,150,150,14,14,0,1,0
12,162,162,21,21,0,1,0
11,176,176,3,3,0,1,0
4,220,220,2,2,0,1,0
0,220,220,43,43,0,1,0
9,222,222,11,11,0,1,0
5,227,227,53,53,0,1,0
2,235,235,33,33,0,1,0
10,308,308,21,3,18,2,1
1,308,308,117,117,0,1,0
15,318,318,50,50,0,1,0
16,322,322,51,51,0,1,0
3,347,347,10,10,0,1,0
13,387,387,53,35,18,3,2
8,409,409,35,35,0,1,0
7,473,473,2,2,0,1,0
6,498,498,55,7,48,2,1

7,101,101,33,9,24,4,3
10,149,149,11,7,4,2,1
0,188,188,75,75,0,1,0
8,219,219,2,2,0,1,0
11,225,225,28,4,24,2,1
3,238,238,64,64,0,1,0
4,338,338,15,1,14,3,2
2,359,359,2,2,0,1,0
5,388,388,6,3,3,2,1
6,416,416,10,10,0,1,0
9,421,421,23,14,9,4,3
12,436,436,194,134,60,4,3
13,471,471,2,2,0,1,0
1,479,479,206,206,0,1,0

11,126,126,20,20,0,1,0
21,135,135,1,1,0,1,0
4,144,144,6,6,0,1,0
6,148,148,3,3,0,1,0
9,177,177,23,13,10,3,2
5,179,179,33,33,0,1,0
10,185,185,1,1,0,1,0
24,186,186,7,7,0,1,0
13,191,191,5,2,3,2,1
14,197,197,3,3,0,1,0
12,204,204,1,1,0,1,0
1,231,231,1,1,0,1,0
20,253,253,22,22,0,1,0
23,261,261,47,25,22,4,3
15,268,268,27,27,0,1,0
22,273,273,7,7,0,1,0
2,276,276,12,2,10,3,2
8,289,289,25,14,11,2,1
25,299,299,10,10,0,1,0
0,303,303,9,5,4,2,1
16,310,310,25,13,12,2,1
19,318,318,42,42,0,1,0
18,353,353,114,70,44,3,2
7,381,381,71,71,0,1,0
17,424,424,94,73,21,2,1
3,480,480,30,12,18,3,2

10,134,134,18,3,15,2,1
18,139,139,27,9,18,4,3
14,173,173,9,9,0,1,0
7,189,189,7,7,0,1,0
13,193,193,2,2,0,1,0
15,194,194,16,16,0,1,0
5,214,214,17,9,8,3,2
20,217,217,11,11,0,1,0
22,232,232,4,1,3,2,1
3,240,240,29,29,0,1,0
12,272,272,13,13,0,1,0
2,277,277,11,11,0,1,0
17,291,291,53,53,0,1,0
21,359,359,6,3,3,2,1
19,390,390,140,140,0,1,0
9,391,391,46,46,0,1,0
11,398,398,102,61,41,2,1
8,420,420,1,1,0,1,0
1,428,428,1,1,0,1,0
4,430,430,26,26,0,1,0
16,431,431,69,12,57,4,3
0,454,454,56,56,0,1,0
6,466,466,37,37,0,1,0

12,139,139,30,10,20,2,1
8,142,142,1,1,0,1,0
11,144,144,19,15,4,2,1
14,146,146,9,4,5,2,1
5,188,188,20,20,0,1,0
18,194,194,15,15,0,1,0
6,199,199,3,3,0,1,0
1,225,225,3,3,0,1,0
16,286,286,26,5,21,2,1
4,320,320,20,20,0,1,0
17,353,353,58,8,50,3,2
10,402,402,26,6,20,2,1
2,412,412,23,16,7,2,1
7,414,414,93,45,48,4,3
15,416,416,48,20,28,2,1
0,422,422,171,135,36,3,2
3,434,434,93,1,92,4,3
9,454,454,70,13,57,4,3
13,497,497,17,17,0,1,0

0,105,105,12,12,0,1,0
16,123,123,33,33,0,1,0
23,126,126,29,18,11,2,1
25,143,143,44,12,32,2,1
3,160,160,4,4,0,1,0
14,166,166,11,11,0,1,0
5,180,180,1,1,0,1,0
17,188,188,2,2,0,1,0
22,197,197,8,5,3,2,1
13,234,234,9,9,0,1,0
24,236,236,1,1,0,1,0
2,302,302,30,14,16,3,2
10,303,303,22,22,0,1,0
1,303,303,12,7,5,2,1
18,313,313,8,2,6,3,2
15,348,348,2,2,0,1,0
7,357,357,54,30,24,2,1
8,361,361,19,9,10,3,2
19,365,365,3,3,0,1,0
12,372,372,102,102,0,1,0
21,385,385,56,16,40,2,1
4,406,406,27,9,18,4,3
11,434,434,2,2,0,1,0
6,446,446,11,11,0,1,0
9,456,456,28,19,9,2,1
20,497,497,42,42,0,1,0

3,106,106,66,66,0,1,0
4,124,124,8,5,3,2,1
16,140,140,20,20,0,1,0
17,149,149,31,31,0,1,0
13,157,157,9,9,0,1,0
2,230,230,13,13,0,1,0
11,307,307,34,34,0,1,0
7,351,351,39,39,0,1,0
12,355,355,71,25,46,3,2
10,401,401,20,20,0,1,0
9,419,419,1,1,0,1,0
6,435,435,29,12,17,2,1
8,435,435,36,36,0,1,0
1,448,448,33,33,0,1,0
5,452,452,1,1,0,1,0
15,464,464,116,116,0,1,0
14,467,467,5,5,0,1,0
0,498,498,52,52,0,1,0

0,130,130,50,50,0,1,0
13,185,185,40,24,16,2,1
10,210,210,16,5,11,2,1
17,234,234,7,7,0,1,0
11,275,275,7,7,0,1,0
1,283,283,26,26,0,1,0
8,290,290,53,53,0,1,0
7,312,312,46,46,0,1,0
15,325,325,88,88,0,1,0
16,339,339,50,50,0,1,0
2,355,355,52,8,44,3,2
3,382,382,39,39,0,1,0
4,387,387,14,14,0,1,0
12,408,408,33,18,15,4,3
6,417,417,52,17,35,2,1
14,418,418,33,33,0,1,0
5,477,477,32,27,5,2,1
9,481,481,3,3,0,1,0

14,109,109,4,4,0,1,0
3,129,129,12,12,0,1,0
21,184,184,25,1,24,4,3
19,193,193,5,2,3,2,1
11,206,206,3,3,0,1,0
18,226,226,4,4,0,1,0
9,253,253,7,7,0,1,0
2,259,259,6,6,0,1,0
0,291,291,83,83,0,1,0
6,315,315,74,64,10,2,1
16,333,333,10,10,0,1,0
13,364,364,12,12,0,1,0
10,369,369,22,22,0,1,0
4,382,382,6,6,0,1,0
1,396,396,39,12,27,4,3
17,420,420,48,6,42,4,3
20,436,436,8,8,0,1,0
7,438,438,70,22,48,3,2
12,445,445,19,19,0,1,0
8,470,470,2,2,0,1,0
5,471,471,41,22,19,2,1
15,496,496,331,321,10,2,1

25,144,144,10,10,0,1,0
14,146,146,4,4,0,1,0
13,160,160,10,10,0,1,0
7,161,161,14,14,0,1,0
2,167,167,1,1,0,1,0
23,169,169,52,52,0,1,0
8,172,172,1,1,0,1,0
0,196,196,23,1,22,2,1
10,246,246,1,1,0,1,0
20,251,251,6,6,0,1,0
18,275,275,42,42,0,1,0
26,292,292,1,1,0,1,0
22,296,296,4,4,0,1,0
9,297,297,16,2,14,2,1
21,308,308,80,80,0,1,0
27,334,334,15,15,0,1,0
12,336,336,8,8,0,1,0
3,365,365,6,6,0,1,0
1,369,369,16,16,0,1,0
16,374,374,51,32,19,2,1
17,376,376,13,13,0,1,0
5,384,384,77,25,52,3,2
4,386,386,6,6,0,1,0
19,388,388,88,88,0,1,0
24,394,394,6,6,0,1,0
6,423,423,42,42,0,1,0
11,433,433,41,9,32,3,2
15,482,482,35,5,30,2,1

21,155,155,11,11,0,1,0
0,158,158,12,5,7,2,1
7,173,173,15,4,11,3,2
18,179,179,29,25,4,2,1
10,180,180,28,28,0,1,0
13,181,181,5,5,0,1,0
14,195,195,3,3,0,1,0
16,206,206,4,4,0,1,0
2,228,228,1,1,0,1,0
23,246,246,113,44,69,3,2
15,271,271,3,3,0,1,0
5,285,285,74,54,20,2,1
22,287,287,59,34,25,2,1
12,295,295,22,22,0,1,0
9,311,311,2,2,0,1,0
1,315,315,29,21,8,2,1
4,319,319,8,3,5,2,1
17,341,341,1,1,0,1,0
20,361,361,30,22,8,2,1
11,363,363,46,46,0,1,0
6,379,379,16,16,0,1,0
3,399,399,8,8,0,1,0
24,446,446,27,27,0,1,0
19,467,467,21,3,18,4,3
8,486,486,43,43,0,1,0

17,105,105,20,16,4,2,1
2,142,142,1,1,0,1,0
20,143,143,26,26,0,1,0
6,163,163,60,57,3,2,1
19,180,180,5,5,0,1,0
12,223,223,8,2,6,2,1
10,239,239,3,3,0,1,0
1,240,240,23,23,0,1,0
18,254,254,64,64,0,1,0
22,261,261,32,32,0,1,0
15,270,270,40,2,38,2,1
24,273,273,13,13,0,1,0
21,296,296,3,3,0,1,0
16,309,309,4,4,0,1,0
4,342,342,11,11,0,1,0
3,377,377,6,6,0,1,0
23,380,380,46,16,30,3,2
11,385,385,2,2,0,1,0
8,385,385,8,8,0,1,0
13,393,393,19,3,16,3,2
7,402,402,4,4,0,1,0
0,402,402,75,75,0,1,0
14,451,451,33,27,6,2,1
5,479,479,54,8,46,2,1
9,498,498,38,38,0,1,0

5,103,103,5,5,0,1,0
17,119,119,2,2,0,1,0
6,129,129,9,9,0,1,0
16,167,167,10,10,0,1,0
4,174,174,28,1,27,4,3
15,200,200,10,2,8,3,2
12,215,215,13,13,0,1,0
14,254,254,100,85,15,4,3
18,273,273,14,8,6,3,2
7,288,288,62,26,36,3,2
9,300,300,56,43,13,3,2
10,300,300,24,1,23,2,1
2,338,338,42,42,0,1,0
0,386,386,53,53,0,1,0
3,407,407,78,78,0,1,0
8,417,417,21,4,17,4,3
1,431,431,44,44,0,1,0
13,467,467,80,58,22,3,2
11,487,487,25,7,18,3,2

21,100,100,1,1,0,1,0
16,115,115,5,5,0,1,0
1,116,116,4,4,0,1,0
10,126,126,2,2,0,1,0
0,145,145,8,8,0,1,0
7,159,159,2,2,0,1,0
8,159,159,23,23,0,1,0
11,172,172,4,4,0,1,0
4,193,193,1,1,0,1,0
20,200,200,60,24,36,3,2
19,204,204,11,11,0,1,0
12,269,269,30,30,0,1,0
18,289,289,14,2,12,2,1
24,294,294,1,1,0,1,0
23,299,299,14,14,0,1,0
14,312,312,44,26,18,4,3
15,343,343,153,63,90,4,3
5,380,380,28,2,26,2,1
22,382,382,48,40,8,3,2
3,406,406,15,7,8,2,1
6,412,412,57,17,40,2,1
13,414,414,40,3,37,4,3
2,443,443,69,57,12,3,2
9,444,444,25,25,0,1,0
17,472,472,22,22,0,1,0

18,149,149,2,2,0,1,0
3,198,198,17,17,0,1,0
15,209,209,98,23,75,4,3
17,211,211,9,9,0,1,0
20,230,230,17,2,15,4,3
6,240,240,13,9,4,2,1
1,241,241,42,20,22,3,2
14,249,249,8,8,0,1,0
11,263,263,11,3,8,3,2
13,265,265,50,50,0,1,0
12,272,272,19,11,8,2,1
2,272,272,26,2,24,4,3
10,284,284,14,14,0,1,0
19,300,300,8,8,0,1,0
7,317,317,7,7,0,1,0
16,352,352,17,17,0,1,0
21,356,356,55,55,0,1,0
5,437,437,6,6,0,1,0
8,448,448,46,20,26,3,2
4,459,459,81,65,16,3,2
0,471,471,48,48,0,1,0
9,474,474,88,12,76,3,2

8,112,112,7,7,0,1,0
13,130,130,24,6,18,3,2
7,131,131,2,2,0,1,0
6,171,171,3,3,0,1,0
20,176,176,1,1,0,1,0
14,178,178,9,2,7,2,1
0,196,196,6,6,0,1,0
9,239,239,2,2,0,1,0
12,257,257,27,3,24,3,2
16,290,290,5,5,0,1,0
23,327,327,19,19,0,1,0
18,352,352,3,3,0,1,0
3,353,353,21,21,0,1,0
4,367,367,25,25,0,1,0
22,402,402,1,1,0,1,0
17,417,417,202,121,81,4,3
10,420,420,32,14,18,2,1
1,422,422,53,53,0,1,0
15,454,454,113,113,0,1,0
11,459,459,127,127,0,1,0
21,463,463,83,21,62,4,3
2,464,464,1,1,0,1,0
5,487,487,34,34,0,1,0
19,500,500,33,33,0,1,0

3,105,105,10,10,0,1,0
10,122,122,6,6,0,1,0
15,125,125,19,19,0,1,0
26,150,150,9,2,7,2,1
21,180,180,13,13,0,1,0
22,182,182,2,2,0,1,0
6,194,194,11,3,8,2,1
24,264,264,111,39,72,4,3
9,266,266,2,2,0,1,0
14,274,274,23,23,0,1,0
20,297,297,58,33,25,2,1
17,316,316,39,39,0,1,0
19,344,344,6,6,0,1,0
1,351,351,9,9,0,1,0
8,352,352,34,34,0,1,0
23,352,352,17,11,6,3,2
16,353,353,27,17,10,3,2
11,359,359,15,15,0,1,0
13,363,363,16,16,0,1,0
18,404,404,40,25,15,4,3
5,420,420,16,6,10,2,1
12,436,436,47,29,18,2,1
7,445,445,2,2,0,1,0
25,447,447,34,34,0,1,0
4,457,457,33,24,9,4,3
0,495,495,60,22,38,2,1
2,500,500,14,14,0,1,0

0,125,125,7,4,3,2,1
3,130,130,8,8,0,1,0
14,147,147,4,1,3,2,1
11,148,148,1,1,0,1,0
1,159,159,29,16,13,2,1
13,167,167,13,9,4,2,1
2,179,179,1,1,0,1,0
4,203,203,4,4,0,1,0
12,232,232,27,27,0,1,0
20,261,261,17,5,12,3,2
6,263,263,76,76,0,1,0
19,265,265,11,11,0,1,0
15,269,269,34,2,32,3,2
22,277,277,19,6,13,2,1
17,280,280,107,42,65,4,3
9,283,283,7,3,4,2,1
7,288,288,1,1,0,1,0
10,327,327,32,10,22,3,2
8,372,372,38,38,0,1,0
5,385,385,53,31,22,3,2
21,415,415,69,69,0,1,0
16,446,446,16,4,12,4,3
18,449,449,57,9,48,2,1

6,129,129,5,5,0,1,0
17,134,134,4,4,0,1,0
4,149,149,30,30,0,1,0
11,188,188,36,36,0,1,0
12,191,191,27,8,19,3,2
10,194,194,8,8,0,1,0
21,200,200,48,48,0,1,0
7,218,218,5,1,4,2,1
18,227,227,26,26,0,1,0
20,249,249,43,43,0,1,0
13,290,290,13,13,0,1,0
2,302,302,3,3,0,1,0
9,314,314,30,30,0,1,0
5,314,314,3,3,0,1,0
14,320,320,20,20,0,1,0
22,339,339,1,1,0,1,0
16,384,384,24,15,9,4,3
8,416,416,17,7,10,2,1
1,448,448,52,52,0,1,0
23,455,455,52,46,6,3,2
15,464,464,15,15,0,1,0
3,471,471,50,50,0,1,0
0,485,485,20,20,0,1,0
19,489,489,137,93,44,4,3

10,120,120,2,2,0,1,0
7,174,174,1,1,0,1,0
6,179,179,50,50,0,1,0
9,181,181,27,27,0,1,0
12,194,194,1,1,0,1,0
15,198,198,62,62,0,1,0
4,205,205,31,5,26,3,2
5,244,244,4,4,0,1,0
13,268,268,7,7,0,1,0
17,281,281,97,97,0,1,0
2,289,289,90,70,20,2,1
3,312,312,1,1,0,1,0
18,340,340,42,15,27,2,1
0,364,364,69,60,9,2,1
8,370,370,37,37,0,1,0
1,454,454,20,20,0,1,0
11,472,472,36,14,22,3,2
16,484,484,24,24,0,1,0
14,499,499,10,5,5,2,1

12,115,115,12,12,0,1,0
8,117,117,23,23,0,1,0
13,122,122,15,15,0,1,0
15,131,131,23,8,15,4,3
7,158,158,32,29,3,2,1
11,158,158,15,15,0,1,0
16,189,189,12,12,0,1,0
6,199,199,34,19,15,4,3
1,214,214,43,6,37,2,1
17,232,232,5,1,4,2,1
3,245,245,15,15,0,1,0
0,267,267,24,24,0,1,0
4,320,320,7,7,0,1,0
19,324,324,52,22,30,3,2
2,349,349,17,17,0,1,0
10,377,377,71,71,0,1,0
9,403,403,25,25,0,1,0
18,406,406,19,19,0,1,0
5,452,452,21,21,0,1,0
14,495,495,71,25,46,3,2

14,126,126,20,9,11,2,1
6,126,126,39,39,0,1,0
5,166,166,30,30,0,1,0
1,176,176,31,31,0,1,0
18,203,203,5,5,0,1,0
17,212,212,22,22,0,1,0
7,230,230,45,15,30,2,1
8,255,255,19,4,15,2,1
13,258,258,45,45,0,1,0
0,258,258,34,16,18,4,3
4,281,281,1,1,0,1,0
3,351,351,2,2,0,1,0
10,368,368,70,22,48,4,3
15,379,379,49,33,16,2,1
16,398,398,32,12,20,4,3
11,410,410,49,49,0,1,0
9,421,421,5,2,3,2,1
12,452,452,57,57,0,1,0
2,466,466,11,11,0,1,0

16,117,117,3,3,0,1,0
8,134,134,5,1,4,2,1
1,146,146,42,2,40,2,1
6,153,153,11,5,6,2,1
4,177,177,10,4,6,2,1
17,213,213,12,12,0,1,0
3,236,236,96,96,0,1,0
2,240,240,15,15,0,1,0
14,306,306,12,12,0,1,0
0,310,310,8,5,3,2,1
18,320,320,67,67,0,1,0
19,330,330,99,99,0,1,0
7,339,339,26,17,9,2,1
5,370,370,22,4,18,2,1
13,392,392,124,2,122,4,3
15,408,408,3,3,0,1,0
9,411,411,7,7,0,1,0
12,417,417,10,1,9,2,1
11,427,427,29,9,20,3,2
10,464,464,33,17,16,2,1

7,140,140,2,2,0,1,0
14,150,150,5,5,0,1,0
17,204,204,1,1,0,1,0
15,217,217,15,5,10,2,1
2,226,226,19,19,0,1,0
9,276,276,32,32,0,1,0
8,321,321,28,21,7,2,1
6,338,338,58,58,0,1,0
1,350,350,38,12,26,3,2
0,358,358,4,4,0,1,0
10,395,395,71,64,7,2,1
13,397,397,54,54,0,1,0
5,416,416,90,78,12,4,3
11,438,438,53,18,35,4,3
12,459,459,62,26,36,2,1
16,479,479,113,20,93,4,3
4,494,494,72,72,0,1,0
3,498,498,176,100,76,4,3

9,121,121,18,18,0,1,0
14,129,129,19,9,10,3,2
2,174,174,11,7,4,2,1
21,178,178,1,1,0,1,0
8,190,190,2,2,0,1,0
12,207,207,11,11,0,1,0
1,214,214,20,20,0,1,0
3,228,228,6,2,4,2,1
17,229,229,41,14,27,2,1
10,230,230,18,18,0,1,0
11,278,278,4,4,0,1,0
20,289,289,4,4,0,1,0
4,300,300,40,17,23,2,1
7,318,318,11,11,0,1,0
5,343,343,38,16,22,4,3
18,345,345,2,2,0,1,0
0,362,362,13,3,10,4,3
15,371,371,38,38,0,1,0
23,453,453,43,13,30,4,3
19,457,457,193,97,96,3,2
6,470,470,12,12,0,1,0
24,480,480,18,18,0,1,0
16,485,485,98,98,0,1,0
13,488,488,63,21,42,3,2
22,490,490,26,22,4,2,1

2,102,102,30,30,0,1,0
15,150,150,13,13,0,1,0
14,171,171,1,1,0,1,0
9,193,193,12,12,0,1,0
3,211,211,21,21,0,1,0
10,253,253,29,14,15,4,3
7,283,283,50,32,18,2,1
11,286,286,87,87,0,1,0
6,288,288,32,32,0,1,0
1,307,307,5,2,3,2,1
5,343,343,15,7,8,3,2
8,361,361,57,57,0,1,0
4,372,372,107,24,83,4,3
13,446,446,57,57,0,1,0
12,450,450,30,30,0,1,0
16,469,469,11,5,6,3,2
0,477,477,119,119,0,1,0

15,100,100,26,12,14,2,1
19,110,110,19,4,15,4,3
1,121,121,6,6,0,1,0
14,125,125,12,8,4,2,1
2,145,145,1,1,0,1,0
18,159,159,5,2,3,2,1
6,168,168,1,1,0,1,0
13,192,192,2,2,0,1,0
17,197,197,26,26,0,1,0
20,202,202,24,24,0,1,0
11,215,215,17,5,12,4,3
16,263,263,55,10,45,4,3
5,288,288,23,17,6,3,2
12,299,299,32,5,27,4,3
4,317,317,21,13,8,3,2
0,328,328,28,28,0,1,0
21,363,363,3,3,0,1,0
3,396,396,73,73,0,1,0
7,401,401,28,16,12,2,1
10,410,410,16,12,4,2,1
8,448,448,4,4,0,1,0
9,481,481,153,153,0,1,0
22,485,485,39,39,0,1,0

21,112,112,10,10,0,1,0
13,122,122,13,5,8,2,1
7,136,136,12,8,4,2,1
1,139,139,19,1,18,2,1
0,196,196,27,27,0,1,0
18,206,206,4,4,0,1,0
14,229,229,3,3,0,1,0
12,279,279,37,37,0,1,0
19,283,283,57,57,0,1,0
4,286,286,14,4,10,3,2
8,302,302,12,12,0,1,0
26,303,303,24,24,0,1,0
5,321,321,19,1,18,2,1
2,324,324,26,26,0,1,0
10,334,334,49,49,0,1,0
20,336,336,64,64,0,1,0
22,352,352,8,8,0,1,0
24,366,366,17,17,0,1,0
9,406,406,10,10,0,1,0
23,431,431,155,57,98,3,2
11,441,441,2,2,0,1,0
6,443,443,5,1,4,2,1
16,443,443,20,1,19,4,3
3,444,444,2,2,0,1,0
15,447,447,9,9,0,1,0
25,460,460,42,42,0,1,0
17,487,487,9,1,8,2,1

13,118,118,12,12,0,1,0
23,121,121,22,22,0,1,0
22,127,127,32,23,9,2,1
4,131,131,27,1,26,2,1
19,165,165,27,27,0,1,0
10,166,166,17,17,0,1,0
9,184,184,19,6,13,4,3
3,187,187,2,2,0,1,0
14,190,190,3,3,0,1,0
27,198,198,2,2,0,1,0
21,236,236,6,6,0,1,0
5,245,245,4,4,0,1,0
15,247,247,12,3,9,4,3
7,252,252,17,5,12,4,3
25,264,264,15,15,0,1,0
8,265,265,33,33,0,1,0
26,274,274,12,4,8,3,2
11,279,279,5,5,0,1,0
1,308,308,7,7,0,1,0
6,314,314,10,10,0,1,0
16,316,316,4,1,3,2,1
0,347,347,12,12,0,1,0
17,368,368,25,25,0,1,0
2,376,376,4,1,3,2,1
24,401,401,24,24,0,1,0
20,452,452,94,94,0,1,0
12,466,466,49,49,0,1,0
18,499,499,66,66,0,1,0

10,103,103,1,1,0,1,0
19,142,142,4,4,0,1,0
9,158,158,1,1,0,1,0
20,185,185,13,3,10,2,1
11,198,198,57,57,0,1,0
7,233,233,1,1,0,1,0
16,234,234,3,3,0,1,0
8,243,243,1,1,0,1,0
17,245,245,25,25,0,1,0
12,249,249,75,30,45,4,3
5,264,264,23,23,0,1,0
1,265,265,42,7,35,2,1
18,267,267,7,7,0,1,0
22,321,321,192,119,73,4,3
15,324,324,4,1,3,2,1
6,383,383,21,9,12,4,3
21,390,390,67,58,9,4,3
0,401,401,26,26,0,1,0
3,428,428,9,9,0,1,0
4,443,443,43,30,13,2,1
14,444,444,37,25,12,3,2
2,453,453,3,3,0,1,0
13,454,454,5,5,0,1,0

4,185,185,9,9,0,1,0
21,212,212,3,3,0,1,0
23,264,264,3,3,0,1,0
17,297,297,50,50,0,1,0
3,301,301,10,10,0,1,0
10,311,311,11,11,0,1,0
0,312,312,85,49,36,2,1
14,323,323,46,39,7,2,1
12,323,323,4,1,3,2,1
6,328,328,5,5,0,1,0
7,368,368,21,21,0,1,0
20,371,371,16,7,9,4,3
19,371,371,80,80,0,1,0
13,373,373,103,58,45,2,1
11,377,377,12,12,0,1,0
8,389,389,1,1,0,1,0
18,415,415,56,17,39,4,3
1,432,432,1,1,0,1,0
16,433,433,110,87,23,2,1
5,471,471,6,3,3,2,1
9,472,472,119,119,0,1,0
2,490,490,24,12,12,4,3
15,493,493,32,32,0,1,0
22,497,497,34,34,0,1,0

8,148,148,3,3,0,1,0
11,157,157,7,7,0,1,0
6,193,193,8,8,0,1,0
9,210,210,9,9,0,1,0
5,212,212,3,3,0,1,0
0,216,216,17,17,0,1,0
13,252,252,20,20,0,1,0
7,256,256,5,5,0,1,0
17,260,260,53,53,0,1,0
14,273,273,23,23,0,1,0
19,293,293,37,19,18,3,2
16,309,309,57,36,21,4,3
22,364,364,36,36,0,1,0
3,367,367,58,58,0,1,0
12,368,368,94,94,0,1,0
4,374,374,9,5,4,2,1
2,383,383,16,16,0,1,0
10,414,414,3,3,0,1,0
24,414,414,155,99,56,4,3
1,430,430,82,18,64,3,2
23,444,444,20,6,14,2,1
18,449,449,8,8,0,1,0
21,478,478,15,4,11,2,1
20,495,495,12,2,10,3,2
15,500,500,4,4,0,1,0

16,133,133,2,2,0,1,0
10,142,142,17,17,0,1,0
13,150,150,10,3,7,2,1
18,162,162,1,1,0,1,0
8,193,193,7,7,0,1,0
2,230,230,7,7,0,1,0
14,254,254,85,85,0,1,0
1,282,282,1,1,0,1,0
12,283,283,5,5,0,1,0
11,337,337,48,48,0,1,0
6,364,364,55,55,0,1,0
4,376,376,14,6,8,2,1
9,408,408,9,9,0,1,0
15,411,411,140,127,13,3,2
7,422,422,63,63,0,1,0
5,426,426,253,214,39,2,1
17,432,432,29,22,7,2,1
0,469,469,24,24,0,1,0
3,477,477,12,2,10,2,1
19,481,481,7,7,0,1,0

0,124,124,16,4,12,4,3
3,138,138,9,3,6,3,2
16,142,142,3,3,0,1,0
10,143,143,11,11,0,1,0
7,153,153,10,4,6,3,2
1,177,177,11,1,10,2,1
4,186,186,101,81,20,3,2
8,230,230,2,2,0,1,0
15,305,305,19,14,5,2,1
12,319,319,11,3,8,2,1
5,326,326,7,7,0,1,0
2,333,333,61,50,11,2,1
9,385,385,130,112,18,2,1
11,454,454,173,141,32,2,1
6,474,474,46,6,40,3,2
13,493,493,4,1,3,2,1
14,500,500,63,40,23,2,1

11,102,102,2,2,0,1,0
13,107,107,10,10,0,1,0
9,135,135,10,10,0,1,0
15,151,151,16,16,0,1,0
1,158,158,12,12,0,1,0
10,160,160,3,3,0,1,0
25,162,162,4,4,0,1,0
24,163,163,11,11,0,1,0
26,165,165,32,32,0,1,0
23,172,172,11,11,0,1,0
12,242,242,4,4,0,1,0
28,286,286,16,16,0,1,0
17,287,287,10,1,9,4,3
22,289,289,84,34,50,3,2
5,291,291,14,2,12,3,2
14,300,300,29,29,0,1,0
0,326,326,26,26,0,1,0
27,332,332,15,7,8,2,1
6,351,351,2,2,0,1,0
2,351,351,4,1,3,2,1
18,363,363,6,6,0,1,0
3,369,369,10,10,0,1,0
21,378,378,18,18,0,1,0
4,398,398,64,38,26,2,1
20,401,401,40,22,18,4,3
8,430,430,2,2,0,1,0
19,442,442,39,31,8,2,1
7,457,457,1,1,0,1,0
16,464,464,10,4,6,3,2
29,472,472,9,9,0,1,0
30,478,478,152,142,10,3,2

21,101,101,70,13,57,4,3
19,138,138,10,3,7,2,1
6,169,169,23,2,21,3,2
17,191,191,12,12,0,1,0
15,203,203,5,5,0,1,0
1,214,214,57,23,34,3,2
4,215,215,33,33,0,1,0
2,257,257,7,7,0,1,0
23,265,265,7,7,0,1,0
11,269,269,12,12,0,1,0
12,271,271,12,12,0,1,0
3,280,280,3,3,0,1,0
0,285,285,3,3,0,1,0
5,306,306,6,1,5,2,1
13,319,319,61,61,0,1,0
22,323,323,3,3,0,1,0
7,336,336,7,1,6,3,2
16,346,346,46,46,0,1,0
18,386,386,18,18,0,1,0
10,396,396,25,25,0,1,0
9,402,402,26,16,10,3,2
14,447,447,21,21,0,1,0
20,476,476,3,3,0,1,0
8,486,486,23,17,6,3,2

18,115,115,1,1,0,1,0
11,141,141,8,5,3,2,1
7,150,150,6,6,0,1,0
15,204,204,16,6,10,2,1
8,224,224,54,54,0,1,0
19,231,231,49,19,30,4,3
10,231,231,11,5,6,3,2
0,269,269,29,13,16,2,1
3,287,287,51,15,36,4,3
6,289,289,37,37,0,1,0
14,293,293,3,3,0,1,0
9,308,308,10,2,8,2,1
1,340,340,87,21,66,3,2
12,374,374,28,28,0,1,0
16,397,397,27,27,0,1,0
4,413,413,44,18,26,2,1
13,434,434,102,21,81,4,3
2,435,435,3,3,0,1,0
17,460,460,150,40,110,4,3
5,470,470,2,2,0,1,0

7,158,158,17,17,0,1,0
15,206,206,29,29,0,1,0
11,215,215,19,19,0,1,0
12,232,232,2,2,0,1,0
19,239,239,12,12,0,1,0
20,242,242,26,26,0,1,0
16,272,272,17,12,5,2,1
9,285,285,34,34,0,1,0
5,288,288,23,23,0,1,0
8,291,291,1,1,0,1,0
13,302,302,36,30,6,2,1
1,326,326,10,10,0,1,0
2,339,339,19,19,0,1,0
10,355,355,37,37,0,1,0
14,370,370,113,113,0,1,0
17,392,392,19,19,0,1,0
3,405,405,142,78,64,4,3
4,430,430,38,38,0,1,0
6,456,456,23,23,0,1,0
18,474,474,90,90,0,1,0
0,492,492,55,25,30,3,2

13,131,131,7,1,6,3,2
16,160,160,10,4,6,3,2
2,167,167,25,25,0,1,0
8,175,175,22,22,0,1,0
11,222,222,2,2,0,1,0
12,231,231,6,6,0,1,0
4,270,270,13,13,0,1,0
5,282,282,50,50,0,1,0
6,366,366,5,5,0,1,0
9,376,376,79,25,54,3,2
7,390,390,103,79,24,4,3
1,398,398,102,102,0,1,0
14,447,447,66,47,19,2,1
15,453,453,11,1,10,3,2
0,457,457,68,44,24,4,3
3,478,478,147,142,5,2,1
10,498,498,100,12,88,3,2

5,121,121,25,7,18,4,3
2,154,154,51,35,16,2,1
8,168,168,8,8,0,1,0
9,210,210,23,23,0,1,0
0,211,211,47,19,28,2,1
3,226,226,12,9,3,2,1
10,318,318,12,12,0,1,0
6,331,331,23,1,22,2,1
4,340,340,67,9,58,4,3
7,346,346,2,2,0,1,0
11,361,361,77,77,0,1,0
14,363,363,17,1,16,2,1
13,390,390,49,3,46,3,2
15,397,397,143,2,141,4,3
12,403,403,32,1,31,2,1
16,489,489,42,9,33,4,3
1,498,498,10,10,0,1,0

20,128,128,16,16,0,1,0
19,131,131,8,8,0,1,0
1,149,149,9,9,0,1,0
13,173,173,1,1,0,1,0
12,183,183,29,21,8,3,2
15,183,183,8,8,0,1,0
9,192,192,21,21,0,1,0
3,196,196,28,1,27,2,1
8,222,222,26,26,0,1,0
16,232,232,3,3,0,1,0
6,235,235,56,28,28,3,2
17,240,240,32,29,3,2,1
22,261,261,8,8,0,1,0
7,261,261,4,4,0,1,0
14,268,268,9,9,0,1,0
0,322,322,4,1,3,2,1
2,394,394,29,15,14,3,2
5,398,398,6,6,0,1,0
18,411,411,142,58,84,4,3
10,472,472,64,64,0,1,0
4,476,476,7,3,4,2,1
11,486,486,5,5,0,1,0
21,499,499,167,137,30,4,3

15,120,120,25,13,12,4,3
12,136,136,35,35,0,1,0
4,140,140,19,19,0,1,0
0,143,143,23,13,10,2,1
16,150,150,3,3,0,1,0
1,207,207,19,16,3,2,1
13,241,241,18,18,0,1,0
9,244,244,4,1,3,2,1
14,258,258,41,41,0,1,0
3,299,299,26,22,4,2,1
5,329,329,162,72,90,4,3
17,335,335,13,5,8,3,2
8,394,394,36,36,0,1,0
2,403,403,7,7,0,1,0
7,423,423,21,8,13,2,1
6,446,446,30,1,29,4,3
10,490,490,7,1,6,3,2
11,496,496,124,91,33,4,3

10,117,117,3,3,0,1,0
12,152,152,37,37,0,1,0
0,155,155,3,3,0,1,0
9,195,195,52,28,24,3,2
4,213,213,18,18,0,1,0
14,222,222,8,8,0,1,0
11,244,244,22,22,0,1,0
1,249,249,1,1,0,1,0
18,265,265,41,18,23,2,1
7,320,320,14,14,0,1,0
16,348,348,140,80,60,3,2
13,379,379,27,12,15,2,1
6,387,387,142,36,106,4,3
3,415,415,1,1,0,1,0
17,429,429,19,4,15,4,3
15,453,453,12,6,6,3,2
2,459,459,83,70,13,2,1
8,469,469,6,6,0,1,0
5,481,481,58,19,39,2,1
19,482,482,11,11,0,1,0

14,119,119,27,20,7,2,1
2,148,148,17,17,0,1,0
11,165,165,14,14,0,1,0
0,172,172,27,11,16,3,2
9,193,193,8,8,0,1,0
3,212,212,4,4,0,1,0
12,238,238,39,5,34,3,2
5,247,247,10,10,0,1,0
17,266,266,9,9,0,1,0
6,313,313,2,2,0,1,0
16,318,318,9,9,0,1,0
15,391,391,101,101,0,1,0
10,407,407,57,57,0,1,0
1,409,409,93,93,0,1,0
13,421,421,26,4,22,3,2
18,430,430,12,3,9,4,3
19,451,451,40,1,39,4,3
4,457,457,105,60,45,2,1
8,462,462,10,10,0,1,0
7,462,462,113,71,42,3,2

10,180,180,1,1,0,1,0
8,240,240,20,20,0,1,0
1,248,248,36,8,28,3,2
5,251,251,23,23,0,1,0
18,258,258,26,26,0,1,0
20,305,305,4,4,0,1,0
16,312,312,6,6,0,1,0
12,331,331,32,32,0,1,0
6,332,332,58,42,16,3,2
7,369,369,4,4,0,1,0
14,376,376,9,9,0,1,0
3,400,400,40,40,0,1,0
19,415,415,77,50,27,4,3
2,416,416,10,10,0,1,0
13,418,418,56,15,41,2,1
4,422,422,130,54,76,4,3
11,423,423,68,68,0,1,0
15,450,450,2,2,0,1,0
0,460,460,32,32,0,1,0
9,463,463,41,29,12,2,1
17,466,466,174,153,21,2,1

12,102,102,1,1,0,1,0
16,105,105,1,1,0,1,0
21,115,115,9,9,0,1,0
18,115,115,6,1,5,2,1
17,134,134,24,17,7,2,1
2,156,156,1,1,0,1,0
4,187,187,1,1,0,1,0
13,223,223,7,4,3,2,1
0,230,230,7,1,6,2,1
14,236,236,97,47,50,3,2
10,287,287,1,1,0,1,0
11,327,327,114,114,0,1,0
6,327,327,83,8,75,4,3
1,333,333,1,1,0,1,0
15,363,363,39,12,27,4,3
8,379,379,17,17,0,1,0
19,391,391,82,9,73,4,3
5,427,427,13,13,0,1,0
3,436,436,81,72,9,4,3
9,470,470,68,68,0,1,0
7,471,471,21,12,9,4,3
20,494,494,23,1,22,3,2

2,136,136,1,1,0,1,0
19,147,147,2,2,0,1,0
18,147,147,19,8,11,2,1
17,181,181,3,3,0,1,0
1,186,186,21,21,0,1,0
3,187,187,32,4,28,2,1
20,213,213,33,33,0,1,0
13,253,253,120,3,117,4,3
10,275,275,3,3,0,1,0
7,295,295,1,1,0,1,0
9,300,300,155,38,117,4,3
5,344,344,2,2,0,1,0
6,365,365,40,19,21,4,3
11,372,372,45,23,22,4,3
16,408,408,29,29,0,1,0
14,418,418,32,5,27,4,3
0,425,425,63,63,0,1,0
8,449,449,2,2,0,1,0
12,474,474,29,19,10,3,2
4,476,476,5,5,0,1,0
15,476,476,1,1,0,1,0

26,105,105,8,8,0,1,0
11,121,121,11,11,0,1,0
0,132,132,4,1,3,2,1
24,134,134,25,25,0,1,0
20,146,146,17,2,15,2,1
18,159,159,26,19,7,2,1
1,167,167,6,3,3,2,1
7,180,180,4,4,0,1,0
14,186,186,18,18,0,1,0
23,190,190,23,13,10,3,2
5,254,254,6,3,3,2,1
3,259,259,21,21,0,1,0
25,282,282,7,7,0,1,0
15,307,307,6,6,0,1,0
2,337,337,20,14,6,3,2
16,347,347,25,11,14,2,1
8,365,365,34,34,0,1,0
6,366,366,34,34,0,1,0
9,366,366,22,22,0,1,0
19,424,424,19,19,0,1,0
10,428,428,54,54,0,1,0
13,429,429,15,9,6,2,1
12,434,434,11,11,0,1,0
4,455,455,63,7,56,4,3
21,458,458,49,21,28,2,1
17,462,462,49,49,0,1,0
22,485,485,86,78,8,3,2

9,113,113,4,4,0,1,0
14,128,128,2,2,0,1,0
8,130,130,18,18,0,1,0
10,154,154,10,4,6,2,1
2,157,157,4,4,0,1,0
4,163,163,19,19,0,1,0
0,175,175,13,13,0,1,0
21,179,179,11,11,0,1,0
22,181,181,92,92,0,1,0
15,212,212,19,4,15,4,3
3,215,215,2,2,0,1,0
7,220,220,18,18,0,1,0
20,223,223,5,5,0,1,0
6,228,228,25,1,24,3,2
16,293,293,9,9,0,1,0
11,299,299,3,3,0,1,0
1,325,325,18,4,14,2,1
17,360,360,18,6,12,4,3
18,380,380,115,69,46,2,1
19,387,387,5,5,0,1,0
12,420,420,3,3,0,1,0
13,424,424,79,46,33,4,3
23,429,429,14,5,9,2,1
5,476,476,89,73,16,3,2

12,176,176,10,3,7,2,1
14,209,209,19,10,9,4,3
16,215,215,2,2,0,1,0
8,226,226,3,3,0,1,0
9,239,239,5,5,0,1,0
2,261,261,56,7,49,2,1
0,276,276,1,1,0,1,0
10,307,307,78,60,18,2,1
11,323,323,39,12,27,4,3
4,329,329,16,11,5,2,1
17,349,349,74,74,0,1,0
15,352,352,15,5,10,2,1
7,375,375,14,5,9,4,3
6,394,394,30,9,21,4,3
1,408,408,122,122,0,1,0
13,420,420,126,72,54,4,3
5,422,422,9,9,0,1,0
3,494,494,198,184,14,2,1

5,100,100,59,24,35,2,1
14,102,102,4,1,3,2,1
3,136,136,2,2,0,1,0
6,162,162,24,18,6,3,2
2,229,229,2,2,0,1,0
10,295,295,27,27,0,1,0
15,297,297,18,9,9,4,3
12,364,364,102,14,88,3,2
9,376,376,41,8,33,4,3
7,391,391,6,3,3,2,1
4,397,397,59,15,44,4,3
0,410,410,5,5,0,1,0
1,414,414,135,57,78,4,3
8,440,440,57,8,49,3,2
13,455,455,9,9,0,1,0
11,459,459,103,70,33,3,2

19,127,127,12,4,8,3,2
3,161,161,5,1,4,2,1
8,188,188,2,2,0,1,0
11,229,229,6,3,3,2,1
13,233,233,51,51,0,1,0
1,263,263,14,7,7,2,1
9,266,266,3,3,0,1,0
18,292,292,69,12,57,4,3
12,293,293,32,9,23,4,3
21,310,310,31,31,0,1,0
7,317,317,90,61,29,2,1
10,319,319,7,7,0,1,0
4,336,336,129,95,34,3,2
20,364,364,23,23,0,1,0
14,388,388,41,1,40,4,3
2,411,411,12,12,0,1,0
17,446,446,49,37,12,4,3
5,447,447,25,16,9,4,3
0,458,458,25,13,12,3,2
6,479,479,68,68,0,1,0
16,487,487,25,9,16,3,2
15,490,490,14,8,6,3,2

5,117,117,3,3,0,1,0
3,123,123,1,1,0,1,0
20,140,140,15,15,0,1,0
18,141,141,23,23,0,1,0
14,144,144,11,11,0,1,0
0,167,167,2,2,0,1,0
6,199,199,40,40,0,1,0
4,204,204,5,2,3,2,1
1,225,225,49,7,42,3,2
9,228,228,8,8,0,1,0
2,274,274,22,22,0,1,0
13,306,306,25,25,0,1,0
12,311,311,79,22,57,4,3
22,317,317,13,13,0,1,0
10,341,341,18,18,0,1,0
17,351,351,51,3,48,2,1
11,372,372,16,1,15,4,3
15,384,384,83,33,50,3,2
16,409,409,66,36,30,2,1
19,411,411,28,28,0,1,0
7,458,458,37,4,33,4,3
21,493,493,27,27,0,1,0
8,500,500,34,12,22,3,2

0,144,144,15,15,0,1,0
9,145,145,1,1,0,1,0
6,180,180,35,13,22,3,2
17,186,186,23,23,0,1,0
3,210,210,33,33,0,1,0
4,220,220,1,1,0,1,0
5,235,235,10,10,0,1,0
18,237,237,67,67,0,1,0
13,262,262,1,1,0,1,0
12,281,281,40,26,14,3,2
7,333,333,7,7,0,1,0
14,362,362,9,9,0,1,0
8,399,399,97,97,0,1,0
10,420,420,4,4,0,1,0
1,428,428,12,4,8,2,1
11,446,446,71,47,24,4,3
19,446,446,27,15,12,2,1
2,449,449,135,70,65,4,3
15,464,464,136,7,129,4,3
16,488,488,8,8,0,1,0

3,114,114,2,2,0,1,0
15,117,117,1,1,0,1,0
25,142,142,6,6,0,1,0
11,162,162,41,2,39,2,1
27,173,173,24,24,0,1,0
2,176,176,1,1,0,1,0
6,186,186,27,18,9,2,1
16,191,191,10,10,0,1,0
5,196,196,9,9,0,1,0
13,196,196,2,2,0,1,0
20,207,207,43,13,30,3,2
18,220,220,4,1,3,2,1
1,236,236,14,1,13,2,1
12,266,266,3,3,0,1,0
23,270,270,60,50,10,2,1
22,282,282,20,1,19,2,1
14,288,288,8,8,0,1,0
4,301,301,68,68,0,1,0
0,307,307,21,15,6,3,2
19,321,321,15,1,14,3,2
9,324,324,2,2,0,1,0
28,367,367,80,46,34,3,2
10,381,381,5,5,0,1,0
21,409,409,20,20,0,1,0
8,451,451,40,40,0,1,0
24,464,464,18,6,12,2,1
26,484,484,41,41,0,1,0
17,497,497,9,3,6,3,2
7,497,497,13,13,0,1,0

15,115,115,12,12,0,1,0
19,121,121,3,3,0,1,0
13,136,136,4,4,0,1,0
11,146,146,27,13,14,2,1
4,148,148,21,3,18,3,2
5,154,154,20,5,15,4,3
12,162,162,50,10,40,3,2
3,213,213,36,3,33,4,3
2,218,218,3,3,0,1,0
16,235,235,11,11,0,1,0
1,302,302,82,26,56,3,2
14,315,315,7,7,0,1,0
0,337,337,53,53,0,1,0
10,340,340,99,99,0,1,0
9,423,423,13,4,9,2,1
18,460,460,43,43,0,1,0
6,471,471,1,1,0,1,0
8,475,475,13,13,0,1,0
17,484,484,9,9,0,1,0
7,485,485,76,22,54,4,3

2,101,101,15,15,0,1,0
4,131,131,13,5,8,3,2
15,134,134,4,4,0,1,0
13,160,160,25,11,14,3,2
0,166,166,15,15,0,1,0
7,192,192,10,7,3,2,1
11,207,207,35,35,0,1,0
10,216,216,14,5,9,2,1
8,232,232,24,24,0,1,0
6,238,238,7,7,0,1,0
9,243,243,20,20,0,1,0
14,255,255,8,4,4,2,1
1,282,282,83,53,30,4,3
16,300,300,32,7,25,2,1
3,316,316,7,7,0,1,0
17,355,355,111,108,3,2,1
5,420,420,155,122,33,4,3
12,496,496,32,20,12,4,3

20,106,106,46,46,0,1,0
16,128,128,1,1,0,1,0
5,147,147,15,4,11,2,1
9,165,165,1,1,0,1,0
4,171,171,3,3,0,1,0
13,177,177,18,12,6,3,2
3,179,179,20,11,9,4,3
19,232,232,19,8,11,2,1
12,241,241,31,31,0,1,0
21,270,270,25,11,14,2,1
2,282,282,15,15,0,1,0
6,294,294,34,12,22,2,1
10,305,305,33,33,0,1,0
8,341,341,107,89,18,2,1
15,351,351,53,42,11,2,1
14,354,354,11,11,0,1,0
18,359,359,24,24,0,1,0
17,427,427,10,10,0,1,0
1,435,435,18,2,16,3,2
7,440,440,38,38,0,1,0
0,475,475,46,28,18,4,3
11,489,489,24,6,18,2,1

0,125,125,11,11,0,1,0
16,174,174,50,3,47,3,2
25,181,181,11,5,6,3,2
3,187,187,8,8,0,1,0
2,195,195,3,3,0,1,0
15,199,199,5,1,4,2,1
26,202,202,36,26,10,3,2
6,212,212,3,3,0,1,0
10,218,218,10,10,0,1,0
23,219,219,19,19,0,1,0
18,278,278,37,10,27,2,1
19,321,321,22,4,18,3,2
5,361,361,22,10,12,4,3
12,364,364,15,15,0,1,0
4,370,370,1,1,0,1,0
20,388,388,9,5,4,2,1
14,391,391,16,16,0,1,0
21,396,396,130,100,30,2,1
13,407,407,10,4,6,3,2
1,410,410,72,28,44,3,2
24,420,420,67,67,0,1,0
9,423,423,41,17,24,4,3
22,444,444,7,7,0,1,0
8,454,454,23,23,0,1,0
17,468,468,29,11,18,4,3
11,483,483,22,22,0,1,0
7,496,496,23,19,4,2,1

21,117,117,10,10,0,1,0
20,146,146,2,2,0,1,0
23,155,155,20,20,0,1,0
3,171,171,4,4,0,1,0
14,176,176,21,1,20,2,1
9,190,190,8,8,0,1,0
11,217,217,5,5,0,1,0
12,243,243,46,17,29,3,2
0,253,253,25,15,10,4,3
10,255,255,55,6,49,2,1
8,293,293,5,5,0,1,0
19,294,294,2,2,0,1,0
2,300,300,6,2,4,2,1
5,301,301,8,8,0,1,0
22,336,336,6,6,0,1,0
1,337,337,9,2,7,2,1
18,356,356,23,8,15,2,1
24,389,389,6,2,4,2,1
6,400,400,5,5,0,1,0
4,401,401,1,1,0,1,0
15,415,415,64,20,44,3,2
7,454,454,77,67,10,3,2
16,464,464,135,33,102,4,3
17,479,479,168,94,74,3,2
13,493,493,56,56,0,1,0

15,126,126,4,4,0,1,0
6,171,171,26,4,22,2,1
0,174,174,60,11,49,2,1
7,177,177,23,13,10,3,2
3,198,198,33,8,25,3,2
17,238,238,4,4,0,1,0
10,251,251,26,26,0,1,0
4,316,316,5,2,3,2,1
9,322,322,73,73,0,1,0
5,331,331,2,2,0,1,0
8,376,376,13,13,0,1,0
13,395,395,29,19,10,3,2
11,424,424,32,3,29,2,1
16,444,444,163,151,12,4,3
12,455,455,53,53,0,1,0
1,458,458,67,45,22,3,2
14,458,458,31,31,0,1,0
2,488,488,69,51,18,2,1

15,122,122,1,1,0,1,0
18,124,124,38,38,0,1,0
4,165,165,4,4,0,1,0
16,193,193,12,12,0,1,0
20,270,270,31,4,27,2,1
5,273,273,11,11,0,1,0
12,311,311,72,21,51,4,3
11,343,343,9,9,0,1,0
10,344,344,90,58,32,4,3
0,350,350,1,1,0,1,0
6,362,362,1,1,0,1,0
13,380,380,32,32,0,1,0
9,390,390,71,71,0,1,0
19,391,391,7,7,0,1,0
7,397,397,21,11,10,3,2
8,452,452,2,2,0,1,0
21,454,454,49,49,0,1,0
2,457,457,12,12,0,1,0
17,465,465,22,6,16,3,2
14,467,467,67,67,0,1,0
1,483,483,4,4,0,1,0
3,490,490,230,192,38,2,1

0,169,169,36,6,30,3,2
2,211,211,28,28,0,1,0
4,217,217,23,23,0,1,0
3,254,254,6,3,3,2,1
1,278,278,132,132,0,1,0
11,278,278,33,18,15,4,3
8,309,309,71,35,36,4,3
6,317,317,25,18,7,2,1
13,334,334,5,1,4,2,1
10,337,337,14,14,0,1,0
5,339,339,51,51,0,1,0
9,340,340,47,47,0,1,0
7,368,368,65,65,0,1,0
15,400,400,61,61,0,1,0
14,404,404,28,28,0,1,0
12,420,420,39,25,14,2,1

12,116,116,4,4,0,1,0
21,131,131,31,10,21,2,1
20,147,147,14,14,0,1,0
9,162,162,7,7,0,1,0
17,180,180,1,1,0,1,0
6,184,184,15,15,0,1,0
24,186,186,39,7,32,3,2
19,189,189,10,10,0,1,0
0,194,194,43,43,0,1,0
4,229,229,17,11,6,2,1
8,240,240,10,10,0,1,0
23,245,245,16,7,9,2,1
10,247,247,8,4,4,2,1
16,252,252,1,1,0,1,0
18,268,268,25,25,0,1,0
13,290,290,9,9,0,1,0
14,337,337,22,1,21,4,3
2,350,350,10,1,9,4,3
7,382,382,31,22,9,4,3
15,398,398,29,19,10,2,1
3,405,405,47,4,43,2,1
5,413,413,68,54,14,2,1
26,421,421,89,51,38,3,2
25,455,455,9,9,0,1,0
1,466,466,3,3,0,1,0
11,489,489,2,2,0,1,0
22,489,489,67,34,33,2,1

17,100,100,9,9,0,1,0
21,104,104,9,2,7,2,1
23,172,172,72,28,44,2,1
11,181,181,20,8,12,4,3
7,190,190,8,8,0,1,0
4,193,193,68,1,67,4,3
14,232,232,3,3,0,1,0
9,242,242,22,22,0,1,0
1,263,263,8,8,0,1,0
6,269,269,4,4,0,1,0
19,284,284,8,8,0,1,0
22,328,328,60,60,0,1,0
5,331,331,4,4,0,1,0
3,332,332,12,8,4,2,1
15,348,348,15,15,0,1,0
10,372,372,68,60,8,3,2
18,389,389,7,7,0,1,0
25,390,390,77,54,23,2,1
2,423,423,33,33,0,1,0
12,426,426,24,24,0,1,0
13,451,451,10,4,6,3,2
8,453,453,5,1,4,2,1
16,465,465,33,33,0,1,0
0,468,468,2,2,0,1,0
20,473,473,18,6,12,3,2
24,479,479,2,2,0,1,0

6,106,106,22,13,9,4,3
0,140,140,3,3,0,1,0
15,140,140,15,1,14,4,3
18,168,168,1,1,0,1,0
5,172,172,47,20,27,4,3
8,172,172,15,15,0,1,0
10,184,184,22,4,18,4,3
3,212,212,1,1,0,1,0
1,214,214,39,27,12,3,2
20,234,234,22,22,0,1,0
7,297,297,1,1,0,1,0
2,309,309,19,9,10,3,2
11,319,319,70,70,0,1,0
4,325,325,43,43,0,1,0
13,337,337,7,7,0,1,0
17,338,338,39,39,0,1,0
19,341,341,63,63,0,1,0
14,346,346,61,61,0,1,0
9,437,437,4,1,3,2,1
16,456,456,72,72,0,1,0
12,487,487,19,2,17,2,1

0,104,104,4,4,0,1,0
10,104,104,7,4,3,2,1
6,120,120,28,16,12,2,1
17,132,132,1,1,0,1,0
12,143,143,22,22,0,1,0
1,146,146,26,8,18,2,1
9,148,148,2,2,0,1,0
13,153,153,47,47,0,1,0
14,169,169,17,13,4,2,1
7,259,259,12,12,0,1,0
16,266,266,7,1,6,3,2
4,267,267,2,2,0,1,0
15,270,270,35,9,26,3,2
20,278,278,44,44,0,1,0
2,279,279,60,60,0,1,0
21,326,326,31,18,13,2,1
11,374,374,12,3,9,2,1
18,400,400,40,4,36,4,3
8,412,412,92,92,0,1,0
3,442,442,15,15,0,1,0
5,463,463,6,6,0,1,0
19,488,488,21,21,0,1,0

19,127,127,2,2,0,1,0
1,151,151,3,3,0,1,0
13,156,156,14,2,12,2,1
22,204,204,47,47,0,1,0
4,216,216,21,21,0,1,0
9,224,224,32,7,25,2,1
15,262,262,15,10,5,2,1
6,264,264,24,2,22,2,1
0,280,280,4,1,3,2,1
3,315,315,2,2,0,1,0
16,327,327,2,2,0,1,0
2,343,343,70,70,0,1,0
7,353,353,19,16,3,2,1
23,375,375,2,2,0,1,0
17,415,415,39,7,32,2,1
12,421,421,70,26,44,2,1
18,451,451,4,4,0,1,0
10,461,461,5,5,0,1,0
5,465,465,49,32,17,2,1
8,480,480,8,8,0,1,0
11,485,485,42,42,0,1,0
20,488,488,98,64,34,3,2
14,493,493,128,95,33,3,2
21,500,500,122,97,25,2,1

9,148,148,1,1,0,1,0
0,162,162,2,2,0,1,0
7,171,171,9,3,6,2,1
18,228,228,15,15,0,1,0
6,255,255,53,53,0,1,0
5,272,272,27,27,0,1,0
8,279,279,8,8,0,1,0
13,282,282,14,14,0,1,0
3,301,301,4,1,3,2,1
4,308,308,17,17,0,1,0
17,314,314,17,12,5,2,1
11,316,316,63,63,0,1,0
1,335,335,5,5,0,1,0
14,336,336,3,3,0,1,0
19,400,400,22,2,20,3,2
22,409,409,24,24,0,1,0
15,419,419,133,40,93,4,3
20,438,438,101,101,0,1,0
16,464,464,119,88,31,2,1
12,485,485,126,126,0,1,0
10,492,492,23,2,21,2,1
21,494,494,9,9,0,1,0
2,499,499,52,45,7,2,1

13,116,116,31,31,0,1,0
12,120,120,18,8,10,3,2
1,125,125,18,15,3,2,1
0,170,170,10,10,0,1,0
11,170,170,32,32,0,1,0
6,176,176,17,1,16,2,1
17,183,183,17,17,0,1,0
19,239,239,56,29,27,2,1
18,251,251,16,10,6,2,1
9,260,260,1,1,0,1,0
2,277,277,38,13,25,3,2
7,296,296,75,44,31,2,1
14,388,388,6,6,0,1,0
8,440,440,55,1,54,3,2
16,443,443,23,1,22,3,2
20,444,444,24,24,0,1,0
15,449,449,5,1,4,2,1
5,450,450,38,38,0,1,0
3,454,454,23,23,0,1,0
4,485,485,43,43,0,1,0
10,486,486,28,3,25,3,2

18,113,113,6,6,0,1,0
12,132,132,14,14,0,1,0
1,188,188,4,4,0,1,0
6,189,189,29,15,14,3,2
4,224,224,3,3,0,1,0
16,224,224,2,2,0,1,0
10,257,257,4,1,3,2,1
13,272,272,2,2,0,1,0
22,278,278,40,27,13,2,1
5,292,292,45,37,8,3,2
8,292,292,17,3,14,3,2
23,304,304,19,19,0,1,0
9,344,344,34,34,0,1,0
17,361,361,28,28,0,1,0
11,361,361,94,94,0,1,0
2,369,369,20,20,0,1,0
7,373,373,45,31,14,3,2
0,382,382,9,9,0,1,0
3,382,382,6,6,0,1,0
14,397,397,81,15,66,3,2
19,410,410,112,112,0,1,0
21,452,452,13,13,0,1,0
15,457,457,53,53,0,1,0
20,478,478,73,73,0,1,0

21,103,103,12,12,0,1,0
3,109,109,7,7,0,1,0
24,114,114,8,8,0,1,0
6,134,134,13,2,11,2,1
12,140,140,23,23,0,1,0
23,158,158,32,10,22,2,1
15,161,161,11,11,0,1,0
5,174,174,8,4,4,2,1
22,190,190,37,37,0,1,0
8,195,195,14,14,0,1,0
13,215,215,1,1,0,1,0
14,234,234,13,13,0,1,0
17,309,309,2,2,0,1,0
18,323,323,32,26,6,3,2
1,326,326,18,12,6,3,2
16,341,341,77,68,9,4,3
10,392,392,36,3,33,4,3
4,408,408,26,14,12,4,3
19,411,411,29,29,0,1,0
0,420,420,27,27,0,1,0
11,440,440,39,31,8,2,1
2,450,450,49,33,16,3,2
7,456,456,3,3,0,1,0
9,469,469,57,57,0,1,0
20,493,493,30,30,0,1,0

14,142,142,2,2,0,1,0
5,143,143,2,2,0,1,0
8,148,148,22,22,0,1,0
7,159,159,12,12,0,1,0
9,184,184,2,2,0,1,0
0,199,199,30,11,19,2,1
18,207,207,21,3,18,2,1
20,231,231,46,13,33,2,1
19,256,256,87,9,78,4,3
6,286,286,16,11,5,2,1
16,313,313,6,6,0,1,0
3,321,321,1,1,0,1,0
11,327,327,18,12,6,2,1
23,349,349,9,9,0,1,0
25,381,381,17,14,3,2,1
13,418,418,7,7,0,1,0
4,433,433,29,20,9,2,1
15,437,437,6,1,5,2,1
26,441,441,40,4,36,4,3
12,441,441,34,34,0,1,0
2,454,454,73,73,0,1,0
24,463,463,4,4,0,1,0
1,464,464,34,34,0,1,0
21,467,467,36,36,0,1,0
17,470,470,8,8,0,1,0
10,482,482,71,24,47,4,3
22,491,491,103,31,72,4,3

6,100,100,14,14,0,1,0
0,104,104,20,7,13,2,1
1,127,127,5,5,0,1,0
15,128,128,35,8,27,2,1
3,153,153,18,18,0,1,0
7,158,158,7,1,6,3,2
13,158,158,12,12,0,1,0
17,197,197,4,4,0,1,0
4,201,201,38,38,0,1,0
9,270,270,16,16,0,1,0
11,308,308,7,1,6,2,1
2,319,319,82,39,43,2,1
8,398,398,13,5,8,2,1
12,403,403,51,51,0,1,0
16,423,423,54,54,0,1,0
5,426,426,38,5,33,4,3
14,434,434,72,31,41,2,1
10,460,460,4,4,0,1,0
18,481,481,114,99,15,2,1

22,100,100,5,5,0,1,0
24,120,120,25,25,0,1,0
21,133,133,11,11,0,1,0
14,136,136,32,32,0,1,0
8,179,179,22,3,19,4,3
0,228,228,75,70,5,2,1
20,249,249,39,39,0,1,0
7,275,275,13,13,0,1,0
3,296,296,1,1,0,1,0
16,311,311,40,40,0,1,0
1,316,316,7,2,5,2,1
23,321,321,45,32,13,2,1
11,327,327,16,2,14,2,1
10,338,338,1,1,0,1,0
5,350,350,1,1,0,1,0
19,358,358,31,31,0,1,0
4,392,392,4,4,0,1,0
6,408,408,1,1,0,1,0
15,432,432,33,33,0,1,0
17,434,434,53,2,51,4,3
13,446,446,10,4,6,2,1
18,454,454,35,35,0,1,0
12,462,462,10,4,6,2,1
9,484,484,23,23,0,1,0
2,493,493,91,64,27,2,1

7,114,114,16,16,0,1,0
15,115,115,5,1,4,2,1
6,128,128,22,22,0,1,0
14,136,136,8,8,0,1,0
0,184,184,57,57,0,1,0
13,230,230,8,8,0,1,0
12,272,272,11,8,3,2,1
2,348,348,20,14,6,3,2
1,360,360,19,19,0,1,0
5,361,361,61,3,58,3,2
8,364,364,68,68,0,1,0
3,391,391,164,83,81,4,3
10,440,440,85,7,78,4,3
9,459,459,59,38,21,4,3
4,477,477,44,4,40,4,3
11,487,487,59,59,0,1,0

7,106,106,16,16,0,1,0
6,112,112,12,12,0,1,0
14,113,113,4,1,3,2,1
9,132,132,6,6,0,1,0
29,135,135,7,7,0,1,0
2,146,146,1,1,0,1,0
28,180,180,2,2,0,1,0
27,188,188,23,23,0,1,0
11,192,192,1,1,0,1,0
12,194,194,1,1,0,1,0
3,260,260,6,6,0,1,0
30,268,268,3,3,0,1,0
8,270,270,1,1,0,1,0
5,276,276,4,4,0,1,0
22,308,308,107,5,102,4,3
21,347,347,13,7,6,3,2
23,362,362,4,4,0,1,0
16,366,366,22,3,19,2,1
10,387,387,123,111,12,3,2
31,391,391,33,25,8,3,2
19,391,391,18,18,0,1,0
18,397,397,4,4,0,1,0
4,422,422,9,6,3,2,1
0,444,444,25,25,0,1,0
15,444,444,5,5,0,1,0
24,451,451,6,6,0,1,0
20,452,452,47,47,0,1,0
1,454,454,15,15,0,1,0
25,475,475,128,128,0,1,0
26,477,477,94,88,6,3,2
17,496,496,2,2,0,1,0
13,498,498,1,1,0,1,0

3,107,107,5,5,0,1,0
14,139,139,16,16,0,1,0
16,195,195,1,1,0,1,0
11,238,238,5,2,3,2,1
10,262,262,26,1,25,4,3
7,270,270,59,39,20,3,2
6,281,281,24,24,0,1,0
8,290,290,45,36,9,2,1
13,294,294,59,59,0,1,0
0,309,309,17,17,0,1,0
9,315,315,21,21,0,1,0
17,358,358,72,72,0,1,0
4,360,360,8,2,6,2,1
1,447,447,57,3,54,4,3
12,448,448,80,24,56,4,3
2,448,448,32,8,24,2,1
15,480,480,39,39,0,1,0
5,487,487,231,216,15,4,3

1,108,108,1,1,0,1,0
23,121,121,5,5,0,1,0
26,156,156,7,7,0,1,0
9,171,171,34,34,0,1,0
14,179,179,46,46,0,1,0
19,192,192,24,24,0,1,0
18,198,198,35,35,0,1,0
3,220,220,11,1,10,3,2
15,225,225,10,10,0,1,0
6,227,227,19,15,4,2,1
4,234,234,2,2,0,1,0
0,237,237,1,1,0,1,0
20,242,242,3,3,0,1,0
16,246,246,3,3,0,1,0
24,280,280,43,25,18,4,3
7,297,297,41,41,0,1,0
17,309,309,34,34,0,1,0
10,324,324,26,26,0,1,0
12,326,326,1,1,0,1,0
2,327,327,4,4,0,1,0
22,368,368,2,2,0,1,0
5,384,384,35,6,29,2,1
25,390,390,85,38,47,4,3
8,438,438,3,3,0,1,0
11,475,475,12,2,10,2,1
13,480,480,37,37,0,1,0
21,496,496,113,113,0,1,0

19,104,104,20,20,0,1,0
11,109,109,19,7,12,2,1
15,113,113,4,4,0,1,0
9,133,133,23,1,22,3,2
13,140,140,1,1,0,1,0
21,156,156,10,10,0,1,0
7,160,160,3,3,0,1,0
0,170,170,1,1,0,1,0
3,218,218,3,3,0,1,0
12,230,230,17,17,0,1,0
5,257,257,37,3,34,2,1
14,281,281,15,7,8,3,2
22,286,286,7,1,6,2,1
6,293,293,1,1,0,1,0
16,332,332,31,31,0,1,0
2,363,363,60,48,12,4,3
8,368,368,5,5,0,1,0
4,395,395,73,73,0,1,0
20,416,416,125,104,21,4,3
1,428,428,24,18,6,3,2
18,467,467,39,8,31,2,1
10,475,475,36,36,0,1,0
17,490,490,133,85,48,4,3

2,106,106,4,4,0,1,0
12,130,130,30,30,0,1,0
7,141,141,46,4,42,4,3
15,157,157,1,1,0,1,0
5,161,161,16,16,0,1,0
0,202,202,3,3,0,1,0
1,262,262,85,53,32,3,2
9,301,301,1,1,0,1,0
11,316,316,3,3,0,1,0
10,357,357,19,1,18,3,2
6,363,363,93,25,68,4,3
14,384,384,16,16,0,1,0
8,437,437,70,28,42,4,3
4,459,459,234,234,0,1,0
13,466,466,17,17,0,1,0
3,482,482,55,55,0,1,0

1,103,103,49,43,6,2,1
15,114,114,17,9,8,3,2
9,118,118,20,20,0,1,0
2,134,134,12,9,3,2,1
7,140,140,2,2,0,1,0
21,147,147,7,7,0,1,0
13,164,164,2,2,0,1,0
20,202,202,47,40,7,2,1
12,229,229,8,8,0,1,0
14,229,229,15,1,14,2,1
11,259,259,6,6,0,1,0
3,277,277,2,2,0,1,0
5,299,299,8,2,6,3,2
6,346,346,18,2,16,3,2
19,401,401,46,46,0,1,0
8,438,438,1,1,0,1,0
17,438,438,93,2,91,3,2
0,443,443,15,7,8,2,1
18,462,462,45,45,0,1,0
10,481,481,5,5,0,1,0
4,488,488,97,16,81,4,3
16,491,491,75,28,47,4,3

15,191,191,12,12,0,1,0
8,210,210,12,2,10,3,2
4,251,251,41,4,37,3,2
10,274,274,45,45,0,1,0
5,284,284,3,3,0,1,0
3,291,291,119,119,0,1,0
9,301,301,1,1,0,1,0
6,323,323,68,68,0,1,0
2,336,336,33,2,31,2,1
17,344,344,26,21,5,2,1
16,351,351,73,73,0,1,0
7,422,422,21,9,12,4,3
12,423,423,22,4,18,2,1
11,438,438,38,38,0,1,0
1,454,454,37,11,26,3,2
0,473,473,37,13,24,3,2
14,490,490,80,66,14,2,1
13,499,499,122,122,0,1,0

2,127,127,20,10,10,3,2
12,150,150,6,6,0,1,0
15,151,151,10,10,0,1,0
3,174,174,43,37,6,2,1
0,190,190,9,9,0,1,0
17,328,328,73,19,54,3,2
7,334,334,61,61,0,1,0
13,343,343,13,2,11,2,1
1,370,370,39,3,36,4,3
5,377,377,15,15,0,1,0
4,400,400,61,20,41,2,1
9,412,412,88,88,0,1,0
10,419,419,35,3,32,2,1
8,429,429,10,6,4,2,1
16,461,461,34,11,23,2,1
14,466,466,31,19,12,3,2
18,483,483,68,68,0,1,0
6,487,487,71,71,0,1,0
11,491,491,85,43,42,3,2

5,137,137,2,2,0,1,0
6,164,164,72,60,12,2,1
14,168,168,31,31,0,1,0
0,188,188,14,1,13,2,1
8,203,203,40,40,0,1,0
16,214,214,44,24,20,2,1
3,231,231,54,54,0,1,0
15,309,309,11,11,0,1,0
17,320,320,15,15,0,1,0
12,342,342,64,64,0,1,0
7,342,342,47,4,43,2,1
2,343,343,19,19,0,1,0
9,362,362,67,67,0,1,0
4,387,387,22,11,11,2,1
1,405,405,36,36,0,1,0
11,419,419,13,4,9,4,3
13,426,426,14,14,0,1,0
10,465,465,4,4,0,1,0

7,133,133,6,2,4,2,1
12,165,165,13,3,10,3,2
20,179,179,37,37,0,1,0
15,191,191,22,22,0,1,0
0,196,196,40,40,0,1,0
18,204,204,30,30,0,1,0
14,209,209,32,7,25,3,2
16,291,291,10,10,0,1,0
21,298,298,21,11,10,4,3
19,301,301,44,5,39,4,3
1,307,307,1,1,0,1,0
4,310,310,1,1,0,1,0
17,328,328,2,2,0,1,0
5,350,350,72,33,39,2,1
9,359,359,18,2,16,3,2
3,379,379,2,2,0,1,0
13,385,385,63,54,9,4,3
10,407,407,7,7,0,1,0
6,426,426,96,96,0,1,0
8,433,433,33,33,0,1,0
2,449,449,61,61,0,1,0
11,452,452,59,20,39,2,1

8,105,105,11,3,8,2,1
2,112,112,3,3,0,1,0
21,117,117,15,15,0,1,0
9,138,138,34,10,24,4,3
1,141,141,10,10,0,1,0
18,141,141,2,2,0,1,0
14,142,142,25,17,8,2,1
6,168,168,29,17,12,3,2
10,185,185,10,10,0,1,0
17,186,186,7,7,0,1,0
16,242,242,30,30,0,1,0
7,331,331,1,1,0,1,0
15,337,337,2,2,0,1,0
20,338,338,86,55,31,2,1
0,342,342,22,6,16,2,1
19,345,345,8,3,5,2,1
12,395,395,21,21,0,1,0
22,427,427,131,21,110,4,3
4,431,431,5,5,0,1,0
11,433,433,67,40,27,4,3
5,441,441,47,47,0,1,0
3,466,466,15,3,12,4,3
13,494,494,27,27,0,1,0

3,112,112,4,4,0,1,0
5,129,129,14,1,13,2,1
11,140,140,24,9,15,3,2
8,154,154,7,4,3,2,1
0,155,155,9,9,0,1,0
12,155,155,1,1,0,1,0
6,160,160,53,1,52,4,3
15,179,179,53,3,50,2,1
18,205,205,14,5,9,2,1
4,247,247,1,1,0,1,0
16,322,322,29,2,27,2,1
14,338,338,53,53,0,1,0
17,372,372,57,33,24,2,1
2,394,394,14,1,13,2,1
1,418,418,124,40,84,3,2
7,422,422,80,80,0,1,0
10,469,469,48,27,21,2,1
9,500,500,23,11,12,4,3
13,500,500,14,14,0,1,0

19,118,118,22,7,15,2,1
11,130,130,1,1,0,1,0
5,138,138,8,8,0,1,0
7,157,157,9,9,0,1,0
14,157,157,28,28,0,1,0
17,235,235,55,55,0,1,0
4,247,247,16,10,6,2,1
8,264,264,48,48,0,1,0
2,285,285,128,14,114,4,3
13,306,306,32,32,0,1,0
12,315,315,14,3,11,2,1
9,336,336,3,3,0,1,0
1,344,344,8,8,0,1,0
16,358,358,18,5,13,2,1
6,367,367,43,22,21,4,3
0,419,419,3,3,0,1,0
10,428,428,12,12,0,1,0
15,442,442,94,94,0,1,0
3,488,488,65,2,63,3,2
18,488,488,37,21,16,3,2

15,107,107,11,11,0,1,0
22,116,116,9,9,0,1,0
5,117,117,6,6,0,1,0
16,136,136,1,1,0,1,0
18,162,162,25,25,0,1,0
0,196,196,2,2,0,1,0
1,201,201,3,3,0,1,0
20,208,208,39,39,0,1,0
3,219,219,6,6,0,1,0
13,230,230,2,2,0,1,0
21,231,231,14,14,0,1,0
6,234,234,1,1,0,1,0
10,254,254,76,76,0,1,0
26,294,294,1,1,0,1,0
14,301,301,25,25,0,1,0
9,305,305,21,8,13,2,1
4,328,328,15,15,0,1,0
24,366,366,45,45,0,1,0
7,393,393,32,13,19,2,1
23,413,413,70,70,0,1,0
12,431,431,81,81,0,1,0
25,436,436,45,11,34,3,2
17,450,450,20,3,17,2,1
19,466,466,89,89,0,1,0
11,479,479,37,37,0,1,0
2,481,481,16,6,10,2,1
8,495,495,1,1,0,1,0

19,106,106,2,2,0,1,0
9,112,112,17,17,0,1,0
6,122,122,15,15,0,1,0
17,134,134,3,3,0,1,0
18,136,136,24,2,22,4,3
7,182,182,5,5,0,1,0
13,208,208,28,16,12,3,2
20,228,228,6,6,0,1,0
16,259,259,18,3,15,4,3
10,263,263,18,18,0,1,0
1,268,268,15,15,0,1,0
3,296,296,6,6,0,1,0
2,307,307,43,19,24,4,3
21,337,337,134,36,98,3,2
4,363,363,103,92,11,2,1
0,379,379,4,4,0,1,0
15,395,395,21,10,11,2,1
11,397,397,7,7,0,1,0
5,446,446,56,56,0,1,0
8,476,476,37,34,3,2,1
14,477,477,29,29,0,1,0
12,496,496,82,82,0,1,0

1,120,120,5,1,4,2,1
0,141,141,23,8,15,4,3
5,182,182,13,7,6,2,1
18,207,207,21,1,20,2,1
6,214,214,14,2,12,4,3
4,224,224,4,4,0,1,0
7,270,270,16,5,11,2,1
9,299,299,17,17,0,1,0
11,334,334,63,63,0,1,0
2,342,342,122,91,31,2,1
19,352,352,80,80,0,1,0
13,377,377,56,24,32,3,2
15,379,379,25,25,0,1,0
8,386,386,24,24,0,1,0
16,394,394,72,50,22,2,1
12,409,409,7,7,0,1,0
10,410,410,54,54,0,1,0
14,414,414,1,1,0,1,0
3,444,444,92,62,30,4,3
17,460,460,21,21,0,1,0

8,103,103,5,1,4,2,1
18,141,141,5,5,0,1,0
11,167,167,2,2,0,1,0
9,206,206,4,1,3,2,1
14,225,225,69,69,0,1,0
7,233,233,59,59,0,1,0
5,234,234,47,2,45,3,2
17,283,283,24,4,20,2,1
1,314,314,28,28,0,1,0
3,328,328,35,26,9,4,3
10,340,340,25,25,0,1,0
6,396,396,51,51,0,1,0
16,397,397,48,48,0,1,0
4,419,419,16,16,0,1,0
12,446,446,3,3,0,1,0
0,451,451,15,15,0,1,0
15,463,463,138,84,54,4,3
2,464,464,97,97,0,1,0
13,484,484,77,43,34,2,1

18,108,108,8,8,0,1,0
19,117,117,6,6,0,1,0
13,120,120,21,4,17,2,1
3,125,125,10,2,8,3,2
15,190,190,8,1,7,2,1
12,243,243,3,3,0,1,0
9,269,269,24,10,14,3,2
5,277,277,12,5,7,2,1
7,292,292,12,7,5,2,1
1,299,299,96,42,54,4,3
6,306,306,106,78,28,3,2
0,324,324,38,30,8,2,1
2,357,357,1,1,0,1,0
10,395,395,191,47,144,4,3
4,458,458,18,5,13,2,1
14,471,471,54,36,18,3,2
16,471,471,10,10,0,1,0
11,476,476,40,40,0,1,0
17,486,486,26,26,0,1,0
8,488,488,10,10,0,1,0

8,125,125,7,2,5,2,1
13,138,138,18,18,0,1,0
20,170,170,30,8,22,3,2
19,208,208,54,28,26,2,1
16,229,229,7,7,0,1,0
0,232,232,1,1,0,1,0
6,232,232,12,7,5,2,1
4,241,241,52,41,11,2,1
15,246,246,68,68,0,1,0
9,254,254,20,8,12,3,2
14,254,254,1,1,0,1,0
10,256,256,21,21,0,1,0
12,271,271,23,23,0,1,0
2,283,283,27,12,15,2,1
7,302,302,1,1,0,1,0
11,329,329,34,34,0,1,0
1,338,338,9,3,6,3,2
3,344,344,56,38,18,3,2
18,365,365,3,3,0,1,0
17,463,463,48,35,13,2,1
5,484,484,107,13,94,3,2
21,496,496,24,14,10,2,1

13,119,119,23,23,0,1,0
1,119,119,10,10,0,1,0
5,123,123,6,6,0,1,0
14,173,173,26,14,12,2,1
4,191,191,58,37,21,4,3
3,208,208,11,7,4,2,1
16,227,227,13,13,0,1,0
15,244,244,4,4,0,1,0
8,252,252,30,30,0,1,0
7,254,254,1,1,0,1,0
6,259,259,55,55,0,1,0
12,290,290,42,42,0,1,0
9,301,301,17,2,15,2,1
11,313,313,16,1,15,4,3
19,333,333,76,60,16,2,1
18,437,437,81,37,44,2,1
2,437,437,16,16,0,1,0
17,445,445,15,15,0,1,0
0,466,466,86,38,48,4,3
10,482,482,29,17,12,4,3

0,113,113,24,24,0,1,0
21,145,145,13,4,9,2,1
13,150,150,27,27,0,1,0
12,161,161,2,2,0,1,0
11,195,195,5,5,0,1,0
18,196,196,31,22,9,4,3
8,199,199,12,12,0,1,0
2,203,203,1,1,0,1,0
9,209,209,2,2,0,1,0
5,231,231,1,1,0,1,0
17,251,251,14,5,9,4,3
14,313,313,15,5,10,3,2
19,338,338,23,23,0,1,0
4,345,345,147,114,33,4,3
3,359,359,11,2,9,4,3
1,364,364,29,1,28,3,2
16,400,400,15,15,0,1,0
10,435,435,10,10,0,1,0
6,445,445,50,32,18,2,1
20,446,446,143,143,0,1,0
7,459,459,51,51,0,1,0
15,495,495,77,20,57,4,3

17,100,100,5,5,0,1,0
11,107,107,5,1,4,2,1
0,123,123,26,26,0,1,0
2,129,129,32,1,31,2,1
4,136,136,9,9,0,1,0
3,148,148,53,53,0,1,0
14,157,157,10,10,0,1,0
12,214,214,2,2,0,1,0
9,278,278,10,4,6,3,2
1,301,301,16,16,0,1,0
7,331,331,30,11,19,2,1
8,351,351,19,1,18,4,3
18,367,367,45,5,40,2,1
15,388,388,22,22,0,1,0
13,395,395,7,7,0,1,0
5,396,396,2,2,0,1,0
10,397,397,15,3,12,3,2
6,409,409,6,2,4,2,1
16,472,472,321,243,78,4,3

17,131,131,11,11,0,1,0
4,140,140,1,1,0,1,0
6,149,149,4,1,3,2,1
9,224,224,1,1,0,1,0
3,229,229,18,18,0,1,0
16,248,248,113,14,99,4,3
7,272,272,44,29,15,2,1
5,321,321,18,18,0,1,0
8,339,339,103,15,88,4,3
1,349,349,54,54,0,1,0
12,370,370,41,20,21,4,3
15,393,393,10,1,9,2,1
11,416,416,13,13,0,1,0
10,419,419,6,2,4,2,1
14,428,428,14,14,0,1,0
13,429,429,42,42,0,1,0
2,433,433,22,22,0,1,0
0,496,496,130,88,42,2,1
18,497,497,129,33,96,4,3

11,108,108,3,3,0,1,0
19,129,129,8,8,0,1,0
14,145,145,19,19,0,1,0
10,152,152,11,11,0,1,0
8,154,154,23,20,3,2,1
18,191,191,4,4,0,1,0
4,202,202,31,19,12,3,2
17,228,228,14,4,10,3,2
1,229,229,10,10,0,1,0
3,255,255,29,26,3,2,1
7,277,277,48,2,46,3,2
0,294,294,12,12,0,1,0
5,301,301,25,25,0,1,0
20,329,329,24,4,20,3,2
16,333,333,39,15,24,3,2
12,335,335,37,37,0,1,0
2,358,358,67,34,33,2,1
9,360,360,16,8,8,2,1
6,396,396,17,17,0,1,0
13,437,437,193,185,8,3,2
15,455,455,34,15,19,2,1

8,125,125,6,6,0,1,0
4,142,142,5,5,0,1,0
7,152,152,4,4,0,1,0
10,154,154,10,10,0,1,0
16,156,156,8,3,5,2,1
0,181,181,27,12,15,2,1
11,192,192,36,36,0,1,0
18,199,199,37,29,8,3,2
9,241,241,5,5,0,1,0
13,256,256,39,39,0,1,0
1,259,259,29,29,0,1,0
17,281,281,4,4,0,1,0
6,327,327,127,73,54,3,2
2,375,375,62,31,31,2,1
12,386,386,83,17,66,3,2
15,417,417,42,42,0,1,0
5,420,420,55,17,38,2,1
3,446,446,23,13,10,2,1
14,467,467,59,59,0,1,0

7,132,132,6,6,0,1,0
1,147,147,48,8,40,4,3
8,157,157,3,3,0,1,0
16,163,163,10,10,0,1,0
4,175,175,12,12,0,1,0
15,180,180,40,6,34,3,2
0,193,193,64,64,0,1,0
17,211,211,8,2,6,2,1
3,239,239,8,8,0,1,0
21,244,244,65,65,0,1,0
14,254,254,11,11,0,1,0
9,291,291,3,3,0,1,0
10,306,306,9,9,0,1,0
6,306,306,50,16,34,3,2
12,321,321,9,9,0,1,0
5,329,329,4,1,3,2,1
2,339,339,1,1,0,1,0
18,349,349,23,6,17,2,1
19,409,409,6,3,3,2,1
13,412,412,22,22,0,1,0
20,439,439,143,113,30,2,1
11,452,452,26,18,8,2,1

2,100,100,7,7,0,1,0
12,118,118,9,4,5,2,1
8,139,139,18,1,17,2,1
26,141,141,41,33,8,2,1
24,164,164,5,5,0,1,0
4,176,176,1,1,0,1,0
0,177,177,24,24,0,1,0
18,193,193,2,2,0,1,0
28,206,206,27,27,0,1,0
22,211,211,10,10,0,1,0
10,224,224,31,31,0,1,0
20,251,251,35,11,24,4,3
1,259,259,3,3,0,1,0
27,296,296,45,2,43,2,1
21,308,308,10,10,0,1,0
13,310,310,37,11,26,4,3
3,331,331,3,3,0,1,0
19,343,343,47,10,37,2,1
7,348,348,2,2,0,1,0
17,360,360,21,9,12,2,1
11,360,360,16,11,5,2,1
25,384,384,59,29,30,3,2
14,396,396,8,8,0,1,0
9,440,440,33,1,32,2,1
15,441,441,12,6,6,3,2
6,441,441,27,27,0,1,0
5,463,463,46,10,36,4,3
23,473,473,3,3,0,1,0
16,485,485,3,3,0,1,0

8,110,110,1,1,0,1,0
22,115,115,2,2,0,1,0
7,127,127,1,1,0,1,0
13,132,132,19,19,0,1,0
5,145,145,19,3,16,2,1
0,185,185,5,2,3,2,1
23,216,216,35,15,20,3,2
16,243,243,20,10,10,2,1
17,250,250,73,73,0,1,0
20,275,275,19,19,0,1,0
24,285,285,57,18,39,2,1
15,307,307,58,14,44,3,2
12,311,311,36,36,0,1,0
18,328,328,12,12,0,1,0
19,337,337,5,2,3,2,1
6,345,345,23,23,0,1,0
10,348,348,13,1,12,3,2
2,353,353,19,19,0,1,0
1,381,381,32,32,0,1,0
3,386,386,33,24,9,2,1
9,395,395,3,3,0,1,0
11,416,416,15,15,0,1,0
4,445,445,71,71,0,1,0
21,459,459,24,24,0,1,0
14,467,467,63,41,22,4,3

5,104,104,37,27,10,3,2
10,129,129,48,48,0,1,0
17,191,191,3,3,0,1,0
4,207,207,23,23,0,1,0
1,223,223,8,5,3,2,1
18,239,239,3,3,0,1,0
6,260,260,2,2,0,1,0
8,268,268,39,39,0,1,0
14,309,309,22,3,19,2,1
0,312,312,64,14,50,3,2
3,315,315,11,11,0,1,0
7,329,329,48,42,6,2,1
11,340,340,53,29,24,3,2
13,340,340,68,68,0,1,0
2,367,367,22,8,14,3,2
12,373,373,15,6,9,2,1
16,384,384,49,49,0,1,0
9,410,410,5,5,0,1,0
15,463,463,49,8,41,2,1

3,102,102,3,3,0,1,0
22,106,106,5,5,0,1,0
5,108,108,1,1,0,1,0
7,141,141,11,11,0,1,0
20,182,182,56,56,0,1,0
19,196,196,7,1,6,3,2
16,213,213,6,6,0,1,0
8,227,227,37,2,35,2,1
0,253,253,37,8,29,2,1
2,258,258,30,30,0,1,0
6,277,277,11,6,5,2,1
18,290,290,2,2,0,1,0
10,296,296,10,6,4,2,1
4,327,327,45,19,26,3,2
14,342,342,48,48,0,1,0
15,351,351,57,57,0,1,0
23,366,366,34,12,22,2,1
13,396,396,39,27,12,4,3
11,420,420,12,12,0,1,0
21,429,429,73,73,0,1,0
17,461,461,64,2,62,3,2
12,491,491,51,9,42,3,2
9,496,496,39,39,0,1,0
1,499,499,19,19,0,1,0

8,155,155,24,3,21,2,1
9,233,233,3,3,0,1,0
2,262,262,116,116,0,1,0
6,272,272,38,38,0,1,0
10,286,286,13,1,12,2,1
15,293,293,13,13,0,1,0
14,339,339,44,39,5,2,1
0,369,369,43,7,36,2,1
1,387,387,58,58,0,1,0
3,408,408,23,18,5,2,1
4,417,417,65,44,21,2,1
7,426,426,85,35,50,3,2
11,448,448,48,14,34,3,2
16,454,454,33,21,12,2,1
13,466,466,101,101,0,1,0
12,480,480,63,31,32,2,1
5,483,483,19,19,0,1,0

12,148,148,4,4,0,1,0
15,154,154,3,3,0,1,0
10,158,158,19,12,7,2,1
2,163,163,1,1,0,1,0
14,176,176,38,38,0,1,0
7,187,187,30,11,19,2,1
4,189,189,6,6,0,1,0
22,192,192,50,50,0,1,0
21,197,197,10,10,0,1,0
16,199,199,8,2,6,2,1
17,211,211,12,3,9,4,3
13,241,241,20,3,17,2,1
6,242,242,3,3,0,1,0
8,248,248,82,82,0,1,0
9,252,252,15,15,0,1,0
19,269,269,43,1,42,4,3
1,275,275,14,14,0,1,0
18,296,296,69,69,0,1,0
11,309,309,6,6,0,1,0
3,325,325,47,15,32,2,1
5,344,344,39,2,37,4,3
0,366,366,11,8,3,2,1
20,480,480,7,7,0,1,0

4,109,109,8,1,7,2,1
9,113,113,4,4,0,1,0
12,131,131,21,11,10,2,1
18,141,141,9,1,8,2,1
20,166,166,14,14,0,1,0
10,179,179,14,14,0,1,0
24,187,187,1,1,0,1,0
22,194,194,15,15,0,1,0
17,195,195,30,30,0,1,0
7,198,198,1,1,0,1,0
2,254,254,6,6,0,1,0
0,276,276,1,1,0,1,0
13,322,322,4,4,0,1,0
8,325,325,116,20,96,4,3
21,330,330,13,4,9,4,3
3,347,347,10,10,0,1,0
1,369,369,32,32,0,1,0
15,376,376,83,52,31,4,3
5,376,376,5,5,0,1,0
19,378,378,87,42,45,3,2
6,408,408,6,6,0,1,0
11,429,429,12,2,10,2,1
16,478,478,33,33,0,1,0
23,486,486,86,54,32,4,3
14,487,487,88,88,0,1,0

16,100,100,10,7,3,2,1
5,183,183,14,14,0,1,0
8,201,201,47,26,21,4,3
12,247,247,51,10,41,3,2
10,256,256,29,11,18,4,3
0,284,284,105,81,24,2,1
15,335,335,24,12,12,3,2
14,342,342,1,1,0,1,0
7,347,347,65,44,21,2,1
11,356,356,19,19,0,1,0
13,376,376,24,5,19,2,1
1,377,377,11,5,6,3,2
6,384,384,16,16,0,1,0
4,389,389,16,2,14,2,1
2,400,400,124,124,0,1,0
9,438,438,39,39,0,1,0
3,446,446,104,29,75,4,3

5,112,112,5,5,0,1,0
1,124,124,7,7,0,1,0
2,136,136,1,1,0,1,0
0,164,164,77,27,50,4,3
20,188,188,1,1,0,1,0
17,189,189,31,31,0,1,0
7,197,197,17,17,0,1,0
18,205,205,14,14,0,1,0
6,221,221,12,12,0,1,0
16,226,226,14,1,13,2,1
15,241,241,17,11,6,2,1
8,304,304,20,20,0,1,0
4,308,308,7,7,0,1,0
13,314,314,25,10,15,4,3
9,323,323,31,31,0,1,0
21,326,326,75,33,42,3,2
3,370,370,24,4,20,2,1
10,408,408,27,4,23,2,1
14,427,427,139,108,31,2,1
19,430,430,20,20,0,1,0
12,476,476,32,2,30,3,2
11,483,483,32,32,0,1,0

17,121,121,22,2,20,2,1
18,136,136,13,10,3,2,1
16,161,161,4,4,0,1,0
14,171,171,11,11,0,1,0
0,174,174,13,7,6,2,1
6,182,182,25,25,0,1,0
1,219,219,10,6,4,2,1
15,225,225,30,30,0,1,0
9,228,228,6,6,0,1,0
8,234,234,18,7,11,2,1
4,234,234,20,8,12,3,2
7,245,245,24,24,0,1,0
10,262,262,22,22,0,1,0
11,358,358,29,29,0,1,0
5,367,367,182,182,0,1,0
3,410,410,9,9,0,1,0
12,429,429,8,1,7,2,1
13,439,439,183,121,62,3,2
2,484,484,32,23,9,4,3

4,100,100,19,19,0,1,0
1,125,125,11,2,9,2,1
3,176,176,18,18,0,1,0
18,182,182,12,12,0,1,0
17,222,222,61,61,0,1,0
10,235,235,17,17,0,1,0
5,258,258,15,15,0,1,0
13,263,263,46,46,0,1,0
19,271,271,11,11,0,1,0
2,284,284,18,18,0,1,0
11,298,298,88,46,42,4,3
0,309,309,3,3,0,1,0
12,355,355,5,5,0,1,0
8,357,357,47,35,12,4,3
7,361,361,76,23,53,4,3
9,402,402,67,49,18,4,3
6,441,441,36,36,0,1,0
16,465,465,63,63,0,1,0
14,478,478,13,9,4,2,1
15,485,485,11,1,10,2,1

20,151,151,33,33,0,1,0
22,155,155,7,7,0,1,0
4,175,175,5,5,0,1,0
21,223,223,1,1,0,1,0
19,224,224,46,1,45,4,3
14,225,225,8,8,0,1,0
3,261,261,22,2,20,3,2
5,263,263,22,22,0,1,0
11,275,275,9,9,0,1,0
7,294,294,36,36,0,1,0
0,300,300,33,33,0,1,0
6,305,305,28,4,24,2,1
12,318,318,73,27,46,3,2
1,339,339,9,1,8,2,1
10,362,362,20,12,8,3,2
2,363,363,83,5,78,4,3
18,395,395,6,6,0,1,0
17,403,403,195,72,123,4,3
9,422,422,3,3,0,1,0
13,424,424,5,5,0,1,0
15,442,442,7,7,0,1,0
8,443,443,1,1,0,1,0
16,484,484,38,28,10,3,2

13,118,118,4,4,0,1,0
14,142,142,18,18,0,1,0
15,149,149,12,12,0,1,0
4,169,169,4,4,0,1,0
1,184,184,9,9,0,1,0
7,195,195,21,15,6,2,1
12,218,218,11,11,0,1,0
19,219,219,18,1,17,4,3
11,219,219,14,4,10,3,2
3,286,286,1,1,0,1,0
10,297,297,44,6,38,3,2
17,303,303,23,12,11,2,1
5,314,314,2,2,0,1,0
8,343,343,69,30,39,4,3
9,345,345,54,54,0,1,0
2,386,386,122,122,0,1,0
20,406,406,25,4,21,2,1
6,407,407,24,9,15,2,1
16,421,421,146,146,0,1,0
0,445,445,13,10,3,2,1
18,494,494,97,85,12,4,3

7,103,103,8,3,5,2,1
15,248,248,18,18,0,1,0
4,259,259,1,1,0,1,0
3,260,260,1,1,0,1,0
6,269,269,24,24,0,1,0
2,270,270,144,90,54,4,3
1,296,296,46,46,0,1,0
16,303,303,50,50,0,1,0
8,307,307,16,16,0,1,0
9,314,314,3,3,0,1,0
17,336,336,61,56,5,2,1
0,433,433,58,58,0,1,0
5,450,450,49,5,44,2,1
11,458,458,76,26,50,2,1
13,479,479,75,48,27,2,1
12,485,485,42,42,0,1,0
10,490,490,67,48,19,2,1
14,495,495,43,1,42,4,3

5,123,123,17,3,14,3,2
14,127,127,1,1,0,1,0
11,134,134,5,5,0,1,0
18,150,150,12,12,0,1,0
19,178,178,26,26,0,1,0
16,215,215,28,18,10,3,2
26,238,238,13,9,4,2,1
7,241,241,21,21,0,1,0
8,260,260,1,1,0,1,0
25,276,276,85,57,28,2,1
4,277,277,2,2,0,1,0
1,284,284,22,22,0,1,0
22,301,301,26,26,0,1,0
21,309,309,70,2,68,3,2
28,312,312,41,41,0,1,0
2,316,316,6,1,5,2,1
3,320,320,1,1,0,1,0
6,338,338,24,10,14,2,1
15,344,344,11,11,0,1,0
10,359,359,9,1,8,3,2
27,361,361,1,1,0,1,0
24,366,366,13,4,9,2,1
20,382,382,47,47,0,1,0
12,405,405,46,46,0,1,0
17,406,406,72,27,45,2,1
13,407,407,18,11,7,2,1
9,416,416,7,7,0,1,0
0,423,423,14,5,9,4,3
23,447,447,1,1,0,1,0

10,106,106,47,47,0,1,0
15,118,118,1,1,0,1,0
16,136,136,8,8,0,1,0
6,138,138,34,13,21,4,3
5,160,160,29,16,13,2,1
7,185,185,38,13,25,2,1
9,194,194,16,16,0,1,0
11,201,201,5,5,0,1,0
12,261,261,11,11,0,1,0
3,264,264,8,8,0,1,0
17,271,271,62,36,26,2,1
2,292,292,4,4,0,1,0
0,296,296,13,1,12,2,1
1,309,309,6,3,3,2,1
14,353,353,12,2,10,2,1
13,359,359,26,26,0,1,0
18,408,408,54,11,43,4,3
4,473,473,123,123,0,1,0
8,475,475,48,12,36,3,2

13,129,129,4,4,0,1,0
10,134,134,26,26,0,1,0
0,144,144,23,23,0,1,0
3,218,218,4,4,0,1,0
19,218,218,1,1,0,1,0
5,252,252,6,6,0,1,0
17,261,261,15,15,0,1,0
8,270,270,51,51,0,1,0
4,275,275,19,1,18,4,3
9,330,330,11,3,8,3,2
12,352,352,6,3,3,2,1
16,355,355,38,38,0,1,0
6,364,364,6,6,0,1,0
11,390,390,29,29,0,1,0
20,407,407,46,46,0,1,0
2,420,420,87,55,32,3,2
1,427,427,35,14,21,3,2
18,465,465,106,62,44,3,2
7,478,478,53,26,27,2,1
14,483,483,183,167,16,3,2
15,500,500,54,30,24,2,1

0,105,105,23,17,6,2,1
18,115,115,14,14,0,1,0
15,130,130,2,2,0,1,0
12,140,140,2,2,0,1,0
16,148,148,20,11,9,2,1
9,167,167,36,36,0,1,0
11,189,189,16,16,0,1,0
4,261,261,65,29,36,4,3
17,278,278,14,4,10,3,2
2,282,282,19,19,0,1,0
6,359,359,42,16,26,3,2
14,395,395,27,6,21,4,3
5,412,412,13,13,0,1,0
7,414,414,2,2,0,1,0
13,425,425,47,47,0,1,0
1,430,430,161,153,8,2,1
8,459,459,15,15,0,1,0
10,473,473,151,71,80,3,2
3,482,482,3,3,0,1,0

1,112,112,10,10,0,1,0
8,117,117,10,2,8,3,2
19,130,130,6,6,0,1,0
13,134,134,11,4,7,2,1
9,183,183,44,44,0,1,0
12,184,184,90,79,11,2,1
20,185,185,12,12,0,1,0
4,191,191,12,12,0,1,0
2,201,201,10,10,0,1,0
5,296,296,1,1,0,1,0
10,310,310,38,9,29,4,3
0,310,310,45,8,37,2,1
15,323,323,3,3,0,1,0
14,325,325,44,12,32,2,1
18,332,332,12,12,0,1,0
7,338,338,42,42,0,1,0
6,414,414,54,33,21,4,3
16,428,428,30,30,0,1,0
17,428,428,14,14,0,1,0
3,438,438,21,21,0,1,0
11,486,486,71,19,52,3,2

18,118,118,29,29,0,1,0
12,131,131,5,5,0,1,0
17,135,135,12,12,0,1,0
22,144,144,44,44,0,1,0
24,148,148,3,3,0,1,0
3,190,190,29,4,25,3,2
11,205,205,21,21,0,1,0
26,206,206,6,6,0,1,0
23,215,215,6,6,0,1,0
7,232,232,17,17,0,1,0
6,237,237,23,23,0,1,0
1,239,239,24,17,7,2,1
20,245,245,10,10,0,1,0
13,252,252,19,7,12,4,3
10,256,256,4,4,0,1,0
4,319,319,32,32,0,1,0
0,329,329,12,12,0,1,0
19,362,362,43,37,6,2,1
9,367,367,18,18,0,1,0
25,369,369,45,8,37,2,1
16,383,383,8,2,6,3,2
2,392,392,6,6,0,1,0
5,400,400,2,2,0,1,0
14,418,418,15,7,8,2,1
15,427,427,39,23,16,2,1
21,460,460,59,14,45,2,1
8,462,462,43,43,0,1,0

15,115,115,13,13,0,1,0
18,155,155,15,15,0,1,0
0,159,159,36,36,0,1,0
8,174,174,2,2,0,1,0
3,268,268,20,20,0,1,0
1,277,277,12,4,8,2,1
6,284,284,4,4,0,1,0
17,321,321,8,8,0,1,0
16,324,324,33,33,0,1,0
14,329,329,138,86,52,3,2
2,337,337,8,4,4,2,1
4,368,368,7,1,6,3,2
12,382,382,25,25,0,1,0
9,387,387,127,33,94,3,2
11,404,404,62,62,0,1,0
19,442,442,44,16,28,3,2
7,470,470,169,156,13,4,3
5,477,477,1,1,0,1,0
10,480,480,1,1,0,1,0
13,497,497,21,2,19,4,3

15,161,161,33,33,0,1,0
5,199,199,3,3,0,1,0
6,212,212,9,5,4,2,1
17,240,240,4,4,0,1,0
3,251,251,4,4,0,1,0
7,277,277,12,2,10,2,1
4,345,345,83,83,0,1,0
1,348,348,10,10,0,1,0
11,359,359,24,24,0,1,0
2,364,364,170,50,120,4,3
12,365,365,14,4,10,3,2
18,399,399,93,24,69,4,3
13,400,400,60,38,22,2,1
9,404,404,24,6,18,4,3
0,412,412,84,84,0,1,0
10,416,416,67,67,0,1,0
16,462,462,42,42,0,1,0
8,488,488,21,9,12,3,2
14,490,490,45,36,9,4,3

11,109,109,20,20,0,1,0
12,122,122,29,29,0,1,0
7,132,132,8,8,0,1,0
0,151,151,1,1,0,1,0
3,151,151,1,1,0,1,0
10,174,174,1,1,0,1,0
16,234,234,16,6,10,3,2
6,245,245,19,19,0,1,0
5,250,250,27,27,0,1,0
22,284,284,64,41,23,2,1
20,301,301,11,11,0,1,0
14,304,304,1,1,0,1,0
15,317,317,77,77,0,1,0
13,322,322,28,28,0,1,0
18,324,324,5,5,0,1,0
17,354,354,41,23,18,2,1
21,373,373,14,14,0,1,0
1,397,397,51,33,18,2,1
2,429,429,2,2,0,1,0
4,444,444,34,12,22,3,2
9,448,448,73,56,17,2,1
19,477,477,136,91,45,2,1
8,494,494,21,21,0,1,0

24,104,104,19,12,7,2,1
7,126,126,1,1,0,1,0
9,145,145,19,3,16,3,2
5,188,188,17,5,12,2,1
16,228,228,9,3,6,2,1
6,261,261,8,8,0,1,0
11,262,262,18,18,0,1,0
3,275,275,3,3,0,1,0
10,286,286,59,23,36,3,2
17,293,293,87,87,0,1,0
22,301,301,62,14,48,2,1
18,365,365,12,3,9,4,3
15,378,378,42,12,30,3,2
4,379,379,1,1,0,1,0
1,391,391,99,99,0,1,0
19,416,416,12,1,11,2,1
23,421,421,14,14,0,1,0
2,448,448,24,24,0,1,0
21,451,451,44,11,33,4,3
8,459,459,31,3,28,4,3
13,461,461,17,17,0,1,0
0,470,470,1,1,0,1,0
14,480,480,33,3,30,4,3
20,485,485,43,43,0,1,0
12,496,496,35,17,18,4,3

18,103,103,6,6,0,1,0
7,125,125,9,9,0,1,0
15,131,131,20,2,18,4,3
16,191,191,3,3,0,1,0
10,201,201,7,7,0,1,0
0,216,216,10,1,9,4,3
24,219,219,18,2,16,2,1
23,224,224,52,52,0,1,0
14,261,261,24,2,22,2,1
8,276,276,18,2,16,2,1
6,289,289,20,20,0,1,0
2,296,296,12,4,8,2,1
22,307,307,4,4,0,1,0
5,327,327,5,5,0,1,0
11,331,331,9,5,4,2,1
21,344,344,71,71,0,1,0
4,392,392,29,5,24,4,3
12,412,412,36,36,0,1,0
13,421,421,9,9,0,1,0
1,422,422,40,4,36,3,2
3,430,430,8,8,0,1,0
26,436,436,131,131,0,1,0
19,439,439,26,16,10,2,1
17,441,441,25,15,10,3,2
20,467,467,40,40,0,1,0
25,474,474,12,12,0,1,0
9,495,495,86,2,84,4,3

10,116,116,19,10,9,4,3
11,134,134,6,6,0,1,0
2,199,199,32,32,0,1,0
16,253,253,6,1,5,2,1
5,283,283,19,2,17,4,3
7,295,295,23,7,16,2,1
17,306,306,81,1,80,3,2
0,308,308,26,26,0,1,0
8,316,316,7,2,5,2,1
13,324,324,27,4,23,2,1
4,339,339,4,4,0,1,0
15,371,371,73,55,18,2,1
1,411,411,95,73,22,3,2
3,412,412,1,1,0,1,0
12,413,413,53,50,3,2,1
6,426,426,199,111,88,4,3
14,475,475,61,37,24,2,1
9,479,479,33,12,21,2,1

10,109,109,6,6,0,1,0
12,118,118,17,1,16,3,2
0,121,121,4,4,0,1,0
18,168,168,8,8,0,1,0
13,178,178,5,5,0,1,0
15,197,197,33,33,0,1,0
6,205,205,23,14,9,4,3
23,242,242,39,39,0,1,0
24,254,254,17,17,0,1,0
14,264,264,38,33,5,2,1
22,266,266,18,5,13,2,1
3,277,277,26,26,0,1,0
9,304,304,3,3,0,1,0
19,314,314,102,72,30,3,2
7,331,331,31,31,0,1,0
8,336,336,4,4,0,1,0
17,374,374,22,22,0,1,0
5,383,383,27,17,10,3,2
1,395,395,16,16,0,1,0
11,396,396,36,24,12,2,1
2,405,405,31,31,0,1,0
21,406,406,14,6,8,2,1
16,409,409,72,72,0,1,0
20,446,446,5,5,0,1,0
4,495,495,49,5,44,3,2

9,113,113,3,3,0,1,0
18,130,130,8,2,6,2,1
6,131,131,14,14,0,1,0
21,138,138,23,14,9,2,1
22,139,139,21,21,0,1,0
7,140,140,9,6,3,2,1
19,168,168,20,20,0,1,0
13,172,172,2,2,0,1,0
8,209,209,24,24,0,1,0
3,241,241,16,16,0,1,0
11,249,249,32,22,10,3,2
15,270,270,8,2,6,2,1
14,292,292,39,7,32,3,2
20,302,302,33,33,0,1,0
17,342,342,19,19,0,1,0
16,361,361,106,106,0,1,0
2,365,365,22,12,10,3,2
4,370,370,84,65,19,2,1
0,412,412,67,24,43,2,1
5,470,470,40,40,0,1,0
12,471,471,16,16,0,1,0
10,480,480,4,4,0,1,0
1,483,483,8,8,0,1,0

3,102,102,3,3,0,1,0
10,109,109,3,3,0,1,0
12,121,121,21,10,11,2,1
11,154,154,8,8,0,1,0
14,219,219,2,2,0,1,0
20,225,225,27,27,0,1,0
18,250,250,16,16,0,1,0
16,258,258,29,29,0,1,0
1,267,267,3,3,0,1,0
4,295,295,9,9,0,1,0
23,309,309,45,18,27,2,1
6,325,325,10,10,0,1,0
7,333,333,1,1,0,1,0
21,337,337,120,66,54,4,3
2,365,365,51,1,50,3,2
0,366,366,72,72,0,1,0
13,387,387,44,44,0,1,0
9,409,409,35,35,0,1,0
19,410,410,4,4,0,1,0
22,415,415,52,52,0,1,0
17,437,437,7,1,6,2,1
15,450,450,71,71,0,1,0
8,474,474,33,15,18,2,1
5,478,478,66,49,17,2,1

3,127,127,7,3,4,2,1
13,128,128,20,20,0,1,0
18,134,134,4,4,0,1,0
6,162,162,18,18,0,1,0
16,175,175,12,3,9,4,3
0,189,189,12,12,0,1,0
10,201,201,76,76,0,1,0
8,249,249,17,17,0,1,0
12,256,256,18,1,17,2,1
17,265,265,1,1,0,1,0
11,279,279,30,17,13,2,1
4,285,285,58,58,0,1,0
19,316,316,16,11,5,2,1
7,330,330,80,43,37,2,1
15,370,370,43,19,24,4,3
14,396,396,55,6,49,4,3
2,397,397,80,80,0,1,0
9,415,415,4,4,0,1,0
1,431,431,10,2,8,2,1
5,479,479,59,20,39,2,1

8,129,129,35,35,0,1,0
10,162,162,21,5,16,2,1
2,170,170,10,10,0,1,0
5,199,199,17,11,6,2,1
12,201,201,2,2,0,1,0
13,208,208,7,7,0,1,0
9,215,215,59,59,0,1,0
11,242,242,15,7,8,2,1
17,283,283,85,19,66,3,2
4,288,288,18,4,14,2,1
16,354,354,9,9,0,1,0
3,364,364,7,1,6,3,2
6,370,370,61,19,42,3,2
7,374,374,14,14,0,1,0
15,374,374,1,1,0,1,0
1,419,419,25,1,24,2,1
0,458,458,281,277,4,2,1
14,486,486,1,1,0,1,0

15,104,104,12,4,8,3,2
10,121,121,2,2,0,1,0
9,121,121,17,3,14,4,3
0,123,123,26,26,0,1,0
12,130,130,17,17,0,1,0
17,279,279,26,6,20,2,1
11,279,279,4,4,0,1,0
4,295,295,17,17,0,1,0
18,319,319,21,10,11,2,1
2,333,333,35,6,29,2,1
13,384,384,150,50,100,4,3
1,392,392,1,1,0,1,0
7,431,431,50,50,0,1,0
3,433,433,23,17,6,2,1
6,454,454,131,77,54,3,2
5,461,461,76,60,16,2,1
8,463,463,47,47,0,1,0
16,469,469,38,38,0,1,0
14,494,494,37,11,26,2,1

5,100,100,20,1,19,2,1
20,155,155,4,4,0,1,0
0,195,195,1,1,0,1,0
11,209,209,2,2,0,1,0
7,227,227,23,23,0,1,0
8,243,243,24,13,11,2,1
6,262,262,43,3,40,4,3
2,270,270,22,7,15,4,3
12,270,270,1,1,0,1,0
18,275,275,49,49,0,1,0
3,284,284,41,14,27,4,3
19,294,294,52,52,0,1,0
21,312,312,35,35,0,1,0
23,317,317,41,41,0,1,0
1,421,421,9,9,0,1,0
14,427,427,132,24,108,4,3
15,438,438,34,34,0,1,0
10,444,444,46,46,0,1,0
22,449,449,8,8,0,1,0
16,463,463,24,24,0,1,0
17,473,473,16,16,0,1,0
13,481,481,7,7,0,1,0
9,488,488,5,5,0,1,0
4,490,490,70,60,10,2,1

17,140,140,19,16,3,2,1
0,146,146,68,68,0,1,0
15,165,165,67,45,22,2,1
11,192,192,15,15,0,1,0
10,220,220,10,4,6,3,2
3,252,252,37,37,0,1,0
4,263,263,22,4,18,4,3
8,309,309,12,12,0,1,0
9,311,311,41,23,18,4,3
2,325,325,76,76,0,1,0
16,345,345,4,4,0,1,0
12,387,387,52,52,0,1,0
14,404,404,27,9,18,3,2
1,453,453,28,28,0,1,0
5,460,460,29,29,0,1,0
13,479,479,36,21,15,4,3
6,482,482,18,18,0,1,0
7,489,489,4,4,0,1,0

8,101,101,1,1,0,1,0
7,120,120,14,4,10,3,2
19,146,146,17,17,0,1,0
11,162,162,21,21,0,1,0
24,162,162,20,6,14,3,2
21,180,180,12,12,0,1,0
23,193,193,18,18,0,1,0
17,214,214,45,45,0,1,0
18,217,217,52,3,49,2,1
14,239,239,21,21,0,1,0
3,255,255,3,3,0,1,0
25,275,275,37,14,23,4,3
6,290,290,8,5,3,2,1
0,295,295,24,5,19,2,1
22,304,304,7,1,6,2,1
5,320,320,5,5,0,1,0
15,324,324,71,53,18,2,1
26,349,349,26,14,12,4,3
20,371,371,14,2,12,4,3
1,383,383,10,10,0,1,0
16,389,389,2,2,0,1,0
12,391,391,7,7,0,1,0
2,399,399,69,55,14,4,3
10,432,432,39,8,31,2,1
13,472,472,17,8,9,4,3
9,483,483,13,8,5,2,1
4,495,495,13,13,0,1,0

6,119,119,34,34,0,1,0
9,121,121,16,6,10,2,1
3,134,134,7,7,0,1,0
10,137,137,8,8,0,1,0
4,138,138,15,12,3,2,1
5,148,148,1,1,0,1,0
13,168,168,1,1,0,1,0
7,184,184,10,4,6,2,1
22,234,234,36,36,0,1,0
23,239,239,7,2,5,2,1
16,250,250,14,4,10,2,1
2,260,260,1,1,0,1,0
17,278,278,6,6,0,1,0
0,294,294,32,14,18,3,2
12,296,296,26,13,13,2,1
21,306,306,101,101,0,1,0
18,323,323,29,3,26,3,2
14,345,345,27,12,15,4,3
8,347,347,7,7,0,1,0
11,347,347,2,2,0,1,0
20,356,356,4,4,0,1,0
15,396,396,1,1,0,1,0
24,397,397,9,9,0,1,0
1,417,417,38,23,15,4,3
19,421,421,168,164,4,2,1

10,127,127,5,5,0,1,0
19,161,161,10,4,6,2,1
22,185,185,13,13,0,1,0
5,186,186,3,3,0,1,0
6,195,195,26,8,18,4,3
15,199,199,19,7,12,2,1
2,211,211,7,7,0,1,0
12,225,225,26,12,14,3,2
17,239,239,4,1,3,2,1
11,258,258,44,44,0,1,0
9,278,278,35,26,9,2,1
16,287,287,25,25,0,1,0
8,300,300,17,17,0,1,0
21,328,328,12,12,0,1,0
18,349,349,24,1,23,2,1
20,349,349,7,7,0,1,0
14,361,361,175,37,138,4,3
4,377,377,3,3,0,1,0
0,410,410,67,17,50,2,1
3,428,428,17,17,0,1,0
13,464,464,82,82,0,1,0
7,466,466,10,5,5,2,1
1,496,496,88,84,4,2,1

24,119,119,3,3,0,1,0
21,134,134,4,1,3,2,1
13,148,148,3,3,0,1,0
0,148,148,12,12,0,1,0
22,159,159,1,1,0,1,0
23,166,166,76,76,0,1,0
20,173,173,11,11,0,1,0
3,184,184,15,15,0,1,0
14,192,192,11,11,0,1,0
7,199,199,25,25,0,1,0
1,225,225,5,5,0,1,0
2,246,246,1,1,0,1,0
5,272,272,6,6,0,1,0
18,277,277,88,53,35,2,1
19,319,319,13,1,12,4,3
12,330,330,49,25,24,4,3
16,355,355,14,14,0,1,0
8,373,373,21,4,17,2,1
25,380,380,10,1,9,2,1
9,416,416,12,12,0,1,0
4,418,418,37,2,35,3,2
10,449,449,6,6,0,1,0
6,451,451,46,46,0,1,0
11,463,463,82,82,0,1,0
15,466,466,16,16,0,1,0
26,474,474,54,15,39,3,2
17,485,485,24,1,23,2,1

12,105,105,34,34,0,1,0
4,123,123,10,2,8,3,2
0,146,146,3,3,0,1,0
7,163,163,10,10,0,1,0
1,192,192,13,13,0,1,0
16,198,198,9,9,0,1,0
13,207,207,26,8,18,2,1
9,220,220,66,48,18,3,2
20,241,241,9,6,3,2,1
14,260,260,24,24,0,1,0
3,272,272,33,13,20,2,1
8,308,308,3,3,0,1,0
11,312,312,22,22,0,1,0
15,361,361,26,26,0,1,0
18,407,407,12,12,0,1,0
2,434,434,123,123,0,1,0
6,462,462,23,23,0,1,0
17,462,462,21,21,0,1,0
10,467,467,4,4,0,1,0
21,477,477,83,83,0,1,0
19,482,482,86,64,22,2,1
5,494,494,13,1,12,4,3

18,101,101,2,2,0,1,0
2,102,102,11,11,0,1,0
13,114,114,5,5,0,1,0
11,122,122,20,20,0,1,0
12,127,127,1,1,0,1,0
19,129,129,13,1,12,3,2
16,132,132,27,27,0,1,0
6,166,166,23,23,0,1,0
9,184,184,4,4,0,1,0
0,190,190,1,1,0,1,0
3,196,196,1,1,0,1,0
20,227,227,25,18,7,2,1
5,231,231,23,23,0,1,0
14,249,249,9,9,0,1,0
15,274,274,55,38,17,2,1
8,339,339,59,11,48,3,2
4,352,352,47,47,0,1,0
10,392,392,53,1,52,4,3
1,420,420,114,52,62,3,2
7,461,461,4,4,0,1,0
17,494,494,122,39,83,3,2

7,135,135,5,5,0,1,0
1,148,148,1,1,0,1,0
21,163,163,5,5,0,1,0
13,172,172,1,1,0,1,0
16,174,174,10,10,0,1,0
3,202,202,17,5,12,4,3
20,207,207,7,7,0,1,0
19,207,207,19,6,13,2,1
4,230,230,48,33,15,2,1
24,232,232,27,1,26,4,3
5,233,233,13,13,0,1,0
0,246,246,29,29,0,1,0
25,264,264,6,2,4,2,1
22,276,276,30,30,0,1,0
2,309,309,12,6,6,3,2
15,315,315,33,33,0,1,0
6,352,352,1,1,0,1,0
8,372,372,26,22,4,2,1
17,375,375,25,7,18,4,3
14,376,376,45,14,31,2,1
26,412,412,151,135,16,2,1
23,419,419,71,33,38,3,2
11,422,422,14,14,0,1,0
10,448,448,36,14,22,2,1
9,460,460,33,33,0,1,0
12,479,479,4,4,0,1,0
18,500,500,55,55,0,1,0

13,120,120,16,7,9,2,1
5,145,145,5,5,0,1,0
4,165,165,6,6,0,1,0
9,170,170,7,4,3,2,1
15,218,218,36,36,0,1,0
18,219,219,29,29,0,1,0
21,223,223,13,13,0,1,0
12,225,225,5,5,0,1,0
22,232,232,23,18,5,2,1
8,240,240,35,16,19,2,1
0,247,247,2,2,0,1,0
16,253,253,86,8,78,3,2
7,270,270,41,41,0,1,0
1,277,277,1,1,0,1,0
17,304,304,1,1,0,1,0
20,315,315,4,1,3,2,1
2,333,333,52,25,27,4,3
24,377,377,59,59,0,1,0
6,404,404,1,1,0,1,0
14,420,420,39,20,19,2,1
10,478,478,95,17,78,4,3
11,495,495,31,15,16,3,2
19,497,497,2,2,0,1,0
23,497,497,72,36,36,4,3
3,500,500,6,6,0,1,0

12,103,103,2,2,0,1,0
4,122,122,10,10,0,1,0
3,136,136,8,8,0,1,0
0,139,139,32,7,25,2,1
13,141,141,11,11,0,1,0
9,181,181,29,8,21,2,1
16,250,250,75,9,66,3,2
11,273,273,1,1,0,1,0
15,288,288,18,18,0,1,0
6,319,319,68,68,0,1,0
17,326,326,8,2,6,3,2
5,358,358,42,28,14,2,1
18,359,359,20,10,10,2,1
1,364,364,13,9,4,2,1
7,369,369,45,8,37,2,1
2,449,449,65,60,5,2,1
10,449,449,167,167,0,1,0
14,469,469,21,21,0,1,0
8,480,480,47,1,46,2,1

1,100,100,7,3,4,2,1
21,130,130,10,10,0,1,0
9,150,150,12,12,0,1,0
14,161,161,8,8,0,1,0
11,179,179,20,20,0,1,0
18,203,203,68,47,21,2,1
16,220,220,43,2,41,4,3
5,246,246,55,17,38,3,2
13,247,247,6,3,3,2,1
20,258,258,8,8,0,1,0
2,269,269,37,37,0,1,0
4,320,320,46,37,9,4,3
17,335,335,39,39,0,1,0
19,345,345,63,63,0,1,0
8,346,346,14,2,12,4,3
0,359,359,40,40,0,1,0
6,371,371,4,4,0,1,0
3,384,384,8,8,0,1,0
12,408,408,26,2,24,3,2
15,450,450,21,16,5,2,1
7,491,491,13,13,0,1,0
10,499,499,62,62,0,1,0

4,132,132,13,5,8,3,2
18,143,143,1,1,0,1,0
23,147,147,36,36,0,1,0
22,155,155,41,41,0,1,0
21,180,180,13,2,11,2,1
9,191,191,36,31,5,2,1
1,196,196,13,3,10,2,1
3,198,198,1,1,0,1,0
15,205,205,59,59,0,1,0
14,219,219,5,5,0,1,0
11,243,243,1,1,0,1,0
20,272,272,1,1,0,1,0
19,296,296,31,7,24,3,2
2,298,298,12,12,0,1,0
12,341,341,34,34,0,1,0
7,375,375,38,29,9,2,1
24,381,381,42,31,11,2,1
17,393,393,10,10,0,1,0
0,406,406,2,2,0,1,0
13,415,415,67,19,48,3,2
16,420,420,1,1,0,1,0
10,433,433,41,15,26,3,2
5,452,452,72,72,0,1,0
6,464,464,22,22,0,1,0
8,495,495,4,4,0,1,0

16,132,132,13,13,0,1,0
0,134,134,17,6,11,2,1
7,157,157,21,21,0,1,0
4,164,164,11,1,10,2,1
12,170,170,8,5,3,2,1
9,174,174,41,41,0,1,0
18,177,177,6,6,0,1,0
10,236,236,38,38,0,1,0
5,242,242,15,15,0,1,0
2,243,243,71,43,28,2,1
19,269,269,55,3,52,3,2
8,270,270,14,14,0,1,0
6,317,317,19,13,6,2,1
17,321,321,43,43,0,1,0
13,338,338,14,14,0,1,0
14,373,373,36,36,0,1,0
1,374,374,10,3,7,2,1
3,411,411,19,19,0,1,0
11,443,443,73,31,42,4,3
15,455,455,64,64,0,1,0

19,119,119,5,5,0,1,0
15,123,123,28,28,0,1,0
22,132,132,3,3,0,1,0
3,147,147,11,11,0,1,0
21,169,169,7,1,6,2,1
11,171,171,29,9,20,3,2
25,221,221,40,14,26,2,1
10,244,244,6,3,3,2,1
17,270,270,6,6,0,1,0
8,272,272,24,24,0,1,0
18,281,281,7,4,3,2,1
14,282,282,26,2,24,4,3
20,308,308,23,23,0,1,0
13,339,339,30,30,0,1,0
12,340,340,3,3,0,1,0
23,355,355,212,65,147,4,3
16,356,356,13,1,12,4,3
7,367,367,14,6,8,2,1
2,371,371,18,18,0,1,0
5,395,395,13,7,6,2,1
0,420,420,15,15,0,1,0
9,451,451,58,43,15,2,1
1,458,458,7,1,6,2,1
6,461,461,7,7,0,1,0
24,487,487,36,3,33,4,3
4,499,499,7,2,5,2,1

1,143,143,41,25,16,2,1
2,146,146,4,4,0,1,0
16,150,150,12,12,0,1,0
13,160,160,1,1,0,1,0
0,214,214,13,1,12,3,2
15,221,221,8,8,0,1,0
20,224,224,8,5,3,2,1
12,245,245,4,4,0,1,0
14,251,251,23,23,0,1,0
11,284,284,3,3,0,1,0
4,317,317,54,30,24,4,3
3,326,326,28,28,0,1,0
10,361,361,9,9,0,1,0
9,365,365,49,49,0,1,0
19,373,373,85,85,0,1,0
7,400,400,27,27,0,1,0
6,405,405,37,19,18,4,3
18,419,419,120,120,0,1,0
5,451,451,11,11,0,1,0
8,451,451,58,29,29,2,1
17,494,494,161,61,100,3,2

16,103,103,7,1,6,3,2
7,126,126,27,27,0,1,0
10,157,157,11,3,8,3,2
0,163,163,1,1,0,1,0
11,166,166,57,25,32,3,2
4,179,179,52,52,0,1,0
2,190,190,18,10,8,2,1
17,261,261,28,28,0,1,0
13,280,280,50,50,0,1,0
1,284,284,2,2,0,1,0
6,315,315,22,6,16,3,2
8,316,316,5,5,0,1,0
20,410,410,72,51,21,4,3
14,426,426,26,26,0,1,0
18,428,428,5,5,0,1,0
5,443,443,59,59,0,1,0
3,443,443,22,22,0,1,0
9,454,454,69,11,58,3,2
19,463,463,14,9,5,2,1
15,488,488,29,29,0,1,0
12,492,492,40,23,17,2,1

5,132,132,37,7,30,4,3
18,153,153,13,5,8,3,2
7,168,168,8,8,0,1,0
1,210,210,5,5,0,1,0
3,211,211,12,3,9,2,1
4,221,221,31,31,0,1,0
8,264,264,27,27,0,1,0
19,266,266,10,10,0,1,0
16,268,268,24,24,0,1,0
17,269,269,1,1,0,1,0
14,315,315,6,6,0,1,0
6,323,323,2,2,0,1,0
10,360,360,5,5,0,1,0
9,396,396,8,8,0,1,0
21,397,397,89,65,24,4,3
13,402,402,36,36,0,1,0
11,420,420,79,79,0,1,0
2,436,436,15,6,9,2,1
22,453,453,45,41,4,2,1
12,460,460,47,47,0,1,0
20,462,462,203,203,0,1,0
0,465,465,40,1,39,2,1
15,472,472,14,2,12,2,1

21,100,100,8,8,0,1,0
22,101,101,11,6,5,2,1
26,108,108,16,16,0,1,0
29,112,112,10,1,9,2,1
1,115,115,5,5,0,1,0
14,119,119,4,4,0,1,0
9,121,121,5,5,0,1,0
19,154,154,3,3,0,1,0
20,203,203,29,29,0,1,0
7,226,226,16,4,12,4,3
11,240,240,8,8,0,1,0
18,270,270,15,3,12,3,2
28,275,275,52,52,0,1,0
6,289,289,5,5,0,1,0
8,293,293,35,35,0,1,0
16,352,352,40,40,0,1,0
2,357,357,38,16,22,3,2
25,361,361,57,57,0,1,0
10,371,371,7,7,0,1,0
3,406,406,18,18,0,1,0
13,423,423,3,3,0,1,0
0,439,439,13,4,9,2,1
24,446,446,4,4,0,1,0
15,458,458,53,53,0,1,0
17,469,469,17,17,0,1,0
27,473,473,86,33,53,4,3
5,476,476,20,20,0,1,0
23,479,479,11,3,8,2,1
4,486,486,38,8,30,2,1
12,494,494,38,11,27,2,1

13,113,113,6,1,5,2,1
5,150,150,19,3,16,4,3
11,150,150,3,3,0,1,0
12,201,201,2,2,0,1,0
2,205,205,41,31,10,3,2
16,335,335,7,7,0,1,0
8,341,341,144,108,36,3,2
3,376,376,4,4,0,1,0
0,401,401,52,52,0,1,0
1,405,405,7,7,0,1,0
7,415,415,1,1,0,1,0
10,428,428,12,12,0,1,0
15,429,429,115,18,97,4,3
9,442,442,55,5,50,3,2
6,446,446,20,11,9,4,3
4,454,454,260,194,66,4,3
14,495,495,82,77,5,2,1

9,101,101,5,5,0,1,0
1,103,103,4,4,0,1,0
4,134,134,56,41,15,2,1
15,162,162,5,5,0,1,0
13,162,162,1,1,0,1,0
3,188,188,17,6,11,2,1
11,188,188,26,1,25,2,1
12,193,193,21,7,14,3,2
16,226,226,23,6,17,2,1
2,271,271,34,1,33,4,3
14,280,280,31,31,0,1,0
17,307,307,48,24,24,2,1
19,311,311,18,18,0,1,0
0,311,311,17,17,0,1,0
7,333,333,70,12,58,3,2
6,347,347,13,13,0,1,0
18,356,356,66,30,36,4,3
5,463,463,13,13,0,1,0
10,466,466,106,73,33,4,3
8,477,477,23,23,0,1,0

11,115,115,12,12,0,1,0
3,115,115,2,2,0,1,0
16,118,118,15,15,0,1,0
13,121,121,10,1,9,4,3
12,163,163,95,95,0,1,0
1,170,170,49,22,27,4,3
20,170,170,1,1,0,1,0
7,181,181,12,12,0,1,0
4,232,232,10,10,0,1,0
0,259,259,1,1,0,1,0
14,267,267,4,4,0,1,0
8,285,285,9,1,8,2,1
19,288,288,9,3,6,2,1
6,304,304,39,39,0,1,0
18,309,309,13,1,12,4,3
5,313,313,99,99,0,1,0
17,329,329,34,34,0,1,0
15,353,353,11,11,0,1,0
2,444,444,4,4,0,1,0
9,463,463,12,5,7,2,1
10,471,471,81,81,0,1,0

8,104,104,6,6,0,1,0
20,136,136,6,6,0,1,0
9,152,152,1,1,0,1,0
12,167,167,10,1,9,3,2
0,172,172,11,11,0,1,0
21,174,174,9,3,6,2,1
16,175,175,31,21,10,3,2
7,186,186,37,9,28,3,2
6,199,199,9,4,5,2,1
5,259,259,31,5,26,3,2
13,277,277,81,81,0,1,0
17,308,308,39,25,14,3,2
2,326,326,11,11,0,1,0
15,354,354,44,17,27,4,3
4,360,360,3,3,0,1,0
19,392,392,22,22,0,1,0
10,399,399,8,8,0,1,0
3,409,409,121,13,108,4,3
18,421,421,3,3,0,1,0
14,470,470,84,84,0,1,0
1,490,490,92,84,8,2,1
11,491,491,31,4,27,4,3

17,110,110,4,4,0,1,0
1,113,113,3,3,0,1,0
13,120,120,4,4,0,1,0
2,123,123,22,22,0,1,0
14,176,176,25,25,0,1,0
11,214,214,3,3,0,1,0
10,240,240,55,55,0,1,0
3,270,270,22,22,0,1,0
4,292,292,31,5,26,2,1
5,338,338,66,66,0,1,0
12,377,377,108,15,93,4,3
7,405,405,36,12,24,3,2
15,425,425,100,64,36,2,1
6,432,432,16,16,0,1,0
16,435,435,7,1,6,3,2
8,443,443,45,21,24,2,1
9,459,459,21,21,0,1,0
18,460,460,21,21,0,1,0
0,479,479,115,76,39,4,3
19,485,485,41,41,0,1,0

9,110,110,9,4,5,2,1
15,113,113,4,4,0,1,0
17,124,124,2,2,0,1,0
4,125,125,14,14,0,1,0
18,151,151,1,1,0,1,0
11,178,178,13,13,0,1,0
16,184,184,58,34,24,2,1
5,208,208,2,2,0,1,0
12,216,216,29,29,0,1,0
14,227,227,15,11,4,2,1
10,244,244,6,6,0,1,0
6,255,255,40,40,0,1,0
3,270,270,63,18,45,3,2
19,281,281,30,18,12,2,1
8,321,321,76,76,0,1,0
2,325,325,30,2,28,2,1
7,390,390,21,1,20,3,2
0,402,402,19,1,18,3,2
1,469,469,38,23,15,4,3
13,494,494,172,172,0,1,0

15,108,108,26,26,0,1,0
19,116,116,7,7,0,1,0
16,169,169,2,2,0,1,0
11,174,174,4,4,0,1,0
1,177,177,3,3,0,1,0
7,206,206,38,38,0,1,0
3,207,207,2,2,0,1,0
4,248,248,59,59,0,1,0
8,298,298,42,2,40,2,1
13,300,300,34,19,15,2,1
0,307,307,25,25,0,1,0
14,309,309,75,75,0,1,0
18,311,311,45,22,23,4,3
9,343,343,28,4,24,2,1
20,384,384,40,8,32,4,3
22,415,415,70,58,12,2,1
23,420,420,52,42,10,2,1
5,429,429,8,8,0,1,0
6,435,435,38,38,0,1,0
10,449,449,15,15,0,1,0
17,474,474,8,1,7,2,1
12,474,474,1,1,0,1,0
21,480,480,5,5,0,1,0
2,496,496,35,17,18,4,3

13,208,208,21,21,0,1,0
4,211,211,3,3,0,1,0
6,222,222,69,54,15,2,1
10,244,244,21,21,0,1,0
11,251,251,145,145,0,1,0
2,305,305,10,10,0,1,0
17,319,319,2,2,0,1,0
14,319,319,5,5,0,1,0
16,321,321,5,5,0,1,0
1,331,331,5,5,0,1,0
15,352,352,19,13,6,2,1
12,353,353,41,41,0,1,0
19,357,357,53,11,42,2,1
8,359,359,19,19,0,1,0
18,389,389,14,2,12,3,2
20,395,395,18,2,16,2,1
0,435,435,43,11,32,2,1
7,443,443,10,10,0,1,0
9,448,448,8,8,0,1,0
3,463,463,53,53,0,1,0
5,468,468,157,101,56,4,3

24,109,109,11,3,8,3,2
23,122,122,1,1,0,1,0
28,123,123,4,1,3,2,1
22,125,125,20,20,0,1,0
4,127,127,2,2,0,1,0
3,127,127,14,14,0,1,0
17,134,134,2,2,0,1,0
13,134,134,6,6,0,1,0
7,156,156,6,6,0,1,0
9,160,160,26,26,0,1,0
26,180,180,62,62,0,1,0
2,224,224,4,4,0,1,0
15,238,238,10,10,0,1,0
25,239,239,3,3,0,1,0
18,283,283,11,7,4,2,1
0,290,290,48,48,0,1,0
6,319,319,2,2,0,1,0
27,343,343,11,11,0,1,0
11,353,353,15,9,6,3,2
5,392,392,11,7,4,2,1
8,395,395,1,1,0,1,0
1,436,436,25,7,18,2,1
14,436,436,21,1,20,3,2
21,439,439,17,17,0,1,0
16,454,454,15,5,10,3,2
10,455,455,105,13,92,3,2
19,473,473,10,10,0,1,0
12,489,489,1,1,0,1,0
20,495,495,185,172,13,2,1

10,118,118,10,3,7,2,1
1,164,164,1,1,0,1,0
9,173,173,15,15,0,1,0
0,322,322,11,11,0,1,0
2,325,325,33,26,7,2,1
5,340,340,18,18,0,1,0
14,342,342,103,103,0,1,0
3,345,345,206,206,0,1,0
15,354,354,35,35,0,1,0
8,362,362,31,31,0,1,0
11,362,362,46,46,0,1,0
13,400,400,10,10,0,1,0
6,433,433,17,3,14,3,2
7,458,458,3,3,0,1,0
12,469,469,38,4,34,3,2
16,472,472,105,105,0,1,0
4,479,479,129,129,0,1,0

0,117,117,2,2,0,1,0
4,127,127,23,23,0,1,0
15,128,128,1,1,0,1,0
1,160,160,10,10,0,1,0
11,207,207,15,15,0,1,0
18,208,208,3,3,0,1,0
13,228,228,11,2,9,3,2
7,239,239,27,22,5,2,1
10,243,243,3,3,0,1,0
9,288,288,119,44,75,4,3
19,293,293,16,10,6,2,1
2,307,307,3,3,0,1,0
6,326,326,39,39,0,1,0
3,336,336,2,2,0,1,0
5,340,340,10,6,4,2,1
20,357,357,75,75,0,1,0
8,378,378,52,52,0,1,0
12,382,382,33,33,0,1,0
17,456,456,40,40,0,1,0
16,464,464,38,23,15,2,1
14,468,468,217,100,117,4,3

2,120,120,30,22,8,3,2
18,151,151,16,1,15,4,3
6,154,154,2,2,0,1,0
20,172,172,10,2,8,2,1
13,196,196,4,4,0,1,0
7,214,214,42,17,25,2,1
15,227,227,43,14,29,2,1
16,228,228,65,65,0,1,0
0,245,245,57,26,31,2,1
14,279,279,8,8,0,1,0
19,288,288,62,55,7,2,1
1,298,298,9,3,6,3,2
9,313,313,9,2,7,2,1
4,313,313,20,14,6,3,2
8,329,329,31,4,27,2,1
3,372,372,28,28,0,1,0
10,373,373,29,29,0,1,0
12,378,378,47,47,0,1,0
11,461,461,11,11,0,1,0
5,474,474,7,7,0,1,0
17,480,480,24,24,0,1,0
21,498,498,18,18,0,1,0

13,146,146,6,6,0,1,0
14,164,164,7,7,0,1,0
1,184,184,36,10,26,3,2
2,188,188,1,1,0,1,0
8,195,195,9,9,0,1,0
18,205,205,25,25,0,1,0
15,215,215,50,50,0,1,0
0,246,246,3,3,0,1,0
19,312,312,1,1,0,1,0
7,319,319,44,44,0,1,0
10,328,328,3,3,0,1,0
20,360,360,18,11,7,2,1
4,389,389,34,34,0,1,0
5,419,419,163,37,126,4,3
12,437,437,8,8,0,1,0
16,464,464,136,52,84,4,3
6,465,465,12,12,0,1,0
9,467,467,53,21,32,2,1
11,468,468,24,24,0,1,0
3,469,469,13,6,7,2,1
17,473,473,13,13,0,1,0
21,474,474,136,92,44,3,2

1,103,103,9,9,0,1,0
10,111,111,3,3,0,1,0
20,134,134,2,2,0,1,0
9,176,176,19,19,0,1,0
6,212,212,31,17,14,3,2
14,243,243,1,1,0,1,0
2,250,250,2,2,0,1,0
17,268,268,20,4,16,3,2
21,287,287,4,4,0,1,0
11,304,304,13,13,0,1,0
19,305,305,9,5,4,2,1
4,307,307,17,17,0,1,0
16,336,336,26,2,24,4,3
22,346,346,7,7,0,1,0
0,349,349,35,35,0,1,0
15,353,353,119,110,9,4,3
8,359,359,54,54,0,1,0
7,384,384,46,35,11,2,1
3,385,385,13,2,11,2,1
13,390,390,139,28,111,4,3
12,426,426,1,1,0,1,0
5,427,427,94,29,65,3,2
18,438,438,83,83,0,1,0

13,101,101,13,4,9,2,1
17,192,192,1,1,0,1,0
2,214,214,8,8,0,1,0
15,259,259,42,42,0,1,0
19,262,262,66,45,21,4,3
0,284,284,11,1,10,2,1
3,324,324,19,11,8,2,1
14,331,331,28,28,0,1,0
4,335,335,64,23,41,2,1
6,341,341,119,77,42,3,2
5,349,349,56,56,0,1,0
18,401,401,14,14,0,1,0
7,420,420,11,2,9,3,2
10,428,428,1,1,0,1,0
9,456,456,93,93,0,1,0
12,459,459,62,62,0,1,0
8,466,466,16,16,0,1,0
11,470,470,123,23,100,3,2
16,489,489,26,26,0,1,0
1,493,493,1,1,0,1,0

18,112,112,33,17,16,3,2
16,136,136,26,11,15,2,1
3,147,147,40,40,0,1,0
21,156,156,13,1,12,2,1
20,188,188,3,3,0,1,0
14,191,191,46,15,31,2,1
4,201,201,9,4,5,2,1
7,211,211,2,2,0,1,0
9,215,215,8,8,0,1,0
6,231,231,23,10,13,2,1
11,291,291,22,10,12,4,3
0,333,333,33,33,0,1,0
13,352,352,5,5,0,1,0
8,398,398,41,41,0,1,0
1,428,428,37,1,36,2,1
2,432,432,10,10,0,1,0
19,436,436,74,74,0,1,0
12,438,438,25,13,12,3,2
10,477,477,3,3,0,1,0
15,480,480,11,7,4,2,1
5,489,489,120,120,0,1,0
17,497,497,19,4,15,4,3

19,117,117,19,8,11,3,2
14,124,124,17,17,0,1,0
11,125,125,7,7,0,1,0
15,147,147,33,23,10,2,1
13,159,159,28,28,0,1,0
0,202,202,3,3,0,1,0
3,211,211,36,17,19,2,1
12,221,221,1,1,0,1,0
17,250,250,3,3,0,1,0
20,313,313,55,43,12,3,2
6,326,326,104,104,0,1,0
9,332,332,7,1,6,3,2
18,372,372,12,12,0,1,0
1,376,376,11,4,7,2,1
7,410,410,31,10,21,4,3
8,418,418,50,40,10,2,1
2,420,420,31,31,0,1,0
16,433,433,61,33,28,3,2
4,484,484,65,65,0,1,0
5,497,497,37,37,0,1,0
10,498,498,34,34,0,1,0

0,132,132,18,18,0,1,0
3,168,168,13,13,0,1,0
10,196,196,14,14,0,1,0
18,218,218,6,6,0,1,0
12,223,223,81,66,15,2,1
7,255,255,6,6,0,1,0
9,272,272,29,12,17,2,1
6,290,290,11,6,5,2,1
14,293,293,17,17,0,1,0
19,371,371,10,6,4,2,1
4,398,398,126,126,0,1,0
2,411,411,17,2,15,2,1
8,419,419,34,34,0,1,0
17,424,424,102,102,0,1,0
13,442,442,21,21,0,1,0
15,443,443,50,50,0,1,0
16,443,443,5,5,0,1,0
1,448,448,40,40,0,1,0
11,464,464,72,48,24,4,3
5,467,467,89,63,26,4,3

17,121,121,5,5,0,1,0
15,132,132,3,3,0,1,0
2,135,135,1,1,0,1,0
6,183,183,32,32,0,1,0
16,183,183,8,3,5,2,1
14,197,197,16,16,0,1,0
1,201,201,13,2,11,2,1
10,245,245,79,53,26,3,2
13,271,271,90,83,7,2,1
3,291,291,16,16,0,1,0
0,386,386,35,35,0,1,0
4,388,388,19,19,0,1,0
7,394,394,86,44,42,3,2
12,402,402,15,15,0,1,0
11,408,408,1,1,0,1,0
8,438,438,23,13,10,2,1
9,465,465,85,38,47,2,1
5,468,468,206,206,0,1,0

4,114,114,3,3,0,1,0
18,126,126,3,3,0,1,0
25,129,129,3,3,0,1,0
21,146,146,9,9,0,1,0
23,173,173,8,1,7,2,1
27,196,196,72,26,46,3,2
1,199,199,1,1,0,1,0
24,213,213,19,19,0,1,0
3,223,223,1,1,0,1,0
6,263,263,9,3,6,2,1
13,264,264,47,2,45,2,1
5,265,265,1,1,0,1,0
9,267,267,1,1,0,1,0
16,275,275,13,13,0,1,0
22,294,294,7,1,6,2,1
14,327,327,34,34,0,1,0
8,351,351,6,6,0,1,0
0,356,356,58,40,18,4,3
10,373,373,57,57,0,1,0
17,389,389,41,17,24,3,2
7,390,390,44,44,0,1,0
26,390,390,118,34,84,3,2
20,401,401,7,7,0,1,0
11,403,403,4,4,0,1,0
19,421,421,72,34,38,4,3
12,424,424,16,16,0,1,0
2,442,442,32,12,20,2,1
15,489,489,12,12,0,1,0

18,104,104,24,6,18,2,1
3,134,134,12,5,7,2,1
2,168,168,1,1,0,1,0
11,171,171,18,7,11,3,2
10,179,179,53,5,48,4,3
17,189,189,18,18,0,1,0
12,210,210,21,21,0,1,0
6,213,213,12,12,0,1,0
20,265,265,18,15,3,2,1
1,298,298,13,3,10,2,1
4,299,299,9,9,0,1,0
8,321,321,1,1,0,1,0
14,357,357,37,37,0,1,0
21,364,364,110,110,0,1,0
13,399,399,39,39,0,1,0
5,430,430,32,14,18,3,2
7,462,462,17,17,0,1,0
16,482,482,11,6,5,2,1
15,484,484,23,3,20,2,1
9,489,489,115,115,0,1,0
0,497,497,62,62,0,1,0
19,500,500,29,11,18,4,3

13,196,196,25,25,0,1,0
7,206,206,59,26,33,4,3
16,227,227,10,10,0,1,0
9,244,244,18,4,14,3,2
0,254,254,1,1,0,1,0
6,264,264,11,5,6,3,2
3,274,274,45,45,0,1,0
5,322,322,29,29,0,1,0
11,322,322,1,1,0,1,0
2,332,332,26,26,0,1,0
1,335,335,91,91,0,1,0
15,371,371,41,30,11,2,1
14,410,410,70,56,14,2,1
17,410,410,25,25,0,1,0
4,416,416,70,41,29,2,1
12,430,430,6,2,4,2,1
8,443,443,123,105,18,2,1
10,453,453,105,105,0,1,0

3,119,119,7,7,0,1,0
0,161,161,10,5,5,2,1
13,165,165,20,3,17,2,1
18,168,168,9,9,0,1,0
1,174,174,13,4,9,2,1
14,182,182,39,39,0,1,0
5,195,195,33,33,0,1,0
17,241,241,39,33,6,3,2
19,248,248,1,1,0,1,0
15,347,347,38,38,0,1,0
7,354,354,104,104,0,1,0
8,355,355,7,7,0,1,0
11,372,372,45,45,0,1,0
12,397,397,63,63,0,1,0
16,397,397,15,12,3,2,1
2,403,403,43,43,0,1,0
9,418,418,5,5,0,1,0
6,450,450,17,17,0,1,0
4,454,454,121,78,43,2,1
10,485,485,65,33,32,2,1

2,102,102,4,4,0,1,0
18,124,124,20,20,0,1,0
1,132,132,48,36,12,4,3
13,157,157,65,65,0,1,0
12,172,172,5,5,0,1,0
0,177,177,16,16,0,1,0
11,194,194,27,27,0,1,0
19,200,200,12,12,0,1,0
7,273,273,8,8,0,1,0
9,288,288,6,6,0,1,0
16,295,295,1,1,0,1,0
3,309,309,44,4,40,3,2
10,320,320,22,5,17,2,1
8,321,321,50,50,0,1,0
6,324,324,46,46,0,1,0
5,351,351,36,36,0,1,0
17,437,437,78,78,0,1,0
15,467,467,5,5,0,1,0
4,469,469,8,8,0,1,0
14,475,475,24,24,0,1,0

2,101,101,1,1,0,1,0
8,122,122,2,2,0,1,0
26,139,139,34,18,16,3,2
9,140,140,2,2,0,1,0
29,151,151,18,11,7,2,1
17,155,155,11,11,0,1,0
13,164,164,27,12,15,4,3
10,169,169,31,26,5,2,1
1,181,181,1,1,0,1,0
6,182,182,1,1,0,1,0
7,192,192,6,1,5,2,1
16,194,194,2,2,0,1,0
24,196,196,1,1,0,1,0
21,210,210,17,17,0,1,0
0,220,220,3,3,0,1,0
4,226,226,83,83,0,1,0
22,276,276,47,27,20,3,2
23,295,295,24,24,0,1,0
12,316,316,20,10,10,2,1
11,316,316,5,5,0,1,0
25,336,336,14,8,6,3,2
20,358,358,37,37,0,1,0
5,365,365,13,4,9,4,3
15,385,385,3,3,0,1,0
27,392,392,56,56,0,1,0
19,413,413,4,4,0,1,0
14,425,425,13,13,0,1,0
3,492,492,19,19,0,1,0
18,492,492,3,3,0,1,0
28,498,498,65,8,57,4,3

6,101,101,1,1,0,1,0
12,116,116,7,7,0,1,0
1,145,145,9,9,0,1,0
0,169,169,27,27,0,1,0
10,202,202,28,19,9,4,3
2,203,203,1,1,0,1,0
9,302,302,2,2,0,1,0
5,308,308,22,7,15,4,3
8,321,321,190,76,114,4,3
7,328,328,6,6,0,1,0
15,335,335,2,2,0,1,0
4,375,375,65,65,0,1,0
17,413,413,62,8,54,3,2
18,421,421,76,72,4,2,1
13,463,463,160,133,27,4,3
3,472,472,5,5,0,1,0
14,479,479,80,50,30,3,2
11,480,480,5,5,0,1,0
16,493,493,27,6,21,4,3

11,123,123,5,5,0,1,0
1,126,126,17,17,0,1,0
14,137,137,29,14,15,4,3
10,218,218,2,2,0,1,0
0,257,257,5,5,0,1,0
12,269,269,34,16,18,3,2
13,277,277,82,24,58,3,2
16,281,281,2,2,0,1,0
6,303,303,34,21,13,3,2
4,357,357,65,26,39,2,1
15,365,365,88,16,72,3,2
9,384,384,9,9,0,1,0
2,391,391,43,43,0,1,0
8,416,416,64,19,45,4,3
3,431,431,149,149,0,1,0
17,439,439,5,5,0,1,0
5,450,450,88,88,0,1,0
7,454,454,1,1,0,1,0

9,114,114,9,3,6,2,1
21,119,119,14,14,0,1,0
12,136,136,20,20,0,1,0
0,137,137,9,9,0,1,0
2,140,140,27,27,0,1,0
13,166,166,7,1,6,3,2
1,230,230,20,20,0,1,0
19,254,254,85,65,20,2,1
3,257,257,3,3,0,1,0
11,267,267,1,1,0,1,0
6,289,289,6,2,4,2,1
17,305,305,30,30,0,1,0
14,320,320,11,11,0,1,0
16,355,355,25,17,8,2,1
10,359,359,92,11,81,4,3
8,374,374,16,16,0,1,0
18,412,412,7,7,0,1,0
5,437,437,53,53,0,1,0
20,460,460,49,49,0,1,0
15,468,468,73,54,19,2,1
7,470,470,95,3,92,4,3
4,492,492,10,2,8,3,2

3,108,108,12,1,11,2,1
4,134,134,1,1,0,1,0
6,156,156,13,2,11,3,2
18,252,252,18,4,14,3,2
9,306,306,75,6,69,4,3
1,318,318,72,72,0,1,0
16,328,328,10,3,7,2,1
11,337,337,77,77,0,1,0
13,356,356,30,15,15,2,1
7,357,357,7,2,5,2,1
8,362,362,23,13,10,3,2
0,402,402,81,81,0,1,0
14,403,403,4,4,0,1,0
10,406,406,61,27,34,4,3
12,411,411,100,8,92,4,3
5,416,416,40,40,0,1,0
17,436,436,9,5,4,2,1
2,459,459,134,95,39,4,3
15,462,462,13,13,0,1,0

14,107,107,14,14,0,1,0
7,114,114,14,14,0,1,0
19,125,125,14,14,0,1,0
20,141,141,3,3,0,1,0
1,168,168,18,18,0,1,0
11,171,171,4,1,3,2,1
3,181,181,11,11,0,1,0
2,187,187,36,30,6,2,1
23,200,200,9,3,6,2,1
0,222,222,10,2,8,3,2
10,227,227,26,11,15,4,3
13,272,272,24,24,0,1,0
4,285,285,45,16,29,2,1
6,302,302,1,1,0,1,0
21,383,383,205,131,74,3,2
22,383,383,7,7,0,1,0
5,390,390,4,4,0,1,0
12,412,412,1,1,0,1,0
9,429,429,15,15,0,1,0
15,460,460,20,20,0,1,0
16,483,483,56,43,13,2,1
18,487,487,45,45,0,1,0
8,488,488,67,67,0,1,0
17,496,496,3,3,0,1,0

7,109,109,12,12,0,1,0
2,112,112,3,3,0,1,0
13,113,113,56,8,48,2,1
10,124,124,1,1,0,1,0
0,161,161,19,19,0,1,0
11,178,178,14,4,10,3,2
1,190,190,23,9,14,3,2
8,191,191,31,1,30,2,1
6,196,196,101,77,24,4,3
12,230,230,8,8,0,1,0
3,257,257,16,13,3,2,1
4,295,295,34,26,8,2,1
5,369,369,14,4,10,2,1
17,375,375,24,24,0,1,0
16,412,412,5,5,0,1,0
15,449,449,45,45,0,1,0
14,475,475,50,20,30,2,1
9,492,492,26,26,0,1,0

11,100,100,8,2,6,2,1
15,166,166,39,39,0,1,0
3,180,180,6,1,5,2,1
14,220,220,13,13,0,1,0
20,255,255,13,3,10,3,2
12,264,264,40,8,32,2,1
10,286,286,35,35,0,1,0
0,323,323,59,59,0,1,0
16,357,357,30,10,20,2,1
8,362,362,32,13,19,2,1
13,362,362,23,16,7,2,1
5,364,364,25,25,0,1,0
6,375,375,10,10,0,1,0
19,385,385,54,7,47,2,1
18,393,393,59,22,37,4,3
7,408,408,8,2,6,3,2
9,420,420,33,18,15,2,1
4,426,426,1,1,0,1,0
2,429,429,100,51,49,2,1
22,460,460,81,35,46,4,3
21,465,465,63,28,35,3,2
1,479,479,7,7,0,1,0
17,485,485,10,2,8,3,2

19,105,105,21,12,9,2,1
10,116,116,13,1,12,3,2
0,170,170,9,9,0,1,0
3,173,173,15,5,10,2,1
6,195,195,16,12,4,2,1
12,231,231,13,13,0,1,0
11,244,244,7,7,0,1,0
15,244,244,16,16,0,1,0
16,255,255,8,8,0,1,0
13,258,258,20,15,5,2,1
5,278,278,2,2,0,1,0
18,298,298,2,2,0,1,0
14,311,311,96,54,42,3,2
17,312,312,32,23,9,2,1
9,342,342,60,46,14,4,3
2,349,349,9,9,0,1,0
8,351,351,76,58,18,2,1
1,402,402,1,1,0,1,0
23,437,437,21,5,16,3,2
22,470,470,95,11,84,3,2
7,482,482,85,19,66,4,3
20,485,485,53,33,20,2,1
4,487,487,1,1,0,1,0
21,493,493,23,23,0,1,0

7,122,122,7,7,0,1,0
12,147,147,2,2,0,1,0
1,156,156,5,2,3,2,1
11,183,183,61,50,11,2,1
13,205,205,30,14,16,3,2
6,218,218,22,15,7,2,1
3,288,288,167,26,141,4,3
10,298,298,17,17,0,1,0
8,322,322,5,2,3,2,1
5,364,364,50,50,0,1,0
0,402,402,41,41,0,1,0
2,428,428,122,122,0,1,0
14,476,476,86,86,0,1,0
9,491,491,42,42,0,1,0
4,496,496,51,5,46,2,1

0,111,111,3,3,0,1,0
6,121,121,26,26,0,1,0
20,138,138,1,1,0,1,0
3,141,141,6,1,5,2,1
4,173,173,3,3,0,1,0
10,175,175,24,24,0,1,0
21,210,210,44,32,12,4,3
17,226,226,31,31,0,1,0
15,241,241,7,1,6,3,2
1,256,256,39,3,36,4,3
14,285,285,11,11,0,1,0
13,317,317,15,2,13,2,1
19,360,360,124,16,108,4,3
11,360,360,23,23,0,1,0
9,374,374,14,4,10,2,1
12,377,377,16,1,15,4,3
8,390,390,67,5,62,4,3
2,419,419,20,20,0,1,0
22,474,474,23,23,0,1,0
5,477,477,22,2,20,3,2
7,481,481,49,7,42,2,1
18,485,485,120,26,94,3,2
16,494,494,6,6,0,1,0

21,106,106,3,3,0,1,0
16,119,119,5,5,0,1,0
9,147,147,2,2,0,1,0
10,153,153,7,7,0,1,0
7,154,154,15,15,0,1,0
19,154,154,5,5,0,1,0
14,219,219,1,1,0,1,0
24,238,238,110,102,8,3,2
13,276,276,17,17,0,1,0
3,292,292,22,11,11,2,1
5,303,303,11,3,8,3,2
18,306,306,6,3,3,2,1
6,361,361,111,111,0,1,0
20,379,379,65,25,40,3,2
0,387,387,23,23,0,1,0
4,388,388,3,3,0,1,0
12,389,389,13,5,8,2,1
23,411,411,4,4,0,1,0
1,422,422,34,16,18,4,3
2,427,427,23,13,10,2,1
17,441,441,3,3,0,1,0
15,459,459,102,12,90,3,2
22,496,496,64,64,0,1,0
8,497,497,87,2,85,4,3
11,497,497,26,2,24,4,3

22,106,106,7,7,0,1,0
21,112,112,15,11,4,2,1
2,148,148,4,4,0,1,0
18,174,174,17,12,5,2,1
9,184,184,6,6,0,1,0
1,191,191,6,6,0,1,0
6,191,191,52,52,0,1,0
20,250,250,40,6,34,3,2
13,293,293,6,6,0,1,0
16,341,341,38,30,8,3,2
15,390,390,26,2,24,2,1
3,408,408,40,19,21,3,2
14,420,420,15,15,0,1,0
23,434,434,30,19,11,2,1
11,444,444,40,40,0,1,0
0,470,470,67,20,47,2,1
12,474,474,13,1,12,2,1
5,474,474,6,6,0,1,0
17,476,476,63,59,4,2,1
19,487,487,119,92,27,4,3
10,499,499,154,91,63,4,3
7,499,499,6,2,4,2,1
8,500,500,2,2,0,1,0
4,500,500,12,12,0,1,0

6,103,103,8,8,0,1,0
10,115,115,1,1,0,1,0
1,154,154,34,6,28,3,2
3,161,161,17,4,13,4,3
15,165,165,20,6,14,3,2
17,194,194,36,36,0,1,0
5,203,203,17,17,0,1,0
7,206,206,1,1,0,1,0
14,209,209,75,75,0,1,0
2,218,218,18,18,0,1,0
21,230,230,10,10,0,1,0
4,239,239,13,4,9,4,3
23,311,311,23,23,0,1,0
12,319,319,2,2,0,1,0
18,327,327,8,8,0,1,0
22,330,330,8,8,0,1,0
16,332,332,53,17,36,2,1
8,347,347,66,8,58,3,2
13,431,431,8,8,0,1,0
0,444,444,31,31,0,1,0
9,451,451,47,31,16,3,2
11,480,480,35,35,0,1,0
20,483,483,23,23,0,1,0
19,497,497,39,39,0,1,0

1,131,131,32,32,0,1,0
7,138,138,9,3,6,2,1
0,156,156,4,4,0,1,0
12,163,163,6,2,4,2,1
18,179,179,74,56,18,4,3
10,205,205,7,1,6,2,1
3,210,210,31,8,23,2,1
15,237,237,36,28,8,2,1
8,240,240,6,1,5,2,1
16,249,249,1,1,0,1,0
11,272,272,20,20,0,1,0
13,274,274,15,2,13,2,1
9,310,310,2,2,0,1,0
17,319,319,34,16,18,3,2
4,338,338,10,4,6,3,2
5,353,353,24,24,0,1,0
6,364,364,19,8,11,2,1
14,415,415,100,50,50,3,2
2,480,480,214,154,60,3,2

1,130,130,20,20,0,1,0
3,134,134,3,3,0,1,0
19,143,143,30,30,0,1,0
7,165,165,13,13,0,1,0
18,166,166,1,1,0,1,0
14,170,170,23,14,9,4,3
23,185,185,16,16,0,1,0
11,200,200,22,22,0,1,0
10,212,212,36,36,0,1,0
5,232,232,1,1,0,1,0
8,245,245,16,16,0,1,0
2,247,247,6,6,0,1,0
16,251,251,13,13,0,1,0
20,302,302,23,14,9,2,1
12,305,305,5,1,4,2,1
15,310,310,119,55,64,3,2
17,342,342,4,4,0,1,0
0,368,368,50,50,0,1,0
13,385,385,4,4,0,1,0
22,408,408,24,10,14,2,1
9,412,412,34,13,21,3,2
21,427,427,41,14,27,2,1
4,445,445,35,35,0,1,0
6,500,500,74,38,36,4,3

11,117,117,13,1,12,3,2
16,157,157,62,62,0,1,0
19,159,159,2,2,0,1,0
2,164,164,1,1,0,1,0
8,186,186,15,15,0,1,0
4,187,187,1,1,0,1,0
13,187,187,5,5,0,1,0
18,191,191,31,1,30,3,2
20,219,219,14,6,8,3,2
17,228,228,2,2,0,1,0
14,283,283,7,7,0,1,0
0,356,356,4,4,0,1,0
3,361,361,158,118,40,2,1
9,392,392,27,5,22,4,3
7,398,398,20,20,0,1,0
12,412,412,64,64,0,1,0
10,446,446,159,71,88,3,2
1,446,446,11,11,0,1,0
15,458,458,73,44,29,2,1
5,476,476,27,11,16,2,1
6,495,495,1,1,0,1,0

19,131,131,33,4,29,2,1
10,150,150,10,10,0,1,0
16,171,171,13,13,0,1,0
9,176,176,8,4,4,2,1
0,178,178,9,9,0,1,0
2,207,207,19,19,0,1,0
21,224,224,30,30,0,1,0
14,262,262,2,2,0,1,0
20,275,275,15,15,0,1,0
8,286,286,23,23,0,1,0
6,292,292,34,34,0,1,0
7,337,337,9,9,0,1,0
18,340,340,2,2,0,1,0
15,364,364,21,21,0,1,0
5,378,378,127,77,50,4,3
17,392,392,133,13,120,4,3
12,393,393,8,8,0,1,0
23,412,412,1,1,0,1,0
22,417,417,27,8,19,2,1
13,420,420,23,2,21,4,3
4,423,423,1,1,0,1,0
11,437,437,50,17,33,2,1
1,492,492,2,2,0,1,0
3,493,493,42,33,9,4,3
24,495,495,65,61,4,2,1

10,104,104,9,9,0,1,0
8,108,108,34,6,28,3,2
3,130,130,25,5,20,3,2
15,163,163,1,1,0,1,0
14,167,167,43,23,20,2,1
2,204,204,19,10,9,4,3
5,225,225,18,3,15,4,3
6,240,240,114,114,0,1,0
16,249,249,18,15,3,2,1
9,293,293,77,17,60,3,2
0,320,320,19,7,12,3,2
4,349,349,56,12,44,3,2
7,370,370,7,7,0,1,0
11,392,392,8,8,0,1,0
13,393,393,30,6,24,3,2
1,427,427,18,11,7,2,1
12,427,427,5,5,0,1,0

6,106,106,8,1,7,2,1
20,117,117,1,1,0,1,0
1,141,141,11,11,0,1,0
16,192,192,5,5,0,1,0
3,208,208,16,16,0,1,0
2,217,217,34,34,0,1,0
9,218,218,1,1,0,1,0
12,257,257,1,1,0,1,0
11,258,258,72,56,16,2,1
4,271,271,33,33,0,1,0
22,286,286,5,1,4,2,1
5,338,338,19,11,8,3,2
15,343,343,84,31,53,4,3
19,350,350,8,8,0,1,0
7,351,351,30,1,29,2,1
10,368,368,4,1,3,2,1
17,385,385,124,124,0,1,0
13,414,414,122,113,9,2,1
8,427,427,8,8,0,1,0
18,433,433,27,9,18,2,1
14,436,436,1,1,0,1,0
21,454,454,50,1,49,3,2
0,489,489,65,15,50,2,1

23,110,110,16,7,9,2,1
6,123,123,20,20,0,1,0
1,150,150,11,11,0,1,0
15,164,164,7,2,5,2,1
10,171,171,4,4,0,1,0
4,194,194,8,8,0,1,0
9,228,228,28,28,0,1,0
0,233,233,12,6,6,2,1
5,266,266,10,10,0,1,0
21,270,270,32,18,14,2,1
22,279,279,28,19,9,2,1
18,281,281,23,1,22,3,2
26,297,297,24,24,0,1,0
17,309,309,49,49,0,1,0
20,310,310,51,51,0,1,0
25,321,321,27,5,22,3,2
3,338,338,17,7,10,3,2
12,344,344,46,46,0,1,0
2,388,388,52,52,0,1,0
16,390,390,3,3,0,1,0
24,406,406,56,16,40,3,2
7,433,433,1,1,0,1,0
19,440,440,21,21,0,1,0
13,449,449,9,5,4,2,1
11,458,458,18,18,0,1,0
8,466,466,40,40,0,1,0
14,475,475,35,31,4,2,1

8,114,114,1,1,0,1,0
4,123,123,13,2,11,2,1
0,124,124,31,31,0,1,0
5,125,125,14,14,0,1,0
16,129,129,1,1,0,1,0
7,139,139,1,1,0,1,0
23,170,170,1,1,0,1,0
19,226,226,67,7,60,3,2
15,236,236,1,1,0,1,0
22,236,236,22,14,8,2,1
9,240,240,10,7,3,2,1
12,243,243,6,6,0,1,0
3,251,251,6,6,0,1,0
6,257,257,30,30,0,1,0
11,272,272,1,1,0,1,0
17,277,277,24,20,4,2,1
13,297,297,85,43,42,4,3
14,310,310,15,15,0,1,0
1,325,325,5,5,0,1,0
2,340,340,15,15,0,1,0
20,354,354,117,117,0,1,0
26,383,383,4,4,0,1,0
25,405,405,20,14,6,3,2
21,447,447,43,43,0,1,0
18,481,481,11,8,3,2,1
24,487,487,60,60,0,1,0
10,495,495,1,1,0,1,0

6,111,111,3,3,0,1,0
5,130,130,9,9,0,1,0
0,150,150,11,11,0,1,0
3,161,161,33,13,20,2,1
1,185,185,103,44,59,3,2
7,194,194,7,4,3,2,1
12,198,198,24,15,9,4,3
4,231,231,27,27,0,1,0
11,314,314,147,147,0,1,0
15,351,351,1,1,0,1,0
2,382,382,23,23,0,1,0
10,396,396,77,20,57,4,3
14,415,415,21,17,4,2,1
8,447,447,33,20,13,3,2
13,451,451,3,3,0,1,0
9,467,467,52,52,0,1,0
16,495,495,24,20,4,2,1

12,203,203,74,74,0,1,0
15,258,258,3,3,0,1,0
1,268,268,1,1,0,1,0
9,299,299,19,19,0,1,0
16,302,302,39,12,27,4,3
14,306,306,10,10,0,1,0
6,308,308,5,5,0,1,0
7,329,329,6,2,4,2,1
0,335,335,49,44,5,2,1
10,342,342,5,5,0,1,0
13,349,349,34,25,9,2,1
17,366,366,73,73,0,1,0
11,375,375,22,22,0,1,0
2,379,379,33,33,0,1,0
5,385,385,101,77,24,4,3
19,394,394,45,34,11,2,1
20,416,416,21,21,0,1,0
4,423,423,98,98,0,1,0
8,433,433,64,1,63,4,3
18,448,448,26,26,0,1,0
3,463,463,51,38,13,2,1

17,113,113,29,11,18,4,3
20,130,130,1,1,0,1,0
9,137,137,9,9,0,1,0
19,137,137,52,52,0,1,0
16,141,141,9,9,0,1,0
21,214,214,6,3,3,2,1
6,235,235,2,2,0,1,0
2,249,249,22,3,19,2,1
3,263,263,11,5,6,2,1
0,274,274,28,12,16,2,1
15,287,287,59,59,0,1,0
10,291,291,108,30,78,4,3
14,334,334,24,24,0,1,0
8,377,377,2,2,0,1,0
7,396,396,43,3,40,3,2
18,406,406,40,28,12,4,3
1,433,433,21,8,13,2,1
4,433,433,4,4,0,1,0
11,463,463,28,4,24,3,2
13,470,470,7,3,4,2,1
12,491,491,2,2,0,1,0
5,498,498,95,65,30,2,1

6,115,115,6,6,0,1,0
18,120,120,9,5,4,2,1
19,130,130,2,2,0,1,0
14,134,134,25,25,0,1,0
16,137,137,5,5,0,1,0
4,170,170,9,6,3,2,1
1,177,177,4,4,0,1,0
15,183,183,14,6,8,3,2
22,189,189,32,24,8,2,1
10,196,196,15,5,10,2,1
8,216,216,18,18,0,1,0
3,252,252,9,9,0,1,0
0,252,252,25,1,24,2,1
11,323,323,54,54,0,1,0
21,357,357,32,26,6,2,1
5,365,365,50,3,47,2,1
7,399,399,19,19,0,1,0
9,411,411,40,40,0,1,0
20,422,422,64,25,39,4,3
17,426,426,36,9,27,2,1
2,447,447,90,90,0,1,0
13,462,462,7,7,0,1,0
12,464,464,6,2,4,2,1
23,474,474,112,112,0,1,0

18,102,102,25,13,12,4,3
14,140,140,30,30,0,1,0
19,174,174,2,2,0,1,0
9,185,185,3,3,0,1,0
16,188,188,7,7,0,1,0
15,189,189,28,28,0,1,0
0,228,228,26,6,20,2,1
6,257,257,34,34,0,1,0
5,259,259,24,10,14,3,2
1,287,287,96,63,33,2,1
3,290,290,14,14,0,1,0
4,298,298,9,9,0,1,0
7,302,302,23,1,22,2,1
11,323,323,70,20,50,3,2
8,361,361,32,7,25,2,1
17,382,382,48,48,0,1,0
12,387,387,2,2,0,1,0
10,406,406,10,10,0,1,0
2,428,428,72,72,0,1,0
13,454,454,43,43,0,1,0

17,102,102,1,1,0,1,0
1,103,103,1,1,0,1,0
7,105,105,10,1,9,2,1
12,105,105,4,4,0,1,0
6,106,106,4,4,0,1,0
0,130,130,19,19,0,1,0
14,141,141,19,13,6,2,1
5,162,162,15,15,0,1,0
13,162,162,16,16,0,1,0
24,194,194,47,39,8,2,1
3,206,206,30,30,0,1,0
8,233,233,7,7,0,1,0
18,236,236,2,2,0,1,0
22,237,237,19,5,14,2,1
4,244,244,7,7,0,1,0
19,248,248,28,28,0,1,0
9,253,253,3,3,0,1,0
21,287,287,69,55,14,3,2
15,302,302,2,2,0,1,0
23,309,309,37,37,0,1,0
11,328,328,24,24,0,1,0
20,347,347,82,10,72,4,3
2,411,411,24,24,0,1,0
10,430,430,40,10,30,3,2
25,439,439,10,7,3,2,1
16,497,497,25,5,20,3,2

15,105,105,20,20,0,1,0
10,114,114,4,4,0,1,0
14,116,116,1,1,0,1,0
3,138,138,2,2,0,1,0
6,174,174,15,15,0,1,0
17,211,211,35,35,0,1,0
11,254,254,27,24,3,2,1
4,285,285,54,9,45,4,3
16,297,297,4,4,0,1,0
2,302,302,2,2,0,1,0
8,316,316,126,126,0,1,0
0,317,317,1,1,0,1,0
18,333,333,6,6,0,1,0
5,343,343,5,5,0,1,0
7,346,346,2,2,0,1,0
1,446,446,171,171,0,1,0
12,458,458,101,29,72,3,2
13,460,460,150,34,116,4,3
9,481,481,18,18,0,1,0

11,123,123,5,5,0,1,0
19,158,158,8,8,0,1,0
15,182,182,2,2,0,1,0
0,202,202,11,11,0,1,0
4,224,224,23,23,0,1,0
10,240,240,21,21,0,1,0
13,240,240,73,35,38,2,1
8,244,244,40,40,0,1,0
16,251,251,2,2,0,1,0
17,270,270,25,25,0,1,0
12,312,312,29,29,0,1,0
14,320,320,15,3,12,4,3
18,330,330,134,2,132,4,3
1,366,366,101,83,18,3,2
2,381,381,25,25,0,1,0
9,423,423,35,35,0,1,0
3,429,429,43,20,23,2,1
21,449,449,6,6,0,1,0
5,452,452,50,22,28,2,1
7,457,457,2,2,0,1,0
6,472,472,7,7,0,1,0
20,479,479,45,14,31,4,3

1,135,135,1,1,0,1,0
8,144,144,10,4,6,2,1
7,219,219,5,5,0,1,0
19,260,260,39,14,25,2,1
23,267,267,2,2,0,1,0
9,273,273,17,17,0,1,0
21,312,312,12,2,10,3,2
15,318,318,16,16,0,1,0
10,320,320,15,6,9,4,3
11,329,329,14,14,0,1,0
18,346,346,104,16,88,4,3
12,353,353,4,4,0,1,0
17,360,360,109,109,0,1,0
5,377,377,2,2,0,1,0
20,387,387,15,15,0,1,0
2,407,407,176,146,30,4,3
16,442,442,49,38,11,2,1
14,451,451,32,32,0,1,0
6,455,455,1,1,0,1,0
3,461,461,56,22,34,2,1
13,464,464,58,13,45,2,1
0,471,471,44,17,27,4,3
22,491,491,23,5,18,4,3
4,493,493,29,20,9,2,1

16,104,104,7,7,0,1,0
4,111,111,41,35,6,3,2
9,124,124,37,23,14,4,3
12,204,204,57,57,0,1,0
6,225,225,12,12,0,1,0
13,259,259,9,9,0,1,0
7,272,272,2,2,0,1,0
2,292,292,23,23,0,1,0
14,325,325,27,19,8,3,2
17,344,344,31,31,0,1,0
15,354,354,57,57,0,1,0
5,355,355,68,68,0,1,0
3,374,374,32,22,10,2,1
11,410,410,28,28,0,1,0
1,423,423,9,9,0,1,0
8,432,432,24,24,0,1,0
18,460,460,12,12,0,1,0
10,478,478,5,5,0,1,0
0,497,497,119,95,24,2,1

11,150,150,6,6,0,1,0
13,160,160,4,4,0,1,0
2,182,182,26,11,15,4,3
12,229,229,9,9,0,1,0
4,230,230,22,4,18,2,1
16,251,251,37,37,0,1,0
14,315,315,94,90,4,2,1
9,330,330,41,41,0,1,0
0,340,340,113,20,93,4,3
3,345,345,26,26,0,1,0
15,358,358,24,24,0,1,0
8,369,369,47,3,44,2,1
10,379,379,93,33,60,3,2
7,387,387,2,2,0,1,0
6,400,400,96,96,0,1,0
5,441,441,50,50,0,1,0
1,487,487,49,17,32,3,2

4,104,104,2,2,0,1,0
3,115,115,4,1,3,2,1
13,123,123,3,3,0,1,0
12,125,125,18,7,11,2,1
10,135,135,12,12,0,1,0
14,139,139,3,3,0,1,0
6,143,143,2,2,0,1,0
19,145,145,28,28,0,1,0
18,153,153,72,30,42,4,3
16,157,157,13,7,6,2,1
11,198,198,36,36,0,1,0
2,301,301,18,2,16,4,3
9,322,322,14,14,0,1,0
5,386,386,210,166,44,3,2
17,392,392,10,5,5,2,1
20,406,406,31,11,20,3,2
8,409,409,27,27,0,1,0
15,414,414,29,29,0,1,0
21,447,447,6,6,0,1,0
7,476,476,6,6,0,1,0
0,487,487,2,2,0,1,0
1,499,499,16,16,0,1,0

16,113,113,5,2,3,2,1
18,130,130,1,1,0,1,0
10,152,152,2,2,0,1,0
3,168,168,11,11,0,1,0
15,188,188,52,16,36,2,1
19,195,195,18,11,7,2,1
4,218,218,55,23,32,2,1
7,223,223,9,9,0,1,0
13,228,228,41,41,0,1,0
2,234,234,64,64,0,1,0
1,248,248,1,1,0,1,0
6,250,250,25,25,0,1,0
5,265,265,47,17,30,4,3
20,276,276,43,43,0,1,0
12,299,299,34,34,0,1,0
8,330,330,11,11,0,1,0
14,360,360,3,3,0,1,0
17,389,389,81,1,80,3,2
0,402,402,15,5,10,2,1
21,422,422,17,11,6,2,1
11,429,429,34,34,0,1,0
9,456,456,11,6,5,2,1

14,123,123,12,5,7,2,1
16,137,137,17,6,11,2,1
1,140,140,9,9,0,1,0
17,161,161,40,40,0,1,0
11,166,166,5,5,0,1,0
10,172,172,6,6,0,1,0
4,192,192,43,43,0,1,0
15,194,194,1,1,0,1,0
18,198,198,9,9,0,1,0
19,232,232,31,3,28,3,2
9,255,255,9,9,0,1,0
12,286,286,5,2,3,2,1
23,293,293,20,20,0,1,0
7,305,305,22,22,0,1,0
3,309,309,29,29,0,1,0
20,341,341,25,3,22,2,1
6,345,345,61,61,0,1,0
24,360,360,41,41,0,1,0
0,371,371,65,19,46,3,2
25,403,403,81,68,13,2,1
13,420,420,18,18,0,1,0
5,426,426,9,6,3,2,1
21,434,434,24,21,3,2,1
2,438,438,5,5,0,1,0
22,449,449,23,23,0,1,0
8,465,465,1,1,0,1,0

5,121,121,8,8,0,1,0
1,176,176,1,1,0,1,0
0,218,218,1,1,0,1,0
12,231,231,33,20,13,2,1
22,258,258,89,89,0,1,0
10,274,274,50,50,0,1,0
7,277,277,18,10,8,3,2
6,307,307,12,12,0,1,0
2,334,334,28,28,0,1,0
20,350,350,1,1,0,1,0
17,364,364,40,13,27,4,3
21,364,364,32,10,22,3,2
8,368,368,3,3,0,1,0
14,400,400,55,6,49,2,1
16,406,406,59,59,0,1,0
13,429,429,101,101,0,1,0
19,432,432,3,3,0,1,0
11,448,448,61,3,58,4,3
9,459,459,43,43,0,1,0
15,474,474,65,65,0,1,0
4,478,478,12,5,7,2,1
23,482,482,63,63,0,1,0
18,484,484,5,5,0,1,0
3,498,498,6,6,0,1,0

16,105,105,16,16,0,1,0
22,108,108,16,10,6,3,2
14,109,109,8,8,0,1,0
2,167,167,1,1,0,1,0
20,174,174,6,1,5,2,1
1,176,176,24,24,0,1,0
4,182,182,24,8,16,4,3
12,191,191,30,30,0,1,0
15,211,211,12,12,0,1,0
18,214,214,18,18,0,1,0
9,214,214,13,13,0,1,0
11,227,227,46,38,8,2,1
10,242,242,16,16,0,1,0
0,278,278,38,38,0,1,0
8,291,291,7,7,0,1,0
19,309,309,46,32,14,2,1
21,313,313,88,25,63,4,3
3,345,345,1,1,0,1,0
17,402,402,29,1,28,3,2
5,416,416,44,44,0,1,0
13,429,429,33,11,22,2,1
7,474,474,34,15,19,2,1
6,483,483,1,1,0,1,0

21,107,107,2,2,0,1,0
20,123,123,20,6,14,3,2
10,131,131,5,5,0,1,0
11,135,135,12,12,0,1,0
4,149,149,2,2,0,1,0
18,155,155,13,13,0,1,0
14,158,158,12,12,0,1,0
22,176,176,9,9,0,1,0
2,179,179,27,27,0,1,0
7,185,185,6,6,0,1,0
16,196,196,51,20,31,2,1
15,208,208,25,25,0,1,0
8,215,215,1,1,0,1,0
6,230,230,45,45,0,1,0
19,233,233,22,22,0,1,0
3,308,308,49,49,0,1,0
9,321,321,29,29,0,1,0
5,399,399,75,75,0,1,0
17,420,420,103,67,36,3,2
0,458,458,8,3,5,2,1
1,475,475,27,21,6,2,1
12,476,476,31,31,0,1,0
13,478,478,7,7,0,1,0

9,102,102,30,30,0,1,0
19,120,120,3,3,0,1,0
3,128,128,1,1,0,1,0
18,133,133,5,5,0,1,0
12,139,139,5,1,4,2,1
17,159,159,10,10,0,1,0
2,165,165,12,12,0,1,0
25,205,205,4,4,0,1,0
0,206,206,18,18,0,1,0
4,207,207,23,6,17,4,3
5,207,207,10,10,0,1,0
26,223,223,21,3,18,4,3
6,252,252,20,20,0,1,0
15,285,285,11,11,0,1,0
7,308,308,1,1,0,1,0
21,311,311,2,2,0,1,0
24,333,333,205,187,18,4,3
14,338,338,26,26,0,1,0
1,341,341,2,2,0,1,0
23,361,361,68,24,44,3,2
20,385,385,9,3,6,3,2
16,413,413,23,15,8,2,1
22,413,413,23,4,19,2,1
13,475,475,36,36,0,1,0
8,475,475,5,5,0,1,0
11,479,479,4,4,0,1,0
10,490,490,44,11,33,2,1

9,136,136,51,27,24,4,3
17,142,142,7,7,0,1,0
4,144,144,13,1,12,2,1
13,181,181,25,25,0,1,0
1,220,220,32,23,9,4,3
5,233,233,102,59,43,4,3
2,246,246,4,4,0,1,0
8,284,284,2,2,0,1,0
10,313,313,94,21,73,4,3
16,316,316,54,54,0,1,0
6,329,329,45,24,21,3,2
3,344,344,5,5,0,1,0
11,357,357,11,7,4,2,1
7,377,377,36,36,0,1,0
14,388,388,5,5,0,1,0
12,444,444,15,15,0,1,0
0,461,461,76,76,0,1,0
15,461,461,1,1,0,1,0

8,177,177,7,7,0,1,0
4,180,180,20,11,9,4,3
2,206,206,7,7,0,1,0
18,229,229,47,3,44,2,1
1,238,238,30,30,0,1,0
12,238,238,4,1,3,2,1
21,249,249,25,25,0,1,0
7,263,263,19,19,0,1,0
22,276,276,11,4,7,2,1
11,276,276,57,57,0,1,0
16,316,316,53,53,0,1,0
6,323,323,31,18,13,2,1
20,349,349,21,10,11,2,1
10,380,380,28,2,26,3,2
3,382,382,16,16,0,1,0
5,402,402,26,26,0,1,0
13,419,419,19,5,14,2,1
17,420,420,8,8,0,1,0
15,427,427,119,27,92,4,3
0,450,450,11,11,0,1,0
14,462,462,51,51,0,1,0
9,472,472,92,4,88,3,2
19,494,494,44,44,0,1,0

16,119,119,19,19,0,1,0
14,134,134,20,1,19,2,1
0,140,140,28,28,0,1,0
17,159,159,19,6,13,2,1
10,178,178,13,4,9,4,3
7,187,187,63,33,30,3,2
4,222,222,6,6,0,1,0
18,229,229,32,32,0,1,0
6,238,238,19,19,0,1,0
11,257,257,35,10,25,4,3
8,272,272,9,4,5,2,1
9,298,298,23,15,8,3,2
13,315,315,30,14,16,2,1
5,322,322,10,10,0,1,0
2,397,397,45,15,30,4,3
3,408,408,2,2,0,1,0
15,409,409,6,6,0,1,0
12,416,416,87,47,40,3,2
1,443,443,57,6,51,4,3
19,475,475,6,6,0,1,0
20,494,494,44,18,26,3,2

2,128,128,2,2,0,1,0
5,157,157,7,7,0,1,0
14,159,159,26,26,0,1,0
4,189,189,6,6,0,1,0
12,201,201,41,41,0,1,0
8,222,222,1,1,0,1,0
1,236,236,44,8,36,3,2
9,251,251,10,6,4,2,1
15,260,260,19,16,3,2,1
17,286,286,88,16,72,4,3
7,287,287,26,26,0,1,0
10,356,356,51,5,46,2,1
13,363,363,13,13,0,1,0
16,393,393,31,31,0,1,0
0,403,403,43,37,6,3,2
3,426,426,139,28,111,4,3
6,454,454,136,56,80,3,2
11,477,477,36,24,12,3,2

16,105,105,23,4,19,2,1
6,108,108,1,1,0,1,0
19,132,132,20,20,0,1,0
9,140,140,8,2,6,3,2
13,142,142,8,5,3,2,1
21,159,159,5,5,0,1,0
15,167,167,13,4,9,2,1
11,173,173,36,3,33,2,1
7,181,181,37,37,0,1,0
3,182,182,14,14,0,1,0
1,183,183,17,4,13,2,1
5,189,189,19,19,0,1,0
18,216,216,42,42,0,1,0
17,239,239,3,3,0,1,0
20,239,239,29,13,16,2,1
12,304,304,70,70,0,1,0
14,304,304,9,2,7,2,1
2,318,318,72,20,52,3,2
8,371,371,27,15,12,4,3
10,409,409,7,7,0,1,0
0,429,429,13,5,8,3,2
4,430,430,2,2,0,1,0

3,100,100,27,3,24,2,1
5,147,147,13,8,5,2,1
1,150,150,61,23,38,2,1
12,156,156,18,18,0,1,0
4,168,168,6,6,0,1,0
0,169,169,30,10,20,2,1
2,206,206,51,18,33,2,1
9,253,253,16,6,10,3,2
10,287,287,23,11,12,4,3
7,378,378,116,76,40,3,2
6,387,387,21,12,9,2,1
13,411,411,5,5,0,1,0
8,434,434,154,154,0,1,0
11,484,484,5,5,0,1,0

2,106,106,10,3,7,3,2
6,110,110,9,9,0,1,0
8,110,110,9,9,0,1,0
5,127,127,1,1,0,1,0
17,142,142,1,1,0,1,0
4,187,187,43,43,0,1,0
0,217,217,46,46,0,1,0
1,229,229,74,74,0,1,0
7,232,232,21,6,15,4,3
13,245,245,54,54,0,1,0
11,310,310,1,1,0,1,0
10,340,340,18,6,12,2,1
9,354,354,114,67,47,2,1
15,370,370,50,50,0,1,0
12,431,431,19,9,10,2,1
3,462,462,29,29,0,1,0
14,483,483,95,53,42,2,1
16,494,494,28,28,0,1,0

5,107,107,4,1,3,2,1
12,109,109,6,6,0,1,0
1,150,150,15,15,0,1,0
15,185,185,54,38,16,3,2
4,200,200,15,7,8,3,2
2,220,220,3,3,0,1,0
20,245,245,7,7,0,1,0
18,261,261,52,52,0,1,0
21,275,275,38,1,37,2,1
7,284,284,19,19,0,1,0
11,315,315,3,3,0,1,0
10,316,316,13,4,9,3,2
8,322,322,70,13,57,4,3
0,340,340,10,1,9,2,1
3,340,340,19,4,15,2,1
14,387,387,27,27,0,1,0
9,394,394,12,3,9,4,3
22,412,412,43,6,37,2,1
17,421,421,41,27,14,2,1
16,464,464,53,48,5,2,1
6,474,474,176,106,70,3,2
19,495,495,28,28,0,1,0
13,498,498,7,4,3,2,1

9,104,104,17,17,0,1,0
5,117,117,19,5,14,2,1
13,126,126,16,16,0,1,0
0,141,141,14,6,8,3,2
14,150,150,5,5,0,1,0
17,168,168,7,1,6,3,2
8,197,197,30,19,11,2,1
15,222,222,15,15,0,1,0
21,233,233,7,7,0,1,0
18,235,235,37,13,24,4,3
11,238,238,1,1,0,1,0
1,257,257,1,1,0,1,0
19,258,258,27,3,24,3,2
12,316,316,45,45,0,1,0
6,318,318,13,13,0,1,0
10,319,319,6,6,0,1,0
3,348,348,25,16,9,4,3
4,384,384,5,5,0,1,0
16,408,408,146,146,0,1,0
22,429,429,22,10,12,2,1
2,460,460,104,57,47,2,1
20,474,474,71,3,68,3,2
7,491,491,2,2,0,1,0

12,102,102,2,2,0,1,0
4,130,130,2,2,0,1,0
18,155,155,32,8,24,2,1
19,162,162,11,11,0,1,0
17,230,230,32,10,22,3,2
9,235,235,8,8,0,1,0
1,252,252,4,4,0,1,0
2,259,259,8,8,0,1,0
13,261,261,30,6,24,3,2
3,275,275,84,84,0,1,0
10,294,294,14,5,9,4,3
21,309,309,45,29,16,3,2
5,348,348,62,22,40,2,1
14,377,377,1,1,0,1,0
6,388,388,7,7,0,1,0
20,411,411,48,48,0,1,0
16,423,423,46,14,32,3,2
22,434,434,6,6,0,1,0
7,439,439,17,17,0,1,0
15,456,456,89,18,71,3,2
8,465,465,45,45,0,1,0
0,479,479,21,21,0,1,0
11,481,481,124,124,0,1,0

12,133,133,1,1,0,1,0
17,152,152,5,5,0,1,0
20,186,186,27,15,12,4,3
7,202,202,16,2,14,3,2
1,205,205,17,7,10,3,2
8,236,236,27,27,0,1,0
10,243,243,3,3,0,1,0
16,278,278,37,21,16,2,1
18,279,279,12,12,0,1,0
19,311,311,51,27,24,3,2
0,321,321,41,41,0,1,0
3,322,322,1,1,0,1,0
22,330,330,45,39,6,2,1
14,334,334,3,3,0,1,0
6,349,349,4,4,0,1,0
2,360,360,8,3,5,2,1
21,365,365,17,2,15,2,1
13,397,397,105,59,46,2,1
5,435,435,3,3,0,1,0
4,443,443,3,3,0,1,0
11,464,464,54,54,0,1,0
15,468,468,17,17,0,1,0
23,468,468,154,34,120,4,3
9,491,491,117,117,0,1,0
24,495,495,23,23,0,1,0

9,114,114,11,11,0,1,0
1,116,116,15,15,0,1,0
11,141,141,19,11,8,2,1
7,152,152,11,2,9,4,3
6,205,205,64,16,48,2,1
3,237,237,51,51,0,1,0
10,239,239,7,7,0,1,0
13,241,241,26,26,0,1,0
5,246,246,92,67,25,2,1
14,294,294,30,30,0,1,0
4,296,296,62,59,3,2,1
0,389,389,24,6,18,3,2
2,415,415,47,47,0,1,0
8,418,418,47,30,17,2,1
12,453,453,18,18,0,1,0
15,494,494,58,58,0,1,0

12,116,116,12,12,0,1,0
19,136,136,8,2,6,3,2
16,150,150,2,2,0,1,0
11,162,162,11,3,8,3,2
5,166,166,18,18,0,1,0
6,169,169,11,3,8,3,2
18,171,171,1,1,0,1,0
1,180,180,36,36,0,1,0
0,243,243,22,1,21,2,1
13,264,264,3,3,0,1,0
9,265,265,29,1,28,2,1
20,270,270,2,2,0,1,0
14,324,324,71,53,18,3,2
7,375,375,4,1,3,2,1
15,403,403,47,37,10,3,2
10,405,405,16,16,0,1,0
2,423,423,7,7,0,1,0
17,442,442,143,143,0,1,0
4,466,466,21,3,18,4,3
21,488,488,129,129,0,1,0
8,496,496,157,97,60,3,2
3,499,499,16,1,15,4,3

7,101,101,16,2,14,3,2
14,160,160,72,48,24,4,3
6,172,172,18,18,0,1,0
2,173,173,52,13,39,4,3
1,179,179,14,2,12,2,1
8,228,228,13,9,4,2,1
15,251,251,2,2,0,1,0
17,296,296,28,7,21,2,1
4,308,308,87,71,16,2,1
16,341,341,37,17,20,3,2
5,374,374,13,13,0,1,0
19,377,377,33,33,0,1,0
10,402,402,17,8,9,4,3
11,422,422,26,26,0,1,0
18,453,453,7,7,0,1,0
12,472,472,32,3,29,3,2
3,478,478,28,28,0,1,0
0,488,488,5,5,0,1,0
13,489,489,85,36,49,2,1
9,491,491,8,8,0,1,0

6,100,100,1,1,0,1,0
12,142,142,47,47,0,1,0
10,189,189,11,2,9,2,1
7,211,211,72,29,43,4,3
18,303,303,17,11,6,3,2
17,310,310,22,10,12,4,3
19,320,320,18,18,0,1,0
15,324,324,67,45,22,4,3
11,332,332,44,4,40,3,2
5,346,346,22,14,8,3,2
3,355,355,84,21,63,4,3
4,364,364,41,41,0,1,0
9,384,384,2,2,0,1,0
14,406,406,42,34,8,2,1
1,415,415,9,3,6,2,1
8,427,427,121,94,27,4,3
13,441,441,22,22,0,1,0
2,458,458,5,5,0,1,0
0,474,474,7,7,0,1,0
16,484,484,24,24,0,1,0

7,100,100,25,25,0,1,0
8,107,107,2,2,0,1,0
14,120,120,29,29,0,1,0
9,193,193,47,24,23,2,1
13,198,198,3,3,0,1,0
1,215,215,8,8,0,1,0
3,218,218,13,13,0,1,0
16,229,229,30,22,8,2,1
0,234,234,25,14,11,2,1
5,244,244,34,34,0,1,0
17,260,260,3,3,0,1,0
4,260,260,26,14,12,3,2
21,266,266,9,9,0,1,0
19,281,281,64,46,18,3,2
10,291,291,10,10,0,1,0
20,299,299,26,26,0,1,0
2,344,344,4,4,0,1,0
18,346,346,79,61,18,4,3
11,365,365,32,8,24,2,1
6,436,436,5,5,0,1,0
15,438,438,54,54,0,1,0
12,443,443,11,3,8,2,1

7,106,106,1,1,0,1,0
14,109,109,12,4,8,2,1
6,121,121,15,9,6,2,1
19,144,144,2,2,0,1,0
0,182,182,37,10,27,4,3
1,191,191,3,3,0,1,0
3,199,199,10,7,3,2,1
5,208,208,47,5,42,3,2
15,235,235,74,24,50,4,3
13,283,283,11,11,0,1,0
10,312,312,3,3,0,1,0
11,324,324,10,2,8,2,1
4,348,348,29,10,19,2,1
12,399,399,15,1,14,3,2
8,400,400,67,67,0,1,0
20,408,408,23,15,8,2,1
18,433,433,108,108,0,1,0
17,451,451,2,2,0,1,0
16,476,476,125,48,77,4,3
9,476,476,18,18,0,1,0
2,479,479,83,83,0,1,0

0,138,138,6,6,0,1,0
11,142,142,2,2,0,1,0
10,145,145,29,2,27,3,2
12,182,182,14,2,12,4,3
1,252,252,60,32,28,2,1
4,253,253,35,2,33,2,1
16,254,254,73,24,49,2,1
14,261,261,4,4,0,1,0
6,285,285,17,5,12,3,2
8,319,319,8,8,0,1,0
5,382,382,101,101,0,1,0
2,389,389,90,21,69,4,3
7,408,408,74,74,0,1,0
9,416,416,50,9,41,2,1
3,423,423,54,54,0,1,0
15,433,433,46,5,41,2,1
13,483,483,43,14,29,2,1

3,132,132,26,10,16,2,1
2,139,139,3,3,0,1,0
10,153,153,7,7,0,1,0
8,171,171,41,30,11,2,1
12,190,190,34,34,0,1,0
11,204,204,1,1,0,1,0
22,229,229,31,31,0,1,0
1,249,249,1,1,0,1,0
15,250,250,3,3,0,1,0
18,258,258,52,52,0,1,0
0,265,265,5,5,0,1,0
13,274,274,43,43,0,1,0
14,282,282,1,1,0,1,0
6,332,332,24,16,8,3,2
17,342,342,4,4,0,1,0
9,344,344,2,2,0,1,0
21,350,350,36,11,25,2,1
19,362,362,19,19,0,1,0
20,401,401,138,65,73,4,3
7,442,442,120,98,22,3,2
4,449,449,1,1,0,1,0
16,473,473,45,45,0,1,0
5,500,500,19,19,0,1,0

17,127,127,19,12,7,2,1
5,135,135,7,1,6,3,2
10,173,173,12,12,0,1,0
0,223,223,4,4,0,1,0
1,232,232,71,61,10,3,2
12,245,245,6,2,4,2,1
2,254,254,8,8,0,1,0
9,271,271,30,20,10,2,1
7,333,333,146,76,70,4,3
14,353,353,116,116,0,1,0
16,361,361,7,2,5,2,1
6,371,371,18,18,0,1,0
8,377,377,47,47,0,1,0
4,404,404,26,4,22,2,1
18,422,422,30,30,0,1,0
15,428,428,51,51,0,1,0
3,436,436,8,8,0,1,0
13,437,437,49,5,44,3,2
11,461,461,51,35,16,2,1

15,106,106,10,10,0,1,0
11,127,127,4,4,0,1,0
7,132,132,20,20,0,1,0
18,162,162,59,59,0,1,0
4,182,182,2,2,0,1,0
8,200,200,22,22,0,1,0
20,201,201,18,4,14,2,1
13,230,230,8,8,0,1,0
0,249,249,3,3,0,1,0
3,304,304,32,12,20,3,2
6,317,317,32,32,0,1,0
12,322,322,43,1,42,4,3
5,338,338,25,7,18,3,2
21,356,356,31,12,19,2,1
14,389,389,33,33,0,1,0
16,413,413,8,2,6,3,2
10,442,442,153,51,102,4,3
1,449,449,40,40,0,1,0
19,467,467,79,49,30,3,2
9,475,475,33,9,24,4,3
17,476,476,23,23,0,1,0
2,481,481,3,3,0,1,0

18,121,121,5,5,0,1,0
7,125,125,1,1,0,1,0
14,165,165,17,17,0,1,0
17,169,169,54,54,0,1,0
23,169,169,20,8,12,4,3
4,205,205,3,3,0,1,0
3,215,215,38,38,0,1,0
13,225,225,16,6,10,2,1
1,228,228,1,1,0,1,0
9,229,229,5,5,0,1,0
20,230,230,34,8,26,3,2
15,236,236,3,3,0,1,0
19,271,271,37,37,0,1,0
10,315,315,7,1,6,2,1
2,321,321,6,2,4,2,1
24,323,323,33,33,0,1,0
0,327,327,9,9,0,1,0
22,328,328,22,22,0,1,0
12,355,355,4,4,0,1,0
25,359,359,43,9,34,3,2
11,365,365,60,33,27,4,3
21,369,369,9,2,7,3,2
26,421,421,17,17,0,1,0
6,434,434,109,109,0,1,0
8,434,434,47,47,0,1,0
16,476,476,27,12,15,4,3
5,499,499,14,14,0,1,0

4,107,107,24,9,15,2,1
14,125,125,23,23,0,1,0
7,141,141,27,8,19,4,3
12,145,145,22,22,0,1,0
2,167,167,45,45,0,1,0
0,170,170,4,4,0,1,0
16,221,221,1,1,0,1,0
9,227,227,4,4,0,1,0
5,237,237,24,24,0,1,0
15,315,315,17,9,8,2,1
1,332,332,10,5,5,2,1
8,333,333,8,8,0,1,0
11,336,336,33,33,0,1,0
3,397,397,176,176,0,1,0
6,470,470,4,4,0,1,0
13,484,484,108,108,0,1,0
10,497,497,85,81,4,2,1

7,105,105,5,5,0,1,0
14,158,158,6,6,0,1,0
18,162,162,41,41,0,1,0
17,177,177,33,21,12,2,1
13,230,230,1,1,0,1,0
11,252,252,29,29,0,1,0
16,279,279,16,16,0,1,0
5,282,282,35,35,0,1,0
9,292,292,40,16,24,3,2
10,304,304,17,17,0,1,0
4,333,333,102,76,26,3,2
2,375,375,7,7,0,1,0
15,376,376,3,3,0,1,0
0,430,430,62,13,49,4,3
8,437,437,24,14,10,3,2
1,437,437,71,71,0,1,0
3,465,465,28,28,0,1,0
19,475,475,9,9,0,1,0
12,486,486,186,155,31,4,3
6,491,491,22,14,8,2,1

18,105,105,5,1,4,2,1
5,128,128,31,31,0,1,0
1,128,128,5,5,0,1,0
3,198,198,6,2,4,2,1
13,203,203,8,1,7,2,1
0,214,214,9,2,7,2,1
17,221,221,37,37,0,1,0
8,222,222,9,9,0,1,0
24,243,243,117,71,46,2,1
11,248,248,17,17,0,1,0
2,252,252,1,1,0,1,0
4,278,278,3,3,0,1,0
6,286,286,8,3,5,2,1
15,288,288,45,22,23,2,1
12,293,293,17,2,15,2,1
16,294,294,14,2,12,2,1
9,325,325,73,73,0,1,0
14,364,364,18,18,0,1,0
10,406,406,12,12,0,1,0
25,438,438,24,21,3,2,1
21,442,442,30,8,22,3,2
7,445,445,18,18,0,1,0
22,450,450,1,1,0,1,0
19,470,470,20,20,0,1,0
23,481,481,88,88,0,1,0
20,492,492,9,2,7,2,1

4,116,116,31,6,25,2,1
16,140,140,43,10,33,2,1
14,171,171,14,8,6,2,1
7,182,182,30,8,22,2,1
6,184,184,3,3,0,1,0
8,187,187,18,18,0,1,0
15,198,198,2,2,0,1,0
9,262,262,41,41,0,1,0
12,264,264,5,5,0,1,0
3,273,273,68,46,22,4,3
17,289,289,3,3,0,1,0
11,303,303,21,9,12,4,3
10,308,308,63,63,0,1,0
18,314,314,49,49,0,1,0
5,317,317,12,12,0,1,0
13,320,320,34,34,0,1,0
0,359,359,17,4,13,2,1
1,410,410,54,21,33,2,1
2,415,415,39,5,34,2,1

15,138,138,27,7,20,3,2
23,140,140,1,1,0,1,0
3,167,167,15,7,8,3,2
22,169,169,30,3,27,2,1
19,182,182,35,25,10,3,2
16,204,204,2,2,0,1,0
10,220,220,5,5,0,1,0
13,227,227,4,1,3,2,1
0,248,248,3,3,0,1,0
8,251,251,88,26,62,4,3
7,260,260,5,5,0,1,0
6,287,287,51,35,16,2,1
1,305,305,16,16,0,1,0
20,309,309,33,33,0,1,0
2,311,311,11,11,0,1,0
5,325,325,3,3,0,1,0
21,333,333,54,54,0,1,0
18,374,374,8,8,0,1,0
14,393,393,13,13,0,1,0
4,459,459,20,20,0,1,0
9,460,460,49,49,0,1,0
12,464,464,31,31,0,1,0
11,474,474,30,30,0,1,0
17,481,481,17,17,0,1,0
24,491,491,102,6,96,4,3

21,102,102,14,14,0,1,0
9,104,104,1,1,0,1,0
17,105,105,9,9,0,1,0
0,110,110,2,2,0,1,0
6,115,115,7,7,0,1,0
27,120,120,11,3,8,2,1
12,128,128,5,5,0,1,0
2,138,138,4,4,0,1,0
5,154,154,5,2,3,2,1
1,206,206,21,13,8,2,1
23,221,221,25,25,0,1,0
8,242,242,1,1,0,1,0
26,244,244,13,3,10,3,2
24,259,259,63,16,47,4,3
4,261,261,16,16,0,1,0
22,262,262,2,2,0,1,0
25,297,297,3,3,0,1,0
3,324,324,61,19,42,4,3
19,336,336,103,53,50,2,1
10,342,342,2,2,0,1,0
13,361,361,17,17,0,1,0
16,379,379,19,2,17,3,2
15,399,399,18,18,0,1,0
7,427,427,115,106,9,2,1
11,430,430,22,22,0,1,0
14,465,465,1,1,0,1,0
20,485,485,78,78,0,1,0
18,494,494,1,1,0,1,0

14,156,156,18,18,0,1,0
24,162,162,14,4,10,2,1
0,164,164,2,2,0,1,0
10,173,173,5,5,0,1,0
23,178,178,119,119,0,1,0
6,201,201,5,5,0,1,0
1,207,207,36,36,0,1,0
13,224,224,1,1,0,1,0
5,226,226,1,1,0,1,0
20,228,228,6,6,0,1,0
11,242,242,2,2,0,1,0
22,261,261,11,6,5,2,1
18,267,267,15,15,0,1,0
3,296,296,1,1,0,1,0
21,321,321,20,4,16,3,2
16,358,358,52,48,4,2,1
2,383,383,63,55,8,2,1
17,384,384,24,24,0,1,0
9,386,386,66,66,0,1,0
15,402,402,9,3,6,3,2
25,425,425,36,36,0,1,0
7,426,426,13,13,0,1,0
27,443,443,8,8,0,1,0
26,473,473,26,14,12,4,3
12,479,479,19,13,6,3,2
19,486,486,8,4,4,2,1
4,488,488,5,5,0,1,0
8,498,498,40,11,29,2,1

5,114,114,1,1,0,1,0
8,117,117,2,2,0,1,0
4,137,137,2,2,0,1,0
24,144,144,8,8,0,1,0
17,145,145,7,7,0,1,0
9,175,175,20,13,7,3,2
0,176,176,10,10,0,1,0
16,197,197,3,3,0,1,0
11,204,204,3,3,0,1,0
19,207,207,16,16,0,1,0
10,277,277,2,2,0,1,0
15,290,290,118,118,0,1,0
21,297,297,97,48,49,2,1
23,303,303,9,3,6,2,1
22,304,304,29,2,27,2,1
6,324,324,93,93,0,1,0
1,343,343,2,2,0,1,0
12,349,349,48,41,7,2,1
14,380,380,3,3,0,1,0
7,398,398,66,57,9,2,1
20,419,419,5,2,3,2,1
2,426,426,25,3,22,3,2
13,432,432,80,3,77,4,3
18,462,462,23,23,0,1,0
3,472,472,9,9,0,1,0

13,104,104,8,8,0,1,0
21,127,127,1,1,0,1,0
14,136,136,15,15,0,1,0
26,142,142,3,3,0,1,0
4,179,179,17,11,6,2,1
0,182,182,4,4,0,1,0
10,224,224,11,11,0,1,0
19,227,227,12,12,0,1,0
7,242,242,9,2,7,2,1
25,261,261,82,75,7,2,1
12,281,281,12,12,0,1,0
22,281,281,83,83,0,1,0
20,301,301,5,1,4,2,1
16,311,311,4,1,3,2,1
11,313,313,17,17,0,1,0
24,325,325,56,9,47,4,3
8,355,355,8,8,0,1,0
15,383,383,21,21,0,1,0
3,392,392,52,13,39,2,1
2,393,393,18,18,0,1,0
5,423,423,78,48,30,4,3
6,433,433,13,13,0,1,0
23,456,456,28,28,0,1,0
9,479,479,21,15,6,2,1
17,490,490,50,36,14,2,1
18,497,497,39,39,0,1,0
1,499,499,44,6,38,3,2

10,104,104,2,2,0,1,0
7,107,107,4,4,0,1,0
24,158,158,20,2,18,2,1
3,165,165,8,2,6,2,1
2,187,187,11,5,6,3,2
21,191,191,4,4,0,1,0
23,193,193,28,17,11,2,1
15,200,200,29,11,18,4,3
12,205,205,25,25,0,1,0
18,218,218,3,3,0,1,0
8,221,221,15,7,8,2,1
14,237,237,58,48,10,2,1
9,251,251,3,3,0,1,0
1,285,285,6,2,4,2,1
22,297,297,85,16,69,4,3
16,300,300,18,18,0,1,0
6,301,301,5,5,0,1,0
4,306,306,12,3,9,4,3
0,345,345,4,1,3,2,1
13,346,346,99,99,0,1,0
19,407,407,64,55,9,4,3
5,410,410,4,1,3,2,1
17,411,411,57,57,0,1,0
20,433,433,12,12,0,1,0
11,488,488,52,52,0,1,0

9,102,102,2,2,0,1,0
19,165,165,27,17,10,3,2
14,166,166,12,3,9,2,1
18,201,201,52,7,45,4,3
16,212,212,9,9,0,1,0
10,216,216,13,6,7,3,2
1,219,219,81,16,65,4,3
2,340,340,50,50,0,1,0
3,343,343,91,69,22,3,2
17,356,356,30,30,0,1,0
5,406,406,56,28,28,3,2
13,414,414,41,41,0,1,0
11,419,419,1,1,0,1,0
7,425,425,11,4,7,2,1
0,433,433,4,4,0,1,0
12,440,440,64,64,0,1,0
4,446,446,2,2,0,1,0
15,448,448,81,24,57,4,3
8,460,460,15,15,0,1,0
6,472,472,46,23,23,2,1

6,109,109,7,7,0,1,0
26,110,110,12,12,0,1,0
9,147,147,35,35,0,1,0
18,158,158,34,34,0,1,0
16,160,160,1,1,0,1,0
7,166,166,3,3,0,1,0
4,185,185,7,7,0,1,0
20,196,196,2,2,0,1,0
27,223,223,13,13,0,1,0
14,232,232,24,24,0,1,0
22,261,261,28,28,0,1,0
17,268,268,67,3,64,3,2
23,285,285,15,15,0,1,0
19,318,318,4,4,0,1,0
8,367,367,21,21,0,1,0
11,378,378,5,5,0,1,0
21,395,395,158,126,32,4,3
24,396,396,8,8,0,1,0
0,399,399,35,35,0,1,0
12,423,423,16,16,0,1,0
2,426,426,21,4,17,2,1
15,431,431,5,5,0,1,0
3,433,433,7,7,0,1,0
25,440,440,60,10,50,3,2
1,441,441,1,1,0,1,0
5,441,441,1,1,0,1,0
10,465,465,27,22,5,2,1
13,478,478,23,23,0,1,0

6,100,100,1,1,0,1,0
24,108,108,1,1,0,1,0
1,123,123,5,5,0,1,0
4,137,137,11,11,0,1,0
13,172,172,8,8,0,1,0
15,229,229,23,11,12,2,1
3,235,235,15,7,8,3,2
12,250,250,23,5,18,3,2
11,252,252,1,1,0,1,0
8,254,254,28,9,19,2,1
10,258,258,44,44,0,1,0
7,273,273,10,4,6,2,1
16,275,275,39,18,21,2,1
19,303,303,15,15,0,1,0
18,305,305,7,4,3,2,1
22,306,306,25,25,0,1,0
5,344,344,10,10,0,1,0
14,361,361,44,8,36,3,2
23,365,365,205,70,135,4,3
2,373,373,50,50,0,1,0
0,400,400,63,29,34,3,2
21,403,403,7,1,6,2,1
17,452,452,34,8,26,2,1
9,456,456,2,2,0,1,0
20,490,490,28,10,18,3,2

12,119,119,13,6,7,2,1
21,132,132,20,20,0,1,0
11,161,161,1,1,0,1,0
0,171,171,2,2,0,1,0
25,172,172,7,1,6,3,2
26,191,191,8,8,0,1,0
18,198,198,4,4,0,1,0
8,200,200,5,5,0,1,0
19,203,203,6,6,0,1,0
10,233,233,37,13,24,2,1
3,240,240,16,3,13,4,3
1,245,245,11,1,10,2,1
2,254,254,57,18,39,2,1
4,266,266,12,1,11,4,3
9,310,310,26,22,4,2,1
22,316,316,107,63,44,4,3
5,336,336,4,4,0,1,0
14,368,368,23,23,0,1,0
20,396,396,9,2,7,2,1
7,399,399,19,4,15,4,3
23,411,411,15,15,0,1,0
17,422,422,50,17,33,4,3
6,430,430,27,27,0,1,0
13,433,433,17,17,0,1,0
24,447,447,144,60,84,3,2
15,467,467,21,21,0,1,0
16,481,481,27,27,0,1,0

20,135,135,11,11,0,1,0
8,160,160,4,1,3,2,1
18,176,176,29,5,24,4,3
11,198,198,5,5,0,1,0
0,199,199,3,3,0,1,0
15,239,239,6,6,0,1,0
13,258,258,36,1,35,2,1
19,267,267,10,5,5,2,1
10,269,269,103,57,46,2,1
9,279,279,37,37,0,1,0
12,295,295,20,20,0,1,0
3,333,333,46,46,0,1,0
7,345,345,4,4,0,1,0
1,346,346,1,1,0,1,0
17,348,348,24,16,8,2,1
6,379,379,121,121,0,1,0
5,385,385,9,3,6,3,2
14,385,385,80,80,0,1,0
2,427,427,6,6,0,1,0
16,432,432,79,40,39,4,3
4,442,442,5,5,0,1,0
21,500,500,71,26,45,4,3

11,100,100,11,8,3,2,1
15,109,109,1,1,0,1,0
3,118,118,9,3,6,3,2
5,119,119,15,15,0,1,0
13,119,119,23,11,12,2,1
17,158,158,19,19,0,1,0
8,160,160,20,20,0,1,0
23,171,171,46,1,45,4,3
21,186,186,10,5,5,2,1
10,197,197,6,3,3,2,1
0,232,232,4,1,3,2,1
22,281,281,13,3,10,3,2
1,290,290,41,41,0,1,0
7,291,291,1,1,0,1,0
12,292,292,21,21,0,1,0
25,314,314,13,13,0,1,0
2,328,328,49,33,16,3,2
20,355,355,9,9,0,1,0
9,369,369,2,2,0,1,0
6,370,370,14,4,10,3,2
4,377,377,1,1,0,1,0
24,387,387,39,39,0,1,0
18,422,422,115,31,84,4,3
16,425,425,41,1,40,2,1
14,443,443,1,1,0,1,0
19,484,484,46,46,0,1,0

18,110,110,53,53,0,1,0
2,115,115,5,1,4,2,1
8,116,116,6,6,0,1,0
19,121,121,5,5,0,1,0
7,124,124,18,18,0,1,0
22,135,135,2,2,0,1,0
13,160,160,9,2,7,2,1
17,190,190,1,1,0,1,0
14,196,196,49,6,43,2,1
10,224,224,8,2,6,3,2
4,245,245,42,21,21,4,3
21,275,275,4,4,0,1,0
20,287,287,19,13,6,2,1
16,310,310,40,40,0,1,0
6,325,325,34,34,0,1,0
0,335,335,49,1,48,3,2
11,343,343,4,4,0,1,0
3,400,400,86,86,0,1,0
1,415,415,25,2,23,2,1
15,422,422,28,9,19,2,1
5,456,456,15,15,0,1,0
9,467,467,4,1,3,2,1
12,494,494,37,28,9,2,1

15,102,102,28,5,23,2,1
5,130,130,7,7,0,1,0
14,157,157,10,4,6,3,2
2,165,165,5,5,0,1,0
1,202,202,21,5,16,3,2
21,209,209,10,4,6,2,1
24,235,235,29,3,26,3,2
16,247,247,1,1,0,1,0
8,250,250,1,1,0,1,0
10,269,269,3,3,0,1,0
7,271,271,60,15,45,4,3
4,276,276,5,5,0,1,0
11,331,331,39,39,0,1,0
3,373,373,16,9,7,2,1
0,374,374,1,1,0,1,0
12,374,374,35,9,26,2,1
17,419,419,35,35,0,1,0
19,419,419,19,19,0,1,0
23,431,431,12,1,11,2,1
18,439,439,11,3,8,3,2
22,465,465,133,76,57,4,3
6,492,492,127,22,105,4,3
9,493,493,20,16,4,2,1
20,496,496,99,33,66,3,2
13,498,498,19,19,0,1,0

8,123,123,2,2,0,1,0
9,130,130,12,2,10,3,2
0,167,167,64,26,38,3,2
13,170,170,7,1,6,2,1
15,212,212,24,24,0,1,0
4,221,221,27,21,6,3,2
19,230,230,20,20,0,1,0
20,240,240,26,26,0,1,0
1,240,240,1,1,0,1,0
18,273,273,44,44,0,1,0
6,289,289,12,2,10,3,2
12,290,290,35,11,24,3,2
11,323,323,35,11,24,2,1
3,353,353,7,7,0,1,0
10,364,364,15,15,0,1,0
17,409,409,48,39,9,2,1
2,445,445,122,68,54,3,2
7,447,447,15,15,0,1,0
16,455,455,55,39,16,2,1
5,467,467,34,34,0,1,0
14,476,476,66,57,9,4,3

4,113,113,17,17,0,1,0
14,122,122,1,1,0,1,0
27,144,144,5,2,3,2,1
23,166,166,11,5,6,2,1
20,198,198,32,20,12,3,2
0,218,218,1,1,0,1,0
21,234,234,45,24,21,4,3
6,238,238,31,9,22,2,1
25,238,238,7,7,0,1,0
24,239,239,34,12,22,3,2
26,251,251,10,10,0,1,0
28,265,265,12,5,7,2,1
12,280,280,1,1,0,1,0
17,280,280,9,1,8,2,1
5,290,290,40,40,0,1,0
8,293,293,5,5,0,1,0
10,293,293,1,1,0,1,0
19,301,301,29,5,24,3,2
15,310,310,12,2,10,2,1
3,325,325,1,1,0,1,0
18,338,338,13,13,0,1,0
16,347,347,4,1,3,2,1
7,403,403,11,2,9,2,1
13,408,408,8,8,0,1,0
2,413,413,24,4,20,3,2
9,434,434,10,1,9,2,1
11,457,457,70,12,58,3,2
22,485,485,150,147,3,2,1
1,492,492,119,59,60,3,2

14,118,118,9,4,5,2,1
4,119,119,7,1,6,3,2
9,139,139,2,2,0,1,0
1,146,146,8,8,0,1,0
3,148,148,27,27,0,1,0
2,167,167,10,10,0,1,0
8,180,180,38,11,27,2,1
16,188,188,6,6,0,1,0
17,227,227,19,9,10,3,2
10,238,238,3,3,0,1,0
11,287,287,137,123,14,3,2
15,301,301,22,1,21,2,1
0,374,374,12,12,0,1,0
12,377,377,14,14,0,1,0
13,389,389,41,5,36,2,1
6,409,409,218,218,0,1,0
7,416,416,71,71,0,1,0
5,468,468,4,4,0,1,0

5,118,118,10,10,0,1,0
12,149,149,22,22,0,1,0
21,163,163,40,20,20,2,1
0,179,179,37,37,0,1,0
11,182,182,9,3,6,2,1
3,208,208,54,54,0,1,0
17,212,212,5,5,0,1,0
18,228,228,6,6,0,1,0
16,253,253,13,6,7,2,1
9,259,259,1,1,0,1,0
19,263,263,60,20,40,3,2
14,273,273,23,2,21,4,3
6,286,286,12,3,9,2,1
2,307,307,8,1,7,2,1
10,354,354,11,2,9,4,3
13,403,403,2,2,0,1,0
8,410,410,29,29,0,1,0
20,410,410,63,21,42,3,2
7,453,453,67,39,28,2,1
4,482,482,52,52,0,1,0
15,484,484,75,75,0,1,0
1,488,488,35,14,21,4,3

8,130,130,1,1,0,1,0
2,148,148,3,3,0,1,0
9,163,163,1,1,0,1,0
15,177,177,31,31,0,1,0
21,227,227,14,14,0,1,0
16,231,231,7,4,3,2,1
4,236,236,37,7,30,4,3
3,241,241,14,6,8,3,2
13,242,242,49,49,0,1,0
25,247,247,11,11,0,1,0
10,275,275,6,6,0,1,0
0,283,283,46,18,28,2,1
23,299,299,3,3,0,1,0
14,309,309,5,5,0,1,0
17,320,320,146,146,0,1,0
7,330,330,22,4,18,2,1
19,346,346,10,10,0,1,0
5,354,354,2,2,0,1,0
11,362,362,4,4,0,1,0
24,386,386,68,38,30,2,1
12,397,397,14,3,11,2,1
20,414,414,65,5,60,4,3
1,415,415,30,9,21,2,1
22,462,462,64,64,0,1,0
6,464,464,40,40,0,1,0
18,491,491,5,5,0,1,0

16,114,114,16,12,4,2,1
11,120,120,8,8,0,1,0
26,141,141,2,2,0,1,0
9,152,152,3,3,0,1,0
28,156,156,20,20,0,1,0
7,169,169,8,8,0,1,0
25,175,175,2,2,0,1,0
24,181,181,25,11,14,2,1
17,189,189,5,2,3,2,1
19,195,195,8,3,5,2,1
10,220,220,4,4,0,1,0
6,224,224,38,38,0,1,0
5,231,231,18,18,0,1,0
22,235,235,80,49,31,3,2
23,242,242,12,12,0,1,0
20,272,272,1,1,0,1,0
1,294,294,1,1,0,1,0
27,302,302,113,113,0,1,0
12,322,322,22,11,11,2,1
3,335,335,24,24,0,1,0
0,350,350,1,1,0,1,0
15,351,351,43,43,0,1,0
13,362,362,6,6,0,1,0
2,372,372,39,39,0,1,0
21,375,375,7,7,0,1,0
14,398,398,9,9,0,1,0
18,417,417,37,37,0,1,0
4,448,448,7,1,6,3,2
8,456,456,8,8,0,1,0

6,103,103,19,4,15,4,3
8,113,113,7,7,0,1,0
9,157,157,2,2,0,1,0
11,247,247,3,3,0,1,0
15,302,302,7,7,0,1,0
3,319,319,61,61,0,1,0
14,328,328,14,14,0,1,0
4,335,335,61,14,47,4,3
7,342,342,41,32,9,4,3
18,349,349,55,55,0,1,0
0,353,353,9,9,0,1,0
2,404,404,65,11,54,4,3
17,409,409,2,2,0,1,0
1,413,413,27,27,0,1,0
19,414,414,22,22,0,1,0
10,434,434,29,16,13,2,1
16,448,448,95,43,52,4,3
20,476,476,207,175,32,2,1
12,491,491,42,6,36,4,3
13,494,494,42,29,13,2,1
5,498,498,15,15,0,1,0

0,102,102,18,18,0,1,0
3,121,121,10,10,0,1,0
2,150,150,3,3,0,1,0
1,153,153,17,9,8,3,2
19,168,168,24,24,0,1,0
11,199,199,14,14,0,1,0
20,203,203,8,8,0,1,0
12,244,244,59,5,54,3,2
9,258,258,19,19,0,1,0
14,275,275,50,50,0,1,0
4,319,319,12,12,0,1,0
7,321,321,17,2,15,3,2
21,327,327,9,6,3,2,1
17,346,346,39,11,28,3,2
18,364,364,9,9,0,1,0
8,364,364,7,7,0,1,0
5,364,364,6,1,5,2,1
16,374,374,40,2,38,3,2
10,376,376,114,88,26,3,2
15,389,389,30,30,0,1,0
13,453,453,74,74,0,1,0
6,486,486,67,16,51,4,3

8,165,165,11,11,0,1,0
22,182,182,23,2,21,4,3
14,215,215,11,1,10,2,1
17,229,229,6,6,0,1,0
23,234,234,1,1,0,1,0
0,245,245,45,3,42,3,2
2,256,256,49,22,27,4,3
1,261,261,37,37,0,1,0
11,272,272,6,6,0,1,0
18,311,311,31,12,19,2,1
5,337,337,2,2,0,1,0
10,353,353,56,18,38,3,2
7,356,356,9,6,3,2,1
15,360,360,30,7,23,2,1
16,371,371,16,11,5,2,1
6,381,381,7,3,4,2,1
20,424,424,96,96,0,1,0
4,432,432,37,1,36,4,3
19,460,460,11,1,10,3,2
3,474,474,47,47,0,1,0
9,485,485,32,11,21,4,3
21,494,494,214,166,48,4,3
12,497,497,11,6,5,2,1
13,499,499,7,1,6,2,1

23,103,103,8,8,0,1,0
1,104,104,2,2,0,1,0
5,108,108,7,7,0,1,0
15,131,131,14,14,0,1,0
6,159,159,1,1,0,1,0
19,221,221,43,9,34,3,2
22,231,231,41,41,0,1,0
7,274,274,6,6,0,1,0
20,303,303,32,15,17,2,1
3,305,305,68,68,0,1,0
18,308,308,81,45,36,2,1
9,310,310,69,27,42,3,2
14,327,327,7,7,0,1,0
16,338,338,21,21,0,1,0
12,347,347,3,3,0,1,0
4,351,351,42,42,0,1,0
0,412,412,8,8,0,1,0
24,422,422,7,1,6,3,2
17,424,424,12,3,9,2,1
21,439,439,40,40,0,1,0
11,448,448,24,24,0,1,0
10,474,474,15,15,0,1,0
2,474,474,9,2,7,2,1
8,480,480,90,90,0,1,0
13,498,498,41,14,27,2,1

15,116,116,5,5,0,1,0
18,158,158,25,3,22,2,1
19,197,197,43,43,0,1,0
17,197,197,1,1,0,1,0
13,198,198,22,22,0,1,0
7,205,205,8,8,0,1,0
14,247,247,25,21,4,2,1
6,253,253,59,59,0,1,0
1,256,256,1,1,0,1,0
0,279,279,29,29,0,1,0
11,283,283,72,46,26,3,2
9,306,306,10,10,0,1,0
16,319,319,47,5,42,4,3
5,356,356,14,14,0,1,0
8,430,430,21,21,0,1,0
4,463,463,44,44,0,1,0
10,467,467,2,2,0,1,0
2,470,470,147,147,0,1,0
3,485,485,94,94,0,1,0
12,496,496,35,35,0,1,0

18,120,120,10,10,0,1,0
16,137,137,6,6,0,1,0
25,202,202,19,19,0,1,0
21,214,214,32,25,7,2,1
17,228,228,3,3,0,1,0
7,236,236,12,12,0,1,0
23,251,251,22,22,0,1,0
14,265,265,6,6,0,1,0
1,281,281,2,2,0,1,0
10,308,308,10,10,0,1,0
11,308,308,27,21,6,2,1
12,340,340,24,24,0,1,0
9,356,356,55,55,0,1,0
19,363,363,121,111,10,2,1
5,370,370,8,8,0,1,0
2,378,378,3,3,0,1,0
13,383,383,3,3,0,1,0
24,386,386,32,3,29,2,1
22,400,400,50,50,0,1,0
0,403,403,61,50,11,2,1
15,424,424,77,77,0,1,0
4,437,437,47,13,34,4,3
3,455,455,49,49,0,1,0
8,459,459,24,24,0,1,0
20,497,497,55,55,0,1,0
6,498,498,19,19,0,1,0

0,100,100,8,8,0,1,0
20,139,139,33,33,0,1,0
4,143,143,19,19,0,1,0
27,154,154,6,6,0,1,0
24,169,169,31,7,24,4,3
3,185,185,28,6,22,2,1
7,193,193,9,3,6,3,2
8,195,195,18,1,17,3,2
26,218,218,4,1,3,2,1
15,219,219,14,2,12,2,1
17,229,229,7,7,0,1,0
5,247,247,36,25,11,2,1
25,285,285,18,3,15,4,3
11,322,322,8,4,4,2,1
6,337,337,3,3,0,1,0
19,360,360,33,33,0,1,0
12,363,363,17,8,9,4,3
1,375,375,38,38,0,1,0
22,378,378,87,33,54,4,3
14,382,382,20,20,0,1,0
13,393,393,6,6,0,1,0
23,400,400,59,59,0,1,0
21,405,405,5,5,0,1,0
16,414,414,1,1,0,1,0
9,462,462,34,1,33,4,3
18,464,464,43,43,0,1,0
10,498,498,10,7,3,2,1
2,498,498,6,6,0,1,0

0,113,113,2,2,0,1,0
17,134,134,2,2,0,1,0
14,142,142,14,6,8,3,2
15,146,146,2,2,0,1,0
1,172,172,23,7,16,2,1
4,240,240,11,11,0,1,0
5,254,254,106,106,0,1,0
9,280,280,20,16,4,2,1
3,288,288,5,1,4,2,1
7,297,297,64,37,27,4,3
12,311,311,61,32,29,4,3
19,335,335,32,32,0,1,0
10,336,336,9,9,0,1,0
18,350,350,83,50,33,2,1
13,383,383,7,4,3,2,1
2,429,429,30,6,24,4,3
16,441,441,85,41,44,3,2
11,445,445,102,102,0,1,0
6,453,453,1,1,0,1,0
8,456,456,50,50,0,1,0

16,281,281,109,91,18,3,2
1,281,281,39,20,19,2,1
6,296,296,70,14,56,3,2
14,300,300,26,26,0,1,0
13,302,302,16,16,0,1,0
11,321,321,33,33,0,1,0
5,332,332,112,112,0,1,0
9,333,333,7,7,0,1,0
8,417,417,7,7,0,1,0
3,421,421,60,45,15,4,3
15,444,444,63,53,10,3,2
0,455,455,50,11,39,2,1
2,461,461,2,2,0,1,0
7,471,471,69,69,0,1,0
10,474,474,49,49,0,1,0
4,482,482,64,64,0,1,0
12,486,486,28,20,8,2,1

12,114,114,7,7,0,1,0
1,139,139,4,4,0,1,0
7,151,151,4,4,0,1,0
13,156,156,23,14,9,4,3
18,172,172,15,15,0,1,0
21,175,175,17,5,12,2,1
20,210,210,40,1,39,2,1
10,232,232,16,16,0,1,0
8,238,238,95,29,66,3,2
14,240,240,85,49,36,3,2
9,245,245,40,40,0,1,0
17,307,307,18,8,10,3,2
5,327,327,11,4,7,2,1
0,329,329,8,8,0,1,0
15,343,343,5,5,0,1,0
19,365,365,23,23,0,1,0
2,365,365,7,7,0,1,0
6,385,385,48,48,0,1,0
3,418,418,1,1,0,1,0
4,423,423,10,10,0,1,0
11,428,428,55,55,0,1,0
16,430,430,50,50,0,1,0
22,493,493,1,1,0,1,0

1,110,110,18,18,0,1,0
18,141,141,15,15,0,1,0
16,147,147,9,9,0,1,0
0,165,165,32,23,9,2,1
4,181,181,42,42,0,1,0
2,193,193,1,1,0,1,0
9,210,210,30,19,11,2,1
14,225,225,12,12,0,1,0
20,248,248,34,22,12,4,3
17,252,252,41,5,36,2,1
12,290,290,48,48,0,1,0
21,297,297,5,5,0,1,0
7,309,309,15,3,12,3,2
3,327,327,4,1,3,2,1
19,363,363,7,1,6,3,2
5,386,386,20,2,18,4,3
13,413,413,112,1,111,4,3
8,413,413,54,54,0,1,0
6,446,446,37,37,0,1,0
11,463,463,4,1,3,2,1
10,477,477,14,1,13,2,1
15,496,496,61,25,36,3,2

16,107,107,30,30,0,1,0
1,114,114,8,8,0,1,0
7,116,116,7,7,0,1,0
15,139,139,18,18,0,1,0
13,153,153,3,3,0,1,0
12,157,157,16,16,0,1,0
24,171,171,30,30,0,1,0
23,192,192,28,28,0,1,0
8,216,216,31,5,26,3,2
2,232,232,4,1,3,2,1
22,240,240,14,14,0,1,0
5,266,266,11,4,7,2,1
20,314,314,34,34,0,1,0
6,368,368,3,3,0,1,0
21,381,381,43,43,0,1,0
18,402,402,19,6,13,4,3
14,402,402,107,107,0,1,0
11,420,420,27,27,0,1,0
0,423,423,9,9,0,1,0
17,447,447,15,1,14,2,1
19,455,455,16,1,15,2,1
4,457,457,94,94,0,1,0
10,470,470,21,21,0,1,0
9,477,477,1,1,0,1,0
3,496,496,17,11,6,2,1

7,101,101,3,3,0,1,0
10,122,122,1,1,0,1,0
12,122,122,5,5,0,1,0
14,152,152,4,4,0,1,0
18,171,171,6,6,0,1,0
5,174,174,3,3,0,1,0
22,221,221,16,6,10,2,1
21,231,231,49,10,39,2,1
17,238,238,50,4,46,2,1
0,259,259,7,7,0,1,0
13,278,278,25,5,20,3,2
15,344,344,43,43,0,1,0
19,345,345,2,2,0,1,0
20,354,354,74,74,0,1,0
4,364,364,2,2,0,1,0
6,376,376,164,114,50,3,2
1,403,403,25,13,12,2,1
9,403,403,10,3,7,2,1
8,420,420,32,16,16,3,2
16,421,421,56,56,0,1,0
3,447,447,86,52,34,3,2
11,466,466,22,22,0,1,0
2,497,497,69,41,28,2,1

15,103,103,15,15,0,1,0
1,127,127,37,16,21,4,3
20,128,128,43,26,17,3,2
17,144,144,16,7,9,4,3
7,178,178,11,11,0,1,0
18,208,208,27,9,18,4,3
13,227,227,3,3,0,1,0
8,231,231,4,4,0,1,0
2,235,235,5,5,0,1,0
4,246,246,24,3,21,2,1
9,254,254,26,16,10,2,1
16,286,286,21,21,0,1,0
0,304,304,29,2,27,4,3
19,316,316,26,14,12,4,3
14,343,343,31,31,0,1,0
6,345,345,4,1,3,2,1
3,365,365,20,2,18,4,3
11,385,385,34,34,0,1,0
12,388,388,20,11,9,4,3
10,424,424,57,28,29,2,1
5,497,497,106,106,0,1,0

12,101,101,9,5,4,2,1
3,166,166,11,11,0,1,0
2,189,189,10,10,0,1,0
16,192,192,7,7,0,1,0
9,224,224,71,29,42,4,3
17,226,226,7,7,0,1,0
13,228,228,8,4,4,2,1
0,240,240,6,2,4,2,1
8,259,259,22,7,15,2,1
11,265,265,7,7,0,1,0
1,278,278,29,18,11,2,1
15,281,281,11,11,0,1,0
7,298,298,34,18,16,3,2
5,298,298,69,69,0,1,0
4,307,307,72,2,70,3,2
14,341,341,127,50,77,4,3
10,463,463,42,42,0,1,0
6,488,488,133,11,122,4,3

14,114,114,10,10,0,1,0
18,165,165,27,14,13,2,1
13,180,180,14,14,0,1,0
21,187,187,24,24,0,1,0
17,190,190,3,3,0,1,0
19,198,198,5,5,0,1,0
2,207,207,4,4,0,1,0
10,217,217,32,21,11,4,3
15,251,251,97,97,0,1,0
16,283,283,20,2,18,4,3
9,288,288,69,57,12,4,3
12,290,290,13,7,6,3,2
3,318,318,2,2,0,1,0
0,344,344,8,5,3,2,1
8,364,364,53,41,12,2,1
5,372,372,48,18,30,4,3
4,392,392,16,2,14,3,2
6,418,418,22,14,8,3,2
7,453,453,10,10,0,1,0
20,478,478,61,61,0,1,0
11,492,492,38,22,16,3,2
1,493,493,97,88,9,2,1

4,123,123,15,15,0,1,0
0,201,201,9,9,0,1,0
21,206,206,3,3,0,1,0
10,220,220,1,1,0,1,0
18,231,231,42,32,10,3,2
1,268,268,44,44,0,1,0
14,269,269,85,35,50,2,1
8,276,276,2,2,0,1,0
9,287,287,39,39,0,1,0
19,288,288,6,1,5,2,1
2,327,327,28,28,0,1,0
13,331,331,35,35,0,1,0
17,351,351,65,35,30,3,2
16,362,362,5,1,4,2,1
5,406,406,94,94,0,1,0
20,412,412,7,1,6,2,1
6,435,435,7,7,0,1,0
15,442,442,63,31,32,2,1
11,472,472,2,2,0,1,0
7,481,481,6,6,0,1,0
3,489,489,133,58,75,4,3
12,490,490,58,19,39,4,3

8,150,150,3,3,0,1,0
15,214,214,12,12,0,1,0
5,240,240,30,22,8,3,2
12,262,262,50,35,15,4,3
9,262,262,7,7,0,1,0
4,268,268,26,23,3,2,1
7,275,275,1,1,0,1,0
13,286,286,5,5,0,1,0
2,341,341,76,32,44,3,2
10,354,354,20,20,0,1,0
16,357,357,15,1,14,4,3
14,377,377,204,132,72,4,3
1,412,412,3,3,0,1,0
0,433,433,7,2,5,2,1
6,440,440,243,196,47,3,2
3,470,470,38,2,36,2,1
11,490,490,81,81,0,1,0

19,100,100,11,11,0,1,0
23,101,101,10,10,0,1,0
15,107,107,4,4,0,1,0
11,131,131,18,18,0,1,0
20,131,131,17,17,0,1,0
16,133,133,25,7,18,2,1
5,138,138,10,10,0,1,0
22,140,140,20,6,14,3,2
2,142,142,4,4,0,1,0
14,144,144,1,1,0,1,0
7,202,202,12,12,0,1,0
8,204,204,1,1,0,1,0
17,206,206,16,4,12,3,2
24,245,245,6,6,0,1,0
4,253,253,29,29,0,1,0
9,323,323,15,15,0,1,0
25,334,334,51,51,0,1,0
1,347,347,38,38,0,1,0
0,370,370,10,10,0,1,0
18,378,378,45,45,0,1,0
12,387,387,17,7,10,4,3
6,398,398,91,70,21,4,3
3,400,400,38,29,9,4,3
21,402,402,38,2,36,4,3
10,425,425,26,26,0,1,0
13,494,494,17,11,6,2,1

15,110,110,19,9,10,3,2
19,120,120,7,4,3,2,1
22,138,138,1,1,0,1,0
5,172,172,1,1,0,1,0
13,185,185,7,4,3,2,1
3,203,203,1,1,0,1,0
12,224,224,28,28,0,1,0
9,234,234,6,6,0,1,0
0,242,242,86,86,0,1,0
20,250,250,112,73,39,4,3
8,276,276,31,31,0,1,0
6,278,278,5,5,0,1,0
7,304,304,14,14,0,1,0
23,308,308,5,5,0,1,0
11,317,317,15,6,9,4,3
18,325,325,17,9,8,2,1
2,332,332,10,10,0,1,0
1,362,362,16,16,0,1,0
24,376,376,39,3,36,4,3
10,398,398,22,14,8,2,1
17,430,430,22,22,0,1,0
16,442,442,71,62,9,4,3
14,460,460,38,26,12,4,3
4,490,490,54,54,0,1,0
21,493,493,25,7,18,2,1

2,144,144,57,3,54,3,2
6,146,146,12,12,0,1,0
3,167,167,30,30,0,1,0
8,170,170,4,4,0,1,0
14,177,177,31,20,11,2,1
11,184,184,25,25,0,1,0
13,223,223,60,1,59,4,3
9,227,227,41,41,0,1,0
0,232,232,13,13,0,1,0
19,250,250,40,40,0,1,0
4,256,256,1,1,0,1,0
5,285,285,18,9,9,4,3
18,289,289,6,6,0,1,0
16,306,306,12,5,7,2,1
17,367,367,7,7,0,1,0
10,398,398,63,63,0,1,0
1,403,403,47,8,39,4,3
15,410,410,13,13,0,1,0
7,421,421,1,1,0,1,0
12,483,483,50,22,28,3,2

14,135,135,5,1,4,2,1
10,196,196,67,5,62,3,2
0,222,222,13,5,8,3,2
4,224,224,4,4,0,1,0
3,236,236,55,55,0,1,0
12,296,296,1,1,0,1,0
8,310,310,13,4,9,2,1
13,313,313,6,6,0,1,0
6,325,325,84,20,64,3,2
7,351,351,15,15,0,1,0
9,366,366,122,78,44,2,1
5,381,381,193,193,0,1,0
16,415,415,22,22,0,1,0
15,419,419,65,65,0,1,0
11,422,422,36,9,27,4,3
2,458,458,10,10,0,1,0
1,458,458,3,3,0,1,0

6,101,101,5,5,0,1,0
17,106,106,3,3,0,1,0
8,166,166,3,3,0,1,0
0,201,201,97,25,72,3,2
4,219,219,12,12,0,1,0
7,225,225,14,2,12,4,3
2,266,266,9,9,0,1,0
9,298,298,100,100,0,1,0
5,332,332,7,7,0,1,0
11,342,342,29,29,0,1,0
3,354,354,56,51,5,2,1
13,357,357,16,16,0,1,0
12,369,369,60,36,24,2,1
18,436,436,7,7,0,1,0
14,442,442,83,47,36,2,1
1,444,444,100,84,16,3,2
10,444,444,34,34,0,1,0
15,485,485,63,63,0,1,0
16,494,494,25,25,0,1,0

1,129,129,20,12,8,3,2
6,134,134,10,2,8,2,1
17,182,182,27,24,3,2,1
7,220,220,12,2,10,2,1
19,228,228,10,2,8,2,1
15,244,244,11,11,0,1,0
9,255,255,13,13,0,1,0
4,286,286,2,2,0,1,0
5,290,290,1,1,0,1,0
8,302,302,59,23,36,4,3
13,305,305,7,1,6,2,1
14,339,339,76,44,32,3,2
18,342,342,71,71,0,1,0
3,357,357,1,1,0,1,0
12,360,360,12,12,0,1,0
20,361,361,30,30,0,1,0
16,373,373,25,9,16,4,3
0,448,448,54,4,50,3,2
2,455,455,139,139,0,1,0
10,467,467,61,16,45,4,3
11,472,472,115,81,34,3,2

3,132,132,10,2,8,2,1
8,145,145,7,7,0,1,0
26,154,154,41,17,24,3,2
0,159,159,19,19,0,1,0
6,161,161,1,1,0,1,0
9,165,165,3,3,0,1,0
13,172,172,7,3,4,2,1
18,193,193,16,2,14,3,2
10,199,199,10,5,5,2,1
11,202,202,2,2,0,1,0
15,209,209,6,1,5,2,1
21,239,239,10,1,9,2,1
24,281,281,5,5,0,1,0
25,303,303,8,8,0,1,0
1,326,326,7,7,0,1,0
4,339,339,16,16,0,1,0
23,340,340,27,27,0,1,0
14,363,363,38,38,0,1,0
16,369,369,35,1,34,4,3
17,383,383,19,4,15,2,1
19,395,395,89,11,78,4,3
5,396,396,20,20,0,1,0
22,402,402,21,21,0,1,0
2,429,429,15,2,13,2,1
12,463,463,81,18,63,4,3
7,471,471,83,83,0,1,0
20,484,484,131,101,30,2,1

0,106,106,1,1,0,1,0
3,126,126,4,4,0,1,0
1,148,148,4,4,0,1,0
10,165,165,26,5,21,2,1
21,194,194,26,5,21,4,3
11,233,233,18,3,15,4,3
19,234,234,16,16,0,1,0
5,271,271,10,10,0,1,0
6,302,302,35,9,26,3,2
13,307,307,13,13,0,1,0
17,317,317,25,11,14,2,1
7,319,319,58,31,27,3,2
9,335,335,30,30,0,1,0
8,407,407,74,9,65,3,2
2,411,411,56,35,21,2,1
12,418,418,3,3,0,1,0
14,419,419,25,19,6,3,2
20,436,436,38,38,0,1,0
18,448,448,143,133,10,2,1
4,450,450,25,25,0,1,0
16,489,489,51,6,45,2,1
15,494,494,107,107,0,1,0

7,101,101,8,8,0,1,0
20,130,130,5,2,3,2,1
15,150,150,4,1,3,2,1
6,169,169,25,25,0,1,0
13,191,191,11,4,7,2,1
11,232,232,1,1,0,1,0
14,278,278,30,30,0,1,0
2,280,280,61,13,48,3,2
21,312,312,35,19,16,2,1
0,317,317,52,52,0,1,0
19,326,326,76,7,69,4,3
9,328,328,28,28,0,1,0
18,338,338,27,27,0,1,0
16,376,376,70,34,36,3,2
1,395,395,13,4,9,2,1
3,396,396,42,28,14,3,2
17,424,424,54,54,0,1,0
5,426,426,24,16,8,2,1
8,457,457,15,15,0,1,0
4,459,459,62,62,0,1,0
10,485,485,20,2,18,3,2
12,491,491,78,28,50,3,2

16,119,119,15,5,10,2,1
4,126,126,20,11,9,4,3
9,191,191,28,28,0,1,0
2,209,209,1,1,0,1,0
13,217,217,4,4,0,1,0
11,220,220,2,2,0,1,0
14,220,220,25,25,0,1,0
10,242,242,56,56,0,1,0
1,266,266,69,24,45,4,3
7,295,295,12,6,6,3,2
12,355,355,28,28,0,1,0
0,361,361,103,103,0,1,0
3,424,424,1,1,0,1,0
6,424,424,90,38,52,3,2
15,434,434,45,45,0,1,0
8,456,456,115,115,0,1,0
5,485,485,86,76,10,3,2

16,107,107,61,61,0,1,0
5,108,108,35,35,0,1,0
19,140,140,15,15,0,1,0
18,200,200,21,21,0,1,0
14,210,210,2,2,0,1,0
12,212,212,8,8,0,1,0
2,219,219,9,9,0,1,0
15,246,246,18,18,0,1,0
20,259,259,3,3,0,1,0
13,278,278,20,15,5,2,1
21,298,298,21,21,0,1,0
6,308,308,31,31,0,1,0
1,315,315,50,8,42,4,3
3,330,330,3,3,0,1,0
9,348,348,47,47,0,1,0
17,381,381,26,26,0,1,0
0,395,395,8,8,0,1,0
4,412,412,23,23,0,1,0
10,437,437,52,24,28,3,2
7,473,473,27,27,0,1,0
11,491,491,17,9,8,3,2
8,494,494,23,11,12,3,2

7,121,121,1,1,0,1,0
1,153,153,14,4,10,3,2
18,166,166,6,6,0,1,0
14,178,178,76,76,0,1,0
0,197,197,25,13,12,4,3
11,219,219,7,7,0,1,0
4,259,259,112,112,0,1,0
8,263,263,7,2,5,2,1
12,288,288,29,14,15,2,1
3,312,312,20,2,18,3,2
13,335,335,9,9,0,1,0
17,342,342,7,7,0,1,0
5,395,395,16,13,3,2,1
2,402,402,24,12,12,2,1
10,419,419,53,48,5,2,1
19,431,431,126,126,0,1,0
6,441,441,74,44,30,4,3
9,462,462,38,32,6,2,1
16,479,479,14,14,0,1,0
15,483,483,9,9,0,1,0

13,108,108,13,5,8,2,1
4,122,122,9,3,6,2,1
20,125,125,6,6,0,1,0
17,129,129,13,13,0,1,0
19,134,134,31,5,26,2,1
1,161,161,42,3,39,4,3
16,166,166,16,16,0,1,0
18,199,199,10,10,0,1,0
10,202,202,7,7,0,1,0
7,278,278,13,1,12,4,3
9,286,286,27,27,0,1,0
5,290,290,9,9,0,1,0
22,296,296,50,50,0,1,0
0,308,308,25,25,0,1,0
23,334,334,7,4,3,2,1
6,338,338,2,2,0,1,0
2,391,391,35,35,0,1,0
12,394,394,8,8,0,1,0
11,401,401,6,6,0,1,0
15,439,439,63,63,0,1,0
8,454,454,41,41,0,1,0
14,455,455,70,49,21,4,3
21,483,483,52,29,23,2,1
3,500,500,71,48,23,2,1

9,102,102,14,2,12,4,3
17,107,107,4,1,3,2,1
18,124,124,8,8,0,1,0
19,167,167,5,5,0,1,0
2,182,182,6,6,0,1,0
20,196,196,54,54,0,1,0
8,203,203,60,6,54,4,3
13,204,204,5,5,0,1,0
3,211,211,6,6,0,1,0
16,216,216,16,10,6,3,2
0,217,217,4,1,3,2,1
11,328,328,45,45,0,1,0
15,334,334,94,94,0,1,0
4,355,355,91,71,20,2,1
1,385,385,24,24,0,1,0
6,394,394,51,26,25,2,1
12,409,409,34,34,0,1,0
5,417,417,7,7,0,1,0
10,424,424,29,17,12,4,3
7,448,448,25,25,0,1,0
14,481,481,54,3,51,3,2

9,140,140,32,12,20,2,1
14,172,172,2,2,0,1,0
21,187,187,14,14,0,1,0
8,193,193,69,18,51,4,3
1,205,205,6,6,0,1,0
10,232,232,1,1,0,1,0
22,236,236,32,15,17,2,1
19,241,241,12,12,0,1,0
3,281,281,8,8,0,1,0
4,321,321,37,37,0,1,0
17,364,364,145,107,38,3,2
18,366,366,90,30,60,4,3
15,370,370,22,22,0,1,0
7,406,406,32,9,23,2,1
12,412,412,41,9,32,3,2
0,447,447,33,18,15,4,3
16,448,448,9,4,5,2,1
20,449,449,38,38,0,1,0
6,456,456,3,3,0,1,0
2,470,470,10,10,0,1,0
5,489,489,18,12,6,2,1
11,493,493,10,10,0,1,0
13,494,494,21,8,13,2,1

9,124,124,1,1,0,1,0
23,150,150,17,17,0,1,0
28,153,153,4,4,0,1,0
7,179,179,3,3,0,1,0
16,199,199,6,1,5,2,1
0,201,201,8,8,0,1,0
18,229,229,1,1,0,1,0
8,233,233,14,4,10,2,1
3,251,251,22,22,0,1,0
20,285,285,33,21,12,4,3
25,291,291,23,23,0,1,0
4,292,292,27,17,10,2,1
13,293,293,34,34,0,1,0
6,310,310,2,2,0,1,0
22,313,313,72,63,9,4,3
1,314,314,17,17,0,1,0
26,331,331,5,5,0,1,0
2,344,344,3,3,0,1,0
27,351,351,39,39,0,1,0
11,354,354,15,15,0,1,0
15,365,365,1,1,0,1,0
19,375,375,107,20,87,4,3
12,383,383,127,127,0,1,0
14,404,404,6,6,0,1,0
17,406,406,4,1,3,2,1
24,407,407,12,12,0,1,0
10,409,409,63,63,0,1,0
21,442,442,48,11,37,2,1
5,455,455,11,11,0,1,0

5,109,109,14,14,0,1,0
8,140,140,7,7,0,1,0
25,145,145,15,15,0,1,0
10,155,155,4,4,0,1,0
14,174,174,25,16,9,2,1
3,174,174,17,17,0,1,0
20,187,187,15,6,9,4,3
13,198,198,7,7,0,1,0
0,231,231,20,20,0,1,0
23,243,243,61,61,0,1,0
15,261,261,22,22,0,1,0
16,317,317,6,6,0,1,0
1,329,329,33,33,0,1,0
9,335,335,9,9,0,1,0
7,340,340,11,11,0,1,0
6,357,357,10,10,0,1,0
22,361,361,27,27,0,1,0
12,380,380,64,64,0,1,0
17,383,383,26,26,0,1,0
4,388,388,22,17,5,2,1
21,405,405,18,3,15,2,1
18,433,433,38,38,0,1,0
19,443,443,36,36,0,1,0
2,448,448,9,1,8,2,1
24,462,462,143,55,88,4,3
11,498,498,9,2,7,3,2

11,163,163,4,4,0,1,0
13,187,187,6,6,0,1,0
18,188,188,16,4,12,4,3
5,198,198,6,6,0,1,0
1,200,200,1,1,0,1,0
9,200,200,9,4,5,2,1
6,258,258,12,12,0,1,0
17,269,269,62,14,48,3,2
16,280,280,50,24,26,2,1
19,321,321,2,2,0,1,0
3,323,323,29,18,11,2,1
10,337,337,111,87,24,4,3
4,345,345,36,36,0,1,0
20,356,356,43,1,42,3,2
7,366,366,30,30,0,1,0
2,367,367,1,1,0,1,0
8,398,398,110,67,43,3,2
12,405,405,42,34,8,2,1
14,413,413,124,70,54,4,3
15,445,445,16,1,15,2,1
0,459,459,42,7,35,2,1

11,136,136,27,18,9,2,1
17,178,178,51,19,32,2,1
2,180,180,16,16,0,1,0
9,189,189,20,20,0,1,0
7,237,237,17,2,15,2,1
14,255,255,20,8,12,4,3
21,257,257,15,15,0,1,0
6,268,268,20,3,17,2,1
16,273,273,20,14,6,2,1
20,281,281,15,15,0,1,0
12,290,290,11,3,8,2,1
18,292,292,24,14,10,2,1
4,334,334,35,11,24,3,2
10,359,359,4,4,0,1,0
5,367,367,12,2,10,2,1
0,398,398,100,8,92,3,2
3,404,404,7,1,6,2,1
1,425,425,61,43,18,3,2
13,450,450,17,8,9,2,1
19,460,460,22,22,0,1,0
8,477,477,1,1,0,1,0
15,495,495,180,180,0,1,0

2,120,120,17,8,9,4,3
17,142,142,16,11,5,2,1
18,158,158,5,5,0,1,0
1,165,165,20,20,0,1,0
4,194,194,11,11,0,1,0
3,209,209,49,49,0,1,0
16,225,225,38,38,0,1,0
13,253,253,19,6,13,2,1
14,266,266,27,18,9,2,1
11,269,269,32,11,21,4,3
0,272,272,62,49,13,2,1
9,273,273,78,45,33,2,1
6,354,354,2,2,0,1,0
8,361,361,5,5,0,1,0
5,393,393,15,7,8,3,2
15,420,420,20,20,0,1,0
10,434,434,14,14,0,1,0
12,473,473,69,13,56,3,2
7,483,483,126,78,48,4,3

4,110,110,5,5,0,1,0
8,127,127,32,32,0,1,0
15,136,136,5,5,0,1,0
3,166,166,32,32,0,1,0
14,223,223,15,9,6,3,2
6,225,225,37,37,0,1,0
10,252,252,7,7,0,1,0
1,280,280,39,9,30,3,2
11,303,303,25,15,10,2,1
7,305,305,9,9,0,1,0
2,312,312,26,10,16,2,1
0,327,327,56,56,0,1,0
13,377,377,22,22,0,1,0
16,399,399,63,63,0,1,0
9,418,418,154,129,25,4,3
5,452,452,139,92,47,2,1
12,479,479,19,3,16,3,2

2,101,101,1,1,0,1,0
15,109,109,1,1,0,1,0
8,146,146,7,1,6,3,2
13,158,158,2,2,0,1,0
18,217,217,79,57,22,3,2
3,228,228,15,3,12,4,3
5,244,244,27,15,12,4,3
6,271,271,43,43,0,1,0
0,287,287,19,5,14,3,2
21,289,289,49,49,0,1,0
23,290,290,46,46,0,1,0
19,319,319,3,3,0,1,0
22,321,321,27,12,15,4,3
7,333,333,44,11,33,4,3
17,336,336,13,1,12,4,3
20,342,342,19,3,16,3,2
12,363,363,57,26,31,2,1
9,365,365,2,2,0,1,0
16,396,396,70,66,4,2,1
4,425,425,47,5,42,2,1
14,439,439,23,8,15,4,3
10,442,442,6,6,0,1,0
11,458,458,55,5,50,3,2
1,484,484,46,28,18,3,2

12,125,125,14,14,0,1,0
15,153,153,28,25,3,2,1
4,163,163,1,1,0,1,0
22,168,168,10,1,9,4,3
7,182,182,1,1,0,1,0
11,223,223,1,1,0,1,0
14,244,244,6,1,5,2,1
13,292,292,18,6,12,3,2
8,296,296,8,8,0,1,0
9,299,299,55,23,32,2,1
0,310,310,21,7,14,2,1
21,311,311,20,5,15,3,2
3,341,341,1,1,0,1,0
20,342,342,61,61,0,1,0
6,345,345,5,1,4,2,1
23,381,381,6,6,0,1,0
18,382,382,68,29,39,2,1
2,391,391,13,4,9,3,2
5,404,404,36,12,24,4,3
17,407,407,39,15,24,4,3
10,425,425,62,62,0,1,0
16,433,433,94,22,72,4,3
19,444,444,46,46,0,1,0
1,488,488,170,117,53,4,3

1,120,120,1,1,0,1,0
8,143,143,20,2,18,3,2
13,176,176,7,7,0,1,0
11,177,177,32,32,0,1,0
3,194,194,31,28,3,2,1
15,202,202,6,6,0,1,0
9,247,247,41,41,0,1,0
5,269,269,1,1,0,1,0
0,286,286,56,22,34,3,2
7,306,306,39,3,36,2,1
18,309,309,46,24,22,3,2
4,319,319,7,7,0,1,0
10,343,343,18,1,17,2,1
14,349,349,70,70,0,1,0
16,356,356,6,6,0,1,0
19,365,365,152,118,34,3,2
6,373,373,85,77,8,2,1
12,418,418,10,1,9,2,1
17,435,435,3,3,0,1,0
2,497,497,25,25,0,1,0

2,188,188,15,15,0,1,0
6,256,256,56,56,0,1,0
15,261,261,32,2,30,3,2
12,263,263,56,5,51,4,3
14,270,270,10,10,0,1,0
11,280,280,28,4,24,4,3
16,284,284,15,15,0,1,0
3,328,328,41,8,33,3,2
8,336,336,16,16,0,1,0
10,378,378,20,8,12,2,1
4,379,379,5,1,4,2,1
1,440,440,53,37,16,3,2
13,457,457,19,19,0,1,0
7,464,464,118,94,24,4,3
5,469,469,163,144,19,2,1
0,471,471,93,93,0,1,0
9,485,485,95,95,0,1,0

8,163,163,11,7,4,2,1
9,198,198,88,88,0,1,0
1,202,202,2,2,0,1,0
2,251,251,14,14,0,1,0
10,251,251,41,41,0,1,0
0,254,254,53,5,48,2,1
11,255,255,13,6,7,2,1
7,274,274,133,100,33,4,3
12,275,275,59,56,3,2,1
14,286,286,25,5,20,4,3
5,367,367,21,17,4,2,1
6,368,368,38,35,3,2,1
17,382,382,8,8,0,1,0
3,402,402,7,3,4,2,1
15,402,402,9,9,0,1,0
4,470,470,77,77,0,1,0
13,476,476,16,11,5,2,1
16,493,493,6,6,0,1,0

3,117,117,4,4,0,1,0
14,172,172,44,44,0,1,0
2,180,180,44,38,6,2,1
1,210,210,26,2,24,2,1
10,241,241,25,10,15,2,1
12,258,258,16,16,0,1,0
9,299,299,13,2,11,2,1
6,330,330,37,12,25,2,1
7,359,359,17,17,0,1,0
5,392,392,16,16,0,1,0
11,412,412,3,3,0,1,0
4,415,415,221,197,24,2,1
8,445,445,152,125,27,4,3
13,452,452,24,4,20,3,2
0,467,467,59,59,0,1,0
15,482,482,45,27,18,4,3

3,102,102,5,1,4,2,1
25,104,104,11,11,0,1,0
19,116,116,2,2,0,1,0
2,121,121,23,23,0,1,0
16,155,155,1,1,0,1,0
10,175,175,8,8,0,1,0
17,182,182,6,2,4,2,1
24,183,183,1,1,0,1,0
7,201,201,26,26,0,1,0
14,213,213,24,24,0,1,0
22,215,215,9,9,0,1,0
15,227,227,7,7,0,1,0
26,261,261,64,64,0,1,0
11,266,266,2,2,0,1,0
9,270,270,33,7,26,3,2
12,278,278,1,1,0,1,0
23,317,317,17,17,0,1,0
18,324,324,26,26,0,1,0
5,348,348,42,6,36,4,3
1,356,356,46,13,33,4,3
4,375,375,20,20,0,1,0
21,382,382,8,5,3,2,1
20,410,410,197,115,82,3,2
27,437,437,28,28,0,1,0
6,454,454,8,8,0,1,0
0,459,459,7,7,0,1,0
8,463,463,15,2,13,2,1
13,484,484,3,3,0,1,0

5,103,103,2,2,0,1,0
16,107,107,5,5,0,1,0
1,114,114,3,3,0,1,0
17,129,129,17,7,10,3,2
13,141,141,1,1,0,1,0
7,143,143,11,11,0,1,0
4,201,201,12,12,0,1,0
10,220,220,11,11,0,1,0
14,231,231,67,67,0,1,0
9,263,263,4,4,0,1,0
18,309,309,83,53,30,4,3
6,315,315,189,63,126,4,3
0,318,318,5,5,0,1,0
11,330,330,9,9,0,1,0
2,336,336,86,50,36,4,3
12,347,347,45,45,0,1,0
19,362,362,7,3,4,2,1
8,372,372,6,6,0,1,0
3,401,401,7,7,0,1,0
15,412,412,62,49,13,2,1

19,103,103,17,17,0,1,0
2,107,107,3,3,0,1,0
11,201,201,14,14,0,1,0
12,207,207,3,3,0,1,0
16,216,216,79,40,39,4,3
14,216,216,18,18,0,1,0
4,222,222,18,2,16,3,2
0,232,232,13,4,9,4,3
1,244,244,22,22,0,1,0
18,248,248,19,1,18,4,3
10,252,252,60,60,0,1,0
6,269,269,50,50,0,1,0
5,295,295,1,1,0,1,0
17,303,303,1,1,0,1,0
7,313,313,39,19,20,2,1
3,359,359,43,6,37,4,3
13,369,369,55,55,0,1,0
20,393,393,38,38,0,1,0
9,409,409,27,14,13,4,3
8,426,426,16,16,0,1,0
15,434,434,62,62,0,1,0
21,483,483,15,1,14,2,1

15,100,100,11,8,3,2,1
12,112,112,14,14,0,1,0
11,112,112,39,6,33,4,3
1,124,124,43,43,0,1,0
14,126,126,4,1,3,2,1
7,128,128,6,1,5,2,1
5,152,152,24,24,0,1,0
2,181,181,34,9,25,2,1
8,234,234,25,25,0,1,0
4,318,318,42,14,28,3,2
0,372,372,1,1,0,1,0
13,408,408,6,6,0,1,0
10,415,415,2,2,0,1,0
3,425,425,55,34,21,2,1
16,434,434,1,1,0,1,0
6,438,438,43,43,0,1,0
17,444,444,25,22,3,2,1
9,495,495,159,159,0,1,0

5,105,105,6,6,0,1,0
4,145,145,1,1,0,1,0
23,165,165,53,53,0,1,0
2,184,184,2,2,0,1,0
6,188,188,7,2,5,2,1
17,192,192,3,3,0,1,0
25,198,198,25,25,0,1,0
0,205,205,27,3,24,4,3
18,206,206,17,3,14,2,1
16,211,211,7,7,0,1,0
21,217,217,19,19,0,1,0
11,228,228,63,53,10,3,2
26,255,255,8,8,0,1,0
13,255,255,7,7,0,1,0
9,272,272,2,2,0,1,0
8,307,307,20,20,0,1,0
19,352,352,101,17,84,4,3
7,363,363,49,25,24,4,3
12,397,397,23,2,21,4,3
22,403,403,9,9,0,1,0
20,412,412,18,18,0,1,0
15,422,422,29,29,0,1,0
10,422,422,14,2,12,4,3
24,442,442,40,40,0,1,0
1,443,443,9,9,0,1,0
3,470,470,39,39,0,1,0
14,494,494,17,17,0,1,0
27,494,494,11,2,9,4,3

14,100,100,1,1,0,1,0
12,112,112,5,5,0,1,0
23,127,127,18,10,8,2,1
13,190,190,25,19,6,2,1
11,204,204,23,15,8,3,2
7,206,206,1,1,0,1,0
8,227,227,2,2,0,1,0
9,234,234,1,1,0,1,0
10,258,258,53,15,38,3,2
2,262,262,15,6,9,4,3
25,267,267,10,1,9,4,3
19,273,273,8,5,3,2,1
0,314,314,5,2,3,2,1
16,317,317,24,2,22,3,2
17,318,318,16,7,9,4,3
15,319,319,27,27,0,1,0
5,332,332,17,17,0,1,0
6,332,332,28,28,0,1,0
3,339,339,1,1,0,1,0
18,341,341,49,49,0,1,0
20,347,347,26,26,0,1,0
21,347,347,44,3,41,4,3
26,356,356,134,38,96,4,3
27,379,379,4,4,0,1,0
24,409,409,59,59,0,1,0
1,420,420,21,12,9,2,1
22,469,469,16,16,0,1,0
4,470,470,50,50,0,1,0

20,143,143,36,36,0,1,0
7,151,151,6,6,0,1,0
3,158,158,9,9,0,1,0
0,163,163,41,41,0,1,0
14,164,164,23,23,0,1,0
10,218,218,22,22,0,1,0
8,226,226,57,57,0,1,0
15,256,256,81,12,69,4,3
4,260,260,32,32,0,1,0
1,276,276,19,19,0,1,0
17,305,305,26,8,18,2,1
16,312,312,29,29,0,1,0
5,317,317,9,5,4,2,1
19,334,334,14,14,0,1,0
2,346,346,7,2,5,2,1
9,358,358,28,28,0,1,0
18,414,414,33,33,0,1,0
21,461,461,3,3,0,1,0
12,472,472,40,40,0,1,0
11,479,479,20,20,0,1,0
13,496,496,11,11,0,1,0
6,500,500,20,20,0,1,0

8,157,157,1,1,0,1,0
7,158,158,40,14,26,3,2
16,186,186,3,3,0,1,0
19,201,201,40,40,0,1,0
17,204,204,42,42,0,1,0
6,223,223,6,6,0,1,0
14,253,253,7,7,0,1,0
13,259,259,35,26,9,2,1
18,271,271,6,6,0,1,0
2,273,273,21,21,0,1,0
4,306,306,39,36,3,2,1
0,316,316,44,10,34,2,1
12,350,350,9,4,5,2,1
11,353,353,1,1,0,1,0
1,360,360,21,21,0,1,0
21,361,361,5,2,3,2,1
20,368,368,53,11,42,2,1
22,378,378,86,86,0,1,0
5,431,431,115,77,38,3,2
15,433,433,55,55,0,1,0
3,487,487,2,2,0,1,0
9,499,499,4,1,3,2,1
10,500,500,53,44,9,4,3

0,106,106,21,21,0,1,0
6,128,128,15,1,14,3,2
16,168,168,22,22,0,1,0
15,168,168,40,40,0,1,0
1,174,174,1,1,0,1,0
11,217,217,74,43,31,2,1
5,220,220,64,64,0,1,0
12,269,269,6,6,0,1,0
9,283,283,13,5,8,3,2
10,300,300,31,31,0,1,0
3,302,302,14,14,0,1,0
14,357,357,18,18,0,1,0
7,388,388,109,109,0,1,0
17,389,389,61,61,0,1,0
8,420,420,1,1,0,1,0
13,432,432,12,2,10,2,1
4,436,436,50,50,0,1,0
2,448,448,21,21,0,1,0

2,106,106,1,1,0,1,0
7,115,115,9,9,0,1,0
12,131,131,5,5,0,1,0
14,132,132,26,11,15,4,3
11,142,142,26,12,14,2,1
19,157,157,1,1,0,1,0
13,167,167,12,2,10,3,2
1,244,244,7,7,0,1,0
16,259,259,11,11,0,1,0
6,265,265,66,51,15,2,1
8,288,288,22,9,13,3,2
20,289,289,132,84,48,3,2
4,308,308,33,33,0,1,0
18,337,337,16,6,10,3,2
10,342,342,5,5,0,1,0
17,382,382,5,5,0,1,0
3,414,414,101,101,0,1,0
9,422,422,1,1,0,1,0
15,437,437,78,78,0,1,0
0,452,452,3,3,0,1,0
21,486,486,33,1,32,4,3
5,500,500,51,51,0,1,0

20,107,107,4,1,3,2,1
26,117,117,4,1,3,2,1
10,120,120,7,7,0,1,0
0,121,121,6,1,5,2,1
21,124,124,11,11,0,1,0
13,138,138,1,1,0,1,0
11,138,138,24,24,0,1,0
24,166,166,3,3,0,1,0
23,177,177,15,15,0,1,0
19,193,193,83,32,51,4,3
22,258,258,9,9,0,1,0
8,267,267,1,1,0,1,0
14,278,278,1,1,0,1,0
5,280,280,5,5,0,1,0
16,287,287,44,32,12,4,3
1,289,289,21,21,0,1,0
9,291,291,30,2,28,3,2
4,300,300,25,25,0,1,0
27,328,328,108,47,61,3,2
6,333,333,10,10,0,1,0
3,338,338,15,15,0,1,0
28,378,378,16,1,15,4,3
25,399,399,12,6,6,2,1
7,411,411,48,48,0,1,0
15,430,430,25,25,0,1,0
18,438,438,10,2,8,3,2
2,454,454,14,14,0,1,0
12,471,471,17,17,0,1,0
17,475,475,17,17,0,1,0

2,101,101,1,1,0,1,0
16,122,122,40,9,31,4,3
5,167,167,2,2,0,1,0
10,172,172,3,3,0,1,0
3,184,184,26,4,22,3,2
9,190,190,25,11,14,3,2
18,193,193,28,28,0,1,0
12,195,195,9,9,0,1,0
0,240,240,25,25,0,1,0
15,243,243,18,18,0,1,0
1,279,279,19,10,9,2,1
4,301,301,11,11,0,1,0
14,381,381,127,115,12,2,1
19,394,394,23,16,7,2,1
8,406,406,54,45,9,2,1
17,442,442,26,1,25,4,3
6,449,449,119,119,0,1,0
13,468,468,24,18,6,3,2
11,484,484,6,6,0,1,0
7,500,500,100,100,0,1,0

13,101,101,8,4,4,2,1
18,116,116,6,6,0,1,0
12,170,170,10,10,0,1,0
17,181,181,54,23,31,2,1
7,200,200,1,1,0,1,0
1,229,229,71,13,58,3,2
6,272,272,38,5,33,4,3
10,297,297,48,48,0,1,0
16,309,309,16,3,13,2,1
19,334,334,20,13,7,2,1
14,337,337,103,19,84,3,2
0,341,341,71,71,0,1,0
2,352,352,20,8,12,2,1
4,355,355,43,21,22,3,2
15,410,410,14,14,0,1,0
8,411,411,28,11,17,2,1
3,425,425,10,10,0,1,0
9,442,442,36,2,34,2,1
5,448,448,39,17,22,2,1
11,468,468,11,8,3,2,1

3,103,103,21,11,10,3,2
14,105,105,30,30,0,1,0
18,124,124,6,6,0,1,0
10,143,143,24,24,0,1,0
13,157,157,6,6,0,1,0
4,159,159,1,1,0,1,0
1,165,165,16,16,0,1,0
5,172,172,1,1,0,1,0
0,178,178,15,11,4,2,1
19,185,185,36,13,23,2,1
6,209,209,48,48,0,1,0
15,267,267,6,6,0,1,0
21,339,339,4,1,3,2,1
7,343,343,12,12,0,1,0
8,359,359,19,19,0,1,0
2,376,376,7,7,0,1,0
9,407,407,23,23,0,1,0
11,414,414,59,34,25,2,1
20,415,415,32,22,10,2,1
16,466,466,162,41,121,4,3
12,492,492,39,3,36,2,1
17,495,495,7,7,0,1,0

13,112,112,4,4,0,1,0
9,116,116,26,26,0,1,0
16,123,123,2,2,0,1,0
6,146,146,4,4,0,1,0
12,168,168,1,1,0,1,0
4,172,172,11,11,0,1,0
7,211,211,6,6,0,1,0
14,211,211,6,1,5,2,1
2,223,223,31,7,24,3,2
20,229,229,22,13,9,4,3
5,235,235,13,7,6,2,1
21,244,244,24,24,0,1,0
23,253,253,28,28,0,1,0
10,256,256,16,16,0,1,0
11,296,296,40,7,33,4,3
15,297,297,31,31,0,1,0
1,346,346,26,6,20,4,3
0,418,418,29,29,0,1,0
18,425,425,110,59,51,4,3
19,441,441,139,139,0,1,0
3,445,445,44,44,0,1,0
8,480,480,39,31,8,2,1
17,483,483,32,32,0,1,0
22,488,488,14,4,10,4,3

6,100,100,1,1,0,1,0
15,106,106,16,4,12,3,2
14,168,168,8,8,0,1,0
18,178,178,23,23,0,1,0
12,194,194,18,18,0,1,0
2,196,196,3,3,0,1,0
0,212,212,9,9,0,1,0
10,215,215,1,1,0,1,0
3,224,224,2,2,0,1,0
9,228,228,1,1,0,1,0
16,290,290,9,2,7,2,1
21,314,314,40,40,0,1,0
20,319,319,43,3,40,3,2
19,344,344,4,4,0,1,0
4,349,349,40,40,0,1,0
23,351,351,7,7,0,1,0
1,356,356,38,38,0,1,0
11,377,377,1,1,0,1,0
22,411,411,95,24,71,4,3
8,444,444,85,67,18,4,3
24,460,460,34,25,9,4,3
17,460,460,94,19,75,4,3
7,464,464,8,8,0,1,0
13,480,480,101,2,99,4,3
5,486,486,113,113,0,1,0

6,136,136,6,6,0,1,0
5,144,144,18,18,0,1,0
7,161,161,21,21,0,1,0
18,171,171,45,23,22,3,2
3,184,184,12,12,0,1,0
20,187,187,9,3,6,3,2
16,209,209,43,15,28,3,2
11,224,224,30,30,0,1,0
0,237,237,24,24,0,1,0
17,292,292,10,4,6,3,2
8,293,293,18,18,0,1,0
10,314,314,49,12,37,2,1
9,320,320,59,42,17,2,1
19,336,336,41,1,40,3,2
4,337,337,14,14,0,1,0
13,394,394,73,73,0,1,0
2,403,403,2,2,0,1,0
1,424,424,23,23,0,1,0
14,443,443,11,4,7,2,1
12,454,454,51,9,42,4,3
21,460,460,11,11,0,1,0
15,490,490,47,29,18,3,2

7,144,144,40,40,0,1,0
12,155,155,2,2,0,1,0
18,206,206,6,1,5,2,1
16,263,263,50,50,0,1,0
14,271,271,20,20,0,1,0
5,274,274,1,1,0,1,0
13,286,286,49,34,15,2,1
6,339,339,11,1,10,2,1
0,347,347,10,6,4,2,1
1,358,358,8,1,7,2,1
17,397,397,4,1,3,2,1
2,411,411,58,51,7,2,1
10,418,418,5,5,0,1,0
8,420,420,47,47,0,1,0
19,420,420,74,45,29,2,1
15,444,444,83,75,8,2,1
4,445,445,97,97,0,1,0
11,485,485,122,122,0,1,0
9,487,487,79,66,13,2,1
3,492,492,51,9,42,2,1

6,107,107,9,3,6,2,1
2,111,111,1,1,0,1,0
1,162,162,19,19,0,1,0
16,192,192,1,1,0,1,0
10,218,218,16,2,14,2,1
7,259,259,65,65,0,1,0
19,259,259,60,60,0,1,0
18,264,264,9,9,0,1,0
17,269,269,7,7,0,1,0
15,342,342,49,49,0,1,0
9,357,357,5,5,0,1,0
12,359,359,25,25,0,1,0
23,365,365,23,7,16,2,1
3,369,369,4,1,3,2,1
4,387,387,10,10,0,1,0
11,388,388,28,10,18,4,3
14,390,390,143,101,42,4,3
20,406,406,28,28,0,1,0
22,426,426,72,36,36,4,3
5,452,452,16,4,12,2,1
21,457,457,1,1,0,1,0
8,458,458,22,22,0,1,0
13,465,465,121,71,50,2,1
0,489,489,15,15,0,1,0

3,106,106,3,3,0,1,0
7,113,113,4,4,0,1,0
15,114,114,20,20,0,1,0
21,138,138,1,1,0,1,0
8,149,149,5,5,0,1,0
18,171,171,8,1,7,2,1
19,192,192,6,6,0,1,0
20,197,197,43,43,0,1,0
9,224,224,5,5,0,1,0
14,249,249,20,5,15,2,1
11,265,265,6,6,0,1,0
5,286,286,32,20,12,2,1
23,288,288,31,31,0,1,0
6,294,294,6,6,0,1,0
10,301,301,66,66,0,1,0
2,308,308,47,47,0,1,0
12,315,315,52,29,23,2,1
1,358,358,1,1,0,1,0
16,384,384,28,2,26,2,1
0,411,411,7,7,0,1,0
17,433,433,117,88,29,2,1
4,460,460,111,59,52,3,2
13,473,473,13,2,11,2,1
22,494,494,54,28,26,3,2

21,126,126,32,32,0,1,0
18,159,159,5,5,0,1,0
12,175,175,21,21,0,1,0
15,193,193,10,6,4,2,1
6,222,222,6,6,0,1,0
4,234,234,1,1,0,1,0
2,239,239,33,1,32,2,1
1,264,264,3,3,0,1,0
10,264,264,14,14,0,1,0
20,269,269,21,21,0,1,0
0,272,272,30,13,17,2,1
16,272,272,99,99,0,1,0
13,279,279,15,15,0,1,0
9,315,315,7,7,0,1,0
14,340,340,44,44,0,1,0
8,356,356,90,81,9,2,1
22,374,374,38,8,30,3,2
7,386,386,10,10,0,1,0
3,389,389,45,45,0,1,0
17,406,406,9,3,6,2,1
19,428,428,17,6,11,2,1
11,459,459,34,34,0,1,0
5,475,475,69,6,63,4,3

6,117,117,3,3,0,1,0
9,134,134,5,2,3,2,1
10,139,139,8,8,0,1,0
20,147,147,8,3,5,2,1
8,151,151,4,4,0,1,0
4,157,157,27,27,0,1,0
1,166,166,11,11,0,1,0
18,187,187,42,14,28,4,3
7,209,209,49,34,15,4,3
15,235,235,32,27,5,2,1
11,239,239,36,36,0,1,0
16,274,274,59,59,0,1,0
14,292,292,5,1,4,2,1
5,339,339,70,64,6,3,2
13,340,340,8,2,6,3,2
3,341,341,18,11,7,2,1
17,356,356,8,3,5,2,1
0,362,362,8,1,7,2,1
2,437,437,22,22,0,1,0
21,445,445,12,12,0,1,0
19,463,463,153,97,56,4,3
12,499,499,33,33,0,1,0

1,104,104,8,8,0,1,0
12,110,110,6,3,3,2,1
6,123,123,7,7,0,1,0
8,130,130,1,1,0,1,0
3,173,173,11,3,8,3,2
2,187,187,24,24,0,1,0
14,199,199,30,17,13,2,1
0,229,229,71,71,0,1,0
13,245,245,4,4,0,1,0
11,285,285,46,46,0,1,0
4,301,301,127,127,0,1,0
16,316,316,90,47,43,2,1
15,330,330,28,13,15,2,1
5,379,379,13,7,6,2,1
18,415,415,22,6,16,2,1
17,441,441,21,9,12,2,1
7,483,483,3,3,0,1,0
10,488,488,101,80,21,4,3
9,497,497,28,28,0,1,0

16,103,103,3,3,0,1,0
8,143,143,7,7,0,1,0
6,143,143,45,45,0,1,0
9,149,149,6,6,0,1,0
17,188,188,7,2,5,2,1
11,264,264,92,56,36,2,1
13,304,304,14,14,0,1,0
3,328,328,31,31,0,1,0
2,348,348,30,30,0,1,0
18,351,351,7,7,0,1,0
5,359,359,32,15,17,2,1
15,364,364,110,38,72,4,3
14,372,372,18,9,9,4,3
10,377,377,11,11,0,1,0
4,388,388,12,8,4,2,1
1,391,391,62,2,60,4,3
12,416,416,94,31,63,3,2
7,454,454,25,25,0,1,0
0,462,462,103,76,27,2,1

0,102,102,7,7,0,1,0
13,105,105,1,1,0,1,0
4,113,113,1,1,0,1,0
9,123,123,21,21,0,1,0
16,130,130,16,16,0,1,0
1,132,132,17,17,0,1,0
20,135,135,4,4,0,1,0
5,152,152,24,24,0,1,0
18,231,231,51,51,0,1,0
3,302,302,52,52,0,1,0
15,308,308,62,62,0,1,0
21,317,317,2,2,0,1,0
11,320,320,37,37,0,1,0
7,330,330,12,2,10,2,1
19,335,335,36,36,0,1,0
12,345,345,11,11,0,1,0
8,375,375,41,41,0,1,0
17,389,389,125,56,69,4,3
14,428,428,31,11,20,3,2
6,437,437,4,1,3,2,1
2,479,479,3,3,0,1,0
10,489,489,58,22,36,2,1

9,110,110,3,3,0,1,0
6,125,125,1,1,0,1,0
7,128,128,24,8,16,2,1
12,143,143,37,3,34,3,2
1,151,151,2,2,0,1,0
3,188,188,12,6,6,3,2
8,211,211,19,7,12,2,1
10,263,263,19,19,0,1,0
15,327,327,26,26,0,1,0
17,330,330,30,30,0,1,0
0,343,343,218,162,56,3,2
11,377,377,47,47,0,1,0
13,378,378,40,40,0,1,0
2,400,400,44,15,29,2,1
14,422,422,3,3,0,1,0
16,462,462,122,5,117,4,3
5,466,466,6,6,0,1,0
4,469,469,33,29,4,2,1

19,123,123,6,1,5,2,1
4,126,126,30,30,0,1,0
11,133,133,24,16,8,3,2
12,155,155,4,4,0,1,0
17,192,192,15,15,0,1,0
13,210,210,29,29,0,1,0
18,305,305,31,31,0,1,0
5,312,312,39,18,21,4,3
10,325,325,20,4,16,3,2
2,336,336,4,4,0,1,0
6,341,341,1,1,0,1,0
15,369,369,89,70,19,2,1
7,369,369,127,78,49,2,1
9,396,396,10,10,0,1,0
14,409,409,13,13,0,1,0
1,428,428,47,47,0,1,0
16,434,434,91,91,0,1,0
0,469,469,15,9,6,2,1
8,473,473,57,30,27,2,1
3,497,497,46,15,31,2,1

5,128,128,15,9,6,3,2
21,141,141,2,2,0,1,0
8,159,159,34,34,0,1,0
17,159,159,4,4,0,1,0
4,172,172,4,4,0,1,0
15,215,215,37,37,0,1,0
10,220,220,35,35,0,1,0
2,227,227,53,53,0,1,0
6,228,228,15,15,0,1,0
3,229,229,9,9,0,1,0
16,262,262,15,15,0,1,0
20,271,271,7,7,0,1,0
18,273,273,50,40,10,2,1
14,288,288,92,17,75,4,3
12,335,335,19,19,0,1,0
7,341,341,21,21,0,1,0
9,348,348,2,2,0,1,0
0,349,349,20,4,16,3,2
1,371,371,20,20,0,1,0
11,380,380,27,27,0,1,0
19,435,435,35,7,28,2,1
13,472,472,84,47,37,2,1

10,104,104,5,5,0,1,0
4,152,152,2,2,0,1,0
0,213,213,49,11,38,3,2
11,214,214,4,1,3,2,1
7,221,221,30,12,18,4,3
8,225,225,15,12,3,2,1
1,255,255,37,37,0,1,0
16,259,259,21,5,16,2,1
12,265,265,40,40,0,1,0
2,281,281,19,1,18,4,3
3,296,296,38,34,4,2,1
19,297,297,31,24,7,2,1
13,317,317,94,90,4,2,1
9,369,369,57,57,0,1,0
6,383,383,2,2,0,1,0
17,439,439,81,45,36,4,3
15,448,448,48,48,0,1,0
14,456,456,54,12,42,3,2
5,459,459,71,11,60,4,3
18,484,484,4,1,3,2,1

5,120,120,11,11,0,1,0
2,125,125,8,8,0,1,0
10,127,127,5,5,0,1,0
24,136,136,13,13,0,1,0
9,160,160,2,2,0,1,0
11,179,179,8,2,6,2,1
23,187,187,7,7,0,1,0
14,244,244,31,28,3,2,1
6,260,260,14,14,0,1,0
18,271,271,19,6,13,2,1
19,289,289,4,4,0,1,0
4,291,291,1,1,0,1,0
0,305,305,27,27,0,1,0
8,329,329,38,4,34,4,3
17,337,337,35,35,0,1,0
1,342,342,13,13,0,1,0
13,377,377,16,16,0,1,0
21,400,400,19,19,0,1,0
22,402,402,105,97,8,3,2
3,406,406,55,55,0,1,0
15,445,445,8,2,6,3,2
7,463,463,36,36,0,1,0
20,466,466,93,75,18,4,3
12,485,485,82,82,0,1,0
16,497,497,137,137,0,1,0

4,105,105,1,1,0,1,0
11,119,119,9,9,0,1,0
15,125,125,2,2,0,1,0
1,126,126,1,1,0,1,0
0,147,147,35,8,27,4,3
13,183,183,7,7,0,1,0
5,254,254,8,2,6,3,2
16,283,283,75,75,0,1,0
12,321,321,27,27,0,1,0
8,326,326,54,54,0,1,0
20,340,340,92,65,27,4,3
14,359,359,30,16,14,2,1
7,375,375,94,16,78,3,2
19,387,387,5,2,3,2,1
2,393,393,53,27,26,4,3
17,396,396,82,22,60,3,2
9,401,401,7,7,0,1,0
6,422,422,3,3,0,1,0
21,427,427,10,3,7,2,1
3,440,440,13,1,12,3,2
18,442,442,52,31,21,4,3
10,454,454,63,21,42,4,3

14,117,117,19,9,10,2,1
9,126,126,12,12,0,1,0
3,185,185,1,1,0,1,0
15,194,194,3,3,0,1,0
8,197,197,1,1,0,1,0
18,227,227,6,6,0,1,0
21,235,235,4,4,0,1,0
5,237,237,23,11,12,2,1
24,242,242,18,15,3,2,1
6,264,264,47,47,0,1,0
10,279,279,6,3,3,2,1
7,311,311,3,3,0,1,0
1,336,336,12,2,10,2,1
2,370,370,8,4,4,2,1
16,373,373,11,1,10,2,1
13,375,375,20,20,0,1,0
4,380,380,7,2,5,2,1
23,392,392,151,151,0,1,0
11,417,417,66,40,26,3,2
0,421,421,53,53,0,1,0
19,426,426,29,29,0,1,0
20,460,460,67,47,20,2,1
17,467,467,10,10,0,1,0
22,491,491,165,165,0,1,0
12,497,497,59,31,28,3,2

7,140,140,35,6,29,4,3
6,176,176,58,58,0,1,0
4,177,177,29,29,0,1,0
10,237,237,14,8,6,3,2
2,256,256,7,7,0,1,0
5,257,257,19,19,0,1,0
12,269,269,80,80,0,1,0
14,286,286,7,1,6,2,1
9,294,294,3,3,0,1,0
0,299,299,53,2,51,4,3
11,385,385,4,4,0,1,0
16,420,420,75,75,0,1,0
13,435,435,33,13,20,3,2
3,437,437,18,3,15,2,1
15,440,440,15,15,0,1,0
1,449,449,19,19,0,1,0
8,453,453,92,32,60,4,3
17,481,481,106,51,55,4,3

12,139,139,10,10,0,1,0
6,150,150,3,3,0,1,0
1,150,150,21,8,13,2,1
7,169,169,50,50,0,1,0
14,181,181,8,8,0,1,0
8,189,189,7,7,0,1,0
5,202,202,53,12,41,2,1
17,220,220,6,2,4,2,1
2,238,238,40,17,23,2,1
0,245,245,13,13,0,1,0
9,248,248,101,83,18,2,1
10,283,283,7,7,0,1,0
4,363,363,32,9,23,2,1
3,374,374,28,7,21,2,1
15,416,416,39,6,33,4,3
16,428,428,82,7,75,4,3
13,445,445,12,6,6,2,1
11,484,484,94,78,16,2,1

16,106,106,15,3,12,3,2
4,117,117,12,12,0,1,0
11,162,162,22,6,16,3,2
1,163,163,41,41,0,1,0
17,257,257,49,7,42,3,2
10,272,272,15,15,0,1,0
6,306,306,4,4,0,1,0
9,310,310,56,16,40,3,2
3,310,310,22,10,12,4,3
12,371,371,29,29,0,1,0
13,373,373,27,15,12,2,1
14,376,376,13,7,6,3,2
15,380,380,81,81,0,1,0
8,385,385,9,9,0,1,0
0,402,402,126,117,9,4,3
7,425,425,21,14,7,2,1
5,461,461,9,1,8,2,1
2,492,492,138,97,41,2,1

6,103,103,19,19,0,1,0
10,117,117,8,8,0,1,0
19,126,126,7,7,0,1,0
9,126,126,4,1,3,2,1
4,137,137,49,15,34,3,2
3,145,145,1,1,0,1,0
8,153,153,1,1,0,1,0
16,159,159,26,6,20,3,2
2,185,185,9,3,6,2,1
11,187,187,33,29,4,2,1
13,248,248,20,10,10,3,2
12,297,297,7,7,0,1,0
7,332,332,81,31,50,3,2
17,337,337,110,110,0,1,0
15,390,390,7,1,6,2,1
14,404,404,8,8,0,1,0
18,436,436,84,26,58,4,3
5,446,446,3,3,0,1,0
0,471,471,29,29,0,1,0
1,500,500,76,76,0,1,0

7,100,100,3,3,0,1,0
23,138,138,3,3,0,1,0
1,141,141,14,14,0,1,0
14,165,165,4,4,0,1,0
9,166,166,3,3,0,1,0
13,175,175,2,2,0,1,0
16,185,185,23,23,0,1,0
11,185,185,10,10,0,1,0
6,192,192,36,36,0,1,0
24,195,195,55,4,51,4,3
10,212,212,1,1,0,1,0
20,226,226,5,5,0,1,0
4,244,244,2,2,0,1,0
19,278,278,91,77,14,2,1
3,289,289,1,1,0,1,0
5,300,300,3,3,0,1,0
0,302,302,52,14,38,2,1
8,307,307,7,7,0,1,0
17,338,338,13,13,0,1,0
21,347,347,6,6,0,1,0
22,380,380,1,1,0,1,0
12,405,405,19,19,0,1,0
18,417,417,23,17,6,3,2
25,448,448,102,102,0,1,0
2,493,493,120,50,70,4,3
15,495,495,82,82,0,1,0

13,152,152,19,19,0,1,0
19,164,164,34,3,31,2,1
9,175,175,3,3,0,1,0
23,201,201,21,21,0,1,0
10,225,225,3,3,0,1,0
2,242,242,19,1,18,3,2
12,260,260,44,37,7,2,1
1,287,287,21,2,19,2,1
16,287,287,10,10,0,1,0
4,294,294,30,18,12,4,3
15,295,295,38,7,31,2,1
0,297,297,96,56,40,2,1
14,301,301,25,25,0,1,0
11,326,326,12,12,0,1,0
5,334,334,1,1,0,1,0
20,374,374,4,1,3,2,1
7,377,377,1,1,0,1,0
18,387,387,6,6,0,1,0
21,405,405,101,29,72,4,3
17,408,408,54,54,0,1,0
8,435,435,23,14,9,4,3
3,471,471,1,1,0,1,0
6,492,492,51,45,6,3,2
22,492,492,76,76,0,1,0

13,106,106,3,3,0,1,0
6,142,142,6,6,0,1,0
16,152,152,4,4,0,1,0
0,177,177,19,19,0,1,0
20,193,193,60,60,0,1,0
14,209,209,20,20,0,1,0
5,253,253,18,3,15,2,1
1,268,268,2,2,0,1,0
7,271,271,16,7,9,2,1
8,272,272,94,74,20,2,1
19,307,307,50,50,0,1,0
17,310,310,51,9,42,4,3
2,330,330,23,1,22,2,1
11,343,343,27,3,24,4,3
10,352,352,51,51,0,1,0
18,371,371,18,18,0,1,0
3,373,373,56,8,48,2,1
9,380,380,11,5,6,2,1
15,466,466,28,8,20,2,1
12,469,469,69,25,44,3,2
4,497,497,37,15,22,2,1

3,101,101,1,1,0,1,0
9,108,108,2,2,0,1,0
18,112,112,13,13,0,1,0
6,119,119,8,4,4,2,1
14,121,121,7,2,5,2,1
0,134,134,13,13,0,1,0
1,154,154,17,17,0,1,0
8,157,157,9,1,8,3,2
22,263,263,28,28,0,1,0
23,279,279,29,1,28,3,2
20,306,306,43,43,0,1,0
12,321,321,12,3,9,2,1
5,327,327,4,1,3,2,1
2,331,331,25,25,0,1,0
13,359,359,127,84,43,4,3
10,363,363,6,6,0,1,0
19,373,373,20,2,18,2,1
17,384,384,5,1,4,2,1
15,388,388,39,39,0,1,0
11,415,415,11,5,6,2,1
7,420,420,75,33,42,4,3
21,437,437,182,32,150,4,3
4,480,480,19,19,0,1,0
16,492,492,11,4,7,2,1

1,125,125,1,1,0,1,0
0,128,128,2,2,0,1,0
16,143,143,3,3,0,1,0
9,159,159,1,1,0,1,0
8,160,160,2,2,0,1,0
4,205,205,48,48,0,1,0
2,220,220,4,1,3,2,1
26,226,226,14,3,11,2,1
22,228,228,11,11,0,1,0
27,234,234,19,7,12,4,3
13,245,245,6,6,0,1,0
7,257,257,3,3,0,1,0
17,266,266,43,43,0,1,0
18,278,278,132,95,37,2,1
10,287,287,32,7,25,2,1
11,288,288,10,10,0,1,0
21,297,297,5,5,0,1,0
3,313,313,18,18,0,1,0
12,357,357,2,2,0,1,0
15,369,369,12,12,0,1,0
14,400,400,5,2,3,2,1
20,411,411,63,7,56,4,3
6,415,415,72,14,58,3,2
25,417,417,28,7,21,2,1
5,427,427,68,4,64,3,2
19,436,436,14,5,9,4,3
23,439,439,36,18,18,2,1
24,491,491,48,15,33,3,2

16,115,115,21,21,0,1,0
25,155,155,20,20,0,1,0
4,156,156,11,3,8,2,1
8,165,165,8,8,0,1,0
19,213,213,6,6,0,1,0
23,238,238,24,24,0,1,0
21,245,245,12,2,10,2,1
22,258,258,20,20,0,1,0
20,292,292,1,1,0,1,0
6,302,302,36,24,12,2,1
26,303,303,92,92,0,1,0
5,311,311,16,16,0,1,0
1,322,322,4,4,0,1,0
13,328,328,6,6,0,1,0
14,345,345,39,39,0,1,0
3,347,347,20,20,0,1,0
18,377,377,72,72,0,1,0
15,388,388,18,10,8,3,2
9,390,390,26,26,0,1,0
10,393,393,9,9,0,1,0
12,395,395,21,7,14,2,1
11,407,407,31,31,0,1,0
7,418,418,32,25,7,2,1
17,423,423,3,3,0,1,0
2,428,428,37,37,0,1,0
24,485,485,111,99,12,3,2
0,493,493,3,3,0,1,0

11,106,106,3,3,0,1,0
18,109,109,9,3,6,2,1
21,112,112,14,14,0,1,0
20,131,131,20,20,0,1,0
24,133,133,12,12,0,1,0
10,139,139,15,15,0,1,0
4,148,148,12,12,0,1,0
23,163,163,28,28,0,1,0
1,194,194,19,4,15,2,1
5,198,198,15,8,7,2,1
19,199,199,12,12,0,1,0
17,199,199,7,1,6,2,1
16,201,201,43,4,39,2,1
7,254,254,23,12,11,3,2
3,263,263,14,2,12,3,2
22,327,327,6,6,0,1,0
2,335,335,1,1,0,1,0
15,363,363,68,68,0,1,0
9,406,406,46,6,40,3,2
6,408,408,116,26,90,4,3
8,445,445,33,2,31,2,1
14,447,447,3,3,0,1,0
0,461,461,2,2,0,1,0
13,474,474,13,1,12,3,2
12,491,491,26,26,0,1,0

10,114,114,18,10,8,2,1
22,130,130,9,3,6,3,2
9,145,145,6,6,0,1,0
21,148,148,38,30,8,2,1
19,166,166,4,1,3,2,1
8,172,172,2,2,0,1,0
15,202,202,60,60,0,1,0
13,212,212,19,3,16,4,3
18,219,219,4,4,0,1,0
7,230,230,49,49,0,1,0
16,241,241,50,50,0,1,0
20,242,242,28,28,0,1,0
6,265,265,8,8,0,1,0
3,287,287,40,22,18,3,2
4,305,305,24,24,0,1,0
11,308,308,3,3,0,1,0
12,313,313,31,22,9,4,3
5,417,417,15,12,3,2,1
2,426,426,39,39,0,1,0
17,431,431,4,4,0,1,0
14,435,435,14,14,0,1,0
1,472,472,8,8,0,1,0
0,498,498,87,36,51,3,2

7,102,102,10,2,8,2,1
16,124,124,14,14,0,1,0
15,124,124,48,18,30,4,3
1,125,125,4,1,3,2,1
18,190,190,31,31,0,1,0
17,198,198,1,1,0,1,0
3,202,202,1,1,0,1,0
10,213,213,5,2,3,2,1
6,214,214,3,3,0,1,0
5,228,228,10,10,0,1,0
2,256,256,7,7,0,1,0
14,299,299,11,11,0,1,0
8,303,303,202,202,0,1,0
12,317,317,35,2,33,2,1
9,358,358,13,1,12,4,3
13,373,373,52,21,31,4,3
11,422,422,46,46,0,1,0
0,440,440,82,82,0,1,0
4,444,444,13,13,0,1,0

5,105,105,46,46,0,1,0
10,154,154,5,5,0,1,0
6,160,160,4,4,0,1,0
7,201,201,21,2,19,2,1
8,201,201,33,3,30,3,2
2,222,222,13,1,12,3,2
4,245,245,25,17,8,2,1
0,265,265,56,24,32,3,2
15,333,333,91,31,60,4,3
3,340,340,49,49,0,1,0
9,368,368,24,24,0,1,0
14,377,377,22,22,0,1,0
13,382,382,26,4,22,2,1
12,409,409,52,52,0,1,0
11,471,471,94,94,0,1,0
1,474,474,72,31,41,4,3

20,128,128,2,2,0,1,0
16,143,143,25,25,0,1,0
12,219,219,27,12,15,2,1
6,249,249,9,9,0,1,0
14,270,270,12,6,6,2,1
3,295,295,49,7,42,4,3
10,308,308,32,14,18,4,3
19,323,323,1,1,0,1,0
15,344,344,52,52,0,1,0
1,345,345,14,10,4,2,1
17,351,351,64,4,60,3,2
4,366,366,53,11,42,2,1
0,374,374,23,2,21,4,3
13,375,375,89,89,0,1,0
8,380,380,28,10,18,3,2
9,390,390,42,26,16,2,1
11,432,432,62,8,54,4,3
21,442,442,52,16,36,2,1
2,457,457,17,17,0,1,0
5,459,459,31,2,29,2,1
18,461,461,28,6,22,3,2
7,477,477,57,22,35,2,1

16,146,146,4,4,0,1,0
8,155,155,14,14,0,1,0
12,165,165,56,42,14,3,2
3,170,170,3,3,0,1,0
9,196,196,9,9,0,1,0
11,207,207,28,28,0,1,0
6,276,276,26,26,0,1,0
17,348,348,121,10,111,4,3
5,357,357,57,57,0,1,0
10,369,369,16,5,11,3,2
0,369,369,1,1,0,1,0
13,373,373,15,9,6,3,2
2,384,384,115,67,48,4,3
7,398,398,167,167,0,1,0
15,403,403,14,2,12,4,3
14,437,437,7,7,0,1,0
4,456,456,24,9,15,4,3
1,478,478,27,27,0,1,0

1,100,100,29,29,0,1,0
6,111,111,20,14,6,2,1
4,115,115,35,35,0,1,0
13,137,137,19,7,12,2,1
9,143,143,7,1,6,3,2
7,145,145,14,14,0,1,0
12,148,148,10,2,8,3,2
10,247,247,12,12,0,1,0
3,317,317,56,22,34,4,3
5,332,332,7,7,0,1,0
14,338,338,147,114,33,4,3
0,380,380,67,67,0,1,0
2,382,382,60,22,38,3,2
8,394,394,31,11,20,2,1
11,475,475,2,2,0,1,0

2,121,121,13,13,0,1,0
20,143,143,3,3,0,1,0
12,159,159,56,56,0,1,0
6,165,165,15,1,14,3,2
15,169,169,15,15,0,1,0
11,176,176,2,2,0,1,0
19,210,210,65,18,47,3,2
5,211,211,36,36,0,1,0
8,248,248,17,17,0,1,0
14,284,284,41,13,28,3,2
13,312,312,11,8,3,2,1
10,314,314,17,17,0,1,0
1,389,389,17,12,5,2,1
4,392,392,43,43,0,1,0
18,400,400,7,7,0,1,0
17,429,429,16,16,0,1,0
9,438,438,145,145,0,1,0
3,443,443,22,13,9,4,3
7,444,444,9,9,0,1,0
0,460,460,25,25,0,1,0
16,476,476,50,50,0,1,0

14,102,102,2,2,0,1,0
10,114,114,3,3,0,1,0
4,120,120,8,8,0,1,0
7,139,139,21,21,0,1,0
16,145,145,19,19,0,1,0
18,156,156,27,27,0,1,0
12,209,209,1,1,0,1,0
0,214,214,66,66,0,1,0
5,220,220,1,1,0,1,0
19,234,234,13,4,9,2,1
21,304,304,36,36,0,1,0
22,311,311,30,30,0,1,0
8,318,318,32,5,27,3,2
1,330,330,52,2,50,3,2
9,356,356,9,9,0,1,0
13,366,366,16,5,11,2,1
2,372,372,25,13,12,4,3
11,423,423,67,67,0,1,0
3,434,434,9,4,5,2,1
15,445,445,48,48,0,1,0
6,456,456,5,1,4,2,1
20,479,479,53,23,30,2,1
17,490,490,131,44,87,4,3

13,135,135,21,1,20,3,2
24,191,191,7,7,0,1,0
6,196,196,15,10,5,2,1
22,199,199,9,4,5,2,1
12,218,218,18,18,0,1,0
3,241,241,11,4,7,2,1
18,267,267,160,74,86,3,2
17,276,276,23,4,19,3,2
5,277,277,38,23,15,2,1
0,279,279,5,2,3,2,1
10,280,280,20,3,17,4,3
4,291,291,38,38,0,1,0
23,344,344,50,50,0,1,0
9,345,345,20,11,9,2,1
19,350,350,16,7,9,4,3
11,352,352,8,8,0,1,0
2,362,362,32,32,0,1,0
7,383,383,1,1,0,1,0
20,387,387,16,16,0,1,0
14,389,389,45,45,0,1,0
25,398,398,11,11,0,1,0
21,423,423,12,2,10,2,1
16,443,443,28,1,27,4,3
8,444,444,8,1,7,2,1
15,451,451,1,1,0,1,0
1,482,482,37,17,20,3,2

4,105,105,42,11,31,2,1
22,118,118,3,3,0,1,0
5,121,121,4,1,3,2,1
23,123,123,2,2,0,1,0
19,125,125,11,11,0,1,0
21,154,154,2,2,0,1,0
1,174,174,9,9,0,1,0
24,184,184,37,5,32,3,2
12,209,209,7,7,0,1,0
25,235,235,14,2,12,4,3
17,263,263,4,4,0,1,0
6,273,273,12,12,0,1,0
18,274,274,38,11,27,4,3
8,291,291,11,1,10,3,2
20,308,308,19,1,18,2,1
16,338,338,4,4,0,1,0
2,353,353,7,7,0,1,0
0,367,367,3,3,0,1,0
13,379,379,42,42,0,1,0
3,380,380,49,4,45,4,3
9,382,382,4,4,0,1,0
11,390,390,15,8,7,2,1
7,390,390,15,1,14,3,2
27,418,418,187,187,0,1,0
26,421,421,32,32,0,1,0
15,442,442,33,11,22,3,2
10,460,460,16,12,4,2,1
14,473,473,5,2,3,2,1

0,105,105,13,13,0,1,0
7,133,133,4,4,0,1,0
15,140,140,33,33,0,1,0
12,161,161,24,24,0,1,0
11,178,178,6,6,0,1,0
10,196,196,2,2,0,1,0
17,306,306,102,54,48,4,3
4,307,307,125,20,105,4,3
8,317,317,2,2,0,1,0
2,358,358,48,27,21,4,3
3,391,391,1,1,0,1,0
13,399,399,14,2,12,3,2
16,425,425,100,55,45,4,3
6,427,427,35,35,0,1,0
5,439,439,112,46,66,4,3
1,465,465,32,11,21,2,1
9,478,478,35,35,0,1,0
14,497,497,6,6,0,1,0

14,137,137,11,11,0,1,0
6,159,159,1,1,0,1,0
8,178,178,12,12,0,1,0
9,189,189,16,16,0,1,0
12,226,226,59,48,11,2,1
10,228,228,9,3,6,2,1
15,230,230,35,32,3,2,1
7,243,243,8,8,0,1,0
16,250,250,11,11,0,1,0
0,281,281,31,31,0,1,0
5,324,324,23,14,9,4,3
11,331,331,75,75,0,1,0
19,350,350,19,19,0,1,0
3,355,355,16,4,12,3,2
4,367,367,28,21,7,2,1
1,403,403,58,58,0,1,0
17,406,406,34,22,12,3,2
2,412,412,82,3,79,4,3
13,460,460,101,37,64,3,2
21,462,462,53,22,31,4,3
18,465,465,1,1,0,1,0
20,483,483,49,43,6,3,2

17,109,109,13,13,0,1,0
4,142,142,3,3,0,1,0
11,147,147,11,1,10,3,2
5,169,169,4,4,0,1,0
15,171,171,54,54,0,1,0
10,176,176,15,15,0,1,0
20,191,191,2,2,0,1,0
1,204,204,30,26,4,2,1
6,238,238,1,1,0,1,0
12,245,245,33,33,0,1,0
3,293,293,18,12,6,3,2
2,315,315,2,2,0,1,0
0,331,331,19,14,5,2,1
16,347,347,21,21,0,1,0
18,349,349,49,12,37,2,1
13,365,365,96,80,16,2,1
8,408,408,24,24,0,1,0
21,410,410,66,51,15,2,1
14,441,441,19,9,10,2,1
19,444,444,5,5,0,1,0
24,450,450,4,4,0,1,0
23,454,454,129,129,0,1,0
9,477,477,5,5,0,1,0
22,480,480,3,3,0,1,0
7,486,486,53,32,21,4,3

2,123,123,10,1,9,2,1
16,134,134,25,13,12,4,3
6,137,137,3,3,0,1,0
12,196,196,22,7,15,2,1
5,198,198,7,7,0,1,0
8,208,208,41,41,0,1,0
14,237,237,13,1,12,4,3
20,246,246,3,3,0,1,0
9,256,256,38,38,0,1,0
10,281,281,36,16,20,2,1
18,305,305,1,1,0,1,0
11,346,346,86,74,12,3,2
3,368,368,30,30,0,1,0
1,368,368,109,57,52,4,3
13,374,374,29,29,0,1,0
17,385,385,34,13,21,4,3
0,389,389,18,6,12,4,3
15,406,406,134,68,66,4,3
4,426,426,7,7,0,1,0
19,427,427,1,1,0,1,0
7,475,475,23,23,0,1,0

15,148,148,11,11,0,1,0
23,164,164,34,34,0,1,0
2,169,169,8,8,0,1,0
0,218,218,5,1,4,2,1
1,220,220,1,1,0,1,0
20,257,257,83,77,6,2,1
6,274,274,16,16,0,1,0
4,294,294,5,1,4,2,1
14,302,302,11,4,7,2,1
16,309,309,15,15,0,1,0
10,328,328,10,10,0,1,0
7,338,338,1,1,0,1,0
3,349,349,66,34,32,3,2
22,352,352,30,30,0,1,0
24,366,366,38,17,21,2,1
18,368,368,49,49,0,1,0
5,376,376,21,2,19,2,1
19,378,378,25,15,10,2,1
8,381,381,10,6,4,2,1
9,382,382,62,40,22,3,2
21,394,394,15,15,0,1,0
11,434,434,143,113,30,4,3
13,460,460,33,5,28,2,1
17,477,477,15,3,12,4,3
12,497,497,24,6,18,2,1

27,129,129,9,9,0,1,0
25,144,144,10,10,0,1,0
23,144,144,7,2,5,2,1
8,176,176,28,28,0,1,0
14,185,185,12,12,0,1,0
17,204,204,4,4,0,1,0
19,208,208,49,49,0,1,0
15,211,211,24,24,0,1,0
10,222,222,23,23,0,1,0
3,226,226,9,9,0,1,0
21,233,233,85,75,10,2,1
7,246,246,3,3,0,1,0
28,255,255,1,1,0,1,0
13,269,269,33,33,0,1,0
18,294,294,10,10,0,1,0
0,323,323,16,16,0,1,0
1,330,330,23,23,0,1,0
4,358,358,3,3,0,1,0
22,375,375,77,35,42,2,1
24,402,402,16,10,6,3,2
2,406,406,2,2,0,1,0
20,422,422,21,21,0,1,0
11,442,442,29,29,0,1,0
26,448,448,17,14,3,2,1
6,459,459,18,18,0,1,0
5,463,463,3,3,0,1,0
12,464,464,21,21,0,1,0
9,464,464,63,32,31,2,1
16,474,474,3,3,0,1,0

0,118,118,13,4,9,4,3
11,145,145,26,6,20,3,2
16,180,180,47,47,0,1,0
10,185,185,11,11,0,1,0
7,212,212,20,5,15,2,1
17,229,229,55,55,0,1,0
9,255,255,52,20,32,3,2
3,266,266,12,2,10,2,1
12,304,304,25,25,0,1,0
15,310,310,6,2,4,2,1
4,330,330,27,27,0,1,0
13,348,348,7,1,6,3,2
8,358,358,19,10,9,4,3
2,379,379,24,12,12,4,3
5,413,413,22,22,0,1,0
6,426,426,121,11,110,4,3
14,443,443,1,1,0,1,0
1,456,456,168,91,77,4,3

20,139,139,9,9,0,1,0
6,163,163,6,2,4,2,1
15,178,178,37,17,20,3,2
0,216,216,35,35,0,1,0
10,219,219,12,2,10,2,1
7,225,225,23,6,17,2,1
13,228,228,73,6,67,4,3
5,235,235,3,3,0,1,0
3,247,247,69,69,0,1,0
12,247,247,9,9,0,1,0
17,256,256,10,4,6,2,1
16,258,258,24,4,20,3,2
14,305,305,17,5,12,4,3
18,390,390,36,6,30,4,3
8,402,402,2,2,0,1,0
1,410,410,82,82,0,1,0
9,419,419,2,2,0,1,0
21,422,422,71,71,0,1,0
2,437,437,50,50,0,1,0
4,440,440,1,1,0,1,0
19,489,489,17,3,14,3,2
11,498,498,63,32,31,2,1

4,162,162,33,33,0,1,0
3,172,172,1,1,0,1,0
18,214,214,3,3,0,1,0
0,218,218,3,3,0,1,0
11,252,252,19,10,9,4,3
10,273,273,19,6,13,2,1
15,286,286,9,9,0,1,0
9,291,291,1,1,0,1,0
17,332,332,8,8,0,1,0
21,339,339,118,87,31,4,3
12,340,340,46,46,0,1,0
13,355,355,64,30,34,3,2
6,366,366,90,72,18,3,2
2,374,374,37,37,0,1,0
22,381,381,126,126,0,1,0
7,391,391,6,6,0,1,0
1,394,394,4,4,0,1,0
16,406,406,21,21,0,1,0
23,422,422,35,35,0,1,0
8,422,422,3,3,0,1,0
24,430,430,14,9,5,2,1
14,446,446,1,1,0,1,0
25,470,470,39,6,33,2,1
19,477,477,53,53,0,1,0
5,483,483,1,1,0,1,0
20,493,493,17,9,8,3,2

8,100,100,22,22,0,1,0
14,113,113,1,1,0,1,0
7,115,115,16,10,6,3,2
20,126,126,23,5,18,2,1
13,152,152,24,6,18,2,1
2,155,155,5,5,0,1,0
4,171,171,8,3,5,2,1
23,199,199,14,2,12,4,3
1,215,215,19,19,0,1,0
11,217,217,2,2,0,1,0
0,258,258,1,1,0,1,0
9,277,277,1,1,0,1,0
3,277,277,27,27,0,1,0
10,282,282,23,23,0,1,0
22,285,285,13,4,9,2,1
18,312,312,30,10,20,2,1
15,342,342,1,1,0,1,0
25,344,344,11,11,0,1,0
24,347,347,53,5,48,2,1
5,355,355,28,28,0,1,0
17,387,387,147,147,0,1,0
21,416,416,10,10,0,1,0
16,418,418,8,2,6,2,1
12,438,438,10,6,4,2,1
19,440,440,31,31,0,1,0
6,446,446,39,7,32,3,2
26,463,463,27,27,0,1,0

19,106,106,14,14,0,1,0
8,146,146,16,16,0,1,0
0,150,150,10,10,0,1,0
5,171,171,3,3,0,1,0
20,200,200,6,6,0,1,0
10,205,205,64,64,0,1,0
4,209,209,2,2,0,1,0
24,225,225,11,11,0,1,0
23,229,229,47,3,44,3,2
11,242,242,6,6,0,1,0
6,255,255,25,25,0,1,0
25,257,257,8,8,0,1,0
9,270,270,12,12,0,1,0
2,279,279,8,8,0,1,0
21,280,280,25,25,0,1,0
7,282,282,4,1,3,2,1
17,294,294,56,56,0,1,0
16,333,333,29,6,23,3,2
12,342,342,1,1,0,1,0
13,369,369,12,12,0,1,0
14,397,397,91,91,0,1,0
18,409,409,52,52,0,1,0
1,427,427,10,10,0,1,0
22,427,427,77,59,18,4,3
15,434,434,22,22,0,1,0
3,471,471,17,17,0,1,0

5,179,179,1,1,0,1,0
12,210,210,5,5,0,1,0
10,211,211,20,20,0,1,0
18,252,252,49,3,46,3,2
7,267,267,1,1,0,1,0
14,269,269,42,7,35,2,1
16,312,312,67,45,22,2,1
0,312,312,7,1,6,3,2
13,361,361,28,14,14,3,2
15,366,366,12,2,10,2,1
11,371,371,24,15,9,4,3
1,373,373,18,13,5,2,1
8,383,383,223,147,76,4,3
6,420,420,89,34,55,4,3
2,423,423,5,1,4,2,1
4,430,430,10,10,0,1,0
19,458,458,97,97,0,1,0
17,465,465,22,22,0,1,0
3,469,469,71,65,6,3,2
9,496,496,20,4,16,2,1

13,129,129,27,27,0,1,0
6,137,137,40,40,0,1,0
3,146,146,2,2,0,1,0
17,151,151,10,7,3,2,1
14,169,169,5,5,0,1,0
12,175,175,2,2,0,1,0
9,181,181,5,5,0,1,0
16,212,212,134,82,52,3,2
11,224,224,5,5,0,1,0
1,258,258,97,63,34,3,2
7,290,290,19,3,16,2,1
15,305,305,18,12,6,3,2
10,348,348,16,16,0,1,0
2,353,353,55,35,20,3,2
0,389,389,15,15,0,1,0
5,408,408,6,6,0,1,0
8,431,431,10,1,9,2,1
4,438,438,63,19,44,4,3

9,107,107,9,5,4,2,1
1,133,133,2,2,0,1,0
10,154,154,5,5,0,1,0
12,192,192,5,5,0,1,0
4,193,193,52,5,47,2,1
11,221,221,43,43,0,1,0
15,222,222,38,38,0,1,0
14,236,236,20,5,15,4,3
0,242,242,42,42,0,1,0
3,250,250,29,17,12,2,1
8,279,279,43,43,0,1,0
7,324,324,25,16,9,4,3
6,406,406,31,31,0,1,0
5,409,409,188,188,0,1,0
13,440,440,95,95,0,1,0
2,497,497,34,34,0,1,0

14,107,107,14,4,10,3,2
17,133,133,43,43,0,1,0
22,143,143,3,3,0,1,0
19,158,158,52,21,31,2,1
5,164,164,45,45,0,1,0
23,174,174,3,3,0,1,0
10,185,185,9,9,0,1,0
0,210,210,18,14,4,2,1
1,211,211,16,6,10,3,2
4,288,288,28,28,0,1,0
9,289,289,17,17,0,1,0
8,302,302,16,8,8,2,1
16,302,302,46,46,0,1,0
7,321,321,56,56,0,1,0
15,327,327,13,1,12,4,3
21,346,346,1,1,0,1,0
6,348,348,35,35,0,1,0
3,365,365,20,20,0,1,0
12,384,384,9,9,0,1,0
18,419,419,19,19,0,1,0
13,425,425,9,9,0,1,0
11,431,431,2,2,0,1,0
20,439,439,29,9,20,3,2
2,483,483,14,14,0,1,0

11,111,111,5,5,0,1,0
10,114,114,2,2,0,1,0
6,125,125,2,2,0,1,0
13,140,140,14,5,9,3,2
18,146,146,13,13,0,1,0
7,194,194,9,9,0,1,0
12,222,222,57,57,0,1,0
1,242,242,74,53,21,2,1
17,254,254,14,14,0,1,0
16,266,266,40,30,10,3,2
9,307,307,106,24,82,3,2
0,310,310,107,96,11,2,1
2,313,313,13,13,0,1,0
5,316,316,30,30,0,1,0
15,328,328,13,9,4,2,1
3,341,341,52,29,23,2,1
14,385,385,11,11,0,1,0
8,475,475,7,7,0,1,0
4,482,482,40,14,26,3,2

0,118,118,8,8,0,1,0
7,131,131,1,1,0,1,0
16,141,141,1,1,0,1,0
2,227,227,6,6,0,1,0
1,230,230,1,1,0,1,0
23,254,254,16,7,9,4,3
11,259,259,7,7,0,1,0
9,283,283,12,12,0,1,0
14,338,338,6,6,0,1,0
12,351,351,13,13,0,1,0
10,373,373,19,4,15,2,1
22,386,386,5,1,4,2,1
21,393,393,60,60,0,1,0
4,398,398,37,13,24,2,1
6,406,406,34,34,0,1,0
13,410,410,89,1,88,3,2
3,428,428,185,107,78,3,2
19,429,429,89,89,0,1,0
17,433,433,77,77,0,1,0
15,449,449,94,64,30,4,3
5,451,451,4,4,0,1,0
8,467,467,1,1,0,1,0
20,472,472,104,104,0,1,0
18,489,489,23,13,10,2,1

5,111,111,1,1,0,1,0
13,117,117,22,14,8,2,1
20,149,149,35,35,0,1,0
1,152,152,2,2,0,1,0
14,235,235,28,28,0,1,0
22,256,256,22,22,0,1,0
6,260,260,5,5,0,1,0
21,276,276,9,4,5,2,1
11,277,277,7,7,0,1,0
10,288,288,27,21,6,2,1
18,295,295,20,16,4,2,1
0,298,298,7,7,0,1,0
17,344,344,10,2,8,3,2
24,358,358,99,27,72,4,3
8,363,363,62,62,0,1,0
15,366,366,44,2,42,3,2
19,378,378,50,28,22,2,1
2,395,395,57,57,0,1,0
9,400,400,3,3,0,1,0
12,406,406,51,11,40,4,3
7,444,444,9,5,4,2,1
3,448,448,40,40,0,1,0
16,475,475,45,4,41,2,1
23,486,486,23,7,16,2,1
4,495,495,26,3,23,2,1

2,139,139,3,3,0,1,0
8,145,145,3,3,0,1,0
3,162,162,22,4,18,4,3
1,187,187,38,38,0,1,0
18,195,195,31,3,28,3,2
17,203,203,42,42,0,1,0
12,217,217,10,10,0,1,0
0,240,240,35,35,0,1,0
19,266,266,9,9,0,1,0
5,268,268,32,32,0,1,0
9,292,292,10,10,0,1,0
13,296,296,9,1,8,2,1
11,328,328,22,22,0,1,0
6,346,346,23,23,0,1,0
10,355,355,78,78,0,1,0
15,380,380,7,7,0,1,0
7,381,381,75,45,30,3,2
14,382,382,73,13,60,3,2
4,452,452,71,71,0,1,0
16,466,466,69,69,0,1,0

7,117,117,1,1,0,1,0
18,124,124,12,9,3,2,1
1,156,156,1,1,0,1,0
9,165,165,51,26,25,4,3
19,174,174,50,50,0,1,0
14,190,190,15,15,0,1,0
20,199,199,28,17,11,2,1
5,215,215,8,8,0,1,0
8,220,220,7,1,6,2,1
12,226,226,16,2,14,4,3
11,275,275,32,32,0,1,0
0,289,289,5,5,0,1,0
4,292,292,25,25,0,1,0
3,362,362,25,13,12,3,2
13,362,362,43,1,42,2,1
17,395,395,15,2,13,4,3
15,414,414,31,31,0,1,0
10,434,434,118,118,0,1,0
16,443,443,45,33,12,4,3
6,446,446,78,38,40,4,3
2,476,476,43,43,0,1,0

12,138,138,18,12,6,2,1
14,139,139,2,2,0,1,0
9,141,141,20,20,0,1,0
23,146,146,43,5,38,2,1
6,174,174,4,4,0,1,0
21,188,188,27,27,0,1,0
10,200,200,5,5,0,1,0
16,207,207,3,3,0,1,0
15,208,208,36,36,0,1,0
7,224,224,1,1,0,1,0
4,313,313,66,66,0,1,0
13,315,315,8,2,6,2,1
20,339,339,25,17,8,2,1
2,360,360,1,1,0,1,0
3,362,362,43,27,16,2,1
22,363,363,66,44,22,3,2
11,368,368,14,14,0,1,0
17,433,433,9,5,4,2,1
8,469,469,35,26,9,2,1
18,469,469,73,73,0,1,0
19,469,469,8,8,0,1,0
5,474,474,84,10,74,4,3
24,477,477,18,18,0,1,0
0,480,480,1,1,0,1,0
1,496,496,57,57,0,1,0

13,112,112,12,4,8,2,1
2,120,120,14,6,8,3,2
6,129,129,10,10,0,1,0
14,155,155,2,2,0,1,0
12,185,185,16,16,0,1,0
4,186,186,29,29,0,1,0
15,257,257,2,2,0,1,0
10,264,264,6,6,0,1,0
21,272,272,30,30,0,1,0
3,274,274,44,44,0,1,0
0,296,296,2,2,0,1,0
18,316,316,12,12,0,1,0
7,318,318,6,6,0,1,0
8,329,329,16,2,14,2,1
17,354,354,132,51,81,4,3
11,361,361,42,42,0,1,0
19,362,362,21,21,0,1,0
16,368,368,96,60,36,4,3
1,408,408,101,16,85,4,3
20,413,413,29,2,27,2,1
5,444,444,2,2,0,1,0
9,444,444,56,56,0,1,0

2,179,179,3,3,0,1,0
5,179,179,7,7,0,1,0
19,186,186,13,3,10,2,1
17,188,188,8,8,0,1,0
10,205,205,16,2,14,3,2
21,207,207,29,29,0,1,0
18,228,228,24,24,0,1,0
8,232,232,62,44,18,4,3
9,277,277,35,35,0,1,0
4,280,280,86,64,22,2,1
11,305,305,9,2,7,2,1
7,339,339,7,2,5,2,1
20,342,342,32,14,18,3,2
3,349,349,22,18,4,2,1
1,351,351,5,1,4,2,1
12,365,365,24,9,15,4,3
14,374,374,158,158,0,1,0
13,395,395,36,18,18,4,3
15,406,406,29,29,0,1,0
0,407,407,42,17,25,2,1
16,436,436,8,8,0,1,0
6,485,485,17,5,12,4,3

2,139,139,4,4,0,1,0
5,151,151,1,1,0,1,0
4,154,154,12,7,5,2,1
12,154,154,9,1,8,3,2
19,156,156,4,4,0,1,0
1,160,160,28,17,11,2,1
13,175,175,39,17,22,2,1
10,185,185,34,18,16,3,2
0,219,219,7,7,0,1,0
8,226,226,24,2,22,2,1
6,230,230,32,16,16,2,1
7,240,240,9,1,8,3,2
14,254,254,20,20,0,1,0
22,255,255,8,5,3,2,1
15,269,269,32,32,0,1,0
11,293,293,41,19,22,2,1
3,368,368,22,22,0,1,0
18,406,406,27,7,20,3,2
17,414,414,100,100,0,1,0
9,415,415,23,23,0,1,0
20,438,438,2,2,0,1,0
21,461,461,54,54,0,1,0
16,498,498,106,33,73,4,3

14,129,129,28,13,15,4,3
3,149,149,3,3,0,1,0
6,170,170,8,8,0,1,0
18,178,178,2,2,0,1,0
9,180,180,73,58,15,2,1
16,188,188,61,5,56,3,2
15,233,233,4,4,0,1,0
8,258,258,4,4,0,1,0
2,262,262,5,5,0,1,0
1,268,268,9,9,0,1,0
12,279,279,3,3,0,1,0
0,297,297,47,47,0,1,0
4,306,306,23,2,21,2,1
23,342,342,52,12,40,3,2
11,358,358,89,83,6,2,1
7,390,390,15,15,0,1,0
20,423,423,42,42,0,1,0
19,424,424,45,12,33,4,3
22,427,427,11,3,8,3,2
17,432,432,8,8,0,1,0
5,436,436,1,1,0,1,0
10,443,443,3,3,0,1,0
13,451,451,9,9,0,1,0
21,488,488,75,75,0,1,0

1,116,116,1,1,0,1,0
6,139,139,3,3,0,1,0
5,143,143,2,2,0,1,0
7,166,166,9,9,0,1,0
12,174,174,3,3,0,1,0
13,177,177,20,12,8,3,2
17,180,180,7,7,0,1,0
16,183,183,3,3,0,1,0
20,227,227,18,18,0,1,0
19,227,227,2,2,0,1,0
9,229,229,34,34,0,1,0
2,230,230,33,33,0,1,0
10,235,235,20,20,0,1,0
22,250,250,34,34,0,1,0
8,262,262,12,12,0,1,0
11,311,311,44,44,0,1,0
3,374,374,59,59,0,1,0
4,392,392,42,42,0,1,0
14,415,415,7,2,5,2,1
21,446,446,36,36,0,1,0
23,448,448,24,24,0,1,0
24,460,460,9,1,8,3,2
15,478,478,150,118,32,3,2
18,484,484,179,44,135,4,3
0,497,497,13,13,0,1,0

14,102,102,20,6,14,3,2
2,110,110,1,1,0,1,0
11,112,112,39,39,0,1,0
0,120,120,25,25,0,1,0
15,135,135,23,23,0,1,0
12,140,140,12,4,8,2,1
4,161,161,17,17,0,1,0
16,196,196,4,4,0,1,0
7,218,218,9,9,0,1,0
8,224,224,47,17,30,3,2
17,232,232,1,1,0,1,0
9,299,299,2,2,0,1,0
18,310,310,7,7,0,1,0
13,362,362,66,49,17,2,1
6,403,403,93,93,0,1,0
5,430,430,25,25,0,1,0
10,465,465,42,42,0,1,0
1,466,466,61,61,0,1,0
3,467,467,51,18,33,4,3

4,103,103,8,2,6,2,1
0,132,132,20,20,0,1,0
1,137,137,1,1,0,1,0
2,140,140,32,6,26,2,1
22,141,141,1,1,0,1,0
21,142,142,5,5,0,1,0
8,153,153,1,1,0,1,0
3,158,158,5,5,0,1,0
14,171,171,13,1,12,3,2
15,174,174,3,3,0,1,0
18,236,236,3,3,0,1,0
10,240,240,7,3,4,2,1
13,261,261,1,1,0,1,0
20,266,266,77,5,72,3,2
5,287,287,65,4,61,4,3
11,293,293,21,21,0,1,0
19,333,333,53,53,0,1,0
12,367,367,45,45,0,1,0
9,384,384,17,17,0,1,0
6,394,394,8,8,0,1,0
23,433,433,2,2,0,1,0
17,454,454,84,62,22,3,2
7,454,454,3,3,0,1,0
24,460,460,106,106,0,1,0
16,484,484,84,84,0,1,0

0,112,112,1,1,0,1,0
1,146,146,1,1,0,1,0
3,147,147,3,3,0,1,0
26,153,153,41,21,20,4,3
22,159,159,17,2,15,4,3
5,189,189,10,4,6,3,2
10,193,193,14,5,9,4,3
2,210,210,21,7,14,2,1
18,216,216,8,3,5,2,1
6,256,256,40,8,32,3,2
19,281,281,2,2,0,1,0
21,288,288,20,20,0,1,0
25,295,295,15,15,0,1,0
20,333,333,9,5,4,2,1
23,335,335,33,13,20,2,1
16,340,340,11,11,0,1,0
24,347,347,9,9,0,1,0
15,353,353,22,6,16,3,2
11,356,356,24,4,20,3,2
12,360,360,105,96,9,4,3
8,375,375,15,15,0,1,0
14,408,408,27,27,0,1,0
13,409,409,25,15,10,4,3
7,426,426,6,6,0,1,0
17,433,433,185,149,36,4,3
9,442,442,12,3,9,4,3
4,495,495,11,3,8,2,1

14,125,125,1,1,0,1,0
1,143,143,6,6,0,1,0
23,143,143,48,48,0,1,0
2,160,160,20,12,8,2,1
4,163,163,44,44,0,1,0
7,204,204,28,28,0,1,0
11,204,204,15,5,10,3,2
13,221,221,12,12,0,1,0
3,231,231,12,12,0,1,0
16,255,255,42,42,0,1,0
10,277,277,9,5,4,2,1
12,285,285,13,13,0,1,0
17,289,289,1,1,0,1,0
21,318,318,25,25,0,1,0
8,410,410,2,2,0,1,0
0,410,410,28,4,24,3,2
9,417,417,27,27,0,1,0
22,423,423,1,1,0,1,0
19,432,432,39,39,0,1,0
6,444,444,46,30,16,2,1
18,449,449,83,77,6,3,2
5,464,464,14,1,13,2,1
15,484,484,115,75,40,2,1
20,500,500,2,2,0,1,0

9,110,110,22,22,0,1,0
2,111,111,5,5,0,1,0
6,111,111,10,1,9,2,1
15,121,121,3,3,0,1,0
13,122,122,1,1,0,1,0
31,142,142,15,3,12,3,2
30,152,152,33,1,32,3,2
1,210,210,14,11,3,2,1
14,237,237,6,6,0,1,0
16,240,240,1,1,0,1,0
21,242,242,2,2,0,1,0
26,247,247,30,30,0,1,0
11,249,249,4,4,0,1,0
29,250,250,30,16,14,2,1
10,269,269,6,3,3,2,1
23,274,274,56,56,0,1,0
7,275,275,14,2,12,3,2
20,306,306,18,4,14,2,1
0,331,331,1,1,0,1,0
25,339,339,8,8,0,1,0
19,340,340,17,7,10,3,2
18,350,350,8,8,0,1,0
24,351,351,8,8,0,1,0
32,351,351,23,23,0,1,0
8,388,388,26,6,20,3,2
12,405,405,58,20,38,3,2
28,413,413,19,19,0,1,0
4,419,419,1,1,0,1,0
5,420,420,6,6,0,1,0
27,454,454,89,61,28,2,1
3,481,481,13,5,8,2,1
17,497,497,49,49,0,1,0
22,498,498,26,1,25,2,1

24,117,117,29,6,23,3,2
5,149,149,1,1,0,1,0
15,204,204,2,2,0,1,0
23,215,215,36,12,24,2,1
26,217,217,5,5,0,1,0
0,218,218,3,3,0,1,0
18,220,220,12,12,0,1,0
25,255,255,41,41,0,1,0
6,269,269,28,18,10,2,1
7,279,279,47,36,11,2,1
16,312,312,22,22,0,1,0
1,324,324,23,13,10,3,2
22,345,345,18,18,0,1,0
2,354,354,13,13,0,1,0
12,368,368,34,34,0,1,0
3,372,372,4,4,0,1,0
21,389,389,47,47,0,1,0
9,391,391,32,32,0,1,0
13,401,401,8,4,4,2,1
11,401,401,36,22,14,2,1
14,406,406,33,15,18,4,3
4,419,419,93,93,0,1,0
20,419,419,6,6,0,1,0
17,433,433,84,30,54,4,3
10,437,437,4,4,0,1,0
19,478,478,42,42,0,1,0
8,498,498,7,7,0,1,0

21,112,112,12,2,10,2,1
11,138,138,6,6,0,1,0
1,170,170,5,5,0,1,0
0,203,203,5,5,0,1,0
23,228,228,3,3,0,1,0
16,231,231,61,25,36,3,2
9,239,239,21,21,0,1,0
18,241,241,64,64,0,1,0
15,306,306,23,23,0,1,0
19,314,314,7,1,6,2,1
7,320,320,19,16,3,2,1
22,337,337,11,8,3,2,1
17,340,340,44,44,0,1,0
20,368,368,62,62,0,1,0
14,376,376,91,50,41,4,3
8,384,384,22,4,18,4,3
13,407,407,46,46,0,1,0
4,407,407,35,35,0,1,0
2,413,413,64,64,0,1,0
10,417,417,2,2,0,1,0
12,419,419,22,10,12,2,1
6,432,432,1,1,0,1,0
24,454,454,17,17,0,1,0
5,470,470,60,52,8,2,1
3,471,471,8,4,4,2,1

18,127,127,1,1,0,1,0
14,156,156,18,2,16,2,1
22,163,163,9,9,0,1,0
12,183,183,30,30,0,1,0
16,191,191,21,5,16,2,1
8,203,203,20,16,4,2,1
6,204,204,2,2,0,1,0
4,247,247,3,3,0,1,0
10,260,260,7,7,0,1,0
0,279,279,2,2,0,1,0
9,282,282,57,22,35,2,1
5,289,289,7,7,0,1,0
15,303,303,7,1,6,2,1
20,326,326,4,4,0,1,0
2,336,336,47,11,36,3,2
17,354,354,11,11,0,1,0
1,375,375,18,18,0,1,0
7,386,386,96,45,51,3,2
21,400,400,23,14,9,4,3
13,429,429,112,112,0,1,0
3,439,439,10,4,6,3,2
11,466,466,45,45,0,1,0
19,487,487,220,193,27,2,1

21,111,111,19,19,0,1,0
11,161,161,10,10,0,1,0
19,187,187,53,31,22,3,2
10,205,205,11,11,0,1,0
12,206,206,1,1,0,1,0
22,229,229,1,1,0,1,0
7,253,253,40,40,0,1,0
16,258,258,18,18,0,1,0
9,264,264,9,9,0,1,0
2,269,269,10,6,4,2,1
13,276,276,50,10,40,2,1
8,277,277,4,4,0,1,0
3,282,282,17,5,12,3,2
15,282,282,20,20,0,1,0
20,299,299,1,1,0,1,0
18,299,299,3,3,0,1,0
17,308,308,116,55,61,4,3
23,313,313,25,25,0,1,0
14,329,329,17,8,9,2,1
4,341,341,5,5,0,1,0
1,344,344,80,6,74,4,3
5,409,409,62,62,0,1,0
6,475,475,43,34,9,4,3
0,500,500,3,3,0,1,0

7,111,111,9,3,6,3,2
21,130,130,14,14,0,1,0
0,151,151,33,19,14,2,1
12,152,152,2,2,0,1,0
17,154,154,18,2,16,2,1
16,156,156,29,29,0,1,0
19,168,168,5,5,0,1,0
2,199,199,31,31,0,1,0
15,207,207,23,23,0,1,0
5,228,228,25,25,0,1,0
8,229,229,28,28,0,1,0
4,244,244,17,3,14,3,2
11,273,273,30,12,18,4,3
14,311,311,19,19,0,1,0
20,336,336,37,37,0,1,0
3,346,346,1,1,0,1,0
13,349,349,91,91,0,1,0
10,365,365,1,1,0,1,0
9,368,368,30,9,21,4,3
22,432,432,23,23,0,1,0
1,442,442,52,52,0,1,0
18,456,456,38,4,34,4,3
6,475,475,9,2,7,2,1

14,102,102,7,7,0,1,0
10,151,151,16,4,12,3,2
13,156,156,3,3,0,1,0
1,187,187,93,93,0,1,0
7,214,214,17,2,15,4,3
11,219,219,6,6,0,1,0
3,256,256,5,5,0,1,0
9,270,270,46,46,0,1,0
8,310,310,9,9,0,1,0
17,312,312,34,34,0,1,0
4,346,346,13,6,7,2,1
16,353,353,58,58,0,1,0
2,378,378,14,2,12,3,2
15,378,378,49,49,0,1,0
0,389,389,32,32,0,1,0
12,409,409,126,73,53,4,3
5,421,421,131,131,0,1,0
6,430,430,3,3,0,1,0
18,461,461,7,1,6,3,2

10,105,105,13,13,0,1,0
20,108,108,3,3,0,1,0
26,140,140,46,13,33,2,1
2,144,144,1,1,0,1,0
6,160,160,8,8,0,1,0
27,165,165,11,11,0,1,0
11,166,166,3,3,0,1,0
23,194,194,5,5,0,1,0
7,195,195,27,27,0,1,0
5,244,244,7,1,6,3,2
17,246,246,7,7,0,1,0
15,246,246,7,7,0,1,0
4,264,264,14,14,0,1,0
9,271,271,2,2,0,1,0
28,302,302,36,36,0,1,0
1,317,317,35,35,0,1,0
22,326,326,47,47,0,1,0
8,327,327,48,8,40,3,2
3,359,359,13,13,0,1,0
25,372,372,41,13,28,2,1
12,388,388,9,9,0,1,0
24,392,392,19,7,12,3,2
19,396,396,42,34,8,2,1
21,398,398,56,17,39,4,3
13,423,423,1,1,0,1,0
14,438,438,62,62,0,1,0
18,470,470,31,31,0,1,0
0,471,471,10,10,0,1,0
16,500,500,35,17,18,2,1

17,130,130,4,4,0,1,0
15,161,161,14,14,0,1,0
13,178,178,19,9,10,3,2
4,179,179,20,20,0,1,0
2,189,189,1,1,0,1,0
3,230,230,49,43,6,2,1
14,235,235,30,30,0,1,0
16,265,265,45,30,15,4,3
9,274,274,46,46,0,1,0
10,294,294,10,4,6,3,2
11,310,310,3,3,0,1,0
6,353,353,37,37,0,1,0
7,365,365,3,3,0,1,0
1,398,398,70,70,0,1,0
12,403,403,107,107,0,1,0
5,405,405,126,31,95,4,3
0,458,458,78,78,0,1,0
8,466,466,57,45,12,4,3

5,154,154,1,1,0,1,0
16,168,168,2,2,0,1,0
12,174,174,25,4,21,4,3
3,178,178,6,6,0,1,0
4,234,234,3,3,0,1,0
1,275,275,14,8,6,2,1
19,374,374,68,25,43,2,1
8,380,380,94,94,0,1,0
9,386,386,47,47,0,1,0
10,386,386,17,17,0,1,0
2,397,397,127,51,76,3,2
18,401,401,34,34,0,1,0
15,406,406,20,16,4,2,1
11,422,422,156,63,93,4,3
0,438,438,48,48,0,1,0
14,444,444,53,53,0,1,0
13,445,445,30,30,0,1,0
17,464,464,14,2,12,3,2
6,479,479,21,21,0,1,0
20,491,491,28,28,0,1,0
7,495,495,55,55,0,1,0

7,100,100,3,3,0,1,0
8,140,140,8,3,5,2,1
15,144,144,2,2,0,1,0
11,147,147,16,16,0,1,0
6,212,212,16,4,12,3,2
4,247,247,7,3,4,2,1
14,247,247,6,6,0,1,0
19,254,254,48,48,0,1,0
20,276,276,22,16,6,3,2
10,281,281,118,112,6,2,1
9,292,292,60,13,47,2,1
0,294,294,10,10,0,1,0
16,313,313,37,31,6,3,2
13,318,318,105,87,18,4,3
12,367,367,33,33,0,1,0
5,387,387,7,2,5,2,1
2,396,396,20,10,10,2,1
18,416,416,11,11,0,1,0
3,465,465,51,37,14,2,1
17,489,489,67,47,20,3,2
1,496,496,36,36,0,1,0

22,107,107,11,11,0,1,0
12,117,117,2,2,0,1,0
18,147,147,19,6,13,2,1
9,200,200,33,33,0,1,0
13,236,236,3,3,0,1,0
15,237,237,62,47,15,2,1
20,265,265,52,52,0,1,0
23,297,297,21,21,0,1,0
21,303,303,32,6,26,2,1
16,347,347,9,9,0,1,0
17,359,359,9,9,0,1,0
2,391,391,15,15,0,1,0
19,404,404,63,18,45,2,1
6,407,407,11,1,10,3,2
14,413,413,100,21,79,4,3
8,425,425,15,4,11,2,1
5,427,427,4,4,0,1,0
24,428,428,24,24,0,1,0
1,436,436,4,4,0,1,0
10,437,437,45,11,34,2,1
3,471,471,2,2,0,1,0
11,478,478,4,4,0,1,0
4,478,478,1,1,0,1,0
7,485,485,101,49,52,3,2
0,488,488,107,9,98,3,2

21,104,104,12,3,9,4,3
5,179,179,9,2,7,2,1
18,218,218,36,15,21,2,1
2,242,242,13,13,0,1,0
12,256,256,56,56,0,1,0
13,265,265,60,42,18,3,2
0,276,276,26,26,0,1,0
3,277,277,67,61,6,2,1
7,277,277,22,10,12,4,3
15,281,281,47,47,0,1,0
6,347,347,76,47,29,2,1
16,348,348,7,2,5,2,1
17,353,353,7,4,3,2,1
11,356,356,51,51,0,1,0
9,362,362,22,4,18,3,2
20,373,373,9,9,0,1,0
14,384,384,29,29,0,1,0
1,418,418,18,2,16,2,1
19,426,426,38,2,36,3,2
8,427,427,17,17,0,1,0
4,479,479,22,22,0,1,0
10,484,484,14,14,0,1,0

19,105,105,17,17,0,1,0
0,112,112,17,17,0,1,0
1,149,149,2,2,0,1,0
15,166,166,7,7,0,1,0
20,171,171,7,7,0,1,0
5,172,172,45,45,0,1,0
17,188,188,6,6,0,1,0
16,198,198,112,112,0,1,0
12,208,208,9,9,0,1,0
9,212,212,1,1,0,1,0
10,220,220,21,9,12,4,3
14,244,244,23,23,0,1,0
13,251,251,4,4,0,1,0
18,293,293,22,22,0,1,0
4,301,301,5,5,0,1,0
3,310,310,13,1,12,2,1
7,316,316,2,2,0,1,0
11,324,324,118,61,57,4,3
8,329,329,5,5,0,1,0
2,432,432,27,3,24,2,1
6,435,435,12,12,0,1,0
21,455,455,8,8,0,1,0
22,487,487,39,39,0,1,0

8,107,107,6,6,0,1,0
6,110,110,16,7,9,2,1
3,123,123,2,2,0,1,0
4,125,125,8,2,6,2,1
1,128,128,19,19,0,1,0
20,142,142,4,4,0,1,0
5,175,175,14,1,13,2,1
12,185,185,9,9,0,1,0
11,214,214,13,6,7,2,1
19,247,247,22,22,0,1,0
7,284,284,1,1,0,1,0
16,296,296,57,23,34,2,1
23,353,353,2,2,0,1,0
18,366,366,35,35,0,1,0
22,367,367,18,9,9,4,3
0,384,384,42,42,0,1,0
15,392,392,24,24,0,1,0
17,399,399,61,39,22,2,1
9,409,409,13,13,0,1,0
14,440,440,90,83,7,2,1
2,454,454,120,40,80,4,3
13,470,470,26,18,8,2,1
21,478,478,116,97,19,2,1
10,486,486,8,8,0,1,0

20,120,120,14,14,0,1,0
4,146,146,23,23,0,1,0
0,157,157,5,2,3,2,1
8,180,180,5,1,4,2,1
15,198,198,6,6,0,1,0
12,207,207,8,2,6,2,1
10,213,213,6,2,4,2,1
2,222,222,1,1,0,1,0
16,227,227,40,14,26,3,2
19,227,227,22,22,0,1,0
6,231,231,6,6,0,1,0
17,232,232,7,1,6,3,2
24,294,294,21,16,5,2,1
5,307,307,2,2,0,1,0
27,325,325,34,27,7,2,1
22,351,351,49,49,0,1,0
26,354,354,23,23,0,1,0
1,370,370,74,54,20,2,1
7,375,375,22,22,0,1,0
14,375,375,15,15,0,1,0
11,398,398,29,2,27,2,1
23,414,414,11,3,8,3,2
18,419,419,54,9,45,3,2
3,420,420,40,24,16,2,1
21,451,451,106,39,67,4,3
13,460,460,3,3,0,1,0
9,464,464,33,10,23,2,1
25,488,488,67,47,20,2,1

6,140,140,2,2,0,1,0
4,145,145,23,8,15,4,3
5,153,153,36,36,0,1,0
10,329,329,17,7,10,3,2
7,331,331,93,84,9,4,3
3,346,346,36,36,0,1,0
15,348,348,39,25,14,3,2
1,350,350,59,59,0,1,0
9,352,352,85,53,32,2,1
13,356,356,31,31,0,1,0
16,357,357,11,11,0,1,0
8,440,440,43,22,21,4,3
14,446,446,82,16,66,4,3
12,464,464,8,8,0,1,0
2,465,465,50,50,0,1,0
11,488,488,5,5,0,1,0
0,498,498,156,156,0,1,0

18,101,101,3,3,0,1,0
11,127,127,20,20,0,1,0
9,128,128,9,9,0,1,0
24,142,142,7,7,0,1,0
0,158,158,1,1,0,1,0
8,195,195,10,10,0,1,0
5,204,204,49,49,0,1,0
4,240,240,1,1,0,1,0
10,245,245,48,48,0,1,0
21,254,254,23,19,4,2,1
12,264,264,25,25,0,1,0
22,293,293,49,49,0,1,0
16,311,311,40,40,0,1,0
3,348,348,2,2,0,1,0
1,360,360,5,1,4,2,1
7,367,367,11,11,0,1,0
15,375,375,5,5,0,1,0
19,377,377,81,24,57,4,3
17,380,380,22,22,0,1,0
23,380,380,13,13,0,1,0
2,395,395,8,8,0,1,0
13,421,421,70,70,0,1,0
6,445,445,16,13,3,2,1
14,445,445,4,4,0,1,0
20,457,457,156,156,0,1,0

4,121,121,13,7,6,3,2
15,131,131,7,7,0,1,0
7,148,148,5,5,0,1,0
9,160,160,31,31,0,1,0
1,161,161,1,1,0,1,0
18,163,163,7,1,6,2,1
5,203,203,10,10,0,1,0
20,221,221,5,5,0,1,0
8,302,302,72,72,0,1,0
12,306,306,7,7,0,1,0
3,317,317,23,14,9,4,3
17,319,319,29,8,21,2,1
14,393,393,100,100,0,1,0
0,405,405,38,2,36,3,2
19,408,408,59,19,40,4,3
13,415,415,64,64,0,1,0
11,429,429,47,47,0,1,0
2,438,438,81,81,0,1,0
6,446,446,37,26,11,2,1
16,450,450,100,18,82,3,2
10,460,460,17,17,0,1,0

16,100,100,1,1,0,1,0
24,104,104,2,2,0,1,0
0,115,115,4,1,3,2,1
3,118,118,1,1,0,1,0
15,118,118,8,8,0,1,0
12,191,191,18,4,14,2,1
21,255,255,10,10,0,1,0
5,260,260,21,21,0,1,0
18,267,267,60,47,13,2,1
19,287,287,59,59,0,1,0
11,293,293,13,1,12,2,1
17,298,298,10,10,0,1,0
9,303,303,3,3,0,1,0
22,308,308,130,13,117,4,3
25,318,318,11,11,0,1,0
13,329,329,12,2,10,2,1
6,335,335,31,31,0,1,0
1,335,335,7,7,0,1,0
8,380,380,19,19,0,1,0
20,409,409,9,9,0,1,0
2,421,421,73,59,14,3,2
10,448,448,7,7,0,1,0
4,462,462,113,25,88,3,2
23,469,469,55,9,46,4,3
14,491,491,31,31,0,1,0
7,495,495,33,12,21,4,3

5,115,115,2,2,0,1,0
3,123,123,24,24,0,1,0
12,125,125,10,4,6,2,1
4,126,126,4,4,0,1,0
14,133,133,16,16,0,1,0
6,143,143,3,3,0,1,0
15,158,158,6,6,0,1,0
2,162,162,1,1,0,1,0
25,222,222,16,16,0,1,0
16,232,232,2,2,0,1,0
10,235,235,25,4,21,2,1
0,247,247,8,2,6,3,2
9,269,269,8,8,0,1,0
18,300,300,53,17,36,3,2
8,304,304,1,1,0,1,0
22,314,314,21,4,17,2,1
21,347,347,37,23,14,3,2
11,394,394,103,61,42,3,2
19,395,395,80,18,62,3,2
1,403,403,33,17,16,3,2
17,411,411,148,69,79,3,2
13,423,423,13,6,7,2,1
23,450,450,30,30,0,1,0
7,464,464,22,8,14,3,2
20,475,475,2,2,0,1,0
24,481,481,21,21,0,1,0

14,113,113,4,4,0,1,0
0,118,118,31,31,0,1,0
12,120,120,10,10,0,1,0
13,139,139,33,33,0,1,0
18,144,144,7,7,0,1,0
8,169,169,1,1,0,1,0
17,221,221,1,1,0,1,0
15,229,229,16,16,0,1,0
9,231,231,23,3,20,2,1
10,248,248,43,43,0,1,0
4,329,329,40,25,15,4,3
7,352,352,28,28,0,1,0
16,398,398,125,125,0,1,0
11,406,406,23,15,8,2,1
1,466,466,161,132,29,3,2
6,483,483,33,25,8,3,2
5,485,485,57,33,24,3,2
2,493,493,40,1,39,4,3
3,493,493,9,1,8,3,2

17,137,137,5,5,0,1,0
22,142,142,8,8,0,1,0
7,170,170,8,8,0,1,0
27,193,193,50,50,0,1,0
5,202,202,18,18,0,1,0
9,248,248,28,7,21,4,3
13,252,252,3,3,0,1,0
12,255,255,11,4,7,2,1
3,293,293,11,3,8,3,2
26,293,293,10,10,0,1,0
6,296,296,47,47,0,1,0
1,313,313,5,5,0,1,0
23,314,314,26,26,0,1,0
24,320,320,3,3,0,1,0
0,353,353,7,7,0,1,0
20,364,364,36,36,0,1,0
21,377,377,91,71,20,2,1
16,383,383,8,8,0,1,0
18,397,397,29,29,0,1,0
10,410,410,26,26,0,1,0
25,430,430,67,13,54,3,2
8,441,441,55,55,0,1,0
11,451,451,12,7,5,2,1
14,463,463,20,20,0,1,0
4,474,474,67,67,0,1,0
19,496,496,52,9,43,3,2
15,498,498,5,5,0,1,0
2,500,500,50,18,32,2,1

5,126,126,37,2,35,2,1
11,133,133,20,4,16,2,1
15,136,136,20,20,0,1,0
13,140,140,6,6,0,1,0
17,165,165,4,4,0,1,0
12,184,184,2,2,0,1,0
6,234,234,4,4,0,1,0
16,266,266,41,9,32,4,3
10,282,282,10,10,0,1,0
9,305,305,73,28,45,2,1
4,320,320,50,41,9,2,1
0,358,358,2,2,0,1,0
3,366,366,4,4,0,1,0
8,406,406,66,13,53,3,2
14,424,424,65,23,42,4,3
2,430,430,64,9,55,4,3
1,439,439,170,43,127,4,3
7,496,496,40,7,33,2,1

9,102,102,15,15,0,1,0
15,139,139,31,19,12,2,1
2,184,184,9,3,6,2,1
10,188,188,19,6,13,2,1
22,209,209,15,2,13,3,2
5,220,220,20,8,12,2,1
1,226,226,6,6,0,1,0
3,242,242,39,29,10,3,2
8,258,258,17,14,3,2,1
20,261,261,59,59,0,1,0
21,278,278,49,49,0,1,0
11,281,281,40,40,0,1,0
14,308,308,19,19,0,1,0
17,319,319,28,28,0,1,0
6,324,324,5,5,0,1,0
19,336,336,5,5,0,1,0
13,342,342,59,59,0,1,0
16,343,343,9,9,0,1,0
18,369,369,23,23,0,1,0
7,392,392,96,96,0,1,0
4,414,414,1,1,0,1,0
12,437,437,6,6,0,1,0
0,446,446,18,18,0,1,0

18,121,121,11,11,0,1,0
21,134,134,16,7,9,4,3
8,148,148,4,4,0,1,0
5,186,186,2,2,0,1,0
15,191,191,39,4,35,2,1
22,206,206,71,29,42,4,3
14,210,210,2,2,0,1,0
4,218,218,29,29,0,1,0
25,219,219,12,12,0,1,0
13,263,263,8,8,0,1,0
27,285,285,3,3,0,1,0
7,308,308,9,9,0,1,0
16,315,315,11,11,0,1,0
10,318,318,24,24,0,1,0
3,321,321,52,16,36,3,2
0,325,325,14,6,8,3,2
6,337,337,16,16,0,1,0
12,342,342,2,2,0,1,0
26,370,370,120,62,58,4,3
17,381,381,13,13,0,1,0
20,399,399,5,1,4,2,1
9,426,426,35,35,0,1,0
1,437,437,9,9,0,1,0
19,454,454,25,4,21,2,1
2,454,454,50,10,40,3,2
24,492,492,33,33,0,1,0
11,495,495,21,2,19,2,1
23,499,499,23,16,7,2,1

10,105,105,10,3,7,2,1
0,113,113,1,1,0,1,0
2,123,123,28,17,11,2,1
4,132,132,8,8,0,1,0
11,163,163,39,39,0,1,0
1,172,172,24,6,18,4,3
7,197,197,33,2,31,2,1
5,203,203,1,1,0,1,0
16,217,217,43,11,32,3,2
6,225,225,21,2,19,2,1
9,225,225,3,3,0,1,0
12,276,276,46,10,36,4,3
15,337,337,2,2,0,1,0
18,396,396,41,41,0,1,0
13,418,418,21,21,0,1,0
3,419,419,59,47,12,2,1
20,421,421,77,50,27,4,3
8,483,483,74,47,27,2,1
19,485,485,31,31,0,1,0
14,491,491,14,11,3,2,1
17,496,496,37,37,0,1,0

9,127,127,27,27,0,1,0
8,131,131,8,8,0,1,0
15,157,157,17,17,0,1,0
2,182,182,2,2,0,1,0
14,189,189,14,9,5,2,1
13,210,210,62,1,61,3,2
18,216,216,30,30,0,1,0
1,223,223,45,37,8,2,1
12,223,223,14,14,0,1,0
10,253,253,42,13,29,2,1
5,263,263,19,5,14,3,2
20,288,288,14,6,8,2,1
6,374,374,12,12,0,1,0
0,379,379,12,3,9,2,1
11,384,384,26,26,0,1,0
17,385,385,66,66,0,1,0
7,398,398,54,54,0,1,0
16,404,404,3,3,0,1,0
3,446,446,45,5,40,3,2
19,473,473,72,26,46,3,2
21,478,478,30,5,25,2,1
4,492,492,4,4,0,1,0

3,119,119,22,2,20,2,1
0,123,123,1,1,0,1,0
20,179,179,15,15,0,1,0
19,186,186,3,3,0,1,0
1,193,193,8,3,5,2,1
10,195,195,34,34,0,1,0
12,214,214,39,39,0,1,0
18,215,215,8,8,0,1,0
5,216,216,6,1,5,2,1
2,233,233,19,19,0,1,0
4,255,255,29,29,0,1,0
11,273,273,5,5,0,1,0
16,284,284,43,10,33,2,1
8,285,285,11,11,0,1,0
15,298,298,44,44,0,1,0
6,304,304,47,9,38,3,2
14,304,304,9,9,0,1,0
13,306,306,81,5,76,4,3
17,399,399,76,10,66,3,2
9,418,418,13,1,12,3,2
7,438,438,108,102,6,3,2

8,101,101,18,18,0,1,0
19,102,102,11,11,0,1,0
16,154,154,23,23,0,1,0
9,226,226,7,7,0,1,0
18,238,238,68,68,0,1,0
1,253,253,14,14,0,1,0
7,262,262,51,1,50,2,1
11,281,281,24,24,0,1,0
0,301,301,4,1,3,2,1
17,308,308,71,51,20,3,2
13,328,328,9,9,0,1,0
10,334,334,52,4,48,2,1
15,349,349,19,19,0,1,0
2,410,410,2,2,0,1,0
12,415,415,9,9,0,1,0
4,450,450,123,123,0,1,0
5,457,457,1,1,0,1,0
6,457,457,158,144,14,2,1
14,457,457,2,2,0,1,0
3,497,497,2,2,0,1,0

3,119,119,9,6,3,2,1
8,147,147,15,4,11,2,1
4,158,158,8,4,4,2,1
11,168,168,1,1,0,1,0
2,169,169,6,6,0,1,0
13,172,172,2,2,0,1,0
9,203,203,10,2,8,3,2
14,249,249,29,29,0,1,0
21,256,256,9,9,0,1,0
5,274,274,49,10,39,4,3
10,277,277,13,2,11,2,1
6,292,292,3,3,0,1,0
18,322,322,19,1,18,4,3
23,351,351,62,35,27,2,1
20,351,351,12,2,10,2,1
15,356,356,47,5,42,2,1
16,359,359,74,12,62,3,2
19,361,361,80,23,57,4,3
22,398,398,22,10,12,2,1
1,410,410,15,3,12,3,2
0,414,414,29,7,22,2,1
12,421,421,138,90,48,3,2
7,478,478,49,27,22,4,3
17,482,482,36,19,17,2,1

8,100,100,1,1,0,1,0
1,137,137,21,21,0,1,0
12,156,156,3,3,0,1,0
13,161,161,26,26,0,1,0
7,166,166,2,2,0,1,0
5,198,198,10,10,0,1,0
6,199,199,29,29,0,1,0
14,215,215,38,11,27,4,3
9,217,217,39,12,27,3,2
10,250,250,77,34,43,2,1
11,268,268,21,10,11,2,1
17,342,342,32,32,0,1,0
20,344,344,45,5,40,2,1
16,344,344,17,2,15,4,3
3,347,347,1,1,0,1,0
2,362,362,3,3,0,1,0
19,367,367,29,26,3,2,1
18,368,368,56,4,52,4,3
21,423,423,105,39,66,4,3
0,428,428,47,8,39,4,3
4,460,460,20,20,0,1,0
15,496,496,5,5,0,1,0

11,119,119,3,3,0,1,0
12,126,126,11,11,0,1,0
23,161,161,60,60,0,1,0
13,167,167,4,4,0,1,0
4,174,174,9,9,0,1,0
15,174,174,25,25,0,1,0
21,208,208,8,2,6,3,2
2,227,227,26,26,0,1,0
24,246,246,78,78,0,1,0
1,253,253,23,23,0,1,0
7,256,256,10,10,0,1,0
9,272,272,29,18,11,2,1
14,293,293,11,11,0,1,0
6,311,311,32,27,5,2,1
10,317,317,22,22,0,1,0
17,340,340,7,7,0,1,0
25,363,363,31,31,0,1,0
18,367,367,14,5,9,2,1
20,369,369,18,6,12,4,3
19,379,379,5,5,0,1,0
0,408,408,21,21,0,1,0
16,422,422,15,5,10,2,1
22,430,430,64,32,32,3,2
3,435,435,6,2,4,2,1
8,489,489,63,12,51,4,3
5,496,496,8,8,0,1,0

10,102,102,13,5,8,3,2
9,103,103,1,1,0,1,0
16,109,109,22,10,12,4,3
1,112,112,13,5,8,2,1
2,137,137,5,1,4,2,1
13,162,162,13,5,8,3,2
17,246,246,59,12,47,3,2
6,253,253,17,8,9,4,3
15,262,262,8,8,0,1,0
14,267,267,11,11,0,1,0
7,291,291,22,22,0,1,0
8,297,297,23,23,0,1,0
0,310,310,75,22,53,3,2
4,316,316,23,23,0,1,0
20,362,362,56,52,4,2,1
21,366,366,25,25,0,1,0
12,385,385,5,5,0,1,0
18,408,408,24,24,0,1,0
19,444,444,105,97,8,2,1
5,446,446,10,4,6,3,2
11,456,456,9,9,0,1,0
3,474,474,111,9,102,4,3

17,110,110,6,3,3,2,1
14,125,125,5,5,0,1,0
9,131,131,9,9,0,1,0
2,134,134,11,11,0,1,0
8,166,166,5,5,0,1,0
11,210,210,19,19,0,1,0
7,226,226,6,6,0,1,0
5,232,232,5,5,0,1,0
4,276,276,8,2,6,3,2
0,299,299,118,108,10,3,2
13,303,303,6,6,0,1,0
6,325,325,24,24,0,1,0
3,375,375,15,6,9,2,1
10,402,402,63,48,15,4,3
15,431,431,21,9,12,4,3
1,439,439,191,191,0,1,0
16,477,477,230,230,0,1,0
12,484,484,68,32,36,4,3

21,105,105,21,6,15,4,3
22,136,136,7,7,0,1,0
3,171,171,24,1,23,2,1
5,173,173,7,7,0,1,0
9,206,206,2,2,0,1,0
19,213,213,95,65,30,4,3
10,221,221,5,5,0,1,0
12,233,233,1,1,0,1,0
18,254,254,6,6,0,1,0
2,278,278,8,2,6,2,1
20,290,290,25,25,0,1,0
8,322,322,12,1,11,2,1
0,334,334,57,57,0,1,0
24,343,343,10,10,0,1,0
4,380,380,30,12,18,3,2
14,386,386,27,1,26,3,2
6,386,386,53,30,23,4,3
16,398,398,37,37,0,1,0
11,402,402,5,5,0,1,0
13,407,407,76,76,0,1,0
17,427,427,25,25,0,1,0
15,440,440,58,10,48,2,1
7,447,447,4,4,0,1,0
23,489,489,4,4,0,1,0
1,494,494,76,76,0,1,0

19,138,138,3,3,0,1,0
10,143,143,12,12,0,1,0
4,153,153,5,5,0,1,0
6,167,167,2,2,0,1,0
17,232,232,10,4,6,2,1
15,268,268,20,2,18,3,2
7,271,271,22,7,15,4,3
3,278,278,3,3,0,1,0
21,299,299,36,36,0,1,0
14,307,307,23,23,0,1,0
12,308,308,9,5,4,2,1
16,310,310,57,57,0,1,0
9,325,325,14,14,0,1,0
11,361,361,43,15,28,4,3
20,366,366,92,62,30,3,2
5,377,377,3,3,0,1,0
8,405,405,43,43,0,1,0
0,466,466,93,57,36,4,3
13,471,471,145,114,31,2,1
2,475,475,1,1,0,1,0
18,497,497,5,5,0,1,0
1,500,500,201,108,93,4,3

21,107,107,36,36,0,1,0
4,150,150,5,5,0,1,0
0,151,151,1,1,0,1,0
29,154,154,19,7,12,3,2
5,168,168,3,3,0,1,0
17,177,177,9,2,7,3,2
16,178,178,15,9,6,3,2
23,180,180,12,12,0,1,0
20,193,193,8,8,0,1,0
9,203,203,9,9,0,1,0
27,222,222,5,2,3,2,1
13,229,229,3,3,0,1,0
11,266,266,28,12,16,3,2
25,280,280,77,25,52,4,3
6,280,280,1,1,0,1,0
12,305,305,11,11,0,1,0
24,305,305,28,13,15,2,1
7,314,314,28,23,5,2,1
22,318,318,8,8,0,1,0
8,327,327,53,53,0,1,0
1,343,343,10,10,0,1,0
18,344,344,28,24,4,2,1
2,351,351,10,2,8,3,2
19,359,359,24,24,0,1,0
10,367,367,4,4,0,1,0
28,395,395,35,9,26,4,3
26,405,405,20,6,14,2,1
15,436,436,61,24,37,4,3
14,457,457,29,29,0,1,0
3,486,486,17,17,0,1,0

21,157,157,44,27,17,2,1
17,171,171,16,3,13,2,1
19,172,172,26,26,0,1,0
14,181,181,25,18,7,2,1
4,186,186,7,7,0,1,0
3,196,196,8,4,4,2,1
24,201,201,17,6,11,2,1
25,213,213,14,14,0,1,0
22,228,228,28,28,0,1,0
9,254,254,13,13,0,1,0
7,268,268,14,3,11,2,1
18,296,296,1,1,0,1,0
0,314,314,3,3,0,1,0
10,344,344,25,25,0,1,0
15,352,352,41,41,0,1,0
13,359,359,35,35,0,1,0
23,367,367,26,26,0,1,0
8,380,380,1,1,0,1,0
5,388,388,4,4,0,1,0
1,395,395,16,1,15,2,1
11,413,413,3,3,0,1,0
16,417,417,68,68,0,1,0
2,424,424,56,30,26,2,1
20,442,442,38,38,0,1,0
12,488,488,111,59,52,3,2
6,490,490,32,25,7,2,1

4,176,176,6,1,5,2,1
14,242,242,7,7,0,1,0
6,247,247,9,9,0,1,0
1,330,330,32,29,3,2,1
2,361,361,127,39,88,3,2
13,378,378,41,41,0,1,0
3,385,385,60,31,29,2,1
10,390,390,106,28,78,4,3
8,391,391,70,41,29,2,1
9,393,393,40,40,0,1,0
11,400,400,54,40,14,3,2
15,414,414,1,1,0,1,0
5,424,424,166,133,33,4,3
16,463,463,41,15,26,3,2
7,466,466,22,22,0,1,0
0,469,469,17,10,7,2,1
12,484,484,71,50,21,2,1

12,108,108,26,10,16,3,2
17,143,143,1,1,0,1,0
13,162,162,10,5,5,2,1
14,172,172,1,1,0,1,0
3,173,173,4,4,0,1,0
11,247,247,13,13,0,1,0
9,279,279,53,53,0,1,0
15,328,328,10,10,0,1,0
18,346,346,97,46,51,4,3
6,363,363,69,69,0,1,0
4,363,363,43,43,0,1,0
10,377,377,38,21,17,2,1
7,390,390,23,16,7,2,1
1,395,395,100,2,98,3,2
16,406,406,62,26,36,3,2
5,428,428,83,83,0,1,0
8,468,468,12,12,0,1,0
0,480,480,66,66,0,1,0
2,481,481,48,30,18,3,2

20,139,139,24,24,0,1,0
8,171,171,4,4,0,1,0
9,179,179,43,13,30,2,1
12,179,179,7,1,6,2,1
3,201,201,6,6,0,1,0
4,204,204,7,1,6,3,2
2,220,220,18,13,5,2,1
19,236,236,21,7,14,3,2
5,245,245,36,22,14,2,1
16,248,248,2,2,0,1,0
22,278,278,23,5,18,2,1
15,281,281,52,2,50,3,2
23,282,282,19,7,12,2,1
13,299,299,7,7,0,1,0
0,332,332,71,71,0,1,0
21,380,380,74,37,37,3,2
18,415,415,100,46,54,4,3
7,416,416,78,78,0,1,0
14,431,431,1,1,0,1,0
6,443,443,24,24,0,1,0
10,444,444,2,2,0,1,0
1,445,445,3,3,0,1,0
17,457,457,35,11,24,3,2
11,459,459,8,8,0,1,0

17,111,111,11,5,6,3,2
6,132,132,17,3,14,2,1
12,141,141,8,8,0,1,0
0,163,163,19,13,6,2,1
18,213,213,20,6,14,3,2
7,280,280,1,1,0,1,0
19,291,291,18,18,0,1,0
13,296,296,59,59,0,1,0
5,302,302,54,20,34,2,1
15,312,312,22,6,16,3,2
3,333,333,118,34,84,4,3
2,344,344,22,22,0,1,0
9,346,346,11,3,8,2,1
14,362,362,21,3,18,4,3
8,374,374,18,9,9,4,3
10,375,375,114,21,93,3,2
16,385,385,49,15,34,3,2
11,405,405,22,5,17,2,1
4,422,422,39,39,0,1,0
1,428,428,36,36,0,1,0

14,106,106,51,51,0,1,0
15,106,106,11,2,9,2,1
10,107,107,1,1,0,1,0
18,132,132,6,6,0,1,0
12,134,134,10,1,9,2,1
4,137,137,1,1,0,1,0
19,147,147,6,3,3,2,1
21,159,159,26,26,0,1,0
2,210,210,31,10,21,4,3
6,217,217,1,1,0,1,0
7,245,245,2,2,0,1,0
20,260,260,35,18,17,4,3
1,275,275,112,112,0,1,0
5,293,293,35,35,0,1,0
0,342,342,10,10,0,1,0
13,364,364,9,2,7,2,1
3,381,381,66,66,0,1,0
9,391,391,50,50,0,1,0
16,414,414,5,5,0,1,0
8,467,467,18,18,0,1,0
17,485,485,24,9,15,2,1
11,494,494,14,8,6,2,1

2,133,133,25,10,15,4,3
0,142,142,66,29,37,2,1
6,154,154,1,1,0,1,0
11,178,178,9,9,0,1,0
4,212,212,26,19,7,2,1
5,234,234,7,7,0,1,0
8,293,293,9,1,8,3,2
12,366,366,68,54,14,4,3
17,369,369,9,3,6,3,2
18,391,391,3,3,0,1,0
14,393,393,23,9,14,2,1
16,422,422,58,40,18,4,3
15,434,434,20,20,0,1,0
13,436,436,224,191,33,2,1
7,451,451,22,6,16,3,2
19,452,452,22,13,9,2,1
10,456,456,20,11,9,4,3
1,479,479,11,11,0,1,0
3,492,492,8,8,0,1,0
9,499,499,85,39,46,4,3

4,112,112,4,4,0,1,0
10,147,147,15,4,11,2,1
8,163,163,12,8,4,2,1
15,189,189,41,41,0,1,0
5,191,191,4,4,0,1,0
17,206,206,48,1,47,2,1
12,224,224,44,44,0,1,0
6,231,231,37,37,0,1,0
14,259,259,7,7,0,1,0
7,267,267,6,6,0,1,0
1,322,322,90,68,22,3,2
20,327,327,28,28,0,1,0
21,333,333,21,21,0,1,0
9,334,334,56,56,0,1,0
18,363,363,51,51,0,1,0
11,366,366,42,42,0,1,0
13,386,386,36,13,23,4,3
0,386,386,14,11,3,2,1
3,409,409,31,7,24,4,3
2,442,442,5,5,0,1,0
19,462,462,25,25,0,1,0
16,464,464,1,1,0,1,0

18,123,123,12,2,10,2,1
5,133,133,13,13,0,1,0
20,146,146,13,4,9,4,3
19,149,149,9,9,0,1,0
13,163,163,52,25,27,2,1
8,166,166,1,1,0,1,0
16,201,201,27,4,23,2,1
2,209,209,19,4,15,4,3
9,226,226,28,28,0,1,0
17,244,244,22,22,0,1,0
0,288,288,30,9,21,4,3
4,294,294,20,20,0,1,0
10,297,297,37,20,17,2,1
6,310,310,102,48,54,4,3
15,316,316,46,1,45,2,1
11,326,326,17,17,0,1,0
14,349,349,6,6,0,1,0
7,376,376,8,8,0,1,0
1,380,380,44,29,15,2,1
3,446,446,9,9,0,1,0
12,482,482,58,58,0,1,0

14,114,114,2,2,0,1,0
11,144,144,13,1,12,4,3
6,168,168,42,42,0,1,0
13,178,178,52,34,18,4,3
7,204,204,1,1,0,1,0
1,236,236,1,1,0,1,0
15,308,308,34,3,31,2,1
10,338,338,66,42,24,4,3
12,358,358,6,6,0,1,0
5,368,368,96,63,33,2,1
3,369,369,44,44,0,1,0
9,398,398,29,17,12,3,2
4,421,421,170,41,129,4,3
2,460,460,24,24,0,1,0
0,465,465,122,88,34,2,1
8,490,490,40,40,0,1,0

16,107,107,8,8,0,1,0
22,116,116,2,2,0,1,0
9,123,123,18,18,0,1,0
18,167,167,43,43,0,1,0
25,169,169,25,16,9,4,3
15,177,177,15,7,8,3,2
20,193,193,8,4,4,2,1
7,199,199,19,19,0,1,0
4,248,248,31,31,0,1,0
23,256,256,43,22,21,2,1
6,259,259,36,24,12,3,2
11,275,275,17,17,0,1,0
12,291,291,8,2,6,3,2
13,293,293,28,28,0,1,0
17,295,295,87,87,0,1,0
1,346,346,21,7,14,3,2
14,357,357,15,6,9,2,1
19,362,362,7,1,6,2,1
5,363,363,55,55,0,1,0
24,365,365,28,10,18,3,2
8,384,384,13,13,0,1,0
10,388,388,6,6,0,1,0
2,412,412,8,8,0,1,0
3,412,412,1,1,0,1,0
0,471,471,2,2,0,1,0
21,490,490,12,3,9,4,3

0,109,109,10,2,8,3,2
24,110,110,10,10,0,1,0
4,112,112,11,11,0,1,0
18,118,118,2,2,0,1,0
15,135,135,7,7,0,1,0
11,143,143,3,3,0,1,0
7,157,157,1,1,0,1,0
5,169,169,39,1,38,2,1
10,187,187,7,7,0,1,0
6,209,209,6,6,0,1,0
1,211,211,1,1,0,1,0
27,252,252,93,36,57,3,2
21,254,254,1,1,0,1,0
23,257,257,40,6,34,3,2
19,280,280,13,8,5,2,1
3,309,309,12,12,0,1,0
17,325,325,15,3,12,2,1
14,332,332,7,3,4,2,1
25,343,343,20,15,5,2,1
2,368,368,18,4,14,3,2
26,390,390,56,34,22,3,2
8,401,401,40,40,0,1,0
16,425,425,1,1,0,1,0
12,429,429,70,2,68,3,2
20,430,430,63,50,13,2,1
9,449,449,4,4,0,1,0
13,491,491,50,50,0,1,0
22,496,496,45,17,28,3,2

0,111,111,9,9,0,1,0
21,116,116,12,8,4,2,1
22,127,127,13,13,0,1,0
8,128,128,2,2,0,1,0
16,135,135,12,12,0,1,0
15,135,135,1,1,0,1,0
14,156,156,10,10,0,1,0
13,173,173,9,9,0,1,0
10,209,209,1,1,0,1,0
11,223,223,55,44,11,2,1
23,225,225,42,26,16,2,1
7,236,236,20,20,0,1,0
17,240,240,14,14,0,1,0
19,289,289,29,1,28,3,2
5,324,324,3,3,0,1,0
1,324,324,20,11,9,4,3
6,353,353,2,2,0,1,0
9,374,374,1,1,0,1,0
24,383,383,65,39,26,3,2
2,388,388,8,8,0,1,0
4,389,389,20,20,0,1,0
20,411,411,5,5,0,1,0
18,439,439,131,94,37,3,2
3,441,441,95,61,34,3,2
12,467,467,89,89,0,1,0

9,110,110,6,6,0,1,0
19,111,111,13,3,10,3,2
12,116,116,3,3,0,1,0
21,120,120,8,8,0,1,0
7,129,129,12,12,0,1,0
24,130,130,24,17,7,2,1
3,143,143,5,5,0,1,0
11,199,199,29,29,0,1,0
18,212,212,19,2,17,4,3
1,227,227,10,10,0,1,0
13,233,233,2,2,0,1,0
23,254,254,1,1,0,1,0
6,255,255,25,1,24,3,2
17,304,304,1,1,0,1,0
14,311,311,20,20,0,1,0
2,338,338,1,1,0,1,0
22,385,385,159,99,60,4,3
15,386,386,13,13,0,1,0
20,388,388,14,14,0,1,0
8,388,388,49,49,0,1,0
5,390,390,16,16,0,1,0
4,390,390,1,1,0,1,0
0,452,452,50,50,0,1,0
10,471,471,117,117,0,1,0
16,483,483,90,10,80,3,2

7,133,133,15,15,0,1,0
10,156,156,5,5,0,1,0
3,175,175,18,18,0,1,0
16,187,187,8,8,0,1,0
11,222,222,60,45,15,2,1
2,241,241,60,24,36,3,2
19,271,271,47,32,15,4,3
17,282,282,7,7,0,1,0
6,302,302,6,6,0,1,0
5,305,305,25,19,6,2,1
1,325,325,3,3,0,1,0
0,325,325,69,69,0,1,0
8,353,353,76,19,57,4,3
4,358,358,25,5,20,3,2
15,373,373,106,106,0,1,0
13,378,378,41,13,28,4,3
9,389,389,11,3,8,3,2
12,440,440,39,17,22,2,1
14,484,484,8,2,6,3,2
18,486,486,36,36,0,1,0

0,124,124,3,3,0,1,0
24,150,150,28,19,9,4,3
17,153,153,44,6,38,2,1
14,160,160,5,2,3,2,1
21,164,164,8,8,0,1,0
25,191,191,19,19,0,1,0
6,234,234,21,3,18,4,3
20,247,247,13,13,0,1,0
23,263,263,23,3,20,3,2
16,283,283,38,2,36,2,1
1,285,285,5,5,0,1,0
7,293,293,13,10,3,2,1
3,297,297,74,38,36,3,2
2,313,313,12,12,0,1,0
8,313,313,19,19,0,1,0
5,328,328,1,1,0,1,0
4,329,329,19,7,12,4,3
18,336,336,24,24,0,1,0
10,353,353,2,2,0,1,0
19,366,366,9,1,8,3,2
9,383,383,19,1,18,3,2
22,389,389,51,51,0,1,0
12,426,426,20,20,0,1,0
15,446,446,113,113,0,1,0
11,469,469,1,1,0,1,0
13,500,500,64,28,36,3,2

3,135,135,23,23,0,1,0
13,172,172,24,16,8,2,1
2,183,183,13,13,0,1,0
6,226,226,79,35,44,2,1
9,274,274,16,16,0,1,0
12,274,274,7,7,0,1,0
11,284,284,9,9,0,1,0
5,297,297,46,1,45,4,3
7,322,322,56,56,0,1,0
14,327,327,53,21,32,2,1
17,332,332,54,54,0,1,0
15,337,337,61,61,0,1,0
4,352,352,1,1,0,1,0
10,366,366,78,33,45,2,1
16,368,368,30,14,16,3,2
8,393,393,45,45,0,1,0
18,401,401,27,1,26,2,1
0,456,456,11,5,6,3,2
1,473,473,19,19,0,1,0

8,114,114,1,1,0,1,0
21,125,125,4,4,0,1,0
23,151,151,14,14,0,1,0
19,168,168,19,19,0,1,0
17,170,170,1,1,0,1,0
6,181,181,13,1,12,3,2
22,201,201,68,41,27,2,1
11,202,202,9,4,5,2,1
16,202,202,11,11,0,1,0
1,257,257,9,4,5,2,1
9,262,262,37,37,0,1,0
10,264,264,29,29,0,1,0
12,269,269,24,18,6,3,2
7,271,271,20,20,0,1,0
20,282,282,22,2,20,2,1
5,316,316,15,15,0,1,0
18,343,343,36,36,0,1,0
2,365,365,3,3,0,1,0
13,375,375,60,41,19,2,1
4,389,389,18,18,0,1,0
3,393,393,32,23,9,4,3
15,446,446,3,3,0,1,0
14,456,456,135,135,0,1,0
0,477,477,88,88,0,1,0

6,107,107,2,2,0,1,0
20,112,112,2,2,0,1,0
3,175,175,16,16,0,1,0
10,196,196,7,7,0,1,0
8,219,219,40,18,22,3,2
24,232,232,19,1,18,4,3
19,234,234,39,39,0,1,0
22,243,243,2,2,0,1,0
4,244,244,1,1,0,1,0
5,269,269,36,36,0,1,0
7,292,292,2,2,0,1,0
16,303,303,86,32,54,4,3
9,303,303,34,13,21,4,3
14,324,324,28,28,0,1,0
23,335,335,77,29,48,3,2
18,355,355,68,68,0,1,0
25,362,362,29,29,0,1,0
17,379,379,5,5,0,1,0
13,394,394,20,4,16,2,1
2,396,396,22,8,14,2,1
11,423,423,2,2,0,1,0
21,442,442,21,12,9,4,3
1,473,473,7,7,0,1,0
0,498,498,32,20,12,4,3
15,500,500,7,3,4,2,1
12,500,500,113,84,29,2,1

11,112,112,26,5,21,4,3
20,124,124,2,2,0,1,0
21,167,167,16,1,15,2,1
7,193,193,1,1,0,1,0
5,201,201,41,41,0,1,0
3,204,204,20,20,0,1,0
1,204,204,3,3,0,1,0
19,212,212,52,52,0,1,0
0,220,220,51,33,18,4,3
14,249,249,29,29,0,1,0
4,252,252,7,7,0,1,0
12,274,274,1,1,0,1,0
13,314,314,22,7,15,4,3
18,315,315,46,46,0,1,0
16,328,328,41,41,0,1,0
10,349,349,8,8,0,1,0
6,374,374,5,2,3,2,1
2,379,379,4,4,0,1,0
17,413,413,113,11,102,4,3
9,454,454,59,18,41,4,3
15,487,487,11,11,0,1,0
8,497,497,55,4,51,4,3

17,108,108,9,1,8,3,2
20,119,119,2,2,0,1,0
1,168,168,6,6,0,1,0
14,180,180,7,4,3,2,1
15,198,198,17,9,8,3,2
19,207,207,76,76,0,1,0
6,223,223,1,1,0,1,0
2,245,245,29,29,0,1,0
16,251,251,21,21,0,1,0
22,254,254,5,5,0,1,0
18,261,261,1,1,0,1,0
12,284,284,3,3,0,1,0
13,292,292,120,83,37,2,1
7,293,293,34,30,4,2,1
0,351,351,31,31,0,1,0
5,363,363,57,32,25,2,1
11,375,375,4,4,0,1,0
4,380,380,27,16,11,2,1
8,400,400,140,52,88,3,2
21,400,400,3,3,0,1,0
10,414,414,8,2,6,2,1
3,454,454,23,2,21,4,3
9,493,493,34,34,0,1,0

10,157,157,3,3,0,1,0
19,170,170,7,7,0,1,0
8,173,173,19,19,0,1,0
1,176,176,4,4,0,1,0
6,178,178,10,10,0,1,0
0,185,185,2,2,0,1,0
9,219,219,3,3,0,1,0
12,259,259,33,22,11,2,1
21,268,268,69,59,10,2,1
18,284,284,14,14,0,1,0
13,288,288,14,14,0,1,0
3,321,321,105,29,76,3,2
14,337,337,63,35,28,4,3
17,356,356,32,11,21,2,1
11,356,356,22,6,16,2,1
5,387,387,47,47,0,1,0
2,390,390,53,19,34,2,1
7,411,411,10,10,0,1,0
20,412,412,62,62,0,1,0
4,434,434,86,53,33,4,3
16,442,442,42,42,0,1,0
15,456,456,32,9,23,2,1

8,126,126,3,3,0,1,0
19,134,134,2,2,0,1,0
12,137,137,11,2,9,4,3
3,160,160,13,1,12,3,2
9,189,189,10,4,6,3,2
15,206,206,32,2,30,4,3
14,231,231,29,29,0,1,0
7,253,253,14,3,11,4,3
17,258,258,80,30,50,2,1
13,267,267,3,3,0,1,0
4,271,271,43,13,30,2,1
2,290,290,30,30,0,1,0
11,306,306,37,37,0,1,0
0,315,315,2,2,0,1,0
5,321,321,23,3,20,3,2
16,352,352,59,59,0,1,0
1,359,359,13,13,0,1,0
18,444,444,29,29,0,1,0
6,452,452,233,233,0,1,0
10,490,490,33,8,25,2,1

19,143,143,1,1,0,1,0
14,161,161,15,15,0,1,0
16,175,175,20,20,0,1,0
10,188,188,17,5,12,2,1
13,198,198,17,4,13,2,1
12,209,209,40,10,30,2,1
15,218,218,30,30,0,1,0
9,244,244,29,29,0,1,0
3,245,245,27,27,0,1,0
8,251,251,1,1,0,1,0
2,253,253,26,26,0,1,0
6,278,278,44,39,5,2,1
4,279,279,61,36,25,2,1
18,283,283,65,45,20,2,1
11,285,285,30,30,0,1,0
1,360,360,57,19,38,3,2
17,393,393,26,16,10,2,1
0,417,417,33,33,0,1,0
7,428,428,27,27,0,1,0
5,474,474,42,12,30,3,2

25,107,107,2,2,0,1,0
22,120,120,1,1,0,1,0
8,132,132,1,1,0,1,0
3,145,145,18,18,0,1,0
15,160,160,17,9,8,3,2
16,210,210,4,4,0,1,0
7,210,210,1,1,0,1,0
4,235,235,2,2,0,1,0
14,243,243,43,21,22,3,2
19,246,246,1,1,0,1,0
26,259,259,39,39,0,1,0
17,321,321,118,118,0,1,0
13,327,327,37,37,0,1,0
0,328,328,18,11,7,2,1
2,357,357,7,7,0,1,0
12,361,361,14,1,13,2,1
1,373,373,9,9,0,1,0
23,376,376,114,96,18,4,3
11,410,410,89,89,0,1,0
10,412,412,37,37,0,1,0
6,441,441,5,1,4,2,1
18,441,441,36,26,10,2,1
5,444,444,1,1,0,1,0
9,463,463,39,39,0,1,0
20,472,472,63,42,21,2,1
21,474,474,14,14,0,1,0
24,499,499,11,6,5,2,1

18,100,100,2,2,0,1,0
20,113,113,9,9,0,1,0
12,115,115,26,26,0,1,0
22,122,122,20,20,0,1,0
8,129,129,7,7,0,1,0
16,132,132,1,1,0,1,0
9,146,146,2,2,0,1,0
14,154,154,20,20,0,1,0
15,154,154,15,6,9,3,2
4,157,157,13,8,5,2,1
19,165,165,7,1,6,2,1
11,210,210,28,28,0,1,0
7,248,248,3,3,0,1,0
6,282,282,9,9,0,1,0
10,286,286,19,1,18,4,3
17,298,298,57,57,0,1,0
2,300,300,25,16,9,4,3
5,326,326,32,32,0,1,0
1,328,328,37,16,21,2,1
13,352,352,3,3,0,1,0
21,389,389,153,51,102,4,3
0,418,418,35,35,0,1,0
3,428,428,46,46,0,1,0

11,110,110,3,3,0,1,0
20,118,118,11,1,10,2,1
23,140,140,14,6,8,3,2
2,158,158,9,9,0,1,0
9,169,169,2,2,0,1,0
18,188,188,2,2,0,1,0
3,214,214,21,5,16,2,1
25,235,235,5,2,3,2,1
24,249,249,30,30,0,1,0
4,257,257,9,9,0,1,0
19,273,273,84,68,16,3,2
13,305,305,35,1,34,3,2
7,309,309,37,30,7,2,1
14,317,317,1,1,0,1,0
16,317,317,22,22,0,1,0
17,320,320,32,32,0,1,0
12,329,329,3,3,0,1,0
1,349,349,56,22,34,4,3
21,357,357,39,39,0,1,0
6,371,371,42,17,25,2,1
5,411,411,22,22,0,1,0
10,414,414,21,21,0,1,0
8,421,421,35,35,0,1,0
22,459,459,91,4,87,4,3
0,469,469,42,16,26,3,2
15,494,494,37,37,0,1,0

8,107,107,38,1,37,2,1
7,114,114,7,2,5,2,1
6,183,183,10,1,9,4,3
5,201,201,4,4,0,1,0
1,225,225,7,2,5,2,1
14,234,234,4,4,0,1,0
16,251,251,36,36,0,1,0
10,256,256,36,22,14,3,2
3,258,258,56,14,42,4,3
2,296,296,41,4,37,2,1
0,353,353,22,22,0,1,0
9,366,366,23,2,21,4,3
18,435,435,82,3,79,4,3
17,442,442,3,3,0,1,0
11,443,443,50,50,0,1,0
15,453,453,136,67,69,4,3
4,475,475,76,34,42,4,3
12,488,488,9,3,6,2,1
13,489,489,62,62,0,1,0

16,154,154,3,3,0,1,0
0,206,206,58,58,0,1,0
15,289,289,22,22,0,1,0
5,300,300,8,1,7,2,1
9,308,308,2,2,0,1,0
12,319,319,86,61,25,2,1
13,319,319,53,11,42,4,3
3,321,321,35,17,18,4,3
14,322,322,51,25,26,2,1
2,335,335,34,34,0,1,0
6,404,404,76,27,49,2,1
7,413,413,44,14,30,3,2
1,433,433,122,28,94,4,3
10,433,433,50,20,30,2,1
11,436,436,24,24,0,1,0
4,453,453,3,3,0,1,0
8,478,478,72,26,46,2,1
17,499,499,48,39,9,3,2

15,129,129,24,24,0,1,0
21,134,134,9,9,0,1,0
8,159,159,32,8,24,4,3
9,173,173,6,6,0,1,0
0,175,175,6,6,0,1,0
12,176,176,5,5,0,1,0
20,200,200,33,10,23,2,1
6,214,214,3,3,0,1,0
5,216,216,47,16,31,2,1
7,311,311,9,9,0,1,0
16,317,317,70,16,54,4,3
3,324,324,68,43,25,2,1
2,327,327,55,12,43,2,1
14,338,338,32,32,0,1,0
11,348,348,39,21,18,4,3
10,356,356,1,1,0,1,0
1,371,371,15,2,13,2,1
19,395,395,12,4,8,3,2
13,405,405,114,3,111,4,3
17,408,408,10,1,9,4,3
18,444,444,14,14,0,1,0
22,458,458,4,1,3,2,1
4,499,499,4,4,0,1,0

8,108,108,1,1,0,1,0
18,128,128,5,5,0,1,0
16,129,129,26,5,21,2,1
12,146,146,20,12,8,3,2
15,156,156,7,7,0,1,0
2,210,210,7,1,6,3,2
17,215,215,2,2,0,1,0
7,232,232,4,4,0,1,0
13,263,263,8,2,6,3,2
14,267,267,65,59,6,3,2
9,270,270,23,9,14,2,1
0,276,276,38,38,0,1,0
5,285,285,37,37,0,1,0
1,310,310,79,79,0,1,0
20,321,321,2,2,0,1,0
19,325,325,91,41,50,4,3
10,390,390,8,1,7,2,1
21,420,420,54,54,0,1,0
6,434,434,71,71,0,1,0
3,451,451,69,69,0,1,0
4,477,477,24,24,0,1,0
11,489,489,23,18,5,2,1

12,114,114,3,3,0,1,0
6,134,134,8,5,3,2,1
22,140,140,6,2,4,2,1
4,141,141,5,5,0,1,0
18,144,144,2,2,0,1,0
11,179,179,1,1,0,1,0
5,199,199,15,15,0,1,0
1,202,202,12,12,0,1,0
16,229,229,58,58,0,1,0
9,243,243,14,14,0,1,0
2,245,245,11,11,0,1,0
8,259,259,27,27,0,1,0
15,266,266,14,9,5,2,1
10,317,317,71,71,0,1,0
23,342,342,23,23,0,1,0
3,351,351,34,34,0,1,0
14,391,391,26,2,24,3,2
0,418,418,53,26,27,2,1
17,433,433,82,82,0,1,0
20,474,474,77,77,0,1,0
7,480,480,88,17,71,4,3
19,488,488,45,40,5,2,1
13,489,489,1,1,0,1,0
21,496,496,89,67,22,2,1

1,139,139,25,7,18,3,2
10,141,141,32,32,0,1,0
14,145,145,19,10,9,4,3
13,151,151,35,7,28,2,1
17,167,167,38,38,0,1,0
6,193,193,12,3,9,4,3
16,209,209,12,9,3,2,1
0,210,210,11,5,6,2,1
12,216,216,2,2,0,1,0
9,279,279,63,63,0,1,0
3,285,285,36,36,0,1,0
15,302,302,7,7,0,1,0
5,327,327,49,49,0,1,0
2,338,338,23,23,0,1,0
11,362,362,2,2,0,1,0
4,374,374,28,17,11,2,1
8,374,374,42,42,0,1,0
18,443,443,78,52,26,4,3
19,463,463,13,4,9,4,3
7,478,478,24,5,19,4,3

12,100,100,19,19,0,1,0
11,106,106,1,1,0,1,0
17,125,125,5,1,4,2,1
0,126,126,7,2,5,2,1
7,150,150,44,14,30,2,1
9,154,154,19,16,3,2,1
6,239,239,13,3,10,3,2
18,243,243,6,3,3,2,1
13,256,256,10,6,4,2,1
16,278,278,31,15,16,3,2
4,281,281,20,6,14,2,1
14,324,324,99,47,52,3,2
2,368,368,11,3,8,3,2
8,393,393,101,63,38,2,1
10,428,428,34,5,29,2,1
15,430,430,85,85,0,1,0
1,450,450,121,24,97,4,3
3,469,469,29,3,26,3,2
5,489,489,4,4,0,1,0

1,101,101,1,1,0,1,0
16,102,102,2,2,0,1,0
5,120,120,1,1,0,1,0
17,141,141,23,16,7,2,1
9,144,144,11,11,0,1,0
21,151,151,29,29,0,1,0
7,161,161,1,1,0,1,0
15,165,165,45,20,25,4,3
14,172,172,2,2,0,1,0
13,196,196,48,48,0,1,0
20,206,206,4,1,3,2,1
6,236,236,23,1,22,2,1
18,263,263,9,9,0,1,0
8,293,293,21,21,0,1,0
19,296,296,44,44,0,1,0
11,299,299,45,29,16,3,2
10,365,365,105,105,0,1,0
12,398,398,10,4,6,2,1
3,416,416,118,13,105,4,3
2,427,427,4,4,0,1,0
0,461,461,45,9,36,2,1
4,491,491,2,2,0,1,0

3,117,117,5,2,3,2,1
11,117,117,3,3,0,1,0
21,119,119,32,32,0,1,0
10,136,136,3,3,0,1,0
23,157,157,36,2,34,2,1
8,167,167,19,19,0,1,0
4,202,202,4,4,0,1,0
7,218,218,11,11,0,1,0
16,250,250,25,5,20,4,3
12,257,257,43,33,10,3,2
6,270,270,59,59,0,1,0
17,278,278,6,6,0,1,0
9,288,288,22,4,18,3,2
5,306,306,31,31,0,1,0
2,353,353,12,12,0,1,0
22,354,354,34,34,0,1,0
19,355,355,13,13,0,1,0
14,381,381,13,13,0,1,0
13,386,386,28,28,0,1,0
1,409,409,2,2,0,1,0
0,412,412,48,13,35,4,3
24,412,412,77,77,0,1,0
15,429,429,12,3,9,2,1
18,459,459,57,29,28,4,3
20,491,491,13,7,6,3,2

2,118,118,6,6,0,1,0
3,133,133,11,3,8,2,1
19,142,142,3,3,0,1,0
8,165,165,7,7,0,1,0
6,179,179,19,19,0,1,0
14,212,212,2,2,0,1,0
1,217,217,5,5,0,1,0
13,219,219,25,1,24,2,1
4,225,225,1,1,0,1,0
17,254,254,29,25,4,2,1
20,300,300,75,75,0,1,0
0,300,300,13,13,0,1,0
21,310,310,100,100,0,1,0
18,312,312,14,5,9,4,3
7,367,367,68,47,21,4,3
10,391,391,71,45,26,2,1
5,394,394,75,29,46,3,2
12,406,406,5,5,0,1,0
16,436,436,44,38,6,2,1
15,467,467,61,61,0,1,0
11,496,496,63,54,9,2,1
9,498,498,32,32,0,1,0

3,100,100,2,2,0,1,0
14,130,130,1,1,0,1,0
23,147,147,19,19,0,1,0
12,185,185,16,16,0,1,0
19,195,195,33,33,0,1,0
17,228,228,3,3,0,1,0
9,234,234,10,10,0,1,0
10,264,264,67,20,47,2,1
1,283,283,28,25,3,2,1
4,283,283,4,1,3,2,1
2,288,288,14,14,0,1,0
21,318,318,25,13,12,3,2
0,325,325,1,1,0,1,0
20,326,326,38,38,0,1,0
5,334,334,2,2,0,1,0
13,341,341,29,29,0,1,0
15,367,367,91,91,0,1,0
7,372,372,39,7,32,4,3
22,378,378,56,15,41,3,2
8,380,380,36,13,23,3,2
6,407,407,4,1,3,2,1
11,438,438,102,42,60,4,3
18,443,443,10,10,0,1,0
16,487,487,93,93,0,1,0

1,100,100,1,1,0,1,0
4,102,102,1,1,0,1,0
6,115,115,23,23,0,1,0
8,135,135,17,17,0,1,0
13,136,136,9,9,0,1,0
5,234,234,41,26,15,4,3
17,237,237,14,14,0,1,0
9,237,237,38,11,27,4,3
12,266,266,4,4,0,1,0
0,271,271,44,10,34,3,2
2,295,295,27,1,26,4,3
14,310,310,17,10,7,2,1
16,363,363,75,75,0,1,0
7,372,372,62,26,36,3,2
10,378,378,40,24,16,3,2
11,401,401,110,110,0,1,0
3,464,464,133,121,12,4,3
15,487,487,23,9,14,3,2

22,124,124,24,24,0,1,0
16,169,169,17,1,16,2,1
20,177,177,13,4,9,2,1
3,193,193,36,36,0,1,0
11,213,213,40,40,0,1,0
9,222,222,20,20,0,1,0
19,254,254,48,48,0,1,0
8,255,255,8,8,0,1,0
10,295,295,84,84,0,1,0
12,297,297,14,14,0,1,0
6,338,338,1,1,0,1,0
1,342,342,8,8,0,1,0
0,345,345,47,47,0,1,0
5,354,354,19,19,0,1,0
14,379,379,14,3,11,4,3
17,380,380,14,5,9,4,3
2,385,385,6,2,4,2,1
7,393,393,9,9,0,1,0
13,403,403,122,54,68,4,3
21,406,406,21,21,0,1,0
4,422,422,8,4,4,2,1
18,444,444,23,23,0,1,0
15,460,460,38,38,0,1,0

1,109,109,18,18,0,1,0
4,127,127,21,21,0,1,0
8,194,194,8,8,0,1,0
5,235,235,39,39,0,1,0
9,236,236,4,4,0,1,0
3,237,237,130,112,18,4,3
13,247,247,57,57,0,1,0
7,294,294,19,19,0,1,0
14,313,313,109,109,0,1,0
11,339,339,18,4,14,3,2
12,406,406,6,6,0,1,0
2,436,436,59,59,0,1,0
10,444,444,41,41,0,1,0
6,445,445,40,12,28,3,2
0,465,465,43,18,25,2,1

15,118,118,25,25,0,1,0
13,127,127,23,23,0,1,0
6,141,141,31,19,12,4,3
12,148,148,13,13,0,1,0
11,171,171,1,1,0,1,0
7,175,175,16,4,12,3,2
0,182,182,39,10,29,3,2
9,194,194,16,2,14,3,2
14,233,233,22,7,15,2,1
10,249,249,27,2,25,2,1
3,267,267,20,20,0,1,0
8,340,340,76,76,0,1,0
1,343,343,37,37,0,1,0
4,376,376,128,86,42,4,3
2,429,429,22,22,0,1,0
5,447,447,1,1,0,1,0
17,462,462,17,17,0,1,0
16,478,478,45,45,0,1,0

22,112,112,5,2,3,2,1
21,133,133,27,27,0,1,0
17,141,141,10,2,8,3,2
3,146,146,20,11,9,4,3
8,181,181,2,2,0,1,0
6,192,192,4,4,0,1,0
19,205,205,11,5,6,2,1
15,250,250,53,33,20,3,2
4,290,290,4,4,0,1,0
18,292,292,20,20,0,1,0
12,295,295,8,8,0,1,0
16,298,298,4,4,0,1,0
9,301,301,49,34,15,4,3
14,309,309,69,42,27,4,3
5,371,371,25,25,0,1,0
10,380,380,24,24,0,1,0
11,387,387,84,84,0,1,0
2,388,388,32,32,0,1,0
7,400,400,19,19,0,1,0
0,421,421,70,70,0,1,0
13,430,430,49,49,0,1,0
20,437,437,52,52,0,1,0
1,481,481,41,4,37,4,3

16,105,105,3,3,0,1,0
12,110,110,52,37,15,4,3
8,117,117,1,1,0,1,0
7,143,143,60,12,48,3,2
5,155,155,23,1,22,4,3
2,217,217,51,51,0,1,0
10,225,225,11,11,0,1,0
6,229,229,11,11,0,1,0
0,244,244,1,1,0,1,0
4,278,278,57,17,40,2,1
14,289,289,86,38,48,3,2
9,334,334,12,2,10,3,2
3,343,343,4,4,0,1,0
15,345,345,15,15,0,1,0
13,370,370,1,1,0,1,0
1,417,417,11,3,8,2,1
11,418,418,21,21,0,1,0
17,430,430,59,59,0,1,0
18,461,461,3,3,0,1,0

4,125,125,4,4,0,1,0
17,153,153,15,4,11,2,1
19,187,187,21,1,20,3,2
16,220,220,26,9,17,2,1
12,237,237,5,5,0,1,0
6,265,265,3,3,0,1,0
15,287,287,43,17,26,3,2
5,313,313,64,34,30,4,3
7,316,316,18,18,0,1,0
22,322,322,75,75,0,1,0
1,332,332,7,7,0,1,0
0,338,338,36,36,0,1,0
14,349,349,7,4,3,2,1
11,361,361,13,13,0,1,0
8,389,389,53,35,18,4,3
10,390,390,43,23,20,3,2
9,402,402,73,44,29,2,1
18,418,418,60,33,27,4,3
3,424,424,50,17,33,4,3
21,428,428,52,40,12,3,2
20,478,478,32,13,19,2,1
2,480,480,32,9,23,2,1
13,482,482,25,25,0,1,0

14,100,100,16,16,0,1,0
3,150,150,47,47,0,1,0
17,194,194,5,5,0,1,0
8,198,198,17,3,14,2,1
9,225,225,29,4,25,2,1
7,246,246,62,62,0,1,0
10,277,277,41,41,0,1,0
13,291,291,29,29,0,1,0
5,360,360,68,68,0,1,0
16,361,361,41,9,32,3,2
11,371,371,9,9,0,1,0
18,373,373,90,66,24,4,3
2,376,376,18,18,0,1,0
4,379,379,59,25,34,2,1
6,388,388,16,16,0,1,0
12,448,448,27,24,3,2,1
15,487,487,56,20,36,3,2
0,494,494,1,1,0,1,0
1,497,497,9,9,0,1,0

20,106,106,30,8,22,3,2
10,151,151,4,4,0,1,0
12,187,187,1,1,0,1,0
15,199,199,4,4,0,1,0
19,200,200,34,34,0,1,0
21,203,203,17,1,16,4,3
9,211,211,1,1,0,1,0
18,214,214,20,20,0,1,0
22,269,269,5,5,0,1,0
16,284,284,8,8,0,1,0
11,294,294,9,1,8,2,1
13,323,323,15,7,8,3,2
17,329,329,112,55,57,4,3
3,344,344,60,60,0,1,0
7,350,350,51,35,16,2,1
2,430,430,80,80,0,1,0
6,440,440,60,60,0,1,0
0,444,444,29,29,0,1,0
1,450,450,24,24,0,1,0
4,451,451,7,7,0,1,0
5,456,456,32,32,0,1,0
14,476,476,22,4,18,3,2
8,484,484,90,90,0,1,0

5,115,115,8,8,0,1,0
7,122,122,1,1,0,1,0
4,129,129,8,2,6,2,1
3,154,154,11,11,0,1,0
2,203,203,22,22,0,1,0
1,230,230,35,35,0,1,0
13,253,253,26,16,10,2,1
11,278,278,97,64,33,2,1
12,279,279,6,6,0,1,0
14,301,301,13,6,7,3,2
8,316,316,12,6,6,2,1
18,327,327,15,3,12,3,2
17,355,355,12,2,10,2,1
16,358,358,87,12,75,4,3
0,375,375,208,94,114,4,3
15,402,402,52,5,47,3,2
10,458,458,44,5,39,2,1
9,460,460,23,23,0,1,0
6,482,482,18,3,15,4,3

18,125,125,25,17,8,3,2
3,142,142,12,4,8,3,2
13,152,152,19,6,13,4,3
20,174,174,3,3,0,1,0
9,182,182,13,13,0,1,0
0,211,211,13,13,0,1,0
15,218,218,2,2,0,1,0
6,232,232,19,10,9,2,1
19,239,239,69,57,12,2,1
22,256,256,12,7,5,2,1
10,294,294,23,23,0,1,0
17,296,296,11,1,10,2,1
7,341,341,1,1,0,1,0
16,355,355,24,14,10,3,2
8,364,364,5,5,0,1,0
5,371,371,95,74,21,4,3
11,378,378,78,4,74,3,2
2,407,407,39,39,0,1,0
12,432,432,13,13,0,1,0
21,451,451,14,14,0,1,0
4,471,471,53,53,0,1,0
1,472,472,3,3,0,1,0
14,500,500,147,71,76,4,3

14,100,100,9,9,0,1,0
17,103,103,8,4,4,2,1
1,122,122,3,3,0,1,0
13,137,137,21,21,0,1,0
10,201,201,25,3,22,2,1
2,205,205,16,4,12,4,3
16,207,207,37,7,30,4,3
18,214,214,12,12,0,1,0
24,218,218,41,20,21,2,1
9,247,247,4,4,0,1,0
7,259,259,4,4,0,1,0
5,291,291,1,1,0,1,0
6,309,309,2,2,0,1,0
3,313,313,1,1,0,1,0
23,330,330,24,8,16,3,2
15,340,340,17,6,11,2,1
19,340,340,49,49,0,1,0
22,368,368,74,74,0,1,0
11,369,369,19,1,18,3,2
12,390,390,32,32,0,1,0
21,394,394,57,23,34,2,1
20,459,459,3,3,0,1,0
0,464,464,109,49,60,3,2
4,485,485,2,2,0,1,0
8,486,486,108,3,105,4,3

17,103,103,1,1,0,1,0
15,117,117,13,13,0,1,0
7,180,180,35,11,24,2,1
14,215,215,42,42,0,1,0
12,222,222,17,17,0,1,0
6,228,228,27,27,0,1,0
3,245,245,28,10,18,2,1
9,249,249,54,33,21,4,3
10,285,285,12,12,0,1,0
13,318,318,30,15,15,2,1
0,319,319,60,1,59,4,3
4,324,324,70,70,0,1,0
5,349,349,1,1,0,1,0
8,354,354,22,16,6,2,1
2,378,378,7,7,0,1,0
11,410,410,83,34,49,2,1
1,428,428,107,20,87,4,3
16,497,497,58,33,25,2,1

7,126,126,5,5,0,1,0
23,131,131,17,4,13,2,1
18,134,134,11,11,0,1,0
17,144,144,24,21,3,2,1
15,146,146,23,23,0,1,0
8,159,159,4,1,3,2,1
9,183,183,34,13,21,4,3
12,201,201,2,2,0,1,0
2,203,203,12,3,9,2,1
3,206,206,13,1,12,4,3
16,215,215,6,6,0,1,0
1,280,280,11,11,0,1,0
10,282,282,14,14,0,1,0
22,289,289,2,2,0,1,0
19,321,321,73,55,18,3,2
14,335,335,16,16,0,1,0
20,357,357,5,5,0,1,0
0,363,363,27,21,6,2,1
6,386,386,58,8,50,2,1
4,395,395,11,6,5,2,1
21,455,455,120,104,16,3,2
11,464,464,143,121,22,3,2
5,488,488,11,5,6,3,2
13,498,498,23,23,0,1,0

0,101,101,30,30,0,1,0
6,104,104,8,8,0,1,0
8,169,169,18,18,0,1,0
13,194,194,1,1,0,1,0
2,229,229,29,8,21,2,1
11,232,232,99,81,18,3,2
14,245,245,17,8,9,4,3
4,250,250,73,4,69,4,3
5,252,252,34,34,0,1,0
12,266,266,7,1,6,3,2
1,300,300,31,6,25,2,1
3,337,337,50,23,27,2,1
9,353,353,35,32,3,2,1
15,379,379,96,58,38,3,2
7,390,390,9,3,6,2,1
10,485,485,21,21,0,1,0

16,110,110,7,7,0,1,0
19,156,156,10,10,0,1,0
14,161,161,4,1,3,2,1
17,171,171,36,36,0,1,0
1,177,177,12,8,4,2,1
7,186,186,22,14,8,3,2
9,189,189,18,3,15,4,3
22,209,209,9,9,0,1,0
8,212,212,20,14,6,3,2
5,232,232,9,9,0,1,0
15,260,260,3,3,0,1,0
18,263,263,65,5,60,3,2
20,295,295,31,7,24,2,1
3,305,305,37,14,23,4,3
21,310,310,108,33,75,3,2
0,334,334,23,23,0,1,0
11,336,336,1,1,0,1,0
4,355,355,43,1,42,4,3
6,437,437,37,2,35,2,1
12,452,452,26,5,21,2,1
2,454,454,7,7,0,1,0
13,471,471,3,3,0,1,0
10,500,500,107,107,0,1,0

20,104,104,28,28,0,1,0
21,127,127,15,15,0,1,0
16,133,133,1,1,0,1,0
13,156,156,7,7,0,1,0
26,158,158,16,16,0,1,0
5,190,190,9,9,0,1,0
3,192,192,23,6,17,2,1
23,207,207,16,8,8,3,2
28,209,209,8,8,0,1,0
7,233,233,40,40,0,1,0
1,237,237,1,1,0,1,0
14,241,241,1,1,0,1,0
17,242,242,3,3,0,1,0
12,264,264,30,3,27,4,3
8,268,268,20,8,12,2,1
6,275,275,1,1,0,1,0
24,284,284,63,63,0,1,0
0,333,333,37,7,30,4,3
22,368,368,21,21,0,1,0
4,379,379,41,41,0,1,0
10,400,400,20,5,15,4,3
9,407,407,7,4,3,2,1
19,422,422,41,41,0,1,0
11,427,427,33,1,32,3,2
15,430,430,24,12,12,3,2
27,432,432,9,9,0,1,0
18,440,440,3,3,0,1,0
2,446,446,32,32,0,1,0
25,494,494,60,60,0,1,0

19,104,104,5,5,0,1,0
0,105,105,10,7,3,2,1
11,106,106,12,6,6,3,2
6,145,145,19,19,0,1,0
7,163,163,28,28,0,1,0
18,198,198,40,31,9,4,3
10,202,202,21,21,0,1,0
20,216,216,46,46,0,1,0
4,244,244,14,2,12,4,3
5,245,245,19,19,0,1,0
2,254,254,7,7,0,1,0
16,296,296,7,7,0,1,0
3,303,303,12,6,6,3,2
12,304,304,27,3,24,4,3
8,332,332,20,20,0,1,0
17,352,352,51,51,0,1,0
13,355,355,77,55,22,2,1
21,383,383,40,40,0,1,0
14,410,410,7,7,0,1,0
15,445,445,26,26,0,1,0
1,460,460,18,3,15,2,1
9,468,468,89,89,0,1,0

10,129,129,18,18,0,1,0
5,134,134,11,11,0,1,0
12,135,135,3,3,0,1,0
9,143,143,17,9,8,2,1
7,151,151,19,19,0,1,0
11,163,163,5,5,0,1,0
15,172,172,50,18,32,3,2
4,188,188,30,18,12,2,1
8,230,230,7,7,0,1,0
13,297,297,82,82,0,1,0
14,321,321,25,25,0,1,0
0,425,425,10,4,6,2,1
6,432,432,197,197,0,1,0
2,435,435,85,5,80,3,2
16,454,454,1,1,0,1,0
1,475,475,23,1,22,3,2
3,481,481,66,48,18,4,3

3,112,112,2,2,0,1,0
5,116,116,1,1,0,1,0
6,137,137,30,11,19,2,1
8,183,183,3,3,0,1,0
7,188,188,1,1,0,1,0
9,195,195,1,1,0,1,0
4,207,207,21,21,0,1,0
2,209,209,3,3,0,1,0
18,223,223,4,4,0,1,0
0,241,241,2,2,0,1,0
16,272,272,15,15,0,1,0
11,309,309,161,23,138,4,3
10,320,320,21,6,15,2,1
19,326,326,69,69,0,1,0
12,342,342,72,72,0,1,0
14,352,352,14,14,0,1,0
17,375,375,21,2,19,4,3
20,389,389,64,6,58,4,3
21,414,414,16,16,0,1,0
15,424,424,89,68,21,2,1
1,469,469,55,55,0,1,0
13,496,496,54,54,0,1,0

8,129,129,9,9,0,1,0
17,148,148,14,7,7,2,1
20,155,155,23,23,0,1,0
12,157,157,12,1,11,2,1
0,165,165,1,1,0,1,0
4,210,210,8,1,7,2,1
1,231,231,9,9,0,1,0
9,248,248,14,4,10,3,2
11,249,249,2,2,0,1,0
19,250,250,34,34,0,1,0
16,265,265,58,17,41,2,1
6,274,274,26,10,16,3,2
22,280,280,45,19,26,3,2
15,284,284,72,72,0,1,0
13,294,294,32,16,16,2,1
5,299,299,33,23,10,3,2
23,308,308,22,22,0,1,0
2,309,309,8,8,0,1,0
3,321,321,24,6,18,3,2
14,338,338,4,4,0,1,0
10,342,342,94,94,0,1,0
18,380,380,8,8,0,1,0
21,478,478,1,1,0,1,0
7,492,492,58,58,0,1,0

5,100,100,1,1,0,1,0
6,105,105,1,1,0,1,0
4,118,118,12,6,6,3,2
13,121,121,4,1,3,2,1
16,179,179,14,14,0,1,0
15,181,181,6,6,0,1,0
11,210,210,8,8,0,1,0
0,222,222,28,16,12,3,2
3,229,229,17,5,12,4,3
23,257,257,39,27,12,4,3
19,270,270,4,4,0,1,0
20,286,286,41,41,0,1,0
1,319,319,28,6,22,4,3
8,324,324,24,6,18,2,1
21,360,360,39,33,6,2,1
14,377,377,47,38,9,4,3
12,380,380,11,11,0,1,0
7,416,416,44,44,0,1,0
9,430,430,44,5,39,4,3
18,447,447,63,28,35,4,3
22,464,464,48,48,0,1,0
2,480,480,91,91,0,1,0
10,492,492,62,62,0,1,0
17,494,494,109,76,33,4,3

7,127,127,25,17,8,3,2
10,177,177,3,3,0,1,0
4,203,203,17,13,4,2,1
0,205,205,3,3,0,1,0
19,212,212,26,26,0,1,0
21,219,219,19,19,0,1,0
3,220,220,2,2,0,1,0
13,221,221,26,26,0,1,0
11,236,236,65,65,0,1,0
9,247,247,37,5,32,3,2
6,249,249,1,1,0,1,0
14,256,256,26,6,20,3,2
2,283,283,11,1,10,2,1
8,344,344,3,3,0,1,0
18,386,386,60,50,10,3,2
5,393,393,87,78,9,4,3
15,394,394,2,2,0,1,0
20,439,439,120,12,108,4,3
17,439,439,11,1,10,3,2
12,462,462,3,3,0,1,0
1,476,476,36,36,0,1,0
16,491,491,50,22,28,3,2
22,494,494,64,8,56,4,3

0,108,108,4,4,0,1,0
6,122,122,7,7,0,1,0
5,123,123,11,11,0,1,0
2,134,134,6,1,5,2,1
14,135,135,25,25,0,1,0
12,188,188,6,3,3,2,1
20,197,197,39,33,6,2,1
7,202,202,2,2,0,1,0
19,212,212,24,24,0,1,0
17,212,212,9,9,0,1,0
21,226,226,92,54,38,3,2
9,243,243,1,1,0,1,0
10,249,249,65,33,32,2,1
16,256,256,22,22,0,1,0
23,293,293,2,2,0,1,0
15,302,302,4,4,0,1,0
1,325,325,23,11,12,3,2
4,360,360,46,17,29,4,3
18,386,386,4,4,0,1,0
3,409,409,7,1,6,3,2
13,413,413,8,8,0,1,0
11,443,443,87,73,14,3,2
8,454,454,61,61,0,1,0
22,481,481,31,31,0,1,0

9,108,108,2,2,0,1,0
16,112,112,1,1,0,1,0
18,124,124,8,8,0,1,0
19,133,133,7,7,0,1,0
4,138,138,6,2,4,2,1
11,145,145,19,19,0,1,0
15,179,179,7,7,0,1,0
21,181,181,29,29,0,1,0
3,181,181,2,2,0,1,0
5,230,230,18,15,3,2,1
14,251,251,42,42,0,1,0
17,258,258,56,25,31,2,1
8,327,327,13,13,0,1,0
23,369,369,9,9,0,1,0
2,385,385,19,9,10,3,2
24,387,387,96,51,45,4,3
1,399,399,48,18,30,2,1
12,407,407,43,43,0,1,0
25,424,424,12,12,0,1,0
22,432,432,88,67,21,2,1
13,451,451,13,5,8,3,2
0,453,453,22,3,19,4,3
20,463,463,22,15,7,2,1
26,464,464,32,17,15,4,3
7,479,479,8,8,0,1,0
10,484,484,28,14,14,3,2
6,498,498,68,53,15,4,3

1,106,106,9,1,8,2,1
9,110,110,6,6,0,1,0
11,124,124,5,5,0,1,0
17,129,129,12,9,3,2,1
13,199,199,13,13,0,1,0
2,200,200,12,12,0,1,0
20,217,217,4,4,0,1,0
7,271,271,34,34,0,1,0
5,276,276,27,17,10,3,2
4,302,302,37,25,12,3,2
14,353,353,27,27,0,1,0
18,368,368,3,3,0,1,0
12,370,370,32,21,11,2,1
0,377,377,63,36,27,4,3
15,382,382,85,55,30,4,3
21,391,391,12,7,5,2,1
8,391,391,46,32,14,2,1
3,399,399,35,35,0,1,0
19,434,434,135,96,39,4,3
16,439,439,93,9,84,3,2
6,441,441,14,14,0,1,0
10,486,486,56,56,0,1,0

3,148,148,3,3,0,1,0
1,225,225,30,30,0,1,0
18,234,234,38,38,0,1,0
19,243,243,5,1,4,2,1
16,268,268,11,1,10,3,2
4,320,320,28,20,8,2,1
10,327,327,24,24,0,1,0
9,334,334,41,8,33,2,1
7,334,334,38,38,0,1,0
14,337,337,14,14,0,1,0
5,356,356,72,8,64,4,3
11,371,371,2,2,0,1,0
6,424,424,35,32,3,2,1
12,430,430,20,6,14,2,1
17,434,434,81,39,42,4,3
0,441,441,63,37,26,3,2
13,447,447,188,53,135,4,3
8,460,460,82,82,0,1,0
2,496,496,9,9,0,1,0
15,500,500,60,60,0,1,0

18,103,103,9,5,4,2,1
5,128,128,6,6,0,1,0
20,135,135,27,27,0,1,0
0,162,162,1,1,0,1,0
4,169,169,5,5,0,1,0
7,185,185,36,36,0,1,0
8,232,232,81,81,0,1,0
11,270,270,4,4,0,1,0
6,275,275,4,4,0,1,0
9,280,280,73,73,0,1,0
16,291,291,19,19,0,1,0
14,310,310,14,14,0,1,0
13,318,318,163,115,48,2,1
21,322,322,31,25,6,2,1
15,363,363,13,13,0,1,0
10,378,378,45,45,0,1,0
3,378,378,1,1,0,1,0
12,430,430,8,8,0,1,0
1,473,473,7,7,0,1,0
19,477,477,25,25,0,1,0
17,490,490,1,1,0,1,0
2,499,499,25,1,24,2,1

11,120,120,6,1,5,2,1
22,122,122,19,19,0,1,0
6,123,123,6,6,0,1,0
12,126,126,11,2,9,4,3
13,127,127,7,1,6,3,2
15,132,132,4,4,0,1,0
17,139,139,9,9,0,1,0
4,187,187,1,1,0,1,0
23,223,223,2,2,0,1,0
20,232,232,24,24,0,1,0
19,234,234,12,12,0,1,0
7,247,247,19,14,5,2,1
0,252,252,13,7,6,3,2
18,258,258,24,24,0,1,0
14,268,268,30,16,14,3,2
10,295,295,23,5,18,4,3
3,317,317,20,20,0,1,0
9,340,340,67,67,0,1,0
2,352,352,13,4,9,2,1
8,359,359,71,71,0,1,0
21,454,454,69,69,0,1,0
24,473,473,122,24,98,4,3
16,475,475,97,48,49,2,1
5,482,482,9,9,0,1,0
1,497,497,11,7,4,2,1

17,102,102,2,2,0,1,0
23,122,122,12,12,0,1,0
15,124,124,13,8,5,2,1
16,167,167,43,1,42,4,3
0,220,220,41,41,0,1,0
10,228,228,61,50,11,2,1
6,230,230,1,1,0,1,0
25,240,240,12,3,9,4,3
19,249,249,17,12,5,2,1
13,253,253,38,29,9,4,3
11,343,343,8,1,7,2,1
24,345,345,104,104,0,1,0
20,349,349,78,62,16,2,1
4,353,353,15,9,6,3,2
8,361,361,1,1,0,1,0
14,375,375,19,5,14,4,3
18,383,383,19,19,0,1,0
9,414,414,16,16,0,1,0
21,418,418,4,4,0,1,0
12,418,418,1,1,0,1,0
22,420,420,19,5,14,3,2
2,457,457,40,1,39,3,2
7,471,471,14,9,5,2,1
1,474,474,33,14,19,2,1
3,490,490,16,9,7,3,2
5,492,492,4,4,0,1,0

14,111,111,2,2,0,1,0
0,123,123,1,1,0,1,0
5,126,126,13,13,0,1,0
3,183,183,4,4,0,1,0
12,223,223,3,3,0,1,0
15,228,228,66,46,20,3,2
8,254,254,17,17,0,1,0
2,258,258,45,45,0,1,0
13,276,276,95,95,0,1,0
20,283,283,4,1,3,2,1
4,290,290,51,51,0,1,0
10,296,296,12,2,10,3,2
11,316,316,17,13,4,2,1
19,357,357,45,3,42,4,3
9,367,367,60,60,0,1,0
18,399,399,54,54,0,1,0
17,405,405,23,7,16,2,1
1,410,410,107,107,0,1,0
21,415,415,17,17,0,1,0
7,477,477,7,4,3,2,1
16,485,485,36,36,0,1,0
6,488,488,8,8,0,1,0

19,117,117,8,8,0,1,0
2,119,119,8,8,0,1,0
3,125,125,8,8,0,1,0
12,142,142,2,2,0,1,0
16,147,147,32,32,0,1,0
8,157,157,2,2,0,1,0
9,168,168,22,22,0,1,0
18,190,190,13,6,7,2,1
11,211,211,25,4,21,2,1
15,229,229,5,5,0,1,0
7,233,233,12,12,0,1,0
14,246,246,20,20,0,1,0
17,252,252,21,21,0,1,0
20,262,262,23,5,18,2,1
24,263,263,2,2,0,1,0
0,283,283,5,2,3,2,1
13,303,303,36,11,25,2,1
5,353,353,67,67,0,1,0
21,365,365,67,67,0,1,0
4,386,386,64,3,61,4,3
6,398,398,3,3,0,1,0
23,402,402,29,29,0,1,0
10,423,423,14,14,0,1,0
1,426,426,3,3,0,1,0
25,488,488,32,2,30,2,1
22,495,495,133,129,4,2,1

3,111,111,6,6,0,1,0
2,126,126,6,6,0,1,0
16,140,140,18,18,0,1,0
8,171,171,4,4,0,1,0
1,188,188,2,2,0,1,0
18,199,199,6,2,4,2,1
4,204,204,28,28,0,1,0
13,209,209,15,15,0,1,0
14,231,231,2,2,0,1,0
11,238,238,21,21,0,1,0
5,245,245,25,25,0,1,0
21,251,251,37,37,0,1,0
19,265,265,48,44,4,2,1
7,276,276,31,23,8,2,1
17,302,302,112,96,16,3,2
10,352,352,51,33,18,2,1
9,373,373,68,68,0,1,0
15,389,389,47,8,39,4,3
6,405,405,64,64,0,1,0
12,419,419,16,2,14,2,1
20,420,420,8,8,0,1,0
0,466,466,19,19,0,1,0

9,111,111,4,1,3,2,1
17,126,126,24,24,0,1,0
19,130,130,10,10,0,1,0
11,156,156,25,16,9,2,1
8,164,164,15,15,0,1,0
16,191,191,10,1,9,2,1
1,193,193,48,48,0,1,0
18,201,201,38,38,0,1,0
2,207,207,38,20,18,4,3
13,227,227,6,6,0,1,0
6,229,229,23,13,10,2,1
10,246,246,29,29,0,1,0
14,276,276,25,8,17,4,3
15,315,315,32,4,28,2,1
7,331,331,68,68,0,1,0
0,362,362,1,1,0,1,0
3,364,364,2,2,0,1,0
12,394,394,47,9,38,3,2
4,440,440,28,23,5,2,1
5,491,491,81,42,39,4,3

9,140,140,16,16,0,1,0
3,174,174,55,38,17,2,1
12,190,190,18,6,12,2,1
5,214,214,1,1,0,1,0
14,259,259,11,8,3,2,1
2,266,266,89,61,28,3,2
13,274,274,10,10,0,1,0
7,287,287,6,6,0,1,0
16,307,307,31,31,0,1,0
18,314,314,50,50,0,1,0
10,369,369,14,14,0,1,0
15,375,375,7,7,0,1,0
17,383,383,36,36,0,1,0
20,395,395,98,32,66,4,3
8,412,412,26,26,0,1,0
19,413,413,39,12,27,2,1
4,419,419,18,6,12,4,3
11,421,421,95,8,87,4,3
0,423,423,9,9,0,1,0
6,494,494,61,61,0,1,0
1,494,494,11,2,9,4,3

0,101,101,7,7,0,1,0
21,124,124,2,2,0,1,0
2,149,149,9,9,0,1,0
1,188,188,22,22,0,1,0
8,206,206,13,10,3,2,1
10,207,207,6,6,0,1,0
20,213,213,17,1,16,4,3
19,219,219,12,12,0,1,0
3,240,240,14,14,0,1,0
11,240,240,18,8,10,2,1
26,265,265,44,44,0,1,0
17,272,272,8,2,6,2,1
24,293,293,32,32,0,1,0
23,360,360,82,82,0,1,0
16,396,396,15,15,0,1,0
9,407,407,16,10,6,3,2
6,415,415,8,8,0,1,0
5,431,431,14,14,0,1,0
18,439,439,12,8,4,2,1
14,440,440,23,5,18,3,2
12,441,441,17,17,0,1,0
25,443,443,37,37,0,1,0
15,459,459,73,73,0,1,0
13,460,460,38,38,0,1,0
4,462,462,6,3,3,2,1
22,470,470,15,7,8,2,1
7,476,476,60,18,42,4,3
27,479,479,158,110,48,4,3

19,109,109,17,4,13,2,1
14,159,159,38,14,24,4,3
0,164,164,5,5,0,1,0
17,182,182,12,6,6,3,2
1,188,188,101,17,84,3,2
11,201,201,13,13,0,1,0
13,203,203,4,4,0,1,0
18,207,207,6,1,5,2,1
7,270,270,22,22,0,1,0
15,271,271,37,13,24,4,3
4,272,272,4,4,0,1,0
12,288,288,5,5,0,1,0
6,307,307,11,1,10,3,2
3,308,308,17,17,0,1,0
16,324,324,21,11,10,3,2
8,351,351,34,34,0,1,0
10,372,372,124,96,28,3,2
9,396,396,71,41,30,2,1
2,397,397,11,11,0,1,0
5,472,472,20,6,14,2,1

26,156,156,45,20,25,2,1
20,184,184,15,11,4,2,1
25,186,186,4,1,3,2,1
31,192,192,15,1,14,2,1
27,199,199,27,7,20,2,1
30,201,201,22,22,0,1,0
5,208,208,7,2,5,2,1
28,209,209,9,9,0,1,0
8,219,219,23,19,4,2,1
23,227,227,65,20,45,4,3
15,239,239,4,4,0,1,0
29,244,244,5,5,0,1,0
32,245,245,4,4,0,1,0
10,261,261,4,4,0,1,0
14,309,309,7,7,0,1,0
21,358,358,1,1,0,1,0
2,378,378,27,10,17,2,1
6,380,380,59,19,40,3,2
22,390,390,11,11,0,1,0
0,395,395,36,9,27,4,3
4,402,402,24,12,12,2,1
1,402,402,42,32,10,2,1
7,406,406,14,14,0,1,0
13,408,408,7,7,0,1,0
18,411,411,1,1,0,1,0
19,416,416,23,6,17,4,3
16,435,435,12,12,0,1,0
3,446,446,5,5,0,1,0
17,452,452,16,16,0,1,0
11,466,466,36,3,33,2,1
12,489,489,1,1,0,1,0
9,492,492,25,16,9,4,3
24,495,495,63,63,0,1,0

2,111,111,6,3,3,2,1
3,126,126,42,42,0,1,0
20,126,126,7,7,0,1,0
19,149,149,9,4,5,2,1
5,160,160,33,20,13,2,1
16,170,170,2,2,0,1,0
4,186,186,2,2,0,1,0
8,196,196,19,19,0,1,0
15,196,196,17,3,14,2,1
11,209,209,2,2,0,1,0
10,219,219,7,7,0,1,0
18,224,224,13,7,6,3,2
1,226,226,21,21,0,1,0
6,231,231,22,5,17,2,1
7,243,243,17,17,0,1,0
21,259,259,37,37,0,1,0
9,265,265,13,7,6,2,1
0,286,286,15,15,0,1,0
14,441,441,146,146,0,1,0
17,457,457,36,25,11,2,1
12,462,462,119,41,78,4,3
13,464,464,15,6,9,2,1

9,100,100,10,2,8,2,1
0,110,110,7,7,0,1,0
2,134,134,15,15,0,1,0
5,135,135,23,23,0,1,0
17,155,155,2,2,0,1,0
12,157,157,8,8,0,1,0
15,166,166,39,14,25,3,2
7,195,195,64,29,35,2,1
13,231,231,39,1,38,2,1
1,235,235,1,1,0,1,0
11,237,237,5,5,0,1,0
18,244,244,113,51,62,3,2
8,268,268,40,14,26,3,2
16,305,305,3,3,0,1,0
19,308,308,13,13,0,1,0
10,341,341,41,41,0,1,0
14,363,363,39,39,0,1,0
4,366,366,4,4,0,1,0
6,392,392,1,1,0,1,0
21,460,460,7,7,0,1,0
3,461,461,10,4,6,3,2
20,464,464,5,5,0,1,0

6,138,138,2,2,0,1,0
9,163,163,30,30,0,1,0
3,166,166,2,2,0,1,0
7,170,170,34,34,0,1,0
13,186,186,48,48,0,1,0
15,193,193,52,52,0,1,0
10,212,212,12,6,6,2,1
8,216,216,5,5,0,1,0
0,243,243,10,10,0,1,0
2,244,244,14,14,0,1,0
16,284,284,28,2,26,2,1
19,288,288,1,1,0,1,0
11,299,299,13,7,6,3,2
1,310,310,77,18,59,3,2
14,313,313,22,2,20,3,2
20,331,331,58,44,14,2,1
4,379,379,32,7,25,3,2
12,398,398,23,6,17,4,3
18,432,432,47,16,31,4,3
17,438,438,11,11,0,1,0
5,482,482,88,88,0,1,0

1,116,116,28,28,0,1,0
14,150,150,5,5,0,1,0
16,176,176,2,2,0,1,0
2,188,188,1,1,0,1,0
0,204,204,4,4,0,1,0
24,254,254,2,2,0,1,0
15,280,280,9,3,6,2,1
17,294,294,87,87,0,1,0
9,306,306,11,1,10,3,2
21,306,306,99,99,0,1,0
4,316,316,33,33,0,1,0
11,330,330,4,4,0,1,0
18,334,334,35,25,10,3,2
12,338,338,8,2,6,3,2
7,361,361,1,1,0,1,0
10,368,368,40,40,0,1,0
6,387,387,36,12,24,2,1
20,387,387,11,1,10,2,1
3,429,429,71,71,0,1,0
5,434,434,1,1,0,1,0
25,442,442,8,8,0,1,0
22,447,447,41,9,32,3,2
8,484,484,49,3,46,3,2
19,491,491,14,3,11,4,3
13,491,491,59,19,40,2,1
23,493,493,99,50,49,4,3

15,101,101,16,10,6,3,2
14,148,148,14,11,3,2,1
6,152,152,16,16,0,1,0
22,153,153,31,31,0,1,0
9,181,181,46,46,0,1,0
8,187,187,20,11,9,4,3
7,202,202,2,2,0,1,0
2,298,298,13,1,12,4,3
17,314,314,18,4,14,3,2
16,320,320,44,11,33,4,3
19,325,325,22,4,18,3,2
10,330,330,15,6,9,2,1
5,336,336,43,43,0,1,0
21,342,342,58,32,26,3,2
3,374,374,16,16,0,1,0
12,398,398,20,20,0,1,0
1,408,408,62,62,0,1,0
20,414,414,33,33,0,1,0
18,435,435,63,63,0,1,0
11,439,439,14,14,0,1,0
4,472,472,56,8,48,3,2
0,492,492,6,2,4,2,1
13,499,499,3,3,0,1,0

2,110,110,1,1,0,1,0
9,123,123,3,3,0,1,0
6,161,161,3,3,0,1,0
13,182,182,6,6,0,1,0
5,194,194,23,15,8,3,2
19,219,219,6,6,0,1,0
11,229,229,8,8,0,1,0
4,244,244,21,8,13,2,1
17,251,251,10,10,0,1,0
27,252,252,14,14,0,1,0
1,255,255,1,1,0,1,0
7,263,263,1,1,0,1,0
12,269,269,1,1,0,1,0
3,278,278,54,33,21,2,1
8,322,322,1,1,0,1,0
14,330,330,5,5,0,1,0
22,342,342,17,17,0,1,0
25,342,342,14,14,0,1,0
15,346,346,78,78,0,1,0
18,363,363,44,26,18,4,3
21,368,368,12,12,0,1,0
0,400,400,12,12,0,1,0
10,443,443,45,45,0,1,0
16,446,446,69,69,0,1,0
26,450,450,6,6,0,1,0
23,455,455,92,23,69,4,3
20,486,486,116,75,41,4,3
24,498,498,165,127,38,2,1

1,150,150,4,4,0,1,0
3,152,152,9,3,6,2,1
20,155,155,1,1,0,1,0
16,171,171,2,2,0,1,0
6,173,173,6,6,0,1,0
7,189,189,4,4,0,1,0
11,225,225,38,38,0,1,0
21,252,252,16,16,0,1,0
19,255,255,20,14,6,3,2
14,256,256,11,1,10,3,2
17,276,276,28,28,0,1,0
15,292,292,42,42,0,1,0
12,335,335,187,187,0,1,0
10,363,363,31,31,0,1,0
13,369,369,2,2,0,1,0
4,398,398,21,21,0,1,0
8,403,403,54,5,49,2,1
5,427,427,55,16,39,2,1
2,450,450,53,23,30,3,2
9,461,461,29,8,21,2,1
18,473,473,49,49,0,1,0
0,497,497,105,57,48,3,2

5,119,119,14,14,0,1,0
16,124,124,8,8,0,1,0
10,198,198,3,3,0,1,0
1,224,224,4,4,0,1,0
7,250,250,39,1,38,3,2
21,255,255,5,5,0,1,0
8,264,264,14,14,0,1,0
13,297,297,14,1,13,2,1
11,310,310,2,2,0,1,0
18,326,326,1,1,0,1,0
23,331,331,21,13,8,2,1
17,346,346,2,2,0,1,0
4,366,366,62,62,0,1,0
2,368,368,49,28,21,2,1
6,373,373,18,4,14,2,1
19,380,380,149,149,0,1,0
20,395,395,36,36,0,1,0
12,408,408,33,33,0,1,0
3,411,411,18,18,0,1,0
15,424,424,23,11,12,3,2
14,434,434,30,11,19,2,1
9,452,452,54,27,27,4,3
0,477,477,45,29,16,2,1
22,500,500,174,174,0,1,0

20,105,105,1,1,0,1,0
7,108,108,1,1,0,1,0
4,121,121,2,2,0,1,0
9,130,130,1,1,0,1,0
5,140,140,22,14,8,3,2
13,155,155,29,17,12,3,2
19,160,160,6,6,0,1,0
24,195,195,3,3,0,1,0
25,202,202,48,8,40,3,2
22,204,204,35,23,12,4,3
16,254,254,4,4,0,1,0
10,255,255,2,2,0,1,0
26,282,282,21,14,7,2,1
11,286,286,2,2,0,1,0
15,299,299,3,3,0,1,0
17,300,300,101,60,41,3,2
23,313,313,33,33,0,1,0
1,313,313,19,10,9,2,1
2,332,332,3,3,0,1,0
21,348,348,29,5,24,4,3
14,362,362,15,15,0,1,0
3,381,381,63,63,0,1,0
8,402,402,13,13,0,1,0
0,410,410,127,74,53,4,3
6,437,437,15,15,0,1,0
18,447,447,22,14,8,2,1
12,460,460,14,14,0,1,0

7,112,112,3,3,0,1,0
9,134,134,15,7,8,2,1
1,141,141,4,4,0,1,0
16,172,172,2,2,0,1,0
6,181,181,6,6,0,1,0
24,209,209,20,8,12,3,2
8,218,218,15,15,0,1,0
23,228,228,77,77,0,1,0
5,230,230,4,4,0,1,0
22,239,239,11,3,8,2,1
17,272,272,15,6,9,4,3
0,276,276,49,9,40,3,2
2,305,305,10,10,0,1,0
19,318,318,20,20,0,1,0
11,319,319,2,2,0,1,0
20,340,340,22,22,0,1,0
13,351,351,26,3,23,4,3
21,360,360,45,18,27,2,1
12,397,397,110,35,75,4,3
4,410,410,5,5,0,1,0
10,412,412,14,14,0,1,0
25,434,434,106,39,67,4,3
14,436,436,25,25,0,1,0
15,469,469,32,32,0,1,0
3,469,469,35,35,0,1,0
18,490,490,37,37,0,1,0

14,164,164,7,7,0,1,0
8,188,188,31,31,0,1,0
15,204,204,1,1,0,1,0
1,239,239,32,10,22,3,2
9,253,253,1,1,0,1,0
4,286,286,18,2,16,2,1
11,290,290,1,1,0,1,0
18,303,303,14,14,0,1,0
2,311,311,36,36,0,1,0
3,316,316,20,20,0,1,0
17,328,328,30,30,0,1,0
5,349,349,52,52,0,1,0
12,365,365,198,198,0,1,0
6,384,384,67,51,16,2,1
10,401,401,19,9,10,2,1
16,403,403,50,50,0,1,0
13,421,421,89,89,0,1,0
0,423,423,42,42,0,1,0
7,454,454,62,18,44,2,1

2,105,105,28,28,0,1,0
8,110,110,9,1,8,2,1
10,139,139,6,6,0,1,0
12,156,156,4,4,0,1,0
1,176,176,4,4,0,1,0
7,215,215,31,31,0,1,0
3,271,271,45,18,27,4,3
9,339,339,6,6,0,1,0
13,355,355,40,18,22,2,1
15,360,360,57,20,37,2,1
6,384,384,8,8,0,1,0
5,396,396,152,60,92,3,2
4,416,416,1,1,0,1,0
11,420,420,194,194,0,1,0
0,485,485,126,108,18,4,3
14,496,496,28,19,9,3,2

5,110,110,11,11,0,1,0
15,122,122,2,2,0,1,0
16,130,130,37,37,0,1,0
10,137,137,61,17,44,2,1
2,149,149,13,13,0,1,0
14,199,199,6,6,0,1,0
9,243,243,2,2,0,1,0
12,287,287,31,9,22,3,2
7,319,319,23,23,0,1,0
1,338,338,24,24,0,1,0
3,344,344,37,2,35,3,2
11,350,350,25,25,0,1,0
6,370,370,175,86,89,4,3
0,438,438,59,35,24,3,2
13,442,442,6,6,0,1,0
4,463,463,59,59,0,1,0
8,465,465,37,37,0,1,0

1,104,104,12,4,8,3,2
14,130,130,20,2,18,4,3
17,160,160,4,4,0,1,0
11,174,174,13,13,0,1,0
3,219,219,38,5,33,2,1
19,221,221,14,14,0,1,0
4,260,260,22,22,0,1,0
9,335,335,2,2,0,1,0
16,347,347,12,2,10,3,2
18,351,351,93,93,0,1,0
13,379,379,44,29,15,2,1
21,382,382,25,25,0,1,0
23,384,384,17,17,0,1,0
22,392,392,70,53,17,2,1
12,402,402,20,3,17,2,1
15,411,411,74,42,32,3,2
20,423,423,48,48,0,1,0
6,429,429,32,32,0,1,0
5,439,439,38,16,22,2,1
10,443,443,69,36,33,4,3
7,443,443,20,20,0,1,0
0,446,446,23,5,18,4,3
2,450,450,9,1,8,3,2
8,471,471,23,2,21,2,1

9,166,166,4,4,0,1,0
11,189,189,15,15,0,1,0
7,190,190,1,1,0,1,0
8,199,199,52,52,0,1,0
13,201,201,30,23,7,2,1
10,212,212,34,34,0,1,0
4,275,275,4,4,0,1,0
0,288,288,16,1,15,2,1
19,289,289,1,1,0,1,0
17,306,306,14,14,0,1,0
15,312,312,86,54,32,3,2
20,313,313,42,42,0,1,0
5,335,335,14,14,0,1,0
22,421,421,24,24,0,1,0
3,424,424,20,6,14,3,2
1,448,448,65,23,42,4,3
2,449,449,50,50,0,1,0
16,453,453,14,14,0,1,0
14,460,460,6,6,0,1,0
6,476,476,21,13,8,3,2
21,481,481,34,34,0,1,0
18,494,494,163,125,38,4,3
12,497,497,55,9,46,2,1

0,107,107,16,16,0,1,0
1,153,153,25,25,0,1,0
13,242,242,9,4,5,2,1
4,247,247,18,18,0,1,0
12,247,247,4,1,3,2,1
18,273,273,12,12,0,1,0
6,276,276,29,29,0,1,0
22,286,286,31,31,0,1,0
17,304,304,9,9,0,1,0
9,333,333,9,9,0,1,0
10,351,351,33,11,22,3,2
2,353,353,30,22,8,2,1
14,359,359,64,16,48,2,1
3,385,385,6,6,0,1,0
16,388,388,91,25,66,3,2
8,392,392,10,10,0,1,0
23,394,394,44,44,0,1,0
24,399,399,17,17,0,1,0
21,414,414,48,48,0,1,0
11,427,427,16,16,0,1,0
15,438,438,158,80,78,4,3
7,443,443,2,2,0,1,0
19,447,447,3,3,0,1,0
20,495,495,33,33,0,1,0
5,497,497,45,6,39,2,1

10,127,127,3,3,0,1,0
11,151,151,44,44,0,1,0
18,169,169,9,1,8,3,2
2,173,173,7,7,0,1,0
3,183,183,95,53,42,4,3
4,186,186,5,5,0,1,0
16,204,204,15,15,0,1,0
8,223,223,14,14,0,1,0
6,291,291,43,43,0,1,0
14,296,296,8,5,3,2,1
13,315,315,43,28,15,4,3
9,320,320,16,16,0,1,0
19,320,320,98,66,32,2,1
7,324,324,14,9,5,2,1
15,335,335,12,7,5,2,1
0,347,347,7,1,6,2,1
17,377,377,55,55,0,1,0
1,392,392,3,3,0,1,0
5,400,400,74,20,54,4,3
12,487,487,15,3,12,3,2

6,102,102,24,24,0,1,0
4,112,112,4,1,3,2,1
3,124,124,16,16,0,1,0
19,128,128,63,35,28,2,1
17,147,147,11,8,3,2,1
7,150,150,23,8,15,2,1
12,167,167,1,1,0,1,0
5,210,210,31,31,0,1,0
9,224,224,11,11,0,1,0
1,246,246,31,21,10,3,2
8,261,261,13,2,11,2,1
14,274,274,1,1,0,1,0
10,287,287,15,15,0,1,0
23,293,293,5,5,0,1,0
24,322,322,11,11,0,1,0
2,342,342,22,22,0,1,0
20,344,344,14,7,7,2,1
11,344,344,3,3,0,1,0
21,359,359,95,59,36,2,1
13,401,401,10,10,0,1,0
16,405,405,15,15,0,1,0
22,422,422,18,18,0,1,0
15,453,453,9,3,6,2,1
18,485,485,47,47,0,1,0
0,488,488,8,4,4,2,1

3,114,114,4,1,3,2,1
0,123,123,18,18,0,1,0
13,155,155,7,4,3,2,1
11,168,168,2,2,0,1,0
5,197,197,13,13,0,1,0
16,198,198,43,43,0,1,0
1,226,226,36,8,28,2,1
6,231,231,6,6,0,1,0
14,234,234,105,105,0,1,0
2,324,324,111,111,0,1,0
8,346,346,22,4,18,2,1
4,353,353,115,45,70,4,3
12,362,362,82,82,0,1,0
9,365,365,3,3,0,1,0
7,382,382,12,12,0,1,0
10,459,459,25,7,18,4,3
15,461,461,5,5,0,1,0

19,132,132,4,1,3,2,1
23,157,157,15,5,10,3,2
4,159,159,10,10,0,1,0
9,162,162,13,9,4,2,1
13,167,167,14,2,12,2,1
5,180,180,12,12,0,1,0
1,182,182,42,42,0,1,0
3,213,213,9,9,0,1,0
15,243,243,11,1,10,3,2
16,245,245,34,34,0,1,0
6,249,249,1,1,0,1,0
20,299,299,8,5,3,2,1
0,335,335,52,4,48,4,3
7,354,354,39,39,0,1,0
17,357,357,57,57,0,1,0
18,362,362,18,2,16,2,1
22,369,369,134,134,0,1,0
21,380,380,15,15,0,1,0
2,383,383,48,36,12,2,1
8,402,402,25,7,18,4,3
11,424,424,2,2,0,1,0
14,425,425,71,62,9,4,3
10,429,429,14,3,11,2,1
12,491,491,21,21,0,1,0

17,113,113,5,5,0,1,0
23,116,116,2,2,0,1,0
24,144,144,12,1,11,2,1
20,186,186,15,15,0,1,0
11,196,196,4,4,0,1,0
14,209,209,16,3,13,2,1
10,211,211,18,2,16,2,1
1,214,214,11,3,8,2,1
6,238,238,33,8,25,2,1
2,256,256,1,1,0,1,0
16,256,256,40,4,36,4,3
13,260,260,5,5,0,1,0
26,267,267,35,25,10,4,3
5,296,296,10,10,0,1,0
19,302,302,28,28,0,1,0
27,311,311,6,1,5,2,1
22,313,313,138,57,81,4,3
8,324,324,17,9,8,2,1
12,334,334,40,10,30,2,1
3,344,344,6,6,0,1,0
7,353,353,4,4,0,1,0
4,358,358,30,30,0,1,0
0,396,396,22,22,0,1,0
25,402,402,26,18,8,3,2
15,403,403,28,28,0,1,0
21,452,452,41,9,32,3,2
28,454,454,45,16,29,2,1
9,480,480,1,1,0,1,0
18,486,486,29,29,0,1,0

1,102,102,5,1,4,2,1
12,103,103,40,40,0,1,0
5,121,121,8,8,0,1,0
10,132,132,3,3,0,1,0
2,154,154,13,13,0,1,0
6,162,162,27,27,0,1,0
3,175,175,19,8,11,2,1
11,195,195,6,1,5,2,1
7,196,196,10,2,8,3,2
0,205,205,10,4,6,3,2
9,242,242,55,16,39,4,3
17,285,285,3,3,0,1,0
4,300,300,135,135,0,1,0
14,330,330,9,9,0,1,0
18,338,338,20,20,0,1,0
15,342,342,42,42,0,1,0
16,357,357,52,52,0,1,0
13,417,417,38,38,0,1,0
8,468,468,36,36,0,1,0

16,102,102,7,1,6,3,2
18,131,131,3,3,0,1,0
24,209,209,1,1,0,1,0
13,264,264,6,6,0,1,0
8,283,283,2,2,0,1,0
7,289,289,8,5,3,2,1
12,293,293,49,25,24,2,1
22,318,318,22,4,18,4,3
3,324,324,8,5,3,2,1
20,335,335,92,12,80,3,2
9,365,365,4,1,3,2,1
4,368,368,25,10,15,2,1
1,371,371,4,4,0,1,0
0,424,424,22,6,16,3,2
15,427,427,50,7,43,2,1
6,436,436,46,4,42,4,3
21,437,437,123,51,72,4,3
10,442,442,41,41,0,1,0
23,451,451,16,7,9,4,3
14,469,469,62,26,36,4,3
11,479,479,60,15,45,3,2
5,490,490,2,2,0,1,0
19,491,491,112,112,0,1,0
2,492,492,123,69,54,3,2
17,496,496,7,3,4,2,1

22,129,129,4,4,0,1,0
9,162,162,22,13,9,2,1
8,162,162,16,10,6,3,2
3,233,233,21,21,0,1,0
6,248,248,1,1,0,1,0
12,266,266,42,42,0,1,0
5,266,266,1,1,0,1,0
19,268,268,28,28,0,1,0
16,282,282,37,37,0,1,0
7,290,290,1,1,0,1,0
11,310,310,14,2,12,4,3
4,313,313,1,1,0,1,0
17,323,323,19,19,0,1,0
20,327,327,72,18,54,4,3
13,333,333,37,37,0,1,0
1,343,343,63,63,0,1,0
18,419,419,35,35,0,1,0
15,433,433,122,109,13,2,1
21,433,433,18,18,0,1,0
2,436,436,113,107,6,2,1
14,456,456,26,7,19,2,1
0,472,472,25,16,9,4,3
10,499,499,31,10,21,3,2

9,106,106,7,7,0,1,0
11,106,106,2,2,0,1,0
14,109,109,14,14,0,1,0
10,144,144,15,15,0,1,0
5,162,162,9,2,7,2,1
4,168,168,6,6,0,1,0
6,188,188,5,1,4,2,1
1,227,227,38,38,0,1,0
2,270,270,42,42,0,1,0
12,312,312,9,9,0,1,0
16,313,313,57,57,0,1,0
8,342,342,4,4,0,1,0
7,348,348,168,63,105,4,3
15,405,405,3,3,0,1,0
17,447,447,89,82,7,2,1
0,456,456,42,42,0,1,0
18,464,464,81,81,0,1,0
3,473,473,35,35,0,1,0
13,496,496,105,19,86,3,2

3,113,113,1,1,0,1,0
14,135,135,18,18,0,1,0
21,168,168,78,78,0,1,0
10,194,194,47,47,0,1,0
22,197,197,6,6,0,1,0
12,200,200,14,14,0,1,0
7,249,249,4,4,0,1,0
0,261,261,24,24,0,1,0
1,273,273,2,2,0,1,0
15,324,324,4,4,0,1,0
16,355,355,14,14,0,1,0
6,362,362,66,31,35,4,3
17,373,373,15,3,12,3,2
20,373,373,17,6,11,2,1
5,398,398,46,46,0,1,0
2,410,410,1,1,0,1,0
8,420,420,7,1,6,3,2
4,436,436,7,1,6,3,2
9,437,437,133,71,62,3,2
13,437,437,47,47,0,1,0
19,449,449,44,13,31,2,1
11,453,453,12,12,0,1,0
18,495,495,72,28,44,2,1

27,100,100,5,5,0,1,0
18,106,106,3,3,0,1,0
10,125,125,2,2,0,1,0
2,133,133,11,1,10,2,1
1,138,138,12,12,0,1,0
28,152,152,7,7,0,1,0
20,167,167,2,2,0,1,0
17,181,181,15,15,0,1,0
16,197,197,1,1,0,1,0
22,199,199,39,39,0,1,0
24,201,201,50,11,39,2,1
11,209,209,9,9,0,1,0
6,214,214,4,1,3,2,1
9,234,234,16,16,0,1,0
25,239,239,68,68,0,1,0
15,249,249,6,6,0,1,0
7,264,264,12,3,9,2,1
23,272,272,2,2,0,1,0
3,290,290,2,2,0,1,0
5,292,292,39,2,37,2,1
14,294,294,22,11,11,2,1
8,372,372,8,8,0,1,0
13,376,376,12,12,0,1,0
4,399,399,7,1,6,2,1
0,418,418,96,40,56,3,2
12,424,424,35,35,0,1,0
19,444,444,61,61,0,1,0
26,460,460,49,49,0,1,0
21,474,474,18,13,5,2,1

9,111,111,10,10,0,1,0
8,114,114,16,2,14,2,1
12,123,123,5,5,0,1,0
10,135,135,8,1,7,2,1
15,148,148,5,2,3,2,1
0,181,181,15,15,0,1,0
13,189,189,34,3,31,3,2
6,201,201,29,21,8,2,1
5,216,216,28,10,18,2,1
3,254,254,10,2,8,2,1
11,271,271,78,28,50,3,2
14,274,274,15,1,14,2,1
1,279,279,105,15,90,3,2
2,348,348,75,75,0,1,0
7,438,438,79,79,0,1,0
4,445,445,51,22,29,2,1
16,482,482,29,14,15,4,3

21,101,101,14,3,11,2,1
20,119,119,21,21,0,1,0
9,136,136,7,7,0,1,0
8,187,187,1,1,0,1,0
1,198,198,14,4,10,2,1
6,199,199,11,8,3,2,1
13,206,206,14,14,0,1,0
10,222,222,4,4,0,1,0
12,255,255,42,42,0,1,0
17,265,265,30,30,0,1,0
7,281,281,15,15,0,1,0
16,293,293,39,17,22,2,1
15,325,325,12,12,0,1,0
19,365,365,7,7,0,1,0
3,367,367,31,31,0,1,0
0,407,407,14,14,0,1,0
2,423,423,116,64,52,3,2
4,429,429,15,10,5,2,1
5,437,437,172,148,24,4,3
11,449,449,11,2,9,4,3
14,450,450,45,29,16,3,2
18,490,490,83,35,48,2,1

1,112,112,16,4,12,4,3
13,113,113,5,5,0,1,0
4,154,154,35,21,14,2,1
18,193,193,35,7,28,2,1
2,196,196,4,4,0,1,0
7,240,240,3,3,0,1,0
15,244,244,12,12,0,1,0
16,256,256,13,13,0,1,0
12,287,287,14,14,0,1,0
22,347,347,26,26,0,1,0
17,358,358,41,15,26,3,2
8,400,400,6,6,0,1,0
9,414,414,75,75,0,1,0
10,422,422,1,1,0,1,0
19,439,439,51,3,48,4,3
20,447,447,11,11,0,1,0
14,448,448,193,166,27,4,3
0,451,451,1,1,0,1,0
5,471,471,26,4,22,3,2
6,477,477,99,15,84,3,2
11,478,478,16,16,0,1,0
3,480,480,73,73,0,1,0
21,492,492,18,3,15,2,1

21,100,100,11,11,0,1,0
14,111,111,30,30,0,1,0
8,123,123,1,1,0,1,0
17,141,141,14,14,0,1,0
10,177,177,14,14,0,1,0
7,200,200,36,36,0,1,0
18,205,205,3,3,0,1,0
11,212,212,55,55,0,1,0
1,241,241,2,2,0,1,0
6,242,242,29,15,14,3,2
0,259,259,11,11,0,1,0
9,272,272,26,13,13,2,1
3,286,286,11,3,8,3,2
13,290,290,82,31,51,3,2
20,297,297,6,6,0,1,0
16,303,303,6,6,0,1,0
2,304,304,7,7,0,1,0
19,324,324,4,4,0,1,0
12,330,330,4,4,0,1,0
5,381,381,77,77,0,1,0
4,430,430,19,13,6,3,2
15,432,432,119,75,44,4,3

0,115,115,26,26,0,1,0
4,132,132,4,4,0,1,0
17,186,186,11,11,0,1,0
7,187,187,16,1,15,2,1
11,187,187,2,2,0,1,0
12,193,193,12,6,6,2,1
21,234,234,10,10,0,1,0
14,234,234,25,7,18,3,2
2,241,241,34,13,21,4,3
8,251,251,2,2,0,1,0
13,268,268,131,131,0,1,0
1,279,279,21,14,7,2,1
16,285,285,38,5,33,2,1
3,321,321,67,26,41,2,1
20,364,364,23,3,20,3,2
19,367,367,25,15,10,3,2
5,400,400,5,5,0,1,0
10,403,403,48,48,0,1,0
6,419,419,45,38,7,2,1
15,435,435,18,18,0,1,0
18,447,447,22,17,5,2,1
22,477,477,28,28,0,1,0
9,480,480,7,7,0,1,0

1,102,102,5,5,0,1,0
5,146,146,15,15,0,1,0
4,168,168,18,3,15,2,1
13,169,169,25,1,24,3,2
14,170,170,5,5,0,1,0
18,172,172,15,15,0,1,0
7,176,176,17,6,11,2,1
22,202,202,30,30,0,1,0
11,225,225,4,4,0,1,0
10,240,240,17,5,12,2,1
15,272,272,36,16,20,3,2
3,329,329,14,14,0,1,0
2,333,333,1,1,0,1,0
16,337,337,44,44,0,1,0
6,366,366,123,123,0,1,0
19,421,421,67,34,33,2,1
17,424,424,23,23,0,1,0
12,429,429,13,1,12,4,3
20,431,431,55,55,0,1,0
8,453,453,54,20,34,2,1
9,476,476,56,56,0,1,0
0,496,496,4,4,0,1,0
21,499,499,51,7,44,3,2

0,101,101,3,3,0,1,0
23,105,105,18,11,7,2,1
13,134,134,2,2,0,1,0
18,135,135,29,29,0,1,0
7,141,141,29,29,0,1,0
21,181,181,5,5,0,1,0
12,190,190,23,2,21,2,1
24,193,193,15,4,11,2,1
9,201,201,18,10,8,3,2
3,202,202,19,19,0,1,0
10,210,210,67,67,0,1,0
19,234,234,22,22,0,1,0
17,241,241,52,40,12,2,1
2,256,256,8,8,0,1,0
8,288,288,6,6,0,1,0
16,327,327,60,34,26,3,2
22,328,328,2,2,0,1,0
4,339,339,22,22,0,1,0
14,346,346,20,6,14,2,1
11,370,370,5,5,0,1,0
1,371,371,12,12,0,1,0
6,374,374,2,2,0,1,0
20,386,386,8,3,5,2,1
15,497,497,54,4,50,2,1
5,498,498,1,1,0,1,0

6,144,144,10,10,0,1,0
10,160,160,15,3,12,3,2
13,191,191,6,6,0,1,0
14,200,200,47,13,34,2,1
7,214,214,16,16,0,1,0
5,240,240,1,1,0,1,0
11,248,248,5,5,0,1,0
2,251,251,32,1,31,3,2
1,310,310,145,75,70,4,3
3,319,319,51,29,22,3,2
12,322,322,118,29,89,4,3
9,333,333,44,10,34,3,2
0,424,424,105,105,0,1,0
8,430,430,42,42,0,1,0
4,454,454,45,23,22,2,1

1,131,131,17,17,0,1,0
6,221,221,3,3,0,1,0
3,245,245,100,1,99,4,3
9,249,249,32,32,0,1,0
16,289,289,27,27,0,1,0
7,352,352,39,11,28,3,2
10,356,356,25,25,0,1,0
0,367,367,10,10,0,1,0
14,403,403,65,18,47,2,1
4,417,417,22,22,0,1,0
12,433,433,106,106,0,1,0
13,433,433,26,26,0,1,0
5,440,440,155,109,46,4,3
11,453,453,37,37,0,1,0
2,465,465,55,11,44,2,1
8,477,477,61,12,49,2,1
15,482,482,19,7,12,3,2

12,113,113,37,31,6,2,1
0,119,119,21,2,19,2,1
6,129,129,1,1,0,1,0
14,130,130,1,1,0,1,0
18,137,137,9,2,7,2,1
13,180,180,1,1,0,1,0
17,198,198,20,5,15,2,1
3,236,236,2,2,0,1,0
11,239,239,7,7,0,1,0
19,257,257,32,19,13,2,1
5,279,279,6,6,0,1,0
16,284,284,25,25,0,1,0
21,308,308,14,14,0,1,0
22,339,339,102,102,0,1,0
23,340,340,12,12,0,1,0
1,346,346,89,17,72,4,3
8,354,354,17,9,8,2,1
4,357,357,11,11,0,1,0
10,360,360,9,9,0,1,0
7,376,376,11,11,0,1,0
2,401,401,36,36,0,1,0
15,458,458,11,11,0,1,0
20,458,458,151,151,0,1,0
9,490,490,22,22,0,1,0

0,124,124,1,1,0,1,0
25,139,139,1,1,0,1,0
2,144,144,14,14,0,1,0
11,192,192,23,1,22,3,2
4,205,205,1,1,0,1,0
7,210,210,23,14,9,2,1
1,253,253,43,2,41,3,2
9,254,254,49,13,36,3,2
16,296,296,108,108,0,1,0
8,353,353,32,32,0,1,0
15,365,365,1,1,0,1,0
3,375,375,4,1,3,2,1
19,386,386,54,54,0,1,0
17,399,399,8,8,0,1,0
20,399,399,6,6,0,1,0
5,402,402,11,11,0,1,0
10,421,421,14,14,0,1,0
22,423,423,129,27,102,4,3
23,426,426,17,1,16,3,2
13,453,453,35,35,0,1,0
14,456,456,36,36,0,1,0
21,458,458,21,15,6,2,1
24,459,459,27,18,9,4,3
18,464,464,56,28,28,2,1
6,469,469,25,25,0,1,0
12,496,496,12,4,8,2,1

7,121,121,16,16,0,1,0
15,193,193,11,7,4,2,1
1,236,236,63,46,17,2,1
8,271,271,1,1,0,1,0
0,328,328,33,33,0,1,0
12,336,336,80,34,46,3,2
9,346,346,5,5,0,1,0
2,347,347,38,2,36,3,2
16,406,406,31,31,0,1,0
5,414,414,12,3,9,4,3
6,431,431,92,70,22,2,1
3,432,432,48,48,0,1,0
14,444,444,12,12,0,1,0
4,448,448,121,16,105,4,3
13,453,453,47,47,0,1,0
11,465,465,79,9,70,3,2
10,466,466,141,54,87,4,3

5,107,107,6,6,0,1,0
26,118,118,47,47,0,1,0
16,162,162,1,1,0,1,0
19,199,199,1,1,0,1,0
14,201,201,11,11,0,1,0
15,237,237,9,9,0,1,0
17,240,240,25,7,18,3,2
10,269,269,11,11,0,1,0
2,277,277,10,10,0,1,0
23,281,281,6,6,0,1,0
0,283,283,1,1,0,1,0
13,306,306,10,6,4,2,1
1,308,308,1,1,0,1,0
12,323,323,71,71,0,1,0
9,324,324,65,65,0,1,0
25,331,331,11,11,0,1,0
11,351,351,1,1,0,1,0
7,352,352,11,4,7,2,1
28,377,377,3,3,0,1,0
4,379,379,24,18,6,2,1
6,382,382,7,7,0,1,0
22,407,407,45,28,17,2,1
20,408,408,38,38,0,1,0
29,417,417,56,10,46,2,1
8,428,428,54,54,0,1,0
27,429,429,100,28,72,3,2
18,430,430,11,11,0,1,0
21,446,446,17,1,16,2,1
24,486,486,21,21,0,1,0
3,491,491,16,16,0,1,0

24,106,106,13,4,9,2,1
7,122,122,3,3,0,1,0
2,133,133,4,4,0,1,0
22,155,155,17,1,16,2,1
0,162,162,21,1,20,3,2
9,188,188,1,1,0,1,0
10,195,195,17,12,5,2,1
11,239,239,1,1,0,1,0
6,250,250,34,34,0,1,0
15,251,251,14,14,0,1,0
8,264,264,2,2,0,1,0
1,266,266,1,1,0,1,0
3,274,274,59,14,45,3,2
12,311,311,37,37,0,1,0
18,338,338,18,3,15,4,3
13,354,354,11,11,0,1,0
5,359,359,102,102,0,1,0
20,360,360,11,11,0,1,0
17,366,366,133,133,0,1,0
19,374,374,61,55,6,2,1
4,410,410,9,3,6,3,2
21,441,441,28,15,13,2,1
16,443,443,60,60,0,1,0
23,464,464,13,13,0,1,0
14,479,479,1,1,0,1,0

5,116,116,10,10,0,1,0
3,130,130,23,5,18,4,3
12,204,204,5,5,0,1,0
1,227,227,11,5,6,3,2
0,236,236,65,65,0,1,0
13,257,257,10,10,0,1,0
8,264,264,4,4,0,1,0
11,273,273,18,11,7,2,1
19,339,339,76,76,0,1,0
10,358,358,23,16,7,2,1
17,388,388,39,39,0,1,0
6,393,393,5,5,0,1,0
20,396,396,20,20,0,1,0
7,396,396,50,50,0,1,0
9,422,422,19,1,18,2,1
2,434,434,12,4,8,2,1
15,437,437,29,2,27,4,3
18,458,458,9,9,0,1,0
4,472,472,106,106,0,1,0
16,472,472,205,205,0,1,0
14,477,477,41,41,0,1,0

12,102,102,3,3,0,1,0
8,104,104,7,7,0,1,0
16,108,108,20,2,18,3,2
18,136,136,4,4,0,1,0
6,161,161,14,14,0,1,0
13,161,161,20,20,0,1,0
11,171,171,18,3,15,2,1
3,190,190,2,2,0,1,0
14,245,245,97,7,90,4,3
5,286,286,38,38,0,1,0
20,298,298,2,2,0,1,0
15,322,322,41,41,0,1,0
10,338,338,16,16,0,1,0
9,342,342,13,13,0,1,0
7,371,371,36,21,15,4,3
1,375,375,31,1,30,4,3
22,403,403,6,6,0,1,0
21,426,426,61,41,20,3,2
17,444,444,7,7,0,1,0
19,445,445,34,21,13,2,1
4,471,471,36,12,24,2,1
2,478,478,103,103,0,1,0
0,497,497,59,27,32,4,3

4,122,122,1,1,0,1,0
17,123,123,8,8,0,1,0
7,129,129,7,7,0,1,0
23,133,133,50,50,0,1,0
15,140,140,5,5,0,1,0
5,145,145,14,14,0,1,0
19,147,147,1,1,0,1,0
0,165,165,5,5,0,1,0
6,184,184,12,12,0,1,0
20,233,233,8,8,0,1,0
14,236,236,1,1,0,1,0
27,250,250,42,42,0,1,0
12,269,269,34,34,0,1,0
1,273,273,5,2,3,2,1
26,277,277,5,5,0,1,0
8,278,278,10,10,0,1,0
24,294,294,5,5,0,1,0
2,299,299,20,20,0,1,0
9,328,328,8,8,0,1,0
13,332,332,2,2,0,1,0
10,342,342,44,4,40,3,2
29,346,346,4,4,0,1,0
3,349,349,32,32,0,1,0
21,366,366,32,32,0,1,0
30,366,366,113,35,78,4,3
11,422,422,54,48,6,3,2
25,422,422,11,4,7,2,1
16,447,447,11,11,0,1,0
22,448,448,15,15,0,1,0
18,454,454,22,22,0,1,0
28,472,472,34,24,10,3,2

3,152,152,37,16,21,2,1
2,240,240,14,14,0,1,0
13,255,255,18,10,8,3,2
8,287,287,7,1,6,3,2
11,303,303,5,5,0,1,0
4,314,314,42,30,12,4,3
7,355,355,84,45,39,2,1
1,357,357,154,154,0,1,0
14,375,375,34,34,0,1,0
6,386,386,60,9,51,4,3
0,398,398,11,11,0,1,0
12,425,425,37,7,30,4,3
15,427,427,18,6,12,2,1
9,428,428,98,98,0,1,0
5,469,469,97,27,70,4,3
10,475,475,77,51,26,2,1

22,131,131,16,4,12,2,1
5,152,152,1,1,0,1,0
17,196,196,8,8,0,1,0
16,218,218,23,23,0,1,0
14,222,222,17,17,0,1,0
21,240,240,2,2,0,1,0
15,242,242,24,24,0,1,0
23,252,252,53,6,47,2,1
0,254,254,35,17,18,3,2
4,254,254,38,38,0,1,0
24,257,257,6,6,0,1,0
12,292,292,1,1,0,1,0
9,306,306,38,8,30,4,3
19,363,363,11,11,0,1,0
10,379,379,5,5,0,1,0
1,382,382,26,10,16,2,1
3,412,412,7,2,5,2,1
20,416,416,33,9,24,3,2
13,418,418,14,2,12,2,1
8,442,442,160,49,111,4,3
7,449,449,17,7,10,3,2
6,455,455,4,4,0,1,0
11,463,463,24,24,0,1,0
18,471,471,193,160,33,4,3
2,491,491,5,5,0,1,0

7,105,105,15,5,10,3,2
6,115,115,7,2,5,2,1
12,131,131,5,5,0,1,0
17,147,147,77,77,0,1,0
2,169,169,3,3,0,1,0
24,177,177,12,2,10,2,1
19,189,189,14,7,7,2,1
15,199,199,3,3,0,1,0
20,236,236,3,3,0,1,0
5,248,248,12,6,6,3,2
10,254,254,62,13,49,4,3
16,257,257,42,30,12,4,3
3,281,281,23,9,14,2,1
11,317,317,27,27,0,1,0
22,317,317,44,12,32,2,1
23,338,338,8,3,5,2,1
0,346,346,23,19,4,2,1
13,389,389,6,6,0,1,0
18,406,406,28,28,0,1,0
14,419,419,2,2,0,1,0
9,452,452,17,7,10,3,2
8,453,453,42,22,20,2,1
4,466,466,22,22,0,1,0
21,479,479,15,1,14,3,2
1,484,484,57,57,0,1,0

1,126,126,6,6,0,1,0
7,157,157,7,2,5,2,1
5,179,179,5,2,3,2,1
16,187,187,18,18,0,1,0
3,188,188,11,1,10,4,3
12,221,221,51,11,40,3,2
2,225,225,14,14,0,1,0
0,235,235,89,18,71,3,2
15,256,256,19,19,0,1,0
8,278,278,27,27,0,1,0
20,285,285,43,43,0,1,0
14,336,336,13,13,0,1,0
9,344,344,1,1,0,1,0
13,358,358,74,54,20,2,1
17,367,367,12,12,0,1,0
10,395,395,57,24,33,3,2
19,406,406,14,1,13,2,1
6,430,430,3,3,0,1,0
11,447,447,34,21,13,2,1
4,473,473,109,66,43,2,1
18,481,481,82,82,0,1,0

12,110,110,24,24,0,1,0
6,164,164,7,3,4,2,1
14,183,183,7,1,6,2,1
1,187,187,32,16,16,2,1
0,192,192,3,3,0,1,0
9,207,207,4,4,0,1,0
2,253,253,6,3,3,2,1
13,294,294,14,4,10,2,1
5,300,300,104,2,102,4,3
17,351,351,18,4,14,3,2
16,353,353,28,4,24,4,3
3,380,380,16,4,12,2,1
7,394,394,59,43,16,3,2
15,394,394,47,11,36,4,3
4,405,405,119,119,0,1,0
10,418,418,6,6,0,1,0
11,439,439,226,94,132,4,3
18,474,474,8,8,0,1,0
8,480,480,7,1,6,3,2

13,109,109,16,16,0,1,0
17,110,110,9,9,0,1,0
9,117,117,1,1,0,1,0
6,168,168,1,1,0,1,0
22,175,175,7,7,0,1,0
24,189,189,87,41,46,4,3
12,229,229,29,8,21,4,3
0,230,230,12,12,0,1,0
11,233,233,2,2,0,1,0
4,252,252,34,34,0,1,0
7,256,256,4,1,3,2,1
15,283,283,14,9,5,2,1
1,293,293,15,1,14,2,1
10,297,297,26,18,8,2,1
19,298,298,12,3,9,4,3
20,302,302,26,8,18,2,1
18,329,329,7,7,0,1,0
16,393,393,37,23,14,2,1
8,403,403,20,20,0,1,0
23,413,413,20,5,15,2,1
14,436,436,60,40,20,2,1
3,439,439,52,6,46,2,1
5,445,445,40,33,7,2,1
21,485,485,100,65,35,4,3
2,500,500,34,34,0,1,0

7,126,126,35,35,0,1,0
6,134,134,45,25,20,3,2
1,139,139,21,13,8,3,2
8,139,139,2,2,0,1,0
11,144,144,18,18,0,1,0
9,151,151,10,10,0,1,0
5,163,163,2,2,0,1,0
17,164,164,4,4,0,1,0
10,182,182,17,17,0,1,0
13,323,323,2,2,0,1,0
12,350,350,181,181,0,1,0
4,384,384,67,33,34,4,3
18,386,386,55,55,0,1,0
14,401,401,14,14,0,1,0
3,444,444,14,1,13,2,1
2,463,463,12,12,0,1,0
0,473,473,38,24,14,2,1
16,474,474,12,12,0,1,0
15,496,496,41,41,0,1,0

11,113,113,1,1,0,1,0
8,130,130,5,5,0,1,0
2,130,130,17,4,13,2,1
1,149,149,9,3,6,3,2
15,202,202,3,3,0,1,0
17,205,205,13,13,0,1,0
18,223,223,5,5,0,1,0
7,276,276,51,51,0,1,0
16,280,280,73,73,0,1,0
6,284,284,17,17,0,1,0
12,339,339,44,44,0,1,0
9,358,358,32,32,0,1,0
10,382,382,20,20,0,1,0
14,438,438,36,25,11,2,1
4,440,440,6,6,0,1,0
0,458,458,31,5,26,3,2
13,458,458,179,67,112,4,3
5,483,483,237,126,111,4,3
3,497,497,28,22,6,3,2

11,109,109,1,1,0,1,0
5,157,157,7,7,0,1,0
18,159,159,20,11,9,2,1
2,184,184,28,14,14,3,2
23,193,193,1,1,0,1,0
13,203,203,11,5,6,2,1
1,223,223,10,10,0,1,0
17,227,227,27,27,0,1,0
4,230,230,28,4,24,3,2
14,234,234,19,7,12,4,3
7,237,237,1,1,0,1,0
12,272,272,61,29,32,3,2
21,276,276,93,11,82,3,2
16,294,294,43,34,9,2,1
9,316,316,4,1,3,2,1
20,339,339,5,5,0,1,0
10,366,366,50,50,0,1,0
19,387,387,55,55,0,1,0
22,424,424,40,33,7,2,1
3,427,427,39,39,0,1,0
8,452,452,35,35,0,1,0
0,454,454,53,53,0,1,0
6,475,475,5,5,0,1,0
15,482,482,22,19,3,2,1

18,117,117,24,6,18,3,2
12,134,134,7,7,0,1,0
2,204,204,5,5,0,1,0
15,227,227,10,10,0,1,0
9,232,232,39,1,38,2,1
4,239,239,30,21,9,4,3
3,252,252,11,11,0,1,0
7,254,254,1,1,0,1,0
11,278,278,16,16,0,1,0
17,293,293,26,11,15,2,1
6,306,306,146,89,57,4,3
0,307,307,18,18,0,1,0
20,308,308,39,39,0,1,0
22,319,319,4,4,0,1,0
14,320,320,44,23,21,2,1
8,399,399,1,1,0,1,0
21,405,405,14,3,11,2,1
5,421,421,22,22,0,1,0
16,428,428,129,95,34,3,2
1,440,440,15,6,9,4,3
13,442,442,10,2,8,2,1
10,457,457,3,3,0,1,0
19,477,477,66,36,30,4,3

0,107,107,4,4,0,1,0
16,115,115,41,9,32,2,1
11,124,124,10,10,0,1,0
10,136,136,5,5,0,1,0
3,150,150,16,16,0,1,0
8,199,199,9,9,0,1,0
21,210,210,4,4,0,1,0
19,234,234,11,11,0,1,0
20,261,261,24,1,23,2,1
2,270,270,46,37,9,2,1
6,272,272,14,5,9,4,3
22,285,285,7,7,0,1,0
17,308,308,60,60,0,1,0
4,334,334,6,6,0,1,0
1,341,341,65,65,0,1,0
14,367,367,30,30,0,1,0
5,382,382,17,17,0,1,0
7,394,394,60,60,0,1,0
15,417,417,29,19,10,3,2
18,432,432,19,19,0,1,0
13,457,457,87,42,45,2,1
9,473,473,15,15,0,1,0
12,500,500,68,68,0,1,0

16,112,112,13,13,0,1,0
14,120,120,1,1,0,1,0
6,157,157,49,9,40,2,1
8,185,185,1,1,0,1,0
3,219,219,38,29,9,4,3
4,230,230,20,8,12,4,3
9,258,258,54,11,43,2,1
2,271,271,64,64,0,1,0
12,309,309,22,9,13,2,1
15,332,332,85,85,0,1,0
13,340,340,82,1,81,4,3
1,340,340,1,1,0,1,0
0,360,360,73,38,35,2,1
5,397,397,20,20,0,1,0
11,424,424,2,2,0,1,0
7,432,432,14,3,11,2,1
18,435,435,16,4,12,4,3
10,448,448,80,76,4,2,1
17,500,500,1,1,0,1,0

5,174,174,9,1,8,3,2
2,186,186,1,1,0,1,0
9,187,187,12,12,0,1,0
3,219,219,68,68,0,1,0
10,260,260,12,4,8,3,2
0,272,272,37,37,0,1,0
11,274,274,128,128,0,1,0
7,281,281,13,13,0,1,0
1,300,300,26,26,0,1,0
13,380,380,39,10,29,4,3
12,382,382,72,23,49,2,1
4,393,393,201,72,129,4,3
8,433,433,71,71,0,1,0
14,449,449,8,8,0,1,0
15,489,489,7,7,0,1,0
6,490,490,5,5,0,1,0

2,127,127,7,2,5,2,1
18,136,136,21,3,18,2,1
13,144,144,7,2,5,2,1
5,152,152,28,28,0,1,0
0,153,153,36,13,23,2,1
6,158,158,45,7,38,2,1
15,158,158,3,3,0,1,0
9,159,159,9,3,6,3,2
3,194,194,2,2,0,1,0
1,235,235,16,16,0,1,0
16,260,260,10,4,6,3,2
4,350,350,8,5,3,2,1
10,367,367,74,40,34,3,2
14,429,429,3,3,0,1,0
11,446,446,141,22,119,4,3
17,452,452,59,59,0,1,0
7,455,455,70,22,48,3,2
8,461,461,40,12,28,2,1
12,463,463,69,48,21,4,3

17,123,123,36,10,26,2,1
9,140,140,9,9,0,1,0
10,201,201,33,33,0,1,0
3,203,203,1,1,0,1,0
11,226,226,23,1,22,2,1
8,233,233,7,7,0,1,0
4,245,245,39,5,34,3,2
6,269,269,12,12,0,1,0
24,269,269,4,4,0,1,0
20,275,275,11,3,8,3,2
25,286,286,27,27,0,1,0
12,293,293,25,25,0,1,0
18,330,330,9,9,0,1,0
14,340,340,4,4,0,1,0
16,344,344,15,15,0,1,0
21,360,360,12,12,0,1,0
19,364,364,173,173,0,1,0
22,370,370,5,5,0,1,0
23,374,374,32,26,6,2,1
15,386,386,14,14,0,1,0
7,424,424,62,1,61,4,3
2,434,434,28,12,16,3,2
1,435,435,45,21,24,2,1
5,440,440,16,8,8,2,1
13,451,451,1,1,0,1,0
0,485,485,23,23,0,1,0

17,117,117,6,6,0,1,0
21,119,119,1,1,0,1,0
19,123,123,42,17,25,2,1
16,137,137,6,6,0,1,0
13,159,159,8,4,4,2,1
5,179,179,1,1,0,1,0
26,190,190,41,41,0,1,0
12,214,214,17,2,15,4,3
3,237,237,3,3,0,1,0
11,241,241,30,30,0,1,0
25,252,252,12,12,0,1,0
9,279,279,14,3,11,2,1
14,290,290,38,38,0,1,0
28,352,352,4,4,0,1,0
15,363,363,43,4,39,4,3
7,364,364,9,1,8,3,2
10,372,372,19,19,0,1,0
6,386,386,1,1,0,1,0
1,396,396,13,4,9,2,1
8,418,418,24,24,0,1,0
4,422,422,57,31,26,3,2
20,422,422,31,3,28,2,1
18,429,429,38,14,24,2,1
22,443,443,23,5,18,4,3
0,456,456,14,6,8,2,1
27,473,473,75,27,48,3,2
23,476,476,41,41,0,1,0
24,490,490,60,60,0,1,0
2,492,492,5,5,0,1,0

19,135,135,5,1,4,2,1
13,163,163,20,20,0,1,0
18,176,176,4,4,0,1,0
6,198,198,19,19,0,1,0
20,234,234,5,5,0,1,0
2,261,261,23,23,0,1,0
8,281,281,26,5,21,2,1
9,301,301,16,4,12,2,1
1,303,303,12,12,0,1,0
11,304,304,12,6,6,3,2
4,328,328,144,144,0,1,0
16,339,339,43,43,0,1,0
10,348,348,16,16,0,1,0
14,354,354,39,1,38,2,1
3,385,385,33,23,10,3,2
12,411,411,42,39,3,2,1
17,412,412,114,70,44,2,1
5,425,425,15,15,0,1,0
0,435,435,22,19,3,2,1
21,448,448,26,26,0,1,0
7,454,454,16,16,0,1,0
15,470,470,113,113,0,1,0

8,138,138,4,4,0,1,0
3,151,151,26,20,6,2,1
12,160,160,1,1,0,1,0
10,170,170,1,1,0,1,0
2,196,196,39,39,0,1,0
13,206,206,3,3,0,1,0
14,207,207,83,53,30,4,3
9,227,227,31,6,25,2,1
7,284,284,77,77,0,1,0
0,305,305,36,22,14,3,2
1,330,330,44,44,0,1,0
17,364,364,83,41,42,4,3
5,399,399,15,9,6,2,1
16,405,405,20,14,6,2,1
6,421,421,5,2,3,2,1
4,441,441,70,40,30,4,3
15,461,461,1,1,0,1,0
11,493,493,121,87,34,3,2

22,115,115,16,16,0,1,0
15,116,116,38,38,0,1,0
5,153,153,9,3,6,3,2
4,172,172,1,1,0,1,0
8,190,190,30,30,0,1,0
19,192,192,3,3,0,1,0
3,213,213,8,8,0,1,0
1,214,214,12,12,0,1,0
23,220,220,8,5,3,2,1
10,236,236,23,23,0,1,0
14,239,239,2,2,0,1,0
6,252,252,1,1,0,1,0
18,261,261,39,3,36,3,2
11,268,268,6,6,0,1,0
21,285,285,16,16,0,1,0
17,306,306,26,14,12,2,1
13,326,326,8,8,0,1,0
0,329,329,61,34,27,3,2
20,365,365,74,74,0,1,0
2,381,381,9,9,0,1,0
12,383,383,85,45,40,2,1
7,416,416,31,31,0,1,0
16,441,441,43,22,21,4,3
9,445,445,58,32,26,2,1

4,139,139,64,27,37,3,2
12,152,152,6,1,5,2,1
0,196,196,1,1,0,1,0
3,197,197,24,24,0,1,0
13,199,199,7,7,0,1,0
14,238,238,90,90,0,1,0
8,250,250,9,9,0,1,0
2,306,306,18,18,0,1,0
16,311,311,38,38,0,1,0
17,312,312,16,2,14,2,1
15,332,332,25,6,19,2,1
7,347,347,3,3,0,1,0
11,362,362,7,1,6,2,1
1,412,412,154,154,0,1,0
10,480,480,156,84,72,4,3
5,495,495,13,13,0,1,0
18,497,497,19,2,17,4,3
9,498,498,14,3,11,2,1
6,500,500,5,2,3,2,1

15,122,122,44,23,21,2,1
9,125,125,5,2,3,2,1
2,135,135,28,3,25,3,2
0,164,164,11,11,0,1,0
5,225,225,1,1,0,1,0
18,228,228,25,25,0,1,0
3,250,250,38,38,0,1,0
11,298,298,6,6,0,1,0
4,306,306,23,9,14,3,2
6,343,343,31,22,9,4,3
14,360,360,74,37,37,2,1
7,371,371,47,3,44,2,1
17,371,371,13,13,0,1,0
1,372,372,50,24,26,4,3
10,386,386,68,46,22,2,1
13,386,386,1,1,0,1,0
16,401,401,78,36,42,3,2
19,435,435,72,72,0,1,0
20,456,456,1,1,0,1,0
8,456,456,12,4,8,2,1
12,458,458,10,10,0,1,0

15,102,102,24,24,0,1,0
14,113,113,4,4,0,1,0
2,135,135,1,1,0,1,0
11,154,154,51,51,0,1,0
8,187,187,37,37,0,1,0
17,218,218,22,14,8,2,1
16,229,229,34,12,22,4,3
9,239,239,90,90,0,1,0
7,252,252,14,14,0,1,0
18,252,252,35,28,7,2,1
5,271,271,12,12,0,1,0
6,299,299,23,17,6,2,1
19,331,331,3,3,0,1,0
3,338,338,10,10,0,1,0
10,410,410,26,26,0,1,0
12,443,443,8,8,0,1,0
0,462,462,15,15,0,1,0
13,473,473,19,19,0,1,0
1,474,474,100,50,50,3,2
4,492,492,35,3,32,3,2

18,100,100,2,2,0,1,0
12,106,106,23,7,16,3,2
1,109,109,14,14,0,1,0
14,120,120,11,11,0,1,0
0,188,188,1,1,0,1,0
19,195,195,22,22,0,1,0
4,211,211,23,8,15,2,1
8,234,234,21,21,0,1,0
6,246,246,1,1,0,1,0
17,273,273,38,38,0,1,0
11,275,275,42,14,28,2,1
9,279,279,78,78,0,1,0
2,299,299,36,36,0,1,0
13,328,328,30,7,23,2,1
16,347,347,41,21,20,3,2
3,384,384,34,12,22,3,2
5,414,414,10,10,0,1,0
20,415,415,18,18,0,1,0
21,456,456,106,54,52,3,2
15,465,465,27,27,0,1,0
7,469,469,12,12,0,1,0
10,488,488,36,36,0,1,0

12,125,125,5,5,0,1,0
16,131,131,13,5,8,2,1
17,131,131,13,13,0,1,0
18,162,162,45,41,4,2,1
3,168,168,1,1,0,1,0
14,186,186,2,2,0,1,0
2,186,186,12,6,6,2,1
4,199,199,23,23,0,1,0
7,215,215,23,8,15,4,3
15,233,233,1,1,0,1,0
9,273,273,49,23,26,2,1
6,286,286,37,22,15,4,3
5,293,293,76,1,75,4,3
19,296,296,18,5,13,2,1
13,357,357,120,120,0,1,0
1,391,391,31,31,0,1,0
20,437,437,40,40,0,1,0
10,461,461,29,29,0,1,0
11,473,473,50,50,0,1,0
8,490,490,39,39,0,1,0
0,495,495,9,5,4,2,1

9,112,112,16,16,0,1,0
17,121,121,5,5,0,1,0
6,134,134,7,1,6,3,2
1,142,142,5,1,4,2,1
3,165,165,2,2,0,1,0
8,220,220,34,34,0,1,0
4,223,223,15,15,0,1,0
13,228,228,10,4,6,2,1
14,243,243,81,81,0,1,0
0,250,250,15,7,8,2,1
5,276,276,118,82,36,2,1
12,285,285,30,30,0,1,0
11,314,314,59,37,22,3,2
2,371,371,10,1,9,4,3
16,394,394,12,5,7,2,1
10,427,427,49,25,24,4,3
7,439,439,3,3,0,1,0
15,440,440,29,12,17,2,1
18,454,454,10,4,6,2,1
19,466,466,69,69,0,1,0
20,478,478,66,31,35,2,1

6,107,107,6,6,0,1,0
2,111,111,16,16,0,1,0
10,111,111,7,7,0,1,0
12,129,129,9,9,0,1,0
11,150,150,6,6,0,1,0
17,216,216,41,41,0,1,0
7,230,230,15,15,0,1,0
5,233,233,36,28,8,3,2
0,286,286,75,66,9,4,3
18,333,333,80,80,0,1,0
13,388,388,11,11,0,1,0
16,388,388,33,33,0,1,0
8,395,395,66,44,22,3,2
4,415,415,52,52,0,1,0
9,422,422,67,13,54,3,2
14,437,437,26,26,0,1,0
3,465,465,50,50,0,1,0
15,470,470,84,51,33,4,3
1,490,490,9,1,8,3,2

20,116,116,9,9,0,1,0
17,134,134,8,2,6,3,2
8,156,156,1,1,0,1,0
14,169,169,16,16,0,1,0
15,185,185,29,6,23,4,3
0,199,199,16,8,8,3,2
23,205,205,24,24,0,1,0
10,211,211,13,4,9,2,1
2,227,227,35,35,0,1,0
5,255,255,1,1,0,1,0
22,257,257,9,6,3,2,1
21,259,259,59,59,0,1,0
13,277,277,1,1,0,1,0
19,278,278,92,92,0,1,0
1,288,288,32,32,0,1,0
3,289,289,22,22,0,1,0
9,300,300,17,10,7,2,1
11,305,305,29,29,0,1,0
24,329,329,39,9,30,4,3
25,378,378,41,41,0,1,0
7,399,399,21,15,6,3,2
6,405,405,18,18,0,1,0
12,422,422,38,20,18,2,1
16,437,437,10,10,0,1,0
18,480,480,15,15,0,1,0
4,497,497,7,7,0,1,0

0,114,114,3,3,0,1,0
13,150,150,32,9,23,2,1
3,152,152,12,12,0,1,0
16,169,169,10,10,0,1,0
18,180,180,32,32,0,1,0
22,185,185,4,4,0,1,0
14,217,217,25,25,0,1,0
12,218,218,14,6,8,3,2
15,228,228,50,8,42,4,3
4,260,260,35,4,31,4,3
5,267,267,9,1,8,3,2
11,284,284,5,5,0,1,0
6,300,300,8,8,0,1,0
23,311,311,29,18,11,3,2
17,311,311,34,34,0,1,0
1,318,318,3,3,0,1,0
10,376,376,19,19,0,1,0
9,382,382,107,44,63,4,3
8,400,400,13,1,12,2,1
20,432,432,13,13,0,1,0
2,452,452,21,21,0,1,0
21,459,459,71,32,39,4,3
7,490,490,43,2,41,2,1
19,494,494,68,68,0,1,0

21,103,103,11,3,8,3,2
15,112,112,22,22,0,1,0
1,118,118,4,4,0,1,0
23,173,173,49,16,33,4,3
12,174,174,4,4,0,1,0
16,180,180,8,3,5,2,1
14,234,234,15,6,9,2,1
7,248,248,51,51,0,1,0
18,273,273,18,14,4,2,1
22,290,290,12,7,5,2,1
8,325,325,21,11,10,3,2
11,337,337,41,3,38,2,1
6,353,353,16,16,0,1,0
19,365,365,42,42,0,1,0
2,366,366,4,1,3,2,1
4,387,387,12,12,0,1,0
17,388,388,33,13,20,2,1
20,402,402,53,53,0,1,0
10,438,438,17,3,14,3,2
3,444,444,6,6,0,1,0
13,455,455,106,34,72,4,3
9,457,457,42,2,40,2,1
0,462,462,74,51,23,2,1
5,483,483,13,13,0,1,0

0,126,126,15,3,12,2,1
1,138,138,73,57,16,2,1
14,153,153,65,50,15,4,3
16,160,160,8,2,6,2,1
5,191,191,12,12,0,1,0
2,245,245,12,1,11,4,3
8,265,265,3,3,0,1,0
15,322,322,1,1,0,1,0
11,353,353,45,23,22,3,2
3,355,355,51,51,0,1,0
12,364,364,18,18,0,1,0
10,366,366,12,3,9,4,3
13,393,393,134,122,12,4,3
7,431,431,17,17,0,1,0
6,440,440,52,52,0,1,0
4,460,460,37,37,0,1,0
9,494,494,19,19,0,1,0

8,153,153,6,6,0,1,0
9,153,153,40,26,14,2,1
20,161,161,3,3,0,1,0
14,164,164,33,9,24,2,1
4,184,184,2,2,0,1,0
6,186,186,33,1,32,3,2
1,194,194,2,2,0,1,0
7,287,287,48,48,0,1,0
2,296,296,10,10,0,1,0
3,327,327,16,16,0,1,0
12,332,332,106,92,14,2,1
10,362,362,51,51,0,1,0
15,363,363,44,2,42,4,3
18,374,374,43,10,33,2,1
0,396,396,11,11,0,1,0
19,402,402,25,25,0,1,0
17,403,403,6,6,0,1,0
11,486,486,17,17,0,1,0
5,496,496,91,8,83,3,2
13,498,498,91,9,82,4,3
16,500,500,25,5,20,2,1

18,101,101,1,1,0,1,0
14,119,119,37,37,0,1,0
7,130,130,35,12,23,2,1
12,135,135,25,25,0,1,0
9,155,155,21,15,6,3,2
1,158,158,18,15,3,2,1
10,174,174,7,2,5,2,1
20,189,189,28,25,3,2,1
19,191,191,19,19,0,1,0
5,198,198,10,4,6,2,1
6,222,222,8,8,0,1,0
15,298,298,12,12,0,1,0
17,299,299,9,9,0,1,0
4,301,301,12,2,10,2,1
21,357,357,35,35,0,1,0
16,373,373,63,63,0,1,0
13,385,385,13,13,0,1,0
11,392,392,60,6,54,3,2
8,435,435,53,53,0,1,0
3,458,458,13,6,7,2,1
0,474,474,45,45,0,1,0
2,496,496,9,9,0,1,0

25,107,107,16,16,0,1,0
22,113,113,4,4,0,1,0
0,126,126,11,1,10,3,2
11,128,128,7,3,4,2,1
4,130,130,8,4,4,2,1
14,135,135,6,6,0,1,0
10,141,141,12,12,0,1,0
24,145,145,21,21,0,1,0
2,160,160,3,3,0,1,0
13,174,174,4,4,0,1,0
23,227,227,19,10,9,2,1
7,261,261,16,6,10,3,2
21,307,307,30,8,22,2,1
1,317,317,6,6,0,1,0
3,368,368,1,1,0,1,0
17,371,371,38,38,0,1,0
6,377,377,5,5,0,1,0
8,389,389,52,52,0,1,0
9,395,395,49,36,13,2,1
15,403,403,50,29,21,4,3
19,425,425,20,15,5,2,1
16,433,433,16,10,6,3,2
5,453,453,53,49,4,2,1
12,463,463,61,61,0,1,0
20,491,491,27,27,0,1,0
18,495,495,187,91,96,4,3

19,110,110,7,3,4,2,1
4,130,130,7,7,0,1,0
15,135,135,58,58,0,1,0
24,154,154,42,42,0,1,0
7,169,169,3,3,0,1,0
16,173,173,1,1,0,1,0
5,180,180,39,20,19,2,1
9,185,185,43,34,9,2,1
12,193,193,12,1,11,2,1
8,208,208,5,5,0,1,0
6,231,231,2,2,0,1,0
3,242,242,30,30,0,1,0
13,242,242,7,7,0,1,0
18,248,248,56,56,0,1,0
22,250,250,1,1,0,1,0
23,266,266,2,2,0,1,0
2,297,297,22,3,19,2,1
11,327,327,4,1,3,2,1
21,331,331,5,5,0,1,0
0,397,397,18,18,0,1,0
17,419,419,4,4,0,1,0
14,433,433,10,1,9,2,1
1,441,441,56,56,0,1,0
10,446,446,23,23,0,1,0
20,455,455,39,13,26,2,1

2,114,114,13,2,11,2,1
1,128,128,1,1,0,1,0
8,128,128,7,1,6,3,2
10,154,154,7,7,0,1,0
12,156,156,3,3,0,1,0
13,178,178,10,1,9,4,3
5,194,194,27,27,0,1,0
15,231,231,64,34,30,2,1
17,237,237,24,24,0,1,0
7,242,242,9,9,0,1,0
6,266,266,22,10,12,3,2
9,319,319,55,55,0,1,0
18,319,319,11,2,9,2,1
3,326,326,155,146,9,2,1
16,332,332,19,19,0,1,0
4,371,371,1,1,0,1,0
11,403,403,15,7,8,2,1
19,416,416,37,37,0,1,0
14,425,425,171,130,41,2,1
0,497,497,8,8,0,1,0

2,104,104,6,6,0,1,0
10,105,105,3,3,0,1,0
0,124,124,11,1,10,3,2
3,131,131,19,11,8,2,1
17,138,138,24,24,0,1,0
1,208,208,32,10,22,3,2
9,209,209,6,3,3,2,1
16,268,268,12,12,0,1,0
12,291,291,36,29,7,2,1
6,292,292,89,89,0,1,0
14,343,343,96,3,93,4,3
13,347,347,26,26,0,1,0
5,377,377,28,28,0,1,0
11,386,386,44,32,12,4,3
7,405,405,94,42,52,3,2
8,459,459,1,1,0,1,0
15,469,469,7,3,4,2,1
4,477,477,20,20,0,1,0
18,482,482,112,52,60,3,2

9,100,100,5,5,0,1,0
14,104,104,7,1,6,3,2
5,109,109,15,3,12,2,1
3,111,111,1,1,0,1,0
15,126,126,9,9,0,1,0
18,158,158,12,6,6,2,1
2,173,173,1,1,0,1,0
0,180,180,79,58,21,4,3
19,180,180,38,38,0,1,0
21,228,228,7,7,0,1,0
4,273,273,1,1,0,1,0
16,280,280,12,12,0,1,0
1,288,288,4,4,0,1,0
12,295,295,54,54,0,1,0
6,322,322,20,20,0,1,0
8,343,343,1,1,0,1,0
11,357,357,51,51,0,1,0
10,369,369,62,62,0,1,0
17,383,383,15,3,12,3,2
20,420,420,22,22,0,1,0
7,435,435,29,11,18,4,3
13,454,454,158,158,0,1,0

18,136,136,19,19,0,1,0
21,137,137,8,3,5,2,1
7,141,141,1,1,0,1,0
6,151,151,5,5,0,1,0
22,193,193,57,10,47,3,2
11,204,204,11,5,6,3,2
0,214,214,5,5,0,1,0
14,220,220,8,5,3,2,1
1,264,264,16,7,9,2,1
3,316,316,3,3,0,1,0
16,321,321,34,2,32,2,1
2,323,323,18,10,8,3,2
17,328,328,1,1,0,1,0
8,339,339,66,66,0,1,0
19,350,350,69,69,0,1,0
13,390,390,70,70,0,1,0
4,392,392,8,8,0,1,0
5,407,407,89,42,47,2,1
20,459,459,2,2,0,1,0
9,465,465,40,14,26,3,2
12,471,471,153,95,58,4,3
10,489,489,6,6,0,1,0
15,495,495,47,14,33,2,1

4,100,100,2,2,0,1,0
15,155,155,13,13,0,1,0
11,184,184,25,25,0,1,0
3,214,214,50,33,17,2,1
7,302,302,92,68,24,3,2
8,305,305,6,6,0,1,0
2,340,340,38,38,0,1,0
12,341,341,57,57,0,1,0
17,344,344,14,14,0,1,0
14,354,354,4,4,0,1,0
5,354,354,39,18,21,4,3
6,391,391,5,5,0,1,0
13,396,396,104,57,47,3,2
10,443,443,19,19,0,1,0
9,445,445,144,99,45,4,3
1,466,466,28,16,12,3,2
0,472,472,117,36,81,3,2
16,499,499,14,7,7,2,1

17,109,109,8,1,7,2,1
0,112,112,1,1,0,1,0
2,125,125,1,1,0,1,0
14,141,141,28,28,0,1,0
8,142,142,12,12,0,1,0
26,146,146,2,2,0,1,0
22,158,158,57,6,51,4,3
6,160,160,11,2,9,2,1
25,176,176,9,1,8,2,1
23,179,179,36,17,19,2,1
20,190,190,9,9,0,1,0
27,196,196,22,12,10,3,2
19,200,200,26,18,8,3,2
11,202,202,1,1,0,1,0
1,204,204,17,17,0,1,0
4,209,209,8,4,4,2,1
24,212,212,6,6,0,1,0
12,229,229,13,13,0,1,0
10,230,230,29,8,21,2,1
9,340,340,4,1,3,2,1
18,354,354,17,17,0,1,0
16,390,390,4,4,0,1,0
7,394,394,14,14,0,1,0
15,406,406,66,32,34,2,1
13,420,420,3,3,0,1,0
5,445,445,48,1,47,2,1
3,448,448,10,10,0,1,0
21,489,489,63,63,0,1,0

6,105,105,7,1,6,3,2
9,138,138,22,5,17,2,1
5,140,140,3,3,0,1,0
4,141,141,29,5,24,3,2
7,166,166,20,20,0,1,0
20,167,167,18,10,8,2,1
13,177,177,19,19,0,1,0
11,208,208,30,6,24,4,3
12,252,252,4,4,0,1,0
15,260,260,4,4,0,1,0
19,264,264,109,109,0,1,0
14,271,271,36,36,0,1,0
17,281,281,6,6,0,1,0
2,299,299,57,57,0,1,0
3,304,304,36,23,13,2,1
0,357,357,37,37,0,1,0
1,359,359,6,6,0,1,0
16,393,393,32,17,15,4,3
8,435,435,15,3,12,2,1
18,466,466,37,37,0,1,0
10,496,496,31,31,0,1,0

14,114,114,16,7,9,4,3
3,123,123,2,2,0,1,0
23,132,132,6,6,0,1,0
11,135,135,35,3,32,3,2
8,161,161,11,11,0,1,0
6,167,167,1,1,0,1,0
13,193,193,1,1,0,1,0
2,198,198,16,9,7,2,1
25,228,228,14,2,12,4,3
7,235,235,9,4,5,2,1
1,236,236,6,6,0,1,0
22,300,300,44,44,0,1,0
18,309,309,35,3,32,3,2
17,313,313,54,48,6,2,1
4,317,317,8,2,6,2,1
20,321,321,18,18,0,1,0
5,342,342,16,6,10,2,1
21,373,373,21,7,14,3,2
19,391,391,5,5,0,1,0
12,405,405,10,10,0,1,0
16,415,415,71,71,0,1,0
15,434,434,39,39,0,1,0
24,434,434,121,115,6,2,1
9,439,439,43,18,25,2,1
10,447,447,50,50,0,1,0
0,464,464,30,9,21,4,3

10,110,110,25,25,0,1,0
17,162,162,34,19,15,4,3
5,216,216,116,102,14,3,2
16,239,239,18,18,0,1,0
2,282,282,17,17,0,1,0
7,308,308,3,3,0,1,0
12,358,358,34,34,0,1,0
13,367,367,24,24,0,1,0
3,370,370,82,82,0,1,0
0,397,397,46,30,16,3,2
15,404,404,12,12,0,1,0
11,410,410,1,1,0,1,0
6,412,412,41,15,26,3,2
4,432,432,5,5,0,1,0
14,439,439,29,17,12,4,3
9,455,455,4,4,0,1,0
8,486,486,166,88,78,4,3
1,499,499,23,23,0,1,0

14,124,124,1,1,0,1,0
1,126,126,11,11,0,1,0
23,130,130,32,32,0,1,0
2,160,160,13,1,12,2,1
6,185,185,37,37,0,1,0
8,189,189,2,2,0,1,0
11,202,202,8,5,3,2,1
15,213,213,39,26,13,2,1
3,222,222,1,1,0,1,0
9,226,226,9,9,0,1,0
21,234,234,27,3,24,3,2
7,279,279,56,56,0,1,0
17,287,287,6,6,0,1,0
18,309,309,36,4,32,2,1
13,339,339,2,2,0,1,0
10,347,347,91,27,64,3,2
0,358,358,41,41,0,1,0
20,378,378,17,17,0,1,0
24,378,378,53,53,0,1,0
19,383,383,9,1,8,2,1
22,385,385,9,9,0,1,0
12,446,446,1,1,0,1,0
4,456,456,13,13,0,1,0
5,457,457,10,2,8,2,1
16,460,460,92,48,44,2,1

14,101,101,44,44,0,1,0
17,136,136,2,2,0,1,0
23,138,138,8,3,5,2,1
19,138,138,5,1,4,2,1
20,174,174,9,6,3,2,1
8,183,183,3,3,0,1,0
0,194,194,67,44,23,2,1
1,205,205,18,18,0,1,0
9,212,212,5,2,3,2,1
22,224,224,23,23,0,1,0
11,229,229,24,6,18,4,3
12,235,235,25,3,22,3,2
7,259,259,9,2,7,3,2
6,299,299,3,3,0,1,0
16,367,367,30,15,15,4,3
3,406,406,17,6,11,3,2
4,408,408,40,40,0,1,0
5,424,424,12,12,0,1,0
21,425,425,5,1,4,2,1
13,440,440,34,18,16,3,2
10,446,446,28,1,27,2,1
18,448,448,40,1,39,2,1
2,477,477,30,24,6,3,2
15,489,489,125,125,0,1,0

5,180,180,8,3,5,2,1
4,184,184,61,61,0,1,0
6,209,209,37,19,18,2,1
7,219,219,23,23,0,1,0
16,240,240,19,19,0,1,0
3,246,246,77,59,18,4,3
9,251,251,5,1,4,2,1
2,259,259,33,23,10,2,1
8,275,275,17,17,0,1,0
1,280,280,7,3,4,2,1
13,288,288,22,22,0,1,0
12,291,291,18,18,0,1,0
0,304,304,26,19,7,2,1
10,407,407,42,2,40,4,3
15,416,416,83,65,18,3,2
14,455,455,77,17,60,3,2
11,488,488,116,95,21,4,3

15,135,135,3,3,0,1,0
14,140,140,9,9,0,1,0
13,167,167,45,15,30,3,2
9,189,189,2,2,0,1,0
17,192,192,16,7,9,2,1
19,209,209,4,4,0,1,0
4,244,244,39,16,23,2,1
20,245,245,44,44,0,1,0
8,280,280,3,3,0,1,0
1,314,314,96,96,0,1,0
21,328,328,12,12,0,1,0
16,338,338,13,13,0,1,0
6,348,348,5,5,0,1,0
18,359,359,50,50,0,1,0
10,413,413,8,4,4,2,1
2,416,416,24,24,0,1,0
5,419,419,98,49,49,2,1
12,438,438,23,23,0,1,0
7,468,468,42,42,0,1,0
3,477,477,21,2,19,2,1
0,482,482,20,2,18,3,2
11,482,482,29,21,8,3,2
22,485,485,129,66,63,4,3

17,105,105,23,11,12,2,1
20,130,130,24,9,15,2,1
18,135,135,17,9,8,3,2
8,144,144,4,1,3,2,1
2,154,154,4,4,0,1,0
22,166,166,18,18,0,1,0
16,176,176,2,2,0,1,0
6,229,229,67,67,0,1,0
19,241,241,68,68,0,1,0
21,257,257,2,2,0,1,0
5,264,264,5,5,0,1,0
12,299,299,4,4,0,1,0
7,302,302,29,21,8,3,2
15,311,311,19,11,8,2,1
1,334,334,93,6,87,4,3
10,343,343,1,1,0,1,0
11,350,350,23,23,0,1,0
0,362,362,10,10,0,1,0
14,426,426,51,35,16,2,1
3,435,435,51,33,18,2,1
9,439,439,39,12,27,2,1
4,440,440,20,20,0,1,0
13,497,497,5,5,0,1,0

13,113,113,7,1,6,3,2
23,117,117,6,6,0,1,0
0,124,124,10,10,0,1,0
15,132,132,31,31,0,1,0
17,135,135,19,19,0,1,0
9,149,149,3,3,0,1,0
2,153,153,3,3,0,1,0
3,184,184,23,12,11,3,2
4,201,201,8,8,0,1,0
6,201,201,29,29,0,1,0
12,215,215,7,7,0,1,0
22,270,270,2,2,0,1,0
7,282,282,38,38,0,1,0
14,288,288,20,20,0,1,0
16,293,293,31,31,0,1,0
19,309,309,52,52,0,1,0
1,319,319,56,56,0,1,0
21,333,333,23,3,20,3,2
10,394,394,2,2,0,1,0
8,410,410,11,11,0,1,0
11,419,419,61,61,0,1,0
20,464,464,63,63,0,1,0
24,464,464,18,12,6,2,1
18,469,469,79,79,0,1,0
5,492,492,10,10,0,1,0

4,111,111,6,3,3,2,1
13,133,133,7,7,0,1,0
19,158,158,5,5,0,1,0
16,178,178,8,8,0,1,0
10,211,211,3,3,0,1,0
14,212,212,66,27,39,2,1
5,213,213,10,10,0,1,0
8,261,261,32,32,0,1,0
1,275,275,54,42,12,4,3
2,340,340,105,21,84,4,3
11,345,345,4,4,0,1,0
0,355,355,2,2,0,1,0
21,374,374,24,3,21,2,1
6,374,374,15,2,13,2,1
20,400,400,15,10,5,2,1
9,401,401,20,20,0,1,0
18,407,407,32,11,21,4,3
3,408,408,101,55,46,3,2
7,411,411,1,1,0,1,0
17,419,419,104,11,93,4,3
12,422,422,45,10,35,2,1
15,445,445,66,36,30,4,3

1,102,102,12,12,0,1,0
2,114,114,15,15,0,1,0
16,127,127,14,14,0,1,0
5,150,150,3,3,0,1,0
6,202,202,5,5,0,1,0
7,246,246,83,25,58,3,2
8,247,247,6,1,5,2,1
17,264,264,65,65,0,1,0
15,270,270,11,11,0,1,0
10,271,271,5,5,0,1,0
12,290,290,61,1,60,4,3
13,329,329,64,21,43,4,3
18,359,359,1,1,0,1,0
19,369,369,50,2,48,4,3
0,379,379,81,81,0,1,0
14,381,381,52,52,0,1,0
11,423,423,6,3,3,2,1
9,435,435,2,2,0,1,0
4,436,436,52,5,47,2,1
3,499,499,54,7,47,4,3

14,127,127,9,5,4,2,1
7,170,170,16,8,8,2,1
2,190,190,9,6,3,2,1
15,235,235,14,11,3,2,1
6,253,253,23,4,19,2,1
12,255,255,18,18,0,1,0
11,352,352,54,16,38,4,3
4,359,359,10,2,8,3,2
3,379,379,31,1,30,3,2
10,382,382,51,23,28,2,1
13,404,404,84,75,9,4,3
8,408,408,5,5,0,1,0
17,433,433,125,68,57,4,3
5,436,436,120,82,38,2,1
16,475,475,41,13,28,3,2
1,483,483,7,7,0,1,0
0,488,488,229,138,91,4,3
9,497,497,19,11,8,2,1

8,156,156,22,22,0,1,0
9,161,161,12,12,0,1,0
21,182,182,63,63,0,1,0
20,185,185,14,14,0,1,0
19,198,198,26,26,0,1,0
12,212,212,3,3,0,1,0
6,230,230,17,17,0,1,0
7,244,244,17,17,0,1,0
2,247,247,25,3,22,4,3
1,249,249,4,4,0,1,0
0,299,299,45,45,0,1,0
14,322,322,45,45,0,1,0
4,336,336,19,7,12,4,3
15,349,349,8,1,7,2,1
11,362,362,113,79,34,2,1
5,392,392,3,3,0,1,0
3,419,419,14,14,0,1,0
18,421,421,34,34,0,1,0
13,423,423,53,17,36,2,1
16,487,487,1,1,0,1,0
10,489,489,32,32,0,1,0
17,494,494,92,92,0,1,0

1,111,111,18,18,0,1,0
22,132,132,1,1,0,1,0
23,134,134,33,33,0,1,0
7,170,170,2,2,0,1,0
8,230,230,13,13,0,1,0
10,230,230,38,38,0,1,0
9,241,241,6,6,0,1,0
19,248,248,29,29,0,1,0
12,292,292,47,4,43,2,1
5,302,302,45,45,0,1,0
13,309,309,17,2,15,2,1
3,315,315,7,7,0,1,0
4,336,336,16,7,9,4,3
18,368,368,60,60,0,1,0
14,372,372,2,2,0,1,0
21,392,392,46,29,17,2,1
20,395,395,44,44,0,1,0
11,423,423,21,18,3,2,1
15,457,457,45,45,0,1,0
6,466,466,3,3,0,1,0
0,471,471,19,19,0,1,0
2,483,483,73,34,39,2,1
16,485,485,116,116,0,1,0
17,488,488,8,8,0,1,0

3,102,102,1,1,0,1,0
11,116,116,10,10,0,1,0
21,128,128,21,21,0,1,0
19,137,137,10,10,0,1,0
12,156,156,4,1,3,2,1
14,161,161,26,7,19,2,1
17,167,167,15,15,0,1,0
5,192,192,22,10,12,2,1
4,229,229,28,28,0,1,0
0,230,230,23,6,17,2,1
16,240,240,37,25,12,2,1
9,243,243,39,39,0,1,0
22,245,245,4,1,3,2,1
1,255,255,4,4,0,1,0
10,261,261,9,9,0,1,0
13,269,269,4,4,0,1,0
24,331,331,24,6,18,2,1
20,340,340,51,51,0,1,0
7,363,363,8,8,0,1,0
6,399,399,31,19,12,4,3
18,400,400,11,8,3,2,1
2,432,432,62,14,48,3,2
23,436,436,116,82,34,4,3
25,490,490,50,28,22,3,2
8,496,496,3,3,0,1,0
15,500,500,3,3,0,1,0

8,109,109,3,3,0,1,0
6,131,131,4,1,3,2,1
4,145,145,27,27,0,1,0
2,159,159,28,28,0,1,0
5,170,170,10,10,0,1,0
19,182,182,23,1,22,3,2
1,234,234,28,7,21,4,3
13,242,242,72,57,15,4,3
14,276,276,10,10,0,1,0
0,280,280,16,1,15,2,1
12,289,289,25,25,0,1,0
16,295,295,3,3,0,1,0
18,298,298,41,4,37,2,1
17,323,323,20,20,0,1,0
15,430,430,105,69,36,4,3
9,433,433,88,88,0,1,0
11,458,458,53,53,0,1,0
7,460,460,106,52,54,4,3
10,461,461,2,2,0,1,0
3,488,488,6,6,0,1,0

8,111,111,37,37,0,1,0
14,112,112,35,26,9,4,3
6,118,118,8,8,0,1,0
5,150,150,12,12,0,1,0
13,150,150,18,3,15,4,3
12,151,151,33,15,18,3,2
15,168,168,3,3,0,1,0
17,232,232,18,18,0,1,0
7,234,234,46,3,43,2,1
16,247,247,7,7,0,1,0
10,260,260,1,1,0,1,0
4,262,262,47,47,0,1,0
18,264,264,48,48,0,1,0
3,337,337,1,1,0,1,0
11,400,400,9,1,8,2,1
9,413,413,60,60,0,1,0
2,413,413,85,1,84,3,2
1,441,441,16,16,0,1,0
0,469,469,2,2,0,1,0

13,133,133,18,5,13,2,1
5,153,153,29,29,0,1,0
3,158,158,61,17,44,2,1
8,169,169,50,14,36,4,3
10,202,202,10,7,3,2,1
12,216,216,11,2,9,2,1
11,283,283,21,21,0,1,0
7,318,318,48,12,36,4,3
1,325,325,49,10,39,4,3
9,336,336,59,16,43,2,1
0,366,366,55,7,48,4,3
4,366,366,59,59,0,1,0
6,381,381,24,24,0,1,0
2,402,402,25,25,0,1,0
14,404,404,41,41,0,1,0
15,434,434,9,9,0,1,0

6,105,105,4,4,0,1,0
16,118,118,7,7,0,1,0
8,143,143,11,11,0,1,0
15,151,151,55,43,12,2,1
18,154,154,4,4,0,1,0
13,195,195,26,19,7,2,1
14,214,214,1,1,0,1,0
10,218,218,13,13,0,1,0
3,222,222,23,23,0,1,0
1,252,252,29,29,0,1,0
17,299,299,5,5,0,1,0
20,303,303,35,35,0,1,0
12,312,312,87,87,0,1,0
7,336,336,43,43,0,1,0
5,341,341,31,31,0,1,0
0,379,379,37,7,30,2,1
19,418,418,20,8,12,3,2
4,427,427,111,38,73,3,2
9,433,433,29,5,24,4,3
21,474,474,34,34,0,1,0
2,483,483,17,10,7,2,1
11,492,492,14,14,0,1,0

1,113,113,5,5,0,1,0
4,117,117,4,4,0,1,0
12,169,169,17,1,16,3,2
7,185,185,12,12,0,1,0
19,188,188,9,9,0,1,0
18,203,203,18,1,17,4,3
21,207,207,34,34,0,1,0
6,216,216,52,38,14,3,2
10,233,233,12,12,0,1,0
13,237,237,13,1,12,4,3
3,242,242,8,8,0,1,0
16,251,251,14,14,0,1,0
11,262,262,2,2,0,1,0
9,265,265,62,22,40,2,1
2,266,266,1,1,0,1,0
0,300,300,10,1,9,2,1
15,300,300,2,2,0,1,0
8,303,303,33,33,0,1,0
22,306,306,41,41,0,1,0
23,316,316,25,25,0,1,0
5,439,439,39,17,22,2,1
17,443,443,91,91,0,1,0
14,479,479,92,60,32,4,3
20,484,484,72,31,41,2,1

20,105,105,7,7,0,1,0
1,107,107,9,9,0,1,0
2,114,114,13,3,10,2,1
0,115,115,1,1,0,1,0
3,144,144,20,10,10,3,2
13,170,170,6,6,0,1,0
7,234,234,28,28,0,1,0
10,255,255,9,9,0,1,0
19,273,273,11,11,0,1,0
5,293,293,30,16,14,3,2
4,333,333,13,13,0,1,0
6,341,341,16,16,0,1,0
18,369,369,13,13,0,1,0
21,375,375,66,66,0,1,0
17,386,386,2,2,0,1,0
11,399,399,81,10,71,4,3
8,411,411,5,5,0,1,0
12,426,426,23,23,0,1,0
9,434,434,86,17,69,4,3
14,441,441,72,28,44,3,2
16,457,457,146,146,0,1,0
15,497,497,113,61,52,4,3

14,116,116,1,1,0,1,0
1,131,131,1,1,0,1,0
0,138,138,1,1,0,1,0
12,140,140,49,49,0,1,0
18,165,165,2,2,0,1,0
9,178,178,16,12,4,2,1
17,202,202,26,11,15,4,3
11,222,222,32,16,16,3,2
7,223,223,87,54,33,4,3
16,223,223,14,14,0,1,0
5,234,234,32,2,30,2,1
13,242,242,31,31,0,1,0
2,247,247,2,2,0,1,0
10,268,268,11,4,7,2,1
4,279,279,76,76,0,1,0
3,344,344,35,35,0,1,0
6,356,356,7,7,0,1,0
15,402,402,12,9,3,2,1
8,423,423,12,12,0,1,0
19,450,450,109,109,0,1,0
20,462,462,6,3,3,2,1

6,100,100,23,8,15,4,3
10,108,108,3,3,0,1,0
14,151,151,2,2,0,1,0
3,165,165,15,15,0,1,0
4,169,169,11,5,6,3,2
15,171,171,6,6,0,1,0
9,174,174,78,52,26,3,2
16,174,174,14,14,0,1,0
1,221,221,13,6,7,2,1
13,236,236,16,16,0,1,0
20,251,251,20,15,5,2,1
2,256,256,3,3,0,1,0
11,272,272,38,9,29,2,1
7,289,289,8,1,7,2,1
18,298,298,10,3,7,3,2
5,340,340,6,6,0,1,0
17,380,380,12,12,0,1,0
19,394,394,82,31,51,4,3
12,407,407,175,93,82,4,3
0,462,462,47,7,40,3,2
8,493,493,14,14,0,1,0

12,128,128,5,5,0,1,0
5,157,157,12,7,5,2,1
0,178,178,7,7,0,1,0
20,178,178,16,4,12,3,2
11,180,180,10,10,0,1,0
2,185,185,14,14,0,1,0
7,222,222,13,13,0,1,0
9,237,237,14,14,0,1,0
1,285,285,62,11,51,4,3
19,312,312,27,12,15,4,3
4,323,323,1,1,0,1,0
6,333,333,19,19,0,1,0
10,352,352,17,17,0,1,0
17,352,352,15,15,0,1,0
18,363,363,177,177,0,1,0
14,409,409,94,94,0,1,0
15,414,414,19,12,7,2,1
16,449,449,4,4,0,1,0
13,455,455,17,5,12,3,2
3,462,462,144,144,0,1,0
8,489,489,75,75,0,1,0

9,109,109,34,34,0,1,0
7,122,122,1,1,0,1,0
15,131,131,49,9,40,3,2
11,139,139,12,4,8,3,2
19,185,185,11,1,10,2,1
14,249,249,16,3,13,2,1
5,270,270,55,27,28,3,2
3,284,284,6,6,0,1,0
10,294,294,15,4,11,2,1
0,342,342,13,5,8,2,1
16,389,389,25,17,8,2,1
6,391,391,45,22,23,4,3
13,399,399,69,69,0,1,0
4,424,424,47,47,0,1,0
2,433,433,49,49,0,1,0
18,451,451,41,41,0,1,0
12,464,464,6,6,0,1,0
17,477,477,69,69,0,1,0
1,490,490,31,31,0,1,0
8,490,490,58,11,47,2,1

18,122,122,33,11,22,2,1
21,138,138,2,2,0,1,0
16,183,183,13,13,0,1,0
3,184,184,1,1,0,1,0
6,190,190,28,28,0,1,0
9,190,190,53,32,21,2,1
13,226,226,10,10,0,1,0
20,229,229,28,28,0,1,0
12,245,245,11,1,10,3,2
14,252,252,1,1,0,1,0
19,264,264,82,82,0,1,0
10,280,280,23,17,6,2,1
15,287,287,16,1,15,2,1
11,308,308,7,7,0,1,0
17,310,310,59,59,0,1,0
0,329,329,27,27,0,1,0
2,376,376,1,1,0,1,0
8,415,415,27,27,0,1,0
1,448,448,33,5,28,4,3
5,458,458,41,7,34,3,2
4,460,460,94,81,13,2,1
7,468,468,1,1,0,1,0
22,492,492,18,13,5,2,1

13,115,115,5,5,0,1,0
1,137,137,1,1,0,1,0
12,158,158,22,17,5,2,1
4,162,162,4,4,0,1,0
9,171,171,13,8,5,2,1
19,179,179,16,16,0,1,0
20,244,244,24,4,20,2,1
8,263,263,22,22,0,1,0
3,285,285,28,13,15,4,3
15,313,313,6,6,0,1,0
18,330,330,26,14,12,3,2
16,353,353,55,55,0,1,0
7,358,358,111,78,33,2,1
10,364,364,55,40,15,4,3
11,400,400,7,7,0,1,0
2,413,413,4,1,3,2,1
0,433,433,34,34,0,1,0
22,438,438,57,30,27,4,3
23,452,452,150,33,117,4,3
14,474,474,17,8,9,4,3
6,474,474,4,4,0,1,0
17,482,482,47,47,0,1,0
5,490,490,27,2,25,4,3
21,498,498,40,1,39,2,1

6,126,126,14,3,11,2,1
11,135,135,10,10,0,1,0
12,149,149,3,3,0,1,0
19,162,162,26,26,0,1,0
17,168,168,45,45,0,1,0
10,174,174,13,8,5,2,1
0,176,176,25,1,24,3,2
15,176,176,1,1,0,1,0
21,193,193,3,3,0,1,0
23,266,266,28,28,0,1,0
26,285,285,22,22,0,1,0
9,296,296,43,22,21,3,2
16,310,310,10,10,0,1,0
7,317,317,2,2,0,1,0
1,332,332,35,13,22,3,2
13,362,362,68,20,48,2,1
22,363,363,24,9,15,2,1
20,366,366,67,22,45,2,1
4,376,376,8,8,0,1,0
14,379,379,6,2,4,2,1
18,415,415,61,61,0,1,0
8,422,422,41,41,0,1,0
2,437,437,4,4,0,1,0
5,460,460,5,5,0,1,0
25,474,474,45,45,0,1,0
24,490,490,1,1,0,1,0
3,495,495,21,21,0,1,0

1,116,116,12,12,0,1,0
4,116,116,17,7,10,3,2
14,157,157,13,13,0,1,0
8,174,174,1,1,0,1,0
9,180,180,3,3,0,1,0
20,201,201,23,23,0,1,0
10,216,216,12,12,0,1,0
6,219,219,1,1,0,1,0
5,232,232,24,5,19,2,1
3,302,302,1,1,0,1,0
13,306,306,31,15,16,2,1
17,320,320,27,24,3,2,1
2,354,354,92,50,42,2,1
11,354,354,14,4,10,3,2
22,356,356,71,19,52,3,2
0,356,356,52,28,24,2,1
21,397,397,13,13,0,1,0
12,422,422,19,19,0,1,0
18,429,429,113,7,106,4,3
7,434,434,74,50,24,3,2
16,462,462,31,31,0,1,0
15,482,482,40,40,0,1,0
19,482,482,43,43,0,1,0

9,125,125,13,4,9,2,1
5,139,139,3,3,0,1,0
0,167,167,2,2,0,1,0
21,171,171,77,77,0,1,0
1,189,189,22,2,20,2,1
11,252,252,32,20,12,4,3
17,266,266,32,32,0,1,0
19,283,283,11,11,0,1,0
8,284,284,36,14,22,3,2
7,287,287,1,1,0,1,0
6,299,299,54,20,34,2,1
16,318,318,49,37,12,4,3
20,320,320,4,1,3,2,1
13,325,325,2,2,0,1,0
10,349,349,59,59,0,1,0
4,352,352,55,31,24,4,3
3,381,381,1,1,0,1,0
14,393,393,56,26,30,4,3
12,414,414,73,51,22,3,2
15,415,415,5,5,0,1,0
2,417,417,34,34,0,1,0
18,435,435,1,1,0,1,0

5,100,100,10,10,0,1,0
13,124,124,21,21,0,1,0
9,128,128,2,2,0,1,0
1,131,131,48,48,0,1,0
4,168,168,7,7,0,1,0
6,169,169,15,15,0,1,0
15,195,195,10,10,0,1,0
11,226,226,55,55,0,1,0
19,288,288,1,1,0,1,0
3,295,295,10,10,0,1,0
2,301,301,1,1,0,1,0
20,328,328,9,9,0,1,0
18,335,335,40,40,0,1,0
17,353,353,21,6,15,2,1
10,362,362,3,3,0,1,0
14,379,379,38,3,35,2,1
8,432,432,18,10,8,2,1
12,456,456,139,96,43,2,1
7,471,471,36,36,0,1,0
16,471,471,18,18,0,1,0
0,490,490,160,154,6,2,1

14,100,100,5,5,0,1,0
7,116,116,5,1,4,2,1
18,166,166,24,24,0,1,0
4,175,175,23,9,14,2,1
11,178,178,7,7,0,1,0
3,227,227,17,9,8,3,2
19,263,263,28,2,26,2,1
12,312,312,36,10,26,3,2
20,322,322,121,49,72,4,3
8,334,334,82,82,0,1,0
16,375,375,22,2,20,3,2
2,379,379,21,21,0,1,0
9,381,381,77,33,44,3,2
17,386,386,28,16,12,4,3
10,401,401,20,20,0,1,0
1,464,464,26,26,0,1,0
6,478,478,17,17,0,1,0
21,486,486,18,18,0,1,0
15,495,495,32,32,0,1,0
13,495,495,46,8,38,4,3
5,498,498,32,32,0,1,0
0,500,500,52,19,33,2,1

25,104,104,32,10,22,2,1
16,108,108,3,3,0,1,0
5,118,118,3,3,0,1,0
9,129,129,6,6,0,1,0
21,148,148,26,26,0,1,0
24,168,168,8,2,6,3,2
2,175,175,2,2,0,1,0
3,179,179,19,4,15,4,3
11,180,180,4,4,0,1,0
14,189,189,45,45,0,1,0
8,200,200,3,3,0,1,0
13,204,204,8,8,0,1,0
29,213,213,47,28,19,2,1
19,244,244,12,9,3,2,1
17,254,254,20,20,0,1,0
26,255,255,6,6,0,1,0
12,287,287,5,5,0,1,0
6,298,298,1,1,0,1,0
15,367,367,3,3,0,1,0
4,378,378,22,22,0,1,0
10,387,387,17,10,7,2,1
20,392,392,13,13,0,1,0
1,439,439,70,20,50,3,2
27,444,444,2,2,0,1,0
22,455,455,49,49,0,1,0
23,472,472,14,14,0,1,0
18,477,477,2,2,0,1,0
7,479,479,22,13,9,2,1
28,482,482,81,81,0,1,0
0,486,486,49,20,29,3,2

15,107,107,13,3,10,3,2
9,118,118,8,1,7,2,1
5,142,142,10,10,0,1,0
6,158,158,6,1,5,2,1
11,258,258,12,12,0,1,0
0,280,280,125,125,0,1,0
18,296,296,6,1,5,2,1
12,298,298,30,10,20,3,2
21,298,298,56,56,0,1,0
14,305,305,30,22,8,2,1
22,351,351,4,1,3,2,1
2,354,354,5,5,0,1,0
7,355,355,1,1,0,1,0
16,359,359,84,67,17,2,1
4,362,362,2,2,0,1,0
20,378,378,32,8,24,4,3
3,382,382,21,21,0,1,0
8,427,427,86,71,15,2,1
10,443,443,12,12,0,1,0
1,449,449,11,11,0,1,0
19,470,470,20,9,11,2,1
13,476,476,81,81,0,1,0
17,499,499,74,6,68,3,2

13,119,119,8,8,0,1,0
2,121,121,7,1,6,2,1
8,125,125,2,2,0,1,0
10,126,126,15,9,6,2,1
16,131,131,12,8,4,2,1
14,135,135,1,1,0,1,0
0,140,140,8,8,0,1,0
5,186,186,42,2,40,2,1
12,188,188,36,36,0,1,0
3,194,194,6,3,3,2,1
7,195,195,1,1,0,1,0
22,232,232,33,8,25,2,1
23,252,252,28,23,5,2,1
15,252,252,6,6,0,1,0
24,262,262,5,5,0,1,0
4,300,300,27,27,0,1,0
6,304,304,27,19,8,2,1
1,356,356,5,2,3,2,1
25,379,379,32,27,5,2,1
11,382,382,30,6,24,2,1
18,386,386,94,94,0,1,0
19,407,407,16,16,0,1,0
20,422,422,11,11,0,1,0
9,436,436,13,8,5,2,1
17,453,453,104,68,36,4,3
21,459,459,61,39,22,3,2

7,135,135,6,6,0,1,0
11,172,172,11,11,0,1,0
19,192,192,23,23,0,1,0
15,192,192,9,1,8,3,2
12,226,226,23,14,9,4,3
8,262,262,7,7,0,1,0
3,275,275,25,25,0,1,0
13,277,277,14,14,0,1,0
16,277,277,46,46,0,1,0
5,290,290,23,11,12,3,2
1,293,293,6,6,0,1,0
0,340,340,9,9,0,1,0
2,342,342,95,40,55,3,2
14,375,375,82,82,0,1,0
10,377,377,63,63,0,1,0
9,378,378,88,26,62,3,2
6,380,380,32,3,29,2,1
4,431,431,94,94,0,1,0
17,438,438,13,3,10,3,2
18,465,465,69,69,0,1,0

5,112,112,2,2,0,1,0
9,151,151,34,34,0,1,0
16,155,155,31,31,0,1,0
17,160,160,13,13,0,1,0
8,202,202,88,88,0,1,0
0,222,222,1,1,0,1,0
13,234,234,53,35,18,4,3
12,257,257,35,14,21,4,3
4,270,270,11,11,0,1,0
18,294,294,31,1,30,4,3
11,312,312,6,6,0,1,0
14,319,319,15,15,0,1,0
2,374,374,10,3,7,2,1
1,374,374,84,24,60,4,3
10,386,386,24,9,15,4,3
7,406,406,99,35,64,4,3
3,415,415,12,6,6,3,2
6,434,434,34,34,0,1,0
15,492,492,10,10,0,1,0

6,103,103,1,1,0,1,0
8,107,107,3,3,0,1,0
26,114,114,2,2,0,1,0
13,116,116,18,14,4,2,1
5,129,129,2,2,0,1,0
15,137,137,22,14,8,3,2
18,141,141,67,67,0,1,0
23,215,215,18,18,0,1,0
17,226,226,1,1,0,1,0
0,240,240,10,3,7,2,1
16,254,254,23,12,11,2,1
19,256,256,41,41,0,1,0
14,262,262,14,11,3,2,1
22,263,263,11,11,0,1,0
20,268,268,44,44,0,1,0
3,268,268,13,3,10,2,1
25,281,281,17,17,0,1,0
11,285,285,2,2,0,1,0
7,293,293,18,8,10,2,1
21,309,309,4,4,0,1,0
2,311,311,16,16,0,1,0
12,383,383,11,1,10,3,2
9,391,391,55,25,30,4,3
10,399,399,1,1,0,1,0
4,409,409,80,80,0,1,0
24,437,437,46,14,32,2,1
1,491,491,6,6,0,1,0

1,109,109,13,13,0,1,0
18,145,145,16,7,9,2,1
6,186,186,12,2,10,2,1
3,197,197,63,63,0,1,0
13,254,254,3,3,0,1,0
10,270,270,11,11,0,1,0
2,286,286,1,1,0,1,0
20,287,287,100,60,40,3,2
14,295,295,1,1,0,1,0
16,300,300,5,5,0,1,0
5,316,316,3,3,0,1,0
19,319,319,13,13,0,1,0
0,328,328,12,12,0,1,0
9,344,344,58,58,0,1,0
12,364,364,66,3,63,3,2
7,391,391,16,16,0,1,0
22,417,417,13,13,0,1,0
4,423,423,22,17,5,2,1
8,455,455,10,10,0,1,0
21,468,468,210,176,34,3,2
17,473,473,2,2,0,1,0
15,475,475,48,48,0,1,0
11,490,490,21,21,0,1,0

13,103,103,1,1,0,1,0
16,117,117,1,1,0,1,0
21,139,139,13,13,0,1,0
0,142,142,4,4,0,1,0
10,149,149,8,8,0,1,0
24,181,181,20,20,0,1,0
4,196,196,1,1,0,1,0
11,198,198,1,1,0,1,0
17,199,199,6,3,3,2,1
3,201,201,15,10,5,2,1
8,209,209,56,56,0,1,0
14,226,226,6,6,0,1,0
18,237,237,44,23,21,4,3
25,240,240,68,17,51,3,2
2,248,248,4,4,0,1,0
1,248,248,48,48,0,1,0
20,274,274,67,67,0,1,0
9,276,276,2,2,0,1,0
22,297,297,18,18,0,1,0
7,313,313,6,6,0,1,0
23,320,320,26,9,17,2,1
12,321,321,24,3,21,2,1
19,358,358,13,13,0,1,0
15,364,364,66,66,0,1,0
5,378,378,8,2,6,3,2
6,423,423,49,41,8,3,2

16,119,119,15,15,0,1,0
10,142,142,1,1,0,1,0
12,170,170,6,6,0,1,0
18,222,222,44,20,24,4,3
14,256,256,34,34,0,1,0
9,264,264,6,6,0,1,0
17,268,268,37,28,9,4,3
15,279,279,17,11,6,2,1
0,348,348,26,7,19,3,2
1,351,351,66,24,42,4,3
3,352,352,5,5,0,1,0
4,361,361,80,17,63,3,2
7,365,365,7,7,0,1,0
20,368,368,25,10,15,3,2
5,379,379,165,165,0,1,0
2,393,393,22,22,0,1,0
6,395,395,9,9,0,1,0
8,407,407,16,5,11,2,1
13,420,420,31,10,21,2,1
19,440,440,53,53,0,1,0
11,458,458,76,56,20,2,1

10,128,128,15,15,0,1,0
19,144,144,37,37,0,1,0
7,159,159,11,11,0,1,0
6,171,171,10,10,0,1,0
17,188,188,17,17,0,1,0
16,202,202,26,26,0,1,0
1,205,205,8,8,0,1,0
18,220,220,38,26,12,4,3
0,227,227,4,1,3,2,1
9,231,231,59,26,33,4,3
8,252,252,50,46,4,2,1
2,282,282,26,26,0,1,0
12,329,329,2,2,0,1,0
5,341,341,54,28,26,2,1
11,368,368,42,12,30,4,3
15,372,372,23,23,0,1,0
20,462,462,119,119,0,1,0
3,465,465,15,15,0,1,0
14,484,484,3,3,0,1,0
13,484,484,13,13,0,1,0
4,497,497,32,32,0,1,0

22,100,100,8,8,0,1,0
17,127,127,3,3,0,1,0
19,132,132,3,3,0,1,0
5,152,152,16,4,12,4,3
14,157,157,9,9,0,1,0
10,199,199,7,7,0,1,0
4,211,211,56,56,0,1,0
9,220,220,2,2,0,1,0
20,220,220,22,22,0,1,0
2,254,254,29,13,16,3,2
7,260,260,7,7,0,1,0
11,266,266,2,2,0,1,0
25,317,317,66,66,0,1,0
24,327,327,40,40,0,1,0
13,353,353,51,1,50,3,2
15,366,366,6,6,0,1,0
8,400,400,18,18,0,1,0
6,402,402,16,16,0,1,0
1,434,434,36,36,0,1,0
16,441,441,147,147,0,1,0
0,456,456,52,52,0,1,0
21,473,473,70,1,69,4,3
3,481,481,4,4,0,1,0
12,483,483,14,14,0,1,0
18,494,494,10,10,0,1,0
23,496,496,32,32,0,1,0

8,131,131,7,7,0,1,0
0,175,175,17,14,3,2,1
6,222,222,22,6,16,2,1
15,242,242,23,7,16,2,1
9,256,256,58,10,48,4,3
4,259,259,38,38,0,1,0
12,284,284,56,56,0,1,0
10,298,298,34,34,0,1,0
5,307,307,6,6,0,1,0
11,314,314,55,55,0,1,0
3,323,323,14,10,4,2,1
18,344,344,16,16,0,1,0
17,349,349,36,7,29,2,1
7,353,353,19,1,18,2,1
19,354,354,30,19,11,2,1
1,376,376,71,71,0,1,0
16,381,381,74,71,3,2,1
2,471,471,81,73,8,2,1
13,476,476,44,44,0,1,0
14,486,486,7,7,0,1,0

17,118,118,13,13,0,1,0
19,122,122,6,6,0,1,0
7,137,137,11,11,0,1,0
8,141,141,25,6,19,2,1
20,157,157,39,39,0,1,0
6,160,160,29,9,20,4,3
21,185,185,39,1,38,3,2
22,187,187,22,14,8,2,1
5,222,222,47,18,29,2,1
15,292,292,1,1,0,1,0
11,336,336,23,23,0,1,0
0,339,339,9,9,0,1,0
18,362,362,29,13,16,2,1
3,364,364,33,33,0,1,0
16,376,376,35,35,0,1,0
13,384,384,54,36,18,4,3
14,394,394,27,18,9,4,3
9,395,395,32,32,0,1,0
2,425,425,5,5,0,1,0
1,441,441,14,7,7,2,1
10,451,451,58,58,0,1,0
4,484,484,1,1,0,1,0
12,484,484,5,5,0,1,0

10,121,121,22,6,16,3,2
16,184,184,32,32,0,1,0
14,191,191,6,6,0,1,0
5,210,210,26,7,19,3,2
12,220,220,7,7,0,1,0
8,238,238,9,9,0,1,0
6,251,251,114,76,38,3,2
18,267,267,4,4,0,1,0
13,267,267,44,7,37,2,1
1,306,306,4,4,0,1,0
19,333,333,11,11,0,1,0
7,337,337,23,7,16,4,3
2,365,365,48,4,44,3,2
17,372,372,116,8,108,4,3
15,411,411,5,5,0,1,0
11,415,415,7,1,6,2,1
20,434,434,145,125,20,2,1
4,439,439,11,11,0,1,0
9,442,442,16,16,0,1,0
3,448,448,2,2,0,1,0
0,478,478,14,9,5,2,1

0,106,106,21,21,0,1,0
18,126,126,40,24,16,3,2
17,127,127,13,13,0,1,0
7,128,128,28,28,0,1,0
19,128,128,2,2,0,1,0
8,142,142,1,1,0,1,0
5,159,159,20,20,0,1,0
15,170,170,13,13,0,1,0
10,218,218,15,15,0,1,0
21,246,246,65,65,0,1,0
1,252,252,39,39,0,1,0
20,259,259,1,1,0,1,0
16,286,286,5,5,0,1,0
12,310,310,59,35,24,3,2
11,316,316,49,7,42,2,1
14,330,330,3,3,0,1,0
2,338,338,8,8,0,1,0
13,353,353,45,45,0,1,0
4,392,392,11,1,10,3,2
3,403,403,6,2,4,2,1
9,460,460,5,5,0,1,0
6,461,461,44,44,0,1,0

10,142,142,39,39,0,1,0
16,144,144,25,25,0,1,0
5,145,145,22,22,0,1,0
2,153,153,32,26,6,3,2
11,205,205,15,15,0,1,0
18,208,208,16,4,12,3,2
12,210,210,51,7,44,2,1
3,251,251,18,18,0,1,0
6,263,263,26,26,0,1,0
17,270,270,44,22,22,2,1
1,270,270,10,10,0,1,0
13,282,282,2,2,0,1,0
4,313,313,75,75,0,1,0
15,319,319,8,8,0,1,0
9,323,323,1,1,0,1,0
0,342,342,34,6,28,2,1
8,414,414,20,20,0,1,0
7,441,441,63,63,0,1,0
14,462,462,14,14,0,1,0
19,495,495,28,6,22,3,2

7,104,104,1,1,0,1,0
8,176,176,22,13,9,2,1
15,183,183,20,4,16,3,2
16,224,224,57,6,51,4,3
2,230,230,31,1,30,3,2
3,254,254,94,94,0,1,0
12,258,258,15,15,0,1,0
9,304,304,2,2,0,1,0
17,307,307,5,5,0,1,0
13,310,310,22,22,0,1,0
11,319,319,85,3,82,3,2
0,342,342,10,6,4,2,1
5,347,347,54,54,0,1,0
14,348,348,19,19,0,1,0
10,369,369,57,29,28,3,2
1,385,385,128,128,0,1,0
6,418,418,4,4,0,1,0
4,482,482,32,7,25,2,1

11,118,118,12,12,0,1,0
21,154,154,8,8,0,1,0
12,197,197,5,2,3,2,1
19,208,208,35,26,9,4,3
13,219,219,32,32,0,1,0
8,236,236,4,4,0,1,0
22,253,253,15,10,5,2,1
6,258,258,30,30,0,1,0
7,284,284,6,6,0,1,0
14,292,292,37,20,17,2,1
1,300,300,69,1,68,3,2
10,309,309,3,3,0,1,0
9,316,316,17,17,0,1,0
5,326,326,21,1,20,3,2
20,344,344,34,34,0,1,0
16,354,354,37,37,0,1,0
18,377,377,7,1,6,2,1
0,385,385,67,16,51,4,3
4,390,390,44,22,22,3,2
3,407,407,62,12,50,3,2
17,444,444,102,92,10,2,1
15,476,476,53,16,37,2,1
2,482,482,12,5,7,2,1

21,108,108,10,10,0,1,0
5,130,130,18,18,0,1,0
17,135,135,5,5,0,1,0
15,151,151,19,19,0,1,0
19,165,165,5,2,3,2,1
8,182,182,23,10,13,2,1
4,201,201,22,22,0,1,0
6,208,208,6,6,0,1,0
13,250,250,44,20,24,2,1
10,271,271,29,29,0,1,0
3,315,315,33,33,0,1,0
7,326,326,59,5,54,3,2
11,326,326,8,8,0,1,0
16,403,403,159,117,42,2,1
0,405,405,72,42,30,4,3
2,412,412,22,9,13,2,1
9,418,418,9,9,0,1,0
14,438,438,22,12,10,2,1
12,445,445,34,4,30,3,2
20,447,447,2,2,0,1,0
18,462,462,60,22,38,2,1
1,469,469,14,7,7,2,1

13,121,121,41,29,12,2,1
12,122,122,3,3,0,1,0
0,167,167,2,2,0,1,0
3,176,176,77,18,59,4,3
4,215,215,17,9,8,3,2
18,255,255,23,15,8,3,2
16,258,258,7,7,0,1,0
2,284,284,25,5,20,2,1
20,288,288,53,13,40,3,2
6,292,292,1,1,0,1,0
8,303,303,58,28,30,3,2
19,304,304,57,1,56,3,2
9,305,305,38,14,24,3,2
17,328,328,43,43,0,1,0
10,331,331,2,2,0,1,0
7,336,336,30,2,28,3,2
11,340,340,6,6,0,1,0
1,345,345,17,17,0,1,0
5,393,393,8,3,5,2,1
15,402,402,24,11,13,2,1
14,493,493,27,27,0,1,0

8,101,101,1,1,0,1,0
13,102,102,25,25,0,1,0
15,120,120,2,2,0,1,0
19,125,125,27,9,18,2,1
2,129,129,30,4,26,3,2
17,168,168,9,3,6,3,2
9,174,174,3,3,0,1,0
3,256,256,22,22,0,1,0
10,301,301,77,29,48,3,2
1,311,311,22,16,6,2,1
14,335,335,40,40,0,1,0
16,378,378,39,39,0,1,0
12,387,387,108,108,0,1,0
7,395,395,23,23,0,1,0
11,403,403,17,17,0,1,0
4,443,443,80,80,0,1,0
20,455,455,1,1,0,1,0
0,460,460,47,37,10,2,1
5,464,464,19,19,0,1,0
18,477,477,5,5,0,1,0
21,499,499,36,6,30,2,1
6,500,500,3,3,0,1,0

14,108,108,11,11,0,1,0
7,116,116,3,3,0,1,0
4,118,118,50,7,43,2,1
9,118,118,34,34,0,1,0
2,121,121,34,34,0,1,0
10,124,124,10,10,0,1,0
0,134,134,24,24,0,1,0
15,196,196,31,1,30,3,2
11,223,223,25,25,0,1,0
12,226,226,14,14,0,1,0
1,296,296,1,1,0,1,0
13,298,298,7,3,4,2,1
8,319,319,84,84,0,1,0
5,326,326,29,20,9,4,3
6,447,447,8,3,5,2,1
3,450,450,57,57,0,1,0

12,121,121,8,3,5,2,1
9,124,124,10,5,5,2,1
6,148,148,1,1,0,1,0
0,160,160,14,14,0,1,0
16,228,228,4,1,3,2,1
11,235,235,5,1,4,2,1
18,268,268,51,51,0,1,0
8,272,272,1,1,0,1,0
15,276,276,1,1,0,1,0
14,312,312,78,45,33,4,3
4,353,353,135,135,0,1,0
2,363,363,23,2,21,4,3
3,365,365,20,11,9,4,3
13,402,402,70,49,21,4,3
7,404,404,4,4,0,1,0
10,412,412,110,58,52,4,3
1,436,436,110,77,33,4,3
19,486,486,55,15,40,3,2
17,487,487,8,2,6,2,1
5,491,491,78,36,42,4,3

11,114,114,12,1,11,2,1
14,194,194,53,53,0,1,0
2,213,213,14,5,9,4,3
5,217,217,82,64,18,4,3
16,220,220,11,1,10,2,1
8,231,231,18,18,0,1,0
12,246,246,6,6,0,1,0
4,252,252,3,3,0,1,0
9,296,296,46,35,11,2,1
0,310,310,4,1,3,2,1
1,311,311,81,81,0,1,0
15,331,331,53,6,47,2,1
10,334,334,41,41,0,1,0
3,355,355,16,16,0,1,0
7,367,367,51,51,0,1,0
13,438,438,6,6,0,1,0
6,491,491,161,117,44,2,1

19,114,114,5,5,0,1,0
20,133,133,13,13,0,1,0
15,134,134,11,6,5,2,1
5,135,135,1,1,0,1,0
6,136,136,6,3,3,2,1
21,160,160,8,2,6,2,1
16,161,161,13,13,0,1,0
14,185,185,28,28,0,1,0
1,186,186,6,6,0,1,0
9,216,216,52,52,0,1,0
22,224,224,40,40,0,1,0
2,233,233,2,2,0,1,0
3,279,279,73,10,63,4,3
11,343,343,13,13,0,1,0
4,359,359,1,1,0,1,0
18,361,361,56,56,0,1,0
7,362,362,39,1,38,3,2
10,373,373,64,64,0,1,0
13,393,393,46,4,42,2,1
8,429,429,9,9,0,1,0
0,434,434,62,47,15,2,1
17,465,465,77,77,0,1,0
12,487,487,11,11,0,1,0

15,114,114,16,16,0,1,0
21,122,122,10,10,0,1,0
2,123,123,34,34,0,1,0
1,126,126,11,7,4,2,1
8,188,188,15,15,0,1,0
18,215,215,22,22,0,1,0
0,239,239,8,8,0,1,0
23,241,241,28,2,26,3,2
20,246,246,48,48,0,1,0
22,248,248,8,8,0,1,0
11,258,258,11,1,10,4,3
17,268,268,8,8,0,1,0
14,308,308,12,7,5,2,1
16,310,310,58,39,19,2,1
5,317,317,2,2,0,1,0
3,320,320,13,13,0,1,0
6,354,354,48,19,29,2,1
13,359,359,18,18,0,1,0
4,362,362,25,25,0,1,0
19,364,364,75,75,0,1,0
10,391,391,2,2,0,1,0
7,422,422,49,49,0,1,0
12,425,425,65,45,20,2,1
9,487,487,3,3,0,1,0

13,100,100,1,1,0,1,0
8,103,103,1,1,0,1,0
14,130,130,15,11,4,2,1
12,138,138,20,20,0,1,0
16,165,165,31,20,11,2,1
10,165,165,6,6,0,1,0
5,203,203,67,47,20,2,1
15,227,227,84,84,0,1,0
0,233,233,4,4,0,1,0
3,242,242,13,1,12,4,3
4,243,243,32,23,9,2,1
1,252,252,28,28,0,1,0
17,300,300,21,6,15,2,1
9,374,374,1,1,0,1,0
2,392,392,33,4,29,2,1
7,458,458,8,8,0,1,0
11,460,460,85,85,0,1,0
6,495,495,176,27,149,4,3

19,114,114,1,1,0,1,0
5,147,147,4,4,0,1,0
14,151,151,30,8,22,2,1
17,204,204,96,96,0,1,0
12,211,211,4,4,0,1,0
11,237,237,57,57,0,1,0
15,253,253,27,3,24,2,1
16,256,256,29,8,21,2,1
7,278,278,13,13,0,1,0
3,293,293,15,15,0,1,0
8,296,296,78,64,14,2,1
2,320,320,12,12,0,1,0
1,369,369,24,9,15,4,3
21,372,372,9,9,0,1,0
0,374,374,13,4,9,2,1
20,377,377,5,5,0,1,0
18,431,431,13,9,4,2,1
13,435,435,61,7,54,4,3
6,461,461,16,10,6,2,1
9,482,482,19,12,7,2,1
10,484,484,77,77,0,1,0
4,499,499,51,15,36,4,3

15,112,112,9,9,0,1,0
0,133,133,8,8,0,1,0
25,149,149,1,1,0,1,0
16,162,162,14,2,12,3,2
1,164,164,1,1,0,1,0
19,187,187,23,3,20,2,1
10,205,205,10,4,6,3,2
3,244,244,12,3,9,4,3
4,249,249,1,1,0,1,0
11,266,266,73,73,0,1,0
6,294,294,10,10,0,1,0
22,296,296,43,43,0,1,0
18,339,339,51,39,12,3,2
8,348,348,14,14,0,1,0
24,351,351,65,65,0,1,0
14,371,371,34,34,0,1,0
12,387,387,9,9,0,1,0
7,401,401,18,11,7,2,1
2,414,414,4,4,0,1,0
9,421,421,4,4,0,1,0
20,433,433,118,56,62,3,2
13,447,447,36,36,0,1,0
23,452,452,51,51,0,1,0
17,464,464,9,5,4,2,1
5,475,475,117,47,70,3,2
21,491,491,9,1,8,2,1

0,106,106,3,3,0,1,0
21,147,147,10,10,0,1,0
22,163,163,12,12,0,1,0
8,174,174,7,7,0,1,0
12,177,177,40,40,0,1,0
9,178,178,1,1,0,1,0
13,202,202,1,1,0,1,0
11,212,212,11,11,0,1,0
10,215,215,25,25,0,1,0
18,216,216,36,21,15,4,3
16,246,246,6,6,0,1,0
7,254,254,1,1,0,1,0
23,288,288,80,80,0,1,0
6,316,316,47,16,31,3,2
24,319,319,1,1,0,1,0
19,332,332,19,19,0,1,0
17,368,368,73,58,15,4,3
5,369,369,43,7,36,2,1
3,377,377,3,3,0,1,0
14,399,399,36,20,16,3,2
1,443,443,66,14,52,3,2
15,452,452,47,33,14,2,1
4,459,459,33,33,0,1,0
20,479,479,69,69,0,1,0
2,488,488,19,19,0,1,0

5,138,138,9,9,0,1,0
7,160,160,52,37,15,2,1
17,170,170,44,27,17,2,1
24,174,174,12,12,0,1,0
15,212,212,70,28,42,3,2
23,227,227,31,31,0,1,0
6,249,249,67,67,0,1,0
22,261,261,4,4,0,1,0
12,262,262,33,33,0,1,0
1,271,271,1,1,0,1,0
4,290,290,37,29,8,2,1
9,303,303,4,4,0,1,0
19,317,317,29,29,0,1,0
21,356,356,41,41,0,1,0
11,366,366,1,1,0,1,0
13,378,378,11,11,0,1,0
18,396,396,20,3,17,2,1
14,397,397,23,23,0,1,0
8,397,397,4,4,0,1,0
2,402,402,9,5,4,2,1
10,419,419,7,7,0,1,0
20,448,448,15,6,9,4,3
0,451,451,7,7,0,1,0
3,456,456,8,8,0,1,0
16,492,492,9,9,0,1,0

10,104,104,3,3,0,1,0
11,107,107,19,6,13,2,1
2,119,119,2,2,0,1,0
20,125,125,4,4,0,1,0
0,185,185,31,7,24,2,1
3,187,187,6,6,0,1,0
16,191,191,72,60,12,2,1
9,201,201,39,39,0,1,0
22,226,226,39,39,0,1,0
1,255,255,10,10,0,1,0
21,290,290,11,11,0,1,0
6,301,301,3,3,0,1,0
7,322,322,58,58,0,1,0
4,349,349,3,3,0,1,0
19,350,350,16,16,0,1,0
13,363,363,52,52,0,1,0
12,371,371,13,9,4,2,1
8,422,422,9,9,0,1,0
5,425,425,81,57,24,4,3
14,457,457,15,1,14,3,2
15,476,476,23,11,12,3,2
18,488,488,43,43,0,1,0
17,491,491,69,33,36,4,3

15,125,125,19,19,0,1,0
2,168,168,40,23,17,2,1
13,192,192,9,9,0,1,0
7,200,200,8,2,6,2,1
10,249,249,10,10,0,1,0
8,263,263,10,10,0,1,0
0,269,269,71,2,69,4,3
1,282,282,8,4,4,2,1
12,286,286,6,6,0,1,0
17,288,288,1,1,0,1,0
6,293,293,46,17,29,2,1
9,350,350,27,21,6,3,2
4,355,355,3,3,0,1,0
14,401,401,117,55,62,3,2
3,414,414,123,27,96,4,3
11,438,438,54,54,0,1,0
16,446,446,28,28,0,1,0
5,452,452,14,14,0,1,0
18,478,478,143,143,0,1,0

1,113,113,9,1,8,2,1
8,121,121,8,8,0,1,0
5,138,138,8,8,0,1,0
13,138,138,16,16,0,1,0
0,188,188,28,28,0,1,0
14,198,198,5,5,0,1,0
2,230,230,9,1,8,2,1
4,235,235,45,45,0,1,0
20,248,248,21,7,14,3,2
21,252,252,68,22,46,3,2
9,269,269,26,26,0,1,0
16,304,304,14,14,0,1,0
12,326,326,69,43,26,2,1
11,334,334,27,27,0,1,0
6,343,343,38,38,0,1,0
15,374,374,11,3,8,3,2
19,453,453,75,67,8,3,2
3,456,456,1,1,0,1,0
10,457,457,92,92,0,1,0
18,487,487,54,54,0,1,0
7,492,492,13,13,0,1,0
17,499,499,27,27,0,1,0

5,101,101,3,3,0,1,0
16,124,124,18,18,0,1,0
14,138,138,7,2,5,2,1
7,146,146,40,40,0,1,0
15,166,166,7,7,0,1,0
2,171,171,1,1,0,1,0
12,175,175,26,5,21,4,3
20,176,176,1,1,0,1,0
8,200,200,4,4,0,1,0
18,219,219,29,29,0,1,0
3,222,222,1,1,0,1,0
17,262,262,24,24,0,1,0
11,263,263,17,17,0,1,0
13,290,290,16,4,12,2,1
10,305,305,36,31,5,2,1
0,309,309,26,22,4,2,1
6,317,317,101,45,56,3,2
9,320,320,3,3,0,1,0
4,356,356,12,3,9,4,3
1,409,409,57,18,39,2,1
21,451,451,139,73,66,4,3
19,465,465,71,71,0,1,0

17,107,107,4,4,0,1,0
3,113,113,28,17,11,2,1
12,138,138,2,2,0,1,0
21,153,153,11,11,0,1,0
15,157,157,24,24,0,1,0
11,164,164,7,7,0,1,0
18,182,182,29,1,28,3,2
5,216,216,53,53,0,1,0
23,225,225,4,1,3,2,1
6,246,246,16,2,14,3,2
22,253,253,10,1,9,2,1
14,268,268,45,45,0,1,0
19,281,281,53,13,40,3,2
4,287,287,10,6,4,2,1
9,290,290,26,15,11,4,3
2,334,334,11,11,0,1,0
7,335,335,9,4,5,2,1
10,342,342,17,17,0,1,0
13,369,369,49,49,0,1,0
1,386,386,32,14,18,2,1
0,391,391,11,11,0,1,0
16,393,393,104,80,24,2,1
20,397,397,10,10,0,1,0
8,441,441,3,3,0,1,0

14,105,105,1,1,0,1,0
13,117,117,24,24,0,1,0
11,124,124,1,1,0,1,0
7,128,128,10,3,7,2,1
9,168,168,24,10,14,2,1
5,194,194,22,22,0,1,0
16,206,206,78,78,0,1,0
0,263,263,66,50,16,2,1
6,285,285,41,21,20,2,1
4,287,287,4,1,3,2,1
1,289,289,91,91,0,1,0
12,339,339,1,1,0,1,0
3,344,344,51,51,0,1,0
8,441,441,84,84,0,1,0
2,449,449,52,25,27,2,1
10,468,468,18,11,7,2,1
15,477,477,39,24,15,4,3

19,124,124,9,9,0,1,0
4,148,148,37,10,27,4,3
12,160,160,3,3,0,1,0
2,174,174,5,5,0,1,0
16,192,192,45,45,0,1,0
3,197,197,40,5,35,2,1
6,213,213,4,1,3,2,1
13,223,223,3,3,0,1,0
7,280,280,4,4,0,1,0
18,320,320,8,8,0,1,0
10,323,323,32,4,28,2,1
8,331,331,43,16,27,2,1
11,345,345,41,1,40,2,1
21,390,390,80,80,0,1,0
1,436,436,3,3,0,1,0
9,439,439,13,3,10,2,1
20,441,441,54,54,0,1,0
17,456,456,10,3,7,2,1
14,462,462,149,71,78,4,3
5,463,463,31,31,0,1,0
0,476,476,64,4,60,4,3
15,482,482,40,14,26,3,2

0,112,112,24,24,0,1,0
11,112,112,10,10,0,1,0
5,133,133,11,11,0,1,0
3,185,185,4,4,0,1,0
1,232,232,149,149,0,1,0
2,253,253,50,42,8,2,1
8,325,325,45,1,44,3,2
12,339,339,12,12,0,1,0
14,341,341,8,2,6,3,2
9,344,344,95,95,0,1,0
13,350,350,58,10,48,4,3
4,372,372,10,1,9,2,1
10,425,425,12,2,10,3,2
6,434,434,24,24,0,1,0
7,488,488,107,84,23,2,1

9,129,129,2,2,0,1,0
17,130,130,11,4,7,2,1
23,142,142,21,3,18,3,2
19,154,154,4,4,0,1,0
10,194,194,7,7,0,1,0
4,211,211,6,1,5,2,1
2,237,237,12,9,3,2,1
16,253,253,1,1,0,1,0
7,256,256,11,2,9,2,1
13,296,296,6,6,0,1,0
14,311,311,5,5,0,1,0
0,313,313,3,3,0,1,0
24,315,315,19,19,0,1,0
25,320,320,52,52,0,1,0
12,322,322,24,8,16,2,1
3,324,324,35,35,0,1,0
18,342,342,59,44,15,4,3
15,356,356,29,29,0,1,0
1,374,374,4,4,0,1,0
8,388,388,92,42,50,2,1
5,397,397,53,6,47,4,3
26,416,416,3,3,0,1,0
21,434,434,98,98,0,1,0
6,449,449,2,2,0,1,0
11,460,460,105,105,0,1,0
20,463,463,66,66,0,1,0
22,492,492,47,47,0,1,0

5,117,117,7,2,5,2,1
11,125,125,22,16,6,2,1
18,149,149,7,7,0,1,0
14,149,149,30,30,0,1,0
4,167,167,18,15,3,2,1
7,222,222,16,2,14,3,2
2,273,273,15,15,0,1,0
23,287,287,15,5,10,2,1
17,328,328,9,9,0,1,0
16,374,374,18,5,13,2,1
15,408,408,76,24,52,3,2
8,413,413,11,5,6,3,2
1,415,415,9,9,0,1,0
3,418,418,53,53,0,1,0
12,419,419,8,2,6,2,1
9,421,421,22,22,0,1,0
13,426,426,118,118,0,1,0
22,427,427,82,47,35,3,2
10,447,447,3,3,0,1,0
6,450,450,40,11,29,2,1
19,481,481,114,114,0,1,0
21,482,482,28,28,0,1,0
0,488,488,6,6,0,1,0
20,493,493,35,35,0,1,0

17,111,111,16,16,0,1,0
6,143,143,2,2,0,1,0
8,150,150,29,7,22,3,2
25,160,160,80,80,0,1,0
1,181,181,22,8,14,2,1
3,191,191,8,8,0,1,0
21,207,207,8,8,0,1,0
4,210,210,6,6,0,1,0
13,217,217,10,10,0,1,0
14,253,253,3,3,0,1,0
5,254,254,7,7,0,1,0
18,307,307,28,28,0,1,0
16,324,324,10,1,9,2,1
11,343,343,23,8,15,4,3
12,348,348,30,30,0,1,0
20,359,359,79,79,0,1,0
15,372,372,22,22,0,1,0
0,375,375,1,1,0,1,0
23,375,375,17,17,0,1,0
19,409,409,7,7,0,1,0
2,416,416,3,3,0,1,0
10,455,455,30,30,0,1,0
24,458,458,6,6,0,1,0
22,467,467,11,11,0,1,0
9,488,488,125,76,49,2,1
7,492,492,36,15,21,2,1

21,100,100,9,4,5,2,1
11,114,114,1,1,0,1,0
23,119,119,18,6,12,4,3
16,122,122,7,7,0,1,0
19,135,135,37,37,0,1,0
13,143,143,32,27,5,2,1
2,174,174,33,33,0,1,0
18,178,178,16,9,7,2,1
6,190,190,4,4,0,1,0
0,195,195,2,2,0,1,0
7,195,195,6,6,0,1,0
3,196,196,13,13,0,1,0
1,205,205,14,14,0,1,0
9,232,232,12,3,9,2,1
10,250,250,32,32,0,1,0
8,265,265,34,16,18,2,1
4,270,270,12,4,8,3,2
22,271,271,34,34,0,1,0
17,287,287,33,33,0,1,0
15,374,374,21,9,12,2,1
5,412,412,53,38,15,2,1
14,447,447,54,21,33,3,2
20,458,458,19,3,16,2,1
12,480,480,3,3,0,1,0

17,137,137,1,1,0,1,0
26,147,147,31,31,0,1,0
18,165,165,6,1,5,2,1
9,166,166,10,10,0,1,0
15,188,188,2,2,0,1,0
4,188,188,5,5,0,1,0
14,200,200,15,15,0,1,0
13,232,232,3,3,0,1,0
3,235,235,42,42,0,1,0
12,248,248,19,19,0,1,0
10,264,264,58,58,0,1,0
24,300,300,30,30,0,1,0
1,327,327,15,15,0,1,0
25,332,332,26,16,10,2,1
11,345,345,48,48,0,1,0
16,347,347,5,5,0,1,0
19,358,358,4,4,0,1,0
22,365,365,12,4,8,3,2
2,372,372,23,11,12,4,3
21,384,384,38,23,15,4,3
6,385,385,34,18,16,2,1
20,387,387,102,102,0,1,0
23,392,392,111,45,66,4,3
7,428,428,10,2,8,3,2
8,468,468,4,4,0,1,0
0,477,477,16,16,0,1,0
5,488,488,12,12,0,1,0

17,109,109,22,14,8,2,1
15,111,111,8,8,0,1,0
14,123,123,6,2,4,2,1
0,178,178,7,7,0,1,0
5,229,229,4,4,0,1,0
11,245,245,123,89,34,3,2
20,253,253,37,22,15,2,1
6,257,257,9,9,0,1,0
21,261,261,4,4,0,1,0
13,262,262,6,6,0,1,0
18,280,280,11,3,8,3,2
12,284,284,72,42,30,4,3
10,298,298,22,4,18,3,2
2,327,327,5,5,0,1,0
4,339,339,30,30,0,1,0
16,395,395,85,70,15,4,3
1,423,423,15,2,13,2,1
8,427,427,15,15,0,1,0
3,436,436,88,57,31,2,1
19,453,453,45,45,0,1,0
7,463,463,11,11,0,1,0
9,494,494,17,17,0,1,0

10,140,140,20,9,11,2,1
1,153,153,1,1,0,1,0
7,176,176,56,56,0,1,0
15,176,176,32,32,0,1,0
13,213,213,54,54,0,1,0
8,230,230,13,8,5,2,1
4,241,241,45,21,24,4,3
9,255,255,16,13,3,2,1
11,341,341,14,14,0,1,0
12,348,348,89,67,22,3,2
14,380,380,15,6,9,4,3
16,399,399,14,11,3,2,1
18,401,401,20,20,0,1,0
17,402,402,24,9,15,4,3
0,440,440,3,3,0,1,0
5,464,464,65,65,0,1,0
3,466,466,147,147,0,1,0
2,466,466,19,11,8,3,2
6,491,491,16,5,11,2,1

15,103,103,16,7,9,4,3
11,110,110,15,7,8,2,1
3,140,140,3,3,0,1,0
1,155,155,7,4,3,2,1
22,174,174,35,12,23,2,1
16,194,194,8,8,0,1,0
7,216,216,13,13,0,1,0
21,224,224,6,6,0,1,0
4,253,253,8,8,0,1,0
19,271,271,21,21,0,1,0
20,278,278,89,44,45,4,3
0,290,290,12,9,3,2,1
6,299,299,1,1,0,1,0
14,313,313,11,11,0,1,0
5,322,322,88,1,87,4,3
10,351,351,23,5,18,4,3
18,366,366,13,8,5,2,1
23,371,371,69,5,64,3,2
12,382,382,44,44,0,1,0
17,408,408,26,21,5,2,1
8,419,419,23,23,0,1,0
9,457,457,19,13,6,3,2
24,468,468,7,2,5,2,1
2,484,484,59,59,0,1,0
13,495,495,27,27,0,1,0

18,116,116,18,10,8,2,1
8,157,157,6,6,0,1,0
0,165,165,1,1,0,1,0
2,178,178,9,1,8,2,1
4,273,273,139,131,8,2,1
3,277,277,8,5,3,2,1
11,279,279,44,31,13,3,2
16,293,293,6,6,0,1,0
20,297,297,26,21,5,2,1
17,344,344,61,61,0,1,0
7,346,346,3,3,0,1,0
1,372,372,1,1,0,1,0
21,373,373,52,52,0,1,0
5,380,380,26,11,15,4,3
19,415,415,71,71,0,1,0
15,427,427,13,13,0,1,0
6,434,434,98,55,43,2,1
10,455,455,1,1,0,1,0
13,481,481,56,56,0,1,0
9,487,487,1,1,0,1,0
14,492,492,38,14,24,3,2
12,494,494,70,28,42,4,3

14,108,108,17,1,16,2,1
9,146,146,6,1,5,2,1
12,185,185,23,23,0,1,0
11,198,198,36,3,33,4,3
5,216,216,42,42,0,1,0
10,235,235,9,9,0,1,0
6,263,263,18,18,0,1,0
1,300,300,45,45,0,1,0
2,305,305,31,21,10,3,2
3,328,328,101,101,0,1,0
0,332,332,3,3,0,1,0
15,366,366,15,15,0,1,0
7,378,378,88,73,15,2,1
16,395,395,3,3,0,1,0
8,437,437,24,24,0,1,0
4,439,439,16,16,0,1,0
17,475,475,143,143,0,1,0
13,500,500,82,37,45,2,1

17,108,108,11,11,0,1,0
23,108,108,2,2,0,1,0
1,123,123,6,2,4,2,1
0,125,125,13,13,0,1,0
3,164,164,15,9,6,3,2
9,179,179,3,3,0,1,0
12,198,198,51,9,42,3,2
10,222,222,3,3,0,1,0
21,235,235,15,15,0,1,0
19,247,247,37,37,0,1,0
11,247,247,49,20,29,4,3
22,251,251,47,47,0,1,0
8,252,252,13,4,9,2,1
18,276,276,4,4,0,1,0
4,296,296,7,7,0,1,0
13,301,301,34,3,31,3,2
6,307,307,6,6,0,1,0
14,350,350,143,83,60,4,3
7,389,389,49,49,0,1,0
2,431,431,5,5,0,1,0
16,439,439,53,3,50,3,2
15,449,449,7,1,6,3,2
5,484,484,12,2,10,3,2
20,487,487,21,21,0,1,0

3,141,141,57,21,36,4,3
7,145,145,16,16,0,1,0
6,156,156,9,2,7,2,1
17,158,158,11,6,5,2,1
5,206,206,21,21,0,1,0
18,243,243,5,5,0,1,0
0,254,254,54,12,42,3,2
13,279,279,56,29,27,4,3
14,297,297,24,3,21,4,3
2,311,311,4,4,0,1,0
1,326,326,1,1,0,1,0
12,353,353,23,23,0,1,0
8,393,393,57,9,48,3,2
9,420,420,105,105,0,1,0
10,422,422,39,39,0,1,0
11,426,426,30,4,26,3,2
16,432,432,40,26,14,3,2
4,474,474,25,15,10,2,1
15,495,495,85,77,8,2,1

7,115,115,18,1,17,2,1
18,115,115,20,1,19,2,1
12,116,116,20,11,9,2,1
9,166,166,15,15,0,1,0
2,189,189,41,32,9,2,1
14,191,191,13,1,12,4,3
1,225,225,61,9,52,3,2
16,315,315,40,1,39,4,3
6,317,317,47,47,0,1,0
4,323,323,25,9,16,2,1
13,325,325,41,41,0,1,0
5,329,329,27,18,9,4,3
15,377,377,30,4,26,2,1
8,401,401,1,1,0,1,0
17,403,403,24,24,0,1,0
11,410,410,43,39,4,2,1
19,435,435,12,12,0,1,0
3,443,443,1,1,0,1,0
10,464,464,1,1,0,1,0
20,467,467,81,81,0,1,0
0,492,492,25,25,0,1,0

0,100,100,1,1,0,1,0
19,122,122,27,27,0,1,0
2,180,180,2,2,0,1,0
17,192,192,25,25,0,1,0
4,242,242,35,35,0,1,0
10,246,246,21,11,10,3,2
18,253,253,10,4,6,2,1
1,303,303,11,11,0,1,0
22,306,306,2,2,0,1,0
5,327,327,44,36,8,3,2
13,345,345,66,66,0,1,0
7,351,351,34,34,0,1,0
9,365,365,42,42,0,1,0
12,366,366,70,70,0,1,0
16,374,374,47,47,0,1,0
3,375,375,4,4,0,1,0
6,376,376,23,5,18,3,2
21,395,395,8,1,7,2,1
20,421,421,98,98,0,1,0
8,456,456,53,39,14,3,2
15,482,482,38,2,36,2,1
11,486,486,43,43,0,1,0
14,486,486,36,36,0,1,0

16,107,107,15,5,10,2,1
5,107,107,6,1,5,2,1
15,112,112,13,7,6,3,2
8,114,114,18,18,0,1,0
0,131,131,11,11,0,1,0
18,162,162,11,11,0,1,0
9,168,168,3,3,0,1,0
10,171,171,17,3,14,4,3
3,228,228,1,1,0,1,0
2,282,282,63,63,0,1,0
11,286,286,17,11,6,3,2
14,297,297,74,74,0,1,0
12,311,311,3,3,0,1,0
6,319,319,10,10,0,1,0
13,330,330,116,116,0,1,0
4,412,412,5,2,3,2,1
17,473,473,9,9,0,1,0
7,488,488,115,67,48,3,2
1,500,500,151,73,78,4,3

11,101,101,7,7,0,1,0
1,121,121,8,8,0,1,0
17,145,145,36,16,20,2,1
7,163,163,55,55,0,1,0
8,183,183,2,2,0,1,0
9,205,205,12,12,0,1,0
18,208,208,43,4,39,2,1
6,223,223,31,31,0,1,0
10,238,238,5,5,0,1,0
4,241,241,17,17,0,1,0
13,246,246,46,13,33,2,1
3,312,312,11,11,0,1,0
14,385,385,6,6,0,1,0
16,406,406,22,22,0,1,0
12,415,415,50,32,18,4,3
2,429,429,24,24,0,1,0
15,441,441,62,62,0,1,0
5,463,463,9,9,0,1,0
0,476,476,175,139,36,4,3

2,139,139,43,9,34,2,1
3,164,164,10,10,0,1,0
0,173,173,2,2,0,1,0
18,191,191,41,41,0,1,0
5,208,208,26,18,8,2,1
13,238,238,26,6,20,4,3
1,243,243,28,28,0,1,0
10,271,271,30,10,20,3,2
14,280,280,4,1,3,2,1
7,302,302,20,20,0,1,0
12,317,317,9,3,6,2,1
8,332,332,1,1,0,1,0
19,342,342,57,11,46,2,1
4,367,367,37,10,27,2,1
17,375,375,23,23,0,1,0
6,376,376,98,19,79,4,3
15,387,387,28,28,0,1,0
11,399,399,54,35,19,4,3
9,439,439,21,6,15,4,3
16,448,448,92,14,78,3,2

18,125,125,9,9,0,1,0
14,131,131,1,1,0,1,0
11,139,139,4,4,0,1,0
12,152,152,14,14,0,1,0
3,173,173,50,1,49,2,1
0,196,196,1,1,0,1,0
9,219,219,8,2,6,3,2
8,243,243,7,7,0,1,0
2,261,261,100,100,0,1,0
15,262,262,63,63,0,1,0
4,299,299,11,3,8,2,1
19,320,320,7,7,0,1,0
16,332,332,90,90,0,1,0
17,347,347,88,88,0,1,0
1,355,355,51,14,37,3,2
13,395,395,26,12,14,3,2
10,421,421,43,43,0,1,0
6,449,449,15,15,0,1,0
5,463,463,8,8,0,1,0
7,473,473,12,2,10,2,1
20,476,476,31,1,30,4,3

11,107,107,5,5,0,1,0
0,114,114,13,13,0,1,0
5,121,121,22,22,0,1,0
6,128,128,13,8,5,2,1
16,200,200,34,34,0,1,0
10,218,218,26,22,4,2,1
17,229,229,37,10,27,4,3
13,236,236,14,14,0,1,0
7,274,274,102,54,48,4,3
2,327,327,1,1,0,1,0
9,351,351,20,3,17,3,2
8,397,397,79,79,0,1,0
18,407,407,37,4,33,2,1
3,417,417,21,21,0,1,0
1,424,424,5,5,0,1,0
14,433,433,40,40,0,1,0
12,443,443,20,20,0,1,0
15,470,470,26,4,22,2,1
4,471,471,5,2,3,2,1
19,491,491,135,135,0,1,0

13,102,102,4,4,0,1,0
6,124,124,8,8,0,1,0
9,143,143,6,6,0,1,0
18,155,155,38,38,0,1,0
7,198,198,1,1,0,1,0
17,225,225,56,45,11,2,1
3,251,251,36,20,16,3,2
2,270,270,32,17,15,4,3
8,302,302,9,9,0,1,0
1,321,321,6,6,0,1,0
14,336,336,4,4,0,1,0
4,347,347,48,48,0,1,0
16,354,354,40,28,12,3,2
19,358,358,14,5,9,4,3
5,376,376,36,23,13,2,1
10,377,377,24,16,8,2,1
21,388,388,46,46,0,1,0
20,405,405,34,34,0,1,0
23,423,423,56,7,49,3,2
22,429,429,36,36,0,1,0
0,442,442,60,60,0,1,0
15,457,457,19,19,0,1,0
12,480,480,19,19,0,1,0
11,492,492,86,86,0,1,0

2,120,120,30,4,26,3,2
9,157,157,6,1,5,2,1
20,199,199,18,10,8,2,1
1,200,200,27,27,0,1,0
3,235,235,77,61,16,3,2
6,238,238,2,2,0,1,0
7,246,246,2,2,0,1,0
0,263,263,7,1,6,2,1
17,304,304,35,35,0,1,0
10,326,326,12,12,0,1,0
13,337,337,13,1,12,4,3
14,350,350,56,41,15,2,1
19,357,357,8,8,0,1,0
18,375,375,44,25,19,4,3
12,382,382,64,28,36,4,3
11,443,443,15,7,8,3,2
8,469,469,33,9,24,4,3
5,481,481,56,56,0,1,0
15,482,482,38,38,0,1,0
4,489,489,41,11,30,3,2
16,496,496,141,57,84,3,2

3,101,101,3,3,0,1,0
5,122,122,5,5,0,1,0
21,122,122,5,1,4,2,1
22,151,151,7,7,0,1,0
7,158,158,2,2,0,1,0
25,162,162,35,16,19,3,2
23,201,201,84,84,0,1,0
2,234,234,2,2,0,1,0
6,234,234,10,10,0,1,0
0,262,262,7,7,0,1,0
4,271,271,31,1,30,3,2
14,281,281,5,5,0,1,0
15,284,284,4,4,0,1,0
11,306,306,11,1,10,3,2
18,331,331,16,4,12,3,2
12,338,338,83,83,0,1,0
16,340,340,4,4,0,1,0
10,361,361,49,26,23,3,2
9,361,361,14,1,13,4,3
24,376,376,9,3,6,3,2
13,377,377,14,14,0,1,0
8,390,390,94,94,0,1,0
19,394,394,9,9,0,1,0
20,427,427,28,16,12,4,3
1,441,441,27,21,6,3,2
17,471,471,109,88,21,2,1

13,108,108,2,2,0,1,0
7,111,111,25,5,20,2,1
5,114,114,29,13,16,3,2
8,125,125,9,1,8,3,2
6,126,126,23,23,0,1,0
0,143,143,2,2,0,1,0
9,162,162,17,17,0,1,0
3,172,172,3,3,0,1,0
17,207,207,9,9,0,1,0
19,229,229,44,20,24,2,1
4,249,249,6,6,0,1,0
12,258,258,5,5,0,1,0
1,289,289,5,5,0,1,0
11,302,302,24,24,0,1,0
16,336,336,3,3,0,1,0
14,413,413,163,91,72,4,3
10,427,427,117,30,87,4,3
18,457,457,7,7,0,1,0
15,473,473,35,29,6,3,2
2,497,497,95,56,39,4,3

20,119,119,21,21,0,1,0
17,136,136,31,31,0,1,0
8,172,172,11,7,4,2,1
1,224,224,26,26,0,1,0
12,259,259,20,8,12,2,1
21,263,263,21,5,16,3,2
9,267,267,27,27,0,1,0
14,269,269,9,9,0,1,0
7,305,305,13,4,9,3,2
15,308,308,45,45,0,1,0
18,317,317,22,22,0,1,0
3,333,333,2,2,0,1,0
19,349,349,66,66,0,1,0
0,363,363,36,29,7,2,1
13,363,363,43,7,36,3,2
4,371,371,26,26,0,1,0
10,376,376,17,2,15,4,3
5,386,386,56,56,0,1,0
16,401,401,2,2,0,1,0
2,420,420,19,19,0,1,0
11,423,423,133,102,31,2,1
6,455,455,24,9,15,2,1

10,118,118,59,59,0,1,0
12,122,122,21,21,0,1,0
0,139,139,9,9,0,1,0
2,162,162,11,5,6,3,2
5,187,187,11,11,0,1,0
17,195,195,6,6,0,1,0
16,217,217,7,7,0,1,0
14,231,231,2,2,0,1,0
7,262,262,20,20,0,1,0
11,275,275,26,26,0,1,0
6,280,280,41,7,34,3,2
1,298,298,88,40,48,4,3
8,307,307,11,3,8,2,1
13,396,396,87,87,0,1,0
15,421,421,2,2,0,1,0
4,426,426,42,9,33,2,1
3,446,446,131,28,103,4,3
9,465,465,11,11,0,1,0

8,123,123,7,7,0,1,0
7,138,138,3,3,0,1,0
16,177,177,1,1,0,1,0
12,209,209,61,7,54,4,3
13,221,221,24,1,23,2,1
1,239,239,36,36,0,1,0
14,251,251,77,77,0,1,0
11,296,296,32,19,13,3,2
2,323,323,23,10,13,2,1
17,363,363,40,4,36,3,2
18,391,391,3,3,0,1,0
15,392,392,25,7,18,4,3
3,394,394,63,15,48,4,3
5,416,416,37,13,24,3,2
10,428,428,31,31,0,1,0
6,429,429,24,24,0,1,0
0,443,443,124,107,17,4,3
9,452,452,20,20,0,1,0
4,476,476,104,104,0,1,0

14,164,164,23,23,0,1,0
3,165,165,13,13,0,1,0
6,184,184,81,81,0,1,0
7,214,214,20,5,15,2,1
1,219,219,33,26,7,2,1
12,225,225,14,1,13,2,1
4,232,232,55,55,0,1,0
8,260,260,68,68,0,1,0
0,272,272,18,4,14,4,3
9,284,284,12,12,0,1,0
11,418,418,119,72,47,3,2
5,433,433,1,1,0,1,0
13,442,442,49,49,0,1,0
15,444,444,48,48,0,1,0
16,453,453,16,5,11,2,1
2,476,476,16,16,0,1,0
17,476,476,8,2,6,2,1
10,486,486,28,16,12,4,3

1,114,114,4,4,0,1,0
10,137,137,8,8,0,1,0
16,172,172,36,36,0,1,0
9,211,211,1,1,0,1,0
6,214,214,60,53,7,2,1
19,214,214,13,6,7,2,1
22,224,224,37,31,6,3,2
5,229,229,2,2,0,1,0
13,268,268,19,19,0,1,0
20,356,356,43,4,39,2,1
18,364,364,3,3,0,1,0
4,366,366,93,93,0,1,0
8,382,382,3,3,0,1,0
15,402,402,54,16,38,2,1
2,406,406,20,20,0,1,0
21,409,409,44,2,42,4,3
11,441,441,96,96,0,1,0
14,443,443,55,40,15,4,3
12,452,452,39,34,5,2,1
0,460,460,15,15,0,1,0
3,479,479,9,6,3,2,1
17,480,480,55,55,0,1,0
7,486,486,23,23,0,1,0

19,107,107,4,4,0,1,0
3,155,155,3,3,0,1,0
2,198,198,48,48,0,1,0
7,210,210,25,25,0,1,0
8,233,233,3,3,0,1,0
1,243,243,38,20,18,3,2
12,273,273,2,2,0,1,0
6,289,289,1,1,0,1,0
16,293,293,88,22,66,3,2
13,301,301,50,50,0,1,0
5,340,340,80,23,57,4,3
9,353,353,15,1,14,3,2
15,361,361,18,18,0,1,0
4,366,366,10,10,0,1,0
10,373,373,30,6,24,4,3
14,387,387,31,21,10,2,1
18,416,416,99,99,0,1,0
17,469,469,12,1,11,2,1
0,480,480,117,37,80,3,2
11,481,481,62,47,15,3,2

15,112,112,8,8,0,1,0
19,152,152,25,25,0,1,0
11,262,262,9,9,0,1,0
4,272,272,22,22,0,1,0
18,272,272,20,6,14,3,2
7,281,281,15,15,0,1,0
2,296,296,7,3,4,2,1
1,304,304,30,12,18,3,2
5,309,309,74,74,0,1,0
3,318,318,38,38,0,1,0
14,366,366,19,19,0,1,0
12,373,373,12,6,6,3,2
6,374,374,52,43,9,4,3
13,387,387,60,60,0,1,0
17,390,390,191,191,0,1,0
10,414,414,3,3,0,1,0
8,422,422,128,115,13,2,1
9,456,456,13,6,7,2,1
0,474,474,7,7,0,1,0
16,488,488,19,1,18,4,3

9,137,137,26,26,0,1,0
17,144,144,3,3,0,1,0
11,145,145,1,1,0,1,0
8,146,146,19,19,0,1,0
19,313,313,17,17,0,1,0
18,337,337,24,11,13,2,1
6,364,364,1,1,0,1,0
15,366,366,35,35,0,1,0
16,367,367,119,119,0,1,0
7,373,373,53,14,39,2,1
0,374,374,5,5,0,1,0
12,379,379,59,26,33,2,1
13,395,395,63,48,15,2,1
4,415,415,20,20,0,1,0
10,423,423,6,6,0,1,0
2,425,425,106,44,62,4,3
3,451,451,51,9,42,3,2
20,453,453,22,16,6,2,1
14,470,470,87,73,14,2,1
1,477,477,92,34,58,3,2
5,484,484,2,2,0,1,0

21,104,104,10,3,7,2,1
13,109,109,10,10,0,1,0
10,127,127,15,15,0,1,0
8,134,134,3,3,0,1,0
17,135,135,33,3,30,3,2
5,141,141,10,10,0,1,0
0,153,153,3,3,0,1,0
12,154,154,2,2,0,1,0
7,162,162,19,11,8,2,1
22,317,317,6,6,0,1,0
6,318,318,41,41,0,1,0
15,325,325,65,65,0,1,0
4,364,364,43,28,15,4,3
2,397,397,86,62,24,4,3
18,397,397,47,47,0,1,0
11,410,410,13,6,7,2,1
20,416,416,8,8,0,1,0
14,429,429,50,32,18,4,3
16,432,432,70,70,0,1,0
1,442,442,84,37,47,2,1
9,459,459,20,20,0,1,0
19,472,472,30,30,0,1,0
3,497,497,5,1,4,2,1

11,102,102,6,3,3,2,1
3,114,114,49,25,24,4,3
13,115,115,4,4,0,1,0
5,141,141,5,5,0,1,0
8,150,150,4,4,0,1,0
19,151,151,8,8,0,1,0
12,154,154,23,3,20,3,2
9,159,159,11,11,0,1,0
20,165,165,12,3,9,2,1
10,173,173,2,2,0,1,0
14,173,173,18,8,10,2,1
2,183,183,17,3,14,2,1
0,205,205,21,13,8,2,1
1,291,291,16,10,6,2,1
21,308,308,82,39,43,2,1
17,333,333,13,5,8,3,2
18,361,361,14,8,6,3,2
4,361,361,34,3,31,3,2
16,397,397,18,18,0,1,0
7,398,398,41,41,0,1,0
6,425,425,11,11,0,1,0
15,446,446,144,120,24,3,2

6,101,101,4,4,0,1,0
8,120,120,29,29,0,1,0
15,127,127,2,2,0,1,0
1,131,131,19,19,0,1,0
3,133,133,10,10,0,1,0
23,159,159,11,11,0,1,0
7,170,170,13,13,0,1,0
11,176,176,36,36,0,1,0
10,186,186,1,1,0,1,0
22,212,212,27,27,0,1,0
2,221,221,1,1,0,1,0
17,240,240,4,4,0,1,0
19,261,261,76,63,13,2,1
21,266,266,3,3,0,1,0
20,338,338,110,48,62,3,2
13,364,364,11,11,0,1,0
14,365,365,39,30,9,4,3
12,391,391,5,5,0,1,0
5,411,411,10,1,9,4,3
9,418,418,9,9,0,1,0
0,448,448,38,16,22,4,3
4,475,475,64,17,47,3,2
16,494,494,51,1,50,2,1
18,494,494,25,25,0,1,0

12,136,136,12,12,0,1,0
1,141,141,17,8,9,4,3
10,146,146,6,6,0,1,0
9,162,162,6,3,3,2,1
0,169,169,5,5,0,1,0
3,209,209,25,25,0,1,0
11,216,216,14,8,6,3,2
2,221,221,110,110,0,1,0
8,298,298,115,115,0,1,0
7,316,316,39,4,35,3,2
5,368,368,44,44,0,1,0
14,395,395,47,12,35,4,3
4,397,397,73,55,18,4,3
16,411,411,3,3,0,1,0
15,415,415,14,7,7,2,1
13,430,430,93,57,36,2,1
6,486,486,15,15,0,1,0

23,100,100,10,7,3,2,1
11,105,105,3,3,0,1,0
22,110,110,23,7,16,2,1
8,126,126,1,1,0,1,0
18,129,129,27,1,26,2,1
2,137,137,9,9,0,1,0
17,158,158,3,3,0,1,0
0,189,189,3,3,0,1,0
10,214,214,3,3,0,1,0
20,218,218,13,13,0,1,0
3,225,225,25,4,21,4,3
1,255,255,35,17,18,3,2
21,259,259,20,20,0,1,0
7,277,277,66,26,40,2,1
5,285,285,3,3,0,1,0
19,351,351,50,43,7,2,1
24,373,373,72,11,61,4,3
6,380,380,16,16,0,1,0
14,381,381,68,55,13,2,1
12,388,388,41,3,38,3,2
4,397,397,43,43,0,1,0
16,399,399,15,1,14,3,2
13,402,402,14,4,10,3,2
15,425,425,31,31,0,1,0
9,493,493,1,1,0,1,0

14,126,126,24,24,0,1,0
6,142,142,16,4,12,4,3
10,155,155,9,9,0,1,0
3,181,181,2,2,0,1,0
12,182,182,2,2,0,1,0
18,198,198,67,67,0,1,0
4,232,232,28,19,9,4,3
21,258,258,28,28,0,1,0
22,259,259,6,6,0,1,0
23,281,281,21,21,0,1,0
2,281,281,1,1,0,1,0
17,293,293,21,21,0,1,0
7,312,312,24,18,6,3,2
8,394,394,11,11,0,1,0
5,408,408,23,23,0,1,0
11,415,415,6,2,4,2,1
19,424,424,49,10,39,4,3
1,435,435,152,152,0,1,0
15,454,454,44,44,0,1,0
16,462,462,9,9,0,1,0
20,462,462,36,33,3,2,1
13,471,471,24,24,0,1,0
0,474,474,88,88,0,1,0
9,476,476,11,11,0,1,0

13,135,135,1,1,0,1,0
8,153,153,1,1,0,1,0
21,162,162,17,5,12,4,3
22,165,165,36,36,0,1,0
5,184,184,11,5,6,3,2
9,244,244,7,2,5,2,1
11,251,251,7,3,4,2,1
12,278,278,1,1,0,1,0
19,315,315,33,3,30,2,1
16,339,339,12,12,0,1,0
15,348,348,50,38,12,4,3
23,351,351,9,9,0,1,0
4,355,355,11,3,8,2,1
2,357,357,21,3,18,4,3
17,366,366,30,30,0,1,0
10,396,396,26,5,21,2,1
24,397,397,99,99,0,1,0
20,400,400,38,12,26,2,1
14,409,409,186,186,0,1,0
6,430,430,9,9,0,1,0
7,446,446,75,75,0,1,0
0,450,450,23,8,15,4,3
1,452,452,19,19,0,1,0
3,456,456,34,2,32,4,3
18,456,456,26,15,11,2,1

21,108,108,16,16,0,1,0
17,109,109,8,8,0,1,0
6,113,113,4,4,0,1,0
24,125,125,17,17,0,1,0
2,150,150,18,18,0,1,0
14,176,176,6,6,0,1,0
7,186,186,13,7,6,2,1
5,194,194,15,9,6,3,2
0,210,210,6,6,0,1,0
20,223,223,10,10,0,1,0
10,224,224,17,17,0,1,0
22,268,268,24,24,0,1,0
11,297,297,23,23,0,1,0
23,310,310,82,82,0,1,0
9,355,355,57,33,24,4,3
3,369,369,11,11,0,1,0
12,383,383,18,18,0,1,0
18,392,392,3,3,0,1,0
15,393,393,58,58,0,1,0
8,413,413,11,3,8,2,1
1,428,428,57,24,33,2,1
13,438,438,45,33,12,4,3
19,468,468,79,58,21,3,2
16,488,488,23,23,0,1,0
4,500,500,41,21,20,2,1

0,100,100,17,17,0,1,0
23,123,123,5,2,3,2,1
17,128,128,11,11,0,1,0
21,132,132,22,22,0,1,0
5,141,141,1,1,0,1,0
2,145,145,22,22,0,1,0
9,162,162,1,1,0,1,0
4,173,173,11,11,0,1,0
7,180,180,17,9,8,3,2
15,243,243,25,1,24,3,2
10,277,277,5,5,0,1,0
1,288,288,9,3,6,2,1
8,337,337,40,16,24,4,3
22,359,359,151,70,81,4,3
14,382,382,32,4,28,3,2
20,388,388,30,30,0,1,0
16,408,408,19,5,14,2,1
13,456,456,123,82,41,4,3
18,462,462,19,19,0,1,0
12,464,464,24,24,0,1,0
6,467,467,1,1,0,1,0
3,475,475,2,2,0,1,0
19,482,482,24,16,8,3,2
11,500,500,56,56,0,1,0

22,123,123,16,16,0,1,0
14,215,215,1,1,0,1,0
19,219,219,9,9,0,1,0
5,245,245,3,3,0,1,0
6,275,275,12,12,0,1,0
27,287,287,122,23,99,4,3
2,313,313,32,7,25,2,1
18,335,335,5,5,0,1,0
24,350,350,2,2,0,1,0
25,352,352,63,63,0,1,0
11,362,362,13,2,11,2,1
13,370,370,77,77,0,1,0
15,394,394,10,10,0,1,0
8,398,398,14,7,7,2,1
3,399,399,24,24,0,1,0
0,403,403,4,4,0,1,0
9,410,410,52,52,0,1,0
4,415,415,17,17,0,1,0
10,421,421,1,1,0,1,0
1,432,432,12,2,10,3,2
7,439,439,46,46,0,1,0
17,443,443,63,15,48,2,1
12,447,447,19,15,4,2,1
20,472,472,37,26,11,2,1
21,475,475,3,3,0,1,0
26,476,476,61,61,0,1,0
23,479,479,52,52,0,1,0
16,492,492,38,28,10,3,2

18,114,114,35,29,6,2,1
7,141,141,15,15,0,1,0
14,142,142,19,13,6,2,1
15,152,152,14,6,8,2,1
17,161,161,43,43,0,1,0
13,161,161,3,3,0,1,0
4,169,169,7,7,0,1,0
3,177,177,22,14,8,3,2
16,218,218,5,5,0,1,0
10,293,293,5,5,0,1,0
5,309,309,19,1,18,3,2
8,331,331,47,47,0,1,0
1,334,334,25,25,0,1,0
2,350,350,5,5,0,1,0
11,432,432,8,1,7,2,1
12,439,439,25,5,20,2,1
0,444,444,48,18,30,2,1
6,472,472,203,159,44,2,1
9,487,487,88,66,22,2,1

11,116,116,12,12,0,1,0
15,124,124,2,2,0,1,0
7,134,134,16,10,6,3,2
14,151,151,8,4,4,2,1
1,152,152,26,26,0,1,0
16,196,196,49,49,0,1,0
10,228,228,32,4,28,3,2
0,237,237,2,2,0,1,0
5,282,282,22,22,0,1,0
2,288,288,26,8,18,4,3
19,291,291,53,3,50,3,2
6,294,294,4,4,0,1,0
9,319,319,30,30,0,1,0
12,341,341,12,12,0,1,0
8,413,413,14,1,13,2,1
3,416,416,78,78,0,1,0
4,417,417,69,57,12,2,1
20,461,461,7,7,0,1,0
18,466,466,79,79,0,1,0
17,483,483,43,43,0,1,0
13,489,489,104,67,37,4,3

12,101,101,1,1,0,1,0
11,109,109,1,1,0,1,0
21,123,123,2,2,0,1,0
2,165,165,10,1,9,2,1
16,244,244,14,2,12,2,1
23,286,286,55,7,48,2,1
14,288,288,2,2,0,1,0
7,291,291,13,13,0,1,0
5,293,293,33,9,24,2,1
1,303,303,14,14,0,1,0
0,309,309,4,4,0,1,0
20,332,332,87,87,0,1,0
19,335,335,31,5,26,3,2
6,355,355,17,17,0,1,0
18,375,375,13,3,10,3,2
9,379,379,36,2,34,3,2
17,393,393,38,17,21,4,3
22,404,404,78,78,0,1,0
15,408,408,1,1,0,1,0
13,428,428,9,3,6,3,2
8,436,436,57,36,21,2,1
4,437,437,64,23,41,2,1
24,440,440,74,14,60,4,3
3,456,456,26,2,24,2,1
10,470,470,142,112,30,4,3

11,122,122,1,1,0,1,0
16,129,129,6,6,0,1,0
18,133,133,46,42,4,2,1
2,136,136,6,6,0,1,0
5,138,138,6,6,0,1,0
0,160,160,7,4,3,2,1
4,164,164,29,29,0,1,0
8,183,183,28,28,0,1,0
1,196,196,1,1,0,1,0
24,214,214,17,4,13,2,1
21,255,255,11,5,6,3,2
9,258,258,59,59,0,1,0
22,263,263,25,9,16,4,3
13,279,279,10,10,0,1,0
20,291,291,2,2,0,1,0
15,303,303,92,92,0,1,0
14,311,311,14,14,0,1,0
6,319,319,3,3,0,1,0
3,328,328,11,11,0,1,0
19,335,335,21,21,0,1,0
10,343,343,45,6,39,3,2
23,415,415,41,6,35,2,1
7,430,430,19,10,9,4,3
17,432,432,20,20,0,1,0
12,466,466,46,9,37,2,1

2,139,139,2,2,0,1,0
9,168,168,3,3,0,1,0
1,175,175,26,2,24,4,3
6,214,214,49,49,0,1,0
14,228,228,12,2,10,2,1
21,242,242,18,18,0,1,0
10,248,248,40,14,26,2,1
16,271,271,80,27,53,4,3
13,289,289,16,16,0,1,0
19,289,289,28,28,0,1,0
0,291,291,11,8,3,2,1
17,296,296,54,54,0,1,0
18,318,318,57,57,0,1,0
15,348,348,18,4,14,3,2
3,355,355,1,1,0,1,0
7,357,357,87,40,47,4,3
5,383,383,15,15,0,1,0
4,391,391,14,14,0,1,0
11,403,403,55,55,0,1,0
20,447,447,9,9,0,1,0
12,472,472,51,51,0,1,0
8,477,477,16,16,0,1,0

12,109,109,1,1,0,1,0
5,110,110,9,9,0,1,0
17,114,114,11,11,0,1,0
10,125,125,3,3,0,1,0
15,202,202,14,14,0,1,0
13,206,206,35,35,0,1,0
14,207,207,1,1,0,1,0
3,228,228,8,8,0,1,0
8,244,244,4,4,0,1,0
20,251,251,12,12,0,1,0
9,258,258,1,1,0,1,0
23,287,287,3,3,0,1,0
18,318,318,43,26,17,2,1
22,331,331,16,16,0,1,0
21,346,346,72,72,0,1,0
0,353,353,27,27,0,1,0
24,377,377,23,2,21,3,2
6,390,390,52,21,31,3,2
4,395,395,30,30,0,1,0
1,418,418,18,3,15,4,3
19,427,427,13,13,0,1,0
11,428,428,136,95,41,2,1
16,433,433,176,176,0,1,0
2,444,444,46,46,0,1,0
7,447,447,3,3,0,1,0

14,109,109,21,3,18,3,2
12,130,130,2,2,0,1,0
6,172,172,11,6,5,2,1
13,181,181,13,5,8,3,2
17,212,212,14,14,0,1,0
1,220,220,46,34,12,2,1
8,222,222,14,11,3,2,1
16,224,224,26,18,8,3,2
3,238,238,18,14,4,2,1
18,249,249,15,15,0,1,0
4,265,265,36,32,4,2,1
11,266,266,75,33,42,2,1
10,340,340,26,8,18,4,3
15,374,374,24,24,0,1,0
9,376,376,68,11,57,4,3
7,380,380,42,37,5,2,1
5,445,445,148,134,14,2,1
2,489,489,26,17,9,2,1
0,494,494,29,29,0,1,0

13,113,113,30,6,24,3,2
4,135,135,14,4,10,3,2
10,146,146,7,1,6,3,2
14,158,158,26,21,5,2,1
19,162,162,1,1,0,1,0
21,164,164,3,3,0,1,0
2,169,169,1,1,0,1,0
7,183,183,13,13,0,1,0
17,200,200,11,3,8,2,1
6,234,234,48,48,0,1,0
16,242,242,31,31,0,1,0
3,255,255,23,3,20,3,2
18,261,261,16,9,7,2,1
12,329,329,41,22,19,2,1
5,335,335,21,3,18,3,2
20,393,393,112,69,43,2,1
1,440,440,45,32,13,2,1
15,451,451,7,7,0,1,0
9,453,453,18,18,0,1,0
8,476,476,72,27,45,4,3
0,477,477,63,20,43,2,1
11,492,492,44,31,13,2,1

13,120,120,1,1,0,1,0
6,127,127,1,1,0,1,0
0,130,130,46,43,3,2,1
1,164,164,18,18,0,1,0
2,178,178,15,15,0,1,0
9,204,204,23,11,12,4,3
5,276,276,10,10,0,1,0
10,312,312,4,4,0,1,0
4,319,319,9,9,0,1,0
14,331,331,41,5,36,4,3
8,413,413,173,74,99,4,3
7,427,427,18,18,0,1,0
16,433,433,30,6,24,4,3
11,434,434,155,155,0,1,0
15,440,440,34,34,0,1,0
3,441,441,9,9,0,1,0
12,462,462,85,85,0,1,0
17,487,487,68,68,0,1,0
18,494,494,17,8,9,4,3

19,112,112,30,30,0,1,0
18,113,113,14,14,0,1,0
10,149,149,5,2,3,2,1
14,178,178,6,6,0,1,0
0,180,180,20,20,0,1,0
3,253,253,2,2,0,1,0
12,256,256,53,12,41,2,1
11,288,288,6,6,0,1,0
2,306,306,25,25,0,1,0
8,337,337,81,8,73,3,2
4,342,342,5,5,0,1,0
6,348,348,23,6,17,4,3
7,354,354,41,41,0,1,0
13,356,356,39,39,0,1,0
1,366,366,49,49,0,1,0
15,412,412,107,85,22,4,3
5,433,433,124,124,0,1,0
17,438,438,21,3,18,3,2
16,447,447,7,7,0,1,0
9,498,498,21,21,0,1,0

6,135,135,8,8,0,1,0
7,147,147,36,33,3,2,1
0,157,157,8,8,0,1,0
1,162,162,31,25,6,3,2
2,182,182,23,23,0,1,0
9,198,198,22,1,21,2,1
15,269,269,2,2,0,1,0
10,312,312,34,34,0,1,0
14,313,313,10,2,8,2,1
3,347,347,64,33,31,2,1
8,377,377,51,51,0,1,0
5,403,403,192,192,0,1,0
16,414,414,17,2,15,4,3
13,427,427,2,2,0,1,0
11,461,461,38,28,10,3,2
12,461,461,159,30,129,4,3
4,492,492,8,3,5,2,1

13,102,102,1,1,0,1,0
1,164,164,4,4,0,1,0
18,165,165,17,17,0,1,0
2,176,176,41,41,0,1,0
3,186,186,10,10,0,1,0
15,198,198,26,26,0,1,0
21,203,203,2,2,0,1,0
17,207,207,57,3,54,4,3
22,221,221,65,12,53,3,2
16,293,293,13,6,7,2,1
12,321,321,20,20,0,1,0
10,325,325,8,8,0,1,0
7,333,333,12,12,0,1,0
20,336,336,14,9,5,2,1
8,346,346,69,59,10,2,1
19,350,350,16,1,15,2,1
4,354,354,14,1,13,2,1
5,371,371,24,24,0,1,0
0,371,371,17,3,14,2,1
6,394,394,83,35,48,4,3
14,438,438,74,7,67,4,3
9,461,461,13,7,6,2,1
11,483,483,38,26,12,4,3

15,125,125,8,1,7,2,1
0,155,155,12,2,10,2,1
6,172,172,86,68,18,4,3
4,176,176,4,4,0,1,0
18,185,185,22,6,16,2,1
3,225,225,48,48,0,1,0
12,244,244,45,15,30,4,3
9,257,257,31,3,28,2,1
17,270,270,75,75,0,1,0
16,280,280,7,1,6,2,1
7,300,300,26,2,24,2,1
14,306,306,32,32,0,1,0
13,330,330,1,1,0,1,0
5,348,348,2,2,0,1,0
11,358,358,10,10,0,1,0
1,442,442,14,11,3,2,1
10,451,451,99,16,83,4,3
19,457,457,43,43,0,1,0
2,465,465,7,4,3,2,1
8,499,499,14,3,11,2,1

6,101,101,8,8,0,1,0
7,128,128,6,6,0,1,0
1,137,137,4,4,0,1,0
0,150,150,6,2,4,2,1
9,215,215,104,65,39,2,1
18,227,227,34,4,30,2,1
13,257,257,21,21,0,1,0
12,262,262,3,3,0,1,0
5,272,272,131,131,0,1,0
15,307,307,8,8,0,1,0
2,325,325,34,1,33,4,3
11,359,359,7,7,0,1,0
3,380,380,20,4,16,2,1
16,386,386,17,17,0,1,0
4,413,413,7,7,0,1,0
8,417,417,104,104,0,1,0
14,420,420,25,25,0,1,0
17,447,447,62,62,0,1,0
10,467,467,47,47,0,1,0

2,125,125,8,3,5,2,1
4,126,126,13,13,0,1,0
10,145,145,1,1,0,1,0
0,192,192,79,79,0,1,0
19,241,241,1,1,0,1,0
11,250,250,56,4,52,3,2
8,256,256,31,31,0,1,0
3,263,263,7,7,0,1,0
14,279,279,33,33,0,1,0
17,309,309,15,15,0,1,0
7,310,310,6,6,0,1,0
13,313,313,42,42,0,1,0
12,342,342,23,23,0,1,0
18,368,368,53,53,0,1,0
16,371,371,121,84,37,3,2
5,434,434,27,27,0,1,0
15,463,463,18,11,7,2,1
9,469,469,4,4,0,1,0
1,471,471,130,112,18,4,3
6,492,492,4,4,0,1,0

10,155,155,34,34,0,1,0
2,167,167,4,4,0,1,0
15,185,185,52,52,0,1,0
16,188,188,24,5,19,2,1
14,216,216,4,4,0,1,0
17,218,218,5,5,0,1,0
5,231,231,15,6,9,4,3
4,234,234,23,1,22,3,2
6,244,244,1,1,0,1,0
3,268,268,1,1,0,1,0
20,280,280,9,9,0,1,0
1,287,287,20,20,0,1,0
11,299,299,81,81,0,1,0
8,306,306,14,14,0,1,0
7,313,313,13,13,0,1,0
19,340,340,46,2,44,2,1
22,341,341,55,55,0,1,0
9,391,391,19,19,0,1,0
12,392,392,29,29,0,1,0
18,394,394,69,48,21,4,3
21,420,420,26,1,25,2,1
13,474,474,49,49,0,1,0
0,493,493,67,40,27,2,1

17,113,113,19,5,14,2,1
20,119,119,18,18,0,1,0
12,124,124,14,14,0,1,0
2,129,129,7,1,6,3,2
5,148,148,7,7,0,1,0
0,150,150,10,10,0,1,0
9,174,174,55,55,0,1,0
7,185,185,39,7,32,2,1
11,189,189,28,8,20,2,1
16,189,189,20,20,0,1,0
6,230,230,4,4,0,1,0
18,235,235,65,21,44,3,2
19,242,242,4,4,0,1,0
1,242,242,23,23,0,1,0
4,261,261,4,4,0,1,0
15,272,272,45,45,0,1,0
8,322,322,6,6,0,1,0
13,353,353,15,9,6,3,2
3,395,395,1,1,0,1,0
10,448,448,49,49,0,1,0
14,472,472,5,5,0,1,0
21,491,491,39,39,0,1,0

7,141,141,2,2,0,1,0
1,142,142,42,6,36,2,1
19,169,169,29,29,0,1,0
17,209,209,42,24,18,4,3
12,210,210,6,6,0,1,0
15,212,212,1,1,0,1,0
11,213,213,14,14,0,1,0
13,222,222,43,13,30,3,2
0,243,243,46,22,24,2,1
6,248,248,4,4,0,1,0
18,288,288,61,23,38,3,2
9,306,306,17,17,0,1,0
16,313,313,8,4,4,2,1
3,346,346,6,3,3,2,1
10,370,370,63,50,13,2,1
8,380,380,52,52,0,1,0
4,439,439,16,16,0,1,0
14,474,474,22,22,0,1,0
2,479,479,152,23,129,4,3
5,495,495,11,11,0,1,0

26,103,103,3,3,0,1,0
11,105,105,7,1,6,2,1
0,107,107,9,9,0,1,0
17,140,140,11,6,5,2,1
20,148,148,7,7,0,1,0
16,165,165,8,8,0,1,0
15,183,183,14,9,5,2,1
9,196,196,1,1,0,1,0
3,206,206,26,23,3,2,1
1,229,229,8,5,3,2,1
8,244,244,15,15,0,1,0
6,246,246,29,1,28,2,1
13,262,262,18,18,0,1,0
7,264,264,10,1,9,2,1
10,278,278,6,3,3,2,1
24,283,283,26,26,0,1,0
23,300,300,41,5,36,3,2
25,306,306,40,25,15,2,1
5,334,334,2,2,0,1,0
12,334,334,2,2,0,1,0
21,337,337,86,76,10,2,1
2,349,349,6,6,0,1,0
14,419,419,45,24,21,4,3
28,423,423,74,26,48,4,3
18,426,426,34,6,28,2,1
22,434,434,46,46,0,1,0
27,445,445,49,31,18,4,3
19,473,473,18,18,0,1,0
4,480,480,27,7,20,3,2

10,106,106,13,13,0,1,0
16,151,151,15,2,13,3,2
8,181,181,2,2,0,1,0
20,198,198,22,22,0,1,0
15,223,223,2,2,0,1,0
9,231,231,32,14,18,4,3
1,248,248,38,38,0,1,0
11,265,265,5,5,0,1,0
13,297,297,122,26,96,3,2
4,299,299,12,12,0,1,0
3,334,334,54,6,48,4,3
17,352,352,92,50,42,3,2
19,357,357,59,5,54,4,3
7,366,366,56,16,40,3,2
12,367,367,3,3,0,1,0
5,411,411,1,1,0,1,0
2,426,426,25,3,22,3,2
6,457,457,30,6,24,3,2
14,457,457,3,3,0,1,0
18,482,482,16,9,7,2,1
0,492,492,96,72,24,4,3

5,107,107,3,3,0,1,0
22,115,115,35,35,0,1,0
7,134,134,7,7,0,1,0
13,135,135,3,3,0,1,0
24,142,142,7,1,6,3,2
23,162,162,4,4,0,1,0
14,174,174,2,2,0,1,0
2,185,185,9,9,0,1,0
11,204,204,42,42,0,1,0
12,212,212,1,1,0,1,0
1,215,215,23,12,11,2,1
17,249,249,42,42,0,1,0
4,275,275,10,10,0,1,0
9,276,276,54,12,42,4,3
16,304,304,75,75,0,1,0
18,315,315,19,1,18,3,2
10,337,337,97,48,49,2,1
8,338,338,2,2,0,1,0
3,345,345,3,3,0,1,0
0,378,378,9,2,7,2,1
21,388,388,1,1,0,1,0
6,411,411,26,10,16,3,2
19,422,422,60,60,0,1,0
15,441,441,45,15,30,2,1
20,449,449,11,11,0,1,0

9,154,154,34,34,0,1,0
2,161,161,13,13,0,1,0
14,161,161,19,19,0,1,0
3,174,174,34,10,24,4,3
0,186,186,27,15,12,4,3
13,199,199,1,1,0,1,0
11,242,242,57,9,48,4,3
17,265,265,2,2,0,1,0
16,269,269,14,14,0,1,0
15,287,287,11,11,0,1,0
4,328,328,11,11,0,1,0
1,336,336,87,72,15,3,2
12,350,350,63,19,44,3,2
7,352,352,61,43,18,4,3
10,378,378,84,36,48,2,1
6,444,444,86,8,78,3,2
5,455,455,10,10,0,1,0
8,461,461,15,15,0,1,0

16,138,138,8,8,0,1,0
2,193,193,3,3,0,1,0
5,204,204,2,2,0,1,0
9,225,225,11,4,7,2,1
22,228,228,20,20,0,1,0
4,240,240,18,18,0,1,0
7,297,297,19,19,0,1,0
1,311,311,31,31,0,1,0
21,325,325,115,87,28,2,1
8,336,336,1,1,0,1,0
10,340,340,1,1,0,1,0
17,356,356,12,12,0,1,0
14,359,359,37,37,0,1,0
18,368,368,70,39,31,2,1
20,384,384,88,67,21,4,3
11,411,411,1,1,0,1,0
3,422,422,151,13,138,4,3
19,442,442,20,2,18,3,2
13,447,447,5,5,0,1,0
12,453,453,71,1,70,3,2
6,454,454,74,18,56,3,2
15,493,493,2,2,0,1,0
0,500,500,51,27,24,3,2

18,108,108,13,13,0,1,0
5,128,128,1,1,0,1,0
19,149,149,12,12,0,1,0
6,163,163,24,12,12,4,3
16,166,166,18,3,15,4,3
12,205,205,1,1,0,1,0
20,211,211,15,3,12,2,1
10,221,221,2,2,0,1,0
9,276,276,149,12,137,4,3
0,282,282,1,1,0,1,0
17,287,287,53,44,9,4,3
21,299,299,48,48,0,1,0
15,315,315,77,65,12,2,1
13,330,330,1,1,0,1,0
11,336,336,29,3,26,2,1
8,345,345,11,11,0,1,0
3,355,355,25,4,21,4,3
1,396,396,13,8,5,2,1
4,403,403,27,8,19,2,1
7,406,406,15,15,0,1,0
14,443,443,66,43,23,2,1
2,483,483,33,33,0,1,0

15,111,111,3,3,0,1,0
5,148,148,11,7,4,2,1
14,170,170,30,30,0,1,0
13,209,209,1,1,0,1,0
11,211,211,1,1,0,1,0
21,213,213,35,35,0,1,0
6,224,224,9,2,7,2,1
19,243,243,12,12,0,1,0
10,247,247,60,60,0,1,0
1,286,286,1,1,0,1,0
17,305,305,33,33,0,1,0
0,325,325,1,1,0,1,0
3,340,340,87,29,58,4,3
24,356,356,51,1,50,2,1
22,357,357,85,75,10,2,1
20,359,359,2,2,0,1,0
18,366,366,109,99,10,3,2
12,367,367,36,24,12,4,3
2,369,369,7,7,0,1,0
23,386,386,18,3,15,2,1
7,425,425,5,5,0,1,0
9,445,445,14,14,0,1,0
8,486,486,20,20,0,1,0
4,494,494,46,46,0,1,0
16,494,494,19,3,16,3,2

21,115,115,17,3,14,4,3
23,117,117,6,3,3,2,1
2,120,120,1,1,0,1,0
1,123,123,10,10,0,1,0
14,133,133,10,10,0,1,0
5,175,175,9,9,0,1,0
3,177,177,30,20,10,3,2
24,188,188,20,20,0,1,0
4,191,191,9,9,0,1,0
28,208,208,11,1,10,2,1
25,238,238,12,7,5,2,1
11,245,245,1,1,0,1,0
0,261,261,1,1,0,1,0
20,266,266,30,30,0,1,0
10,313,313,21,5,16,3,2
22,325,325,26,9,17,2,1
6,330,330,6,6,0,1,0
16,340,340,21,21,0,1,0
13,343,343,71,43,28,3,2
8,354,354,1,1,0,1,0
17,363,363,31,15,16,2,1
15,367,367,30,30,0,1,0
9,388,388,21,21,0,1,0
19,405,405,183,169,14,3,2
7,424,424,13,13,0,1,0
18,442,442,10,10,0,1,0
26,464,464,16,16,0,1,0
27,487,487,18,2,16,3,2
12,490,490,14,8,6,3,2

9,113,113,1,1,0,1,0
16,154,154,34,34,0,1,0
7,175,175,56,41,15,2,1
8,176,176,17,9,8,3,2
18,177,177,14,11,3,2,1
3,179,179,27,12,15,4,3
2,192,192,1,1,0,1,0
21,197,197,10,10,0,1,0
1,198,198,22,10,12,3,2
20,201,201,8,8,0,1,0
19,211,211,12,8,4,2,1
6,223,223,31,31,0,1,0
12,314,314,20,20,0,1,0
17,324,324,91,35,56,3,2
4,390,390,12,12,0,1,0
14,412,412,90,90,0,1,0
10,414,414,16,7,9,2,1
5,431,431,34,10,24,3,2
0,449,449,50,8,42,4,3
11,470,470,5,5,0,1,0
15,481,481,17,5,12,4,3
13,491,491,37,34,3,2,1

7,123,123,18,18,0,1,0
22,147,147,4,4,0,1,0
11,149,149,22,12,10,2,1
14,153,153,5,2,3,2,1
20,165,165,18,2,16,3,2
9,202,202,47,35,12,4,3
5,208,208,5,1,4,2,1
6,210,210,34,34,0,1,0
10,217,217,23,23,0,1,0
18,218,218,40,40,0,1,0
2,256,256,1,1,0,1,0
23,266,266,39,39,0,1,0
21,271,271,25,25,0,1,0
15,286,286,37,9,28,3,2
1,334,334,2,2,0,1,0
4,344,344,7,1,6,3,2
16,358,358,8,8,0,1,0
12,375,375,16,4,12,4,3
24,387,387,79,55,24,4,3
13,399,399,28,13,15,3,2
8,414,414,22,22,0,1,0
19,429,429,33,2,31,4,3
3,460,460,17,17,0,1,0
0,467,467,8,8,0,1,0
17,498,498,64,64,0,1,0

6,108,108,9,5,4,2,1
8,125,125,20,20,0,1,0
11,173,173,19,19,0,1,0
14,183,183,13,13,0,1,0
17,189,189,51,21,30,2,1
5,202,202,11,11,0,1,0
13,211,211,39,3,36,3,2
15,212,212,3,3,0,1,0
9,229,229,35,23,12,4,3
10,238,238,34,4,30,2,1
1,307,307,48,2,46,3,2
12,316,316,16,16,0,1,0
2,338,338,21,3,18,3,2
4,344,344,21,21,0,1,0
16,389,389,13,1,12,3,2
7,392,392,3,3,0,1,0
3,423,423,55,37,18,2,1
18,481,481,47,7,40,3,2
0,483,483,186,120,66,3,2

8,133,133,27,18,9,2,1
11,189,189,3,3,0,1,0
2,234,234,20,1,19,2,1
15,236,236,5,1,4,2,1
3,256,256,14,4,10,3,2
5,319,319,1,1,0,1,0
0,325,325,25,25,0,1,0
7,332,332,56,38,18,4,3
13,358,358,182,182,0,1,0
10,361,361,20,20,0,1,0
1,386,386,85,36,49,2,1
14,390,390,26,1,25,2,1
12,397,397,9,1,8,2,1
17,404,404,12,4,8,3,2
6,407,407,40,40,0,1,0
4,434,434,83,83,0,1,0
18,436,436,66,33,33,3,2
16,477,477,13,13,0,1,0
9,500,500,108,74,34,2,1

16,116,116,7,7,0,1,0
8,138,138,12,6,6,2,1
17,185,185,44,19,25,2,1
0,191,191,41,6,35,3,2
4,212,212,71,71,0,1,0
15,215,215,1,1,0,1,0
5,244,244,3,3,0,1,0
1,273,273,45,45,0,1,0
14,292,292,14,8,6,2,1
3,306,306,22,2,20,2,1
7,306,306,35,35,0,1,0
11,307,307,7,3,4,2,1
9,329,329,92,92,0,1,0
18,357,357,31,19,12,3,2
10,421,421,31,31,0,1,0
13,442,442,107,98,9,4,3
6,463,463,8,8,0,1,0
12,469,469,30,12,18,3,2
2,500,500,44,20,24,2,1

22,105,105,10,4,6,3,2
2,114,114,4,4,0,1,0
10,120,120,4,4,0,1,0
16,123,123,60,50,10,3,2
18,146,146,11,11,0,1,0
7,147,147,26,2,24,3,2
4,159,159,7,3,4,2,1
23,217,217,11,11,0,1,0
1,249,249,2,2,0,1,0
13,250,250,24,24,0,1,0
14,254,254,16,16,0,1,0
3,268,268,2,2,0,1,0
20,275,275,32,18,14,3,2
21,309,309,11,11,0,1,0
15,321,321,7,7,0,1,0
8,340,340,21,21,0,1,0
11,353,353,10,10,0,1,0
12,367,367,16,16,0,1,0
17,403,403,25,25,0,1,0
6,412,412,59,59,0,1,0
5,419,419,57,41,16,3,2
0,423,423,118,88,30,4,3
19,484,484,57,6,51,4,3
9,495,495,4,1,3,2,1

6,104,104,1,1,0,1,0
15,140,140,7,3,4,2,1
10,196,196,10,5,5,2,1
4,200,200,14,5,9,2,1
12,226,226,12,1,11,2,1
17,231,231,47,22,25,2,1
14,233,233,78,78,0,1,0
3,239,239,40,19,21,2,1
8,264,264,4,1,3,2,1
5,272,272,19,19,0,1,0
19,328,328,62,62,0,1,0
0,330,330,106,4,102,4,3
16,340,340,12,12,0,1,0
9,347,347,24,24,0,1,0
18,360,360,11,11,0,1,0
21,385,385,21,6,15,4,3
7,399,399,29,15,14,4,3
11,410,410,4,4,0,1,0
13,432,432,49,17,32,2,1
2,448,448,67,2,65,4,3
1,450,450,43,43,0,1,0
20,485,485,26,7,19,2,1

15,113,113,5,5,0,1,0
10,125,125,6,2,4,2,1
4,133,133,4,4,0,1,0
0,173,173,4,1,3,2,1
3,206,206,40,28,12,3,2
16,230,230,28,28,0,1,0
9,234,234,45,45,0,1,0
18,255,255,36,1,35,2,1
11,266,266,6,6,0,1,0
14,282,282,14,2,12,3,2
12,287,287,15,5,10,3,2
2,324,324,61,47,14,2,1
21,339,339,11,11,0,1,0
1,344,344,36,36,0,1,0
20,356,356,31,31,0,1,0
13,390,390,190,169,21,4,3
7,444,444,60,46,14,3,2
5,451,451,20,6,14,2,1
6,467,467,22,22,0,1,0
19,477,477,31,11,20,2,1
8,478,478,35,35,0,1,0
17,489,489,19,14,5,2,1

22,103,103,7,7,0,1,0
7,103,103,9,5,4,2,1
0,131,131,13,13,0,1,0
12,142,142,8,2,6,3,2
9,149,149,6,1,5,2,1
20,150,150,49,49,0,1,0
3,156,156,9,9,0,1,0
5,196,196,1,1,0,1,0
21,201,201,12,6,6,2,1
10,246,246,21,21,0,1,0
19,247,247,10,10,0,1,0
6,285,285,15,8,7,2,1
16,286,286,5,5,0,1,0
13,291,291,15,12,3,2,1
18,295,295,83,83,0,1,0
14,358,358,60,60,0,1,0
4,398,398,21,3,18,4,3
8,427,427,47,47,0,1,0
17,433,433,8,8,0,1,0
2,463,463,184,148,36,3,2
11,472,472,11,1,10,2,1
1,478,478,17,11,6,3,2
15,484,484,42,17,25,2,1

13,121,121,14,14,0,1,0
17,160,160,41,18,23,4,3
18,175,175,10,6,4,2,1
0,188,188,25,19,6,3,2
7,189,189,12,9,3,2,1
4,225,225,43,43,0,1,0
2,280,280,67,67,0,1,0
10,307,307,3,3,0,1,0
1,331,331,70,29,41,2,1
8,345,345,2,2,0,1,0
3,357,357,81,81,0,1,0
16,379,379,47,23,24,2,1
9,399,399,2,2,0,1,0
6,403,403,1,1,0,1,0
5,461,461,13,7,6,2,1
15,477,477,41,41,0,1,0
12,478,478,157,157,0,1,0
11,479,479,49,49,0,1,0
14,499,499,16,16,0,1,0

18,134,134,31,31,0,1,0
21,135,135,35,35,0,1,0
10,174,174,25,25,0,1,0
1,177,177,9,3,6,2,1
5,190,190,8,4,4,2,1
13,208,208,2,2,0,1,0
2,236,236,1,1,0,1,0
4,243,243,60,60,0,1,0
11,243,243,8,8,0,1,0
17,250,250,14,14,0,1,0
20,300,300,4,4,0,1,0
3,314,314,11,11,0,1,0
7,359,359,1,1,0,1,0
0,364,364,55,13,42,4,3
15,372,372,1,1,0,1,0
8,374,374,59,59,0,1,0
12,378,378,33,33,0,1,0
16,390,390,3,3,0,1,0
14,404,404,49,49,0,1,0
23,412,412,25,25,0,1,0
19,424,424,14,2,12,2,1
22,424,424,141,141,0,1,0
6,430,430,25,5,20,3,2
9,436,436,34,34,0,1,0

9,103,103,3,3,0,1,0
12,103,103,6,6,0,1,0
13,129,129,33,4,29,2,1
2,137,137,20,20,0,1,0
5,157,157,2,2,0,1,0
4,185,185,33,13,20,3,2
3,199,199,36,8,28,2,1
16,275,275,18,7,11,2,1
1,276,276,126,126,0,1,0
11,291,291,35,35,0,1,0
0,300,300,16,11,5,2,1
6,361,361,19,10,9,4,3
15,390,390,21,9,12,3,2
10,407,407,21,21,0,1,0
14,423,423,56,23,33,4,3
8,438,438,47,47,0,1,0
17,483,483,114,6,108,4,3
7,492,492,10,7,3,2,1

8,106,106,12,3,9,2,1
22,127,127,15,2,13,3,2
4,140,140,6,6,0,1,0
21,185,185,17,17,0,1,0
19,185,185,72,72,0,1,0
14,200,200,6,2,4,2,1
17,225,225,28,10,18,2,1
25,228,228,16,7,9,4,3
16,236,236,1,1,0,1,0
0,244,244,49,49,0,1,0
23,265,265,63,63,0,1,0
15,277,277,40,31,9,4,3
10,292,292,1,1,0,1,0
26,314,314,2,2,0,1,0
18,324,324,25,19,6,3,2
11,325,325,14,14,0,1,0
13,357,357,5,1,4,2,1
24,357,357,10,4,6,2,1
9,388,388,6,6,0,1,0
7,391,391,19,1,18,3,2
2,399,399,13,13,0,1,0
20,405,405,23,23,0,1,0
5,406,406,28,28,0,1,0
3,408,408,14,4,10,2,1
27,438,438,18,3,15,2,1
12,447,447,35,13,22,2,1
1,466,466,18,18,0,1,0
6,495,495,33,33,0,1,0

10,120,120,4,1,3,2,1
11,127,127,11,11,0,1,0
9,157,157,2,2,0,1,0
2,176,176,9,9,0,1,0
5,180,180,71,71,0,1,0
20,201,201,36,2,34,3,2
21,202,202,38,38,0,1,0
7,219,219,5,5,0,1,0
15,230,230,10,7,3,2,1
16,231,231,24,2,22,3,2
4,231,231,18,18,0,1,0
18,247,247,18,11,7,2,1
3,275,275,22,4,18,4,3
12,331,331,37,37,0,1,0
14,351,351,39,39,0,1,0
6,372,372,25,25,0,1,0
8,385,385,67,67,0,1,0
19,408,408,10,10,0,1,0
17,414,414,56,56,0,1,0
13,418,418,60,60,0,1,0
0,489,489,27,27,0,1,0
1,498,498,25,9,16,3,2

16,140,140,1,1,0,1,0
10,170,170,16,16,0,1,0
13,187,187,3,3,0,1,0
14,205,205,28,8,20,3,2
5,211,211,11,7,4,2,1
7,249,249,20,5,15,2,1
1,269,269,29,29,0,1,0
3,272,272,6,6,0,1,0
17,272,272,25,25,0,1,0
11,291,291,46,12,34,3,2
18,315,315,84,9,75,4,3
0,317,317,17,9,8,2,1
12,318,318,67,5,62,4,3
8,319,319,81,64,17,2,1
6,325,325,16,7,9,4,3
2,359,359,109,21,88,3,2
4,413,413,74,74,0,1,0
15,425,425,59,59,0,1,0
9,438,438,1,1,0,1,0

5,101,101,9,9,0,1,0
3,131,131,7,1,6,3,2
2,158,158,1,1,0,1,0
15,179,179,36,36,0,1,0
6,186,186,60,60,0,1,0
0,218,218,22,22,0,1,0
7,238,238,15,2,13,2,1
13,261,261,26,26,0,1,0
12,291,291,64,64,0,1,0
14,300,300,63,63,0,1,0
20,344,344,10,10,0,1,0
4,373,373,9,9,0,1,0
9,378,378,61,19,42,4,3
1,428,428,8,8,0,1,0
11,434,434,12,9,3,2,1
18,435,435,31,28,3,2,1
17,457,457,67,61,6,2,1
16,458,458,2,2,0,1,0
8,460,460,70,28,42,2,1
10,483,483,53,2,51,4,3
19,491,491,52,52,0,1,0

14,122,122,7,1,6,2,1
19,173,173,10,4,6,2,1
3,179,179,8,5,3,2,1
9,181,181,14,1,13,2,1
16,198,198,17,17,0,1,0
17,203,203,17,13,4,2,1
20,211,211,30,11,19,4,3
0,231,231,1,1,0,1,0
15,238,238,49,5,44,3,2
5,243,243,53,53,0,1,0
7,280,280,5,5,0,1,0
10,290,290,13,13,0,1,0
1,304,304,23,10,13,2,1
12,337,337,2,2,0,1,0
21,389,389,96,96,0,1,0
6,395,395,33,12,21,2,1
23,412,412,29,5,24,4,3
8,426,426,2,2,0,1,0
18,433,433,76,30,46,3,2
22,443,443,2,2,0,1,0
4,450,450,54,54,0,1,0
2,470,470,127,127,0,1,0
13,475,475,30,30,0,1,0
11,496,496,35,35,0,1,0

14,168,168,21,9,12,3,2
11,174,174,5,5,0,1,0
5,180,180,11,2,9,3,2
8,201,201,51,13,38,3,2
13,220,220,1,1,0,1,0
0,236,236,68,68,0,1,0
4,236,236,24,24,0,1,0
9,242,242,17,17,0,1,0
7,247,247,6,1,5,2,1
10,255,255,24,9,15,2,1
12,305,305,9,2,7,2,1
17,339,339,33,22,11,2,1
6,352,352,36,36,0,1,0
16,395,395,16,16,0,1,0
15,396,396,148,148,0,1,0
3,412,412,71,26,45,2,1
1,478,478,74,74,0,1,0
2,486,486,96,96,0,1,0

16,157,157,28,28,0,1,0
11,168,168,27,27,0,1,0
13,175,175,17,8,9,4,3
10,213,213,7,7,0,1,0
19,215,215,14,14,0,1,0
0,218,218,2,2,0,1,0
8,260,260,12,6,6,3,2
7,262,262,79,15,64,3,2
12,275,275,78,78,0,1,0
17,297,297,34,34,0,1,0
4,306,306,1,1,0,1,0
5,310,310,93,93,0,1,0
15,323,323,17,17,0,1,0
2,355,355,37,37,0,1,0
3,379,379,76,23,53,3,2
6,383,383,18,4,14,4,3
14,383,383,27,27,0,1,0
9,415,415,30,22,8,3,2
18,476,476,32,32,0,1,0
1,500,500,8,8,0,1,0

23,100,100,19,7,12,3,2
24,101,101,28,28,0,1,0
19,110,110,6,6,0,1,0
11,160,160,12,12,0,1,0
22,167,167,34,34,0,1,0
18,169,169,1,1,0,1,0
21,204,204,1,1,0,1,0
5,221,221,12,5,7,2,1
12,225,225,23,5,18,2,1
15,239,239,5,5,0,1,0
14,293,293,2,2,0,1,0
26,294,294,18,18,0,1,0
3,316,316,15,15,0,1,0
13,332,332,31,28,3,2,1
4,345,345,11,5,6,3,2
0,360,360,76,76,0,1,0
9,375,375,19,19,0,1,0
6,379,379,16,16,0,1,0
10,398,398,2,2,0,1,0
7,402,402,30,13,17,4,3
8,405,405,49,49,0,1,0
16,417,417,21,12,9,2,1
17,420,420,96,75,21,4,3
25,433,433,6,6,0,1,0
2,444,444,1,1,0,1,0
20,450,450,39,39,0,1,0
1,483,483,54,39,15,4,3

15,122,122,10,10,0,1,0
11,151,151,12,7,5,2,1
20,195,195,13,13,0,1,0
3,204,204,8,8,0,1,0
17,211,211,2,2,0,1,0
10,212,212,10,3,7,2,1
21,219,219,1,1,0,1,0
7,234,234,3,3,0,1,0
19,243,243,25,13,12,4,3
23,275,275,39,13,26,2,1
13,278,278,9,9,0,1,0
0,278,278,1,1,0,1,0
14,295,295,72,5,67,4,3
2,312,312,65,50,15,4,3
8,316,316,86,8,78,4,3
16,322,322,83,70,13,2,1
5,329,329,26,20,6,2,1
18,348,348,23,23,0,1,0
22,351,351,50,28,22,2,1
9,366,366,7,4,3,2,1
1,386,386,59,46,13,2,1
12,427,427,13,13,0,1,0
6,430,430,47,15,32,2,1
4,441,441,7,7,0,1,0

3,145,145,1,1,0,1,0
8,172,172,72,20,52,3,2
16,196,196,8,8,0,1,0
10,197,197,30,12,18,2,1
12,202,202,19,6,13,3,2
13,219,219,10,10,0,1,0
20,220,220,14,5,9,2,1
4,236,236,11,3,8,3,2
19,236,236,37,37,0,1,0
9,252,252,23,9,14,2,1
1,328,328,24,6,18,2,1
5,335,335,16,16,0,1,0
17,341,341,32,32,0,1,0
15,351,351,85,85,0,1,0
7,356,356,17,8,9,4,3
21,363,363,15,15,0,1,0
6,380,380,12,3,9,4,3
0,385,385,47,17,30,4,3
2,445,445,7,7,0,1,0
18,477,477,50,28,22,3,2
14,487,487,117,95,22,3,2
11,488,488,23,11,12,4,3

9,122,122,16,16,0,1,0
29,140,140,2,2,0,1,0
22,164,164,13,13,0,1,0
8,173,173,6,6,0,1,0
3,206,206,28,12,16,2,1
2,225,225,1,1,0,1,0
12,231,231,1,1,0,1,0
17,238,238,9,3,6,2,1
26,248,248,52,29,23,2,1
13,260,260,17,1,16,2,1
23,280,280,8,8,0,1,0
20,297,297,1,1,0,1,0
11,297,297,5,5,0,1,0
28,299,299,11,2,9,4,3
6,304,304,15,1,14,3,2
0,310,310,5,5,0,1,0
1,312,312,18,2,16,3,2
15,315,315,12,6,6,3,2
19,315,315,1,1,0,1,0
18,322,322,9,2,7,2,1
14,323,323,6,3,3,2,1
30,337,337,20,8,12,4,3
7,346,346,8,8,0,1,0
5,371,371,25,25,0,1,0
25,372,372,120,69,51,4,3
21,381,381,51,16,35,2,1
10,386,386,44,44,0,1,0
16,420,420,67,67,0,1,0
24,431,431,6,6,0,1,0
4,492,492,46,46,0,1,0
27,498,498,111,75,36,2,1

18,125,125,4,4,0,1,0
7,144,144,12,12,0,1,0
10,148,148,39,12,27,2,1
11,173,173,9,9,0,1,0
21,192,192,49,49,0,1,0
9,241,241,38,1,37,2,1
19,241,241,17,2,15,3,2
5,265,265,15,4,11,2,1
4,291,291,1,1,0,1,0
12,293,293,1,1,0,1,0
1,298,298,53,3,50,3,2
16,304,304,3,3,0,1,0
3,306,306,46,46,0,1,0
17,318,318,92,42,50,2,1
0,347,347,9,9,0,1,0
8,351,351,37,15,22,3,2
6,387,387,4,4,0,1,0
15,394,394,16,11,5,2,1
2,430,430,7,7,0,1,0
20,449,449,57,45,12,3,2
14,469,469,15,15,0,1,0
13,498,498,129,129,0,1,0

6,144,144,9,9,0,1,0
5,147,147,27,6,21,4,3
3,177,177,7,1,6,3,2
8,187,187,2,2,0,1,0
13,232,232,20,2,18,2,1
0,269,269,138,138,0,1,0
9,270,270,24,24,0,1,0
10,301,301,33,33,0,1,0
12,318,318,45,23,22,3,2
15,343,343,25,25,0,1,0
4,347,347,54,54,0,1,0
1,394,394,60,36,24,3,2
2,394,394,24,24,0,1,0
11,399,399,28,22,6,2,1
7,417,417,147,111,36,3,2
14,442,442,56,13,43,2,1

0,104,104,2,2,0,1,0
15,112,112,43,43,0,1,0
16,134,134,10,3,7,2,1
18,140,140,5,5,0,1,0
5,174,174,5,5,0,1,0
14,215,215,7,7,0,1,0
6,223,223,39,39,0,1,0
2,228,228,52,52,0,1,0
8,244,244,10,10,0,1,0
7,268,268,25,25,0,1,0
17,298,298,32,32,0,1,0
1,315,315,36,36,0,1,0
9,331,331,12,9,3,2,1
4,344,344,92,76,16,3,2
3,357,357,28,15,13,2,1
20,360,360,36,5,31,2,1
12,375,375,57,29,28,3,2
10,447,447,9,9,0,1,0
19,452,452,57,7,50,4,3
11,481,481,26,26,0,1,0
13,491,491,27,27,0,1,0

6,108,108,11,5,6,2,1
26,109,109,1,1,0,1,0
21,109,109,10,10,0,1,0
19,134,134,1,1,0,1,0
2,137,137,2,2,0,1,0
17,180,180,9,3,6,3,2
1,183,183,1,1,0,1,0
28,207,207,21,12,9,2,1
10,209,209,16,16,0,1,0
9,214,214,11,7,4,2,1
25,226,226,42,42,0,1,0
8,229,229,12,12,0,1,0
27,248,248,15,15,0,1,0
20,292,292,48,11,37,3,2
22,311,311,21,5,16,3,2
7,311,311,10,10,0,1,0
15,313,313,27,11,16,2,1
13,314,314,8,1,7,2,1
24,322,322,12,2,10,2,1
11,339,339,2,2,0,1,0
14,403,403,18,9,9,3,2
18,420,420,9,9,0,1,0
0,432,432,17,17,0,1,0
5,436,436,10,10,0,1,0
3,439,439,60,33,27,4,3
12,442,442,15,15,0,1,0
23,466,466,189,142,47,2,1
16,471,471,123,113,10,3,2
4,476,476,19,19,0,1,0

6,100,100,15,11,4,2,1
0,112,112,3,3,0,1,0
19,148,148,30,22,8,2,1
18,180,180,68,28,40,3,2
2,201,201,22,22,0,1,0
12,206,206,3,3,0,1,0
14,211,211,22,22,0,1,0
13,222,222,61,7,54,3,2
4,224,224,7,7,0,1,0
8,233,233,17,17,0,1,0
1,257,257,29,2,27,2,1
5,277,277,88,53,35,2,1
7,286,286,50,5,45,2,1
10,296,296,12,12,0,1,0
15,309,309,4,4,0,1,0
16,359,359,11,2,9,2,1
3,367,367,16,16,0,1,0
11,373,373,19,8,11,3,2
20,444,444,2,2,0,1,0
17,452,452,19,10,9,2,1
9,491,491,11,11,0,1,0

17,114,114,3,3,0,1,0
6,133,133,1,1,0,1,0
13,146,146,9,1,8,3,2
16,158,158,20,6,14,2,1
19,204,204,3,3,0,1,0
9,250,250,1,1,0,1,0
7,254,254,36,12,24,2,1
5,282,282,5,5,0,1,0
15,314,314,42,42,0,1,0
21,316,316,5,2,3,2,1
3,317,317,25,25,0,1,0
8,328,328,68,68,0,1,0
18,330,330,47,38,9,4,3
2,343,343,81,81,0,1,0
0,344,344,52,21,31,2,1
14,363,363,72,72,0,1,0
11,398,398,30,30,0,1,0
1,414,414,36,4,32,2,1
10,436,436,22,4,18,4,3
20,454,454,49,49,0,1,0
4,466,466,20,20,0,1,0
12,495,495,146,146,0,1,0

0,118,118,1,1,0,1,0
14,145,145,1,1,0,1,0
11,173,173,17,7,10,2,1
20,201,201,7,1,6,2,1
15,211,211,15,9,6,3,2
19,220,220,7,7,0,1,0
5,259,259,57,57,0,1,0
12,265,265,25,17,8,2,1
6,270,270,4,1,3,2,1
22,281,281,68,68,0,1,0
8,284,284,9,9,0,1,0
13,285,285,26,8,18,2,1
10,337,337,36,36,0,1,0
25,354,354,94,8,86,3,2
3,391,391,4,1,3,2,1
18,414,414,36,10,26,3,2
24,415,415,41,41,0,1,0
9,429,429,39,39,0,1,0
1,459,459,6,6,0,1,0
4,471,471,41,11,30,3,2
2,472,472,74,74,0,1,0
7,477,477,1,1,0,1,0
17,484,484,3,3,0,1,0
21,491,491,7,3,4,2,1
23,491,491,71,71,0,1,0
16,500,500,91,91,0,1,0

16,142,142,17,5,12,2,1
18,178,178,2,2,0,1,0
21,187,187,7,7,0,1,0
19,200,200,6,6,0,1,0
1,206,206,10,2,8,2,1
13,218,218,52,24,28,2,1
7,219,219,53,22,31,2,1
12,223,223,3,3,0,1,0
14,242,242,58,58,0,1,0
8,277,277,35,18,17,2,1
23,282,282,40,40,0,1,0
0,282,282,3,3,0,1,0
2,324,324,5,2,3,2,1
3,326,326,22,22,0,1,0
4,352,352,12,4,8,2,1
15,369,369,107,107,0,1,0
22,373,373,13,13,0,1,0
6,378,378,10,5,5,2,1
11,397,397,3,3,0,1,0
5,411,411,4,4,0,1,0
9,417,417,59,31,28,2,1
20,466,466,12,12,0,1,0
17,474,474,88,88,0,1,0
10,496,496,60,50,10,3,2

6,129,129,3,3,0,1,0
12,135,135,27,9,18,4,3
15,147,147,16,3,13,2,1
8,148,148,2,2,0,1,0
0,153,153,4,4,0,1,0
9,181,181,8,2,6,3,2
5,197,197,13,4,9,2,1
17,230,230,30,30,0,1,0
2,262,262,35,35,0,1,0
18,290,290,37,37,0,1,0
11,299,299,6,6,0,1,0
19,323,323,19,19,0,1,0
1,341,341,197,83,114,4,3
13,352,352,58,58,0,1,0
20,366,366,47,47,0,1,0
10,366,366,18,18,0,1,0
3,380,380,32,32,0,1,0
16,382,382,20,3,17,2,1
14,470,470,61,61,0,1,0
4,476,476,10,1,9,4,3
7,485,485,30,21,9,2,1

1,132,132,6,2,4,2,1
17,133,133,33,33,0,1,0
16,135,135,5,5,0,1,0
18,146,146,1,1,0,1,0
0,161,161,3,3,0,1,0
6,173,173,34,34,0,1,0
7,185,185,81,35,46,4,3
4,195,195,10,10,0,1,0
8,205,205,8,4,4,2,1
9,251,251,3,3,0,1,0
12,289,289,32,32,0,1,0
19,291,291,17,17,0,1,0
11,298,298,20,8,12,3,2
5,306,306,7,7,0,1,0
15,306,306,6,6,0,1,0
20,329,329,134,96,38,2,1
2,349,349,24,17,7,2,1
21,372,372,47,47,0,1,0
14,387,387,33,33,0,1,0
10,390,390,9,1,8,2,1
13,446,446,10,4,6,3,2
3,497,497,59,32,27,2,1

3,102,102,6,6,0,1,0
17,112,112,15,15,0,1,0
15,125,125,4,4,0,1,0
9,146,146,30,23,7,2,1
7,172,172,10,4,6,3,2
20,206,206,2,2,0,1,0
1,208,208,7,1,6,3,2
8,213,213,8,8,0,1,0
18,279,279,101,101,0,1,0
14,281,281,15,3,12,4,3
11,303,303,20,20,0,1,0
2,319,319,20,20,0,1,0
19,321,321,78,48,30,3,2
0,370,370,2,2,0,1,0
12,378,378,70,36,34,3,2
10,410,410,11,6,5,2,1
6,419,419,45,45,0,1,0
5,420,420,47,9,38,2,1
13,457,457,17,2,15,4,3
4,473,473,186,129,57,4,3
16,479,479,2,2,0,1,0

12,157,157,1,1,0,1,0
16,168,168,5,5,0,1,0
9,197,197,20,6,14,3,2
8,220,220,1,1,0,1,0
6,228,228,6,6,0,1,0
18,246,246,35,19,16,3,2
10,274,274,2,2,0,1,0
17,278,278,1,1,0,1,0
4,287,287,58,47,11,2,1
13,299,299,56,56,0,1,0
11,305,305,38,38,0,1,0
15,311,311,28,28,0,1,0
14,342,342,147,48,99,4,3
2,365,365,6,6,0,1,0
7,368,368,23,15,8,3,2
1,442,442,5,5,0,1,0
0,445,445,28,28,0,1,0
3,445,445,144,45,99,4,3
5,488,488,192,187,5,2,1

19,106,106,12,12,0,1,0
2,111,111,22,4,18,4,3
9,112,112,12,12,0,1,0
5,132,132,14,14,0,1,0
17,198,198,14,14,0,1,0
6,212,212,1,1,0,1,0
13,217,217,9,5,4,2,1
15,217,217,22,13,9,2,1
14,227,227,1,1,0,1,0
26,233,233,28,2,26,4,3
18,238,238,5,5,0,1,0
16,240,240,3,3,0,1,0
1,245,245,24,2,22,4,3
25,259,259,4,4,0,1,0
4,262,262,1,1,0,1,0
11,299,299,5,5,0,1,0
21,307,307,34,34,0,1,0
0,343,343,1,1,0,1,0
22,383,383,77,23,54,3,2
8,390,390,5,5,0,1,0
23,409,409,101,57,44,3,2
20,411,411,21,5,16,2,1
27,414,414,20,8,12,4,3
10,432,432,60,11,49,4,3
3,453,453,68,68,0,1,0
24,454,454,87,48,39,4,3
7,455,455,14,14,0,1,0
12,492,492,1,1,0,1,0

10,131,131,20,20,0,1,0
1,151,151,1,1,0,1,0
13,193,193,18,18,0,1,0
11,255,255,43,43,0,1,0
15,278,278,46,19,27,4,3
5,282,282,57,57,0,1,0
4,285,285,24,24,0,1,0
0,304,304,51,51,0,1,0
9,317,317,5,5,0,1,0
3,365,365,147,147,0,1,0
8,382,382,10,1,9,2,1
12,386,386,118,118,0,1,0
7,402,402,13,13,0,1,0
16,412,412,3,3,0,1,0
6,424,424,18,18,0,1,0
2,443,443,87,66,21,3,2
14,491,491,73,13,60,4,3

8,118,118,16,16,0,1,0
2,127,127,29,29,0,1,0
9,134,134,11,11,0,1,0
15,134,134,19,9,10,3,2
7,137,137,1,1,0,1,0
3,158,158,6,6,0,1,0
23,162,162,76,72,4,2,1
12,203,203,2,2,0,1,0
4,208,208,1,1,0,1,0
24,218,218,23,23,0,1,0
18,248,248,13,1,12,3,2
17,249,249,4,4,0,1,0
13,263,263,19,3,16,3,2
16,269,269,2,2,0,1,0
14,305,305,13,1,12,4,3
21,342,342,39,31,8,2,1
20,381,381,42,15,27,2,1
0,388,388,23,6,17,2,1
10,422,422,17,17,0,1,0
6,429,429,47,47,0,1,0
11,433,433,28,8,20,2,1
22,436,436,36,3,33,4,3
19,444,444,12,12,0,1,0
1,488,488,78,28,50,2,1
5,492,492,24,24,0,1,0

4,169,169,21,13,8,2,1
10,197,197,28,28,0,1,0
3,201,201,19,7,12,2,1
5,201,201,9,2,7,2,1
8,215,215,41,41,0,1,0
9,296,296,54,12,42,2,1
1,304,304,112,67,45,4,3
0,339,339,66,2,64,4,3
6,378,378,20,20,0,1,0
13,386,386,26,26,0,1,0
16,395,395,28,28,0,1,0
11,469,469,13,1,12,4,3
7,470,470,20,8,12,3,2
12,476,476,150,63,87,4,3
15,483,483,21,21,0,1,0
14,484,484,19,19,0,1,0
2,499,499,110,74,36,2,1

19,112,112,6,6,0,1,0
0,114,114,8,8,0,1,0
11,134,134,1,1,0,1,0
20,139,139,14,14,0,1,0
7,146,146,8,2,6,2,1
1,159,159,12,12,0,1,0
12,165,165,11,11,0,1,0
5,198,198,11,11,0,1,0
14,208,208,11,3,8,3,2
8,255,255,13,13,0,1,0
10,281,281,5,5,0,1,0
22,282,282,9,9,0,1,0
3,308,308,28,28,0,1,0
17,350,350,62,62,0,1,0
18,361,361,47,39,8,3,2
6,393,393,48,26,22,3,2
24,408,408,22,14,8,2,1
23,415,415,47,16,31,2,1
2,426,426,55,4,51,4,3
13,428,428,13,13,0,1,0
15,435,435,39,33,6,2,1
4,435,435,75,75,0,1,0
16,476,476,46,4,42,3,2
21,483,483,129,83,46,3,2
9,491,491,51,18,33,4,3

1,100,100,11,1,10,3,2
21,116,116,19,2,17,2,1
19,129,129,47,47,0,1,0
10,140,140,46,16,30,2,1
3,161,161,4,4,0,1,0
11,181,181,6,6,0,1,0
20,188,188,2,2,0,1,0
18,203,203,3,3,0,1,0
13,215,215,28,28,0,1,0
16,216,216,28,9,19,4,3
0,230,230,14,14,0,1,0
12,259,259,35,35,0,1,0
9,278,278,1,1,0,1,0
17,280,280,23,23,0,1,0
15,281,281,18,18,0,1,0
2,363,363,43,43,0,1,0
6,380,380,17,17,0,1,0
8,426,426,24,24,0,1,0
7,430,430,14,14,0,1,0
4,437,437,41,41,0,1,0
5,438,438,85,85,0,1,0
14,498,498,15,5,10,3,2

4,123,123,2,2,0,1,0
6,133,133,10,10,0,1,0
18,153,153,19,3,16,3,2
5,229,229,5,5,0,1,0
8,249,249,9,2,7,2,1
1,290,290,15,15,0,1,0
13,309,309,4,1,3,2,1
7,323,323,54,54,0,1,0
10,327,327,103,87,16,3,2
12,342,342,59,59,0,1,0
0,343,343,96,56,40,2,1
15,345,345,11,11,0,1,0
3,351,351,92,20,72,4,3
16,408,408,96,20,76,3,2
9,426,426,38,38,0,1,0
17,439,439,28,21,7,2,1
11,470,470,29,22,7,2,1
2,490,490,93,93,0,1,0
14,493,493,6,3,3,2,1

1,114,114,4,4,0,1,0
8,114,114,1,1,0,1,0
0,122,122,4,4,0,1,0
14,126,126,9,9,0,1,0
24,128,128,5,5,0,1,0
13,130,130,7,7,0,1,0
23,144,144,11,11,0,1,0
12,162,162,4,4,0,1,0
19,179,179,11,7,4,2,1
18,185,185,22,22,0,1,0
21,204,204,15,5,10,2,1
6,224,224,10,10,0,1,0
16,248,248,7,7,0,1,0
17,256,256,7,3,4,2,1
11,256,256,5,5,0,1,0
5,269,269,10,10,0,1,0
7,281,281,167,47,120,4,3
10,348,348,35,35,0,1,0
9,352,352,9,9,0,1,0
15,405,405,63,23,40,3,2
20,406,406,184,169,15,4,3
3,414,414,10,10,0,1,0
22,427,427,41,30,11,2,1
4,471,471,7,7,0,1,0
2,483,483,9,1,8,2,1

6,111,111,3,3,0,1,0
7,144,144,12,12,0,1,0
8,149,149,1,1,0,1,0
5,151,151,46,5,41,2,1
10,183,183,1,1,0,1,0
0,223,223,24,24,0,1,0
19,237,237,5,5,0,1,0
18,238,238,4,4,0,1,0
20,241,241,6,6,0,1,0
4,242,242,32,17,15,2,1
13,292,292,14,11,3,2,1
1,342,342,28,28,0,1,0
16,350,350,15,15,0,1,0
17,377,377,115,115,0,1,0
3,377,377,107,107,0,1,0
15,384,384,27,27,0,1,0
14,393,393,24,4,20,2,1
9,437,437,12,3,9,4,3
2,479,479,20,20,0,1,0
11,483,483,106,63,43,2,1
12,486,486,147,147,0,1,0

21,108,108,9,9,0,1,0
9,127,127,39,39,0,1,0
5,147,147,3,3,0,1,0
12,182,182,5,5,0,1,0
13,193,193,17,5,12,4,3
6,204,204,6,6,0,1,0
0,225,225,19,19,0,1,0
20,237,237,45,15,30,4,3
10,264,264,4,4,0,1,0
11,268,268,11,1,10,2,1
8,278,278,42,42,0,1,0
14,310,310,44,44,0,1,0
4,312,312,28,28,0,1,0
15,317,317,68,26,42,4,3
7,324,324,24,24,0,1,0
16,325,325,5,5,0,1,0
17,347,347,9,9,0,1,0
18,355,355,76,55,21,2,1
19,367,367,42,15,27,4,3
3,371,371,91,53,38,3,2
2,377,377,12,12,0,1,0
1,379,379,4,4,0,1,0

3,113,113,3,3,0,1,0
26,146,146,32,20,12,4,3
11,157,157,1,1,0,1,0
19,157,157,1,1,0,1,0
6,175,175,17,9,8,3,2
13,181,181,24,24,0,1,0
18,189,189,49,49,0,1,0
12,211,211,12,12,0,1,0
2,211,211,10,4,6,2,1
9,222,222,19,6,13,2,1
0,247,247,38,38,0,1,0
10,263,263,26,16,10,3,2
20,278,278,50,50,0,1,0
23,287,287,34,28,6,3,2
14,296,296,21,7,14,2,1
7,298,298,19,19,0,1,0
16,317,317,17,7,10,2,1
5,331,331,2,2,0,1,0
25,378,378,1,1,0,1,0
22,385,385,37,37,0,1,0
15,419,419,3,3,0,1,0
4,421,421,29,24,5,2,1
24,436,436,62,62,0,1,0
1,440,440,23,9,14,2,1
21,460,460,36,8,28,3,2
8,488,488,36,36,0,1,0
17,489,489,8,2,6,3,2

19,106,106,3,3,0,1,0
8,116,116,18,12,6,3,2
0,122,122,1,1,0,1,0
14,125,125,9,6,3,2,1
17,170,170,1,1,0,1,0
12,234,234,10,6,4,2,1
1,240,240,8,4,4,2,1
5,258,258,44,4,40,3,2
20,281,281,16,10,6,3,2
22,305,305,8,8,0,1,0
4,309,309,69,69,0,1,0
13,362,362,46,37,9,4,3
18,385,385,171,131,40,3,2
21,388,388,110,48,62,3,2
15,399,399,16,8,8,3,2
3,401,401,2,2,0,1,0
16,411,411,58,58,0,1,0
9,415,415,50,33,17,2,1
7,416,416,17,17,0,1,0
6,434,434,32,7,25,2,1
11,437,437,33,20,13,2,1
23,470,470,8,8,0,1,0
2,475,475,1,1,0,1,0
10,494,494,11,3,8,3,2

17,102,102,1,1,0,1,0
10,102,102,8,5,3,2,1
7,122,122,1,1,0,1,0
9,124,124,1,1,0,1,0
18,124,124,4,1,3,2,1
12,162,162,3,3,0,1,0
14,164,164,13,4,9,2,1
22,168,168,10,10,0,1,0
5,201,201,1,1,0,1,0
4,223,223,5,5,0,1,0
2,230,230,12,12,0,1,0
19,245,245,3,3,0,1,0
25,266,266,19,19,0,1,0
16,269,269,23,23,0,1,0
26,272,272,22,1,21,4,3
21,274,274,59,59,0,1,0
15,308,308,1,1,0,1,0
23,325,325,109,17,92,3,2
28,337,337,28,19,9,2,1
11,341,341,6,6,0,1,0
27,353,353,63,48,15,2,1
3,367,367,2,2,0,1,0
0,387,387,59,59,0,1,0
6,404,404,78,66,12,4,3
8,408,408,44,27,17,2,1
1,411,411,7,7,0,1,0
24,428,428,21,1,20,3,2
13,456,456,94,89,5,2,1
20,458,458,13,1,12,3,2

10,111,111,11,3,8,2,1
0,149,149,25,8,17,2,1
2,155,155,18,18,0,1,0
4,174,174,5,5,0,1,0
18,197,197,1,1,0,1,0
13,204,204,19,19,0,1,0
16,212,212,1,1,0,1,0
17,271,271,29,29,0,1,0
3,296,296,59,59,0,1,0
14,311,311,10,2,8,2,1
15,321,321,13,1,12,2,1
12,331,331,111,18,93,4,3
6,387,387,109,109,0,1,0
11,409,409,21,21,0,1,0
19,426,426,149,75,74,3,2
1,427,427,21,21,0,1,0
7,429,429,39,39,0,1,0
9,470,470,53,53,0,1,0
5,473,473,25,25,0,1,0
8,482,482,1,1,0,1,0

12,147,147,1,1,0,1,0
0,166,166,27,22,5,2,1
4,168,168,21,21,0,1,0
7,180,180,7,2,5,2,1
9,181,181,9,3,6,2,1
20,190,190,16,6,10,2,1
8,222,222,1,1,0,1,0
10,226,226,25,25,0,1,0
16,266,266,13,6,7,2,1
19,295,295,57,39,18,3,2
18,304,304,22,22,0,1,0
14,330,330,31,16,15,2,1
2,342,342,52,52,0,1,0
5,355,355,33,1,32,2,1
11,361,361,4,1,3,2,1
15,363,363,30,21,9,4,3
6,370,370,24,4,20,2,1
17,384,384,1,1,0,1,0
3,393,393,10,4,6,2,1
24,396,396,46,46,0,1,0
1,435,435,68,68,0,1,0
21,444,444,80,44,36,4,3
23,448,448,35,14,21,4,3
22,478,478,123,39,84,4,3
13,492,492,3,3,0,1,0

2,113,113,5,5,0,1,0
20,141,141,26,26,0,1,0
7,157,157,13,1,12,4,3
15,160,160,43,43,0,1,0
9,188,188,4,4,0,1,0
12,229,229,7,4,3,2,1
5,248,248,10,10,0,1,0
23,248,248,33,8,25,2,1
18,279,279,22,22,0,1,0
3,312,312,20,12,8,3,2
17,331,331,51,45,6,2,1
0,334,334,41,20,21,2,1
25,364,364,22,22,0,1,0
22,378,378,42,42,0,1,0
24,387,387,4,4,0,1,0
13,402,402,2,2,0,1,0
11,409,409,1,1,0,1,0
1,411,411,9,1,8,2,1
10,421,421,12,3,9,2,1
14,429,429,11,5,6,2,1
16,431,431,32,32,0,1,0
4,434,434,78,78,0,1,0
21,436,436,21,21,0,1,0
8,437,437,6,6,0,1,0
19,446,446,116,70,46,2,1
6,491,491,74,26,48,2,1

20,114,114,16,16,0,1,0
8,118,118,2,2,0,1,0
13,147,147,2,2,0,1,0
22,155,155,15,10,5,2,1
10,179,179,1,1,0,1,0
19,189,189,11,11,0,1,0
23,199,199,15,6,9,2,1
9,207,207,54,54,0,1,0
6,223,223,1,1,0,1,0
15,232,232,4,4,0,1,0
2,250,250,1,1,0,1,0
5,273,273,89,10,79,4,3
17,284,284,7,7,0,1,0
25,286,286,8,8,0,1,0
12,320,320,1,1,0,1,0
18,336,336,3,3,0,1,0
21,361,361,113,113,0,1,0
7,364,364,1,1,0,1,0
4,373,373,5,5,0,1,0
16,376,376,80,80,0,1,0
11,398,398,12,12,0,1,0
3,412,412,57,3,54,3,2
26,414,414,75,1,74,3,2
24,416,416,84,27,57,4,3
0,450,450,4,4,0,1,0
1,469,469,15,15,0,1,0
14,498,498,5,5,0,1,0

16,133,133,1,1,0,1,0
13,144,144,28,6,22,2,1
12,145,145,35,27,8,2,1
8,148,148,15,6,9,4,3
15,186,186,50,50,0,1,0
7,198,198,8,8,0,1,0
1,229,229,42,42,0,1,0
11,231,231,33,18,15,2,1
2,305,305,66,66,0,1,0
6,339,339,27,3,24,3,2
5,341,341,54,17,37,4,3
4,363,363,39,39,0,1,0
3,377,377,74,74,0,1,0
14,383,383,6,6,0,1,0
10,437,437,46,46,0,1,0
0,452,452,72,24,48,3,2
9,472,472,4,4,0,1,0

0,127,127,4,4,0,1,0
18,138,138,20,20,0,1,0
15,161,161,14,14,0,1,0
12,177,177,60,8,52,4,3
1,181,181,10,2,8,3,2
13,201,201,30,8,22,2,1
6,215,215,2,2,0,1,0
17,225,225,40,28,12,4,3
14,243,243,7,7,0,1,0
3,255,255,20,20,0,1,0
7,321,321,69,30,39,2,1
9,327,327,42,37,5,2,1
10,338,338,15,6,9,2,1
5,377,377,14,2,12,4,3
8,396,396,216,75,141,4,3
11,413,413,7,7,0,1,0
16,448,448,1,1,0,1,0
2,453,453,39,24,15,2,1
4,466,466,20,8,12,2,1

1,162,162,8,8,0,1,0
18,180,180,20,5,15,3,2
0,181,181,21,6,15,2,1
13,213,213,40,40,0,1,0
10,222,222,28,28,0,1,0
15,244,244,36,4,32,3,2
12,244,244,23,23,0,1,0
14,255,255,18,18,0,1,0
9,274,274,18,18,0,1,0
17,285,285,62,36,26,2,1
3,290,290,13,9,4,2,1
2,296,296,16,16,0,1,0
20,354,354,3,3,0,1,0
16,367,367,25,25,0,1,0
6,402,402,100,1,99,4,3
5,405,405,13,9,4,2,1
4,407,407,9,3,6,3,2
19,410,410,19,19,0,1,0
8,426,426,35,16,19,3,2
7,447,447,116,116,0,1,0
11,458,458,75,27,48,2,1

11,105,105,6,6,0,1,0
13,106,106,14,2,12,2,1
17,150,150,32,32,0,1,0
18,158,158,35,35,0,1,0
8,205,205,38,31,7,2,1
1,226,226,10,7,3,2,1
16,228,228,15,15,0,1,0
15,228,228,11,11,0,1,0
6,239,239,2,2,0,1,0
9,274,274,52,52,0,1,0
3,295,295,14,14,0,1,0
0,350,350,8,2,6,3,2
7,350,350,31,4,27,2,1
19,353,353,20,14,6,2,1
4,397,397,41,21,20,2,1
14,404,404,77,45,32,2,1
10,422,422,5,5,0,1,0
12,459,459,56,11,45,2,1
5,474,474,3,3,0,1,0
2,483,483,196,196,0,1,0

14,135,135,7,1,6,3,2
16,154,154,16,16,0,1,0
3,256,256,22,22,0,1,0
10,261,261,27,9,18,4,3
12,264,264,12,3,9,4,3
17,275,275,67,25,42,4,3
9,281,281,2,2,0,1,0
19,308,308,52,23,29,2,1
13,318,318,12,12,0,1,0
22,322,322,59,59,0,1,0
5,323,323,11,11,0,1,0
11,350,350,8,8,0,1,0
1,356,356,17,17,0,1,0
0,367,367,88,72,16,2,1
8,403,403,2,2,0,1,0
6,413,413,33,13,20,3,2
20,415,415,23,23,0,1,0
15,433,433,35,23,12,4,3
2,436,436,64,55,9,4,3
7,438,438,65,65,0,1,0
4,446,446,44,30,14,2,1
21,457,457,73,57,16,3,2
23,459,459,25,25,0,1,0
18,465,465,8,8,0,1,0

4,108,108,2,2,0,1,0
22,127,127,12,12,0,1,0
6,167,167,1,1,0,1,0
11,177,177,7,1,6,3,2
8,177,177,17,17,0,1,0
14,188,188,1,1,0,1,0
0,190,190,7,7,0,1,0
17,203,203,55,12,43,3,2
13,216,216,11,5,6,3,2
27,217,217,4,4,0,1,0
3,234,234,5,5,0,1,0
20,252,252,4,1,3,2,1
9,282,282,3,3,0,1,0
23,301,301,33,33,0,1,0
19,305,305,16,4,12,4,3
24,318,318,39,39,0,1,0
10,326,326,8,2,6,3,2
15,331,331,45,4,41,2,1
7,349,349,7,7,0,1,0
12,355,355,37,37,0,1,0
18,401,401,53,53,0,1,0
16,402,402,10,10,0,1,0
2,422,422,2,2,0,1,0
25,447,447,31,3,28,3,2
26,457,457,201,201,0,1,0
5,458,458,14,2,12,4,3
21,461,461,28,28,0,1,0
1,471,471,94,26,68,4,3

23,117,117,1,1,0,1,0
0,123,123,7,1,6,3,2
8,131,131,1,1,0,1,0
21,135,135,10,10,0,1,0
10,153,153,19,5,14,2,1
13,155,155,10,10,0,1,0
11,177,177,1,1,0,1,0
16,180,180,9,9,0,1,0
9,188,188,19,10,9,2,1
24,200,200,30,30,0,1,0
22,203,203,23,23,0,1,0
5,229,229,1,1,0,1,0
17,238,238,21,15,6,2,1
19,240,240,11,2,9,4,3
18,242,242,1,1,0,1,0
3,271,271,22,10,12,3,2
4,293,293,21,3,18,3,2
2,341,341,1,1,0,1,0
6,346,346,26,26,0,1,0
12,374,374,17,8,9,2,1
1,427,427,107,35,72,3,2
15,428,428,20,3,17,4,3
26,433,433,190,154,36,4,3
20,470,470,53,53,0,1,0
14,491,491,36,3,33,2,1
25,491,491,45,42,3,2,1
7,498,498,20,20,0,1,0

13,168,168,25,22,3,2,1
0,183,183,1,1,0,1,0
8,198,198,56,15,41,4,3
12,208,208,30,9,21,4,3
10,226,226,31,17,14,3,2
18,245,245,34,7,27,4,3
17,273,273,50,50,0,1,0
16,295,295,55,40,15,4,3
4,305,305,38,38,0,1,0
3,328,328,45,45,0,1,0
11,334,334,35,15,20,4,3
7,354,354,6,2,4,2,1
1,372,372,29,19,10,3,2
6,384,384,8,8,0,1,0
15,405,405,45,11,34,3,2
2,409,409,67,59,8,2,1
19,413,413,16,5,11,3,2
5,416,416,7,1,6,3,2
14,437,437,18,3,15,4,3
20,478,478,12,12,0,1,0
9,489,489,57,47,10,2,1

3,112,112,27,27,0,1,0
0,176,176,41,41,0,1,0
5,209,209,37,31,6,3,2
8,211,211,1,1,0,1,0
1,215,215,2,2,0,1,0
13,222,222,2,2,0,1,0
17,245,245,3,3,0,1,0
2,265,265,23,1,22,2,1
6,269,269,15,3,12,3,2
10,275,275,45,45,0,1,0
7,322,322,72,50,22,3,2
18,353,353,12,6,6,2,1
19,383,383,3,3,0,1,0
15,393,393,14,14,0,1,0
16,393,393,174,122,52,3,2
4,404,404,14,11,3,2,1
12,417,417,90,19,71,4,3
9,433,433,15,15,0,1,0
14,449,449,2,2,0,1,0
11,497,497,97,15,82,3,2

13,120,120,9,2,7,2,1
5,143,143,10,10,0,1,0
4,160,160,5,5,0,1,0
12,160,160,8,8,0,1,0
0,174,174,5,5,0,1,0
15,195,195,5,2,3,2,1
7,202,202,7,7,0,1,0
20,213,213,88,41,47,3,2
8,228,228,5,5,0,1,0
3,229,229,11,11,0,1,0
14,245,245,22,2,20,3,2
19,265,265,12,6,6,2,1
24,267,267,4,4,0,1,0
6,283,283,17,5,12,3,2
2,288,288,18,18,0,1,0
22,320,320,19,19,0,1,0
26,332,332,20,2,18,2,1
18,344,344,18,10,8,2,1
10,344,344,8,8,0,1,0
25,390,390,74,74,0,1,0
1,424,424,30,15,15,4,3
9,425,425,24,24,0,1,0
16,434,434,116,53,63,3,2
21,451,451,15,1,14,3,2
17,464,464,50,15,35,2,1
11,494,494,42,25,17,2,1
23,499,499,68,2,66,4,3

23,108,108,21,11,10,3,2
13,108,108,11,11,0,1,0
16,110,110,11,6,5,2,1
10,114,114,1,1,0,1,0
7,118,118,4,4,0,1,0
18,119,119,9,3,6,3,2
5,123,123,1,1,0,1,0
1,137,137,3,3,0,1,0
11,180,180,48,48,0,1,0
24,205,205,33,33,0,1,0
19,218,218,20,20,0,1,0
6,237,237,26,2,24,2,1
21,237,237,40,8,32,4,3
15,270,270,16,7,9,2,1
2,273,273,43,34,9,4,3
14,301,301,9,9,0,1,0
4,313,313,1,1,0,1,0
12,340,340,63,16,47,2,1
22,363,363,6,6,0,1,0
9,379,379,10,1,9,2,1
0,381,381,29,4,25,2,1
17,387,387,60,60,0,1,0
3,406,406,16,16,0,1,0
20,410,410,41,25,16,2,1
8,426,426,14,14,0,1,0

0,123,123,10,1,9,2,1
15,135,135,30,8,22,3,2
9,141,141,17,17,0,1,0
23,164,164,17,17,0,1,0
5,172,172,8,8,0,1,0
7,172,172,7,7,0,1,0
8,180,180,1,1,0,1,0
6,203,203,36,18,18,2,1
22,233,233,22,12,10,2,1
1,273,273,6,6,0,1,0
2,289,289,1,1,0,1,0
21,305,305,13,3,10,3,2
18,319,319,65,27,38,2,1
11,360,360,14,14,0,1,0
13,382,382,64,26,38,2,1
16,402,402,11,11,0,1,0
3,416,416,5,5,0,1,0
19,446,446,90,24,66,4,3
10,462,462,11,1,10,2,1
14,468,468,12,12,0,1,0
17,474,474,78,78,0,1,0
4,476,476,71,21,50,2,1
20,488,488,13,8,5,2,1
12,490,490,104,40,64,4,3

21,103,103,15,15,0,1,0
7,111,111,18,7,11,2,1
5,127,127,21,9,12,4,3
10,133,133,32,32,0,1,0
15,136,136,49,49,0,1,0
9,141,141,6,1,5,2,1
1,148,148,10,2,8,2,1
19,162,162,36,24,12,3,2
13,191,191,27,15,12,4,3
17,196,196,23,14,9,4,3
4,208,208,1,1,0,1,0
18,227,227,1,1,0,1,0
20,246,246,17,17,0,1,0
0,261,261,15,3,12,2,1
22,265,265,5,5,0,1,0
16,286,286,8,8,0,1,0
8,290,290,13,9,4,2,1
12,292,292,51,41,10,2,1
14,324,324,6,1,5,2,1
3,391,391,15,12,3,2,1
2,393,393,8,2,6,2,1
11,426,426,7,1,6,3,2
6,442,442,30,30,0,1,0

14,109,109,12,12,0,1,0
9,111,111,34,1,33,4,3
5,135,135,4,4,0,1,0
12,158,158,29,29,0,1,0
6,159,159,14,14,0,1,0
17,164,164,17,5,12,3,2
2,175,175,47,47,0,1,0
15,200,200,17,5,12,2,1
20,202,202,28,6,22,2,1
7,217,217,2,2,0,1,0
1,244,244,32,7,25,2,1
13,253,253,26,5,21,2,1
16,254,254,10,10,0,1,0
10,260,260,26,18,8,2,1
18,336,336,55,55,0,1,0
4,336,336,6,6,0,1,0
0,388,388,3,3,0,1,0
8,395,395,34,19,15,2,1
21,396,396,44,7,37,2,1
19,428,428,37,37,0,1,0
3,441,441,10,1,9,3,2
11,497,497,17,17,0,1,0

17,115,115,6,6,0,1,0
1,160,160,15,15,0,1,0
12,169,169,23,7,16,2,1
8,197,197,20,14,6,3,2
5,207,207,14,14,0,1,0
15,216,216,11,8,3,2,1
4,254,254,72,72,0,1,0
18,262,262,68,68,0,1,0
9,293,293,5,5,0,1,0
19,315,315,40,25,15,4,3
2,318,318,5,5,0,1,0
7,325,325,20,5,15,4,3
11,330,330,64,64,0,1,0
16,336,336,82,71,11,2,1
3,361,361,83,83,0,1,0
10,367,367,1,1,0,1,0
0,406,406,71,71,0,1,0
13,426,426,15,8,7,2,1
14,454,454,11,11,0,1,0
6,471,471,26,26,0,1,0

22,104,104,4,4,0,1,0
16,105,105,14,6,8,2,1
19,110,110,22,4,18,2,1
12,111,111,5,1,4,2,1
17,132,132,45,45,0,1,0
3,142,142,36,5,31,2,1
23,147,147,5,2,3,2,1
13,153,153,2,2,0,1,0
14,200,200,12,12,0,1,0
2,229,229,16,16,0,1,0
0,259,259,20,8,12,4,3
9,259,259,4,1,3,2,1
5,283,283,4,4,0,1,0
8,285,285,22,22,0,1,0
24,288,288,55,55,0,1,0
11,303,303,1,1,0,1,0
15,313,313,13,10,3,2,1
18,318,318,17,17,0,1,0
10,318,318,21,11,10,2,1
7,342,342,28,14,14,3,2
1,345,345,13,13,0,1,0
20,390,390,26,5,21,4,3
21,418,418,9,9,0,1,0
6,420,420,59,59,0,1,0
4,459,459,68,68,0,1,0

22,151,151,18,18,0,1,0
23,191,191,4,1,3,2,1
16,193,193,1,1,0,1,0
14,196,196,33,1,32,2,1
24,205,205,45,21,24,3,2
18,220,220,41,41,0,1,0
20,248,248,13,13,0,1,0
19,259,259,67,19,48,4,3
6,282,282,1,1,0,1,0
15,284,284,27,27,0,1,0
3,295,295,13,13,0,1,0
0,295,295,1,1,0,1,0
13,301,301,74,46,28,2,1
5,320,320,42,42,0,1,0
2,343,343,4,1,3,2,1
27,355,355,15,9,6,2,1
1,375,375,2,2,0,1,0
11,376,376,31,19,12,4,3
17,378,378,21,11,10,2,1
25,415,415,6,6,0,1,0
7,424,424,2,2,0,1,0
10,446,446,2,2,0,1,0
26,450,450,68,52,16,3,2
8,456,456,72,72,0,1,0
9,460,460,11,11,0,1,0
12,467,467,13,13,0,1,0
4,478,478,15,15,0,1,0
21,482,482,27,27,0,1,0

14,118,118,49,1,48,3,2
2,127,127,1,1,0,1,0
8,131,131,14,1,13,2,1
16,157,157,22,22,0,1,0
12,161,161,34,34,0,1,0
7,192,192,4,4,0,1,0
1,207,207,1,1,0,1,0
6,215,215,33,18,15,2,1
13,219,219,51,51,0,1,0
4,231,231,12,12,0,1,0
5,246,246,13,5,8,2,1
10,246,246,14,14,0,1,0
11,250,250,23,23,0,1,0
3,265,265,21,4,17,4,3
18,272,272,4,4,0,1,0
0,293,293,8,8,0,1,0
22,312,312,27,27,0,1,0
23,331,331,2,2,0,1,0
19,347,347,102,102,0,1,0
15,374,374,39,32,7,2,1
20,432,432,7,7,0,1,0
17,449,449,16,4,12,2,1
21,462,462,2,2,0,1,0
9,491,491,3,3,0,1,0

4,104,104,30,30,0,1,0
3,134,134,21,11,10,2,1
14,136,136,6,6,0,1,0
11,185,185,4,4,0,1,0
7,196,196,19,19,0,1,0
13,207,207,26,4,22,2,1
8,238,238,34,1,33,4,3
0,276,276,13,13,0,1,0
1,344,344,17,17,0,1,0
15,358,358,79,41,38,2,1
9,376,376,45,45,0,1,0
12,378,378,113,41,72,4,3
10,397,397,4,4,0,1,0
5,454,454,125,107,18,4,3
16,476,476,20,12,8,3,2
6,495,495,4,4,0,1,0
2,495,495,137,70,67,4,3

11,110,110,32,23,9,2,1
5,127,127,3,3,0,1,0
16,159,159,15,6,9,4,3
4,169,169,18,3,15,4,3
6,171,171,98,66,32,3,2
10,201,201,8,8,0,1,0
1,276,276,24,24,0,1,0
15,281,281,53,53,0,1,0
3,293,293,13,8,5,2,1
14,305,305,9,2,7,2,1
2,356,356,67,67,0,1,0
9,383,383,17,13,4,2,1
12,390,390,29,29,0,1,0
7,399,399,52,14,38,2,1
13,402,402,45,45,0,1,0
8,420,420,50,50,0,1,0
0,463,463,37,5,32,3,2

13,139,139,2,2,0,1,0
15,144,144,7,7,0,1,0
10,155,155,2,2,0,1,0
16,155,155,6,6,0,1,0
1,186,186,28,16,12,2,1
4,187,187,6,2,4,2,1
6,240,240,19,2,17,2,1
9,294,294,13,13,0,1,0
5,304,304,21,6,15,4,3
8,309,309,9,9,0,1,0
0,346,346,26,26,0,1,0
12,348,348,38,10,28,3,2
18,364,364,15,15,0,1,0
23,377,377,37,37,0,1,0
17,377,377,52,52,0,1,0
7,383,383,15,10,5,2,1
21,393,393,100,100,0,1,0
3,403,403,97,61,36,3,2
11,451,451,67,5,62,3,2
14,452,452,113,80,33,2,1
2,458,458,26,26,0,1,0
22,467,467,48,48,0,1,0
20,475,475,20,7,13,4,3
19,491,491,51,20,31,2,1

18,122,122,6,6,0,1,0
12,138,138,26,8,18,4,3
5,142,142,47,47,0,1,0
6,143,143,15,15,0,1,0
8,144,144,19,3,16,3,2
15,148,148,25,6,19,2,1
13,201,201,20,13,7,2,1
11,221,221,10,4,6,2,1
1,221,221,7,7,0,1,0
7,291,291,37,21,16,2,1
2,308,308,27,27,0,1,0
9,330,330,34,34,0,1,0
14,345,345,75,75,0,1,0
17,381,381,45,19,26,2,1
3,394,394,15,15,0,1,0
16,432,432,19,19,0,1,0
4,440,440,14,14,0,1,0
10,476,476,42,14,28,2,1
0,486,486,106,106,0,1,0

13,122,122,4,1,3,2,1
3,127,127,1,1,0,1,0
8,154,154,9,9,0,1,0
24,155,155,32,18,14,3,2
23,171,171,57,34,23,2,1
0,172,172,11,7,4,2,1
19,199,199,52,34,18,3,2
21,201,201,5,5,0,1,0
6,205,205,20,20,0,1,0
4,239,239,37,37,0,1,0
20,283,283,30,30,0,1,0
10,292,292,17,17,0,1,0
11,314,314,45,6,39,4,3
12,341,341,6,6,0,1,0
9,376,376,1,1,0,1,0
22,388,388,6,2,4,2,1
15,390,390,13,13,0,1,0
5,391,391,6,6,0,1,0
14,392,392,20,20,0,1,0
18,417,417,28,28,0,1,0
2,435,435,98,56,42,4,3
17,446,446,25,25,0,1,0
7,465,465,21,21,0,1,0
16,475,475,11,11,0,1,0
1,491,491,46,21,25,2,1
25,495,495,14,14,0,1,0

17,143,143,24,9,15,4,3
4,154,154,7,4,3,2,1
18,155,155,22,15,7,2,1
19,166,166,4,1,3,2,1
11,168,168,2,2,0,1,0
12,168,168,5,5,0,1,0
24,170,170,55,55,0,1,0
9,190,190,4,4,0,1,0
6,227,227,23,23,0,1,0
10,233,233,36,20,16,2,1
8,241,241,14,1,13,2,1
21,253,253,9,9,0,1,0
20,284,284,25,3,22,2,1
1,284,284,17,17,0,1,0
22,315,315,6,6,0,1,0
3,339,339,51,7,44,2,1
23,364,364,82,82,0,1,0
7,407,407,23,12,11,2,1
5,424,424,60,60,0,1,0
16,436,436,13,13,0,1,0
15,449,449,7,1,6,3,2
0,460,460,5,2,3,2,1
13,494,494,94,24,70,3,2
14,497,497,5,5,0,1,0
25,498,498,34,34,0,1,0
2,500,500,22,22,0,1,0

7,112,112,31,31,0,1,0
3,135,135,1,1,0,1,0
1,137,137,3,3,0,1,0
10,180,180,32,32,0,1,0
2,188,188,2,2,0,1,0
12,197,197,2,2,0,1,0
5,208,208,1,1,0,1,0
13,290,290,45,18,27,4,3
15,303,303,79,79,0,1,0
17,319,319,43,43,0,1,0
14,324,324,14,14,0,1,0
8,326,326,10,10,0,1,0
0,340,340,77,51,26,2,1
11,341,341,4,4,0,1,0
6,380,380,1,1,0,1,0
16,389,389,29,29,0,1,0
4,392,392,52,8,44,3,2
18,468,468,33,33,0,1,0
19,482,482,83,13,70,3,2
9,496,496,192,77,115,4,3

13,106,106,10,10,0,1,0
12,126,126,6,3,3,2,1
14,134,134,5,2,3,2,1
16,140,140,22,22,0,1,0
19,141,141,27,27,0,1,0
22,195,195,6,3,3,2,1
2,199,199,8,8,0,1,0
15,212,212,36,36,0,1,0
18,221,221,57,25,32,3,2
7,221,221,34,11,23,3,2
0,277,277,45,45,0,1,0
3,288,288,10,10,0,1,0
10,319,319,48,48,0,1,0
17,346,346,28,28,0,1,0
9,348,348,3,3,0,1,0
4,353,353,55,24,31,2,1
6,365,365,9,9,0,1,0
1,390,390,8,8,0,1,0
5,403,403,19,19,0,1,0
20,438,438,17,17,0,1,0
8,476,476,6,3,3,2,1
21,480,480,31,21,10,3,2
11,482,482,119,35,84,3,2

0,135,135,65,65,0,1,0
13,170,170,10,10,0,1,0
17,196,196,2,2,0,1,0
8,232,232,63,63,0,1,0
5,293,293,33,12,21,4,3
7,294,294,1,1,0,1,0
15,301,301,18,18,0,1,0
16,341,341,3,3,0,1,0
12,357,357,139,139,0,1,0
1,368,368,17,1,16,3,2
6,375,375,34,5,29,2,1
14,389,389,22,22,0,1,0
9,399,399,40,40,0,1,0
4,404,404,29,23,6,3,2
3,408,408,111,111,0,1,0
11,423,423,33,2,31,2,1
10,445,445,40,6,34,3,2
2,479,479,12,12,0,1,0

19,103,103,10,10,0,1,0
17,113,113,3,3,0,1,0
1,121,121,3,3,0,1,0
18,124,124,6,3,3,2,1
16,140,140,13,2,11,2,1
3,146,146,16,1,15,3,2
7,167,167,1,1,0,1,0
8,206,206,9,9,0,1,0
13,209,209,37,37,0,1,0
9,249,249,15,9,6,2,1
11,313,313,27,3,24,3,2
0,326,326,127,35,92,4,3
2,347,347,5,5,0,1,0
10,361,361,111,78,33,4,3
15,370,370,2,2,0,1,0
6,417,417,35,8,27,4,3
5,421,421,73,70,3,2,1
4,453,453,89,89,0,1,0
14,465,465,34,4,30,3,2
12,483,483,104,2,102,4,3

17,114,114,13,13,0,1,0
8,114,114,25,25,0,1,0
2,117,117,2,2,0,1,0
7,122,122,16,16,0,1,0
3,123,123,6,6,0,1,0
14,142,142,1,1,0,1,0
1,149,149,16,8,8,2,1
11,183,183,9,1,8,2,1
10,189,189,4,4,0,1,0
20,189,189,7,7,0,1,0
0,298,298,24,4,20,3,2
5,301,301,27,27,0,1,0
18,351,351,54,54,0,1,0
15,374,374,57,37,20,2,1
12,383,383,73,47,26,3,2
16,388,388,15,15,0,1,0
23,388,388,35,5,30,2,1
19,390,390,46,46,0,1,0
22,402,402,26,13,13,3,2
21,429,429,68,68,0,1,0
4,431,431,34,12,22,4,3
24,464,464,92,56,36,3,2
6,468,468,15,15,0,1,0
13,487,487,7,1,6,2,1
9,498,498,9,9,0,1,0

18,101,101,11,1,10,4,3
9,111,111,1,1,0,1,0
14,111,111,7,7,0,1,0
10,130,130,3,3,0,1,0
6,144,144,8,8,0,1,0
16,177,177,2,2,0,1,0
15,192,192,8,8,0,1,0
2,244,244,20,14,6,3,2
7,259,259,28,28,0,1,0
8,287,287,76,67,9,2,1
4,287,287,37,37,0,1,0
20,302,302,53,21,32,3,2
11,309,309,29,29,0,1,0
12,310,310,9,9,0,1,0
13,343,343,155,138,17,2,1
3,360,360,3,3,0,1,0
1,363,363,28,10,18,3,2
17,383,383,47,47,0,1,0
5,443,443,144,144,0,1,0
0,448,448,11,6,5,2,1
19,452,452,10,10,0,1,0

11,116,116,16,16,0,1,0
2,175,175,17,17,0,1,0
1,180,180,3,3,0,1,0
12,194,194,23,23,0,1,0
3,232,232,12,12,0,1,0
17,234,234,14,14,0,1,0
5,241,241,30,30,0,1,0
8,248,248,2,2,0,1,0
10,249,249,36,36,0,1,0
19,254,254,18,7,11,2,1
4,264,264,36,36,0,1,0
14,271,271,47,47,0,1,0
15,289,289,5,2,3,2,1
9,305,305,13,13,0,1,0
22,306,306,24,17,7,2,1
7,307,307,3,3,0,1,0
16,355,355,88,60,28,2,1
13,435,435,12,6,6,3,2
0,438,438,8,8,0,1,0
20,448,448,15,9,6,2,1
6,454,454,76,76,0,1,0
21,460,460,82,48,34,2,1
23,488,488,111,111,0,1,0
18,490,490,12,9,3,2,1

16,107,107,27,9,18,2,1
8,134,134,1,1,0,1,0
6,148,148,1,1,0,1,0
0,191,191,2,2,0,1,0
14,192,192,1,1,0,1,0
22,214,214,1,1,0,1,0
21,267,267,12,12,0,1,0
20,285,285,73,13,60,3,2
2,309,309,10,10,0,1,0
10,316,316,23,20,3,2,1
19,320,320,54,18,36,3,2
18,325,325,17,17,0,1,0
1,326,326,121,102,19,2,1
9,329,329,86,70,16,2,1
12,343,343,6,6,0,1,0
11,347,347,12,4,8,2,1
7,351,351,2,2,0,1,0
5,356,356,43,43,0,1,0
17,426,426,7,3,4,2,1
13,441,441,95,95,0,1,0
15,449,449,44,44,0,1,0
4,460,460,29,29,0,1,0
3,468,468,45,5,40,2,1

6,124,124,4,4,0,1,0
0,132,132,2,2,0,1,0
11,149,149,3,3,0,1,0
13,218,218,4,4,0,1,0
15,220,220,39,18,21,4,3
5,235,235,7,2,5,2,1
4,268,268,4,4,0,1,0
3,320,320,78,78,0,1,0
10,356,356,28,18,10,3,2
16,357,357,2,2,0,1,0
7,361,361,92,62,30,3,2
9,418,418,184,81,103,4,3
8,426,426,30,10,20,3,2
2,426,426,64,10,54,4,3
12,432,432,5,5,0,1,0
14,470,470,18,1,17,3,2
1,492,492,305,242,63,3,2

3,126,126,9,9,0,1,0
14,197,197,23,5,18,3,2
13,236,236,11,11,0,1,0
11,256,256,5,5,0,1,0
2,276,276,124,31,93,4,3
15,278,278,44,7,37,2,1
12,300,300,18,5,13,2,1
0,303,303,21,21,0,1,0
9,320,320,26,7,19,2,1
16,324,324,6,6,0,1,0
6,388,388,98,78,20,3,2
1,399,399,74,12,62,3,2
4,407,407,22,3,19,2,1
7,411,411,128,62,66,4,3
8,461,461,85,49,36,2,1
5,482,482,9,1,8,3,2
10,483,483,57,12,45,2,1

16,104,104,3,3,0,1,0
14,146,146,6,1,5,2,1
5,154,154,2,2,0,1,0
12,159,159,31,31,0,1,0
21,187,187,14,14,0,1,0
1,198,198,2,2,0,1,0
0,200,200,5,5,0,1,0
13,232,232,15,15,0,1,0
19,239,239,22,7,15,2,1
6,254,254,68,8,60,4,3
20,256,256,92,5,87,4,3
17,273,273,27,10,17,2,1
4,283,283,97,85,12,2,1
3,307,307,34,34,0,1,0
2,312,312,74,74,0,1,0
18,335,335,54,10,44,3,2
10,339,339,1,1,0,1,0
15,420,420,2,2,0,1,0
11,425,425,11,11,0,1,0
7,442,442,16,16,0,1,0
8,443,443,8,8,0,1,0
9,464,464,5,5,0,1,0

1,102,102,13,13,0,1,0
8,139,139,2,2,0,1,0
15,141,141,2,2,0,1,0
4,156,156,66,66,0,1,0
5,190,190,37,1,36,4,3
2,196,196,11,6,5,2,1
3,206,206,5,2,3,2,1
13,206,206,25,3,22,3,2
18,223,223,7,7,0,1,0
10,269,269,103,103,0,1,0
6,277,277,23,23,0,1,0
16,295,295,25,1,24,3,2
17,300,300,21,3,18,4,3
0,305,305,42,42,0,1,0
9,347,347,23,23,0,1,0
11,349,349,91,21,70,3,2
12,369,369,21,21,0,1,0
7,410,410,19,16,3,2,1
14,410,410,11,11,0,1,0

20,123,123,15,3,12,3,2
7,157,157,3,3,0,1,0
15,164,164,52,52,0,1,0
17,189,189,2,2,0,1,0
2,191,191,19,4,15,3,2
5,231,231,6,6,0,1,0
10,237,237,29,29,0,1,0
12,249,249,14,14,0,1,0
4,251,251,22,4,18,4,3
3,266,266,71,71,0,1,0
1,268,268,39,39,0,1,0
14,317,317,44,44,0,1,0
18,335,335,68,12,56,3,2
16,346,346,1,1,0,1,0
8,356,356,65,65,0,1,0
9,379,379,4,4,0,1,0
13,397,397,12,12,0,1,0
11,412,412,94,42,52,4,3
19,414,414,1,1,0,1,0
0,444,444,9,9,0,1,0
6,478,478,58,34,24,4,3

20,107,107,11,11,0,1,0
4,118,118,3,3,0,1,0
17,132,132,22,16,6,3,2
13,149,149,5,5,0,1,0
7,155,155,4,1,3,2,1
5,166,166,23,23,0,1,0
3,171,171,6,6,0,1,0
19,172,172,9,5,4,2,1
1,179,179,1,1,0,1,0
11,206,206,12,12,0,1,0
22,225,225,16,16,0,1,0
8,239,239,1,1,0,1,0
14,259,259,78,62,16,3,2
16,308,308,24,14,10,3,2
15,313,313,4,4,0,1,0
0,376,376,38,38,0,1,0
12,383,383,70,20,50,3,2
21,397,397,1,1,0,1,0
23,405,405,24,24,0,1,0
6,415,415,34,17,17,2,1
2,447,447,69,69,0,1,0
18,451,451,127,127,0,1,0
9,465,465,94,12,82,3,2
10,500,500,27,18,9,2,1

0,123,123,12,12,0,1,0
14,125,125,15,8,7,2,1
10,140,140,20,13,7,2,1
13,163,163,1,1,0,1,0
2,209,209,1,1,0,1,0
11,270,270,41,26,15,4,3
8,297,297,12,9,3,2,1
7,335,335,82,45,37,4,3
5,365,365,24,24,0,1,0
3,389,389,7,7,0,1,0
21,391,391,145,130,15,4,3
19,395,395,35,28,7,2,1
18,420,420,11,4,7,2,1
1,428,428,22,22,0,1,0
6,449,449,80,29,51,4,3
16,450,450,62,62,0,1,0
17,451,451,91,43,48,4,3
9,452,452,27,27,0,1,0
4,454,454,21,21,0,1,0
15,461,461,4,4,0,1,0
20,469,469,40,40,0,1,0
12,474,474,34,18,16,3,2

18,129,129,18,8,10,2,1
15,142,142,5,1,4,2,1
0,144,144,32,32,0,1,0
17,150,150,7,7,0,1,0
13,194,194,18,6,12,2,1
6,316,316,20,9,11,2,1
2,321,321,7,7,0,1,0
4,325,325,17,17,0,1,0
9,356,356,3,3,0,1,0
5,356,356,8,8,0,1,0
12,362,362,44,44,0,1,0
19,386,386,19,19,0,1,0
16,398,398,51,11,40,3,2
8,400,400,1,1,0,1,0
1,407,407,2,2,0,1,0
7,440,440,3,3,0,1,0
14,455,455,48,13,35,2,1
11,472,472,44,8,36,3,2
10,482,482,88,88,0,1,0
20,486,486,5,5,0,1,0
3,487,487,205,205,0,1,0
21,497,497,194,194,0,1,0

21,123,123,5,1,4,2,1
3,135,135,6,6,0,1,0
22,139,139,4,4,0,1,0
1,191,191,6,6,0,1,0
18,202,202,17,3,14,2,1
23,206,206,14,14,0,1,0
19,247,247,72,60,12,4,3
15,248,248,18,18,0,1,0
16,279,279,75,75,0,1,0
11,287,287,20,20,0,1,0
6,303,303,12,9,3,2,1
13,305,305,8,8,0,1,0
14,309,309,35,10,25,3,2
20,324,324,49,49,0,1,0
2,332,332,10,10,0,1,0
9,342,342,39,39,0,1,0
8,342,342,161,20,141,4,3
4,350,350,23,10,13,2,1
5,376,376,1,1,0,1,0
17,376,376,1,1,0,1,0
10,377,377,10,10,0,1,0
0,434,434,30,12,18,4,3
7,468,468,28,28,0,1,0
12,478,478,24,24,0,1,0

6,129,129,8,8,0,1,0
3,136,136,1,1,0,1,0
22,164,164,89,31,58,3,2
8,176,176,16,10,6,2,1
10,190,190,10,1,9,4,3
7,207,207,28,1,27,4,3
16,207,207,1,1,0,1,0
4,243,243,9,9,0,1,0
20,260,260,14,2,12,3,2
19,279,279,33,33,0,1,0
14,289,289,8,4,4,2,1
11,340,340,2,2,0,1,0
1,343,343,6,6,0,1,0
18,357,357,6,6,0,1,0
21,357,357,15,4,11,2,1
5,369,369,3,3,0,1,0
13,371,371,131,26,105,4,3
9,399,399,17,4,13,2,1
25,401,401,21,16,5,2,1
12,404,404,45,45,0,1,0
23,412,412,47,42,5,2,1
2,414,414,19,19,0,1,0
15,425,425,10,10,0,1,0
0,443,443,36,36,0,1,0
17,458,458,67,42,25,2,1
24,472,472,12,12,0,1,0

4,116,116,10,10,0,1,0
18,129,129,7,7,0,1,0
15,138,138,16,16,0,1,0
7,171,171,15,4,11,2,1
13,171,171,1,1,0,1,0
3,203,203,19,19,0,1,0
8,216,216,13,13,0,1,0
20,228,228,32,32,0,1,0
1,236,236,4,4,0,1,0
6,252,252,12,8,4,2,1
9,265,265,43,23,20,3,2
12,282,282,42,42,0,1,0
2,298,298,42,42,0,1,0
16,340,340,19,19,0,1,0
11,355,355,78,45,33,2,1
14,407,407,49,49,0,1,0
17,413,413,99,99,0,1,0
0,421,421,57,23,34,2,1
10,447,447,93,37,56,4,3
19,453,453,7,7,0,1,0
5,474,474,29,29,0,1,0

15,102,102,6,6,0,1,0
1,106,106,11,2,9,2,1
4,109,109,9,9,0,1,0
9,117,117,10,4,6,2,1
6,118,118,2,2,0,1,0
16,131,131,12,12,0,1,0
2,132,132,5,5,0,1,0
14,139,139,7,3,4,2,1
11,143,143,28,13,15,2,1
17,163,163,11,11,0,1,0
23,169,169,28,14,14,3,2
12,174,174,19,4,15,4,3
22,177,177,13,6,7,2,1
18,217,217,8,2,6,3,2
20,251,251,44,20,24,3,2
5,266,266,1,1,0,1,0
0,290,290,37,23,14,2,1
25,342,342,8,8,0,1,0
24,367,367,38,14,24,2,1
10,386,386,27,27,0,1,0
13,421,421,53,43,10,2,1
7,425,425,7,1,6,3,2
21,481,481,67,67,0,1,0
3,484,484,1,1,0,1,0
8,491,491,10,10,0,1,0
19,498,498,117,85,32,2,1

15,108,108,2,2,0,1,0
13,134,134,6,6,0,1,0
5,136,136,3,3,0,1,0
8,159,159,18,1,17,2,1
11,168,168,22,10,12,2,1
4,178,178,17,17,0,1,0
2,191,191,22,3,19,3,2
1,224,224,59,44,15,2,1
18,225,225,10,2,8,3,2
7,254,254,15,15,0,1,0
21,259,259,114,114,0,1,0
0,273,273,7,7,0,1,0
10,286,286,27,27,0,1,0
3,295,295,35,4,31,2,1
12,371,371,52,52,0,1,0
17,389,389,41,41,0,1,0
16,393,393,41,31,10,2,1
14,397,397,10,2,8,2,1
19,423,423,78,45,33,2,1
20,434,434,7,2,5,2,1
6,471,471,17,2,15,4,3
9,480,480,14,14,0,1,0

9,111,111,12,12,0,1,0
27,112,112,29,15,14,3,2
13,124,124,15,15,0,1,0
0,129,129,1,1,0,1,0
19,130,130,1,1,0,1,0
7,138,138,17,5,12,2,1
29,146,146,19,3,16,3,2
3,166,166,10,10,0,1,0
21,173,173,34,34,0,1,0
4,195,195,6,6,0,1,0
5,198,198,19,8,11,2,1
25,209,209,12,12,0,1,0
8,258,258,1,1,0,1,0
6,263,263,2,2,0,1,0
18,275,275,34,34,0,1,0
1,335,335,8,8,0,1,0
16,339,339,17,8,9,2,1
15,348,348,6,6,0,1,0
11,362,362,4,4,0,1,0
20,368,368,58,58,0,1,0
2,379,379,22,22,0,1,0
14,395,395,27,27,0,1,0
28,397,397,15,15,0,1,0
22,404,404,67,19,48,2,1
12,405,405,4,1,3,2,1
10,423,423,56,56,0,1,0
26,423,423,10,10,0,1,0
23,429,429,4,4,0,1,0
17,456,456,20,20,0,1,0
24,483,483,42,42,0,1,0

19,124,124,1,1,0,1,0
0,127,127,1,1,0,1,0
3,177,177,6,6,0,1,0
1,183,183,18,18,0,1,0
12,191,191,44,5,39,4,3
20,197,197,29,8,21,2,1
6,198,198,13,1,12,3,2
17,202,202,5,5,0,1,0
5,243,243,17,5,12,4,3
16,245,245,17,2,15,2,1
14,289,289,6,6,0,1,0
18,289,289,59,44,15,2,1
2,290,290,43,43,0,1,0
9,363,363,31,31,0,1,0
7,366,366,1,1,0,1,0
21,410,410,25,12,13,2,1
13,442,442,5,5,0,1,0
8,442,442,24,24,0,1,0
15,447,447,151,52,99,4,3
10,465,465,134,90,44,3,2
11,466,466,51,51,0,1,0
4,466,466,64,28,36,4,3

14,161,161,7,7,0,1,0
10,176,176,12,1,11,2,1
23,191,191,45,27,18,3,2
1,193,193,26,26,0,1,0
8,221,221,3,3,0,1,0
0,247,247,13,13,0,1,0
17,274,274,24,19,5,2,1
4,275,275,8,8,0,1,0
7,279,279,2,2,0,1,0
6,298,298,11,11,0,1,0
2,302,302,12,4,8,2,1
25,304,304,20,2,18,3,2
13,313,313,11,11,0,1,0
9,323,323,11,7,4,2,1
21,326,326,18,10,8,3,2
15,335,335,11,11,0,1,0
18,347,347,9,2,7,3,2
22,368,368,24,24,0,1,0
12,378,378,18,18,0,1,0
19,389,389,9,9,0,1,0
16,411,411,40,40,0,1,0
11,416,416,1,1,0,1,0
3,428,428,145,71,74,3,2
20,439,439,78,56,22,4,3
26,457,457,32,3,29,3,2
5,466,466,1,1,0,1,0
27,469,469,49,13,36,4,3
24,476,476,138,126,12,4,3

8,100,100,5,5,0,1,0
11,110,110,15,15,0,1,0
18,130,130,39,39,0,1,0
13,133,133,5,5,0,1,0
10,167,167,28,5,23,4,3
14,167,167,12,1,11,2,1
12,168,168,11,11,0,1,0
3,179,179,83,83,0,1,0
2,221,221,1,1,0,1,0
7,248,248,3,3,0,1,0
16,256,256,20,11,9,4,3
9,267,267,5,5,0,1,0
17,315,315,52,30,22,3,2
1,321,321,2,2,0,1,0
15,351,351,58,58,0,1,0
5,361,361,6,6,0,1,0
0,373,373,32,20,12,3,2
6,419,419,53,53,0,1,0
21,433,433,45,36,9,4,3
19,442,442,17,17,0,1,0
4,483,483,8,8,0,1,0
20,496,496,47,5,42,2,1

5,100,100,4,4,0,1,0
11,100,100,2,2,0,1,0
3,122,122,12,3,9,2,1
8,163,163,20,6,14,2,1
6,186,186,60,60,0,1,0
10,210,210,15,15,0,1,0
0,291,291,19,19,0,1,0
7,311,311,6,6,0,1,0
15,335,335,40,40,0,1,0
2,445,445,102,78,24,4,3
13,461,461,84,60,24,4,3
14,464,464,38,2,36,2,1
12,474,474,99,43,56,3,2
4,482,482,47,47,0,1,0
9,496,496,46,46,0,1,0
16,499,499,103,94,9,4,3
1,500,500,125,125,0,1,0

8,152,152,29,29,0,1,0
9,184,184,13,13,0,1,0
1,187,187,19,19,0,1,0
3,193,193,1,1,0,1,0
13,196,196,34,3,31,2,1
18,200,200,4,1,3,2,1
17,212,212,6,6,0,1,0
19,223,223,3,3,0,1,0
4,237,237,38,17,21,2,1
6,289,289,42,18,24,4,3
5,294,294,46,4,42,3,2
20,305,305,18,18,0,1,0
7,324,324,23,23,0,1,0
10,367,367,63,52,11,2,1
11,373,373,88,88,0,1,0
12,383,383,46,46,0,1,0
14,399,399,133,133,0,1,0
0,439,439,11,11,0,1,0
16,447,447,27,27,0,1,0
15,452,452,31,31,0,1,0
2,498,498,1,1,0,1,0

8,101,101,1,1,0,1,0
17,106,106,28,28,0,1,0
10,129,129,3,3,0,1,0
16,136,136,23,3,20,2,1
12,145,145,1,1,0,1,0
22,156,156,33,3,30,2,1
21,158,158,10,4,6,2,1
9,165,165,10,10,0,1,0
3,178,178,26,11,15,2,1
6,183,183,6,6,0,1,0
26,188,188,29,29,0,1,0
18,277,277,9,9,0,1,0
2,301,301,18,18,0,1,0
24,314,314,6,6,0,1,0
13,315,315,7,7,0,1,0
4,318,318,47,3,44,3,2
0,322,322,33,26,7,2,1
1,342,342,25,13,12,2,1
23,346,346,29,1,28,2,1
14,352,352,17,17,0,1,0
7,407,407,17,7,10,3,2
19,426,426,47,29,18,3,2
15,431,431,14,14,0,1,0
20,437,437,49,7,42,2,1
25,458,458,34,34,0,1,0
11,463,463,47,25,22,4,3
5,467,467,12,8,4,2,1

0,110,110,1,1,0,1,0
14,110,110,4,4,0,1,0
26,132,132,4,4,0,1,0
17,133,133,1,1,0,1,0
18,145,145,2,2,0,1,0
4,149,149,16,16,0,1,0
27,158,158,27,27,0,1,0
2,170,170,12,12,0,1,0
8,178,178,4,1,3,2,1
20,179,179,11,5,6,3,2
5,191,191,3,3,0,1,0
1,198,198,17,17,0,1,0
7,201,201,3,3,0,1,0
12,207,207,7,7,0,1,0
24,248,248,14,4,10,2,1
21,257,257,31,17,14,3,2
15,327,327,45,45,0,1,0
3,330,330,9,9,0,1,0
23,356,356,83,15,68,3,2
10,369,369,21,21,0,1,0
13,379,379,1,1,0,1,0
25,395,395,29,29,0,1,0
19,413,413,36,36,0,1,0
9,423,423,11,5,6,2,1
22,442,442,45,32,13,4,3
28,452,452,82,37,45,4,3
11,458,458,79,67,12,3,2
16,462,462,95,56,39,2,1
6,475,475,26,2,24,4,3

15,120,120,12,1,11,2,1
17,157,157,12,12,0,1,0
7,192,192,33,33,0,1,0
4,199,199,40,16,24,2,1
2,246,246,1,1,0,1,0
14,255,255,37,27,10,4,3
0,256,256,77,2,75,4,3
3,261,261,7,1,6,3,2
1,267,267,6,6,0,1,0
12,269,269,14,1,13,2,1
11,309,309,26,26,0,1,0
9,337,337,77,39,38,3,2
5,360,360,87,87,0,1,0
8,388,388,34,27,7,2,1
16,395,395,139,28,111,4,3
13,424,424,12,6,6,2,1
18,461,461,18,5,13,4,3
6,479,479,21,14,7,2,1
10,490,490,3,3,0,1,0

7,101,101,10,4,6,2,1
2,134,134,12,12,0,1,0
17,167,167,12,12,0,1,0
3,202,202,55,3,52,3,2
8,219,219,8,8,0,1,0
11,231,231,13,5,8,2,1
12,246,246,49,49,0,1,0
5,254,254,37,37,0,1,0
4,273,273,13,2,11,2,1
1,303,303,51,51,0,1,0
15,343,343,90,80,10,2,1
9,347,347,13,13,0,1,0
0,353,353,85,19,66,4,3
14,358,358,13,13,0,1,0
16,371,371,47,8,39,2,1
10,404,404,52,52,0,1,0
13,424,424,69,69,0,1,0
6,432,432,20,20,0,1,0

19,124,124,1,1,0,1,0
16,140,140,5,5,0,1,0
12,141,141,14,14,0,1,0
2,171,171,23,19,4,2,1
17,183,183,17,17,0,1,0
0,190,190,14,5,9,4,3
11,201,201,59,35,24,3,2
14,209,209,10,2,8,3,2
18,224,224,2,2,0,1,0
13,238,238,5,5,0,1,0
9,259,259,1,1,0,1,0
10,283,283,103,103,0,1,0
4,327,327,2,2,0,1,0
6,335,335,29,29,0,1,0
8,417,417,46,43,3,2,1
7,439,439,42,38,4,2,1
15,456,456,65,65,0,1,0
3,481,481,100,26,74,3,2
1,494,494,77,11,66,4,3
5,494,494,112,88,24,4,3

2,102,102,3,3,0,1,0
6,110,110,2,2,0,1,0
7,125,125,2,2,0,1,0
12,194,194,22,7,15,2,1
4,201,201,1,1,0,1,0
1,223,223,26,8,18,3,2
13,233,233,32,32,0,1,0
10,236,236,46,4,42,4,3
23,256,256,13,13,0,1,0
8,265,265,6,6,0,1,0
11,280,280,11,2,9,2,1
18,295,295,20,5,15,2,1
17,308,308,21,21,0,1,0
14,310,310,53,53,0,1,0
22,318,318,8,4,4,2,1
0,327,327,28,28,0,1,0
19,340,340,8,8,0,1,0
21,347,347,21,3,18,2,1
16,393,393,94,37,57,4,3
20,422,422,147,147,0,1,0
15,431,431,25,25,0,1,0
5,472,472,92,58,34,2,1
3,490,490,7,3,4,2,1
9,496,496,56,56,0,1,0

20,104,104,6,6,0,1,0
17,107,107,2,2,0,1,0
19,130,130,19,10,9,4,3
15,160,160,19,19,0,1,0
5,165,165,1,1,0,1,0
9,170,170,1,1,0,1,0
23,171,171,28,28,0,1,0
1,183,183,2,2,0,1,0
8,219,219,10,10,0,1,0
4,240,240,16,16,0,1,0
12,274,274,42,32,10,3,2
13,282,282,66,10,56,3,2
21,293,293,58,15,43,3,2
10,296,296,10,10,0,1,0
6,304,304,17,17,0,1,0
2,319,319,15,15,0,1,0
22,355,355,16,6,10,3,2
7,386,386,2,2,0,1,0
16,396,396,47,47,0,1,0
3,424,424,45,5,40,3,2
18,432,432,96,24,72,4,3
0,446,446,34,34,0,1,0
11,446,446,114,98,16,3,2
14,446,446,14,1,13,2,1

6,107,107,33,20,13,2,1
15,122,122,3,3,0,1,0
13,137,137,21,18,3,2,1
9,159,159,14,14,0,1,0
5,177,177,16,6,10,3,2
1,197,197,5,5,0,1,0
17,205,205,8,8,0,1,0
12,213,213,26,22,4,2,1
11,229,229,1,1,0,1,0
2,257,257,45,21,24,4,3
18,266,266,84,37,47,2,1
3,311,311,2,2,0,1,0
10,340,340,17,17,0,1,0
19,388,388,98,93,5,2,1
21,401,401,33,29,4,2,1
8,433,433,39,39,0,1,0
20,448,448,19,7,12,2,1
0,458,458,1,1,0,1,0
16,473,473,37,15,22,2,1
7,478,478,62,42,20,3,2
4,484,484,64,40,24,4,3
14,488,488,5,5,0,1,0

1,106,106,19,5,14,2,1
12,128,128,5,5,0,1,0
0,184,184,18,11,7,3,2
20,186,186,55,49,6,3,2
6,187,187,21,21,0,1,0
9,203,203,15,15,0,1,0
7,218,218,22,6,16,2,1
8,219,219,31,12,19,2,1
19,233,233,32,32,0,1,0
15,247,247,2,2,0,1,0
10,264,264,13,13,0,1,0
4,279,279,24,2,22,3,2
2,320,320,5,5,0,1,0
14,324,324,10,10,0,1,0
18,356,356,44,44,0,1,0
17,358,358,13,13,0,1,0
5,406,406,84,84,0,1,0
13,416,416,164,83,81,4,3
16,440,440,22,19,3,2,1
3,445,445,17,17,0,1,0
11,482,482,1,1,0,1,0

15,121,121,3,3,0,1,0
0,134,134,1,1,0,1,0
1,153,153,10,3,7,2,1
14,173,173,2,2,0,1,0
6,208,208,13,13,0,1,0
11,209,209,46,41,5,2,1
22,215,215,7,7,0,1,0
5,245,245,23,23,0,1,0
21,267,267,18,18,0,1,0
24,276,276,43,43,0,1,0
25,278,278,17,17,0,1,0
23,279,279,14,1,13,2,1
26,280,280,21,1,20,3,2
3,281,281,23,6,17,2,1
20,294,294,43,43,0,1,0
18,351,351,56,56,0,1,0
17,394,394,91,91,0,1,0
7,397,397,11,2,9,2,1
2,420,420,43,43,0,1,0
19,434,434,59,33,26,2,1
13,446,446,15,3,12,4,3
4,451,451,30,30,0,1,0
8,471,471,1,1,0,1,0
16,478,478,110,110,0,1,0
9,480,480,5,5,0,1,0
12,490,490,24,6,18,2,1
10,490,490,6,6,0,1,0

1,144,144,1,1,0,1,0
21,146,146,31,31,0,1,0
13,154,154,13,13,0,1,0
23,155,155,66,3,63,4,3
4,161,161,25,25,0,1,0
7,202,202,20,2,18,3,2
5,222,222,12,2,10,2,1
8,223,223,14,14,0,1,0
14,233,233,44,44,0,1,0
3,271,271,4,4,0,1,0
11,290,290,9,6,3,2,1
15,293,293,13,8,5,2,1
22,298,298,1,1,0,1,0
10,302,302,4,4,0,1,0
9,327,327,25,10,15,2,1
2,361,361,64,14,50,2,1
24,377,377,6,6,0,1,0
0,397,397,30,30,0,1,0
19,425,425,22,22,0,1,0
12,438,438,17,17,0,1,0
18,445,445,31,31,0,1,0
20,453,453,21,4,17,2,1
17,481,481,106,24,82,4,3
16,484,484,13,2,11,4,3
6,491,491,11,3,8,3,2

9,100,100,9,1,8,3,2
4,100,100,1,1,0,1,0
27,107,107,17,17,0,1,0
24,114,114,7,7,0,1,0
5,126,126,7,1,6,2,1
12,155,155,27,27,0,1,0
16,162,162,1,1,0,1,0
22,178,178,3,3,0,1,0
6,179,179,13,2,11,4,3
1,181,181,6,1,5,2,1
3,237,237,31,31,0,1,0
18,244,244,2,2,0,1,0
0,265,265,11,7,4,2,1
23,295,295,38,28,10,3,2
19,317,317,43,43,0,1,0
20,317,317,64,15,49,3,2
11,322,322,1,1,0,1,0
17,356,356,3,3,0,1,0
8,366,366,23,23,0,1,0
13,369,369,3,3,0,1,0
25,412,412,70,70,0,1,0
14,418,418,23,23,0,1,0
7,424,424,59,59,0,1,0
10,430,430,1,1,0,1,0
2,460,460,9,6,3,2,1
26,460,460,45,33,12,4,3
21,487,487,70,70,0,1,0
15,496,496,94,57,37,2,1

4,117,117,33,14,19,2,1
13,139,139,16,16,0,1,0
20,140,140,27,1,26,2,1
0,145,145,11,11,0,1,0
15,174,174,8,2,6,3,2
5,202,202,8,1,7,2,1
6,227,227,3,3,0,1,0
1,242,242,23,23,0,1,0
14,247,247,3,3,0,1,0
8,249,249,6,1,5,2,1
3,258,258,32,32,0,1,0
19,271,271,6,2,4,2,1
9,284,284,78,29,49,2,1
2,284,284,19,2,17,3,2
11,292,292,42,42,0,1,0
18,357,357,28,23,5,2,1
7,372,372,31,31,0,1,0
10,419,419,9,2,7,2,1
12,429,429,79,79,0,1,0
16,434,434,17,17,0,1,0
17,440,440,125,85,40,3,2

7,126,126,22,22,0,1,0
14,147,147,21,12,9,2,1
15,181,181,45,45,0,1,0
4,191,191,48,48,0,1,0
5,229,229,26,18,8,2,1
0,253,253,9,9,0,1,0
8,282,282,15,15,0,1,0
13,339,339,25,4,21,2,1
11,346,346,30,3,27,4,3
10,351,351,36,21,15,2,1
6,395,395,105,7,98,3,2
3,426,426,54,39,15,2,1
2,433,433,68,68,0,1,0
12,436,436,34,10,24,4,3
16,441,441,49,49,0,1,0
9,457,457,21,21,0,1,0
1,487,487,74,24,50,4,3

15,100,100,12,12,0,1,0
18,165,165,40,13,27,4,3
4,177,177,2,2,0,1,0
0,188,188,5,5,0,1,0
20,193,193,34,14,20,3,2
10,202,202,36,7,29,2,1
16,210,210,10,4,6,2,1
3,223,223,66,66,0,1,0
13,226,226,8,8,0,1,0
2,295,295,4,4,0,1,0
1,326,326,94,72,22,3,2
5,339,339,21,21,0,1,0
19,377,377,34,34,0,1,0
11,378,378,51,51,0,1,0
17,380,380,17,17,0,1,0
14,384,384,22,10,12,3,2
8,389,389,44,44,0,1,0
9,394,394,5,5,0,1,0
12,406,406,71,13,58,3,2
6,446,446,7,7,0,1,0
7,457,457,40,8,32,4,3

11,100,100,5,5,0,1,0
13,105,105,5,5,0,1,0
20,131,131,55,48,7,2,1
6,134,134,32,32,0,1,0
22,161,161,17,17,0,1,0
15,197,197,12,2,10,3,2
0,216,216,28,28,0,1,0
2,220,220,20,20,0,1,0
10,221,221,28,28,0,1,0
5,222,222,2,2,0,1,0
3,275,275,13,13,0,1,0
12,276,276,9,9,0,1,0
8,292,292,21,21,0,1,0
4,321,321,64,7,57,3,2
16,334,334,18,18,0,1,0
14,349,349,43,43,0,1,0
7,377,377,1,1,0,1,0
1,380,380,4,4,0,1,0
21,400,400,5,1,4,2,1
9,405,405,38,38,0,1,0
18,466,466,51,51,0,1,0
19,476,476,35,35,0,1,0
17,498,498,52,52,0,1,0

24,104,104,13,13,0,1,0
8,108,108,3,3,0,1,0
4,112,112,7,7,0,1,0
7,184,184,33,33,0,1,0
15,199,199,26,8,18,3,2
11,201,201,12,6,6,3,2
1,230,230,6,6,0,1,0
20,233,233,26,26,0,1,0
6,269,269,11,3,8,3,2
19,284,284,5,5,0,1,0
13,286,286,32,32,0,1,0
23,289,289,100,22,78,3,2
3,294,294,6,6,0,1,0
21,309,309,3,3,0,1,0
0,326,326,32,32,0,1,0
22,357,357,2,2,0,1,0
14,361,361,73,61,12,2,1
5,406,406,13,13,0,1,0
10,413,413,18,18,0,1,0
12,425,425,49,20,29,3,2
2,460,460,33,33,0,1,0
9,464,464,4,4,0,1,0
17,474,474,1,1,0,1,0
18,480,480,147,106,41,2,1
16,497,497,34,34,0,1,0

6,106,106,17,17,0,1,0
23,116,116,9,9,0,1,0
20,122,122,27,12,15,3,2
10,141,141,1,1,0,1,0
22,141,141,26,26,0,1,0
3,143,143,22,22,0,1,0
11,157,157,6,6,0,1,0
2,199,199,45,45,0,1,0
1,203,203,2,2,0,1,0
19,220,220,5,5,0,1,0
16,332,332,18,18,0,1,0
15,350,350,47,47,0,1,0
13,353,353,6,6,0,1,0
18,361,361,6,2,4,2,1
4,365,365,4,1,3,2,1
12,407,407,48,24,24,3,2
21,421,421,61,61,0,1,0
7,437,437,61,30,31,4,3
17,461,461,24,4,20,3,2
5,478,478,44,39,5,2,1
14,484,484,105,87,18,2,1
0,484,484,6,6,0,1,0
9,486,486,51,39,12,2,1
8,498,498,5,2,3,2,1

21,127,127,14,14,0,1,0
19,131,131,11,11,0,1,0
7,140,140,14,14,0,1,0
12,195,195,16,8,8,3,2
22,198,198,103,103,0,1,0
6,205,205,10,10,0,1,0
5,266,266,39,13,26,3,2
8,300,300,16,3,13,2,1
13,310,310,10,10,0,1,0
0,321,321,19,13,6,2,1
20,333,333,20,10,10,3,2
11,383,383,32,32,0,1,0
14,403,403,19,14,5,2,1
4,419,419,18,18,0,1,0
9,420,420,18,9,9,4,3
15,431,431,26,5,21,4,3
16,431,431,13,2,11,3,2
18,439,439,70,70,0,1,0
2,448,448,21,21,0,1,0
17,454,454,15,3,12,4,3
1,470,470,15,15,0,1,0
3,478,478,99,99,0,1,0
10,490,490,61,1,60,3,2
23,492,492,6,6,0,1,0

17,147,147,3,3,0,1,0
13,168,168,60,60,0,1,0
1,211,211,66,32,34,2,1
11,213,213,4,4,0,1,0
3,216,216,39,39,0,1,0
15,244,244,1,1,0,1,0
4,273,273,98,4,94,3,2
19,306,306,27,27,0,1,0
12,319,319,27,27,0,1,0
21,343,343,14,8,6,2,1
18,349,349,79,79,0,1,0
10,350,350,9,9,0,1,0
16,358,358,10,10,0,1,0
0,359,359,23,23,0,1,0
20,363,363,24,3,21,4,3
8,384,384,5,5,0,1,0
5,387,387,11,11,0,1,0
14,440,440,91,91,0,1,0
9,451,451,5,5,0,1,0
6,451,451,39,17,22,3,2
2,474,474,1,1,0,1,0
7,483,483,1,1,0,1,0

20,146,146,1,1,0,1,0
9,153,153,46,31,15,4,3
6,186,186,9,9,0,1,0
4,203,203,17,12,5,2,1
19,210,210,2,2,0,1,0
12,262,262,7,4,3,2,1
14,284,284,78,24,54,3,2
18,313,313,62,62,0,1,0
17,326,326,53,53,0,1,0
5,331,331,100,30,70,3,2
13,344,344,27,27,0,1,0
15,380,380,46,27,19,2,1
16,397,397,17,17,0,1,0
8,410,410,7,7,0,1,0
2,415,415,1,1,0,1,0
10,420,420,8,8,0,1,0
1,435,435,28,28,0,1,0
11,466,466,92,62,30,2,1
0,482,482,42,14,28,2,1
3,484,484,42,42,0,1,0
7,493,493,44,12,32,2,1

7,125,125,42,42,0,1,0
11,136,136,17,17,0,1,0
9,138,138,25,1,24,2,1
2,151,151,12,9,3,2,1
25,167,167,41,10,31,2,1
10,177,177,3,3,0,1,0
21,190,190,17,17,0,1,0
22,196,196,5,2,3,2,1
14,215,215,1,1,0,1,0
4,221,221,9,9,0,1,0
6,222,222,1,1,0,1,0
13,237,237,1,1,0,1,0
16,238,238,33,22,11,2,1
18,300,300,46,42,4,2,1
3,343,343,28,14,14,2,1
23,410,410,75,25,50,3,2
5,411,411,13,1,12,4,3
0,417,417,5,5,0,1,0
1,417,417,1,1,0,1,0
19,421,421,1,1,0,1,0
20,455,455,43,43,0,1,0
8,460,460,1,1,0,1,0
24,462,462,49,23,26,2,1
12,470,470,71,71,0,1,0
15,470,470,13,13,0,1,0
17,489,489,40,20,20,2,1

11,135,135,6,6,0,1,0
10,142,142,6,6,0,1,0
7,160,160,14,14,0,1,0
0,161,161,12,7,5,2,1
3,236,236,36,27,9,2,1
2,239,239,31,4,27,2,1
9,299,299,15,15,0,1,0
15,335,335,44,44,0,1,0
4,351,351,33,33,0,1,0
6,352,352,40,40,0,1,0
17,361,361,41,41,0,1,0
13,378,378,99,7,92,4,3
14,381,381,34,3,31,2,1
1,391,391,65,2,63,4,3
16,417,417,93,93,0,1,0
8,451,451,56,44,12,4,3
5,455,455,131,59,72,4,3
12,498,498,17,9,8,2,1

10,122,122,1,1,0,1,0
19,129,129,2,2,0,1,0
23,164,164,1,1,0,1,0
20,171,171,6,6,0,1,0
21,197,197,57,57,0,1,0
5,214,214,52,16,36,2,1
15,219,219,7,7,0,1,0
1,220,220,16,16,0,1,0
18,231,231,18,8,10,3,2
16,237,237,55,14,41,4,3
9,269,269,32,2,30,4,3
7,283,283,6,6,0,1,0
14,283,283,55,55,0,1,0
4,290,290,1,1,0,1,0
11,311,311,62,41,21,2,1
2,325,325,9,1,8,3,2
8,345,345,6,1,5,2,1
0,374,374,54,54,0,1,0
12,386,386,32,32,0,1,0
22,410,410,59,59,0,1,0
17,456,456,41,13,28,2,1
13,459,459,20,20,0,1,0
6,475,475,55,55,0,1,0
3,484,484,1,1,0,1,0

14,109,109,16,8,8,2,1
11,142,142,6,6,0,1,0
0,146,146,20,1,19,2,1
7,181,181,33,18,15,2,1
16,220,220,12,6,6,3,2
5,222,222,25,5,20,3,2
9,233,233,8,8,0,1,0
6,242,242,1,1,0,1,0
8,242,242,12,12,0,1,0
19,253,253,8,8,0,1,0
1,259,259,46,46,0,1,0
20,277,277,23,3,20,2,1
13,297,297,65,65,0,1,0
10,320,320,40,12,28,3,2
18,343,343,43,43,0,1,0
4,344,344,11,7,4,2,1
12,358,358,18,18,0,1,0
2,379,379,44,44,0,1,0
15,397,397,124,124,0,1,0
3,428,428,56,56,0,1,0
17,463,463,27,11,16,3,2

0,105,105,1,1,0,1,0
10,117,117,1,1,0,1,0
27,167,167,20,20,0,1,0
15,175,175,25,1,24,3,2
23,179,179,4,4,0,1,0
20,181,181,16,1,15,4,3
7,228,228,13,13,0,1,0
4,233,233,44,44,0,1,0
14,242,242,2,2,0,1,0
8,246,246,21,2,19,2,1
3,247,247,35,23,12,2,1
9,262,262,3,3,0,1,0
19,279,279,24,10,14,2,1
1,334,334,63,33,30,4,3
6,341,341,8,8,0,1,0
22,354,354,37,37,0,1,0
11,354,354,9,9,0,1,0
25,354,354,97,97,0,1,0
2,375,375,29,29,0,1,0
18,381,381,4,4,0,1,0
13,390,390,5,5,0,1,0
12,424,424,15,3,12,3,2
24,434,434,19,12,7,2,1
21,444,444,9,9,0,1,0
26,451,451,155,155,0,1,0
5,459,459,2,2,0,1,0
16,490,490,11,11,0,1,0
17,494,494,28,21,7,2,1

22,103,103,2,2,0,1,0
3,119,119,10,1,9,2,1
19,133,133,5,5,0,1,0
1,148,148,7,7,0,1,0
20,168,168,41,41,0,1,0
6,181,181,9,1,8,2,1
11,183,183,6,6,0,1,0
8,184,184,17,2,15,2,1
14,235,235,14,14,0,1,0
12,238,238,1,1,0,1,0
21,262,262,10,10,0,1,0
5,313,313,40,1,39,4,3
4,343,343,22,8,14,3,2
0,346,346,52,36,16,2,1
16,351,351,119,119,0,1,0
2,363,363,36,36,0,1,0
13,374,374,2,2,0,1,0
7,375,375,60,60,0,1,0
15,379,379,30,30,0,1,0
10,387,387,17,17,0,1,0
9,412,412,58,58,0,1,0
23,440,440,109,19,90,4,3
17,462,462,14,1,13,2,1
18,499,499,12,12,0,1,0

6,159,159,11,3,8,2,1
13,162,162,21,21,0,1,0
1,180,180,9,9,0,1,0
9,209,209,2,2,0,1,0
11,211,211,14,3,11,2,1
10,224,224,11,3,8,2,1
3,226,226,9,9,0,1,0
7,230,230,59,39,20,3,2
15,237,237,12,4,8,2,1
17,243,243,6,6,0,1,0
5,247,247,21,21,0,1,0
14,264,264,98,56,42,4,3
4,341,341,120,102,18,2,1
18,348,348,9,3,6,2,1
8,379,379,25,13,12,4,3
2,405,405,27,12,15,4,3
0,471,471,55,51,4,2,1
16,480,480,18,3,15,2,1
12,498,498,177,62,115,4,3

12,138,138,5,5,0,1,0
9,184,184,19,14,5,2,1
6,195,195,19,19,0,1,0
10,235,235,30,30,0,1,0
7,245,245,22,22,0,1,0
4,290,290,31,31,0,1,0
14,302,302,24,6,18,4,3
15,337,337,1,1,0,1,0
5,350,350,55,1,54,4,3
11,359,359,15,6,9,4,3
16,372,372,99,49,50,2,1
0,378,378,1,1,0,1,0
1,404,404,102,102,0,1,0
3,413,413,180,176,4,2,1
2,446,446,23,10,13,2,1
13,478,478,166,24,142,4,3
8,491,491,12,12,0,1,0

15,144,144,1,1,0,1,0
3,172,172,24,10,14,2,1
9,183,183,5,5,0,1,0
22,225,225,21,12,9,2,1
10,226,226,5,5,0,1,0
7,231,231,4,4,0,1,0
5,244,244,21,21,0,1,0
16,249,249,39,39,0,1,0
6,309,309,3,3,0,1,0
11,314,314,21,1,20,2,1
14,314,314,123,59,64,4,3
13,317,317,1,1,0,1,0
19,320,320,33,9,24,4,3
4,362,362,5,5,0,1,0
12,375,375,80,80,0,1,0
8,379,379,154,130,24,2,1
2,390,390,16,7,9,4,3
18,429,429,1,1,0,1,0
21,440,440,87,66,21,4,3
0,451,451,17,7,10,3,2
17,451,451,49,32,17,3,2
20,473,473,15,15,0,1,0
1,478,478,9,3,6,3,2
23,492,492,13,13,0,1,0

5,112,112,47,42,5,2,1
7,112,112,4,4,0,1,0
13,116,116,33,18,15,4,3
14,122,122,18,10,8,3,2
9,133,133,6,6,0,1,0
4,163,163,28,10,18,2,1
15,173,173,20,20,0,1,0
11,195,195,27,9,18,3,2
3,212,212,32,14,18,4,3
8,218,218,7,1,6,2,1
6,266,266,13,13,0,1,0
0,294,294,22,22,0,1,0
1,401,401,70,8,62,4,3
12,410,410,67,41,26,3,2
2,415,415,47,2,45,4,3
10,495,495,57,24,33,4,3

4,143,143,21,21,0,1,0
17,148,148,48,48,0,1,0
1,243,243,116,84,32,2,1
13,267,267,5,5,0,1,0
8,271,271,9,9,0,1,0
14,295,295,121,77,44,2,1
15,341,341,8,8,0,1,0
11,344,344,22,8,14,3,2
9,374,374,3,3,0,1,0
10,400,400,28,22,6,2,1
16,403,403,35,35,0,1,0
2,433,433,19,19,0,1,0
5,435,435,94,54,40,3,2
3,442,442,57,57,0,1,0
0,447,447,10,10,0,1,0
12,468,468,37,37,0,1,0
6,474,474,22,17,5,2,1
7,480,480,9,2,7,2,1

5,129,129,25,17,8,3,2
6,139,139,9,9,0,1,0
0,149,149,8,8,0,1,0
14,153,153,35,8,27,2,1
8,159,159,40,40,0,1,0
16,165,165,5,5,0,1,0
22,213,213,14,14,0,1,0
13,220,220,3,3,0,1,0
19,250,250,17,17,0,1,0
2,253,253,8,3,5,2,1
7,266,266,51,51,0,1,0
12,281,281,2,2,0,1,0
10,324,324,8,8,0,1,0
21,336,336,27,1,26,3,2
9,341,341,4,4,0,1,0
15,376,376,7,7,0,1,0
1,433,433,1,1,0,1,0
20,455,455,139,88,51,4,3
17,462,462,101,17,84,3,2
18,465,465,16,16,0,1,0
23,471,471,34,16,18,2,1
11,473,473,79,15,64,3,2
4,478,478,38,4,34,3,2
3,491,491,5,5,0,1,0

2,114,114,6,6,0,1,0
4,134,134,20,20,0,1,0
9,154,154,16,1,15,2,1
17,158,158,23,15,8,2,1
12,178,178,23,23,0,1,0
13,199,199,16,16,0,1,0
5,214,214,5,5,0,1,0
6,221,221,11,11,0,1,0
11,232,232,53,17,36,4,3
3,243,243,20,20,0,1,0
1,253,253,14,6,8,2,1
8,264,264,9,9,0,1,0
20,319,319,92,92,0,1,0
16,328,328,9,9,0,1,0
0,338,338,41,41,0,1,0
7,344,344,33,25,8,3,2
10,354,354,37,16,21,4,3
19,371,371,5,5,0,1,0
18,390,390,55,55,0,1,0
15,405,405,101,83,18,4,3
14,440,440,10,10,0,1,0
21,447,447,11,11,0,1,0

4,108,108,1,1,0,1,0
10,117,117,40,13,27,4,3
3,128,128,30,26,4,2,1
2,214,214,92,92,0,1,0
11,217,217,10,10,0,1,0
0,230,230,22,22,0,1,0
6,289,289,1,1,0,1,0
9,308,308,31,11,20,3,2
16,322,322,13,13,0,1,0
13,349,349,15,15,0,1,0
1,377,377,3,3,0,1,0
8,379,379,39,13,26,2,1
15,393,393,16,5,11,2,1
7,408,408,19,2,17,2,1
5,412,412,132,132,0,1,0
12,433,433,94,42,52,3,2
14,492,492,65,65,0,1,0

17,136,136,10,10,0,1,0
9,207,207,12,12,0,1,0
1,240,240,50,50,0,1,0
7,242,242,11,11,0,1,0
11,245,245,18,18,0,1,0
4,268,268,61,61,0,1,0
15,303,303,10,2,8,3,2
6,315,315,18,18,0,1,0
5,348,348,68,15,53,4,3
8,349,349,86,86,0,1,0
19,352,352,3,3,0,1,0
0,374,374,5,1,4,2,1
2,379,379,16,16,0,1,0
10,387,387,83,16,67,4,3
14,396,396,45,45,0,1,0
16,401,401,129,87,42,4,3
12,437,437,72,72,0,1,0
18,468,468,6,6,0,1,0
13,471,471,47,47,0,1,0
3,474,474,3,3,0,1,0

2,110,110,8,1,7,2,1
8,131,131,32,32,0,1,0
4,158,158,52,52,0,1,0
13,161,161,10,2,8,3,2
0,197,197,34,13,21,2,1
12,216,216,39,39,0,1,0
6,284,284,38,38,0,1,0
9,295,295,24,8,16,3,2
5,344,344,8,3,5,2,1
7,349,349,24,24,0,1,0
11,377,377,12,2,10,3,2
15,401,401,42,20,22,2,1
1,420,420,6,3,3,2,1
3,430,430,210,210,0,1,0
14,435,435,4,4,0,1,0
10,454,454,92,46,46,2,1

4,163,163,41,41,0,1,0
7,178,178,20,2,18,4,3
16,189,189,7,7,0,1,0
15,196,196,2,2,0,1,0
23,217,217,5,5,0,1,0
13,225,225,9,9,0,1,0
6,247,247,1,1,0,1,0
0,279,279,3,3,0,1,0
21,294,294,45,45,0,1,0
11,305,305,14,10,4,2,1
1,310,310,47,47,0,1,0
8,311,311,27,27,0,1,0
19,330,330,5,5,0,1,0
9,345,345,46,7,39,4,3
14,354,354,14,14,0,1,0
12,382,382,6,6,0,1,0
3,422,422,18,18,0,1,0
2,477,477,47,47,0,1,0
5,481,481,16,16,0,1,0
17,484,484,165,83,82,3,2
20,487,487,48,42,6,2,1
22,490,490,170,159,11,2,1
18,497,497,27,27,0,1,0
10,500,500,37,11,26,2,1

0,110,110,15,15,0,1,0
15,111,111,18,18,0,1,0
19,134,134,31,31,0,1,0
2,143,143,2,2,0,1,0
6,148,148,23,23,0,1,0
17,153,153,4,1,3,2,1
20,160,160,2,2,0,1,0
4,165,165,5,2,3,2,1
21,193,193,46,13,33,4,3
12,314,314,30,10,20,3,2
9,321,321,21,21,0,1,0
7,326,326,5,1,4,2,1
11,333,333,10,1,9,2,1
10,334,334,70,3,67,4,3
3,359,359,8,1,7,2,1
8,409,409,17,6,11,2,1
14,413,413,26,8,18,4,3
1,435,435,65,47,18,2,1
18,447,447,47,24,23,2,1
13,466,466,32,10,22,3,2
16,478,478,55,37,18,3,2
5,499,499,116,60,56,4,3

16,104,104,7,7,0,1,0
11,112,112,11,1,10,3,2
9,118,118,4,4,0,1,0
6,137,137,18,18,0,1,0
8,142,142,37,21,16,3,2
19,164,164,6,6,0,1,0
5,179,179,24,17,7,2,1
17,180,180,31,31,0,1,0
7,194,194,15,10,5,2,1
0,239,239,2,2,0,1,0
18,266,266,1,1,0,1,0
10,295,295,71,39,32,3,2
20,319,319,14,14,0,1,0
3,339,339,10,5,5,2,1
12,363,363,44,7,37,2,1
15,371,371,172,143,29,2,1
14,372,372,22,4,18,3,2
13,447,447,30,9,21,4,3
4,454,454,70,26,44,3,2
1,468,468,14,2,12,3,2
2,484,484,1,1,0,1,0

23,100,100,6,3,3,2,1
18,116,116,6,6,0,1,0
13,119,119,7,1,6,2,1
17,123,123,21,1,20,3,2
21,125,125,31,11,20,3,2
1,132,132,5,2,3,2,1
6,184,184,4,4,0,1,0
3,184,184,35,35,0,1,0
19,195,195,31,8,23,2,1
2,241,241,15,12,3,2,1
16,253,253,20,20,0,1,0
5,256,256,18,9,9,2,1
20,267,267,3,3,0,1,0
11,292,292,13,13,0,1,0
10,306,306,93,93,0,1,0
12,358,358,1,1,0,1,0
4,390,390,1,1,0,1,0
22,394,394,40,16,24,2,1
8,409,409,13,13,0,1,0
15,416,416,1,1,0,1,0
14,438,438,75,37,38,3,2
0,454,454,3,3,0,1,0
9,467,467,29,29,0,1,0
24,482,482,117,12,105,4,3
7,486,486,17,17,0,1,0

10,109,109,13,13,0,1,0
1,139,139,21,13,8,2,1
7,152,152,3,3,0,1,0
14,153,153,5,5,0,1,0
25,160,160,1,1,0,1,0
13,160,160,9,9,0,1,0
22,165,165,27,3,24,3,2
24,168,168,11,2,9,2,1
5,191,191,13,1,12,4,3
23,235,235,4,4,0,1,0
2,241,241,32,32,0,1,0
19,262,262,13,13,0,1,0
16,282,282,11,11,0,1,0
11,287,287,6,6,0,1,0
20,293,293,95,95,0,1,0
18,322,322,2,2,0,1,0
3,323,323,46,5,41,3,2
9,329,329,8,8,0,1,0
0,348,348,14,2,12,4,3
15,384,384,42,16,26,2,1
4,403,403,20,20,0,1,0
12,408,408,1,1,0,1,0
8,450,450,56,56,0,1,0
6,488,488,4,4,0,1,0
21,490,490,134,103,31,2,1
17,492,492,87,87,0,1,0

0,109,109,24,24,0,1,0
2,113,113,9,9,0,1,0
6,135,135,22,16,6,3,2
12,146,146,17,17,0,1,0
18,149,149,30,30,0,1,0
1,149,149,33,2,31,2,1
14,188,188,5,5,0,1,0
9,243,243,15,10,5,2,1
10,275,275,15,7,8,2,1
11,288,288,49,49,0,1,0
16,295,295,91,91,0,1,0
4,302,302,14,2,12,3,2
15,314,314,3,3,0,1,0
3,348,348,32,6,26,2,1
17,363,363,9,3,6,2,1
7,400,400,67,20,47,2,1
5,405,405,8,3,5,2,1
8,490,490,45,45,0,1,0
13,494,494,70,70,0,1,0

1,131,131,35,30,5,2,1
11,138,138,2,2,0,1,0
7,162,162,10,5,5,2,1
4,175,175,54,54,0,1,0
14,184,184,7,7,0,1,0
18,185,185,52,52,0,1,0
10,186,186,25,17,8,2,1
2,193,193,2,2,0,1,0
8,208,208,48,19,29,4,3
16,212,212,8,8,0,1,0
12,265,265,8,8,0,1,0
0,267,267,26,26,0,1,0
6,290,290,10,1,9,4,3
9,324,324,34,34,0,1,0
5,363,363,20,20,0,1,0
3,383,383,14,7,7,2,1
17,435,435,86,14,72,3,2
13,468,468,79,11,68,4,3
15,500,500,53,36,17,2,1

20,110,110,16,16,0,1,0
4,134,134,23,10,13,2,1
9,146,146,20,2,18,2,1
10,147,147,17,17,0,1,0
6,157,157,12,3,9,2,1
8,184,184,4,4,0,1,0
19,186,186,13,13,0,1,0
16,189,189,19,3,16,2,1
14,190,190,7,7,0,1,0
13,201,201,2,2,0,1,0
12,206,206,1,1,0,1,0
21,219,219,49,1,48,2,1
17,267,267,57,57,0,1,0
5,304,304,23,2,21,3,2
15,322,322,33,33,0,1,0
2,381,381,1,1,0,1,0
0,424,424,44,10,34,3,2
18,427,427,91,55,36,4,3
3,428,428,22,12,10,3,2
11,458,458,10,10,0,1,0
7,478,478,38,38,0,1,0
1,492,492,120,120,0,1,0

7,117,117,32,11,21,4,3
3,120,120,8,8,0,1,0
16,124,124,23,23,0,1,0
4,140,140,7,4,3,2,1
5,195,195,9,9,0,1,0
2,219,219,4,4,0,1,0
11,250,250,29,7,22,3,2
8,275,275,12,9,3,2,1
9,280,280,1,1,0,1,0
6,284,284,22,22,0,1,0
12,299,299,32,21,11,2,1
15,339,339,124,53,71,4,3
17,364,364,27,27,0,1,0
20,387,387,44,11,33,2,1
14,392,392,31,31,0,1,0
1,392,392,14,14,0,1,0
0,429,429,129,99,30,2,1
13,451,451,1,1,0,1,0
18,475,475,10,1,9,2,1
19,479,479,23,11,12,4,3
10,493,493,91,91,0,1,0

15,108,108,1,1,0,1,0
6,133,133,8,3,5,2,1
9,142,142,3,3,0,1,0
10,156,156,5,2,3,2,1
14,209,209,4,4,0,1,0
3,219,219,51,51,0,1,0
12,289,289,60,60,0,1,0
7,291,291,29,24,5,2,1
11,315,315,99,99,0,1,0
0,323,323,101,101,0,1,0
2,384,384,3,3,0,1,0
13,406,406,4,4,0,1,0
4,426,426,149,127,22,3,2
5,448,448,40,40,0,1,0
1,449,449,23,6,17,2,1
8,455,455,131,92,39,4,3
16,456,456,52,52,0,1,0

18,118,118,5,1,4,2,1
11,145,145,15,15,0,1,0
6,153,153,4,1,3,2,1
12,160,160,27,27,0,1,0
17,165,165,7,7,0,1,0
2,186,186,6,3,3,2,1
5,231,231,11,4,7,2,1
20,266,266,4,4,0,1,0
10,277,277,47,47,0,1,0
9,289,289,44,44,0,1,0
0,296,296,21,21,0,1,0
19,297,297,6,6,0,1,0
3,303,303,11,11,0,1,0
21,355,355,89,73,16,3,2
13,360,360,76,6,70,3,2
8,360,360,51,6,45,2,1
14,367,367,23,5,18,4,3
1,386,386,36,36,0,1,0
16,392,392,68,21,47,2,1
15,435,435,57,35,22,2,1
7,453,453,13,2,11,2,1
4,489,489,99,99,0,1,0

10,113,113,7,7,0,1,0
8,151,151,11,11,0,1,0
15,151,151,18,18,0,1,0
1,173,173,2,2,0,1,0
7,177,177,14,14,0,1,0
0,191,191,10,10,0,1,0
16,205,205,5,5,0,1,0
18,220,220,31,31,0,1,0
19,238,238,48,39,9,2,1
14,248,248,11,11,0,1,0
20,281,281,52,28,24,4,3
3,310,310,69,24,45,2,1
17,311,311,2,2,0,1,0
21,315,315,65,65,0,1,0
13,317,317,46,37,9,2,1
12,318,318,15,15,0,1,0
2,337,337,7,7,0,1,0
6,346,346,48,48,0,1,0
9,354,354,85,80,5,2,1
5,378,378,8,4,4,2,1
4,400,400,19,19,0,1,0
11,411,411,54,10,44,2,1

16,106,106,24,24,0,1,0
22,111,111,1,1,0,1,0
3,118,118,24,14,10,3,2
25,144,144,40,22,18,2,1
9,166,166,6,1,5,2,1
7,173,173,6,6,0,1,0
17,209,209,14,14,0,1,0
8,213,213,10,1,9,4,3
15,213,213,68,68,0,1,0
2,219,219,11,11,0,1,0
6,221,221,8,1,7,2,1
23,260,260,4,4,0,1,0
4,276,276,4,4,0,1,0
0,283,283,21,21,0,1,0
10,289,289,27,27,0,1,0
5,343,343,14,14,0,1,0
1,347,347,5,2,3,2,1
13,360,360,22,1,21,4,3
18,369,369,7,3,4,2,1
21,369,369,90,90,0,1,0
24,379,379,11,6,5,2,1
19,388,388,61,61,0,1,0
20,406,406,33,33,0,1,0
12,439,439,6,6,0,1,0
14,445,445,14,14,0,1,0
11,449,449,14,9,5,2,1

14,103,103,3,3,0,1,0
19,113,113,21,1,20,2,1
17,113,113,14,4,10,2,1
2,124,124,15,5,10,3,2
13,138,138,22,22,0,1,0
4,144,144,23,23,0,1,0
20,167,167,1,1,0,1,0
15,175,175,9,1,8,3,2
16,262,262,18,18,0,1,0
1,269,269,47,33,14,2,1
9,273,273,37,17,20,2,1
3,299,299,42,5,37,2,1
5,300,300,30,8,22,3,2
7,317,317,1,1,0,1,0
6,352,352,2,2,0,1,0
0,362,362,2,2,0,1,0
12,393,393,6,6,0,1,0
8,421,421,20,20,0,1,0
11,455,455,200,113,87,4,3
10,478,478,99,6,93,4,3
18,499,499,25,9,16,2,1

7,183,183,15,3,12,3,2
2,194,194,21,21,0,1,0
17,224,224,10,10,0,1,0
14,227,227,53,53,0,1,0
18,231,231,11,11,0,1,0
0,287,287,14,2,12,3,2
5,321,321,16,10,6,3,2
6,325,325,16,2,14,3,2
12,326,326,56,56,0,1,0
8,329,329,28,28,0,1,0
3,393,393,80,13,67,4,3
15,393,393,75,75,0,1,0
1,423,423,173,110,63,4,3
10,426,426,4,4,0,1,0
13,426,426,98,59,39,4,3
11,433,433,12,7,5,2,1
9,450,450,18,3,15,4,3
16,458,458,55,21,34,4,3
4,459,459,30,3,27,2,1

3,116,116,12,1,11,2,1
18,130,130,2,2,0,1,0
6,157,157,9,9,0,1,0
10,177,177,5,5,0,1,0
1,185,185,29,1,28,2,1
19,192,192,25,25,0,1,0
2,200,200,47,5,42,2,1
4,213,213,20,20,0,1,0
13,246,246,69,4,65,4,3
15,304,304,58,13,45,2,1
20,315,315,20,20,0,1,0
8,327,327,72,25,47,2,1
14,365,365,42,42,0,1,0
12,379,379,32,5,27,4,3
0,397,397,20,20,0,1,0
5,426,426,1,1,0,1,0
16,430,430,42,24,18,4,3
7,434,434,54,54,0,1,0
11,435,435,24,2,22,3,2
17,446,446,37,11,26,2,1
9,454,454,15,15,0,1,0

19,105,105,14,14,0,1,0
4,114,114,18,18,0,1,0
2,164,164,20,20,0,1,0
11,164,164,4,4,0,1,0
17,165,165,3,3,0,1,0
21,182,182,37,3,34,3,2
13,192,192,51,35,16,2,1
18,208,208,4,4,0,1,0
20,232,232,29,29,0,1,0
6,238,238,35,17,18,2,1
10,241,241,30,9,21,4,3
9,283,283,1,1,0,1,0
3,296,296,1,1,0,1,0
15,296,296,74,28,46,3,2
0,299,299,54,12,42,4,3
7,311,311,24,24,0,1,0
1,320,320,66,66,0,1,0
14,352,352,10,10,0,1,0
16,387,387,24,24,0,1,0
8,428,428,18,18,0,1,0
5,439,439,6,1,5,2,1
12,478,478,16,16,0,1,0

7,116,116,7,7,0,1,0
8,186,186,34,7,27,2,1
6,237,237,29,29,0,1,0
19,298,298,6,6,0,1,0
5,302,302,13,13,0,1,0
2,338,338,146,146,0,1,0
10,345,345,62,3,59,3,2
17,345,345,58,58,0,1,0
14,360,360,24,24,0,1,0
3,362,362,26,18,8,3,2
15,365,365,12,8,4,2,1
9,366,366,5,5,0,1,0
1,384,384,60,16,44,2,1
0,426,426,1,1,0,1,0
12,432,432,30,30,0,1,0
11,438,438,59,8,51,4,3
18,457,457,29,11,18,4,3
13,476,476,162,63,99,4,3
4,482,482,8,2,6,3,2
16,486,486,17,17,0,1,0

5,119,119,23,2,21,4,3
16,123,123,21,21,0,1,0
6,129,129,17,17,0,1,0
1,139,139,15,15,0,1,0
13,200,200,28,6,22,3,2
15,259,259,52,14,38,3,2
12,260,260,11,11,0,1,0
10,272,272,26,26,0,1,0
4,308,308,7,1,6,3,2
8,321,321,18,11,7,2,1
7,333,333,2,2,0,1,0
11,336,336,16,12,4,2,1
3,345,345,189,169,20,3,2
17,350,350,36,10,26,3,2
14,368,368,67,67,0,1,0
0,409,409,24,24,0,1,0
9,441,441,33,2,31,3,2
2,457,457,15,15,0,1,0

2,124,124,8,3,5,2,1
4,131,131,17,17,0,1,0
3,141,141,7,7,0,1,0
10,155,155,29,23,6,2,1
17,164,164,2,2,0,1,0
5,207,207,3,3,0,1,0
16,226,226,24,24,0,1,0
13,251,251,47,47,0,1,0
0,262,262,19,19,0,1,0
14,296,296,12,12,0,1,0
12,314,314,2,2,0,1,0
9,344,344,29,5,24,2,1
6,353,353,31,31,0,1,0
15,404,404,116,38,78,4,3
1,434,434,288,264,24,4,3
8,437,437,38,25,13,2,1
7,452,452,8,8,0,1,0
11,459,459,57,43,14,2,1

23,119,119,8,1,7,2,1
20,125,125,2,2,0,1,0
12,130,130,4,4,0,1,0
1,137,137,16,16,0,1,0
24,195,195,40,40,0,1,0
8,205,205,46,46,0,1,0
5,217,217,1,1,0,1,0
0,250,250,1,1,0,1,0
25,254,254,11,11,0,1,0
2,265,265,3,3,0,1,0
10,266,266,52,52,0,1,0
18,266,266,6,6,0,1,0
15,285,285,8,8,0,1,0
4,286,286,12,4,8,2,1
19,325,325,45,2,43,2,1
17,345,345,8,4,4,2,1
26,378,378,17,1,16,3,2
9,419,419,10,10,0,1,0
3,425,425,48,19,29,4,3
14,432,432,1,1,0,1,0
11,440,440,45,45,0,1,0
21,455,455,154,74,80,3,2
6,456,456,24,16,8,3,2
16,457,457,12,12,0,1,0
7,486,486,26,26,0,1,0
22,492,492,107,107,0,1,0
13,497,497,35,17,18,2,1

11,104,104,2,2,0,1,0
2,129,129,2,2,0,1,0
16,164,164,18,18,0,1,0
13,189,189,55,55,0,1,0
9,203,203,65,65,0,1,0
8,232,232,10,10,0,1,0
10,242,242,18,4,14,3,2
22,250,250,19,19,0,1,0
0,262,262,22,22,0,1,0
4,285,285,62,30,32,3,2
20,294,294,5,1,4,2,1
14,315,315,44,27,17,2,1
19,332,332,3,3,0,1,0
6,350,350,3,3,0,1,0
1,364,364,19,1,18,3,2
12,395,395,42,14,28,2,1
17,404,404,42,42,0,1,0
7,437,437,24,16,8,3,2
3,441,441,33,11,22,3,2
5,446,446,14,14,0,1,0
18,468,468,11,11,0,1,0
21,496,496,28,7,21,2,1
15,498,498,143,143,0,1,0

4,108,108,8,8,0,1,0
12,126,126,17,11,6,2,1
15,187,187,14,4,10,2,1
10,199,199,13,2,11,2,1
13,214,214,14,14,0,1,0
6,216,216,2,2,0,1,0
17,234,234,12,12,0,1,0
14,246,246,35,35,0,1,0
2,255,255,15,15,0,1,0
8,288,288,26,26,0,1,0
20,293,293,7,7,0,1,0
0,307,307,4,4,0,1,0
3,330,330,64,43,21,4,3
9,335,335,26,26,0,1,0
21,364,364,1,1,0,1,0
7,381,381,1,1,0,1,0
22,388,388,95,95,0,1,0
1,402,402,23,23,0,1,0
16,414,414,36,36,0,1,0
5,441,441,120,49,71,3,2
19,451,451,75,25,50,3,2
18,486,486,124,93,31,4,3
11,489,489,26,12,14,2,1

1,111,111,3,3,0,1,0
10,138,138,6,3,3,2,1
2,144,144,81,81,0,1,0
3,152,152,17,10,7,2,1
13,187,187,5,5,0,1,0
12,189,189,36,10,26,2,1
18,208,208,5,1,4,2,1
0,215,215,8,8,0,1,0
9,220,220,5,2,3,2,1
20,227,227,9,2,7,2,1
19,232,232,98,76,22,2,1
11,254,254,36,29,7,2,1
17,265,265,54,38,16,3,2
15,304,304,7,7,0,1,0
4,307,307,11,11,0,1,0
7,340,340,37,37,0,1,0
8,377,377,8,5,3,2,1
16,405,405,6,2,4,2,1
14,449,449,14,14,0,1,0
5,454,454,47,47,0,1,0
6,472,472,13,5,8,3,2

12,112,112,8,8,0,1,0
1,133,133,1,1,0,1,0
4,172,172,53,17,36,3,2
17,182,182,3,3,0,1,0
6,198,198,1,1,0,1,0
3,205,205,5,1,4,2,1
0,219,219,23,11,12,2,1
7,234,234,3,3,0,1,0
10,234,234,22,9,13,2,1
8,241,241,57,21,36,4,3
13,249,249,34,34,0,1,0
18,278,278,10,10,0,1,0
5,282,282,5,5,0,1,0
2,346,346,133,112,21,4,3
15,362,362,5,5,0,1,0
16,374,374,3,3,0,1,0
14,392,392,4,1,3,2,1
11,468,468,4,4,0,1,0
9,476,476,344,300,44,4,3

26,140,140,9,9,0,1,0
6,146,146,4,4,0,1,0
19,148,148,52,52,0,1,0
13,155,155,6,3,3,2,1
21,189,189,1,1,0,1,0
24,194,194,36,36,0,1,0
7,196,196,18,18,0,1,0
17,227,227,15,15,0,1,0
27,245,245,5,5,0,1,0
8,258,258,1,1,0,1,0
2,259,259,19,19,0,1,0
1,266,266,36,36,0,1,0
14,280,280,1,1,0,1,0
0,312,312,43,20,23,2,1
25,317,317,52,28,24,4,3
11,355,355,1,1,0,1,0
15,365,365,12,8,4,2,1
22,382,382,6,6,0,1,0
23,387,387,19,19,0,1,0
9,395,395,5,5,0,1,0
3,397,397,20,6,14,3,2
16,410,410,36,5,31,2,1
12,436,436,9,3,6,2,1
4,442,442,17,1,16,3,2
20,462,462,12,12,0,1,0
28,463,463,106,92,14,2,1
18,469,469,96,61,35,2,1
10,471,471,1,1,0,1,0
5,472,472,33,33,0,1,0

9,160,160,3,3,0,1,0
0,170,170,7,7,0,1,0
12,182,182,22,12,10,2,1
15,194,194,3,3,0,1,0
19,209,209,30,15,15,2,1
13,231,231,7,7,0,1,0
18,283,283,2,2,0,1,0
7,301,301,100,76,24,2,1
1,304,304,9,9,0,1,0
17,322,322,8,8,0,1,0
3,332,332,3,3,0,1,0
11,336,336,64,16,48,4,3
10,366,366,109,109,0,1,0
8,373,373,15,1,14,3,2
5,392,392,5,5,0,1,0
16,394,394,99,99,0,1,0
6,396,396,43,43,0,1,0
14,398,398,15,15,0,1,0
4,434,434,68,68,0,1,0
2,463,463,164,148,16,4,3

30,114,114,5,5,0,1,0
27,126,126,6,6,0,1,0
21,140,140,1,1,0,1,0
15,158,158,7,7,0,1,0
19,174,174,24,13,11,2,1
26,188,188,27,3,24,4,3
17,212,212,1,1,0,1,0
29,220,220,15,3,12,3,2
31,237,237,38,16,22,4,3
11,241,241,14,14,0,1,0
13,264,264,18,6,12,3,2
24,271,271,91,55,36,4,3
3,281,281,6,6,0,1,0
28,307,307,41,29,12,3,2
25,316,316,52,52,0,1,0
14,333,333,21,21,0,1,0
9,343,343,15,9,6,2,1
12,345,345,11,2,9,4,3
16,366,366,69,69,0,1,0
22,370,370,3,3,0,1,0
2,375,375,2,2,0,1,0
1,381,381,30,30,0,1,0
6,382,382,2,2,0,1,0
5,389,389,35,22,13,2,1
8,400,400,12,12,0,1,0
10,411,411,11,11,0,1,0
20,417,417,49,49,0,1,0
0,423,423,14,14,0,1,0
18,462,462,11,11,0,1,0
23,483,483,5,5,0,1,0
32,484,484,7,7,0,1,0
7,493,493,3,3,0,1,0
4,500,500,4,4,0,1,0

1,122,122,9,9,0,1,0
7,122,122,1,1,0,1,0
8,159,159,15,7,8,3,2
9,186,186,26,26,0,1,0
6,223,223,34,34,0,1,0
2,248,248,21,8,13,4,3
16,251,251,57,57,0,1,0
21,257,257,19,5,14,4,3
12,269,269,24,24,0,1,0
3,272,272,6,3,3,2,1
18,300,300,6,6,0,1,0
13,360,360,103,3,100,3,2
4,382,382,30,25,5,2,1
0,385,385,8,5,3,2,1
19,390,390,36,36,0,1,0
5,394,394,41,41,0,1,0
10,416,416,19,19,0,1,0
17,425,425,32,10,22,3,2
15,452,452,36,36,0,1,0
14,464,464,72,24,48,4,3
11,479,479,133,53,80,3,2
20,479,479,9,1,8,3,2

19,109,109,37,37,0,1,0
13,114,114,49,16,33,4,3
5,128,128,1,1,0,1,0
12,167,167,9,9,0,1,0
0,180,180,32,26,6,2,1
17,190,190,1,1,0,1,0
2,217,217,16,16,0,1,0
15,253,253,11,5,6,3,2
10,254,254,9,1,8,2,1
16,256,256,6,6,0,1,0
11,259,259,26,26,0,1,0
7,264,264,26,6,20,2,1
4,299,299,10,4,6,2,1
18,309,309,3,3,0,1,0
14,324,324,30,3,27,4,3
1,354,354,18,18,0,1,0
6,370,370,80,36,44,2,1
9,384,384,68,58,10,4,3
8,432,432,93,45,48,4,3
3,434,434,22,22,0,1,0

0,119,119,2,2,0,1,0
5,141,141,17,17,0,1,0
20,152,152,18,18,0,1,0
3,158,158,15,15,0,1,0
18,165,165,25,25,0,1,0
2,195,195,6,2,4,2,1
16,195,195,21,21,0,1,0
13,202,202,19,19,0,1,0
10,220,220,23,10,13,2,1
9,222,222,27,27,0,1,0
19,228,228,31,31,0,1,0
6,231,231,46,46,0,1,0
12,242,242,14,14,0,1,0
14,249,249,16,8,8,3,2
21,256,256,7,7,0,1,0
8,289,289,32,32,0,1,0
15,290,290,67,37,30,4,3
11,327,327,32,9,23,2,1
17,356,356,46,46,0,1,0
7,372,372,43,43,0,1,0
1,425,425,14,14,0,1,0
4,448,448,25,25,0,1,0

13,110,110,1,1,0,1,0
19,119,119,20,7,13,4,3
23,129,129,3,3,0,1,0
22,131,131,6,6,0,1,0
0,148,148,4,4,0,1,0
5,161,161,23,5,18,3,2
24,162,162,10,10,0,1,0
4,169,169,3,3,0,1,0
3,216,216,30,2,28,4,3
20,240,240,35,35,0,1,0
21,295,295,39,39,0,1,0
8,302,302,60,60,0,1,0
10,310,310,5,5,0,1,0
1,324,324,114,3,111,4,3
15,325,325,20,1,19,2,1
7,364,364,23,2,21,4,3
2,366,366,1,1,0,1,0
9,368,368,15,15,0,1,0
18,394,394,22,14,8,3,2
17,421,421,80,41,39,4,3
12,439,439,9,1,8,3,2
11,442,442,2,2,0,1,0
16,446,446,106,106,0,1,0
6,446,446,4,4,0,1,0
14,464,464,27,3,24,3,2

6,104,104,4,4,0,1,0
23,108,108,2,2,0,1,0
15,115,115,31,14,17,2,1
24,119,119,4,4,0,1,0
3,128,128,3,3,0,1,0
14,130,130,6,3,3,2,1
2,133,133,10,10,0,1,0
18,150,150,16,6,10,4,3
9,155,155,5,5,0,1,0
20,160,160,7,2,5,2,1
21,165,165,13,10,3,2,1
17,173,173,26,26,0,1,0
10,183,183,2,2,0,1,0
7,209,209,6,6,0,1,0
4,233,233,48,48,0,1,0
11,252,252,23,2,21,2,1
16,255,255,22,10,12,4,3
5,316,316,5,5,0,1,0
1,322,322,25,25,0,1,0
12,322,322,22,22,0,1,0
0,366,366,3,3,0,1,0
22,388,388,70,70,0,1,0
13,430,430,77,32,45,4,3
8,457,457,93,93,0,1,0
19,490,490,84,71,13,2,1

14,122,122,2,2,0,1,0
13,133,133,13,13,0,1,0
7,137,137,19,19,0,1,0
10,142,142,8,8,0,1,0
6,146,146,4,4,0,1,0
22,146,146,18,18,0,1,0
19,155,155,29,11,18,3,2
1,168,168,2,2,0,1,0
4,188,188,35,29,6,2,1
3,204,204,13,13,0,1,0
21,292,292,49,49,0,1,0
12,293,293,1,1,0,1,0
16,319,319,35,35,0,1,0
18,334,334,35,13,22,2,1
2,337,337,42,42,0,1,0
9,339,339,44,26,18,2,1
23,347,347,6,6,0,1,0
8,347,347,20,20,0,1,0
0,362,362,1,1,0,1,0
11,371,371,35,35,0,1,0
20,381,381,1,1,0,1,0
15,444,444,6,6,0,1,0
17,457,457,172,139,33,4,3
5,462,462,51,51,0,1,0

12,181,181,18,7,11,2,1
7,194,194,40,19,21,4,3
18,204,204,48,14,34,3,2
15,239,239,31,4,27,4,3
0,277,277,5,5,0,1,0
6,294,294,60,36,24,3,2
11,314,314,22,22,0,1,0
14,341,341,23,23,0,1,0
1,344,344,42,28,14,3,2
10,351,351,41,41,0,1,0
19,356,356,3,3,0,1,0
5,364,364,39,11,28,2,1
2,381,381,59,59,0,1,0
9,386,386,39,39,0,1,0
16,414,414,22,8,14,3,2
17,418,418,70,25,45,4,3
8,428,428,21,3,18,3,2
13,464,464,77,65,12,3,2
3,471,471,63,10,53,4,3
4,475,475,3,3,0,1,0

4,145,145,37,37,0,1,0
16,157,157,6,6,0,1,0
8,163,163,2,2,0,1,0
13,171,171,5,5,0,1,0
15,171,171,7,1,6,2,1
2,178,178,8,3,5,2,1
1,192,192,34,34,0,1,0
0,262,262,4,4,0,1,0
9,296,296,101,101,0,1,0
6,297,297,107,68,39,2,1
5,302,302,70,42,28,2,1
12,346,346,36,1,35,2,1
7,351,351,109,109,0,1,0
3,364,364,6,6,0,1,0
11,405,405,46,16,30,2,1
10,486,486,52,52,0,1,0
14,492,492,13,2,11,3,2

22,101,101,14,1,13,2,1
11,154,154,12,12,0,1,0
8,155,155,13,7,6,2,1
6,157,157,8,5,3,2,1
2,173,173,24,9,15,3,2
16,185,185,5,5,0,1,0
15,214,214,14,1,13,2,1
10,248,248,41,22,19,2,1
7,272,272,8,1,7,2,1
5,273,273,38,10,28,2,1
21,283,283,3,3,0,1,0
14,306,306,31,7,24,3,2
3,312,312,65,65,0,1,0
20,344,344,43,11,32,2,1
4,345,345,2,2,0,1,0
9,346,346,21,5,16,2,1
13,347,347,5,5,0,1,0
0,373,373,5,1,4,2,1
12,383,383,48,48,0,1,0
19,436,436,89,74,15,2,1
1,468,468,1,1,0,1,0
18,471,471,116,88,28,3,2
17,498,498,89,21,68,3,2

2,119,119,21,21,0,1,0
6,145,145,11,11,0,1,0
15,145,145,25,12,13,2,1
9,162,162,9,9,0,1,0
0,174,174,2,2,0,1,0
13,191,191,7,7,0,1,0
17,191,191,5,1,4,2,1
8,204,204,32,32,0,1,0
4,223,223,4,1,3,2,1
5,224,224,18,18,0,1,0
16,254,254,13,13,0,1,0
14,295,295,112,112,0,1,0
10,300,300,115,22,93,4,3
12,360,360,8,1,7,2,1
1,360,360,6,6,0,1,0
7,363,363,23,23,0,1,0
20,400,400,16,6,10,2,1
3,453,453,29,29,0,1,0
18,465,465,84,84,0,1,0
19,495,495,82,82,0,1,0
11,500,500,22,4,18,4,3

6,138,138,2,2,0,1,0
0,155,155,7,7,0,1,0
16,156,156,17,17,0,1,0
10,179,179,9,3,6,2,1
22,217,217,1,1,0,1,0
4,237,237,36,36,0,1,0
13,252,252,16,16,0,1,0
20,274,274,41,41,0,1,0
14,274,274,12,2,10,2,1
15,301,301,5,5,0,1,0
8,324,324,1,1,0,1,0
17,351,351,64,64,0,1,0
18,366,366,56,56,0,1,0
1,367,367,22,10,12,3,2
9,368,368,6,1,5,2,1
21,384,384,10,7,3,2,1
23,386,386,28,1,27,4,3
12,406,406,28,28,0,1,0
5,407,407,1,1,0,1,0
19,418,418,150,39,111,4,3
11,420,420,29,29,0,1,0
7,431,431,94,94,0,1,0
2,459,459,11,11,0,1,0
3,474,474,150,119,31,2,1

10,104,104,10,1,9,4,3
0,119,119,25,25,0,1,0
5,129,129,7,7,0,1,0
16,132,132,14,2,12,3,2
8,132,132,3,3,0,1,0
6,152,152,8,2,6,2,1
9,157,157,17,11,6,2,1
12,184,184,30,18,12,4,3
17,189,189,60,60,0,1,0
13,222,222,20,20,0,1,0
2,233,233,31,28,3,2,1
11,257,257,50,22,28,4,3
7,292,292,17,17,0,1,0
1,341,341,7,7,0,1,0
4,354,354,57,57,0,1,0
15,360,360,14,14,0,1,0
3,405,405,167,139,28,2,1
14,406,406,1,1,0,1,0

19,121,121,28,28,0,1,0
4,136,136,6,6,0,1,0
17,156,156,9,4,5,2,1
11,184,184,18,2,16,2,1
14,196,196,26,12,14,2,1
13,206,206,16,16,0,1,0
5,210,210,35,26,9,2,1
7,216,216,7,7,0,1,0
16,221,221,63,30,33,2,1
0,239,239,15,15,0,1,0
18,316,316,4,4,0,1,0
15,320,320,13,6,7,2,1
3,368,368,2,2,0,1,0
2,408,408,9,9,0,1,0
1,444,444,21,21,0,1,0
6,454,454,109,82,27,2,1
9,455,455,134,134,0,1,0
8,478,478,89,60,29,2,1
10,489,489,4,4,0,1,0
12,500,500,92,53,39,2,1

16,116,116,12,8,4,2,1
18,125,125,3,3,0,1,0
2,127,127,6,6,0,1,0
17,131,131,24,16,8,2,1
1,132,132,26,26,0,1,0
15,143,143,1,1,0,1,0
4,205,205,4,4,0,1,0
5,216,216,1,1,0,1,0
19,224,224,9,9,0,1,0
20,239,239,94,48,46,2,1
6,245,245,3,3,0,1,0
12,250,250,20,3,17,2,1
13,258,258,9,4,5,2,1
11,284,284,19,19,0,1,0
10,335,335,69,8,61,4,3
9,364,364,15,6,9,2,1
14,387,387,77,77,0,1,0
3,396,396,108,18,90,3,2
7,429,429,37,25,12,4,3
0,471,471,22,22,0,1,0
8,479,479,80,80,0,1,0

20,107,107,11,4,7,2,1
14,116,116,3,3,0,1,0
8,124,124,8,4,4,2,1
0,127,127,17,6,11,2,1
16,198,198,11,11,0,1,0
7,199,199,12,12,0,1,0
12,206,206,3,3,0,1,0
11,219,219,7,7,0,1,0
2,231,231,10,6,4,2,1
18,247,247,110,38,72,3,2
9,290,290,4,4,0,1,0
5,298,298,33,1,32,2,1
17,314,314,35,3,32,3,2
6,322,322,15,11,4,2,1
13,352,352,36,36,0,1,0
25,359,359,46,6,40,2,1
4,372,372,31,11,20,2,1
23,392,392,1,1,0,1,0
10,435,435,18,18,0,1,0
3,440,440,78,56,22,2,1
15,444,444,50,41,9,2,1
21,456,456,1,1,0,1,0
22,465,465,30,15,15,4,3
1,471,471,18,2,16,2,1
19,475,475,66,61,5,2,1
24,488,488,29,15,14,3,2

9,109,109,7,1,6,3,2
7,119,119,7,1,6,3,2
26,125,125,7,3,4,2,1
23,129,129,2,2,0,1,0
17,132,132,3,3,0,1,0
28,151,151,18,8,10,3,2
8,156,156,1,1,0,1,0
11,189,189,1,1,0,1,0
24,191,191,6,2,4,2,1
3,193,193,15,15,0,1,0
14,198,198,28,14,14,2,1
1,222,222,11,11,0,1,0
5,253,253,1,1,0,1,0
6,254,254,52,52,0,1,0
27,275,275,18,12,6,2,1
12,280,280,8,1,7,2,1
21,290,290,45,38,7,2,1
19,317,317,75,1,74,4,3
20,345,345,5,1,4,2,1
18,392,392,3,3,0,1,0
4,394,394,12,1,11,3,2
15,394,394,4,4,0,1,0
22,414,414,44,34,10,3,2
0,433,433,18,6,12,4,3
25,434,434,141,78,63,4,3
13,437,437,13,3,10,3,2
16,448,448,46,46,0,1,0
10,450,450,60,51,9,4,3
2,485,485,40,40,0,1,0

1,109,109,2,2,0,1,0
5,111,111,1,1,0,1,0
2,117,117,12,12,0,1,0
23,118,118,45,14,31,2,1
6,120,120,15,9,6,2,1
17,133,133,2,2,0,1,0
13,139,139,12,6,6,2,1
12,149,149,14,5,9,4,3
10,169,169,10,1,9,2,1
0,184,184,8,8,0,1,0
3,204,204,7,7,0,1,0
4,215,215,35,4,31,2,1
11,223,223,21,21,0,1,0
16,249,249,3,3,0,1,0
21,279,279,34,34,0,1,0
15,314,314,62,62,0,1,0
9,316,316,28,28,0,1,0
20,316,316,3,3,0,1,0
14,367,367,45,45,0,1,0
19,369,369,1,1,0,1,0
7,370,370,58,38,20,2,1
8,477,477,14,14,0,1,0
22,477,477,81,81,0,1,0
18,479,479,41,41,0,1,0

10,111,111,13,9,4,2,1
4,186,186,96,50,46,3,2
12,209,209,9,9,0,1,0
13,211,211,2,2,0,1,0
8,212,212,10,1,9,4,3
6,263,263,20,12,8,3,2
3,267,267,126,36,90,4,3
9,299,299,2,2,0,1,0
7,334,334,22,22,0,1,0
11,344,344,31,31,0,1,0
5,348,348,56,23,33,4,3
2,412,412,23,23,0,1,0
0,442,442,197,197,0,1,0
1,488,488,62,62,0,1,0

11,195,195,72,2,70,3,2
15,200,200,3,3,0,1,0
8,201,201,17,3,14,2,1
2,231,231,151,151,0,1,0
6,240,240,10,1,9,2,1
14,293,293,49,49,0,1,0
13,330,330,24,24,0,1,0
12,363,363,24,24,0,1,0
1,371,371,49,17,32,2,1
4,392,392,22,22,0,1,0
3,401,401,92,92,0,1,0
10,408,408,42,42,0,1,0
5,413,413,5,5,0,1,0
0,452,452,8,8,0,1,0
7,457,457,63,9,54,4,3
9,479,479,28,6,22,2,1

3,147,147,9,9,0,1,0
10,149,149,10,10,0,1,0
13,151,151,17,17,0,1,0
12,152,152,3,3,0,1,0
17,172,172,15,15,0,1,0
1,180,180,10,10,0,1,0
15,210,210,6,6,0,1,0
0,244,244,2,2,0,1,0
14,253,253,8,8,0,1,0
11,270,270,18,18,0,1,0
8,349,349,91,23,68,3,2
4,365,365,31,8,23,2,1
18,370,370,166,132,34,2,1
5,380,380,155,80,75,3,2
7,458,458,40,1,39,2,1
2,477,477,39,39,0,1,0
16,491,491,14,8,6,2,1
6,495,495,27,1,26,3,2
9,500,500,117,117,0,1,0

5,117,117,1,1,0,1,0
12,123,123,1,1,0,1,0
1,163,163,70,38,32,2,1
6,170,170,7,2,5,2,1
0,174,174,25,7,18,4,3
3,181,181,12,12,0,1,0
15,183,183,7,7,0,1,0
16,201,201,23,8,15,4,3
9,210,210,6,6,0,1,0
2,268,268,19,19,0,1,0
4,298,298,16,4,12,4,3
14,315,315,37,15,22,3,2
11,338,338,135,63,72,4,3
19,354,354,65,27,38,2,1
10,378,378,3,3,0,1,0
7,387,387,41,41,0,1,0
20,402,402,41,5,36,2,1
18,459,459,19,5,14,2,1
8,461,461,67,67,0,1,0
17,466,466,3,3,0,1,0
13,473,473,51,5,46,3,2

3,100,100,4,4,0,1,0
11,100,100,8,8,0,1,0
0,101,101,11,3,8,3,2
1,107,107,1,1,0,1,0
19,141,141,6,6,0,1,0
26,144,144,15,15,0,1,0
6,154,154,9,6,3,2,1
14,215,215,62,62,0,1,0
15,234,234,1,1,0,1,0
2,243,243,10,10,0,1,0
22,254,254,2,2,0,1,0
24,280,280,57,12,45,4,3
21,332,332,11,11,0,1,0
4,362,362,18,18,0,1,0
18,366,366,103,103,0,1,0
8,367,367,22,22,0,1,0
10,371,371,5,2,3,2,1
5,382,382,22,8,14,3,2
9,388,388,65,43,22,3,2
7,390,390,17,17,0,1,0
13,390,390,20,20,0,1,0
25,392,392,11,11,0,1,0
16,406,406,2,2,0,1,0
20,426,426,47,2,45,2,1
27,444,444,53,53,0,1,0
12,468,468,2,2,0,1,0
23,481,481,90,6,84,3,2
17,493,493,9,9,0,1,0

10,102,102,14,14,0,1,0
0,121,121,3,3,0,1,0
18,121,121,2,2,0,1,0
5,188,188,1,1,0,1,0
15,190,190,18,18,0,1,0
19,193,193,1,1,0,1,0
12,211,211,77,37,40,3,2
1,213,213,9,1,8,2,1
3,219,219,67,46,21,4,3
14,243,243,6,6,0,1,0
2,267,267,4,1,3,2,1
9,343,343,9,2,7,2,1
11,348,348,15,15,0,1,0
8,375,375,17,17,0,1,0
16,386,386,66,39,27,4,3
13,389,389,4,4,0,1,0
17,414,414,106,66,40,3,2
7,464,464,38,27,11,2,1
6,487,487,193,175,18,4,3
4,495,495,79,79,0,1,0

10,141,141,9,9,0,1,0
8,144,144,25,25,0,1,0
7,170,170,7,7,0,1,0
5,195,195,1,1,0,1,0
3,204,204,5,1,4,2,1
23,209,209,11,6,5,2,1
11,212,212,2,2,0,1,0
22,212,212,45,45,0,1,0
14,223,223,33,33,0,1,0
4,237,237,63,63,0,1,0
19,242,242,25,25,0,1,0
20,257,257,43,43,0,1,0
15,264,264,35,35,0,1,0
16,268,268,18,18,0,1,0
0,291,291,7,1,6,3,2
18,292,292,25,25,0,1,0
12,312,312,12,12,0,1,0
9,335,335,7,7,0,1,0
2,352,352,26,2,24,3,2
1,357,357,9,2,7,2,1
17,391,391,16,4,12,2,1
13,393,393,17,8,9,2,1
21,409,409,133,62,71,3,2
24,428,428,9,9,0,1,0
25,432,432,19,5,14,2,1
6,451,451,5,2,3,2,1

16,108,108,6,3,3,2,1
8,113,113,5,5,0,1,0
18,163,163,3,3,0,1,0
14,184,184,13,13,0,1,0
17,189,189,11,11,0,1,0
11,191,191,4,4,0,1,0
3,206,206,20,16,4,2,1
25,218,218,18,9,9,4,3
9,267,267,5,5,0,1,0
24,267,267,6,6,0,1,0
6,269,269,16,1,15,2,1
21,274,274,105,105,0,1,0
13,288,288,18,6,12,2,1
7,293,293,33,24,9,4,3
1,301,301,1,1,0,1,0
4,334,334,3,3,0,1,0
20,352,352,54,54,0,1,0
23,352,352,1,1,0,1,0
12,360,360,3,3,0,1,0
0,369,369,21,9,12,2,1
10,400,400,108,87,21,2,1
2,418,418,20,6,14,3,2
5,445,445,15,15,0,1,0
19,451,451,48,3,45,4,3
15,476,476,88,88,0,1,0
22,494,494,116,104,12,4,3

4,106,106,11,2,9,4,3
14,123,123,4,4,0,1,0
9,133,133,8,8,0,1,0
10,151,151,10,10,0,1,0
12,165,165,22,11,11,2,1
6,169,169,21,21,0,1,0
17,170,170,26,26,0,1,0
5,179,179,21,21,0,1,0
2,224,224,17,17,0,1,0
13,226,226,2,2,0,1,0
0,269,269,31,1,30,2,1
19,282,282,43,5,38,3,2
15,286,286,2,2,0,1,0
21,288,288,11,2,9,2,1
8,327,327,52,31,21,2,1
7,344,344,7,7,0,1,0
11,345,345,10,1,9,3,2
1,357,357,57,14,43,2,1
18,362,362,73,36,37,4,3
3,407,407,29,8,21,3,2
16,409,409,20,20,0,1,0
20,448,448,154,64,90,4,3

1,107,107,1,1,0,1,0
15,115,115,7,7,0,1,0
22,115,115,28,16,12,3,2
25,124,124,6,3,3,2,1
21,129,129,13,13,0,1,0
10,143,143,37,37,0,1,0
3,179,179,8,8,0,1,0
24,192,192,10,6,4,2,1
13,197,197,2,2,0,1,0
16,199,199,10,7,3,2,1
20,214,214,1,1,0,1,0
0,219,219,6,3,3,2,1
4,222,222,24,13,11,2,1
19,226,226,11,1,10,2,1
8,231,231,46,38,8,2,1
17,252,252,92,92,0,1,0
14,298,298,27,9,18,3,2
11,313,313,13,4,9,2,1
18,318,318,56,56,0,1,0
2,358,358,19,19,0,1,0
23,396,396,13,1,12,3,2
7,404,404,2,2,0,1,0
12,407,407,1,1,0,1,0
6,445,445,2,2,0,1,0
9,479,479,53,7,46,2,1
5,481,481,36,2,34,3,2

21,139,139,15,1,14,3,2
19,144,144,6,3,3,2,1
18,153,153,29,29,0,1,0
14,165,165,20,7,13,2,1
16,194,194,4,1,3,2,1
5,227,227,5,2,3,2,1
11,234,234,4,4,0,1,0
13,241,241,13,13,0,1,0
2,242,242,34,12,22,3,2
17,249,249,27,5,22,3,2
7,271,271,14,4,10,3,2
0,274,274,89,5,84,3,2
1,284,284,9,2,7,2,1
20,300,300,12,12,0,1,0
12,375,375,58,58,0,1,0
9,383,383,50,17,33,2,1
4,397,397,2,2,0,1,0
8,398,398,42,18,24,4,3
10,421,421,24,8,16,3,2
6,445,445,14,14,0,1,0
3,468,468,86,82,4,2,1
15,469,469,135,96,39,4,3

27,102,102,21,11,10,2,1
16,120,120,2,2,0,1,0
13,132,132,17,2,15,4,3
6,137,137,3,3,0,1,0
29,139,139,12,12,0,1,0
24,158,158,2,2,0,1,0
19,166,166,4,4,0,1,0
28,173,173,38,38,0,1,0
22,223,223,46,46,0,1,0
4,228,228,4,4,0,1,0
17,249,249,1,1,0,1,0
8,262,262,26,11,15,4,3
18,289,289,1,1,0,1,0
1,306,306,20,20,0,1,0
0,313,313,1,1,0,1,0
25,321,321,17,17,0,1,0
15,329,329,2,2,0,1,0
21,336,336,53,17,36,4,3
3,336,336,2,2,0,1,0
7,338,338,26,16,10,3,2
26,347,347,1,1,0,1,0
10,366,366,12,8,4,2,1
12,375,375,9,9,0,1,0
23,381,381,65,65,0,1,0
2,383,383,17,4,13,2,1
5,410,410,35,26,9,4,3
9,418,418,41,11,30,3,2
20,436,436,3,3,0,1,0
14,465,465,4,1,3,2,1
11,478,478,160,31,129,4,3

0,110,110,28,25,3,2,1
6,170,170,11,11,0,1,0
5,191,191,39,39,0,1,0
12,228,228,8,8,0,1,0
7,231,231,3,3,0,1,0
8,251,251,28,28,0,1,0
4,286,286,57,39,18,4,3
16,304,304,80,44,36,3,2
17,331,331,61,61,0,1,0
14,355,355,7,7,0,1,0
2,359,359,1,1,0,1,0
11,379,379,14,3,11,2,1
10,441,441,27,27,0,1,0
13,450,450,14,5,9,4,3
1,454,454,11,11,0,1,0
9,469,469,151,141,10,3,2
15,488,488,2,2,0,1,0
18,490,490,77,77,0,1,0
3,496,496,113,90,23,4,3

1,102,102,5,5,0,1,0
16,104,104,1,1,0,1,0
5,147,147,31,31,0,1,0
6,161,161,2,2,0,1,0
17,164,164,10,10,0,1,0
14,184,184,56,56,0,1,0
18,217,217,11,11,0,1,0
8,242,242,30,30,0,1,0
15,252,252,36,5,31,2,1
11,282,282,24,24,0,1,0
10,372,372,54,54,0,1,0
2,377,377,81,39,42,4,3
9,378,378,43,1,42,3,2
0,389,389,58,50,8,2,1
19,406,406,50,10,40,3,2
4,414,414,74,74,0,1,0
7,420,420,18,7,11,2,1
12,425,425,33,9,24,4,3
3,432,432,2,2,0,1,0
13,455,455,57,57,0,1,0

9,116,116,14,14,0,1,0
17,125,125,14,14,0,1,0
0,127,127,1,1,0,1,0
5,131,131,26,26,0,1,0
10,139,139,3,3,0,1,0
1,139,139,10,1,9,4,3
2,143,143,8,5,3,2,1
8,146,146,4,4,0,1,0
6,228,228,35,35,0,1,0
12,231,231,64,7,57,4,3
14,237,237,31,13,18,4,3
19,320,320,58,58,0,1,0
3,335,335,53,28,25,2,1
4,381,381,85,39,46,4,3
15,430,430,8,8,0,1,0
16,432,432,2,2,0,1,0
18,445,445,22,2,20,2,1
13,455,455,6,6,0,1,0
7,486,486,44,14,30,3,2
11,497,497,155,155,0,1,0

6,106,106,5,5,0,1,0
22,107,107,5,5,0,1,0
5,141,141,9,9,0,1,0
2,150,150,10,10,0,1,0
13,158,158,62,18,44,2,1
19,193,193,3,3,0,1,0
11,217,217,1,1,0,1,0
10,224,224,8,8,0,1,0
4,253,253,36,5,31,2,1
20,282,282,29,29,0,1,0
17,315,315,19,5,14,3,2
7,330,330,12,12,0,1,0
14,354,354,10,4,6,2,1
18,359,359,67,67,0,1,0
12,380,380,26,26,0,1,0
8,384,384,8,1,7,2,1
1,386,386,1,1,0,1,0
15,408,408,57,57,0,1,0
16,415,415,30,6,24,2,1
0,442,442,63,45,18,4,3
21,446,446,37,37,0,1,0
3,464,464,47,37,10,2,1
9,466,466,172,100,72,4,3

7,117,117,2,2,0,1,0
5,128,128,31,31,0,1,0
11,145,145,31,31,0,1,0
4,150,150,19,19,0,1,0
17,157,157,4,4,0,1,0
19,172,172,72,35,37,2,1
8,179,179,53,53,0,1,0
12,194,194,11,5,6,2,1
10,195,195,1,1,0,1,0
3,254,254,8,8,0,1,0
2,290,290,19,19,0,1,0
18,291,291,11,11,0,1,0
13,296,296,7,1,6,3,2
9,319,319,3,3,0,1,0
0,357,357,69,69,0,1,0
6,388,388,25,25,0,1,0
1,391,391,22,22,0,1,0
16,401,401,18,18,0,1,0
14,405,405,67,59,8,3,2
15,452,452,58,37,21,4,3

4,113,113,8,3,5,2,1
22,132,132,32,32,0,1,0
2,141,141,9,9,0,1,0
15,179,179,3,3,0,1,0
5,193,193,5,5,0,1,0
9,199,199,13,13,0,1,0
13,202,202,35,35,0,1,0
14,212,212,6,6,0,1,0
0,212,212,1,1,0,1,0
10,236,236,32,2,30,4,3
6,268,268,31,31,0,1,0
16,293,293,39,12,27,2,1
3,322,322,26,8,18,3,2
1,323,323,17,17,0,1,0
21,325,325,36,11,25,4,3
12,343,343,72,26,46,2,1
19,356,356,46,46,0,1,0
11,361,361,10,10,0,1,0
7,376,376,34,16,18,4,3
17,390,390,53,15,38,3,2
18,404,404,12,12,0,1,0
20,429,429,54,22,32,3,2
8,465,465,74,44,30,4,3

22,116,116,43,9,34,2,1
20,120,120,12,12,0,1,0
16,131,131,1,1,0,1,0
21,134,134,15,15,0,1,0
5,215,215,3,3,0,1,0
17,245,245,44,38,6,3,2
15,255,255,11,11,0,1,0
18,312,312,16,6,10,3,2
3,324,324,19,19,0,1,0
13,330,330,3,3,0,1,0
10,332,332,27,17,10,2,1
9,340,340,14,11,3,2,1
6,390,390,32,12,20,3,2
11,392,392,66,66,0,1,0
1,405,405,88,88,0,1,0
14,406,406,60,60,0,1,0
19,415,415,46,46,0,1,0
12,427,427,77,44,33,4,3
7,429,429,16,16,0,1,0
2,431,431,24,1,23,2,1
8,459,459,41,41,0,1,0
0,475,475,7,7,0,1,0
4,492,492,30,1,29,2,1

9,101,101,9,9,0,1,0
3,125,125,5,5,0,1,0
11,133,133,13,1,12,3,2
12,134,134,1,1,0,1,0
16,145,145,12,12,0,1,0
2,154,154,1,1,0,1,0
4,172,172,17,17,0,1,0
13,173,173,35,28,7,2,1
6,250,250,19,19,0,1,0
22,300,300,59,59,0,1,0
8,312,312,4,4,0,1,0
18,349,349,33,19,14,2,1
23,359,359,14,14,0,1,0
20,364,364,24,17,7,2,1
10,374,374,46,46,0,1,0
7,376,376,1,1,0,1,0
14,389,389,42,6,36,3,2
19,397,397,12,7,5,2,1
0,406,406,58,58,0,1,0
21,466,466,23,1,22,3,2
17,469,469,77,77,0,1,0
5,478,478,16,16,0,1,0
1,490,490,84,22,62,3,2
15,490,490,140,140,0,1,0

22,120,120,23,15,8,2,1
4,129,129,5,5,0,1,0
7,130,130,2,2,0,1,0
10,180,180,26,26,0,1,0
3,190,190,2,2,0,1,0
9,202,202,18,18,0,1,0
17,202,202,14,6,8,2,1
14,246,246,20,6,14,3,2
5,264,264,40,6,34,3,2
20,302,302,17,7,10,3,2
18,302,302,65,31,34,2,1
1,312,312,12,12,0,1,0
0,315,315,31,31,0,1,0
11,338,338,51,43,8,3,2
21,345,345,91,1,90,4,3
2,347,347,28,28,0,1,0
8,357,357,79,79,0,1,0
13,359,359,15,7,8,3,2
19,370,370,4,4,0,1,0
23,386,386,35,35,0,1,0
16,393,393,33,19,14,3,2
15,447,447,27,18,9,2,1
12,467,467,8,8,0,1,0
6,489,489,1,1,0,1,0

3,107,107,1,1,0,1,0
6,112,112,35,13,22,3,2
0,158,158,34,34,0,1,0
8,168,168,42,42,0,1,0
12,168,168,2,2,0,1,0
7,170,170,2,2,0,1,0
4,218,218,2,2,0,1,0
1,228,228,26,26,0,1,0
9,239,239,14,14,0,1,0
17,249,249,2,2,0,1,0
21,255,255,30,8,22,3,2
5,298,298,5,5,0,1,0
11,309,309,2,2,0,1,0
15,311,311,19,19,0,1,0
19,323,323,46,2,44,2,1
10,351,351,21,21,0,1,0
16,383,383,106,94,12,3,2
14,397,397,8,2,6,3,2
2,428,428,12,12,0,1,0
18,437,437,13,5,8,3,2
13,459,459,108,34,74,4,3
20,482,482,22,12,10,2,1
22,492,492,87,55,32,3,2

4,138,138,1,1,0,1,0
12,163,163,47,47,0,1,0
5,177,177,5,5,0,1,0
0,178,178,26,26,0,1,0
16,207,207,19,13,6,3,2
18,266,266,17,17,0,1,0
1,288,288,32,32,0,1,0
9,299,299,25,1,24,3,2
17,306,306,10,10,0,1,0
3,311,311,37,37,0,1,0
10,313,313,5,5,0,1,0
7,313,313,56,56,0,1,0
13,321,321,53,53,0,1,0
11,354,354,5,5,0,1,0
8,380,380,107,100,7,2,1
15,410,410,103,103,0,1,0
14,412,412,46,46,0,1,0
2,419,419,35,8,27,4,3
6,492,492,72,24,48,2,1

10,109,109,3,3,0,1,0
13,113,113,4,4,0,1,0
7,119,119,5,5,0,1,0
3,139,139,2,2,0,1,0
15,139,139,38,17,21,4,3
14,143,143,13,13,0,1,0
16,198,198,2,2,0,1,0
17,200,200,7,7,0,1,0
6,218,218,22,22,0,1,0
1,226,226,29,29,0,1,0
5,226,226,1,1,0,1,0
20,233,233,72,72,0,1,0
19,241,241,53,12,41,4,3
21,243,243,26,1,25,4,3
18,285,285,7,7,0,1,0
8,296,296,12,12,0,1,0
0,304,304,51,51,0,1,0
4,314,314,5,2,3,2,1
11,320,320,45,1,44,3,2
12,323,323,5,1,4,2,1
9,371,371,54,38,16,2,1
2,376,376,103,85,18,4,3

8,115,115,8,5,3,2,1
15,120,120,3,3,0,1,0
27,122,122,40,40,0,1,0
23,168,168,17,17,0,1,0
5,192,192,4,4,0,1,0
17,250,250,71,7,64,3,2
24,276,276,40,40,0,1,0
26,283,283,20,8,12,3,2
12,299,299,2,2,0,1,0
19,300,300,14,11,3,2,1
10,317,317,30,30,0,1,0
25,321,321,9,6,3,2,1
0,327,327,7,7,0,1,0
22,327,327,53,53,0,1,0
18,358,358,3,3,0,1,0
9,360,360,24,24,0,1,0
28,362,362,29,3,26,3,2
13,380,380,31,31,0,1,0
7,380,380,41,24,17,2,1
3,386,386,26,18,8,3,2
20,426,426,20,20,0,1,0
2,433,433,1,1,0,1,0
14,443,443,17,11,6,2,1
6,450,450,20,4,16,2,1
1,456,456,10,10,0,1,0
4,462,462,39,24,15,4,3
11,488,488,9,9,0,1,0
21,492,492,53,53,0,1,0
16,496,496,19,8,11,2,1

14,127,127,2,2,0,1,0
12,187,187,20,20,0,1,0
5,207,207,72,72,0,1,0
9,235,235,69,69,0,1,0
10,277,277,4,1,3,2,1
1,285,285,9,4,5,2,1
15,313,313,56,56,0,1,0
4,326,326,3,3,0,1,0
13,370,370,14,14,0,1,0
7,389,389,123,90,33,2,1
2,396,396,213,166,47,2,1
11,433,433,32,23,9,4,3
8,434,434,9,9,0,1,0
3,441,441,28,13,15,2,1
6,471,471,28,6,22,2,1
0,494,494,55,2,53,4,3

7,122,122,16,16,0,1,0
16,128,128,25,25,0,1,0
6,141,141,14,14,0,1,0
10,182,182,5,5,0,1,0
1,220,220,10,10,0,1,0
8,276,276,12,5,7,2,1
11,309,309,52,25,27,2,1
14,331,331,7,1,6,2,1
9,355,355,21,21,0,1,0
15,376,376,132,91,41,3,2
13,413,413,24,7,17,2,1
5,423,423,148,148,0,1,0
0,444,444,7,1,6,3,2
2,463,463,31,17,14,2,1
3,472,472,10,10,0,1,0
4,475,475,240,240,0,1,0
12,476,476,31,3,28,3,2

9,165,165,51,47,4,2,1
0,172,172,24,24,0,1,0
12,177,177,7,4,3,2,1
6,192,192,16,16,0,1,0
10,206,206,14,11,3,2,1
3,214,214,30,30,0,1,0
11,239,239,24,24,0,1,0
15,241,241,2,2,0,1,0
1,251,251,27,27,0,1,0
4,267,267,30,10,20,2,1
17,271,271,21,21,0,1,0
14,292,292,98,71,27,4,3
13,337,337,4,4,0,1,0
2,374,374,33,33,0,1,0
5,378,378,110,80,30,3,2
8,454,454,33,33,0,1,0
7,481,481,32,6,26,3,2
18,488,488,41,41,0,1,0
16,497,497,43,22,21,2,1

0,122,122,2,2,0,1,0
16,128,128,2,2,0,1,0
19,149,149,33,10,23,2,1
13,152,152,39,39,0,1,0
18,186,186,25,25,0,1,0
1,198,198,22,22,0,1,0
4,202,202,14,14,0,1,0
6,282,282,14,3,11,2,1
3,282,282,12,6,6,3,2
14,305,305,23,11,12,3,2
7,323,323,177,177,0,1,0
2,342,342,1,1,0,1,0
10,358,358,18,4,14,2,1
5,392,392,23,11,12,3,2
11,400,400,27,4,23,4,3
20,408,408,42,12,30,4,3
17,425,425,57,57,0,1,0
8,426,426,7,7,0,1,0
21,470,470,13,13,0,1,0
12,476,476,44,44,0,1,0
15,497,497,30,19,11,2,1
9,499,499,34,7,27,3,2

8,115,115,1,1,0,1,0
3,142,142,1,1,0,1,0
0,147,147,6,6,0,1,0
9,152,152,2,2,0,1,0
7,189,189,2,2,0,1,0
2,193,193,7,1,6,3,2
6,223,223,23,15,8,3,2
19,224,224,12,2,10,2,1
1,243,243,75,48,27,4,3
4,253,253,7,7,0,1,0
22,263,263,6,1,5,2,1
16,263,263,14,14,0,1,0
23,286,286,78,44,34,3,2
15,302,302,36,18,18,4,3
18,311,311,19,6,13,4,3
20,351,351,37,37,0,1,0
24,366,366,33,33,0,1,0
10,380,380,10,1,9,2,1
11,390,390,66,66,0,1,0
12,430,430,11,11,0,1,0
21,476,476,74,31,43,2,1
17,479,479,87,87,0,1,0
14,482,482,150,150,0,1,0
13,493,493,5,5,0,1,0
5,498,498,1,1,0,1,0

5,128,128,11,3,8,3,2
10,184,184,21,3,18,3,2
2,191,191,16,16,0,1,0
18,200,200,29,17,12,4,3
8,225,225,55,18,37,2,1
21,232,232,19,19,0,1,0
4,242,242,17,17,0,1,0
1,245,245,19,19,0,1,0
20,246,246,9,3,6,2,1
17,254,254,29,29,0,1,0
13,294,294,27,6,21,2,1
0,314,314,37,31,6,2,1
15,323,323,64,64,0,1,0
9,338,338,23,23,0,1,0
12,344,344,2,2,0,1,0
19,365,365,61,61,0,1,0
6,392,392,3,3,0,1,0
16,428,428,113,107,6,2,1
7,438,438,46,46,0,1,0
11,440,440,54,54,0,1,0
14,460,460,6,6,0,1,0
3,498,498,2,2,0,1,0

16,108,108,11,7,4,2,1
10,145,145,7,7,0,1,0
17,154,154,21,21,0,1,0
2,170,170,15,15,0,1,0
7,171,171,16,4,12,4,3
9,205,205,5,5,0,1,0
6,214,214,28,28,0,1,0
4,271,271,12,12,0,1,0
8,284,284,32,25,7,2,1
14,350,350,1,1,0,1,0
3,351,351,149,41,108,4,3
15,356,356,39,14,25,3,2
0,358,358,51,18,33,4,3
18,360,360,12,8,4,2,1
11,361,361,91,4,87,4,3
12,372,372,1,1,0,1,0
1,431,431,10,10,0,1,0
13,467,467,80,23,57,4,3
19,481,481,126,120,6,3,2
5,498,498,8,8,0,1,0

14,112,112,8,8,0,1,0
0,127,127,4,4,0,1,0
7,140,140,16,4,12,3,2
13,170,170,36,27,9,4,3
22,186,186,11,4,7,2,1
18,197,197,1,1,0,1,0
15,224,224,55,24,31,2,1
2,238,238,26,2,24,2,1
6,267,267,10,10,0,1,0
20,275,275,34,3,31,4,3
19,307,307,34,17,17,2,1
12,328,328,22,3,19,3,2
17,346,346,36,36,0,1,0
3,356,356,40,9,31,2,1
11,371,371,1,1,0,1,0
1,371,371,7,7,0,1,0
8,399,399,26,26,0,1,0
10,413,413,13,3,10,2,1
4,443,443,16,16,0,1,0
9,450,450,97,3,94,3,2
5,451,451,117,63,54,4,3
21,483,483,80,28,52,3,2
16,484,484,12,4,8,2,1

15,110,110,17,6,11,4,3
22,129,129,7,7,0,1,0
12,200,200,31,31,0,1,0
11,203,203,34,34,0,1,0
18,206,206,30,3,27,4,3
3,225,225,1,1,0,1,0
13,247,247,30,30,0,1,0
2,271,271,4,4,0,1,0
1,305,305,22,19,3,2,1
17,311,311,12,3,9,4,3
24,318,318,36,36,0,1,0
10,318,318,29,7,22,2,1
4,319,319,33,23,10,3,2
8,371,371,2,2,0,1,0
9,382,382,25,25,0,1,0
5,401,401,88,28,60,4,3
23,413,413,65,1,64,3,2
16,432,432,93,32,61,4,3
14,439,439,12,4,8,3,2
7,464,464,7,4,3,2,1
20,468,468,44,44,0,1,0
19,471,471,10,1,9,4,3
6,473,473,9,4,5,2,1
21,478,478,59,45,14,2,1
0,488,488,9,9,0,1,0

17,100,100,4,1,3,2,1
0,160,160,46,14,32,3,2
12,166,166,14,14,0,1,0
11,208,208,22,22,0,1,0
14,224,224,10,4,6,3,2
2,243,243,1,1,0,1,0
13,247,247,7,7,0,1,0
7,271,271,34,24,10,3,2
15,293,293,127,106,21,4,3
16,295,295,33,3,30,2,1
1,300,300,102,55,47,2,1
3,346,346,35,35,0,1,0
10,347,347,20,20,0,1,0
4,411,411,15,15,0,1,0
9,427,427,24,24,0,1,0
8,440,440,71,3,68,3,2
6,445,445,66,66,0,1,0
5,463,463,27,5,22,3,2

17,108,108,24,24,0,1,0
0,120,120,13,13,0,1,0
6,134,134,28,1,27,4,3
1,135,135,6,6,0,1,0
5,136,136,7,7,0,1,0
24,144,144,1,1,0,1,0
2,145,145,4,4,0,1,0
15,149,149,25,13,12,2,1
8,169,169,6,6,0,1,0
13,180,180,25,22,3,2,1
11,194,194,34,25,9,2,1
20,219,219,20,20,0,1,0
22,231,231,35,35,0,1,0
3,253,253,9,1,8,2,1
10,276,276,5,5,0,1,0
19,358,358,31,1,30,2,1
12,371,371,18,18,0,1,0
18,417,417,18,1,17,2,1
14,422,422,4,1,3,2,1
7,429,429,9,9,0,1,0
16,433,433,24,24,0,1,0
9,445,445,24,24,0,1,0
23,449,449,62,56,6,3,2
21,489,489,77,35,42,2,1
4,499,499,62,32,30,2,1

8,128,128,1,1,0,1,0
6,167,167,6,6,0,1,0
11,200,200,38,17,21,3,2
7,305,305,18,18,0,1,0
13,317,317,66,66,0,1,0
1,320,320,102,12,90,3,2
12,320,320,105,6,99,4,3
9,321,321,14,6,8,2,1
2,328,328,162,118,44,2,1
5,350,350,19,19,0,1,0
4,378,378,68,14,54,4,3
3,414,414,88,1,87,3,2
0,432,432,33,20,13,2,1
10,463,463,8,8,0,1,0

21,105,105,6,6,0,1,0
5,112,112,17,7,10,3,2
20,124,124,6,6,0,1,0
15,128,128,7,3,4,2,1
19,142,142,18,13,5,2,1
10,153,153,18,18,0,1,0
17,167,167,13,13,0,1,0
18,184,184,5,5,0,1,0
3,199,199,9,9,0,1,0
14,232,232,8,2,6,2,1
4,251,251,17,8,9,2,1
11,260,260,31,31,0,1,0
0,307,307,2,2,0,1,0
12,308,308,28,9,19,2,1
13,318,318,23,13,10,3,2
9,368,368,33,3,30,3,2
7,394,394,66,8,58,3,2
2,419,419,1,1,0,1,0
8,429,429,1,1,0,1,0
16,434,434,233,233,0,1,0
6,447,447,117,72,45,4,3
1,493,493,35,31,4,2,1

20,117,117,4,4,0,1,0
3,122,122,32,32,0,1,0
13,138,138,6,6,0,1,0
6,139,139,6,6,0,1,0
2,147,147,1,1,0,1,0
19,260,260,32,5,27,2,1
9,265,265,25,25,0,1,0
1,302,302,24,24,0,1,0
18,305,305,9,9,0,1,0
12,318,318,11,11,0,1,0
5,326,326,22,16,6,2,1
4,327,327,9,9,0,1,0
22,339,339,5,5,0,1,0
16,345,345,39,22,17,2,1
11,361,361,77,77,0,1,0
7,372,372,9,9,0,1,0
10,405,405,32,32,0,1,0
0,437,437,39,39,0,1,0
17,443,443,71,47,24,4,3
21,454,454,172,159,13,2,1
14,460,460,72,72,0,1,0
15,462,462,14,14,0,1,0
8,491,491,20,8,12,4,3
23,496,496,36,36,0,1,0

3,106,106,2,2,0,1,0
15,126,126,6,6,0,1,0
1,146,146,14,9,5,2,1
23,182,182,20,20,0,1,0
16,186,186,20,6,14,4,3
13,201,201,3,3,0,1,0
20,228,228,7,7,0,1,0
25,269,269,56,15,41,2,1
17,280,280,20,1,19,2,1
10,285,285,36,22,14,3,2
12,292,292,19,5,14,3,2
19,334,334,56,37,19,4,3
6,350,350,1,1,0,1,0
8,360,360,37,37,0,1,0
0,367,367,5,5,0,1,0
2,371,371,7,3,4,2,1
7,395,395,51,51,0,1,0
9,397,397,17,17,0,1,0
4,403,403,22,22,0,1,0
11,412,412,13,13,0,1,0
14,413,413,42,42,0,1,0
22,429,429,12,12,0,1,0
26,441,441,94,18,76,4,3
21,444,444,76,76,0,1,0
24,444,444,19,19,0,1,0
18,465,465,34,6,28,3,2
5,483,483,63,63,0,1,0

26,118,118,3,3,0,1,0
20,132,132,10,10,0,1,0
8,135,135,19,10,9,2,1
13,135,135,6,6,0,1,0
21,166,166,13,1,12,3,2
11,179,179,1,1,0,1,0
17,185,185,37,13,24,3,2
18,234,234,28,18,10,2,1
7,247,247,1,1,0,1,0
24,262,262,71,71,0,1,0
0,264,264,9,4,5,2,1
25,268,268,10,10,0,1,0
9,269,269,9,9,0,1,0
16,273,273,5,1,4,2,1
2,301,301,45,38,7,2,1
12,328,328,29,29,0,1,0
14,329,329,11,11,0,1,0
3,345,345,2,2,0,1,0
5,346,346,64,55,9,4,3
4,351,351,11,2,9,3,2
6,353,353,12,12,0,1,0
19,379,379,88,88,0,1,0
22,382,382,89,39,50,3,2
1,388,388,33,33,0,1,0
23,392,392,11,1,10,2,1
10,432,432,4,4,0,1,0
27,442,442,10,3,7,2,1
15,498,498,1,1,0,1,0

8,103,103,31,5,26,2,1
15,112,112,1,1,0,1,0
12,147,147,41,41,0,1,0
18,177,177,10,10,0,1,0
5,217,217,3,3,0,1,0
2,225,225,28,28,0,1,0
14,231,231,33,21,12,2,1
1,244,244,27,27,0,1,0
6,268,268,34,34,0,1,0
0,281,281,62,15,47,2,1
9,285,285,29,29,0,1,0
10,336,336,41,33,8,3,2
11,347,347,36,5,31,4,3
16,347,347,11,4,7,2,1
7,352,352,3,3,0,1,0
4,391,391,28,28,0,1,0
19,410,410,64,20,44,2,1
17,424,424,41,6,35,4,3
3,425,425,10,10,0,1,0
13,427,427,50,50,0,1,0

9,185,185,4,4,0,1,0
7,195,195,12,2,10,3,2
2,201,201,65,65,0,1,0
12,212,212,23,18,5,2,1
1,226,226,22,10,12,4,3
3,287,287,6,6,0,1,0
13,316,316,59,27,32,3,2
17,324,324,50,22,28,3,2
5,356,356,100,88,12,3,2
11,366,366,46,46,0,1,0
0,375,375,15,5,10,2,1
14,388,388,19,7,12,4,3
4,406,406,77,59,18,2,1
15,442,442,16,16,0,1,0
6,470,470,42,37,5,2,1
8,471,471,129,129,0,1,0
10,487,487,44,44,0,1,0
16,489,489,34,34,0,1,0

7,113,113,19,10,9,2,1
5,122,122,3,3,0,1,0
18,125,125,12,1,11,3,2
3,129,129,11,3,8,2,1
10,147,147,2,2,0,1,0
14,159,159,25,25,0,1,0
12,160,160,25,13,12,2,1
22,202,202,8,8,0,1,0
0,214,214,1,1,0,1,0
19,237,237,1,1,0,1,0
21,270,270,14,14,0,1,0
11,274,274,3,3,0,1,0
2,286,286,14,14,0,1,0
16,317,317,31,6,25,2,1
20,340,340,99,3,96,4,3
13,375,375,19,19,0,1,0
9,382,382,7,7,0,1,0
15,403,403,64,64,0,1,0
1,417,417,89,41,48,4,3
4,430,430,29,29,0,1,0
17,437,437,73,73,0,1,0
6,455,455,50,50,0,1,0
8,476,476,87,2,85,4,3

3,134,134,5,5,0,1,0
21,144,144,2,2,0,1,0
9,187,187,1,1,0,1,0
20,187,187,16,16,0,1,0
5,199,199,1,1,0,1,0
8,217,217,3,3,0,1,0
17,240,240,1,1,0,1,0
15,305,305,48,31,17,2,1
13,338,338,47,12,35,3,2
10,364,364,24,24,0,1,0
7,401,401,33,9,24,3,2
18,430,430,167,80,87,4,3
1,432,432,24,24,0,1,0
4,434,434,63,63,0,1,0
12,435,435,14,11,3,2,1
2,441,441,115,107,8,2,1
16,453,453,113,32,81,4,3
19,455,455,7,7,0,1,0
0,460,460,49,49,0,1,0
14,490,490,14,8,6,3,2
6,498,498,72,32,40,3,2
11,500,500,89,89,0,1,0

15,125,125,1,1,0,1,0
4,133,133,5,5,0,1,0
7,149,149,16,1,15,3,2
19,150,150,19,5,14,3,2
0,153,153,28,16,12,2,1
6,167,167,9,2,7,2,1
13,180,180,12,12,0,1,0
16,199,199,32,9,23,2,1
24,200,200,11,11,0,1,0
10,206,206,10,10,0,1,0
17,209,209,7,1,6,3,2
1,227,227,7,7,0,1,0
14,242,242,19,19,0,1,0
3,243,243,3,3,0,1,0
18,297,297,7,7,0,1,0
11,299,299,32,8,24,4,3
22,321,321,59,41,18,4,3
2,364,364,12,7,5,2,1
20,379,379,48,48,0,1,0
23,381,381,90,6,84,3,2
12,407,407,28,16,12,4,3
8,427,427,82,82,0,1,0
5,470,470,12,12,0,1,0
21,488,488,64,64,0,1,0
9,489,489,25,25,0,1,0
25,497,497,20,2,18,3,2

11,114,114,8,4,4,2,1
12,158,158,20,8,12,3,2
8,179,179,42,42,0,1,0
10,183,183,3,3,0,1,0
15,207,207,7,1,6,3,2
18,219,219,4,4,0,1,0
21,222,222,44,44,0,1,0
6,228,228,37,27,10,2,1
2,228,228,23,23,0,1,0
9,258,258,21,17,4,2,1
7,286,286,5,5,0,1,0
1,310,310,22,3,19,2,1
5,313,313,40,40,0,1,0
14,328,328,13,7,6,3,2
0,340,340,10,4,6,3,2
3,349,349,1,1,0,1,0
16,368,368,70,70,0,1,0
17,403,403,40,4,36,4,3
13,413,413,126,126,0,1,0
19,448,448,39,7,32,2,1
4,473,473,91,91,0,1,0
20,478,478,8,8,0,1,0

11,114,114,17,17,0,1,0
12,159,159,9,9,0,1,0
7,168,168,95,61,34,3,2
10,183,183,3,3,0,1,0
4,220,220,11,5,6,2,1
6,221,221,1,1,0,1,0
1,229,229,18,18,0,1,0
3,244,244,67,39,28,2,1
2,261,261,69,69,0,1,0
0,265,265,115,61,54,4,3
14,271,271,3,3,0,1,0
8,312,312,20,20,0,1,0
9,343,343,3,3,0,1,0
5,443,443,75,54,21,4,3
13,457,457,33,33,0,1,0

1,108,108,5,5,0,1,0
2,137,137,18,18,0,1,0
4,144,144,11,4,7,2,1
8,153,153,10,7,3,2,1
23,154,154,2,2,0,1,0
6,167,167,27,8,19,4,3
14,171,171,17,17,0,1,0
0,174,174,29,29,0,1,0
5,239,239,5,5,0,1,0
24,252,252,15,11,4,2,1
20,257,257,35,35,0,1,0
12,259,259,10,10,0,1,0
19,263,263,10,10,0,1,0
11,287,287,16,11,5,2,1
13,296,296,10,10,0,1,0
21,324,324,21,18,3,2,1
16,326,326,44,44,0,1,0
22,356,356,135,75,60,4,3
15,368,368,45,45,0,1,0
18,393,393,55,55,0,1,0
3,400,400,31,31,0,1,0
10,400,400,4,4,0,1,0
7,418,418,41,28,13,2,1
9,434,434,9,5,4,2,1
17,500,500,15,15,0,1,0

20,124,124,13,13,0,1,0
14,148,148,9,3,6,3,2
4,158,158,1,1,0,1,0
12,172,172,7,1,6,2,1
0,182,182,4,4,0,1,0
1,220,220,5,5,0,1,0
21,229,229,8,8,0,1,0
7,232,232,9,9,0,1,0
5,240,240,93,18,75,4,3
2,255,255,15,3,12,4,3
6,260,260,1,1,0,1,0
15,278,278,93,54,39,4,3
11,318,318,48,48,0,1,0
18,322,322,14,2,12,3,2
9,331,331,18,12,6,3,2
16,363,363,11,11,0,1,0
13,364,364,76,76,0,1,0
17,369,369,89,89,0,1,0
19,383,383,5,1,4,2,1
10,422,422,52,52,0,1,0
8,465,465,78,40,38,2,1
3,482,482,31,3,28,3,2

6,120,120,23,13,10,2,1
15,175,175,2,2,0,1,0
12,180,180,33,33,0,1,0
17,181,181,13,13,0,1,0
0,208,208,2,2,0,1,0
4,218,218,1,1,0,1,0
18,227,227,20,20,0,1,0
9,229,229,9,9,0,1,0
11,232,232,9,9,0,1,0
16,234,234,80,42,38,2,1
13,235,235,58,58,0,1,0
8,241,241,31,22,9,4,3
7,247,247,63,18,45,2,1
20,262,262,8,8,0,1,0
5,280,280,30,6,24,3,2
10,330,330,57,24,33,3,2
3,358,358,43,43,0,1,0
19,362,362,23,23,0,1,0
2,381,381,3,3,0,1,0
1,427,427,12,12,0,1,0
21,429,429,27,27,0,1,0
14,493,493,8,8,0,1,0

23,112,112,2,2,0,1,0
12,117,117,9,9,0,1,0
7,159,159,13,1,12,4,3
9,207,207,11,3,8,2,1
20,257,257,11,11,0,1,0
4,258,258,81,81,0,1,0
18,262,262,112,112,0,1,0
17,263,263,15,7,8,2,1
3,268,268,21,16,5,2,1
22,270,270,42,42,0,1,0
5,279,279,15,3,12,3,2
11,282,282,12,12,0,1,0
10,291,291,15,15,0,1,0
13,295,295,11,11,0,1,0
1,336,336,16,16,0,1,0
2,346,346,54,36,18,3,2
6,369,369,20,12,8,3,2
8,371,371,4,4,0,1,0
21,392,392,41,10,31,4,3
14,395,395,24,24,0,1,0
0,433,433,19,1,18,4,3
16,472,472,3,3,0,1,0
15,474,474,24,24,0,1,0
19,480,480,94,16,78,3,2

14,112,112,5,2,3,2,1
15,117,117,2,2,0,1,0
11,161,161,6,3,3,2,1
18,174,174,28,3,25,2,1
5,179,179,4,4,0,1,0
9,190,190,6,6,0,1,0
20,204,204,35,35,0,1,0
17,207,207,61,61,0,1,0
2,280,280,9,9,0,1,0
13,282,282,44,44,0,1,0
4,288,288,28,28,0,1,0
12,303,303,23,5,18,2,1
10,350,350,15,15,0,1,0
19,353,353,6,6,0,1,0
6,370,370,10,4,6,3,2
1,372,372,1,1,0,1,0
7,413,413,166,166,0,1,0
3,447,447,46,46,0,1,0
8,483,483,36,36,0,1,0
0,486,486,130,60,70,4,3
16,492,492,73,1,72,4,3

4,138,138,1,1,0,1,0
12,156,156,25,1,24,3,2
10,157,157,37,37,0,1,0
8,185,185,4,4,0,1,0
7,223,223,31,26,5,2,1
11,351,351,24,3,21,4,3
0,355,355,98,62,36,3,2
1,360,360,62,62,0,1,0
15,387,387,52,25,27,4,3
16,387,387,3,3,0,1,0
14,400,400,32,12,20,2,1
9,411,411,34,22,12,2,1
6,414,414,42,11,31,3,2
5,431,431,3,3,0,1,0
13,457,457,88,68,20,2,1
2,465,465,84,35,49,4,3
3,478,478,171,137,34,2,1

13,102,102,40,15,25,2,1
4,131,131,11,11,0,1,0
7,162,162,1,1,0,1,0
19,173,173,2,2,0,1,0
8,210,210,14,14,0,1,0
21,211,211,7,2,5,2,1
16,245,245,7,7,0,1,0
1,247,247,39,19,20,2,1
11,277,277,18,3,15,2,1
12,285,285,24,24,0,1,0
17,292,292,10,10,0,1,0
9,318,318,44,21,23,4,3
5,340,340,16,16,0,1,0
15,348,348,13,7,6,2,1
20,359,359,73,35,38,3,2
3,376,376,68,20,48,3,2
14,385,385,16,4,12,2,1
6,438,438,78,62,16,2,1
18,457,457,118,118,0,1,0
0,458,458,25,15,10,2,1
2,460,460,34,34,0,1,0
10,473,473,23,23,0,1,0

4,107,107,15,15,0,1,0
1,139,139,29,29,0,1,0
9,161,161,12,7,5,2,1
2,189,189,12,12,0,1,0
11,195,195,63,36,27,3,2
15,204,204,44,44,0,1,0
0,209,209,42,8,34,3,2
8,212,212,1,1,0,1,0
18,238,238,32,32,0,1,0
3,277,277,101,32,69,4,3
16,279,279,5,5,0,1,0
10,283,283,19,8,11,2,1
14,312,312,10,10,0,1,0
12,326,326,19,19,0,1,0
13,359,359,37,37,0,1,0
17,413,413,39,39,0,1,0
6,414,414,1,1,0,1,0
7,459,459,38,2,36,3,2
5,462,462,16,9,7,2,1

9,121,121,24,24,0,1,0
6,173,173,3,3,0,1,0
21,184,184,5,5,0,1,0
7,199,199,19,19,0,1,0
14,272,272,40,40,0,1,0
15,287,287,37,37,0,1,0
0,304,304,8,8,0,1,0
20,326,326,27,27,0,1,0
4,332,332,12,12,0,1,0
19,366,366,38,6,32,4,3
8,369,369,7,1,6,3,2
10,390,390,2,2,0,1,0
1,390,390,16,4,12,3,2
3,405,405,38,38,0,1,0
5,412,412,169,68,101,4,3
17,428,428,3,3,0,1,0
18,450,450,40,7,33,4,3
16,459,459,1,1,0,1,0
2,476,476,27,1,26,4,3
11,478,478,49,49,0,1,0
13,485,485,116,88,28,2,1
12,488,488,141,141,0,1,0

18,103,103,6,6,0,1,0
6,112,112,2,2,0,1,0
22,114,114,9,9,0,1,0
23,136,136,11,6,5,2,1
1,147,147,1,1,0,1,0
26,183,183,43,43,0,1,0
25,183,183,24,24,0,1,0
16,190,190,2,2,0,1,0
13,206,206,22,7,15,2,1
0,216,216,2,2,0,1,0
17,241,241,2,2,0,1,0
3,258,258,5,1,4,2,1
9,301,301,38,38,0,1,0
14,324,324,2,2,0,1,0
11,379,379,19,7,12,2,1
5,380,380,132,111,21,2,1
7,383,383,17,2,15,2,1
2,388,388,15,15,0,1,0
8,393,393,13,13,0,1,0
24,401,401,26,6,20,2,1
12,410,410,2,2,0,1,0
19,410,410,86,24,62,3,2
15,417,417,3,3,0,1,0
10,433,433,111,39,72,3,2
20,461,461,103,63,40,3,2
21,469,469,14,4,10,3,2
4,479,479,9,9,0,1,0

14,105,105,2,2,0,1,0
16,119,119,9,4,5,2,1
0,136,136,17,17,0,1,0
17,138,138,16,6,10,2,1
20,143,143,1,1,0,1,0
3,173,173,29,12,17,2,1
6,197,197,13,1,12,2,1
5,233,233,1,1,0,1,0
10,256,256,7,4,3,2,1
23,315,315,6,6,0,1,0
7,321,321,19,2,17,2,1
18,328,328,65,65,0,1,0
2,340,340,11,1,10,2,1
11,343,343,46,7,39,2,1
8,363,363,2,2,0,1,0
15,375,375,38,6,32,2,1
24,402,402,27,27,0,1,0
12,415,415,32,32,0,1,0
1,419,419,72,32,40,2,1
4,424,424,25,25,0,1,0
13,436,436,38,16,22,2,1
19,448,448,73,57,16,3,2
22,459,459,128,80,48,4,3
21,494,494,47,5,42,4,3
9,500,500,36,36,0,1,0

4,100,100,10,6,4,2,1
22,107,107,29,11,18,4,3
10,110,110,1,1,0,1,0
0,116,116,2,2,0,1,0
14,117,117,10,10,0,1,0
11,129,129,1,1,0,1,0
25,179,179,10,10,0,1,0
2,184,184,5,5,0,1,0
20,184,184,44,14,30,4,3
24,225,225,54,54,0,1,0
7,229,229,9,1,8,2,1
15,249,249,28,28,0,1,0
16,266,266,44,4,40,3,2
13,284,284,20,20,0,1,0
17,326,326,22,16,6,3,2
12,339,339,7,7,0,1,0
8,368,368,59,59,0,1,0
9,369,369,40,40,0,1,0
21,404,404,3,3,0,1,0
1,418,418,38,38,0,1,0
18,422,422,5,5,0,1,0
23,433,433,15,15,0,1,0
19,434,434,11,7,4,2,1
6,442,442,35,35,0,1,0
3,444,444,54,14,40,2,1
5,457,457,24,8,16,3,2

11,107,107,7,1,6,2,1
13,119,119,13,13,0,1,0
12,133,133,42,20,22,2,1
3,201,201,78,38,40,4,3
8,211,211,6,6,0,1,0
2,245,245,87,3,84,3,2
6,265,265,35,8,27,2,1
9,317,317,11,7,4,2,1
16,382,382,14,6,8,2,1
10,416,416,50,50,0,1,0
0,434,434,17,17,0,1,0
5,441,441,25,25,0,1,0
17,460,460,49,16,33,2,1
1,465,465,28,1,27,2,1
14,472,472,96,68,28,3,2
15,485,485,46,22,24,2,1
4,486,486,29,29,0,1,0
7,498,498,5,2,3,2,1

5,115,115,3,3,0,1,0
3,121,121,1,1,0,1,0
16,124,124,8,8,0,1,0
14,144,144,18,18,0,1,0
2,166,166,2,2,0,1,0
22,177,177,7,2,5,2,1
19,198,198,38,9,29,2,1
8,210,210,30,23,7,2,1
15,217,217,5,1,4,2,1
7,250,250,12,12,0,1,0
0,253,253,24,10,14,3,2
10,263,263,9,9,0,1,0
17,268,268,75,18,57,4,3
18,284,284,2,2,0,1,0
21,309,309,9,2,7,2,1
9,376,376,7,7,0,1,0
20,378,378,90,90,0,1,0
12,391,391,34,31,3,2,1
4,419,419,156,156,0,1,0
1,448,448,57,57,0,1,0
13,449,449,54,42,12,3,2
6,453,453,49,49,0,1,0
11,489,489,10,2,8,2,1

3,119,119,5,1,4,2,1
20,125,125,15,15,0,1,0
11,126,126,10,1,9,2,1
8,127,127,17,17,0,1,0
7,142,142,38,38,0,1,0
19,186,186,62,20,42,3,2
17,188,188,9,9,0,1,0
21,203,203,14,4,10,3,2
12,205,205,11,5,6,3,2
14,214,214,9,1,8,2,1
4,249,249,11,5,6,3,2
13,263,263,65,37,28,2,1
15,269,269,19,19,0,1,0
10,282,282,27,27,0,1,0
6,356,356,15,15,0,1,0
1,379,379,23,23,0,1,0
0,389,389,15,6,9,4,3
16,416,416,54,39,15,2,1
18,433,433,4,1,3,2,1
9,473,473,14,14,0,1,0
5,478,478,111,14,97,4,3
2,483,483,20,12,8,2,1

15,100,100,4,4,0,1,0
16,108,108,20,20,0,1,0
18,115,115,11,11,0,1,0
14,119,119,26,13,13,4,3
12,129,129,15,15,0,1,0
4,133,133,5,5,0,1,0
7,136,136,4,4,0,1,0
2,144,144,12,6,6,3,2
8,190,190,93,51,42,4,3
6,193,193,4,1,3,2,1
20,211,211,14,4,10,2,1
1,233,233,2,2,0,1,0
13,263,263,6,6,0,1,0
3,329,329,11,5,6,3,2
19,378,378,56,56,0,1,0
17,384,384,13,7,6,3,2
0,415,415,102,24,78,4,3
5,427,427,36,15,21,2,1
10,432,432,28,28,0,1,0
11,473,473,99,24,75,4,3
9,483,483,2,2,0,1,0

10,121,121,33,33,0,1,0
13,143,143,36,36,0,1,0
7,171,171,15,15,0,1,0
15,175,175,20,20,0,1,0
6,195,195,14,14,0,1,0
8,230,230,10,10,0,1,0
11,286,286,16,16,0,1,0
17,289,289,4,4,0,1,0
5,319,319,220,208,12,3,2
0,349,349,1,1,0,1,0
1,369,369,48,6,42,3,2
9,374,374,18,2,16,4,3
2,405,405,8,8,0,1,0
14,413,413,43,8,35,2,1
18,419,419,18,18,0,1,0
3,425,425,22,7,15,2,1
12,465,465,96,47,49,2,1
4,465,465,2,2,0,1,0
16,486,486,8,8,0,1,0

9,127,127,2,2,0,1,0
18,134,134,7,7,0,1,0
14,137,137,13,13,0,1,0
7,166,166,12,12,0,1,0
12,189,189,11,11,0,1,0
21,202,202,17,17,0,1,0
2,238,238,23,2,21,2,1
20,285,285,68,68,0,1,0
3,290,290,1,1,0,1,0
17,324,324,77,61,16,3,2
5,345,345,3,3,0,1,0
8,377,377,14,8,6,3,2
19,381,381,84,22,62,3,2
16,387,387,14,3,11,2,1
6,415,415,111,18,93,4,3
4,417,417,17,10,7,2,1
11,432,432,77,37,40,4,3
0,434,434,132,99,33,4,3
22,438,438,53,36,17,4,3
13,450,450,10,2,8,3,2
15,474,474,6,3,3,2,1
1,476,476,6,2,4,2,1
10,489,489,4,4,0,1,0

19,102,102,2,2,0,1,0
22,103,103,13,1,12,4,3
12,114,114,6,6,0,1,0
21,125,125,32,17,15,2,1
20,126,126,15,15,0,1,0
8,162,162,8,1,7,2,1
15,165,165,23,23,0,1,0
29,175,175,42,14,28,3,2
9,182,182,37,1,36,2,1
1,190,190,12,12,0,1,0
17,193,193,4,1,3,2,1
27,195,195,16,9,7,2,1
7,212,212,15,3,12,4,3
26,213,213,1,1,0,1,0
11,269,269,5,5,0,1,0
2,278,278,5,5,0,1,0
13,316,316,5,5,0,1,0
16,316,316,2,2,0,1,0
23,318,318,57,15,42,4,3
30,351,351,26,18,8,2,1
18,354,354,1,1,0,1,0
24,356,356,30,3,27,4,3
0,362,362,38,28,10,2,1
3,368,368,8,8,0,1,0
25,369,369,6,3,3,2,1
28,386,386,22,22,0,1,0
5,403,403,11,3,8,3,2
6,419,419,25,13,12,3,2
10,436,436,18,13,5,2,1
14,455,455,14,14,0,1,0
4,470,470,9,9,0,1,0

7,106,106,1,1,0,1,0
0,123,123,6,6,0,1,0
11,128,128,11,11,0,1,0
15,178,178,5,5,0,1,0
21,189,189,75,75,0,1,0
10,197,197,12,7,5,2,1
1,198,198,32,32,0,1,0
20,233,233,5,2,3,2,1
12,254,254,50,50,0,1,0
5,275,275,5,5,0,1,0
6,289,289,44,44,0,1,0
16,315,315,13,10,3,2,1
3,317,317,1,1,0,1,0
4,334,334,87,87,0,1,0
2,344,344,26,17,9,4,3
22,349,349,35,23,12,4,3
8,349,349,9,4,5,2,1
18,396,396,66,18,48,4,3
9,412,412,1,1,0,1,0
13,422,422,21,21,0,1,0
19,441,441,2,2,0,1,0
17,465,465,25,16,9,4,3
14,493,493,125,81,44,3,2

10,109,109,11,11,0,1,0
9,125,125,8,5,3,2,1
18,125,125,8,2,6,2,1
7,142,142,5,5,0,1,0
0,148,148,14,14,0,1,0
6,152,152,15,15,0,1,0
14,163,163,27,27,0,1,0
4,208,208,33,11,22,2,1
23,244,244,29,29,0,1,0
13,246,246,11,11,0,1,0
12,271,271,6,6,0,1,0
3,281,281,1,1,0,1,0
20,282,282,127,18,109,4,3
22,285,285,6,1,5,2,1
21,309,309,18,2,16,3,2
1,348,348,26,12,14,3,2
8,354,354,7,7,0,1,0
2,371,371,8,3,5,2,1
19,409,409,4,1,3,2,1
15,411,411,15,15,0,1,0
5,425,425,4,4,0,1,0
25,426,426,75,5,70,3,2
24,436,436,24,24,0,1,0
16,449,449,18,18,0,1,0
11,464,464,70,58,12,4,3
17,467,467,61,25,36,4,3

12,115,115,23,8,15,4,3
21,118,118,1,1,0,1,0
11,175,175,4,4,0,1,0
9,182,182,37,37,0,1,0
3,184,184,13,13,0,1,0
23,211,211,33,11,22,2,1
2,217,217,1,1,0,1,0
5,217,217,13,13,0,1,0
7,218,218,6,6,0,1,0
1,226,226,4,4,0,1,0
20,247,247,1,1,0,1,0
4,251,251,2,2,0,1,0
0,267,267,3,3,0,1,0
17,299,299,1,1,0,1,0
18,320,320,157,85,72,4,3
15,321,321,26,26,0,1,0
16,349,349,18,18,0,1,0
8,354,354,91,49,42,2,1
14,407,407,37,13,24,4,3
13,419,419,10,10,0,1,0
19,424,424,19,19,0,1,0
22,428,428,80,12,68,3,2
10,452,452,12,12,0,1,0
6,494,494,83,71,12,4,3

10,110,110,10,6,4,2,1
0,124,124,2,2,0,1,0
5,136,136,14,14,0,1,0
12,148,148,6,6,0,1,0
17,164,164,87,21,66,4,3
2,201,201,22,8,14,3,2
16,243,243,42,2,40,3,2
14,287,287,2,2,0,1,0
1,312,312,47,4,43,2,1
7,343,343,27,27,0,1,0
9,368,368,47,47,0,1,0
4,379,379,195,116,79,4,3
6,383,383,1,1,0,1,0
13,396,396,17,17,0,1,0
8,399,399,23,6,17,4,3
18,415,415,9,9,0,1,0
11,420,420,26,26,0,1,0
3,436,436,30,10,20,2,1
15,470,470,13,7,6,3,2

14,107,107,21,21,0,1,0
10,108,108,32,32,0,1,0
4,124,124,6,6,0,1,0
15,125,125,5,5,0,1,0
18,141,141,9,1,8,2,1
6,148,148,25,3,22,2,1
12,161,161,27,17,10,2,1
13,175,175,12,12,0,1,0
2,176,176,42,42,0,1,0
9,188,188,13,1,12,3,2
17,243,243,27,15,12,2,1
8,269,269,2,2,0,1,0
11,292,292,32,8,24,4,3
1,337,337,33,11,22,2,1
16,393,393,4,4,0,1,0
3,398,398,22,14,8,2,1
5,400,400,21,21,0,1,0
7,444,444,53,15,38,3,2
0,450,450,141,141,0,1,0

0,166,166,26,5,21,4,3
16,208,208,17,9,8,3,2
17,228,228,57,57,0,1,0
3,244,244,2,2,0,1,0
4,260,260,45,29,16,3,2
12,279,279,49,8,41,2,1
1,283,283,10,1,9,4,3
15,294,294,4,4,0,1,0
2,330,330,39,6,33,2,1
11,343,343,7,3,4,2,1
13,346,346,83,41,42,3,2
6,359,359,31,2,29,2,1
10,364,364,12,8,4,2,1
7,379,379,59,59,0,1,0
19,382,382,51,51,0,1,0
14,390,390,30,6,24,3,2
18,441,441,41,41,0,1,0
5,442,442,28,2,26,3,2
8,460,460,34,22,12,3,2
9,483,483,111,111,0,1,0

13,136,136,26,26,0,1,0
0,146,146,1,1,0,1,0
4,148,148,5,1,4,2,1
12,171,171,20,20,0,1,0
9,211,211,88,84,4,2,1
14,230,230,18,15,3,2,1
5,248,248,14,9,5,2,1
8,260,260,11,11,0,1,0
7,263,263,18,18,0,1,0
18,279,279,30,19,11,2,1
15,279,279,11,3,8,3,2
16,300,300,20,20,0,1,0
3,327,327,52,52,0,1,0
20,351,351,21,12,9,4,3
6,383,383,12,12,0,1,0
21,385,385,1,1,0,1,0
17,389,389,114,69,45,2,1
11,396,396,65,50,15,4,3
2,407,407,8,8,0,1,0
10,441,441,27,27,0,1,0
19,454,454,74,74,0,1,0
1,456,456,19,19,0,1,0

7,119,119,7,4,3,2,1
8,127,127,5,2,3,2,1
9,180,180,11,4,7,2,1
2,187,187,41,17,24,2,1
18,215,215,6,1,5,2,1
1,226,226,12,1,11,2,1
12,271,271,32,16,16,3,2
0,286,286,102,102,0,1,0
13,299,299,7,7,0,1,0
19,316,316,4,4,0,1,0
3,316,316,4,4,0,1,0
11,354,354,9,9,0,1,0
4,376,376,23,19,4,2,1
17,389,389,11,11,0,1,0
16,394,394,34,34,0,1,0
5,417,417,1,1,0,1,0
15,439,439,21,21,0,1,0
14,448,448,315,259,56,3,2
20,466,466,20,20,0,1,0
10,470,470,56,48,8,2,1
6,500,500,59,13,46,3,2

19,117,117,6,6,0,1,0
18,136,136,18,18,0,1,0
1,144,144,5,1,4,2,1
20,174,174,14,14,0,1,0
3,191,191,9,9,0,1,0
0,194,194,9,9,0,1,0
5,203,203,56,56,0,1,0
9,299,299,18,18,0,1,0
12,301,301,14,14,0,1,0
13,301,301,18,10,8,3,2
7,302,302,36,36,0,1,0
6,305,305,3,3,0,1,0
8,312,312,10,10,0,1,0
2,313,313,4,1,3,2,1
17,332,332,6,6,0,1,0
15,435,435,8,8,0,1,0
4,448,448,99,39,60,4,3
14,452,452,258,186,72,4,3
10,455,455,110,110,0,1,0
11,455,455,48,41,7,2,1
16,487,487,14,14,0,1,0

10,165,165,1,1,0,1,0
1,175,175,45,45,0,1,0
4,188,188,32,1,31,4,3
8,203,203,1,1,0,1,0
17,206,206,14,14,0,1,0
5,211,211,8,2,6,2,1
0,217,217,45,12,33,2,1
16,282,282,46,28,18,4,3
12,287,287,13,13,0,1,0
11,331,331,66,66,0,1,0
3,340,340,4,4,0,1,0
7,362,362,21,18,3,2,1
18,376,376,55,22,33,4,3
2,400,400,23,3,20,3,2
19,428,428,17,5,12,4,3
14,436,436,7,7,0,1,0
6,443,443,84,16,68,3,2
13,456,456,68,7,61,3,2
9,462,462,49,29,20,2,1
15,481,481,135,121,14,2,1

15,111,111,13,4,9,2,1
18,112,112,24,24,0,1,0
21,125,125,2,2,0,1,0
22,133,133,5,5,0,1,0
7,142,142,10,1,9,4,3
10,157,157,1,1,0,1,0
0,172,172,4,4,0,1,0
20,180,180,35,35,0,1,0
13,187,187,2,2,0,1,0
12,190,190,21,3,18,3,2
19,225,225,15,15,0,1,0
23,270,270,1,1,0,1,0
17,277,277,75,60,15,2,1
4,316,316,3,3,0,1,0
6,382,382,7,1,6,2,1
9,400,400,4,4,0,1,0
3,411,411,144,144,0,1,0
1,432,432,12,8,4,2,1
2,451,451,9,3,6,2,1
14,455,455,76,76,0,1,0
16,455,455,12,12,0,1,0
5,468,468,39,33,6,2,1
8,480,480,110,10,100,4,3
11,481,481,64,8,56,3,2

3,122,122,1,1,0,1,0
4,177,177,25,25,0,1,0
13,179,179,6,6,0,1,0
16,209,209,29,29,0,1,0
12,242,242,1,1,0,1,0
9,256,256,34,23,11,2,1
11,316,316,110,64,46,2,1
8,318,318,11,3,8,3,2
10,334,334,15,15,0,1,0
15,358,358,4,4,0,1,0
2,364,364,73,73,0,1,0
18,375,375,15,7,8,3,2
0,400,400,14,7,7,2,1
19,412,412,23,23,0,1,0
7,416,416,88,40,48,3,2
1,421,421,51,9,42,4,3
5,426,426,56,36,20,2,1
17,452,452,146,146,0,1,0
14,486,486,57,24,33,4,3
6,492,492,42,42,0,1,0

16,102,102,34,2,32,3,2
0,179,179,10,10,0,1,0
3,236,236,32,32,0,1,0
6,236,236,7,7,0,1,0
8,239,239,25,10,15,4,3
4,245,245,62,62,0,1,0
17,250,250,27,12,15,2,1
18,261,261,49,4,45,4,3
20,291,291,1,1,0,1,0
11,302,302,21,13,8,2,1
12,314,314,8,8,0,1,0
14,332,332,5,5,0,1,0
10,340,340,93,11,82,3,2
1,391,391,3,3,0,1,0
19,394,394,40,40,0,1,0
9,421,421,9,2,7,2,1
7,435,435,39,1,38,3,2
13,437,437,62,62,0,1,0
15,437,437,58,58,0,1,0
5,462,462,16,1,15,2,1
2,494,494,48,48,0,1,0

14,131,131,40,37,3,2,1
8,147,147,13,13,0,1,0
17,164,164,6,6,0,1,0
13,181,181,21,21,0,1,0
0,194,194,9,9,0,1,0
15,206,206,8,8,0,1,0
16,207,207,25,25,0,1,0
5,220,220,16,16,0,1,0
4,228,228,10,10,0,1,0
19,236,236,15,7,8,3,2
12,250,250,44,12,32,2,1
11,281,281,24,8,16,2,1
10,340,340,8,8,0,1,0
3,355,355,7,1,6,2,1
18,359,359,61,17,44,4,3
9,397,397,172,172,0,1,0
7,438,438,16,2,14,3,2
1,478,478,42,42,0,1,0
2,480,480,61,20,41,4,3
6,486,486,71,32,39,4,3

17,120,120,14,14,0,1,0
19,167,167,29,29,0,1,0
9,170,170,3,3,0,1,0
5,173,173,6,6,0,1,0
7,188,188,18,18,0,1,0
8,194,194,1,1,0,1,0
4,215,215,19,19,0,1,0
2,231,231,53,53,0,1,0
6,238,238,46,1,45,4,3
10,262,262,46,7,39,2,1
12,270,270,46,46,0,1,0
3,271,271,5,2,3,2,1
13,281,281,14,14,0,1,0
11,323,323,42,12,30,4,3
1,343,343,19,19,0,1,0
18,353,353,51,51,0,1,0
21,373,373,58,58,0,1,0
16,378,378,3,3,0,1,0
15,396,396,80,45,35,2,1
14,407,407,5,5,0,1,0
20,419,419,36,36,0,1,0
0,499,499,29,29,0,1,0

14,128,128,11,11,0,1,0
5,153,153,1,1,0,1,0
30,169,169,45,45,0,1,0
1,171,171,10,7,3,2,1
26,185,185,41,41,0,1,0
27,190,190,7,7,0,1,0
6,199,199,1,1,0,1,0
29,240,240,28,28,0,1,0
19,251,251,16,16,0,1,0
8,266,266,9,9,0,1,0
11,279,279,12,9,3,2,1
20,283,283,11,11,0,1,0
21,287,287,10,10,0,1,0
0,304,304,16,16,0,1,0
10,307,307,38,29,9,2,1
25,319,319,57,57,0,1,0
12,340,340,17,17,0,1,0
15,348,348,7,7,0,1,0
17,364,364,2,2,0,1,0
28,366,366,16,16,0,1,0
16,369,369,3,3,0,1,0
9,400,400,34,8,26,3,2
18,406,406,13,13,0,1,0
7,414,414,1,1,0,1,0
23,449,449,36,36,0,1,0
3,459,459,74,74,0,1,0
4,467,467,42,6,36,3,2
24,488,488,1,1,0,1,0
2,490,490,32,4,28,3,2
22,491,491,68,12,56,3,2
13,498,498,35,29,6,2,1

4,126,126,37,37,0,1,0
5,128,128,4,4,0,1,0
8,130,130,28,10,18,2,1
2,161,161,5,5,0,1,0
17,163,163,49,49,0,1,0
13,165,165,6,6,0,1,0
16,174,174,23,23,0,1,0
14,201,201,13,8,5,2,1
0,220,220,2,2,0,1,0
1,269,269,3,3,0,1,0
15,272,272,4,4,0,1,0
11,291,291,29,29,0,1,0
7,299,299,55,55,0,1,0
9,305,305,44,44,0,1,0
19,325,325,4,4,0,1,0
20,339,339,89,26,63,3,2
3,344,344,1,1,0,1,0
10,350,350,18,4,14,3,2
6,373,373,11,6,5,2,1
21,381,381,18,6,12,2,1
18,481,481,32,32,0,1,0
12,500,500,95,35,60,4,3

6,115,115,44,44,0,1,0
2,125,125,2,2,0,1,0
18,127,127,22,10,12,4,3
8,127,127,45,45,0,1,0
3,154,154,3,3,0,1,0
7,155,155,2,2,0,1,0
17,162,162,9,9,0,1,0
16,189,189,7,7,0,1,0
13,194,194,22,14,8,2,1
4,224,224,18,15,3,2,1
10,253,253,12,12,0,1,0
11,273,273,35,19,16,3,2
12,277,277,6,6,0,1,0
1,284,284,62,28,34,4,3
5,332,332,3,3,0,1,0
15,351,351,78,68,10,2,1
9,352,352,30,30,0,1,0
14,434,434,104,23,81,4,3
0,441,441,4,4,0,1,0

19,101,101,8,8,0,1,0
21,113,113,12,12,0,1,0
9,155,155,1,1,0,1,0
8,160,160,24,3,21,4,3
12,173,173,13,4,9,2,1
18,188,188,32,32,0,1,0
5,228,228,5,5,0,1,0
7,258,258,6,6,0,1,0
6,297,297,49,11,38,2,1
14,308,308,55,52,3,2,1
2,326,326,29,29,0,1,0
0,338,338,21,21,0,1,0
10,387,387,21,21,0,1,0
17,392,392,83,83,0,1,0
11,396,396,15,15,0,1,0
20,405,405,39,21,18,2,1
16,412,412,50,38,12,2,1
1,416,416,180,180,0,1,0
4,450,450,26,26,0,1,0
15,486,486,16,16,0,1,0
13,489,489,25,4,21,3,2
3,496,496,1,1,0,1,0

1,109,109,13,13,0,1,0
12,126,126,1,1,0,1,0
20,137,137,12,3,9,4,3
2,150,150,17,17,0,1,0
21,162,162,3,3,0,1,0
8,170,170,4,1,3,2,1
9,171,171,4,1,3,2,1
0,183,183,13,7,6,2,1
5,195,195,20,9,11,2,1
6,211,211,8,8,0,1,0
3,226,226,1,1,0,1,0
11,267,267,56,41,15,4,3
17,269,269,10,10,0,1,0
18,273,273,40,13,27,4,3
7,295,295,1,1,0,1,0
24,301,301,6,3,3,2,1
13,303,303,72,11,61,3,2
4,371,371,43,6,37,4,3
16,386,386,38,4,34,3,2
22,388,388,97,97,0,1,0
19,398,398,34,16,18,3,2
10,427,427,9,6,3,2,1
23,472,472,4,4,0,1,0
15,481,481,176,149,27,3,2
14,494,494,5,1,4,2,1

9,128,128,42,8,34,2,1
19,131,131,25,25,0,1,0
0,155,155,32,14,18,2,1
14,182,182,62,12,50,2,1
8,193,193,2,2,0,1,0
16,227,227,2,2,0,1,0
4,234,234,5,5,0,1,0
3,242,242,7,4,3,2,1
10,287,287,66,66,0,1,0
13,299,299,8,8,0,1,0
18,300,300,1,1,0,1,0
1,325,325,81,66,15,2,1
15,334,334,31,10,21,4,3
6,337,337,14,14,0,1,0
7,342,342,8,8,0,1,0
17,362,362,49,49,0,1,0
2,448,448,47,9,38,3,2
12,482,482,4,4,0,1,0
5,487,487,43,4,39,2,1
11,492,492,37,9,28,3,2

17,163,163,14,4,10,2,1
11,163,163,44,21,23,3,2
3,171,171,5,5,0,1,0
14,175,175,9,3,6,3,2
6,190,190,6,6,0,1,0
16,190,190,4,1,3,2,1
8,200,200,6,6,0,1,0
5,204,204,13,3,10,3,2
19,204,204,31,31,0,1,0
13,210,210,26,26,0,1,0
15,216,216,45,14,31,2,1
2,226,226,15,15,0,1,0
0,253,253,13,13,0,1,0
18,260,260,5,5,0,1,0
21,316,316,5,5,0,1,0
10,331,331,11,11,0,1,0
1,355,355,13,13,0,1,0
22,412,412,75,45,30,4,3
12,431,431,129,27,102,4,3
9,438,438,20,12,8,2,1
20,446,446,117,27,90,3,2
7,459,459,12,3,9,2,1
4,500,500,59,59,0,1,0

1,121,121,36,36,0,1,0
2,134,134,7,7,0,1,0
6,143,143,4,1,3,2,1
5,144,144,2,2,0,1,0
9,148,148,8,8,0,1,0
17,160,160,22,22,0,1,0
18,215,215,51,51,0,1,0
10,223,223,11,3,8,2,1
14,252,252,8,5,3,2,1
13,284,284,47,47,0,1,0
7,322,322,2,2,0,1,0
12,373,373,24,24,0,1,0
15,386,386,14,2,12,2,1
16,402,402,12,12,0,1,0
8,416,416,53,21,32,3,2
19,443,443,80,80,0,1,0
0,449,449,75,52,23,2,1
4,461,461,71,56,15,2,1
3,471,471,71,56,15,2,1
11,495,495,9,9,0,1,0
20,499,499,107,69,38,2,1

9,109,109,1,1,0,1,0
14,131,131,34,34,0,1,0
15,131,131,1,1,0,1,0
0,155,155,3,3,0,1,0
8,186,186,25,1,24,2,1
13,194,194,37,9,28,4,3
4,240,240,27,14,13,2,1
1,265,265,1,1,0,1,0
2,297,297,34,16,18,2,1
7,333,333,44,44,0,1,0
3,334,334,202,103,99,4,3
11,340,340,115,36,79,4,3
6,432,432,17,17,0,1,0
5,439,439,108,21,87,4,3
10,445,445,4,4,0,1,0
12,447,447,2,2,0,1,0

8,110,110,9,9,0,1,0
17,111,111,5,5,0,1,0
7,124,124,35,9,26,2,1
11,151,151,1,1,0,1,0
9,181,181,39,31,8,2,1
18,207,207,51,39,12,4,3
16,233,233,2,2,0,1,0
0,237,237,7,7,0,1,0
1,239,239,36,1,35,3,2
3,251,251,4,4,0,1,0
4,270,270,54,54,0,1,0
10,272,272,25,25,0,1,0
2,287,287,30,14,16,2,1
5,353,353,75,47,28,3,2
14,355,355,37,37,0,1,0
6,413,413,12,5,7,2,1
12,433,433,147,134,13,2,1
13,448,448,12,6,6,3,2
15,484,484,19,7,12,4,3

7,110,110,43,43,0,1,0
14,128,128,7,7,0,1,0
8,148,148,10,4,6,2,1
3,219,219,11,11,0,1,0
1,246,246,29,5,24,4,3
18,261,261,3,3,0,1,0
6,289,289,20,5,15,2,1
12,293,293,48,9,39,4,3
10,304,304,5,5,0,1,0
9,316,316,32,2,30,2,1
13,322,322,12,12,0,1,0
0,336,336,74,16,58,3,2
16,399,399,13,13,0,1,0
17,402,402,146,53,93,4,3
2,441,441,7,2,5,2,1
5,455,455,24,24,0,1,0
15,467,467,96,81,15,4,3
11,497,497,65,11,54,4,3
4,498,498,60,60,0,1,0

6,107,107,24,7,17,4,3
16,138,138,17,5,12,3,2
7,148,148,6,6,0,1,0
2,168,168,14,11,3,2,1
14,203,203,12,8,4,2,1
8,245,245,43,43,0,1,0
5,250,250,25,25,0,1,0
9,255,255,15,1,14,2,1
3,263,263,6,6,0,1,0
1,275,275,71,71,0,1,0
11,341,341,67,56,11,3,2
13,348,348,57,57,0,1,0
17,351,351,14,14,0,1,0
12,380,380,26,26,0,1,0
10,421,421,71,41,30,2,1
4,444,444,85,12,73,3,2
0,468,468,85,85,0,1,0
15,484,484,30,10,20,2,1

2,100,100,1,1,0,1,0
26,117,117,35,5,30,2,1
14,141,141,12,6,6,3,2
9,159,159,49,25,24,3,2
24,166,166,6,1,5,2,1
17,171,171,7,7,0,1,0
23,180,180,18,18,0,1,0
20,183,183,6,6,0,1,0
5,185,185,1,1,0,1,0
1,186,186,1,1,0,1,0
0,195,195,1,1,0,1,0
21,240,240,4,4,0,1,0
8,271,271,1,1,0,1,0
6,272,272,14,14,0,1,0
11,276,276,30,24,6,2,1
22,287,287,31,23,8,2,1
7,296,296,12,12,0,1,0
10,313,313,8,1,7,2,1
19,323,323,11,5,6,3,2
18,355,355,99,99,0,1,0
4,404,404,10,1,9,2,1
12,412,412,60,60,0,1,0
13,413,413,3,3,0,1,0
16,416,416,8,8,0,1,0
15,418,418,71,7,64,3,2
25,434,434,75,75,0,1,0
3,499,499,42,15,27,2,1

4,115,115,21,16,5,2,1
3,117,117,35,35,0,1,0
15,153,153,15,15,0,1,0
2,183,183,33,12,21,2,1
6,204,204,27,17,10,3,2
9,276,276,35,35,0,1,0
11,286,286,26,26,0,1,0
12,295,295,5,5,0,1,0
10,340,340,83,83,0,1,0
7,344,344,11,3,8,3,2
0,351,351,59,59,0,1,0
14,367,367,77,5,72,3,2
13,399,399,33,33,0,1,0
1,407,407,5,5,0,1,0
8,437,437,38,3,35,3,2
5,491,491,127,40,87,4,3

9,106,106,5,5,0,1,0
6,115,115,52,17,35,4,3
4,165,165,1,1,0,1,0
15,178,178,32,32,0,1,0
1,188,188,4,4,0,1,0
11,191,191,14,14,0,1,0
17,231,231,7,7,0,1,0
3,246,246,75,56,19,2,1
16,246,246,9,3,6,3,2
0,248,248,26,26,0,1,0
13,311,311,31,15,16,3,2
18,316,316,59,47,12,4,3
8,320,320,6,2,4,2,1
10,335,335,55,55,0,1,0
2,368,368,15,7,8,2,1
7,409,409,39,5,34,2,1
12,435,435,9,9,0,1,0
5,459,459,27,19,8,3,2
14,493,493,142,109,33,2,1

8,103,103,4,4,0,1,0
15,103,103,13,13,0,1,0
4,108,108,1,1,0,1,0
9,120,120,1,1,0,1,0
5,134,134,23,8,15,2,1
13,136,136,11,1,10,3,2
16,155,155,2,2,0,1,0
6,294,294,90,62,28,3,2
10,316,316,146,48,98,3,2
11,321,321,1,1,0,1,0
18,329,329,24,12,12,3,2
17,397,397,61,20,41,4,3
2,409,409,19,19,0,1,0
0,427,427,42,18,24,2,1
7,453,453,81,45,36,4,3
1,469,469,33,13,20,2,1
14,482,482,39,6,33,3,2
12,484,484,58,22,36,4,3
3,495,495,92,52,40,3,2

12,108,108,28,13,15,2,1
16,145,145,37,37,0,1,0
2,154,154,26,4,22,3,2
0,201,201,2,2,0,1,0
19,209,209,16,16,0,1,0
18,212,212,16,8,8,3,2
20,226,226,47,9,38,3,2
8,249,249,16,16,0,1,0
7,286,286,12,5,7,2,1
3,312,312,4,1,3,2,1
21,314,314,48,48,0,1,0
23,315,315,24,2,22,3,2
5,332,332,56,53,3,2,1
15,341,341,36,3,33,4,3
14,355,355,26,2,24,2,1
22,372,372,15,15,0,1,0
9,373,373,3,3,0,1,0
13,387,387,35,35,0,1,0
1,406,406,3,3,0,1,0
10,411,411,37,5,32,2,1
11,424,424,50,40,10,2,1
4,428,428,25,5,20,3,2
17,435,435,24,24,0,1,0
6,473,473,2,2,0,1,0

6,101,101,7,7,0,1,0
2,104,104,8,2,6,2,1
10,113,113,3,3,0,1,0
21,116,116,2,2,0,1,0
0,147,147,12,3,9,2,1
15,151,151,24,11,13,3,2
9,172,172,7,7,0,1,0
11,172,172,15,15,0,1,0
5,193,193,10,5,5,2,1
3,202,202,12,12,0,1,0
20,216,216,18,18,0,1,0
16,220,220,14,14,0,1,0
4,244,244,5,5,0,1,0
13,249,249,17,17,0,1,0
19,281,281,66,20,46,2,1
7,386,386,56,37,19,2,1
14,392,392,16,13,3,2,1
18,392,392,62,22,40,3,2
12,421,421,116,26,90,4,3
22,453,453,100,55,45,4,3
1,453,453,54,54,0,1,0
8,480,480,23,23,0,1,0
17,499,499,38,38,0,1,0

10,115,115,3,3,0,1,0
14,118,118,44,20,24,3,2
5,138,138,24,8,16,3,2
1,174,174,10,4,6,3,2
7,174,174,15,15,0,1,0
2,252,252,13,1,12,3,2
15,254,254,17,5,12,4,3
17,263,263,1,1,0,1,0
9,282,282,84,43,41,2,1
0,291,291,13,13,0,1,0
8,313,313,19,9,10,2,1
3,324,324,27,3,24,3,2
13,341,341,12,4,8,3,2
12,392,392,2,2,0,1,0
20,398,398,4,4,0,1,0
11,399,399,17,17,0,1,0
16,467,467,119,80,39,2,1
18,473,473,62,62,0,1,0
19,474,474,92,50,42,3,2
6,488,488,62,15,47,4,3
4,496,496,49,22,27,4,3

17,121,121,6,6,0,1,0
11,122,122,2,2,0,1,0
9,154,154,24,13,11,2,1
12,236,236,14,6,8,3,2
15,243,243,41,41,0,1,0
16,249,249,2,2,0,1,0
0,262,262,15,5,10,2,1
3,273,273,1,1,0,1,0
14,302,302,76,76,0,1,0
7,329,329,4,1,3,2,1
4,337,337,106,20,86,4,3
6,360,360,14,14,0,1,0
8,374,374,19,19,0,1,0
20,388,388,4,4,0,1,0
19,410,410,29,29,0,1,0
13,412,412,20,20,0,1,0
22,419,419,111,111,0,1,0
18,420,420,69,29,40,3,2
21,441,441,37,37,0,1,0
10,469,469,11,11,0,1,0
1,469,469,113,69,44,3,2
5,491,491,34,4,30,4,3
2,492,492,30,30,0,1,0

13,126,126,4,4,0,1,0
18,127,127,5,1,4,2,1
3,132,132,33,33,0,1,0
7,133,133,13,4,9,2,1
2,172,172,37,37,0,1,0
12,187,187,17,17,0,1,0
16,212,212,17,4,13,3,2
10,231,231,15,15,0,1,0
1,252,252,34,34,0,1,0
14,310,310,31,22,9,2,1
15,341,341,29,21,8,2,1
19,355,355,171,125,46,4,3
9,359,359,11,11,0,1,0
17,376,376,3,3,0,1,0
8,386,386,17,7,10,3,2
5,434,434,75,57,18,3,2
4,449,449,2,2,0,1,0
11,455,455,64,54,10,3,2
6,466,466,14,4,10,2,1
0,473,473,57,42,15,2,1

9,110,110,6,3,3,2,1
3,131,131,16,1,15,4,3
12,141,141,3,3,0,1,0
0,158,158,17,6,11,2,1
16,161,161,6,6,0,1,0
15,165,165,26,26,0,1,0
10,168,168,3,3,0,1,0
8,171,171,19,19,0,1,0
2,176,176,30,8,22,4,3
18,186,186,22,8,14,3,2
14,206,206,2,2,0,1,0
6,224,224,22,2,20,2,1
7,241,241,5,5,0,1,0
1,242,242,56,56,0,1,0
5,265,265,19,19,0,1,0
20,291,291,82,82,0,1,0
11,321,321,14,14,0,1,0
4,372,372,36,24,12,2,1
13,441,441,78,34,44,3,2
19,443,443,8,8,0,1,0
17,481,481,122,76,46,4,3

9,114,114,20,14,6,2,1
16,131,131,9,5,4,2,1
12,153,153,2,2,0,1,0
11,166,166,19,10,9,4,3
21,167,167,1,1,0,1,0
10,188,188,2,2,0,1,0
8,199,199,17,17,0,1,0
14,224,224,3,3,0,1,0
19,225,225,13,13,0,1,0
20,244,244,3,3,0,1,0
22,277,277,6,2,4,2,1
15,298,298,8,5,3,2,1
18,298,298,30,7,23,2,1
23,322,322,120,40,80,4,3
6,349,349,3,3,0,1,0
17,394,394,173,75,98,3,2
2,394,394,16,16,0,1,0
0,396,396,86,32,54,3,2
7,420,420,44,13,31,2,1
1,425,425,2,2,0,1,0
5,434,434,78,78,0,1,0
3,443,443,28,3,25,4,3
4,473,473,30,18,12,4,3
13,499,499,10,1,9,2,1

17,100,100,9,6,3,2,1
5,110,110,21,21,0,1,0
11,142,142,5,5,0,1,0
21,145,145,24,24,0,1,0
7,169,169,7,7,0,1,0
16,184,184,11,11,0,1,0
22,225,225,13,3,10,2,1
2,227,227,3,3,0,1,0
24,237,237,6,6,0,1,0
3,251,251,8,8,0,1,0
12,252,252,17,17,0,1,0
1,265,265,12,4,8,3,2
8,287,287,7,7,0,1,0
14,296,296,6,6,0,1,0
19,316,316,23,5,18,3,2
6,320,320,1,1,0,1,0
9,328,328,14,14,0,1,0
13,344,344,65,15,50,3,2
20,383,383,185,59,126,4,3
18,386,386,21,21,0,1,0
15,395,395,52,46,6,3,2
10,414,414,20,2,18,3,2
4,432,432,83,47,36,4,3
23,434,434,16,16,0,1,0
25,482,482,41,41,0,1,0
0,487,487,12,12,0,1,0

6,102,102,20,20,0,1,0
7,126,126,12,12,0,1,0
3,141,141,5,5,0,1,0
13,153,153,3,3,0,1,0
5,287,287,13,13,0,1,0
16,290,290,9,9,0,1,0
4,300,300,37,37,0,1,0
14,303,303,50,21,29,4,3
0,309,309,9,9,0,1,0
1,318,318,15,11,4,2,1
17,352,352,36,36,0,1,0
15,376,376,56,56,0,1,0
12,382,382,17,17,0,1,0
9,411,411,18,10,8,2,1
22,414,414,32,32,0,1,0
18,438,438,130,104,26,3,2
11,442,442,12,12,0,1,0
8,446,446,50,50,0,1,0
2,448,448,79,72,7,2,1
19,455,455,84,84,0,1,0
20,487,487,23,23,0,1,0
21,494,494,21,21,0,1,0
10,495,495,62,62,0,1,0

11,110,110,17,17,0,1,0
14,116,116,22,11,11,2,1
2,157,157,16,16,0,1,0
9,176,176,20,20,0,1,0
12,181,181,3,3,0,1,0
3,191,191,96,44,52,3,2
5,224,224,14,14,0,1,0
4,284,284,17,17,0,1,0
16,320,320,32,2,30,2,1
6,328,328,32,32,0,1,0
1,353,353,40,40,0,1,0
0,363,363,7,2,5,2,1
10,369,369,18,4,14,3,2
17,396,396,96,96,0,1,0
8,404,404,63,5,58,3,2
7,415,415,60,60,0,1,0
15,482,482,28,10,18,3,2
13,499,499,21,2,19,4,3

9,109,109,4,4,0,1,0
16,170,170,3,3,0,1,0
2,180,180,8,8,0,1,0
0,249,249,77,77,0,1,0
5,256,256,8,4,4,2,1
18,264,264,40,15,25,2,1
3,309,309,17,17,0,1,0
7,311,311,14,14,0,1,0
15,312,312,12,5,7,2,1
8,316,316,109,49,60,4,3
10,324,324,29,13,16,2,1
11,327,327,3,3,0,1,0
1,347,347,26,2,24,2,1
4,358,358,6,1,5,2,1
14,379,379,142,22,120,4,3
17,397,397,37,31,6,2,1
6,403,403,73,73,0,1,0
12,454,454,28,3,25,3,2
13,479,479,119,35,84,3,2

9,104,104,2,2,0,1,0
16,106,106,2,2,0,1,0
20,146,146,3,3,0,1,0
8,184,184,7,7,0,1,0
4,227,227,3,3,0,1,0
11,273,273,45,24,21,2,1
5,285,285,8,4,4,2,1
14,300,300,22,22,0,1,0
7,301,301,12,12,0,1,0
19,308,308,56,34,22,3,2
3,313,313,39,39,0,1,0
2,313,313,31,31,0,1,0
21,329,329,17,17,0,1,0
10,371,371,51,51,0,1,0
17,388,388,16,7,9,2,1
0,405,405,39,39,0,1,0
1,410,410,109,53,56,4,3
15,440,440,123,107,16,3,2
18,443,443,128,80,48,3,2
6,444,444,34,16,18,2,1
13,478,478,60,18,42,4,3
12,492,492,16,2,14,3,2

5,134,134,1,1,0,1,0
2,139,139,12,12,0,1,0
6,168,168,15,15,0,1,0
7,170,170,4,4,0,1,0
13,175,175,23,23,0,1,0
14,212,212,23,23,0,1,0
9,234,234,42,30,12,3,2
8,317,317,12,3,9,3,2
10,317,317,45,45,0,1,0
18,331,331,7,1,6,2,1
4,348,348,32,18,14,2,1
12,350,350,14,14,0,1,0
19,354,354,45,45,0,1,0
20,373,373,159,117,42,2,1
1,383,383,14,2,12,3,2
15,407,407,59,9,50,2,1
16,428,428,23,23,0,1,0
0,429,429,65,65,0,1,0
11,431,431,19,19,0,1,0
3,433,433,111,87,24,4,3
17,467,467,9,9,0,1,0

16,133,133,2,2,0,1,0
3,140,140,3,3,0,1,0
21,143,143,21,4,17,4,3
6,173,173,2,2,0,1,0
17,179,179,14,6,8,3,2
1,185,185,1,1,0,1,0
8,199,199,40,40,0,1,0
2,205,205,10,4,6,3,2
14,208,208,52,28,24,3,2
20,264,264,2,2,0,1,0
10,284,284,21,15,6,3,2
11,315,315,21,21,0,1,0
7,323,323,40,40,0,1,0
13,341,341,75,75,0,1,0
12,353,353,37,37,0,1,0
9,382,382,40,1,39,4,3
18,385,385,7,7,0,1,0
23,385,385,16,3,13,2,1
4,390,390,1,1,0,1,0
5,404,404,20,2,18,4,3
15,447,447,58,58,0,1,0
0,460,460,31,31,0,1,0
22,467,467,24,5,19,2,1
19,488,488,187,121,66,4,3

11,129,129,24,24,0,1,0
14,151,151,21,21,0,1,0
15,225,225,3,3,0,1,0
6,231,231,22,13,9,4,3
8,279,279,14,14,0,1,0
1,314,314,25,4,21,4,3
16,340,340,8,8,0,1,0
20,350,350,22,10,12,2,1
2,374,374,5,5,0,1,0
4,404,404,23,2,21,2,1
5,410,410,21,3,18,2,1
7,422,422,54,54,0,1,0
12,424,424,63,12,51,4,3
18,433,433,115,109,6,3,2
13,439,439,18,18,0,1,0
3,440,440,57,41,16,3,2
9,465,465,131,89,42,4,3
19,466,466,22,22,0,1,0
0,475,475,69,69,0,1,0
17,481,481,93,89,4,2,1
10,485,485,34,10,24,4,3

16,100,100,23,23,0,1,0
14,150,150,22,10,12,3,2
20,153,153,2,2,0,1,0
15,176,176,12,12,0,1,0
13,210,210,28,20,8,3,2
10,235,235,20,20,0,1,0
1,270,270,2,2,0,1,0
18,282,282,56,10,46,3,2
17,282,282,7,7,0,1,0
5,299,299,1,1,0,1,0
3,306,306,15,6,9,2,1
11,340,340,9,9,0,1,0
8,344,344,3,3,0,1,0
7,368,368,34,4,30,4,3
9,381,381,2,2,0,1,0
6,384,384,79,46,33,4,3
12,401,401,32,25,7,2,1
0,412,412,35,35,0,1,0
21,413,413,34,1,33,4,3
2,463,463,158,149,9,4,3
19,468,468,68,22,46,4,3
4,479,479,92,71,21,4,3

17,139,139,34,34,0,1,0
10,178,178,21,21,0,1,0
7,195,195,14,2,12,2,1
18,246,246,70,70,0,1,0
0,250,250,35,29,6,2,1
4,254,254,2,2,0,1,0
2,276,276,12,12,0,1,0
15,276,276,40,17,23,2,1
6,300,300,86,62,24,4,3
19,303,303,6,6,0,1,0
14,339,339,54,54,0,1,0
12,364,364,24,7,17,2,1
8,389,389,51,51,0,1,0
16,398,398,5,5,0,1,0
20,415,415,7,2,5,2,1
13,430,430,69,69,0,1,0
1,430,430,87,48,39,2,1
3,443,443,7,7,0,1,0
5,455,455,37,37,0,1,0
9,464,464,2,2,0,1,0
11,482,482,2,2,0,1,0

4,118,118,27,27,0,1,0
7,126,126,2,2,0,1,0
1,135,135,28,13,15,4,3
9,141,141,33,30,3,2,1
13,155,155,30,14,16,2,1
14,168,168,44,44,0,1,0
18,169,169,1,1,0,1,0
11,176,176,51,46,5,2,1
3,251,251,52,48,4,2,1
10,273,273,20,20,0,1,0
17,282,282,20,20,0,1,0
19,299,299,9,9,0,1,0
2,352,352,21,6,15,4,3
12,353,353,55,41,14,3,2
8,392,392,17,9,8,2,1
5,411,411,1,1,0,1,0
6,426,426,21,21,0,1,0
15,436,436,3,3,0,1,0
16,447,447,14,2,12,2,1
0,464,464,27,22,5,2,1

8,100,100,1,1,0,1,0
16,105,105,9,5,4,2,1
3,247,247,97,3,94,3,2
14,255,255,88,88,0,1,0
2,294,294,70,70,0,1,0
5,304,304,1,1,0,1,0
7,320,320,16,7,9,4,3
13,324,324,10,10,0,1,0
11,337,337,10,10,0,1,0
6,344,344,72,72,0,1,0
15,348,348,34,5,29,2,1
10,386,386,48,40,8,3,2
4,389,389,8,4,4,2,1
0,458,458,50,41,9,4,3
9,468,468,83,83,0,1,0
12,471,471,76,76,0,1,0
1,493,493,63,11,52,4,3

12,164,164,41,7,34,3,2
15,180,180,15,5,10,3,2
7,191,191,14,2,12,3,2
11,196,196,14,14,0,1,0
1,199,199,23,23,0,1,0
17,207,207,20,20,0,1,0
2,274,274,88,60,28,4,3
5,310,310,13,13,0,1,0
0,319,319,83,38,45,2,1
9,319,319,3,3,0,1,0
3,370,370,7,2,5,2,1
8,384,384,99,99,0,1,0
4,393,393,72,72,0,1,0
14,402,402,1,1,0,1,0
6,413,413,36,36,0,1,0
13,420,420,44,10,34,3,2
16,429,429,67,26,41,2,1
10,468,468,39,39,0,1,0

1,115,115,16,4,12,3,2
6,162,162,14,4,10,2,1
11,189,189,26,1,25,2,1
20,202,202,3,3,0,1,0
9,204,204,15,8,7,2,1
0,237,237,13,1,12,4,3
5,246,246,7,7,0,1,0
8,252,252,1,1,0,1,0
19,281,281,18,18,0,1,0
15,293,293,72,41,31,2,1
16,300,300,12,1,11,2,1
3,323,323,27,10,17,2,1
23,338,338,35,35,0,1,0
4,348,348,18,18,0,1,0
14,385,385,157,151,6,3,2
12,392,392,58,4,54,4,3
2,411,411,4,1,3,2,1
17,413,413,18,2,16,3,2
10,431,431,20,5,15,4,3
13,441,441,25,25,0,1,0
7,455,455,82,28,54,4,3
22,465,465,42,11,31,4,3
18,485,485,37,37,0,1,0
21,486,486,16,16,0,1,0

8,113,113,20,8,12,3,2
2,152,152,10,10,0,1,0
9,175,175,12,12,0,1,0
14,181,181,2,2,0,1,0
10,191,191,54,36,18,3,2
4,220,220,5,2,3,2,1
12,236,236,1,1,0,1,0
16,247,247,56,56,0,1,0
11,267,267,2,2,0,1,0
5,269,269,9,9,0,1,0
1,346,346,52,52,0,1,0
0,391,391,15,15,0,1,0
15,401,401,51,51,0,1,0
3,440,440,111,75,36,4,3
6,444,444,61,61,0,1,0
13,453,453,11,8,3,2,1
17,492,492,96,40,56,3,2
7,500,500,200,59,141,4,3

5,100,100,5,2,3,2,1
9,117,117,3,3,0,1,0
20,152,152,2,2,0,1,0
15,152,152,5,5,0,1,0
18,170,170,19,7,12,4,3
14,207,207,42,42,0,1,0
8,211,211,34,13,21,4,3
11,308,308,12,1,11,2,1
0,311,311,14,14,0,1,0
19,311,311,28,17,11,2,1
17,336,336,18,4,14,2,1
2,340,340,38,38,0,1,0
3,342,342,103,89,14,2,1
16,348,348,48,17,31,3,2
12,413,413,27,10,17,2,1
13,413,413,27,27,0,1,0
22,415,415,18,5,13,2,1
21,422,422,37,37,0,1,0
1,434,434,24,24,0,1,0
7,435,435,1,1,0,1,0
10,451,451,51,51,0,1,0
4,453,453,2,2,0,1,0
6,472,472,29,14,15,4,3
23,482,482,165,99,66,3,2

0,105,105,1,1,0,1,0
15,116,116,12,6,6,2,1
12,154,154,1,1,0,1,0
2,156,156,14,14,0,1,0
17,184,184,25,25,0,1,0
21,185,185,26,26,0,1,0
4,197,197,2,2,0,1,0
16,224,224,81,35,46,2,1
13,228,228,26,26,0,1,0
1,251,251,3,3,0,1,0
5,255,255,37,3,34,3,2
14,266,266,1,1,0,1,0
8,268,268,5,1,4,2,1
10,293,293,26,11,15,4,3
3,321,321,4,4,0,1,0
11,333,333,20,20,0,1,0
19,362,362,50,10,40,3,2
9,439,439,11,11,0,1,0
18,468,468,50,2,48,3,2
7,479,479,241,109,132,4,3
20,489,489,6,6,0,1,0
6,493,493,62,45,17,2,1

8,127,127,3,3,0,1,0
14,159,159,5,5,0,1,0
4,168,168,21,7,14,3,2
17,189,189,16,16,0,1,0
19,193,193,14,14,0,1,0
12,205,205,35,15,20,2,1
13,227,227,18,6,12,3,2
3,251,251,47,47,0,1,0
1,255,255,1,1,0,1,0
10,285,285,2,2,0,1,0
16,296,296,36,6,30,3,2
20,317,317,58,42,16,3,2
18,327,327,101,26,75,4,3
9,328,328,6,6,0,1,0
5,332,332,94,94,0,1,0
7,365,365,99,99,0,1,0
6,423,423,31,5,26,3,2
15,438,438,25,25,0,1,0
11,468,468,4,1,3,2,1
2,483,483,12,12,0,1,0
0,495,495,42,42,0,1,0

1,118,118,1,1,0,1,0
9,140,140,17,5,12,4,3
17,141,141,23,23,0,1,0
4,142,142,13,1,12,2,1
20,174,174,12,3,9,2,1
10,182,182,32,32,0,1,0
0,198,198,7,3,4,2,1
16,250,250,89,16,73,3,2
18,253,253,14,14,0,1,0
2,254,254,14,14,0,1,0
14,284,284,13,13,0,1,0
13,334,334,39,39,0,1,0
3,339,339,46,9,37,2,1
6,383,383,95,95,0,1,0
12,389,389,3,3,0,1,0
5,416,416,48,48,0,1,0
11,423,423,4,4,0,1,0
19,428,428,73,29,44,3,2
15,434,434,55,37,18,3,2
7,475,475,7,4,3,2,1
8,487,487,49,49,0,1,0

10,113,113,1,1,0,1,0
11,127,127,4,4,0,1,0
7,146,146,12,12,0,1,0
9,159,159,25,15,10,2,1
15,160,160,57,45,12,3,2
6,164,164,27,4,23,2,1
21,226,226,41,23,18,4,3
19,271,271,22,22,0,1,0
14,275,275,25,25,0,1,0
13,276,276,24,6,18,4,3
20,331,331,26,26,0,1,0
16,335,335,36,19,17,2,1
12,337,337,75,75,0,1,0
17,342,342,12,12,0,1,0
23,376,376,13,13,0,1,0
22,391,391,6,2,4,2,1
1,401,401,8,8,0,1,0
3,417,417,27,15,12,2,1
0,446,446,58,58,0,1,0
5,450,450,15,6,9,4,3
2,450,450,26,1,25,2,1
4,460,460,11,1,10,2,1
8,492,492,9,6,3,2,1
18,496,496,68,18,50,2,1

6,160,160,21,21,0,1,0
18,161,161,16,1,15,4,3
3,170,170,4,4,0,1,0
16,176,176,48,48,0,1,0
7,190,190,9,1,8,2,1
17,209,209,21,21,0,1,0
9,219,219,7,7,0,1,0
11,241,241,43,33,10,3,2
19,249,249,3,3,0,1,0
0,274,274,26,3,23,2,1
14,305,305,32,8,24,2,1
8,361,361,48,48,0,1,0
23,368,368,14,4,10,3,2
10,376,376,2,2,0,1,0
5,384,384,10,10,0,1,0
12,385,385,10,10,0,1,0
2,406,406,38,3,35,3,2
22,406,406,21,21,0,1,0
13,408,408,20,5,15,4,3
21,411,411,29,19,10,2,1
20,420,420,28,28,0,1,0
1,436,436,34,13,21,2,1
15,437,437,132,132,0,1,0
4,479,479,88,41,47,2,1

8,103,103,7,1,6,2,1
7,106,106,5,5,0,1,0
13,132,132,24,18,6,3,2
1,133,133,1,1,0,1,0
14,135,135,8,8,0,1,0
11,146,146,4,4,0,1,0
0,156,156,11,11,0,1,0
2,163,163,16,16,0,1,0
19,186,186,49,13,36,3,2
5,195,195,12,12,0,1,0
17,226,226,82,1,81,4,3
6,316,316,73,52,21,4,3
18,324,324,21,16,5,2,1
4,339,339,38,33,5,2,1
10,354,354,81,81,0,1,0
20,365,365,34,22,12,2,1
12,397,397,33,33,0,1,0
3,404,404,11,6,5,2,1
15,405,405,1,1,0,1,0
16,420,420,3,3,0,1,0
21,425,425,2,2,0,1,0
9,427,427,53,48,5,2,1

14,108,108,1,1,0,1,0
17,115,115,24,17,7,2,1
11,158,158,2,2,0,1,0
12,161,161,18,18,0,1,0
1,174,174,10,10,0,1,0
4,228,228,1,1,0,1,0
0,244,244,83,83,0,1,0
5,246,246,14,4,10,2,1
13,266,266,21,12,9,2,1
3,296,296,39,21,18,4,3
9,311,311,8,5,3,2,1
2,315,315,4,4,0,1,0
8,334,334,7,7,0,1,0
22,349,349,32,8,24,4,3
21,357,357,51,3,48,2,1
19,367,367,31,11,20,2,1
15,383,383,47,47,0,1,0
7,388,388,99,95,4,2,1
20,394,394,9,9,0,1,0
18,414,414,101,15,86,4,3
6,428,428,6,6,0,1,0
10,432,432,26,14,12,4,3
16,490,490,58,38,20,2,1

0,109,109,9,9,0,1,0
22,120,120,15,4,11,2,1
2,136,136,20,11,9,4,3
1,170,170,7,7,0,1,0
6,170,170,24,8,16,2,1
23,221,221,3,3,0,1,0
4,223,223,22,10,12,2,1
14,238,238,7,7,0,1,0
5,246,246,1,1,0,1,0
7,255,255,3,3,0,1,0
13,271,271,11,11,0,1,0
19,276,276,54,41,13,2,1
16,277,277,39,39,0,1,0
11,294,294,19,10,9,4,3
12,300,300,19,19,0,1,0
3,306,306,23,23,0,1,0
21,325,325,74,6,68,3,2
18,330,330,36,36,0,1,0
24,360,360,25,25,0,1,0
17,386,386,32,32,0,1,0
15,399,399,51,21,30,2,1
10,404,404,72,72,0,1,0
9,410,410,35,9,26,4,3
20,433,433,10,10,0,1,0
8,498,498,20,20,0,1,0

13,104,104,1,1,0,1,0
27,111,111,4,4,0,1,0
24,115,115,6,6,0,1,0
9,150,150,9,9,0,1,0
10,154,154,26,15,11,2,1
8,208,208,1,1,0,1,0
4,210,210,39,5,34,3,2
0,215,215,8,8,0,1,0
15,232,232,4,4,0,1,0
5,255,255,10,3,7,2,1
21,282,282,8,8,0,1,0
25,299,299,71,71,0,1,0
20,317,317,20,4,16,2,1
1,325,325,26,26,0,1,0
26,329,329,32,32,0,1,0
29,329,329,60,13,47,2,1
7,338,338,18,18,0,1,0
18,359,359,4,4,0,1,0
6,373,373,14,14,0,1,0
12,376,376,2,2,0,1,0
2,391,391,1,1,0,1,0
19,403,403,62,62,0,1,0
14,403,403,59,59,0,1,0
22,426,426,109,109,0,1,0
17,436,436,17,6,11,4,3
23,446,446,19,2,17,2,1
11,454,454,19,19,0,1,0
16,462,462,2,2,0,1,0
3,465,465,2,2,0,1,0
28,477,477,63,63,0,1,0

12,101,101,23,2,21,4,3
3,114,114,9,9,0,1,0
4,125,125,4,4,0,1,0
17,176,176,32,16,16,2,1
15,189,189,29,11,18,2,1
16,203,203,4,1,3,2,1
10,207,207,4,4,0,1,0
0,218,218,133,133,0,1,0
6,233,233,12,12,0,1,0
1,249,249,44,44,0,1,0
5,262,262,14,2,12,4,3
7,293,293,14,14,0,1,0
13,296,296,2,2,0,1,0
14,302,302,29,5,24,4,3
8,375,375,16,16,0,1,0
11,375,375,7,7,0,1,0
2,382,382,3,3,0,1,0
9,398,398,55,33,22,2,1
18,404,404,106,106,0,1,0

12,125,125,17,17,0,1,0
16,135,135,11,5,6,2,1
0,141,141,18,18,0,1,0
10,157,157,5,5,0,1,0
8,178,178,24,24,0,1,0
7,204,204,42,8,34,2,1
3,229,229,15,5,10,3,2
5,242,242,14,6,8,3,2
1,256,256,84,62,22,4,3
9,287,287,57,57,0,1,0
4,299,299,12,12,0,1,0
15,319,319,3,3,0,1,0
2,326,326,27,27,0,1,0
13,344,344,113,27,86,3,2
17,366,366,7,7,0,1,0
14,398,398,38,3,35,2,1
11,412,412,40,40,0,1,0
6,468,468,92,40,52,4,3

4,101,101,1,1,0,1,0
20,136,136,6,6,0,1,0
10,172,172,17,17,0,1,0
22,173,173,21,18,3,2,1
30,178,178,20,5,15,2,1
13,193,193,3,3,0,1,0
14,201,201,9,9,0,1,0
7,220,220,15,15,0,1,0
27,228,228,15,6,9,4,3
24,234,234,11,3,8,3,2
23,258,258,22,22,0,1,0
9,269,269,9,2,7,2,1
0,269,269,3,3,0,1,0
8,282,282,9,9,0,1,0
12,291,291,20,2,18,3,2
28,345,345,31,2,29,3,2
17,351,351,21,3,18,4,3
1,358,358,23,20,3,2,1
6,364,364,29,18,11,2,1
19,381,381,65,1,64,3,2
29,388,388,174,54,120,4,3
2,411,411,14,14,0,1,0
21,415,415,12,1,11,2,1
18,421,421,66,57,9,2,1
11,442,442,18,18,0,1,0
15,452,452,7,7,0,1,0
16,456,456,1,1,0,1,0
3,475,475,1,1,0,1,0
26,477,477,9,9,0,1,0
25,484,484,49,5,44,3,2
5,496,496,27,13,14,3,2

24,137,137,15,3,12,4,3
15,148,148,1,1,0,1,0
9,156,156,3,3,0,1,0
17,166,166,3,3,0,1,0
20,171,171,2,2,0,1,0
14,175,175,5,5,0,1,0
0,215,215,10,10,0,1,0
8,256,256,5,1,4,2,1
25,282,282,116,11,105,4,3
6,292,292,25,14,11,2,1
3,315,315,12,12,0,1,0
10,322,322,30,30,0,1,0
27,328,328,21,21,0,1,0
16,343,343,13,13,0,1,0
2,361,361,18,18,0,1,0
13,362,362,35,35,0,1,0
11,363,363,10,5,5,2,1
19,389,389,31,25,6,2,1
22,412,412,35,35,0,1,0
5,413,413,116,116,0,1,0
4,425,425,52,52,0,1,0
21,436,436,82,6,76,3,2
23,470,470,7,7,0,1,0
7,476,476,9,9,0,1,0
26,476,476,28,2,26,2,1
1,487,487,43,43,0,1,0
12,497,497,12,4,8,3,2
18,499,499,44,8,36,4,3

28,103,103,2,2,0,1,0
4,106,106,8,8,0,1,0
16,131,131,1,1,0,1,0
7,158,158,9,9,0,1,0
9,161,161,5,5,0,1,0
23,182,182,77,13,64,3,2
8,201,201,1,1,0,1,0
26,222,222,64,30,34,4,3
11,244,244,8,8,0,1,0
3,246,246,12,12,0,1,0
10,251,251,9,2,7,2,1
27,251,251,8,8,0,1,0
29,256,256,1,1,0,1,0
20,283,283,16,16,0,1,0
14,286,286,32,9,23,2,1
22,288,288,4,4,0,1,0
15,313,313,14,14,0,1,0
6,318,318,3,3,0,1,0
24,318,318,24,8,16,2,1
21,320,320,54,54,0,1,0
13,327,327,44,44,0,1,0
1,335,335,39,39,0,1,0
25,354,354,15,2,13,3,2
2,415,415,34,34,0,1,0
18,431,431,2,2,0,1,0
19,447,447,23,23,0,1,0
12,469,469,55,13,42,3,2
0,474,474,21,21,0,1,0
17,484,484,31,31,0,1,0
5,500,500,13,1,12,3,2

18,111,111,1,1,0,1,0
20,118,118,6,2,4,2,1
14,122,122,11,11,0,1,0
9,141,141,19,3,16,2,1
13,182,182,13,13,0,1,0
3,197,197,10,10,0,1,0
1,224,224,1,1,0,1,0
7,252,252,11,11,0,1,0
0,291,291,1,1,0,1,0
6,293,293,20,9,11,2,1
22,353,353,42,22,20,3,2
19,367,367,8,8,0,1,0
15,368,368,33,17,16,3,2
5,376,376,12,8,4,2,1
4,380,380,46,7,39,3,2
16,384,384,137,137,0,1,0
11,387,387,118,26,92,3,2
12,395,395,18,4,14,3,2
8,398,398,68,26,42,4,3
2,430,430,44,5,39,4,3
17,470,470,61,34,27,4,3
21,478,478,89,89,0,1,0
10,488,488,10,1,9,4,3

3,109,109,4,4,0,1,0
2,110,110,3,3,0,1,0
5,145,145,11,11,0,1,0
4,160,160,1,1,0,1,0
12,166,166,2,2,0,1,0
18,211,211,31,31,0,1,0
16,243,243,62,31,31,4,3
10,265,265,45,45,0,1,0
19,290,290,31,31,0,1,0
15,308,308,27,20,7,2,1
17,324,324,51,24,27,4,3
7,354,354,107,60,47,2,1
0,419,419,132,83,49,2,1
6,423,423,1,1,0,1,0
8,425,425,30,30,0,1,0
9,458,458,52,52,0,1,0
11,462,462,32,8,24,4,3
13,472,472,6,6,0,1,0
14,479,479,49,23,26,2,1
1,490,490,74,59,15,4,3

3,126,126,7,7,0,1,0
12,132,132,4,4,0,1,0
0,144,144,12,1,11,2,1
20,156,156,4,1,3,2,1
8,157,157,7,7,0,1,0
4,158,158,1,1,0,1,0
9,186,186,10,10,0,1,0
1,199,199,40,1,39,2,1
2,208,208,24,12,12,4,3
14,212,212,55,26,29,4,3
19,224,224,19,19,0,1,0
16,280,280,25,25,0,1,0
18,307,307,77,77,0,1,0
10,374,374,20,2,18,2,1
13,375,375,36,28,8,3,2
5,388,388,12,9,3,2,1
11,390,390,10,4,6,3,2
17,391,391,14,4,10,3,2
7,411,411,51,21,30,4,3
15,412,412,90,90,0,1,0
6,460,460,153,75,78,4,3

15,107,107,46,46,0,1,0
9,128,128,8,8,0,1,0
8,141,141,9,9,0,1,0
10,155,155,9,9,0,1,0
5,160,160,3,3,0,1,0
14,161,161,25,25,0,1,0
13,207,207,8,1,7,2,1
2,244,244,14,14,0,1,0
1,254,254,22,22,0,1,0
11,322,322,10,10,0,1,0
6,385,385,27,27,0,1,0
7,391,391,30,14,16,3,2
3,439,439,72,72,0,1,0
0,458,458,145,109,36,4,3
4,466,466,215,155,60,4,3
12,476,476,68,68,0,1,0

9,111,111,23,23,0,1,0
6,149,149,1,1,0,1,0
0,179,179,28,8,20,3,2
7,193,193,15,15,0,1,0
18,201,201,18,18,0,1,0
17,246,246,10,10,0,1,0
3,293,293,49,18,31,4,3
10,308,308,82,82,0,1,0
12,327,327,7,7,0,1,0
11,329,329,28,28,0,1,0
4,351,351,11,11,0,1,0
13,370,370,23,23,0,1,0
1,383,383,66,44,22,2,1
8,392,392,148,148,0,1,0
5,455,455,26,4,22,2,1
16,474,474,47,47,0,1,0
15,478,478,56,2,54,3,2
2,483,483,26,26,0,1,0
14,493,493,65,65,0,1,0

9,135,135,4,4,0,1,0
21,144,144,34,34,0,1,0
5,153,153,8,2,6,3,2
10,178,178,1,1,0,1,0
0,192,192,9,9,0,1,0
13,207,207,6,6,0,1,0
11,209,209,22,22,0,1,0
8,258,258,52,9,43,2,1
2,270,270,17,17,0,1,0
7,295,295,5,1,4,2,1
20,318,318,61,61,0,1,0
3,378,378,13,1,12,4,3
17,381,381,43,43,0,1,0
18,383,383,28,28,0,1,0
6,387,387,130,130,0,1,0
22,389,389,30,30,0,1,0
1,391,391,12,4,8,2,1
4,393,393,3,3,0,1,0
12,405,405,69,39,30,4,3
14,409,409,96,96,0,1,0
15,448,448,14,1,13,2,1
19,450,450,37,9,28,4,3
16,457,457,22,22,0,1,0

1,130,130,2,2,0,1,0
10,135,135,5,5,0,1,0
27,136,136,4,4,0,1,0
6,168,168,1,1,0,1,0
22,181,181,36,12,24,3,2
12,182,182,6,6,0,1,0
28,203,203,31,28,3,2,1
11,203,203,12,8,4,2,1
8,208,208,18,8,10,3,2
17,215,215,12,12,0,1,0
16,237,237,36,36,0,1,0
19,258,258,10,2,8,3,2
25,295,295,30,21,9,4,3
14,298,298,11,3,8,3,2
26,307,307,26,11,15,3,2
23,312,312,73,53,20,2,1
20,323,323,47,3,44,2,1
21,337,337,16,16,0,1,0
5,352,352,38,38,0,1,0
7,371,371,23,6,17,2,1
4,377,377,53,53,0,1,0
13,385,385,6,3,3,2,1
15,389,389,11,11,0,1,0
9,390,390,15,15,0,1,0
24,401,401,35,5,30,4,3
18,417,417,24,4,20,3,2
3,440,440,22,22,0,1,0
0,470,470,3,3,0,1,0
2,483,483,55,51,4,2,1

0,104,104,1,1,0,1,0
5,140,140,6,2,4,2,1
15,156,156,13,4,9,4,3
12,177,177,12,12,0,1,0
13,182,182,43,27,16,3,2
19,202,202,4,1,3,2,1
14,232,232,3,3,0,1,0
17,245,245,56,56,0,1,0
3,256,256,58,28,30,2,1
18,307,307,28,4,24,3,2
4,339,339,12,4,8,3,2
8,344,344,34,14,20,4,3
16,363,363,53,53,0,1,0
20,367,367,27,14,13,2,1
6,395,395,19,19,0,1,0
21,418,418,68,35,33,4,3
11,420,420,5,5,0,1,0
2,421,421,50,7,43,2,1
7,435,435,10,10,0,1,0
9,444,444,18,18,0,1,0
10,481,481,206,206,0,1,0
1,494,494,9,9,0,1,0

1,129,129,5,1,4,2,1
7,167,167,23,1,22,3,2
2,170,170,8,8,0,1,0
4,189,189,4,4,0,1,0
12,210,210,15,15,0,1,0
8,215,215,1,1,0,1,0
3,217,217,1,1,0,1,0
17,225,225,86,86,0,1,0
16,237,237,23,17,6,2,1
10,239,239,24,24,0,1,0
24,240,240,13,13,0,1,0
13,255,255,3,3,0,1,0
20,273,273,4,4,0,1,0
6,278,278,11,11,0,1,0
5,279,279,24,24,0,1,0
14,283,283,10,7,3,2,1
9,330,330,110,95,15,4,3
21,356,356,45,36,9,2,1
22,393,393,44,4,40,2,1
0,410,410,21,5,16,3,2
15,410,410,10,1,9,4,3
19,425,425,23,16,7,2,1
18,479,479,78,4,74,3,2
11,480,480,57,18,39,4,3
23,489,489,44,44,0,1,0

7,111,111,24,15,9,2,1
9,136,136,8,8,0,1,0
2,153,153,78,4,74,3,2
12,197,197,18,3,15,2,1
0,218,218,11,5,6,2,1
15,227,227,3,3,0,1,0
14,243,243,22,22,0,1,0
13,293,293,51,51,0,1,0
5,315,315,108,23,85,4,3
3,317,317,20,13,7,2,1
8,331,331,21,11,10,3,2
1,352,352,9,9,0,1,0
6,423,423,19,19,0,1,0
4,433,433,48,32,16,3,2
11,448,448,46,16,30,3,2
10,496,496,132,48,84,4,3

19,161,161,6,2,4,2,1
20,175,175,1,1,0,1,0
15,187,187,32,10,22,4,3
1,203,203,1,1,0,1,0
14,245,245,24,14,10,2,1
7,253,253,4,4,0,1,0
18,265,265,9,9,0,1,0
9,266,266,56,43,13,2,1
11,292,292,60,11,49,2,1
17,320,320,130,52,78,4,3
3,324,324,8,8,0,1,0
8,345,345,16,16,0,1,0
6,352,352,47,47,0,1,0
5,362,362,27,7,20,2,1
10,376,376,133,133,0,1,0
13,426,426,60,33,27,2,1
12,427,427,4,4,0,1,0
0,457,457,30,30,0,1,0
4,484,484,25,25,0,1,0
2,490,490,59,44,15,4,3
16,490,490,4,4,0,1,0

10,122,122,19,11,8,3,2
1,133,133,38,38,0,1,0
11,156,156,1,1,0,1,0
3,192,192,57,57,0,1,0
8,198,198,2,2,0,1,0
4,214,214,3,3,0,1,0
2,231,231,35,35,0,1,0
6,233,233,61,61,0,1,0
12,296,296,3,3,0,1,0
9,296,296,10,10,0,1,0
14,316,316,32,32,0,1,0
7,320,320,19,13,6,2,1
5,330,330,6,6,0,1,0
17,342,342,67,30,37,2,1
16,376,376,110,25,85,4,3
13,379,379,46,46,0,1,0
0,381,381,5,5,0,1,0
15,381,381,74,74,0,1,0

9,102,102,28,15,13,2,1
5,109,109,7,7,0,1,0
20,112,112,43,38,5,2,1
17,186,186,15,15,0,1,0
21,190,190,1,1,0,1,0
1,194,194,4,4,0,1,0
16,236,236,17,17,0,1,0
3,304,304,15,5,10,2,1
8,310,310,21,13,8,3,2
0,343,343,21,3,18,3,2
22,378,378,47,19,28,3,2
19,384,384,22,22,0,1,0
14,397,397,36,4,32,3,2
18,402,402,8,3,5,2,1
4,415,415,28,28,0,1,0
11,415,415,51,33,18,2,1
10,427,427,19,19,0,1,0
13,431,431,99,45,54,4,3
15,441,441,72,18,54,4,3
7,448,448,5,5,0,1,0
12,465,465,11,11,0,1,0
23,474,474,57,57,0,1,0
6,480,480,1,1,0,1,0
2,487,487,30,6,24,3,2

1,108,108,20,20,0,1,0
12,140,140,20,20,0,1,0
13,140,140,24,24,0,1,0
2,238,238,40,40,0,1,0
4,263,263,33,22,11,2,1
10,276,276,6,6,0,1,0
9,314,314,40,32,8,3,2
7,329,329,65,65,0,1,0
5,341,341,8,8,0,1,0
0,347,347,216,216,0,1,0
6,353,353,32,8,24,3,2
3,395,395,1,1,0,1,0
11,418,418,93,93,0,1,0
8,449,449,19,19,0,1,0
14,472,472,39,39,0,1,0

14,111,111,22,10,12,2,1
4,132,132,3,3,0,1,0
1,135,135,3,3,0,1,0
3,162,162,9,1,8,3,2
7,173,173,1,1,0,1,0
5,198,198,37,37,0,1,0
15,231,231,2,2,0,1,0
12,291,291,4,4,0,1,0
0,342,342,34,31,3,2,1
8,356,356,54,54,0,1,0
13,366,366,31,31,0,1,0
10,390,390,25,19,6,2,1
16,407,407,139,10,129,4,3
11,434,434,102,27,75,4,3
6,447,447,153,153,0,1,0
9,481,481,8,8,0,1,0
2,487,487,181,123,58,4,3

13,112,112,3,3,0,1,0
10,153,153,10,1,9,4,3
2,161,161,36,36,0,1,0
6,167,167,3,3,0,1,0
15,181,181,9,3,6,2,1
16,183,183,14,14,0,1,0
14,198,198,76,76,0,1,0
9,216,216,7,7,0,1,0
7,298,298,38,38,0,1,0
5,320,320,78,56,22,3,2
11,335,335,14,5,9,3,2
1,345,345,71,71,0,1,0
4,402,402,15,3,12,2,1
12,409,409,1,1,0,1,0
3,447,447,132,100,32,2,1
0,478,478,39,7,32,3,2
8,492,492,155,56,99,4,3

13,108,108,7,2,5,2,1
14,136,136,15,11,4,2,1
7,137,137,5,1,4,2,1
4,150,150,1,1,0,1,0
6,167,167,2,2,0,1,0
24,167,167,16,16,0,1,0
5,178,178,11,11,0,1,0
10,180,180,12,8,4,2,1
0,201,201,1,1,0,1,0
27,212,212,6,6,0,1,0
9,218,218,18,6,12,4,3
12,219,219,17,17,0,1,0
28,246,246,51,51,0,1,0
20,248,248,8,2,6,3,2
18,257,257,14,9,5,2,1
17,267,267,24,13,11,2,1
3,270,270,5,5,0,1,0
23,286,286,24,24,0,1,0
26,332,332,1,1,0,1,0
22,358,358,145,145,0,1,0
21,388,388,36,3,33,4,3
11,394,394,8,4,4,2,1
19,410,410,91,43,48,3,2
8,415,415,10,10,0,1,0
25,433,433,8,8,0,1,0
2,445,445,33,23,10,3,2
15,445,445,19,19,0,1,0
29,458,458,68,68,0,1,0
16,479,479,13,5,8,2,1
1,492,492,2,2,0,1,0

8,113,113,11,7,4,2,1
4,143,143,38,17,21,4,3
10,151,151,17,17,0,1,0
11,155,155,77,77,0,1,0
5,159,159,25,25,0,1,0
14,205,205,14,4,10,2,1
9,228,228,15,1,14,2,1
6,323,323,19,19,0,1,0
17,343,343,24,24,0,1,0
7,349,349,57,57,0,1,0
3,394,394,14,5,9,2,1
0,396,396,1,1,0,1,0
12,415,415,3,3,0,1,0
16,436,436,20,20,0,1,0
1,438,438,49,49,0,1,0
15,454,454,37,37,0,1,0
13,469,469,34,3,31,2,1
2,490,490,150,136,14,2,1

5,117,117,6,6,0,1,0
9,121,121,5,5,0,1,0
7,133,133,3,3,0,1,0
8,153,153,3,3,0,1,0
11,171,171,5,5,0,1,0
17,204,204,32,17,15,2,1
10,264,264,24,10,14,2,1
15,282,282,36,26,10,2,1
16,292,292,25,25,0,1,0
13,310,310,13,7,6,2,1
2,360,360,47,29,18,4,3
3,371,371,126,122,4,2,1
1,374,374,22,9,13,2,1
12,378,378,10,10,0,1,0
14,443,443,21,21,0,1,0
0,455,455,114,114,0,1,0
19,456,456,128,45,83,4,3
18,481,481,110,110,0,1,0
4,498,498,76,76,0,1,0
6,499,499,18,4,14,2,1

7,122,122,6,6,0,1,0
12,174,174,13,13,0,1,0
2,181,181,1,1,0,1,0
20,190,190,10,6,4,2,1
17,207,207,31,16,15,4,3
0,210,210,17,17,0,1,0
16,214,214,22,2,20,3,2
22,222,222,11,2,9,4,3
5,231,231,1,1,0,1,0
1,252,252,1,1,0,1,0
8,256,256,18,6,12,3,2
3,275,275,7,4,3,2,1
4,281,281,7,7,0,1,0
21,304,304,33,29,4,2,1
13,319,319,7,7,0,1,0
11,335,335,94,56,38,2,1
14,357,357,13,13,0,1,0
19,357,357,27,27,0,1,0
18,382,382,107,107,0,1,0
15,395,395,3,3,0,1,0
24,415,415,5,5,0,1,0
6,430,430,110,110,0,1,0
9,440,440,38,38,0,1,0
23,467,467,130,112,18,4,3
10,486,486,39,39,0,1,0

12,104,104,3,3,0,1,0
19,117,117,3,3,0,1,0
6,119,119,15,15,0,1,0
18,128,128,4,4,0,1,0
23,157,157,26,14,12,2,1
27,177,177,17,5,12,3,2
14,179,179,15,1,14,3,2
16,181,181,6,2,4,2,1
13,189,189,8,8,0,1,0
7,190,190,8,8,0,1,0
15,209,209,4,4,0,1,0
9,222,222,15,3,12,3,2
10,222,222,26,26,0,1,0
24,255,255,38,38,0,1,0
0,264,264,26,14,12,2,1
8,279,279,49,38,11,2,1
2,280,280,24,24,0,1,0
5,285,285,3,3,0,1,0
11,292,292,11,4,7,2,1
26,325,325,1,1,0,1,0
17,341,341,12,3,9,4,3
20,382,382,50,10,40,2,1
22,392,392,90,9,81,4,3
1,394,394,11,7,4,2,1
21,448,448,125,115,10,2,1
28,449,449,17,3,14,3,2
4,452,452,1,1,0,1,0
25,462,462,2,2,0,1,0
3,496,496,19,7,12,4,3

10,183,183,56,56,0,1,0
8,283,283,61,28,33,4,3
4,288,288,51,51,0,1,0
1,303,303,109,80,29,2,1
12,334,334,13,13,0,1,0
0,356,356,234,185,49,2,1
2,378,378,32,20,12,3,2
3,380,380,7,7,0,1,0
6,414,414,26,26,0,1,0
11,415,415,13,1,12,2,1
9,422,422,29,2,27,4,3
5,428,428,31,31,0,1,0
7,459,459,56,32,24,2,1

15,102,102,7,7,0,1,0
5,110,110,23,23,0,1,0
16,112,112,4,4,0,1,0
4,156,156,16,16,0,1,0
10,170,170,2,2,0,1,0
12,217,217,87,12,75,3,2
13,242,242,3,3,0,1,0
7,243,243,93,54,39,2,1
1,270,270,52,36,16,2,1
2,296,296,49,49,0,1,0
6,319,319,14,14,0,1,0
3,321,321,124,1,123,4,3
11,378,378,31,31,0,1,0
9,400,400,14,14,0,1,0
0,492,492,1,1,0,1,0
8,493,493,25,25,0,1,0
14,494,494,22,22,0,1,0

16,108,108,13,13,0,1,0
13,123,123,7,1,6,3,2
0,154,154,8,2,6,3,2
7,165,165,6,6,0,1,0
6,178,178,1,1,0,1,0
12,220,220,2,2,0,1,0
8,225,225,9,9,0,1,0
14,252,252,48,48,0,1,0
1,282,282,40,40,0,1,0
11,299,299,24,24,0,1,0
10,305,305,64,2,62,3,2
15,329,329,104,74,30,2,1
2,341,341,2,2,0,1,0
9,369,369,47,47,0,1,0
19,379,379,5,1,4,2,1
17,390,390,31,3,28,3,2
5,415,415,146,146,0,1,0
20,430,430,95,89,6,3,2
4,441,441,24,24,0,1,0
3,453,453,35,35,0,1,0
18,491,491,16,7,9,4,3

1,112,112,4,4,0,1,0
20,116,116,15,15,0,1,0
0,118,118,13,3,10,3,2
14,123,123,30,21,9,4,3
3,157,157,36,36,0,1,0
8,164,164,28,28,0,1,0
5,164,164,2,2,0,1,0
17,182,182,5,5,0,1,0
18,247,247,56,16,40,3,2
12,259,259,15,15,0,1,0
6,276,276,21,11,10,2,1
11,280,280,20,20,0,1,0
15,299,299,3,3,0,1,0
9,331,331,24,24,0,1,0
7,341,341,29,6,23,2,1
21,422,422,3,3,0,1,0
4,423,423,23,7,16,2,1
22,428,428,2,2,0,1,0
13,438,438,3,3,0,1,0
23,439,439,109,39,70,3,2
16,449,449,25,25,0,1,0
10,462,462,39,31,8,2,1
2,469,469,16,8,8,3,2
19,499,499,85,42,43,2,1

9,105,105,1,1,0,1,0
2,122,122,19,9,10,2,1
13,137,137,3,3,0,1,0
0,145,145,12,12,0,1,0
3,156,156,10,5,5,2,1
4,156,156,17,3,14,3,2
20,201,201,5,2,3,2,1
19,233,233,8,8,0,1,0
10,249,249,5,5,0,1,0
17,261,261,28,4,24,2,1
11,278,278,14,2,12,3,2
8,291,291,78,78,0,1,0
21,302,302,16,16,0,1,0
1,339,339,19,5,14,2,1
18,378,378,10,10,0,1,0
14,382,382,36,22,14,2,1
16,423,423,129,129,0,1,0
7,439,439,57,6,51,4,3
15,441,441,126,102,24,4,3
6,474,474,39,21,18,3,2
5,480,480,36,16,20,2,1
12,484,484,79,31,48,4,3

4,104,104,4,4,0,1,0
11,127,127,4,4,0,1,0
2,137,137,56,20,36,3,2
3,138,138,2,2,0,1,0
0,150,150,2,2,0,1,0
18,193,193,18,18,0,1,0
6,195,195,2,2,0,1,0
16,196,196,32,8,24,2,1
7,244,244,6,3,3,2,1
5,316,316,9,1,8,3,2
8,320,320,88,76,12,3,2
14,323,323,32,8,24,3,2
10,332,332,16,8,8,3,2
19,347,347,141,57,84,3,2
1,361,361,47,47,0,1,0
13,372,372,17,17,0,1,0
15,388,388,28,28,0,1,0
9,390,390,62,58,4,2,1
12,435,435,35,35,0,1,0
17,444,444,34,10,24,3,2

5,138,138,5,2,3,2,1
19,189,189,27,27,0,1,0
1,194,194,43,43,0,1,0
17,204,204,70,1,69,4,3
6,239,239,13,3,10,3,2
12,261,261,33,33,0,1,0
10,261,261,5,5,0,1,0
7,265,265,46,46,0,1,0
9,266,266,50,11,39,2,1
3,297,297,40,40,0,1,0
4,303,303,22,7,15,2,1
8,311,311,14,2,12,4,3
15,322,322,16,16,0,1,0
13,328,328,36,24,12,4,3
18,365,365,26,15,11,2,1
16,385,385,2,2,0,1,0
14,405,405,73,73,0,1,0
0,461,461,52,43,9,4,3
2,483,483,31,1,30,4,3
11,488,488,33,33,0,1,0

23,101,101,9,9,0,1,0
22,106,106,4,4,0,1,0
8,118,118,9,9,0,1,0
3,134,134,4,4,0,1,0
13,156,156,30,26,4,2,1
16,159,159,22,8,14,2,1
0,186,186,5,5,0,1,0
18,245,245,91,48,43,2,1
9,257,257,3,3,0,1,0
1,281,281,68,68,0,1,0
11,292,292,12,12,0,1,0
17,295,295,3,3,0,1,0
4,364,364,23,23,0,1,0
21,374,374,70,70,0,1,0
20,382,382,40,23,17,2,1
12,384,384,37,21,16,2,1
5,387,387,47,47,0,1,0
2,394,394,22,7,15,4,3
7,414,414,20,20,0,1,0
15,447,447,6,6,0,1,0
10,468,468,40,40,0,1,0
19,477,477,11,2,9,2,1
6,486,486,5,5,0,1,0
14,494,494,74,32,42,2,1

6,100,100,2,2,0,1,0
9,101,101,7,7,0,1,0
1,127,127,19,9,10,2,1
21,160,160,21,5,16,3,2
0,169,169,33,9,24,2,1
2,170,170,17,17,0,1,0
19,170,170,3,3,0,1,0
5,172,172,5,5,0,1,0
7,219,219,1,1,0,1,0
10,248,248,4,1,3,2,1
12,261,261,31,9,22,4,3
8,267,267,67,67,0,1,0
3,322,322,26,26,0,1,0
18,330,330,17,7,10,3,2
22,333,333,17,5,12,2,1
16,367,367,18,18,0,1,0
13,387,387,26,16,10,3,2
4,405,405,27,18,9,2,1
11,408,408,1,1,0,1,0
14,455,455,210,174,36,3,2
20,459,459,11,11,0,1,0
15,472,472,25,16,9,2,1
17,492,492,103,82,21,4,3

14,123,123,12,6,6,2,1
9,124,124,54,3,51,4,3
3,141,141,20,20,0,1,0
25,174,174,24,16,8,2,1
10,180,180,13,13,0,1,0
11,190,190,3,3,0,1,0
22,204,204,32,2,30,3,2
13,212,212,11,11,0,1,0
18,242,242,30,21,9,4,3
0,253,253,9,9,0,1,0
4,255,255,5,5,0,1,0
26,262,262,45,45,0,1,0
8,272,272,3,3,0,1,0
20,317,317,74,40,34,3,2
12,346,346,18,18,0,1,0
21,355,355,54,54,0,1,0
7,359,359,7,7,0,1,0
16,385,385,12,3,9,4,3
2,391,391,8,8,0,1,0
1,420,420,12,12,0,1,0
6,423,423,15,15,0,1,0
23,431,431,14,4,10,2,1
15,440,440,1,1,0,1,0
24,462,462,19,11,8,3,2
5,463,463,14,2,12,4,3
17,468,468,6,3,3,2,1
19,500,500,28,11,17,2,1

17,100,100,8,8,0,1,0
3,112,112,4,1,3,2,1
6,155,155,24,24,0,1,0
18,174,174,5,5,0,1,0
14,182,182,44,3,41,4,3
7,194,194,26,26,0,1,0
8,209,209,11,2,9,2,1
9,228,228,7,7,0,1,0
0,254,254,10,10,0,1,0
4,257,257,30,10,20,3,2
10,285,285,10,10,0,1,0
13,336,336,51,39,12,2,1
2,337,337,40,40,0,1,0
5,343,343,13,7,6,2,1
19,400,400,37,15,22,3,2
11,415,415,107,68,39,4,3
12,418,418,31,31,0,1,0
16,449,449,62,32,30,2,1
15,452,452,9,9,0,1,0
1,481,481,183,183,0,1,0

25,101,101,26,26,0,1,0
26,123,123,4,4,0,1,0
14,130,130,4,1,3,2,1
18,133,133,1,1,0,1,0
13,140,140,6,6,0,1,0
23,142,142,30,30,0,1,0
3,153,153,6,6,0,1,0
17,169,169,1,1,0,1,0
27,177,177,24,24,0,1,0
11,237,237,26,26,0,1,0
28,239,239,15,7,8,2,1
4,250,250,6,6,0,1,0
1,254,254,1,1,0,1,0
22,275,275,36,36,0,1,0
7,281,281,29,1,28,3,2
8,284,284,35,22,13,2,1
12,293,293,3,3,0,1,0
29,300,300,16,8,8,2,1
16,332,332,22,15,7,2,1
10,334,334,10,2,8,2,1
9,338,338,50,9,41,2,1
24,368,368,2,2,0,1,0
21,436,436,89,61,28,2,1
20,437,437,17,10,7,2,1
6,440,440,5,5,0,1,0
15,462,462,27,15,12,4,3
2,470,470,11,11,0,1,0
5,489,489,10,10,0,1,0
0,489,489,46,30,16,3,2
19,490,490,73,32,41,4,3

19,112,112,50,50,0,1,0
14,145,145,8,2,6,2,1
17,151,151,2,2,0,1,0
21,161,161,11,11,0,1,0
4,177,177,2,2,0,1,0
9,178,178,15,15,0,1,0
0,202,202,16,13,3,2,1
15,213,213,10,10,0,1,0
12,222,222,60,44,16,2,1
2,233,233,4,4,0,1,0
26,237,237,23,17,6,2,1
23,279,279,31,14,17,2,1
10,288,288,6,6,0,1,0
1,290,290,8,8,0,1,0
3,340,340,4,4,0,1,0
8,349,349,11,11,0,1,0
20,350,350,11,5,6,3,2
16,360,360,52,52,0,1,0
25,372,372,29,29,0,1,0
11,378,378,15,4,11,2,1
24,400,400,64,46,18,2,1
13,406,406,14,14,0,1,0
18,443,443,19,19,0,1,0
7,466,466,46,46,0,1,0
5,471,471,15,6,9,2,1
6,484,484,46,36,10,3,2
22,493,493,33,8,25,3,2

2,114,114,71,71,0,1,0
8,136,136,10,10,0,1,0
17,172,172,17,2,15,4,3
0,177,177,8,5,3,2,1
16,197,197,19,19,0,1,0
12,201,201,54,5,49,4,3
11,213,213,28,28,0,1,0
13,239,239,63,48,15,4,3
15,329,329,39,39,0,1,0
9,340,340,2,2,0,1,0
4,346,346,13,1,12,2,1
5,355,355,18,9,9,2,1
3,362,362,24,24,0,1,0
14,371,371,21,21,0,1,0
10,420,420,2,2,0,1,0
1,433,433,9,9,0,1,0
7,450,450,21,21,0,1,0
6,456,456,96,24,72,4,3

0,103,103,13,13,0,1,0
12,108,108,12,12,0,1,0
6,132,132,12,6,6,3,2
15,137,137,23,5,18,2,1
17,145,145,61,20,41,2,1
19,186,186,23,23,0,1,0
5,187,187,1,1,0,1,0
14,200,200,10,10,0,1,0
16,239,239,28,28,0,1,0
20,241,241,6,3,3,2,1
13,243,243,3,3,0,1,0
4,279,279,50,50,0,1,0
9,283,283,32,32,0,1,0
2,298,298,11,5,6,2,1
3,313,313,65,37,28,4,3
21,339,339,19,14,5,2,1
11,400,400,3,3,0,1,0
8,422,422,72,45,27,4,3
7,423,423,22,22,0,1,0
1,431,431,25,25,0,1,0
18,435,435,17,9,8,2,1
10,467,467,25,4,21,3,2

20,114,114,19,8,11,2,1
5,124,124,1,1,0,1,0
9,139,139,16,16,0,1,0
6,148,148,9,9,0,1,0
17,154,154,1,1,0,1,0
8,164,164,18,13,5,2,1
18,164,164,17,1,16,3,2
15,164,164,1,1,0,1,0
16,207,207,22,22,0,1,0
3,261,261,32,32,0,1,0
13,317,317,41,41,0,1,0
14,348,348,92,92,0,1,0
19,356,356,9,9,0,1,0
10,384,384,7,7,0,1,0
4,391,391,35,3,32,3,2
11,403,403,22,6,16,3,2
12,408,408,106,64,42,4,3
0,410,410,18,4,14,2,1
1,414,414,35,35,0,1,0
7,440,440,47,21,26,2,1
2,481,481,164,88,76,4,3

9,150,150,5,5,0,1,0
0,154,154,1,1,0,1,0
21,160,160,4,1,3,2,1
12,188,188,2,2,0,1,0
17,195,195,29,29,0,1,0
6,236,236,11,3,8,2,1
3,244,244,6,1,5,2,1
22,252,252,18,18,0,1,0
19,271,271,133,133,0,1,0
2,274,274,30,30,0,1,0
11,284,284,37,34,3,2,1
8,286,286,27,18,9,4,3
10,310,310,76,57,19,2,1
13,314,314,51,51,0,1,0
1,349,349,15,5,10,2,1
14,357,357,6,6,0,1,0
7,366,366,67,32,35,2,1
4,441,441,5,5,0,1,0
16,448,448,1,1,0,1,0
5,453,453,74,74,0,1,0
20,473,473,32,32,0,1,0
18,475,475,56,34,22,3,2
15,484,484,6,6,0,1,0

10,126,126,24,24,0,1,0
8,143,143,18,6,12,3,2
2,157,157,13,3,10,3,2
14,167,167,5,5,0,1,0
0,216,216,40,40,0,1,0
13,240,240,8,2,6,2,1
6,248,248,56,12,44,2,1
7,250,250,55,55,0,1,0
3,256,256,26,9,17,2,1
16,265,265,48,48,0,1,0
12,277,277,42,42,0,1,0
1,335,335,76,28,48,4,3
5,383,383,19,19,0,1,0
15,387,387,4,4,0,1,0
11,420,420,139,89,50,3,2
9,478,478,2,2,0,1,0
17,484,484,29,29,0,1,0
4,500,500,5,5,0,1,0

18,137,137,20,11,9,2,1
0,163,163,1,1,0,1,0
13,181,181,23,23,0,1,0
19,184,184,12,3,9,2,1
5,192,192,56,56,0,1,0
12,207,207,12,12,0,1,0
14,217,217,9,9,0,1,0
17,256,256,1,1,0,1,0
11,264,264,27,6,21,2,1
2,277,277,35,21,14,3,2
1,296,296,5,2,3,2,1
4,302,302,1,1,0,1,0
20,314,314,52,16,36,4,3
3,365,365,172,131,41,2,1
6,381,381,1,1,0,1,0
9,393,393,2,2,0,1,0
16,395,395,89,63,26,3,2
7,417,417,31,1,30,2,1
15,420,420,78,54,24,4,3
8,437,437,20,4,16,3,2
10,496,496,29,22,7,2,1

0,205,205,1,1,0,1,0
10,218,218,16,16,0,1,0
13,222,222,24,19,5,2,1
5,223,223,66,22,44,3,2
2,232,232,58,58,0,1,0
9,254,254,4,4,0,1,0
7,296,296,3,3,0,1,0
1,312,312,2,2,0,1,0
8,323,323,90,90,0,1,0
11,336,336,35,7,28,3,2
3,338,338,98,52,46,3,2
12,363,363,15,15,0,1,0
16,368,368,73,73,0,1,0
17,369,369,78,78,0,1,0
15,413,413,2,2,0,1,0
14,463,463,39,28,11,2,1
6,474,474,26,2,24,4,3
4,478,478,90,11,79,4,3

2,101,101,8,8,0,1,0
8,120,120,3,3,0,1,0
0,143,143,33,33,0,1,0
3,158,158,17,17,0,1,0
4,163,163,37,7,30,2,1
18,189,189,61,61,0,1,0
9,194,194,22,10,12,4,3
14,213,213,4,1,3,2,1
11,240,240,21,21,0,1,0
15,246,246,49,25,24,4,3
1,268,268,9,9,0,1,0
16,305,305,12,3,9,2,1
13,308,308,21,21,0,1,0
20,313,313,50,8,42,4,3
22,356,356,45,45,0,1,0
17,361,361,12,6,6,2,1
6,373,373,38,30,8,3,2
5,378,378,11,11,0,1,0
7,395,395,1,1,0,1,0
10,408,408,4,1,3,2,1
21,416,416,7,7,0,1,0
19,438,438,58,58,0,1,0
12,479,479,26,9,17,2,1

22,100,100,6,6,0,1,0
21,150,150,9,6,3,2,1
23,159,159,27,13,14,2,1
3,189,189,8,8,0,1,0
19,197,197,16,16,0,1,0
6,201,201,8,3,5,2,1
15,203,203,29,24,5,2,1
16,230,230,15,15,0,1,0
1,231,231,11,5,6,3,2
8,238,238,10,10,0,1,0
4,260,260,12,4,8,3,2
12,288,288,1,1,0,1,0
5,306,306,13,2,11,2,1
13,336,336,15,15,0,1,0
17,336,336,94,85,9,4,3
18,357,357,43,35,8,3,2
10,367,367,22,22,0,1,0
9,369,369,18,4,14,2,1
7,397,397,11,11,0,1,0
14,398,398,31,5,26,3,2
0,424,424,55,11,44,2,1
2,430,430,57,7,50,3,2
20,436,436,27,27,0,1,0
11,476,476,151,113,38,3,2
24,491,491,43,43,0,1,0

4,100,100,12,2,10,3,2
20,122,122,14,9,5,2,1
14,134,134,53,5,48,3,2
21,170,170,15,15,0,1,0
9,184,184,8,2,6,3,2
22,188,188,1,1,0,1,0
17,217,217,2,2,0,1,0
5,218,218,7,7,0,1,0
0,258,258,1,1,0,1,0
2,278,278,10,1,9,4,3
6,284,284,1,1,0,1,0
12,293,293,30,30,0,1,0
16,296,296,2,2,0,1,0
18,299,299,130,130,0,1,0
8,308,308,17,17,0,1,0
15,351,351,69,48,21,2,1
11,367,367,43,15,28,4,3
23,372,372,30,7,23,3,2
19,381,381,13,13,0,1,0
1,431,431,4,4,0,1,0
7,471,471,5,5,0,1,0
13,479,479,43,43,0,1,0
24,483,483,73,73,0,1,0
10,488,488,28,28,0,1,0
3,497,497,12,12,0,1,0

2,125,125,12,12,0,1,0
10,148,148,26,4,22,3,2
18,220,220,25,7,18,4,3
8,241,241,11,1,10,3,2
16,242,242,12,3,9,4,3
4,258,258,80,80,0,1,0
11,308,308,37,21,16,2,1
12,322,322,26,15,11,2,1
6,342,342,9,9,0,1,0
0,347,347,89,5,84,3,2
5,358,358,38,20,18,2,1
14,370,370,2,2,0,1,0
17,374,374,73,73,0,1,0
13,378,378,62,5,57,3,2
15,393,393,31,31,0,1,0
3,420,420,2,2,0,1,0
1,449,449,33,7,26,2,1
7,449,449,82,44,38,3,2
9,454,454,60,25,35,3,2

10,110,110,2,2,0,1,0
12,116,116,23,23,0,1,0
3,150,150,1,1,0,1,0
9,161,161,13,3,10,3,2
5,173,173,29,29,0,1,0
2,182,182,122,93,29,2,1
7,187,187,1,1,0,1,0
11,225,225,5,5,0,1,0
14,275,275,72,12,60,3,2
0,277,277,5,1,4,2,1
6,287,287,69,15,54,4,3
8,295,295,9,9,0,1,0
1,306,306,64,64,0,1,0
4,307,307,9,4,5,2,1
13,325,325,36,18,18,4,3
15,405,405,67,67,0,1,0

4,119,119,2,2,0,1,0
6,161,161,1,1,0,1,0
18,165,165,2,2,0,1,0
13,199,199,122,99,23,4,3
19,205,205,11,11,0,1,0
11,214,214,15,8,7,2,1
15,314,314,36,6,30,2,1
0,322,322,56,56,0,1,0
17,324,324,11,11,0,1,0
14,330,330,18,18,0,1,0
3,340,340,14,6,8,2,1
2,357,357,4,4,0,1,0
1,380,380,68,59,9,4,3
9,384,384,39,12,27,4,3
20,402,402,5,2,3,2,1
8,409,409,17,1,16,3,2
10,411,411,17,8,9,4,3
16,443,443,13,4,9,4,3
7,467,467,59,59,0,1,0
5,473,473,171,171,0,1,0
12,492,492,62,62,0,1,0

1,135,135,8,8,0,1,0
20,147,147,12,12,0,1,0
15,167,167,14,14,0,1,0
5,169,169,10,10,0,1,0
25,179,179,4,4,0,1,0
14,210,210,26,18,8,3,2
3,215,215,12,12,0,1,0
12,224,224,20,14,6,2,1
11,231,231,33,33,0,1,0
0,234,234,9,9,0,1,0
18,244,244,16,11,5,2,1
19,247,247,33,33,0,1,0
23,257,257,1,1,0,1,0
22,261,261,6,2,4,2,1
16,263,263,19,5,14,3,2
9,266,266,4,4,0,1,0
13,274,274,52,52,0,1,0
2,300,300,1,1,0,1,0
10,327,327,28,28,0,1,0
24,330,330,65,65,0,1,0
17,372,372,119,47,72,4,3
4,378,378,7,7,0,1,0
21,381,381,57,9,48,4,3
7,392,392,1,1,0,1,0
8,409,409,1,1,0,1,0
6,486,486,29,29,0,1,0
26,496,496,61,49,12,3,2

12,103,103,19,3,16,2,1
19,129,129,12,12,0,1,0
18,131,131,27,27,0,1,0
17,131,131,7,7,0,1,0
15,132,132,23,23,0,1,0
4,169,169,6,6,0,1,0
9,187,187,9,9,0,1,0
11,194,194,12,12,0,1,0
14,194,194,14,3,11,2,1
7,217,217,4,1,3,2,1
22,226,226,11,3,8,2,1
21,257,257,8,8,0,1,0
2,319,319,20,4,16,3,2
13,345,345,1,1,0,1,0
6,372,372,50,17,33,4,3
0,375,375,9,9,0,1,0
5,386,386,71,2,69,4,3
20,397,397,152,104,48,3,2
8,398,398,91,91,0,1,0
10,452,452,21,17,4,2,1
3,484,484,24,24,0,1,0
1,485,485,15,6,9,2,1
16,494,494,34,17,17,2,1

14,111,111,13,7,6,3,2
3,111,111,3,3,0,1,0
4,113,113,20,8,12,4,3
1,117,117,4,4,0,1,0
5,123,123,28,9,19,4,3
11,138,138,5,5,0,1,0
17,173,173,1,1,0,1,0
13,189,189,20,1,19,3,2
7,225,225,16,5,11,2,1
15,246,246,27,27,0,1,0
19,280,280,105,97,8,2,1
10,284,284,31,31,0,1,0
18,288,288,50,50,0,1,0
6,292,292,24,24,0,1,0
16,337,337,19,11,8,3,2
9,420,420,75,10,65,4,3
8,440,440,48,48,0,1,0
0,443,443,38,9,29,2,1
2,459,459,50,50,0,1,0
12,463,463,19,19,0,1,0

17,101,101,2,2,0,1,0
8,192,192,33,33,0,1,0
20,204,204,42,18,24,3,2
10,213,213,7,7,0,1,0
5,244,244,1,1,0,1,0
2,251,251,40,14,26,3,2
16,264,264,35,35,0,1,0
6,271,271,8,8,0,1,0
12,304,304,11,11,0,1,0
11,335,335,60,60,0,1,0
7,349,349,92,92,0,1,0
19,365,365,9,9,0,1,0
14,372,372,32,17,15,4,3
18,385,385,60,60,0,1,0
13,386,386,77,77,0,1,0
3,386,386,19,3,16,2,1
4,419,419,59,59,0,1,0
15,434,434,31,2,29,2,1
0,456,456,36,36,0,1,0
1,459,459,62,38,24,3,2
9,459,459,16,4,12,3,2

5,104,104,6,6,0,1,0
22,106,106,5,5,0,1,0
8,113,113,7,7,0,1,0
16,158,158,18,9,9,2,1
3,163,163,9,5,4,2,1
4,172,172,2,2,0,1,0
15,173,173,17,17,0,1,0
23,188,188,19,19,0,1,0
13,205,205,74,74,0,1,0
19,221,221,18,9,9,2,1
1,257,257,1,1,0,1,0
12,289,289,18,4,14,2,1
18,296,296,14,7,7,2,1
14,387,387,77,23,54,4,3
21,403,403,35,35,0,1,0
9,407,407,46,40,6,2,1
17,415,415,41,1,40,3,2
10,432,432,1,1,0,1,0
7,434,434,10,10,0,1,0
11,441,441,42,32,10,2,1
2,459,459,4,4,0,1,0
24,466,466,151,106,45,4,3
0,478,478,18,18,0,1,0
20,487,487,60,16,44,3,2
6,494,494,4,4,0,1,0

3,101,101,1,1,0,1,0
7,130,130,6,6,0,1,0
14,130,130,5,5,0,1,0
1,131,131,5,2,3,2,1
10,154,154,1,1,0,1,0
19,177,177,5,5,0,1,0
15,184,184,17,10,7,2,1
6,198,198,30,26,4,2,1
18,220,220,42,42,0,1,0
4,223,223,45,12,33,4,3
17,245,245,17,17,0,1,0
16,252,252,39,39,0,1,0
13,264,264,5,5,0,1,0
21,297,297,49,49,0,1,0
5,353,353,57,57,0,1,0
2,354,354,25,25,0,1,0
11,359,359,28,28,0,1,0
20,383,383,47,4,43,2,1
9,437,437,15,15,0,1,0
8,457,457,90,90,0,1,0
12,465,465,115,115,0,1,0
0,496,496,52,20,32,3,2

11,103,103,7,7,0,1,0
15,103,103,12,12,0,1,0
6,124,124,4,4,0,1,0
1,137,137,13,13,0,1,0
8,152,152,1,1,0,1,0
5,181,181,46,16,30,4,3
2,192,192,24,24,0,1,0
17,204,204,1,1,0,1,0
0,251,251,3,3,0,1,0
3,256,256,37,18,19,2,1
10,288,288,40,12,28,3,2
13,331,331,11,5,6,2,1
19,349,349,10,4,6,2,1
9,365,365,20,8,12,2,1
7,376,376,2,2,0,1,0
12,379,379,103,103,0,1,0
4,383,383,64,20,44,3,2
16,409,409,84,84,0,1,0
20,431,431,92,30,62,3,2
14,457,457,3,3,0,1,0
21,470,470,57,48,9,4,3
18,494,494,55,55,0,1,0

1,100,100,4,1,3,2,1
2,113,113,1,1,0,1,0
8,115,115,1,1,0,1,0
4,120,120,7,7,0,1,0
0,126,126,33,33,0,1,0
11,127,127,13,4,9,2,1
17,185,185,14,5,9,4,3
16,197,197,30,30,0,1,0
21,257,257,11,2,9,2,1
19,264,264,25,1,24,2,1
9,308,308,10,4,6,3,2
13,333,333,36,31,5,2,1
6,345,345,44,10,34,3,2
18,359,359,32,23,9,4,3
14,366,366,60,24,36,4,3
5,411,411,41,4,37,2,1
22,425,425,13,13,0,1,0
3,435,435,26,26,0,1,0
7,438,438,34,2,32,3,2
20,440,440,34,6,28,2,1
10,449,449,30,30,0,1,0
15,458,458,131,67,64,4,3
12,499,499,78,52,26,4,3

13,109,109,2,2,0,1,0
1,111,111,23,23,0,1,0
11,116,116,17,17,0,1,0
12,129,129,17,17,0,1,0
4,189,189,26,26,0,1,0
2,198,198,26,26,0,1,0
16,202,202,44,3,41,2,1
15,207,207,17,4,13,4,3
3,211,211,4,4,0,1,0
7,330,330,32,2,30,4,3
9,335,335,52,52,0,1,0
6,379,379,44,44,0,1,0
8,391,391,11,3,8,3,2
14,394,394,92,92,0,1,0
10,401,401,5,5,0,1,0
0,415,415,33,11,22,2,1
5,473,473,194,140,54,3,2

18,114,114,11,11,0,1,0
4,125,125,15,15,0,1,0
14,141,141,28,28,0,1,0
7,142,142,6,6,0,1,0
20,147,147,38,38,0,1,0
17,175,175,37,4,33,4,3
16,181,181,5,5,0,1,0
2,214,214,4,4,0,1,0
10,294,294,55,33,22,2,1
3,296,296,27,27,0,1,0
11,303,303,1,1,0,1,0
9,310,310,60,8,52,3,2
13,317,317,26,2,24,4,3
12,371,371,47,25,22,2,1
6,375,375,75,15,60,4,3
8,393,393,8,8,0,1,0
0,404,404,7,7,0,1,0
5,407,407,19,19,0,1,0
19,452,452,25,11,14,3,2
1,476,476,78,78,0,1,0
15,495,495,32,32,0,1,0

23,117,117,7,7,0,1,0
20,126,126,3,3,0,1,0
13,171,171,6,6,0,1,0
26,182,182,49,7,42,4,3
7,192,192,2,2,0,1,0
27,199,199,33,33,0,1,0
21,211,211,17,17,0,1,0
25,229,229,8,5,3,2,1
18,239,239,11,11,0,1,0
0,264,264,18,3,15,2,1
19,266,266,41,41,0,1,0
2,272,272,28,4,24,3,2
12,308,308,13,13,0,1,0
1,311,311,1,1,0,1,0
11,311,311,9,1,8,3,2
8,335,335,3,3,0,1,0
10,337,337,34,3,31,2,1
9,340,340,58,26,32,3,2
15,375,375,10,5,5,2,1
6,377,377,5,5,0,1,0
3,396,396,29,29,0,1,0
22,428,428,93,50,43,2,1
4,431,431,11,2,9,2,1
17,436,436,1,1,0,1,0
16,450,450,85,85,0,1,0
24,453,453,34,34,0,1,0
14,475,475,78,70,8,3,2
5,480,480,17,5,12,3,2

7,100,100,15,6,9,2,1
13,117,117,1,1,0,1,0
11,118,118,5,5,0,1,0
8,208,208,63,39,24,4,3
12,216,216,36,16,20,4,3
5,266,266,4,1,3,2,1
9,270,270,15,5,10,2,1
17,277,277,12,12,0,1,0
1,317,317,51,51,0,1,0
0,329,329,29,29,0,1,0
3,363,363,114,65,49,2,1
6,371,371,54,54,0,1,0
4,392,392,68,47,21,4,3
2,394,394,23,23,0,1,0
10,404,404,86,38,48,3,2
15,449,449,9,1,8,2,1
14,464,464,21,17,4,2,1
16,498,498,115,92,23,2,1

3,105,105,31,21,10,2,1
20,109,109,39,27,12,3,2
12,135,135,3,3,0,1,0
21,139,139,14,8,6,3,2
1,152,152,19,1,18,4,3
8,184,184,4,4,0,1,0
9,189,189,10,7,3,2,1
7,202,202,2,2,0,1,0
19,202,202,14,14,0,1,0
15,238,238,14,14,0,1,0
11,260,260,26,26,0,1,0
18,264,264,37,19,18,2,1
4,288,288,12,3,9,2,1
2,306,306,18,5,13,2,1
25,318,318,1,1,0,1,0
23,319,319,19,4,15,4,3
6,328,328,5,5,0,1,0
14,341,341,2,2,0,1,0
16,397,397,24,24,0,1,0
17,421,421,76,76,0,1,0
0,438,438,52,52,0,1,0
5,439,439,18,2,16,3,2
10,462,462,11,2,9,2,1
13,467,467,51,51,0,1,0
24,483,483,36,36,0,1,0
22,487,487,36,18,18,2,1

2,127,127,5,5,0,1,0
1,133,133,1,1,0,1,0
21,143,143,12,12,0,1,0
12,168,168,5,2,3,2,1
3,194,194,27,9,18,3,2
24,202,202,14,14,0,1,0
22,210,210,14,10,4,2,1
26,213,213,50,18,32,3,2
9,238,238,2,2,0,1,0
11,250,250,1,1,0,1,0
28,254,254,47,20,27,4,3
13,257,257,40,40,0,1,0
23,264,264,6,2,4,2,1
4,287,287,24,24,0,1,0
25,292,292,12,12,0,1,0
10,298,298,8,4,4,2,1
17,308,308,35,20,15,2,1
27,309,309,13,13,0,1,0
8,318,318,37,37,0,1,0
19,325,325,19,1,18,2,1
14,340,340,6,1,5,2,1
20,389,389,123,123,0,1,0
18,433,433,11,5,6,2,1
15,440,440,16,1,15,4,3
6,460,460,16,6,10,2,1
5,468,468,18,3,15,2,1
7,474,474,23,23,0,1,0
16,475,475,78,42,36,2,1
0,484,484,6,1,5,2,1

13,105,105,1,1,0,1,0
21,129,129,3,3,0,1,0
5,132,132,9,1,8,2,1
16,144,144,13,13,0,1,0
2,145,145,8,3,5,2,1
3,148,148,6,6,0,1,0
12,171,171,15,15,0,1,0
10,172,172,24,24,0,1,0
9,184,184,9,5,4,2,1
14,264,264,19,9,10,2,1
23,276,276,41,41,0,1,0
22,277,277,14,14,0,1,0
7,292,292,12,12,0,1,0
8,375,375,40,40,0,1,0
19,382,382,52,39,13,2,1
17,389,389,69,60,9,2,1
18,392,392,4,4,0,1,0
20,398,398,3,3,0,1,0
4,411,411,87,67,20,2,1
15,422,422,167,110,57,4,3
1,439,439,98,2,96,4,3
0,474,474,5,5,0,1,0
6,477,477,28,7,21,2,1
11,483,483,1,1,0,1,0

16,128,128,14,14,0,1,0
2,136,136,7,7,0,1,0
18,153,153,37,37,0,1,0
20,168,168,18,18,0,1,0
7,186,186,11,6,5,2,1
0,190,190,31,31,0,1,0
6,202,202,48,48,0,1,0
17,221,221,2,2,0,1,0
10,238,238,16,16,0,1,0
15,245,245,23,5,18,3,2
8,258,258,2,2,0,1,0
5,346,346,52,52,0,1,0
19,354,354,32,32,0,1,0
14,363,363,99,16,83,4,3
12,376,376,29,29,0,1,0
9,377,377,44,11,33,4,3
21,383,383,17,17,0,1,0
1,384,384,57,57,0,1,0
13,404,404,30,30,0,1,0
4,434,434,15,15,0,1,0
3,449,449,8,1,7,2,1
11,498,498,23,23,0,1,0

8,116,116,17,17,0,1,0
4,131,131,22,22,0,1,0
17,147,147,8,2,6,3,2
10,149,149,1,1,0,1,0
12,169,169,22,6,16,2,1
16,246,246,1,1,0,1,0
2,265,265,46,46,0,1,0
1,267,267,8,2,6,3,2
0,287,287,31,31,0,1,0
15,289,289,2,2,0,1,0
6,290,290,50,16,34,2,1
14,313,313,3,3,0,1,0
11,314,314,23,23,0,1,0
9,327,327,54,54,0,1,0
18,335,335,29,3,26,3,2
7,356,356,17,5,12,4,3
20,378,378,139,127,12,3,2
5,408,408,4,4,0,1,0
3,435,435,33,9,24,3,2
19,443,443,140,119,21,2,1
13,479,479,34,10,24,3,2

18,153,153,14,14,0,1,0
5,162,162,2,2,0,1,0
0,177,177,9,9,0,1,0
20,202,202,67,41,26,3,2
9,241,241,40,40,0,1,0
1,272,272,60,60,0,1,0
16,285,285,12,6,6,3,2
8,296,296,53,8,45,2,1
10,299,299,5,5,0,1,0
11,303,303,14,6,8,3,2
21,318,318,82,58,24,3,2
3,324,324,35,17,18,4,3
17,330,330,32,32,0,1,0
22,334,334,21,4,17,2,1
7,344,344,1,1,0,1,0
6,357,357,11,11,0,1,0
4,387,387,21,21,0,1,0
2,427,427,42,34,8,2,1
19,431,431,3,3,0,1,0
12,434,434,50,50,0,1,0
13,479,479,25,17,8,2,1
14,483,483,85,85,0,1,0
15,487,487,1,1,0,1,0

13,119,119,1,1,0,1,0
12,132,132,5,5,0,1,0
6,135,135,8,8,0,1,0
20,138,138,11,3,8,3,2
8,179,179,7,7,0,1,0
16,181,181,2,2,0,1,0
19,185,185,47,12,35,3,2
9,206,206,1,1,0,1,0
3,229,229,9,9,0,1,0
18,258,258,2,2,0,1,0
14,289,289,106,4,102,4,3
1,291,291,12,12,0,1,0
15,296,296,29,29,0,1,0
17,306,306,11,11,0,1,0
11,333,333,75,46,29,3,2
2,360,360,49,49,0,1,0
7,399,399,97,97,0,1,0
4,409,409,51,51,0,1,0
21,418,418,92,40,52,3,2
0,432,432,43,12,31,2,1
10,434,434,26,26,0,1,0
5,469,469,14,3,11,2,1

11,105,105,22,22,0,1,0
21,150,150,8,8,0,1,0
5,183,183,34,34,0,1,0
10,191,191,19,19,0,1,0
16,198,198,4,4,0,1,0
6,199,199,10,10,0,1,0
18,199,199,43,43,0,1,0
14,207,207,24,1,23,2,1
1,236,236,11,11,0,1,0
9,246,246,14,11,3,2,1
3,248,248,4,1,3,2,1
17,277,277,69,69,0,1,0
2,303,303,7,7,0,1,0
4,329,329,28,28,0,1,0
22,334,334,61,31,30,3,2
7,342,342,22,4,18,4,3
12,368,368,11,11,0,1,0
15,380,380,63,63,0,1,0
0,396,396,12,1,11,2,1
8,415,415,31,31,0,1,0
13,436,436,56,56,0,1,0
19,473,473,5,5,0,1,0
23,484,484,43,21,22,2,1
20,485,485,9,9,0,1,0

10,121,121,7,1,6,2,1
17,165,165,40,40,0,1,0
5,167,167,35,6,29,2,1
7,174,174,10,6,4,2,1
18,177,177,51,23,28,3,2
15,214,214,5,5,0,1,0
8,280,280,14,14,0,1,0
11,287,287,1,1,0,1,0
13,309,309,38,10,28,3,2
6,317,317,31,5,26,2,1
20,322,322,21,1,20,3,2
3,330,330,3,3,0,1,0
4,333,333,32,32,0,1,0
1,365,365,59,59,0,1,0
16,378,378,24,24,0,1,0
14,404,404,8,8,0,1,0
2,417,417,26,19,7,2,1
19,418,418,90,83,7,2,1
0,448,448,61,61,0,1,0
9,460,460,77,17,60,3,2
12,472,472,35,35,0,1,0

15,121,121,27,10,17,2,1
6,134,134,7,7,0,1,0
16,149,149,18,18,0,1,0
4,165,165,30,30,0,1,0
7,180,180,15,7,8,2,1
9,210,210,3,3,0,1,0
12,264,264,24,24,0,1,0
17,264,264,17,17,0,1,0
2,268,268,12,4,8,2,1
14,285,285,18,2,16,3,2
10,300,300,15,15,0,1,0
8,318,318,71,32,39,2,1
1,370,370,43,43,0,1,0
13,376,376,44,44,0,1,0
5,382,382,129,129,0,1,0
0,394,394,95,95,0,1,0
3,481,481,22,22,0,1,0
11,491,491,77,9,68,3,2

14,109,109,1,1,0,1,0
19,138,138,54,33,21,4,3
8,139,139,17,5,12,4,3
22,160,160,19,4,15,4,3
0,171,171,1,1,0,1,0
15,182,182,10,10,0,1,0
12,182,182,28,28,0,1,0
17,188,188,2,2,0,1,0
18,208,208,7,1,6,2,1
21,210,210,3,3,0,1,0
1,230,230,64,64,0,1,0
13,233,233,18,18,0,1,0
26,238,238,34,2,32,3,2
4,249,249,2,2,0,1,0
2,294,294,5,5,0,1,0
10,303,303,1,1,0,1,0
27,322,322,7,7,0,1,0
20,338,338,10,10,0,1,0
6,359,359,7,7,0,1,0
25,368,368,42,6,36,2,1
16,388,388,6,3,3,2,1
5,389,389,66,66,0,1,0
9,399,399,24,24,0,1,0
23,401,401,95,43,52,3,2
3,419,419,8,8,0,1,0
24,427,427,8,8,0,1,0
7,429,429,13,13,0,1,0
11,485,485,22,22,0,1,0

11,112,112,14,14,0,1,0
0,116,116,1,1,0,1,0
1,139,139,11,6,5,2,1
13,139,139,5,5,0,1,0
18,154,154,11,3,8,2,1
16,155,155,42,21,21,4,3
19,164,164,9,9,0,1,0
17,189,189,3,3,0,1,0
5,198,198,13,4,9,4,3
2,324,324,71,59,12,4,3
7,354,354,36,36,0,1,0
8,380,380,21,21,0,1,0
12,387,387,111,77,34,2,1
15,399,399,36,36,0,1,0
6,416,416,45,45,0,1,0
4,425,425,46,8,38,3,2
9,435,435,146,146,0,1,0
3,446,446,9,1,8,2,1
10,454,454,49,49,0,1,0
14,463,463,28,28,0,1,0

9,102,102,12,12,0,1,0
0,117,117,12,3,9,2,1
4,121,121,11,4,7,2,1
8,132,132,15,7,8,2,1
10,166,166,27,1,26,3,2
11,172,172,8,8,0,1,0
1,183,183,2,2,0,1,0
19,192,192,20,20,0,1,0
12,204,204,12,3,9,3,2
3,249,249,5,2,3,2,1
17,287,287,107,49,58,4,3
16,325,325,1,1,0,1,0
21,332,332,57,1,56,4,3
20,336,336,19,19,0,1,0
7,342,342,25,25,0,1,0
2,360,360,92,20,72,4,3
14,415,415,19,1,18,4,3
13,458,458,86,26,60,3,2
18,466,466,37,10,27,4,3
5,471,471,14,14,0,1,0
15,476,476,16,9,7,2,1
6,483,483,38,38,0,1,0

7,126,126,4,4,0,1,0
2,141,141,41,15,26,2,1
13,149,149,56,52,4,2,1
4,151,151,13,13,0,1,0
22,174,174,12,4,8,2,1
3,225,225,31,5,26,3,2
6,247,247,5,5,0,1,0
8,258,258,17,8,9,4,3
21,260,260,2,2,0,1,0
17,261,261,26,26,0,1,0
12,276,276,5,1,4,2,1
10,281,281,11,11,0,1,0
14,343,343,12,9,3,2,1
1,374,374,46,46,0,1,0
20,382,382,23,23,0,1,0
0,395,395,62,62,0,1,0
9,419,419,1,1,0,1,0
15,427,427,116,116,0,1,0
19,428,428,71,71,0,1,0
11,452,452,35,35,0,1,0
18,457,457,1,1,0,1,0
5,460,460,24,12,12,4,3
16,495,495,12,5,7,2,1

15,111,111,29,1,28,2,1
14,116,116,14,14,0,1,0
18,116,116,2,2,0,1,0
10,132,132,14,14,0,1,0
2,145,145,6,3,3,2,1
20,165,165,5,2,3,2,1
21,183,183,5,5,0,1,0
0,198,198,12,2,10,3,2
3,205,205,29,29,0,1,0
6,239,239,1,1,0,1,0
4,241,241,4,4,0,1,0
24,257,257,26,2,24,3,2
16,276,276,49,10,39,4,3
8,285,285,1,1,0,1,0
11,314,314,25,2,23,3,2
1,318,318,56,56,0,1,0
5,326,326,2,2,0,1,0
23,348,348,66,41,25,2,1
9,359,359,96,63,33,4,3
12,429,429,4,4,0,1,0
7,437,437,16,1,15,4,3
19,454,454,54,48,6,2,1
22,458,458,39,39,0,1,0
17,486,486,57,57,0,1,0
13,493,493,15,5,10,3,2

2,115,115,42,42,0,1,0
18,122,122,10,10,0,1,0
8,138,138,38,38,0,1,0
6,173,173,30,12,18,4,3
12,187,187,19,19,0,1,0
5,204,204,2,2,0,1,0
11,207,207,5,2,3,2,1
16,217,217,13,13,0,1,0
14,236,236,6,6,0,1,0
7,256,256,19,11,8,3,2
9,276,276,49,49,0,1,0
13,338,338,88,58,30,3,2
0,405,405,4,4,0,1,0
10,418,418,34,20,14,3,2
3,421,421,12,12,0,1,0
1,427,427,39,39,0,1,0
17,452,452,64,44,20,3,2
4,479,479,37,14,23,3,2
15,490,490,80,30,50,3,2

4,119,119,3,3,0,1,0
15,120,120,8,8,0,1,0
24,127,127,14,14,0,1,0
5,130,130,9,9,0,1,0
14,132,132,20,20,0,1,0
8,194,194,13,13,0,1,0
10,209,209,13,13,0,1,0
22,243,243,5,2,3,2,1
13,253,253,8,8,0,1,0
7,271,271,28,28,0,1,0
9,288,288,3,3,0,1,0
19,328,328,32,6,26,3,2
21,336,336,38,38,0,1,0
20,339,339,56,56,0,1,0
3,385,385,1,1,0,1,0
18,387,387,98,98,0,1,0
0,395,395,32,29,3,2,1
17,401,401,86,6,80,4,3
23,404,404,8,8,0,1,0
1,417,417,7,7,0,1,0
12,425,425,60,60,0,1,0
2,427,427,57,18,39,4,3
16,454,454,26,26,0,1,0
6,471,471,47,18,29,2,1
25,479,479,29,20,9,4,3
11,490,490,19,19,0,1,0

4,109,109,5,5,0,1,0
6,139,139,3,3,0,1,0
16,142,142,35,25,10,2,1
12,172,172,49,21,28,3,2
14,176,176,20,20,0,1,0
17,187,187,3,3,0,1,0
7,208,208,27,27,0,1,0
15,226,226,10,10,0,1,0
3,266,266,7,2,5,2,1
0,296,296,62,62,0,1,0
10,324,324,1,1,0,1,0
11,366,366,13,13,0,1,0
18,410,410,2,2,0,1,0
13,411,411,150,81,69,4,3
9,412,412,4,4,0,1,0
1,443,443,128,96,32,3,2
8,477,477,169,118,51,4,3
5,478,478,1,1,0,1,0
2,497,497,11,11,0,1,0

10,126,126,4,4,0,1,0
2,138,138,36,19,17,2,1
16,174,174,12,12,0,1,0
13,196,196,47,17,30,3,2
7,208,208,1,1,0,1,0
18,215,215,12,5,7,2,1
8,230,230,16,2,14,2,1
6,233,233,30,15,15,4,3
17,306,306,10,10,0,1,0
0,309,309,60,24,36,3,2
1,321,321,24,24,0,1,0
15,328,328,50,5,45,4,3
19,341,341,14,14,0,1,0
3,367,367,9,9,0,1,0
12,385,385,63,63,0,1,0
4,440,440,66,35,31,2,1
21,456,456,13,13,0,1,0
11,457,457,33,1,32,2,1
14,474,474,147,120,27,2,1
5,484,484,4,1,3,2,1
20,492,492,15,15,0,1,0
9,497,497,40,40,0,1,0

26,102,102,2,2,0,1,0
20,112,112,13,13,0,1,0
12,114,114,4,1,3,2,1
1,159,159,1,1,0,1,0
9,161,161,1,1,0,1,0
7,175,175,1,1,0,1,0
25,180,180,6,3,3,2,1
16,213,213,1,1,0,1,0
4,222,222,4,1,3,2,1
13,245,245,15,2,13,2,1
6,254,254,1,1,0,1,0
8,255,255,68,17,51,4,3
24,268,268,18,18,0,1,0
5,270,270,43,43,0,1,0
11,274,274,22,22,0,1,0
23,326,326,30,12,18,3,2
15,344,344,37,7,30,2,1
21,354,354,66,45,21,4,3
2,369,369,43,11,32,3,2
0,378,378,47,47,0,1,0
14,382,382,15,15,0,1,0
17,400,400,4,4,0,1,0
18,411,411,169,34,135,4,3
19,419,419,28,16,12,3,2
3,435,435,8,8,0,1,0
10,477,477,18,9,9,4,3
27,487,487,23,16,7,2,1
22,492,492,37,3,34,2,1

8,108,108,1,1,0,1,0
18,140,140,5,5,0,1,0
3,143,143,13,4,9,4,3
17,160,160,32,17,15,4,3
20,172,172,1,1,0,1,0
1,174,174,2,2,0,1,0
10,189,189,12,2,10,3,2
23,204,204,35,17,18,2,1
4,207,207,2,2,0,1,0
0,210,210,48,48,0,1,0
19,249,249,29,29,0,1,0
2,265,265,10,10,0,1,0
14,271,271,14,14,0,1,0
13,288,288,43,43,0,1,0
9,293,293,28,28,0,1,0
22,323,323,47,23,24,2,1
7,341,341,21,4,17,2,1
21,356,356,41,41,0,1,0
16,384,384,69,57,12,4,3
15,397,397,46,1,45,2,1
24,407,407,12,4,8,2,1
5,424,424,41,23,18,2,1
6,432,432,15,15,0,1,0
11,467,467,31,31,0,1,0
12,487,487,47,39,8,2,1

14,103,103,49,49,0,1,0
5,103,103,1,1,0,1,0
13,140,140,9,9,0,1,0
17,142,142,12,3,9,4,3
19,144,144,5,2,3,2,1
2,188,188,26,15,11,2,1
8,188,188,3,3,0,1,0
18,195,195,10,10,0,1,0
16,202,202,21,21,0,1,0
0,211,211,23,2,21,2,1
10,259,259,3,3,0,1,0
12,270,270,58,58,0,1,0
9,287,287,32,26,6,2,1
4,323,323,160,160,0,1,0
15,337,337,20,11,9,4,3
11,364,364,10,10,0,1,0
6,415,415,14,14,0,1,0
3,417,417,15,15,0,1,0
7,431,431,27,2,25,2,1
1,464,464,42,22,20,2,1

14,110,110,1,1,0,1,0
3,121,121,11,2,9,2,1
4,168,168,3,3,0,1,0
23,170,170,98,32,66,3,2
21,180,180,4,4,0,1,0
13,217,217,13,13,0,1,0
2,230,230,12,12,0,1,0
22,237,237,18,8,10,3,2
9,261,261,3,3,0,1,0
19,268,268,11,11,0,1,0
18,280,280,19,19,0,1,0
10,303,303,11,5,6,2,1
7,377,377,67,29,38,3,2
6,377,377,5,5,0,1,0
1,399,399,74,74,0,1,0
0,421,421,37,37,0,1,0
16,422,422,7,7,0,1,0
5,429,429,97,97,0,1,0
11,440,440,28,28,0,1,0
20,455,455,28,28,0,1,0
12,459,459,32,1,31,2,1
17,467,467,107,107,0,1,0
15,472,472,14,14,0,1,0
8,473,473,5,5,0,1,0

19,101,101,6,6,0,1,0
0,118,118,6,6,0,1,0
16,134,134,2,2,0,1,0
9,185,185,24,24,0,1,0
8,188,188,9,1,8,2,1
5,189,189,40,40,0,1,0
15,190,190,20,13,7,2,1
4,210,210,6,6,0,1,0
1,249,249,5,5,0,1,0
3,261,261,30,30,0,1,0
17,269,269,11,11,0,1,0
13,274,274,8,8,0,1,0
14,284,284,12,3,9,2,1
18,290,290,59,59,0,1,0
20,295,295,139,62,77,4,3
6,322,322,26,1,25,2,1
7,330,330,42,22,20,2,1
12,360,360,8,8,0,1,0
21,363,363,49,49,0,1,0
10,387,387,71,71,0,1,0
11,391,391,7,7,0,1,0
2,395,395,35,35,0,1,0

9,109,109,1,1,0,1,0
23,143,143,6,6,0,1,0
13,150,150,5,5,0,1,0
17,174,174,77,77,0,1,0
19,222,222,35,35,0,1,0
12,226,226,7,7,0,1,0
7,278,278,30,4,26,4,3
10,296,296,58,58,0,1,0
20,301,301,18,6,12,2,1
6,316,316,20,20,0,1,0
14,319,319,34,34,0,1,0
21,320,320,14,14,0,1,0
22,343,343,54,16,38,2,1
16,346,346,3,3,0,1,0
2,380,380,7,2,5,2,1
3,395,395,23,12,11,2,1
8,396,396,29,19,10,2,1
11,419,419,7,7,0,1,0
0,447,447,107,107,0,1,0
18,468,468,13,5,8,3,2
5,473,473,30,9,21,4,3
15,491,491,37,37,0,1,0
1,494,494,18,18,0,1,0
4,496,496,79,79,0,1,0

11,119,119,31,9,22,2,1
0,132,132,11,11,0,1,0
15,194,194,1,1,0,1,0
2,198,198,7,7,0,1,0
6,202,202,1,1,0,1,0
1,211,211,98,98,0,1,0
18,213,213,28,23,5,2,1
5,242,242,11,11,0,1,0
4,263,263,1,1,0,1,0
8,302,302,28,20,8,3,2
7,305,305,34,6,28,2,1
10,320,320,68,41,27,2,1
14,337,337,16,16,0,1,0
13,345,345,1,1,0,1,0
9,366,366,38,26,12,2,1
17,366,366,97,59,38,2,1
12,369,369,29,3,26,3,2
16,418,418,6,6,0,1,0
3,452,452,117,39,78,4,3

3,133,133,8,8,0,1,0
7,142,142,2,2,0,1,0
21,150,150,16,16,0,1,0
16,156,156,9,9,0,1,0
0,158,158,2,2,0,1,0
13,158,158,9,9,0,1,0
22,159,159,2,2,0,1,0
15,170,170,12,3,9,3,2
12,176,176,15,15,0,1,0
2,193,193,1,1,0,1,0
23,200,200,18,1,17,2,1
17,208,208,45,5,40,3,2
26,210,210,57,13,44,4,3
11,213,213,38,38,0,1,0
5,213,213,30,30,0,1,0
4,241,241,2,2,0,1,0
10,265,265,9,9,0,1,0
18,302,302,1,1,0,1,0
25,321,321,38,22,16,2,1
14,361,361,20,12,8,3,2
19,374,374,2,2,0,1,0
6,376,376,53,53,0,1,0
1,379,379,53,12,41,2,1
9,413,413,5,5,0,1,0
24,418,418,110,86,24,4,3
8,447,447,13,13,0,1,0
20,454,454,14,2,12,3,2

12,129,129,20,2,18,3,2
13,149,149,19,3,16,4,3
4,178,178,2,2,0,1,0
5,202,202,35,26,9,4,3
3,228,228,24,12,12,4,3
15,258,258,5,5,0,1,0
18,289,289,45,45,0,1,0
8,325,325,1,1,0,1,0
11,327,327,25,11,14,2,1
9,349,349,39,39,0,1,0
2,364,364,45,8,37,2,1
7,376,376,103,13,90,4,3
14,384,384,22,22,0,1,0
0,385,385,89,57,32,3,2
16,397,397,11,8,3,2,1
6,417,417,14,14,0,1,0
1,471,471,69,24,45,4,3
10,475,475,82,82,0,1,0
17,492,492,107,90,17,2,1

15,118,118,12,12,0,1,0
17,135,135,9,9,0,1,0
2,141,141,18,18,0,1,0
13,182,182,14,14,0,1,0
5,192,192,21,21,0,1,0
18,239,239,3,3,0,1,0
3,263,263,22,18,4,2,1
14,322,322,69,55,14,2,1
9,345,345,84,30,54,4,3
16,386,386,50,50,0,1,0
1,386,386,55,55,0,1,0
11,392,392,27,3,24,3,2
6,395,395,7,7,0,1,0
10,398,398,72,29,43,3,2
7,423,423,120,87,33,2,1
8,424,424,60,42,18,4,3
0,445,445,39,39,0,1,0
12,462,462,13,1,12,2,1
4,487,487,52,5,47,2,1

14,109,109,13,13,0,1,0
15,118,118,16,16,0,1,0
13,205,205,10,6,4,2,1
7,240,240,48,19,29,4,3
5,284,284,41,22,19,2,1
8,286,286,1,1,0,1,0
17,314,314,21,21,0,1,0
3,367,367,49,2,47,4,3
12,375,375,15,15,0,1,0
9,387,387,60,4,56,3,2
0,390,390,27,16,11,2,1
10,412,412,51,51,0,1,0
6,414,414,1,1,0,1,0
19,427,427,45,45,0,1,0
11,433,433,117,55,62,4,3
2,433,433,51,13,38,2,1
1,452,452,71,32,39,4,3
16,467,467,7,7,0,1,0
4,484,484,57,57,0,1,0
18,490,490,94,4,90,4,3

13,114,114,13,5,8,3,2
21,117,117,1,1,0,1,0
18,125,125,24,10,14,2,1
17,153,153,21,21,0,1,0
2,155,155,19,19,0,1,0
8,197,197,8,3,5,2,1
16,214,214,15,7,8,3,2
7,242,242,34,34,0,1,0
19,249,249,58,49,9,2,1
20,253,253,23,6,17,2,1
11,294,294,43,43,0,1,0
14,296,296,8,8,0,1,0
9,305,305,51,51,0,1,0
12,321,321,59,59,0,1,0
4,322,322,29,26,3,2,1
0,358,358,65,47,18,3,2
3,374,374,4,4,0,1,0
15,439,439,33,33,0,1,0
10,450,450,1,1,0,1,0
1,461,461,4,4,0,1,0
5,475,475,60,36,24,2,1
6,497,497,32,22,10,3,2

15,104,104,36,16,20,2,1
19,118,118,9,1,8,2,1
11,160,160,6,6,0,1,0
18,188,188,1,1,0,1,0
20,207,207,4,4,0,1,0
16,217,217,4,4,0,1,0
14,233,233,37,31,6,3,2
12,235,235,1,1,0,1,0
0,236,236,43,35,8,2,1
21,243,243,72,28,44,3,2
3,247,247,3,3,0,1,0
17,292,292,41,41,0,1,0
9,319,319,30,7,23,2,1
5,336,336,18,18,0,1,0
13,345,345,22,6,16,3,2
2,359,359,54,54,0,1,0
1,366,366,42,5,37,2,1
8,410,410,7,7,0,1,0
7,442,442,11,2,9,4,3
4,454,454,43,43,0,1,0
6,467,467,104,62,42,3,2
10,468,468,45,45,0,1,0

3,155,155,20,17,3,2,1
21,173,173,40,40,0,1,0
8,220,220,25,7,18,2,1
15,246,246,11,11,0,1,0
22,253,253,18,3,15,4,3
10,264,264,4,4,0,1,0
17,285,285,34,34,0,1,0
1,334,334,1,1,0,1,0
4,356,356,45,45,0,1,0
18,358,358,2,2,0,1,0
19,362,362,5,5,0,1,0
7,373,373,19,1,18,3,2
9,394,394,3,3,0,1,0
0,407,407,1,1,0,1,0
5,421,421,17,1,16,3,2
12,424,424,58,40,18,3,2
13,429,429,48,48,0,1,0
11,433,433,57,13,44,4,3
14,470,470,14,5,9,2,1
16,481,481,120,44,76,3,2
6,482,482,153,23,130,4,3
2,487,487,13,13,0,1,0
20,489,489,115,64,51,4,3

10,114,114,4,4,0,1,0
18,136,136,3,3,0,1,0
0,147,147,11,11,0,1,0
3,161,161,3,3,0,1,0
25,182,182,4,4,0,1,0
17,222,222,8,3,5,2,1
6,227,227,1,1,0,1,0
14,236,236,9,9,0,1,0
13,250,250,1,1,0,1,0
15,270,270,28,6,22,4,3
16,281,281,19,19,0,1,0
11,304,304,39,39,0,1,0
2,304,304,19,19,0,1,0
21,342,342,6,6,0,1,0
20,363,363,14,14,0,1,0
12,380,380,120,110,10,2,1
4,389,389,40,40,0,1,0
5,397,397,2,2,0,1,0
8,403,403,1,1,0,1,0
9,433,433,24,16,8,3,2
24,437,437,90,20,70,3,2
23,441,441,12,3,9,4,3
19,446,446,285,285,0,1,0
1,460,460,9,2,7,2,1
22,481,481,22,4,18,3,2
7,497,497,66,24,42,4,3

14,131,131,24,16,8,2,1
1,154,154,2,2,0,1,0
6,156,156,6,6,0,1,0
19,191,191,10,10,0,1,0
22,221,221,52,52,0,1,0
2,224,224,36,24,12,2,1
4,248,248,1,1,0,1,0
8,306,306,41,14,27,4,3
3,314,314,52,4,48,3,2
7,330,330,46,27,19,3,2
13,349,349,4,4,0,1,0
10,351,351,20,20,0,1,0
18,356,356,35,29,6,2,1
15,365,365,16,16,0,1,0
16,376,376,32,32,0,1,0
0,377,377,64,64,0,1,0
9,387,387,4,4,0,1,0
21,388,388,23,10,13,2,1
17,420,420,125,125,0,1,0
20,426,426,22,22,0,1,0
11,432,432,28,3,25,2,1
5,446,446,16,16,0,1,0
12,489,489,53,29,24,4,3

9,125,125,2,2,0,1,0
14,132,132,26,21,5,2,1
7,155,155,35,35,0,1,0
19,165,165,9,9,0,1,0
5,200,200,2,2,0,1,0
16,205,205,38,15,23,2,1
1,210,210,61,34,27,2,1
10,247,247,8,3,5,2,1
12,273,273,46,46,0,1,0
3,329,329,25,25,0,1,0
21,355,355,14,5,9,3,2
11,377,377,58,58,0,1,0
17,379,379,27,17,10,2,1
18,394,394,41,29,12,2,1
8,418,418,99,69,30,3,2
4,430,430,7,7,0,1,0
13,443,443,6,6,0,1,0
0,458,458,2,2,0,1,0
20,464,464,24,24,0,1,0
6,471,471,18,1,17,2,1
2,487,487,1,1,0,1,0
15,487,487,115,41,74,3,2

17,116,116,16,16,0,1,0
18,116,116,11,1,10,2,1
1,122,122,7,7,0,1,0
0,153,153,11,11,0,1,0
19,171,171,22,22,0,1,0
11,182,182,2,2,0,1,0
13,184,184,10,10,0,1,0
10,195,195,24,24,0,1,0
12,231,231,43,4,39,2,1
16,264,264,8,3,5,2,1
2,303,303,95,95,0,1,0
3,325,325,58,17,41,2,1
8,334,334,42,15,27,4,3
14,365,365,82,30,52,3,2
9,420,420,28,10,18,2,1
6,428,428,10,4,6,2,1
4,447,447,60,18,42,3,2
15,451,451,62,32,30,3,2
5,457,457,35,23,12,4,3
7,484,484,26,26,0,1,0

16,104,104,9,9,0,1,0
3,132,132,5,5,0,1,0
5,156,156,2,2,0,1,0
0,174,174,2,2,0,1,0
17,176,176,3,3,0,1,0
8,187,187,3,3,0,1,0
19,191,191,2,2,0,1,0
9,217,217,2,2,0,1,0
4,230,230,18,18,0,1,0
15,233,233,20,10,10,3,2
6,245,245,87,63,24,4,3
1,261,261,31,31,0,1,0
12,316,316,60,60,0,1,0
11,317,317,1,1,0,1,0
10,344,344,16,1,15,4,3
14,357,357,13,4,9,4,3
20,399,399,96,75,21,2,1
2,417,417,23,1,22,2,1
21,418,418,42,6,36,2,1
24,421,421,50,4,46,4,3
13,444,444,29,29,0,1,0
23,465,465,13,13,0,1,0
7,480,480,32,32,0,1,0
18,484,484,122,92,30,2,1
22,498,498,91,34,57,4,3

9,120,120,34,34,0,1,0
20,124,124,2,2,0,1,0
4,151,151,2,2,0,1,0
3,173,173,19,19,0,1,0
8,194,194,23,23,0,1,0
1,220,220,46,46,0,1,0
23,235,235,2,2,0,1,0
11,240,240,13,10,3,2,1
22,248,248,51,51,0,1,0
6,280,280,3,3,0,1,0
12,294,294,4,4,0,1,0
7,305,305,22,22,0,1,0
10,332,332,41,9,32,3,2
15,364,364,30,22,8,3,2
17,375,375,98,98,0,1,0
18,395,395,41,8,33,2,1
21,396,396,32,17,15,2,1
0,397,397,11,11,0,1,0
2,403,403,16,7,9,2,1
14,430,430,4,4,0,1,0
19,453,453,32,32,0,1,0
16,469,469,21,12,9,4,3
5,478,478,7,7,0,1,0
13,480,480,1,1,0,1,0
24,499,499,119,10,109,4,3

3,136,136,14,4,10,4,3
12,144,144,6,6,0,1,0
16,169,169,2,2,0,1,0
14,170,170,59,59,0,1,0
5,191,191,16,16,0,1,0
0,239,239,91,60,31,4,3
17,241,241,8,8,0,1,0
4,247,247,8,8,0,1,0
13,248,248,20,20,0,1,0
2,311,311,1,1,0,1,0
6,337,337,11,11,0,1,0
19,403,403,119,119,0,1,0
10,419,419,105,97,8,3,2
18,423,423,4,4,0,1,0
7,427,427,52,13,39,4,3
8,444,444,46,4,42,2,1
11,458,458,17,17,0,1,0
15,466,466,6,2,4,2,1
9,466,466,20,1,19,3,2
1,482,482,95,8,87,3,2

7,117,117,9,5,4,2,1
17,123,123,2,2,0,1,0
6,127,127,2,2,0,1,0
18,139,139,10,2,8,2,1
3,145,145,11,2,9,4,3
10,149,149,33,15,18,2,1
4,152,152,5,5,0,1,0
21,158,158,15,15,0,1,0
2,180,180,16,16,0,1,0
0,181,181,29,29,0,1,0
8,186,186,56,56,0,1,0
11,198,198,5,5,0,1,0
23,200,200,25,20,5,2,1
13,218,218,1,1,0,1,0
5,269,269,6,1,5,2,1
14,304,304,82,40,42,3,2
9,308,308,15,1,14,2,1
20,317,317,23,20,3,2,1
16,324,324,47,38,9,4,3
22,364,364,8,8,0,1,0
1,383,383,1,1,0,1,0
15,415,415,42,42,0,1,0
19,417,417,85,85,0,1,0
12,418,418,11,5,6,3,2

14,116,116,2,2,0,1,0
10,119,119,2,2,0,1,0
11,124,124,6,6,0,1,0
6,134,134,39,20,19,4,3
13,138,138,20,12,8,2,1
22,212,212,26,26,0,1,0
3,226,226,1,1,0,1,0
12,266,266,19,19,0,1,0
2,286,286,1,1,0,1,0
4,299,299,81,27,54,4,3
21,311,311,11,11,0,1,0
15,322,322,19,7,12,3,2
9,330,330,26,20,6,3,2
1,346,346,45,34,11,2,1
19,347,347,68,45,23,2,1
5,367,367,2,2,0,1,0
16,369,369,49,33,16,3,2
18,370,370,43,27,16,3,2
17,395,395,56,56,0,1,0
8,428,428,15,12,3,2,1
20,434,434,65,47,18,2,1
0,479,479,11,6,5,2,1
7,494,494,60,19,41,2,1

14,109,109,2,2,0,1,0
11,125,125,30,30,0,1,0
3,139,139,6,6,0,1,0
12,158,158,2,2,0,1,0
23,189,189,8,8,0,1,0
15,227,227,23,23,0,1,0
21,239,239,27,27,0,1,0
1,247,247,6,6,0,1,0
2,249,249,1,1,0,1,0
17,251,251,1,1,0,1,0
0,266,266,2,2,0,1,0
22,267,267,36,36,0,1,0
13,279,279,1,1,0,1,0
6,303,303,5,5,0,1,0
8,333,333,23,8,15,4,3
27,339,339,34,34,0,1,0
5,341,341,5,5,0,1,0
28,343,343,59,30,29,2,1
24,344,344,69,48,21,2,1
20,370,370,34,34,0,1,0
4,385,385,1,1,0,1,0
16,389,389,97,97,0,1,0
19,390,390,56,56,0,1,0
25,407,407,23,11,12,4,3
9,426,426,21,21,0,1,0
18,431,431,9,9,0,1,0
7,483,483,92,88,4,2,1
10,491,491,14,9,5,2,1
26,498,498,32,3,29,2,1

1,150,150,36,1,35,4,3
2,152,152,19,19,0,1,0
11,159,159,7,7,0,1,0
0,178,178,7,7,0,1,0
18,203,203,4,4,0,1,0
23,231,231,47,47,0,1,0
21,248,248,29,29,0,1,0
7,280,280,1,1,0,1,0
8,283,283,40,40,0,1,0
16,289,289,6,3,3,2,1
15,318,318,13,5,8,2,1
10,323,323,1,1,0,1,0
13,339,339,36,18,18,3,2
12,347,347,25,1,24,4,3
5,348,348,34,34,0,1,0
19,387,387,74,60,14,2,1
3,390,390,9,9,0,1,0
22,404,404,102,68,34,3,2
9,417,417,33,24,9,2,1
20,457,457,55,19,36,4,3
14,461,461,46,46,0,1,0
4,463,463,48,24,24,2,1
6,491,491,11,11,0,1,0
17,499,499,22,18,4,2,1

12,103,103,5,5,0,1,0
21,104,104,8,8,0,1,0
6,129,129,18,3,15,4,3
8,187,187,64,64,0,1,0
3,221,221,1,1,0,1,0
14,244,244,27,27,0,1,0
16,252,252,4,1,3,2,1
13,292,292,82,82,0,1,0
1,317,317,3,3,0,1,0
20,344,344,136,52,84,3,2
10,352,352,25,10,15,2,1
19,359,359,7,7,0,1,0
11,372,372,13,1,12,3,2
0,374,374,67,17,50,3,2
17,381,381,2,2,0,1,0
5,383,383,17,17,0,1,0
2,394,394,16,8,8,3,2
4,401,401,21,21,0,1,0
9,413,413,15,15,0,1,0
15,416,416,55,55,0,1,0
7,450,450,66,23,43,2,1
18,479,479,18,18,0,1,0

9,112,112,7,4,3,2,1
3,138,138,12,12,0,1,0
8,151,151,27,27,0,1,0
13,152,152,35,20,15,2,1
20,154,154,18,18,0,1,0
7,160,160,1,1,0,1,0
18,171,171,3,3,0,1,0
11,185,185,9,9,0,1,0
2,208,208,23,23,0,1,0
1,250,250,1,1,0,1,0
4,284,284,17,3,14,4,3
5,307,307,41,12,29,4,3
14,322,322,4,4,0,1,0
0,323,323,28,28,0,1,0
16,325,325,7,1,6,2,1
10,366,366,118,28,90,4,3
6,381,381,19,5,14,3,2
19,421,421,16,10,6,2,1
12,424,424,150,39,111,4,3
17,495,495,69,31,38,4,3
15,500,500,68,68,0,1,0

5,127,127,31,31,0,1,0
16,135,135,17,17,0,1,0
6,193,193,6,6,0,1,0
7,209,209,20,20,0,1,0
9,229,229,11,11,0,1,0
0,241,241,22,22,0,1,0
8,252,252,39,1,38,3,2
4,254,254,77,77,0,1,0
1,274,274,10,10,0,1,0
11,287,287,42,36,6,3,2
15,318,318,28,28,0,1,0
14,336,336,10,10,0,1,0
2,383,383,127,127,0,1,0
10,410,410,16,16,0,1,0
13,410,410,153,71,82,3,2
12,479,479,10,5,5,2,1
3,494,494,32,27,5,2,1

6,111,111,1,1,0,1,0
10,113,113,4,4,0,1,0
15,183,183,9,9,0,1,0
16,203,203,23,23,0,1,0
11,209,209,7,7,0,1,0
18,217,217,13,9,4,2,1
20,218,218,48,48,0,1,0
3,252,252,2,2,0,1,0
17,264,264,43,43,0,1,0
7,267,267,30,26,4,2,1
0,272,272,59,59,0,1,0
13,279,279,1,1,0,1,0
1,326,326,95,95,0,1,0
19,329,329,6,6,0,1,0
4,338,338,45,25,20,2,1
12,350,350,18,2,16,3,2
9,393,393,3,3,0,1,0
14,410,410,166,112,54,4,3
5,447,447,3,3,0,1,0
8,494,494,104,104,0,1,0
2,499,499,38,18,20,2,1

7,120,120,13,1,12,2,1
9,157,157,8,2,6,3,2
8,172,172,15,5,10,3,2
5,187,187,3,3,0,1,0
3,204,204,3,3,0,1,0
2,231,231,10,10,0,1,0
16,250,250,2,2,0,1,0
0,281,281,50,10,40,3,2
1,299,299,87,7,80,3,2
15,342,342,35,35,0,1,0
12,347,347,21,21,0,1,0
10,357,357,105,30,75,4,3
13,363,363,67,37,30,2,1
6,380,380,132,132,0,1,0
4,433,433,47,1,46,3,2
14,442,442,97,73,24,2,1
11,482,482,17,6,11,2,1
17,487,487,38,8,30,3,2

8,139,139,6,2,4,2,1
20,156,156,1,1,0,1,0
9,174,174,4,4,0,1,0
12,185,185,55,41,14,3,2
0,202,202,6,6,0,1,0
2,205,205,1,1,0,1,0
16,242,242,17,17,0,1,0
11,264,264,35,9,26,4,3
5,274,274,8,2,6,3,2
25,281,281,78,50,28,3,2
4,296,296,3,3,0,1,0
10,299,299,5,5,0,1,0
1,367,367,78,70,8,2,1
22,376,376,23,11,12,4,3
17,383,383,79,4,75,3,2
19,385,385,37,10,27,4,3
24,387,387,36,36,0,1,0
13,405,405,28,28,0,1,0
6,409,409,19,19,0,1,0
18,432,432,28,6,22,2,1
21,434,434,19,7,12,3,2
7,444,444,58,58,0,1,0
3,476,476,8,2,6,3,2
15,481,481,8,8,0,1,0
14,487,487,11,11,0,1,0
23,500,500,97,61,36,3,2

7,108,108,1,1,0,1,0
27,113,113,9,9,0,1,0
4,164,164,1,1,0,1,0
15,177,177,7,7,0,1,0
8,190,190,30,9,21,4,3
28,203,203,45,45,0,1,0
24,205,205,6,6,0,1,0
22,209,209,24,24,0,1,0
5,220,220,2,2,0,1,0
10,222,222,5,1,4,2,1
19,259,259,21,1,20,3,2
0,269,269,7,7,0,1,0
2,277,277,44,10,34,2,1
9,278,278,31,11,20,2,1
25,296,296,50,8,42,4,3
23,297,297,38,38,0,1,0
20,298,298,15,15,0,1,0
17,300,300,29,13,16,2,1
1,301,301,24,18,6,2,1
26,308,308,57,57,0,1,0
21,324,324,21,9,12,2,1
3,351,351,43,39,4,2,1
12,360,360,56,43,13,2,1
18,381,381,11,11,0,1,0
13,383,383,3,3,0,1,0
6,401,401,10,4,6,3,2
16,424,424,1,1,0,1,0
11,492,492,13,13,0,1,0
14,493,493,8,8,0,1,0

14,100,100,1,1,0,1,0
9,121,121,1,1,0,1,0
13,146,146,34,34,0,1,0
4,170,170,14,14,0,1,0
3,184,184,26,26,0,1,0
5,237,237,48,2,46,2,1
11,260,260,4,4,0,1,0
6,266,266,13,13,0,1,0
18,267,267,8,8,0,1,0
1,274,274,56,56,0,1,0
16,283,283,43,43,0,1,0
2,321,321,42,42,0,1,0
12,355,355,60,12,48,2,1
19,383,383,45,6,39,4,3
17,410,410,63,21,42,4,3
15,416,416,64,54,10,3,2
10,426,426,40,9,31,4,3
8,456,456,52,52,0,1,0
0,472,472,19,19,0,1,0
7,475,475,64,32,32,3,2

26,110,110,1,1,0,1,0
28,118,118,14,6,8,2,1
13,120,120,1,1,0,1,0
2,147,147,2,2,0,1,0
15,171,171,5,5,0,1,0
20,177,177,69,10,59,4,3
11,180,180,10,10,0,1,0
1,205,205,15,3,12,3,2
9,227,227,1,1,0,1,0
24,233,233,31,7,24,4,3
12,237,237,7,7,0,1,0
5,256,256,2,2,0,1,0
14,271,271,27,27,0,1,0
17,302,302,4,4,0,1,0
25,327,327,48,2,46,3,2
0,328,328,27,27,0,1,0
23,365,365,54,22,32,2,1
27,367,367,25,21,4,2,1
6,375,375,3,3,0,1,0
18,379,379,3,3,0,1,0
7,381,381,1,1,0,1,0
3,384,384,12,2,10,3,2
21,395,395,13,13,0,1,0
30,402,402,164,164,0,1,0
16,406,406,51,19,32,2,1
29,411,411,7,7,0,1,0
4,417,417,21,21,0,1,0
22,425,425,17,3,14,4,3
10,449,449,7,1,6,2,1
19,488,488,23,23,0,1,0
8,495,495,3,3,0,1,0

0,102,102,9,5,4,2,1
17,117,117,1,1,0,1,0
16,119,119,34,34,0,1,0
6,131,131,1,1,0,1,0
4,140,140,14,7,7,2,1
15,161,161,3,3,0,1,0
22,168,168,7,7,0,1,0
2,172,172,20,8,12,4,3
9,201,201,21,21,0,1,0
24,209,209,19,19,0,1,0
14,210,210,54,54,0,1,0
11,215,215,26,26,0,1,0
5,217,217,18,4,14,2,1
7,219,219,11,3,8,3,2
18,220,220,16,10,6,2,1
12,229,229,7,3,4,2,1
1,292,292,1,1,0,1,0
13,295,295,18,12,6,2,1
23,341,341,28,28,0,1,0
3,356,356,1,1,0,1,0
10,357,357,16,4,12,3,2
20,406,406,34,34,0,1,0
21,418,418,178,106,72,3,2
8,472,472,15,2,13,2,1
19,492,492,8,8,0,1,0

2,108,108,4,4,0,1,0
5,110,110,1,1,0,1,0
21,113,113,3,3,0,1,0
23,145,145,37,37,0,1,0
0,159,159,46,12,34,2,1
15,168,168,3,3,0,1,0
18,178,178,15,11,4,2,1
26,189,189,9,9,0,1,0
1,198,198,1,1,0,1,0
7,210,210,5,5,0,1,0
16,212,212,8,8,0,1,0
19,219,219,3,3,0,1,0
25,220,220,22,22,0,1,0
24,226,226,59,59,0,1,0
6,226,226,10,10,0,1,0
27,254,254,42,22,20,3,2
20,254,254,24,13,11,2,1
12,259,259,18,18,0,1,0
8,283,283,15,15,0,1,0
13,308,308,55,31,24,2,1
3,326,326,53,53,0,1,0
14,332,332,14,6,8,3,2
17,347,347,7,3,4,2,1
9,356,356,7,7,0,1,0
4,381,381,17,7,10,3,2
22,453,453,35,20,15,4,3
10,472,472,20,13,7,2,1
11,480,480,2,2,0,1,0

5,105,105,33,11,22,2,1
16,147,147,3,3,0,1,0
15,169,169,1,1,0,1,0
7,178,178,24,24,0,1,0
17,223,223,16,1,15,4,3
14,239,239,50,20,30,4,3
8,248,248,5,5,0,1,0
12,274,274,19,19,0,1,0
18,285,285,22,22,0,1,0
13,287,287,34,34,0,1,0
19,302,302,50,50,0,1,0
4,314,314,1,1,0,1,0
6,320,320,12,12,0,1,0
11,341,341,27,12,15,2,1
2,356,356,21,18,3,2,1
20,357,357,108,108,0,1,0
9,360,360,12,12,0,1,0
3,366,366,171,121,50,2,1
0,434,434,2,2,0,1,0
10,461,461,6,6,0,1,0
1,477,477,7,7,0,1,0

11,105,105,5,5,0,1,0
19,107,107,4,4,0,1,0
16,111,111,18,12,6,3,2
14,121,121,2,2,0,1,0
5,133,133,11,3,8,2,1
15,146,146,12,2,10,2,1
18,155,155,27,27,0,1,0
2,171,171,5,5,0,1,0
3,182,182,50,15,35,2,1
0,183,183,26,26,0,1,0
9,233,233,15,15,0,1,0
10,256,256,1,1,0,1,0
7,263,263,16,10,6,2,1
17,274,274,10,10,0,1,0
20,351,351,75,46,29,4,3
1,410,410,68,13,55,4,3
22,447,447,130,130,0,1,0
8,452,452,28,12,16,2,1
12,456,456,36,36,0,1,0
6,456,456,26,20,6,2,1
4,466,466,15,2,13,3,2
21,488,488,46,10,36,4,3
13,499,499,10,10,0,1,0

13,114,114,3,3,0,1,0
10,116,116,5,5,0,1,0
0,125,125,1,1,0,1,0
26,126,126,22,22,0,1,0
9,136,136,8,8,0,1,0
5,136,136,4,4,0,1,0
1,139,139,9,9,0,1,0
11,149,149,14,4,10,2,1
2,185,185,4,4,0,1,0
23,212,212,20,12,8,2,1
17,234,234,1,1,0,1,0
20,255,255,35,35,0,1,0
3,257,257,23,4,19,2,1
12,260,260,65,26,39,3,2
6,264,264,30,6,24,2,1
7,278,278,16,1,15,4,3
18,283,283,35,35,0,1,0
19,296,296,8,8,0,1,0
22,320,320,54,7,47,4,3
25,338,338,1,1,0,1,0
27,354,354,8,5,3,2,1
4,363,363,5,5,0,1,0
8,383,383,42,26,16,3,2
15,407,407,8,3,5,2,1
14,434,434,9,9,0,1,0
24,466,466,42,8,34,3,2
16,477,477,37,6,31,2,1
21,490,490,134,134,0,1,0

6,131,131,16,4,12,3,2
17,141,141,18,10,8,2,1
15,150,150,46,31,15,4,3
0,151,151,1,1,0,1,0
2,172,172,33,33,0,1,0
7,172,172,4,4,0,1,0
8,179,179,12,12,0,1,0
1,198,198,42,23,19,2,1
12,226,226,16,16,0,1,0
4,257,257,6,6,0,1,0
13,274,274,12,5,7,2,1
14,281,281,4,4,0,1,0
16,313,313,80,30,50,2,1
10,316,316,7,4,3,2,1
18,363,363,25,7,18,2,1
5,366,366,31,26,5,2,1
9,375,375,102,21,81,4,3
19,384,384,22,22,0,1,0
3,412,412,41,11,30,3,2
11,413,413,63,41,22,3,2

7,100,100,10,10,0,1,0
2,124,124,1,1,0,1,0
16,130,130,4,4,0,1,0
12,158,158,26,17,9,4,3
18,165,165,15,15,0,1,0
8,171,171,1,1,0,1,0
10,172,172,15,15,0,1,0
9,176,176,34,34,0,1,0
13,180,180,9,9,0,1,0
1,192,192,18,18,0,1,0
4,222,222,7,7,0,1,0
17,225,225,17,17,0,1,0
0,231,231,18,18,0,1,0
22,243,243,38,3,35,2,1
20,286,286,10,10,0,1,0
3,298,298,27,11,16,2,1
19,321,321,47,29,18,2,1
11,322,322,73,17,56,3,2
5,326,326,4,4,0,1,0
14,387,387,56,20,36,2,1
15,401,401,21,7,14,2,1
21,426,426,145,71,74,3,2
6,479,479,7,7,0,1,0

19,109,109,30,30,0,1,0
7,136,136,19,2,17,2,1
17,143,143,27,27,0,1,0
18,155,155,20,20,0,1,0
16,159,159,3,3,0,1,0
4,173,173,37,9,28,2,1
3,191,191,1,1,0,1,0
13,224,224,17,5,12,3,2
11,250,250,9,5,4,2,1
2,262,262,36,5,31,3,2
5,263,263,6,3,3,2,1
1,286,286,9,9,0,1,0
14,286,286,28,19,9,4,3
10,291,291,12,4,8,3,2
6,292,292,18,3,15,4,3
8,370,370,70,67,3,2,1
15,370,370,23,8,15,4,3
9,373,373,69,24,45,4,3
0,397,397,15,15,0,1,0
20,439,439,24,24,0,1,0
12,442,442,44,44,0,1,0
21,476,476,58,42,16,2,1

18,115,115,5,5,0,1,0
6,118,118,19,9,10,2,1
8,146,146,4,1,3,2,1
0,192,192,2,2,0,1,0
17,196,196,3,3,0,1,0
13,209,209,3,3,0,1,0
3,216,216,52,52,0,1,0
5,222,222,14,4,10,2,1
12,256,256,15,3,12,4,3
2,281,281,16,16,0,1,0
19,328,328,76,76,0,1,0
7,328,328,5,5,0,1,0
11,333,333,178,86,92,3,2
1,377,377,105,4,101,4,3
15,386,386,16,16,0,1,0
14,399,399,5,5,0,1,0
10,407,407,63,63,0,1,0
16,419,419,7,7,0,1,0
4,470,470,62,26,36,2,1
9,488,488,56,25,31,2,1

20,112,112,6,6,0,1,0
26,116,116,4,4,0,1,0
0,146,146,29,14,15,4,3
13,157,157,41,26,15,4,3
12,186,186,3,3,0,1,0
1,192,192,1,1,0,1,0
2,210,210,2,2,0,1,0
4,211,211,9,9,0,1,0
7,214,214,24,24,0,1,0
8,224,224,7,1,6,2,1
10,258,258,11,1,10,3,2
6,262,262,13,2,11,2,1
22,279,279,3,3,0,1,0
5,291,291,22,16,6,3,2
9,311,311,5,1,4,2,1
25,317,317,26,26,0,1,0
19,321,321,50,50,0,1,0
3,347,347,6,6,0,1,0
24,348,348,13,13,0,1,0
18,380,380,50,41,9,2,1
14,383,383,9,9,0,1,0
21,397,397,75,75,0,1,0
16,415,415,37,18,19,2,1
23,415,415,153,121,32,4,3
15,461,461,2,2,0,1,0
17,477,477,26,17,9,2,1
11,500,500,53,44,9,4,3

11,102,102,8,8,0,1,0
16,152,152,13,7,6,3,2
19,164,164,10,1,9,2,1
15,171,171,1,1,0,1,0
1,183,183,19,13,6,2,1
4,204,204,14,2,12,2,1
21,207,207,35,35,0,1,0
0,259,259,20,6,14,2,1
17,262,262,1,1,0,1,0
9,273,273,4,4,0,1,0
12,277,277,12,12,0,1,0
7,284,284,12,12,0,1,0
22,289,289,13,13,0,1,0
14,318,318,44,17,27,2,1
13,328,328,87,50,37,3,2
10,368,368,5,5,0,1,0
8,369,369,55,55,0,1,0
6,426,426,140,5,135,4,3
18,427,427,11,11,0,1,0
20,433,433,138,116,22,3,2
3,434,434,37,37,0,1,0
5,451,451,34,34,0,1,0
2,486,486,10,10,0,1,0

17,146,146,34,30,4,2,1
13,148,148,7,7,0,1,0
18,152,152,16,10,6,2,1
11,152,152,29,15,14,2,1
12,157,157,7,7,0,1,0
9,171,171,29,29,0,1,0
10,248,248,27,18,9,4,3
6,274,274,16,16,0,1,0
8,278,278,14,14,0,1,0
7,283,283,88,16,72,3,2
2,349,349,66,48,18,4,3
0,362,362,25,25,0,1,0
19,362,362,73,60,13,2,1
4,368,368,37,37,0,1,0
14,376,376,29,29,0,1,0
15,394,394,32,32,0,1,0
1,437,437,32,32,0,1,0
3,459,459,37,37,0,1,0
5,467,467,1,1,0,1,0
16,480,480,17,1,16,3,2

19,107,107,20,6,14,2,1
14,134,134,18,18,0,1,0
11,142,142,3,3,0,1,0
21,163,163,8,1,7,2,1
0,168,168,4,4,0,1,0
5,173,173,21,21,0,1,0
4,195,195,1,1,0,1,0
3,245,245,45,45,0,1,0
23,261,261,3,3,0,1,0
16,264,264,54,14,40,3,2
10,270,270,65,56,9,2,1
6,277,277,1,1,0,1,0
18,285,285,6,6,0,1,0
22,294,294,36,22,14,2,1
17,294,294,28,28,0,1,0
1,302,302,6,6,0,1,0
12,353,353,24,24,0,1,0
9,368,368,20,14,6,3,2
13,371,371,24,24,0,1,0
8,435,435,43,9,34,3,2
24,466,466,122,109,13,2,1
7,476,476,5,5,0,1,0
15,477,477,19,10,9,4,3
20,483,483,60,19,41,2,1
2,493,493,27,27,0,1,0

14,108,108,3,3,0,1,0
8,118,118,48,48,0,1,0
18,133,133,1,1,0,1,0
11,138,138,45,45,0,1,0
13,161,161,47,47,0,1,0
17,162,162,23,9,14,3,2
5,177,177,2,2,0,1,0
4,192,192,3,3,0,1,0
12,199,199,14,14,0,1,0
0,213,213,11,1,10,2,1
10,249,249,83,42,41,2,1
9,306,306,13,13,0,1,0
7,328,328,5,5,0,1,0
15,338,338,25,7,18,3,2
2,341,341,38,21,17,2,1
20,373,373,5,5,0,1,0
3,392,392,9,3,6,3,2
19,412,412,34,34,0,1,0
6,453,453,19,3,16,2,1
1,454,454,22,22,0,1,0
16,459,459,44,44,0,1,0

6,134,134,5,1,4,2,1
16,158,158,2,2,0,1,0
14,184,184,6,6,0,1,0
0,202,202,70,55,15,4,3
8,245,245,9,2,7,2,1
4,276,276,11,11,0,1,0
5,284,284,8,8,0,1,0
10,332,332,64,38,26,2,1
12,342,342,25,6,19,4,3
18,343,343,7,7,0,1,0
3,349,349,85,85,0,1,0
7,388,388,35,31,4,2,1
15,411,411,122,29,93,4,3
9,425,425,48,42,6,2,1
13,431,431,69,69,0,1,0
17,443,443,2,2,0,1,0
1,469,469,6,6,0,1,0
2,476,476,128,128,0,1,0
11,499,499,108,83,25,2,1

2,272,272,42,8,34,2,1
12,283,283,2,2,0,1,0
7,287,287,2,2,0,1,0
6,288,288,19,19,0,1,0
4,347,347,75,57,18,4,3
0,349,349,25,25,0,1,0
5,358,358,30,6,24,2,1
14,360,360,52,31,21,4,3
10,365,365,20,20,0,1,0
8,367,367,49,49,0,1,0
15,419,419,118,105,13,2,1
13,451,451,24,4,20,2,1
9,455,455,28,1,27,4,3
3,460,460,2,2,0,1,0
11,474,474,87,87,0,1,0
16,484,484,90,28,62,4,3
1,500,500,252,152,100,3,2

17,104,104,8,2,6,3,2
0,109,109,5,5,0,1,0
8,130,130,13,13,0,1,0
14,130,130,5,5,0,1,0
5,135,135,6,6,0,1,0
18,151,151,1,1,0,1,0
4,163,163,10,10,0,1,0
13,184,184,10,3,7,2,1
1,195,195,39,3,36,4,3
20,209,209,2,2,0,1,0
19,219,219,11,6,5,2,1
22,235,235,31,31,0,1,0
21,245,245,30,30,0,1,0
11,267,267,16,16,0,1,0
10,318,318,13,3,10,3,2
15,378,378,200,160,40,3,2
3,393,393,63,63,0,1,0
12,400,400,18,10,8,2,1
6,402,402,42,42,0,1,0
16,419,419,45,45,0,1,0
9,437,437,70,70,0,1,0
2,466,466,18,18,0,1,0
7,472,472,19,1,18,4,3

22,116,116,16,2,14,3,2
2,132,132,11,3,8,2,1
6,136,136,27,27,0,1,0
18,137,137,11,11,0,1,0
15,148,148,3,3,0,1,0
12,156,156,8,8,0,1,0
5,157,157,24,3,21,4,3
8,170,170,22,22,0,1,0
17,181,181,25,1,24,3,2
11,183,183,1,1,0,1,0
0,192,192,1,1,0,1,0
4,219,219,1,1,0,1,0
1,246,246,40,17,23,2,1
9,306,306,13,1,12,2,1
20,311,311,7,7,0,1,0
7,332,332,18,2,16,3,2
14,336,336,45,3,42,4,3
3,341,341,47,47,0,1,0
13,350,350,56,23,33,4,3
16,376,376,91,91,0,1,0
10,416,416,31,3,28,3,2
21,427,427,34,34,0,1,0
19,500,500,51,26,25,3,2

13,104,104,35,26,9,4,3
11,116,116,6,3,3,2,1
14,120,120,2,2,0,1,0
5,138,138,24,5,19,2,1
16,150,150,5,5,0,1,0
3,161,161,46,32,14,2,1
12,170,170,56,51,5,2,1
17,251,251,12,4,8,2,1
7,252,252,15,10,5,2,1
15,263,263,34,34,0,1,0
18,268,268,18,13,5,2,1
9,337,337,23,11,12,3,2
2,381,381,14,7,7,2,1
10,382,382,14,9,5,2,1
0,405,405,1,1,0,1,0
6,423,423,12,12,0,1,0
1,462,462,42,42,0,1,0
4,467,467,86,43,43,2,1
8,490,490,117,51,66,3,2

15,121,121,4,4,0,1,0
6,132,132,2,2,0,1,0
10,133,133,16,6,10,2,1
1,141,141,1,1,0,1,0
5,155,155,23,9,14,2,1
12,164,164,29,29,0,1,0
4,211,211,68,16,52,3,2
18,259,259,10,1,9,2,1
11,279,279,36,36,0,1,0
17,299,299,47,35,12,4,3
2,316,316,50,50,0,1,0
8,325,325,8,8,0,1,0
16,347,347,61,61,0,1,0
0,356,356,96,72,24,3,2
9,416,416,77,77,0,1,0
7,444,444,12,12,0,1,0
13,475,475,41,41,0,1,0
14,492,492,12,4,8,3,2
3,499,499,64,35,29,2,1

1,116,116,7,7,0,1,0
16,140,140,10,3,7,2,1
14,155,155,3,3,0,1,0
0,157,157,17,10,7,2,1
12,176,176,18,9,9,4,3
2,185,185,27,27,0,1,0
15,201,201,45,45,0,1,0
6,204,204,34,3,31,2,1
13,207,207,3,3,0,1,0
3,226,226,23,2,21,2,1
8,292,292,43,15,28,3,2
10,295,295,36,24,12,2,1
17,332,332,19,10,9,4,3
4,407,407,32,5,27,4,3
7,410,410,94,94,0,1,0
5,417,417,26,8,18,3,2
9,450,450,162,42,120,4,3
11,452,452,17,8,9,2,1
18,470,470,56,20,36,2,1

19,101,101,27,27,0,1,0
4,112,112,12,12,0,1,0
13,122,122,14,14,0,1,0
16,125,125,11,11,0,1,0
3,127,127,2,2,0,1,0
9,168,168,5,1,4,2,1
2,189,189,30,30,0,1,0
5,204,204,34,31,3,2,1
21,214,214,8,8,0,1,0
15,214,214,4,4,0,1,0
10,216,216,7,1,6,2,1
7,230,230,4,4,0,1,0
1,241,241,22,22,0,1,0
12,244,244,37,37,0,1,0
8,299,299,18,18,0,1,0
17,325,325,57,57,0,1,0
11,327,327,26,12,14,2,1
14,345,345,6,6,0,1,0
18,388,388,29,29,0,1,0
6,412,412,42,42,0,1,0
20,412,412,75,11,64,3,2
0,453,453,109,11,98,3,2

15,107,107,23,1,22,3,2
0,115,115,13,13,0,1,0
16,138,138,16,8,8,3,2
13,175,175,55,18,37,2,1
20,188,188,20,5,15,4,3
2,191,191,2,2,0,1,0
10,212,212,31,15,16,3,2
3,222,222,33,10,23,3,2
5,252,252,11,3,8,3,2
17,256,256,5,5,0,1,0
11,260,260,3,3,0,1,0
12,263,263,30,30,0,1,0
18,263,263,15,7,8,2,1
19,278,278,14,14,0,1,0
1,337,337,17,3,14,4,3
14,376,376,47,22,25,2,1
4,403,403,59,59,0,1,0
8,412,412,34,19,15,4,3
9,427,427,147,100,47,4,3
6,447,447,1,1,0,1,0
7,497,497,7,7,0,1,0

16,168,168,60,60,0,1,0
1,225,225,2,2,0,1,0
6,229,229,26,26,0,1,0
21,267,267,15,8,7,2,1
10,268,268,46,46,0,1,0
11,270,270,23,8,15,4,3
22,275,275,109,100,9,3,2
18,280,280,4,4,0,1,0
23,280,280,16,10,6,3,2
3,281,281,48,39,9,4,3
7,302,302,24,8,16,2,1
8,309,309,10,2,8,2,1
0,316,316,33,2,31,2,1
2,320,320,10,10,0,1,0
20,343,343,32,11,21,4,3
4,348,348,1,1,0,1,0
17,353,353,4,1,3,2,1
5,410,410,3,3,0,1,0
13,411,411,36,4,32,3,2
15,414,414,5,2,3,2,1
24,443,443,45,31,14,2,1
12,463,463,70,43,27,4,3
9,467,467,8,2,6,3,2
14,488,488,18,11,7,2,1
19,493,493,7,3,4,2,1

7,125,125,8,3,5,2,1
13,196,196,42,42,0,1,0
0,207,207,21,6,15,2,1
10,213,213,19,15,4,2,1
5,260,260,36,36,0,1,0
1,268,268,11,11,0,1,0
11,276,276,9,9,0,1,0
8,282,282,23,14,9,2,1
6,300,300,158,26,132,4,3
2,345,345,65,65,0,1,0
15,389,389,47,31,16,3,2
17,394,394,26,26,0,1,0
14,406,406,22,22,0,1,0
3,431,431,6,1,5,2,1
4,444,444,13,13,0,1,0
16,476,476,162,134,28,3,2
9,484,484,54,33,21,4,3
12,486,486,2,2,0,1,0

21,110,110,19,19,0,1,0
2,141,141,22,22,0,1,0
18,190,190,22,4,18,2,1
20,207,207,11,11,0,1,0
4,234,234,1,1,0,1,0
8,235,235,62,62,0,1,0
12,235,235,3,3,0,1,0
1,237,237,2,2,0,1,0
17,275,275,61,17,44,3,2
13,278,278,32,24,8,2,1
6,289,289,23,23,0,1,0
0,312,312,62,62,0,1,0
9,320,320,27,27,0,1,0
16,331,331,6,6,0,1,0
10,374,374,53,53,0,1,0
15,402,402,45,35,10,3,2
14,422,422,41,41,0,1,0
11,444,444,8,8,0,1,0
7,446,446,17,17,0,1,0
19,473,473,96,96,0,1,0
3,487,487,1,1,0,1,0
5,490,490,52,5,47,2,1

21,179,179,34,34,0,1,0
10,249,249,2,2,0,1,0
8,264,264,35,11,24,3,2
20,281,281,72,72,0,1,0
19,288,288,18,6,12,4,3
12,314,314,7,1,6,2,1
14,321,321,19,19,0,1,0
0,345,345,9,9,0,1,0
22,346,346,11,11,0,1,0
13,361,361,97,97,0,1,0
18,363,363,11,11,0,1,0
2,372,372,53,40,13,2,1
1,376,376,12,12,0,1,0
17,378,378,32,8,24,3,2
15,384,384,15,15,0,1,0
9,389,389,67,32,35,3,2
5,417,417,88,76,12,4,3
6,445,445,110,98,12,3,2
4,474,474,1,1,0,1,0
11,474,474,17,17,0,1,0
7,486,486,31,5,26,2,1
16,487,487,45,5,40,3,2
3,497,497,3,3,0,1,0

5,117,117,9,9,0,1,0
3,125,125,5,5,0,1,0
8,151,151,23,15,8,2,1
6,175,175,79,1,78,4,3
15,176,176,3,3,0,1,0
11,293,293,59,59,0,1,0
14,327,327,75,37,38,2,1
2,340,340,33,33,0,1,0
1,371,371,21,21,0,1,0
7,418,418,53,53,0,1,0
0,425,425,72,72,0,1,0
10,427,427,60,60,0,1,0
9,439,439,32,32,0,1,0
12,445,445,43,43,0,1,0
13,474,474,36,24,12,4,3
16,479,479,2,2,0,1,0
4,493,493,104,54,50,2,1

21,116,116,4,4,0,1,0
19,133,133,5,5,0,1,0
11,142,142,1,1,0,1,0
18,158,158,7,7,0,1,0
6,159,159,15,15,0,1,0
13,178,178,5,5,0,1,0
23,186,186,25,25,0,1,0
4,244,244,10,10,0,1,0
0,267,267,19,19,0,1,0
14,271,271,29,29,0,1,0
3,292,292,16,6,10,3,2
20,295,295,8,8,0,1,0
15,304,304,3,3,0,1,0
2,340,340,17,17,0,1,0
5,368,368,43,43,0,1,0
22,368,368,54,26,28,2,1
17,370,370,57,47,10,2,1
9,375,375,133,133,0,1,0
1,375,375,14,14,0,1,0
7,383,383,6,6,0,1,0
12,394,394,49,49,0,1,0
10,454,454,29,29,0,1,0
8,483,483,22,16,6,2,1
16,492,492,208,155,53,4,3

20,123,123,2,2,0,1,0
1,139,139,4,1,3,2,1
0,140,140,2,2,0,1,0
11,140,140,14,4,10,4,3
2,175,175,27,27,0,1,0
19,187,187,15,11,4,2,1
17,197,197,7,7,0,1,0
6,201,201,19,14,5,2,1
5,295,295,25,9,16,2,1
16,296,296,14,8,6,3,2
10,299,299,30,12,18,3,2
18,306,306,10,10,0,1,0
7,313,313,18,9,9,2,1
4,315,315,10,5,5,2,1
13,326,326,7,7,0,1,0
3,341,341,57,9,48,2,1
12,372,372,69,59,10,3,2
9,380,380,59,3,56,3,2
8,403,403,86,71,15,2,1
14,413,413,203,178,25,2,1
15,416,416,46,25,21,4,3

1,111,111,1,1,0,1,0
14,144,144,26,26,0,1,0
5,218,218,19,9,10,3,2
18,218,218,31,13,18,3,2
4,257,257,27,3,24,2,1
7,293,293,19,19,0,1,0
2,293,293,42,16,26,2,1
6,305,305,98,91,7,2,1
9,327,327,19,19,0,1,0
16,352,352,17,4,13,4,3
11,353,353,109,45,64,4,3
13,353,353,19,10,9,4,3
15,425,425,49,49,0,1,0
3,437,437,35,27,8,2,1
12,446,446,32,6,26,3,2
17,446,446,7,7,0,1,0
0,472,472,3,3,0,1,0
10,473,473,59,37,22,3,2
8,482,482,137,75,62,3,2

1,105,105,6,6,0,1,0
10,109,109,5,5,0,1,0
19,119,119,13,13,0,1,0
18,125,125,2,2,0,1,0
2,133,133,10,10,0,1,0
13,167,167,1,1,0,1,0
14,171,171,3,3,0,1,0
9,236,236,13,13,0,1,0
4,247,247,13,9,4,2,1
12,254,254,5,5,0,1,0
0,309,309,51,11,40,2,1
5,310,310,9,3,6,3,2
23,321,321,17,17,0,1,0
8,332,332,37,37,0,1,0
7,336,336,71,71,0,1,0
3,350,350,44,44,0,1,0
15,351,351,3,3,0,1,0
16,365,365,291,267,24,4,3
17,374,374,27,2,25,2,1
22,404,404,5,1,4,2,1
6,422,422,46,9,37,4,3
21,439,439,12,12,0,1,0
20,463,463,7,3,4,2,1
11,492,492,20,7,13,4,3

18,113,113,6,6,0,1,0
10,134,134,21,21,0,1,0
2,151,151,13,8,5,2,1
21,185,185,30,9,21,2,1
4,202,202,1,1,0,1,0
1,204,204,28,28,0,1,0
8,211,211,33,6,27,4,3
17,213,213,41,7,34,3,2
12,250,250,17,17,0,1,0
22,254,254,47,25,22,3,2
14,263,263,9,1,8,3,2
0,278,278,10,1,9,2,1
6,294,294,9,9,0,1,0
7,309,309,2,2,0,1,0
16,341,341,47,47,0,1,0
13,350,350,10,2,8,3,2
3,355,355,16,6,10,3,2
5,364,364,43,10,33,4,3
20,371,371,8,8,0,1,0
11,383,383,86,26,60,3,2
15,402,402,102,93,9,2,1
9,416,416,1,1,0,1,0
23,438,438,18,18,0,1,0
19,479,479,16,2,14,3,2

13,102,102,1,1,0,1,0
16,119,119,6,6,0,1,0
1,140,140,32,32,0,1,0
6,155,155,11,6,5,2,1
24,166,166,75,61,14,2,1
5,180,180,2,2,0,1,0
4,188,188,1,1,0,1,0
20,196,196,9,9,0,1,0
21,208,208,5,1,4,2,1
25,243,243,15,15,0,1,0
8,252,252,19,19,0,1,0
3,260,260,2,2,0,1,0
18,265,265,2,2,0,1,0
11,273,273,35,9,26,3,2
23,302,302,30,22,8,2,1
19,307,307,10,10,0,1,0
10,322,322,15,2,13,2,1
7,356,356,19,15,4,2,1
17,377,377,43,43,0,1,0
0,400,400,2,2,0,1,0
15,415,415,105,81,24,3,2
9,452,452,48,27,21,4,3
22,460,460,107,49,58,4,3
12,462,462,1,1,0,1,0
2,480,480,43,12,31,4,3
14,491,491,4,4,0,1,0

1,114,114,24,24,0,1,0
15,119,119,17,5,12,4,3
13,145,145,5,5,0,1,0
0,147,147,1,1,0,1,0
9,160,160,7,1,6,3,2
17,183,183,5,5,0,1,0
6,213,213,29,2,27,4,3
11,217,217,46,46,0,1,0
18,237,237,30,30,0,1,0
2,241,241,12,5,7,2,1
19,247,247,37,5,32,4,3
7,263,263,1,1,0,1,0
5,285,285,25,25,0,1,0
12,301,301,33,33,0,1,0
4,308,308,4,4,0,1,0
20,336,336,19,1,18,2,1
21,343,343,17,13,4,2,1
10,367,367,90,90,0,1,0
14,372,372,49,49,0,1,0
16,381,381,112,19,93,4,3
3,385,385,36,8,28,2,1
8,453,453,1,1,0,1,0

9,114,114,39,27,12,2,1
6,176,176,28,13,15,4,3
8,200,200,1,1,0,1,0
14,214,214,1,1,0,1,0
13,232,232,7,7,0,1,0
1,267,267,19,19,0,1,0
5,270,270,26,26,0,1,0
15,273,273,29,17,12,4,3
4,305,305,11,5,6,3,2
10,311,311,14,2,12,4,3
11,312,312,111,18,93,4,3
3,318,318,8,8,0,1,0
18,321,321,21,21,0,1,0
17,328,328,22,8,14,2,1
16,353,353,17,1,16,4,3
0,371,371,46,46,0,1,0
19,371,371,14,5,9,3,2
2,406,406,63,46,17,2,1
12,416,416,147,119,28,2,1
7,488,488,46,46,0,1,0

10,110,110,8,8,0,1,0
7,124,124,11,3,8,3,2
19,138,138,42,7,35,2,1
16,144,144,10,10,0,1,0
2,148,148,5,2,3,2,1
1,169,169,16,10,6,3,2
22,171,171,3,3,0,1,0
23,173,173,10,10,0,1,0
0,187,187,16,5,11,2,1
12,215,215,21,21,0,1,0
17,238,238,3,3,0,1,0
6,239,239,6,2,4,2,1
14,239,239,10,10,0,1,0
26,266,266,6,2,4,2,1
13,281,281,8,8,0,1,0
8,295,295,48,16,32,2,1
11,311,311,20,2,18,2,1
25,317,317,1,1,0,1,0
4,406,406,25,12,13,2,1
3,409,409,9,9,0,1,0
9,410,410,42,17,25,2,1
20,410,410,111,63,48,4,3
21,429,429,46,46,0,1,0
15,432,432,21,21,0,1,0
18,434,434,78,58,20,2,1
24,470,470,68,17,51,4,3
5,473,473,2,2,0,1,0

4,133,133,9,9,0,1,0
9,195,195,18,2,16,3,2
15,215,215,18,18,0,1,0
16,240,240,4,1,3,2,1
1,247,247,48,48,0,1,0
19,276,276,16,16,0,1,0
10,296,296,39,39,0,1,0
6,339,339,39,33,6,2,1
8,340,340,2,2,0,1,0
17,357,357,23,23,0,1,0
14,361,361,90,90,0,1,0
5,389,389,34,1,33,2,1
18,398,398,31,31,0,1,0
2,400,400,1,1,0,1,0
0,403,403,57,30,27,2,1
13,426,426,91,91,0,1,0
7,470,470,167,167,0,1,0
3,473,473,19,19,0,1,0
11,478,478,98,98,0,1,0
12,498,498,6,6,0,1,0

20,108,108,2,2,0,1,0
7,113,113,16,4,12,4,3
0,144,144,5,5,0,1,0
4,166,166,16,1,15,4,3
16,168,168,5,5,0,1,0
6,201,201,1,1,0,1,0
15,240,240,42,42,0,1,0
8,248,248,67,67,0,1,0
18,262,262,41,41,0,1,0
3,277,277,39,10,29,2,1
19,285,285,68,68,0,1,0
1,300,300,34,34,0,1,0
10,303,303,4,4,0,1,0
14,312,312,16,16,0,1,0
5,322,322,22,22,0,1,0
12,373,373,45,45,0,1,0
2,379,379,61,23,38,3,2
11,427,427,19,5,14,3,2
21,432,432,26,26,0,1,0
17,476,476,74,74,0,1,0
13,480,480,52,52,0,1,0
9,486,486,6,6,0,1,0

21,129,129,1,1,0,1,0
12,145,145,18,18,0,1,0
8,145,145,28,28,0,1,0
20,154,154,19,19,0,1,0
16,189,189,11,1,10,3,2
6,203,203,1,1,0,1,0
7,207,207,3,3,0,1,0
14,210,210,6,1,5,2,1
3,217,217,5,5,0,1,0
19,221,221,5,5,0,1,0
1,261,261,33,33,0,1,0
5,270,270,13,13,0,1,0
10,270,270,17,17,0,1,0
22,298,298,64,12,52,3,2
0,373,373,68,44,24,2,1
15,390,390,24,8,16,2,1
11,412,412,20,12,8,3,2
2,439,439,55,19,36,2,1
18,452,452,74,74,0,1,0
13,461,461,141,12,129,4,3
9,464,464,65,9,56,3,2
4,478,478,4,4,0,1,0
17,496,496,66,66,0,1,0

20,115,115,2,2,0,1,0
16,126,126,7,1,6,3,2
3,128,128,11,11,0,1,0
15,130,130,38,30,8,3,2
9,156,156,19,19,0,1,0
7,196,196,10,1,9,2,1
5,214,214,7,4,3,2,1
4,219,219,1,1,0,1,0
21,236,236,46,21,25,2,1
22,261,261,58,46,12,4,3
17,280,280,7,7,0,1,0
8,307,307,30,30,0,1,0
1,321,321,9,3,6,2,1
0,355,355,76,76,0,1,0
2,361,361,24,24,0,1,0
12,370,370,89,47,42,3,2
11,400,400,2,2,0,1,0
13,420,420,10,6,4,2,1
10,422,422,51,51,0,1,0
23,432,432,26,7,19,2,1
14,480,480,3,3,0,1,0
18,481,481,76,50,26,2,1
6,483,483,4,4,0,1,0
19,484,484,46,46,0,1,0

2,103,103,35,17,18,2,1
1,154,154,7,7,0,1,0
13,157,157,15,7,8,3,2
6,160,160,25,25,0,1,0
18,180,180,8,8,0,1,0
4,189,189,6,6,0,1,0
9,195,195,3,3,0,1,0
5,197,197,16,9,7,2,1
7,204,204,28,28,0,1,0
22,214,214,33,33,0,1,0
20,266,266,4,4,0,1,0
3,291,291,2,2,0,1,0
21,310,310,44,2,42,4,3
15,312,312,17,9,8,3,2
8,325,325,3,3,0,1,0
0,327,327,27,15,12,4,3
12,338,338,6,6,0,1,0
19,366,366,134,90,44,3,2
14,378,378,40,20,20,2,1
10,442,442,77,39,38,3,2
11,447,447,2,2,0,1,0
16,447,447,27,27,0,1,0
17,467,467,39,12,27,3,2

14,110,110,11,2,9,4,3
20,113,113,5,5,0,1,0
1,154,154,17,17,0,1,0
7,154,154,20,5,15,2,1
13,179,179,10,10,0,1,0
9,211,211,5,5,0,1,0
18,244,244,52,52,0,1,0
12,246,246,4,4,0,1,0
15,256,256,34,8,26,2,1
21,277,277,14,4,10,3,2
22,278,278,44,44,0,1,0
24,291,291,8,8,0,1,0
0,309,309,19,1,18,3,2
11,333,333,55,46,9,4,3
16,335,335,100,13,87,4,3
17,356,356,3,3,0,1,0
8,369,369,35,7,28,2,1
3,393,393,17,17,0,1,0
23,405,405,37,37,0,1,0
4,409,409,31,9,22,2,1
2,411,411,1,1,0,1,0
5,427,427,52,9,43,4,3
10,435,435,38,38,0,1,0
19,454,454,42,42,0,1,0
6,459,459,7,7,0,1,0

2,165,165,5,5,0,1,0
10,170,170,4,4,0,1,0
13,198,198,1,1,0,1,0
27,201,201,15,3,12,2,1
3,211,211,1,1,0,1,0
25,217,217,11,4,7,2,1
18,217,217,12,12,0,1,0
16,256,256,32,21,11,2,1
7,281,281,15,10,5,2,1
11,282,282,21,21,0,1,0
4,283,283,13,13,0,1,0
26,292,292,24,14,10,2,1
5,308,308,30,30,0,1,0
6,322,322,56,56,0,1,0
12,327,327,4,4,0,1,0
9,330,330,11,11,0,1,0
8,336,336,16,16,0,1,0
20,346,346,27,27,0,1,0
0,355,355,9,1,8,3,2
22,368,368,31,31,0,1,0
14,375,375,8,8,0,1,0
17,377,377,53,49,4,2,1
21,399,399,53,53,0,1,0
23,407,407,19,19,0,1,0
24,408,408,156,42,114,4,3
15,426,426,19,19,0,1,0
19,455,455,59,59,0,1,0
1,487,487,69,69,0,1,0

5,106,106,2,2,0,1,0
19,126,126,12,12,0,1,0
20,150,150,7,7,0,1,0
13,161,161,4,4,0,1,0
22,180,180,19,9,10,2,1
16,184,184,45,30,15,4,3
15,184,184,60,60,0,1,0
6,230,230,8,5,3,2,1
12,238,238,11,11,0,1,0
7,240,240,20,20,0,1,0
9,284,284,58,58,0,1,0
14,293,293,10,10,0,1,0
3,336,336,20,17,3,2,1
1,344,344,19,19,0,1,0
11,345,345,12,9,3,2,1
8,356,356,53,53,0,1,0
18,382,382,14,14,0,1,0
2,403,403,21,21,0,1,0
4,407,407,12,12,0,1,0
21,432,432,49,43,6,2,1
10,443,443,63,63,0,1,0
0,458,458,88,16,72,4,3
17,486,486,46,46,0,1,0

2,149,149,3,3,0,1,0
15,186,186,73,73,0,1,0
17,212,212,12,6,6,3,2
8,224,224,46,46,0,1,0
12,224,224,3,3,0,1,0
0,225,225,45,4,41,2,1
10,234,234,12,12,0,1,0
9,243,243,34,7,27,4,3
3,262,262,27,27,0,1,0
1,275,275,1,1,0,1,0
14,278,278,26,26,0,1,0
5,291,291,19,19,0,1,0
18,334,334,32,32,0,1,0
19,346,346,63,63,0,1,0
16,353,353,22,17,5,2,1
4,408,408,27,27,0,1,0
13,431,431,68,8,60,3,2
7,461,461,49,5,44,2,1
6,465,465,90,65,25,2,1
11,496,496,10,10,0,1,0

9,111,111,18,18,0,1,0
18,133,133,1,1,0,1,0
16,155,155,14,5,9,2,1
5,158,158,24,9,15,4,3
6,188,188,11,11,0,1,0
2,216,216,27,27,0,1,0
8,234,234,1,1,0,1,0
4,298,298,15,6,9,4,3
21,300,300,82,74,8,2,1
11,308,308,3,3,0,1,0
14,316,316,10,7,3,2,1
3,343,343,6,6,0,1,0
10,355,355,17,9,8,3,2
15,364,364,63,9,54,4,3
19,367,367,21,21,0,1,0
0,375,375,24,18,6,3,2
12,383,383,38,18,20,3,2
17,387,387,21,6,15,4,3
1,416,416,150,60,90,4,3
20,474,474,44,41,3,2,1
7,488,488,25,25,0,1,0
13,488,488,117,30,87,4,3

8,122,122,20,11,9,4,3
13,140,140,5,5,0,1,0
10,160,160,15,15,0,1,0
11,163,163,8,8,0,1,0
9,203,203,15,15,0,1,0
7,229,229,32,4,28,3,2
5,237,237,21,21,0,1,0
0,238,238,3,3,0,1,0
4,287,287,28,28,0,1,0
16,294,294,11,11,0,1,0
12,317,317,27,6,21,4,3
2,333,333,28,28,0,1,0
3,353,353,131,93,38,4,3
1,360,360,12,12,0,1,0
15,369,369,99,49,50,4,3
14,371,371,161,109,52,3,2
18,385,385,6,1,5,2,1
17,459,459,17,5,12,4,3
6,496,496,58,58,0,1,0

0,122,122,1,1,0,1,0
14,139,139,2,2,0,1,0
13,150,150,29,29,0,1,0
24,156,156,32,23,9,4,3
5,160,160,25,25,0,1,0
9,165,165,19,19,0,1,0
6,170,170,14,14,0,1,0
8,186,186,1,1,0,1,0
2,198,198,1,1,0,1,0
3,202,202,21,7,14,2,1
25,220,220,1,1,0,1,0
22,283,283,97,97,0,1,0
11,291,291,38,38,0,1,0
4,336,336,30,30,0,1,0
26,383,383,22,14,8,2,1
17,388,388,31,5,26,3,2
1,405,405,14,14,0,1,0
20,435,435,5,5,0,1,0
18,444,444,25,2,23,2,1
15,449,449,7,7,0,1,0
23,450,450,36,4,32,4,3
7,454,454,21,10,11,2,1
21,458,458,36,36,0,1,0
12,460,460,10,10,0,1,0
10,461,461,16,12,4,2,1
16,496,496,22,17,5,2,1
19,497,497,96,16,80,3,2

19,100,100,17,17,0,1,0
8,113,113,4,4,0,1,0
4,143,143,3,3,0,1,0
2,168,168,1,1,0,1,0
0,192,192,19,19,0,1,0
11,196,196,11,11,0,1,0
23,216,216,18,9,9,4,3
27,228,228,1,1,0,1,0
24,231,231,48,6,42,2,1
10,302,302,41,41,0,1,0
21,313,313,15,15,0,1,0
26,337,337,60,60,0,1,0
13,349,349,33,33,0,1,0
3,358,358,49,49,0,1,0
16,370,370,7,7,0,1,0
15,375,375,2,2,0,1,0
20,375,375,67,51,16,2,1
9,376,376,57,3,54,3,2
7,377,377,1,1,0,1,0
18,394,394,28,14,14,3,2
5,399,399,5,5,0,1,0
22,435,435,26,26,0,1,0
17,456,456,28,28,0,1,0
25,456,456,54,54,0,1,0
12,465,465,30,3,27,4,3
1,470,470,45,24,21,2,1
6,485,485,47,37,10,3,2
14,497,497,3,3,0,1,0

2,107,107,6,1,5,2,1
4,117,117,5,5,0,1,0
22,136,136,29,9,20,2,1
10,160,160,30,30,0,1,0
14,161,161,3,3,0,1,0
9,167,167,16,16,0,1,0
6,168,168,6,6,0,1,0
13,176,176,26,26,0,1,0
8,182,182,1,1,0,1,0
18,213,213,28,28,0,1,0
1,215,215,23,7,16,2,1
16,244,244,28,28,0,1,0
15,253,253,26,6,20,4,3
11,285,285,8,8,0,1,0
21,285,285,11,3,8,3,2
0,294,294,13,13,0,1,0
17,331,331,70,28,42,2,1
5,354,354,22,8,14,3,2
7,356,356,35,35,0,1,0
3,405,405,98,77,21,4,3
12,443,443,43,43,0,1,0
20,473,473,50,50,0,1,0
19,494,494,20,20,0,1,0

13,105,105,24,24,0,1,0
18,146,146,11,5,6,2,1
19,174,174,19,1,18,3,2
17,174,174,21,21,0,1,0
22,187,187,12,4,8,2,1
8,193,193,2,2,0,1,0
6,197,197,1,1,0,1,0
10,230,230,32,32,0,1,0
23,234,234,1,1,0,1,0
21,239,239,10,10,0,1,0
12,282,282,18,1,17,3,2
7,304,304,62,48,14,3,2
3,319,319,5,5,0,1,0
1,337,337,4,4,0,1,0
11,338,338,4,1,3,2,1
5,346,346,13,13,0,1,0
20,359,359,70,70,0,1,0
4,391,391,16,8,8,3,2
9,408,408,5,5,0,1,0
0,430,430,120,120,0,1,0
2,437,437,19,1,18,2,1
15,447,447,113,5,108,4,3
14,450,450,101,101,0,1,0
16,453,453,16,16,0,1,0

5,148,148,1,1,0,1,0
10,160,160,25,25,0,1,0
12,186,186,9,9,0,1,0
13,195,195,14,14,0,1,0
19,218,218,37,5,32,2,1
3,220,220,2,2,0,1,0
8,226,226,13,9,4,2,1
16,239,239,33,33,0,1,0
14,264,264,50,40,10,3,2
7,296,296,4,4,0,1,0
4,322,322,79,79,0,1,0
15,329,329,30,30,0,1,0
22,355,355,11,11,0,1,0
20,357,357,2,2,0,1,0
2,380,380,27,27,0,1,0
11,383,383,26,19,7,2,1
18,384,384,15,15,0,1,0
17,398,398,61,31,30,3,2
1,454,454,8,2,6,2,1
6,459,459,76,5,71,4,3
9,460,460,99,99,0,1,0
0,484,484,14,14,0,1,0
21,495,495,110,77,33,4,3

9,102,102,5,5,0,1,0
18,130,130,11,3,8,3,2
0,148,148,42,42,0,1,0
13,185,185,40,28,12,4,3
2,190,190,38,33,5,2,1
16,196,196,21,21,0,1,0
1,263,263,17,11,6,2,1
5,275,275,28,7,21,2,1
12,287,287,2,2,0,1,0
7,291,291,1,1,0,1,0
8,298,298,45,18,27,2,1
11,346,346,5,5,0,1,0
17,351,351,52,52,0,1,0
15,353,353,12,6,6,2,1
6,360,360,40,1,39,4,3
10,378,378,58,16,42,4,3
3,393,393,47,38,9,4,3
14,402,402,16,10,6,3,2
4,435,435,9,3,6,2,1
19,490,490,156,66,90,4,3

17,147,147,14,14,0,1,0
8,154,154,17,10,7,2,1
12,160,160,7,7,0,1,0
19,212,212,68,35,33,4,3
16,227,227,7,7,0,1,0
6,255,255,23,9,14,2,1
20,256,256,56,56,0,1,0
18,294,294,4,4,0,1,0
14,301,301,24,24,0,1,0
1,302,302,7,7,0,1,0
21,304,304,12,12,0,1,0
15,334,334,90,90,0,1,0
9,358,358,59,59,0,1,0
11,394,394,22,22,0,1,0
5,401,401,30,3,27,4,3
13,409,409,3,3,0,1,0
0,418,418,4,4,0,1,0
10,421,421,124,44,80,3,2
4,452,452,35,15,20,2,1
2,469,469,36,30,6,2,1
7,485,485,43,43,0,1,0
3,500,500,17,10,7,2,1

7,165,165,3,3,0,1,0
11,190,190,50,16,34,2,1
9,218,218,18,18,0,1,0
8,220,220,3,3,0,1,0
0,257,257,42,42,0,1,0
5,310,310,54,3,51,4,3
10,340,340,26,26,0,1,0
15,363,363,98,77,21,4,3
14,370,370,19,19,0,1,0
2,373,373,164,20,144,4,3
4,386,386,72,41,31,2,1
13,397,397,56,36,20,3,2
6,407,407,73,36,37,2,1
1,455,455,51,51,0,1,0
12,466,466,9,9,0,1,0
3,479,479,12,1,11,2,1

11,130,130,4,1,3,2,1
21,137,137,25,25,0,1,0
15,147,147,5,2,3,2,1
12,153,153,28,28,0,1,0
7,157,157,2,2,0,1,0
9,195,195,12,12,0,1,0
6,205,205,12,12,0,1,0
2,241,241,61,61,0,1,0
1,266,266,13,7,6,3,2
16,273,273,67,51,16,3,2
5,284,284,69,26,43,3,2
14,304,304,22,22,0,1,0
0,319,319,1,1,0,1,0
17,335,335,26,7,19,3,2
10,365,365,33,33,0,1,0
3,378,378,5,5,0,1,0
20,385,385,16,1,15,2,1
19,397,397,3,3,0,1,0
13,404,404,82,6,76,3,2
22,450,450,8,8,0,1,0
4,468,468,16,10,6,3,2
8,469,469,33,23,10,2,1
18,498,498,116,77,39,4,3

0,141,141,57,31,26,2,1
5,170,170,3,3,0,1,0
10,229,229,8,3,5,2,1
13,229,229,1,1,0,1,0
17,234,234,32,32,0,1,0
3,246,246,5,1,4,2,1
7,249,249,18,1,17,4,3
22,297,297,102,84,18,4,3
8,298,298,60,10,50,3,2
14,326,326,25,10,15,2,1
21,337,337,26,8,18,2,1
16,356,356,33,33,0,1,0
6,361,361,13,4,9,2,1
18,369,369,13,1,12,4,3
1,394,394,6,6,0,1,0
15,400,400,62,47,15,4,3
4,403,403,43,43,0,1,0
20,404,404,28,28,0,1,0
11,407,407,14,14,0,1,0
9,416,416,18,18,0,1,0
19,420,420,53,53,0,1,0
12,467,467,38,30,8,3,2
2,493,493,16,16,0,1,0

8,113,113,9,9,0,1,0
0,117,117,45,32,13,2,1
11,136,136,21,21,0,1,0
18,144,144,3,3,0,1,0
13,174,174,90,45,45,4,3
17,176,176,8,1,7,2,1
9,187,187,8,8,0,1,0
10,197,197,3,3,0,1,0
5,216,216,68,8,60,4,3
7,233,233,10,10,0,1,0
14,301,301,1,1,0,1,0
15,328,328,1,1,0,1,0
16,344,344,98,11,87,4,3
1,408,408,30,18,12,3,2
4,451,451,25,1,24,3,2
2,458,458,12,12,0,1,0
12,477,477,20,20,0,1,0
6,483,483,52,27,25,2,1
3,492,492,8,8,0,1,0

10,112,112,10,10,0,1,0
1,119,119,20,2,18,2,1
14,159,159,13,13,0,1,0
7,167,167,40,16,24,2,1
8,169,169,4,4,0,1,0
0,190,190,20,20,0,1,0
12,215,215,24,1,23,2,1
15,220,220,7,1,6,2,1
3,297,297,26,26,0,1,0
11,299,299,50,42,8,3,2
5,330,330,48,18,30,2,1
4,336,336,101,96,5,2,1
2,346,346,86,86,0,1,0
6,356,356,16,6,10,2,1
13,487,487,1,1,0,1,0
16,488,488,136,31,105,4,3
9,493,493,45,9,36,4,3

12,112,112,1,1,0,1,0
4,140,140,15,3,12,2,1
28,145,145,25,25,0,1,0
3,145,145,6,3,3,2,1
19,153,153,17,7,10,3,2
0,181,181,3,3,0,1,0
21,201,201,8,2,6,2,1
23,238,238,15,3,12,3,2
25,244,244,8,8,0,1,0
1,274,274,1,1,0,1,0
20,293,293,154,108,46,3,2
13,346,346,59,15,44,2,1
16,360,360,36,3,33,4,3
15,367,367,2,2,0,1,0
9,367,367,16,16,0,1,0
10,373,373,31,31,0,1,0
11,375,375,26,26,0,1,0
6,383,383,3,3,0,1,0
27,400,400,1,1,0,1,0
24,416,416,9,9,0,1,0
18,426,426,34,30,4,2,1
14,430,430,13,13,0,1,0
26,438,438,60,60,0,1,0
7,454,454,2,2,0,1,0
8,454,454,49,49,0,1,0
17,469,469,41,7,34,3,2
22,470,470,9,9,0,1,0
2,496,496,43,43,0,1,0
5,498,498,24,24,0,1,0

0,111,111,13,13,0,1,0
17,128,128,4,4,0,1,0
6,143,143,5,5,0,1,0
18,155,155,7,7,0,1,0
2,175,175,27,2,25,4,3
4,201,201,7,7,0,1,0
15,202,202,71,71,0,1,0
13,205,205,25,25,0,1,0
7,222,222,8,8,0,1,0
14,254,254,16,13,3,2,1
19,263,263,61,61,0,1,0
8,267,267,5,5,0,1,0
10,277,277,8,8,0,1,0
3,282,282,35,35,0,1,0
5,287,287,21,6,15,4,3
1,302,302,116,50,66,4,3
11,321,321,26,23,3,2,1
20,326,326,45,21,24,2,1
9,447,447,43,43,0,1,0
16,463,463,16,8,8,2,1
12,499,499,12,6,6,2,1

4,101,101,3,3,0,1,0
5,130,130,1,1,0,1,0
1,133,133,2,2,0,1,0
7,168,168,4,1,3,2,1
14,173,173,36,26,10,2,1
2,182,182,16,4,12,2,1
12,212,212,43,43,0,1,0
10,215,215,11,11,0,1,0
6,243,243,26,26,0,1,0
18,250,250,76,32,44,2,1
17,312,312,1,1,0,1,0
11,342,342,2,2,0,1,0
13,374,374,12,12,0,1,0
15,382,382,33,19,14,2,1
3,399,399,30,30,0,1,0
20,401,401,21,21,0,1,0
0,404,404,52,52,0,1,0
16,446,446,2,2,0,1,0
9,462,462,235,207,28,3,2
21,466,466,59,44,15,4,3
19,477,477,48,30,18,3,2
8,483,483,30,18,12,4,3

4,111,111,2,2,0,1,0
3,155,155,9,1,8,3,2
19,185,185,32,32,0,1,0
2,198,198,15,15,0,1,0
16,217,217,27,27,0,1,0
10,227,227,99,93,6,3,2
15,250,250,5,5,0,1,0
6,261,261,28,22,6,2,1
14,262,262,17,17,0,1,0
7,286,286,3,3,0,1,0
9,323,323,56,13,43,2,1
0,326,326,22,2,20,3,2
5,359,359,23,23,0,1,0
17,366,366,32,32,0,1,0
13,387,387,15,15,0,1,0
1,395,395,53,53,0,1,0
18,420,420,35,25,10,2,1
8,438,438,172,172,0,1,0
12,463,463,36,9,27,2,1
11,475,475,8,5,3,2,1

7,121,121,4,4,0,1,0
4,128,128,3,3,0,1,0
9,135,135,23,14,9,4,3
13,153,153,11,1,10,3,2
15,162,162,13,13,0,1,0
16,199,199,39,20,19,3,2
8,244,244,62,62,0,1,0
12,287,287,10,10,0,1,0
6,303,303,84,70,14,2,1
11,340,340,62,54,8,2,1
5,342,342,44,32,12,3,2
14,355,355,9,9,0,1,0
3,356,356,12,3,9,4,3
17,395,395,13,13,0,1,0
1,437,437,30,6,24,3,2
2,441,441,167,117,50,2,1
0,471,471,76,76,0,1,0
10,497,497,39,12,27,4,3

13,104,104,17,11,6,2,1
0,114,114,13,13,0,1,0
9,140,140,15,15,0,1,0
21,160,160,8,8,0,1,0
11,179,179,15,15,0,1,0
10,194,194,9,9,0,1,0
23,202,202,10,3,7,3,2
12,219,219,22,9,13,2,1
22,252,252,8,8,0,1,0
17,263,263,39,39,0,1,0
15,284,284,23,9,14,2,1
6,312,312,6,2,4,2,1
18,313,313,2,2,0,1,0
2,314,314,40,40,0,1,0
1,318,318,3,3,0,1,0
14,326,326,140,140,0,1,0
4,326,326,32,23,9,2,1
8,356,356,24,24,0,1,0
3,362,362,30,30,0,1,0
7,369,369,14,14,0,1,0
5,404,404,19,9,10,3,2
19,436,436,26,26,0,1,0
20,451,451,94,49,45,2,1
16,467,467,27,5,22,3,2

12,147,147,9,1,8,2,1
6,183,183,1,1,0,1,0
5,201,201,14,14,0,1,0
1,204,204,17,5,12,4,3
11,205,205,74,62,12,4,3
10,230,230,30,30,0,1,0
13,233,233,8,3,5,2,1
15,242,242,24,1,23,2,1
16,253,253,25,25,0,1,0
3,254,254,66,66,0,1,0
8,260,260,56,56,0,1,0
2,308,308,18,3,15,2,1
0,309,309,121,57,64,4,3
4,333,333,1,1,0,1,0
7,354,354,81,50,31,2,1
9,398,398,22,14,8,3,2
14,409,409,16,16,0,1,0
17,466,466,10,6,4,2,1

13,113,113,1,1,0,1,0
16,116,116,3,3,0,1,0
12,123,123,17,17,0,1,0
14,130,130,34,18,16,2,1
17,204,204,40,26,14,3,2
4,209,209,2,2,0,1,0
1,239,239,19,19,0,1,0
10,254,254,18,18,0,1,0
15,294,294,1,1,0,1,0
2,312,312,24,12,12,2,1
20,317,317,1,1,0,1,0
19,320,320,23,23,0,1,0
6,333,333,24,2,22,3,2
7,337,337,39,23,16,2,1
0,360,360,13,4,9,4,3
3,368,368,109,28,81,4,3
5,375,375,15,3,12,4,3
9,391,391,108,108,0,1,0
8,406,406,12,12,0,1,0
11,416,416,129,103,26,3,2
18,465,465,48,14,34,3,2

6,146,146,57,17,40,3,2
10,189,189,6,3,3,2,1
8,192,192,24,12,12,3,2
11,198,198,50,50,0,1,0
5,208,208,2,2,0,1,0
13,214,214,7,7,0,1,0
2,221,221,58,24,34,2,1
7,226,226,26,26,0,1,0
9,227,227,48,48,0,1,0
12,277,277,7,7,0,1,0
4,282,282,28,20,8,2,1
16,295,295,45,13,32,2,1
0,339,339,96,43,53,4,3
3,373,373,15,15,0,1,0
15,396,396,25,10,15,4,3
14,479,479,53,53,0,1,0
1,482,482,10,10,0,1,0

14,108,108,4,4,0,1,0
1,113,113,19,11,8,2,1
16,113,113,53,53,0,1,0
13,126,126,7,7,0,1,0
11,140,140,7,4,3,2,1
2,200,200,15,7,8,2,1
18,209,209,5,5,0,1,0
5,266,266,18,18,0,1,0
6,297,297,37,9,28,2,1
4,316,316,19,19,0,1,0
8,324,324,2,2,0,1,0
7,336,336,13,1,12,3,2
15,344,344,15,15,0,1,0
12,346,346,45,45,0,1,0
0,373,373,101,65,36,3,2
19,411,411,90,64,26,3,2
10,428,428,21,21,0,1,0
17,446,446,19,9,10,3,2
3,446,446,8,8,0,1,0
9,456,456,124,85,39,4,3

14,110,110,15,15,0,1,0
6,124,124,1,1,0,1,0
3,141,141,24,13,11,2,1
17,184,184,12,12,0,1,0
4,236,236,4,4,0,1,0
1,273,273,18,18,0,1,0
13,277,277,6,3,3,2,1
9,280,280,49,49,0,1,0
16,288,288,32,4,28,4,3
10,297,297,7,1,6,2,1
8,331,331,62,62,0,1,0
15,342,342,97,67,30,3,2
0,343,343,3,3,0,1,0
7,344,344,113,29,84,3,2
11,349,349,12,12,0,1,0
5,358,358,106,1,105,4,3
12,457,457,35,5,30,2,1
2,500,500,103,103,0,1,0

16,101,101,14,2,12,2,1
3,105,105,14,2,12,3,2
6,116,116,1,1,0,1,0
5,119,119,2,2,0,1,0
8,121,121,13,1,12,4,3
2,141,141,20,20,0,1,0
22,154,154,1,1,0,1,0
12,168,168,18,18,0,1,0
14,189,189,59,59,0,1,0
13,215,215,48,48,0,1,0
15,217,217,60,60,0,1,0
4,230,230,16,16,0,1,0
0,250,250,17,2,15,4,3
21,298,298,4,4,0,1,0
11,323,323,61,24,37,2,1
17,330,330,14,14,0,1,0
19,344,344,4,4,0,1,0
7,385,385,14,5,9,2,1
1,411,411,29,29,0,1,0
18,470,470,21,21,0,1,0
9,481,481,22,22,0,1,0
10,481,481,53,20,33,2,1
20,484,484,24,24,0,1,0

17,106,106,1,1,0,1,0
11,114,114,8,8,0,1,0
10,118,118,2,2,0,1,0
0,137,137,16,16,0,1,0
4,147,147,9,9,0,1,0
2,153,153,23,23,0,1,0
13,157,157,45,1,44,2,1
15,168,168,36,36,0,1,0
16,180,180,30,30,0,1,0
8,230,230,14,14,0,1,0
1,238,238,11,3,8,2,1
14,280,280,27,27,0,1,0
5,303,303,95,3,92,3,2
7,341,341,23,5,18,3,2
6,380,380,12,12,0,1,0
9,400,400,60,2,58,4,3
18,406,406,12,12,0,1,0
3,439,439,111,66,45,4,3
12,450,450,37,19,18,2,1

8,111,111,18,2,16,2,1
1,166,166,26,26,0,1,0
7,167,167,3,3,0,1,0
0,178,178,73,43,30,4,3
16,207,207,1,1,0,1,0
2,284,284,19,19,0,1,0
11,304,304,15,15,0,1,0
18,317,317,162,15,147,4,3
4,341,341,6,6,0,1,0
13,361,361,20,20,0,1,0
14,377,377,55,55,0,1,0
17,387,387,51,51,0,1,0
12,389,389,25,17,8,3,2
5,398,398,6,6,0,1,0
6,445,445,50,50,0,1,0
9,450,450,22,14,8,3,2
10,460,460,23,1,22,2,1
15,470,470,24,24,0,1,0
3,490,490,72,22,50,3,2

17,109,109,3,3,0,1,0
13,142,142,31,9,22,4,3
10,199,199,37,37,0,1,0
0,201,201,2,2,0,1,0
20,213,213,78,6,72,3,2
16,268,268,36,15,21,2,1
14,271,271,24,24,0,1,0
6,316,316,46,46,0,1,0
19,331,331,18,18,0,1,0
2,351,351,11,11,0,1,0
12,357,357,6,1,5,2,1
8,360,360,8,8,0,1,0
15,383,383,6,3,3,2,1
9,394,394,25,25,0,1,0
3,399,399,47,47,0,1,0
4,421,421,72,46,26,2,1
1,438,438,10,2,8,3,2
22,446,446,29,29,0,1,0
21,454,454,22,13,9,4,3
11,480,480,31,18,13,2,1
18,483,483,47,3,44,2,1
7,488,488,117,117,0,1,0
5,490,490,5,5,0,1,0

18,101,101,38,2,36,4,3
8,145,145,3,3,0,1,0
4,160,160,15,8,7,2,1
1,172,172,4,4,0,1,0
14,208,208,15,15,0,1,0
16,212,212,23,23,0,1,0
15,228,228,20,20,0,1,0
17,234,234,13,13,0,1,0
12,280,280,20,14,6,3,2
11,286,286,54,33,21,4,3
13,348,348,17,6,11,2,1
10,367,367,28,4,24,4,3
2,375,375,62,56,6,2,1
9,379,379,18,18,0,1,0
7,393,393,80,80,0,1,0
6,396,396,105,105,0,1,0
0,420,420,53,6,47,2,1
3,480,480,38,32,6,3,2
5,483,483,60,60,0,1,0

6,108,108,7,7,0,1,0
4,112,112,11,6,5,2,1
18,134,134,6,3,3,2,1
10,149,149,1,1,0,1,0
26,173,173,7,3,4,2,1
8,177,177,3,3,0,1,0
23,195,195,42,3,39,4,3
19,213,213,26,26,0,1,0
9,235,235,7,7,0,1,0
0,256,256,28,28,0,1,0
5,284,284,12,12,0,1,0
25,293,293,14,14,0,1,0
20,301,301,67,67,0,1,0
15,311,311,12,12,0,1,0
22,315,315,6,6,0,1,0
17,319,319,13,13,0,1,0
14,324,324,30,30,0,1,0
27,345,345,18,12,6,2,1
21,374,374,11,11,0,1,0
11,376,376,13,13,0,1,0
24,381,381,92,92,0,1,0
12,385,385,28,2,26,3,2
7,391,391,23,15,8,3,2
16,396,396,57,57,0,1,0
2,413,413,29,29,0,1,0
3,424,424,28,28,0,1,0
1,437,437,9,9,0,1,0
28,452,452,57,3,54,3,2
13,487,487,27,17,10,3,2

11,126,126,17,17,0,1,0
5,140,140,2,2,0,1,0
10,144,144,12,12,0,1,0
3,155,155,3,3,0,1,0
1,159,159,5,5,0,1,0
15,184,184,4,4,0,1,0
20,207,207,10,10,0,1,0
4,286,286,45,45,0,1,0
9,305,305,53,23,30,2,1
12,340,340,157,94,63,4,3
14,343,343,13,1,12,2,1
19,357,357,58,1,57,4,3
8,363,363,14,14,0,1,0
16,386,386,23,23,0,1,0
13,399,399,18,18,0,1,0
6,407,407,87,87,0,1,0
17,407,407,57,57,0,1,0
7,408,408,65,65,0,1,0
2,467,467,89,57,32,2,1
0,477,477,10,10,0,1,0
18,486,486,3,3,0,1,0

5,156,156,10,10,0,1,0
7,167,167,1,1,0,1,0
3,171,171,24,6,18,3,2
14,249,249,29,19,10,3,2
2,251,251,30,30,0,1,0
10,258,258,33,33,0,1,0
13,280,280,69,41,28,3,2
6,292,292,42,3,39,4,3
18,311,311,6,6,0,1,0
11,334,334,4,4,0,1,0
17,340,340,2,2,0,1,0
15,353,353,86,86,0,1,0
0,384,384,47,15,32,2,1
16,386,386,44,44,0,1,0
4,415,415,1,1,0,1,0
8,431,431,23,15,8,3,2
9,481,481,76,76,0,1,0
1,484,484,217,154,63,4,3
12,492,492,37,15,22,4,3

17,112,112,2,2,0,1,0
12,120,120,2,2,0,1,0
8,144,144,1,1,0,1,0
18,165,165,4,4,0,1,0
0,168,168,61,17,44,3,2
16,194,194,6,2,4,2,1
6,273,273,47,47,0,1,0
2,292,292,3,3,0,1,0
4,303,303,60,29,31,3,2
11,309,309,96,96,0,1,0
13,309,309,89,22,67,4,3
5,341,341,15,15,0,1,0
9,369,369,8,2,6,3,2
7,390,390,32,32,0,1,0
1,391,391,10,3,7,2,1
3,393,393,78,51,27,2,1
14,406,406,89,59,30,4,3
15,409,409,60,60,0,1,0
10,471,471,19,19,0,1,0

13,120,120,4,1,3,2,1
8,129,129,35,3,32,4,3
17,168,168,1,1,0,1,0
2,206,206,14,14,0,1,0
0,214,214,27,27,0,1,0
15,237,237,36,36,0,1,0
12,270,270,30,20,10,2,1
9,285,285,2,2,0,1,0
10,293,293,15,1,14,3,2
14,302,302,9,4,5,2,1
18,340,340,111,111,0,1,0
3,369,369,1,1,0,1,0
5,391,391,56,34,22,3,2
1,401,401,13,13,0,1,0
19,416,416,6,6,0,1,0
6,417,417,7,1,6,3,2
7,419,419,83,83,0,1,0
16,428,428,23,10,13,2,1
4,484,484,114,110,4,2,1
11,484,484,164,164,0,1,0

8,100,100,25,25,0,1,0
16,117,117,16,16,0,1,0
12,119,119,6,2,4,2,1
7,162,162,4,4,0,1,0
15,187,187,50,3,47,2,1
19,212,212,17,2,15,2,1
5,250,250,52,20,32,3,2
4,275,275,1,1,0,1,0
10,294,294,5,5,0,1,0
3,307,307,43,35,8,3,2
18,331,331,2,2,0,1,0
17,362,362,22,2,20,4,3
0,370,370,25,22,3,2,1
6,375,375,2,2,0,1,0
1,385,385,1,1,0,1,0
2,397,397,120,120,0,1,0
14,421,421,2,2,0,1,0
13,430,430,20,20,0,1,0
20,439,439,157,121,36,4,3
11,440,440,30,30,0,1,0
9,449,449,5,5,0,1,0
21,467,467,50,50,0,1,0

0,117,117,1,1,0,1,0
14,130,130,5,5,0,1,0
4,142,142,3,3,0,1,0
20,150,150,45,45,0,1,0
24,151,151,19,10,9,2,1
10,163,163,21,1,20,3,2
21,165,165,6,6,0,1,0
1,176,176,2,2,0,1,0
8,194,194,1,1,0,1,0
9,211,211,1,1,0,1,0
17,224,224,28,28,0,1,0
16,244,244,7,7,0,1,0
19,247,247,43,15,28,3,2
15,251,251,5,5,0,1,0
23,260,260,27,11,16,4,3
2,277,277,9,5,4,2,1
27,280,280,2,2,0,1,0
12,297,297,15,1,14,2,1
25,313,313,6,3,3,2,1
7,318,318,27,3,24,3,2
5,325,325,21,21,0,1,0
26,336,336,70,19,51,4,3
13,340,340,106,106,0,1,0
18,354,354,15,15,0,1,0
3,357,357,12,3,9,2,1
11,474,474,17,13,4,2,1
22,484,484,52,3,49,2,1
6,486,486,47,47,0,1,0

0,102,102,29,29,0,1,0
22,105,105,8,8,0,1,0
6,115,115,8,8,0,1,0
12,116,116,1,1,0,1,0
2,126,126,1,1,0,1,0
18,155,155,16,16,0,1,0
9,205,205,1,1,0,1,0
15,210,210,4,4,0,1,0
7,211,211,8,8,0,1,0
21,295,295,24,12,12,3,2
4,312,312,7,7,0,1,0
13,332,332,34,16,18,2,1
10,348,348,49,49,0,1,0
3,388,388,26,1,25,2,1
19,407,407,25,5,20,3,2
11,412,412,16,7,9,2,1
14,412,412,23,5,18,2,1
8,419,419,45,45,0,1,0
17,451,451,218,119,99,4,3
20,479,479,9,3,6,2,1
16,480,480,40,10,30,2,1
5,494,494,15,15,0,1,0
1,495,495,88,4,84,3,2
23,499,499,70,70,0,1,0

17,102,102,1,1,0,1,0
13,121,121,27,3,24,4,3
9,192,192,1,1,0,1,0
18,231,231,1,1,0,1,0
14,254,254,19,19,0,1,0
5,263,263,16,12,4,2,1
16,274,274,29,29,0,1,0
2,289,289,85,27,58,3,2
19,301,301,14,14,0,1,0
15,308,308,21,2,19,2,1
11,308,308,19,6,13,3,2
4,321,321,25,25,0,1,0
10,404,404,210,210,0,1,0
8,418,418,12,12,0,1,0
7,435,435,42,42,0,1,0
0,435,435,23,1,22,2,1
6,437,437,158,123,35,2,1
3,450,450,51,21,30,2,1
12,478,478,3,3,0,1,0
1,494,494,5,5,0,1,0

8,116,116,1,1,0,1,0
19,159,159,5,1,4,2,1
14,171,171,1,1,0,1,0
7,184,184,12,12,0,1,0
4,191,191,5,5,0,1,0
6,249,249,25,17,8,3,2
23,258,258,49,17,32,3,2
3,264,264,26,18,8,2,1
21,265,265,1,1,0,1,0
15,275,275,32,32,0,1,0
12,291,291,84,8,76,3,2
17,291,291,56,38,18,4,3
22,311,311,28,28,0,1,0
20,324,324,105,9,96,4,3
13,325,325,5,2,3,2,1
10,339,339,15,3,12,2,1
9,340,340,10,10,0,1,0
11,349,349,37,37,0,1,0
0,442,442,40,40,0,1,0
18,463,463,39,39,0,1,0
1,472,472,51,38,13,2,1
5,477,477,36,36,0,1,0
2,483,483,20,4,16,2,1
16,490,490,33,33,0,1,0
24,494,494,10,6,4,2,1

7,108,108,5,5,0,1,0
19,170,170,6,1,5,2,1
6,196,196,80,29,51,4,3
4,209,209,1,1,0,1,0
14,227,227,14,14,0,1,0
11,245,245,26,13,13,2,1
5,304,304,19,19,0,1,0
17,318,318,13,13,0,1,0
10,319,319,34,34,0,1,0
8,322,322,2,2,0,1,0
3,341,341,24,1,23,2,1
9,344,344,1,1,0,1,0
12,350,350,17,17,0,1,0
18,358,358,33,33,0,1,0
20,360,360,16,16,0,1,0
1,365,365,35,35,0,1,0
21,385,385,172,145,27,4,3
23,400,400,40,3,37,2,1
2,418,418,38,30,8,3,2
15,443,443,63,6,57,4,3
0,470,470,7,7,0,1,0
13,477,477,18,10,8,3,2
16,482,482,74,74,0,1,0
22,500,500,1,1,0,1,0

16,129,129,7,4,3,2,1
10,137,137,1,1,0,1,0
22,160,160,8,8,0,1,0
13,188,188,39,39,0,1,0
2,198,198,45,45,0,1,0
17,205,205,71,26,45,2,1
18,217,217,2,2,0,1,0
6,234,234,1,1,0,1,0
11,289,289,13,13,0,1,0
9,314,314,27,12,15,2,1
23,315,315,105,63,42,2,1
25,348,348,27,8,19,2,1
1,353,353,1,1,0,1,0
5,354,354,13,13,0,1,0
4,359,359,5,5,0,1,0
3,360,360,52,52,0,1,0
7,363,363,19,4,15,4,3
12,375,375,13,13,0,1,0
24,383,383,18,18,0,1,0
14,413,413,1,1,0,1,0
19,435,435,50,35,15,4,3
8,442,442,33,33,0,1,0
15,445,445,58,43,15,4,3
0,469,469,15,3,12,4,3
20,478,478,26,26,0,1,0
21,497,497,17,1,16,2,1

18,116,116,14,14,0,1,0
1,190,190,17,11,6,3,2
3,213,213,8,5,3,2,1
4,238,238,76,4,72,4,3
15,242,242,20,8,12,2,1
9,251,251,41,3,38,3,2
13,269,269,27,27,0,1,0
17,275,275,33,33,0,1,0
16,345,345,28,28,0,1,0
8,364,364,43,43,0,1,0
10,367,367,9,9,0,1,0
6,379,379,1,1,0,1,0
11,407,407,48,7,41,2,1
14,417,417,19,10,9,2,1
7,419,419,7,7,0,1,0
0,428,428,54,15,39,4,3
19,434,434,159,128,31,2,1
2,437,437,62,18,44,2,1
12,476,476,25,25,0,1,0
5,480,480,41,41,0,1,0

6,104,104,19,3,16,2,1
7,108,108,3,3,0,1,0
8,191,191,18,18,0,1,0
4,206,206,43,43,0,1,0
16,207,207,28,16,12,3,2
1,222,222,35,35,0,1,0
9,300,300,3,3,0,1,0
11,309,309,44,7,37,2,1
5,314,314,12,3,9,2,1
17,342,342,71,13,58,3,2
15,380,380,24,6,18,4,3
2,396,396,22,13,9,4,3
3,404,404,87,20,67,4,3
14,436,436,11,11,0,1,0
10,443,443,23,23,0,1,0
12,456,456,94,20,74,4,3
0,461,461,102,6,96,4,3
13,463,463,83,43,40,4,3

5,103,103,2,2,0,1,0
19,109,109,1,1,0,1,0
0,114,114,3,3,0,1,0
23,126,126,20,1,19,4,3
2,174,174,42,42,0,1,0
1,195,195,3,3,0,1,0
21,218,218,48,18,30,4,3
4,237,237,38,38,0,1,0
11,238,238,10,10,0,1,0
13,246,246,17,17,0,1,0
22,268,268,4,4,0,1,0
8,297,297,38,38,0,1,0
10,305,305,1,1,0,1,0
20,306,306,13,2,11,2,1
18,384,384,74,45,29,3,2
12,395,395,3,3,0,1,0
7,408,408,89,51,38,2,1
9,417,417,11,1,10,3,2
15,432,432,19,19,0,1,0
16,435,435,63,63,0,1,0
17,440,440,60,22,38,3,2
14,463,463,74,74,0,1,0
6,467,467,32,32,0,1,0
3,496,496,38,26,12,4,3

1,160,160,42,42,0,1,0
5,161,161,1,1,0,1,0
0,172,172,1,1,0,1,0
8,172,172,36,36,0,1,0
6,173,173,8,1,7,2,1
7,193,193,16,9,7,2,1
4,199,199,31,31,0,1,0
20,206,206,8,4,4,2,1
2,211,211,29,29,0,1,0
19,218,218,22,7,15,2,1
12,234,234,14,11,3,2,1
17,239,239,8,5,3,2,1
21,243,243,54,24,30,4,3
15,281,281,57,57,0,1,0
3,291,291,7,7,0,1,0
18,315,315,76,4,72,4,3
14,333,333,45,33,12,2,1
16,409,409,18,18,0,1,0
13,419,419,18,6,12,4,3
9,432,432,22,22,0,1,0
11,446,446,36,33,3,2,1
10,474,474,19,2,17,4,3

15,101,101,10,10,0,1,0
6,111,111,12,12,0,1,0
13,117,117,7,7,0,1,0
8,126,126,12,3,9,4,3
14,145,145,19,6,13,4,3
21,161,161,3,3,0,1,0
7,194,194,16,4,12,4,3
10,198,198,15,15,0,1,0
9,204,204,11,5,6,3,2
1,242,242,69,62,7,2,1
4,252,252,17,7,10,2,1
19,276,276,3,3,0,1,0
11,316,316,3,3,0,1,0
22,336,336,34,34,0,1,0
5,350,350,11,11,0,1,0
3,362,362,53,23,30,4,3
16,365,365,52,2,50,2,1
18,397,397,38,38,0,1,0
2,413,413,30,30,0,1,0
12,440,440,6,6,0,1,0
17,453,453,142,142,0,1,0
0,476,476,28,7,21,4,3
20,495,495,77,54,23,2,1

14,137,137,2,2,0,1,0
17,150,150,26,26,0,1,0
10,223,223,2,2,0,1,0
8,238,238,35,35,0,1,0
11,268,268,44,20,24,2,1
9,279,279,3,3,0,1,0
2,303,303,71,43,28,2,1
6,322,322,104,35,69,4,3
12,330,330,16,16,0,1,0
5,374,374,32,32,0,1,0
13,381,381,161,95,66,4,3
0,401,401,1,1,0,1,0
1,411,411,26,8,18,2,1
18,412,412,28,16,12,4,3
3,417,417,11,11,0,1,0
16,433,433,55,55,0,1,0
4,443,443,55,27,28,2,1
15,465,465,38,38,0,1,0
7,483,483,47,34,13,2,1

7,107,107,2,2,0,1,0
0,135,135,5,5,0,1,0
22,141,141,54,54,0,1,0
5,152,152,13,13,0,1,0
20,166,166,9,9,0,1,0
14,171,171,19,1,18,4,3
21,230,230,11,5,6,2,1
17,231,231,29,8,21,4,3
1,235,235,4,1,3,2,1
6,239,239,26,26,0,1,0
11,257,257,12,7,5,2,1
8,273,273,37,6,31,2,1
2,299,299,21,21,0,1,0
10,307,307,117,89,28,2,1
13,322,322,7,7,0,1,0
15,333,333,90,42,48,2,1
9,370,370,20,11,9,2,1
12,374,374,28,28,0,1,0
3,390,390,8,2,6,3,2
19,435,435,20,10,10,2,1
18,456,456,8,5,3,2,1
4,457,457,24,12,12,2,1
16,486,486,21,21,0,1,0

3,106,106,10,6,4,2,1
18,106,106,24,15,9,4,3
8,119,119,20,20,0,1,0
13,122,122,4,1,3,2,1
11,128,128,1,1,0,1,0
16,128,128,10,7,3,2,1
21,131,131,44,9,35,4,3
10,134,134,7,7,0,1,0
5,174,174,7,1,6,3,2
17,194,194,14,14,0,1,0
12,213,213,3,3,0,1,0
6,251,251,17,2,15,4,3
4,256,256,2,2,0,1,0
0,276,276,56,56,0,1,0
15,291,291,2,2,0,1,0
9,302,302,37,37,0,1,0
1,314,314,19,19,0,1,0
14,319,319,16,16,0,1,0
23,347,347,6,6,0,1,0
22,351,351,21,15,6,2,1
2,362,362,68,17,51,4,3
19,414,414,94,19,75,4,3
20,451,451,24,3,21,2,1
7,494,494,21,12,9,4,3

1,127,127,32,24,8,2,1
14,157,157,29,3,26,2,1
3,180,180,1,1,0,1,0
7,190,190,33,17,16,2,1
9,190,190,6,6,0,1,0
8,200,200,8,8,0,1,0
17,208,208,9,9,0,1,0
6,210,210,14,8,6,2,1
4,211,211,39,39,0,1,0
18,224,224,13,1,12,2,1
13,230,230,5,5,0,1,0
16,257,257,7,3,4,2,1
15,273,273,53,53,0,1,0
2,273,273,7,7,0,1,0
0,279,279,25,25,0,1,0
12,303,303,59,59,0,1,0
11,323,323,35,14,21,4,3
5,401,401,93,55,38,2,1
19,446,446,121,78,43,2,1
10,465,465,8,8,0,1,0

2,165,165,5,2,3,2,1
7,168,168,67,44,23,2,1
1,222,222,11,7,4,2,1
11,272,272,150,96,54,4,3
12,277,277,14,3,11,2,1
3,324,324,24,24,0,1,0
5,338,338,17,17,0,1,0
6,347,347,5,5,0,1,0
13,370,370,11,11,0,1,0
18,399,399,41,41,0,1,0
4,402,402,48,48,0,1,0
17,402,402,64,22,42,2,1
15,402,402,1,1,0,1,0
0,405,405,119,2,117,4,3
9,415,415,8,4,4,2,1
14,426,426,7,7,0,1,0
8,447,447,23,6,17,2,1
16,480,480,42,42,0,1,0
19,500,500,25,25,0,1,0
10,500,500,31,31,0,1,0

13,137,137,4,1,3,2,1
4,143,143,2,2,0,1,0
10,148,148,7,7,0,1,0
6,167,167,52,52,0,1,0
11,212,212,7,7,0,1,0
2,234,234,8,8,0,1,0
8,242,242,2,2,0,1,0
5,244,244,3,3,0,1,0
7,264,264,42,18,24,3,2
1,267,267,147,9,138,4,3
9,298,298,113,17,96,3,2
14,351,351,35,35,0,1,0
17,359,359,71,23,48,3,2
15,391,391,2,2,0,1,0
12,400,400,44,44,0,1,0
0,404,404,1,1,0,1,0
16,414,414,84,63,21,4,3
3,459,459,8,8,0,1,0

13,137,137,1,1,0,1,0
12,150,150,4,4,0,1,0
10,152,152,33,15,18,4,3
6,166,166,8,4,4,2,1
18,179,179,1,1,0,1,0
20,183,183,50,50,0,1,0
19,201,201,17,17,0,1,0
23,202,202,27,27,0,1,0
11,216,216,12,9,3,2,1
22,217,217,18,18,0,1,0
14,224,224,8,8,0,1,0
3,235,235,19,19,0,1,0
2,269,269,6,3,3,2,1
16,281,281,25,25,0,1,0
8,299,299,28,28,0,1,0
4,354,354,18,18,0,1,0
24,358,358,10,10,0,1,0
21,360,360,25,25,0,1,0
5,365,365,44,44,0,1,0
7,392,392,11,11,0,1,0
1,413,413,104,47,57,4,3
15,414,414,55,20,35,4,3
17,476,476,101,101,0,1,0
9,477,477,29,25,4,2,1
0,484,484,2,2,0,1,0

14,111,111,10,10,0,1,0
10,120,120,8,3,5,2,1
15,132,132,33,33,0,1,0
0,140,140,46,22,24,4,3
22,149,149,15,15,0,1,0
9,188,188,16,16,0,1,0
8,203,203,13,6,7,2,1
6,212,212,1,1,0,1,0
12,228,228,30,6,24,2,1
19,238,238,23,5,18,4,3
4,266,266,16,16,0,1,0
18,271,271,1,1,0,1,0
23,283,283,46,46,0,1,0
7,291,291,15,15,0,1,0
20,322,322,15,9,6,2,1
17,335,335,98,57,41,4,3
3,335,335,24,24,0,1,0
1,336,336,6,6,0,1,0
21,347,347,3,3,0,1,0
13,396,396,36,36,0,1,0
16,401,401,29,11,18,4,3
5,424,424,1,1,0,1,0
11,471,471,55,55,0,1,0
2,493,493,5,5,0,1,0

4,122,122,9,9,0,1,0
3,145,145,9,9,0,1,0
15,155,155,33,33,0,1,0
16,207,207,11,5,6,2,1
12,207,207,11,11,0,1,0
9,215,215,16,2,14,3,2
11,257,257,10,4,6,3,2
17,277,277,52,32,20,2,1
10,293,293,31,31,0,1,0
2,301,301,3,3,0,1,0
6,320,320,141,97,44,2,1
21,324,324,23,5,18,2,1
20,360,360,47,47,0,1,0
0,361,361,11,7,4,2,1
19,385,385,6,6,0,1,0
8,387,387,17,1,16,2,1
18,396,396,56,56,0,1,0
13,413,413,89,89,0,1,0
14,462,462,15,15,0,1,0
5,484,484,18,18,0,1,0
1,488,488,79,41,38,4,3
7,500,500,12,4,8,2,1

11,111,111,14,14,0,1,0
15,150,150,21,4,17,2,1
19,168,168,14,7,7,2,1
4,175,175,6,6,0,1,0
17,198,198,11,5,6,3,2
2,211,211,11,11,0,1,0
18,216,216,42,42,0,1,0
8,218,218,7,7,0,1,0
3,238,238,2,2,0,1,0
13,253,253,34,6,28,3,2
9,272,272,5,5,0,1,0
10,273,273,25,7,18,4,3
7,287,287,43,15,28,3,2
6,341,341,183,143,40,4,3
16,344,344,2,2,0,1,0
5,385,385,41,7,34,2,1
14,392,392,23,3,20,3,2
12,428,428,101,101,0,1,0
1,479,479,25,1,24,4,3
0,500,500,55,17,38,2,1

0,110,110,14,14,0,1,0
5,118,118,3,3,0,1,0
17,118,118,3,3,0,1,0
11,124,124,2,2,0,1,0
15,161,161,43,43,0,1,0
6,168,168,21,12,9,2,1
2,183,183,9,9,0,1,0
18,198,198,1,1,0,1,0
20,212,212,36,36,0,1,0
14,232,232,23,23,0,1,0
13,237,237,57,9,48,3,2
7,238,238,11,11,0,1,0
3,260,260,26,16,10,3,2
19,297,297,3,3,0,1,0
12,312,312,44,2,42,4,3
8,313,313,2,2,0,1,0
10,357,357,63,42,21,2,1
9,375,375,88,88,0,1,0
4,396,396,34,34,0,1,0
16,490,490,73,11,62,3,2
1,499,499,62,44,18,2,1

2,100,100,3,3,0,1,0
5,115,115,20,20,0,1,0
7,137,137,6,6,0,1,0
20,165,165,4,4,0,1,0
9,169,169,14,14,0,1,0
10,172,172,2,2,0,1,0
16,236,236,41,1,40,2,1
19,282,282,11,11,0,1,0
17,306,306,40,40,0,1,0
18,310,310,93,19,74,3,2
1,334,334,4,1,3,2,1
14,335,335,73,63,10,3,2
11,370,370,30,16,14,2,1
4,374,374,1,1,0,1,0
8,381,381,93,61,32,3,2
0,408,408,72,72,0,1,0
3,424,424,37,37,0,1,0
13,476,476,22,4,18,4,3
15,492,492,18,18,0,1,0
12,497,497,33,33,0,1,0
6,497,497,118,118,0,1,0

17,101,101,20,8,12,3,2
11,108,108,2,2,0,1,0
8,136,136,5,5,0,1,0
2,140,140,27,9,18,4,3
12,148,148,2,2,0,1,0
18,151,151,23,9,14,3,2
9,155,155,11,11,0,1,0
13,228,228,62,1,61,4,3
15,229,229,2,2,0,1,0
7,249,249,29,29,0,1,0
10,264,264,67,11,56,3,2
6,283,283,9,4,5,2,1
3,283,283,107,69,38,2,1
4,290,290,11,11,0,1,0
5,352,352,27,27,0,1,0
1,363,363,33,13,20,4,3
14,370,370,52,52,0,1,0
16,405,405,2,2,0,1,0
0,433,433,62,17,45,2,1

21,162,162,41,15,26,2,1
20,172,172,6,6,0,1,0
18,180,180,36,14,22,3,2
22,185,185,1,1,0,1,0
6,187,187,7,3,4,2,1
14,190,190,9,9,0,1,0
7,210,210,9,3,6,2,1
13,234,234,32,32,0,1,0
11,239,239,7,7,0,1,0
9,242,242,1,1,0,1,0
16,250,250,3,3,0,1,0
17,297,297,86,53,33,4,3
5,298,298,3,3,0,1,0
10,348,348,4,4,0,1,0
4,369,369,4,4,0,1,0
2,382,382,87,51,36,2,1
8,395,395,116,116,0,1,0
0,398,398,52,31,21,4,3
15,428,428,45,9,36,4,3
1,440,440,22,22,0,1,0
12,472,472,62,62,0,1,0
3,490,490,60,60,0,1,0
19,493,493,18,18,0,1,0

15,132,132,4,1,3,2,1
5,137,137,8,8,0,1,0
9,144,144,14,14,0,1,0
18,180,180,14,6,8,3,2
21,194,194,50,50,0,1,0
13,208,208,16,3,13,2,1
0,215,215,12,3,9,2,1
14,242,242,27,27,0,1,0
1,255,255,32,32,0,1,0
20,278,278,20,20,0,1,0
10,293,293,5,5,0,1,0
7,295,295,5,1,4,2,1
22,296,296,3,3,0,1,0
23,297,297,23,1,22,3,2
3,298,298,36,36,0,1,0
19,314,314,86,86,0,1,0
2,332,332,5,2,3,2,1
4,356,356,27,27,0,1,0
11,363,363,15,15,0,1,0
16,411,411,21,9,12,4,3
12,436,436,46,35,11,2,1
17,440,440,72,42,30,3,2
6,445,445,16,16,0,1,0
8,471,471,123,17,106,4,3

16,167,167,21,21,0,1,0
5,167,167,11,3,8,2,1
11,170,170,35,3,32,3,2
1,190,190,13,5,8,2,1
13,194,194,12,12,0,1,0
12,199,199,4,4,0,1,0
18,205,205,4,1,3,2,1
9,243,243,15,1,14,3,2
0,297,297,79,38,41,2,1
7,320,320,39,39,0,1,0
10,353,353,88,88,0,1,0
14,362,362,52,10,42,2,1
17,362,362,4,4,0,1,0
4,406,406,3,3,0,1,0
6,413,413,60,14,46,4,3
2,451,451,122,122,0,1,0
15,456,456,99,99,0,1,0
3,463,463,41,14,27,2,1
8,487,487,33,2,31,4,3

0,108,108,19,19,0,1,0
5,124,124,3,3,0,1,0
1,129,129,41,7,34,3,2
2,176,176,68,68,0,1,0
13,214,214,37,37,0,1,0
12,243,243,46,41,5,2,1
11,313,313,22,22,0,1,0
9,323,323,14,4,10,2,1
7,360,360,46,46,0,1,0
3,425,425,94,94,0,1,0
6,436,436,24,24,0,1,0
10,441,441,60,60,0,1,0
4,453,453,93,6,87,4,3
8,496,496,43,43,0,1,0

7,136,136,10,4,6,3,2
15,140,140,4,4,0,1,0
11,162,162,5,5,0,1,0
3,176,176,1,1,0,1,0
2,195,195,18,18,0,1,0
4,199,199,1,1,0,1,0
18,235,235,4,1,3,2,1
13,243,243,2,2,0,1,0
6,277,277,43,7,36,2,1
14,284,284,56,36,20,3,2
0,298,298,40,40,0,1,0
16,310,310,3,3,0,1,0
10,321,321,45,5,40,3,2
20,324,324,34,20,14,2,1
1,331,331,62,62,0,1,0
9,363,363,52,34,18,2,1
17,379,379,47,47,0,1,0
5,382,382,21,21,0,1,0
21,412,412,71,1,70,3,2
19,461,461,118,61,57,4,3
12,473,473,95,59,36,3,2
8,489,489,40,26,14,4,3

9,107,107,5,5,0,1,0
10,126,126,1,1,0,1,0
16,146,146,3,3,0,1,0
20,154,154,19,11,8,3,2
12,155,155,2,2,0,1,0
21,180,180,36,36,0,1,0
5,194,194,16,7,9,2,1
1,224,224,14,2,12,2,1
17,233,233,17,17,0,1,0
19,234,234,70,24,46,3,2
7,235,235,14,4,10,3,2
18,237,237,57,8,49,2,1
11,238,238,7,7,0,1,0
3,244,244,14,14,0,1,0
13,268,268,9,9,0,1,0
0,283,283,32,27,5,2,1
8,299,299,36,3,33,4,3
4,317,317,6,6,0,1,0
6,322,322,93,93,0,1,0
15,384,384,3,3,0,1,0
2,407,407,88,10,78,4,3
14,445,445,53,53,0,1,0

18,118,118,18,18,0,1,0
17,121,121,6,1,5,2,1
13,151,151,9,1,8,3,2
12,159,159,22,22,0,1,0
4,178,178,1,1,0,1,0
3,181,181,47,19,28,3,2
6,204,204,4,1,3,2,1
9,218,218,20,20,0,1,0
2,222,222,36,26,10,3,2
10,227,227,11,11,0,1,0
0,245,245,15,15,0,1,0
8,250,250,64,17,47,3,2
14,279,279,32,21,11,2,1
1,316,316,28,13,15,4,3
16,316,316,38,29,9,4,3
15,351,351,28,16,12,2,1
5,398,398,59,51,8,2,1
11,410,410,107,107,0,1,0
7,490,490,49,49,0,1,0

9,134,134,11,5,6,2,1
19,139,139,1,1,0,1,0
12,144,144,31,26,5,2,1
6,153,153,54,31,23,2,1
3,214,214,9,4,5,2,1
5,220,220,28,14,14,3,2
21,225,225,12,12,0,1,0
17,230,230,12,2,10,2,1
14,234,234,18,18,0,1,0
11,262,262,19,19,0,1,0
10,292,292,3,3,0,1,0
13,294,294,32,2,30,3,2
1,307,307,34,2,32,2,1
20,318,318,19,19,0,1,0
15,351,351,19,19,0,1,0
7,358,358,1,1,0,1,0
8,361,361,37,19,18,3,2
18,411,411,178,34,144,4,3
2,425,425,17,2,15,4,3
0,461,461,44,11,33,4,3
16,478,478,29,20,9,2,1
4,487,487,31,31,0,1,0

8,106,106,1,1,0,1,0
22,117,117,8,2,6,3,2
6,123,123,1,1,0,1,0
1,136,136,20,6,14,3,2
14,144,144,8,8,0,1,0
24,146,146,4,1,3,2,1
17,150,150,8,3,5,2,1
13,187,187,14,14,0,1,0
0,210,210,21,3,18,4,3
16,266,266,84,36,48,3,2
9,270,270,32,2,30,2,1
5,279,279,29,29,0,1,0
23,295,295,8,8,0,1,0
15,314,314,15,1,14,2,1
4,316,316,14,14,0,1,0
18,320,320,19,13,6,2,1
3,344,344,7,7,0,1,0
21,371,371,51,51,0,1,0
19,372,372,140,140,0,1,0
11,391,391,10,1,9,4,3
10,398,398,22,22,0,1,0
7,437,437,106,82,24,4,3
20,438,438,3,3,0,1,0
2,440,440,1,1,0,1,0
12,489,489,48,48,0,1,0

5,111,111,14,14,0,1,0
21,133,133,2,2,0,1,0
10,142,142,4,4,0,1,0
11,165,165,9,9,0,1,0
3,172,172,8,8,0,1,0
8,172,172,31,9,22,3,2
22,180,180,27,27,0,1,0
7,261,261,58,58,0,1,0
1,275,275,27,27,0,1,0
12,298,298,2,2,0,1,0
9,303,303,1,1,0,1,0
16,327,327,62,62,0,1,0
14,331,331,46,46,0,1,0
15,341,341,28,1,27,4,3
6,350,350,45,45,0,1,0
0,387,387,27,27,0,1,0
19,392,392,52,52,0,1,0
2,402,402,21,7,14,3,2
4,451,451,39,3,36,3,2
20,456,456,96,96,0,1,0
18,467,467,3,3,0,1,0
13,482,482,82,28,54,3,2
17,483,483,11,11,0,1,0

10,118,118,1,1,0,1,0
4,119,119,6,3,3,2,1
0,154,154,62,62,0,1,0
14,185,185,10,10,0,1,0
11,208,208,32,16,16,3,2
9,274,274,74,62,12,2,1
16,281,281,16,7,9,4,3
5,314,314,55,7,48,2,1
7,315,315,24,24,0,1,0
3,335,335,109,109,0,1,0
2,338,338,4,4,0,1,0
15,376,376,122,122,0,1,0
6,413,413,19,3,16,3,2
1,451,451,7,1,6,2,1
13,466,466,56,22,34,3,2
8,492,492,8,8,0,1,0
12,492,492,18,1,17,2,1
17,498,498,42,42,0,1,0

12,123,123,33,33,0,1,0
6,143,143,1,1,0,1,0
14,154,154,1,1,0,1,0
5,167,167,4,4,0,1,0
9,178,178,12,12,0,1,0
7,192,192,19,3,16,2,1
8,199,199,1,1,0,1,0
16,212,212,2,2,0,1,0
0,235,235,48,28,20,3,2
1,236,236,1,1,0,1,0
13,243,243,68,68,0,1,0
2,250,250,10,2,8,3,2
3,300,300,51,51,0,1,0
11,349,349,82,28,54,3,2
18,383,383,14,14,0,1,0
20,385,385,2,2,0,1,0
15,385,385,17,17,0,1,0
19,401,401,125,104,21,2,1
21,403,403,35,7,28,2,1
10,405,405,36,4,32,2,1
17,495,495,33,12,21,4,3
4,497,497,78,42,36,2,1

2,102,102,23,15,8,2,1
6,162,162,15,15,0,1,0
12,173,173,5,5,0,1,0
0,177,177,55,43,12,2,1
13,190,190,18,18,0,1,0
3,192,192,7,2,5,2,1
7,213,213,17,17,0,1,0
18,226,226,18,18,0,1,0
16,240,240,17,17,0,1,0
11,280,280,66,31,35,2,1
5,287,287,58,42,16,3,2
17,311,311,15,15,0,1,0
10,331,331,11,8,3,2,1
9,346,346,138,119,19,4,3
15,356,356,12,12,0,1,0
8,432,432,42,42,0,1,0
14,436,436,42,6,36,4,3
1,440,440,8,2,6,3,2
4,462,462,18,18,0,1,0

0,122,122,5,5,0,1,0
4,159,159,21,18,3,2,1
17,212,212,20,8,12,3,2
1,212,212,56,44,12,2,1
11,220,220,19,19,0,1,0
9,229,229,1,1,0,1,0
7,230,230,14,1,13,2,1
5,257,257,44,3,41,4,3
10,265,265,36,28,8,3,2
8,286,286,81,51,30,4,3
2,297,297,31,31,0,1,0
16,318,318,13,1,12,3,2
6,323,323,67,3,64,3,2
13,324,324,17,3,14,2,1
12,325,325,92,92,0,1,0
14,366,366,11,1,10,3,2
15,474,474,52,52,0,1,0
3,488,488,60,60,0,1,0

16,112,112,3,3,0,1,0
5,115,115,26,1,25,2,1
1,216,216,2,2,0,1,0
8,237,237,65,65,0,1,0
19,238,238,37,10,27,2,1
20,242,242,4,4,0,1,0
10,259,259,8,8,0,1,0
15,270,270,77,49,28,2,1
14,294,294,66,22,44,4,3
13,296,296,24,7,17,3,2
3,297,297,4,4,0,1,0
11,302,302,12,1,11,3,2
7,322,322,64,64,0,1,0
9,325,325,1,1,0,1,0
4,340,340,1,1,0,1,0
17,412,412,5,2,3,2,1
6,437,437,63,63,0,1,0
0,451,451,35,12,23,4,3
12,473,473,38,27,11,2,1
18,486,486,96,48,48,4,3
2,492,492,60,45,15,4,3

1,107,107,12,1,11,3,2
10,122,122,36,1,35,2,1
11,160,160,22,4,18,4,3
5,203,203,14,8,6,2,1
8,223,223,1,1,0,1,0
2,234,234,85,85,0,1,0
18,249,249,1,1,0,1,0
0,258,258,8,8,0,1,0
15,271,271,37,37,0,1,0
12,277,277,69,69,0,1,0
16,288,288,19,1,18,4,3
13,307,307,36,36,0,1,0
3,316,316,4,1,3,2,1
14,375,375,67,48,19,3,2
9,396,396,37,37,0,1,0
4,399,399,7,1,6,3,2
6,412,412,26,20,6,3,2
7,420,420,18,6,12,2,1
17,437,437,30,17,13,4,3
19,482,482,11,6,5,2,1
20,484,484,65,14,51,4,3

10,111,111,2,2,0,1,0
0,131,131,3,3,0,1,0
1,155,155,38,38,0,1,0
16,171,171,8,5,3,2,1
15,172,172,40,6,34,3,2
14,173,173,18,18,0,1,0
3,249,249,10,10,0,1,0
12,249,249,98,98,0,1,0
9,274,274,18,18,0,1,0
17,283,283,7,7,0,1,0
11,321,321,36,36,0,1,0
6,327,327,112,10,102,4,3
2,337,337,40,24,16,2,1
13,360,360,36,13,23,2,1
5,372,372,40,2,38,3,2
8,401,401,41,18,23,2,1
4,405,405,29,17,12,2,1
18,437,437,11,8,3,2,1
7,486,486,24,24,0,1,0

9,122,122,35,35,0,1,0
3,144,144,12,9,3,2,1
6,167,167,42,31,11,2,1
0,195,195,16,7,9,2,1
18,204,204,23,23,0,1,0
12,222,222,2,2,0,1,0
10,240,240,3,3,0,1,0
15,319,319,118,22,96,4,3
2,332,332,14,14,0,1,0
13,367,367,59,49,10,3,2
1,387,387,10,10,0,1,0
11,401,401,33,33,0,1,0
5,417,417,82,2,80,4,3
17,436,436,11,11,0,1,0
14,454,454,9,9,0,1,0
7,456,456,40,40,0,1,0
8,457,457,100,100,0,1,0
4,481,481,54,54,0,1,0
16,483,483,19,15,4,2,1

24,103,103,7,7,0,1,0
9,126,126,1,1,0,1,0
3,130,130,7,7,0,1,0
8,134,134,8,1,7,2,1
12,139,139,1,1,0,1,0
13,147,147,6,6,0,1,0
1,167,167,28,28,0,1,0
0,208,208,20,20,0,1,0
2,226,226,10,1,9,4,3
22,254,254,17,9,8,2,1
4,256,256,7,3,4,2,1
18,274,274,1,1,0,1,0
10,291,291,71,71,0,1,0
19,311,311,42,39,3,2,1
6,342,342,24,24,0,1,0
11,345,345,26,26,0,1,0
15,355,355,96,36,60,4,3
7,362,362,53,53,0,1,0
20,375,375,4,4,0,1,0
17,382,382,75,75,0,1,0
21,391,391,95,21,74,4,3
14,401,401,15,6,9,2,1
16,434,434,18,18,0,1,0
23,453,453,40,40,0,1,0
5,460,460,11,3,8,2,1

10,101,101,1,1,0,1,0
3,136,136,12,12,0,1,0
12,177,177,7,7,0,1,0
15,188,188,19,7,12,2,1
16,212,212,36,16,20,2,1
2,245,245,1,1,0,1,0
5,259,259,59,35,24,3,2
0,288,288,11,1,10,3,2
4,315,315,5,5,0,1,0
8,330,330,56,8,48,3,2
13,332,332,120,21,99,4,3
7,345,345,15,15,0,1,0
11,353,353,13,13,0,1,0
14,381,381,3,3,0,1,0
1,402,402,91,64,27,4,3
6,423,423,122,98,24,4,3
18,457,457,54,54,0,1,0
17,485,485,117,117,0,1,0
9,489,489,18,18,0,1,0

12,107,107,3,3,0,1,0
1,142,142,22,22,0,1,0
19,186,186,26,26,0,1,0
14,192,192,5,5,0,1,0
3,225,225,55,55,0,1,0
15,233,233,8,8,0,1,0
9,244,244,13,13,0,1,0
13,245,245,21,4,17,3,2
17,299,299,190,88,102,4,3
18,315,315,27,27,0,1,0
6,318,318,16,4,12,2,1
10,332,332,11,3,8,3,2
5,335,335,13,13,0,1,0
4,372,372,91,80,11,2,1
11,411,411,7,2,5,2,1
8,423,423,57,42,15,2,1
0,437,437,9,9,0,1,0
7,479,479,71,22,49,2,1
16,491,491,19,2,17,4,3
2,495,495,5,1,4,2,1

3,112,112,7,2,5,2,1
17,119,119,2,2,0,1,0
13,121,121,17,17,0,1,0
10,133,133,1,1,0,1,0
9,136,136,8,2,6,2,1
15,167,167,10,6,4,2,1
8,174,174,33,1,32,3,2
4,179,179,26,1,25,2,1
14,179,179,36,19,17,2,1
7,185,185,42,42,0,1,0
0,243,243,34,26,8,3,2
21,252,252,8,8,0,1,0
1,260,260,13,13,0,1,0
16,287,287,24,24,0,1,0
18,386,386,166,121,45,4,3
5,395,395,8,1,7,2,1
20,410,410,22,22,0,1,0
2,458,458,17,17,0,1,0
12,466,466,15,1,14,3,2
19,466,466,32,2,30,4,3
11,467,467,43,43,0,1,0
6,493,493,35,29,6,2,1

9,122,122,2,2,0,1,0
2,131,131,24,3,21,2,1
5,158,158,25,16,9,2,1
3,196,196,18,12,6,2,1
10,233,233,102,14,88,3,2
13,238,238,33,33,0,1,0
14,295,295,29,3,26,2,1
12,296,296,29,11,18,2,1
16,342,342,5,5,0,1,0
15,342,342,12,12,0,1,0
6,346,346,66,66,0,1,0
4,359,359,2,2,0,1,0
0,376,376,151,67,84,4,3
11,389,389,41,12,29,4,3
17,409,409,58,58,0,1,0
1,411,411,3,3,0,1,0
7,491,491,31,7,24,4,3
8,498,498,16,16,0,1,0

3,130,130,13,13,0,1,0
10,152,152,4,1,3,2,1
13,173,173,50,50,0,1,0
0,176,176,7,7,0,1,0
5,219,219,44,44,0,1,0
17,268,268,18,18,0,1,0
12,275,275,24,1,23,2,1
8,313,313,23,16,7,2,1
16,325,325,37,37,0,1,0
15,325,325,64,17,47,2,1
2,387,387,39,39,0,1,0
1,388,388,11,11,0,1,0
9,399,399,52,22,30,2,1
7,400,400,26,26,0,1,0
6,405,405,143,95,48,3,2
14,431,431,9,9,0,1,0
11,452,452,51,5,46,3,2
4,473,473,101,41,60,4,3

9,117,117,1,1,0,1,0
0,133,133,48,48,0,1,0
15,144,144,11,11,0,1,0
11,145,145,16,3,13,2,1
18,187,187,8,3,5,2,1
19,188,188,8,8,0,1,0
17,192,192,15,15,0,1,0
5,233,233,21,21,0,1,0
2,243,243,7,1,6,3,2
13,245,245,21,9,12,3,2
6,292,292,6,1,5,2,1
21,299,299,93,93,0,1,0
8,318,318,5,5,0,1,0
20,325,325,38,10,28,3,2
16,341,341,41,20,21,4,3
14,382,382,44,44,0,1,0
12,388,388,52,52,0,1,0
1,407,407,4,4,0,1,0
10,422,422,42,35,7,2,1
3,449,449,44,13,31,3,2
4,490,490,12,2,10,2,1
7,493,493,117,60,57,4,3

16,123,123,43,13,30,3,2
1,137,137,25,25,0,1,0
14,143,143,1,1,0,1,0
4,156,156,29,29,0,1,0
19,183,183,17,17,0,1,0
12,197,197,8,5,3,2,1
6,216,216,8,8,0,1,0
2,229,229,5,5,0,1,0
7,251,251,22,12,10,2,1
15,256,256,73,73,0,1,0
8,266,266,24,3,21,2,1
17,273,273,11,5,6,3,2
0,286,286,34,34,0,1,0
13,306,306,5,5,0,1,0
11,367,367,29,29,0,1,0
3,384,384,1,1,0,1,0
18,448,448,53,53,0,1,0
9,471,471,122,51,71,4,3
10,488,488,44,1,43,3,2
5,498,498,58,58,0,1,0

0,108,108,17,17,0,1,0
12,114,114,6,1,5,2,1
7,133,133,11,11,0,1,0
5,152,152,7,4,3,2,1
10,163,163,28,13,15,2,1
6,227,227,93,93,0,1,0
16,287,287,9,1,8,3,2
11,326,326,100,68,32,4,3
3,339,339,95,23,72,3,2
9,384,384,15,15,0,1,0
14,392,392,62,62,0,1,0
13,393,393,133,33,100,4,3
17,415,415,1,1,0,1,0
1,423,423,1,1,0,1,0
4,431,431,52,41,11,2,1
15,436,436,4,4,0,1,0
2,442,442,1,1,0,1,0
8,458,458,2,2,0,1,0

8,111,111,22,22,0,1,0
9,118,118,2,2,0,1,0
16,139,139,53,15,38,2,1
2,169,169,1,1,0,1,0
6,173,173,7,7,0,1,0
13,197,197,21,6,15,2,1
1,228,228,60,45,15,2,1
3,237,237,2,2,0,1,0
0,246,246,83,5,78,3,2
19,255,255,2,2,0,1,0
11,266,266,16,16,0,1,0
18,271,271,24,12,12,3,2
12,276,276,30,30,0,1,0
10,282,282,91,91,0,1,0
5,313,313,30,6,24,2,1
4,333,333,38,28,10,2,1
15,341,341,2,2,0,1,0
14,372,372,5,5,0,1,0
17,389,389,9,3,6,2,1
7,481,481,10,4,6,3,2

18,122,122,1,1,0,1,0
20,143,143,49,9,40,2,1
5,165,165,16,13,3,2,1
19,166,166,1,1,0,1,0
6,179,179,28,28,0,1,0
9,194,194,27,27,0,1,0
12,196,196,25,9,16,4,3
2,215,215,24,24,0,1,0
14,215,215,5,5,0,1,0
8,235,235,3,3,0,1,0
0,244,244,8,8,0,1,0
10,290,290,16,16,0,1,0
1,360,360,33,1,32,2,1
17,365,365,29,4,25,2,1
3,394,394,16,16,0,1,0
21,397,397,42,27,15,2,1
22,397,397,107,9,98,3,2
11,404,404,11,6,5,2,1
7,405,405,31,5,26,2,1
15,414,414,34,34,0,1,0
16,441,441,54,54,0,1,0
13,456,456,40,3,37,2,1
23,472,472,38,38,0,1,0
4,496,496,22,22,0,1,0

15,105,105,16,6,10,2,1
21,123,123,2,2,0,1,0
13,126,126,2,2,0,1,0
6,153,153,26,20,6,2,1
5,167,167,47,47,0,1,0
19,229,229,44,44,0,1,0
8,237,237,40,40,0,1,0
0,242,242,10,10,0,1,0
2,271,271,15,15,0,1,0
10,312,312,18,18,0,1,0
1,318,318,9,9,0,1,0
17,337,337,100,77,23,2,1
18,349,349,37,2,35,2,1
7,363,363,50,45,5,2,1
9,365,365,17,2,15,2,1
16,367,367,24,24,0,1,0
11,369,369,6,6,0,1,0
12,382,382,10,10,0,1,0
3,404,404,28,28,0,1,0
14,416,416,87,47,40,3,2
4,419,419,12,3,9,2,1
20,439,439,22,22,0,1,0

13,100,100,23,23,0,1,0
14,106,106,22,5,17,2,1
11,117,117,36,18,18,4,3
15,149,149,5,5,0,1,0
6,154,154,3,3,0,1,0
5,167,167,21,21,0,1,0
1,172,172,14,14,0,1,0
9,172,172,33,30,3,2,1
8,218,218,35,23,12,4,3
0,230,230,29,29,0,1,0
3,243,243,23,23,0,1,0
20,261,261,10,2,8,3,2
16,298,298,36,15,21,4,3
4,305,305,7,7,0,1,0
19,328,328,3,3,0,1,0
7,350,350,39,12,27,2,1
10,361,361,54,6,48,3,2
17,385,385,16,16,0,1,0
12,396,396,3,3,0,1,0
2,443,443,8,8,0,1,0
18,470,470,59,41,18,4,3

10,120,120,16,6,10,3,2
7,159,159,35,35,0,1,0
16,195,195,9,3,6,2,1
12,222,222,44,13,31,2,1
5,248,248,37,6,31,2,1
8,253,253,15,1,14,3,2
17,275,275,24,9,15,2,1
13,287,287,75,75,0,1,0
15,311,311,17,17,0,1,0
4,324,324,61,7,54,3,2
9,406,406,59,59,0,1,0
0,416,416,37,37,0,1,0
3,420,420,28,5,23,2,1
1,454,454,102,33,69,4,3
2,471,471,70,70,0,1,0
14,477,477,36,27,9,4,3
11,490,490,27,27,0,1,0
6,496,496,7,7,0,1,0

10,103,103,7,7,0,1,0
16,103,103,9,9,0,1,0
21,117,117,4,4,0,1,0
6,122,122,18,18,0,1,0
15,214,214,3,3,0,1,0
12,248,248,6,6,0,1,0
14,261,261,38,38,0,1,0
7,296,296,29,29,0,1,0
11,302,302,7,7,0,1,0
18,327,327,7,7,0,1,0
3,335,335,50,21,29,2,1
1,338,338,30,1,29,4,3
13,389,389,54,3,51,4,3
20,391,391,60,60,0,1,0
17,424,424,76,10,66,3,2
8,441,441,14,14,0,1,0
0,441,441,28,28,0,1,0
9,449,449,43,25,18,3,2
5,454,454,30,1,29,2,1
4,454,454,89,21,68,3,2
19,474,474,151,151,0,1,0
2,487,487,24,13,11,2,1
22,496,496,10,2,8,2,1

20,104,104,16,8,8,3,2
4,111,111,27,27,0,1,0
14,123,123,25,25,0,1,0
22,139,139,16,16,0,1,0
12,151,151,1,1,0,1,0
15,152,152,3,3,0,1,0
21,157,157,55,40,15,2,1
13,190,190,17,9,8,3,2
3,200,200,90,50,40,2,1
0,202,202,10,10,0,1,0
9,311,311,14,11,3,2,1
1,311,311,5,5,0,1,0
7,317,317,9,4,5,2,1
8,320,320,45,45,0,1,0
2,320,320,1,1,0,1,0
5,339,339,10,4,6,3,2
19,365,365,2,2,0,1,0
16,371,371,15,15,0,1,0
11,419,419,19,19,0,1,0
17,421,421,12,4,8,2,1
6,430,430,18,15,3,2,1
10,432,432,2,2,0,1,0
18,478,478,57,15,42,4,3

3,116,116,1,1,0,1,0
20,117,117,21,1,20,2,1
0,119,119,18,18,0,1,0
9,120,120,12,12,0,1,0
24,133,133,31,31,0,1,0
1,149,149,9,1,8,3,2
13,156,156,23,3,20,4,3
22,173,173,14,9,5,2,1
10,184,184,2,2,0,1,0
14,206,206,1,1,0,1,0
16,225,225,41,11,30,2,1
11,235,235,10,6,4,2,1
4,250,250,23,23,0,1,0
23,275,275,35,20,15,4,3
19,311,311,17,14,3,2,1
12,385,385,23,23,0,1,0
17,392,392,5,5,0,1,0
21,394,394,8,8,0,1,0
8,410,410,40,40,0,1,0
7,414,414,80,80,0,1,0
15,419,419,55,12,43,2,1
18,460,460,47,47,0,1,0
5,464,464,44,44,0,1,0
2,471,471,5,5,0,1,0
6,496,496,15,15,0,1,0

21,122,122,16,16,0,1,0
8,125,125,2,2,0,1,0
22,128,128,2,2,0,1,0
12,153,153,17,17,0,1,0
1,166,166,6,6,0,1,0
14,169,169,12,2,10,2,1
5,174,174,29,23,6,2,1
20,174,174,50,5,45,2,1
26,183,183,2,2,0,1,0
28,190,190,73,73,0,1,0
10,211,211,23,23,0,1,0
9,288,288,5,5,0,1,0
7,290,290,1,1,0,1,0
3,290,290,11,11,0,1,0
15,311,311,7,1,6,2,1
13,327,327,34,15,19,2,1
24,340,340,7,7,0,1,0
11,356,356,16,6,10,2,1
18,356,356,29,29,0,1,0
0,357,357,1,1,0,1,0
16,379,379,4,4,0,1,0
2,384,384,22,22,0,1,0
25,414,414,22,22,0,1,0
17,425,425,43,12,31,3,2
6,432,432,6,6,0,1,0
4,435,435,41,41,0,1,0
23,437,437,33,3,30,2,1
27,463,463,13,13,0,1,0
19,494,494,58,45,13,2,1

21,157,157,5,5,0,1,0
1,165,165,25,25,0,1,0
5,175,175,15,7,8,3,2
17,208,208,10,10,0,1,0
12,220,220,28,16,12,3,2
2,230,230,2,2,0,1,0
6,256,256,47,47,0,1,0
13,259,259,61,28,33,4,3
0,262,262,3,3,0,1,0
19,266,266,92,14,78,4,3
3,280,280,20,20,0,1,0
4,328,328,11,3,8,3,2
18,343,343,42,42,0,1,0
9,349,349,47,35,12,3,2
10,359,359,116,14,102,4,3
7,412,412,15,15,0,1,0
11,417,417,14,14,0,1,0
15,428,428,16,4,12,4,3
8,455,455,13,4,9,4,3
14,458,458,53,34,19,4,3
16,471,471,14,14,0,1,0
20,475,475,14,14,0,1,0

2,125,125,14,14,0,1,0
19,135,135,17,17,0,1,0
16,147,147,5,5,0,1,0
18,191,191,10,4,6,2,1
7,193,193,8,8,0,1,0
11,198,198,18,6,12,2,1
0,254,254,27,3,24,4,3
21,273,273,9,9,0,1,0
9,274,274,15,15,0,1,0
12,283,283,9,1,8,2,1
13,296,296,7,1,6,3,2
17,304,304,128,128,0,1,0
14,321,321,5,2,3,2,1
8,331,331,32,12,20,3,2
3,362,362,52,44,8,3,2
1,383,383,51,7,44,3,2
4,396,396,91,31,60,4,3
20,409,409,79,79,0,1,0
10,420,420,18,7,11,4,3
5,426,426,16,4,12,4,3
6,471,471,6,6,0,1,0
15,479,479,90,52,38,2,1

4,115,115,18,18,0,1,0
13,139,139,4,4,0,1,0
2,163,163,23,20,3,2,1
16,177,177,4,4,0,1,0
17,180,180,66,38,28,2,1
12,236,236,25,14,11,3,2
1,263,263,69,7,62,3,2
18,285,285,11,2,9,4,3
7,294,294,8,8,0,1,0
9,324,324,42,15,27,2,1
0,330,330,5,5,0,1,0
5,347,347,4,4,0,1,0
10,374,374,22,4,18,4,3
14,399,399,10,10,0,1,0
15,412,412,42,13,29,3,2
6,429,429,48,3,45,2,1
8,441,441,94,79,15,2,1
3,441,441,15,15,0,1,0
19,458,458,67,52,15,4,3
11,497,497,113,80,33,2,1

20,128,128,4,4,0,1,0
21,131,131,15,1,14,2,1
11,153,153,2,2,0,1,0
15,155,155,25,25,0,1,0
12,162,162,2,2,0,1,0
3,178,178,26,18,8,3,2
8,186,186,11,5,6,2,1
19,202,202,30,30,0,1,0
4,203,203,3,3,0,1,0
23,210,210,24,24,0,1,0
0,228,228,11,11,0,1,0
14,236,236,33,13,20,3,2
7,247,247,52,26,26,2,1
22,260,260,48,34,14,3,2
5,280,280,1,1,0,1,0
1,311,311,14,8,6,2,1
6,393,393,53,27,26,3,2
10,404,404,10,10,0,1,0
16,408,408,25,13,12,4,3
13,415,415,4,4,0,1,0
18,424,424,49,49,0,1,0
17,469,469,22,10,12,2,1
9,470,470,170,170,0,1,0
2,495,495,9,3,6,3,2

8,102,102,5,5,0,1,0
18,111,111,5,5,0,1,0
6,116,116,4,4,0,1,0
12,157,157,54,54,0,1,0
16,162,162,10,7,3,2,1
11,176,176,4,4,0,1,0
4,208,208,42,42,0,1,0
13,213,213,29,1,28,3,2
7,234,234,6,6,0,1,0
5,292,292,108,56,52,4,3
0,305,305,10,10,0,1,0
10,317,317,14,9,5,2,1
19,346,346,17,17,0,1,0
2,364,364,35,35,0,1,0
3,366,366,34,34,0,1,0
9,382,382,75,44,31,2,1
1,439,439,1,1,0,1,0
17,446,446,29,16,13,2,1
15,454,454,84,63,21,4,3
14,469,469,83,83,0,1,0

4,115,115,11,11,0,1,0
13,128,128,14,8,6,3,2
15,150,150,2,2,0,1,0
1,211,211,1,1,0,1,0
16,243,243,11,11,0,1,0
6,245,245,12,3,9,2,1
0,248,248,78,74,4,2,1
9,306,306,4,1,3,2,1
5,337,337,25,25,0,1,0
11,338,338,2,2,0,1,0
14,375,375,44,44,0,1,0
12,391,391,117,117,0,1,0
17,395,395,98,80,18,4,3
10,415,415,54,2,52,3,2
8,434,434,30,4,26,3,2
3,474,474,25,2,23,2,1
18,485,485,67,44,23,2,1
2,490,490,119,119,0,1,0
7,497,497,99,99,0,1,0

4,112,112,3,3,0,1,0
22,122,122,1,1,0,1,0
21,154,154,31,19,12,2,1
6,158,158,3,3,0,1,0
17,160,160,17,17,0,1,0
12,205,205,42,9,33,4,3
15,219,219,1,1,0,1,0
14,268,268,15,9,6,3,2
1,272,272,2,2,0,1,0
20,273,273,45,45,0,1,0
19,309,309,39,6,33,4,3
0,321,321,9,9,0,1,0
5,334,334,1,1,0,1,0
18,344,344,58,58,0,1,0
3,360,360,28,13,15,4,3
11,366,366,5,5,0,1,0
2,369,369,31,23,8,3,2
9,388,388,15,15,0,1,0
8,423,423,71,71,0,1,0
13,460,460,110,2,108,4,3
7,490,490,25,25,0,1,0
16,495,495,21,11,10,3,2
10,499,499,190,156,34,2,1

2,182,182,43,43,0,1,0
16,199,199,4,1,3,2,1
13,202,202,14,14,0,1,0
8,229,229,16,16,0,1,0
15,243,243,1,1,0,1,0
3,244,244,5,2,3,2,1
20,253,253,21,5,16,3,2
18,253,253,94,55,39,2,1
0,275,275,13,3,10,3,2
14,291,291,41,41,0,1,0
12,316,316,1,1,0,1,0
11,343,343,71,71,0,1,0
19,368,368,8,2,6,3,2
4,376,376,51,33,18,4,3
5,397,397,12,12,0,1,0
1,410,410,1,1,0,1,0
9,426,426,149,8,141,4,3
10,440,440,38,38,0,1,0
7,447,447,14,14,0,1,0
6,454,454,42,42,0,1,0
17,478,478,94,24,70,4,3

7,101,101,1,1,0,1,0
30,111,111,14,4,10,3,2
15,126,126,16,7,9,4,3
16,140,140,1,1,0,1,0
4,162,162,2,2,0,1,0
19,183,183,1,1,0,1,0
5,197,197,11,11,0,1,0
25,211,211,2,2,0,1,0
1,212,212,5,5,0,1,0
17,221,221,21,1,20,3,2
8,225,225,3,3,0,1,0
29,230,230,12,2,10,3,2
11,236,236,11,2,9,4,3
12,256,256,30,19,11,2,1
2,277,277,16,16,0,1,0
24,303,303,129,40,89,4,3
3,309,309,25,25,0,1,0
20,338,338,14,14,0,1,0
0,346,346,7,3,4,2,1
10,352,352,42,1,41,2,1
23,385,385,34,34,0,1,0
26,388,388,3,3,0,1,0
9,426,426,32,32,0,1,0
22,432,432,107,51,56,3,2
14,462,462,15,5,10,3,2
13,474,474,30,30,0,1,0
18,478,478,26,6,20,2,1
21,478,478,10,10,0,1,0
28,484,484,45,45,0,1,0
27,486,486,19,19,0,1,0
6,497,497,22,19,3,2,1

23,114,114,2,2,0,1,0
3,116,116,10,10,0,1,0
21,116,116,11,1,10,2,1
12,120,120,5,5,0,1,0
22,159,159,13,2,11,2,1
10,179,179,18,6,12,4,3
1,183,183,4,4,0,1,0
5,190,190,30,2,28,2,1
6,198,198,8,8,0,1,0
11,228,228,3,3,0,1,0
9,235,235,27,8,19,4,3
18,255,255,10,10,0,1,0
0,290,290,33,33,0,1,0
13,295,295,4,4,0,1,0
19,324,324,42,42,0,1,0
16,350,350,24,24,0,1,0
2,355,355,63,16,47,4,3
20,379,379,12,12,0,1,0
14,401,401,37,37,0,1,0
4,403,403,13,1,12,4,3
15,414,414,66,18,48,4,3
7,425,425,50,50,0,1,0
17,450,450,185,168,17,2,1
8,486,486,35,23,12,2,1

16,106,106,1,1,0,1,0
1,109,109,1,1,0,1,0
21,110,110,17,17,0,1,0
17,130,130,11,11,0,1,0
5,136,136,62,62,0,1,0
9,136,136,1,1,0,1,0
10,141,141,3,3,0,1,0
11,188,188,1,1,0,1,0
6,208,208,19,19,0,1,0
19,227,227,50,12,38,3,2
4,234,234,11,2,9,4,3
18,265,265,1,1,0,1,0
7,303,303,29,29,0,1,0
22,336,336,102,102,0,1,0
2,372,372,60,60,0,1,0
13,374,374,1,1,0,1,0
14,375,375,119,101,18,4,3
12,388,388,44,29,15,4,3
3,394,394,4,4,0,1,0
0,400,400,2,2,0,1,0
15,424,424,11,11,0,1,0
8,451,451,35,17,18,4,3
20,453,453,1,1,0,1,0

1,113,113,24,12,12,4,3
6,123,123,12,6,6,3,2
16,145,145,7,1,6,3,2
8,159,159,45,42,3,2,1
22,202,202,72,41,31,2,1
7,205,205,9,9,0,1,0
0,241,241,5,5,0,1,0
20,255,255,6,6,0,1,0
11,256,256,2,2,0,1,0
18,269,269,46,46,0,1,0
4,277,277,22,22,0,1,0
19,321,321,96,96,0,1,0
13,323,323,1,1,0,1,0
14,323,323,26,26,0,1,0
5,329,329,35,35,0,1,0
9,336,336,2,2,0,1,0
12,353,353,7,7,0,1,0
17,382,382,1,1,0,1,0
10,389,389,12,1,11,3,2
3,447,447,70,4,66,4,3
2,475,475,17,17,0,1,0
21,476,476,37,37,0,1,0
15,496,496,28,28,0,1,0

13,103,103,17,11,6,2,1
15,105,105,14,14,0,1,0
11,109,109,7,7,0,1,0
1,118,118,24,24,0,1,0
17,129,129,3,3,0,1,0
6,187,187,98,98,0,1,0
8,195,195,13,13,0,1,0
12,285,285,72,72,0,1,0
3,299,299,5,5,0,1,0
16,326,326,9,9,0,1,0
10,331,331,118,118,0,1,0
0,358,358,1,1,0,1,0
9,361,361,13,4,9,2,1
4,381,381,8,8,0,1,0
7,389,389,14,14,0,1,0
2,484,484,39,39,0,1,0
5,485,485,105,11,94,3,2
14,491,491,2,2,0,1,0

15,101,101,5,5,0,1,0
6,116,116,4,4,0,1,0
11,119,119,19,19,0,1,0
2,123,123,1,1,0,1,0
18,127,127,3,3,0,1,0
9,152,152,17,17,0,1,0
0,158,158,9,9,0,1,0
13,236,236,5,5,0,1,0
19,241,241,101,27,74,3,2
16,257,257,4,4,0,1,0
4,282,282,42,16,26,2,1
12,300,300,2,2,0,1,0
3,308,308,21,21,0,1,0
20,363,363,38,2,36,4,3
1,367,367,27,27,0,1,0
17,376,376,48,8,40,2,1
14,379,379,77,77,0,1,0
7,391,391,80,4,76,4,3
8,445,445,51,37,14,3,2
5,477,477,106,85,21,3,2
10,490,490,28,19,9,4,3

14,117,117,9,9,0,1,0
13,131,131,5,5,0,1,0
8,148,148,7,1,6,3,2
1,179,179,10,10,0,1,0
16,195,195,46,20,26,2,1
10,201,201,45,19,26,3,2
0,232,232,35,5,30,3,2
9,234,234,3,3,0,1,0
2,237,237,38,26,12,4,3
4,243,243,1,1,0,1,0
12,289,289,67,67,0,1,0
15,295,295,30,30,0,1,0
6,296,296,166,135,31,4,3
3,301,301,1,1,0,1,0
7,323,323,31,13,18,4,3
11,331,331,16,4,12,2,1
17,350,350,26,26,0,1,0
19,390,390,11,11,0,1,0
18,430,430,27,3,24,2,1
5,489,489,5,5,0,1,0

18,132,132,28,28,0,1,0
3,139,139,4,4,0,1,0
23,140,140,10,7,3,2,1
17,159,159,1,1,0,1,0
20,187,187,32,15,17,2,1
16,199,199,31,15,16,2,1
9,213,213,7,1,6,3,2
14,214,214,17,17,0,1,0
0,219,219,14,1,13,2,1
22,226,226,43,4,39,3,2
1,248,248,9,1,8,2,1
8,257,257,2,2,0,1,0
2,271,271,30,21,9,4,3
11,279,279,2,2,0,1,0
24,280,280,4,4,0,1,0
21,285,285,9,9,0,1,0
5,312,312,1,1,0,1,0
19,317,317,63,63,0,1,0
10,343,343,36,10,26,2,1
6,393,393,1,1,0,1,0
7,410,410,40,40,0,1,0
15,431,431,31,31,0,1,0
13,451,451,108,63,45,4,3
12,451,451,3,3,0,1,0
4,455,455,127,127,0,1,0

13,155,155,7,7,0,1,0
16,158,158,40,40,0,1,0
0,164,164,33,4,29,2,1
11,182,182,2,2,0,1,0
14,219,219,38,8,30,4,3
10,237,237,26,26,0,1,0
15,252,252,57,3,54,4,3
6,256,256,38,9,29,2,1
2,259,259,16,1,15,2,1
12,265,265,41,41,0,1,0
17,284,284,32,26,6,3,2
4,324,324,136,136,0,1,0
8,332,332,8,8,0,1,0
3,351,351,13,13,0,1,0
7,373,373,62,12,50,3,2
5,408,408,2,2,0,1,0
1,444,444,27,19,8,3,2
9,481,481,4,4,0,1,0

23,101,101,4,4,0,1,0
8,183,183,1,1,0,1,0
7,186,186,14,14,0,1,0
5,197,197,25,25,0,1,0
9,211,211,29,29,0,1,0
17,227,227,63,63,0,1,0
22,231,231,1,1,0,1,0
24,236,236,8,2,6,3,2
18,273,273,16,16,0,1,0
16,284,284,19,9,10,4,3
1,288,288,1,1,0,1,0
13,345,345,52,52,0,1,0
10,346,346,35,35,0,1,0
19,364,364,152,140,12,4,3
3,385,385,1,1,0,1,0
12,385,385,21,3,18,3,2
4,401,401,3,3,0,1,0
20,410,410,22,22,0,1,0
15,430,430,20,10,10,2,1
6,437,437,44,44,0,1,0
11,451,451,8,1,7,2,1
21,466,466,59,59,0,1,0
14,477,477,28,28,0,1,0
2,490,490,112,4,108,4,3
0,496,496,15,15,0,1,0

7,100,100,6,6,0,1,0
21,158,158,13,8,5,2,1
20,239,239,28,28,0,1,0
5,270,270,4,4,0,1,0
18,271,271,12,12,0,1,0
8,272,272,13,13,0,1,0
1,281,281,38,38,0,1,0
10,281,281,34,34,0,1,0
22,291,291,155,74,81,4,3
17,307,307,14,14,0,1,0
3,325,325,52,52,0,1,0
0,347,347,24,24,0,1,0
11,350,350,21,18,3,2,1
16,364,364,15,15,0,1,0
14,379,379,54,11,43,2,1
4,385,385,6,6,0,1,0
2,403,403,76,56,20,3,2
9,411,411,80,26,54,4,3
15,431,431,33,4,29,2,1
19,456,456,3,3,0,1,0
6,472,472,10,10,0,1,0
13,485,485,15,15,0,1,0
12,486,486,6,6,0,1,0

7,110,110,15,15,0,1,0
12,128,128,19,4,15,3,2
15,137,137,13,13,0,1,0
14,137,137,3,3,0,1,0
4,162,162,4,4,0,1,0
3,272,272,10,4,6,2,1
10,275,275,21,3,18,3,2
17,304,304,17,17,0,1,0
2,308,308,13,13,0,1,0
1,334,334,57,57,0,1,0
16,358,358,95,30,65,4,3
9,388,388,5,5,0,1,0
5,411,411,11,6,5,2,1
18,421,421,3,3,0,1,0
13,427,427,92,11,81,4,3
8,446,446,154,49,105,4,3
0,451,451,99,66,33,4,3
11,468,468,107,80,27,4,3
6,495,495,49,22,27,4,3

9,131,131,41,5,36,3,2
12,133,133,3,3,0,1,0
5,184,184,8,3,5,2,1
3,197,197,11,11,0,1,0
6,211,211,17,17,0,1,0
13,213,213,34,34,0,1,0
15,226,226,37,37,0,1,0
11,252,252,7,1,6,2,1
21,253,253,19,19,0,1,0
17,281,281,2,2,0,1,0
10,310,310,25,25,0,1,0
1,310,310,32,32,0,1,0
22,327,327,28,16,12,3,2
16,349,349,21,1,20,3,2
14,391,391,15,12,3,2,1
20,393,393,20,1,19,4,3
7,397,397,70,44,26,3,2
18,398,398,106,16,90,4,3
0,408,408,4,4,0,1,0
19,435,435,91,91,0,1,0
2,466,466,10,10,0,1,0
4,477,477,26,17,9,2,1
8,478,478,53,53,0,1,0

3,107,107,6,6,0,1,0
8,118,118,3,3,0,1,0
18,118,118,17,7,10,2,1
11,139,139,15,15,0,1,0
9,156,156,21,13,8,2,1
4,175,175,25,25,0,1,0
1,266,266,13,13,0,1,0
17,271,271,9,9,0,1,0
19,294,294,23,23,0,1,0
2,307,307,77,77,0,1,0
16,314,314,3,3,0,1,0
20,325,325,16,16,0,1,0
7,340,340,12,12,0,1,0
13,376,376,161,146,15,2,1
0,390,390,85,85,0,1,0
5,396,396,44,44,0,1,0
12,399,399,5,5,0,1,0
15,404,404,41,17,24,2,1
14,415,415,63,63,0,1,0
6,467,467,21,21,0,1,0
10,497,497,16,16,0,1,0

17,103,103,14,14,0,1,0
28,103,103,4,4,0,1,0
1,106,106,8,1,7,2,1
9,140,140,4,4,0,1,0
20,157,157,59,59,0,1,0
19,164,164,7,7,0,1,0
8,164,164,11,11,0,1,0
11,169,169,1,1,0,1,0
2,169,169,7,7,0,1,0
26,175,175,15,15,0,1,0
21,183,183,38,1,37,4,3
5,192,192,8,8,0,1,0
10,196,196,12,12,0,1,0
22,211,211,7,1,6,3,2
6,237,237,5,5,0,1,0
15,264,264,18,2,16,2,1
27,273,273,50,50,0,1,0
25,278,278,4,1,3,2,1
12,283,283,53,25,28,2,1
18,285,285,1,1,0,1,0
13,301,301,3,3,0,1,0
23,310,310,12,6,6,3,2
14,313,313,1,1,0,1,0
3,323,323,45,45,0,1,0
4,334,334,29,9,20,3,2
16,388,388,19,4,15,2,1
29,430,430,5,5,0,1,0
24,461,461,64,64,0,1,0
7,468,468,3,3,0,1,0
0,485,485,14,14,0,1,0

3,102,102,1,1,0,1,0
0,122,122,13,13,0,1,0
5,131,131,1,1,0,1,0
21,148,148,6,6,0,1,0
7,170,170,4,4,0,1,0
6,174,174,7,7,0,1,0
17,188,188,1,1,0,1,0
14,204,204,22,1,21,4,3
15,239,239,10,10,0,1,0
11,245,245,11,11,0,1,0
1,254,254,25,7,18,3,2
12,269,269,24,24,0,1,0
22,280,280,14,14,0,1,0
4,294,294,29,29,0,1,0
16,299,299,11,11,0,1,0
24,317,317,26,14,12,4,3
8,344,344,33,5,28,2,1
19,356,356,146,91,55,3,2
9,361,361,10,3,7,2,1
2,373,373,1,1,0,1,0
10,407,407,85,85,0,1,0
20,454,454,12,1,11,2,1
13,457,457,64,64,0,1,0
23,477,477,125,57,68,3,2
18,492,492,77,77,0,1,0

8,147,147,1,1,0,1,0
24,181,181,9,9,0,1,0
4,217,217,11,11,0,1,0
25,242,242,11,1,10,3,2
13,242,242,21,14,7,2,1
7,247,247,2,2,0,1,0
20,272,272,155,124,31,2,1
15,287,287,15,15,0,1,0
12,288,288,30,30,0,1,0
21,307,307,31,22,9,4,3
19,312,312,12,2,10,2,1
9,314,314,22,22,0,1,0
23,329,329,7,7,0,1,0
0,335,335,50,50,0,1,0
2,342,342,14,14,0,1,0
11,365,365,21,21,0,1,0
14,369,369,55,39,16,3,2
16,369,369,13,13,0,1,0
17,378,378,25,12,13,2,1
6,384,384,6,6,0,1,0
1,405,405,19,19,0,1,0
5,453,453,31,31,0,1,0
18,456,456,27,18,9,4,3
10,478,478,22,22,0,1,0
22,478,478,64,45,19,3,2
3,498,498,74,62,12,4,3

20,100,100,44,18,26,2,1
16,141,141,6,6,0,1,0
12,159,159,1,1,0,1,0
8,185,185,19,19,0,1,0
5,186,186,15,1,14,2,1
0,255,255,84,9,75,3,2
13,262,262,40,40,0,1,0
4,273,273,2,2,0,1,0
11,282,282,14,3,11,2,1
19,306,306,9,4,5,2,1
10,340,340,37,37,0,1,0
1,372,372,21,7,14,2,1
18,378,378,16,16,0,1,0
17,441,441,43,28,15,2,1
9,464,464,8,8,0,1,0
3,470,470,19,9,10,2,1
15,473,473,110,95,15,4,3
14,480,480,13,13,0,1,0
7,483,483,6,2,4,2,1
2,486,486,77,48,29,2,1
6,493,493,93,39,54,3,2

2,106,106,3,3,0,1,0
19,163,163,55,55,0,1,0
6,170,170,62,62,0,1,0
17,207,207,10,4,6,2,1
7,209,209,3,3,0,1,0
13,218,218,6,6,0,1,0
5,226,226,19,3,16,2,1
18,226,226,18,13,5,2,1
1,243,243,22,22,0,1,0
8,244,244,18,6,12,3,2
12,269,269,87,87,0,1,0
4,277,277,63,63,0,1,0
3,283,283,28,8,20,3,2
10,304,304,48,48,0,1,0
16,361,361,25,25,0,1,0
15,371,371,18,18,0,1,0
14,388,388,3,3,0,1,0
0,398,398,41,41,0,1,0
9,463,463,7,1,6,2,1
11,466,466,8,8,0,1,0

12,106,106,5,5,0,1,0
15,122,122,6,1,5,2,1
4,128,128,24,24,0,1,0
3,130,130,36,36,0,1,0
1,181,181,7,7,0,1,0
2,225,225,39,39,0,1,0
11,233,233,44,28,16,3,2
16,311,311,7,7,0,1,0
7,321,321,4,4,0,1,0
8,330,330,104,49,55,4,3
17,374,374,10,10,0,1,0
10,384,384,127,107,20,2,1
0,402,402,44,44,0,1,0
6,424,424,60,6,54,3,2
13,430,430,29,29,0,1,0
5,443,443,72,72,0,1,0
9,460,460,13,7,6,3,2
14,461,461,18,4,14,2,1

18,108,108,6,3,3,2,1
13,114,114,5,5,0,1,0
11,131,131,1,1,0,1,0
1,158,158,15,15,0,1,0
12,163,163,8,8,0,1,0
3,188,188,19,1,18,2,1
10,239,239,25,25,0,1,0
9,248,248,27,27,0,1,0
7,260,260,28,10,18,2,1
2,274,274,2,2,0,1,0
5,278,278,51,35,16,2,1
8,334,334,35,17,18,2,1
22,357,357,90,12,78,4,3
0,368,368,24,12,12,4,3
21,384,384,104,81,23,2,1
4,386,386,47,11,36,4,3
19,406,406,18,10,8,3,2
14,416,416,22,22,0,1,0
17,435,435,10,10,0,1,0
23,450,450,96,96,0,1,0
15,456,456,3,3,0,1,0
6,460,460,3,3,0,1,0
20,463,463,78,78,0,1,0
16,496,496,14,4,10,2,1

1,121,121,28,28,0,1,0
7,125,125,2,2,0,1,0
16,165,165,42,42,0,1,0
17,214,214,14,14,0,1,0
18,224,224,26,16,10,2,1
11,243,243,28,11,17,4,3
4,292,292,5,1,4,2,1
20,292,292,2,2,0,1,0
12,320,320,43,43,0,1,0
3,323,323,47,47,0,1,0
21,336,336,50,50,0,1,0
14,338,338,33,4,29,2,1
6,352,352,5,1,4,2,1
5,353,353,84,60,24,2,1
10,371,371,10,10,0,1,0
8,404,404,7,7,0,1,0
13,426,426,16,6,10,2,1
2,445,445,12,12,0,1,0
0,446,446,13,3,10,3,2
9,470,470,105,35,70,3,2
15,470,470,38,30,8,3,2
19,487,487,88,68,20,2,1

0,111,111,15,7,8,3,2
18,125,125,25,7,18,4,3
4,132,132,1,1,0,1,0
23,146,146,4,4,0,1,0
16,151,151,1,1,0,1,0
17,170,170,29,29,0,1,0
6,203,203,17,17,0,1,0
5,216,216,5,2,3,2,1
10,216,216,35,35,0,1,0
14,253,253,57,57,0,1,0
19,264,264,41,41,0,1,0
21,277,277,9,1,8,3,2
9,283,283,99,21,78,3,2
22,287,287,63,17,46,3,2
3,300,300,13,10,3,2,1
8,312,312,3,3,0,1,0
2,331,331,1,1,0,1,0
15,354,354,15,15,0,1,0
1,369,369,5,5,0,1,0
11,377,377,6,6,0,1,0
20,450,450,19,19,0,1,0
13,453,453,6,6,0,1,0
7,456,456,7,3,4,2,1
12,459,459,104,104,0,1,0

10,109,109,15,5,10,3,2
0,110,110,8,8,0,1,0
12,130,130,17,10,7,2,1
13,145,145,9,9,0,1,0
7,184,184,1,1,0,1,0
8,201,201,27,11,16,2,1
4,211,211,51,51,0,1,0
6,320,320,22,22,0,1,0
16,324,324,20,11,9,2,1
11,330,330,15,15,0,1,0
1,354,354,8,8,0,1,0
14,361,361,1,1,0,1,0
2,363,363,3,3,0,1,0
15,369,369,31,25,6,3,2
3,374,374,17,1,16,3,2
5,379,379,92,82,10,2,1
19,388,388,115,67,48,4,3
9,400,400,104,8,96,4,3
18,431,431,97,55,42,3,2
17,480,480,33,33,0,1,0

23,103,103,6,3,3,2,1
18,120,120,27,27,0,1,0
12,122,122,2,2,0,1,0
16,129,129,6,6,0,1,0
22,130,130,30,30,0,1,0
10,150,150,14,11,3,2,1
14,158,158,2,2,0,1,0
0,179,179,5,2,3,2,1
6,197,197,9,9,0,1,0
1,201,201,29,29,0,1,0
7,223,223,24,19,5,2,1
8,230,230,34,28,6,3,2
3,241,241,14,9,5,2,1
17,249,249,5,5,0,1,0
2,268,268,19,19,0,1,0
5,284,284,35,35,0,1,0
25,311,311,41,41,0,1,0
20,323,323,15,4,11,2,1
15,373,373,37,7,30,3,2
11,388,388,3,3,0,1,0
4,388,388,28,2,26,3,2
24,392,392,20,15,5,2,1
19,434,434,108,12,96,4,3
13,467,467,28,28,0,1,0
9,483,483,7,7,0,1,0
21,496,496,36,7,29,4,3

13,125,125,6,6,0,1,0
17,156,156,4,4,0,1,0
4,165,165,1,1,0,1,0
16,174,174,28,3,25,3,2
1,203,203,9,5,4,2,1
11,204,204,44,44,0,1,0
6,229,229,43,43,0,1,0
0,242,242,36,36,0,1,0
19,260,260,1,1,0,1,0
20,265,265,19,19,0,1,0
2,281,281,35,35,0,1,0
5,283,283,58,12,46,3,2
8,287,287,1,1,0,1,0
12,290,290,80,2,78,4,3
3,305,305,9,9,0,1,0
10,336,336,40,25,15,2,1
18,347,347,30,3,27,4,3
15,390,390,49,49,0,1,0
9,411,411,71,71,0,1,0
14,484,484,52,52,0,1,0
7,498,498,30,30,0,1,0

14,107,107,9,2,7,3,2
1,108,108,4,1,3,2,1
16,134,134,1,1,0,1,0
0,155,155,1,1,0,1,0
6,159,159,1,1,0,1,0
10,172,172,4,4,0,1,0
17,186,186,21,21,0,1,0
25,211,211,51,30,21,4,3
24,227,227,22,13,9,2,1
11,233,233,22,7,15,4,3
12,234,234,30,30,0,1,0
21,237,237,4,4,0,1,0
19,240,240,2,2,0,1,0
9,241,241,20,20,0,1,0
23,256,256,6,6,0,1,0
15,257,257,3,3,0,1,0
4,265,265,3,3,0,1,0
3,338,338,3,3,0,1,0
27,370,370,12,12,0,1,0
18,374,374,8,8,0,1,0
13,374,374,53,53,0,1,0
26,388,388,10,10,0,1,0
22,400,400,40,40,0,1,0
20,406,406,221,221,0,1,0
5,415,415,6,3,3,2,1
8,431,431,85,63,22,3,2
2,438,438,52,52,0,1,0
7,477,477,8,8,0,1,0

18,106,106,47,16,31,2,1
7,144,144,19,19,0,1,0
10,156,156,6,1,5,2,1
5,162,162,28,6,22,4,3
17,163,163,2,2,0,1,0
16,205,205,6,6,0,1,0
1,246,246,12,12,0,1,0
15,276,276,24,4,20,3,2
13,298,298,34,2,32,2,1
12,332,332,4,4,0,1,0
14,334,334,13,13,0,1,0
6,352,352,30,30,0,1,0
4,364,364,71,52,19,4,3
8,364,364,89,62,27,4,3
3,369,369,53,47,6,2,1
9,403,403,64,37,27,4,3
2,410,410,26,26,0,1,0
0,470,470,8,8,0,1,0
11,475,475,88,46,42,2,1

13,124,124,7,2,5,2,1
21,125,125,37,1,36,3,2
9,132,132,1,1,0,1,0
4,151,151,4,4,0,1,0
11,152,152,35,35,0,1,0
17,166,166,7,1,6,2,1
12,199,199,4,4,0,1,0
20,201,201,8,8,0,1,0
19,221,221,7,7,0,1,0
16,239,239,74,74,0,1,0
10,250,250,39,39,0,1,0
15,255,255,1,1,0,1,0
3,271,271,28,16,12,4,3
14,305,305,56,28,28,2,1
22,335,335,9,3,6,2,1
1,336,336,5,5,0,1,0
18,354,354,51,51,0,1,0
7,364,364,32,32,0,1,0
6,374,374,12,7,5,2,1
2,425,425,14,14,0,1,0
8,484,484,170,127,43,4,3
0,485,485,6,6,0,1,0
5,494,494,13,9,4,2,1

11,107,107,19,2,17,3,2
9,122,122,5,5,0,1,0
10,135,135,1,1,0,1,0
13,141,141,4,1,3,2,1
1,184,184,39,39,0,1,0
17,209,209,57,33,24,2,1
4,213,213,1,1,0,1,0
12,219,219,13,1,12,3,2
18,257,257,32,32,0,1,0
2,311,311,9,9,0,1,0
8,315,315,1,1,0,1,0
19,329,329,22,4,18,2,1
7,337,337,146,58,88,4,3
16,337,337,9,9,0,1,0
6,358,358,12,9,3,2,1
3,363,363,33,33,0,1,0
15,372,372,1,1,0,1,0
5,382,382,55,55,0,1,0
0,383,383,41,5,36,4,3
14,416,416,61,28,33,4,3
20,497,497,105,105,0,1,0

7,122,122,31,31,0,1,0
17,137,137,34,18,16,2,1
16,143,143,11,11,0,1,0
11,153,153,5,5,0,1,0
15,163,163,17,11,6,2,1
12,185,185,4,1,3,2,1
1,198,198,1,1,0,1,0
0,221,221,23,18,5,2,1
20,254,254,23,1,22,3,2
18,281,281,3,3,0,1,0
9,332,332,1,1,0,1,0
22,386,386,5,5,0,1,0
10,394,394,14,14,0,1,0
13,402,402,21,7,14,2,1
23,414,414,113,99,14,2,1
3,418,418,10,3,7,2,1
14,426,426,2,2,0,1,0
4,430,430,1,1,0,1,0
6,448,448,52,41,11,2,1
21,462,462,44,28,16,3,2
8,470,470,59,38,21,4,3
5,471,471,50,16,34,3,2
19,487,487,100,76,24,4,3
2,496,496,108,76,32,3,2

14,100,100,1,1,0,1,0
7,113,113,10,10,0,1,0
16,127,127,25,16,9,2,1
1,148,148,8,8,0,1,0
9,175,175,1,1,0,1,0
4,180,180,21,21,0,1,0
15,188,188,19,19,0,1,0
17,199,199,1,1,0,1,0
8,228,228,16,16,0,1,0
6,236,236,52,52,0,1,0
11,237,237,23,23,0,1,0
5,238,238,14,3,11,2,1
10,314,314,4,4,0,1,0
3,327,327,28,16,12,2,1
18,329,329,29,2,27,3,2
0,335,335,101,101,0,1,0
13,362,362,166,166,0,1,0
2,396,396,41,41,0,1,0
12,412,412,34,3,31,2,1
19,448,448,35,35,0,1,0

11,142,142,16,16,0,1,0
6,186,186,3,3,0,1,0
15,187,187,8,8,0,1,0
3,225,225,43,15,28,3,2
8,227,227,19,19,0,1,0
9,247,247,3,3,0,1,0
18,260,260,8,8,0,1,0
12,299,299,4,1,3,2,1
7,300,300,16,4,12,3,2
19,300,300,13,13,0,1,0
20,308,308,9,9,0,1,0
0,309,309,36,27,9,4,3
2,339,339,4,4,0,1,0
14,349,349,85,31,54,3,2
5,359,359,16,6,10,2,1
24,363,363,32,2,30,4,3
13,384,384,13,13,0,1,0
1,385,385,20,20,0,1,0
21,392,392,129,129,0,1,0
4,395,395,37,16,21,4,3
22,442,442,168,75,93,4,3
10,453,453,10,2,8,2,1
23,456,456,29,29,0,1,0
16,494,494,27,3,24,2,1
17,494,494,27,15,12,4,3

24,102,102,20,20,0,1,0
21,114,114,6,2,4,2,1
1,114,114,1,1,0,1,0
20,123,123,4,4,0,1,0
6,125,125,2,2,0,1,0
14,126,126,10,10,0,1,0
23,127,127,25,25,0,1,0
12,136,136,7,7,0,1,0
0,145,145,10,3,7,2,1
16,173,173,44,11,33,4,3
19,221,221,14,8,6,3,2
13,222,222,2,2,0,1,0
3,235,235,47,47,0,1,0
4,277,277,43,13,30,4,3
2,308,308,49,21,28,3,2
9,324,324,1,1,0,1,0
18,325,325,60,60,0,1,0
5,340,340,2,2,0,1,0
10,386,386,36,28,8,2,1
17,394,394,30,2,28,2,1
25,411,411,19,19,0,1,0
7,419,419,48,48,0,1,0
8,442,442,51,51,0,1,0
11,455,455,2,2,0,1,0
22,465,465,11,11,0,1,0
15,500,500,8,8,0,1,0

15,112,112,5,5,0,1,0
12,129,129,26,26,0,1,0
6,140,140,5,5,0,1,0
5,144,144,15,8,7,2,1
17,150,150,30,6,24,4,3
7,165,165,9,9,0,1,0
21,197,197,15,8,7,3,2
14,214,214,33,6,27,4,3
19,219,219,38,14,24,4,3
1,228,228,7,7,0,1,0
13,261,261,26,26,0,1,0
22,265,265,36,6,30,3,2
8,301,301,24,24,0,1,0
20,325,325,14,14,0,1,0
10,382,382,21,15,6,2,1
11,383,383,31,5,26,2,1
9,413,413,93,9,84,4,3
2,413,413,11,11,0,1,0
0,437,437,54,51,3,2,1
4,451,451,36,36,0,1,0
16,453,453,38,38,0,1,0
18,476,476,54,54,0,1,0
3,499,499,2,2,0,1,0

3,142,142,11,11,0,1,0
5,143,143,6,6,0,1,0
0,144,144,14,5,9,2,1
6,152,152,38,17,21,4,3
2,198,198,18,18,0,1,0
16,219,219,6,6,0,1,0
13,237,237,2,2,0,1,0
12,253,253,123,72,51,4,3
8,258,258,25,25,0,1,0
1,304,304,31,3,28,2,1
11,380,380,8,1,7,2,1
7,399,399,65,65,0,1,0
14,421,421,33,24,9,2,1
15,445,445,13,13,0,1,0
9,459,459,70,30,40,3,2
4,485,485,214,185,29,3,2
10,495,495,26,26,0,1,0

8,111,111,1,1,0,1,0
20,116,116,28,28,0,1,0
9,126,126,13,13,0,1,0
26,181,181,1,1,0,1,0
5,190,190,56,56,0,1,0
22,190,190,41,20,21,4,3
0,199,199,10,10,0,1,0
4,202,202,3,3,0,1,0
17,216,216,10,1,9,4,3
11,223,223,1,1,0,1,0
25,233,233,4,4,0,1,0
21,238,238,68,32,36,3,2
10,243,243,4,1,3,2,1
12,254,254,21,14,7,2,1
2,257,257,1,1,0,1,0
14,286,286,25,25,0,1,0
24,335,335,13,4,9,3,2
1,340,340,3,3,0,1,0
16,363,363,28,28,0,1,0
7,365,365,33,15,18,2,1
3,370,370,46,7,39,2,1
6,405,405,30,30,0,1,0
13,411,411,9,9,0,1,0
18,426,426,52,38,14,3,2
23,454,454,48,48,0,1,0
19,478,478,21,15,6,2,1
15,495,495,19,19,0,1,0

4,109,109,1,1,0,1,0
6,126,126,7,7,0,1,0
3,170,170,48,33,15,4,3
11,171,171,17,9,8,3,2
10,177,177,14,14,0,1,0
0,249,249,81,78,3,2,1
12,283,283,10,10,0,1,0
13,289,289,11,11,0,1,0
16,296,296,26,26,0,1,0
1,296,296,34,4,30,4,3
8,302,302,19,19,0,1,0
7,351,351,29,29,0,1,0
9,352,352,112,112,0,1,0
15,367,367,64,64,0,1,0
5,412,412,63,63,0,1,0
2,416,416,68,30,38,4,3
14,450,450,59,59,0,1,0

18,108,108,6,6,0,1,0
1,134,134,8,8,0,1,0
8,140,140,45,45,0,1,0
6,227,227,21,21,0,1,0
4,232,232,9,9,0,1,0
17,239,239,21,8,13,2,1
13,259,259,11,11,0,1,0
9,265,265,2,2,0,1,0
7,303,303,14,14,0,1,0
3,314,314,19,5,14,3,2
2,334,334,15,2,13,3,2
12,358,358,133,67,66,4,3
14,358,358,51,27,24,2,1
11,377,377,19,4,15,4,3
15,393,393,30,8,22,2,1
10,422,422,30,11,19,2,1
5,432,432,117,78,39,4,3
0,448,448,74,61,13,2,1
16,488,488,105,105,0,1,0

2,100,100,18,18,0,1,0
13,123,123,18,8,10,2,1
19,124,124,23,23,0,1,0
7,130,130,9,9,0,1,0
1,159,159,1,1,0,1,0
15,164,164,45,14,31,2,1
3,173,173,22,22,0,1,0
12,193,193,13,5,8,2,1
18,196,196,32,1,31,2,1
22,243,243,17,3,14,4,3
0,249,249,1,1,0,1,0
5,261,261,15,15,0,1,0
23,266,266,9,9,0,1,0
14,273,273,32,6,26,2,1
9,281,281,1,1,0,1,0
11,292,292,22,22,0,1,0
16,296,296,2,2,0,1,0
6,308,308,14,14,0,1,0
21,326,326,43,28,15,4,3
8,331,331,77,23,54,4,3
4,375,375,23,23,0,1,0
17,377,377,18,2,16,2,1
20,472,472,42,42,0,1,0
10,498,498,13,8,5,2,1

11,131,131,1,1,0,1,0
14,142,142,6,6,0,1,0
5,152,152,8,1,7,2,1
9,166,166,17,1,16,3,2
1,183,183,1,1,0,1,0
2,186,186,19,5,14,2,1
10,195,195,9,9,0,1,0
6,206,206,2,2,0,1,0
12,208,208,69,69,0,1,0
3,219,219,2,2,0,1,0
4,242,242,6,6,0,1,0
13,247,247,39,39,0,1,0
16,271,271,21,21,0,1,0
19,278,278,89,4,85,3,2
22,291,291,14,4,10,2,1
20,322,322,31,31,0,1,0
7,326,326,61,61,0,1,0
0,363,363,13,13,0,1,0
15,367,367,55,55,0,1,0
17,372,372,24,24,0,1,0
18,379,379,87,64,23,2,1
23,399,399,19,14,5,2,1
21,455,455,19,16,3,2,1
8,466,466,13,6,7,2,1

12,100,100,8,8,0,1,0
23,105,105,4,4,0,1,0
14,107,107,5,5,0,1,0
18,108,108,11,11,0,1,0
3,115,115,1,1,0,1,0
19,126,126,16,2,14,3,2
9,155,155,13,3,10,2,1
10,160,160,1,1,0,1,0
4,239,239,33,33,0,1,0
7,294,294,7,7,0,1,0
2,312,312,1,1,0,1,0
15,315,315,4,4,0,1,0
21,351,351,3,3,0,1,0
13,357,357,41,28,13,2,1
8,373,373,16,16,0,1,0
6,376,376,33,33,0,1,0
20,387,387,1,1,0,1,0
17,388,388,139,139,0,1,0
0,403,403,3,3,0,1,0
24,436,436,12,8,4,2,1
5,439,439,2,2,0,1,0
1,443,443,35,24,11,2,1
16,448,448,143,92,51,4,3
11,449,449,171,125,46,3,2
22,480,480,55,45,10,2,1

20,112,112,6,6,0,1,0
16,116,116,6,6,0,1,0
3,127,127,30,12,18,2,1
23,131,131,4,4,0,1,0
11,138,138,1,1,0,1,0
24,146,146,7,1,6,3,2
4,171,171,4,4,0,1,0
0,183,183,1,1,0,1,0
19,222,222,25,7,18,3,2
5,248,248,4,4,0,1,0
13,274,274,47,40,7,2,1
7,279,279,9,9,0,1,0
10,279,279,9,9,0,1,0
21,305,305,31,31,0,1,0
6,309,309,16,16,0,1,0
15,314,314,40,13,27,4,3
9,320,320,18,18,0,1,0
8,326,326,3,3,0,1,0
17,340,340,127,77,50,3,2
18,351,351,40,40,0,1,0
2,353,353,105,105,0,1,0
1,403,403,15,1,14,2,1
22,446,446,51,51,0,1,0
12,477,477,41,41,0,1,0
14,489,489,19,19,0,1,0

15,134,134,11,2,9,2,1
7,143,143,1,1,0,1,0
22,145,145,1,1,0,1,0
16,150,150,83,43,40,3,2
9,174,174,4,4,0,1,0
14,184,184,1,1,0,1,0
5,200,200,61,61,0,1,0
8,226,226,1,1,0,1,0
2,249,249,5,2,3,2,1
19,277,277,1,1,0,1,0
13,285,285,13,3,10,3,2
21,317,317,26,26,0,1,0
1,339,339,23,23,0,1,0
18,351,351,30,30,0,1,0
10,360,360,42,3,39,2,1
17,393,393,23,1,22,3,2
0,401,401,75,75,0,1,0
20,417,417,37,27,10,2,1
12,431,431,4,1,3,2,1
23,441,441,68,62,6,2,1
4,445,445,16,16,0,1,0
11,455,455,46,16,30,3,2
6,483,483,49,49,0,1,0
3,500,500,38,16,22,2,1

5,111,111,37,37,0,1,0
18,113,113,24,15,9,4,3
21,147,147,3,3,0,1,0
20,149,149,3,3,0,1,0
10,156,156,3,3,0,1,0
15,157,157,26,26,0,1,0
19,167,167,2,2,0,1,0
16,183,183,35,5,30,4,3
12,199,199,6,6,0,1,0
13,246,246,43,13,30,2,1
4,246,246,1,1,0,1,0
3,248,248,2,2,0,1,0
17,254,254,50,42,8,3,2
6,260,260,11,7,4,2,1
11,336,336,20,20,0,1,0
9,338,338,1,1,0,1,0
14,360,360,38,38,0,1,0
7,363,363,37,33,4,2,1
0,364,364,30,18,12,4,3
2,420,420,107,75,32,3,2
1,447,447,1,1,0,1,0
8,465,465,88,66,22,3,2

6,109,109,10,2,8,2,1
11,158,158,21,21,0,1,0
2,178,178,107,107,0,1,0
14,246,246,23,3,20,2,1
5,249,249,5,5,0,1,0
10,265,265,24,6,18,4,3
9,326,326,72,24,48,4,3
12,334,334,10,6,4,2,1
3,351,351,97,61,36,3,2
13,367,367,104,22,82,4,3
7,407,407,4,4,0,1,0
1,413,413,28,7,21,2,1
4,415,415,4,4,0,1,0
8,442,442,67,67,0,1,0
0,445,445,65,17,48,2,1

23,119,119,9,9,0,1,0
0,184,184,1,1,0,1,0
5,209,209,12,2,10,3,2
20,220,220,45,45,0,1,0
19,277,277,21,11,10,3,2
18,308,308,64,15,49,2,1
8,310,310,4,4,0,1,0
16,357,357,30,21,9,4,3
10,365,365,51,51,0,1,0
9,368,368,20,20,0,1,0
2,388,388,29,24,5,2,1
6,393,393,29,29,0,1,0
7,393,393,187,171,16,2,1
13,402,402,17,17,0,1,0
3,418,418,3,3,0,1,0
1,426,426,27,27,0,1,0
12,426,426,4,4,0,1,0
15,429,429,76,26,50,2,1
21,433,433,5,5,0,1,0
11,453,453,25,4,21,2,1
17,454,454,75,43,32,3,2
22,467,467,54,20,34,2,1
4,474,474,14,14,0,1,0
14,475,475,4,4,0,1,0

12,127,127,2,2,0,1,0
13,152,152,7,7,0,1,0
8,156,156,17,17,0,1,0
10,167,167,68,57,11,2,1
17,186,186,19,19,0,1,0
16,205,205,34,10,24,3,2
7,218,218,25,11,14,2,1
18,223,223,11,11,0,1,0
14,315,315,56,23,33,4,3
6,318,318,49,23,26,3,2
5,339,339,5,5,0,1,0
19,340,340,10,3,7,3,2
3,342,342,41,41,0,1,0
1,350,350,5,5,0,1,0
15,391,391,35,15,20,2,1
9,399,399,24,24,0,1,0
11,416,416,18,18,0,1,0
2,418,418,52,52,0,1,0
0,444,444,66,66,0,1,0
4,498,498,120,31,89,4,3

6,105,105,20,15,5,2,1
19,170,170,6,6,0,1,0
1,177,177,20,20,0,1,0
8,187,187,90,18,72,4,3
5,196,196,13,13,0,1,0
14,206,206,6,6,0,1,0
16,208,208,13,4,9,2,1
17,237,237,47,47,0,1,0
15,290,290,88,56,32,4,3
9,316,316,7,2,5,2,1
12,317,317,17,2,15,4,3
10,370,370,16,6,10,3,2
3,375,375,13,6,7,2,1
18,378,378,29,11,18,2,1
4,383,383,41,41,0,1,0
0,387,387,7,2,5,2,1
11,393,393,9,9,0,1,0
13,433,433,127,52,75,4,3
2,448,448,2,2,0,1,0
7,461,461,30,6,24,2,1

13,114,114,36,12,24,4,3
5,122,122,8,8,0,1,0
14,140,140,37,37,0,1,0
17,173,173,7,1,6,3,2
19,178,178,2,2,0,1,0
21,199,199,3,3,0,1,0
1,228,228,6,6,0,1,0
3,252,252,1,1,0,1,0
15,265,265,31,31,0,1,0
22,275,275,14,14,0,1,0
11,280,280,6,6,0,1,0
23,289,289,103,103,0,1,0
6,304,304,60,51,9,4,3
16,321,321,43,43,0,1,0
20,333,333,30,30,0,1,0
9,342,342,8,4,4,2,1
4,377,377,4,4,0,1,0
7,381,381,10,10,0,1,0
2,413,413,1,1,0,1,0
12,437,437,39,39,0,1,0
0,444,444,39,7,32,3,2
8,452,452,49,22,27,4,3
18,454,454,18,18,0,1,0
10,489,489,63,37,26,3,2

5,100,100,7,7,0,1,0
18,109,109,18,18,0,1,0
2,145,145,16,2,14,3,2
13,161,161,16,2,14,2,1
12,162,162,3,3,0,1,0
19,211,211,19,9,10,2,1
15,220,220,4,4,0,1,0
17,224,224,21,11,10,2,1
16,243,243,17,17,0,1,0
9,274,274,10,6,4,2,1
21,284,284,131,26,105,4,3
23,286,286,4,4,0,1,0
0,292,292,30,30,0,1,0
22,297,297,27,27,0,1,0
14,318,318,1,1,0,1,0
8,334,334,68,58,10,3,2
7,338,338,2,2,0,1,0
11,355,355,20,20,0,1,0
4,432,432,64,36,28,2,1
3,449,449,42,42,0,1,0
10,459,459,42,42,0,1,0
1,478,478,28,28,0,1,0
20,486,486,55,16,39,2,1
6,491,491,4,4,0,1,0

9,118,118,13,13,0,1,0
7,175,175,8,3,5,2,1
23,190,190,35,20,15,4,3
17,204,204,4,4,0,1,0
12,217,217,2,2,0,1,0
14,226,226,10,10,0,1,0
6,262,262,29,29,0,1,0
21,265,265,28,1,27,4,3
26,274,274,13,6,7,2,1
10,278,278,118,19,99,4,3
2,319,319,18,18,0,1,0
11,341,341,29,29,0,1,0
15,353,353,5,5,0,1,0
4,354,354,8,8,0,1,0
25,357,357,109,24,85,4,3
13,385,385,3,3,0,1,0
24,388,388,10,1,9,2,1
5,422,422,11,11,0,1,0
22,423,423,18,8,10,3,2
1,432,432,23,8,15,4,3
0,436,436,11,1,10,3,2
8,447,447,1,1,0,1,0
18,448,448,40,40,0,1,0
19,455,455,75,69,6,3,2
16,467,467,29,11,18,3,2
20,484,484,64,31,33,4,3
3,493,493,1,1,0,1,0

8,110,110,27,12,15,4,3
22,121,121,9,1,8,3,2
0,145,145,1,1,0,1,0
14,158,158,14,14,0,1,0
2,173,173,4,4,0,1,0
21,183,183,12,6,6,3,2
5,195,195,25,25,0,1,0
18,219,219,69,26,43,3,2
17,222,222,36,24,12,4,3
11,225,225,1,1,0,1,0
15,257,257,38,38,0,1,0
9,268,268,8,8,0,1,0
6,277,277,30,3,27,4,3
20,283,283,17,17,0,1,0
3,297,297,34,17,17,2,1
24,298,298,18,18,0,1,0
1,376,376,27,19,8,3,2
13,381,381,2,2,0,1,0
10,383,383,35,35,0,1,0
19,408,408,35,5,30,2,1
25,414,414,79,1,78,3,2
16,424,424,38,3,35,2,1
23,436,436,9,9,0,1,0
4,458,458,4,4,0,1,0
7,477,477,10,4,6,3,2
12,483,483,3,3,0,1,0

21,120,120,6,6,0,1,0
13,131,131,15,10,5,2,1
5,155,155,11,11,0,1,0
17,168,168,14,14,0,1,0
22,183,183,52,9,43,2,1
4,202,202,5,5,0,1,0
10,213,213,38,38,0,1,0
11,223,223,4,1,3,2,1
0,243,243,15,7,8,2,1
18,250,250,38,8,30,3,2
8,253,253,29,29,0,1,0
19,275,275,33,18,15,4,3
2,288,288,33,33,0,1,0
1,293,293,10,10,0,1,0
7,297,297,37,9,28,3,2
16,303,303,5,5,0,1,0
23,329,329,26,26,0,1,0
15,353,353,23,23,0,1,0
12,354,354,21,3,18,2,1
3,389,389,13,13,0,1,0
9,417,417,4,4,0,1,0
14,424,424,103,46,57,3,2
20,441,441,10,10,0,1,0
6,488,488,71,54,17,2,1

5,106,106,3,3,0,1,0
16,131,131,1,1,0,1,0
6,149,149,1,1,0,1,0
4,159,159,5,5,0,1,0
24,167,167,46,46,0,1,0
14,183,183,16,2,14,2,1
19,184,184,42,42,0,1,0
11,190,190,11,11,0,1,0
8,201,201,18,18,0,1,0
18,242,242,3,3,0,1,0
15,260,260,16,13,3,2,1
0,279,279,22,4,18,3,2
17,284,284,58,22,36,3,2
22,284,284,8,8,0,1,0
20,284,284,2,2,0,1,0
1,317,317,66,66,0,1,0
12,325,325,60,27,33,4,3
13,346,346,5,5,0,1,0
23,357,357,6,6,0,1,0
9,384,384,34,34,0,1,0
21,391,391,107,90,17,2,1
7,403,403,49,22,27,2,1
3,429,429,11,11,0,1,0
2,456,456,7,7,0,1,0
10,496,496,31,3,28,4,3

2,129,129,6,6,0,1,0
17,133,133,52,52,0,1,0
5,163,163,52,22,30,2,1
10,212,212,13,13,0,1,0
0,235,235,64,18,46,3,2
7,273,273,28,16,12,3,2
13,274,274,43,43,0,1,0
8,279,279,32,10,22,4,3
9,304,304,14,14,0,1,0
6,321,321,15,15,0,1,0
16,352,352,32,16,16,3,2
15,353,353,21,7,14,3,2
11,371,371,24,24,0,1,0
3,382,382,16,8,8,3,2
1,442,442,67,31,36,3,2
12,452,452,18,18,0,1,0
14,470,470,44,33,11,4,3
4,497,497,60,60,0,1,0

5,117,117,15,9,6,2,1
19,118,118,18,9,9,2,1
15,148,148,4,1,3,2,1
11,172,172,19,11,8,2,1
7,177,177,58,3,55,4,3
4,187,187,12,12,0,1,0
14,204,204,27,5,22,2,1
10,211,211,72,27,45,2,1
0,275,275,41,26,15,2,1
6,294,294,10,10,0,1,0
17,301,301,30,9,21,2,1
16,324,324,23,23,0,1,0
8,345,345,17,5,12,4,3
9,364,364,53,53,0,1,0
13,368,368,2,2,0,1,0
3,411,411,14,10,4,2,1
12,416,416,43,38,5,2,1
2,426,426,44,44,0,1,0
1,490,490,32,32,0,1,0
18,490,490,41,41,0,1,0

19,104,104,5,5,0,1,0
17,123,123,9,5,4,2,1
23,131,131,5,5,0,1,0
6,155,155,5,1,4,2,1
11,196,196,5,5,0,1,0
21,197,197,60,60,0,1,0
20,206,206,4,4,0,1,0
10,232,232,45,45,0,1,0
24,254,254,39,39,0,1,0
1,265,265,20,14,6,2,1
15,287,287,39,34,5,2,1
5,292,292,65,65,0,1,0
22,295,295,38,4,34,3,2
7,308,308,11,11,0,1,0
16,336,336,27,27,0,1,0
8,367,367,48,23,25,2,1
14,376,376,1,1,0,1,0
0,379,379,42,2,40,2,1
9,380,380,2,2,0,1,0
13,380,380,1,1,0,1,0
12,411,411,10,10,0,1,0
18,412,412,59,59,0,1,0
3,444,444,14,6,8,3,2
4,471,471,54,11,43,2,1
2,475,475,44,44,0,1,0

9,114,114,3,3,0,1,0
15,119,119,24,24,0,1,0
4,121,121,3,3,0,1,0
10,134,134,10,10,0,1,0
6,176,176,8,8,0,1,0
11,191,191,3,3,0,1,0
1,197,197,45,45,0,1,0
13,206,206,18,18,0,1,0
8,235,235,107,56,51,4,3
19,249,249,19,6,13,3,2
20,297,297,3,3,0,1,0
2,311,311,9,2,7,2,1
18,330,330,61,23,38,2,1
7,378,378,18,18,0,1,0
5,390,390,22,22,0,1,0
3,397,397,1,1,0,1,0
21,419,419,43,43,0,1,0
16,427,427,18,18,0,1,0
0,447,447,42,42,0,1,0
17,450,450,42,42,0,1,0
12,467,467,111,111,0,1,0
14,493,493,39,39,0,1,0

5,100,100,3,3,0,1,0
2,101,101,15,10,5,2,1
13,110,110,13,13,0,1,0
17,123,123,10,10,0,1,0
3,143,143,30,30,0,1,0
7,179,179,39,36,3,2,1
9,187,187,48,48,0,1,0
1,306,306,19,11,8,3,2
8,319,319,17,17,0,1,0
6,325,325,7,7,0,1,0
11,344,344,100,100,0,1,0
0,374,374,103,49,54,3,2
14,382,382,18,18,0,1,0
12,395,395,20,20,0,1,0
16,395,395,14,6,8,2,1
15,435,435,2,2,0,1,0
10,477,477,85,59,26,2,1
4,486,486,68,36,32,2,1

3,100,100,36,5,31,2,1
5,118,118,21,11,10,3,2
15,170,170,16,9,7,2,1
7,177,177,14,14,0,1,0
12,223,223,16,10,6,2,1
17,274,274,87,35,52,3,2
8,291,291,32,32,0,1,0
11,295,295,51,51,0,1,0
2,308,308,2,2,0,1,0
4,325,325,33,33,0,1,0
0,333,333,27,18,9,4,3
14,334,334,38,1,37,2,1
9,355,355,12,12,0,1,0
10,357,357,48,14,34,4,3
16,395,395,3,3,0,1,0
1,433,433,34,29,5,2,1
6,455,455,98,98,0,1,0
13,468,468,30,30,0,1,0

10,107,107,2,2,0,1,0
4,109,109,1,1,0,1,0
15,111,111,20,4,16,3,2
13,120,120,5,5,0,1,0
5,128,128,8,8,0,1,0
7,130,130,1,1,0,1,0
19,138,138,6,6,0,1,0
9,167,167,11,11,0,1,0
2,233,233,54,10,44,4,3
16,240,240,32,1,31,2,1
11,243,243,51,51,0,1,0
17,260,260,25,25,0,1,0
3,299,299,48,48,0,1,0
18,324,324,12,8,4,2,1
6,351,351,19,19,0,1,0
1,364,364,88,36,52,3,2
14,368,368,149,118,31,2,1
20,400,400,62,19,43,2,1
0,410,410,6,6,0,1,0
21,437,437,8,8,0,1,0
12,438,438,8,8,0,1,0
8,460,460,12,12,0,1,0

8,102,102,1,1,0,1,0
14,111,111,5,5,0,1,0
10,151,151,4,4,0,1,0
7,181,181,22,17,5,2,1
4,247,247,44,44,0,1,0
17,280,280,29,29,0,1,0
5,317,317,8,8,0,1,0
16,341,341,11,11,0,1,0
9,363,363,36,36,0,1,0
0,374,374,34,14,20,2,1
12,378,378,28,3,25,4,3
1,391,391,20,4,16,3,2
18,399,399,33,33,0,1,0
2,412,412,86,86,0,1,0
19,413,413,21,21,0,1,0
11,420,420,56,38,18,4,3
6,435,435,78,56,22,3,2
13,441,441,160,36,124,4,3
3,446,446,61,61,0,1,0
15,476,476,99,42,57,4,3

6,129,129,10,4,6,2,1
17,158,158,18,5,13,2,1
11,175,175,12,12,0,1,0
21,178,178,10,10,0,1,0
15,179,179,21,21,0,1,0
0,181,181,6,3,3,2,1
23,207,207,13,5,8,2,1
4,234,234,41,41,0,1,0
19,269,269,117,93,24,4,3
22,301,301,7,7,0,1,0
10,321,321,24,11,13,4,3
1,326,326,5,5,0,1,0
2,329,329,15,15,0,1,0
9,331,331,68,35,33,2,1
14,371,371,17,9,8,2,1
18,387,387,47,47,0,1,0
12,391,391,18,18,0,1,0
13,424,424,40,28,12,4,3
16,444,444,61,61,0,1,0
3,459,459,47,26,21,4,3
20,482,482,3,3,0,1,0
8,487,487,34,34,0,1,0
5,496,496,38,38,0,1,0
7,499,499,8,2,6,3,2

8,108,108,17,17,0,1,0
17,154,154,1,1,0,1,0
15,220,220,56,2,54,4,3
5,265,265,14,14,0,1,0
1,267,267,21,12,9,2,1
14,276,276,16,16,0,1,0
3,305,305,88,10,78,3,2
4,308,308,38,38,0,1,0
0,326,326,62,62,0,1,0
10,327,327,70,31,39,4,3
12,375,375,60,39,21,2,1
2,405,405,30,30,0,1,0
9,435,435,22,13,9,2,1
16,437,437,20,20,0,1,0
11,457,457,30,30,0,1,0
7,464,464,10,10,0,1,0
6,465,465,56,31,25,2,1
18,471,471,106,11,95,4,3
13,488,488,18,18,0,1,0

21,109,109,14,14,0,1,0
3,115,115,15,3,12,4,3
11,116,116,1,1,0,1,0
1,129,129,5,5,0,1,0
2,157,157,5,5,0,1,0
17,164,164,1,1,0,1,0
6,202,202,6,1,5,2,1
19,215,215,42,1,41,2,1
22,232,232,33,23,10,3,2
20,235,235,1,1,0,1,0
0,239,239,1,1,0,1,0
10,260,260,15,15,0,1,0
15,317,317,28,2,26,4,3
14,319,319,11,5,6,2,1
7,331,331,89,41,48,2,1
18,337,337,122,79,43,2,1
12,380,380,63,63,0,1,0
5,410,410,60,60,0,1,0
9,424,424,4,4,0,1,0
8,435,435,1,1,0,1,0
4,435,435,75,36,39,4,3
16,454,454,1,1,0,1,0
23,467,467,72,72,0,1,0
13,473,473,16,16,0,1,0

16,102,102,12,4,8,3,2
21,126,126,11,3,8,2,1
2,142,142,8,2,6,3,2
0,178,178,39,39,0,1,0
11,203,203,3,3,0,1,0
9,218,218,2,2,0,1,0
23,246,246,9,9,0,1,0
8,247,247,1,1,0,1,0
18,275,275,1,1,0,1,0
5,288,288,23,23,0,1,0
13,289,289,11,11,0,1,0
14,293,293,26,26,0,1,0
27,296,296,10,6,4,2,1
12,327,327,41,5,36,3,2
20,331,331,40,40,0,1,0
4,343,343,4,4,0,1,0
3,344,344,31,3,28,3,2
22,349,349,18,18,0,1,0
24,401,401,26,14,12,2,1
25,412,412,14,11,3,2,1
6,424,424,66,19,47,3,2
7,434,434,3,3,0,1,0
1,436,436,2,2,0,1,0
10,441,441,16,1,15,2,1
26,442,442,151,105,46,2,1
17,451,451,3,3,0,1,0
15,483,483,17,7,10,2,1
19,497,497,168,144,24,4,3

19,100,100,5,5,0,1,0
9,107,107,12,12,0,1,0
4,151,151,1,1,0,1,0
2,160,160,3,3,0,1,0
12,170,170,2,2,0,1,0
18,201,201,45,41,4,2,1
3,213,213,4,4,0,1,0
13,236,236,27,17,10,3,2
0,244,244,40,8,32,2,1
6,266,266,72,72,0,1,0
7,320,320,66,22,44,2,1
5,330,330,11,3,8,3,2
14,339,339,19,19,0,1,0
8,370,370,80,80,0,1,0
15,413,413,9,9,0,1,0
16,425,425,27,16,11,2,1
10,454,454,35,28,7,2,1
1,466,466,26,16,10,3,2
11,467,467,7,7,0,1,0
17,495,495,240,240,0,1,0

0,100,100,34,3,31,2,1
18,116,116,7,7,0,1,0
7,119,119,14,4,10,3,2
11,124,124,8,8,0,1,0
19,133,133,14,14,0,1,0
16,160,160,7,4,3,2,1
10,163,163,31,31,0,1,0
9,167,167,18,18,0,1,0
17,186,186,9,9,0,1,0
4,215,215,1,1,0,1,0
15,227,227,15,10,5,2,1
8,258,258,7,7,0,1,0
12,292,292,82,57,25,3,2
6,293,293,12,12,0,1,0
1,296,296,14,14,0,1,0
2,364,364,43,18,25,2,1
14,403,403,83,83,0,1,0
3,425,425,79,16,63,4,3
5,441,441,50,50,0,1,0
13,458,458,30,30,0,1,0

17,128,128,4,4,0,1,0
16,132,132,11,2,9,2,1
10,143,143,6,6,0,1,0
4,168,168,15,15,0,1,0
23,175,175,11,11,0,1,0
7,209,209,42,29,13,2,1
5,211,211,6,6,0,1,0
11,218,218,1,1,0,1,0
0,239,239,7,3,4,2,1
9,243,243,6,6,0,1,0
24,248,248,46,46,0,1,0
1,260,260,12,2,10,2,1
3,261,261,2,2,0,1,0
20,264,264,45,27,18,3,2
2,290,290,31,13,18,2,1
13,306,306,37,37,0,1,0
18,319,319,57,29,28,2,1
15,350,350,85,85,0,1,0
25,377,377,23,11,12,2,1
6,377,377,9,1,8,3,2
19,389,389,17,17,0,1,0
14,405,405,18,18,0,1,0
12,411,411,1,1,0,1,0
21,412,412,20,10,10,2,1
8,418,418,36,5,31,2,1
22,470,470,121,121,0,1,0

8,119,119,21,21,0,1,0
6,134,134,1,1,0,1,0
1,167,167,28,28,0,1,0
18,196,196,7,1,6,2,1
12,211,211,29,9,20,3,2
11,215,215,34,34,0,1,0
14,223,223,5,5,0,1,0
13,237,237,37,37,0,1,0
4,269,269,74,50,24,4,3
5,276,276,42,21,21,2,1
15,285,285,17,17,0,1,0
3,292,292,59,59,0,1,0
16,302,302,32,32,0,1,0
10,311,311,54,26,28,2,1
17,320,320,36,5,31,4,3
2,342,342,8,8,0,1,0
0,372,372,27,12,15,2,1
7,476,476,14,14,0,1,0
9,492,492,76,76,0,1,0

10,101,101,1,1,0,1,0
15,108,108,1,1,0,1,0
17,111,111,37,37,0,1,0
1,119,119,31,7,24,3,2
12,140,140,15,15,0,1,0
5,159,159,18,18,0,1,0
8,165,165,40,15,25,2,1
23,179,179,4,4,0,1,0
3,182,182,11,11,0,1,0
6,211,211,3,3,0,1,0
0,231,231,29,2,27,4,3
22,237,237,14,9,5,2,1
18,239,239,74,74,0,1,0
11,247,247,5,5,0,1,0
16,315,315,24,15,9,2,1
20,342,342,11,2,9,2,1
21,352,352,19,3,16,3,2
7,358,358,2,2,0,1,0
4,391,391,13,4,9,2,1
13,396,396,21,9,12,3,2
9,406,406,2,2,0,1,0
19,415,415,64,54,10,2,1
24,440,440,30,11,19,2,1
14,463,463,21,21,0,1,0
2,487,487,3,3,0,1,0

1,101,101,8,8,0,1,0
12,126,126,8,8,0,1,0
7,152,152,22,7,15,2,1
6,173,173,77,49,28,2,1
2,223,223,24,24,0,1,0
15,234,234,36,29,7,2,1
20,277,277,13,13,0,1,0
0,281,281,11,11,0,1,0
11,289,289,5,5,0,1,0
18,298,298,44,15,29,2,1
9,300,300,14,14,0,1,0
10,301,301,24,16,8,3,2
17,313,313,62,62,0,1,0
3,317,317,21,21,0,1,0
16,323,323,43,43,0,1,0
8,362,362,11,11,0,1,0
14,372,372,7,7,0,1,0
5,388,388,9,9,0,1,0
19,416,416,99,81,18,4,3
13,453,453,43,22,21,4,3
4,483,483,19,19,0,1,0

13,104,104,3,3,0,1,0
1,107,107,9,6,3,2,1
21,107,107,32,2,30,2,1
11,109,109,1,1,0,1,0
12,127,127,3,3,0,1,0
0,135,135,5,5,0,1,0
22,136,136,19,4,15,2,1
5,156,156,13,5,8,2,1
20,167,167,25,25,0,1,0
9,261,261,5,2,3,2,1
4,285,285,21,7,14,3,2
7,292,292,19,6,13,2,1
23,325,325,21,6,15,4,3
15,343,343,17,17,0,1,0
2,362,362,38,29,9,2,1
14,365,365,69,69,0,1,0
6,374,374,37,37,0,1,0
17,388,388,41,41,0,1,0
8,394,394,64,64,0,1,0
18,404,404,16,7,9,4,3
19,445,445,39,39,0,1,0
10,447,447,22,13,9,2,1
3,450,450,121,106,15,2,1
16,457,457,1,1,0,1,0

4,107,107,8,1,7,2,1
7,119,119,12,12,0,1,0
16,125,125,37,37,0,1,0
2,137,137,3,3,0,1,0
10,193,193,5,5,0,1,0
9,201,201,20,20,0,1,0
21,223,223,46,46,0,1,0
18,243,243,13,13,0,1,0
3,250,250,16,16,0,1,0
23,254,254,58,27,31,2,1
8,270,270,1,1,0,1,0
19,279,279,4,4,0,1,0
12,326,326,58,58,0,1,0
5,326,326,8,8,0,1,0
14,335,335,19,14,5,2,1
20,351,351,57,57,0,1,0
0,352,352,28,9,19,2,1
13,354,354,79,79,0,1,0
15,355,355,6,6,0,1,0
1,382,382,4,4,0,1,0
11,417,417,61,19,42,3,2
6,431,431,21,15,6,2,1
17,488,488,27,27,0,1,0
22,488,488,11,11,0,1,0

0,114,114,5,5,0,1,0
5,119,119,17,17,0,1,0
17,124,124,4,4,0,1,0
22,149,149,15,3,12,4,3
6,150,150,1,1,0,1,0
10,159,159,6,1,5,2,1
15,163,163,19,8,11,2,1
21,192,192,4,4,0,1,0
23,201,201,5,5,0,1,0
3,202,202,10,10,0,1,0
9,243,243,2,2,0,1,0
7,249,249,8,8,0,1,0
4,268,268,1,1,0,1,0
24,287,287,8,8,0,1,0
1,300,300,90,13,77,4,3
25,350,350,65,17,48,4,3
13,385,385,1,1,0,1,0
16,403,403,15,15,0,1,0
14,418,418,1,1,0,1,0
20,427,427,51,25,26,4,3
18,428,428,103,46,57,4,3
12,428,428,6,6,0,1,0
8,436,436,75,36,39,2,1
11,445,445,22,22,0,1,0
2,449,449,55,55,0,1,0
19,483,483,160,114,46,2,1

13,122,122,1,1,0,1,0
6,150,150,2,2,0,1,0
11,160,160,38,38,0,1,0
17,163,163,6,6,0,1,0
19,165,165,52,52,0,1,0
5,193,193,1,1,0,1,0
2,210,210,12,12,0,1,0
8,218,218,16,16,0,1,0
14,226,226,2,2,0,1,0
16,284,284,28,9,19,4,3
9,301,301,4,4,0,1,0
4,307,307,29,11,18,2,1
1,311,311,72,72,0,1,0
15,315,315,48,18,30,4,3
18,345,345,31,22,9,4,3
12,356,356,39,35,4,2,1
7,378,378,44,44,0,1,0
20,383,383,83,56,27,3,2
21,409,409,38,8,30,2,1
0,423,423,45,45,0,1,0
3,478,478,66,12,54,4,3
10,495,495,9,9,0,1,0

15,114,114,9,3,6,2,1
10,127,127,14,1,13,2,1
1,132,132,16,16,0,1,0
16,182,182,11,11,0,1,0
7,292,292,8,8,0,1,0
13,315,315,44,40,4,2,1
11,325,325,82,64,18,4,3
3,353,353,108,108,0,1,0
2,358,358,39,39,0,1,0
5,381,381,5,5,0,1,0
9,387,387,51,12,39,4,3
8,397,397,23,23,0,1,0
4,406,406,10,10,0,1,0
6,409,409,131,89,42,4,3
14,410,410,5,2,3,2,1
18,439,439,34,1,33,4,3
0,455,455,55,33,22,2,1
12,480,480,84,69,15,2,1
17,500,500,38,7,31,2,1

3,118,118,3,3,0,1,0
25,128,128,5,5,0,1,0
28,144,144,12,12,0,1,0
11,186,186,6,6,0,1,0
7,197,197,14,14,0,1,0
8,212,212,26,26,0,1,0
26,219,219,4,4,0,1,0
27,236,236,12,9,3,2,1
21,245,245,10,10,0,1,0
15,274,274,12,4,8,2,1
10,280,280,36,6,30,4,3
2,292,292,33,33,0,1,0
22,292,292,32,27,5,2,1
16,301,301,6,6,0,1,0
5,306,306,2,2,0,1,0
23,309,309,128,50,78,3,2
13,313,313,27,1,26,2,1
9,318,318,52,52,0,1,0
14,337,337,4,1,3,2,1
18,359,359,11,11,0,1,0
19,362,362,75,50,25,2,1
17,362,362,8,8,0,1,0
24,377,377,42,42,0,1,0
6,396,396,32,25,7,2,1
1,421,421,28,28,0,1,0
12,439,439,6,2,4,2,1
20,473,473,20,20,0,1,0
4,485,485,30,30,0,1,0
0,490,490,1,1,0,1,0

