5,131,131,30,3,27,4,3
0,173,173,32,18,14,3,2
4,175,175,8,2,6,2,1
1,249,249,23,17,6,3,2
3,260,260,9,9,0,1,0
2,464,464,11,3,8,2,1

1,199,199,20,20,0,1,0
0,229,229,4,4,0,1,0
2,306,306,3,3,0,1,0
6,326,326,62,17,45,4,3
3,329,329,21,3,18,3,2
4,337,337,8,8,0,1,0
8,364,364,24,24,0,1,0
5,421,421,36,36,0,1,0
7,500,500,24,11,13,2,1

0,127,127,12,12,0,1,0
5,155,155,15,15,0,1,0
3,166,166,3,3,0,1,0
2,192,192,12,3,9,3,2
1,314,314,45,45,0,1,0
4,423,423,79,79,0,1,0

6,105,105,13,13,0,1,0
3,166,166,9,9,0,1,0
5,172,172,10,3,7,2,1
0,347,347,65,7,58,3,2
4,352,352,1,1,0,1,0
7,360,360,44,16,28,2,1
2,405,405,21,13,8,2,1
1,430,430,2,2,0,1,0

0,145,145,10,10,0,1,0
4,252,252,20,20,0,1,0
2,276,276,31,1,30,4,3
8,282,282,37,6,31,2,1
1,351,351,11,1,10,3,2
6,352,352,7,3,4,2,1
7,407,407,63,15,48,4,3
3,422,422,2,2,0,1,0
5,476,476,2,2,0,1,0

3,121,121,5,2,3,2,1
1,129,129,22,22,0,1,0
2,170,170,7,3,4,2,1
0,292,292,5,1,4,2,1
4,322,322,10,10,0,1,0
6,367,367,27,27,0,1,0
7,402,402,45,12,33,2,1
5,470,470,56,56,0,1,0

3,164,164,34,34,0,1,0
4,180,180,14,5,9,2,1
5,211,211,5,1,4,2,1
2,234,234,56,36,20,3,2
0,255,255,6,6,0,1,0
1,357,357,14,14,0,1,0

1,111,111,1,1,0,1,0
6,222,222,29,11,18,2,1
5,294,294,1,1,0,1,0
4,300,300,52,52,0,1,0
2,339,339,73,3,70,3,2
3,340,340,10,10,0,1,0
0,450,450,21,21,0,1,0

3,144,144,12,12,0,1,0
1,221,221,43,24,19,2,1
2,368,368,11,11,0,1,0
0,411,411,124,124,0,1,0

2,108,108,1,1,0,1,0
0,134,134,6,1,5,2,1
6,154,154,39,21,18,4,3
5,168,168,5,5,0,1,0
4,231,231,28,28,0,1,0
1,236,236,11,5,6,3,2
3,295,295,24,2,22,3,2
7,449,449,10,2,8,3,2

5,128,128,1,1,0,1,0
3,192,192,1,1,0,1,0
1,203,203,39,39,0,1,0
4,252,252,12,12,0,1,0
6,308,308,79,40,39,2,1
0,442,442,28,28,0,1,0
2,467,467,20,20,0,1,0

4,159,159,1,1,0,1,0
5,169,169,24,24,0,1,0
3,172,172,7,7,0,1,0
6,186,186,29,29,0,1,0
1,360,360,7,3,4,2,1
0,378,378,72,61,11,2,1
2,419,419,21,5,16,3,2

0,165,165,10,10,0,1,0
3,206,206,41,19,22,3,2
4,297,297,19,2,17,2,1
1,403,403,97,64,33,4,3
2,426,426,18,18,0,1,0

0,159,159,16,16,0,1,0
3,190,190,17,17,0,1,0
4,289,289,49,1,48,3,2
2,324,324,5,5,0,1,0
5,378,378,18,8,10,3,2
1,439,439,81,11,70,4,3

6,151,151,11,3,8,3,2
7,169,169,8,8,0,1,0
4,206,206,4,4,0,1,0
3,210,210,9,9,0,1,0
0,263,263,20,6,14,3,2
1,317,317,14,14,0,1,0
5,357,357,68,68,0,1,0
2,469,469,56,56,0,1,0

10,108,108,24,24,0,1,0
2,189,189,9,2,7,2,1
4,209,209,12,6,6,2,1
1,233,233,3,3,0,1,0
3,285,285,19,4,15,2,1
8,314,314,20,20,0,1,0
9,346,346,6,6,0,1,0
6,356,356,16,6,10,2,1
5,396,396,6,6,0,1,0
7,450,450,7,1,6,3,2
0,465,465,19,19,0,1,0

1,112,112,6,6,0,1,0
5,143,143,7,7,0,1,0
7,163,163,24,12,12,2,1
0,190,190,8,8,0,1,0
2,209,209,1,1,0,1,0
4,221,221,5,1,4,2,1
3,451,451,80,26,54,4,3
6,452,452,49,11,38,3,2

2,204,204,24,7,17,2,1
0,220,220,40,40,0,1,0
3,393,393,69,31,38,3,2
4,437,437,12,6,6,2,1
5,462,462,47,41,6,3,2
1,472,472,1,1,0,1,0

4,154,154,12,3,9,4,3
8,199,199,38,38,0,1,0
7,226,226,14,14,0,1,0
6,358,358,20,4,16,2,1
3,375,375,31,1,30,2,1
1,406,406,10,5,5,2,1
0,420,420,31,31,0,1,0
5,433,433,17,17,0,1,0
2,496,496,1,1,0,1,0

5,158,158,5,5,0,1,0
7,204,204,11,2,9,2,1
3,237,237,4,1,3,2,1
0,262,262,27,6,21,2,1
1,292,292,10,10,0,1,0
8,328,328,34,20,14,3,2
2,337,337,1,1,0,1,0
6,355,355,2,2,0,1,0
9,369,369,54,54,0,1,0
4,381,381,41,41,0,1,0

4,310,310,46,46,0,1,0
2,344,344,24,24,0,1,0
3,378,378,50,50,0,1,0
1,397,397,80,80,0,1,0
0,436,436,13,13,0,1,0
5,451,451,10,10,0,1,0

7,163,163,9,2,7,2,1
2,171,171,1,1,0,1,0
3,298,298,28,28,0,1,0
1,335,335,2,2,0,1,0
4,382,382,21,17,4,2,1
0,430,430,60,32,28,3,2
5,430,430,95,1,94,3,2
6,462,462,13,13,0,1,0

0,144,144,10,4,6,3,2
6,147,147,4,4,0,1,0
1,173,173,3,3,0,1,0
2,258,258,27,27,0,1,0
4,261,261,52,28,24,4,3
3,266,266,29,21,8,2,1
5,476,476,38,8,30,3,2

2,118,118,14,5,9,4,3
3,194,194,19,8,11,2,1
1,205,205,3,3,0,1,0
4,296,296,21,7,14,2,1
5,301,301,1,1,0,1,0
0,443,443,31,31,0,1,0
6,483,483,112,112,0,1,0

5,105,105,13,2,11,4,3
2,116,116,9,9,0,1,0
3,135,135,7,1,6,3,2
7,148,148,2,2,0,1,0
0,325,325,3,3,0,1,0
4,356,356,3,3,0,1,0
1,363,363,12,12,0,1,0
8,371,371,90,90,0,1,0
6,462,462,24,24,0,1,0

3,139,139,21,16,5,2,1
5,194,194,20,1,19,2,1
7,207,207,22,6,16,3,2
1,241,241,4,1,3,2,1
0,326,326,10,2,8,2,1
2,349,349,28,16,12,4,3
4,408,408,9,3,6,2,1
6,500,500,48,3,45,4,3

2,167,167,2,2,0,1,0
0,210,210,53,42,11,2,1
1,230,230,11,6,5,2,1
4,250,250,54,14,40,3,2
3,267,267,20,5,15,2,1

0,128,128,3,3,0,1,0
6,271,271,60,11,49,2,1
2,278,278,32,32,0,1,0
4,339,339,53,53,0,1,0
1,367,367,1,1,0,1,0
7,384,384,1,1,0,1,0
3,392,392,1,1,0,1,0
5,398,398,32,12,20,3,2

3,150,150,15,9,6,2,1
1,174,174,48,39,9,2,1
2,364,364,35,29,6,3,2
4,463,463,52,52,0,1,0
0,473,473,14,10,4,2,1

1,118,118,27,27,0,1,0
0,264,264,80,80,0,1,0
2,319,319,5,1,4,2,1
3,459,459,30,30,0,1,0

1,111,111,5,5,0,1,0
5,143,143,17,17,0,1,0
4,163,163,12,4,8,3,2
3,274,274,32,32,0,1,0
2,314,314,58,58,0,1,0
0,486,486,35,27,8,3,2

2,111,111,1,1,0,1,0
6,237,237,38,38,0,1,0
7,309,309,17,17,0,1,0
0,322,322,1,1,0,1,0
3,357,357,22,13,9,4,3
1,374,374,40,40,0,1,0
4,389,389,34,19,15,2,1
8,394,394,35,35,0,1,0
5,446,446,15,10,5,2,1

5,124,124,12,12,0,1,0
6,141,141,22,22,0,1,0
1,162,162,4,4,0,1,0
3,178,178,1,1,0,1,0
7,228,228,14,3,11,4,3
2,264,264,18,9,9,4,3
0,363,363,23,11,12,4,3
4,442,442,62,62,0,1,0

1,109,109,2,2,0,1,0
2,130,130,16,16,0,1,0
0,134,134,7,2,5,2,1
3,137,137,15,5,10,2,1
5,236,236,33,33,0,1,0
4,346,346,49,49,0,1,0
6,471,471,10,10,0,1,0

7,208,208,25,9,16,2,1
2,233,233,15,15,0,1,0
3,244,244,1,1,0,1,0
0,274,274,6,6,0,1,0
1,274,274,7,7,0,1,0
5,292,292,53,53,0,1,0
4,336,336,62,42,20,2,1
6,496,496,2,2,0,1,0

3,189,189,9,9,0,1,0
5,207,207,2,2,0,1,0
2,274,274,11,11,0,1,0
1,303,303,19,5,14,2,1
6,330,330,10,4,6,3,2
4,353,353,93,42,51,4,3
0,407,407,62,20,42,2,1

2,245,245,35,35,0,1,0
3,248,248,7,7,0,1,0
0,324,324,17,17,0,1,0
5,344,344,9,9,0,1,0
4,351,351,89,89,0,1,0
1,365,365,39,39,0,1,0

0,101,101,10,10,0,1,0
3,214,214,4,4,0,1,0
1,217,217,1,1,0,1,0
2,314,314,9,4,5,2,1
8,359,359,39,5,34,3,2
6,389,389,2,2,0,1,0
4,451,451,1,1,0,1,0
9,451,451,26,26,0,1,0
5,469,469,67,67,0,1,0
7,490,490,67,17,50,3,2

4,139,139,19,10,9,4,3
3,267,267,11,11,0,1,0
2,330,330,26,26,0,1,0
5,426,426,56,56,0,1,0
0,435,435,32,32,0,1,0
1,455,455,68,53,15,4,3

3,136,136,5,5,0,1,0
10,179,179,31,31,0,1,0
2,238,238,4,4,0,1,0
4,270,270,7,7,0,1,0
0,272,272,8,2,6,2,1
6,278,278,9,9,0,1,0
8,295,295,1,1,0,1,0
9,299,299,20,16,4,2,1
7,300,300,21,14,7,2,1
5,342,342,13,1,12,4,3
11,373,373,24,24,0,1,0
1,409,409,20,20,0,1,0

4,149,149,17,11,6,2,1
0,253,253,29,29,0,1,0
1,357,357,57,33,24,2,1
2,372,372,10,7,3,2,1
3,425,425,26,26,0,1,0
5,430,430,56,50,6,2,1

5,114,114,21,1,20,2,1
3,189,189,6,6,0,1,0
0,211,211,26,26,0,1,0
1,295,295,4,4,0,1,0
6,332,332,15,15,0,1,0
2,334,334,44,44,0,1,0
4,396,396,31,22,9,2,1

3,152,152,2,2,0,1,0
2,162,162,24,2,22,3,2
1,204,204,4,1,3,2,1
6,300,300,2,2,0,1,0
4,310,310,5,5,0,1,0
0,314,314,28,28,0,1,0
5,350,350,5,5,0,1,0
7,420,420,85,10,75,4,3
8,475,475,45,35,10,3,2

6,148,148,27,16,11,2,1
3,156,156,9,9,0,1,0
8,221,221,20,20,0,1,0
5,277,277,4,4,0,1,0
1,309,309,1,1,0,1,0
2,342,342,44,23,21,4,3
4,373,373,36,11,25,2,1
7,398,398,14,14,0,1,0
0,485,485,1,1,0,1,0

5,120,120,30,4,26,2,1
1,186,186,15,15,0,1,0
4,188,188,9,9,0,1,0
3,320,320,19,19,0,1,0
0,359,359,6,3,3,2,1
2,433,433,63,63,0,1,0
6,495,495,6,6,0,1,0

3,109,109,4,4,0,1,0
1,169,169,7,7,0,1,0
6,210,210,23,5,18,3,2
5,215,215,32,32,0,1,0
4,255,255,8,8,0,1,0
0,371,371,70,22,48,3,2
2,409,409,1,1,0,1,0
7,473,473,22,22,0,1,0

1,105,105,14,14,0,1,0
0,419,419,72,12,60,3,2
2,442,442,21,21,0,1,0
4,486,486,28,28,0,1,0
3,498,498,99,94,5,2,1

2,133,133,1,1,0,1,0
6,171,171,2,2,0,1,0
7,181,181,3,3,0,1,0
8,181,181,47,39,8,3,2
9,199,199,7,1,6,3,2
4,201,201,3,3,0,1,0
0,255,255,6,6,0,1,0
3,318,318,36,12,24,4,3
5,345,345,8,3,5,2,1
1,363,363,40,40,0,1,0

2,144,144,28,12,16,2,1
3,277,277,13,13,0,1,0
0,329,329,13,13,0,1,0
1,375,375,27,27,0,1,0
5,435,435,61,29,32,2,1
4,456,456,53,53,0,1,0

4,207,207,16,4,12,4,3
3,314,314,19,4,15,4,3
2,327,327,13,13,0,1,0
5,383,383,40,19,21,4,3
6,438,438,54,54,0,1,0
0,463,463,66,66,0,1,0
1,496,496,29,29,0,1,0

3,101,101,4,4,0,1,0
7,136,136,10,2,8,3,2
6,169,169,26,22,4,2,1
0,175,175,7,3,4,2,1
4,190,190,10,1,9,2,1
1,257,257,32,32,0,1,0
5,333,333,27,10,17,2,1
2,362,362,17,8,9,4,3

6,122,122,10,10,0,1,0
1,124,124,9,9,0,1,0
2,128,128,10,10,0,1,0
7,202,202,6,6,0,1,0
3,318,318,18,18,0,1,0
0,336,336,1,1,0,1,0
5,416,416,82,2,80,3,2
4,495,495,45,3,42,3,2

5,104,104,11,11,0,1,0
1,135,135,6,6,0,1,0
6,168,168,33,33,0,1,0
0,303,303,15,12,3,2,1
3,317,317,15,3,12,3,2
4,324,324,1,1,0,1,0
8,372,372,16,16,0,1,0
2,395,395,22,4,18,3,2
7,436,436,28,28,0,1,0

0,117,117,2,2,0,1,0
2,120,120,16,5,11,2,1
4,274,274,35,28,7,2,1
1,401,401,114,9,105,4,3
3,425,425,21,15,6,3,2

3,185,185,12,1,11,2,1
4,206,206,13,3,10,2,1
1,298,298,63,63,0,1,0
0,425,425,39,27,12,2,1
2,425,425,76,76,0,1,0

3,103,103,4,4,0,1,0
4,128,128,29,29,0,1,0
1,226,226,29,19,10,2,1
2,241,241,24,24,0,1,0
0,310,310,23,23,0,1,0
5,470,470,22,22,0,1,0

1,125,125,2,2,0,1,0
4,159,159,3,3,0,1,0
3,254,254,15,15,0,1,0
0,487,487,140,95,45,2,1
2,500,500,113,57,56,3,2

3,100,100,9,6,3,2,1
10,117,117,6,6,0,1,0
2,120,120,1,1,0,1,0
8,148,148,1,1,0,1,0
0,268,268,18,18,0,1,0
6,305,305,2,2,0,1,0
5,321,321,1,1,0,1,0
1,425,425,2,2,0,1,0
7,428,428,19,7,12,3,2
9,480,480,118,19,99,4,3
4,496,496,38,3,35,3,2

0,123,123,1,1,0,1,0
1,150,150,1,1,0,1,0
6,208,208,31,3,28,3,2
2,332,332,20,20,0,1,0
4,332,332,22,22,0,1,0
7,385,385,14,2,12,2,1
3,434,434,60,60,0,1,0
8,462,462,56,48,8,2,1
5,500,500,11,1,10,2,1

6,128,128,24,24,0,1,0
5,130,130,14,4,10,3,2
0,180,180,6,6,0,1,0
2,233,233,9,1,8,2,1
4,287,287,22,1,21,4,3
7,290,290,3,3,0,1,0
3,357,357,44,5,39,4,3
1,472,472,14,14,0,1,0

2,109,109,4,4,0,1,0
0,173,173,1,1,0,1,0
3,319,319,1,1,0,1,0
5,352,352,88,60,28,3,2
7,357,357,11,2,9,2,1
1,385,385,79,72,7,2,1
6,408,408,10,10,0,1,0
4,447,447,22,22,0,1,0

7,148,148,26,10,16,3,2
3,179,179,4,1,3,2,1
1,224,224,1,1,0,1,0
2,256,256,11,7,4,2,1
4,288,288,35,35,0,1,0
6,367,367,12,12,0,1,0
0,376,376,42,6,36,4,3
5,500,500,47,47,0,1,0

0,130,130,14,1,13,2,1
5,130,130,5,5,0,1,0
1,150,150,19,19,0,1,0
4,165,165,12,12,0,1,0
2,286,286,19,4,15,4,3
3,330,330,66,51,15,2,1

0,126,126,2,2,0,1,0
1,131,131,28,12,16,3,2
2,161,161,1,1,0,1,0
5,175,175,25,25,0,1,0
4,212,212,19,19,0,1,0
3,340,340,22,22,0,1,0
6,361,361,27,10,17,2,1

2,100,100,3,3,0,1,0
0,158,158,8,8,0,1,0
4,424,424,53,27,26,2,1
1,451,451,99,7,92,3,2
3,476,476,44,8,36,3,2
5,482,482,41,41,0,1,0

1,101,101,13,13,0,1,0
4,210,210,42,9,33,4,3
0,264,264,35,17,18,2,1
2,449,449,18,12,6,3,2
5,471,471,11,11,0,1,0
3,500,500,39,18,21,4,3

1,119,119,14,10,4,2,1
0,161,161,4,4,0,1,0
5,174,174,8,8,0,1,0
6,221,221,2,2,0,1,0
2,443,443,17,14,3,2,1
4,492,492,124,13,111,4,3
3,499,499,60,60,0,1,0

5,105,105,18,18,0,1,0
1,118,118,1,1,0,1,0
2,165,165,8,1,7,2,1
6,240,240,4,4,0,1,0
3,263,263,64,64,0,1,0
0,288,288,1,1,0,1,0
4,339,339,41,11,30,2,1

9,122,122,29,2,27,2,1
7,124,124,9,3,6,2,1
2,139,139,1,1,0,1,0
3,140,140,14,14,0,1,0
4,147,147,14,8,6,3,2
5,211,211,10,10,0,1,0
8,224,224,1,1,0,1,0
6,272,272,3,3,0,1,0
1,317,317,12,12,0,1,0
0,402,402,1,1,0,1,0

3,176,176,1,1,0,1,0
5,195,195,1,1,0,1,0
1,240,240,3,3,0,1,0
7,271,271,5,5,0,1,0
2,309,309,42,27,15,4,3
0,405,405,5,5,0,1,0
4,426,426,46,46,0,1,0
6,450,450,10,10,0,1,0
8,456,456,78,78,0,1,0
9,479,479,55,4,51,3,2

1,127,127,4,4,0,1,0
2,236,236,51,33,18,4,3
3,262,262,8,8,0,1,0
0,397,397,107,17,90,4,3
4,471,471,28,2,26,3,2

5,129,129,1,1,0,1,0
7,165,165,4,4,0,1,0
10,169,169,21,21,0,1,0
3,183,183,16,5,11,2,1
1,195,195,2,2,0,1,0
2,217,217,2,2,0,1,0
6,242,242,20,20,0,1,0
0,377,377,16,16,0,1,0
9,392,392,16,16,0,1,0
4,424,424,17,6,11,2,1
8,454,454,63,63,0,1,0

4,103,103,5,5,0,1,0
0,146,146,9,9,0,1,0
1,244,244,14,3,11,2,1
6,259,259,37,25,12,2,1
2,443,443,65,65,0,1,0
5,456,456,53,53,0,1,0
3,462,462,16,3,13,4,3

8,187,187,4,1,3,2,1
6,239,239,8,2,6,2,1
2,257,257,1,1,0,1,0
9,276,276,11,11,0,1,0
7,288,288,3,3,0,1,0
11,297,297,42,2,40,3,2
3,319,319,1,1,0,1,0
1,329,329,1,1,0,1,0
12,329,329,24,24,0,1,0
5,340,340,16,8,8,2,1
0,368,368,11,11,0,1,0
10,400,400,36,22,14,2,1
4,433,433,48,10,38,3,2

1,110,110,4,4,0,1,0
3,209,209,41,1,40,3,2
2,231,231,1,1,0,1,0
4,315,315,34,34,0,1,0
0,374,374,100,53,47,2,1

5,161,161,30,30,0,1,0
0,235,235,18,11,7,2,1
3,293,293,28,28,0,1,0
1,304,304,7,7,0,1,0
2,421,421,45,45,0,1,0
4,446,446,15,15,0,1,0
6,479,479,42,15,27,2,1

2,107,107,9,9,0,1,0
1,186,186,39,39,0,1,0
0,219,219,3,3,0,1,0
3,219,219,22,4,18,4,3
4,287,287,51,51,0,1,0
5,485,485,14,14,0,1,0

3,187,187,35,2,33,4,3
2,242,242,14,1,13,2,1
0,254,254,77,50,27,4,3
1,278,278,17,17,0,1,0

1,161,161,2,2,0,1,0
0,196,196,17,17,0,1,0
4,330,330,7,7,0,1,0
5,366,366,89,52,37,4,3
3,377,377,4,4,0,1,0
6,451,451,18,4,14,2,1
2,473,473,91,49,42,3,2

4,148,148,4,4,0,1,0
7,177,177,22,13,9,4,3
2,267,267,5,5,0,1,0
0,290,290,17,17,0,1,0
1,361,361,62,55,7,2,1
5,392,392,15,15,0,1,0
6,436,436,62,52,10,2,1
3,498,498,15,15,0,1,0

1,119,119,20,20,0,1,0
6,126,126,3,3,0,1,0
5,276,276,12,4,8,3,2
0,289,289,7,4,3,2,1
3,320,320,30,30,0,1,0
4,345,345,81,81,0,1,0
2,408,408,6,6,0,1,0

3,115,115,1,1,0,1,0
2,232,232,1,1,0,1,0
8,240,240,15,3,12,3,2
0,350,350,16,3,13,2,1
6,451,451,40,34,6,3,2
1,469,469,51,51,0,1,0
5,469,469,42,33,9,4,3
4,473,473,21,21,0,1,0
7,491,491,75,75,0,1,0

1,103,103,22,22,0,1,0
0,108,108,10,2,8,2,1
4,218,218,53,53,0,1,0
2,461,461,25,25,0,1,0
3,489,489,3,3,0,1,0

2,267,267,57,25,32,4,3
5,402,402,19,15,4,2,1
0,437,437,6,6,0,1,0
1,465,465,35,35,0,1,0
3,465,465,93,93,0,1,0
4,498,498,28,7,21,4,3

2,195,195,15,15,0,1,0
3,196,196,37,37,0,1,0
1,264,264,11,6,5,2,1
0,496,496,149,149,0,1,0

2,166,166,10,4,6,3,2
5,217,217,2,2,0,1,0
4,319,319,25,25,0,1,0
3,325,325,1,1,0,1,0
0,354,354,8,4,4,2,1
6,385,385,86,31,55,3,2
1,396,396,51,51,0,1,0
7,427,427,12,12,0,1,0
8,440,440,23,23,0,1,0

0,119,119,9,9,0,1,0
1,120,120,27,27,0,1,0
4,148,148,13,13,0,1,0
2,317,317,33,18,15,4,3
3,380,380,44,44,0,1,0

4,102,102,11,2,9,2,1
1,140,140,35,35,0,1,0
2,201,201,5,1,4,2,1
0,335,335,18,9,9,2,1
3,476,476,82,65,17,2,1

2,137,137,5,5,0,1,0
6,208,208,25,4,21,4,3
4,211,211,16,16,0,1,0
5,237,237,26,10,16,3,2
3,294,294,25,25,0,1,0
0,324,324,54,19,35,4,3
1,349,349,5,5,0,1,0

4,224,224,25,13,12,2,1
2,245,245,4,1,3,2,1
5,290,290,48,48,0,1,0
6,294,294,9,4,5,2,1
1,385,385,10,7,3,2,1
0,420,420,73,1,72,3,2
3,421,421,36,15,21,4,3

1,260,260,56,9,47,2,1
0,369,369,19,19,0,1,0
5,396,396,20,20,0,1,0
3,443,443,63,28,35,2,1
2,479,479,16,16,0,1,0
4,491,491,54,54,0,1,0

4,150,150,12,12,0,1,0
6,170,170,4,1,3,2,1
1,203,203,13,13,0,1,0
2,242,242,7,3,4,2,1
5,299,299,10,2,8,3,2
0,315,315,39,39,0,1,0
3,446,446,4,4,0,1,0
7,487,487,119,65,54,3,2

0,136,136,8,8,0,1,0
1,223,223,54,42,12,2,1
2,464,464,86,32,54,4,3
4,483,483,38,29,9,4,3
3,488,488,20,20,0,1,0

0,114,114,31,31,0,1,0
1,152,152,5,5,0,1,0
2,203,203,1,1,0,1,0
3,290,290,8,4,4,2,1
4,343,343,94,18,76,3,2

0,208,208,46,38,8,3,2
1,229,229,19,19,0,1,0
2,230,230,6,6,0,1,0
3,382,382,65,65,0,1,0
4,401,401,44,11,33,4,3

4,147,147,12,12,0,1,0
5,153,153,5,5,0,1,0
6,284,284,55,55,0,1,0
1,314,314,2,2,0,1,0
0,424,424,23,6,17,2,1
2,450,450,89,26,63,4,3
3,498,498,21,21,0,1,0

11,114,114,19,19,0,1,0
2,134,134,2,2,0,1,0
3,137,137,1,1,0,1,0
9,152,152,8,8,0,1,0
6,173,173,2,2,0,1,0
12,285,285,18,18,0,1,0
4,292,292,7,7,0,1,0
8,297,297,9,9,0,1,0
7,306,306,12,12,0,1,0
5,344,344,10,7,3,2,1
1,352,352,1,1,0,1,0
0,385,385,35,5,30,3,2
10,385,385,31,28,3,2,1

2,119,119,28,7,21,2,1
3,243,243,3,3,0,1,0
0,277,277,42,5,37,4,3
1,294,294,44,29,15,4,3
4,327,327,20,20,0,1,0

3,121,121,2,2,0,1,0
1,122,122,11,3,8,3,2
2,165,165,14,14,0,1,0
5,222,222,7,7,0,1,0
6,232,232,47,1,46,4,3
7,269,269,20,2,18,3,2
0,438,438,21,21,0,1,0
4,488,488,30,6,24,4,3

4,126,126,2,2,0,1,0
0,243,243,26,26,0,1,0
1,256,256,26,26,0,1,0
5,281,281,28,18,10,2,1
6,383,383,72,40,32,3,2
2,454,454,38,5,33,4,3
3,498,498,4,1,3,2,1

3,132,132,5,2,3,2,1
1,184,184,21,21,0,1,0
2,225,225,23,23,0,1,0
5,230,230,41,31,10,2,1
0,244,244,12,12,0,1,0
6,254,254,29,29,0,1,0
4,410,410,6,1,5,2,1

5,105,105,23,3,20,2,1
4,111,111,4,4,0,1,0
3,152,152,10,10,0,1,0
0,185,185,3,3,0,1,0
2,228,228,51,51,0,1,0
1,430,430,26,5,21,4,3

6,109,109,16,16,0,1,0
0,161,161,1,1,0,1,0
2,236,236,24,24,0,1,0
3,245,245,6,6,0,1,0
1,303,303,51,22,29,2,1
4,402,402,25,3,22,3,2
5,482,482,47,47,0,1,0

3,356,356,2,2,0,1,0
1,402,402,11,11,0,1,0
2,403,403,66,14,52,4,3
0,469,469,128,22,106,4,3
4,496,496,67,55,12,4,3

3,107,107,1,1,0,1,0
1,201,201,7,7,0,1,0
0,264,264,24,24,0,1,0
2,297,297,39,39,0,1,0
5,368,368,4,4,0,1,0
7,376,376,102,20,82,3,2
6,435,435,7,4,3,2,1
4,444,444,11,11,0,1,0
8,448,448,7,1,6,2,1

0,173,173,24,6,18,2,1
1,203,203,26,26,0,1,0
2,270,270,9,3,6,2,1
4,279,279,59,20,39,4,3
5,336,336,7,3,4,2,1
3,378,378,27,27,0,1,0

5,152,152,14,14,0,1,0
3,163,163,28,28,0,1,0
1,180,180,9,1,8,2,1
0,329,329,76,31,45,2,1
4,354,354,16,16,0,1,0
2,413,413,8,4,4,2,1

5,176,176,13,13,0,1,0
2,195,195,1,1,0,1,0
6,215,215,30,30,0,1,0
3,242,242,54,54,0,1,0
4,402,402,36,36,0,1,0
0,470,470,1,1,0,1,0
1,486,486,34,34,0,1,0

3,124,124,18,18,0,1,0
0,215,215,18,18,0,1,0
1,330,330,5,1,4,2,1
4,460,460,6,6,0,1,0
5,482,482,71,25,46,3,2
2,494,494,100,100,0,1,0

6,146,146,28,18,10,3,2
1,328,328,13,13,0,1,0
5,360,360,36,7,29,2,1
2,372,372,14,14,0,1,0
4,376,376,58,22,36,4,3
3,401,401,18,2,16,3,2
7,434,434,6,2,4,2,1
0,435,435,11,11,0,1,0

1,146,146,43,8,35,2,1
2,161,161,11,1,10,4,3
3,218,218,29,29,0,1,0
0,267,267,2,2,0,1,0
4,472,472,50,1,49,2,1

3,264,264,44,2,42,3,2
1,267,267,8,2,6,2,1
2,297,297,32,32,0,1,0
0,426,426,128,56,72,4,3

3,148,148,5,5,0,1,0
0,193,193,15,2,13,3,2
1,238,238,21,21,0,1,0
5,303,303,64,64,0,1,0
4,414,414,25,17,8,2,1
2,444,444,60,23,37,2,1

1,164,164,8,8,0,1,0
5,228,228,17,17,0,1,0
0,247,247,12,12,0,1,0
4,306,306,9,1,8,3,2
7,365,365,33,33,0,1,0
3,422,422,39,39,0,1,0
6,429,429,59,59,0,1,0
2,476,476,39,39,0,1,0

2,193,193,33,1,32,3,2
5,235,235,7,7,0,1,0
4,238,238,48,48,0,1,0
0,260,260,21,6,15,2,1
3,286,286,21,15,6,3,2
1,348,348,17,17,0,1,0

7,111,111,30,30,0,1,0
6,136,136,4,4,0,1,0
3,141,141,1,1,0,1,0
0,212,212,24,9,15,4,3
2,302,302,2,2,0,1,0
5,318,318,4,1,3,2,1
1,368,368,43,3,40,3,2
4,397,397,23,23,0,1,0

1,246,246,52,52,0,1,0
3,317,317,26,26,0,1,0
2,318,318,3,3,0,1,0
4,352,352,76,76,0,1,0
0,382,382,34,1,33,4,3

3,168,168,10,3,7,2,1
2,184,184,1,1,0,1,0
4,233,233,38,38,0,1,0
1,287,287,85,71,14,4,3
5,339,339,27,2,25,2,1
0,351,351,1,1,0,1,0

2,185,185,7,3,4,2,1
1,294,294,8,8,0,1,0
3,303,303,13,13,0,1,0
0,427,427,102,66,36,4,3
5,427,427,60,7,53,4,3
4,479,479,58,22,36,4,3

4,104,104,7,1,6,3,2
6,207,207,8,8,0,1,0
7,208,208,33,22,11,2,1
3,218,218,2,2,0,1,0
0,260,260,13,13,0,1,0
5,362,362,2,2,0,1,0
8,446,446,48,13,35,2,1
1,447,447,53,53,0,1,0
2,472,472,24,24,0,1,0

0,131,131,8,8,0,1,0
7,255,255,1,1,0,1,0
6,265,265,5,5,0,1,0
3,267,267,3,3,0,1,0
8,272,272,77,17,60,4,3
1,373,373,40,40,0,1,0
4,449,449,11,4,7,2,1
5,476,476,5,5,0,1,0
2,485,485,42,42,0,1,0

0,245,245,35,11,24,3,2
1,439,439,69,41,28,2,1
3,467,467,3,3,0,1,0
4,468,468,104,61,43,2,1
2,478,478,35,35,0,1,0

2,146,146,6,2,4,2,1
4,194,194,12,3,9,4,3
3,298,298,1,1,0,1,0
5,299,299,36,36,0,1,0
6,334,334,68,68,0,1,0
1,353,353,20,20,0,1,0
0,411,411,8,8,0,1,0
8,437,437,29,29,0,1,0
7,460,460,16,16,0,1,0

5,154,154,4,4,0,1,0
1,192,192,1,1,0,1,0
2,193,193,24,12,12,2,1
0,219,219,3,3,0,1,0
7,346,346,6,3,3,2,1
6,427,427,111,111,0,1,0
4,445,445,65,41,24,4,3
3,467,467,6,6,0,1,0

7,212,212,21,21,0,1,0
2,258,258,4,4,0,1,0
5,279,279,4,4,0,1,0
3,354,354,17,17,0,1,0
4,440,440,12,7,5,2,1
0,441,441,28,28,0,1,0
6,468,468,90,75,15,4,3
1,469,469,69,69,0,1,0

1,173,173,22,17,5,2,1
4,181,181,19,19,0,1,0
3,206,206,23,7,16,2,1
0,215,215,34,27,7,2,1
5,410,410,35,23,12,3,2
2,467,467,7,7,0,1,0

4,122,122,26,26,0,1,0
6,153,153,9,9,0,1,0
1,172,172,7,7,0,1,0
3,175,175,4,4,0,1,0
0,185,185,39,39,0,1,0
2,248,248,7,2,5,2,1
5,275,275,8,3,5,2,1

1,103,103,3,3,0,1,0
2,135,135,20,20,0,1,0
3,150,150,20,20,0,1,0
0,427,427,129,105,24,2,1

5,116,116,2,2,0,1,0
1,162,162,4,4,0,1,0
3,234,234,19,7,12,4,3
2,378,378,51,51,0,1,0
0,383,383,23,23,0,1,0
4,489,489,48,48,0,1,0
6,489,489,95,95,0,1,0

3,105,105,7,4,3,2,1
2,115,115,19,19,0,1,0
0,176,176,53,32,21,4,3
1,400,400,29,29,0,1,0

1,300,300,8,5,3,2,1
6,312,312,20,20,0,1,0
5,387,387,64,22,42,2,1
3,401,401,6,1,5,2,1
4,415,415,10,10,0,1,0
7,430,430,33,33,0,1,0
0,433,433,53,53,0,1,0
2,459,459,52,52,0,1,0

0,104,104,3,3,0,1,0
3,130,130,4,4,0,1,0
1,258,258,36,36,0,1,0
5,294,294,3,3,0,1,0
4,321,321,18,1,17,2,1
6,348,348,18,9,9,2,1
8,350,350,64,52,12,2,1
2,359,359,13,13,0,1,0
7,403,403,28,1,27,2,1

6,201,201,15,10,5,2,1
5,235,235,41,5,36,2,1
4,242,242,8,3,5,2,1
2,308,308,1,1,0,1,0
1,340,340,34,8,26,2,1
0,408,408,45,28,17,2,1
7,489,489,28,28,0,1,0
3,494,494,27,9,18,4,3

2,133,133,24,18,6,2,1
1,220,220,12,12,0,1,0
5,244,244,25,25,0,1,0
4,311,311,7,7,0,1,0
3,329,329,59,41,18,3,2
0,409,409,29,29,0,1,0

2,154,154,5,5,0,1,0
5,192,192,2,2,0,1,0
0,201,201,32,32,0,1,0
4,273,273,36,36,0,1,0
3,287,287,48,27,21,4,3
1,401,401,46,8,38,2,1

0,160,160,20,20,0,1,0
3,197,197,5,5,0,1,0
1,287,287,11,11,0,1,0
5,297,297,9,9,0,1,0
10,299,299,45,29,16,2,1
6,341,341,1,1,0,1,0
8,389,389,19,13,6,3,2
9,390,390,15,15,0,1,0
11,420,420,48,48,0,1,0
4,457,457,3,3,0,1,0
7,487,487,3,3,0,1,0
2,495,495,9,1,8,2,1

0,123,123,1,1,0,1,0
6,150,150,17,17,0,1,0
4,194,194,19,19,0,1,0
2,231,231,16,16,0,1,0
5,304,304,30,2,28,4,3
1,339,339,43,14,29,2,1
3,363,363,35,35,0,1,0

3,174,174,23,2,21,4,3
1,224,224,64,42,22,4,3
2,459,459,62,62,0,1,0
0,467,467,8,8,0,1,0
4,494,494,18,18,0,1,0

4,107,107,9,5,4,2,1
6,120,120,27,27,0,1,0
5,222,222,21,21,0,1,0
2,337,337,18,3,15,4,3
7,339,339,8,2,6,3,2
1,348,348,5,1,4,2,1
8,353,353,22,4,18,3,2
3,461,461,22,22,0,1,0
0,480,480,4,4,0,1,0

1,110,110,19,4,15,4,3
4,154,154,16,16,0,1,0
0,276,276,37,25,12,4,3
3,286,286,30,30,0,1,0
2,335,335,32,23,9,2,1

4,137,137,1,1,0,1,0
2,138,138,3,3,0,1,0
0,158,158,10,10,0,1,0
6,299,299,9,1,8,2,1
3,301,301,26,26,0,1,0
5,328,328,36,36,0,1,0
1,420,420,51,44,7,2,1
7,428,428,70,23,47,2,1

1,227,227,13,4,9,4,3
3,293,293,50,11,39,4,3
2,363,363,29,29,0,1,0
0,442,442,133,58,75,4,3

4,107,107,2,2,0,1,0
5,172,172,1,1,0,1,0
7,229,229,14,5,9,2,1
1,289,289,20,6,14,2,1
2,338,338,32,7,25,2,1
6,353,353,6,6,0,1,0
8,358,358,76,76,0,1,0
0,448,448,42,17,25,2,1
3,451,451,1,1,0,1,0
9,460,460,15,15,0,1,0

3,106,106,3,3,0,1,0
4,166,166,30,4,26,2,1
0,289,289,42,42,0,1,0
1,302,302,1,1,0,1,0
2,319,319,49,49,0,1,0
5,461,461,48,13,35,2,1

0,186,186,24,3,21,4,3
5,201,201,5,5,0,1,0
2,308,308,33,9,24,3,2
3,431,431,110,42,68,3,2
4,460,460,12,12,0,1,0
1,468,468,30,14,16,3,2

7,103,103,1,1,0,1,0
1,215,215,1,1,0,1,0
5,343,343,24,24,0,1,0
2,347,347,35,35,0,1,0
4,372,372,26,15,11,2,1
3,409,409,11,11,0,1,0
6,412,412,94,78,16,3,2
0,448,448,44,44,0,1,0

0,174,174,8,8,0,1,0
5,202,202,32,23,9,4,3
4,272,272,8,8,0,1,0
1,302,302,8,5,3,2,1
2,377,377,17,17,0,1,0
3,452,452,83,75,8,2,1
6,475,475,56,56,0,1,0

0,154,154,2,2,0,1,0
1,161,161,21,3,18,4,3
4,172,172,3,3,0,1,0
5,222,222,54,10,44,2,1
2,348,348,52,32,20,3,2
6,416,416,21,10,11,2,1
3,486,486,4,4,0,1,0

1,124,124,15,10,5,2,1
3,133,133,13,13,0,1,0
6,209,209,17,17,0,1,0
2,211,211,1,1,0,1,0
5,228,228,22,6,16,3,2
4,309,309,39,39,0,1,0
0,327,327,26,6,20,2,1

5,241,241,2,2,0,1,0
6,249,249,24,24,0,1,0
1,291,291,35,35,0,1,0
3,313,313,4,4,0,1,0
2,368,368,40,40,0,1,0
4,412,412,83,78,5,2,1
0,428,428,26,4,22,3,2

5,150,150,30,30,0,1,0
0,341,341,16,13,3,2,1
4,383,383,34,34,0,1,0
1,478,478,64,64,0,1,0
3,490,490,9,9,0,1,0
2,494,494,59,59,0,1,0

0,107,107,1,1,0,1,0
1,130,130,1,1,0,1,0
2,270,270,8,8,0,1,0
6,325,325,34,34,0,1,0
5,381,381,52,52,0,1,0
3,387,387,29,6,23,3,2
4,411,411,74,74,0,1,0
7,484,484,31,11,20,3,2

2,129,129,1,1,0,1,0
6,163,163,22,22,0,1,0
5,270,270,4,4,0,1,0
1,272,272,1,1,0,1,0
0,316,316,66,5,61,4,3
4,319,319,50,50,0,1,0
3,476,476,38,38,0,1,0

7,153,153,9,9,0,1,0
1,165,165,13,13,0,1,0
2,248,248,3,3,0,1,0
0,259,259,9,2,7,2,1
5,269,269,51,51,0,1,0
6,283,283,16,16,0,1,0
3,295,295,38,5,33,4,3
4,463,463,22,22,0,1,0

2,116,116,5,5,0,1,0
6,182,182,33,33,0,1,0
1,213,213,10,10,0,1,0
5,230,230,14,4,10,3,2
3,399,399,58,58,0,1,0
0,446,446,29,15,14,3,2
4,491,491,31,16,15,2,1

3,107,107,8,8,0,1,0
1,118,118,23,9,14,3,2
2,123,123,8,2,6,3,2
4,162,162,5,5,0,1,0
0,333,333,14,11,3,2,1
5,378,378,78,4,74,3,2

9,134,134,5,5,0,1,0
0,149,149,2,2,0,1,0
6,169,169,8,8,0,1,0
4,184,184,8,2,6,2,1
2,218,218,21,1,20,2,1
8,224,224,43,43,0,1,0
1,256,256,21,21,0,1,0
5,271,271,2,2,0,1,0
3,354,354,4,4,0,1,0
7,434,434,34,4,30,4,3

6,129,129,3,3,0,1,0
2,246,246,28,10,18,3,2
1,276,276,35,13,22,2,1
3,279,279,12,12,0,1,0
0,296,296,5,5,0,1,0
5,388,388,93,93,0,1,0
4,417,417,16,16,0,1,0

1,276,276,16,16,0,1,0
3,383,383,87,65,22,3,2
0,403,403,98,98,0,1,0
4,428,428,19,4,15,2,1
2,433,433,14,14,0,1,0

1,268,268,8,8,0,1,0
4,298,298,14,14,0,1,0
5,298,298,31,31,0,1,0
3,345,345,54,54,0,1,0
0,417,417,112,112,0,1,0
2,494,494,1,1,0,1,0

1,147,147,32,20,12,3,2
3,206,206,3,3,0,1,0
2,304,304,11,11,0,1,0
4,348,348,98,41,57,4,3
5,383,383,3,3,0,1,0
0,401,401,19,5,14,2,1

1,155,155,2,2,0,1,0
3,266,266,33,33,0,1,0
2,345,345,59,59,0,1,0
0,497,497,150,15,135,4,3

5,113,113,4,1,3,2,1
2,199,199,18,18,0,1,0
4,238,238,44,44,0,1,0
3,293,293,27,5,22,3,2
1,408,408,1,1,0,1,0
0,482,482,102,8,94,3,2

1,123,123,6,6,0,1,0
2,150,150,20,20,0,1,0
7,173,173,13,1,12,3,2
3,268,268,2,2,0,1,0
6,305,305,41,21,20,2,1
5,309,309,30,11,19,2,1
0,377,377,21,21,0,1,0
4,455,455,25,14,11,2,1

3,104,104,1,1,0,1,0
0,128,128,16,16,0,1,0
1,157,157,28,28,0,1,0
4,322,322,55,55,0,1,0
2,408,408,53,26,27,4,3

4,101,101,13,7,6,3,2
1,141,141,5,2,3,2,1
0,143,143,11,1,10,3,2
2,150,150,1,1,0,1,0
3,193,193,11,11,0,1,0
6,257,257,5,5,0,1,0
7,373,373,22,22,0,1,0
5,421,421,95,31,64,3,2

6,102,102,7,7,0,1,0
2,209,209,16,4,12,4,3
5,258,258,59,15,44,3,2
4,274,274,5,5,0,1,0
3,338,338,6,6,0,1,0
1,475,475,82,47,35,2,1
0,491,491,17,17,0,1,0

3,130,130,5,5,0,1,0
0,144,144,1,1,0,1,0
2,192,192,27,27,0,1,0
7,276,276,22,6,16,3,2
4,278,278,20,5,15,4,3
1,280,280,12,12,0,1,0
6,296,296,53,53,0,1,0
5,347,347,16,16,0,1,0

0,240,240,5,5,0,1,0
2,319,319,56,15,41,4,3
1,373,373,39,39,0,1,0
5,435,435,96,55,41,4,3
4,459,459,3,3,0,1,0
3,465,465,35,8,27,2,1

1,132,132,1,1,0,1,0
0,171,171,8,8,0,1,0
2,272,272,38,38,0,1,0
7,333,333,16,2,14,2,1
3,392,392,2,2,0,1,0
6,395,395,40,1,39,4,3
5,437,437,68,34,34,3,2
4,487,487,50,50,0,1,0

4,168,168,3,3,0,1,0
3,173,173,40,40,0,1,0
0,227,227,5,5,0,1,0
6,265,265,61,61,0,1,0
2,289,289,4,4,0,1,0
1,351,351,13,13,0,1,0
5,434,434,25,6,19,4,3

4,223,223,54,15,39,4,3
2,283,283,13,13,0,1,0
3,342,342,14,9,5,2,1
1,352,352,34,7,27,2,1
5,405,405,9,3,6,3,2
0,483,483,77,77,0,1,0

5,141,141,15,10,5,2,1
0,172,172,14,14,0,1,0
3,187,187,24,24,0,1,0
6,386,386,56,56,0,1,0
4,414,414,22,22,0,1,0
1,420,420,1,1,0,1,0
2,481,481,44,15,29,2,1

3,177,177,30,30,0,1,0
0,237,237,30,6,24,4,3
1,359,359,3,3,0,1,0
5,399,399,4,4,0,1,0
2,456,456,76,20,56,3,2
4,496,496,62,62,0,1,0

6,125,125,16,16,0,1,0
5,151,151,16,16,0,1,0
1,259,259,3,3,0,1,0
0,326,326,44,44,0,1,0
3,349,349,5,5,0,1,0
2,381,381,54,9,45,4,3
4,430,430,34,10,24,3,2

5,271,271,15,15,0,1,0
3,287,287,14,14,0,1,0
4,308,308,14,14,0,1,0
6,385,385,78,40,38,2,1
2,411,411,8,8,0,1,0
1,449,449,91,79,12,4,3
0,467,467,14,14,0,1,0

0,140,140,3,3,0,1,0
5,164,164,10,2,8,2,1
4,221,221,4,1,3,2,1
3,318,318,82,6,76,3,2
6,364,364,84,44,40,4,3
1,415,415,4,4,0,1,0
2,498,498,6,6,0,1,0

4,153,153,19,3,16,2,1
0,202,202,9,9,0,1,0
6,224,224,34,34,0,1,0
1,321,321,54,12,42,4,3
2,349,349,25,25,0,1,0
5,365,365,12,2,10,2,1
3,470,470,8,8,0,1,0

6,156,156,1,1,0,1,0
0,162,162,11,11,0,1,0
4,261,261,7,2,5,2,1
1,311,311,16,11,5,2,1
5,334,334,87,3,84,4,3
2,373,373,35,35,0,1,0
7,421,421,17,2,15,4,3
3,462,462,29,11,18,4,3

6,104,104,8,2,6,3,2
4,124,124,23,23,0,1,0
3,230,230,11,11,0,1,0
1,261,261,8,2,6,3,2
0,298,298,18,4,14,3,2
2,475,475,78,78,0,1,0
5,496,496,26,26,0,1,0

2,186,186,44,32,12,4,3
3,233,233,5,1,4,2,1
0,331,331,21,5,16,2,1
1,392,392,93,93,0,1,0
4,437,437,20,13,7,2,1

2,129,129,10,10,0,1,0
6,164,164,31,31,0,1,0
5,251,251,13,13,0,1,0
0,320,320,1,1,0,1,0
3,454,454,25,11,14,3,2
4,485,485,32,32,0,1,0
1,493,493,82,82,0,1,0

2,136,136,3,3,0,1,0
4,246,246,8,1,7,2,1
0,261,261,17,17,0,1,0
3,281,281,70,70,0,1,0
1,395,395,93,11,82,3,2

0,120,120,9,9,0,1,0
8,266,266,39,30,9,2,1
4,369,369,22,22,0,1,0
5,391,391,30,30,0,1,0
2,395,395,21,21,0,1,0
6,401,401,20,20,0,1,0
3,426,426,13,13,0,1,0
1,481,481,3,3,0,1,0
7,492,492,53,53,0,1,0

1,206,206,3,3,0,1,0
0,215,215,11,11,0,1,0
5,260,260,52,52,0,1,0
2,397,397,28,28,0,1,0
6,406,406,26,12,14,2,1
3,437,437,72,56,16,2,1
4,454,454,18,10,8,2,1

3,320,320,30,30,0,1,0
1,363,363,42,4,38,2,1
2,369,369,35,35,0,1,0
0,478,478,144,117,27,4,3

5,207,207,15,15,0,1,0
4,283,283,55,5,50,2,1
2,329,329,49,39,10,3,2
3,350,350,14,14,0,1,0
0,427,427,1,1,0,1,0
1,500,500,75,67,8,3,2

0,305,305,16,16,0,1,0
2,362,362,24,14,10,3,2
3,416,416,13,5,8,3,2
1,452,452,112,112,0,1,0
4,455,455,94,94,0,1,0

2,291,291,18,18,0,1,0
3,301,301,5,5,0,1,0
4,338,338,77,37,40,3,2
0,364,364,108,87,21,4,3
1,381,381,2,2,0,1,0

0,109,109,1,1,0,1,0
1,154,154,14,14,0,1,0
3,157,157,8,2,6,2,1
5,160,160,5,5,0,1,0
7,173,173,21,21,0,1,0
8,222,222,9,9,0,1,0
2,311,311,5,5,0,1,0
6,395,395,2,2,0,1,0
4,413,413,40,40,0,1,0
9,437,437,62,42,20,2,1

1,106,106,3,3,0,1,0
3,199,199,38,6,32,3,2
0,278,278,78,4,74,3,2
2,444,444,8,8,0,1,0
4,451,451,44,44,0,1,0

5,111,111,7,7,0,1,0
0,192,192,2,2,0,1,0
1,267,267,2,2,0,1,0
6,269,269,12,3,9,2,1
3,293,293,33,33,0,1,0
7,405,405,80,80,0,1,0
4,445,445,55,25,30,2,1
2,498,498,23,11,12,2,1

4,120,120,16,16,0,1,0
2,148,148,10,10,0,1,0
0,348,348,22,10,12,3,2
5,369,369,35,35,0,1,0
1,413,413,71,65,6,2,1
3,471,471,38,20,18,4,3

4,104,104,14,14,0,1,0
0,174,174,16,3,13,2,1
1,277,277,7,7,0,1,0
5,284,284,28,28,0,1,0
3,348,348,25,25,0,1,0
2,380,380,70,28,42,4,3

9,192,192,12,12,0,1,0
7,215,215,43,43,0,1,0
2,228,228,3,3,0,1,0
6,250,250,8,8,0,1,0
5,262,262,42,42,0,1,0
4,279,279,1,1,0,1,0
3,298,298,1,1,0,1,0
0,450,450,1,1,0,1,0
1,455,455,39,39,0,1,0
8,492,492,23,23,0,1,0

3,108,108,3,3,0,1,0
5,143,143,6,6,0,1,0
7,283,283,19,19,0,1,0
1,348,348,48,48,0,1,0
4,351,351,16,6,10,3,2
6,408,408,20,11,9,2,1
0,422,422,14,2,12,3,2
2,430,430,8,8,0,1,0
8,464,464,87,59,28,2,1

4,150,150,5,5,0,1,0
5,218,218,12,3,9,4,3
3,406,406,89,86,3,2,1
0,422,422,48,34,14,3,2
1,436,436,27,18,9,4,3
2,465,465,58,58,0,1,0

6,123,123,3,3,0,1,0
2,196,196,20,4,16,3,2
4,242,242,22,10,12,4,3
5,296,296,56,56,0,1,0
0,315,315,14,14,0,1,0
3,362,362,13,13,0,1,0
1,383,383,46,46,0,1,0

7,101,101,14,14,0,1,0
6,128,128,9,9,0,1,0
3,165,165,26,18,8,2,1
1,176,176,6,6,0,1,0
2,255,255,1,1,0,1,0
4,434,434,22,22,0,1,0
8,436,436,42,42,0,1,0
5,442,442,3,3,0,1,0
0,472,472,23,23,0,1,0

3,146,146,10,10,0,1,0
8,160,160,1,1,0,1,0
5,182,182,26,26,0,1,0
4,222,222,7,2,5,2,1
0,284,284,3,3,0,1,0
1,345,345,16,16,0,1,0
7,370,370,103,61,42,3,2
2,419,419,1,1,0,1,0
6,424,424,9,9,0,1,0

4,114,114,7,7,0,1,0
5,155,155,36,21,15,4,3
0,206,206,34,34,0,1,0
2,212,212,18,18,0,1,0
1,444,444,23,5,18,4,3
3,446,446,5,5,0,1,0

2,279,279,14,14,0,1,0
4,402,402,33,18,15,2,1
5,403,403,6,6,0,1,0
0,445,445,23,7,16,3,2
6,480,480,99,99,0,1,0
1,492,492,9,1,8,2,1
3,492,492,89,49,40,3,2

1,103,103,4,4,0,1,0
3,150,150,1,1,0,1,0
4,291,291,16,9,7,2,1
7,331,331,22,22,0,1,0
0,366,366,14,14,0,1,0
6,406,406,63,63,0,1,0
5,438,438,36,36,0,1,0
2,464,464,76,46,30,4,3

0,171,171,46,46,0,1,0
2,311,311,38,10,28,3,2
3,381,381,17,17,0,1,0
4,422,422,57,57,0,1,0
1,438,438,14,2,12,2,1

2,105,105,5,5,0,1,0
1,177,177,32,28,4,2,1
4,222,222,44,44,0,1,0
0,290,290,22,2,20,3,2
3,453,453,32,6,26,3,2
5,487,487,17,17,0,1,0

2,152,152,1,1,0,1,0
6,161,161,4,4,0,1,0
0,243,243,15,2,13,2,1
9,251,251,8,8,0,1,0
1,255,255,23,5,18,2,1
7,333,333,70,70,0,1,0
4,354,354,1,1,0,1,0
5,409,409,18,18,0,1,0
3,432,432,32,11,21,4,3
8,454,454,29,8,21,2,1

2,108,108,1,1,0,1,0
0,188,188,3,3,0,1,0
6,337,337,16,9,7,2,1
8,374,374,42,13,29,2,1
1,396,396,11,11,0,1,0
3,431,431,49,49,0,1,0
5,449,449,42,42,0,1,0
4,486,486,20,1,19,2,1
7,487,487,70,70,0,1,0

6,101,101,4,4,0,1,0
4,154,154,22,22,0,1,0
3,155,155,21,21,0,1,0
5,234,234,31,31,0,1,0
0,313,313,9,2,7,2,1
2,409,409,33,10,23,2,1
1,480,480,27,27,0,1,0

2,188,188,33,33,0,1,0
1,221,221,14,14,0,1,0
0,409,409,26,26,0,1,0
4,435,435,69,27,42,2,1
5,442,442,6,3,3,2,1
3,451,451,60,14,46,2,1

6,196,196,29,15,14,3,2
3,202,202,7,7,0,1,0
1,226,226,1,1,0,1,0
0,262,262,20,6,14,2,1
2,263,263,19,19,0,1,0
5,369,369,29,29,0,1,0
7,458,458,36,22,14,2,1
4,473,473,54,54,0,1,0

3,119,119,6,6,0,1,0
1,126,126,26,20,6,2,1
4,132,132,19,19,0,1,0
2,136,136,16,12,4,2,1
0,289,289,28,10,18,4,3

5,188,188,8,2,6,2,1
3,409,409,24,21,3,2,1
6,421,421,3,3,0,1,0
1,426,426,8,8,0,1,0
2,426,426,87,41,46,4,3
0,458,458,1,1,0,1,0
7,471,471,119,119,0,1,0
4,481,481,8,2,6,3,2

5,156,156,6,3,3,2,1
3,160,160,40,32,8,2,1
0,184,184,6,6,0,1,0
4,353,353,8,5,3,2,1
1,406,406,28,28,0,1,0
2,463,463,92,27,65,4,3

2,193,193,20,4,16,3,2
1,244,244,1,1,0,1,0
0,304,304,90,44,46,2,1
4,349,349,11,11,0,1,0
3,395,395,67,67,0,1,0

1,346,346,61,61,0,1,0
4,399,399,36,36,0,1,0
2,476,476,23,1,22,2,1
0,491,491,61,20,41,2,1
3,494,494,81,64,17,4,3

2,234,234,7,2,5,2,1
5,240,240,13,7,6,3,2
0,314,314,77,45,32,3,2
1,376,376,10,3,7,2,1
3,380,380,50,50,0,1,0
4,444,444,53,53,0,1,0

7,205,205,22,22,0,1,0
5,233,233,23,23,0,1,0
2,319,319,22,22,0,1,0
3,349,349,10,10,0,1,0
4,370,370,12,7,5,2,1
6,375,375,25,25,0,1,0
0,465,465,10,10,0,1,0
8,496,496,64,4,60,3,2
1,500,500,25,13,12,3,2

1,244,244,28,28,0,1,0
0,296,296,55,55,0,1,0
4,324,324,13,13,0,1,0
2,326,326,57,57,0,1,0
3,361,361,32,32,0,1,0

5,158,158,1,1,0,1,0
6,195,195,4,4,0,1,0
0,228,228,22,17,5,2,1
7,272,272,10,2,8,2,1
1,292,292,2,2,0,1,0
3,348,348,1,1,0,1,0
4,361,361,28,13,15,2,1
8,390,390,43,43,0,1,0
2,397,397,36,36,0,1,0
9,484,484,76,43,33,4,3

3,145,145,5,5,0,1,0
5,150,150,10,2,8,3,2
0,184,184,5,5,0,1,0
4,260,260,54,54,0,1,0
2,277,277,46,46,0,1,0
1,372,372,41,32,9,4,3

2,169,169,11,3,8,2,1
9,210,210,24,24,0,1,0
4,297,297,18,18,0,1,0
5,297,297,1,1,0,1,0
7,377,377,5,1,4,2,1
8,379,379,32,32,0,1,0
0,420,420,21,21,0,1,0
6,430,430,2,2,0,1,0
1,458,458,7,7,0,1,0
3,488,488,44,44,0,1,0
10,492,492,53,9,44,3,2

4,124,124,14,14,0,1,0
5,155,155,17,17,0,1,0
6,353,353,30,30,0,1,0
2,406,406,38,38,0,1,0
1,415,415,1,1,0,1,0
0,435,435,88,18,70,4,3
3,500,500,1,1,0,1,0

1,196,196,7,7,0,1,0
5,238,238,25,6,19,4,3
3,252,252,22,22,0,1,0
6,330,330,64,46,18,4,3
2,337,337,14,14,0,1,0
0,412,412,56,41,15,2,1
4,462,462,2,2,0,1,0

2,192,192,16,16,0,1,0
0,260,260,79,19,60,3,2
3,390,390,73,73,0,1,0
1,432,432,15,15,0,1,0

2,261,261,46,29,17,2,1
3,300,300,15,1,14,3,2
0,436,436,131,108,23,2,1
1,471,471,37,37,0,1,0

4,169,169,26,26,0,1,0
1,181,181,54,32,22,3,2
0,196,196,1,1,0,1,0
3,228,228,32,32,0,1,0
2,272,272,4,4,0,1,0

6,170,170,1,1,0,1,0
4,189,189,7,4,3,2,1
0,198,198,5,1,4,2,1
10,248,248,20,2,18,4,3
8,263,263,1,1,0,1,0
9,271,271,11,1,10,3,2
11,368,368,67,31,36,3,2
5,396,396,8,8,0,1,0
3,413,413,3,3,0,1,0
2,439,439,20,20,0,1,0
7,480,480,67,26,41,4,3
1,493,493,8,8,0,1,0

1,114,114,1,1,0,1,0
4,166,166,14,14,0,1,0
3,253,253,1,1,0,1,0
5,297,297,15,5,10,3,2
6,332,332,50,12,38,2,1
7,394,394,41,32,9,4,3
2,441,441,58,58,0,1,0
0,495,495,38,2,36,4,3

1,162,162,13,13,0,1,0
0,217,217,21,5,16,3,2
2,225,225,14,5,9,2,1
6,302,302,30,30,0,1,0
4,304,304,51,51,0,1,0
5,314,314,12,12,0,1,0
3,480,480,30,24,6,2,1

2,179,179,3,3,0,1,0
3,226,226,50,24,26,2,1
1,276,276,20,1,19,2,1
0,322,322,97,97,0,1,0

7,161,161,19,19,0,1,0
4,202,202,4,1,3,2,1
1,204,204,20,3,17,2,1
6,275,275,35,14,21,2,1
5,276,276,17,17,0,1,0
3,360,360,3,3,0,1,0
0,384,384,14,14,0,1,0
2,499,499,69,21,48,3,2

1,225,225,36,36,0,1,0
4,298,298,25,25,0,1,0
0,376,376,54,33,21,4,3
3,383,383,79,75,4,2,1
2,491,491,8,3,5,2,1

1,106,106,4,4,0,1,0
7,107,107,25,7,18,4,3
3,131,131,7,4,3,2,1
5,159,159,6,6,0,1,0
6,182,182,6,2,4,2,1
4,317,317,28,12,16,3,2
0,334,334,27,27,0,1,0
2,399,399,1,1,0,1,0
8,425,425,19,19,0,1,0

2,110,110,14,14,0,1,0
4,132,132,1,1,0,1,0
5,137,137,27,7,20,2,1
3,142,142,15,6,9,4,3
0,289,289,8,4,4,2,1
1,292,292,10,10,0,1,0
7,293,293,22,12,10,3,2
6,348,348,13,2,11,2,1

7,123,123,1,1,0,1,0
4,144,144,2,2,0,1,0
5,146,146,17,17,0,1,0
6,162,162,11,3,8,3,2
2,245,245,6,1,5,2,1
3,245,245,12,5,7,2,1
8,277,277,66,28,38,2,1
0,313,313,10,2,8,3,2
1,484,484,34,34,0,1,0

5,176,176,24,24,0,1,0
3,212,212,11,4,7,2,1
2,218,218,17,17,0,1,0
6,230,230,5,5,0,1,0
4,346,346,52,52,0,1,0
0,363,363,4,4,0,1,0
1,436,436,70,20,50,3,2

0,238,238,54,5,49,3,2
4,320,320,45,41,4,2,1
1,348,348,26,26,0,1,0
3,348,348,43,11,32,3,2
2,443,443,18,1,17,2,1

1,101,101,14,14,0,1,0
2,207,207,32,32,0,1,0
3,221,221,41,32,9,2,1
5,233,233,16,3,13,4,3
4,236,236,13,3,10,2,1
0,459,459,4,4,0,1,0

2,127,127,4,4,0,1,0
3,155,155,1,1,0,1,0
5,256,256,42,3,39,4,3
0,366,366,35,17,18,2,1
6,428,428,20,20,0,1,0
7,455,455,43,33,10,2,1
1,457,457,35,35,0,1,0
4,463,463,42,13,29,4,3

4,125,125,4,4,0,1,0
6,173,173,41,16,25,2,1
2,186,186,1,1,0,1,0
7,194,194,5,2,3,2,1
3,285,285,29,9,20,3,2
5,315,315,17,17,0,1,0
8,342,342,16,4,12,2,1
1,362,362,13,10,3,2,1
0,493,493,35,35,0,1,0

3,136,136,1,1,0,1,0
7,166,166,5,5,0,1,0
1,169,169,3,3,0,1,0
0,209,209,31,31,0,1,0
2,280,280,24,18,6,2,1
4,429,429,18,18,0,1,0
6,448,448,85,34,51,4,3
5,493,493,43,43,0,1,0

3,126,126,10,10,0,1,0
5,162,162,4,1,3,2,1
6,243,243,61,11,50,2,1
0,251,251,26,2,24,3,2
2,267,267,15,15,0,1,0
4,400,400,15,15,0,1,0
1,416,416,10,10,0,1,0
7,461,461,14,14,0,1,0

3,100,100,15,8,7,2,1
1,147,147,20,8,12,3,2
0,151,151,25,25,0,1,0
4,263,263,10,2,8,2,1
2,391,391,48,8,40,3,2

4,166,166,10,1,9,2,1
7,195,195,10,10,0,1,0
6,233,233,48,48,0,1,0
1,322,322,16,16,0,1,0
3,342,342,35,20,15,2,1
2,379,379,34,34,0,1,0
5,414,414,22,2,20,2,1
0,483,483,1,1,0,1,0

5,131,131,8,8,0,1,0
6,136,136,20,20,0,1,0
0,236,236,16,16,0,1,0
3,372,372,5,5,0,1,0
1,449,449,89,73,16,2,1
4,456,456,46,9,37,2,1
2,488,488,11,11,0,1,0

5,113,113,2,2,0,1,0
7,128,128,35,35,0,1,0
6,169,169,3,3,0,1,0
0,177,177,18,2,16,2,1
4,210,210,1,1,0,1,0
2,263,263,17,4,13,4,3
3,400,400,19,19,0,1,0
1,434,434,36,36,0,1,0

1,241,241,11,2,9,4,3
2,265,265,65,65,0,1,0
0,340,340,103,61,42,3,2
3,378,378,6,3,3,2,1

1,203,203,7,7,0,1,0
4,213,213,3,3,0,1,0
7,234,234,14,14,0,1,0
0,267,267,22,10,12,3,2
6,268,268,35,35,0,1,0
3,335,335,39,39,0,1,0
8,455,455,52,19,33,4,3
2,479,479,16,16,0,1,0
5,492,492,10,3,7,2,1

5,111,111,2,2,0,1,0
10,132,132,25,25,0,1,0
6,151,151,3,3,0,1,0
2,171,171,4,4,0,1,0
1,175,175,2,2,0,1,0
12,235,235,24,20,4,2,1
3,242,242,7,7,0,1,0
9,348,348,20,20,0,1,0
7,369,369,1,1,0,1,0
8,375,375,15,15,0,1,0
11,401,401,6,6,0,1,0
4,412,412,31,31,0,1,0
0,464,464,11,11,0,1,0

6,139,139,18,18,0,1,0
8,174,174,9,1,8,3,2
2,223,223,20,20,0,1,0
3,223,223,1,1,0,1,0
7,254,254,33,33,0,1,0
0,356,356,41,2,39,2,1
4,387,387,26,26,0,1,0
5,391,391,2,2,0,1,0
1,435,435,9,9,0,1,0

3,109,109,3,3,0,1,0
2,130,130,17,17,0,1,0
0,200,200,15,15,0,1,0
1,231,231,22,22,0,1,0
5,419,419,33,33,0,1,0
4,497,497,98,12,86,3,2

5,133,133,11,11,0,1,0
2,185,185,5,2,3,2,1
0,236,236,46,46,0,1,0
1,302,302,24,24,0,1,0
4,322,322,24,21,3,2,1
3,483,483,71,16,55,4,3

2,135,135,1,1,0,1,0
3,230,230,17,5,12,4,3
1,294,294,52,52,0,1,0
4,346,346,79,4,75,4,3
6,446,446,6,6,0,1,0
5,458,458,28,28,0,1,0
0,485,485,22,8,14,2,1

2,137,137,6,6,0,1,0
3,147,147,9,9,0,1,0
1,161,161,17,17,0,1,0
4,226,226,43,15,28,2,1
5,282,282,17,17,0,1,0
0,484,484,75,53,22,2,1

5,116,116,17,17,0,1,0
3,121,121,1,1,0,1,0
1,136,136,3,3,0,1,0
8,179,179,27,12,15,4,3
6,197,197,18,4,14,2,1
2,302,302,13,7,6,2,1
7,338,338,22,8,14,2,1
0,390,390,14,14,0,1,0
4,394,394,18,6,12,3,2

2,184,184,33,33,0,1,0
0,215,215,41,11,30,4,3
1,267,267,30,4,26,2,1
4,285,285,17,17,0,1,0
3,481,481,30,30,0,1,0

2,226,226,12,12,0,1,0
5,308,308,44,9,35,2,1
1,320,320,45,45,0,1,0
7,335,335,48,48,0,1,0
4,421,421,31,2,29,2,1
3,433,433,12,5,7,2,1
0,446,446,3,3,0,1,0
6,482,482,9,4,5,2,1

3,112,112,10,10,0,1,0
8,112,112,9,3,6,3,2
0,128,128,6,6,0,1,0
7,141,141,6,2,4,2,1
2,258,258,2,2,0,1,0
1,352,352,16,8,8,2,1
4,366,366,30,9,21,3,2
6,391,391,73,13,60,3,2
5,396,396,12,12,0,1,0

0,115,115,1,1,0,1,0
6,267,267,39,39,0,1,0
7,337,337,48,12,36,2,1
4,357,357,6,6,0,1,0
5,403,403,6,6,0,1,0
2,408,408,26,26,0,1,0
1,466,466,16,16,0,1,0
3,472,472,84,27,57,4,3

1,113,113,6,1,5,2,1
0,213,213,1,1,0,1,0
4,265,265,23,15,8,2,1
2,344,344,22,11,11,2,1
5,394,394,12,6,6,2,1
8,438,438,31,31,0,1,0
7,441,441,25,13,12,2,1
3,474,474,30,30,0,1,0
6,493,493,87,87,0,1,0

0,342,342,68,68,0,1,0
1,348,348,25,13,12,4,3
5,370,370,66,66,0,1,0
3,404,404,10,3,7,2,1
4,426,426,43,43,0,1,0
2,498,498,15,15,0,1,0

2,235,235,27,1,26,2,1
1,250,250,8,8,0,1,0
4,384,384,13,13,0,1,0
3,403,403,100,23,77,4,3
5,438,438,9,9,0,1,0
0,463,463,71,5,66,4,3

4,100,100,16,16,0,1,0
0,208,208,12,12,0,1,0
1,281,281,6,1,5,2,1
7,305,305,42,5,37,2,1
6,409,409,21,21,0,1,0
3,410,410,28,28,0,1,0
5,429,429,50,50,0,1,0
2,464,464,1,1,0,1,0

3,271,271,25,25,0,1,0
4,323,323,66,3,63,4,3
0,373,373,51,51,0,1,0
1,387,387,51,51,0,1,0
5,390,390,3,3,0,1,0
2,445,445,15,1,14,3,2

1,104,104,2,2,0,1,0
4,104,104,12,2,10,3,2
6,122,122,24,12,12,4,3
3,179,179,13,13,0,1,0
5,200,200,17,17,0,1,0
0,265,265,11,11,0,1,0
2,389,389,21,12,9,4,3
7,461,461,12,12,0,1,0

3,119,119,26,26,0,1,0
2,235,235,2,2,0,1,0
4,260,260,22,10,12,2,1
1,264,264,36,36,0,1,0
0,425,425,70,67,3,2,1

4,163,163,1,1,0,1,0
6,191,191,17,17,0,1,0
8,234,234,51,51,0,1,0
5,244,244,5,1,4,2,1
9,264,264,5,5,0,1,0
10,264,264,18,18,0,1,0
3,312,312,9,3,6,2,1
2,381,381,4,4,0,1,0
0,391,391,17,3,14,3,2
1,401,401,17,3,14,3,2
7,421,421,25,25,0,1,0

5,156,156,9,3,6,2,1
0,188,188,11,3,8,2,1
4,200,200,31,2,29,4,3
2,247,247,4,4,0,1,0
7,270,270,15,15,0,1,0
3,404,404,14,3,11,2,1
1,415,415,16,8,8,2,1
6,480,480,94,51,43,2,1

4,210,210,8,8,0,1,0
3,230,230,1,1,0,1,0
6,240,240,23,23,0,1,0
2,242,242,19,19,0,1,0
1,284,284,10,7,3,2,1
5,316,316,2,2,0,1,0
8,358,358,56,36,20,2,1
7,361,361,20,4,16,4,3
0,454,454,63,63,0,1,0

1,182,182,19,19,0,1,0
5,214,214,3,3,0,1,0
4,284,284,26,26,0,1,0
3,327,327,66,66,0,1,0
2,401,401,39,39,0,1,0
0,408,408,41,41,0,1,0

1,179,179,2,2,0,1,0
0,196,196,59,59,0,1,0
2,252,252,7,7,0,1,0
3,273,273,73,17,56,4,3

6,123,123,22,6,16,3,2
1,172,172,1,1,0,1,0
5,185,185,5,5,0,1,0
2,274,274,30,6,24,4,3
4,349,349,36,36,0,1,0
3,420,420,24,24,0,1,0
0,491,491,63,63,0,1,0

1,104,104,4,4,0,1,0
6,106,106,8,3,5,2,1
7,111,111,7,7,0,1,0
0,144,144,18,18,0,1,0
5,176,176,31,1,30,3,2
3,277,277,19,9,10,3,2
4,384,384,17,17,0,1,0
2,481,481,12,12,0,1,0

4,173,173,2,2,0,1,0
6,173,173,30,30,0,1,0
1,211,211,1,1,0,1,0
5,213,213,16,16,0,1,0
3,289,289,70,41,29,2,1
2,290,290,8,8,0,1,0
7,352,352,21,3,18,4,3
0,419,419,6,6,0,1,0

2,206,206,32,5,27,4,3
4,300,300,1,1,0,1,0
6,311,311,74,28,46,2,1
1,373,373,23,23,0,1,0
5,409,409,25,4,21,4,3
7,409,409,1,1,0,1,0
0,437,437,24,24,0,1,0
3,453,453,12,9,3,2,1

2,108,108,8,8,0,1,0
3,153,153,7,7,0,1,0
6,210,210,40,40,0,1,0
1,247,247,6,3,3,2,1
5,410,410,40,4,36,3,2
4,437,437,61,61,0,1,0
7,445,445,7,1,6,3,2
0,490,490,8,8,0,1,0

3,126,126,1,1,0,1,0
0,127,127,26,26,0,1,0
1,279,279,27,27,0,1,0
4,279,279,68,51,17,2,1
2,332,332,19,19,0,1,0

3,192,192,17,1,16,3,2
1,361,361,54,54,0,1,0
0,440,440,133,71,62,3,2
2,484,484,32,11,21,2,1

2,108,108,15,15,0,1,0
0,121,121,11,6,5,2,1
3,183,183,4,4,0,1,0
1,232,232,17,9,8,3,2
4,389,389,22,1,21,4,3
5,450,450,102,40,62,3,2

3,172,172,17,1,16,3,2
0,179,179,46,46,0,1,0
2,188,188,7,7,0,1,0
1,264,264,2,2,0,1,0
4,386,386,40,40,0,1,0
5,434,434,46,46,0,1,0

0,259,259,16,16,0,1,0
1,290,290,70,29,41,2,1
4,301,301,14,2,12,4,3
3,417,417,81,81,0,1,0
2,489,489,31,31,0,1,0

5,101,101,9,3,6,3,2
2,162,162,10,1,9,4,3
3,182,182,39,5,34,3,2
0,327,327,51,51,0,1,0
1,356,356,30,30,0,1,0
4,449,449,4,4,0,1,0

4,109,109,16,16,0,1,0
8,132,132,1,1,0,1,0
1,191,191,6,1,5,2,1
0,316,316,14,14,0,1,0
5,328,328,6,6,0,1,0
6,371,371,10,10,0,1,0
2,373,373,12,12,0,1,0
7,443,443,119,119,0,1,0
3,480,480,13,1,12,2,1

5,114,114,15,15,0,1,0
4,115,115,7,1,6,3,2
3,187,187,23,2,21,4,3
2,190,190,11,11,0,1,0
0,250,250,51,5,46,3,2
1,453,453,18,7,11,2,1

3,184,184,15,15,0,1,0
2,242,242,19,19,0,1,0
0,263,263,23,23,0,1,0
4,282,282,42,21,21,4,3
1,292,292,63,63,0,1,0

1,122,122,24,4,20,3,2
3,262,262,21,1,20,3,2
0,328,328,36,16,20,2,1
4,343,343,29,21,8,2,1
2,348,348,49,24,25,2,1

4,174,174,6,6,0,1,0
9,177,177,2,2,0,1,0
2,182,182,15,15,0,1,0
8,192,192,32,1,31,2,1
10,223,223,29,5,24,2,1
3,238,238,28,28,0,1,0
6,268,268,2,2,0,1,0
7,297,297,5,5,0,1,0
0,323,323,12,12,0,1,0
1,481,481,1,1,0,1,0
5,489,489,2,2,0,1,0

0,103,103,21,9,12,2,1
2,106,106,3,3,0,1,0
1,144,144,3,3,0,1,0
3,196,196,10,1,9,2,1
5,261,261,55,20,35,3,2
4,265,265,6,1,5,2,1
6,288,288,21,3,18,3,2

3,135,135,3,3,0,1,0
8,139,139,22,17,5,2,1
4,230,230,22,3,19,2,1
0,249,249,2,2,0,1,0
5,348,348,19,11,8,2,1
7,382,382,25,1,24,3,2
9,438,438,38,8,30,3,2
2,474,474,12,12,0,1,0
1,480,480,1,1,0,1,0
6,498,498,46,23,23,2,1

1,168,168,39,4,35,3,2
2,196,196,5,5,0,1,0
0,212,212,6,6,0,1,0
3,301,301,5,1,4,2,1
5,372,372,29,2,27,4,3
4,411,411,42,15,27,2,1
6,455,455,57,57,0,1,0

2,189,189,3,3,0,1,0
4,222,222,3,3,0,1,0
5,266,266,54,54,0,1,0
3,300,300,27,9,18,2,1
1,331,331,92,4,88,3,2
0,486,486,5,5,0,1,0

0,117,117,21,21,0,1,0
3,171,171,32,4,28,3,2
1,222,222,27,4,23,2,1
4,248,248,23,23,0,1,0
2,435,435,11,1,10,3,2

2,100,100,1,1,0,1,0
5,110,110,25,25,0,1,0
6,157,157,3,3,0,1,0
1,275,275,46,30,16,3,2
3,426,426,17,3,14,2,1
0,433,433,36,36,0,1,0
4,454,454,28,14,14,3,2

0,138,138,42,42,0,1,0
1,151,151,3,3,0,1,0
2,160,160,42,42,0,1,0
3,237,237,5,5,0,1,0

4,100,100,2,2,0,1,0
6,109,109,14,14,0,1,0
1,141,141,2,2,0,1,0
3,176,176,15,15,0,1,0
7,183,183,30,30,0,1,0
2,223,223,1,1,0,1,0
0,409,409,37,7,30,4,3
8,414,414,7,7,0,1,0
5,454,454,39,24,15,2,1

1,192,192,45,7,38,4,3
3,205,205,37,37,0,1,0
0,242,242,16,3,13,2,1
2,246,246,19,16,3,2,1
4,363,363,19,3,16,4,3

2,118,118,27,1,26,3,2
3,136,136,17,17,0,1,0
5,177,177,5,5,0,1,0
0,279,279,6,2,4,2,1
1,341,341,19,19,0,1,0
4,470,470,72,18,54,3,2

3,163,163,11,11,0,1,0
7,168,168,5,1,4,2,1
9,213,213,27,27,0,1,0
0,308,308,14,14,0,1,0
5,366,366,2,2,0,1,0
8,367,367,54,11,43,2,1
10,388,388,12,12,0,1,0
2,390,390,1,1,0,1,0
6,450,450,11,11,0,1,0
1,458,458,7,4,3,2,1
4,465,465,53,53,0,1,0

6,150,150,13,5,8,3,2
1,203,203,11,11,0,1,0
2,250,250,16,16,0,1,0
4,323,323,51,51,0,1,0
5,357,357,23,23,0,1,0
0,461,461,47,47,0,1,0
3,496,496,40,10,30,3,2

5,234,234,24,24,0,1,0
1,322,322,1,1,0,1,0
4,362,362,25,25,0,1,0
0,396,396,25,25,0,1,0
2,403,403,95,17,78,4,3
3,446,446,60,43,17,2,1

11,116,116,15,3,12,3,2
10,131,131,6,6,0,1,0
1,143,143,1,1,0,1,0
7,186,186,15,15,0,1,0
6,193,193,6,6,0,1,0
2,210,210,1,1,0,1,0
9,267,267,38,14,24,4,3
4,326,326,3,3,0,1,0
5,374,374,18,5,13,2,1
0,417,417,8,8,0,1,0
3,447,447,37,26,11,2,1
8,467,467,9,9,0,1,0

3,198,198,17,17,0,1,0
2,257,257,4,4,0,1,0
1,307,307,44,44,0,1,0
0,327,327,47,18,29,2,1
4,333,333,16,4,12,3,2
5,361,361,63,63,0,1,0

2,274,274,11,3,8,3,2
4,300,300,27,9,18,3,2
5,317,317,92,92,0,1,0
1,346,346,53,1,52,3,2
0,366,366,1,1,0,1,0
7,404,404,3,3,0,1,0
3,454,454,7,7,0,1,0
6,479,479,3,3,0,1,0

2,166,166,12,12,0,1,0
3,171,171,23,13,10,3,2
0,214,214,5,5,0,1,0
1,367,367,75,39,36,2,1
4,375,375,48,10,38,3,2
5,405,405,17,17,0,1,0

4,140,140,23,5,18,2,1
1,185,185,23,23,0,1,0
0,280,280,9,6,3,2,1
5,357,357,14,1,13,2,1
3,372,372,39,36,3,2,1
2,432,432,63,31,32,3,2

2,109,109,4,4,0,1,0
1,150,150,2,2,0,1,0
6,209,209,6,6,0,1,0
4,248,248,2,2,0,1,0
9,268,268,42,42,0,1,0
8,306,306,39,26,13,2,1
5,323,323,37,37,0,1,0
3,437,437,5,2,3,2,1
0,451,451,41,12,29,3,2
7,473,473,11,11,0,1,0

4,245,245,13,13,0,1,0
2,272,272,27,27,0,1,0
3,285,285,44,44,0,1,0
0,349,349,57,35,22,4,3
1,368,368,51,15,36,2,1

3,174,174,27,5,22,3,2
2,323,323,28,28,0,1,0
0,345,345,104,104,0,1,0
1,430,430,29,8,21,4,3

5,163,163,13,4,9,4,3
1,243,243,4,1,3,2,1
6,257,257,41,41,0,1,0
4,276,276,18,9,9,4,3
3,286,286,68,29,39,4,3
0,375,375,12,12,0,1,0
2,406,406,6,6,0,1,0

1,196,196,3,3,0,1,0
5,213,213,28,23,5,2,1
0,290,290,38,38,0,1,0
3,309,309,2,2,0,1,0
6,383,383,28,20,8,3,2
2,407,407,61,39,22,3,2
4,433,433,43,43,0,1,0

4,106,106,16,4,12,2,1
3,109,109,3,3,0,1,0
2,351,351,47,8,39,4,3
0,414,414,1,1,0,1,0
1,460,460,137,67,70,3,2

1,179,179,9,9,0,1,0
4,223,223,10,10,0,1,0
5,328,328,19,19,0,1,0
0,411,411,70,42,28,3,2
3,425,425,86,48,38,3,2
2,455,455,37,37,0,1,0

5,129,129,20,20,0,1,0
4,175,175,4,4,0,1,0
3,272,272,21,21,0,1,0
6,384,384,50,8,42,4,3
0,391,391,37,37,0,1,0
1,397,397,39,39,0,1,0
2,493,493,15,7,8,3,2

5,109,109,1,1,0,1,0
0,121,121,9,9,0,1,0
2,133,133,1,1,0,1,0
3,153,153,25,25,0,1,0
4,258,258,13,13,0,1,0
1,259,259,2,2,0,1,0
6,263,263,49,49,0,1,0
7,400,400,44,10,34,3,2

0,110,110,8,8,0,1,0
3,248,248,30,30,0,1,0
5,312,312,56,42,14,4,3
1,354,354,31,17,14,3,2
4,372,372,2,2,0,1,0
2,441,441,62,12,50,3,2

1,162,162,18,18,0,1,0
4,253,253,9,1,8,2,1
2,285,285,17,17,0,1,0
0,340,340,66,40,26,4,3
3,395,395,83,44,39,4,3

3,113,113,1,1,0,1,0
0,239,239,57,12,45,2,1
2,291,291,20,1,19,3,2
4,296,296,67,45,22,3,2
1,401,401,25,1,24,4,3

2,109,109,15,9,6,2,1
5,235,235,19,19,0,1,0
0,344,344,27,27,0,1,0
3,380,380,17,10,7,2,1
1,391,391,34,11,23,2,1
4,433,433,78,62,16,3,2

2,127,127,8,2,6,2,1
6,167,167,31,12,19,2,1
3,173,173,11,11,0,1,0
4,194,194,2,2,0,1,0
7,204,204,17,6,11,2,1
0,221,221,21,21,0,1,0
1,239,239,17,5,12,4,3
5,472,472,16,16,0,1,0

1,106,106,6,6,0,1,0
7,148,148,17,9,8,3,2
8,220,220,24,18,6,3,2
4,240,240,5,5,0,1,0
0,308,308,15,15,0,1,0
5,370,370,4,4,0,1,0
6,370,370,29,6,23,2,1
2,376,376,15,11,4,2,1
3,396,396,49,49,0,1,0

2,106,106,3,3,0,1,0
3,141,141,34,34,0,1,0
0,231,231,32,32,0,1,0
4,379,379,11,5,6,3,2
1,392,392,55,26,29,2,1
5,397,397,14,14,0,1,0

2,113,113,15,15,0,1,0
4,114,114,17,10,7,2,1
0,255,255,12,3,9,2,1
5,392,392,39,7,32,3,2
3,410,410,23,23,0,1,0
1,435,435,54,45,9,2,1

7,119,119,6,6,0,1,0
2,155,155,9,1,8,3,2
5,216,216,2,2,0,1,0
6,251,251,63,63,0,1,0
3,328,328,7,7,0,1,0
1,426,426,67,52,15,2,1
0,433,433,6,2,4,2,1
4,439,439,22,19,3,2,1

2,195,195,28,14,14,3,2
0,219,219,66,51,15,4,3
3,231,231,30,30,0,1,0
1,275,275,9,9,0,1,0

0,138,138,8,1,7,2,1
9,227,227,23,3,20,2,1
8,236,236,38,2,36,2,1
1,243,243,32,1,31,2,1
2,244,244,4,1,3,2,1
3,266,266,7,7,0,1,0
7,292,292,12,12,0,1,0
4,420,420,2,2,0,1,0
5,424,424,26,21,5,2,1
6,461,461,1,1,0,1,0

1,127,127,25,6,19,2,1
4,202,202,5,5,0,1,0
2,238,238,10,10,0,1,0
5,276,276,57,57,0,1,0
3,309,309,24,12,12,4,3
0,492,492,32,32,0,1,0

3,196,196,1,1,0,1,0
5,208,208,17,9,8,2,1
6,240,240,38,16,22,2,1
2,252,252,9,9,0,1,0
4,269,269,1,1,0,1,0
7,283,283,5,5,0,1,0
0,345,345,33,9,24,2,1
1,394,394,32,2,30,3,2
8,490,490,63,63,0,1,0

7,101,101,6,6,0,1,0
0,124,124,20,20,0,1,0
2,134,134,5,5,0,1,0
4,135,135,2,2,0,1,0
5,150,150,5,5,0,1,0
6,211,211,45,3,42,2,1
3,258,258,9,9,0,1,0
1,480,480,26,14,12,2,1

6,100,100,12,12,0,1,0
7,134,134,24,12,12,4,3
0,255,255,1,1,0,1,0
2,269,269,1,1,0,1,0
5,316,316,35,35,0,1,0
8,397,397,5,2,3,2,1
3,448,448,18,9,9,2,1
1,453,453,52,3,49,4,3
4,497,497,14,5,9,4,3

1,225,225,37,20,17,2,1
0,243,243,26,2,24,3,2
4,252,252,40,30,10,3,2
6,266,266,25,25,0,1,0
5,274,274,14,14,0,1,0
2,291,291,5,5,0,1,0
3,462,462,6,2,4,2,1

2,211,211,20,7,13,2,1
3,435,435,76,76,0,1,0
1,471,471,85,85,0,1,0
4,473,473,17,17,0,1,0
0,484,484,58,11,47,4,3

7,119,119,18,18,0,1,0
1,248,248,1,1,0,1,0
0,353,353,47,15,32,4,3
4,426,426,33,33,0,1,0
2,427,427,17,6,11,2,1
6,456,456,37,9,28,3,2
5,492,492,38,9,29,2,1
3,500,500,23,23,0,1,0

3,115,115,15,15,0,1,0
5,235,235,41,41,0,1,0
4,268,268,7,7,0,1,0
2,276,276,22,22,0,1,0
1,290,290,14,14,0,1,0
7,379,379,3,3,0,1,0
0,465,465,8,8,0,1,0
6,475,475,58,26,32,2,1

0,126,126,27,27,0,1,0
6,143,143,11,4,7,2,1
5,165,165,5,5,0,1,0
1,191,191,1,1,0,1,0
3,349,349,9,9,0,1,0
2,427,427,24,12,12,4,3
4,483,483,98,98,0,1,0

3,111,111,1,1,0,1,0
0,139,139,23,23,0,1,0
2,155,155,7,4,3,2,1
5,159,159,9,5,4,2,1
6,183,183,34,29,5,2,1
1,201,201,10,7,3,2,1
7,436,436,28,12,16,2,1
4,490,490,15,15,0,1,0

0,176,176,53,53,0,1,0
3,287,287,24,24,0,1,0
1,292,292,21,21,0,1,0
2,432,432,64,64,0,1,0

1,139,139,3,3,0,1,0
0,185,185,11,11,0,1,0
4,253,253,15,10,5,2,1
5,323,323,26,19,7,2,1
6,387,387,75,75,0,1,0
3,420,420,8,8,0,1,0
7,459,459,14,8,6,2,1
2,467,467,66,58,8,2,1

4,101,101,9,3,6,2,1
2,108,108,6,3,3,2,1
0,353,353,28,2,26,3,2
3,401,401,67,36,31,2,1
1,471,471,104,32,72,4,3

3,153,153,23,23,0,1,0
5,235,235,12,12,0,1,0
2,357,357,40,31,9,4,3
4,420,420,43,12,31,2,1
0,435,435,6,6,0,1,0
1,492,492,86,6,80,3,2

4,112,112,14,14,0,1,0
6,263,263,3,3,0,1,0
1,275,275,50,14,36,3,2
0,384,384,5,5,0,1,0
2,463,463,10,10,0,1,0
3,470,470,40,30,10,2,1
5,494,494,85,85,0,1,0

2,126,126,13,4,9,4,3
5,182,182,10,4,6,3,2
0,207,207,2,2,0,1,0
1,266,266,10,4,6,3,2
3,402,402,23,23,0,1,0
6,425,425,58,58,0,1,0
4,426,426,16,16,0,1,0
8,474,474,73,73,0,1,0
7,499,499,6,2,4,2,1

2,141,141,1,1,0,1,0
1,215,215,25,16,9,2,1
3,235,235,39,5,34,2,1
6,306,306,53,53,0,1,0
5,341,341,4,4,0,1,0
4,399,399,2,2,0,1,0
7,457,457,54,12,42,4,3
0,486,486,3,3,0,1,0

3,222,222,20,11,9,4,3
4,301,301,38,38,0,1,0
5,311,311,28,28,0,1,0
0,406,406,67,34,33,2,1
2,412,412,10,10,0,1,0
1,472,472,53,29,24,3,2

5,157,157,14,8,6,2,1
0,185,185,32,14,18,4,3
3,226,226,20,7,13,2,1
1,416,416,5,2,3,2,1
2,468,468,54,54,0,1,0
4,490,490,64,7,57,4,3

3,127,127,4,1,3,2,1
0,237,237,13,1,12,4,3
2,279,279,16,16,0,1,0
4,286,286,38,12,26,2,1
5,306,306,45,36,9,4,3
1,439,439,83,34,49,2,1

5,272,272,31,26,5,2,1
3,297,297,36,2,34,3,2
4,325,325,23,23,0,1,0
2,342,342,11,11,0,1,0
1,343,343,82,33,49,4,3
0,346,346,10,4,6,2,1

1,155,155,7,7,0,1,0
0,209,209,47,47,0,1,0
2,409,409,13,1,12,2,1
3,413,413,25,25,0,1,0
4,414,414,37,37,0,1,0
5,469,469,72,72,0,1,0

2,109,109,14,14,0,1,0
4,209,209,29,11,18,3,2
5,260,260,9,9,0,1,0
1,321,321,53,39,14,2,1
0,323,323,5,2,3,2,1
3,445,445,57,27,30,3,2

6,217,217,10,2,8,3,2
4,220,220,2,2,0,1,0
3,350,350,20,12,8,3,2
2,369,369,61,17,44,4,3
5,411,411,103,96,7,2,1
1,444,444,24,13,11,2,1
0,457,457,12,7,5,2,1

3,182,182,27,27,0,1,0
2,304,304,3,3,0,1,0
5,324,324,4,4,0,1,0
4,330,330,48,4,44,2,1
1,413,413,113,101,12,2,1
0,446,446,8,8,0,1,0

6,131,131,12,12,0,1,0
3,164,164,20,4,16,2,1
1,190,190,6,6,0,1,0
5,227,227,1,1,0,1,0
8,287,287,47,47,0,1,0
0,311,311,3,3,0,1,0
7,396,396,21,21,0,1,0
4,414,414,40,20,20,2,1
2,435,435,17,8,9,2,1

5,158,158,19,19,0,1,0
0,212,212,36,19,17,2,1
4,224,224,32,10,22,3,2
1,381,381,34,34,0,1,0
3,425,425,19,7,12,4,3
2,442,442,19,12,7,2,1

0,102,102,1,1,0,1,0
5,207,207,14,1,13,2,1
7,252,252,39,39,0,1,0
6,291,291,24,24,0,1,0
1,295,295,7,7,0,1,0
4,303,303,6,2,4,2,1
3,319,319,2,2,0,1,0
2,497,497,121,121,0,1,0

4,115,115,4,4,0,1,0
0,249,249,46,11,35,2,1
3,364,364,8,8,0,1,0
2,371,371,2,2,0,1,0
1,446,446,40,2,38,3,2
6,448,448,35,19,16,3,2
5,494,494,97,64,33,3,2

6,125,125,13,8,5,2,1
2,140,140,16,16,0,1,0
0,207,207,3,3,0,1,0
8,218,218,38,26,12,4,3
3,220,220,5,5,0,1,0
1,269,269,19,19,0,1,0
7,283,283,9,6,3,2,1
4,308,308,17,3,14,2,1
5,313,313,8,8,0,1,0

2,108,108,6,6,0,1,0
1,194,194,18,18,0,1,0
4,362,362,17,6,11,3,2
0,430,430,66,66,0,1,0
3,438,438,30,30,0,1,0
5,488,488,92,92,0,1,0

3,154,154,29,7,22,2,1
4,171,171,7,7,0,1,0
2,324,324,26,26,0,1,0
1,332,332,8,5,3,2,1
0,409,409,114,21,93,4,3

4,164,164,30,30,0,1,0
5,222,222,3,3,0,1,0
0,229,229,24,1,23,2,1
2,294,294,56,40,16,2,1
1,402,402,2,2,0,1,0
3,471,471,53,53,0,1,0

4,114,114,3,3,0,1,0
3,156,156,1,1,0,1,0
0,444,444,56,17,39,4,3
1,461,461,81,81,0,1,0
2,499,499,138,138,0,1,0

2,102,102,15,15,0,1,0
0,184,184,1,1,0,1,0
1,212,212,21,21,0,1,0
6,297,297,5,2,3,2,1
4,335,335,15,15,0,1,0
5,390,390,17,2,15,2,1
7,473,473,115,86,29,2,1
3,487,487,3,3,0,1,0

3,122,122,6,1,5,2,1
4,191,191,42,2,40,3,2
2,290,290,11,4,7,2,1
0,442,442,36,36,0,1,0
1,477,477,105,63,42,4,3

2,138,138,4,4,0,1,0
6,151,151,3,3,0,1,0
3,153,153,13,9,4,2,1
7,160,160,38,38,0,1,0
4,182,182,14,3,11,2,1
5,248,248,1,1,0,1,0
8,293,293,14,14,0,1,0
1,297,297,26,8,18,4,3
0,325,325,7,7,0,1,0

2,151,151,10,10,0,1,0
3,154,154,18,10,8,2,1
4,160,160,8,8,0,1,0
6,246,246,3,3,0,1,0
1,275,275,15,15,0,1,0
5,391,391,18,18,0,1,0
0,447,447,8,2,6,2,1
7,462,462,113,102,11,2,1

10,120,120,31,23,8,3,2
6,183,183,1,1,0,1,0
7,185,185,8,8,0,1,0
5,224,224,6,6,0,1,0
9,229,229,7,1,6,3,2
1,289,289,3,3,0,1,0
3,306,306,2,2,0,1,0
4,323,323,4,4,0,1,0
0,380,380,28,4,24,4,3
8,380,380,7,7,0,1,0
2,468,468,59,15,44,2,1

2,261,261,24,6,18,2,1
0,276,276,47,24,23,2,1
3,381,381,11,11,0,1,0
1,423,423,55,39,16,2,1
4,455,455,85,85,0,1,0

1,171,171,26,4,22,3,2
3,174,174,34,34,0,1,0
4,179,179,19,19,0,1,0
2,194,194,2,2,0,1,0
0,441,441,67,49,18,4,3

0,171,171,41,41,0,1,0
2,183,183,33,33,0,1,0
3,184,184,4,4,0,1,0
4,186,186,20,20,0,1,0
1,349,349,22,22,0,1,0

1,156,156,38,38,0,1,0
0,164,164,10,10,0,1,0
2,352,352,7,7,0,1,0
4,383,383,47,47,0,1,0
3,471,471,77,77,0,1,0

7,101,101,15,2,13,2,1
3,110,110,2,2,0,1,0
0,230,230,4,4,0,1,0
1,247,247,1,1,0,1,0
2,288,288,1,1,0,1,0
8,304,304,13,13,0,1,0
9,330,330,38,38,0,1,0
5,368,368,10,2,8,3,2
4,428,428,93,93,0,1,0
6,455,455,6,6,0,1,0

1,142,142,8,8,0,1,0
4,174,174,27,27,0,1,0
0,233,233,32,32,0,1,0
5,300,300,19,19,0,1,0
2,357,357,17,17,0,1,0
3,401,401,24,24,0,1,0
6,407,407,36,8,28,2,1

6,131,131,3,3,0,1,0
4,134,134,25,12,13,2,1
0,143,143,3,3,0,1,0
2,303,303,1,1,0,1,0
3,319,319,51,8,43,2,1
1,465,465,55,55,0,1,0
5,470,470,47,8,39,4,3

4,102,102,2,2,0,1,0
9,169,169,13,13,0,1,0
2,184,184,10,2,8,3,2
5,217,217,28,25,3,2,1
1,337,337,6,6,0,1,0
3,341,341,16,16,0,1,0
8,343,343,13,13,0,1,0
6,375,375,6,6,0,1,0
7,423,423,80,1,79,4,3
0,500,500,9,6,3,2,1

2,132,132,12,12,0,1,0
0,179,179,19,2,17,4,3
1,218,218,12,1,11,2,1
3,300,300,15,3,12,2,1
4,329,329,42,19,23,2,1
5,359,359,25,25,0,1,0
6,460,460,50,50,0,1,0

0,309,309,31,31,0,1,0
2,316,316,36,36,0,1,0
1,334,334,29,7,22,3,2
3,364,364,27,1,26,4,3
4,378,378,11,7,4,2,1
5,411,411,82,82,0,1,0

3,111,111,14,14,0,1,0
0,160,160,17,17,0,1,0
4,238,238,33,33,0,1,0
5,270,270,10,10,0,1,0
1,333,333,23,23,0,1,0
2,405,405,51,51,0,1,0

3,153,153,17,17,0,1,0
2,246,246,20,20,0,1,0
1,278,278,38,2,36,4,3
0,316,316,52,52,0,1,0
4,414,414,47,47,0,1,0

5,123,123,20,9,11,2,1
6,174,174,1,1,0,1,0
2,214,214,16,16,0,1,0
1,253,253,43,43,0,1,0
4,327,327,47,47,0,1,0
0,345,345,9,9,0,1,0
3,421,421,13,13,0,1,0

2,199,199,1,1,0,1,0
3,211,211,3,3,0,1,0
4,230,230,42,42,0,1,0
5,247,247,23,11,12,3,2
0,291,291,17,8,9,4,3
1,295,295,12,4,8,2,1
6,380,380,34,11,23,3,2
7,381,381,47,47,0,1,0

2,261,261,24,24,0,1,0
1,269,269,17,3,14,3,2
3,279,279,31,19,12,2,1
4,406,406,42,42,0,1,0
0,487,487,117,67,50,4,3

9,166,166,23,23,0,1,0
0,194,194,12,4,8,2,1
2,207,207,1,1,0,1,0
3,262,262,7,1,6,3,2
5,265,265,2,2,0,1,0
6,317,317,7,7,0,1,0
4,368,368,40,4,36,4,3
8,371,371,19,8,11,2,1
7,446,446,52,6,46,4,3
1,480,480,33,33,0,1,0

0,114,114,3,3,0,1,0
4,171,171,28,23,5,2,1
2,343,343,38,38,0,1,0
5,396,396,5,2,3,2,1
1,440,440,72,11,61,4,3
3,488,488,62,62,0,1,0

3,160,160,16,16,0,1,0
5,261,261,8,8,0,1,0
2,316,316,83,53,30,4,3
0,382,382,7,7,0,1,0
4,386,386,68,68,0,1,0
1,459,459,10,2,8,3,2

3,119,119,30,4,26,2,1
0,261,261,71,21,50,3,2
1,359,359,11,11,0,1,0
2,402,402,6,3,3,2,1
4,421,421,16,16,0,1,0

5,130,130,27,27,0,1,0
2,335,335,41,41,0,1,0
4,368,368,21,21,0,1,0
1,388,388,6,6,0,1,0
6,423,423,19,19,0,1,0
3,474,474,60,18,42,3,2
0,476,476,17,17,0,1,0

5,114,114,16,16,0,1,0
1,289,289,48,48,0,1,0
3,298,298,25,25,0,1,0
0,311,311,29,1,28,2,1
4,349,349,29,9,20,3,2
2,470,470,20,20,0,1,0

7,101,101,15,2,13,2,1
5,103,103,1,1,0,1,0
1,135,135,21,12,9,4,3
8,174,174,16,16,0,1,0
9,217,217,15,15,0,1,0
6,319,319,3,3,0,1,0
4,389,389,13,5,8,2,1
0,399,399,2,2,0,1,0
3,420,420,11,11,0,1,0
2,476,476,30,30,0,1,0

6,106,106,5,5,0,1,0
5,137,137,9,9,0,1,0
0,139,139,6,3,3,2,1
2,256,256,24,24,0,1,0
1,382,382,4,4,0,1,0
3,386,386,59,44,15,4,3
4,453,453,92,82,10,2,1

0,126,126,2,2,0,1,0
5,141,141,24,18,6,3,2
4,153,153,8,2,6,2,1
1,185,185,27,27,0,1,0
3,199,199,11,1,10,2,1
2,228,228,20,3,17,3,2
6,366,366,31,23,8,2,1

0,109,109,1,1,0,1,0
4,166,166,5,5,0,1,0
8,210,210,54,54,0,1,0
1,282,282,13,13,0,1,0
7,327,327,9,9,0,1,0
2,397,397,15,5,10,2,1
5,401,401,55,55,0,1,0
6,422,422,9,9,0,1,0
3,444,444,18,18,0,1,0

4,178,178,2,2,0,1,0
3,288,288,18,18,0,1,0
0,298,298,51,46,5,2,1
1,329,329,14,14,0,1,0
5,412,412,95,25,70,3,2
2,467,467,41,14,27,4,3

5,144,144,15,15,0,1,0
6,149,149,2,2,0,1,0
4,247,247,31,3,28,3,2
3,256,256,9,9,0,1,0
0,356,356,12,12,0,1,0
2,359,359,7,7,0,1,0
7,390,390,75,17,58,4,3
1,478,478,42,42,0,1,0

4,109,109,8,8,0,1,0
3,117,117,8,8,0,1,0
0,200,200,23,23,0,1,0
8,201,201,10,1,9,4,3
7,266,266,8,8,0,1,0
6,295,295,67,40,27,4,3
2,347,347,1,1,0,1,0
1,419,419,15,15,0,1,0
5,427,427,2,2,0,1,0

5,100,100,9,4,5,2,1
2,128,128,8,8,0,1,0
3,141,141,15,1,14,2,1
4,248,248,29,14,15,4,3
0,357,357,61,31,30,2,1
1,372,372,25,14,11,2,1

0,165,165,6,6,0,1,0
1,168,168,14,9,5,2,1
3,197,197,35,4,31,2,1
2,200,200,1,1,0,1,0
4,291,291,47,31,16,2,1
6,359,359,6,6,0,1,0
5,494,494,62,18,44,3,2

3,235,235,18,12,6,3,2
0,270,270,37,37,0,1,0
5,271,271,35,27,8,3,2
1,421,421,7,7,0,1,0
4,448,448,44,44,0,1,0
2,486,486,72,48,24,4,3

2,128,128,2,2,0,1,0
0,183,183,35,35,0,1,0
1,247,247,17,14,3,2,1
3,286,286,7,7,0,1,0
4,405,405,101,3,98,3,2
6,449,449,7,7,0,1,0
5,493,493,18,18,0,1,0

4,126,126,19,13,6,3,2
2,167,167,4,4,0,1,0
6,181,181,21,21,0,1,0
0,185,185,24,24,0,1,0
5,364,364,15,15,0,1,0
3,431,431,62,14,48,3,2
1,458,458,2,2,0,1,0

3,143,143,25,25,0,1,0
4,286,286,12,12,0,1,0
1,326,326,1,1,0,1,0
5,354,354,53,4,49,4,3
2,418,418,32,12,20,3,2
0,435,435,21,17,4,2,1
6,486,486,54,54,0,1,0

1,140,140,21,21,0,1,0
3,213,213,30,30,0,1,0
0,418,418,126,99,27,4,3
2,498,498,10,6,4,2,1

0,338,338,60,60,0,1,0
2,384,384,6,6,0,1,0
4,419,419,97,29,68,3,2
3,461,461,25,25,0,1,0
1,476,476,59,59,0,1,0

0,155,155,17,17,0,1,0
4,229,229,33,33,0,1,0
5,307,307,23,1,22,3,2
2,411,411,38,6,32,3,2
3,481,481,42,42,0,1,0
1,485,485,48,48,0,1,0

2,313,313,56,56,0,1,0
0,321,321,1,1,0,1,0
5,324,324,58,58,0,1,0
3,385,385,14,14,0,1,0
4,434,434,37,15,22,3,2
1,494,494,59,59,0,1,0

2,139,139,28,4,24,4,3
4,139,139,15,15,0,1,0
1,228,228,1,1,0,1,0
3,261,261,14,14,0,1,0
5,379,379,53,53,0,1,0
0,480,480,48,48,0,1,0

4,141,141,7,7,0,1,0
2,152,152,12,12,0,1,0
6,197,197,1,1,0,1,0
7,259,259,10,10,0,1,0
8,334,334,45,12,33,4,3
9,361,361,48,23,25,2,1
0,395,395,3,3,0,1,0
3,403,403,46,46,0,1,0
5,407,407,13,13,0,1,0
1,428,428,6,6,0,1,0

10,110,110,4,4,0,1,0
2,123,123,1,1,0,1,0
7,128,128,8,8,0,1,0
3,194,194,6,1,5,2,1
5,208,208,23,23,0,1,0
1,212,212,1,1,0,1,0
0,221,221,15,1,14,2,1
9,283,283,58,46,12,3,2
6,293,293,1,1,0,1,0
4,365,365,7,4,3,2,1
8,465,465,33,33,0,1,0

0,132,132,1,1,0,1,0
7,133,133,15,7,8,2,1
1,228,228,1,1,0,1,0
3,267,267,25,25,0,1,0
6,289,289,34,34,0,1,0
2,323,323,11,4,7,2,1
8,405,405,32,6,26,2,1
4,421,421,5,5,0,1,0
5,428,428,64,20,44,2,1

0,223,223,17,3,14,3,2
5,237,237,6,6,0,1,0
7,301,301,37,37,0,1,0
3,374,374,4,4,0,1,0
6,374,374,59,59,0,1,0
4,430,430,57,21,36,2,1
1,438,438,1,1,0,1,0
2,459,459,36,10,26,2,1

1,200,200,60,24,36,4,3
2,225,225,59,32,27,4,3
4,239,239,6,6,0,1,0
0,307,307,1,1,0,1,0
3,417,417,8,2,6,3,2

4,184,184,31,31,0,1,0
3,239,239,23,23,0,1,0
6,249,249,4,4,0,1,0
2,302,302,43,37,6,3,2
1,307,307,16,16,0,1,0
5,416,416,50,35,15,4,3
0,484,484,6,6,0,1,0

6,107,107,9,9,0,1,0
1,302,302,11,11,0,1,0
0,322,322,45,45,0,1,0
7,336,336,11,1,10,2,1
2,368,368,9,3,6,2,1
5,370,370,71,59,12,4,3
3,465,465,43,34,9,2,1
4,466,466,4,1,3,2,1

5,171,171,25,5,20,2,1
2,286,286,12,12,0,1,0
3,311,311,18,18,0,1,0
0,378,378,39,39,0,1,0
4,412,412,47,47,0,1,0
6,412,412,18,18,0,1,0
1,430,430,42,42,0,1,0

4,141,141,25,25,0,1,0
1,165,165,35,35,0,1,0
3,251,251,4,4,0,1,0
2,410,410,46,28,18,3,2
0,458,458,41,41,0,1,0

6,115,115,2,2,0,1,0
7,205,205,8,8,0,1,0
0,232,232,9,9,0,1,0
9,253,253,7,3,4,2,1
3,267,267,12,3,9,4,3
5,344,344,4,4,0,1,0
8,360,360,47,29,18,4,3
4,369,369,18,18,0,1,0
1,430,430,1,1,0,1,0
10,464,464,68,21,47,2,1
2,470,470,46,28,18,3,2

3,105,105,9,1,8,3,2
2,172,172,36,36,0,1,0
0,394,394,119,68,51,4,3
1,423,423,3,3,0,1,0

0,125,125,8,8,0,1,0
4,169,169,7,7,0,1,0
3,189,189,2,2,0,1,0
2,240,240,5,1,4,2,1
6,276,276,40,25,15,2,1
5,414,414,51,51,0,1,0
1,464,464,95,53,42,4,3

3,107,107,1,1,0,1,0
7,130,130,27,27,0,1,0
8,143,143,3,3,0,1,0
1,165,165,6,6,0,1,0
5,167,167,8,2,6,3,2
2,211,211,26,4,22,3,2
6,289,289,23,23,0,1,0
0,394,394,18,3,15,2,1
4,471,471,20,20,0,1,0

0,102,102,19,4,15,2,1
1,185,185,4,4,0,1,0
2,189,189,18,18,0,1,0
3,287,287,20,20,0,1,0
4,332,332,71,63,8,3,2
5,498,498,11,1,10,3,2

4,193,193,11,4,7,2,1
1,217,217,41,41,0,1,0
0,251,251,16,16,0,1,0
2,315,315,15,8,7,2,1
5,400,400,76,10,66,4,3
3,487,487,27,27,0,1,0

0,139,139,4,4,0,1,0
4,307,307,50,32,18,4,3
5,323,323,18,18,0,1,0
2,357,357,2,2,0,1,0
3,433,433,37,28,9,2,1
1,470,470,125,95,30,2,1

0,207,207,9,9,0,1,0
7,248,248,19,19,0,1,0
5,262,262,23,8,15,4,3
2,297,297,54,54,0,1,0
1,367,367,14,14,0,1,0
6,377,377,53,11,42,3,2
4,438,438,16,7,9,4,3
3,465,465,1,1,0,1,0

4,126,126,1,1,0,1,0
0,153,153,18,18,0,1,0
8,210,210,18,6,12,2,1
1,245,245,4,4,0,1,0
7,308,308,54,21,33,4,3
2,356,356,21,9,12,2,1
6,412,412,19,3,16,2,1
5,428,428,42,42,0,1,0
3,487,487,1,1,0,1,0

0,159,159,1,1,0,1,0
2,162,162,33,3,30,4,3
3,403,403,39,39,0,1,0
4,409,409,46,28,18,4,3
1,423,423,39,3,36,4,3
5,471,471,44,44,0,1,0

4,238,238,29,19,10,3,2
2,248,248,1,1,0,1,0
1,282,282,40,19,21,4,3
0,323,323,25,25,0,1,0
6,344,344,5,5,0,1,0
5,458,458,76,54,22,2,1
3,487,487,38,38,0,1,0

10,155,155,15,4,11,2,1
2,188,188,2,2,0,1,0
12,202,202,6,6,0,1,0
4,256,256,9,9,0,1,0
0,288,288,2,2,0,1,0
1,317,317,7,2,5,2,1
7,333,333,1,1,0,1,0
3,363,363,16,6,10,2,1
5,371,371,1,1,0,1,0
9,430,430,20,11,9,4,3
8,467,467,20,10,10,3,2
11,483,483,87,78,9,2,1
6,487,487,43,43,0,1,0

4,146,146,10,5,5,2,1
1,165,165,23,11,12,4,3
5,185,185,3,3,0,1,0
6,223,223,50,50,0,1,0
0,243,243,4,4,0,1,0
2,451,451,52,52,0,1,0
3,451,451,14,14,0,1,0

9,100,100,4,1,3,2,1
8,140,140,15,1,14,2,1
5,194,194,3,3,0,1,0
4,199,199,16,2,14,3,2
1,244,244,6,6,0,1,0
7,256,256,5,5,0,1,0
0,305,305,39,39,0,1,0
10,391,391,64,64,0,1,0
3,413,413,7,7,0,1,0
6,418,418,1,1,0,1,0
2,464,464,7,1,6,3,2

0,114,114,5,5,0,1,0
1,155,155,40,29,11,2,1
2,180,180,49,13,36,3,2
4,407,407,9,9,0,1,0
3,408,408,5,5,0,1,0

4,122,122,7,7,0,1,0
0,144,144,29,4,25,3,2
1,402,402,32,32,0,1,0
3,448,448,45,15,30,2,1
2,464,464,9,9,0,1,0
5,494,494,71,71,0,1,0

0,163,163,24,24,0,1,0
2,201,201,16,2,14,3,2
1,273,273,42,28,14,2,1
3,323,323,29,29,0,1,0
4,459,459,62,62,0,1,0

2,102,102,17,1,16,4,3
1,154,154,15,15,0,1,0
5,304,304,9,1,8,3,2
4,326,326,88,70,18,4,3
3,332,332,2,2,0,1,0
0,380,380,14,14,0,1,0

8,102,102,6,6,0,1,0
3,115,115,2,2,0,1,0
7,182,182,32,2,30,2,1
5,296,296,8,8,0,1,0
1,304,304,11,3,8,2,1
0,330,330,36,10,26,3,2
6,355,355,25,20,5,2,1
2,365,365,18,3,15,2,1
4,489,489,30,18,12,2,1

2,107,107,18,6,12,2,1
0,169,169,41,9,32,2,1
4,230,230,27,15,12,4,3
3,313,313,7,7,0,1,0
1,362,362,21,21,0,1,0

4,137,137,1,1,0,1,0
6,152,152,6,6,0,1,0
9,204,204,4,4,0,1,0
5,222,222,8,8,0,1,0
1,268,268,20,8,12,2,1
8,291,291,78,6,72,4,3
7,332,332,7,7,0,1,0
3,379,379,44,44,0,1,0
0,445,445,1,1,0,1,0
2,448,448,11,5,6,2,1

0,185,185,3,3,0,1,0
1,214,214,43,23,20,3,2
3,220,220,8,8,0,1,0
5,268,268,61,61,0,1,0
4,272,272,12,12,0,1,0
2,323,323,27,27,0,1,0

0,171,171,17,2,15,2,1
3,182,182,5,5,0,1,0
7,199,199,16,12,4,2,1
4,267,267,32,6,26,2,1
8,275,275,24,6,18,4,3
9,324,324,45,23,22,2,1
6,354,354,10,10,0,1,0
1,381,381,1,1,0,1,0
2,468,468,1,1,0,1,0
5,491,491,11,2,9,4,3

0,148,148,28,18,10,2,1
2,226,226,26,26,0,1,0
1,284,284,32,32,0,1,0
3,433,433,60,60,0,1,0
4,481,481,24,24,0,1,0

1,103,103,1,1,0,1,0
3,163,163,28,7,21,4,3
2,202,202,26,26,0,1,0
0,272,272,82,82,0,1,0

1,142,142,6,6,0,1,0
6,205,205,7,7,0,1,0
10,213,213,14,14,0,1,0
5,241,241,1,1,0,1,0
8,268,268,16,2,14,3,2
3,310,310,5,5,0,1,0
0,388,388,54,54,0,1,0
4,398,398,8,8,0,1,0
9,462,462,83,35,48,4,3
2,470,470,14,5,9,4,3
7,492,492,8,8,0,1,0

3,155,155,10,10,0,1,0
0,173,173,36,29,7,2,1
2,304,304,4,4,0,1,0
1,374,374,7,1,6,3,2
4,405,405,23,23,0,1,0
5,436,436,30,30,0,1,0
6,488,488,87,78,9,2,1

3,154,154,29,29,0,1,0
1,215,215,5,2,3,2,1
0,323,323,97,10,87,4,3
2,348,348,33,19,14,3,2

4,106,106,1,1,0,1,0
2,159,159,1,1,0,1,0
0,171,171,5,5,0,1,0
3,235,235,21,13,8,2,1
1,266,266,1,1,0,1,0
5,376,376,31,13,18,3,2
7,378,378,4,1,3,2,1
9,387,387,36,3,33,2,1
10,407,407,57,36,21,4,3
8,423,423,30,30,0,1,0
6,479,479,33,33,0,1,0

6,132,132,21,21,0,1,0
3,155,155,3,3,0,1,0
5,261,261,18,18,0,1,0
4,313,313,24,24,0,1,0
0,415,415,27,19,8,3,2
1,464,464,53,29,24,4,3
2,464,464,48,42,6,2,1

4,213,213,33,33,0,1,0
1,221,221,30,30,0,1,0
3,237,237,3,3,0,1,0
2,250,250,19,3,16,3,2
6,311,311,29,8,21,2,1
0,391,391,31,31,0,1,0
5,482,482,29,1,28,3,2

5,115,115,2,2,0,1,0
0,124,124,15,15,0,1,0
3,146,146,8,3,5,2,1
1,242,242,6,6,0,1,0
2,268,268,28,28,0,1,0
4,472,472,86,86,0,1,0
6,497,497,52,7,45,4,3

5,174,174,26,26,0,1,0
0,222,222,27,27,0,1,0
1,294,294,4,1,3,2,1
2,323,323,54,54,0,1,0
3,373,373,13,13,0,1,0
4,374,374,45,45,0,1,0

3,111,111,14,14,0,1,0
2,261,261,5,5,0,1,0
1,452,452,74,74,0,1,0
0,498,498,150,96,54,3,2

3,109,109,3,3,0,1,0
0,242,242,13,13,0,1,0
6,319,319,11,11,0,1,0
5,357,357,50,18,32,3,2
7,378,378,49,49,0,1,0
4,383,383,14,14,0,1,0
1,408,408,7,7,0,1,0
2,447,447,74,24,50,4,3

2,273,273,13,3,10,2,1
3,319,319,38,38,0,1,0
0,418,418,126,126,0,1,0
1,466,466,65,65,0,1,0

0,186,186,56,56,0,1,0
3,206,206,5,5,0,1,0
2,302,302,84,32,52,4,3
1,353,353,1,1,0,1,0

1,109,109,23,23,0,1,0
4,125,125,8,8,0,1,0
3,187,187,30,13,17,2,1
5,231,231,20,20,0,1,0
2,250,250,11,3,8,2,1
0,306,306,14,14,0,1,0

4,192,192,26,5,21,2,1
5,196,196,33,33,0,1,0
1,243,243,16,16,0,1,0
6,343,343,20,11,9,4,3
3,399,399,4,4,0,1,0
2,458,458,15,3,12,2,1
7,488,488,40,1,39,2,1
0,495,495,28,21,7,2,1

2,121,121,1,1,0,1,0
0,179,179,9,5,4,2,1
1,215,215,4,1,3,2,1
8,232,232,7,7,0,1,0
3,260,260,1,1,0,1,0
6,317,317,30,30,0,1,0
4,382,382,9,9,0,1,0
7,459,459,82,73,9,2,1
5,493,493,97,33,64,3,2

3,121,121,9,9,0,1,0
4,147,147,1,1,0,1,0
6,256,256,73,11,62,3,2
2,346,346,6,6,0,1,0
0,356,356,9,9,0,1,0
1,386,386,71,29,42,2,1
5,421,421,6,1,5,2,1

2,208,208,6,2,4,2,1
5,265,265,5,2,3,2,1
4,288,288,69,23,46,3,2
0,328,328,65,20,45,2,1
1,460,460,27,27,0,1,0
3,464,464,7,7,0,1,0
6,473,473,23,5,18,3,2

0,102,102,6,6,0,1,0
4,166,166,6,6,0,1,0
5,173,173,9,9,0,1,0
6,189,189,19,7,12,4,3
2,227,227,22,22,0,1,0
3,234,234,13,5,8,3,2
8,262,262,27,27,0,1,0
7,322,322,33,33,0,1,0
1,434,434,1,1,0,1,0

3,112,112,1,1,0,1,0
7,134,134,9,4,5,2,1
2,223,223,15,7,8,2,1
6,234,234,46,46,0,1,0
0,282,282,27,9,18,4,3
5,383,383,16,16,0,1,0
1,422,422,53,26,27,4,3
4,466,466,2,2,0,1,0

3,117,117,7,3,4,2,1
4,137,137,6,6,0,1,0
2,338,338,68,20,48,4,3
1,452,452,13,13,0,1,0
0,482,482,131,81,50,4,3

4,170,170,33,33,0,1,0
0,231,231,35,7,28,3,2
1,396,396,51,51,0,1,0
5,410,410,19,19,0,1,0
2,424,424,9,9,0,1,0
3,437,437,29,17,12,4,3

3,103,103,1,1,0,1,0
7,250,250,9,9,0,1,0
2,251,251,1,1,0,1,0
6,260,260,63,13,50,3,2
4,269,269,5,5,0,1,0
1,416,416,84,84,0,1,0
5,434,434,11,5,6,2,1
0,467,467,32,32,0,1,0

6,179,179,33,33,0,1,0
3,201,201,30,30,0,1,0
1,212,212,1,1,0,1,0
5,218,218,13,13,0,1,0
0,223,223,20,20,0,1,0
4,250,250,17,4,13,2,1
2,399,399,24,20,4,2,1

2,281,281,26,26,0,1,0
0,295,295,23,13,10,2,1
1,298,298,39,7,32,2,1
3,341,341,33,9,24,3,2
4,414,414,36,16,20,3,2
5,474,474,57,20,37,2,1

6,120,120,7,7,0,1,0
8,139,139,8,8,0,1,0
3,165,165,13,13,0,1,0
4,223,223,14,14,0,1,0
0,284,284,1,1,0,1,0
7,298,298,48,48,0,1,0
1,384,384,23,23,0,1,0
9,386,386,33,33,0,1,0
2,391,391,3,3,0,1,0
5,424,424,13,3,10,3,2

2,135,135,19,19,0,1,0
1,259,259,19,11,8,3,2
5,382,382,72,23,49,3,2
0,414,414,38,5,33,3,2
4,458,458,16,16,0,1,0
3,498,498,40,14,26,4,3

5,129,129,13,7,6,2,1
1,216,216,18,12,6,3,2
7,307,307,30,21,9,2,1
2,341,341,23,23,0,1,0
0,357,357,27,1,26,3,2
6,372,372,40,7,33,3,2
3,405,405,24,13,11,2,1
4,473,473,7,7,0,1,0

4,175,175,32,12,20,2,1
0,237,237,44,28,16,4,3
3,263,263,24,24,0,1,0
1,420,420,49,49,0,1,0
2,428,428,13,10,3,2,1

2,120,120,15,7,8,2,1
1,208,208,28,8,20,3,2
6,342,342,45,45,0,1,0
0,410,410,12,8,4,2,1
4,423,423,43,28,15,2,1
5,466,466,33,3,30,4,3
3,479,479,6,6,0,1,0

7,202,202,9,9,0,1,0
8,221,221,53,4,49,2,1
1,299,299,3,3,0,1,0
9,311,311,6,3,3,2,1
2,344,344,1,1,0,1,0
5,361,361,22,22,0,1,0
6,379,379,9,9,0,1,0
4,470,470,92,83,9,4,3
0,492,492,1,1,0,1,0
3,493,493,3,3,0,1,0

6,123,123,33,1,32,2,1
1,140,140,3,3,0,1,0
0,164,164,4,4,0,1,0
2,196,196,48,48,0,1,0
3,373,373,4,1,3,2,1
5,426,426,11,11,0,1,0
4,475,475,4,4,0,1,0

2,107,107,1,1,0,1,0
1,163,163,18,18,0,1,0
5,256,256,8,2,6,3,2
0,311,311,48,48,0,1,0
6,320,320,3,3,0,1,0
4,360,360,96,33,63,4,3
3,428,428,12,12,0,1,0

1,109,109,15,4,11,2,1
2,140,140,9,9,0,1,0
0,146,146,25,25,0,1,0
4,184,184,28,25,3,2,1
3,322,322,28,28,0,1,0

0,104,104,9,9,0,1,0
4,143,143,10,10,0,1,0
2,277,277,52,52,0,1,0
3,312,312,15,15,0,1,0
1,436,436,94,94,0,1,0

2,171,171,6,6,0,1,0
4,197,197,23,13,10,2,1
1,267,267,58,58,0,1,0
6,325,325,55,55,0,1,0
5,339,339,7,7,0,1,0
0,368,368,14,2,12,3,2
3,456,456,5,5,0,1,0

4,121,121,2,2,0,1,0
3,188,188,10,6,4,2,1
5,207,207,13,9,4,2,1
2,287,287,3,3,0,1,0
0,307,307,3,3,0,1,0
8,348,348,4,4,0,1,0
1,361,361,54,28,26,2,1
6,391,391,38,14,24,4,3
7,479,479,93,15,78,4,3

2,123,123,1,1,0,1,0
0,132,132,1,1,0,1,0
3,160,160,8,2,6,3,2
7,230,230,3,3,0,1,0
5,324,324,26,26,0,1,0
1,325,325,24,24,0,1,0
6,326,326,24,10,14,2,1
9,329,329,47,47,0,1,0
4,368,368,3,3,0,1,0
8,446,446,66,50,16,3,2

3,208,208,3,3,0,1,0
4,246,246,57,26,31,3,2
1,363,363,45,33,12,2,1
6,367,367,13,8,5,2,1
5,383,383,15,3,12,4,3
0,388,388,38,38,0,1,0
2,455,455,31,27,4,2,1

3,277,277,4,4,0,1,0
4,361,361,25,19,6,2,1
6,372,372,64,64,0,1,0
1,391,391,1,1,0,1,0
5,427,427,27,27,0,1,0
2,449,449,105,13,92,3,2
0,494,494,26,18,8,2,1

2,125,125,1,1,0,1,0
8,163,163,31,21,10,3,2
4,186,186,11,11,0,1,0
9,212,212,19,19,0,1,0
1,214,214,6,6,0,1,0
6,256,256,18,18,0,1,0
0,278,278,8,8,0,1,0
3,326,326,10,10,0,1,0
5,475,475,36,14,22,2,1
7,478,478,15,15,0,1,0

6,123,123,7,2,5,2,1
1,194,194,20,20,0,1,0
0,215,215,13,13,0,1,0
3,245,245,1,1,0,1,0
5,325,325,31,22,9,4,3
2,426,426,58,14,44,2,1
4,483,483,75,40,35,2,1

6,151,151,24,24,0,1,0
0,169,169,18,4,14,2,1
1,240,240,6,1,5,2,1
3,333,333,9,1,8,2,1
4,346,346,2,2,0,1,0
5,385,385,55,33,22,2,1
2,451,451,65,25,40,3,2

4,209,209,56,17,39,4,3
2,281,281,1,1,0,1,0
0,425,425,12,12,0,1,0
1,429,429,117,117,0,1,0
3,472,472,16,16,0,1,0

4,101,101,15,15,0,1,0
6,176,176,23,23,0,1,0
3,183,183,3,3,0,1,0
7,205,205,19,19,0,1,0
5,268,268,29,13,16,3,2
1,270,270,6,6,0,1,0
2,321,321,1,1,0,1,0
0,405,405,1,1,0,1,0
8,447,447,37,8,29,2,1

1,229,229,28,4,24,4,3
3,301,301,6,6,0,1,0
0,367,367,30,19,11,2,1
4,369,369,30,30,0,1,0
6,397,397,17,17,0,1,0
5,436,436,78,20,58,3,2
2,452,452,35,7,28,2,1

3,253,253,28,2,26,3,2
4,365,365,30,30,0,1,0
0,391,391,38,38,0,1,0
2,414,414,47,23,24,4,3
1,484,484,99,87,12,4,3

4,230,230,1,1,0,1,0
8,257,257,46,46,0,1,0
1,260,260,18,18,0,1,0
2,318,318,46,31,15,2,1
5,318,318,19,19,0,1,0
7,357,357,26,11,15,2,1
6,375,375,20,6,14,2,1
0,431,431,9,9,0,1,0
3,479,479,2,2,0,1,0

4,132,132,2,2,0,1,0
3,156,156,14,3,11,2,1
7,222,222,11,1,10,3,2
6,241,241,20,13,7,3,2
1,340,340,9,3,6,3,2
2,382,382,13,4,9,4,3
8,421,421,72,27,45,2,1
0,429,429,20,7,13,2,1
5,437,437,39,11,28,3,2

1,103,103,17,17,0,1,0
2,107,107,7,7,0,1,0
3,169,169,15,6,9,4,3
0,406,406,32,32,0,1,0
5,454,454,19,4,15,4,3
4,465,465,82,8,74,3,2

1,209,209,27,1,26,3,2
5,248,248,59,59,0,1,0
4,261,261,6,6,0,1,0
0,426,426,49,49,0,1,0
3,466,466,21,21,0,1,0
2,478,478,27,18,9,2,1

0,105,105,6,6,0,1,0
2,145,145,9,9,0,1,0
7,238,238,31,31,0,1,0
3,240,240,12,6,6,2,1
1,275,275,13,1,12,2,1
8,302,302,50,12,38,2,1
5,330,330,27,8,19,2,1
4,444,444,2,2,0,1,0
6,490,490,5,5,0,1,0

4,129,129,1,1,0,1,0
7,139,139,7,7,0,1,0
0,200,200,14,14,0,1,0
3,207,207,20,8,12,4,3
5,260,260,66,66,0,1,0
6,298,298,2,2,0,1,0
2,304,304,8,8,0,1,0
1,479,479,51,21,30,4,3

2,121,121,7,7,0,1,0
0,158,158,14,1,13,2,1
1,196,196,24,24,0,1,0
4,236,236,31,31,0,1,0
6,339,339,40,40,0,1,0
5,359,359,19,19,0,1,0
3,423,423,14,1,13,2,1

3,157,157,21,21,0,1,0
4,165,165,2,2,0,1,0
2,198,198,6,3,3,2,1
1,276,276,63,1,62,4,3
5,408,408,66,24,42,4,3
0,498,498,22,5,17,2,1

4,103,103,13,1,12,3,2
0,107,107,1,1,0,1,0
2,118,118,4,4,0,1,0
1,139,139,15,1,14,2,1
5,298,298,68,4,64,3,2
3,366,366,11,2,9,4,3
6,413,413,21,21,0,1,0
7,460,460,11,11,0,1,0

0,154,154,15,15,0,1,0
3,230,230,5,5,0,1,0
2,279,279,2,2,0,1,0
1,303,303,62,62,0,1,0
4,343,343,96,96,0,1,0

5,146,146,5,5,0,1,0
2,167,167,17,7,10,3,2
0,260,260,45,27,18,2,1
3,280,280,46,21,25,3,2
4,327,327,35,35,0,1,0
1,392,392,10,10,0,1,0

5,123,123,3,3,0,1,0
4,137,137,16,8,8,3,2
1,153,153,16,6,10,2,1
6,207,207,35,28,7,2,1
0,285,285,26,26,0,1,0
3,399,399,41,38,3,2,1
2,433,433,1,1,0,1,0

6,222,222,18,7,11,4,3
5,370,370,25,25,0,1,0
7,370,370,33,33,0,1,0
4,383,383,8,8,0,1,0
1,398,398,14,14,0,1,0
2,398,398,4,4,0,1,0
8,471,471,64,64,0,1,0
0,472,472,62,62,0,1,0
3,486,486,17,17,0,1,0

3,163,163,3,3,0,1,0
5,252,252,23,23,0,1,0
1,271,271,3,3,0,1,0
0,310,310,45,12,33,2,1
4,407,407,17,17,0,1,0
2,409,409,52,24,28,3,2
6,485,485,84,84,0,1,0

8,101,101,2,2,0,1,0
9,230,230,50,6,44,2,1
5,267,267,1,1,0,1,0
4,282,282,10,10,0,1,0
1,297,297,24,24,0,1,0
0,305,305,1,1,0,1,0
7,343,343,23,23,0,1,0
3,440,440,32,10,22,2,1
6,450,450,31,2,29,2,1
2,487,487,18,8,10,3,2

2,137,137,15,3,12,2,1
6,218,218,13,2,11,2,1
0,298,298,19,19,0,1,0
3,346,346,10,4,6,3,2
5,348,348,4,4,0,1,0
1,355,355,35,35,0,1,0
4,420,420,99,33,66,4,3

2,107,107,8,8,0,1,0
1,231,231,8,8,0,1,0
4,285,285,13,1,12,3,2
3,296,296,64,64,0,1,0
0,310,310,60,60,0,1,0
5,473,473,20,13,7,2,1

6,208,208,11,3,8,3,2
2,243,243,9,9,0,1,0
3,245,245,11,11,0,1,0
4,273,273,21,1,20,2,1
0,363,363,31,31,0,1,0
5,366,366,76,31,45,4,3
7,371,371,16,16,0,1,0
1,372,372,21,6,15,2,1

7,147,147,20,12,8,3,2
0,194,194,1,1,0,1,0
3,228,228,3,3,0,1,0
2,265,265,26,26,0,1,0
1,371,371,42,24,18,2,1
8,378,378,18,18,0,1,0
6,450,450,54,9,45,4,3
5,460,460,7,1,6,2,1
4,479,479,27,27,0,1,0

2,121,121,12,12,0,1,0
3,160,160,18,2,16,3,2
0,225,225,7,7,0,1,0
1,235,235,14,1,13,2,1
5,245,245,4,4,0,1,0
6,315,315,31,7,24,3,2
4,416,416,79,79,0,1,0

1,177,177,6,6,0,1,0
2,239,239,3,3,0,1,0
6,252,252,10,1,9,2,1
3,260,260,17,11,6,2,1
9,289,289,35,3,32,3,2
8,333,333,51,21,30,3,2
4,347,347,19,19,0,1,0
7,413,413,12,12,0,1,0
0,426,426,5,2,3,2,1
5,438,438,37,11,26,3,2

2,100,100,14,14,0,1,0
4,147,147,14,10,4,2,1
5,330,330,62,62,0,1,0
1,332,332,8,1,7,2,1
0,398,398,56,7,49,2,1
3,428,428,12,4,8,3,2

0,222,222,55,55,0,1,0
2,263,263,4,4,0,1,0
1,299,299,16,10,6,3,2
3,314,314,50,50,0,1,0
4,432,432,57,8,49,4,3

2,132,132,4,4,0,1,0
1,193,193,11,11,0,1,0
8,201,201,37,17,20,3,2
0,221,221,22,22,0,1,0
7,245,245,7,7,0,1,0
5,304,304,5,1,4,2,1
3,333,333,3,3,0,1,0
6,355,355,32,11,21,4,3
4,438,438,39,12,27,2,1

5,168,168,2,2,0,1,0
1,189,189,9,3,6,3,2
6,203,203,7,7,0,1,0
7,314,314,73,13,60,3,2
2,365,365,14,8,6,3,2
3,373,373,13,13,0,1,0
0,385,385,6,2,4,2,1
4,414,414,63,3,60,4,3
8,430,430,16,16,0,1,0

5,128,128,23,15,8,3,2
2,129,129,24,24,0,1,0
0,192,192,19,2,17,2,1
1,292,292,5,5,0,1,0
3,362,362,34,19,15,2,1
4,472,472,16,6,10,3,2

6,101,101,11,11,0,1,0
7,271,271,46,46,0,1,0
5,307,307,10,1,9,4,3
3,351,351,42,30,12,4,3
0,357,357,6,6,0,1,0
1,403,403,1,1,0,1,0
2,463,463,62,62,0,1,0
4,465,465,13,13,0,1,0

1,221,221,1,1,0,1,0
3,244,244,26,26,0,1,0
6,254,254,62,36,26,2,1
5,256,256,4,4,0,1,0
4,309,309,13,1,12,2,1
2,342,342,48,48,0,1,0
0,364,364,18,18,0,1,0

2,134,134,5,5,0,1,0
4,196,196,2,2,0,1,0
3,203,203,53,23,30,3,2
0,271,271,25,25,0,1,0
1,317,317,66,66,0,1,0

2,164,164,24,13,11,2,1
3,179,179,8,8,0,1,0
1,400,400,48,48,0,1,0
0,463,463,139,58,81,4,3

4,107,107,1,1,0,1,0
2,110,110,5,5,0,1,0
1,197,197,34,34,0,1,0
8,344,344,45,45,0,1,0
3,369,369,12,3,9,2,1
7,374,374,51,37,14,2,1
0,378,378,11,11,0,1,0
5,410,410,5,1,4,2,1
6,459,459,17,5,12,3,2

0,195,195,30,18,12,3,2
3,283,283,34,34,0,1,0
4,336,336,8,8,0,1,0
2,385,385,62,15,47,3,2
1,498,498,73,73,0,1,0

4,243,243,14,7,7,2,1
5,247,247,33,22,11,2,1
2,333,333,42,42,0,1,0
0,336,336,11,11,0,1,0
1,379,379,29,29,0,1,0
6,448,448,51,51,0,1,0
3,484,484,32,32,0,1,0

4,104,104,1,1,0,1,0
1,274,274,20,14,6,2,1
7,292,292,83,83,0,1,0
3,302,302,7,7,0,1,0
8,310,310,3,3,0,1,0
9,383,383,4,1,3,2,1
6,399,399,52,22,30,2,1
2,423,423,5,5,0,1,0
0,452,452,1,1,0,1,0
5,494,494,25,9,16,3,2

2,125,125,11,11,0,1,0
1,141,141,4,4,0,1,0
7,176,176,11,11,0,1,0
3,228,228,12,3,9,4,3
6,273,273,1,1,0,1,0
4,276,276,2,2,0,1,0
11,302,302,8,8,0,1,0
9,369,369,5,5,0,1,0
10,394,394,14,6,8,2,1
0,441,441,10,10,0,1,0
5,457,457,1,1,0,1,0
8,463,463,9,9,0,1,0
12,495,495,120,43,77,4,3

4,150,150,2,2,0,1,0
0,210,210,8,8,0,1,0
1,252,252,26,26,0,1,0
3,291,291,34,34,0,1,0
2,330,330,14,14,0,1,0
6,432,432,121,91,30,4,3
5,488,488,6,6,0,1,0

4,116,116,2,2,0,1,0
0,133,133,14,14,0,1,0
2,278,278,44,2,42,4,3
1,364,364,14,14,0,1,0
3,417,417,57,57,0,1,0
5,490,490,75,75,0,1,0

2,132,132,1,1,0,1,0
6,253,253,25,20,5,2,1
0,267,267,6,6,0,1,0
4,298,298,15,15,0,1,0
5,343,343,39,39,0,1,0
3,358,358,44,36,8,3,2
1,474,474,47,39,8,2,1
7,477,477,44,8,36,4,3

0,131,131,2,2,0,1,0
7,140,140,5,5,0,1,0
6,148,148,2,2,0,1,0
5,173,173,44,44,0,1,0
4,223,223,31,31,0,1,0
2,370,370,5,5,0,1,0
1,388,388,46,46,0,1,0
3,450,450,7,7,0,1,0

4,173,173,12,12,0,1,0
2,251,251,52,6,46,3,2
1,314,314,83,2,81,4,3
3,327,327,10,2,8,3,2
0,425,425,16,2,14,2,1

4,233,233,7,7,0,1,0
3,244,244,33,9,24,3,2
0,257,257,11,1,10,3,2
2,322,322,6,6,0,1,0
6,363,363,18,7,11,2,1
1,376,376,29,29,0,1,0
7,382,382,11,11,0,1,0
5,487,487,110,42,68,4,3

4,194,194,28,6,22,2,1
5,203,203,24,5,19,2,1
1,211,211,11,11,0,1,0
0,278,278,43,32,11,2,1
3,300,300,13,3,10,3,2
2,418,418,39,39,0,1,0

2,106,106,6,3,3,2,1
0,154,154,47,15,32,2,1
1,204,204,24,15,9,2,1
3,366,366,47,5,42,4,3

2,239,239,26,7,19,2,1
1,318,318,7,7,0,1,0
3,384,384,67,7,60,4,3
0,414,414,125,77,48,4,3

1,119,119,16,3,13,4,3
3,234,234,36,10,26,2,1
2,401,401,22,17,5,2,1
0,402,402,68,8,60,4,3
4,474,474,45,18,27,2,1

2,108,108,16,16,0,1,0
4,185,185,32,23,9,2,1
1,306,306,13,1,12,2,1
3,309,309,36,36,0,1,0
0,382,382,44,44,0,1,0
5,435,435,7,7,0,1,0

11,118,118,22,22,0,1,0
8,147,147,3,3,0,1,0
9,167,167,12,12,0,1,0
1,198,198,6,6,0,1,0
6,215,215,4,4,0,1,0
3,239,239,5,5,0,1,0
5,300,300,13,13,0,1,0
2,387,387,18,11,7,2,1
12,389,389,42,42,0,1,0
0,415,415,8,1,7,2,1
7,439,439,9,9,0,1,0
10,450,450,6,6,0,1,0
4,459,459,4,4,0,1,0

4,105,105,2,2,0,1,0
2,275,275,8,2,6,3,2
1,376,376,5,5,0,1,0
0,401,401,115,81,34,3,2
3,481,481,127,47,80,3,2

1,184,184,26,26,0,1,0
4,198,198,17,9,8,2,1
3,252,252,48,48,0,1,0
0,313,313,36,36,0,1,0
5,371,371,10,10,0,1,0
2,486,486,22,22,0,1,0

3,148,148,7,3,4,2,1
7,245,245,20,20,0,1,0
5,313,313,68,53,15,4,3
0,403,403,23,23,0,1,0
1,422,422,29,6,23,3,2
6,431,431,2,2,0,1,0
4,454,454,8,4,4,2,1
2,466,466,51,51,0,1,0

0,136,136,1,1,0,1,0
2,246,246,27,3,24,2,1
1,256,256,10,1,9,4,3
3,273,273,40,40,0,1,0
6,343,343,5,5,0,1,0
4,404,404,82,52,30,2,1
5,434,434,37,21,16,3,2

5,208,208,1,1,0,1,0
3,278,278,63,63,0,1,0
1,338,338,9,9,0,1,0
0,393,393,69,45,24,2,1
2,473,473,47,47,0,1,0
4,497,497,37,20,17,2,1

0,101,101,19,19,0,1,0
3,182,182,11,11,0,1,0
2,259,259,23,23,0,1,0
4,361,361,58,46,12,4,3
1,388,388,44,44,0,1,0

5,215,215,35,35,0,1,0
0,235,235,21,15,6,3,2
3,283,283,13,13,0,1,0
1,289,289,29,29,0,1,0
4,294,294,5,5,0,1,0
2,411,411,27,27,0,1,0
6,449,449,55,55,0,1,0

2,151,151,1,1,0,1,0
0,275,275,27,4,23,4,3
3,282,282,49,25,24,3,2
4,286,286,13,8,5,2,1
6,364,364,53,27,26,2,1
1,370,370,8,8,0,1,0
5,499,499,55,55,0,1,0

1,171,171,3,3,0,1,0
2,174,174,43,43,0,1,0
4,385,385,20,6,14,2,1
3,416,416,2,2,0,1,0
0,499,499,143,26,117,4,3

6,102,102,11,11,0,1,0
2,156,156,22,12,10,3,2
7,159,159,3,3,0,1,0
4,295,295,1,1,0,1,0
8,300,300,53,53,0,1,0
3,306,306,7,7,0,1,0
5,376,376,9,9,0,1,0
0,395,395,19,2,17,2,1
1,493,493,31,31,0,1,0

7,107,107,8,2,6,3,2
0,124,124,16,16,0,1,0
1,186,186,3,3,0,1,0
3,238,238,11,3,8,3,2
5,350,350,67,13,54,4,3
2,445,445,13,13,0,1,0
4,445,445,36,6,30,3,2
6,498,498,21,3,18,3,2

1,151,151,14,14,0,1,0
0,174,174,24,1,23,4,3
5,187,187,40,4,36,3,2
2,305,305,15,15,0,1,0
7,338,338,12,12,0,1,0
4,346,346,3,3,0,1,0
6,427,427,24,14,10,2,1
3,493,493,6,6,0,1,0

5,110,110,25,12,13,2,1
1,275,275,11,1,10,3,2
6,337,337,25,25,0,1,0
3,380,380,44,16,28,2,1
0,408,408,14,14,0,1,0
4,432,432,1,1,0,1,0
2,499,499,55,55,0,1,0

1,162,162,13,3,10,2,1
0,195,195,43,7,36,3,2
3,285,285,12,8,4,2,1
4,356,356,8,8,0,1,0
2,364,364,88,76,12,4,3

6,202,202,34,34,0,1,0
4,284,284,9,9,0,1,0
3,308,308,5,5,0,1,0
7,315,315,7,7,0,1,0
1,373,373,45,29,16,2,1
2,415,415,26,26,0,1,0
5,435,435,49,8,41,2,1
0,459,459,33,33,0,1,0

4,142,142,31,11,20,3,2
6,147,147,8,2,6,3,2
5,168,168,6,3,3,2,1
0,223,223,8,8,0,1,0
3,266,266,16,2,14,2,1
2,355,355,36,36,0,1,0
1,461,461,49,7,42,4,3

11,109,109,9,5,4,2,1
2,111,111,2,2,0,1,0
10,124,124,8,3,5,2,1
4,137,137,1,1,0,1,0
7,206,206,6,6,0,1,0
8,309,309,20,5,15,2,1
5,324,324,42,30,12,4,3
6,326,326,5,5,0,1,0
1,340,340,4,4,0,1,0
9,343,343,54,16,38,4,3
3,394,394,9,3,6,2,1
0,493,493,1,1,0,1,0

4,143,143,5,2,3,2,1
0,195,195,20,5,15,4,3
2,250,250,30,30,0,1,0
3,440,440,10,1,9,4,3
5,459,459,114,16,98,3,2
1,479,479,38,38,0,1,0

3,266,266,39,9,30,2,1
2,346,346,8,8,0,1,0
4,377,377,51,21,30,2,1
0,409,409,5,5,0,1,0
1,473,473,137,18,119,4,3

2,117,117,11,7,4,2,1
1,218,218,23,23,0,1,0
4,235,235,20,20,0,1,0
0,236,236,21,7,14,3,2
6,279,279,16,16,0,1,0
5,350,350,57,9,48,3,2
3,462,462,6,6,0,1,0

4,159,159,1,1,0,1,0
0,167,167,20,8,12,4,3
1,219,219,40,40,0,1,0
3,249,249,1,1,0,1,0
2,500,500,147,147,0,1,0

9,142,142,2,2,0,1,0
3,154,154,8,2,6,3,2
4,157,157,6,6,0,1,0
7,162,162,21,3,18,2,1
8,232,232,39,22,17,4,3
2,250,250,3,3,0,1,0
0,312,312,21,21,0,1,0
5,377,377,6,6,0,1,0
6,384,384,33,33,0,1,0
1,416,416,13,13,0,1,0

4,130,130,7,7,0,1,0
13,153,153,11,11,0,1,0
11,158,158,1,1,0,1,0
7,166,166,3,3,0,1,0
10,259,259,16,16,0,1,0
2,267,267,31,31,0,1,0
12,268,268,6,3,3,2,1
0,300,300,4,4,0,1,0
14,362,362,77,35,42,4,3
5,364,364,2,2,0,1,0
3,371,371,2,2,0,1,0
9,403,403,1,1,0,1,0
8,418,418,3,3,0,1,0
6,428,428,4,4,0,1,0
1,451,451,1,1,0,1,0

0,107,107,3,3,0,1,0
5,109,109,5,5,0,1,0
1,176,176,5,5,0,1,0
3,182,182,7,7,0,1,0
2,281,281,22,22,0,1,0
6,373,373,96,96,0,1,0
7,495,495,4,4,0,1,0
4,497,497,64,64,0,1,0

1,190,190,36,15,21,4,3
4,224,224,1,1,0,1,0
5,236,236,32,21,11,2,1
0,374,374,10,4,6,3,2
3,378,378,1,1,0,1,0
7,425,425,65,65,0,1,0
6,427,427,6,6,0,1,0
2,478,478,38,20,18,3,2

4,161,161,36,15,21,4,3
0,284,284,59,14,45,2,1
2,299,299,20,20,0,1,0
6,327,327,5,5,0,1,0
1,434,434,3,3,0,1,0
5,466,466,32,2,30,2,1
3,493,493,10,10,0,1,0

5,140,140,28,13,15,2,1
4,249,249,5,5,0,1,0
1,273,273,48,48,0,1,0
3,344,344,30,2,28,3,2
2,362,362,12,12,0,1,0
0,372,372,34,13,21,4,3

3,104,104,2,2,0,1,0
0,112,112,9,6,3,2,1
4,183,183,26,17,9,2,1
2,281,281,43,21,22,3,2
1,390,390,86,71,15,4,3

3,110,110,13,1,12,2,1
1,161,161,18,2,16,2,1
5,228,228,2,2,0,1,0
6,232,232,60,56,4,2,1
0,245,245,17,17,0,1,0
4,267,267,11,2,9,4,3
2,285,285,1,1,0,1,0

6,111,111,9,9,0,1,0
1,227,227,36,36,0,1,0
3,254,254,24,24,0,1,0
5,325,325,73,25,48,4,3
0,429,429,20,14,6,2,1
2,432,432,1,1,0,1,0
4,461,461,2,2,0,1,0

5,272,272,47,16,31,2,1
0,285,285,5,5,0,1,0
6,289,289,2,2,0,1,0
7,327,327,41,19,22,2,1
1,403,403,61,17,44,2,1
4,492,492,2,2,0,1,0
2,493,493,1,1,0,1,0
3,496,496,62,62,0,1,0

1,297,297,44,44,0,1,0
2,396,396,60,60,0,1,0
3,402,402,37,37,0,1,0
5,405,405,60,32,28,3,2
0,424,424,1,1,0,1,0
4,456,456,29,11,18,3,2

9,108,108,2,2,0,1,0
6,111,111,4,4,0,1,0
4,145,145,17,8,9,4,3
0,186,186,4,1,3,2,1
5,216,216,3,3,0,1,0
1,229,229,9,9,0,1,0
7,252,252,4,4,0,1,0
2,277,277,8,4,4,2,1
8,431,431,119,94,25,2,1
3,442,442,21,21,0,1,0

2,148,148,11,11,0,1,0
5,211,211,17,17,0,1,0
0,306,306,15,6,9,2,1
6,318,318,5,5,0,1,0
1,329,329,3,3,0,1,0
4,364,364,22,2,20,3,2
7,389,389,34,26,8,2,1
9,409,409,82,23,59,4,3
8,435,435,6,6,0,1,0
3,444,444,5,5,0,1,0

0,296,296,41,41,0,1,0
2,299,299,1,1,0,1,0
1,347,347,57,57,0,1,0
4,364,364,8,8,0,1,0
3,475,475,131,11,120,4,3

7,119,119,10,10,0,1,0
3,164,164,1,1,0,1,0
2,183,183,2,2,0,1,0
6,211,211,3,3,0,1,0
4,283,283,4,4,0,1,0
0,324,324,50,50,0,1,0
5,332,332,69,26,43,2,1
1,397,397,46,17,29,4,3

5,106,106,18,2,16,2,1
3,274,274,23,2,21,4,3
2,288,288,34,34,0,1,0
0,295,295,30,8,22,3,2
4,320,320,18,18,0,1,0
1,459,459,37,37,0,1,0

1,267,267,26,4,22,4,3
4,320,320,25,3,22,2,1
5,344,344,68,68,0,1,0
3,363,363,3,3,0,1,0
6,382,382,10,10,0,1,0
2,433,433,18,9,9,4,3
0,447,447,69,33,36,4,3

1,255,255,2,2,0,1,0
2,258,258,4,4,0,1,0
4,258,258,11,11,0,1,0
0,341,341,1,1,0,1,0
9,375,375,54,20,34,3,2
3,382,382,53,53,0,1,0
8,415,415,1,1,0,1,0
6,428,428,20,9,11,2,1
7,439,439,1,1,0,1,0
5,460,460,20,20,0,1,0
10,460,460,73,63,10,3,2

2,125,125,1,1,0,1,0
1,136,136,12,12,0,1,0
3,164,164,2,2,0,1,0
5,351,351,12,12,0,1,0
0,387,387,80,68,12,2,1
4,472,472,121,80,41,2,1

0,218,218,6,6,0,1,0
2,243,243,8,8,0,1,0
4,290,290,72,72,0,1,0
1,334,334,92,92,0,1,0
3,437,437,10,10,0,1,0

1,108,108,3,3,0,1,0
2,128,128,12,4,8,3,2
3,131,131,26,26,0,1,0
5,408,408,15,1,14,3,2
4,439,439,31,31,0,1,0
0,482,482,88,18,70,4,3

1,104,104,15,1,14,2,1
3,222,222,3,3,0,1,0
2,257,257,33,33,0,1,0
0,395,395,63,37,26,3,2
4,434,434,71,71,0,1,0

0,134,134,13,6,7,2,1
5,134,134,5,5,0,1,0
6,312,312,50,35,15,4,3
3,413,413,39,33,6,3,2
1,416,416,43,43,0,1,0
2,441,441,3,3,0,1,0
4,479,479,52,52,0,1,0

8,146,146,17,17,0,1,0
6,177,177,2,2,0,1,0
1,235,235,1,1,0,1,0
5,299,299,44,40,4,2,1
4,305,305,10,10,0,1,0
7,366,366,66,24,42,3,2
9,383,383,4,4,0,1,0
2,402,402,24,9,15,4,3
3,439,439,14,6,8,3,2
0,485,485,7,7,0,1,0

1,103,103,27,27,0,1,0
2,254,254,54,6,48,3,2
0,317,317,14,5,9,2,1
4,442,442,2,2,0,1,0
3,484,484,42,42,0,1,0

3,138,138,28,28,0,1,0
5,221,221,8,5,3,2,1
0,400,400,10,10,0,1,0
1,402,402,50,50,0,1,0
4,440,440,30,30,0,1,0
2,475,475,72,72,0,1,0

5,172,172,16,2,14,3,2
0,174,174,21,18,3,2,1
2,215,215,33,4,29,2,1
1,237,237,7,1,6,2,1
3,297,297,48,48,0,1,0
4,328,328,17,4,13,2,1

1,106,106,1,1,0,1,0
0,154,154,3,3,0,1,0
7,201,201,35,8,27,4,3
6,224,224,16,16,0,1,0
3,243,243,35,27,8,2,1
4,384,384,41,29,12,2,1
2,452,452,10,10,0,1,0
5,480,480,28,28,0,1,0

1,377,377,59,59,0,1,0
2,438,438,23,23,0,1,0
0,466,466,140,140,0,1,0
3,495,495,47,47,0,1,0

4,108,108,3,3,0,1,0
0,165,165,22,22,0,1,0
5,188,188,27,27,0,1,0
6,208,208,9,9,0,1,0
3,226,226,14,14,0,1,0
2,257,257,15,15,0,1,0
1,438,438,11,11,0,1,0
7,470,470,57,57,0,1,0

7,178,178,31,15,16,2,1
8,211,211,26,26,0,1,0
4,213,213,6,1,5,2,1
2,228,228,9,9,0,1,0
0,237,237,9,9,0,1,0
5,281,281,48,48,0,1,0
3,303,303,1,1,0,1,0
1,462,462,11,3,8,3,2
6,494,494,5,5,0,1,0

0,168,168,27,9,18,2,1
1,280,280,11,11,0,1,0
4,299,299,66,39,27,4,3
2,322,322,22,22,0,1,0
6,344,344,26,26,0,1,0
5,412,412,4,4,0,1,0
3,446,446,15,11,4,2,1

3,126,126,12,9,3,2,1
5,131,131,30,30,0,1,0
6,147,147,10,10,0,1,0
1,161,161,1,1,0,1,0
0,193,193,13,5,8,2,1
7,310,310,3,3,0,1,0
4,466,466,31,31,0,1,0
2,469,469,31,31,0,1,0

0,271,271,32,32,0,1,0
2,287,287,30,30,0,1,0
5,297,297,23,10,13,2,1
4,368,368,71,33,38,2,1
1,386,386,30,30,0,1,0
3,481,481,15,12,3,2,1

1,120,120,1,1,0,1,0
5,257,257,45,36,9,2,1
4,347,347,35,35,0,1,0
3,348,348,11,11,0,1,0
2,408,408,94,34,60,3,2
0,443,443,28,11,17,2,1

5,124,124,10,4,6,3,2
0,136,136,30,30,0,1,0
1,181,181,6,6,0,1,0
4,305,305,44,40,4,2,1
3,398,398,32,22,10,2,1
2,472,472,22,22,0,1,0

2,101,101,9,9,0,1,0
3,105,105,8,8,0,1,0
1,148,148,1,1,0,1,0
5,213,213,43,43,0,1,0
0,320,320,66,38,28,2,1
4,324,324,11,11,0,1,0

4,102,102,1,1,0,1,0
0,383,383,7,1,6,2,1
3,401,401,42,42,0,1,0
6,406,406,17,10,7,2,1
8,439,439,26,3,23,2,1
5,478,478,22,22,0,1,0
7,482,482,98,89,9,4,3
1,495,495,52,52,0,1,0
2,495,495,8,8,0,1,0

3,147,147,10,10,0,1,0
5,153,153,4,1,3,2,1
0,201,201,18,18,0,1,0
7,264,264,32,2,30,4,3
6,282,282,12,12,0,1,0
9,368,368,10,10,0,1,0
8,384,384,60,60,0,1,0
4,388,388,1,1,0,1,0
2,429,429,25,25,0,1,0
1,483,483,7,1,6,3,2

6,117,117,1,1,0,1,0
7,138,138,4,4,0,1,0
1,202,202,13,3,10,2,1
4,227,227,1,1,0,1,0
8,248,248,20,20,0,1,0
2,266,266,2,2,0,1,0
5,326,326,15,3,12,4,3
3,332,332,27,11,16,2,1
9,364,364,72,3,69,4,3
0,366,366,34,16,18,3,2

5,178,178,28,13,15,4,3
0,237,237,18,15,3,2,1
6,338,338,48,36,12,4,3
7,370,370,3,3,0,1,0
2,385,385,5,5,0,1,0
3,431,431,4,4,0,1,0
4,464,464,18,7,11,2,1
1,483,483,79,10,69,4,3

7,119,119,6,6,0,1,0
6,178,178,32,2,30,2,1
0,255,255,31,4,27,2,1
4,302,302,6,6,0,1,0
3,377,377,3,3,0,1,0
2,389,389,31,31,0,1,0
5,394,394,30,14,16,3,2
1,397,397,29,3,26,2,1

7,184,184,5,5,0,1,0
5,209,209,3,3,0,1,0
1,212,212,6,6,0,1,0
6,380,380,57,36,21,2,1
2,415,415,15,3,12,3,2
4,437,437,15,15,0,1,0
8,439,439,55,13,42,4,3
3,449,449,44,44,0,1,0
0,464,464,42,42,0,1,0

3,127,127,25,25,0,1,0
1,253,253,25,25,0,1,0
5,321,321,81,81,0,1,0
2,381,381,2,2,0,1,0
4,417,417,11,11,0,1,0
0,435,435,1,1,0,1,0
6,491,491,12,12,0,1,0

4,144,144,14,1,13,2,1
5,412,412,65,16,49,2,1
1,433,433,30,15,15,2,1
0,442,442,17,5,12,3,2
3,456,456,21,21,0,1,0
2,471,471,25,25,0,1,0
6,480,480,60,60,0,1,0
7,489,489,10,1,9,2,1

3,136,136,21,1,20,3,2
0,228,228,10,10,0,1,0
2,317,317,44,18,26,3,2
1,354,354,91,91,0,1,0
4,448,448,4,4,0,1,0

3,101,101,15,15,0,1,0
2,252,252,34,34,0,1,0
1,299,299,5,5,0,1,0
5,343,343,38,29,9,4,3
6,376,376,15,15,0,1,0
0,414,414,3,3,0,1,0
4,487,487,74,53,21,2,1

1,118,118,26,20,6,2,1
2,198,198,7,7,0,1,0
4,390,390,31,7,24,2,1
0,400,400,19,16,3,2,1
3,449,449,74,29,45,2,1
5,468,468,27,14,13,3,2

2,107,107,1,1,0,1,0
5,160,160,4,4,0,1,0
3,203,203,3,3,0,1,0
1,302,302,14,3,11,2,1
7,359,359,77,54,23,4,3
6,406,406,26,26,0,1,0
4,431,431,85,25,60,3,2
0,493,493,16,16,0,1,0

5,112,112,7,7,0,1,0
3,169,169,6,6,0,1,0
2,170,170,1,1,0,1,0
1,277,277,32,14,18,2,1
0,411,411,74,33,41,2,1
4,421,421,88,51,37,2,1

4,116,116,4,4,0,1,0
7,139,139,8,8,0,1,0
2,219,219,9,9,0,1,0
6,303,303,23,23,0,1,0
0,375,375,42,42,0,1,0
1,381,381,43,12,31,3,2
5,400,400,71,71,0,1,0
3,455,455,1,1,0,1,0

5,147,147,11,11,0,1,0
3,167,167,24,24,0,1,0
2,256,256,27,27,0,1,0
1,362,362,8,8,0,1,0
0,392,392,69,69,0,1,0
4,490,490,43,43,0,1,0

0,145,145,3,3,0,1,0
5,166,166,3,3,0,1,0
6,200,200,12,12,0,1,0
4,260,260,20,20,0,1,0
7,273,273,49,49,0,1,0
2,339,339,20,3,17,4,3
3,364,364,6,6,0,1,0
8,366,366,24,18,6,2,1
1,472,472,52,52,0,1,0

3,156,156,3,3,0,1,0
2,170,170,18,7,11,2,1
4,213,213,27,21,6,3,2
6,250,250,5,5,0,1,0
1,379,379,18,18,0,1,0
0,425,425,1,1,0,1,0
5,440,440,89,21,68,3,2
7,464,464,39,19,20,3,2

2,217,217,2,2,0,1,0
3,240,240,35,35,0,1,0
1,244,244,59,59,0,1,0
0,355,355,18,18,0,1,0
5,367,367,31,25,6,3,2
4,376,376,29,17,12,3,2

5,112,112,14,14,0,1,0
0,177,177,1,1,0,1,0
1,212,212,1,1,0,1,0
4,370,370,48,31,17,2,1
3,383,383,19,19,0,1,0
2,481,481,140,140,0,1,0

3,133,133,3,3,0,1,0
0,185,185,34,34,0,1,0
2,229,229,7,7,0,1,0
1,312,312,22,22,0,1,0
5,369,369,76,43,33,2,1
6,465,465,7,7,0,1,0
4,484,484,41,41,0,1,0

1,153,153,39,39,0,1,0
2,271,271,9,9,0,1,0
5,321,321,2,2,0,1,0
0,364,364,5,5,0,1,0
4,455,455,115,4,111,4,3
3,461,461,20,20,0,1,0

0,334,334,50,34,16,2,1
3,365,365,53,53,0,1,0
4,397,397,15,3,12,2,1
5,411,411,50,2,48,2,1
2,463,463,30,30,0,1,0
1,465,465,40,14,26,3,2

0,154,154,1,1,0,1,0
10,235,235,22,7,15,4,3
3,315,315,8,8,0,1,0
9,324,324,3,3,0,1,0
7,414,414,15,15,0,1,0
4,415,415,27,27,0,1,0
1,425,425,26,8,18,2,1
5,431,431,9,1,8,3,2
2,448,448,7,7,0,1,0
6,486,486,34,24,10,3,2
8,490,490,99,54,45,2,1

2,123,123,17,17,0,1,0
1,126,126,6,2,4,2,1
0,281,281,85,85,0,1,0
3,348,348,43,33,10,2,1

6,160,160,19,19,0,1,0
0,273,273,8,8,0,1,0
8,279,279,36,36,0,1,0
3,295,295,17,17,0,1,0
1,312,312,23,23,0,1,0
4,333,333,36,11,25,2,1
7,346,346,20,20,0,1,0
2,412,412,8,1,7,2,1
5,459,459,6,6,0,1,0

3,109,109,2,2,0,1,0
2,332,332,71,41,30,4,3
1,381,381,11,5,6,3,2
0,412,412,112,60,52,4,3
4,466,466,34,28,6,2,1

2,130,130,12,12,0,1,0
1,312,312,18,4,14,3,2
4,366,366,63,63,0,1,0
0,416,416,102,102,0,1,0
3,485,485,22,4,18,3,2

1,111,111,2,2,0,1,0
6,263,263,18,18,0,1,0
2,326,326,14,2,12,3,2
0,349,349,20,20,0,1,0
8,388,388,7,1,6,3,2
7,391,391,85,85,0,1,0
3,409,409,51,51,0,1,0
5,454,454,21,21,0,1,0
4,462,462,5,5,0,1,0

2,185,185,12,12,0,1,0
0,207,207,55,55,0,1,0
4,247,247,49,43,6,2,1
3,325,325,14,1,13,2,1
1,487,487,17,9,8,3,2

6,123,123,13,5,8,3,2
4,217,217,1,1,0,1,0
3,224,224,19,19,0,1,0
7,274,274,52,29,23,2,1
0,295,295,24,24,0,1,0
1,328,328,36,15,21,2,1
5,328,328,4,4,0,1,0
2,336,336,8,4,4,2,1

4,235,235,16,1,15,4,3
0,276,276,23,7,16,3,2
3,286,286,5,5,0,1,0
1,312,312,1,1,0,1,0
6,376,376,51,31,20,2,1
2,394,394,52,52,0,1,0
7,434,434,17,17,0,1,0
5,453,453,58,16,42,2,1

4,123,123,11,1,10,3,2
5,170,170,29,29,0,1,0
6,182,182,9,9,0,1,0
1,234,234,20,20,0,1,0
3,297,297,6,1,5,2,1
2,344,344,13,13,0,1,0
0,483,483,77,77,0,1,0

6,147,147,29,11,18,3,2
0,159,159,21,21,0,1,0
4,318,318,13,13,0,1,0
2,330,330,3,3,0,1,0
3,367,367,18,6,12,2,1
1,380,380,42,18,24,3,2
5,440,440,31,31,0,1,0

4,181,181,11,4,7,2,1
2,248,248,5,5,0,1,0
1,264,264,58,58,0,1,0
3,387,387,67,7,60,4,3
0,436,436,27,27,0,1,0
5,463,463,34,1,33,2,1

3,176,176,12,2,10,2,1
8,186,186,1,1,0,1,0
1,248,248,8,8,0,1,0
5,279,279,3,3,0,1,0
0,306,306,22,10,12,2,1
2,378,378,41,41,0,1,0
6,403,403,71,57,14,3,2
7,484,484,60,51,9,4,3
4,491,491,5,5,0,1,0

1,146,146,7,7,0,1,0
4,167,167,6,6,0,1,0
6,216,216,12,5,7,2,1
5,299,299,69,12,57,4,3
7,404,404,7,7,0,1,0
2,444,444,1,1,0,1,0
3,449,449,90,76,14,2,1
0,456,456,7,7,0,1,0

1,228,228,28,9,19,2,1
6,263,263,27,4,23,2,1
3,283,283,6,1,5,2,1
4,373,373,28,8,20,3,2
0,392,392,20,20,0,1,0
7,411,411,31,31,0,1,0
2,439,439,14,14,0,1,0
5,486,486,62,26,36,2,1

3,114,114,15,15,0,1,0
1,249,249,20,6,14,2,1
4,251,251,2,2,0,1,0
0,266,266,6,6,0,1,0
8,287,287,41,25,16,3,2
5,293,293,16,6,10,2,1
2,351,351,2,2,0,1,0
7,397,397,35,35,0,1,0
6,432,432,32,3,29,2,1

12,126,126,4,4,0,1,0
5,176,176,1,1,0,1,0
8,187,187,1,1,0,1,0
7,202,202,9,9,0,1,0
2,281,281,35,35,0,1,0
0,308,308,1,1,0,1,0
1,350,350,12,12,0,1,0
6,380,380,1,1,0,1,0
9,421,421,13,13,0,1,0
3,425,425,1,1,0,1,0
4,427,427,20,5,15,2,1
11,438,438,2,2,0,1,0
10,473,473,128,66,62,3,2

4,113,113,16,16,0,1,0
5,120,120,4,4,0,1,0
0,218,218,3,3,0,1,0
2,229,229,1,1,0,1,0
3,317,317,35,35,0,1,0
1,357,357,1,1,0,1,0
6,422,422,59,25,34,3,2
8,475,475,31,10,21,2,1
7,500,500,49,34,15,4,3

1,228,228,4,4,0,1,0
2,301,301,5,5,0,1,0
9,311,311,52,39,13,2,1
4,338,338,42,42,0,1,0
5,347,347,1,1,0,1,0
6,357,357,6,6,0,1,0
8,366,366,28,20,8,3,2
3,444,444,24,24,0,1,0
7,449,449,27,19,8,2,1
0,500,500,34,34,0,1,0

0,265,265,21,12,9,4,3
5,388,388,20,20,0,1,0
1,389,389,2,2,0,1,0
2,401,401,1,1,0,1,0
3,413,413,60,60,0,1,0
4,453,453,8,8,0,1,0
8,479,479,41,32,9,4,3
6,487,487,22,22,0,1,0
7,498,498,86,8,78,3,2

4,138,138,9,9,0,1,0
0,163,163,1,1,0,1,0
1,216,216,5,2,3,2,1
2,225,225,61,16,45,4,3
5,256,256,4,4,0,1,0
3,488,488,109,4,105,4,3

1,136,136,38,38,0,1,0
4,195,195,24,24,0,1,0
3,425,425,6,3,3,2,1
2,442,442,73,73,0,1,0
0,466,466,10,3,7,2,1

5,100,100,2,2,0,1,0
2,184,184,9,1,8,3,2
8,281,281,47,47,0,1,0
3,305,305,49,39,10,2,1
6,312,312,17,17,0,1,0
0,382,382,4,4,0,1,0
4,421,421,4,4,0,1,0
1,429,429,25,18,7,2,1
7,431,431,36,36,0,1,0

4,152,152,18,18,0,1,0
2,153,153,12,3,9,2,1
0,230,230,19,19,0,1,0
5,251,251,15,1,14,2,1
1,298,298,42,22,20,3,2
3,328,328,42,3,39,4,3

2,133,133,25,15,10,3,2
7,150,150,7,7,0,1,0
6,256,256,27,27,0,1,0
5,293,293,45,45,0,1,0
3,369,369,27,12,15,4,3
1,379,379,1,1,0,1,0
0,420,420,15,3,12,4,3
4,493,493,1,1,0,1,0

5,232,232,9,1,8,3,2
2,258,258,6,6,0,1,0
3,261,261,19,19,0,1,0
6,264,264,33,33,0,1,0
1,306,306,4,4,0,1,0
7,374,374,102,102,0,1,0
9,376,376,4,4,0,1,0
0,394,394,2,2,0,1,0
8,414,414,8,8,0,1,0
4,474,474,11,11,0,1,0

0,161,161,5,5,0,1,0
3,230,230,1,1,0,1,0
4,256,256,16,6,10,3,2
5,294,294,46,39,7,2,1
6,349,349,39,39,0,1,0
2,382,382,9,9,0,1,0
1,468,468,84,75,9,4,3
7,494,494,19,13,6,3,2

6,140,140,5,5,0,1,0
7,159,159,3,3,0,1,0
1,169,169,1,1,0,1,0
8,184,184,2,2,0,1,0
11,204,204,44,44,0,1,0
5,211,211,28,20,8,2,1
4,224,224,1,1,0,1,0
9,291,291,24,6,18,4,3
2,344,344,15,15,0,1,0
10,357,357,2,2,0,1,0
0,364,364,18,5,13,2,1
3,432,432,1,1,0,1,0

8,100,100,8,2,6,2,1
2,115,115,8,8,0,1,0
6,117,117,3,3,0,1,0
3,150,150,12,12,0,1,0
4,302,302,15,15,0,1,0
0,341,341,28,11,17,2,1
7,439,439,89,55,34,3,2
5,452,452,1,1,0,1,0
1,465,465,8,8,0,1,0

3,101,101,3,3,0,1,0
8,127,127,2,2,0,1,0
11,134,134,13,13,0,1,0
10,202,202,20,20,0,1,0
1,236,236,9,9,0,1,0
2,244,244,25,25,0,1,0
4,333,333,8,8,0,1,0
6,356,356,20,14,6,2,1
9,387,387,44,8,36,2,1
5,417,417,7,7,0,1,0
7,428,428,4,4,0,1,0
0,478,478,4,1,3,2,1

2,104,104,2,2,0,1,0
3,104,104,8,8,0,1,0
5,107,107,7,7,0,1,0
4,214,214,6,6,0,1,0
0,241,241,36,21,15,4,3
1,325,325,10,10,0,1,0
6,336,336,73,40,33,2,1
7,440,440,9,9,0,1,0

4,120,120,30,9,21,4,3
2,194,194,10,10,0,1,0
0,309,309,43,1,42,2,1
1,346,346,56,49,7,2,1
3,463,463,2,2,0,1,0

4,128,128,1,1,0,1,0
6,241,241,32,32,0,1,0
1,275,275,1,1,0,1,0
8,276,276,34,4,30,3,2
0,355,355,28,28,0,1,0
5,359,359,70,12,58,3,2
7,401,401,21,2,19,2,1
3,439,439,4,1,3,2,1
2,499,499,4,4,0,1,0

4,166,166,1,1,0,1,0
3,172,172,27,17,10,2,1
0,179,179,48,24,24,2,1
1,337,337,11,8,3,2,1
2,386,386,55,25,30,2,1

6,146,146,5,1,4,2,1
1,151,151,12,2,10,3,2
3,231,231,22,2,20,3,2
2,252,252,13,1,12,4,3
5,400,400,94,51,43,2,1
0,450,450,33,33,0,1,0
7,458,458,16,13,3,2,1
4,465,465,1,1,0,1,0

2,149,149,1,1,0,1,0
6,153,153,2,2,0,1,0
9,226,226,44,32,12,4,3
8,234,234,8,8,0,1,0
1,263,263,1,1,0,1,0
10,345,345,4,1,3,2,1
5,352,352,14,14,0,1,0
7,389,389,27,27,0,1,0
3,427,427,8,8,0,1,0
11,428,428,42,42,0,1,0
4,437,437,9,5,4,2,1
0,472,472,45,18,27,2,1

0,127,127,33,33,0,1,0
1,196,196,8,8,0,1,0
3,216,216,52,44,8,2,1
2,252,252,10,10,0,1,0
4,262,262,7,7,0,1,0

4,144,144,2,2,0,1,0
3,188,188,18,18,0,1,0
6,190,190,37,37,0,1,0
1,231,231,10,10,0,1,0
5,298,298,30,3,27,4,3
2,336,336,20,20,0,1,0
0,380,380,39,39,0,1,0

4,168,168,39,19,20,2,1
2,181,181,36,12,24,2,1
5,388,388,10,2,8,3,2
0,427,427,6,6,0,1,0
3,471,471,22,22,0,1,0
1,500,500,46,23,23,2,1

5,345,345,26,26,0,1,0
3,369,369,13,13,0,1,0
4,379,379,72,42,30,3,2
1,383,383,8,8,0,1,0
2,413,413,30,20,10,3,2
0,415,415,86,86,0,1,0

8,150,150,1,1,0,1,0
4,157,157,15,15,0,1,0
9,160,160,20,20,0,1,0
7,202,202,23,23,0,1,0
2,223,223,2,2,0,1,0
1,239,239,6,6,0,1,0
10,306,306,54,46,8,3,2
6,323,323,7,7,0,1,0
0,353,353,2,2,0,1,0
3,377,377,5,5,0,1,0
5,445,445,9,9,0,1,0

0,121,121,7,1,6,2,1
5,152,152,32,5,27,2,1
1,168,168,12,2,10,2,1
3,181,181,13,13,0,1,0
2,313,313,54,11,43,4,3
4,361,361,8,8,0,1,0

5,150,150,5,5,0,1,0
6,166,166,7,7,0,1,0
0,177,177,4,4,0,1,0
4,189,189,7,1,6,2,1
2,272,272,13,9,4,2,1
7,460,460,107,107,0,1,0
1,481,481,66,24,42,3,2
3,499,499,29,29,0,1,0

6,111,111,9,9,0,1,0
5,169,169,2,2,0,1,0
4,348,348,77,77,0,1,0
2,359,359,5,5,0,1,0
1,392,392,55,6,49,2,1
0,421,421,4,4,0,1,0
3,472,472,65,65,0,1,0

1,156,156,9,3,6,2,1
3,210,210,10,2,8,2,1
2,345,345,10,10,0,1,0
4,391,391,75,7,68,4,3
5,417,417,27,27,0,1,0
0,491,491,105,66,39,4,3

1,167,167,5,5,0,1,0
4,181,181,6,6,0,1,0
2,271,271,56,56,0,1,0
0,307,307,84,6,78,3,2
3,399,399,25,25,0,1,0

0,102,102,1,1,0,1,0
1,107,107,11,11,0,1,0
3,213,213,5,5,0,1,0
4,265,265,19,19,0,1,0
2,326,326,62,62,0,1,0
5,451,451,95,53,42,2,1

1,170,170,9,9,0,1,0
6,191,191,16,16,0,1,0
4,193,193,16,16,0,1,0
5,257,257,1,1,0,1,0
2,269,269,19,4,15,4,3
8,329,329,33,33,0,1,0
3,334,334,26,6,20,3,2
7,347,347,42,10,32,3,2
0,398,398,6,2,4,2,1

3,246,246,5,5,0,1,0
2,347,347,68,36,32,3,2
1,410,410,96,96,0,1,0
0,449,449,30,30,0,1,0
4,488,488,44,44,0,1,0

3,182,182,8,8,0,1,0
2,317,317,39,39,0,1,0
4,337,337,46,16,30,3,2
0,415,415,17,8,9,2,1
1,497,497,129,21,108,4,3

3,142,142,11,11,0,1,0
5,212,212,21,1,20,4,3
4,294,294,14,1,13,3,2
1,357,357,9,4,5,2,1
2,373,373,28,4,24,4,3
6,380,380,31,19,12,3,2
7,474,474,59,59,0,1,0
0,481,481,37,37,0,1,0

2,129,129,15,15,0,1,0
5,165,165,6,2,4,2,1
0,260,260,6,2,4,2,1
4,266,266,51,51,0,1,0
1,275,275,11,11,0,1,0
3,313,313,38,38,0,1,0
6,416,416,32,2,30,3,2

8,145,145,14,14,0,1,0
4,290,290,11,11,0,1,0
2,312,312,10,10,0,1,0
6,353,353,55,37,18,4,3
7,354,354,19,6,13,3,2
0,370,370,49,49,0,1,0
3,405,405,2,2,0,1,0
1,419,419,17,10,7,2,1
5,458,458,24,3,21,3,2

4,298,298,55,31,24,4,3
1,365,365,66,35,31,2,1
6,390,390,43,43,0,1,0
0,448,448,40,28,12,2,1
5,459,459,4,4,0,1,0
2,464,464,1,1,0,1,0
3,464,464,13,2,11,3,2

6,119,119,1,1,0,1,0
7,121,121,3,3,0,1,0
2,124,124,1,1,0,1,0
5,132,132,11,11,0,1,0
9,260,260,14,9,5,2,1
4,277,277,10,4,6,3,2
8,281,281,33,33,0,1,0
0,288,288,26,4,22,2,1
1,354,354,15,6,9,2,1
3,418,418,6,6,0,1,0
10,447,447,60,22,38,3,2

3,101,101,19,8,11,2,1
6,164,164,34,34,0,1,0
0,188,188,6,6,0,1,0
2,257,257,3,3,0,1,0
1,292,292,20,11,9,2,1
4,296,296,10,1,9,2,1
5,402,402,25,25,0,1,0

1,108,108,1,1,0,1,0
0,218,218,44,30,14,2,1
7,241,241,32,32,0,1,0
5,248,248,4,1,3,2,1
2,282,282,9,9,0,1,0
3,299,299,4,4,0,1,0
4,313,313,9,9,0,1,0
6,451,451,46,25,21,2,1
8,480,480,33,21,12,4,3

2,128,128,1,1,0,1,0
6,209,209,3,3,0,1,0
3,295,295,60,12,48,4,3
4,378,378,32,32,0,1,0
1,455,455,19,16,3,2,1
0,465,465,22,22,0,1,0
5,482,482,100,100,0,1,0

0,249,249,37,5,32,3,2
3,304,304,35,35,0,1,0
1,313,313,3,3,0,1,0
5,316,316,53,53,0,1,0
2,366,366,1,1,0,1,0
6,370,370,11,11,0,1,0
4,374,374,9,1,8,2,1
7,442,442,47,6,41,2,1

4,115,115,22,8,14,3,2
6,125,125,7,7,0,1,0
1,158,158,2,2,0,1,0
5,195,195,13,13,0,1,0
2,248,248,9,9,0,1,0
0,389,389,82,82,0,1,0
3,453,453,19,9,10,2,1

8,128,128,10,10,0,1,0
3,218,218,26,26,0,1,0
6,231,231,48,48,0,1,0
0,244,244,20,20,0,1,0
7,257,257,6,6,0,1,0
5,268,268,21,4,17,2,1
2,280,280,1,1,0,1,0
1,459,459,8,8,0,1,0
4,481,481,1,1,0,1,0

2,117,117,1,1,0,1,0
5,199,199,2,2,0,1,0
1,234,234,22,7,15,4,3
4,287,287,64,18,46,2,1
3,433,433,32,32,0,1,0
0,481,481,95,95,0,1,0

3,119,119,17,17,0,1,0
5,146,146,12,12,0,1,0
4,167,167,15,8,7,2,1
2,347,347,2,2,0,1,0
0,365,365,85,23,62,3,2
1,465,465,29,29,0,1,0

6,102,102,7,7,0,1,0
3,238,238,32,32,0,1,0
2,278,278,16,16,0,1,0
0,284,284,27,15,12,3,2
4,293,293,8,8,0,1,0
1,298,298,4,4,0,1,0
5,403,403,84,55,29,3,2

5,143,143,1,1,0,1,0
1,165,165,8,2,6,2,1
0,238,238,8,2,6,3,2
2,299,299,4,4,0,1,0
4,359,359,47,11,36,2,1
3,381,381,78,3,75,4,3
6,400,400,68,49,19,2,1

1,127,127,10,4,6,2,1
4,171,171,6,6,0,1,0
5,189,189,16,1,15,2,1
7,215,215,10,10,0,1,0
2,272,272,11,5,6,2,1
6,282,282,39,23,16,2,1
0,310,310,5,5,0,1,0
8,408,408,48,48,0,1,0
3,468,468,23,14,9,4,3

4,100,100,1,1,0,1,0
7,140,140,5,5,0,1,0
1,151,151,2,2,0,1,0
0,202,202,9,9,0,1,0
3,214,214,3,3,0,1,0
8,259,259,1,1,0,1,0
2,304,304,49,17,32,2,1
6,393,393,104,89,15,2,1
5,477,477,28,28,0,1,0

4,105,105,27,9,18,4,3
2,193,193,40,40,0,1,0
0,223,223,13,13,0,1,0
3,264,264,11,3,8,3,2
5,323,323,2,2,0,1,0
1,335,335,12,12,0,1,0

2,222,222,23,23,0,1,0
0,310,310,26,4,22,2,1
3,398,398,71,66,5,2,1
1,408,408,89,1,88,3,2
4,447,447,9,9,0,1,0

0,289,289,19,1,18,3,2
6,318,318,49,49,0,1,0
4,412,412,53,27,26,2,1
5,430,430,9,1,8,2,1
1,438,438,10,4,6,3,2
2,457,457,10,7,3,2,1
3,484,484,92,62,30,4,3

2,146,146,16,7,9,4,3
1,275,275,7,7,0,1,0
5,343,343,28,28,0,1,0
0,398,398,31,31,0,1,0
4,403,403,25,5,20,2,1
3,407,407,11,11,0,1,0
6,425,425,34,34,0,1,0
7,447,447,63,39,24,4,3

0,107,107,6,3,3,2,1
7,163,163,12,12,0,1,0
6,171,171,4,4,0,1,0
4,203,203,3,3,0,1,0
2,316,316,25,3,22,2,1
8,394,394,83,83,0,1,0
1,413,413,17,5,12,2,1
3,437,437,3,3,0,1,0
5,442,442,46,12,34,2,1

2,153,153,10,5,5,2,1
6,156,156,1,1,0,1,0
0,170,170,21,11,10,3,2
7,224,224,25,6,19,4,3
4,235,235,5,1,4,2,1
1,251,251,21,8,13,2,1
5,335,335,64,64,0,1,0
3,458,458,4,4,0,1,0

5,104,104,1,1,0,1,0
8,204,204,2,2,0,1,0
6,206,206,26,26,0,1,0
0,217,217,13,13,0,1,0
7,225,225,39,26,13,2,1
2,254,254,10,2,8,2,1
3,267,267,35,35,0,1,0
1,300,300,19,9,10,3,2
4,491,491,1,1,0,1,0

6,118,118,7,1,6,2,1
2,197,197,31,31,0,1,0
4,265,265,9,3,6,3,2
5,382,382,83,83,0,1,0
3,387,387,14,14,0,1,0
0,398,398,41,41,0,1,0
1,403,403,2,2,0,1,0

3,108,108,13,1,12,3,2
5,167,167,36,31,5,2,1
0,180,180,7,7,0,1,0
6,196,196,3,3,0,1,0
2,348,348,6,3,3,2,1
1,362,362,46,28,18,3,2
4,408,408,32,6,26,2,1

2,218,218,50,11,39,4,3
5,226,226,12,12,0,1,0
4,265,265,9,9,0,1,0
3,278,278,2,2,0,1,0
1,407,407,10,10,0,1,0
6,484,484,106,22,84,4,3
0,488,488,19,19,0,1,0

2,114,114,2,2,0,1,0
6,136,136,2,2,0,1,0
7,171,171,6,3,3,2,1
4,183,183,6,6,0,1,0
3,201,201,1,1,0,1,0
0,314,314,12,12,0,1,0
1,316,316,66,66,0,1,0
5,439,439,112,94,18,4,3

4,163,163,26,26,0,1,0
6,204,204,6,6,0,1,0
0,221,221,7,7,0,1,0
3,265,265,3,3,0,1,0
5,320,320,10,4,6,3,2
7,325,325,80,80,0,1,0
2,398,398,23,23,0,1,0
1,441,441,20,20,0,1,0

4,189,189,29,12,17,3,2
1,241,241,72,48,24,2,1
3,330,330,37,3,34,3,2
0,461,461,2,2,0,1,0
2,465,465,18,10,8,3,2

1,119,119,9,9,0,1,0
4,180,180,25,25,0,1,0
2,275,275,22,22,0,1,0
0,359,359,53,37,16,3,2
5,382,382,22,22,0,1,0
3,462,462,49,31,18,2,1

3,181,181,31,15,16,3,2
0,249,249,25,25,0,1,0
1,250,250,45,45,0,1,0
2,408,408,8,2,6,2,1
5,422,422,17,11,6,2,1
4,424,424,38,38,0,1,0

5,163,163,23,13,10,2,1
3,210,210,30,1,29,2,1
0,241,241,26,16,10,2,1
6,252,252,5,5,0,1,0
2,281,281,8,8,0,1,0
1,407,407,10,4,6,2,1
4,425,425,61,46,15,3,2

1,202,202,27,15,12,2,1
3,229,229,16,11,5,2,1
4,245,245,42,42,0,1,0
2,258,258,17,7,10,3,2
0,323,323,54,54,0,1,0

0,169,169,36,7,29,2,1
1,223,223,20,2,18,2,1
4,423,423,36,14,22,4,3
3,469,469,69,69,0,1,0
2,486,486,35,35,0,1,0

2,145,145,3,3,0,1,0
4,152,152,15,9,6,3,2
3,173,173,3,3,0,1,0
1,200,200,11,11,0,1,0
0,264,264,7,2,5,2,1
7,285,285,28,22,6,2,1
6,381,381,40,40,0,1,0
8,450,450,44,44,0,1,0
5,482,482,40,13,27,4,3

8,114,114,7,1,6,3,2
4,174,174,1,1,0,1,0
7,186,186,4,1,3,2,1
1,260,260,12,12,0,1,0
0,284,284,1,1,0,1,0
10,332,332,36,36,0,1,0
3,394,394,2,2,0,1,0
5,436,436,31,31,0,1,0
9,443,443,60,60,0,1,0
2,463,463,42,12,30,3,2
6,486,486,29,18,11,2,1

1,178,178,37,17,20,2,1
6,219,219,35,9,26,3,2
3,221,221,20,20,0,1,0
4,243,243,26,26,0,1,0
5,279,279,11,11,0,1,0
0,355,355,1,1,0,1,0
2,484,484,1,1,0,1,0

3,110,110,7,7,0,1,0
2,119,119,5,1,4,2,1
8,148,148,40,17,23,2,1
4,164,164,4,4,0,1,0
5,242,242,3,3,0,1,0
0,285,285,30,30,0,1,0
6,445,445,9,2,7,2,1
1,469,469,25,25,0,1,0
7,492,492,7,7,0,1,0

3,127,127,9,9,0,1,0
0,205,205,62,62,0,1,0
2,219,219,43,43,0,1,0
1,290,290,11,2,9,4,3

5,133,133,10,10,0,1,0
1,187,187,4,4,0,1,0
2,241,241,13,1,12,2,1
3,306,306,9,9,0,1,0
6,367,367,83,74,9,4,3
4,450,450,2,2,0,1,0
0,499,499,99,99,0,1,0

6,117,117,10,10,0,1,0
5,140,140,15,15,0,1,0
4,190,190,22,22,0,1,0
2,266,266,31,31,0,1,0
0,328,328,3,3,0,1,0
3,355,355,31,22,9,4,3
1,436,436,39,13,26,3,2

2,117,117,29,29,0,1,0
1,131,131,5,1,4,2,1
0,311,311,94,94,0,1,0
3,417,417,9,9,0,1,0

1,100,100,1,1,0,1,0
6,150,150,23,23,0,1,0
5,202,202,10,10,0,1,0
3,298,298,32,32,0,1,0
4,299,299,32,32,0,1,0
2,342,342,36,36,0,1,0
0,448,448,35,35,0,1,0

5,134,134,36,36,0,1,0
0,183,183,12,12,0,1,0
6,185,185,5,1,4,2,1
4,202,202,2,2,0,1,0
1,367,367,28,28,0,1,0
3,401,401,49,49,0,1,0
2,432,432,16,3,13,2,1

1,164,164,9,9,0,1,0
2,235,235,35,35,0,1,0
4,383,383,6,6,0,1,0
3,494,494,69,69,0,1,0
0,498,498,125,43,82,3,2

1,113,113,13,1,12,4,3
0,284,284,53,53,0,1,0
3,341,341,33,23,10,3,2
4,341,341,70,17,53,3,2
2,479,479,1,1,0,1,0

0,174,174,3,3,0,1,0
1,197,197,1,1,0,1,0
2,218,218,11,1,10,3,2
10,263,263,24,24,0,1,0
9,272,272,36,23,13,2,1
7,276,276,38,8,30,4,3
6,285,285,2,2,0,1,0
8,292,292,24,24,0,1,0
5,403,403,14,14,0,1,0
4,406,406,13,1,12,2,1
3,481,481,9,2,7,2,1

5,109,109,6,6,0,1,0
0,139,139,2,2,0,1,0
6,180,180,45,25,20,2,1
1,206,206,46,46,0,1,0
4,305,305,2,2,0,1,0
2,380,380,3,3,0,1,0
3,381,381,21,21,0,1,0

1,164,164,20,20,0,1,0
0,244,244,19,19,0,1,0
3,260,260,59,59,0,1,0
4,285,285,14,6,8,2,1
2,301,301,31,31,0,1,0
5,394,394,12,7,5,2,1

1,101,101,10,10,0,1,0
5,183,183,53,23,30,2,1
0,244,244,14,14,0,1,0
2,251,251,37,37,0,1,0
3,318,318,1,1,0,1,0
4,386,386,6,6,0,1,0

2,122,122,9,9,0,1,0
4,128,128,6,2,4,2,1
6,196,196,31,24,7,2,1
3,265,265,2,2,0,1,0
1,365,365,6,6,0,1,0
5,383,383,41,13,28,3,2
0,457,457,93,93,0,1,0

3,100,100,1,1,0,1,0
8,172,172,5,5,0,1,0
6,175,175,23,2,21,4,3
7,176,176,27,27,0,1,0
1,222,222,4,4,0,1,0
2,225,225,2,2,0,1,0
0,287,287,56,15,41,4,3
4,373,373,15,15,0,1,0
5,467,467,13,13,0,1,0

5,142,142,31,31,0,1,0
4,219,219,8,5,3,2,1
0,280,280,47,47,0,1,0
3,322,322,17,17,0,1,0
2,357,357,43,43,0,1,0
1,413,413,5,1,4,2,1

0,208,208,21,21,0,1,0
4,225,225,10,10,0,1,0
3,259,259,6,6,0,1,0
2,330,330,79,53,26,4,3
1,359,359,72,20,52,3,2

3,182,182,39,13,26,2,1
2,243,243,20,20,0,1,0
0,254,254,50,50,0,1,0
1,314,314,33,13,20,2,1
4,333,333,3,3,0,1,0

3,122,122,6,6,0,1,0
7,234,234,19,5,14,4,3
2,238,238,11,11,0,1,0
0,259,259,22,4,18,4,3
5,279,279,20,13,7,3,2
4,320,320,10,2,8,3,2
6,462,462,70,70,0,1,0
1,466,466,42,21,21,2,1

1,101,101,7,7,0,1,0
0,110,110,15,7,8,2,1
3,166,166,37,31,6,3,2
5,309,309,7,7,0,1,0
4,346,346,21,3,18,2,1
2,472,472,45,27,18,4,3

5,196,196,14,14,0,1,0
3,207,207,12,12,0,1,0
1,214,214,1,1,0,1,0
6,248,248,30,30,0,1,0
2,470,470,53,53,0,1,0
0,480,480,62,52,10,3,2
4,494,494,57,9,48,4,3

2,130,130,12,6,6,2,1
1,155,155,9,9,0,1,0
3,188,188,8,8,0,1,0
5,308,308,25,11,14,2,1
0,315,315,13,13,0,1,0
4,394,394,26,26,0,1,0
7,415,415,29,6,23,3,2
6,459,459,70,66,4,2,1

2,117,117,13,10,3,2,1
7,205,205,3,3,0,1,0
6,290,290,42,42,0,1,0
5,370,370,54,31,23,2,1
4,371,371,8,8,0,1,0
3,390,390,3,3,0,1,0
1,404,404,64,18,46,2,1
0,420,420,1,1,0,1,0

1,104,104,5,5,0,1,0
4,184,184,8,3,5,2,1
2,229,229,23,9,14,2,1
7,234,234,39,3,36,4,3
6,339,339,3,3,0,1,0
5,400,400,3,3,0,1,0
0,405,405,2,2,0,1,0
9,439,439,28,28,0,1,0
8,461,461,34,19,15,2,1
3,489,489,43,7,36,4,3

0,108,108,1,1,0,1,0
1,192,192,41,1,40,2,1
2,239,239,4,4,0,1,0
4,364,364,98,98,0,1,0
3,368,368,23,23,0,1,0
5,368,368,12,5,7,2,1
6,379,379,1,1,0,1,0

2,152,152,12,4,8,3,2
1,173,173,33,33,0,1,0
5,258,258,44,44,0,1,0
4,355,355,44,23,21,4,3
0,415,415,13,1,12,3,2
3,445,445,5,5,0,1,0

0,125,125,8,8,0,1,0
1,139,139,2,2,0,1,0
8,151,151,25,20,5,2,1
2,198,198,23,23,0,1,0
4,224,224,2,2,0,1,0
5,301,301,24,24,0,1,0
3,377,377,7,7,0,1,0
7,394,394,41,41,0,1,0
6,439,439,16,16,0,1,0

7,121,121,2,2,0,1,0
5,133,133,21,6,15,2,1
6,176,176,26,26,0,1,0
0,181,181,1,1,0,1,0
2,199,199,2,2,0,1,0
3,351,351,22,22,0,1,0
4,446,446,2,2,0,1,0
8,450,450,62,14,48,3,2
1,494,494,31,4,27,4,3

3,132,132,1,1,0,1,0
5,187,187,37,11,26,3,2
6,309,309,23,3,20,3,2
0,310,310,63,45,18,4,3
1,338,338,9,3,6,2,1
2,377,377,17,5,12,3,2
7,468,468,15,15,0,1,0
4,471,471,9,9,0,1,0

7,123,123,18,18,0,1,0
8,231,231,17,8,9,4,3
4,245,245,5,2,3,2,1
1,249,249,17,17,0,1,0
3,269,269,27,21,6,3,2
0,309,309,10,10,0,1,0
6,414,414,37,37,0,1,0
5,429,429,9,2,7,2,1
2,451,451,27,10,17,4,3

5,236,236,17,8,9,4,3
1,323,323,68,68,0,1,0
4,370,370,9,9,0,1,0
0,412,412,25,2,23,2,1
3,427,427,88,37,51,4,3
2,488,488,15,15,0,1,0

5,169,169,25,17,8,3,2
4,224,224,34,34,0,1,0
1,234,234,22,22,0,1,0
0,286,286,26,26,0,1,0
2,289,289,22,22,0,1,0
6,337,337,3,3,0,1,0
3,380,380,15,2,13,4,3

7,105,105,16,6,10,2,1
1,110,110,11,11,0,1,0
4,183,183,2,2,0,1,0
6,200,200,4,4,0,1,0
0,263,263,28,14,14,2,1
2,266,266,12,12,0,1,0
3,285,285,11,11,0,1,0
5,464,464,62,54,8,2,1

5,130,130,4,1,3,2,1
1,166,166,14,2,12,3,2
0,171,171,5,1,4,2,1
3,195,195,4,4,0,1,0
2,305,305,23,18,5,2,1
6,346,346,35,35,0,1,0
7,356,356,64,22,42,4,3
4,379,379,24,24,0,1,0
8,385,385,9,9,0,1,0

2,199,199,14,6,8,2,1
1,264,264,44,2,42,4,3
0,318,318,96,9,87,4,3
3,453,453,31,31,0,1,0

0,306,306,92,20,72,3,2
3,428,428,67,67,0,1,0
1,450,450,11,11,0,1,0
2,464,464,56,6,50,3,2

4,174,174,2,2,0,1,0
0,177,177,37,10,27,4,3
5,241,241,58,34,24,3,2
1,284,284,14,14,0,1,0
2,293,293,13,13,0,1,0
3,485,485,26,26,0,1,0

2,107,107,8,8,0,1,0
3,248,248,30,30,0,1,0
6,290,290,6,6,0,1,0
4,324,324,31,25,6,2,1
5,360,360,68,11,57,3,2
1,490,490,36,21,15,2,1
0,495,495,16,3,13,2,1

0,173,173,2,2,0,1,0
7,208,208,1,1,0,1,0
2,245,245,15,15,0,1,0
6,245,245,5,5,0,1,0
10,269,269,6,6,0,1,0
8,270,270,43,43,0,1,0
3,302,302,9,9,0,1,0
4,316,316,16,16,0,1,0
9,389,389,47,47,0,1,0
1,392,392,41,41,0,1,0
5,411,411,7,1,6,2,1

1,101,101,17,7,10,2,1
5,149,149,6,6,0,1,0
2,252,252,15,3,12,4,3
3,355,355,6,6,0,1,0
0,479,479,35,2,33,4,3
4,482,482,119,29,90,4,3

5,104,104,9,9,0,1,0
3,175,175,15,1,14,3,2
6,181,181,9,6,3,2,1
0,189,189,3,3,0,1,0
2,405,405,32,32,0,1,0
1,466,466,56,56,0,1,0
4,481,481,83,32,51,4,3

4,140,140,2,2,0,1,0
5,215,215,36,5,31,2,1
7,247,247,6,6,0,1,0
0,268,268,11,11,0,1,0
3,300,300,22,4,18,4,3
1,411,411,1,1,0,1,0
2,439,439,1,1,0,1,0
8,494,494,52,52,0,1,0
6,495,495,85,85,0,1,0

4,127,127,7,7,0,1,0
2,276,276,31,31,0,1,0
6,301,301,45,11,34,2,1
1,329,329,14,6,8,2,1
3,365,365,36,36,0,1,0
0,406,406,19,7,12,4,3
5,441,441,45,45,0,1,0

6,109,109,3,3,0,1,0
8,119,119,5,5,0,1,0
1,177,177,14,10,4,2,1
2,179,179,8,8,0,1,0
5,189,189,15,15,0,1,0
3,224,224,1,1,0,1,0
0,349,349,12,12,0,1,0
4,382,382,14,10,4,2,1
9,397,397,60,60,0,1,0
7,497,497,54,54,0,1,0

2,149,149,21,21,0,1,0
7,164,164,15,15,0,1,0
1,212,212,10,2,8,3,2
6,233,233,48,48,0,1,0
0,237,237,19,19,0,1,0
3,295,295,1,1,0,1,0
5,397,397,1,1,0,1,0
4,399,399,11,5,6,3,2
8,471,471,4,4,0,1,0

0,226,226,68,25,43,2,1
1,228,228,6,6,0,1,0
2,403,403,4,4,0,1,0
3,469,469,126,117,9,4,3

3,284,284,40,4,36,3,2
2,298,298,48,19,29,2,1
0,299,299,57,20,37,2,1
4,378,378,1,1,0,1,0
1,427,427,47,20,27,2,1

1,199,199,5,5,0,1,0
0,306,306,92,35,57,4,3
2,379,379,104,86,18,2,1
3,418,418,3,3,0,1,0

2,106,106,23,23,0,1,0
5,117,117,15,8,7,2,1
3,190,190,1,1,0,1,0
0,398,398,1,1,0,1,0
1,449,449,37,37,0,1,0
4,475,475,84,84,0,1,0

2,144,144,16,16,0,1,0
1,163,163,8,2,6,2,1
5,163,163,6,6,0,1,0
4,242,242,4,4,0,1,0
0,411,411,31,9,22,3,2
3,457,457,30,7,23,2,1
6,499,499,125,65,60,3,2

1,139,139,1,1,0,1,0
6,182,182,5,5,0,1,0
5,201,201,8,8,0,1,0
3,218,218,13,3,10,2,1
7,249,249,60,60,0,1,0
2,290,290,37,3,34,2,1
0,293,293,25,25,0,1,0
4,387,387,8,8,0,1,0

2,213,213,5,5,0,1,0
1,246,246,50,50,0,1,0
0,371,371,112,51,61,4,3
3,478,478,37,13,24,2,1

3,168,168,25,25,0,1,0
0,212,212,64,64,0,1,0
1,329,329,25,4,21,4,3
2,416,416,33,6,27,2,1

6,138,138,31,13,18,2,1
1,271,271,43,13,30,4,3
3,345,345,27,27,0,1,0
5,352,352,5,5,0,1,0
0,370,370,7,7,0,1,0
4,384,384,27,6,21,2,1
2,429,429,19,19,0,1,0

0,156,156,8,8,0,1,0
1,193,193,44,44,0,1,0
2,227,227,5,5,0,1,0
4,352,352,63,43,20,3,2
5,392,392,48,48,0,1,0
3,460,460,1,1,0,1,0

4,183,183,35,35,0,1,0
2,214,214,17,1,16,3,2
3,217,217,10,5,5,2,1
6,239,239,11,4,7,2,1
1,339,339,44,17,27,3,2
5,357,357,26,12,14,2,1
0,372,372,17,12,5,2,1

5,231,231,49,10,39,4,3
3,377,377,20,5,15,3,2
2,423,423,1,1,0,1,0
0,424,424,39,39,0,1,0
1,437,437,90,57,33,4,3
4,477,477,18,6,12,2,1

0,102,102,2,2,0,1,0
6,150,150,18,18,0,1,0
1,181,181,44,44,0,1,0
2,245,245,7,7,0,1,0
3,292,292,3,3,0,1,0
4,379,379,6,6,0,1,0
5,456,456,77,50,27,4,3

2,235,235,7,7,0,1,0
4,262,262,34,34,0,1,0
6,318,318,11,11,0,1,0
0,409,409,30,30,0,1,0
5,414,414,95,5,90,4,3
1,450,450,11,5,6,3,2
7,484,484,20,20,0,1,0
3,490,490,22,1,21,2,1

2,241,241,17,5,12,4,3
3,317,317,57,57,0,1,0
1,478,478,26,26,0,1,0
0,480,480,145,112,33,4,3

8,169,169,11,11,0,1,0
0,184,184,1,1,0,1,0
7,268,268,13,2,11,2,1
6,361,361,69,22,47,3,2
5,362,362,28,28,0,1,0
3,380,380,44,38,6,3,2
4,407,407,20,20,0,1,0
2,456,456,7,1,6,2,1
1,476,476,18,12,6,2,1

1,226,226,49,49,0,1,0
2,346,346,7,7,0,1,0
4,400,400,27,27,0,1,0
0,419,419,36,4,32,4,3
3,487,487,106,106,0,1,0

4,276,276,62,62,0,1,0
3,285,285,19,9,10,2,1
1,354,354,11,8,3,2,1
0,399,399,63,19,44,3,2
5,406,406,6,6,0,1,0
2,469,469,53,11,42,4,3

2,152,152,15,15,0,1,0
4,175,175,8,1,7,2,1
1,197,197,39,39,0,1,0
0,219,219,23,23,0,1,0
3,437,437,73,73,0,1,0

0,130,130,9,9,0,1,0
1,134,134,17,17,0,1,0
7,240,240,36,36,0,1,0
2,249,249,7,1,6,3,2
8,260,260,11,6,5,2,1
6,317,317,4,4,0,1,0
4,336,336,1,1,0,1,0
9,389,389,43,43,0,1,0
5,433,433,1,1,0,1,0
3,489,489,29,12,17,4,3

4,195,195,19,19,0,1,0
2,211,211,12,8,4,2,1
3,272,272,27,18,9,4,3
0,334,334,13,9,4,2,1
6,434,434,65,56,9,4,3
1,457,457,49,27,22,3,2
5,492,492,28,23,5,2,1

2,133,133,3,3,0,1,0
0,191,191,6,6,0,1,0
3,195,195,7,7,0,1,0
7,266,266,25,1,24,4,3
4,272,272,1,1,0,1,0
8,287,287,47,14,33,4,3
9,314,314,14,4,10,2,1
1,333,333,47,47,0,1,0
6,399,399,5,5,0,1,0
5,441,441,24,19,5,2,1

0,175,175,41,9,32,3,2
5,211,211,14,9,5,2,1
1,240,240,8,8,0,1,0
4,304,304,72,13,59,4,3
2,360,360,12,12,0,1,0
3,379,379,1,1,0,1,0

2,238,238,8,8,0,1,0
0,303,303,38,38,0,1,0
4,345,345,52,52,0,1,0
3,390,390,47,33,14,2,1
1,459,459,81,81,0,1,0

3,113,113,1,1,0,1,0
2,256,256,37,29,8,3,2
1,317,317,44,44,0,1,0
0,477,477,77,51,26,4,3
4,499,499,77,77,0,1,0

2,108,108,3,3,0,1,0
1,129,129,1,1,0,1,0
5,140,140,4,4,0,1,0
6,214,214,12,12,0,1,0
3,275,275,8,8,0,1,0
4,289,289,50,28,22,2,1
0,359,359,23,11,12,4,3
7,450,450,100,2,98,3,2

8,116,116,23,8,15,4,3
6,147,147,11,1,10,2,1
5,154,154,9,9,0,1,0
1,187,187,7,2,5,2,1
4,193,193,18,3,15,2,1
2,321,321,2,2,0,1,0
7,322,322,12,12,0,1,0
3,363,363,14,14,0,1,0
0,482,482,32,14,18,2,1

2,197,197,30,30,0,1,0
1,211,211,12,12,0,1,0
6,285,285,6,6,0,1,0
4,309,309,35,23,12,4,3
3,326,326,2,2,0,1,0
0,346,346,30,30,0,1,0
5,360,360,61,61,0,1,0

1,140,140,15,15,0,1,0
3,171,171,3,3,0,1,0
4,184,184,23,23,0,1,0
6,368,368,65,12,53,4,3
0,413,413,67,12,55,3,2
2,430,430,6,6,0,1,0
5,499,499,1,1,0,1,0

4,103,103,2,2,0,1,0
0,165,165,2,2,0,1,0
2,232,232,44,20,24,2,1
1,309,309,15,11,4,2,1
3,451,451,23,23,0,1,0
5,451,451,117,91,26,2,1
6,454,454,11,11,0,1,0

2,283,283,28,28,0,1,0
3,339,339,1,1,0,1,0
5,361,361,86,86,0,1,0
1,388,388,6,6,0,1,0
4,452,452,27,18,9,4,3
0,474,474,88,88,0,1,0

0,114,114,35,26,9,2,1
1,288,288,29,29,0,1,0
3,369,369,22,22,0,1,0
2,478,478,69,69,0,1,0

3,201,201,9,6,3,2,1
0,317,317,96,63,33,4,3
1,365,365,52,34,18,3,2
2,387,387,46,22,24,2,1

2,174,174,1,1,0,1,0
3,206,206,10,5,5,2,1
4,244,244,14,4,10,3,2
6,253,253,6,1,5,2,1
7,259,259,64,25,39,4,3
5,307,307,11,4,7,2,1
0,337,337,25,4,21,3,2
1,342,342,40,10,30,2,1

1,111,111,17,3,14,2,1
0,221,221,21,6,15,2,1
4,296,296,8,5,3,2,1
3,323,323,74,74,0,1,0
2,356,356,19,19,0,1,0
5,490,490,24,24,0,1,0

1,140,140,22,1,21,2,1
6,148,148,3,3,0,1,0
5,190,190,11,11,0,1,0
4,236,236,55,55,0,1,0
0,278,278,11,4,7,2,1
2,322,322,17,17,0,1,0
3,361,361,19,19,0,1,0

1,156,156,9,9,0,1,0
4,212,212,11,11,0,1,0
6,248,248,45,19,26,3,2
2,296,296,6,6,0,1,0
3,320,320,54,4,50,4,3
0,432,432,24,7,17,2,1
5,457,457,33,19,14,3,2

4,148,148,6,6,0,1,0
3,161,161,3,3,0,1,0
2,173,173,23,23,0,1,0
7,179,179,11,11,0,1,0
1,210,210,7,1,6,2,1
8,214,214,21,12,9,2,1
0,262,262,19,19,0,1,0
5,376,376,1,1,0,1,0
6,398,398,59,59,0,1,0

5,154,154,4,4,0,1,0
3,184,184,28,28,0,1,0
0,278,278,38,20,18,4,3
4,316,316,41,6,35,4,3
1,371,371,49,40,9,2,1
2,434,434,14,6,8,3,2

3,108,108,12,8,4,2,1
2,317,317,21,21,0,1,0
4,381,381,47,12,35,2,1
0,411,411,49,49,0,1,0
1,443,443,81,23,58,3,2

4,106,106,6,6,0,1,0
0,316,316,1,1,0,1,0
3,346,346,7,7,0,1,0
5,440,440,3,3,0,1,0
6,470,470,115,61,54,4,3
2,477,477,2,2,0,1,0
1,493,493,135,39,96,4,3

7,137,137,14,14,0,1,0
4,139,139,5,5,0,1,0
2,280,280,4,4,0,1,0
5,309,309,38,38,0,1,0
0,325,325,27,27,0,1,0
1,339,339,7,3,4,2,1
8,365,365,21,21,0,1,0
6,431,431,64,22,42,3,2
3,451,451,11,11,0,1,0

4,111,111,2,2,0,1,0
2,150,150,35,35,0,1,0
0,300,300,11,11,0,1,0
3,367,367,20,20,0,1,0
1,382,382,101,101,0,1,0

8,116,116,9,1,8,3,2
7,163,163,32,8,24,3,2
1,193,193,5,5,0,1,0
5,264,264,4,1,3,2,1
0,285,285,4,4,0,1,0
3,303,303,11,11,0,1,0
6,335,335,3,3,0,1,0
4,366,366,72,27,45,2,1
9,388,388,14,14,0,1,0
2,480,480,2,2,0,1,0

2,159,159,32,32,0,1,0
1,264,264,17,1,16,3,2
3,337,337,18,2,16,3,2
0,344,344,82,82,0,1,0
4,486,486,25,7,18,2,1

3,301,301,63,63,0,1,0
2,322,322,2,2,0,1,0
1,333,333,58,58,0,1,0
4,343,343,31,14,17,2,1
0,374,374,48,8,40,3,2

7,113,113,1,1,0,1,0
8,176,176,26,11,15,2,1
6,190,190,10,2,8,3,2
2,222,222,25,25,0,1,0
9,246,246,39,39,0,1,0
0,264,264,1,1,0,1,0
5,333,333,18,18,0,1,0
4,349,349,7,7,0,1,0
1,423,423,3,3,0,1,0
3,461,461,23,2,21,4,3

0,111,111,2,2,0,1,0
6,124,124,1,1,0,1,0
1,131,131,1,1,0,1,0
2,155,155,1,1,0,1,0
7,213,213,24,15,9,4,3
5,253,253,63,30,33,2,1
4,268,268,1,1,0,1,0
9,394,394,26,26,0,1,0
8,396,396,50,50,0,1,0
3,405,405,4,4,0,1,0

3,135,135,1,1,0,1,0
8,217,217,45,45,0,1,0
4,296,296,22,13,9,2,1
1,297,297,1,1,0,1,0
5,305,305,3,3,0,1,0
6,324,324,19,19,0,1,0
2,392,392,54,44,10,2,1
0,463,463,32,32,0,1,0
7,467,467,17,17,0,1,0

5,180,180,7,7,0,1,0
1,197,197,3,3,0,1,0
3,227,227,48,48,0,1,0
0,321,321,27,21,6,2,1
4,384,384,21,3,18,3,2
2,433,433,87,87,0,1,0

0,154,154,9,9,0,1,0
1,259,259,63,63,0,1,0
3,350,350,26,26,0,1,0
2,434,434,79,64,15,2,1
4,458,458,22,22,0,1,0

1,121,121,13,6,7,2,1
4,195,195,14,14,0,1,0
2,299,299,17,17,0,1,0
0,366,366,50,24,26,3,2
5,400,400,70,48,22,2,1
3,496,496,29,23,6,2,1

8,161,161,9,1,8,2,1
4,165,165,5,1,4,2,1
9,171,171,6,6,0,1,0
1,179,179,12,12,0,1,0
5,189,189,1,1,0,1,0
0,231,231,10,5,5,2,1
7,266,266,3,3,0,1,0
6,277,277,3,3,0,1,0
3,292,292,14,2,12,2,1
10,367,367,79,46,33,2,1
2,399,399,34,25,9,4,3

5,160,160,46,46,0,1,0
0,187,187,1,1,0,1,0
3,247,247,3,3,0,1,0
2,350,350,43,43,0,1,0
4,460,460,3,3,0,1,0
1,490,490,85,30,55,4,3

6,107,107,2,2,0,1,0
3,212,212,23,23,0,1,0
1,356,356,16,13,3,2,1
2,386,386,48,48,0,1,0
0,413,413,10,10,0,1,0
5,414,414,94,90,4,2,1
4,456,456,27,9,18,2,1

3,203,203,39,39,0,1,0
2,225,225,4,4,0,1,0
1,236,236,18,18,0,1,0
0,326,326,5,5,0,1,0
6,373,373,87,41,46,2,1
5,400,400,1,1,0,1,0
4,439,439,30,16,14,2,1

2,141,141,1,1,0,1,0
7,173,173,30,3,27,2,1
6,231,231,29,3,26,4,3
5,335,335,1,1,0,1,0
4,345,345,39,18,21,4,3
3,359,359,42,2,40,4,3
1,432,432,21,5,16,3,2
0,439,439,7,3,4,2,1

0,123,123,1,1,0,1,0
4,152,152,39,15,24,4,3
6,224,224,10,10,0,1,0
3,363,363,66,66,0,1,0
1,369,369,31,31,0,1,0
2,451,451,12,12,0,1,0
5,469,469,1,1,0,1,0

1,107,107,13,13,0,1,0
3,117,117,1,1,0,1,0
5,208,208,22,22,0,1,0
0,327,327,53,53,0,1,0
2,355,355,3,3,0,1,0
4,365,365,71,41,30,4,3
6,470,470,2,2,0,1,0

1,197,197,8,8,0,1,0
7,225,225,7,7,0,1,0
6,290,290,42,34,8,3,2
2,326,326,31,2,29,2,1
4,327,327,20,20,0,1,0
0,389,389,26,5,21,2,1
5,447,447,58,58,0,1,0
3,448,448,17,17,0,1,0

1,138,138,33,33,0,1,0
0,151,151,2,2,0,1,0
3,189,189,8,3,5,2,1
2,219,219,2,2,0,1,0
5,291,291,71,71,0,1,0
4,355,355,18,12,6,2,1
6,358,358,3,3,0,1,0

5,142,142,19,15,4,2,1
7,233,233,31,31,0,1,0
4,340,340,33,15,18,3,2
0,352,352,45,11,34,2,1
1,357,357,8,2,6,3,2
2,362,362,5,1,4,2,1
3,387,387,16,1,15,2,1
6,480,480,19,4,15,4,3

8,120,120,6,6,0,1,0
6,132,132,14,14,0,1,0
5,182,182,14,14,0,1,0
4,250,250,1,1,0,1,0
3,265,265,34,25,9,4,3
2,281,281,16,5,11,2,1
1,320,320,6,6,0,1,0
7,328,328,51,51,0,1,0
0,421,421,8,1,7,2,1

5,154,154,18,14,4,2,1
4,171,171,36,14,22,4,3
6,174,174,3,3,0,1,0
3,204,204,3,3,0,1,0
1,207,207,1,1,0,1,0
2,288,288,16,16,0,1,0
7,333,333,56,12,44,2,1
0,408,408,8,5,3,2,1

1,162,162,16,12,4,2,1
0,178,178,1,1,0,1,0
6,258,258,10,6,4,2,1
2,368,368,63,5,58,3,2
5,391,391,55,55,0,1,0
3,482,482,12,12,0,1,0
4,497,497,63,63,0,1,0

2,171,171,12,1,11,2,1
1,187,187,14,14,0,1,0
6,201,201,5,5,0,1,0
5,218,218,48,12,36,4,3
4,277,277,17,17,0,1,0
0,342,342,33,33,0,1,0
3,386,386,23,11,12,3,2

5,133,133,8,4,4,2,1
1,137,137,3,3,0,1,0
3,212,212,43,17,26,2,1
0,240,240,3,3,0,1,0
6,269,269,2,2,0,1,0
2,320,320,8,8,0,1,0
4,386,386,15,15,0,1,0
7,424,424,102,90,12,4,3

1,129,129,4,4,0,1,0
4,165,165,11,11,0,1,0
3,169,169,22,13,9,4,3
0,219,219,12,6,6,3,2
6,272,272,49,10,39,3,2
2,338,338,7,7,0,1,0
5,351,351,10,10,0,1,0
7,424,424,40,10,30,2,1

8,104,104,11,7,4,2,1
7,216,216,6,6,0,1,0
1,232,232,8,2,6,3,2
5,347,347,5,5,0,1,0
4,351,351,12,12,0,1,0
0,385,385,37,9,28,3,2
9,393,393,69,69,0,1,0
2,400,400,13,13,0,1,0
3,422,422,27,3,24,3,2
6,437,437,11,1,10,2,1

4,165,165,15,15,0,1,0
6,307,307,26,26,0,1,0
0,337,337,39,25,14,2,1
3,374,374,38,5,33,4,3
2,443,443,24,24,0,1,0
5,487,487,64,64,0,1,0
1,490,490,14,7,7,2,1

3,149,149,5,5,0,1,0
4,340,340,23,23,0,1,0
2,350,350,58,2,56,3,2
5,384,384,73,42,31,2,1
0,390,390,22,22,0,1,0
6,478,478,21,11,10,2,1
1,484,484,24,24,0,1,0

3,102,102,4,4,0,1,0
6,173,173,4,4,0,1,0
8,212,212,28,28,0,1,0
1,280,280,6,2,4,2,1
7,370,370,39,39,0,1,0
9,411,411,28,28,0,1,0
0,416,416,9,9,0,1,0
4,425,425,62,45,17,3,2
2,490,490,6,3,3,2,1
5,490,490,18,10,8,3,2

0,121,121,37,29,8,2,1
1,149,149,15,10,5,2,1
3,311,311,60,3,57,4,3
2,484,484,5,1,4,2,1

0,122,122,21,21,0,1,0
6,138,138,38,38,0,1,0
1,225,225,3,3,0,1,0
3,232,232,22,15,7,2,1
7,305,305,5,5,0,1,0
4,445,445,2,2,0,1,0
5,477,477,8,4,4,2,1
2,486,486,8,8,0,1,0

1,104,104,1,1,0,1,0
3,118,118,30,7,23,2,1
6,237,237,45,36,9,4,3
4,266,266,6,6,0,1,0
5,395,395,36,4,32,2,1
0,416,416,1,1,0,1,0
2,441,441,17,3,14,2,1

1,175,175,1,1,0,1,0
3,206,206,45,45,0,1,0
4,235,235,11,8,3,2,1
5,290,290,21,21,0,1,0
0,301,301,21,5,16,2,1
2,306,306,2,2,0,1,0
6,436,436,81,11,70,3,2

0,129,129,23,9,14,3,2
5,288,288,37,18,19,2,1
1,296,296,3,3,0,1,0
3,336,336,51,11,40,3,2
2,370,370,42,28,14,2,1
4,461,461,10,4,6,3,2

3,139,139,21,11,10,3,2
0,159,159,1,1,0,1,0
2,264,264,28,28,0,1,0
4,297,297,10,10,0,1,0
1,372,372,16,16,0,1,0
5,416,416,81,21,60,3,2
6,490,490,36,30,6,2,1

4,110,110,1,1,0,1,0
3,125,125,31,31,0,1,0
2,209,209,40,40,0,1,0
0,317,317,31,17,14,2,1
5,337,337,17,17,0,1,0
1,370,370,5,5,0,1,0

4,106,106,21,21,0,1,0
8,122,122,15,4,11,2,1
2,264,264,15,15,0,1,0
1,267,267,2,2,0,1,0
7,268,268,16,2,14,4,3
3,285,285,2,2,0,1,0
5,291,291,9,2,7,2,1
6,340,340,42,42,0,1,0
0,394,394,1,1,0,1,0

4,127,127,3,3,0,1,0
0,156,156,44,12,32,4,3
2,347,347,38,38,0,1,0
1,433,433,8,1,7,3,2
3,467,467,79,79,0,1,0

4,101,101,6,6,0,1,0
3,166,166,27,3,24,2,1
2,264,264,19,19,0,1,0
6,269,269,20,8,12,4,3
7,285,285,16,16,0,1,0
0,377,377,1,1,0,1,0
5,471,471,83,64,19,2,1
1,475,475,4,4,0,1,0

6,106,106,17,17,0,1,0
7,326,326,16,16,0,1,0
3,375,375,14,5,9,3,2
0,406,406,6,6,0,1,0
1,412,412,73,41,32,3,2
5,459,459,44,44,0,1,0
2,490,490,14,14,0,1,0
4,496,496,21,3,18,3,2

2,176,176,6,6,0,1,0
0,181,181,1,1,0,1,0
1,257,257,31,31,0,1,0
3,364,364,36,3,33,4,3
5,375,375,68,68,0,1,0
7,417,417,33,7,26,3,2
6,438,438,19,11,8,3,2
4,477,477,20,1,19,3,2

4,173,173,33,1,32,3,2
3,449,449,1,1,0,1,0
2,458,458,52,28,24,2,1
1,467,467,43,43,0,1,0
0,475,475,99,99,0,1,0

4,107,107,16,16,0,1,0
0,140,140,8,3,5,2,1
1,154,154,1,1,0,1,0
2,226,226,40,9,31,2,1
6,286,286,13,13,0,1,0
3,337,337,21,21,0,1,0
5,351,351,39,39,0,1,0

2,106,106,10,10,0,1,0
6,115,115,19,19,0,1,0
1,184,184,24,13,11,2,1
7,226,226,18,8,10,3,2
4,234,234,1,1,0,1,0
3,330,330,13,13,0,1,0
0,438,438,15,8,7,2,1
5,469,469,30,30,0,1,0

2,171,171,11,11,0,1,0
5,272,272,13,1,12,3,2
1,305,305,11,2,9,2,1
4,317,317,37,23,14,2,1
7,384,384,3,3,0,1,0
0,474,474,31,19,12,3,2
3,480,480,9,2,7,2,1
6,484,484,120,9,111,4,3

0,152,152,34,13,21,4,3
4,205,205,1,1,0,1,0
2,208,208,38,38,0,1,0
1,352,352,27,21,6,2,1
3,384,384,44,44,0,1,0

0,115,115,1,1,0,1,0
2,174,174,16,3,13,2,1
4,184,184,4,4,0,1,0
3,288,288,38,38,0,1,0
7,327,327,85,85,0,1,0
1,336,336,16,3,13,2,1
6,454,454,2,2,0,1,0
5,464,464,18,18,0,1,0

3,314,314,62,62,0,1,0
4,323,323,19,19,0,1,0
1,346,346,66,40,26,2,1
0,446,446,49,7,42,2,1
2,479,479,24,24,0,1,0

3,187,187,46,46,0,1,0
1,226,226,31,31,0,1,0
5,234,234,5,2,3,2,1
4,298,298,10,4,6,2,1
0,319,319,21,21,0,1,0
2,394,394,39,24,15,4,3

1,115,115,13,1,12,3,2
0,152,152,1,1,0,1,0
2,235,235,27,27,0,1,0
6,276,276,9,1,8,3,2
4,313,313,66,34,32,2,1
3,332,332,22,22,0,1,0
5,407,407,25,25,0,1,0

2,101,101,7,7,0,1,0
8,172,172,6,6,0,1,0
0,231,231,8,8,0,1,0
5,280,280,26,5,21,4,3
7,303,303,58,58,0,1,0
9,345,345,28,28,0,1,0
4,349,349,8,1,7,2,1
6,365,365,7,4,3,2,1
1,423,423,23,23,0,1,0
3,486,486,4,4,0,1,0

4,104,104,13,10,3,2,1
5,112,112,2,2,0,1,0
2,128,128,1,1,0,1,0
3,203,203,26,26,0,1,0
7,423,423,86,86,0,1,0
6,460,460,41,41,0,1,0
0,466,466,14,14,0,1,0
1,494,494,5,2,3,2,1

5,204,204,13,1,12,3,2
2,208,208,11,8,3,2,1
9,233,233,24,5,19,2,1
8,292,292,32,32,0,1,0
1,323,323,4,4,0,1,0
6,339,339,4,4,0,1,0
0,361,361,31,31,0,1,0
3,413,413,6,6,0,1,0
7,413,413,9,9,0,1,0
4,459,459,18,7,11,2,1
10,474,474,43,13,30,2,1

3,159,159,3,3,0,1,0
8,169,169,39,39,0,1,0
5,244,244,5,2,3,2,1
0,269,269,28,10,18,2,1
7,306,306,18,3,15,3,2
4,336,336,34,25,9,4,3
1,339,339,12,3,9,2,1
2,359,359,8,8,0,1,0
6,491,491,8,8,0,1,0

0,129,129,1,1,0,1,0
7,182,182,13,4,9,2,1
3,251,251,10,4,6,3,2
2,254,254,34,26,8,2,1
5,273,273,9,1,8,3,2
6,331,331,67,35,32,2,1
1,399,399,47,47,0,1,0
4,452,452,1,1,0,1,0

1,267,267,9,9,0,1,0
3,310,310,24,24,0,1,0
2,315,315,13,13,0,1,0
4,316,316,45,45,0,1,0
0,351,351,52,52,0,1,0
6,426,426,68,17,51,4,3
5,447,447,1,1,0,1,0

7,174,174,1,1,0,1,0
2,198,198,12,12,0,1,0
6,241,241,45,24,21,2,1
3,251,251,1,1,0,1,0
4,344,344,5,5,0,1,0
0,346,346,71,47,24,2,1
5,350,350,40,36,4,2,1
1,368,368,6,6,0,1,0

2,219,219,3,3,0,1,0
0,225,225,6,1,5,2,1
3,232,232,16,16,0,1,0
5,280,280,17,17,0,1,0
6,350,350,10,5,5,2,1
4,460,460,99,99,0,1,0
1,464,464,89,2,87,4,3

5,112,112,3,3,0,1,0
4,118,118,3,3,0,1,0
6,151,151,25,25,0,1,0
7,178,178,3,3,0,1,0
1,209,209,7,7,0,1,0
8,221,221,28,28,0,1,0
2,336,336,17,3,14,2,1
3,353,353,8,2,6,2,1
0,388,388,56,56,0,1,0

3,108,108,3,3,0,1,0
8,132,132,8,1,7,2,1
1,178,178,11,11,0,1,0
7,191,191,3,3,0,1,0
10,233,233,24,9,15,2,1
5,263,263,27,14,13,2,1
9,294,294,43,12,31,2,1
4,299,299,1,1,0,1,0
6,316,316,10,10,0,1,0
2,434,434,16,1,15,2,1
0,492,492,12,8,4,2,1

0,228,228,35,35,0,1,0
1,243,243,31,17,14,3,2
4,339,339,28,14,14,2,1
5,412,412,38,13,25,2,1
2,420,420,8,8,0,1,0
3,434,434,56,38,18,2,1

6,100,100,8,8,0,1,0
2,147,147,34,12,22,3,2
0,166,166,3,3,0,1,0
3,276,276,1,1,0,1,0
5,277,277,44,44,0,1,0
4,286,286,9,9,0,1,0
7,286,286,18,18,0,1,0
1,422,422,8,8,0,1,0

3,148,148,1,1,0,1,0
4,164,164,3,3,0,1,0
10,174,174,37,7,30,3,2
7,201,201,2,2,0,1,0
2,209,209,8,8,0,1,0
0,233,233,14,14,0,1,0
1,266,266,40,40,0,1,0
5,285,285,4,4,0,1,0
9,382,382,1,1,0,1,0
6,387,387,2,2,0,1,0
8,404,404,36,2,34,3,2

6,191,191,16,5,11,2,1
4,276,276,43,19,24,3,2
1,310,310,17,14,3,2,1
3,314,314,31,4,27,2,1
5,359,359,25,7,18,4,3
0,402,402,32,15,17,2,1
2,448,448,31,28,3,2,1

1,104,104,2,2,0,1,0
6,114,114,26,5,21,2,1
2,128,128,4,4,0,1,0
3,193,193,14,6,8,2,1
4,222,222,5,5,0,1,0
7,343,343,19,19,0,1,0
0,350,350,38,35,3,2,1
5,385,385,18,6,12,3,2
8,453,453,12,3,9,2,1

1,161,161,26,4,22,2,1
3,164,164,7,7,0,1,0
8,174,174,22,10,12,4,3
7,227,227,30,18,12,3,2
4,267,267,16,1,15,3,2
0,289,289,2,2,0,1,0
5,478,478,3,3,0,1,0
2,484,484,11,11,0,1,0
6,484,484,22,22,0,1,0

2,185,185,1,1,0,1,0
9,211,211,11,2,9,4,3
5,223,223,13,13,0,1,0
7,279,279,9,3,6,2,1
0,322,322,30,4,26,3,2
4,336,336,11,11,0,1,0
8,337,337,74,23,51,3,2
6,357,357,21,2,19,3,2
3,375,375,19,7,12,2,1
1,385,385,1,1,0,1,0

2,195,195,11,3,8,3,2
0,242,242,68,11,57,4,3
3,312,312,3,3,0,1,0
4,466,466,110,105,5,2,1
1,484,484,10,10,0,1,0

2,211,211,15,15,0,1,0
0,411,411,124,124,0,1,0
3,421,421,32,32,0,1,0
1,463,463,72,3,69,3,2

4,167,167,6,6,0,1,0
1,227,227,5,1,4,2,1
7,339,339,6,6,0,1,0
6,354,354,34,1,33,3,2
2,362,362,64,50,14,3,2
3,377,377,3,3,0,1,0
5,395,395,1,1,0,1,0
8,415,415,79,46,33,4,3
0,461,461,26,2,24,4,3

4,174,174,12,12,0,1,0
0,312,312,2,2,0,1,0
5,335,335,24,2,22,3,2
1,410,410,38,14,24,3,2
2,422,422,85,58,27,2,1
3,472,472,79,55,24,2,1

5,177,177,35,27,8,2,1
0,283,283,16,16,0,1,0
2,318,318,24,24,0,1,0
1,320,320,14,4,10,2,1
6,364,364,38,9,29,2,1
3,456,456,57,7,50,3,2
4,487,487,1,1,0,1,0

2,319,319,10,10,0,1,0
3,382,382,1,1,0,1,0
0,397,397,120,120,0,1,0
1,420,420,114,41,73,4,3

3,273,273,15,3,12,4,3
2,284,284,59,13,46,2,1
1,368,368,16,16,0,1,0
0,387,387,117,57,60,4,3

1,159,159,4,4,0,1,0
7,171,171,8,8,0,1,0
0,172,172,4,1,3,2,1
5,187,187,4,4,0,1,0
3,339,339,49,42,7,2,1
8,350,350,41,13,28,2,1
6,356,356,50,13,37,3,2
2,415,415,12,12,0,1,0
4,442,442,27,15,12,4,3

1,134,134,1,1,0,1,0
9,159,159,10,1,9,4,3
0,162,162,11,11,0,1,0
5,176,176,5,5,0,1,0
2,282,282,7,7,0,1,0
8,301,301,44,44,0,1,0
7,389,389,38,38,0,1,0
6,409,409,6,6,0,1,0
3,481,481,17,17,0,1,0
4,494,494,60,60,0,1,0

8,138,138,14,6,8,3,2
0,223,223,13,13,0,1,0
1,325,325,1,1,0,1,0
7,328,328,35,8,27,4,3
5,365,365,3,3,0,1,0
6,405,405,40,18,22,2,1
3,422,422,49,20,29,4,3
4,441,441,30,30,0,1,0
2,496,496,24,24,0,1,0

0,168,168,51,51,0,1,0
2,192,192,33,33,0,1,0
1,205,205,9,5,4,2,1
3,435,435,39,27,12,2,1

2,135,135,3,3,0,1,0
7,247,247,30,25,5,2,1
9,272,272,23,17,6,2,1
8,340,340,33,27,6,2,1
1,357,357,4,4,0,1,0
0,374,374,61,22,39,2,1
3,411,411,1,1,0,1,0
6,422,422,1,1,0,1,0
4,437,437,32,2,30,2,1
5,459,459,12,12,0,1,0

4,178,178,4,4,0,1,0
6,191,191,12,1,11,4,3
3,341,341,56,18,38,2,1
2,395,395,28,28,0,1,0
0,447,447,14,14,0,1,0
1,449,449,16,16,0,1,0
5,492,492,107,55,52,4,3

4,140,140,10,10,0,1,0
2,306,306,1,1,0,1,0
6,422,422,11,11,0,1,0
0,426,426,35,15,20,3,2
7,437,437,41,10,31,3,2
5,478,478,88,81,7,2,1
3,491,491,31,16,15,4,3
1,494,494,41,41,0,1,0

4,322,322,24,24,0,1,0
5,331,331,28,20,8,2,1
0,373,373,16,4,12,3,2
1,384,384,38,6,32,2,1
3,479,479,70,34,36,4,3
2,485,485,77,32,45,3,2

0,111,111,6,6,0,1,0
3,129,129,30,7,23,2,1
1,161,161,40,3,37,2,1
2,208,208,15,15,0,1,0
4,416,416,2,2,0,1,0

3,217,217,6,1,5,2,1
7,309,309,50,4,46,3,2
8,321,321,38,38,0,1,0
0,336,336,2,2,0,1,0
4,351,351,76,76,0,1,0
6,384,384,10,3,7,2,1
1,391,391,5,5,0,1,0
2,398,398,13,13,0,1,0
5,439,439,2,2,0,1,0

2,100,100,2,2,0,1,0
5,132,132,20,20,0,1,0
0,144,144,12,12,0,1,0
4,198,198,7,7,0,1,0
3,295,295,36,6,30,4,3
1,310,310,61,7,54,4,3

1,165,165,7,3,4,2,1
4,359,359,23,13,10,2,1
0,376,376,60,60,0,1,0
3,410,410,62,52,10,3,2
2,411,411,41,41,0,1,0
5,435,435,38,38,0,1,0

6,199,199,27,11,16,3,2
5,331,331,5,5,0,1,0
0,383,383,69,69,0,1,0
1,394,394,20,11,9,3,2
3,434,434,20,3,17,2,1
2,458,458,11,11,0,1,0
4,496,496,77,2,75,4,3

2,102,102,9,9,0,1,0
3,150,150,8,4,4,2,1
1,325,325,55,14,41,2,1
4,349,349,56,56,0,1,0
0,430,430,57,57,0,1,0

4,176,176,20,12,8,2,1
1,188,188,4,4,0,1,0
3,279,279,5,1,4,2,1
0,370,370,37,37,0,1,0
5,385,385,42,27,15,2,1
2,387,387,63,7,56,3,2
6,448,448,37,15,22,2,1

4,104,104,4,4,0,1,0
3,149,149,33,7,26,3,2
2,224,224,12,12,0,1,0
1,255,255,60,60,0,1,0
0,396,396,27,17,10,2,1

4,145,145,5,5,0,1,0
1,252,252,5,1,4,2,1
0,301,301,85,7,78,4,3
3,437,437,30,30,0,1,0
2,442,442,91,43,48,3,2

0,190,190,18,18,0,1,0
5,192,192,19,4,15,4,3
4,220,220,14,4,10,2,1
6,390,390,55,55,0,1,0
1,425,425,17,17,0,1,0
2,453,453,12,12,0,1,0
3,489,489,68,68,0,1,0

0,105,105,7,7,0,1,0
5,131,131,8,8,0,1,0
2,158,158,15,15,0,1,0
6,224,224,18,18,0,1,0
4,230,230,39,39,0,1,0
1,266,266,20,5,15,2,1
3,447,447,29,4,25,3,2

4,192,192,25,25,0,1,0
5,197,197,2,2,0,1,0
9,234,234,33,20,13,2,1
3,265,265,2,2,0,1,0
8,282,282,33,25,8,2,1
7,358,358,17,1,16,2,1
2,366,366,51,23,28,3,2
0,386,386,1,1,0,1,0
6,453,453,4,4,0,1,0
1,492,492,1,1,0,1,0

3,135,135,3,3,0,1,0
6,228,228,39,39,0,1,0
7,325,325,8,8,0,1,0
5,352,352,38,38,0,1,0
2,429,429,14,14,0,1,0
4,436,436,11,3,8,3,2
1,447,447,3,3,0,1,0
0,470,470,101,76,25,2,1

0,250,250,2,2,0,1,0
7,260,260,3,3,0,1,0
3,263,263,21,21,0,1,0
1,291,291,32,32,0,1,0
5,291,291,9,9,0,1,0
2,314,314,11,6,5,2,1
8,337,337,35,26,9,4,3
6,358,358,68,68,0,1,0
4,433,433,16,16,0,1,0

3,218,218,17,9,8,3,2
1,234,234,8,8,0,1,0
4,424,424,86,59,27,3,2
2,451,451,11,11,0,1,0
0,467,467,125,68,57,3,2

2,319,319,51,27,24,2,1
4,378,378,16,16,0,1,0
1,395,395,68,18,50,2,1
3,407,407,41,9,32,4,3
0,445,445,57,57,0,1,0

0,115,115,22,22,0,1,0
1,145,145,3,3,0,1,0
7,201,201,14,14,0,1,0
8,303,303,48,30,18,4,3
5,312,312,3,3,0,1,0
6,337,337,26,14,12,4,3
2,359,359,1,1,0,1,0
4,385,385,2,2,0,1,0
3,402,402,29,9,20,2,1

1,133,133,4,4,0,1,0
0,224,224,16,16,0,1,0
5,283,283,37,37,0,1,0
6,302,302,22,22,0,1,0
4,316,316,32,16,16,2,1
3,386,386,14,14,0,1,0
2,446,446,73,27,46,4,3

1,114,114,12,12,0,1,0
2,122,122,4,1,3,2,1
8,124,124,15,15,0,1,0
5,156,156,5,2,3,2,1
4,200,200,8,8,0,1,0
3,205,205,7,7,0,1,0
7,219,219,4,4,0,1,0
0,226,226,8,2,6,2,1
9,259,259,43,39,4,2,1
6,390,390,8,8,0,1,0

2,203,203,22,4,18,4,3
4,205,205,1,1,0,1,0
0,247,247,22,22,0,1,0
1,348,348,37,28,9,4,3
3,374,374,84,15,69,4,3
5,404,404,29,11,18,2,1

2,166,166,3,3,0,1,0
0,302,302,33,3,30,4,3
5,338,338,19,3,16,3,2
1,361,361,64,22,42,2,1
3,378,378,70,14,56,3,2
4,435,435,27,27,0,1,0

5,135,135,14,14,0,1,0
1,234,234,19,19,0,1,0
0,396,396,24,24,0,1,0
6,408,408,57,57,0,1,0
2,428,428,4,1,3,2,1
4,453,453,27,10,17,2,1
3,461,461,69,24,45,4,3

5,125,125,4,4,0,1,0
4,156,156,5,5,0,1,0
3,224,224,29,18,11,2,1
7,246,246,52,42,10,3,2
6,284,284,18,3,15,2,1
0,286,286,11,2,9,2,1
1,367,367,37,37,0,1,0
2,386,386,2,2,0,1,0

4,122,122,25,25,0,1,0
3,201,201,18,10,8,2,1
0,204,204,41,1,40,2,1
2,229,229,5,5,0,1,0
1,233,233,19,2,17,2,1
5,451,451,5,5,0,1,0

0,111,111,9,1,8,2,1
2,195,195,5,5,0,1,0
1,401,401,79,51,28,2,1
4,407,407,100,40,60,4,3
5,436,436,3,3,0,1,0
3,454,454,24,16,8,3,2

0,128,128,8,2,6,2,1
6,192,192,5,5,0,1,0
3,339,339,25,25,0,1,0
2,458,458,51,51,0,1,0
4,466,466,61,61,0,1,0
1,476,476,26,26,0,1,0
5,495,495,73,73,0,1,0

3,244,244,5,5,0,1,0
6,312,312,32,32,0,1,0
0,321,321,45,13,32,3,2
4,350,350,3,3,0,1,0
5,402,402,77,15,62,3,2
2,411,411,33,25,8,2,1
1,437,437,27,27,0,1,0

1,150,150,15,15,0,1,0
0,187,187,2,2,0,1,0
3,198,198,18,18,0,1,0
2,201,201,8,8,0,1,0
4,329,329,20,20,0,1,0
6,458,458,80,80,0,1,0
5,461,461,6,6,0,1,0
7,491,491,57,57,0,1,0

3,175,175,36,36,0,1,0
4,316,316,12,12,0,1,0
0,350,350,93,93,0,1,0
2,413,413,25,25,0,1,0
1,442,442,16,16,0,1,0

4,101,101,1,1,0,1,0
2,140,140,30,30,0,1,0
1,273,273,58,58,0,1,0
3,301,301,24,12,12,3,2
0,317,317,28,28,0,1,0

1,172,172,12,3,9,2,1
5,201,201,31,31,0,1,0
3,214,214,37,37,0,1,0
2,264,264,13,13,0,1,0
4,331,331,6,6,0,1,0
0,423,423,5,5,0,1,0
6,435,435,56,19,37,2,1

0,133,133,19,19,0,1,0
5,144,144,7,7,0,1,0
4,154,154,17,17,0,1,0
3,173,173,21,21,0,1,0
6,324,324,47,17,30,3,2
2,435,435,15,15,0,1,0
1,465,465,2,2,0,1,0

2,109,109,21,3,18,4,3
0,157,157,4,4,0,1,0
8,174,174,28,28,0,1,0
5,246,246,18,18,0,1,0
4,252,252,1,1,0,1,0
3,283,283,1,1,0,1,0
1,316,316,1,1,0,1,0
6,322,322,46,46,0,1,0
7,489,489,2,2,0,1,0

3,133,133,1,1,0,1,0
2,186,186,9,9,0,1,0
0,366,366,6,6,0,1,0
5,443,443,28,28,0,1,0
4,469,469,109,35,74,3,2
1,481,481,115,110,5,2,1

3,168,168,18,18,0,1,0
5,341,341,13,13,0,1,0
6,343,343,54,54,0,1,0
4,385,385,43,28,15,4,3
1,404,404,33,33,0,1,0
0,459,459,38,38,0,1,0
2,497,497,15,6,9,4,3

3,221,221,13,13,0,1,0
2,229,229,50,33,17,2,1
1,273,273,8,8,0,1,0
0,494,494,149,68,81,4,3

3,117,117,25,25,0,1,0
2,202,202,14,10,4,2,1
5,310,310,1,1,0,1,0
4,317,317,29,29,0,1,0
0,375,375,85,7,78,3,2
1,403,403,3,3,0,1,0

0,106,106,22,12,10,3,2
4,113,113,11,11,0,1,0
2,117,117,7,7,0,1,0
3,239,239,48,6,42,3,2
5,401,401,3,3,0,1,0
1,432,432,16,4,12,3,2

1,152,152,27,17,10,3,2
3,203,203,31,1,30,3,2
2,209,209,9,9,0,1,0
4,215,215,24,4,20,2,1
0,398,398,49,24,25,2,1

1,128,128,20,20,0,1,0
7,176,176,34,10,24,2,1
2,207,207,11,5,6,2,1
6,210,210,21,21,0,1,0
5,252,252,3,3,0,1,0
0,372,372,1,1,0,1,0
3,403,403,25,25,0,1,0
4,428,428,12,3,9,4,3

4,105,105,3,3,0,1,0
3,185,185,39,39,0,1,0
5,274,274,19,19,0,1,0
1,302,302,59,50,9,4,3
0,319,319,9,9,0,1,0
2,349,349,27,13,14,3,2

6,120,120,2,2,0,1,0
3,223,223,38,10,28,4,3
7,349,349,87,87,0,1,0
4,368,368,6,6,0,1,0
2,372,372,4,4,0,1,0
0,412,412,36,36,0,1,0
1,413,413,7,7,0,1,0
5,495,495,20,20,0,1,0

3,125,125,2,2,0,1,0
2,164,164,4,4,0,1,0
0,178,178,37,32,5,2,1
4,201,201,1,1,0,1,0
5,262,262,75,31,44,3,2
1,454,454,32,18,14,3,2

2,109,109,8,8,0,1,0
4,177,177,5,5,0,1,0
1,190,190,25,25,0,1,0
0,305,305,52,52,0,1,0
3,324,324,67,67,0,1,0

4,179,179,5,5,0,1,0
6,210,210,15,15,0,1,0
3,214,214,9,1,8,2,1
1,274,274,50,50,0,1,0
7,348,348,80,44,36,3,2
8,392,392,1,1,0,1,0
5,456,456,1,1,0,1,0
0,467,467,1,1,0,1,0
2,475,475,21,21,0,1,0

0,139,139,7,7,0,1,0
5,188,188,7,7,0,1,0
7,272,272,45,41,4,2,1
3,274,274,15,15,0,1,0
6,304,304,31,2,29,2,1
4,375,375,32,5,27,2,1
2,392,392,27,27,0,1,0
1,393,393,17,8,9,2,1

3,111,111,12,2,10,2,1
0,130,130,16,16,0,1,0
4,221,221,29,13,16,3,2
1,235,235,17,7,10,2,1
5,258,258,17,17,0,1,0
2,353,353,37,37,0,1,0

6,124,124,6,6,0,1,0
5,151,151,32,18,14,2,1
0,255,255,11,6,5,2,1
3,265,265,52,21,31,2,1
2,295,295,11,2,9,3,2
1,380,380,9,9,0,1,0
4,381,381,21,6,15,4,3

2,165,165,8,8,0,1,0
0,218,218,32,10,22,3,2
3,278,278,50,41,9,4,3
1,314,314,49,49,0,1,0
4,359,359,27,27,0,1,0

4,182,182,22,1,21,4,3
5,210,210,27,11,16,2,1
1,228,228,10,10,0,1,0
2,238,238,16,16,0,1,0
0,382,382,73,49,24,4,3
3,475,475,25,25,0,1,0

5,135,135,23,14,9,2,1
2,253,253,21,21,0,1,0
3,293,293,19,1,18,3,2
4,293,293,3,3,0,1,0
1,321,321,13,13,0,1,0
6,350,350,44,44,0,1,0
0,472,472,53,5,48,3,2

1,136,136,13,13,0,1,0
4,204,204,23,5,18,2,1
3,251,251,25,3,22,2,1
0,283,283,58,24,34,3,2
2,284,284,27,27,0,1,0

5,189,189,9,1,8,2,1
4,210,210,30,4,26,4,3
3,263,263,11,1,10,3,2
8,286,286,48,48,0,1,0
7,305,305,40,34,6,2,1
1,342,342,1,1,0,1,0
6,373,373,2,2,0,1,0
0,429,429,9,9,0,1,0
2,484,484,23,19,4,2,1

10,107,107,6,6,0,1,0
1,150,150,2,2,0,1,0
0,159,159,8,3,5,2,1
6,188,188,19,13,6,3,2
9,197,197,15,15,0,1,0
3,251,251,8,8,0,1,0
5,279,279,4,4,0,1,0
7,349,349,28,28,0,1,0
4,388,388,3,3,0,1,0
8,414,414,72,72,0,1,0
2,459,459,1,1,0,1,0

3,117,117,11,8,3,2,1
1,139,139,1,1,0,1,0
5,166,166,18,7,11,2,1
2,205,205,28,28,0,1,0
4,314,314,34,34,0,1,0
0,426,426,68,68,0,1,0

4,166,166,13,2,11,2,1
1,177,177,1,1,0,1,0
2,192,192,55,31,24,4,3
3,404,404,62,62,0,1,0
5,405,405,29,4,25,4,3
0,447,447,4,1,3,2,1

1,127,127,3,3,0,1,0
0,151,151,10,10,0,1,0
6,238,238,32,32,0,1,0
8,271,271,42,31,11,2,1
2,297,297,17,2,15,4,3
7,308,308,6,6,0,1,0
3,360,360,35,19,16,3,2
5,483,483,23,17,6,2,1
4,491,491,4,4,0,1,0

3,140,140,3,3,0,1,0
1,176,176,7,7,0,1,0
5,198,198,18,18,0,1,0
2,203,203,44,44,0,1,0
0,379,379,18,18,0,1,0
4,482,482,95,61,34,3,2

2,103,103,1,1,0,1,0
3,168,168,39,31,8,2,1
0,206,206,55,16,39,2,1
4,245,245,16,16,0,1,0
1,288,288,10,10,0,1,0

7,102,102,4,4,0,1,0
6,152,152,28,4,24,2,1
0,199,199,4,4,0,1,0
5,234,234,20,5,15,4,3
2,263,263,40,4,36,4,3
1,335,335,3,3,0,1,0
3,412,412,36,36,0,1,0
4,488,488,16,4,12,4,3

6,225,225,10,10,0,1,0
3,264,264,36,28,8,2,1
2,320,320,1,1,0,1,0
4,384,384,82,69,13,2,1
1,435,435,3,3,0,1,0
0,445,445,70,70,0,1,0
5,486,486,24,24,0,1,0

0,143,143,10,10,0,1,0
6,220,220,18,18,0,1,0
3,222,222,3,3,0,1,0
4,226,226,38,38,0,1,0
2,276,276,20,20,0,1,0
5,309,309,18,6,12,4,3
1,487,487,72,69,3,2,1

3,141,141,4,4,0,1,0
4,198,198,1,1,0,1,0
5,250,250,1,1,0,1,0
8,296,296,13,13,0,1,0
9,300,300,11,7,4,2,1
1,409,409,1,1,0,1,0
0,411,411,8,8,0,1,0
7,448,448,100,42,58,3,2
2,484,484,21,12,9,4,3
6,490,490,97,48,49,3,2

4,142,142,8,8,0,1,0
2,191,191,13,13,0,1,0
1,209,209,27,13,14,2,1
0,279,279,3,3,0,1,0
6,373,373,76,7,69,4,3
3,394,394,37,9,28,3,2
5,405,405,20,20,0,1,0

3,163,163,34,34,0,1,0
5,175,175,11,11,0,1,0
1,198,198,1,1,0,1,0
4,395,395,14,14,0,1,0
2,463,463,89,83,6,2,1
0,485,485,50,50,0,1,0

5,163,163,10,4,6,3,2
6,188,188,37,3,34,3,2
1,203,203,32,32,0,1,0
3,336,336,4,1,3,2,1
0,409,409,20,15,5,2,1
4,437,437,21,21,0,1,0
2,457,457,38,13,25,4,3

7,105,105,12,2,10,3,2
3,174,174,5,2,3,2,1
6,184,184,29,29,0,1,0
2,202,202,8,8,0,1,0
0,205,205,2,2,0,1,0
4,278,278,16,16,0,1,0
5,333,333,14,14,0,1,0
1,376,376,63,63,0,1,0

2,119,119,20,10,10,3,2
1,136,136,3,3,0,1,0
4,323,323,70,70,0,1,0
3,341,341,26,20,6,2,1
0,365,365,42,18,24,2,1
5,413,413,4,4,0,1,0

2,154,154,2,2,0,1,0
1,162,162,30,30,0,1,0
0,426,426,50,50,0,1,0
4,448,448,80,80,0,1,0
3,457,457,53,53,0,1,0

4,106,106,16,6,10,3,2
1,112,112,27,12,15,4,3
2,172,172,25,25,0,1,0
0,233,233,14,8,6,2,1
3,428,428,5,5,0,1,0

5,131,131,6,6,0,1,0
3,257,257,43,13,30,4,3
1,275,275,24,24,0,1,0
2,413,413,85,46,39,2,1
4,424,424,39,39,0,1,0
0,462,462,4,4,0,1,0

1,137,137,5,5,0,1,0
4,175,175,21,3,18,3,2
0,263,263,23,8,15,4,3
2,269,269,16,11,5,2,1
5,374,374,66,25,41,2,1
6,398,398,4,4,0,1,0
3,478,478,56,56,0,1,0

0,142,142,1,1,0,1,0
2,167,167,46,13,33,4,3
5,239,239,41,41,0,1,0
3,245,245,24,24,0,1,0
4,357,357,12,12,0,1,0
1,390,390,8,8,0,1,0

5,166,166,7,3,4,2,1
0,216,216,1,1,0,1,0
1,259,259,2,2,0,1,0
4,289,289,16,7,9,4,3
7,334,334,9,5,4,2,1
2,340,340,38,22,16,2,1
3,387,387,32,32,0,1,0
6,387,387,85,11,74,3,2
8,396,396,23,8,15,4,3

6,187,187,40,40,0,1,0
5,249,249,1,1,0,1,0
1,262,262,24,16,8,3,2
2,297,297,45,9,36,3,2
3,374,374,6,6,0,1,0
4,377,377,33,1,32,2,1
0,456,456,19,7,12,4,3

6,225,225,36,7,29,2,1
3,245,245,21,15,6,2,1
2,410,410,45,1,44,3,2
4,421,421,31,31,0,1,0
0,441,441,30,1,29,2,1
5,449,449,32,32,0,1,0
1,478,478,18,18,0,1,0

1,218,218,63,63,0,1,0
4,292,292,22,4,18,2,1
2,334,334,16,4,12,2,1
3,341,341,61,7,54,4,3
0,412,412,5,5,0,1,0

0,123,123,1,1,0,1,0
4,138,138,1,1,0,1,0
5,216,216,13,8,5,2,1
6,217,217,1,1,0,1,0
8,226,226,11,11,0,1,0
7,306,306,77,46,31,2,1
1,348,348,5,5,0,1,0
3,464,464,40,40,0,1,0
2,476,476,61,61,0,1,0

8,127,127,3,3,0,1,0
3,204,204,4,4,0,1,0
0,219,219,3,3,0,1,0
4,304,304,9,9,0,1,0
5,338,338,48,48,0,1,0
1,343,343,28,28,0,1,0
2,448,448,7,7,0,1,0
7,491,491,49,1,48,4,3
6,498,498,90,42,48,3,2

5,115,115,2,2,0,1,0
0,240,240,24,12,12,3,2
2,336,336,22,2,20,4,3
4,391,391,68,68,0,1,0
6,404,404,47,28,19,2,1
1,406,406,28,12,16,2,1
3,436,436,29,29,0,1,0

1,214,214,3,3,0,1,0
0,235,235,51,13,38,3,2
5,274,274,14,1,13,2,1
4,311,311,14,14,0,1,0
3,450,450,94,94,0,1,0
2,490,490,34,34,0,1,0

3,179,179,32,17,15,2,1
4,192,192,2,2,0,1,0
1,271,271,54,54,0,1,0
2,442,442,51,51,0,1,0
0,477,477,49,49,0,1,0

0,308,308,51,13,38,3,2
5,334,334,24,24,0,1,0
6,338,338,6,6,0,1,0
3,375,375,42,42,0,1,0
2,429,429,3,3,0,1,0
4,453,453,97,97,0,1,0
1,490,490,8,4,4,2,1

2,117,117,5,5,0,1,0
1,156,156,7,2,5,2,1
5,297,297,8,8,0,1,0
3,300,300,1,1,0,1,0
6,350,350,52,52,0,1,0
0,370,370,78,64,14,2,1
4,450,450,57,57,0,1,0

1,109,109,12,12,0,1,0
6,136,136,14,2,12,2,1
3,150,150,7,7,0,1,0
0,224,224,11,11,0,1,0
5,272,272,10,10,0,1,0
8,293,293,31,31,0,1,0
2,364,364,20,12,8,3,2
4,397,397,1,1,0,1,0
7,428,428,42,42,0,1,0

4,121,121,24,24,0,1,0
1,167,167,33,2,31,2,1
0,226,226,24,24,0,1,0
2,302,302,23,23,0,1,0
3,370,370,11,2,9,3,2

4,107,107,2,2,0,1,0
0,154,154,36,36,0,1,0
1,174,174,12,1,11,2,1
3,364,364,77,77,0,1,0
2,493,493,40,40,0,1,0

0,114,114,18,18,0,1,0
1,155,155,22,22,0,1,0
5,171,171,17,17,0,1,0
4,270,270,47,27,20,2,1
3,310,310,10,1,9,3,2
2,421,421,1,1,0,1,0

2,179,179,21,21,0,1,0
3,196,196,4,4,0,1,0
0,265,265,80,50,30,3,2
1,430,430,71,17,54,3,2

2,130,130,4,1,3,2,1
6,147,147,8,8,0,1,0
4,177,177,42,42,0,1,0
1,201,201,41,2,39,3,2
3,238,238,13,4,9,4,3
0,378,378,5,5,0,1,0
5,394,394,6,6,0,1,0

6,126,126,2,2,0,1,0
7,173,173,11,11,0,1,0
1,175,175,7,3,4,2,1
4,186,186,5,1,4,2,1
8,282,282,66,20,46,2,1
2,298,298,36,36,0,1,0
3,305,305,16,16,0,1,0
0,323,323,14,1,13,2,1
5,371,371,3,3,0,1,0
9,444,444,3,3,0,1,0

1,126,126,1,1,0,1,0
5,149,149,1,1,0,1,0
6,157,157,15,15,0,1,0
0,235,235,39,39,0,1,0
2,250,250,2,2,0,1,0
7,271,271,56,56,0,1,0
4,278,278,2,2,0,1,0
3,458,458,51,7,44,2,1

5,109,109,16,2,14,3,2
3,208,208,26,26,0,1,0
2,253,253,69,69,0,1,0
4,367,367,13,13,0,1,0
0,484,484,11,5,6,3,2
1,491,491,3,3,0,1,0

5,216,216,31,13,18,2,1
4,250,250,25,25,0,1,0
3,338,338,21,21,0,1,0
2,418,418,14,10,4,2,1
0,432,432,58,16,42,3,2
1,479,479,64,33,31,4,3

2,101,101,8,3,5,2,1
0,111,111,15,12,3,2,1
5,163,163,13,13,0,1,0
4,244,244,30,30,0,1,0
1,337,337,11,6,5,2,1
6,403,403,43,2,41,2,1
3,429,429,23,1,22,3,2

0,220,220,1,1,0,1,0
3,359,359,4,4,0,1,0
2,373,373,39,9,30,3,2
1,420,420,125,28,97,3,2
4,452,452,85,28,57,4,3

4,125,125,1,1,0,1,0
5,134,134,4,4,0,1,0
1,157,157,24,8,16,3,2
0,333,333,19,19,0,1,0
3,395,395,106,77,29,2,1
2,469,469,43,15,28,2,1

5,148,148,15,6,9,2,1
4,152,152,1,1,0,1,0
2,238,238,4,1,3,2,1
8,241,241,37,22,15,4,3
1,295,295,18,10,8,2,1
6,296,296,20,20,0,1,0
7,420,420,34,19,15,4,3
3,433,433,22,11,11,4,3
0,489,489,33,7,26,2,1

0,129,129,12,12,0,1,0
8,161,161,6,6,0,1,0
6,236,236,5,5,0,1,0
4,260,260,21,15,6,2,1
3,298,298,12,2,10,2,1
9,349,349,43,43,0,1,0
2,357,357,10,1,9,4,3
7,370,370,53,37,16,2,1
1,436,436,1,1,0,1,0
5,468,468,18,18,0,1,0

3,113,113,2,2,0,1,0
5,179,179,33,33,0,1,0
1,319,319,14,14,0,1,0
4,338,338,37,37,0,1,0
0,342,342,27,27,0,1,0
2,434,434,77,69,8,2,1

0,259,259,19,1,18,2,1
4,309,309,6,1,5,2,1
5,331,331,15,15,0,1,0
3,366,366,10,10,0,1,0
6,374,374,89,89,0,1,0
1,398,398,36,21,15,4,3
2,429,429,47,47,0,1,0

4,151,151,3,3,0,1,0
1,188,188,2,2,0,1,0
7,193,193,31,31,0,1,0
2,374,374,10,10,0,1,0
0,390,390,49,1,48,4,3
6,421,421,22,11,11,2,1
3,450,450,55,37,18,2,1
5,474,474,43,43,0,1,0

2,160,160,26,26,0,1,0
0,184,184,4,4,0,1,0
3,184,184,30,30,0,1,0
5,201,201,2,2,0,1,0
4,306,306,41,11,30,2,1
1,414,414,50,3,47,2,1

3,111,111,3,3,0,1,0
2,337,337,59,15,44,2,1
4,374,374,73,40,33,4,3
5,391,391,23,3,20,3,2
1,394,394,27,27,0,1,0
0,418,418,15,15,0,1,0
6,490,490,24,24,0,1,0

2,286,286,7,7,0,1,0
6,318,318,16,6,10,3,2
7,329,329,72,72,0,1,0
1,359,359,22,22,0,1,0
3,369,369,41,41,0,1,0
0,377,377,30,30,0,1,0
5,408,408,15,15,0,1,0
4,455,455,11,11,0,1,0

4,117,117,9,3,6,2,1
6,134,134,12,2,10,2,1
0,186,186,6,6,0,1,0
5,306,306,57,47,10,2,1
1,418,418,8,4,4,2,1
3,485,485,30,30,0,1,0
7,491,491,14,5,9,4,3
2,500,500,58,46,12,4,3

2,175,175,12,6,6,3,2
5,178,178,2,2,0,1,0
4,236,236,36,36,0,1,0
6,237,237,8,8,0,1,0
0,248,248,13,1,12,2,1
1,291,291,7,4,3,2,1
7,433,433,112,112,0,1,0
3,468,468,2,2,0,1,0

3,297,297,1,1,0,1,0
0,325,325,35,17,18,4,3
2,387,387,105,78,27,4,3
4,452,452,13,2,11,2,1
1,476,476,92,70,22,2,1

3,122,122,3,3,0,1,0
4,204,204,40,40,0,1,0
1,211,211,39,6,33,2,1
5,303,303,26,16,10,3,2
0,340,340,18,6,12,2,1
2,480,480,30,30,0,1,0

5,263,263,18,7,11,2,1
4,273,273,4,4,0,1,0
1,353,353,31,7,24,4,3
3,397,397,88,88,0,1,0
2,444,444,81,5,76,3,2
0,478,478,15,15,0,1,0

2,147,147,22,22,0,1,0
1,251,251,17,6,11,2,1
3,265,265,6,6,0,1,0
0,456,456,106,106,0,1,0
4,494,494,64,20,44,3,2

4,112,112,1,1,0,1,0
6,150,150,7,7,0,1,0
8,157,157,35,11,24,3,2
3,162,162,21,9,12,2,1
2,212,212,3,3,0,1,0
5,222,222,6,6,0,1,0
0,345,345,25,25,0,1,0
1,379,379,19,19,0,1,0
7,401,401,15,15,0,1,0

6,103,103,3,3,0,1,0
7,119,119,16,6,10,3,2
0,158,158,1,1,0,1,0
1,163,163,18,18,0,1,0
4,181,181,7,1,6,3,2
2,216,216,3,3,0,1,0
8,221,221,30,30,0,1,0
3,244,244,3,3,0,1,0
9,268,268,11,11,0,1,0
5,375,375,34,22,12,3,2

3,191,191,5,5,0,1,0
1,225,225,11,4,7,2,1
6,233,233,9,9,0,1,0
4,270,270,4,1,3,2,1
2,290,290,4,4,0,1,0
0,324,324,69,17,52,3,2
5,456,456,115,97,18,3,2

3,130,130,24,10,14,3,2
1,181,181,43,15,28,3,2
4,187,187,20,6,14,2,1
0,406,406,27,6,21,4,3
2,435,435,7,2,5,2,1

6,114,114,18,3,15,2,1
5,181,181,21,21,0,1,0
3,192,192,15,15,0,1,0
8,222,222,9,2,7,2,1
4,397,397,16,16,0,1,0
0,430,430,12,7,5,2,1
2,431,431,1,1,0,1,0
1,459,459,17,5,12,4,3
7,482,482,54,54,0,1,0

0,102,102,4,4,0,1,0
1,253,253,66,33,33,4,3
4,351,351,63,23,40,4,3
3,385,385,12,6,6,3,2
2,453,453,42,42,0,1,0

4,136,136,3,3,0,1,0
0,163,163,20,20,0,1,0
1,183,183,20,20,0,1,0
3,398,398,101,8,93,4,3
2,462,462,32,32,0,1,0
5,474,474,15,3,12,4,3

4,102,102,3,3,0,1,0
2,147,147,11,11,0,1,0
0,168,168,6,2,4,2,1
6,171,171,5,2,3,2,1
5,181,181,46,31,15,3,2
1,331,331,56,56,0,1,0
3,468,468,10,4,6,2,1

0,133,133,1,1,0,1,0
2,201,201,10,3,7,2,1
6,215,215,27,27,0,1,0
1,272,272,3,3,0,1,0
5,301,301,16,6,10,3,2
4,343,343,44,25,19,2,1
3,446,446,104,31,73,4,3

4,162,162,16,3,13,2,1
2,173,173,1,1,0,1,0
0,198,198,1,1,0,1,0
9,209,209,22,1,21,2,1
6,268,268,3,3,0,1,0
1,326,326,12,12,0,1,0
8,369,369,22,6,16,2,1
3,445,445,9,6,3,2,1
7,448,448,63,63,0,1,0
5,474,474,59,49,10,2,1

2,172,172,10,10,0,1,0
5,228,228,41,41,0,1,0
6,280,280,24,6,18,3,2
0,329,329,34,34,0,1,0
3,365,365,12,12,0,1,0
7,401,401,16,16,0,1,0
4,405,405,37,37,0,1,0
1,490,490,8,2,6,3,2

5,156,156,26,22,4,2,1
3,158,158,15,7,8,2,1
1,275,275,14,2,12,2,1
4,334,334,1,1,0,1,0
7,366,366,41,41,0,1,0
0,418,418,32,26,6,2,1
2,428,428,32,12,20,4,3
6,469,469,12,12,0,1,0

3,115,115,22,22,0,1,0
4,155,155,5,5,0,1,0
7,282,282,6,6,0,1,0
5,286,286,73,73,0,1,0
1,405,405,11,2,9,4,3
2,423,423,5,5,0,1,0
0,490,490,21,8,13,2,1
6,492,492,14,14,0,1,0

7,138,138,4,4,0,1,0
2,248,248,36,26,10,2,1
6,346,346,58,58,0,1,0
0,388,388,49,49,0,1,0
4,394,394,7,7,0,1,0
5,412,412,46,19,27,4,3
1,462,462,1,1,0,1,0
3,462,462,5,5,0,1,0

2,153,153,3,3,0,1,0
0,176,176,42,20,22,2,1
6,211,211,2,2,0,1,0
1,216,216,6,6,0,1,0
5,238,238,45,12,33,2,1
4,431,431,46,10,36,3,2
3,477,477,7,7,0,1,0

3,210,210,11,11,0,1,0
4,298,298,45,11,34,3,2
1,361,361,9,4,5,2,1
0,392,392,56,20,36,4,3
6,436,436,48,33,15,4,3
5,481,481,20,8,12,3,2
2,490,490,41,24,17,2,1

0,105,105,1,1,0,1,0
5,161,161,1,1,0,1,0
9,226,226,26,26,0,1,0
4,248,248,6,6,0,1,0
8,254,254,6,6,0,1,0
6,278,278,13,5,8,2,1
7,340,340,56,56,0,1,0
2,417,417,11,5,6,3,2
3,418,418,62,50,12,3,2
1,427,427,18,7,11,2,1

0,130,130,28,1,27,2,1
3,156,156,15,15,0,1,0
1,160,160,6,6,0,1,0
5,271,271,11,11,0,1,0
4,349,349,60,42,18,3,2
2,442,442,21,21,0,1,0

3,102,102,5,5,0,1,0
2,111,111,1,1,0,1,0
5,221,221,21,12,9,4,3
4,262,262,20,5,15,4,3
6,294,294,22,22,0,1,0
1,333,333,46,37,9,2,1
0,361,361,11,11,0,1,0
7,442,442,61,61,0,1,0

1,228,228,47,7,40,2,1
4,303,303,27,27,0,1,0
3,333,333,19,5,14,3,2
2,435,435,68,39,29,2,1
0,490,490,48,33,15,4,3

3,167,167,25,7,18,3,2
1,177,177,14,14,0,1,0
2,191,191,2,2,0,1,0
6,223,223,22,22,0,1,0
0,324,324,15,12,3,2,1
7,346,346,63,63,0,1,0
4,361,361,4,4,0,1,0
8,414,414,10,10,0,1,0
5,475,475,2,2,0,1,0

2,137,137,9,9,0,1,0
4,233,233,55,55,0,1,0
0,302,302,69,9,60,3,2
3,377,377,2,2,0,1,0
1,433,433,31,22,9,4,3

3,117,117,5,5,0,1,0
1,193,193,27,22,5,2,1
5,222,222,3,3,0,1,0
0,229,229,1,1,0,1,0
2,242,242,6,6,0,1,0
4,346,346,6,3,3,2,1
6,398,398,23,23,0,1,0
7,430,430,89,89,0,1,0
9,430,430,15,15,0,1,0
8,459,459,28,28,0,1,0

5,140,140,5,5,0,1,0
1,156,156,17,17,0,1,0
3,183,183,1,1,0,1,0
6,187,187,13,13,0,1,0
7,204,204,10,10,0,1,0
0,242,242,1,1,0,1,0
2,318,318,22,3,19,2,1
8,377,377,71,71,0,1,0
4,443,443,35,35,0,1,0

3,115,115,19,1,18,2,1
1,160,160,2,2,0,1,0
0,247,247,21,2,19,2,1
4,317,317,40,36,4,2,1
2,338,338,15,15,0,1,0
6,395,395,29,19,10,2,1
5,475,475,49,49,0,1,0

2,154,154,1,1,0,1,0
6,204,204,5,5,0,1,0
1,270,270,66,24,42,3,2
0,336,336,16,16,0,1,0
4,407,407,79,79,0,1,0
5,420,420,37,37,0,1,0
3,447,447,1,1,0,1,0

2,138,138,7,7,0,1,0
4,160,160,5,5,0,1,0
8,181,181,30,30,0,1,0
1,311,311,11,11,0,1,0
6,315,315,24,24,0,1,0
5,396,396,9,3,6,2,1
0,406,406,29,4,25,4,3
3,445,445,40,13,27,2,1
7,496,496,30,10,20,3,2

1,257,257,34,34,0,1,0
5,286,286,35,3,32,2,1
2,331,331,40,40,0,1,0
0,351,351,17,17,0,1,0
3,365,365,21,3,18,3,2
4,484,484,61,61,0,1,0

2,143,143,28,28,0,1,0
3,332,332,8,8,0,1,0
1,403,403,34,20,14,3,2
0,479,479,144,122,22,2,1

2,150,150,7,7,0,1,0
1,213,213,9,9,0,1,0
10,253,253,20,11,9,4,3
0,265,265,11,8,3,2,1
5,313,313,15,15,0,1,0
6,344,344,9,9,0,1,0
7,358,358,29,8,21,4,3
3,361,361,1,1,0,1,0
9,434,434,39,39,0,1,0
4,441,441,6,6,0,1,0
8,444,444,61,5,56,3,2

5,127,127,14,2,12,3,2
7,166,166,32,32,0,1,0
1,287,287,23,23,0,1,0
3,306,306,11,8,3,2,1
8,416,416,24,16,8,3,2
6,438,438,26,26,0,1,0
0,452,452,17,17,0,1,0
4,471,471,3,3,0,1,0
2,478,478,17,9,8,3,2

1,315,315,31,19,12,2,1
2,320,320,13,3,10,3,2
3,343,343,38,38,0,1,0
0,346,346,70,6,64,3,2
4,475,475,72,24,48,3,2

3,177,177,8,8,0,1,0
2,225,225,14,14,0,1,0
0,282,282,31,14,17,2,1
5,301,301,49,19,30,4,3
1,394,394,51,37,14,2,1
4,442,442,42,42,0,1,0

7,178,178,1,1,0,1,0
11,183,183,7,7,0,1,0
6,220,220,15,2,13,2,1
10,284,284,66,56,10,2,1
9,307,307,6,2,4,2,1
12,318,318,10,1,9,2,1
0,329,329,9,9,0,1,0
1,329,329,4,4,0,1,0
3,347,347,13,13,0,1,0
4,382,382,11,8,3,2,1
8,421,421,11,1,10,3,2
5,456,456,26,1,25,4,3
2,486,486,9,1,8,3,2

1,149,149,24,1,23,2,1
0,193,193,5,2,3,2,1
5,301,301,22,16,6,3,2
3,352,352,4,4,0,1,0
2,413,413,42,42,0,1,0
6,461,461,5,5,0,1,0
4,498,498,110,110,0,1,0

8,112,112,7,4,3,2,1
2,130,130,8,8,0,1,0
5,160,160,3,3,0,1,0
6,180,180,22,16,6,3,2
3,214,214,20,10,10,3,2
1,224,224,3,3,0,1,0
7,357,357,42,42,0,1,0
4,385,385,24,24,0,1,0
0,498,498,28,28,0,1,0

1,116,116,34,17,17,2,1
0,214,214,3,3,0,1,0
2,323,323,31,31,0,1,0
4,419,419,55,33,22,2,1
3,433,433,34,34,0,1,0

2,120,120,9,9,0,1,0
3,150,150,1,1,0,1,0
0,250,250,12,6,6,3,2
1,254,254,47,2,45,4,3
5,273,273,71,23,48,4,3
4,337,337,13,13,0,1,0

6,120,120,12,12,0,1,0
1,136,136,2,2,0,1,0
3,247,247,19,9,10,3,2
2,327,327,34,34,0,1,0
7,343,343,49,49,0,1,0
5,361,361,24,24,0,1,0
0,445,445,21,15,6,2,1
4,449,449,26,2,24,4,3

1,134,134,4,4,0,1,0
8,175,175,45,25,20,3,2
0,202,202,25,19,6,3,2
4,221,221,1,1,0,1,0
6,318,318,6,6,0,1,0
5,319,319,11,5,6,2,1
2,339,339,11,11,0,1,0
7,448,448,13,1,12,2,1
3,497,497,38,24,14,3,2

5,104,104,4,1,3,2,1
3,105,105,3,3,0,1,0
6,133,133,7,1,6,3,2
0,199,199,1,1,0,1,0
7,246,246,53,53,0,1,0
1,326,326,25,25,0,1,0
4,468,468,4,4,0,1,0
2,491,491,90,90,0,1,0

2,123,123,20,20,0,1,0
3,150,150,3,3,0,1,0
1,164,164,2,2,0,1,0
5,205,205,27,27,0,1,0
0,372,372,48,37,11,2,1
4,497,497,78,78,0,1,0

6,124,124,16,8,8,2,1
3,364,364,79,79,0,1,0
4,376,376,65,29,36,3,2
1,402,402,3,3,0,1,0
2,458,458,33,33,0,1,0
0,467,467,2,2,0,1,0
5,495,495,4,4,0,1,0

0,145,145,1,1,0,1,0
4,264,264,32,13,19,2,1
2,408,408,92,41,51,4,3
3,430,430,27,21,6,2,1
1,468,468,32,12,20,2,1
5,469,469,57,57,0,1,0

2,271,271,1,1,0,1,0
0,277,277,1,1,0,1,0
7,385,385,101,37,64,4,3
5,392,392,4,4,0,1,0
6,397,397,12,4,8,3,2
1,430,430,49,49,0,1,0
3,454,454,56,56,0,1,0
4,496,496,28,12,16,3,2

2,111,111,3,3,0,1,0
0,113,113,9,9,0,1,0
5,118,118,5,2,3,2,1
7,233,233,54,54,0,1,0
3,240,240,2,2,0,1,0
4,288,288,37,37,0,1,0
6,310,310,11,8,3,2,1
1,366,366,21,21,0,1,0

9,111,111,6,6,0,1,0
7,148,148,29,19,10,3,2
2,221,221,5,5,0,1,0
8,230,230,14,14,0,1,0
6,238,238,33,33,0,1,0
1,340,340,21,21,0,1,0
4,375,375,1,1,0,1,0
5,411,411,3,3,0,1,0
3,421,421,13,13,0,1,0
0,490,490,19,3,16,4,3

5,101,101,17,2,15,4,3
1,242,242,32,32,0,1,0
6,268,268,14,2,12,2,1
3,295,295,38,30,8,2,1
0,327,327,4,1,3,2,1
2,445,445,13,13,0,1,0
4,445,445,39,13,26,3,2

5,158,158,6,6,0,1,0
1,229,229,2,2,0,1,0
3,265,265,69,69,0,1,0
2,296,296,4,4,0,1,0
0,331,331,92,42,50,3,2
4,349,349,3,3,0,1,0

0,149,149,39,39,0,1,0
3,175,175,24,24,0,1,0
1,322,322,13,3,10,3,2
2,434,434,10,2,8,2,1
4,461,461,68,14,54,4,3

2,112,112,2,2,0,1,0
3,169,169,34,3,31,3,2
5,208,208,1,1,0,1,0
4,240,240,1,1,0,1,0
0,361,361,8,8,0,1,0
1,365,365,23,23,0,1,0
6,378,378,111,107,4,2,1

1,246,246,2,2,0,1,0
2,276,276,59,59,0,1,0
0,340,340,103,16,87,4,3
3,447,447,37,37,0,1,0

4,144,144,11,11,0,1,0
5,193,193,6,6,0,1,0
6,193,193,39,33,6,2,1
2,258,258,26,14,12,3,2
3,380,380,9,6,3,2,1
1,416,416,61,37,24,3,2
0,453,453,14,7,7,2,1

0,163,163,2,2,0,1,0
1,246,246,66,20,46,3,2
3,376,376,29,23,6,2,1
4,389,389,22,22,0,1,0
2,438,438,9,9,0,1,0
5,475,475,81,29,52,3,2

3,120,120,8,8,0,1,0
5,134,134,6,2,4,2,1
0,175,175,1,1,0,1,0
6,254,254,4,4,0,1,0
7,345,345,10,10,0,1,0
2,364,364,4,4,0,1,0
4,366,366,28,16,12,2,1
1,420,420,41,2,39,2,1
8,494,494,128,128,0,1,0

1,100,100,21,9,12,4,3
4,149,149,3,3,0,1,0
0,300,300,29,29,0,1,0
3,318,318,61,1,60,4,3
2,396,396,37,7,30,4,3

0,121,121,16,16,0,1,0
3,209,209,20,20,0,1,0
2,210,210,10,1,9,2,1
4,351,351,57,18,39,4,3
1,469,469,79,32,47,3,2

5,100,100,1,1,0,1,0
0,185,185,2,2,0,1,0
6,202,202,17,17,0,1,0
8,285,285,16,16,0,1,0
9,314,314,8,8,0,1,0
3,336,336,22,14,8,3,2
4,366,366,38,26,12,4,3
2,386,386,2,2,0,1,0
7,403,403,5,5,0,1,0
10,457,457,102,102,0,1,0
1,489,489,5,5,0,1,0

4,135,135,16,7,9,4,3
6,149,149,20,20,0,1,0
7,164,164,10,10,0,1,0
1,213,213,12,4,8,2,1
5,302,302,34,4,30,4,3
3,322,322,27,6,21,4,3
0,353,353,13,13,0,1,0
2,373,373,3,3,0,1,0

4,186,186,25,7,18,3,2
2,215,215,22,6,16,3,2
5,314,314,14,2,12,2,1
3,334,334,42,1,41,2,1
1,482,482,35,8,27,4,3
0,489,489,62,62,0,1,0

0,293,293,6,6,0,1,0
3,322,322,15,15,0,1,0
1,464,464,34,34,0,1,0
4,473,473,52,47,5,2,1
2,484,484,25,25,0,1,0
7,486,486,49,33,16,3,2
5,487,487,21,7,14,3,2
6,487,487,78,63,15,4,3

1,136,136,16,8,8,3,2
3,206,206,4,4,0,1,0
0,223,223,17,14,3,2,1
4,389,389,106,57,49,2,1
2,399,399,43,5,38,4,3
5,437,437,6,1,5,2,1

2,193,193,13,6,7,2,1
4,237,237,15,15,0,1,0
3,257,257,16,16,0,1,0
1,293,293,36,36,0,1,0
0,428,428,21,21,0,1,0
5,435,435,68,53,15,4,3
6,484,484,40,12,28,3,2

0,140,140,11,2,9,4,3
4,276,276,9,9,0,1,0
1,305,305,68,68,0,1,0
3,459,459,4,4,0,1,0
2,476,476,125,7,118,4,3

2,102,102,13,13,0,1,0
0,209,209,35,35,0,1,0
3,265,265,4,4,0,1,0
4,426,426,109,67,42,2,1
5,452,452,16,16,0,1,0
1,477,477,3,3,0,1,0

2,108,108,9,9,0,1,0
0,126,126,1,1,0,1,0
4,158,158,12,5,7,2,1
1,342,342,72,9,63,4,3
3,387,387,55,15,40,2,1
5,390,390,35,35,0,1,0

1,105,105,6,6,0,1,0
0,114,114,23,23,0,1,0
4,321,321,48,48,0,1,0
3,398,398,4,4,0,1,0
2,442,442,19,10,9,2,1
5,470,470,68,68,0,1,0

5,183,183,20,20,0,1,0
3,202,202,12,3,9,2,1
2,215,215,8,8,0,1,0
1,219,219,9,9,0,1,0
6,283,283,31,9,22,4,3
0,290,290,7,7,0,1,0
8,343,343,9,9,0,1,0
4,446,446,14,8,6,3,2
7,482,482,81,24,57,4,3

3,115,115,2,2,0,1,0
6,152,152,3,3,0,1,0
4,171,171,46,33,13,2,1
5,202,202,3,3,0,1,0
1,252,252,42,42,0,1,0
0,494,494,31,17,14,4,3
2,497,497,29,1,28,3,2

0,104,104,1,1,0,1,0
5,146,146,9,9,0,1,0
1,225,225,1,1,0,1,0
3,290,290,18,18,0,1,0
6,296,296,50,50,0,1,0
2,418,418,95,95,0,1,0
4,424,424,31,31,0,1,0

2,139,139,5,5,0,1,0
0,237,237,26,26,0,1,0
4,319,319,17,7,10,3,2
7,325,325,14,14,0,1,0
3,368,368,17,17,0,1,0
5,380,380,61,46,15,2,1
1,402,402,23,23,0,1,0
6,412,412,41,41,0,1,0

7,125,125,17,17,0,1,0
4,269,269,21,12,9,2,1
6,275,275,29,17,12,3,2
8,297,297,20,20,0,1,0
0,324,324,10,10,0,1,0
5,429,429,20,20,0,1,0
1,450,450,19,9,10,2,1
2,475,475,38,5,33,2,1
3,489,489,11,2,9,2,1

2,176,176,2,2,0,1,0
5,204,204,7,7,0,1,0
4,208,208,2,2,0,1,0
1,223,223,32,32,0,1,0
3,245,245,5,5,0,1,0
6,258,258,24,5,19,2,1
8,267,267,46,46,0,1,0
7,317,317,12,4,8,2,1
0,440,440,37,37,0,1,0

9,145,145,3,3,0,1,0
2,204,204,1,1,0,1,0
8,252,252,69,69,0,1,0
5,331,331,11,2,9,4,3
1,337,337,17,17,0,1,0
3,349,349,26,2,24,3,2
0,420,420,51,41,10,3,2
4,438,438,1,1,0,1,0
7,445,445,7,4,3,2,1
6,487,487,7,7,0,1,0

0,185,185,3,3,0,1,0
5,188,188,10,10,0,1,0
3,219,219,13,2,11,2,1
6,374,374,70,70,0,1,0
4,391,391,12,12,0,1,0
2,406,406,4,4,0,1,0
1,411,411,76,24,52,4,3
7,487,487,31,11,20,4,3

1,119,119,1,1,0,1,0
0,139,139,2,2,0,1,0
4,329,329,21,8,13,2,1
6,334,334,14,14,0,1,0
5,336,336,67,36,31,3,2
2,448,448,6,1,5,2,1
3,489,489,130,130,0,1,0

2,145,145,3,3,0,1,0
10,154,154,4,4,0,1,0
0,171,171,2,2,0,1,0
8,172,172,43,43,0,1,0
5,173,173,4,4,0,1,0
7,189,189,11,11,0,1,0
4,220,220,7,7,0,1,0
1,313,313,24,24,0,1,0
9,370,370,11,3,8,3,2
3,371,371,1,1,0,1,0
6,412,412,32,32,0,1,0

2,214,214,9,9,0,1,0
6,263,263,24,24,0,1,0
3,264,264,20,20,0,1,0
5,396,396,20,20,0,1,0
0,409,409,39,39,0,1,0
4,454,454,73,4,69,4,3
1,482,482,43,21,22,2,1

4,136,136,20,15,5,2,1
1,246,246,25,13,12,4,3
3,315,315,10,10,0,1,0
0,323,323,1,1,0,1,0
6,370,370,12,2,10,2,1
2,430,430,71,32,39,2,1
5,495,495,62,13,49,2,1

6,149,149,18,4,14,2,1
7,151,151,6,6,0,1,0
4,226,226,4,4,0,1,0
3,244,244,21,21,0,1,0
0,354,354,36,4,32,2,1
2,376,376,35,23,12,3,2
1,407,407,2,2,0,1,0
5,436,436,64,52,12,4,3

7,176,176,6,6,0,1,0
6,187,187,32,32,0,1,0
4,189,189,14,14,0,1,0
1,289,289,7,7,0,1,0
3,318,318,14,14,0,1,0
5,372,372,37,37,0,1,0
2,378,378,1,1,0,1,0
0,406,406,63,63,0,1,0

1,176,176,11,11,0,1,0
3,194,194,1,1,0,1,0
0,277,277,25,13,12,3,2
4,368,368,54,54,0,1,0
2,461,461,68,68,0,1,0
5,483,483,72,72,0,1,0

9,101,101,5,2,3,2,1
2,140,140,2,2,0,1,0
6,143,143,3,3,0,1,0
3,161,161,6,6,0,1,0
8,201,201,20,20,0,1,0
5,259,259,20,17,3,2,1
7,382,382,5,5,0,1,0
4,393,393,20,20,0,1,0
1,426,426,3,3,0,1,0
0,440,440,35,20,15,2,1
10,455,455,72,72,0,1,0

6,337,337,35,31,4,2,1
1,364,364,11,11,0,1,0
3,377,377,11,11,0,1,0
2,421,421,52,19,33,2,1
0,426,426,26,18,8,2,1
4,445,445,25,25,0,1,0
5,470,470,87,87,0,1,0
7,496,496,8,3,5,2,1

1,112,112,7,3,4,2,1
7,124,124,28,28,0,1,0
5,227,227,6,6,0,1,0
4,236,236,15,10,5,2,1
3,352,352,3,3,0,1,0
0,462,462,54,30,24,2,1
6,480,480,26,8,18,2,1
2,498,498,26,26,0,1,0

3,117,117,9,9,0,1,0
0,143,143,22,10,12,2,1
4,145,145,19,19,0,1,0
2,435,435,7,7,0,1,0
1,459,459,60,2,58,3,2
5,467,467,47,15,32,2,1

4,114,114,6,3,3,2,1
0,168,168,26,26,0,1,0
3,258,258,32,11,21,4,3
1,262,262,39,2,37,2,1
2,398,398,51,29,22,2,1

4,168,168,14,14,0,1,0
1,263,263,12,12,0,1,0
2,309,309,56,6,50,4,3
3,455,455,19,19,0,1,0
0,461,461,118,42,76,3,2

3,113,113,2,2,0,1,0
2,424,424,122,71,51,4,3
1,432,432,1,1,0,1,0
0,485,485,146,82,64,3,2

5,272,272,69,57,12,3,2
2,290,290,21,9,12,2,1
4,354,354,13,9,4,2,1
0,362,362,76,36,40,4,3
3,372,372,5,5,0,1,0
1,456,456,9,1,8,3,2

9,101,101,16,16,0,1,0
6,168,168,1,1,0,1,0
8,197,197,16,16,0,1,0
5,243,243,1,1,0,1,0
7,275,275,21,14,7,2,1
2,292,292,39,22,17,2,1
1,306,306,17,4,13,2,1
0,337,337,15,12,3,2,1
3,363,363,16,4,12,4,3
4,374,374,6,6,0,1,0

6,128,128,21,12,9,4,3
4,129,129,4,4,0,1,0
7,145,145,8,8,0,1,0
1,151,151,2,2,0,1,0
5,209,209,19,19,0,1,0
0,240,240,26,26,0,1,0
2,356,356,6,2,4,2,1
3,493,493,65,26,39,2,1

5,102,102,16,7,9,4,3
6,141,141,1,1,0,1,0
4,153,153,22,22,0,1,0
1,232,232,15,15,0,1,0
2,271,271,2,2,0,1,0
0,351,351,5,5,0,1,0
3,463,463,35,2,33,4,3
7,497,497,71,64,7,2,1

3,146,146,22,22,0,1,0
4,183,183,19,19,0,1,0
0,193,193,7,1,6,3,2
1,211,211,5,5,0,1,0
5,347,347,41,37,4,2,1
6,383,383,32,25,7,2,1
2,487,487,44,6,38,3,2

2,110,110,7,7,0,1,0
9,224,224,19,19,0,1,0
5,276,276,6,1,5,2,1
10,321,321,31,31,0,1,0
6,324,324,3,3,0,1,0
1,345,345,11,2,9,2,1
0,393,393,11,1,10,3,2
7,394,394,7,4,3,2,1
3,417,417,12,12,0,1,0
8,442,442,54,45,9,4,3
4,475,475,48,48,0,1,0

0,189,189,29,11,18,2,1
1,229,229,25,9,16,2,1
4,232,232,52,52,0,1,0
3,294,294,3,3,0,1,0
6,337,337,27,27,0,1,0
2,344,344,10,10,0,1,0
5,418,418,1,1,0,1,0

0,156,156,45,45,0,1,0
1,204,204,3,3,0,1,0
3,427,427,84,84,0,1,0
2,429,429,19,8,11,2,1
4,459,459,28,12,16,3,2

3,120,120,9,1,8,3,2
1,150,150,9,2,7,3,2
2,173,173,20,17,3,2,1
4,260,260,30,30,0,1,0
0,341,341,84,54,30,2,1

3,165,165,22,22,0,1,0
2,310,310,44,17,27,4,3
0,437,437,132,89,43,2,1
1,484,484,14,2,12,3,2

2,211,211,20,20,0,1,0
4,259,259,3,3,0,1,0
1,309,309,1,1,0,1,0
6,330,330,91,47,44,2,1
0,373,373,24,24,0,1,0
3,432,432,60,60,0,1,0
5,459,459,8,8,0,1,0

2,168,168,6,1,5,2,1
6,170,170,18,18,0,1,0
3,243,243,21,21,0,1,0
5,283,283,28,10,18,4,3
0,326,326,39,18,21,4,3
1,375,375,22,14,8,3,2
4,378,378,39,39,0,1,0

3,167,167,2,2,0,1,0
4,173,173,49,4,45,4,3
1,186,186,37,37,0,1,0
6,188,188,4,4,0,1,0
0,247,247,12,6,6,2,1
5,335,335,1,1,0,1,0
2,443,443,18,18,0,1,0

2,140,140,2,2,0,1,0
8,148,148,17,17,0,1,0
1,192,192,1,1,0,1,0
4,208,208,3,3,0,1,0
10,245,245,7,3,4,2,1
3,302,302,47,15,32,3,2
6,348,348,4,4,0,1,0
9,366,366,61,61,0,1,0
5,380,380,14,14,0,1,0
7,394,394,4,4,0,1,0
0,466,466,25,7,18,3,2

5,100,100,4,4,0,1,0
1,300,300,11,11,0,1,0
0,311,311,2,2,0,1,0
2,324,324,14,14,0,1,0
3,337,337,73,8,65,4,3
6,428,428,14,3,11,2,1
4,454,454,105,105,0,1,0

7,102,102,2,2,0,1,0
8,114,114,27,3,24,4,3
3,127,127,5,2,3,2,1
1,233,233,20,9,11,2,1
0,266,266,14,4,10,3,2
5,322,322,1,1,0,1,0
6,344,344,18,18,0,1,0
2,457,457,15,8,7,2,1
9,470,470,27,27,0,1,0
4,471,471,16,3,13,3,2

1,163,163,4,1,3,2,1
4,163,163,7,7,0,1,0
3,193,193,1,1,0,1,0
2,232,232,1,1,0,1,0
5,242,242,29,29,0,1,0
7,286,286,75,29,46,3,2
9,341,341,6,6,0,1,0
6,378,378,33,3,30,3,2
8,446,446,10,7,3,2,1
0,456,456,8,8,0,1,0

3,311,311,50,24,26,2,1
1,347,347,18,3,15,4,3
2,466,466,15,15,0,1,0
0,468,468,117,48,69,4,3
4,493,493,54,54,0,1,0

3,117,117,3,3,0,1,0
0,236,236,6,3,3,2,1
2,247,247,16,16,0,1,0
9,251,251,10,10,0,1,0
10,276,276,50,50,0,1,0
5,283,283,6,6,0,1,0
1,313,313,2,2,0,1,0
7,386,386,25,13,12,4,3
4,428,428,11,11,0,1,0
6,442,442,30,8,22,2,1
8,488,488,41,41,0,1,0

2,133,133,3,3,0,1,0
0,152,152,3,3,0,1,0
4,277,277,74,32,42,3,2
3,301,301,5,5,0,1,0
1,403,403,113,96,17,2,1

6,185,185,30,6,24,3,2
1,233,233,7,7,0,1,0
4,263,263,15,3,12,4,3
0,293,293,13,7,6,2,1
2,414,414,66,66,0,1,0
5,453,453,38,2,36,2,1
3,460,460,31,7,24,3,2

3,211,211,32,32,0,1,0
5,297,297,34,29,5,2,1
0,311,311,27,27,0,1,0
2,337,337,11,11,0,1,0
1,346,346,10,10,0,1,0
6,364,364,4,4,0,1,0
4,449,449,80,80,0,1,0

4,108,108,7,4,3,2,1
0,197,197,3,3,0,1,0
2,271,271,33,22,11,2,1
3,326,326,40,15,25,4,3
1,475,475,136,136,0,1,0

4,134,134,7,7,0,1,0
3,193,193,3,3,0,1,0
5,225,225,48,48,0,1,0
1,273,273,2,2,0,1,0
2,392,392,43,43,0,1,0
7,407,407,34,6,28,3,2
6,431,431,4,1,3,2,1
0,435,435,51,51,0,1,0

5,102,102,11,11,0,1,0
1,133,133,10,2,8,2,1
3,204,204,6,6,0,1,0
6,206,206,35,35,0,1,0
2,218,218,7,1,6,3,2
0,241,241,1,1,0,1,0
4,434,434,26,14,12,2,1
7,443,443,21,6,15,2,1
8,462,462,40,40,0,1,0

0,140,140,32,32,0,1,0
5,236,236,45,5,40,3,2
2,365,365,24,24,0,1,0
4,374,374,14,6,8,2,1
3,432,432,32,32,0,1,0
1,478,478,4,4,0,1,0

2,123,123,29,29,0,1,0
1,234,234,9,5,4,2,1
0,299,299,9,3,6,2,1
5,361,361,61,61,0,1,0
3,399,399,43,27,16,2,1
4,436,436,13,13,0,1,0

6,118,118,1,1,0,1,0
2,145,145,1,1,0,1,0
1,265,265,10,4,6,2,1
4,280,280,4,4,0,1,0
8,308,308,7,7,0,1,0
7,343,343,21,2,19,2,1
5,347,347,6,6,0,1,0
10,442,442,13,13,0,1,0
11,449,449,1,1,0,1,0
0,478,478,59,21,38,3,2
9,488,488,133,133,0,1,0
3,500,500,4,4,0,1,0

1,129,129,3,3,0,1,0
4,185,185,3,3,0,1,0
2,206,206,42,4,38,2,1
0,302,302,85,37,48,2,1
3,359,359,30,30,0,1,0

2,235,235,12,7,5,2,1
3,260,260,35,35,0,1,0
0,376,376,12,12,0,1,0
6,387,387,16,16,0,1,0
4,445,445,7,1,6,3,2
5,447,447,110,26,84,3,2
1,481,481,41,35,6,2,1

0,182,182,19,10,9,4,3
1,229,229,25,9,16,3,2
5,279,279,38,26,12,2,1
2,385,385,34,2,32,2,1
3,417,417,65,21,44,2,1
4,476,476,6,6,0,1,0

6,121,121,23,23,0,1,0
4,211,211,14,8,6,3,2
8,225,225,1,1,0,1,0
1,235,235,17,17,0,1,0
5,237,237,13,13,0,1,0
2,376,376,1,1,0,1,0
7,399,399,46,15,31,2,1
3,498,498,27,9,18,3,2
0,500,500,25,25,0,1,0

3,111,111,17,2,15,4,3
4,112,112,5,5,0,1,0
1,113,113,7,1,6,2,1
2,318,318,46,46,0,1,0
5,403,403,47,7,40,2,1
0,478,478,45,7,38,2,1

4,122,122,18,12,6,3,2
3,179,179,18,18,0,1,0
1,189,189,3,3,0,1,0
5,189,189,11,11,0,1,0
2,278,278,71,46,25,4,3
0,483,483,14,2,12,3,2

5,108,108,1,1,0,1,0
6,113,113,16,11,5,2,1
7,183,183,30,12,18,3,2
4,279,279,15,6,9,3,2
0,406,406,26,12,14,3,2
1,417,417,15,6,9,2,1
3,422,422,3,3,0,1,0
2,429,429,61,61,0,1,0

5,146,146,1,1,0,1,0
2,332,332,16,16,0,1,0
3,337,337,60,51,9,4,3
0,358,358,77,77,0,1,0
1,439,439,17,3,14,2,1
4,483,483,59,59,0,1,0

3,105,105,3,3,0,1,0
0,128,128,8,8,0,1,0
4,157,157,16,16,0,1,0
8,170,170,46,25,21,2,1
6,259,259,18,18,0,1,0
1,271,271,6,2,4,2,1
7,377,377,2,2,0,1,0
2,382,382,6,2,4,2,1
5,475,475,1,1,0,1,0
9,491,491,15,15,0,1,0

1,144,144,12,2,10,2,1
0,185,185,56,42,14,3,2
2,193,193,33,25,8,3,2
3,257,257,14,14,0,1,0

5,130,130,31,31,0,1,0
3,175,175,25,25,0,1,0
6,179,179,10,10,0,1,0
1,241,241,26,26,0,1,0
0,255,255,9,9,0,1,0
4,291,291,4,4,0,1,0
2,357,357,7,3,4,2,1

3,179,179,19,15,4,2,1
1,204,204,2,2,0,1,0
7,274,274,16,16,0,1,0
5,299,299,1,1,0,1,0
4,403,403,39,39,0,1,0
6,420,420,102,102,0,1,0
2,449,449,28,28,0,1,0
0,450,450,12,12,0,1,0

7,110,110,5,2,3,2,1
6,173,173,3,3,0,1,0
2,200,200,1,1,0,1,0
5,215,215,54,54,0,1,0
3,302,302,1,1,0,1,0
0,320,320,12,12,0,1,0
4,356,356,77,14,63,3,2
1,415,415,16,2,14,3,2

2,188,188,10,10,0,1,0
0,208,208,40,5,35,2,1
3,235,235,18,2,16,3,2
4,354,354,21,7,14,3,2
1,364,364,20,20,0,1,0
5,457,457,77,39,38,3,2

5,139,139,29,3,26,2,1
0,175,175,7,7,0,1,0
7,175,175,11,1,10,3,2
6,258,258,10,4,6,2,1
2,273,273,1,1,0,1,0
1,279,279,55,43,12,4,3
4,315,315,10,10,0,1,0
3,381,381,11,11,0,1,0

0,124,124,3,3,0,1,0
7,148,148,14,5,9,4,3
6,223,223,25,21,4,2,1
1,248,248,31,31,0,1,0
4,248,248,9,9,0,1,0
2,292,292,2,2,0,1,0
3,343,343,38,38,0,1,0
5,479,479,50,50,0,1,0

5,146,146,12,12,0,1,0
4,166,166,13,8,5,2,1
3,206,206,33,3,30,3,2
6,244,244,36,36,0,1,0
0,303,303,10,10,0,1,0
1,386,386,18,18,0,1,0
2,498,498,32,32,0,1,0

7,119,119,5,5,0,1,0
6,175,175,41,28,13,2,1
1,251,251,13,13,0,1,0
5,417,417,13,13,0,1,0
4,421,421,33,7,26,2,1
0,437,437,29,17,12,3,2
3,452,452,30,30,0,1,0
2,457,457,17,17,0,1,0

2,115,115,2,2,0,1,0
1,220,220,41,41,0,1,0
5,241,241,8,4,4,2,1
0,338,338,35,35,0,1,0
3,371,371,33,3,30,3,2
4,405,405,75,31,44,3,2

1,164,164,20,12,8,2,1
4,233,233,42,42,0,1,0
3,293,293,1,1,0,1,0
0,322,322,17,5,12,4,3
5,344,344,43,4,39,3,2
2,446,446,56,56,0,1,0

1,180,180,10,10,0,1,0
7,192,192,1,1,0,1,0
6,293,293,5,5,0,1,0
8,300,300,55,55,0,1,0
5,307,307,30,22,8,2,1
4,341,341,19,19,0,1,0
10,372,372,19,19,0,1,0
3,399,399,18,18,0,1,0
9,461,461,32,15,17,2,1
0,487,487,7,7,0,1,0
2,498,498,5,5,0,1,0

1,167,167,1,1,0,1,0
2,211,211,11,1,10,3,2
3,243,243,13,1,12,3,2
4,329,329,5,5,0,1,0
8,330,330,13,8,5,2,1
7,341,341,54,54,0,1,0
6,368,368,21,13,8,3,2
5,432,432,43,26,17,2,1
0,479,479,9,9,0,1,0
9,481,481,51,51,0,1,0

2,127,127,1,1,0,1,0
1,153,153,23,23,0,1,0
4,256,256,2,2,0,1,0
6,352,352,24,24,0,1,0
0,413,413,26,26,0,1,0
5,454,454,105,33,72,4,3
3,489,489,39,23,16,2,1

5,100,100,8,4,4,2,1
3,118,118,8,8,0,1,0
1,140,140,19,19,0,1,0
0,242,242,37,37,0,1,0
4,286,286,47,47,0,1,0
2,338,338,4,4,0,1,0

3,106,106,19,11,8,3,2
4,204,204,3,3,0,1,0
1,245,245,8,8,0,1,0
5,255,255,29,10,19,4,3
2,348,348,14,14,0,1,0
6,369,369,29,29,0,1,0
0,385,385,14,14,0,1,0
7,483,483,53,15,38,2,1

0,168,168,2,2,0,1,0
3,184,184,13,13,0,1,0
1,246,246,10,7,3,2,1
4,295,295,42,42,0,1,0
7,338,338,3,3,0,1,0
2,341,341,12,9,3,2,1
6,358,358,88,71,17,2,1
5,494,494,25,25,0,1,0

0,253,253,49,49,0,1,0
1,398,398,43,43,0,1,0
3,416,416,34,6,28,3,2
2,440,440,68,29,39,2,1
4,463,463,31,31,0,1,0

5,104,104,13,13,0,1,0
0,111,111,7,2,5,2,1
3,217,217,9,9,0,1,0
1,346,346,19,19,0,1,0
2,361,361,51,51,0,1,0
4,380,380,21,17,4,2,1
6,380,380,48,48,0,1,0

7,153,153,18,2,16,4,3
6,158,158,13,1,12,4,3
2,327,327,58,13,45,2,1
3,342,342,3,3,0,1,0
1,380,380,4,1,3,2,1
0,427,427,6,6,0,1,0
4,453,453,21,11,10,2,1
8,453,453,50,11,39,2,1
5,485,485,21,13,8,3,2

6,148,148,8,8,0,1,0
0,197,197,19,16,3,2,1
8,208,208,25,25,0,1,0
1,226,226,18,15,3,2,1
3,233,233,9,9,0,1,0
2,300,300,24,24,0,1,0
5,314,314,1,1,0,1,0
4,353,353,1,1,0,1,0
7,360,360,47,47,0,1,0

2,109,109,1,1,0,1,0
1,190,190,15,15,0,1,0
4,207,207,1,1,0,1,0
8,228,228,18,18,0,1,0
7,289,289,4,1,3,2,1
9,314,314,67,26,41,2,1
3,323,323,19,19,0,1,0
6,338,338,26,10,16,3,2
0,446,446,29,17,12,2,1
5,476,476,4,1,3,2,1

1,108,108,5,1,4,2,1
6,139,139,16,6,10,4,3
5,233,233,21,4,17,3,2
0,246,246,43,9,34,2,1
3,271,271,11,11,0,1,0
4,324,324,34,34,0,1,0
2,428,428,17,8,9,2,1

1,125,125,12,12,0,1,0
4,152,152,21,8,13,2,1
3,211,211,12,12,0,1,0
2,280,280,7,7,0,1,0
6,302,302,28,16,12,4,3
5,399,399,32,32,0,1,0
0,435,435,55,5,50,3,2

3,170,170,1,1,0,1,0
6,188,188,19,1,18,3,2
5,260,260,41,41,0,1,0
4,362,362,16,16,0,1,0
2,369,369,50,50,0,1,0
1,431,431,31,31,0,1,0
0,485,485,44,44,0,1,0

0,115,115,22,22,0,1,0
1,137,137,5,5,0,1,0
3,386,386,64,64,0,1,0
2,415,415,30,30,0,1,0
5,454,454,50,35,15,4,3
4,500,500,14,14,0,1,0

4,117,117,3,3,0,1,0
1,226,226,6,6,0,1,0
2,250,250,13,5,8,3,2
0,253,253,57,5,52,3,2
5,253,253,24,6,18,4,3
3,491,491,91,91,0,1,0

2,109,109,12,12,0,1,0
0,155,155,3,3,0,1,0
1,167,167,29,7,22,3,2
3,194,194,28,28,0,1,0
5,393,393,4,4,0,1,0
4,416,416,63,37,26,3,2

1,211,211,17,17,0,1,0
2,234,234,5,5,0,1,0
6,249,249,21,21,0,1,0
3,373,373,8,2,6,3,2
4,398,398,22,4,18,2,1
0,404,404,72,60,12,3,2
5,444,444,73,69,4,2,1

5,160,160,13,1,12,4,3
3,236,236,50,50,0,1,0
4,321,321,5,5,0,1,0
1,347,347,6,3,3,2,1
2,446,446,51,3,48,4,3
0,481,481,82,82,0,1,0

5,162,162,13,8,5,2,1
4,192,192,36,7,29,4,3
0,243,243,25,25,0,1,0
6,243,243,10,1,9,4,3
2,261,261,4,4,0,1,0
3,327,327,21,4,17,2,1
1,405,405,48,48,0,1,0

6,149,149,7,7,0,1,0
8,163,163,1,1,0,1,0
1,211,211,16,16,0,1,0
3,221,221,7,7,0,1,0
7,226,226,58,58,0,1,0
4,377,377,11,3,8,2,1
5,382,382,15,3,12,3,2
0,448,448,35,26,9,4,3
2,499,499,23,1,22,4,3

2,109,109,7,7,0,1,0
4,264,264,21,21,0,1,0
3,350,350,58,48,10,3,2
0,361,361,69,5,64,3,2
1,400,400,44,8,36,2,1

4,158,158,31,31,0,1,0
1,166,166,9,3,6,3,2
0,176,176,44,44,0,1,0
2,256,256,2,2,0,1,0
3,424,424,45,45,0,1,0

2,148,148,5,2,3,2,1
5,219,219,47,47,0,1,0
1,227,227,41,27,14,2,1
0,309,309,27,12,15,4,3
4,323,323,16,16,0,1,0
3,359,359,15,11,4,2,1

2,127,127,2,2,0,1,0
5,141,141,16,10,6,2,1
4,205,205,8,2,6,3,2
0,304,304,82,82,0,1,0
3,326,326,51,5,46,4,3
1,371,371,6,6,0,1,0

5,114,114,19,15,4,2,1
6,255,255,26,20,6,2,1
2,270,270,1,1,0,1,0
7,296,296,12,6,6,3,2
4,331,331,24,15,9,2,1
3,412,412,18,18,0,1,0
0,481,481,57,50,7,2,1
1,492,492,31,3,28,3,2

2,123,123,12,12,0,1,0
0,131,131,1,1,0,1,0
5,219,219,49,6,43,2,1
3,352,352,27,15,12,3,2
1,364,364,71,71,0,1,0
4,376,376,2,2,0,1,0

4,118,118,11,11,0,1,0
3,124,124,4,4,0,1,0
1,159,159,17,5,12,4,3
0,170,170,7,7,0,1,0
2,204,204,6,6,0,1,0
5,210,210,6,3,3,2,1
6,480,480,37,17,20,3,2
7,487,487,97,97,0,1,0

0,168,168,15,15,0,1,0
1,172,172,6,3,3,2,1
5,227,227,36,36,0,1,0
4,260,260,22,2,20,3,2
2,305,305,54,54,0,1,0
3,431,431,27,27,0,1,0

2,124,124,6,2,4,2,1
5,249,249,9,5,4,2,1
4,274,274,53,53,0,1,0
6,278,278,21,5,16,2,1
0,306,306,53,53,0,1,0
1,350,350,15,15,0,1,0
3,486,486,18,1,17,2,1

1,165,165,20,20,0,1,0
7,245,245,42,42,0,1,0
3,280,280,5,5,0,1,0
0,288,288,5,5,0,1,0
4,351,351,6,1,5,2,1
6,363,363,45,24,21,2,1
5,451,451,5,2,3,2,1
2,470,470,60,60,0,1,0

3,165,165,24,17,7,2,1
0,221,221,50,17,33,4,3
1,249,249,7,4,3,2,1
5,275,275,3,3,0,1,0
2,390,390,18,2,16,3,2
4,462,462,70,41,29,4,3

1,182,182,9,9,0,1,0
3,186,186,11,11,0,1,0
2,274,274,30,3,27,2,1
5,281,281,21,21,0,1,0
4,288,288,49,49,0,1,0
0,323,323,46,31,15,4,3

7,130,130,12,3,9,2,1
2,189,189,9,9,0,1,0
3,263,263,1,1,0,1,0
0,269,269,12,6,6,3,2
4,286,286,2,2,0,1,0
8,303,303,54,54,0,1,0
1,343,343,7,7,0,1,0
6,462,462,15,1,14,2,1
5,464,464,82,54,28,2,1

7,132,132,20,20,0,1,0
3,180,180,21,21,0,1,0
0,246,246,4,4,0,1,0
4,260,260,18,18,0,1,0
1,318,318,4,4,0,1,0
8,322,322,43,43,0,1,0
6,346,346,8,8,0,1,0
5,352,352,16,9,7,2,1
2,402,402,17,4,13,2,1

3,101,101,12,1,11,2,1
2,117,117,4,4,0,1,0
4,168,168,16,16,0,1,0
1,272,272,64,55,9,4,3
5,348,348,35,16,19,2,1
0,492,492,16,16,0,1,0

5,102,102,3,3,0,1,0
9,179,179,9,9,0,1,0
4,193,193,1,1,0,1,0
1,216,216,9,9,0,1,0
7,245,245,6,6,0,1,0
10,264,264,36,36,0,1,0
6,358,358,7,4,3,2,1
2,372,372,2,2,0,1,0
0,413,413,40,40,0,1,0
8,433,433,50,40,10,2,1
3,451,451,36,36,0,1,0

6,204,204,48,38,10,2,1
3,322,322,22,22,0,1,0
2,330,330,41,41,0,1,0
5,330,330,14,4,10,3,2
4,337,337,9,9,0,1,0
0,364,364,2,2,0,1,0
1,372,372,38,38,0,1,0

2,142,142,22,8,14,2,1
0,190,190,6,6,0,1,0
6,232,232,20,20,0,1,0
1,236,236,9,9,0,1,0
3,277,277,21,5,16,3,2
4,417,417,50,50,0,1,0
5,433,433,43,3,40,3,2

1,237,237,52,9,43,2,1
3,333,333,5,5,0,1,0
2,392,392,102,52,50,4,3
0,485,485,40,40,0,1,0
4,492,492,14,2,12,2,1

7,172,172,19,19,0,1,0
5,175,175,1,1,0,1,0
0,206,206,1,1,0,1,0
6,215,215,3,3,0,1,0
9,290,290,55,39,16,2,1
8,317,317,3,3,0,1,0
1,363,363,19,1,18,3,2
3,407,407,69,69,0,1,0
4,479,479,8,8,0,1,0
2,490,490,19,13,6,3,2

7,133,133,3,3,0,1,0
6,142,142,33,33,0,1,0
4,260,260,13,13,0,1,0
0,296,296,18,6,12,4,3
5,323,323,17,17,0,1,0
2,358,358,13,5,8,2,1
3,479,479,68,56,12,3,2
1,485,485,7,7,0,1,0

2,115,115,7,7,0,1,0
1,133,133,19,19,0,1,0
0,387,387,117,79,38,4,3
3,418,418,45,45,0,1,0

0,142,142,1,1,0,1,0
6,144,144,5,2,3,2,1
9,145,145,27,27,0,1,0
7,155,155,2,2,0,1,0
1,197,197,1,1,0,1,0
2,201,201,26,2,24,4,3
11,202,202,16,1,15,2,1
4,361,361,26,26,0,1,0
8,436,436,2,2,0,1,0
5,444,444,11,11,0,1,0
10,454,454,18,18,0,1,0
3,459,459,5,2,3,2,1

2,131,131,24,24,0,1,0
4,194,194,12,3,9,4,3
1,375,375,56,36,20,3,2
3,452,452,28,20,8,2,1
0,470,470,71,9,62,3,2

0,167,167,45,45,0,1,0
4,186,186,1,1,0,1,0
1,208,208,7,7,0,1,0
2,227,227,58,54,4,2,1
3,240,240,11,8,3,2,1

3,254,254,37,37,0,1,0
0,277,277,84,60,24,4,3
2,371,371,17,4,13,2,1
1,417,417,48,4,44,4,3

1,142,142,13,5,8,3,2
5,192,192,1,1,0,1,0
9,195,195,18,6,12,3,2
4,247,247,3,3,0,1,0
6,258,258,17,2,15,2,1
3,275,275,28,18,10,2,1
7,346,346,55,41,14,3,2
2,424,424,1,1,0,1,0
8,480,480,26,14,12,3,2
0,488,488,12,12,0,1,0

4,139,139,11,2,9,4,3
1,239,239,58,28,30,2,1
2,325,325,35,17,18,2,1
3,339,339,42,32,10,2,1
0,456,456,28,10,18,3,2

6,156,156,24,9,15,2,1
2,165,165,1,1,0,1,0
3,224,224,5,2,3,2,1
0,382,382,18,3,15,4,3
4,409,409,50,47,3,2,1
1,423,423,96,96,0,1,0
5,437,437,13,13,0,1,0

1,138,138,1,1,0,1,0
2,215,215,17,14,3,2,1
4,324,324,21,21,0,1,0
3,342,342,64,54,10,2,1
0,361,361,10,10,0,1,0
5,418,418,60,9,51,4,3
6,492,492,47,29,18,2,1

0,114,114,3,3,0,1,0
4,251,251,56,56,0,1,0
6,346,346,24,6,18,3,2
2,392,392,59,59,0,1,0
3,424,424,49,4,45,4,3
5,495,495,7,7,0,1,0
1,498,498,4,1,3,2,1

1,115,115,19,4,15,4,3
5,125,125,13,13,0,1,0
4,156,156,23,23,0,1,0
0,173,173,5,5,0,1,0
6,361,361,21,21,0,1,0
3,407,407,14,14,0,1,0
2,426,426,31,31,0,1,0

1,105,105,19,1,18,3,2
4,119,119,28,28,0,1,0
5,284,284,18,2,16,3,2
0,382,382,7,7,0,1,0
3,430,430,4,4,0,1,0
2,494,494,50,50,0,1,0

4,199,199,40,10,30,3,2
5,294,294,16,7,9,4,3
2,351,351,46,46,0,1,0
3,361,361,17,9,8,3,2
0,367,367,53,17,36,4,3
1,412,412,11,3,8,2,1

3,116,116,19,3,16,2,1
4,235,235,46,46,0,1,0
6,243,243,20,4,16,3,2
0,357,357,35,35,0,1,0
1,387,387,1,1,0,1,0
2,438,438,18,3,15,4,3
5,498,498,12,2,10,3,2

5,170,170,28,1,27,2,1
0,235,235,2,2,0,1,0
4,335,335,9,9,0,1,0
1,354,354,41,17,24,4,3
2,418,418,69,51,18,2,1
6,473,473,54,2,52,3,2
3,482,482,6,3,3,2,1

4,284,284,13,13,0,1,0
2,319,319,36,26,10,3,2
1,346,346,14,14,0,1,0
0,368,368,34,22,12,2,1
3,381,381,4,4,0,1,0
6,438,438,15,15,0,1,0
5,474,474,35,35,0,1,0
7,475,475,93,42,51,4,3

0,236,236,11,2,9,4,3
2,258,258,44,25,19,2,1
4,294,294,4,4,0,1,0
3,301,301,5,5,0,1,0
7,335,335,36,36,0,1,0
1,364,364,20,17,3,2,1
6,422,422,25,22,3,2,1
5,467,467,64,64,0,1,0

3,201,201,11,11,0,1,0
2,305,305,22,8,14,2,1
4,472,472,85,41,44,3,2
0,478,478,77,37,40,2,1
1,495,495,69,2,67,4,3

2,152,152,1,1,0,1,0
1,153,153,6,1,5,2,1
7,172,172,13,13,0,1,0
4,224,224,32,2,30,2,1
6,248,248,39,39,0,1,0
0,291,291,14,14,0,1,0
3,324,324,7,7,0,1,0
8,453,453,32,2,30,3,2
5,492,492,21,10,11,3,2

5,148,148,9,9,0,1,0
2,198,198,32,32,0,1,0
3,222,222,4,4,0,1,0
0,286,286,22,8,14,3,2
1,355,355,16,16,0,1,0
6,388,388,90,9,81,4,3
4,480,480,7,3,4,2,1

5,152,152,31,31,0,1,0
3,202,202,8,8,0,1,0
0,225,225,24,15,9,2,1
4,251,251,13,13,0,1,0
2,272,272,20,4,16,2,1
6,280,280,14,14,0,1,0
1,427,427,35,35,0,1,0

4,170,170,7,2,5,2,1
2,171,171,2,2,0,1,0
0,270,270,1,1,0,1,0
3,415,415,106,8,98,3,2
1,417,417,124,66,58,4,3

2,114,114,9,9,0,1,0
4,173,173,20,20,0,1,0
5,308,308,47,47,0,1,0
3,350,350,13,5,8,3,2
0,368,368,44,44,0,1,0
1,458,458,49,49,0,1,0

1,220,220,9,3,6,2,1
0,263,263,79,37,42,2,1
2,315,315,60,60,0,1,0
3,320,320,24,5,19,2,1

3,187,187,34,34,0,1,0
4,208,208,11,11,0,1,0
0,256,256,1,1,0,1,0
1,366,366,20,20,0,1,0
5,417,417,8,8,0,1,0
2,430,430,26,6,20,3,2
6,470,470,109,91,18,3,2

2,165,165,9,1,8,3,2
4,184,184,41,41,0,1,0
0,194,194,24,24,0,1,0
1,224,224,40,1,39,4,3
3,477,477,15,1,14,2,1

4,227,227,13,4,9,4,3
3,232,232,15,1,14,2,1
2,298,298,7,2,5,2,1
0,342,342,16,6,10,3,2
6,399,399,43,6,37,4,3
1,415,415,69,69,0,1,0
5,449,449,63,31,32,3,2

3,106,106,2,2,0,1,0
0,148,148,7,7,0,1,0
4,154,154,9,9,0,1,0
1,159,159,5,2,3,2,1
7,206,206,8,3,5,2,1
5,262,262,21,21,0,1,0
6,368,368,88,21,67,4,3
8,380,380,10,10,0,1,0
2,496,496,33,11,22,2,1

1,163,163,28,28,0,1,0
4,177,177,1,1,0,1,0
3,185,185,3,3,0,1,0
5,398,398,77,77,0,1,0
0,418,418,45,35,10,2,1
6,465,465,49,49,0,1,0
2,498,498,4,1,3,2,1

2,173,173,4,4,0,1,0
5,256,256,14,1,13,2,1
0,264,264,39,3,36,3,2
1,268,268,36,36,0,1,0
3,413,413,93,51,42,3,2
4,433,433,11,11,0,1,0

2,192,192,2,2,0,1,0
6,201,201,1,1,0,1,0
3,218,218,35,35,0,1,0
4,260,260,68,57,11,2,1
5,358,358,15,9,6,3,2
0,442,442,24,24,0,1,0
1,491,491,38,38,0,1,0

7,166,166,1,1,0,1,0
2,195,195,15,5,10,3,2
1,202,202,4,4,0,1,0
3,232,232,5,5,0,1,0
0,265,265,1,1,0,1,0
8,287,287,21,21,0,1,0
4,292,292,2,2,0,1,0
6,321,321,25,25,0,1,0
5,349,349,5,5,0,1,0
11,407,407,66,20,46,2,1
10,440,440,19,19,0,1,0
9,492,492,49,17,32,2,1

1,232,232,7,7,0,1,0
6,234,234,30,23,7,2,1
4,250,250,9,1,8,3,2
5,317,317,44,44,0,1,0
2,339,339,31,10,21,4,3
0,359,359,50,38,12,3,2
3,498,498,20,20,0,1,0

7,165,165,3,3,0,1,0
2,189,189,12,3,9,2,1
5,246,246,70,70,0,1,0
1,282,282,17,12,5,2,1
0,326,326,21,6,15,2,1
3,454,454,22,22,0,1,0
6,464,464,3,3,0,1,0
4,500,500,32,32,0,1,0

0,198,198,6,3,3,2,1
4,217,217,56,56,0,1,0
2,263,263,24,24,0,1,0
1,267,267,48,38,10,2,1
3,319,319,2,2,0,1,0
5,469,469,19,19,0,1,0

1,211,211,31,31,0,1,0
0,275,275,1,1,0,1,0
5,288,288,5,5,0,1,0
3,415,415,11,2,9,2,1
2,417,417,52,52,0,1,0
6,445,445,74,66,8,2,1
4,456,456,56,56,0,1,0

3,143,143,10,10,0,1,0
6,179,179,17,1,16,3,2
4,241,241,42,18,24,4,3
1,341,341,7,7,0,1,0
5,401,401,14,14,0,1,0
0,405,405,66,32,34,2,1
2,425,425,20,20,0,1,0

2,122,122,11,11,0,1,0
5,225,225,3,3,0,1,0
3,284,284,48,48,0,1,0
4,291,291,36,36,0,1,0
0,388,388,81,81,0,1,0
1,496,496,1,1,0,1,0

2,141,141,15,4,11,2,1
4,255,255,7,7,0,1,0
1,284,284,56,56,0,1,0
0,288,288,30,16,14,3,2
3,428,428,75,75,0,1,0

1,115,115,18,18,0,1,0
0,145,145,44,44,0,1,0
3,178,178,14,2,12,4,3
2,389,389,28,28,0,1,0

6,147,147,16,16,0,1,0
3,224,224,9,9,0,1,0
5,269,269,4,4,0,1,0
1,287,287,39,39,0,1,0
0,318,318,27,15,12,4,3
4,412,412,75,23,52,4,3
2,429,429,18,18,0,1,0

4,152,152,8,2,6,3,2
0,199,199,1,1,0,1,0
3,200,200,9,9,0,1,0
1,244,244,61,17,44,4,3
6,271,271,32,32,0,1,0
5,311,311,41,8,33,2,1
2,370,370,1,1,0,1,0

0,108,108,1,1,0,1,0
1,138,138,8,8,0,1,0
7,179,179,17,17,0,1,0
3,199,199,10,2,8,3,2
6,207,207,37,37,0,1,0
5,296,296,10,10,0,1,0
2,320,320,46,46,0,1,0
4,372,372,15,3,12,2,1

7,109,109,5,5,0,1,0
4,202,202,26,26,0,1,0
5,255,255,51,25,26,3,2
2,298,298,13,4,9,4,3
1,356,356,17,17,0,1,0
6,372,372,21,21,0,1,0
0,389,389,17,7,10,2,1
3,469,469,19,19,0,1,0

8,126,126,18,10,8,2,1
0,151,151,2,2,0,1,0
5,176,176,2,2,0,1,0
2,204,204,11,8,3,2,1
3,265,265,34,4,30,3,2
1,286,286,10,3,7,2,1
10,361,361,27,17,10,2,1
9,385,385,33,17,16,3,2
7,414,414,9,9,0,1,0
4,417,417,12,4,8,3,2
6,489,489,4,4,0,1,0

4,157,157,11,11,0,1,0
1,251,251,8,8,0,1,0
6,278,278,54,54,0,1,0
2,289,289,31,25,6,2,1
3,386,386,53,41,12,4,3
0,420,420,10,2,8,3,2
5,453,453,19,13,6,3,2

1,110,110,4,4,0,1,0
5,159,159,28,5,23,2,1
6,171,171,20,20,0,1,0
4,206,206,7,7,0,1,0
7,363,363,7,7,0,1,0
3,372,372,1,1,0,1,0
0,419,419,48,39,9,2,1
2,495,495,57,35,22,4,3

1,267,267,42,22,20,3,2
3,286,286,12,12,0,1,0
0,307,307,25,25,0,1,0
2,367,367,8,8,0,1,0
6,376,376,44,44,0,1,0
5,425,425,41,1,40,3,2
4,466,466,42,42,0,1,0

2,104,104,3,3,0,1,0
5,170,170,13,13,0,1,0
3,193,193,33,15,18,2,1
4,217,217,23,7,16,2,1
1,223,223,20,11,9,3,2
6,365,365,45,45,0,1,0
0,397,397,5,5,0,1,0

1,159,159,1,1,0,1,0
0,186,186,7,7,0,1,0
5,221,221,35,1,34,3,2
2,228,228,11,8,3,2,1
7,299,299,35,5,30,3,2
3,317,317,49,8,41,2,1
6,342,342,11,4,7,2,1
4,425,425,23,23,0,1,0

2,214,214,45,10,35,2,1
1,253,253,5,2,3,2,1
4,381,381,3,3,0,1,0
3,400,400,17,17,0,1,0
0,421,421,30,17,13,2,1
5,438,438,111,111,0,1,0

5,102,102,12,12,0,1,0
2,138,138,3,3,0,1,0
6,220,220,11,11,0,1,0
0,331,331,22,7,15,4,3
4,353,353,50,2,48,4,3
1,419,419,83,83,0,1,0
3,438,438,7,7,0,1,0

2,143,143,24,3,21,2,1
4,212,212,46,24,22,3,2
5,244,244,16,6,10,3,2
1,264,264,1,1,0,1,0
3,286,286,23,8,15,4,3
0,295,295,15,15,0,1,0
6,500,500,11,11,0,1,0

3,134,134,7,7,0,1,0
0,186,186,14,6,8,2,1
1,222,222,39,1,38,2,1
4,232,232,15,6,9,3,2
5,376,376,16,16,0,1,0
2,447,447,1,1,0,1,0
6,467,467,93,77,16,2,1

4,161,161,9,9,0,1,0
6,161,161,5,5,0,1,0
9,162,162,8,1,7,2,1
5,315,315,9,9,0,1,0
2,325,325,1,1,0,1,0
8,333,333,44,13,31,2,1
3,370,370,24,24,0,1,0
1,427,427,51,35,16,3,2
0,483,483,1,1,0,1,0
7,489,489,60,41,19,2,1

1,185,185,1,1,0,1,0
2,186,186,35,35,0,1,0
0,221,221,66,9,57,4,3
3,221,221,6,2,4,2,1
4,484,484,43,34,9,4,3

4,152,152,28,28,0,1,0
0,173,173,26,18,8,2,1
5,212,212,22,6,16,2,1
3,249,249,6,6,0,1,0
2,400,400,18,18,0,1,0
1,465,465,49,49,0,1,0

0,227,227,63,27,36,4,3
4,314,314,63,63,0,1,0
3,346,346,7,4,3,2,1
2,462,462,39,39,0,1,0
1,465,465,11,11,0,1,0

3,204,204,27,19,8,2,1
4,228,228,9,9,0,1,0
1,291,291,45,29,16,2,1
5,318,318,62,62,0,1,0
0,415,415,1,1,0,1,0
2,426,426,5,5,0,1,0
6,477,477,35,35,0,1,0

5,125,125,10,10,0,1,0
2,162,162,12,4,8,3,2
7,196,196,37,37,0,1,0
6,356,356,15,15,0,1,0
3,373,373,39,39,0,1,0
0,415,415,11,11,0,1,0
4,428,428,7,7,0,1,0
1,447,447,1,1,0,1,0
8,452,452,35,35,0,1,0

3,115,115,1,1,0,1,0
2,224,224,34,34,0,1,0
8,242,242,22,22,0,1,0
1,248,248,23,6,17,2,1
7,260,260,7,1,6,3,2
4,365,365,11,8,3,2,1
6,436,436,81,15,66,3,2
5,454,454,7,7,0,1,0
0,469,469,1,1,0,1,0

4,250,250,10,10,0,1,0
7,268,268,28,12,16,2,1
8,364,364,49,16,33,2,1
2,382,382,73,19,54,3,2
9,390,390,26,4,22,3,2
3,408,408,8,2,6,2,1
1,434,434,8,2,6,2,1
0,455,455,2,2,0,1,0
6,484,484,4,4,0,1,0
5,492,492,9,1,8,3,2

6,142,142,3,3,0,1,0
7,150,150,30,12,18,2,1
2,215,215,27,27,0,1,0
4,232,232,1,1,0,1,0
8,281,281,14,14,0,1,0
1,362,362,20,7,13,2,1
0,406,406,4,4,0,1,0
9,411,411,23,23,0,1,0
5,430,430,4,4,0,1,0
3,461,461,37,37,0,1,0

0,144,144,17,1,16,2,1
4,179,179,13,1,12,2,1
1,277,277,16,16,0,1,0
2,369,369,46,34,12,4,3
3,374,374,46,46,0,1,0
5,383,383,42,23,19,2,1

5,108,108,22,22,0,1,0
3,165,165,5,5,0,1,0
4,313,313,23,5,18,4,3
2,317,317,10,10,0,1,0
0,454,454,89,89,0,1,0
1,466,466,35,35,0,1,0

1,235,235,14,14,0,1,0
2,312,312,3,3,0,1,0
0,402,402,121,89,32,3,2
3,425,425,99,36,63,4,3

4,172,172,26,26,0,1,0
2,297,297,4,4,0,1,0
0,322,322,6,3,3,2,1
3,380,380,55,55,0,1,0
1,431,431,122,58,64,4,3

3,145,145,41,41,0,1,0
6,146,146,19,7,12,2,1
1,155,155,1,1,0,1,0
2,212,212,1,1,0,1,0
0,284,284,3,3,0,1,0
4,294,294,42,42,0,1,0
5,365,365,12,7,5,2,1

1,182,182,1,1,0,1,0
4,268,268,61,61,0,1,0
3,280,280,14,6,8,2,1
0,333,333,99,99,0,1,0
2,430,430,12,12,0,1,0

0,123,123,14,14,0,1,0
6,189,189,41,32,9,2,1
3,202,202,34,34,0,1,0
4,251,251,8,8,0,1,0
2,315,315,5,5,0,1,0
5,385,385,23,8,15,2,1
1,398,398,1,1,0,1,0

1,137,137,4,4,0,1,0
3,211,211,8,4,4,2,1
4,235,235,48,34,14,2,1
0,242,242,43,25,18,3,2
5,259,259,16,16,0,1,0
2,358,358,34,34,0,1,0

6,135,135,11,11,0,1,0
7,198,198,23,23,0,1,0
5,219,219,25,8,17,2,1
4,224,224,36,6,30,2,1
0,312,312,14,14,0,1,0
1,433,433,11,11,0,1,0
2,448,448,26,17,9,2,1
3,468,468,6,6,0,1,0

1,154,154,6,6,0,1,0
0,244,244,1,1,0,1,0
5,254,254,23,23,0,1,0
4,319,319,22,9,13,2,1
2,379,379,98,52,46,3,2
3,426,426,62,62,0,1,0

2,219,219,40,40,0,1,0
0,240,240,46,28,18,2,1
4,312,312,11,11,0,1,0
3,313,313,28,12,16,3,2
1,476,476,52,52,0,1,0

1,170,170,3,3,0,1,0
5,336,336,29,29,0,1,0
3,366,366,29,29,0,1,0
7,387,387,63,63,0,1,0
6,437,437,24,24,0,1,0
0,451,451,43,43,0,1,0
2,461,461,32,32,0,1,0
4,494,494,19,19,0,1,0

2,108,108,17,7,10,2,1
4,160,160,26,13,13,2,1
0,224,224,1,1,0,1,0
5,255,255,3,3,0,1,0
1,391,391,55,23,32,2,1
3,414,414,54,39,15,2,1

1,116,116,6,2,4,2,1
2,198,198,24,2,22,3,2
3,281,281,49,49,0,1,0
4,302,302,3,3,0,1,0
0,390,390,99,99,0,1,0

1,108,108,10,10,0,1,0
4,203,203,1,1,0,1,0
0,219,219,35,35,0,1,0
3,225,225,5,2,3,2,1
7,300,300,61,58,3,2,1
5,346,346,16,3,13,2,1
6,404,404,23,2,21,2,1
2,493,493,11,11,0,1,0

4,163,163,5,2,3,2,1
5,192,192,30,14,16,2,1
2,282,282,3,3,0,1,0
3,362,362,43,13,30,2,1
0,367,367,26,26,0,1,0
1,500,500,111,72,39,4,3

6,229,229,22,22,0,1,0
3,291,291,7,7,0,1,0
4,299,299,50,2,48,4,3
1,317,317,45,45,0,1,0
0,406,406,8,1,7,2,1
5,435,435,19,19,0,1,0
2,453,453,53,53,0,1,0

0,222,222,21,21,0,1,0
5,237,237,60,48,12,4,3
3,257,257,23,23,0,1,0
6,263,263,6,6,0,1,0
1,345,345,10,10,0,1,0
2,448,448,40,40,0,1,0
4,474,474,15,15,0,1,0

3,114,114,20,8,12,3,2
2,260,260,26,26,0,1,0
4,317,317,10,10,0,1,0
1,331,331,89,5,84,4,3
0,347,347,11,3,8,3,2

7,100,100,2,2,0,1,0
1,109,109,13,9,4,2,1
2,157,157,13,10,3,2,1
3,173,173,4,4,0,1,0
4,246,246,17,7,10,3,2
6,316,316,41,23,18,2,1
0,495,495,4,4,0,1,0
5,495,495,80,80,0,1,0

3,142,142,9,9,0,1,0
1,160,160,14,14,0,1,0
0,293,293,31,31,0,1,0
6,364,364,30,18,12,2,1
5,373,373,21,21,0,1,0
2,450,450,22,16,6,3,2
4,483,483,80,5,75,4,3

4,139,139,1,1,0,1,0
3,231,231,36,36,0,1,0
6,288,288,22,22,0,1,0
7,302,302,38,38,0,1,0
1,421,421,30,24,6,2,1
0,443,443,6,6,0,1,0
5,451,451,45,45,0,1,0
2,487,487,26,22,4,2,1

5,100,100,2,2,0,1,0
4,137,137,23,14,9,4,3
2,210,210,38,38,0,1,0
3,364,364,18,9,9,4,3
0,411,411,18,15,3,2,1
6,412,412,49,29,20,3,2
1,448,448,12,6,6,3,2

5,116,116,21,12,9,2,1
7,167,167,18,18,0,1,0
1,254,254,29,1,28,3,2
3,271,271,25,25,0,1,0
4,330,330,13,3,10,3,2
2,407,407,18,18,0,1,0
0,443,443,5,5,0,1,0
6,478,478,7,1,6,2,1

1,109,109,13,10,3,2,1
0,228,228,20,20,0,1,0
4,301,301,14,14,0,1,0
5,355,355,21,21,0,1,0
2,399,399,38,38,0,1,0
3,457,457,92,92,0,1,0

0,117,117,4,4,0,1,0
1,164,164,29,14,15,2,1
3,197,197,5,1,4,2,1
6,206,206,36,30,6,3,2
2,211,211,14,10,4,2,1
4,233,233,6,2,4,2,1
5,474,474,51,25,26,3,2

9,156,156,19,19,0,1,0
4,171,171,10,7,3,2,1
3,235,235,7,7,0,1,0
8,258,258,23,3,20,4,3
2,290,290,34,14,20,3,2
5,411,411,7,7,0,1,0
0,424,424,20,8,12,2,1
7,466,466,44,2,42,4,3
1,496,496,7,7,0,1,0
6,499,499,9,4,5,2,1

7,108,108,15,6,9,4,3
0,111,111,8,2,6,2,1
4,168,168,23,11,12,3,2
1,186,186,7,7,0,1,0
8,197,197,30,30,0,1,0
2,306,306,7,7,0,1,0
3,384,384,11,2,9,2,1
6,393,393,7,2,5,2,1
5,475,475,1,1,0,1,0

5,122,122,17,17,0,1,0
4,154,154,33,7,26,2,1
7,168,168,6,6,0,1,0
6,190,190,25,25,0,1,0
2,220,220,2,2,0,1,0
3,231,231,1,1,0,1,0
0,261,261,16,1,15,2,1
1,430,430,6,6,0,1,0

1,186,186,16,16,0,1,0
2,202,202,17,17,0,1,0
0,264,264,80,17,63,4,3
3,396,396,55,55,0,1,0

4,185,185,6,3,3,2,1
2,290,290,21,21,0,1,0
0,315,315,26,11,15,2,1
1,328,328,48,12,36,4,3
5,478,478,46,46,0,1,0
3,479,479,84,2,82,4,3

4,103,103,6,6,0,1,0
5,110,110,14,14,0,1,0
3,141,141,7,4,3,2,1
1,204,204,8,2,6,2,1
2,208,208,1,1,0,1,0
8,313,313,58,9,49,4,3
0,316,316,9,9,0,1,0
7,332,332,37,37,0,1,0
6,374,374,2,2,0,1,0

2,327,327,10,10,0,1,0
3,358,358,32,29,3,2,1
1,428,428,113,105,8,2,1
4,451,451,84,71,13,2,1
0,487,487,18,18,0,1,0

5,116,116,25,11,14,2,1
2,163,163,1,1,0,1,0
4,318,318,24,24,0,1,0
3,319,319,16,10,6,3,2
6,319,319,7,7,0,1,0
1,348,348,53,53,0,1,0
0,476,476,45,7,38,3,2

7,150,150,19,19,0,1,0
5,170,170,7,1,6,3,2
1,184,184,22,22,0,1,0
3,270,270,7,7,0,1,0
6,333,333,47,47,0,1,0
4,437,437,23,2,21,2,1
2,456,456,12,4,8,3,2
0,463,463,36,36,0,1,0

6,100,100,11,1,10,2,1
1,156,156,2,2,0,1,0
2,183,183,17,17,0,1,0
5,351,351,16,8,8,2,1
3,364,364,53,11,42,2,1
4,409,409,62,32,30,4,3
0,496,496,25,25,0,1,0

1,197,197,17,3,14,2,1
6,216,216,4,4,0,1,0
2,321,321,11,11,0,1,0
7,384,384,86,44,42,3,2
0,385,385,36,36,0,1,0
5,391,391,24,24,0,1,0
3,450,450,32,27,5,2,1
4,465,465,7,1,6,3,2

1,183,183,26,26,0,1,0
4,183,183,3,3,0,1,0
7,228,228,5,5,0,1,0
3,229,229,10,10,0,1,0
5,304,304,35,35,0,1,0
2,398,398,13,3,10,2,1
0,472,472,32,32,0,1,0
6,493,493,82,10,72,4,3

5,225,225,14,14,0,1,0
1,296,296,2,2,0,1,0
6,403,403,11,3,8,3,2
3,411,411,7,7,0,1,0
2,416,416,1,1,0,1,0
0,450,450,124,124,0,1,0
4,462,462,98,43,55,4,3

2,102,102,4,4,0,1,0
1,135,135,7,7,0,1,0
8,191,191,13,13,0,1,0
6,198,198,7,2,5,2,1
7,289,289,45,3,42,2,1
3,318,318,28,21,7,2,1
0,332,332,7,7,0,1,0
9,364,364,30,30,0,1,0
4,406,406,24,24,0,1,0
5,445,445,3,3,0,1,0

4,194,194,15,9,6,3,2
5,209,209,28,3,25,2,1
1,229,229,28,28,0,1,0
0,398,398,2,2,0,1,0
3,432,432,40,30,10,3,2
2,475,475,83,83,0,1,0

1,178,178,42,42,0,1,0
2,253,253,36,16,20,2,1
0,273,273,19,19,0,1,0
4,280,280,25,25,0,1,0
3,482,482,36,36,0,1,0

6,177,177,2,2,0,1,0
3,322,322,48,48,0,1,0
4,347,347,27,3,24,3,2
1,387,387,5,5,0,1,0
8,436,436,94,94,0,1,0
2,437,437,7,7,0,1,0
0,454,454,5,5,0,1,0
7,477,477,37,9,28,2,1
5,481,481,16,16,0,1,0

6,190,190,24,9,15,4,3
3,269,269,35,35,0,1,0
0,276,276,2,2,0,1,0
4,285,285,16,6,10,2,1
5,299,299,38,38,0,1,0
1,328,328,1,1,0,1,0
2,374,374,61,25,36,2,1

4,178,178,16,16,0,1,0
2,198,198,18,6,12,4,3
0,342,342,2,2,0,1,0
5,434,434,76,76,0,1,0
1,457,457,95,74,21,4,3
3,499,499,21,3,18,3,2

3,219,219,21,2,19,2,1
5,327,327,14,14,0,1,0
1,339,339,11,5,6,3,2
2,377,377,90,70,20,3,2
0,408,408,12,12,0,1,0
4,464,464,77,77,0,1,0

2,138,138,14,14,0,1,0
1,195,195,39,39,0,1,0
4,201,201,34,26,8,3,2
0,379,379,39,5,34,2,1
3,469,469,20,4,16,4,3

6,123,123,11,5,6,2,1
3,140,140,8,8,0,1,0
1,170,170,21,15,6,2,1
7,182,182,29,29,0,1,0
5,183,183,12,12,0,1,0
0,233,233,9,6,3,2,1
2,341,341,7,3,4,2,1
4,399,399,25,5,20,3,2

4,160,160,5,5,0,1,0
6,161,161,9,9,0,1,0
7,165,165,1,1,0,1,0
1,186,186,19,9,10,2,1
2,192,192,11,1,10,3,2
0,205,205,6,6,0,1,0
5,351,351,16,16,0,1,0
8,365,365,89,89,0,1,0
3,437,437,16,7,9,2,1

0,135,135,11,7,4,2,1
5,144,144,25,15,10,3,2
2,164,164,2,2,0,1,0
1,321,321,49,17,32,3,2
6,420,420,9,9,0,1,0
3,459,459,25,25,0,1,0
4,469,469,51,51,0,1,0

2,175,175,12,12,0,1,0
6,183,183,9,9,0,1,0
1,214,214,18,18,0,1,0
4,268,268,25,25,0,1,0
5,307,307,50,18,32,3,2
3,333,333,26,4,22,3,2
0,487,487,35,5,30,4,3

0,202,202,38,38,0,1,0
1,300,300,34,34,0,1,0
3,332,332,14,14,0,1,0
4,372,372,52,52,0,1,0
2,432,432,53,53,0,1,0

0,109,109,1,1,0,1,0
1,236,236,1,1,0,1,0
7,268,268,7,3,4,2,1
8,295,295,54,54,0,1,0
5,336,336,57,4,53,3,2
2,446,446,24,10,14,2,1
4,462,462,28,28,0,1,0
3,464,464,2,2,0,1,0
6,478,478,45,45,0,1,0

1,165,165,12,3,9,2,1
3,165,165,18,18,0,1,0
4,181,181,25,4,21,4,3
5,243,243,14,14,0,1,0
0,348,348,16,16,0,1,0
2,394,394,72,24,48,4,3

0,186,186,15,15,0,1,0
1,201,201,28,28,0,1,0
5,272,272,51,51,0,1,0
2,274,274,5,5,0,1,0
6,276,276,28,28,0,1,0
4,374,374,4,4,0,1,0
7,390,390,6,6,0,1,0
3,441,441,23,8,15,4,3

1,285,285,25,22,3,2,1
0,312,312,16,16,0,1,0
5,366,366,22,22,0,1,0
2,367,367,24,24,0,1,0
4,370,370,10,10,0,1,0
6,440,440,96,84,12,2,1
3,495,495,48,27,21,4,3

7,119,119,3,3,0,1,0
6,124,124,10,3,7,2,1
8,211,211,21,3,18,3,2
0,212,212,7,7,0,1,0
3,312,312,11,11,0,1,0
10,349,349,56,56,0,1,0
9,359,359,16,16,0,1,0
2,382,382,1,1,0,1,0
4,396,396,16,16,0,1,0
1,429,429,25,25,0,1,0
5,453,453,12,2,10,3,2

2,329,329,64,42,22,2,1
4,338,338,36,24,12,2,1
3,429,429,29,23,6,2,1
0,452,452,32,32,0,1,0
5,472,472,62,2,60,3,2
1,486,486,17,17,0,1,0

1,253,253,19,19,0,1,0
3,286,286,58,58,0,1,0
0,407,407,93,75,18,4,3
4,462,462,1,1,0,1,0
2,488,488,49,31,18,3,2

5,100,100,17,6,11,2,1
2,182,182,19,4,15,4,3
0,188,188,5,5,0,1,0
1,277,277,22,3,19,2,1
4,393,393,26,14,12,3,2
3,427,427,39,15,24,3,2
6,498,498,37,37,0,1,0

1,170,170,14,14,0,1,0
2,297,297,12,7,5,2,1
0,324,324,16,16,0,1,0
3,333,333,43,34,9,2,1
5,348,348,9,9,0,1,0
6,390,390,41,41,0,1,0
4,488,488,85,85,0,1,0

6,100,100,13,1,12,3,2
2,160,160,8,8,0,1,0
3,199,199,32,10,22,3,2
7,224,224,3,3,0,1,0
1,252,252,15,7,8,3,2
0,388,388,7,7,0,1,0
4,475,475,6,6,0,1,0
5,498,498,81,36,45,4,3

5,130,130,13,13,0,1,0
1,131,131,15,2,13,2,1
7,131,131,5,2,3,2,1
3,186,186,8,8,0,1,0
6,224,224,41,41,0,1,0
2,305,305,12,12,0,1,0
0,386,386,2,2,0,1,0
8,394,394,32,32,0,1,0
4,482,482,1,1,0,1,0

12,122,122,8,8,0,1,0
7,164,164,1,1,0,1,0
4,203,203,2,2,0,1,0
10,204,204,18,9,9,2,1
6,206,206,18,3,15,4,3
13,287,287,25,11,14,2,1
3,314,314,2,2,0,1,0
9,326,326,6,2,4,2,1
5,358,358,9,9,0,1,0
1,363,363,8,2,6,3,2
0,372,372,1,1,0,1,0
8,460,460,11,11,0,1,0
11,461,461,70,43,27,2,1
2,499,499,5,5,0,1,0

3,221,221,5,5,0,1,0
4,249,249,28,4,24,4,3
0,267,267,24,24,0,1,0
5,336,336,57,24,33,2,1
1,389,389,3,3,0,1,0
2,403,403,82,82,0,1,0

3,105,105,3,3,0,1,0
4,158,158,20,4,16,2,1
0,208,208,37,3,34,2,1
2,245,245,3,3,0,1,0
1,246,246,21,12,9,2,1
6,445,445,38,38,0,1,0
5,466,466,44,39,5,2,1

6,117,117,22,5,17,2,1
5,125,125,9,9,0,1,0
0,199,199,8,4,4,2,1
3,264,264,1,1,0,1,0
2,281,281,61,49,12,4,3
1,359,359,14,14,0,1,0
4,464,464,24,24,0,1,0

5,170,170,16,16,0,1,0
1,302,302,11,11,0,1,0
6,344,344,44,20,24,4,3
0,363,363,41,26,15,2,1
2,391,391,2,2,0,1,0
4,420,420,33,29,4,2,1
3,456,456,31,31,0,1,0
7,489,489,39,39,0,1,0

2,140,140,1,1,0,1,0
5,172,172,14,7,7,2,1
4,176,176,4,4,0,1,0
7,214,214,9,1,8,2,1
6,235,235,27,1,26,3,2
8,400,400,59,59,0,1,0
1,412,412,14,10,4,2,1
0,416,416,43,43,0,1,0
3,485,485,27,27,0,1,0

0,161,161,10,10,0,1,0
1,258,258,11,11,0,1,0
5,374,374,9,5,4,2,1
4,453,453,34,34,0,1,0
2,479,479,94,18,76,3,2
3,481,481,97,31,66,4,3

3,122,122,4,4,0,1,0
4,222,222,20,5,15,4,3
0,337,337,51,9,42,3,2
1,456,456,68,44,24,3,2
2,472,472,87,71,16,2,1

1,140,140,12,12,0,1,0
0,158,158,9,9,0,1,0
4,225,225,18,18,0,1,0
3,282,282,17,17,0,1,0
5,460,460,75,75,0,1,0
2,482,482,76,19,57,4,3

2,144,144,11,11,0,1,0
0,150,150,46,46,0,1,0
3,165,165,16,16,0,1,0
1,452,452,60,23,37,2,1

4,101,101,3,3,0,1,0
7,117,117,3,3,0,1,0
8,124,124,23,3,20,3,2
0,225,225,3,3,0,1,0
1,272,272,6,1,5,2,1
3,302,302,14,14,0,1,0
6,335,335,33,33,0,1,0
5,399,399,25,21,4,2,1
2,427,427,54,54,0,1,0

1,197,197,20,20,0,1,0
3,197,197,14,14,0,1,0
0,233,233,5,5,0,1,0
7,236,236,41,18,23,2,1
4,282,282,30,30,0,1,0
5,355,355,27,27,0,1,0
2,419,419,1,1,0,1,0
6,450,450,24,24,0,1,0

3,192,192,4,4,0,1,0
2,195,195,30,4,26,2,1
1,204,204,23,11,12,4,3
4,217,217,58,1,57,4,3
0,468,468,18,18,0,1,0
5,473,473,10,1,9,2,1

3,103,103,2,2,0,1,0
6,126,126,1,1,0,1,0
10,132,132,2,2,0,1,0
0,171,171,7,7,0,1,0
7,225,225,17,9,8,3,2
1,343,343,21,21,0,1,0
4,358,358,10,5,5,2,1
9,433,433,112,74,38,3,2
2,452,452,22,22,0,1,0
5,495,495,10,6,4,2,1
8,499,499,14,5,9,4,3

0,165,165,4,4,0,1,0
4,186,186,41,13,28,4,3
3,257,257,8,2,6,3,2
2,278,278,5,5,0,1,0
6,300,300,37,16,21,4,3
7,309,309,16,1,15,4,3
5,389,389,51,51,0,1,0
1,413,413,3,3,0,1,0

2,139,139,9,9,0,1,0
4,230,230,15,15,0,1,0
5,287,287,18,5,13,2,1
7,310,310,41,41,0,1,0
1,322,322,19,19,0,1,0
0,350,350,6,6,0,1,0
8,396,396,4,4,0,1,0
3,416,416,14,14,0,1,0
6,450,450,74,35,39,4,3

8,112,112,13,13,0,1,0
2,140,140,17,2,15,2,1
5,267,267,15,15,0,1,0
1,313,313,7,7,0,1,0
4,317,317,1,1,0,1,0
6,402,402,22,22,0,1,0
9,405,405,75,21,54,4,3
0,448,448,1,1,0,1,0
3,462,462,19,11,8,2,1
7,465,465,5,2,3,2,1

4,204,204,17,3,14,2,1
2,234,234,15,6,9,4,3
6,254,254,7,7,0,1,0
5,297,297,59,59,0,1,0
1,309,309,20,16,4,2,1
0,340,340,28,28,0,1,0
3,455,455,41,13,28,2,1

3,100,100,17,9,8,2,1
2,129,129,8,8,0,1,0
4,421,421,33,33,0,1,0
1,428,428,82,71,11,2,1
0,450,450,49,43,6,3,2

4,149,149,19,3,16,2,1
0,186,186,1,1,0,1,0
5,197,197,44,32,12,2,1
2,250,250,2,2,0,1,0
6,260,260,7,1,6,2,1
7,304,304,16,7,9,4,3
1,329,329,45,32,13,2,1
3,487,487,12,12,0,1,0

0,106,106,8,8,0,1,0
1,117,117,6,6,0,1,0
6,138,138,21,17,4,2,1
3,254,254,7,3,4,2,1
8,267,267,18,10,8,2,1
2,274,274,22,14,8,2,1
4,283,283,1,1,0,1,0
5,410,410,26,26,0,1,0
7,420,420,37,19,18,2,1

0,248,248,75,75,0,1,0
1,279,279,15,2,13,3,2
3,336,336,80,80,0,1,0
2,493,493,7,7,0,1,0

3,161,161,31,1,30,3,2
4,271,271,30,30,0,1,0
5,386,386,1,1,0,1,0
1,389,389,7,4,3,2,1
2,391,391,82,82,0,1,0
0,459,459,34,20,14,2,1

2,168,168,1,1,0,1,0
3,223,223,29,29,0,1,0
6,284,284,23,23,0,1,0
0,297,297,17,17,0,1,0
5,425,425,35,35,0,1,0
7,429,429,60,33,27,4,3
1,449,449,22,22,0,1,0
4,449,449,26,26,0,1,0

6,128,128,22,13,9,2,1
0,173,173,1,1,0,1,0
2,220,220,4,4,0,1,0
3,258,258,28,28,0,1,0
5,300,300,10,10,0,1,0
1,373,373,60,16,44,2,1
4,431,431,3,3,0,1,0
7,473,473,46,46,0,1,0

6,194,194,16,10,6,2,1
3,228,228,9,3,6,2,1
2,331,331,49,31,18,4,3
5,351,351,68,68,0,1,0
0,361,361,12,12,0,1,0
1,412,412,33,3,30,3,2
4,458,458,14,6,8,2,1

3,111,111,7,7,0,1,0
4,143,143,35,27,8,3,2
0,148,148,26,26,0,1,0
2,157,157,9,9,0,1,0
5,250,250,1,1,0,1,0
1,373,373,27,3,24,3,2

3,112,112,1,1,0,1,0
0,138,138,8,1,7,2,1
4,205,205,2,2,0,1,0
5,262,262,74,28,46,3,2
2,264,264,63,63,0,1,0
1,485,485,2,2,0,1,0

3,178,178,24,5,19,2,1
2,243,243,21,21,0,1,0
1,292,292,26,26,0,1,0
0,309,309,93,84,9,4,3

7,150,150,11,11,0,1,0
3,196,196,31,31,0,1,0
5,196,196,9,5,4,2,1
0,207,207,1,1,0,1,0
1,305,305,19,19,0,1,0
6,325,325,61,24,37,3,2
2,406,406,18,4,14,3,2
4,495,495,16,6,10,3,2

3,179,179,8,8,0,1,0
4,191,191,2,2,0,1,0
6,199,199,50,50,0,1,0
5,214,214,7,7,0,1,0
1,278,278,34,34,0,1,0
0,298,298,2,2,0,1,0
7,377,377,3,3,0,1,0
2,433,433,37,37,0,1,0
8,468,468,22,14,8,2,1

0,120,120,14,14,0,1,0
1,310,310,47,23,24,2,1
5,404,404,19,7,12,4,3
4,426,426,53,14,39,2,1
3,445,445,58,24,34,2,1
2,458,458,15,3,12,4,3

2,169,169,29,29,0,1,0
0,177,177,6,6,0,1,0
5,183,183,45,45,0,1,0
3,247,247,8,4,4,2,1
1,248,248,24,12,12,4,3
4,268,268,7,7,0,1,0

4,234,234,3,3,0,1,0
0,298,298,45,45,0,1,0
1,316,316,13,4,9,2,1
5,353,353,21,9,12,3,2
2,401,401,18,18,0,1,0
6,428,428,100,59,41,4,3
3,431,431,28,5,23,2,1

3,174,174,6,6,0,1,0
8,221,221,47,47,0,1,0
1,245,245,4,4,0,1,0
6,276,276,2,2,0,1,0
9,322,322,20,11,9,4,3
5,351,351,14,14,0,1,0
10,375,375,13,3,10,3,2
2,422,422,46,46,0,1,0
0,424,424,2,2,0,1,0
4,426,426,33,17,16,2,1
7,477,477,6,6,0,1,0

7,113,113,5,5,0,1,0
0,144,144,1,1,0,1,0
6,222,222,9,2,7,3,2
5,232,232,5,5,0,1,0
3,249,249,26,26,0,1,0
1,281,281,2,2,0,1,0
4,318,318,20,7,13,2,1
10,429,429,78,57,21,4,3
2,443,443,9,2,7,2,1
9,446,446,32,10,22,2,1
8,447,447,22,22,0,1,0

6,124,124,8,8,0,1,0
0,158,158,1,1,0,1,0
4,340,340,15,15,0,1,0
3,384,384,67,7,60,4,3
2,385,385,22,22,0,1,0
1,388,388,8,8,0,1,0
7,415,415,70,70,0,1,0
5,452,452,34,4,30,4,3

2,154,154,11,11,0,1,0
4,201,201,6,6,0,1,0
1,223,223,29,20,9,2,1
0,441,441,44,44,0,1,0
5,451,451,28,2,26,2,1
3,497,497,107,19,88,3,2

0,132,132,14,14,0,1,0
3,190,190,14,10,4,2,1
6,201,201,35,35,0,1,0
1,253,253,29,18,11,2,1
2,280,280,3,3,0,1,0
4,436,436,6,6,0,1,0
5,496,496,57,24,33,4,3

2,126,126,7,7,0,1,0
6,180,180,20,20,0,1,0
5,184,184,15,1,14,3,2
1,221,221,7,1,6,3,2
7,376,376,43,7,36,4,3
3,384,384,43,43,0,1,0
0,475,475,26,26,0,1,0
4,480,480,23,23,0,1,0

5,119,119,15,15,0,1,0
4,324,324,11,11,0,1,0
3,371,371,67,67,0,1,0
1,379,379,39,27,12,2,1
0,434,434,1,1,0,1,0
2,443,443,7,7,0,1,0
6,445,445,63,63,0,1,0

3,103,103,4,4,0,1,0
0,166,166,30,3,27,4,3
6,207,207,7,7,0,1,0
1,218,218,15,15,0,1,0
2,253,253,4,4,0,1,0
4,407,407,74,74,0,1,0
5,417,417,37,37,0,1,0

0,140,140,5,5,0,1,0
5,144,144,2,2,0,1,0
6,175,175,1,1,0,1,0
4,194,194,1,1,0,1,0
8,207,207,28,28,0,1,0
7,243,243,26,26,0,1,0
9,308,308,26,6,20,3,2
3,439,439,8,8,0,1,0
2,446,446,50,12,38,3,2
1,450,450,1,1,0,1,0
10,483,483,42,42,0,1,0

4,166,166,22,12,10,3,2
3,192,192,16,8,8,2,1
1,204,204,20,8,12,4,3
5,276,276,37,37,0,1,0
2,289,289,16,16,0,1,0
0,292,292,19,10,9,4,3
6,402,402,17,17,0,1,0

0,163,163,5,5,0,1,0
4,255,255,70,22,48,4,3
1,258,258,28,17,11,2,1
3,321,321,7,7,0,1,0
5,382,382,4,1,3,2,1
2,409,409,66,66,0,1,0

2,151,151,4,1,3,2,1
4,267,267,55,19,36,3,2
1,345,345,94,73,21,4,3
0,348,348,10,10,0,1,0
3,374,374,27,27,0,1,0

10,129,129,9,9,0,1,0
8,203,203,14,14,0,1,0
4,212,212,24,4,20,3,2
1,228,228,3,3,0,1,0
6,287,287,12,7,5,2,1
0,297,297,3,3,0,1,0
9,386,386,65,18,47,2,1
3,393,393,7,7,0,1,0
7,394,394,1,1,0,1,0
5,411,411,21,21,0,1,0
2,483,483,25,7,18,3,2

2,186,186,1,1,0,1,0
6,226,226,2,2,0,1,0
1,324,324,45,45,0,1,0
0,351,351,26,2,24,4,3
7,402,402,71,40,31,2,1
4,426,426,28,14,14,3,2
3,446,446,8,8,0,1,0
5,463,463,55,55,0,1,0

6,148,148,15,7,8,2,1
1,230,230,3,3,0,1,0
3,258,258,67,67,0,1,0
5,267,267,26,26,0,1,0
4,304,304,33,25,8,2,1
0,332,332,8,8,0,1,0
2,380,380,2,2,0,1,0

0,186,186,3,3,0,1,0
6,323,323,40,40,0,1,0
3,338,338,53,29,24,2,1
5,344,344,7,7,0,1,0
1,365,365,39,36,3,2,1
4,418,418,8,5,3,2,1
2,477,477,1,1,0,1,0
7,499,499,81,1,80,3,2

5,142,142,5,5,0,1,0
0,173,173,14,14,0,1,0
4,206,206,30,30,0,1,0
2,272,272,25,3,22,3,2
6,379,379,47,27,20,2,1
1,449,449,57,7,50,3,2
3,460,460,1,1,0,1,0

1,102,102,6,6,0,1,0
4,323,323,4,4,0,1,0
2,360,360,41,20,21,4,3
3,386,386,68,23,45,2,1
0,393,393,97,80,17,2,1

0,187,187,25,6,19,4,3
4,298,298,12,12,0,1,0
3,419,419,64,37,27,2,1
2,445,445,49,49,0,1,0
1,466,466,78,42,36,4,3

3,132,132,5,5,0,1,0
0,216,216,42,20,22,4,3
1,311,311,33,33,0,1,0
4,391,391,38,31,7,2,1
2,436,436,74,14,60,4,3

0,211,211,55,35,20,3,2
1,228,228,3,3,0,1,0
3,238,238,33,33,0,1,0
4,368,368,46,46,0,1,0
2,375,375,10,10,0,1,0
5,378,378,16,8,8,2,1

1,184,184,2,2,0,1,0
3,215,215,18,18,0,1,0
7,233,233,39,31,8,2,1
2,288,288,42,8,34,4,3
6,384,384,5,1,4,2,1
0,385,385,20,20,0,1,0
5,444,444,56,1,55,3,2
4,452,452,4,4,0,1,0

1,110,110,3,3,0,1,0
0,121,121,31,13,18,4,3
4,200,200,33,33,0,1,0
5,231,231,17,17,0,1,0
3,371,371,26,26,0,1,0
2,481,481,8,1,7,2,1

6,191,191,23,23,0,1,0
5,223,223,18,5,13,2,1
7,322,322,34,24,10,3,2
2,330,330,7,3,4,2,1
3,341,341,14,7,7,2,1
1,391,391,42,13,29,4,3
0,394,394,22,6,16,2,1
4,394,394,30,30,0,1,0

0,108,108,7,7,0,1,0
5,212,212,27,2,25,2,1
3,249,249,23,11,12,4,3
1,317,317,3,3,0,1,0
4,331,331,8,8,0,1,0
6,403,403,19,6,13,3,2
2,410,410,45,45,0,1,0
7,487,487,64,50,14,4,3

0,161,161,4,4,0,1,0
1,165,165,46,46,0,1,0
3,337,337,14,2,12,4,3
2,369,369,46,46,0,1,0
4,480,480,67,67,0,1,0

3,204,204,34,34,0,1,0
6,214,214,28,28,0,1,0
5,234,234,21,11,10,2,1
2,356,356,1,1,0,1,0
1,361,361,3,3,0,1,0
0,374,374,46,12,34,3,2
4,437,437,37,37,0,1,0

2,136,136,15,15,0,1,0
0,205,205,36,36,0,1,0
3,271,271,37,16,21,2,1
4,281,281,17,7,10,3,2
1,352,352,44,44,0,1,0

5,121,121,27,6,21,4,3
2,136,136,19,4,15,4,3
6,162,162,10,3,7,2,1
0,261,261,12,12,0,1,0
3,327,327,27,1,26,3,2
7,376,376,9,9,0,1,0
4,449,449,14,14,0,1,0
1,474,474,1,1,0,1,0

5,135,135,26,6,20,2,1
1,148,148,17,17,0,1,0
6,268,268,6,3,3,2,1
2,285,285,37,37,0,1,0
0,346,346,16,16,0,1,0
3,437,437,4,4,0,1,0
4,457,457,42,42,0,1,0

7,294,294,34,22,12,4,3
0,323,323,9,1,8,2,1
1,384,384,12,12,0,1,0
6,397,397,74,44,30,4,3
2,408,408,50,41,9,4,3
5,433,433,2,2,0,1,0
4,443,443,15,15,0,1,0
8,451,451,1,1,0,1,0
3,475,475,38,15,23,2,1

4,111,111,1,1,0,1,0
1,284,284,66,66,0,1,0
0,286,286,4,4,0,1,0
5,463,463,110,53,57,4,3
3,474,474,26,12,14,2,1
2,500,500,27,27,0,1,0

7,102,102,5,5,0,1,0
0,149,149,2,2,0,1,0
9,160,160,40,25,15,4,3
8,222,222,3,3,0,1,0
4,356,356,20,20,0,1,0
6,357,357,10,1,9,2,1
3,385,385,8,1,7,2,1
1,388,388,34,10,24,4,3
5,447,447,1,1,0,1,0
2,498,498,46,2,44,2,1

0,148,148,32,32,0,1,0
1,263,263,7,3,4,2,1
4,274,274,42,21,21,2,1
5,398,398,49,33,16,2,1
3,418,418,12,5,7,2,1
2,442,442,26,26,0,1,0

4,179,179,5,5,0,1,0
6,249,249,21,10,11,2,1
0,305,305,6,6,0,1,0
1,368,368,42,42,0,1,0
2,383,383,29,13,16,2,1
7,431,431,84,4,80,3,2
3,448,448,30,30,0,1,0
5,494,494,12,12,0,1,0

4,234,234,1,1,0,1,0
0,277,277,5,5,0,1,0
6,293,293,31,12,19,3,2
1,332,332,4,4,0,1,0
2,338,338,31,19,12,2,1
3,361,361,32,20,12,3,2
8,409,409,68,68,0,1,0
7,480,480,16,3,13,2,1
5,497,497,43,43,0,1,0

7,129,129,4,1,3,2,1
6,169,169,45,20,25,2,1
4,200,200,18,8,10,2,1
1,205,205,5,5,0,1,0
0,319,319,3,3,0,1,0
8,353,353,4,4,0,1,0
2,362,362,2,2,0,1,0
3,410,410,50,41,9,2,1
5,419,419,21,18,3,2,1

2,144,144,28,16,12,4,3
1,195,195,2,2,0,1,0
0,244,244,24,24,0,1,0
3,340,340,33,29,4,2,1
4,402,402,22,14,8,2,1
5,462,462,71,26,45,4,3

4,144,144,14,14,0,1,0
7,179,179,14,14,0,1,0
1,203,203,2,2,0,1,0
6,300,300,7,7,0,1,0
5,337,337,68,23,45,4,3
3,451,451,34,34,0,1,0
0,478,478,22,22,0,1,0
2,500,500,36,36,0,1,0

1,126,126,17,11,6,3,2
0,133,133,19,5,14,2,1
2,346,346,8,8,0,1,0
3,389,389,64,37,27,4,3
4,457,457,62,46,16,2,1
5,499,499,2,2,0,1,0

7,132,132,9,6,3,2,1
2,209,209,17,17,0,1,0
6,246,246,20,11,9,4,3
4,283,283,17,17,0,1,0
1,408,408,49,49,0,1,0
5,451,451,71,71,0,1,0
0,460,460,14,4,10,2,1
3,494,494,4,4,0,1,0

0,127,127,35,20,15,2,1
3,152,152,1,1,0,1,0
5,311,311,87,87,0,1,0
2,388,388,2,2,0,1,0
4,439,439,8,8,0,1,0
1,440,440,9,9,0,1,0

0,111,111,8,8,0,1,0
1,157,157,2,2,0,1,0
6,354,354,86,86,0,1,0
3,362,362,22,22,0,1,0
2,419,419,65,32,33,3,2
4,451,451,3,3,0,1,0
5,458,458,25,25,0,1,0

4,154,154,1,1,0,1,0
3,164,164,9,3,6,3,2
2,241,241,59,59,0,1,0
0,384,384,106,106,0,1,0
1,452,452,11,11,0,1,0

1,212,212,5,1,4,2,1
3,229,229,30,30,0,1,0
2,295,295,77,20,57,3,2
0,324,324,6,6,0,1,0
5,401,401,27,9,18,4,3
4,412,412,44,26,18,3,2

1,131,131,1,1,0,1,0
7,145,145,27,3,24,3,2
5,193,193,17,7,10,3,2
4,341,341,60,32,28,3,2
2,362,362,6,6,0,1,0
0,385,385,23,23,0,1,0
3,445,445,19,3,16,3,2
6,495,495,17,17,0,1,0

1,135,135,5,5,0,1,0
3,141,141,21,21,0,1,0
5,157,157,1,1,0,1,0
0,241,241,30,30,0,1,0
4,304,304,48,2,46,3,2
2,315,315,44,11,33,3,2

6,168,168,24,24,0,1,0
7,197,197,6,6,0,1,0
4,201,201,11,11,0,1,0
3,235,235,41,26,15,2,1
1,242,242,10,10,0,1,0
2,363,363,8,5,3,2,1
0,397,397,3,3,0,1,0
5,412,412,56,56,0,1,0

5,122,122,7,7,0,1,0
3,152,152,27,27,0,1,0
1,226,226,37,10,27,3,2
2,331,331,12,12,0,1,0
4,403,403,29,4,25,2,1
0,439,439,44,14,30,4,3

0,148,148,15,15,0,1,0
5,159,159,3,3,0,1,0
3,192,192,20,20,0,1,0
1,197,197,17,17,0,1,0
2,220,220,2,2,0,1,0
4,272,272,31,31,0,1,0
6,404,404,70,70,0,1,0

4,192,192,2,2,0,1,0
2,257,257,67,67,0,1,0
1,320,320,94,37,57,4,3
0,337,337,3,3,0,1,0
3,346,346,11,11,0,1,0

5,190,190,3,3,0,1,0
0,229,229,1,1,0,1,0
2,314,314,1,1,0,1,0
6,342,342,19,9,10,3,2
3,346,346,12,6,6,3,2
7,347,347,80,8,72,3,2
1,379,379,39,39,0,1,0
4,412,412,64,64,0,1,0

5,172,172,16,5,11,2,1
1,200,200,30,6,24,3,2
2,254,254,25,1,24,3,2
6,347,347,68,4,64,3,2
4,354,354,6,6,0,1,0
0,479,479,9,9,0,1,0
3,495,495,17,11,6,2,1

6,127,127,12,12,0,1,0
3,131,131,1,1,0,1,0
0,153,153,7,7,0,1,0
5,215,215,8,8,0,1,0
7,220,220,17,17,0,1,0
2,238,238,31,13,18,2,1
8,384,384,50,50,0,1,0
4,393,393,29,29,0,1,0
1,430,430,3,3,0,1,0

5,151,151,15,15,0,1,0
1,226,226,30,20,10,3,2
3,258,258,5,5,0,1,0
0,259,259,28,28,0,1,0
4,309,309,33,33,0,1,0
2,328,328,14,1,13,2,1
6,348,348,34,34,0,1,0

2,200,200,24,1,23,2,1
3,218,218,13,13,0,1,0
0,224,224,32,8,24,4,3
4,320,320,40,40,0,1,0
1,427,427,68,28,40,3,2

6,170,170,14,14,0,1,0
3,182,182,13,13,0,1,0
4,271,271,31,13,18,2,1
5,294,294,33,13,20,2,1
0,384,384,28,28,0,1,0
2,411,411,29,29,0,1,0
1,414,414,37,37,0,1,0

0,108,108,3,3,0,1,0
1,165,165,7,7,0,1,0
7,192,192,18,6,12,3,2
4,222,222,43,43,0,1,0
8,314,314,27,27,0,1,0
5,374,374,5,1,4,2,1
6,378,378,48,48,0,1,0
2,386,386,3,3,0,1,0
3,450,450,7,7,0,1,0

5,136,136,20,2,18,3,2
6,191,191,9,9,0,1,0
3,207,207,35,35,0,1,0
2,299,299,34,13,21,4,3
1,313,313,3,3,0,1,0
4,350,350,40,40,0,1,0
0,370,370,3,3,0,1,0

3,142,142,3,3,0,1,0
2,143,143,1,1,0,1,0
0,160,160,3,3,0,1,0
9,238,238,21,15,6,3,2
4,283,283,25,11,14,2,1
10,336,336,69,26,43,2,1
7,351,351,7,7,0,1,0
6,366,366,1,1,0,1,0
8,386,386,4,1,3,2,1
1,485,485,66,66,0,1,0
5,492,492,3,3,0,1,0

0,113,113,23,23,0,1,0
3,116,116,1,1,0,1,0
6,147,147,22,10,12,4,3
4,217,217,21,4,17,2,1
1,245,245,1,1,0,1,0
5,305,305,19,19,0,1,0
2,315,315,27,7,20,3,2

0,112,112,16,12,4,2,1
5,132,132,10,10,0,1,0
4,184,184,3,3,0,1,0
2,235,235,24,11,13,2,1
1,356,356,21,3,18,2,1
3,437,437,94,25,69,4,3

3,164,164,17,8,9,4,3
0,177,177,54,54,0,1,0
1,212,212,36,36,0,1,0
2,226,226,8,5,3,2,1

3,262,262,65,21,44,2,1
2,288,288,6,6,0,1,0
0,315,315,79,79,0,1,0
4,316,316,12,12,0,1,0
1,324,324,16,16,0,1,0

6,152,152,18,9,9,4,3
2,173,173,1,1,0,1,0
3,212,212,30,12,18,4,3
0,309,309,36,11,25,2,1
1,379,379,7,7,0,1,0
5,432,432,55,55,0,1,0
7,447,447,27,27,0,1,0
4,498,498,9,3,6,3,2

5,200,200,1,1,0,1,0
0,274,274,33,33,0,1,0
3,361,361,30,5,25,3,2
4,385,385,34,18,16,3,2
2,431,431,17,5,12,3,2
6,436,436,92,36,56,3,2
1,494,494,29,29,0,1,0

4,221,221,1,1,0,1,0
3,251,251,65,20,45,2,1
5,314,314,12,3,9,4,3
1,409,409,5,5,0,1,0
0,413,413,29,29,0,1,0
2,478,478,104,44,60,3,2

7,119,119,1,1,0,1,0
4,267,267,9,9,0,1,0
2,290,290,33,24,9,4,3
1,307,307,25,25,0,1,0
6,311,311,31,1,30,4,3
3,369,369,21,21,0,1,0
0,377,377,6,2,4,2,1
5,378,378,75,21,54,3,2

8,105,105,12,12,0,1,0
5,156,156,16,10,6,3,2
0,160,160,1,1,0,1,0
1,224,224,2,2,0,1,0
6,274,274,19,3,16,3,2
4,447,447,18,18,0,1,0
2,454,454,31,31,0,1,0
7,474,474,60,60,0,1,0
3,496,496,38,38,0,1,0

4,161,161,2,2,0,1,0
5,251,251,65,29,36,4,3
3,253,253,9,9,0,1,0
0,330,330,29,17,12,4,3
2,351,351,35,23,12,3,2
1,367,367,42,37,5,2,1

3,137,137,35,35,0,1,0
4,234,234,12,12,0,1,0
2,237,237,31,31,0,1,0
5,344,344,1,1,0,1,0
0,403,403,6,3,3,2,1
1,473,473,73,34,39,4,3

1,108,108,8,8,0,1,0
3,136,136,9,9,0,1,0
5,235,235,17,17,0,1,0
6,237,237,24,12,12,2,1
7,293,293,38,13,25,2,1
2,295,295,27,6,21,4,3
4,300,300,19,3,16,3,2
0,309,309,2,2,0,1,0

4,176,176,34,34,0,1,0
2,211,211,6,1,5,2,1
6,235,235,17,17,0,1,0
0,267,267,16,16,0,1,0
5,293,293,12,12,0,1,0
3,334,334,61,31,30,4,3
1,363,363,11,11,0,1,0

2,166,166,16,16,0,1,0
1,261,261,17,1,16,2,1
4,409,409,3,3,0,1,0
3,471,471,95,95,0,1,0
0,495,495,117,30,87,4,3

1,124,124,15,6,9,4,3
3,132,132,15,6,9,4,3
0,140,140,1,1,0,1,0
5,142,142,17,10,7,2,1
4,277,277,3,3,0,1,0
2,333,333,20,20,0,1,0
6,499,499,87,16,71,4,3

3,293,293,71,71,0,1,0
4,299,299,9,9,0,1,0
0,326,326,91,65,26,2,1
2,376,376,12,12,0,1,0
1,494,494,11,11,0,1,0

1,127,127,23,4,19,2,1
2,310,310,37,37,0,1,0
4,430,430,41,8,33,2,1
0,453,453,54,46,8,3,2
3,470,470,43,43,0,1,0

8,203,203,27,27,0,1,0
4,252,252,3,3,0,1,0
1,297,297,43,43,0,1,0
10,342,342,49,49,0,1,0
5,361,361,2,2,0,1,0
2,375,375,3,3,0,1,0
0,386,386,8,8,0,1,0
3,386,386,16,16,0,1,0
7,421,421,23,23,0,1,0
9,440,440,13,6,7,2,1
6,498,498,7,7,0,1,0

6,131,131,13,13,0,1,0
2,186,186,5,5,0,1,0
4,260,260,9,9,0,1,0
1,355,355,17,17,0,1,0
0,410,410,21,14,7,2,1
3,443,443,78,26,52,3,2
5,450,450,77,13,64,3,2

3,178,178,22,11,11,2,1
1,323,323,26,26,0,1,0
2,419,419,67,67,0,1,0
5,442,442,17,17,0,1,0
0,453,453,27,11,16,3,2
4,496,496,71,57,14,2,1

3,115,115,11,11,0,1,0
0,208,208,20,8,12,3,2
7,230,230,38,6,32,2,1
5,250,250,8,2,6,2,1
1,316,316,4,1,3,2,1
6,337,337,36,12,24,4,3
4,419,419,35,3,32,2,1
2,474,474,6,3,3,2,1

7,118,118,22,5,17,3,2
8,211,211,18,18,0,1,0
6,234,234,22,22,0,1,0
9,260,260,11,5,6,2,1
2,321,321,5,5,0,1,0
4,365,365,1,1,0,1,0
0,378,378,6,6,0,1,0
3,396,396,22,22,0,1,0
5,452,452,6,2,4,2,1
1,468,468,49,13,36,3,2

5,100,100,1,1,0,1,0
1,113,113,13,13,0,1,0
8,119,119,21,21,0,1,0
3,245,245,6,6,0,1,0
6,285,285,22,4,18,3,2
7,364,364,43,7,36,4,3
9,372,372,4,4,0,1,0
0,436,436,15,1,14,3,2
4,454,454,16,16,0,1,0
2,456,456,2,2,0,1,0

5,112,112,26,26,0,1,0
6,123,123,4,4,0,1,0
3,213,213,10,7,3,2,1
1,277,277,20,2,18,2,1
4,447,447,21,1,20,2,1
2,463,463,37,37,0,1,0
0,490,490,50,18,32,3,2

0,171,171,6,6,0,1,0
5,210,210,29,7,22,2,1
2,384,384,28,28,0,1,0
4,388,388,32,1,31,2,1
1,390,390,73,73,0,1,0
6,450,450,38,4,34,2,1
3,458,458,3,3,0,1,0

0,116,116,12,8,4,2,1
9,206,206,7,3,4,2,1
5,221,221,2,2,0,1,0
8,275,275,44,44,0,1,0
1,292,292,2,2,0,1,0
2,312,312,24,24,0,1,0
3,312,312,13,1,12,2,1
7,420,420,48,34,14,3,2
6,453,453,10,10,0,1,0
4,476,476,20,1,19,2,1

6,113,113,2,2,0,1,0
1,122,122,8,8,0,1,0
4,177,177,3,3,0,1,0
5,261,261,18,18,0,1,0
2,278,278,28,28,0,1,0
7,279,279,71,37,34,2,1
8,280,280,12,12,0,1,0
9,353,353,3,3,0,1,0
3,473,473,3,3,0,1,0
0,497,497,15,15,0,1,0

2,176,176,3,3,0,1,0
4,189,189,3,3,0,1,0
3,245,245,67,32,35,2,1
1,357,357,3,3,0,1,0
0,480,480,141,9,132,4,3

0,163,163,21,21,0,1,0
1,255,255,32,32,0,1,0
4,319,319,66,26,40,2,1
2,391,391,18,8,10,2,1
5,439,439,12,5,7,2,1
3,460,460,32,32,0,1,0

1,112,112,2,2,0,1,0
6,152,152,29,11,18,3,2
2,191,191,1,1,0,1,0
3,260,260,53,12,41,2,1
0,279,279,1,1,0,1,0
4,287,287,20,20,0,1,0
7,390,390,43,8,35,4,3
5,464,464,2,2,0,1,0

0,107,107,4,4,0,1,0
4,168,168,4,4,0,1,0
6,181,181,45,45,0,1,0
3,197,197,3,3,0,1,0
8,334,334,2,2,0,1,0
1,396,396,13,4,9,2,1
5,445,445,84,14,70,3,2
7,473,473,26,7,19,2,1
2,488,488,1,1,0,1,0

2,107,107,22,6,16,2,1
5,143,143,14,14,0,1,0
1,171,171,7,1,6,3,2
4,185,185,14,14,0,1,0
6,186,186,25,25,0,1,0
0,241,241,6,6,0,1,0
3,461,461,14,14,0,1,0

0,127,127,11,5,6,3,2
6,239,239,4,4,0,1,0
4,242,242,66,66,0,1,0
2,290,290,39,39,0,1,0
5,292,292,4,4,0,1,0
3,306,306,15,6,9,4,3
1,497,497,16,16,0,1,0

3,142,142,16,1,15,2,1
5,267,267,22,11,11,2,1
0,340,340,6,6,0,1,0
2,346,346,66,8,58,3,2
4,355,355,39,31,8,3,2
1,382,382,36,36,0,1,0

3,109,109,11,11,0,1,0
6,161,161,21,13,8,3,2
5,162,162,1,1,0,1,0
7,201,201,18,18,0,1,0
1,307,307,4,1,3,2,1
4,340,340,41,28,13,2,1
8,380,380,33,9,24,4,3
2,431,431,3,3,0,1,0
0,469,469,27,19,8,3,2

3,140,140,18,6,12,2,1
1,265,265,42,21,21,4,3
2,348,348,34,1,33,4,3
0,387,387,56,10,46,3,2
4,485,485,37,37,0,1,0

3,202,202,15,15,0,1,0
4,266,266,22,4,18,4,3
0,328,328,69,27,42,3,2
5,328,328,49,49,0,1,0
1,398,398,25,25,0,1,0
2,480,480,13,6,7,2,1

1,109,109,13,9,4,2,1
4,210,210,35,35,0,1,0
3,239,239,6,6,0,1,0
2,383,383,45,32,13,4,3
0,385,385,70,40,30,2,1

5,140,140,11,11,0,1,0
0,246,246,18,18,0,1,0
3,261,261,11,4,7,2,1
1,276,276,4,4,0,1,0
6,428,428,50,50,0,1,0
2,429,429,74,31,43,2,1
4,491,491,54,54,0,1,0

1,243,243,51,35,16,2,1
0,245,245,23,2,21,4,3
2,310,310,31,31,0,1,0
3,382,382,74,74,0,1,0
4,434,434,4,1,3,2,1

1,150,150,2,2,0,1,0
9,185,185,18,4,14,2,1
4,199,199,17,17,0,1,0
7,213,213,30,4,26,3,2
0,364,364,29,29,0,1,0
5,376,376,32,4,28,3,2
6,376,376,5,5,0,1,0
2,381,381,8,3,5,2,1
3,457,457,1,1,0,1,0
8,495,495,32,2,30,3,2

1,135,135,26,26,0,1,0
2,231,231,6,6,0,1,0
0,301,301,34,6,28,3,2
4,430,430,22,22,0,1,0
3,474,474,108,48,60,4,3

3,275,275,1,1,0,1,0
6,277,277,14,8,6,2,1
5,373,373,74,50,24,4,3
0,422,422,14,14,0,1,0
4,466,466,26,7,19,2,1
2,484,484,52,4,48,3,2
1,488,488,77,47,30,3,2

3,206,206,37,37,0,1,0
2,407,407,31,4,27,2,1
1,436,436,43,11,32,3,2
0,439,439,56,56,0,1,0
4,446,446,21,16,5,2,1
5,479,479,37,37,0,1,0

0,130,130,40,22,18,4,3
1,176,176,9,9,0,1,0
2,300,300,30,3,27,4,3
3,468,468,71,38,33,2,1

3,110,110,10,10,0,1,0
5,166,166,9,9,0,1,0
6,327,327,45,45,0,1,0
1,336,336,44,44,0,1,0
4,353,353,40,7,33,2,1
2,396,396,29,14,15,2,1
0,463,463,5,5,0,1,0

1,162,162,14,11,3,2,1
2,198,198,17,5,12,4,3
3,221,221,2,2,0,1,0
4,280,280,20,20,0,1,0
0,302,302,36,36,0,1,0
5,392,392,89,38,51,4,3
6,499,499,3,3,0,1,0

8,109,109,5,5,0,1,0
0,123,123,6,1,5,2,1
9,231,231,59,59,0,1,0
7,258,258,2,2,0,1,0
6,356,356,9,1,8,3,2
4,367,367,2,2,0,1,0
5,404,404,5,5,0,1,0
2,424,424,17,17,0,1,0
3,475,475,35,2,33,4,3
1,490,490,47,36,11,2,1

6,132,132,9,9,0,1,0
8,149,149,2,2,0,1,0
9,214,214,23,7,16,2,1
2,229,229,18,18,0,1,0
10,251,251,30,18,12,3,2
5,271,271,10,10,0,1,0
3,304,304,6,6,0,1,0
4,338,338,1,1,0,1,0
0,339,339,10,10,0,1,0
1,384,384,19,10,9,4,3
11,384,384,31,31,0,1,0
7,435,435,3,3,0,1,0

2,185,185,11,1,10,3,2
0,255,255,77,33,44,4,3
3,270,270,25,7,18,2,1
1,318,318,49,43,6,3,2

7,129,129,28,23,5,2,1
3,145,145,8,8,0,1,0
2,146,146,1,1,0,1,0
6,183,183,11,1,10,3,2
1,240,240,35,16,19,2,1
5,255,255,8,8,0,1,0
4,366,366,29,20,9,4,3
0,392,392,6,6,0,1,0

9,107,107,3,3,0,1,0
3,135,135,11,2,9,2,1
6,165,165,2,2,0,1,0
7,192,192,3,3,0,1,0
4,203,203,1,1,0,1,0
12,254,254,35,35,0,1,0
11,268,268,13,10,3,2,1
0,288,288,27,27,0,1,0
10,292,292,35,35,0,1,0
1,350,350,8,8,0,1,0
5,385,385,15,6,9,2,1
8,411,411,1,1,0,1,0
2,437,437,3,3,0,1,0

2,107,107,26,13,13,2,1
4,206,206,1,1,0,1,0
1,310,310,13,13,0,1,0
0,317,317,7,7,0,1,0
5,446,446,113,35,78,3,2
3,498,498,23,11,12,4,3

1,100,100,15,2,13,2,1
6,346,346,78,78,0,1,0
4,395,395,34,34,0,1,0
0,431,431,6,6,0,1,0
7,446,446,4,1,3,2,1
2,471,471,21,21,0,1,0
5,479,479,33,21,12,4,3
3,483,483,3,3,0,1,0

5,159,159,34,34,0,1,0
2,167,167,40,40,0,1,0
0,172,172,2,2,0,1,0
4,325,325,16,9,7,2,1
3,427,427,19,19,0,1,0
1,488,488,25,25,0,1,0

1,146,146,3,3,0,1,0
3,165,165,33,16,17,2,1
2,290,290,31,2,29,2,1
5,316,316,12,4,8,3,2
0,456,456,79,23,56,4,3
4,500,500,34,2,32,2,1

3,113,113,9,9,0,1,0
6,218,218,22,16,6,3,2
2,274,274,28,8,20,2,1
1,276,276,31,31,0,1,0
5,359,359,47,47,0,1,0
4,439,439,33,12,21,4,3
0,482,482,6,2,4,2,1

4,120,120,13,13,0,1,0
6,212,212,16,16,0,1,0
3,224,224,23,7,16,2,1
2,255,255,27,5,22,3,2
1,375,375,10,1,9,2,1
5,395,395,48,8,40,3,2
0,492,492,32,5,27,4,3

1,115,115,14,14,0,1,0
2,115,115,14,2,12,3,2
5,417,417,27,27,0,1,0
4,426,426,100,1,99,4,3
3,455,455,1,1,0,1,0
0,484,484,30,4,26,3,2

2,117,117,12,3,9,4,3
9,157,157,33,27,6,2,1
8,163,163,16,16,0,1,0
6,225,225,9,9,0,1,0
7,258,258,1,1,0,1,0
4,272,272,1,1,0,1,0
5,298,298,16,4,12,3,2
0,305,305,25,13,12,4,3
1,318,318,5,5,0,1,0
3,328,328,1,1,0,1,0

2,110,110,21,11,10,2,1
1,149,149,10,10,0,1,0
5,155,155,15,15,0,1,0
0,339,339,15,3,12,2,1
3,404,404,42,42,0,1,0
4,479,479,51,51,0,1,0

6,106,106,1,1,0,1,0
4,108,108,20,2,18,4,3
0,207,207,6,6,0,1,0
5,221,221,27,27,0,1,0
3,224,224,23,15,8,2,1
2,405,405,54,26,28,3,2
1,485,485,17,12,5,2,1

2,132,132,2,2,0,1,0
4,155,155,32,32,0,1,0
0,231,231,41,1,40,2,1
3,232,232,9,6,3,2,1
1,272,272,30,30,0,1,0
5,275,275,17,17,0,1,0

4,159,159,8,8,0,1,0
1,169,169,10,10,0,1,0
3,316,316,55,37,18,3,2
2,328,328,27,27,0,1,0
0,431,431,104,104,0,1,0

1,142,142,33,12,21,2,1
0,184,184,13,9,4,2,1
4,255,255,42,3,39,2,1
3,259,259,7,7,0,1,0
2,449,449,50,5,45,4,3

4,115,115,14,5,9,3,2
0,161,161,5,5,0,1,0
2,189,189,46,46,0,1,0
3,191,191,3,3,0,1,0
5,348,348,60,60,0,1,0
1,381,381,11,11,0,1,0

5,115,115,11,2,9,2,1
0,200,200,13,13,0,1,0
1,243,243,16,16,0,1,0
6,284,284,10,10,0,1,0
2,345,345,22,10,12,4,3
3,348,348,1,1,0,1,0
7,366,366,65,52,13,2,1
4,420,420,44,5,39,2,1

4,129,129,6,6,0,1,0
3,188,188,14,2,12,2,1
5,259,259,68,53,15,4,3
0,261,261,30,30,0,1,0
1,268,268,10,10,0,1,0
2,341,341,11,11,0,1,0
7,459,459,14,14,0,1,0
6,485,485,4,4,0,1,0

0,143,143,43,43,0,1,0
1,276,276,60,60,0,1,0
2,360,360,4,1,3,2,1
3,387,387,30,23,7,2,1

3,216,216,16,7,9,4,3
1,239,239,37,16,21,2,1
4,365,365,27,27,0,1,0
5,444,444,71,62,9,4,3
2,461,461,35,5,30,2,1
0,478,478,34,17,17,3,2

0,133,133,19,19,0,1,0
3,171,171,6,6,0,1,0
1,296,296,13,8,5,2,1
5,369,369,53,38,15,4,3
4,386,386,49,49,0,1,0
2,465,465,53,41,12,4,3

2,111,111,18,18,0,1,0
1,143,143,1,1,0,1,0
0,340,340,100,100,0,1,0
4,436,436,24,11,13,2,1
3,443,443,41,17,24,3,2

2,151,151,4,4,0,1,0
0,171,171,28,14,14,3,2
3,186,186,32,26,6,3,2
1,191,191,21,17,4,2,1
4,194,194,22,22,0,1,0
5,215,215,5,5,0,1,0

3,112,112,13,13,0,1,0
0,147,147,21,21,0,1,0
5,197,197,37,37,0,1,0
2,263,263,28,4,24,2,1
1,377,377,20,10,10,2,1
4,416,416,4,4,0,1,0

4,137,137,11,11,0,1,0
5,169,169,36,16,20,2,1
1,206,206,21,21,0,1,0
0,260,260,30,18,12,4,3
2,283,283,10,10,0,1,0
6,311,311,4,1,3,2,1
3,490,490,24,3,21,2,1

3,102,102,17,17,0,1,0
2,199,199,11,11,0,1,0
0,277,277,38,29,9,2,1
4,420,420,37,37,0,1,0
1,423,423,69,69,0,1,0

4,201,201,13,1,12,2,1
1,224,224,5,5,0,1,0
2,227,227,37,37,0,1,0
3,458,458,35,8,27,4,3
0,484,484,136,104,32,3,2

0,122,122,3,3,0,1,0
4,160,160,1,1,0,1,0
5,325,325,39,3,36,3,2
3,384,384,68,38,30,3,2
2,418,418,114,24,90,4,3
1,479,479,2,2,0,1,0

3,102,102,4,4,0,1,0
0,335,335,10,10,0,1,0
4,356,356,44,44,0,1,0
2,397,397,57,25,32,3,2
1,403,403,109,109,0,1,0

6,116,116,12,12,0,1,0
5,153,153,4,4,0,1,0
0,156,156,11,3,8,2,1
4,339,339,63,63,0,1,0
3,411,411,8,1,7,2,1
2,438,438,92,92,0,1,0
1,446,446,1,1,0,1,0

2,205,205,50,50,0,1,0
0,342,342,60,60,0,1,0
1,342,342,43,16,27,2,1
3,397,397,20,20,0,1,0
4,489,489,5,2,3,2,1

1,120,120,22,7,15,2,1
6,137,137,18,18,0,1,0
3,217,217,4,4,0,1,0
2,387,387,19,8,11,4,3
4,444,444,28,8,20,2,1
5,461,461,51,51,0,1,0
0,479,479,25,25,0,1,0

5,125,125,13,13,0,1,0
4,205,205,13,3,10,2,1
0,237,237,24,24,0,1,0
2,360,360,24,24,0,1,0
6,431,431,60,60,0,1,0
1,443,443,46,13,33,4,3
3,481,481,14,14,0,1,0

4,131,131,34,24,10,3,2
0,166,166,2,2,0,1,0
2,286,286,48,48,0,1,0
1,290,290,28,28,0,1,0
3,417,417,10,5,5,2,1
5,470,470,20,12,8,2,1
6,489,489,2,2,0,1,0

5,154,154,24,12,12,3,2
1,206,206,37,14,23,2,1
4,346,346,19,19,0,1,0
6,348,348,33,1,32,3,2
3,354,354,22,22,0,1,0
0,376,376,17,17,0,1,0
2,460,460,7,2,5,2,1

6,121,121,33,33,0,1,0
5,130,130,3,3,0,1,0
7,146,146,3,3,0,1,0
4,236,236,18,9,9,2,1
0,333,333,20,20,0,1,0
1,449,449,1,1,0,1,0
3,453,453,21,6,15,4,3
2,455,455,53,53,0,1,0

8,100,100,3,3,0,1,0
7,125,125,7,7,0,1,0
2,144,144,13,13,0,1,0
1,160,160,1,1,0,1,0
3,181,181,9,1,8,3,2
6,246,246,1,1,0,1,0
9,342,342,20,7,13,2,1
5,359,359,22,22,0,1,0
4,363,363,5,5,0,1,0
0,394,394,10,10,0,1,0
10,415,415,90,38,52,3,2

4,205,205,25,3,22,3,2
3,302,302,41,21,20,2,1
0,380,380,4,4,0,1,0
2,386,386,18,18,0,1,0
1,419,419,122,72,50,2,1

1,107,107,4,4,0,1,0
2,173,173,5,5,0,1,0
0,301,301,81,21,60,3,2
3,407,407,37,37,0,1,0
4,472,472,87,19,68,4,3

1,310,310,17,7,10,2,1
3,321,321,51,51,0,1,0
0,355,355,107,94,13,2,1
2,440,440,41,41,0,1,0

0,100,100,2,2,0,1,0
4,220,220,13,13,0,1,0
6,230,230,45,21,24,4,3
5,247,247,14,14,0,1,0
1,355,355,15,8,7,2,1
3,389,389,46,46,0,1,0
2,467,467,57,3,54,3,2

3,107,107,18,4,14,3,2
5,121,121,1,1,0,1,0
2,320,320,26,6,20,3,2
0,350,350,62,47,15,4,3
4,376,376,51,9,42,3,2
1,461,461,20,5,15,2,1

2,103,103,7,2,5,2,1
9,145,145,14,6,8,2,1
7,170,170,20,10,10,2,1
4,198,198,21,21,0,1,0
8,235,235,23,4,19,2,1
0,368,368,6,6,0,1,0
6,372,372,9,9,0,1,0
3,383,383,9,9,0,1,0
1,389,389,19,19,0,1,0
5,450,450,6,6,0,1,0

3,230,230,9,5,4,2,1
0,293,293,1,1,0,1,0
4,320,320,28,21,7,2,1
7,325,325,47,25,22,3,2
5,344,344,10,10,0,1,0
2,350,350,19,14,5,2,1
6,452,452,59,59,0,1,0
1,494,494,58,58,0,1,0

4,117,117,6,6,0,1,0
1,165,165,2,2,0,1,0
3,185,185,8,8,0,1,0
2,217,217,25,1,24,3,2
6,300,300,53,35,18,2,1
5,320,320,17,13,4,2,1
7,398,398,30,8,22,2,1
0,462,462,39,9,30,2,1

4,130,130,2,2,0,1,0
5,186,186,28,28,0,1,0
0,234,234,25,25,0,1,0
7,260,260,24,24,0,1,0
2,340,340,16,16,0,1,0
6,345,345,22,19,3,2,1
1,357,357,21,21,0,1,0
3,429,429,31,31,0,1,0

1,178,178,15,15,0,1,0
0,231,231,70,59,11,2,1
2,268,268,41,23,18,2,1
3,399,399,28,28,0,1,0

3,112,112,1,1,0,1,0
0,140,140,1,1,0,1,0
2,152,152,8,8,0,1,0
9,238,238,13,13,0,1,0
1,276,276,7,7,0,1,0
4,281,281,32,32,0,1,0
5,359,359,24,2,22,3,2
10,400,400,81,63,18,3,2
7,432,432,10,10,0,1,0
8,434,434,21,6,15,4,3
6,462,462,1,1,0,1,0

0,106,106,6,6,0,1,0
3,158,158,7,7,0,1,0
4,161,161,25,25,0,1,0
1,221,221,5,5,0,1,0
2,235,235,52,26,26,3,2
5,444,444,48,48,0,1,0

11,149,149,3,3,0,1,0
10,158,158,37,4,33,4,3
9,162,162,12,12,0,1,0
7,195,195,3,3,0,1,0
8,210,210,3,3,0,1,0
12,241,241,12,3,9,4,3
4,273,273,1,1,0,1,0
6,279,279,15,15,0,1,0
5,293,293,7,7,0,1,0
2,332,332,1,1,0,1,0
1,407,407,19,1,18,2,1
0,420,420,14,3,11,2,1
3,479,479,16,4,12,4,3

1,145,145,15,15,0,1,0
3,156,156,29,3,26,3,2
4,195,195,9,9,0,1,0
5,241,241,18,18,0,1,0
0,344,344,45,15,30,4,3
2,387,387,26,26,0,1,0

1,113,113,1,1,0,1,0
5,163,163,33,33,0,1,0
4,247,247,11,11,0,1,0
0,254,254,2,2,0,1,0
3,282,282,16,11,5,2,1
2,461,461,131,105,26,4,3

1,349,349,13,13,0,1,0
0,394,394,119,107,12,3,2
2,398,398,39,39,0,1,0
3,403,403,69,69,0,1,0

0,145,145,16,16,0,1,0
5,177,177,1,1,0,1,0
1,245,245,12,3,9,4,3
3,429,429,82,19,63,4,3
2,443,443,63,63,0,1,0
4,465,465,49,49,0,1,0

0,133,133,4,1,3,2,1
5,344,344,33,6,27,4,3
2,346,346,14,14,0,1,0
1,369,369,85,85,0,1,0
4,401,401,51,23,28,3,2
3,407,407,32,14,18,2,1

2,147,147,27,6,21,2,1
0,218,218,66,48,18,3,2
1,426,426,2,2,0,1,0
3,479,479,54,5,49,2,1

1,132,132,1,1,0,1,0
3,151,151,18,10,8,3,2
4,255,255,5,5,0,1,0
2,275,275,39,12,27,4,3
5,327,327,13,13,0,1,0
6,410,410,101,95,6,3,2
0,464,464,17,1,16,2,1

1,114,114,14,8,6,3,2
7,123,123,8,8,0,1,0
6,290,290,31,31,0,1,0
4,293,293,37,18,19,4,3
0,299,299,4,4,0,1,0
2,427,427,12,12,0,1,0
3,469,469,5,5,0,1,0
5,492,492,65,29,36,3,2

4,105,105,2,2,0,1,0
0,115,115,1,1,0,1,0
3,118,118,12,12,0,1,0
7,189,189,22,22,0,1,0
2,219,219,8,8,0,1,0
6,297,297,41,41,0,1,0
8,308,308,17,5,12,4,3
5,315,315,35,35,0,1,0
1,474,474,12,12,0,1,0

7,118,118,3,3,0,1,0
8,154,154,18,4,14,3,2
4,170,170,29,29,0,1,0
2,178,178,1,1,0,1,0
9,178,178,29,5,24,3,2
5,199,199,5,2,3,2,1
6,255,255,4,4,0,1,0
3,287,287,4,4,0,1,0
0,293,293,3,3,0,1,0
1,362,362,22,22,0,1,0

5,117,117,17,17,0,1,0
3,131,131,6,6,0,1,0
7,195,195,28,28,0,1,0
1,216,216,48,14,34,3,2
4,369,369,8,4,4,2,1
2,440,440,2,2,0,1,0
0,454,454,3,3,0,1,0
6,464,464,9,4,5,2,1

2,284,284,14,14,0,1,0
3,329,329,20,20,0,1,0
0,402,402,121,30,91,4,3
1,486,486,94,53,41,2,1

9,134,134,1,1,0,1,0
2,145,145,9,3,6,2,1
8,196,196,16,11,5,2,1
7,219,219,49,49,0,1,0
4,274,274,1,1,0,1,0
0,329,329,42,42,0,1,0
6,376,376,22,11,11,2,1
5,399,399,1,1,0,1,0
3,419,419,1,1,0,1,0
1,459,459,20,14,6,2,1

7,226,226,45,37,8,3,2
3,238,238,10,10,0,1,0
4,313,313,12,7,5,2,1
2,358,358,24,24,0,1,0
9,363,363,22,22,0,1,0
0,399,399,14,14,0,1,0
8,400,400,18,18,0,1,0
5,401,401,17,17,0,1,0
6,491,491,25,25,0,1,0
1,495,495,12,12,0,1,0

0,130,130,10,10,0,1,0
4,164,164,10,7,3,2,1
2,317,317,4,4,0,1,0
5,331,331,68,68,0,1,0
1,338,338,56,56,0,1,0
3,433,433,20,11,9,3,2
6,481,481,18,18,0,1,0

7,101,101,13,13,0,1,0
3,112,112,7,7,0,1,0
5,136,136,1,1,0,1,0
6,137,137,24,24,0,1,0
0,152,152,1,1,0,1,0
1,287,287,3,3,0,1,0
2,341,341,6,6,0,1,0
4,386,386,78,12,66,3,2
8,472,472,2,2,0,1,0

4,152,152,2,2,0,1,0
2,276,276,2,2,0,1,0
1,417,417,47,47,0,1,0
3,418,418,107,107,0,1,0
5,444,444,16,16,0,1,0
0,484,484,88,27,61,4,3

8,117,117,12,1,11,2,1
7,180,180,3,3,0,1,0
6,206,206,16,2,14,2,1
5,215,215,7,7,0,1,0
9,221,221,42,6,36,3,2
2,226,226,10,4,6,2,1
0,319,319,13,13,0,1,0
1,362,362,4,1,3,2,1
10,367,367,6,6,0,1,0
3,379,379,15,9,6,2,1
4,488,488,19,19,0,1,0

0,104,104,3,3,0,1,0
1,128,128,9,9,0,1,0
4,261,261,28,28,0,1,0
6,262,262,37,1,36,3,2
5,292,292,16,16,0,1,0
3,293,293,19,16,3,2,1
2,295,295,41,6,35,2,1

4,200,200,12,2,10,2,1
0,213,213,53,53,0,1,0
2,215,215,8,1,7,2,1
1,283,283,5,2,3,2,1
3,392,392,2,2,0,1,0
5,470,470,112,3,109,4,3

4,109,109,15,15,0,1,0
8,151,151,20,20,0,1,0
3,224,224,5,5,0,1,0
1,233,233,1,1,0,1,0
0,254,254,12,3,9,4,3
7,266,266,15,15,0,1,0
2,346,346,22,22,0,1,0
5,465,465,12,6,6,3,2
6,491,491,60,20,40,2,1

6,113,113,7,3,4,2,1
2,219,219,17,17,0,1,0
0,241,241,7,7,0,1,0
3,254,254,2,2,0,1,0
7,316,316,13,9,4,2,1
1,338,338,3,3,0,1,0
8,438,438,88,83,5,2,1
4,449,449,1,1,0,1,0
5,494,494,87,20,67,4,3

