0,129,129,10,10,0,1,0
10,135,135,13,13,0,1,0
8,142,142,26,8,18,2,1
3,149,149,7,1,6,2,1
2,204,204,6,3,3,2,1
9,215,215,27,9,18,3,2
5,262,262,26,12,14,3,2
4,337,337,38,30,8,3,2
1,370,370,1,1,0,1,0
7,476,476,11,11,0,1,0
6,495,495,5,5,0,1,0

1,100,100,35,35,0,1,0
4,222,222,55,55,0,1,0
5,463,463,31,31,0,1,0
3,465,465,43,43,0,1,0
2,481,481,14,14,0,1,0
0,487,487,11,1,10,3,2

5,103,103,1,1,0,1,0
4,117,117,22,4,18,3,2
2,138,138,6,6,0,1,0
11,223,223,11,3,8,2,1
1,240,240,9,9,0,1,0
7,249,249,4,1,3,2,1
6,314,314,10,10,0,1,0
10,336,336,83,55,28,2,1
0,382,382,6,3,3,2,1
8,387,387,15,3,12,3,2
3,422,422,8,8,0,1,0
9,430,430,47,47,0,1,0

2,102,102,2,2,0,1,0
7,136,136,30,30,0,1,0
3,177,177,25,11,14,3,2
4,219,219,4,4,0,1,0
5,274,274,19,19,0,1,0
0,279,279,55,55,0,1,0
6,468,468,54,54,0,1,0
1,500,500,14,14,0,1,0

5,103,103,30,9,21,4,3
3,128,128,12,12,0,1,0
0,156,156,10,10,0,1,0
2,283,283,62,62,0,1,0
4,408,408,3,3,0,1,0
1,425,425,12,12,0,1,0
6,438,438,49,39,10,3,2

5,124,124,8,8,0,1,0
0,128,128,1,1,0,1,0
2,243,243,15,15,0,1,0
3,291,291,56,56,0,1,0
1,384,384,54,54,0,1,0
6,410,410,114,114,0,1,0
4,494,494,30,30,0,1,0

7,110,110,11,3,8,3,2
3,137,137,11,11,0,1,0
2,202,202,13,2,11,2,1
0,253,253,21,21,0,1,0
6,351,351,91,2,89,4,3
1,432,432,38,12,26,3,2
4,482,482,41,8,33,4,3
5,482,482,24,24,0,1,0

2,112,112,1,1,0,1,0
3,116,116,18,18,0,1,0
6,255,255,22,12,10,3,2
8,267,267,22,22,0,1,0
1,380,380,1,1,0,1,0
7,385,385,91,91,0,1,0
5,459,459,37,37,0,1,0
0,463,463,31,17,14,3,2
4,490,490,42,42,0,1,0

3,121,121,5,5,0,1,0
1,287,287,19,4,15,4,3
6,342,342,110,2,108,4,3
4,348,348,19,15,4,2,1
0,382,382,52,4,48,3,2
2,417,417,68,30,38,2,1
5,447,447,11,5,6,2,1

3,145,145,5,5,0,1,0
10,155,155,6,6,0,1,0
5,223,223,8,8,0,1,0
7,302,302,4,4,0,1,0
8,313,313,62,17,45,2,1
9,361,361,60,60,0,1,0
6,367,367,11,6,5,2,1
1,381,381,11,11,0,1,0
2,432,432,48,6,42,2,1
0,460,460,20,4,16,3,2
4,489,489,51,51,0,1,0

13,115,115,24,24,0,1,0
9,133,133,7,2,5,2,1
12,142,142,24,9,15,2,1
10,197,197,12,12,0,1,0
5,224,224,12,4,8,2,1
11,238,238,9,9,0,1,0
0,249,249,12,4,8,3,2
8,265,265,1,1,0,1,0
3,350,350,4,4,0,1,0
4,360,360,6,6,0,1,0
1,430,430,1,1,0,1,0
6,451,451,33,27,6,2,1
7,483,483,32,32,0,1,0
2,497,497,7,1,6,3,2

7,159,159,27,27,0,1,0
6,242,242,49,49,0,1,0
0,281,281,45,45,0,1,0
1,282,282,3,3,0,1,0
8,299,299,10,10,0,1,0
4,303,303,5,5,0,1,0
5,376,376,32,32,0,1,0
2,481,481,40,40,0,1,0
3,492,492,23,23,0,1,0

3,106,106,18,6,12,4,3
0,140,140,17,17,0,1,0
7,209,209,11,11,0,1,0
4,255,255,11,11,0,1,0
1,357,357,12,12,0,1,0
6,449,449,107,26,81,4,3
2,451,451,16,16,0,1,0
5,466,466,53,31,22,3,2

3,295,295,5,2,3,2,1
5,312,312,16,1,15,4,3
8,346,346,38,16,22,3,2
7,348,348,96,13,83,4,3
6,365,365,8,8,0,1,0
4,389,389,41,11,30,2,1
0,446,446,16,2,14,3,2
1,466,466,48,7,41,4,3
2,484,484,43,43,0,1,0

5,121,121,12,12,0,1,0
7,128,128,29,11,18,4,3
3,193,193,30,30,0,1,0
6,259,259,32,21,11,2,1
4,361,361,7,1,6,2,1
8,362,362,19,19,0,1,0
2,378,378,23,8,15,4,3
1,421,421,16,1,15,2,1
0,441,441,12,7,5,2,1

1,134,134,20,20,0,1,0
3,237,237,1,1,0,1,0
0,257,257,45,30,15,2,1
5,294,294,100,100,0,1,0
2,303,303,22,8,14,3,2
6,389,389,17,4,13,3,2
4,407,407,8,8,0,1,0

0,109,109,1,1,0,1,0
10,119,119,8,2,6,3,2
7,122,122,1,1,0,1,0
6,130,130,1,1,0,1,0
5,219,219,23,3,20,3,2
2,233,233,1,1,0,1,0
12,237,237,74,32,42,2,1
13,260,260,11,1,10,3,2
8,317,317,7,1,6,3,2
3,327,327,33,5,28,4,3
9,407,407,7,7,0,1,0
11,431,431,22,19,3,2,1
1,468,468,25,16,9,4,3
4,468,468,6,2,4,2,1

5,191,191,11,11,0,1,0
1,220,220,40,40,0,1,0
0,296,296,3,3,0,1,0
2,323,323,22,22,0,1,0
6,342,342,16,6,10,2,1
3,360,360,5,5,0,1,0
7,384,384,91,78,13,2,1
4,393,393,9,9,0,1,0
9,454,454,8,4,4,2,1
8,465,465,69,45,24,3,2

4,115,115,10,10,0,1,0
0,126,126,5,5,0,1,0
8,199,199,56,56,0,1,0
3,204,204,14,14,0,1,0
2,241,241,15,15,0,1,0
6,352,352,25,2,23,2,1
5,363,363,51,10,41,2,1
1,371,371,1,1,0,1,0
7,420,420,22,11,11,2,1

6,169,169,7,3,4,2,1
1,204,204,33,33,0,1,0
7,240,240,75,56,19,2,1
4,251,251,9,9,0,1,0
3,295,295,32,19,13,2,1
0,300,300,11,6,5,2,1
5,357,357,17,3,14,2,1
2,414,414,24,24,0,1,0

3,174,174,7,7,0,1,0
0,178,178,15,1,14,2,1
6,227,227,15,15,0,1,0
4,228,228,14,14,0,1,0
9,230,230,25,25,0,1,0
1,257,257,17,17,0,1,0
8,403,403,20,5,15,4,3
2,428,428,10,2,8,3,2
10,434,434,107,81,26,3,2
5,442,442,9,3,6,3,2
7,493,493,19,5,14,2,1

3,118,118,1,1,0,1,0
2,264,264,2,2,0,1,0
4,310,310,39,39,0,1,0
0,314,314,15,6,9,4,3
10,383,383,109,8,101,4,3
5,389,389,6,6,0,1,0
8,389,389,41,14,27,4,3
9,395,395,5,5,0,1,0
1,417,417,12,12,0,1,0
6,444,444,19,19,0,1,0
7,489,489,61,61,0,1,0

9,131,131,22,22,0,1,0
2,153,153,4,4,0,1,0
4,159,159,3,3,0,1,0
8,172,172,5,5,0,1,0
3,193,193,2,2,0,1,0
1,219,219,19,1,18,2,1
0,229,229,36,36,0,1,0
6,259,259,12,2,10,3,2
5,335,335,19,19,0,1,0
7,408,408,87,25,62,3,2

3,113,113,3,3,0,1,0
1,124,124,21,21,0,1,0
0,197,197,46,46,0,1,0
2,209,209,14,14,0,1,0
4,333,333,104,76,28,2,1

0,104,104,18,13,5,2,1
4,120,120,7,7,0,1,0
6,235,235,17,6,11,4,3
1,256,256,8,2,6,2,1
3,326,326,4,4,0,1,0
5,346,346,94,49,45,2,1
2,495,495,91,64,27,4,3

7,104,104,17,17,0,1,0
1,108,108,3,3,0,1,0
10,136,136,14,3,11,2,1
9,193,193,54,17,37,2,1
5,255,255,3,3,0,1,0
4,316,316,9,9,0,1,0
8,328,328,1,1,0,1,0
2,364,364,11,11,0,1,0
6,436,436,1,1,0,1,0
11,459,459,9,6,3,2,1
3,476,476,14,14,0,1,0
0,493,493,52,52,0,1,0

1,113,113,8,8,0,1,0
5,214,214,35,8,27,4,3
2,274,274,44,38,6,3,2
0,416,416,26,15,11,2,1
4,430,430,43,17,26,3,2
7,450,450,63,28,35,4,3
6,473,473,47,20,27,2,1
3,487,487,3,3,0,1,0

3,104,104,3,3,0,1,0
4,104,104,10,6,4,2,1
8,150,150,31,31,0,1,0
0,169,169,1,1,0,1,0
1,196,196,6,6,0,1,0
10,247,247,3,3,0,1,0
2,285,285,19,19,0,1,0
7,302,302,26,26,0,1,0
6,383,383,17,17,0,1,0
9,398,398,74,74,0,1,0
5,485,485,21,21,0,1,0

3,290,290,86,20,66,4,3
0,329,329,84,11,73,4,3
4,344,344,12,12,0,1,0
1,406,406,6,3,3,2,1
5,439,439,32,32,0,1,0
2,486,486,64,20,44,3,2

5,118,118,1,1,0,1,0
6,144,144,52,52,0,1,0
4,223,223,36,15,21,4,3
7,361,361,15,15,0,1,0
2,385,385,21,21,0,1,0
1,387,387,20,20,0,1,0
0,426,426,52,52,0,1,0
3,481,481,5,5,0,1,0

5,110,110,14,14,0,1,0
4,139,139,16,16,0,1,0
2,275,275,10,10,0,1,0
3,276,276,47,47,0,1,0
0,460,460,22,22,0,1,0
1,474,474,150,111,39,4,3

4,122,122,34,17,17,2,1
2,215,215,47,47,0,1,0
3,247,247,20,20,0,1,0
5,315,315,19,19,0,1,0
0,365,365,30,19,11,2,1
1,452,452,10,7,3,2,1
6,495,495,34,34,0,1,0

0,143,143,12,12,0,1,0
4,155,155,7,7,0,1,0
3,208,208,10,2,8,2,1
5,326,326,102,12,90,3,2
1,360,360,82,13,69,4,3
2,475,475,42,42,0,1,0

3,110,110,18,14,4,2,1
8,227,227,18,18,0,1,0
2,246,246,7,4,3,2,1
7,267,267,63,20,43,4,3
4,272,272,1,1,0,1,0
6,277,277,26,5,21,4,3
0,319,319,32,32,0,1,0
1,458,458,13,3,10,3,2
5,475,475,36,36,0,1,0

11,108,108,15,15,0,1,0
1,124,124,4,1,3,2,1
5,146,146,1,1,0,1,0
10,174,174,39,39,0,1,0
4,198,198,15,15,0,1,0
8,241,241,5,2,3,2,1
7,295,295,18,3,15,3,2
2,340,340,32,17,15,4,3
3,358,358,9,9,0,1,0
9,395,395,19,19,0,1,0
0,449,449,4,4,0,1,0
6,496,496,38,21,17,2,1

2,117,117,18,10,8,3,2
1,121,121,2,2,0,1,0
0,123,123,7,7,0,1,0
3,194,194,26,26,0,1,0
5,205,205,3,3,0,1,0
4,223,223,9,9,0,1,0
7,340,340,60,14,46,3,2
6,388,388,82,18,64,4,3

3,172,172,26,8,18,4,3
2,181,181,2,2,0,1,0
1,291,291,94,94,0,1,0
4,332,332,82,82,0,1,0
0,448,448,36,36,0,1,0

5,112,112,22,22,0,1,0
6,301,301,62,62,0,1,0
4,344,344,1,1,0,1,0
3,403,403,29,29,0,1,0
0,413,413,62,20,42,4,3
1,465,465,17,2,15,2,1
2,487,487,69,61,8,3,2

3,137,137,6,6,0,1,0
1,321,321,57,57,0,1,0
0,332,332,17,8,9,4,3
2,366,366,49,13,36,2,1
4,371,371,21,21,0,1,0
5,378,378,45,38,7,2,1
6,448,448,102,60,42,2,1

3,114,114,4,1,3,2,1
6,143,143,10,2,8,2,1
4,206,206,11,3,8,2,1
1,223,223,24,24,0,1,0
8,228,228,19,13,6,2,1
5,240,240,1,1,0,1,0
0,271,271,13,1,12,4,3
9,276,276,16,16,0,1,0
7,380,380,4,4,0,1,0
10,392,392,105,105,0,1,0
2,461,461,34,4,30,3,2

1,109,109,13,1,12,2,1
8,248,248,54,17,37,2,1
4,258,258,10,10,0,1,0
0,283,283,8,8,0,1,0
7,327,327,6,6,0,1,0
3,357,357,11,11,0,1,0
2,420,420,19,19,0,1,0
6,473,473,81,39,42,3,2
5,478,478,66,42,24,4,3

7,126,126,1,1,0,1,0
9,130,130,4,4,0,1,0
4,145,145,10,10,0,1,0
10,164,164,16,16,0,1,0
8,174,174,49,49,0,1,0
6,191,191,5,5,0,1,0
1,272,272,23,23,0,1,0
0,283,283,5,2,3,2,1
3,329,329,9,9,0,1,0
2,414,414,21,21,0,1,0
5,438,438,53,53,0,1,0

6,139,139,1,1,0,1,0
2,142,142,7,7,0,1,0
4,157,157,4,4,0,1,0
7,190,190,22,22,0,1,0
5,228,228,2,2,0,1,0
0,272,272,35,35,0,1,0
3,338,338,57,11,46,3,2
1,371,371,8,8,0,1,0
8,460,460,132,46,86,4,3

8,106,106,6,1,5,2,1
1,113,113,1,1,0,1,0
5,128,128,6,6,0,1,0
7,243,243,42,42,0,1,0
6,248,248,43,43,0,1,0
2,307,307,3,3,0,1,0
0,349,349,21,7,14,3,2
4,358,358,21,13,8,2,1
3,451,451,100,65,35,3,2

6,100,100,13,8,5,2,1
7,133,133,5,5,0,1,0
3,140,140,25,8,17,2,1
0,178,178,14,14,0,1,0
5,186,186,46,12,34,3,2
4,268,268,26,1,25,2,1
2,272,272,12,6,6,3,2
1,403,403,2,2,0,1,0

7,130,130,8,3,5,2,1
4,217,217,12,4,8,2,1
6,290,290,22,19,3,2,1
3,316,316,73,39,34,2,1
0,322,322,34,2,32,4,3
2,323,323,3,3,0,1,0
5,353,353,96,93,3,2,1
1,478,478,1,1,0,1,0

11,138,138,9,9,0,1,0
9,156,156,46,46,0,1,0
5,255,255,11,11,0,1,0
4,275,275,10,5,5,2,1
1,307,307,3,3,0,1,0
10,316,316,15,15,0,1,0
2,364,364,25,15,10,2,1
8,385,385,9,3,6,2,1
7,420,420,24,24,0,1,0
0,422,422,37,37,0,1,0
3,427,427,6,2,4,2,1
6,499,499,31,31,0,1,0

7,126,126,4,4,0,1,0
0,278,278,17,11,6,2,1
5,324,324,66,21,45,4,3
2,337,337,3,3,0,1,0
4,348,348,24,24,0,1,0
3,369,369,21,14,7,2,1
6,413,413,22,22,0,1,0
1,453,453,1,1,0,1,0
8,492,492,158,158,0,1,0

4,128,128,4,4,0,1,0
7,129,129,8,2,6,2,1
0,141,141,3,3,0,1,0
1,268,268,1,1,0,1,0
9,268,268,19,7,12,2,1
11,303,303,92,25,67,3,2
10,314,314,10,10,0,1,0
8,317,317,8,1,7,2,1
6,391,391,24,11,13,2,1
2,421,421,36,36,0,1,0
3,446,446,20,14,6,3,2
5,486,486,32,32,0,1,0

12,115,115,1,1,0,1,0
5,134,134,10,10,0,1,0
1,143,143,1,1,0,1,0
6,202,202,7,4,3,2,1
8,245,245,12,12,0,1,0
4,262,262,3,3,0,1,0
9,308,308,6,6,0,1,0
7,312,312,30,30,0,1,0
11,332,332,61,61,0,1,0
10,375,375,81,63,18,3,2
3,378,378,11,5,6,3,2
0,436,436,14,14,0,1,0
2,447,447,21,5,16,2,1

6,125,125,9,3,6,3,2
2,179,179,3,3,0,1,0
7,238,238,14,14,0,1,0
3,275,275,1,1,0,1,0
1,290,290,51,5,46,3,2
0,308,308,50,6,44,3,2
4,339,339,8,8,0,1,0
8,379,379,105,51,54,3,2
5,463,463,9,9,0,1,0

0,123,123,29,29,0,1,0
2,266,266,27,10,17,2,1
1,291,291,19,19,0,1,0
3,301,301,40,40,0,1,0
5,328,328,56,17,39,2,1
4,382,382,38,38,0,1,0

1,127,127,20,12,8,3,2
3,187,187,26,11,15,2,1
4,278,278,9,9,0,1,0
2,309,309,31,16,15,4,3
5,442,442,74,74,0,1,0
6,446,446,91,9,82,4,3
0,495,495,2,2,0,1,0

5,171,171,41,41,0,1,0
6,173,173,25,25,0,1,0
7,247,247,6,6,0,1,0
4,333,333,29,29,0,1,0
2,370,370,19,19,0,1,0
3,398,398,16,16,0,1,0
1,456,456,94,79,15,2,1
0,499,499,9,9,0,1,0

0,117,117,6,6,0,1,0
2,177,177,39,39,0,1,0
6,256,256,21,21,0,1,0
9,291,291,89,89,0,1,0
3,297,297,1,1,0,1,0
1,347,347,8,8,0,1,0
7,356,356,3,3,0,1,0
4,377,377,1,1,0,1,0
8,406,406,37,37,0,1,0
5,462,462,8,8,0,1,0

2,142,142,37,15,22,2,1
4,233,233,2,2,0,1,0
0,253,253,90,24,66,3,2
1,264,264,12,3,9,2,1
3,362,362,49,13,36,4,3

8,167,167,12,8,4,2,1
1,177,177,14,14,0,1,0
2,234,234,20,3,17,3,2
7,258,258,26,26,0,1,0
5,338,338,5,1,4,2,1
4,350,350,45,45,0,1,0
0,375,375,24,14,10,3,2
3,411,411,12,6,6,2,1
6,437,437,102,77,25,2,1

8,131,131,11,11,0,1,0
5,188,188,29,23,6,3,2
0,191,191,3,3,0,1,0
3,193,193,21,1,20,3,2
4,193,193,1,1,0,1,0
6,246,246,26,26,0,1,0
1,284,284,3,3,0,1,0
7,353,353,28,28,0,1,0
9,370,370,90,30,60,3,2
2,490,490,1,1,0,1,0

6,105,105,6,1,5,2,1
5,112,112,3,3,0,1,0
2,127,127,5,5,0,1,0
1,150,150,7,7,0,1,0
3,224,224,57,35,22,2,1
0,322,322,1,1,0,1,0
4,424,424,24,2,22,3,2
7,458,458,149,68,81,4,3

6,180,180,15,3,12,3,2
5,238,238,49,41,8,2,1
3,259,259,37,22,15,4,3
4,279,279,33,33,0,1,0
1,411,411,11,11,0,1,0
2,444,444,96,59,37,4,3
0,471,471,7,7,0,1,0

2,224,224,34,29,5,2,1
3,245,245,21,6,15,4,3
4,289,289,62,29,33,2,1
0,391,391,61,25,36,4,3
5,414,414,71,71,0,1,0
1,446,446,4,1,3,2,1
6,453,453,8,8,0,1,0

4,107,107,9,9,0,1,0
7,147,147,9,3,6,2,1
8,157,157,14,14,0,1,0
2,169,169,14,2,12,4,3
9,189,189,49,2,47,2,1
5,222,222,2,2,0,1,0
1,298,298,11,11,0,1,0
0,399,399,36,36,0,1,0
3,401,401,23,3,20,3,2
6,477,477,19,8,11,2,1

5,131,131,1,1,0,1,0
3,336,336,24,24,0,1,0
4,408,408,161,80,81,4,3
2,409,409,90,68,22,3,2
6,437,437,3,3,0,1,0
0,465,465,40,19,21,4,3
1,493,493,12,6,6,3,2

1,119,119,33,13,20,2,1
0,140,140,2,2,0,1,0
2,161,161,18,18,0,1,0
3,166,166,27,27,0,1,0
4,262,262,63,30,33,4,3
5,353,353,2,2,0,1,0

5,103,103,18,6,12,3,2
2,104,104,2,2,0,1,0
1,175,175,25,6,19,2,1
0,240,240,30,18,12,3,2
4,288,288,2,2,0,1,0
3,300,300,34,28,6,2,1
6,344,344,76,19,57,4,3

5,121,121,9,9,0,1,0
6,167,167,8,8,0,1,0
0,176,176,5,5,0,1,0
3,258,258,3,3,0,1,0
4,264,264,11,7,4,2,1
7,301,301,87,87,0,1,0
2,449,449,18,18,0,1,0
1,461,461,129,80,49,3,2

2,119,119,10,10,0,1,0
3,166,166,3,3,0,1,0
0,182,182,3,3,0,1,0
7,287,287,25,25,0,1,0
1,289,289,6,6,0,1,0
8,300,300,19,19,0,1,0
9,351,351,33,10,23,2,1
10,387,387,96,66,30,4,3
5,422,422,26,26,0,1,0
6,437,437,44,17,27,2,1
4,461,461,6,6,0,1,0

5,121,121,4,4,0,1,0
7,125,125,1,1,0,1,0
3,138,138,16,16,0,1,0
4,160,160,10,2,8,3,2
2,164,164,6,6,0,1,0
6,239,239,46,46,0,1,0
8,269,269,55,14,41,2,1
0,359,359,32,32,0,1,0
1,415,415,27,27,0,1,0

0,263,263,9,9,0,1,0
3,266,266,101,11,90,3,2
4,294,294,2,2,0,1,0
2,308,308,6,6,0,1,0
1,451,451,165,112,53,4,3

0,123,123,9,9,0,1,0
2,205,205,17,17,0,1,0
6,235,235,4,1,3,2,1
1,278,278,42,42,0,1,0
3,315,315,30,18,12,4,3
4,472,472,64,64,0,1,0
5,485,485,122,47,75,4,3

3,193,193,5,5,0,1,0
5,251,251,90,56,34,3,2
4,291,291,9,3,6,3,2
0,390,390,65,65,0,1,0
2,427,427,37,8,29,2,1
6,457,457,7,7,0,1,0
1,482,482,59,43,16,3,2

1,111,111,16,16,0,1,0
5,200,200,20,6,14,3,2
4,284,284,61,45,16,2,1
0,405,405,63,36,27,2,1
2,454,454,46,34,12,2,1
3,500,500,45,19,26,3,2

4,133,133,12,12,0,1,0
5,157,157,31,5,26,2,1
1,186,186,1,1,0,1,0
3,310,310,1,1,0,1,0
0,387,387,98,60,38,2,1
6,389,389,36,18,18,3,2
2,450,450,24,6,18,2,1
7,460,460,52,52,0,1,0

1,125,125,1,1,0,1,0
8,198,198,33,13,20,2,1
4,233,233,18,18,0,1,0
6,284,284,67,34,33,2,1
0,287,287,48,48,0,1,0
2,341,341,4,1,3,2,1
5,397,397,15,5,10,3,2
7,460,460,1,1,0,1,0
3,496,496,49,18,31,2,1

4,122,122,6,6,0,1,0
5,149,149,2,2,0,1,0
0,157,157,12,12,0,1,0
7,171,171,7,7,0,1,0
3,182,182,30,18,12,4,3
1,247,247,5,5,0,1,0
6,290,290,9,9,0,1,0
8,351,351,110,67,43,2,1
2,436,436,2,2,0,1,0
9,458,458,18,18,0,1,0
10,476,476,24,13,11,2,1

1,178,178,32,32,0,1,0
4,235,235,29,29,0,1,0
0,271,271,9,9,0,1,0
5,309,309,15,15,0,1,0
6,397,397,93,83,10,2,1
2,419,419,17,17,0,1,0
3,424,424,63,55,8,2,1

4,131,131,15,1,14,2,1
3,140,140,16,16,0,1,0
0,237,237,4,1,3,2,1
2,387,387,71,37,34,3,2
1,460,460,177,112,65,3,2

9,133,133,23,17,6,2,1
8,149,149,34,30,4,2,1
5,188,188,10,3,7,2,1
0,216,216,15,1,14,3,2
4,333,333,2,2,0,1,0
3,345,345,8,8,0,1,0
1,369,369,5,1,4,2,1
6,373,373,16,4,12,4,3
2,458,458,88,16,72,3,2
7,476,476,3,3,0,1,0

1,146,146,19,19,0,1,0
2,263,263,15,15,0,1,0
3,443,443,25,25,0,1,0
4,447,447,130,49,81,4,3
0,455,455,125,125,0,1,0

2,185,185,1,1,0,1,0
0,298,298,62,28,34,3,2
6,312,312,2,2,0,1,0
7,365,365,123,113,10,3,2
5,419,419,26,18,8,2,1
4,440,440,9,2,7,2,1
3,462,462,70,70,0,1,0
1,481,481,8,8,0,1,0

2,152,152,7,7,0,1,0
0,172,172,69,69,0,1,0
3,248,248,73,73,0,1,0
1,479,479,32,6,26,2,1

4,144,144,1,1,0,1,0
10,203,203,23,13,10,3,2
6,218,218,2,2,0,1,0
9,285,285,24,24,0,1,0
5,300,300,19,5,14,2,1
1,313,313,60,18,42,3,2
7,329,329,14,7,7,2,1
2,341,341,2,2,0,1,0
3,345,345,1,1,0,1,0
0,473,473,38,19,19,2,1
8,496,496,102,102,0,1,0

7,121,121,1,1,0,1,0
2,141,141,8,8,0,1,0
0,173,173,11,11,0,1,0
5,266,266,92,76,16,3,2
6,383,383,21,21,0,1,0
1,402,402,46,27,19,2,1
3,422,422,36,18,18,3,2
4,468,468,38,38,0,1,0

9,107,107,6,6,0,1,0
0,111,111,1,1,0,1,0
6,187,187,7,7,0,1,0
7,231,231,16,16,0,1,0
8,242,242,69,6,63,3,2
5,250,250,8,8,0,1,0
2,352,352,12,4,8,2,1
1,357,357,22,22,0,1,0
3,371,371,71,45,26,2,1
4,414,414,16,16,0,1,0

4,129,129,1,1,0,1,0
2,184,184,4,4,0,1,0
3,213,213,11,11,0,1,0
8,223,223,7,2,5,2,1
6,354,354,10,10,0,1,0
5,392,392,74,54,20,3,2
1,394,394,33,33,0,1,0
7,397,397,138,90,48,4,3
0,398,398,19,19,0,1,0

0,293,293,3,3,0,1,0
1,315,315,96,33,63,4,3
4,318,318,48,4,44,3,2
3,328,328,42,22,20,3,2
5,379,379,48,48,0,1,0
2,430,430,37,15,22,3,2

7,154,154,6,6,0,1,0
4,168,168,14,4,10,3,2
5,273,273,13,13,0,1,0
3,324,324,24,14,10,3,2
1,396,396,4,4,0,1,0
2,408,408,67,67,0,1,0
6,448,448,143,143,0,1,0
0,449,449,32,29,3,2,1

1,131,131,7,7,0,1,0
2,180,180,30,12,18,4,3
0,186,186,28,28,0,1,0
4,223,223,40,40,0,1,0
5,235,235,28,18,10,3,2
6,262,262,28,15,13,2,1
3,350,350,11,11,0,1,0

6,272,272,1,1,0,1,0
3,313,313,73,73,0,1,0
2,361,361,3,3,0,1,0
7,366,366,85,51,34,3,2
8,398,398,67,67,0,1,0
0,421,421,21,3,18,2,1
4,434,434,15,6,9,2,1
5,434,434,6,1,5,2,1
1,444,444,27,21,6,2,1

1,148,148,37,26,11,2,1
4,176,176,47,37,10,2,1
2,238,238,28,9,19,2,1
0,278,278,10,10,0,1,0
5,278,278,27,23,4,2,1
3,375,375,16,7,9,4,3

0,200,200,3,3,0,1,0
8,226,226,8,8,0,1,0
1,244,244,64,64,0,1,0
2,275,275,3,3,0,1,0
7,281,281,11,1,10,2,1
3,295,295,8,8,0,1,0
4,299,299,8,8,0,1,0
6,418,418,137,125,12,2,1
5,420,420,25,25,0,1,0

6,131,131,38,29,9,2,1
1,150,150,11,2,9,2,1
2,168,168,8,8,0,1,0
5,234,234,26,26,0,1,0
0,322,322,78,78,0,1,0
3,399,399,15,15,0,1,0
4,434,434,4,1,3,2,1

5,111,111,26,14,12,3,2
2,167,167,19,19,0,1,0
0,215,215,38,13,25,2,1
6,236,236,23,23,0,1,0
4,446,446,35,35,0,1,0
1,454,454,6,6,0,1,0
3,470,470,46,46,0,1,0

4,105,105,1,1,0,1,0
2,150,150,23,11,12,4,3
6,210,210,70,32,38,2,1
7,231,231,3,3,0,1,0
8,307,307,18,5,13,2,1
0,343,343,8,8,0,1,0
5,409,409,64,22,42,2,1
1,416,416,17,17,0,1,0
3,424,424,7,4,3,2,1

7,192,192,15,15,0,1,0
0,207,207,14,14,0,1,0
2,214,214,1,1,0,1,0
6,234,234,1,1,0,1,0
5,244,244,6,6,0,1,0
4,269,269,4,4,0,1,0
1,292,292,17,1,16,3,2
11,336,336,13,13,0,1,0
10,340,340,20,20,0,1,0
12,364,364,43,43,0,1,0
9,390,390,8,5,3,2,1
13,397,397,106,106,0,1,0
14,415,415,8,2,6,2,1
3,457,457,1,1,0,1,0
8,461,461,14,14,0,1,0

4,111,111,18,9,9,4,3
7,143,143,24,8,16,2,1
2,170,170,9,1,8,2,1
6,244,244,48,17,31,2,1
5,324,324,14,14,0,1,0
0,440,440,50,14,36,4,3
1,483,483,9,9,0,1,0
3,500,500,30,20,10,3,2

8,156,156,2,2,0,1,0
0,163,163,2,2,0,1,0
7,272,272,33,33,0,1,0
1,294,294,5,5,0,1,0
4,313,313,6,6,0,1,0
5,328,328,51,21,30,3,2
2,388,388,68,68,0,1,0
3,458,458,10,10,0,1,0
6,473,473,130,130,0,1,0

2,124,124,5,2,3,2,1
7,174,174,26,26,0,1,0
5,192,192,34,25,9,2,1
3,340,340,1,1,0,1,0
4,445,445,12,12,0,1,0
1,448,448,1,1,0,1,0
8,472,472,79,24,55,4,3
0,482,482,73,73,0,1,0
6,488,488,44,15,29,2,1

1,142,142,36,16,20,4,3
5,155,155,30,24,6,3,2
2,190,190,8,8,0,1,0
3,276,276,5,5,0,1,0
0,400,400,43,25,18,2,1
4,405,405,79,1,78,4,3

5,203,203,65,65,0,1,0
0,227,227,4,4,0,1,0
4,267,267,69,41,28,2,1
6,312,312,10,10,0,1,0
3,444,444,4,1,3,2,1
2,449,449,50,17,33,4,3
7,462,462,24,24,0,1,0
1,463,463,2,2,0,1,0

5,132,132,4,4,0,1,0
9,195,195,20,13,7,2,1
8,266,266,20,20,0,1,0
4,310,310,22,2,20,3,2
0,358,358,16,1,15,2,1
10,367,367,84,17,67,3,2
7,394,394,47,47,0,1,0
6,420,420,4,1,3,2,1
2,466,466,10,10,0,1,0
3,470,470,5,5,0,1,0
1,485,485,46,46,0,1,0

1,139,139,7,7,0,1,0
8,156,156,42,42,0,1,0
6,158,158,2,2,0,1,0
2,184,184,5,5,0,1,0
4,213,213,12,12,0,1,0
5,284,284,1,1,0,1,0
3,296,296,14,5,9,2,1
0,379,379,31,26,5,2,1
9,431,431,57,21,36,4,3
10,482,482,2,2,0,1,0
7,500,500,61,15,46,2,1

2,101,101,9,9,0,1,0
4,257,257,15,15,0,1,0
3,295,295,101,44,57,4,3
5,327,327,2,2,0,1,0
0,366,366,102,28,74,4,3
1,459,459,16,4,12,3,2

4,105,105,9,3,6,3,2
6,202,202,1,1,0,1,0
3,336,336,23,19,4,2,1
2,397,397,40,12,28,2,1
1,446,446,1,1,0,1,0
0,452,452,104,104,0,1,0
5,464,464,148,138,10,2,1

1,165,165,17,17,0,1,0
2,226,226,27,13,14,2,1
5,236,236,5,5,0,1,0
7,304,304,15,15,0,1,0
0,339,339,40,40,0,1,0
3,347,347,1,1,0,1,0
4,436,436,25,14,11,2,1
6,462,462,154,154,0,1,0

1,110,110,17,5,12,4,3
0,121,121,22,22,0,1,0
6,183,183,6,6,0,1,0
3,276,276,15,15,0,1,0
2,375,375,4,4,0,1,0
5,456,456,28,28,0,1,0
4,499,499,154,16,138,4,3

5,143,143,1,1,0,1,0
2,193,193,19,19,0,1,0
8,199,199,22,1,21,3,2
0,208,208,11,1,10,3,2
10,315,315,38,38,0,1,0
9,328,328,56,56,0,1,0
4,353,353,8,8,0,1,0
7,418,418,4,1,3,2,1
1,439,439,31,11,20,3,2
3,481,481,18,8,10,2,1
6,500,500,51,51,0,1,0

3,188,188,7,7,0,1,0
4,285,285,79,79,0,1,0
0,367,367,90,90,0,1,0
1,388,388,61,49,12,2,1
2,445,445,40,1,39,4,3

1,109,109,17,17,0,1,0
7,205,205,13,13,0,1,0
3,228,228,1,1,0,1,0
8,246,246,1,1,0,1,0
6,297,297,102,102,0,1,0
0,298,298,28,28,0,1,0
4,387,387,29,29,0,1,0
5,410,410,20,13,7,2,1
2,491,491,11,11,0,1,0

0,122,122,15,10,5,2,1
1,133,133,17,17,0,1,0
3,168,168,21,21,0,1,0
6,316,316,59,6,53,4,3
7,341,341,15,15,0,1,0
5,436,436,75,75,0,1,0
2,461,461,4,4,0,1,0
4,463,463,8,8,0,1,0

5,115,115,9,1,8,2,1
2,154,154,2,2,0,1,0
9,214,214,33,16,17,2,1
0,226,226,13,13,0,1,0
1,239,239,6,6,0,1,0
7,290,290,11,11,0,1,0
4,309,309,43,4,39,2,1
6,331,331,7,2,5,2,1
3,339,339,10,10,0,1,0
8,419,419,17,4,13,2,1
10,486,486,102,1,101,4,3

1,101,101,15,15,0,1,0
4,219,219,30,25,5,2,1
2,294,294,14,8,6,2,1
0,298,298,61,19,42,4,3
3,384,384,51,51,0,1,0
5,389,389,53,53,0,1,0

3,113,113,1,1,0,1,0
2,197,197,52,52,0,1,0
7,263,263,55,55,0,1,0
9,295,295,6,6,0,1,0
5,332,332,12,12,0,1,0
1,340,340,1,1,0,1,0
0,355,355,21,7,14,2,1
6,380,380,5,5,0,1,0
4,395,395,7,3,4,2,1
8,434,434,75,57,18,3,2

3,122,122,9,6,3,2,1
4,188,188,16,16,0,1,0
7,218,218,38,3,35,2,1
6,305,305,41,41,0,1,0
8,318,318,31,31,0,1,0
2,374,374,17,4,13,2,1
0,412,412,14,14,0,1,0
5,426,426,58,49,9,2,1
1,438,438,12,6,6,2,1

2,110,110,7,7,0,1,0
6,159,159,1,1,0,1,0
3,261,261,65,65,0,1,0
4,406,406,60,19,41,3,2
1,445,445,27,27,0,1,0
5,450,450,113,113,0,1,0
0,496,496,14,2,12,3,2

6,218,218,11,7,4,2,1
3,233,233,2,2,0,1,0
4,260,260,3,3,0,1,0
5,340,340,116,31,85,4,3
2,422,422,42,42,0,1,0
0,423,423,32,32,0,1,0
1,490,490,107,50,57,4,3

3,104,104,11,2,9,2,1
0,153,153,59,1,58,3,2
4,240,240,62,53,9,4,3
2,394,394,16,4,12,4,3
1,445,445,7,7,0,1,0

8,119,119,15,15,0,1,0
1,132,132,7,7,0,1,0
6,139,139,13,13,0,1,0
5,212,212,1,1,0,1,0
9,247,247,66,45,21,4,3
2,263,263,52,52,0,1,0
4,282,282,5,2,3,2,1
7,310,310,4,4,0,1,0
0,452,452,9,9,0,1,0
3,491,491,10,2,8,3,2

3,296,296,9,9,0,1,0
0,304,304,20,20,0,1,0
1,333,333,21,5,16,3,2
2,335,335,91,85,6,3,2
5,383,383,133,101,32,2,1
4,410,410,12,2,10,3,2

2,100,100,1,1,0,1,0
3,131,131,5,2,3,2,1
6,131,131,16,1,15,4,3
5,189,189,8,3,5,2,1
0,227,227,25,14,11,2,1
1,243,243,59,1,58,4,3
4,244,244,59,59,0,1,0

9,143,143,14,14,0,1,0
7,247,247,35,35,0,1,0
4,251,251,1,1,0,1,0
6,262,262,32,32,0,1,0
1,287,287,7,4,3,2,1
10,308,308,69,69,0,1,0
5,338,338,1,1,0,1,0
3,375,375,27,27,0,1,0
2,477,477,5,2,3,2,1
0,481,481,12,1,11,2,1
8,493,493,41,41,0,1,0

0,166,166,67,40,27,2,1
3,176,176,13,13,0,1,0
2,354,354,91,64,27,2,1
1,380,380,29,9,20,2,1

10,118,118,21,21,0,1,0
2,124,124,12,4,8,3,2
6,173,173,3,3,0,1,0
0,199,199,21,21,0,1,0
4,221,221,12,3,9,2,1
7,225,225,1,1,0,1,0
3,257,257,11,11,0,1,0
8,271,271,11,11,0,1,0
11,315,315,14,6,8,2,1
1,359,359,7,7,0,1,0
5,378,378,8,8,0,1,0
9,395,395,71,40,31,2,1

2,118,118,11,11,0,1,0
7,120,120,12,12,0,1,0
8,186,186,44,44,0,1,0
4,189,189,5,5,0,1,0
3,248,248,1,1,0,1,0
0,255,255,14,2,12,3,2
1,310,310,65,39,26,2,1
5,439,439,6,6,0,1,0
6,452,452,32,32,0,1,0

1,243,243,8,2,6,2,1
0,257,257,2,2,0,1,0
3,290,290,2,2,0,1,0
2,327,327,7,7,0,1,0
9,345,345,13,13,0,1,0
8,361,361,23,23,0,1,0
5,422,422,94,36,58,4,3
6,438,438,47,47,0,1,0
7,485,485,146,32,114,4,3
4,490,490,1,1,0,1,0

2,245,245,15,8,7,2,1
6,301,301,10,10,0,1,0
3,319,319,49,49,0,1,0
4,420,420,98,98,0,1,0
0,460,460,75,50,25,2,1
1,463,463,11,5,6,2,1
5,468,468,64,59,5,2,1

4,203,203,43,43,0,1,0
0,239,239,25,17,8,3,2
5,265,265,8,8,0,1,0
3,375,375,62,3,59,3,2
2,400,400,69,69,0,1,0
1,480,480,59,29,30,4,3

3,102,102,3,3,0,1,0
2,114,114,8,8,0,1,0
8,193,193,28,8,20,4,3
4,198,198,16,16,0,1,0
5,279,279,9,9,0,1,0
7,336,336,15,3,12,4,3
0,413,413,23,23,0,1,0
1,444,444,59,35,24,4,3
6,444,444,97,46,51,4,3

0,112,112,11,11,0,1,0
4,118,118,20,16,4,2,1
1,212,212,8,1,7,2,1
7,216,216,7,2,5,2,1
6,277,277,27,27,0,1,0
2,281,281,20,20,0,1,0
8,313,313,86,39,47,4,3
3,343,343,1,1,0,1,0
5,454,454,10,10,0,1,0

3,191,191,3,3,0,1,0
1,238,238,16,16,0,1,0
4,294,294,42,26,16,3,2
6,306,306,67,37,30,2,1
2,364,364,28,11,17,2,1
5,389,389,16,8,8,3,2
0,476,476,115,52,63,4,3

0,137,137,24,12,12,2,1
3,184,184,1,1,0,1,0
6,196,196,15,1,14,2,1
4,290,290,3,3,0,1,0
1,441,441,24,2,22,3,2
5,451,451,142,34,108,4,3
2,454,454,75,53,22,2,1

1,287,287,10,10,0,1,0
3,307,307,8,5,3,2,1
4,323,323,56,8,48,3,2
5,343,343,36,24,12,3,2
6,376,376,7,7,0,1,0
8,430,430,24,3,21,2,1
7,459,459,37,23,14,3,2
9,477,477,128,128,0,1,0
2,479,479,20,10,10,2,1
0,490,490,1,1,0,1,0

4,114,114,10,10,0,1,0
3,170,170,8,8,0,1,0
5,218,218,60,48,12,2,1
0,227,227,60,60,0,1,0
2,298,298,23,1,22,2,1
1,465,465,28,28,0,1,0

1,181,181,9,6,3,2,1
7,199,199,9,9,0,1,0
4,216,216,11,11,0,1,0
8,236,236,73,73,0,1,0
3,272,272,17,17,0,1,0
0,319,319,11,11,0,1,0
6,335,335,18,13,5,2,1
2,472,472,28,28,0,1,0
5,483,483,70,35,35,2,1

3,161,161,10,6,4,2,1
7,226,226,1,1,0,1,0
6,241,241,1,1,0,1,0
9,261,261,1,1,0,1,0
4,262,262,1,1,0,1,0
8,333,333,7,3,4,2,1
11,374,374,71,47,24,4,3
2,384,384,12,12,0,1,0
10,406,406,85,85,0,1,0
1,431,431,21,21,0,1,0
5,461,461,86,86,0,1,0
0,473,473,19,19,0,1,0

0,120,120,36,3,33,4,3
4,203,203,36,27,9,4,3
2,395,395,21,21,0,1,0
1,490,490,49,49,0,1,0
3,492,492,86,55,31,2,1

2,128,128,1,1,0,1,0
5,139,139,16,4,12,2,1
4,190,190,21,6,15,4,3
3,197,197,10,7,3,2,1
6,314,314,58,34,24,4,3
1,424,424,6,6,0,1,0
0,458,458,151,109,42,2,1

1,147,147,16,11,5,2,1
2,304,304,12,6,6,2,1
0,329,329,98,78,20,3,2
4,368,368,6,3,3,2,1
3,420,420,145,145,0,1,0

2,120,120,3,3,0,1,0
6,126,126,16,4,12,2,1
8,128,128,13,13,0,1,0
7,176,176,33,21,12,2,1
4,328,328,13,13,0,1,0
3,376,376,30,9,21,4,3
1,422,422,40,35,5,2,1
5,449,449,32,32,0,1,0
0,472,472,43,43,0,1,0

1,105,105,3,3,0,1,0
6,152,152,15,15,0,1,0
8,156,156,45,38,7,2,1
5,162,162,25,2,23,2,1
0,170,170,4,4,0,1,0
2,210,210,11,8,3,2,1
4,228,228,26,26,0,1,0
7,430,430,7,7,0,1,0
3,432,432,14,5,9,2,1

5,170,170,7,7,0,1,0
6,201,201,50,50,0,1,0
2,206,206,11,11,0,1,0
3,320,320,22,22,0,1,0
0,421,421,110,32,78,4,3
4,441,441,53,47,6,3,2
1,482,482,9,9,0,1,0

7,178,178,26,8,18,4,3
1,198,198,5,5,0,1,0
4,291,291,1,1,0,1,0
5,303,303,9,9,0,1,0
2,305,305,52,8,44,3,2
6,389,389,71,71,0,1,0
0,436,436,48,39,9,4,3
3,444,444,28,28,0,1,0
8,467,467,36,36,0,1,0

9,164,164,6,6,0,1,0
6,186,186,4,1,3,2,1
1,205,205,7,3,4,2,1
0,206,206,11,11,0,1,0
3,214,214,10,10,0,1,0
2,240,240,6,6,0,1,0
8,271,271,30,18,12,2,1
10,358,358,94,94,0,1,0
7,363,363,67,21,46,2,1
4,392,392,13,4,9,4,3
5,496,496,1,1,0,1,0

4,116,116,11,8,3,2,1
5,154,154,12,12,0,1,0
0,206,206,2,2,0,1,0
2,229,229,12,6,6,2,1
6,256,256,47,13,34,3,2
7,380,380,2,2,0,1,0
1,387,387,55,55,0,1,0
3,392,392,11,11,0,1,0
8,498,498,107,41,66,3,2

0,111,111,1,1,0,1,0
1,182,182,17,3,14,3,2
7,240,240,21,21,0,1,0
2,335,335,24,6,18,2,1
6,356,356,8,2,6,2,1
4,362,362,11,11,0,1,0
3,367,367,49,10,39,3,2
8,466,466,138,138,0,1,0
5,477,477,30,30,0,1,0

6,156,156,27,27,0,1,0
5,163,163,8,2,6,2,1
8,205,205,37,37,0,1,0
4,236,236,48,48,0,1,0
3,259,259,6,3,3,2,1
1,263,263,16,8,8,3,2
0,329,329,11,1,10,2,1
7,369,369,18,9,9,4,3
2,470,470,15,2,13,2,1

0,104,104,1,1,0,1,0
1,125,125,9,1,8,2,1
3,127,127,23,1,22,2,1
4,165,165,10,4,6,3,2
7,202,202,13,9,4,2,1
6,275,275,57,2,55,3,2
2,398,398,31,31,0,1,0
5,411,411,55,55,0,1,0

5,125,125,3,3,0,1,0
2,131,131,32,14,18,3,2
1,185,185,13,4,9,4,3
6,367,367,68,68,0,1,0
4,385,385,77,77,0,1,0
3,415,415,12,12,0,1,0
0,484,484,28,28,0,1,0

6,123,123,5,5,0,1,0
5,162,162,3,3,0,1,0
8,236,236,28,1,27,4,3
0,281,281,4,4,0,1,0
1,287,287,2,2,0,1,0
7,325,325,12,12,0,1,0
4,338,338,90,90,0,1,0
3,368,368,17,12,5,2,1
2,407,407,3,3,0,1,0
9,473,473,119,119,0,1,0

6,111,111,4,4,0,1,0
8,124,124,18,5,13,2,1
3,134,134,1,1,0,1,0
9,135,135,1,1,0,1,0
7,170,170,45,33,12,4,3
1,226,226,14,10,4,2,1
0,356,356,39,39,0,1,0
4,373,373,44,44,0,1,0
5,390,390,15,7,8,2,1
2,404,404,13,2,11,2,1

8,231,231,60,60,0,1,0
2,235,235,12,12,0,1,0
9,273,273,10,10,0,1,0
0,305,305,10,10,0,1,0
3,306,306,10,3,7,2,1
6,368,368,1,1,0,1,0
4,407,407,17,7,10,4,3
5,443,443,44,26,18,4,3
7,450,450,4,4,0,1,0
10,475,475,52,35,17,2,1
1,481,481,63,27,36,3,2

13,105,105,26,1,25,2,1
0,117,117,1,1,0,1,0
12,145,145,19,19,0,1,0
3,176,176,4,1,3,2,1
1,188,188,1,1,0,1,0
5,193,193,11,6,5,2,1
6,231,231,14,14,0,1,0
2,318,318,5,5,0,1,0
8,334,334,11,11,0,1,0
4,348,348,10,4,6,2,1
7,377,377,37,12,25,2,1
9,402,402,16,16,0,1,0
10,415,415,13,5,8,3,2
11,494,494,18,3,15,2,1

7,107,107,15,2,13,2,1
5,166,166,41,41,0,1,0
4,249,249,3,3,0,1,0
0,291,291,4,4,0,1,0
1,305,305,48,8,40,2,1
2,393,393,4,4,0,1,0
6,440,440,9,2,7,2,1
3,443,443,93,20,73,3,2

1,105,105,7,7,0,1,0
2,152,152,32,12,20,4,3
5,161,161,12,12,0,1,0
4,178,178,21,21,0,1,0
0,379,379,47,24,23,2,1
3,430,430,94,46,48,3,2

6,221,221,45,24,21,4,3
8,297,297,6,6,0,1,0
4,340,340,27,13,14,3,2
3,380,380,36,24,12,4,3
2,401,401,26,16,10,2,1
0,409,409,14,14,0,1,0
7,419,419,76,76,0,1,0
5,465,465,45,24,21,4,3
1,496,496,15,15,0,1,0

2,122,122,29,29,0,1,0
0,124,124,12,12,0,1,0
3,172,172,11,2,9,4,3
5,346,346,35,6,29,2,1
1,397,397,27,15,12,3,2
4,483,483,117,71,46,4,3

4,181,181,46,32,14,2,1
1,214,214,3,3,0,1,0
3,295,295,42,42,0,1,0
0,450,450,174,105,69,4,3
2,463,463,4,1,3,2,1

5,104,104,1,1,0,1,0
2,178,178,2,2,0,1,0
1,191,191,6,3,3,2,1
8,199,199,11,11,0,1,0
6,290,290,6,6,0,1,0
7,337,337,112,64,48,2,1
0,368,368,38,38,0,1,0
3,379,379,31,31,0,1,0
4,471,471,79,79,0,1,0

6,110,110,14,1,13,2,1
4,162,162,7,7,0,1,0
3,171,171,10,2,8,2,1
0,211,211,12,6,6,2,1
8,211,211,19,19,0,1,0
1,216,216,16,11,5,2,1
2,223,223,36,36,0,1,0
5,326,326,2,2,0,1,0
7,455,455,86,68,18,4,3

3,141,141,18,4,14,2,1
2,226,226,15,15,0,1,0
6,230,230,39,12,27,4,3
5,240,240,16,10,6,2,1
1,331,331,1,1,0,1,0
0,399,399,14,14,0,1,0
4,411,411,69,69,0,1,0
7,455,455,77,19,58,3,2

1,197,197,11,1,10,2,1
8,227,227,42,42,0,1,0
4,301,301,2,2,0,1,0
6,388,388,58,16,42,3,2
7,388,388,45,18,27,3,2
0,405,405,1,1,0,1,0
9,412,412,43,43,0,1,0
3,459,459,70,70,0,1,0
2,485,485,16,16,0,1,0
5,499,499,1,1,0,1,0

3,121,121,24,24,0,1,0
4,160,160,8,8,0,1,0
9,177,177,11,11,0,1,0
5,211,211,9,9,0,1,0
0,294,294,14,3,11,2,1
6,310,310,5,5,0,1,0
7,341,341,52,52,0,1,0
2,359,359,15,5,10,2,1
1,396,396,2,2,0,1,0
8,456,456,87,87,0,1,0

8,152,152,2,2,0,1,0
1,163,163,2,2,0,1,0
2,312,312,16,16,0,1,0
6,329,329,88,88,0,1,0
3,352,352,3,3,0,1,0
5,375,375,89,89,0,1,0
7,401,401,51,51,0,1,0
4,485,485,44,33,11,2,1
0,495,495,1,1,0,1,0

0,118,118,33,7,26,2,1
5,123,123,3,3,0,1,0
6,141,141,31,31,0,1,0
1,295,295,12,12,0,1,0
3,328,328,15,11,4,2,1
2,373,373,13,13,0,1,0
4,399,399,65,8,57,4,3

2,121,121,5,5,0,1,0
7,123,123,28,28,0,1,0
0,164,164,23,23,0,1,0
5,164,164,24,13,11,2,1
6,272,272,11,2,9,4,3
3,310,310,1,1,0,1,0
1,354,354,47,47,0,1,0
4,408,408,34,34,0,1,0

2,155,155,4,4,0,1,0
3,199,199,19,19,0,1,0
0,219,219,42,15,27,2,1
4,271,271,15,1,14,3,2
7,295,295,18,14,4,2,1
5,333,333,84,84,0,1,0
6,397,397,36,36,0,1,0
1,495,495,17,17,0,1,0

4,165,165,53,19,34,3,2
1,186,186,14,14,0,1,0
5,196,196,13,13,0,1,0
2,236,236,62,53,9,2,1
0,273,273,17,17,0,1,0
3,291,291,6,1,5,2,1

1,120,120,8,8,0,1,0
2,161,161,12,12,0,1,0
9,190,190,28,16,12,2,1
7,231,231,24,5,19,2,1
0,235,235,25,25,0,1,0
4,323,323,26,1,25,4,3
3,331,331,5,5,0,1,0
5,348,348,14,4,10,2,1
6,471,471,8,2,6,3,2
8,481,481,76,76,0,1,0

1,156,156,7,7,0,1,0
5,206,206,55,41,14,3,2
2,307,307,2,2,0,1,0
0,310,310,17,8,9,4,3
6,365,365,13,7,6,3,2
7,406,406,42,42,0,1,0
4,408,408,120,120,0,1,0
3,499,499,1,1,0,1,0

1,235,235,52,52,0,1,0
0,342,342,137,137,0,1,0
3,347,347,5,5,0,1,0
2,491,491,82,37,45,3,2

5,124,124,20,20,0,1,0
1,174,174,1,1,0,1,0
7,258,258,46,10,36,4,3
3,279,279,68,39,29,2,1
2,340,340,3,3,0,1,0
0,423,423,25,25,0,1,0
6,429,429,29,5,24,3,2
4,448,448,38,3,35,4,3

6,118,118,4,4,0,1,0
2,214,214,28,19,9,4,3
8,225,225,4,4,0,1,0
9,242,242,88,50,38,3,2
4,257,257,14,14,0,1,0
0,261,261,12,12,0,1,0
3,282,282,2,2,0,1,0
7,333,333,30,30,0,1,0
5,365,365,1,1,0,1,0
1,401,401,15,15,0,1,0
10,456,456,11,11,0,1,0

0,146,146,19,7,12,3,2
6,159,159,58,58,0,1,0
2,195,195,1,1,0,1,0
4,196,196,5,5,0,1,0
1,389,389,34,34,0,1,0
5,407,407,7,7,0,1,0
3,437,437,78,78,0,1,0

2,110,110,13,13,0,1,0
7,191,191,21,21,0,1,0
6,224,224,32,14,18,3,2
1,309,309,18,18,0,1,0
4,384,384,21,10,11,2,1
0,438,438,15,6,9,4,3
3,460,460,63,63,0,1,0
5,463,463,70,27,43,2,1

0,143,143,14,5,9,4,3
1,201,201,6,6,0,1,0
6,235,235,11,6,5,2,1
4,249,249,35,24,11,2,1
3,281,281,4,1,3,2,1
7,306,306,4,1,3,2,1
9,323,323,103,7,96,3,2
8,356,356,26,3,23,2,1
5,363,363,26,26,0,1,0
2,385,385,1,1,0,1,0

2,151,151,1,1,0,1,0
4,189,189,19,8,11,2,1
0,195,195,42,42,0,1,0
3,260,260,25,25,0,1,0
1,270,270,23,14,9,4,3
5,312,312,37,33,4,2,1
6,337,337,63,63,0,1,0

5,108,108,4,4,0,1,0
3,127,127,6,1,5,2,1
7,131,131,47,47,0,1,0
0,137,137,1,1,0,1,0
8,179,179,8,8,0,1,0
2,290,290,69,57,12,2,1
4,296,296,10,10,0,1,0
6,317,317,1,1,0,1,0
1,395,395,16,16,0,1,0

0,176,176,63,63,0,1,0
1,211,211,9,6,3,2,1
4,309,309,66,43,23,2,1
3,355,355,31,2,29,4,3
2,461,461,48,48,0,1,0

2,121,121,1,1,0,1,0
5,206,206,45,45,0,1,0
1,259,259,21,9,12,4,3
0,278,278,37,37,0,1,0
3,306,306,9,9,0,1,0
6,317,317,49,7,42,3,2
7,321,321,10,4,6,3,2
4,489,489,73,2,71,4,3

6,146,146,8,8,0,1,0
3,273,273,24,14,10,2,1
0,382,382,30,30,0,1,0
2,430,430,35,35,0,1,0
4,461,461,40,40,0,1,0
5,464,464,118,24,94,3,2
1,471,471,31,25,6,3,2
7,486,486,47,32,15,2,1

1,100,100,1,1,0,1,0
7,237,237,37,37,0,1,0
5,278,278,26,17,9,4,3
8,315,315,63,63,0,1,0
6,337,337,17,17,0,1,0
2,342,342,46,46,0,1,0
4,402,402,22,10,12,2,1
3,436,436,33,33,0,1,0
0,442,442,15,15,0,1,0

5,121,121,2,2,0,1,0
4,195,195,14,14,0,1,0
3,206,206,2,2,0,1,0
2,208,208,11,4,7,2,1
8,383,383,60,44,16,2,1
0,414,414,17,17,0,1,0
6,459,459,15,5,10,3,2
1,476,476,101,78,23,2,1
7,478,478,103,98,5,2,1

2,232,232,18,18,0,1,0
5,244,244,14,2,12,2,1
3,269,269,1,1,0,1,0
0,313,313,9,9,0,1,0
1,405,405,70,70,0,1,0
4,432,432,51,51,0,1,0
6,492,492,43,43,0,1,0
7,495,495,129,6,123,4,3

0,141,141,9,9,0,1,0
4,145,145,25,11,14,2,1
2,309,309,24,24,0,1,0
3,331,331,5,5,0,1,0
1,462,462,120,24,96,3,2
5,476,476,102,84,18,3,2

0,154,154,20,20,0,1,0
6,223,223,36,14,22,2,1
3,236,236,54,13,41,4,3
2,261,261,1,1,0,1,0
5,277,277,35,35,0,1,0
4,317,317,38,20,18,3,2
1,397,397,16,8,8,3,2

3,109,109,5,1,4,2,1
2,140,140,5,5,0,1,0
4,150,150,9,9,0,1,0
1,270,270,7,1,6,3,2
5,325,325,23,23,0,1,0
6,360,360,21,21,0,1,0
9,392,392,65,65,0,1,0
0,413,413,43,32,11,2,1
8,471,471,56,56,0,1,0
7,475,475,56,56,0,1,0

4,234,234,61,19,42,3,2
3,314,314,17,17,0,1,0
2,341,341,31,4,27,2,1
1,344,344,122,36,86,4,3
0,481,481,23,23,0,1,0

7,118,118,11,2,9,4,3
0,166,166,1,1,0,1,0
3,260,260,14,14,0,1,0
6,277,277,69,34,35,2,1
8,281,281,18,18,0,1,0
4,288,288,7,7,0,1,0
1,337,337,15,1,14,3,2
2,446,446,100,75,25,2,1
5,485,485,23,23,0,1,0

1,144,144,48,4,44,3,2
2,322,322,43,6,37,2,1
4,364,364,40,15,25,2,1
0,397,397,29,22,7,2,1
3,409,409,65,27,38,2,1

6,254,254,32,2,30,2,1
5,280,280,10,10,0,1,0
2,330,330,4,4,0,1,0
3,407,407,28,25,3,2,1
1,443,443,42,27,15,4,3
4,462,462,112,93,19,2,1
0,499,499,112,99,13,2,1

9,104,104,8,8,0,1,0
3,148,148,5,5,0,1,0
5,160,160,2,2,0,1,0
1,219,219,14,14,0,1,0
2,220,220,1,1,0,1,0
0,228,228,13,13,0,1,0
10,292,292,82,16,66,3,2
6,332,332,19,1,18,2,1
11,352,352,18,6,12,3,2
4,407,407,23,11,12,2,1
8,432,432,23,7,16,2,1
7,448,448,28,11,17,2,1

5,241,241,46,22,24,2,1
2,263,263,11,1,10,2,1
1,341,341,49,49,0,1,0
0,404,404,87,56,31,4,3
3,464,464,87,61,26,3,2
4,476,476,13,10,3,2,1

0,211,211,1,1,0,1,0
4,300,300,35,35,0,1,0
7,347,347,26,7,19,2,1
6,360,360,21,6,15,2,1
2,369,369,14,14,0,1,0
5,402,402,108,66,42,2,1
3,433,433,13,9,4,2,1
1,490,490,104,8,96,3,2

3,256,256,13,4,9,4,3
1,263,263,37,5,32,2,1
7,341,341,6,1,5,2,1
0,354,354,16,16,0,1,0
4,383,383,49,7,42,3,2
2,433,433,16,16,0,1,0
6,493,493,65,65,0,1,0
5,498,498,127,68,59,3,2

2,182,182,39,39,0,1,0
4,234,234,24,11,13,2,1
0,248,248,52,4,48,4,3
3,306,306,27,27,0,1,0
1,431,431,83,83,0,1,0

1,162,162,44,44,0,1,0
0,234,234,31,31,0,1,0
2,245,245,76,76,0,1,0
4,354,354,21,21,0,1,0
3,432,432,15,15,0,1,0

2,129,129,9,1,8,3,2
0,259,259,45,33,12,4,3
3,303,303,40,12,28,3,2
1,321,321,73,73,0,1,0
4,374,374,76,76,0,1,0

2,264,264,13,7,6,3,2
1,322,322,23,23,0,1,0
6,328,328,93,93,0,1,0
7,374,374,16,16,0,1,0
5,376,376,29,18,11,2,1
3,404,404,32,7,25,2,1
0,427,427,22,22,0,1,0
4,490,490,73,37,36,3,2

4,174,174,36,36,0,1,0
3,259,259,25,1,24,4,3
6,286,286,5,2,3,2,1
2,339,339,27,13,14,2,1
0,395,395,84,63,21,4,3
1,460,460,6,2,4,2,1
5,483,483,86,86,0,1,0

2,172,172,2,2,0,1,0
1,193,193,9,9,0,1,0
4,209,209,44,44,0,1,0
0,218,218,7,1,6,2,1
3,229,229,23,4,19,2,1
5,346,346,28,28,0,1,0
6,413,413,119,32,87,3,2
7,486,486,17,17,0,1,0

1,190,190,28,20,8,3,2
0,339,339,10,10,0,1,0
5,344,344,37,28,9,2,1
3,375,375,12,6,6,3,2
6,426,426,83,31,52,3,2
7,429,429,44,38,6,2,1
2,494,494,88,88,0,1,0
4,500,500,7,7,0,1,0

4,126,126,16,4,12,4,3
3,188,188,5,5,0,1,0
5,241,241,60,40,20,2,1
1,337,337,83,12,71,4,3
6,375,375,12,1,11,2,1
0,447,447,11,11,0,1,0
2,455,455,49,27,22,2,1

8,215,215,8,1,7,2,1
1,216,216,1,1,0,1,0
10,217,217,33,11,22,2,1
9,254,254,25,25,0,1,0
4,272,272,17,9,8,3,2
11,299,299,46,4,42,3,2
7,356,356,18,18,0,1,0
2,367,367,35,35,0,1,0
6,461,461,7,7,0,1,0
0,481,481,29,29,0,1,0
5,481,481,10,10,0,1,0
3,500,500,28,16,12,4,3

0,142,142,13,13,0,1,0
1,157,157,18,1,17,2,1
7,272,272,74,50,24,4,3
8,275,275,2,2,0,1,0
6,286,286,37,2,35,2,1
4,297,297,19,9,10,2,1
2,379,379,10,10,0,1,0
3,434,434,38,38,0,1,0
5,445,445,8,4,4,2,1

7,116,116,4,1,3,2,1
1,167,167,5,5,0,1,0
5,171,171,1,1,0,1,0
0,283,283,23,23,0,1,0
6,287,287,56,56,0,1,0
9,337,337,97,91,6,3,2
3,421,421,1,1,0,1,0
2,455,455,15,6,9,2,1
8,456,456,36,23,13,2,1
4,472,472,25,9,16,3,2

5,156,156,6,6,0,1,0
6,156,156,29,16,13,2,1
7,336,336,21,16,5,2,1
9,348,348,26,26,0,1,0
0,372,372,23,23,0,1,0
2,416,416,26,26,0,1,0
1,432,432,11,11,0,1,0
4,443,443,10,10,0,1,0
3,470,470,2,2,0,1,0
8,490,490,131,32,99,4,3

6,112,112,1,1,0,1,0
9,132,132,5,5,0,1,0
5,215,215,37,18,19,2,1
8,230,230,69,69,0,1,0
10,241,241,17,8,9,4,3
4,242,242,1,1,0,1,0
3,257,257,14,2,12,3,2
1,296,296,4,4,0,1,0
0,435,435,20,20,0,1,0
2,469,469,5,2,3,2,1
7,481,481,44,6,38,2,1

4,127,127,1,1,0,1,0
3,190,190,5,5,0,1,0
2,206,206,2,2,0,1,0
1,214,214,5,1,4,2,1
5,235,235,15,15,0,1,0
0,264,264,7,7,0,1,0
10,274,274,98,50,48,4,3
8,290,290,1,1,0,1,0
7,340,340,16,16,0,1,0
6,443,443,87,87,0,1,0
9,490,490,21,13,8,2,1

3,139,139,14,6,8,3,2
4,157,157,10,10,0,1,0
9,196,196,12,5,7,2,1
5,246,246,22,12,10,3,2
0,331,331,1,1,0,1,0
8,387,387,130,104,26,2,1
7,410,410,32,32,0,1,0
1,421,421,16,9,7,2,1
10,435,435,4,4,0,1,0
6,482,482,10,10,0,1,0
2,484,484,4,4,0,1,0

6,124,124,15,15,0,1,0
4,164,164,16,7,9,4,3
5,193,193,3,3,0,1,0
0,218,218,20,8,12,3,2
1,219,219,27,27,0,1,0
2,234,234,1,1,0,1,0
3,252,252,18,18,0,1,0
7,344,344,31,31,0,1,0
8,383,383,75,35,40,2,1

5,112,112,5,5,0,1,0
1,125,125,9,9,0,1,0
4,159,159,34,34,0,1,0
3,224,224,33,33,0,1,0
0,285,285,23,23,0,1,0
2,491,491,122,22,100,3,2

2,104,104,2,2,0,1,0
10,166,166,20,20,0,1,0
4,216,216,6,6,0,1,0
8,229,229,15,9,6,3,2
6,263,263,9,1,8,2,1
1,265,265,3,3,0,1,0
3,266,266,28,28,0,1,0
5,274,274,5,5,0,1,0
7,285,285,22,22,0,1,0
9,299,299,18,4,14,2,1
0,380,380,16,16,0,1,0
11,423,423,96,15,81,3,2

5,249,249,39,39,0,1,0
1,314,314,29,29,0,1,0
4,338,338,67,67,0,1,0
0,415,415,64,64,0,1,0
3,463,463,58,25,33,4,3
6,477,477,23,20,3,2,1
2,493,493,14,14,0,1,0

2,111,111,12,7,5,2,1
4,279,279,42,32,10,3,2
3,300,300,47,47,0,1,0
0,309,309,23,23,0,1,0
1,356,356,116,101,15,4,3

6,131,131,8,8,0,1,0
4,134,134,21,21,0,1,0
1,193,193,3,3,0,1,0
0,220,220,4,4,0,1,0
7,224,224,19,19,0,1,0
8,239,239,48,44,4,2,1
9,299,299,35,35,0,1,0
5,354,354,33,33,0,1,0
2,373,373,22,7,15,4,3
3,452,452,1,1,0,1,0

3,191,191,25,10,15,2,1
1,258,258,66,30,36,4,3
0,288,288,3,3,0,1,0
4,312,312,18,18,0,1,0
5,337,337,72,12,60,4,3
2,388,388,52,33,19,2,1

0,104,104,15,9,6,3,2
3,107,107,5,1,4,2,1
7,176,176,30,1,29,2,1
1,207,207,14,2,12,3,2
2,221,221,29,29,0,1,0
6,222,222,39,39,0,1,0
4,380,380,4,4,0,1,0
5,424,424,26,18,8,2,1

3,111,111,4,4,0,1,0
4,191,191,16,16,0,1,0
0,197,197,29,29,0,1,0
5,263,263,5,5,0,1,0
7,270,270,84,21,63,4,3
2,287,287,17,14,3,2,1
1,373,373,28,28,0,1,0
6,451,451,34,10,24,3,2

2,179,179,46,16,30,3,2
4,183,183,27,27,0,1,0
5,260,260,58,58,0,1,0
0,327,327,23,8,15,4,3
1,353,353,26,6,20,2,1
3,399,399,13,13,0,1,0

2,106,106,21,21,0,1,0
5,232,232,30,30,0,1,0
3,243,243,14,14,0,1,0
0,320,320,31,31,0,1,0
4,357,357,25,2,23,2,1
1,375,375,18,18,0,1,0
6,492,492,101,101,0,1,0

0,125,125,47,22,25,2,1
2,190,190,2,2,0,1,0
3,288,288,14,5,9,2,1
4,343,343,41,27,14,3,2
5,345,345,81,3,78,4,3
1,499,499,8,8,0,1,0

1,111,111,3,3,0,1,0
7,186,186,13,6,7,2,1
0,278,278,18,4,14,2,1
5,294,294,47,5,42,2,1
2,337,337,37,1,36,3,2
6,349,349,62,15,47,2,1
4,436,436,56,56,0,1,0
3,464,464,33,33,0,1,0

6,108,108,12,4,8,3,2
3,146,146,1,1,0,1,0
1,259,259,44,44,0,1,0
7,261,261,30,25,5,2,1
5,280,280,50,41,9,2,1
4,299,299,40,18,22,3,2
2,385,385,6,6,0,1,0
0,396,396,30,22,8,3,2

7,130,130,4,4,0,1,0
5,257,257,93,39,54,3,2
0,289,289,13,13,0,1,0
3,325,325,54,54,0,1,0
2,408,408,50,16,34,3,2
6,435,435,7,7,0,1,0
1,448,448,16,16,0,1,0
4,472,472,15,2,13,2,1

2,136,136,15,15,0,1,0
5,200,200,34,15,19,2,1
3,214,214,1,1,0,1,0
4,249,249,53,5,48,4,3
1,385,385,55,55,0,1,0
6,411,411,8,8,0,1,0
0,450,450,65,15,50,3,2

2,141,141,9,9,0,1,0
3,177,177,33,27,6,2,1
6,242,242,24,13,11,2,1
5,310,310,10,10,0,1,0
7,311,311,75,42,33,2,1
1,346,346,2,2,0,1,0
8,412,412,26,3,23,2,1
4,479,479,26,1,25,2,1
0,495,495,30,30,0,1,0

4,117,117,2,2,0,1,0
3,155,155,2,2,0,1,0
5,209,209,19,13,6,2,1
7,230,230,44,44,0,1,0
9,248,248,20,20,0,1,0
1,293,293,11,4,7,2,1
2,328,328,14,11,3,2,1
6,453,453,59,33,26,2,1
8,453,453,60,60,0,1,0
0,478,478,33,14,19,2,1

4,225,225,12,12,0,1,0
2,234,234,39,33,6,2,1
1,271,271,69,54,15,2,1
3,323,323,60,6,54,3,2
0,405,405,60,56,4,2,1

3,230,230,50,2,48,4,3
1,254,254,5,5,0,1,0
0,257,257,103,70,33,4,3
2,314,314,52,28,24,2,1

4,153,153,37,19,18,2,1
3,176,176,1,1,0,1,0
0,211,211,16,16,0,1,0
1,213,213,38,38,0,1,0
6,247,247,28,3,25,2,1
2,276,276,39,16,23,2,1
5,489,489,26,26,0,1,0

0,163,163,10,10,0,1,0
4,184,184,28,28,0,1,0
6,215,215,27,7,20,2,1
7,249,249,49,23,26,2,1
1,283,283,18,18,0,1,0
5,357,357,31,25,6,3,2
3,445,445,35,35,0,1,0
2,459,459,22,7,15,4,3

2,102,102,1,1,0,1,0
1,158,158,44,13,31,2,1
3,168,168,21,1,20,3,2
0,497,497,199,134,65,4,3

4,171,171,50,41,9,2,1
5,189,189,20,15,5,2,1
2,313,313,65,65,0,1,0
3,357,357,11,1,10,2,1
6,370,370,3,3,0,1,0
1,402,402,34,14,20,2,1
0,454,454,35,35,0,1,0

2,216,216,72,39,33,4,3
3,230,230,37,37,0,1,0
4,300,300,42,42,0,1,0
0,307,307,11,11,0,1,0
5,379,379,40,40,0,1,0
1,384,384,12,8,4,2,1

3,140,140,16,16,0,1,0
4,251,251,70,70,0,1,0
0,282,282,77,77,0,1,0
1,314,314,2,2,0,1,0
5,431,431,7,7,0,1,0
2,481,481,58,44,14,3,2

4,123,123,2,2,0,1,0
5,138,138,6,6,0,1,0
10,165,165,21,3,18,3,2
7,219,219,4,4,0,1,0
11,286,286,85,85,0,1,0
3,294,294,14,4,10,3,2
6,309,309,1,1,0,1,0
13,316,316,24,24,0,1,0
8,353,353,20,20,0,1,0
12,388,388,12,12,0,1,0
1,420,420,4,4,0,1,0
0,427,427,27,27,0,1,0
2,453,453,3,3,0,1,0
9,457,457,4,4,0,1,0

3,120,120,9,9,0,1,0
10,127,127,7,7,0,1,0
6,144,144,4,4,0,1,0
4,155,155,4,1,3,2,1
8,192,192,54,42,12,4,3
7,202,202,18,10,8,2,1
2,306,306,15,15,0,1,0
0,317,317,28,16,12,3,2
5,328,328,9,4,5,2,1
1,364,364,8,2,6,3,2
9,395,395,28,28,0,1,0

1,124,124,20,20,0,1,0
8,161,161,7,7,0,1,0
4,198,198,1,1,0,1,0
6,264,264,7,1,6,2,1
7,271,271,92,92,0,1,0
3,305,305,19,2,17,3,2
2,342,342,10,1,9,4,3
0,382,382,24,24,0,1,0
5,418,418,34,34,0,1,0

0,153,153,37,17,20,4,3
3,269,269,12,12,0,1,0
1,278,278,44,19,25,3,2
4,296,296,22,22,0,1,0
2,418,418,120,66,54,4,3

0,193,193,30,30,0,1,0
1,201,201,33,33,0,1,0
6,263,263,6,6,0,1,0
5,265,265,100,48,52,3,2
2,278,278,2,2,0,1,0
4,400,400,3,3,0,1,0
3,432,432,32,29,3,2,1

2,131,131,8,8,0,1,0
7,154,154,6,6,0,1,0
1,201,201,23,13,10,2,1
0,353,353,22,22,0,1,0
4,452,452,30,13,17,2,1
5,457,457,29,8,21,4,3
6,463,463,141,75,66,3,2
3,492,492,48,48,0,1,0

7,101,101,2,2,0,1,0
8,145,145,32,5,27,2,1
0,284,284,18,18,0,1,0
4,297,297,7,1,6,2,1
2,316,316,8,8,0,1,0
3,317,317,10,10,0,1,0
6,370,370,60,18,42,3,2
1,446,446,15,3,12,2,1
5,486,486,109,51,58,3,2

2,118,118,5,5,0,1,0
3,143,143,33,33,0,1,0
0,323,323,12,4,8,2,1
4,364,364,2,2,0,1,0
5,378,378,118,49,69,3,2
1,401,401,38,38,0,1,0
6,424,424,37,37,0,1,0

2,114,114,5,5,0,1,0
6,127,127,12,4,8,2,1
4,239,239,36,36,0,1,0
1,287,287,7,7,0,1,0
0,340,340,2,2,0,1,0
3,346,346,113,105,8,3,2
5,496,496,79,79,0,1,0

5,109,109,17,13,4,2,1
6,196,196,7,2,5,2,1
3,241,241,2,2,0,1,0
2,302,302,108,18,90,4,3
1,310,310,8,8,0,1,0
4,329,329,71,13,58,3,2
0,487,487,6,1,5,2,1

3,159,159,5,5,0,1,0
7,187,187,10,5,5,2,1
1,228,228,1,1,0,1,0
0,270,270,76,67,9,4,3
4,374,374,24,24,0,1,0
2,381,381,7,7,0,1,0
8,392,392,30,30,0,1,0
5,419,419,1,1,0,1,0
6,462,462,128,50,78,4,3

9,137,137,41,41,0,1,0
0,155,155,1,1,0,1,0
4,183,183,2,2,0,1,0
6,190,190,20,20,0,1,0
1,223,223,16,16,0,1,0
3,311,311,7,7,0,1,0
10,337,337,2,2,0,1,0
2,368,368,10,10,0,1,0
11,371,371,39,6,33,4,3
7,394,394,28,28,0,1,0
5,403,403,33,1,32,3,2
8,426,426,2,2,0,1,0

0,182,182,9,9,0,1,0
2,211,211,4,4,0,1,0
7,234,234,3,3,0,1,0
1,265,265,8,4,4,2,1
5,383,383,119,94,25,2,1
6,384,384,31,31,0,1,0
3,409,409,80,68,12,2,1
4,468,468,50,8,42,2,1

6,144,144,12,8,4,2,1
4,294,294,18,18,0,1,0
5,353,353,20,2,18,4,3
0,405,405,2,2,0,1,0
9,407,407,55,55,0,1,0
3,411,411,47,47,0,1,0
2,448,448,22,7,15,2,1
7,448,448,76,76,0,1,0
8,464,464,46,38,8,3,2
1,496,496,16,16,0,1,0

4,105,105,8,8,0,1,0
7,122,122,7,4,3,2,1
8,133,133,2,2,0,1,0
0,135,135,7,7,0,1,0
9,141,141,34,13,21,4,3
1,167,167,2,2,0,1,0
5,302,302,3,3,0,1,0
2,304,304,9,9,0,1,0
10,360,360,55,40,15,4,3
6,390,390,28,28,0,1,0
3,391,391,37,37,0,1,0

1,241,241,12,7,5,2,1
8,277,277,10,10,0,1,0
6,289,289,65,65,0,1,0
4,350,350,21,15,6,3,2
5,402,402,37,17,20,3,2
7,405,405,59,37,22,3,2
2,431,431,51,51,0,1,0
0,477,477,33,11,22,4,3
3,486,486,6,6,0,1,0

4,192,192,8,8,0,1,0
5,251,251,21,5,16,2,1
1,264,264,34,34,0,1,0
3,291,291,4,4,0,1,0
6,342,342,98,98,0,1,0
2,399,399,83,23,60,4,3
0,425,425,4,4,0,1,0
7,499,499,17,8,9,2,1

5,137,137,9,4,5,2,1
4,206,206,27,27,0,1,0
3,253,253,54,54,0,1,0
1,369,369,72,25,47,3,2
2,406,406,32,14,18,2,1
0,489,489,62,62,0,1,0

1,107,107,36,36,0,1,0
3,334,334,84,12,72,4,3
2,383,383,9,9,0,1,0
4,395,395,40,40,0,1,0
0,418,418,17,14,3,2,1
5,458,458,23,23,0,1,0

1,189,189,14,14,0,1,0
6,217,217,3,3,0,1,0
4,241,241,8,8,0,1,0
5,259,259,93,69,24,4,3
3,267,267,53,31,22,2,1
2,306,306,22,7,15,2,1
0,428,428,25,25,0,1,0

2,127,127,15,11,4,2,1
6,158,158,3,3,0,1,0
8,167,167,40,40,0,1,0
1,194,194,33,33,0,1,0
9,203,203,13,1,12,4,3
4,233,233,12,12,0,1,0
7,342,342,36,36,0,1,0
3,344,344,1,1,0,1,0
5,452,452,14,14,0,1,0
0,463,463,5,2,3,2,1

6,140,140,28,2,26,2,1
2,214,214,15,6,9,4,3
5,262,262,8,8,0,1,0
7,306,306,22,22,0,1,0
0,318,318,27,5,22,4,3
4,351,351,11,11,0,1,0
3,359,359,54,54,0,1,0
1,412,412,14,4,10,3,2
8,425,425,56,56,0,1,0

1,168,168,9,9,0,1,0
2,199,199,6,2,4,2,1
0,239,239,54,20,34,2,1
3,431,431,39,39,0,1,0
5,436,436,84,72,12,2,1
4,440,440,42,42,0,1,0
6,441,441,51,51,0,1,0

5,101,101,5,5,0,1,0
0,116,116,4,4,0,1,0
2,124,124,9,9,0,1,0
8,149,149,1,1,0,1,0
6,199,199,7,7,0,1,0
15,225,225,25,25,0,1,0
14,251,251,47,47,0,1,0
7,267,267,6,6,0,1,0
12,273,273,12,3,9,2,1
9,281,281,1,1,0,1,0
1,285,285,5,5,0,1,0
4,287,287,7,2,5,2,1
13,352,352,13,13,0,1,0
3,366,366,3,3,0,1,0
10,369,369,4,4,0,1,0
11,441,441,15,3,12,3,2
16,473,473,50,7,43,3,2

6,228,228,3,3,0,1,0
1,378,378,39,39,0,1,0
8,382,382,107,80,27,3,2
7,391,391,44,44,0,1,0
5,400,400,34,34,0,1,0
0,411,411,8,3,5,2,1
4,446,446,26,11,15,4,3
3,459,459,7,7,0,1,0
2,470,470,57,5,52,3,2

1,148,148,29,25,4,2,1
0,202,202,25,25,0,1,0
3,267,267,4,1,3,2,1
4,344,344,56,33,23,2,1
5,359,359,11,11,0,1,0
6,370,370,78,37,41,2,1
2,494,494,33,30,3,2,1

9,100,100,9,3,6,3,2
0,143,143,5,1,4,2,1
1,245,245,4,4,0,1,0
5,250,250,4,4,0,1,0
8,283,283,38,17,21,4,3
2,301,301,3,3,0,1,0
4,307,307,5,5,0,1,0
6,315,315,27,27,0,1,0
10,335,335,88,59,29,2,1
3,398,398,8,4,4,2,1
11,463,463,27,27,0,1,0
7,496,496,33,21,12,4,3

5,153,153,29,3,26,2,1
7,157,157,14,2,12,3,2
0,244,244,3,3,0,1,0
2,250,250,41,27,14,3,2
3,271,271,14,14,0,1,0
6,307,307,39,39,0,1,0
1,312,312,4,4,0,1,0
4,358,358,58,4,54,3,2

0,127,127,14,14,0,1,0
6,201,201,44,11,33,4,3
3,301,301,17,14,3,2,1
7,370,370,8,8,0,1,0
1,401,401,84,84,0,1,0
4,461,461,5,5,0,1,0
2,479,479,7,7,0,1,0
5,497,497,81,21,60,4,3

4,192,192,16,8,8,3,2
3,269,269,56,56,0,1,0
2,304,304,35,35,0,1,0
0,326,326,103,21,82,3,2
1,390,390,33,33,0,1,0

0,105,105,17,6,11,3,2
4,130,130,21,21,0,1,0
5,191,191,30,30,0,1,0
2,287,287,11,11,0,1,0
6,300,300,26,26,0,1,0
3,315,315,9,9,0,1,0
1,419,419,73,53,20,3,2

2,219,219,26,17,9,3,2
0,224,224,4,1,3,2,1
8,231,231,13,13,0,1,0
3,235,235,7,7,0,1,0
7,256,256,55,55,0,1,0
5,319,319,27,27,0,1,0
4,351,351,28,28,0,1,0
1,399,399,10,10,0,1,0
9,409,409,55,55,0,1,0
6,473,473,21,21,0,1,0

6,128,128,11,11,0,1,0
1,159,159,15,7,8,3,2
2,162,162,2,2,0,1,0
7,225,225,22,22,0,1,0
10,285,285,21,21,0,1,0
0,306,306,4,4,0,1,0
4,360,360,8,8,0,1,0
8,382,382,106,106,0,1,0
5,407,407,2,2,0,1,0
9,425,425,22,22,0,1,0
3,452,452,32,32,0,1,0

5,188,188,9,9,0,1,0
6,240,240,61,7,54,4,3
2,278,278,14,7,7,2,1
3,281,281,6,6,0,1,0
0,292,292,62,62,0,1,0
1,430,430,50,4,46,3,2
4,491,491,52,52,0,1,0

0,222,222,1,1,0,1,0
1,232,232,92,41,51,4,3
2,320,320,30,30,0,1,0
3,332,332,32,32,0,1,0
4,351,351,75,71,4,2,1

4,218,218,36,36,0,1,0
6,241,241,29,14,15,4,3
2,298,298,27,23,4,2,1
5,337,337,41,12,29,3,2
1,357,357,48,48,0,1,0
0,459,459,57,57,0,1,0
3,498,498,26,26,0,1,0

2,114,114,4,4,0,1,0
3,115,115,13,13,0,1,0
0,333,333,23,23,0,1,0
4,371,371,32,9,23,2,1
1,411,411,125,125,0,1,0
5,459,459,94,70,24,2,1

3,137,137,12,6,6,3,2
2,156,156,16,16,0,1,0
4,260,260,57,13,44,4,3
0,403,403,65,25,40,2,1
1,451,451,108,88,20,4,3

0,219,219,30,30,0,1,0
4,312,312,42,37,5,2,1
3,334,334,51,51,0,1,0
2,353,353,41,9,32,2,1
1,411,411,109,59,50,3,2

7,143,143,12,12,0,1,0
5,147,147,38,20,18,4,3
2,225,225,1,1,0,1,0
0,239,239,22,22,0,1,0
4,283,283,32,23,9,4,3
3,327,327,23,23,0,1,0
6,434,434,27,27,0,1,0
1,480,480,58,58,0,1,0

3,187,187,20,20,0,1,0
4,245,245,55,16,39,3,2
5,331,331,25,4,21,2,1
2,372,372,84,63,21,4,3
1,450,450,71,71,0,1,0
0,486,486,8,2,6,2,1

4,126,126,28,8,20,2,1
0,168,168,3,3,0,1,0
1,175,175,28,28,0,1,0
5,272,272,43,43,0,1,0
3,337,337,10,10,0,1,0
2,488,488,109,79,30,2,1

1,105,105,21,1,20,2,1
2,139,139,4,4,0,1,0
5,204,204,45,15,30,2,1
4,284,284,9,2,7,2,1
3,307,307,33,33,0,1,0
6,442,442,69,11,58,4,3
0,478,478,32,32,0,1,0

2,111,111,1,1,0,1,0
5,115,115,4,4,0,1,0
4,148,148,5,5,0,1,0
1,215,215,16,9,7,2,1
7,249,249,84,72,12,2,1
6,250,250,10,4,6,2,1
0,356,356,49,49,0,1,0
3,437,437,64,64,0,1,0

3,187,187,29,17,12,4,3
4,202,202,6,6,0,1,0
5,243,243,7,7,0,1,0
6,274,274,30,7,23,2,1
1,437,437,24,24,0,1,0
7,473,473,126,102,24,3,2
2,490,490,43,6,37,4,3
0,493,493,37,10,27,2,1

3,143,143,34,26,8,2,1
1,230,230,85,85,0,1,0
0,279,279,9,1,8,2,1
4,329,329,6,6,0,1,0
2,350,350,51,51,0,1,0

0,142,142,6,6,0,1,0
4,165,165,26,18,8,3,2
6,177,177,17,1,16,2,1
5,202,202,8,5,3,2,1
10,237,237,16,16,0,1,0
7,256,256,5,1,4,2,1
3,345,345,3,3,0,1,0
8,345,345,107,107,0,1,0
9,392,392,10,5,5,2,1
1,452,452,14,14,0,1,0
2,493,493,3,3,0,1,0

3,124,124,2,2,0,1,0
2,129,129,1,1,0,1,0
6,147,147,16,7,9,3,2
9,153,153,21,9,12,4,3
5,172,172,31,7,24,2,1
8,276,276,68,68,0,1,0
0,331,331,4,4,0,1,0
1,352,352,10,10,0,1,0
7,436,436,10,10,0,1,0
4,443,443,21,21,0,1,0

5,100,100,8,2,6,3,2
3,162,162,1,1,0,1,0
0,186,186,59,59,0,1,0
1,206,206,15,6,9,4,3
6,437,437,43,21,22,3,2
4,441,441,102,80,22,2,1
2,470,470,3,3,0,1,0

9,110,110,13,4,9,2,1
8,167,167,9,1,8,2,1
5,197,197,2,2,0,1,0
1,225,225,2,2,0,1,0
10,226,226,54,54,0,1,0
7,311,311,14,14,0,1,0
6,346,346,12,2,10,2,1
0,367,367,55,16,39,4,3
3,402,402,18,18,0,1,0
2,407,407,28,21,7,2,1
4,448,448,17,10,7,2,1

2,104,104,22,22,0,1,0
3,105,105,10,10,0,1,0
8,146,146,32,2,30,4,3
0,165,165,9,2,7,2,1
1,175,175,1,1,0,1,0
4,240,240,7,7,0,1,0
6,274,274,9,9,0,1,0
5,407,407,2,2,0,1,0
7,423,423,66,66,0,1,0

4,186,186,1,1,0,1,0
2,192,192,3,3,0,1,0
6,217,217,50,50,0,1,0
0,285,285,10,10,0,1,0
5,385,385,66,66,0,1,0
1,421,421,66,66,0,1,0
3,476,476,92,88,4,2,1

1,197,197,10,10,0,1,0
0,228,228,11,11,0,1,0
5,277,277,17,5,12,2,1
3,313,313,1,1,0,1,0
8,389,389,38,38,0,1,0
9,408,408,83,47,36,3,2
2,411,411,6,1,5,2,1
6,452,452,26,26,0,1,0
4,457,457,76,43,33,4,3
7,486,486,50,2,48,4,3

1,109,109,6,6,0,1,0
6,278,278,10,2,8,2,1
5,286,286,28,13,15,2,1
3,306,306,11,8,3,2,1
2,329,329,1,1,0,1,0
10,352,352,111,20,91,4,3
7,354,354,12,12,0,1,0
4,394,394,44,21,23,2,1
0,443,443,12,12,0,1,0
9,469,469,4,4,0,1,0
8,499,499,40,40,0,1,0

0,134,134,14,2,12,3,2
1,163,163,15,6,9,2,1
2,219,219,28,23,5,2,1
6,256,256,36,22,14,2,1
5,415,415,44,16,28,3,2
4,418,418,65,25,40,2,1
3,462,462,35,35,0,1,0

5,189,189,3,3,0,1,0
4,222,222,28,14,14,2,1
3,272,272,33,9,24,2,1
1,283,283,30,30,0,1,0
2,301,301,6,6,0,1,0
7,301,301,1,1,0,1,0
0,338,338,9,9,0,1,0
6,429,429,167,167,0,1,0

5,126,126,14,14,0,1,0
1,142,142,14,14,0,1,0
4,162,162,47,5,42,4,3
6,207,207,1,1,0,1,0
2,214,214,51,29,22,2,1
0,248,248,1,1,0,1,0
3,446,446,27,3,24,4,3

5,102,102,9,1,8,3,2
2,116,116,1,1,0,1,0
0,128,128,12,5,7,2,1
6,144,144,6,6,0,1,0
3,172,172,7,1,6,3,2
1,255,255,66,66,0,1,0
4,420,420,118,22,96,4,3

0,113,113,18,6,12,4,3
5,132,132,7,7,0,1,0
2,181,181,14,14,0,1,0
1,205,205,13,13,0,1,0
7,377,377,104,86,18,2,1
4,411,411,22,7,15,4,3
3,421,421,20,6,14,3,2
6,459,459,36,36,0,1,0

0,102,102,7,7,0,1,0
1,103,103,18,18,0,1,0
3,145,145,18,1,17,4,3
2,169,169,5,1,4,2,1
7,237,237,14,2,12,4,3
6,259,259,78,22,56,3,2
4,307,307,1,1,0,1,0
5,442,442,21,21,0,1,0

1,167,167,41,11,30,4,3
2,295,295,5,1,4,2,1
5,331,331,11,11,0,1,0
4,395,395,42,42,0,1,0
0,397,397,55,22,33,2,1
3,454,454,120,115,5,2,1

7,119,119,33,26,7,2,1
5,211,211,16,1,15,4,3
4,261,261,13,13,0,1,0
3,287,287,5,5,0,1,0
1,341,341,7,7,0,1,0
6,452,452,27,27,0,1,0
2,482,482,137,107,30,4,3
0,489,489,14,7,7,2,1

3,117,117,1,1,0,1,0
8,134,134,12,1,11,2,1
5,229,229,1,1,0,1,0
9,237,237,32,32,0,1,0
6,240,240,12,4,8,3,2
0,250,250,2,2,0,1,0
4,269,269,54,7,47,3,2
1,278,278,12,5,7,2,1
2,314,314,27,11,16,3,2
7,350,350,64,18,46,3,2

2,151,151,1,1,0,1,0
8,194,194,2,2,0,1,0
1,206,206,16,16,0,1,0
0,277,277,3,3,0,1,0
4,315,315,25,5,20,3,2
7,366,366,94,94,0,1,0
5,383,383,38,28,10,3,2
6,443,443,62,42,20,3,2
3,451,451,57,51,6,2,1

7,206,206,33,33,0,1,0
5,209,209,23,3,20,3,2
6,291,291,39,5,34,3,2
0,314,314,25,25,0,1,0
1,335,335,24,8,16,3,2
3,364,364,6,6,0,1,0
2,472,472,32,32,0,1,0
4,474,474,28,8,20,2,1
8,484,484,54,54,0,1,0

3,106,106,2,2,0,1,0
1,189,189,38,38,0,1,0
6,278,278,21,6,15,4,3
0,307,307,55,55,0,1,0
4,313,313,10,10,0,1,0
5,331,331,99,47,52,3,2
2,464,464,1,1,0,1,0

5,167,167,20,20,0,1,0
2,170,170,1,1,0,1,0
4,190,190,38,26,12,4,3
1,221,221,58,25,33,4,3
0,369,369,43,4,39,4,3
3,438,438,7,7,0,1,0
6,496,496,44,44,0,1,0

1,115,115,11,1,10,3,2
3,121,121,19,3,16,2,1
4,259,259,18,18,0,1,0
2,260,260,18,18,0,1,0
0,292,292,23,23,0,1,0
6,388,388,56,44,12,4,3
5,446,446,85,13,72,4,3

1,220,220,31,2,29,2,1
0,238,238,62,28,34,3,2
2,369,369,40,24,16,2,1
4,403,403,113,28,85,4,3
3,425,425,6,6,0,1,0

5,158,158,41,41,0,1,0
7,248,248,14,14,0,1,0
0,287,287,13,13,0,1,0
1,367,367,14,8,6,3,2
3,391,391,4,1,3,2,1
2,406,406,67,63,4,2,1
6,426,426,38,25,13,2,1
4,464,464,66,28,38,2,1

2,127,127,2,2,0,1,0
3,144,144,7,7,0,1,0
4,146,146,10,6,4,2,1
10,162,162,21,21,0,1,0
9,224,224,53,53,0,1,0
8,240,240,10,4,6,2,1
1,241,241,35,11,24,3,2
6,399,399,17,1,16,2,1
0,435,435,6,1,5,2,1
7,436,436,28,20,8,2,1
5,485,485,1,1,0,1,0

6,104,104,12,12,0,1,0
7,123,123,3,3,0,1,0
5,163,163,45,45,0,1,0
0,226,226,11,11,0,1,0
3,227,227,16,16,0,1,0
2,288,288,32,32,0,1,0
4,406,406,13,13,0,1,0
1,429,429,60,20,40,4,3

0,119,119,2,2,0,1,0
2,215,215,16,16,0,1,0
9,233,233,49,5,44,2,1
5,301,301,1,1,0,1,0
4,339,339,33,18,15,2,1
6,363,363,10,10,0,1,0
1,382,382,39,22,17,2,1
7,382,382,31,31,0,1,0
3,413,413,33,33,0,1,0
8,436,436,49,30,19,2,1

5,158,158,14,14,0,1,0
2,298,298,6,6,0,1,0
4,324,324,20,20,0,1,0
3,346,346,90,40,50,2,1
0,375,375,4,4,0,1,0
1,497,497,184,49,135,4,3

3,119,119,6,6,0,1,0
8,185,185,43,28,15,2,1
7,246,246,5,2,3,2,1
5,265,265,21,8,13,2,1
4,300,300,6,6,0,1,0
0,316,316,10,1,9,4,3
6,349,349,54,30,24,2,1
2,459,459,37,17,20,3,2
1,478,478,67,67,0,1,0

8,101,101,4,4,0,1,0
2,118,118,1,1,0,1,0
6,244,244,42,18,24,2,1
5,285,285,9,9,0,1,0
1,301,301,1,1,0,1,0
0,325,325,62,62,0,1,0
7,406,406,78,53,25,2,1
3,455,455,64,1,63,4,3
4,484,484,13,1,12,2,1

1,142,142,19,13,6,2,1
5,148,148,2,2,0,1,0
6,189,189,73,59,14,2,1
0,210,210,16,16,0,1,0
4,233,233,2,2,0,1,0
3,375,375,6,3,3,2,1
2,428,428,75,36,39,4,3

2,159,159,44,17,27,2,1
4,238,238,42,11,31,2,1
1,254,254,1,1,0,1,0
6,272,272,4,4,0,1,0
3,407,407,11,7,4,2,1
0,453,453,42,42,0,1,0
5,453,453,98,53,45,4,3

6,156,156,4,4,0,1,0
7,201,201,35,35,0,1,0
3,207,207,1,1,0,1,0
8,213,213,40,40,0,1,0
1,272,272,15,15,0,1,0
9,350,350,16,10,6,3,2
2,376,376,39,39,0,1,0
4,416,416,48,48,0,1,0
0,420,420,27,19,8,2,1
5,465,465,15,15,0,1,0

2,122,122,42,17,25,2,1
0,140,140,6,6,0,1,0
3,252,252,22,9,13,4,3
4,259,259,44,44,0,1,0
1,313,313,6,6,0,1,0
5,492,492,73,49,24,4,3

0,118,118,5,5,0,1,0
4,121,121,9,5,4,2,1
5,188,188,4,1,3,2,1
1,244,244,10,10,0,1,0
3,300,300,12,12,0,1,0
2,310,310,23,23,0,1,0
9,343,343,24,24,0,1,0
6,357,357,39,39,0,1,0
8,370,370,28,4,24,3,2
7,491,491,126,126,0,1,0

7,104,104,5,1,4,2,1
0,114,114,14,14,0,1,0
4,336,336,2,2,0,1,0
1,373,373,30,30,0,1,0
3,388,388,4,4,0,1,0
6,392,392,46,21,25,2,1
5,417,417,5,2,3,2,1
2,423,423,72,36,36,4,3
8,483,483,119,119,0,1,0

5,126,126,11,11,0,1,0
2,148,148,26,26,0,1,0
1,166,166,4,4,0,1,0
4,187,187,58,36,22,2,1
3,202,202,25,15,10,2,1
0,346,346,28,5,23,2,1
6,432,432,3,3,0,1,0

1,179,179,11,2,9,2,1
3,274,274,24,1,23,2,1
0,339,339,60,60,0,1,0
6,354,354,108,108,0,1,0
2,397,397,30,12,18,3,2
5,490,490,22,14,8,3,2
4,493,493,26,20,6,2,1

7,189,189,44,44,0,1,0
2,198,198,4,4,0,1,0
0,239,239,51,3,48,2,1
3,241,241,8,8,0,1,0
5,253,253,2,2,0,1,0
4,345,345,32,32,0,1,0
6,387,387,23,1,22,3,2
8,487,487,55,55,0,1,0
1,489,489,17,3,14,3,2

3,105,105,1,1,0,1,0
6,121,121,17,9,8,3,2
0,178,178,25,25,0,1,0
5,216,216,52,52,0,1,0
1,272,272,42,42,0,1,0
4,349,349,10,10,0,1,0
2,423,423,44,3,41,2,1

1,147,147,1,1,0,1,0
2,149,149,9,9,0,1,0
7,256,256,55,19,36,2,1
5,280,280,14,14,0,1,0
9,281,281,51,51,0,1,0
8,298,298,3,3,0,1,0
4,360,360,2,2,0,1,0
6,369,369,38,38,0,1,0
0,394,394,12,12,0,1,0
3,438,438,63,63,0,1,0

3,147,147,5,5,0,1,0
1,163,163,12,12,0,1,0
0,186,186,12,12,0,1,0
5,194,194,1,1,0,1,0
6,386,386,3,3,0,1,0
7,424,424,166,149,17,2,1
2,428,428,22,9,13,2,1
4,465,465,83,8,75,4,3

6,139,139,3,3,0,1,0
4,146,146,12,12,0,1,0
0,181,181,24,24,0,1,0
9,205,205,51,51,0,1,0
7,258,258,6,6,0,1,0
1,347,347,4,4,0,1,0
3,388,388,27,27,0,1,0
5,398,398,11,11,0,1,0
8,454,454,61,49,12,2,1
2,461,461,27,27,0,1,0

5,111,111,14,14,0,1,0
1,120,120,16,16,0,1,0
2,204,204,24,16,8,2,1
3,239,239,6,6,0,1,0
0,360,360,55,55,0,1,0
4,424,424,109,94,15,2,1

8,249,249,29,9,20,2,1
5,280,280,39,39,0,1,0
4,302,302,6,6,0,1,0
2,311,311,2,2,0,1,0
3,320,320,4,1,3,2,1
9,327,327,26,26,0,1,0
0,409,409,11,11,0,1,0
7,442,442,11,5,6,2,1
6,449,449,20,20,0,1,0
1,467,467,6,6,0,1,0
10,469,469,33,33,0,1,0
11,474,474,121,121,0,1,0

3,127,127,39,9,30,3,2
4,136,136,13,13,0,1,0
6,139,139,33,33,0,1,0
2,259,259,15,10,5,2,1
1,312,312,3,3,0,1,0
5,325,325,25,25,0,1,0
0,331,331,11,11,0,1,0

4,236,236,16,16,0,1,0
0,257,257,1,1,0,1,0
1,300,300,19,15,4,2,1
3,300,300,22,4,18,3,2
2,309,309,21,15,6,3,2
7,343,343,28,28,0,1,0
6,374,374,18,2,16,2,1
5,432,432,33,9,24,4,3
9,464,464,102,46,56,3,2
8,485,485,50,50,0,1,0

3,105,105,17,17,0,1,0
2,380,380,88,88,0,1,0
0,447,447,179,160,19,2,1
1,447,447,5,5,0,1,0

4,167,167,48,3,45,4,3
7,180,180,15,15,0,1,0
0,262,262,8,1,7,2,1
2,286,286,4,4,0,1,0
6,327,327,50,29,21,4,3
5,359,359,60,16,44,4,3
3,371,371,8,8,0,1,0
1,458,458,23,23,0,1,0

0,271,271,109,39,70,3,2
1,373,373,7,7,0,1,0
3,384,384,47,47,0,1,0
2,452,452,118,118,0,1,0

7,102,102,12,1,11,2,1
6,182,182,31,31,0,1,0
5,245,245,15,15,0,1,0
2,297,297,53,7,46,2,1
3,301,301,2,2,0,1,0
1,340,340,40,40,0,1,0
4,373,373,7,7,0,1,0
0,398,398,8,8,0,1,0
8,406,406,49,6,43,4,3

2,102,102,8,8,0,1,0
3,166,166,43,38,5,2,1
4,174,174,13,6,7,2,1
1,212,212,46,46,0,1,0
0,469,469,87,29,58,4,3

3,135,135,17,17,0,1,0
6,141,141,16,6,10,2,1
1,189,189,30,11,19,2,1
5,299,299,13,13,0,1,0
4,406,406,100,60,40,2,1
2,420,420,16,5,11,3,2
0,460,460,37,34,3,2,1

2,160,160,55,55,0,1,0
3,221,221,7,7,0,1,0
5,242,242,54,17,37,2,1
4,295,295,30,21,9,2,1
0,355,355,2,2,0,1,0
1,360,360,7,3,4,2,1
6,377,377,30,13,17,2,1

4,104,104,4,4,0,1,0
6,129,129,24,21,3,2,1
5,310,310,57,57,0,1,0
0,362,362,1,1,0,1,0
1,400,400,156,156,0,1,0
2,465,465,2,2,0,1,0
3,472,472,2,2,0,1,0

6,102,102,34,34,0,1,0
1,206,206,22,13,9,4,3
0,263,263,10,1,9,2,1
3,324,324,35,16,19,4,3
4,366,366,37,37,0,1,0
7,402,402,25,18,7,2,1
2,424,424,20,5,15,4,3
5,438,438,3,3,0,1,0

0,150,150,20,16,4,2,1
4,183,183,19,1,18,2,1
2,192,192,2,2,0,1,0
1,241,241,32,32,0,1,0
7,275,275,62,62,0,1,0
6,402,402,36,22,14,3,2
3,479,479,10,10,0,1,0
5,495,495,44,32,12,3,2

2,112,112,14,6,8,3,2
0,137,137,4,4,0,1,0
4,248,248,7,4,3,2,1
1,307,307,15,15,0,1,0
8,335,335,89,35,54,3,2
5,368,368,10,10,0,1,0
9,390,390,25,25,0,1,0
7,394,394,30,6,24,4,3
6,460,460,38,38,0,1,0
3,495,495,30,7,23,2,1

7,194,194,5,2,3,2,1
9,215,215,39,11,28,2,1
1,230,230,31,31,0,1,0
6,269,269,27,22,5,2,1
2,273,273,5,5,0,1,0
4,351,351,2,2,0,1,0
5,378,378,16,16,0,1,0
8,378,378,75,9,66,3,2
3,389,389,15,8,7,2,1
0,470,470,29,19,10,3,2

5,292,292,45,16,29,4,3
6,297,297,8,1,7,2,1
2,343,343,57,57,0,1,0
4,354,354,24,6,18,2,1
0,374,374,16,4,12,3,2
1,428,428,23,23,0,1,0
7,441,441,98,74,24,4,3
3,498,498,35,10,25,2,1

9,142,142,2,2,0,1,0
8,196,196,61,22,39,2,1
6,206,206,20,20,0,1,0
5,235,235,1,1,0,1,0
2,272,272,9,9,0,1,0
4,276,276,2,2,0,1,0
1,290,290,25,25,0,1,0
7,356,356,31,31,0,1,0
3,364,364,15,15,0,1,0
0,449,449,59,44,15,4,3

6,151,151,4,4,0,1,0
5,213,213,33,6,27,4,3
4,237,237,53,8,45,4,3
2,288,288,41,41,0,1,0
1,309,309,40,40,0,1,0
3,317,317,34,34,0,1,0
0,494,494,11,2,9,4,3

6,115,115,14,14,0,1,0
0,192,192,6,6,0,1,0
5,205,205,39,18,21,4,3
1,334,334,78,61,17,2,1
2,340,340,1,1,0,1,0
3,362,362,37,37,0,1,0
4,412,412,13,2,11,2,1
7,462,462,42,42,0,1,0

6,125,125,5,1,4,2,1
3,161,161,18,18,0,1,0
5,189,189,6,6,0,1,0
0,222,222,24,13,11,4,3
1,226,226,4,4,0,1,0
4,302,302,3,3,0,1,0
7,371,371,77,65,12,2,1
9,385,385,28,19,9,4,3
8,434,434,54,54,0,1,0
2,462,462,38,8,30,2,1

2,107,107,13,13,0,1,0
4,367,367,79,37,42,3,2
1,389,389,80,71,9,4,3
0,468,468,92,8,84,4,3
3,499,499,38,38,0,1,0

5,104,104,3,3,0,1,0
2,164,164,33,33,0,1,0
0,233,233,11,11,0,1,0
4,295,295,2,2,0,1,0
6,307,307,93,93,0,1,0
3,372,372,35,22,13,2,1
7,425,425,32,32,0,1,0
1,463,463,25,15,10,3,2

8,123,123,18,6,12,4,3
7,128,128,24,24,0,1,0
6,188,188,15,15,0,1,0
0,251,251,43,17,26,2,1
5,365,365,7,7,0,1,0
1,382,382,14,2,12,2,1
2,426,426,5,1,4,2,1
4,470,470,67,67,0,1,0
3,496,496,10,10,0,1,0

2,101,101,5,1,4,2,1
5,307,307,48,37,11,2,1
1,323,323,35,35,0,1,0
6,366,366,24,18,6,2,1
0,386,386,68,68,0,1,0
4,413,413,75,12,63,4,3
3,457,457,31,5,26,3,2

4,107,107,2,2,0,1,0
3,143,143,39,39,0,1,0
0,182,182,10,1,9,4,3
6,199,199,34,20,14,2,1
1,244,244,13,2,11,2,1
5,381,381,16,16,0,1,0
2,436,436,1,1,0,1,0
7,474,474,92,86,6,2,1

4,102,102,1,1,0,1,0
3,110,110,1,1,0,1,0
10,121,121,27,13,14,3,2
7,126,126,3,3,0,1,0
2,211,211,30,30,0,1,0
6,306,306,1,1,0,1,0
9,314,314,1,1,0,1,0
11,323,323,57,45,12,2,1
5,337,337,1,1,0,1,0
8,390,390,71,52,19,2,1
1,396,396,1,1,0,1,0
0,452,452,12,12,0,1,0

4,174,174,40,40,0,1,0
7,189,189,22,16,6,2,1
5,194,194,27,27,0,1,0
2,251,251,4,1,3,2,1
1,271,271,2,2,0,1,0
6,350,350,53,5,48,4,3
0,361,361,45,21,24,4,3
3,468,468,11,5,6,2,1

4,114,114,6,3,3,2,1
1,257,257,50,41,9,4,3
0,344,344,71,71,0,1,0
2,417,417,6,6,0,1,0
3,485,485,167,137,30,3,2

9,158,158,34,18,16,2,1
8,187,187,25,8,17,2,1
4,193,193,5,5,0,1,0
7,235,235,13,13,0,1,0
5,257,257,19,19,0,1,0
2,270,270,11,11,0,1,0
10,347,347,51,21,30,4,3
3,362,362,13,13,0,1,0
11,386,386,17,17,0,1,0
6,464,464,1,1,0,1,0
1,477,477,4,1,3,2,1
0,483,483,14,7,7,2,1

3,120,120,9,9,0,1,0
6,135,135,39,25,14,3,2
1,190,190,18,18,0,1,0
5,219,219,6,1,5,2,1
4,256,256,45,45,0,1,0
7,273,273,30,30,0,1,0
2,313,313,3,3,0,1,0
0,428,428,9,9,0,1,0
8,456,456,4,4,0,1,0

6,105,105,12,12,0,1,0
5,204,204,6,6,0,1,0
3,218,218,37,37,0,1,0
8,317,317,44,44,0,1,0
1,332,332,7,1,6,2,1
0,349,349,45,37,8,2,1
4,388,388,2,2,0,1,0
7,480,480,74,74,0,1,0
2,498,498,24,24,0,1,0

3,110,110,9,9,0,1,0
7,149,149,11,11,0,1,0
4,198,198,24,7,17,2,1
5,200,200,27,15,12,4,3
1,268,268,45,45,0,1,0
6,352,352,70,8,62,3,2
2,356,356,11,11,0,1,0
0,459,459,1,1,0,1,0

7,150,150,36,36,0,1,0
1,285,285,9,9,0,1,0
0,331,331,41,41,0,1,0
4,378,378,58,7,51,4,3
2,422,422,19,10,9,4,3
5,457,457,27,27,0,1,0
3,486,486,23,5,18,4,3
6,495,495,53,53,0,1,0

0,113,113,5,5,0,1,0
8,142,142,21,21,0,1,0
6,170,170,17,17,0,1,0
7,199,199,31,31,0,1,0
3,294,294,15,15,0,1,0
2,321,321,11,1,10,3,2
4,323,323,25,16,9,2,1
1,455,455,3,3,0,1,0
5,490,490,92,53,39,4,3

0,234,234,1,1,0,1,0
3,253,253,59,56,3,2,1
5,343,343,13,1,12,3,2
2,408,408,41,41,0,1,0
7,409,409,73,73,0,1,0
6,459,459,87,87,0,1,0
4,480,480,17,17,0,1,0
1,492,492,14,7,7,2,1

5,183,183,5,2,3,2,1
1,190,190,2,2,0,1,0
4,253,253,88,59,29,2,1
6,265,265,8,8,0,1,0
2,381,381,1,1,0,1,0
3,395,395,116,14,102,4,3
0,433,433,41,41,0,1,0

5,106,106,1,1,0,1,0
7,148,148,49,49,0,1,0
0,173,173,5,5,0,1,0
3,248,248,2,2,0,1,0
8,333,333,9,9,0,1,0
4,348,348,1,1,0,1,0
6,443,443,21,18,3,2,1
2,452,452,134,134,0,1,0
1,461,461,27,15,12,3,2

5,130,130,9,9,0,1,0
1,133,133,12,4,8,3,2
6,170,170,10,10,0,1,0
7,264,264,32,32,0,1,0
4,295,295,5,1,4,2,1
0,390,390,46,8,38,2,1
3,395,395,20,4,16,4,3
2,444,444,26,8,18,2,1
8,473,473,107,56,51,4,3

1,106,106,10,7,3,2,1
2,221,221,8,8,0,1,0
3,256,256,3,3,0,1,0
5,305,305,22,13,9,4,3
4,366,366,74,11,63,4,3
6,373,373,94,94,0,1,0
0,429,429,25,25,0,1,0
7,475,475,38,26,12,2,1

7,102,102,1,1,0,1,0
3,156,156,5,5,0,1,0
8,179,179,67,36,31,2,1
5,211,211,32,32,0,1,0
6,252,252,5,5,0,1,0
0,321,321,2,2,0,1,0
4,436,436,43,17,26,3,2
1,441,441,24,24,0,1,0
2,489,489,29,29,0,1,0

3,138,138,1,1,0,1,0
6,149,149,5,5,0,1,0
1,165,165,8,4,4,2,1
2,252,252,23,13,10,2,1
10,305,305,19,1,18,2,1
4,322,322,9,4,5,2,1
8,384,384,46,46,0,1,0
7,397,397,9,2,7,2,1
11,413,413,128,106,22,2,1
5,429,429,20,20,0,1,0
9,430,430,14,6,8,3,2
0,498,498,2,2,0,1,0

0,130,130,6,6,0,1,0
2,162,162,22,22,0,1,0
6,191,191,18,6,12,3,2
1,328,328,70,70,0,1,0
5,359,359,49,2,47,4,3
3,363,363,1,1,0,1,0
7,469,469,83,7,76,3,2
4,477,477,1,1,0,1,0

1,114,114,1,1,0,1,0
2,208,208,59,59,0,1,0
3,299,299,40,13,27,3,2
5,376,376,65,15,50,2,1
0,392,392,43,40,3,2,1
4,461,461,45,5,40,2,1

1,106,106,16,16,0,1,0
0,226,226,91,73,18,3,2
3,281,281,47,47,0,1,0
2,400,400,35,14,21,4,3

4,135,135,2,2,0,1,0
6,148,148,31,31,0,1,0
0,195,195,11,11,0,1,0
8,195,195,23,1,22,3,2
2,204,204,3,3,0,1,0
3,284,284,17,2,15,2,1
7,288,288,24,24,0,1,0
1,344,344,8,2,6,2,1
5,377,377,88,50,38,2,1

8,192,192,17,17,0,1,0
0,232,232,9,3,6,3,2
1,262,262,6,2,4,2,1
2,326,326,15,15,0,1,0
9,363,363,31,31,0,1,0
10,389,389,110,86,24,3,2
6,403,403,9,4,5,2,1
4,428,428,33,33,0,1,0
7,447,447,2,2,0,1,0
11,449,449,16,16,0,1,0
5,490,490,39,39,0,1,0
3,492,492,11,2,9,2,1

2,118,118,1,1,0,1,0
5,130,130,9,5,4,2,1
10,136,136,7,7,0,1,0
4,139,139,4,4,0,1,0
3,155,155,9,9,0,1,0
6,203,203,1,1,0,1,0
9,213,213,21,21,0,1,0
8,302,302,78,9,69,4,3
1,417,417,20,11,9,4,3
0,475,475,35,35,0,1,0
7,482,482,53,40,13,2,1

3,131,131,1,1,0,1,0
1,282,282,16,10,6,3,2
7,363,363,19,19,0,1,0
0,416,416,8,8,0,1,0
4,426,426,57,45,12,4,3
2,428,428,79,39,40,4,3
6,439,439,57,24,33,4,3
5,445,445,98,12,86,3,2

1,106,106,1,1,0,1,0
11,111,111,11,1,10,2,1
3,135,135,19,16,3,2,1
4,139,139,4,4,0,1,0
0,158,158,14,4,10,2,1
5,310,310,18,18,0,1,0
2,344,344,9,9,0,1,0
9,369,369,50,50,0,1,0
7,370,370,3,3,0,1,0
10,405,405,68,68,0,1,0
8,410,410,11,1,10,3,2
6,411,411,6,6,0,1,0

4,100,100,1,1,0,1,0
3,132,132,14,5,9,2,1
7,140,140,7,7,0,1,0
0,199,199,2,2,0,1,0
8,217,217,14,14,0,1,0
2,244,244,2,2,0,1,0
1,303,303,10,10,0,1,0
5,334,334,77,77,0,1,0
6,492,492,2,2,0,1,0
9,500,500,144,98,46,2,1

6,109,109,11,7,4,2,1
8,177,177,21,4,17,4,3
10,227,227,17,17,0,1,0
9,241,241,76,2,74,4,3
5,317,317,3,3,0,1,0
1,321,321,11,11,0,1,0
3,372,372,29,29,0,1,0
2,394,394,7,7,0,1,0
11,402,402,8,2,6,3,2
4,408,408,14,5,9,4,3
7,429,429,1,1,0,1,0
0,452,452,2,2,0,1,0

5,171,171,17,1,16,2,1
1,224,224,1,1,0,1,0
6,300,300,88,88,0,1,0
3,383,383,22,13,9,2,1
4,421,421,7,7,0,1,0
0,496,496,78,78,0,1,0
2,497,497,91,91,0,1,0

2,141,141,9,9,0,1,0
3,226,226,6,6,0,1,0
9,244,244,7,7,0,1,0
1,271,271,15,15,0,1,0
7,354,354,107,4,103,4,3
5,368,368,28,28,0,1,0
8,380,380,28,28,0,1,0
0,389,389,35,17,18,4,3
6,447,447,22,16,6,3,2
4,492,492,20,8,12,3,2

0,102,102,8,8,0,1,0
6,154,154,13,13,0,1,0
2,188,188,36,15,21,4,3
5,208,208,58,58,0,1,0
3,278,278,11,11,0,1,0
4,416,416,19,19,0,1,0
1,469,469,43,43,0,1,0

0,114,114,8,8,0,1,0
6,152,152,8,8,0,1,0
3,192,192,7,7,0,1,0
5,192,192,3,3,0,1,0
1,210,210,6,6,0,1,0
8,235,235,60,33,27,4,3
4,292,292,43,20,23,2,1
7,456,456,45,36,9,4,3
2,469,469,49,31,18,3,2

3,136,136,27,1,26,4,3
4,354,354,62,5,57,3,2
0,462,462,31,16,15,2,1
2,469,469,44,44,0,1,0
5,474,474,15,15,0,1,0
1,477,477,115,58,57,4,3

4,147,147,5,5,0,1,0
2,211,211,4,4,0,1,0
5,230,230,62,16,46,3,2
3,284,284,29,15,14,2,1
1,349,349,91,62,29,2,1
0,416,416,52,34,18,4,3

5,174,174,27,22,5,2,1
4,283,283,59,59,0,1,0
2,331,331,70,43,27,2,1
1,337,337,18,18,0,1,0
3,369,369,15,2,13,2,1
0,418,418,57,57,0,1,0

8,104,104,20,20,0,1,0
2,110,110,10,10,0,1,0
1,122,122,8,1,7,2,1
0,154,154,6,6,0,1,0
5,237,237,14,9,5,2,1
4,238,238,28,28,0,1,0
7,261,261,24,24,0,1,0
6,454,454,56,10,46,3,2
3,485,485,15,15,0,1,0

6,160,160,1,1,0,1,0
5,188,188,4,4,0,1,0
1,234,234,16,1,15,4,3
2,281,281,58,37,21,2,1
0,315,315,14,14,0,1,0
3,399,399,33,33,0,1,0
4,491,491,186,66,120,4,3

0,100,100,4,4,0,1,0
1,192,192,29,23,6,2,1
2,287,287,10,10,0,1,0
7,324,324,25,10,15,2,1
3,356,356,47,3,44,2,1
4,370,370,16,13,3,2,1
5,457,457,139,45,94,3,2
6,495,495,10,4,6,3,2

2,164,164,6,6,0,1,0
4,242,242,58,58,0,1,0
1,291,291,78,78,0,1,0
5,385,385,61,61,0,1,0
0,412,412,40,40,0,1,0
3,432,432,2,2,0,1,0

0,102,102,29,15,14,3,2
3,351,351,19,19,0,1,0
1,361,361,4,4,0,1,0
5,381,381,34,25,9,4,3
2,408,408,21,21,0,1,0
4,479,479,130,130,0,1,0
6,500,500,22,9,13,2,1

12,127,127,8,8,0,1,0
13,152,152,23,1,22,2,1
8,154,154,5,1,4,2,1
5,164,164,8,8,0,1,0
14,171,171,33,33,0,1,0
2,196,196,2,2,0,1,0
3,239,239,3,3,0,1,0
1,294,294,1,1,0,1,0
6,295,295,6,6,0,1,0
7,321,321,36,9,27,2,1
11,401,401,5,5,0,1,0
0,446,446,11,11,0,1,0
4,467,467,29,29,0,1,0
9,476,476,1,1,0,1,0
10,497,497,30,12,18,4,3

4,130,130,2,2,0,1,0
2,147,147,30,9,21,2,1
1,152,152,16,16,0,1,0
3,258,258,43,34,9,2,1
0,370,370,36,15,21,2,1
5,411,411,93,35,58,3,2

5,111,111,21,21,0,1,0
4,178,178,17,17,0,1,0
6,190,190,24,24,0,1,0
2,235,235,8,8,0,1,0
1,310,310,27,27,0,1,0
0,377,377,88,20,68,3,2
3,465,465,22,22,0,1,0

10,118,118,7,4,3,2,1
5,133,133,15,15,0,1,0
1,173,173,1,1,0,1,0
3,259,259,1,1,0,1,0
8,304,304,54,21,33,4,3
7,307,307,31,28,3,2,1
9,362,362,61,61,0,1,0
6,428,428,5,1,4,2,1
0,465,465,17,1,16,2,1
4,476,476,1,1,0,1,0
2,495,495,64,64,0,1,0

2,147,147,7,7,0,1,0
0,175,175,58,58,0,1,0
4,332,332,83,58,25,2,1
3,376,376,40,40,0,1,0
1,422,422,29,3,26,3,2

10,169,169,2,2,0,1,0
5,172,172,2,2,0,1,0
0,193,193,8,1,7,2,1
8,194,194,35,35,0,1,0
9,258,258,55,55,0,1,0
1,269,269,5,2,3,2,1
4,331,331,41,3,38,3,2
3,356,356,6,6,0,1,0
6,397,397,49,19,30,3,2
2,428,428,27,27,0,1,0
7,440,440,1,1,0,1,0

3,146,146,1,1,0,1,0
8,255,255,8,8,0,1,0
4,257,257,24,7,17,2,1
9,262,262,52,30,22,2,1
10,276,276,49,49,0,1,0
1,351,351,16,13,3,2,1
7,351,351,39,39,0,1,0
5,436,436,14,14,0,1,0
6,451,451,1,1,0,1,0
0,484,484,50,16,34,3,2
2,491,491,3,3,0,1,0

6,248,248,23,23,0,1,0
4,265,265,14,14,0,1,0
5,330,330,85,85,0,1,0
2,341,341,8,1,7,2,1
0,358,358,51,6,45,2,1
1,408,408,83,6,77,4,3
3,459,459,15,1,14,3,2

1,133,133,1,1,0,1,0
9,151,151,23,5,18,4,3
3,158,158,22,22,0,1,0
4,171,171,8,8,0,1,0
0,196,196,17,17,0,1,0
6,317,317,10,2,8,3,2
8,323,323,40,40,0,1,0
7,488,488,64,14,50,2,1
2,493,493,6,6,0,1,0
5,500,500,39,39,0,1,0

4,147,147,44,44,0,1,0
0,281,281,5,2,3,2,1
5,287,287,22,8,14,4,3
3,369,369,11,11,0,1,0
1,373,373,43,3,40,2,1
2,466,466,125,125,0,1,0

9,132,132,35,35,0,1,0
2,167,167,5,5,0,1,0
7,173,173,22,22,0,1,0
4,217,217,18,8,10,2,1
6,305,305,7,3,4,2,1
0,330,330,6,6,0,1,0
3,355,355,3,3,0,1,0
5,356,356,35,35,0,1,0
8,429,429,43,23,20,3,2
10,449,449,17,17,0,1,0
1,476,476,7,7,0,1,0

2,104,104,4,4,0,1,0
6,118,118,5,5,0,1,0
4,142,142,1,1,0,1,0
0,217,217,16,1,15,2,1
1,251,251,1,1,0,1,0
9,305,305,16,4,12,2,1
3,367,367,72,24,48,3,2
5,375,375,17,17,0,1,0
7,415,415,140,46,94,3,2
8,423,423,6,6,0,1,0

0,107,107,29,5,24,4,3
1,149,149,3,3,0,1,0
2,262,262,29,29,0,1,0
4,280,280,51,27,24,2,1
3,330,330,27,27,0,1,0
5,428,428,59,59,0,1,0

2,416,416,52,10,42,4,3
1,420,420,106,38,68,4,3
3,453,453,42,3,39,4,3
4,480,480,89,35,54,4,3
0,486,486,72,28,44,4,3

7,118,118,1,1,0,1,0
5,127,127,7,7,0,1,0
1,137,137,5,2,3,2,1
8,215,215,22,22,0,1,0
9,285,285,86,63,23,3,2
3,329,329,47,47,0,1,0
4,332,332,29,24,5,2,1
2,342,342,18,18,0,1,0
0,415,415,2,2,0,1,0
6,422,422,9,3,6,3,2

3,135,135,16,7,9,2,1
2,197,197,6,6,0,1,0
5,204,204,8,8,0,1,0
4,329,329,48,17,31,2,1
0,345,345,34,34,0,1,0
1,368,368,58,10,48,3,2
6,378,378,83,83,0,1,0

6,164,164,42,9,33,2,1
4,258,258,6,6,0,1,0
2,365,365,2,2,0,1,0
1,377,377,1,1,0,1,0
0,464,464,70,70,0,1,0
3,478,478,116,92,24,4,3
5,479,479,61,54,7,2,1

3,125,125,2,2,0,1,0
8,181,181,5,5,0,1,0
9,193,193,35,35,0,1,0
4,195,195,8,8,0,1,0
7,241,241,16,16,0,1,0
1,252,252,1,1,0,1,0
10,281,281,56,41,15,4,3
5,300,300,29,29,0,1,0
2,365,365,27,27,0,1,0
6,367,367,20,6,14,3,2
0,483,483,24,24,0,1,0

3,200,200,4,4,0,1,0
2,217,217,11,11,0,1,0
0,261,261,60,60,0,1,0
1,272,272,28,28,0,1,0
4,296,296,82,4,78,4,3
6,296,296,22,22,0,1,0
5,393,393,21,21,0,1,0

2,108,108,11,1,10,2,1
0,114,114,1,1,0,1,0
1,136,136,4,1,3,2,1
3,140,140,15,15,0,1,0
8,261,261,21,13,8,3,2
6,282,282,79,5,74,3,2
4,284,284,3,3,0,1,0
5,300,300,43,43,0,1,0
7,475,475,22,22,0,1,0

0,159,159,3,3,0,1,0
4,175,175,33,12,21,4,3
6,315,315,55,28,27,3,2
1,387,387,15,15,0,1,0
5,458,458,20,1,19,4,3
3,470,470,127,100,27,2,1
2,485,485,35,14,21,4,3

5,110,110,7,7,0,1,0
4,119,119,9,9,0,1,0
1,276,276,4,4,0,1,0
3,314,314,85,85,0,1,0
6,359,359,97,55,42,2,1
0,392,392,8,8,0,1,0
2,402,402,38,11,27,4,3

2,114,114,6,6,0,1,0
4,145,145,15,7,8,3,2
0,171,171,28,10,18,3,2
1,210,210,2,2,0,1,0
9,234,234,53,53,0,1,0
7,370,370,7,1,6,3,2
3,444,444,20,10,10,2,1
5,448,448,11,11,0,1,0
8,453,453,73,5,68,3,2
6,488,488,1,1,0,1,0

4,107,107,14,14,0,1,0
6,305,305,22,14,8,3,2
5,331,331,61,7,54,4,3
2,335,335,12,12,0,1,0
3,337,337,1,1,0,1,0
7,346,346,83,1,82,3,2
1,409,409,13,8,5,2,1
8,409,409,37,37,0,1,0
0,448,448,7,2,5,2,1

1,102,102,6,3,3,2,1
3,130,130,38,30,8,3,2
2,235,235,14,14,0,1,0
0,463,463,186,107,79,4,3

1,125,125,1,1,0,1,0
4,156,156,8,8,0,1,0
2,207,207,22,22,0,1,0
0,224,224,38,11,27,2,1
7,304,304,30,30,0,1,0
6,306,306,30,23,7,2,1
3,425,425,28,28,0,1,0
5,460,460,95,5,90,3,2

0,140,140,21,21,0,1,0
7,161,161,27,27,0,1,0
5,178,178,2,2,0,1,0
2,179,179,14,14,0,1,0
8,184,184,37,7,30,2,1
4,294,294,1,1,0,1,0
3,306,306,19,9,10,2,1
6,358,358,14,14,0,1,0
1,447,447,44,30,14,2,1

3,141,141,21,21,0,1,0
4,143,143,7,7,0,1,0
1,228,228,21,3,18,3,2
2,235,235,50,50,0,1,0
0,362,362,113,11,102,4,3

5,125,125,4,4,0,1,0
7,169,169,49,49,0,1,0
6,389,389,35,35,0,1,0
0,416,416,41,41,0,1,0
1,446,446,54,42,12,2,1
2,472,472,70,5,65,4,3
3,481,481,3,3,0,1,0
4,490,490,13,2,11,2,1

5,135,135,31,31,0,1,0
2,193,193,54,48,6,3,2
3,287,287,31,5,26,2,1
1,403,403,47,47,0,1,0
4,441,441,32,32,0,1,0
0,494,494,2,2,0,1,0

0,169,169,9,9,0,1,0
6,211,211,5,2,3,2,1
2,232,232,5,5,0,1,0
1,348,348,26,26,0,1,0
3,378,378,61,13,48,3,2
7,384,384,60,60,0,1,0
4,447,447,19,4,15,2,1
8,455,455,102,95,7,2,1
5,482,482,23,8,15,4,3

0,139,139,3,3,0,1,0
2,169,169,50,34,16,2,1
5,236,236,1,1,0,1,0
6,276,276,76,8,68,4,3
1,373,373,29,15,14,3,2
4,392,392,49,38,11,2,1
3,430,430,3,3,0,1,0

1,144,144,8,8,0,1,0
3,203,203,2,2,0,1,0
4,288,288,63,13,50,3,2
2,300,300,55,13,42,2,1
0,311,311,48,13,35,2,1
6,339,339,3,3,0,1,0
5,407,407,71,71,0,1,0

1,110,110,4,4,0,1,0
0,179,179,24,12,12,4,3
6,212,212,15,15,0,1,0
2,353,353,39,39,0,1,0
4,362,362,90,83,7,2,1
5,417,417,36,20,16,2,1
3,459,459,55,1,54,4,3

8,124,124,5,5,0,1,0
0,134,134,4,4,0,1,0
4,172,172,4,4,0,1,0
5,196,196,20,20,0,1,0
2,232,232,39,39,0,1,0
3,257,257,19,3,16,3,2
7,300,300,75,75,0,1,0
6,361,361,43,15,28,3,2
1,405,405,2,2,0,1,0

11,254,254,29,16,13,2,1
8,274,274,18,18,0,1,0
7,281,281,5,5,0,1,0
9,302,302,77,34,43,2,1
10,333,333,12,12,0,1,0
4,363,363,6,6,0,1,0
3,375,375,10,1,9,2,1
1,383,383,21,2,19,2,1
0,423,423,61,43,18,3,2
2,434,434,14,14,0,1,0
6,436,436,7,3,4,2,1
5,490,490,14,6,8,2,1

0,158,158,8,8,0,1,0
2,254,254,22,5,17,2,1
5,267,267,78,6,72,3,2
4,293,293,2,2,0,1,0
1,315,315,83,43,40,2,1
3,352,352,37,37,0,1,0

4,113,113,4,4,0,1,0
6,127,127,33,33,0,1,0
0,150,150,17,17,0,1,0
5,225,225,19,4,15,4,3
7,304,304,19,19,0,1,0
3,315,315,19,19,0,1,0
2,397,397,73,65,8,3,2
1,488,488,5,5,0,1,0

4,106,106,4,4,0,1,0
0,190,190,29,29,0,1,0
3,209,209,2,2,0,1,0
5,219,219,41,3,38,3,2
1,233,233,11,11,0,1,0
6,376,376,57,57,0,1,0
7,394,394,26,7,19,2,1
2,407,407,66,66,0,1,0

2,105,105,2,2,0,1,0
1,113,113,23,23,0,1,0
5,132,132,22,22,0,1,0
6,140,140,28,28,0,1,0
7,267,267,10,1,9,4,3
4,280,280,1,1,0,1,0
0,316,316,10,10,0,1,0
3,414,414,59,59,0,1,0

7,153,153,4,4,0,1,0
6,163,163,10,10,0,1,0
4,214,214,3,3,0,1,0
2,284,284,51,51,0,1,0
0,296,296,29,4,25,2,1
3,340,340,9,1,8,2,1
1,488,488,40,3,37,2,1
5,495,495,158,113,45,4,3

0,189,189,26,26,0,1,0
4,286,286,36,11,25,2,1
1,289,289,76,76,0,1,0
2,318,318,88,88,0,1,0
3,329,329,1,1,0,1,0

1,213,213,21,21,0,1,0
2,220,220,28,28,0,1,0
3,241,241,12,12,0,1,0
5,355,355,9,9,0,1,0
0,385,385,68,42,26,3,2
4,454,454,151,139,12,4,3

2,106,106,4,4,0,1,0
10,123,123,15,12,3,2,1
6,143,143,3,3,0,1,0
7,185,185,9,9,0,1,0
1,197,197,25,25,0,1,0
5,242,242,15,4,11,2,1
3,264,264,7,7,0,1,0
4,310,310,17,5,12,4,3
8,392,392,58,15,43,3,2
0,437,437,11,8,3,2,1
9,496,496,66,61,5,2,1

0,119,119,9,9,0,1,0
1,146,146,8,2,6,3,2
2,214,214,27,27,0,1,0
5,235,235,35,35,0,1,0
7,277,277,7,7,0,1,0
3,384,384,16,16,0,1,0
4,408,408,42,42,0,1,0
6,465,465,108,45,63,4,3

6,111,111,27,27,0,1,0
2,146,146,1,1,0,1,0
4,166,166,17,9,8,3,2
5,311,311,22,22,0,1,0
1,377,377,43,43,0,1,0
0,442,442,18,6,12,4,3
3,498,498,119,104,15,2,1

7,121,121,9,2,7,2,1
8,228,228,12,4,8,3,2
6,241,241,68,68,0,1,0
5,267,267,70,65,5,2,1
1,293,293,18,18,0,1,0
3,325,325,2,2,0,1,0
0,333,333,1,1,0,1,0
4,418,418,4,4,0,1,0
2,444,444,27,27,0,1,0

3,128,128,1,1,0,1,0
4,146,146,3,3,0,1,0
0,155,155,1,1,0,1,0
8,165,165,32,32,0,1,0
2,177,177,47,47,0,1,0
7,199,199,7,1,6,3,2
6,274,274,1,1,0,1,0
5,277,277,13,13,0,1,0
1,375,375,19,19,0,1,0
9,474,474,82,54,28,3,2

1,201,201,10,3,7,2,1
5,335,335,72,34,38,3,2
0,360,360,94,50,44,2,1
3,361,361,41,26,15,4,3
2,432,432,39,39,0,1,0
4,497,497,37,10,27,3,2

0,119,119,1,1,0,1,0
5,120,120,9,9,0,1,0
1,133,133,1,1,0,1,0
3,162,162,48,48,0,1,0
6,212,212,10,2,8,3,2
2,250,250,18,18,0,1,0
4,290,290,5,1,4,2,1
7,298,298,84,9,75,4,3

3,124,124,11,11,0,1,0
5,137,137,1,1,0,1,0
4,193,193,6,1,5,2,1
9,199,199,52,52,0,1,0
0,220,220,5,5,0,1,0
2,268,268,1,1,0,1,0
6,279,279,40,22,18,3,2
8,299,299,40,4,36,4,3
1,318,318,33,5,28,3,2
7,466,466,5,2,3,2,1

2,120,120,24,24,0,1,0
1,134,134,20,20,0,1,0
3,210,210,30,17,13,2,1
0,335,335,86,4,82,4,3
4,378,378,23,23,0,1,0

2,111,111,1,1,0,1,0
4,233,233,25,25,0,1,0
0,266,266,17,7,10,3,2
7,320,320,55,55,0,1,0
1,376,376,10,10,0,1,0
3,412,412,81,17,64,4,3
5,453,453,14,2,12,4,3
6,497,497,100,25,75,4,3

3,157,157,8,8,0,1,0
4,296,296,66,20,46,3,2
2,374,374,19,19,0,1,0
6,398,398,3,3,0,1,0
5,414,414,71,55,16,3,2
1,455,455,67,7,60,3,2
0,480,480,73,73,0,1,0

4,107,107,26,14,12,3,2
2,161,161,10,10,0,1,0
3,166,166,17,8,9,3,2
0,199,199,28,28,0,1,0
1,443,443,115,115,0,1,0

8,134,134,19,19,0,1,0
4,160,160,4,4,0,1,0
1,205,205,33,12,21,4,3
10,213,213,28,14,14,2,1
2,227,227,1,1,0,1,0
0,263,263,24,6,18,2,1
3,275,275,1,1,0,1,0
7,386,386,17,17,0,1,0
5,396,396,10,6,4,2,1
6,418,418,20,20,0,1,0
9,499,499,67,28,39,4,3

7,127,127,5,5,0,1,0
4,135,135,5,5,0,1,0
1,196,196,9,3,6,3,2
8,215,215,63,63,0,1,0
0,237,237,18,6,12,4,3
5,429,429,18,18,0,1,0
2,439,439,69,69,0,1,0
6,439,439,18,4,14,3,2
3,449,449,1,1,0,1,0
9,497,497,37,37,0,1,0

3,115,115,3,3,0,1,0
2,316,316,92,64,28,2,1
1,382,382,82,66,16,2,1
0,398,398,74,28,46,3,2
4,432,432,40,40,0,1,0

2,108,108,1,1,0,1,0
7,150,150,5,1,4,2,1
1,188,188,26,26,0,1,0
6,201,201,75,75,0,1,0
3,307,307,50,50,0,1,0
5,310,310,2,2,0,1,0
4,317,317,22,6,16,4,3
0,359,359,8,8,0,1,0

1,137,137,8,8,0,1,0
2,206,206,7,7,0,1,0
3,208,208,59,59,0,1,0
4,243,243,2,2,0,1,0
6,290,290,18,2,16,3,2
0,407,407,11,11,0,1,0
5,441,441,148,37,111,4,3

4,204,204,16,2,14,3,2
1,234,234,13,3,10,3,2
5,245,245,39,16,23,4,3
6,283,283,48,48,0,1,0
2,305,305,41,26,15,2,1
0,356,356,19,19,0,1,0
3,359,359,57,57,0,1,0

4,105,105,5,5,0,1,0
3,116,116,1,1,0,1,0
6,134,134,15,15,0,1,0
0,151,151,37,37,0,1,0
1,180,180,1,1,0,1,0
2,209,209,6,6,0,1,0
7,304,304,26,26,0,1,0
5,405,405,27,27,0,1,0
8,471,471,98,98,0,1,0

11,138,138,21,21,0,1,0
1,153,153,2,2,0,1,0
2,200,200,9,9,0,1,0
7,207,207,1,1,0,1,0
3,285,285,12,3,9,3,2
10,290,290,55,5,50,4,3
12,340,340,23,23,0,1,0
8,356,356,39,39,0,1,0
9,426,426,10,10,0,1,0
0,442,442,4,4,0,1,0
6,453,453,17,17,0,1,0
5,475,475,25,10,15,2,1
4,491,491,31,7,24,2,1

9,117,117,20,20,0,1,0
5,165,165,1,1,0,1,0
0,168,168,9,9,0,1,0
3,168,168,1,1,0,1,0
10,272,272,49,49,0,1,0
1,295,295,62,62,0,1,0
7,322,322,9,9,0,1,0
8,347,347,20,8,12,3,2
6,409,409,1,1,0,1,0
2,443,443,15,5,10,3,2
4,482,482,29,29,0,1,0

2,106,106,2,2,0,1,0
6,204,204,47,41,6,2,1
0,250,250,14,5,9,2,1
8,281,281,15,1,14,3,2
3,363,363,3,3,0,1,0
4,399,399,72,40,32,3,2
7,445,445,52,52,0,1,0
1,446,446,27,27,0,1,0
5,484,484,37,13,24,4,3

3,101,101,8,4,4,2,1
4,101,101,13,1,12,3,2
0,106,106,3,3,0,1,0
7,114,114,33,33,0,1,0
2,231,231,4,4,0,1,0
5,237,237,33,18,15,4,3
8,362,362,13,13,0,1,0
1,379,379,3,3,0,1,0
6,408,408,33,33,0,1,0

2,155,155,4,4,0,1,0
0,168,168,3,3,0,1,0
1,244,244,6,6,0,1,0
6,267,267,64,64,0,1,0
5,308,308,4,4,0,1,0
3,329,329,79,46,33,4,3
4,369,369,34,34,0,1,0
7,458,458,70,58,12,2,1

1,100,100,5,1,4,2,1
5,133,133,19,12,7,2,1
0,194,194,2,2,0,1,0
6,205,205,37,14,23,2,1
3,319,319,27,2,25,4,3
2,380,380,97,24,73,3,2
4,431,431,35,23,12,4,3

1,185,185,40,21,19,2,1
4,251,251,18,2,16,2,1
2,299,299,31,31,0,1,0
5,350,350,102,60,42,4,3
0,400,400,27,12,15,4,3
3,425,425,6,6,0,1,0
6,453,453,19,10,9,2,1

4,374,374,9,5,4,2,1
5,389,389,9,9,0,1,0
1,443,443,36,36,0,1,0
0,451,451,47,47,0,1,0
2,469,469,25,3,22,2,1
6,478,478,171,171,0,1,0
3,483,483,78,78,0,1,0

1,126,126,1,1,0,1,0
2,300,300,99,28,71,3,2
5,303,303,98,76,22,3,2
0,390,390,21,21,0,1,0
6,403,403,14,14,0,1,0
3,404,404,4,4,0,1,0
4,496,496,22,7,15,4,3

5,289,289,3,3,0,1,0
1,314,314,36,28,8,3,2
3,315,315,43,24,19,3,2
4,317,317,45,45,0,1,0
7,318,318,88,4,84,4,3
6,333,333,40,40,0,1,0
0,453,453,1,1,0,1,0
2,465,465,3,3,0,1,0

8,127,127,18,10,8,3,2
6,200,200,39,39,0,1,0
1,202,202,6,6,0,1,0
0,212,212,2,2,0,1,0
4,223,223,8,5,3,2,1
5,242,242,23,23,0,1,0
3,353,353,10,10,0,1,0
9,442,442,94,94,0,1,0
7,451,451,22,22,0,1,0
2,496,496,5,5,0,1,0

0,139,139,56,35,21,2,1
1,250,250,27,1,26,3,2
2,415,415,82,10,72,3,2
3,438,438,43,43,0,1,0

9,104,104,18,12,6,2,1
4,127,127,8,8,0,1,0
7,161,161,1,1,0,1,0
3,207,207,6,6,0,1,0
11,252,252,36,36,0,1,0
6,275,275,4,4,0,1,0
5,308,308,24,7,17,4,3
10,345,345,31,31,0,1,0
1,369,369,47,6,41,2,1
8,407,407,1,1,0,1,0
0,415,415,33,10,23,2,1
2,478,478,1,1,0,1,0

3,133,133,10,10,0,1,0
1,144,144,13,2,11,2,1
6,171,171,4,4,0,1,0
5,179,179,47,16,31,4,3
4,198,198,24,24,0,1,0
2,234,234,24,6,18,4,3
0,453,453,61,61,0,1,0

2,171,171,8,4,4,2,1
6,172,172,9,9,0,1,0
0,183,183,7,7,0,1,0
3,279,279,19,1,18,2,1
9,407,407,4,4,0,1,0
8,424,424,151,4,147,4,3
1,429,429,20,20,0,1,0
7,456,456,18,18,0,1,0
4,483,483,5,5,0,1,0
5,483,483,69,69,0,1,0

1,202,202,28,28,0,1,0
4,235,235,43,43,0,1,0
5,280,280,13,13,0,1,0
2,292,292,54,25,29,2,1
0,391,391,31,2,29,2,1
3,426,426,75,75,0,1,0

4,141,141,1,1,0,1,0
7,162,162,61,11,50,3,2
0,256,256,31,19,12,3,2
6,308,308,7,2,5,2,1
1,332,332,25,10,15,4,3
5,418,418,30,30,0,1,0
3,451,451,51,51,0,1,0
8,460,460,4,4,0,1,0
2,462,462,6,3,3,2,1

0,115,115,8,8,0,1,0
7,174,174,41,31,10,2,1
6,271,271,39,33,6,2,1
4,296,296,3,3,0,1,0
5,316,316,9,9,0,1,0
3,374,374,8,4,4,2,1
1,377,377,67,67,0,1,0
2,456,456,56,47,9,2,1

4,147,147,3,3,0,1,0
2,160,160,11,5,6,2,1
7,176,176,37,23,14,3,2
0,187,187,3,3,0,1,0
6,200,200,6,6,0,1,0
9,282,282,4,4,0,1,0
1,302,302,1,1,0,1,0
3,324,324,53,39,14,3,2
5,400,400,41,41,0,1,0
8,492,492,89,89,0,1,0

1,122,122,17,17,0,1,0
6,153,153,31,19,12,2,1
5,210,210,7,4,3,2,1
0,244,244,7,7,0,1,0
2,367,367,82,22,60,3,2
4,403,403,69,44,25,2,1
3,446,446,4,4,0,1,0

0,103,103,1,1,0,1,0
1,176,176,28,28,0,1,0
3,185,185,7,7,0,1,0
2,212,212,19,19,0,1,0
6,274,274,52,52,0,1,0
7,308,308,64,64,0,1,0
8,372,372,2,2,0,1,0
5,376,376,16,16,0,1,0
4,481,481,30,8,22,2,1

1,146,146,18,2,16,2,1
0,156,156,11,3,8,3,2
4,362,362,36,10,26,3,2
3,405,405,75,2,73,4,3
6,440,440,55,22,33,4,3
2,461,461,10,10,0,1,0
5,471,471,84,84,0,1,0

2,113,113,20,20,0,1,0
3,169,169,1,1,0,1,0
0,198,198,6,6,0,1,0
1,199,199,40,37,3,2,1
4,405,405,27,27,0,1,0
5,435,435,145,135,10,3,2

6,102,102,19,13,6,3,2
1,105,105,3,3,0,1,0
3,236,236,43,43,0,1,0
0,249,249,9,9,0,1,0
4,276,276,18,18,0,1,0
2,289,289,4,4,0,1,0
8,304,304,26,26,0,1,0
5,338,338,26,26,0,1,0
7,475,475,64,64,0,1,0

2,113,113,9,9,0,1,0
0,148,148,1,1,0,1,0
9,181,181,15,9,6,3,2
1,200,200,4,1,3,2,1
7,200,200,9,9,0,1,0
4,305,305,6,6,0,1,0
3,358,358,18,1,17,2,1
10,447,447,34,13,21,2,1
5,472,472,13,7,6,3,2
8,478,478,118,93,25,2,1
6,494,494,75,60,15,4,3

2,159,159,5,2,3,2,1
4,166,166,10,10,0,1,0
1,236,236,4,4,0,1,0
3,305,305,62,32,30,2,1
6,426,426,50,29,21,4,3
8,447,447,22,2,20,3,2
0,462,462,23,23,0,1,0
5,475,475,19,3,16,2,1
7,498,498,118,70,48,4,3

3,192,192,37,9,28,3,2
4,266,266,36,8,28,4,3
0,323,323,10,10,0,1,0
2,404,404,102,15,87,4,3
1,441,441,52,4,48,4,3
5,454,454,34,34,0,1,0

9,159,159,47,32,15,2,1
3,163,163,5,5,0,1,0
1,210,210,4,4,0,1,0
4,219,219,31,19,12,2,1
5,244,244,14,2,12,4,3
8,300,300,13,13,0,1,0
6,308,308,17,17,0,1,0
2,394,394,23,23,0,1,0
7,405,405,27,27,0,1,0
0,495,495,20,20,0,1,0

4,126,126,12,12,0,1,0
3,185,185,1,1,0,1,0
6,219,219,38,38,0,1,0
7,234,234,1,1,0,1,0
8,257,257,59,59,0,1,0
0,285,285,20,20,0,1,0
2,412,412,22,19,3,2,1
5,460,460,66,17,49,2,1
1,484,484,16,1,15,4,3

6,146,146,19,11,8,3,2
10,177,177,53,10,43,4,3
4,222,222,4,4,0,1,0
1,242,242,3,3,0,1,0
8,304,304,4,4,0,1,0
2,367,367,25,25,0,1,0
0,384,384,10,10,0,1,0
5,398,398,20,8,12,4,3
7,403,403,1,1,0,1,0
9,421,421,38,2,36,2,1
3,423,423,40,40,0,1,0

5,125,125,29,29,0,1,0
6,343,343,50,23,27,4,3
0,391,391,4,4,0,1,0
1,442,442,3,3,0,1,0
3,445,445,165,145,20,2,1
2,453,453,6,6,0,1,0
4,471,471,15,15,0,1,0

3,209,209,33,33,0,1,0
1,354,354,46,46,0,1,0
4,358,358,66,66,0,1,0
2,410,410,25,25,0,1,0
0,459,459,124,72,52,3,2

9,137,137,22,4,18,3,2
7,154,154,14,2,12,2,1
10,259,259,11,5,6,3,2
3,296,296,29,4,25,4,3
1,315,315,3,3,0,1,0
5,393,393,17,17,0,1,0
2,398,398,9,3,6,2,1
4,426,426,29,1,28,3,2
6,443,443,4,4,0,1,0
0,458,458,29,6,23,2,1
8,481,481,98,66,32,3,2

3,105,105,1,1,0,1,0
5,161,161,13,13,0,1,0
0,169,169,26,14,12,2,1
7,216,216,43,43,0,1,0
2,274,274,10,10,0,1,0
8,406,406,34,34,0,1,0
4,448,448,20,7,13,2,1
6,450,450,55,7,48,2,1
1,480,480,37,6,31,2,1

2,177,177,16,10,6,3,2
3,177,177,8,8,0,1,0
5,275,275,19,15,4,2,1
4,302,302,89,89,0,1,0
1,356,356,101,71,30,2,1
0,462,462,12,2,10,3,2

2,121,121,22,4,18,3,2
4,209,209,59,33,26,3,2
0,360,360,19,19,0,1,0
5,457,457,10,10,0,1,0
3,464,464,18,18,0,1,0
6,466,466,48,48,0,1,0
1,497,497,63,39,24,2,1

7,159,159,4,4,0,1,0
3,177,177,17,17,0,1,0
6,193,193,43,29,14,2,1
2,263,263,38,14,24,2,1
5,288,288,46,46,0,1,0
0,403,403,39,7,32,2,1
1,473,473,21,21,0,1,0
4,497,497,10,10,0,1,0

4,197,197,3,3,0,1,0
3,263,263,12,12,0,1,0
0,324,324,9,1,8,2,1
9,324,324,14,5,9,4,3
1,332,332,49,49,0,1,0
2,332,332,22,13,9,4,3
5,359,359,16,7,9,2,1
6,479,479,26,18,8,3,2
8,484,484,172,37,135,4,3
7,488,488,2,2,0,1,0

7,166,166,18,9,9,4,3
8,167,167,12,9,3,2,1
6,185,185,42,4,38,3,2
4,201,201,12,12,0,1,0
5,217,217,3,3,0,1,0
0,324,324,35,17,18,4,3
1,401,401,76,76,0,1,0
3,413,413,5,5,0,1,0
2,466,466,9,9,0,1,0

4,109,109,20,20,0,1,0
2,171,171,19,9,10,2,1
6,297,297,2,2,0,1,0
3,315,315,9,9,0,1,0
1,382,382,16,4,12,3,2
7,402,402,95,79,16,2,1
0,414,414,15,7,8,2,1
5,416,416,67,67,0,1,0

8,155,155,2,2,0,1,0
3,279,279,7,7,0,1,0
7,368,368,128,59,69,4,3
5,426,426,3,3,0,1,0
6,438,438,20,20,0,1,0
4,444,444,10,3,7,2,1
0,448,448,38,38,0,1,0
2,463,463,60,60,0,1,0
1,471,471,62,18,44,3,2

0,160,160,27,3,24,3,2
1,222,222,40,12,28,2,1
2,245,245,13,13,0,1,0
5,368,368,26,10,16,3,2
4,424,424,90,90,0,1,0
3,486,486,58,58,0,1,0

6,170,170,2,2,0,1,0
8,255,255,65,65,0,1,0
3,290,290,1,1,0,1,0
5,303,303,1,1,0,1,0
2,305,305,39,6,33,4,3
1,348,348,18,18,0,1,0
4,410,410,23,23,0,1,0
7,468,468,39,39,0,1,0
0,476,476,71,26,45,2,1
9,500,500,33,12,21,2,1

3,196,196,18,18,0,1,0
4,216,216,2,2,0,1,0
7,238,238,5,5,0,1,0
0,352,352,1,1,0,1,0
2,355,355,56,56,0,1,0
6,356,356,53,53,0,1,0
1,375,375,50,2,48,4,3
5,412,412,3,3,0,1,0
8,417,417,97,97,0,1,0

6,125,125,32,16,16,3,2
5,132,132,5,5,0,1,0
7,144,144,18,8,10,2,1
2,158,158,5,5,0,1,0
3,172,172,1,1,0,1,0
1,215,215,2,2,0,1,0
4,222,222,9,5,4,2,1
8,386,386,86,34,52,4,3
0,396,396,10,2,8,2,1
9,471,471,26,26,0,1,0

5,158,158,21,21,0,1,0
6,301,301,31,23,8,2,1
4,374,374,12,6,6,2,1
7,383,383,64,30,34,2,1
1,390,390,12,1,11,2,1
0,433,433,11,2,9,2,1
2,484,484,51,51,0,1,0
3,497,497,103,85,18,3,2

5,146,146,16,2,14,3,2
4,192,192,1,1,0,1,0
3,220,220,10,4,6,3,2
8,241,241,2,2,0,1,0
2,269,269,35,35,0,1,0
10,285,285,88,55,33,4,3
6,294,294,1,1,0,1,0
1,325,325,10,10,0,1,0
9,332,332,29,29,0,1,0
7,432,432,25,15,10,2,1
0,483,483,9,6,3,2,1

4,121,121,3,3,0,1,0
1,125,125,29,29,0,1,0
6,160,160,2,2,0,1,0
2,262,262,19,19,0,1,0
3,322,322,28,19,9,4,3
0,377,377,4,1,3,2,1
5,401,401,148,119,29,2,1

0,149,149,52,16,36,2,1
3,242,242,44,25,19,2,1
2,298,298,28,22,6,3,2
1,368,368,19,19,0,1,0
4,407,407,52,12,40,2,1

1,149,149,2,2,0,1,0
3,172,172,14,1,13,2,1
8,189,189,1,1,0,1,0
0,289,289,10,10,0,1,0
4,297,297,28,15,13,2,1
7,313,313,2,2,0,1,0
6,321,321,37,37,0,1,0
10,344,344,36,27,9,2,1
9,366,366,98,62,36,2,1
2,446,446,14,14,0,1,0
5,449,449,10,10,0,1,0
11,457,457,14,14,0,1,0

6,134,134,14,14,0,1,0
1,165,165,9,9,0,1,0
2,187,187,13,13,0,1,0
5,243,243,11,8,3,2,1
8,268,268,52,2,50,4,3
9,291,291,4,4,0,1,0
4,295,295,23,23,0,1,0
3,362,362,1,1,0,1,0
7,420,420,83,83,0,1,0
0,430,430,21,21,0,1,0

6,146,146,1,1,0,1,0
0,177,177,22,4,18,3,2
4,226,226,23,23,0,1,0
1,277,277,3,3,0,1,0
9,327,327,40,40,0,1,0
5,414,414,4,4,0,1,0
3,428,428,8,8,0,1,0
2,431,431,56,2,54,4,3
7,432,432,54,54,0,1,0
8,463,463,72,57,15,2,1

6,221,221,10,3,7,2,1
1,309,309,31,12,19,3,2
7,333,333,30,30,0,1,0
5,347,347,94,25,69,4,3
2,365,365,44,11,33,4,3
0,368,368,37,14,23,2,1
4,378,378,3,3,0,1,0
3,432,432,31,31,0,1,0

3,130,130,10,4,6,3,2
2,307,307,36,36,0,1,0
5,351,351,68,36,32,2,1
1,406,406,24,24,0,1,0
0,428,428,66,56,10,3,2
6,443,443,23,23,0,1,0
4,494,494,78,66,12,3,2

6,150,150,37,37,0,1,0
5,174,174,4,1,3,2,1
0,175,175,2,2,0,1,0
3,221,221,29,29,0,1,0
4,273,273,37,37,0,1,0
1,308,308,1,1,0,1,0
2,340,340,87,49,38,2,1

5,100,100,13,13,0,1,0
4,323,323,69,59,10,3,2
1,367,367,81,81,0,1,0
2,407,407,12,9,3,2,1
0,481,481,73,73,0,1,0
3,494,494,30,30,0,1,0

4,136,136,26,16,10,3,2
2,139,139,18,18,0,1,0
3,229,229,35,7,28,4,3
0,300,300,33,33,0,1,0
1,306,306,3,3,0,1,0
5,307,307,62,41,21,4,3
6,320,320,4,4,0,1,0

6,126,126,3,3,0,1,0
3,188,188,12,12,0,1,0
4,198,198,3,3,0,1,0
10,235,235,39,1,38,2,1
0,305,305,21,21,0,1,0
9,358,358,8,8,0,1,0
8,415,415,90,90,0,1,0
1,431,431,29,5,24,2,1
5,449,449,31,7,24,4,3
7,451,451,18,18,0,1,0
2,466,466,25,16,9,2,1

7,119,119,18,18,0,1,0
1,185,185,5,5,0,1,0
3,211,211,52,52,0,1,0
8,254,254,53,53,0,1,0
2,257,257,2,2,0,1,0
4,313,313,13,13,0,1,0
6,337,337,16,16,0,1,0
5,343,343,21,21,0,1,0
0,493,493,8,8,0,1,0

8,112,112,10,10,0,1,0
9,120,120,23,23,0,1,0
5,140,140,8,1,7,2,1
6,186,186,1,1,0,1,0
2,207,207,7,7,0,1,0
7,255,255,34,34,0,1,0
3,305,305,14,14,0,1,0
1,436,436,87,57,30,4,3
4,467,467,28,28,0,1,0
0,497,497,1,1,0,1,0

1,169,169,5,5,0,1,0
7,244,244,2,2,0,1,0
4,270,270,39,39,0,1,0
5,281,281,106,106,0,1,0
2,333,333,48,35,13,2,1
6,408,408,8,1,7,2,1
0,450,450,13,13,0,1,0
3,470,470,25,7,18,4,3

1,210,210,28,10,18,3,2
3,223,223,2,2,0,1,0
5,342,342,105,39,66,4,3
2,362,362,50,50,0,1,0
0,431,431,56,2,54,3,2
4,497,497,43,5,38,2,1

0,100,100,3,3,0,1,0
5,108,108,21,3,18,3,2
8,175,175,34,34,0,1,0
9,189,189,14,8,6,2,1
3,213,213,1,1,0,1,0
1,267,267,17,1,16,2,1
4,338,338,24,18,6,3,2
7,366,366,51,10,41,2,1
6,401,401,5,5,0,1,0
2,448,448,11,2,9,4,3

2,140,140,15,15,0,1,0
4,161,161,24,24,0,1,0
1,327,327,86,86,0,1,0
0,383,383,53,12,41,2,1
3,495,495,77,11,66,3,2

2,108,108,1,1,0,1,0
9,180,180,69,39,30,3,2
1,209,209,4,4,0,1,0
8,228,228,5,5,0,1,0
5,248,248,41,38,3,2,1
0,270,270,2,2,0,1,0
3,302,302,31,20,11,2,1
4,388,388,12,3,9,2,1
7,460,460,1,1,0,1,0
6,487,487,32,32,0,1,0

2,209,209,37,37,0,1,0
5,221,221,27,27,0,1,0
4,287,287,23,17,6,2,1
0,307,307,21,21,0,1,0
6,355,355,98,12,86,3,2
7,391,391,3,3,0,1,0
3,465,465,2,2,0,1,0
1,491,491,35,18,17,2,1

2,132,132,10,1,9,4,3
6,150,150,31,31,0,1,0
1,255,255,36,36,0,1,0
4,294,294,43,5,38,3,2
0,319,319,43,33,10,3,2
3,435,435,21,21,0,1,0
5,484,484,24,24,0,1,0

0,130,130,23,10,13,2,1
5,131,131,8,3,5,2,1
3,148,148,14,14,0,1,0
7,182,182,20,20,0,1,0
6,244,244,57,33,24,4,3
1,285,285,10,6,4,2,1
2,454,454,4,4,0,1,0
4,457,457,39,5,34,3,2

11,110,110,25,1,24,3,2
10,122,122,3,3,0,1,0
6,194,194,5,5,0,1,0
8,194,194,15,3,12,3,2
3,249,249,15,15,0,1,0
2,306,306,9,9,0,1,0
1,337,337,21,7,14,2,1
13,343,343,23,23,0,1,0
0,344,344,11,11,0,1,0
7,355,355,8,8,0,1,0
4,366,366,10,10,0,1,0
12,438,438,49,3,46,4,3
5,461,461,14,14,0,1,0
9,480,480,5,1,4,2,1

1,151,151,1,1,0,1,0
4,165,165,51,51,0,1,0
0,166,166,24,24,0,1,0
6,238,238,10,1,9,2,1
3,259,259,48,48,0,1,0
2,451,451,30,30,0,1,0
5,459,459,26,2,24,3,2

4,108,108,13,1,12,3,2
6,139,139,23,23,0,1,0
3,183,183,17,17,0,1,0
2,348,348,4,1,3,2,1
0,373,373,14,7,7,2,1
1,392,392,103,61,42,4,3
5,499,499,62,6,56,4,3

3,100,100,11,11,0,1,0
1,111,111,1,1,0,1,0
2,113,113,1,1,0,1,0
6,191,191,55,6,49,2,1
4,194,194,6,2,4,2,1
5,250,250,17,1,16,3,2
7,340,340,32,5,27,4,3
8,425,425,10,1,9,4,3
0,443,443,78,12,66,3,2

3,105,105,28,10,18,4,3
0,123,123,14,14,0,1,0
1,241,241,30,30,0,1,0
4,265,265,21,18,3,2,1
2,353,353,58,6,52,3,2
5,356,356,23,8,15,3,2

7,124,124,30,30,0,1,0
4,168,168,20,20,0,1,0
6,178,178,5,5,0,1,0
2,225,225,25,25,0,1,0
9,292,292,48,48,0,1,0
1,295,295,1,1,0,1,0
0,336,336,1,1,0,1,0
8,383,383,1,1,0,1,0
5,446,446,48,48,0,1,0
3,491,491,16,16,0,1,0

6,224,224,26,6,20,3,2
0,237,237,1,1,0,1,0
2,307,307,36,36,0,1,0
3,368,368,50,14,36,3,2
5,378,378,20,20,0,1,0
1,399,399,57,31,26,3,2
4,429,429,101,35,66,4,3

2,341,341,54,54,0,1,0
0,354,354,40,40,0,1,0
4,367,367,35,3,32,3,2
3,422,422,63,63,0,1,0
1,492,492,142,142,0,1,0

3,157,157,14,1,13,2,1
5,178,178,6,6,0,1,0
8,240,240,64,15,49,3,2
1,254,254,5,5,0,1,0
9,269,269,30,9,21,4,3
6,328,328,12,3,9,4,3
10,365,365,10,10,0,1,0
4,380,380,21,21,0,1,0
2,418,418,4,4,0,1,0
0,475,475,8,8,0,1,0
7,480,480,67,43,24,2,1

3,171,171,23,11,12,3,2
4,188,188,42,42,0,1,0
0,239,239,62,62,0,1,0
2,257,257,12,4,8,2,1
1,486,486,69,31,38,2,1

4,113,113,3,3,0,1,0
11,125,125,3,3,0,1,0
7,169,169,8,8,0,1,0
6,189,189,2,2,0,1,0
3,190,190,18,15,3,2,1
8,229,229,8,8,0,1,0
5,257,257,11,3,8,3,2
12,278,278,99,3,96,4,3
1,297,297,2,2,0,1,0
2,353,353,10,4,6,2,1
9,383,383,34,8,26,3,2
10,483,483,13,6,7,2,1
0,485,485,10,2,8,2,1

4,122,122,20,11,9,4,3
6,152,152,4,1,3,2,1
2,185,185,3,3,0,1,0
7,188,188,25,19,6,2,1
0,192,192,7,7,0,1,0
1,223,223,1,1,0,1,0
8,230,230,57,37,20,2,1
3,254,254,36,15,21,4,3
5,341,341,13,13,0,1,0

0,116,116,6,1,5,2,1
4,379,379,115,70,45,3,2
2,380,380,103,34,69,4,3
1,392,392,31,31,0,1,0
5,417,417,3,3,0,1,0
3,498,498,46,3,43,3,2

5,131,131,6,6,0,1,0
0,191,191,4,1,3,2,1
2,205,205,4,4,0,1,0
6,241,241,48,36,12,2,1
4,268,268,49,49,0,1,0
7,305,305,50,3,47,4,3
1,378,378,30,20,10,3,2
3,427,427,42,42,0,1,0

0,179,179,11,11,0,1,0
2,207,207,24,12,12,3,2
1,238,238,11,8,3,2,1
7,264,264,32,32,0,1,0
4,275,275,1,1,0,1,0
3,352,352,61,61,0,1,0
5,426,426,89,89,0,1,0
6,450,450,33,5,28,3,2

1,172,172,11,5,6,2,1
2,222,222,35,35,0,1,0
3,315,315,58,58,0,1,0
0,482,482,193,61,132,4,3

1,105,105,11,11,0,1,0
2,131,131,2,2,0,1,0
4,131,131,18,11,7,2,1
0,187,187,22,4,18,3,2
5,283,283,14,2,12,2,1
6,388,388,84,30,54,4,3
3,499,499,81,22,59,3,2

0,158,158,18,10,8,3,2
4,248,248,30,30,0,1,0
3,273,273,27,27,0,1,0
5,360,360,65,45,20,2,1
6,371,371,39,39,0,1,0
1,397,397,68,68,0,1,0
2,446,446,8,8,0,1,0

2,140,140,24,15,9,4,3
0,169,169,6,6,0,1,0
6,223,223,85,67,18,3,2
3,261,261,8,8,0,1,0
7,304,304,4,4,0,1,0
1,306,306,24,20,4,2,1
5,445,445,6,6,0,1,0
4,473,473,40,14,26,2,1

5,131,131,14,5,9,2,1
0,135,135,9,9,0,1,0
4,230,230,3,3,0,1,0
3,249,249,8,8,0,1,0
2,257,257,31,31,0,1,0
1,270,270,46,46,0,1,0
6,341,341,88,88,0,1,0
7,429,429,16,5,11,2,1

4,117,117,30,30,0,1,0
0,196,196,9,9,0,1,0
1,259,259,22,7,15,2,1
6,326,326,33,19,14,2,1
5,334,334,16,16,0,1,0
3,426,426,19,2,17,2,1
2,431,431,97,80,17,2,1

4,108,108,5,5,0,1,0
1,130,130,12,12,0,1,0
0,212,212,1,1,0,1,0
2,238,238,7,7,0,1,0
5,258,258,18,18,0,1,0
7,311,311,90,28,62,3,2
8,380,380,13,8,5,2,1
6,448,448,49,49,0,1,0
3,457,457,22,8,14,2,1
9,467,467,38,2,36,4,3

5,146,146,1,1,0,1,0
1,172,172,45,30,15,4,3
0,201,201,21,8,13,2,1
2,383,383,13,13,0,1,0
3,489,489,137,55,82,3,2
4,490,490,57,57,0,1,0

6,110,110,3,3,0,1,0
1,125,125,6,6,0,1,0
8,142,142,48,48,0,1,0
5,225,225,6,2,4,2,1
0,244,244,12,12,0,1,0
7,278,278,12,12,0,1,0
3,381,381,58,44,14,3,2
2,411,411,23,3,20,4,3
4,482,482,34,23,11,2,1

2,120,120,1,1,0,1,0
5,139,139,6,6,0,1,0
7,173,173,4,4,0,1,0
4,185,185,3,3,0,1,0
6,206,206,1,1,0,1,0
9,268,268,19,19,0,1,0
0,335,335,22,22,0,1,0
12,366,366,42,42,0,1,0
8,380,380,46,46,0,1,0
1,397,397,2,2,0,1,0
10,424,424,9,9,0,1,0
11,425,425,114,3,111,4,3
3,440,440,19,19,0,1,0

3,231,231,19,19,0,1,0
6,292,292,11,11,0,1,0
4,385,385,4,4,0,1,0
0,402,402,22,22,0,1,0
2,421,421,23,23,0,1,0
7,461,461,65,18,47,4,3
5,489,489,110,110,0,1,0
1,490,490,98,42,56,3,2

6,104,104,31,16,15,2,1
2,121,121,10,7,3,2,1
3,232,232,14,2,12,3,2
1,362,362,29,29,0,1,0
7,398,398,36,36,0,1,0
0,436,436,32,32,0,1,0
4,463,463,48,48,0,1,0
5,475,475,7,2,5,2,1

3,170,170,5,5,0,1,0
6,174,174,43,43,0,1,0
5,300,300,21,21,0,1,0
2,361,361,41,22,19,2,1
4,377,377,48,8,40,2,1
1,385,385,22,4,18,3,2
0,411,411,30,15,15,4,3
7,450,450,40,32,8,3,2

5,182,182,6,3,3,2,1
2,223,223,10,6,4,2,1
1,274,274,35,35,0,1,0
3,350,350,119,102,17,2,1
4,364,364,13,3,10,3,2
0,393,393,90,61,29,3,2

7,132,132,16,16,0,1,0
6,242,242,15,1,14,2,1
5,245,245,55,55,0,1,0
1,300,300,36,6,30,3,2
2,307,307,14,14,0,1,0
3,377,377,4,4,0,1,0
4,411,411,4,4,0,1,0
0,486,486,105,30,75,4,3

0,117,117,21,21,0,1,0
2,206,206,17,9,8,3,2
4,295,295,22,9,13,2,1
5,396,396,1,1,0,1,0
1,467,467,65,65,0,1,0
3,492,492,161,116,45,4,3

3,147,147,17,6,11,2,1
1,163,163,8,8,0,1,0
4,219,219,22,16,6,3,2
2,300,300,15,6,9,2,1
0,339,339,63,63,0,1,0
5,458,458,18,18,0,1,0
6,458,458,121,42,79,4,3

0,300,300,45,45,0,1,0
1,368,368,92,56,36,4,3
4,441,441,15,15,0,1,0
3,464,464,117,117,0,1,0
2,487,487,58,14,44,3,2

2,226,226,15,15,0,1,0
0,250,250,58,22,36,4,3
5,337,337,19,2,17,2,1
4,361,361,3,3,0,1,0
1,370,370,38,12,26,2,1
3,385,385,131,11,120,4,3

0,132,132,7,7,0,1,0
6,208,208,50,6,44,3,2
5,209,209,30,6,24,2,1
1,234,234,8,8,0,1,0
2,236,236,25,11,14,2,1
4,237,237,32,32,0,1,0
3,333,333,24,24,0,1,0
7,444,444,10,2,8,3,2

6,109,109,10,10,0,1,0
0,120,120,1,1,0,1,0
9,144,144,2,2,0,1,0
4,148,148,16,16,0,1,0
7,187,187,64,64,0,1,0
8,188,188,10,10,0,1,0
2,209,209,3,3,0,1,0
1,366,366,22,6,16,3,2
3,371,371,8,2,6,2,1
5,410,410,40,9,31,2,1

1,200,200,56,56,0,1,0
2,269,269,11,11,0,1,0
4,302,302,28,4,24,3,2
3,320,320,36,4,32,3,2
5,334,334,66,66,0,1,0
0,414,414,34,34,0,1,0

1,204,204,5,2,3,2,1
7,248,248,67,5,62,3,2
0,314,314,37,37,0,1,0
5,342,342,15,15,0,1,0
3,403,403,64,42,22,2,1
6,409,409,37,37,0,1,0
4,447,447,44,44,0,1,0
2,482,482,1,1,0,1,0

10,109,109,9,6,3,2,1
4,113,113,20,20,0,1,0
7,140,140,2,2,0,1,0
5,173,173,1,1,0,1,0
1,266,266,5,5,0,1,0
6,324,324,8,8,0,1,0
3,327,327,3,3,0,1,0
9,348,348,39,39,0,1,0
0,361,361,33,33,0,1,0
8,379,379,79,15,64,4,3
2,426,426,28,28,0,1,0

0,144,144,4,4,0,1,0
2,187,187,8,8,0,1,0
3,231,231,1,1,0,1,0
1,322,322,120,120,0,1,0
4,484,484,174,36,138,4,3

6,115,115,17,17,0,1,0
4,135,135,5,5,0,1,0
2,225,225,12,12,0,1,0
0,270,270,10,4,6,2,1
7,336,336,15,15,0,1,0
3,361,361,16,16,0,1,0
5,380,380,82,10,72,4,3
1,497,497,114,44,70,4,3

5,102,102,15,11,4,2,1
0,104,104,3,3,0,1,0
2,124,124,1,1,0,1,0
4,275,275,39,27,12,3,2
6,302,302,70,44,26,3,2
7,333,333,11,4,7,2,1
1,489,489,23,8,15,4,3
3,497,497,87,77,10,2,1

4,163,163,17,17,0,1,0
7,315,315,33,33,0,1,0
5,356,356,70,32,38,2,1
6,379,379,40,40,0,1,0
3,390,390,33,33,0,1,0
1,427,427,67,67,0,1,0
0,462,462,16,16,0,1,0
2,467,467,11,11,0,1,0

2,165,165,13,13,0,1,0
3,217,217,12,12,0,1,0
1,309,309,75,7,68,4,3
4,397,397,107,69,38,3,2
0,400,400,63,33,30,2,1

1,132,132,2,2,0,1,0
5,141,141,22,1,21,4,3
2,152,152,13,3,10,3,2
4,214,214,14,14,0,1,0
6,244,244,46,46,0,1,0
3,310,310,91,19,72,3,2
0,498,498,4,4,0,1,0

8,166,166,15,15,0,1,0
0,206,206,6,6,0,1,0
7,211,211,65,65,0,1,0
4,319,319,9,6,3,2,1
6,348,348,3,3,0,1,0
5,365,365,75,43,32,3,2
1,405,405,18,18,0,1,0
3,460,460,29,29,0,1,0
2,496,496,16,8,8,3,2

1,186,186,42,42,0,1,0
2,189,189,5,5,0,1,0
4,196,196,3,3,0,1,0
5,277,277,12,12,0,1,0
3,395,395,35,14,21,2,1
0,401,401,18,18,0,1,0
7,482,482,25,25,0,1,0
6,491,491,151,19,132,4,3

1,129,129,27,9,18,4,3
3,130,130,12,12,0,1,0
4,286,286,38,38,0,1,0
0,298,298,25,25,0,1,0
5,336,336,63,5,58,3,2
2,381,381,41,41,0,1,0

1,113,113,5,5,0,1,0
2,139,139,13,13,0,1,0
7,187,187,2,2,0,1,0
0,251,251,11,11,0,1,0
6,310,310,10,10,0,1,0
9,367,367,104,104,0,1,0
8,383,383,43,43,0,1,0
4,385,385,23,23,0,1,0
5,430,430,9,4,5,2,1
3,497,497,54,12,42,4,3

5,166,166,23,15,8,3,2
4,242,242,3,3,0,1,0
6,277,277,71,13,58,3,2
0,284,284,22,10,12,4,3
1,291,291,26,8,18,3,2
3,303,303,65,65,0,1,0
2,430,430,9,2,7,2,1

0,137,137,11,8,3,2,1
5,182,182,9,1,8,2,1
3,204,204,46,17,29,2,1
1,225,225,21,13,8,2,1
2,257,257,1,1,0,1,0
4,441,441,79,72,7,2,1
6,449,449,79,79,0,1,0

1,153,153,19,1,18,4,3
3,203,203,17,17,0,1,0
5,209,209,13,13,0,1,0
4,218,218,57,48,9,2,1
0,352,352,7,2,5,2,1
2,457,457,117,117,0,1,0

2,267,267,35,13,22,2,1
3,287,287,2,2,0,1,0
1,294,294,106,106,0,1,0
4,304,304,81,81,0,1,0
0,311,311,13,13,0,1,0

3,140,140,23,1,22,2,1
4,244,244,49,2,47,2,1
2,254,254,22,22,0,1,0
1,277,277,48,30,18,4,3
5,293,293,13,4,9,4,3
0,392,392,55,55,0,1,0

1,133,133,29,9,20,2,1
4,201,201,30,22,8,3,2
2,377,377,91,91,0,1,0
0,454,454,86,86,0,1,0
3,463,463,8,8,0,1,0

1,135,135,8,2,6,2,1
6,162,162,6,6,0,1,0
3,166,166,15,15,0,1,0
0,265,265,5,1,4,2,1
9,265,265,77,39,38,3,2
5,284,284,9,4,5,2,1
7,317,317,1,1,0,1,0
4,354,354,21,21,0,1,0
2,409,409,43,2,41,2,1
8,421,421,46,15,31,2,1

1,149,149,20,12,8,3,2
0,227,227,20,20,0,1,0
4,347,347,68,55,13,2,1
2,377,377,67,40,27,4,3
5,444,444,16,6,10,3,2
3,482,482,83,83,0,1,0

1,153,153,31,6,25,4,3
6,285,285,12,7,5,2,1
5,305,305,76,25,51,4,3
4,313,313,36,36,0,1,0
0,341,341,48,48,0,1,0
3,377,377,19,3,16,2,1
2,421,421,3,3,0,1,0

8,109,109,4,4,0,1,0
6,114,114,6,6,0,1,0
4,120,120,4,4,0,1,0
3,200,200,17,17,0,1,0
10,243,243,39,33,6,3,2
2,254,254,9,9,0,1,0
7,277,277,9,9,0,1,0
0,304,304,28,28,0,1,0
11,327,327,46,46,0,1,0
5,369,369,11,11,0,1,0
1,396,396,2,2,0,1,0
9,419,419,44,44,0,1,0

2,166,166,4,4,0,1,0
4,251,251,24,1,23,4,3
5,296,296,14,14,0,1,0
1,328,328,70,28,42,4,3
3,367,367,54,54,0,1,0
6,398,398,103,93,10,3,2
0,477,477,8,3,5,2,1

5,189,189,8,8,0,1,0
2,221,221,1,1,0,1,0
1,267,267,41,33,8,3,2
0,354,354,86,71,15,4,3
3,358,358,61,15,46,3,2
4,437,437,84,62,22,3,2

3,257,257,4,4,0,1,0
1,290,290,60,60,0,1,0
7,311,311,81,81,0,1,0
4,337,337,3,3,0,1,0
0,338,338,17,13,4,2,1
5,347,347,22,22,0,1,0
2,364,364,44,44,0,1,0
6,441,441,34,3,31,3,2

4,189,189,29,21,8,2,1
2,330,330,58,58,0,1,0
5,335,335,39,39,0,1,0
0,371,371,53,7,46,2,1
1,375,375,1,1,0,1,0
3,460,460,37,37,0,1,0
6,472,472,64,57,7,2,1

6,165,165,16,10,6,2,1
3,283,283,33,33,0,1,0
4,307,307,10,4,6,3,2
5,310,310,1,1,0,1,0
9,319,319,30,30,0,1,0
2,371,371,5,5,0,1,0
1,381,381,1,1,0,1,0
8,388,388,86,44,42,4,3
0,406,406,56,8,48,4,3
7,406,406,35,35,0,1,0

2,122,122,17,17,0,1,0
4,238,238,7,7,0,1,0
3,249,249,19,13,6,3,2
0,300,300,46,46,0,1,0
1,315,315,35,35,0,1,0
5,398,398,119,91,28,3,2

0,131,131,16,6,10,3,2
1,194,194,45,8,37,2,1
2,213,213,10,7,3,2,1
5,236,236,26,14,12,3,2
4,257,257,55,33,22,2,1
3,312,312,25,4,21,4,3

5,143,143,1,1,0,1,0
4,222,222,3,3,0,1,0
8,261,261,10,2,8,2,1
7,284,284,40,40,0,1,0
1,293,293,35,35,0,1,0
6,342,342,77,77,0,1,0
3,448,448,11,5,6,2,1
2,473,473,8,8,0,1,0
0,485,485,109,45,64,3,2

0,106,106,7,7,0,1,0
8,170,170,8,1,7,2,1
2,173,173,2,2,0,1,0
1,252,252,7,3,4,2,1
6,283,283,3,3,0,1,0
4,302,302,43,43,0,1,0
7,321,321,54,14,40,2,1
9,358,358,68,53,15,2,1
3,429,429,14,6,8,3,2
5,465,465,51,1,50,3,2

2,106,106,1,1,0,1,0
6,197,197,15,6,9,2,1
3,224,224,18,6,12,3,2
1,298,298,5,5,0,1,0
0,352,352,78,4,74,3,2
7,402,402,5,5,0,1,0
4,407,407,12,7,5,2,1
5,408,408,18,18,0,1,0
8,483,483,151,67,84,3,2

2,149,149,10,7,3,2,1
0,183,183,38,38,0,1,0
5,265,265,82,82,0,1,0
3,317,317,1,1,0,1,0
4,445,445,42,42,0,1,0
1,456,456,59,59,0,1,0

5,116,116,1,1,0,1,0
4,127,127,3,3,0,1,0
2,140,140,5,5,0,1,0
6,160,160,63,15,48,2,1
1,300,300,60,60,0,1,0
0,302,302,44,44,0,1,0
7,326,326,1,1,0,1,0
3,411,411,1,1,0,1,0

3,103,103,16,16,0,1,0
4,103,103,21,11,10,3,2
6,152,152,18,18,0,1,0
2,164,164,27,1,26,3,2
5,247,247,21,21,0,1,0
1,269,269,7,2,5,2,1
0,451,451,26,26,0,1,0

3,194,194,17,10,7,2,1
7,216,216,59,19,40,2,1
0,280,280,44,6,38,3,2
8,300,300,17,3,14,3,2
4,328,328,24,24,0,1,0
5,402,402,24,24,0,1,0
2,472,472,2,2,0,1,0
1,473,473,9,9,0,1,0
6,477,477,35,35,0,1,0

0,177,177,62,62,0,1,0
2,219,219,2,2,0,1,0
4,347,347,1,1,0,1,0
6,366,366,48,48,0,1,0
3,415,415,12,2,10,3,2
1,438,438,5,1,4,2,1
5,462,462,79,79,0,1,0
7,471,471,48,48,0,1,0

4,140,140,2,2,0,1,0
0,145,145,19,1,18,3,2
8,187,187,31,19,12,2,1
6,241,241,13,13,0,1,0
2,253,253,21,21,0,1,0
7,400,400,74,74,0,1,0
1,450,450,1,1,0,1,0
5,480,480,22,22,0,1,0
3,489,489,61,61,0,1,0

5,103,103,11,2,9,2,1
1,135,135,21,21,0,1,0
2,162,162,11,11,0,1,0
4,338,338,9,9,0,1,0
0,351,351,1,1,0,1,0
7,354,354,88,88,0,1,0
6,403,403,22,1,21,3,2
3,440,440,66,66,0,1,0

0,101,101,1,1,0,1,0
1,110,110,3,3,0,1,0
2,163,163,11,1,10,3,2
4,169,169,30,30,0,1,0
6,189,189,18,9,9,2,1
5,322,322,67,28,39,4,3
7,436,436,46,46,0,1,0
3,498,498,61,61,0,1,0

6,134,134,18,14,4,2,1
0,146,146,42,22,20,2,1
5,187,187,4,4,0,1,0
3,224,224,10,1,9,4,3
4,280,280,17,17,0,1,0
7,294,294,74,74,0,1,0
1,370,370,1,1,0,1,0
2,434,434,2,2,0,1,0

4,104,104,8,8,0,1,0
0,130,130,1,1,0,1,0
1,152,152,3,3,0,1,0
8,273,273,16,4,12,3,2
3,326,326,8,8,0,1,0
2,355,355,77,77,0,1,0
7,381,381,111,111,0,1,0
5,412,412,23,23,0,1,0
6,493,493,28,28,0,1,0

3,140,140,4,4,0,1,0
6,197,197,43,28,15,2,1
1,215,215,57,57,0,1,0
5,388,388,10,2,8,2,1
2,439,439,11,11,0,1,0
4,491,491,79,51,28,2,1
0,495,495,42,42,0,1,0

2,159,159,1,1,0,1,0
0,208,208,49,22,27,2,1
3,294,294,19,19,0,1,0
4,396,396,16,16,0,1,0
6,438,438,36,3,33,3,2
1,441,441,24,15,9,2,1
7,463,463,72,25,47,4,3
5,472,472,78,56,22,2,1

4,209,209,5,5,0,1,0
5,253,253,2,2,0,1,0
0,287,287,35,26,9,4,3
2,298,298,4,4,0,1,0
3,309,309,9,9,0,1,0
1,414,414,89,77,12,4,3
6,456,456,62,9,53,3,2
7,469,469,121,121,0,1,0

1,108,108,27,27,0,1,0
0,170,170,17,17,0,1,0
5,298,298,58,58,0,1,0
2,385,385,1,1,0,1,0
7,396,396,57,36,21,2,1
4,407,407,1,1,0,1,0
3,443,443,20,20,0,1,0
6,496,496,33,22,11,2,1

3,183,183,26,15,11,2,1
4,269,269,66,2,64,3,2
1,423,423,18,18,0,1,0
2,485,485,8,8,0,1,0
0,486,486,174,174,0,1,0

1,105,105,1,1,0,1,0
3,217,217,6,6,0,1,0
0,260,260,1,1,0,1,0
4,330,330,94,12,82,3,2
2,462,462,179,101,78,4,3
5,485,485,45,45,0,1,0

2,127,127,18,8,10,3,2
0,183,183,58,4,54,4,3
3,282,282,69,69,0,1,0
1,297,297,25,25,0,1,0
4,470,470,9,9,0,1,0

4,148,148,13,9,4,2,1
0,190,190,15,15,0,1,0
2,190,190,52,52,0,1,0
1,292,292,15,7,8,3,2
5,396,396,92,70,22,2,1
3,483,483,41,41,0,1,0

0,127,127,1,1,0,1,0
1,137,137,35,35,0,1,0
5,244,244,19,19,0,1,0
3,263,263,11,1,10,3,2
2,275,275,27,5,22,3,2
6,334,334,15,15,0,1,0
4,413,413,117,13,104,4,3

5,128,128,30,30,0,1,0
4,169,169,12,12,0,1,0
3,227,227,23,23,0,1,0
0,261,261,1,1,0,1,0
2,285,285,48,48,0,1,0
1,398,398,91,12,79,4,3

4,148,148,6,6,0,1,0
2,185,185,33,33,0,1,0
6,209,209,11,11,0,1,0
1,290,290,1,1,0,1,0
8,342,342,90,74,16,3,2
5,422,422,12,7,5,2,1
3,434,434,41,41,0,1,0
9,436,436,9,1,8,3,2
7,461,461,55,6,49,2,1
0,462,462,2,2,0,1,0

5,129,129,3,3,0,1,0
2,189,189,10,10,0,1,0
4,358,358,78,42,36,4,3
1,405,405,14,14,0,1,0
3,417,417,69,28,41,2,1
0,497,497,156,103,53,4,3

0,102,102,1,1,0,1,0
4,130,130,1,1,0,1,0
7,140,140,7,7,0,1,0
6,163,163,19,7,12,4,3
9,201,201,64,28,36,3,2
3,334,334,29,3,26,3,2
5,347,347,20,20,0,1,0
1,442,442,10,10,0,1,0
8,450,450,18,6,12,3,2
2,464,464,47,28,19,2,1

2,121,121,19,19,0,1,0
3,161,161,7,7,0,1,0
1,416,416,25,3,22,2,1
4,476,476,99,40,59,4,3
0,480,480,164,98,66,4,3

7,113,113,37,10,27,2,1
3,195,195,10,10,0,1,0
5,241,241,8,8,0,1,0
0,263,263,1,1,0,1,0
8,326,326,8,8,0,1,0
4,335,335,28,19,9,2,1
6,339,339,33,1,32,3,2
1,426,426,1,1,0,1,0
2,496,496,65,20,45,2,1
9,496,496,27,18,9,4,3

1,232,232,34,26,8,2,1
5,297,297,71,71,0,1,0
4,300,300,35,3,32,3,2
2,400,400,53,5,48,3,2
3,450,450,22,22,0,1,0
0,489,489,60,60,0,1,0

3,139,139,2,2,0,1,0
6,161,161,24,24,0,1,0
7,219,219,29,29,0,1,0
1,261,261,19,19,0,1,0
5,305,305,38,38,0,1,0
0,330,330,78,12,66,3,2
2,349,349,24,5,19,2,1
4,364,364,3,3,0,1,0

1,103,103,1,1,0,1,0
5,106,106,21,6,15,2,1
3,206,206,2,2,0,1,0
6,261,261,11,6,5,2,1
8,266,266,56,44,12,4,3
7,275,275,42,42,0,1,0
0,379,379,47,47,0,1,0
2,384,384,12,12,0,1,0
4,437,437,12,3,9,4,3

5,108,108,21,21,0,1,0
7,171,171,24,10,14,3,2
3,246,246,23,13,10,3,2
2,250,250,32,32,0,1,0
0,265,265,12,12,0,1,0
1,266,266,12,4,8,2,1
4,267,267,24,24,0,1,0
6,479,479,34,12,22,2,1

2,100,100,6,3,3,2,1
1,122,122,15,2,13,2,1
4,370,370,46,46,0,1,0
3,413,413,113,26,87,3,2
0,429,429,94,31,63,4,3
5,467,467,2,2,0,1,0

3,146,146,9,9,0,1,0
2,155,155,14,14,0,1,0
5,236,236,47,3,44,2,1
0,252,252,51,51,0,1,0
4,341,341,35,10,25,2,1
1,368,368,18,18,0,1,0
6,371,371,39,39,0,1,0

3,158,158,17,17,0,1,0
4,206,206,13,1,12,3,2
5,214,214,51,51,0,1,0
1,277,277,4,4,0,1,0
2,280,280,49,1,48,4,3
0,493,493,105,80,25,2,1

0,114,114,1,1,0,1,0
5,203,203,8,8,0,1,0
4,209,209,56,56,0,1,0
2,299,299,32,22,10,3,2
3,306,306,30,19,11,2,1
1,380,380,109,68,41,2,1

3,117,117,2,2,0,1,0
9,171,171,31,9,22,3,2
1,197,197,21,6,15,2,1
6,201,201,6,6,0,1,0
5,265,265,19,19,0,1,0
4,267,267,18,18,0,1,0
2,339,339,3,3,0,1,0
10,418,418,64,61,3,2,1
0,439,439,15,9,6,2,1
8,488,488,33,33,0,1,0
7,500,500,33,4,29,2,1

1,111,111,15,10,5,2,1
4,133,133,1,1,0,1,0
6,170,170,63,25,38,2,1
3,272,272,12,1,11,2,1
5,348,348,10,10,0,1,0
0,456,456,46,46,0,1,0
2,494,494,60,60,0,1,0

5,155,155,5,2,3,2,1
4,171,171,17,12,5,2,1
3,202,202,40,9,31,2,1
1,289,289,54,17,37,3,2
2,323,323,5,5,0,1,0
0,414,414,1,1,0,1,0
6,417,417,115,115,0,1,0

4,125,125,2,2,0,1,0
0,227,227,1,1,0,1,0
2,237,237,10,10,0,1,0
7,247,247,33,33,0,1,0
8,247,247,9,9,0,1,0
6,265,265,1,1,0,1,0
13,312,312,13,13,0,1,0
11,327,327,15,15,0,1,0
5,367,367,14,14,0,1,0
14,392,392,7,1,6,3,2
10,456,456,21,21,0,1,0
12,459,459,158,158,0,1,0
9,461,461,1,1,0,1,0
1,464,464,3,3,0,1,0
3,482,482,12,12,0,1,0

3,132,132,11,11,0,1,0
10,133,133,33,1,32,3,2
0,164,164,14,8,6,2,1
4,179,179,6,1,5,2,1
2,209,209,3,3,0,1,0
5,215,215,8,8,0,1,0
7,285,285,1,1,0,1,0
8,393,393,16,3,13,2,1
6,430,430,1,1,0,1,0
1,456,456,46,46,0,1,0
11,456,456,14,4,10,3,2
9,471,471,60,39,21,2,1

0,104,104,3,3,0,1,0
2,105,105,1,1,0,1,0
3,133,133,10,3,7,2,1
5,209,209,22,5,17,4,3
4,268,268,62,62,0,1,0
1,400,400,148,148,0,1,0

4,119,119,17,17,0,1,0
5,149,149,22,2,20,3,2
2,294,294,85,31,54,4,3
1,417,417,18,18,0,1,0
0,472,472,32,32,0,1,0
3,481,481,57,41,16,3,2

0,132,132,1,1,0,1,0
6,146,146,15,15,0,1,0
5,202,202,56,56,0,1,0
4,231,231,6,6,0,1,0
1,326,326,27,27,0,1,0
2,388,388,10,7,3,2,1
3,414,414,118,75,43,2,1

1,132,132,13,3,10,3,2
6,168,168,5,5,0,1,0
3,206,206,9,9,0,1,0
2,385,385,82,82,0,1,0
4,409,409,65,65,0,1,0
0,473,473,22,22,0,1,0
5,474,474,102,75,27,4,3

2,112,112,6,3,3,2,1
4,162,162,1,1,0,1,0
0,169,169,2,2,0,1,0
6,201,201,42,33,9,2,1
1,214,214,44,7,37,2,1
3,333,333,42,9,33,2,1
7,342,342,18,18,0,1,0
5,438,438,63,22,41,2,1

1,134,134,7,7,0,1,0
0,184,184,8,8,0,1,0
7,305,305,61,37,24,2,1
6,320,320,29,29,0,1,0
5,327,327,37,26,11,2,1
3,400,400,10,10,0,1,0
4,453,453,86,86,0,1,0
2,459,459,42,39,3,2,1

2,106,106,3,3,0,1,0
8,130,130,21,21,0,1,0
5,134,134,1,1,0,1,0
4,293,293,13,9,4,2,1
1,309,309,59,59,0,1,0
7,334,334,15,8,7,2,1
0,346,346,42,42,0,1,0
6,374,374,75,26,49,4,3
3,408,408,4,1,3,2,1

1,334,334,4,4,0,1,0
0,385,385,155,155,0,1,0
3,398,398,66,43,23,2,1
2,406,406,91,74,17,2,1

4,159,159,8,1,7,2,1
7,171,171,9,1,8,3,2
0,247,247,20,15,5,2,1
1,262,262,19,4,15,4,3
3,279,279,36,36,0,1,0
2,388,388,28,4,24,2,1
6,416,416,60,39,21,4,3
5,432,432,89,77,12,3,2

1,152,152,9,1,8,2,1
5,161,161,9,9,0,1,0
0,182,182,25,25,0,1,0
7,189,189,16,5,11,4,3
6,327,327,26,26,0,1,0
4,341,341,41,7,34,2,1
2,342,342,1,1,0,1,0
3,347,347,10,4,6,2,1
8,442,442,107,59,48,2,1

0,104,104,42,33,9,2,1
2,163,163,35,7,28,2,1
3,237,237,42,4,38,2,1
1,461,461,8,8,0,1,0

5,145,145,16,16,0,1,0
4,204,204,6,6,0,1,0
1,216,216,1,1,0,1,0
9,255,255,11,1,10,2,1
7,297,297,59,59,0,1,0
3,355,355,53,11,42,4,3
8,369,369,60,39,21,2,1
2,372,372,11,11,0,1,0
6,413,413,19,19,0,1,0
0,478,478,15,15,0,1,0

4,122,122,1,1,0,1,0
5,136,136,10,10,0,1,0
7,163,163,8,8,0,1,0
10,196,196,22,22,0,1,0
9,209,209,49,17,32,3,2
1,254,254,5,5,0,1,0
8,270,270,16,3,13,2,1
2,327,327,20,20,0,1,0
0,440,440,19,19,0,1,0
3,447,447,35,26,9,2,1
6,470,470,33,33,0,1,0

0,273,273,81,81,0,1,0
2,273,273,66,66,0,1,0
1,282,282,30,13,17,2,1
4,340,340,55,39,16,3,2
3,377,377,1,1,0,1,0

7,154,154,9,3,6,2,1
0,169,169,6,3,3,2,1
3,236,236,15,15,0,1,0
8,314,314,44,44,0,1,0
9,338,338,37,37,0,1,0
10,378,378,59,59,0,1,0
2,400,400,17,9,8,3,2
5,413,413,6,3,3,2,1
1,469,469,40,3,37,2,1
6,483,483,18,12,6,3,2
4,499,499,34,24,10,3,2

4,143,143,13,1,12,2,1
3,159,159,2,2,0,1,0
5,291,291,74,15,59,4,3
0,309,309,31,31,0,1,0
6,324,324,19,3,16,3,2
2,337,337,24,24,0,1,0
1,434,434,95,95,0,1,0

2,127,127,16,16,0,1,0
0,159,159,19,19,0,1,0
5,192,192,1,1,0,1,0
1,462,462,74,29,45,4,3
3,475,475,119,119,0,1,0
4,487,487,71,39,32,3,2

2,146,146,5,5,0,1,0
4,166,166,7,7,0,1,0
5,272,272,26,26,0,1,0
6,322,322,38,32,6,2,1
3,323,323,61,61,0,1,0
1,344,344,3,3,0,1,0
7,409,409,79,44,35,2,1
0,488,488,62,62,0,1,0

6,100,100,2,2,0,1,0
3,159,159,1,1,0,1,0
4,186,186,22,10,12,4,3
2,212,212,6,1,5,2,1
8,361,361,108,108,0,1,0
5,366,366,55,9,46,4,3
7,400,400,34,34,0,1,0
0,423,423,9,9,0,1,0
1,450,450,35,35,0,1,0

3,200,200,49,20,29,2,1
2,240,240,8,8,0,1,0
5,243,243,31,31,0,1,0
4,271,271,10,10,0,1,0
1,367,367,22,22,0,1,0
0,474,474,31,6,25,2,1
6,499,499,118,29,89,3,2

4,116,116,4,4,0,1,0
3,154,154,17,8,9,4,3
0,157,157,1,1,0,1,0
8,235,235,53,23,30,3,2
7,248,248,8,8,0,1,0
1,253,253,33,27,6,2,1
2,325,325,12,12,0,1,0
6,363,363,54,27,27,2,1
5,376,376,31,31,0,1,0

4,194,194,64,28,36,3,2
1,264,264,7,7,0,1,0
0,334,334,6,6,0,1,0
3,368,368,89,89,0,1,0
6,377,377,25,5,20,3,2
5,386,386,3,3,0,1,0
2,421,421,49,6,43,2,1

7,122,122,9,9,0,1,0
5,133,133,4,4,0,1,0
6,206,206,63,63,0,1,0
4,214,214,9,9,0,1,0
0,283,283,58,58,0,1,0
1,392,392,1,1,0,1,0
3,439,439,47,14,33,2,1
2,486,486,22,22,0,1,0

4,137,137,10,10,0,1,0
0,143,143,4,4,0,1,0
2,201,201,13,13,0,1,0
1,211,211,13,13,0,1,0
3,228,228,22,4,18,2,1
5,386,386,30,30,0,1,0
8,434,434,54,10,44,3,2
7,439,439,3,3,0,1,0
6,454,454,124,75,49,4,3

2,152,152,16,13,3,2,1
0,209,209,9,9,0,1,0
6,239,239,3,3,0,1,0
9,267,267,3,3,0,1,0
4,319,319,1,1,0,1,0
3,320,320,16,16,0,1,0
8,428,428,88,59,29,2,1
7,442,442,83,83,0,1,0
1,456,456,78,28,50,2,1
5,460,460,8,5,3,2,1

8,159,159,14,14,0,1,0
1,164,164,4,1,3,2,1
5,179,179,2,2,0,1,0
9,205,205,8,8,0,1,0
3,260,260,8,2,6,2,1
2,261,261,9,5,4,2,1
4,270,270,46,10,36,4,3
6,371,371,22,22,0,1,0
7,385,385,25,4,21,2,1
0,447,447,3,3,0,1,0
10,485,485,136,76,60,4,3

4,137,137,11,4,7,2,1
1,152,152,13,13,0,1,0
6,221,221,12,12,0,1,0
3,333,333,57,21,36,4,3
8,364,364,85,85,0,1,0
7,417,417,49,34,15,4,3
2,424,424,4,4,0,1,0
0,429,429,3,3,0,1,0
5,484,484,23,23,0,1,0

4,157,157,1,1,0,1,0
2,168,168,38,28,10,2,1
9,239,239,41,41,0,1,0
6,243,243,18,2,16,4,3
0,252,252,8,8,0,1,0
5,257,257,9,2,7,2,1
1,346,346,9,3,6,2,1
3,451,451,1,1,0,1,0
7,483,483,91,76,15,2,1
8,485,485,21,21,0,1,0

0,101,101,8,8,0,1,0
5,193,193,37,37,0,1,0
3,305,305,57,57,0,1,0
2,313,313,22,12,10,2,1
1,455,455,114,92,22,3,2
4,474,474,12,12,0,1,0

5,129,129,14,4,10,2,1
3,155,155,13,7,6,2,1
1,306,306,22,12,10,4,3
0,328,328,63,54,9,4,3
6,423,423,84,84,0,1,0
4,450,450,44,44,0,1,0
2,461,461,25,25,0,1,0

5,162,162,4,4,0,1,0
1,175,175,12,12,0,1,0
4,269,269,38,38,0,1,0
2,282,282,78,78,0,1,0
0,346,346,20,16,4,2,1
3,467,467,111,111,0,1,0

4,269,269,55,55,0,1,0
0,366,366,43,43,0,1,0
1,405,405,17,17,0,1,0
6,429,429,56,32,24,4,3
3,445,445,31,15,16,3,2
5,458,458,32,11,21,2,1
2,462,462,79,79,0,1,0

5,115,115,2,2,0,1,0
4,153,153,7,7,0,1,0
0,194,194,16,16,0,1,0
3,260,260,20,3,17,2,1
9,302,302,35,35,0,1,0
8,396,396,87,87,0,1,0
2,434,434,22,10,12,2,1
1,463,463,7,7,0,1,0
6,488,488,55,55,0,1,0
7,495,495,34,34,0,1,0

2,176,176,9,9,0,1,0
3,234,234,24,12,12,4,3
6,252,252,9,1,8,3,2
7,307,307,16,16,0,1,0
1,319,319,5,1,4,2,1
0,337,337,11,11,0,1,0
5,345,345,109,109,0,1,0
4,406,406,81,27,54,3,2

6,179,179,36,5,31,2,1
5,251,251,50,38,12,4,3
3,270,270,13,13,0,1,0
7,296,296,2,2,0,1,0
0,306,306,14,3,11,4,3
4,317,317,65,43,22,2,1
2,337,337,21,21,0,1,0
1,383,383,16,16,0,1,0

6,125,125,24,24,0,1,0
4,188,188,25,25,0,1,0
2,287,287,43,43,0,1,0
1,369,369,42,5,37,3,2
3,424,424,16,6,10,2,1
5,438,438,37,37,0,1,0
0,452,452,45,5,40,3,2

1,135,135,7,1,6,2,1
6,178,178,10,10,0,1,0
2,312,312,2,2,0,1,0
0,417,417,119,83,36,3,2
4,420,420,58,14,44,2,1
3,435,435,25,12,13,2,1
5,440,440,91,91,0,1,0

0,169,169,1,1,0,1,0
3,254,254,29,22,7,2,1
5,385,385,87,75,12,3,2
4,392,392,25,8,17,2,1
1,406,406,70,70,0,1,0
2,455,455,101,29,72,3,2

1,228,228,35,3,32,2,1
2,238,238,31,19,12,2,1
3,392,392,60,60,0,1,0
0,463,463,116,116,0,1,0
4,483,483,57,21,36,3,2

3,196,196,13,5,8,2,1
1,202,202,37,37,0,1,0
4,290,290,67,67,0,1,0
5,331,331,37,3,34,3,2
0,402,402,45,37,8,3,2
2,484,484,51,21,30,3,2

2,117,117,1,1,0,1,0
0,179,179,9,9,0,1,0
5,190,190,20,20,0,1,0
1,199,199,40,24,16,3,2
7,295,295,10,6,4,2,1
3,334,334,4,4,0,1,0
6,468,468,126,114,12,4,3
4,487,487,63,42,21,4,3

1,145,145,5,5,0,1,0
0,271,271,100,100,0,1,0
4,380,380,64,64,0,1,0
3,390,390,35,35,0,1,0
2,500,500,72,60,12,2,1

1,104,104,5,5,0,1,0
0,181,181,20,12,8,3,2
7,252,252,37,37,0,1,0
5,309,309,32,32,0,1,0
3,329,329,12,6,6,3,2
6,333,333,53,30,23,4,3
8,357,357,35,23,12,2,1
4,369,369,22,22,0,1,0
2,472,472,20,20,0,1,0

9,181,181,11,5,6,3,2
7,189,189,21,21,0,1,0
4,216,216,6,2,4,2,1
6,261,261,7,7,0,1,0
0,268,268,48,48,0,1,0
1,283,283,25,25,0,1,0
5,330,330,1,1,0,1,0
8,364,364,86,14,72,3,2
2,369,369,1,1,0,1,0
3,461,461,35,35,0,1,0

2,106,106,14,14,0,1,0
3,145,145,23,23,0,1,0
8,216,216,32,32,0,1,0
6,248,248,13,13,0,1,0
0,265,265,6,6,0,1,0
7,460,460,94,71,23,2,1
4,474,474,1,1,0,1,0
5,474,474,4,1,3,2,1
1,493,493,38,12,26,2,1

2,124,124,3,3,0,1,0
10,203,203,6,6,0,1,0
0,221,221,9,3,6,2,1
1,243,243,8,2,6,3,2
6,319,319,1,1,0,1,0
4,324,324,10,10,0,1,0
5,350,350,17,8,9,4,3
3,356,356,49,49,0,1,0
7,412,412,34,24,10,3,2
9,454,454,24,8,16,2,1
8,495,495,160,130,30,3,2

2,211,211,53,53,0,1,0
0,228,228,1,1,0,1,0
1,302,302,44,44,0,1,0
4,304,304,79,79,0,1,0
5,311,311,11,11,0,1,0
3,478,478,53,53,0,1,0

7,105,105,17,17,0,1,0
4,120,120,16,6,10,2,1
5,275,275,43,43,0,1,0
2,333,333,14,10,4,2,1
3,348,348,71,71,0,1,0
1,431,431,3,3,0,1,0
6,463,463,42,6,36,3,2
0,470,470,10,10,0,1,0

5,136,136,31,31,0,1,0
1,162,162,29,29,0,1,0
2,190,190,23,8,15,4,3
4,209,209,8,8,0,1,0
3,212,212,4,4,0,1,0
6,212,212,9,9,0,1,0
0,361,361,17,8,9,2,1
7,367,367,50,38,12,3,2

3,210,210,22,13,9,4,3
0,214,214,1,1,0,1,0
6,284,284,47,10,37,4,3
2,315,315,13,5,8,3,2
5,353,353,24,24,0,1,0
1,463,463,116,77,39,4,3
4,476,476,81,19,62,3,2

5,105,105,33,33,0,1,0
6,156,156,6,6,0,1,0
2,169,169,7,3,4,2,1
3,387,387,25,25,0,1,0
1,431,431,72,72,0,1,0
4,479,479,29,19,10,2,1
0,485,485,62,62,0,1,0

5,162,162,11,11,0,1,0
2,179,179,17,4,13,2,1
7,195,195,22,22,0,1,0
0,202,202,9,5,4,2,1
3,269,269,12,12,0,1,0
6,293,293,66,57,9,2,1
1,330,330,29,29,0,1,0
4,418,418,54,54,0,1,0

4,233,233,14,14,0,1,0
2,265,265,10,1,9,2,1
1,316,316,106,106,0,1,0
0,323,323,3,3,0,1,0
5,382,382,34,20,14,2,1
3,476,476,9,9,0,1,0
6,478,478,122,79,43,2,1

4,145,145,17,17,0,1,0
0,161,161,9,2,7,2,1
1,231,231,6,6,0,1,0
6,302,302,29,16,13,4,3
5,326,326,86,86,0,1,0
3,345,345,7,7,0,1,0
2,411,411,76,76,0,1,0
7,459,459,21,7,14,4,3

2,142,142,25,25,0,1,0
3,207,207,12,12,0,1,0
8,274,274,47,47,0,1,0
6,356,356,66,66,0,1,0
4,390,390,18,5,13,3,2
1,398,398,38,4,34,2,1
7,406,406,19,19,0,1,0
5,432,432,4,1,3,2,1
0,458,458,7,7,0,1,0

1,103,103,7,1,6,3,2
6,202,202,2,2,0,1,0
3,272,272,31,14,17,2,1
5,302,302,35,35,0,1,0
2,369,369,39,39,0,1,0
0,389,389,8,5,3,2,1
7,402,402,111,47,64,3,2
4,458,458,43,15,28,3,2

2,108,108,3,3,0,1,0
3,139,139,8,8,0,1,0
7,244,244,9,2,7,2,1
8,255,255,42,18,24,2,1
6,267,267,4,4,0,1,0
5,333,333,33,1,32,3,2
9,343,343,3,3,0,1,0
0,346,346,2,2,0,1,0
10,360,360,83,83,0,1,0
4,361,361,40,40,0,1,0
1,376,376,18,11,7,2,1

2,185,185,29,7,22,2,1
0,257,257,7,7,0,1,0
6,258,258,1,1,0,1,0
5,299,299,44,28,16,2,1
3,437,437,90,72,18,3,2
1,488,488,6,6,0,1,0
4,492,492,125,125,0,1,0

4,126,126,5,5,0,1,0
5,140,140,28,28,0,1,0
1,188,188,1,1,0,1,0
0,263,263,1,1,0,1,0
6,281,281,50,50,0,1,0
2,300,300,10,10,0,1,0
3,315,315,39,9,30,2,1
7,440,440,35,35,0,1,0
8,478,478,71,71,0,1,0

7,105,105,4,4,0,1,0
3,133,133,7,7,0,1,0
6,229,229,75,55,20,3,2
5,252,252,3,3,0,1,0
8,294,294,11,5,6,2,1
4,328,328,23,2,21,2,1
1,368,368,16,16,0,1,0
0,377,377,33,33,0,1,0
2,433,433,59,59,0,1,0

1,103,103,1,1,0,1,0
2,197,197,75,75,0,1,0
5,299,299,74,38,36,4,3
0,324,324,4,4,0,1,0
3,483,483,28,28,0,1,0
4,486,486,48,48,0,1,0

1,208,208,21,7,14,3,2
4,230,230,38,38,0,1,0
2,290,290,57,57,0,1,0
0,294,294,31,31,0,1,0
3,372,372,81,58,23,2,1
5,388,388,9,9,0,1,0

3,118,118,21,21,0,1,0
1,139,139,27,11,16,3,2
4,231,231,13,10,3,2,1
2,315,315,56,56,0,1,0
0,410,410,85,28,57,4,3

1,100,100,20,20,0,1,0
0,113,113,21,6,15,4,3
2,124,124,2,2,0,1,0
4,151,151,31,7,24,3,2
5,155,155,9,2,7,2,1
3,364,364,51,12,39,4,3

9,107,107,5,1,4,2,1
6,136,136,2,2,0,1,0
3,178,178,37,37,0,1,0
1,347,347,21,6,15,2,1
0,349,349,5,2,3,2,1
4,438,438,30,30,0,1,0
2,456,456,4,1,3,2,1
8,467,467,59,47,12,4,3
5,478,478,13,13,0,1,0
7,486,486,114,114,0,1,0

4,170,170,61,5,56,4,3
1,300,300,91,19,72,4,3
0,327,327,30,30,0,1,0
3,383,383,12,12,0,1,0
2,425,425,3,3,0,1,0
5,426,426,6,6,0,1,0

6,129,129,2,2,0,1,0
1,328,328,41,41,0,1,0
2,359,359,2,2,0,1,0
7,367,367,101,101,0,1,0
5,372,372,43,43,0,1,0
3,399,399,57,14,43,2,1
4,476,476,44,44,0,1,0
0,485,485,17,11,6,2,1

1,153,153,47,47,0,1,0
2,200,200,9,9,0,1,0
3,274,274,55,55,0,1,0
0,309,309,16,16,0,1,0
5,352,352,30,30,0,1,0
4,477,477,57,57,0,1,0

4,181,181,35,3,32,2,1
3,194,194,3,3,0,1,0
0,294,294,65,46,19,2,1
2,329,329,64,34,30,3,2
1,455,455,82,49,33,4,3

1,100,100,4,4,0,1,0
4,129,129,4,4,0,1,0
7,174,174,5,1,4,2,1
0,220,220,17,4,13,4,3
10,243,243,42,42,0,1,0
3,274,274,3,3,0,1,0
9,318,318,34,3,31,2,1
6,368,368,43,16,27,2,1
5,384,384,14,4,10,2,1
8,463,463,59,50,9,4,3
2,493,493,31,13,18,4,3

2,295,295,63,27,36,3,2
1,301,301,14,14,0,1,0
3,360,360,45,45,0,1,0
0,366,366,52,46,6,3,2
4,391,391,3,3,0,1,0
5,419,419,114,51,63,4,3

4,150,150,5,1,4,2,1
1,181,181,33,33,0,1,0
2,188,188,22,4,18,2,1
0,194,194,7,7,0,1,0
5,233,233,2,2,0,1,0
6,294,294,3,3,0,1,0
3,310,310,8,5,3,2,1
7,376,376,137,36,101,4,3
8,495,495,14,5,9,4,3

5,121,121,4,4,0,1,0
1,133,133,6,1,5,2,1
7,157,157,6,6,0,1,0
3,165,165,6,6,0,1,0
0,202,202,17,17,0,1,0
8,202,202,40,22,18,4,3
2,233,233,19,19,0,1,0
4,386,386,47,4,43,4,3
6,415,415,70,49,21,2,1

6,148,148,52,52,0,1,0
0,151,151,3,3,0,1,0
1,188,188,15,2,13,3,2
2,258,258,76,58,18,2,1
5,259,259,8,3,5,2,1
4,332,332,7,3,4,2,1
3,381,381,3,3,0,1,0

4,107,107,26,18,8,3,2
5,221,221,5,5,0,1,0
2,289,289,72,34,38,2,1
1,301,301,12,12,0,1,0
0,411,411,46,20,26,2,1
3,444,444,64,18,46,4,3

7,105,105,8,1,7,2,1
6,120,120,31,31,0,1,0
1,133,133,14,6,8,3,2
3,151,151,4,4,0,1,0
8,210,210,15,15,0,1,0
4,244,244,48,22,26,2,1
5,392,392,10,4,6,3,2
2,427,427,1,1,0,1,0
0,441,441,20,20,0,1,0

0,139,139,13,13,0,1,0
3,165,165,3,3,0,1,0
8,199,199,34,6,28,3,2
7,206,206,17,17,0,1,0
1,213,213,1,1,0,1,0
4,303,303,8,8,0,1,0
5,344,344,41,9,32,3,2
2,381,381,9,2,7,2,1
9,418,418,65,65,0,1,0
6,482,482,56,56,0,1,0

0,193,193,59,59,0,1,0
3,207,207,18,9,9,2,1
4,262,262,8,8,0,1,0
2,379,379,110,53,57,4,3
1,442,442,42,28,14,2,1

1,217,217,5,5,0,1,0
4,222,222,7,7,0,1,0
7,289,289,10,6,4,2,1
0,293,293,38,10,28,4,3
2,307,307,7,1,6,3,2
8,316,316,66,16,50,2,1
3,444,444,39,9,30,4,3
6,460,460,75,15,60,3,2
5,490,490,52,13,39,4,3

3,101,101,1,1,0,1,0
7,210,210,49,49,0,1,0
4,252,252,4,1,3,2,1
5,264,264,12,7,5,2,1
1,301,301,24,10,14,3,2
0,324,324,12,9,3,2,1
2,349,349,75,54,21,2,1
8,406,406,11,11,0,1,0
6,419,419,61,41,20,3,2

1,224,224,26,5,21,2,1
3,260,260,49,49,0,1,0
4,300,300,49,49,0,1,0
0,341,341,98,98,0,1,0
2,434,434,22,2,20,3,2

1,144,144,26,1,25,2,1
0,222,222,50,50,0,1,0
2,380,380,41,27,14,3,2
3,457,457,11,11,0,1,0
4,471,471,128,77,51,4,3

3,130,130,15,15,0,1,0
2,170,170,6,6,0,1,0
5,252,252,8,4,4,2,1
1,266,266,7,1,6,3,2
4,302,302,36,36,0,1,0
8,323,323,47,29,18,4,3
0,371,371,23,13,10,3,2
9,410,410,64,64,0,1,0
7,449,449,46,39,7,2,1
6,465,465,5,5,0,1,0

2,137,137,4,4,0,1,0
0,286,286,45,29,16,2,1
3,292,292,106,78,28,4,3
1,341,341,83,17,66,3,2
4,464,464,8,8,0,1,0

6,169,169,15,15,0,1,0
4,179,179,8,8,0,1,0
2,205,205,9,9,0,1,0
1,268,268,13,13,0,1,0
7,301,301,70,34,36,4,3
5,343,343,30,30,0,1,0
0,361,361,50,13,37,3,2
3,497,497,64,64,0,1,0

0,136,136,22,18,4,2,1
5,147,147,38,38,0,1,0
1,198,198,33,33,0,1,0
3,353,353,42,42,0,1,0
2,433,433,31,17,14,2,1
4,439,439,12,12,0,1,0

6,114,114,5,5,0,1,0
4,154,154,19,19,0,1,0
2,160,160,15,5,10,3,2
1,217,217,3,3,0,1,0
7,282,282,53,53,0,1,0
5,313,313,55,55,0,1,0
3,328,328,56,18,38,3,2
0,492,492,2,2,0,1,0

3,156,156,1,1,0,1,0
2,204,204,9,5,4,2,1
0,214,214,20,11,9,4,3
6,327,327,98,98,0,1,0
4,370,370,13,13,0,1,0
5,407,407,28,11,17,2,1
1,442,442,114,74,40,4,3

3,203,203,3,3,0,1,0
6,208,208,28,7,21,2,1
8,260,260,67,22,45,3,2
7,322,322,2,2,0,1,0
0,338,338,33,11,22,3,2
5,338,338,4,1,3,2,1
4,368,368,11,11,0,1,0
10,371,371,6,6,0,1,0
9,411,411,53,47,6,3,2
2,420,420,34,34,0,1,0
1,466,466,12,4,8,2,1

6,176,176,11,11,0,1,0
5,187,187,59,59,0,1,0
1,203,203,25,25,0,1,0
0,244,244,30,30,0,1,0
7,270,270,8,8,0,1,0
4,303,303,15,15,0,1,0
3,338,338,8,8,0,1,0
2,371,371,30,30,0,1,0

0,149,149,10,10,0,1,0
6,229,229,51,9,42,4,3
4,250,250,14,2,12,4,3
7,257,257,9,9,0,1,0
2,316,316,30,30,0,1,0
3,388,388,41,41,0,1,0
5,398,398,58,58,0,1,0
1,430,430,33,4,29,2,1

3,101,101,2,2,0,1,0
4,107,107,32,21,11,2,1
1,259,259,24,5,19,2,1
2,287,287,25,25,0,1,0
0,293,293,91,76,15,2,1

5,185,185,4,4,0,1,0
3,186,186,3,3,0,1,0
0,220,220,15,15,0,1,0
6,225,225,1,1,0,1,0
7,234,234,43,43,0,1,0
8,269,269,6,3,3,2,1
10,284,284,2,2,0,1,0
11,337,337,46,46,0,1,0
1,364,364,12,12,0,1,0
13,408,408,82,35,47,4,3
9,416,416,6,6,0,1,0
4,440,440,1,1,0,1,0
2,471,471,13,9,4,2,1
12,476,476,31,31,0,1,0

4,105,105,13,1,12,4,3
6,119,119,6,6,0,1,0
7,244,244,2,2,0,1,0
5,290,290,8,3,5,2,1
10,328,328,67,23,44,3,2
3,379,379,33,15,18,3,2
9,388,388,34,34,0,1,0
2,441,441,39,23,16,2,1
0,482,482,4,4,0,1,0
1,482,482,4,4,0,1,0
8,482,482,53,44,9,4,3

4,100,100,3,3,0,1,0
2,256,256,30,15,15,4,3
1,274,274,13,5,8,2,1
0,318,318,9,9,0,1,0
6,348,348,73,10,63,4,3
8,349,349,15,8,7,2,1
7,373,373,57,6,51,3,2
5,435,435,42,2,40,2,1
3,439,439,36,20,16,3,2

4,100,100,10,10,0,1,0
5,119,119,20,9,11,2,1
6,136,136,5,5,0,1,0
8,140,140,35,29,6,3,2
3,155,155,1,1,0,1,0
9,172,172,21,21,0,1,0
0,176,176,2,2,0,1,0
1,185,185,11,5,6,3,2
7,287,287,11,2,9,2,1
2,406,406,10,10,0,1,0

2,128,128,36,36,0,1,0
0,221,221,1,1,0,1,0
3,236,236,40,22,18,2,1
5,321,321,70,70,0,1,0
1,398,398,46,46,0,1,0
4,482,482,7,7,0,1,0

0,106,106,9,5,4,2,1
6,186,186,6,6,0,1,0
4,207,207,12,3,9,4,3
3,224,224,8,8,0,1,0
5,280,280,35,35,0,1,0
9,301,301,15,1,14,3,2
1,356,356,3,3,0,1,0
8,471,471,152,97,55,4,3
2,482,482,29,29,0,1,0
7,490,490,16,10,6,3,2

3,160,160,9,9,0,1,0
0,188,188,28,28,0,1,0
2,286,286,2,2,0,1,0
7,350,350,69,69,0,1,0
6,354,354,24,24,0,1,0
4,355,355,32,32,0,1,0
1,363,363,36,30,6,2,1
5,380,380,52,8,44,4,3

1,331,331,34,22,12,3,2
0,360,360,12,1,11,2,1
4,400,400,22,14,8,2,1
2,417,417,58,37,21,4,3
6,464,464,18,18,0,1,0
3,494,494,62,62,0,1,0
5,497,497,153,79,74,4,3

3,119,119,1,1,0,1,0
4,189,189,55,55,0,1,0
5,201,201,22,22,0,1,0
1,244,244,1,1,0,1,0
2,311,311,86,86,0,1,0
0,484,484,58,11,47,4,3

2,102,102,6,6,0,1,0
3,104,104,31,31,0,1,0
1,162,162,7,7,0,1,0
0,176,176,1,1,0,1,0
4,194,194,10,3,7,2,1
5,234,234,5,2,3,2,1
6,312,312,104,99,5,2,1

3,156,156,1,1,0,1,0
1,179,179,2,2,0,1,0
4,188,188,8,2,6,3,2
6,251,251,5,5,0,1,0
11,268,268,21,13,8,3,2
2,288,288,51,51,0,1,0
9,302,302,2,2,0,1,0
10,325,325,20,20,0,1,0
8,347,347,7,1,6,2,1
0,437,437,6,6,0,1,0
5,457,457,7,7,0,1,0
7,458,458,41,20,21,2,1
12,498,498,132,103,29,4,3

1,139,139,9,4,5,2,1
5,185,185,18,3,15,4,3
6,241,241,4,4,0,1,0
4,246,246,10,10,0,1,0
2,378,378,1,1,0,1,0
3,447,447,67,43,24,3,2
7,468,468,136,136,0,1,0
0,490,490,71,3,68,3,2

1,166,166,20,20,0,1,0
5,184,184,14,14,0,1,0
6,192,192,44,44,0,1,0
3,205,205,6,3,3,2,1
4,210,210,21,5,16,3,2
2,303,303,55,37,18,4,3
0,410,410,30,6,24,2,1

4,136,136,2,2,0,1,0
2,161,161,27,27,0,1,0
3,204,204,46,11,35,2,1
1,220,220,41,41,0,1,0
5,397,397,66,7,59,4,3
0,494,494,23,23,0,1,0

5,105,105,2,2,0,1,0
0,171,171,14,1,13,2,1
8,195,195,3,3,0,1,0
9,226,226,73,40,33,4,3
4,293,293,3,3,0,1,0
10,310,310,20,3,17,2,1
6,312,312,2,2,0,1,0
2,321,321,5,2,3,2,1
1,425,425,64,64,0,1,0
7,484,484,17,3,14,3,2
3,498,498,41,17,24,2,1

3,112,112,14,14,0,1,0
4,114,114,5,2,3,2,1
5,197,197,28,28,0,1,0
1,235,235,15,15,0,1,0
6,248,248,61,10,51,4,3
2,331,331,47,29,18,3,2
0,475,475,13,8,5,2,1
7,482,482,7,7,0,1,0

5,155,155,6,1,5,2,1
8,158,158,15,3,12,2,1
3,166,166,1,1,0,1,0
10,209,209,58,58,0,1,0
4,236,236,27,27,0,1,0
1,246,246,27,7,20,2,1
0,272,272,1,1,0,1,0
2,320,320,29,13,16,2,1
7,395,395,12,12,0,1,0
6,451,451,3,3,0,1,0
9,468,468,16,16,0,1,0

4,109,109,3,3,0,1,0
5,112,112,29,29,0,1,0
1,146,146,1,1,0,1,0
3,200,200,2,2,0,1,0
8,286,286,53,14,39,4,3
2,330,330,2,2,0,1,0
6,335,335,8,8,0,1,0
7,367,367,3,3,0,1,0
9,429,429,90,90,0,1,0
0,454,454,31,31,0,1,0

0,287,287,58,58,0,1,0
3,325,325,1,1,0,1,0
2,352,352,6,6,0,1,0
5,376,376,129,88,41,2,1
4,386,386,22,1,21,4,3
1,398,398,73,73,0,1,0

8,125,125,7,4,3,2,1
2,150,150,7,7,0,1,0
1,161,161,10,4,6,3,2
6,312,312,59,44,15,2,1
5,323,323,63,24,39,4,3
7,352,352,55,55,0,1,0
0,394,394,23,23,0,1,0
4,399,399,3,3,0,1,0
3,452,452,15,15,0,1,0

1,139,139,55,55,0,1,0
4,240,240,1,1,0,1,0
3,407,407,47,47,0,1,0
0,428,428,4,4,0,1,0
2,491,491,139,125,14,3,2

9,108,108,38,26,12,2,1
6,235,235,6,6,0,1,0
2,287,287,14,14,0,1,0
7,325,325,17,17,0,1,0
4,366,366,49,49,0,1,0
0,367,367,8,2,6,2,1
8,383,383,3,3,0,1,0
1,393,393,1,1,0,1,0
3,424,424,11,11,0,1,0
5,494,494,72,72,0,1,0

0,148,148,6,6,0,1,0
5,212,212,43,31,12,3,2
2,302,302,54,28,26,4,3
4,358,358,28,28,0,1,0
3,437,437,55,55,0,1,0
1,442,442,80,2,78,3,2

1,122,122,5,1,4,2,1
2,126,126,1,1,0,1,0
3,158,158,40,4,36,2,1
0,221,221,23,15,8,2,1
5,332,332,129,41,88,4,3
6,356,356,5,1,4,2,1
4,405,405,1,1,0,1,0

1,100,100,30,30,0,1,0
5,106,106,12,12,0,1,0
4,165,165,41,41,0,1,0
3,221,221,10,10,0,1,0
0,340,340,25,25,0,1,0
2,393,393,11,11,0,1,0

8,118,118,27,27,0,1,0
5,159,159,6,6,0,1,0
7,161,161,26,26,0,1,0
1,167,167,3,3,0,1,0
6,198,198,4,4,0,1,0
2,219,219,25,13,12,3,2
0,246,246,14,14,0,1,0
4,349,349,11,11,0,1,0
3,464,464,67,57,10,2,1

7,123,123,16,16,0,1,0
3,125,125,1,1,0,1,0
2,139,139,28,28,0,1,0
6,147,147,3,3,0,1,0
8,149,149,12,8,4,2,1
4,231,231,13,3,10,3,2
9,238,238,47,2,45,4,3
0,300,300,2,2,0,1,0
5,414,414,9,9,0,1,0
1,491,491,43,43,0,1,0

11,101,101,23,23,0,1,0
10,137,137,13,10,3,2,1
9,152,152,13,13,0,1,0
5,185,185,1,1,0,1,0
0,259,259,31,15,16,3,2
4,260,260,1,1,0,1,0
2,261,261,19,19,0,1,0
8,310,310,5,5,0,1,0
1,375,375,1,1,0,1,0
7,377,377,2,2,0,1,0
3,437,437,24,5,19,2,1
6,482,482,58,39,19,2,1

0,136,136,40,12,28,2,1
3,138,138,5,1,4,2,1
1,384,384,4,4,0,1,0
7,395,395,83,53,30,4,3
5,409,409,26,11,15,2,1
4,410,410,7,7,0,1,0
6,429,429,56,4,52,3,2
2,434,434,19,7,12,2,1

5,101,101,4,4,0,1,0
3,131,131,9,9,0,1,0
0,171,171,39,23,16,3,2
6,208,208,31,8,23,2,1
8,211,211,51,51,0,1,0
7,217,217,4,1,3,2,1
2,348,348,3,3,0,1,0
1,349,349,9,9,0,1,0
4,481,481,17,17,0,1,0

0,155,155,12,12,0,1,0
3,157,157,7,7,0,1,0
5,241,241,11,2,9,3,2
4,310,310,60,39,21,4,3
6,333,333,56,56,0,1,0
1,353,353,3,3,0,1,0
2,477,477,130,130,0,1,0

0,108,108,1,1,0,1,0
3,120,120,1,1,0,1,0
8,135,135,1,1,0,1,0
2,166,166,14,5,9,2,1
5,190,190,2,2,0,1,0
4,196,196,4,4,0,1,0
7,246,246,10,10,0,1,0
6,256,256,44,44,0,1,0
1,288,288,16,16,0,1,0
10,297,297,91,52,39,4,3
9,372,372,36,36,0,1,0

1,110,110,7,7,0,1,0
4,134,134,1,1,0,1,0
10,174,174,6,6,0,1,0
8,250,250,72,72,0,1,0
0,253,253,1,1,0,1,0
5,283,283,5,5,0,1,0
6,322,322,24,24,0,1,0
3,378,378,35,35,0,1,0
9,393,393,33,33,0,1,0
7,441,441,44,32,12,3,2
2,457,457,19,19,0,1,0

3,119,119,22,2,20,3,2
0,215,215,9,9,0,1,0
1,252,252,16,5,11,2,1
5,333,333,26,26,0,1,0
2,399,399,118,7,111,4,3
4,476,476,68,15,53,4,3

0,172,172,38,28,10,2,1
5,195,195,19,10,9,4,3
3,227,227,27,2,25,3,2
1,245,245,11,11,0,1,0
4,255,255,24,11,13,2,1
6,290,290,62,37,25,2,1
2,409,409,8,1,7,2,1

2,209,209,36,2,34,4,3
1,229,229,22,22,0,1,0
5,345,345,46,26,20,2,1
0,371,371,49,49,0,1,0
4,392,392,49,23,26,3,2
3,409,409,60,60,0,1,0

0,135,135,16,16,0,1,0
5,179,179,25,25,0,1,0
1,217,217,8,8,0,1,0
3,259,259,1,1,0,1,0
4,308,308,34,22,12,4,3
6,370,370,8,8,0,1,0
7,375,375,92,77,15,2,1
2,455,455,60,47,13,4,3

2,166,166,20,20,0,1,0
6,186,186,70,70,0,1,0
4,197,197,2,2,0,1,0
3,205,205,40,8,32,2,1
5,210,210,5,5,0,1,0
1,460,460,8,3,5,2,1
0,488,488,34,34,0,1,0

0,115,115,1,1,0,1,0
5,139,139,22,22,0,1,0
1,161,161,2,2,0,1,0
3,166,166,7,7,0,1,0
7,215,215,14,6,8,3,2
10,224,224,5,5,0,1,0
4,281,281,2,2,0,1,0
2,307,307,9,9,0,1,0
8,330,330,119,83,36,3,2
9,359,359,8,2,6,2,1
6,369,369,30,30,0,1,0

3,169,169,9,9,0,1,0
5,196,196,3,3,0,1,0
6,208,208,5,5,0,1,0
1,339,339,53,53,0,1,0
4,404,404,13,7,6,2,1
7,413,413,15,15,0,1,0
0,447,447,1,1,0,1,0
2,459,459,65,11,54,4,3
8,479,479,165,130,35,3,2

0,111,111,31,20,11,2,1
2,152,152,23,23,0,1,0
4,347,347,86,46,40,3,2
1,439,439,53,23,30,3,2
3,471,471,1,1,0,1,0

0,209,209,13,1,12,2,1
1,272,272,6,1,5,2,1
5,299,299,6,6,0,1,0
6,330,330,14,14,0,1,0
8,366,366,130,58,72,4,3
4,401,401,7,2,5,2,1
7,410,410,2,2,0,1,0
3,429,429,1,1,0,1,0
2,445,445,124,124,0,1,0

1,143,143,22,22,0,1,0
3,189,189,4,4,0,1,0
5,244,244,21,12,9,2,1
7,362,362,28,2,26,3,2
6,382,382,101,66,35,3,2
2,415,415,9,9,0,1,0
8,440,440,27,27,0,1,0
0,480,480,48,48,0,1,0
4,491,491,9,9,0,1,0

5,302,302,10,10,0,1,0
3,305,305,77,49,28,3,2
1,389,389,53,42,11,2,1
4,436,436,52,2,50,2,1
0,439,439,59,39,20,3,2
2,454,454,59,59,0,1,0

6,295,295,93,53,40,3,2
0,340,340,47,15,32,2,1
5,356,356,28,19,9,4,3
2,364,364,15,9,6,3,2
1,432,432,68,68,0,1,0
3,444,444,29,9,20,3,2
4,480,480,5,5,0,1,0

2,126,126,2,2,0,1,0
4,126,126,39,39,0,1,0
0,163,163,1,1,0,1,0
7,202,202,15,8,7,2,1
6,234,234,28,28,0,1,0
5,280,280,59,59,0,1,0
3,284,284,20,2,18,4,3
1,406,406,2,2,0,1,0

1,150,150,38,30,8,3,2
2,265,265,6,6,0,1,0
3,326,326,100,2,98,4,3
4,427,427,33,33,0,1,0
0,434,434,65,65,0,1,0

7,181,181,31,31,0,1,0
1,208,208,21,8,13,2,1
4,228,228,3,3,0,1,0
3,282,282,46,31,15,2,1
5,330,330,70,18,52,3,2
0,367,367,37,37,0,1,0
6,399,399,10,10,0,1,0
2,425,425,10,4,6,2,1

2,202,202,21,21,0,1,0
6,240,240,54,42,12,2,1
4,244,244,11,11,0,1,0
1,353,353,10,10,0,1,0
3,370,370,50,31,19,2,1
0,400,400,54,32,22,2,1
5,425,425,58,58,0,1,0

1,195,195,12,12,0,1,0
0,219,219,24,12,12,4,3
4,221,221,2,2,0,1,0
7,231,231,2,2,0,1,0
5,255,255,73,26,47,3,2
2,307,307,8,8,0,1,0
6,429,429,47,47,0,1,0
3,462,462,91,91,0,1,0

0,118,118,29,29,0,1,0
3,294,294,11,11,0,1,0
4,306,306,64,12,52,4,3
2,315,315,51,43,8,2,1
1,479,479,74,44,30,2,1

5,162,162,2,2,0,1,0
6,177,177,2,2,0,1,0
1,244,244,37,15,22,2,1
3,299,299,26,12,14,3,2
2,354,354,5,5,0,1,0
0,364,364,48,8,40,3,2
8,446,446,20,6,14,2,1
4,464,464,2,2,0,1,0
7,490,490,171,149,22,3,2

1,188,188,11,11,0,1,0
0,388,388,130,117,13,2,1
3,413,413,21,8,13,2,1
4,416,416,6,6,0,1,0
2,426,426,3,3,0,1,0
5,496,496,167,137,30,4,3

4,141,141,26,6,20,3,2
1,155,155,1,1,0,1,0
3,196,196,22,22,0,1,0
9,292,292,22,22,0,1,0
0,340,340,4,1,3,2,1
2,349,349,3,3,0,1,0
7,357,357,68,26,42,4,3
5,424,424,24,8,16,2,1
6,456,456,10,10,0,1,0
8,465,465,65,49,16,2,1

5,170,170,3,3,0,1,0
6,181,181,65,65,0,1,0
3,193,193,37,37,0,1,0
0,233,233,2,2,0,1,0
2,240,240,18,3,15,4,3
1,261,261,33,33,0,1,0
4,278,278,8,3,5,2,1

7,188,188,36,14,22,2,1
4,234,234,43,29,14,2,1
6,250,250,51,5,46,3,2
1,385,385,4,1,3,2,1
0,388,388,11,11,0,1,0
5,391,391,55,55,0,1,0
8,396,396,5,5,0,1,0
3,488,488,12,12,0,1,0
2,494,494,7,7,0,1,0

5,102,102,21,21,0,1,0
2,136,136,25,4,21,4,3
4,169,169,22,22,0,1,0
3,206,206,16,2,14,2,1
1,241,241,24,7,17,2,1
0,415,415,51,51,0,1,0

7,112,112,6,6,0,1,0
4,141,141,3,3,0,1,0
8,194,194,1,1,0,1,0
9,225,225,24,24,0,1,0
10,246,246,27,21,6,3,2
1,266,266,53,4,49,2,1
6,314,314,2,2,0,1,0
3,361,361,25,7,18,3,2
11,383,383,73,23,50,3,2
5,385,385,3,3,0,1,0
0,399,399,1,1,0,1,0
2,409,409,15,15,0,1,0

0,184,184,13,13,0,1,0
6,204,204,15,1,14,4,3
8,234,234,9,3,6,2,1
1,281,281,12,12,0,1,0
9,296,296,56,43,13,2,1
7,297,297,3,3,0,1,0
4,354,354,24,14,10,3,2
10,358,358,1,1,0,1,0
3,370,370,3,3,0,1,0
5,404,404,36,36,0,1,0
11,417,417,89,89,0,1,0
2,486,486,1,1,0,1,0

6,120,120,19,19,0,1,0
2,163,163,27,27,0,1,0
4,166,166,26,26,0,1,0
0,230,230,12,3,9,2,1
3,389,389,4,4,0,1,0
1,403,403,7,7,0,1,0
5,407,407,77,27,50,4,3
7,423,423,25,25,0,1,0

5,181,181,67,21,46,3,2
4,194,194,2,2,0,1,0
6,216,216,6,6,0,1,0
1,217,217,21,16,5,2,1
0,219,219,26,26,0,1,0
3,243,243,30,10,20,3,2
2,299,299,19,7,12,4,3

4,151,151,50,40,10,2,1
5,227,227,7,7,0,1,0
1,355,355,4,1,3,2,1
3,395,395,17,9,8,2,1
2,432,432,69,69,0,1,0
0,456,456,105,59,46,2,1

4,150,150,20,20,0,1,0
3,167,167,21,21,0,1,0
1,204,204,19,11,8,3,2
2,244,244,4,4,0,1,0
5,263,263,6,6,0,1,0
7,321,321,101,101,0,1,0
8,401,401,28,11,17,3,2
0,425,425,5,1,4,2,1
6,455,455,9,9,0,1,0

7,161,161,12,12,0,1,0
1,190,190,33,18,15,2,1
5,303,303,71,35,36,4,3
0,347,347,24,24,0,1,0
2,352,352,38,29,9,2,1
6,369,369,36,36,0,1,0
4,383,383,2,2,0,1,0
3,485,485,22,14,8,3,2

3,165,165,16,5,11,2,1
1,230,230,9,3,6,2,1
4,292,292,80,10,70,3,2
5,327,327,11,11,0,1,0
0,449,449,43,43,0,1,0
2,465,465,124,66,58,3,2

0,185,185,49,43,6,3,2
4,188,188,22,22,0,1,0
2,241,241,47,11,36,4,3
3,285,285,26,16,10,2,1
1,305,305,42,1,41,4,3

0,218,218,10,10,0,1,0
5,235,235,19,3,16,3,2
2,300,300,70,55,15,2,1
3,309,309,37,26,11,2,1
6,442,442,112,42,70,3,2
4,483,483,34,7,27,4,3
1,489,489,1,1,0,1,0

6,180,180,17,17,0,1,0
2,181,181,9,5,4,2,1
4,209,209,40,7,33,2,1
0,217,217,20,20,0,1,0
1,249,249,4,1,3,2,1
3,313,313,17,17,0,1,0
5,343,343,39,39,0,1,0
7,388,388,77,77,0,1,0

5,143,143,1,1,0,1,0
9,143,143,9,6,3,2,1
0,211,211,1,1,0,1,0
1,232,232,1,1,0,1,0
7,268,268,2,2,0,1,0
10,303,303,3,3,0,1,0
8,321,321,108,108,0,1,0
4,331,331,26,6,20,3,2
3,332,332,62,62,0,1,0
6,397,397,3,3,0,1,0
2,434,434,46,31,15,2,1

0,115,115,7,7,0,1,0
3,225,225,35,35,0,1,0
4,251,251,14,14,0,1,0
5,287,287,55,31,24,4,3
1,321,321,81,81,0,1,0
2,450,450,40,40,0,1,0

6,178,178,29,29,0,1,0
2,250,250,10,10,0,1,0
1,283,283,17,5,12,2,1
4,296,296,72,72,0,1,0
0,323,323,15,15,0,1,0
5,326,326,1,1,0,1,0
3,433,433,110,66,44,3,2

5,102,102,20,15,5,2,1
0,121,121,2,2,0,1,0
7,153,153,20,5,15,3,2
4,243,243,11,11,0,1,0
1,280,280,74,74,0,1,0
6,318,318,26,4,22,3,2
2,358,358,23,23,0,1,0
3,391,391,4,4,0,1,0

3,185,185,2,2,0,1,0
2,229,229,77,47,30,3,2
4,295,295,38,38,0,1,0
5,302,302,80,80,0,1,0
0,388,388,4,4,0,1,0
1,469,469,27,27,0,1,0

2,321,321,91,30,61,4,3
3,337,337,38,38,0,1,0
4,347,347,2,2,0,1,0
0,372,372,74,66,8,2,1
1,449,449,91,52,39,2,1

8,141,141,10,2,8,2,1
4,180,180,10,1,9,3,2
5,241,241,7,1,6,3,2
6,358,358,119,39,80,3,2
3,397,397,61,7,54,3,2
7,426,426,2,2,0,1,0
0,435,435,11,3,8,3,2
1,479,479,44,44,0,1,0
2,496,496,24,12,12,3,2

1,114,114,12,12,0,1,0
7,167,167,12,6,6,3,2
3,282,282,29,5,24,3,2
4,328,328,5,2,3,2,1
2,348,348,58,58,0,1,0
0,381,381,4,4,0,1,0
6,417,417,13,13,0,1,0
5,464,464,141,69,72,4,3

7,105,105,12,12,0,1,0
0,114,114,3,3,0,1,0
1,129,129,36,36,0,1,0
4,169,169,5,5,0,1,0
6,200,200,10,10,0,1,0
3,201,201,13,7,6,2,1
5,231,231,57,57,0,1,0
2,379,379,1,1,0,1,0

2,108,108,8,8,0,1,0
7,152,152,34,34,0,1,0
0,183,183,8,3,5,2,1
5,185,185,18,6,12,3,2
1,240,240,5,5,0,1,0
3,252,252,16,9,7,2,1
6,301,301,27,5,22,3,2
4,403,403,80,29,51,4,3

1,210,210,26,10,16,3,2
0,288,288,42,42,0,1,0
4,300,300,41,41,0,1,0
3,365,365,17,10,7,2,1
6,392,392,67,51,16,2,1
5,422,422,40,18,22,2,1
2,484,484,41,41,0,1,0

6,120,120,1,1,0,1,0
7,143,143,5,5,0,1,0
4,167,167,2,2,0,1,0
2,202,202,7,2,5,2,1
3,247,247,49,43,6,3,2
8,265,265,46,46,0,1,0
1,307,307,17,8,9,2,1
5,340,340,31,14,17,4,3
0,358,358,2,2,0,1,0
9,361,361,71,71,0,1,0

4,125,125,2,2,0,1,0
6,134,134,44,44,0,1,0
3,139,139,7,7,0,1,0
1,164,164,3,3,0,1,0
2,240,240,2,2,0,1,0
8,316,316,21,21,0,1,0
7,332,332,3,3,0,1,0
5,358,358,59,59,0,1,0
0,436,436,63,27,36,4,3

0,115,115,3,3,0,1,0
3,117,117,26,26,0,1,0
7,148,148,32,14,18,3,2
4,205,205,1,1,0,1,0
5,213,213,26,26,0,1,0
6,251,251,2,2,0,1,0
2,397,397,7,7,0,1,0
8,404,404,75,2,73,4,3
1,459,459,5,5,0,1,0

5,113,113,11,11,0,1,0
0,134,134,6,6,0,1,0
4,158,158,1,1,0,1,0
1,268,268,43,13,30,3,2
7,276,276,19,12,7,2,1
6,363,363,16,1,15,2,1
9,364,364,15,15,0,1,0
3,373,373,4,1,3,2,1
8,405,405,119,44,75,4,3
2,430,430,16,4,12,2,1

8,102,102,10,2,8,3,2
2,219,219,9,9,0,1,0
1,244,244,15,11,4,2,1
7,286,286,49,49,0,1,0
3,301,301,12,12,0,1,0
9,322,322,44,44,0,1,0
5,330,330,5,5,0,1,0
6,398,398,20,20,0,1,0
0,457,457,61,61,0,1,0
4,470,470,28,28,0,1,0

5,117,117,3,3,0,1,0
6,141,141,4,1,3,2,1
1,153,153,15,3,12,3,2
2,276,276,50,43,7,2,1
3,287,287,22,22,0,1,0
4,321,321,113,93,20,3,2
0,421,421,20,14,6,3,2

2,152,152,1,1,0,1,0
5,155,155,22,22,0,1,0
7,167,167,4,4,0,1,0
0,211,211,4,4,0,1,0
1,230,230,15,11,4,2,1
3,259,259,9,9,0,1,0
10,289,289,34,34,0,1,0
9,381,381,65,59,6,3,2
8,384,384,45,19,26,3,2
4,408,408,44,44,0,1,0
6,472,472,3,3,0,1,0

3,109,109,23,1,22,4,3
0,338,338,42,42,0,1,0
6,364,364,27,10,17,2,1
4,407,407,21,21,0,1,0
2,424,424,15,5,10,3,2
5,430,430,119,100,19,2,1
1,463,463,16,6,10,2,1

8,124,124,10,10,0,1,0
1,160,160,22,22,0,1,0
2,167,167,4,4,0,1,0
4,181,181,8,8,0,1,0
7,203,203,13,4,9,4,3
5,221,221,15,6,9,2,1
6,305,305,81,32,49,2,1
3,324,324,35,14,21,4,3
0,378,378,7,7,0,1,0

1,198,198,22,16,6,3,2
4,302,302,48,48,0,1,0
2,322,322,13,7,6,2,1
3,341,341,70,22,48,4,3
0,361,361,105,71,34,3,2

4,106,106,3,3,0,1,0
7,213,213,64,46,18,3,2
2,247,247,12,3,9,4,3
3,294,294,1,1,0,1,0
6,320,320,13,7,6,3,2
5,345,345,42,42,0,1,0
8,349,349,23,23,0,1,0
0,386,386,18,18,0,1,0
1,406,406,62,26,36,2,1

6,152,152,17,17,0,1,0
4,154,154,19,10,9,4,3
2,172,172,9,9,0,1,0
0,176,176,38,14,24,3,2
3,310,310,30,30,0,1,0
5,315,315,53,3,50,3,2
1,319,319,12,12,0,1,0

10,138,138,25,25,0,1,0
3,156,156,3,3,0,1,0
8,165,165,35,35,0,1,0
6,187,187,7,7,0,1,0
1,226,226,5,5,0,1,0
9,228,228,5,5,0,1,0
2,261,261,34,34,0,1,0
5,272,272,14,5,9,4,3
0,289,289,10,10,0,1,0
7,340,340,9,9,0,1,0
4,408,408,33,33,0,1,0

6,107,107,36,5,31,2,1
1,114,114,2,2,0,1,0
5,135,135,8,8,0,1,0
2,255,255,34,34,0,1,0
7,290,290,5,5,0,1,0
0,329,329,54,28,26,2,1
4,399,399,32,18,14,2,1
3,486,486,3,3,0,1,0

4,252,252,51,3,48,4,3
3,261,261,11,11,0,1,0
0,293,293,24,24,0,1,0
5,344,344,55,21,34,3,2
1,480,480,90,90,0,1,0
2,492,492,65,16,49,3,2

4,180,180,37,28,9,2,1
3,181,181,11,11,0,1,0
7,226,226,31,6,25,3,2
5,246,246,32,4,28,2,1
1,408,408,8,4,4,2,1
0,418,418,28,16,12,4,3
2,492,492,25,18,7,2,1
6,492,492,67,27,40,3,2

4,199,199,1,1,0,1,0
2,231,231,31,31,0,1,0
6,231,231,21,21,0,1,0
5,237,237,23,23,0,1,0
3,363,363,50,50,0,1,0
0,445,445,55,1,54,3,2
7,466,466,102,102,0,1,0
1,474,474,1,1,0,1,0

4,104,104,5,1,4,2,1
5,126,126,26,26,0,1,0
2,133,133,28,19,9,4,3
3,181,181,28,28,0,1,0
1,306,306,35,35,0,1,0
0,338,338,26,26,0,1,0

2,103,103,5,5,0,1,0
7,145,145,46,33,13,4,3
0,172,172,30,30,0,1,0
3,221,221,6,6,0,1,0
1,336,336,30,30,0,1,0
5,345,345,4,4,0,1,0
4,440,440,27,8,19,2,1
6,492,492,40,1,39,2,1

0,120,120,48,48,0,1,0
3,206,206,28,28,0,1,0
1,208,208,41,2,39,2,1
2,314,314,24,24,0,1,0

6,177,177,8,8,0,1,0
0,251,251,13,13,0,1,0
1,264,264,24,18,6,3,2
2,314,314,51,51,0,1,0
5,388,388,53,53,0,1,0
3,445,445,43,43,0,1,0
4,471,471,105,12,93,4,3

6,151,151,12,12,0,1,0
5,181,181,44,44,0,1,0
2,221,221,11,11,0,1,0
3,254,254,44,20,24,2,1
4,321,321,28,28,0,1,0
1,329,329,56,21,35,3,2
0,337,337,3,3,0,1,0

1,129,129,10,10,0,1,0
4,153,153,45,27,18,3,2
2,250,250,51,51,0,1,0
5,346,346,34,34,0,1,0
3,356,356,6,6,0,1,0
0,480,480,57,57,0,1,0

2,111,111,10,10,0,1,0
1,121,121,8,8,0,1,0
5,312,312,10,10,0,1,0
0,340,340,85,17,68,3,2
3,412,412,125,92,33,4,3
4,448,448,31,31,0,1,0

6,114,114,6,6,0,1,0
0,167,167,1,1,0,1,0
1,284,284,7,7,0,1,0
2,288,288,20,7,13,2,1
4,354,354,118,82,36,4,3
5,461,461,10,10,0,1,0
3,487,487,147,47,100,3,2

4,161,161,8,8,0,1,0
1,295,295,43,21,22,3,2
0,306,306,72,60,12,3,2
5,354,354,105,9,96,4,3
3,481,481,29,5,24,3,2
2,494,494,10,1,9,2,1

5,271,271,36,36,0,1,0
3,279,279,4,4,0,1,0
4,302,302,77,9,68,3,2
1,370,370,58,52,6,3,2
2,391,391,47,47,0,1,0
0,430,430,53,13,40,3,2

3,143,143,10,6,4,2,1
2,310,310,84,84,0,1,0
1,427,427,29,29,0,1,0
0,481,481,193,112,81,4,3

1,116,116,17,17,0,1,0
3,181,181,21,13,8,3,2
4,227,227,25,25,0,1,0
2,413,413,79,28,51,4,3
0,486,486,31,1,30,4,3
5,496,496,91,91,0,1,0

5,147,147,21,6,15,4,3
1,190,190,47,47,0,1,0
2,207,207,12,2,10,3,2
6,268,268,11,11,0,1,0
4,282,282,21,3,18,3,2
7,385,385,85,75,10,3,2
0,426,426,9,9,0,1,0
3,429,429,1,1,0,1,0

3,155,155,29,2,27,2,1
0,195,195,12,12,0,1,0
4,251,251,8,8,0,1,0
7,275,275,38,38,0,1,0
1,372,372,27,27,0,1,0
5,392,392,13,13,0,1,0
2,458,458,22,22,0,1,0
6,493,493,115,115,0,1,0

6,106,106,1,1,0,1,0
1,118,118,1,1,0,1,0
3,150,150,26,12,14,2,1
8,182,182,57,57,0,1,0
7,244,244,21,12,9,4,3
0,268,268,20,4,16,3,2
5,309,309,20,20,0,1,0
2,419,419,13,2,11,4,3
4,459,459,23,9,14,4,3

3,201,201,12,12,0,1,0
0,219,219,88,38,50,3,2
1,323,323,88,83,5,2,1
2,457,457,33,12,21,4,3

5,112,112,3,3,0,1,0
4,130,130,12,12,0,1,0
9,181,181,3,3,0,1,0
0,228,228,20,12,8,2,1
1,258,258,10,10,0,1,0
6,270,270,24,24,0,1,0
3,332,332,8,3,5,2,1
8,335,335,30,10,20,2,1
7,338,338,102,102,0,1,0
2,448,448,19,3,16,3,2

5,107,107,13,13,0,1,0
2,140,140,3,3,0,1,0
4,155,155,6,6,0,1,0
3,210,210,31,31,0,1,0
0,292,292,9,9,0,1,0
7,335,335,27,2,25,2,1
8,340,340,95,56,39,4,3
6,463,463,20,20,0,1,0
1,490,490,20,20,0,1,0

2,201,201,16,6,10,3,2
4,201,201,3,3,0,1,0
0,288,288,1,1,0,1,0
7,298,298,4,4,0,1,0
10,334,334,14,1,13,2,1
8,368,368,5,2,3,2,1
6,385,385,39,39,0,1,0
1,409,409,22,22,0,1,0
5,446,446,22,22,0,1,0
9,455,455,102,27,75,4,3
3,498,498,36,8,28,2,1
11,500,500,68,20,48,2,1

0,145,145,18,3,15,4,3
11,156,156,29,29,0,1,0
4,167,167,2,2,0,1,0
2,179,179,1,1,0,1,0
7,198,198,18,18,0,1,0
8,226,226,11,11,0,1,0
5,227,227,10,10,0,1,0
6,345,345,16,2,14,2,1
1,375,375,9,5,4,2,1
10,399,399,71,9,62,3,2
3,410,410,2,2,0,1,0
9,498,498,21,11,10,2,1

6,246,246,4,4,0,1,0
2,278,278,24,24,0,1,0
3,308,308,45,45,0,1,0
0,384,384,4,4,0,1,0
4,469,469,78,36,42,4,3
1,473,473,75,31,44,2,1
5,499,499,111,103,8,3,2

5,165,165,1,1,0,1,0
7,173,173,35,35,0,1,0
9,180,180,23,23,0,1,0
4,237,237,19,19,0,1,0
1,297,297,12,12,0,1,0
6,336,336,2,2,0,1,0
0,386,386,23,1,22,3,2
3,397,397,42,42,0,1,0
2,410,410,43,16,27,4,3
8,473,473,38,38,0,1,0

5,103,103,34,34,0,1,0
4,185,185,8,8,0,1,0
0,231,231,7,7,0,1,0
2,315,315,2,2,0,1,0
7,325,325,16,7,9,2,1
1,328,328,50,5,45,4,3
3,354,354,61,61,0,1,0
6,500,500,14,2,12,3,2

1,173,173,17,4,13,2,1
5,180,180,9,9,0,1,0
2,217,217,2,2,0,1,0
0,265,265,28,28,0,1,0
7,315,315,37,31,6,2,1
4,334,334,3,3,0,1,0
8,358,358,99,57,42,2,1
6,391,391,4,4,0,1,0
3,448,448,59,59,0,1,0

6,110,110,27,3,24,3,2
5,210,210,42,42,0,1,0
2,260,260,1,1,0,1,0
3,350,350,25,25,0,1,0
1,359,359,31,1,30,3,2
8,404,404,28,10,18,4,3
7,417,417,38,20,18,2,1
0,428,428,16,16,0,1,0
4,454,454,1,1,0,1,0

2,125,125,14,14,0,1,0
0,138,138,2,2,0,1,0
1,151,151,1,1,0,1,0
7,280,280,29,29,0,1,0
4,352,352,73,63,10,3,2
8,378,378,15,4,11,2,1
5,435,435,7,7,0,1,0
6,461,461,122,75,47,2,1
3,470,470,21,21,0,1,0

2,127,127,19,4,15,3,2
1,261,261,39,23,16,2,1
0,264,264,28,28,0,1,0
4,292,292,7,3,4,2,1
3,314,314,81,81,0,1,0
5,387,387,48,48,0,1,0

5,146,146,13,13,0,1,0
2,250,250,37,37,0,1,0
9,268,268,5,5,0,1,0
6,322,322,1,1,0,1,0
7,339,339,20,20,0,1,0
8,356,356,117,2,115,4,3
0,392,392,2,2,0,1,0
1,408,408,31,23,8,3,2
4,444,444,13,6,7,2,1
3,464,464,23,7,16,2,1

3,128,128,28,28,0,1,0
4,132,132,44,44,0,1,0
2,134,134,22,2,20,2,1
1,176,176,3,3,0,1,0
0,307,307,1,1,0,1,0
5,361,361,16,7,9,4,3
6,381,381,11,8,3,2,1

7,184,184,3,3,0,1,0
5,187,187,65,65,0,1,0
6,265,265,11,11,0,1,0
1,290,290,17,2,15,2,1
0,389,389,5,1,4,2,1
2,419,419,11,11,0,1,0
4,484,484,100,73,27,2,1
3,492,492,48,48,0,1,0

3,165,165,25,2,23,2,1
9,279,279,91,91,0,1,0
6,285,285,4,4,0,1,0
1,290,290,6,6,0,1,0
2,291,291,1,1,0,1,0
7,292,292,5,5,0,1,0
0,333,333,7,7,0,1,0
4,373,373,44,44,0,1,0
8,380,380,24,12,12,2,1
5,488,488,35,13,22,3,2

5,109,109,11,3,8,2,1
1,151,151,10,3,7,2,1
8,153,153,26,26,0,1,0
3,188,188,2,2,0,1,0
6,266,266,8,8,0,1,0
0,293,293,48,38,10,2,1
2,307,307,3,3,0,1,0
4,337,337,7,7,0,1,0
9,385,385,36,4,32,3,2
7,392,392,55,11,44,2,1

1,133,133,3,3,0,1,0
2,166,166,5,2,3,2,1
0,207,207,15,15,0,1,0
3,236,236,18,1,17,2,1
7,274,274,25,12,13,2,1
6,308,308,11,11,0,1,0
8,395,395,3,3,0,1,0
4,407,407,7,7,0,1,0
5,431,431,24,24,0,1,0
9,438,438,88,88,0,1,0
10,457,457,89,79,10,2,1

0,122,122,23,23,0,1,0
1,236,236,17,17,0,1,0
4,251,251,17,17,0,1,0
3,277,277,38,11,27,4,3
2,433,433,61,61,0,1,0
5,487,487,97,73,24,3,2

1,130,130,3,3,0,1,0
4,247,247,13,13,0,1,0
3,254,254,17,3,14,3,2
5,321,321,98,98,0,1,0
0,335,335,12,12,0,1,0
6,341,341,15,15,0,1,0
2,410,410,91,4,87,4,3
7,465,465,26,26,0,1,0

0,107,107,22,8,14,3,2
2,125,125,16,16,0,1,0
1,155,155,11,11,0,1,0
4,295,295,9,9,0,1,0
5,302,302,43,43,0,1,0
3,325,325,76,76,0,1,0

4,111,111,11,11,0,1,0
6,225,225,10,10,0,1,0
0,299,299,26,21,5,2,1
5,358,358,17,6,11,2,1
7,381,381,24,24,0,1,0
3,385,385,28,22,6,2,1
2,387,387,27,3,24,4,3
8,422,422,126,126,0,1,0
1,499,499,13,13,0,1,0

5,132,132,1,1,0,1,0
8,156,156,26,6,20,2,1
7,178,178,8,8,0,1,0
4,208,208,8,8,0,1,0
3,238,238,27,27,0,1,0
6,273,273,54,54,0,1,0
1,286,286,24,3,21,2,1
0,306,306,45,9,36,3,2
2,391,391,4,4,0,1,0

3,140,140,8,8,0,1,0
7,194,194,37,37,0,1,0
8,233,233,5,5,0,1,0
4,268,268,4,4,0,1,0
0,310,310,37,37,0,1,0
5,335,335,32,32,0,1,0
2,424,424,27,14,13,2,1
1,429,429,22,1,21,2,1
6,465,465,89,50,39,4,3

6,153,153,1,1,0,1,0
10,250,250,15,15,0,1,0
4,311,311,18,18,0,1,0
0,352,352,9,9,0,1,0
5,362,362,8,8,0,1,0
8,418,418,97,97,0,1,0
7,421,421,21,21,0,1,0
2,434,434,82,25,57,4,3
1,474,474,17,1,16,3,2
9,477,477,53,53,0,1,0
3,479,479,7,4,3,2,1

8,189,189,30,2,28,3,2
4,203,203,10,4,6,2,1
6,208,208,2,2,0,1,0
3,306,306,63,63,0,1,0
7,311,311,74,65,9,4,3
5,350,350,18,8,10,2,1
2,403,403,9,9,0,1,0
1,409,409,11,11,0,1,0
0,477,477,22,17,5,2,1

0,110,110,11,2,9,4,3
2,117,117,14,2,12,2,1
4,169,169,49,36,13,2,1
1,178,178,54,54,0,1,0
3,326,326,2,2,0,1,0

1,102,102,13,9,4,2,1
2,115,115,19,19,0,1,0
4,183,183,1,1,0,1,0
7,259,259,27,27,0,1,0
5,300,300,90,54,36,2,1
0,321,321,19,16,3,2,1
6,343,343,1,1,0,1,0
3,357,357,17,17,0,1,0

1,197,197,7,3,4,2,1
3,198,198,34,8,26,2,1
0,244,244,9,9,0,1,0
4,254,254,8,8,0,1,0
7,327,327,91,10,81,4,3
6,400,400,39,39,0,1,0
5,410,410,12,12,0,1,0
2,421,421,53,53,0,1,0

4,106,106,6,6,0,1,0
6,153,153,14,14,0,1,0
7,240,240,57,57,0,1,0
8,332,332,25,25,0,1,0
1,387,387,3,3,0,1,0
0,438,438,4,1,3,2,1
2,449,449,101,101,0,1,0
3,450,450,35,35,0,1,0
5,485,485,12,12,0,1,0

0,125,125,9,1,8,3,2
4,212,212,60,60,0,1,0
1,225,225,20,20,0,1,0
5,247,247,20,2,18,3,2
3,264,264,17,6,11,2,1
6,281,281,12,12,0,1,0
2,359,359,63,63,0,1,0

0,106,106,32,29,3,2,1
3,107,107,11,6,5,2,1
2,127,127,12,12,0,1,0
1,280,280,2,2,0,1,0
4,471,471,89,11,78,3,2
5,490,490,56,29,27,4,3

5,122,122,14,14,0,1,0
6,170,170,30,2,28,2,1
1,184,184,27,3,24,2,1
4,218,218,27,27,0,1,0
0,291,291,19,19,0,1,0
3,324,324,3,3,0,1,0
2,455,455,82,82,0,1,0

3,119,119,15,15,0,1,0
1,125,125,20,20,0,1,0
2,144,144,12,12,0,1,0
6,256,256,21,7,14,2,1
0,277,277,10,4,6,3,2
5,348,348,9,9,0,1,0
4,455,455,134,113,21,2,1

7,176,176,16,16,0,1,0
3,179,179,29,23,6,3,2
5,196,196,49,49,0,1,0
4,268,268,4,1,3,2,1
6,327,327,22,22,0,1,0
2,374,374,41,41,0,1,0
1,394,394,18,5,13,2,1
0,496,496,35,26,9,2,1

3,170,170,7,7,0,1,0
7,266,266,45,3,42,3,2
1,269,269,60,60,0,1,0
8,304,304,25,4,21,4,3
5,339,339,10,2,8,3,2
6,365,365,57,57,0,1,0
2,390,390,15,15,0,1,0
4,409,409,12,12,0,1,0
0,425,425,17,17,0,1,0

0,257,257,19,1,18,3,2
2,330,330,16,1,15,4,3
1,378,378,74,55,19,2,1
4,391,391,31,31,0,1,0
3,450,450,37,37,0,1,0
6,457,457,9,1,8,3,2
5,472,472,144,99,45,4,3

2,103,103,8,5,3,2,1
1,114,114,43,29,14,3,2
4,143,143,22,1,21,3,2
3,247,247,45,45,0,1,0
0,394,394,12,1,11,2,1

4,106,106,2,2,0,1,0
1,119,119,7,7,0,1,0
0,150,150,15,3,12,3,2
2,355,355,86,86,0,1,0
5,358,358,84,43,41,2,1
3,388,388,59,59,0,1,0

5,152,152,18,18,0,1,0
3,157,157,43,43,0,1,0
1,180,180,10,10,0,1,0
2,378,378,3,3,0,1,0
4,402,402,5,5,0,1,0
0,486,486,164,164,0,1,0

6,162,162,51,51,0,1,0
5,176,176,8,8,0,1,0
3,268,268,60,13,47,4,3
4,329,329,15,1,14,3,2
0,360,360,3,3,0,1,0
2,453,453,25,25,0,1,0
1,474,474,55,55,0,1,0

1,180,180,8,2,6,2,1
10,224,224,61,29,32,4,3
0,234,234,12,3,9,2,1
7,249,249,4,4,0,1,0
9,260,260,5,5,0,1,0
5,279,279,11,11,0,1,0
11,338,338,43,43,0,1,0
6,364,364,23,23,0,1,0
8,402,402,4,4,0,1,0
12,406,406,2,2,0,1,0
4,435,435,13,13,0,1,0
3,452,452,30,30,0,1,0
2,465,465,29,20,9,4,3

1,244,244,17,17,0,1,0
6,255,255,22,22,0,1,0
9,257,257,14,2,12,4,3
0,301,301,3,3,0,1,0
2,327,327,8,8,0,1,0
8,359,359,78,60,18,2,1
3,376,376,14,5,9,4,3
5,377,377,39,39,0,1,0
7,393,393,53,21,32,3,2
4,498,498,36,36,0,1,0

4,103,103,1,1,0,1,0
5,131,131,3,3,0,1,0
6,178,178,4,4,0,1,0
7,229,229,4,4,0,1,0
2,254,254,43,43,0,1,0
8,292,292,93,71,22,3,2
3,310,310,9,5,4,2,1
1,354,354,22,3,19,2,1
0,393,393,34,34,0,1,0
9,477,477,34,5,29,2,1

6,108,108,2,2,0,1,0
4,110,110,1,1,0,1,0
2,115,115,12,12,0,1,0
9,162,162,17,17,0,1,0
1,283,283,13,10,3,2,1
7,363,363,6,6,0,1,0
0,398,398,29,29,0,1,0
8,407,407,115,23,92,3,2
5,456,456,33,5,28,3,2
3,492,492,39,39,0,1,0

5,108,108,13,13,0,1,0
6,187,187,2,2,0,1,0
4,190,190,28,28,0,1,0
7,202,202,56,10,46,4,3
1,263,263,27,13,14,3,2
2,280,280,1,1,0,1,0
3,351,351,41,41,0,1,0
0,494,494,17,17,0,1,0

5,112,112,8,1,7,2,1
6,208,208,6,2,4,2,1
3,256,256,10,5,5,2,1
9,264,264,63,63,0,1,0
8,265,265,5,5,0,1,0
10,293,293,44,44,0,1,0
1,330,330,16,4,12,4,3
4,343,343,21,9,12,4,3
2,344,344,1,1,0,1,0
7,376,376,16,8,8,3,2
0,450,450,48,48,0,1,0

0,145,145,43,43,0,1,0
2,149,149,3,3,0,1,0
4,321,321,84,50,34,4,3
6,337,337,4,4,0,1,0
5,363,363,48,1,47,2,1
3,390,390,31,1,30,2,1
1,456,456,2,2,0,1,0

6,120,120,4,4,0,1,0
1,153,153,2,2,0,1,0
4,286,286,15,15,0,1,0
7,318,318,106,106,0,1,0
3,366,366,24,24,0,1,0
8,403,403,15,15,0,1,0
2,462,462,94,94,0,1,0
5,471,471,18,14,4,2,1
0,480,480,14,9,5,2,1

3,153,153,2,2,0,1,0
2,181,181,69,69,0,1,0
4,193,193,16,16,0,1,0
5,201,201,63,63,0,1,0
1,353,353,1,1,0,1,0
0,412,412,7,7,0,1,0

4,279,279,56,2,54,4,3
5,358,358,51,51,0,1,0
2,402,402,43,43,0,1,0
0,431,431,110,46,64,3,2
6,437,437,26,14,12,3,2
3,451,451,6,6,0,1,0
1,487,487,12,12,0,1,0

7,147,147,44,44,0,1,0
6,263,263,18,18,0,1,0
0,269,269,9,9,0,1,0
1,276,276,31,31,0,1,0
2,283,283,15,3,12,2,1
3,350,350,9,9,0,1,0
5,406,406,15,5,10,4,3
4,488,488,86,86,0,1,0

7,145,145,35,7,28,2,1
8,160,160,8,1,7,2,1
1,181,181,1,1,0,1,0
0,231,231,43,43,0,1,0
2,278,278,6,6,0,1,0
9,342,342,41,41,0,1,0
3,351,351,57,33,24,2,1
4,372,372,3,3,0,1,0
5,475,475,4,1,3,2,1
6,475,475,4,4,0,1,0

6,140,140,24,12,12,3,2
3,240,240,1,1,0,1,0
5,245,245,47,47,0,1,0
4,294,294,12,12,0,1,0
0,335,335,3,3,0,1,0
2,357,357,3,3,0,1,0
1,477,477,181,107,74,3,2

4,105,105,2,2,0,1,0
7,152,152,51,21,30,4,3
0,160,160,36,8,28,2,1
6,263,263,14,14,0,1,0
2,283,283,14,10,4,2,1
3,428,428,16,16,0,1,0
5,449,449,9,2,7,2,1
1,453,453,32,32,0,1,0

4,103,103,9,6,3,2,1
2,161,161,40,12,28,4,3
3,177,177,13,13,0,1,0
1,294,294,108,54,54,4,3
0,320,320,11,11,0,1,0

6,131,131,7,2,5,2,1
5,141,141,1,1,0,1,0
7,141,141,20,11,9,2,1
4,154,154,1,1,0,1,0
9,228,228,14,1,13,2,1
8,273,273,55,43,12,3,2
2,315,315,11,11,0,1,0
1,330,330,8,8,0,1,0
0,393,393,10,10,0,1,0
3,426,426,109,89,20,2,1

4,107,107,20,6,14,3,2
2,127,127,1,1,0,1,0
3,175,175,38,3,35,2,1
0,213,213,78,78,0,1,0
1,414,414,14,14,0,1,0

1,165,165,5,5,0,1,0
7,173,173,6,6,0,1,0
4,179,179,33,33,0,1,0
5,186,186,17,9,8,3,2
2,226,226,1,1,0,1,0
6,272,272,3,3,0,1,0
3,353,353,14,5,9,2,1
8,365,365,7,4,3,2,1
0,380,380,2,2,0,1,0
9,398,398,137,32,105,4,3
10,498,498,20,5,15,4,3

2,121,121,17,11,6,3,2
5,151,151,30,26,4,2,1
1,189,189,6,6,0,1,0
4,243,243,13,13,0,1,0
3,314,314,22,22,0,1,0
6,329,329,16,11,5,2,1
7,330,330,53,25,28,3,2
0,484,484,51,51,0,1,0

5,152,152,16,8,8,3,2
6,210,210,2,2,0,1,0
4,218,218,13,13,0,1,0
2,236,236,8,8,0,1,0
7,261,261,23,13,10,3,2
3,267,267,8,8,0,1,0
0,301,301,16,7,9,4,3
9,335,335,42,28,14,3,2
1,341,341,7,7,0,1,0
8,428,428,36,36,0,1,0
10,433,433,84,84,0,1,0

1,114,114,12,5,7,2,1
0,200,200,29,29,0,1,0
2,227,227,34,25,9,4,3
5,318,318,4,4,0,1,0
3,429,429,65,65,0,1,0
4,458,458,111,111,0,1,0

7,172,172,15,15,0,1,0
1,177,177,6,6,0,1,0
4,223,223,6,2,4,2,1
3,230,230,49,19,30,4,3
5,378,378,95,15,80,4,3
2,446,446,42,42,0,1,0
6,447,447,29,29,0,1,0
0,483,483,17,17,0,1,0

4,156,156,1,1,0,1,0
6,181,181,14,14,0,1,0
3,186,186,34,26,8,3,2
2,188,188,2,2,0,1,0
1,344,344,68,68,0,1,0
7,352,352,27,27,0,1,0
5,488,488,123,67,56,3,2
0,495,495,2,2,0,1,0

7,104,104,20,2,18,2,1
4,134,134,1,1,0,1,0
6,161,161,1,1,0,1,0
5,200,200,11,11,0,1,0
0,228,228,7,7,0,1,0
3,258,258,71,33,38,2,1
1,347,347,8,5,3,2,1
8,366,366,23,11,12,3,2
2,420,420,2,2,0,1,0
9,452,452,68,36,32,3,2

6,152,152,45,13,32,3,2
7,158,158,11,6,5,2,1
0,162,162,1,1,0,1,0
5,179,179,19,13,6,2,1
2,275,275,52,52,0,1,0
8,331,331,13,13,0,1,0
1,402,402,2,2,0,1,0
3,415,415,4,1,3,2,1
4,473,473,40,14,26,2,1

4,100,100,13,13,0,1,0
5,123,123,12,12,0,1,0
7,167,167,21,21,0,1,0
1,252,252,33,33,0,1,0
6,295,295,55,7,48,2,1
2,350,350,21,7,14,2,1
0,428,428,19,19,0,1,0
3,481,481,21,8,13,2,1

4,181,181,15,15,0,1,0
5,188,188,16,8,8,2,1
2,290,290,22,19,3,2,1
3,290,290,68,37,31,2,1
0,353,353,27,3,24,3,2
1,490,490,123,78,45,2,1

10,107,107,22,1,21,2,1
8,111,111,19,7,12,4,3
2,217,217,26,16,10,3,2
3,239,239,21,5,16,2,1
6,291,291,24,24,0,1,0
7,317,317,9,4,5,2,1
0,322,322,5,5,0,1,0
1,362,362,1,1,0,1,0
5,367,367,10,10,0,1,0
9,455,455,14,7,7,2,1
4,465,465,17,17,0,1,0

2,126,126,39,19,20,2,1
4,298,298,70,6,64,3,2
3,338,338,17,17,0,1,0
1,396,396,12,12,0,1,0
0,409,409,27,11,16,2,1
5,422,422,50,50,0,1,0

0,102,102,1,1,0,1,0
6,268,268,45,45,0,1,0
5,310,310,18,6,12,2,1
4,311,311,12,12,0,1,0
1,401,401,35,25,10,3,2
2,412,412,29,29,0,1,0
3,445,445,87,80,7,2,1
7,500,500,91,27,64,3,2

5,187,187,16,7,9,4,3
3,216,216,2,2,0,1,0
0,369,369,72,39,33,4,3
1,393,393,32,32,0,1,0
6,396,396,113,53,60,3,2
4,455,455,14,5,9,2,1
7,486,486,17,17,0,1,0
2,493,493,42,32,10,3,2

1,163,163,45,20,25,2,1
3,285,285,32,2,30,2,1
4,364,364,34,28,6,3,2
0,413,413,53,53,0,1,0
2,445,445,89,89,0,1,0

0,108,108,6,6,0,1,0
1,135,135,47,2,45,4,3
2,244,244,56,56,0,1,0
3,266,266,8,8,0,1,0
4,434,434,63,44,19,3,2

2,141,141,21,14,7,2,1
7,203,203,43,28,15,4,3
6,229,229,30,30,0,1,0
1,315,315,2,2,0,1,0
5,319,319,8,5,3,2,1
3,366,366,45,45,0,1,0
4,387,387,30,1,29,3,2
0,432,432,9,5,4,2,1
8,464,464,29,14,15,4,3

4,114,114,15,1,14,3,2
2,133,133,15,15,0,1,0
1,167,167,23,4,19,3,2
3,315,315,54,54,0,1,0
0,496,496,133,55,78,3,2

2,122,122,4,4,0,1,0
6,125,125,9,1,8,2,1
3,207,207,32,22,10,3,2
5,211,211,14,6,8,2,1
0,276,276,31,31,0,1,0
4,335,335,20,2,18,2,1
1,397,397,17,17,0,1,0
7,465,465,124,75,49,4,3

2,232,232,19,19,0,1,0
0,369,369,17,11,6,3,2
3,393,393,52,52,0,1,0
5,459,459,52,47,5,2,1
1,460,460,126,49,77,4,3
4,476,476,75,75,0,1,0

3,110,110,19,5,14,2,1
1,253,253,29,29,0,1,0
5,331,331,35,35,0,1,0
2,334,334,69,20,49,3,2
4,370,370,46,35,11,2,1
0,485,485,39,19,20,4,3

3,210,210,27,27,0,1,0
4,218,218,5,2,3,2,1
7,225,225,27,15,12,3,2
1,234,234,1,1,0,1,0
6,249,249,60,33,27,2,1
5,330,330,16,7,9,4,3
2,365,365,88,22,66,4,3
0,481,481,2,2,0,1,0

5,109,109,8,5,3,2,1
0,163,163,45,25,20,3,2
3,219,219,22,22,0,1,0
4,299,299,71,56,15,4,3
2,355,355,31,15,16,2,1
1,464,464,17,17,0,1,0

2,137,137,5,5,0,1,0
1,196,196,55,55,0,1,0
5,232,232,41,25,16,2,1
4,296,296,53,11,42,2,1
3,332,332,16,10,6,3,2
0,458,458,40,40,0,1,0

8,164,164,24,16,8,3,2
5,264,264,21,6,15,4,3
0,288,288,20,10,10,2,1
6,306,306,4,4,0,1,0
1,340,340,6,6,0,1,0
3,428,428,7,1,6,2,1
4,431,431,85,22,63,4,3
7,438,438,65,15,50,3,2
9,443,443,48,4,44,2,1
2,460,460,4,4,0,1,0

0,160,160,28,28,0,1,0
2,240,240,24,24,0,1,0
7,254,254,17,17,0,1,0
6,297,297,64,64,0,1,0
3,353,353,14,2,12,3,2
4,387,387,12,12,0,1,0
5,387,387,49,25,24,3,2
1,429,429,24,15,9,4,3

3,112,112,9,6,3,2,1
0,178,178,19,19,0,1,0
1,220,220,10,10,0,1,0
5,220,220,59,59,0,1,0
7,229,229,6,6,0,1,0
6,357,357,40,40,0,1,0
2,392,392,23,11,12,3,2
4,403,403,44,44,0,1,0

0,125,125,3,3,0,1,0
6,185,185,1,1,0,1,0
8,190,190,16,16,0,1,0
2,191,191,5,1,4,2,1
9,197,197,56,6,50,4,3
4,212,212,25,25,0,1,0
5,278,278,35,13,22,3,2
1,379,379,16,16,0,1,0
3,397,397,13,4,9,2,1
10,416,416,17,14,3,2,1
7,461,461,12,12,0,1,0

6,162,162,27,15,12,3,2
5,187,187,30,10,20,3,2
2,195,195,53,27,26,3,2
0,208,208,6,2,4,2,1
4,356,356,30,9,21,2,1
1,408,408,23,14,9,4,3
3,488,488,21,11,10,2,1

5,183,183,57,57,0,1,0
2,205,205,16,16,0,1,0
4,209,209,2,2,0,1,0
3,271,271,15,15,0,1,0
6,307,307,27,16,11,2,1
1,368,368,81,65,16,2,1
0,472,472,23,23,0,1,0

5,114,114,5,5,0,1,0
0,126,126,6,6,0,1,0
3,156,156,19,7,12,4,3
6,202,202,31,16,15,4,3
4,219,219,9,1,8,2,1
2,303,303,1,1,0,1,0
7,380,380,81,12,69,4,3
1,458,458,86,14,72,4,3

14,147,147,21,21,0,1,0
10,148,148,1,1,0,1,0
13,166,166,28,28,0,1,0
6,199,199,9,2,7,2,1
8,215,215,3,3,0,1,0
2,249,249,5,5,0,1,0
5,277,277,1,1,0,1,0
12,293,293,27,27,0,1,0
7,300,300,19,13,6,2,1
0,338,338,6,2,4,2,1
11,340,340,3,3,0,1,0
1,370,370,34,10,24,3,2
4,434,434,8,8,0,1,0
3,498,498,35,1,34,2,1
9,500,500,21,13,8,3,2

6,105,105,37,37,0,1,0
1,176,176,22,4,18,2,1
3,240,240,3,3,0,1,0
2,283,283,8,8,0,1,0
4,299,299,17,17,0,1,0
7,311,311,12,12,0,1,0
0,346,346,62,28,34,3,2
5,370,370,7,7,0,1,0

7,174,174,11,11,0,1,0
5,233,233,9,9,0,1,0
3,234,234,5,5,0,1,0
9,250,250,8,8,0,1,0
2,251,251,12,12,0,1,0
11,300,300,105,50,55,4,3
1,383,383,28,3,25,3,2
6,395,395,32,24,8,2,1
8,470,470,10,10,0,1,0
0,485,485,8,3,5,2,1
4,490,490,19,19,0,1,0
10,496,496,12,8,4,2,1

2,134,134,1,1,0,1,0
6,138,138,1,1,0,1,0
1,259,259,54,54,0,1,0
5,270,270,93,7,86,3,2
3,278,278,16,16,0,1,0
0,374,374,48,32,16,4,3
4,396,396,21,13,8,2,1

5,205,205,51,7,44,3,2
3,258,258,18,18,0,1,0
2,296,296,28,18,10,2,1
4,318,318,28,28,0,1,0
0,341,341,87,87,0,1,0
1,451,451,24,5,19,4,3

3,155,155,5,5,0,1,0
1,188,188,5,5,0,1,0
5,200,200,6,6,0,1,0
8,212,212,14,5,9,4,3
4,355,355,1,1,0,1,0
2,391,391,50,20,30,3,2
6,400,400,136,18,118,4,3
0,416,416,77,77,0,1,0
7,446,446,1,1,0,1,0

1,114,114,7,2,5,2,1
5,133,133,12,12,0,1,0
7,144,144,42,42,0,1,0
3,218,218,13,13,0,1,0
2,283,283,1,1,0,1,0
0,336,336,62,62,0,1,0
4,353,353,2,2,0,1,0
8,487,487,3,3,0,1,0
6,497,497,54,8,46,3,2

4,163,163,23,11,12,2,1
6,181,181,31,31,0,1,0
0,190,190,1,1,0,1,0
5,202,202,20,2,18,3,2
1,281,281,91,40,51,4,3
3,328,328,8,3,5,2,1
2,382,382,18,6,12,4,3

0,178,178,4,1,3,2,1
6,244,244,3,3,0,1,0
8,337,337,71,53,18,4,3
1,391,391,18,2,16,2,1
2,417,417,72,42,30,3,2
4,424,424,44,44,0,1,0
9,426,426,61,16,45,2,1
3,442,442,8,2,6,3,2
5,470,470,3,3,0,1,0
7,476,476,9,1,8,3,2
10,500,500,24,24,0,1,0

2,113,113,5,5,0,1,0
3,132,132,19,19,0,1,0
5,151,151,16,11,5,2,1
1,199,199,1,1,0,1,0
0,203,203,42,22,20,2,1
6,411,411,27,1,26,2,1
4,457,457,107,33,74,3,2

3,208,208,7,7,0,1,0
0,245,245,12,12,0,1,0
8,274,274,58,12,46,2,1
4,296,296,48,48,0,1,0
7,351,351,18,6,12,4,3
6,382,382,55,55,0,1,0
2,407,407,17,5,12,2,1
5,451,451,46,46,0,1,0
1,468,468,6,6,0,1,0

5,212,212,60,60,0,1,0
4,268,268,10,10,0,1,0
3,330,330,96,96,0,1,0
7,336,336,32,24,8,3,2
2,365,365,4,4,0,1,0
1,400,400,13,13,0,1,0
0,420,420,12,12,0,1,0
6,432,432,11,11,0,1,0

1,120,120,45,3,42,3,2
0,172,172,1,1,0,1,0
3,209,209,38,9,29,2,1
5,249,249,54,42,12,3,2
2,263,263,6,1,5,2,1
4,371,371,2,2,0,1,0

2,164,164,6,3,3,2,1
9,181,181,2,2,0,1,0
7,188,188,15,15,0,1,0
6,193,193,6,3,3,2,1
8,270,270,12,12,0,1,0
3,285,285,2,2,0,1,0
10,373,373,132,132,0,1,0
4,403,403,57,57,0,1,0
0,412,412,25,7,18,3,2
1,446,446,6,6,0,1,0
5,460,460,15,3,12,3,2

2,114,114,24,24,0,1,0
6,289,289,27,27,0,1,0
4,393,393,12,7,5,2,1
5,399,399,112,61,51,4,3
1,437,437,6,3,3,2,1
0,454,454,56,5,51,4,3
3,487,487,26,26,0,1,0

5,103,103,1,1,0,1,0
4,129,129,6,6,0,1,0
6,143,143,7,7,0,1,0
3,177,177,28,17,11,2,1
1,191,191,1,1,0,1,0
7,370,370,54,54,0,1,0
2,393,393,28,28,0,1,0
8,401,401,85,53,32,3,2
0,402,402,45,33,12,2,1

5,107,107,2,2,0,1,0
4,137,137,2,2,0,1,0
6,147,147,8,8,0,1,0
8,338,338,83,8,75,4,3
9,356,356,43,43,0,1,0
3,400,400,64,55,9,4,3
1,440,440,2,2,0,1,0
2,451,451,67,17,50,4,3
0,453,453,1,1,0,1,0
7,458,458,18,18,0,1,0

9,139,139,6,1,5,2,1
2,146,146,1,1,0,1,0
3,159,159,10,7,3,2,1
8,159,159,52,40,12,2,1
1,176,176,20,9,11,3,2
5,179,179,9,9,0,1,0
4,248,248,4,4,0,1,0
0,349,349,15,3,12,3,2
7,394,394,17,5,12,2,1
6,441,441,48,11,37,2,1

1,159,159,21,3,18,4,3
0,208,208,1,1,0,1,0
5,305,305,12,12,0,1,0
6,312,312,78,35,43,2,1
4,335,335,38,38,0,1,0
2,406,406,57,13,44,4,3
3,469,469,58,17,41,2,1

7,138,138,1,1,0,1,0
2,158,158,14,4,10,2,1
6,287,287,5,2,3,2,1
3,298,298,18,7,11,2,1
1,329,329,2,2,0,1,0
9,396,396,14,14,0,1,0
8,399,399,145,127,18,4,3
0,422,422,81,81,0,1,0
5,442,442,1,1,0,1,0
4,462,462,16,4,12,4,3

0,103,103,19,3,16,2,1
5,119,119,13,13,0,1,0
4,125,125,8,8,0,1,0
1,158,158,2,2,0,1,0
2,191,191,9,9,0,1,0
6,195,195,3,3,0,1,0
3,437,437,41,34,7,2,1
7,465,465,133,59,74,4,3

7,120,120,5,5,0,1,0
3,132,132,1,1,0,1,0
6,132,132,44,31,13,2,1
0,135,135,18,4,14,3,2
5,147,147,5,2,3,2,1
4,281,281,58,8,50,3,2
1,464,464,21,4,17,4,3
2,493,493,4,4,0,1,0

4,180,180,13,13,0,1,0
0,184,184,16,4,12,2,1
1,196,196,9,9,0,1,0
7,251,251,57,9,48,2,1
2,296,296,48,22,26,3,2
3,382,382,13,4,9,2,1
5,431,431,20,20,0,1,0
6,483,483,63,63,0,1,0

10,113,113,3,3,0,1,0
1,128,128,1,1,0,1,0
5,137,137,1,1,0,1,0
7,137,137,3,3,0,1,0
8,147,147,3,3,0,1,0
13,149,149,26,23,3,2,1
6,157,157,3,3,0,1,0
12,194,194,43,27,16,3,2
2,221,221,4,4,0,1,0
0,234,234,12,12,0,1,0
9,246,246,40,2,38,4,3
4,329,329,14,7,7,2,1
11,458,458,3,3,0,1,0
3,475,475,11,11,0,1,0

11,142,142,33,33,0,1,0
10,148,148,5,5,0,1,0
0,149,149,2,2,0,1,0
6,157,157,8,8,0,1,0
1,207,207,6,6,0,1,0
7,247,247,6,6,0,1,0
5,269,269,13,2,11,2,1
12,298,298,42,42,0,1,0
9,364,364,17,17,0,1,0
3,367,367,8,8,0,1,0
2,394,394,1,1,0,1,0
8,401,401,20,20,0,1,0
4,449,449,52,52,0,1,0

0,154,154,4,4,0,1,0
5,174,174,21,21,0,1,0
2,257,257,19,19,0,1,0
3,266,266,35,14,21,2,1
1,276,276,17,17,0,1,0
4,336,336,36,2,34,3,2
7,454,454,100,43,57,3,2
6,459,459,30,2,28,2,1

2,132,132,11,11,0,1,0
4,188,188,12,7,5,2,1
6,223,223,12,2,10,2,1
9,313,313,27,27,0,1,0
8,365,365,72,32,40,3,2
1,371,371,5,5,0,1,0
3,390,390,6,6,0,1,0
0,427,427,14,6,8,3,2
10,438,438,53,17,36,2,1
7,451,451,29,14,15,2,1
5,497,497,37,12,25,2,1

5,175,175,44,44,0,1,0
0,245,245,53,33,20,2,1
1,298,298,30,30,0,1,0
2,300,300,3,3,0,1,0
3,334,334,9,9,0,1,0
7,384,384,10,3,7,2,1
4,432,432,20,20,0,1,0
6,462,462,59,47,12,4,3

0,261,261,36,13,23,2,1
4,291,291,15,15,0,1,0
3,312,312,43,22,21,2,1
2,380,380,47,47,0,1,0
1,382,382,53,15,38,3,2
5,470,470,101,101,0,1,0

6,162,162,2,2,0,1,0
0,224,224,41,41,0,1,0
3,262,262,42,38,4,2,1
1,309,309,1,1,0,1,0
4,416,416,113,67,46,4,3
5,423,423,51,51,0,1,0
2,444,444,24,15,9,2,1

2,203,203,6,2,4,2,1
5,209,209,1,1,0,1,0
6,239,239,89,8,81,4,3
4,303,303,64,52,12,4,3
0,438,438,1,1,0,1,0
3,440,440,61,10,51,4,3
1,490,490,9,5,4,2,1
7,496,496,14,14,0,1,0

6,120,120,5,5,0,1,0
4,146,146,4,4,0,1,0
9,150,150,43,43,0,1,0
1,187,187,2,2,0,1,0
2,221,221,16,16,0,1,0
0,225,225,30,4,26,2,1
8,283,283,16,16,0,1,0
7,294,294,18,18,0,1,0
5,356,356,25,4,21,2,1
3,461,461,21,9,12,2,1

1,241,241,14,14,0,1,0
0,332,332,16,16,0,1,0
5,378,378,89,78,11,2,1
4,379,379,10,1,9,2,1
7,413,413,59,53,6,3,2
2,472,472,106,92,14,3,2
3,481,481,21,8,13,3,2
6,497,497,13,13,0,1,0

5,122,122,4,4,0,1,0
2,137,137,30,30,0,1,0
0,243,243,37,18,19,2,1
3,276,276,34,22,12,3,2
1,355,355,11,11,0,1,0
4,496,496,124,60,64,3,2

2,119,119,40,40,0,1,0
4,175,175,3,3,0,1,0
3,188,188,11,11,0,1,0
1,359,359,39,8,31,2,1
0,453,453,133,47,86,4,3

8,118,118,31,7,24,2,1
2,129,129,1,1,0,1,0
0,148,148,4,4,0,1,0
9,237,237,10,1,9,4,3
5,257,257,4,4,0,1,0
10,314,314,32,2,30,3,2
3,351,351,6,6,0,1,0
1,370,370,37,1,36,2,1
6,381,381,28,28,0,1,0
4,398,398,30,30,0,1,0
7,433,433,37,37,0,1,0

8,152,152,23,23,0,1,0
2,171,171,15,15,0,1,0
7,197,197,23,23,0,1,0
5,236,236,12,2,10,3,2
4,259,259,10,10,0,1,0
10,277,277,10,1,9,2,1
1,294,294,15,1,14,3,2
6,317,317,2,2,0,1,0
9,388,388,84,84,0,1,0
3,430,430,1,1,0,1,0
0,464,464,22,5,17,2,1

6,103,103,3,3,0,1,0
0,108,108,2,2,0,1,0
1,131,131,15,3,12,4,3
8,137,137,11,11,0,1,0
9,180,180,25,4,21,2,1
2,246,246,15,9,6,2,1
5,324,324,9,9,0,1,0
4,347,347,8,8,0,1,0
3,370,370,29,21,8,3,2
7,396,396,19,5,14,2,1
10,473,473,89,2,87,4,3

6,110,110,11,11,0,1,0
4,118,118,17,2,15,2,1
0,287,287,11,2,9,2,1
5,343,343,14,2,12,4,3
2,358,358,21,3,18,3,2
3,372,372,42,42,0,1,0
7,456,456,120,8,112,4,3
1,461,461,23,23,0,1,0

2,144,144,20,20,0,1,0
6,278,278,81,55,26,2,1
1,411,411,23,23,0,1,0
5,435,435,24,24,0,1,0
4,448,448,26,5,21,4,3
3,482,482,39,15,24,4,3
0,500,500,63,63,0,1,0

7,210,210,7,1,6,2,1
2,211,211,10,7,3,2,1
5,252,252,40,3,37,2,1
6,286,286,61,10,51,4,3
0,345,345,8,8,0,1,0
3,357,357,11,11,0,1,0
4,380,380,19,19,0,1,0
1,410,410,103,103,0,1,0

6,101,101,12,12,0,1,0
7,151,151,9,2,7,2,1
1,190,190,2,2,0,1,0
3,265,265,9,9,0,1,0
4,296,296,50,50,0,1,0
2,298,298,42,42,0,1,0
5,444,444,9,3,6,3,2
8,447,447,104,104,0,1,0
0,494,494,13,13,0,1,0

3,120,120,17,3,14,3,2
2,259,259,14,6,8,2,1
4,326,326,69,37,32,3,2
1,360,360,120,58,62,4,3
0,494,494,34,34,0,1,0

0,102,102,1,1,0,1,0
4,118,118,1,1,0,1,0
2,160,160,14,14,0,1,0
10,250,250,27,11,16,2,1
9,286,286,12,8,4,2,1
7,319,319,6,6,0,1,0
1,362,362,28,28,0,1,0
5,405,405,28,16,12,4,3
6,413,413,18,1,17,2,1
8,430,430,16,5,11,2,1
3,441,441,3,3,0,1,0
11,457,457,10,1,9,4,3
12,487,487,133,68,65,4,3

6,109,109,1,1,0,1,0
1,110,110,1,1,0,1,0
4,145,145,1,1,0,1,0
7,181,181,3,3,0,1,0
10,197,197,55,16,39,2,1
0,238,238,11,5,6,2,1
5,241,241,35,35,0,1,0
11,281,281,25,25,0,1,0
8,302,302,1,1,0,1,0
2,343,343,33,10,23,2,1
9,395,395,25,11,14,2,1
3,455,455,2,2,0,1,0
12,455,455,16,16,0,1,0

4,101,101,4,4,0,1,0
0,176,176,18,18,0,1,0
5,197,197,64,2,62,4,3
3,201,201,13,13,0,1,0
6,237,237,9,9,0,1,0
1,249,249,16,6,10,3,2
2,284,284,49,49,0,1,0

7,195,195,21,21,0,1,0
5,247,247,14,14,0,1,0
6,312,312,53,53,0,1,0
8,366,366,48,48,0,1,0
4,372,372,40,40,0,1,0
2,390,390,11,11,0,1,0
3,396,396,42,42,0,1,0
0,400,400,34,34,0,1,0
1,423,423,8,5,3,2,1

10,125,125,5,1,4,2,1
3,132,132,5,5,0,1,0
8,215,215,9,9,0,1,0
5,242,242,1,1,0,1,0
2,267,267,27,2,25,3,2
9,280,280,24,16,8,3,2
4,288,288,10,10,0,1,0
7,320,320,20,11,9,4,3
12,374,374,103,93,10,2,1
11,396,396,37,8,29,3,2
6,417,417,4,4,0,1,0
1,491,491,3,3,0,1,0
0,495,495,9,9,0,1,0

11,109,109,1,1,0,1,0
3,183,183,8,2,6,2,1
7,293,293,1,1,0,1,0
2,327,327,17,7,10,2,1
6,332,332,22,22,0,1,0
0,377,377,1,1,0,1,0
5,380,380,2,2,0,1,0
4,431,431,53,53,0,1,0
9,443,443,26,10,16,3,2
1,471,471,47,47,0,1,0
10,482,482,165,54,111,4,3
8,485,485,2,2,0,1,0

2,134,134,11,1,10,2,1
7,164,164,22,2,20,2,1
1,374,374,13,7,6,3,2
0,400,400,16,1,15,3,2
5,415,415,31,31,0,1,0
6,429,429,56,9,47,4,3
3,451,451,49,13,36,4,3
4,453,453,28,28,0,1,0
8,462,462,65,18,47,4,3

8,110,110,5,5,0,1,0
3,174,174,5,5,0,1,0
1,264,264,1,1,0,1,0
7,325,325,1,1,0,1,0
2,333,333,45,27,18,3,2
10,337,337,1,1,0,1,0
0,358,358,13,13,0,1,0
11,360,360,46,31,15,4,3
4,378,378,1,1,0,1,0
9,431,431,118,118,0,1,0
6,440,440,18,18,0,1,0
5,447,447,47,47,0,1,0

2,114,114,8,8,0,1,0
1,249,249,16,1,15,4,3
7,249,249,9,1,8,3,2
6,297,297,99,45,54,4,3
4,321,321,54,54,0,1,0
3,385,385,14,14,0,1,0
5,473,473,18,18,0,1,0
0,482,482,30,13,17,4,3

7,108,108,3,3,0,1,0
1,148,148,16,6,10,2,1
10,154,154,31,31,0,1,0
8,175,175,24,4,20,2,1
6,295,295,3,3,0,1,0
2,338,338,22,22,0,1,0
0,340,340,8,8,0,1,0
9,356,356,23,5,18,4,3
4,362,362,4,4,0,1,0
3,461,461,39,39,0,1,0
5,484,484,35,35,0,1,0

3,148,148,20,4,16,2,1
6,180,180,31,31,0,1,0
1,195,195,12,12,0,1,0
7,225,225,43,4,39,4,3
4,267,267,11,11,0,1,0
0,312,312,44,6,38,2,1
5,359,359,16,6,10,2,1
2,371,371,8,8,0,1,0

4,183,183,12,7,5,2,1
1,191,191,9,9,0,1,0
3,197,197,3,3,0,1,0
6,246,246,54,38,16,3,2
5,283,283,35,35,0,1,0
0,333,333,51,51,0,1,0
2,485,485,91,33,58,4,3

3,155,155,24,1,23,4,3
6,210,210,12,3,9,2,1
2,233,233,15,15,0,1,0
1,295,295,44,44,0,1,0
4,338,338,82,82,0,1,0
5,401,401,43,43,0,1,0
0,480,480,16,16,0,1,0

0,123,123,4,4,0,1,0
6,125,125,9,9,0,1,0
3,165,165,6,3,3,2,1
1,211,211,16,16,0,1,0
9,238,238,37,13,24,3,2
4,275,275,13,13,0,1,0
7,303,303,3,3,0,1,0
2,386,386,27,22,5,2,1
8,397,397,96,68,28,3,2
5,403,403,29,9,20,3,2

5,121,121,18,13,5,2,1
0,166,166,11,2,9,4,3
3,176,176,11,3,8,3,2
2,203,203,59,59,0,1,0
1,439,439,19,3,16,4,3
4,469,469,94,35,59,4,3

7,111,111,16,16,0,1,0
6,126,126,5,5,0,1,0
5,166,166,25,25,0,1,0
4,207,207,12,12,0,1,0
8,221,221,50,4,46,2,1
2,250,250,21,21,0,1,0
1,337,337,16,16,0,1,0
0,363,363,3,3,0,1,0
3,486,486,27,27,0,1,0

0,148,148,13,13,0,1,0
6,252,252,20,20,0,1,0
1,350,350,16,1,15,4,3
4,375,375,64,64,0,1,0
5,402,402,62,32,30,2,1
3,407,407,27,11,16,2,1
2,491,491,99,89,10,2,1

0,174,174,56,53,3,2,1
1,344,344,15,15,0,1,0
4,421,421,11,11,0,1,0
2,425,425,15,3,12,2,1
3,444,444,155,155,0,1,0
5,469,469,13,5,8,2,1

6,168,168,13,13,0,1,0
8,183,183,34,34,0,1,0
7,317,317,45,45,0,1,0
3,381,381,38,38,0,1,0
4,421,421,31,31,0,1,0
2,441,441,6,6,0,1,0
1,452,452,43,37,6,2,1
0,462,462,53,53,0,1,0
5,497,497,2,2,0,1,0

3,134,134,6,2,4,2,1
0,168,168,20,2,18,3,2
1,171,171,3,3,0,1,0
2,212,212,2,2,0,1,0
8,230,230,53,45,8,3,2
4,321,321,15,15,0,1,0
5,373,373,61,61,0,1,0
6,469,469,41,41,0,1,0
7,476,476,42,42,0,1,0

3,100,100,7,4,3,2,1
1,129,129,1,1,0,1,0
4,214,214,21,21,0,1,0
2,312,312,51,51,0,1,0
5,370,370,89,21,68,4,3
0,437,437,100,94,6,2,1

2,149,149,13,13,0,1,0
1,215,215,26,26,0,1,0
6,224,224,7,7,0,1,0
0,226,226,12,4,8,3,2
4,292,292,26,26,0,1,0
5,338,338,96,20,76,3,2
3,433,433,61,61,0,1,0

2,161,161,46,18,28,3,2
6,169,169,26,26,0,1,0
3,172,172,7,7,0,1,0
1,273,273,6,6,0,1,0
5,370,370,55,44,11,2,1
0,373,373,21,17,4,2,1
4,445,445,47,43,4,2,1

3,117,117,4,4,0,1,0
6,124,124,12,12,0,1,0
4,169,169,25,7,18,4,3
1,296,296,16,16,0,1,0
0,345,345,4,4,0,1,0
2,462,462,139,118,21,4,3
5,462,462,76,76,0,1,0

3,132,132,22,22,0,1,0
1,330,330,53,11,42,2,1
0,408,408,164,52,112,4,3
2,419,419,33,33,0,1,0

4,144,144,21,21,0,1,0
7,254,254,14,14,0,1,0
2,263,263,15,15,0,1,0
6,284,284,2,2,0,1,0
0,288,288,7,7,0,1,0
8,323,323,73,49,24,4,3
5,366,366,6,6,0,1,0
9,417,417,50,36,14,2,1
1,421,421,14,5,9,2,1
3,468,468,55,11,44,3,2

1,127,127,42,27,15,4,3
3,135,135,16,16,0,1,0
4,186,186,15,3,12,4,3
5,286,286,60,60,0,1,0
0,290,290,2,2,0,1,0
2,314,314,20,20,0,1,0

2,122,122,10,4,6,2,1
1,183,183,20,14,6,3,2
5,196,196,10,10,0,1,0
6,196,196,37,37,0,1,0
4,277,277,21,21,0,1,0
0,359,359,28,28,0,1,0
3,407,407,2,2,0,1,0
8,468,468,59,59,0,1,0
7,485,485,44,28,16,3,2

4,188,188,16,16,0,1,0
2,227,227,72,51,21,4,3
5,311,311,31,15,16,2,1
3,319,319,71,11,60,3,2
0,388,388,21,21,0,1,0
1,467,467,14,14,0,1,0

2,247,247,63,63,0,1,0
5,286,286,20,11,9,2,1
3,302,302,73,7,66,3,2
0,349,349,28,28,0,1,0
4,420,420,39,23,16,3,2
1,428,428,28,5,23,4,3

4,105,105,3,3,0,1,0
0,205,205,13,5,8,3,2
5,291,291,11,11,0,1,0
7,295,295,29,19,10,2,1
6,301,301,7,7,0,1,0
8,325,325,38,5,33,2,1
9,362,362,67,42,25,2,1
10,362,362,37,37,0,1,0
3,418,418,39,18,21,4,3
1,420,420,19,5,14,2,1
2,492,492,6,6,0,1,0

0,104,104,6,3,3,2,1
3,113,113,1,1,0,1,0
4,406,406,72,64,8,3,2
6,448,448,54,44,10,2,1
5,451,451,48,48,0,1,0
2,467,467,16,16,0,1,0
1,473,473,142,93,49,2,1

2,119,119,10,10,0,1,0
3,325,325,5,5,0,1,0
5,440,440,139,93,46,3,2
0,444,444,136,136,0,1,0
1,462,462,8,3,5,2,1
4,473,473,34,34,0,1,0

1,229,229,66,60,6,2,1
4,233,233,22,22,0,1,0
5,332,332,38,38,0,1,0
3,345,345,68,17,51,3,2
0,378,378,23,23,0,1,0
2,492,492,26,2,24,3,2

5,108,108,5,5,0,1,0
1,126,126,8,5,3,2,1
2,164,164,28,8,20,2,1
6,206,206,5,5,0,1,0
4,304,304,102,66,36,4,3
3,375,375,6,2,4,2,1
0,491,491,74,29,45,3,2

11,113,113,17,7,10,2,1
0,137,137,3,3,0,1,0
3,153,153,9,3,6,2,1
4,186,186,1,1,0,1,0
10,227,227,29,29,0,1,0
9,288,288,37,16,21,2,1
1,346,346,18,14,4,2,1
8,376,376,21,7,14,3,2
6,383,383,21,21,0,1,0
5,421,421,41,41,0,1,0
7,471,471,3,3,0,1,0
2,480,480,24,6,18,4,3

6,108,108,20,2,18,3,2
4,167,167,24,6,18,4,3
1,274,274,11,7,4,2,1
0,319,319,7,1,6,2,1
2,334,334,27,15,12,2,1
5,403,403,35,35,0,1,0
3,418,418,108,108,0,1,0

0,153,153,5,1,4,2,1
3,180,180,2,2,0,1,0
5,203,203,5,5,0,1,0
6,218,218,7,2,5,2,1
9,243,243,14,10,4,2,1
1,264,264,14,14,0,1,0
4,264,264,10,10,0,1,0
10,274,274,7,1,6,3,2
11,337,337,30,10,20,2,1
2,368,368,5,5,0,1,0
12,391,391,113,17,96,4,3
8,426,426,38,30,8,3,2
7,493,493,25,18,7,2,1

6,112,112,8,3,5,2,1
8,138,138,6,1,5,2,1
7,155,155,34,34,0,1,0
2,199,199,11,5,6,2,1
4,211,211,20,20,0,1,0
3,237,237,10,3,7,2,1
1,240,240,30,30,0,1,0
0,353,353,6,6,0,1,0
5,372,372,1,1,0,1,0
9,452,452,67,23,44,2,1

5,205,205,13,1,12,4,3
1,227,227,6,6,0,1,0
0,244,244,13,13,0,1,0
2,282,282,48,48,0,1,0
4,307,307,28,1,27,2,1
3,436,436,66,66,0,1,0
6,480,480,121,38,83,4,3

4,209,209,23,17,6,2,1
0,278,278,62,62,0,1,0
2,308,308,58,3,55,4,3
1,366,366,65,65,0,1,0
3,454,454,47,47,0,1,0

2,109,109,13,1,12,3,2
0,123,123,20,7,13,2,1
3,205,205,2,2,0,1,0
4,296,296,84,5,79,4,3
1,332,332,42,42,0,1,0
5,469,469,52,49,3,2,1

4,231,231,17,17,0,1,0
6,240,240,29,29,0,1,0
2,267,267,14,2,12,4,3
7,418,418,83,65,18,2,1
1,453,453,1,1,0,1,0
0,483,483,45,45,0,1,0
5,495,495,43,29,14,3,2
3,496,496,89,53,36,4,3

3,210,210,30,30,0,1,0
2,346,346,18,18,0,1,0
1,360,360,141,49,92,4,3
4,386,386,80,49,31,2,1
0,404,404,4,4,0,1,0

0,175,175,71,54,17,2,1
3,177,177,25,7,18,4,3
2,190,190,50,50,0,1,0
1,449,449,1,1,0,1,0

2,187,187,17,3,14,3,2
4,210,210,51,51,0,1,0
1,216,216,2,2,0,1,0
0,243,243,96,96,0,1,0
3,267,267,19,14,5,2,1

5,227,227,31,12,19,2,1
1,252,252,5,5,0,1,0
3,252,252,3,3,0,1,0
2,334,334,13,13,0,1,0
7,360,360,1,1,0,1,0
4,423,423,108,99,9,4,3
6,454,454,121,108,13,2,1
0,459,459,34,34,0,1,0

0,100,100,16,16,0,1,0
8,118,118,3,3,0,1,0
4,126,126,4,4,0,1,0
2,160,160,1,1,0,1,0
7,208,208,42,42,0,1,0
5,259,259,10,4,6,2,1
6,372,372,66,44,22,3,2
3,406,406,10,1,9,4,3
1,410,410,57,57,0,1,0

1,139,139,13,4,9,4,3
4,168,168,2,2,0,1,0
3,273,273,15,3,12,4,3
8,279,279,38,38,0,1,0
6,311,311,20,20,0,1,0
5,341,341,9,4,5,2,1
0,386,386,66,66,0,1,0
7,405,405,83,70,13,2,1
2,462,462,20,20,0,1,0

5,148,148,7,7,0,1,0
0,151,151,12,8,4,2,1
3,216,216,13,3,10,2,1
1,347,347,37,37,0,1,0
2,349,349,2,2,0,1,0
6,402,402,21,21,0,1,0
7,424,424,131,131,0,1,0
4,488,488,73,10,63,4,3

2,241,241,3,3,0,1,0
3,265,265,32,32,0,1,0
7,300,300,40,22,18,3,2
0,315,315,17,14,3,2,1
5,349,349,5,5,0,1,0
4,412,412,21,21,0,1,0
6,412,412,57,38,19,2,1
9,437,437,31,31,0,1,0
1,448,448,5,5,0,1,0
8,478,478,95,51,44,2,1

5,113,113,3,3,0,1,0
7,160,160,32,6,26,3,2
2,183,183,10,10,0,1,0
4,274,274,13,8,5,2,1
0,308,308,17,17,0,1,0
9,322,322,17,5,12,3,2
1,338,338,22,14,8,2,1
6,340,340,14,2,12,2,1
3,360,360,40,6,34,3,2
8,426,426,65,38,27,2,1

3,138,138,6,6,0,1,0
4,149,149,53,53,0,1,0
1,171,171,20,13,7,2,1
2,183,183,17,13,4,2,1
6,322,322,16,16,0,1,0
0,361,361,54,18,36,2,1
5,366,366,1,1,0,1,0

0,204,204,11,5,6,2,1
4,213,213,17,17,0,1,0
8,230,230,3,3,0,1,0
5,260,260,8,2,6,2,1
6,260,260,17,17,0,1,0
7,273,273,90,90,0,1,0
2,299,299,13,13,0,1,0
3,403,403,31,13,18,4,3
1,486,486,56,23,33,4,3

8,136,136,37,37,0,1,0
4,184,184,23,16,7,2,1
7,240,240,32,23,9,4,3
2,263,263,54,54,0,1,0
1,289,289,7,7,0,1,0
3,425,425,10,5,5,2,1
5,429,429,8,8,0,1,0
6,464,464,1,1,0,1,0
0,483,483,2,2,0,1,0

2,294,294,2,2,0,1,0
0,312,312,112,101,11,2,1
1,332,332,12,4,8,2,1
4,408,408,47,47,0,1,0
5,437,437,92,92,0,1,0
3,484,484,38,23,15,4,3

7,119,119,3,3,0,1,0
5,176,176,1,1,0,1,0
3,228,228,3,3,0,1,0
0,232,232,10,10,0,1,0
4,284,284,50,50,0,1,0
2,325,325,17,17,0,1,0
1,346,346,1,1,0,1,0
6,384,384,42,42,0,1,0
8,391,391,31,17,14,2,1
9,435,435,134,50,84,3,2

5,113,113,9,9,0,1,0
1,115,115,3,3,0,1,0
6,148,148,10,6,4,2,1
2,239,239,3,3,0,1,0
0,338,338,8,8,0,1,0
3,374,374,70,31,39,4,3
7,447,447,119,62,57,4,3
4,476,476,72,18,54,3,2

0,149,149,11,3,8,2,1
4,237,237,3,3,0,1,0
3,299,299,32,15,17,2,1
2,344,344,96,87,9,2,1
5,431,431,124,124,0,1,0
1,484,484,24,12,12,3,2

7,213,213,4,4,0,1,0
6,266,266,38,32,6,3,2
0,329,329,14,14,0,1,0
4,333,333,1,1,0,1,0
5,339,339,83,7,76,3,2
1,409,409,35,35,0,1,0
2,484,484,56,22,34,3,2
3,487,487,75,24,51,4,3

5,108,108,2,2,0,1,0
9,255,255,59,59,0,1,0
4,257,257,8,8,0,1,0
0,266,266,1,1,0,1,0
8,306,306,18,18,0,1,0
3,336,336,27,27,0,1,0
1,364,364,1,1,0,1,0
10,421,421,48,48,0,1,0
2,431,431,47,47,0,1,0
7,451,451,19,12,7,2,1
6,455,455,52,52,0,1,0

9,111,111,13,1,12,2,1
6,226,226,12,12,0,1,0
3,233,233,3,3,0,1,0
2,235,235,20,20,0,1,0
1,302,302,4,4,0,1,0
0,311,311,5,5,0,1,0
8,340,340,96,45,51,3,2
4,353,353,21,21,0,1,0
5,383,383,62,10,52,4,3
7,458,458,3,3,0,1,0

2,111,111,17,17,0,1,0
0,179,179,40,40,0,1,0
1,186,186,5,5,0,1,0
4,214,214,12,4,8,3,2
5,415,415,87,87,0,1,0
3,449,449,62,14,48,4,3

1,138,138,1,1,0,1,0
5,141,141,11,6,5,2,1
0,194,194,1,1,0,1,0
2,211,211,1,1,0,1,0
7,238,238,48,48,0,1,0
9,238,238,45,27,18,4,3
8,263,263,4,1,3,2,1
6,388,388,35,35,0,1,0
3,395,395,71,7,64,3,2
4,438,438,16,16,0,1,0

2,154,154,23,19,4,2,1
6,185,185,42,14,28,2,1
5,202,202,23,11,12,4,3
1,334,334,18,18,0,1,0
0,483,483,50,50,0,1,0
3,486,486,46,22,24,3,2
4,493,493,32,32,0,1,0

0,112,112,17,17,0,1,0
4,149,149,26,26,0,1,0
5,198,198,37,37,0,1,0
2,211,211,2,2,0,1,0
6,256,256,13,13,0,1,0
1,360,360,71,63,8,2,1
3,473,473,20,9,11,4,3

0,108,108,14,14,0,1,0
6,154,154,18,5,13,2,1
2,156,156,10,10,0,1,0
4,284,284,4,4,0,1,0
5,296,296,27,27,0,1,0
3,298,298,4,4,0,1,0
7,384,384,77,77,0,1,0
1,490,490,89,62,27,4,3

4,160,160,38,19,19,2,1
3,190,190,19,15,4,2,1
1,201,201,42,1,41,2,1
0,239,239,12,5,7,3,2
5,452,452,29,29,0,1,0
2,463,463,66,66,0,1,0

3,151,151,5,5,0,1,0
0,275,275,24,12,12,4,3
7,329,329,77,77,0,1,0
6,392,392,43,4,39,2,1
2,411,411,53,53,0,1,0
1,454,454,43,43,0,1,0
4,460,460,26,26,0,1,0
5,462,462,27,21,6,3,2

3,131,131,2,2,0,1,0
2,166,166,22,7,15,4,3
4,275,275,65,11,54,3,2
6,316,316,11,11,0,1,0
1,403,403,48,48,0,1,0
0,490,490,66,23,43,2,1
5,499,499,66,66,0,1,0

1,109,109,5,5,0,1,0
8,135,135,9,9,0,1,0
5,264,264,10,10,0,1,0
2,285,285,5,5,0,1,0
9,289,289,42,42,0,1,0
4,291,291,25,1,24,2,1
0,304,304,12,1,11,2,1
3,331,331,8,8,0,1,0
6,430,430,8,8,0,1,0
7,480,480,63,63,0,1,0
10,491,491,95,18,77,4,3

3,112,112,2,2,0,1,0
6,208,208,7,3,4,2,1
5,211,211,50,25,25,2,1
7,243,243,33,33,0,1,0
1,290,290,23,14,9,2,1
0,325,325,26,2,24,4,3
4,325,325,56,34,22,2,1
2,448,448,24,6,18,3,2

7,109,109,19,19,0,1,0
8,139,139,4,4,0,1,0
4,142,142,13,13,0,1,0
1,251,251,8,3,5,2,1
5,252,252,9,1,8,3,2
0,268,268,2,2,0,1,0
2,321,321,12,5,7,2,1
3,335,335,66,66,0,1,0
6,500,500,101,14,87,4,3

1,159,159,9,4,5,2,1
3,206,206,25,25,0,1,0
5,208,208,12,12,0,1,0
4,324,324,85,85,0,1,0
6,358,358,31,25,6,2,1
0,433,433,95,53,42,4,3
2,494,494,3,3,0,1,0

7,123,123,9,9,0,1,0
0,140,140,13,3,10,2,1
6,156,156,22,4,18,4,3
4,338,338,48,33,15,4,3
1,339,339,13,5,8,2,1
5,343,343,66,27,39,4,3
3,417,417,42,1,41,2,1
2,497,497,13,13,0,1,0

2,133,133,9,9,0,1,0
0,146,146,2,2,0,1,0
5,181,181,31,13,18,4,3
7,253,253,18,6,12,4,3
1,257,257,5,5,0,1,0
4,313,313,25,25,0,1,0
8,349,349,31,11,20,2,1
3,420,420,22,22,0,1,0
6,435,435,106,49,57,3,2

5,149,149,21,21,0,1,0
6,161,161,40,40,0,1,0
4,189,189,4,1,3,2,1
0,375,375,50,50,0,1,0
1,401,401,5,1,4,2,1
2,419,419,66,66,0,1,0
3,476,476,47,47,0,1,0

5,145,145,16,7,9,2,1
2,149,149,36,19,17,2,1
3,160,160,5,1,4,2,1
1,290,290,21,21,0,1,0
4,304,304,16,16,0,1,0
0,362,362,1,1,0,1,0
6,381,381,97,75,22,2,1
7,469,469,20,20,0,1,0

0,125,125,14,6,8,2,1
1,222,222,16,4,12,4,3
4,340,340,48,48,0,1,0
2,408,408,89,69,20,2,1
5,479,479,121,121,0,1,0
3,481,481,5,5,0,1,0

1,130,130,11,1,10,2,1
4,237,237,31,7,24,3,2
0,292,292,3,3,0,1,0
3,320,320,30,24,6,3,2
2,347,347,28,7,21,4,3
6,398,398,107,44,63,4,3
5,476,476,62,44,18,4,3
7,484,484,2,2,0,1,0

3,107,107,7,2,5,2,1
7,130,130,38,38,0,1,0
0,133,133,2,2,0,1,0
1,173,173,16,16,0,1,0
2,270,270,5,5,0,1,0
6,392,392,17,5,12,2,1
5,395,395,7,4,3,2,1
4,420,420,81,81,0,1,0
8,437,437,31,13,18,4,3

6,143,143,1,1,0,1,0
4,153,153,10,10,0,1,0
1,162,162,18,18,0,1,0
3,228,228,4,1,3,2,1
7,246,246,64,64,0,1,0
0,347,347,20,20,0,1,0
5,394,394,55,55,0,1,0
2,414,414,63,63,0,1,0

5,150,150,34,15,19,3,2
3,156,156,6,6,0,1,0
7,165,165,1,1,0,1,0
2,266,266,8,8,0,1,0
6,356,356,63,51,12,4,3
0,391,391,14,14,0,1,0
1,415,415,27,7,20,3,2
4,494,494,114,114,0,1,0

3,206,206,19,19,0,1,0
2,220,220,59,45,14,2,1
0,230,230,92,50,42,3,2
1,240,240,11,11,0,1,0

0,121,121,26,26,0,1,0
2,174,174,32,11,21,4,3
3,206,206,48,25,23,2,1
4,244,244,39,7,32,2,1
5,294,294,4,1,3,2,1
1,433,433,1,1,0,1,0

2,133,133,33,12,21,2,1
4,134,134,12,9,3,2,1
0,190,190,47,47,0,1,0
3,434,434,31,31,0,1,0
1,452,452,69,44,25,2,1

6,124,124,1,1,0,1,0
5,195,195,36,7,29,2,1
0,357,357,28,25,3,2,1
3,367,367,11,11,0,1,0
2,385,385,3,3,0,1,0
4,444,444,96,96,0,1,0
1,479,479,136,128,8,2,1

4,102,102,22,22,0,1,0
2,153,153,19,8,11,2,1
3,178,178,1,1,0,1,0
1,190,190,12,1,11,2,1
0,239,239,50,50,0,1,0
5,467,467,79,79,0,1,0
6,472,472,10,10,0,1,0

4,242,242,34,34,0,1,0
3,316,316,30,30,0,1,0
1,331,331,12,12,0,1,0
0,411,411,93,73,20,2,1
2,434,434,60,23,37,2,1
5,457,457,78,36,42,3,2

1,123,123,17,17,0,1,0
2,133,133,1,1,0,1,0
6,202,202,32,1,31,3,2
3,215,215,26,26,0,1,0
5,270,270,10,10,0,1,0
0,320,320,43,25,18,4,3
4,469,469,99,50,49,2,1

3,127,127,34,16,18,3,2
1,188,188,16,16,0,1,0
2,249,249,16,1,15,2,1
4,359,359,27,8,19,2,1
0,493,493,157,73,84,3,2

2,274,274,57,50,7,2,1
0,329,329,58,16,42,3,2
3,335,335,43,33,10,3,2
4,423,423,29,29,0,1,0
1,500,500,112,102,10,2,1

4,117,117,14,14,0,1,0
0,138,138,1,1,0,1,0
3,218,218,51,51,0,1,0
2,260,260,22,10,12,2,1
6,371,371,6,6,0,1,0
5,471,471,128,82,46,2,1
1,475,475,37,17,20,4,3

4,335,335,53,53,0,1,0
6,372,372,10,10,0,1,0
1,384,384,5,2,3,2,1
3,416,416,48,48,0,1,0
0,444,444,120,62,58,3,2
5,454,454,99,96,3,2,1
2,479,479,1,1,0,1,0

7,111,111,14,14,0,1,0
5,142,142,14,7,7,2,1
3,293,293,58,25,33,2,1
6,377,377,68,62,6,3,2
4,396,396,1,1,0,1,0
1,406,406,42,42,0,1,0
2,443,443,9,9,0,1,0
0,446,446,34,18,16,2,1

6,106,106,6,6,0,1,0
4,169,169,7,1,6,2,1
5,198,198,32,4,28,3,2
2,242,242,11,11,0,1,0
0,285,285,20,5,15,2,1
1,358,358,79,32,47,3,2
7,362,362,68,68,0,1,0
3,407,407,11,2,9,4,3

2,137,137,22,22,0,1,0
1,163,163,6,1,5,2,1
6,293,293,67,55,12,3,2
3,317,317,10,10,0,1,0
4,357,357,56,42,14,3,2
5,374,374,7,7,0,1,0
0,443,443,77,70,7,2,1

2,145,145,26,26,0,1,0
5,181,181,47,47,0,1,0
1,186,186,19,2,17,2,1
4,301,301,17,17,0,1,0
0,425,425,53,29,24,4,3
3,456,456,42,42,0,1,0

0,250,250,6,6,0,1,0
1,277,277,2,2,0,1,0
2,305,305,34,4,30,3,2
6,419,419,75,75,0,1,0
4,444,444,80,53,27,4,3
3,454,454,117,9,108,4,3
5,495,495,22,6,16,3,2

5,269,269,25,1,24,2,1
1,273,273,20,10,10,3,2
2,303,303,75,75,0,1,0
3,323,323,47,47,0,1,0
0,339,339,27,27,0,1,0
4,373,373,63,15,48,3,2

0,116,116,9,9,0,1,0
6,321,321,21,21,0,1,0
7,330,330,88,34,54,4,3
4,388,388,32,7,25,2,1
2,390,390,85,40,45,4,3
3,393,393,5,5,0,1,0
1,491,491,5,5,0,1,0
5,492,492,36,3,33,2,1

5,240,240,12,12,0,1,0
4,289,289,48,48,0,1,0
2,294,294,9,9,0,1,0
1,412,412,56,56,0,1,0
0,444,444,27,15,12,3,2
3,470,470,82,82,0,1,0
6,485,485,90,83,7,2,1

2,147,147,2,2,0,1,0
4,177,177,26,4,22,2,1
3,234,234,22,22,0,1,0
1,349,349,2,2,0,1,0
0,430,430,166,151,15,4,3
5,469,469,77,41,36,4,3

3,172,172,20,20,0,1,0
1,202,202,12,12,0,1,0
4,211,211,47,32,15,4,3
5,216,216,4,4,0,1,0
0,355,355,31,28,3,2,1
6,420,420,69,52,17,4,3
2,442,442,61,61,0,1,0

2,301,301,64,29,35,2,1
3,338,338,42,27,15,4,3
1,340,340,18,13,5,2,1
0,354,354,4,4,0,1,0
5,367,367,47,47,0,1,0
4,373,373,30,18,12,2,1
6,379,379,75,65,10,3,2

3,178,178,24,24,0,1,0
1,275,275,10,10,0,1,0
6,288,288,33,33,0,1,0
2,333,333,41,41,0,1,0
4,399,399,98,98,0,1,0
5,405,405,18,18,0,1,0
0,418,418,45,45,0,1,0

1,160,160,2,2,0,1,0
3,180,180,40,16,24,3,2
0,247,247,96,75,21,4,3
4,290,290,42,42,0,1,0
2,413,413,15,5,10,3,2

5,155,155,5,2,3,2,1
2,168,168,15,15,0,1,0
3,271,271,22,12,10,3,2
0,298,298,18,18,0,1,0
6,424,424,138,89,49,2,1
1,426,426,64,64,0,1,0
7,438,438,21,21,0,1,0
4,448,448,9,9,0,1,0

6,140,140,30,30,0,1,0
3,159,159,18,18,0,1,0
4,181,181,9,9,0,1,0
5,198,198,28,28,0,1,0
0,430,430,53,53,0,1,0
1,441,441,48,48,0,1,0
7,446,446,22,22,0,1,0
2,466,466,4,4,0,1,0

10,120,120,4,4,0,1,0
4,127,127,11,11,0,1,0
5,128,128,4,4,0,1,0
6,135,135,7,7,0,1,0
2,154,154,10,6,4,2,1
11,182,182,34,4,30,2,1
3,237,237,1,1,0,1,0
1,294,294,1,1,0,1,0
8,319,319,4,4,0,1,0
7,327,327,4,4,0,1,0
9,354,354,27,9,18,4,3
12,357,357,69,35,34,3,2
0,409,409,24,24,0,1,0

4,125,125,1,1,0,1,0
3,158,158,21,21,0,1,0
1,326,326,54,44,10,2,1
0,332,332,78,2,76,3,2
2,341,341,91,34,57,4,3

1,210,210,41,35,6,2,1
3,322,322,33,33,0,1,0
2,338,338,35,19,16,4,3
0,384,384,39,17,22,3,2
5,391,391,21,21,0,1,0
4,462,462,114,114,0,1,0

0,114,114,19,19,0,1,0
6,161,161,37,37,0,1,0
2,274,274,7,7,0,1,0
3,296,296,49,49,0,1,0
1,329,329,14,2,12,3,2
5,385,385,32,32,0,1,0
4,490,490,45,39,6,2,1

5,111,111,13,1,12,3,2
8,125,125,14,14,0,1,0
7,184,184,22,6,16,3,2
6,204,204,36,36,0,1,0
4,299,299,9,4,5,2,1
3,372,372,22,6,16,2,1
2,394,394,10,3,7,2,1
1,411,411,41,41,0,1,0
0,436,436,32,32,0,1,0

8,251,251,10,3,7,2,1
0,275,275,10,4,6,2,1
1,320,320,14,2,12,3,2
4,372,372,18,5,13,2,1
9,372,372,130,130,0,1,0
2,411,411,10,10,0,1,0
3,443,443,87,87,0,1,0
6,464,464,4,4,0,1,0
7,488,488,6,6,0,1,0
5,497,497,22,22,0,1,0

6,242,242,6,2,4,2,1
1,256,256,2,2,0,1,0
3,290,290,16,16,0,1,0
0,309,309,64,64,0,1,0
7,338,338,115,65,50,2,1
5,401,401,17,12,5,2,1
4,407,407,19,19,0,1,0
2,415,415,35,9,26,2,1

5,162,162,40,27,13,2,1
2,230,230,56,44,12,3,2
4,338,338,19,4,15,2,1
0,353,353,24,24,0,1,0
3,354,354,31,31,0,1,0
6,387,387,40,6,34,2,1
1,480,480,1,1,0,1,0

5,223,223,26,7,19,2,1
2,321,321,41,30,11,2,1
4,341,341,39,39,0,1,0
0,427,427,35,35,0,1,0
1,441,441,85,85,0,1,0
3,455,455,79,58,21,4,3

0,126,126,5,5,0,1,0
2,177,177,5,5,0,1,0
3,179,179,15,5,10,3,2
5,195,195,4,1,3,2,1
1,197,197,28,28,0,1,0
9,311,311,16,16,0,1,0
4,345,345,3,3,0,1,0
8,371,371,114,17,97,4,3
7,400,400,18,6,12,4,3
6,455,455,36,36,0,1,0

2,126,126,9,2,7,2,1
4,191,191,10,10,0,1,0
5,193,193,25,12,13,2,1
6,234,234,53,25,28,2,1
3,262,262,49,49,0,1,0
1,329,329,36,36,0,1,0
0,341,341,11,5,6,3,2

7,111,111,4,1,3,2,1
2,130,130,18,18,0,1,0
3,137,137,16,13,3,2,1
0,194,194,9,1,8,3,2
8,232,232,8,1,7,2,1
6,245,245,84,17,67,4,3
5,311,311,2,2,0,1,0
4,439,439,31,31,0,1,0
1,459,459,10,2,8,3,2

4,192,192,16,9,7,2,1
0,199,199,5,1,4,2,1
3,269,269,8,4,4,2,1
7,292,292,2,2,0,1,0
5,319,319,18,18,0,1,0
8,319,319,3,3,0,1,0
1,413,413,40,8,32,2,1
2,440,440,48,44,4,2,1
6,464,464,180,90,90,4,3

1,100,100,24,24,0,1,0
3,135,135,11,11,0,1,0
6,148,148,35,35,0,1,0
4,191,191,11,11,0,1,0
0,207,207,4,4,0,1,0
5,252,252,29,29,0,1,0
2,305,305,20,1,19,2,1

6,100,100,14,2,12,2,1
2,129,129,5,5,0,1,0
3,141,141,1,1,0,1,0
0,169,169,15,15,0,1,0
8,222,222,39,39,0,1,0
1,234,234,5,5,0,1,0
7,360,360,34,11,23,2,1
5,409,409,51,51,0,1,0
4,421,421,51,51,0,1,0

2,111,111,27,8,19,4,3
3,174,174,31,31,0,1,0
4,192,192,39,30,9,4,3
0,277,277,17,17,0,1,0
5,467,467,13,13,0,1,0
1,474,474,46,18,28,3,2

8,119,119,32,3,29,2,1
6,255,255,33,9,24,3,2
0,274,274,28,12,16,2,1
3,336,336,9,9,0,1,0
5,431,431,20,8,12,2,1
2,465,465,78,53,25,4,3
1,468,468,14,5,9,4,3
4,495,495,14,4,10,3,2
7,499,499,2,2,0,1,0

10,203,203,30,30,0,1,0
6,210,210,21,9,12,4,3
0,219,219,18,18,0,1,0
4,256,256,12,12,0,1,0
5,274,274,17,17,0,1,0
3,302,302,1,1,0,1,0
2,313,313,8,8,0,1,0
8,399,399,18,18,0,1,0
1,418,418,30,21,9,4,3
7,469,469,4,4,0,1,0
9,492,492,105,67,38,2,1

1,139,139,6,6,0,1,0
5,166,166,33,33,0,1,0
2,222,222,53,9,44,3,2
4,260,260,32,32,0,1,0
0,300,300,21,21,0,1,0
6,346,346,29,29,0,1,0
3,463,463,23,23,0,1,0

2,108,108,4,4,0,1,0
6,179,179,7,7,0,1,0
1,189,189,6,6,0,1,0
7,196,196,5,5,0,1,0
3,300,300,3,3,0,1,0
4,319,319,43,43,0,1,0
0,338,338,14,10,4,2,1
8,367,367,116,101,15,4,3
5,428,428,46,19,27,2,1
9,443,443,29,3,26,3,2

4,124,124,4,1,3,2,1
0,147,147,4,4,0,1,0
1,151,151,11,1,10,2,1
3,171,171,42,34,8,3,2
2,256,256,15,15,0,1,0
6,271,271,100,54,46,4,3
5,393,393,2,2,0,1,0

4,113,113,29,23,6,3,2
0,144,144,12,12,0,1,0
2,237,237,2,2,0,1,0
3,250,250,36,16,20,2,1
1,440,440,140,89,51,4,3

1,141,141,15,7,8,3,2
7,144,144,24,10,14,3,2
9,182,182,36,18,18,2,1
2,230,230,32,5,27,2,1
4,244,244,7,7,0,1,0
8,299,299,12,12,0,1,0
3,333,333,7,3,4,2,1
5,336,336,20,5,15,2,1
6,377,377,4,4,0,1,0
0,494,494,18,18,0,1,0

2,221,221,47,47,0,1,0
3,283,283,42,42,0,1,0
1,289,289,1,1,0,1,0
0,292,292,55,28,27,4,3
4,325,325,15,15,0,1,0
5,390,390,83,66,17,2,1

3,144,144,32,14,18,4,3
2,211,211,31,31,0,1,0
1,235,235,6,6,0,1,0
0,238,238,2,2,0,1,0
5,238,238,53,37,16,3,2
6,291,291,23,12,11,2,1
4,435,435,46,46,0,1,0

11,113,113,12,12,0,1,0
12,124,124,28,28,0,1,0
1,131,131,4,4,0,1,0
8,138,138,1,1,0,1,0
4,283,283,6,6,0,1,0
13,309,309,25,25,0,1,0
10,357,357,2,2,0,1,0
6,382,382,15,8,7,2,1
3,392,392,20,20,0,1,0
7,421,421,24,24,0,1,0
9,471,471,17,17,0,1,0
0,490,490,54,54,0,1,0
2,494,494,4,1,3,2,1
5,498,498,18,18,0,1,0

1,109,109,8,5,3,2,1
2,328,328,103,103,0,1,0
0,375,375,151,106,45,2,1
3,375,375,6,6,0,1,0

7,166,166,15,15,0,1,0
1,226,226,29,29,0,1,0
8,243,243,64,12,52,3,2
0,250,250,20,20,0,1,0
2,322,322,12,4,8,2,1
5,353,353,31,31,0,1,0
6,401,401,22,18,4,2,1
4,447,447,12,2,10,3,2
3,465,465,19,10,9,2,1

4,231,231,43,24,19,3,2
0,319,319,1,1,0,1,0
3,333,333,52,7,45,4,3
2,380,380,24,10,14,3,2
1,482,482,192,180,12,4,3

5,108,108,11,11,0,1,0
2,126,126,8,8,0,1,0
0,145,145,20,4,16,2,1
10,170,170,4,4,0,1,0
1,203,203,8,8,0,1,0
9,275,275,62,5,57,4,3
4,328,328,1,1,0,1,0
6,368,368,1,1,0,1,0
8,368,368,57,57,0,1,0
3,404,404,4,4,0,1,0
7,486,486,21,14,7,2,1

3,113,113,3,3,0,1,0
2,134,134,9,9,0,1,0
8,155,155,15,3,12,3,2
1,162,162,1,1,0,1,0
4,259,259,6,6,0,1,0
7,276,276,11,11,0,1,0
9,340,340,101,89,12,2,1
11,363,363,12,12,0,1,0
0,393,393,11,6,5,2,1
5,422,422,25,7,18,4,3
6,423,423,23,23,0,1,0
10,472,472,35,20,15,2,1

0,155,155,7,3,4,2,1
1,195,195,14,2,12,3,2
2,288,288,82,12,70,3,2
4,371,371,70,70,0,1,0
5,406,406,44,44,0,1,0
3,482,482,51,51,0,1,0

2,133,133,2,2,0,1,0
4,218,218,49,49,0,1,0
3,233,233,5,5,0,1,0
1,257,257,89,33,56,4,3
0,272,272,5,1,4,2,1
5,287,287,1,1,0,1,0
6,299,299,52,52,0,1,0

8,218,218,15,15,0,1,0
7,246,246,57,19,38,2,1
5,254,254,2,2,0,1,0
0,281,281,22,3,19,2,1
3,398,398,9,1,8,3,2
6,402,402,42,20,22,3,2
2,424,424,71,71,0,1,0
1,469,469,40,16,24,3,2
4,493,493,20,20,0,1,0

3,280,280,28,7,21,4,3
1,287,287,7,2,5,2,1
5,289,289,52,52,0,1,0
7,347,347,46,46,0,1,0
2,368,368,35,1,34,2,1
0,430,430,62,62,0,1,0
6,437,437,40,16,24,2,1
4,480,480,18,18,0,1,0

1,122,122,9,1,8,3,2
4,258,258,14,11,3,2,1
5,266,266,4,4,0,1,0
2,279,279,61,61,0,1,0
3,370,370,11,1,10,2,1
6,404,404,135,131,4,2,1
0,469,469,37,3,34,2,1

7,147,147,32,32,0,1,0
8,153,153,20,20,0,1,0
2,285,285,34,34,0,1,0
3,328,328,51,37,14,2,1
4,328,328,4,4,0,1,0
1,330,330,31,31,0,1,0
0,363,363,1,1,0,1,0
6,436,436,24,24,0,1,0
5,494,494,9,3,6,3,2

4,158,158,29,29,0,1,0
5,201,201,2,2,0,1,0
1,332,332,21,2,19,2,1
3,332,332,70,70,0,1,0
2,335,335,18,18,0,1,0
0,342,342,97,47,50,3,2

4,112,112,25,7,18,3,2
3,164,164,3,3,0,1,0
1,178,178,26,6,20,2,1
2,179,179,31,2,29,2,1
0,426,426,109,10,99,4,3

5,103,103,25,25,0,1,0
0,167,167,13,1,12,3,2
4,201,201,6,6,0,1,0
2,429,429,4,4,0,1,0
6,477,477,67,67,0,1,0
1,490,490,15,15,0,1,0
3,500,500,142,19,123,4,3

2,122,122,22,22,0,1,0
4,142,142,1,1,0,1,0
3,182,182,18,9,9,2,1
0,191,191,20,20,0,1,0
1,256,256,3,3,0,1,0
7,333,333,43,43,0,1,0
6,492,492,93,50,43,4,3
5,494,494,42,4,38,2,1

3,289,289,88,26,62,3,2
5,356,356,29,5,24,4,3
2,393,393,60,23,37,4,3
0,397,397,49,49,0,1,0
1,412,412,52,5,47,2,1
4,471,471,9,9,0,1,0

4,159,159,36,36,0,1,0
2,229,229,33,2,31,2,1
0,358,358,89,44,45,4,3
5,446,446,30,23,7,2,1
3,455,455,50,10,40,3,2
1,484,484,4,4,0,1,0

7,116,116,3,3,0,1,0
9,120,120,14,14,0,1,0
3,137,137,21,3,18,3,2
6,139,139,22,4,18,3,2
8,161,161,44,33,11,2,1
0,231,231,2,2,0,1,0
10,376,376,8,8,0,1,0
2,395,395,2,2,0,1,0
1,442,442,13,5,8,2,1
5,459,459,10,7,3,2,1
4,493,493,2,2,0,1,0

5,224,224,26,14,12,3,2
4,227,227,11,11,0,1,0
1,307,307,29,29,0,1,0
7,314,314,28,7,21,4,3
2,320,320,2,2,0,1,0
3,361,361,18,18,0,1,0
0,417,417,85,3,82,3,2
6,436,436,88,78,10,2,1

5,189,189,17,17,0,1,0
3,203,203,27,27,0,1,0
0,290,290,23,23,0,1,0
1,335,335,5,1,4,2,1
7,338,338,72,72,0,1,0
2,413,413,19,5,14,3,2
4,449,449,18,18,0,1,0
6,474,474,18,6,12,4,3
8,483,483,74,53,21,4,3

2,104,104,12,5,7,2,1
4,163,163,5,5,0,1,0
1,345,345,15,15,0,1,0
3,364,364,11,11,0,1,0
0,391,391,2,2,0,1,0
8,398,398,128,84,44,2,1
6,402,402,2,2,0,1,0
5,478,478,84,6,78,4,3
7,499,499,38,1,37,2,1

0,144,144,16,7,9,4,3
9,158,158,8,8,0,1,0
3,171,171,15,9,6,3,2
7,208,208,8,8,0,1,0
2,257,257,1,1,0,1,0
5,261,261,9,9,0,1,0
4,339,339,4,4,0,1,0
1,349,349,27,27,0,1,0
10,350,350,3,3,0,1,0
8,372,372,5,5,0,1,0
6,477,477,11,6,5,2,1
11,491,491,171,129,42,4,3

3,228,228,14,14,0,1,0
2,232,232,33,33,0,1,0
1,276,276,1,1,0,1,0
0,311,311,29,29,0,1,0
5,319,319,14,2,12,3,2
6,368,368,67,21,46,2,1
4,417,417,42,42,0,1,0
7,444,444,80,80,0,1,0

7,136,136,36,16,20,2,1
6,204,204,1,1,0,1,0
1,213,213,16,2,14,3,2
3,246,246,3,3,0,1,0
9,260,260,32,32,0,1,0
0,294,294,27,5,22,2,1
2,422,422,6,6,0,1,0
4,428,428,83,83,0,1,0
5,439,439,5,2,3,2,1
8,439,439,7,7,0,1,0

4,145,145,6,6,0,1,0
1,164,164,39,39,0,1,0
0,242,242,2,2,0,1,0
2,325,325,44,22,22,3,2
6,363,363,127,127,0,1,0
5,470,470,7,7,0,1,0
3,472,472,9,9,0,1,0

4,153,153,13,5,8,2,1
1,213,213,43,19,24,4,3
2,218,218,13,10,3,2,1
3,360,360,75,18,57,4,3
0,423,423,60,26,34,4,3
5,474,474,54,54,0,1,0

2,227,227,39,39,0,1,0
6,266,266,8,5,3,2,1
5,273,273,28,28,0,1,0
0,338,338,18,18,0,1,0
3,419,419,35,35,0,1,0
4,426,426,116,116,0,1,0
1,490,490,45,24,21,4,3

0,297,297,119,42,77,4,3
1,303,303,102,93,9,4,3
2,370,370,21,21,0,1,0
3,455,455,4,1,3,2,1

1,119,119,11,11,0,1,0
0,129,129,19,19,0,1,0
4,162,162,20,3,17,4,3
6,282,282,15,15,0,1,0
5,370,370,85,42,43,4,3
2,391,391,48,48,0,1,0
3,492,492,19,5,14,3,2

3,138,138,16,8,8,2,1
1,181,181,11,11,0,1,0
6,282,282,9,5,4,2,1
8,294,294,88,88,0,1,0
4,414,414,16,16,0,1,0
0,416,416,38,38,0,1,0
5,467,467,33,16,17,2,1
2,471,471,11,11,0,1,0
7,485,485,36,8,28,2,1

7,127,127,4,4,0,1,0
1,207,207,28,28,0,1,0
6,209,209,13,13,0,1,0
0,252,252,8,8,0,1,0
2,260,260,16,4,12,2,1
3,346,346,16,1,15,2,1
5,449,449,39,30,9,4,3
8,464,464,144,99,45,4,3
4,479,479,19,1,18,2,1

5,218,218,20,20,0,1,0
2,249,249,20,10,10,2,1
1,263,263,17,17,0,1,0
0,309,309,15,15,0,1,0
3,316,316,16,9,7,2,1
7,336,336,34,7,27,3,2
6,346,346,73,73,0,1,0
4,487,487,76,14,62,4,3

1,122,122,6,6,0,1,0
6,152,152,8,3,5,2,1
4,165,165,1,1,0,1,0
3,244,244,11,1,10,2,1
5,300,300,74,59,15,4,3
0,305,305,8,8,0,1,0
2,336,336,10,10,0,1,0
7,377,377,80,80,0,1,0
8,411,411,57,57,0,1,0

4,112,112,25,8,17,2,1
1,153,153,20,7,13,2,1
3,155,155,22,22,0,1,0
0,198,198,10,10,0,1,0
6,297,297,9,1,8,3,2
2,375,375,29,29,0,1,0
5,453,453,68,25,43,2,1

3,137,137,7,7,0,1,0
0,187,187,21,21,0,1,0
7,253,253,18,18,0,1,0
2,271,271,43,17,26,3,2
6,300,300,92,58,34,3,2
5,388,388,3,3,0,1,0
8,429,429,12,3,9,2,1
1,437,437,29,17,12,4,3
4,449,449,2,2,0,1,0

2,129,129,1,1,0,1,0
4,142,142,5,2,3,2,1
3,177,177,19,19,0,1,0
5,232,232,34,34,0,1,0
6,362,362,82,34,48,2,1
1,401,401,79,79,0,1,0
0,440,440,41,41,0,1,0

6,172,172,40,5,35,2,1
3,216,216,6,6,0,1,0
5,217,217,34,5,29,2,1
1,225,225,2,2,0,1,0
8,249,249,40,40,0,1,0
4,371,371,34,8,26,2,1
7,390,390,7,7,0,1,0
0,453,453,10,10,0,1,0
2,500,500,48,48,0,1,0

4,232,232,17,2,15,4,3
5,246,246,31,14,17,4,3
1,309,309,1,1,0,1,0
0,314,314,4,4,0,1,0
2,325,325,96,52,44,2,1
3,365,365,33,8,25,2,1
6,469,469,98,20,78,4,3

3,121,121,5,1,4,2,1
7,147,147,18,18,0,1,0
1,186,186,34,7,27,4,3
6,265,265,3,3,0,1,0
8,273,273,75,37,38,3,2
0,279,279,17,17,0,1,0
4,417,417,1,1,0,1,0
5,430,430,29,29,0,1,0
2,477,477,22,22,0,1,0

1,105,105,13,3,10,3,2
4,165,165,22,22,0,1,0
5,248,248,12,8,4,2,1
0,327,327,1,1,0,1,0
8,343,343,20,1,19,2,1
2,400,400,36,29,7,2,1
7,400,400,17,4,13,4,3
3,448,448,1,1,0,1,0
6,473,473,143,95,48,4,3

5,191,191,72,63,9,4,3
1,209,209,54,23,31,2,1
2,223,223,12,12,0,1,0
0,341,341,25,20,5,2,1
3,435,435,7,4,3,2,1
6,444,444,5,5,0,1,0
4,476,476,8,1,7,2,1

2,160,160,23,23,0,1,0
4,162,162,18,3,15,4,3
0,165,165,3,3,0,1,0
1,192,192,36,9,27,2,1
5,348,348,86,86,0,1,0
3,447,447,23,23,0,1,0
6,492,492,24,24,0,1,0

6,107,107,23,23,0,1,0
5,174,174,1,1,0,1,0
1,183,183,19,7,12,3,2
7,208,208,40,7,33,2,1
4,311,311,35,4,31,4,3
2,318,318,31,31,0,1,0
0,355,355,28,28,0,1,0
3,497,497,5,5,0,1,0

5,104,104,5,5,0,1,0
6,129,129,12,12,0,1,0
2,131,131,1,1,0,1,0
9,144,144,36,17,19,2,1
8,191,191,11,11,0,1,0
4,197,197,6,6,0,1,0
7,221,221,22,14,8,2,1
1,226,226,33,33,0,1,0
3,459,459,16,7,9,4,3
0,467,467,22,22,0,1,0

8,140,140,25,12,13,2,1
6,148,148,15,4,11,4,3
7,323,323,43,43,0,1,0
5,356,356,48,10,38,3,2
2,368,368,14,2,12,4,3
3,419,419,27,16,11,2,1
1,425,425,36,36,0,1,0
0,465,465,14,14,0,1,0
4,496,496,24,1,23,2,1

1,103,103,8,8,0,1,0
6,153,153,5,5,0,1,0
2,158,158,35,35,0,1,0
4,193,193,18,18,0,1,0
0,284,284,21,15,6,3,2
5,408,408,113,82,31,2,1
3,500,500,14,14,0,1,0

0,171,171,19,19,0,1,0
2,234,234,13,13,0,1,0
4,286,286,57,57,0,1,0
3,345,345,44,44,0,1,0
5,435,435,34,10,24,4,3
1,469,469,111,111,0,1,0

1,101,101,26,26,0,1,0
5,116,116,2,2,0,1,0
2,202,202,9,9,0,1,0
3,264,264,1,1,0,1,0
4,274,274,16,16,0,1,0
0,369,369,8,2,6,3,2
8,375,375,90,90,0,1,0
7,440,440,17,9,8,3,2
6,460,460,57,25,32,3,2

4,152,152,20,12,8,2,1
7,156,156,20,2,18,4,3
3,174,174,16,11,5,2,1
0,301,301,2,2,0,1,0
1,333,333,31,31,0,1,0
5,420,420,54,54,0,1,0
2,429,429,33,33,0,1,0
6,466,466,68,8,60,3,2

6,174,174,33,5,28,2,1
0,201,201,9,9,0,1,0
2,268,268,43,43,0,1,0
3,304,304,23,9,14,3,2
1,337,337,41,41,0,1,0
4,413,413,67,46,21,4,3
5,425,425,21,21,0,1,0

1,143,143,6,6,0,1,0
2,253,253,31,11,20,3,2
4,279,279,41,11,30,2,1
5,333,333,11,11,0,1,0
0,384,384,78,78,0,1,0
3,432,432,14,6,8,3,2
6,490,490,111,42,69,4,3

2,113,113,2,2,0,1,0
7,158,158,40,40,0,1,0
1,167,167,1,1,0,1,0
4,172,172,45,33,12,2,1
6,215,215,24,24,0,1,0
5,360,360,16,8,8,2,1
3,410,410,26,26,0,1,0
0,444,444,25,3,22,3,2

1,118,118,13,13,0,1,0
11,174,174,60,43,17,2,1
4,211,211,1,1,0,1,0
6,269,269,2,2,0,1,0
7,381,381,18,12,6,2,1
10,394,394,21,21,0,1,0
8,403,403,11,7,4,2,1
2,434,434,6,3,3,2,1
3,449,449,3,3,0,1,0
0,458,458,32,32,0,1,0
5,466,466,53,53,0,1,0
9,480,480,5,5,0,1,0

8,210,210,66,51,15,4,3
3,226,226,15,15,0,1,0
1,245,245,18,9,9,2,1
0,269,269,13,13,0,1,0
2,276,276,28,28,0,1,0
6,296,296,19,9,10,3,2
5,388,388,19,19,0,1,0
7,389,389,10,10,0,1,0
4,391,391,25,25,0,1,0

5,228,228,83,42,41,2,1
3,240,240,8,8,0,1,0
4,261,261,2,2,0,1,0
1,435,435,34,23,11,2,1
2,482,482,63,42,21,3,2
0,498,498,96,47,49,4,3

1,128,128,49,12,37,2,1
4,161,161,17,4,13,2,1
3,251,251,44,44,0,1,0
2,255,255,33,27,6,3,2
0,371,371,7,1,6,3,2

2,126,126,7,1,6,2,1
1,148,148,25,25,0,1,0
0,172,172,21,21,0,1,0
6,290,290,37,21,16,3,2
5,324,324,16,8,8,3,2
3,362,362,20,11,9,4,3
4,484,484,110,94,16,2,1

2,108,108,3,3,0,1,0
6,143,143,34,20,14,2,1
0,147,147,20,4,16,3,2
4,247,247,27,7,20,3,2
3,380,380,41,35,6,3,2
7,425,425,37,9,28,3,2
5,430,430,34,34,0,1,0
1,456,456,10,10,0,1,0

9,125,125,27,27,0,1,0
7,142,142,8,8,0,1,0
0,159,159,1,1,0,1,0
4,174,174,7,7,0,1,0
2,189,189,34,34,0,1,0
6,194,194,10,4,6,3,2
1,214,214,4,4,0,1,0
3,277,277,11,11,0,1,0
5,281,281,4,4,0,1,0
8,359,359,22,2,20,2,1
10,388,388,51,51,0,1,0

3,106,106,13,13,0,1,0
5,107,107,5,5,0,1,0
1,112,112,4,4,0,1,0
4,131,131,9,9,0,1,0
6,212,212,45,45,0,1,0
0,214,214,18,14,4,2,1
2,316,316,16,7,9,2,1
7,431,431,76,41,35,4,3
8,489,489,8,8,0,1,0

4,115,115,4,4,0,1,0
0,116,116,45,27,18,3,2
3,367,367,27,4,23,2,1
2,487,487,143,80,63,4,3
1,488,488,6,6,0,1,0

3,104,104,13,13,0,1,0
0,145,145,1,1,0,1,0
1,221,221,38,38,0,1,0
2,249,249,56,36,20,3,2
4,377,377,81,73,8,2,1
5,417,417,28,11,17,2,1

0,114,114,4,1,3,2,1
3,210,210,6,2,4,2,1
1,212,212,15,15,0,1,0
2,242,242,65,65,0,1,0
6,325,325,23,12,11,3,2
4,392,392,50,50,0,1,0
5,424,424,87,5,82,3,2

1,124,124,5,1,4,2,1
3,207,207,42,20,22,3,2
5,418,418,61,31,30,3,2
6,423,423,56,56,0,1,0
2,450,450,68,68,0,1,0
4,460,460,58,42,16,3,2
0,473,473,3,3,0,1,0

2,129,129,13,3,10,2,1
3,277,277,47,47,0,1,0
1,381,381,26,26,0,1,0
4,402,402,53,17,36,3,2
0,461,461,153,102,51,4,3

3,197,197,2,2,0,1,0
6,208,208,26,26,0,1,0
0,213,213,13,9,4,2,1
4,355,355,44,13,31,2,1
7,391,391,103,103,0,1,0
2,419,419,68,8,60,4,3
1,478,478,21,3,18,3,2
5,481,481,8,8,0,1,0

3,138,138,6,6,0,1,0
1,200,200,43,11,32,3,2
4,209,209,20,4,16,3,2
0,213,213,24,11,13,4,3
2,305,305,9,9,0,1,0
5,332,332,65,21,44,2,1
6,333,333,37,5,32,3,2

0,126,126,5,5,0,1,0
4,217,217,6,6,0,1,0
1,228,228,15,15,0,1,0
3,266,266,79,45,34,2,1
5,279,279,23,23,0,1,0
2,362,362,107,92,15,4,3

6,124,124,13,2,11,2,1
7,148,148,8,8,0,1,0
4,170,170,25,14,11,2,1
3,256,256,23,23,0,1,0
1,316,316,8,4,4,2,1
2,385,385,34,19,15,4,3
0,450,450,24,24,0,1,0
5,463,463,115,115,0,1,0

8,135,135,7,7,0,1,0
5,136,136,5,5,0,1,0
4,151,151,30,27,3,2,1
7,153,153,3,3,0,1,0
3,237,237,6,6,0,1,0
6,253,253,14,14,0,1,0
1,337,337,14,2,12,4,3
10,360,360,88,63,25,2,1
2,376,376,8,5,3,2,1
0,425,425,1,1,0,1,0
9,460,460,51,10,41,4,3

6,202,202,27,27,0,1,0
3,239,239,11,11,0,1,0
2,253,253,33,33,0,1,0
7,262,262,27,18,9,4,3
0,292,292,1,1,0,1,0
1,403,403,67,15,52,3,2
5,454,454,77,68,9,4,3
4,470,470,26,6,20,3,2

0,116,116,17,17,0,1,0
6,151,151,33,6,27,2,1
3,160,160,15,1,14,3,2
2,274,274,15,8,7,2,1
7,373,373,1,1,0,1,0
1,399,399,28,19,9,2,1
4,438,438,16,10,6,2,1
5,476,476,88,88,0,1,0

1,116,116,1,1,0,1,0
7,117,117,1,1,0,1,0
6,128,128,43,21,22,3,2
8,199,199,13,3,10,3,2
2,205,205,24,24,0,1,0
0,360,360,44,44,0,1,0
4,401,401,29,29,0,1,0
5,454,454,16,16,0,1,0
3,455,455,21,7,14,3,2

3,100,100,7,7,0,1,0
0,156,156,21,5,16,3,2
4,286,286,1,1,0,1,0
2,292,292,30,22,8,2,1
1,301,301,27,27,0,1,0
6,442,442,17,17,0,1,0
5,451,451,5,2,3,2,1
7,460,460,162,70,92,3,2

7,116,116,5,5,0,1,0
9,200,200,10,4,6,2,1
3,253,253,16,16,0,1,0
2,256,256,1,1,0,1,0
1,277,277,3,3,0,1,0
8,304,304,60,54,6,3,2
10,309,309,49,11,38,4,3
0,312,312,45,45,0,1,0
5,334,334,22,22,0,1,0
6,463,463,31,31,0,1,0
4,478,478,1,1,0,1,0

7,105,105,17,17,0,1,0
1,119,119,4,4,0,1,0
5,180,180,20,20,0,1,0
3,189,189,3,3,0,1,0
2,199,199,17,17,0,1,0
6,233,233,36,36,0,1,0
8,375,375,34,2,32,3,2
4,403,403,15,15,0,1,0
0,469,469,55,52,3,2,1

6,136,136,9,3,6,2,1
7,219,219,47,33,14,4,3
2,268,268,25,2,23,2,1
0,309,309,45,33,12,4,3
4,318,318,19,19,0,1,0
1,331,331,1,1,0,1,0
3,347,347,7,1,6,3,2
8,354,354,35,31,4,2,1
5,373,373,6,6,0,1,0
9,459,459,43,43,0,1,0

12,111,111,2,2,0,1,0
10,123,123,4,1,3,2,1
8,150,150,1,1,0,1,0
0,157,157,8,8,0,1,0
4,169,169,3,3,0,1,0
14,181,181,17,17,0,1,0
16,199,199,6,1,5,2,1
2,211,211,3,3,0,1,0
6,235,235,6,6,0,1,0
1,331,331,5,5,0,1,0
15,337,337,95,43,52,4,3
13,347,347,5,5,0,1,0
9,387,387,15,15,0,1,0
11,439,439,42,42,0,1,0
5,440,440,6,6,0,1,0
3,445,445,20,20,0,1,0
7,485,485,6,6,0,1,0

6,131,131,32,32,0,1,0
5,208,208,22,1,21,4,3
1,239,239,29,4,25,2,1
4,241,241,13,13,0,1,0
0,295,295,11,8,3,2,1
2,362,362,61,24,37,2,1
3,478,478,35,27,8,3,2

3,149,149,6,6,0,1,0
4,178,178,5,5,0,1,0
6,199,199,15,15,0,1,0
7,209,209,20,2,18,4,3
8,247,247,58,34,24,3,2
2,318,318,58,22,36,4,3
1,404,404,4,1,3,2,1
0,420,420,45,19,26,2,1
5,437,437,15,3,12,3,2

1,100,100,12,12,0,1,0
4,116,116,14,14,0,1,0
5,314,314,52,52,0,1,0
0,343,343,1,1,0,1,0
6,361,361,42,18,24,2,1
2,392,392,53,53,0,1,0
7,395,395,48,48,0,1,0
3,442,442,13,1,12,2,1

1,153,153,6,6,0,1,0
4,263,263,57,57,0,1,0
5,433,433,59,59,0,1,0
0,438,438,41,41,0,1,0
2,481,481,129,87,42,2,1
3,488,488,24,15,9,4,3

1,163,163,46,46,0,1,0
5,211,211,37,37,0,1,0
3,226,226,17,17,0,1,0
0,263,263,11,11,0,1,0
4,413,413,3,3,0,1,0
2,415,415,1,1,0,1,0
6,452,452,101,75,26,3,2

3,122,122,2,2,0,1,0
1,230,230,29,29,0,1,0
2,278,278,4,1,3,2,1
0,379,379,105,105,0,1,0
4,444,444,168,91,77,4,3

1,170,170,1,1,0,1,0
2,195,195,22,9,13,3,2
3,196,196,18,18,0,1,0
0,276,276,79,31,48,2,1
5,333,333,26,26,0,1,0
4,387,387,91,91,0,1,0

5,109,109,9,9,0,1,0
3,121,121,37,37,0,1,0
1,129,129,5,2,3,2,1
0,261,261,73,13,60,3,2
4,334,334,8,8,0,1,0
2,480,480,40,40,0,1,0

6,102,102,21,3,18,3,2
5,123,123,14,14,0,1,0
2,168,168,18,10,8,3,2
1,262,262,18,18,0,1,0
0,350,350,14,14,0,1,0
3,406,406,20,6,14,2,1
4,425,425,58,8,50,3,2
7,440,440,37,37,0,1,0

2,144,144,9,9,0,1,0
3,230,230,42,42,0,1,0
11,256,256,27,27,0,1,0
7,321,321,1,1,0,1,0
8,365,365,18,2,16,3,2
10,391,391,104,9,95,3,2
4,396,396,9,9,0,1,0
9,420,420,13,5,8,2,1
5,427,427,5,5,0,1,0
1,440,440,14,14,0,1,0
6,440,440,4,4,0,1,0
0,472,472,14,9,5,2,1

0,166,166,26,26,0,1,0
1,189,189,13,13,0,1,0
2,320,320,31,14,17,2,1
6,349,349,10,5,5,2,1
5,362,362,123,18,105,4,3
4,369,369,13,13,0,1,0
3,465,465,37,16,21,4,3

6,154,154,9,9,0,1,0
9,187,187,58,58,0,1,0
5,234,234,14,14,0,1,0
8,250,250,15,3,12,4,3
2,256,256,21,7,14,3,2
3,318,318,14,14,0,1,0
7,359,359,12,7,5,2,1
4,360,360,20,20,0,1,0
1,482,482,5,1,4,2,1
0,491,491,45,17,28,2,1

3,314,314,32,32,0,1,0
4,318,318,49,49,0,1,0
2,327,327,49,40,9,2,1
0,354,354,8,8,0,1,0
1,498,498,188,188,0,1,0

0,111,111,1,1,0,1,0
8,119,119,15,15,0,1,0
7,123,123,5,5,0,1,0
5,127,127,4,1,3,2,1
6,136,136,3,3,0,1,0
3,219,219,9,9,0,1,0
4,278,278,60,42,18,4,3
1,314,314,9,3,6,2,1
9,408,408,69,69,0,1,0
2,441,441,7,1,6,3,2
10,496,496,56,56,0,1,0

5,167,167,1,1,0,1,0
9,204,204,38,5,33,4,3
1,294,294,38,5,33,2,1
7,314,314,48,5,43,2,1
3,343,343,37,9,28,2,1
2,367,367,3,3,0,1,0
4,390,390,33,15,18,2,1
8,425,425,27,27,0,1,0
6,441,441,1,1,0,1,0
0,445,445,28,6,22,4,3

3,166,166,21,21,0,1,0
2,175,175,18,18,0,1,0
1,206,206,10,10,0,1,0
6,283,283,66,14,52,3,2
5,286,286,40,34,6,3,2
0,357,357,45,45,0,1,0
4,382,382,12,12,0,1,0

4,172,172,9,1,8,3,2
9,249,249,26,26,0,1,0
5,264,264,5,5,0,1,0
3,265,265,35,23,12,4,3
2,316,316,16,16,0,1,0
7,352,352,72,66,6,2,1
6,363,363,38,38,0,1,0
1,382,382,15,3,12,3,2
0,383,383,1,1,0,1,0
8,400,400,38,38,0,1,0

6,126,126,10,10,0,1,0
3,231,231,12,12,0,1,0
5,255,255,13,3,10,3,2
7,275,275,18,3,15,3,2
0,335,335,19,19,0,1,0
8,394,394,78,56,22,3,2
2,423,423,31,31,0,1,0
1,443,443,29,17,12,3,2
9,494,494,70,70,0,1,0
4,499,499,12,12,0,1,0

4,109,109,14,14,0,1,0
1,111,111,16,7,9,2,1
5,242,242,2,2,0,1,0
2,244,244,6,6,0,1,0
0,327,327,22,22,0,1,0
3,397,397,66,66,0,1,0
6,433,433,116,65,51,4,3

2,134,134,6,1,5,2,1
1,157,157,12,12,0,1,0
4,235,235,19,13,6,2,1
0,278,278,18,6,12,3,2
8,302,302,8,8,0,1,0
5,390,390,12,2,10,2,1
7,425,425,30,18,12,4,3
9,450,450,138,93,45,4,3
6,487,487,17,9,8,3,2
3,494,494,34,34,0,1,0

5,134,134,13,1,12,3,2
2,157,157,10,3,7,2,1
1,220,220,45,45,0,1,0
0,249,249,33,33,0,1,0
4,272,272,16,16,0,1,0
3,282,282,71,51,20,3,2

3,131,131,25,25,0,1,0
4,312,312,3,3,0,1,0
2,336,336,12,3,9,3,2
5,361,361,74,55,19,2,1
0,422,422,35,35,0,1,0
1,489,489,138,115,23,2,1

2,123,123,15,15,0,1,0
6,136,136,3,3,0,1,0
0,225,225,26,2,24,4,3
4,245,245,17,2,15,2,1
1,298,298,14,14,0,1,0
7,306,306,30,30,0,1,0
5,330,330,93,93,0,1,0
3,404,404,19,19,0,1,0

8,108,108,11,11,0,1,0
9,112,112,20,6,14,3,2
7,123,123,6,1,5,2,1
1,138,138,1,1,0,1,0
0,246,246,27,15,12,2,1
5,254,254,2,2,0,1,0
3,258,258,31,31,0,1,0
4,280,280,1,1,0,1,0
10,291,291,38,38,0,1,0
2,347,347,35,35,0,1,0
6,464,464,1,1,0,1,0

9,105,105,30,30,0,1,0
8,118,118,15,15,0,1,0
0,123,123,20,20,0,1,0
7,147,147,1,1,0,1,0
2,167,167,10,7,3,2,1
4,249,249,2,2,0,1,0
3,289,289,3,3,0,1,0
5,306,306,15,3,12,2,1
6,367,367,6,3,3,2,1
1,490,490,46,24,22,2,1

4,138,138,24,3,21,4,3
8,225,225,24,24,0,1,0
0,271,271,12,12,0,1,0
9,308,308,22,1,21,4,3
6,320,320,6,3,3,2,1
1,373,373,15,15,0,1,0
3,399,399,19,5,14,2,1
7,423,423,95,95,0,1,0
2,426,426,1,1,0,1,0
5,436,436,32,16,16,2,1

0,126,126,39,21,18,4,3
4,279,279,13,13,0,1,0
2,297,297,5,5,0,1,0
1,412,412,38,20,18,4,3
3,458,458,155,134,21,2,1

6,134,134,26,20,6,2,1
2,202,202,21,13,8,2,1
7,225,225,32,2,30,3,2
4,246,246,10,10,0,1,0
5,256,256,19,19,0,1,0
3,375,375,33,11,22,3,2
1,402,402,53,16,37,2,1
0,457,457,18,18,0,1,0

5,195,195,64,64,0,1,0
3,291,291,33,9,24,4,3
0,370,370,38,17,21,4,3
4,382,382,10,10,0,1,0
2,439,439,22,22,0,1,0
1,440,440,48,48,0,1,0
6,441,441,1,1,0,1,0
7,476,476,37,37,0,1,0

4,158,158,14,14,0,1,0
1,196,196,60,5,55,3,2
2,238,238,18,18,0,1,0
5,321,321,86,46,40,2,1
3,382,382,20,8,12,4,3
0,487,487,10,10,0,1,0

1,223,223,13,13,0,1,0
2,235,235,2,2,0,1,0
5,244,244,40,40,0,1,0
3,258,258,4,4,0,1,0
4,331,331,74,26,48,4,3
0,456,456,152,152,0,1,0

3,129,129,3,3,0,1,0
4,167,167,11,5,6,2,1
2,173,173,13,8,5,2,1
5,198,198,63,63,0,1,0
1,319,319,10,5,5,2,1
0,398,398,119,119,0,1,0

4,118,118,5,5,0,1,0
10,131,131,38,6,32,2,1
2,171,171,1,1,0,1,0
0,197,197,6,3,3,2,1
3,202,202,1,1,0,1,0
6,229,229,14,1,13,2,1
5,353,353,4,4,0,1,0
1,374,374,37,5,32,3,2
7,383,383,56,15,41,2,1
8,445,445,23,5,18,2,1
9,448,448,28,28,0,1,0

5,259,259,5,5,0,1,0
4,286,286,56,56,0,1,0
0,347,347,36,26,10,2,1
3,352,352,11,11,0,1,0
6,382,382,72,56,16,2,1
1,463,463,115,115,0,1,0
2,482,482,9,9,0,1,0

8,139,139,4,1,3,2,1
6,158,158,43,39,4,2,1
1,188,188,6,6,0,1,0
4,214,214,3,3,0,1,0
0,230,230,12,12,0,1,0
2,235,235,16,16,0,1,0
5,348,348,2,2,0,1,0
3,359,359,82,32,50,3,2
7,500,500,54,13,41,4,3

2,116,116,17,17,0,1,0
0,180,180,1,1,0,1,0
6,215,215,16,1,15,4,3
1,300,300,21,21,0,1,0
3,348,348,7,7,0,1,0
5,376,376,10,2,8,3,2
4,468,468,74,40,34,2,1
7,500,500,152,134,18,3,2

2,243,243,15,15,0,1,0
1,276,276,14,1,13,2,1
0,364,364,105,31,74,3,2
4,377,377,121,121,0,1,0
5,398,398,24,10,14,2,1
3,458,458,9,9,0,1,0

1,137,137,19,19,0,1,0
4,167,167,11,11,0,1,0
2,215,215,13,3,10,2,1
3,284,284,22,18,4,2,1
0,328,328,67,27,40,3,2
5,329,329,88,28,60,4,3

1,115,115,7,1,6,2,1
6,134,134,17,1,16,3,2
7,257,257,2,2,0,1,0
4,336,336,56,56,0,1,0
5,339,339,91,91,0,1,0
0,436,436,11,11,0,1,0
3,449,449,3,3,0,1,0
2,500,500,71,71,0,1,0

2,155,155,11,11,0,1,0
5,298,298,43,43,0,1,0
6,413,413,68,68,0,1,0
4,420,420,39,17,22,3,2
0,429,429,27,27,0,1,0
1,446,446,42,4,38,2,1
3,479,479,83,17,66,3,2

3,122,122,3,3,0,1,0
2,222,222,33,33,0,1,0
4,224,224,15,15,0,1,0
7,252,252,20,20,0,1,0
6,254,254,44,35,9,4,3
5,255,255,39,39,0,1,0
0,296,296,39,6,33,4,3
1,420,420,12,4,8,3,2

2,245,245,11,6,5,2,1
5,269,269,80,80,0,1,0
3,300,300,78,78,0,1,0
0,367,367,17,17,0,1,0
6,433,433,44,44,0,1,0
1,459,459,23,7,16,3,2
4,465,465,2,2,0,1,0

11,121,121,33,33,0,1,0
8,152,152,5,2,3,2,1
5,153,153,16,16,0,1,0
0,231,231,18,1,17,2,1
6,254,254,2,2,0,1,0
10,313,313,24,24,0,1,0
1,314,314,12,12,0,1,0
2,363,363,19,19,0,1,0
4,368,368,18,18,0,1,0
7,409,409,13,6,7,2,1
9,420,420,23,2,21,3,2
3,486,486,4,4,0,1,0

3,116,116,5,5,0,1,0
10,118,118,15,6,9,2,1
4,123,123,22,22,0,1,0
9,134,134,17,1,16,3,2
5,210,210,2,2,0,1,0
8,210,210,33,33,0,1,0
0,219,219,5,5,0,1,0
7,278,278,3,3,0,1,0
6,381,381,20,4,16,2,1
1,469,469,18,7,11,2,1
2,469,469,22,22,0,1,0

0,167,167,33,33,0,1,0
1,288,288,59,35,24,4,3
3,308,308,48,3,45,2,1
4,382,382,51,51,0,1,0
2,483,483,56,13,43,2,1

0,117,117,8,8,0,1,0
5,169,169,10,10,0,1,0
2,184,184,16,10,6,2,1
1,337,337,83,7,76,3,2
4,459,459,8,8,0,1,0
3,496,496,164,38,126,4,3

4,112,112,7,7,0,1,0
5,117,117,28,10,18,2,1
3,224,224,12,12,0,1,0
1,261,261,11,2,9,2,1
0,271,271,56,56,0,1,0
6,292,292,29,14,15,2,1
2,316,316,13,3,10,2,1
7,422,422,27,27,0,1,0

1,109,109,10,4,6,2,1
0,113,113,22,17,5,2,1
2,147,147,17,17,0,1,0
3,279,279,27,3,24,4,3
4,327,327,67,42,25,2,1
5,377,377,38,13,25,2,1

3,263,263,8,8,0,1,0
0,264,264,106,106,0,1,0
1,287,287,30,30,0,1,0
2,350,350,95,29,66,4,3

7,168,168,29,29,0,1,0
1,180,180,9,9,0,1,0
9,185,185,4,4,0,1,0
6,196,196,19,7,12,2,1
2,210,210,12,12,0,1,0
0,299,299,33,12,21,2,1
5,402,402,2,2,0,1,0
4,418,418,31,8,23,2,1
8,434,434,92,39,53,4,3
3,483,483,4,4,0,1,0

7,237,237,14,14,0,1,0
5,310,310,29,29,0,1,0
6,341,341,86,31,55,4,3
2,346,346,2,2,0,1,0
4,359,359,9,9,0,1,0
0,367,367,91,51,40,4,3
3,406,406,34,34,0,1,0
1,443,443,17,8,9,2,1

2,212,212,38,33,5,2,1
4,300,300,7,7,0,1,0
6,301,301,39,39,0,1,0
0,307,307,51,51,0,1,0
1,346,346,5,5,0,1,0
3,354,354,15,3,12,3,2
5,372,372,94,28,66,3,2

5,219,219,11,8,3,2,1
2,428,428,21,21,0,1,0
1,436,436,58,49,9,2,1
3,440,440,153,99,54,4,3
0,448,448,98,98,0,1,0
4,451,451,4,4,0,1,0

6,124,124,32,32,0,1,0
1,131,131,43,43,0,1,0
2,271,271,15,11,4,2,1
0,289,289,1,1,0,1,0
4,339,339,49,30,19,2,1
5,347,347,3,3,0,1,0
3,415,415,6,6,0,1,0

3,106,106,1,1,0,1,0
2,119,119,1,1,0,1,0
1,187,187,2,2,0,1,0
6,189,189,22,18,4,2,1
7,219,219,1,1,0,1,0
11,260,260,23,17,6,3,2
4,350,350,36,3,33,2,1
8,376,376,2,2,0,1,0
9,418,418,30,30,0,1,0
0,424,424,33,11,22,3,2
10,424,424,103,85,18,4,3
5,471,471,31,6,25,2,1

0,178,178,12,4,8,2,1
6,184,184,20,2,18,2,1
1,203,203,7,7,0,1,0
2,341,341,21,21,0,1,0
3,360,360,54,10,44,2,1
4,399,399,35,26,9,4,3
7,465,465,86,86,0,1,0
5,481,481,53,38,15,2,1

7,176,176,33,17,16,2,1
2,219,219,56,56,0,1,0
4,227,227,8,8,0,1,0
5,296,296,4,4,0,1,0
0,360,360,30,30,0,1,0
3,390,390,4,4,0,1,0
8,423,423,15,15,0,1,0
1,427,427,1,1,0,1,0
6,494,494,91,91,0,1,0

7,114,114,25,25,0,1,0
0,187,187,1,1,0,1,0
3,201,201,4,1,3,2,1
6,227,227,13,3,10,3,2
5,280,280,32,32,0,1,0
2,283,283,29,29,0,1,0
4,344,344,3,3,0,1,0
1,382,382,58,32,26,2,1
8,494,494,65,61,4,2,1

2,164,164,19,19,0,1,0
4,165,165,26,26,0,1,0
1,204,204,1,1,0,1,0
3,221,221,6,6,0,1,0
5,393,393,92,28,64,4,3
0,462,462,117,117,0,1,0
6,469,469,8,2,6,3,2

4,115,115,6,6,0,1,0
1,177,177,54,18,36,4,3
3,241,241,72,53,19,2,1
2,307,307,3,3,0,1,0
0,402,402,35,11,24,3,2
5,432,432,24,24,0,1,0

2,161,161,13,13,0,1,0
4,256,256,41,5,36,4,3
3,269,269,44,13,31,2,1
0,299,299,2,2,0,1,0
1,388,388,153,132,21,4,3

5,167,167,13,5,8,3,2
0,193,193,49,4,45,2,1
3,208,208,55,23,32,4,3
4,331,331,22,22,0,1,0
2,334,334,38,38,0,1,0
1,409,409,14,10,4,2,1

5,169,169,22,7,15,2,1
1,264,264,89,89,0,1,0
3,285,285,50,50,0,1,0
4,287,287,28,5,23,2,1
0,308,308,17,8,9,4,3
2,456,456,4,1,3,2,1

3,103,103,17,1,16,3,2
1,154,154,4,4,0,1,0
4,161,161,5,5,0,1,0
6,266,266,34,4,30,4,3
5,312,312,36,9,27,3,2
8,355,355,59,49,10,3,2
7,397,397,43,43,0,1,0
2,413,413,1,1,0,1,0
0,457,457,28,10,18,2,1

3,146,146,20,13,7,2,1
1,186,186,28,1,27,3,2
4,194,194,2,2,0,1,0
5,241,241,17,17,0,1,0
6,309,309,6,6,0,1,0
7,386,386,15,7,8,2,1
0,413,413,12,12,0,1,0
8,489,489,170,170,0,1,0
2,494,494,2,2,0,1,0

6,132,132,16,4,12,3,2
2,263,263,19,9,10,2,1
5,296,296,81,76,5,2,1
4,307,307,5,1,4,2,1
1,408,408,17,6,11,2,1
0,438,438,120,105,15,4,3
3,440,440,6,3,3,2,1

2,116,116,18,18,0,1,0
5,136,136,13,13,0,1,0
1,210,210,12,12,0,1,0
4,212,212,22,22,0,1,0
0,229,229,11,1,10,3,2
7,289,289,47,2,45,4,3
6,305,305,46,46,0,1,0
3,359,359,14,6,8,2,1

3,121,121,1,1,0,1,0
5,140,140,8,8,0,1,0
8,152,152,2,2,0,1,0
1,183,183,15,15,0,1,0
6,208,208,47,5,42,4,3
2,220,220,36,4,32,2,1
0,316,316,6,6,0,1,0
4,326,326,25,1,24,3,2
7,327,327,56,7,49,3,2

0,104,104,1,1,0,1,0
4,126,126,7,7,0,1,0
3,158,158,36,36,0,1,0
6,162,162,6,6,0,1,0
7,162,162,27,7,20,4,3
5,187,187,8,8,0,1,0
1,292,292,8,8,0,1,0
8,333,333,78,21,57,4,3
2,390,390,1,1,0,1,0
9,417,417,3,3,0,1,0

6,121,121,31,31,0,1,0
5,173,173,12,12,0,1,0
8,177,177,17,14,3,2,1
3,189,189,9,9,0,1,0
0,215,215,9,9,0,1,0
1,308,308,48,48,0,1,0
2,431,431,1,1,0,1,0
4,445,445,38,38,0,1,0
7,499,499,30,17,13,2,1

0,119,119,13,4,9,4,3
7,147,147,14,2,12,4,3
2,274,274,4,4,0,1,0
1,279,279,6,6,0,1,0
5,283,283,72,26,46,2,1
3,291,291,32,17,15,4,3
4,404,404,59,59,0,1,0
6,419,419,24,7,17,2,1

0,114,114,5,2,3,2,1
5,155,155,8,8,0,1,0
1,195,195,3,3,0,1,0
3,219,219,40,40,0,1,0
2,237,237,81,81,0,1,0
4,378,378,66,27,39,2,1

6,110,110,19,19,0,1,0
3,117,117,37,37,0,1,0
5,119,119,18,18,0,1,0
4,172,172,15,15,0,1,0
0,273,273,7,2,5,2,1
1,363,363,1,1,0,1,0
2,485,485,29,29,0,1,0

7,124,124,1,1,0,1,0
5,154,154,20,20,0,1,0
8,172,172,43,43,0,1,0
0,203,203,6,6,0,1,0
6,227,227,12,12,0,1,0
3,302,302,4,4,0,1,0
9,307,307,47,47,0,1,0
1,372,372,28,16,12,3,2
2,377,377,26,5,21,4,3
4,485,485,16,7,9,2,1

1,132,132,4,1,3,2,1
3,139,139,10,10,0,1,0
2,178,178,34,34,0,1,0
0,309,309,34,34,0,1,0
4,331,331,77,43,34,3,2
5,406,406,15,8,7,2,1
6,495,495,66,66,0,1,0

2,145,145,1,1,0,1,0
3,213,213,2,2,0,1,0
0,318,318,7,7,0,1,0
1,334,334,121,81,40,3,2
5,388,388,51,51,0,1,0
6,421,421,17,17,0,1,0
4,477,477,110,17,93,4,3

1,174,174,40,40,0,1,0
2,374,374,42,42,0,1,0
0,386,386,23,23,0,1,0
3,432,432,5,5,0,1,0
4,459,459,120,23,97,4,3
5,483,483,63,63,0,1,0

2,297,297,28,9,19,2,1
4,313,313,86,86,0,1,0
3,350,350,10,10,0,1,0
0,373,373,20,20,0,1,0
1,452,452,102,12,90,4,3
5,460,460,10,10,0,1,0
6,493,493,52,52,0,1,0

1,242,242,4,4,0,1,0
3,250,250,18,4,14,2,1
0,295,295,118,72,46,2,1
2,489,489,155,155,0,1,0

5,112,112,12,3,9,4,3
4,191,191,7,2,5,2,1
2,224,224,8,8,0,1,0
3,284,284,27,27,0,1,0
0,358,358,20,20,0,1,0
6,366,366,12,12,0,1,0
1,379,379,27,1,26,4,3
7,420,420,68,38,30,3,2
8,455,455,96,88,8,2,1

0,155,155,5,5,0,1,0
4,162,162,41,7,34,2,1
3,168,168,3,3,0,1,0
7,237,237,2,2,0,1,0
2,302,302,25,11,14,2,1
6,306,306,2,2,0,1,0
9,331,331,28,12,16,2,1
5,386,386,1,1,0,1,0
1,406,406,3,3,0,1,0
8,489,489,153,153,0,1,0

5,146,146,3,3,0,1,0
3,178,178,39,27,12,3,2
6,184,184,24,24,0,1,0
2,346,346,23,23,0,1,0
7,381,381,96,96,0,1,0
1,384,384,7,1,6,3,2
4,411,411,10,2,8,3,2
0,418,418,31,21,10,2,1

0,134,134,14,14,0,1,0
2,160,160,3,3,0,1,0
4,280,280,85,85,0,1,0
3,295,295,25,25,0,1,0
1,479,479,142,142,0,1,0

0,103,103,2,2,0,1,0
9,159,159,24,4,20,2,1
5,179,179,6,6,0,1,0
7,228,228,50,50,0,1,0
6,270,270,24,15,9,2,1
1,278,278,20,20,0,1,0
3,282,282,15,15,0,1,0
2,321,321,16,16,0,1,0
8,389,389,15,1,14,2,1
4,486,486,41,11,30,4,3

6,123,123,31,19,12,4,3
1,223,223,2,2,0,1,0
4,257,257,21,21,0,1,0
5,320,320,20,20,0,1,0
2,358,358,67,24,43,2,1
0,435,435,47,29,18,2,1
3,466,466,8,2,6,2,1
7,466,466,41,16,25,4,3

0,113,113,1,1,0,1,0
2,188,188,5,5,0,1,0
4,208,208,8,8,0,1,0
3,249,249,75,57,18,4,3
6,407,407,56,7,49,2,1
7,414,414,63,63,0,1,0
5,416,416,48,48,0,1,0
1,447,447,13,13,0,1,0

5,151,151,45,45,0,1,0
0,155,155,18,6,12,4,3
4,173,173,12,5,7,2,1
6,175,175,9,2,7,2,1
2,258,258,18,2,16,3,2
3,358,358,25,10,15,4,3
7,370,370,21,1,20,3,2
1,385,385,31,16,15,4,3

1,180,180,10,2,8,2,1
7,220,220,15,11,4,2,1
0,230,230,5,2,3,2,1
4,313,313,15,15,0,1,0
6,314,314,71,49,22,3,2
5,360,360,39,23,16,3,2
3,374,374,23,23,0,1,0
2,480,480,103,79,24,2,1

2,139,139,1,1,0,1,0
7,149,149,16,16,0,1,0
5,171,171,14,7,7,2,1
6,196,196,3,3,0,1,0
4,221,221,30,30,0,1,0
1,359,359,41,41,0,1,0
8,374,374,105,43,62,3,2
3,471,471,23,1,22,2,1
0,486,486,8,4,4,2,1

5,133,133,5,5,0,1,0
7,141,141,19,3,16,2,1
4,214,214,1,1,0,1,0
3,280,280,13,13,0,1,0
0,290,290,10,1,9,2,1
2,291,291,51,42,9,4,3
8,412,412,3,3,0,1,0
1,427,427,44,8,36,4,3
6,458,458,121,87,34,2,1

4,291,291,51,45,6,2,1
5,302,302,56,6,50,2,1
2,312,312,30,4,26,3,2
0,379,379,7,7,0,1,0
1,415,415,19,3,16,3,2
3,457,457,110,82,28,3,2
6,473,473,22,22,0,1,0

0,154,154,10,6,4,2,1
3,160,160,5,5,0,1,0
2,167,167,48,10,38,2,1
1,337,337,7,7,0,1,0
4,337,337,43,9,34,3,2
6,375,375,27,11,16,3,2
5,493,493,102,18,84,3,2

3,106,106,10,10,0,1,0
1,117,117,22,18,4,2,1
2,132,132,4,4,0,1,0
7,154,154,15,15,0,1,0
6,198,198,26,3,23,2,1
5,275,275,50,50,0,1,0
4,365,365,6,6,0,1,0
0,444,444,32,32,0,1,0

2,126,126,8,8,0,1,0
5,250,250,29,4,25,2,1
3,274,274,37,37,0,1,0
1,323,323,6,6,0,1,0
0,383,383,71,71,0,1,0
6,439,439,57,57,0,1,0
4,471,471,75,35,40,3,2

10,108,108,4,1,3,2,1
0,116,116,8,8,0,1,0
7,172,172,8,2,6,3,2
9,225,225,76,20,56,3,2
3,239,239,3,3,0,1,0
2,247,247,31,12,19,4,3
6,247,247,3,3,0,1,0
4,249,249,6,6,0,1,0
1,303,303,9,9,0,1,0
5,409,409,34,34,0,1,0
8,437,437,14,2,12,3,2

0,142,142,3,3,0,1,0
5,148,148,4,4,0,1,0
9,225,225,8,2,6,3,2
6,234,234,4,4,0,1,0
4,281,281,10,10,0,1,0
8,351,351,105,90,15,4,3
10,405,405,28,2,26,4,3
7,411,411,18,7,11,2,1
3,412,412,56,2,54,3,2
1,417,417,7,7,0,1,0
2,463,463,48,48,0,1,0

1,125,125,5,1,4,2,1
6,184,184,8,8,0,1,0
7,253,253,38,38,0,1,0
3,299,299,42,10,32,2,1
5,348,348,73,69,4,2,1
2,371,371,48,1,47,2,1
4,371,371,17,1,16,2,1
0,490,490,22,6,16,3,2

8,100,100,16,16,0,1,0
2,192,192,15,15,0,1,0
1,210,210,3,3,0,1,0
0,251,251,5,5,0,1,0
6,252,252,37,37,0,1,0
4,277,277,19,19,0,1,0
3,319,319,37,37,0,1,0
5,411,411,43,9,34,4,3
7,418,418,44,25,19,2,1

6,142,142,7,7,0,1,0
4,158,158,9,9,0,1,0
7,247,247,27,27,0,1,0
2,369,369,37,37,0,1,0
1,380,380,38,38,0,1,0
0,392,392,17,8,9,2,1
5,485,485,122,81,41,2,1
3,486,486,51,51,0,1,0

3,103,103,6,6,0,1,0
7,126,126,5,5,0,1,0
12,208,208,13,1,12,4,3
10,237,237,14,3,11,2,1
6,278,278,19,6,13,2,1
1,295,295,1,1,0,1,0
8,343,343,1,1,0,1,0
9,349,349,4,4,0,1,0
11,356,356,101,76,25,2,1
2,387,387,2,2,0,1,0
4,400,400,28,2,26,3,2
5,459,459,19,1,18,3,2
0,493,493,49,42,7,2,1

1,144,144,16,5,11,2,1
6,212,212,2,2,0,1,0
9,265,265,21,8,13,2,1
5,284,284,20,2,18,2,1
0,323,323,1,1,0,1,0
2,336,336,23,9,14,4,3
7,355,355,13,13,0,1,0
10,385,385,123,99,24,3,2
3,386,386,26,26,0,1,0
8,456,456,12,12,0,1,0
4,485,485,4,4,0,1,0
11,490,490,4,4,0,1,0

2,140,140,29,29,0,1,0
5,276,276,1,1,0,1,0
3,378,378,63,33,30,4,3
1,391,391,5,5,0,1,0
4,451,451,105,23,82,3,2
0,488,488,88,88,0,1,0

4,118,118,23,23,0,1,0
5,232,232,18,18,0,1,0
3,254,254,3,3,0,1,0
1,304,304,9,9,0,1,0
0,345,345,43,37,6,2,1
6,389,389,52,13,39,3,2
2,461,461,108,52,56,3,2

0,110,110,3,3,0,1,0
7,130,130,9,9,0,1,0
4,319,319,26,15,11,2,1
6,335,335,46,34,12,4,3
1,395,395,22,4,18,3,2
5,407,407,82,58,24,2,1
3,423,423,16,6,10,2,1
2,456,456,91,51,40,2,1

1,200,200,18,4,14,3,2
7,207,207,28,28,0,1,0
3,327,327,6,6,0,1,0
2,340,340,4,4,0,1,0
4,359,359,87,31,56,3,2
0,388,388,15,15,0,1,0
6,391,391,5,5,0,1,0
5,482,482,123,73,50,2,1

1,363,363,10,4,6,2,1
2,426,426,6,6,0,1,0
0,454,454,182,97,85,4,3
3,476,476,172,88,84,3,2

2,104,104,19,19,0,1,0
0,150,150,31,31,0,1,0
1,227,227,44,11,33,4,3
3,303,303,47,26,21,2,1
4,354,354,23,17,6,2,1

10,109,109,8,8,0,1,0
3,124,124,1,1,0,1,0
6,242,242,8,8,0,1,0
1,245,245,9,9,0,1,0
2,283,283,1,1,0,1,0
7,296,296,1,1,0,1,0
11,331,331,39,39,0,1,0
12,339,339,72,72,0,1,0
9,383,383,16,6,10,2,1
4,395,395,40,3,37,2,1
0,404,404,65,23,42,2,1
8,429,429,4,4,0,1,0
5,500,500,2,2,0,1,0

6,132,132,3,3,0,1,0
7,169,169,42,36,6,2,1
0,317,317,29,8,21,2,1
1,328,328,29,29,0,1,0
2,337,337,44,32,12,2,1
5,337,337,45,45,0,1,0
3,356,356,31,4,27,2,1
4,397,397,1,1,0,1,0

1,115,115,8,8,0,1,0
0,121,121,27,27,0,1,0
5,160,160,52,52,0,1,0
6,160,160,2,2,0,1,0
2,207,207,6,6,0,1,0
4,324,324,23,11,12,4,3
3,405,405,32,4,28,2,1

2,133,133,1,1,0,1,0
7,137,137,10,10,0,1,0
3,150,150,3,3,0,1,0
6,223,223,41,11,30,4,3
5,344,344,14,14,0,1,0
4,353,353,98,78,20,3,2
1,365,365,4,4,0,1,0
0,371,371,17,17,0,1,0
8,423,423,64,49,15,4,3

5,134,134,2,2,0,1,0
0,170,170,1,1,0,1,0
6,354,354,62,20,42,2,1
2,357,357,7,2,5,2,1
4,381,381,95,35,60,4,3
8,427,427,4,4,0,1,0
3,432,432,43,43,0,1,0
7,471,471,104,35,69,4,3
1,479,479,7,1,6,2,1

0,171,171,5,1,4,2,1
6,203,203,31,31,0,1,0
3,208,208,49,30,19,2,1
7,333,333,50,50,0,1,0
2,383,383,1,1,0,1,0
5,383,383,39,39,0,1,0
1,404,404,34,34,0,1,0
4,431,431,21,15,6,2,1

1,275,275,58,58,0,1,0
0,358,358,144,99,45,4,3
2,472,472,7,7,0,1,0
3,475,475,84,84,0,1,0

4,109,109,7,7,0,1,0
1,149,149,3,3,0,1,0
2,306,306,11,11,0,1,0
3,325,325,42,3,39,4,3
0,340,340,117,55,62,4,3
5,382,382,83,26,57,4,3

0,119,119,1,1,0,1,0
5,129,129,1,1,0,1,0
3,154,154,41,41,0,1,0
1,182,182,3,3,0,1,0
2,232,232,18,13,5,2,1
8,235,235,88,58,30,4,3
7,326,326,5,5,0,1,0
4,343,343,9,9,0,1,0
6,473,473,8,3,5,2,1

3,137,137,5,1,4,2,1
2,138,138,27,4,23,2,1
0,166,166,67,7,60,4,3
1,389,389,68,5,63,4,3

2,161,161,17,17,0,1,0
10,242,242,31,9,22,3,2
4,258,258,8,8,0,1,0
8,270,270,68,68,0,1,0
7,288,288,17,17,0,1,0
9,385,385,11,11,0,1,0
0,406,406,13,13,0,1,0
3,453,453,53,29,24,3,2
6,454,454,13,13,0,1,0
1,475,475,6,6,0,1,0
5,484,484,7,7,0,1,0

0,107,107,1,1,0,1,0
1,170,170,35,2,33,3,2
4,175,175,1,1,0,1,0
5,254,254,37,15,22,2,1
3,286,286,7,7,0,1,0
7,357,357,50,29,21,4,3
2,398,398,62,32,30,4,3
6,499,499,58,19,39,4,3

8,108,108,14,14,0,1,0
5,140,140,2,2,0,1,0
3,201,201,9,9,0,1,0
9,209,209,23,23,0,1,0
0,396,396,19,4,15,2,1
6,419,419,34,20,14,3,2
1,420,420,4,4,0,1,0
10,448,448,74,74,0,1,0
4,468,468,17,7,10,3,2
2,485,485,18,18,0,1,0
7,485,485,63,7,56,4,3

3,109,109,10,2,8,2,1
2,118,118,10,4,6,3,2
6,217,217,22,14,8,2,1
5,235,235,9,1,8,3,2
1,246,246,47,47,0,1,0
0,265,265,10,3,7,2,1
4,454,454,121,81,40,3,2

0,103,103,23,8,15,2,1
5,159,159,23,4,19,2,1
1,173,173,13,7,6,3,2
2,218,218,2,2,0,1,0
6,272,272,43,5,38,2,1
3,408,408,34,12,22,2,1
4,440,440,4,4,0,1,0
7,484,484,50,50,0,1,0

7,158,158,7,7,0,1,0
0,181,181,1,1,0,1,0
3,209,209,32,10,22,3,2
8,232,232,47,47,0,1,0
6,237,237,37,19,18,4,3
2,241,241,28,16,12,4,3
1,266,266,19,19,0,1,0
4,356,356,4,4,0,1,0
5,489,489,21,7,14,2,1

2,118,118,1,1,0,1,0
0,133,133,14,14,0,1,0
3,224,224,2,2,0,1,0
8,279,279,56,11,45,2,1
1,302,302,10,7,3,2,1
6,352,352,38,38,0,1,0
5,423,423,24,21,3,2,1
4,455,455,86,82,4,2,1
7,488,488,47,47,0,1,0

1,160,160,15,11,4,2,1
3,171,171,7,7,0,1,0
0,207,207,28,6,22,2,1
4,302,302,25,25,0,1,0
2,350,350,17,17,0,1,0
5,359,359,93,93,0,1,0
7,494,494,16,16,0,1,0
6,498,498,55,55,0,1,0

4,103,103,22,8,14,2,1
3,118,118,41,41,0,1,0
5,164,164,7,7,0,1,0
2,172,172,3,3,0,1,0
1,211,211,2,2,0,1,0
0,262,262,7,7,0,1,0
6,396,396,60,24,36,3,2

2,144,144,4,4,0,1,0
5,258,258,26,3,23,2,1
4,259,259,42,36,6,2,1
1,279,279,8,1,7,2,1
0,323,323,64,48,16,3,2
6,397,397,56,42,14,3,2
3,421,421,62,62,0,1,0

4,118,118,3,3,0,1,0
7,139,139,6,1,5,2,1
1,223,223,1,1,0,1,0
5,322,322,7,7,0,1,0
0,439,439,82,82,0,1,0
3,447,447,3,3,0,1,0
6,491,491,169,159,10,3,2
2,493,493,88,21,67,4,3

10,124,124,1,1,0,1,0
0,146,146,4,4,0,1,0
1,211,211,12,12,0,1,0
8,217,217,10,4,6,2,1
7,266,266,13,13,0,1,0
12,324,324,83,54,29,2,1
9,347,347,10,2,8,3,2
5,372,372,3,3,0,1,0
4,392,392,11,8,3,2,1
3,395,395,17,5,12,3,2
6,398,398,5,1,4,2,1
2,405,405,41,41,0,1,0
11,455,455,64,64,0,1,0

8,112,112,9,9,0,1,0
7,162,162,22,22,0,1,0
5,228,228,22,14,8,2,1
2,285,285,47,16,31,2,1
6,311,311,12,12,0,1,0
1,334,334,17,17,0,1,0
4,366,366,1,1,0,1,0
0,394,394,6,2,4,2,1
3,414,414,14,9,5,2,1
9,421,421,81,37,44,2,1

5,108,108,18,18,0,1,0
3,174,174,17,17,0,1,0
1,222,222,14,4,10,3,2
6,230,230,13,2,11,2,1
4,260,260,48,20,28,3,2
2,413,413,70,1,69,4,3
0,438,438,31,31,0,1,0

5,102,102,2,2,0,1,0
10,102,102,4,4,0,1,0
1,143,143,7,1,6,2,1
6,148,148,6,6,0,1,0
11,168,168,48,10,38,2,1
7,210,210,13,13,0,1,0
9,276,276,23,23,0,1,0
2,387,387,20,15,5,2,1
0,399,399,11,11,0,1,0
8,430,430,33,33,0,1,0
4,436,436,7,7,0,1,0
3,445,445,26,4,22,2,1

1,124,124,7,4,3,2,1
5,167,167,27,9,18,2,1
3,226,226,30,9,21,4,3
4,253,253,46,46,0,1,0
6,319,319,37,2,35,2,1
2,393,393,3,3,0,1,0
0,447,447,11,11,0,1,0
7,467,467,60,35,25,2,1

7,113,113,10,10,0,1,0
5,134,134,33,26,7,3,2
1,154,154,2,2,0,1,0
4,204,204,18,18,0,1,0
6,285,285,22,22,0,1,0
2,287,287,18,18,0,1,0
3,339,339,2,2,0,1,0
0,415,415,97,13,84,3,2

1,217,217,29,29,0,1,0
3,310,310,15,15,0,1,0
2,354,354,62,11,51,4,3
4,358,358,65,65,0,1,0
0,378,378,102,24,78,4,3

2,108,108,14,2,12,2,1
4,115,115,8,8,0,1,0
1,170,170,17,17,0,1,0
3,205,205,13,13,0,1,0
7,290,290,59,33,26,2,1
5,337,337,40,5,35,2,1
6,360,360,29,29,0,1,0
0,414,414,16,16,0,1,0

2,116,116,7,1,6,2,1
5,153,153,8,2,6,2,1
1,349,349,42,6,36,3,2
7,361,361,42,42,0,1,0
8,375,375,51,7,44,3,2
0,422,422,13,13,0,1,0
4,440,440,1,1,0,1,0
6,491,491,22,22,0,1,0
3,494,494,45,45,0,1,0
9,498,498,75,75,0,1,0

2,123,123,19,19,0,1,0
6,202,202,6,6,0,1,0
7,209,209,46,23,23,2,1
0,213,213,4,4,0,1,0
1,350,350,5,2,3,2,1
4,395,395,59,53,6,3,2
5,422,422,64,6,58,3,2
3,428,428,28,3,25,2,1

8,148,148,33,33,0,1,0
0,209,209,7,7,0,1,0
6,212,212,5,1,4,2,1
7,224,224,6,6,0,1,0
3,282,282,2,2,0,1,0
4,282,282,5,5,0,1,0
5,296,296,3,3,0,1,0
9,309,309,49,10,39,2,1
1,378,378,13,2,11,2,1
2,500,500,138,138,0,1,0

5,134,134,2,2,0,1,0
4,246,246,1,1,0,1,0
2,249,249,2,2,0,1,0
6,268,268,97,97,0,1,0
7,275,275,9,4,5,2,1
3,312,312,38,29,9,2,1
0,369,369,86,86,0,1,0
1,407,407,14,14,0,1,0

8,128,128,4,1,3,2,1
0,254,254,36,12,24,4,3
6,340,340,69,69,0,1,0
4,356,356,25,7,18,3,2
2,428,428,19,19,0,1,0
5,441,441,41,41,0,1,0
7,463,463,81,3,78,4,3
3,471,471,15,3,12,2,1
1,492,492,10,10,0,1,0

3,130,130,1,1,0,1,0
5,139,139,2,2,0,1,0
2,141,141,4,4,0,1,0
4,161,161,28,28,0,1,0
8,170,170,3,3,0,1,0
6,171,171,1,1,0,1,0
11,289,289,13,13,0,1,0
7,330,330,24,6,18,2,1
12,352,352,92,92,0,1,0
0,377,377,1,1,0,1,0
9,450,450,10,10,0,1,0
10,480,480,47,47,0,1,0
1,495,495,27,27,0,1,0

2,119,119,10,6,4,2,1
5,121,121,13,1,12,4,3
3,189,189,15,15,0,1,0
0,269,269,17,10,7,2,1
6,316,316,31,4,27,4,3
4,409,409,82,82,0,1,0
1,493,493,87,33,54,3,2

3,111,111,6,6,0,1,0
7,166,166,11,5,6,3,2
5,229,229,50,50,0,1,0
0,262,262,4,4,0,1,0
6,291,291,36,36,0,1,0
4,345,345,60,10,50,2,1
1,389,389,31,26,5,2,1
2,417,417,33,33,0,1,0

4,105,105,9,9,0,1,0
5,140,140,33,33,0,1,0
0,179,179,22,22,0,1,0
2,180,180,16,13,3,2,1
3,193,193,3,3,0,1,0
6,378,378,33,33,0,1,0
1,469,469,83,70,13,2,1

7,114,114,1,1,0,1,0
4,183,183,21,21,0,1,0
6,229,229,8,8,0,1,0
3,246,246,10,4,6,3,2
8,258,258,10,4,6,2,1
5,359,359,15,15,0,1,0
1,367,367,2,2,0,1,0
0,383,383,52,52,0,1,0
2,427,427,11,11,0,1,0
10,443,443,156,152,4,2,1
9,490,490,6,1,5,2,1

7,127,127,2,2,0,1,0
3,131,131,4,4,0,1,0
5,171,171,56,56,0,1,0
0,225,225,33,33,0,1,0
6,269,269,19,19,0,1,0
2,363,363,13,13,0,1,0
1,423,423,12,12,0,1,0
4,474,474,76,67,9,4,3

4,221,221,33,20,13,2,1
2,222,222,43,43,0,1,0
0,241,241,37,26,11,2,1
3,268,268,17,1,16,2,1
1,298,298,74,74,0,1,0

0,108,108,8,2,6,3,2
6,183,183,9,9,0,1,0
1,207,207,1,1,0,1,0
2,262,262,71,29,42,4,3
4,343,343,110,42,68,4,3
5,411,411,14,3,11,2,1
3,472,472,24,24,0,1,0

3,147,147,36,2,34,2,1
2,309,309,22,22,0,1,0
4,344,344,14,10,4,2,1
8,350,350,49,49,0,1,0
0,409,409,2,2,0,1,0
5,433,433,8,2,6,2,1
6,440,440,20,20,0,1,0
1,459,459,10,10,0,1,0
7,467,467,102,27,75,4,3

0,167,167,13,13,0,1,0
5,202,202,39,34,5,2,1
3,257,257,57,16,41,2,1
1,358,358,10,10,0,1,0
4,365,365,70,31,39,4,3
2,488,488,36,36,0,1,0
6,492,492,11,1,10,4,3

4,116,116,4,4,0,1,0
5,117,117,6,6,0,1,0
8,214,214,66,66,0,1,0
2,234,234,46,46,0,1,0
7,237,237,11,11,0,1,0
6,401,401,21,21,0,1,0
1,420,420,25,25,0,1,0
3,452,452,1,1,0,1,0
0,480,480,30,14,16,2,1

1,110,110,6,6,0,1,0
3,118,118,14,6,8,2,1
6,125,125,6,6,0,1,0
10,169,169,42,42,0,1,0
7,310,310,17,17,0,1,0
8,311,311,2,2,0,1,0
2,345,345,26,17,9,2,1
4,423,423,10,10,0,1,0
0,428,428,10,2,8,2,1
5,487,487,1,1,0,1,0
9,490,490,75,55,20,2,1

3,161,161,1,1,0,1,0
7,229,229,7,7,0,1,0
1,278,278,84,39,45,4,3
2,288,288,15,15,0,1,0
5,311,311,98,98,0,1,0
6,324,324,19,19,0,1,0
0,389,389,3,3,0,1,0
4,471,471,15,15,0,1,0

5,119,119,10,10,0,1,0
3,144,144,31,10,21,2,1
1,211,211,1,1,0,1,0
2,238,238,55,55,0,1,0
4,449,449,48,20,28,3,2
0,452,452,75,72,3,2,1

5,121,121,5,5,0,1,0
7,132,132,3,3,0,1,0
1,180,180,14,14,0,1,0
4,195,195,2,2,0,1,0
6,250,250,35,35,0,1,0
3,267,267,6,6,0,1,0
0,275,275,61,20,41,4,3
8,376,376,92,14,78,3,2
2,396,396,12,12,0,1,0

3,118,118,4,4,0,1,0
6,144,144,2,2,0,1,0
4,302,302,47,4,43,4,3
5,351,351,19,4,15,4,3
0,387,387,16,11,5,2,1
1,389,389,40,13,27,4,3
7,402,402,142,103,39,4,3
2,423,423,6,2,4,2,1
8,428,428,17,2,15,4,3

5,102,102,4,4,0,1,0
7,147,147,14,14,0,1,0
1,226,226,13,13,0,1,0
2,259,259,50,6,44,3,2
3,360,360,8,8,0,1,0
4,365,365,38,38,0,1,0
0,369,369,9,9,0,1,0
6,382,382,108,108,0,1,0

2,181,181,41,17,24,4,3
3,232,232,58,58,0,1,0
0,284,284,42,4,38,2,1
5,382,382,44,33,11,2,1
1,429,429,11,3,8,2,1
4,437,437,17,17,0,1,0

1,174,174,4,4,0,1,0
2,175,175,15,15,0,1,0
0,210,210,2,2,0,1,0
4,210,210,30,8,22,3,2
8,235,235,29,29,0,1,0
6,252,252,24,15,9,2,1
9,445,445,67,54,13,3,2
5,453,453,15,15,0,1,0
3,469,469,5,5,0,1,0
7,476,476,61,61,0,1,0

2,183,183,6,6,0,1,0
7,339,339,20,2,18,4,3
0,380,380,5,1,4,2,1
3,407,407,73,31,42,3,2
4,416,416,2,2,0,1,0
6,441,441,21,12,9,4,3
5,449,449,133,133,0,1,0
1,484,484,83,50,33,4,3

6,175,175,4,4,0,1,0
7,196,196,9,9,0,1,0
1,202,202,10,2,8,2,1
2,302,302,42,12,30,2,1
4,361,361,23,19,4,2,1
5,382,382,128,122,6,3,2
0,419,419,2,2,0,1,0
3,438,438,63,63,0,1,0

2,122,122,17,2,15,2,1
4,335,335,34,19,15,4,3
1,338,338,35,24,11,2,1
3,410,410,69,69,0,1,0
0,488,488,145,145,0,1,0

2,111,111,18,18,0,1,0
1,114,114,6,6,0,1,0
7,143,143,11,7,4,2,1
4,180,180,6,2,4,2,1
6,203,203,6,6,0,1,0
8,293,293,25,25,0,1,0
3,319,319,7,2,5,2,1
9,353,353,52,52,0,1,0
10,371,371,64,43,21,4,3
5,392,392,1,1,0,1,0
0,470,470,12,12,0,1,0

4,110,110,5,2,3,2,1
9,111,111,10,2,8,3,2
0,130,130,9,9,0,1,0
8,132,132,38,19,19,2,1
6,157,157,7,4,3,2,1
3,210,210,13,13,0,1,0
1,212,212,2,2,0,1,0
2,224,224,6,6,0,1,0
7,234,234,15,3,12,3,2
10,331,331,10,5,5,2,1
5,475,475,38,3,35,2,1

1,101,101,2,2,0,1,0
3,164,164,17,1,16,2,1
0,219,219,41,6,35,2,1
5,276,276,71,71,0,1,0
2,350,350,32,3,29,2,1
4,384,384,44,7,37,2,1
6,443,443,15,15,0,1,0

9,103,103,23,15,8,3,2
6,119,119,12,12,0,1,0
4,146,146,12,3,9,2,1
0,158,158,7,2,5,2,1
1,248,248,10,10,0,1,0
7,322,322,12,12,0,1,0
8,337,337,51,37,14,2,1
3,386,386,35,35,0,1,0
5,387,387,8,8,0,1,0
2,420,420,10,10,0,1,0

1,127,127,13,6,7,2,1
2,148,148,4,4,0,1,0
4,163,163,22,22,0,1,0
3,270,270,65,23,42,2,1
0,394,394,107,107,0,1,0
5,433,433,14,14,0,1,0

4,104,104,8,8,0,1,0
5,152,152,8,8,0,1,0
3,178,178,29,29,0,1,0
2,190,190,9,1,8,2,1
0,215,215,7,7,0,1,0
1,356,356,12,6,6,2,1
6,420,420,83,64,19,2,1
8,452,452,41,14,27,4,3
7,480,480,55,5,50,2,1

8,124,124,23,5,18,4,3
7,158,158,33,33,0,1,0
3,163,163,11,4,7,2,1
6,169,169,8,5,3,2,1
9,242,242,4,4,0,1,0
4,322,322,16,16,0,1,0
1,331,331,60,6,54,4,3
5,387,387,18,18,0,1,0
2,440,440,4,4,0,1,0
0,443,443,1,1,0,1,0

2,157,157,45,45,0,1,0
3,229,229,36,22,14,2,1
4,240,240,5,5,0,1,0
1,311,311,22,10,12,2,1
5,342,342,78,10,68,3,2
0,382,382,17,7,10,2,1

5,151,151,7,7,0,1,0
0,202,202,26,26,0,1,0
6,217,217,3,3,0,1,0
8,240,240,17,2,15,2,1
3,272,272,7,7,0,1,0
7,292,292,47,36,11,2,1
1,298,298,7,7,0,1,0
9,309,309,53,53,0,1,0
4,358,358,6,1,5,2,1
2,395,395,59,6,53,4,3

0,117,117,1,1,0,1,0
5,127,127,1,1,0,1,0
10,223,223,76,37,39,4,3
3,244,244,40,2,38,2,1
4,331,331,18,4,14,4,3
2,368,368,3,3,0,1,0
1,386,386,1,1,0,1,0
9,407,407,24,16,8,2,1
8,417,417,1,1,0,1,0
7,459,459,4,4,0,1,0
6,467,467,69,48,21,2,1

4,118,118,6,6,0,1,0
3,141,141,17,10,7,2,1
2,173,173,28,28,0,1,0
0,204,204,14,1,13,2,1
6,245,245,21,21,0,1,0
1,449,449,22,1,21,4,3
5,472,472,126,126,0,1,0

1,152,152,51,30,21,4,3
4,165,165,10,10,0,1,0
2,262,262,88,39,49,2,1
3,405,405,5,5,0,1,0
0,453,453,31,31,0,1,0

5,113,113,11,5,6,3,2
0,130,130,2,2,0,1,0
7,138,138,20,20,0,1,0
4,156,156,1,1,0,1,0
8,294,294,24,24,0,1,0
9,385,385,70,28,42,4,3
2,412,412,2,2,0,1,0
3,430,430,74,74,0,1,0
1,444,444,29,15,14,3,2
6,463,463,18,18,0,1,0

1,140,140,4,1,3,2,1
2,165,165,23,18,5,2,1
4,333,333,88,52,36,4,3
0,404,404,151,113,38,3,2
3,436,436,1,1,0,1,0

1,118,118,24,12,12,3,2
5,137,137,32,32,0,1,0
3,195,195,9,1,8,3,2
7,205,205,23,12,11,2,1
6,282,282,17,17,0,1,0
2,414,414,30,16,14,2,1
4,420,420,8,1,7,2,1
0,477,477,29,29,0,1,0

1,190,190,20,20,0,1,0
0,196,196,38,26,12,2,1
4,199,199,17,17,0,1,0
3,204,204,5,2,3,2,1
5,239,239,71,71,0,1,0
2,304,304,31,31,0,1,0

3,101,101,22,22,0,1,0
1,178,178,1,1,0,1,0
5,192,192,31,9,22,2,1
2,268,268,13,13,0,1,0
6,278,278,5,5,0,1,0
4,313,313,71,71,0,1,0
0,469,469,64,64,0,1,0

1,103,103,1,1,0,1,0
5,155,155,22,22,0,1,0
6,172,172,38,38,0,1,0
4,216,216,10,7,3,2,1
0,315,315,85,56,29,2,1
2,318,318,18,18,0,1,0
3,321,321,21,21,0,1,0

3,147,147,13,13,0,1,0
2,233,233,2,2,0,1,0
0,268,268,14,14,0,1,0
4,283,283,2,2,0,1,0
6,289,289,65,45,20,3,2
1,381,381,96,6,90,4,3
5,445,445,77,77,0,1,0

2,107,107,4,4,0,1,0
8,152,152,5,5,0,1,0
7,231,231,20,20,0,1,0
0,305,305,28,28,0,1,0
6,319,319,92,74,18,2,1
4,380,380,12,5,7,2,1
3,392,392,25,9,16,3,2
5,435,435,28,28,0,1,0
1,443,443,50,50,0,1,0

0,348,348,55,55,0,1,0
6,356,356,34,11,23,2,1
2,358,358,45,6,39,2,1
1,361,361,18,3,15,4,3
5,381,381,77,77,0,1,0
3,402,402,27,27,0,1,0
4,491,491,52,28,24,2,1

4,105,105,36,11,25,2,1
0,176,176,11,11,0,1,0
6,208,208,1,1,0,1,0
3,246,246,4,1,3,2,1
5,319,319,18,18,0,1,0
2,338,338,60,60,0,1,0
1,368,368,53,10,43,2,1

0,205,205,8,4,4,2,1
5,294,294,103,66,37,2,1
6,328,328,16,16,0,1,0
3,376,376,16,11,5,2,1
1,392,392,86,36,50,4,3
2,444,444,45,4,41,2,1
4,478,478,1,1,0,1,0

7,134,134,4,4,0,1,0
2,186,186,8,8,0,1,0
1,187,187,5,5,0,1,0
5,203,203,67,21,46,2,1
6,244,244,11,11,0,1,0
4,250,250,33,5,28,3,2
3,414,414,64,64,0,1,0
0,458,458,21,21,0,1,0

8,112,112,7,7,0,1,0
0,198,198,16,16,0,1,0
7,231,231,34,34,0,1,0
5,313,313,14,14,0,1,0
9,416,416,81,81,0,1,0
2,464,464,16,16,0,1,0
1,467,467,12,12,0,1,0
6,482,482,21,16,5,2,1
4,492,492,32,32,0,1,0
3,498,498,53,53,0,1,0

5,181,181,32,32,0,1,0
7,269,269,45,4,41,2,1
2,376,376,76,27,49,4,3
6,418,418,26,17,9,4,3
4,421,421,18,6,12,4,3
0,427,427,2,2,0,1,0
1,436,436,54,54,0,1,0
3,487,487,14,14,0,1,0

2,122,122,42,42,0,1,0
1,359,359,87,15,72,4,3
3,425,425,15,5,10,3,2
4,431,431,10,1,9,4,3
0,499,499,79,79,0,1,0

2,104,104,8,4,4,2,1
0,250,250,13,13,0,1,0
3,298,298,11,2,9,4,3
5,362,362,56,11,45,4,3
4,404,404,33,33,0,1,0
6,452,452,75,39,36,2,1
1,488,488,115,91,24,2,1

0,131,131,1,1,0,1,0
3,170,170,6,6,0,1,0
6,204,204,12,5,7,2,1
5,218,218,42,42,0,1,0
1,338,338,25,1,24,4,3
4,345,345,24,4,20,3,2
7,399,399,60,12,48,4,3
2,433,433,93,56,37,2,1

1,106,106,9,6,3,2,1
4,120,120,1,1,0,1,0
5,129,129,28,8,20,3,2
0,198,198,41,41,0,1,0
3,269,269,1,1,0,1,0
2,295,295,30,16,14,3,2
7,334,334,30,24,6,3,2
6,437,437,42,42,0,1,0

5,107,107,6,6,0,1,0
3,124,124,19,19,0,1,0
6,151,151,9,1,8,2,1
7,159,159,6,3,3,2,1
4,170,170,1,1,0,1,0
9,175,175,61,61,0,1,0
0,205,205,3,3,0,1,0
1,402,402,29,17,12,4,3
8,444,444,9,4,5,2,1
2,480,480,20,20,0,1,0

0,143,143,1,1,0,1,0
3,156,156,11,11,0,1,0
4,182,182,12,12,0,1,0
1,201,201,21,17,4,2,1
8,269,269,79,79,0,1,0
6,317,317,21,21,0,1,0
5,346,346,18,2,16,2,1
2,436,436,44,2,42,4,3
7,459,459,20,4,16,2,1

3,130,130,10,10,0,1,0
9,148,148,28,28,0,1,0
0,167,167,16,10,6,3,2
1,240,240,17,17,0,1,0
8,279,279,57,57,0,1,0
4,314,314,38,38,0,1,0
6,375,375,1,1,0,1,0
2,387,387,10,1,9,4,3
5,448,448,4,1,3,2,1
7,495,495,8,8,0,1,0

7,104,104,16,12,4,2,1
2,122,122,2,2,0,1,0
6,220,220,21,21,0,1,0
8,262,262,61,55,6,3,2
3,267,267,12,12,0,1,0
4,297,297,4,4,0,1,0
5,307,307,1,1,0,1,0
0,392,392,35,9,26,2,1
9,394,394,8,8,0,1,0
1,487,487,67,52,15,4,3

3,327,327,61,61,0,1,0
2,369,369,8,8,0,1,0
4,390,390,77,77,0,1,0
0,398,398,93,44,49,2,1
1,446,446,75,75,0,1,0

2,106,106,15,15,0,1,0
4,131,131,27,27,0,1,0
1,150,150,4,4,0,1,0
0,151,151,36,28,8,2,1
5,353,353,3,3,0,1,0
3,448,448,87,53,34,2,1

3,160,160,43,43,0,1,0
6,239,239,3,3,0,1,0
4,347,347,114,92,22,3,2
1,352,352,22,22,0,1,0
5,427,427,28,28,0,1,0
0,454,454,9,9,0,1,0
2,467,467,23,23,0,1,0

7,107,107,2,2,0,1,0
3,116,116,11,7,4,2,1
6,166,166,44,4,40,3,2
1,222,222,1,1,0,1,0
4,283,283,44,44,0,1,0
8,316,316,39,39,0,1,0
0,331,331,1,1,0,1,0
5,403,403,19,19,0,1,0
2,461,461,44,14,30,4,3

4,157,157,32,11,21,4,3
3,174,174,3,3,0,1,0
0,360,360,71,40,31,2,1
2,384,384,11,11,0,1,0
5,442,442,84,84,0,1,0
1,443,443,78,57,21,2,1

2,172,172,7,7,0,1,0
4,303,303,2,2,0,1,0
7,331,331,54,54,0,1,0
0,336,336,71,71,0,1,0
6,354,354,71,71,0,1,0
3,376,376,21,21,0,1,0
5,433,433,17,17,0,1,0
1,475,475,41,41,0,1,0

1,153,153,1,1,0,1,0
0,155,155,30,4,26,3,2
5,207,207,10,10,0,1,0
6,279,279,55,55,0,1,0
3,430,430,11,2,9,4,3
4,448,448,73,10,63,4,3
2,500,500,88,88,0,1,0

2,146,146,26,26,0,1,0
7,185,185,12,12,0,1,0
6,186,186,26,11,15,4,3
4,227,227,3,3,0,1,0
5,300,300,60,31,29,4,3
1,346,346,16,16,0,1,0
0,405,405,63,63,0,1,0
3,475,475,4,4,0,1,0

4,321,321,44,24,20,3,2
2,344,344,49,49,0,1,0
0,375,375,49,49,0,1,0
5,416,416,20,3,17,2,1
1,426,426,55,6,49,2,1
3,431,431,94,28,66,4,3

4,108,108,4,4,0,1,0
0,140,140,4,4,0,1,0
3,157,157,16,10,6,3,2
5,178,178,27,9,18,2,1
6,275,275,11,11,0,1,0
1,288,288,45,30,15,2,1
7,376,376,81,81,0,1,0
2,455,455,35,35,0,1,0

5,142,142,6,6,0,1,0
4,149,149,1,1,0,1,0
2,167,167,38,38,0,1,0
6,305,305,62,2,60,3,2
0,319,319,25,25,0,1,0
7,328,328,1,1,0,1,0
3,331,331,5,5,0,1,0
1,408,408,14,14,0,1,0
8,476,476,93,45,48,4,3

4,144,144,2,2,0,1,0
3,171,171,12,12,0,1,0
0,226,226,37,37,0,1,0
7,262,262,73,58,15,4,3
5,347,347,21,21,0,1,0
6,400,400,27,22,5,2,1
1,427,427,15,15,0,1,0
2,475,475,57,57,0,1,0

4,124,124,1,1,0,1,0
9,168,168,4,4,0,1,0
1,264,264,20,20,0,1,0
3,267,267,11,11,0,1,0
7,303,303,80,32,48,4,3
0,321,321,35,35,0,1,0
2,395,395,23,10,13,2,1
5,448,448,44,44,0,1,0
6,455,455,5,5,0,1,0
8,478,478,58,58,0,1,0

3,208,208,19,1,18,4,3
0,310,310,24,24,0,1,0
4,348,348,19,19,0,1,0
1,376,376,31,1,30,4,3
2,392,392,59,59,0,1,0
5,481,481,72,33,39,4,3
6,499,499,99,53,46,3,2

1,100,100,3,3,0,1,0
7,189,189,43,31,12,4,3
6,191,191,33,33,0,1,0
2,211,211,32,32,0,1,0
4,314,314,2,2,0,1,0
5,359,359,1,1,0,1,0
0,405,405,60,60,0,1,0
3,476,476,31,31,0,1,0

3,247,247,1,1,0,1,0
1,325,325,52,26,26,2,1
0,380,380,92,50,42,4,3
2,478,478,141,54,87,4,3
4,490,490,51,21,30,2,1

6,200,200,35,35,0,1,0
3,224,224,12,12,0,1,0
4,238,238,24,13,11,2,1
7,319,319,52,14,38,4,3
1,320,320,17,2,15,2,1
5,451,451,29,29,0,1,0
2,475,475,84,50,34,3,2
0,498,498,8,8,0,1,0

5,129,129,27,27,0,1,0
4,214,214,15,15,0,1,0
3,317,317,41,14,27,4,3
1,331,331,33,9,24,2,1
2,383,383,96,3,93,4,3
0,443,443,22,1,21,2,1

2,105,105,36,36,0,1,0
3,150,150,3,3,0,1,0
5,270,270,12,5,7,2,1
1,279,279,13,1,12,2,1
0,354,354,6,6,0,1,0
4,427,427,147,38,109,4,3

6,154,154,23,23,0,1,0
5,157,157,4,4,0,1,0
3,200,200,28,28,0,1,0
4,285,285,35,11,24,3,2
1,310,310,4,4,0,1,0
7,343,343,2,2,0,1,0
2,427,427,27,27,0,1,0
0,454,454,18,10,8,2,1
8,456,456,114,52,62,3,2

7,153,153,4,4,0,1,0
4,182,182,18,18,0,1,0
0,236,236,43,11,32,4,3
2,236,236,1,1,0,1,0
1,273,273,1,1,0,1,0
6,350,350,87,66,21,4,3
3,415,415,40,8,32,3,2
8,453,453,59,26,33,2,1
5,488,488,8,8,0,1,0

0,116,116,1,1,0,1,0
5,124,124,4,4,0,1,0
12,177,177,30,30,0,1,0
6,181,181,6,3,3,2,1
11,237,237,54,54,0,1,0
4,266,266,33,33,0,1,0
7,273,273,3,3,0,1,0
2,275,275,3,3,0,1,0
3,298,298,21,15,6,2,1
8,373,373,26,4,22,2,1
9,379,379,15,15,0,1,0
10,412,412,5,5,0,1,0
1,463,463,1,1,0,1,0

1,181,181,13,13,0,1,0
3,183,183,6,2,4,2,1
2,201,201,65,51,14,2,1
4,445,445,112,72,40,4,3
0,472,472,4,4,0,1,0
5,499,499,61,61,0,1,0

2,116,116,1,1,0,1,0
5,131,131,1,1,0,1,0
6,134,134,16,16,0,1,0
3,164,164,9,2,7,2,1
9,217,217,7,7,0,1,0
4,253,253,26,26,0,1,0
10,296,296,9,9,0,1,0
1,328,328,6,6,0,1,0
7,346,346,5,5,0,1,0
0,380,380,29,19,10,2,1
8,409,409,140,8,132,4,3

4,182,182,38,38,0,1,0
3,204,204,16,16,0,1,0
0,232,232,15,4,11,2,1
1,466,466,76,13,63,4,3
5,496,496,57,57,0,1,0
2,500,500,87,50,37,2,1

2,165,165,1,1,0,1,0
6,195,195,50,21,29,4,3
5,230,230,13,1,12,3,2
3,263,263,25,5,20,4,3
7,329,329,31,16,15,2,1
1,341,341,22,3,19,2,1
4,369,369,77,68,9,2,1
0,472,472,13,13,0,1,0

7,138,138,10,1,9,2,1
3,143,143,20,4,16,2,1
8,171,171,15,3,12,2,1
2,178,178,8,8,0,1,0
0,318,318,35,35,0,1,0
6,323,323,80,80,0,1,0
1,349,349,26,10,16,2,1
4,429,429,7,7,0,1,0
5,490,490,8,8,0,1,0

9,107,107,28,28,0,1,0
7,126,126,5,5,0,1,0
2,190,190,9,9,0,1,0
6,207,207,2,2,0,1,0
0,218,218,25,17,8,3,2
4,220,220,1,1,0,1,0
8,230,230,26,26,0,1,0
5,284,284,7,3,4,2,1
3,402,402,74,61,13,3,2
1,455,455,8,1,7,2,1

5,125,125,46,46,0,1,0
1,171,171,9,9,0,1,0
4,171,171,5,5,0,1,0
2,225,225,54,24,30,2,1
0,268,268,4,4,0,1,0
6,405,405,3,3,0,1,0
3,416,416,39,39,0,1,0

2,154,154,14,10,4,2,1
5,163,163,19,11,8,3,2
7,166,166,38,38,0,1,0
3,169,169,8,8,0,1,0
8,199,199,17,17,0,1,0
4,353,353,1,1,0,1,0
0,379,379,1,1,0,1,0
9,413,413,40,40,0,1,0
6,419,419,45,34,11,2,1
1,432,432,14,11,3,2,1

5,143,143,32,16,16,3,2
0,197,197,1,1,0,1,0
3,319,319,6,6,0,1,0
2,367,367,23,3,20,2,1
1,368,368,34,8,26,2,1
4,399,399,89,89,0,1,0
7,399,399,12,12,0,1,0
6,479,479,72,58,14,2,1

9,125,125,20,20,0,1,0
4,136,136,6,1,5,2,1
7,178,178,1,1,0,1,0
5,249,249,10,10,0,1,0
10,322,322,15,4,11,3,2
0,326,326,55,11,44,3,2
3,331,331,22,22,0,1,0
11,377,377,76,35,41,2,1
8,410,410,17,5,12,2,1
1,437,437,2,2,0,1,0
2,459,459,11,11,0,1,0
6,480,480,3,3,0,1,0

5,177,177,14,1,13,2,1
4,252,252,15,3,12,3,2
6,283,283,76,55,21,4,3
1,293,293,11,11,0,1,0
0,352,352,5,5,0,1,0
2,375,375,70,40,30,3,2
3,477,477,78,12,66,4,3

3,169,169,9,9,0,1,0
4,229,229,14,1,13,2,1
5,238,238,80,17,63,4,3
6,269,269,18,18,0,1,0
2,294,294,49,35,14,3,2
7,358,358,1,1,0,1,0
0,425,425,50,2,48,3,2
1,462,462,1,1,0,1,0

0,143,143,7,1,6,2,1
8,152,152,36,36,0,1,0
4,220,220,4,4,0,1,0
9,242,242,10,2,8,2,1
2,281,281,13,13,0,1,0
7,403,403,52,22,30,2,1
6,404,404,8,2,6,3,2
3,432,432,69,11,58,3,2
5,452,452,38,4,34,3,2
1,474,474,12,8,4,2,1

3,116,116,1,1,0,1,0
2,149,149,1,1,0,1,0
5,160,160,5,1,4,2,1
0,197,197,4,4,0,1,0
7,293,293,86,86,0,1,0
9,388,388,32,32,0,1,0
1,438,438,93,3,90,3,2
4,460,460,40,10,30,3,2
8,460,460,12,1,11,2,1
6,491,491,17,17,0,1,0

1,112,112,1,1,0,1,0
3,139,139,9,3,6,3,2
7,171,171,27,22,5,2,1
6,183,183,7,7,0,1,0
0,194,194,6,6,0,1,0
8,211,211,52,52,0,1,0
4,236,236,15,15,0,1,0
9,307,307,1,1,0,1,0
2,388,388,8,5,3,2,1
5,438,438,78,5,73,4,3

4,170,170,23,23,0,1,0
5,170,170,10,10,0,1,0
3,183,183,2,2,0,1,0
2,185,185,19,15,4,2,1
0,297,297,23,23,0,1,0
1,308,308,3,3,0,1,0
7,350,350,104,6,98,3,2
9,375,375,14,14,0,1,0
6,461,461,3,3,0,1,0
8,491,491,34,34,0,1,0

6,119,119,1,1,0,1,0
0,155,155,2,2,0,1,0
7,237,237,86,19,67,4,3
3,245,245,15,1,14,3,2
4,283,283,5,1,4,2,1
2,318,318,16,6,10,2,1
5,425,425,16,5,11,2,1
1,426,426,110,94,16,3,2

3,139,139,26,26,0,1,0
1,145,145,10,2,8,3,2
0,375,375,151,81,70,4,3
2,460,460,70,13,57,4,3

5,144,144,2,2,0,1,0
6,144,144,41,17,24,3,2
1,149,149,4,4,0,1,0
4,247,247,28,8,20,2,1
0,309,309,24,24,0,1,0
2,411,411,1,1,0,1,0
3,442,442,130,40,90,3,2

4,101,101,25,2,23,2,1
5,135,135,6,1,5,2,1
3,166,166,20,20,0,1,0
2,197,197,28,28,0,1,0
1,303,303,30,13,17,3,2
0,432,432,70,23,47,4,3

1,139,139,2,2,0,1,0
2,198,198,49,3,46,3,2
5,215,215,67,67,0,1,0
4,295,295,22,14,8,2,1
3,355,355,7,7,0,1,0
0,371,371,53,53,0,1,0

8,158,158,13,13,0,1,0
1,203,203,19,19,0,1,0
3,276,276,1,1,0,1,0
2,283,283,7,7,0,1,0
6,362,362,22,22,0,1,0
10,371,371,28,5,23,4,3
9,375,375,9,9,0,1,0
11,394,394,120,120,0,1,0
5,415,415,5,5,0,1,0
4,428,428,13,2,11,2,1
0,447,447,43,43,0,1,0
7,477,477,1,1,0,1,0

8,137,137,11,1,10,3,2
10,195,195,25,25,0,1,0
5,197,197,12,12,0,1,0
4,258,258,4,4,0,1,0
3,282,282,2,2,0,1,0
9,318,318,63,47,16,2,1
6,329,329,8,3,5,2,1
0,339,339,38,38,0,1,0
7,353,353,5,5,0,1,0
1,370,370,16,16,0,1,0
2,486,486,60,60,0,1,0

1,133,133,17,8,9,4,3
5,174,174,42,9,33,4,3
3,215,215,31,31,0,1,0
6,350,350,13,1,12,3,2
4,382,382,50,50,0,1,0
2,467,467,18,11,7,2,1
0,500,500,46,46,0,1,0

5,121,121,25,7,18,3,2
0,148,148,18,18,0,1,0
3,155,155,22,13,9,2,1
1,191,191,20,3,17,2,1
4,406,406,25,15,10,3,2
2,494,494,86,86,0,1,0

6,159,159,14,14,0,1,0
8,161,161,7,7,0,1,0
5,233,233,45,29,16,3,2
2,264,264,1,1,0,1,0
0,266,266,17,17,0,1,0
1,271,271,8,8,0,1,0
4,311,311,9,4,5,2,1
3,332,332,28,3,25,2,1
7,498,498,137,43,94,4,3

6,120,120,16,16,0,1,0
3,222,222,6,3,3,2,1
2,325,325,44,44,0,1,0
5,373,373,78,64,14,3,2
4,390,390,26,26,0,1,0
0,397,397,89,47,42,3,2
1,421,421,6,1,5,2,1

4,166,166,18,3,15,4,3
5,252,252,37,4,33,4,3
2,304,304,3,3,0,1,0
1,318,318,2,2,0,1,0
3,327,327,65,65,0,1,0
7,389,389,23,23,0,1,0
0,435,435,35,35,0,1,0
6,438,438,87,87,0,1,0

4,109,109,1,1,0,1,0
0,223,223,16,3,13,4,3
6,374,374,51,3,48,3,2
1,404,404,86,86,0,1,0
5,430,430,111,17,94,3,2
2,466,466,19,11,8,2,1
3,466,466,35,35,0,1,0

8,150,150,18,6,12,4,3
5,176,176,1,1,0,1,0
7,269,269,22,22,0,1,0
9,334,334,68,68,0,1,0
2,385,385,1,1,0,1,0
0,403,403,79,79,0,1,0
4,409,409,5,5,0,1,0
1,418,418,23,23,0,1,0
6,436,436,20,20,0,1,0
3,472,472,40,19,21,2,1

3,112,112,19,19,0,1,0
1,198,198,14,1,13,2,1
6,202,202,20,20,0,1,0
0,240,240,14,14,0,1,0
7,334,334,2,2,0,1,0
2,430,430,9,9,0,1,0
5,459,459,137,137,0,1,0
4,480,480,39,39,0,1,0

3,104,104,5,5,0,1,0
7,156,156,4,4,0,1,0
12,189,189,2,2,0,1,0
4,214,214,6,3,3,2,1
13,302,302,97,88,9,4,3
8,331,331,40,25,15,2,1
2,332,332,10,4,6,3,2
0,349,349,8,2,6,2,1
6,386,386,26,26,0,1,0
5,421,421,1,1,0,1,0
11,444,444,33,33,0,1,0
1,456,456,2,2,0,1,0
10,475,475,8,8,0,1,0
9,498,498,17,2,15,2,1

0,122,122,12,4,8,3,2
3,157,157,6,6,0,1,0
6,245,245,10,10,0,1,0
4,293,293,9,1,8,2,1
1,327,327,50,50,0,1,0
7,398,398,126,126,0,1,0
5,448,448,30,17,13,2,1
8,453,453,21,13,8,2,1
2,459,459,6,6,0,1,0

1,119,119,7,7,0,1,0
3,159,159,14,4,10,2,1
9,199,199,40,40,0,1,0
10,230,230,14,14,0,1,0
6,246,246,34,34,0,1,0
0,257,257,3,3,0,1,0
2,301,301,4,1,3,2,1
4,425,425,25,25,0,1,0
7,449,449,13,8,5,2,1
8,475,475,67,20,47,2,1
5,476,476,2,2,0,1,0

8,131,131,6,3,3,2,1
2,169,169,19,19,0,1,0
4,172,172,12,12,0,1,0
7,172,172,7,2,5,2,1
0,181,181,1,1,0,1,0
1,222,222,17,17,0,1,0
9,229,229,74,74,0,1,0
5,252,252,9,9,0,1,0
6,263,263,20,10,10,3,2
3,290,290,8,8,0,1,0

2,266,266,15,15,0,1,0
7,272,272,44,39,5,2,1
5,313,313,40,10,30,4,3
6,335,335,39,39,0,1,0
0,438,438,5,5,0,1,0
3,462,462,92,81,11,2,1
4,479,479,24,11,13,2,1
1,492,492,41,41,0,1,0

3,219,219,10,10,0,1,0
4,263,263,2,2,0,1,0
1,318,318,55,37,18,2,1
2,326,326,114,9,105,4,3
0,492,492,113,104,9,4,3

5,126,126,10,10,0,1,0
7,127,127,4,4,0,1,0
8,148,148,22,22,0,1,0
1,163,163,16,16,0,1,0
9,172,172,21,21,0,1,0
0,232,232,1,1,0,1,0
3,313,313,6,6,0,1,0
6,321,321,12,12,0,1,0
10,411,411,56,23,33,2,1
2,426,426,28,7,21,4,3
4,481,481,31,8,23,2,1

0,284,284,23,16,7,2,1
1,299,299,32,3,29,2,1
4,302,302,8,8,0,1,0
5,348,348,9,9,0,1,0
6,350,350,99,75,24,2,1
3,391,391,67,37,30,3,2
7,411,411,40,40,0,1,0
2,418,418,6,6,0,1,0

1,100,100,15,15,0,1,0
5,140,140,3,3,0,1,0
9,188,188,1,1,0,1,0
8,199,199,22,22,0,1,0
2,209,209,1,1,0,1,0
4,345,345,30,18,12,4,3
6,383,383,7,7,0,1,0
3,422,422,49,35,14,3,2
0,465,465,2,2,0,1,0
7,494,494,142,116,26,3,2

5,127,127,8,1,7,2,1
3,141,141,9,1,8,3,2
2,185,185,1,1,0,1,0
6,244,244,82,41,41,2,1
0,466,466,49,39,10,3,2
4,477,477,5,5,0,1,0
1,487,487,112,112,0,1,0

6,141,141,50,23,27,2,1
0,158,158,42,9,33,2,1
1,188,188,12,12,0,1,0
2,252,252,9,9,0,1,0
3,333,333,12,2,10,2,1
5,394,394,7,7,0,1,0
4,453,453,14,14,0,1,0

10,132,132,10,10,0,1,0
3,144,144,6,6,0,1,0
8,144,144,17,10,7,2,1
4,188,188,9,3,6,2,1
0,190,190,7,1,6,3,2
1,232,232,8,8,0,1,0
2,385,385,6,3,3,2,1
5,403,403,68,68,0,1,0
9,412,412,88,51,37,2,1
6,426,426,12,12,0,1,0
7,437,437,12,12,0,1,0

5,155,155,4,4,0,1,0
6,279,279,75,48,27,4,3
1,285,285,3,3,0,1,0
2,299,299,7,1,6,3,2
3,410,410,8,4,4,2,1
4,470,470,53,5,48,4,3
0,493,493,172,104,68,4,3

0,281,281,62,62,0,1,0
1,351,351,12,12,0,1,0
5,376,376,64,64,0,1,0
2,379,379,4,4,0,1,0
4,383,383,75,44,31,2,1
3,464,464,63,63,0,1,0
6,464,464,18,18,0,1,0

4,117,117,14,4,10,2,1
6,282,282,77,77,0,1,0
1,313,313,14,14,0,1,0
0,325,325,44,37,7,2,1
3,359,359,20,9,11,2,1
5,406,406,7,4,3,2,1
2,499,499,82,82,0,1,0

2,105,105,20,4,16,3,2
1,133,133,15,9,6,2,1
5,175,175,44,26,18,3,2
4,388,388,52,43,9,4,3
3,395,395,7,1,6,2,1
0,444,444,45,20,25,2,1

4,180,180,6,6,0,1,0
6,193,193,20,14,6,3,2
1,236,236,9,1,8,3,2
5,237,237,10,2,8,2,1
7,253,253,17,1,16,2,1
0,255,255,63,17,46,4,3
2,380,380,14,2,12,2,1
3,482,482,2,2,0,1,0
8,482,482,113,14,99,4,3

2,249,249,3,3,0,1,0
4,345,345,6,6,0,1,0
0,362,362,1,1,0,1,0
1,381,381,148,148,0,1,0
5,432,432,163,85,78,3,2
3,454,454,4,4,0,1,0

3,168,168,47,47,0,1,0
0,202,202,17,5,12,2,1
2,256,256,2,2,0,1,0
4,296,296,10,10,0,1,0
5,350,350,62,12,50,3,2
1,395,395,13,13,0,1,0
6,396,396,76,76,0,1,0

0,135,135,4,4,0,1,0
2,222,222,42,31,11,2,1
5,258,258,62,28,34,3,2
3,389,389,40,14,26,3,2
1,390,390,31,20,11,2,1
4,430,430,16,3,13,2,1
6,461,461,59,9,50,4,3

5,230,230,68,68,0,1,0
3,315,315,3,3,0,1,0
2,353,353,30,8,22,2,1
1,363,363,69,69,0,1,0
4,398,398,39,12,27,4,3
0,485,485,61,61,0,1,0

0,152,152,25,22,3,2,1
3,153,153,5,2,3,2,1
2,156,156,18,8,10,3,2
4,237,237,63,63,0,1,0
1,415,415,98,30,68,3,2

4,104,104,33,33,0,1,0
5,218,218,3,3,0,1,0
3,220,220,22,13,9,4,3
0,228,228,35,6,29,2,1
2,234,234,18,3,15,4,3
1,286,286,20,20,0,1,0
6,326,326,26,21,5,2,1

1,237,237,4,4,0,1,0
2,238,238,3,3,0,1,0
5,297,297,13,13,0,1,0
0,301,301,44,41,3,2,1
3,315,315,71,47,24,4,3
6,337,337,88,77,11,4,3
4,479,479,47,47,0,1,0

5,108,108,1,1,0,1,0
4,116,116,1,1,0,1,0
7,150,150,1,1,0,1,0
13,159,159,13,3,10,2,1
0,173,173,20,20,0,1,0
3,201,201,13,13,0,1,0
2,230,230,3,3,0,1,0
1,257,257,11,11,0,1,0
11,284,284,10,10,0,1,0
8,298,298,12,12,0,1,0
6,307,307,7,7,0,1,0
14,317,317,2,2,0,1,0
12,357,357,114,114,0,1,0
10,383,383,2,2,0,1,0
9,387,387,14,14,0,1,0

6,129,129,49,36,13,3,2
1,145,145,11,1,10,3,2
7,147,147,3,3,0,1,0
5,254,254,3,3,0,1,0
0,256,256,43,5,38,2,1
2,451,451,10,10,0,1,0
3,473,473,31,31,0,1,0
4,496,496,34,13,21,4,3

5,228,228,26,8,18,4,3
0,243,243,38,12,26,2,1
7,250,250,30,30,0,1,0
1,271,271,12,12,0,1,0
4,290,290,10,10,0,1,0
3,307,307,48,48,0,1,0
2,340,340,4,4,0,1,0
6,419,419,71,9,62,3,2

2,139,139,13,7,6,3,2
1,214,214,15,6,9,2,1
3,294,294,39,39,0,1,0
4,392,392,30,22,8,2,1
0,443,443,107,65,42,4,3
5,447,447,88,88,0,1,0

0,112,112,10,10,0,1,0
1,333,333,33,15,18,4,3
5,344,344,39,2,37,2,1
6,378,378,12,12,0,1,0
3,408,408,5,5,0,1,0
4,430,430,112,18,94,3,2
2,470,470,94,94,0,1,0

3,136,136,3,3,0,1,0
2,149,149,12,12,0,1,0
0,171,171,1,1,0,1,0
1,257,257,81,52,29,4,3
5,286,286,77,63,14,2,1
4,348,348,40,40,0,1,0

2,102,102,7,7,0,1,0
3,149,149,10,10,0,1,0
8,157,157,12,12,0,1,0
4,296,296,2,2,0,1,0
1,321,321,26,26,0,1,0
7,336,336,80,74,6,3,2
0,352,352,57,57,0,1,0
5,370,370,6,3,3,2,1
6,385,385,35,35,0,1,0

0,140,140,11,8,3,2,1
3,165,165,28,1,27,2,1
4,218,218,37,2,35,2,1
1,263,263,16,1,15,2,1
2,338,338,31,25,6,3,2
5,468,468,22,22,0,1,0
6,494,494,92,38,54,4,3

1,119,119,5,5,0,1,0
2,142,142,31,31,0,1,0
4,259,259,56,6,50,2,1
6,284,284,48,2,46,2,1
0,340,340,36,36,0,1,0
5,369,369,7,7,0,1,0
3,496,496,17,17,0,1,0

4,116,116,3,3,0,1,0
6,298,298,57,57,0,1,0
3,311,311,27,27,0,1,0
5,352,352,66,31,35,2,1
0,412,412,111,69,42,2,1
1,433,433,17,2,15,2,1
2,450,450,3,3,0,1,0

3,116,116,10,10,0,1,0
1,225,225,12,12,0,1,0
2,266,266,33,15,18,2,1
4,371,371,82,82,0,1,0
0,458,458,103,27,76,3,2
5,489,489,50,50,0,1,0

1,132,132,2,2,0,1,0
3,142,142,8,2,6,2,1
0,205,205,61,54,7,2,1
6,216,216,11,11,0,1,0
4,221,221,59,27,32,2,1
5,224,224,19,5,14,3,2
2,273,273,10,4,6,2,1

5,110,110,22,14,8,2,1
3,152,152,1,1,0,1,0
0,192,192,48,48,0,1,0
7,279,279,28,28,0,1,0
6,306,306,32,32,0,1,0
2,307,307,12,8,4,2,1
1,332,332,31,31,0,1,0
4,424,424,5,1,4,2,1

0,127,127,20,20,0,1,0
1,247,247,18,18,0,1,0
7,333,333,78,78,0,1,0
5,347,347,19,9,10,2,1
3,386,386,30,30,0,1,0
2,442,442,2,2,0,1,0
4,448,448,40,40,0,1,0
6,450,450,51,19,32,2,1

4,104,104,1,1,0,1,0
1,194,194,12,3,9,2,1
0,202,202,37,20,17,2,1
3,203,203,17,17,0,1,0
5,298,298,93,63,30,3,2
2,406,406,63,1,62,4,3

3,124,124,2,2,0,1,0
5,184,184,5,5,0,1,0
2,196,196,16,7,9,4,3
0,209,209,12,12,0,1,0
4,346,346,68,52,16,2,1
1,372,372,18,2,16,3,2
6,408,408,147,147,0,1,0
7,416,416,8,5,3,2,1

2,134,134,27,6,21,4,3
4,286,286,25,25,0,1,0
1,433,433,133,106,27,3,2
3,438,438,52,52,0,1,0
0,454,454,43,43,0,1,0

4,147,147,4,4,0,1,0
1,155,155,17,17,0,1,0
0,208,208,6,6,0,1,0
8,246,246,27,2,25,2,1
6,248,248,5,2,3,2,1
7,280,280,78,78,0,1,0
2,293,293,38,6,32,3,2
5,367,367,18,15,3,2,1
3,487,487,28,14,14,3,2

8,129,129,19,2,17,2,1
2,166,166,13,13,0,1,0
4,172,172,6,6,0,1,0
6,193,193,1,1,0,1,0
9,255,255,32,32,0,1,0
10,283,283,38,38,0,1,0
0,346,346,23,23,0,1,0
5,364,364,26,26,0,1,0
7,432,432,41,11,30,2,1
1,448,448,3,3,0,1,0
3,464,464,20,16,4,2,1

5,180,180,53,33,20,3,2
2,228,228,42,42,0,1,0
4,242,242,10,10,0,1,0
1,269,269,42,42,0,1,0
3,332,332,23,23,0,1,0
0,469,469,29,29,0,1,0

5,132,132,1,1,0,1,0
3,204,204,8,8,0,1,0
11,231,231,69,33,36,4,3
1,338,338,31,31,0,1,0
0,350,350,47,47,0,1,0
4,354,354,1,1,0,1,0
9,420,420,26,26,0,1,0
7,446,446,21,21,0,1,0
2,449,449,22,9,13,3,2
10,482,482,21,14,7,2,1
6,485,485,1,1,0,1,0
8,485,485,13,1,12,4,3

1,106,106,11,11,0,1,0
8,123,123,33,4,29,4,3
0,143,143,2,2,0,1,0
6,164,164,11,7,4,2,1
3,183,183,1,1,0,1,0
5,238,238,42,14,28,3,2
4,298,298,7,7,0,1,0
2,358,358,4,4,0,1,0
9,407,407,26,3,23,2,1
7,458,458,33,33,0,1,0

6,141,141,8,8,0,1,0
1,195,195,5,5,0,1,0
4,226,226,1,1,0,1,0
8,312,312,22,22,0,1,0
9,322,322,32,25,7,2,1
7,347,347,81,57,24,4,3
3,417,417,89,40,49,2,1
5,421,421,9,1,8,3,2
0,442,442,27,27,0,1,0
2,449,449,9,9,0,1,0

4,108,108,2,2,0,1,0
6,174,174,13,13,0,1,0
0,258,258,8,2,6,2,1
7,264,264,42,42,0,1,0
1,270,270,49,2,47,2,1
5,279,279,48,30,18,2,1
2,365,365,62,62,0,1,0
3,411,411,3,3,0,1,0

4,183,183,20,3,17,2,1
8,260,260,58,19,39,4,3
5,300,300,12,12,0,1,0
3,308,308,5,5,0,1,0
1,333,333,48,14,34,2,1
0,339,339,1,1,0,1,0
6,365,365,60,60,0,1,0
7,388,388,6,6,0,1,0
2,452,452,40,24,16,3,2

4,106,106,1,1,0,1,0
1,114,114,17,14,3,2,1
8,126,126,7,1,6,3,2
6,135,135,9,9,0,1,0
5,198,198,3,3,0,1,0
9,236,236,71,52,19,2,1
7,288,288,14,8,6,2,1
3,340,340,7,7,0,1,0
0,387,387,54,18,36,2,1
2,415,415,2,2,0,1,0

5,113,113,2,2,0,1,0
0,224,224,2,2,0,1,0
2,238,238,71,71,0,1,0
6,319,319,20,20,0,1,0
4,351,351,115,115,0,1,0
1,366,366,8,4,4,2,1
3,437,437,31,8,23,4,3

0,131,131,27,3,24,4,3
4,158,158,16,16,0,1,0
1,163,163,1,1,0,1,0
3,214,214,10,10,0,1,0
7,241,241,3,3,0,1,0
2,263,263,6,2,4,2,1
8,302,302,46,19,27,4,3
5,423,423,8,8,0,1,0
6,426,426,102,25,77,3,2

3,100,100,10,10,0,1,0
2,133,133,39,39,0,1,0
0,164,164,63,6,57,3,2
4,208,208,3,3,0,1,0
1,266,266,5,5,0,1,0

3,119,119,1,1,0,1,0
7,280,280,29,29,0,1,0
6,315,315,57,23,34,3,2
0,345,345,5,5,0,1,0
5,379,379,39,25,14,2,1
8,405,405,74,74,0,1,0
9,434,434,51,26,25,2,1
2,461,461,4,4,0,1,0
1,465,465,1,1,0,1,0
4,468,468,39,18,21,2,1

5,238,238,14,1,13,4,3
2,258,258,45,45,0,1,0
3,329,329,37,37,0,1,0
1,342,342,41,41,0,1,0
0,444,444,48,48,0,1,0
4,488,488,114,37,77,4,3

4,180,180,7,3,4,2,1
2,192,192,15,15,0,1,0
7,209,209,2,2,0,1,0
0,213,213,26,26,0,1,0
5,220,220,17,5,12,4,3
8,386,386,120,87,33,2,1
1,437,437,35,35,0,1,0
3,462,462,3,3,0,1,0
6,474,474,41,3,38,2,1

0,164,164,6,6,0,1,0
8,170,170,7,7,0,1,0
4,228,228,8,4,4,2,1
2,239,239,1,1,0,1,0
7,342,342,86,54,32,2,1
5,380,380,2,2,0,1,0
3,428,428,17,10,7,2,1
6,429,429,49,23,26,3,2
1,488,488,137,68,69,3,2

5,165,165,36,22,14,3,2
1,171,171,36,36,0,1,0
3,290,290,38,38,0,1,0
2,469,469,5,5,0,1,0
4,473,473,28,28,0,1,0
0,499,499,90,56,34,2,1

4,110,110,24,24,0,1,0
2,119,119,7,7,0,1,0
6,186,186,8,8,0,1,0
5,243,243,36,36,0,1,0
3,275,275,22,22,0,1,0
1,332,332,70,6,64,3,2
0,428,428,22,7,15,4,3

2,218,218,30,22,8,2,1
5,240,240,61,16,45,2,1
6,294,294,32,1,31,2,1
1,312,312,35,23,12,2,1
3,422,422,43,43,0,1,0
4,439,439,17,2,15,2,1
0,473,473,23,17,6,3,2

4,168,168,22,10,12,3,2
0,184,184,17,13,4,2,1
5,272,272,13,4,9,2,1
2,289,289,46,11,35,4,3
6,412,412,93,93,0,1,0
1,443,443,27,27,0,1,0
3,446,446,40,1,39,2,1

3,136,136,7,7,0,1,0
4,202,202,32,23,9,4,3
0,324,324,64,43,21,4,3
1,340,340,26,1,25,4,3
2,474,474,60,60,0,1,0
5,480,480,93,86,7,2,1

0,140,140,1,1,0,1,0
4,162,162,36,36,0,1,0
2,189,189,74,37,37,2,1
3,190,190,7,1,6,2,1
1,401,401,1,1,0,1,0
5,496,496,75,72,3,2,1

0,132,132,5,5,0,1,0
2,133,133,20,20,0,1,0
3,169,169,20,17,3,2,1
1,397,397,144,98,46,3,2
4,481,481,65,40,25,2,1

5,149,149,20,20,0,1,0
6,209,209,16,16,0,1,0
2,271,271,88,88,0,1,0
4,273,273,54,54,0,1,0
1,306,306,7,7,0,1,0
0,381,381,19,19,0,1,0
3,497,497,2,2,0,1,0

8,242,242,46,46,0,1,0
7,244,244,46,35,11,2,1
0,258,258,3,3,0,1,0
4,268,268,41,41,0,1,0
5,317,317,10,10,0,1,0
3,384,384,18,5,13,2,1
9,420,420,12,6,6,3,2
6,423,423,8,8,0,1,0
1,430,430,31,18,13,2,1
2,471,471,32,32,0,1,0

7,144,144,30,20,10,3,2
8,269,269,49,49,0,1,0
5,288,288,7,7,0,1,0
1,341,341,7,1,6,3,2
6,374,374,7,7,0,1,0
4,384,384,34,34,0,1,0
3,402,402,50,40,10,3,2
2,403,403,8,8,0,1,0
0,454,454,57,21,36,2,1

4,231,231,7,7,0,1,0
0,315,315,52,52,0,1,0
5,347,347,29,29,0,1,0
2,356,356,16,16,0,1,0
7,402,402,24,24,0,1,0
1,435,435,5,5,0,1,0
3,469,469,71,71,0,1,0
6,495,495,129,95,34,2,1

9,145,145,20,8,12,2,1
7,159,159,1,1,0,1,0
3,170,170,2,2,0,1,0
4,220,220,3,3,0,1,0
8,252,252,67,67,0,1,0
1,319,319,19,14,5,2,1
2,333,333,9,9,0,1,0
6,334,334,15,15,0,1,0
5,363,363,11,2,9,4,3
0,390,390,84,15,69,4,3

4,104,104,12,12,0,1,0
3,342,342,35,11,24,3,2
2,346,346,11,5,6,2,1
5,364,364,94,25,69,4,3
7,371,371,44,32,12,3,2
1,443,443,30,30,0,1,0
0,447,447,40,40,0,1,0
6,478,478,12,12,0,1,0

2,109,109,4,4,0,1,0
4,137,137,13,1,12,2,1
1,156,156,9,9,0,1,0
7,159,159,13,4,9,2,1
0,173,173,7,7,0,1,0
8,183,183,25,4,21,4,3
9,334,334,63,16,47,2,1
6,399,399,2,2,0,1,0
3,448,448,47,47,0,1,0
5,476,476,29,4,25,3,2

5,168,168,2,2,0,1,0
6,234,234,32,32,0,1,0
3,275,275,87,87,0,1,0
1,293,293,10,1,9,2,1
0,380,380,4,4,0,1,0
2,396,396,16,16,0,1,0
4,462,462,120,20,100,3,2

1,257,257,1,1,0,1,0
4,264,264,24,15,9,4,3
6,284,284,11,11,0,1,0
5,357,357,98,98,0,1,0
0,383,383,105,105,0,1,0
3,432,432,44,4,40,3,2
2,485,485,10,10,0,1,0

1,133,133,13,13,0,1,0
3,145,145,5,5,0,1,0
2,229,229,19,19,0,1,0
5,231,231,17,17,0,1,0
0,394,394,73,73,0,1,0
4,436,436,112,112,0,1,0
6,458,458,34,1,33,2,1

7,185,185,29,29,0,1,0
5,187,187,1,1,0,1,0
0,210,210,6,6,0,1,0
2,242,242,8,8,0,1,0
1,278,278,4,1,3,2,1
6,382,382,94,46,48,2,1
4,405,405,40,10,30,3,2
3,420,420,95,95,0,1,0

3,129,129,16,6,10,3,2
6,165,165,12,12,0,1,0
5,206,206,12,12,0,1,0
2,253,253,39,39,0,1,0
0,341,341,9,9,0,1,0
1,353,353,8,8,0,1,0
4,410,410,30,8,22,2,1
7,425,425,116,44,72,3,2

0,113,113,18,18,0,1,0
5,139,139,31,31,0,1,0
3,263,263,7,7,0,1,0
4,332,332,61,49,12,4,3
1,338,338,1,1,0,1,0
7,378,378,36,26,10,3,2
2,430,430,12,12,0,1,0
6,444,444,40,6,34,3,2

