5,164,164,16,4,12,2,1
7,208,208,48,48,0,1,0
3,215,215,88,20,68,3,2
4,222,222,14,14,0,1,0
6,227,227,26,8,18,4,3
2,303,303,3,3,0,1,0
1,427,427,30,2,28,2,1
0,448,448,5,1,4,2,1

1,156,156,62,26,36,4,3
2,177,177,12,6,6,2,1
5,273,273,100,20,80,3,2
3,412,412,13,4,9,4,3
4,460,460,43,31,12,4,3
6,473,473,7,7,0,1,0
0,480,480,18,5,13,4,3

6,132,132,2,2,0,1,0
2,165,165,65,35,30,3,2
1,189,189,8,8,0,1,0
0,255,255,17,12,5,2,1
5,385,385,39,18,21,4,3
3,442,442,59,59,0,1,0
4,456,456,117,51,66,4,3

9,128,128,3,3,0,1,0
10,154,154,6,1,5,2,1
1,183,183,26,19,7,2,1
2,212,212,18,9,9,4,3
7,218,218,22,22,0,1,0
8,327,327,9,1,8,2,1
3,344,344,10,10,0,1,0
6,372,372,11,11,0,1,0
0,397,397,14,3,11,2,1
4,414,414,30,18,12,4,3
11,460,460,191,171,20,3,2
5,467,467,3,3,0,1,0

5,108,108,3,3,0,1,0
4,299,299,125,125,0,1,0
1,318,318,88,88,0,1,0
3,344,344,11,11,0,1,0
0,372,372,84,84,0,1,0
2,474,474,14,5,9,2,1

0,137,137,18,18,0,1,0
3,146,146,4,4,0,1,0
7,147,147,6,3,3,2,1
1,149,149,5,5,0,1,0
13,158,158,13,13,0,1,0
10,199,199,30,16,14,3,2
12,362,362,57,57,0,1,0
5,374,374,11,11,0,1,0
2,383,383,9,3,6,3,2
4,396,396,17,17,0,1,0
6,437,437,25,3,22,3,2
8,449,449,14,2,12,3,2
9,451,451,38,38,0,1,0
11,472,472,55,55,0,1,0

1,118,118,20,20,0,1,0
6,127,127,38,14,24,3,2
5,129,129,14,14,0,1,0
4,183,183,13,7,6,3,2
2,242,242,2,2,0,1,0
0,291,291,26,4,22,3,2
9,307,307,5,2,3,2,1
8,338,338,4,1,3,2,1
3,414,414,24,24,0,1,0
7,450,450,80,38,42,4,3

6,119,119,6,6,0,1,0
1,123,123,6,1,5,2,1
10,138,138,29,29,0,1,0
3,249,249,20,20,0,1,0
0,321,321,9,3,6,3,2
9,333,333,32,32,0,1,0
2,350,350,25,19,6,2,1
5,382,382,1,1,0,1,0
4,384,384,70,44,26,3,2
8,397,397,23,5,18,3,2
11,444,444,62,34,28,2,1
7,485,485,18,18,0,1,0

9,113,113,16,6,10,3,2
10,135,135,10,2,8,3,2
7,153,153,23,23,0,1,0
1,168,168,9,5,4,2,1
6,184,184,25,25,0,1,0
0,194,194,20,20,0,1,0
8,196,196,30,21,9,2,1
4,356,356,43,15,28,3,2
3,448,448,12,12,0,1,0
2,487,487,29,29,0,1,0
5,499,499,1,1,0,1,0

4,121,121,7,7,0,1,0
7,215,215,11,1,10,2,1
2,232,232,39,3,36,2,1
1,239,239,19,19,0,1,0
3,255,255,6,6,0,1,0
0,262,262,27,12,15,2,1
9,280,280,47,19,28,2,1
6,307,307,43,43,0,1,0
8,411,411,61,23,38,4,3
5,464,464,32,2,30,2,1

1,103,103,9,5,4,2,1
8,113,113,11,11,0,1,0
2,118,118,12,12,0,1,0
4,136,136,1,1,0,1,0
0,158,158,28,2,26,4,3
7,195,195,45,45,0,1,0
5,285,285,29,29,0,1,0
6,320,320,34,1,33,4,3
3,333,333,9,9,0,1,0
9,345,345,27,17,10,3,2

9,101,101,35,4,31,2,1
4,168,168,6,6,0,1,0
2,215,215,27,27,0,1,0
1,300,300,42,42,0,1,0
0,338,338,19,19,0,1,0
5,341,341,2,2,0,1,0
7,366,366,50,24,26,3,2
6,410,410,1,1,0,1,0
8,457,457,8,8,0,1,0
3,479,479,66,33,33,3,2

7,162,162,23,6,17,2,1
3,210,210,7,7,0,1,0
1,211,211,17,17,0,1,0
4,231,231,19,7,12,4,3
10,299,299,11,11,0,1,0
2,315,315,4,4,0,1,0
9,320,320,24,24,0,1,0
8,352,352,25,25,0,1,0
0,422,422,35,35,0,1,0
5,426,426,14,11,3,2,1
11,440,440,142,44,98,3,2
6,488,488,17,17,0,1,0

2,160,160,6,6,0,1,0
7,165,165,33,33,0,1,0
8,194,194,47,13,34,2,1
1,237,237,23,5,18,4,3
0,246,246,34,25,9,4,3
6,258,258,1,1,0,1,0
4,324,324,73,50,23,3,2
5,375,375,24,10,14,3,2
3,430,430,2,2,0,1,0

5,116,116,1,1,0,1,0
8,121,121,10,10,0,1,0
1,157,157,14,5,9,2,1
2,183,183,4,4,0,1,0
3,255,255,2,2,0,1,0
4,258,258,51,19,32,2,1
9,326,326,73,73,0,1,0
10,327,327,23,3,20,2,1
6,333,333,11,1,10,3,2
7,424,424,55,55,0,1,0
0,462,462,66,61,5,2,1

13,138,138,9,1,8,3,2
3,151,151,1,1,0,1,0
2,181,181,2,2,0,1,0
15,186,186,30,30,0,1,0
14,213,213,57,43,14,3,2
7,228,228,21,21,0,1,0
4,307,307,5,5,0,1,0
9,316,316,4,4,0,1,0
10,333,333,36,22,14,3,2
12,372,372,8,8,0,1,0
1,391,391,9,9,0,1,0
8,396,396,9,1,8,2,1
11,404,404,41,2,39,2,1
0,452,452,2,2,0,1,0
6,495,495,49,13,36,4,3
5,498,498,2,2,0,1,0

7,112,112,11,11,0,1,0
2,143,143,14,14,0,1,0
3,176,176,6,6,0,1,0
1,210,210,17,17,0,1,0
4,213,213,34,8,26,3,2
5,241,241,14,14,0,1,0
6,253,253,72,18,54,3,2
9,273,273,24,9,15,2,1
0,327,327,24,24,0,1,0
8,348,348,13,1,12,3,2

5,156,156,11,5,6,3,2
7,180,180,24,24,0,1,0
3,232,232,46,23,23,2,1
2,243,243,38,4,34,4,3
6,251,251,62,14,48,3,2
4,281,281,17,9,8,3,2
1,444,444,7,2,5,2,1
0,493,493,65,29,36,3,2

4,118,118,5,5,0,1,0
2,141,141,1,1,0,1,0
0,150,150,2,2,0,1,0
3,204,204,3,3,0,1,0
1,217,217,1,1,0,1,0
10,238,238,10,7,3,2,1
6,248,248,101,50,51,4,3
9,305,305,20,20,0,1,0
5,356,356,4,4,0,1,0
7,394,394,103,76,27,4,3
8,467,467,64,64,0,1,0

2,100,100,12,12,0,1,0
8,103,103,6,6,0,1,0
1,135,135,8,8,0,1,0
4,140,140,11,11,0,1,0
6,154,154,11,11,0,1,0
0,158,158,1,1,0,1,0
10,168,168,1,1,0,1,0
9,236,236,33,33,0,1,0
7,287,287,15,15,0,1,0
11,302,302,81,81,0,1,0
12,378,378,37,6,31,2,1
5,404,404,8,8,0,1,0
3,413,413,16,16,0,1,0

9,122,122,19,19,0,1,0
12,151,151,23,23,0,1,0
6,154,154,9,3,6,2,1
5,201,201,19,19,0,1,0
3,209,209,12,9,3,2,1
8,216,216,19,14,5,2,1
1,235,235,1,1,0,1,0
7,239,239,23,8,15,4,3
4,256,256,12,1,11,2,1
2,300,300,2,2,0,1,0
0,361,361,18,4,14,2,1
11,374,374,56,28,28,3,2
10,386,386,18,8,10,3,2

1,143,143,8,8,0,1,0
9,209,209,12,4,8,3,2
7,233,233,18,9,9,4,3
0,260,260,20,7,13,2,1
8,281,281,71,26,45,4,3
5,282,282,20,20,0,1,0
6,304,304,38,13,25,2,1
2,314,314,14,4,10,3,2
4,385,385,2,2,0,1,0
3,489,489,122,70,52,3,2

8,158,158,12,8,4,2,1
0,186,186,18,12,6,3,2
5,192,192,15,8,7,2,1
10,195,195,9,5,4,2,1
7,261,261,61,61,0,1,0
6,289,289,27,27,0,1,0
4,312,312,24,4,20,3,2
3,382,382,8,8,0,1,0
9,396,396,59,29,30,3,2
2,432,432,52,31,21,4,3
1,485,485,7,7,0,1,0

5,101,101,11,11,0,1,0
4,136,136,1,1,0,1,0
7,136,136,17,12,5,2,1
2,141,141,10,6,4,2,1
3,166,166,6,6,0,1,0
0,331,331,4,4,0,1,0
8,394,394,47,31,16,2,1
9,394,394,69,41,28,2,1
6,418,418,37,14,23,2,1
1,424,424,115,115,0,1,0

1,131,131,40,4,36,2,1
5,188,188,21,12,9,4,3
0,210,210,42,4,38,3,2
4,283,283,11,4,7,2,1
3,409,409,30,3,27,2,1
2,428,428,121,82,39,4,3

10,149,149,40,1,39,2,1
3,202,202,1,1,0,1,0
6,217,217,2,2,0,1,0
4,259,259,4,4,0,1,0
0,276,276,20,20,0,1,0
7,353,353,54,39,15,2,1
8,356,356,28,28,0,1,0
5,365,365,45,17,28,2,1
2,373,373,5,2,3,2,1
9,411,411,5,2,3,2,1
1,451,451,118,86,32,3,2

11,137,137,12,12,0,1,0
10,286,286,50,50,0,1,0
1,300,300,33,33,0,1,0
3,321,321,28,3,25,2,1
4,325,325,25,25,0,1,0
7,338,338,28,28,0,1,0
9,365,365,27,27,0,1,0
8,371,371,7,7,0,1,0
5,400,400,3,3,0,1,0
2,403,403,2,2,0,1,0
6,409,409,15,15,0,1,0
13,417,417,21,21,0,1,0
0,428,428,1,1,0,1,0
12,457,457,88,43,45,4,3

4,160,160,19,1,18,2,1
1,278,278,82,1,81,4,3
6,282,282,19,5,14,2,1
3,289,289,3,3,0,1,0
0,399,399,49,43,6,2,1
2,427,427,36,36,0,1,0
5,494,494,155,155,0,1,0

3,110,110,7,1,6,3,2
7,148,148,53,53,0,1,0
8,152,152,11,5,6,2,1
2,157,157,1,1,0,1,0
0,173,173,5,5,0,1,0
6,178,178,7,4,3,2,1
1,275,275,15,15,0,1,0
4,359,359,17,3,14,2,1
9,372,372,15,3,12,4,3
5,488,488,147,109,38,2,1

2,111,111,2,2,0,1,0
9,176,176,17,17,0,1,0
4,192,192,9,9,0,1,0
7,203,203,27,20,7,2,1
11,226,226,52,18,34,2,1
6,242,242,11,11,0,1,0
1,248,248,1,1,0,1,0
5,296,296,18,18,0,1,0
0,348,348,15,15,0,1,0
3,359,359,55,16,39,2,1
8,386,386,29,29,0,1,0
10,449,449,47,47,0,1,0

5,184,184,8,8,0,1,0
0,243,243,61,5,56,3,2
2,269,269,59,2,57,4,3
3,316,316,19,2,17,2,1
4,336,336,62,52,10,3,2
1,355,355,89,62,27,2,1

5,113,113,17,17,0,1,0
3,117,117,4,4,0,1,0
1,141,141,9,9,0,1,0
6,229,229,1,1,0,1,0
4,315,315,2,2,0,1,0
7,351,351,17,17,0,1,0
11,390,390,37,25,12,3,2
8,400,400,8,8,0,1,0
9,408,408,12,3,9,4,3
2,451,451,29,15,14,2,1
12,459,459,131,102,29,2,1
10,466,466,43,43,0,1,0
0,484,484,53,3,50,2,1

6,121,121,25,25,0,1,0
7,161,161,9,1,8,3,2
4,257,257,16,16,0,1,0
0,300,300,23,2,21,4,3
1,312,312,87,87,0,1,0
5,333,333,61,34,27,4,3
3,336,336,34,24,10,2,1
2,348,348,16,1,15,4,3

1,104,104,1,1,0,1,0
7,130,130,37,37,0,1,0
6,170,170,6,6,0,1,0
0,177,177,1,1,0,1,0
14,201,201,9,9,0,1,0
15,215,215,53,1,52,3,2
8,219,219,3,3,0,1,0
9,220,220,2,2,0,1,0
5,232,232,16,9,7,2,1
2,233,233,1,1,0,1,0
11,274,274,1,1,0,1,0
12,279,279,20,20,0,1,0
3,305,305,1,1,0,1,0
4,385,385,10,1,9,2,1
10,464,464,17,1,16,2,1
13,467,467,67,58,9,4,3

5,115,115,6,6,0,1,0
7,116,116,5,5,0,1,0
10,128,128,4,4,0,1,0
9,141,141,8,2,6,3,2
6,200,200,32,32,0,1,0
0,227,227,2,2,0,1,0
2,269,269,16,16,0,1,0
4,304,304,15,9,6,2,1
1,321,321,31,31,0,1,0
3,361,361,27,11,16,3,2
8,399,399,152,104,48,4,3

5,111,111,5,5,0,1,0
4,177,177,7,3,4,2,1
9,194,194,44,11,33,2,1
10,234,234,61,17,44,3,2
7,280,280,1,1,0,1,0
2,335,335,9,4,5,2,1
3,348,348,43,11,32,3,2
0,380,380,19,12,7,2,1
11,398,398,1,1,0,1,0
1,432,432,43,43,0,1,0
8,468,468,8,8,0,1,0
6,489,489,56,4,52,3,2

3,109,109,4,4,0,1,0
10,172,172,17,17,0,1,0
0,182,182,19,1,18,4,3
8,210,210,11,4,7,2,1
9,215,215,19,5,14,2,1
1,358,358,59,2,57,4,3
4,372,372,2,2,0,1,0
2,398,398,25,5,20,2,1
7,446,446,121,76,45,4,3
5,474,474,43,43,0,1,0
6,482,482,17,1,16,2,1

3,136,136,7,7,0,1,0
12,143,143,19,3,16,2,1
0,146,146,15,15,0,1,0
6,190,190,34,34,0,1,0
11,240,240,52,52,0,1,0
13,290,290,29,21,8,2,1
4,341,341,4,1,3,2,1
8,343,343,18,18,0,1,0
9,362,362,2,2,0,1,0
7,384,384,7,7,0,1,0
10,407,407,25,13,12,3,2
5,426,426,11,11,0,1,0
2,485,485,9,9,0,1,0
1,489,489,18,18,0,1,0

4,172,172,3,3,0,1,0
2,185,185,42,42,0,1,0
8,319,319,15,15,0,1,0
7,340,340,6,2,4,2,1
0,378,378,27,27,0,1,0
5,383,383,10,1,9,4,3
3,414,414,29,29,0,1,0
6,446,446,48,13,35,2,1
1,465,465,42,42,0,1,0
9,465,465,155,155,0,1,0

5,142,142,5,5,0,1,0
7,148,148,3,3,0,1,0
1,189,189,35,35,0,1,0
6,253,253,39,39,0,1,0
3,296,296,13,13,0,1,0
0,380,380,66,32,34,3,2
4,418,418,8,8,0,1,0
2,420,420,19,4,15,4,3
8,420,420,24,6,18,2,1
9,455,455,124,103,21,4,3

9,180,180,16,10,6,2,1
11,216,216,21,10,11,2,1
6,220,220,20,11,9,2,1
2,231,231,6,6,0,1,0
3,274,274,66,41,25,2,1
10,316,316,19,2,17,2,1
8,336,336,89,11,78,4,3
1,381,381,2,2,0,1,0
5,388,388,34,4,30,4,3
7,403,403,8,8,0,1,0
0,404,404,10,10,0,1,0
4,457,457,3,3,0,1,0

4,132,132,1,1,0,1,0
3,148,148,9,1,8,3,2
9,184,184,1,1,0,1,0
6,193,193,22,22,0,1,0
8,195,195,12,12,0,1,0
5,283,283,65,56,9,2,1
1,345,345,30,6,24,2,1
7,371,371,121,112,9,4,3
0,391,391,7,7,0,1,0
2,432,432,42,30,12,4,3

5,129,129,7,7,0,1,0
6,187,187,53,53,0,1,0
3,215,215,2,2,0,1,0
4,224,224,15,15,0,1,0
0,312,312,69,50,19,2,1
7,325,325,36,36,0,1,0
9,329,329,28,28,0,1,0
8,347,347,10,1,9,4,3
1,353,353,9,9,0,1,0
2,459,459,59,22,37,2,1

1,129,129,10,10,0,1,0
6,154,154,11,8,3,2,1
3,158,158,14,14,0,1,0
0,189,189,6,2,4,2,1
9,226,226,30,21,9,2,1
10,253,253,86,64,22,3,2
11,348,348,3,3,0,1,0
2,353,353,1,1,0,1,0
5,361,361,12,1,11,2,1
8,377,377,9,9,0,1,0
7,456,456,84,48,36,4,3
4,492,492,6,6,0,1,0

4,130,130,10,6,4,2,1
1,141,141,5,5,0,1,0
8,263,263,26,2,24,3,2
2,304,304,52,1,51,3,2
7,357,357,59,10,49,2,1
9,364,364,37,37,0,1,0
5,440,440,48,48,0,1,0
3,452,452,30,13,17,2,1
6,455,455,63,40,23,2,1
0,492,492,21,21,0,1,0

7,118,118,1,1,0,1,0
2,171,171,16,16,0,1,0
6,173,173,8,2,6,3,2
0,179,179,4,4,0,1,0
5,190,190,18,4,14,4,3
8,200,200,70,47,23,2,1
4,317,317,51,18,33,4,3
9,345,345,38,4,34,2,1
1,350,350,40,19,21,4,3
3,497,497,8,8,0,1,0

8,122,122,3,3,0,1,0
2,129,129,12,2,10,3,2
4,137,137,8,8,0,1,0
6,142,142,14,14,0,1,0
7,191,191,2,2,0,1,0
3,213,213,10,10,0,1,0
1,234,234,9,4,5,2,1
5,239,239,18,2,16,2,1
10,258,258,76,60,16,2,1
11,332,332,9,9,0,1,0
9,417,417,69,25,44,3,2
0,442,442,35,32,3,2,1

8,122,122,11,11,0,1,0
4,123,123,3,3,0,1,0
3,136,136,15,15,0,1,0
5,145,145,12,6,6,3,2
6,169,169,6,6,0,1,0
1,218,218,19,7,12,4,3
2,255,255,37,11,26,2,1
7,281,281,18,18,0,1,0
9,287,287,8,8,0,1,0
10,373,373,123,101,22,3,2
0,495,495,8,8,0,1,0

6,101,101,1,1,0,1,0
7,173,173,3,3,0,1,0
10,180,180,31,31,0,1,0
3,199,199,16,16,0,1,0
5,209,209,25,17,8,2,1
9,348,348,78,32,46,3,2
4,380,380,30,30,0,1,0
0,384,384,27,16,11,2,1
2,413,413,2,2,0,1,0
8,420,420,40,40,0,1,0
1,454,454,62,27,35,4,3

5,115,115,2,2,0,1,0
2,133,133,8,8,0,1,0
9,186,186,32,32,0,1,0
10,192,192,57,57,0,1,0
8,280,280,4,4,0,1,0
3,283,283,32,11,21,4,3
0,355,355,1,1,0,1,0
6,370,370,17,17,0,1,0
4,405,405,34,34,0,1,0
7,424,424,26,26,0,1,0
12,425,425,6,6,0,1,0
1,433,433,45,21,24,3,2
11,454,454,10,10,0,1,0

1,115,115,10,10,0,1,0
12,118,118,2,2,0,1,0
13,122,122,41,6,35,4,3
5,127,127,4,4,0,1,0
9,140,140,5,1,4,2,1
11,184,184,1,1,0,1,0
0,190,190,17,1,16,3,2
7,265,265,7,1,6,2,1
3,286,286,14,5,9,4,3
10,313,313,49,49,0,1,0
6,327,327,12,9,3,2,1
2,355,355,50,14,36,2,1
8,361,361,1,1,0,1,0
4,465,465,2,2,0,1,0

5,108,108,9,2,7,2,1
1,135,135,11,5,6,3,2
9,158,158,5,5,0,1,0
8,182,182,51,51,0,1,0
10,190,190,3,3,0,1,0
0,238,238,7,4,3,2,1
7,246,246,45,12,33,4,3
2,336,336,51,42,9,4,3
6,366,366,28,28,0,1,0
3,429,429,16,16,0,1,0
4,463,463,19,19,0,1,0

1,106,106,2,2,0,1,0
6,141,141,31,31,0,1,0
10,166,166,45,15,30,4,3
3,172,172,3,3,0,1,0
2,174,174,9,9,0,1,0
0,240,240,13,8,5,2,1
5,321,321,15,15,0,1,0
7,334,334,23,23,0,1,0
8,367,367,49,20,29,2,1
9,442,442,15,4,11,2,1
4,451,451,44,32,12,3,2

6,146,146,8,8,0,1,0
9,157,157,3,3,0,1,0
4,162,162,2,2,0,1,0
5,191,191,1,1,0,1,0
8,192,192,1,1,0,1,0
1,215,215,30,30,0,1,0
11,227,227,4,4,0,1,0
0,255,255,57,57,0,1,0
10,346,346,63,63,0,1,0
12,376,376,109,79,30,4,3
7,399,399,21,21,0,1,0
2,422,422,1,1,0,1,0
3,450,450,3,3,0,1,0

9,106,106,8,8,0,1,0
4,128,128,27,3,24,3,2
0,132,132,5,5,0,1,0
6,173,173,16,16,0,1,0
3,234,234,5,5,0,1,0
5,248,248,15,6,9,2,1
8,334,334,113,113,0,1,0
1,376,376,25,25,0,1,0
2,455,455,47,47,0,1,0
7,456,456,2,2,0,1,0

8,185,185,24,24,0,1,0
3,203,203,35,25,10,2,1
7,206,206,38,38,0,1,0
2,210,210,19,10,9,4,3
4,261,261,18,4,14,3,2
6,264,264,44,44,0,1,0
1,351,351,5,5,0,1,0
5,396,396,12,12,0,1,0
0,397,397,62,13,49,2,1

6,144,144,3,3,0,1,0
5,190,190,13,3,10,2,1
2,191,191,2,2,0,1,0
0,198,198,10,10,0,1,0
7,238,238,14,14,0,1,0
3,289,289,17,17,0,1,0
10,324,324,81,81,0,1,0
9,325,325,8,8,0,1,0
8,342,342,16,16,0,1,0
1,355,355,59,13,46,2,1
11,402,402,52,20,32,4,3
4,466,466,9,9,0,1,0
12,466,466,47,47,0,1,0

3,181,181,1,1,0,1,0
1,256,256,4,4,0,1,0
9,289,289,19,5,14,4,3
4,336,336,17,2,15,3,2
5,377,377,21,7,14,4,3
6,388,388,108,21,87,4,3
8,403,403,24,2,22,2,1
2,409,409,90,68,22,2,1
0,478,478,73,73,0,1,0
7,481,481,50,3,47,4,3

5,128,128,10,3,7,2,1
4,137,137,5,5,0,1,0
2,152,152,2,2,0,1,0
7,171,171,8,8,0,1,0
1,197,197,3,3,0,1,0
8,342,342,34,34,0,1,0
3,376,376,15,3,12,3,2
6,405,405,100,16,84,4,3
10,475,475,145,97,48,4,3
0,483,483,35,26,9,2,1
9,497,497,27,15,12,3,2

4,104,104,10,10,0,1,0
2,131,131,8,8,0,1,0
6,221,221,49,19,30,3,2
9,247,247,45,45,0,1,0
7,290,290,73,53,20,4,3
3,314,314,11,6,5,2,1
8,403,403,3,3,0,1,0
5,414,414,13,3,10,3,2
10,467,467,30,7,23,3,2
0,477,477,27,7,20,3,2
1,481,481,1,1,0,1,0

7,182,182,5,5,0,1,0
4,185,185,9,6,3,2,1
3,196,196,6,6,0,1,0
12,205,205,43,15,28,3,2
6,215,215,4,1,3,2,1
9,227,227,11,11,0,1,0
10,264,264,25,25,0,1,0
8,274,274,15,15,0,1,0
0,359,359,24,16,8,2,1
2,392,392,19,1,18,2,1
1,416,416,55,55,0,1,0
11,442,442,68,2,66,3,2
5,467,467,35,10,25,4,3

0,119,119,14,4,10,2,1
3,125,125,9,1,8,3,2
4,167,167,40,40,0,1,0
2,172,172,16,6,10,2,1
1,173,173,38,12,26,2,1
5,176,176,16,6,10,2,1
6,457,457,44,44,0,1,0
7,495,495,42,15,27,2,1

3,134,134,1,1,0,1,0
8,142,142,2,2,0,1,0
9,158,158,14,8,6,3,2
1,181,181,1,1,0,1,0
4,216,216,14,2,12,3,2
2,220,220,8,8,0,1,0
7,330,330,47,47,0,1,0
5,355,355,137,137,0,1,0
0,475,475,1,1,0,1,0
6,491,491,133,91,42,4,3

6,143,143,1,1,0,1,0
10,285,285,9,9,0,1,0
11,288,288,4,1,3,2,1
7,291,291,1,1,0,1,0
4,297,297,7,2,5,2,1
8,313,313,27,27,0,1,0
3,386,386,18,18,0,1,0
5,395,395,11,5,6,2,1
2,400,400,5,5,0,1,0
14,404,404,13,13,0,1,0
9,432,432,107,107,0,1,0
13,439,439,69,69,0,1,0
12,450,450,136,42,94,3,2
1,452,452,4,4,0,1,0
0,491,491,4,1,3,2,1

0,144,144,6,3,3,2,1
12,168,168,23,23,0,1,0
8,173,173,5,5,0,1,0
3,200,200,25,25,0,1,0
13,205,205,20,8,12,4,3
14,209,209,47,35,12,2,1
10,217,217,1,1,0,1,0
6,267,267,16,16,0,1,0
11,273,273,6,6,0,1,0
15,282,282,14,9,5,2,1
4,331,331,11,11,0,1,0
7,348,348,16,16,0,1,0
1,352,352,12,3,9,2,1
9,440,440,31,10,21,2,1
2,445,445,9,9,0,1,0
5,457,457,7,7,0,1,0

1,100,100,9,9,0,1,0
2,126,126,1,1,0,1,0
10,166,166,14,14,0,1,0
9,187,187,42,42,0,1,0
6,206,206,13,9,4,2,1
4,252,252,20,20,0,1,0
8,297,297,58,58,0,1,0
0,324,324,9,1,8,3,2
5,333,333,73,7,66,3,2
7,338,338,2,2,0,1,0
3,387,387,5,5,0,1,0

3,120,120,8,5,3,2,1
10,230,230,47,33,14,3,2
9,256,256,19,19,0,1,0
1,291,291,1,1,0,1,0
7,298,298,21,7,14,2,1
11,310,310,67,67,0,1,0
6,320,320,17,17,0,1,0
4,329,329,6,2,4,2,1
5,343,343,63,63,0,1,0
0,385,385,4,4,0,1,0
2,433,433,27,27,0,1,0
8,440,440,14,2,12,2,1
12,500,500,7,7,0,1,0

4,105,105,7,4,3,2,1
9,122,122,26,8,18,3,2
10,143,143,12,2,10,2,1
1,168,168,2,2,0,1,0
0,187,187,6,6,0,1,0
3,199,199,8,3,5,2,1
2,250,250,18,18,0,1,0
6,327,327,60,60,0,1,0
8,380,380,63,18,45,4,3
7,425,425,18,15,3,2,1
5,456,456,44,32,12,4,3

3,110,110,25,13,12,3,2
7,226,226,34,34,0,1,0
1,310,310,25,25,0,1,0
5,313,313,72,72,0,1,0
2,338,338,32,32,0,1,0
6,376,376,27,20,7,2,1
4,393,393,21,3,18,3,2
0,408,408,42,8,34,4,3

1,199,199,1,1,0,1,0
2,246,246,10,1,9,4,3
8,249,249,17,2,15,2,1
5,299,299,3,3,0,1,0
7,307,307,4,4,0,1,0
9,322,322,42,33,9,4,3
3,341,341,30,14,16,2,1
0,395,395,103,13,90,4,3
6,425,425,126,50,76,4,3
4,478,478,46,46,0,1,0

0,121,121,4,4,0,1,0
7,170,170,50,50,0,1,0
3,219,219,29,20,9,4,3
2,232,232,56,12,44,3,2
1,256,256,24,24,0,1,0
6,414,414,75,75,0,1,0
5,469,469,1,1,0,1,0
4,496,496,13,1,12,4,3

11,137,137,14,6,8,2,1
12,150,150,27,27,0,1,0
10,198,198,6,1,5,2,1
8,204,204,1,1,0,1,0
6,248,248,6,6,0,1,0
4,265,265,10,3,7,2,1
13,270,270,54,54,0,1,0
5,307,307,1,1,0,1,0
9,310,310,57,14,43,2,1
3,332,332,2,2,0,1,0
7,356,356,5,5,0,1,0
0,374,374,18,18,0,1,0
2,380,380,29,12,17,3,2
1,392,392,40,40,0,1,0

7,153,153,4,4,0,1,0
2,164,164,28,28,0,1,0
4,224,224,7,4,3,2,1
1,232,232,7,7,0,1,0
5,234,234,10,10,0,1,0
3,268,268,11,11,0,1,0
0,312,312,72,72,0,1,0
6,423,423,50,50,0,1,0
8,455,455,146,8,138,4,3

1,125,125,7,7,0,1,0
3,136,136,14,3,11,2,1
0,158,158,1,1,0,1,0
10,205,205,4,4,0,1,0
9,209,209,36,36,0,1,0
4,229,229,1,1,0,1,0
2,366,366,65,65,0,1,0
6,371,371,6,6,0,1,0
7,427,427,43,43,0,1,0
5,439,439,61,21,40,2,1
8,459,459,98,10,88,3,2

8,111,111,1,1,0,1,0
9,122,122,10,10,0,1,0
1,174,174,14,2,12,3,2
10,178,178,10,10,0,1,0
5,204,204,34,34,0,1,0
2,265,265,7,7,0,1,0
7,287,287,104,104,0,1,0
4,333,333,43,43,0,1,0
6,454,454,2,2,0,1,0
3,468,468,21,21,0,1,0
0,472,472,23,11,12,2,1

3,145,145,24,24,0,1,0
5,212,212,31,13,18,3,2
7,278,278,28,14,14,4,3
6,305,305,68,68,0,1,0
0,403,403,54,54,0,1,0
1,433,433,36,36,0,1,0
4,461,461,18,18,0,1,0
2,470,470,56,38,18,2,1

5,245,245,3,3,0,1,0
1,389,389,100,73,27,2,1
0,421,421,67,24,43,4,3
3,454,454,19,3,16,2,1
6,461,461,202,133,69,3,2
2,478,478,41,3,38,3,2
4,497,497,7,7,0,1,0

7,121,121,10,4,6,3,2
1,148,148,4,4,0,1,0
6,158,158,2,2,0,1,0
10,186,186,11,7,4,2,1
9,282,282,74,74,0,1,0
3,285,285,4,4,0,1,0
4,287,287,50,24,26,3,2
2,394,394,20,12,8,3,2
5,394,394,48,11,37,4,3
8,432,432,47,7,40,3,2
0,437,437,44,6,38,2,1

5,174,174,2,2,0,1,0
1,207,207,44,44,0,1,0
6,258,258,47,5,42,4,3
4,265,265,37,37,0,1,0
8,320,320,34,10,24,2,1
0,329,329,16,16,0,1,0
7,374,374,70,38,32,2,1
2,426,426,12,3,9,2,1
3,435,435,28,5,23,2,1
9,464,464,14,3,11,2,1

4,145,145,11,11,0,1,0
7,151,151,11,11,0,1,0
2,153,153,17,17,0,1,0
6,167,167,11,11,0,1,0
1,196,196,9,3,6,2,1
0,307,307,7,7,0,1,0
3,345,345,17,17,0,1,0
9,367,367,56,56,0,1,0
10,382,382,9,9,0,1,0
5,416,416,24,3,21,2,1
11,423,423,90,90,0,1,0
8,500,500,59,59,0,1,0

4,150,150,23,8,15,4,3
1,250,250,24,24,0,1,0
8,251,251,17,17,0,1,0
2,310,310,19,19,0,1,0
3,345,345,27,9,18,2,1
0,399,399,46,19,27,4,3
5,418,418,5,5,0,1,0
6,430,430,149,76,73,4,3
7,444,444,34,34,0,1,0

8,120,120,12,12,0,1,0
4,154,154,42,24,18,3,2
0,170,170,1,1,0,1,0
3,277,277,25,7,18,3,2
9,279,279,28,28,0,1,0
5,297,297,19,19,0,1,0
10,323,323,5,5,0,1,0
1,357,357,14,8,6,2,1
7,404,404,119,116,3,2,1
2,451,451,5,5,0,1,0
6,462,462,8,8,0,1,0

9,147,147,1,1,0,1,0
10,147,147,29,3,26,3,2
1,224,224,15,15,0,1,0
4,246,246,15,5,10,2,1
3,257,257,21,1,20,3,2
7,285,285,67,67,0,1,0
5,322,322,7,2,5,2,1
8,437,437,33,2,31,2,1
6,453,453,74,74,0,1,0
0,464,464,48,33,15,4,3
2,475,475,1,1,0,1,0

11,196,196,10,10,0,1,0
0,214,214,8,4,4,2,1
6,285,285,20,10,10,3,2
4,303,303,1,1,0,1,0
3,328,328,8,5,3,2,1
9,329,329,54,23,31,2,1
2,357,357,13,1,12,3,2
5,400,400,62,5,57,4,3
10,438,438,21,3,18,2,1
1,443,443,44,2,42,3,2
8,453,453,110,30,80,3,2
7,477,477,36,15,21,4,3

6,109,109,7,7,0,1,0
10,122,122,17,1,16,3,2
0,137,137,3,3,0,1,0
4,186,186,9,9,0,1,0
5,187,187,4,4,0,1,0
2,190,190,1,1,0,1,0
1,273,273,4,4,0,1,0
9,352,352,88,20,68,3,2
7,398,398,45,45,0,1,0
3,413,413,88,35,53,3,2
8,424,424,14,8,6,3,2
11,468,468,42,42,0,1,0

6,180,180,7,4,3,2,1
2,221,221,38,10,28,3,2
7,246,246,24,24,0,1,0
0,328,328,11,11,0,1,0
10,361,361,29,29,0,1,0
5,417,417,16,11,5,2,1
3,438,438,13,4,9,4,3
9,440,440,74,74,0,1,0
11,458,458,61,61,0,1,0
8,472,472,59,59,0,1,0
1,491,491,28,28,0,1,0
4,498,498,17,9,8,3,2

4,107,107,4,4,0,1,0
8,121,121,15,6,9,2,1
5,129,129,3,3,0,1,0
13,159,159,9,9,0,1,0
11,168,168,40,40,0,1,0
9,211,211,7,1,6,2,1
7,296,296,6,6,0,1,0
3,326,326,1,1,0,1,0
2,333,333,14,14,0,1,0
6,344,344,21,21,0,1,0
12,378,378,75,75,0,1,0
0,410,410,55,42,13,2,1
10,481,481,7,7,0,1,0
1,500,500,13,6,7,2,1

6,186,186,14,14,0,1,0
3,224,224,58,58,0,1,0
2,252,252,8,8,0,1,0
1,292,292,5,5,0,1,0
8,310,310,80,56,24,4,3
7,314,314,33,33,0,1,0
4,334,334,27,27,0,1,0
9,351,351,24,4,20,3,2
0,395,395,10,10,0,1,0
5,431,431,38,19,19,2,1

2,153,153,2,2,0,1,0
5,169,169,70,28,42,2,1
4,172,172,9,3,6,3,2
1,192,192,32,32,0,1,0
3,212,212,5,1,4,2,1
0,486,486,162,116,46,3,2

6,183,183,9,3,6,3,2
4,314,314,1,1,0,1,0
7,354,354,65,33,32,2,1
1,378,378,2,2,0,1,0
2,404,404,115,66,49,3,2
0,423,423,29,29,0,1,0
3,427,427,60,12,48,2,1
5,427,427,87,39,48,4,3
8,438,438,31,9,22,3,2

8,188,188,50,50,0,1,0
10,221,221,2,2,0,1,0
4,241,241,28,28,0,1,0
1,274,274,31,2,29,3,2
5,292,292,49,26,23,2,1
6,312,312,8,8,0,1,0
9,340,340,41,2,39,3,2
0,354,354,1,1,0,1,0
3,413,413,18,4,14,3,2
2,449,449,14,2,12,4,3
7,477,477,53,26,27,4,3

9,130,130,43,10,33,4,3
8,139,139,1,1,0,1,0
10,141,141,3,3,0,1,0
0,200,200,4,4,0,1,0
6,214,214,9,9,0,1,0
4,313,313,97,40,57,4,3
3,319,319,22,8,14,3,2
2,370,370,11,11,0,1,0
1,411,411,2,2,0,1,0
7,440,440,67,1,66,3,2
5,455,455,13,3,10,3,2

6,115,115,1,1,0,1,0
5,142,142,52,52,0,1,0
0,202,202,95,95,0,1,0
3,309,309,12,12,0,1,0
1,332,332,3,3,0,1,0
4,474,474,45,45,0,1,0
2,482,482,10,2,8,2,1

5,122,122,20,20,0,1,0
8,144,144,16,16,0,1,0
7,221,221,15,5,10,2,1
0,236,236,16,4,12,3,2
2,305,305,20,11,9,2,1
4,335,335,38,38,0,1,0
6,353,353,57,57,0,1,0
1,373,373,76,33,43,4,3
3,418,418,21,18,3,2,1

3,101,101,14,14,0,1,0
7,107,107,2,2,0,1,0
8,120,120,42,42,0,1,0
4,164,164,3,3,0,1,0
11,195,195,1,1,0,1,0
10,283,283,18,18,0,1,0
5,286,286,3,3,0,1,0
1,299,299,48,24,24,2,1
2,316,316,27,1,26,3,2
9,351,351,31,31,0,1,0
0,379,379,11,11,0,1,0
6,484,484,23,7,16,3,2

5,175,175,3,3,0,1,0
7,210,210,35,19,16,2,1
1,235,235,49,4,45,3,2
4,276,276,23,23,0,1,0
2,306,306,30,23,7,2,1
8,351,351,16,4,12,4,3
0,354,354,11,11,0,1,0
9,357,357,6,6,0,1,0
3,363,363,24,4,20,3,2
6,446,446,124,124,0,1,0

7,138,138,15,15,0,1,0
4,205,205,7,4,3,2,1
1,281,281,66,13,53,4,3
2,284,284,39,39,0,1,0
5,294,294,37,37,0,1,0
6,298,298,14,6,8,2,1
3,313,313,8,8,0,1,0
0,347,347,24,24,0,1,0
8,364,364,84,74,10,4,3

8,119,119,27,15,12,4,3
10,119,119,9,9,0,1,0
2,145,145,16,7,9,4,3
0,166,166,25,1,24,3,2
6,222,222,18,15,3,2,1
1,240,240,3,3,0,1,0
11,254,254,2,2,0,1,0
7,261,261,14,9,5,2,1
3,272,272,10,3,7,2,1
9,282,282,57,43,14,2,1
4,410,410,19,19,0,1,0
5,466,466,5,5,0,1,0

7,113,113,12,12,0,1,0
11,143,143,30,15,15,4,3
10,270,270,25,11,14,2,1
9,323,323,39,9,30,3,2
6,349,349,30,1,29,2,1
3,362,362,4,4,0,1,0
1,368,368,21,7,14,2,1
5,422,422,2,2,0,1,0
8,430,430,34,1,33,4,3
2,486,486,38,21,17,2,1
0,488,488,5,5,0,1,0
4,488,488,73,32,41,2,1

4,109,109,1,1,0,1,0
0,137,137,8,8,0,1,0
6,181,181,21,21,0,1,0
3,267,267,53,53,0,1,0
1,305,305,28,13,15,4,3
5,320,320,94,94,0,1,0
2,382,382,58,58,0,1,0
7,441,441,39,4,35,4,3

1,109,109,3,3,0,1,0
4,313,313,104,22,82,4,3
0,322,322,154,25,129,4,3
3,357,357,23,23,0,1,0
5,389,389,38,8,30,4,3
2,407,407,5,5,0,1,0

3,116,116,7,4,3,2,1
2,119,119,13,13,0,1,0
5,155,155,6,6,0,1,0
8,263,263,2,2,0,1,0
6,341,341,47,41,6,3,2
9,374,374,9,9,0,1,0
4,407,407,9,1,8,2,1
1,440,440,97,97,0,1,0
7,464,464,157,31,126,4,3
0,478,478,26,17,9,4,3

5,169,169,34,1,33,2,1
7,264,264,50,42,8,3,2
4,275,275,23,8,15,2,1
1,307,307,105,51,54,3,2
2,308,308,1,1,0,1,0
0,313,313,31,31,0,1,0
6,417,417,14,14,0,1,0
3,425,425,24,18,6,3,2

12,113,113,3,3,0,1,0
2,127,127,14,6,8,2,1
5,150,150,1,1,0,1,0
9,180,180,6,6,0,1,0
13,242,242,3,3,0,1,0
7,265,265,8,8,0,1,0
6,279,279,9,9,0,1,0
10,301,301,113,4,109,4,3
4,306,306,20,20,0,1,0
3,327,327,12,12,0,1,0
0,337,337,26,10,16,4,3
8,392,392,13,13,0,1,0
11,431,431,40,32,8,3,2
1,499,499,39,39,0,1,0

11,142,142,23,23,0,1,0
3,172,172,1,1,0,1,0
9,173,173,29,29,0,1,0
5,213,213,5,5,0,1,0
4,247,247,30,3,27,2,1
8,255,255,22,22,0,1,0
1,268,268,7,1,6,3,2
6,271,271,3,3,0,1,0
12,372,372,22,5,17,2,1
0,402,402,46,46,0,1,0
2,441,441,20,6,14,2,1
7,446,446,31,31,0,1,0
10,469,469,55,24,31,2,1

2,132,132,19,19,0,1,0
8,144,144,3,3,0,1,0
1,180,180,23,11,12,2,1
4,206,206,17,17,0,1,0
0,209,209,7,7,0,1,0
6,217,217,54,13,41,3,2
3,311,311,32,32,0,1,0
9,323,323,36,36,0,1,0
5,365,365,4,4,0,1,0
7,427,427,55,55,0,1,0

4,130,130,1,1,0,1,0
10,148,148,49,28,21,4,3
7,156,156,15,15,0,1,0
6,165,165,8,8,0,1,0
5,184,184,27,27,0,1,0
1,196,196,9,4,5,2,1
2,269,269,9,5,4,2,1
0,284,284,29,11,18,4,3
8,291,291,15,8,7,2,1
9,464,464,14,14,0,1,0
3,472,472,56,56,0,1,0

8,113,113,19,7,12,3,2
2,120,120,1,1,0,1,0
5,122,122,29,17,12,4,3
3,137,137,8,8,0,1,0
7,259,259,20,20,0,1,0
6,379,379,12,2,10,2,1
0,436,436,64,64,0,1,0
4,447,447,56,56,0,1,0
1,466,466,76,51,25,2,1

5,101,101,6,6,0,1,0
4,165,165,16,1,15,4,3
6,182,182,3,3,0,1,0
0,196,196,37,23,14,2,1
11,205,205,37,37,0,1,0
7,235,235,2,2,0,1,0
1,332,332,23,23,0,1,0
2,333,333,14,4,10,3,2
8,402,402,24,24,0,1,0
3,459,459,9,9,0,1,0
10,462,462,65,65,0,1,0
9,499,499,63,63,0,1,0

2,169,169,29,29,0,1,0
1,173,173,23,23,0,1,0
0,177,177,5,5,0,1,0
8,213,213,10,10,0,1,0
6,339,339,11,3,8,2,1
5,352,352,32,1,31,2,1
7,376,376,52,10,42,3,2
9,380,380,110,110,0,1,0
4,406,406,2,2,0,1,0
3,485,485,35,35,0,1,0

5,183,183,52,28,24,2,1
7,215,215,9,4,5,2,1
1,245,245,15,3,12,4,3
0,249,249,11,11,0,1,0
4,273,273,56,20,36,2,1
6,430,430,28,16,12,2,1
2,445,445,57,57,0,1,0
8,458,458,53,49,4,2,1
3,499,499,31,31,0,1,0

7,162,162,1,1,0,1,0
9,188,188,19,7,12,2,1
8,198,198,38,11,27,4,3
6,218,218,19,2,17,2,1
2,244,244,13,1,12,3,2
1,257,257,21,21,0,1,0
4,287,287,11,11,0,1,0
3,289,289,12,12,0,1,0
5,385,385,4,4,0,1,0
11,389,389,48,6,42,4,3
0,430,430,79,15,64,3,2
10,442,442,41,41,0,1,0

5,127,127,31,31,0,1,0
0,237,237,31,31,0,1,0
3,265,265,1,1,0,1,0
7,319,319,49,49,0,1,0
1,337,337,6,6,0,1,0
9,365,365,96,96,0,1,0
2,387,387,12,2,10,3,2
6,391,391,26,8,18,2,1
8,427,427,10,10,0,1,0
4,430,430,32,9,23,2,1

1,119,119,20,10,10,3,2
3,164,164,57,1,56,4,3
5,219,219,29,13,16,3,2
2,280,280,55,4,51,3,2
0,329,329,45,45,0,1,0
4,393,393,9,3,6,3,2
6,409,409,2,2,0,1,0

3,120,120,22,7,15,2,1
11,136,136,17,17,0,1,0
1,160,160,17,17,0,1,0
2,163,163,2,2,0,1,0
5,232,232,9,9,0,1,0
8,261,261,25,25,0,1,0
0,272,272,2,2,0,1,0
10,317,317,74,24,50,2,1
7,353,353,3,3,0,1,0
9,373,373,20,20,0,1,0
6,431,431,23,7,16,2,1
4,444,444,41,41,0,1,0

1,173,173,26,1,25,2,1
0,211,211,31,31,0,1,0
2,253,253,52,52,0,1,0
5,285,285,24,24,0,1,0
6,408,408,25,4,21,4,3
3,467,467,120,120,0,1,0
4,474,474,50,22,28,3,2

6,177,177,49,33,16,2,1
8,235,235,19,19,0,1,0
3,257,257,19,5,14,2,1
7,282,282,6,6,0,1,0
5,292,292,14,8,6,2,1
2,328,328,13,6,7,2,1
1,392,392,1,1,0,1,0
4,408,408,83,8,75,4,3
0,452,452,60,12,48,3,2
9,479,479,63,33,30,3,2

4,127,127,14,14,0,1,0
0,134,134,4,4,0,1,0
7,168,168,10,10,0,1,0
1,187,187,38,38,0,1,0
3,213,213,18,9,9,2,1
5,219,219,68,68,0,1,0
2,318,318,24,9,15,4,3
6,327,327,41,23,18,2,1
8,471,471,4,4,0,1,0

3,149,149,24,24,0,1,0
1,189,189,6,6,0,1,0
6,265,265,2,2,0,1,0
5,370,370,12,12,0,1,0
2,392,392,71,71,0,1,0
0,411,411,52,52,0,1,0
4,423,423,36,6,30,3,2
7,447,447,171,118,53,4,3

9,111,111,4,4,0,1,0
0,122,122,6,2,4,2,1
10,126,126,10,10,0,1,0
2,182,182,1,1,0,1,0
7,184,184,1,1,0,1,0
12,189,189,47,9,38,2,1
3,191,191,2,2,0,1,0
5,208,208,7,1,6,3,2
8,299,299,100,34,66,3,2
4,347,347,2,2,0,1,0
6,371,371,5,5,0,1,0
13,417,417,16,16,0,1,0
11,484,484,68,50,18,2,1
1,493,493,6,6,0,1,0

0,162,162,17,17,0,1,0
8,213,213,49,11,38,2,1
2,215,215,8,8,0,1,0
6,332,332,9,9,0,1,0
7,376,376,6,6,0,1,0
1,391,391,4,4,0,1,0
5,441,441,104,104,0,1,0
4,449,449,8,8,0,1,0
3,475,475,157,19,138,4,3

8,207,207,34,22,12,3,2
6,255,255,6,6,0,1,0
2,355,355,45,45,0,1,0
7,367,367,11,5,6,2,1
0,402,402,51,14,37,2,1
1,435,435,28,28,0,1,0
5,443,443,128,93,35,2,1
4,480,480,83,83,0,1,0
3,481,481,5,1,4,2,1

2,129,129,3,3,0,1,0
12,129,129,9,9,0,1,0
7,157,157,1,1,0,1,0
6,181,181,4,1,3,2,1
3,185,185,14,14,0,1,0
10,227,227,42,42,0,1,0
5,271,271,16,9,7,2,1
11,283,283,25,7,18,2,1
0,303,303,30,3,27,4,3
9,335,335,19,19,0,1,0
1,428,428,1,1,0,1,0
8,445,445,22,22,0,1,0
4,485,485,52,52,0,1,0
13,487,487,80,80,0,1,0

2,129,129,4,1,3,2,1
0,138,138,3,3,0,1,0
4,185,185,2,2,0,1,0
10,251,251,7,7,0,1,0
5,282,282,38,38,0,1,0
3,308,308,40,40,0,1,0
8,331,331,9,9,0,1,0
11,394,394,170,82,88,4,3
9,414,414,8,2,6,3,2
6,415,415,44,24,20,2,1
7,425,425,15,15,0,1,0
1,465,465,15,15,0,1,0

7,166,166,40,40,0,1,0
5,287,287,42,6,36,3,2
3,324,324,64,43,21,2,1
1,360,360,41,41,0,1,0
6,365,365,23,11,12,4,3
4,403,403,24,2,22,3,2
2,465,465,35,35,0,1,0
0,487,487,56,35,21,4,3

1,125,125,8,8,0,1,0
8,162,162,35,35,0,1,0
7,188,188,6,6,0,1,0
6,229,229,13,13,0,1,0
2,236,236,13,13,0,1,0
9,321,321,77,59,18,4,3
3,406,406,25,9,16,2,1
10,412,412,10,10,0,1,0
5,426,426,25,25,0,1,0
4,449,449,86,86,0,1,0
0,485,485,8,8,0,1,0

1,156,156,1,1,0,1,0
6,183,183,6,6,0,1,0
7,244,244,10,10,0,1,0
5,303,303,102,42,60,4,3
3,316,316,21,13,8,2,1
0,333,333,43,43,0,1,0
2,342,342,102,102,0,1,0
4,470,470,44,1,43,4,3

0,134,134,8,8,0,1,0
4,146,146,13,10,3,2,1
1,163,163,25,25,0,1,0
8,267,267,5,2,3,2,1
9,349,349,93,69,24,4,3
2,356,356,31,3,28,2,1
5,398,398,11,3,8,3,2
6,424,424,66,36,30,4,3
7,432,432,28,28,0,1,0
3,473,473,40,40,0,1,0

4,117,117,9,9,0,1,0
5,228,228,36,12,24,2,1
6,237,237,55,25,30,3,2
1,258,258,14,3,11,4,3
0,307,307,88,88,0,1,0
3,344,344,34,34,0,1,0
7,382,382,16,16,0,1,0
2,465,465,29,29,0,1,0

4,108,108,13,3,10,2,1
0,175,175,30,6,24,2,1
1,280,280,42,6,36,3,2
3,287,287,25,25,0,1,0
6,304,304,43,43,0,1,0
2,392,392,36,6,30,3,2
5,416,416,88,88,0,1,0
7,443,443,17,1,16,3,2

7,159,159,16,1,15,4,3
6,231,231,26,5,21,4,3
2,251,251,46,46,0,1,0
0,309,309,23,8,15,2,1
4,312,312,91,91,0,1,0
3,364,364,47,47,0,1,0
1,377,377,43,17,26,3,2
5,436,436,1,1,0,1,0

7,101,101,1,1,0,1,0
2,141,141,4,4,0,1,0
10,145,145,20,20,0,1,0
13,161,161,6,6,0,1,0
5,187,187,5,5,0,1,0
0,268,268,1,1,0,1,0
11,287,287,11,11,0,1,0
1,321,321,1,1,0,1,0
9,350,350,32,32,0,1,0
6,356,356,23,23,0,1,0
8,376,376,23,23,0,1,0
3,382,382,28,28,0,1,0
14,412,412,29,16,13,4,3
4,429,429,2,2,0,1,0
12,480,480,172,92,80,3,2

2,249,249,15,6,9,4,3
9,272,272,20,20,0,1,0
7,276,276,38,23,15,2,1
3,295,295,91,14,77,4,3
5,301,301,15,15,0,1,0
1,315,315,1,1,0,1,0
4,340,340,10,10,0,1,0
0,441,441,22,22,0,1,0
6,455,455,107,72,35,2,1
8,498,498,29,3,26,3,2

6,104,104,14,14,0,1,0
2,123,123,3,3,0,1,0
10,170,170,29,29,0,1,0
7,174,174,21,13,8,3,2
5,221,221,4,4,0,1,0
1,354,354,18,18,0,1,0
3,371,371,32,32,0,1,0
0,408,408,36,30,6,2,1
8,427,427,65,40,25,2,1
4,451,451,44,34,10,3,2
9,451,451,31,31,0,1,0

1,129,129,63,63,0,1,0
0,171,171,2,2,0,1,0
4,371,371,50,29,21,2,1
5,423,423,76,32,44,4,3
3,483,483,78,74,4,2,1
2,487,487,15,9,6,3,2

5,149,149,6,6,0,1,0
3,166,166,4,4,0,1,0
11,179,179,18,18,0,1,0
7,242,242,4,4,0,1,0
13,243,243,46,46,0,1,0
2,246,246,18,6,12,3,2
9,274,274,4,4,0,1,0
10,315,315,22,22,0,1,0
4,359,359,27,27,0,1,0
14,379,379,32,14,18,4,3
0,385,385,1,1,0,1,0
6,410,410,5,5,0,1,0
12,410,410,54,54,0,1,0
1,429,429,54,12,42,4,3
8,460,460,21,21,0,1,0

6,124,124,4,1,3,2,1
2,134,134,9,9,0,1,0
4,145,145,10,10,0,1,0
7,158,158,5,5,0,1,0
0,164,164,3,3,0,1,0
9,327,327,55,7,48,2,1
11,371,371,19,2,17,4,3
3,396,396,13,13,0,1,0
8,425,425,1,1,0,1,0
10,431,431,122,80,42,4,3
5,432,432,73,44,29,2,1
1,446,446,37,37,0,1,0

0,104,104,5,5,0,1,0
9,129,129,42,42,0,1,0
12,229,229,13,13,0,1,0
2,248,248,2,2,0,1,0
8,295,295,14,4,10,2,1
6,300,300,2,2,0,1,0
3,336,336,46,46,0,1,0
7,339,339,3,3,0,1,0
1,340,340,37,3,34,3,2
10,374,374,38,38,0,1,0
5,380,380,21,8,13,4,3
4,445,445,36,36,0,1,0
11,487,487,11,11,0,1,0

3,250,250,5,5,0,1,0
6,320,320,49,49,0,1,0
2,357,357,2,2,0,1,0
4,418,418,48,48,0,1,0
7,439,439,50,50,0,1,0
0,464,464,17,14,3,2,1
5,465,465,58,7,51,4,3
1,474,474,209,209,0,1,0

0,161,161,62,20,42,3,2
5,224,224,12,1,11,3,2
4,277,277,40,40,0,1,0
2,299,299,31,6,25,4,3
3,425,425,37,37,0,1,0
1,443,443,5,5,0,1,0
6,455,455,100,70,30,3,2

6,160,160,17,17,0,1,0
5,206,206,5,5,0,1,0
7,246,246,59,59,0,1,0
0,270,270,79,34,45,2,1
8,284,284,45,27,18,3,2
2,355,355,24,24,0,1,0
3,425,425,1,1,0,1,0
1,429,429,42,42,0,1,0
4,474,474,9,9,0,1,0
9,474,474,2,2,0,1,0

5,123,123,17,17,0,1,0
1,131,131,21,21,0,1,0
3,153,153,9,9,0,1,0
0,218,218,16,16,0,1,0
2,277,277,74,74,0,1,0
4,329,329,88,64,24,4,3
6,422,422,19,15,4,2,1

7,101,101,21,21,0,1,0
0,192,192,58,37,21,2,1
2,257,257,31,31,0,1,0
3,271,271,21,7,14,2,1
6,291,291,40,40,0,1,0
5,333,333,46,36,10,3,2
4,357,357,9,9,0,1,0
1,494,494,1,1,0,1,0

5,152,152,3,3,0,1,0
2,187,187,10,10,0,1,0
10,224,224,9,1,8,3,2
1,261,261,28,28,0,1,0
6,268,268,1,1,0,1,0
4,330,330,16,8,8,2,1
9,350,350,35,3,32,2,1
3,441,441,1,1,0,1,0
7,447,447,108,108,0,1,0
11,447,447,34,34,0,1,0
0,457,457,11,2,9,4,3
8,464,464,135,78,57,4,3

5,130,130,12,8,4,2,1
0,160,160,2,2,0,1,0
3,198,198,14,7,7,2,1
6,225,225,20,20,0,1,0
1,277,277,12,12,0,1,0
9,281,281,6,6,0,1,0
4,350,350,21,21,0,1,0
7,438,438,45,23,22,3,2
8,439,439,39,39,0,1,0
10,472,472,138,123,15,4,3
2,491,491,67,25,42,2,1

0,265,265,20,20,0,1,0
2,338,338,51,5,46,3,2
3,351,351,7,7,0,1,0
5,434,434,49,49,0,1,0
6,435,435,36,36,0,1,0
1,440,440,121,10,111,4,3
4,448,448,130,85,45,4,3

4,151,151,1,1,0,1,0
0,152,152,4,1,3,2,1
11,165,165,33,33,0,1,0
7,180,180,11,11,0,1,0
10,204,204,14,2,12,3,2
1,209,209,17,17,0,1,0
8,307,307,74,29,45,2,1
6,308,308,59,59,0,1,0
5,359,359,24,24,0,1,0
9,373,373,1,1,0,1,0
2,394,394,18,2,16,3,2
3,476,476,12,6,6,3,2

7,105,105,3,3,0,1,0
1,122,122,5,5,0,1,0
10,124,124,1,1,0,1,0
9,150,150,3,3,0,1,0
12,214,214,6,6,0,1,0
11,295,295,7,1,6,2,1
13,302,302,48,22,26,3,2
4,359,359,31,31,0,1,0
6,387,387,14,14,0,1,0
2,388,388,7,1,6,3,2
3,401,401,15,6,9,2,1
14,419,419,3,3,0,1,0
0,459,459,19,1,18,3,2
16,461,461,56,41,15,4,3
5,472,472,57,33,24,4,3
8,481,481,7,2,5,2,1
15,499,499,108,108,0,1,0

11,104,104,22,22,0,1,0
8,115,115,6,3,3,2,1
2,124,124,1,1,0,1,0
5,204,204,10,4,6,3,2
12,220,220,22,5,17,2,1
4,386,386,77,71,6,2,1
13,391,391,19,19,0,1,0
9,411,411,6,2,4,2,1
1,412,412,8,1,7,2,1
10,413,413,61,56,5,2,1
7,427,427,34,2,32,3,2
6,448,448,19,19,0,1,0
3,462,462,5,5,0,1,0
0,486,486,12,6,6,2,1

8,132,132,4,4,0,1,0
12,136,136,12,1,11,3,2
9,198,198,3,3,0,1,0
1,260,260,8,3,5,2,1
7,315,315,28,28,0,1,0
2,341,341,5,5,0,1,0
4,342,342,17,17,0,1,0
11,349,349,55,10,45,4,3
6,421,421,86,44,42,3,2
0,452,452,1,1,0,1,0
10,482,482,120,23,97,4,3
5,483,483,18,18,0,1,0
3,497,497,22,22,0,1,0

5,134,134,3,3,0,1,0
7,187,187,46,46,0,1,0
4,195,195,20,12,8,2,1
6,332,332,47,47,0,1,0
2,349,349,87,59,28,2,1
0,466,466,67,56,11,2,1
1,496,496,13,13,0,1,0
3,498,498,41,10,31,2,1

2,260,260,5,5,0,1,0
1,278,278,37,24,13,2,1
0,303,303,31,31,0,1,0
3,305,305,63,63,0,1,0
7,343,343,41,41,0,1,0
8,409,409,66,66,0,1,0
5,436,436,21,21,0,1,0
6,436,436,76,76,0,1,0
4,467,467,19,19,0,1,0

3,116,116,11,4,7,2,1
0,129,129,38,38,0,1,0
5,195,195,4,4,0,1,0
6,288,288,105,81,24,3,2
4,356,356,10,3,7,2,1
1,377,377,5,2,3,2,1
2,481,481,93,93,0,1,0

10,105,105,5,5,0,1,0
11,140,140,43,43,0,1,0
2,147,147,24,12,12,3,2
6,150,150,9,9,0,1,0
9,285,285,13,7,6,3,2
4,323,323,13,3,10,2,1
12,325,325,37,37,0,1,0
8,418,418,10,10,0,1,0
5,421,421,1,1,0,1,0
7,433,433,8,8,0,1,0
0,443,443,54,21,33,2,1
3,466,466,25,15,10,3,2
1,493,493,8,8,0,1,0

0,134,134,8,8,0,1,0
2,137,137,33,11,22,2,1
7,198,198,36,36,0,1,0
3,201,201,14,14,0,1,0
1,247,247,33,15,18,4,3
6,311,311,67,8,59,4,3
4,315,315,13,13,0,1,0
5,420,420,28,28,0,1,0

2,131,131,1,1,0,1,0
6,153,153,11,11,0,1,0
5,173,173,8,1,7,2,1
9,348,348,17,17,0,1,0
0,387,387,61,61,0,1,0
1,390,390,70,57,13,2,1
3,440,440,27,27,0,1,0
4,443,443,23,23,0,1,0
8,450,450,59,59,0,1,0
7,498,498,128,128,0,1,0

5,118,118,9,9,0,1,0
6,150,150,8,8,0,1,0
2,334,334,55,6,49,2,1
0,344,344,1,1,0,1,0
3,346,346,12,3,9,4,3
7,355,355,29,9,20,3,2
1,378,378,2,2,0,1,0
4,386,386,113,113,0,1,0
8,439,439,133,100,33,4,3

1,114,114,2,2,0,1,0
0,126,126,5,5,0,1,0
8,138,138,9,9,0,1,0
2,155,155,13,7,6,2,1
6,207,207,16,16,0,1,0
9,235,235,74,74,0,1,0
3,250,250,15,15,0,1,0
4,255,255,47,37,10,3,2
7,385,385,20,20,0,1,0
5,389,389,45,25,20,2,1

0,126,126,37,37,0,1,0
3,187,187,37,37,0,1,0
1,212,212,44,44,0,1,0
2,215,215,11,11,0,1,0
4,335,335,65,39,26,3,2
5,451,451,28,20,8,2,1

10,124,124,4,4,0,1,0
3,140,140,5,5,0,1,0
0,164,164,11,11,0,1,0
5,253,253,8,1,7,2,1
12,294,294,7,7,0,1,0
6,312,312,2,2,0,1,0
4,321,321,36,18,18,2,1
9,338,338,4,4,0,1,0
8,356,356,18,18,0,1,0
1,388,388,22,22,0,1,0
2,394,394,36,36,0,1,0
11,397,397,124,42,82,4,3
14,450,450,41,3,38,3,2
13,467,467,36,36,0,1,0
7,497,497,6,6,0,1,0

3,160,160,9,9,0,1,0
10,160,160,20,14,6,2,1
1,181,181,11,11,0,1,0
9,184,184,2,2,0,1,0
2,230,230,8,8,0,1,0
8,311,311,20,20,0,1,0
5,360,360,14,9,5,2,1
0,384,384,52,4,48,4,3
6,434,434,64,64,0,1,0
4,446,446,12,12,0,1,0
7,467,467,143,100,43,2,1

1,137,137,9,9,0,1,0
6,201,201,4,4,0,1,0
5,288,288,44,44,0,1,0
0,298,298,8,8,0,1,0
9,298,298,23,23,0,1,0
3,299,299,25,25,0,1,0
2,305,305,19,10,9,2,1
8,325,325,105,105,0,1,0
4,443,443,40,28,12,4,3
7,478,478,42,28,14,2,1
10,494,494,8,2,6,3,2

6,132,132,7,1,6,3,2
0,164,164,1,1,0,1,0
5,185,185,36,5,31,2,1
2,209,209,2,2,0,1,0
7,256,256,13,13,0,1,0
4,363,363,123,123,0,1,0
3,368,368,25,25,0,1,0
1,412,412,33,18,15,2,1
8,489,489,102,102,0,1,0

0,123,123,10,1,9,2,1
1,235,235,16,16,0,1,0
6,302,302,38,34,4,2,1
4,339,339,5,2,3,2,1
7,393,393,23,6,17,2,1
5,395,395,121,121,0,1,0
3,397,397,105,105,0,1,0
2,427,427,37,13,24,2,1

5,119,119,2,2,0,1,0
9,145,145,30,2,28,2,1
3,170,170,17,17,0,1,0
1,194,194,43,43,0,1,0
0,274,274,16,4,12,4,3
10,354,354,8,8,0,1,0
8,357,357,48,13,35,2,1
2,373,373,9,9,0,1,0
6,379,379,11,1,10,3,2
4,401,401,21,21,0,1,0
7,460,460,65,57,8,2,1

9,112,112,7,7,0,1,0
7,168,168,22,1,21,2,1
4,203,203,6,6,0,1,0
8,252,252,25,25,0,1,0
3,308,308,33,33,0,1,0
6,309,309,68,31,37,4,3
2,376,376,4,1,3,2,1
5,394,394,65,7,58,3,2
1,400,400,68,61,7,2,1
0,426,426,8,8,0,1,0

3,124,124,6,6,0,1,0
4,129,129,2,2,0,1,0
10,149,149,2,2,0,1,0
2,158,158,3,3,0,1,0
6,191,191,12,2,10,3,2
13,194,194,42,14,28,3,2
11,206,206,4,4,0,1,0
9,251,251,49,49,0,1,0
0,263,263,5,5,0,1,0
5,288,288,6,6,0,1,0
8,294,294,13,5,8,3,2
12,301,301,2,2,0,1,0
1,335,335,1,1,0,1,0
14,434,434,116,42,74,3,2
7,492,492,29,29,0,1,0

8,163,163,22,22,0,1,0
9,218,218,5,5,0,1,0
2,227,227,48,48,0,1,0
6,239,239,62,62,0,1,0
1,240,240,9,9,0,1,0
3,320,320,1,1,0,1,0
7,376,376,35,35,0,1,0
4,391,391,43,43,0,1,0
0,408,408,24,14,10,3,2
5,490,490,39,22,17,2,1

10,119,119,28,2,26,2,1
0,196,196,15,2,13,2,1
6,212,212,17,17,0,1,0
9,234,234,16,12,4,2,1
8,240,240,36,36,0,1,0
1,250,250,4,1,3,2,1
3,260,260,2,2,0,1,0
7,354,354,21,1,20,2,1
4,364,364,70,28,42,4,3
2,479,479,42,42,0,1,0
5,490,490,21,21,0,1,0

0,110,110,5,5,0,1,0
8,144,144,11,11,0,1,0
9,165,165,4,4,0,1,0
7,170,170,55,46,9,4,3
5,231,231,9,9,0,1,0
1,247,247,10,1,9,3,2
3,332,332,42,10,32,2,1
2,372,372,10,10,0,1,0
6,489,489,43,16,27,2,1
4,493,493,111,21,90,3,2

6,144,144,6,6,0,1,0
0,199,199,39,39,0,1,0
4,202,202,30,3,27,4,3
1,227,227,17,17,0,1,0
3,291,291,43,31,12,3,2
2,416,416,96,71,25,2,1
5,421,421,71,71,0,1,0

0,142,142,1,1,0,1,0
8,233,233,8,8,0,1,0
12,238,238,15,1,14,4,3
5,250,250,1,1,0,1,0
6,260,260,30,5,25,2,1
9,278,278,3,3,0,1,0
1,279,279,2,2,0,1,0
2,307,307,21,12,9,2,1
3,325,325,31,31,0,1,0
13,327,327,113,29,84,3,2
10,379,379,22,22,0,1,0
7,424,424,57,47,10,2,1
11,431,431,17,17,0,1,0
4,493,493,13,13,0,1,0

5,118,118,10,5,5,2,1
7,166,166,2,2,0,1,0
4,230,230,50,33,17,2,1
0,246,246,8,8,0,1,0
9,334,334,109,76,33,4,3
11,347,347,32,32,0,1,0
3,368,368,11,11,0,1,0
1,466,466,18,18,0,1,0
2,466,466,32,17,15,2,1
8,486,486,4,4,0,1,0
10,486,486,33,7,26,2,1
6,494,494,4,4,0,1,0
12,500,500,8,8,0,1,0

2,100,100,1,1,0,1,0
13,107,107,6,6,0,1,0
7,125,125,3,3,0,1,0
3,193,193,1,1,0,1,0
4,208,208,35,35,0,1,0
1,227,227,8,2,6,2,1
12,244,244,10,10,0,1,0
6,295,295,33,33,0,1,0
0,302,302,13,13,0,1,0
9,331,331,19,11,8,3,2
11,368,368,110,110,0,1,0
5,424,424,10,1,9,2,1
10,458,458,52,52,0,1,0
8,497,497,11,11,0,1,0

0,143,143,1,1,0,1,0
2,156,156,1,1,0,1,0
13,157,157,14,4,10,3,2
3,204,204,33,33,0,1,0
7,273,273,8,8,0,1,0
5,292,292,2,2,0,1,0
6,304,304,29,11,18,2,1
8,349,349,20,12,8,2,1
1,361,361,15,2,13,3,2
14,408,408,49,19,30,3,2
10,428,428,28,28,0,1,0
9,443,443,5,5,0,1,0
12,443,443,82,21,61,4,3
4,478,478,9,9,0,1,0
11,494,494,55,55,0,1,0

4,123,123,11,4,7,2,1
3,196,196,85,37,48,4,3
6,253,253,1,1,0,1,0
1,299,299,6,6,0,1,0
0,351,351,13,13,0,1,0
5,437,437,167,137,30,4,3
2,441,441,6,6,0,1,0
7,500,500,16,12,4,2,1

0,182,182,62,21,41,4,3
5,191,191,9,9,0,1,0
1,241,241,9,9,0,1,0
2,292,292,14,3,11,2,1
7,308,308,42,24,18,4,3
3,312,312,24,24,0,1,0
6,322,322,25,5,20,3,2
4,441,441,107,23,84,3,2

6,168,168,19,11,8,2,1
7,248,248,79,19,60,3,2
0,321,321,49,43,6,3,2
4,331,331,9,9,0,1,0
1,369,369,100,100,0,1,0
5,404,404,21,21,0,1,0
2,445,445,16,7,9,4,3
3,449,449,19,19,0,1,0

7,117,117,13,4,9,4,3
3,147,147,9,3,6,2,1
0,204,204,23,23,0,1,0
9,315,315,18,6,12,3,2
6,338,338,7,7,0,1,0
1,361,361,20,20,0,1,0
10,396,396,83,83,0,1,0
4,411,411,82,59,23,2,1
8,448,448,59,59,0,1,0
2,454,454,18,5,13,2,1
5,454,454,5,5,0,1,0

8,219,219,36,21,15,4,3
7,235,235,7,7,0,1,0
9,265,265,70,70,0,1,0
6,273,273,13,4,9,4,3
1,352,352,49,49,0,1,0
2,388,388,69,69,0,1,0
4,459,459,42,42,0,1,0
5,463,463,24,24,0,1,0
3,490,490,16,16,0,1,0
0,498,498,4,1,3,2,1

8,166,166,5,5,0,1,0
0,211,211,32,32,0,1,0
6,262,262,80,8,72,4,3
5,302,302,22,4,18,3,2
3,306,306,3,3,0,1,0
4,319,319,45,9,36,2,1
1,392,392,50,50,0,1,0
2,457,457,33,33,0,1,0
7,473,473,47,47,0,1,0

8,116,116,10,3,7,2,1
7,170,170,4,1,3,2,1
1,177,177,1,1,0,1,0
10,257,257,62,12,50,4,3
9,281,281,37,28,9,4,3
6,328,328,1,1,0,1,0
11,343,343,17,8,9,2,1
2,392,392,5,5,0,1,0
5,413,413,18,10,8,3,2
4,420,420,77,5,72,4,3
0,492,492,93,86,7,2,1
3,497,497,20,8,12,4,3

4,111,111,27,27,0,1,0
1,191,191,4,4,0,1,0
7,255,255,40,40,0,1,0
0,317,317,9,9,0,1,0
6,325,325,12,12,0,1,0
3,364,364,25,8,17,2,1
8,464,464,33,33,0,1,0
5,479,479,60,35,25,2,1
9,491,491,118,57,61,3,2
2,498,498,7,2,5,2,1

7,132,132,2,2,0,1,0
8,150,150,16,2,14,3,2
6,159,159,15,15,0,1,0
10,239,239,15,1,14,3,2
9,241,241,8,8,0,1,0
12,256,256,29,29,0,1,0
5,257,257,13,1,12,4,3
1,301,301,9,9,0,1,0
3,306,306,1,1,0,1,0
11,340,340,102,66,36,4,3
0,399,399,27,27,0,1,0
2,418,418,10,3,7,2,1
4,491,491,56,29,27,4,3

3,209,209,36,18,18,4,3
7,256,256,14,14,0,1,0
4,265,265,66,36,30,4,3
6,332,332,65,65,0,1,0
0,338,338,31,31,0,1,0
1,386,386,36,36,0,1,0
2,427,427,61,61,0,1,0
5,493,493,1,1,0,1,0

5,279,279,6,6,0,1,0
7,280,280,29,25,4,2,1
4,354,354,103,103,0,1,0
3,355,355,24,3,21,4,3
1,392,392,109,92,17,2,1
0,398,398,12,12,0,1,0
2,450,450,57,45,12,4,3
6,500,500,44,11,33,3,2

6,135,135,1,1,0,1,0
11,168,168,7,7,0,1,0
7,173,173,49,28,21,2,1
2,191,191,4,4,0,1,0
8,191,191,45,45,0,1,0
10,210,210,33,33,0,1,0
1,265,265,10,10,0,1,0
4,301,301,12,5,7,2,1
3,339,339,27,27,0,1,0
0,356,356,3,3,0,1,0
5,400,400,11,11,0,1,0
9,466,466,35,8,27,2,1

15,103,103,4,4,0,1,0
0,107,107,1,1,0,1,0
9,122,122,3,3,0,1,0
6,166,166,1,1,0,1,0
3,167,167,22,22,0,1,0
14,214,214,14,14,0,1,0
7,224,224,19,8,11,2,1
1,228,228,24,2,22,3,2
13,238,238,66,66,0,1,0
16,284,284,36,36,0,1,0
11,287,287,3,3,0,1,0
12,369,369,7,7,0,1,0
8,385,385,7,1,6,3,2
5,397,397,14,14,0,1,0
4,399,399,16,16,0,1,0
2,408,408,4,1,3,2,1
10,422,422,3,3,0,1,0

11,168,168,20,20,0,1,0
12,171,171,7,7,0,1,0
7,177,177,7,3,4,2,1
1,234,234,21,3,18,3,2
10,239,239,30,30,0,1,0
6,246,246,20,20,0,1,0
0,309,309,14,1,13,2,1
2,314,314,40,40,0,1,0
9,424,424,94,25,69,4,3
5,425,425,1,1,0,1,0
8,445,445,27,27,0,1,0
3,478,478,9,9,0,1,0
4,486,486,18,18,0,1,0

3,107,107,4,4,0,1,0
2,124,124,9,9,0,1,0
8,136,136,11,11,0,1,0
0,196,196,5,1,4,2,1
6,208,208,21,5,16,3,2
12,272,272,64,44,20,2,1
10,305,305,9,1,8,3,2
4,324,324,3,3,0,1,0
5,373,373,6,6,0,1,0
9,378,378,89,49,40,2,1
1,425,425,57,22,35,4,3
11,475,475,4,4,0,1,0
7,491,491,12,12,0,1,0

0,109,109,9,9,0,1,0
4,176,176,18,18,0,1,0
11,187,187,18,12,6,3,2
8,246,246,56,56,0,1,0
6,289,289,14,14,0,1,0
7,328,328,27,3,24,3,2
3,349,349,19,19,0,1,0
9,376,376,1,1,0,1,0
10,391,391,70,28,42,4,3
1,405,405,46,46,0,1,0
5,451,451,5,2,3,2,1
2,456,456,3,3,0,1,0

8,173,173,5,5,0,1,0
1,285,285,1,1,0,1,0
5,285,285,80,22,58,4,3
6,361,361,32,23,9,4,3
2,366,366,8,8,0,1,0
0,369,369,26,10,16,3,2
7,406,406,44,26,18,4,3
4,449,449,177,93,84,4,3
3,494,494,5,5,0,1,0

3,102,102,17,9,8,2,1
7,189,189,68,13,55,4,3
4,275,275,31,31,0,1,0
6,291,291,2,2,0,1,0
5,356,356,10,7,3,2,1
1,380,380,30,30,0,1,0
2,451,451,18,12,6,3,2
0,456,456,99,99,0,1,0

6,155,155,8,4,4,2,1
8,156,156,13,5,8,3,2
4,157,157,13,9,4,2,1
7,210,210,37,16,21,4,3
9,259,259,61,25,36,4,3
10,270,270,4,4,0,1,0
5,294,294,10,10,0,1,0
2,373,373,30,21,9,2,1
1,413,413,48,7,41,2,1
0,483,483,30,6,24,2,1
3,484,484,36,12,24,4,3

6,107,107,6,6,0,1,0
7,119,119,15,15,0,1,0
4,186,186,29,14,15,4,3
2,321,321,92,22,70,3,2
0,354,354,26,26,0,1,0
5,372,372,67,67,0,1,0
1,399,399,1,1,0,1,0
3,425,425,59,7,52,4,3

4,104,104,3,3,0,1,0
2,230,230,52,17,35,2,1
3,231,231,7,7,0,1,0
5,320,320,10,10,0,1,0
8,375,375,39,39,0,1,0
0,401,401,14,14,0,1,0
1,414,414,76,16,60,4,3
6,434,434,109,43,66,4,3
7,449,449,54,26,28,3,2

7,100,100,9,9,0,1,0
5,133,133,37,25,12,4,3
8,136,136,16,10,6,2,1
6,166,166,5,1,4,2,1
3,184,184,57,57,0,1,0
2,271,271,16,4,12,3,2
1,304,304,8,8,0,1,0
4,351,351,17,12,5,2,1
0,355,355,21,21,0,1,0

3,103,103,2,2,0,1,0
6,104,104,8,8,0,1,0
10,218,218,27,27,0,1,0
7,246,246,3,3,0,1,0
4,323,323,14,4,10,2,1
11,349,349,10,10,0,1,0
1,356,356,8,8,0,1,0
5,405,405,72,25,47,2,1
8,443,443,113,113,0,1,0
2,472,472,59,15,44,3,2
9,486,486,49,3,46,2,1
0,497,497,12,1,11,2,1

5,131,131,15,15,0,1,0
1,132,132,1,1,0,1,0
2,164,164,14,1,13,2,1
7,193,193,3,3,0,1,0
9,200,200,14,10,4,2,1
0,236,236,45,33,12,4,3
3,310,310,14,14,0,1,0
6,345,345,8,8,0,1,0
10,394,394,136,126,10,3,2
4,421,421,15,9,6,2,1
8,456,456,36,36,0,1,0

7,121,121,5,5,0,1,0
0,166,166,3,3,0,1,0
3,199,199,12,5,7,2,1
11,290,290,38,12,26,4,3
9,302,302,26,26,0,1,0
2,304,304,21,2,19,4,3
4,353,353,3,3,0,1,0
8,397,397,82,82,0,1,0
10,433,433,36,1,35,2,1
1,440,440,27,27,0,1,0
5,448,448,7,3,4,2,1
6,474,474,107,99,8,2,1

2,118,118,13,13,0,1,0
7,122,122,33,33,0,1,0
3,230,230,41,21,20,2,1
8,234,234,40,7,33,4,3
5,262,262,10,10,0,1,0
4,319,319,26,8,18,3,2
6,353,353,11,2,9,4,3
0,419,419,15,3,12,3,2
1,453,453,44,44,0,1,0

14,102,102,16,16,0,1,0
1,187,187,14,14,0,1,0
6,198,198,4,4,0,1,0
9,215,215,15,2,13,2,1
12,233,233,4,4,0,1,0
4,245,245,3,3,0,1,0
3,293,293,14,14,0,1,0
5,312,312,3,3,0,1,0
11,341,341,78,71,7,2,1
10,357,357,8,4,4,2,1
0,384,384,14,4,10,3,2
7,385,385,54,54,0,1,0
8,387,387,14,5,9,2,1
13,425,425,47,47,0,1,0
2,437,437,14,14,0,1,0

10,100,100,28,28,0,1,0
5,115,115,9,1,8,3,2
6,148,148,3,3,0,1,0
3,206,206,3,3,0,1,0
4,281,281,19,19,0,1,0
8,303,303,38,38,0,1,0
11,318,318,14,4,10,2,1
7,394,394,22,22,0,1,0
1,410,410,69,24,45,3,2
0,414,414,7,7,0,1,0
9,440,440,24,24,0,1,0
2,461,461,37,28,9,4,3

3,107,107,3,3,0,1,0
5,121,121,3,3,0,1,0
1,241,241,11,2,9,3,2
0,253,253,7,7,0,1,0
6,253,253,48,33,15,4,3
7,359,359,88,19,69,4,3
2,431,431,174,24,150,4,3
4,479,479,24,24,0,1,0

0,106,106,1,1,0,1,0
4,134,134,9,9,0,1,0
5,147,147,20,20,0,1,0
7,223,223,52,15,37,2,1
2,363,363,50,41,9,2,1
6,413,413,30,30,0,1,0
1,434,434,44,44,0,1,0
3,456,456,115,46,69,3,2

5,119,119,25,25,0,1,0
1,213,213,4,4,0,1,0
2,251,251,15,15,0,1,0
6,256,256,11,11,0,1,0
3,337,337,31,1,30,2,1
9,340,340,11,8,3,2,1
7,354,354,18,18,0,1,0
8,387,387,147,90,57,4,3
0,457,457,43,31,12,2,1
4,481,481,15,8,7,2,1

1,107,107,23,23,0,1,0
2,107,107,13,5,8,3,2
7,113,113,11,11,0,1,0
5,306,306,58,42,16,2,1
3,357,357,58,37,21,2,1
6,418,418,27,27,0,1,0
4,446,446,69,69,0,1,0
0,469,469,1,1,0,1,0

6,190,190,8,1,7,2,1
9,205,205,21,18,3,2,1
3,211,211,8,8,0,1,0
11,274,274,48,48,0,1,0
2,342,342,54,11,43,2,1
0,380,380,7,7,0,1,0
4,399,399,7,7,0,1,0
1,408,408,3,3,0,1,0
8,414,414,16,16,0,1,0
5,427,427,68,68,0,1,0
10,431,431,81,35,46,3,2
7,432,432,26,19,7,2,1

5,117,117,10,10,0,1,0
6,140,140,51,51,0,1,0
4,165,165,2,2,0,1,0
2,166,166,6,6,0,1,0
0,206,206,6,6,0,1,0
1,250,250,53,44,9,4,3
8,258,258,8,4,4,2,1
7,284,284,9,9,0,1,0
3,469,469,99,58,41,2,1

3,162,162,22,4,18,3,2
2,193,193,2,2,0,1,0
4,279,279,22,12,10,2,1
5,281,281,21,21,0,1,0
0,307,307,93,22,71,4,3
6,347,347,74,43,31,2,1
1,426,426,81,81,0,1,0

0,138,138,9,9,0,1,0
10,205,205,46,46,0,1,0
4,222,222,17,17,0,1,0
5,257,257,11,1,10,2,1
3,274,274,7,7,0,1,0
9,288,288,19,14,5,2,1
6,317,317,26,3,23,2,1
7,345,345,66,11,55,4,3
1,468,468,45,45,0,1,0
8,479,479,12,12,0,1,0
2,499,499,56,56,0,1,0

8,132,132,7,7,0,1,0
3,135,135,9,9,0,1,0
5,155,155,14,14,0,1,0
4,156,156,1,1,0,1,0
10,178,178,6,6,0,1,0
1,240,240,2,2,0,1,0
9,244,244,6,6,0,1,0
0,269,269,1,1,0,1,0
11,284,284,60,60,0,1,0
12,287,287,13,1,12,3,2
13,314,314,49,37,12,4,3
14,356,356,33,33,0,1,0
2,439,439,10,10,0,1,0
7,447,447,59,53,6,3,2
6,471,471,29,8,21,4,3

7,158,158,4,1,3,2,1
2,196,196,36,36,0,1,0
3,375,375,50,50,0,1,0
0,406,406,58,58,0,1,0
6,435,435,26,26,0,1,0
1,448,448,18,9,9,2,1
5,494,494,15,15,0,1,0
4,499,499,195,165,30,4,3

1,178,178,6,2,4,2,1
5,208,208,30,16,14,3,2
4,306,306,50,6,44,4,3
8,311,311,49,49,0,1,0
0,359,359,22,7,15,4,3
2,406,406,70,70,0,1,0
3,434,434,31,7,24,3,2
7,444,444,52,52,0,1,0
6,469,469,41,41,0,1,0

7,182,182,15,15,0,1,0
3,189,189,43,8,35,2,1
2,231,231,4,4,0,1,0
8,245,245,6,1,5,2,1
6,324,324,70,62,8,3,2
4,357,357,15,15,0,1,0
5,364,364,55,5,50,2,1
9,429,429,79,79,0,1,0
0,478,478,14,14,0,1,0
1,482,482,17,17,0,1,0

6,104,104,5,5,0,1,0
3,112,112,16,12,4,2,1
5,119,119,5,2,3,2,1
1,184,184,13,9,4,2,1
8,184,184,1,1,0,1,0
4,195,195,4,4,0,1,0
10,211,211,43,43,0,1,0
11,263,263,43,43,0,1,0
12,335,335,13,5,8,2,1
9,378,378,38,38,0,1,0
0,428,428,59,20,39,4,3
7,457,457,4,4,0,1,0
2,462,462,13,13,0,1,0

6,105,105,4,4,0,1,0
4,144,144,52,52,0,1,0
3,215,215,59,59,0,1,0
7,219,219,23,1,22,3,2
0,264,264,49,2,47,2,1
2,276,276,9,2,7,2,1
1,306,306,3,3,0,1,0
5,350,350,2,2,0,1,0

9,125,125,23,5,18,4,3
3,222,222,27,27,0,1,0
0,258,258,19,19,0,1,0
7,315,315,22,22,0,1,0
8,322,322,1,1,0,1,0
5,388,388,67,25,42,3,2
2,434,434,7,7,0,1,0
1,469,469,1,1,0,1,0
6,470,470,117,94,23,2,1
4,487,487,56,36,20,2,1

6,135,135,53,7,46,2,1
3,153,153,11,6,5,2,1
7,178,178,15,15,0,1,0
9,193,193,1,1,0,1,0
2,229,229,3,3,0,1,0
5,237,237,9,9,0,1,0
0,248,248,38,25,13,2,1
4,304,304,23,12,11,2,1
8,333,333,9,9,0,1,0
1,448,448,68,68,0,1,0

4,152,152,10,7,3,2,1
2,204,204,51,19,32,4,3
0,267,267,134,134,0,1,0
1,367,367,51,24,27,4,3
3,461,461,25,1,24,4,3

4,102,102,1,1,0,1,0
10,144,144,8,5,3,2,1
1,148,148,2,2,0,1,0
3,185,185,7,7,0,1,0
6,202,202,49,42,7,2,1
7,250,250,31,31,0,1,0
5,251,251,1,1,0,1,0
9,316,316,74,74,0,1,0
0,388,388,58,19,39,4,3
2,420,420,19,19,0,1,0
8,433,433,41,4,37,2,1

1,118,118,10,2,8,3,2
3,263,263,87,49,38,2,1
0,324,324,75,32,43,2,1
6,384,384,10,1,9,2,1
2,422,422,78,15,63,3,2
4,456,456,18,8,10,2,1
5,463,463,51,25,26,3,2

7,130,130,10,4,6,3,2
5,162,162,7,7,0,1,0
8,174,174,11,11,0,1,0
9,200,200,56,14,42,3,2
10,206,206,3,3,0,1,0
2,252,252,49,43,6,2,1
1,278,278,10,10,0,1,0
0,328,328,25,17,8,3,2
6,383,383,13,13,0,1,0
11,436,436,67,49,18,4,3
4,437,437,2,2,0,1,0
3,499,499,21,9,12,3,2

3,105,105,7,3,4,2,1
4,116,116,1,1,0,1,0
6,142,142,1,1,0,1,0
5,149,149,2,2,0,1,0
1,163,163,24,24,0,1,0
10,180,180,26,5,21,2,1
2,233,233,53,9,44,3,2
9,389,389,86,42,44,2,1
8,395,395,53,31,22,2,1
7,417,417,2,2,0,1,0
0,488,488,16,16,0,1,0

8,123,123,2,2,0,1,0
0,128,128,28,2,26,3,2
6,188,188,36,18,18,2,1
9,191,191,55,35,20,2,1
7,268,268,3,3,0,1,0
4,331,331,15,9,6,2,1
1,420,420,36,2,34,3,2
2,437,437,30,12,18,4,3
3,459,459,4,1,3,2,1
5,496,496,37,37,0,1,0

8,104,104,1,1,0,1,0
6,141,141,5,5,0,1,0
10,157,157,10,10,0,1,0
0,191,191,8,8,0,1,0
9,191,191,6,6,0,1,0
2,241,241,17,5,12,4,3
13,255,255,8,5,3,2,1
3,271,271,17,3,14,3,2
7,315,315,41,41,0,1,0
12,363,363,18,6,12,2,1
11,385,385,140,101,39,4,3
5,397,397,10,10,0,1,0
1,473,473,6,3,3,2,1
4,484,484,39,39,0,1,0

4,146,146,5,1,4,2,1
7,178,178,6,6,0,1,0
3,217,217,30,14,16,2,1
5,375,375,149,108,41,2,1
2,393,393,18,3,15,2,1
1,401,401,41,41,0,1,0
6,415,415,18,18,0,1,0
0,499,499,108,14,94,3,2

7,138,138,22,4,18,4,3
6,232,232,13,13,0,1,0
0,298,298,10,10,0,1,0
3,371,371,118,87,31,2,1
4,385,385,90,50,40,3,2
1,395,395,36,36,0,1,0
2,411,411,24,10,14,3,2
5,498,498,29,14,15,2,1

1,136,136,4,4,0,1,0
9,164,164,5,5,0,1,0
0,166,166,6,6,0,1,0
5,267,267,23,1,22,3,2
2,270,270,8,8,0,1,0
3,276,276,24,5,19,4,3
7,300,300,4,4,0,1,0
6,304,304,30,12,18,2,1
11,316,316,60,27,33,2,1
8,435,435,62,2,60,4,3
10,441,441,64,20,44,2,1
4,449,449,54,30,24,4,3

6,121,121,8,2,6,2,1
1,137,137,22,18,4,2,1
2,200,200,36,36,0,1,0
4,220,220,6,6,0,1,0
3,261,261,2,2,0,1,0
9,343,343,2,2,0,1,0
8,413,413,144,144,0,1,0
0,419,419,11,11,0,1,0
5,448,448,15,12,3,2,1
10,457,457,6,6,0,1,0
7,485,485,67,67,0,1,0

10,127,127,2,2,0,1,0
7,131,131,2,2,0,1,0
9,137,137,39,25,14,3,2
8,175,175,2,2,0,1,0
4,185,185,37,11,26,2,1
3,193,193,7,1,6,2,1
1,194,194,19,9,10,3,2
11,256,256,26,26,0,1,0
2,273,273,16,16,0,1,0
5,299,299,20,9,11,2,1
6,332,332,1,1,0,1,0
12,425,425,46,46,0,1,0
0,437,437,7,7,0,1,0

2,111,111,28,23,5,2,1
1,225,225,5,5,0,1,0
3,287,287,11,4,7,2,1
9,296,296,104,40,64,4,3
4,299,299,24,24,0,1,0
7,321,321,16,16,0,1,0
6,402,402,12,1,11,2,1
8,428,428,31,5,26,3,2
0,433,433,10,10,0,1,0
5,472,472,40,28,12,2,1

5,100,100,4,1,3,2,1
2,102,102,28,1,27,4,3
6,144,144,7,7,0,1,0
3,155,155,10,4,6,2,1
7,225,225,7,7,0,1,0
8,304,304,32,32,0,1,0
4,326,326,24,24,0,1,0
0,368,368,7,7,0,1,0
9,371,371,119,15,104,4,3
1,484,484,15,1,14,2,1

2,106,106,1,1,0,1,0
7,129,129,15,12,3,2,1
10,132,132,9,9,0,1,0
9,134,134,1,1,0,1,0
13,135,135,13,13,0,1,0
5,139,139,1,1,0,1,0
15,201,201,21,21,0,1,0
3,237,237,14,14,0,1,0
14,283,283,32,7,25,2,1
0,299,299,12,3,9,2,1
1,327,327,18,18,0,1,0
11,339,339,29,29,0,1,0
6,388,388,2,2,0,1,0
8,395,395,11,6,5,2,1
4,400,400,8,1,7,2,1
12,476,476,93,65,28,2,1

7,106,106,1,1,0,1,0
0,155,155,23,23,0,1,0
3,195,195,32,1,31,3,2
1,213,213,12,2,10,3,2
8,266,266,40,18,22,2,1
4,268,268,1,1,0,1,0
5,380,380,23,9,14,3,2
6,439,439,84,84,0,1,0
9,468,468,75,3,72,3,2
2,495,495,34,34,0,1,0

9,108,108,6,6,0,1,0
7,220,220,49,32,17,2,1
0,244,244,8,8,0,1,0
1,334,334,13,13,0,1,0
5,344,344,5,5,0,1,0
6,359,359,64,46,18,3,2
2,369,369,91,83,8,2,1
3,391,391,45,25,20,3,2
8,473,473,25,25,0,1,0
4,499,499,26,9,17,2,1

1,175,175,35,14,21,4,3
0,185,185,8,1,7,2,1
9,229,229,6,6,0,1,0
2,242,242,35,35,0,1,0
5,287,287,11,4,7,2,1
7,323,323,27,19,8,2,1
3,329,329,14,14,0,1,0
6,332,332,109,109,0,1,0
4,333,333,11,1,10,2,1
8,351,351,25,5,20,3,2

4,189,189,5,5,0,1,0
3,253,253,16,16,0,1,0
2,271,271,5,5,0,1,0
1,283,283,22,22,0,1,0
6,382,382,26,26,0,1,0
8,398,398,65,23,42,2,1
5,402,402,8,8,0,1,0
7,458,458,117,21,96,4,3
0,473,473,140,96,44,2,1
9,477,477,9,9,0,1,0

0,129,129,13,1,12,3,2
5,172,172,17,17,0,1,0
3,207,207,11,3,8,2,1
6,230,230,8,8,0,1,0
10,235,235,16,16,0,1,0
1,252,252,6,1,5,2,1
7,263,263,1,1,0,1,0
9,318,318,29,11,18,2,1
2,334,334,39,23,16,4,3
12,337,337,4,1,3,2,1
4,364,364,5,5,0,1,0
8,462,462,26,3,23,2,1
11,499,499,168,92,76,4,3

9,131,131,4,4,0,1,0
8,148,148,1,1,0,1,0
1,160,160,24,24,0,1,0
13,181,181,17,5,12,4,3
7,195,195,22,22,0,1,0
0,227,227,19,19,0,1,0
12,275,275,4,4,0,1,0
6,346,346,12,3,9,2,1
11,417,417,62,62,0,1,0
3,435,435,19,9,10,2,1
10,435,435,108,108,0,1,0
5,443,443,2,2,0,1,0
2,472,472,13,13,0,1,0
4,493,493,6,6,0,1,0

5,122,122,1,1,0,1,0
4,124,124,1,1,0,1,0
0,174,174,24,24,0,1,0
7,191,191,21,21,0,1,0
1,274,274,1,1,0,1,0
6,295,295,55,16,39,2,1
2,379,379,126,31,95,4,3
8,394,394,31,11,20,3,2
9,437,437,56,56,0,1,0
3,462,462,7,7,0,1,0

2,101,101,19,19,0,1,0
4,142,142,6,6,0,1,0
3,193,193,11,5,6,3,2
0,250,250,5,5,0,1,0
6,323,323,7,7,0,1,0
7,340,340,45,45,0,1,0
1,362,362,70,70,0,1,0
8,375,375,103,10,93,4,3
5,487,487,37,37,0,1,0

7,140,140,13,13,0,1,0
5,186,186,40,40,0,1,0
1,251,251,23,9,14,3,2
3,276,276,21,13,8,3,2
2,419,419,81,81,0,1,0
4,447,447,79,5,74,3,2
0,466,466,65,65,0,1,0
6,500,500,13,13,0,1,0

1,134,134,17,8,9,4,3
4,179,179,12,5,7,2,1
8,219,219,66,66,0,1,0
7,346,346,38,38,0,1,0
6,351,351,10,2,8,3,2
9,376,376,26,26,0,1,0
2,380,380,39,39,0,1,0
3,398,398,32,32,0,1,0
0,407,407,3,3,0,1,0
5,412,412,48,48,0,1,0

6,108,108,28,28,0,1,0
0,111,111,3,3,0,1,0
7,174,174,9,9,0,1,0
2,178,178,11,1,10,3,2
3,269,269,9,1,8,3,2
1,293,293,84,64,20,3,2
8,350,350,38,38,0,1,0
5,362,362,33,33,0,1,0
4,394,394,36,36,0,1,0

1,102,102,6,1,5,2,1
4,110,110,2,2,0,1,0
5,126,126,1,1,0,1,0
11,138,138,12,2,10,2,1
10,225,225,8,3,5,2,1
9,236,236,1,1,0,1,0
8,287,287,14,7,7,2,1
12,288,288,110,110,0,1,0
2,351,351,25,16,9,4,3
6,412,412,27,27,0,1,0
7,424,424,85,14,71,3,2
3,439,439,1,1,0,1,0
0,441,441,12,12,0,1,0

7,137,137,8,3,5,2,1
9,174,174,48,24,24,4,3
3,219,219,28,8,20,3,2
2,295,295,5,5,0,1,0
0,324,324,35,24,11,2,1
1,358,358,19,1,18,3,2
6,400,400,15,15,0,1,0
4,479,479,12,3,9,4,3
8,490,490,67,1,66,4,3
5,497,497,85,85,0,1,0

10,124,124,6,6,0,1,0
9,126,126,1,1,0,1,0
7,200,200,54,14,40,2,1
0,232,232,11,1,10,3,2
2,233,233,6,6,0,1,0
1,275,275,21,21,0,1,0
5,297,297,13,1,12,2,1
8,302,302,57,42,15,4,3
6,304,304,6,6,0,1,0
3,359,359,81,81,0,1,0
4,397,397,25,17,8,2,1

11,138,138,18,18,0,1,0
5,139,139,24,24,0,1,0
4,199,199,16,10,6,2,1
9,232,232,6,2,4,2,1
6,237,237,1,1,0,1,0
7,269,269,12,12,0,1,0
8,274,274,7,7,0,1,0
3,283,283,21,13,8,3,2
1,294,294,18,4,14,3,2
0,321,321,8,2,6,2,1
10,376,376,121,42,79,4,3
2,453,453,18,13,5,2,1

7,168,168,2,2,0,1,0
5,241,241,80,69,11,2,1
0,315,315,102,15,87,4,3
3,433,433,13,13,0,1,0
6,459,459,16,1,15,3,2
2,478,478,1,1,0,1,0
4,482,482,63,63,0,1,0
1,497,497,72,36,36,2,1

2,105,105,3,3,0,1,0
4,244,244,60,50,10,2,1
6,252,252,46,11,35,3,2
0,276,276,28,28,0,1,0
1,289,289,107,107,0,1,0
3,294,294,13,3,10,2,1
5,437,437,15,12,3,2,1

2,120,120,8,8,0,1,0
4,129,129,4,4,0,1,0
3,218,218,12,12,0,1,0
0,312,312,36,10,26,2,1
1,334,334,129,35,94,3,2
5,394,394,140,140,0,1,0

5,171,171,20,20,0,1,0
1,174,174,62,38,24,2,1
0,220,220,32,32,0,1,0
4,295,295,107,65,42,3,2
3,349,349,6,6,0,1,0
2,355,355,4,4,0,1,0

1,136,136,14,11,3,2,1
7,186,186,2,2,0,1,0
5,191,191,70,5,65,4,3
8,203,203,20,20,0,1,0
0,303,303,5,5,0,1,0
4,352,352,64,37,27,4,3
2,420,420,50,22,28,2,1
3,449,449,36,20,16,3,2
6,454,454,14,4,10,4,3

1,130,130,13,1,12,2,1
4,136,136,10,10,0,1,0
0,158,158,8,1,7,2,1
6,200,200,1,1,0,1,0
7,248,248,69,69,0,1,0
5,297,297,1,1,0,1,0
3,315,315,46,46,0,1,0
8,329,329,37,25,12,2,1
9,365,365,40,40,0,1,0
2,430,430,55,55,0,1,0

2,142,142,11,11,0,1,0
3,208,208,32,32,0,1,0
6,209,209,13,13,0,1,0
7,251,251,2,2,0,1,0
11,256,256,50,50,0,1,0
1,266,266,6,6,0,1,0
8,298,298,2,2,0,1,0
5,355,355,48,48,0,1,0
12,360,360,64,64,0,1,0
0,431,431,11,11,0,1,0
10,431,431,56,56,0,1,0
4,434,434,4,4,0,1,0
9,496,496,1,1,0,1,0

14,118,118,2,2,0,1,0
6,120,120,10,10,0,1,0
5,125,125,1,1,0,1,0
8,146,146,11,11,0,1,0
7,223,223,33,14,19,2,1
13,227,227,48,48,0,1,0
3,229,229,12,12,0,1,0
0,265,265,7,1,6,3,2
2,265,265,2,2,0,1,0
9,359,359,1,1,0,1,0
4,371,371,1,1,0,1,0
1,374,374,1,1,0,1,0
11,383,383,15,15,0,1,0
10,456,456,24,6,18,2,1
12,468,468,100,52,48,4,3
15,483,483,33,33,0,1,0

3,109,109,1,1,0,1,0
7,198,198,49,49,0,1,0
6,201,201,9,6,3,2,1
0,203,203,4,4,0,1,0
1,242,242,7,7,0,1,0
10,272,272,50,25,25,2,1
2,322,322,18,18,0,1,0
9,339,339,6,1,5,2,1
5,366,366,80,80,0,1,0
8,371,371,22,22,0,1,0
4,396,396,49,6,43,2,1

12,114,114,4,4,0,1,0
2,162,162,3,3,0,1,0
9,221,221,13,13,0,1,0
0,243,243,42,42,0,1,0
8,253,253,1,1,0,1,0
4,270,270,10,10,0,1,0
3,279,279,10,1,9,3,2
10,308,308,3,3,0,1,0
5,355,355,22,2,20,2,1
13,355,355,85,85,0,1,0
14,377,377,36,1,35,2,1
1,397,397,19,19,0,1,0
7,454,454,10,3,7,2,1
11,473,473,68,20,48,4,3
6,497,497,17,10,7,2,1

0,118,118,3,3,0,1,0
2,129,129,1,1,0,1,0
9,129,129,25,25,0,1,0
5,146,146,1,1,0,1,0
1,180,180,74,32,42,3,2
4,244,244,10,1,9,4,3
8,306,306,32,14,18,4,3
6,354,354,51,46,5,2,1
7,426,426,27,27,0,1,0
3,484,484,7,7,0,1,0

1,195,195,17,17,0,1,0
8,195,195,1,1,0,1,0
11,198,198,12,12,0,1,0
3,237,237,9,3,6,3,2
2,303,303,34,28,6,3,2
7,321,321,11,11,0,1,0
5,335,335,22,22,0,1,0
6,347,347,5,2,3,2,1
0,350,350,37,37,0,1,0
10,382,382,50,32,18,2,1
4,383,383,17,14,3,2,1
9,471,471,147,84,63,4,3

6,110,110,15,15,0,1,0
3,219,219,6,6,0,1,0
7,257,257,24,12,12,4,3
2,291,291,48,48,0,1,0
4,292,292,38,24,14,3,2
5,314,314,46,26,20,2,1
0,356,356,36,36,0,1,0
1,389,389,82,28,54,4,3

6,155,155,14,14,0,1,0
2,213,213,31,9,22,3,2
1,226,226,36,18,18,4,3
0,299,299,34,16,18,4,3
8,328,328,2,2,0,1,0
4,344,344,15,15,0,1,0
5,364,364,117,109,8,2,1
7,439,439,40,40,0,1,0
3,477,477,19,11,8,2,1

0,100,100,14,14,0,1,0
1,139,139,20,20,0,1,0
3,170,170,13,13,0,1,0
4,205,205,7,7,0,1,0
6,219,219,13,13,0,1,0
7,272,272,55,55,0,1,0
5,389,389,82,55,27,3,2
2,469,469,67,53,14,4,3

1,117,117,3,3,0,1,0
2,187,187,57,57,0,1,0
5,238,238,6,6,0,1,0
6,274,274,16,3,13,2,1
3,394,394,130,38,92,3,2
4,468,468,43,43,0,1,0
0,497,497,85,82,3,2,1

8,208,208,5,5,0,1,0
0,235,235,5,5,0,1,0
2,289,289,26,26,0,1,0
3,320,320,6,6,0,1,0
9,358,358,15,3,12,4,3
6,403,403,104,92,12,4,3
1,409,409,22,22,0,1,0
7,410,410,74,48,26,3,2
4,440,440,94,55,39,4,3
5,462,462,48,17,31,2,1

6,121,121,11,11,0,1,0
5,186,186,26,26,0,1,0
0,234,234,18,4,14,3,2
7,248,248,32,23,9,4,3
3,400,400,31,12,19,2,1
4,468,468,69,69,0,1,0
2,469,469,35,35,0,1,0
1,491,491,134,54,80,4,3

7,135,135,2,2,0,1,0
0,150,150,2,2,0,1,0
9,191,191,31,3,28,4,3
4,214,214,13,5,8,2,1
10,238,238,45,45,0,1,0
11,245,245,10,3,7,2,1
5,260,260,18,6,12,2,1
6,284,284,6,6,0,1,0
3,306,306,64,64,0,1,0
2,318,318,3,3,0,1,0
1,440,440,11,1,10,3,2
8,440,440,34,18,16,3,2
12,471,471,55,55,0,1,0

9,108,108,7,2,5,2,1
5,118,118,13,13,0,1,0
8,129,129,10,2,8,2,1
10,149,149,51,51,0,1,0
1,185,185,15,2,13,3,2
4,279,279,2,2,0,1,0
2,339,339,50,5,45,2,1
3,367,367,16,16,0,1,0
6,376,376,22,22,0,1,0
7,401,401,12,4,8,2,1
0,417,417,22,6,16,2,1

1,111,111,34,6,28,3,2
0,139,139,21,21,0,1,0
8,174,174,15,1,14,2,1
2,303,303,4,4,0,1,0
6,412,412,3,3,0,1,0
5,446,446,98,98,0,1,0
7,465,465,90,47,43,2,1
4,480,480,8,8,0,1,0
3,499,499,7,3,4,2,1

4,106,106,1,1,0,1,0
3,147,147,1,1,0,1,0
10,166,166,26,8,18,2,1
9,169,169,26,26,0,1,0
5,201,201,2,2,0,1,0
6,270,270,1,1,0,1,0
0,306,306,34,4,30,2,1
7,315,315,39,16,23,2,1
8,404,404,30,5,25,2,1
2,475,475,171,93,78,4,3
1,492,492,1,1,0,1,0

5,110,110,33,9,24,2,1
3,138,138,23,23,0,1,0
4,314,314,2,2,0,1,0
2,316,316,113,113,0,1,0
0,382,382,54,54,0,1,0
6,475,475,18,18,0,1,0
1,484,484,2,2,0,1,0

0,128,128,17,13,4,2,1
7,138,138,10,6,4,2,1
4,146,146,10,10,0,1,0
3,168,168,10,10,0,1,0
8,217,217,58,53,5,2,1
2,254,254,49,49,0,1,0
1,311,311,15,5,10,2,1
5,371,371,55,55,0,1,0
6,395,395,8,1,7,2,1

9,113,113,1,1,0,1,0
2,164,164,19,10,9,4,3
12,177,177,5,5,0,1,0
11,180,180,52,52,0,1,0
7,197,197,15,3,12,4,3
1,241,241,17,9,8,3,2
8,243,243,1,1,0,1,0
6,286,286,15,15,0,1,0
10,335,335,22,22,0,1,0
4,341,341,3,3,0,1,0
5,345,345,5,5,0,1,0
13,345,345,44,44,0,1,0
3,374,374,24,11,13,2,1
0,459,459,42,18,24,3,2

2,162,162,9,9,0,1,0
7,215,215,1,1,0,1,0
1,253,253,5,1,4,2,1
8,256,256,19,8,11,2,1
4,264,264,37,37,0,1,0
6,264,264,16,16,0,1,0
0,308,308,20,20,0,1,0
11,320,320,7,1,6,3,2
3,366,366,4,4,0,1,0
10,405,405,122,35,87,4,3
5,426,426,3,3,0,1,0
9,455,455,29,9,20,3,2
12,465,465,28,28,0,1,0
13,469,469,58,11,47,3,2

0,161,161,39,26,13,2,1
5,191,191,1,1,0,1,0
1,269,269,39,13,26,4,3
4,275,275,35,10,25,2,1
6,317,317,98,98,0,1,0
2,458,458,52,52,0,1,0
3,472,472,31,21,10,3,2

1,203,203,12,2,10,3,2
8,221,221,53,31,22,3,2
3,253,253,40,28,12,2,1
2,266,266,43,5,38,4,3
5,351,351,38,38,0,1,0
4,366,366,40,40,0,1,0
0,426,426,6,2,4,2,1
7,444,444,59,26,33,4,3
6,452,452,11,11,0,1,0

7,108,108,1,1,0,1,0
2,114,114,12,5,7,2,1
3,188,188,16,6,10,3,2
0,279,279,16,4,12,3,2
1,303,303,60,16,44,3,2
8,327,327,145,145,0,1,0
6,421,421,1,1,0,1,0
5,458,458,22,12,10,3,2
4,482,482,27,27,0,1,0

1,120,120,12,12,0,1,0
5,238,238,42,4,38,2,1
6,247,247,37,37,0,1,0
2,248,248,54,54,0,1,0
7,274,274,31,31,0,1,0
0,434,434,22,4,18,2,1
3,474,474,9,9,0,1,0
8,475,475,32,20,12,2,1
4,490,490,56,38,18,3,2

0,125,125,4,1,3,2,1
3,144,144,40,28,12,2,1
10,166,166,3,3,0,1,0
5,196,196,4,4,0,1,0
9,280,280,17,17,0,1,0
7,308,308,33,6,27,2,1
2,340,340,5,5,0,1,0
4,349,349,5,2,3,2,1
8,366,366,117,79,38,3,2
6,368,368,9,3,6,2,1
1,466,466,55,55,0,1,0

3,173,173,50,50,0,1,0
2,174,174,5,5,0,1,0
4,208,208,13,13,0,1,0
0,445,445,223,223,0,1,0
1,463,463,63,2,61,3,2

2,248,248,26,10,16,2,1
3,305,305,60,60,0,1,0
5,322,322,25,11,14,2,1
4,439,439,77,77,0,1,0
6,472,472,26,26,0,1,0
1,475,475,139,139,0,1,0
0,484,484,50,50,0,1,0

5,117,117,5,5,0,1,0
4,172,172,33,33,0,1,0
7,186,186,11,5,6,3,2
1,201,201,1,1,0,1,0
3,213,213,46,14,32,3,2
6,227,227,86,36,50,4,3
2,390,390,9,9,0,1,0
0,430,430,28,28,0,1,0
8,500,500,13,13,0,1,0

0,230,230,12,2,10,2,1
7,249,249,33,15,18,4,3
3,256,256,47,11,36,3,2
4,299,299,59,59,0,1,0
6,341,341,30,30,0,1,0
2,440,440,23,6,17,2,1
1,455,455,97,47,50,3,2
5,477,477,42,42,0,1,0

1,120,120,9,9,0,1,0
9,162,162,38,4,34,2,1
6,168,168,27,15,12,4,3
8,227,227,26,6,20,3,2
4,287,287,35,31,4,2,1
0,294,294,14,2,12,3,2
5,319,319,21,21,0,1,0
10,327,327,48,48,0,1,0
7,412,412,4,4,0,1,0
3,436,436,7,4,3,2,1
2,462,462,6,3,3,2,1

7,122,122,5,2,3,2,1
5,132,132,24,14,10,3,2
1,263,263,15,15,0,1,0
9,325,325,139,68,71,3,2
6,347,347,10,10,0,1,0
2,371,371,64,40,24,3,2
4,374,374,9,9,0,1,0
0,432,432,25,25,0,1,0
8,482,482,6,6,0,1,0
3,495,495,6,6,0,1,0

0,102,102,51,51,0,1,0
3,182,182,14,7,7,3,2
4,375,375,24,24,0,1,0
2,448,448,38,38,0,1,0
1,475,475,133,88,45,4,3

5,105,105,14,2,12,2,1
1,126,126,14,14,0,1,0
4,136,136,13,5,8,2,1
3,153,153,22,9,13,2,1
2,225,225,29,29,0,1,0
6,311,311,66,66,0,1,0
7,359,359,25,25,0,1,0
0,439,439,52,30,22,3,2

5,110,110,9,5,4,2,1
0,155,155,6,6,0,1,0
3,163,163,24,24,0,1,0
8,201,201,48,48,0,1,0
2,325,325,91,91,0,1,0
1,352,352,5,5,0,1,0
4,359,359,8,8,0,1,0
7,366,366,43,43,0,1,0
6,432,432,30,23,7,2,1

7,185,185,26,12,14,3,2
5,252,252,4,1,3,2,1
6,278,278,74,61,13,2,1
1,327,327,47,41,6,2,1
2,345,345,93,75,18,2,1
3,389,389,8,8,0,1,0
4,444,444,38,38,0,1,0
0,452,452,30,30,0,1,0

1,127,127,42,12,30,4,3
3,198,198,9,9,0,1,0
0,206,206,26,23,3,2,1
7,230,230,10,10,0,1,0
5,307,307,38,11,27,2,1
4,331,331,37,28,9,2,1
6,455,455,104,47,57,4,3
2,480,480,1,1,0,1,0

5,103,103,7,7,0,1,0
9,139,139,5,2,3,2,1
4,141,141,2,2,0,1,0
8,222,222,13,13,0,1,0
0,225,225,9,9,0,1,0
1,325,325,46,42,4,2,1
7,367,367,74,53,21,2,1
2,386,386,1,1,0,1,0
6,445,445,93,50,43,3,2
3,471,471,114,19,95,3,2

1,158,158,14,3,11,2,1
5,187,187,1,1,0,1,0
9,234,234,2,2,0,1,0
4,286,286,25,1,24,4,3
0,318,318,69,60,9,4,3
8,352,352,74,74,0,1,0
2,363,363,15,15,0,1,0
7,375,375,8,1,7,2,1
6,436,436,8,8,0,1,0
10,494,494,132,129,3,2,1
3,500,500,22,5,17,2,1

4,256,256,37,16,21,4,3
5,294,294,39,39,0,1,0
3,298,298,27,27,0,1,0
7,342,342,43,1,42,3,2
2,350,350,2,2,0,1,0
6,355,355,36,36,0,1,0
0,413,413,8,8,0,1,0
1,470,470,181,143,38,4,3

7,103,103,2,2,0,1,0
2,106,106,32,32,0,1,0
5,113,113,28,28,0,1,0
8,191,191,28,28,0,1,0
6,272,272,27,15,12,4,3
4,325,325,32,17,15,2,1
3,357,357,14,11,3,2,1
1,375,375,22,22,0,1,0
0,377,377,1,1,0,1,0

6,144,144,19,19,0,1,0
2,200,200,23,23,0,1,0
3,206,206,14,14,0,1,0
7,232,232,35,35,0,1,0
0,233,233,16,16,0,1,0
8,265,265,6,6,0,1,0
4,280,280,37,25,12,3,2
5,352,352,71,12,59,3,2
1,466,466,55,29,26,2,1

3,127,127,15,15,0,1,0
4,155,155,8,2,6,3,2
0,173,173,8,8,0,1,0
2,299,299,74,74,0,1,0
5,391,391,93,93,0,1,0
6,419,419,40,4,36,4,3
1,451,451,94,28,66,4,3

3,114,114,3,3,0,1,0
10,122,122,8,2,6,2,1
8,216,216,51,42,9,4,3
1,222,222,1,1,0,1,0
7,246,246,26,26,0,1,0
0,274,274,26,2,24,3,2
2,282,282,29,19,10,2,1
6,361,361,56,56,0,1,0
4,413,413,18,15,3,2,1
9,415,415,42,42,0,1,0
5,487,487,36,3,33,2,1

11,100,100,20,7,13,3,2
0,232,232,14,4,10,2,1
3,240,240,4,4,0,1,0
1,304,304,41,13,28,3,2
5,316,316,5,5,0,1,0
9,338,338,31,31,0,1,0
2,352,352,16,16,0,1,0
7,362,362,8,2,6,2,1
8,376,376,64,22,42,4,3
6,388,388,33,33,0,1,0
10,468,468,21,6,15,2,1
4,489,489,59,59,0,1,0

3,104,104,2,2,0,1,0
0,137,137,65,13,52,3,2
6,194,194,12,4,8,3,2
5,207,207,19,7,12,4,3
1,294,294,1,1,0,1,0
2,430,430,10,10,0,1,0
4,472,472,158,136,22,3,2

8,132,132,20,20,0,1,0
7,154,154,34,31,3,2,1
0,250,250,31,2,29,2,1
6,307,307,32,32,0,1,0
5,322,322,10,10,0,1,0
3,352,352,49,49,0,1,0
1,385,385,4,4,0,1,0
2,414,414,43,35,8,3,2
4,491,491,61,16,45,2,1

4,134,134,1,1,0,1,0
5,163,163,31,4,27,4,3
11,167,167,31,31,0,1,0
10,186,186,44,9,35,3,2
2,203,203,1,1,0,1,0
12,205,205,1,1,0,1,0
13,282,282,23,23,0,1,0
8,316,316,9,9,0,1,0
9,323,323,8,2,6,3,2
0,338,338,44,44,0,1,0
6,344,344,2,2,0,1,0
3,349,349,5,5,0,1,0
1,394,394,19,19,0,1,0
7,399,399,19,19,0,1,0

0,121,121,61,52,9,4,3
1,175,175,38,38,0,1,0
2,341,341,26,5,21,2,1
4,393,393,76,76,0,1,0
3,454,454,10,2,8,3,2

10,135,135,32,22,10,2,1
7,149,149,7,7,0,1,0
8,168,168,20,11,9,4,3
9,195,195,23,23,0,1,0
5,207,207,5,5,0,1,0
1,235,235,3,3,0,1,0
2,269,269,31,31,0,1,0
6,360,360,33,33,0,1,0
3,379,379,40,40,0,1,0
0,448,448,62,62,0,1,0
4,475,475,6,2,4,2,1

0,164,164,41,41,0,1,0
1,178,178,45,45,0,1,0
2,235,235,34,34,0,1,0
5,271,271,42,42,0,1,0
3,281,281,6,6,0,1,0
4,440,440,81,37,44,3,2

2,120,120,7,2,5,2,1
6,204,204,36,36,0,1,0
4,205,205,8,8,0,1,0
1,226,226,28,28,0,1,0
8,249,249,17,1,16,2,1
5,254,254,5,2,3,2,1
3,267,267,55,5,50,2,1
9,342,342,30,30,0,1,0
0,382,382,21,21,0,1,0
7,447,447,79,45,34,3,2

1,111,111,6,2,4,2,1
0,165,165,6,6,0,1,0
8,190,190,19,19,0,1,0
11,199,199,63,26,37,2,1
5,204,204,8,8,0,1,0
2,268,268,5,2,3,2,1
9,290,290,6,6,0,1,0
4,352,352,4,1,3,2,1
10,391,391,20,10,10,3,2
6,466,466,42,42,0,1,0
12,482,482,56,56,0,1,0
3,488,488,16,16,0,1,0
7,493,493,60,60,0,1,0

8,115,115,38,15,23,2,1
5,166,166,31,15,16,3,2
3,187,187,10,1,9,4,3
4,220,220,20,20,0,1,0
10,221,221,11,2,9,2,1
9,364,364,1,1,0,1,0
0,367,367,17,2,15,4,3
1,409,409,35,11,24,3,2
6,426,426,8,1,7,2,1
2,451,451,9,9,0,1,0
7,495,495,61,61,0,1,0

8,140,140,10,10,0,1,0
10,174,174,17,17,0,1,0
9,178,178,42,42,0,1,0
4,214,214,18,2,16,2,1
5,274,274,11,11,0,1,0
0,286,286,59,59,0,1,0
1,320,320,10,1,9,4,3
3,343,343,11,11,0,1,0
7,419,419,44,11,33,4,3
6,467,467,15,15,0,1,0
2,480,480,36,36,0,1,0

5,100,100,17,13,4,2,1
9,151,151,10,10,0,1,0
1,156,156,1,1,0,1,0
4,209,209,10,5,5,2,1
3,224,224,5,1,4,2,1
2,243,243,1,1,0,1,0
6,315,315,5,5,0,1,0
12,332,332,10,10,0,1,0
0,335,335,4,1,3,2,1
7,363,363,11,3,8,2,1
14,363,363,13,2,11,2,1
10,364,364,17,3,14,3,2
11,422,422,143,99,44,3,2
8,423,423,34,31,3,2,1
13,482,482,48,17,31,2,1

7,114,114,1,1,0,1,0
2,174,174,11,5,6,2,1
9,298,298,48,48,0,1,0
1,315,315,66,66,0,1,0
8,320,320,107,41,66,4,3
3,336,336,25,11,14,3,2
4,377,377,1,1,0,1,0
6,393,393,2,2,0,1,0
0,469,469,17,5,12,3,2
5,487,487,56,56,0,1,0

7,172,172,39,9,30,4,3
5,186,186,26,13,13,2,1
2,190,190,10,10,0,1,0
6,205,205,28,28,0,1,0
4,259,259,4,1,3,2,1
8,261,261,2,2,0,1,0
3,330,330,75,36,39,4,3
0,410,410,79,79,0,1,0
1,456,456,7,7,0,1,0

3,138,138,1,1,0,1,0
4,194,194,19,5,14,4,3
9,210,210,33,33,0,1,0
2,302,302,8,4,4,2,1
1,313,313,35,21,14,2,1
7,325,325,2,2,0,1,0
6,367,367,36,13,23,3,2
5,379,379,27,9,18,2,1
8,393,393,97,49,48,4,3
0,464,464,87,87,0,1,0

9,218,218,60,60,0,1,0
2,228,228,18,18,0,1,0
7,272,272,9,3,6,3,2
1,293,293,46,46,0,1,0
5,294,294,2,2,0,1,0
8,296,296,56,56,0,1,0
6,389,389,4,1,3,2,1
3,393,393,15,7,8,2,1
0,398,398,47,47,0,1,0
4,418,418,43,43,0,1,0

4,134,134,10,10,0,1,0
0,229,229,16,11,5,2,1
6,263,263,21,21,0,1,0
2,306,306,4,1,3,2,1
1,336,336,141,141,0,1,0
3,483,483,11,4,7,2,1
5,496,496,164,68,96,4,3

4,100,100,23,1,22,3,2
7,129,129,11,7,4,2,1
0,208,208,69,69,0,1,0
6,252,252,37,1,36,2,1
5,255,255,13,13,0,1,0
2,261,261,2,2,0,1,0
1,378,378,35,8,27,4,3
3,403,403,28,19,9,4,3

7,119,119,2,2,0,1,0
6,135,135,40,40,0,1,0
5,155,155,4,1,3,2,1
1,249,249,47,47,0,1,0
2,281,281,3,3,0,1,0
3,346,346,9,9,0,1,0
4,390,390,67,22,45,4,3
0,415,415,43,1,42,4,3
8,436,436,75,43,32,2,1

6,203,203,44,17,27,4,3
2,205,205,2,2,0,1,0
7,212,212,20,20,0,1,0
1,258,258,50,17,33,4,3
0,287,287,29,29,0,1,0
4,310,310,28,1,27,4,3
5,318,318,34,34,0,1,0
3,380,380,75,75,0,1,0

10,136,136,21,21,0,1,0
5,218,218,12,3,9,2,1
3,245,245,4,4,0,1,0
2,252,252,44,44,0,1,0
9,329,329,43,12,31,2,1
8,336,336,37,11,26,4,3
7,345,345,40,24,16,3,2
6,361,361,18,18,0,1,0
4,414,414,1,1,0,1,0
1,419,419,35,35,0,1,0
0,439,439,53,16,37,3,2

1,100,100,3,3,0,1,0
3,134,134,25,14,11,2,1
2,156,156,1,1,0,1,0
5,161,161,16,16,0,1,0
9,177,177,32,32,0,1,0
0,183,183,7,4,3,2,1
7,186,186,14,6,8,2,1
8,342,342,5,5,0,1,0
4,363,363,52,33,19,2,1
6,430,430,100,52,48,3,2

4,114,114,14,14,0,1,0
1,240,240,75,42,33,4,3
3,255,255,38,15,23,2,1
5,278,278,70,70,0,1,0
6,297,297,19,19,0,1,0
7,398,398,29,4,25,4,3
0,467,467,1,1,0,1,0
2,479,479,18,18,0,1,0

2,154,154,52,30,22,3,2
3,237,237,4,4,0,1,0
5,292,292,29,29,0,1,0
0,376,376,1,1,0,1,0
8,376,376,34,5,29,2,1
7,388,388,4,4,0,1,0
1,428,428,34,25,9,4,3
4,464,464,30,21,9,4,3
6,468,468,143,89,54,4,3

8,100,100,1,1,0,1,0
6,106,106,25,3,22,3,2
7,108,108,18,18,0,1,0
0,202,202,14,8,6,3,2
1,282,282,11,1,10,2,1
5,307,307,32,32,0,1,0
2,317,317,73,13,60,4,3
3,379,379,59,27,32,2,1
4,414,414,3,3,0,1,0

3,124,124,11,4,7,2,1
5,155,155,2,2,0,1,0
6,186,186,17,17,0,1,0
10,219,219,2,2,0,1,0
9,231,231,71,27,44,3,2
1,237,237,16,16,0,1,0
11,314,314,45,34,11,2,1
4,332,332,33,1,32,3,2
2,336,336,8,8,0,1,0
8,381,381,18,18,0,1,0
0,431,431,28,28,0,1,0
7,471,471,25,25,0,1,0

1,112,112,10,10,0,1,0
2,259,259,45,45,0,1,0
0,320,320,30,12,18,3,2
6,352,352,31,31,0,1,0
3,376,376,54,9,45,2,1
4,394,394,4,4,0,1,0
5,394,394,99,27,72,4,3
7,418,418,66,66,0,1,0

11,212,212,9,2,7,2,1
7,213,213,1,1,0,1,0
3,232,232,61,61,0,1,0
8,255,255,5,2,3,2,1
5,293,293,32,32,0,1,0
2,318,318,10,3,7,2,1
1,327,327,1,1,0,1,0
12,355,355,63,1,62,3,2
4,382,382,2,2,0,1,0
10,408,408,110,110,0,1,0
0,484,484,25,25,0,1,0
6,486,486,7,7,0,1,0
9,487,487,8,8,0,1,0

6,114,114,9,9,0,1,0
5,140,140,35,35,0,1,0
2,169,169,5,5,0,1,0
0,262,262,13,13,0,1,0
1,294,294,2,2,0,1,0
8,359,359,14,14,0,1,0
3,379,379,1,1,0,1,0
4,397,397,66,10,56,4,3
9,408,408,132,36,96,4,3
7,449,449,30,9,21,4,3

8,109,109,19,19,0,1,0
1,140,140,28,28,0,1,0
9,144,144,22,22,0,1,0
6,208,208,13,4,9,2,1
3,240,240,1,1,0,1,0
11,315,315,40,11,29,2,1
2,330,330,3,3,0,1,0
0,364,364,19,5,14,3,2
5,390,390,61,28,33,4,3
4,419,419,3,3,0,1,0
10,488,488,31,21,10,2,1
7,499,499,5,5,0,1,0

7,146,146,14,14,0,1,0
3,196,196,44,44,0,1,0
2,289,289,48,48,0,1,0
1,320,320,19,19,0,1,0
6,348,348,66,51,15,4,3
0,383,383,20,10,10,2,1
5,422,422,18,18,0,1,0
4,469,469,85,85,0,1,0

5,135,135,6,2,4,2,1
12,136,136,24,8,16,2,1
1,151,151,14,1,13,4,3
7,178,178,2,2,0,1,0
3,188,188,14,14,0,1,0
0,233,233,17,8,9,4,3
2,309,309,15,15,0,1,0
6,328,328,9,9,0,1,0
11,342,342,62,4,58,3,2
9,345,345,31,31,0,1,0
13,346,346,10,10,0,1,0
10,361,361,42,2,40,3,2
8,364,364,6,1,5,2,1
4,419,419,10,2,8,2,1

7,114,114,3,3,0,1,0
4,148,148,1,1,0,1,0
1,154,154,23,2,21,4,3
10,154,154,51,6,45,4,3
5,265,265,2,2,0,1,0
9,277,277,31,20,11,3,2
2,383,383,19,19,0,1,0
8,389,389,7,7,0,1,0
6,403,403,8,8,0,1,0
0,415,415,19,6,13,2,1
11,464,464,25,4,21,4,3
3,489,489,87,35,52,3,2
12,499,499,7,7,0,1,0

0,116,116,31,31,0,1,0
7,141,141,12,2,10,3,2
4,144,144,3,3,0,1,0
5,174,174,5,5,0,1,0
8,179,179,40,40,0,1,0
2,207,207,3,3,0,1,0
1,224,224,29,23,6,2,1
6,247,247,46,4,42,3,2
3,297,297,13,13,0,1,0
9,424,424,6,6,0,1,0

7,109,109,1,1,0,1,0
6,153,153,17,1,16,3,2
1,156,156,21,10,11,2,1
0,161,161,1,1,0,1,0
9,190,190,72,72,0,1,0
10,245,245,1,1,0,1,0
2,273,273,47,47,0,1,0
8,277,277,33,33,0,1,0
4,367,367,12,12,0,1,0
3,375,375,9,9,0,1,0
5,492,492,12,3,9,4,3

0,100,100,5,5,0,1,0
8,109,109,9,9,0,1,0
5,113,113,1,1,0,1,0
1,146,146,3,3,0,1,0
7,187,187,2,2,0,1,0
4,238,238,26,26,0,1,0
2,286,286,16,7,9,4,3
9,325,325,84,84,0,1,0
10,345,345,55,55,0,1,0
6,362,362,59,59,0,1,0
3,487,487,46,26,20,3,2

7,105,105,18,18,0,1,0
0,128,128,9,1,8,3,2
3,176,176,1,1,0,1,0
2,200,200,61,61,0,1,0
5,200,200,42,13,29,2,1
4,205,205,23,23,0,1,0
8,308,308,29,12,17,2,1
6,324,324,10,10,0,1,0
1,469,469,4,1,3,2,1

1,105,105,21,5,16,3,2
6,128,128,29,3,26,2,1
3,140,140,10,10,0,1,0
0,232,232,19,19,0,1,0
4,376,376,45,29,16,2,1
5,409,409,38,38,0,1,0
2,488,488,107,37,70,3,2

4,164,164,29,25,4,2,1
2,329,329,77,77,0,1,0
1,335,335,123,123,0,1,0
3,385,385,12,12,0,1,0
5,445,445,28,5,23,2,1
0,480,480,64,64,0,1,0

2,146,146,9,2,7,2,1
0,189,189,5,5,0,1,0
4,193,193,3,3,0,1,0
7,252,252,14,4,10,2,1
9,273,273,77,58,19,2,1
5,296,296,43,9,34,3,2
10,314,314,21,21,0,1,0
11,340,340,13,1,12,3,2
3,376,376,22,22,0,1,0
12,408,408,49,19,30,2,1
6,418,418,13,10,3,2,1
8,425,425,16,16,0,1,0
1,474,474,33,33,0,1,0

0,138,138,3,3,0,1,0
8,139,139,24,24,0,1,0
6,150,150,35,8,27,2,1
5,161,161,2,2,0,1,0
3,212,212,26,26,0,1,0
1,282,282,30,20,10,3,2
4,306,306,65,39,26,2,1
2,350,350,14,14,0,1,0
7,355,355,34,10,24,3,2

6,258,258,33,33,0,1,0
2,263,263,25,25,0,1,0
4,266,266,11,11,0,1,0
7,299,299,27,27,0,1,0
5,320,320,42,42,0,1,0
3,337,337,75,75,0,1,0
1,362,362,12,12,0,1,0
8,439,439,69,69,0,1,0
0,496,496,55,55,0,1,0

8,116,116,27,27,0,1,0
4,212,212,63,22,41,2,1
7,212,212,46,15,31,4,3
1,235,235,1,1,0,1,0
3,276,276,4,4,0,1,0
0,294,294,10,10,0,1,0
2,325,325,49,23,26,2,1
6,336,336,15,3,12,4,3
5,494,494,8,8,0,1,0

7,129,129,30,25,5,2,1
4,235,235,7,2,5,2,1
5,272,272,19,4,15,4,3
6,328,328,58,58,0,1,0
1,336,336,54,54,0,1,0
3,362,362,29,29,0,1,0
2,413,413,77,45,32,3,2
0,483,483,36,23,13,2,1

7,248,248,61,29,32,2,1
5,289,289,25,25,0,1,0
4,334,334,7,7,0,1,0
2,431,431,4,4,0,1,0
1,448,448,146,146,0,1,0
6,484,484,76,46,30,4,3
3,491,491,21,21,0,1,0
0,499,499,61,61,0,1,0

4,197,197,13,13,0,1,0
2,231,231,1,1,0,1,0
3,254,254,41,41,0,1,0
1,270,270,51,25,26,3,2
8,319,319,33,33,0,1,0
5,369,369,39,39,0,1,0
0,386,386,31,11,20,3,2
7,416,416,104,26,78,4,3
6,493,493,22,22,0,1,0

6,102,102,8,4,4,2,1
4,134,134,11,5,6,3,2
7,146,146,2,2,0,1,0
0,149,149,7,7,0,1,0
9,186,186,28,28,0,1,0
11,251,251,47,47,0,1,0
5,253,253,29,29,0,1,0
8,279,279,1,1,0,1,0
2,334,334,47,37,10,2,1
3,375,375,1,1,0,1,0
10,477,477,78,58,20,2,1
1,485,485,12,12,0,1,0

5,122,122,36,36,0,1,0
6,233,233,23,10,13,2,1
8,249,249,27,27,0,1,0
1,258,258,23,23,0,1,0
3,287,287,57,54,3,2,1
7,340,340,3,3,0,1,0
4,383,383,18,6,12,3,2
2,455,455,24,6,18,2,1
0,482,482,55,55,0,1,0

3,106,106,1,1,0,1,0
8,113,113,5,5,0,1,0
2,185,185,12,4,8,2,1
4,209,209,33,33,0,1,0
5,212,212,12,12,0,1,0
0,225,225,22,11,11,2,1
1,335,335,38,38,0,1,0
6,406,406,87,69,18,2,1
7,413,413,15,8,7,2,1
9,434,434,93,93,0,1,0

9,114,114,31,20,11,2,1
1,120,120,7,7,0,1,0
12,120,120,9,2,7,2,1
5,136,136,13,1,12,4,3
0,182,182,9,5,4,2,1
11,243,243,25,5,20,3,2
7,247,247,16,4,12,2,1
4,251,251,16,16,0,1,0
8,258,258,2,2,0,1,0
6,265,265,8,2,6,2,1
2,410,410,39,39,0,1,0
10,423,423,25,25,0,1,0
3,459,459,17,17,0,1,0

2,175,175,46,25,21,2,1
0,197,197,45,33,12,2,1
1,338,338,4,4,0,1,0
3,410,410,32,4,28,2,1
4,416,416,150,102,48,2,1
6,446,446,8,8,0,1,0
5,496,496,25,25,0,1,0

1,369,369,38,8,30,2,1
4,370,370,37,37,0,1,0
3,399,399,83,17,66,4,3
2,402,402,36,36,0,1,0
5,438,438,47,11,36,4,3
0,465,465,185,86,99,4,3

9,116,116,23,23,0,1,0
10,148,148,3,3,0,1,0
0,174,174,1,1,0,1,0
4,220,220,43,8,35,2,1
1,270,270,31,31,0,1,0
6,301,301,13,13,0,1,0
8,364,364,63,56,7,2,1
2,428,428,24,10,14,2,1
7,437,437,53,53,0,1,0
3,462,462,4,4,0,1,0
5,478,478,37,37,0,1,0

3,100,100,11,11,0,1,0
0,117,117,18,18,0,1,0
6,132,132,14,14,0,1,0
4,239,239,9,2,7,3,2
8,284,284,57,57,0,1,0
7,294,294,17,10,7,2,1
2,400,400,6,2,4,2,1
1,449,449,84,70,14,2,1
5,461,461,68,40,28,3,2

1,202,202,76,76,0,1,0
6,232,232,38,38,0,1,0
2,257,257,16,16,0,1,0
5,348,348,17,17,0,1,0
3,392,392,80,18,62,3,2
4,411,411,36,36,0,1,0
0,496,496,32,32,0,1,0

7,154,154,7,7,0,1,0
6,199,199,1,1,0,1,0
3,213,213,4,1,3,2,1
9,218,218,94,77,17,2,1
1,232,232,24,24,0,1,0
2,257,257,12,12,0,1,0
0,300,300,45,45,0,1,0
8,347,347,9,9,0,1,0
4,376,376,46,46,0,1,0
5,458,458,27,27,0,1,0

5,149,149,46,46,0,1,0
1,172,172,23,23,0,1,0
8,187,187,19,5,14,3,2
6,202,202,10,10,0,1,0
4,232,232,3,3,0,1,0
0,307,307,84,78,6,2,1
2,378,378,30,4,26,2,1
3,433,433,1,1,0,1,0
7,439,439,20,20,0,1,0

9,128,128,26,26,0,1,0
4,143,143,10,5,5,2,1
0,204,204,23,23,0,1,0
2,280,280,25,25,0,1,0
3,297,297,9,5,4,2,1
5,303,303,1,1,0,1,0
8,307,307,3,3,0,1,0
1,379,379,74,63,11,2,1
6,390,390,79,79,0,1,0
7,447,447,42,6,36,3,2

4,159,159,6,6,0,1,0
5,172,172,2,2,0,1,0
0,173,173,11,11,0,1,0
9,189,189,7,7,0,1,0
8,260,260,97,48,49,2,1
3,285,285,30,2,28,2,1
2,305,305,48,48,0,1,0
6,322,322,21,11,10,2,1
7,335,335,11,11,0,1,0
1,419,419,53,53,0,1,0

6,115,115,11,11,0,1,0
0,132,132,15,15,0,1,0
5,216,216,9,9,0,1,0
7,258,258,64,4,60,3,2
4,263,263,33,33,0,1,0
2,298,298,14,14,0,1,0
3,435,435,104,50,54,4,3
1,488,488,50,19,31,2,1

5,128,128,15,6,9,2,1
0,154,154,8,8,0,1,0
10,183,183,65,15,50,4,3
2,186,186,8,8,0,1,0
1,197,197,14,14,0,1,0
7,278,278,3,3,0,1,0
3,317,317,7,4,3,2,1
8,323,323,42,42,0,1,0
4,406,406,56,25,31,2,1
9,422,422,6,6,0,1,0
6,467,467,27,6,21,4,3

2,178,178,18,9,9,2,1
7,186,186,48,48,0,1,0
6,195,195,5,5,0,1,0
5,305,305,11,11,0,1,0
4,360,360,66,66,0,1,0
1,419,419,26,13,13,2,1
0,422,422,93,60,33,4,3
3,484,484,57,38,19,4,3

0,169,169,1,1,0,1,0
2,171,171,13,3,10,2,1
4,195,195,2,2,0,1,0
8,234,234,1,1,0,1,0
6,249,249,83,42,41,3,2
5,263,263,19,19,0,1,0
3,309,309,52,21,31,3,2
7,456,456,43,43,0,1,0
1,469,469,114,114,0,1,0

13,121,121,42,12,30,2,1
14,138,138,2,2,0,1,0
2,145,145,7,2,5,2,1
9,164,164,20,20,0,1,0
8,183,183,15,15,0,1,0
5,283,283,8,8,0,1,0
7,300,300,13,13,0,1,0
4,306,306,4,1,3,2,1
0,313,313,1,1,0,1,0
3,349,349,19,19,0,1,0
10,379,379,28,20,8,2,1
11,388,388,22,1,21,4,3
6,408,408,7,3,4,2,1
12,419,419,39,39,0,1,0
1,430,430,7,7,0,1,0

2,105,105,4,4,0,1,0
9,214,214,9,9,0,1,0
3,223,223,8,8,0,1,0
7,283,283,67,67,0,1,0
10,326,326,71,61,10,3,2
0,387,387,37,27,10,3,2
6,424,424,1,1,0,1,0
1,428,428,94,74,20,2,1
5,446,446,44,44,0,1,0
4,467,467,5,5,0,1,0
8,484,484,5,1,4,2,1

1,140,140,41,29,12,2,1
7,165,165,4,1,3,2,1
2,210,210,25,4,21,2,1
4,274,274,11,1,10,3,2
0,341,341,30,11,19,2,1
5,445,445,59,5,54,4,3
6,470,470,146,86,60,4,3
3,478,478,1,1,0,1,0

1,103,103,13,7,6,2,1
5,110,110,16,1,15,2,1
4,139,139,11,11,0,1,0
6,211,211,3,3,0,1,0
8,232,232,37,37,0,1,0
11,253,253,53,26,27,4,3
10,296,296,29,29,0,1,0
3,297,297,5,5,0,1,0
9,300,300,12,7,5,2,1
2,330,330,2,2,0,1,0
0,337,337,19,19,0,1,0
7,382,382,22,7,15,2,1

5,135,135,30,30,0,1,0
4,232,232,5,5,0,1,0
7,244,244,58,58,0,1,0
3,307,307,17,17,0,1,0
6,319,319,9,3,6,3,2
1,356,356,49,1,48,2,1
2,363,363,70,18,52,3,2
0,497,497,58,58,0,1,0

5,110,110,13,13,0,1,0
7,112,112,27,27,0,1,0
3,209,209,36,36,0,1,0
1,265,265,1,1,0,1,0
4,269,269,37,27,10,2,1
0,343,343,1,1,0,1,0
6,348,348,6,6,0,1,0
2,441,441,142,114,28,3,2

9,129,129,3,3,0,1,0
8,130,130,19,10,9,4,3
2,213,213,2,2,0,1,0
10,215,215,2,2,0,1,0
5,292,292,4,4,0,1,0
12,314,314,93,15,78,3,2
0,335,335,21,21,0,1,0
11,351,351,62,62,0,1,0
1,382,382,4,4,0,1,0
4,427,427,22,22,0,1,0
6,429,429,13,1,12,3,2
7,474,474,40,12,28,3,2
3,476,476,47,47,0,1,0

0,129,129,28,12,16,2,1
3,147,147,18,5,13,4,3
2,195,195,10,10,0,1,0
6,237,237,18,18,0,1,0
4,334,334,2,2,0,1,0
7,340,340,143,71,72,4,3
5,470,470,2,2,0,1,0
1,484,484,54,54,0,1,0

0,137,137,1,1,0,1,0
3,189,189,35,11,24,4,3
1,273,273,3,3,0,1,0
6,289,289,41,41,0,1,0
8,349,349,109,106,3,2,1
2,365,365,90,63,27,4,3
4,422,422,22,15,7,2,1
5,441,441,20,5,15,4,3
7,486,486,3,3,0,1,0

8,120,120,16,16,0,1,0
0,156,156,41,41,0,1,0
7,168,168,33,3,30,3,2
1,352,352,6,3,3,2,1
3,383,383,9,9,0,1,0
2,421,421,25,25,0,1,0
6,443,443,55,55,0,1,0
4,450,450,62,24,38,4,3
5,475,475,28,28,0,1,0

1,176,176,9,6,3,2,1
2,289,289,106,96,10,2,1
0,293,293,25,22,3,2,1
5,362,362,92,32,60,4,3
4,367,367,55,55,0,1,0
6,415,415,36,9,27,2,1
3,444,444,7,7,0,1,0

7,102,102,9,9,0,1,0
3,202,202,11,11,0,1,0
0,305,305,5,5,0,1,0
9,321,321,42,23,19,4,3
4,327,327,7,1,6,2,1
8,328,328,40,40,0,1,0
1,379,379,32,32,0,1,0
5,390,390,81,81,0,1,0
2,415,415,49,49,0,1,0
6,417,417,70,8,62,4,3

4,143,143,13,13,0,1,0
5,184,184,1,1,0,1,0
3,197,197,4,4,0,1,0
13,198,198,11,11,0,1,0
1,240,240,5,5,0,1,0
6,273,273,7,7,0,1,0
0,277,277,8,2,6,3,2
11,339,339,99,75,24,2,1
10,348,348,15,1,14,4,3
2,372,372,31,27,4,2,1
8,376,376,9,2,7,2,1
7,427,427,74,62,12,4,3
12,450,450,53,53,0,1,0
9,493,493,14,14,0,1,0

4,160,160,5,5,0,1,0
6,200,200,18,18,0,1,0
0,214,214,16,16,0,1,0
5,236,236,69,69,0,1,0
9,266,266,64,11,53,4,3
2,293,293,18,18,0,1,0
1,319,319,1,1,0,1,0
7,431,431,28,11,17,2,1
8,438,438,49,49,0,1,0
3,454,454,17,17,0,1,0

1,149,149,9,9,0,1,0
0,177,177,11,11,0,1,0
3,209,209,23,23,0,1,0
10,266,266,93,45,48,4,3
9,309,309,39,39,0,1,0
5,342,342,7,7,0,1,0
2,352,352,23,23,0,1,0
8,413,413,3,3,0,1,0
4,418,418,69,69,0,1,0
7,466,466,11,11,0,1,0
6,469,469,8,5,3,2,1

6,148,148,13,5,8,3,2
4,184,184,8,1,7,2,1
8,184,184,45,30,15,4,3
3,221,221,5,2,3,2,1
7,236,236,25,25,0,1,0
11,281,281,3,3,0,1,0
2,314,314,35,19,16,3,2
10,347,347,50,16,34,3,2
1,357,357,18,13,5,2,1
5,422,422,4,4,0,1,0
9,428,428,47,47,0,1,0
0,433,433,31,31,0,1,0

10,166,166,15,2,13,2,1
4,172,172,22,14,8,3,2
6,184,184,20,20,0,1,0
2,204,204,2,2,0,1,0
8,237,237,38,38,0,1,0
3,266,266,5,1,4,2,1
7,307,307,5,5,0,1,0
0,323,323,28,4,24,4,3
1,341,341,29,3,26,2,1
5,399,399,19,19,0,1,0
11,445,445,57,57,0,1,0
9,489,489,64,54,10,3,2

5,143,143,1,1,0,1,0
1,180,180,26,6,20,4,3
6,180,180,23,23,0,1,0
11,241,241,11,7,4,2,1
2,308,308,8,8,0,1,0
0,334,334,9,2,7,2,1
8,351,351,68,22,46,2,1
10,362,362,59,25,34,4,3
7,374,374,29,4,25,2,1
3,395,395,22,22,0,1,0
9,451,451,47,47,0,1,0
4,467,467,17,17,0,1,0

3,196,196,31,31,0,1,0
5,265,265,12,12,0,1,0
0,360,360,6,6,0,1,0
4,399,399,52,52,0,1,0
1,438,438,136,43,93,4,3
6,446,446,77,23,54,4,3
2,490,490,85,42,43,2,1

7,114,114,16,3,13,2,1
1,132,132,13,13,0,1,0
4,161,161,29,1,28,3,2
2,253,253,33,33,0,1,0
0,313,313,28,28,0,1,0
5,396,396,56,56,0,1,0
3,399,399,73,57,16,2,1
6,498,498,23,11,12,2,1

1,117,117,54,51,3,2,1
5,124,124,21,12,9,4,3
3,203,203,22,22,0,1,0
2,223,223,26,10,16,3,2
4,355,355,40,35,5,2,1
0,496,496,20,20,0,1,0

7,114,114,7,7,0,1,0
6,222,222,6,6,0,1,0
5,244,244,82,39,43,4,3
4,278,278,6,3,3,2,1
0,307,307,56,56,0,1,0
1,335,335,19,19,0,1,0
2,366,366,68,56,12,2,1
3,412,412,23,23,0,1,0
8,419,419,37,12,25,2,1

5,154,154,8,8,0,1,0
8,229,229,67,22,45,4,3
3,242,242,57,57,0,1,0
7,267,267,40,40,0,1,0
2,270,270,15,9,6,3,2
4,327,327,6,3,3,2,1
0,339,339,10,2,8,3,2
1,339,339,4,4,0,1,0
10,398,398,8,5,3,2,1
9,466,466,20,20,0,1,0
6,476,476,47,47,0,1,0

4,158,158,5,5,0,1,0
7,186,186,1,1,0,1,0
9,231,231,73,73,0,1,0
3,248,248,1,1,0,1,0
1,281,281,10,10,0,1,0
8,307,307,20,20,0,1,0
2,347,347,9,9,0,1,0
5,358,358,53,14,39,4,3
6,379,379,46,46,0,1,0
0,437,437,112,7,105,4,3

1,114,114,3,3,0,1,0
5,164,164,9,9,0,1,0
3,168,168,31,2,29,2,1
0,302,302,5,5,0,1,0
6,310,310,74,41,33,4,3
8,378,378,5,5,0,1,0
4,419,419,109,100,9,4,3
7,442,442,88,49,39,2,1
2,472,472,7,7,0,1,0

5,107,107,8,8,0,1,0
6,172,172,1,1,0,1,0
8,287,287,24,4,20,2,1
10,303,303,7,7,0,1,0
3,357,357,2,2,0,1,0
7,359,359,18,18,0,1,0
4,371,371,43,29,14,2,1
1,382,382,4,4,0,1,0
9,384,384,55,55,0,1,0
11,412,412,77,77,0,1,0
2,429,429,23,23,0,1,0
0,443,443,45,45,0,1,0
12,469,469,71,71,0,1,0

6,148,148,41,4,37,3,2
3,161,161,30,30,0,1,0
5,197,197,8,8,0,1,0
2,315,315,14,2,12,4,3
8,346,346,47,47,0,1,0
0,349,349,46,13,33,4,3
7,353,353,21,13,8,3,2
1,402,402,21,11,10,2,1
4,442,442,38,38,0,1,0

1,121,121,8,4,4,2,1
4,141,141,10,10,0,1,0
2,310,310,47,47,0,1,0
6,335,335,31,31,0,1,0
0,381,381,77,17,60,4,3
5,389,389,53,53,0,1,0
3,390,390,32,32,0,1,0
7,492,492,102,41,61,4,3

9,225,225,52,18,34,3,2
1,260,260,10,1,9,2,1
3,262,262,20,20,0,1,0
6,266,266,4,4,0,1,0
8,270,270,21,21,0,1,0
4,337,337,7,3,4,2,1
7,345,345,64,64,0,1,0
5,385,385,19,7,12,4,3
0,434,434,11,11,0,1,0
2,435,435,127,70,57,4,3

8,100,100,17,7,10,3,2
7,107,107,18,7,11,2,1
6,113,113,3,3,0,1,0
5,171,171,29,29,0,1,0
4,283,283,28,28,0,1,0
2,314,314,23,5,18,4,3
3,346,346,16,16,0,1,0
1,370,370,20,20,0,1,0
0,490,490,30,27,3,2,1
9,499,499,72,72,0,1,0

6,139,139,52,52,0,1,0
0,239,239,25,25,0,1,0
4,313,313,31,6,25,2,1
3,328,328,9,3,6,2,1
5,345,345,8,1,7,2,1
2,391,391,3,3,0,1,0
1,442,442,160,141,19,2,1
7,474,474,6,6,0,1,0

6,137,137,3,3,0,1,0
2,224,224,64,64,0,1,0
3,254,254,105,93,12,4,3
5,349,349,23,23,0,1,0
4,353,353,2,2,0,1,0
0,413,413,54,37,17,2,1
1,483,483,41,41,0,1,0

7,199,199,1,1,0,1,0
6,214,214,16,16,0,1,0
9,224,224,30,21,9,2,1
5,236,236,42,42,0,1,0
1,244,244,14,6,8,2,1
3,265,265,3,3,0,1,0
12,270,270,59,9,50,3,2
10,339,339,9,9,0,1,0
2,340,340,25,13,12,2,1
11,354,354,45,45,0,1,0
8,365,365,8,2,6,3,2
4,448,448,15,15,0,1,0
0,462,462,21,21,0,1,0

9,129,129,8,8,0,1,0
5,193,193,9,9,0,1,0
4,203,203,21,16,5,2,1
8,237,237,11,6,5,2,1
7,246,246,53,53,0,1,0
0,278,278,34,34,0,1,0
1,294,294,23,8,15,4,3
6,308,308,4,1,3,2,1
2,311,311,7,2,5,2,1
3,334,334,39,31,8,3,2
10,411,411,76,50,26,2,1

1,156,156,19,19,0,1,0
3,192,192,26,26,0,1,0
6,205,205,23,23,0,1,0
4,424,424,40,10,30,2,1
2,453,453,18,12,6,2,1
5,456,456,116,2,114,4,3
0,476,476,97,49,48,2,1
7,487,487,22,6,16,3,2

4,130,130,23,7,16,3,2
8,160,160,11,11,0,1,0
0,294,294,24,24,0,1,0
6,309,309,38,26,12,4,3
7,322,322,68,49,19,2,1
1,347,347,4,4,0,1,0
5,377,377,39,5,34,2,1
3,406,406,37,20,17,2,1
2,430,430,60,50,10,2,1

4,140,140,1,1,0,1,0
7,180,180,23,13,10,2,1
2,190,190,8,1,7,2,1
5,190,190,1,1,0,1,0
9,206,206,11,11,0,1,0
6,229,229,23,6,17,3,2
0,273,273,1,1,0,1,0
1,278,278,1,1,0,1,0
13,370,370,69,69,0,1,0
12,383,383,41,41,0,1,0
8,425,425,66,19,47,2,1
3,430,430,1,1,0,1,0
10,467,467,88,52,36,2,1
11,475,475,11,11,0,1,0

1,112,112,17,17,0,1,0
3,115,115,3,3,0,1,0
2,160,160,9,3,6,3,2
5,198,198,27,27,0,1,0
6,198,198,10,2,8,2,1
0,269,269,29,29,0,1,0
8,284,284,63,41,22,2,1
7,419,419,39,39,0,1,0
4,497,497,79,46,33,2,1

5,100,100,4,4,0,1,0
2,311,311,68,17,51,3,2
3,358,358,62,62,0,1,0
4,429,429,34,34,0,1,0
0,437,437,175,81,94,3,2
1,448,448,45,45,0,1,0

3,116,116,11,2,9,4,3
8,135,135,13,1,12,2,1
2,188,188,9,3,6,2,1
6,232,232,76,31,45,4,3
0,296,296,4,4,0,1,0
7,384,384,32,32,0,1,0
5,428,428,2,2,0,1,0
1,441,441,74,24,50,4,3
4,441,441,78,78,0,1,0

0,164,164,10,10,0,1,0
6,175,175,9,9,0,1,0
2,201,201,5,5,0,1,0
11,211,211,9,9,0,1,0
10,230,230,70,70,0,1,0
3,232,232,22,22,0,1,0
1,306,306,12,12,0,1,0
8,309,309,16,16,0,1,0
12,315,315,40,37,3,2,1
5,385,385,20,20,0,1,0
4,483,483,42,23,19,2,1
9,491,491,15,15,0,1,0
7,497,497,19,7,12,4,3

14,170,170,6,1,5,2,1
10,230,230,19,19,0,1,0
9,238,238,4,4,0,1,0
2,276,276,13,13,0,1,0
4,277,277,10,6,4,2,1
8,303,303,1,1,0,1,0
7,319,319,3,3,0,1,0
13,356,356,53,53,0,1,0
11,392,392,16,16,0,1,0
12,405,405,113,113,0,1,0
3,414,414,2,2,0,1,0
5,435,435,11,1,10,4,3
0,439,439,74,48,26,3,2
6,444,444,5,2,3,2,1
1,474,474,46,10,36,4,3

8,170,170,12,6,6,3,2
2,174,174,11,4,7,2,1
7,193,193,12,2,10,2,1
5,246,246,17,17,0,1,0
12,265,265,6,2,4,2,1
4,293,293,18,18,0,1,0
6,356,356,41,9,32,2,1
0,404,404,17,17,0,1,0
3,414,414,3,3,0,1,0
11,420,420,81,57,24,3,2
9,421,421,80,80,0,1,0
1,431,431,6,6,0,1,0
10,464,464,47,47,0,1,0

3,142,142,29,9,20,2,1
5,142,142,16,6,10,2,1
2,153,153,5,5,0,1,0
1,154,154,15,15,0,1,0
7,243,243,7,7,0,1,0
6,245,245,7,2,5,2,1
4,247,247,2,2,0,1,0
8,285,285,3,3,0,1,0
9,351,351,102,72,30,4,3
0,358,358,7,7,0,1,0
10,452,452,81,70,11,2,1

6,161,161,11,5,6,2,1
5,169,169,9,9,0,1,0
3,215,215,6,3,3,2,1
4,247,247,14,14,0,1,0
2,281,281,26,26,0,1,0
0,298,298,91,41,50,3,2
1,323,323,25,17,8,3,2
7,446,446,146,102,44,4,3

8,181,181,19,19,0,1,0
2,267,267,11,3,8,2,1
1,278,278,51,51,0,1,0
7,314,314,87,87,0,1,0
0,411,411,38,22,16,2,1
5,427,427,8,3,5,2,1
3,444,444,41,41,0,1,0
4,492,492,45,45,0,1,0
6,495,495,54,37,17,3,2

5,123,123,28,5,23,3,2
4,206,206,48,48,0,1,0
7,227,227,1,1,0,1,0
3,271,271,37,3,34,2,1
0,367,367,70,20,50,3,2
1,414,414,28,28,0,1,0
2,437,437,46,46,0,1,0
6,496,496,21,21,0,1,0

0,155,155,24,24,0,1,0
8,180,180,20,20,0,1,0
1,222,222,3,3,0,1,0
3,251,251,2,2,0,1,0
9,254,254,53,53,0,1,0
5,262,262,5,1,4,2,1
6,329,329,27,3,24,3,2
2,352,352,31,31,0,1,0
11,352,352,63,63,0,1,0
10,356,356,2,2,0,1,0
7,404,404,1,1,0,1,0
4,423,423,56,56,0,1,0

6,205,205,14,14,0,1,0
0,260,260,19,9,10,2,1
3,299,299,2,2,0,1,0
1,439,439,42,42,0,1,0
5,442,442,7,4,3,2,1
2,457,457,149,26,123,4,3
4,492,492,30,9,21,4,3
7,494,494,179,88,91,3,2

5,208,208,5,2,3,2,1
4,242,242,29,29,0,1,0
6,242,242,73,73,0,1,0
2,278,278,45,1,44,3,2
1,335,335,30,30,0,1,0
3,398,398,26,26,0,1,0
0,463,463,116,116,0,1,0

3,142,142,11,5,6,2,1
7,149,149,4,1,3,2,1
6,188,188,50,50,0,1,0
5,328,328,53,26,27,2,1
0,381,381,30,30,0,1,0
2,439,439,3,3,0,1,0
4,441,441,23,12,11,2,1
1,454,454,153,135,18,3,2

0,151,151,4,1,3,2,1
12,151,151,31,25,6,3,2
9,159,159,1,1,0,1,0
3,197,197,14,2,12,4,3
1,201,201,4,1,3,2,1
6,243,243,23,3,20,2,1
14,258,258,16,16,0,1,0
8,260,260,5,5,0,1,0
10,287,287,17,7,10,2,1
2,291,291,4,4,0,1,0
15,310,310,38,8,30,4,3
4,323,323,29,29,0,1,0
13,376,376,44,33,11,2,1
11,382,382,18,18,0,1,0
7,420,420,9,9,0,1,0
5,498,498,16,9,7,2,1

7,161,161,12,12,0,1,0
2,182,182,25,25,0,1,0
8,191,191,3,3,0,1,0
9,195,195,26,26,0,1,0
4,217,217,13,4,9,2,1
3,237,237,16,9,7,2,1
6,345,345,99,62,37,4,3
1,366,366,24,24,0,1,0
0,467,467,57,57,0,1,0
5,499,499,24,7,17,2,1

3,105,105,38,6,32,2,1
5,127,127,16,16,0,1,0
0,200,200,16,1,15,2,1
4,208,208,4,4,0,1,0
8,277,277,26,26,0,1,0
6,283,283,7,7,0,1,0
2,306,306,7,7,0,1,0
7,325,325,86,27,59,4,3
1,490,490,10,3,7,2,1

8,129,129,42,4,38,2,1
0,199,199,13,13,0,1,0
6,230,230,6,6,0,1,0
3,253,253,43,7,36,3,2
7,313,313,4,4,0,1,0
2,365,365,20,12,8,3,2
4,383,383,15,8,7,3,2
9,402,402,60,24,36,4,3
1,434,434,64,64,0,1,0
5,450,450,11,4,7,2,1

2,150,150,3,3,0,1,0
9,168,168,1,1,0,1,0
12,194,194,34,34,0,1,0
6,263,263,19,13,6,2,1
8,301,301,16,7,9,4,3
13,330,330,20,8,12,2,1
3,333,333,1,1,0,1,0
1,339,339,7,7,0,1,0
4,346,346,62,55,7,2,1
10,403,403,26,26,0,1,0
0,421,421,42,42,0,1,0
5,470,470,2,2,0,1,0
7,470,470,22,7,15,4,3
11,477,477,98,77,21,3,2

8,113,113,9,9,0,1,0
5,135,135,13,13,0,1,0
0,151,151,5,5,0,1,0
2,158,158,18,9,9,4,3
10,183,183,3,3,0,1,0
3,285,285,38,2,36,4,3
1,297,297,31,26,5,2,1
7,377,377,92,92,0,1,0
9,462,462,78,57,21,2,1
6,478,478,7,4,3,2,1
4,498,498,3,3,0,1,0

1,126,126,8,3,5,2,1
3,288,288,36,8,28,3,2
10,299,299,73,27,46,4,3
5,326,326,2,2,0,1,0
4,349,349,57,41,16,3,2
2,376,376,36,30,6,2,1
7,455,455,8,5,3,2,1
6,457,457,6,6,0,1,0
9,463,463,90,6,84,3,2
0,470,470,8,4,4,2,1
8,481,481,22,22,0,1,0
11,487,487,11,1,10,3,2

5,116,116,7,1,6,3,2
7,148,148,9,9,0,1,0
1,166,166,6,1,5,2,1
2,263,263,67,67,0,1,0
6,284,284,37,37,0,1,0
3,325,325,52,52,0,1,0
4,341,341,89,27,62,4,3
0,500,500,25,21,4,2,1

6,133,133,5,5,0,1,0
10,146,146,34,16,18,4,3
8,148,148,5,5,0,1,0
9,160,160,7,7,0,1,0
7,166,166,45,45,0,1,0
11,229,229,47,34,13,2,1
4,254,254,2,2,0,1,0
3,351,351,33,6,27,4,3
1,363,363,14,14,0,1,0
0,366,366,16,10,6,3,2
2,384,384,2,2,0,1,0
5,411,411,2,2,0,1,0

7,171,171,36,7,29,2,1
0,285,285,43,16,27,4,3
8,310,310,31,11,20,2,1
1,317,317,25,21,4,2,1
4,329,329,4,4,0,1,0
3,331,331,40,40,0,1,0
9,367,367,3,3,0,1,0
6,419,419,79,70,9,2,1
5,428,428,35,6,29,4,3
2,479,479,27,12,15,2,1

8,108,108,11,11,0,1,0
2,118,118,1,1,0,1,0
5,139,139,55,48,7,2,1
7,142,142,27,15,12,4,3
6,210,210,31,14,17,2,1
1,218,218,1,1,0,1,0
9,261,261,18,18,0,1,0
3,283,283,1,1,0,1,0
4,297,297,3,3,0,1,0
0,332,332,26,1,25,3,2

3,115,115,22,22,0,1,0
1,223,223,25,25,0,1,0
5,235,235,23,5,18,4,3
2,267,267,75,23,52,3,2
6,274,274,28,4,24,3,2
4,300,300,36,24,12,3,2
0,449,449,49,33,16,3,2

7,109,109,6,6,0,1,0
5,152,152,15,15,0,1,0
9,153,153,28,16,12,4,3
4,192,192,2,2,0,1,0
10,225,225,27,27,0,1,0
0,312,312,69,27,42,3,2
2,363,363,30,2,28,4,3
6,381,381,7,2,5,2,1
3,481,481,28,28,0,1,0
8,493,493,75,54,21,2,1
1,495,495,6,6,0,1,0

5,119,119,10,10,0,1,0
2,150,150,16,1,15,2,1
7,184,184,1,1,0,1,0
4,200,200,1,1,0,1,0
6,219,219,28,22,6,2,1
3,270,270,36,36,0,1,0
0,287,287,11,11,0,1,0
1,346,346,1,1,0,1,0
11,356,356,71,59,12,4,3
9,367,367,83,83,0,1,0
10,437,437,26,26,0,1,0
8,486,486,10,10,0,1,0

5,181,181,22,2,20,3,2
9,223,223,31,31,0,1,0
3,224,224,22,4,18,3,2
7,230,230,3,3,0,1,0
6,253,253,63,63,0,1,0
2,283,283,7,7,0,1,0
1,373,373,50,50,0,1,0
4,374,374,36,30,6,3,2
0,393,393,12,12,0,1,0
8,399,399,43,5,38,3,2

8,100,100,13,13,0,1,0
1,129,129,10,10,0,1,0
13,135,135,6,6,0,1,0
3,146,146,11,6,5,2,1
4,195,195,6,6,0,1,0
5,198,198,11,1,10,3,2
6,240,240,1,1,0,1,0
9,275,275,6,2,4,2,1
12,316,316,67,67,0,1,0
0,321,321,13,4,9,2,1
11,321,321,60,60,0,1,0
2,339,339,2,2,0,1,0
7,374,374,22,22,0,1,0
10,486,486,31,31,0,1,0

0,100,100,6,3,3,2,1
7,118,118,31,17,14,3,2
10,128,128,3,3,0,1,0
1,191,191,13,5,8,2,1
2,327,327,43,43,0,1,0
6,333,333,40,20,20,3,2
9,361,361,10,10,0,1,0
5,369,369,4,4,0,1,0
3,435,435,21,15,6,3,2
8,443,443,87,44,43,4,3
4,457,457,28,20,8,3,2

7,169,169,4,4,0,1,0
11,201,201,12,12,0,1,0
9,203,203,59,17,42,4,3
5,227,227,1,1,0,1,0
8,235,235,20,20,0,1,0
4,258,258,62,62,0,1,0
3,311,311,3,3,0,1,0
2,343,343,14,14,0,1,0
1,406,406,8,8,0,1,0
10,431,431,30,30,0,1,0
6,467,467,41,41,0,1,0
0,495,495,39,26,13,2,1

7,145,145,4,4,0,1,0
6,169,169,19,19,0,1,0
10,186,186,4,4,0,1,0
3,205,205,14,6,8,3,2
9,242,242,5,2,3,2,1
11,297,297,67,56,11,2,1
4,298,298,3,3,0,1,0
5,332,332,46,4,42,2,1
1,377,377,5,5,0,1,0
2,429,429,24,9,15,4,3
8,434,434,105,21,84,3,2
0,448,448,34,2,32,3,2

3,126,126,6,6,0,1,0
5,158,158,18,18,0,1,0
0,186,186,1,1,0,1,0
4,351,351,54,49,5,2,1
6,452,452,94,56,38,3,2
7,452,452,16,16,0,1,0
1,477,477,52,2,50,4,3
2,495,495,170,78,92,4,3

11,101,101,6,1,5,2,1
10,142,142,1,1,0,1,0
5,143,143,8,8,0,1,0
14,148,148,13,13,0,1,0
4,197,197,1,1,0,1,0
13,248,248,57,9,48,4,3
2,292,292,6,6,0,1,0
15,295,295,50,14,36,2,1
9,301,301,13,13,0,1,0
6,341,341,33,18,15,4,3
12,351,351,8,8,0,1,0
0,353,353,4,4,0,1,0
3,363,363,46,24,22,3,2
7,370,370,11,11,0,1,0
1,395,395,4,4,0,1,0
8,495,495,17,14,3,2,1

6,133,133,11,11,0,1,0
8,148,148,35,35,0,1,0
4,203,203,55,55,0,1,0
1,245,245,31,8,23,2,1
5,374,374,18,8,10,2,1
0,394,394,19,19,0,1,0
3,428,428,16,13,3,2,1
2,470,470,9,9,0,1,0
7,495,495,69,69,0,1,0

11,136,136,41,16,25,3,2
5,143,143,3,3,0,1,0
7,173,173,24,24,0,1,0
12,191,191,12,7,5,2,1
1,214,214,3,3,0,1,0
4,226,226,5,5,0,1,0
3,227,227,13,1,12,3,2
10,252,252,32,27,5,2,1
0,343,343,42,42,0,1,0
2,345,345,6,6,0,1,0
8,348,348,25,25,0,1,0
9,407,407,1,1,0,1,0
13,421,421,7,7,0,1,0
6,438,438,15,7,8,3,2

8,106,106,3,3,0,1,0
4,113,113,1,1,0,1,0
7,169,169,6,2,4,2,1
11,219,219,10,4,6,3,2
0,270,270,1,1,0,1,0
9,270,270,13,3,10,3,2
3,320,320,11,11,0,1,0
10,337,337,131,131,0,1,0
1,393,393,3,3,0,1,0
5,410,410,9,2,7,2,1
2,461,461,32,32,0,1,0
6,473,473,151,76,75,4,3

9,135,135,30,30,0,1,0
2,146,146,2,2,0,1,0
5,296,296,13,13,0,1,0
8,314,314,7,7,0,1,0
0,317,317,24,5,19,2,1
6,317,317,1,1,0,1,0
10,328,328,62,48,14,3,2
3,393,393,85,75,10,3,2
4,431,431,58,27,31,3,2
1,447,447,6,6,0,1,0
7,478,478,35,1,34,2,1

6,108,108,1,1,0,1,0
7,148,148,10,2,8,3,2
11,186,186,63,50,13,2,1
4,211,211,6,6,0,1,0
12,234,234,15,15,0,1,0
2,286,286,22,6,16,3,2
0,303,303,18,18,0,1,0
3,364,364,1,1,0,1,0
1,393,393,7,3,4,2,1
9,418,418,40,16,24,4,3
8,420,420,21,21,0,1,0
5,455,455,43,37,6,3,2
13,478,478,31,16,15,4,3
10,489,489,20,20,0,1,0

0,266,266,34,34,0,1,0
3,302,302,45,13,32,3,2
6,361,361,125,125,0,1,0
1,383,383,139,75,64,3,2
5,390,390,2,2,0,1,0
4,398,398,2,2,0,1,0
2,399,399,4,4,0,1,0

0,113,113,2,2,0,1,0
1,183,183,5,5,0,1,0
7,193,193,2,2,0,1,0
9,229,229,16,4,12,4,3
13,263,263,13,8,5,2,1
8,266,266,4,4,0,1,0
10,267,267,2,2,0,1,0
14,277,277,7,7,0,1,0
3,300,300,7,7,0,1,0
6,400,400,39,11,28,2,1
12,400,400,50,22,28,2,1
2,433,433,14,14,0,1,0
11,447,447,138,138,0,1,0
5,459,459,25,3,22,3,2
4,467,467,69,29,40,2,1

5,107,107,8,5,3,2,1
3,113,113,2,2,0,1,0
0,209,209,11,11,0,1,0
1,216,216,5,2,3,2,1
8,258,258,38,38,0,1,0
9,302,302,52,41,11,2,1
2,370,370,82,42,40,2,1
7,394,394,55,55,0,1,0
4,479,479,53,40,13,2,1
6,493,493,23,23,0,1,0

2,144,144,5,5,0,1,0
9,265,265,10,10,0,1,0
8,286,286,13,5,8,2,1
5,294,294,78,52,26,3,2
4,295,295,1,1,0,1,0
3,341,341,20,20,0,1,0
6,394,394,44,34,10,2,1
7,453,453,140,94,46,3,2
0,461,461,12,12,0,1,0
1,480,480,54,12,42,4,3

0,149,149,13,9,4,2,1
3,262,262,48,44,4,2,1
2,312,312,111,31,80,4,3
6,315,315,50,38,12,4,3
5,381,381,47,21,26,4,3
1,403,403,24,24,0,1,0
4,449,449,17,17,0,1,0

3,109,109,10,2,8,2,1
0,251,251,27,27,0,1,0
5,292,292,68,30,38,2,1
2,314,314,109,22,87,4,3
6,328,328,31,31,0,1,0
4,337,337,30,30,0,1,0
1,446,446,21,21,0,1,0

9,212,212,4,4,0,1,0
2,273,273,12,12,0,1,0
5,275,275,21,15,6,3,2
8,300,300,83,44,39,4,3
4,349,349,104,10,94,3,2
7,392,392,31,19,12,2,1
6,408,408,54,24,30,2,1
3,452,452,3,3,0,1,0
1,468,468,20,5,15,2,1
0,489,489,17,17,0,1,0

3,134,134,24,24,0,1,0
6,171,171,18,1,17,4,3
2,174,174,2,2,0,1,0
7,234,234,54,36,18,4,3
0,293,293,25,8,17,2,1
4,311,311,48,48,0,1,0
5,481,481,46,31,15,4,3
1,485,485,34,10,24,2,1
8,489,489,37,2,35,3,2

6,165,165,1,1,0,1,0
3,170,170,1,1,0,1,0
8,183,183,3,3,0,1,0
5,217,217,11,7,4,2,1
0,300,300,91,91,0,1,0
7,303,303,65,7,58,4,3
1,312,312,12,3,9,4,3
9,326,326,89,89,0,1,0
4,363,363,18,18,0,1,0
2,483,483,26,26,0,1,0

4,104,104,20,20,0,1,0
2,213,213,1,1,0,1,0
12,243,243,7,7,0,1,0
3,255,255,3,3,0,1,0
6,281,281,2,2,0,1,0
7,399,399,23,17,6,2,1
11,423,423,1,1,0,1,0
9,435,435,151,70,81,4,3
1,447,447,1,1,0,1,0
5,469,469,13,13,0,1,0
8,469,469,69,36,33,2,1
10,477,477,61,61,0,1,0
0,479,479,24,24,0,1,0

1,130,130,2,2,0,1,0
9,179,179,2,2,0,1,0
0,235,235,43,13,30,2,1
5,325,325,32,20,12,2,1
7,337,337,2,2,0,1,0
3,375,375,39,39,0,1,0
4,409,409,15,15,0,1,0
2,418,418,18,18,0,1,0
10,419,419,94,94,0,1,0
11,420,420,69,22,47,2,1
6,432,432,6,1,5,2,1
8,497,497,53,11,42,2,1

5,192,192,39,39,0,1,0
3,288,288,59,59,0,1,0
6,306,306,15,1,14,3,2
0,343,343,1,1,0,1,0
2,372,372,105,33,72,4,3
4,385,385,41,41,0,1,0
1,469,469,6,6,0,1,0
7,498,498,74,38,36,4,3

6,139,139,23,11,12,3,2
8,211,211,17,4,13,2,1
2,292,292,6,6,0,1,0
0,369,369,10,10,0,1,0
4,369,369,25,10,15,2,1
7,423,423,65,65,0,1,0
5,450,450,34,20,14,3,2
3,481,481,145,126,19,2,1
1,484,484,4,4,0,1,0
9,499,499,56,56,0,1,0

6,176,176,71,15,56,3,2
3,223,223,15,8,7,2,1
8,250,250,2,2,0,1,0
7,255,255,8,1,7,2,1
0,354,354,30,12,18,4,3
1,397,397,12,8,4,2,1
5,402,402,27,18,9,2,1
4,411,411,37,37,0,1,0
2,425,425,97,27,70,3,2

1,102,102,3,3,0,1,0
8,123,123,4,1,3,2,1
2,263,263,37,19,18,2,1
10,264,264,21,21,0,1,0
0,287,287,21,21,0,1,0
9,374,374,29,29,0,1,0
5,380,380,21,21,0,1,0
6,399,399,26,4,22,4,3
3,401,401,50,50,0,1,0
7,412,412,132,48,84,4,3
4,427,427,5,5,0,1,0

5,135,135,12,12,0,1,0
6,161,161,13,7,6,2,1
8,182,182,38,38,0,1,0
7,253,253,20,10,10,3,2
2,255,255,43,1,42,3,2
0,341,341,60,60,0,1,0
4,353,353,5,1,4,2,1
3,389,389,16,16,0,1,0
9,444,444,62,62,0,1,0
1,499,499,6,6,0,1,0

7,101,101,8,8,0,1,0
5,131,131,1,1,0,1,0
11,158,158,29,29,0,1,0
10,211,211,12,4,8,3,2
1,234,234,50,50,0,1,0
3,240,240,24,2,22,3,2
2,310,310,1,1,0,1,0
0,330,330,20,2,18,4,3
9,338,338,67,11,56,3,2
4,376,376,6,6,0,1,0
6,377,377,10,2,8,2,1
8,388,388,27,8,19,2,1

13,119,119,6,2,4,2,1
2,127,127,4,4,0,1,0
5,185,185,22,13,9,4,3
10,192,192,2,2,0,1,0
0,205,205,9,9,0,1,0
11,225,225,49,49,0,1,0
6,247,247,14,14,0,1,0
3,255,255,2,2,0,1,0
7,262,262,18,18,0,1,0
14,271,271,58,15,43,3,2
9,300,300,9,9,0,1,0
4,305,305,5,5,0,1,0
1,395,395,17,6,11,2,1
12,448,448,12,6,6,2,1
8,495,495,36,36,0,1,0

5,121,121,7,7,0,1,0
6,122,122,3,3,0,1,0
1,213,213,18,6,12,2,1
4,240,240,14,1,13,2,1
3,242,242,40,40,0,1,0
7,242,242,29,29,0,1,0
2,300,300,26,26,0,1,0
0,346,346,8,8,0,1,0
10,373,373,7,4,3,2,1
8,378,378,122,62,60,3,2
9,437,437,18,18,0,1,0

7,103,103,25,25,0,1,0
6,134,134,24,5,19,2,1
8,150,150,16,16,0,1,0
1,184,184,32,32,0,1,0
3,265,265,4,4,0,1,0
9,287,287,41,29,12,4,3
4,294,294,22,22,0,1,0
2,381,381,14,14,0,1,0
10,403,403,10,10,0,1,0
0,405,405,6,3,3,2,1
5,447,447,3,3,0,1,0

6,117,117,16,16,0,1,0
2,119,119,1,1,0,1,0
7,183,183,14,2,12,4,3
3,230,230,26,26,0,1,0
1,252,252,7,7,0,1,0
0,295,295,27,4,23,2,1
5,312,312,78,32,46,3,2
8,364,364,29,20,9,2,1
4,449,449,5,5,0,1,0
9,475,475,102,102,0,1,0

3,168,168,1,1,0,1,0
8,237,237,12,12,0,1,0
2,239,239,50,5,45,2,1
6,256,256,56,35,21,2,1
5,272,272,23,23,0,1,0
1,358,358,14,14,0,1,0
4,358,358,52,46,6,2,1
7,411,411,62,62,0,1,0
0,429,429,44,44,0,1,0

2,114,114,15,15,0,1,0
6,153,153,37,4,33,4,3
0,166,166,2,2,0,1,0
4,261,261,32,32,0,1,0
7,265,265,6,3,3,2,1
1,294,294,23,23,0,1,0
9,294,294,48,48,0,1,0
8,373,373,30,30,0,1,0
5,420,420,16,16,0,1,0
3,432,432,51,51,0,1,0

6,136,136,2,2,0,1,0
4,141,141,19,1,18,3,2
3,220,220,22,2,20,3,2
8,225,225,13,1,12,2,1
7,253,253,31,31,0,1,0
0,273,273,9,1,8,3,2
2,319,319,33,33,0,1,0
5,396,396,126,64,62,4,3
1,464,464,62,62,0,1,0

3,102,102,5,2,3,2,1
6,181,181,12,4,8,3,2
8,211,211,50,46,4,2,1
2,225,225,2,2,0,1,0
7,230,230,25,25,0,1,0
4,262,262,81,66,15,2,1
9,356,356,13,5,8,2,1
0,376,376,15,1,14,3,2
5,424,424,11,11,0,1,0
10,435,435,54,54,0,1,0
1,492,492,3,3,0,1,0

5,128,128,22,22,0,1,0
1,132,132,1,1,0,1,0
3,273,273,13,13,0,1,0
7,289,289,59,13,46,2,1
6,290,290,31,16,15,2,1
4,301,301,3,3,0,1,0
0,356,356,67,67,0,1,0
8,431,431,10,2,8,2,1
2,436,436,108,66,42,4,3

1,120,120,21,14,7,2,1
3,166,166,5,5,0,1,0
8,184,184,19,19,0,1,0
2,226,226,4,4,0,1,0
5,231,231,71,67,4,2,1
6,295,295,24,11,13,2,1
0,379,379,90,17,73,4,3
4,427,427,17,7,10,3,2
7,487,487,8,5,3,2,1

1,131,131,49,9,40,3,2
2,139,139,12,6,6,2,1
6,203,203,51,3,48,3,2
5,296,296,19,7,12,4,3
4,324,324,24,24,0,1,0
7,339,339,39,9,30,2,1
3,348,348,11,3,8,2,1
0,418,418,4,4,0,1,0

7,149,149,41,24,17,2,1
2,200,200,14,1,13,2,1
6,231,231,43,43,0,1,0
0,279,279,89,89,0,1,0
8,299,299,4,4,0,1,0
5,318,318,12,12,0,1,0
4,348,348,35,35,0,1,0
3,477,477,1,1,0,1,0
1,482,482,5,5,0,1,0

6,102,102,6,1,5,2,1
4,113,113,9,6,3,2,1
1,172,172,10,2,8,3,2
9,179,179,4,4,0,1,0
5,191,191,1,1,0,1,0
7,348,348,14,7,7,2,1
3,352,352,7,7,0,1,0
13,384,384,139,23,116,4,3
10,393,393,13,13,0,1,0
8,416,416,50,11,39,4,3
2,425,425,1,1,0,1,0
11,468,468,30,30,0,1,0
12,475,475,22,22,0,1,0
0,497,497,49,1,48,3,2

4,125,125,12,12,0,1,0
1,185,185,86,86,0,1,0
3,270,270,16,8,8,3,2
2,296,296,44,18,26,2,1
0,316,316,12,1,11,2,1
5,471,471,97,97,0,1,0

0,109,109,1,1,0,1,0
3,201,201,19,2,17,2,1
4,283,283,18,18,0,1,0
8,318,318,24,19,5,2,1
1,366,366,39,6,33,3,2
6,373,373,17,17,0,1,0
5,407,407,42,42,0,1,0
7,409,409,51,51,0,1,0
9,429,429,111,93,18,4,3
2,499,499,62,33,29,2,1

3,197,197,74,65,9,2,1
5,315,315,4,4,0,1,0
2,352,352,64,23,41,2,1
0,363,363,90,82,8,3,2
4,411,411,33,33,0,1,0
1,440,440,32,32,0,1,0
6,451,451,16,16,0,1,0

10,101,101,22,7,15,3,2
8,116,116,3,3,0,1,0
1,120,120,14,14,0,1,0
7,126,126,7,7,0,1,0
0,133,133,11,7,4,2,1
4,155,155,22,22,0,1,0
2,306,306,3,3,0,1,0
9,328,328,70,70,0,1,0
3,355,355,2,2,0,1,0
5,411,411,32,32,0,1,0
6,411,411,27,11,16,2,1

8,149,149,25,1,24,2,1
4,163,163,22,22,0,1,0
0,177,177,38,20,18,2,1
1,242,242,10,10,0,1,0
2,276,276,1,1,0,1,0
5,298,298,25,18,7,2,1
9,331,331,41,20,21,2,1
3,354,354,8,1,7,2,1
7,394,394,25,13,12,2,1
6,433,433,66,66,0,1,0

5,106,106,13,7,6,3,2
0,236,236,36,36,0,1,0
8,268,268,81,11,70,3,2
3,292,292,51,51,0,1,0
4,296,296,4,4,0,1,0
6,359,359,5,5,0,1,0
1,429,429,45,45,0,1,0
7,486,486,33,7,26,2,1
2,490,490,27,11,16,3,2

6,107,107,25,6,19,2,1
0,136,136,5,5,0,1,0
4,141,141,6,6,0,1,0
2,163,163,40,7,33,4,3
9,247,247,33,6,27,2,1
7,249,249,23,11,12,4,3
3,314,314,34,34,0,1,0
8,368,368,19,19,0,1,0
5,408,408,15,15,0,1,0
1,491,491,15,3,12,3,2

4,102,102,5,5,0,1,0
8,119,119,7,7,0,1,0
5,152,152,28,28,0,1,0
3,155,155,2,2,0,1,0
0,168,168,25,13,12,4,3
7,251,251,71,71,0,1,0
6,271,271,34,34,0,1,0
1,287,287,26,26,0,1,0
9,458,458,19,14,5,2,1
2,481,481,7,7,0,1,0

0,141,141,33,33,0,1,0
6,167,167,6,6,0,1,0
7,204,204,17,17,0,1,0
4,214,214,11,11,0,1,0
9,236,236,54,54,0,1,0
8,249,249,41,41,0,1,0
1,273,273,7,7,0,1,0
5,347,347,1,1,0,1,0
2,451,451,23,7,16,3,2
3,451,451,61,11,50,3,2

6,131,131,2,2,0,1,0
7,132,132,2,2,0,1,0
0,164,164,16,11,5,2,1
5,213,213,25,25,0,1,0
1,233,233,24,6,18,4,3
3,288,288,32,4,28,3,2
4,301,301,109,109,0,1,0
2,451,451,86,86,0,1,0

1,125,125,28,9,19,2,1
7,153,153,28,19,9,2,1
4,160,160,2,2,0,1,0
3,218,218,13,13,0,1,0
2,312,312,61,39,22,3,2
5,313,313,69,40,29,2,1
0,448,448,11,11,0,1,0
6,468,468,42,24,18,3,2

4,106,106,5,5,0,1,0
2,118,118,22,22,0,1,0
0,153,153,5,5,0,1,0
3,173,173,16,7,9,2,1
6,197,197,5,1,4,2,1
5,216,216,27,27,0,1,0
7,331,331,103,103,0,1,0
8,362,362,56,56,0,1,0
1,366,366,7,1,6,3,2
9,382,382,5,5,0,1,0

1,133,133,1,1,0,1,0
7,186,186,10,10,0,1,0
4,264,264,46,13,33,2,1
3,274,274,98,86,12,4,3
6,321,321,77,41,36,4,3
5,348,348,13,4,9,4,3
2,410,410,38,10,28,3,2
0,449,449,20,20,0,1,0

2,130,130,2,2,0,1,0
0,132,132,8,5,3,2,1
10,174,174,18,18,0,1,0
4,263,263,2,2,0,1,0
1,276,276,46,46,0,1,0
6,332,332,53,53,0,1,0
5,355,355,32,17,15,2,1
8,404,404,27,27,0,1,0
7,446,446,104,64,40,4,3
9,456,456,47,21,26,3,2
3,495,495,1,1,0,1,0

11,133,133,36,17,19,2,1
9,180,180,7,7,0,1,0
3,209,209,7,7,0,1,0
6,228,228,3,3,0,1,0
2,365,365,1,1,0,1,0
10,389,389,33,33,0,1,0
0,407,407,45,45,0,1,0
7,424,424,6,6,0,1,0
4,436,436,5,5,0,1,0
8,455,455,54,2,52,3,2
5,460,460,62,62,0,1,0
1,480,480,87,17,70,3,2

0,147,147,5,5,0,1,0
3,159,159,30,21,9,2,1
8,252,252,1,1,0,1,0
5,304,304,128,128,0,1,0
4,309,309,15,15,0,1,0
1,310,310,24,3,21,4,3
7,353,353,22,3,19,2,1
6,395,395,7,7,0,1,0
2,403,403,62,24,38,2,1

2,118,118,13,13,0,1,0
0,178,178,20,20,0,1,0
7,207,207,41,12,29,2,1
5,293,293,22,22,0,1,0
1,329,329,10,6,4,2,1
6,351,351,22,4,18,4,3
4,379,379,60,20,40,3,2
8,390,390,67,67,0,1,0
3,494,494,45,33,12,4,3

4,117,117,18,18,0,1,0
7,127,127,28,28,0,1,0
1,147,147,19,5,14,2,1
9,178,178,4,4,0,1,0
2,246,246,1,1,0,1,0
5,254,254,26,26,0,1,0
3,278,278,29,13,16,3,2
8,292,292,46,46,0,1,0
0,317,317,2,2,0,1,0
6,451,451,48,48,0,1,0

3,142,142,17,8,9,4,3
5,194,194,5,5,0,1,0
10,209,209,20,6,14,2,1
6,242,242,67,27,40,2,1
9,259,259,1,1,0,1,0
4,288,288,6,6,0,1,0
8,363,363,35,35,0,1,0
0,387,387,11,5,6,3,2
1,418,418,4,4,0,1,0
2,424,424,9,9,0,1,0
7,475,475,147,72,75,3,2

5,115,115,12,12,0,1,0
6,155,155,1,1,0,1,0
1,170,170,12,12,0,1,0
9,188,188,47,40,7,2,1
0,190,190,5,5,0,1,0
7,314,314,43,43,0,1,0
10,317,317,36,2,34,3,2
3,380,380,14,3,11,2,1
8,393,393,2,2,0,1,0
4,414,414,57,21,36,2,1
2,455,455,54,54,0,1,0

3,149,149,39,39,0,1,0
2,153,153,1,1,0,1,0
4,168,168,3,3,0,1,0
1,176,176,5,1,4,2,1
0,221,221,46,31,15,4,3
6,273,273,114,106,8,2,1
7,350,350,22,13,9,4,3
5,415,415,3,3,0,1,0

0,111,111,5,5,0,1,0
10,115,115,31,31,0,1,0
6,181,181,17,17,0,1,0
4,236,236,38,38,0,1,0
1,380,380,9,9,0,1,0
5,449,449,31,7,24,3,2
7,469,469,22,6,16,2,1
8,469,469,15,15,0,1,0
9,472,472,73,53,20,3,2
3,482,482,39,1,38,3,2
2,500,500,14,14,0,1,0

8,175,175,27,27,0,1,0
0,178,178,18,5,13,2,1
6,193,193,24,24,0,1,0
5,197,197,4,1,3,2,1
2,322,322,7,2,5,2,1
4,356,356,10,10,0,1,0
10,361,361,37,7,30,2,1
9,408,408,50,50,0,1,0
1,429,429,61,61,0,1,0
3,466,466,31,31,0,1,0
7,474,474,60,37,23,2,1

3,136,136,10,5,5,2,1
8,211,211,17,3,14,3,2
1,216,216,76,2,74,4,3
0,263,263,1,1,0,1,0
6,276,276,16,16,0,1,0
7,297,297,62,62,0,1,0
4,335,335,13,13,0,1,0
5,373,373,60,52,8,2,1
2,379,379,13,4,9,4,3

2,101,101,21,8,13,2,1
1,126,126,5,5,0,1,0
7,162,162,7,1,6,3,2
3,236,236,19,19,0,1,0
5,272,272,36,36,0,1,0
6,324,324,20,9,11,2,1
9,325,325,106,70,36,4,3
4,345,345,12,3,9,2,1
0,402,402,3,3,0,1,0
8,481,481,37,8,29,4,3

5,195,195,39,15,24,4,3
1,214,214,10,1,9,3,2
0,300,300,137,125,12,4,3
3,383,383,9,9,0,1,0
2,410,410,104,104,0,1,0
4,447,447,13,1,12,4,3

2,108,108,16,7,9,2,1
4,111,111,2,2,0,1,0
0,146,146,1,1,0,1,0
7,230,230,31,4,27,4,3
1,299,299,55,55,0,1,0
3,307,307,46,4,42,2,1
8,340,340,2,2,0,1,0
5,414,414,20,20,0,1,0
6,482,482,152,152,0,1,0

0,118,118,6,6,0,1,0
2,266,266,78,32,46,3,2
4,286,286,38,38,0,1,0
6,295,295,11,11,0,1,0
5,303,303,37,3,34,2,1
1,346,346,55,55,0,1,0
3,423,423,90,90,0,1,0

6,150,150,11,1,10,2,1
5,156,156,14,14,0,1,0
0,157,157,48,7,41,2,1
3,238,238,10,4,6,3,2
4,290,290,5,5,0,1,0
1,316,316,1,1,0,1,0
7,376,376,119,119,0,1,0
8,385,385,10,10,0,1,0
2,415,415,56,56,0,1,0

7,106,106,23,5,18,2,1
2,113,113,1,1,0,1,0
1,137,137,2,2,0,1,0
6,290,290,2,2,0,1,0
9,362,362,80,80,0,1,0
0,390,390,17,13,4,2,1
8,396,396,24,24,0,1,0
5,432,432,35,31,4,2,1
3,448,448,87,54,33,2,1
4,469,469,75,34,41,2,1

16,102,102,16,16,0,1,0
11,156,156,4,4,0,1,0
1,164,164,4,4,0,1,0
12,166,166,1,1,0,1,0
9,188,188,1,1,0,1,0
15,190,190,1,1,0,1,0
6,247,247,11,11,0,1,0
2,249,249,3,3,0,1,0
5,280,280,21,13,8,2,1
4,280,280,9,9,0,1,0
17,308,308,74,24,50,2,1
0,326,326,28,11,17,2,1
8,348,348,1,1,0,1,0
3,376,376,25,25,0,1,0
13,412,412,26,26,0,1,0
10,413,413,23,23,0,1,0
14,414,414,43,43,0,1,0
7,486,486,1,1,0,1,0

3,114,114,6,6,0,1,0
9,159,159,32,32,0,1,0
2,193,193,17,17,0,1,0
4,235,235,10,10,0,1,0
5,239,239,8,8,0,1,0
11,245,245,18,6,12,2,1
7,421,421,2,2,0,1,0
6,448,448,17,8,9,4,3
8,450,450,53,39,14,2,1
12,468,468,82,82,0,1,0
1,472,472,57,57,0,1,0
0,477,477,1,1,0,1,0
10,479,479,26,21,5,2,1

4,126,126,22,22,0,1,0
7,210,210,40,2,38,3,2
0,238,238,6,6,0,1,0
5,316,316,63,63,0,1,0
3,324,324,13,2,11,2,1
2,371,371,88,58,30,4,3
1,480,480,13,13,0,1,0
6,489,489,22,13,9,2,1
8,500,500,36,10,26,2,1

5,130,130,23,11,12,4,3
3,149,149,4,1,3,2,1
6,251,251,3,3,0,1,0
1,333,333,37,4,33,2,1
0,360,360,8,8,0,1,0
2,454,454,167,47,120,4,3
4,483,483,141,141,0,1,0

5,177,177,10,3,7,2,1
7,251,251,2,2,0,1,0
3,350,350,28,22,6,2,1
8,361,361,21,21,0,1,0
1,364,364,2,2,0,1,0
0,366,366,93,93,0,1,0
4,424,424,30,10,20,3,2
2,450,450,17,7,10,3,2
9,483,483,76,64,12,3,2
6,493,493,138,90,48,4,3

1,142,142,1,1,0,1,0
7,156,156,19,3,16,2,1
6,163,163,3,3,0,1,0
8,207,207,23,10,13,2,1
3,276,276,35,35,0,1,0
2,334,334,43,14,29,3,2
5,346,346,90,90,0,1,0
0,368,368,85,18,67,4,3
4,419,419,3,3,0,1,0

2,131,131,5,5,0,1,0
4,234,234,47,47,0,1,0
5,246,246,45,7,38,3,2
6,300,300,15,15,0,1,0
3,338,338,48,29,19,2,1
0,361,361,36,36,0,1,0
7,401,401,29,29,0,1,0
1,425,425,94,68,26,2,1

5,173,173,13,13,0,1,0
0,228,228,13,3,10,2,1
4,266,266,4,4,0,1,0
9,273,273,59,59,0,1,0
7,277,277,34,1,33,2,1
6,280,280,19,19,0,1,0
8,324,324,3,3,0,1,0
3,362,362,12,4,8,3,2
10,409,409,65,65,0,1,0
1,441,441,59,59,0,1,0
2,480,480,57,9,48,2,1

0,115,115,16,5,11,4,3
1,155,155,14,14,0,1,0
7,207,207,39,16,23,2,1
3,253,253,17,17,0,1,0
6,321,321,76,34,42,3,2
2,349,349,63,63,0,1,0
5,410,410,10,4,6,3,2
4,441,441,11,11,0,1,0
8,496,496,27,27,0,1,0

6,116,116,32,32,0,1,0
0,137,137,17,17,0,1,0
3,198,198,5,5,0,1,0
4,251,251,30,30,0,1,0
1,381,381,22,6,16,2,1
5,477,477,43,43,0,1,0
2,489,489,156,156,0,1,0

0,141,141,7,7,0,1,0
4,191,191,6,6,0,1,0
7,226,226,18,18,0,1,0
2,239,239,21,21,0,1,0
5,239,239,27,27,0,1,0
10,295,295,6,6,0,1,0
9,307,307,60,42,18,4,3
1,353,353,9,9,0,1,0
11,359,359,83,83,0,1,0
6,393,393,17,17,0,1,0
8,478,478,28,28,0,1,0
3,499,499,35,25,10,3,2

2,124,124,17,14,3,2,1
0,137,137,28,16,12,2,1
5,207,207,9,9,0,1,0
3,307,307,6,3,3,2,1
6,321,321,7,7,0,1,0
1,332,332,18,18,0,1,0
4,339,339,7,1,6,2,1
10,357,357,81,81,0,1,0
8,396,396,52,52,0,1,0
7,428,428,19,7,12,2,1
9,441,441,45,4,41,4,3

0,114,114,1,1,0,1,0
5,143,143,5,5,0,1,0
2,176,176,9,9,0,1,0
4,203,203,15,3,12,2,1
8,269,269,58,58,0,1,0
3,384,384,55,30,25,3,2
6,429,429,52,52,0,1,0
1,467,467,106,106,0,1,0
7,494,494,66,49,17,2,1

1,123,123,11,1,10,3,2
5,156,156,2,2,0,1,0
2,157,157,7,7,0,1,0
3,277,277,50,50,0,1,0
7,305,305,90,90,0,1,0
0,352,352,66,66,0,1,0
4,390,390,20,8,12,4,3
6,395,395,58,55,3,2,1

9,111,111,2,2,0,1,0
1,163,163,15,15,0,1,0
2,199,199,10,4,6,2,1
5,249,249,16,4,12,2,1
0,297,297,11,6,5,2,1
4,328,328,45,11,34,3,2
8,408,408,38,10,28,2,1
3,441,441,54,10,44,2,1
6,453,453,29,24,5,2,1
7,486,486,160,80,80,3,2

8,106,106,1,1,0,1,0
6,114,114,1,1,0,1,0
5,197,197,22,1,21,2,1
12,256,256,33,1,32,3,2
9,378,378,91,42,49,2,1
11,412,412,13,13,0,1,0
10,419,419,44,4,40,3,2
4,421,421,20,20,0,1,0
1,434,434,35,35,0,1,0
0,443,443,76,24,52,3,2
7,467,467,17,14,3,2,1
2,477,477,1,1,0,1,0
3,489,489,19,6,13,2,1

4,115,115,1,1,0,1,0
5,143,143,24,14,10,2,1
1,202,202,1,1,0,1,0
7,271,271,58,49,9,4,3
6,279,279,21,15,6,2,1
8,302,302,46,46,0,1,0
9,347,347,23,23,0,1,0
3,382,382,66,26,40,3,2
0,419,419,1,1,0,1,0
2,491,491,72,22,50,2,1

2,187,187,17,7,10,3,2
8,275,275,13,2,11,3,2
5,320,320,31,31,0,1,0
1,365,365,2,2,0,1,0
7,371,371,123,12,111,4,3
0,407,407,7,1,6,2,1
4,418,418,137,128,9,4,3
6,450,450,13,7,6,3,2
3,478,478,29,29,0,1,0

8,135,135,35,35,0,1,0
2,147,147,4,4,0,1,0
9,164,164,7,1,6,3,2
3,221,221,18,2,16,3,2
0,258,258,92,72,20,2,1
1,261,261,7,2,5,2,1
4,315,315,1,1,0,1,0
6,442,442,11,11,0,1,0
5,490,490,3,3,0,1,0
7,498,498,90,43,47,2,1

7,108,108,35,35,0,1,0
8,161,161,3,3,0,1,0
1,243,243,28,13,15,4,3
0,287,287,23,8,15,4,3
9,359,359,54,32,22,2,1
6,369,369,5,5,0,1,0
2,393,393,51,39,12,2,1
5,393,393,35,23,12,2,1
4,440,440,28,7,21,2,1
3,492,492,12,9,3,2,1

3,123,123,22,9,13,2,1
4,182,182,33,30,3,2,1
1,355,355,22,22,0,1,0
7,370,370,77,37,40,2,1
0,395,395,22,16,6,3,2
6,421,421,4,4,0,1,0
5,436,436,48,48,0,1,0
2,498,498,103,95,8,3,2

4,205,205,35,23,12,4,3
6,215,215,21,6,15,4,3
0,260,260,24,24,0,1,0
5,339,339,49,43,6,3,2
3,362,362,27,27,0,1,0
7,407,407,81,24,57,4,3
8,423,423,28,28,0,1,0
2,442,442,35,8,27,4,3
1,452,452,38,34,4,2,1

10,112,112,38,5,33,4,3
0,115,115,1,1,0,1,0
13,122,122,8,8,0,1,0
3,164,164,1,1,0,1,0
9,194,194,17,17,0,1,0
7,199,199,10,7,3,2,1
4,213,213,6,6,0,1,0
8,242,242,8,8,0,1,0
5,248,248,8,8,0,1,0
1,272,272,24,24,0,1,0
6,414,414,20,3,17,2,1
11,429,429,40,40,0,1,0
2,433,433,52,52,0,1,0
12,470,470,4,4,0,1,0

6,107,107,18,18,0,1,0
0,110,110,28,28,0,1,0
5,215,215,1,1,0,1,0
1,218,218,37,5,32,2,1
3,291,291,4,1,3,2,1
2,294,294,5,5,0,1,0
7,388,388,16,16,0,1,0
9,396,396,25,25,0,1,0
4,415,415,18,6,12,2,1
8,483,483,113,113,0,1,0

11,102,102,19,19,0,1,0
3,151,151,9,9,0,1,0
1,153,153,6,3,3,2,1
13,163,163,17,17,0,1,0
8,190,190,4,4,0,1,0
6,210,210,7,7,0,1,0
10,219,219,9,9,0,1,0
0,220,220,5,5,0,1,0
4,258,258,4,4,0,1,0
2,265,265,26,22,4,2,1
9,317,317,8,4,4,2,1
7,355,355,15,15,0,1,0
14,396,396,63,63,0,1,0
12,450,450,27,4,23,2,1
5,484,484,51,51,0,1,0

2,109,109,25,12,13,2,1
4,146,146,3,3,0,1,0
0,148,148,4,4,0,1,0
11,148,148,18,6,12,2,1
7,248,248,1,1,0,1,0
9,306,306,42,42,0,1,0
3,360,360,14,1,13,2,1
6,360,360,46,16,30,4,3
8,366,366,12,7,5,2,1
5,416,416,1,1,0,1,0
10,427,427,92,14,78,3,2
12,453,453,16,4,12,4,3
1,464,464,8,8,0,1,0

1,232,232,68,68,0,1,0
2,305,305,54,3,51,4,3
0,307,307,64,64,0,1,0
3,322,322,58,58,0,1,0
4,420,420,46,5,41,4,3
5,444,444,16,16,0,1,0

3,145,145,2,2,0,1,0
10,174,174,62,26,36,3,2
6,192,192,21,1,20,3,2
2,195,195,13,1,12,3,2
5,240,240,35,6,29,2,1
4,243,243,6,6,0,1,0
8,246,246,25,25,0,1,0
0,261,261,2,2,0,1,0
1,354,354,48,48,0,1,0
9,420,420,20,14,6,2,1
7,474,474,2,2,0,1,0

6,180,180,70,48,22,3,2
1,201,201,33,25,8,3,2
3,207,207,26,26,0,1,0
7,210,210,10,5,5,2,1
4,250,250,16,16,0,1,0
5,328,328,2,2,0,1,0
0,345,345,60,60,0,1,0
2,464,464,17,17,0,1,0

10,101,101,7,1,6,2,1
1,154,154,1,1,0,1,0
5,182,182,1,1,0,1,0
8,198,198,50,50,0,1,0
2,199,199,1,1,0,1,0
0,239,239,22,22,0,1,0
9,281,281,29,29,0,1,0
7,304,304,27,1,26,3,2
3,367,367,58,58,0,1,0
4,384,384,36,24,12,4,3
6,454,454,64,10,54,3,2

3,187,187,8,8,0,1,0
4,187,187,12,6,6,2,1
7,203,203,12,2,10,3,2
9,221,221,14,14,0,1,0
2,261,261,4,4,0,1,0
8,280,280,11,6,5,2,1
0,292,292,35,35,0,1,0
5,313,313,23,8,15,2,1
10,328,328,114,94,20,2,1
6,411,411,12,12,0,1,0
1,438,438,68,68,0,1,0

3,108,108,1,1,0,1,0
5,134,134,3,3,0,1,0
9,145,145,41,12,29,4,3
10,151,151,10,4,6,2,1
11,193,193,4,4,0,1,0
4,255,255,11,7,4,2,1
2,260,260,22,22,0,1,0
6,286,286,6,6,0,1,0
7,437,437,70,46,24,4,3
1,455,455,49,49,0,1,0
0,469,469,25,5,20,2,1
8,496,496,70,29,41,4,3

9,164,164,33,5,28,2,1
11,190,190,11,1,10,3,2
5,195,195,9,9,0,1,0
0,203,203,3,3,0,1,0
12,241,241,46,46,0,1,0
6,249,249,1,1,0,1,0
10,267,267,17,2,15,4,3
7,270,270,1,1,0,1,0
3,294,294,9,9,0,1,0
4,309,309,19,7,12,4,3
8,397,397,7,7,0,1,0
1,463,463,101,44,57,4,3
2,492,492,52,46,6,3,2

12,100,100,2,2,0,1,0
9,126,126,40,9,31,3,2
0,146,146,6,2,4,2,1
5,146,146,13,13,0,1,0
3,192,192,14,4,10,2,1
6,202,202,4,1,3,2,1
7,205,205,15,15,0,1,0
8,214,214,9,9,0,1,0
11,277,277,6,6,0,1,0
4,296,296,6,6,0,1,0
1,305,305,26,26,0,1,0
2,323,323,19,19,0,1,0
10,405,405,64,48,16,2,1

6,110,110,4,4,0,1,0
8,170,170,5,5,0,1,0
5,186,186,5,5,0,1,0
12,223,223,42,42,0,1,0
9,230,230,5,2,3,2,1
3,260,260,15,15,0,1,0
11,277,277,18,18,0,1,0
1,306,306,14,5,9,4,3
10,339,339,48,48,0,1,0
13,343,343,39,3,36,4,3
4,439,439,64,32,32,2,1
7,464,464,20,20,0,1,0
0,477,477,13,9,4,2,1
2,484,484,34,6,28,2,1

4,109,109,2,2,0,1,0
8,123,123,3,3,0,1,0
7,172,172,32,13,19,2,1
0,189,189,8,4,4,2,1
2,219,219,12,12,0,1,0
3,298,298,55,55,0,1,0
1,351,351,73,28,45,4,3
6,353,353,62,2,60,3,2
5,453,453,53,13,40,2,1

1,182,182,21,12,9,4,3
2,191,191,6,3,3,2,1
4,216,216,8,4,4,2,1
9,243,243,13,13,0,1,0
3,252,252,34,6,28,2,1
0,281,281,21,21,0,1,0
7,338,338,39,29,10,3,2
10,348,348,111,66,45,4,3
6,370,370,15,15,0,1,0
5,418,418,28,10,18,4,3
8,489,489,7,1,6,2,1

4,136,136,4,4,0,1,0
1,199,199,13,1,12,4,3
0,200,200,5,5,0,1,0
3,238,238,24,24,0,1,0
5,360,360,108,21,87,4,3
6,453,453,63,18,45,4,3
8,461,461,24,13,11,2,1
2,471,471,132,132,0,1,0
7,477,477,6,6,0,1,0

13,131,131,29,18,11,2,1
8,174,174,14,14,0,1,0
4,184,184,10,5,5,2,1
9,194,194,8,8,0,1,0
0,222,222,16,16,0,1,0
1,277,277,11,11,0,1,0
6,305,305,2,2,0,1,0
14,335,335,39,39,0,1,0
3,351,351,1,1,0,1,0
11,367,367,35,35,0,1,0
10,374,374,19,19,0,1,0
7,462,462,14,14,0,1,0
2,489,489,4,4,0,1,0
5,489,489,56,56,0,1,0
12,494,494,38,38,0,1,0

7,119,119,23,23,0,1,0
10,122,122,6,6,0,1,0
8,166,166,18,9,9,4,3
0,176,176,5,5,0,1,0
6,180,180,7,7,0,1,0
2,185,185,16,1,15,2,1
5,201,201,6,6,0,1,0
1,313,313,60,30,30,4,3
3,343,343,42,9,33,4,3
9,416,416,69,9,60,3,2
4,438,438,2,2,0,1,0

8,179,179,3,3,0,1,0
1,185,185,12,12,0,1,0
5,249,249,71,36,35,3,2
4,263,263,25,25,0,1,0
2,288,288,8,8,0,1,0
3,346,346,60,60,0,1,0
6,434,434,31,31,0,1,0
7,497,497,66,12,54,4,3
0,500,500,70,4,66,3,2

4,105,105,16,16,0,1,0
2,126,126,42,42,0,1,0
1,184,184,20,8,12,3,2
7,194,194,18,13,5,2,1
0,211,211,7,4,3,2,1
5,242,242,35,35,0,1,0
3,357,357,9,9,0,1,0
6,489,489,62,6,56,3,2

13,100,100,11,1,10,2,1
6,134,134,5,5,0,1,0
8,138,138,15,3,12,3,2
11,177,177,54,30,24,3,2
12,228,228,5,5,0,1,0
1,232,232,1,1,0,1,0
5,249,249,26,26,0,1,0
2,264,264,6,6,0,1,0
9,270,270,9,9,0,1,0
7,298,298,46,46,0,1,0
0,319,319,1,1,0,1,0
10,362,362,27,27,0,1,0
3,408,408,6,6,0,1,0
4,460,460,8,1,7,2,1

4,104,104,2,2,0,1,0
0,172,172,7,7,0,1,0
2,191,191,50,17,33,2,1
5,220,220,47,47,0,1,0
6,437,437,119,104,15,4,3
3,493,493,2,2,0,1,0
1,496,496,100,100,0,1,0

0,103,103,6,6,0,1,0
9,157,157,10,10,0,1,0
6,168,168,3,3,0,1,0
5,200,200,32,32,0,1,0
4,240,240,6,6,0,1,0
3,266,266,23,5,18,3,2
2,449,449,7,7,0,1,0
1,458,458,73,73,0,1,0
7,498,498,169,66,103,4,3
8,498,498,43,43,0,1,0

0,149,149,8,8,0,1,0
6,180,180,29,29,0,1,0
4,195,195,31,7,24,2,1
9,218,218,32,27,5,2,1
2,240,240,37,37,0,1,0
1,252,252,4,4,0,1,0
7,312,312,58,36,22,3,2
5,324,324,12,1,11,3,2
8,457,457,7,1,6,3,2
3,461,461,37,23,14,3,2

1,184,184,1,1,0,1,0
0,194,194,16,16,0,1,0
8,227,227,86,86,0,1,0
2,269,269,42,42,0,1,0
9,295,295,6,6,0,1,0
6,442,442,10,4,6,3,2
7,455,455,39,3,36,4,3
5,468,468,28,28,0,1,0
3,475,475,53,53,0,1,0
4,487,487,42,15,27,4,3

11,164,164,4,4,0,1,0
8,227,227,1,1,0,1,0
4,231,231,26,2,24,4,3
6,248,248,22,22,0,1,0
13,261,261,38,21,17,2,1
12,280,280,81,43,38,3,2
3,302,302,10,10,0,1,0
9,366,366,4,4,0,1,0
0,377,377,28,7,21,2,1
1,411,411,4,1,3,2,1
2,425,425,55,55,0,1,0
7,448,448,5,5,0,1,0
10,449,449,23,23,0,1,0
5,486,486,13,13,0,1,0

3,123,123,1,1,0,1,0
4,141,141,8,1,7,2,1
0,149,149,22,22,0,1,0
7,156,156,6,1,5,2,1
6,206,206,1,1,0,1,0
8,279,279,18,6,12,2,1
9,315,315,36,2,34,3,2
2,350,350,42,3,39,2,1
10,368,368,107,57,50,3,2
1,448,448,63,20,43,2,1
5,456,456,11,3,8,2,1

2,101,101,2,2,0,1,0
1,228,228,19,13,6,2,1
4,243,243,19,19,0,1,0
8,284,284,56,10,46,2,1
7,350,350,78,78,0,1,0
5,376,376,5,5,0,1,0
0,395,395,28,8,20,2,1
3,443,443,111,111,0,1,0
6,495,495,36,36,0,1,0

1,157,157,9,4,5,2,1
3,186,186,52,6,46,3,2
7,264,264,75,60,15,4,3
0,274,274,9,1,8,2,1
9,341,341,15,6,9,4,3
5,393,393,9,9,0,1,0
4,399,399,12,12,0,1,0
8,400,400,63,11,52,3,2
2,401,401,32,4,28,2,1
6,428,428,9,9,0,1,0

6,195,195,18,9,9,4,3
0,200,200,17,17,0,1,0
4,275,275,55,10,45,2,1
5,279,279,18,6,12,3,2
3,318,318,47,47,0,1,0
2,368,368,73,42,31,4,3
1,376,376,82,55,27,4,3

5,222,222,7,7,0,1,0
2,261,261,58,58,0,1,0
7,261,261,12,12,0,1,0
6,264,264,41,17,24,4,3
4,291,291,81,21,60,4,3
1,394,394,33,33,0,1,0
3,432,432,80,13,67,3,2
0,450,450,5,5,0,1,0

4,111,111,7,7,0,1,0
9,139,139,24,24,0,1,0
7,175,175,10,10,0,1,0
0,243,243,3,3,0,1,0
2,257,257,4,4,0,1,0
5,309,309,12,12,0,1,0
3,331,331,29,20,9,4,3
6,344,344,82,82,0,1,0
10,424,424,66,66,0,1,0
8,441,441,56,17,39,2,1
1,471,471,22,22,0,1,0

12,144,144,5,1,4,2,1
3,165,165,1,1,0,1,0
5,208,208,15,15,0,1,0
7,266,266,6,6,0,1,0
0,314,314,51,51,0,1,0
8,328,328,9,9,0,1,0
10,369,369,23,23,0,1,0
4,389,389,45,36,9,4,3
1,425,425,16,7,9,2,1
9,450,450,24,18,6,3,2
6,475,475,25,25,0,1,0
2,493,493,3,3,0,1,0
11,500,500,178,178,0,1,0

6,112,112,22,22,0,1,0
7,132,132,21,8,13,2,1
0,225,225,2,2,0,1,0
8,278,278,22,7,15,2,1
5,283,283,22,16,6,2,1
4,284,284,5,5,0,1,0
1,390,390,14,14,0,1,0
3,401,401,74,7,67,4,3
2,472,472,120,120,0,1,0

0,152,152,9,9,0,1,0
8,244,244,36,36,0,1,0
4,285,285,36,36,0,1,0
3,291,291,37,25,12,3,2
5,305,305,3,3,0,1,0
6,336,336,3,3,0,1,0
9,339,339,29,17,12,4,3
10,348,348,6,6,0,1,0
2,407,407,26,5,21,4,3
7,413,413,107,32,75,4,3
1,477,477,50,50,0,1,0

5,110,110,3,3,0,1,0
1,216,216,1,1,0,1,0
4,227,227,6,6,0,1,0
8,275,275,22,22,0,1,0
2,338,338,2,2,0,1,0
7,338,338,114,114,0,1,0
6,344,344,105,105,0,1,0
0,420,420,16,16,0,1,0
10,452,452,16,16,0,1,0
3,460,460,43,7,36,4,3
9,493,493,27,27,0,1,0

1,165,165,4,4,0,1,0
3,271,271,11,11,0,1,0
4,294,294,36,10,26,2,1
0,396,396,41,41,0,1,0
2,401,401,85,51,34,4,3
6,408,408,97,14,83,4,3
7,425,425,65,65,0,1,0
8,445,445,48,48,0,1,0
5,472,472,3,3,0,1,0

0,102,102,24,24,0,1,0
9,120,120,4,4,0,1,0
3,216,216,15,15,0,1,0
1,223,223,5,5,0,1,0
4,308,308,8,1,7,2,1
5,315,315,28,28,0,1,0
2,330,330,20,5,15,2,1
6,379,379,118,118,0,1,0
8,380,380,27,20,7,2,1
7,400,400,38,14,24,2,1

3,119,119,25,15,10,3,2
0,161,161,1,1,0,1,0
4,231,231,1,1,0,1,0
5,235,235,28,28,0,1,0
10,266,266,95,54,41,2,1
7,271,271,5,5,0,1,0
1,310,310,10,10,0,1,0
2,329,329,29,29,0,1,0
8,386,386,25,25,0,1,0
9,456,456,6,6,0,1,0
11,478,478,34,15,19,2,1
6,489,489,12,3,9,2,1

14,108,108,23,10,13,2,1
11,109,109,9,6,3,2,1
4,129,129,4,4,0,1,0
6,141,141,3,3,0,1,0
12,196,196,34,7,27,4,3
8,198,198,8,4,4,2,1
5,214,214,9,1,8,3,2
0,233,233,10,2,8,3,2
13,266,266,13,13,0,1,0
9,332,332,40,40,0,1,0
3,350,350,2,2,0,1,0
7,385,385,13,1,12,4,3
2,404,404,19,6,13,2,1
10,410,410,47,47,0,1,0
1,414,414,1,1,0,1,0

6,120,120,2,2,0,1,0
0,214,214,2,2,0,1,0
8,286,286,50,50,0,1,0
2,342,342,20,20,0,1,0
3,342,342,9,4,5,2,1
5,342,342,50,32,18,3,2
7,364,364,105,56,49,2,1
4,388,388,48,48,0,1,0
1,434,434,52,52,0,1,0
9,455,455,12,4,8,3,2
10,455,455,7,7,0,1,0

2,136,136,31,31,0,1,0
5,152,152,39,39,0,1,0
4,154,154,4,4,0,1,0
8,298,298,29,16,13,2,1
7,301,301,27,27,0,1,0
3,339,339,3,3,0,1,0
6,421,421,26,4,22,2,1
1,461,461,97,97,0,1,0
0,479,479,14,8,6,2,1

4,103,103,14,4,10,2,1
1,162,162,42,25,17,2,1
5,202,202,30,30,0,1,0
6,332,332,53,40,13,2,1
0,353,353,35,35,0,1,0
3,378,378,23,2,21,2,1
2,396,396,57,57,0,1,0

2,115,115,4,4,0,1,0
6,138,138,9,6,3,2,1
5,177,177,20,20,0,1,0
11,227,227,32,7,25,2,1
7,252,252,11,11,0,1,0
8,287,287,18,7,11,2,1
10,329,329,11,11,0,1,0
9,343,343,1,1,0,1,0
0,349,349,4,4,0,1,0
3,375,375,5,2,3,2,1
4,396,396,45,27,18,2,1
12,407,407,134,134,0,1,0
1,452,452,20,20,0,1,0

2,131,131,21,2,19,2,1
3,135,135,9,9,0,1,0
8,146,146,3,3,0,1,0
7,151,151,19,19,0,1,0
4,195,195,1,1,0,1,0
11,210,210,62,62,0,1,0
1,315,315,4,4,0,1,0
0,326,326,6,3,3,2,1
10,350,350,31,16,15,4,3
9,407,407,44,18,26,3,2
5,411,411,17,11,6,2,1
6,424,424,30,30,0,1,0

2,210,210,12,12,0,1,0
13,268,268,28,14,14,3,2
4,289,289,23,23,0,1,0
10,303,303,2,2,0,1,0
11,312,312,19,19,0,1,0
9,320,320,15,15,0,1,0
5,354,354,6,6,0,1,0
0,358,358,2,2,0,1,0
7,364,364,6,2,4,2,1
14,415,415,45,5,40,2,1
6,437,437,2,2,0,1,0
12,437,437,72,72,0,1,0
8,441,441,2,2,0,1,0
1,444,444,5,5,0,1,0
15,452,452,58,52,6,2,1
3,480,480,92,35,57,4,3

2,126,126,21,14,7,2,1
0,132,132,5,5,0,1,0
6,136,136,19,19,0,1,0
4,215,215,28,6,22,2,1
3,232,232,30,30,0,1,0
5,331,331,37,25,12,4,3
1,433,433,130,130,0,1,0

0,144,144,39,39,0,1,0
4,184,184,12,4,8,3,2
1,312,312,20,5,15,4,3
6,351,351,1,1,0,1,0
3,415,415,167,125,42,4,3
5,440,440,15,15,0,1,0
2,441,441,73,37,36,2,1

5,231,231,46,10,36,4,3
7,236,236,3,3,0,1,0
4,289,289,2,2,0,1,0
6,341,341,54,21,33,4,3
0,343,343,35,21,14,2,1
2,343,343,25,1,24,2,1
1,396,396,10,2,8,2,1
8,415,415,58,4,54,4,3
3,487,487,144,144,0,1,0

10,110,110,8,8,0,1,0
0,116,116,11,11,0,1,0
7,169,169,4,1,3,2,1
8,259,259,25,25,0,1,0
3,284,284,8,8,0,1,0
5,304,304,5,5,0,1,0
6,331,331,1,1,0,1,0
11,360,360,14,14,0,1,0
1,364,364,84,4,80,3,2
9,376,376,112,10,102,4,3
4,426,426,4,1,3,2,1
2,444,444,42,42,0,1,0

7,134,134,2,2,0,1,0
5,149,149,2,2,0,1,0
4,151,151,10,2,8,3,2
1,270,270,43,43,0,1,0
6,284,284,20,20,0,1,0
2,311,311,32,27,5,2,1
8,391,391,104,42,62,4,3
0,396,396,42,9,33,4,3
9,406,406,63,53,10,3,2
3,496,496,26,12,14,3,2

4,119,119,2,2,0,1,0
10,122,122,50,50,0,1,0
3,159,159,2,2,0,1,0
7,276,276,17,2,15,4,3
5,310,310,13,1,12,2,1
2,312,312,31,17,14,2,1
9,345,345,1,1,0,1,0
6,434,434,19,19,0,1,0
0,467,467,93,24,69,4,3
8,480,480,17,5,12,4,3
1,483,483,42,42,0,1,0

4,110,110,1,1,0,1,0
2,162,162,18,18,0,1,0
7,193,193,59,34,25,2,1
9,214,214,5,5,0,1,0
6,240,240,16,16,0,1,0
3,269,269,5,1,4,2,1
1,275,275,10,10,0,1,0
10,283,283,41,23,18,3,2
0,360,360,28,16,12,2,1
5,471,471,85,85,0,1,0
8,480,480,17,5,12,4,3

8,102,102,5,1,4,2,1
11,113,113,20,8,12,4,3
13,195,195,32,32,0,1,0
4,246,246,1,1,0,1,0
7,257,257,10,10,0,1,0
0,290,290,6,6,0,1,0
6,318,318,45,33,12,4,3
14,333,333,47,7,40,3,2
5,360,360,5,1,4,2,1
10,380,380,8,2,6,3,2
3,389,389,5,5,0,1,0
2,412,412,16,6,10,3,2
12,420,420,11,5,6,2,1
1,445,445,5,5,0,1,0
9,472,472,71,47,24,3,2

2,103,103,17,7,10,3,2
5,110,110,2,2,0,1,0
7,156,156,11,11,0,1,0
0,160,160,3,3,0,1,0
3,275,275,14,14,0,1,0
9,311,311,2,2,0,1,0
8,314,314,31,7,24,3,2
4,340,340,72,66,6,2,1
6,379,379,126,62,64,3,2
1,499,499,19,19,0,1,0

0,171,171,6,6,0,1,0
7,215,215,32,20,12,3,2
5,301,301,24,2,22,2,1
8,303,303,25,19,6,2,1
2,337,337,51,40,11,2,1
3,349,349,6,6,0,1,0
4,371,371,30,15,15,2,1
10,392,392,83,44,39,4,3
1,397,397,4,4,0,1,0
6,471,471,60,12,48,4,3
9,500,500,31,9,22,2,1

11,104,104,1,1,0,1,0
5,138,138,2,2,0,1,0
9,143,143,1,1,0,1,0
6,169,169,3,3,0,1,0
3,173,173,2,2,0,1,0
4,175,175,26,26,0,1,0
2,260,260,24,13,11,2,1
1,284,284,23,23,0,1,0
15,288,288,38,38,0,1,0
10,341,341,14,14,0,1,0
7,345,345,15,15,0,1,0
12,401,401,6,2,4,2,1
14,416,416,45,45,0,1,0
0,418,418,12,12,0,1,0
13,495,495,124,96,28,4,3
8,497,497,4,4,0,1,0

4,196,196,65,65,0,1,0
5,202,202,25,25,0,1,0
1,291,291,20,20,0,1,0
2,340,340,85,85,0,1,0
6,379,379,9,9,0,1,0
0,408,408,75,75,0,1,0
3,457,457,11,3,8,3,2

8,103,103,17,17,0,1,0
10,122,122,2,2,0,1,0
11,125,125,13,5,8,3,2
0,140,140,2,2,0,1,0
5,164,164,1,1,0,1,0
2,171,171,7,1,6,2,1
3,223,223,21,7,14,3,2
9,244,244,56,39,17,2,1
6,290,290,37,3,34,3,2
1,350,350,40,40,0,1,0
7,373,373,26,23,3,2,1
4,496,496,17,3,14,3,2

11,141,141,29,8,21,4,3
6,151,151,1,1,0,1,0
2,167,167,6,6,0,1,0
4,168,168,10,10,0,1,0
5,198,198,6,1,5,2,1
1,225,225,15,15,0,1,0
0,239,239,33,33,0,1,0
3,251,251,7,7,0,1,0
10,353,353,34,34,0,1,0
12,410,410,59,59,0,1,0
9,428,428,26,17,9,2,1
8,432,432,20,20,0,1,0
7,437,437,39,30,9,2,1

0,123,123,1,1,0,1,0
7,126,126,19,14,5,2,1
8,164,164,5,5,0,1,0
3,188,188,1,1,0,1,0
5,218,218,35,3,32,2,1
9,238,238,21,21,0,1,0
1,269,269,12,7,5,2,1
6,284,284,69,69,0,1,0
4,459,459,119,97,22,2,1
2,493,493,11,7,4,2,1

4,126,126,17,17,0,1,0
10,197,197,14,9,5,2,1
11,219,219,28,14,14,2,1
3,308,308,7,1,6,2,1
1,322,322,37,19,18,4,3
7,342,342,5,5,0,1,0
5,373,373,12,12,0,1,0
0,376,376,17,3,14,3,2
9,431,431,48,48,0,1,0
8,434,434,85,45,40,3,2
6,478,478,58,24,34,3,2
2,489,489,7,2,5,2,1

4,129,129,6,6,0,1,0
0,134,134,3,3,0,1,0
7,161,161,56,56,0,1,0
5,187,187,28,28,0,1,0
2,232,232,21,21,0,1,0
6,324,324,17,1,16,2,1
3,340,340,46,30,16,2,1
1,341,341,20,20,0,1,0
8,386,386,26,26,0,1,0
9,387,387,16,16,0,1,0

1,166,166,2,2,0,1,0
5,175,175,54,21,33,2,1
2,193,193,73,28,45,4,3
4,223,223,30,7,23,2,1
3,311,311,10,1,9,4,3
7,319,319,20,5,15,4,3
6,337,337,2,2,0,1,0
0,346,346,27,18,9,4,3

2,104,104,13,3,10,3,2
5,127,127,3,3,0,1,0
0,179,179,50,50,0,1,0
3,241,241,9,4,5,2,1
7,252,252,51,37,14,3,2
4,318,318,1,1,0,1,0
9,318,318,17,5,12,2,1
6,322,322,20,20,0,1,0
1,409,409,13,6,7,2,1
8,492,492,92,84,8,2,1

1,153,153,4,1,3,2,1
3,168,168,1,1,0,1,0
7,236,236,9,4,5,2,1
4,239,239,3,3,0,1,0
8,303,303,2,2,0,1,0
9,310,310,97,19,78,4,3
0,344,344,56,56,0,1,0
5,374,374,8,8,0,1,0
2,423,423,115,85,30,4,3
6,425,425,62,28,34,2,1

3,108,108,7,7,0,1,0
4,123,123,13,5,8,2,1
7,137,137,5,5,0,1,0
5,140,140,3,3,0,1,0
9,223,223,18,7,11,2,1
10,314,314,97,92,5,2,1
8,333,333,28,12,16,3,2
2,355,355,19,19,0,1,0
0,366,366,30,30,0,1,0
6,480,480,8,2,6,2,1
1,486,486,76,55,21,2,1

1,160,160,5,1,4,2,1
5,162,162,24,18,6,2,1
2,172,172,20,20,0,1,0
3,208,208,11,11,0,1,0
0,244,244,87,77,10,2,1
6,327,327,76,76,0,1,0
4,328,328,26,26,0,1,0

3,129,129,10,10,0,1,0
2,155,155,2,2,0,1,0
0,245,245,24,24,0,1,0
5,250,250,12,4,8,3,2
7,325,325,2,2,0,1,0
6,333,333,46,46,0,1,0
8,447,447,78,12,66,3,2
4,449,449,51,46,5,2,1
9,457,457,86,2,84,4,3
1,500,500,76,76,0,1,0

2,131,131,5,5,0,1,0
1,190,190,88,88,0,1,0
4,208,208,18,18,0,1,0
0,224,224,1,1,0,1,0
5,298,298,50,35,15,2,1
6,428,428,2,2,0,1,0
3,482,482,119,119,0,1,0

1,141,141,2,2,0,1,0
7,170,170,12,12,0,1,0
8,204,204,1,1,0,1,0
9,221,221,34,34,0,1,0
6,267,267,36,25,11,2,1
10,269,269,68,28,40,3,2
11,283,283,26,8,18,4,3
2,316,316,46,46,0,1,0
4,356,356,9,9,0,1,0
0,368,368,12,12,0,1,0
5,445,445,26,26,0,1,0
3,484,484,10,1,9,2,1

8,123,123,42,33,9,4,3
4,170,170,33,33,0,1,0
5,211,211,2,2,0,1,0
3,270,270,1,1,0,1,0
1,280,280,14,14,0,1,0
6,360,360,9,1,8,2,1
7,383,383,51,9,42,2,1
2,401,401,38,1,37,2,1
0,453,453,73,3,70,3,2

5,157,157,4,1,3,2,1
4,159,159,9,1,8,2,1
7,190,190,26,26,0,1,0
0,251,251,1,1,0,1,0
9,251,251,50,36,14,2,1
3,254,254,13,13,0,1,0
2,357,357,73,73,0,1,0
8,376,376,42,8,34,3,2
10,400,400,24,6,18,4,3
6,441,441,44,22,22,3,2
1,485,485,29,4,25,2,1

4,104,104,11,1,10,2,1
3,106,106,17,13,4,2,1
0,195,195,9,9,0,1,0
7,212,212,18,6,12,3,2
2,269,269,19,11,8,2,1
6,335,335,75,75,0,1,0
1,442,442,99,99,0,1,0
5,467,467,44,10,34,3,2

1,127,127,7,7,0,1,0
3,132,132,4,4,0,1,0
0,145,145,1,1,0,1,0
9,300,300,94,94,0,1,0
7,312,312,38,38,0,1,0
4,393,393,27,27,0,1,0
5,432,432,121,121,0,1,0
6,457,457,21,3,18,4,3
2,462,462,28,28,0,1,0
8,483,483,11,6,5,2,1

3,114,114,9,3,6,3,2
6,234,234,9,9,0,1,0
0,278,278,4,4,0,1,0
1,320,320,44,44,0,1,0
7,325,325,9,9,0,1,0
9,429,429,51,51,0,1,0
8,439,439,93,45,48,4,3
4,442,442,47,47,0,1,0
2,452,452,19,5,14,2,1
10,458,458,67,67,0,1,0
5,498,498,42,42,0,1,0

4,103,103,4,4,0,1,0
9,243,243,78,48,30,3,2
11,254,254,9,2,7,2,1
0,290,290,16,16,0,1,0
8,293,293,26,26,0,1,0
2,320,320,32,32,0,1,0
7,351,351,10,10,0,1,0
6,363,363,48,2,46,3,2
1,377,377,16,1,15,2,1
10,392,392,24,24,0,1,0
5,419,419,1,1,0,1,0
3,486,486,50,50,0,1,0

1,101,101,15,9,6,2,1
3,192,192,24,18,6,3,2
6,195,195,11,11,0,1,0
5,230,230,14,3,11,2,1
7,345,345,60,15,45,2,1
4,348,348,76,55,21,4,3
2,415,415,84,56,28,3,2
0,456,456,11,2,9,2,1

10,137,137,22,10,12,4,3
5,143,143,10,10,0,1,0
6,150,150,3,3,0,1,0
4,154,154,3,3,0,1,0
11,185,185,26,19,7,2,1
3,350,350,7,4,3,2,1
9,357,357,53,53,0,1,0
2,369,369,4,4,0,1,0
7,383,383,23,23,0,1,0
1,421,421,70,70,0,1,0
0,465,465,63,12,51,4,3
8,469,469,29,7,22,2,1

5,121,121,15,1,14,2,1
4,273,273,3,3,0,1,0
1,330,330,26,26,0,1,0
9,344,344,37,37,0,1,0
10,354,354,15,6,9,2,1
8,373,373,69,69,0,1,0
6,388,388,32,32,0,1,0
2,390,390,25,13,12,3,2
3,408,408,29,29,0,1,0
7,409,409,70,70,0,1,0
0,478,478,34,26,8,2,1

9,123,123,1,1,0,1,0
7,198,198,27,7,20,3,2
4,235,235,10,10,0,1,0
1,245,245,10,10,0,1,0
2,255,255,29,13,16,3,2
8,371,371,27,27,0,1,0
6,413,413,119,119,0,1,0
5,414,414,26,26,0,1,0
3,446,446,46,46,0,1,0
0,487,487,67,67,0,1,0

7,123,123,9,1,8,2,1
6,140,140,3,3,0,1,0
4,144,144,1,1,0,1,0
9,217,217,41,30,11,2,1
0,277,277,12,5,7,2,1
2,313,313,1,1,0,1,0
5,325,325,6,6,0,1,0
8,361,361,40,40,0,1,0
10,411,411,56,56,0,1,0
1,472,472,35,15,20,2,1
3,476,476,161,143,18,4,3

2,121,121,6,6,0,1,0
6,121,121,6,6,0,1,0
4,126,126,19,5,14,2,1
9,183,183,9,6,3,2,1
0,292,292,79,79,0,1,0
1,406,406,1,1,0,1,0
7,416,416,13,13,0,1,0
3,444,444,2,2,0,1,0
5,447,447,10,10,0,1,0
8,496,496,186,108,78,4,3

11,113,113,5,5,0,1,0
2,155,155,1,1,0,1,0
0,170,170,1,1,0,1,0
1,186,186,2,2,0,1,0
8,190,190,57,32,25,2,1
9,328,328,24,10,14,2,1
5,347,347,40,22,18,4,3
7,352,352,30,4,26,2,1
10,421,421,40,6,34,3,2
4,425,425,30,30,0,1,0
6,451,451,22,4,18,2,1
3,480,480,76,64,12,4,3

2,125,125,41,41,0,1,0
3,173,173,12,12,0,1,0
7,225,225,20,12,8,2,1
4,311,311,92,59,33,2,1
0,339,339,6,6,0,1,0
1,349,349,30,30,0,1,0
6,386,386,11,5,6,2,1
5,458,458,43,43,0,1,0

7,165,165,1,1,0,1,0
3,197,197,37,1,36,4,3
6,253,253,3,3,0,1,0
2,261,261,16,16,0,1,0
0,267,267,8,8,0,1,0
1,295,295,31,17,14,3,2
5,339,339,10,10,0,1,0
4,384,384,34,9,25,2,1
8,384,384,121,105,16,2,1
9,476,476,86,59,27,4,3

1,187,187,10,2,8,3,2
4,198,198,23,5,18,2,1
2,210,210,4,4,0,1,0
10,275,275,55,55,0,1,0
3,294,294,8,8,0,1,0
8,312,312,55,55,0,1,0
6,349,349,34,34,0,1,0
0,384,384,13,1,12,2,1
9,390,390,8,8,0,1,0
11,403,403,44,38,6,2,1
7,426,426,48,48,0,1,0
5,477,477,20,20,0,1,0

2,132,132,1,1,0,1,0
9,165,165,49,1,48,3,2
4,217,217,11,4,7,2,1
1,316,316,38,38,0,1,0
5,318,318,6,3,3,2,1
8,350,350,3,3,0,1,0
3,412,412,44,44,0,1,0
0,432,432,66,20,46,3,2
10,471,471,74,74,0,1,0
7,494,494,22,1,21,4,3
6,499,499,22,14,8,2,1

3,154,154,7,3,4,2,1
2,223,223,90,90,0,1,0
0,260,260,130,121,9,4,3
4,313,313,5,5,0,1,0
1,323,323,13,1,12,4,3

12,139,139,14,7,7,2,1
3,141,141,17,17,0,1,0
5,169,169,1,1,0,1,0
9,190,190,1,1,0,1,0
7,197,197,2,2,0,1,0
11,200,200,41,41,0,1,0
4,284,284,10,1,9,2,1
2,384,384,6,6,0,1,0
8,443,443,33,33,0,1,0
1,457,457,23,23,0,1,0
6,460,460,74,74,0,1,0
0,487,487,14,3,11,4,3
10,488,488,95,28,67,4,3

2,146,146,45,9,36,4,3
3,168,168,35,23,12,4,3
6,210,210,5,5,0,1,0
4,225,225,28,28,0,1,0
1,300,300,10,10,0,1,0
0,363,363,60,60,0,1,0
5,480,480,74,74,0,1,0

2,187,187,22,22,0,1,0
8,281,281,15,8,7,2,1
9,296,296,26,26,0,1,0
7,303,303,34,12,22,3,2
1,315,315,51,51,0,1,0
6,324,324,81,61,20,3,2
3,333,333,41,8,33,2,1
0,370,370,11,11,0,1,0
5,412,412,25,25,0,1,0
4,445,445,4,4,0,1,0

0,165,165,8,8,0,1,0
3,176,176,1,1,0,1,0
8,177,177,5,5,0,1,0
2,273,273,41,41,0,1,0
7,346,346,153,153,0,1,0
6,354,354,11,11,0,1,0
4,379,379,99,11,88,3,2
5,490,490,2,2,0,1,0
1,499,499,18,18,0,1,0

6,122,122,15,9,6,2,1
2,132,132,3,3,0,1,0
4,140,140,14,14,0,1,0
3,176,176,14,14,0,1,0
0,210,210,60,60,0,1,0
8,225,225,2,2,0,1,0
5,301,301,101,20,81,4,3
1,399,399,5,5,0,1,0
7,430,430,18,18,0,1,0

0,121,121,4,4,0,1,0
2,144,144,21,21,0,1,0
7,264,264,25,4,21,4,3
6,276,276,29,26,3,2,1
1,330,330,67,47,20,2,1
4,344,344,6,6,0,1,0
5,358,358,94,94,0,1,0
8,360,360,17,17,0,1,0
3,364,364,37,19,18,2,1

2,162,162,31,31,0,1,0
1,167,167,51,11,40,3,2
6,353,353,14,4,10,3,2
4,385,385,49,7,42,4,3
3,415,415,103,103,0,1,0
0,465,465,2,2,0,1,0
5,487,487,43,37,6,2,1

5,110,110,22,22,0,1,0
9,122,122,5,5,0,1,0
2,133,133,6,6,0,1,0
6,145,145,5,5,0,1,0
7,168,168,14,14,0,1,0
8,267,267,76,60,16,2,1
4,323,323,11,11,0,1,0
1,344,344,22,17,5,2,1
0,347,347,1,1,0,1,0
10,372,372,37,37,0,1,0
3,470,470,57,19,38,3,2

9,108,108,19,19,0,1,0
1,153,153,6,2,4,2,1
7,157,157,5,5,0,1,0
2,199,199,17,17,0,1,0
4,208,208,28,1,27,4,3
5,229,229,30,6,24,2,1
3,262,262,12,12,0,1,0
10,272,272,56,56,0,1,0
8,279,279,27,27,0,1,0
6,310,310,9,9,0,1,0
0,341,341,12,12,0,1,0

0,127,127,18,18,0,1,0
6,147,147,7,1,6,2,1
4,148,148,7,7,0,1,0
9,159,159,5,5,0,1,0
10,236,236,54,41,13,2,1
3,243,243,18,7,11,3,2
7,304,304,30,13,17,4,3
1,359,359,20,20,0,1,0
2,411,411,29,13,16,2,1
8,434,434,66,66,0,1,0
5,455,455,30,30,0,1,0

9,163,163,5,5,0,1,0
8,202,202,58,58,0,1,0
7,247,247,1,1,0,1,0
5,270,270,10,10,0,1,0
6,291,291,55,12,43,3,2
1,299,299,1,1,0,1,0
2,299,299,82,82,0,1,0
3,441,441,16,16,0,1,0
4,441,441,55,15,40,2,1
0,488,488,13,3,10,3,2

6,114,114,7,1,6,2,1
4,132,132,8,8,0,1,0
7,246,246,73,73,0,1,0
8,295,295,1,1,0,1,0
0,314,314,8,8,0,1,0
3,369,369,79,34,45,4,3
1,385,385,67,64,3,2,1
2,435,435,13,13,0,1,0
5,440,440,64,64,0,1,0

2,106,106,18,10,8,3,2
6,165,165,5,1,4,2,1
1,352,352,81,81,0,1,0
3,359,359,69,24,45,4,3
4,390,390,7,1,6,3,2
5,441,441,117,117,0,1,0
0,476,476,49,14,35,2,1

8,126,126,13,13,0,1,0
5,148,148,6,6,0,1,0
13,155,155,19,19,0,1,0
14,175,175,41,41,0,1,0
4,183,183,17,17,0,1,0
0,248,248,8,1,7,2,1
3,248,248,1,1,0,1,0
12,258,258,15,15,0,1,0
1,259,259,39,22,17,2,1
2,292,292,2,2,0,1,0
10,295,295,14,6,8,3,2
9,311,311,1,1,0,1,0
11,343,343,33,6,27,2,1
6,444,444,6,1,5,2,1
7,466,466,4,1,3,2,1

7,118,118,32,27,5,2,1
1,124,124,6,6,0,1,0
5,180,180,11,11,0,1,0
9,188,188,6,1,5,2,1
3,197,197,19,4,15,2,1
2,198,198,45,1,44,3,2
8,235,235,34,34,0,1,0
4,274,274,18,18,0,1,0
6,341,341,23,23,0,1,0
0,378,378,1,1,0,1,0

1,136,136,48,1,47,2,1
5,162,162,7,7,0,1,0
0,170,170,25,9,16,2,1
4,212,212,22,12,10,3,2
2,369,369,23,13,10,3,2
3,459,459,136,43,93,4,3

8,109,109,6,6,0,1,0
4,140,140,8,8,0,1,0
11,165,165,4,4,0,1,0
9,207,207,22,22,0,1,0
2,246,246,7,7,0,1,0
5,268,268,8,8,0,1,0
6,270,270,22,14,8,3,2
10,293,293,50,50,0,1,0
1,315,315,13,7,6,3,2
12,352,352,73,73,0,1,0
0,427,427,34,24,10,2,1
7,433,433,46,46,0,1,0
3,496,496,12,12,0,1,0

3,126,126,9,9,0,1,0
1,154,154,11,2,9,2,1
0,229,229,16,4,12,3,2
12,234,234,54,54,0,1,0
9,236,236,2,2,0,1,0
13,270,270,39,1,38,2,1
5,311,311,1,1,0,1,0
4,353,353,33,5,28,3,2
6,365,365,3,3,0,1,0
10,391,391,14,14,0,1,0
8,408,408,39,39,0,1,0
7,449,449,13,4,9,4,3
2,469,469,24,24,0,1,0
11,477,477,46,4,42,3,2

1,115,115,36,36,0,1,0
4,128,128,16,16,0,1,0
5,222,222,6,6,0,1,0
6,241,241,39,39,0,1,0
2,262,262,48,22,26,2,1
3,277,277,53,48,5,2,1
0,483,483,3,3,0,1,0

2,117,117,5,5,0,1,0
5,136,136,6,1,5,2,1
8,174,174,34,34,0,1,0
6,240,240,36,21,15,4,3
0,290,290,9,9,0,1,0
4,323,323,5,5,0,1,0
1,331,331,54,49,5,2,1
7,334,334,24,5,19,3,2
9,416,416,37,2,35,2,1
3,459,459,94,94,0,1,0

2,104,104,1,1,0,1,0
8,105,105,20,5,15,4,3
10,139,139,17,17,0,1,0
4,191,191,11,11,0,1,0
1,196,196,4,4,0,1,0
11,243,243,29,29,0,1,0
9,247,247,21,21,0,1,0
0,257,257,6,2,4,2,1
7,267,267,11,11,0,1,0
5,341,341,9,9,0,1,0
3,373,373,110,80,30,4,3
6,487,487,14,14,0,1,0

2,102,102,2,2,0,1,0
8,108,108,15,15,0,1,0
9,127,127,2,2,0,1,0
7,145,145,26,20,6,2,1
6,310,310,1,1,0,1,0
0,314,314,34,1,33,2,1
10,318,318,58,41,17,2,1
3,412,412,53,53,0,1,0
5,428,428,42,42,0,1,0
4,451,451,5,5,0,1,0
1,468,468,62,62,0,1,0

9,218,218,12,4,8,2,1
11,233,233,80,46,34,2,1
6,247,247,15,15,0,1,0
2,263,263,41,41,0,1,0
10,267,267,11,11,0,1,0
0,274,274,1,1,0,1,0
5,284,284,4,4,0,1,0
3,286,286,8,8,0,1,0
7,300,300,4,4,0,1,0
4,310,310,3,3,0,1,0
1,318,318,69,45,24,2,1
8,459,459,32,14,18,2,1

2,106,106,4,4,0,1,0
6,171,171,23,20,3,2,1
5,174,174,57,30,27,4,3
0,220,220,52,27,25,2,1
1,327,327,28,4,24,4,3
7,437,437,11,5,6,3,2
4,478,478,11,11,0,1,0
3,487,487,69,69,0,1,0

4,102,102,10,5,5,2,1
6,127,127,10,3,7,2,1
3,231,231,11,11,0,1,0
8,239,239,67,1,66,3,2
7,271,271,40,40,0,1,0
2,293,293,21,21,0,1,0
0,360,360,27,4,23,2,1
5,370,370,48,35,13,2,1
10,439,439,7,7,0,1,0
1,475,475,2,2,0,1,0
9,487,487,30,30,0,1,0

1,127,127,29,29,0,1,0
0,131,131,16,16,0,1,0
3,187,187,22,22,0,1,0
5,241,241,11,11,0,1,0
7,318,318,9,9,0,1,0
4,341,341,142,70,72,4,3
6,346,346,7,7,0,1,0
2,394,394,14,14,0,1,0

1,122,122,11,11,0,1,0
6,125,125,6,6,0,1,0
0,162,162,7,7,0,1,0
4,179,179,6,6,0,1,0
8,340,340,77,39,38,3,2
3,360,360,67,14,53,3,2
7,393,393,69,21,48,3,2
2,394,394,58,58,0,1,0
5,396,396,24,6,18,2,1

2,157,157,32,12,20,2,1
5,195,195,12,6,6,3,2
1,271,271,37,6,31,2,1
8,338,338,89,50,39,4,3
0,380,380,2,2,0,1,0
7,437,437,9,2,7,2,1
4,463,463,58,26,32,2,1
6,463,463,74,74,0,1,0
3,471,471,14,14,0,1,0

3,164,164,10,10,0,1,0
4,191,191,3,3,0,1,0
1,202,202,11,11,0,1,0
5,252,252,62,37,25,2,1
2,261,261,39,9,30,4,3
0,371,371,82,36,46,4,3
8,401,401,22,2,20,3,2
6,452,452,88,19,69,4,3
7,477,477,3,3,0,1,0

5,128,128,1,1,0,1,0
4,195,195,4,4,0,1,0
8,196,196,9,5,4,2,1
3,201,201,17,5,12,4,3
1,267,267,42,18,24,4,3
6,274,274,62,24,38,3,2
0,328,328,66,33,33,2,1
7,404,404,92,92,0,1,0
2,464,464,17,13,4,2,1

7,106,106,26,26,0,1,0
1,141,141,3,3,0,1,0
4,168,168,4,4,0,1,0
6,272,272,61,21,40,2,1
2,371,371,68,68,0,1,0
5,375,375,8,4,4,2,1
0,416,416,6,2,4,2,1
3,453,453,128,106,22,3,2

8,153,153,37,37,0,1,0
5,170,170,9,9,0,1,0
0,204,204,16,16,0,1,0
6,248,248,3,3,0,1,0
3,261,261,22,17,5,2,1
9,275,275,53,21,32,2,1
1,362,362,13,13,0,1,0
2,370,370,65,25,40,3,2
7,383,383,23,15,8,3,2
4,447,447,34,34,0,1,0

4,103,103,1,1,0,1,0
1,120,120,2,2,0,1,0
3,150,150,35,24,11,2,1
2,169,169,30,21,9,2,1
8,199,199,15,15,0,1,0
6,257,257,57,27,30,4,3
7,341,341,12,12,0,1,0
9,359,359,64,64,0,1,0
5,372,372,1,1,0,1,0
0,391,391,24,24,0,1,0

2,150,150,6,1,5,2,1
0,175,175,2,2,0,1,0
4,219,219,33,33,0,1,0
1,244,244,9,9,0,1,0
6,291,291,26,5,21,4,3
11,316,316,81,33,48,3,2
3,391,391,17,17,0,1,0
9,402,402,13,13,0,1,0
5,410,410,7,7,0,1,0
7,442,442,50,10,40,3,2
10,443,443,82,70,12,2,1
8,449,449,14,5,9,2,1

1,134,134,2,2,0,1,0
5,151,151,1,1,0,1,0
6,208,208,11,11,0,1,0
0,242,242,1,1,0,1,0
4,271,271,33,10,23,2,1
10,271,271,43,32,11,2,1
11,276,276,19,5,14,3,2
3,327,327,44,44,0,1,0
7,334,334,18,18,0,1,0
8,362,362,93,93,0,1,0
2,411,411,46,16,30,4,3
9,481,481,12,2,10,3,2

4,109,109,8,8,0,1,0
0,123,123,1,1,0,1,0
8,154,154,1,1,0,1,0
2,163,163,17,17,0,1,0
10,186,186,12,6,6,2,1
6,199,199,20,13,7,2,1
5,225,225,39,39,0,1,0
1,246,246,7,7,0,1,0
9,258,258,75,67,8,2,1
7,317,317,48,18,30,4,3
3,464,464,6,3,3,2,1

9,125,125,21,21,0,1,0
6,140,140,5,5,0,1,0
2,175,175,15,5,10,3,2
4,232,232,44,2,42,2,1
10,264,264,56,56,0,1,0
1,270,270,33,33,0,1,0
8,311,311,33,33,0,1,0
3,368,368,12,12,0,1,0
5,408,408,14,14,0,1,0
7,462,462,11,11,0,1,0
0,491,491,3,3,0,1,0

4,161,161,7,7,0,1,0
1,222,222,8,1,7,2,1
2,284,284,23,8,15,3,2
3,429,429,148,76,72,4,3
0,457,457,229,229,0,1,0

6,108,108,6,6,0,1,0
4,161,161,23,23,0,1,0
5,207,207,6,6,0,1,0
8,212,212,25,10,15,2,1
11,230,230,3,3,0,1,0
9,272,272,43,43,0,1,0
0,292,292,18,18,0,1,0
10,332,332,72,4,68,4,3
3,356,356,20,10,10,3,2
2,424,424,15,7,8,2,1
7,430,430,26,23,3,2,1
1,436,436,26,2,24,3,2

6,146,146,10,10,0,1,0
1,196,196,7,3,4,2,1
0,252,252,81,33,48,3,2
5,268,268,40,14,26,3,2
3,296,296,2,2,0,1,0
2,332,332,46,46,0,1,0
4,335,335,2,2,0,1,0
7,473,473,134,94,40,3,2

9,107,107,4,4,0,1,0
3,159,159,6,6,0,1,0
5,170,170,4,4,0,1,0
6,170,170,1,1,0,1,0
1,190,190,15,3,12,2,1
2,198,198,17,6,11,3,2
8,221,221,72,48,24,4,3
0,286,286,50,4,46,2,1
7,355,355,37,37,0,1,0
4,472,472,46,34,12,4,3
10,498,498,20,7,13,2,1

13,163,163,18,2,16,4,3
15,193,193,12,1,11,2,1
11,216,216,22,22,0,1,0
3,222,222,2,2,0,1,0
2,231,231,16,6,10,2,1
0,254,254,23,10,13,2,1
14,285,285,92,48,44,2,1
9,318,318,3,3,0,1,0
1,320,320,2,2,0,1,0
4,342,342,12,12,0,1,0
6,359,359,2,2,0,1,0
8,388,388,26,26,0,1,0
12,406,406,6,6,0,1,0
10,416,416,19,19,0,1,0
5,445,445,1,1,0,1,0
7,453,453,27,27,0,1,0

6,106,106,4,4,0,1,0
7,153,153,33,9,24,2,1
10,158,158,15,15,0,1,0
9,177,177,5,5,0,1,0
2,200,200,29,12,17,2,1
3,201,201,5,5,0,1,0
4,207,207,10,10,0,1,0
1,394,394,50,11,39,2,1
8,399,399,70,70,0,1,0
0,404,404,29,25,4,2,1
5,461,461,25,6,19,2,1

1,140,140,16,4,12,2,1
5,219,219,14,6,8,3,2
0,251,251,42,8,34,3,2
3,290,290,7,7,0,1,0
2,296,296,58,58,0,1,0
7,447,447,124,49,75,4,3
4,449,449,44,44,0,1,0
6,459,459,30,3,27,4,3

4,148,148,22,14,8,2,1
3,150,150,5,2,3,2,1
0,205,205,91,23,68,3,2
6,207,207,61,16,45,4,3
5,228,228,6,6,0,1,0
1,239,239,1,1,0,1,0
2,288,288,7,2,5,2,1
7,332,332,13,5,8,3,2

7,127,127,13,13,0,1,0
5,221,221,14,10,4,2,1
4,240,240,16,16,0,1,0
1,311,311,23,3,20,3,2
2,333,333,19,19,0,1,0
0,364,364,28,12,16,3,2
6,407,407,112,94,18,4,3
3,484,484,142,76,66,4,3

0,138,138,6,6,0,1,0
15,150,150,37,21,16,2,1
3,162,162,8,3,5,2,1
7,168,168,1,1,0,1,0
8,187,187,10,4,6,2,1
11,192,192,2,2,0,1,0
12,217,217,1,1,0,1,0
1,252,252,13,1,12,3,2
10,270,270,13,8,5,2,1
2,293,293,31,10,21,2,1
6,343,343,4,4,0,1,0
16,390,390,18,18,0,1,0
14,409,409,48,14,34,3,2
9,428,428,43,43,0,1,0
13,446,446,42,7,35,2,1
5,470,470,7,1,6,3,2
4,473,473,2,2,0,1,0

10,125,125,4,4,0,1,0
3,153,153,1,1,0,1,0
0,177,177,8,3,5,2,1
11,180,180,28,28,0,1,0
7,196,196,64,28,36,4,3
2,206,206,3,3,0,1,0
9,220,220,16,16,0,1,0
1,257,257,12,4,8,2,1
6,275,275,7,7,0,1,0
8,289,289,72,51,21,2,1
4,353,353,12,12,0,1,0
5,397,397,2,2,0,1,0

3,177,177,57,41,16,2,1
4,213,213,28,28,0,1,0
2,267,267,31,31,0,1,0
5,309,309,12,12,0,1,0
0,355,355,13,9,4,2,1
6,403,403,6,6,0,1,0
1,496,496,174,156,18,2,1

0,242,242,4,1,3,2,1
6,258,258,2,2,0,1,0
5,359,359,55,55,0,1,0
3,389,389,6,1,5,2,1
1,400,400,38,38,0,1,0
4,440,440,145,67,78,4,3
2,500,500,195,195,0,1,0

1,193,193,45,29,16,2,1
0,211,211,32,4,28,2,1
8,242,242,19,19,0,1,0
5,305,305,12,8,4,2,1
7,398,398,78,54,24,3,2
4,406,406,40,28,12,2,1
3,410,410,6,1,5,2,1
6,465,465,91,91,0,1,0
2,493,493,2,2,0,1,0

1,195,195,15,15,0,1,0
3,227,227,2,2,0,1,0
8,238,238,12,9,3,2,1
6,267,267,18,6,12,2,1
4,268,268,51,4,47,2,1
7,306,306,69,69,0,1,0
10,332,332,35,35,0,1,0
2,375,375,19,19,0,1,0
5,382,382,39,33,6,2,1
9,387,387,49,49,0,1,0
0,431,431,3,3,0,1,0

2,116,116,28,28,0,1,0
0,155,155,2,2,0,1,0
1,163,163,1,1,0,1,0
10,201,201,15,15,0,1,0
3,214,214,9,6,3,2,1
4,276,276,23,20,3,2,1
5,346,346,9,9,0,1,0
11,397,397,106,106,0,1,0
9,402,402,63,42,21,4,3
8,403,403,3,3,0,1,0
6,411,411,17,17,0,1,0
7,484,484,23,18,5,2,1

5,105,105,21,11,10,3,2
4,119,119,1,1,0,1,0
2,132,132,9,2,7,2,1
8,144,144,21,21,0,1,0
1,174,174,26,26,0,1,0
0,184,184,13,1,12,3,2
3,296,296,62,62,0,1,0
6,334,334,16,9,7,2,1
7,406,406,48,24,24,2,1

2,186,186,9,3,6,3,2
6,188,188,8,8,0,1,0
1,242,242,2,2,0,1,0
4,349,349,65,15,50,2,1
7,360,360,11,8,3,2,1
5,373,373,93,63,30,4,3
0,424,424,5,5,0,1,0
3,470,470,203,203,0,1,0

2,252,252,56,30,26,4,3
5,277,277,26,26,0,1,0
7,312,312,81,81,0,1,0
1,325,325,40,40,0,1,0
3,373,373,15,15,0,1,0
6,397,397,7,7,0,1,0
4,444,444,59,59,0,1,0
0,478,478,55,43,12,3,2

6,131,131,11,11,0,1,0
5,165,165,1,1,0,1,0
8,199,199,70,27,43,2,1
0,269,269,30,30,0,1,0
1,303,303,48,24,24,2,1
3,303,303,45,18,27,2,1
7,350,350,24,7,17,2,1
2,458,458,24,24,0,1,0
4,480,480,14,11,3,2,1

11,100,100,6,6,0,1,0
8,118,118,8,2,6,2,1
1,121,121,7,7,0,1,0
15,124,124,34,34,0,1,0
7,142,142,1,1,0,1,0
10,159,159,17,17,0,1,0
12,201,201,4,4,0,1,0
5,221,221,2,2,0,1,0
3,230,230,18,18,0,1,0
14,293,293,20,4,16,3,2
6,338,338,20,20,0,1,0
4,373,373,7,7,0,1,0
9,378,378,5,5,0,1,0
0,391,391,8,8,0,1,0
13,419,419,61,61,0,1,0
2,486,486,2,2,0,1,0

2,240,240,15,3,12,2,1
6,244,244,9,9,0,1,0
8,281,281,119,119,0,1,0
1,312,312,53,53,0,1,0
7,313,313,9,5,4,2,1
5,325,325,5,5,0,1,0
4,327,327,22,4,18,4,3
0,334,334,35,5,30,3,2
3,375,375,36,16,20,3,2

6,139,139,2,2,0,1,0
7,218,218,13,2,11,2,1
4,261,261,44,16,28,3,2
2,273,273,11,7,4,2,1
5,303,303,17,17,0,1,0
3,310,310,58,28,30,2,1
1,315,315,7,1,6,3,2
0,345,345,29,20,9,4,3
8,419,419,156,156,0,1,0

10,103,103,21,21,0,1,0
5,105,105,7,1,6,3,2
3,133,133,29,9,20,2,1
11,189,189,15,15,0,1,0
0,206,206,4,4,0,1,0
4,218,218,15,6,9,2,1
2,298,298,1,1,0,1,0
1,324,324,3,3,0,1,0
8,327,327,46,46,0,1,0
7,378,378,10,1,9,4,3
9,474,474,42,2,40,2,1
6,479,479,43,22,21,2,1

5,101,101,15,5,10,3,2
6,175,175,2,2,0,1,0
7,203,203,9,9,0,1,0
8,208,208,17,5,12,4,3
1,220,220,21,21,0,1,0
9,233,233,57,57,0,1,0
3,260,260,60,28,32,3,2
2,300,300,1,1,0,1,0
0,315,315,1,1,0,1,0
4,391,391,4,4,0,1,0
10,409,409,56,43,13,2,1

6,102,102,24,19,5,2,1
7,112,112,32,6,26,3,2
0,141,141,2,2,0,1,0
2,156,156,6,6,0,1,0
5,177,177,8,8,0,1,0
9,184,184,33,5,28,2,1
4,195,195,3,3,0,1,0
3,268,268,33,33,0,1,0
8,286,286,3,3,0,1,0
1,289,289,10,2,8,2,1
10,438,438,14,14,0,1,0

5,127,127,40,25,15,4,3
0,153,153,62,62,0,1,0
6,222,222,13,13,0,1,0
4,226,226,15,15,0,1,0
3,313,313,12,12,0,1,0
7,337,337,25,25,0,1,0
1,445,445,15,12,3,2,1
2,472,472,11,3,8,2,1

9,123,123,8,8,0,1,0
7,156,156,12,12,0,1,0
2,169,169,1,1,0,1,0
5,268,268,30,30,0,1,0
4,278,278,38,29,9,2,1
10,312,312,23,20,3,2,1
1,356,356,16,16,0,1,0
8,356,356,42,42,0,1,0
11,413,413,104,104,0,1,0
0,415,415,22,4,18,2,1
3,431,431,13,3,10,3,2
6,480,480,22,22,0,1,0

5,207,207,13,13,0,1,0
0,279,279,74,74,0,1,0
2,284,284,59,3,56,3,2
3,285,285,8,8,0,1,0
6,327,327,19,11,8,3,2
1,422,422,1,1,0,1,0
4,446,446,106,74,32,3,2
7,496,496,74,56,18,2,1

5,101,101,16,16,0,1,0
1,105,105,4,4,0,1,0
2,180,180,26,26,0,1,0
6,223,223,7,7,0,1,0
8,272,272,15,3,12,3,2
4,349,349,28,7,21,4,3
7,382,382,49,23,26,2,1
3,399,399,13,2,11,4,3
10,437,437,40,7,33,4,3
0,481,481,8,5,3,2,1
9,482,482,111,49,62,3,2

8,170,170,48,10,38,2,1
9,206,206,7,7,0,1,0
2,227,227,14,14,0,1,0
5,334,334,25,25,0,1,0
3,402,402,30,21,9,4,3
1,403,403,9,9,0,1,0
6,403,403,17,6,11,2,1
7,416,416,64,53,11,3,2
4,433,433,41,13,28,3,2
0,485,485,84,30,54,4,3

1,104,104,25,4,21,3,2
6,164,164,3,3,0,1,0
3,231,231,12,12,0,1,0
5,345,345,20,6,14,3,2
0,349,349,26,12,14,3,2
2,350,350,40,25,15,2,1
8,356,356,135,135,0,1,0
4,365,365,7,7,0,1,0
7,470,470,24,12,12,3,2

3,128,128,1,1,0,1,0
2,134,134,3,3,0,1,0
7,142,142,11,2,9,2,1
4,160,160,1,1,0,1,0
6,186,186,43,13,30,3,2
9,269,269,15,15,0,1,0
8,292,292,1,1,0,1,0
12,315,315,17,17,0,1,0
10,329,329,103,47,56,3,2
1,364,364,13,13,0,1,0
5,459,459,12,2,10,2,1
13,461,461,9,9,0,1,0
0,481,481,17,17,0,1,0
11,489,489,57,17,40,2,1

5,151,151,3,3,0,1,0
9,168,168,7,4,3,2,1
7,179,179,54,54,0,1,0
2,195,195,35,35,0,1,0
1,210,210,1,1,0,1,0
3,325,325,37,1,36,2,1
4,381,381,2,2,0,1,0
6,422,422,50,50,0,1,0
0,447,447,81,43,38,3,2
8,470,470,21,21,0,1,0

5,123,123,28,4,24,4,3
6,215,215,50,20,30,2,1
4,289,289,5,5,0,1,0
1,305,305,44,44,0,1,0
0,347,347,94,80,14,3,2
3,363,363,12,12,0,1,0
2,474,474,41,41,0,1,0

2,106,106,1,1,0,1,0
1,136,136,12,6,6,3,2
6,233,233,71,5,66,3,2
5,252,252,4,1,3,2,1
9,258,258,31,21,10,3,2
4,298,298,110,110,0,1,0
0,390,390,3,3,0,1,0
7,413,413,6,6,0,1,0
3,458,458,6,6,0,1,0
8,480,480,33,19,14,3,2

1,116,116,6,6,0,1,0
7,158,158,18,1,17,3,2
3,172,172,4,4,0,1,0
0,196,196,8,4,4,2,1
10,208,208,53,6,47,2,1
9,251,251,22,9,13,2,1
8,267,267,14,4,10,3,2
4,304,304,77,77,0,1,0
6,376,376,12,4,8,2,1
2,485,485,25,21,4,2,1
5,486,486,24,2,22,3,2

2,117,117,1,1,0,1,0
0,223,223,49,49,0,1,0
6,240,240,48,36,12,3,2
5,318,318,7,4,3,2,1
7,339,339,38,38,0,1,0
4,353,353,61,1,60,4,3
1,375,375,75,12,63,4,3
3,445,445,32,14,18,4,3

5,123,123,1,1,0,1,0
8,172,172,9,3,6,3,2
6,178,178,9,9,0,1,0
0,234,234,5,2,3,2,1
1,251,251,93,61,32,3,2
7,339,339,24,24,0,1,0
3,359,359,9,6,3,2,1
9,371,371,126,105,21,4,3
4,427,427,19,1,18,2,1
2,495,495,19,19,0,1,0

3,200,200,61,34,27,4,3
2,242,242,5,5,0,1,0
1,265,265,42,42,0,1,0
4,274,274,10,10,0,1,0
6,400,400,52,11,41,2,1
5,401,401,58,58,0,1,0
0,413,413,7,2,5,2,1
7,463,463,90,78,12,3,2

5,113,113,1,1,0,1,0
8,126,126,59,11,48,2,1
1,138,138,9,9,0,1,0
6,230,230,13,10,3,2,1
0,253,253,11,11,0,1,0
2,321,321,10,10,0,1,0
11,369,369,4,4,0,1,0
7,387,387,51,19,32,2,1
3,395,395,57,23,34,4,3
10,428,428,2,2,0,1,0
9,444,444,9,9,0,1,0
4,487,487,10,2,8,2,1

7,160,160,12,12,0,1,0
5,184,184,37,27,10,2,1
0,225,225,1,1,0,1,0
1,256,256,24,24,0,1,0
6,284,284,103,75,28,3,2
4,303,303,5,5,0,1,0
2,304,304,17,6,11,2,1
8,332,332,2,2,0,1,0
9,355,355,23,23,0,1,0
3,400,400,53,53,0,1,0

2,110,110,8,8,0,1,0
4,255,255,6,6,0,1,0
3,283,283,76,64,12,4,3
6,304,304,7,2,5,2,1
1,410,410,56,56,0,1,0
7,419,419,52,28,24,3,2
0,433,433,11,11,0,1,0
5,436,436,146,26,120,4,3

4,128,128,7,4,3,2,1
2,180,180,10,10,0,1,0
5,239,239,1,1,0,1,0
6,256,256,4,1,3,2,1
0,282,282,26,26,0,1,0
8,292,292,22,9,13,2,1
11,322,322,68,68,0,1,0
1,328,328,5,5,0,1,0
13,341,341,57,3,54,4,3
7,413,413,12,12,0,1,0
9,459,459,19,3,16,2,1
12,476,476,3,3,0,1,0
3,486,486,57,23,34,2,1
10,495,495,60,60,0,1,0

1,106,106,10,10,0,1,0
3,120,120,6,6,0,1,0
8,198,198,41,41,0,1,0
0,217,217,38,17,21,3,2
6,234,234,33,33,0,1,0
2,254,254,25,4,21,3,2
5,361,361,19,13,6,3,2
7,430,430,45,10,35,3,2
4,464,464,39,39,0,1,0

5,147,147,32,6,26,3,2
1,183,183,10,10,0,1,0
0,206,206,18,18,0,1,0
4,251,251,33,33,0,1,0
6,259,259,26,9,17,2,1
9,364,364,66,66,0,1,0
8,368,368,17,17,0,1,0
3,455,455,1,1,0,1,0
2,461,461,5,5,0,1,0
7,487,487,86,75,11,2,1

11,114,114,4,4,0,1,0
10,121,121,51,51,0,1,0
8,126,126,3,3,0,1,0
4,176,176,20,14,6,3,2
0,191,191,12,12,0,1,0
2,209,209,42,4,38,4,3
5,217,217,3,3,0,1,0
1,298,298,15,15,0,1,0
9,346,346,15,10,5,2,1
3,347,347,18,18,0,1,0
7,391,391,1,1,0,1,0
6,469,469,3,3,0,1,0

7,181,181,22,22,0,1,0
8,190,190,22,22,0,1,0
6,208,208,46,19,27,4,3
0,218,218,16,16,0,1,0
3,306,306,1,1,0,1,0
2,361,361,66,16,50,3,2
4,383,383,15,10,5,2,1
5,403,403,24,24,0,1,0
9,427,427,22,1,21,4,3
1,474,474,68,68,0,1,0

5,112,112,9,5,4,2,1
0,177,177,18,18,0,1,0
7,230,230,17,2,15,4,3
6,302,302,31,19,12,3,2
2,311,311,80,80,0,1,0
3,323,323,15,15,0,1,0
4,358,358,91,61,30,4,3
1,468,468,45,8,37,3,2

5,168,168,8,8,0,1,0
4,276,276,29,29,0,1,0
2,303,303,61,61,0,1,0
9,327,327,66,19,47,2,1
10,330,330,22,22,0,1,0
1,372,372,26,26,0,1,0
6,383,383,7,1,6,3,2
3,408,408,19,4,15,4,3
8,431,431,59,1,58,3,2
7,436,436,44,4,40,3,2
0,482,482,6,6,0,1,0

5,151,151,3,3,0,1,0
2,167,167,44,44,0,1,0
7,186,186,27,27,0,1,0
4,203,203,16,16,0,1,0
1,215,215,1,1,0,1,0
3,222,222,17,17,0,1,0
6,272,272,84,84,0,1,0
0,374,374,30,4,26,3,2
8,457,457,14,9,5,2,1

7,119,119,22,22,0,1,0
0,120,120,1,1,0,1,0
8,227,227,22,2,20,3,2
9,239,239,47,47,0,1,0
6,303,303,11,4,7,2,1
2,320,320,21,17,4,2,1
5,355,355,22,1,21,4,3
1,386,386,62,62,0,1,0
4,390,390,54,25,29,2,1
3,431,431,29,8,21,2,1

6,114,114,5,5,0,1,0
5,249,249,95,9,86,3,2
0,251,251,45,8,37,4,3
2,294,294,14,2,12,4,3
1,356,356,11,11,0,1,0
4,367,367,3,3,0,1,0
3,384,384,90,51,39,4,3
7,407,407,22,22,0,1,0
8,474,474,13,5,8,2,1

3,118,118,1,1,0,1,0
4,219,219,6,6,0,1,0
1,224,224,3,3,0,1,0
6,374,374,16,16,0,1,0
5,380,380,56,29,27,2,1
0,396,396,34,34,0,1,0
7,468,468,97,28,69,4,3
8,469,469,51,9,42,3,2
2,470,470,173,109,64,4,3

1,130,130,3,3,0,1,0
2,171,171,6,6,0,1,0
7,347,347,68,68,0,1,0
5,384,384,33,33,0,1,0
0,407,407,73,32,41,2,1
8,408,408,16,6,10,3,2
3,451,451,16,8,8,2,1
4,461,461,66,66,0,1,0
9,461,461,112,104,8,2,1
6,488,488,12,3,9,2,1

0,115,115,10,6,4,2,1
1,131,131,2,2,0,1,0
12,153,153,56,14,42,4,3
11,275,275,10,10,0,1,0
7,306,306,19,19,0,1,0
5,313,313,6,6,0,1,0
8,344,344,12,12,0,1,0
2,345,345,18,18,0,1,0
9,392,392,15,1,14,2,1
13,401,401,8,8,0,1,0
6,408,408,1,1,0,1,0
10,440,440,38,38,0,1,0
4,453,453,54,24,30,3,2
3,458,458,33,5,28,3,2

6,103,103,1,1,0,1,0
1,148,148,1,1,0,1,0
2,173,173,26,16,10,2,1
11,233,233,73,40,33,4,3
9,252,252,9,9,0,1,0
10,253,253,34,14,20,2,1
4,311,311,3,3,0,1,0
0,318,318,9,3,6,2,1
5,332,332,20,14,6,3,2
7,347,347,8,8,0,1,0
8,353,353,10,6,4,2,1
3,432,432,92,74,18,4,3

0,165,165,22,22,0,1,0
2,231,231,15,1,14,3,2
6,293,293,5,5,0,1,0
10,307,307,114,47,67,3,2
3,308,308,21,5,16,3,2
9,310,310,14,11,3,2,1
8,321,321,15,5,10,3,2
1,341,341,26,17,9,4,3
5,363,363,11,11,0,1,0
4,376,376,7,7,0,1,0
11,380,380,16,3,13,2,1
7,382,382,35,31,4,2,1

8,116,116,17,17,0,1,0
6,164,164,7,7,0,1,0
7,256,256,14,14,0,1,0
2,303,303,48,36,12,3,2
4,328,328,28,28,0,1,0
1,355,355,27,27,0,1,0
9,400,400,105,105,0,1,0
3,404,404,14,1,13,2,1
0,406,406,38,38,0,1,0
5,477,477,25,25,0,1,0

0,215,215,7,4,3,2,1
7,238,238,3,3,0,1,0
4,245,245,17,17,0,1,0
1,301,301,18,18,0,1,0
5,322,322,59,30,29,2,1
6,323,323,78,37,41,2,1
3,352,352,74,71,3,2,1
2,410,410,81,81,0,1,0

8,128,128,43,43,0,1,0
5,130,130,13,13,0,1,0
6,176,176,2,2,0,1,0
0,225,225,1,1,0,1,0
3,262,262,1,1,0,1,0
4,286,286,76,29,47,2,1
2,299,299,1,1,0,1,0
1,385,385,87,87,0,1,0
7,419,419,29,29,0,1,0

8,129,129,1,1,0,1,0
7,140,140,30,30,0,1,0
9,153,153,21,21,0,1,0
4,173,173,33,33,0,1,0
6,200,200,32,32,0,1,0
5,240,240,19,9,10,3,2
3,244,244,16,10,6,2,1
0,407,407,33,5,28,3,2
2,484,484,14,6,8,2,1
1,497,497,28,4,24,4,3

11,125,125,36,3,33,2,1
2,134,134,1,1,0,1,0
0,145,145,6,6,0,1,0
3,154,154,8,8,0,1,0
1,215,215,13,3,10,4,3
6,252,252,12,12,0,1,0
7,263,263,10,3,7,2,1
4,296,296,28,28,0,1,0
8,410,410,13,13,0,1,0
10,446,446,62,52,10,3,2
5,469,469,75,75,0,1,0
9,477,477,25,12,13,2,1

2,134,134,22,22,0,1,0
9,139,139,11,11,0,1,0
1,148,148,3,3,0,1,0
10,216,216,6,6,0,1,0
11,240,240,75,9,66,4,3
0,317,317,31,1,30,2,1
5,337,337,5,5,0,1,0
7,352,352,15,15,0,1,0
6,367,367,29,20,9,4,3
8,418,418,38,12,26,2,1
4,458,458,19,8,11,2,1
3,460,460,19,19,0,1,0

1,182,182,14,14,0,1,0
5,201,201,37,15,22,3,2
7,252,252,4,1,3,2,1
2,257,257,67,23,44,2,1
4,270,270,13,1,12,4,3
8,282,282,47,47,0,1,0
0,312,312,9,9,0,1,0
6,322,322,44,44,0,1,0
3,484,484,43,43,0,1,0

3,116,116,4,4,0,1,0
6,129,129,17,17,0,1,0
2,132,132,22,22,0,1,0
5,164,164,5,1,4,2,1
1,176,176,2,2,0,1,0
9,203,203,22,7,15,4,3
4,248,248,1,1,0,1,0
7,282,282,73,73,0,1,0
0,373,373,95,43,52,3,2
8,490,490,2,2,0,1,0

5,158,158,25,5,20,3,2
4,165,165,8,8,0,1,0
0,179,179,1,1,0,1,0
1,219,219,3,3,0,1,0
9,241,241,9,9,0,1,0
7,293,293,32,32,0,1,0
8,298,298,76,76,0,1,0
2,310,310,15,3,12,2,1
3,346,346,79,79,0,1,0
6,379,379,40,7,33,2,1

7,100,100,1,1,0,1,0
0,110,110,15,6,9,2,1
4,139,139,2,2,0,1,0
11,233,233,57,40,17,2,1
5,256,256,26,26,0,1,0
1,266,266,48,48,0,1,0
10,272,272,3,3,0,1,0
9,318,318,20,20,0,1,0
2,328,328,2,2,0,1,0
6,362,362,2,2,0,1,0
8,377,377,70,22,48,4,3
3,463,463,24,16,8,3,2

3,131,131,5,5,0,1,0
0,155,155,2,2,0,1,0
7,156,156,9,9,0,1,0
12,156,156,8,4,4,2,1
8,194,194,36,36,0,1,0
1,224,224,26,26,0,1,0
10,249,249,32,27,5,2,1
2,272,272,2,2,0,1,0
4,374,374,14,5,9,4,3
6,377,377,9,9,0,1,0
11,398,398,4,4,0,1,0
9,401,401,127,16,111,4,3
5,430,430,11,1,10,2,1

1,100,100,1,1,0,1,0
8,117,117,15,3,12,3,2
2,137,137,17,17,0,1,0
7,246,246,15,5,10,3,2
6,347,347,30,30,0,1,0
3,349,349,75,42,33,2,1
0,365,365,8,3,5,2,1
10,377,377,37,37,0,1,0
5,410,410,11,11,0,1,0
9,415,415,92,86,6,3,2
4,424,424,7,2,5,2,1

2,146,146,14,14,0,1,0
12,151,151,7,7,0,1,0
0,212,212,8,4,4,2,1
10,239,239,1,1,0,1,0
7,252,252,16,5,11,2,1
9,270,270,31,31,0,1,0
6,318,318,12,12,0,1,0
14,331,331,113,50,63,4,3
11,343,343,23,23,0,1,0
5,350,350,5,5,0,1,0
13,387,387,20,5,15,4,3
3,415,415,15,8,7,2,1
1,443,443,28,16,12,3,2
4,448,448,3,3,0,1,0
8,448,448,12,12,0,1,0

8,150,150,63,33,30,4,3
3,223,223,16,2,14,2,1
2,286,286,48,48,0,1,0
4,331,331,6,6,0,1,0
1,333,333,32,32,0,1,0
0,338,338,50,50,0,1,0
7,357,357,20,3,17,2,1
5,360,360,10,10,0,1,0
6,462,462,1,1,0,1,0

6,253,253,21,21,0,1,0
1,336,336,27,20,7,2,1
3,364,364,33,33,0,1,0
5,372,372,16,13,3,2,1
2,385,385,105,105,0,1,0
4,433,433,26,10,16,2,1
7,483,483,153,36,117,4,3
0,486,486,28,18,10,2,1

6,176,176,17,8,9,2,1
8,190,190,34,16,18,4,3
0,223,223,21,21,0,1,0
10,223,223,24,11,13,2,1
7,292,292,63,1,62,4,3
5,345,345,4,4,0,1,0
3,381,381,16,8,8,2,1
1,404,404,48,48,0,1,0
2,446,446,24,10,14,3,2
4,481,481,40,40,0,1,0
9,486,486,4,4,0,1,0

2,209,209,18,8,10,2,1
0,236,236,55,16,39,2,1
1,249,249,23,4,19,3,2
6,250,250,68,68,0,1,0
3,256,256,23,2,21,2,1
4,300,300,27,10,17,4,3
5,448,448,22,22,0,1,0
7,492,492,47,29,18,4,3

0,128,128,5,5,0,1,0
8,143,143,16,6,10,3,2
6,219,219,5,5,0,1,0
1,243,243,5,5,0,1,0
5,277,277,10,10,0,1,0
3,285,285,3,3,0,1,0
10,312,312,18,4,14,3,2
2,344,344,9,9,0,1,0
11,357,357,40,40,0,1,0
13,387,387,29,7,22,3,2
12,392,392,102,48,54,3,2
4,406,406,25,12,13,2,1
9,427,427,40,40,0,1,0
7,488,488,38,34,4,2,1

6,124,124,20,20,0,1,0
4,193,193,1,1,0,1,0
3,211,211,46,38,8,2,1
5,268,268,52,52,0,1,0
2,298,298,39,36,3,2,1
1,350,350,15,15,0,1,0
7,356,356,54,27,27,4,3
0,452,452,49,49,0,1,0

4,106,106,1,1,0,1,0
2,189,189,12,1,11,2,1
7,227,227,43,43,0,1,0
0,271,271,10,10,0,1,0
3,321,321,7,7,0,1,0
6,360,360,15,15,0,1,0
8,377,377,23,12,11,2,1
10,422,422,86,21,65,4,3
9,438,438,21,21,0,1,0
5,439,439,137,92,45,4,3
1,461,461,7,4,3,2,1

1,112,112,1,1,0,1,0
7,137,137,11,11,0,1,0
2,161,161,3,3,0,1,0
4,365,365,23,15,8,2,1
0,373,373,61,53,8,3,2
6,425,425,6,6,0,1,0
8,426,426,93,93,0,1,0
5,464,464,90,61,29,2,1
3,479,479,118,86,32,2,1

6,100,100,8,8,0,1,0
0,103,103,20,10,10,3,2
5,138,138,15,7,8,3,2
8,211,211,27,9,18,3,2
3,257,257,56,46,10,3,2
2,320,320,18,15,3,2,1
7,344,344,68,54,14,3,2
1,435,435,3,3,0,1,0
4,494,494,13,13,0,1,0

3,126,126,2,2,0,1,0
9,155,155,33,14,19,2,1
7,201,201,7,7,0,1,0
8,220,220,39,39,0,1,0
2,234,234,9,9,0,1,0
5,277,277,20,9,11,2,1
6,291,291,31,31,0,1,0
11,303,303,5,5,0,1,0
10,323,323,33,3,30,3,2
0,402,402,27,27,0,1,0
4,411,411,40,8,32,3,2
1,488,488,35,35,0,1,0

2,110,110,5,5,0,1,0
6,111,111,7,1,6,3,2
8,209,209,4,4,0,1,0
5,279,279,16,4,12,2,1
7,286,286,107,63,44,3,2
3,340,340,3,3,0,1,0
1,366,366,10,4,6,3,2
4,453,453,40,40,0,1,0
0,478,478,158,98,60,3,2

0,113,113,5,1,4,2,1
7,113,113,12,2,10,3,2
6,126,126,20,6,14,4,3
2,309,309,3,3,0,1,0
1,392,392,161,137,24,4,3
5,440,440,12,12,0,1,0
4,441,441,97,5,92,4,3
3,491,491,18,8,10,2,1

1,180,180,33,33,0,1,0
2,192,192,18,7,11,2,1
5,196,196,17,17,0,1,0
0,239,239,54,54,0,1,0
3,256,256,1,1,0,1,0
6,310,310,5,5,0,1,0
4,312,312,125,79,46,2,1

2,129,129,1,1,0,1,0
5,143,143,15,6,9,2,1
6,197,197,43,43,0,1,0
1,236,236,45,17,28,4,3
7,287,287,38,6,32,3,2
0,292,292,85,60,25,2,1
3,298,298,4,4,0,1,0
4,356,356,18,10,8,3,2

1,201,201,15,15,0,1,0
7,231,231,30,30,0,1,0
0,295,295,50,47,3,2,1
6,360,360,26,5,21,4,3
3,372,372,7,7,0,1,0
5,411,411,11,1,10,2,1
4,431,431,120,78,42,4,3
2,442,442,105,55,50,2,1

3,154,154,59,26,33,4,3
4,157,157,59,59,0,1,0
6,157,157,1,1,0,1,0
2,244,244,7,7,0,1,0
1,252,252,18,18,0,1,0
0,321,321,7,1,6,3,2
7,354,354,2,2,0,1,0
5,446,446,54,16,38,2,1

4,122,122,20,2,18,2,1
5,181,181,19,19,0,1,0
10,245,245,12,3,9,2,1
8,256,256,9,9,0,1,0
7,331,331,115,115,0,1,0
0,336,336,10,4,6,3,2
2,348,348,7,7,0,1,0
1,378,378,1,1,0,1,0
3,415,415,3,3,0,1,0
6,469,469,81,46,35,2,1
9,480,480,34,34,0,1,0

4,106,106,3,3,0,1,0
15,143,143,8,8,0,1,0
9,145,145,1,1,0,1,0
2,159,159,17,4,13,2,1
0,162,162,15,11,4,2,1
16,167,167,30,30,0,1,0
1,209,209,8,5,3,2,1
8,253,253,8,1,7,2,1
11,261,261,16,7,9,2,1
12,300,300,9,9,0,1,0
5,363,363,9,9,0,1,0
3,377,377,2,2,0,1,0
10,461,461,3,3,0,1,0
14,470,470,2,2,0,1,0
13,480,480,128,88,40,3,2
6,486,486,27,5,22,3,2
7,487,487,7,7,0,1,0

1,129,129,3,3,0,1,0
11,135,135,17,7,10,3,2
10,136,136,14,14,0,1,0
0,158,158,22,22,0,1,0
2,167,167,10,1,9,2,1
9,171,171,37,27,10,2,1
4,210,210,33,9,24,3,2
7,232,232,2,2,0,1,0
8,304,304,3,3,0,1,0
5,312,312,4,4,0,1,0
3,322,322,11,7,4,2,1
6,389,389,22,22,0,1,0
12,460,460,28,16,12,3,2

7,149,149,11,5,6,2,1
6,172,172,2,2,0,1,0
8,189,189,9,9,0,1,0
3,210,210,14,4,10,3,2
4,222,222,42,42,0,1,0
1,236,236,25,25,0,1,0
10,266,266,54,54,0,1,0
0,319,319,5,2,3,2,1
2,319,319,19,15,4,2,1
9,351,351,63,39,24,2,1
5,385,385,22,2,20,3,2

8,182,182,12,12,0,1,0
2,186,186,17,17,0,1,0
4,202,202,28,22,6,2,1
5,255,255,36,6,30,4,3
1,274,274,4,4,0,1,0
6,278,278,3,3,0,1,0
0,283,283,27,17,10,2,1
7,390,390,145,105,40,2,1
3,413,413,9,3,6,3,2
9,433,433,26,5,21,2,1

3,142,142,6,6,0,1,0
6,189,189,3,3,0,1,0
9,279,279,44,38,6,2,1
10,332,332,7,7,0,1,0
7,343,343,19,19,0,1,0
2,375,375,8,8,0,1,0
11,454,454,30,3,27,2,1
0,466,466,50,10,40,2,1
8,481,481,124,118,6,3,2
5,487,487,7,4,3,2,1
4,488,488,116,116,0,1,0
1,497,497,3,3,0,1,0

5,157,157,6,6,0,1,0
12,176,176,8,8,0,1,0
1,199,199,17,1,16,2,1
8,201,201,6,3,3,2,1
2,214,214,12,12,0,1,0
11,255,255,31,9,22,3,2
0,270,270,13,13,0,1,0
7,273,273,10,1,9,2,1
10,317,317,13,13,0,1,0
6,347,347,3,3,0,1,0
9,347,347,105,30,75,4,3
4,410,410,33,21,12,2,1
3,496,496,60,60,0,1,0

4,262,262,59,11,48,2,1
5,388,388,15,1,14,2,1
1,396,396,1,1,0,1,0
3,409,409,1,1,0,1,0
2,416,416,66,37,29,2,1
6,447,447,106,106,0,1,0
7,453,453,2,2,0,1,0
0,496,496,167,120,47,2,1

7,100,100,7,7,0,1,0
5,209,209,16,16,0,1,0
4,229,229,12,12,0,1,0
2,246,246,9,9,0,1,0
3,276,276,68,68,0,1,0
1,390,390,47,47,0,1,0
6,402,402,125,115,10,3,2
0,478,478,47,47,0,1,0

8,105,105,13,8,5,2,1
5,124,124,1,1,0,1,0
4,239,239,21,21,0,1,0
1,299,299,72,72,0,1,0
3,300,300,8,8,0,1,0
2,319,319,25,25,0,1,0
6,334,334,90,72,18,2,1
7,371,371,8,8,0,1,0
0,372,372,22,12,10,3,2
9,498,498,44,11,33,2,1

8,126,126,2,2,0,1,0
4,139,139,29,29,0,1,0
2,172,172,8,8,0,1,0
3,225,225,46,46,0,1,0
0,244,244,2,2,0,1,0
5,269,269,9,3,6,3,2
7,292,292,39,39,0,1,0
1,421,421,1,1,0,1,0
6,422,422,61,54,7,2,1
9,473,473,101,101,0,1,0

0,113,113,27,27,0,1,0
3,137,137,12,12,0,1,0
6,238,238,18,18,0,1,0
4,353,353,64,64,0,1,0
1,357,357,71,71,0,1,0
5,381,381,62,62,0,1,0
2,450,450,28,8,20,3,2

6,111,111,1,1,0,1,0
5,118,118,10,10,0,1,0
13,221,221,7,7,0,1,0
12,236,236,23,23,0,1,0
1,252,252,21,21,0,1,0
4,267,267,8,8,0,1,0
8,325,325,27,27,0,1,0
10,364,364,89,62,27,4,3
7,385,385,6,6,0,1,0
9,417,417,2,2,0,1,0
11,473,473,62,46,16,2,1
0,476,476,31,31,0,1,0
2,485,485,9,9,0,1,0
3,499,499,53,53,0,1,0

3,119,119,34,34,0,1,0
2,181,181,21,21,0,1,0
4,223,223,4,4,0,1,0
0,245,245,1,1,0,1,0
7,351,351,112,112,0,1,0
5,416,416,13,13,0,1,0
1,463,463,45,7,38,2,1
6,494,494,68,68,0,1,0

0,100,100,20,20,0,1,0
7,118,118,13,4,9,4,3
2,136,136,3,3,0,1,0
3,162,162,38,38,0,1,0
5,192,192,4,4,0,1,0
1,251,251,12,12,0,1,0
6,287,287,90,90,0,1,0
4,456,456,31,20,11,2,1

0,137,137,9,9,0,1,0
7,140,140,2,2,0,1,0
2,208,208,34,13,21,4,3
6,255,255,93,9,84,4,3
4,268,268,34,34,0,1,0
5,332,332,3,3,0,1,0
1,417,417,85,67,18,4,3
3,461,461,31,31,0,1,0

6,181,181,41,21,20,2,1
4,197,197,27,27,0,1,0
3,207,207,24,6,18,4,3
0,322,322,10,10,0,1,0
1,375,375,138,74,64,3,2
2,455,455,46,46,0,1,0
5,499,499,11,5,6,3,2

6,102,102,34,34,0,1,0
2,122,122,26,5,21,4,3
5,139,139,12,4,8,2,1
8,140,140,6,6,0,1,0
3,166,166,13,13,0,1,0
1,190,190,9,3,6,3,2
4,203,203,8,1,7,2,1
7,317,317,18,5,13,2,1
0,446,446,55,55,0,1,0

4,100,100,19,19,0,1,0
5,116,116,14,5,9,4,3
0,170,170,8,8,0,1,0
6,186,186,7,7,0,1,0
3,243,243,9,1,8,3,2
7,318,318,28,8,20,3,2
8,405,405,108,69,39,2,1
1,425,425,45,45,0,1,0
2,489,489,59,27,32,3,2

7,196,196,51,51,0,1,0
1,242,242,6,6,0,1,0
4,291,291,1,1,0,1,0
0,333,333,6,6,0,1,0
5,337,337,27,3,24,2,1
8,351,351,26,6,20,3,2
3,428,428,191,149,42,4,3
6,432,432,39,39,0,1,0
2,437,437,4,4,0,1,0

7,124,124,26,26,0,1,0
1,140,140,5,5,0,1,0
4,160,160,26,26,0,1,0
6,256,256,10,10,0,1,0
3,308,308,116,116,0,1,0
5,331,331,33,29,4,2,1
2,346,346,22,1,21,4,3
0,440,440,11,4,7,2,1

7,133,133,2,2,0,1,0
11,139,139,8,8,0,1,0
5,144,144,5,5,0,1,0
0,225,225,30,18,12,3,2
10,259,259,22,22,0,1,0
9,295,295,77,11,66,3,2
3,303,303,47,47,0,1,0
8,303,303,31,31,0,1,0
1,388,388,44,44,0,1,0
2,429,429,10,10,0,1,0
6,462,462,8,8,0,1,0
4,478,478,6,6,0,1,0

3,188,188,1,1,0,1,0
1,193,193,3,3,0,1,0
8,263,263,10,10,0,1,0
2,315,315,16,16,0,1,0
6,351,351,44,8,36,4,3
7,358,358,22,22,0,1,0
4,361,361,21,21,0,1,0
9,380,380,27,27,0,1,0
0,484,484,22,22,0,1,0
5,484,484,97,25,72,3,2
10,496,496,166,166,0,1,0

2,175,175,3,3,0,1,0
7,175,175,5,5,0,1,0
8,184,184,19,6,13,2,1
0,187,187,33,3,30,2,1
5,318,318,10,10,0,1,0
6,325,325,40,5,35,2,1
3,331,331,1,1,0,1,0
9,437,437,111,100,11,2,1
4,444,444,73,14,59,3,2
1,498,498,55,55,0,1,0

6,115,115,14,14,0,1,0
2,116,116,5,5,0,1,0
8,152,152,5,1,4,2,1
1,210,210,11,11,0,1,0
3,227,227,17,17,0,1,0
7,261,261,15,6,9,4,3
4,407,407,30,30,0,1,0
9,416,416,47,38,9,4,3
5,427,427,7,3,4,2,1
10,455,455,23,23,0,1,0
11,462,462,142,29,113,4,3
0,486,486,30,9,21,2,1

9,101,101,2,2,0,1,0
7,110,110,1,1,0,1,0
12,124,124,2,2,0,1,0
10,187,187,68,32,36,2,1
8,202,202,2,2,0,1,0
0,236,236,29,8,21,4,3
6,289,289,2,2,0,1,0
13,292,292,4,1,3,2,1
2,314,314,68,68,0,1,0
3,361,361,32,32,0,1,0
11,387,387,47,6,41,3,2
5,418,418,3,3,0,1,0
4,447,447,3,3,0,1,0
1,485,485,9,3,6,2,1

5,100,100,13,2,11,2,1
6,141,141,20,20,0,1,0
0,185,185,21,12,9,2,1
3,221,221,8,2,6,3,2
8,254,254,33,33,0,1,0
4,268,268,9,3,6,3,2
1,290,290,3,3,0,1,0
7,358,358,85,85,0,1,0
9,412,412,54,2,52,4,3
2,428,428,16,16,0,1,0
10,462,462,4,4,0,1,0

4,144,144,7,2,5,2,1
0,234,234,15,12,3,2,1
5,408,408,64,64,0,1,0
3,445,445,28,18,10,3,2
1,473,473,207,207,0,1,0
2,480,480,114,99,15,4,3

0,126,126,11,5,6,2,1
2,159,159,10,1,9,2,1
13,159,159,11,11,0,1,0
5,211,211,21,13,8,3,2
4,254,254,6,3,3,2,1
15,268,268,86,35,51,3,2
12,310,310,18,18,0,1,0
10,322,322,4,4,0,1,0
11,333,333,4,4,0,1,0
7,351,351,20,20,0,1,0
6,360,360,23,14,9,4,3
8,389,389,3,3,0,1,0
1,427,427,5,2,3,2,1
3,430,430,6,3,3,2,1
14,430,430,26,2,24,3,2
9,459,459,23,23,0,1,0

5,104,104,1,1,0,1,0
9,160,160,3,3,0,1,0
6,161,161,40,31,9,2,1
2,175,175,21,3,18,4,3
3,256,256,57,57,0,1,0
8,259,259,47,1,46,2,1
0,380,380,7,4,3,2,1
1,458,458,5,1,4,2,1
4,471,471,60,60,0,1,0
7,494,494,29,29,0,1,0

0,104,104,15,15,0,1,0
5,117,117,10,2,8,3,2
3,241,241,54,54,0,1,0
1,322,322,115,73,42,4,3
2,353,353,10,10,0,1,0
4,445,445,76,28,48,3,2

11,142,142,9,4,5,2,1
7,146,146,6,1,5,2,1
13,159,159,47,2,45,4,3
3,253,253,20,20,0,1,0
8,254,254,1,1,0,1,0
10,316,316,26,26,0,1,0
4,317,317,12,12,0,1,0
12,321,321,21,3,18,2,1
1,323,323,7,7,0,1,0
9,366,366,40,40,0,1,0
0,386,386,7,7,0,1,0
6,388,388,52,37,15,2,1
5,394,394,9,9,0,1,0
2,427,427,14,3,11,2,1

4,159,159,2,2,0,1,0
2,193,193,16,16,0,1,0
6,193,193,18,18,0,1,0
5,209,209,16,16,0,1,0
1,213,213,1,1,0,1,0
3,215,215,32,32,0,1,0
8,216,216,11,4,7,3,2
0,263,263,47,20,27,4,3
7,293,293,4,1,3,2,1
9,386,386,135,77,58,3,2

1,130,130,34,34,0,1,0
4,380,380,14,14,0,1,0
2,388,388,32,24,8,3,2
0,453,453,227,209,18,4,3
3,499,499,65,47,18,3,2

2,117,117,9,5,4,2,1
0,144,144,27,27,0,1,0
3,188,188,12,2,10,2,1
1,215,215,37,37,0,1,0
6,258,258,22,22,0,1,0
5,383,383,25,3,22,3,2
7,407,407,142,58,84,4,3
4,468,468,3,3,0,1,0

6,179,179,24,24,0,1,0
7,219,219,13,2,11,2,1
5,226,226,34,18,16,3,2
0,252,252,25,13,12,4,3
1,349,349,5,2,3,2,1
2,368,368,125,99,26,2,1
4,445,445,70,70,0,1,0
3,456,456,22,10,12,2,1

1,121,121,6,6,0,1,0
10,129,129,3,3,0,1,0
8,211,211,9,1,8,3,2
9,240,240,81,67,14,3,2
5,249,249,21,1,20,2,1
0,318,318,51,5,46,3,2
6,325,325,16,16,0,1,0
2,379,379,22,12,10,2,1
4,430,430,5,5,0,1,0
3,464,464,41,5,36,4,3
7,499,499,51,34,17,2,1

1,135,135,7,4,3,2,1
0,174,174,1,1,0,1,0
2,181,181,8,2,6,3,2
7,198,198,27,21,6,3,2
4,264,264,30,12,18,2,1
9,354,354,48,15,33,4,3
5,421,421,20,1,19,2,1
8,443,443,33,4,29,4,3
3,470,470,112,65,47,2,1
6,485,485,78,16,62,3,2

10,105,105,29,29,0,1,0
0,123,123,1,1,0,1,0
4,180,180,8,8,0,1,0
11,182,182,23,23,0,1,0
7,221,221,5,5,0,1,0
8,237,237,1,1,0,1,0
5,249,249,12,4,8,2,1
12,289,289,16,7,9,2,1
9,296,296,14,14,0,1,0
3,349,349,23,2,21,4,3
2,351,351,20,17,3,2,1
6,421,421,38,20,18,4,3
13,438,438,25,25,0,1,0
1,443,443,51,17,34,3,2

6,111,111,10,3,7,2,1
2,119,119,1,1,0,1,0
0,195,195,17,2,15,2,1
5,264,264,40,40,0,1,0
7,265,265,66,66,0,1,0
1,266,266,23,23,0,1,0
3,300,300,96,44,52,4,3
4,318,318,4,4,0,1,0

7,129,129,17,3,14,2,1
0,162,162,25,3,22,3,2
6,256,256,81,57,24,4,3
1,406,406,91,91,0,1,0
5,409,409,20,20,0,1,0
4,420,420,3,3,0,1,0
2,474,474,45,7,38,3,2
3,496,496,14,14,0,1,0

7,125,125,26,14,12,3,2
5,158,158,40,40,0,1,0
0,166,166,6,6,0,1,0
10,167,167,33,21,12,4,3
4,229,229,1,1,0,1,0
9,231,231,1,1,0,1,0
3,327,327,32,32,0,1,0
1,366,366,13,2,11,2,1
2,390,390,24,1,23,4,3
6,467,467,6,6,0,1,0
8,493,493,51,36,15,4,3

1,163,163,44,20,24,4,3
4,166,166,2,2,0,1,0
5,178,178,16,1,15,4,3
0,193,193,1,1,0,1,0
6,233,233,3,3,0,1,0
3,247,247,26,26,0,1,0
2,288,288,6,6,0,1,0
8,317,317,8,8,0,1,0
9,359,359,126,54,72,3,2
7,466,466,55,46,9,4,3

8,105,105,13,13,0,1,0
7,119,119,2,2,0,1,0
5,126,126,5,1,4,2,1
4,132,132,1,1,0,1,0
0,154,154,3,3,0,1,0
10,207,207,30,4,26,2,1
2,227,227,8,1,7,2,1
3,249,249,8,8,0,1,0
6,328,328,35,25,10,3,2
9,482,482,111,111,0,1,0
1,489,489,127,127,0,1,0

2,156,156,10,3,7,2,1
5,231,231,6,6,0,1,0
0,280,280,9,6,3,2,1
8,300,300,13,13,0,1,0
3,321,321,41,41,0,1,0
10,333,333,22,22,0,1,0
4,339,339,16,7,9,3,2
1,372,372,59,59,0,1,0
11,376,376,12,12,0,1,0
7,413,413,14,14,0,1,0
9,415,415,150,115,35,2,1
6,469,469,5,5,0,1,0

4,129,129,30,14,16,3,2
2,163,163,8,8,0,1,0
0,194,194,4,4,0,1,0
3,212,212,3,3,0,1,0
6,236,236,45,45,0,1,0
5,407,407,5,5,0,1,0
1,450,450,83,83,0,1,0
7,453,453,97,97,0,1,0
8,482,482,42,42,0,1,0

1,113,113,2,2,0,1,0
0,254,254,33,33,0,1,0
6,316,316,20,20,0,1,0
7,361,361,50,26,24,3,2
4,412,412,16,16,0,1,0
2,434,434,52,31,21,2,1
3,486,486,114,20,94,4,3
5,491,491,130,119,11,2,1

7,119,119,5,2,3,2,1
2,158,158,22,22,0,1,0
9,191,191,47,5,42,4,3
0,217,217,5,2,3,2,1
1,233,233,13,5,8,3,2
4,264,264,1,1,0,1,0
6,277,277,59,54,5,2,1
8,287,287,8,8,0,1,0
10,287,287,56,21,35,4,3
5,303,303,10,10,0,1,0
3,341,341,12,1,11,2,1

2,108,108,6,1,5,2,1
7,180,180,35,35,0,1,0
4,233,233,4,4,0,1,0
3,236,236,33,33,0,1,0
9,283,283,3,3,0,1,0
8,350,350,60,60,0,1,0
5,356,356,45,45,0,1,0
1,377,377,58,58,0,1,0
6,432,432,56,56,0,1,0
0,488,488,4,4,0,1,0

6,127,127,1,1,0,1,0
4,133,133,1,1,0,1,0
5,151,151,1,1,0,1,0
7,198,198,26,26,0,1,0
10,224,224,5,1,4,2,1
11,232,232,78,2,76,3,2
0,280,280,30,21,9,4,3
1,352,352,40,40,0,1,0
9,358,358,26,2,24,2,1
2,369,369,4,4,0,1,0
8,390,390,30,1,29,2,1
3,477,477,55,19,36,3,2

2,160,160,33,33,0,1,0
13,166,166,4,4,0,1,0
6,171,171,5,5,0,1,0
10,177,177,14,14,0,1,0
1,199,199,9,3,6,3,2
9,201,201,7,3,4,2,1
5,254,254,15,15,0,1,0
11,314,314,62,62,0,1,0
4,328,328,4,1,3,2,1
3,343,343,1,1,0,1,0
0,396,396,24,24,0,1,0
8,423,423,1,1,0,1,0
7,464,464,24,21,3,2,1
12,479,479,99,99,0,1,0

1,101,101,4,4,0,1,0
4,156,156,26,26,0,1,0
5,183,183,3,3,0,1,0
0,197,197,7,7,0,1,0
7,227,227,89,59,30,3,2
8,233,233,9,9,0,1,0
9,240,240,11,4,7,2,1
10,264,264,10,1,9,2,1
2,391,391,32,32,0,1,0
3,413,413,41,41,0,1,0
6,422,422,26,5,21,3,2

7,102,102,15,12,3,2,1
8,173,173,5,5,0,1,0
2,204,204,28,28,0,1,0
0,219,219,31,31,0,1,0
6,267,267,16,2,14,3,2
1,283,283,17,17,0,1,0
10,289,289,48,48,0,1,0
3,387,387,12,9,3,2,1
4,405,405,12,4,8,2,1
5,410,410,17,17,0,1,0
9,469,469,80,80,0,1,0

0,121,121,1,1,0,1,0
8,162,162,17,7,10,3,2
3,237,237,5,5,0,1,0
2,239,239,39,20,19,2,1
7,259,259,30,30,0,1,0
13,311,311,47,38,9,4,3
5,331,331,5,5,0,1,0
4,341,341,2,2,0,1,0
1,351,351,4,4,0,1,0
10,351,351,19,19,0,1,0
9,392,392,21,1,20,3,2
6,423,423,1,1,0,1,0
11,429,429,12,3,9,4,3
12,497,497,135,96,39,2,1

0,159,159,2,2,0,1,0
5,176,176,11,1,10,2,1
2,200,200,14,14,0,1,0
8,206,206,28,4,24,2,1
3,221,221,52,14,38,2,1
6,274,274,17,17,0,1,0
4,330,330,24,18,6,2,1
9,362,362,85,31,54,4,3
7,418,418,31,1,30,4,3
1,476,476,23,5,18,2,1

3,184,184,24,1,23,4,3
7,185,185,42,42,0,1,0
1,209,209,24,15,9,2,1
2,236,236,12,2,10,3,2
6,333,333,1,1,0,1,0
8,335,335,51,51,0,1,0
4,406,406,58,25,33,4,3
5,407,407,50,50,0,1,0
0,460,460,29,29,0,1,0

2,115,115,9,9,0,1,0
0,123,123,17,12,5,2,1
5,138,138,10,3,7,2,1
8,190,190,39,18,21,4,3
6,341,341,62,62,0,1,0
4,369,369,7,1,6,2,1
1,429,429,79,33,46,3,2
7,452,452,1,1,0,1,0
9,473,473,56,44,12,3,2
3,492,492,6,6,0,1,0

1,142,142,6,6,0,1,0
3,175,175,18,18,0,1,0
6,224,224,44,44,0,1,0
2,264,264,49,35,14,3,2
8,282,282,1,1,0,1,0
5,335,335,63,63,0,1,0
4,449,449,65,5,60,4,3
7,460,460,54,21,33,4,3
0,490,490,13,1,12,4,3

6,126,126,19,4,15,4,3
1,161,161,13,6,7,2,1
4,205,205,35,11,24,3,2
3,276,276,1,1,0,1,0
5,299,299,55,19,36,2,1
2,422,422,106,73,33,4,3
0,456,456,77,77,0,1,0

5,138,138,8,5,3,2,1
7,162,162,37,7,30,4,3
0,174,174,40,40,0,1,0
4,178,178,24,3,21,4,3
6,283,283,33,33,0,1,0
9,288,288,31,5,26,2,1
3,345,345,1,1,0,1,0
8,407,407,23,5,18,2,1
2,412,412,23,6,17,2,1
1,476,476,9,2,7,2,1

6,123,123,9,9,0,1,0
5,167,167,1,1,0,1,0
3,298,298,89,61,28,2,1
0,305,305,25,25,0,1,0
2,347,347,14,14,0,1,0
4,471,471,61,32,29,2,1
1,486,486,184,158,26,2,1

8,113,113,23,23,0,1,0
0,133,133,24,12,12,3,2
6,137,137,27,2,25,4,3
7,146,146,8,8,0,1,0
1,157,157,17,17,0,1,0
4,169,169,11,1,10,3,2
2,316,316,24,24,0,1,0
5,323,323,17,5,12,4,3
3,414,414,31,7,24,2,1

10,171,171,61,61,0,1,0
0,207,207,8,8,0,1,0
2,300,300,13,13,0,1,0
6,331,331,15,8,7,2,1
1,337,337,28,28,0,1,0
8,363,363,26,10,16,3,2
4,374,374,15,15,0,1,0
9,441,441,5,5,0,1,0
5,470,470,66,66,0,1,0
3,474,474,53,25,28,2,1
7,495,495,33,33,0,1,0

8,129,129,26,26,0,1,0
9,145,145,5,5,0,1,0
3,160,160,17,17,0,1,0
5,239,239,23,23,0,1,0
1,247,247,29,29,0,1,0
6,257,257,27,27,0,1,0
0,284,284,5,5,0,1,0
2,325,325,4,4,0,1,0
11,356,356,37,13,24,2,1
4,358,358,10,10,0,1,0
7,359,359,7,7,0,1,0
10,452,452,77,77,0,1,0

1,140,140,4,4,0,1,0
2,151,151,15,15,0,1,0
12,163,163,14,2,12,3,2
5,172,172,16,16,0,1,0
8,214,214,6,6,0,1,0
11,273,273,13,13,0,1,0
10,288,288,103,46,57,4,3
13,298,298,4,4,0,1,0
0,311,311,9,1,8,3,2
7,383,383,21,21,0,1,0
3,431,431,37,37,0,1,0
9,434,434,15,15,0,1,0
6,444,444,3,3,0,1,0
4,465,465,19,19,0,1,0

0,128,128,7,7,0,1,0
2,134,134,1,1,0,1,0
6,157,157,11,5,6,2,1
8,166,166,2,2,0,1,0
7,192,192,13,13,0,1,0
9,229,229,95,78,17,2,1
4,309,309,5,5,0,1,0
1,419,419,84,84,0,1,0
5,436,436,59,59,0,1,0
3,477,477,9,3,6,2,1
10,499,499,8,1,7,3,2

1,120,120,14,14,0,1,0
6,130,130,2,2,0,1,0
2,250,250,94,67,27,4,3
4,334,334,17,7,10,3,2
3,379,379,25,3,22,3,2
0,407,407,3,3,0,1,0
5,499,499,188,116,72,4,3

5,103,103,3,3,0,1,0
10,235,235,83,83,0,1,0
1,289,289,21,21,0,1,0
4,318,318,17,5,12,2,1
6,366,366,5,5,0,1,0
0,387,387,3,3,0,1,0
2,389,389,116,95,21,4,3
7,392,392,2,2,0,1,0
3,408,408,11,3,8,3,2
8,442,442,47,29,18,2,1
9,442,442,20,9,11,2,1

4,128,128,1,1,0,1,0
1,153,153,10,10,0,1,0
0,225,225,16,4,12,4,3
3,232,232,74,41,33,4,3
5,289,289,5,5,0,1,0
6,311,311,23,23,0,1,0
2,374,374,14,14,0,1,0
7,399,399,124,115,9,4,3
8,496,496,50,35,15,4,3

7,127,127,22,22,0,1,0
4,201,201,5,5,0,1,0
6,242,242,23,23,0,1,0
8,247,247,35,27,8,3,2
1,277,277,59,59,0,1,0
3,308,308,1,1,0,1,0
2,358,358,6,6,0,1,0
0,392,392,96,96,0,1,0
5,398,398,41,41,0,1,0

1,184,184,78,78,0,1,0
3,190,190,51,51,0,1,0
0,245,245,19,19,0,1,0
5,273,273,4,4,0,1,0
4,304,304,15,15,0,1,0
2,342,342,59,37,22,4,3

6,120,120,12,12,0,1,0
7,215,215,38,4,34,2,1
1,233,233,7,2,5,2,1
5,268,268,39,25,14,3,2
10,288,288,7,7,0,1,0
0,351,351,12,3,9,2,1
3,367,367,17,5,12,2,1
2,435,435,36,36,0,1,0
8,454,454,89,89,0,1,0
4,458,458,29,23,6,3,2
9,471,471,50,14,36,3,2

2,136,136,52,10,42,4,3
1,152,152,7,7,0,1,0
5,172,172,25,18,7,2,1
4,209,209,19,4,15,4,3
7,240,240,55,34,21,4,3
6,273,273,12,12,0,1,0
3,308,308,5,2,3,2,1
0,317,317,18,9,9,4,3

1,113,113,8,4,4,2,1
6,141,141,8,8,0,1,0
8,154,154,10,10,0,1,0
4,159,159,3,3,0,1,0
11,212,212,20,20,0,1,0
9,248,248,6,3,3,2,1
0,249,249,2,2,0,1,0
2,260,260,3,3,0,1,0
7,306,306,50,26,24,2,1
3,329,329,22,18,4,2,1
5,359,359,15,15,0,1,0
10,454,454,42,42,0,1,0
12,491,491,145,99,46,3,2

10,152,152,18,3,15,4,3
5,184,184,4,4,0,1,0
1,192,192,2,2,0,1,0
3,263,263,36,18,18,3,2
8,271,271,89,5,84,3,2
7,286,286,3,3,0,1,0
2,327,327,28,4,24,3,2
0,329,329,6,6,0,1,0
9,365,365,21,12,9,4,3
4,425,425,87,60,27,4,3
11,430,430,1,1,0,1,0
6,495,495,7,4,3,2,1

4,111,111,4,1,3,2,1
2,177,177,5,5,0,1,0
12,177,177,34,30,4,2,1
0,205,205,1,1,0,1,0
3,210,210,12,12,0,1,0
11,262,262,6,2,4,2,1
7,291,291,28,6,22,3,2
1,303,303,16,16,0,1,0
6,305,305,47,23,24,4,3
9,362,362,1,1,0,1,0
8,409,409,18,18,0,1,0
10,429,429,124,124,0,1,0
5,495,495,14,2,12,4,3

4,134,134,34,6,28,3,2
6,134,134,5,5,0,1,0
5,137,137,5,5,0,1,0
12,184,184,16,16,0,1,0
7,230,230,6,6,0,1,0
8,260,260,19,3,16,2,1
0,284,284,13,13,0,1,0
11,301,301,25,25,0,1,0
3,342,342,5,5,0,1,0
1,349,349,1,1,0,1,0
10,353,353,84,77,7,2,1
2,360,360,4,4,0,1,0
9,433,433,42,42,0,1,0

4,112,112,18,18,0,1,0
7,117,117,16,16,0,1,0
6,144,144,25,25,0,1,0
3,310,310,11,7,4,2,1
0,331,331,31,2,29,2,1
2,347,347,67,10,57,4,3
1,396,396,10,2,8,3,2
5,423,423,22,14,8,2,1
8,431,431,64,3,61,3,2

10,148,148,29,29,0,1,0
8,188,188,13,13,0,1,0
4,209,209,24,6,18,2,1
1,221,221,4,4,0,1,0
2,340,340,21,1,20,3,2
6,354,354,6,6,0,1,0
7,404,404,56,24,32,2,1
3,419,419,22,10,12,2,1
9,445,445,45,27,18,4,3
0,452,452,53,10,43,2,1
5,498,498,60,44,16,3,2

4,140,140,1,1,0,1,0
5,161,161,10,10,0,1,0
11,169,169,30,30,0,1,0
1,176,176,10,4,6,2,1
7,206,206,17,17,0,1,0
9,253,253,7,3,4,2,1
2,293,293,2,2,0,1,0
10,319,319,37,37,0,1,0
6,321,321,27,20,7,2,1
3,353,353,41,12,29,2,1
0,403,403,35,4,31,4,3
8,449,449,85,9,76,4,3

0,177,177,22,22,0,1,0
2,281,281,35,35,0,1,0
5,292,292,12,7,5,2,1
1,338,338,43,19,24,2,1
3,340,340,43,16,27,4,3
4,415,415,73,23,50,3,2
7,478,478,23,17,6,2,1
6,498,498,120,105,15,2,1

3,175,175,4,4,0,1,0
12,270,270,39,39,0,1,0
1,278,278,6,1,5,2,1
8,293,293,1,1,0,1,0
6,297,297,40,40,0,1,0
9,314,314,39,26,13,2,1
5,330,330,18,4,14,2,1
10,369,369,26,26,0,1,0
13,382,382,3,3,0,1,0
0,391,391,17,5,12,2,1
11,440,440,78,78,0,1,0
7,458,458,5,5,0,1,0
14,458,458,81,81,0,1,0
4,470,470,1,1,0,1,0
2,495,495,7,7,0,1,0

3,104,104,34,8,26,2,1
1,213,213,1,1,0,1,0
2,259,259,17,10,7,2,1
8,289,289,27,3,24,4,3
9,337,337,42,21,21,4,3
4,352,352,3,3,0,1,0
10,372,372,17,10,7,2,1
6,386,386,35,35,0,1,0
5,393,393,1,1,0,1,0
7,465,465,112,38,74,4,3
0,475,475,1,1,0,1,0

0,101,101,2,2,0,1,0
1,131,131,7,4,3,2,1
6,175,175,43,43,0,1,0
10,255,255,61,15,46,3,2
7,279,279,13,13,0,1,0
9,313,313,39,29,10,2,1
8,369,369,35,23,12,4,3
4,376,376,6,6,0,1,0
5,400,400,21,21,0,1,0
2,421,421,9,4,5,2,1
3,425,425,40,40,0,1,0

0,111,111,4,4,0,1,0
5,189,189,4,4,0,1,0
6,258,258,19,19,0,1,0
4,300,300,16,7,9,4,3
1,317,317,10,4,6,2,1
2,342,342,5,5,0,1,0
3,406,406,170,170,0,1,0
7,486,486,174,174,0,1,0

6,151,151,1,1,0,1,0
4,216,216,22,22,0,1,0
1,218,218,30,1,29,4,3
10,245,245,4,1,3,2,1
3,254,254,1,1,0,1,0
2,309,309,24,24,0,1,0
7,344,344,21,10,11,2,1
5,422,422,10,10,0,1,0
11,433,433,78,35,43,2,1
9,436,436,100,100,0,1,0
8,443,443,36,36,0,1,0
0,467,467,42,42,0,1,0

3,136,136,34,34,0,1,0
2,170,170,25,22,3,2,1
0,252,252,62,12,50,3,2
1,281,281,31,31,0,1,0
5,400,400,64,59,5,2,1
4,477,477,30,30,0,1,0
6,490,490,18,10,8,2,1

11,133,133,32,32,0,1,0
1,184,184,2,2,0,1,0
3,255,255,5,5,0,1,0
9,255,255,4,4,0,1,0
0,295,295,5,1,4,2,1
10,306,306,66,12,54,4,3
6,312,312,65,2,63,4,3
7,318,318,27,12,15,4,3
8,322,322,14,14,0,1,0
2,398,398,14,7,7,2,1
5,458,458,47,47,0,1,0
4,497,497,11,11,0,1,0

5,105,105,5,5,0,1,0
10,129,129,4,4,0,1,0
1,133,133,13,8,5,2,1
2,212,212,1,1,0,1,0
6,215,215,5,2,3,2,1
9,221,221,45,3,42,2,1
8,273,273,23,23,0,1,0
7,276,276,53,41,12,2,1
4,297,297,6,6,0,1,0
3,440,440,35,10,25,2,1
0,478,478,109,99,10,3,2

7,122,122,8,8,0,1,0
3,251,251,16,16,0,1,0
8,256,256,26,26,0,1,0
6,258,258,72,72,0,1,0
0,263,263,24,24,0,1,0
1,387,387,6,6,0,1,0
2,434,434,12,6,6,3,2
9,442,442,26,7,19,2,1
5,451,451,134,36,98,4,3
4,455,455,3,3,0,1,0

6,102,102,15,10,5,2,1
7,104,104,1,1,0,1,0
1,151,151,20,20,0,1,0
0,205,205,4,4,0,1,0
8,238,238,42,24,18,2,1
9,238,238,43,20,23,2,1
4,295,295,45,39,6,2,1
5,330,330,11,5,6,2,1
2,338,338,4,4,0,1,0
10,393,393,55,16,39,3,2
3,440,440,2,2,0,1,0

9,114,114,11,11,0,1,0
11,133,133,14,6,8,3,2
0,143,143,2,2,0,1,0
2,150,150,8,1,7,2,1
1,205,205,4,4,0,1,0
6,208,208,12,3,9,4,3
7,267,267,65,65,0,1,0
5,307,307,13,3,10,3,2
3,374,374,2,2,0,1,0
4,385,385,8,2,6,2,1
10,411,411,73,63,10,2,1
12,439,439,56,56,0,1,0
8,461,461,21,13,8,3,2

2,149,149,3,3,0,1,0
6,154,154,6,6,0,1,0
4,282,282,25,10,15,4,3
1,340,340,26,2,24,3,2
0,458,458,185,105,80,3,2
5,466,466,70,70,0,1,0
3,469,469,107,85,22,4,3

1,110,110,5,5,0,1,0
3,167,167,3,3,0,1,0
4,222,222,70,70,0,1,0
7,335,335,34,7,27,4,3
6,337,337,32,23,9,2,1
5,346,346,77,39,38,2,1
8,378,378,33,33,0,1,0
2,381,381,22,4,18,3,2
0,489,489,32,32,0,1,0

4,102,102,12,12,0,1,0
1,157,157,28,28,0,1,0
2,189,189,66,25,41,2,1
3,268,268,12,1,11,4,3
0,369,369,120,120,0,1,0
5,420,420,1,1,0,1,0

0,179,179,24,17,7,2,1
1,193,193,14,14,0,1,0
5,200,200,34,34,0,1,0
4,346,346,12,2,10,3,2
2,419,419,123,15,108,4,3
3,476,476,107,77,30,4,3
6,492,492,38,9,29,2,1

2,157,157,4,4,0,1,0
4,216,216,29,10,19,4,3
7,250,250,29,16,13,4,3
9,267,267,46,46,0,1,0
3,295,295,2,2,0,1,0
0,312,312,14,14,0,1,0
5,348,348,36,36,0,1,0
1,449,449,84,76,8,2,1
6,452,452,61,61,0,1,0
8,453,453,37,37,0,1,0

7,118,118,16,1,15,2,1
4,130,130,11,1,10,2,1
9,167,167,39,39,0,1,0
2,199,199,9,3,6,2,1
6,312,312,41,23,18,4,3
5,318,318,20,16,4,2,1
11,329,329,6,6,0,1,0
3,344,344,2,2,0,1,0
8,369,369,4,4,0,1,0
10,383,383,95,95,0,1,0
1,388,388,11,2,9,3,2
0,465,465,4,4,0,1,0

1,198,198,43,43,0,1,0
2,240,240,25,1,24,2,1
0,378,378,107,17,90,4,3
4,432,432,61,1,60,4,3
3,470,470,32,32,0,1,0
5,477,477,91,1,90,3,2

11,104,104,8,8,0,1,0
1,139,139,13,5,8,3,2
3,182,182,2,2,0,1,0
10,209,209,3,3,0,1,0
9,279,279,101,77,24,3,2
12,279,279,17,17,0,1,0
8,305,305,27,27,0,1,0
5,361,361,8,8,0,1,0
6,369,369,16,16,0,1,0
2,431,431,38,38,0,1,0
4,455,455,4,4,0,1,0
0,496,496,48,48,0,1,0
7,500,500,24,7,17,2,1

3,205,205,35,14,21,2,1
0,292,292,68,51,17,2,1
2,372,372,78,78,0,1,0
1,418,418,112,30,82,3,2
5,434,434,8,8,0,1,0
4,480,480,50,28,22,3,2

5,112,112,7,7,0,1,0
3,127,127,3,3,0,1,0
9,183,183,38,38,0,1,0
8,191,191,37,10,27,2,1
2,270,270,23,13,10,3,2
7,274,274,7,7,0,1,0
1,380,380,19,19,0,1,0
4,393,393,92,4,88,3,2
6,415,415,33,19,14,3,2
0,481,481,25,7,18,4,3

1,102,102,19,19,0,1,0
0,145,145,7,7,0,1,0
10,156,156,28,28,0,1,0
11,171,171,1,1,0,1,0
6,240,240,26,12,14,3,2
9,306,306,61,6,55,4,3
12,315,315,39,28,11,2,1
8,355,355,7,7,0,1,0
2,356,356,1,1,0,1,0
3,409,409,1,1,0,1,0
4,421,421,39,25,14,3,2
7,480,480,19,4,15,2,1
5,482,482,1,1,0,1,0

7,111,111,1,1,0,1,0
0,141,141,1,1,0,1,0
4,194,194,72,72,0,1,0
2,201,201,36,21,15,2,1
6,214,214,16,16,0,1,0
3,355,355,28,5,23,4,3
5,406,406,23,17,6,2,1
1,442,442,104,104,0,1,0

2,154,154,44,29,15,2,1
3,159,159,1,1,0,1,0
7,166,166,3,3,0,1,0
5,212,212,32,2,30,3,2
4,215,215,33,25,8,2,1
1,224,224,11,11,0,1,0
0,271,271,44,44,0,1,0
6,314,314,57,57,0,1,0

7,129,129,28,9,19,2,1
9,154,154,4,4,0,1,0
6,262,262,7,7,0,1,0
4,268,268,29,29,0,1,0
2,291,291,4,4,0,1,0
8,296,296,72,46,26,4,3
1,332,332,44,9,35,2,1
3,371,371,43,14,29,2,1
5,415,415,52,26,26,3,2
0,444,444,2,2,0,1,0

7,115,115,10,10,0,1,0
9,138,138,2,2,0,1,0
10,182,182,34,8,26,2,1
8,197,197,3,3,0,1,0
6,269,269,1,1,0,1,0
11,277,277,54,54,0,1,0
3,280,280,26,12,14,3,2
13,314,314,6,6,0,1,0
12,336,336,36,9,27,4,3
1,357,357,33,33,0,1,0
5,379,379,28,13,15,2,1
4,414,414,1,1,0,1,0
0,445,445,14,14,0,1,0
2,446,446,41,13,28,3,2

9,115,115,19,1,18,2,1
6,156,156,3,3,0,1,0
7,166,166,33,17,16,2,1
5,197,197,36,27,9,2,1
3,266,266,4,4,0,1,0
2,286,286,18,18,0,1,0
4,298,298,3,3,0,1,0
1,303,303,40,13,27,4,3
8,321,321,33,33,0,1,0
10,329,329,13,13,0,1,0
0,422,422,33,12,21,2,1

1,104,104,15,11,4,2,1
8,105,105,3,3,0,1,0
5,157,157,7,7,0,1,0
4,212,212,13,13,0,1,0
3,344,344,12,12,0,1,0
0,356,356,89,8,81,4,3
7,405,405,152,8,144,4,3
6,475,475,31,31,0,1,0
2,494,494,6,3,3,2,1

6,175,175,6,6,0,1,0
7,183,183,2,2,0,1,0
8,188,188,1,1,0,1,0
4,235,235,48,1,47,2,1
10,278,278,5,5,0,1,0
11,386,386,86,86,0,1,0
1,396,396,5,2,3,2,1
2,462,462,2,2,0,1,0
9,472,472,125,79,46,4,3
0,490,490,100,56,44,3,2
5,497,497,1,1,0,1,0
3,500,500,15,15,0,1,0

3,122,122,12,12,0,1,0
13,171,171,3,3,0,1,0
6,176,176,30,30,0,1,0
11,206,206,14,14,0,1,0
10,214,214,19,7,12,3,2
9,268,268,1,1,0,1,0
12,291,291,96,30,66,4,3
5,296,296,30,15,15,4,3
4,321,321,20,20,0,1,0
1,352,352,6,6,0,1,0
0,374,374,4,1,3,2,1
7,381,381,1,1,0,1,0
8,395,395,3,3,0,1,0
2,401,401,11,11,0,1,0

2,167,167,17,12,5,2,1
4,170,170,1,1,0,1,0
6,189,189,1,1,0,1,0
5,261,261,17,14,3,2,1
1,282,282,60,45,15,4,3
9,318,318,14,14,0,1,0
0,360,360,3,3,0,1,0
7,388,388,134,83,51,4,3
8,425,425,49,49,0,1,0
3,434,434,47,9,38,3,2

12,108,108,46,46,0,1,0
0,161,161,2,2,0,1,0
1,164,164,5,5,0,1,0
11,166,166,4,4,0,1,0
4,170,170,21,5,16,2,1
10,189,189,10,10,0,1,0
9,226,226,2,2,0,1,0
2,288,288,20,3,17,3,2
5,299,299,13,1,12,4,3
3,346,346,1,1,0,1,0
8,376,376,23,17,6,3,2
6,401,401,48,48,0,1,0
7,436,436,17,17,0,1,0

3,111,111,7,4,3,2,1
4,128,128,6,6,0,1,0
2,137,137,2,2,0,1,0
1,219,219,27,1,26,2,1
0,432,432,164,72,92,3,2
5,440,440,175,139,36,4,3

7,100,100,18,4,14,3,2
2,110,110,1,1,0,1,0
1,155,155,7,1,6,2,1
4,165,165,3,3,0,1,0
6,195,195,1,1,0,1,0
3,210,210,17,17,0,1,0
9,213,213,14,14,0,1,0
0,229,229,9,5,4,2,1
11,268,268,16,16,0,1,0
5,303,303,1,1,0,1,0
12,311,311,4,4,0,1,0
8,393,393,47,47,0,1,0
10,403,403,148,148,0,1,0

3,110,110,2,2,0,1,0
0,126,126,46,46,0,1,0
7,168,168,1,1,0,1,0
6,242,242,103,103,0,1,0
1,282,282,2,2,0,1,0
5,372,372,11,1,10,2,1
2,379,379,42,42,0,1,0
4,384,384,18,18,0,1,0

7,131,131,12,12,0,1,0
9,165,165,30,10,20,3,2
10,202,202,15,7,8,3,2
2,205,205,11,11,0,1,0
5,228,228,12,12,0,1,0
1,236,236,19,19,0,1,0
4,237,237,29,29,0,1,0
8,272,272,67,67,0,1,0
0,298,298,1,1,0,1,0
6,351,351,29,23,6,3,2
11,430,430,3,3,0,1,0
3,445,445,9,9,0,1,0

5,146,146,18,18,0,1,0
6,212,212,10,10,0,1,0
7,252,252,17,17,0,1,0
10,323,323,2,2,0,1,0
9,329,329,76,43,33,2,1
0,370,370,4,1,3,2,1
3,385,385,9,9,0,1,0
11,400,400,26,26,0,1,0
8,433,433,89,77,12,2,1
4,437,437,71,71,0,1,0
2,439,439,26,26,0,1,0
1,440,440,3,3,0,1,0

0,135,135,1,1,0,1,0
4,138,138,4,4,0,1,0
8,215,215,55,8,47,3,2
6,257,257,48,15,33,4,3
2,298,298,44,20,24,2,1
5,307,307,7,7,0,1,0
3,375,375,42,42,0,1,0
7,408,408,17,5,12,2,1
1,409,409,84,30,54,3,2

5,105,105,15,15,0,1,0
0,129,129,52,52,0,1,0
3,283,283,10,7,3,2,1
6,285,285,43,2,41,2,1
4,376,376,66,3,63,4,3
2,472,472,26,26,0,1,0
1,498,498,21,1,20,2,1

5,131,131,2,2,0,1,0
2,189,189,14,5,9,4,3
1,190,190,28,8,20,2,1
3,315,315,54,36,18,2,1
4,427,427,105,105,0,1,0
0,472,472,168,168,0,1,0

1,137,137,4,4,0,1,0
6,163,163,8,2,6,3,2
9,169,169,23,23,0,1,0
0,192,192,23,16,7,2,1
4,237,237,1,1,0,1,0
8,237,237,7,7,0,1,0
2,280,280,6,1,5,2,1
7,291,291,84,40,44,4,3
5,332,332,7,2,5,2,1
3,371,371,114,105,9,2,1

9,152,152,2,2,0,1,0
10,157,157,23,11,12,2,1
7,166,166,6,6,0,1,0
8,167,167,3,3,0,1,0
2,215,215,7,1,6,3,2
1,219,219,6,6,0,1,0
13,236,236,27,22,5,2,1
5,259,259,4,4,0,1,0
6,265,265,12,12,0,1,0
11,336,336,15,2,13,2,1
12,359,359,73,23,50,3,2
0,406,406,12,12,0,1,0
4,469,469,15,15,0,1,0
3,488,488,125,44,81,4,3

5,104,104,36,14,22,3,2
2,160,160,10,10,0,1,0
0,202,202,5,5,0,1,0
7,217,217,17,17,0,1,0
4,297,297,84,58,26,2,1
3,339,339,32,32,0,1,0
1,344,344,13,13,0,1,0
6,435,435,3,3,0,1,0
8,458,458,35,35,0,1,0

10,100,100,3,3,0,1,0
5,106,106,9,9,0,1,0
6,123,123,1,1,0,1,0
12,132,132,11,11,0,1,0
8,201,201,11,11,0,1,0
7,222,222,11,11,0,1,0
4,226,226,10,10,0,1,0
2,247,247,26,22,4,2,1
0,251,251,34,34,0,1,0
9,328,328,34,17,17,2,1
1,330,330,4,4,0,1,0
3,433,433,4,4,0,1,0
11,485,485,147,53,94,4,3

0,108,108,10,10,0,1,0
5,186,186,19,19,0,1,0
1,239,239,14,6,8,2,1
7,332,332,15,5,10,2,1
4,388,388,20,20,0,1,0
6,391,391,121,121,0,1,0
3,394,394,100,62,38,3,2
2,478,478,46,46,0,1,0

6,105,105,13,13,0,1,0
8,116,116,10,10,0,1,0
2,157,157,36,36,0,1,0
9,211,211,28,14,14,3,2
5,340,340,21,21,0,1,0
0,367,367,19,8,11,2,1
3,381,381,11,1,10,3,2
1,417,417,31,6,25,2,1
7,438,438,72,11,61,4,3
4,470,470,26,26,0,1,0

1,105,105,1,1,0,1,0
9,144,144,7,1,6,3,2
8,195,195,1,1,0,1,0
14,196,196,25,13,12,4,3
3,280,280,5,1,4,2,1
13,285,285,89,20,69,4,3
11,286,286,1,1,0,1,0
6,315,315,15,1,14,2,1
12,342,342,12,6,6,2,1
7,353,353,10,10,0,1,0
4,355,355,20,6,14,2,1
5,381,381,61,61,0,1,0
10,428,428,4,4,0,1,0
2,461,461,34,34,0,1,0
0,468,468,20,20,0,1,0
15,477,477,16,7,9,4,3

1,112,112,5,5,0,1,0
2,146,146,2,2,0,1,0
7,176,176,37,37,0,1,0
0,262,262,32,32,0,1,0
3,287,287,11,11,0,1,0
4,288,288,81,57,24,2,1
8,356,356,14,5,9,2,1
5,400,400,86,19,67,4,3
6,452,452,19,7,12,4,3

2,129,129,21,16,5,2,1
4,211,211,12,12,0,1,0
3,241,241,29,29,0,1,0
0,256,256,45,45,0,1,0
5,374,374,65,65,0,1,0
1,382,382,124,57,67,3,2

7,144,144,1,1,0,1,0
2,151,151,10,10,0,1,0
6,164,164,31,5,26,2,1
3,170,170,3,3,0,1,0
5,172,172,2,2,0,1,0
0,239,239,30,30,0,1,0
8,242,242,10,10,0,1,0
9,254,254,38,31,7,2,1
1,316,316,14,14,0,1,0
4,343,343,15,15,0,1,0
10,349,349,74,74,0,1,0
11,464,464,48,8,40,2,1

0,145,145,18,18,0,1,0
2,148,148,13,13,0,1,0
3,188,188,11,11,0,1,0
7,228,228,5,5,0,1,0
1,292,292,68,68,0,1,0
6,356,356,121,121,0,1,0
4,374,374,7,1,6,2,1
5,402,402,51,30,21,2,1

4,104,104,1,1,0,1,0
9,124,124,3,3,0,1,0
7,211,211,38,22,16,2,1
3,226,226,19,3,16,3,2
8,231,231,46,46,0,1,0
2,267,267,8,8,0,1,0
5,310,310,26,26,0,1,0
0,343,343,25,5,20,2,1
1,382,382,85,21,64,3,2
6,413,413,45,45,0,1,0

3,187,187,44,27,17,2,1
1,193,193,27,27,0,1,0
6,251,251,26,1,25,2,1
4,351,351,19,19,0,1,0
7,388,388,38,38,0,1,0
5,445,445,111,48,63,4,3
0,457,457,45,30,15,4,3
2,464,464,14,7,7,2,1

7,182,182,8,8,0,1,0
3,335,335,74,74,0,1,0
5,351,351,50,43,7,2,1
8,373,373,115,82,33,4,3
2,375,375,42,42,0,1,0
4,383,383,38,2,36,2,1
6,417,417,5,5,0,1,0
0,422,422,2,2,0,1,0
1,454,454,29,29,0,1,0

10,123,123,3,3,0,1,0
7,162,162,22,13,9,2,1
9,179,179,26,3,23,2,1
2,265,265,23,13,10,2,1
8,329,329,67,63,4,2,1
3,338,338,33,33,0,1,0
5,346,346,29,29,0,1,0
0,374,374,27,27,0,1,0
6,403,403,21,21,0,1,0
4,445,445,2,2,0,1,0
1,477,477,50,22,28,2,1

7,107,107,2,2,0,1,0
6,116,116,5,1,4,2,1
13,138,138,34,34,0,1,0
0,178,178,5,5,0,1,0
4,242,242,15,10,5,2,1
1,244,244,9,1,8,3,2
10,247,247,2,2,0,1,0
14,305,305,9,4,5,2,1
9,332,332,52,52,0,1,0
5,341,341,18,3,15,4,3
8,387,387,19,1,18,4,3
3,406,406,6,6,0,1,0
11,439,439,52,40,12,3,2
2,488,488,16,9,7,2,1
12,489,489,55,30,25,2,1

1,105,105,1,1,0,1,0
0,120,120,11,11,0,1,0
8,124,124,25,25,0,1,0
3,137,137,19,19,0,1,0
5,141,141,11,1,10,2,1
7,240,240,4,4,0,1,0
4,334,334,13,13,0,1,0
2,468,468,104,12,92,3,2
6,498,498,106,58,48,3,2

6,168,168,6,2,4,2,1
7,209,209,67,67,0,1,0
0,273,273,40,2,38,2,1
4,328,328,34,34,0,1,0
9,330,330,33,33,0,1,0
1,353,353,9,9,0,1,0
2,405,405,29,29,0,1,0
8,425,425,22,22,0,1,0
5,443,443,22,11,11,2,1
3,475,475,50,39,11,2,1

0,140,140,4,4,0,1,0
11,143,143,4,4,0,1,0
4,174,174,3,3,0,1,0
5,263,263,21,21,0,1,0
9,274,274,88,88,0,1,0
1,284,284,20,3,17,4,3
2,296,296,26,6,20,2,1
10,383,383,34,34,0,1,0
3,430,430,6,6,0,1,0
7,433,433,6,1,5,2,1
6,437,437,83,83,0,1,0
8,468,468,35,19,16,2,1

4,207,207,37,37,0,1,0
6,247,247,9,3,6,3,2
1,324,324,101,47,54,3,2
0,330,330,6,6,0,1,0
3,365,365,26,26,0,1,0
7,383,383,18,8,10,3,2
5,433,433,107,7,100,3,2
2,465,465,47,47,0,1,0

7,109,109,1,1,0,1,0
4,124,124,10,6,4,2,1
5,136,136,1,1,0,1,0
1,144,144,22,22,0,1,0
12,173,173,7,7,0,1,0
9,208,208,18,18,0,1,0
2,227,227,2,2,0,1,0
3,285,285,3,3,0,1,0
0,297,297,18,18,0,1,0
10,394,394,92,66,26,3,2
8,410,410,45,45,0,1,0
6,446,446,28,16,12,2,1
11,484,484,71,71,0,1,0

1,106,106,11,11,0,1,0
4,112,112,27,23,4,2,1
3,136,136,18,18,0,1,0
5,260,260,26,26,0,1,0
0,356,356,20,12,8,3,2
7,440,440,6,6,0,1,0
6,485,485,75,75,0,1,0
2,488,488,103,56,47,3,2

4,124,124,41,35,6,3,2
3,140,140,7,7,0,1,0
5,192,192,3,3,0,1,0
1,203,203,1,1,0,1,0
6,221,221,27,27,0,1,0
0,237,237,74,34,40,3,2
2,346,346,64,64,0,1,0

1,179,179,13,3,10,3,2
6,198,198,13,13,0,1,0
0,223,223,38,38,0,1,0
9,237,237,53,53,0,1,0
2,284,284,10,10,0,1,0
8,308,308,32,32,0,1,0
4,364,364,13,1,12,4,3
5,402,402,35,1,34,4,3
3,456,456,46,46,0,1,0
7,472,472,53,53,0,1,0

6,117,117,10,6,4,2,1
7,175,175,32,32,0,1,0
8,215,215,4,1,3,2,1
4,282,282,22,22,0,1,0
1,287,287,19,10,9,2,1
3,292,292,36,13,23,2,1
5,315,315,46,36,10,2,1
0,380,380,27,27,0,1,0
9,422,422,93,57,36,2,1
2,495,495,8,2,6,3,2

1,162,162,5,5,0,1,0
7,224,224,6,2,4,2,1
2,227,227,9,9,0,1,0
10,245,245,47,47,0,1,0
0,261,261,20,2,18,3,2
6,294,294,30,30,0,1,0
9,317,317,39,14,25,2,1
3,382,382,72,24,48,4,3
8,407,407,24,9,15,2,1
4,442,442,1,1,0,1,0
11,462,462,61,40,21,2,1
5,492,492,17,17,0,1,0

7,101,101,4,4,0,1,0
0,106,106,8,8,0,1,0
9,109,109,3,3,0,1,0
5,111,111,1,1,0,1,0
8,136,136,42,22,20,2,1
1,153,153,1,1,0,1,0
3,214,214,39,14,25,4,3
4,231,231,30,19,11,3,2
6,297,297,24,2,22,3,2
10,320,320,46,11,35,2,1
2,331,331,6,6,0,1,0

3,107,107,2,2,0,1,0
2,170,170,6,6,0,1,0
4,233,233,3,3,0,1,0
5,237,237,26,12,14,2,1
9,250,250,73,73,0,1,0
7,327,327,5,5,0,1,0
0,329,329,36,36,0,1,0
10,365,365,67,52,15,2,1
1,380,380,11,5,6,3,2
8,395,395,7,2,5,2,1
6,434,434,81,69,12,4,3

10,116,116,8,8,0,1,0
8,156,156,1,1,0,1,0
1,213,213,5,5,0,1,0
2,215,215,1,1,0,1,0
0,222,222,2,2,0,1,0
7,284,284,6,6,0,1,0
5,285,285,26,26,0,1,0
13,301,301,3,3,0,1,0
9,335,335,6,6,0,1,0
12,339,339,3,3,0,1,0
3,376,376,10,4,6,2,1
11,381,381,160,160,0,1,0
6,475,475,7,3,4,2,1
4,499,499,143,89,54,4,3

7,119,119,26,26,0,1,0
9,123,123,19,2,17,2,1
1,138,138,13,1,12,4,3
6,157,157,20,20,0,1,0
10,165,165,13,5,8,2,1
2,192,192,8,2,6,3,2
4,316,316,17,12,5,2,1
3,320,320,8,2,6,2,1
5,338,338,19,19,0,1,0
8,357,357,21,21,0,1,0
0,471,471,49,49,0,1,0

2,121,121,16,16,0,1,0
5,239,239,35,14,21,4,3
3,353,353,43,32,11,2,1
6,399,399,66,6,60,4,3
4,451,451,33,10,23,2,1
1,457,457,141,39,102,4,3
0,472,472,28,28,0,1,0

5,193,193,14,2,12,2,1
4,199,199,4,4,0,1,0
2,206,206,15,7,8,3,2
6,219,219,22,2,20,4,3
7,247,247,78,56,22,3,2
1,308,308,1,1,0,1,0
3,317,317,103,79,24,4,3
0,494,494,49,23,26,3,2

2,111,111,1,1,0,1,0
8,142,142,8,2,6,2,1
6,147,147,1,1,0,1,0
3,192,192,13,13,0,1,0
7,208,208,27,21,6,3,2
0,305,305,11,5,6,2,1
4,339,339,58,27,31,2,1
9,424,424,132,42,90,4,3
1,450,450,50,50,0,1,0
5,471,471,50,50,0,1,0

6,144,144,5,5,0,1,0
7,144,144,27,12,15,2,1
3,204,204,1,1,0,1,0
1,267,267,80,41,39,4,3
4,286,286,1,1,0,1,0
5,390,390,93,93,0,1,0
2,396,396,6,6,0,1,0
8,412,412,19,19,0,1,0
0,492,492,88,88,0,1,0

4,179,179,28,16,12,3,2
1,218,218,20,5,15,4,3
6,245,245,30,30,0,1,0
0,273,273,33,33,0,1,0
9,298,298,5,5,0,1,0
5,304,304,6,6,0,1,0
7,340,340,100,52,48,4,3
2,370,370,1,1,0,1,0
8,468,468,34,16,18,2,1
3,483,483,54,21,33,3,2

3,149,149,5,2,3,2,1
2,163,163,7,7,0,1,0
5,166,166,22,2,20,2,1
0,247,247,47,47,0,1,0
4,259,259,42,42,0,1,0
1,273,273,74,28,46,3,2
6,406,406,73,29,44,2,1

6,131,131,25,5,20,3,2
2,146,146,23,20,3,2,1
1,207,207,23,20,3,2,1
7,300,300,1,1,0,1,0
0,343,343,1,1,0,1,0
5,379,379,78,42,36,4,3
8,394,394,42,42,0,1,0
3,398,398,31,6,25,2,1
4,462,462,70,70,0,1,0

5,102,102,2,2,0,1,0
3,107,107,31,31,0,1,0
6,112,112,21,9,12,2,1
7,158,158,34,10,24,3,2
1,271,271,10,2,8,2,1
4,321,321,29,25,4,2,1
2,385,385,15,15,0,1,0
0,405,405,58,42,16,3,2

9,107,107,30,30,0,1,0
5,178,178,18,13,5,2,1
4,180,180,15,8,7,2,1
7,209,209,4,4,0,1,0
6,229,229,22,22,0,1,0
3,344,344,3,3,0,1,0
11,350,350,55,18,37,2,1
1,366,366,7,1,6,2,1
8,405,405,9,2,7,2,1
10,409,409,19,19,0,1,0
2,473,473,19,19,0,1,0
0,479,479,65,22,43,2,1

3,118,118,1,1,0,1,0
7,154,154,10,6,4,2,1
2,175,175,30,24,6,3,2
5,235,235,51,16,35,2,1
6,253,253,16,16,0,1,0
0,305,305,4,4,0,1,0
1,348,348,15,15,0,1,0
4,438,438,116,116,0,1,0
8,442,442,73,73,0,1,0

6,277,277,22,3,19,2,1
4,290,290,50,50,0,1,0
7,326,326,28,11,17,2,1
1,332,332,73,23,50,2,1
0,406,406,36,36,0,1,0
2,442,442,10,3,7,2,1
5,458,458,77,77,0,1,0
3,472,472,80,37,43,2,1

4,215,215,28,24,4,2,1
8,253,253,55,43,12,3,2
5,364,364,38,13,25,2,1
3,368,368,24,8,16,2,1
1,372,372,22,12,10,3,2
7,385,385,5,5,0,1,0
6,393,393,67,5,62,3,2
0,400,400,98,98,0,1,0
2,405,405,2,2,0,1,0

6,128,128,17,17,0,1,0
4,211,211,4,1,3,2,1
2,246,246,14,14,0,1,0
0,263,263,20,4,16,2,1
5,339,339,67,15,52,3,2
1,414,414,153,153,0,1,0
3,422,422,67,40,27,2,1

5,132,132,35,26,9,2,1
4,143,143,1,1,0,1,0
1,156,156,9,1,8,2,1
2,163,163,52,52,0,1,0
6,326,326,71,45,26,2,1
0,383,383,48,26,22,3,2
3,461,461,9,4,5,2,1

4,160,160,22,22,0,1,0
8,275,275,51,51,0,1,0
1,290,290,33,18,15,2,1
6,319,319,23,5,18,4,3
3,340,340,36,36,0,1,0
5,436,436,9,9,0,1,0
2,444,444,32,3,29,2,1
7,458,458,10,10,0,1,0
9,472,472,107,39,68,3,2
0,490,490,25,21,4,2,1

2,102,102,15,15,0,1,0
1,155,155,10,10,0,1,0
4,167,167,1,1,0,1,0
6,195,195,13,13,0,1,0
5,212,212,5,5,0,1,0
3,259,259,45,17,28,3,2
0,292,292,25,25,0,1,0
7,307,307,42,42,0,1,0
9,484,484,10,10,0,1,0
8,488,488,137,78,59,4,3

5,122,122,9,9,0,1,0
2,150,150,32,32,0,1,0
6,190,190,8,4,4,2,1
9,224,224,30,15,15,2,1
7,243,243,15,6,9,2,1
0,287,287,15,3,12,3,2
11,319,319,25,25,0,1,0
4,356,356,7,7,0,1,0
3,382,382,12,6,6,3,2
10,432,432,81,81,0,1,0
1,463,463,3,3,0,1,0
8,479,479,51,43,8,2,1

11,101,101,1,1,0,1,0
1,137,137,12,12,0,1,0
5,153,153,5,5,0,1,0
0,200,200,2,2,0,1,0
10,228,228,50,9,41,2,1
7,247,247,12,12,0,1,0
8,294,294,19,19,0,1,0
9,310,310,24,16,8,3,2
3,319,319,3,3,0,1,0
13,323,323,44,31,13,2,1
12,388,388,57,30,27,4,3
4,390,390,38,10,28,2,1
2,474,474,18,8,10,3,2
6,487,487,17,17,0,1,0

2,186,186,5,5,0,1,0
5,228,228,8,2,6,2,1
0,236,236,13,1,12,3,2
6,249,249,10,10,0,1,0
4,271,271,30,30,0,1,0
1,302,302,1,1,0,1,0
9,302,302,1,1,0,1,0
11,320,320,5,5,0,1,0
3,337,337,18,18,0,1,0
10,368,368,178,76,102,4,3
8,471,471,3,3,0,1,0
7,499,499,88,41,47,2,1

4,153,153,25,25,0,1,0
0,154,154,5,5,0,1,0
7,185,185,61,61,0,1,0
5,190,190,22,22,0,1,0
1,200,200,6,2,4,2,1
8,293,293,18,18,0,1,0
9,299,299,1,1,0,1,0
6,310,310,35,35,0,1,0
3,441,441,63,63,0,1,0
2,465,465,9,9,0,1,0

3,157,157,17,8,9,4,3
6,195,195,59,59,0,1,0
5,256,256,5,5,0,1,0
1,277,277,36,2,34,2,1
4,306,306,38,10,28,3,2
7,315,315,19,19,0,1,0
0,373,373,35,8,27,4,3
2,482,482,81,57,24,4,3

1,110,110,5,2,3,2,1
0,153,153,43,43,0,1,0
3,204,204,27,27,0,1,0
7,282,282,73,39,34,3,2
4,319,319,7,7,0,1,0
5,348,348,6,6,0,1,0
2,357,357,7,7,0,1,0
8,365,365,64,64,0,1,0
6,460,460,26,18,8,2,1

8,108,108,12,12,0,1,0
10,120,120,11,2,9,4,3
4,123,123,3,3,0,1,0
9,137,137,32,32,0,1,0
0,141,141,3,3,0,1,0
12,144,144,18,18,0,1,0
7,166,166,6,2,4,2,1
5,189,189,14,14,0,1,0
1,269,269,7,7,0,1,0
3,286,286,12,12,0,1,0
11,314,314,17,2,15,2,1
2,400,400,63,41,22,2,1
6,459,459,4,4,0,1,0

5,136,136,6,1,5,2,1
0,144,144,3,3,0,1,0
2,144,144,36,36,0,1,0
3,267,267,31,31,0,1,0
6,277,277,104,90,14,2,1
1,291,291,4,1,3,2,1
7,326,326,10,3,7,2,1
8,331,331,20,20,0,1,0
4,476,476,48,36,12,3,2

1,128,128,15,1,14,2,1
3,175,175,9,6,3,2,1
7,197,197,37,37,0,1,0
2,206,206,36,4,32,2,1
4,322,322,5,5,0,1,0
0,355,355,57,57,0,1,0
5,464,464,74,68,6,2,1
6,485,485,70,41,29,2,1

6,125,125,4,4,0,1,0
1,226,226,1,1,0,1,0
3,254,254,47,35,12,4,3
5,263,263,7,2,5,2,1
0,347,347,33,27,6,2,1
2,361,361,79,55,24,2,1
4,416,416,141,129,12,2,1
7,452,452,50,50,0,1,0

5,102,102,3,3,0,1,0
4,143,143,9,3,6,3,2
8,147,147,1,1,0,1,0
14,177,177,10,10,0,1,0
9,192,192,8,3,5,2,1
1,208,208,3,3,0,1,0
7,297,297,15,15,0,1,0
13,315,315,131,47,84,4,3
6,327,327,25,25,0,1,0
10,374,374,34,17,17,2,1
0,407,407,22,4,18,2,1
12,417,417,1,1,0,1,0
2,458,458,20,12,8,2,1
3,462,462,14,14,0,1,0
11,477,477,15,15,0,1,0

4,136,136,4,4,0,1,0
8,138,138,23,23,0,1,0
1,185,185,1,1,0,1,0
2,229,229,12,12,0,1,0
5,252,252,50,7,43,2,1
0,282,282,33,3,30,2,1
3,347,347,34,30,4,2,1
9,433,433,38,38,0,1,0
6,449,449,99,54,45,4,3
7,452,452,15,6,9,4,3

5,110,110,7,7,0,1,0
2,157,157,5,5,0,1,0
9,159,159,42,42,0,1,0
4,188,188,28,28,0,1,0
0,225,225,16,6,10,2,1
7,228,228,42,34,8,3,2
1,234,234,21,21,0,1,0
8,350,350,6,6,0,1,0
6,352,352,7,3,4,2,1
3,441,441,34,12,22,3,2
10,444,444,17,14,3,2,1

6,100,100,9,9,0,1,0
3,155,155,6,1,5,2,1
7,172,172,4,1,3,2,1
10,199,199,4,4,0,1,0
4,224,224,30,30,0,1,0
9,244,244,36,36,0,1,0
1,265,265,1,1,0,1,0
8,293,293,24,24,0,1,0
2,350,350,4,4,0,1,0
0,379,379,16,16,0,1,0
11,384,384,11,11,0,1,0
12,408,408,125,125,0,1,0
5,470,470,36,4,32,2,1

16,104,104,7,1,6,3,2
1,108,108,1,1,0,1,0
0,124,124,17,1,16,2,1
10,126,126,1,1,0,1,0
14,175,175,37,7,30,3,2
3,207,207,5,5,0,1,0
11,229,229,24,6,18,2,1
6,263,263,9,9,0,1,0
7,265,265,1,1,0,1,0
12,278,278,2,2,0,1,0
8,370,370,16,16,0,1,0
5,376,376,12,12,0,1,0
4,379,379,8,2,6,2,1
13,385,385,70,70,0,1,0
9,388,388,23,15,8,3,2
15,407,407,20,20,0,1,0
2,418,418,7,7,0,1,0

0,158,158,24,24,0,1,0
8,241,241,56,14,42,3,2
7,249,249,10,2,8,3,2
4,264,264,1,1,0,1,0
6,327,327,59,33,26,2,1
2,371,371,49,49,0,1,0
3,431,431,10,3,7,2,1
5,432,432,9,2,7,2,1
1,435,435,74,48,26,3,2
9,487,487,26,10,16,2,1

0,129,129,22,18,4,2,1
3,217,217,17,17,0,1,0
4,348,348,52,52,0,1,0
2,362,362,16,16,0,1,0
7,375,375,8,8,0,1,0
5,376,376,13,13,0,1,0
6,379,379,8,2,6,3,2
1,445,445,1,1,0,1,0
9,462,462,159,9,150,4,3
8,466,466,52,20,32,3,2
10,493,493,13,7,6,2,1

0,155,155,22,10,12,2,1
1,181,181,33,33,0,1,0
8,277,277,13,2,11,4,3
2,298,298,12,1,11,2,1
4,328,328,13,13,0,1,0
5,405,405,9,9,0,1,0
9,413,413,136,10,126,4,3
3,421,421,31,31,0,1,0
7,452,452,43,5,38,3,2
6,472,472,18,18,0,1,0

4,275,275,34,34,0,1,0
3,313,313,42,42,0,1,0
0,319,319,125,38,87,4,3
1,339,339,18,13,5,2,1
5,414,414,46,10,36,4,3
6,458,458,63,63,0,1,0
2,463,463,26,26,0,1,0

8,169,169,5,5,0,1,0
7,203,203,54,17,37,2,1
4,335,335,44,15,29,4,3
6,338,338,65,21,44,2,1
3,394,394,15,3,12,3,2
1,421,421,30,18,12,4,3
0,433,433,22,22,0,1,0
5,447,447,9,9,0,1,0
2,465,465,98,49,49,2,1

6,124,124,11,11,0,1,0
3,140,140,7,7,0,1,0
2,142,142,1,1,0,1,0
10,148,148,5,5,0,1,0
8,172,172,1,1,0,1,0
1,211,211,3,3,0,1,0
5,246,246,15,15,0,1,0
13,273,273,25,25,0,1,0
12,282,282,83,70,13,2,1
11,285,285,25,25,0,1,0
4,290,290,25,16,9,2,1
15,302,302,32,6,26,2,1
9,305,305,3,3,0,1,0
7,325,325,9,9,0,1,0
14,343,343,4,1,3,2,1
0,418,418,12,12,0,1,0

1,101,101,1,1,0,1,0
0,149,149,34,16,18,4,3
4,231,231,15,12,3,2,1
8,254,254,68,68,0,1,0
10,305,305,30,12,18,3,2
5,337,337,6,2,4,2,1
2,351,351,25,21,4,2,1
7,364,364,47,3,44,3,2
3,369,369,27,8,19,4,3
9,401,401,4,4,0,1,0
6,417,417,15,15,0,1,0

5,184,184,1,1,0,1,0
11,238,238,38,38,0,1,0
12,296,296,51,51,0,1,0
4,303,303,9,9,0,1,0
8,313,313,34,10,24,2,1
7,314,314,5,5,0,1,0
0,344,344,43,43,0,1,0
6,372,372,7,7,0,1,0
9,402,402,21,21,0,1,0
10,416,416,51,51,0,1,0
3,440,440,19,19,0,1,0
1,445,445,48,30,18,4,3
2,482,482,23,23,0,1,0

10,127,127,17,17,0,1,0
9,135,135,27,7,20,2,1
7,196,196,2,2,0,1,0
0,207,207,17,9,8,3,2
1,219,219,12,3,9,4,3
6,242,242,57,25,32,2,1
5,253,253,12,12,0,1,0
8,319,319,53,14,39,2,1
2,357,357,2,2,0,1,0
4,384,384,7,7,0,1,0
3,445,445,26,26,0,1,0

3,145,145,2,2,0,1,0
9,200,200,42,20,22,3,2
1,244,244,1,1,0,1,0
4,261,261,32,7,25,2,1
2,262,262,9,6,3,2,1
6,269,269,18,2,16,3,2
7,310,310,30,4,26,3,2
5,311,311,36,28,8,2,1
10,396,396,19,9,10,2,1
11,457,457,58,58,0,1,0
8,459,459,56,11,45,2,1
0,492,492,23,5,18,2,1

7,101,101,7,7,0,1,0
9,271,271,30,24,6,3,2
1,289,289,6,6,0,1,0
5,290,290,7,7,0,1,0
2,339,339,43,13,30,4,3
0,340,340,20,17,3,2,1
6,356,356,20,7,13,2,1
11,378,378,123,81,42,3,2
3,388,388,29,9,20,3,2
10,453,453,24,24,0,1,0
4,468,468,33,3,30,2,1
8,475,475,7,7,0,1,0

6,114,114,28,4,24,4,3
4,162,162,12,3,9,2,1
0,178,178,17,3,14,2,1
1,203,203,5,5,0,1,0
8,209,209,2,2,0,1,0
7,220,220,7,1,6,3,2
9,261,261,17,17,0,1,0
11,282,282,42,32,10,2,1
2,362,362,2,2,0,1,0
10,365,365,104,104,0,1,0
5,379,379,1,1,0,1,0
3,469,469,11,4,7,2,1

7,136,136,26,2,24,3,2
6,210,210,2,2,0,1,0
1,231,231,19,14,5,2,1
4,252,252,16,9,7,2,1
0,312,312,8,2,6,3,2
5,314,314,76,16,60,3,2
8,332,332,21,21,0,1,0
2,397,397,49,19,30,4,3
3,419,419,86,64,22,3,2

3,137,137,15,15,0,1,0
4,175,175,1,1,0,1,0
5,232,232,50,50,0,1,0
8,240,240,9,1,8,3,2
7,271,271,64,54,10,2,1
6,294,294,5,5,0,1,0
0,376,376,69,69,0,1,0
1,402,402,18,3,15,4,3
2,498,498,79,79,0,1,0

9,111,111,35,14,21,2,1
1,139,139,3,3,0,1,0
4,158,158,20,1,19,3,2
2,160,160,10,10,0,1,0
6,207,207,36,15,21,2,1
0,246,246,22,22,0,1,0
3,283,283,47,17,30,3,2
5,345,345,12,12,0,1,0
8,348,348,5,5,0,1,0
7,357,357,2,2,0,1,0

2,110,110,1,1,0,1,0
10,129,129,17,11,6,2,1
4,145,145,17,17,0,1,0
8,146,146,15,5,10,3,2
6,169,169,5,5,0,1,0
0,200,200,15,15,0,1,0
3,250,250,7,7,0,1,0
7,252,252,6,6,0,1,0
1,364,364,33,8,25,4,3
5,406,406,53,53,0,1,0
11,437,437,26,26,0,1,0
9,481,481,103,37,66,3,2

0,108,108,7,7,0,1,0
6,162,162,66,28,38,2,1
3,166,166,32,32,0,1,0
5,211,211,5,5,0,1,0
2,244,244,27,15,12,3,2
4,255,255,1,1,0,1,0
8,268,268,5,5,0,1,0
7,275,275,17,17,0,1,0
1,430,430,55,25,30,4,3

0,159,159,70,54,16,3,2
5,285,285,96,51,45,4,3
4,313,313,7,7,0,1,0
3,446,446,51,51,0,1,0
1,456,456,28,28,0,1,0
2,495,495,16,16,0,1,0

4,101,101,1,1,0,1,0
10,123,123,13,5,8,2,1
11,209,209,8,8,0,1,0
8,250,250,3,3,0,1,0
3,296,296,1,1,0,1,0
7,361,361,7,2,5,2,1
9,402,402,142,142,0,1,0
6,426,426,49,49,0,1,0
0,430,430,82,35,47,4,3
2,430,430,26,22,4,2,1
1,437,437,41,8,33,3,2
5,482,482,4,4,0,1,0

4,108,108,2,2,0,1,0
2,168,168,20,2,18,3,2
1,229,229,1,1,0,1,0
0,345,345,130,130,0,1,0
6,385,385,118,7,111,4,3
5,394,394,12,12,0,1,0
3,425,425,64,64,0,1,0

2,137,137,4,4,0,1,0
7,146,146,21,5,16,3,2
4,205,205,62,62,0,1,0
1,207,207,23,11,12,4,3
3,220,220,23,23,0,1,0
6,230,230,4,4,0,1,0
0,231,231,59,19,40,3,2
5,345,345,17,7,10,3,2

1,115,115,7,7,0,1,0
8,139,139,21,21,0,1,0
0,184,184,6,6,0,1,0
6,185,185,1,1,0,1,0
3,219,219,11,11,0,1,0
2,233,233,18,12,6,2,1
5,246,246,20,17,3,2,1
4,275,275,53,31,22,3,2
10,295,295,25,7,18,2,1
7,480,480,5,1,4,2,1
9,480,480,126,108,18,4,3

1,133,133,13,13,0,1,0
2,166,166,12,12,0,1,0
0,207,207,7,1,6,3,2
6,246,246,25,25,0,1,0
7,259,259,53,24,29,2,1
5,327,327,16,2,14,2,1
3,448,448,95,13,82,3,2
8,467,467,71,3,68,4,3
4,473,473,40,16,24,3,2

0,112,112,17,17,0,1,0
5,128,128,9,9,0,1,0
2,146,146,6,3,3,2,1
6,155,155,13,13,0,1,0
3,174,174,1,1,0,1,0
1,187,187,21,4,17,3,2
4,202,202,8,8,0,1,0
7,276,276,29,29,0,1,0
8,282,282,17,17,0,1,0
10,425,425,17,17,0,1,0
9,461,461,139,100,39,4,3

7,154,154,23,23,0,1,0
11,258,258,52,52,0,1,0
12,262,262,4,4,0,1,0
1,270,270,3,3,0,1,0
9,295,295,41,41,0,1,0
0,311,311,2,2,0,1,0
3,329,329,16,3,13,2,1
4,332,332,38,4,34,2,1
8,372,372,3,3,0,1,0
10,403,403,62,54,8,2,1
2,412,412,60,24,36,4,3
6,422,422,4,4,0,1,0
5,484,484,4,4,0,1,0

4,100,100,4,4,0,1,0
6,124,124,4,4,0,1,0
1,127,127,11,4,7,2,1
9,142,142,3,3,0,1,0
5,207,207,47,11,36,2,1
2,216,216,1,1,0,1,0
3,257,257,7,7,0,1,0
7,331,331,134,62,72,4,3
8,426,426,22,22,0,1,0
0,462,462,54,54,0,1,0

4,114,114,15,3,12,3,2
3,171,171,9,9,0,1,0
7,227,227,10,10,0,1,0
8,307,307,81,81,0,1,0
6,316,316,58,49,9,2,1
9,336,336,5,2,3,2,1
5,385,385,53,29,24,4,3
2,444,444,4,4,0,1,0
1,447,447,58,58,0,1,0
0,467,467,19,2,17,2,1

6,121,121,36,22,14,2,1
0,200,200,4,4,0,1,0
2,256,256,34,34,0,1,0
5,265,265,22,22,0,1,0
3,325,325,16,16,0,1,0
4,369,369,107,75,32,2,1
1,375,375,3,3,0,1,0
8,378,378,44,44,0,1,0
7,469,469,5,1,4,2,1

1,154,154,1,1,0,1,0
8,159,159,32,8,24,3,2
5,229,229,20,20,0,1,0
2,282,282,6,6,0,1,0
4,295,295,6,6,0,1,0
3,330,330,47,5,42,4,3
6,331,331,13,4,9,4,3
0,381,381,118,71,47,2,1
7,417,417,77,77,0,1,0

8,131,131,3,3,0,1,0
3,150,150,9,9,0,1,0
5,162,162,1,1,0,1,0
1,170,170,13,13,0,1,0
9,283,283,8,1,7,2,1
2,302,302,55,7,48,2,1
4,352,352,62,62,0,1,0
7,391,391,110,82,28,2,1
6,415,415,72,39,33,2,1
0,483,483,1,1,0,1,0

1,106,106,5,5,0,1,0
3,115,115,11,11,0,1,0
8,148,148,27,27,0,1,0
6,208,208,22,22,0,1,0
7,258,258,30,30,0,1,0
9,271,271,28,28,0,1,0
4,319,319,8,8,0,1,0
5,397,397,19,19,0,1,0
0,443,443,81,47,34,4,3
2,448,448,46,18,28,2,1

1,121,121,14,14,0,1,0
3,127,127,18,18,0,1,0
4,138,138,6,3,3,2,1
2,191,191,3,3,0,1,0
0,254,254,47,38,9,4,3
8,297,297,64,64,0,1,0
6,303,303,41,41,0,1,0
7,376,376,26,5,21,4,3
5,403,403,34,34,0,1,0

5,143,143,18,3,15,3,2
7,149,149,7,7,0,1,0
9,181,181,5,5,0,1,0
6,183,183,2,2,0,1,0
4,193,193,1,1,0,1,0
11,226,226,42,8,34,2,1
12,245,245,24,15,9,4,3
8,277,277,52,52,0,1,0
3,295,295,19,19,0,1,0
2,313,313,3,3,0,1,0
0,348,348,11,11,0,1,0
10,354,354,70,70,0,1,0
1,449,449,8,8,0,1,0

9,102,102,6,6,0,1,0
2,171,171,5,5,0,1,0
12,216,216,48,22,26,2,1
0,235,235,22,11,11,2,1
1,252,252,6,6,0,1,0
11,253,253,51,22,29,3,2
4,256,256,1,1,0,1,0
8,316,316,4,4,0,1,0
10,406,406,11,5,6,2,1
7,447,447,33,33,0,1,0
5,451,451,78,4,74,3,2
6,479,479,35,20,15,4,3
3,486,486,9,6,3,2,1

3,101,101,12,12,0,1,0
6,128,128,10,10,0,1,0
10,133,133,1,1,0,1,0
2,152,152,7,7,0,1,0
9,196,196,34,34,0,1,0
4,206,206,11,11,0,1,0
0,272,272,1,1,0,1,0
8,331,331,39,10,29,2,1
5,358,358,5,5,0,1,0
1,381,381,72,14,58,3,2
7,435,435,93,78,15,4,3

7,116,116,2,2,0,1,0
1,151,151,3,3,0,1,0
6,158,158,50,50,0,1,0
0,226,226,1,1,0,1,0
5,245,245,12,12,0,1,0
8,334,334,42,32,10,4,3
2,340,340,68,10,58,3,2
4,357,357,17,2,15,4,3
3,481,481,110,20,90,4,3

1,185,185,1,1,0,1,0
2,293,293,50,42,8,2,1
5,309,309,7,7,0,1,0
4,324,324,75,35,40,3,2
3,359,359,34,1,33,4,3
7,402,402,46,46,0,1,0
6,406,406,57,5,52,3,2
0,462,462,106,74,32,4,3

13,102,102,18,18,0,1,0
10,128,128,11,11,0,1,0
12,128,128,31,19,12,4,3
9,181,181,21,21,0,1,0
4,236,236,12,4,8,3,2
1,244,244,6,1,5,2,1
11,262,262,3,3,0,1,0
3,284,284,6,6,0,1,0
0,315,315,2,2,0,1,0
7,345,345,9,3,6,2,1
6,384,384,9,9,0,1,0
2,389,389,15,15,0,1,0
8,426,426,77,65,12,4,3
5,431,431,7,1,6,3,2

8,134,134,39,39,0,1,0
9,137,137,23,4,19,4,3
2,225,225,13,2,11,2,1
4,329,329,31,19,12,3,2
7,347,347,15,15,0,1,0
6,350,350,2,2,0,1,0
0,400,400,43,43,0,1,0
1,461,461,76,13,63,4,3
3,462,462,22,9,13,4,3
5,486,486,14,14,0,1,0

8,102,102,6,2,4,2,1
9,124,124,20,20,0,1,0
2,200,200,1,1,0,1,0
3,205,205,20,20,0,1,0
0,242,242,52,52,0,1,0
7,261,261,37,37,0,1,0
4,420,420,8,8,0,1,0
6,424,424,67,67,0,1,0
1,429,429,12,12,0,1,0
5,469,469,64,52,12,3,2

7,106,106,12,12,0,1,0
2,115,115,14,14,0,1,0
8,206,206,34,4,30,3,2
0,216,216,38,38,0,1,0
5,282,282,20,20,0,1,0
1,342,342,1,1,0,1,0
6,446,446,70,38,32,3,2
4,448,448,7,1,6,2,1
3,468,468,87,71,16,2,1

10,219,219,39,39,0,1,0
3,223,223,26,4,22,3,2
1,230,230,11,11,0,1,0
0,232,232,31,31,0,1,0
5,269,269,25,11,14,2,1
2,302,302,1,1,0,1,0
8,319,319,29,19,10,3,2
9,384,384,84,9,75,4,3
4,444,444,32,15,17,2,1
6,474,474,16,7,9,4,3
7,479,479,8,2,6,3,2

2,131,131,24,24,0,1,0
0,179,179,3,3,0,1,0
6,201,201,42,42,0,1,0
5,220,220,15,15,0,1,0
8,224,224,10,10,0,1,0
9,231,231,11,11,0,1,0
1,324,324,61,29,32,3,2
7,373,373,77,20,57,4,3
3,390,390,9,9,0,1,0
4,428,428,10,4,6,2,1

0,106,106,1,1,0,1,0
2,108,108,18,18,0,1,0
7,270,270,46,46,0,1,0
4,337,337,39,39,0,1,0
6,361,361,67,67,0,1,0
5,381,381,11,11,0,1,0
8,384,384,46,46,0,1,0
1,394,394,24,24,0,1,0
3,418,418,62,18,44,3,2

7,117,117,25,15,10,2,1
5,198,198,2,2,0,1,0
2,263,263,25,9,16,3,2
1,302,302,1,1,0,1,0
0,343,343,12,12,0,1,0
6,384,384,54,15,39,4,3
3,438,438,69,29,40,3,2
8,475,475,69,69,0,1,0
4,498,498,105,11,94,3,2

2,139,139,17,17,0,1,0
9,146,146,39,39,0,1,0
11,221,221,9,1,8,3,2
8,235,235,46,5,41,2,1
6,278,278,24,11,13,2,1
0,301,301,22,22,0,1,0
3,360,360,6,6,0,1,0
4,362,362,38,38,0,1,0
1,413,413,7,7,0,1,0
5,469,469,2,2,0,1,0
7,469,469,36,36,0,1,0
10,480,480,1,1,0,1,0

9,129,129,8,2,6,3,2
0,253,253,4,4,0,1,0
5,261,261,2,2,0,1,0
3,326,326,85,85,0,1,0
4,335,335,33,18,15,2,1
6,335,335,62,54,8,3,2
1,374,374,6,2,4,2,1
8,420,420,53,53,0,1,0
7,489,489,66,19,47,2,1
2,493,493,50,40,10,3,2

12,100,100,14,14,0,1,0
4,146,146,4,4,0,1,0
6,228,228,15,7,8,3,2
0,284,284,16,6,10,2,1
8,286,286,31,31,0,1,0
3,347,347,23,11,12,2,1
2,363,363,1,1,0,1,0
1,379,379,17,1,16,3,2
11,388,388,14,14,0,1,0
10,399,399,34,34,0,1,0
5,420,420,3,3,0,1,0
9,432,432,106,106,0,1,0
7,458,458,56,56,0,1,0

0,110,110,33,9,24,4,3
6,179,179,29,29,0,1,0
4,227,227,3,3,0,1,0
5,329,329,65,26,39,2,1
3,343,343,46,46,0,1,0
1,357,357,64,64,0,1,0
2,389,389,9,3,6,2,1

0,104,104,14,4,10,3,2
3,257,257,63,33,30,4,3
2,271,271,31,31,0,1,0
4,283,283,18,5,13,2,1
6,288,288,43,43,0,1,0
1,342,342,87,87,0,1,0
5,458,458,22,4,18,4,3

6,154,154,30,8,22,2,1
3,273,273,43,43,0,1,0
2,290,290,94,94,0,1,0
5,306,306,40,8,32,2,1
0,339,339,32,23,9,4,3
1,362,362,30,30,0,1,0
4,410,410,11,11,0,1,0

2,105,105,12,12,0,1,0
0,209,209,18,18,0,1,0
9,227,227,48,30,18,3,2
3,230,230,5,5,0,1,0
4,232,232,16,16,0,1,0
10,244,244,29,12,17,2,1
6,261,261,6,6,0,1,0
8,286,286,31,27,4,2,1
11,308,308,22,2,20,3,2
5,310,310,15,1,14,3,2
1,335,335,13,13,0,1,0
7,368,368,37,13,24,4,3

4,112,112,14,7,7,2,1
6,147,147,1,1,0,1,0
2,169,169,5,5,0,1,0
3,218,218,19,5,14,4,3
0,240,240,7,1,6,2,1
10,288,288,60,60,0,1,0
9,334,334,2,2,0,1,0
5,382,382,29,17,12,2,1
1,388,388,58,10,48,3,2
8,428,428,119,119,0,1,0
7,473,473,7,2,5,2,1

4,135,135,2,2,0,1,0
1,156,156,14,2,12,2,1
0,236,236,98,98,0,1,0
2,247,247,95,53,42,3,2
3,390,390,6,6,0,1,0
5,485,485,46,13,33,2,1

8,116,116,41,41,0,1,0
6,134,134,2,2,0,1,0
1,152,152,6,6,0,1,0
2,202,202,22,12,10,2,1
7,232,232,6,1,5,2,1
0,291,291,8,5,3,2,1
4,291,291,31,7,24,2,1
3,363,363,79,79,0,1,0
5,463,463,52,34,18,4,3

5,111,111,3,3,0,1,0
6,201,201,11,11,0,1,0
4,255,255,102,39,63,4,3
2,257,257,75,6,69,3,2
3,354,354,4,4,0,1,0
0,463,463,49,41,8,2,1
7,482,482,14,10,4,2,1
1,484,484,45,6,39,3,2

8,204,204,29,9,20,3,2
5,239,239,1,1,0,1,0
2,369,369,39,7,32,3,2
7,404,404,133,113,20,3,2
3,410,410,32,32,0,1,0
6,410,410,12,2,10,3,2
0,418,418,102,93,9,2,1
1,463,463,5,5,0,1,0
4,469,469,29,5,24,3,2

2,111,111,8,5,3,2,1
8,151,151,24,20,4,2,1
7,191,191,10,3,7,2,1
3,195,195,4,4,0,1,0
9,224,224,21,21,0,1,0
10,277,277,56,18,38,2,1
1,304,304,14,14,0,1,0
5,312,312,59,59,0,1,0
4,317,317,14,14,0,1,0
0,343,343,5,5,0,1,0
6,364,364,42,17,25,2,1

3,109,109,4,4,0,1,0
4,132,132,11,11,0,1,0
8,133,133,10,10,0,1,0
2,220,220,5,5,0,1,0
12,233,233,28,17,11,2,1
11,235,235,26,26,0,1,0
9,287,287,75,35,40,2,1
7,331,331,15,15,0,1,0
1,335,335,13,3,10,3,2
6,351,351,43,4,39,2,1
5,391,391,31,31,0,1,0
10,418,418,7,1,6,3,2
0,497,497,1,1,0,1,0

7,110,110,14,4,10,3,2
9,168,168,26,14,12,3,2
6,276,276,24,11,13,2,1
8,284,284,42,42,0,1,0
0,318,318,16,11,5,2,1
2,324,324,64,38,26,4,3
5,337,337,18,18,0,1,0
1,357,357,7,7,0,1,0
4,415,415,13,13,0,1,0
3,458,458,69,69,0,1,0

1,121,121,45,45,0,1,0
6,176,176,44,35,9,4,3
3,179,179,33,33,0,1,0
4,290,290,4,4,0,1,0
0,452,452,4,4,0,1,0
5,480,480,29,7,22,3,2
2,499,499,60,38,22,3,2

7,100,100,15,15,0,1,0
8,148,148,3,3,0,1,0
6,153,153,3,3,0,1,0
9,342,342,82,82,0,1,0
10,351,351,41,15,26,3,2
0,384,384,3,3,0,1,0
5,393,393,7,7,0,1,0
2,430,430,1,1,0,1,0
3,446,446,84,30,54,3,2
12,475,475,7,7,0,1,0
11,496,496,66,48,18,4,3
1,497,497,22,22,0,1,0
4,499,499,27,27,0,1,0

3,188,188,21,1,20,3,2
0,189,189,20,8,12,4,3
5,193,193,6,6,0,1,0
7,235,235,20,5,15,2,1
8,273,273,2,2,0,1,0
10,294,294,25,20,5,2,1
6,300,300,32,32,0,1,0
9,393,393,19,1,18,4,3
1,440,440,12,3,9,4,3
2,440,440,3,3,0,1,0
4,444,444,9,9,0,1,0
12,472,472,98,93,5,2,1
11,494,494,81,34,47,4,3

8,117,117,5,5,0,1,0
0,126,126,4,4,0,1,0
6,126,126,4,4,0,1,0
2,206,206,33,33,0,1,0
4,217,217,3,3,0,1,0
12,225,225,40,40,0,1,0
7,231,231,1,1,0,1,0
3,241,241,20,20,0,1,0
11,281,281,12,12,0,1,0
5,330,330,11,11,0,1,0
9,357,357,40,40,0,1,0
10,399,399,68,68,0,1,0
1,491,491,51,5,46,3,2

9,122,122,9,9,0,1,0
10,123,123,13,3,10,2,1
3,131,131,1,1,0,1,0
6,199,199,2,2,0,1,0
0,291,291,5,5,0,1,0
4,300,300,10,10,0,1,0
7,319,319,25,25,0,1,0
8,368,368,92,92,0,1,0
2,403,403,13,13,0,1,0
5,417,417,92,92,0,1,0
1,442,442,80,80,0,1,0

9,127,127,36,28,8,3,2
7,201,201,6,6,0,1,0
0,205,205,9,9,0,1,0
2,229,229,29,29,0,1,0
6,290,290,8,8,0,1,0
5,292,292,29,29,0,1,0
1,352,352,21,14,7,2,1
4,371,371,23,11,12,2,1
8,373,373,62,40,22,4,3
3,387,387,42,42,0,1,0

1,100,100,6,1,5,2,1
5,103,103,9,9,0,1,0
8,152,152,28,25,3,2,1
4,305,305,9,9,0,1,0
9,315,315,71,27,44,3,2
7,356,356,10,10,0,1,0
6,385,385,26,5,21,4,3
3,436,436,91,72,19,2,1
0,458,458,12,12,0,1,0
2,497,497,48,26,22,2,1

4,121,121,26,26,0,1,0
3,126,126,11,8,3,2,1
0,134,134,7,1,6,2,1
6,289,289,11,11,0,1,0
1,343,343,25,10,15,4,3
5,379,379,94,25,69,4,3
2,387,387,112,112,0,1,0
7,428,428,1,1,0,1,0

2,100,100,3,3,0,1,0
1,117,117,1,1,0,1,0
6,243,243,4,4,0,1,0
10,287,287,10,6,4,2,1
5,298,298,12,7,5,2,1
11,332,332,38,38,0,1,0
4,337,337,30,17,13,2,1
9,353,353,115,18,97,4,3
7,379,379,17,17,0,1,0
8,388,388,11,11,0,1,0
0,408,408,9,3,6,3,2
3,433,433,108,72,36,4,3

8,119,119,8,2,6,3,2
6,135,135,42,42,0,1,0
0,191,191,13,4,9,2,1
4,236,236,1,1,0,1,0
2,256,256,41,11,30,2,1
9,301,301,27,18,9,2,1
7,352,352,16,2,14,3,2
3,362,362,82,82,0,1,0
1,374,374,4,4,0,1,0
5,461,461,14,2,12,2,1

0,151,151,20,10,10,2,1
1,192,192,12,12,0,1,0
7,194,194,17,17,0,1,0
2,249,249,10,4,6,2,1
4,354,354,65,57,8,3,2
6,396,396,57,57,0,1,0
5,447,447,40,40,0,1,0
3,458,458,122,122,0,1,0

4,168,168,21,5,16,3,2
0,220,220,14,6,8,3,2
3,274,274,46,28,18,2,1
2,309,309,6,6,0,1,0
6,313,313,29,29,0,1,0
9,318,318,3,3,0,1,0
7,340,340,39,26,13,2,1
10,382,382,38,6,32,2,1
1,432,432,9,2,7,2,1
5,439,439,5,5,0,1,0
8,488,488,138,91,47,2,1

3,102,102,15,15,0,1,0
9,124,124,6,6,0,1,0
1,218,218,1,1,0,1,0
4,244,244,22,22,0,1,0
2,254,254,13,6,7,2,1
10,271,271,5,5,0,1,0
8,317,317,23,5,18,3,2
5,324,324,17,17,0,1,0
0,340,340,13,13,0,1,0
6,398,398,31,31,0,1,0
7,423,423,17,17,0,1,0
11,460,460,171,171,0,1,0

0,125,125,11,5,6,3,2
2,131,131,7,7,0,1,0
6,174,174,9,9,0,1,0
7,189,189,19,19,0,1,0
8,217,217,3,3,0,1,0
9,273,273,6,6,0,1,0
11,275,275,13,13,0,1,0
12,286,286,105,5,100,3,2
10,306,306,22,8,14,2,1
5,325,325,26,14,12,3,2
1,393,393,20,11,9,4,3
4,394,394,22,22,0,1,0
3,489,489,4,4,0,1,0

6,156,156,4,4,0,1,0
10,217,217,61,61,0,1,0
8,243,243,23,3,20,3,2
1,256,256,34,34,0,1,0
2,257,257,22,2,20,2,1
5,291,291,30,21,9,4,3
4,297,297,4,4,0,1,0
9,306,306,22,22,0,1,0
7,337,337,19,19,0,1,0
0,468,468,28,28,0,1,0
3,488,488,39,30,9,2,1

5,103,103,3,3,0,1,0
7,103,103,14,9,5,2,1
0,121,121,2,2,0,1,0
8,199,199,26,1,25,2,1
2,231,231,7,1,6,2,1
3,238,238,23,23,0,1,0
4,252,252,15,15,0,1,0
9,353,353,59,29,30,4,3
1,388,388,105,27,78,3,2
6,490,490,36,36,0,1,0

2,148,148,9,9,0,1,0
6,151,151,3,3,0,1,0
9,153,153,33,33,0,1,0
8,162,162,7,2,5,2,1
10,180,180,40,40,0,1,0
5,184,184,31,24,7,2,1
0,209,209,7,7,0,1,0
3,210,210,7,2,5,2,1
1,325,325,26,20,6,3,2
4,382,382,42,27,15,4,3
7,405,405,11,3,8,2,1

0,121,121,30,30,0,1,0
4,192,192,74,74,0,1,0
7,275,275,3,3,0,1,0
3,279,279,7,7,0,1,0
6,347,347,29,29,0,1,0
5,378,378,10,10,0,1,0
2,439,439,10,10,0,1,0
1,484,484,100,79,21,2,1

7,155,155,1,1,0,1,0
6,213,213,56,56,0,1,0
3,226,226,1,1,0,1,0
2,265,265,5,5,0,1,0
0,314,314,116,71,45,4,3
4,365,365,13,13,0,1,0
5,367,367,73,28,45,4,3
1,432,432,48,38,10,3,2

2,146,146,28,14,14,4,3
0,238,238,15,2,13,4,3
4,239,239,12,3,9,2,1
7,251,251,80,50,30,2,1
3,286,286,60,60,0,1,0
1,291,291,11,6,5,2,1
6,409,409,25,25,0,1,0
5,476,476,36,36,0,1,0

1,178,178,30,30,0,1,0
5,208,208,11,11,0,1,0
4,215,215,3,3,0,1,0
2,223,223,33,15,18,2,1
8,225,225,61,13,48,2,1
7,231,231,33,33,0,1,0
0,236,236,29,29,0,1,0
6,423,423,19,12,7,2,1
3,470,470,23,23,0,1,0

6,187,187,16,10,6,2,1
4,228,228,9,2,7,2,1
5,242,242,37,37,0,1,0
3,343,343,78,75,3,2,1
0,347,347,9,9,0,1,0
2,348,348,13,13,0,1,0
1,378,378,166,104,62,3,2

5,147,147,34,34,0,1,0
0,243,243,12,6,6,2,1
6,283,283,5,5,0,1,0
2,336,336,11,11,0,1,0
3,362,362,13,13,0,1,0
4,379,379,8,1,7,2,1
7,392,392,10,10,0,1,0
1,401,401,54,30,24,2,1
8,411,411,176,32,144,4,3
9,441,441,16,2,14,3,2

7,124,124,18,18,0,1,0
5,129,129,2,2,0,1,0
3,143,143,12,2,10,3,2
9,189,189,46,4,42,2,1
4,235,235,33,28,5,2,1
8,275,275,10,4,6,2,1
1,351,351,25,25,0,1,0
0,352,352,16,16,0,1,0
2,395,395,1,1,0,1,0
10,411,411,36,36,0,1,0
6,496,496,70,70,0,1,0

0,151,151,11,11,0,1,0
8,163,163,8,8,0,1,0
5,226,226,6,3,3,2,1
10,235,235,10,4,6,3,2
2,284,284,5,5,0,1,0
3,290,290,3,3,0,1,0
4,325,325,14,3,11,2,1
9,407,407,27,27,0,1,0
1,445,445,41,26,15,4,3
6,471,471,112,7,105,4,3
7,483,483,169,129,40,4,3

7,112,112,1,1,0,1,0
3,156,156,17,1,16,3,2
4,174,174,13,13,0,1,0
9,176,176,11,11,0,1,0
10,177,177,6,6,0,1,0
2,227,227,10,10,0,1,0
0,287,287,5,5,0,1,0
5,316,316,18,7,11,2,1
1,360,360,47,47,0,1,0
11,372,372,28,2,26,2,1
6,411,411,26,2,24,3,2
8,473,473,159,159,0,1,0

8,112,112,1,1,0,1,0
0,130,130,1,1,0,1,0
6,173,173,7,1,6,2,1
11,223,223,27,27,0,1,0
4,236,236,10,10,0,1,0
12,261,261,79,79,0,1,0
3,276,276,35,31,4,2,1
7,372,372,30,30,0,1,0
9,378,378,8,8,0,1,0
5,398,398,28,9,19,2,1
1,412,412,23,23,0,1,0
2,431,431,29,26,3,2,1
10,482,482,30,10,20,3,2

3,106,106,26,26,0,1,0
7,148,148,44,44,0,1,0
9,183,183,6,6,0,1,0
1,203,203,16,16,0,1,0
0,216,216,13,5,8,3,2
10,217,217,7,7,0,1,0
6,264,264,14,14,0,1,0
5,286,286,8,8,0,1,0
2,291,291,1,1,0,1,0
8,318,318,47,47,0,1,0
4,362,362,12,1,11,2,1

3,112,112,31,31,0,1,0
0,274,274,1,1,0,1,0
5,375,375,15,15,0,1,0
2,382,382,89,74,15,4,3
4,402,402,11,11,0,1,0
6,403,403,66,42,24,2,1
1,443,443,117,77,40,3,2

3,101,101,4,4,0,1,0
0,149,149,1,1,0,1,0
8,158,158,43,43,0,1,0
6,200,200,21,21,0,1,0
1,271,271,8,2,6,2,1
11,323,323,36,3,33,4,3
2,381,381,13,5,8,3,2
10,447,447,49,49,0,1,0
5,453,453,54,54,0,1,0
4,496,496,57,57,0,1,0
9,498,498,5,5,0,1,0
7,500,500,26,12,14,3,2

6,116,116,1,1,0,1,0
0,129,129,2,2,0,1,0
10,184,184,11,11,0,1,0
8,200,200,14,14,0,1,0
1,226,226,13,4,9,2,1
5,279,279,3,3,0,1,0
12,309,309,6,6,0,1,0
4,345,345,34,4,30,4,3
7,437,437,38,14,24,2,1
3,458,458,9,6,3,2,1
11,466,466,105,105,0,1,0
9,495,495,100,85,15,4,3
2,496,496,67,43,24,2,1

4,214,214,6,3,3,2,1
5,237,237,13,1,12,4,3
7,315,315,56,14,42,3,2
2,320,320,1,1,0,1,0
3,387,387,101,101,0,1,0
6,410,410,66,3,63,4,3
8,427,427,11,11,0,1,0
1,448,448,49,49,0,1,0
9,478,478,66,66,0,1,0
0,485,485,23,23,0,1,0

5,133,133,6,2,4,2,1
8,231,231,5,5,0,1,0
13,249,249,22,22,0,1,0
7,285,285,11,11,0,1,0
2,295,295,23,23,0,1,0
1,296,296,10,10,0,1,0
12,321,321,64,64,0,1,0
11,336,336,2,2,0,1,0
10,341,341,73,1,72,3,2
3,379,379,15,9,6,3,2
4,396,396,35,35,0,1,0
6,431,431,1,1,0,1,0
0,445,445,61,23,38,3,2
9,449,449,7,4,3,2,1

1,124,124,10,6,4,2,1
6,231,231,11,1,10,3,2
0,281,281,68,23,45,2,1
5,343,343,36,2,34,4,3
3,390,390,99,19,80,4,3
4,416,416,42,30,12,3,2
2,421,421,75,75,0,1,0

0,114,114,22,2,20,3,2
5,162,162,17,6,11,2,1
1,220,220,3,3,0,1,0
8,274,274,3,3,0,1,0
6,324,324,1,1,0,1,0
2,332,332,35,35,0,1,0
4,429,429,26,11,15,3,2
3,471,471,61,3,58,3,2
7,484,484,188,188,0,1,0

8,124,124,6,6,0,1,0
6,138,138,12,12,0,1,0
9,149,149,2,2,0,1,0
12,200,200,18,6,12,3,2
7,206,206,2,2,0,1,0
0,221,221,27,5,22,3,2
3,221,221,3,3,0,1,0
13,226,226,24,6,18,2,1
4,282,282,4,4,0,1,0
1,336,336,27,27,0,1,0
11,359,359,93,13,80,3,2
2,369,369,2,2,0,1,0
10,447,447,24,24,0,1,0
5,499,499,55,46,9,2,1

0,104,104,3,3,0,1,0
1,129,129,2,2,0,1,0
9,158,158,4,4,0,1,0
2,170,170,3,3,0,1,0
3,215,215,9,9,0,1,0
10,220,220,16,16,0,1,0
6,221,221,35,13,22,3,2
12,229,229,72,46,26,2,1
7,292,292,1,1,0,1,0
8,312,312,16,16,0,1,0
11,339,339,32,32,0,1,0
4,351,351,36,36,0,1,0
5,367,367,30,9,21,4,3

0,107,107,6,2,4,2,1
4,139,139,17,7,10,2,1
3,196,196,21,5,16,3,2
10,207,207,8,8,0,1,0
7,225,225,25,15,10,3,2
5,270,270,27,3,24,2,1
1,316,316,26,26,0,1,0
8,367,367,120,59,61,4,3
2,370,370,10,4,6,3,2
9,406,406,12,3,9,2,1
6,425,425,3,3,0,1,0

2,101,101,27,22,5,2,1
9,164,164,51,51,0,1,0
3,207,207,19,19,0,1,0
6,282,282,9,9,0,1,0
0,312,312,12,1,11,2,1
5,322,322,8,8,0,1,0
8,363,363,38,30,8,2,1
1,364,364,3,3,0,1,0
4,447,447,31,31,0,1,0
7,486,486,30,30,0,1,0

0,111,111,31,31,0,1,0
3,198,198,28,28,0,1,0
2,273,273,53,53,0,1,0
6,288,288,2,2,0,1,0
4,308,308,85,85,0,1,0
1,368,368,11,11,0,1,0
5,468,468,39,1,38,2,1

7,149,149,31,16,15,2,1
8,162,162,44,38,6,2,1
9,179,179,5,5,0,1,0
0,217,217,31,31,0,1,0
3,251,251,3,3,0,1,0
2,269,269,17,17,0,1,0
4,283,283,24,24,0,1,0
6,362,362,2,2,0,1,0
5,428,428,46,6,40,3,2
1,436,436,40,25,15,4,3

3,243,243,26,4,22,3,2
1,265,265,8,8,0,1,0
2,324,324,33,20,13,2,1
0,330,330,122,83,39,4,3
5,469,469,45,45,0,1,0
4,489,489,11,11,0,1,0
6,499,499,140,113,27,4,3

9,107,107,27,27,0,1,0
7,112,112,8,1,7,2,1
0,142,142,4,4,0,1,0
5,224,224,26,14,12,2,1
6,226,226,24,24,0,1,0
10,247,247,35,35,0,1,0
1,274,274,8,8,0,1,0
4,334,334,3,3,0,1,0
2,350,350,35,35,0,1,0
3,439,439,49,49,0,1,0
8,490,490,24,24,0,1,0

1,155,155,15,15,0,1,0
3,192,192,7,7,0,1,0
6,283,283,28,28,0,1,0
4,334,334,5,5,0,1,0
7,362,362,54,54,0,1,0
9,370,370,30,30,0,1,0
2,378,378,5,1,4,2,1
8,400,400,70,70,0,1,0
5,436,436,72,72,0,1,0
0,437,437,76,10,66,3,2

5,158,158,13,8,5,2,1
7,221,221,4,1,3,2,1
9,255,255,97,71,26,3,2
4,268,268,12,8,4,2,1
1,345,345,42,27,15,2,1
8,346,346,11,11,0,1,0
0,400,400,43,6,37,2,1
6,400,400,32,32,0,1,0
2,482,482,13,7,6,2,1
3,500,500,59,11,48,2,1

5,125,125,44,44,0,1,0
8,233,233,26,26,0,1,0
0,259,259,32,32,0,1,0
7,272,272,11,2,9,4,3
1,376,376,13,1,12,2,1
4,401,401,3,3,0,1,0
2,431,431,118,3,115,4,3
3,466,466,29,2,27,4,3
6,469,469,2,2,0,1,0

3,102,102,10,5,5,2,1
1,129,129,32,18,14,2,1
6,198,198,71,49,22,3,2
7,230,230,14,14,0,1,0
2,277,277,35,29,6,2,1
0,323,323,9,9,0,1,0
5,381,381,32,5,27,2,1
4,386,386,2,2,0,1,0

3,191,191,26,14,12,2,1
5,225,225,23,23,0,1,0
8,225,225,8,8,0,1,0
2,256,256,17,4,13,4,3
1,270,270,46,38,8,3,2
0,338,338,41,41,0,1,0
6,380,380,113,113,0,1,0
7,460,460,32,23,9,2,1
4,485,485,3,3,0,1,0

2,109,109,11,11,0,1,0
0,153,153,3,3,0,1,0
1,291,291,17,5,12,4,3
3,331,331,107,107,0,1,0
5,348,348,14,14,0,1,0
4,386,386,125,61,64,4,3
6,387,387,5,5,0,1,0
7,497,497,64,64,0,1,0

4,106,106,17,17,0,1,0
5,171,171,37,37,0,1,0
3,217,217,34,9,25,2,1
6,225,225,1,1,0,1,0
1,238,238,67,67,0,1,0
0,310,310,13,13,0,1,0
2,326,326,7,7,0,1,0
7,500,500,67,67,0,1,0

4,120,120,1,1,0,1,0
2,198,198,3,3,0,1,0
5,384,384,3,3,0,1,0
0,389,389,57,57,0,1,0
3,451,451,19,7,12,4,3
6,454,454,37,9,28,3,2
1,483,483,144,41,103,4,3
7,495,495,203,161,42,2,1

4,118,118,2,2,0,1,0
11,152,152,7,7,0,1,0
12,173,173,55,7,48,4,3
10,198,198,10,6,4,2,1
5,253,253,26,14,12,2,1
8,302,302,24,6,18,4,3
2,311,311,18,18,0,1,0
7,388,388,3,3,0,1,0
3,440,440,24,24,0,1,0
9,465,465,46,10,36,2,1
0,468,468,55,55,0,1,0
1,475,475,12,2,10,2,1
6,480,480,19,19,0,1,0

5,108,108,1,1,0,1,0
3,165,165,1,1,0,1,0
2,198,198,33,33,0,1,0
8,211,211,3,3,0,1,0
6,233,233,11,11,0,1,0
11,245,245,67,19,48,4,3
12,262,262,9,3,6,2,1
1,291,291,7,7,0,1,0
4,311,311,1,1,0,1,0
9,318,318,28,28,0,1,0
7,323,323,6,3,3,2,1
0,460,460,99,99,0,1,0
10,497,497,54,6,48,3,2

6,115,115,27,7,20,2,1
3,142,142,3,3,0,1,0
9,192,192,1,1,0,1,0
4,195,195,3,3,0,1,0
8,227,227,35,23,12,3,2
10,302,302,44,44,0,1,0
2,328,328,23,23,0,1,0
5,354,354,27,27,0,1,0
7,357,357,1,1,0,1,0
11,382,382,78,78,0,1,0
1,449,449,24,18,6,3,2
0,490,490,14,3,11,2,1

3,117,117,13,3,10,2,1
4,236,236,2,2,0,1,0
1,323,323,34,34,0,1,0
2,352,352,40,40,0,1,0
5,357,357,25,3,22,3,2
0,441,441,75,11,64,3,2
6,448,448,42,1,41,2,1
7,454,454,150,150,0,1,0

9,117,117,5,5,0,1,0
4,212,212,25,12,13,3,2
1,234,234,1,1,0,1,0
11,235,235,5,5,0,1,0
5,263,263,2,2,0,1,0
6,266,266,1,1,0,1,0
0,271,271,51,43,8,2,1
2,322,322,26,19,7,2,1
8,371,371,112,109,3,2,1
10,425,425,61,39,22,2,1
3,468,468,39,12,27,2,1
7,474,474,7,7,0,1,0

9,106,106,9,9,0,1,0
6,134,134,3,3,0,1,0
3,205,205,10,7,3,2,1
0,279,279,21,21,0,1,0
5,301,301,36,36,0,1,0
4,318,318,13,13,0,1,0
7,334,334,11,1,10,2,1
2,441,441,9,6,3,2,1
10,490,490,65,12,53,4,3
8,492,492,126,114,12,3,2
1,497,497,89,39,50,2,1

8,153,153,15,3,12,2,1
3,188,188,58,6,52,3,2
2,260,260,16,16,0,1,0
0,292,292,8,8,0,1,0
1,318,318,32,32,0,1,0
6,328,328,86,50,36,4,3
4,473,473,1,1,0,1,0
5,477,477,26,26,0,1,0
7,480,480,43,7,36,3,2

3,117,117,1,1,0,1,0
6,133,133,23,23,0,1,0
4,241,241,5,5,0,1,0
8,270,270,53,24,29,2,1
1,303,303,4,4,0,1,0
5,305,305,16,16,0,1,0
2,325,325,6,6,0,1,0
10,404,404,78,33,45,2,1
9,411,411,5,5,0,1,0
7,431,431,44,44,0,1,0
0,470,470,101,39,62,3,2

7,135,135,4,4,0,1,0
10,172,172,1,1,0,1,0
4,177,177,9,9,0,1,0
9,231,231,70,70,0,1,0
11,316,316,29,29,0,1,0
8,344,344,38,3,35,2,1
3,358,358,49,4,45,4,3
6,359,359,10,10,0,1,0
1,407,407,9,3,6,3,2
2,409,409,33,1,32,2,1
0,418,418,20,14,6,3,2
5,466,466,49,11,38,2,1

0,123,123,19,19,0,1,0
8,132,132,29,29,0,1,0
2,220,220,11,11,0,1,0
4,276,276,53,17,36,3,2
5,299,299,36,8,28,3,2
6,323,323,9,5,4,2,1
7,351,351,51,51,0,1,0
3,420,420,26,14,12,2,1
1,453,453,19,7,12,3,2

4,104,104,3,3,0,1,0
10,106,106,3,3,0,1,0
3,170,170,8,8,0,1,0
0,192,192,3,3,0,1,0
7,225,225,4,1,3,2,1
8,238,238,15,3,12,4,3
13,250,250,24,15,9,2,1
14,250,250,25,25,0,1,0
16,270,270,17,17,0,1,0
12,272,272,8,2,6,3,2
17,289,289,12,12,0,1,0
1,317,317,11,11,0,1,0
15,351,351,107,79,28,3,2
2,352,352,1,1,0,1,0
11,358,358,9,9,0,1,0
6,406,406,9,4,5,2,1
5,467,467,34,25,9,2,1
9,486,486,9,1,8,3,2

4,106,106,3,3,0,1,0
6,113,113,17,17,0,1,0
1,139,139,23,1,22,3,2
3,190,190,1,1,0,1,0
2,224,224,46,39,7,2,1
0,225,225,15,4,11,2,1
5,267,267,8,8,0,1,0
7,273,273,45,12,33,4,3
8,435,435,38,38,0,1,0
9,469,469,52,22,30,4,3

7,108,108,11,11,0,1,0
2,145,145,7,3,4,2,1
11,209,209,25,25,0,1,0
12,242,242,13,13,0,1,0
0,262,262,33,33,0,1,0
3,262,262,6,2,4,2,1
8,311,311,10,10,0,1,0
6,320,320,8,1,7,2,1
13,345,345,8,8,0,1,0
10,370,370,116,116,0,1,0
1,380,380,2,2,0,1,0
5,380,380,7,7,0,1,0
4,440,440,1,1,0,1,0
9,477,477,57,12,45,3,2

6,202,202,4,4,0,1,0
2,208,208,6,6,0,1,0
9,224,224,12,2,10,3,2
7,242,242,34,3,31,4,3
5,353,353,40,40,0,1,0
3,361,361,7,7,0,1,0
0,390,390,43,43,0,1,0
1,484,484,46,24,22,2,1
8,490,490,144,144,0,1,0
4,497,497,67,21,46,3,2

2,139,139,12,12,0,1,0
3,139,139,8,8,0,1,0
6,179,179,29,29,0,1,0
7,210,210,28,28,0,1,0
1,251,251,15,5,10,3,2
4,333,333,52,11,41,3,2
5,346,346,21,21,0,1,0
0,365,365,109,109,0,1,0

4,165,165,10,10,0,1,0
7,173,173,35,29,6,2,1
5,193,193,22,10,12,2,1
2,279,279,2,2,0,1,0
1,357,357,139,64,75,4,3
6,447,447,58,20,38,4,3
0,474,474,1,1,0,1,0
3,489,489,50,50,0,1,0

4,114,114,10,10,0,1,0
2,191,191,2,2,0,1,0
1,251,251,10,5,5,2,1
5,278,278,1,1,0,1,0
6,309,309,112,26,86,3,2
7,369,369,22,22,0,1,0
3,402,402,120,120,0,1,0
0,448,448,68,68,0,1,0

3,114,114,10,10,0,1,0
2,131,131,32,13,19,4,3
1,182,182,9,9,0,1,0
4,189,189,48,48,0,1,0
5,190,190,20,14,6,2,1
7,223,223,28,28,0,1,0
6,241,241,6,6,0,1,0
0,266,266,32,8,24,4,3

8,105,105,18,18,0,1,0
4,134,134,6,6,0,1,0
2,175,175,33,21,12,3,2
3,209,209,15,7,8,2,1
5,296,296,79,27,52,3,2
0,341,341,13,13,0,1,0
7,370,370,5,5,0,1,0
6,397,397,23,23,0,1,0
1,500,500,79,22,57,3,2

6,124,124,16,16,0,1,0
0,126,126,5,2,3,2,1
9,137,137,19,5,14,3,2
1,153,153,14,5,9,4,3
7,155,155,10,5,5,2,1
8,298,298,34,34,0,1,0
4,352,352,9,9,0,1,0
2,380,380,51,51,0,1,0
10,443,443,85,69,16,3,2
3,473,473,12,12,0,1,0
5,485,485,27,27,0,1,0

5,124,124,3,3,0,1,0
9,141,141,30,10,20,2,1
10,168,168,22,4,18,4,3
4,202,202,9,9,0,1,0
11,291,291,47,47,0,1,0
3,294,294,15,9,6,2,1
1,311,311,11,11,0,1,0
6,324,324,38,26,12,3,2
8,392,392,1,1,0,1,0
2,404,404,2,2,0,1,0
7,409,409,1,1,0,1,0
0,451,451,100,4,96,4,3

0,151,151,9,9,0,1,0
4,185,185,16,16,0,1,0
6,188,188,53,53,0,1,0
7,235,235,17,17,0,1,0
9,282,282,28,28,0,1,0
8,332,332,19,19,0,1,0
1,359,359,87,61,26,2,1
3,419,419,26,20,6,2,1
5,463,463,22,22,0,1,0
2,488,488,1,1,0,1,0

1,128,128,22,7,15,2,1
6,184,184,36,36,0,1,0
7,192,192,16,6,10,2,1
8,277,277,43,6,37,2,1
4,290,290,7,7,0,1,0
2,320,320,63,18,45,2,1
3,347,347,5,1,4,2,1
0,427,427,26,26,0,1,0
9,444,444,32,5,27,4,3
5,481,481,16,16,0,1,0

10,126,126,28,28,0,1,0
5,139,139,1,1,0,1,0
0,213,213,2,2,0,1,0
7,259,259,31,31,0,1,0
8,266,266,12,12,0,1,0
11,285,285,39,39,0,1,0
9,294,294,32,21,11,2,1
2,318,318,51,37,14,2,1
3,326,326,20,20,0,1,0
6,404,404,15,11,4,2,1
4,434,434,45,21,24,3,2
1,437,437,2,2,0,1,0

1,165,165,1,1,0,1,0
5,170,170,14,14,0,1,0
2,214,214,9,9,0,1,0
10,214,214,20,20,0,1,0
7,224,224,10,5,5,2,1
4,252,252,10,1,9,3,2
8,343,343,40,40,0,1,0
9,355,355,89,89,0,1,0
3,370,370,2,2,0,1,0
0,452,452,71,71,0,1,0
6,468,468,79,79,0,1,0

7,121,121,4,4,0,1,0
1,193,193,17,7,10,3,2
5,260,260,5,1,4,2,1
4,261,261,40,40,0,1,0
3,267,267,26,26,0,1,0
8,267,267,102,102,0,1,0
6,383,383,28,28,0,1,0
2,415,415,1,1,0,1,0
0,427,427,69,31,38,2,1

7,119,119,1,1,0,1,0
2,142,142,37,20,17,2,1
5,145,145,1,1,0,1,0
8,169,169,12,12,0,1,0
3,172,172,2,2,0,1,0
12,201,201,29,11,18,3,2
6,217,217,4,4,0,1,0
1,241,241,10,10,0,1,0
10,242,242,39,39,0,1,0
9,341,341,34,34,0,1,0
11,400,400,42,42,0,1,0
0,439,439,26,9,17,2,1
4,496,496,14,14,0,1,0

3,262,262,8,8,0,1,0
7,284,284,14,14,0,1,0
8,314,314,1,1,0,1,0
10,346,346,79,18,61,3,2
6,349,349,13,5,8,3,2
0,393,393,53,35,18,2,1
4,435,435,33,33,0,1,0
2,459,459,23,23,0,1,0
5,493,493,70,70,0,1,0
9,498,498,111,55,56,4,3
1,499,499,15,15,0,1,0

7,124,124,1,1,0,1,0
1,195,195,35,35,0,1,0
3,213,213,1,1,0,1,0
5,216,216,26,1,25,2,1
0,243,243,25,4,21,4,3
6,269,269,72,24,48,4,3
2,281,281,51,51,0,1,0
8,378,378,43,8,35,3,2
4,381,381,12,6,6,3,2

2,264,264,127,76,51,4,3
4,302,302,5,5,0,1,0
1,371,371,2,2,0,1,0
3,403,403,112,49,63,4,3
5,449,449,65,46,19,4,3
6,454,454,30,30,0,1,0
0,469,469,8,8,0,1,0

8,105,105,21,21,0,1,0
7,155,155,8,8,0,1,0
4,299,299,10,2,8,2,1
2,325,325,118,50,68,4,3
6,344,344,70,34,36,4,3
3,412,412,39,1,38,2,1
0,424,424,1,1,0,1,0
1,430,430,4,4,0,1,0
5,465,465,25,25,0,1,0

6,110,110,11,11,0,1,0
0,209,209,25,7,18,4,3
8,210,210,2,2,0,1,0
5,228,228,10,4,6,3,2
1,270,270,26,26,0,1,0
2,274,274,28,8,20,2,1
4,311,311,13,4,9,2,1
10,398,398,79,79,0,1,0
9,447,447,28,28,0,1,0
3,452,452,2,2,0,1,0
7,495,495,116,17,99,4,3

5,109,109,25,7,18,3,2
4,110,110,1,1,0,1,0
1,171,171,3,3,0,1,0
2,198,198,25,7,18,3,2
8,223,223,26,8,18,4,3
7,233,233,23,23,0,1,0
9,323,323,105,105,0,1,0
11,323,323,5,5,0,1,0
3,422,422,1,1,0,1,0
10,423,423,22,1,21,2,1
6,424,424,2,2,0,1,0
0,467,467,6,6,0,1,0

7,105,105,3,3,0,1,0
4,120,120,4,4,0,1,0
9,161,161,1,1,0,1,0
5,237,237,45,45,0,1,0
6,319,319,57,7,50,2,1
1,352,352,2,2,0,1,0
3,368,368,7,1,6,2,1
2,431,431,4,4,0,1,0
8,464,464,8,1,7,2,1
11,481,481,141,58,83,4,3
0,494,494,18,7,11,2,1
10,499,499,96,6,90,3,2

1,115,115,1,1,0,1,0
0,168,168,2,2,0,1,0
4,177,177,23,23,0,1,0
8,183,183,32,27,5,2,1
10,237,237,71,59,12,4,3
2,304,304,5,2,3,2,1
7,353,353,5,5,0,1,0
3,379,379,52,9,43,4,3
5,390,390,59,59,0,1,0
9,430,430,9,9,0,1,0
6,489,489,22,22,0,1,0

5,103,103,2,2,0,1,0
12,112,112,24,1,23,3,2
14,122,122,21,21,0,1,0
0,126,126,12,12,0,1,0
13,151,151,4,4,0,1,0
9,237,237,1,1,0,1,0
6,245,245,6,6,0,1,0
10,248,248,11,11,0,1,0
7,268,268,22,4,18,2,1
2,347,347,1,1,0,1,0
11,356,356,10,10,0,1,0
15,394,394,39,19,20,4,3
8,416,416,34,13,21,4,3
1,432,432,2,2,0,1,0
4,454,454,3,3,0,1,0
3,463,463,50,13,37,2,1

0,115,115,4,4,0,1,0
6,123,123,28,28,0,1,0
9,168,168,9,5,4,2,1
8,211,211,18,18,0,1,0
3,217,217,9,6,3,2,1
4,221,221,47,8,39,2,1
1,301,301,39,39,0,1,0
2,351,351,6,6,0,1,0
7,440,440,62,23,39,4,3
5,464,464,30,30,0,1,0

8,144,144,5,5,0,1,0
4,149,149,9,9,0,1,0
9,292,292,34,14,20,2,1
2,303,303,17,2,15,2,1
3,321,321,5,1,4,2,1
7,343,343,14,8,6,3,2
6,354,354,13,13,0,1,0
5,388,388,21,11,10,2,1
1,402,402,108,108,0,1,0
10,409,409,129,81,48,4,3
0,482,482,5,5,0,1,0

9,134,134,16,16,0,1,0
5,149,149,12,12,0,1,0
7,153,153,1,1,0,1,0
8,180,180,54,54,0,1,0
1,237,237,13,13,0,1,0
3,291,291,12,12,0,1,0
0,305,305,8,8,0,1,0
4,426,426,121,34,87,4,3
6,447,447,38,11,27,4,3
2,451,451,7,3,4,2,1

3,118,118,1,1,0,1,0
2,126,126,31,27,4,2,1
1,283,283,132,65,67,4,3
0,288,288,10,1,9,2,1
4,326,326,21,13,8,2,1
5,426,426,80,80,0,1,0

6,153,153,10,10,0,1,0
0,255,255,72,34,38,2,1
1,288,288,44,13,31,2,1
3,301,301,12,12,0,1,0
5,355,355,48,30,18,3,2
4,401,401,106,67,39,4,3
2,464,464,31,4,27,4,3

9,192,192,19,19,0,1,0
4,227,227,41,8,33,2,1
6,242,242,44,28,16,2,1
1,255,255,19,19,0,1,0
5,260,260,16,16,0,1,0
2,379,379,26,26,0,1,0
8,393,393,63,63,0,1,0
0,394,394,37,37,0,1,0
7,410,410,26,6,20,3,2
3,487,487,11,11,0,1,0

3,108,108,30,24,6,2,1
1,150,150,15,3,12,2,1
7,211,211,8,8,0,1,0
5,253,253,53,53,0,1,0
4,295,295,58,58,0,1,0
6,327,327,22,22,0,1,0
2,368,368,14,14,0,1,0
0,404,404,36,36,0,1,0

8,104,104,2,2,0,1,0
7,113,113,17,5,12,4,3
10,129,129,52,34,18,2,1
11,146,146,6,6,0,1,0
2,263,263,17,1,16,3,2
4,276,276,1,1,0,1,0
0,281,281,14,14,0,1,0
9,294,294,14,14,0,1,0
3,299,299,6,6,0,1,0
6,320,320,7,7,0,1,0
5,478,478,1,1,0,1,0
1,487,487,92,83,9,4,3

11,115,115,5,5,0,1,0
13,145,145,7,3,4,2,1
12,147,147,9,4,5,2,1
10,159,159,2,2,0,1,0
7,160,160,3,3,0,1,0
4,169,169,1,1,0,1,0
0,191,191,4,4,0,1,0
14,223,223,65,65,0,1,0
8,236,236,7,7,0,1,0
5,267,267,1,1,0,1,0
6,277,277,10,10,0,1,0
2,283,283,10,1,9,4,3
3,296,296,4,4,0,1,0
9,322,322,42,42,0,1,0
15,398,398,43,4,39,2,1
1,459,459,71,71,0,1,0

3,115,115,9,9,0,1,0
2,144,144,1,1,0,1,0
7,152,152,6,6,0,1,0
8,186,186,19,12,7,2,1
0,400,400,101,53,48,3,2
6,408,408,103,73,30,2,1
5,425,425,49,19,30,2,1
1,448,448,20,15,5,2,1
4,485,485,58,13,45,2,1

3,106,106,27,7,20,3,2
6,194,194,33,33,0,1,0
7,223,223,25,25,0,1,0
5,228,228,36,28,8,2,1
0,261,261,49,49,0,1,0
4,301,301,22,14,8,2,1
2,314,314,18,15,3,2,1
1,427,427,1,1,0,1,0

6,165,165,34,25,9,4,3
7,237,237,54,49,5,2,1
5,246,246,7,2,5,2,1
8,298,298,14,14,0,1,0
4,326,326,10,10,0,1,0
2,381,381,28,18,10,2,1
3,408,408,78,15,63,4,3
0,418,418,18,18,0,1,0
1,443,443,72,62,10,2,1

2,159,159,10,1,9,2,1
1,205,205,9,9,0,1,0
7,362,362,57,57,0,1,0
6,412,412,78,8,70,3,2
4,427,427,51,33,18,4,3
3,440,440,86,86,0,1,0
0,457,457,91,6,85,4,3
5,472,472,18,18,0,1,0

0,112,112,56,44,12,2,1
4,190,190,7,1,6,2,1
3,209,209,2,2,0,1,0
2,260,260,112,70,42,3,2
1,491,491,16,16,0,1,0

2,159,159,28,28,0,1,0
8,178,178,4,4,0,1,0
7,194,194,8,8,0,1,0
3,246,246,34,34,0,1,0
6,312,312,96,96,0,1,0
4,380,380,3,3,0,1,0
0,412,412,9,9,0,1,0
5,472,472,64,46,18,2,1
1,488,488,77,77,0,1,0

8,104,104,7,3,4,2,1
3,108,108,9,1,8,3,2
5,123,123,21,18,3,2,1
6,140,140,5,5,0,1,0
2,184,184,3,3,0,1,0
7,248,248,60,60,0,1,0
4,249,249,43,43,0,1,0
1,267,267,17,1,16,2,1
0,434,434,72,72,0,1,0

9,100,100,16,6,10,3,2
0,166,166,6,6,0,1,0
2,172,172,5,5,0,1,0
1,186,186,10,2,8,2,1
3,187,187,3,3,0,1,0
8,269,269,8,1,7,2,1
7,277,277,52,52,0,1,0
4,326,326,59,30,29,4,3
10,341,341,44,2,42,3,2
5,400,400,56,44,12,4,3
6,449,449,20,1,19,2,1

2,213,213,8,3,5,2,1
8,314,314,3,3,0,1,0
5,346,346,98,98,0,1,0
1,349,349,14,14,0,1,0
3,369,369,5,2,3,2,1
6,392,392,150,51,99,4,3
9,394,394,18,8,10,2,1
7,402,402,27,9,18,4,3
4,433,433,1,1,0,1,0
0,443,443,55,26,29,2,1

1,123,123,3,3,0,1,0
0,147,147,9,9,0,1,0
5,253,253,71,71,0,1,0
4,259,259,8,5,3,2,1
10,314,314,62,20,42,4,3
2,317,317,1,1,0,1,0
9,353,353,40,40,0,1,0
6,372,372,32,32,0,1,0
8,428,428,64,54,10,2,1
3,461,461,7,2,5,2,1
7,470,470,20,20,0,1,0

9,132,132,35,35,0,1,0
4,207,207,3,3,0,1,0
6,227,227,3,3,0,1,0
10,250,250,45,45,0,1,0
0,278,278,30,18,12,2,1
3,352,352,30,30,0,1,0
8,393,393,12,12,0,1,0
1,397,397,3,3,0,1,0
7,441,441,14,14,0,1,0
2,495,495,95,46,49,2,1
5,496,496,40,17,23,2,1

11,107,107,5,2,3,2,1
2,127,127,10,1,9,4,3
1,129,129,5,1,4,2,1
0,151,151,16,7,9,2,1
9,182,182,1,1,0,1,0
7,340,340,1,1,0,1,0
4,359,359,19,15,4,2,1
10,360,360,22,22,0,1,0
6,367,367,23,15,8,2,1
5,388,388,61,46,15,4,3
3,407,407,1,1,0,1,0
8,431,431,170,20,150,4,3

1,103,103,6,6,0,1,0
6,107,107,5,5,0,1,0
5,164,164,25,2,23,2,1
9,227,227,8,8,0,1,0
3,284,284,26,11,15,4,3
7,342,342,8,8,0,1,0
2,352,352,26,26,0,1,0
0,374,374,19,11,8,3,2
10,382,382,48,48,0,1,0
8,406,406,131,59,72,4,3
4,440,440,12,6,6,2,1

3,125,125,30,8,22,4,3
7,131,131,2,2,0,1,0
1,194,194,7,2,5,2,1
10,247,247,26,5,21,4,3
2,253,253,18,1,17,2,1
4,266,266,2,2,0,1,0
8,294,294,101,41,60,3,2
6,397,397,18,18,0,1,0
5,401,401,29,29,0,1,0
9,427,427,19,19,0,1,0
0,435,435,13,13,0,1,0

2,130,130,3,3,0,1,0
3,166,166,12,6,6,3,2
6,184,184,23,11,12,3,2
9,191,191,8,8,0,1,0
7,203,203,16,6,10,2,1
1,254,254,36,36,0,1,0
5,335,335,38,38,0,1,0
4,358,358,44,7,37,4,3
8,408,408,107,11,96,4,3
0,486,486,13,5,8,2,1

9,141,141,10,10,0,1,0
1,145,145,1,1,0,1,0
7,152,152,12,1,11,2,1
8,204,204,40,5,35,2,1
0,244,244,18,18,0,1,0
4,294,294,27,27,0,1,0
5,311,311,14,1,13,3,2
3,315,315,14,11,3,2,1
6,389,389,63,63,0,1,0
2,419,419,100,19,81,4,3

6,161,161,4,1,3,2,1
5,173,173,32,16,16,3,2
7,198,198,22,14,8,2,1
0,208,208,3,3,0,1,0
4,215,215,10,10,0,1,0
2,348,348,1,1,0,1,0
3,377,377,55,55,0,1,0
8,387,387,139,91,48,4,3
9,429,429,5,5,0,1,0
1,485,485,52,52,0,1,0

8,123,123,15,3,12,3,2
4,176,176,12,12,0,1,0
7,329,329,11,6,5,2,1
1,342,342,74,34,40,3,2
0,385,385,22,22,0,1,0
3,398,398,29,29,0,1,0
2,401,401,11,3,8,2,1
5,433,433,26,26,0,1,0
6,445,445,59,37,22,3,2
9,472,472,103,1,102,4,3

1,113,113,2,2,0,1,0
5,162,162,4,4,0,1,0
6,166,166,35,7,28,2,1
3,173,173,30,30,0,1,0
4,186,186,35,21,14,3,2
2,204,204,3,3,0,1,0
0,318,318,34,34,0,1,0
7,428,428,23,14,9,2,1
8,429,429,93,15,78,3,2

5,197,197,42,42,0,1,0
8,201,201,5,5,0,1,0
6,307,307,4,4,0,1,0
7,319,319,76,76,0,1,0
2,329,329,49,49,0,1,0
0,336,336,2,2,0,1,0
4,364,364,26,26,0,1,0
10,385,385,74,68,6,3,2
3,441,441,20,20,0,1,0
1,457,457,1,1,0,1,0
9,488,488,26,3,23,2,1

3,103,103,2,2,0,1,0
1,217,217,1,1,0,1,0
4,219,219,1,1,0,1,0
2,227,227,4,4,0,1,0
9,283,283,38,30,8,3,2
6,303,303,50,50,0,1,0
0,322,322,23,23,0,1,0
8,322,322,55,11,44,4,3
7,425,425,15,9,6,2,1
5,435,435,167,139,28,3,2

0,150,150,31,26,5,2,1
2,166,166,29,29,0,1,0
5,168,168,2,2,0,1,0
1,209,209,4,1,3,2,1
7,346,346,15,3,12,3,2
6,390,390,85,85,0,1,0
3,448,448,1,1,0,1,0
4,485,485,48,48,0,1,0
8,488,488,114,84,30,4,3

6,117,117,37,37,0,1,0
4,126,126,24,24,0,1,0
0,181,181,21,6,15,2,1
7,240,240,17,8,9,4,3
2,263,263,18,11,7,2,1
5,387,387,2,2,0,1,0
8,437,437,52,38,14,3,2
1,479,479,42,42,0,1,0
3,494,494,21,21,0,1,0

8,125,125,1,1,0,1,0
1,153,153,6,6,0,1,0
3,174,174,3,3,0,1,0
6,199,199,9,2,7,2,1
11,264,264,15,5,10,3,2
0,277,277,37,16,21,4,3
10,298,298,16,16,0,1,0
2,300,300,54,54,0,1,0
5,324,324,4,4,0,1,0
12,376,376,41,41,0,1,0
4,397,397,17,9,8,3,2
9,466,466,133,101,32,2,1
7,480,480,13,1,12,2,1

10,106,106,13,13,0,1,0
3,113,113,1,1,0,1,0
5,121,121,12,12,0,1,0
1,182,182,2,2,0,1,0
11,189,189,34,18,16,2,1
8,216,216,12,8,4,2,1
2,241,241,2,2,0,1,0
6,267,267,2,2,0,1,0
9,283,283,45,21,24,2,1
7,357,357,8,8,0,1,0
0,406,406,27,27,0,1,0
4,409,409,114,114,0,1,0

0,132,132,2,2,0,1,0
9,134,134,50,50,0,1,0
4,190,190,4,4,0,1,0
5,198,198,3,3,0,1,0
11,221,221,14,14,0,1,0
7,240,240,26,6,20,3,2
3,259,259,6,6,0,1,0
6,307,307,94,76,18,2,1
8,360,360,4,4,0,1,0
1,419,419,2,2,0,1,0
2,455,455,3,3,0,1,0
10,496,496,28,28,0,1,0

4,284,284,47,47,0,1,0
2,294,294,53,53,0,1,0
5,299,299,49,16,33,4,3
0,346,346,61,1,60,3,2
1,443,443,65,41,24,4,3
3,463,463,24,1,23,2,1
6,473,473,59,19,40,3,2

4,110,110,10,10,0,1,0
3,128,128,4,4,0,1,0
0,143,143,18,2,16,3,2
5,217,217,85,12,73,4,3
7,241,241,5,5,0,1,0
2,261,261,67,67,0,1,0
8,270,270,24,12,12,2,1
1,330,330,1,1,0,1,0
6,415,415,4,4,0,1,0

0,134,134,10,10,0,1,0
9,163,163,29,29,0,1,0
3,220,220,2,2,0,1,0
4,340,340,22,22,0,1,0
6,376,376,27,1,26,3,2
5,378,378,72,27,45,3,2
1,386,386,1,1,0,1,0
8,420,420,75,55,20,3,2
7,421,421,31,12,19,2,1
2,472,472,76,76,0,1,0

9,124,124,4,1,3,2,1
0,137,137,1,1,0,1,0
5,193,193,2,2,0,1,0
6,194,194,16,16,0,1,0
4,254,254,5,5,0,1,0
7,267,267,13,13,0,1,0
1,377,377,30,30,0,1,0
2,413,413,137,42,95,4,3
3,419,419,23,7,16,2,1
8,472,472,166,166,0,1,0

0,156,156,4,4,0,1,0
5,159,159,38,38,0,1,0
6,228,228,52,52,0,1,0
1,264,264,83,67,16,2,1
3,389,389,4,1,3,2,1
4,424,424,14,14,0,1,0
2,436,436,70,48,22,3,2

0,100,100,25,25,0,1,0
5,253,253,12,12,0,1,0
7,293,293,61,16,45,2,1
4,333,333,34,34,0,1,0
2,360,360,9,9,0,1,0
8,406,406,29,20,9,4,3
3,423,423,32,19,13,2,1
1,461,461,23,23,0,1,0
6,500,500,90,2,88,4,3

4,196,196,7,4,3,2,1
2,265,265,74,28,46,3,2
5,276,276,71,46,25,4,3
0,310,310,34,18,16,3,2
1,359,359,7,7,0,1,0
8,360,360,31,1,30,3,2
7,386,386,19,16,3,2,1
6,456,456,50,25,25,2,1
3,465,465,26,1,25,2,1

1,133,133,25,25,0,1,0
2,142,142,12,12,0,1,0
8,150,150,9,9,0,1,0
3,319,319,36,2,34,2,1
5,331,331,9,9,0,1,0
6,368,368,3,3,0,1,0
7,390,390,159,18,141,4,3
4,438,438,27,27,0,1,0
0,440,440,24,8,16,3,2

5,116,116,15,12,3,2,1
6,151,151,16,7,9,4,3
3,209,209,16,16,0,1,0
7,224,224,44,2,42,4,3
1,269,269,21,21,0,1,0
2,412,412,50,34,16,3,2
8,433,433,37,37,0,1,0
0,444,444,23,5,18,3,2
4,457,457,79,79,0,1,0

2,125,125,6,1,5,2,1
1,289,289,30,18,12,3,2
3,311,311,1,1,0,1,0
0,312,312,110,80,30,4,3
5,363,363,19,19,0,1,0
6,411,411,18,18,0,1,0
4,429,429,174,133,41,2,1

0,132,132,40,12,28,3,2
6,138,138,36,36,0,1,0
4,194,194,26,16,10,3,2
3,238,238,8,8,0,1,0
7,243,243,13,13,0,1,0
2,353,353,24,24,0,1,0
5,408,408,24,24,0,1,0
1,449,449,43,3,40,2,1

2,181,181,10,10,0,1,0
0,184,184,19,3,16,2,1
9,187,187,26,26,0,1,0
7,196,196,30,6,24,4,3
1,260,260,15,6,9,2,1
4,266,266,4,4,0,1,0
3,303,303,42,42,0,1,0
8,357,357,12,12,0,1,0
5,456,456,60,60,0,1,0
6,470,470,85,19,66,4,3

9,135,135,8,8,0,1,0
3,159,159,6,6,0,1,0
2,167,167,1,1,0,1,0
4,172,172,27,27,0,1,0
0,186,186,1,1,0,1,0
8,187,187,32,24,8,3,2
6,190,190,3,3,0,1,0
7,254,254,54,54,0,1,0
5,263,263,30,30,0,1,0
1,309,309,51,51,0,1,0
10,369,369,22,22,0,1,0

0,265,265,34,13,21,2,1
2,297,297,42,9,33,2,1
1,327,327,7,7,0,1,0
4,362,362,43,37,6,2,1
3,373,373,34,34,0,1,0
6,381,381,5,5,0,1,0
5,447,447,44,44,0,1,0
8,457,457,118,64,54,3,2
7,469,469,63,40,23,2,1

0,122,122,16,13,3,2,1
6,217,217,37,37,0,1,0
7,220,220,46,13,33,4,3
5,226,226,7,2,5,2,1
2,326,326,13,5,8,2,1
3,375,375,61,19,42,2,1
1,386,386,36,36,0,1,0
4,389,389,18,18,0,1,0
8,423,423,17,17,0,1,0
9,455,455,38,14,24,2,1

7,120,120,23,14,9,2,1
1,127,127,22,4,18,4,3
10,187,187,6,1,5,2,1
5,287,287,37,3,34,2,1
6,314,314,6,6,0,1,0
0,346,346,19,19,0,1,0
9,368,368,34,14,20,2,1
2,372,372,26,20,6,2,1
8,392,392,75,45,30,2,1
3,467,467,11,1,10,3,2
4,484,484,15,3,12,2,1

3,120,120,7,7,0,1,0
5,123,123,8,8,0,1,0
6,127,127,10,3,7,2,1
2,145,145,1,1,0,1,0
9,183,183,47,26,21,2,1
8,189,189,7,3,4,2,1
0,236,236,31,31,0,1,0
4,304,304,2,2,0,1,0
7,356,356,50,24,26,2,1
1,403,403,96,96,0,1,0

10,127,127,24,4,20,3,2
12,128,128,16,16,0,1,0
11,165,165,22,22,0,1,0
8,186,186,8,2,6,2,1
5,199,199,3,3,0,1,0
6,232,232,31,31,0,1,0
1,258,258,5,5,0,1,0
2,262,262,4,4,0,1,0
0,285,285,6,2,4,2,1
3,288,288,17,17,0,1,0
9,300,300,3,3,0,1,0
13,304,304,20,20,0,1,0
7,407,407,6,6,0,1,0
4,419,419,71,15,56,3,2

3,135,135,28,12,16,4,3
2,182,182,36,9,27,2,1
4,282,282,51,5,46,2,1
6,342,342,27,27,0,1,0
5,374,374,17,17,0,1,0
0,395,395,67,23,44,2,1
1,400,400,55,55,0,1,0

0,101,101,10,10,0,1,0
6,174,174,9,9,0,1,0
2,213,213,33,12,21,4,3
7,319,319,79,79,0,1,0
5,351,351,38,11,27,2,1
4,369,369,37,32,5,2,1
3,444,444,57,31,26,3,2
1,471,471,56,27,29,2,1

5,119,119,13,13,0,1,0
3,164,164,1,1,0,1,0
6,209,209,28,28,0,1,0
8,251,251,74,74,0,1,0
4,263,263,28,28,0,1,0
9,310,310,18,18,0,1,0
0,405,405,17,7,10,2,1
7,460,460,9,9,0,1,0
1,471,471,69,60,9,2,1
2,487,487,46,22,24,3,2

0,154,154,41,33,8,2,1
5,203,203,43,1,42,3,2
6,257,257,25,25,0,1,0
3,294,294,41,5,36,4,3
1,374,374,45,18,27,4,3
2,378,378,43,43,0,1,0
4,434,434,26,26,0,1,0

0,159,159,60,39,21,2,1
1,190,190,7,7,0,1,0
4,239,239,14,14,0,1,0
3,248,248,59,59,0,1,0
2,345,345,30,30,0,1,0
6,352,352,74,31,43,4,3
5,427,427,1,1,0,1,0

9,186,186,30,27,3,2,1
5,230,230,15,7,8,3,2
0,324,324,34,34,0,1,0
7,378,378,11,11,0,1,0
8,394,394,57,57,0,1,0
4,410,410,45,24,21,4,3
3,432,432,59,59,0,1,0
2,454,454,1,1,0,1,0
6,469,469,79,22,57,4,3
1,478,478,39,11,28,2,1

15,100,100,1,1,0,1,0
6,106,106,6,6,0,1,0
5,117,117,2,2,0,1,0
13,143,143,36,23,13,2,1
14,201,201,36,26,10,3,2
8,232,232,9,4,5,2,1
11,232,232,6,6,0,1,0
0,284,284,11,2,9,4,3
3,363,363,17,17,0,1,0
2,392,392,12,12,0,1,0
12,419,419,17,7,10,3,2
10,419,419,55,55,0,1,0
7,432,432,9,9,0,1,0
4,442,442,10,10,0,1,0
1,474,474,6,6,0,1,0
16,476,476,32,14,18,2,1
9,488,488,9,9,0,1,0

4,184,184,23,23,0,1,0
5,285,285,3,3,0,1,0
0,301,301,63,52,11,2,1
6,304,304,78,22,56,3,2
3,317,317,20,20,0,1,0
2,343,343,43,17,26,3,2
1,388,388,40,2,38,2,1
7,404,404,48,48,0,1,0

4,126,126,7,7,0,1,0
3,151,151,10,7,3,2,1
6,200,200,29,14,15,2,1
2,204,204,1,1,0,1,0
5,214,214,4,4,0,1,0
1,248,248,40,40,0,1,0
7,288,288,10,5,5,2,1
12,295,295,16,16,0,1,0
11,364,364,105,65,40,4,3
8,383,383,5,5,0,1,0
0,390,390,1,1,0,1,0
10,480,480,55,55,0,1,0
9,481,481,23,23,0,1,0

1,205,205,27,12,15,4,3
0,264,264,42,2,40,3,2
8,276,276,11,6,5,2,1
3,299,299,1,1,0,1,0
9,343,343,42,42,0,1,0
4,348,348,51,27,24,4,3
5,350,350,20,20,0,1,0
2,363,363,1,1,0,1,0
7,452,452,105,45,60,4,3
6,477,477,53,53,0,1,0

9,128,128,11,11,0,1,0
3,186,186,37,37,0,1,0
5,189,189,1,1,0,1,0
10,206,206,1,1,0,1,0
2,218,218,12,12,0,1,0
6,266,266,6,6,0,1,0
4,332,332,9,3,6,2,1
8,350,350,137,122,15,4,3
11,386,386,12,3,9,2,1
0,413,413,43,19,24,2,1
7,463,463,23,1,22,3,2
1,488,488,19,19,0,1,0

11,179,179,29,29,0,1,0
0,191,191,1,1,0,1,0
9,195,195,8,8,0,1,0
3,196,196,13,1,12,4,3
8,227,227,9,9,0,1,0
6,272,272,33,25,8,3,2
12,286,286,69,69,0,1,0
5,303,303,24,24,0,1,0
2,319,319,29,17,12,4,3
7,374,374,5,5,0,1,0
4,378,378,13,13,0,1,0
10,418,418,26,26,0,1,0
1,447,447,23,1,22,2,1

5,202,202,13,7,6,3,2
4,221,221,13,13,0,1,0
2,240,240,21,21,0,1,0
3,345,345,5,2,3,2,1
6,383,383,27,1,26,2,1
8,430,430,55,18,37,3,2
1,437,437,54,42,12,4,3
7,437,437,58,28,30,4,3
9,484,484,84,52,32,2,1
0,495,495,77,77,0,1,0

1,126,126,37,37,0,1,0
4,238,238,41,17,24,4,3
2,246,246,13,13,0,1,0
7,319,319,14,8,6,3,2
3,390,390,50,18,32,3,2
0,395,395,10,10,0,1,0
5,437,437,93,93,0,1,0
6,443,443,33,33,0,1,0

2,138,138,5,1,4,2,1
6,172,172,20,10,10,3,2
5,178,178,4,1,3,2,1
1,180,180,5,5,0,1,0
8,184,184,17,17,0,1,0
3,326,326,9,5,4,2,1
9,346,346,12,12,0,1,0
10,357,357,8,8,0,1,0
7,408,408,145,141,4,2,1
4,415,415,46,1,45,2,1
0,454,454,73,73,0,1,0

5,212,212,42,20,22,2,1
1,315,315,77,43,34,4,3
4,316,316,86,86,0,1,0
2,326,326,7,7,0,1,0
3,371,371,4,4,0,1,0
0,393,393,101,29,72,3,2

2,110,110,19,8,11,2,1
1,195,195,2,2,0,1,0
0,213,213,7,1,6,2,1
3,315,315,90,45,45,4,3
7,317,317,8,2,6,3,2
5,323,323,15,15,0,1,0
4,374,374,21,21,0,1,0
6,377,377,142,124,18,4,3

1,213,213,15,5,10,2,1
4,227,227,68,24,44,3,2
6,239,239,5,5,0,1,0
5,296,296,41,13,28,4,3
7,349,349,18,18,0,1,0
3,395,395,102,102,0,1,0
0,449,449,5,5,0,1,0
2,494,494,80,35,45,4,3

2,125,125,2,2,0,1,0
11,140,140,2,2,0,1,0
4,209,209,12,2,10,2,1
10,255,255,117,91,26,3,2
0,265,265,7,7,0,1,0
7,312,312,67,57,10,3,2
8,316,316,6,6,0,1,0
6,359,359,6,6,0,1,0
1,397,397,44,34,10,2,1
9,411,411,5,2,3,2,1
3,459,459,2,2,0,1,0
5,466,466,26,26,0,1,0

0,139,139,20,20,0,1,0
9,139,139,3,3,0,1,0
6,160,160,9,9,0,1,0
5,172,172,4,4,0,1,0
1,204,204,5,5,0,1,0
8,224,224,1,1,0,1,0
4,233,233,36,14,22,3,2
10,260,260,114,78,36,4,3
2,270,270,25,9,16,3,2
7,478,478,21,21,0,1,0
3,482,482,4,4,0,1,0

10,142,142,4,4,0,1,0
2,155,155,37,32,5,2,1
4,156,156,5,5,0,1,0
0,233,233,11,1,10,2,1
5,266,266,7,4,3,2,1
6,392,392,52,52,0,1,0
3,409,409,9,9,0,1,0
9,428,428,22,22,0,1,0
8,434,434,155,113,42,2,1
7,487,487,34,16,18,4,3
1,489,489,1,1,0,1,0

3,109,109,11,11,0,1,0
8,150,150,6,6,0,1,0
6,178,178,7,7,0,1,0
10,195,195,31,31,0,1,0
4,211,211,11,11,0,1,0
11,223,223,47,29,18,3,2
2,256,256,11,11,0,1,0
0,261,261,45,45,0,1,0
1,285,285,10,4,6,2,1
5,330,330,1,1,0,1,0
7,362,362,20,20,0,1,0
9,479,479,48,48,0,1,0

4,131,131,11,11,0,1,0
7,189,189,50,50,0,1,0
6,190,190,9,9,0,1,0
1,196,196,37,37,0,1,0
3,258,258,23,9,14,3,2
0,426,426,54,54,0,1,0
5,432,432,56,32,24,4,3
8,437,437,28,28,0,1,0
2,494,494,6,6,0,1,0

0,172,172,13,1,12,4,3
3,208,208,6,6,0,1,0
1,234,234,100,74,26,4,3
4,264,264,74,74,0,1,0
2,425,425,10,2,8,2,1
5,465,465,80,50,30,4,3

6,145,145,5,5,0,1,0
4,148,148,14,14,0,1,0
2,238,238,14,14,0,1,0
8,238,238,4,4,0,1,0
9,280,280,31,10,21,3,2
7,319,319,66,57,9,4,3
10,340,340,58,58,0,1,0
5,453,453,18,9,9,2,1
1,456,456,32,32,0,1,0
0,485,485,80,8,72,4,3
3,488,488,19,1,18,3,2

2,135,135,6,1,5,2,1
6,183,183,45,45,0,1,0
4,236,236,5,5,0,1,0
1,238,238,5,5,0,1,0
3,255,255,49,49,0,1,0
7,259,259,12,12,0,1,0
5,300,300,58,19,39,2,1
0,494,494,120,62,58,3,2

3,214,214,13,5,8,2,1
1,237,237,10,4,6,3,2
4,253,253,28,7,21,2,1
5,273,273,6,6,0,1,0
2,404,404,93,33,60,4,3
6,453,453,26,18,8,3,2
0,479,479,27,2,25,3,2
7,479,479,91,4,87,4,3
8,493,493,117,101,16,4,3

3,114,114,4,4,0,1,0
12,152,152,14,2,12,3,2
1,182,182,1,1,0,1,0
8,211,211,5,5,0,1,0
11,239,239,19,19,0,1,0
5,293,293,2,2,0,1,0
6,306,306,12,7,5,2,1
2,331,331,96,96,0,1,0
9,333,333,80,40,40,2,1
10,336,336,33,33,0,1,0
4,391,391,24,18,6,3,2
0,397,397,14,14,0,1,0
7,449,449,2,2,0,1,0

4,197,197,9,5,4,2,1
1,285,285,3,3,0,1,0
7,363,363,61,61,0,1,0
5,388,388,74,37,37,4,3
2,393,393,65,8,57,4,3
0,397,397,79,79,0,1,0
3,430,430,35,35,0,1,0
6,430,430,14,5,9,4,3
8,489,489,56,56,0,1,0

0,117,117,9,6,3,2,1
4,120,120,11,5,6,3,2
3,126,126,18,6,12,2,1
2,132,132,15,15,0,1,0
5,354,354,44,44,0,1,0
7,371,371,90,61,29,4,3
6,373,373,45,45,0,1,0
1,427,427,35,25,10,3,2
8,439,439,9,9,0,1,0

1,134,134,23,23,0,1,0
8,168,168,1,1,0,1,0
5,178,178,7,7,0,1,0
0,185,185,5,1,4,2,1
9,186,186,11,2,9,4,3
10,239,239,65,14,51,4,3
3,314,314,12,2,10,2,1
12,327,327,27,3,24,4,3
11,350,350,27,27,0,1,0
2,358,358,17,17,0,1,0
13,360,360,27,27,0,1,0
4,403,403,23,2,21,2,1
7,413,413,13,2,11,2,1
6,461,461,12,12,0,1,0

1,150,150,7,1,6,2,1
8,184,184,49,20,29,2,1
3,200,200,66,66,0,1,0
7,259,259,27,27,0,1,0
5,268,268,29,8,21,4,3
4,379,379,15,7,8,2,1
6,458,458,14,5,9,3,2
0,481,481,16,7,9,2,1
2,489,489,25,25,0,1,0

2,237,237,9,9,0,1,0
6,288,288,85,85,0,1,0
5,297,297,5,5,0,1,0
3,331,331,24,24,0,1,0
0,424,424,109,67,42,4,3
4,448,448,54,54,0,1,0
1,471,471,98,98,0,1,0

2,147,147,9,9,0,1,0
5,216,216,46,46,0,1,0
4,239,239,17,11,6,2,1
3,244,244,16,11,5,2,1
0,248,248,67,67,0,1,0
7,301,301,18,18,0,1,0
1,407,407,43,7,36,4,3
6,457,457,75,5,70,4,3

4,118,118,5,5,0,1,0
2,150,150,9,9,0,1,0
3,164,164,3,3,0,1,0
0,176,176,14,9,5,2,1
7,183,183,4,4,0,1,0
10,338,338,6,6,0,1,0
1,410,410,38,38,0,1,0
5,426,426,12,6,6,2,1
6,431,431,78,78,0,1,0
9,443,443,133,86,47,2,1
8,449,449,76,76,0,1,0

5,133,133,14,2,12,2,1
8,154,154,21,21,0,1,0
3,213,213,14,14,0,1,0
1,266,266,32,16,16,3,2
2,275,275,28,5,23,2,1
4,288,288,6,6,0,1,0
0,289,289,56,25,31,2,1
6,323,323,23,23,0,1,0
7,374,374,72,28,44,2,1

8,119,119,41,41,0,1,0
1,188,188,6,6,0,1,0
6,235,235,2,2,0,1,0
4,260,260,14,14,0,1,0
0,268,268,1,1,0,1,0
3,454,454,103,93,10,3,2
2,455,455,84,60,24,4,3
5,485,485,23,23,0,1,0
7,500,500,53,13,40,2,1

0,180,180,9,9,0,1,0
10,191,191,11,11,0,1,0
8,218,218,45,27,18,3,2
12,282,282,14,4,10,3,2
6,285,285,1,1,0,1,0
11,323,323,54,54,0,1,0
3,349,349,23,23,0,1,0
7,373,373,1,1,0,1,0
2,391,391,38,6,32,3,2
5,391,391,18,6,12,3,2
9,455,455,105,13,92,3,2
1,486,486,6,6,0,1,0
4,489,489,9,3,6,3,2

0,128,128,31,5,26,2,1
3,149,149,3,3,0,1,0
1,164,164,7,4,3,2,1
2,237,237,51,51,0,1,0
4,291,291,49,38,11,2,1
6,336,336,35,35,0,1,0
5,449,449,97,97,0,1,0

4,123,123,1,1,0,1,0
6,129,129,36,27,9,4,3
7,149,149,7,2,5,2,1
2,196,196,9,9,0,1,0
1,199,199,3,3,0,1,0
0,242,242,43,43,0,1,0
5,264,264,14,5,9,2,1
3,322,322,65,20,45,2,1
8,430,430,34,34,0,1,0
9,436,436,47,7,40,3,2

3,144,144,21,17,4,2,1
6,281,281,3,3,0,1,0
7,292,292,14,14,0,1,0
2,339,339,26,26,0,1,0
1,370,370,17,17,0,1,0
0,416,416,16,16,0,1,0
4,435,435,84,84,0,1,0
8,468,468,80,80,0,1,0
5,469,469,131,36,95,4,3

1,108,108,1,1,0,1,0
4,120,120,7,2,5,2,1
9,155,155,5,5,0,1,0
8,160,160,66,11,55,4,3
0,204,204,22,22,0,1,0
5,258,258,3,3,0,1,0
2,324,324,75,36,39,4,3
7,347,347,7,1,6,2,1
3,386,386,32,24,8,3,2
6,473,473,21,11,10,2,1

2,128,128,11,3,8,3,2
4,160,160,45,8,37,4,3
0,186,186,43,43,0,1,0
3,219,219,11,11,0,1,0
1,223,223,60,60,0,1,0
5,240,240,24,8,16,2,1

6,299,299,62,35,27,2,1
2,336,336,13,13,0,1,0
4,357,357,71,71,0,1,0
5,400,400,28,14,14,2,1
0,445,445,23,11,12,2,1
3,446,446,13,5,8,2,1
1,485,485,200,176,24,2,1

4,144,144,3,3,0,1,0
1,156,156,51,51,0,1,0
0,187,187,12,12,0,1,0
6,240,240,20,20,0,1,0
7,273,273,93,93,0,1,0
5,353,353,23,8,15,4,3
2,359,359,11,6,5,2,1
3,468,468,37,18,19,2,1

6,174,174,32,5,27,2,1
5,230,230,41,17,24,3,2
4,269,269,12,12,0,1,0
0,329,329,46,23,23,2,1
3,360,360,38,10,28,3,2
2,398,398,22,22,0,1,0
1,481,481,147,147,0,1,0

3,189,189,5,1,4,2,1
0,265,265,36,36,0,1,0
1,271,271,99,99,0,1,0
5,302,302,20,20,0,1,0
2,351,351,60,47,13,2,1
4,366,366,90,3,87,4,3

5,118,118,6,1,5,2,1
1,172,172,1,1,0,1,0
10,178,178,14,14,0,1,0
9,196,196,15,15,0,1,0
3,208,208,25,25,0,1,0
8,267,267,85,28,57,4,3
7,309,309,12,4,8,3,2
2,327,327,40,1,39,4,3
0,350,350,38,38,0,1,0
6,442,442,33,3,30,4,3
4,478,478,9,9,0,1,0

7,107,107,2,2,0,1,0
8,177,177,11,11,0,1,0
3,179,179,26,21,5,2,1
4,373,373,38,38,0,1,0
1,399,399,39,3,36,3,2
0,409,409,58,58,0,1,0
5,438,438,131,5,126,4,3
6,450,450,60,36,24,4,3
2,500,500,7,7,0,1,0

10,112,112,11,11,0,1,0
9,145,145,7,7,0,1,0
7,154,154,8,8,0,1,0
5,155,155,1,1,0,1,0
3,165,165,25,25,0,1,0
0,168,168,8,3,5,2,1
6,173,173,25,5,20,3,2
2,196,196,11,11,0,1,0
1,241,241,3,3,0,1,0
4,400,400,34,1,33,2,1
8,468,468,148,108,40,2,1

1,162,162,3,3,0,1,0
8,200,200,44,44,0,1,0
3,237,237,65,65,0,1,0
6,304,304,21,6,15,4,3
2,423,423,12,12,0,1,0
0,436,436,18,18,0,1,0
7,440,440,22,22,0,1,0
4,451,451,63,30,33,2,1
5,487,487,81,37,44,4,3

0,115,115,2,2,0,1,0
9,134,134,5,5,0,1,0
4,153,153,10,4,6,3,2
3,219,219,7,7,0,1,0
7,274,274,22,12,10,2,1
8,302,302,27,5,22,2,1
1,312,312,5,5,0,1,0
11,382,382,112,14,98,3,2
5,465,465,38,38,0,1,0
6,473,473,47,47,0,1,0
12,483,483,12,12,0,1,0
10,486,486,73,1,72,3,2
2,491,491,10,4,6,2,1

3,124,124,3,3,0,1,0
5,161,161,13,13,0,1,0
8,244,244,6,6,0,1,0
1,246,246,57,57,0,1,0
6,283,283,58,16,42,4,3
4,290,290,13,4,9,4,3
0,301,301,3,3,0,1,0
2,474,474,90,90,0,1,0
7,494,494,98,59,39,4,3

5,158,158,14,11,3,2,1
1,175,175,28,28,0,1,0
0,179,179,20,4,16,2,1
2,244,244,7,7,0,1,0
3,292,292,8,8,0,1,0
4,294,294,22,22,0,1,0
6,379,379,4,4,0,1,0
8,446,446,22,1,21,2,1
7,464,464,14,5,9,2,1
10,489,489,17,14,3,2,1
9,491,491,191,93,98,3,2

5,132,132,25,21,4,2,1
0,171,171,63,63,0,1,0
6,297,297,5,5,0,1,0
1,308,308,15,15,0,1,0
4,322,322,66,37,29,2,1
2,381,381,32,11,21,2,1
3,431,431,44,44,0,1,0

4,103,103,12,7,5,2,1
2,150,150,8,5,3,2,1
10,158,158,4,4,0,1,0
1,200,200,5,5,0,1,0
5,239,239,19,19,0,1,0
3,254,254,29,2,27,2,1
9,276,276,3,3,0,1,0
0,352,352,15,15,0,1,0
7,360,360,117,92,25,2,1
8,402,402,60,18,42,2,1
6,443,443,31,31,0,1,0

3,223,223,11,2,9,2,1
0,290,290,57,33,24,4,3
4,363,363,67,57,10,3,2
2,376,376,67,34,33,3,2
5,450,450,42,42,0,1,0
1,496,496,151,61,90,4,3

0,147,147,15,1,14,3,2
6,166,166,27,19,8,3,2
7,223,223,67,47,20,2,1
1,309,309,1,1,0,1,0
3,327,327,23,23,0,1,0
4,338,338,52,52,0,1,0
2,364,364,33,25,8,3,2
5,366,366,30,30,0,1,0
9,383,383,12,12,0,1,0
8,482,482,6,6,0,1,0

7,166,166,54,54,0,1,0
6,177,177,2,2,0,1,0
2,224,224,19,1,18,4,3
3,248,248,16,16,0,1,0
8,248,248,29,29,0,1,0
0,260,260,53,53,0,1,0
5,276,276,22,22,0,1,0
4,308,308,14,9,5,2,1
1,423,423,6,6,0,1,0
9,436,436,13,4,9,4,3
10,438,438,14,14,0,1,0

2,113,113,7,7,0,1,0
6,268,268,14,8,6,3,2
7,337,337,40,40,0,1,0
3,361,361,4,4,0,1,0
8,363,363,89,89,0,1,0
1,402,402,125,80,45,2,1
0,407,407,32,26,6,2,1
5,472,472,43,19,24,4,3
4,490,490,19,1,18,2,1

14,135,135,1,1,0,1,0
3,137,137,5,1,4,2,1
0,140,140,2,2,0,1,0
10,206,206,24,3,21,4,3
5,261,261,25,7,18,2,1
12,280,280,57,57,0,1,0
1,323,323,6,6,0,1,0
13,326,326,38,4,34,2,1
8,327,327,24,24,0,1,0
6,384,384,2,2,0,1,0
11,384,384,71,71,0,1,0
4,418,418,2,2,0,1,0
9,424,424,1,1,0,1,0
2,426,426,31,31,0,1,0
7,482,482,31,31,0,1,0

9,103,103,3,3,0,1,0
6,129,129,10,10,0,1,0
3,137,137,5,5,0,1,0
7,200,200,40,40,0,1,0
0,292,292,4,4,0,1,0
1,299,299,49,49,0,1,0
5,319,319,12,7,5,2,1
2,323,323,61,61,0,1,0
4,327,327,20,6,14,3,2
8,427,427,91,91,0,1,0

10,119,119,17,9,8,3,2
5,153,153,7,2,5,2,1
7,160,160,27,3,24,2,1
4,222,222,3,3,0,1,0
1,273,273,3,3,0,1,0
8,344,344,24,6,18,2,1
0,349,349,53,15,38,3,2
9,403,403,49,16,33,4,3
2,404,404,83,54,29,2,1
6,435,435,2,2,0,1,0
3,481,481,33,33,0,1,0

10,104,104,20,14,6,3,2
2,149,149,29,22,7,2,1
8,211,211,1,1,0,1,0
4,264,264,7,7,0,1,0
3,299,299,27,3,24,3,2
0,361,361,1,1,0,1,0
1,382,382,15,3,12,3,2
7,405,405,82,82,0,1,0
6,420,420,19,19,0,1,0
9,440,440,48,5,43,4,3
5,485,485,50,25,25,2,1

6,146,146,18,8,10,3,2
3,246,246,7,7,0,1,0
1,247,247,25,1,24,3,2
4,312,312,37,15,22,3,2
5,327,327,77,25,52,3,2
2,488,488,126,126,0,1,0
0,496,496,70,62,8,2,1

0,189,189,19,1,18,2,1
4,270,270,31,31,0,1,0
1,333,333,6,6,0,1,0
7,341,341,70,70,0,1,0
6,342,342,51,51,0,1,0
3,383,383,130,72,58,4,3
5,416,416,16,16,0,1,0
2,474,474,20,20,0,1,0

0,122,122,32,25,7,2,1
7,204,204,50,50,0,1,0
4,220,220,23,23,0,1,0
6,231,231,10,10,0,1,0
3,238,238,30,26,4,2,1
1,295,295,28,28,0,1,0
2,404,404,7,7,0,1,0
5,491,491,55,37,18,4,3

5,177,177,13,13,0,1,0
2,205,205,35,11,24,2,1
6,224,224,18,9,9,4,3
1,261,261,28,1,27,3,2
0,291,291,21,21,0,1,0
8,306,306,53,53,0,1,0
3,318,318,2,2,0,1,0
7,471,471,84,84,0,1,0
4,496,496,72,72,0,1,0

0,268,268,100,13,87,4,3
1,293,293,38,38,0,1,0
2,308,308,31,24,7,2,1
5,365,365,13,13,0,1,0
4,468,468,132,107,25,2,1
3,492,492,43,11,32,2,1

8,132,132,26,26,0,1,0
0,148,148,12,12,0,1,0
4,156,156,10,1,9,3,2
9,173,173,37,7,30,2,1
3,203,203,16,16,0,1,0
7,329,329,8,5,3,2,1
5,399,399,9,2,7,2,1
2,419,419,25,25,0,1,0
6,434,434,33,23,10,2,1
1,458,458,89,89,0,1,0

6,109,109,7,7,0,1,0
2,144,144,39,39,0,1,0
8,148,148,13,4,9,2,1
4,203,203,5,5,0,1,0
10,259,259,62,14,48,4,3
1,376,376,10,7,3,2,1
9,405,405,25,25,0,1,0
3,441,441,1,1,0,1,0
11,441,441,54,54,0,1,0
5,461,461,5,2,3,2,1
0,464,464,25,25,0,1,0
7,492,492,23,7,16,3,2

7,146,146,22,9,13,2,1
6,228,228,80,8,72,4,3
9,266,266,1,1,0,1,0
3,304,304,40,40,0,1,0
5,369,369,16,10,6,3,2
4,382,382,3,3,0,1,0
2,444,444,15,15,0,1,0
8,474,474,2,2,0,1,0
0,477,477,115,115,0,1,0
1,480,480,21,10,11,2,1

3,197,197,1,1,0,1,0
0,206,206,1,1,0,1,0
1,223,223,28,11,17,4,3
6,231,231,75,10,65,4,3
7,302,302,11,3,8,3,2
5,394,394,27,27,0,1,0
4,422,422,33,21,12,4,3
2,494,494,182,167,15,2,1

9,211,211,18,18,0,1,0
6,214,214,7,7,0,1,0
5,270,270,5,5,0,1,0
2,290,290,68,68,0,1,0
0,295,295,23,4,19,2,1
4,302,302,33,15,18,3,2
7,316,316,90,3,87,4,3
8,317,317,33,33,0,1,0
1,461,461,23,20,3,2,1
3,480,480,6,6,0,1,0

11,112,112,20,20,0,1,0
8,156,156,32,32,0,1,0
3,214,214,7,1,6,3,2
9,214,214,23,23,0,1,0
1,281,281,12,12,0,1,0
0,312,312,5,5,0,1,0
7,315,315,63,19,44,4,3
6,367,367,30,30,0,1,0
5,381,381,20,20,0,1,0
10,401,401,8,8,0,1,0
2,446,446,23,23,0,1,0
4,468,468,12,12,0,1,0

2,135,135,6,6,0,1,0
1,237,237,67,67,0,1,0
7,247,247,40,7,33,4,3
5,363,363,64,58,6,2,1
6,379,379,50,50,0,1,0
3,405,405,2,2,0,1,0
4,437,437,16,13,3,2,1
0,469,469,79,30,49,4,3

4,150,150,14,6,8,2,1
1,218,218,3,3,0,1,0
2,226,226,19,15,4,2,1
9,234,234,6,2,4,2,1
8,279,279,35,7,28,3,2
7,291,291,12,12,0,1,0
10,320,320,8,1,7,2,1
6,355,355,6,6,0,1,0
12,366,366,126,40,86,3,2
13,379,379,51,51,0,1,0
11,439,439,1,1,0,1,0
5,458,458,19,19,0,1,0
0,462,462,27,27,0,1,0
3,491,491,1,1,0,1,0

0,192,192,40,40,0,1,0
2,193,193,5,5,0,1,0
5,195,195,55,55,0,1,0
3,240,240,52,52,0,1,0
4,244,244,8,8,0,1,0
6,269,269,47,47,0,1,0
8,311,311,12,4,8,2,1
1,410,410,7,7,0,1,0
7,435,435,6,3,3,2,1

2,107,107,15,15,0,1,0
4,280,280,76,71,5,2,1
5,293,293,14,11,3,2,1
3,321,321,19,19,0,1,0
6,370,370,19,11,8,3,2
8,379,379,141,88,53,3,2
1,380,380,9,9,0,1,0
0,469,469,4,4,0,1,0
7,499,499,18,18,0,1,0

8,144,144,5,1,4,2,1
11,173,173,36,36,0,1,0
2,221,221,5,5,0,1,0
12,296,296,32,22,10,2,1
9,362,362,14,6,8,2,1
4,386,386,14,6,8,2,1
0,402,402,19,10,9,2,1
3,413,413,12,12,0,1,0
5,420,420,72,72,0,1,0
7,427,427,4,4,0,1,0
1,435,435,5,5,0,1,0
10,447,447,76,61,15,2,1
6,452,452,46,13,33,4,3
13,469,469,9,9,0,1,0

1,126,126,19,19,0,1,0
9,234,234,12,12,0,1,0
10,234,234,47,38,9,4,3
0,308,308,23,11,12,3,2
2,340,340,31,16,15,4,3
8,364,364,55,55,0,1,0
5,366,366,12,3,9,4,3
4,377,377,1,1,0,1,0
7,382,382,38,38,0,1,0
6,385,385,31,17,14,3,2
3,397,397,27,1,26,2,1

2,258,258,29,29,0,1,0
0,275,275,127,127,0,1,0
4,306,306,33,18,15,4,3
5,316,316,21,21,0,1,0
3,345,345,75,1,74,3,2
1,452,452,18,9,9,2,1

7,160,160,45,33,12,3,2
1,164,164,13,13,0,1,0
6,185,185,30,16,14,4,3
4,200,200,7,7,0,1,0
2,265,265,79,10,69,4,3
0,309,309,10,10,0,1,0
5,359,359,10,10,0,1,0
3,494,494,45,45,0,1,0

2,177,177,7,7,0,1,0
9,197,197,14,14,0,1,0
3,198,198,1,1,0,1,0
0,279,279,35,35,0,1,0
7,303,303,3,3,0,1,0
11,328,328,76,2,74,4,3
8,394,394,24,4,20,2,1
12,396,396,36,30,6,2,1
5,419,419,10,10,0,1,0
6,419,419,47,47,0,1,0
10,452,452,51,51,0,1,0
1,481,481,58,58,0,1,0
4,485,485,2,2,0,1,0

8,135,135,30,2,28,4,3
0,171,171,13,1,12,2,1
5,224,224,39,22,17,2,1
9,271,271,41,41,0,1,0
10,279,279,19,19,0,1,0
3,280,280,12,12,0,1,0
1,324,324,7,7,0,1,0
7,328,328,23,2,21,2,1
2,332,332,26,8,18,4,3
4,349,349,29,29,0,1,0
6,386,386,10,10,0,1,0

5,172,172,11,6,5,2,1
7,267,267,18,18,0,1,0
9,268,268,24,6,18,2,1
10,318,318,4,4,0,1,0
4,329,329,61,1,60,3,2
6,334,334,27,12,15,4,3
0,420,420,23,23,0,1,0
2,420,420,19,19,0,1,0
1,449,449,7,7,0,1,0
8,453,453,153,102,51,4,3
3,496,496,28,18,10,3,2

7,102,102,1,1,0,1,0
9,235,235,12,6,6,2,1
1,264,264,45,45,0,1,0
8,285,285,32,32,0,1,0
0,351,351,7,7,0,1,0
4,371,371,1,1,0,1,0
5,380,380,7,1,6,3,2
12,388,388,61,50,11,2,1
2,391,391,4,1,3,2,1
6,436,436,60,1,59,3,2
10,459,459,134,32,102,4,3
11,479,479,2,2,0,1,0
3,493,493,10,10,0,1,0

5,165,165,26,26,0,1,0
3,195,195,9,9,0,1,0
4,233,233,14,14,0,1,0
1,239,239,73,73,0,1,0
7,253,253,22,22,0,1,0
6,376,376,48,10,38,3,2
2,403,403,16,16,0,1,0
0,460,460,24,24,0,1,0
8,496,496,66,66,0,1,0

4,157,157,5,5,0,1,0
7,260,260,36,5,31,2,1
2,270,270,1,1,0,1,0
1,373,373,39,39,0,1,0
5,375,375,59,50,9,2,1
10,407,407,56,35,21,4,3
0,447,447,8,8,0,1,0
3,451,451,36,36,0,1,0
8,459,459,29,14,15,2,1
9,469,469,78,27,51,3,2
6,495,495,52,52,0,1,0

1,134,134,33,33,0,1,0
5,135,135,21,21,0,1,0
4,163,163,24,3,21,3,2
2,410,410,75,75,0,1,0
0,449,449,114,44,70,3,2
3,450,450,12,12,0,1,0

6,139,139,23,20,3,2,1
7,148,148,3,3,0,1,0
0,239,239,41,1,40,3,2
2,287,287,47,47,0,1,0
4,357,357,17,17,0,1,0
5,404,404,112,58,54,3,2
1,412,412,25,25,0,1,0
3,486,486,51,51,0,1,0

5,153,153,17,17,0,1,0
0,212,212,8,8,0,1,0
7,231,231,1,1,0,1,0
8,258,258,6,6,0,1,0
10,298,298,38,38,0,1,0
3,357,357,13,13,0,1,0
1,366,366,57,57,0,1,0
6,369,369,34,34,0,1,0
9,380,380,74,74,0,1,0
11,392,392,62,62,0,1,0
2,418,418,19,1,18,2,1
4,436,436,9,9,0,1,0

5,129,129,15,15,0,1,0
4,130,130,30,2,28,2,1
3,224,224,18,18,0,1,0
2,282,282,27,27,0,1,0
1,319,319,128,128,0,1,0
0,342,342,2,2,0,1,0
6,387,387,34,34,0,1,0

8,109,109,6,6,0,1,0
0,118,118,3,3,0,1,0
6,125,125,47,47,0,1,0
3,257,257,6,2,4,2,1
5,301,301,73,43,30,4,3
1,309,309,21,21,0,1,0
4,322,322,30,9,21,2,1
7,347,347,26,16,10,2,1
9,459,459,5,5,0,1,0
2,477,477,24,24,0,1,0

2,192,192,1,1,0,1,0
4,268,268,58,39,19,2,1
7,339,339,24,19,5,2,1
6,353,353,14,6,8,2,1
3,368,368,11,4,7,2,1
0,437,437,56,8,48,3,2
1,444,444,54,28,26,3,2
8,452,452,114,114,0,1,0
5,456,456,65,5,60,4,3

7,115,115,14,14,0,1,0
3,138,138,10,2,8,2,1
6,185,185,7,7,0,1,0
8,232,232,28,2,26,2,1
4,255,255,11,3,8,2,1
1,276,276,25,15,10,3,2
2,372,372,9,9,0,1,0
0,457,457,84,75,9,4,3
9,467,467,107,75,32,2,1
5,485,485,42,2,40,4,3

6,130,130,4,4,0,1,0
8,142,142,2,2,0,1,0
13,153,153,6,6,0,1,0
3,180,180,28,28,0,1,0
9,194,194,18,8,10,3,2
11,253,253,52,52,0,1,0
12,309,309,71,40,31,2,1
4,313,313,7,7,0,1,0
10,342,342,11,11,0,1,0
1,387,387,6,1,5,2,1
5,401,401,37,13,24,4,3
7,405,405,8,5,3,2,1
2,427,427,24,24,0,1,0
0,443,443,1,1,0,1,0

4,218,218,7,7,0,1,0
5,225,225,25,25,0,1,0
6,234,234,44,44,0,1,0
8,284,284,25,25,0,1,0
9,314,314,32,24,8,3,2
1,347,347,60,26,34,3,2
2,416,416,28,12,16,3,2
0,435,435,38,38,0,1,0
3,478,478,14,1,13,4,3
7,494,494,64,64,0,1,0

6,131,131,3,3,0,1,0
4,138,138,3,3,0,1,0
3,187,187,25,25,0,1,0
5,187,187,40,40,0,1,0
7,189,189,61,61,0,1,0
2,229,229,9,2,7,2,1
8,243,243,31,8,23,2,1
10,371,371,10,1,9,4,3
9,387,387,12,12,0,1,0
0,434,434,7,7,0,1,0
1,493,493,27,27,0,1,0

1,162,162,32,2,30,3,2
3,219,219,4,4,0,1,0
8,279,279,54,7,47,2,1
9,361,361,16,3,13,4,3
2,368,368,1,1,0,1,0
4,423,423,6,6,0,1,0
7,433,433,48,48,0,1,0
0,449,449,50,35,15,4,3
6,452,452,71,71,0,1,0
5,458,458,72,72,0,1,0

3,100,100,23,23,0,1,0
8,160,160,17,5,12,3,2
5,166,166,43,21,22,2,1
0,174,174,22,22,0,1,0
4,275,275,13,1,12,2,1
2,292,292,28,28,0,1,0
6,407,407,45,45,0,1,0
1,493,493,1,1,0,1,0
7,495,495,15,15,0,1,0

5,135,135,4,4,0,1,0
8,136,136,13,13,0,1,0
0,152,152,52,40,12,4,3
9,166,166,52,52,0,1,0
2,206,206,8,8,0,1,0
6,217,217,21,21,0,1,0
7,232,232,1,1,0,1,0
4,243,243,16,16,0,1,0
1,416,416,9,9,0,1,0
3,488,488,4,4,0,1,0

4,107,107,9,3,6,3,2
6,167,167,56,56,0,1,0
2,240,240,12,12,0,1,0
9,288,288,14,14,0,1,0
0,355,355,12,4,8,2,1
5,370,370,93,55,38,4,3
7,370,370,19,7,12,4,3
8,377,377,27,18,9,2,1
1,402,402,22,1,21,4,3
3,489,489,14,4,10,3,2

11,115,115,12,12,0,1,0
9,116,116,28,15,13,2,1
6,153,153,8,1,7,2,1
3,168,168,13,5,8,2,1
2,231,231,5,5,0,1,0
0,289,289,18,8,10,2,1
7,330,330,9,9,0,1,0
1,388,388,8,2,6,2,1
8,454,454,5,5,0,1,0
4,468,468,70,20,50,3,2
10,468,468,70,40,30,2,1
5,481,481,44,44,0,1,0

1,107,107,1,1,0,1,0
9,145,145,3,3,0,1,0
3,167,167,5,1,4,2,1
11,188,188,10,10,0,1,0
8,233,233,15,6,9,4,3
6,274,274,28,28,0,1,0
4,316,316,33,24,9,4,3
12,344,344,5,5,0,1,0
10,356,356,45,42,3,2,1
0,369,369,19,10,9,4,3
2,416,416,9,9,0,1,0
5,453,453,30,30,0,1,0
7,484,484,16,16,0,1,0
13,499,499,155,131,24,3,2

7,188,188,6,6,0,1,0
2,263,263,4,4,0,1,0
9,288,288,102,87,15,4,3
0,292,292,68,39,29,2,1
8,322,322,22,1,21,2,1
1,354,354,60,46,14,2,1
3,397,397,24,10,14,2,1
5,433,433,9,9,0,1,0
6,475,475,25,25,0,1,0
4,498,498,1,1,0,1,0

5,110,110,26,26,0,1,0
7,170,170,24,19,5,2,1
4,171,171,12,3,9,2,1
1,296,296,29,29,0,1,0
3,296,296,39,19,20,2,1
6,320,320,21,1,20,3,2
2,439,439,68,68,0,1,0
0,451,451,53,53,0,1,0

5,124,124,3,3,0,1,0
3,169,169,7,7,0,1,0
8,169,169,10,10,0,1,0
10,176,176,8,8,0,1,0
7,200,200,14,10,4,2,1
6,229,229,7,7,0,1,0
1,252,252,14,14,0,1,0
2,287,287,12,2,10,2,1
11,314,314,55,55,0,1,0
9,334,334,13,13,0,1,0
4,405,405,5,5,0,1,0
12,438,438,109,59,50,2,1
0,444,444,75,20,55,3,2

3,165,165,28,8,20,3,2
2,231,231,22,22,0,1,0
4,239,239,32,23,9,4,3
7,239,239,4,4,0,1,0
1,318,318,61,31,30,4,3
5,337,337,72,23,49,2,1
0,361,361,17,9,8,2,1
6,422,422,60,30,30,3,2

1,132,132,13,3,10,2,1
3,132,132,36,27,9,4,3
4,264,264,45,13,32,3,2
0,270,270,14,14,0,1,0
7,282,282,8,8,0,1,0
2,322,322,27,27,0,1,0
6,370,370,88,88,0,1,0
5,453,453,32,12,20,3,2

4,100,100,3,3,0,1,0
7,104,104,11,1,10,3,2
2,138,138,6,6,0,1,0
6,268,268,12,12,0,1,0
0,281,281,12,12,0,1,0
8,283,283,1,1,0,1,0
5,303,303,1,1,0,1,0
11,318,318,54,54,0,1,0
1,320,320,5,2,3,2,1
3,337,337,75,75,0,1,0
10,459,459,39,5,34,3,2
9,464,464,115,106,9,4,3

4,126,126,23,5,18,4,3
5,165,165,1,1,0,1,0
9,221,221,50,50,0,1,0
10,235,235,20,20,0,1,0
6,239,239,2,2,0,1,0
1,269,269,16,5,11,2,1
3,341,341,23,23,0,1,0
0,371,371,32,32,0,1,0
8,407,407,10,10,0,1,0
2,441,441,41,41,0,1,0
7,491,491,84,84,0,1,0

7,157,157,5,5,0,1,0
2,168,168,12,12,0,1,0
5,189,189,15,5,10,2,1
0,203,203,19,13,6,2,1
3,211,211,36,4,32,3,2
6,364,364,130,80,50,2,1
4,404,404,16,7,9,2,1
1,441,441,74,74,0,1,0

0,158,158,20,12,8,2,1
8,158,158,1,1,0,1,0
5,178,178,8,3,5,2,1
7,232,232,5,5,0,1,0
6,258,258,14,14,0,1,0
10,277,277,10,10,0,1,0
2,289,289,10,7,3,2,1
1,352,352,14,14,0,1,0
3,361,361,20,4,16,2,1
4,441,441,55,7,48,4,3
11,445,445,152,77,75,4,3
9,497,497,62,62,0,1,0

10,153,153,12,12,0,1,0
1,237,237,9,9,0,1,0
8,242,242,16,16,0,1,0
0,252,252,42,9,33,4,3
4,269,269,16,10,6,3,2
2,295,295,9,9,0,1,0
6,325,325,27,27,0,1,0
9,367,367,39,39,0,1,0
7,397,397,101,92,9,4,3
5,408,408,39,39,0,1,0
3,414,414,12,12,0,1,0

0,130,130,3,3,0,1,0
6,196,196,8,1,7,2,1
10,264,264,30,30,0,1,0
1,265,265,7,1,6,2,1
2,278,278,30,30,0,1,0
5,279,279,40,30,10,3,2
9,288,288,40,1,39,2,1
8,369,369,70,64,6,3,2
4,386,386,12,9,3,2,1
3,408,408,52,1,51,4,3
7,484,484,30,8,22,2,1

3,195,195,6,6,0,1,0
0,226,226,3,3,0,1,0
2,238,238,34,28,6,3,2
5,264,264,45,45,0,1,0
6,285,285,87,81,6,2,1
1,391,391,136,82,54,3,2
4,410,410,1,1,0,1,0

0,175,175,25,7,18,4,3
6,289,289,4,4,0,1,0
2,356,356,1,1,0,1,0
1,371,371,22,22,0,1,0
3,372,372,64,48,16,3,2
7,384,384,12,2,10,3,2
4,386,386,48,10,38,3,2
8,442,442,52,52,0,1,0
5,481,481,165,88,77,4,3

5,113,113,8,8,0,1,0
3,135,135,1,1,0,1,0
9,148,148,1,1,0,1,0
0,172,172,3,3,0,1,0
2,251,251,52,52,0,1,0
1,260,260,12,12,0,1,0
4,273,273,11,6,5,2,1
10,290,290,63,28,35,4,3
6,297,297,33,33,0,1,0
7,333,333,31,31,0,1,0
8,357,357,70,35,35,2,1

7,112,112,15,15,0,1,0
12,167,167,28,28,0,1,0
4,175,175,3,3,0,1,0
3,188,188,10,5,5,2,1
1,192,192,15,15,0,1,0
5,228,228,22,22,0,1,0
10,286,286,19,19,0,1,0
2,303,303,28,4,24,4,3
9,325,325,17,4,13,2,1
0,338,338,2,2,0,1,0
6,396,396,1,1,0,1,0
8,429,429,9,9,0,1,0
11,483,483,107,107,0,1,0

9,131,131,33,33,0,1,0
5,132,132,16,12,4,2,1
6,151,151,6,6,0,1,0
2,163,163,10,10,0,1,0
8,195,195,42,21,21,2,1
0,233,233,49,15,34,3,2
10,234,234,8,8,0,1,0
1,271,271,1,1,0,1,0
7,329,329,4,4,0,1,0
3,371,371,16,16,0,1,0
4,429,429,11,11,0,1,0

4,132,132,6,6,0,1,0
6,197,197,29,29,0,1,0
3,231,231,5,5,0,1,0
1,288,288,27,2,25,2,1
7,382,382,115,65,50,4,3
2,440,440,52,52,0,1,0
5,467,467,8,8,0,1,0
0,470,470,127,29,98,3,2

5,135,135,23,9,14,3,2
1,161,161,7,7,0,1,0
7,171,171,25,3,22,4,3
3,198,198,44,30,14,2,1
2,286,286,58,58,0,1,0
0,313,313,10,10,0,1,0
4,404,404,62,24,38,4,3
6,494,494,22,10,12,2,1

0,129,129,13,13,0,1,0
7,155,155,9,1,8,3,2
2,176,176,8,8,0,1,0
10,184,184,36,36,0,1,0
6,271,271,6,6,0,1,0
8,294,294,14,14,0,1,0
5,344,344,60,12,48,4,3
1,423,423,48,35,13,4,3
9,425,425,90,90,0,1,0
4,488,488,20,20,0,1,0
3,498,498,2,2,0,1,0

0,161,161,12,12,0,1,0
3,279,279,40,40,0,1,0
7,352,352,3,3,0,1,0
5,356,356,28,28,0,1,0
2,427,427,1,1,0,1,0
1,439,439,124,124,0,1,0
6,460,460,178,178,0,1,0
4,497,497,15,1,14,4,3

6,134,134,16,16,0,1,0
2,208,208,23,10,13,2,1
4,229,229,61,4,57,4,3
7,236,236,19,19,0,1,0
3,373,373,1,1,0,1,0
5,373,373,13,8,5,2,1
1,374,374,8,8,0,1,0
9,403,403,17,1,16,3,2
0,450,450,30,30,0,1,0
8,486,486,131,131,0,1,0

5,157,157,1,1,0,1,0
3,164,164,1,1,0,1,0
1,201,201,30,30,0,1,0
6,236,236,54,27,27,4,3
0,305,305,78,78,0,1,0
7,328,328,34,34,0,1,0
9,349,349,25,13,12,4,3
2,355,355,9,9,0,1,0
8,415,415,41,16,25,2,1
4,475,475,30,30,0,1,0

5,141,141,4,4,0,1,0
2,176,176,53,53,0,1,0
3,309,309,11,11,0,1,0
4,375,375,53,53,0,1,0
0,469,469,75,6,69,4,3
6,470,470,141,73,68,3,2
1,471,471,21,21,0,1,0

5,174,174,13,13,0,1,0
3,311,311,1,1,0,1,0
1,324,324,59,35,24,4,3
6,408,408,71,7,64,3,2
0,478,478,120,120,0,1,0
4,479,479,121,94,27,4,3
2,498,498,34,34,0,1,0

2,192,192,61,13,48,4,3
1,199,199,21,21,0,1,0
4,213,213,8,3,5,2,1
0,331,331,26,7,19,2,1
5,399,399,37,37,0,1,0
3,410,410,13,13,0,1,0
6,444,444,152,43,109,4,3

5,128,128,1,1,0,1,0
0,133,133,9,9,0,1,0
7,183,183,57,52,5,2,1
1,234,234,7,7,0,1,0
3,243,243,65,65,0,1,0
8,314,314,33,33,0,1,0
4,357,357,38,2,36,2,1
6,375,375,31,31,0,1,0
2,404,404,12,12,0,1,0

3,158,158,43,3,40,3,2
4,167,167,5,2,3,2,1
0,216,216,15,11,4,2,1
6,230,230,23,23,0,1,0
2,261,261,7,7,0,1,0
5,294,294,21,21,0,1,0
8,374,374,35,13,22,2,1
1,406,406,42,31,11,2,1
7,412,412,98,89,9,2,1

5,116,116,32,21,11,2,1
3,217,217,34,13,21,2,1
1,222,222,56,35,21,3,2
2,294,294,28,28,0,1,0
6,402,402,26,16,10,3,2
4,404,404,3,3,0,1,0
0,450,450,69,69,0,1,0

8,161,161,22,22,0,1,0
3,178,178,31,4,27,4,3
2,184,184,5,1,4,2,1
4,194,194,13,13,0,1,0
5,213,213,39,5,34,4,3
7,314,314,55,55,0,1,0
0,332,332,42,42,0,1,0
1,408,408,43,28,15,4,3
6,498,498,8,8,0,1,0

5,132,132,5,2,3,2,1
6,219,219,49,49,0,1,0
1,238,238,6,6,0,1,0
4,366,366,5,5,0,1,0
2,377,377,41,41,0,1,0
0,383,383,68,8,60,4,3
7,396,396,27,12,15,2,1
8,431,431,21,21,0,1,0
9,475,475,78,44,34,3,2
3,486,486,68,2,66,4,3

6,157,157,35,35,0,1,0
3,162,162,16,16,0,1,0
0,173,173,16,8,8,3,2
7,204,204,50,50,0,1,0
2,207,207,18,18,0,1,0
8,301,301,6,6,0,1,0
4,417,417,61,61,0,1,0
5,434,434,8,8,0,1,0
1,435,435,33,33,0,1,0

0,177,177,29,15,14,2,1
3,197,197,4,4,0,1,0
6,274,274,32,32,0,1,0
2,289,289,30,20,10,2,1
8,290,290,18,18,0,1,0
5,352,352,1,1,0,1,0
9,391,391,1,1,0,1,0
4,405,405,11,11,0,1,0
10,459,459,80,80,0,1,0
7,467,467,124,103,21,4,3
1,500,500,33,33,0,1,0

2,129,129,31,19,12,4,3
3,296,296,39,36,3,2,1
0,322,322,68,50,18,3,2
6,357,357,26,1,25,2,1
4,363,363,39,5,34,3,2
5,374,374,73,11,62,3,2
1,472,472,26,26,0,1,0

5,129,129,1,1,0,1,0
9,241,241,9,3,6,2,1
6,252,252,74,17,57,4,3
1,335,335,16,5,11,2,1
2,346,346,87,69,18,3,2
8,346,346,10,10,0,1,0
0,350,350,8,2,6,2,1
3,352,352,50,50,0,1,0
7,385,385,58,43,15,4,3
4,437,437,13,4,9,4,3

1,114,114,1,1,0,1,0
0,126,126,28,28,0,1,0
2,150,150,1,1,0,1,0
6,203,203,23,8,15,4,3
4,336,336,69,9,60,3,2
3,372,372,22,2,20,3,2
7,411,411,26,8,18,2,1
8,474,474,22,10,12,3,2
5,491,491,139,49,90,4,3

6,171,171,26,26,0,1,0
5,316,316,43,43,0,1,0
2,325,325,18,18,0,1,0
1,377,377,62,62,0,1,0
3,412,412,97,76,21,4,3
7,418,418,63,2,61,4,3
0,426,426,20,20,0,1,0
4,427,427,30,30,0,1,0

8,128,128,9,4,5,2,1
0,150,150,25,25,0,1,0
3,169,169,6,6,0,1,0
2,309,309,46,46,0,1,0
7,318,318,30,17,13,2,1
1,355,355,9,4,5,2,1
6,385,385,64,31,33,4,3
4,396,396,14,8,6,2,1
5,400,400,36,36,0,1,0
9,419,419,74,46,28,2,1

11,276,276,91,91,0,1,0
5,283,283,1,1,0,1,0
4,291,291,14,1,13,2,1
2,292,292,8,8,0,1,0
6,294,294,14,6,8,2,1
8,327,327,45,45,0,1,0
10,363,363,42,42,0,1,0
12,402,402,19,19,0,1,0
7,451,451,20,20,0,1,0
0,458,458,1,1,0,1,0
1,477,477,52,31,21,2,1
3,483,483,39,3,36,4,3
9,493,493,6,6,0,1,0

1,127,127,1,1,0,1,0
0,214,214,45,45,0,1,0
2,241,241,14,14,0,1,0
6,251,251,11,5,6,2,1
3,345,345,78,46,32,3,2
5,374,374,2,2,0,1,0
7,383,383,62,62,0,1,0
4,441,441,129,102,27,4,3

3,120,120,2,2,0,1,0
5,180,180,60,21,39,4,3
0,320,320,4,1,3,2,1
1,329,329,65,20,45,4,3
6,334,334,19,19,0,1,0
2,407,407,43,43,0,1,0
8,427,427,3,3,0,1,0
4,428,428,72,72,0,1,0
7,473,473,52,52,0,1,0

5,145,145,54,54,0,1,0
2,170,170,51,51,0,1,0
6,171,171,4,4,0,1,0
1,189,189,2,2,0,1,0
4,200,200,18,18,0,1,0
7,220,220,5,2,3,2,1
3,286,286,23,14,9,4,3
0,425,425,47,47,0,1,0

5,114,114,9,9,0,1,0
0,178,178,34,5,29,4,3
6,291,291,73,73,0,1,0
2,300,300,55,47,8,2,1
1,365,365,47,47,0,1,0
3,403,403,25,1,24,4,3
4,454,454,54,54,0,1,0

3,168,168,7,7,0,1,0
2,189,189,10,10,0,1,0
5,192,192,18,18,0,1,0
12,199,199,47,47,0,1,0
4,221,221,8,8,0,1,0
6,250,250,5,2,3,2,1
0,268,268,2,2,0,1,0
1,338,338,17,17,0,1,0
10,341,341,32,5,27,4,3
7,389,389,42,33,9,2,1
8,421,421,38,11,27,2,1
9,423,423,2,2,0,1,0
11,495,495,84,24,60,3,2

10,101,101,5,5,0,1,0
1,110,110,3,3,0,1,0
4,126,126,7,7,0,1,0
3,194,194,9,4,5,2,1
7,194,194,35,2,33,2,1
5,241,241,18,6,12,4,3
9,270,270,30,19,11,2,1
6,399,399,16,2,14,3,2
8,466,466,78,78,0,1,0
0,467,467,84,13,71,4,3
2,499,499,38,6,32,3,2

6,126,126,8,3,5,2,1
10,173,173,17,17,0,1,0
0,236,236,32,32,0,1,0
7,247,247,28,2,26,3,2
3,272,272,13,7,6,2,1
4,305,305,15,15,0,1,0
5,327,327,1,1,0,1,0
9,428,428,92,65,27,2,1
8,464,464,37,3,34,3,2
2,470,470,35,35,0,1,0
1,489,489,65,23,42,2,1

8,118,118,36,19,17,2,1
4,174,174,23,23,0,1,0
6,175,175,6,1,5,2,1
9,181,181,9,9,0,1,0
0,236,236,1,1,0,1,0
7,240,240,29,11,18,4,3
2,300,300,12,12,0,1,0
3,356,356,72,68,4,2,1
5,357,357,33,3,30,3,2
1,389,389,12,4,8,3,2

5,127,127,4,4,0,1,0
11,148,148,4,4,0,1,0
6,178,178,1,1,0,1,0
1,182,182,1,1,0,1,0
12,222,222,86,86,0,1,0
7,230,230,21,1,20,2,1
8,336,336,9,9,0,1,0
4,348,348,57,17,40,3,2
10,348,348,24,18,6,3,2
9,449,449,10,10,0,1,0
0,450,450,43,43,0,1,0
3,460,460,33,33,0,1,0
2,465,465,5,5,0,1,0

2,104,104,7,7,0,1,0
1,196,196,10,4,6,3,2
11,208,208,4,4,0,1,0
9,271,271,29,20,9,2,1
5,316,316,26,26,0,1,0
12,340,340,22,22,0,1,0
7,359,359,7,4,3,2,1
8,425,425,8,8,0,1,0
0,444,444,40,30,10,2,1
10,453,453,19,7,12,2,1
3,463,463,2,2,0,1,0
14,471,471,197,125,72,4,3
4,478,478,7,7,0,1,0
13,484,484,2,2,0,1,0
6,486,486,2,2,0,1,0

3,117,117,3,3,0,1,0
0,131,131,2,2,0,1,0
9,140,140,9,9,0,1,0
7,144,144,40,40,0,1,0
1,200,200,4,4,0,1,0
6,233,233,7,7,0,1,0
2,250,250,77,53,24,4,3
4,260,260,15,1,14,3,2
5,319,319,24,24,0,1,0
8,474,474,63,63,0,1,0

4,130,130,14,14,0,1,0
6,213,213,55,55,0,1,0
7,247,247,11,11,0,1,0
9,269,269,44,38,6,3,2
5,356,356,22,2,20,2,1
2,365,365,31,31,0,1,0
1,408,408,1,1,0,1,0
0,429,429,44,3,41,2,1
3,468,468,66,66,0,1,0
8,493,493,19,8,11,2,1

0,116,116,16,16,0,1,0
5,143,143,25,25,0,1,0
4,230,230,66,48,18,4,3
3,268,268,4,4,0,1,0
1,287,287,51,6,45,2,1
7,311,311,12,12,0,1,0
6,443,443,2,2,0,1,0
2,475,475,81,81,0,1,0

6,144,144,1,1,0,1,0
8,220,220,78,41,37,4,3
2,243,243,10,3,7,2,1
4,287,287,15,3,12,3,2
1,312,312,93,93,0,1,0
0,442,442,12,4,8,3,2
7,447,447,29,29,0,1,0
5,458,458,40,40,0,1,0
3,476,476,39,39,0,1,0

2,151,151,2,2,0,1,0
4,273,273,5,5,0,1,0
8,332,332,23,15,8,3,2
0,404,404,27,27,0,1,0
7,420,420,140,23,117,4,3
1,464,464,136,109,27,2,1
3,464,464,51,20,31,2,1
5,491,491,26,19,7,2,1
6,494,494,23,15,8,3,2

2,163,163,27,27,0,1,0
8,186,186,17,17,0,1,0
6,205,205,26,1,25,2,1
1,209,209,21,5,16,3,2
5,342,342,28,28,0,1,0
7,367,367,92,50,42,4,3
9,385,385,15,15,0,1,0
3,394,394,38,38,0,1,0
0,429,429,2,2,0,1,0
4,439,439,23,23,0,1,0

10,147,147,21,4,17,2,1
1,163,163,3,3,0,1,0
4,238,238,4,4,0,1,0
0,313,313,14,2,12,2,1
7,354,354,14,14,0,1,0
5,379,379,11,11,0,1,0
2,385,385,83,83,0,1,0
3,420,420,53,23,30,4,3
9,484,484,85,85,0,1,0
6,491,491,6,6,0,1,0
11,492,492,11,3,8,3,2
8,500,500,83,56,27,2,1

6,126,126,2,2,0,1,0
2,154,154,18,18,0,1,0
10,159,159,1,1,0,1,0
8,324,324,87,39,48,3,2
4,327,327,16,16,0,1,0
0,362,362,28,28,0,1,0
1,394,394,8,8,0,1,0
3,410,410,37,37,0,1,0
5,441,441,60,51,9,4,3
9,456,456,77,77,0,1,0
7,497,497,31,31,0,1,0

0,141,141,23,23,0,1,0
7,195,195,68,11,57,4,3
4,252,252,15,9,6,3,2
5,265,265,1,1,0,1,0
3,281,281,37,37,0,1,0
1,284,284,25,12,13,2,1
6,313,313,30,30,0,1,0
8,313,313,20,20,0,1,0
2,356,356,21,21,0,1,0

13,107,107,35,35,0,1,0
2,133,133,9,3,6,3,2
9,167,167,1,1,0,1,0
1,186,186,5,5,0,1,0
8,208,208,12,4,8,2,1
11,216,216,13,13,0,1,0
3,220,220,6,6,0,1,0
10,225,225,11,11,0,1,0
0,230,230,1,1,0,1,0
14,257,257,21,21,0,1,0
5,285,285,7,7,0,1,0
6,317,317,34,26,8,3,2
12,336,336,15,15,0,1,0
15,406,406,21,1,20,3,2
4,419,419,22,13,9,4,3
7,497,497,10,10,0,1,0

0,124,124,1,1,0,1,0
2,128,128,2,2,0,1,0
10,135,135,19,8,11,2,1
6,165,165,9,9,0,1,0
13,188,188,36,36,0,1,0
1,218,218,2,2,0,1,0
11,218,218,61,25,36,4,3
14,223,223,6,6,0,1,0
4,225,225,4,4,0,1,0
7,255,255,28,28,0,1,0
12,301,301,3,3,0,1,0
5,387,387,8,2,6,3,2
8,422,422,23,23,0,1,0
3,437,437,27,27,0,1,0
9,454,454,4,4,0,1,0

10,123,123,7,1,6,2,1
5,155,155,4,1,3,2,1
0,225,225,48,48,0,1,0
1,280,280,30,16,14,3,2
8,298,298,118,118,0,1,0
11,312,312,15,3,12,4,3
7,318,318,2,2,0,1,0
2,350,350,28,6,22,2,1
4,354,354,12,12,0,1,0
9,417,417,3,3,0,1,0
6,429,429,14,14,0,1,0
3,453,453,1,1,0,1,0

7,131,131,8,8,0,1,0
11,134,134,21,8,13,2,1
5,159,159,2,2,0,1,0
6,183,183,1,1,0,1,0
4,231,231,21,1,20,3,2
2,261,261,29,29,0,1,0
9,264,264,35,1,34,4,3
12,293,293,50,50,0,1,0
8,331,331,17,7,10,2,1
3,336,336,4,1,3,2,1
0,462,462,56,56,0,1,0
10,466,466,23,1,22,3,2
1,488,488,18,18,0,1,0

1,106,106,1,1,0,1,0
0,121,121,3,3,0,1,0
12,125,125,13,9,4,2,1
14,145,145,2,2,0,1,0
13,169,169,31,31,0,1,0
7,258,258,2,2,0,1,0
3,268,268,3,3,0,1,0
9,287,287,13,3,10,3,2
10,291,291,10,10,0,1,0
5,368,368,2,2,0,1,0
2,403,403,72,34,38,2,1
11,421,421,3,3,0,1,0
15,469,469,102,77,25,4,3
4,486,486,3,3,0,1,0
6,487,487,82,19,63,4,3
8,495,495,1,1,0,1,0

9,121,121,1,1,0,1,0
10,122,122,3,3,0,1,0
3,126,126,1,1,0,1,0
16,143,143,8,8,0,1,0
2,176,176,1,1,0,1,0
17,214,214,56,56,0,1,0
4,236,236,13,13,0,1,0
7,303,303,2,2,0,1,0
15,318,318,7,7,0,1,0
5,355,355,2,2,0,1,0
12,358,358,1,1,0,1,0
14,367,367,62,62,0,1,0
0,372,372,78,42,36,2,1
13,409,409,2,2,0,1,0
1,458,458,3,3,0,1,0
8,464,464,16,4,12,2,1
11,484,484,5,5,0,1,0
6,493,493,58,46,12,3,2

6,121,121,22,10,12,4,3
0,204,204,88,55,33,4,3
3,255,255,24,19,5,2,1
1,259,259,9,3,6,2,1
4,332,332,75,75,0,1,0
2,379,379,13,13,0,1,0
5,470,470,2,2,0,1,0

1,124,124,16,16,0,1,0
8,147,147,28,28,0,1,0
0,217,217,34,34,0,1,0
3,250,250,1,1,0,1,0
2,252,252,1,1,0,1,0
4,360,360,75,27,48,4,3
5,401,401,48,48,0,1,0
6,422,422,8,2,6,3,2
7,466,466,81,54,27,4,3

2,102,102,5,5,0,1,0
3,120,120,4,4,0,1,0
7,191,191,27,9,18,3,2
4,217,217,17,17,0,1,0
9,233,233,49,8,41,2,1
11,256,256,22,22,0,1,0
6,276,276,4,4,0,1,0
5,354,354,8,8,0,1,0
1,374,374,19,19,0,1,0
0,396,396,45,45,0,1,0
8,406,406,51,10,41,2,1
10,452,452,39,27,12,3,2

10,124,124,12,3,9,4,3
1,136,136,3,3,0,1,0
6,149,149,18,2,16,4,3
2,198,198,8,8,0,1,0
3,203,203,34,34,0,1,0
9,219,219,5,5,0,1,0
0,293,293,19,1,18,3,2
7,359,359,115,4,111,4,3
4,391,391,11,11,0,1,0
5,441,441,27,27,0,1,0
8,474,474,33,24,9,4,3

1,163,163,1,1,0,1,0
12,232,232,21,21,0,1,0
5,253,253,14,14,0,1,0
4,274,274,10,10,0,1,0
8,313,313,50,44,6,3,2
0,379,379,5,5,0,1,0
7,423,423,2,2,0,1,0
3,424,424,57,57,0,1,0
2,428,428,16,2,14,4,3
9,428,428,16,16,0,1,0
6,441,441,24,11,13,3,2
11,463,463,126,126,0,1,0
10,477,477,50,50,0,1,0

13,119,119,16,2,14,4,3
11,179,179,29,29,0,1,0
12,225,225,26,26,0,1,0
2,242,242,19,19,0,1,0
9,244,244,9,9,0,1,0
5,247,247,2,2,0,1,0
0,332,332,16,6,10,2,1
7,337,337,21,13,8,3,2
4,411,411,7,1,6,2,1
10,435,435,43,43,0,1,0
1,453,453,7,3,4,2,1
3,453,453,14,14,0,1,0
6,474,474,28,5,23,2,1
8,500,500,73,69,4,2,1

1,255,255,24,15,9,4,3
3,291,291,8,4,4,2,1
7,322,322,11,11,0,1,0
6,337,337,3,3,0,1,0
8,360,360,63,33,30,3,2
2,380,380,7,7,0,1,0
10,389,389,67,67,0,1,0
9,396,396,48,31,17,3,2
0,431,431,19,19,0,1,0
4,481,481,36,31,5,2,1
5,482,482,112,28,84,4,3

7,101,101,15,15,0,1,0
5,114,114,2,2,0,1,0
3,174,174,62,62,0,1,0
9,213,213,6,6,0,1,0
2,246,246,5,1,4,2,1
8,252,252,28,16,12,4,3
4,329,329,7,7,0,1,0
0,381,381,5,5,0,1,0
1,408,408,32,32,0,1,0
6,429,429,94,16,78,4,3

4,133,133,32,32,0,1,0
8,192,192,16,2,14,2,1
0,329,329,2,2,0,1,0
2,348,348,1,1,0,1,0
7,381,381,114,14,100,4,3
3,423,423,65,23,42,4,3
1,428,428,43,43,0,1,0
5,431,431,15,10,5,2,1
6,490,490,44,21,23,2,1

1,121,121,1,1,0,1,0
5,150,150,5,5,0,1,0
9,170,170,26,17,9,4,3
8,172,172,54,28,26,3,2
0,178,178,1,1,0,1,0
10,246,246,8,8,0,1,0
2,287,287,27,27,0,1,0
3,346,346,3,3,0,1,0
6,444,444,121,121,0,1,0
4,473,473,37,37,0,1,0
7,490,490,4,4,0,1,0

6,112,112,6,6,0,1,0
3,164,164,22,22,0,1,0
0,190,190,28,28,0,1,0
7,292,292,43,16,27,4,3
4,316,316,18,2,16,2,1
5,391,391,99,84,15,4,3
1,420,420,36,24,12,4,3
2,473,473,63,32,31,4,3

6,154,154,2,2,0,1,0
2,212,212,7,7,0,1,0
1,216,216,93,93,0,1,0
8,250,250,21,21,0,1,0
0,283,283,1,1,0,1,0
7,370,370,86,29,57,4,3
3,413,413,11,1,10,2,1
4,421,421,3,3,0,1,0
5,437,437,77,77,0,1,0

9,115,115,19,7,12,2,1
8,116,116,9,9,0,1,0
4,129,129,11,11,0,1,0
3,191,191,30,15,15,2,1
7,205,205,9,9,0,1,0
6,262,262,4,4,0,1,0
5,290,290,16,16,0,1,0
0,301,301,8,2,6,2,1
10,392,392,87,87,0,1,0
2,463,463,74,48,26,2,1
1,478,478,1,1,0,1,0

11,107,107,21,8,13,2,1
10,137,137,29,29,0,1,0
5,153,153,16,2,14,3,2
9,186,186,19,19,0,1,0
6,192,192,5,5,0,1,0
3,226,226,7,7,0,1,0
1,243,243,21,21,0,1,0
4,276,276,26,26,0,1,0
7,323,323,10,10,0,1,0
0,424,424,37,25,12,4,3
2,429,429,17,5,12,2,1
8,489,489,4,4,0,1,0

7,117,117,14,2,12,4,3
3,160,160,3,3,0,1,0
12,187,187,36,12,24,3,2
9,236,236,6,6,0,1,0
5,284,284,31,4,27,4,3
11,331,331,7,7,0,1,0
4,333,333,41,41,0,1,0
0,335,335,9,3,6,2,1
10,361,361,97,35,62,3,2
1,397,397,5,2,3,2,1
2,409,409,8,2,6,2,1
6,477,477,16,7,9,4,3
8,497,497,19,19,0,1,0

1,166,166,82,1,81,3,2
5,199,199,8,2,6,2,1
6,374,374,5,5,0,1,0
4,410,410,129,82,47,3,2
2,424,424,1,1,0,1,0
0,430,430,2,2,0,1,0
3,444,444,63,45,18,4,3

0,105,105,6,1,5,2,1
2,112,112,3,3,0,1,0
9,149,149,19,19,0,1,0
5,208,208,31,3,28,3,2
6,223,223,18,18,0,1,0
1,243,243,57,57,0,1,0
4,391,391,2,2,0,1,0
3,432,432,12,12,0,1,0
8,441,441,24,24,0,1,0
7,483,483,118,103,15,4,3

0,103,103,2,2,0,1,0
4,241,241,64,24,40,3,2
5,295,295,20,2,18,4,3
1,296,296,68,8,60,3,2
2,348,348,88,75,13,2,1
3,356,356,14,4,10,2,1
6,402,402,54,54,0,1,0

6,148,148,3,3,0,1,0
10,158,158,5,5,0,1,0
0,162,162,1,1,0,1,0
4,281,281,17,5,12,3,2
7,312,312,127,4,123,4,3
9,318,318,19,19,0,1,0
2,347,347,51,29,22,3,2
5,442,442,75,39,36,4,3
1,447,447,44,11,33,3,2
8,471,471,4,4,0,1,0
3,493,493,2,2,0,1,0

9,150,150,6,6,0,1,0
2,208,208,4,4,0,1,0
11,253,253,1,1,0,1,0
12,268,268,95,38,57,4,3
5,272,272,3,3,0,1,0
8,276,276,1,1,0,1,0
7,287,287,14,14,0,1,0
3,320,320,22,6,16,2,1
10,335,335,46,46,0,1,0
6,348,348,10,4,6,3,2
4,422,422,33,20,13,2,1
1,425,425,29,11,18,4,3
0,436,436,61,1,60,4,3
13,462,462,5,5,0,1,0

7,104,104,6,6,0,1,0
0,152,152,1,1,0,1,0
15,206,206,7,7,0,1,0
6,216,216,1,1,0,1,0
1,239,239,1,1,0,1,0
10,243,243,5,5,0,1,0
11,261,261,1,1,0,1,0
5,273,273,23,1,22,3,2
2,275,275,8,8,0,1,0
8,355,355,6,6,0,1,0
12,355,355,7,4,3,2,1
4,358,358,37,17,20,3,2
9,358,358,37,25,12,4,3
13,393,393,12,12,0,1,0
3,476,476,22,2,20,2,1
14,478,478,10,2,8,2,1
16,493,493,208,187,21,4,3

1,115,115,5,5,0,1,0
5,382,382,21,17,4,2,1
2,402,402,114,87,27,4,3
0,428,428,75,14,61,4,3
6,441,441,69,25,44,3,2
3,461,461,47,47,0,1,0
4,463,463,88,88,0,1,0

5,191,191,8,8,0,1,0
1,195,195,18,18,0,1,0
6,264,264,53,26,27,4,3
3,284,284,10,1,9,2,1
2,308,308,35,2,33,4,3
0,405,405,120,70,50,3,2
4,484,484,112,76,36,2,1

3,112,112,10,10,0,1,0
0,189,189,95,95,0,1,0
4,264,264,29,29,0,1,0
2,274,274,81,42,39,4,3
1,420,420,7,7,0,1,0

4,118,118,7,7,0,1,0
6,142,142,30,27,3,2,1
2,204,204,9,9,0,1,0
3,250,250,74,74,0,1,0
7,270,270,12,12,0,1,0
8,333,333,4,1,3,2,1
0,348,348,1,1,0,1,0
5,360,360,87,87,0,1,0
1,484,484,49,49,0,1,0

3,113,113,28,28,0,1,0
1,195,195,9,9,0,1,0
7,283,283,14,14,0,1,0
5,329,329,77,5,72,3,2
2,332,332,64,16,48,3,2
4,368,368,31,31,0,1,0
0,413,413,6,6,0,1,0
6,482,482,67,67,0,1,0

5,105,105,1,1,0,1,0
9,146,146,49,21,28,2,1
3,189,189,36,36,0,1,0
4,216,216,12,12,0,1,0
0,265,265,4,4,0,1,0
12,299,299,13,9,4,2,1
11,326,326,35,1,34,3,2
1,344,344,25,22,3,2,1
2,349,349,13,1,12,2,1
7,473,473,11,1,10,3,2
8,485,485,5,5,0,1,0
6,491,491,43,43,0,1,0
10,491,491,9,1,8,3,2

2,205,205,2,2,0,1,0
3,238,238,5,5,0,1,0
7,249,249,9,9,0,1,0
11,271,271,13,4,9,4,3
0,278,278,27,3,24,2,1
9,279,279,75,51,24,4,3
8,316,316,47,3,44,4,3
1,322,322,1,1,0,1,0
6,339,339,54,41,13,2,1
10,374,374,16,16,0,1,0
4,468,468,71,11,60,4,3
5,489,489,11,11,0,1,0

0,100,100,7,7,0,1,0
5,103,103,2,2,0,1,0
6,190,190,2,2,0,1,0
7,212,212,9,5,4,2,1
3,296,296,30,4,26,2,1
8,296,296,2,2,0,1,0
1,298,298,34,34,0,1,0
4,307,307,51,51,0,1,0
2,393,393,12,12,0,1,0
9,473,473,211,211,0,1,0

7,224,224,59,26,33,2,1
3,276,276,6,6,0,1,0
5,276,276,15,15,0,1,0
8,331,331,5,5,0,1,0
6,362,362,63,6,57,4,3
1,376,376,45,45,0,1,0
2,385,385,108,58,50,2,1
0,431,431,10,3,7,2,1
4,459,459,26,26,0,1,0

4,170,170,11,11,0,1,0
2,171,171,49,49,0,1,0
1,262,262,38,38,0,1,0
3,291,291,9,3,6,3,2
5,321,321,84,65,19,2,1
0,326,326,24,24,0,1,0
6,479,479,72,72,0,1,0

8,132,132,31,6,25,2,1
2,213,213,1,1,0,1,0
0,289,289,1,1,0,1,0
9,303,303,68,68,0,1,0
3,312,312,26,9,17,4,3
10,369,369,10,10,0,1,0
5,420,420,53,53,0,1,0
1,427,427,44,44,0,1,0
7,428,428,11,11,0,1,0
4,432,432,41,7,34,2,1
6,493,493,42,35,7,2,1

7,230,230,3,3,0,1,0
4,235,235,18,18,0,1,0
9,249,249,17,17,0,1,0
10,286,286,93,93,0,1,0
8,327,327,33,33,0,1,0
5,352,352,18,13,5,2,1
6,395,395,68,68,0,1,0
1,408,408,36,6,30,4,3
2,434,434,1,1,0,1,0
3,480,480,30,30,0,1,0
0,486,486,23,23,0,1,0

4,109,109,1,1,0,1,0
6,134,134,10,1,9,4,3
8,305,305,33,22,11,2,1
2,307,307,50,50,0,1,0
5,315,315,61,61,0,1,0
0,320,320,23,14,9,4,3
3,374,374,15,15,0,1,0
9,376,376,22,2,20,2,1
1,431,431,10,10,0,1,0
7,438,438,118,56,62,3,2

16,118,118,9,9,0,1,0
1,122,122,10,10,0,1,0
9,153,153,4,1,3,2,1
4,174,174,2,2,0,1,0
14,224,224,39,23,16,3,2
5,229,229,6,6,0,1,0
15,256,256,33,30,3,2,1
11,265,265,1,1,0,1,0
12,299,299,13,13,0,1,0
10,320,320,10,1,9,4,3
6,340,340,15,15,0,1,0
3,354,354,1,1,0,1,0
8,361,361,26,9,17,2,1
0,372,372,2,2,0,1,0
2,395,395,12,12,0,1,0
13,461,461,58,58,0,1,0
7,485,485,59,47,12,2,1

5,176,176,3,3,0,1,0
4,312,312,123,87,36,2,1
6,356,356,19,19,0,1,0
3,382,382,16,16,0,1,0
0,421,421,48,48,0,1,0
2,463,463,10,10,0,1,0
1,465,465,170,134,36,4,3

5,105,105,13,3,10,3,2
6,187,187,40,4,36,3,2
4,194,194,5,1,4,2,1
8,238,238,21,11,10,2,1
3,266,266,87,25,62,3,2
2,315,315,20,8,12,4,3
1,322,322,8,1,7,2,1
7,353,353,32,32,0,1,0
0,394,394,24,24,0,1,0

5,154,154,65,10,55,3,2
1,174,174,46,29,17,2,1
3,186,186,8,8,0,1,0
6,302,302,9,9,0,1,0
7,421,421,6,6,0,1,0
2,422,422,81,5,76,3,2
0,468,468,1,1,0,1,0
4,498,498,19,19,0,1,0

4,113,113,12,12,0,1,0
9,165,165,2,2,0,1,0
6,203,203,20,20,0,1,0
7,226,226,81,7,74,4,3
8,327,327,12,12,0,1,0
3,359,359,1,1,0,1,0
2,393,393,54,54,0,1,0
5,457,457,66,45,21,4,3
0,493,493,5,5,0,1,0
1,495,495,50,50,0,1,0

3,101,101,11,11,0,1,0
8,155,155,25,4,21,2,1
5,170,170,4,4,0,1,0
1,326,326,18,7,11,2,1
2,414,414,29,29,0,1,0
0,427,427,54,11,43,4,3
4,458,458,64,64,0,1,0
6,466,466,110,110,0,1,0
7,490,490,43,43,0,1,0

6,256,256,12,12,0,1,0
1,269,269,19,19,0,1,0
8,355,355,10,1,9,4,3
4,392,392,19,19,0,1,0
2,396,396,91,46,45,4,3
0,404,404,26,26,0,1,0
5,417,417,95,65,30,3,2
7,469,469,95,49,46,2,1
3,484,484,42,26,16,2,1

6,142,142,38,25,13,2,1
1,161,161,24,7,17,3,2
3,297,297,4,1,3,2,1
2,299,299,67,46,21,4,3
0,347,347,40,40,0,1,0
4,423,423,8,5,3,2,1
7,453,453,44,44,0,1,0
5,480,480,61,13,48,2,1

1,105,105,4,1,3,2,1
11,181,181,22,22,0,1,0
5,232,232,6,6,0,1,0
2,251,251,16,5,11,2,1
3,281,281,13,13,0,1,0
10,294,294,4,4,0,1,0
4,359,359,6,6,0,1,0
9,366,366,105,69,36,3,2
8,469,469,40,40,0,1,0
0,470,470,23,23,0,1,0
7,474,474,27,18,9,4,3
6,497,497,102,54,48,4,3

2,109,109,27,27,0,1,0
3,121,121,3,3,0,1,0
0,136,136,16,16,0,1,0
5,224,224,76,8,68,3,2
4,305,305,27,27,0,1,0
6,464,464,29,29,0,1,0
1,492,492,69,42,27,2,1

1,132,132,2,2,0,1,0
4,137,137,7,4,3,2,1
2,160,160,22,22,0,1,0
6,163,163,8,8,0,1,0
5,242,242,11,11,0,1,0
8,259,259,7,7,0,1,0
7,260,260,15,15,0,1,0
3,281,281,16,12,4,2,1
0,319,319,28,28,0,1,0
9,333,333,53,53,0,1,0
11,359,359,106,91,15,2,1
10,386,386,10,3,7,2,1

1,134,134,9,9,0,1,0
2,140,140,1,1,0,1,0
5,148,148,18,18,0,1,0
0,174,174,28,14,14,3,2
8,223,223,17,7,10,3,2
4,289,289,9,3,6,3,2
3,312,312,35,35,0,1,0
9,385,385,26,5,21,3,2
6,393,393,115,93,22,4,3
7,448,448,31,12,19,2,1

2,182,182,38,38,0,1,0
5,187,187,9,2,7,2,1
3,339,339,13,1,12,4,3
1,342,342,8,8,0,1,0
4,423,423,90,90,0,1,0
0,496,496,237,237,0,1,0

2,104,104,5,5,0,1,0
10,121,121,8,3,5,2,1
1,180,180,13,3,10,3,2
6,196,196,15,15,0,1,0
11,218,218,27,27,0,1,0
9,286,286,80,80,0,1,0
3,301,301,7,7,0,1,0
5,319,319,28,28,0,1,0
4,321,321,4,4,0,1,0
8,349,349,20,20,0,1,0
0,421,421,6,6,0,1,0
7,460,460,50,50,0,1,0
12,500,500,18,7,11,2,1

6,197,197,10,10,0,1,0
2,327,327,15,15,0,1,0
7,360,360,96,39,57,4,3
0,388,388,132,111,21,4,3
1,417,417,17,17,0,1,0
4,462,462,71,43,28,3,2
5,493,493,17,17,0,1,0
3,500,500,37,10,27,4,3

3,109,109,5,5,0,1,0
0,111,111,5,1,4,2,1
1,125,125,4,1,3,2,1
12,210,210,56,14,42,3,2
2,228,228,2,2,0,1,0
4,269,269,38,38,0,1,0
11,291,291,25,6,19,4,3
5,317,317,14,11,3,2,1
6,318,318,40,16,24,4,3
10,330,330,19,7,12,2,1
7,342,342,9,1,8,3,2
8,420,420,13,3,10,2,1
9,499,499,49,30,19,4,3

4,242,242,14,14,0,1,0
6,248,248,10,10,0,1,0
2,268,268,16,16,0,1,0
5,300,300,62,17,45,2,1
3,309,309,62,22,40,2,1
1,373,373,88,88,0,1,0
0,397,397,82,37,45,4,3

4,159,159,15,3,12,4,3
7,162,162,1,1,0,1,0
2,215,215,38,29,9,4,3
0,243,243,34,34,0,1,0
8,313,313,47,34,13,2,1
3,402,402,30,20,10,3,2
5,451,451,52,7,45,4,3
1,496,496,9,9,0,1,0
6,500,500,119,55,64,3,2

6,157,157,3,3,0,1,0
7,192,192,10,2,8,3,2
9,206,206,1,1,0,1,0
15,233,233,75,75,0,1,0
4,234,234,6,2,4,2,1
2,237,237,12,12,0,1,0
5,280,280,13,13,0,1,0
8,290,290,12,12,0,1,0
14,298,298,9,6,3,2,1
0,343,343,2,2,0,1,0
1,406,406,18,18,0,1,0
12,409,409,56,56,0,1,0
3,445,445,18,18,0,1,0
10,459,459,41,28,13,2,1
13,466,466,8,8,0,1,0
11,483,483,39,35,4,2,1

7,112,112,7,4,3,2,1
9,199,199,13,10,3,2,1
4,268,268,2,2,0,1,0
6,273,273,82,44,38,2,1
3,315,315,1,1,0,1,0
8,326,326,27,9,18,2,1
5,414,414,19,7,12,4,3
1,426,426,51,51,0,1,0
2,438,438,37,5,32,4,3
0,467,467,112,22,90,4,3

5,106,106,15,15,0,1,0
3,158,158,33,33,0,1,0
2,191,191,5,5,0,1,0
0,233,233,23,23,0,1,0
1,383,383,64,31,33,4,3
4,401,401,29,25,4,2,1
7,401,401,85,49,36,2,1
6,430,430,34,34,0,1,0

6,127,127,28,28,0,1,0
7,131,131,2,2,0,1,0
5,268,268,2,2,0,1,0
4,317,317,46,46,0,1,0
9,349,349,24,24,0,1,0
2,369,369,36,4,32,2,1
3,391,391,55,7,48,4,3
8,487,487,100,40,60,4,3
1,489,489,49,42,7,2,1
0,495,495,6,6,0,1,0

8,150,150,3,3,0,1,0
7,152,152,9,9,0,1,0
3,191,191,5,1,4,2,1
1,201,201,37,7,30,4,3
6,277,277,96,35,61,4,3
4,306,306,41,1,40,2,1
2,317,317,12,3,9,2,1
0,373,373,44,44,0,1,0
5,392,392,34,23,11,2,1

4,108,108,19,13,6,2,1
1,221,221,109,109,0,1,0
3,236,236,23,8,15,2,1
5,246,246,46,46,0,1,0
2,249,249,11,3,8,3,2
0,378,378,4,4,0,1,0

5,127,127,14,14,0,1,0
4,130,130,2,2,0,1,0
6,142,142,5,5,0,1,0
12,198,198,32,32,0,1,0
9,215,215,12,12,0,1,0
7,232,232,1,1,0,1,0
0,265,265,7,7,0,1,0
2,398,398,58,42,16,2,1
10,398,398,64,12,52,3,2
8,402,402,10,2,8,2,1
11,414,414,55,55,0,1,0
3,426,426,30,6,24,3,2
1,449,449,31,19,12,3,2

0,171,171,36,36,0,1,0
4,190,190,5,5,0,1,0
3,224,224,27,27,0,1,0
9,241,241,10,5,5,2,1
6,247,247,4,4,0,1,0
10,277,277,108,59,49,4,3
8,295,295,21,21,0,1,0
2,308,308,14,8,6,2,1
7,375,375,13,13,0,1,0
5,426,426,1,1,0,1,0
1,440,440,20,20,0,1,0
11,473,473,1,1,0,1,0

7,124,124,9,1,8,3,2
10,126,126,36,12,24,3,2
5,165,165,13,13,0,1,0
9,215,215,7,7,0,1,0
1,248,248,19,19,0,1,0
8,290,290,34,22,12,2,1
6,296,296,19,2,17,2,1
0,320,320,3,3,0,1,0
3,341,341,56,16,40,3,2
2,460,460,29,18,11,2,1
4,484,484,22,11,11,2,1

5,130,130,11,11,0,1,0
7,172,172,37,37,0,1,0
3,213,213,12,12,0,1,0
8,241,241,2,2,0,1,0
4,261,261,36,12,24,3,2
2,285,285,59,45,14,3,2
6,288,288,47,32,15,4,3
9,397,397,47,33,14,3,2
0,418,418,2,2,0,1,0
1,460,460,5,1,4,2,1

8,178,178,19,19,0,1,0
9,207,207,55,55,0,1,0
1,264,264,17,10,7,2,1
0,375,375,37,8,29,2,1
3,384,384,8,8,0,1,0
6,387,387,6,6,0,1,0
5,397,397,20,1,19,4,3
10,402,402,12,12,0,1,0
2,418,418,66,24,42,4,3
7,424,424,45,10,35,2,1
4,499,499,47,47,0,1,0

9,150,150,3,3,0,1,0
3,167,167,14,1,13,2,1
5,267,267,39,39,0,1,0
7,281,281,73,64,9,3,2
6,312,312,16,1,15,2,1
8,370,370,5,5,0,1,0
0,423,423,26,10,16,2,1
4,429,429,48,48,0,1,0
10,459,459,98,17,81,4,3
1,467,467,12,3,9,2,1
2,486,486,10,10,0,1,0

10,103,103,18,18,0,1,0
8,174,174,33,24,9,4,3
2,250,250,4,1,3,2,1
3,340,340,3,3,0,1,0
0,359,359,12,12,0,1,0
5,377,377,55,55,0,1,0
6,413,413,43,43,0,1,0
9,429,429,47,19,28,4,3
4,454,454,16,16,0,1,0
1,460,460,72,45,27,2,1
7,496,496,16,16,0,1,0

8,101,101,4,4,0,1,0
7,150,150,34,34,0,1,0
1,202,202,3,3,0,1,0
10,239,239,75,15,60,3,2
3,323,323,13,13,0,1,0
6,339,339,30,30,0,1,0
5,406,406,10,10,0,1,0
4,413,413,36,5,31,2,1
11,421,421,53,53,0,1,0
2,430,430,7,7,0,1,0
9,444,444,14,2,12,4,3
0,449,449,1,1,0,1,0

3,187,187,7,7,0,1,0
2,202,202,33,22,11,2,1
4,209,209,2,2,0,1,0
13,223,223,2,2,0,1,0
9,238,238,4,4,0,1,0
5,255,255,7,1,6,3,2
1,270,270,7,7,0,1,0
8,270,270,28,18,10,3,2
10,314,314,46,46,0,1,0
0,345,345,3,3,0,1,0
11,409,409,77,47,30,4,3
7,418,418,8,8,0,1,0
12,419,419,67,1,66,3,2
6,446,446,41,41,0,1,0

8,159,159,7,7,0,1,0
3,298,298,20,4,16,3,2
6,299,299,43,43,0,1,0
5,311,311,22,22,0,1,0
1,329,329,48,48,0,1,0
4,406,406,31,2,29,2,1
0,445,445,38,2,36,3,2
7,489,489,120,105,15,4,3
2,499,499,63,23,40,4,3

3,137,137,1,1,0,1,0
7,190,190,38,38,0,1,0
6,239,239,9,9,0,1,0
0,245,245,50,50,0,1,0
4,294,294,26,26,0,1,0
1,304,304,11,11,0,1,0
5,352,352,19,1,18,2,1
9,391,391,5,5,0,1,0
8,405,405,68,68,0,1,0
10,406,406,50,50,0,1,0
2,410,410,30,30,0,1,0

6,173,173,7,7,0,1,0
0,209,209,9,9,0,1,0
3,263,263,20,4,16,3,2
7,265,265,38,17,21,4,3
1,272,272,78,62,16,2,1
4,430,430,126,126,0,1,0
2,431,431,41,32,9,4,3
5,462,462,14,9,5,2,1

11,117,117,1,1,0,1,0
10,174,174,5,5,0,1,0
9,207,207,62,56,6,3,2
4,240,240,30,30,0,1,0
1,285,285,19,19,0,1,0
2,304,304,7,7,0,1,0
12,329,329,58,58,0,1,0
8,347,347,13,13,0,1,0
5,380,380,10,10,0,1,0
0,397,397,62,62,0,1,0
7,434,434,2,2,0,1,0
6,452,452,8,8,0,1,0
3,482,482,21,21,0,1,0

5,109,109,6,6,0,1,0
7,116,116,13,13,0,1,0
3,273,273,16,16,0,1,0
4,292,292,27,27,0,1,0
6,297,297,46,4,42,2,1
2,388,388,35,35,0,1,0
1,425,425,2,2,0,1,0
8,428,428,27,5,22,3,2
0,446,446,20,6,14,3,2
10,453,453,46,21,25,2,1
9,459,459,104,104,0,1,0

7,140,140,2,2,0,1,0
2,261,261,17,3,14,2,1
1,271,271,42,42,0,1,0
6,278,278,23,23,0,1,0
8,317,317,90,90,0,1,0
0,335,335,38,11,27,4,3
3,398,398,22,22,0,1,0
5,415,415,54,10,44,2,1
4,437,437,49,3,46,4,3

6,204,204,10,5,5,2,1
5,222,222,60,1,59,3,2
4,301,301,32,6,26,2,1
3,357,357,30,30,0,1,0
0,413,413,111,84,27,4,3
2,415,415,83,41,42,3,2
1,418,418,14,14,0,1,0

9,111,111,16,16,0,1,0
8,131,131,3,3,0,1,0
2,189,189,3,3,0,1,0
5,267,267,2,2,0,1,0
6,293,293,41,41,0,1,0
0,305,305,49,49,0,1,0
1,363,363,50,12,38,3,2
4,419,419,7,7,0,1,0
7,423,423,86,86,0,1,0
3,468,468,76,76,0,1,0

2,103,103,6,6,0,1,0
6,132,132,9,2,7,2,1
3,263,263,45,24,21,4,3
1,310,310,12,12,0,1,0
4,441,441,90,44,46,2,1
5,452,452,31,23,8,3,2
0,487,487,197,115,82,3,2

8,103,103,12,12,0,1,0
7,142,142,1,1,0,1,0
1,145,145,1,1,0,1,0
9,205,205,15,15,0,1,0
0,209,209,4,4,0,1,0
10,266,266,52,52,0,1,0
2,288,288,5,5,0,1,0
11,309,309,38,38,0,1,0
6,380,380,23,4,19,2,1
5,457,457,72,10,62,3,2
4,496,496,25,25,0,1,0
3,500,500,93,93,0,1,0

8,190,190,36,8,28,3,2
5,312,312,30,30,0,1,0
7,327,327,63,20,43,2,1
1,385,385,32,4,28,4,3
2,428,428,20,4,16,4,3
6,464,464,14,4,10,2,1
0,488,488,40,8,32,2,1
3,495,495,71,19,52,3,2
4,499,499,73,11,62,3,2

10,130,130,9,9,0,1,0
1,146,146,34,2,32,2,1
9,162,162,19,2,17,4,3
7,170,170,50,13,37,3,2
4,178,178,7,7,0,1,0
5,180,180,3,3,0,1,0
2,263,263,5,5,0,1,0
8,298,298,9,9,0,1,0
6,359,359,31,22,9,4,3
0,446,446,27,7,20,3,2
3,494,494,23,23,0,1,0

1,107,107,1,1,0,1,0
3,148,148,29,8,21,4,3
4,156,156,38,38,0,1,0
2,183,183,7,4,3,2,1
5,214,214,4,4,0,1,0
0,254,254,115,46,69,4,3
6,428,428,23,1,22,2,1

6,142,142,13,6,7,2,1
1,171,171,19,19,0,1,0
3,178,178,41,20,21,2,1
7,260,260,62,42,20,2,1
2,342,342,20,17,3,2,1
5,358,358,5,5,0,1,0
4,443,443,72,72,0,1,0
0,468,468,49,29,20,2,1

8,142,142,13,13,0,1,0
4,188,188,14,14,0,1,0
6,257,257,18,1,17,3,2
3,296,296,3,3,0,1,0
5,305,305,4,4,0,1,0
7,320,320,106,103,3,2,1
0,339,339,24,10,14,3,2
1,345,345,51,51,0,1,0
2,452,452,89,86,3,2,1

5,189,189,5,1,4,2,1
7,196,196,19,7,12,4,3
0,215,215,11,11,0,1,0
6,244,244,88,51,37,2,1
1,341,341,51,33,18,2,1
3,354,354,80,80,0,1,0
2,463,463,35,9,26,4,3
4,480,480,12,12,0,1,0

3,120,120,27,27,0,1,0
1,143,143,32,4,28,3,2
0,155,155,78,8,70,3,2
2,413,413,18,2,16,2,1
4,440,440,7,7,0,1,0

5,106,106,42,20,22,3,2
1,299,299,100,84,16,2,1
2,299,299,11,2,9,4,3
4,317,317,1,1,0,1,0
3,364,364,28,28,0,1,0
0,419,419,70,70,0,1,0

6,101,101,31,31,0,1,0
5,178,178,4,4,0,1,0
1,241,241,1,1,0,1,0
2,272,272,9,2,7,2,1
0,290,290,35,35,0,1,0
3,360,360,91,91,0,1,0
7,381,381,3,3,0,1,0
4,386,386,35,35,0,1,0
8,439,439,74,74,0,1,0

5,137,137,5,5,0,1,0
6,176,176,3,3,0,1,0
2,189,189,9,4,5,2,1
4,193,193,18,18,0,1,0
0,212,212,8,8,0,1,0
3,269,269,69,27,42,4,3
8,298,298,19,19,0,1,0
1,335,335,22,4,18,3,2
7,450,450,177,172,5,2,1

13,129,129,34,34,0,1,0
6,149,149,1,1,0,1,0
5,169,169,3,3,0,1,0
2,210,210,37,5,32,2,1
11,211,211,30,30,0,1,0
3,235,235,17,17,0,1,0
1,275,275,16,6,10,3,2
7,278,278,9,9,0,1,0
10,282,282,14,4,10,3,2
12,335,335,17,17,0,1,0
4,360,360,10,10,0,1,0
0,381,381,1,1,0,1,0
9,420,420,9,1,8,2,1
8,435,435,37,15,22,3,2

2,107,107,39,39,0,1,0
3,199,199,3,3,0,1,0
4,244,244,12,12,0,1,0
0,276,276,25,3,22,3,2
6,276,276,45,29,16,2,1
5,328,328,93,39,54,3,2
1,459,459,22,10,12,3,2

2,158,158,9,9,0,1,0
4,175,175,27,17,10,3,2
8,217,217,44,5,39,4,3
6,291,291,43,34,9,2,1
1,311,311,51,51,0,1,0
5,348,348,24,15,9,4,3
0,389,389,25,21,4,2,1
3,417,417,27,6,21,3,2
7,432,432,38,2,36,3,2

8,109,109,5,5,0,1,0
2,147,147,4,4,0,1,0
3,160,160,17,11,6,2,1
9,178,178,39,19,20,2,1
6,231,231,1,1,0,1,0
4,285,285,4,4,0,1,0
0,312,312,34,34,0,1,0
5,345,345,18,18,0,1,0
10,352,352,79,16,63,4,3
1,425,425,29,3,26,2,1
7,462,462,55,55,0,1,0
11,480,480,8,1,7,2,1

1,160,160,11,11,0,1,0
0,175,175,29,29,0,1,0
6,181,181,2,2,0,1,0
10,203,203,1,1,0,1,0
7,217,217,1,1,0,1,0
4,223,223,5,5,0,1,0
3,317,317,17,5,12,2,1
2,322,322,52,37,15,4,3
9,364,364,70,70,0,1,0
8,389,389,119,119,0,1,0
5,465,465,10,6,4,2,1

0,177,177,2,2,0,1,0
10,235,235,15,6,9,4,3
4,282,282,71,32,39,4,3
5,283,283,5,5,0,1,0
9,295,295,72,63,9,2,1
7,350,350,31,21,10,2,1
6,351,351,1,1,0,1,0
2,359,359,27,27,0,1,0
3,361,361,3,3,0,1,0
8,432,432,47,47,0,1,0
1,466,466,62,62,0,1,0

3,145,145,15,15,0,1,0
5,159,159,28,28,0,1,0
9,300,300,31,31,0,1,0
6,380,380,86,86,0,1,0
1,413,413,3,3,0,1,0
4,426,426,1,1,0,1,0
8,427,427,70,2,68,3,2
7,431,431,4,4,0,1,0
2,440,440,16,16,0,1,0
0,476,476,86,86,0,1,0

5,199,199,4,4,0,1,0
0,302,302,100,22,78,3,2
4,362,362,32,17,15,4,3
1,399,399,11,2,9,2,1
6,410,410,46,25,21,4,3
7,442,442,125,125,0,1,0
2,461,461,46,46,0,1,0
3,476,476,20,5,15,2,1

6,115,115,14,2,12,3,2
3,155,155,29,29,0,1,0
2,208,208,5,5,0,1,0
7,209,209,60,23,37,4,3
5,278,278,10,1,9,4,3
1,312,312,50,50,0,1,0
4,341,341,37,37,0,1,0
0,420,420,9,9,0,1,0
8,489,489,30,10,20,3,2

9,204,204,21,21,0,1,0
7,206,206,28,28,0,1,0
4,235,235,33,33,0,1,0
5,323,323,43,5,38,3,2
2,326,326,8,8,0,1,0
0,343,343,9,1,8,3,2
1,347,347,55,25,30,4,3
6,401,401,47,47,0,1,0
8,468,468,72,27,45,3,2
3,493,493,9,1,8,3,2

6,154,154,33,33,0,1,0
2,156,156,66,56,10,2,1
8,198,198,39,26,13,2,1
5,266,266,11,11,0,1,0
4,343,343,8,2,6,3,2
0,350,350,2,2,0,1,0
1,425,425,3,3,0,1,0
3,468,468,1,1,0,1,0
7,487,487,41,31,10,3,2
9,487,487,5,5,0,1,0

0,103,103,5,5,0,1,0
4,136,136,7,7,0,1,0
1,137,137,5,5,0,1,0
6,143,143,7,4,3,2,1
8,149,149,14,14,0,1,0
2,202,202,2,2,0,1,0
7,288,288,106,106,0,1,0
3,394,394,142,82,60,3,2
5,449,449,1,1,0,1,0

5,117,117,3,3,0,1,0
7,136,136,9,9,0,1,0
9,159,159,46,37,9,2,1
4,197,197,7,7,0,1,0
10,204,204,24,14,10,2,1
6,206,206,15,8,7,2,1
0,213,213,21,21,0,1,0
2,280,280,3,3,0,1,0
1,288,288,22,22,0,1,0
3,437,437,80,68,12,2,1
8,446,446,15,9,6,3,2

0,112,112,6,6,0,1,0
1,347,347,37,29,8,2,1
8,387,387,119,80,39,4,3
6,410,410,4,1,3,2,1
7,414,414,74,14,60,3,2
2,439,439,51,51,0,1,0
4,442,442,5,5,0,1,0
3,457,457,98,57,41,4,3
5,480,480,4,4,0,1,0

0,143,143,4,4,0,1,0
4,179,179,21,21,0,1,0
1,188,188,8,4,4,2,1
6,239,239,14,14,0,1,0
9,252,252,95,26,69,4,3
7,253,253,7,7,0,1,0
2,306,306,52,52,0,1,0
8,323,323,14,14,0,1,0
3,346,346,38,38,0,1,0
5,428,428,14,14,0,1,0

1,143,143,10,10,0,1,0
4,163,163,34,14,20,3,2
6,164,164,20,20,0,1,0
5,172,172,5,5,0,1,0
8,192,192,1,1,0,1,0
3,363,363,14,3,11,4,3
7,380,380,36,36,0,1,0
0,385,385,43,17,26,3,2
9,393,393,113,88,25,2,1
2,409,409,18,5,13,2,1

3,102,102,3,3,0,1,0
10,150,150,6,6,0,1,0
4,199,199,5,5,0,1,0
9,254,254,46,46,0,1,0
12,255,255,6,6,0,1,0
0,260,260,25,17,8,3,2
1,274,274,22,2,20,2,1
7,276,276,24,10,14,3,2
6,306,306,21,21,0,1,0
8,351,351,15,15,0,1,0
11,409,409,107,26,81,4,3
2,476,476,1,1,0,1,0
5,479,479,33,33,0,1,0

5,134,134,4,4,0,1,0
11,143,143,13,6,7,2,1
6,184,184,1,1,0,1,0
9,249,249,83,53,30,2,1
10,291,291,14,2,12,4,3
1,325,325,11,11,0,1,0
3,334,334,28,8,20,3,2
0,362,362,48,10,38,2,1
2,382,382,43,43,0,1,0
8,405,405,13,13,0,1,0
7,408,408,2,2,0,1,0
4,427,427,42,42,0,1,0

9,119,119,2,2,0,1,0
3,134,134,18,4,14,3,2
2,170,170,28,28,0,1,0
10,189,189,7,7,0,1,0
8,237,237,61,10,51,4,3
5,382,382,31,31,0,1,0
1,395,395,23,23,0,1,0
0,423,423,2,2,0,1,0
4,453,453,21,4,17,2,1
6,456,456,2,2,0,1,0
7,463,463,3,3,0,1,0
11,494,494,99,99,0,1,0

3,173,173,21,21,0,1,0
2,176,176,19,19,0,1,0
1,196,196,1,1,0,1,0
6,209,209,72,51,21,2,1
4,296,296,11,1,10,3,2
8,317,317,16,8,8,2,1
9,422,422,33,15,18,2,1
0,435,435,99,33,66,3,2
7,446,446,16,16,0,1,0
5,492,492,1,1,0,1,0

4,140,140,12,12,0,1,0
0,238,238,24,13,11,2,1
7,271,271,3,3,0,1,0
2,296,296,14,2,12,3,2
5,302,302,3,3,0,1,0
1,319,319,79,43,36,3,2
9,319,319,49,1,48,4,3
8,390,390,29,29,0,1,0
3,412,412,4,4,0,1,0
6,473,473,126,126,0,1,0

5,119,119,5,5,0,1,0
6,159,159,38,20,18,3,2
8,263,263,7,7,0,1,0
1,329,329,4,4,0,1,0
0,359,359,6,6,0,1,0
4,369,369,54,54,0,1,0
7,430,430,15,15,0,1,0
9,431,431,89,89,0,1,0
2,471,471,68,68,0,1,0
3,473,473,68,32,36,4,3

4,149,149,20,2,18,4,3
8,165,165,58,29,29,2,1
7,183,183,1,1,0,1,0
2,189,189,8,3,5,2,1
3,225,225,56,56,0,1,0
5,273,273,29,29,0,1,0
1,306,306,7,4,3,2,1
0,433,433,24,24,0,1,0
6,488,488,22,22,0,1,0

7,199,199,27,6,21,4,3
8,235,235,39,7,32,3,2
9,249,249,51,25,26,3,2
4,270,270,32,19,13,2,1
5,280,280,8,8,0,1,0
3,327,327,3,3,0,1,0
10,412,412,1,1,0,1,0
6,417,417,52,52,0,1,0
1,453,453,17,6,11,2,1
2,476,476,74,74,0,1,0
0,500,500,14,14,0,1,0

0,178,178,50,21,29,3,2
2,209,209,18,18,0,1,0
7,225,225,4,4,0,1,0
1,273,273,13,1,12,2,1
6,346,346,12,2,10,3,2
8,352,352,128,128,0,1,0
4,376,376,3,3,0,1,0
3,491,491,39,39,0,1,0
5,493,493,45,45,0,1,0

6,115,115,20,8,12,3,2
2,197,197,61,40,21,4,3
7,243,243,42,42,0,1,0
1,301,301,9,9,0,1,0
5,336,336,41,35,6,2,1
4,387,387,17,3,14,4,3
3,401,401,60,51,9,4,3
0,468,468,6,6,0,1,0

1,134,134,8,2,6,2,1
7,135,135,13,13,0,1,0
4,160,160,27,19,8,2,1
6,202,202,34,34,0,1,0
5,312,312,23,23,0,1,0
2,399,399,37,4,33,4,3
0,421,421,42,42,0,1,0
3,447,447,111,56,55,4,3

10,129,129,30,20,10,3,2
9,142,142,7,7,0,1,0
8,166,166,30,15,15,2,1
1,246,246,19,19,0,1,0
11,310,310,16,16,0,1,0
2,326,326,1,1,0,1,0
6,334,334,11,1,10,2,1
5,335,335,2,2,0,1,0
0,410,410,51,18,33,2,1
3,421,421,14,14,0,1,0
7,456,456,70,4,66,4,3
4,474,474,34,34,0,1,0

0,107,107,9,9,0,1,0
1,108,108,7,7,0,1,0
3,179,179,18,18,0,1,0
7,201,201,68,68,0,1,0
8,243,243,16,4,12,2,1
2,301,301,23,7,16,3,2
6,331,331,26,7,19,2,1
4,423,423,74,46,28,2,1
5,447,447,9,9,0,1,0

3,117,117,20,20,0,1,0
1,276,276,46,46,0,1,0
4,314,314,118,15,103,4,3
5,394,394,3,3,0,1,0
7,435,435,10,4,6,3,2
6,458,458,45,45,0,1,0
0,466,466,4,4,0,1,0
2,498,498,77,14,63,4,3

6,199,199,17,1,16,2,1
7,218,218,5,1,4,2,1
4,246,246,5,5,0,1,0
11,258,258,44,44,0,1,0
0,265,265,8,8,0,1,0
2,304,304,8,1,7,2,1
8,314,314,22,2,20,3,2
3,322,322,45,29,16,2,1
9,371,371,53,22,31,4,3
10,371,371,35,27,8,3,2
5,396,396,22,22,0,1,0
1,475,475,24,24,0,1,0
12,494,494,48,18,30,3,2

3,180,180,20,20,0,1,0
10,243,243,34,34,0,1,0
11,250,250,57,19,38,2,1
5,280,280,19,19,0,1,0
7,320,320,2,2,0,1,0
8,326,326,1,1,0,1,0
9,371,371,51,3,48,3,2
1,377,377,2,2,0,1,0
4,414,414,6,6,0,1,0
6,424,424,76,64,12,4,3
0,494,494,4,4,0,1,0
2,494,494,54,5,49,3,2

2,123,123,26,26,0,1,0
0,130,130,9,9,0,1,0
1,146,146,8,2,6,2,1
7,181,181,1,1,0,1,0
5,303,303,47,47,0,1,0
8,327,327,12,12,0,1,0
6,349,349,108,27,81,4,3
4,373,373,8,8,0,1,0
3,390,390,56,48,8,2,1

6,117,117,13,13,0,1,0
7,143,143,16,16,0,1,0
1,198,198,22,19,3,2,1
8,198,198,36,36,0,1,0
4,242,242,34,14,20,3,2
2,447,447,20,2,18,4,3
5,461,461,15,3,12,4,3
9,485,485,53,12,41,2,1
0,496,496,59,59,0,1,0
3,499,499,27,11,16,2,1

8,106,106,2,2,0,1,0
0,145,145,1,1,0,1,0
9,147,147,17,2,15,4,3
2,212,212,2,2,0,1,0
4,212,212,18,18,0,1,0
1,228,228,56,36,20,2,1
5,323,323,6,2,4,2,1
3,324,324,44,15,29,2,1
6,414,414,8,8,0,1,0
7,456,456,166,53,113,4,3

0,254,254,56,7,49,2,1
1,260,260,20,20,0,1,0
3,263,263,37,37,0,1,0
2,266,266,17,5,12,4,3
6,297,297,60,36,24,4,3
7,310,310,17,9,8,3,2
4,409,409,32,32,0,1,0
5,411,411,70,4,66,4,3

9,111,111,7,7,0,1,0
5,112,112,33,9,24,3,2
0,138,138,1,1,0,1,0
4,143,143,17,17,0,1,0
2,327,327,1,1,0,1,0
6,366,366,119,102,17,4,3
1,388,388,27,27,0,1,0
3,429,429,5,5,0,1,0
8,443,443,27,27,0,1,0
7,448,448,28,25,3,2,1

5,128,128,3,3,0,1,0
4,164,164,1,1,0,1,0
0,168,168,7,7,0,1,0
6,170,170,4,4,0,1,0
3,172,172,16,2,14,3,2
1,241,241,13,3,10,2,1
7,256,256,2,2,0,1,0
12,283,283,84,33,51,4,3
13,284,284,31,31,0,1,0
9,344,344,50,29,21,4,3
2,399,399,4,1,3,2,1
11,423,423,14,2,12,3,2
10,430,430,27,3,24,2,1
8,447,447,43,43,0,1,0

1,199,199,21,21,0,1,0
2,276,276,37,26,11,2,1
5,300,300,4,1,3,2,1
8,305,305,80,36,44,4,3
7,306,306,56,56,0,1,0
3,314,314,39,39,0,1,0
6,321,321,15,15,0,1,0
0,388,388,23,23,0,1,0
4,464,464,36,36,0,1,0

8,155,155,13,13,0,1,0
2,168,168,3,3,0,1,0
6,172,172,2,2,0,1,0
5,287,287,12,1,11,4,3
0,313,313,3,3,0,1,0
7,315,315,37,4,33,2,1
10,343,343,28,9,19,2,1
4,344,344,15,2,13,2,1
1,402,402,27,13,14,3,2
3,406,406,127,127,0,1,0
9,487,487,110,20,90,3,2

5,133,133,10,10,0,1,0
2,190,190,26,26,0,1,0
3,308,308,48,19,29,3,2
1,414,414,148,99,49,4,3
0,424,424,61,61,0,1,0
4,478,478,66,48,18,2,1

3,157,157,14,14,0,1,0
4,172,172,2,2,0,1,0
7,176,176,33,33,0,1,0
0,189,189,37,37,0,1,0
2,244,244,28,28,0,1,0
5,295,295,17,2,15,4,3
9,405,405,63,63,0,1,0
6,410,410,32,32,0,1,0
1,480,480,15,3,12,4,3
8,490,490,43,43,0,1,0

1,123,123,3,3,0,1,0
3,202,202,35,14,21,4,3
0,216,216,12,12,0,1,0
8,241,241,32,29,3,2,1
6,266,266,79,22,57,4,3
2,282,282,48,23,25,4,3
4,285,285,2,2,0,1,0
7,299,299,16,16,0,1,0
5,311,311,22,4,18,3,2
9,422,422,9,9,0,1,0

5,113,113,1,1,0,1,0
1,193,193,5,5,0,1,0
0,223,223,31,22,9,2,1
6,261,261,68,68,0,1,0
7,305,305,58,58,0,1,0
2,380,380,37,29,8,3,2
4,396,396,57,57,0,1,0
3,479,479,46,37,9,2,1
8,500,500,27,2,25,2,1

9,122,122,11,11,0,1,0
7,133,133,30,19,11,2,1
8,189,189,15,15,0,1,0
3,213,213,8,8,0,1,0
4,267,267,6,1,5,2,1
0,311,311,89,56,33,2,1
6,331,331,7,7,0,1,0
1,336,336,6,1,5,2,1
2,389,389,28,28,0,1,0
10,418,418,49,49,0,1,0
5,482,482,21,21,0,1,0

2,116,116,1,1,0,1,0
7,137,137,21,21,0,1,0
11,168,168,15,15,0,1,0
10,195,195,51,51,0,1,0
8,223,223,18,18,0,1,0
5,236,236,7,7,0,1,0
9,263,263,19,19,0,1,0
0,325,325,33,2,31,2,1
3,358,358,7,7,0,1,0
6,396,396,53,46,7,2,1
4,476,476,23,11,12,3,2
1,488,488,5,5,0,1,0

0,147,147,29,9,20,3,2
7,159,159,30,15,15,4,3
6,169,169,15,2,13,2,1
1,213,213,26,26,0,1,0
9,233,233,20,14,6,3,2
2,294,294,20,4,16,3,2
4,358,358,16,4,12,4,3
3,382,382,24,2,22,3,2
5,424,424,3,3,0,1,0
8,425,425,64,64,0,1,0

7,130,130,24,24,0,1,0
3,198,198,9,2,7,2,1
8,236,236,9,9,0,1,0
2,270,270,3,3,0,1,0
9,271,271,16,16,0,1,0
6,280,280,64,19,45,2,1
5,290,290,89,81,8,3,2
4,332,332,25,2,23,2,1
1,372,372,8,8,0,1,0
0,424,424,18,18,0,1,0

6,153,153,21,13,8,3,2
9,266,266,45,10,35,2,1
0,288,288,21,5,16,4,3
8,307,307,31,31,0,1,0
3,349,349,3,3,0,1,0
1,360,360,6,2,4,2,1
5,385,385,9,9,0,1,0
2,400,400,5,5,0,1,0
7,413,413,93,93,0,1,0
10,454,454,69,42,27,2,1
11,464,464,40,40,0,1,0
4,485,485,2,2,0,1,0

1,164,164,10,10,0,1,0
0,187,187,18,18,0,1,0
7,233,233,3,3,0,1,0
3,273,273,74,30,44,3,2
2,312,312,14,14,0,1,0
4,385,385,3,3,0,1,0
6,390,390,84,47,37,2,1
5,417,417,8,8,0,1,0
9,447,447,52,52,0,1,0
8,453,453,73,13,60,4,3

3,157,157,23,23,0,1,0
5,171,171,31,31,0,1,0
0,272,272,36,36,0,1,0
1,278,278,3,3,0,1,0
6,283,283,53,53,0,1,0
8,298,298,41,3,38,2,1
7,299,299,1,1,0,1,0
2,414,414,64,18,46,3,2
4,414,414,24,8,16,2,1

7,140,140,39,19,20,3,2
2,218,218,1,1,0,1,0
1,259,259,92,71,21,2,1
6,301,301,17,17,0,1,0
8,327,327,36,15,21,4,3
9,329,329,21,9,12,4,3
5,381,381,5,5,0,1,0
3,384,384,2,2,0,1,0
0,465,465,19,4,15,4,3
4,467,467,39,13,26,3,2

0,128,128,7,7,0,1,0
6,173,173,19,19,0,1,0
11,187,187,19,7,12,4,3
8,245,245,85,41,44,2,1
3,251,251,1,1,0,1,0
7,287,287,7,1,6,3,2
9,404,404,4,4,0,1,0
4,425,425,21,21,0,1,0
1,445,445,73,37,36,3,2
2,458,458,12,2,10,2,1
10,494,494,24,6,18,4,3
5,496,496,35,35,0,1,0

7,111,111,29,23,6,2,1
8,127,127,8,2,6,2,1
1,158,158,37,37,0,1,0
2,276,276,6,6,0,1,0
3,419,419,18,18,0,1,0
0,441,441,4,4,0,1,0
4,441,441,85,46,39,2,1
6,448,448,68,6,62,4,3
5,456,456,16,1,15,4,3

4,110,110,2,2,0,1,0
3,188,188,40,8,32,2,1
7,199,199,41,41,0,1,0
0,230,230,17,17,0,1,0
9,324,324,45,3,42,3,2
1,361,361,25,11,14,3,2
2,391,391,18,18,0,1,0
8,406,406,52,52,0,1,0
5,439,439,36,3,33,4,3
6,488,488,16,16,0,1,0

6,191,191,21,21,0,1,0
7,264,264,34,2,32,3,2
11,309,309,13,13,0,1,0
9,356,356,91,5,86,4,3
3,380,380,30,30,0,1,0
1,384,384,8,8,0,1,0
5,385,385,8,8,0,1,0
8,385,385,44,44,0,1,0
4,391,391,43,12,31,3,2
10,395,395,36,2,34,3,2
2,461,461,11,11,0,1,0
0,471,471,4,4,0,1,0

1,113,113,27,19,8,2,1
6,120,120,13,7,6,3,2
4,124,124,16,16,0,1,0
0,163,163,25,2,23,2,1
5,197,197,43,43,0,1,0
2,198,198,6,6,0,1,0
7,350,350,22,16,6,3,2
3,439,439,34,30,4,2,1

1,145,145,11,11,0,1,0
4,145,145,12,12,0,1,0
0,146,146,29,29,0,1,0
3,148,148,29,29,0,1,0
2,205,205,7,3,4,2,1
5,292,292,49,22,27,2,1
7,471,471,3,3,0,1,0
6,498,498,124,124,0,1,0

3,186,186,32,11,21,4,3
5,218,218,67,67,0,1,0
4,234,234,3,3,0,1,0
1,262,262,61,40,21,4,3
0,285,285,77,54,23,2,1
2,408,408,6,2,4,2,1

10,205,205,22,10,12,3,2
8,248,248,44,36,8,3,2
4,271,271,33,33,0,1,0
9,330,330,51,51,0,1,0
6,353,353,2,2,0,1,0
1,395,395,14,14,0,1,0
3,424,424,59,23,36,3,2
2,429,429,65,39,26,2,1
5,435,435,12,12,0,1,0
0,461,461,10,10,0,1,0
7,467,467,32,32,0,1,0

5,130,130,37,37,0,1,0
4,141,141,1,1,0,1,0
3,145,145,15,15,0,1,0
2,198,198,2,2,0,1,0
0,206,206,38,38,0,1,0
6,289,289,34,18,16,3,2
1,500,500,153,131,22,4,3

2,158,158,17,5,12,3,2
3,173,173,26,11,15,2,1
4,192,192,11,11,0,1,0
1,306,306,59,13,46,2,1
0,441,441,221,221,0,1,0

9,148,148,9,5,4,2,1
1,188,188,16,13,3,2,1
7,196,196,44,14,30,3,2
8,202,202,17,7,10,2,1
5,234,234,6,6,0,1,0
0,290,290,10,10,0,1,0
4,306,306,21,9,12,2,1
11,373,373,24,24,0,1,0
6,389,389,2,2,0,1,0
3,395,395,1,1,0,1,0
2,412,412,23,15,8,3,2
10,424,424,126,117,9,4,3

5,123,123,1,1,0,1,0
7,161,161,21,15,6,3,2
10,187,187,23,23,0,1,0
3,270,270,11,11,0,1,0
4,343,343,7,3,4,2,1
8,353,353,25,25,0,1,0
2,378,378,44,24,20,2,1
9,382,382,82,82,0,1,0
11,440,440,44,44,0,1,0
1,465,465,15,15,0,1,0
6,470,470,1,1,0,1,0
0,473,473,71,39,32,2,1

1,226,226,19,13,6,2,1
5,267,267,35,35,0,1,0
2,313,313,50,9,41,4,3
3,343,343,46,46,0,1,0
0,367,367,45,45,0,1,0
4,391,391,89,73,16,2,1
7,434,434,22,1,21,2,1
6,468,468,45,45,0,1,0

1,166,166,3,3,0,1,0
5,180,180,28,7,21,4,3
7,186,186,32,32,0,1,0
4,196,196,21,10,11,2,1
0,356,356,31,3,28,2,1
2,415,415,62,51,11,2,1
3,447,447,110,107,3,2,1
6,476,476,33,33,0,1,0

9,106,106,26,26,0,1,0
5,107,107,15,15,0,1,0
10,141,141,2,2,0,1,0
11,162,162,40,40,0,1,0
6,163,163,11,11,0,1,0
8,167,167,1,1,0,1,0
2,201,201,7,7,0,1,0
1,299,299,4,4,0,1,0
3,337,337,4,4,0,1,0
0,397,397,13,7,6,3,2
12,448,448,4,1,3,2,1
7,464,464,55,2,53,4,3
4,465,465,37,19,18,4,3

0,141,141,20,20,0,1,0
2,282,282,8,8,0,1,0
8,289,289,88,30,58,3,2
3,307,307,1,1,0,1,0
4,313,313,18,18,0,1,0
6,411,411,28,16,12,4,3
5,447,447,26,8,18,2,1
1,460,460,124,79,45,4,3
7,487,487,36,36,0,1,0

0,141,141,13,13,0,1,0
2,161,161,4,4,0,1,0
9,193,193,11,6,5,2,1
7,214,214,25,25,0,1,0
4,223,223,45,3,42,3,2
10,225,225,44,26,18,3,2
3,276,276,14,6,8,2,1
1,413,413,35,20,15,4,3
6,488,488,12,12,0,1,0
8,488,488,68,23,45,4,3
5,498,498,11,2,9,2,1

6,100,100,1,1,0,1,0
3,133,133,2,2,0,1,0
1,177,177,24,24,0,1,0
5,230,230,23,23,0,1,0
0,250,250,60,24,36,4,3
2,277,277,2,2,0,1,0
9,369,369,16,16,0,1,0
8,372,372,19,19,0,1,0
7,395,395,161,131,30,4,3
4,448,448,2,2,0,1,0

4,133,133,27,16,11,2,1
3,165,165,1,1,0,1,0
8,180,180,21,21,0,1,0
7,193,193,3,3,0,1,0
10,247,247,1,1,0,1,0
11,275,275,75,57,18,4,3
1,283,283,1,1,0,1,0
2,287,287,15,15,0,1,0
5,367,367,40,10,30,3,2
6,367,367,32,32,0,1,0
0,442,442,12,12,0,1,0
9,466,466,53,53,0,1,0

7,112,112,1,1,0,1,0
3,167,167,5,5,0,1,0
6,192,192,10,4,6,2,1
9,305,305,11,7,4,2,1
0,329,329,7,1,6,2,1
2,345,345,87,87,0,1,0
1,373,373,5,5,0,1,0
10,384,384,45,30,15,2,1
5,391,391,9,5,4,2,1
12,395,395,93,72,21,2,1
4,407,407,19,19,0,1,0
11,426,426,50,50,0,1,0
8,451,451,24,5,19,2,1

5,158,158,45,45,0,1,0
4,229,229,10,10,0,1,0
2,268,268,61,61,0,1,0
3,321,321,38,14,24,3,2
0,390,390,60,3,57,4,3
6,414,414,30,5,25,4,3
1,419,419,1,1,0,1,0
7,484,484,51,23,28,2,1

5,101,101,15,5,10,3,2
6,140,140,4,4,0,1,0
9,226,226,86,86,0,1,0
2,291,291,3,3,0,1,0
3,306,306,21,5,16,3,2
7,361,361,4,4,0,1,0
8,377,377,34,27,7,2,1
1,387,387,39,15,24,3,2
0,480,480,71,2,69,3,2
4,492,492,14,2,12,2,1

5,129,129,8,8,0,1,0
8,200,200,41,41,0,1,0
2,212,212,8,8,0,1,0
4,242,242,14,14,0,1,0
0,247,247,2,2,0,1,0
6,314,314,11,11,0,1,0
11,316,316,16,16,0,1,0
9,344,344,71,71,0,1,0
10,355,355,15,15,0,1,0
7,371,371,48,16,32,2,1
1,425,425,18,18,0,1,0
3,427,427,55,41,14,2,1

7,147,147,44,2,42,2,1
3,158,158,28,3,25,2,1
5,159,159,16,8,8,3,2
0,225,225,62,62,0,1,0
2,248,248,1,1,0,1,0
8,381,381,36,36,0,1,0
4,472,472,8,2,6,3,2
6,490,490,7,3,4,2,1
1,491,491,13,9,4,2,1

0,117,117,23,23,0,1,0
1,241,241,74,74,0,1,0
3,299,299,1,1,0,1,0
5,305,305,17,5,12,2,1
2,391,391,26,26,0,1,0
4,414,414,157,127,30,4,3

2,127,127,5,5,0,1,0
7,164,164,20,20,0,1,0
3,176,176,1,1,0,1,0
10,206,206,31,31,0,1,0
0,284,284,33,22,11,2,1
1,301,301,1,1,0,1,0
8,326,326,68,68,0,1,0
5,357,357,95,32,63,3,2
4,361,361,11,11,0,1,0
6,385,385,15,7,8,2,1
9,446,446,13,5,8,3,2

4,122,122,3,3,0,1,0
5,131,131,12,12,0,1,0
6,133,133,5,1,4,2,1
1,255,255,69,69,0,1,0
2,306,306,2,2,0,1,0
3,368,368,33,3,30,2,1
7,425,425,12,6,6,2,1
8,432,432,150,150,0,1,0
0,496,496,54,54,0,1,0

1,174,174,39,1,38,3,2
2,215,215,18,18,0,1,0
0,222,222,8,5,3,2,1
5,281,281,7,7,0,1,0
3,286,286,33,1,32,2,1
8,325,325,90,90,0,1,0
4,340,340,6,6,0,1,0
9,398,398,15,8,7,2,1
7,492,492,16,16,0,1,0
6,500,500,80,80,0,1,0

3,103,103,1,1,0,1,0
5,257,257,95,95,0,1,0
7,283,283,33,25,8,2,1
0,331,331,53,32,21,2,1
1,401,401,27,27,0,1,0
2,403,403,107,107,0,1,0
6,445,445,5,5,0,1,0
4,499,499,4,4,0,1,0

7,134,134,26,11,15,2,1
10,199,199,9,1,8,2,1
5,237,237,17,8,9,4,3
0,246,246,10,10,0,1,0
11,247,247,17,8,9,4,3
8,255,255,62,12,50,3,2
3,281,281,21,18,3,2,1
6,291,291,8,2,6,2,1
1,296,296,15,15,0,1,0
9,351,351,52,52,0,1,0
4,373,373,12,12,0,1,0
2,396,396,6,6,0,1,0

10,128,128,5,5,0,1,0
4,141,141,20,20,0,1,0
13,157,157,37,37,0,1,0
1,161,161,11,11,0,1,0
5,191,191,12,4,8,3,2
7,236,236,19,12,7,2,1
11,323,323,7,7,0,1,0
9,328,328,17,17,0,1,0
0,363,363,1,1,0,1,0
2,417,417,1,1,0,1,0
8,449,449,7,2,5,2,1
6,472,472,8,2,6,3,2
12,477,477,103,103,0,1,0
3,490,490,28,1,27,2,1

8,107,107,43,43,0,1,0
7,212,212,6,6,0,1,0
5,243,243,2,2,0,1,0
3,296,296,40,40,0,1,0
4,307,307,15,8,7,2,1
6,343,343,25,16,9,2,1
0,351,351,97,67,30,2,1
1,352,352,4,4,0,1,0
2,431,431,13,3,10,2,1

7,103,103,2,2,0,1,0
6,115,115,3,3,0,1,0
12,200,200,56,2,54,4,3
2,231,231,6,6,0,1,0
5,240,240,21,21,0,1,0
0,256,256,1,1,0,1,0
1,302,302,10,1,9,4,3
8,359,359,18,18,0,1,0
3,360,360,11,11,0,1,0
4,377,377,22,22,0,1,0
10,395,395,20,20,0,1,0
14,437,437,82,82,0,1,0
13,446,446,8,8,0,1,0
9,463,463,54,54,0,1,0
11,487,487,10,10,0,1,0

4,135,135,29,7,22,3,2
3,182,182,9,9,0,1,0
7,184,184,4,4,0,1,0
5,280,280,25,7,18,3,2
8,333,333,1,1,0,1,0
1,344,344,6,6,0,1,0
0,347,347,39,39,0,1,0
6,415,415,163,159,4,2,1
2,463,463,51,51,0,1,0

5,146,146,26,26,0,1,0
1,152,152,4,4,0,1,0
4,192,192,34,20,14,3,2
7,217,217,32,32,0,1,0
8,223,223,21,1,20,2,1
2,372,372,75,36,39,4,3
3,388,388,18,2,16,2,1
0,446,446,23,23,0,1,0
6,461,461,40,4,36,3,2

6,140,140,13,13,0,1,0
0,215,215,7,7,0,1,0
8,221,221,5,5,0,1,0
7,266,266,47,31,16,3,2
1,302,302,44,44,0,1,0
3,332,332,18,15,3,2,1
2,343,343,1,1,0,1,0
4,373,373,43,7,36,2,1
5,488,488,73,52,21,4,3
9,499,499,108,108,0,1,0

6,103,103,20,7,13,2,1
1,136,136,35,3,32,3,2
3,150,150,10,1,9,2,1
0,157,157,8,5,3,2,1
8,226,226,24,24,0,1,0
5,252,252,15,3,12,2,1
7,286,286,44,18,26,4,3
2,371,371,32,32,0,1,0
4,462,462,18,18,0,1,0

4,183,183,16,16,0,1,0
2,206,206,64,9,55,4,3
0,263,263,4,4,0,1,0
5,316,316,46,25,21,4,3
3,358,358,88,70,18,4,3
1,388,388,68,50,18,4,3
6,453,453,12,2,10,2,1

0,142,142,6,6,0,1,0
2,150,150,13,13,0,1,0
3,157,157,6,6,0,1,0
5,325,325,70,27,43,4,3
9,348,348,90,90,0,1,0
8,365,365,68,4,64,3,2
7,426,426,10,10,0,1,0
4,461,461,43,43,0,1,0
1,474,474,12,12,0,1,0
6,490,490,17,9,8,3,2

0,176,176,4,4,0,1,0
2,219,219,2,2,0,1,0
1,228,228,2,2,0,1,0
11,252,252,16,16,0,1,0
12,262,262,69,69,0,1,0
9,294,294,6,3,3,2,1
7,303,303,23,9,14,3,2
3,327,327,5,5,0,1,0
13,330,330,43,29,14,2,1
8,406,406,45,45,0,1,0
4,417,417,7,1,6,2,1
6,423,423,83,38,45,4,3
5,458,458,12,6,6,2,1
10,478,478,24,24,0,1,0

3,128,128,6,6,0,1,0
4,140,140,3,3,0,1,0
2,151,151,15,1,14,2,1
8,231,231,8,8,0,1,0
1,275,275,5,5,0,1,0
13,291,291,82,61,21,2,1
7,322,322,1,1,0,1,0
11,323,323,5,5,0,1,0
0,334,334,49,35,14,3,2
5,349,349,26,16,10,2,1
6,355,355,5,5,0,1,0
12,365,365,33,4,29,2,1
9,413,413,17,17,0,1,0
10,452,452,53,35,18,4,3

6,109,109,6,6,0,1,0
1,229,229,22,16,6,2,1
5,262,262,5,5,0,1,0
4,303,303,37,11,26,2,1
0,416,416,29,29,0,1,0
3,420,420,135,35,100,4,3
7,467,467,149,95,54,4,3
2,498,498,7,7,0,1,0

8,108,108,14,2,12,2,1
5,148,148,12,2,10,3,2
1,167,167,7,7,0,1,0
13,218,218,34,3,31,3,2
9,234,234,6,6,0,1,0
10,237,237,4,4,0,1,0
12,239,239,30,30,0,1,0
0,266,266,1,1,0,1,0
2,314,314,3,3,0,1,0
6,318,318,18,1,17,2,1
3,341,341,3,3,0,1,0
11,428,428,89,89,0,1,0
7,444,444,47,47,0,1,0
4,481,481,19,9,10,2,1

1,139,139,20,20,0,1,0
5,161,161,23,23,0,1,0
3,231,231,61,33,28,2,1
6,257,257,25,6,19,2,1
2,291,291,86,81,5,2,1
0,332,332,21,8,13,2,1
4,484,484,2,2,0,1,0

1,141,141,15,15,0,1,0
8,174,174,16,12,4,2,1
9,184,184,15,15,0,1,0
5,190,190,20,6,14,2,1
0,215,215,32,19,13,2,1
7,233,233,64,42,22,4,3
4,238,238,15,15,0,1,0
2,318,318,4,4,0,1,0
6,346,346,20,20,0,1,0
3,360,360,3,3,0,1,0
10,397,397,24,24,0,1,0

8,187,187,64,38,26,2,1
2,190,190,9,9,0,1,0
5,191,191,3,3,0,1,0
1,216,216,60,42,18,3,2
0,238,238,6,6,0,1,0
7,272,272,27,27,0,1,0
6,295,295,17,17,0,1,0
3,342,342,42,42,0,1,0
4,353,353,10,2,8,3,2

2,106,106,2,2,0,1,0
10,183,183,15,15,0,1,0
3,201,201,26,26,0,1,0
1,221,221,12,12,0,1,0
13,226,226,29,8,21,4,3
6,251,251,3,3,0,1,0
0,281,281,40,40,0,1,0
9,342,342,9,9,0,1,0
8,403,403,8,8,0,1,0
5,408,408,4,1,3,2,1
11,417,417,36,36,0,1,0
4,429,429,26,7,19,2,1
12,434,434,91,25,66,3,2
7,482,482,13,4,9,4,3

4,134,134,6,6,0,1,0
6,228,228,8,2,6,3,2
8,265,265,45,45,0,1,0
7,283,283,4,4,0,1,0
9,333,333,97,41,56,3,2
3,400,400,59,59,0,1,0
0,430,430,34,10,24,2,1
2,436,436,62,53,9,4,3
1,438,438,7,7,0,1,0
5,478,478,34,20,14,3,2

4,103,103,15,15,0,1,0
6,145,145,38,38,0,1,0
5,150,150,8,4,4,2,1
3,189,189,16,16,0,1,0
0,213,213,40,8,32,2,1
2,273,273,9,9,0,1,0
7,360,360,55,55,0,1,0
1,465,465,26,26,0,1,0
8,466,466,20,20,0,1,0

0,189,189,11,11,0,1,0
7,220,220,9,9,0,1,0
5,238,238,8,5,3,2,1
11,244,244,7,7,0,1,0
6,260,260,14,1,13,3,2
1,309,309,23,5,18,3,2
4,348,348,2,2,0,1,0
10,369,369,75,46,29,2,1
2,370,370,44,44,0,1,0
9,402,402,16,16,0,1,0
3,428,428,50,50,0,1,0
8,446,446,104,104,0,1,0

5,115,115,5,5,0,1,0
6,120,120,3,3,0,1,0
2,235,235,12,2,10,2,1
1,236,236,47,47,0,1,0
0,256,256,64,64,0,1,0
4,462,462,151,151,0,1,0
3,468,468,55,25,30,2,1

2,106,106,1,1,0,1,0
8,106,106,5,5,0,1,0
3,184,184,1,1,0,1,0
4,185,185,7,7,0,1,0
1,190,190,24,16,8,2,1
7,244,244,13,13,0,1,0
0,268,268,78,40,38,4,3
6,289,289,1,1,0,1,0
10,306,306,124,124,0,1,0
5,335,335,9,9,0,1,0
9,451,451,2,2,0,1,0

6,113,113,6,6,0,1,0
5,124,124,16,6,10,2,1
2,193,193,32,32,0,1,0
8,196,196,16,16,0,1,0
7,199,199,39,36,3,2,1
9,255,255,46,46,0,1,0
1,418,418,34,34,0,1,0
4,444,444,29,7,22,4,3
0,461,461,2,2,0,1,0
3,493,493,30,30,0,1,0

5,189,189,4,4,0,1,0
9,305,305,21,3,18,2,1
0,364,364,20,20,0,1,0
11,370,370,43,19,24,3,2
3,371,371,44,44,0,1,0
7,375,375,17,17,0,1,0
8,421,421,114,31,83,4,3
6,426,426,2,2,0,1,0
1,432,432,41,41,0,1,0
4,444,444,30,30,0,1,0
10,446,446,23,23,0,1,0
2,476,476,45,39,6,3,2

8,115,115,23,23,0,1,0
7,116,116,1,1,0,1,0
11,119,119,15,10,5,2,1
0,148,148,8,8,0,1,0
2,192,192,25,25,0,1,0
3,192,192,14,14,0,1,0
6,196,196,7,7,0,1,0
5,313,313,12,12,0,1,0
1,325,325,47,47,0,1,0
9,342,342,10,10,0,1,0
4,344,344,8,1,7,2,1
10,487,487,75,75,0,1,0

7,132,132,17,17,0,1,0
11,133,133,7,7,0,1,0
3,137,137,4,4,0,1,0
0,155,155,1,1,0,1,0
8,173,173,29,29,0,1,0
2,184,184,5,1,4,2,1
10,222,222,73,15,58,3,2
13,224,224,26,26,0,1,0
12,308,308,4,4,0,1,0
4,326,326,4,4,0,1,0
1,365,365,7,7,0,1,0
6,406,406,41,41,0,1,0
5,416,416,3,3,0,1,0
9,447,447,1,1,0,1,0

3,126,126,10,1,9,4,3
2,179,179,32,7,25,2,1
7,203,203,35,29,6,3,2
0,212,212,5,5,0,1,0
1,237,237,1,1,0,1,0
6,320,320,41,41,0,1,0
5,330,330,30,30,0,1,0
8,393,393,19,19,0,1,0
4,402,402,50,12,38,2,1
9,481,481,75,50,25,2,1

3,110,110,19,19,0,1,0
1,113,113,15,15,0,1,0
5,155,155,13,13,0,1,0
6,216,216,6,6,0,1,0
4,239,239,10,10,0,1,0
2,275,275,22,12,10,2,1
7,383,383,135,77,58,4,3
0,389,389,46,2,44,2,1

1,111,111,15,15,0,1,0
5,183,183,9,5,4,2,1
8,282,282,45,45,0,1,0
0,321,321,28,21,7,2,1
7,383,383,12,3,9,2,1
4,401,401,6,6,0,1,0
6,406,406,30,30,0,1,0
10,430,430,100,64,36,2,1
2,466,466,62,62,0,1,0
9,478,478,39,29,10,2,1
3,489,489,4,1,3,2,1

3,256,256,38,8,30,2,1
5,340,340,26,21,5,2,1
2,350,350,103,28,75,4,3
6,409,409,112,78,34,2,1
4,424,424,3,3,0,1,0
1,471,471,72,72,0,1,0
0,494,494,27,13,14,2,1

1,101,101,13,13,0,1,0
4,177,177,24,24,0,1,0
0,258,258,80,29,51,4,3
2,329,329,21,5,16,3,2
6,333,333,46,46,0,1,0
3,451,451,57,57,0,1,0
5,454,454,50,50,0,1,0

6,114,114,1,1,0,1,0
9,191,191,29,1,28,2,1
2,240,240,4,4,0,1,0
1,256,256,52,16,36,2,1
7,272,272,50,50,0,1,0
10,315,315,26,26,0,1,0
8,338,338,31,31,0,1,0
4,400,400,1,1,0,1,0
0,414,414,60,60,0,1,0
3,469,469,15,15,0,1,0
5,488,488,45,9,36,2,1

6,206,206,20,20,0,1,0
3,309,309,10,4,6,3,2
7,318,318,47,47,0,1,0
0,339,339,21,13,8,3,2
1,386,386,69,20,49,2,1
2,395,395,10,4,6,3,2
8,405,405,7,7,0,1,0
5,418,418,78,78,0,1,0
9,427,427,105,105,0,1,0
4,475,475,8,4,4,2,1

2,145,145,34,7,27,2,1
0,301,301,34,34,0,1,0
3,362,362,18,18,0,1,0
1,365,365,142,102,40,4,3
4,410,410,69,5,64,3,2
5,455,455,27,27,0,1,0

7,146,146,29,29,0,1,0
2,167,167,2,2,0,1,0
3,174,174,43,16,27,2,1
8,178,178,1,1,0,1,0
6,208,208,49,26,23,2,1
1,220,220,4,4,0,1,0
4,364,364,76,76,0,1,0
5,400,400,29,29,0,1,0
0,464,464,7,1,6,3,2

2,115,115,2,2,0,1,0
5,148,148,19,19,0,1,0
4,177,177,32,2,30,4,3
3,287,287,14,14,0,1,0
0,425,425,105,9,96,3,2
6,451,451,71,35,36,3,2
1,498,498,121,71,50,3,2

3,103,103,1,1,0,1,0
2,108,108,18,18,0,1,0
0,166,166,8,8,0,1,0
7,186,186,63,26,37,2,1
8,192,192,9,9,0,1,0
4,222,222,43,22,21,2,1
5,312,312,34,8,26,3,2
1,383,383,33,33,0,1,0
6,439,439,6,6,0,1,0

3,103,103,14,10,4,2,1
7,177,177,3,3,0,1,0
1,197,197,4,4,0,1,0
5,222,222,38,38,0,1,0
2,266,266,1,1,0,1,0
8,303,303,37,7,30,2,1
4,347,347,49,8,41,3,2
0,402,402,80,12,68,3,2
6,433,433,85,85,0,1,0

12,163,163,18,18,0,1,0
2,204,204,1,1,0,1,0
4,274,274,2,2,0,1,0
5,279,279,6,3,3,2,1
9,291,291,20,2,18,3,2
1,294,294,18,18,0,1,0
13,322,322,1,1,0,1,0
3,343,343,16,4,12,3,2
11,344,344,84,18,66,4,3
6,388,388,1,1,0,1,0
0,413,413,28,28,0,1,0
8,417,417,49,11,38,4,3
7,422,422,43,13,30,2,1
10,455,455,67,55,12,2,1

1,277,277,51,51,0,1,0
7,296,296,7,3,4,2,1
2,305,305,34,34,0,1,0
5,312,312,54,35,19,2,1
6,323,323,98,17,81,4,3
3,334,334,36,31,5,2,1
4,335,335,2,2,0,1,0
0,344,344,34,10,24,4,3

9,137,137,5,5,0,1,0
6,153,153,3,3,0,1,0
5,167,167,5,5,0,1,0
8,171,171,10,3,7,2,1
2,235,235,23,6,17,2,1
7,250,250,14,14,0,1,0
1,253,253,8,8,0,1,0
13,253,253,52,52,0,1,0
12,322,322,78,62,16,3,2
10,386,386,7,7,0,1,0
0,446,446,56,47,9,2,1
4,446,446,19,19,0,1,0
11,457,457,17,17,0,1,0
3,486,486,1,1,0,1,0

8,136,136,1,1,0,1,0
3,141,141,1,1,0,1,0
5,158,158,1,1,0,1,0
11,159,159,1,1,0,1,0
2,180,180,7,7,0,1,0
0,207,207,20,5,15,3,2
9,208,208,12,4,8,2,1
1,212,212,1,1,0,1,0
10,212,212,39,3,36,2,1
12,213,213,7,2,5,2,1
15,310,310,114,75,39,4,3
7,329,329,4,1,3,2,1
13,348,348,5,5,0,1,0
6,403,403,18,18,0,1,0
4,430,430,15,15,0,1,0
14,484,484,43,43,0,1,0

8,107,107,25,25,0,1,0
6,147,147,10,2,8,3,2
5,159,159,28,22,6,2,1
0,217,217,62,62,0,1,0
7,258,258,9,1,8,2,1
4,263,263,16,16,0,1,0
3,304,304,13,7,6,2,1
2,353,353,16,7,9,4,3
1,402,402,27,8,19,2,1

3,160,160,32,32,0,1,0
0,164,164,2,2,0,1,0
8,173,173,32,32,0,1,0
9,239,239,5,5,0,1,0
5,258,258,2,2,0,1,0
6,266,266,56,56,0,1,0
7,275,275,25,25,0,1,0
2,336,336,63,63,0,1,0
4,383,383,1,1,0,1,0
1,489,489,45,13,32,3,2

9,187,187,15,9,6,2,1
2,217,217,50,33,17,2,1
0,262,262,31,31,0,1,0
4,280,280,7,3,4,2,1
5,374,374,18,18,0,1,0
1,382,382,3,3,0,1,0
6,434,434,52,52,0,1,0
8,473,473,55,1,54,4,3
3,494,494,36,36,0,1,0
7,500,500,94,40,54,4,3

6,138,138,3,3,0,1,0
1,173,173,50,50,0,1,0
0,185,185,4,4,0,1,0
8,190,190,75,75,0,1,0
10,194,194,4,4,0,1,0
3,238,238,26,13,13,2,1
4,243,243,6,2,4,2,1
11,274,274,3,3,0,1,0
2,364,364,5,1,4,2,1
5,395,395,2,2,0,1,0
7,401,401,6,6,0,1,0
9,433,433,34,20,14,3,2

9,187,187,48,48,0,1,0
1,263,263,11,4,7,2,1
8,263,263,35,19,16,3,2
0,290,290,30,22,8,2,1
7,294,294,18,18,0,1,0
5,311,311,33,33,0,1,0
2,363,363,60,60,0,1,0
4,397,397,7,7,0,1,0
6,425,425,23,4,19,2,1
3,494,494,33,9,24,2,1

3,147,147,14,14,0,1,0
4,188,188,43,43,0,1,0
1,209,209,11,11,0,1,0
2,378,378,1,1,0,1,0
0,425,425,149,125,24,4,3
6,457,457,95,2,93,4,3
5,471,471,1,1,0,1,0
7,489,489,32,11,21,4,3

