14,129,129,4,4,0,1,0
3,133,133,63,63,0,1,0
23,155,155,21,17,4,2,1
13,158,158,3,3,0,1,0
21,161,161,102,20,82,3,2
2,177,177,9,6,3,2,1
26,199,199,3,3,0,1,0
9,208,208,57,57,0,1,0
6,212,212,38,1,37,2,1
0,238,238,3,3,0,1,0
29,241,241,1,1,0,1,0
11,246,246,8,4,4,2,1
18,251,251,21,11,10,2,1
25,252,252,19,19,0,1,0
12,267,267,15,2,13,2,1
19,269,269,40,40,0,1,0
22,336,336,50,44,6,3,2
10,345,345,29,29,0,1,0
8,372,372,56,56,0,1,0
27,376,376,19,5,14,3,2
28,393,393,6,2,4,2,1
24,410,410,5,5,0,1,0
20,414,414,39,39,0,1,0
1,415,415,163,58,105,4,3
16,431,431,91,91,0,1,0
7,452,452,25,25,0,1,0
4,457,457,24,1,23,3,2
17,462,462,23,23,0,1,0
15,474,474,28,28,0,1,0
5,482,482,21,21,0,1,0

5,109,109,4,4,0,1,0
27,114,114,2,2,0,1,0
0,120,120,10,4,6,3,2
1,127,127,7,7,0,1,0
17,133,133,5,5,0,1,0
12,137,137,26,22,4,2,1
19,144,144,8,4,4,2,1
23,147,147,38,8,30,2,1
7,167,167,14,14,0,1,0
35,169,169,6,1,5,2,1
3,176,176,26,26,0,1,0
22,179,179,9,6,3,2,1
2,180,180,56,56,0,1,0
34,199,199,37,37,0,1,0
15,203,203,3,3,0,1,0
30,212,212,9,9,0,1,0
28,224,224,67,22,45,3,2
29,229,229,23,23,0,1,0
14,238,238,1,1,0,1,0
31,247,247,16,7,9,2,1
33,251,251,31,4,27,4,3
24,253,253,1,1,0,1,0
9,256,256,35,35,0,1,0
10,258,258,34,34,0,1,0
20,283,283,34,26,8,3,2
13,332,332,33,33,0,1,0
16,334,334,11,5,6,3,2
25,335,335,74,23,51,4,3
6,364,364,12,12,0,1,0
4,400,400,98,86,12,2,1
32,415,415,36,36,0,1,0
26,418,418,59,31,28,2,1
18,443,443,6,6,0,1,0
11,469,469,38,38,0,1,0
8,475,475,38,38,0,1,0
21,483,483,13,4,9,4,3

29,112,112,1,1,0,1,0
5,151,151,3,3,0,1,0
4,159,159,17,17,0,1,0
7,159,159,17,5,12,3,2
1,164,164,43,43,0,1,0
14,169,169,3,3,0,1,0
6,194,194,9,3,6,2,1
9,204,204,14,14,0,1,0
17,217,217,14,2,12,2,1
20,221,221,10,2,8,2,1
18,223,223,61,61,0,1,0
3,223,223,26,26,0,1,0
19,227,227,17,17,0,1,0
16,240,240,10,10,0,1,0
10,263,263,19,7,12,4,3
24,273,273,1,1,0,1,0
15,288,288,19,19,0,1,0
22,317,317,177,177,0,1,0
13,364,364,88,88,0,1,0
2,372,372,48,48,0,1,0
28,381,381,8,2,6,2,1
8,384,384,134,126,8,2,1
12,390,390,24,9,15,4,3
23,391,391,69,9,60,3,2
26,405,405,5,5,0,1,0
25,430,430,11,11,0,1,0
21,433,433,52,52,0,1,0
27,435,435,6,6,0,1,0
11,475,475,108,108,0,1,0
0,486,486,144,64,80,3,2

8,111,111,4,4,0,1,0
19,118,118,12,3,9,2,1
45,123,123,8,3,5,2,1
18,132,132,2,2,0,1,0
23,149,149,5,5,0,1,0
11,171,171,7,7,0,1,0
17,182,182,11,11,0,1,0
26,191,191,11,11,0,1,0
41,191,191,20,2,18,2,1
7,193,193,37,37,0,1,0
31,198,198,14,14,0,1,0
14,203,203,20,4,16,2,1
10,209,209,1,1,0,1,0
38,210,210,57,10,47,2,1
34,211,211,76,47,29,2,1
27,217,217,11,5,6,2,1
16,224,224,16,16,0,1,0
37,230,230,9,9,0,1,0
21,236,236,5,5,0,1,0
32,240,240,14,5,9,2,1
30,242,242,35,35,0,1,0
0,246,246,5,5,0,1,0
35,269,269,27,6,21,2,1
15,281,281,5,2,3,2,1
3,288,288,10,1,9,3,2
20,296,296,50,50,0,1,0
4,301,301,12,12,0,1,0
2,303,303,1,1,0,1,0
6,306,306,5,5,0,1,0
36,315,315,4,1,3,2,1
47,324,324,21,7,14,4,3
42,341,341,26,1,25,4,3
24,347,347,9,5,4,2,1
46,360,360,19,9,10,3,2
33,368,368,18,18,0,1,0
9,370,370,23,23,0,1,0
43,387,387,43,21,22,4,3
12,394,394,84,12,72,4,3
28,395,395,14,14,0,1,0
25,404,404,10,4,6,3,2
39,406,406,20,17,3,2,1
5,413,413,2,2,0,1,0
40,425,425,27,6,21,2,1
44,441,441,63,19,44,2,1
1,461,461,45,45,0,1,0
29,484,484,23,7,16,3,2
13,496,496,10,10,0,1,0
22,499,499,92,30,62,3,2

0,105,105,14,14,0,1,0
9,126,126,9,9,0,1,0
41,128,128,20,20,0,1,0
27,135,135,20,10,10,3,2
32,164,164,55,55,0,1,0
25,191,191,6,6,0,1,0
37,198,198,26,26,0,1,0
28,200,200,17,12,5,2,1
26,206,206,10,10,0,1,0
36,214,214,14,2,12,2,1
12,222,222,14,14,0,1,0
1,226,226,9,6,3,2,1
17,242,242,1,1,0,1,0
13,243,243,1,1,0,1,0
20,246,246,43,43,0,1,0
35,246,246,24,6,18,3,2
24,248,248,28,28,0,1,0
11,283,283,90,90,0,1,0
18,292,292,17,9,8,2,1
39,296,296,9,4,5,2,1
7,306,306,11,6,5,2,1
30,307,307,10,4,6,3,2
33,317,317,8,8,0,1,0
40,317,317,22,22,0,1,0
6,323,323,2,2,0,1,0
14,336,336,19,19,0,1,0
23,344,344,21,15,6,2,1
22,350,350,55,9,46,4,3
16,356,356,26,26,0,1,0
4,358,358,16,16,0,1,0
21,362,362,13,13,0,1,0
10,380,380,11,11,0,1,0
8,389,389,4,1,3,2,1
3,392,392,37,37,0,1,0
5,404,404,1,1,0,1,0
38,405,405,86,82,4,2,1
34,413,413,27,7,20,3,2
29,439,439,42,42,0,1,0
31,439,439,41,41,0,1,0
15,446,446,46,46,0,1,0
2,475,475,16,6,10,2,1
19,498,498,95,64,31,2,1

16,111,111,27,13,14,3,2
29,113,113,19,4,15,4,3
28,134,134,5,5,0,1,0
22,155,155,10,2,8,2,1
0,162,162,14,14,0,1,0
32,177,177,10,4,6,2,1
4,178,178,9,2,7,2,1
26,178,178,4,1,3,2,1
5,183,183,8,8,0,1,0
31,187,187,2,2,0,1,0
7,195,195,5,5,0,1,0
8,226,226,29,29,0,1,0
12,233,233,7,2,5,2,1
18,242,242,16,6,10,3,2
40,274,274,32,32,0,1,0
10,289,289,3,3,0,1,0
39,293,293,32,32,0,1,0
24,293,293,22,22,0,1,0
23,302,302,35,26,9,4,3
13,305,305,17,14,3,2,1
34,318,318,45,45,0,1,0
36,327,327,11,11,0,1,0
2,336,336,24,3,21,2,1
19,349,349,2,2,0,1,0
6,353,353,10,2,8,3,2
27,353,353,95,83,12,3,2
30,367,367,53,53,0,1,0
37,367,367,34,11,23,4,3
3,371,371,61,61,0,1,0
38,381,381,66,12,54,3,2
33,393,393,74,74,0,1,0
25,395,395,4,4,0,1,0
11,424,424,35,11,24,3,2
21,433,433,5,5,0,1,0
15,441,441,10,10,0,1,0
20,448,448,34,23,11,2,1
9,448,448,77,11,66,3,2
1,471,471,1,1,0,1,0
14,487,487,97,72,25,2,1
35,490,490,33,2,31,4,3
17,493,493,79,67,12,4,3

37,108,108,10,6,4,2,1
18,116,116,1,1,0,1,0
15,134,134,1,1,0,1,0
19,139,139,3,3,0,1,0
10,139,139,5,1,4,2,1
3,141,141,17,17,0,1,0
25,141,141,11,3,8,2,1
32,141,141,39,39,0,1,0
5,143,143,19,19,0,1,0
27,153,153,24,24,0,1,0
29,164,164,22,10,12,3,2
20,169,169,4,4,0,1,0
35,181,181,24,10,14,2,1
36,189,189,29,29,0,1,0
33,227,227,2,2,0,1,0
24,237,237,18,18,0,1,0
28,269,269,17,17,0,1,0
34,284,284,19,15,4,2,1
31,285,285,9,9,0,1,0
11,292,292,17,17,0,1,0
40,299,299,34,8,26,3,2
14,304,304,87,45,42,2,1
22,308,308,18,18,0,1,0
9,308,308,87,87,0,1,0
13,309,309,7,7,0,1,0
38,312,312,49,49,0,1,0
39,339,339,5,5,0,1,0
7,358,358,8,8,0,1,0
16,367,367,2,2,0,1,0
0,377,377,51,3,48,2,1
23,381,381,68,68,0,1,0
4,383,383,70,52,18,2,1
6,386,386,14,2,12,2,1
17,417,417,23,5,18,2,1
12,418,418,57,25,32,3,2
30,431,431,43,43,0,1,0
8,435,435,3,3,0,1,0
26,447,447,4,4,0,1,0
1,455,455,4,1,3,2,1
2,472,472,72,45,27,2,1
21,497,497,1,1,0,1,0

4,107,107,13,13,0,1,0
13,108,108,1,1,0,1,0
30,115,115,6,6,0,1,0
11,120,120,4,4,0,1,0
23,133,133,3,3,0,1,0
19,155,155,9,9,0,1,0
28,156,156,11,11,0,1,0
6,164,164,14,9,5,2,1
20,171,171,26,21,5,2,1
33,174,174,17,17,0,1,0
22,203,203,14,4,10,3,2
5,206,206,38,38,0,1,0
26,207,207,21,9,12,4,3
9,209,209,43,43,0,1,0
32,220,220,32,1,31,2,1
17,239,239,15,15,0,1,0
29,245,245,22,15,7,2,1
35,254,254,80,32,48,3,2
10,271,271,24,24,0,1,0
16,283,283,9,3,6,2,1
18,292,292,55,12,43,2,1
8,336,336,22,22,0,1,0
0,344,344,33,12,21,2,1
12,348,348,23,23,0,1,0
15,349,349,13,8,5,2,1
2,350,350,32,11,21,4,3
21,382,382,21,3,18,3,2
3,392,392,51,6,45,2,1
24,400,400,35,35,0,1,0
7,430,430,79,79,0,1,0
31,432,432,25,25,0,1,0
25,441,441,2,2,0,1,0
1,456,456,38,11,27,2,1
27,461,461,113,113,0,1,0
34,474,474,10,10,0,1,0
14,496,496,113,110,3,2,1

28,133,133,6,2,4,2,1
15,145,145,3,3,0,1,0
20,145,145,22,13,9,2,1
10,148,148,10,4,6,2,1
12,165,165,3,3,0,1,0
33,174,174,23,23,0,1,0
34,180,180,25,2,23,3,2
23,188,188,9,9,0,1,0
25,191,191,33,28,5,2,1
3,192,192,1,1,0,1,0
18,198,198,1,1,0,1,0
24,251,251,13,13,0,1,0
13,261,261,18,18,0,1,0
6,284,284,36,4,32,3,2
16,293,293,10,3,7,2,1
19,294,294,1,1,0,1,0
7,302,302,11,1,10,3,2
0,306,306,108,37,71,4,3
2,323,323,29,29,0,1,0
29,337,337,78,78,0,1,0
31,342,342,33,33,0,1,0
5,349,349,16,16,0,1,0
26,353,353,25,25,0,1,0
9,359,359,21,21,0,1,0
8,370,370,104,104,0,1,0
14,374,374,50,25,25,4,3
32,375,375,20,14,6,2,1
30,380,380,52,52,0,1,0
22,389,389,62,62,0,1,0
1,395,395,45,17,28,3,2
21,398,398,45,36,9,2,1
11,462,462,121,91,30,2,1
27,475,475,6,6,0,1,0
17,477,477,104,104,0,1,0
4,489,489,42,42,0,1,0

39,106,106,13,6,7,2,1
23,112,112,31,4,27,4,3
11,120,120,16,16,0,1,0
21,129,129,2,2,0,1,0
26,136,136,25,1,24,2,1
38,161,161,20,10,10,2,1
3,167,167,19,2,17,2,1
35,172,172,7,7,0,1,0
0,192,192,1,1,0,1,0
2,194,194,21,21,0,1,0
40,200,200,7,7,0,1,0
28,202,202,34,34,0,1,0
24,202,202,4,1,3,2,1
9,215,215,48,9,39,4,3
7,228,228,1,1,0,1,0
29,239,239,5,2,3,2,1
8,243,243,29,10,19,2,1
32,243,243,16,13,3,2,1
37,248,248,6,6,0,1,0
1,259,259,10,10,0,1,0
20,260,260,24,8,16,3,2
10,262,262,7,3,4,2,1
17,263,263,11,11,0,1,0
25,271,271,84,84,0,1,0
31,273,273,31,10,21,4,3
19,275,275,11,11,0,1,0
27,330,330,3,3,0,1,0
5,336,336,19,19,0,1,0
30,356,356,9,6,3,2,1
16,379,379,37,37,0,1,0
6,389,389,63,23,40,2,1
14,393,393,19,19,0,1,0
22,399,399,1,1,0,1,0
12,413,413,5,5,0,1,0
36,436,436,5,5,0,1,0
18,442,442,62,62,0,1,0
15,456,456,2,2,0,1,0
34,470,470,49,22,27,2,1
13,472,472,77,71,6,2,1
4,478,478,72,50,22,3,2
33,479,479,84,16,68,3,2

9,115,115,4,4,0,1,0
10,118,118,13,6,7,2,1
15,150,150,43,28,15,2,1
14,175,175,11,11,0,1,0
23,181,181,4,4,0,1,0
20,184,184,16,16,0,1,0
28,202,202,21,21,0,1,0
25,211,211,52,2,50,2,1
16,220,220,28,28,0,1,0
6,224,224,3,3,0,1,0
30,236,236,54,46,8,2,1
19,241,241,23,23,0,1,0
3,254,254,28,7,21,2,1
7,255,255,10,10,0,1,0
13,257,257,12,8,4,2,1
22,266,266,36,36,0,1,0
8,271,271,8,8,0,1,0
29,272,272,3,3,0,1,0
4,318,318,58,58,0,1,0
21,349,349,8,8,0,1,0
27,379,379,9,9,0,1,0
1,382,382,28,28,0,1,0
11,393,393,49,9,40,2,1
17,398,398,30,20,10,2,1
12,429,429,298,259,39,4,3
18,429,429,13,13,0,1,0
2,438,438,38,8,30,4,3
31,443,443,76,40,36,2,1
5,446,446,7,2,5,2,1
26,458,458,30,25,5,2,1
24,471,471,16,6,10,2,1
0,479,479,116,62,54,4,3

15,116,116,1,1,0,1,0
21,122,122,12,4,8,2,1
10,169,169,2,2,0,1,0
22,175,175,8,8,0,1,0
20,181,181,2,2,0,1,0
17,190,190,72,72,0,1,0
19,201,201,36,36,0,1,0
0,269,269,59,59,0,1,0
16,269,269,17,17,0,1,0
28,279,279,23,23,0,1,0
2,282,282,103,25,78,3,2
11,285,285,37,37,0,1,0
23,285,285,23,14,9,2,1
13,286,286,62,62,0,1,0
6,299,299,35,35,0,1,0
9,318,318,28,28,0,1,0
14,332,332,9,9,0,1,0
24,335,335,5,1,4,2,1
12,337,337,14,6,8,3,2
5,342,342,223,196,27,4,3
27,358,358,68,68,0,1,0
18,366,366,39,39,0,1,0
8,383,383,60,30,30,3,2
25,388,388,32,6,26,3,2
7,425,425,53,12,41,2,1
26,486,486,38,25,13,2,1
1,487,487,20,5,15,4,3
4,490,490,8,4,4,2,1
3,491,491,4,4,0,1,0

11,100,100,10,10,0,1,0
27,101,101,24,24,0,1,0
8,106,106,5,1,4,2,1
15,111,111,26,26,0,1,0
33,117,117,17,17,0,1,0
22,125,125,7,7,0,1,0
29,127,127,13,1,12,3,2
10,138,138,9,1,8,3,2
16,149,149,1,1,0,1,0
2,174,174,28,18,10,3,2
38,196,196,58,58,0,1,0
23,206,206,21,6,15,2,1
42,210,210,18,8,10,3,2
14,216,216,3,3,0,1,0
24,228,228,20,20,0,1,0
20,228,228,8,2,6,3,2
28,243,243,56,14,42,4,3
40,247,247,3,3,0,1,0
3,247,247,25,12,13,2,1
41,254,254,2,2,0,1,0
25,256,256,37,37,0,1,0
19,273,273,57,29,28,2,1
7,287,287,8,8,0,1,0
0,288,288,14,14,0,1,0
17,297,297,1,1,0,1,0
36,310,310,36,36,0,1,0
32,315,315,22,22,0,1,0
4,343,343,13,13,0,1,0
5,357,357,12,12,0,1,0
1,369,369,17,14,3,2,1
13,373,373,14,1,13,2,1
37,375,375,20,11,9,4,3
35,379,379,33,33,0,1,0
31,382,382,21,21,0,1,0
6,387,387,5,5,0,1,0
26,395,395,26,2,24,4,3
39,401,401,36,36,0,1,0
30,402,402,7,1,6,3,2
21,403,403,4,1,3,2,1
18,424,424,60,15,45,4,3
34,447,447,8,8,0,1,0
12,451,451,58,12,46,3,2
9,498,498,28,10,18,4,3

18,105,105,4,4,0,1,0
17,120,120,12,6,6,2,1
31,130,130,6,6,0,1,0
23,166,166,6,6,0,1,0
5,173,173,3,3,0,1,0
28,212,212,63,41,22,2,1
10,213,213,51,51,0,1,0
30,213,213,7,3,4,2,1
26,218,218,54,4,50,2,1
14,219,219,38,4,34,2,1
7,226,226,27,17,10,2,1
4,228,228,8,2,6,3,2
22,251,251,66,34,32,3,2
12,256,256,21,17,4,2,1
2,265,265,63,63,0,1,0
1,270,270,31,9,22,3,2
11,294,294,42,11,31,2,1
24,294,294,34,34,0,1,0
6,334,334,91,60,31,2,1
13,348,348,12,6,6,3,2
19,356,356,19,14,5,2,1
29,359,359,14,14,0,1,0
25,375,375,50,50,0,1,0
8,376,376,71,71,0,1,0
20,387,387,14,14,0,1,0
16,390,390,72,72,0,1,0
32,410,410,17,17,0,1,0
9,424,424,17,9,8,3,2
0,433,433,39,39,0,1,0
15,444,444,28,28,0,1,0
21,447,447,45,10,35,2,1
3,469,469,7,7,0,1,0
27,493,493,8,5,3,2,1

29,105,105,17,9,8,2,1
22,122,122,4,1,3,2,1
16,136,136,1,1,0,1,0
2,140,140,10,10,0,1,0
35,161,161,39,33,6,2,1
1,181,181,2,2,0,1,0
34,194,194,4,4,0,1,0
12,197,197,1,1,0,1,0
5,214,214,3,3,0,1,0
13,221,221,13,6,7,2,1
27,229,229,72,51,21,4,3
31,249,249,29,29,0,1,0
6,249,249,3,3,0,1,0
4,253,253,8,2,6,2,1
17,260,260,147,147,0,1,0
20,261,261,39,13,26,2,1
3,262,262,47,41,6,2,1
33,271,271,9,3,6,3,2
8,272,272,19,12,7,2,1
24,274,274,23,11,12,4,3
18,277,277,29,5,24,4,3
10,293,293,10,2,8,2,1
28,316,316,22,22,0,1,0
15,321,321,11,11,0,1,0
25,336,336,42,23,19,2,1
40,390,390,76,31,45,3,2
36,392,392,113,101,12,3,2
14,396,396,1,1,0,1,0
26,398,398,7,7,0,1,0
7,418,418,32,32,0,1,0
37,422,422,6,6,0,1,0
39,424,424,8,2,6,3,2
9,434,434,13,13,0,1,0
38,450,450,26,2,24,3,2
30,458,458,11,11,0,1,0
23,460,460,15,15,0,1,0
19,467,467,1,1,0,1,0
21,471,471,40,25,15,4,3
11,473,473,52,52,0,1,0
0,475,475,56,56,0,1,0
32,484,484,9,9,0,1,0

22,102,102,14,5,9,4,3
25,137,137,28,24,4,2,1
3,143,143,32,32,0,1,0
26,162,162,1,1,0,1,0
32,174,174,39,15,24,2,1
20,189,189,49,49,0,1,0
11,194,194,1,1,0,1,0
6,196,196,1,1,0,1,0
27,209,209,13,1,12,2,1
29,220,220,13,3,10,3,2
5,221,221,34,1,33,4,3
31,221,221,8,5,3,2,1
7,234,234,13,10,3,2,1
2,243,243,16,2,14,4,3
24,256,256,55,55,0,1,0
21,326,326,9,9,0,1,0
19,347,347,7,7,0,1,0
4,357,357,78,39,39,4,3
8,366,366,13,13,0,1,0
10,368,368,79,79,0,1,0
14,377,377,77,8,69,4,3
16,382,382,20,20,0,1,0
18,384,384,31,13,18,3,2
1,394,394,17,3,14,3,2
30,394,394,15,15,0,1,0
12,397,397,3,3,0,1,0
28,406,406,45,33,12,2,1
33,408,408,53,15,38,3,2
0,409,409,15,3,12,4,3
13,438,438,18,18,0,1,0
23,449,449,19,4,15,4,3
9,473,473,215,77,138,4,3
17,488,488,67,11,56,4,3
15,490,490,18,1,17,2,1

24,119,119,5,5,0,1,0
18,124,124,5,5,0,1,0
9,124,124,12,12,0,1,0
32,126,126,1,1,0,1,0
12,130,130,2,2,0,1,0
42,170,170,22,1,21,4,3
33,171,171,47,47,0,1,0
30,206,206,50,29,21,3,2
29,220,220,32,32,0,1,0
38,223,223,15,12,3,2,1
34,227,227,60,30,30,4,3
10,233,233,48,48,0,1,0
21,244,244,14,14,0,1,0
7,264,264,36,21,15,2,1
14,280,280,3,3,0,1,0
15,289,289,2,2,0,1,0
27,291,291,6,2,4,2,1
41,296,296,60,60,0,1,0
3,297,297,22,22,0,1,0
20,303,303,4,4,0,1,0
19,309,309,54,54,0,1,0
0,355,355,90,27,63,4,3
36,358,358,2,2,0,1,0
37,367,367,53,19,34,3,2
25,367,367,36,36,0,1,0
40,371,371,29,19,10,2,1
5,378,378,8,8,0,1,0
4,381,381,7,1,6,2,1
35,381,381,9,5,4,2,1
8,383,383,10,4,6,2,1
16,384,384,14,6,8,3,2
11,390,390,73,37,36,2,1
1,418,418,46,16,30,4,3
22,422,422,2,2,0,1,0
6,424,424,55,11,44,2,1
13,427,427,4,4,0,1,0
39,431,431,2,2,0,1,0
31,476,476,31,31,0,1,0
28,480,480,7,7,0,1,0
26,485,485,22,22,0,1,0
2,491,491,13,13,0,1,0
23,494,494,46,46,0,1,0
17,499,499,8,5,3,2,1

22,102,102,4,4,0,1,0
7,110,110,5,5,0,1,0
28,111,111,2,2,0,1,0
21,111,111,3,3,0,1,0
12,140,140,29,20,9,4,3
17,143,143,35,7,28,2,1
3,146,146,7,7,0,1,0
16,147,147,8,8,0,1,0
23,179,179,7,1,6,3,2
2,186,186,15,7,8,2,1
20,200,200,2,2,0,1,0
11,201,201,3,3,0,1,0
30,209,209,19,4,15,4,3
24,217,217,26,26,0,1,0
13,229,229,13,1,12,4,3
18,235,235,3,3,0,1,0
37,238,238,1,1,0,1,0
33,275,275,21,9,12,3,2
5,285,285,7,1,6,2,1
6,303,303,9,6,3,2,1
8,305,305,6,2,4,2,1
31,307,307,34,14,20,2,1
38,325,325,47,47,0,1,0
26,367,367,41,31,10,2,1
34,381,381,131,45,86,4,3
9,391,391,14,14,0,1,0
0,399,399,104,104,0,1,0
27,401,401,87,61,26,4,3
36,417,417,42,42,0,1,0
19,441,441,1,1,0,1,0
4,445,445,75,27,48,4,3
10,447,447,93,93,0,1,0
29,448,448,20,20,0,1,0
35,448,448,82,1,81,4,3
15,456,456,44,20,24,4,3
25,460,460,28,15,13,2,1
1,463,463,40,40,0,1,0
14,480,480,47,22,25,2,1
32,484,484,54,54,0,1,0

1,121,121,30,16,14,3,2
14,129,129,29,22,7,2,1
35,137,137,13,13,0,1,0
4,138,138,8,8,0,1,0
15,148,148,1,1,0,1,0
8,168,168,11,11,0,1,0
28,168,168,40,40,0,1,0
5,188,188,21,21,0,1,0
25,196,196,15,15,0,1,0
13,212,212,4,4,0,1,0
22,217,217,42,8,34,2,1
12,217,217,18,15,3,2,1
7,221,221,56,56,0,1,0
38,235,235,43,43,0,1,0
18,240,240,13,13,0,1,0
3,251,251,5,5,0,1,0
29,261,261,7,7,0,1,0
0,285,285,39,17,22,4,3
10,286,286,1,1,0,1,0
31,290,290,49,13,36,2,1
16,302,302,54,25,29,3,2
11,328,328,11,1,10,3,2
9,331,331,7,2,5,2,1
19,334,334,1,1,0,1,0
2,337,337,40,16,24,4,3
21,365,365,9,5,4,2,1
33,371,371,24,7,17,4,3
26,388,388,31,31,0,1,0
30,397,397,12,2,10,3,2
23,397,397,28,2,26,2,1
36,402,402,137,80,57,4,3
27,417,417,54,54,0,1,0
34,420,420,3,3,0,1,0
32,428,428,5,5,0,1,0
37,476,476,25,25,0,1,0
17,480,480,36,9,27,4,3
6,480,480,11,5,6,3,2
24,490,490,15,15,0,1,0
20,498,498,32,32,0,1,0

19,100,100,6,6,0,1,0
18,103,103,36,3,33,2,1
16,103,103,2,2,0,1,0
3,109,109,1,1,0,1,0
52,115,115,5,5,0,1,0
51,123,123,5,5,0,1,0
45,135,135,14,2,12,3,2
40,138,138,7,4,3,2,1
36,140,140,55,11,44,3,2
27,148,148,11,1,10,3,2
24,150,150,6,6,0,1,0
22,156,156,2,2,0,1,0
25,183,183,1,1,0,1,0
17,187,187,1,1,0,1,0
43,189,189,17,3,14,4,3
6,195,195,3,3,0,1,0
31,201,201,9,9,0,1,0
2,212,212,7,1,6,3,2
47,224,224,4,4,0,1,0
0,241,241,4,4,0,1,0
12,268,268,13,13,0,1,0
33,271,271,21,7,14,3,2
32,275,275,16,7,9,2,1
28,294,294,16,3,13,2,1
5,309,309,18,9,9,3,2
9,312,312,11,11,0,1,0
4,316,316,19,19,0,1,0
23,318,318,14,14,0,1,0
21,323,323,60,4,56,3,2
7,325,325,2,2,0,1,0
10,330,330,54,22,32,2,1
29,330,330,1,1,0,1,0
35,338,338,20,6,14,3,2
46,355,355,11,11,0,1,0
11,356,356,6,6,0,1,0
13,359,359,55,13,42,3,2
8,360,360,2,2,0,1,0
34,369,369,6,3,3,2,1
50,375,375,55,19,36,2,1
39,378,378,6,6,0,1,0
30,382,382,3,3,0,1,0
15,420,420,12,1,11,2,1
26,420,420,2,2,0,1,0
1,463,463,6,6,0,1,0
49,467,467,41,41,0,1,0
44,470,470,100,6,94,3,2
14,470,470,34,34,0,1,0
48,475,475,41,6,35,3,2
20,479,479,1,1,0,1,0
41,485,485,91,91,0,1,0
37,486,486,30,25,5,2,1
42,487,487,45,45,0,1,0
38,488,488,53,29,24,2,1

18,104,104,1,1,0,1,0
31,113,113,7,7,0,1,0
39,129,129,37,8,29,2,1
33,137,137,2,2,0,1,0
14,138,138,27,27,0,1,0
3,174,174,8,8,0,1,0
16,195,195,1,1,0,1,0
10,195,195,17,17,0,1,0
29,206,206,2,2,0,1,0
19,216,216,15,5,10,3,2
38,216,216,13,5,8,2,1
44,220,220,3,3,0,1,0
9,223,223,8,8,0,1,0
7,245,245,29,1,28,2,1
42,251,251,43,43,0,1,0
6,260,260,4,4,0,1,0
12,267,267,22,4,18,4,3
25,270,270,25,25,0,1,0
2,272,272,2,2,0,1,0
26,282,282,12,12,0,1,0
32,286,286,9,9,0,1,0
23,297,297,1,1,0,1,0
36,312,312,25,25,0,1,0
4,318,318,40,24,16,2,1
22,320,320,40,14,26,3,2
1,321,321,9,9,0,1,0
0,325,325,6,1,5,2,1
17,329,329,33,4,29,2,1
37,338,338,39,5,34,2,1
30,349,349,26,26,0,1,0
15,353,353,24,24,0,1,0
40,363,363,71,56,15,2,1
41,370,370,3,3,0,1,0
8,400,400,36,36,0,1,0
24,421,421,19,19,0,1,0
5,439,439,73,27,46,3,2
28,450,450,76,49,27,4,3
11,452,452,53,53,0,1,0
34,459,459,18,18,0,1,0
21,473,473,25,5,20,3,2
27,485,485,24,24,0,1,0
13,487,487,24,24,0,1,0
43,491,491,119,119,0,1,0
35,494,494,105,105,0,1,0
20,496,496,2,2,0,1,0

28,105,105,5,5,0,1,0
13,107,107,5,5,0,1,0
22,117,117,5,5,0,1,0
3,126,126,13,13,0,1,0
23,132,132,18,5,13,3,2
34,166,166,64,34,30,3,2
6,167,167,17,14,3,2,1
2,182,182,2,2,0,1,0
21,189,189,2,2,0,1,0
0,203,203,2,2,0,1,0
32,207,207,13,4,9,4,3
12,221,221,35,35,0,1,0
29,230,230,22,22,0,1,0
20,275,275,65,20,45,2,1
5,279,279,3,3,0,1,0
17,295,295,1,1,0,1,0
1,308,308,25,25,0,1,0
31,322,322,54,54,0,1,0
19,327,327,1,1,0,1,0
37,328,328,5,5,0,1,0
18,349,349,8,8,0,1,0
10,353,353,85,85,0,1,0
30,361,361,6,6,0,1,0
7,362,362,51,51,0,1,0
33,364,364,64,25,39,4,3
26,386,386,9,9,0,1,0
15,389,389,25,25,0,1,0
16,400,400,7,7,0,1,0
27,418,418,5,2,3,2,1
8,422,422,88,37,51,4,3
4,430,430,65,65,0,1,0
38,431,431,63,63,0,1,0
36,437,437,149,110,39,3,2
25,439,439,1,1,0,1,0
11,450,450,34,34,0,1,0
9,458,458,10,3,7,3,2
14,466,466,43,1,42,3,2
35,470,470,7,4,3,2,1
24,475,475,63,33,30,4,3

3,100,100,2,2,0,1,0
31,100,100,4,4,0,1,0
33,108,108,9,9,0,1,0
28,120,120,27,27,0,1,0
13,123,123,5,5,0,1,0
15,127,127,13,13,0,1,0
27,131,131,16,6,10,3,2
18,154,154,1,1,0,1,0
37,180,180,47,11,36,3,2
14,185,185,39,18,21,4,3
29,188,188,33,21,12,3,2
38,193,193,14,4,10,2,1
26,196,196,14,1,13,2,1
35,212,212,8,8,0,1,0
16,223,223,36,26,10,2,1
1,236,236,8,8,0,1,0
22,248,248,35,15,20,3,2
25,258,258,3,3,0,1,0
19,264,264,68,12,56,3,2
39,275,275,21,21,0,1,0
5,278,278,15,7,8,3,2
6,286,286,1,1,0,1,0
20,294,294,5,5,0,1,0
32,304,304,27,27,0,1,0
9,306,306,38,16,22,2,1
12,309,309,2,2,0,1,0
11,315,315,2,2,0,1,0
10,316,316,20,10,10,2,1
2,323,323,2,2,0,1,0
0,333,333,5,5,0,1,0
4,365,365,4,4,0,1,0
30,372,372,21,17,4,2,1
34,372,372,14,7,7,2,1
36,390,390,95,38,57,4,3
17,391,391,132,116,16,3,2
21,403,403,7,4,3,2,1
8,425,425,111,84,27,2,1
24,478,478,10,1,9,4,3
23,478,478,45,45,0,1,0
7,481,481,22,22,0,1,0

4,112,112,8,8,0,1,0
22,121,121,3,3,0,1,0
14,134,134,21,5,16,3,2
17,136,136,2,2,0,1,0
29,151,151,4,4,0,1,0
30,159,159,25,4,21,2,1
2,163,163,1,1,0,1,0
3,163,163,8,8,0,1,0
0,164,164,30,30,0,1,0
20,167,167,8,8,0,1,0
8,170,170,1,1,0,1,0
23,173,173,4,4,0,1,0
26,188,188,19,19,0,1,0
36,208,208,25,25,0,1,0
7,219,219,35,19,16,3,2
28,221,221,33,13,20,2,1
27,232,232,20,2,18,2,1
12,233,233,15,9,6,3,2
34,240,240,35,35,0,1,0
16,255,255,5,1,4,2,1
31,274,274,35,15,20,3,2
39,281,281,20,7,13,2,1
9,289,289,21,6,15,2,1
19,290,290,34,34,0,1,0
35,314,314,80,40,40,2,1
6,316,316,22,22,0,1,0
11,370,370,26,26,0,1,0
25,373,373,28,28,0,1,0
18,378,378,18,18,0,1,0
5,382,382,127,97,30,4,3
37,384,384,79,44,35,2,1
21,386,386,54,16,38,3,2
32,395,395,37,18,19,4,3
13,397,397,57,37,20,4,3
1,446,446,1,1,0,1,0
15,456,456,7,1,6,3,2
33,471,471,7,7,0,1,0
10,474,474,6,6,0,1,0
38,482,482,63,63,0,1,0
24,498,498,11,11,0,1,0

17,132,132,3,3,0,1,0
24,133,133,18,18,0,1,0
25,138,138,2,2,0,1,0
30,142,142,2,2,0,1,0
33,144,144,9,9,0,1,0
23,157,157,4,4,0,1,0
22,165,165,9,4,5,2,1
20,169,169,3,3,0,1,0
21,182,182,17,17,0,1,0
32,187,187,35,35,0,1,0
4,190,190,19,7,12,3,2
1,196,196,4,4,0,1,0
16,202,202,20,20,0,1,0
8,228,228,58,58,0,1,0
31,232,232,96,8,88,3,2
11,236,236,15,15,0,1,0
27,239,239,35,3,32,4,3
6,241,241,14,14,0,1,0
3,276,276,15,3,12,4,3
18,280,280,10,1,9,2,1
34,284,284,1,1,0,1,0
0,304,304,21,21,0,1,0
2,315,315,1,1,0,1,0
10,335,335,11,11,0,1,0
26,338,338,113,113,0,1,0
5,355,355,36,16,20,2,1
15,372,372,1,1,0,1,0
12,393,393,2,2,0,1,0
29,393,393,8,8,0,1,0
13,410,410,228,162,66,3,2
9,415,415,36,36,0,1,0
14,425,425,78,78,0,1,0
19,481,481,69,19,50,3,2
28,488,488,54,54,0,1,0
7,488,488,55,7,48,3,2

5,119,119,8,8,0,1,0
22,122,122,32,8,24,4,3
9,127,127,11,3,8,2,1
1,128,128,9,9,0,1,0
20,132,132,1,1,0,1,0
4,141,141,1,1,0,1,0
33,144,144,12,7,5,2,1
14,159,159,4,4,0,1,0
38,160,160,28,28,0,1,0
16,206,206,17,17,0,1,0
28,206,206,5,1,4,2,1
24,207,207,46,9,37,2,1
29,211,211,35,35,0,1,0
30,230,230,12,12,0,1,0
25,230,230,33,33,0,1,0
12,241,241,4,4,0,1,0
8,242,242,33,15,18,3,2
11,257,257,24,18,6,2,1
0,265,265,7,1,6,3,2
36,278,278,14,14,0,1,0
31,292,292,30,11,19,3,2
15,296,296,87,87,0,1,0
37,309,309,19,5,14,3,2
2,314,314,1,1,0,1,0
13,351,351,25,25,0,1,0
34,355,355,8,8,0,1,0
6,357,357,83,83,0,1,0
19,358,358,4,4,0,1,0
10,407,407,75,75,0,1,0
23,429,429,50,50,0,1,0
21,436,436,10,10,0,1,0
27,437,437,30,13,17,2,1
7,453,453,17,3,14,2,1
32,467,467,76,40,36,4,3
26,476,476,10,5,5,2,1
35,482,482,36,12,24,3,2
3,483,483,5,2,3,2,1
17,494,494,32,32,0,1,0
18,500,500,139,68,71,4,3

26,128,128,14,14,0,1,0
10,137,137,40,40,0,1,0
25,167,167,12,12,0,1,0
23,168,168,7,7,0,1,0
27,175,175,5,5,0,1,0
3,176,176,14,14,0,1,0
19,177,177,23,23,0,1,0
18,178,178,2,2,0,1,0
11,191,191,20,7,13,2,1
30,205,205,27,23,4,2,1
5,210,210,33,33,0,1,0
28,212,212,50,50,0,1,0
21,213,213,119,105,14,3,2
20,217,217,24,6,18,3,2
6,222,222,80,43,37,2,1
36,296,296,4,1,3,2,1
12,297,297,20,13,7,2,1
2,311,311,2,2,0,1,0
29,313,313,26,15,11,2,1
32,315,315,15,15,0,1,0
9,327,327,23,23,0,1,0
8,328,328,7,1,6,3,2
24,332,332,4,4,0,1,0
37,345,345,10,10,0,1,0
1,371,371,34,2,32,2,1
15,381,381,48,21,27,2,1
4,389,389,2,2,0,1,0
16,408,408,71,27,44,2,1
7,413,413,21,21,0,1,0
13,417,417,5,5,0,1,0
35,423,423,92,92,0,1,0
14,433,433,12,12,0,1,0
34,437,437,3,3,0,1,0
0,439,439,2,2,0,1,0
22,451,451,6,2,4,2,1
33,462,462,14,11,3,2,1
17,487,487,4,4,0,1,0
31,487,487,48,36,12,4,3

28,115,115,2,2,0,1,0
29,117,117,2,2,0,1,0
35,138,138,3,3,0,1,0
34,139,139,6,6,0,1,0
37,142,142,6,3,3,2,1
10,146,146,34,34,0,1,0
4,152,152,8,8,0,1,0
3,164,164,9,9,0,1,0
30,173,173,13,3,10,2,1
18,179,179,8,3,5,2,1
1,206,206,24,24,0,1,0
24,208,208,3,3,0,1,0
26,210,210,82,64,18,4,3
2,223,223,8,3,5,2,1
5,225,225,13,13,0,1,0
38,233,233,3,3,0,1,0
22,245,245,19,2,17,2,1
8,248,248,33,10,23,2,1
7,249,249,4,4,0,1,0
36,254,254,67,19,48,3,2
31,269,269,61,31,30,2,1
11,272,272,44,15,29,2,1
0,288,288,28,28,0,1,0
21,291,291,42,42,0,1,0
13,312,312,6,6,0,1,0
27,340,340,2,2,0,1,0
6,341,341,43,43,0,1,0
14,345,345,2,2,0,1,0
9,347,347,51,4,47,3,2
17,357,357,42,33,9,2,1
15,357,357,39,39,0,1,0
16,381,381,5,5,0,1,0
25,399,399,44,36,8,3,2
20,408,408,8,2,6,3,2
23,420,420,36,12,24,4,3
19,430,430,65,65,0,1,0
32,432,432,42,2,40,3,2
33,458,458,91,50,41,4,3
12,484,484,43,34,9,4,3

5,111,111,1,1,0,1,0
3,115,115,10,10,0,1,0
1,128,128,58,16,42,3,2
15,136,136,1,1,0,1,0
8,136,136,7,2,5,2,1
16,138,138,4,4,0,1,0
35,184,184,37,1,36,4,3
33,197,197,9,9,0,1,0
22,201,201,14,9,5,2,1
26,216,216,43,43,0,1,0
25,234,234,41,29,12,4,3
4,234,234,35,35,0,1,0
11,243,243,5,5,0,1,0
9,249,249,2,2,0,1,0
29,249,249,21,4,17,2,1
40,264,264,9,9,0,1,0
17,265,265,3,3,0,1,0
31,266,266,10,10,0,1,0
27,272,272,6,2,4,2,1
28,281,281,45,3,42,3,2
32,283,283,35,35,0,1,0
20,288,288,16,16,0,1,0
2,294,294,16,5,11,4,3
34,308,308,19,19,0,1,0
14,318,318,51,51,0,1,0
21,325,325,10,10,0,1,0
12,343,343,40,20,20,2,1
6,347,347,14,8,6,2,1
39,355,355,65,65,0,1,0
10,366,366,57,57,0,1,0
19,367,367,1,1,0,1,0
24,414,414,16,16,0,1,0
7,419,419,51,51,0,1,0
0,425,425,8,8,0,1,0
13,434,434,58,33,25,2,1
36,451,451,20,3,17,2,1
30,454,454,47,47,0,1,0
38,457,457,66,66,0,1,0
23,488,488,14,14,0,1,0
37,496,496,69,43,26,3,2
18,496,496,8,8,0,1,0

13,101,101,11,3,8,2,1
32,119,119,8,8,0,1,0
17,119,119,11,3,8,3,2
30,165,165,9,3,6,2,1
25,167,167,24,15,9,4,3
2,170,170,20,6,14,2,1
26,175,175,10,10,0,1,0
24,193,193,37,10,27,4,3
6,195,195,26,26,0,1,0
23,201,201,42,25,17,2,1
29,206,206,12,12,0,1,0
22,272,272,19,1,18,4,3
18,277,277,20,20,0,1,0
5,278,278,25,25,0,1,0
15,282,282,83,83,0,1,0
8,302,302,16,1,15,4,3
4,306,306,5,5,0,1,0
20,313,313,28,28,0,1,0
27,316,316,25,6,19,2,1
7,318,318,61,61,0,1,0
11,322,322,135,98,37,4,3
1,355,355,28,22,6,2,1
0,357,357,66,66,0,1,0
28,370,370,42,42,0,1,0
31,416,416,9,9,0,1,0
21,425,425,36,36,0,1,0
12,430,430,15,15,0,1,0
19,433,433,25,3,22,2,1
3,446,446,29,29,0,1,0
16,456,456,36,36,0,1,0
9,456,456,46,40,6,2,1
14,473,473,38,38,0,1,0
10,475,475,60,36,24,4,3

16,114,114,10,10,0,1,0
22,125,125,6,6,0,1,0
29,140,140,14,14,0,1,0
36,156,156,28,2,26,3,2
10,163,163,18,6,12,3,2
27,178,178,23,18,5,2,1
32,191,191,44,22,22,2,1
4,226,226,33,3,30,2,1
25,229,229,21,3,18,2,1
15,229,229,59,23,36,2,1
26,230,230,15,15,0,1,0
19,230,230,1,1,0,1,0
2,242,242,10,10,0,1,0
6,242,242,8,8,0,1,0
12,244,244,19,8,11,3,2
31,246,246,28,15,13,2,1
8,295,295,10,10,0,1,0
17,312,312,26,26,0,1,0
7,319,319,22,22,0,1,0
28,353,353,11,1,10,2,1
1,361,361,59,59,0,1,0
35,365,365,12,4,8,3,2
21,366,366,8,8,0,1,0
18,371,371,62,62,0,1,0
37,373,373,46,46,0,1,0
24,380,380,39,1,38,2,1
9,388,388,47,10,37,2,1
33,389,389,63,15,48,4,3
34,400,400,84,12,72,3,2
0,405,405,27,21,6,3,2
11,409,409,6,6,0,1,0
30,415,415,20,5,15,3,2
20,426,426,17,14,3,2,1
14,434,434,1,1,0,1,0
5,441,441,1,1,0,1,0
23,444,444,46,17,29,4,3
13,453,453,23,6,17,2,1
3,481,481,130,130,0,1,0

32,107,107,15,15,0,1,0
18,116,116,6,2,4,2,1
7,131,131,27,27,0,1,0
0,141,141,7,7,0,1,0
21,143,143,8,8,0,1,0
17,148,148,14,2,12,3,2
4,168,168,15,15,0,1,0
30,170,170,49,49,0,1,0
25,184,184,2,2,0,1,0
13,193,193,1,1,0,1,0
3,208,208,21,9,12,4,3
20,217,217,13,13,0,1,0
9,219,219,27,27,0,1,0
5,219,219,6,6,0,1,0
16,231,231,34,26,8,2,1
24,236,236,18,18,0,1,0
36,248,248,115,71,44,3,2
10,253,253,2,2,0,1,0
26,272,272,6,6,0,1,0
31,282,282,4,4,0,1,0
35,283,283,25,25,0,1,0
28,290,290,17,12,5,2,1
22,297,297,13,13,0,1,0
14,313,313,40,22,18,2,1
2,342,342,28,28,0,1,0
6,361,361,7,2,5,2,1
12,373,373,66,39,27,4,3
34,379,379,81,45,36,4,3
37,389,389,7,7,0,1,0
27,390,390,27,12,15,4,3
38,401,401,14,14,0,1,0
23,418,418,38,38,0,1,0
33,427,427,29,29,0,1,0
19,447,447,23,23,0,1,0
29,459,459,36,36,0,1,0
11,460,460,31,31,0,1,0
8,461,461,15,15,0,1,0
15,474,474,26,8,18,3,2
1,482,482,109,55,54,4,3

17,123,123,5,5,0,1,0
12,126,126,14,14,0,1,0
18,127,127,10,3,7,2,1
16,131,131,5,1,4,2,1
34,151,151,10,10,0,1,0
7,170,170,12,12,0,1,0
26,175,175,31,31,0,1,0
15,194,194,16,8,8,3,2
20,199,199,5,5,0,1,0
29,216,216,4,1,3,2,1
21,222,222,7,1,6,2,1
14,236,236,86,86,0,1,0
3,241,241,36,36,0,1,0
8,252,252,51,13,38,4,3
23,263,263,33,4,29,2,1
2,271,271,4,4,0,1,0
6,297,297,47,47,0,1,0
1,307,307,49,49,0,1,0
24,320,320,5,5,0,1,0
13,321,321,30,30,0,1,0
0,324,324,26,26,0,1,0
5,324,324,10,6,4,2,1
31,341,341,83,18,65,4,3
32,349,349,49,49,0,1,0
22,351,351,3,3,0,1,0
9,367,367,12,6,6,2,1
25,380,380,10,5,5,2,1
27,401,401,71,41,30,3,2
10,425,425,2,2,0,1,0
11,434,434,60,60,0,1,0
19,447,447,24,9,15,4,3
30,448,448,27,14,13,2,1
4,465,465,32,8,24,3,2
33,475,475,155,155,0,1,0
28,478,478,112,112,0,1,0

3,103,103,1,1,0,1,0
16,104,104,5,5,0,1,0
11,104,104,3,3,0,1,0
32,113,113,1,1,0,1,0
4,115,115,2,2,0,1,0
1,116,116,4,4,0,1,0
0,116,116,16,1,15,2,1
28,116,116,12,12,0,1,0
7,158,158,17,17,0,1,0
8,208,208,3,3,0,1,0
18,234,234,2,2,0,1,0
33,255,255,36,36,0,1,0
15,262,262,57,57,0,1,0
30,267,267,34,17,17,2,1
26,270,270,7,1,6,3,2
20,274,274,29,29,0,1,0
34,299,299,63,45,18,4,3
19,303,303,1,1,0,1,0
22,326,326,13,4,9,4,3
27,327,327,31,31,0,1,0
5,338,338,24,24,0,1,0
6,345,345,14,8,6,2,1
31,352,352,26,14,12,3,2
10,358,358,25,25,0,1,0
2,362,362,128,34,94,4,3
29,363,363,95,5,90,4,3
25,377,377,11,11,0,1,0
14,382,382,132,120,12,4,3
24,406,406,6,6,0,1,0
12,410,410,11,7,4,2,1
13,432,432,13,13,0,1,0
17,455,455,260,260,0,1,0
23,463,463,7,1,6,3,2
21,474,474,2,2,0,1,0
9,500,500,127,85,42,4,3

8,101,101,1,1,0,1,0
12,113,113,9,1,8,2,1
20,118,118,8,8,0,1,0
9,135,135,2,2,0,1,0
26,157,157,25,9,16,2,1
29,159,159,36,36,0,1,0
7,163,163,12,12,0,1,0
17,203,203,83,83,0,1,0
34,224,224,1,1,0,1,0
18,228,228,9,9,0,1,0
30,236,236,50,50,0,1,0
2,245,245,71,71,0,1,0
31,264,264,69,69,0,1,0
4,283,283,18,18,0,1,0
27,309,309,38,38,0,1,0
3,314,314,19,19,0,1,0
11,326,326,14,14,0,1,0
13,330,330,36,36,0,1,0
33,335,335,26,19,7,2,1
32,344,344,26,4,22,3,2
28,349,349,3,3,0,1,0
16,350,350,10,1,9,4,3
21,352,352,36,36,0,1,0
35,386,386,3,3,0,1,0
1,388,388,45,24,21,4,3
24,392,392,85,85,0,1,0
15,402,402,45,15,30,2,1
22,405,405,15,15,0,1,0
19,411,411,31,31,0,1,0
6,420,420,24,15,9,4,3
0,421,421,14,14,0,1,0
23,425,425,41,24,17,2,1
25,437,437,17,7,10,2,1
5,460,460,49,19,30,2,1
14,473,473,50,26,24,4,3
10,500,500,46,46,0,1,0

7,108,108,6,1,5,2,1
29,129,129,8,8,0,1,0
18,134,134,15,15,0,1,0
20,134,134,9,5,4,2,1
6,137,137,6,3,3,2,1
12,146,146,6,6,0,1,0
13,147,147,3,3,0,1,0
0,152,152,6,6,0,1,0
9,157,157,22,19,3,2,1
27,157,157,19,9,10,3,2
22,171,171,5,5,0,1,0
15,174,174,1,1,0,1,0
33,178,178,7,4,3,2,1
8,232,232,8,2,6,2,1
19,249,249,56,56,0,1,0
34,262,262,18,18,0,1,0
17,279,279,2,2,0,1,0
10,308,308,33,9,24,4,3
11,309,309,56,35,21,4,3
35,320,320,8,8,0,1,0
1,331,331,9,9,0,1,0
14,333,333,16,4,12,3,2
28,339,339,49,17,32,4,3
4,343,343,36,16,20,2,1
25,346,346,17,7,10,3,2
21,363,363,71,15,56,3,2
3,391,391,19,11,8,3,2
23,397,397,48,48,0,1,0
5,415,415,142,94,48,4,3
24,419,419,11,11,0,1,0
32,423,423,59,59,0,1,0
30,433,433,1,1,0,1,0
31,448,448,83,83,0,1,0
2,486,486,61,61,0,1,0
26,487,487,108,108,0,1,0
16,498,498,214,142,72,3,2

32,117,117,14,14,0,1,0
36,139,139,27,27,0,1,0
11,164,164,15,15,0,1,0
29,174,174,62,25,37,2,1
27,176,176,1,1,0,1,0
28,191,191,2,2,0,1,0
19,203,203,9,9,0,1,0
37,204,204,12,12,0,1,0
10,205,205,4,4,0,1,0
21,209,209,20,13,7,2,1
2,218,218,41,9,32,3,2
7,239,239,28,28,0,1,0
24,243,243,12,2,10,2,1
30,245,245,37,37,0,1,0
1,255,255,30,30,0,1,0
15,256,256,9,9,0,1,0
5,274,274,17,17,0,1,0
0,285,285,37,37,0,1,0
22,290,290,73,73,0,1,0
3,302,302,16,16,0,1,0
18,304,304,15,5,10,2,1
20,304,304,4,1,3,2,1
38,307,307,10,10,0,1,0
17,320,320,25,25,0,1,0
31,359,359,24,19,5,2,1
34,365,365,59,24,35,3,2
4,390,390,74,74,0,1,0
25,406,406,7,4,3,2,1
35,407,407,2,2,0,1,0
13,413,413,2,2,0,1,0
23,417,417,28,12,16,2,1
33,417,417,18,18,0,1,0
8,424,424,57,44,13,2,1
16,429,429,31,31,0,1,0
6,437,437,24,10,14,2,1
26,439,439,67,41,26,3,2
9,444,444,123,113,10,2,1
14,453,453,6,2,4,2,1
12,456,456,26,4,22,3,2

22,107,107,3,3,0,1,0
9,110,110,6,6,0,1,0
4,116,116,24,20,4,2,1
37,126,126,3,3,0,1,0
18,132,132,1,1,0,1,0
19,202,202,12,9,3,2,1
29,228,228,82,56,26,3,2
26,235,235,39,21,18,3,2
1,257,257,23,23,0,1,0
17,258,258,17,1,16,4,3
0,260,260,9,9,0,1,0
13,281,281,60,60,0,1,0
20,294,294,13,13,0,1,0
31,297,297,24,24,0,1,0
24,301,301,3,3,0,1,0
40,304,304,27,27,0,1,0
33,305,305,36,18,18,3,2
12,310,310,41,41,0,1,0
27,336,336,16,16,0,1,0
2,344,344,4,4,0,1,0
39,354,354,33,13,20,3,2
6,365,365,3,3,0,1,0
11,377,377,12,12,0,1,0
32,378,378,16,16,0,1,0
7,399,399,87,3,84,3,2
3,411,411,66,24,42,2,1
38,429,429,11,5,6,3,2
10,437,437,38,38,0,1,0
30,437,437,54,54,0,1,0
16,438,438,22,22,0,1,0
8,441,441,6,1,5,2,1
35,454,454,17,8,9,2,1
5,457,457,8,8,0,1,0
15,457,457,19,19,0,1,0
23,459,459,96,71,25,2,1
36,463,463,87,87,0,1,0
25,471,471,21,21,0,1,0
21,479,479,65,7,58,3,2
28,494,494,62,50,12,4,3
14,496,496,45,45,0,1,0
34,497,497,23,23,0,1,0

28,101,101,7,1,6,2,1
32,121,121,9,9,0,1,0
5,154,154,6,6,0,1,0
2,157,157,1,1,0,1,0
10,158,158,5,5,0,1,0
42,160,160,3,3,0,1,0
31,161,161,13,13,0,1,0
8,166,166,1,1,0,1,0
1,171,171,5,5,0,1,0
29,172,172,11,11,0,1,0
17,191,191,8,5,3,2,1
43,213,213,15,12,3,2,1
25,217,217,5,1,4,2,1
34,218,218,14,4,10,2,1
3,233,233,10,10,0,1,0
24,236,236,51,51,0,1,0
45,239,239,66,66,0,1,0
15,260,260,1,1,0,1,0
38,262,262,17,4,13,2,1
14,262,262,8,1,7,3,2
33,287,287,83,48,35,4,3
27,295,295,2,2,0,1,0
36,299,299,15,1,14,3,2
7,318,318,98,98,0,1,0
46,342,342,13,1,12,3,2
18,346,346,41,41,0,1,0
40,350,350,53,53,0,1,0
13,355,355,10,10,0,1,0
21,360,360,2,2,0,1,0
4,370,370,12,8,4,2,1
41,370,370,51,51,0,1,0
39,372,372,3,3,0,1,0
30,377,377,88,24,64,3,2
12,383,383,18,18,0,1,0
6,384,384,33,33,0,1,0
37,397,397,30,1,29,2,1
19,399,399,77,77,0,1,0
26,415,415,22,4,18,2,1
11,421,421,12,12,0,1,0
47,425,425,9,9,0,1,0
0,426,426,18,18,0,1,0
22,429,429,19,19,0,1,0
9,449,449,74,34,40,2,1
44,455,455,64,49,15,4,3
20,456,456,13,2,11,2,1
35,469,469,18,18,0,1,0
16,474,474,1,1,0,1,0
23,497,497,5,5,0,1,0

3,100,100,16,2,14,3,2
16,105,105,27,4,23,2,1
20,106,106,1,1,0,1,0
22,112,112,23,18,5,2,1
14,114,114,1,1,0,1,0
19,117,117,6,1,5,2,1
35,133,133,12,12,0,1,0
33,134,134,1,1,0,1,0
0,166,166,1,1,0,1,0
18,176,176,6,1,5,2,1
13,188,188,3,3,0,1,0
4,195,195,6,6,0,1,0
5,202,202,14,5,9,4,3
10,208,208,1,1,0,1,0
23,209,209,42,14,28,3,2
31,220,220,34,11,23,3,2
26,225,225,7,7,0,1,0
12,239,239,39,39,0,1,0
9,271,271,65,65,0,1,0
37,277,277,5,5,0,1,0
24,287,287,17,17,0,1,0
25,288,288,41,41,0,1,0
1,301,301,18,8,10,3,2
29,319,319,61,57,4,2,1
32,344,344,80,6,74,3,2
2,351,351,29,9,20,4,3
34,384,384,58,29,29,2,1
27,392,392,10,10,0,1,0
17,410,410,34,34,0,1,0
30,411,411,56,56,0,1,0
15,436,436,15,4,11,4,3
38,450,450,14,14,0,1,0
7,450,450,41,41,0,1,0
8,456,456,30,30,0,1,0
36,469,469,26,18,8,2,1
28,470,470,20,20,0,1,0
21,479,479,31,31,0,1,0
11,490,490,163,43,120,4,3
6,499,499,4,4,0,1,0

7,118,118,46,46,0,1,0
25,121,121,1,1,0,1,0
16,125,125,22,22,0,1,0
1,137,137,5,5,0,1,0
19,145,145,3,3,0,1,0
15,167,167,3,3,0,1,0
11,172,172,12,12,0,1,0
14,178,178,2,2,0,1,0
33,183,183,7,7,0,1,0
27,199,199,14,3,11,2,1
6,205,205,21,21,0,1,0
9,220,220,9,4,5,2,1
17,265,265,33,9,24,4,3
4,280,280,96,57,39,4,3
23,289,289,77,33,44,3,2
13,290,290,52,52,0,1,0
5,305,305,17,17,0,1,0
20,347,347,1,1,0,1,0
8,349,349,47,11,36,3,2
18,362,362,21,21,0,1,0
2,366,366,40,31,9,4,3
28,380,380,21,21,0,1,0
29,386,386,25,13,12,3,2
26,407,407,99,7,92,3,2
22,412,412,25,25,0,1,0
31,413,413,106,5,101,4,3
3,418,418,16,1,15,4,3
21,438,438,63,26,37,3,2
12,454,454,31,5,26,2,1
30,460,460,15,15,0,1,0
32,461,461,86,72,14,2,1
24,470,470,11,11,0,1,0
10,486,486,34,34,0,1,0
0,488,488,65,65,0,1,0

17,101,101,5,5,0,1,0
30,112,112,5,5,0,1,0
10,125,125,7,7,0,1,0
3,125,125,7,1,6,2,1
27,137,137,2,2,0,1,0
19,163,163,1,1,0,1,0
26,168,168,43,43,0,1,0
41,173,173,27,14,13,2,1
40,175,175,2,2,0,1,0
33,197,197,38,35,3,2,1
24,198,198,18,15,3,2,1
36,200,200,18,18,0,1,0
18,201,201,11,2,9,3,2
22,202,202,12,12,0,1,0
12,207,207,71,45,26,3,2
13,207,207,4,4,0,1,0
25,211,211,37,37,0,1,0
5,222,222,4,4,0,1,0
14,224,224,105,105,0,1,0
8,253,253,5,2,3,2,1
37,254,254,29,11,18,3,2
31,257,257,12,8,4,2,1
21,263,263,10,10,0,1,0
32,264,264,69,28,41,2,1
20,274,274,1,1,0,1,0
28,276,276,30,6,24,4,3
39,286,286,12,3,9,2,1
1,288,288,47,21,26,3,2
29,289,289,36,36,0,1,0
34,291,291,10,10,0,1,0
7,309,309,12,2,10,2,1
15,361,361,42,18,24,4,3
35,365,365,23,1,22,3,2
23,374,374,6,6,0,1,0
0,380,380,33,33,0,1,0
9,388,388,1,1,0,1,0
11,389,389,1,1,0,1,0
4,405,405,42,42,0,1,0
6,433,433,7,7,0,1,0
2,439,439,24,24,0,1,0
16,466,466,4,4,0,1,0
38,480,480,3,3,0,1,0

5,103,103,1,1,0,1,0
29,106,106,1,1,0,1,0
10,110,110,3,3,0,1,0
1,117,117,4,4,0,1,0
12,129,129,2,2,0,1,0
9,133,133,11,11,0,1,0
32,138,138,13,7,6,3,2
8,152,152,19,10,9,4,3
36,158,158,6,6,0,1,0
31,177,177,24,4,20,2,1
37,178,178,5,5,0,1,0
11,199,199,78,37,41,4,3
6,225,225,39,15,24,4,3
26,230,230,25,25,0,1,0
21,244,244,107,12,95,4,3
7,261,261,17,5,12,3,2
17,261,261,30,18,12,4,3
18,283,283,16,16,0,1,0
0,305,305,105,60,45,4,3
30,316,316,8,8,0,1,0
15,318,318,1,1,0,1,0
14,337,337,60,60,0,1,0
2,353,353,5,5,0,1,0
22,360,360,9,1,8,3,2
33,377,377,60,56,4,2,1
25,390,390,41,5,36,4,3
24,402,402,18,18,0,1,0
34,406,406,16,7,9,4,3
19,407,407,17,6,11,2,1
20,408,408,1,1,0,1,0
3,426,426,22,22,0,1,0
16,432,432,17,5,12,2,1
27,444,444,81,47,34,2,1
35,445,445,45,45,0,1,0
28,447,447,114,106,8,2,1
4,460,460,13,13,0,1,0
13,483,483,2,2,0,1,0
23,483,483,20,20,0,1,0

1,100,100,15,9,6,2,1
9,102,102,5,5,0,1,0
31,105,105,15,15,0,1,0
0,108,108,4,4,0,1,0
24,110,110,28,10,18,2,1
36,121,121,3,3,0,1,0
7,129,129,1,1,0,1,0
38,142,142,1,1,0,1,0
32,148,148,7,7,0,1,0
16,153,153,15,15,0,1,0
26,156,156,11,3,8,2,1
14,165,165,10,10,0,1,0
30,179,179,2,2,0,1,0
15,201,201,15,15,0,1,0
25,207,207,15,2,13,2,1
34,209,209,54,39,15,4,3
8,218,218,13,13,0,1,0
22,228,228,12,12,0,1,0
28,229,229,6,2,4,2,1
23,232,232,33,5,28,3,2
6,251,251,15,15,0,1,0
3,255,255,41,41,0,1,0
18,264,264,24,24,0,1,0
39,268,268,25,25,0,1,0
12,269,269,18,6,12,3,2
17,274,274,17,11,6,3,2
40,284,284,30,30,0,1,0
33,306,306,2,2,0,1,0
10,321,321,17,5,12,3,2
13,347,347,11,11,0,1,0
35,350,350,35,35,0,1,0
37,374,374,92,44,48,2,1
41,375,375,71,71,0,1,0
19,384,384,23,23,0,1,0
2,394,394,20,9,11,2,1
11,396,396,64,49,15,4,3
4,418,418,11,3,8,3,2
5,457,457,52,33,19,2,1
20,461,461,38,5,33,4,3
21,478,478,24,24,0,1,0
27,491,491,18,18,0,1,0
29,494,494,71,25,46,4,3

0,125,125,4,4,0,1,0
18,130,130,1,1,0,1,0
9,163,163,20,14,6,3,2
23,165,165,29,14,15,4,3
1,187,187,1,1,0,1,0
14,195,195,29,18,11,2,1
3,207,207,2,2,0,1,0
26,216,216,72,72,0,1,0
24,239,239,3,3,0,1,0
15,245,245,10,10,0,1,0
22,246,246,44,44,0,1,0
17,253,253,35,35,0,1,0
28,254,254,7,4,3,2,1
21,276,276,9,9,0,1,0
2,284,284,14,10,4,2,1
7,296,296,37,37,0,1,0
20,336,336,4,4,0,1,0
13,342,342,20,13,7,2,1
4,356,356,202,202,0,1,0
25,397,397,16,16,0,1,0
29,402,402,12,9,3,2,1
10,404,404,1,1,0,1,0
8,406,406,68,68,0,1,0
19,413,413,58,58,0,1,0
27,423,423,42,42,0,1,0
12,449,449,82,28,54,4,3
5,455,455,62,62,0,1,0
6,477,477,114,102,12,4,3
11,481,481,166,128,38,4,3
16,488,488,81,81,0,1,0

5,102,102,15,11,4,2,1
0,102,102,3,3,0,1,0
23,124,124,10,3,7,2,1
32,125,125,40,25,15,4,3
35,148,148,8,8,0,1,0
12,174,174,5,2,3,2,1
24,184,184,12,5,7,2,1
16,196,196,5,5,0,1,0
17,254,254,6,6,0,1,0
7,279,279,4,4,0,1,0
30,284,284,87,11,76,3,2
10,284,284,19,19,0,1,0
33,295,295,7,2,5,2,1
21,300,300,18,18,0,1,0
31,309,309,32,2,30,3,2
11,317,317,41,41,0,1,0
9,320,320,34,17,17,4,3
38,324,324,9,9,0,1,0
20,325,325,2,2,0,1,0
8,331,331,102,78,24,4,3
13,340,340,24,21,3,2,1
37,341,341,11,6,5,2,1
25,352,352,34,34,0,1,0
34,363,363,36,17,19,2,1
1,365,365,54,54,0,1,0
27,375,375,16,16,0,1,0
6,379,379,43,24,19,2,1
18,391,391,34,16,18,4,3
19,398,398,37,17,20,3,2
3,399,399,68,34,34,2,1
28,430,430,16,16,0,1,0
39,436,436,82,22,60,4,3
26,443,443,70,70,0,1,0
22,447,447,40,7,33,2,1
4,467,467,12,4,8,3,2
14,469,469,40,40,0,1,0
2,475,475,21,21,0,1,0
29,481,481,3,3,0,1,0
36,494,494,46,46,0,1,0
15,496,496,9,5,4,2,1

20,101,101,20,20,0,1,0
42,109,109,15,15,0,1,0
4,117,117,5,5,0,1,0
40,121,121,77,70,7,2,1
43,133,133,3,3,0,1,0
7,146,146,2,2,0,1,0
24,157,157,19,19,0,1,0
36,165,165,30,30,0,1,0
15,178,178,22,22,0,1,0
41,207,207,16,16,0,1,0
14,227,227,15,10,5,2,1
31,234,234,7,7,0,1,0
13,251,251,25,25,0,1,0
46,259,259,5,5,0,1,0
21,273,273,7,1,6,3,2
11,282,282,4,1,3,2,1
6,299,299,22,22,0,1,0
44,320,320,18,13,5,2,1
16,325,325,1,1,0,1,0
37,325,325,15,15,0,1,0
0,325,325,23,13,10,2,1
30,333,333,18,6,12,3,2
12,336,336,27,27,0,1,0
28,338,338,8,8,0,1,0
18,342,342,13,4,9,2,1
47,359,359,46,46,0,1,0
9,366,366,1,1,0,1,0
19,391,391,43,35,8,3,2
25,405,405,5,2,3,2,1
33,416,416,17,9,8,2,1
27,417,417,24,24,0,1,0
23,427,427,1,1,0,1,0
22,432,432,23,23,0,1,0
8,437,437,28,12,16,2,1
35,443,443,30,30,0,1,0
10,448,448,30,30,0,1,0
1,452,452,41,19,22,2,1
3,459,459,13,13,0,1,0
2,459,459,24,24,0,1,0
38,467,467,4,4,0,1,0
45,467,467,69,69,0,1,0
39,469,469,37,3,34,2,1
5,476,476,42,22,20,3,2
34,478,478,13,6,7,2,1
26,479,479,38,38,0,1,0
48,482,482,13,3,10,2,1
32,490,490,56,56,0,1,0
29,498,498,18,13,5,2,1
17,500,500,4,4,0,1,0

22,106,106,4,1,3,2,1
18,117,117,32,32,0,1,0
25,123,123,4,4,0,1,0
3,127,127,5,5,0,1,0
20,140,140,24,24,0,1,0
31,168,168,2,2,0,1,0
12,204,204,56,3,53,4,3
11,208,208,29,29,0,1,0
7,213,213,22,22,0,1,0
15,215,215,11,5,6,3,2
19,218,218,19,2,17,4,3
8,236,236,18,18,0,1,0
30,236,236,29,9,20,3,2
24,244,244,11,1,10,3,2
28,279,279,5,5,0,1,0
16,286,286,3,3,0,1,0
0,291,291,56,56,0,1,0
9,294,294,9,9,0,1,0
26,299,299,51,39,12,4,3
5,304,304,26,26,0,1,0
4,309,309,112,112,0,1,0
2,315,315,2,2,0,1,0
6,327,327,31,21,10,3,2
29,354,354,12,2,10,3,2
17,358,358,170,83,87,4,3
14,396,396,43,43,0,1,0
1,415,415,72,30,42,3,2
21,425,425,52,8,44,3,2
27,458,458,39,27,12,2,1
10,461,461,29,20,9,4,3
13,465,465,24,14,10,3,2
32,487,487,38,38,0,1,0
23,488,488,6,6,0,1,0

38,113,113,1,1,0,1,0
16,115,115,7,7,0,1,0
29,117,117,23,23,0,1,0
26,117,117,7,2,5,2,1
37,122,122,12,12,0,1,0
24,137,137,21,2,19,2,1
6,139,139,25,7,18,2,1
1,141,141,11,11,0,1,0
19,146,146,10,10,0,1,0
13,156,156,1,1,0,1,0
32,157,157,35,20,15,2,1
39,158,158,30,22,8,3,2
34,177,177,4,4,0,1,0
8,208,208,39,24,15,4,3
30,213,213,9,1,8,3,2
27,234,234,32,32,0,1,0
5,256,256,17,17,0,1,0
25,263,263,37,30,7,2,1
20,271,271,12,4,8,3,2
7,288,288,1,1,0,1,0
12,289,289,22,4,18,2,1
28,296,296,35,11,24,4,3
11,308,308,22,22,0,1,0
21,318,318,52,6,46,3,2
22,339,339,14,14,0,1,0
31,349,349,16,11,5,2,1
40,350,350,25,3,22,3,2
15,353,353,124,108,16,2,1
18,354,354,1,1,0,1,0
17,392,392,14,14,0,1,0
35,410,410,2,2,0,1,0
3,417,417,24,17,7,2,1
0,429,429,13,4,9,2,1
10,445,445,27,27,0,1,0
23,460,460,32,32,0,1,0
9,469,469,16,16,0,1,0
36,469,469,80,26,54,4,3
2,472,472,12,12,0,1,0
33,477,477,41,30,11,2,1
14,490,490,48,10,38,3,2
4,491,491,29,29,0,1,0

7,102,102,6,1,5,2,1
14,111,111,5,5,0,1,0
31,112,112,2,2,0,1,0
16,117,117,5,5,0,1,0
8,122,122,42,42,0,1,0
1,142,142,28,14,14,3,2
3,153,153,2,2,0,1,0
21,158,158,2,2,0,1,0
32,166,166,38,16,22,2,1
33,209,209,8,8,0,1,0
6,240,240,6,6,0,1,0
11,261,261,17,5,12,4,3
5,268,268,24,24,0,1,0
26,274,274,25,7,18,3,2
2,286,286,47,47,0,1,0
35,294,294,14,14,0,1,0
15,301,301,1,1,0,1,0
19,305,305,17,13,4,2,1
20,319,319,43,43,0,1,0
25,321,321,8,8,0,1,0
23,328,328,55,29,26,2,1
13,330,330,15,3,12,3,2
9,344,344,33,33,0,1,0
29,347,347,25,25,0,1,0
30,358,358,79,42,37,2,1
4,381,381,32,16,16,4,3
0,402,402,6,6,0,1,0
27,409,409,9,9,0,1,0
10,409,409,49,29,20,3,2
17,412,412,7,1,6,2,1
28,413,413,4,4,0,1,0
22,430,430,166,106,60,3,2
34,433,433,57,57,0,1,0
12,460,460,173,80,93,4,3
24,486,486,47,14,33,2,1
18,495,495,39,39,0,1,0

1,107,107,31,10,21,4,3
23,122,122,7,7,0,1,0
11,129,129,6,6,0,1,0
29,144,144,34,17,17,2,1
21,194,194,33,33,0,1,0
13,203,203,9,1,8,2,1
30,235,235,2,2,0,1,0
7,243,243,23,11,12,4,3
4,255,255,16,16,0,1,0
16,306,306,73,13,60,3,2
14,309,309,2,2,0,1,0
12,319,319,10,1,9,4,3
27,330,330,1,1,0,1,0
3,330,330,228,212,16,2,1
9,334,334,146,116,30,2,1
20,357,357,100,50,50,4,3
8,363,363,4,4,0,1,0
10,368,368,19,19,0,1,0
6,378,378,5,5,0,1,0
19,387,387,4,4,0,1,0
26,396,396,83,3,80,3,2
22,403,403,23,5,18,3,2
2,407,407,12,12,0,1,0
18,413,413,59,13,46,3,2
0,419,419,8,8,0,1,0
24,438,438,9,9,0,1,0
28,450,450,7,7,0,1,0
17,478,478,3,3,0,1,0
15,479,479,145,35,110,4,3
5,485,485,11,11,0,1,0
25,488,488,10,10,0,1,0

32,100,100,1,1,0,1,0
40,109,109,1,1,0,1,0
3,116,116,15,8,7,2,1
13,120,120,5,5,0,1,0
34,134,134,13,13,0,1,0
0,142,142,5,5,0,1,0
21,159,159,27,24,3,2,1
4,167,167,12,8,4,2,1
38,172,172,13,13,0,1,0
15,182,182,32,4,28,2,1
26,197,197,6,6,0,1,0
10,214,214,2,2,0,1,0
11,228,228,1,1,0,1,0
23,229,229,4,4,0,1,0
28,243,243,10,10,0,1,0
35,274,274,21,21,0,1,0
29,275,275,51,1,50,2,1
37,276,276,26,26,0,1,0
30,281,281,48,15,33,4,3
7,285,285,25,25,0,1,0
12,327,327,43,6,37,2,1
27,331,331,71,53,18,2,1
18,345,345,33,19,14,4,3
39,346,346,65,47,18,2,1
41,347,347,51,51,0,1,0
24,354,354,54,54,0,1,0
36,358,358,57,57,0,1,0
5,363,363,16,5,11,2,1
9,369,369,72,6,66,4,3
8,373,373,90,52,38,2,1
17,391,391,16,7,9,4,3
2,402,402,39,4,35,2,1
6,406,406,8,2,6,3,2
22,411,411,18,18,0,1,0
25,419,419,18,6,12,3,2
1,451,451,13,13,0,1,0
33,465,465,21,13,8,2,1
19,477,477,7,4,3,2,1
14,479,479,33,33,0,1,0
20,485,485,15,12,3,2,1
31,486,486,50,36,14,2,1
16,492,492,4,4,0,1,0

18,101,101,2,2,0,1,0
9,115,115,22,22,0,1,0
2,121,121,6,6,0,1,0
20,131,131,1,1,0,1,0
0,141,141,24,24,0,1,0
24,154,154,2,2,0,1,0
31,156,156,23,23,0,1,0
26,178,178,2,2,0,1,0
12,208,208,27,14,13,2,1
3,216,216,24,24,0,1,0
11,269,269,90,39,51,4,3
21,281,281,31,31,0,1,0
16,285,285,57,57,0,1,0
30,296,296,37,11,26,3,2
14,299,299,23,23,0,1,0
6,305,305,5,5,0,1,0
27,310,310,49,49,0,1,0
13,313,313,40,40,0,1,0
17,370,370,113,113,0,1,0
23,381,381,30,30,0,1,0
15,385,385,46,46,0,1,0
29,386,386,26,8,18,4,3
8,386,386,3,3,0,1,0
5,391,391,11,8,3,2,1
19,407,407,36,36,0,1,0
32,416,416,17,11,6,2,1
1,419,419,71,17,54,4,3
25,427,427,16,16,0,1,0
4,444,444,32,32,0,1,0
10,444,444,80,48,32,4,3
22,470,470,39,23,16,2,1
7,484,484,66,66,0,1,0
28,492,492,112,84,28,3,2

6,130,130,3,3,0,1,0
33,142,142,16,16,0,1,0
3,147,147,6,1,5,2,1
17,151,151,44,16,28,2,1
37,160,160,5,5,0,1,0
16,166,166,6,6,0,1,0
12,175,175,1,1,0,1,0
32,181,181,32,2,30,2,1
18,188,188,19,19,0,1,0
23,201,201,3,3,0,1,0
8,216,216,49,2,47,4,3
42,216,216,3,3,0,1,0
26,218,218,11,11,0,1,0
41,229,229,22,4,18,2,1
39,234,234,9,9,0,1,0
15,248,248,18,18,0,1,0
36,261,261,27,16,11,2,1
13,272,272,21,5,16,2,1
4,274,274,13,1,12,2,1
27,279,279,24,24,0,1,0
28,297,297,21,21,0,1,0
31,298,298,87,6,81,4,3
34,301,301,19,19,0,1,0
21,312,312,20,17,3,2,1
24,314,314,23,23,0,1,0
43,318,318,14,14,0,1,0
11,338,338,22,22,0,1,0
0,339,339,10,10,0,1,0
29,358,358,3,3,0,1,0
1,371,371,17,17,0,1,0
7,385,385,1,1,0,1,0
14,385,385,51,36,15,4,3
9,387,387,3,3,0,1,0
44,395,395,51,51,0,1,0
22,400,400,3,3,0,1,0
20,400,400,109,109,0,1,0
40,410,410,13,2,11,2,1
30,423,423,60,42,18,2,1
38,429,429,88,88,0,1,0
35,434,434,82,76,6,2,1
2,446,446,2,2,0,1,0
19,457,457,14,14,0,1,0
5,468,468,17,17,0,1,0
10,474,474,15,15,0,1,0
25,498,498,6,6,0,1,0

30,108,108,3,3,0,1,0
20,110,110,7,1,6,3,2
7,114,114,19,3,16,4,3
31,115,115,25,25,0,1,0
33,134,134,11,3,8,3,2
18,140,140,1,1,0,1,0
34,143,143,26,26,0,1,0
2,163,163,12,6,6,3,2
15,189,189,4,4,0,1,0
21,199,199,9,9,0,1,0
12,200,200,13,4,9,2,1
23,203,203,14,14,0,1,0
22,205,205,6,6,0,1,0
1,216,216,22,22,0,1,0
38,239,239,29,29,0,1,0
10,239,239,21,13,8,3,2
14,250,250,4,4,0,1,0
35,253,253,1,1,0,1,0
0,256,256,13,1,12,4,3
3,258,258,86,86,0,1,0
5,263,263,77,23,54,4,3
8,288,288,1,1,0,1,0
11,297,297,7,3,4,2,1
26,297,297,37,7,30,3,2
25,299,299,22,22,0,1,0
29,304,304,20,20,0,1,0
32,310,310,35,14,21,4,3
17,311,311,23,23,0,1,0
24,326,326,78,4,74,3,2
36,326,326,12,12,0,1,0
27,334,334,46,5,41,3,2
37,370,370,41,41,0,1,0
4,407,407,2,2,0,1,0
16,422,422,19,19,0,1,0
19,453,453,28,28,0,1,0
13,458,458,12,12,0,1,0
6,468,468,46,46,0,1,0
28,486,486,77,35,42,3,2
9,497,497,91,31,60,3,2

26,118,118,12,12,0,1,0
12,120,120,1,1,0,1,0
4,128,128,40,40,0,1,0
14,157,157,9,4,5,2,1
7,184,184,10,10,0,1,0
18,187,187,2,2,0,1,0
35,187,187,6,6,0,1,0
20,203,203,22,7,15,4,3
19,215,215,26,17,9,4,3
15,218,218,11,11,0,1,0
9,221,221,13,1,12,2,1
3,234,234,63,16,47,4,3
21,237,237,42,42,0,1,0
5,244,244,6,6,0,1,0
17,250,250,3,3,0,1,0
6,251,251,2,2,0,1,0
30,257,257,31,21,10,3,2
32,261,261,1,1,0,1,0
24,279,279,43,43,0,1,0
28,281,281,44,44,0,1,0
25,288,288,26,26,0,1,0
1,291,291,46,6,40,3,2
16,317,317,6,6,0,1,0
0,318,318,1,1,0,1,0
10,323,323,33,18,15,4,3
13,351,351,36,36,0,1,0
22,353,353,5,5,0,1,0
27,378,378,56,47,9,4,3
36,383,383,13,13,0,1,0
8,383,383,10,10,0,1,0
33,394,394,79,79,0,1,0
29,403,403,70,25,45,4,3
34,408,408,52,52,0,1,0
23,437,437,22,22,0,1,0
11,463,463,66,66,0,1,0
31,477,477,11,1,10,3,2
2,497,497,191,96,95,4,3

35,103,103,1,1,0,1,0
0,115,115,36,2,34,2,1
1,139,139,4,4,0,1,0
17,150,150,22,22,0,1,0
9,159,159,2,2,0,1,0
3,168,168,13,13,0,1,0
28,182,182,12,12,0,1,0
10,183,183,49,19,30,2,1
31,193,193,4,4,0,1,0
23,195,195,10,10,0,1,0
38,196,196,29,14,15,2,1
20,202,202,4,4,0,1,0
22,204,204,1,1,0,1,0
18,214,214,9,9,0,1,0
34,219,219,2,2,0,1,0
36,222,222,2,2,0,1,0
2,227,227,39,39,0,1,0
11,230,230,12,12,0,1,0
12,245,245,23,23,0,1,0
33,248,248,37,37,0,1,0
8,251,251,1,1,0,1,0
13,252,252,15,15,0,1,0
25,306,306,59,25,34,4,3
5,312,312,6,6,0,1,0
32,318,318,13,13,0,1,0
24,339,339,56,38,18,3,2
7,344,344,8,2,6,2,1
19,348,348,68,10,58,4,3
6,363,363,20,20,0,1,0
27,363,363,109,62,47,2,1
4,371,371,7,1,6,2,1
15,379,379,30,14,16,2,1
16,437,437,2,2,0,1,0
14,439,439,17,11,6,2,1
30,449,449,7,7,0,1,0
26,450,450,35,14,21,4,3
29,452,452,5,5,0,1,0
39,461,461,69,69,0,1,0
37,478,478,196,118,78,4,3
21,479,479,37,37,0,1,0

11,113,113,18,7,11,3,2
25,123,123,45,13,32,2,1
26,145,145,2,2,0,1,0
10,150,150,29,29,0,1,0
14,164,164,31,31,0,1,0
22,172,172,8,4,4,2,1
6,203,203,4,1,3,2,1
29,232,232,27,27,0,1,0
12,234,234,13,8,5,2,1
9,251,251,79,7,72,3,2
5,256,256,66,66,0,1,0
0,260,260,50,50,0,1,0
27,261,261,17,8,9,2,1
20,264,264,31,16,15,4,3
13,282,282,17,17,0,1,0
7,291,291,52,52,0,1,0
1,305,305,4,4,0,1,0
24,309,309,29,29,0,1,0
8,324,324,25,16,9,4,3
17,326,326,91,48,43,4,3
23,331,331,38,15,23,2,1
4,362,362,31,31,0,1,0
16,365,365,13,13,0,1,0
3,372,372,91,16,75,3,2
19,373,373,53,32,21,2,1
28,376,376,33,17,16,2,1
21,418,418,2,2,0,1,0
30,429,429,9,6,3,2,1
15,432,432,7,4,3,2,1
2,455,455,4,4,0,1,0
18,490,490,28,12,16,3,2

12,120,120,3,3,0,1,0
1,121,121,7,7,0,1,0
28,138,138,43,43,0,1,0
22,147,147,2,2,0,1,0
11,151,151,1,1,0,1,0
4,154,154,6,6,0,1,0
5,169,169,5,5,0,1,0
6,174,174,5,5,0,1,0
36,174,174,35,26,9,4,3
25,175,175,9,9,0,1,0
33,180,180,9,9,0,1,0
9,195,195,18,18,0,1,0
34,215,215,21,21,0,1,0
19,222,222,43,25,18,2,1
31,226,226,16,16,0,1,0
32,227,227,12,12,0,1,0
3,245,245,15,8,7,2,1
29,266,266,7,4,3,2,1
18,271,271,19,19,0,1,0
35,282,282,40,33,7,2,1
24,288,288,1,1,0,1,0
2,294,294,46,46,0,1,0
10,311,311,15,1,14,3,2
0,315,315,3,3,0,1,0
30,320,320,45,7,38,4,3
17,354,354,64,2,62,3,2
8,391,391,73,30,43,2,1
37,396,396,28,28,0,1,0
23,399,399,58,58,0,1,0
13,415,415,37,15,22,2,1
20,428,428,46,46,0,1,0
27,439,439,66,18,48,4,3
15,445,445,65,17,48,3,2
16,446,446,46,22,24,3,2
14,452,452,37,37,0,1,0
26,480,480,19,19,0,1,0
7,490,490,97,97,0,1,0
21,500,500,81,64,17,2,1

7,100,100,19,7,12,3,2
40,113,113,10,10,0,1,0
17,114,114,1,1,0,1,0
5,115,115,6,6,0,1,0
20,120,120,7,4,3,2,1
19,121,121,6,1,5,2,1
29,129,129,6,6,0,1,0
33,131,131,10,10,0,1,0
2,138,138,1,1,0,1,0
16,142,142,18,3,15,4,3
37,149,149,17,17,0,1,0
26,152,152,8,8,0,1,0
8,171,171,1,1,0,1,0
11,177,177,1,1,0,1,0
28,178,178,1,1,0,1,0
3,202,202,23,23,0,1,0
27,204,204,5,5,0,1,0
10,205,205,23,15,8,2,1
31,212,212,11,5,6,2,1
36,214,214,21,21,0,1,0
21,221,221,8,8,0,1,0
32,223,223,61,4,57,4,3
34,230,230,17,1,16,4,3
46,240,240,4,1,3,2,1
47,255,255,7,3,4,2,1
4,261,261,31,31,0,1,0
35,269,269,13,1,12,3,2
39,274,274,22,19,3,2,1
25,294,294,35,35,0,1,0
41,302,302,72,36,36,2,1
14,302,302,2,2,0,1,0
43,313,313,36,36,0,1,0
38,317,317,14,4,10,2,1
18,329,329,1,1,0,1,0
12,350,350,19,7,12,4,3
13,360,360,79,79,0,1,0
42,361,361,70,70,0,1,0
1,369,369,4,4,0,1,0
6,374,374,6,6,0,1,0
9,392,392,38,38,0,1,0
44,408,408,10,4,6,2,1
30,412,412,82,82,0,1,0
45,421,421,35,13,22,3,2
23,450,450,10,5,5,2,1
22,451,451,6,6,0,1,0
0,453,453,26,2,24,2,1
15,472,472,50,36,14,2,1
24,479,479,29,29,0,1,0

35,106,106,2,2,0,1,0
5,108,108,1,1,0,1,0
18,110,110,5,5,0,1,0
17,111,111,1,1,0,1,0
13,127,127,23,23,0,1,0
11,131,131,18,18,0,1,0
25,138,138,4,1,3,2,1
7,147,147,1,1,0,1,0
2,149,149,10,10,0,1,0
27,156,156,7,2,5,2,1
12,162,162,9,1,8,2,1
33,195,195,61,35,26,3,2
30,201,201,36,4,32,3,2
23,210,210,6,6,0,1,0
24,212,212,7,7,0,1,0
38,215,215,18,4,14,2,1
1,227,227,40,40,0,1,0
20,235,235,25,1,24,4,3
39,239,239,9,9,0,1,0
29,254,254,6,6,0,1,0
14,265,265,17,3,14,3,2
34,280,280,56,18,38,3,2
9,317,317,9,3,6,2,1
22,323,323,30,30,0,1,0
19,328,328,3,3,0,1,0
26,328,328,53,23,30,3,2
21,347,347,99,99,0,1,0
0,359,359,1,1,0,1,0
4,361,361,28,28,0,1,0
37,366,366,21,21,0,1,0
32,385,385,23,14,9,4,3
28,412,412,43,43,0,1,0
15,416,416,34,4,30,4,3
8,421,421,91,3,88,3,2
36,429,429,154,90,64,3,2
6,429,429,58,28,30,4,3
31,434,434,7,2,5,2,1
10,459,459,3,3,0,1,0
3,479,479,40,14,26,2,1
16,488,488,8,8,0,1,0

15,106,106,2,2,0,1,0
37,112,112,7,7,0,1,0
30,116,116,19,3,16,2,1
34,122,122,12,4,8,2,1
27,139,139,18,18,0,1,0
25,142,142,3,3,0,1,0
7,154,154,49,49,0,1,0
3,174,174,17,6,11,2,1
17,212,212,70,70,0,1,0
10,228,228,28,2,26,3,2
9,240,240,3,3,0,1,0
21,250,250,7,7,0,1,0
33,261,261,14,1,13,2,1
2,266,266,20,8,12,4,3
24,277,277,8,8,0,1,0
20,283,283,30,1,29,3,2
28,288,288,1,1,0,1,0
23,301,301,43,23,20,3,2
0,315,315,39,39,0,1,0
31,316,316,113,19,94,4,3
11,332,332,9,9,0,1,0
4,341,341,3,3,0,1,0
1,349,349,17,17,0,1,0
29,370,370,12,2,10,3,2
26,383,383,57,57,0,1,0
35,387,387,37,37,0,1,0
19,388,388,9,9,0,1,0
5,404,404,55,44,11,2,1
13,410,410,10,1,9,4,3
36,411,411,92,70,22,3,2
8,422,422,47,22,25,2,1
18,444,444,15,15,0,1,0
16,447,447,2,2,0,1,0
6,469,469,31,8,23,2,1
32,474,474,57,42,15,4,3
12,476,476,10,10,0,1,0
14,484,484,95,95,0,1,0
22,491,491,13,4,9,2,1

23,121,121,60,27,33,2,1
5,136,136,28,28,0,1,0
10,137,137,17,17,0,1,0
34,169,169,3,3,0,1,0
8,169,169,21,15,6,3,2
12,170,170,1,1,0,1,0
18,172,172,1,1,0,1,0
6,176,176,50,5,45,4,3
19,182,182,13,13,0,1,0
1,186,186,1,1,0,1,0
24,199,199,13,13,0,1,0
4,241,241,48,48,0,1,0
9,243,243,11,11,0,1,0
11,246,246,5,5,0,1,0
27,247,247,45,18,27,2,1
26,254,254,9,3,6,3,2
15,258,258,9,3,6,3,2
7,277,277,20,20,0,1,0
28,282,282,3,3,0,1,0
31,282,282,13,5,8,2,1
25,290,290,13,13,0,1,0
22,297,297,3,3,0,1,0
3,302,302,34,4,30,4,3
17,302,302,37,37,0,1,0
16,342,342,15,15,0,1,0
30,351,351,91,55,36,4,3
13,367,367,149,56,93,4,3
21,389,389,96,32,64,4,3
2,397,397,9,1,8,3,2
20,399,399,18,18,0,1,0
32,401,401,19,19,0,1,0
33,441,441,4,4,0,1,0
0,472,472,25,3,22,3,2
14,476,476,20,20,0,1,0
29,497,497,61,43,18,4,3

34,109,109,5,2,3,2,1
19,114,114,15,15,0,1,0
38,118,118,3,3,0,1,0
29,118,118,13,5,8,3,2
32,136,136,36,36,0,1,0
20,141,141,11,11,0,1,0
36,159,159,29,29,0,1,0
31,167,167,7,7,0,1,0
5,169,169,19,16,3,2,1
25,176,176,7,3,4,2,1
13,198,198,8,2,6,2,1
16,210,210,20,20,0,1,0
14,231,231,23,1,22,3,2
4,239,239,49,28,21,2,1
15,260,260,1,1,0,1,0
28,278,278,12,3,9,2,1
10,280,280,4,4,0,1,0
3,289,289,20,8,12,2,1
12,298,298,17,17,0,1,0
30,302,302,62,62,0,1,0
18,307,307,28,21,7,2,1
1,313,313,16,16,0,1,0
8,321,321,7,7,0,1,0
26,321,321,13,13,0,1,0
40,325,325,41,29,12,3,2
7,325,325,49,49,0,1,0
33,327,327,40,25,15,4,3
9,342,342,56,56,0,1,0
17,353,353,2,2,0,1,0
27,380,380,21,6,15,4,3
23,382,382,20,8,12,4,3
21,387,387,6,6,0,1,0
0,388,388,27,2,25,2,1
35,390,390,13,13,0,1,0
6,418,418,7,4,3,2,1
11,418,418,86,86,0,1,0
39,421,421,21,21,0,1,0
22,424,424,15,7,8,2,1
24,428,428,93,24,69,4,3
37,455,455,83,41,42,3,2
2,490,490,33,33,0,1,0

16,110,110,17,11,6,2,1
36,126,126,11,11,0,1,0
12,133,133,1,1,0,1,0
26,136,136,6,6,0,1,0
35,146,146,33,33,0,1,0
9,156,156,11,4,7,2,1
11,165,165,17,5,12,4,3
19,168,168,31,25,6,2,1
23,177,177,1,1,0,1,0
27,193,193,3,3,0,1,0
34,228,228,41,23,18,4,3
20,229,229,2,2,0,1,0
37,239,239,25,16,9,4,3
22,260,260,6,6,0,1,0
38,273,273,76,76,0,1,0
2,284,284,6,6,0,1,0
7,312,312,29,18,11,2,1
29,314,314,39,24,15,2,1
28,319,319,5,2,3,2,1
25,323,323,11,11,0,1,0
31,324,324,116,116,0,1,0
4,332,332,9,9,0,1,0
0,335,335,33,33,0,1,0
18,353,353,2,2,0,1,0
21,357,357,14,14,0,1,0
33,387,387,2,2,0,1,0
8,387,387,53,23,30,2,1
6,389,389,31,31,0,1,0
14,391,391,50,31,19,2,1
13,401,401,17,7,10,2,1
32,415,415,94,94,0,1,0
17,421,421,74,74,0,1,0
5,434,434,34,34,0,1,0
30,439,439,5,5,0,1,0
1,450,450,17,11,6,2,1
10,464,464,85,85,0,1,0
39,467,467,15,15,0,1,0
24,469,469,3,3,0,1,0
40,485,485,39,39,0,1,0
15,496,496,38,17,21,2,1
3,500,500,14,14,0,1,0

21,115,115,11,11,0,1,0
7,141,141,1,1,0,1,0
22,163,163,11,3,8,3,2
5,172,172,7,3,4,2,1
6,181,181,40,34,6,2,1
26,194,194,46,42,4,2,1
3,200,200,6,6,0,1,0
4,202,202,59,23,36,2,1
32,204,204,11,11,0,1,0
15,215,215,20,20,0,1,0
31,230,230,3,3,0,1,0
9,231,231,31,15,16,3,2
23,244,244,12,12,0,1,0
25,249,249,8,8,0,1,0
11,254,254,6,6,0,1,0
19,276,276,82,82,0,1,0
29,281,281,11,7,4,2,1
30,293,293,5,2,3,2,1
33,310,310,87,6,81,4,3
2,331,331,5,5,0,1,0
8,356,356,30,30,0,1,0
18,361,361,7,2,5,2,1
1,387,387,164,104,60,4,3
24,389,389,4,4,0,1,0
12,395,395,19,19,0,1,0
13,425,425,13,13,0,1,0
14,428,428,21,21,0,1,0
0,428,428,23,7,16,3,2
16,430,430,82,14,68,3,2
20,443,443,14,14,0,1,0
27,453,453,105,105,0,1,0
17,474,474,74,74,0,1,0
28,478,478,1,1,0,1,0
10,485,485,125,95,30,4,3

17,119,119,10,6,4,2,1
16,138,138,1,1,0,1,0
8,151,151,4,4,0,1,0
6,155,155,23,9,14,2,1
0,156,156,4,4,0,1,0
5,156,156,18,5,13,2,1
21,171,171,2,2,0,1,0
18,178,178,10,6,4,2,1
28,190,190,19,19,0,1,0
11,191,191,26,26,0,1,0
15,200,200,17,17,0,1,0
4,200,200,16,1,15,2,1
20,211,211,6,6,0,1,0
25,212,212,22,22,0,1,0
12,215,215,13,13,0,1,0
31,242,242,6,6,0,1,0
24,261,261,48,2,46,2,1
34,275,275,55,49,6,3,2
14,277,277,6,6,0,1,0
27,288,288,3,3,0,1,0
22,307,307,1,1,0,1,0
37,318,318,11,11,0,1,0
2,325,325,7,1,6,3,2
3,346,346,3,3,0,1,0
1,368,368,15,15,0,1,0
32,368,368,46,46,0,1,0
29,391,391,74,74,0,1,0
26,398,398,109,109,0,1,0
13,398,398,44,44,0,1,0
38,403,403,18,8,10,3,2
35,414,414,6,6,0,1,0
7,435,435,15,12,3,2,1
19,439,439,174,57,117,4,3
10,450,450,68,68,0,1,0
33,455,455,34,16,18,4,3
23,469,469,127,115,12,4,3
9,471,471,78,78,0,1,0
30,473,473,18,15,3,2,1
36,498,498,65,65,0,1,0

21,115,115,3,3,0,1,0
6,149,149,4,4,0,1,0
33,150,150,15,15,0,1,0
16,153,153,8,8,0,1,0
18,157,157,1,1,0,1,0
9,169,169,10,5,5,2,1
10,176,176,16,16,0,1,0
5,180,180,21,14,7,2,1
28,181,181,8,8,0,1,0
26,185,185,14,14,0,1,0
11,191,191,5,5,0,1,0
1,193,193,12,12,0,1,0
20,202,202,44,14,30,2,1
19,207,207,1,1,0,1,0
29,215,215,2,2,0,1,0
37,218,218,22,7,15,4,3
35,240,240,3,3,0,1,0
32,243,243,51,33,18,3,2
25,252,252,4,4,0,1,0
0,257,257,4,4,0,1,0
15,257,257,50,50,0,1,0
8,262,262,4,4,0,1,0
27,264,264,4,1,3,2,1
12,270,270,64,39,25,2,1
14,279,279,68,54,14,3,2
22,294,294,35,1,34,3,2
4,313,313,44,22,22,3,2
24,333,333,21,21,0,1,0
13,337,337,2,2,0,1,0
36,357,357,76,76,0,1,0
30,381,381,1,1,0,1,0
17,383,383,1,1,0,1,0
38,394,394,7,7,0,1,0
34,409,409,36,2,34,3,2
31,415,415,119,104,15,2,1
7,431,431,22,12,10,3,2
2,461,461,94,94,0,1,0
23,478,478,206,206,0,1,0
3,499,499,15,1,14,3,2

28,120,120,3,3,0,1,0
29,120,120,8,8,0,1,0
2,128,128,26,26,0,1,0
24,162,162,14,5,9,4,3
15,167,167,23,23,0,1,0
34,181,181,18,18,0,1,0
22,187,187,5,5,0,1,0
30,190,190,44,19,25,4,3
35,198,198,18,3,15,2,1
1,209,209,9,9,0,1,0
12,211,211,22,7,15,3,2
16,213,213,1,1,0,1,0
25,219,219,8,5,3,2,1
20,222,222,9,3,6,3,2
37,227,227,21,21,0,1,0
3,265,265,8,8,0,1,0
11,277,277,30,30,0,1,0
32,284,284,75,3,72,4,3
31,289,289,3,3,0,1,0
9,289,289,19,19,0,1,0
18,297,297,11,11,0,1,0
27,300,300,7,2,5,2,1
0,310,310,50,50,0,1,0
13,314,314,1,1,0,1,0
36,331,331,2,2,0,1,0
33,348,348,65,17,48,2,1
26,367,367,49,49,0,1,0
10,376,376,75,1,74,4,3
7,380,380,52,52,0,1,0
8,387,387,100,64,36,4,3
5,397,397,18,6,12,3,2
19,413,413,55,55,0,1,0
23,415,415,159,159,0,1,0
4,417,417,26,26,0,1,0
6,431,431,24,24,0,1,0
14,447,447,2,2,0,1,0
17,459,459,3,3,0,1,0
21,485,485,21,21,0,1,0

1,104,104,1,1,0,1,0
3,108,108,9,9,0,1,0
21,115,115,4,1,3,2,1
26,135,135,20,4,16,3,2
19,137,137,8,8,0,1,0
35,146,146,3,3,0,1,0
25,156,156,8,5,3,2,1
37,166,166,25,25,0,1,0
42,177,177,1,1,0,1,0
32,179,179,22,22,0,1,0
39,189,189,24,24,0,1,0
20,201,201,10,10,0,1,0
43,205,205,3,3,0,1,0
15,210,210,19,19,0,1,0
27,212,212,15,15,0,1,0
4,221,221,2,2,0,1,0
16,240,240,2,2,0,1,0
31,246,246,27,5,22,3,2
0,249,249,12,1,11,2,1
24,260,260,3,3,0,1,0
9,285,285,31,31,0,1,0
17,345,345,42,42,0,1,0
5,362,362,13,3,10,3,2
33,363,363,120,81,39,4,3
22,364,364,15,15,0,1,0
23,368,368,50,50,0,1,0
18,374,374,22,6,16,2,1
36,386,386,54,54,0,1,0
28,391,391,85,85,0,1,0
34,405,405,24,8,16,3,2
2,406,406,23,23,0,1,0
41,408,408,12,12,0,1,0
40,418,418,34,34,0,1,0
11,422,422,34,2,32,2,1
8,427,427,13,3,10,2,1
10,430,430,73,73,0,1,0
30,437,437,16,9,7,2,1
13,439,439,83,83,0,1,0
6,452,452,37,37,0,1,0
14,455,455,14,14,0,1,0
12,466,466,86,86,0,1,0
29,471,471,35,35,0,1,0
7,488,488,12,1,11,2,1
38,499,499,46,34,12,3,2

13,112,112,2,2,0,1,0
16,127,127,25,25,0,1,0
2,142,142,12,3,9,4,3
22,143,143,37,37,0,1,0
28,179,179,3,3,0,1,0
6,193,193,32,1,31,2,1
25,202,202,31,31,0,1,0
15,208,208,6,6,0,1,0
30,209,209,20,16,4,2,1
17,213,213,14,14,0,1,0
32,215,215,21,10,11,2,1
14,223,223,20,12,8,2,1
26,225,225,27,6,21,3,2
5,235,235,37,37,0,1,0
1,239,239,32,26,6,2,1
3,240,240,43,30,13,2,1
21,242,242,5,5,0,1,0
7,264,264,38,5,33,4,3
33,275,275,71,71,0,1,0
34,279,279,54,54,0,1,0
8,288,288,29,29,0,1,0
27,305,305,12,12,0,1,0
18,321,321,10,10,0,1,0
29,322,322,1,1,0,1,0
31,359,359,1,1,0,1,0
9,368,368,8,5,3,2,1
19,370,370,22,22,0,1,0
10,412,412,8,1,7,2,1
11,420,420,2,2,0,1,0
0,421,421,78,78,0,1,0
24,424,424,28,28,0,1,0
23,428,428,25,3,22,4,3
12,452,452,9,9,0,1,0
20,460,460,141,67,74,3,2
4,473,473,119,119,0,1,0

34,108,108,2,2,0,1,0
4,110,110,2,2,0,1,0
13,119,119,7,2,5,2,1
5,119,119,12,4,8,2,1
23,121,121,7,1,6,3,2
20,133,133,2,2,0,1,0
26,150,150,4,4,0,1,0
24,195,195,23,23,0,1,0
32,200,200,16,2,14,2,1
12,201,201,3,3,0,1,0
2,224,224,44,44,0,1,0
7,226,226,7,7,0,1,0
22,227,227,4,4,0,1,0
1,266,266,28,7,21,2,1
21,267,267,91,91,0,1,0
10,280,280,9,9,0,1,0
8,283,283,38,23,15,4,3
11,286,286,4,4,0,1,0
28,299,299,54,54,0,1,0
16,319,319,25,5,20,2,1
6,330,330,92,92,0,1,0
18,331,331,90,90,0,1,0
0,341,341,20,11,9,4,3
30,347,347,31,31,0,1,0
9,351,351,10,10,0,1,0
25,353,353,13,13,0,1,0
14,361,361,35,20,15,4,3
27,361,361,6,2,4,2,1
17,364,364,4,4,0,1,0
33,394,394,36,36,0,1,0
29,414,414,57,57,0,1,0
19,423,423,78,69,9,2,1
3,471,471,247,213,34,3,2
15,475,475,14,1,13,3,2
31,491,491,71,40,31,2,1

24,100,100,30,30,0,1,0
31,102,102,4,4,0,1,0
28,106,106,2,2,0,1,0
5,113,113,3,3,0,1,0
37,121,121,20,3,17,4,3
11,137,137,21,3,18,4,3
10,146,146,50,17,33,4,3
7,149,149,1,1,0,1,0
35,154,154,22,12,10,2,1
6,247,247,6,6,0,1,0
33,253,253,29,13,16,3,2
21,264,264,44,44,0,1,0
1,280,280,15,7,8,2,1
18,282,282,1,1,0,1,0
30,282,282,32,32,0,1,0
20,286,286,72,72,0,1,0
9,289,289,13,13,0,1,0
25,293,293,11,6,5,2,1
8,324,324,51,11,40,4,3
38,331,331,103,19,84,4,3
19,341,341,20,20,0,1,0
17,345,345,37,1,36,3,2
13,347,347,43,8,35,4,3
14,349,349,1,1,0,1,0
34,350,350,33,14,19,2,1
15,352,352,7,7,0,1,0
36,359,359,40,40,0,1,0
12,376,376,22,7,15,2,1
26,377,377,14,4,10,3,2
4,386,386,72,72,0,1,0
23,394,394,15,5,10,3,2
2,398,398,24,14,10,2,1
3,399,399,6,6,0,1,0
27,418,418,24,24,0,1,0
29,424,424,2,2,0,1,0
16,425,425,4,4,0,1,0
32,435,435,29,15,14,2,1
22,445,445,6,6,0,1,0
0,499,499,48,5,43,2,1

29,106,106,5,5,0,1,0
31,117,117,6,6,0,1,0
2,120,120,18,18,0,1,0
14,123,123,24,3,21,4,3
17,131,131,2,2,0,1,0
11,135,135,1,1,0,1,0
0,142,142,2,2,0,1,0
19,145,145,12,6,6,2,1
10,146,146,7,7,0,1,0
4,151,151,1,1,0,1,0
18,164,164,11,11,0,1,0
15,165,165,24,24,0,1,0
35,171,171,11,11,0,1,0
30,188,188,120,28,92,3,2
25,211,211,14,14,0,1,0
23,234,234,26,2,24,3,2
8,246,246,8,8,0,1,0
22,271,271,4,4,0,1,0
34,273,273,40,40,0,1,0
5,278,278,49,49,0,1,0
27,302,302,39,39,0,1,0
9,346,346,25,20,5,2,1
6,349,349,31,31,0,1,0
1,360,360,29,11,18,3,2
13,363,363,2,2,0,1,0
3,365,365,175,94,81,4,3
21,367,367,14,14,0,1,0
7,378,378,51,51,0,1,0
24,381,381,21,1,20,2,1
20,386,386,15,8,7,2,1
36,417,417,57,22,35,2,1
12,438,438,27,11,16,2,1
28,448,448,45,3,42,3,2
33,450,450,16,11,5,2,1
26,470,470,6,3,3,2,1
32,482,482,36,36,0,1,0
16,485,485,11,11,0,1,0

17,106,106,17,17,0,1,0
33,112,112,8,8,0,1,0
32,116,116,3,3,0,1,0
39,124,124,19,8,11,2,1
37,136,136,1,1,0,1,0
24,157,157,57,57,0,1,0
30,161,161,1,1,0,1,0
14,169,169,16,4,12,2,1
25,169,169,17,1,16,2,1
21,180,180,18,13,5,2,1
29,186,186,54,10,44,3,2
4,190,190,10,4,6,2,1
22,221,221,29,2,27,2,1
34,233,233,25,25,0,1,0
10,233,233,2,2,0,1,0
27,236,236,12,2,10,3,2
5,241,241,45,45,0,1,0
3,256,256,29,29,0,1,0
20,271,271,31,10,21,4,3
36,275,275,44,44,0,1,0
13,276,276,14,1,13,2,1
1,293,293,12,9,3,2,1
7,293,293,44,35,9,4,3
18,295,295,1,1,0,1,0
38,302,302,62,8,54,3,2
0,310,310,11,11,0,1,0
19,311,311,4,1,3,2,1
15,317,317,71,21,50,3,2
26,320,320,26,26,0,1,0
12,345,345,9,1,8,3,2
28,354,354,8,8,0,1,0
6,371,371,1,1,0,1,0
8,371,371,29,29,0,1,0
31,371,371,11,11,0,1,0
2,398,398,24,8,16,3,2
11,398,398,13,13,0,1,0
16,400,400,8,8,0,1,0
9,403,403,42,42,0,1,0
40,408,408,27,27,0,1,0
35,423,423,22,8,14,2,1
23,437,437,22,22,0,1,0

12,108,108,1,1,0,1,0
15,113,113,20,20,0,1,0
29,124,124,3,3,0,1,0
3,135,135,1,1,0,1,0
31,138,138,17,17,0,1,0
32,140,140,2,2,0,1,0
2,147,147,19,10,9,4,3
10,154,154,32,17,15,2,1
19,158,158,1,1,0,1,0
26,162,162,32,2,30,4,3
35,163,163,8,8,0,1,0
40,172,172,5,5,0,1,0
16,173,173,3,3,0,1,0
28,175,175,13,13,0,1,0
22,181,181,21,21,0,1,0
33,190,190,5,5,0,1,0
18,192,192,27,27,0,1,0
39,228,228,7,1,6,2,1
20,228,228,26,26,0,1,0
23,235,235,9,9,0,1,0
17,244,244,1,1,0,1,0
1,246,246,51,45,6,3,2
37,247,247,73,58,15,2,1
36,247,247,8,2,6,3,2
25,266,266,31,31,0,1,0
13,273,273,3,3,0,1,0
27,273,273,42,4,38,2,1
24,275,275,90,32,58,4,3
38,286,286,17,17,0,1,0
4,299,299,6,6,0,1,0
21,304,304,22,8,14,3,2
0,309,309,28,21,7,2,1
6,314,314,9,9,0,1,0
11,345,345,16,9,7,2,1
8,358,358,52,2,50,2,1
5,398,398,11,11,0,1,0
9,400,400,32,15,17,2,1
7,439,439,1,1,0,1,0
30,448,448,68,62,6,2,1
34,470,470,47,47,0,1,0
14,488,488,68,68,0,1,0

8,123,123,1,1,0,1,0
7,147,147,15,6,9,4,3
3,165,165,36,1,35,2,1
21,175,175,7,7,0,1,0
20,175,175,28,4,24,3,2
30,183,183,1,1,0,1,0
29,194,194,1,1,0,1,0
1,200,200,3,3,0,1,0
34,222,222,12,12,0,1,0
31,228,228,134,134,0,1,0
9,238,238,9,9,0,1,0
37,238,238,18,3,15,3,2
28,263,263,13,13,0,1,0
24,264,264,5,5,0,1,0
12,264,264,5,5,0,1,0
4,282,282,18,18,0,1,0
22,287,287,9,3,6,3,2
11,313,313,23,23,0,1,0
2,317,317,8,1,7,2,1
5,318,318,36,9,27,4,3
15,320,320,59,59,0,1,0
33,334,334,84,84,0,1,0
10,339,339,6,6,0,1,0
13,352,352,62,43,19,3,2
27,361,361,78,78,0,1,0
19,383,383,31,6,25,2,1
23,385,385,54,23,31,2,1
26,407,407,23,23,0,1,0
6,414,414,52,34,18,2,1
35,429,429,25,1,24,3,2
18,437,437,21,12,9,2,1
0,439,439,37,5,32,2,1
25,451,451,10,10,0,1,0
32,452,452,21,6,15,2,1
14,462,462,37,37,0,1,0
36,462,462,8,2,6,2,1
17,498,498,129,129,0,1,0
16,498,498,34,21,13,2,1

16,135,135,44,17,27,4,3
28,149,149,12,9,3,2,1
11,151,151,14,6,8,2,1
13,151,151,12,12,0,1,0
9,155,155,6,6,0,1,0
8,184,184,21,21,0,1,0
1,188,188,14,14,0,1,0
29,191,191,41,41,0,1,0
26,207,207,20,20,0,1,0
21,217,217,22,14,8,3,2
37,244,244,12,3,9,4,3
38,246,246,34,25,9,2,1
30,254,254,1,1,0,1,0
22,274,274,1,1,0,1,0
35,281,281,16,16,0,1,0
18,301,301,3,3,0,1,0
12,308,308,18,3,15,4,3
3,311,311,2,2,0,1,0
6,334,334,10,5,5,2,1
25,338,338,34,34,0,1,0
0,338,338,3,3,0,1,0
27,340,340,5,5,0,1,0
32,357,357,2,2,0,1,0
36,358,358,127,77,50,3,2
10,361,361,3,3,0,1,0
17,369,369,31,31,0,1,0
15,381,381,24,6,18,2,1
31,385,385,85,85,0,1,0
20,386,386,9,1,8,2,1
24,398,398,19,14,5,2,1
5,436,436,89,68,21,4,3
4,451,451,81,5,76,4,3
23,454,454,1,1,0,1,0
19,456,456,22,5,17,4,3
33,459,459,64,31,33,2,1
14,461,461,63,1,62,4,3
2,481,481,64,16,48,3,2
34,483,483,94,12,82,3,2
7,496,496,41,5,36,3,2

32,101,101,23,15,8,2,1
29,102,102,24,9,15,2,1
2,105,105,15,15,0,1,0
1,114,114,12,8,4,2,1
31,134,134,16,7,9,2,1
17,139,139,3,3,0,1,0
20,152,152,26,1,25,2,1
22,158,158,7,1,6,2,1
10,183,183,1,1,0,1,0
16,194,194,16,16,0,1,0
21,210,210,9,9,0,1,0
9,228,228,1,1,0,1,0
5,251,251,5,2,3,2,1
13,269,269,27,11,16,2,1
18,271,271,54,38,16,2,1
14,278,278,5,5,0,1,0
23,307,307,15,15,0,1,0
24,317,317,17,17,0,1,0
30,347,347,14,14,0,1,0
6,390,390,49,49,0,1,0
28,390,390,12,12,0,1,0
26,394,394,42,42,0,1,0
7,397,397,18,11,7,2,1
8,403,403,121,74,47,2,1
25,404,404,33,33,0,1,0
12,408,408,223,193,30,4,3
3,414,414,32,1,31,2,1
11,417,417,1,1,0,1,0
27,426,426,101,49,52,3,2
33,434,434,4,4,0,1,0
4,474,474,13,8,5,2,1
19,476,476,37,37,0,1,0
0,476,476,68,3,65,4,3
15,484,484,66,33,33,4,3

21,109,109,1,1,0,1,0
36,113,113,28,28,0,1,0
31,124,124,9,3,6,2,1
9,131,131,17,8,9,2,1
20,133,133,10,10,0,1,0
5,134,134,24,6,18,2,1
23,148,148,7,7,0,1,0
6,170,170,1,1,0,1,0
3,192,192,20,11,9,2,1
11,207,207,32,32,0,1,0
14,214,214,16,16,0,1,0
22,224,224,30,26,4,2,1
30,238,238,30,30,0,1,0
26,246,246,14,4,10,3,2
8,252,252,23,19,4,2,1
0,262,262,30,30,0,1,0
17,262,262,2,2,0,1,0
35,273,273,14,7,7,2,1
27,278,278,31,13,18,3,2
2,285,285,77,50,27,4,3
1,285,285,3,3,0,1,0
18,309,309,19,9,10,3,2
15,318,318,13,3,10,2,1
19,326,326,39,9,30,3,2
13,331,331,26,26,0,1,0
7,350,350,10,2,8,3,2
12,375,375,1,1,0,1,0
34,401,401,26,1,25,3,2
24,420,420,20,9,11,2,1
25,432,432,112,88,24,4,3
10,436,436,110,98,12,4,3
33,440,440,41,41,0,1,0
16,461,461,62,62,0,1,0
4,483,483,29,11,18,2,1
28,487,487,4,4,0,1,0
29,489,489,104,104,0,1,0
32,498,498,53,23,30,3,2

16,106,106,3,3,0,1,0
3,118,118,1,1,0,1,0
22,137,137,25,1,24,3,2
37,153,153,1,1,0,1,0
28,172,172,4,4,0,1,0
26,190,190,56,56,0,1,0
33,194,194,17,2,15,4,3
10,209,209,36,9,27,2,1
14,210,210,86,86,0,1,0
6,220,220,48,15,33,2,1
27,221,221,4,4,0,1,0
25,222,222,82,2,80,3,2
23,243,243,4,4,0,1,0
35,252,252,1,1,0,1,0
19,268,268,21,1,20,2,1
18,277,277,45,45,0,1,0
36,287,287,55,55,0,1,0
29,311,311,29,29,0,1,0
30,314,314,7,3,4,2,1
17,367,367,50,50,0,1,0
1,374,374,15,15,0,1,0
21,376,376,40,40,0,1,0
31,378,378,39,3,36,4,3
11,380,380,3,3,0,1,0
4,382,382,29,29,0,1,0
2,385,385,19,19,0,1,0
34,396,396,82,82,0,1,0
15,406,406,12,12,0,1,0
32,415,415,2,2,0,1,0
12,427,427,22,5,17,2,1
8,434,434,21,21,0,1,0
9,439,439,1,1,0,1,0
0,443,443,22,22,0,1,0
24,453,453,24,2,22,4,3
20,461,461,27,15,12,4,3
5,482,482,45,18,27,4,3
7,487,487,1,1,0,1,0
13,494,494,69,69,0,1,0

0,150,150,8,8,0,1,0
28,159,159,6,6,0,1,0
10,169,169,9,9,0,1,0
27,171,171,5,2,3,2,1
30,202,202,11,11,0,1,0
13,204,204,6,6,0,1,0
2,235,235,34,16,18,4,3
12,259,259,1,1,0,1,0
9,268,268,16,2,14,3,2
22,274,274,4,1,3,2,1
33,309,309,47,7,40,3,2
25,312,312,7,1,6,3,2
32,316,316,83,20,63,4,3
8,321,321,17,17,0,1,0
6,342,342,2,2,0,1,0
18,344,344,10,1,9,2,1
16,344,344,33,6,27,2,1
1,347,347,2,2,0,1,0
21,385,385,23,5,18,3,2
35,386,386,91,7,84,3,2
5,388,388,17,17,0,1,0
24,391,391,6,3,3,2,1
4,398,398,110,90,20,2,1
14,400,400,136,76,60,3,2
23,419,419,22,22,0,1,0
34,421,421,33,33,0,1,0
26,422,422,26,11,15,2,1
29,442,442,241,206,35,3,2
7,448,448,115,85,30,4,3
31,459,459,12,12,0,1,0
19,470,470,36,36,0,1,0
17,476,476,15,15,0,1,0
3,484,484,55,19,36,3,2
11,485,485,6,6,0,1,0
20,487,487,37,2,35,2,1
15,493,493,109,85,24,3,2

8,102,102,8,8,0,1,0
16,109,109,9,4,5,2,1
9,152,152,17,17,0,1,0
2,158,158,3,3,0,1,0
19,162,162,3,3,0,1,0
23,168,168,7,7,0,1,0
7,172,172,8,8,0,1,0
28,179,179,23,23,0,1,0
4,187,187,54,20,34,2,1
18,194,194,4,4,0,1,0
21,206,206,16,2,14,3,2
14,217,217,27,17,10,2,1
25,222,222,2,2,0,1,0
3,226,226,12,3,9,4,3
24,229,229,19,19,0,1,0
0,244,244,42,30,12,4,3
37,253,253,97,97,0,1,0
38,257,257,2,2,0,1,0
35,265,265,4,4,0,1,0
36,266,266,26,26,0,1,0
6,270,270,6,1,5,2,1
34,281,281,45,45,0,1,0
26,285,285,95,5,90,4,3
1,304,304,6,6,0,1,0
32,307,307,31,31,0,1,0
12,320,320,11,8,3,2,1
31,342,342,1,1,0,1,0
10,349,349,47,26,21,3,2
5,377,377,100,23,77,4,3
15,378,378,7,7,0,1,0
20,400,400,25,25,0,1,0
22,405,405,16,16,0,1,0
29,408,408,8,1,7,2,1
33,413,413,12,12,0,1,0
30,438,438,90,90,0,1,0
27,440,440,41,7,34,2,1
13,452,452,27,8,19,4,3
11,490,490,82,82,0,1,0
17,493,493,1,1,0,1,0

11,102,102,10,3,7,2,1
33,109,109,19,7,12,4,3
3,114,114,7,7,0,1,0
2,135,135,1,1,0,1,0
30,140,140,1,1,0,1,0
22,142,142,5,5,0,1,0
24,167,167,19,3,16,3,2
29,184,184,8,8,0,1,0
26,210,210,45,39,6,2,1
12,213,213,34,34,0,1,0
20,215,215,46,22,24,4,3
35,217,217,10,2,8,3,2
31,254,254,53,53,0,1,0
14,277,277,59,59,0,1,0
34,295,295,5,5,0,1,0
9,306,306,28,23,5,2,1
4,312,312,9,9,0,1,0
5,370,370,14,14,0,1,0
32,374,374,73,61,12,4,3
19,376,376,31,31,0,1,0
18,385,385,5,2,3,2,1
28,395,395,1,1,0,1,0
6,396,396,8,4,4,2,1
1,400,400,16,16,0,1,0
23,403,403,32,32,0,1,0
17,404,404,96,62,34,3,2
7,405,405,117,5,112,4,3
8,421,421,56,56,0,1,0
10,429,429,19,19,0,1,0
27,441,441,12,12,0,1,0
25,455,455,134,134,0,1,0
15,461,461,63,16,47,2,1
16,470,470,53,7,46,3,2
13,472,472,42,42,0,1,0
0,487,487,1,1,0,1,0
21,499,499,33,33,0,1,0

28,113,113,3,3,0,1,0
23,128,128,9,9,0,1,0
22,128,128,3,3,0,1,0
15,131,131,11,11,0,1,0
11,146,146,15,1,14,3,2
9,175,175,35,35,0,1,0
2,188,188,41,11,30,4,3
1,213,213,6,6,0,1,0
0,221,221,57,57,0,1,0
17,222,222,54,54,0,1,0
20,225,225,64,64,0,1,0
29,284,284,21,3,18,3,2
14,285,285,94,62,32,2,1
27,293,293,12,1,11,4,3
8,294,294,1,1,0,1,0
24,298,298,11,11,0,1,0
4,305,305,70,14,56,4,3
3,306,306,32,6,26,2,1
18,308,308,26,26,0,1,0
12,312,312,22,22,0,1,0
6,337,337,60,45,15,4,3
21,341,341,16,6,10,2,1
5,350,350,8,4,4,2,1
7,357,357,22,22,0,1,0
13,380,380,28,28,0,1,0
16,386,386,3,3,0,1,0
19,403,403,71,30,41,3,2
26,421,421,9,3,6,2,1
10,426,426,169,128,41,2,1
25,499,499,66,66,0,1,0

5,105,105,12,2,10,3,2
35,110,110,26,5,21,4,3
28,136,136,1,1,0,1,0
27,139,139,6,6,0,1,0
23,142,142,15,15,0,1,0
29,153,153,5,1,4,2,1
22,177,177,5,5,0,1,0
26,186,186,1,1,0,1,0
33,193,193,2,2,0,1,0
4,209,209,2,2,0,1,0
12,217,217,59,18,41,2,1
7,229,229,10,10,0,1,0
25,231,231,12,12,0,1,0
24,235,235,51,51,0,1,0
32,237,237,27,27,0,1,0
31,241,241,39,17,22,2,1
0,260,260,57,57,0,1,0
18,267,267,1,1,0,1,0
11,270,270,21,21,0,1,0
8,270,270,49,10,39,2,1
36,309,309,35,35,0,1,0
19,323,323,68,16,52,4,3
6,323,323,7,2,5,2,1
3,329,329,64,64,0,1,0
16,350,350,2,2,0,1,0
15,354,354,8,2,6,2,1
14,370,370,3,3,0,1,0
30,391,391,7,7,0,1,0
21,395,395,25,25,0,1,0
2,398,398,16,16,0,1,0
10,411,411,2,2,0,1,0
9,419,419,63,63,0,1,0
1,423,423,65,65,0,1,0
17,457,457,111,81,30,2,1
20,460,460,164,73,91,3,2
13,463,463,16,16,0,1,0
34,465,465,31,8,23,2,1

8,112,112,12,3,9,4,3
18,120,120,32,32,0,1,0
1,131,131,18,18,0,1,0
10,139,139,9,6,3,2,1
11,155,155,16,3,13,2,1
24,164,164,23,23,0,1,0
29,173,173,10,10,0,1,0
31,176,176,14,6,8,3,2
9,177,177,25,13,12,2,1
13,187,187,1,1,0,1,0
5,198,198,6,6,0,1,0
4,204,204,30,30,0,1,0
35,209,209,3,3,0,1,0
32,218,218,3,3,0,1,0
20,223,223,18,18,0,1,0
3,235,235,30,30,0,1,0
23,267,267,53,53,0,1,0
34,281,281,11,3,8,3,2
26,281,281,11,11,0,1,0
22,296,296,78,78,0,1,0
36,298,298,25,25,0,1,0
25,333,333,34,23,11,2,1
7,339,339,10,1,9,4,3
37,341,341,11,11,0,1,0
21,345,345,82,12,70,4,3
6,370,370,62,62,0,1,0
17,387,387,44,44,0,1,0
30,405,405,63,63,0,1,0
19,428,428,7,4,3,2,1
28,431,431,20,12,8,2,1
16,443,443,10,1,9,4,3
33,444,444,105,71,34,3,2
0,456,456,65,53,12,4,3
12,461,461,6,1,5,2,1
27,463,463,7,7,0,1,0
15,474,474,29,14,15,2,1
2,477,477,30,26,4,2,1
14,483,483,20,16,4,2,1

35,110,110,5,5,0,1,0
7,117,117,7,7,0,1,0
9,144,144,15,15,0,1,0
16,144,144,22,12,10,3,2
31,193,193,2,2,0,1,0
4,201,201,11,4,7,2,1
21,203,203,54,41,13,2,1
8,207,207,16,7,9,2,1
17,215,215,20,1,19,2,1
34,220,220,12,12,0,1,0
0,226,226,42,21,21,2,1
5,228,228,71,56,15,2,1
29,253,253,2,2,0,1,0
2,259,259,17,1,16,3,2
14,279,279,22,22,0,1,0
15,282,282,8,8,0,1,0
18,284,284,9,2,7,2,1
1,293,293,80,56,24,4,3
13,297,297,5,5,0,1,0
26,301,301,86,38,48,4,3
22,310,310,4,4,0,1,0
23,322,322,79,66,13,2,1
12,323,323,15,7,8,2,1
10,327,327,4,4,0,1,0
6,328,328,40,40,0,1,0
30,333,333,98,77,21,4,3
27,340,340,18,12,6,2,1
11,345,345,34,1,33,2,1
28,385,385,69,63,6,2,1
25,408,408,21,21,0,1,0
33,416,416,41,31,10,2,1
32,421,421,47,47,0,1,0
3,438,438,10,10,0,1,0
20,440,440,22,22,0,1,0
24,449,449,10,10,0,1,0
19,496,496,10,10,0,1,0

23,122,122,7,2,5,2,1
7,132,132,18,4,14,2,1
18,143,143,52,2,50,3,2
20,145,145,21,21,0,1,0
30,149,149,6,6,0,1,0
1,153,153,20,20,0,1,0
15,154,154,27,27,0,1,0
6,177,177,11,11,0,1,0
12,206,206,66,66,0,1,0
16,209,209,25,25,0,1,0
4,236,236,5,5,0,1,0
19,238,238,11,11,0,1,0
22,266,266,1,1,0,1,0
14,266,266,39,21,18,3,2
25,301,301,14,14,0,1,0
13,318,318,55,55,0,1,0
17,324,324,15,1,14,2,1
24,328,328,7,7,0,1,0
26,350,350,2,2,0,1,0
8,352,352,7,7,0,1,0
10,370,370,94,23,71,4,3
29,378,378,7,1,6,2,1
21,399,399,104,88,16,2,1
28,402,402,41,41,0,1,0
27,409,409,32,32,0,1,0
5,410,410,43,43,0,1,0
3,412,412,67,33,34,3,2
11,443,443,37,37,0,1,0
2,472,472,66,66,0,1,0
9,479,479,13,13,0,1,0
0,486,486,166,44,122,4,3

41,108,108,2,2,0,1,0
13,137,137,16,16,0,1,0
27,166,166,22,22,0,1,0
15,170,170,12,12,0,1,0
25,175,175,20,20,0,1,0
20,198,198,1,1,0,1,0
24,201,201,1,1,0,1,0
8,205,205,6,6,0,1,0
33,208,208,10,1,9,3,2
39,221,221,6,3,3,2,1
42,224,224,12,12,0,1,0
34,227,227,21,2,19,2,1
4,229,229,6,2,4,2,1
35,239,239,5,5,0,1,0
32,239,239,16,11,5,2,1
1,248,248,13,4,9,2,1
5,254,254,14,5,9,4,3
17,254,254,1,1,0,1,0
9,270,270,14,14,0,1,0
38,283,283,88,58,30,4,3
0,294,294,13,13,0,1,0
19,295,295,1,1,0,1,0
22,300,300,107,2,105,4,3
30,309,309,8,8,0,1,0
10,313,313,22,18,4,2,1
2,318,318,27,27,0,1,0
23,319,319,30,16,14,3,2
37,320,320,7,7,0,1,0
28,343,343,47,3,44,3,2
14,350,350,44,5,39,4,3
29,356,356,80,30,50,4,3
12,365,365,9,2,7,2,1
40,396,396,33,33,0,1,0
18,411,411,37,37,0,1,0
36,411,411,165,160,5,2,1
31,442,442,8,8,0,1,0
16,464,464,24,9,15,2,1
11,469,469,41,41,0,1,0
6,470,470,59,20,39,4,3
26,479,479,11,2,9,4,3
43,482,482,61,61,0,1,0
3,492,492,8,5,3,2,1
21,500,500,47,47,0,1,0
7,500,500,3,3,0,1,0

18,100,100,1,1,0,1,0
32,100,100,5,5,0,1,0
36,114,114,3,3,0,1,0
6,132,132,1,1,0,1,0
33,133,133,37,14,23,2,1
5,142,142,5,5,0,1,0
21,157,157,13,13,0,1,0
4,157,157,12,12,0,1,0
34,178,178,30,6,24,4,3
1,185,185,19,19,0,1,0
31,185,185,1,1,0,1,0
28,191,191,53,53,0,1,0
25,194,194,28,7,21,4,3
38,245,245,2,2,0,1,0
30,251,251,65,15,50,3,2
23,262,262,3,3,0,1,0
37,266,266,29,2,27,2,1
9,277,277,5,5,0,1,0
26,285,285,21,21,0,1,0
14,294,294,24,20,4,2,1
22,295,295,11,1,10,2,1
10,314,314,54,6,48,2,1
15,318,318,13,13,0,1,0
8,336,336,14,14,0,1,0
12,338,338,64,64,0,1,0
2,342,342,32,7,25,2,1
16,352,352,14,4,10,3,2
7,387,387,49,25,24,4,3
3,397,397,15,15,0,1,0
27,402,402,7,7,0,1,0
0,403,403,8,8,0,1,0
17,417,417,157,95,62,3,2
35,436,436,70,70,0,1,0
39,442,442,17,5,12,4,3
11,444,444,4,4,0,1,0
19,470,470,6,6,0,1,0
24,484,484,9,5,4,2,1
20,491,491,51,25,26,4,3
13,498,498,61,19,42,3,2
29,500,500,78,44,34,3,2

20,108,108,13,13,0,1,0
13,132,132,5,1,4,2,1
12,140,140,6,1,5,2,1
19,145,145,5,5,0,1,0
7,169,169,34,4,30,4,3
22,171,171,12,12,0,1,0
25,183,183,6,6,0,1,0
28,208,208,34,14,20,2,1
16,219,219,6,1,5,2,1
21,221,221,19,1,18,2,1
8,242,242,18,5,13,4,3
33,252,252,10,10,0,1,0
14,267,267,21,21,0,1,0
27,316,316,21,21,0,1,0
0,324,324,13,13,0,1,0
15,329,329,40,29,11,2,1
3,331,331,44,44,0,1,0
18,335,335,31,31,0,1,0
6,342,342,80,10,70,3,2
9,358,358,7,3,4,2,1
24,363,363,52,52,0,1,0
4,369,369,51,51,0,1,0
23,382,382,90,48,42,2,1
29,390,390,20,2,18,4,3
5,409,409,148,148,0,1,0
32,418,418,105,13,92,3,2
26,437,437,16,12,4,2,1
17,446,446,43,43,0,1,0
30,448,448,16,16,0,1,0
1,472,472,8,2,6,2,1
34,475,475,62,2,60,4,3
11,477,477,4,4,0,1,0
10,477,477,36,32,4,2,1
2,483,483,93,22,71,3,2
31,493,493,71,23,48,4,3

30,121,121,24,24,0,1,0
2,126,126,12,6,6,2,1
10,164,164,1,1,0,1,0
8,168,168,1,1,0,1,0
18,177,177,10,10,0,1,0
26,178,178,64,41,23,2,1
27,179,179,4,4,0,1,0
0,182,182,58,58,0,1,0
6,184,184,1,1,0,1,0
28,215,215,51,21,30,4,3
17,243,243,11,1,10,4,3
3,249,249,59,41,18,2,1
9,266,266,8,8,0,1,0
14,284,284,4,4,0,1,0
32,287,287,1,1,0,1,0
25,292,292,30,2,28,3,2
4,302,302,12,12,0,1,0
11,305,305,40,40,0,1,0
21,319,319,21,21,0,1,0
23,327,327,42,42,0,1,0
31,350,350,40,37,3,2,1
12,354,354,48,48,0,1,0
7,364,364,47,9,38,3,2
16,365,365,38,16,22,2,1
13,372,372,60,60,0,1,0
15,372,372,109,48,61,4,3
33,373,373,6,6,0,1,0
24,390,390,5,5,0,1,0
20,419,419,101,53,48,4,3
19,423,423,9,9,0,1,0
1,423,423,55,38,17,3,2
22,436,436,42,42,0,1,0
5,472,472,32,7,25,3,2
29,473,473,5,5,0,1,0

21,124,124,5,5,0,1,0
30,125,125,14,2,12,3,2
25,137,137,21,21,0,1,0
35,147,147,3,3,0,1,0
16,151,151,11,11,0,1,0
22,152,152,11,1,10,3,2
23,152,152,3,3,0,1,0
24,154,154,4,4,0,1,0
12,158,158,3,3,0,1,0
5,167,167,2,2,0,1,0
6,178,178,1,1,0,1,0
11,209,209,23,5,18,3,2
34,225,225,110,110,0,1,0
4,244,244,57,14,43,4,3
32,258,258,15,15,0,1,0
37,259,259,18,18,0,1,0
8,280,280,18,18,0,1,0
28,284,284,39,21,18,2,1
2,290,290,32,32,0,1,0
14,290,290,49,1,48,4,3
0,298,298,27,27,0,1,0
33,316,316,36,36,0,1,0
9,316,316,10,3,7,3,2
15,321,321,4,4,0,1,0
13,335,335,110,8,102,4,3
3,358,358,26,10,16,2,1
20,360,360,1,1,0,1,0
18,375,375,86,68,18,2,1
26,381,381,3,3,0,1,0
7,384,384,23,23,0,1,0
10,389,389,4,4,0,1,0
1,405,405,49,9,40,4,3
36,414,414,117,6,111,4,3
19,434,434,9,9,0,1,0
38,448,448,32,32,0,1,0
29,453,453,20,20,0,1,0
31,472,472,30,14,16,3,2
17,498,498,13,13,0,1,0
27,499,499,33,9,24,2,1

40,108,108,26,6,20,4,3
9,114,114,22,22,0,1,0
35,121,121,41,31,10,2,1
39,140,140,1,1,0,1,0
11,153,153,3,3,0,1,0
34,155,155,26,20,6,2,1
14,157,157,7,7,0,1,0
1,178,178,4,4,0,1,0
28,198,198,34,34,0,1,0
2,206,206,1,1,0,1,0
17,211,211,7,4,3,2,1
41,215,215,16,16,0,1,0
8,244,244,7,7,0,1,0
16,246,246,4,4,0,1,0
37,259,259,6,3,3,2,1
5,269,269,10,2,8,3,2
32,278,278,3,3,0,1,0
22,289,289,1,1,0,1,0
24,292,292,75,75,0,1,0
25,297,297,14,14,0,1,0
20,298,298,2,2,0,1,0
6,323,323,79,47,32,3,2
31,324,324,50,6,44,3,2
36,327,327,26,26,0,1,0
7,330,330,1,1,0,1,0
30,341,341,34,34,0,1,0
27,342,342,7,1,6,3,2
29,354,354,19,19,0,1,0
3,355,355,78,78,0,1,0
23,372,372,51,39,12,4,3
33,377,377,20,20,0,1,0
4,379,379,86,2,84,4,3
10,391,391,42,15,27,2,1
38,410,410,8,5,3,2,1
12,433,433,7,4,3,2,1
26,438,438,5,1,4,2,1
15,441,441,3,3,0,1,0
13,452,452,32,32,0,1,0
0,454,454,36,11,25,2,1
19,463,463,28,28,0,1,0
18,476,476,54,26,28,3,2
21,500,500,53,49,4,2,1

27,135,135,60,60,0,1,0
9,155,155,27,1,26,2,1
3,157,157,4,4,0,1,0
1,159,159,20,16,4,2,1
2,169,169,31,31,0,1,0
8,170,170,20,20,0,1,0
21,183,183,26,10,16,2,1
19,195,195,3,3,0,1,0
6,202,202,34,34,0,1,0
15,230,230,115,100,15,4,3
18,250,250,13,7,6,3,2
11,309,309,61,61,0,1,0
7,315,315,2,2,0,1,0
28,321,321,7,1,6,3,2
12,323,323,48,15,33,2,1
4,342,342,111,51,60,4,3
5,346,346,15,15,0,1,0
24,358,358,16,1,15,2,1
22,366,366,21,13,8,3,2
17,375,375,1,1,0,1,0
26,383,383,4,4,0,1,0
16,402,402,24,24,0,1,0
30,413,413,39,9,30,2,1
29,417,417,1,1,0,1,0
14,418,418,7,2,5,2,1
25,435,435,43,14,29,2,1
20,466,466,42,3,39,4,3
23,471,471,29,29,0,1,0
13,487,487,57,57,0,1,0
0,489,489,22,4,18,2,1
10,496,496,119,107,12,2,1

22,100,100,4,4,0,1,0
19,143,143,29,8,21,4,3
9,152,152,8,8,0,1,0
13,154,154,1,1,0,1,0
5,162,162,16,16,0,1,0
24,175,175,4,4,0,1,0
14,188,188,8,8,0,1,0
28,197,197,14,14,0,1,0
16,209,209,15,2,13,2,1
31,209,209,12,12,0,1,0
1,218,218,46,46,0,1,0
12,233,233,78,66,12,4,3
32,240,240,46,46,0,1,0
36,255,255,20,11,9,2,1
7,257,257,9,1,8,3,2
6,295,295,26,14,12,4,3
27,344,344,2,2,0,1,0
18,353,353,54,16,38,3,2
3,363,363,20,2,18,2,1
2,371,371,30,1,29,2,1
10,373,373,20,9,11,2,1
4,373,373,52,16,36,3,2
35,379,379,20,1,19,2,1
21,384,384,34,34,0,1,0
15,388,388,29,29,0,1,0
20,397,397,38,38,0,1,0
0,398,398,5,2,3,2,1
34,406,406,22,10,12,4,3
29,442,442,8,3,5,2,1
11,447,447,37,37,0,1,0
26,448,448,12,12,0,1,0
8,452,452,26,2,24,3,2
30,463,463,300,222,78,3,2
17,465,465,70,8,62,3,2
23,470,470,53,34,19,2,1
33,470,470,28,12,16,3,2
25,481,481,3,3,0,1,0

0,120,120,2,2,0,1,0
16,125,125,9,4,5,2,1
19,134,134,4,1,3,2,1
33,152,152,4,4,0,1,0
27,154,154,11,11,0,1,0
32,192,192,43,43,0,1,0
3,198,198,46,1,45,2,1
6,208,208,20,20,0,1,0
4,220,220,9,9,0,1,0
22,224,224,3,3,0,1,0
21,252,252,32,16,16,2,1
34,255,255,40,40,0,1,0
20,263,263,10,10,0,1,0
9,279,279,49,49,0,1,0
13,309,309,26,26,0,1,0
28,317,317,16,4,12,4,3
30,319,319,32,17,15,4,3
2,322,322,1,1,0,1,0
18,325,325,38,31,7,2,1
15,327,327,31,31,0,1,0
17,354,354,42,28,14,2,1
5,364,364,37,4,33,3,2
1,370,370,82,82,0,1,0
24,371,371,40,40,0,1,0
10,379,379,47,5,42,2,1
7,384,384,120,60,60,4,3
11,385,385,24,7,17,2,1
8,424,424,2,2,0,1,0
12,428,428,34,12,22,3,2
29,429,429,49,28,21,4,3
26,434,434,62,21,41,4,3
14,442,442,37,4,33,4,3
23,449,449,19,1,18,2,1
25,474,474,63,63,0,1,0
31,484,484,106,6,100,3,2

4,104,104,10,4,6,2,1
16,110,110,1,1,0,1,0
19,122,122,4,4,0,1,0
3,130,130,21,13,8,2,1
0,134,134,36,36,0,1,0
14,141,141,1,1,0,1,0
1,148,148,30,30,0,1,0
13,150,150,71,21,50,2,1
20,153,153,5,2,3,2,1
5,160,160,9,9,0,1,0
8,188,188,23,23,0,1,0
32,202,202,7,2,5,2,1
33,207,207,35,35,0,1,0
30,217,217,65,43,22,4,3
21,240,240,21,7,14,2,1
22,242,242,13,13,0,1,0
7,251,251,1,1,0,1,0
18,259,259,7,1,6,3,2
17,279,279,10,10,0,1,0
6,295,295,8,1,7,2,1
29,334,334,51,51,0,1,0
9,345,345,20,20,0,1,0
12,361,361,1,1,0,1,0
23,378,378,64,64,0,1,0
25,381,381,31,7,24,3,2
15,390,390,11,2,9,2,1
28,398,398,22,1,21,4,3
27,411,411,61,28,33,2,1
34,423,423,46,46,0,1,0
10,443,443,99,38,61,4,3
26,456,456,72,72,0,1,0
24,461,461,53,39,14,3,2
11,462,462,22,13,9,4,3
31,472,472,36,3,33,2,1
2,500,500,7,7,0,1,0

4,111,111,2,2,0,1,0
8,111,111,17,17,0,1,0
28,118,118,13,13,0,1,0
9,131,131,10,4,6,3,2
21,161,161,13,5,8,2,1
22,167,167,6,6,0,1,0
10,174,174,80,80,0,1,0
24,177,177,8,4,4,2,1
36,185,185,12,12,0,1,0
12,215,215,1,1,0,1,0
11,232,232,9,1,8,2,1
13,238,238,7,4,3,2,1
26,240,240,10,10,0,1,0
27,243,243,65,9,56,4,3
34,258,258,20,20,0,1,0
2,262,262,35,35,0,1,0
33,280,280,39,31,8,3,2
32,313,313,25,18,7,2,1
25,328,328,6,6,0,1,0
6,329,329,43,34,9,2,1
3,342,342,2,2,0,1,0
31,346,346,2,2,0,1,0
7,362,362,11,11,0,1,0
23,367,367,13,8,5,2,1
30,374,374,58,38,20,2,1
5,379,379,30,2,28,3,2
35,404,404,180,42,138,4,3
16,405,405,34,5,29,2,1
20,411,411,22,22,0,1,0
17,421,421,58,58,0,1,0
19,451,451,74,28,46,3,2
1,451,451,89,24,65,4,3
0,458,458,7,7,0,1,0
18,459,459,36,36,0,1,0
14,466,466,37,13,24,3,2
29,468,468,9,2,7,2,1
15,471,471,23,9,14,3,2

29,122,122,14,6,8,2,1
6,125,125,1,1,0,1,0
23,137,137,11,11,0,1,0
25,142,142,36,12,24,4,3
15,145,145,9,9,0,1,0
22,165,165,10,10,0,1,0
17,172,172,54,22,32,3,2
24,188,188,7,1,6,3,2
11,200,200,50,50,0,1,0
18,200,200,1,1,0,1,0
13,239,239,9,9,0,1,0
28,239,239,9,9,0,1,0
27,240,240,31,11,20,2,1
16,241,241,24,2,22,3,2
1,245,245,26,26,0,1,0
14,257,257,6,6,0,1,0
5,267,267,20,11,9,2,1
20,277,277,9,3,6,3,2
31,296,296,61,22,39,2,1
8,307,307,8,8,0,1,0
2,324,324,14,14,0,1,0
0,331,331,37,37,0,1,0
12,336,336,112,102,10,3,2
7,352,352,56,22,34,3,2
26,377,377,82,47,35,2,1
10,389,389,68,6,62,4,3
21,408,408,31,4,27,4,3
19,428,428,18,2,16,2,1
30,429,429,27,13,14,2,1
3,436,436,104,57,47,4,3
9,483,483,64,64,0,1,0
4,498,498,52,34,18,4,3

22,106,106,11,1,10,3,2
20,124,124,5,2,3,2,1
27,129,129,14,4,10,3,2
19,133,133,7,7,0,1,0
7,150,150,9,9,0,1,0
30,172,172,1,1,0,1,0
21,191,191,53,5,48,4,3
9,204,204,29,2,27,2,1
8,206,206,23,13,10,2,1
5,207,207,113,15,98,3,2
10,244,244,1,1,0,1,0
15,269,269,18,18,0,1,0
28,270,270,12,12,0,1,0
31,291,291,71,59,12,3,2
17,291,291,13,3,10,3,2
6,297,297,11,2,9,4,3
0,314,314,13,13,0,1,0
29,327,327,21,9,12,3,2
1,355,355,52,11,41,3,2
16,370,370,10,10,0,1,0
2,388,388,101,77,24,2,1
23,390,390,33,33,0,1,0
24,392,392,13,4,9,3,2
3,453,453,10,10,0,1,0
14,457,457,44,44,0,1,0
25,459,459,18,3,15,4,3
13,460,460,25,25,0,1,0
4,461,461,61,12,49,2,1
18,464,464,113,62,51,4,3
26,476,476,121,77,44,2,1
12,480,480,31,21,10,2,1
11,483,483,86,47,39,4,3

26,102,102,1,1,0,1,0
21,103,103,11,11,0,1,0
11,107,107,34,7,27,2,1
15,108,108,39,30,9,2,1
28,119,119,6,6,0,1,0
2,127,127,11,11,0,1,0
24,131,131,7,7,0,1,0
18,143,143,47,47,0,1,0
5,146,146,62,62,0,1,0
6,157,157,4,4,0,1,0
20,172,172,5,5,0,1,0
25,192,192,48,48,0,1,0
1,232,232,28,22,6,3,2
10,233,233,36,36,0,1,0
12,242,242,10,10,0,1,0
17,261,261,13,4,9,2,1
4,266,266,37,37,0,1,0
13,268,268,9,3,6,2,1
19,277,277,14,14,0,1,0
29,314,314,36,12,24,4,3
27,321,321,4,4,0,1,0
8,328,328,46,24,22,3,2
3,329,329,8,8,0,1,0
22,336,336,11,11,0,1,0
16,341,341,46,11,35,2,1
0,343,343,50,50,0,1,0
14,356,356,4,1,3,2,1
7,412,412,27,2,25,2,1
30,440,440,85,13,72,4,3
9,442,442,52,52,0,1,0
23,446,446,16,16,0,1,0

19,102,102,10,10,0,1,0
24,106,106,18,18,0,1,0
14,107,107,8,8,0,1,0
4,110,110,20,10,10,2,1
21,114,114,62,62,0,1,0
10,118,118,7,7,0,1,0
3,148,148,3,3,0,1,0
6,151,151,15,15,0,1,0
7,164,164,7,7,0,1,0
28,175,175,33,33,0,1,0
11,180,180,14,14,0,1,0
31,196,196,12,1,11,2,1
1,198,198,35,8,27,4,3
27,210,210,29,29,0,1,0
30,212,212,27,7,20,3,2
16,214,214,6,6,0,1,0
29,217,217,21,3,18,3,2
22,219,219,34,18,16,2,1
20,234,234,2,2,0,1,0
12,259,259,4,4,0,1,0
26,265,265,7,7,0,1,0
0,289,289,54,15,39,2,1
9,313,313,132,113,19,2,1
2,344,344,27,27,0,1,0
17,363,363,5,5,0,1,0
23,392,392,6,6,0,1,0
15,399,399,23,23,0,1,0
13,424,424,67,50,17,3,2
8,429,429,34,9,25,2,1
18,441,441,7,7,0,1,0
5,485,485,99,99,0,1,0
25,493,493,13,13,0,1,0

29,133,133,1,1,0,1,0
30,163,163,4,4,0,1,0
1,167,167,1,1,0,1,0
31,171,171,18,18,0,1,0
9,181,181,24,24,0,1,0
34,188,188,24,24,0,1,0
19,213,213,12,8,4,2,1
18,228,228,30,2,28,3,2
24,235,235,52,28,24,3,2
22,237,237,41,41,0,1,0
10,240,240,25,25,0,1,0
14,255,255,32,32,0,1,0
23,272,272,43,43,0,1,0
0,285,285,35,1,34,2,1
8,289,289,32,32,0,1,0
16,308,308,10,10,0,1,0
32,334,334,4,4,0,1,0
12,342,342,26,6,20,3,2
13,366,366,76,42,34,4,3
28,371,371,25,8,17,2,1
2,387,387,48,30,18,3,2
7,397,397,9,9,0,1,0
6,405,405,63,63,0,1,0
33,407,407,18,18,0,1,0
4,413,413,49,1,48,2,1
25,415,415,91,49,42,3,2
20,441,441,4,4,0,1,0
17,443,443,26,26,0,1,0
15,444,444,66,42,24,4,3
21,447,447,44,4,40,3,2
3,448,448,81,38,43,2,1
26,474,474,88,83,5,2,1
11,479,479,57,57,0,1,0
27,486,486,63,31,32,2,1
5,491,491,7,7,0,1,0

21,106,106,2,2,0,1,0
11,123,123,5,2,3,2,1
28,125,125,22,22,0,1,0
34,140,140,1,1,0,1,0
5,140,140,12,12,0,1,0
19,146,146,17,17,0,1,0
8,172,172,5,5,0,1,0
26,176,176,9,3,6,3,2
38,176,176,5,5,0,1,0
14,190,190,1,1,0,1,0
23,196,196,58,18,40,2,1
3,211,211,35,35,0,1,0
1,222,222,12,4,8,2,1
32,228,228,8,8,0,1,0
36,263,263,27,27,0,1,0
25,275,275,16,3,13,2,1
39,281,281,16,16,0,1,0
35,285,285,13,13,0,1,0
20,287,287,17,6,11,3,2
2,300,300,17,17,0,1,0
4,301,301,3,3,0,1,0
7,301,301,15,3,12,2,1
33,304,304,63,63,0,1,0
0,331,331,2,2,0,1,0
6,346,346,26,23,3,2,1
31,360,360,28,28,0,1,0
22,374,374,29,29,0,1,0
16,398,398,54,22,32,2,1
13,405,405,23,23,0,1,0
30,411,411,12,7,5,2,1
29,433,433,4,4,0,1,0
9,436,436,77,77,0,1,0
12,446,446,40,40,0,1,0
10,449,449,37,5,32,4,3
40,452,452,109,102,7,2,1
18,463,463,125,82,43,3,2
24,472,472,157,93,64,3,2
15,482,482,61,4,57,4,3
37,483,483,5,5,0,1,0
27,499,499,34,34,0,1,0
17,499,499,6,2,4,2,1

24,107,107,6,6,0,1,0
10,123,123,11,11,0,1,0
26,126,126,9,9,0,1,0
9,148,148,13,4,9,2,1
7,149,149,2,2,0,1,0
37,152,152,9,1,8,3,2
20,163,163,5,5,0,1,0
4,193,193,16,16,0,1,0
42,194,194,23,23,0,1,0
30,206,206,15,6,9,2,1
13,207,207,9,6,3,2,1
8,213,213,11,5,6,2,1
35,218,218,25,7,18,2,1
14,224,224,20,20,0,1,0
16,236,236,2,2,0,1,0
36,252,252,15,15,0,1,0
18,269,269,22,22,0,1,0
0,270,270,4,4,0,1,0
5,276,276,4,4,0,1,0
45,277,277,5,5,0,1,0
31,289,289,48,3,45,4,3
23,298,298,24,24,0,1,0
22,331,331,3,3,0,1,0
1,333,333,28,1,27,4,3
19,336,336,25,25,0,1,0
32,366,366,19,7,12,2,1
17,368,368,29,5,24,3,2
28,373,373,21,3,18,4,3
38,378,378,101,66,35,2,1
11,398,398,45,45,0,1,0
27,425,425,19,19,0,1,0
33,430,430,3,3,0,1,0
34,442,442,6,2,4,2,1
39,443,443,40,40,0,1,0
40,448,448,64,25,39,4,3
15,453,453,6,6,0,1,0
6,455,455,10,4,6,3,2
41,455,455,76,76,0,1,0
12,455,455,124,52,72,4,3
44,457,457,31,10,21,2,1
29,459,459,151,4,147,4,3
25,469,469,26,9,17,2,1
21,483,483,35,25,10,3,2
43,495,495,16,5,11,2,1
2,497,497,22,22,0,1,0
3,499,499,50,50,0,1,0

24,100,100,9,9,0,1,0
22,119,119,5,5,0,1,0
15,122,122,3,3,0,1,0
12,126,126,5,5,0,1,0
36,135,135,9,9,0,1,0
2,177,177,40,40,0,1,0
4,192,192,3,3,0,1,0
17,194,194,5,5,0,1,0
20,211,211,42,42,0,1,0
32,215,215,3,3,0,1,0
19,222,222,24,9,15,2,1
25,239,239,15,15,0,1,0
7,277,277,37,22,15,2,1
9,290,290,10,10,0,1,0
0,303,303,8,8,0,1,0
34,324,324,35,7,28,3,2
3,331,331,20,20,0,1,0
35,341,341,41,17,24,4,3
14,347,347,5,5,0,1,0
21,353,353,5,5,0,1,0
28,386,386,162,111,51,4,3
18,419,419,23,23,0,1,0
6,424,424,38,38,0,1,0
27,424,424,39,3,36,3,2
11,426,426,39,9,30,3,2
10,429,429,8,4,4,2,1
16,436,436,44,44,0,1,0
30,440,440,38,8,30,3,2
33,446,446,20,5,15,2,1
31,450,450,102,99,3,2,1
13,450,450,90,4,86,3,2
8,461,461,73,44,29,2,1
5,467,467,6,6,0,1,0
29,469,469,18,8,10,2,1
1,470,470,223,91,132,4,3
23,493,493,10,10,0,1,0
26,495,495,39,18,21,4,3

30,123,123,26,26,0,1,0
15,124,124,11,11,0,1,0
2,124,124,17,4,13,3,2
45,126,126,21,11,10,2,1
27,133,133,19,1,18,2,1
23,136,136,17,12,5,2,1
26,147,147,34,12,22,2,1
9,175,175,1,1,0,1,0
5,181,181,6,6,0,1,0
18,181,181,4,4,0,1,0
16,182,182,33,19,14,3,2
37,185,185,10,10,0,1,0
38,189,189,30,4,26,2,1
21,196,196,8,3,5,2,1
6,199,199,1,1,0,1,0
31,203,203,7,7,0,1,0
20,206,206,38,20,18,3,2
7,211,211,6,6,0,1,0
32,233,233,8,8,0,1,0
12,263,263,47,5,42,4,3
34,266,266,12,12,0,1,0
42,269,269,3,3,0,1,0
1,270,270,4,4,0,1,0
8,276,276,1,1,0,1,0
28,287,287,21,21,0,1,0
44,292,292,25,25,0,1,0
29,292,292,20,10,10,2,1
14,297,297,12,12,0,1,0
3,298,298,1,1,0,1,0
25,301,301,1,1,0,1,0
43,309,309,65,17,48,3,2
35,318,318,126,111,15,4,3
19,322,322,6,6,0,1,0
22,335,335,17,17,0,1,0
41,341,341,3,3,0,1,0
36,347,347,44,1,43,2,1
24,354,354,2,2,0,1,0
17,362,362,11,11,0,1,0
0,364,364,4,4,0,1,0
11,364,364,10,2,8,3,2
40,379,379,43,31,12,4,3
39,407,407,24,18,6,3,2
10,441,441,27,6,21,2,1
4,448,448,1,1,0,1,0
46,457,457,25,25,0,1,0
33,471,471,2,2,0,1,0
13,488,488,25,25,0,1,0

13,100,100,12,12,0,1,0
3,100,100,4,4,0,1,0
34,110,110,3,3,0,1,0
14,110,110,9,9,0,1,0
9,125,125,1,1,0,1,0
1,129,129,22,22,0,1,0
5,153,153,1,1,0,1,0
27,154,154,4,4,0,1,0
25,171,171,11,11,0,1,0
18,172,172,5,5,0,1,0
2,173,173,36,32,4,2,1
16,174,174,9,1,8,3,2
19,205,205,45,45,0,1,0
32,211,211,19,19,0,1,0
29,225,225,49,49,0,1,0
33,243,243,9,3,6,3,2
36,252,252,9,5,4,2,1
35,271,271,43,43,0,1,0
15,278,278,5,5,0,1,0
20,281,281,42,42,0,1,0
11,282,282,76,76,0,1,0
17,285,285,27,27,0,1,0
24,299,299,32,14,18,3,2
10,300,300,27,27,0,1,0
21,301,301,7,2,5,2,1
30,309,309,68,44,24,4,3
6,315,315,6,2,4,2,1
26,321,321,2,2,0,1,0
31,333,333,85,28,57,4,3
4,335,335,83,47,36,3,2
8,350,350,20,7,13,2,1
7,367,367,37,5,32,3,2
12,372,372,7,7,0,1,0
28,380,380,20,4,16,3,2
22,406,406,49,49,0,1,0
23,455,455,10,10,0,1,0
0,469,469,80,29,51,4,3

31,110,110,1,1,0,1,0
37,113,113,6,6,0,1,0
0,129,129,8,8,0,1,0
13,133,133,42,42,0,1,0
12,134,134,1,1,0,1,0
30,136,136,3,3,0,1,0
6,137,137,4,4,0,1,0
8,145,145,2,2,0,1,0
5,146,146,9,9,0,1,0
11,149,149,3,3,0,1,0
39,156,156,3,3,0,1,0
17,158,158,6,3,3,2,1
2,171,171,1,1,0,1,0
21,178,178,1,1,0,1,0
32,188,188,38,38,0,1,0
41,192,192,31,10,21,4,3
35,205,205,41,41,0,1,0
3,207,207,8,5,3,2,1
4,214,214,1,1,0,1,0
14,214,214,33,33,0,1,0
19,240,240,20,20,0,1,0
22,258,258,83,77,6,2,1
7,269,269,4,4,0,1,0
24,274,274,29,29,0,1,0
29,285,285,30,1,29,2,1
40,302,302,30,7,23,2,1
15,313,313,117,105,12,4,3
9,317,317,9,9,0,1,0
20,327,327,39,39,0,1,0
1,334,334,9,1,8,2,1
38,337,337,12,12,0,1,0
18,350,350,16,16,0,1,0
36,356,356,20,3,17,2,1
33,359,359,2,2,0,1,0
16,382,382,2,2,0,1,0
26,390,390,7,7,0,1,0
23,407,407,8,8,0,1,0
27,416,416,5,5,0,1,0
10,421,421,2,2,0,1,0
25,432,432,76,49,27,4,3
34,480,480,174,51,123,4,3
28,500,500,103,103,0,1,0

28,105,105,7,7,0,1,0
15,117,117,1,1,0,1,0
26,137,137,22,22,0,1,0
21,168,168,7,7,0,1,0
7,169,169,8,8,0,1,0
3,178,178,70,70,0,1,0
20,201,201,10,5,5,2,1
2,210,210,3,3,0,1,0
10,224,224,19,19,0,1,0
1,228,228,30,19,11,2,1
5,247,247,7,7,0,1,0
9,250,250,112,16,96,4,3
29,263,263,33,15,18,4,3
18,275,275,14,4,10,3,2
30,286,286,57,17,40,3,2
12,292,292,4,4,0,1,0
16,292,292,34,34,0,1,0
14,294,294,3,3,0,1,0
0,303,303,14,14,0,1,0
17,313,313,30,30,0,1,0
24,317,317,118,43,75,4,3
6,319,319,29,7,22,2,1
8,322,322,22,2,20,3,2
13,353,353,106,57,49,4,3
27,357,357,66,35,31,2,1
4,380,380,19,7,12,4,3
19,389,389,3,3,0,1,0
25,440,440,11,2,9,2,1
11,468,468,39,15,24,4,3
23,468,468,29,17,12,4,3
22,470,470,89,89,0,1,0
31,485,485,32,18,14,2,1

31,103,103,25,25,0,1,0
14,121,121,15,15,0,1,0
1,153,153,5,1,4,2,1
18,167,167,10,2,8,3,2
3,171,171,3,3,0,1,0
32,172,172,5,5,0,1,0
34,243,243,5,2,3,2,1
9,245,245,1,1,0,1,0
20,245,245,41,41,0,1,0
36,250,250,6,6,0,1,0
2,254,254,13,13,0,1,0
16,255,255,38,31,7,2,1
17,263,263,74,74,0,1,0
4,288,288,1,1,0,1,0
37,296,296,46,46,0,1,0
6,302,302,15,3,12,4,3
21,312,312,11,11,0,1,0
25,313,313,128,61,67,4,3
24,319,319,8,2,6,3,2
5,346,346,18,18,0,1,0
28,359,359,23,23,0,1,0
15,381,381,28,11,17,2,1
27,387,387,8,8,0,1,0
29,391,391,12,12,0,1,0
35,395,395,17,17,0,1,0
11,400,400,34,14,20,3,2
19,410,410,40,40,0,1,0
0,412,412,82,82,0,1,0
30,415,415,49,49,0,1,0
33,416,416,78,54,24,2,1
26,435,435,56,14,42,4,3
12,436,436,66,66,0,1,0
22,444,444,3,3,0,1,0
13,470,470,18,12,6,3,2
8,475,475,37,37,0,1,0
23,477,477,57,30,27,4,3
10,489,489,76,10,66,3,2
7,492,492,48,48,0,1,0

42,143,143,1,1,0,1,0
31,146,146,10,4,6,3,2
21,149,149,27,27,0,1,0
15,151,151,5,5,0,1,0
28,156,156,23,23,0,1,0
18,178,178,30,30,0,1,0
11,181,181,2,2,0,1,0
29,189,189,7,2,5,2,1
41,193,193,7,7,0,1,0
27,196,196,14,14,0,1,0
1,209,209,13,13,0,1,0
39,211,211,3,3,0,1,0
32,213,213,20,20,0,1,0
17,217,217,14,14,0,1,0
30,217,217,36,36,0,1,0
14,218,218,1,1,0,1,0
40,222,222,1,1,0,1,0
12,237,237,2,2,0,1,0
25,240,240,79,79,0,1,0
24,249,249,24,6,18,2,1
5,253,253,13,4,9,4,3
34,254,254,29,29,0,1,0
8,259,259,28,12,16,3,2
2,260,260,2,2,0,1,0
13,263,263,19,13,6,2,1
35,285,285,66,66,0,1,0
6,299,299,71,71,0,1,0
0,309,309,5,5,0,1,0
33,314,314,41,13,28,4,3
16,318,318,2,2,0,1,0
3,321,321,1,1,0,1,0
7,329,329,7,7,0,1,0
38,336,336,46,30,16,3,2
19,346,346,42,42,0,1,0
20,373,373,11,3,8,2,1
26,387,387,53,53,0,1,0
9,407,407,25,10,15,2,1
10,434,434,39,39,0,1,0
23,464,464,79,79,0,1,0
36,472,472,52,28,24,4,3
37,489,489,1,1,0,1,0
4,491,491,63,48,15,4,3
22,494,494,23,5,18,4,3

2,116,116,9,9,0,1,0
7,118,118,6,6,0,1,0
4,138,138,28,28,0,1,0
8,145,145,5,5,0,1,0
28,154,154,15,1,14,3,2
17,165,165,1,1,0,1,0
12,170,170,113,113,0,1,0
24,217,217,17,2,15,4,3
26,247,247,13,13,0,1,0
21,248,248,72,28,44,2,1
29,256,256,105,60,45,2,1
25,264,264,10,10,0,1,0
15,292,292,13,3,10,2,1
11,314,314,32,22,10,2,1
18,325,325,27,27,0,1,0
3,326,326,107,107,0,1,0
19,327,327,10,4,6,2,1
13,336,336,68,68,0,1,0
9,338,338,16,2,14,3,2
14,354,354,13,7,6,3,2
20,360,360,94,9,85,4,3
0,360,360,1,1,0,1,0
27,376,376,10,10,0,1,0
1,385,385,13,13,0,1,0
30,434,434,28,28,0,1,0
16,438,438,13,13,0,1,0
10,441,441,55,55,0,1,0
22,455,455,25,1,24,2,1
6,470,470,61,24,37,4,3
5,476,476,2,2,0,1,0
23,493,493,14,4,10,2,1

19,113,113,10,10,0,1,0
16,128,128,3,3,0,1,0
25,143,143,1,1,0,1,0
2,211,211,18,13,5,2,1
4,222,222,19,14,5,2,1
9,225,225,8,1,7,2,1
11,243,243,1,1,0,1,0
15,252,252,7,7,0,1,0
22,255,255,42,17,25,3,2
28,268,268,34,13,21,4,3
17,273,273,34,6,28,2,1
5,313,313,6,3,3,2,1
21,314,314,5,5,0,1,0
8,317,317,47,47,0,1,0
20,340,340,113,48,65,4,3
29,351,351,32,20,12,4,3
12,359,359,7,1,6,2,1
30,372,372,2,2,0,1,0
27,376,376,23,9,14,3,2
26,384,384,85,16,69,4,3
13,389,389,163,154,9,4,3
24,394,394,33,23,10,3,2
0,396,396,104,68,36,4,3
6,405,405,55,55,0,1,0
31,423,423,43,43,0,1,0
7,435,435,191,164,27,4,3
23,440,440,53,53,0,1,0
10,469,469,10,10,0,1,0
3,472,472,9,9,0,1,0
1,481,481,51,45,6,3,2
14,482,482,83,57,26,2,1
18,498,498,33,24,9,2,1

22,152,152,1,1,0,1,0
15,155,155,15,15,0,1,0
3,182,182,30,8,22,3,2
12,206,206,44,44,0,1,0
25,215,215,45,45,0,1,0
24,220,220,8,8,0,1,0
18,221,221,2,2,0,1,0
10,227,227,54,11,43,2,1
27,256,256,11,1,10,3,2
8,262,262,39,39,0,1,0
23,288,288,3,3,0,1,0
11,301,301,40,40,0,1,0
14,312,312,27,5,22,3,2
28,331,331,61,61,0,1,0
20,343,343,26,26,0,1,0
30,377,377,205,178,27,2,1
6,384,384,71,71,0,1,0
19,399,399,29,14,15,4,3
26,404,404,39,21,18,3,2
9,417,417,37,37,0,1,0
4,422,422,84,50,34,3,2
7,423,423,91,72,19,2,1
16,428,428,27,27,0,1,0
13,430,430,8,8,0,1,0
29,439,439,34,34,0,1,0
2,441,441,11,11,0,1,0
17,442,442,61,61,0,1,0
0,458,458,22,22,0,1,0
5,472,472,3,3,0,1,0
31,475,475,33,33,0,1,0
1,495,495,58,43,15,2,1
21,499,499,8,4,4,2,1

31,102,102,6,6,0,1,0
15,114,114,11,11,0,1,0
34,115,115,8,8,0,1,0
26,122,122,49,36,13,2,1
12,150,150,17,17,0,1,0
18,169,169,34,2,32,2,1
3,173,173,5,2,3,2,1
29,185,185,5,5,0,1,0
11,200,200,7,7,0,1,0
33,200,200,52,52,0,1,0
5,219,219,9,4,5,2,1
17,226,226,10,7,3,2,1
1,226,226,7,7,0,1,0
41,231,231,18,11,7,2,1
0,259,259,73,73,0,1,0
35,271,271,24,24,0,1,0
36,277,277,60,11,49,2,1
19,286,286,20,17,3,2,1
16,310,310,47,22,25,2,1
28,311,311,2,2,0,1,0
24,321,321,1,1,0,1,0
30,325,325,82,16,66,4,3
38,357,357,7,7,0,1,0
9,380,380,1,1,0,1,0
4,382,382,1,1,0,1,0
13,390,390,20,3,17,2,1
23,400,400,18,3,15,2,1
7,400,400,15,11,4,2,1
10,408,408,6,6,0,1,0
8,417,417,17,17,0,1,0
21,423,423,2,2,0,1,0
37,430,430,35,35,0,1,0
39,432,432,1,1,0,1,0
32,449,449,5,1,4,2,1
27,457,457,18,18,0,1,0
14,457,457,18,18,0,1,0
2,465,465,2,2,0,1,0
6,467,467,107,107,0,1,0
22,480,480,65,65,0,1,0
20,483,483,48,20,28,3,2
40,490,490,12,12,0,1,0
25,491,491,94,94,0,1,0

4,124,124,26,11,15,4,3
31,154,154,17,11,6,2,1
14,158,158,11,2,9,4,3
20,163,163,5,5,0,1,0
17,188,188,42,42,0,1,0
10,190,190,31,8,23,3,2
2,191,191,40,40,0,1,0
26,192,192,26,2,24,4,3
18,205,205,3,3,0,1,0
24,207,207,44,44,0,1,0
21,210,210,5,5,0,1,0
16,211,211,7,7,0,1,0
22,223,223,5,5,0,1,0
25,256,256,44,4,40,3,2
13,271,271,9,9,0,1,0
29,289,289,14,11,3,2,1
11,303,303,50,50,0,1,0
27,341,341,40,1,39,3,2
19,355,355,21,21,0,1,0
30,367,367,10,10,0,1,0
0,397,397,44,26,18,3,2
32,403,403,38,25,13,2,1
3,408,408,44,44,0,1,0
1,413,413,6,1,5,2,1
33,414,414,141,110,31,2,1
12,417,417,26,13,13,2,1
7,434,434,17,2,15,4,3
34,435,435,5,5,0,1,0
5,446,446,64,36,28,3,2
28,453,453,28,6,22,2,1
23,456,456,96,96,0,1,0
15,458,458,13,13,0,1,0
35,471,471,33,6,27,4,3
36,474,474,38,38,0,1,0
9,480,480,24,24,0,1,0
6,485,485,32,32,0,1,0
8,486,486,28,13,15,4,3

20,101,101,1,1,0,1,0
16,147,147,31,31,0,1,0
10,149,149,29,11,18,2,1
0,149,149,8,8,0,1,0
8,150,150,1,1,0,1,0
11,150,150,28,28,0,1,0
21,163,163,33,33,0,1,0
31,169,169,44,24,20,2,1
14,182,182,17,17,0,1,0
33,202,202,19,1,18,4,3
4,233,233,19,19,0,1,0
7,239,239,40,23,17,2,1
25,241,241,24,17,7,2,1
19,253,253,37,37,0,1,0
23,269,269,11,11,0,1,0
34,273,273,26,26,0,1,0
15,297,297,22,22,0,1,0
28,310,310,14,14,0,1,0
3,350,350,19,8,11,2,1
17,357,357,57,57,0,1,0
2,358,358,8,8,0,1,0
13,372,372,5,1,4,2,1
12,375,375,75,39,36,2,1
5,395,395,38,38,0,1,0
22,400,400,26,1,25,2,1
24,408,408,14,6,8,2,1
9,427,427,62,62,0,1,0
32,428,428,5,2,3,2,1
30,442,442,46,3,43,4,3
6,450,450,73,7,66,3,2
1,461,461,20,4,16,2,1
27,477,477,2,2,0,1,0
26,480,480,145,121,24,4,3
29,489,489,65,65,0,1,0
18,497,497,12,8,4,2,1

38,119,119,17,17,0,1,0
2,130,130,7,7,0,1,0
14,137,137,2,2,0,1,0
15,164,164,14,14,0,1,0
22,176,176,8,8,0,1,0
7,176,176,8,2,6,3,2
35,186,186,1,1,0,1,0
33,192,192,10,2,8,2,1
36,212,212,51,51,0,1,0
23,221,221,42,42,0,1,0
30,234,234,43,43,0,1,0
34,240,240,2,2,0,1,0
11,242,242,17,9,8,2,1
18,252,252,13,5,8,2,1
5,254,254,58,4,54,4,3
27,257,257,36,4,32,2,1
3,280,280,34,10,24,3,2
16,283,283,30,6,24,4,3
28,286,286,74,17,57,3,2
12,306,306,32,2,30,2,1
6,311,311,1,1,0,1,0
29,323,323,31,31,0,1,0
1,354,354,19,11,8,2,1
4,357,357,1,1,0,1,0
17,364,364,23,2,21,4,3
19,373,373,52,18,34,3,2
26,374,374,11,2,9,4,3
21,409,409,8,2,6,2,1
20,412,412,12,12,0,1,0
25,413,413,3,3,0,1,0
37,418,418,2,2,0,1,0
8,420,420,46,46,0,1,0
10,426,426,2,2,0,1,0
39,444,444,7,7,0,1,0
13,461,461,136,112,24,4,3
9,461,461,70,22,48,3,2
0,465,465,2,2,0,1,0
31,481,481,16,10,6,3,2
40,486,486,136,62,74,4,3
32,488,488,18,1,17,2,1
24,500,500,58,2,56,3,2

28,102,102,1,1,0,1,0
1,107,107,1,1,0,1,0
21,132,132,25,1,24,2,1
0,158,158,3,3,0,1,0
9,160,160,5,5,0,1,0
4,181,181,36,36,0,1,0
15,192,192,18,18,0,1,0
5,207,207,27,27,0,1,0
30,214,214,40,40,0,1,0
12,219,219,156,51,105,4,3
10,228,228,12,6,6,2,1
19,230,230,27,5,22,3,2
29,239,239,70,48,22,3,2
7,246,246,18,3,15,4,3
33,265,265,7,7,0,1,0
16,283,283,36,36,0,1,0
24,309,309,4,4,0,1,0
13,312,312,44,32,12,4,3
6,352,352,46,46,0,1,0
17,382,382,16,16,0,1,0
27,387,387,94,58,36,4,3
32,399,399,27,9,18,2,1
8,400,400,36,36,0,1,0
18,411,411,25,25,0,1,0
20,416,416,19,8,11,2,1
31,417,417,8,8,0,1,0
14,422,422,5,2,3,2,1
25,423,423,53,53,0,1,0
11,423,423,6,6,0,1,0
3,431,431,3,3,0,1,0
23,435,435,12,12,0,1,0
2,453,453,39,26,13,2,1
22,476,476,32,32,0,1,0
26,478,478,81,81,0,1,0

25,100,100,9,9,0,1,0
27,131,131,16,16,0,1,0
5,147,147,5,1,4,2,1
0,151,151,32,18,14,2,1
12,157,157,51,30,21,4,3
13,175,175,12,12,0,1,0
4,195,195,19,6,13,2,1
15,200,200,15,3,12,4,3
30,207,207,16,2,14,2,1
31,210,210,5,1,4,2,1
24,212,212,7,7,0,1,0
17,216,216,76,76,0,1,0
21,247,247,20,1,19,2,1
22,273,273,73,73,0,1,0
2,331,331,74,5,69,4,3
18,340,340,6,6,0,1,0
8,348,348,62,22,40,2,1
1,349,349,104,24,80,3,2
14,355,355,1,1,0,1,0
6,378,378,48,2,46,2,1
3,378,378,26,26,0,1,0
29,388,388,39,1,38,3,2
7,390,390,33,12,21,3,2
28,390,390,6,6,0,1,0
26,390,390,60,12,48,2,1
16,412,412,4,4,0,1,0
23,414,414,33,28,5,2,1
9,417,417,12,4,8,2,1
11,435,435,13,13,0,1,0
19,454,454,152,110,42,4,3
20,479,479,2,2,0,1,0
10,500,500,15,6,9,4,3

28,126,126,25,7,18,3,2
37,127,127,4,4,0,1,0
13,135,135,8,8,0,1,0
32,138,138,26,26,0,1,0
9,142,142,17,14,3,2,1
21,145,145,4,1,3,2,1
15,156,156,11,11,0,1,0
18,163,163,1,1,0,1,0
1,172,172,12,12,0,1,0
17,178,178,6,6,0,1,0
20,181,181,29,13,16,3,2
26,193,193,22,22,0,1,0
35,200,200,8,4,4,2,1
33,222,222,68,50,18,4,3
2,227,227,20,20,0,1,0
14,229,229,32,18,14,2,1
19,261,261,8,8,0,1,0
36,281,281,34,13,21,4,3
38,282,282,15,15,0,1,0
12,297,297,10,10,0,1,0
25,306,306,39,27,12,3,2
16,313,313,22,22,0,1,0
4,324,324,30,24,6,2,1
29,330,330,31,7,24,4,3
11,354,354,26,26,0,1,0
5,371,371,14,11,3,2,1
0,375,375,33,1,32,3,2
3,377,377,33,21,12,2,1
22,384,384,7,7,0,1,0
10,389,389,105,105,0,1,0
7,403,403,98,79,19,2,1
30,431,431,16,16,0,1,0
24,435,435,30,5,25,4,3
8,458,458,7,4,3,2,1
27,467,467,146,146,0,1,0
31,468,468,31,4,27,4,3
34,473,473,13,13,0,1,0
23,493,493,1,1,0,1,0
6,494,494,7,1,6,3,2

9,126,126,49,49,0,1,0
7,130,130,12,3,9,4,3
5,146,146,23,2,21,4,3
10,150,150,5,5,0,1,0
30,157,157,21,21,0,1,0
15,166,166,3,3,0,1,0
25,180,180,9,9,0,1,0
17,183,183,39,32,7,2,1
0,184,184,2,2,0,1,0
19,184,184,7,7,0,1,0
2,193,193,46,4,42,2,1
4,200,200,6,6,0,1,0
27,201,201,13,13,0,1,0
14,213,213,32,32,0,1,0
33,227,227,25,15,10,2,1
12,238,238,35,35,0,1,0
16,254,254,34,21,13,2,1
32,262,262,9,9,0,1,0
13,272,272,48,48,0,1,0
6,313,313,52,22,30,4,3
23,318,318,66,66,0,1,0
26,338,338,15,7,8,2,1
29,347,347,20,20,0,1,0
3,353,353,13,13,0,1,0
28,362,362,8,8,0,1,0
24,368,368,70,32,38,2,1
8,402,402,10,1,9,2,1
31,417,417,18,10,8,2,1
18,425,425,23,7,16,2,1
20,438,438,52,52,0,1,0
21,458,458,88,46,42,3,2
1,468,468,52,12,40,3,2
11,484,484,11,11,0,1,0
22,490,490,58,40,18,2,1

26,107,107,19,15,4,2,1
22,130,130,1,1,0,1,0
39,131,131,14,14,0,1,0
10,133,133,5,5,0,1,0
37,183,183,20,8,12,2,1
28,195,195,69,69,0,1,0
33,213,213,7,7,0,1,0
34,219,219,13,13,0,1,0
19,231,231,36,36,0,1,0
4,239,239,3,3,0,1,0
5,261,261,14,14,0,1,0
36,261,261,2,2,0,1,0
40,269,269,116,83,33,4,3
6,280,280,24,24,0,1,0
15,284,284,11,2,9,4,3
27,291,291,30,2,28,2,1
9,294,294,1,1,0,1,0
0,295,295,57,46,11,2,1
32,309,309,5,5,0,1,0
23,316,316,10,10,0,1,0
35,323,323,9,9,0,1,0
13,329,329,25,17,8,2,1
7,338,338,5,5,0,1,0
16,352,352,31,20,11,2,1
30,356,356,11,11,0,1,0
18,365,365,1,1,0,1,0
2,367,367,55,55,0,1,0
38,379,379,1,1,0,1,0
20,400,400,118,118,0,1,0
21,402,402,22,22,0,1,0
29,404,404,1,1,0,1,0
11,405,405,12,4,8,2,1
8,410,410,2,2,0,1,0
31,413,413,47,47,0,1,0
41,423,423,45,8,37,2,1
12,464,464,30,30,0,1,0
1,480,480,51,47,4,2,1
3,488,488,99,64,35,2,1
14,490,490,13,3,10,3,2
24,497,497,53,53,0,1,0
25,499,499,24,24,0,1,0
17,499,499,33,33,0,1,0

28,127,127,29,29,0,1,0
4,142,142,2,2,0,1,0
13,152,152,5,5,0,1,0
15,173,173,15,1,14,2,1
9,202,202,3,3,0,1,0
20,204,204,25,17,8,3,2
16,212,212,57,57,0,1,0
29,214,214,11,11,0,1,0
11,227,227,3,3,0,1,0
26,236,236,37,37,0,1,0
10,238,238,12,2,10,3,2
30,249,249,14,14,0,1,0
6,268,268,32,32,0,1,0
23,273,273,3,3,0,1,0
21,284,284,12,12,0,1,0
27,307,307,15,1,14,3,2
22,319,319,29,29,0,1,0
25,371,371,92,92,0,1,0
1,373,373,92,77,15,3,2
5,384,384,127,51,76,3,2
17,417,417,23,17,6,2,1
0,419,419,36,18,18,2,1
2,426,426,111,88,23,2,1
7,433,433,13,6,7,2,1
3,443,443,232,157,75,3,2
14,445,445,59,59,0,1,0
8,449,449,19,19,0,1,0
18,460,460,58,30,28,3,2
12,477,477,33,33,0,1,0
24,484,484,19,7,12,3,2
19,500,500,17,17,0,1,0

27,103,103,1,1,0,1,0
28,107,107,3,3,0,1,0
18,138,138,3,3,0,1,0
4,142,142,6,6,0,1,0
31,143,143,6,6,0,1,0
6,152,152,9,9,0,1,0
8,153,153,2,2,0,1,0
7,154,154,8,8,0,1,0
26,172,172,1,1,0,1,0
32,178,178,19,19,0,1,0
0,193,193,19,3,16,3,2
29,207,207,21,21,0,1,0
20,215,215,6,6,0,1,0
1,220,220,1,1,0,1,0
24,234,234,23,23,0,1,0
23,234,234,64,64,0,1,0
30,239,239,27,27,0,1,0
22,253,253,40,40,0,1,0
21,260,260,21,21,0,1,0
10,262,262,46,43,3,2,1
5,276,276,85,3,82,3,2
14,282,282,7,7,0,1,0
25,304,304,168,162,6,3,2
2,329,329,147,147,0,1,0
13,331,331,40,5,35,4,3
12,357,357,76,34,42,4,3
15,370,370,42,42,0,1,0
3,374,374,50,50,0,1,0
19,375,375,13,13,0,1,0
11,404,404,38,38,0,1,0
16,461,461,3,3,0,1,0
17,482,482,33,33,0,1,0
9,482,482,7,7,0,1,0

25,139,139,2,2,0,1,0
28,151,151,9,9,0,1,0
1,156,156,16,16,0,1,0
4,156,156,1,1,0,1,0
29,158,158,86,48,38,3,2
2,161,161,6,6,0,1,0
0,188,188,29,5,24,3,2
22,231,231,3,3,0,1,0
11,231,231,16,16,0,1,0
10,234,234,6,6,0,1,0
32,269,269,23,23,0,1,0
34,280,280,36,13,23,2,1
14,282,282,12,12,0,1,0
36,288,288,6,6,0,1,0
31,314,314,18,3,15,4,3
6,323,323,80,32,48,4,3
17,324,324,14,14,0,1,0
3,327,327,14,14,0,1,0
20,335,335,19,3,16,3,2
30,343,343,13,13,0,1,0
23,345,345,44,44,0,1,0
27,353,353,1,1,0,1,0
7,354,354,59,34,25,3,2
13,354,354,26,26,0,1,0
12,357,357,7,3,4,2,1
39,358,358,132,38,94,3,2
9,361,361,61,61,0,1,0
33,362,362,17,10,7,2,1
26,384,384,21,21,0,1,0
18,385,385,54,7,47,2,1
16,392,392,5,5,0,1,0
21,404,404,2,2,0,1,0
38,417,417,3,3,0,1,0
5,426,426,34,4,30,3,2
15,445,445,1,1,0,1,0
19,454,454,57,57,0,1,0
8,454,454,81,39,42,2,1
35,476,476,55,33,22,3,2
37,477,477,27,27,0,1,0
24,497,497,44,36,8,2,1

1,100,100,3,3,0,1,0
25,126,126,11,6,5,2,1
8,131,131,12,12,0,1,0
13,131,131,14,1,13,2,1
32,166,166,36,18,18,4,3
10,172,172,14,3,11,2,1
5,180,180,54,54,0,1,0
12,181,181,11,1,10,2,1
19,184,184,40,40,0,1,0
27,194,194,4,4,0,1,0
21,207,207,6,1,5,2,1
16,211,211,66,66,0,1,0
2,224,224,3,3,0,1,0
3,246,246,32,32,0,1,0
4,247,247,16,16,0,1,0
22,256,256,42,18,24,2,1
9,275,275,28,28,0,1,0
35,275,275,10,10,0,1,0
15,282,282,7,2,5,2,1
36,300,300,30,30,0,1,0
24,306,306,6,6,0,1,0
6,308,308,9,9,0,1,0
34,308,308,21,12,9,4,3
28,311,311,85,79,6,3,2
17,351,351,1,1,0,1,0
23,359,359,45,45,0,1,0
0,380,380,44,44,0,1,0
20,384,384,11,11,0,1,0
11,395,395,13,1,12,3,2
7,420,420,47,2,45,4,3
31,420,420,52,39,13,2,1
30,423,423,33,15,18,2,1
14,437,437,70,10,60,3,2
18,438,438,13,8,5,2,1
29,439,439,11,11,0,1,0
26,472,472,85,55,30,4,3
33,478,478,22,22,0,1,0

4,113,113,3,3,0,1,0
29,147,147,15,5,10,2,1
20,149,149,3,3,0,1,0
13,153,153,2,2,0,1,0
30,164,164,3,3,0,1,0
33,166,166,11,2,9,2,1
15,170,170,7,7,0,1,0
5,173,173,1,1,0,1,0
21,176,176,12,1,11,2,1
9,187,187,41,41,0,1,0
19,193,193,2,2,0,1,0
18,203,203,30,9,21,2,1
23,208,208,5,5,0,1,0
27,223,223,14,4,10,2,1
32,225,225,37,12,25,4,3
25,225,225,33,26,7,2,1
8,260,260,1,1,0,1,0
34,262,262,16,3,13,3,2
17,265,265,23,23,0,1,0
38,276,276,40,40,0,1,0
28,285,285,18,7,11,2,1
31,300,300,27,21,6,2,1
26,312,312,36,36,0,1,0
6,338,338,50,50,0,1,0
14,356,356,8,2,6,3,2
24,360,360,70,52,18,3,2
16,375,375,40,28,12,4,3
22,379,379,125,3,122,4,3
12,393,393,74,64,10,2,1
0,411,411,20,20,0,1,0
2,429,429,24,3,21,2,1
37,429,429,11,3,8,3,2
11,438,438,64,55,9,4,3
3,453,453,53,53,0,1,0
1,460,460,138,6,132,4,3
35,465,465,4,4,0,1,0
36,485,485,75,75,0,1,0
10,493,493,3,3,0,1,0
7,498,498,45,12,33,2,1

36,121,121,27,27,0,1,0
2,139,139,12,2,10,3,2
23,153,153,9,9,0,1,0
5,157,157,28,12,16,2,1
30,177,177,11,4,7,2,1
12,191,191,1,1,0,1,0
8,212,212,34,34,0,1,0
9,241,241,51,15,36,4,3
28,248,248,41,41,0,1,0
3,251,251,2,2,0,1,0
1,259,259,18,11,7,2,1
19,263,263,24,8,16,3,2
6,265,265,2,2,0,1,0
33,289,289,16,10,6,3,2
0,314,314,35,35,0,1,0
18,320,320,30,2,28,2,1
25,325,325,98,98,0,1,0
16,331,331,46,46,0,1,0
32,363,363,7,7,0,1,0
35,368,368,17,5,12,3,2
21,372,372,65,65,0,1,0
26,386,386,45,45,0,1,0
17,390,390,14,14,0,1,0
4,393,393,20,20,0,1,0
29,396,396,42,22,20,3,2
10,399,399,57,47,10,2,1
27,403,403,1,1,0,1,0
20,428,428,40,40,0,1,0
13,430,430,43,43,0,1,0
7,432,432,80,71,9,4,3
24,441,441,63,43,20,2,1
37,449,449,28,10,18,4,3
14,458,458,34,23,11,2,1
34,461,461,19,19,0,1,0
22,465,465,30,11,19,3,2
31,471,471,45,6,39,4,3
15,471,471,5,5,0,1,0
11,488,488,20,20,0,1,0

18,117,117,35,35,0,1,0
15,128,128,8,8,0,1,0
24,151,151,13,6,7,2,1
8,157,157,67,67,0,1,0
28,161,161,10,10,0,1,0
32,167,167,4,4,0,1,0
21,179,179,14,5,9,2,1
14,193,193,16,16,0,1,0
5,210,210,27,27,0,1,0
19,215,215,8,3,5,2,1
11,243,243,21,21,0,1,0
30,257,257,37,25,12,4,3
0,261,261,57,9,48,3,2
10,273,273,25,15,10,3,2
1,279,279,75,41,34,2,1
7,312,312,8,8,0,1,0
6,320,320,21,11,10,3,2
4,342,342,3,3,0,1,0
2,377,377,3,3,0,1,0
17,385,385,17,17,0,1,0
31,385,385,6,6,0,1,0
29,388,388,2,2,0,1,0
3,389,389,49,49,0,1,0
27,391,391,52,18,34,3,2
12,407,407,24,8,16,3,2
25,428,428,102,48,54,4,3
26,443,443,14,14,0,1,0
13,446,446,85,85,0,1,0
20,456,456,19,1,18,2,1
9,462,462,8,8,0,1,0
16,471,471,213,213,0,1,0
23,484,484,15,15,0,1,0
22,493,493,22,8,14,3,2

14,109,109,3,3,0,1,0
4,114,114,4,4,0,1,0
29,120,120,5,5,0,1,0
17,137,137,15,6,9,4,3
9,151,151,2,2,0,1,0
10,161,161,26,2,24,3,2
24,184,184,14,14,0,1,0
27,186,186,28,6,22,3,2
28,207,207,5,5,0,1,0
13,207,207,9,9,0,1,0
19,216,216,3,3,0,1,0
21,251,251,26,2,24,2,1
0,251,251,17,17,0,1,0
6,263,263,78,63,15,4,3
23,263,263,4,4,0,1,0
5,263,263,64,52,12,2,1
2,274,274,10,2,8,3,2
15,281,281,17,17,0,1,0
12,295,295,56,8,48,4,3
8,303,303,121,10,111,4,3
11,309,309,9,9,0,1,0
31,312,312,18,9,9,4,3
16,333,333,26,26,0,1,0
26,363,363,113,113,0,1,0
18,410,410,13,4,9,4,3
20,456,456,40,3,37,4,3
1,461,461,37,37,0,1,0
25,470,470,209,206,3,2,1
30,473,473,88,70,18,2,1
3,480,480,48,30,18,4,3
7,483,483,51,51,0,1,0
22,490,490,9,9,0,1,0

23,102,102,1,1,0,1,0
26,105,105,5,2,3,2,1
19,112,112,1,1,0,1,0
35,122,122,2,2,0,1,0
6,139,139,2,2,0,1,0
18,162,162,14,5,9,2,1
39,162,162,13,13,0,1,0
17,171,171,17,3,14,2,1
12,187,187,1,1,0,1,0
14,187,187,47,47,0,1,0
33,188,188,11,5,6,3,2
36,193,193,30,30,0,1,0
40,194,194,24,24,0,1,0
3,194,194,18,12,6,3,2
24,199,199,5,5,0,1,0
15,207,207,11,6,5,2,1
30,215,215,1,1,0,1,0
38,235,235,32,32,0,1,0
7,240,240,36,27,9,4,3
9,256,256,6,3,3,2,1
21,256,256,71,71,0,1,0
34,258,258,13,1,12,2,1
31,280,280,37,14,23,2,1
8,282,282,10,10,0,1,0
28,299,299,51,3,48,4,3
27,301,301,33,3,30,2,1
37,301,301,36,12,24,2,1
29,304,304,39,39,0,1,0
4,304,304,2,2,0,1,0
11,309,309,14,3,11,2,1
1,344,344,34,34,0,1,0
20,370,370,45,10,35,4,3
13,370,370,8,8,0,1,0
10,380,380,23,23,0,1,0
32,383,383,139,61,78,4,3
5,410,410,50,36,14,3,2
22,454,454,1,1,0,1,0
25,455,455,48,48,0,1,0
2,455,455,44,3,41,2,1
0,459,459,19,19,0,1,0
16,492,492,42,42,0,1,0

3,100,100,1,1,0,1,0
28,106,106,10,10,0,1,0
2,112,112,6,6,0,1,0
20,129,129,11,2,9,4,3
26,134,134,27,10,17,2,1
0,143,143,23,5,18,3,2
21,150,150,2,2,0,1,0
31,164,164,30,21,9,4,3
15,167,167,2,2,0,1,0
14,182,182,17,17,0,1,0
37,193,193,20,10,10,3,2
38,207,207,65,11,54,4,3
33,208,208,14,14,0,1,0
36,211,211,8,8,0,1,0
10,235,235,31,31,0,1,0
13,264,264,14,14,0,1,0
12,282,282,48,26,22,2,1
9,286,286,5,5,0,1,0
17,287,287,21,21,0,1,0
19,300,300,20,9,11,4,3
11,328,328,130,48,82,3,2
6,329,329,1,1,0,1,0
24,334,334,22,22,0,1,0
16,335,335,4,4,0,1,0
25,338,338,7,7,0,1,0
34,342,342,33,1,32,3,2
23,365,365,14,2,12,3,2
1,377,377,58,38,20,3,2
29,382,382,53,53,0,1,0
35,382,382,11,11,0,1,0
39,387,387,30,30,0,1,0
18,399,399,4,4,0,1,0
27,409,409,13,3,10,3,2
32,424,424,44,44,0,1,0
30,432,432,60,34,26,2,1
5,443,443,8,4,4,2,1
22,460,460,38,38,0,1,0
40,462,462,43,43,0,1,0
8,470,470,20,14,6,2,1
4,472,472,19,19,0,1,0
7,498,498,51,5,46,3,2

21,100,100,9,9,0,1,0
27,109,109,46,1,45,3,2
4,138,138,11,11,0,1,0
0,144,144,33,16,17,2,1
19,186,186,40,40,0,1,0
36,190,190,1,1,0,1,0
32,205,205,11,2,9,4,3
5,207,207,44,44,0,1,0
28,216,216,25,7,18,3,2
22,223,223,32,32,0,1,0
6,228,228,65,21,44,4,3
7,231,231,16,16,0,1,0
33,234,234,26,16,10,3,2
1,259,259,8,8,0,1,0
8,267,267,76,49,27,2,1
11,269,269,18,8,10,4,3
16,285,285,6,6,0,1,0
3,288,288,7,7,0,1,0
25,306,306,2,2,0,1,0
2,313,313,5,5,0,1,0
23,317,317,17,17,0,1,0
17,325,325,45,6,39,3,2
24,327,327,19,9,10,2,1
18,332,332,22,5,17,4,3
15,352,352,34,20,14,3,2
10,364,364,7,1,6,3,2
35,366,366,21,8,13,2,1
20,374,374,17,8,9,2,1
12,380,380,1,1,0,1,0
9,399,399,2,2,0,1,0
29,409,409,50,50,0,1,0
26,423,423,78,78,0,1,0
34,444,444,47,8,39,2,1
14,465,465,15,1,14,4,3
13,471,471,57,18,39,3,2
30,487,487,3,3,0,1,0
31,494,494,25,18,7,2,1

20,104,104,2,2,0,1,0
27,109,109,9,9,0,1,0
9,113,113,2,2,0,1,0
4,114,114,2,2,0,1,0
31,120,120,19,1,18,4,3
5,139,139,4,4,0,1,0
1,140,140,1,1,0,1,0
37,143,143,12,5,7,2,1
2,149,149,9,9,0,1,0
0,149,149,13,13,0,1,0
15,156,156,5,5,0,1,0
13,163,163,9,9,0,1,0
34,174,174,43,31,12,4,3
7,184,184,21,21,0,1,0
3,187,187,41,17,24,2,1
30,193,193,3,3,0,1,0
6,208,208,2,2,0,1,0
41,223,223,31,31,0,1,0
12,223,223,37,4,33,4,3
40,225,225,40,40,0,1,0
25,235,235,21,21,0,1,0
19,258,258,8,8,0,1,0
8,259,259,1,1,0,1,0
29,273,273,11,11,0,1,0
10,276,276,1,1,0,1,0
35,278,278,38,13,25,2,1
16,289,289,19,19,0,1,0
28,290,290,9,9,0,1,0
26,292,292,6,6,0,1,0
14,320,320,12,12,0,1,0
38,338,338,34,34,0,1,0
17,357,357,7,7,0,1,0
23,383,383,12,1,11,2,1
22,401,401,64,64,0,1,0
32,430,430,20,10,10,2,1
24,431,431,21,7,14,3,2
36,434,434,55,55,0,1,0
39,445,445,14,14,0,1,0
21,450,450,51,51,0,1,0
18,451,451,25,25,0,1,0
33,455,455,123,68,55,4,3
11,474,474,211,149,62,4,3

35,102,102,12,9,3,2,1
19,109,109,1,1,0,1,0
18,138,138,7,7,0,1,0
24,141,141,15,15,0,1,0
15,148,148,1,1,0,1,0
8,151,151,8,2,6,2,1
6,164,164,13,13,0,1,0
11,178,178,1,1,0,1,0
42,179,179,49,49,0,1,0
14,197,197,10,10,0,1,0
33,219,219,3,3,0,1,0
34,226,226,5,5,0,1,0
10,228,228,5,5,0,1,0
31,228,228,3,3,0,1,0
22,247,247,18,18,0,1,0
1,251,251,20,14,6,2,1
0,251,251,14,14,0,1,0
3,264,264,12,3,9,2,1
36,266,266,4,4,0,1,0
7,268,268,37,11,26,2,1
29,274,274,27,8,19,2,1
37,287,287,3,3,0,1,0
44,300,300,18,18,0,1,0
21,307,307,32,32,0,1,0
2,311,311,14,14,0,1,0
28,312,312,36,11,25,2,1
13,313,313,57,25,32,2,1
9,313,313,8,8,0,1,0
30,322,322,57,57,0,1,0
16,323,323,36,5,31,2,1
17,327,327,44,5,39,4,3
23,330,330,1,1,0,1,0
32,347,347,38,38,0,1,0
4,349,349,25,25,0,1,0
12,366,366,15,15,0,1,0
5,377,377,10,3,7,2,1
41,381,381,38,38,0,1,0
26,381,381,31,31,0,1,0
25,397,397,52,52,0,1,0
43,428,428,73,73,0,1,0
20,432,432,29,29,0,1,0
39,447,447,69,69,0,1,0
38,455,455,11,1,10,3,2
27,457,457,11,11,0,1,0
40,458,458,150,84,66,3,2

4,106,106,1,1,0,1,0
22,121,121,7,7,0,1,0
16,159,159,7,4,3,2,1
12,174,174,43,25,18,2,1
19,176,176,4,4,0,1,0
28,180,180,17,17,0,1,0
15,181,181,4,4,0,1,0
0,202,202,21,12,9,2,1
27,223,223,47,47,0,1,0
6,231,231,21,21,0,1,0
10,239,239,72,48,24,2,1
3,253,253,15,15,0,1,0
21,253,253,58,58,0,1,0
7,264,264,82,57,25,2,1
17,275,275,5,5,0,1,0
20,295,295,55,25,30,4,3
30,318,318,20,20,0,1,0
14,320,320,3,3,0,1,0
23,331,331,32,18,14,2,1
13,340,340,2,2,0,1,0
29,367,367,56,20,36,2,1
26,386,386,49,13,36,2,1
2,392,392,49,7,42,4,3
5,393,393,20,20,0,1,0
9,398,398,44,2,42,2,1
24,450,450,9,1,8,2,1
18,461,461,7,3,4,2,1
25,463,463,45,45,0,1,0
1,468,468,25,25,0,1,0
8,475,475,89,89,0,1,0
31,489,489,176,98,78,4,3
11,492,492,72,42,30,4,3

31,103,103,3,3,0,1,0
14,112,112,9,2,7,2,1
18,127,127,5,5,0,1,0
15,131,131,4,4,0,1,0
10,163,163,3,3,0,1,0
25,163,163,16,4,12,2,1
35,181,181,25,16,9,4,3
12,197,197,27,27,0,1,0
30,208,208,4,4,0,1,0
13,240,240,12,12,0,1,0
32,247,247,60,60,0,1,0
16,249,249,19,19,0,1,0
2,264,264,47,17,30,4,3
33,272,272,15,5,10,3,2
4,272,272,3,3,0,1,0
26,284,284,35,35,0,1,0
3,286,286,9,9,0,1,0
7,291,291,74,6,68,3,2
17,293,293,35,1,34,3,2
34,296,296,12,5,7,2,1
11,306,306,1,1,0,1,0
8,317,317,19,19,0,1,0
23,335,335,102,66,36,3,2
19,348,348,17,8,9,4,3
29,353,353,12,12,0,1,0
27,368,368,69,24,45,2,1
21,374,374,54,30,24,2,1
1,387,387,21,1,20,2,1
22,394,394,76,76,0,1,0
5,414,414,46,46,0,1,0
20,419,419,7,7,0,1,0
0,425,425,19,13,6,3,2
24,429,429,34,34,0,1,0
28,437,437,23,23,0,1,0
6,442,442,188,158,30,4,3
9,476,476,56,56,0,1,0

45,102,102,2,2,0,1,0
14,102,102,3,3,0,1,0
0,112,112,4,4,0,1,0
55,118,118,4,4,0,1,0
15,119,119,11,11,0,1,0
11,120,120,9,9,0,1,0
30,125,125,1,1,0,1,0
21,136,136,12,12,0,1,0
41,141,141,17,17,0,1,0
16,158,158,8,8,0,1,0
39,170,170,33,16,17,3,2
8,175,175,7,7,0,1,0
9,177,177,1,1,0,1,0
20,184,184,1,1,0,1,0
52,186,186,9,9,0,1,0
33,227,227,5,1,4,2,1
36,239,239,11,11,0,1,0
6,241,241,1,1,0,1,0
28,248,248,29,29,0,1,0
40,252,252,63,13,50,2,1
5,262,262,2,2,0,1,0
3,263,263,33,13,20,2,1
42,280,280,31,25,6,3,2
25,290,290,15,5,10,3,2
35,292,292,43,43,0,1,0
19,296,296,7,7,0,1,0
27,332,332,22,8,14,2,1
49,350,350,50,4,46,2,1
7,355,355,28,28,0,1,0
34,366,366,1,1,0,1,0
37,366,366,8,8,0,1,0
29,368,368,36,3,33,2,1
51,369,369,5,5,0,1,0
48,372,372,7,7,0,1,0
32,388,388,42,7,35,3,2
22,396,396,27,3,24,4,3
44,399,399,39,39,0,1,0
13,401,401,4,4,0,1,0
1,409,409,26,17,9,4,3
38,410,410,17,17,0,1,0
47,410,410,69,32,37,2,1
17,424,424,1,1,0,1,0
50,426,426,116,31,85,4,3
10,426,426,1,1,0,1,0
31,428,428,38,38,0,1,0
43,444,444,1,1,0,1,0
24,450,450,9,9,0,1,0
12,452,452,20,20,0,1,0
26,453,453,22,4,18,3,2
54,469,469,56,26,30,3,2
46,470,470,75,43,32,2,1
2,471,471,16,16,0,1,0
18,476,476,6,2,4,2,1
23,476,476,16,16,0,1,0
53,494,494,10,1,9,4,3
4,495,495,11,11,0,1,0

7,101,101,46,5,41,2,1
25,112,112,17,3,14,3,2
15,121,121,1,1,0,1,0
30,132,132,11,11,0,1,0
28,133,133,38,38,0,1,0
27,156,156,4,4,0,1,0
21,156,156,35,35,0,1,0
29,157,157,35,4,31,2,1
1,204,204,51,51,0,1,0
24,213,213,16,16,0,1,0
31,215,215,11,11,0,1,0
23,215,215,14,14,0,1,0
4,215,215,21,9,12,2,1
19,236,236,7,1,6,3,2
16,246,246,68,2,66,4,3
0,252,252,32,18,14,3,2
22,268,268,21,4,17,2,1
18,269,269,3,3,0,1,0
5,303,303,16,7,9,4,3
8,309,309,55,5,50,3,2
3,334,334,38,17,21,3,2
6,344,344,21,7,14,2,1
13,364,364,72,27,45,4,3
12,367,367,29,16,13,2,1
17,371,371,7,1,6,2,1
26,376,376,18,18,0,1,0
14,381,381,51,22,29,4,3
2,393,393,1,1,0,1,0
10,440,440,38,22,16,3,2
9,444,444,29,21,8,3,2
11,465,465,16,5,11,3,2
20,483,483,23,23,0,1,0

33,109,109,1,1,0,1,0
28,110,110,4,4,0,1,0
26,122,122,23,23,0,1,0
11,131,131,6,3,3,2,1
22,160,160,11,11,0,1,0
14,160,160,1,1,0,1,0
17,166,166,15,15,0,1,0
31,187,187,11,11,0,1,0
20,200,200,18,5,13,2,1
2,201,201,21,17,4,2,1
25,221,221,11,5,6,2,1
19,222,222,26,7,19,2,1
36,224,224,60,33,27,2,1
21,236,236,1,1,0,1,0
23,239,239,2,2,0,1,0
29,239,239,2,2,0,1,0
15,244,244,55,55,0,1,0
37,252,252,34,34,0,1,0
13,255,255,3,3,0,1,0
34,258,258,2,2,0,1,0
24,262,262,34,34,0,1,0
16,267,267,2,2,0,1,0
10,282,282,13,5,8,3,2
8,283,283,2,2,0,1,0
40,300,300,63,7,56,3,2
32,310,310,32,32,0,1,0
12,316,316,1,1,0,1,0
0,333,333,61,25,36,3,2
9,335,335,7,7,0,1,0
27,341,341,30,4,26,3,2
4,349,349,111,111,0,1,0
3,369,369,31,7,24,4,3
39,372,372,29,29,0,1,0
6,388,388,72,36,36,3,2
5,393,393,1,1,0,1,0
30,397,397,78,78,0,1,0
38,400,400,1,1,0,1,0
35,410,410,109,40,69,4,3
1,439,439,24,24,0,1,0
7,460,460,12,9,3,2,1
18,500,500,50,41,9,4,3

4,102,102,4,4,0,1,0
36,115,115,26,6,20,3,2
6,126,126,6,2,4,2,1
23,136,136,11,11,0,1,0
24,143,143,4,1,3,2,1
28,153,153,9,9,0,1,0
8,158,158,6,6,0,1,0
26,174,174,1,1,0,1,0
22,174,174,38,38,0,1,0
15,179,179,1,1,0,1,0
5,186,186,4,4,0,1,0
7,187,187,1,1,0,1,0
18,190,190,12,4,8,3,2
16,190,190,5,2,3,2,1
34,200,200,4,4,0,1,0
37,218,218,33,12,21,4,3
9,233,233,16,4,12,3,2
35,257,257,22,4,18,3,2
1,267,267,34,34,0,1,0
11,275,275,7,7,0,1,0
12,280,280,13,4,9,2,1
21,285,285,12,6,6,2,1
39,307,307,50,50,0,1,0
44,307,307,22,22,0,1,0
17,308,308,3,3,0,1,0
10,325,325,83,75,8,3,2
19,325,325,67,67,0,1,0
0,325,325,8,3,5,2,1
25,333,333,33,33,0,1,0
41,343,343,27,27,0,1,0
2,358,358,18,2,16,3,2
38,361,361,2,2,0,1,0
42,367,367,8,8,0,1,0
13,383,383,3,3,0,1,0
3,386,386,83,39,44,4,3
33,392,392,3,3,0,1,0
14,396,396,7,7,0,1,0
32,416,416,19,11,8,2,1
29,440,440,103,55,48,3,2
20,467,467,8,2,6,2,1
40,472,472,204,204,0,1,0
27,475,475,4,4,0,1,0
31,476,476,57,57,0,1,0
43,477,477,4,4,0,1,0
45,491,491,41,41,0,1,0
30,494,494,7,7,0,1,0

33,109,109,1,1,0,1,0
36,117,117,3,3,0,1,0
0,118,118,5,1,4,2,1
11,129,129,12,12,0,1,0
13,152,152,27,8,19,2,1
26,155,155,26,12,14,3,2
25,159,159,2,2,0,1,0
17,170,170,1,1,0,1,0
12,171,171,18,9,9,4,3
6,176,176,1,1,0,1,0
34,178,178,14,9,5,2,1
10,187,187,15,15,0,1,0
27,194,194,7,2,5,2,1
23,226,226,97,76,21,2,1
9,244,244,55,10,45,4,3
16,256,256,38,8,30,4,3
31,269,269,15,5,10,3,2
28,277,277,135,105,30,3,2
22,295,295,7,1,6,2,1
35,303,303,8,1,7,2,1
19,308,308,62,32,30,4,3
30,312,312,23,23,0,1,0
37,326,326,19,16,3,2,1
21,338,338,3,3,0,1,0
4,338,338,69,69,0,1,0
8,340,340,29,3,26,2,1
18,362,362,5,5,0,1,0
14,369,369,52,52,0,1,0
20,387,387,30,6,24,2,1
1,397,397,3,3,0,1,0
3,400,400,11,11,0,1,0
5,415,415,19,19,0,1,0
32,416,416,57,57,0,1,0
15,424,424,1,1,0,1,0
24,437,437,32,10,22,3,2
2,444,444,57,57,0,1,0
29,457,457,22,15,7,2,1
7,472,472,28,28,0,1,0

0,103,103,17,17,0,1,0
18,111,111,24,24,0,1,0
34,115,115,9,9,0,1,0
14,116,116,4,4,0,1,0
31,126,126,3,3,0,1,0
2,145,145,23,2,21,2,1
22,148,148,11,3,8,3,2
27,150,150,1,1,0,1,0
28,160,160,14,14,0,1,0
30,163,163,1,1,0,1,0
20,169,169,25,25,0,1,0
12,176,176,10,10,0,1,0
24,187,187,21,11,10,2,1
7,207,207,14,14,0,1,0
11,209,209,17,17,0,1,0
32,237,237,1,1,0,1,0
23,243,243,7,7,0,1,0
3,254,254,22,4,18,4,3
19,257,257,43,43,0,1,0
4,260,260,74,74,0,1,0
33,270,270,8,8,0,1,0
8,270,270,36,36,0,1,0
6,270,270,2,2,0,1,0
15,358,358,51,42,9,2,1
21,360,360,81,18,63,4,3
5,385,385,8,8,0,1,0
16,390,390,15,4,11,2,1
26,392,392,41,41,0,1,0
29,400,400,102,94,8,3,2
9,409,409,124,40,84,3,2
13,410,410,34,34,0,1,0
25,422,422,55,55,0,1,0
10,447,447,19,19,0,1,0
17,452,452,68,47,21,4,3
1,497,497,47,26,21,2,1

21,102,102,6,6,0,1,0
3,104,104,11,6,5,2,1
11,126,126,11,3,8,3,2
2,161,161,19,19,0,1,0
22,172,172,1,1,0,1,0
33,204,204,1,1,0,1,0
15,239,239,16,16,0,1,0
16,245,245,90,90,0,1,0
32,258,258,43,43,0,1,0
17,265,265,52,4,48,4,3
8,270,270,15,6,9,2,1
28,285,285,17,17,0,1,0
26,313,313,39,21,18,3,2
6,314,314,10,10,0,1,0
25,344,344,18,18,0,1,0
35,348,348,23,14,9,4,3
27,368,368,45,45,0,1,0
34,377,377,46,46,0,1,0
19,385,385,40,5,35,2,1
30,394,394,42,2,40,3,2
20,396,396,41,4,37,2,1
23,397,397,19,10,9,4,3
7,410,410,3,3,0,1,0
4,419,419,43,37,6,2,1
29,420,420,30,30,0,1,0
31,421,421,104,104,0,1,0
14,422,422,27,1,26,4,3
5,439,439,165,165,0,1,0
12,441,441,1,1,0,1,0
24,454,454,119,95,24,3,2
9,466,466,22,22,0,1,0
1,471,471,44,3,41,2,1
10,478,478,9,9,0,1,0
18,480,480,55,12,43,2,1
0,486,486,26,9,17,3,2
13,496,496,3,3,0,1,0

25,102,102,3,3,0,1,0
22,113,113,40,28,12,4,3
2,139,139,2,2,0,1,0
20,151,151,3,3,0,1,0
15,164,164,1,1,0,1,0
12,164,164,1,1,0,1,0
19,173,173,7,4,3,2,1
18,178,178,21,18,3,2,1
1,182,182,40,27,13,2,1
16,185,185,11,11,0,1,0
32,189,189,19,19,0,1,0
5,195,195,17,6,11,2,1
34,219,219,36,2,34,2,1
29,223,223,1,1,0,1,0
21,226,226,11,11,0,1,0
28,235,235,21,15,6,3,2
9,279,279,19,19,0,1,0
35,331,331,9,9,0,1,0
27,338,338,34,34,0,1,0
14,365,365,18,18,0,1,0
10,369,369,7,7,0,1,0
8,372,372,5,5,0,1,0
3,373,373,12,3,9,4,3
11,373,373,7,7,0,1,0
26,381,381,46,22,24,2,1
30,381,381,19,3,16,3,2
6,409,409,213,213,0,1,0
24,421,421,135,1,134,4,3
31,428,428,44,24,20,3,2
13,443,443,45,45,0,1,0
4,456,456,29,29,0,1,0
0,465,465,98,98,0,1,0
17,484,484,94,94,0,1,0
23,498,498,36,36,0,1,0
33,499,499,32,32,0,1,0
7,499,499,58,50,8,3,2

2,107,107,6,6,0,1,0
0,120,120,4,4,0,1,0
27,128,128,7,2,5,2,1
1,144,144,1,1,0,1,0
31,146,146,41,41,0,1,0
14,151,151,10,10,0,1,0
25,160,160,15,1,14,3,2
6,171,171,10,2,8,2,1
10,174,174,47,3,44,3,2
11,180,180,1,1,0,1,0
41,194,194,15,15,0,1,0
37,197,197,61,37,24,3,2
17,198,198,2,2,0,1,0
8,203,203,23,15,8,2,1
20,224,224,25,2,23,2,1
15,240,240,45,45,0,1,0
39,263,263,4,4,0,1,0
38,268,268,1,1,0,1,0
29,271,271,41,41,0,1,0
34,275,275,14,14,0,1,0
28,277,277,2,2,0,1,0
22,302,302,9,9,0,1,0
7,304,304,20,5,15,4,3
36,309,309,39,39,0,1,0
3,320,320,37,37,0,1,0
18,326,326,1,1,0,1,0
9,332,332,29,1,28,3,2
12,345,345,22,19,3,2,1
30,355,355,13,13,0,1,0
24,356,356,40,1,39,4,3
19,369,369,1,1,0,1,0
40,372,372,44,3,41,2,1
23,386,386,8,5,3,2,1
26,431,431,137,137,0,1,0
16,445,445,57,39,18,3,2
32,447,447,1,1,0,1,0
33,463,463,20,20,0,1,0
35,471,471,15,15,0,1,0
5,471,471,18,18,0,1,0
13,477,477,48,40,8,2,1
4,486,486,42,2,40,2,1
21,499,499,70,4,66,4,3

19,112,112,13,13,0,1,0
21,135,135,3,3,0,1,0
30,141,141,13,1,12,4,3
15,141,141,10,10,0,1,0
2,145,145,11,11,0,1,0
16,174,174,4,4,0,1,0
25,181,181,9,1,8,2,1
37,183,183,92,2,90,3,2
38,199,199,15,15,0,1,0
18,200,200,23,19,4,2,1
20,204,204,52,52,0,1,0
28,217,217,6,3,3,2,1
35,220,220,15,15,0,1,0
11,249,249,4,4,0,1,0
1,269,269,1,1,0,1,0
0,279,279,31,18,13,2,1
23,310,310,9,9,0,1,0
8,321,321,36,17,19,4,3
36,335,335,77,1,76,3,2
33,347,347,58,7,51,4,3
26,351,351,4,4,0,1,0
7,352,352,4,4,0,1,0
10,371,371,1,1,0,1,0
17,380,380,86,67,19,2,1
4,382,382,21,1,20,3,2
24,393,393,9,9,0,1,0
13,400,400,11,8,3,2,1
34,405,405,16,3,13,2,1
3,408,408,36,9,27,4,3
12,442,442,33,33,0,1,0
6,450,450,39,9,30,4,3
32,458,458,13,7,6,2,1
27,464,464,10,10,0,1,0
29,465,465,40,3,37,3,2
31,466,466,71,22,49,2,1
5,476,476,10,10,0,1,0
9,498,498,19,19,0,1,0
22,499,499,99,51,48,3,2
14,500,500,136,124,12,3,2

14,117,117,16,16,0,1,0
25,131,131,4,4,0,1,0
7,135,135,4,4,0,1,0
5,142,142,7,7,0,1,0
20,146,146,25,2,23,3,2
6,155,155,1,1,0,1,0
24,159,159,8,1,7,2,1
31,179,179,21,6,15,2,1
10,183,183,32,32,0,1,0
16,184,184,21,3,18,4,3
8,187,187,12,8,4,2,1
17,200,200,6,6,0,1,0
1,208,208,19,8,11,2,1
30,209,209,3,3,0,1,0
27,227,227,33,3,30,4,3
23,230,230,46,46,0,1,0
22,254,254,11,2,9,2,1
19,276,276,35,35,0,1,0
15,277,277,15,15,0,1,0
9,290,290,38,4,34,3,2
11,330,330,178,126,52,3,2
4,343,343,44,11,33,2,1
12,348,348,56,24,32,3,2
18,365,365,23,11,12,4,3
3,383,383,57,57,0,1,0
28,437,437,25,25,0,1,0
0,442,442,84,72,12,3,2
26,462,462,28,28,0,1,0
29,474,474,45,45,0,1,0
2,480,480,14,14,0,1,0
21,483,483,158,76,82,4,3
13,489,489,28,28,0,1,0

6,105,105,17,1,16,3,2
7,106,106,10,7,3,2,1
16,112,112,9,9,0,1,0
33,120,120,3,3,0,1,0
34,136,136,39,39,0,1,0
3,143,143,6,6,0,1,0
9,146,146,3,3,0,1,0
25,148,148,26,26,0,1,0
27,177,177,24,24,0,1,0
1,190,190,20,2,18,4,3
13,197,197,3,3,0,1,0
29,197,197,29,29,0,1,0
10,224,224,29,7,22,2,1
31,228,228,7,7,0,1,0
2,230,230,18,6,12,4,3
32,275,275,6,6,0,1,0
5,300,300,8,2,6,2,1
23,300,300,30,30,0,1,0
18,307,307,22,22,0,1,0
8,307,307,95,64,31,2,1
22,331,331,85,38,47,2,1
4,335,335,14,8,6,3,2
24,344,344,6,6,0,1,0
35,345,345,11,11,0,1,0
21,363,363,3,3,0,1,0
26,376,376,52,6,46,2,1
12,377,377,31,10,21,4,3
30,441,441,78,25,53,4,3
11,441,441,57,57,0,1,0
28,446,446,25,4,21,2,1
0,452,452,97,64,33,4,3
14,459,459,61,21,40,2,1
17,465,465,33,3,30,2,1
15,475,475,31,31,0,1,0
19,476,476,34,34,0,1,0
20,490,490,45,45,0,1,0

31,124,124,6,3,3,2,1
20,129,129,1,1,0,1,0
23,154,154,1,1,0,1,0
15,164,164,10,1,9,4,3
35,176,176,58,58,0,1,0
0,188,188,31,13,18,3,2
9,193,193,5,5,0,1,0
28,203,203,16,16,0,1,0
13,208,208,33,33,0,1,0
29,208,208,72,50,22,2,1
36,218,218,38,12,26,3,2
11,240,240,1,1,0,1,0
12,248,248,9,9,0,1,0
16,251,251,1,1,0,1,0
1,292,292,22,22,0,1,0
14,294,294,81,81,0,1,0
24,296,296,11,4,7,2,1
2,310,310,24,17,7,2,1
19,311,311,10,4,6,2,1
10,315,315,60,39,21,2,1
32,316,316,68,68,0,1,0
6,320,320,1,1,0,1,0
17,334,334,63,27,36,3,2
8,347,347,41,24,17,2,1
30,394,394,36,36,0,1,0
22,397,397,41,3,38,3,2
4,401,401,84,84,0,1,0
26,409,409,9,4,5,2,1
7,410,410,1,1,0,1,0
5,411,411,41,21,20,3,2
27,423,423,50,50,0,1,0
18,441,441,7,1,6,3,2
21,458,458,40,40,0,1,0
33,475,475,20,8,12,4,3
34,480,480,27,27,0,1,0
25,484,484,18,18,0,1,0
3,494,494,44,21,23,2,1

3,126,126,52,52,0,1,0
8,126,126,10,1,9,4,3
27,129,129,8,8,0,1,0
14,143,143,1,1,0,1,0
18,148,148,1,1,0,1,0
21,176,176,30,8,22,4,3
29,184,184,6,6,0,1,0
13,200,200,20,2,18,3,2
10,203,203,33,28,5,2,1
25,276,276,17,11,6,3,2
32,277,277,1,1,0,1,0
2,290,290,12,12,0,1,0
0,314,314,4,4,0,1,0
17,327,327,76,69,7,2,1
9,334,334,5,5,0,1,0
1,349,349,52,10,42,4,3
20,353,353,108,87,21,2,1
15,354,354,96,96,0,1,0
4,360,360,23,7,16,3,2
26,369,369,9,1,8,3,2
24,380,380,4,4,0,1,0
33,382,382,19,19,0,1,0
28,382,382,44,44,0,1,0
23,392,392,2,2,0,1,0
16,394,394,46,46,0,1,0
5,406,406,1,1,0,1,0
31,410,410,106,42,64,3,2
12,413,413,92,92,0,1,0
11,424,424,39,11,28,3,2
30,438,438,133,85,48,3,2
7,447,447,66,62,4,2,1
22,467,467,17,1,16,4,3
19,482,482,14,8,6,3,2
6,495,495,11,11,0,1,0

14,100,100,14,11,3,2,1
9,121,121,10,4,6,3,2
6,123,123,43,43,0,1,0
28,146,146,10,10,0,1,0
8,156,156,2,2,0,1,0
24,159,159,39,39,0,1,0
18,167,167,3,3,0,1,0
30,183,183,9,9,0,1,0
12,191,191,62,23,39,4,3
26,201,201,6,6,0,1,0
13,202,202,39,13,26,3,2
5,205,205,1,1,0,1,0
17,217,217,9,6,3,2,1
27,230,230,17,17,0,1,0
7,236,236,26,26,0,1,0
32,250,250,25,25,0,1,0
15,274,274,2,2,0,1,0
2,308,308,28,18,10,2,1
11,308,308,39,39,0,1,0
16,347,347,43,43,0,1,0
1,351,351,3,3,0,1,0
29,358,358,41,5,36,4,3
23,370,370,39,2,37,3,2
19,396,396,13,13,0,1,0
33,416,416,139,71,68,3,2
20,416,416,18,18,0,1,0
22,421,421,27,3,24,2,1
25,427,427,33,9,24,3,2
3,428,428,81,51,30,3,2
4,430,430,31,31,0,1,0
31,437,437,50,14,36,2,1
0,445,445,5,2,3,2,1
21,466,466,93,41,52,3,2
10,498,498,39,27,12,3,2

19,100,100,4,4,0,1,0
24,103,103,16,4,12,4,3
21,110,110,1,1,0,1,0
10,131,131,34,17,17,2,1
25,133,133,22,22,0,1,0
30,134,134,13,9,4,2,1
15,138,138,55,55,0,1,0
20,148,148,11,6,5,2,1
16,155,155,11,2,9,4,3
0,162,162,37,37,0,1,0
18,178,178,17,17,0,1,0
4,195,195,14,14,0,1,0
28,195,195,33,33,0,1,0
13,198,198,28,19,9,4,3
2,202,202,25,25,0,1,0
9,204,204,1,1,0,1,0
5,220,220,2,2,0,1,0
27,225,225,20,7,13,3,2
12,235,235,43,14,29,2,1
26,248,248,15,15,0,1,0
6,265,265,32,24,8,3,2
29,273,273,13,7,6,2,1
23,289,289,13,9,4,2,1
8,339,339,7,7,0,1,0
1,357,357,56,20,36,2,1
7,361,361,19,19,0,1,0
3,375,375,19,19,0,1,0
17,386,386,5,5,0,1,0
14,393,393,109,64,45,2,1
22,425,425,14,10,4,2,1
11,456,456,174,152,22,3,2
31,463,463,7,7,0,1,0

9,111,111,17,3,14,2,1
4,146,146,6,6,0,1,0
3,148,148,19,6,13,2,1
23,202,202,6,6,0,1,0
1,216,216,6,6,0,1,0
10,235,235,1,1,0,1,0
21,237,237,11,11,0,1,0
2,247,247,110,30,80,3,2
17,252,252,13,1,12,3,2
13,263,263,2,2,0,1,0
0,295,295,37,33,4,2,1
12,299,299,82,82,0,1,0
28,304,304,11,11,0,1,0
26,318,318,30,15,15,4,3
16,325,325,14,14,0,1,0
7,325,325,149,110,39,4,3
15,328,328,32,32,0,1,0
22,355,355,24,24,0,1,0
8,370,370,13,13,0,1,0
30,372,372,56,56,0,1,0
29,377,377,8,8,0,1,0
19,377,377,151,51,100,4,3
25,377,377,41,41,0,1,0
31,380,380,73,73,0,1,0
27,390,390,107,107,0,1,0
24,390,390,21,21,0,1,0
11,391,391,10,4,6,3,2
5,406,406,22,22,0,1,0
18,450,450,10,10,0,1,0
20,454,454,10,10,0,1,0
14,488,488,55,45,10,2,1
6,492,492,10,7,3,2,1

6,104,104,1,1,0,1,0
1,127,127,3,3,0,1,0
11,147,147,11,11,0,1,0
10,166,166,10,10,0,1,0
28,178,178,28,1,27,2,1
22,179,179,22,12,10,3,2
18,183,183,28,10,18,2,1
29,190,190,30,4,26,3,2
7,190,190,21,21,0,1,0
23,192,192,25,25,0,1,0
34,196,196,63,43,20,2,1
36,200,200,2,2,0,1,0
5,205,205,17,12,5,2,1
37,205,205,23,14,9,2,1
26,216,216,22,22,0,1,0
20,239,239,5,5,0,1,0
38,239,239,16,16,0,1,0
19,247,247,25,25,0,1,0
0,294,294,40,40,0,1,0
13,299,299,16,16,0,1,0
8,307,307,13,1,12,3,2
32,338,338,25,20,5,2,1
25,346,346,50,9,41,4,3
33,356,356,38,38,0,1,0
40,362,362,1,1,0,1,0
4,371,371,12,12,0,1,0
12,389,389,1,1,0,1,0
31,410,410,7,4,3,2,1
9,414,414,27,27,0,1,0
16,425,425,44,8,36,3,2
15,438,438,61,61,0,1,0
17,451,451,105,79,26,2,1
30,458,458,10,4,6,3,2
2,465,465,37,10,27,2,1
27,468,468,48,48,0,1,0
21,478,478,1,1,0,1,0
14,479,479,5,5,0,1,0
39,487,487,22,22,0,1,0
24,489,489,66,66,0,1,0
3,499,499,72,42,30,3,2
35,499,499,60,40,20,3,2

16,102,102,6,1,5,2,1
27,109,109,9,2,7,2,1
30,136,136,16,16,0,1,0
29,139,139,32,32,0,1,0
2,152,152,20,20,0,1,0
7,156,156,8,8,0,1,0
22,159,159,12,12,0,1,0
45,175,175,2,2,0,1,0
1,184,184,4,4,0,1,0
40,197,197,46,31,15,2,1
37,202,202,13,10,3,2,1
0,202,202,19,3,16,3,2
18,207,207,13,13,0,1,0
38,207,207,7,7,0,1,0
10,212,212,33,33,0,1,0
4,212,212,3,3,0,1,0
17,213,213,16,16,0,1,0
21,222,222,3,3,0,1,0
24,223,223,1,1,0,1,0
32,224,224,5,1,4,2,1
41,232,232,31,1,30,3,2
11,233,233,10,10,0,1,0
8,239,239,2,2,0,1,0
39,242,242,37,37,0,1,0
20,267,267,11,6,5,2,1
5,272,272,1,1,0,1,0
6,272,272,28,17,11,2,1
36,278,278,56,56,0,1,0
35,283,283,16,16,0,1,0
19,287,287,13,13,0,1,0
25,310,310,7,7,0,1,0
13,313,313,28,17,11,2,1
14,330,330,28,15,13,2,1
46,335,335,43,20,23,2,1
9,357,357,46,5,41,2,1
15,369,369,30,30,0,1,0
12,374,374,41,25,16,2,1
3,427,427,3,3,0,1,0
44,429,429,46,46,0,1,0
42,443,443,11,6,5,2,1
23,449,449,9,9,0,1,0
31,451,451,13,6,7,3,2
43,451,451,26,9,17,2,1
33,454,454,88,72,16,2,1
26,459,459,40,40,0,1,0
28,473,473,40,11,29,2,1
34,497,497,20,5,15,2,1

20,102,102,4,4,0,1,0
27,113,113,2,2,0,1,0
18,120,120,31,31,0,1,0
5,133,133,1,1,0,1,0
29,156,156,30,12,18,4,3
11,188,188,1,1,0,1,0
23,193,193,81,30,51,4,3
7,197,197,26,26,0,1,0
22,203,203,30,10,20,3,2
1,207,207,1,1,0,1,0
9,217,217,44,1,43,2,1
10,222,222,31,31,0,1,0
15,222,222,25,25,0,1,0
6,232,232,1,1,0,1,0
0,265,265,41,41,0,1,0
13,265,265,5,5,0,1,0
28,270,270,2,2,0,1,0
17,275,275,68,68,0,1,0
12,313,313,24,11,13,2,1
19,374,374,11,11,0,1,0
26,409,409,8,8,0,1,0
14,451,451,17,5,12,2,1
3,452,452,5,5,0,1,0
8,453,453,278,239,39,4,3
2,453,453,21,21,0,1,0
24,459,459,16,16,0,1,0
25,459,459,55,55,0,1,0
4,471,471,226,100,126,4,3
21,483,483,3,3,0,1,0
16,489,489,25,25,0,1,0

10,109,109,4,4,0,1,0
14,127,127,19,19,0,1,0
26,148,148,2,2,0,1,0
12,150,150,82,82,0,1,0
17,154,154,4,4,0,1,0
27,162,162,26,26,0,1,0
7,204,204,52,10,42,2,1
13,213,213,8,8,0,1,0
5,236,236,1,1,0,1,0
28,258,258,26,26,0,1,0
18,259,259,12,12,0,1,0
16,282,282,61,27,34,4,3
30,296,296,32,16,16,3,2
2,317,317,22,22,0,1,0
21,342,342,38,26,12,3,2
1,373,373,29,29,0,1,0
0,373,373,20,20,0,1,0
9,378,378,51,36,15,4,3
23,382,382,10,10,0,1,0
6,385,385,2,2,0,1,0
3,395,395,30,13,17,2,1
11,407,407,76,12,64,3,2
15,414,414,67,67,0,1,0
20,420,420,87,67,20,3,2
8,426,426,5,5,0,1,0
22,427,427,30,9,21,2,1
4,440,440,71,5,66,4,3
29,448,448,47,47,0,1,0
32,450,450,103,103,0,1,0
19,466,466,33,23,10,2,1
25,472,472,20,20,0,1,0
24,480,480,44,11,33,2,1
31,490,490,20,20,0,1,0

37,100,100,10,10,0,1,0
9,117,117,14,14,0,1,0
23,117,117,9,9,0,1,0
33,120,120,6,6,0,1,0
8,123,123,9,5,4,2,1
5,128,128,1,1,0,1,0
24,135,135,49,49,0,1,0
4,164,164,8,8,0,1,0
19,170,170,9,9,0,1,0
35,172,172,16,3,13,2,1
6,202,202,18,6,12,2,1
22,203,203,13,13,0,1,0
0,215,215,2,2,0,1,0
32,224,224,60,60,0,1,0
41,236,236,3,3,0,1,0
2,237,237,5,5,0,1,0
10,242,242,48,6,42,2,1
17,251,251,58,58,0,1,0
36,252,252,3,3,0,1,0
26,254,254,32,8,24,4,3
20,259,259,22,1,21,4,3
25,272,272,18,18,0,1,0
21,294,294,21,15,6,3,2
7,301,301,61,25,36,2,1
18,325,325,2,2,0,1,0
30,334,334,2,2,0,1,0
13,343,343,18,3,15,2,1
16,348,348,4,1,3,2,1
15,348,348,4,4,0,1,0
28,355,355,41,4,37,4,3
11,355,355,61,19,42,3,2
40,356,356,6,6,0,1,0
39,363,363,5,5,0,1,0
27,385,385,146,116,30,4,3
34,389,389,4,4,0,1,0
31,394,394,11,11,0,1,0
14,411,411,25,11,14,3,2
29,450,450,74,27,47,2,1
38,450,450,9,1,8,2,1
3,484,484,50,50,0,1,0
12,492,492,9,9,0,1,0
1,494,494,9,5,4,2,1

2,100,100,13,5,8,3,2
40,101,101,6,6,0,1,0
0,112,112,3,3,0,1,0
18,115,115,10,10,0,1,0
3,123,123,19,16,3,2,1
15,129,129,4,4,0,1,0
29,134,134,30,30,0,1,0
35,149,149,5,5,0,1,0
31,150,150,11,5,6,2,1
13,165,165,19,10,9,2,1
10,187,187,9,9,0,1,0
19,195,195,5,2,3,2,1
25,219,219,19,1,18,4,3
8,222,222,4,1,3,2,1
1,238,238,23,17,6,2,1
30,245,245,14,5,9,4,3
17,248,248,13,2,11,2,1
20,265,265,23,16,7,2,1
16,277,277,1,1,0,1,0
9,285,285,41,41,0,1,0
6,295,295,49,40,9,4,3
11,299,299,30,15,15,4,3
39,300,300,39,6,33,4,3
36,305,305,76,76,0,1,0
33,326,326,27,4,23,2,1
23,335,335,17,1,16,3,2
28,337,337,41,32,9,4,3
5,344,344,30,30,0,1,0
14,363,363,16,16,0,1,0
27,367,367,17,14,3,2,1
34,386,386,101,80,21,4,3
38,404,404,8,8,0,1,0
32,420,420,43,43,0,1,0
24,422,422,5,2,3,2,1
12,429,429,13,1,12,3,2
7,445,445,75,75,0,1,0
21,446,446,42,42,0,1,0
26,451,451,20,20,0,1,0
37,454,454,79,79,0,1,0
22,459,459,8,8,0,1,0
4,496,496,36,36,0,1,0

29,103,103,2,2,0,1,0
14,105,105,20,20,0,1,0
3,123,123,12,9,3,2,1
11,125,125,11,1,10,3,2
18,131,131,32,24,8,3,2
16,134,134,7,7,0,1,0
19,149,149,3,3,0,1,0
27,217,217,7,3,4,2,1
32,242,242,5,2,3,2,1
0,261,261,49,49,0,1,0
25,279,279,28,5,23,3,2
33,285,285,59,43,16,2,1
13,287,287,8,8,0,1,0
9,291,291,47,23,24,4,3
30,291,291,23,13,10,3,2
4,300,300,6,2,4,2,1
15,300,300,27,27,0,1,0
34,304,304,26,4,22,3,2
8,308,308,9,9,0,1,0
1,315,315,1,1,0,1,0
20,317,317,19,19,0,1,0
35,320,320,17,17,0,1,0
24,323,323,35,11,24,4,3
12,367,367,5,5,0,1,0
36,369,369,173,91,82,4,3
7,384,384,2,2,0,1,0
21,399,399,38,3,35,2,1
26,418,418,48,1,47,4,3
10,425,425,6,3,3,2,1
37,428,428,55,16,39,2,1
6,444,444,13,13,0,1,0
28,451,451,23,23,0,1,0
2,452,452,12,12,0,1,0
17,481,481,143,143,0,1,0
31,485,485,91,19,72,4,3
22,487,487,3,3,0,1,0
23,488,488,5,1,4,2,1
5,495,495,102,102,0,1,0

16,140,140,5,5,0,1,0
13,141,141,22,2,20,2,1
27,183,183,5,5,0,1,0
7,184,184,4,4,0,1,0
2,187,187,34,22,12,2,1
10,189,189,24,20,4,2,1
24,200,200,41,30,11,2,1
6,230,230,3,3,0,1,0
4,236,236,81,13,68,4,3
17,264,264,42,42,0,1,0
23,294,294,11,11,0,1,0
5,296,296,4,4,0,1,0
14,296,296,7,1,6,2,1
26,309,309,47,3,44,4,3
9,311,311,25,4,21,4,3
3,314,314,104,62,42,2,1
21,327,327,19,19,0,1,0
29,332,332,41,14,27,4,3
30,335,335,41,14,27,2,1
8,338,338,12,12,0,1,0
31,339,339,162,30,132,4,3
33,341,341,17,5,12,2,1
28,343,343,4,1,3,2,1
18,364,364,53,53,0,1,0
0,366,366,5,5,0,1,0
15,384,384,29,5,24,2,1
1,404,404,49,12,37,2,1
12,408,408,64,48,16,3,2
19,422,422,41,14,27,2,1
32,426,426,15,15,0,1,0
11,427,427,46,15,31,2,1
20,434,434,22,11,11,2,1
22,459,459,3,3,0,1,0
25,490,490,19,19,0,1,0

8,107,107,9,9,0,1,0
13,110,110,18,18,0,1,0
2,112,112,1,1,0,1,0
30,139,139,5,2,3,2,1
9,145,145,9,3,6,2,1
36,154,154,12,3,9,4,3
21,166,166,26,3,23,2,1
33,193,193,22,16,6,2,1
19,212,212,1,1,0,1,0
17,219,219,1,1,0,1,0
12,226,226,20,20,0,1,0
3,227,227,58,44,14,3,2
5,230,230,11,1,10,2,1
6,230,230,6,2,4,2,1
32,232,232,106,106,0,1,0
11,242,242,36,27,9,4,3
4,249,249,5,5,0,1,0
20,255,255,24,12,12,3,2
26,271,271,54,54,0,1,0
25,277,277,23,23,0,1,0
35,291,291,6,1,5,2,1
7,306,306,23,23,0,1,0
0,307,307,15,12,3,2,1
37,340,340,16,16,0,1,0
14,348,348,19,19,0,1,0
38,361,361,39,13,26,2,1
27,364,364,1,1,0,1,0
28,375,375,25,16,9,2,1
15,385,385,50,44,6,2,1
18,413,413,5,5,0,1,0
10,435,435,25,25,0,1,0
1,437,437,4,4,0,1,0
23,441,441,4,4,0,1,0
24,448,448,18,8,10,2,1
40,465,465,118,93,25,2,1
34,468,468,42,42,0,1,0
29,481,481,26,26,0,1,0
31,482,482,9,2,7,2,1
39,486,486,72,48,24,4,3
16,490,490,70,19,51,4,3
22,495,495,52,52,0,1,0

21,106,106,24,24,0,1,0
17,115,115,16,16,0,1,0
12,132,132,26,10,16,2,1
31,136,136,6,2,4,2,1
13,137,137,5,5,0,1,0
8,145,145,74,19,55,4,3
7,155,155,1,1,0,1,0
6,165,165,2,2,0,1,0
15,170,170,8,8,0,1,0
20,175,175,4,4,0,1,0
1,176,176,1,1,0,1,0
29,210,210,1,1,0,1,0
27,221,221,6,6,0,1,0
22,223,223,2,2,0,1,0
0,226,226,16,16,0,1,0
28,230,230,32,32,0,1,0
18,233,233,46,46,0,1,0
24,251,251,9,9,0,1,0
9,269,269,71,25,46,4,3
19,292,292,45,12,33,2,1
26,300,300,19,7,12,4,3
10,319,319,26,3,23,2,1
14,324,324,39,28,11,2,1
34,333,333,5,1,4,2,1
4,434,434,26,8,18,3,2
3,435,435,28,28,0,1,0
11,441,441,53,53,0,1,0
33,442,442,137,84,53,4,3
2,457,457,23,23,0,1,0
16,459,459,1,1,0,1,0
23,467,467,89,41,48,3,2
32,472,472,70,58,12,3,2
30,477,477,15,10,5,2,1
25,495,495,38,22,16,3,2
5,496,496,76,34,42,3,2

0,107,107,1,1,0,1,0
37,111,111,14,6,8,2,1
30,124,124,9,5,4,2,1
27,140,140,3,3,0,1,0
11,145,145,3,3,0,1,0
2,150,150,8,8,0,1,0
34,154,154,7,7,0,1,0
33,155,155,6,6,0,1,0
25,169,169,4,4,0,1,0
9,170,170,20,10,10,2,1
5,175,175,2,2,0,1,0
12,179,179,77,55,22,3,2
23,193,193,45,24,21,4,3
7,195,195,21,21,0,1,0
14,201,201,18,18,0,1,0
1,208,208,3,3,0,1,0
6,210,210,4,1,3,2,1
24,212,212,16,4,12,4,3
17,242,242,2,2,0,1,0
39,262,262,39,12,27,4,3
13,264,264,1,1,0,1,0
31,271,271,5,1,4,2,1
10,280,280,2,2,0,1,0
32,285,285,92,42,50,2,1
28,288,288,84,84,0,1,0
41,307,307,62,33,29,2,1
18,309,309,1,1,0,1,0
36,334,334,52,46,6,3,2
8,343,343,4,4,0,1,0
22,357,357,13,3,10,2,1
21,361,361,24,24,0,1,0
26,362,362,9,9,0,1,0
15,389,389,59,29,30,2,1
38,391,391,10,7,3,2,1
42,403,403,35,35,0,1,0
40,412,412,2,2,0,1,0
43,425,425,4,4,0,1,0
3,426,426,2,2,0,1,0
16,428,428,44,44,0,1,0
19,439,439,11,6,5,2,1
4,443,443,53,8,45,4,3
20,456,456,25,6,19,3,2
35,461,461,106,10,96,4,3
29,495,495,6,6,0,1,0

30,110,110,14,1,13,2,1
6,125,125,1,1,0,1,0
29,131,131,16,16,0,1,0
4,135,135,1,1,0,1,0
3,155,155,39,39,0,1,0
28,184,184,3,3,0,1,0
33,198,198,7,1,6,2,1
26,200,200,41,11,30,4,3
32,204,204,2,2,0,1,0
12,210,210,15,2,13,2,1
19,213,213,87,65,22,3,2
13,215,215,15,15,0,1,0
22,218,218,16,4,12,2,1
1,240,240,6,6,0,1,0
27,245,245,7,7,0,1,0
21,248,248,46,18,28,2,1
15,254,254,4,4,0,1,0
7,267,267,11,11,0,1,0
2,288,288,64,64,0,1,0
16,317,317,12,12,0,1,0
14,318,318,76,20,56,4,3
9,318,318,70,14,56,3,2
31,324,324,2,2,0,1,0
17,324,324,29,17,12,4,3
0,333,333,32,10,22,2,1
11,337,337,43,25,18,4,3
24,353,353,19,4,15,2,1
8,365,365,14,2,12,4,3
10,382,382,49,39,10,3,2
20,404,404,83,62,21,4,3
34,469,469,77,3,74,4,3
25,472,472,6,3,3,2,1
5,492,492,99,75,24,2,1
18,496,496,16,2,14,2,1
23,497,497,30,30,0,1,0

20,120,120,2,2,0,1,0
29,144,144,34,3,31,4,3
10,157,157,26,9,17,2,1
38,159,159,16,3,13,2,1
28,163,163,34,34,0,1,0
19,169,169,5,1,4,2,1
14,179,179,2,2,0,1,0
25,191,191,18,12,6,2,1
24,206,206,23,23,0,1,0
8,231,231,26,26,0,1,0
33,233,233,5,5,0,1,0
36,240,240,1,1,0,1,0
6,249,249,8,3,5,2,1
26,271,271,10,10,0,1,0
39,272,272,27,27,0,1,0
22,278,278,57,5,52,3,2
2,290,290,55,55,0,1,0
11,326,326,40,40,0,1,0
5,328,328,9,9,0,1,0
27,337,337,49,36,13,2,1
4,347,347,9,4,5,2,1
31,348,348,34,9,25,2,1
15,353,353,2,2,0,1,0
0,367,367,23,18,5,2,1
1,368,368,19,19,0,1,0
18,395,395,19,19,0,1,0
32,405,405,102,26,76,3,2
12,418,418,59,19,40,3,2
21,419,419,8,8,0,1,0
3,420,420,95,95,0,1,0
34,426,426,18,18,0,1,0
30,426,426,22,22,0,1,0
17,441,441,47,38,9,4,3
13,443,443,17,17,0,1,0
7,449,449,19,19,0,1,0
16,460,460,25,11,14,4,3
37,463,463,20,20,0,1,0
35,477,477,14,2,12,4,3
23,477,477,117,57,60,3,2
9,478,478,32,32,0,1,0
40,481,481,9,1,8,3,2

29,107,107,7,1,6,3,2
25,115,115,19,3,16,3,2
14,135,135,10,10,0,1,0
7,145,145,20,6,14,2,1
1,149,149,29,5,24,4,3
0,178,178,10,4,6,2,1
22,199,199,39,39,0,1,0
19,201,201,1,1,0,1,0
9,217,217,7,7,0,1,0
13,223,223,22,22,0,1,0
3,238,238,18,18,0,1,0
4,268,268,26,26,0,1,0
6,277,277,49,49,0,1,0
20,283,283,23,23,0,1,0
17,295,295,4,4,0,1,0
16,296,296,1,1,0,1,0
26,298,298,110,68,42,3,2
2,306,306,24,24,0,1,0
23,307,307,49,49,0,1,0
11,322,322,88,38,50,2,1
27,367,367,11,11,0,1,0
24,395,395,101,3,98,3,2
28,413,413,9,9,0,1,0
10,413,413,169,166,3,2,1
15,415,415,30,30,0,1,0
12,425,425,30,27,3,2,1
5,455,455,10,3,7,2,1
21,458,458,32,32,0,1,0
8,465,465,116,116,0,1,0
18,500,500,39,39,0,1,0

22,104,104,4,1,3,2,1
27,111,111,11,5,6,2,1
16,125,125,2,2,0,1,0
13,144,144,18,18,0,1,0
18,146,146,19,10,9,4,3
21,156,156,12,8,4,2,1
26,176,176,1,1,0,1,0
31,183,183,8,1,7,2,1
35,191,191,27,27,0,1,0
19,193,193,26,26,0,1,0
10,199,199,3,3,0,1,0
4,200,200,14,7,7,2,1
24,231,231,31,31,0,1,0
8,242,242,87,55,32,2,1
6,246,246,60,60,0,1,0
2,247,247,1,1,0,1,0
29,297,297,13,13,0,1,0
30,304,304,79,23,56,3,2
3,307,307,23,15,8,2,1
32,307,307,2,2,0,1,0
28,319,319,24,3,21,3,2
33,327,327,4,4,0,1,0
7,341,341,4,4,0,1,0
17,374,374,2,2,0,1,0
14,385,385,40,40,0,1,0
0,427,427,23,15,8,3,2
34,435,435,93,41,52,3,2
9,446,446,32,32,0,1,0
25,459,459,32,32,0,1,0
20,460,460,79,40,39,4,3
12,464,464,3,3,0,1,0
5,465,465,8,8,0,1,0
23,468,468,91,27,64,3,2
11,478,478,19,19,0,1,0
15,480,480,57,57,0,1,0
1,488,488,226,187,39,4,3

7,115,115,8,8,0,1,0
19,116,116,9,1,8,2,1
13,128,128,27,27,0,1,0
3,148,148,9,5,4,2,1
18,160,160,5,5,0,1,0
2,212,212,19,1,18,4,3
5,231,231,20,1,19,2,1
23,244,244,27,2,25,2,1
10,245,245,33,13,20,2,1
30,248,248,3,3,0,1,0
20,260,260,46,19,27,4,3
29,263,263,1,1,0,1,0
14,271,271,4,4,0,1,0
16,272,272,11,11,0,1,0
6,276,276,14,4,10,2,1
24,285,285,49,10,39,4,3
22,300,300,24,13,11,2,1
25,310,310,80,24,56,3,2
15,333,333,14,14,0,1,0
11,334,334,59,59,0,1,0
31,363,363,29,29,0,1,0
4,367,367,29,29,0,1,0
17,370,370,2,2,0,1,0
34,371,371,16,16,0,1,0
26,396,396,40,28,12,4,3
9,418,418,129,57,72,3,2
33,421,421,93,15,78,4,3
8,432,432,71,26,45,2,1
32,436,436,89,11,78,3,2
28,454,454,5,5,0,1,0
12,457,457,29,5,24,2,1
1,485,485,57,57,0,1,0
27,487,487,82,53,29,2,1
0,493,493,46,46,0,1,0
21,494,494,37,27,10,2,1

25,102,102,2,2,0,1,0
19,120,120,9,9,0,1,0
23,124,124,24,24,0,1,0
14,125,125,4,4,0,1,0
1,135,135,9,9,0,1,0
6,137,137,4,4,0,1,0
20,140,140,25,25,0,1,0
10,141,141,2,2,0,1,0
28,145,145,4,4,0,1,0
5,151,151,40,40,0,1,0
0,153,153,1,1,0,1,0
35,160,160,6,1,5,2,1
30,168,168,25,25,0,1,0
8,174,174,1,1,0,1,0
24,181,181,2,2,0,1,0
9,193,193,17,17,0,1,0
26,196,196,4,4,0,1,0
31,204,204,43,15,28,2,1
16,249,249,6,6,0,1,0
37,249,249,58,13,45,2,1
7,258,258,60,29,31,2,1
21,271,271,8,2,6,2,1
3,288,288,14,3,11,2,1
4,292,292,83,83,0,1,0
11,294,294,11,11,0,1,0
13,325,325,53,1,52,3,2
17,331,331,7,2,5,2,1
15,334,334,6,1,5,2,1
29,356,356,26,26,0,1,0
36,400,400,159,110,49,4,3
12,407,407,5,5,0,1,0
22,428,428,6,1,5,2,1
33,438,438,72,72,0,1,0
34,457,457,1,1,0,1,0
27,460,460,6,2,4,2,1
18,471,471,127,83,44,2,1
2,478,478,54,54,0,1,0
32,481,481,34,2,32,4,3

40,104,104,2,2,0,1,0
15,107,107,15,3,12,3,2
25,110,110,27,27,0,1,0
7,120,120,1,1,0,1,0
43,121,121,2,2,0,1,0
14,136,136,25,13,12,4,3
19,140,140,11,1,10,2,1
27,153,153,5,5,0,1,0
26,162,162,1,1,0,1,0
21,165,165,1,1,0,1,0
44,172,172,21,6,15,2,1
3,197,197,10,7,3,2,1
31,199,199,19,6,13,2,1
16,200,200,1,1,0,1,0
29,217,217,21,10,11,2,1
10,219,219,9,9,0,1,0
17,221,221,16,16,0,1,0
1,226,226,3,3,0,1,0
33,233,233,15,10,5,2,1
11,242,242,13,3,10,3,2
36,245,245,100,29,71,3,2
35,261,261,39,39,0,1,0
39,263,263,25,25,0,1,0
34,270,270,11,3,8,3,2
28,272,272,13,1,12,2,1
20,275,275,5,5,0,1,0
24,275,275,1,1,0,1,0
9,291,291,7,7,0,1,0
0,314,314,37,21,16,3,2
30,328,328,23,13,10,2,1
32,344,344,50,24,26,2,1
13,346,346,12,5,7,2,1
2,351,351,45,45,0,1,0
4,353,353,1,1,0,1,0
23,370,370,1,1,0,1,0
37,371,371,9,9,0,1,0
38,385,385,68,29,39,2,1
8,393,393,19,19,0,1,0
6,394,394,51,10,41,4,3
5,399,399,38,8,30,3,2
18,455,455,101,14,87,3,2
12,465,465,26,5,21,4,3
41,489,489,69,69,0,1,0
42,493,493,47,47,0,1,0
22,495,495,9,9,0,1,0

33,126,126,29,29,0,1,0
43,127,127,15,15,0,1,0
12,132,132,14,14,0,1,0
44,139,139,11,11,0,1,0
31,146,146,7,2,5,2,1
35,148,148,4,4,0,1,0
27,150,150,6,2,4,2,1
32,160,160,17,2,15,2,1
37,165,165,9,9,0,1,0
0,183,183,33,23,10,3,2
18,185,185,11,2,9,4,3
8,187,187,4,4,0,1,0
2,202,202,18,18,0,1,0
24,214,214,21,21,0,1,0
34,214,214,46,46,0,1,0
5,215,215,2,2,0,1,0
9,218,218,10,3,7,2,1
36,231,231,2,2,0,1,0
42,234,234,82,19,63,4,3
28,249,249,3,3,0,1,0
40,268,268,42,42,0,1,0
3,287,287,14,5,9,4,3
45,288,288,5,5,0,1,0
1,309,309,8,8,0,1,0
25,311,311,12,1,11,2,1
21,312,312,2,2,0,1,0
29,318,318,68,68,0,1,0
6,324,324,31,31,0,1,0
7,344,344,32,32,0,1,0
13,393,393,2,2,0,1,0
14,397,397,53,14,39,4,3
22,415,415,61,61,0,1,0
10,420,420,83,83,0,1,0
15,424,424,5,5,0,1,0
23,426,426,1,1,0,1,0
38,429,429,4,4,0,1,0
39,431,431,49,18,31,2,1
17,438,438,33,33,0,1,0
4,446,446,39,16,23,2,1
19,448,448,40,40,0,1,0
20,464,464,11,11,0,1,0
11,483,483,4,1,3,2,1
30,488,488,29,11,18,3,2
26,489,489,31,31,0,1,0
16,490,490,1,1,0,1,0
41,499,499,12,2,10,2,1

35,108,108,6,6,0,1,0
5,124,124,16,9,7,2,1
33,134,134,13,1,12,2,1
0,138,138,2,2,0,1,0
9,138,138,5,5,0,1,0
20,166,166,3,3,0,1,0
6,169,169,87,87,0,1,0
32,192,192,3,3,0,1,0
28,203,203,2,2,0,1,0
17,215,215,14,14,0,1,0
19,220,220,38,4,34,3,2
12,225,225,28,10,18,3,2
1,232,232,3,3,0,1,0
7,254,254,16,8,8,3,2
21,257,257,4,4,0,1,0
24,268,268,6,2,4,2,1
31,280,280,98,22,76,3,2
2,294,294,8,8,0,1,0
14,313,313,8,2,6,3,2
13,318,318,42,42,0,1,0
34,321,321,52,6,46,2,1
30,364,364,9,5,4,2,1
22,389,389,83,46,37,2,1
25,390,390,2,2,0,1,0
16,390,390,18,18,0,1,0
23,398,398,96,62,34,3,2
26,402,402,27,9,18,2,1
15,448,448,30,30,0,1,0
29,455,455,8,8,0,1,0
18,456,456,115,13,102,4,3
10,463,463,58,40,18,4,3
4,472,472,121,39,82,3,2
8,474,474,14,3,11,2,1
27,476,476,44,12,32,2,1
11,480,480,36,25,11,2,1
3,499,499,30,8,22,2,1

6,101,101,11,11,0,1,0
9,109,109,4,4,0,1,0
25,128,128,21,21,0,1,0
34,135,135,36,36,0,1,0
18,156,156,65,48,17,2,1
5,157,157,1,1,0,1,0
28,170,170,13,3,10,3,2
24,187,187,15,15,0,1,0
17,189,189,20,20,0,1,0
35,196,196,17,17,0,1,0
13,196,196,22,22,0,1,0
20,212,212,2,2,0,1,0
29,213,213,2,2,0,1,0
23,222,222,37,37,0,1,0
15,227,227,1,1,0,1,0
12,253,253,10,5,5,2,1
0,263,263,26,7,19,2,1
2,288,288,8,2,6,3,2
33,294,294,4,4,0,1,0
3,309,309,26,26,0,1,0
19,325,325,35,5,30,3,2
14,332,332,3,3,0,1,0
21,339,339,59,59,0,1,0
32,346,346,9,9,0,1,0
27,361,361,70,46,24,3,2
10,366,366,35,35,0,1,0
8,379,379,90,78,12,4,3
31,403,403,22,22,0,1,0
11,410,410,42,7,35,2,1
30,414,414,3,3,0,1,0
1,420,420,22,18,4,2,1
4,447,447,94,73,21,4,3
36,461,461,46,46,0,1,0
7,464,464,25,25,0,1,0
16,475,475,1,1,0,1,0
26,485,485,58,10,48,3,2
22,498,498,90,90,0,1,0

36,115,115,4,4,0,1,0
29,123,123,2,2,0,1,0
8,136,136,1,1,0,1,0
13,155,155,20,20,0,1,0
26,171,171,9,9,0,1,0
7,180,180,84,60,24,3,2
4,193,193,19,7,12,4,3
18,194,194,57,27,30,2,1
19,202,202,11,11,0,1,0
15,211,211,82,52,30,4,3
0,212,212,4,4,0,1,0
20,216,216,2,2,0,1,0
5,274,274,14,14,0,1,0
3,290,290,10,10,0,1,0
22,290,290,7,2,5,2,1
37,302,302,7,4,3,2,1
23,305,305,100,34,66,3,2
25,321,321,9,9,0,1,0
34,321,321,4,1,3,2,1
28,327,327,3,3,0,1,0
33,356,356,13,13,0,1,0
6,373,373,7,7,0,1,0
12,377,377,1,1,0,1,0
31,384,384,21,21,0,1,0
10,387,387,13,13,0,1,0
32,388,388,12,5,7,2,1
21,388,388,91,9,82,3,2
14,389,389,7,3,4,2,1
11,426,426,3,3,0,1,0
16,429,429,22,22,0,1,0
30,430,430,36,36,0,1,0
9,437,437,6,6,0,1,0
35,455,455,162,38,124,4,3
27,463,463,85,19,66,3,2
17,467,467,6,6,0,1,0
38,480,480,28,28,0,1,0
1,485,485,44,44,0,1,0
2,493,493,1,1,0,1,0
24,499,499,132,114,18,3,2

32,106,106,1,1,0,1,0
8,107,107,1,1,0,1,0
20,120,120,23,2,21,2,1
9,124,124,32,32,0,1,0
16,134,134,7,1,6,2,1
21,150,150,8,3,5,2,1
4,181,181,4,4,0,1,0
14,194,194,11,5,6,3,2
1,213,213,58,58,0,1,0
13,213,213,19,19,0,1,0
3,224,224,15,3,12,2,1
33,259,259,12,6,6,3,2
23,267,267,57,57,0,1,0
6,268,268,19,6,13,2,1
26,283,283,47,33,14,2,1
25,306,306,19,2,17,2,1
5,324,324,66,48,18,2,1
10,336,336,97,97,0,1,0
22,339,339,1,1,0,1,0
28,347,347,15,5,10,2,1
30,373,373,15,7,8,2,1
15,390,390,4,4,0,1,0
0,429,429,57,57,0,1,0
29,435,435,28,28,0,1,0
18,444,444,25,25,0,1,0
19,450,450,27,23,4,2,1
24,452,452,30,30,0,1,0
12,455,455,31,31,0,1,0
7,474,474,4,1,3,2,1
17,479,479,116,48,68,4,3
31,480,480,176,176,0,1,0
11,481,481,89,62,27,2,1
2,487,487,29,29,0,1,0
27,492,492,48,15,33,2,1

24,126,126,3,3,0,1,0
26,137,137,5,2,3,2,1
27,140,140,39,25,14,2,1
16,147,147,76,34,42,4,3
30,166,166,2,2,0,1,0
2,187,187,14,4,10,2,1
35,201,201,20,13,7,2,1
25,225,225,6,6,0,1,0
23,227,227,42,42,0,1,0
11,233,233,16,16,0,1,0
31,241,241,6,6,0,1,0
14,248,248,18,14,4,2,1
10,255,255,14,14,0,1,0
12,263,263,3,3,0,1,0
13,272,272,8,8,0,1,0
5,299,299,23,2,21,3,2
18,304,304,20,20,0,1,0
29,305,305,59,59,0,1,0
22,327,327,83,33,50,3,2
17,330,330,1,1,0,1,0
32,341,341,23,23,0,1,0
6,341,341,58,28,30,4,3
8,345,345,49,24,25,2,1
1,345,345,20,8,12,3,2
33,364,364,9,1,8,3,2
15,382,382,86,86,0,1,0
21,386,386,8,8,0,1,0
7,400,400,27,12,15,4,3
4,422,422,14,14,0,1,0
28,424,424,78,12,66,4,3
9,428,428,14,14,0,1,0
19,434,434,33,33,0,1,0
3,434,434,29,29,0,1,0
0,446,446,44,5,39,2,1
34,478,478,117,27,90,4,3
20,484,484,12,12,0,1,0

2,109,109,25,25,0,1,0
35,137,137,36,36,0,1,0
25,138,138,2,2,0,1,0
36,138,138,10,10,0,1,0
29,159,159,2,2,0,1,0
30,168,168,6,6,0,1,0
0,169,169,1,1,0,1,0
11,180,180,1,1,0,1,0
31,180,180,5,5,0,1,0
6,185,185,7,2,5,2,1
20,191,191,24,24,0,1,0
27,204,204,27,27,0,1,0
3,206,206,1,1,0,1,0
5,226,226,9,9,0,1,0
21,266,266,6,2,4,2,1
9,276,276,48,48,0,1,0
8,281,281,68,68,0,1,0
22,299,299,51,1,50,2,1
19,302,302,53,53,0,1,0
17,315,315,11,11,0,1,0
10,318,318,1,1,0,1,0
18,325,325,16,16,0,1,0
23,350,350,54,24,30,2,1
14,354,354,1,1,0,1,0
34,354,354,61,61,0,1,0
16,363,363,40,40,0,1,0
33,378,378,14,14,0,1,0
12,394,394,9,3,6,2,1
24,408,408,89,20,69,4,3
26,409,409,26,4,22,3,2
15,435,435,39,39,0,1,0
1,449,449,20,20,0,1,0
32,457,457,13,5,8,2,1
7,467,467,120,112,8,2,1
4,468,468,80,80,0,1,0
28,482,482,52,52,0,1,0
13,494,494,137,118,19,2,1

34,109,109,4,4,0,1,0
18,116,116,13,3,10,2,1
21,117,117,1,1,0,1,0
36,146,146,28,23,5,2,1
1,158,158,23,23,0,1,0
33,158,158,23,8,15,2,1
29,161,161,7,2,5,2,1
27,168,168,46,46,0,1,0
24,205,205,12,6,6,2,1
20,207,207,8,1,7,2,1
31,212,212,2,2,0,1,0
13,219,219,18,15,3,2,1
9,223,223,5,5,0,1,0
11,229,229,1,1,0,1,0
39,244,244,25,1,24,4,3
26,245,245,36,12,24,3,2
22,246,246,19,19,0,1,0
35,251,251,2,2,0,1,0
8,269,269,10,6,4,2,1
10,273,273,41,41,0,1,0
7,298,298,4,4,0,1,0
0,308,308,6,6,0,1,0
19,313,313,32,22,10,3,2
38,321,321,29,29,0,1,0
30,322,322,35,16,19,4,3
4,322,322,8,8,0,1,0
2,350,350,38,9,29,4,3
15,351,351,1,1,0,1,0
40,366,366,25,10,15,2,1
28,368,368,18,3,15,2,1
5,369,369,74,74,0,1,0
32,386,386,23,17,6,2,1
42,387,387,49,1,48,3,2
16,393,393,40,12,28,3,2
37,412,412,38,38,0,1,0
12,422,422,98,79,19,2,1
17,422,422,52,47,5,2,1
3,444,444,26,14,12,4,3
25,445,445,49,42,7,2,1
41,471,471,87,87,0,1,0
6,480,480,19,19,0,1,0
23,489,489,15,15,0,1,0
14,498,498,3,3,0,1,0

8,100,100,17,3,14,3,2
23,102,102,19,19,0,1,0
1,109,109,15,8,7,2,1
11,109,109,4,1,3,2,1
33,119,119,6,6,0,1,0
18,125,125,14,14,0,1,0
22,131,131,9,9,0,1,0
6,154,154,40,40,0,1,0
12,175,175,25,25,0,1,0
10,181,181,1,1,0,1,0
24,183,183,29,29,0,1,0
7,187,187,15,15,0,1,0
32,187,187,23,2,21,2,1
21,187,187,53,34,19,4,3
5,189,189,27,2,25,2,1
19,193,193,31,31,0,1,0
3,206,206,2,2,0,1,0
9,242,242,18,9,9,4,3
30,254,254,6,6,0,1,0
26,270,270,4,4,0,1,0
14,280,280,9,4,5,2,1
16,280,280,29,29,0,1,0
27,327,327,11,1,10,3,2
0,345,345,99,70,29,2,1
25,355,355,77,9,68,3,2
31,365,365,51,24,27,3,2
20,368,368,4,4,0,1,0
17,381,381,13,13,0,1,0
4,407,407,1,1,0,1,0
28,436,436,6,6,0,1,0
2,457,457,37,17,20,3,2
29,461,461,52,52,0,1,0
15,462,462,9,9,0,1,0
13,473,473,151,151,0,1,0

35,107,107,1,1,0,1,0
34,110,110,1,1,0,1,0
13,114,114,28,1,27,3,2
31,119,119,20,12,8,3,2
20,125,125,9,4,5,2,1
12,131,131,5,2,3,2,1
26,141,141,36,36,0,1,0
37,147,147,17,17,0,1,0
32,158,158,6,6,0,1,0
2,161,161,2,2,0,1,0
17,177,177,28,13,15,2,1
21,177,177,17,17,0,1,0
10,178,178,37,23,14,2,1
25,180,180,2,2,0,1,0
28,198,198,38,38,0,1,0
40,216,216,3,3,0,1,0
30,224,224,69,15,54,4,3
19,250,250,8,4,4,2,1
43,258,258,56,56,0,1,0
29,262,262,1,1,0,1,0
14,264,264,45,45,0,1,0
11,269,269,20,8,12,2,1
22,272,272,24,3,21,4,3
6,281,281,1,1,0,1,0
33,297,297,3,3,0,1,0
5,302,302,20,3,17,2,1
18,316,316,4,4,0,1,0
16,341,341,11,5,6,2,1
15,347,347,2,2,0,1,0
7,368,368,65,24,41,2,1
8,377,377,7,7,0,1,0
41,381,381,2,2,0,1,0
36,403,403,63,29,34,2,1
24,406,406,24,24,0,1,0
42,412,412,60,60,0,1,0
1,413,413,43,43,0,1,0
0,438,438,3,3,0,1,0
39,440,440,35,35,0,1,0
23,449,449,5,2,3,2,1
4,456,456,6,6,0,1,0
38,465,465,25,25,0,1,0
3,466,466,21,12,9,2,1
27,470,470,28,22,6,2,1
9,500,500,21,12,9,2,1

27,110,110,23,23,0,1,0
23,115,115,20,20,0,1,0
8,136,136,39,9,30,4,3
24,140,140,7,7,0,1,0
3,166,166,4,4,0,1,0
25,166,166,15,2,13,2,1
7,199,199,52,6,46,3,2
22,199,199,14,14,0,1,0
9,200,200,24,24,0,1,0
29,214,214,3,3,0,1,0
33,222,222,53,46,7,2,1
26,224,224,39,9,30,3,2
2,224,224,32,32,0,1,0
1,225,225,10,6,4,2,1
16,227,227,12,12,0,1,0
32,231,231,40,22,18,3,2
0,252,252,16,12,4,2,1
15,261,261,12,12,0,1,0
28,267,267,2,2,0,1,0
21,283,283,33,15,18,4,3
34,305,305,15,15,0,1,0
6,313,313,56,56,0,1,0
18,334,334,31,31,0,1,0
31,363,363,19,13,6,3,2
4,363,363,12,2,10,3,2
12,380,380,22,5,17,3,2
5,401,401,5,5,0,1,0
30,407,407,11,6,5,2,1
10,414,414,53,5,48,4,3
35,418,418,64,25,39,2,1
36,427,427,54,17,37,4,3
20,438,438,44,44,0,1,0
14,480,480,30,30,0,1,0
19,488,488,7,4,3,2,1
13,493,493,48,38,10,3,2
17,499,499,4,4,0,1,0
11,499,499,44,3,41,2,1

6,115,115,7,7,0,1,0
31,128,128,3,3,0,1,0
14,130,130,1,1,0,1,0
19,144,144,4,4,0,1,0
34,150,150,30,30,0,1,0
29,150,150,49,49,0,1,0
22,153,153,9,9,0,1,0
10,159,159,25,18,7,2,1
3,177,177,8,8,0,1,0
26,188,188,12,1,11,2,1
21,202,202,26,26,0,1,0
32,208,208,12,2,10,3,2
4,279,279,42,16,26,2,1
8,282,282,19,19,0,1,0
16,287,287,11,6,5,2,1
15,297,297,1,1,0,1,0
12,299,299,47,33,14,2,1
18,314,314,20,20,0,1,0
13,315,315,5,5,0,1,0
28,317,317,90,68,22,2,1
35,320,320,3,3,0,1,0
30,331,331,7,7,0,1,0
24,340,340,19,19,0,1,0
23,361,361,4,4,0,1,0
20,377,377,61,61,0,1,0
33,384,384,15,15,0,1,0
25,388,388,7,7,0,1,0
9,396,396,96,69,27,4,3
1,405,405,17,8,9,2,1
7,412,412,113,81,32,2,1
0,418,418,45,45,0,1,0
17,429,429,140,122,18,2,1
27,443,443,129,81,48,3,2
2,455,455,1,1,0,1,0
5,489,489,29,4,25,2,1
11,494,494,21,6,15,4,3

7,141,141,5,5,0,1,0
9,149,149,14,1,13,2,1
3,151,151,14,6,8,2,1
20,155,155,7,7,0,1,0
18,165,165,3,3,0,1,0
15,182,182,20,20,0,1,0
0,190,190,33,33,0,1,0
4,248,248,5,2,3,2,1
30,249,249,78,8,70,3,2
27,254,254,71,71,0,1,0
2,260,260,112,74,38,2,1
17,272,272,11,11,0,1,0
21,281,281,16,16,0,1,0
8,284,284,2,2,0,1,0
31,298,298,4,4,0,1,0
12,307,307,79,40,39,4,3
10,309,309,78,78,0,1,0
13,312,312,63,63,0,1,0
29,322,322,10,10,0,1,0
32,332,332,12,12,0,1,0
1,337,337,21,21,0,1,0
23,345,345,61,6,55,3,2
11,359,359,8,5,3,2,1
24,361,361,34,16,18,3,2
26,375,375,6,6,0,1,0
5,381,381,19,7,12,3,2
14,417,417,30,30,0,1,0
28,445,445,121,75,46,3,2
25,449,449,45,45,0,1,0
22,454,454,40,40,0,1,0
19,456,456,47,9,38,3,2
6,458,458,13,13,0,1,0
16,474,474,15,15,0,1,0

26,104,104,2,2,0,1,0
24,111,111,2,2,0,1,0
25,116,116,8,3,5,2,1
31,144,144,4,4,0,1,0
3,150,150,2,2,0,1,0
14,155,155,31,31,0,1,0
28,172,172,10,4,6,2,1
17,179,179,7,7,0,1,0
33,192,192,39,39,0,1,0
30,230,230,25,25,0,1,0
22,258,258,33,19,14,3,2
2,272,272,34,8,26,2,1
15,273,273,95,57,38,2,1
20,291,291,22,22,0,1,0
1,292,292,38,2,36,4,3
19,296,296,10,10,0,1,0
13,312,312,18,18,0,1,0
11,317,317,33,26,7,2,1
7,318,318,8,8,0,1,0
16,333,333,9,9,0,1,0
23,340,340,39,4,35,4,3
34,347,347,14,14,0,1,0
18,350,350,26,26,0,1,0
6,370,370,37,12,25,2,1
29,377,377,66,66,0,1,0
27,393,393,62,41,21,2,1
12,401,401,73,73,0,1,0
9,412,412,13,9,4,2,1
35,440,440,62,20,42,4,3
32,443,443,39,28,11,2,1
5,448,448,1,1,0,1,0
36,466,466,103,57,46,2,1
4,473,473,121,94,27,4,3
8,477,477,13,4,9,4,3
0,480,480,13,5,8,3,2
10,489,489,16,6,10,3,2
21,494,494,83,50,33,2,1

32,115,115,3,3,0,1,0
12,121,121,12,12,0,1,0
22,127,127,2,2,0,1,0
14,150,150,10,10,0,1,0
31,160,160,54,15,39,4,3
16,166,166,47,47,0,1,0
28,172,172,7,7,0,1,0
9,183,183,18,18,0,1,0
29,188,188,4,4,0,1,0
35,189,189,33,33,0,1,0
27,215,215,11,11,0,1,0
19,226,226,4,4,0,1,0
38,227,227,5,2,3,2,1
11,236,236,17,3,14,3,2
20,243,243,39,29,10,3,2
41,246,246,27,27,0,1,0
25,251,251,20,10,10,3,2
42,253,253,23,23,0,1,0
18,263,263,10,10,0,1,0
34,267,267,22,8,14,3,2
8,278,278,24,6,18,3,2
0,280,280,11,11,0,1,0
13,286,286,15,15,0,1,0
4,290,290,31,4,27,4,3
10,296,296,16,16,0,1,0
6,303,303,6,6,0,1,0
37,325,325,26,26,0,1,0
30,339,339,17,17,0,1,0
26,342,342,52,26,26,3,2
15,390,390,11,8,3,2,1
5,396,396,49,33,16,3,2
17,396,396,12,12,0,1,0
21,406,406,39,39,0,1,0
24,409,409,5,2,3,2,1
40,411,411,42,13,29,2,1
23,427,427,41,41,0,1,0
33,441,441,127,127,0,1,0
7,448,448,27,3,24,4,3
2,451,451,12,12,0,1,0
36,458,458,58,58,0,1,0
3,467,467,38,2,36,2,1
1,468,468,17,13,4,2,1
39,470,470,2,2,0,1,0

33,111,111,17,17,0,1,0
16,124,124,9,2,7,2,1
34,129,129,5,5,0,1,0
13,141,141,16,2,14,3,2
20,157,157,9,3,6,3,2
22,177,177,21,21,0,1,0
14,179,179,19,19,0,1,0
6,180,180,40,10,30,2,1
27,195,195,66,37,29,2,1
4,215,215,21,7,14,3,2
18,228,228,11,11,0,1,0
12,232,232,17,17,0,1,0
1,240,240,28,12,16,2,1
32,243,243,17,17,0,1,0
8,280,280,80,80,0,1,0
21,285,285,13,13,0,1,0
10,286,286,9,3,6,3,2
7,295,295,47,47,0,1,0
17,301,301,10,10,0,1,0
0,305,305,11,11,0,1,0
28,327,327,8,4,4,2,1
30,331,331,65,65,0,1,0
35,349,349,5,2,3,2,1
15,351,351,6,2,4,2,1
29,352,352,29,29,0,1,0
11,356,356,4,4,0,1,0
25,380,380,23,23,0,1,0
36,386,386,6,6,0,1,0
9,388,388,1,1,0,1,0
19,394,394,50,50,0,1,0
5,418,418,7,1,6,3,2
23,434,434,27,27,0,1,0
24,447,447,132,99,33,2,1
2,447,447,71,41,30,4,3
26,491,491,61,61,0,1,0
31,494,494,6,6,0,1,0
3,496,496,100,64,36,4,3

6,108,108,1,1,0,1,0
31,115,115,20,20,0,1,0
10,130,130,32,28,4,2,1
17,147,147,21,14,7,3,2
33,152,152,18,2,16,3,2
12,168,168,7,1,6,3,2
5,176,176,41,41,0,1,0
14,185,185,3,3,0,1,0
18,188,188,2,2,0,1,0
28,193,193,4,4,0,1,0
20,229,229,4,1,3,2,1
32,278,278,6,6,0,1,0
29,281,281,49,49,0,1,0
19,283,283,33,33,0,1,0
23,295,295,55,55,0,1,0
22,308,308,2,2,0,1,0
16,312,312,52,23,29,4,3
21,324,324,27,27,0,1,0
11,325,325,58,26,32,3,2
27,328,328,21,2,19,2,1
9,329,329,99,99,0,1,0
3,349,349,34,34,0,1,0
7,356,356,1,1,0,1,0
8,362,362,129,95,34,3,2
4,363,363,17,17,0,1,0
25,365,365,53,53,0,1,0
24,376,376,31,6,25,2,1
0,397,397,9,9,0,1,0
1,412,412,31,25,6,3,2
26,432,432,100,80,20,2,1
2,432,432,23,3,20,2,1
30,453,453,39,39,0,1,0
15,474,474,47,4,43,3,2
13,493,493,11,11,0,1,0

15,112,112,2,2,0,1,0
27,114,114,2,2,0,1,0
36,134,134,28,28,0,1,0
32,140,140,19,19,0,1,0
40,142,142,1,1,0,1,0
4,144,144,3,3,0,1,0
18,149,149,4,4,0,1,0
22,153,153,18,18,0,1,0
26,160,160,7,7,0,1,0
24,163,163,1,1,0,1,0
23,205,205,36,18,18,4,3
6,239,239,23,23,0,1,0
13,241,241,22,22,0,1,0
17,241,241,1,1,0,1,0
20,260,260,2,2,0,1,0
5,262,262,67,57,10,2,1
41,267,267,42,28,14,2,1
2,274,274,7,3,4,2,1
11,274,274,5,5,0,1,0
28,276,276,81,70,11,2,1
29,299,299,44,38,6,2,1
1,303,303,13,13,0,1,0
16,307,307,21,21,0,1,0
3,314,314,12,12,0,1,0
8,320,320,16,16,0,1,0
21,352,352,27,17,10,2,1
30,356,356,100,100,0,1,0
19,360,360,7,2,5,2,1
12,363,363,65,65,0,1,0
31,375,375,1,1,0,1,0
7,386,386,57,57,0,1,0
0,393,393,1,1,0,1,0
39,395,395,35,35,0,1,0
14,424,424,32,32,0,1,0
38,426,426,4,4,0,1,0
35,432,432,67,9,58,3,2
25,436,436,25,1,24,2,1
37,469,469,61,61,0,1,0
10,472,472,3,3,0,1,0
34,478,478,8,1,7,2,1
33,482,482,40,40,0,1,0
9,484,484,115,19,96,4,3

25,109,109,4,4,0,1,0
34,117,117,3,3,0,1,0
9,119,119,6,6,0,1,0
35,127,127,2,2,0,1,0
20,132,132,9,9,0,1,0
31,135,135,17,17,0,1,0
8,140,140,20,2,18,2,1
2,140,140,1,1,0,1,0
4,141,141,2,2,0,1,0
13,141,141,16,6,10,3,2
40,145,145,19,4,15,2,1
18,178,178,75,53,22,2,1
36,178,178,14,5,9,4,3
32,178,178,38,9,29,2,1
28,181,181,39,39,0,1,0
21,194,194,10,10,0,1,0
7,199,199,36,5,31,2,1
10,218,218,5,2,3,2,1
24,222,222,19,4,15,3,2
15,241,241,3,3,0,1,0
14,250,250,45,18,27,4,3
39,250,250,12,8,4,2,1
1,272,272,4,1,3,2,1
41,277,277,17,17,0,1,0
16,285,285,9,9,0,1,0
6,308,308,12,12,0,1,0
22,319,319,24,24,0,1,0
33,354,354,4,1,3,2,1
30,355,355,119,48,71,4,3
26,359,359,32,32,0,1,0
3,366,366,9,9,0,1,0
11,407,407,49,49,0,1,0
23,424,424,16,10,6,2,1
38,429,429,57,44,13,2,1
37,431,431,44,44,0,1,0
29,441,441,51,51,0,1,0
27,448,448,10,10,0,1,0
0,451,451,29,29,0,1,0
5,468,468,10,10,0,1,0
19,475,475,19,12,7,2,1
12,493,493,13,13,0,1,0
17,499,499,20,11,9,2,1

14,114,114,3,3,0,1,0
21,114,114,25,8,17,2,1
15,115,115,4,4,0,1,0
12,121,121,34,34,0,1,0
22,128,128,3,3,0,1,0
10,156,156,61,61,0,1,0
9,162,162,18,7,11,2,1
18,165,165,2,2,0,1,0
0,189,189,23,14,9,2,1
20,205,205,23,1,22,2,1
19,231,231,30,30,0,1,0
5,238,238,12,4,8,2,1
28,263,263,95,20,75,4,3
1,265,265,13,4,9,2,1
23,266,266,18,8,10,3,2
24,333,333,1,1,0,1,0
31,358,358,73,73,0,1,0
33,362,362,3,3,0,1,0
8,390,390,35,35,0,1,0
25,403,403,20,20,0,1,0
16,440,440,6,6,0,1,0
13,442,442,62,5,57,4,3
17,445,445,6,6,0,1,0
11,445,445,124,92,32,2,1
7,447,447,14,14,0,1,0
2,448,448,51,51,0,1,0
29,460,460,112,26,86,3,2
3,465,465,9,4,5,2,1
30,473,473,15,9,6,2,1
4,475,475,25,25,0,1,0
27,480,480,94,4,90,3,2
6,483,483,6,6,0,1,0
32,493,493,5,5,0,1,0
26,496,496,66,66,0,1,0

25,101,101,3,3,0,1,0
31,102,102,4,4,0,1,0
7,119,119,4,4,0,1,0
0,119,119,7,1,6,2,1
21,120,120,25,1,24,3,2
8,130,130,12,4,8,2,1
33,140,140,5,5,0,1,0
26,146,146,25,4,21,3,2
15,150,150,33,6,27,4,3
11,152,152,6,6,0,1,0
12,156,156,11,4,7,2,1
17,170,170,5,2,3,2,1
14,188,188,21,1,20,2,1
1,189,189,22,22,0,1,0
10,198,198,34,16,18,3,2
3,200,200,1,1,0,1,0
16,201,201,4,4,0,1,0
13,222,222,17,13,4,2,1
18,227,227,24,24,0,1,0
19,233,233,46,46,0,1,0
29,260,260,65,18,47,4,3
22,266,266,25,25,0,1,0
4,278,278,20,11,9,4,3
28,285,285,24,14,10,2,1
9,304,304,1,1,0,1,0
34,322,322,10,10,0,1,0
27,335,335,27,21,6,2,1
35,347,347,63,55,8,2,1
36,353,353,13,1,12,3,2
23,358,358,85,85,0,1,0
6,380,380,18,18,0,1,0
32,409,409,27,3,24,3,2
38,420,420,76,43,33,4,3
20,435,435,17,7,10,3,2
37,442,442,24,16,8,2,1
30,443,443,3,3,0,1,0
24,454,454,23,13,10,3,2
2,481,481,63,52,11,2,1
5,495,495,79,22,57,4,3

13,103,103,28,28,0,1,0
8,107,107,4,4,0,1,0
17,135,135,10,4,6,2,1
2,136,136,54,48,6,3,2
24,138,138,2,2,0,1,0
23,147,147,47,37,10,3,2
1,148,148,15,15,0,1,0
29,174,174,9,9,0,1,0
7,177,177,6,1,5,2,1
4,179,179,8,8,0,1,0
31,193,193,19,12,7,2,1
6,199,199,16,16,0,1,0
22,211,211,52,52,0,1,0
30,214,214,25,8,17,2,1
34,217,217,3,3,0,1,0
28,219,219,3,3,0,1,0
11,240,240,8,8,0,1,0
5,249,249,18,18,0,1,0
36,264,264,37,37,0,1,0
33,288,288,23,23,0,1,0
26,289,289,23,23,0,1,0
12,292,292,72,72,0,1,0
0,304,304,1,1,0,1,0
19,305,305,81,49,32,3,2
27,332,332,10,10,0,1,0
21,392,392,84,84,0,1,0
14,397,397,49,49,0,1,0
18,404,404,34,34,0,1,0
20,405,405,12,12,0,1,0
9,413,413,17,1,16,2,1
35,437,437,25,16,9,4,3
25,463,463,5,5,0,1,0
10,472,472,14,14,0,1,0
32,474,474,20,8,12,2,1
3,486,486,18,18,0,1,0
16,493,493,39,39,0,1,0
15,496,496,5,5,0,1,0

19,103,103,1,1,0,1,0
25,107,107,18,2,16,4,3
4,109,109,2,2,0,1,0
36,115,115,6,6,0,1,0
17,120,120,15,3,12,3,2
24,133,133,5,5,0,1,0
18,141,141,14,10,4,2,1
12,141,141,19,19,0,1,0
27,145,145,60,41,19,2,1
7,166,166,5,5,0,1,0
2,186,186,1,1,0,1,0
9,204,204,16,13,3,2,1
21,210,210,19,19,0,1,0
23,211,211,5,5,0,1,0
31,245,245,9,9,0,1,0
32,259,259,41,3,38,4,3
11,275,275,40,40,0,1,0
14,278,278,19,7,12,4,3
8,304,304,23,5,18,4,3
3,332,332,3,3,0,1,0
22,340,340,8,3,5,2,1
33,341,341,26,26,0,1,0
0,354,354,42,14,28,2,1
13,354,354,82,82,0,1,0
29,357,357,118,79,39,2,1
35,363,363,21,21,0,1,0
26,388,388,22,22,0,1,0
15,393,393,19,19,0,1,0
30,397,397,68,68,0,1,0
16,401,401,47,47,0,1,0
20,409,409,26,26,0,1,0
37,413,413,11,11,0,1,0
5,441,441,41,41,0,1,0
1,454,454,56,56,0,1,0
10,481,481,70,1,69,4,3
6,491,491,63,18,45,2,1
34,492,492,6,2,4,2,1
28,500,500,20,20,0,1,0

28,103,103,12,12,0,1,0
29,111,111,27,27,0,1,0
7,112,112,6,2,4,2,1
3,116,116,23,23,0,1,0
24,123,123,6,6,0,1,0
6,128,128,9,3,6,3,2
35,129,129,7,7,0,1,0
22,139,139,6,6,0,1,0
26,140,140,3,3,0,1,0
31,146,146,27,23,4,2,1
17,172,172,6,6,0,1,0
10,176,176,3,3,0,1,0
19,185,185,14,14,0,1,0
11,202,202,5,1,4,2,1
20,205,205,2,2,0,1,0
27,212,212,3,3,0,1,0
30,240,240,9,9,0,1,0
33,248,248,2,2,0,1,0
36,258,258,95,95,0,1,0
34,267,267,22,22,0,1,0
37,282,282,16,5,11,3,2
1,282,282,21,17,4,2,1
2,291,291,16,16,0,1,0
9,301,301,23,9,14,3,2
5,301,301,31,11,20,3,2
14,302,302,1,1,0,1,0
8,302,302,22,4,18,2,1
43,329,329,5,5,0,1,0
18,352,352,24,11,13,2,1
41,385,385,14,8,6,3,2
13,386,386,8,8,0,1,0
0,401,401,46,34,12,4,3
25,406,406,14,5,9,4,3
15,414,414,6,6,0,1,0
38,419,419,20,1,19,2,1
4,431,431,21,21,0,1,0
23,436,436,43,43,0,1,0
21,447,447,20,14,6,2,1
12,450,450,62,26,36,4,3
39,452,452,129,129,0,1,0
32,465,465,47,41,6,2,1
42,486,486,60,60,0,1,0
16,498,498,128,119,9,4,3
40,500,500,21,21,0,1,0

6,103,103,3,3,0,1,0
17,118,118,9,9,0,1,0
7,127,127,1,1,0,1,0
27,131,131,1,1,0,1,0
9,148,148,34,10,24,4,3
31,155,155,12,1,11,4,3
19,158,158,18,2,16,2,1
4,173,173,34,1,33,4,3
25,179,179,38,38,0,1,0
15,200,200,53,31,22,2,1
14,207,207,4,4,0,1,0
8,208,208,2,2,0,1,0
23,208,208,12,9,3,2,1
0,220,220,20,16,4,2,1
29,222,222,74,74,0,1,0
12,233,233,40,18,22,2,1
1,236,236,15,6,9,4,3
34,276,276,2,2,0,1,0
24,287,287,26,16,10,3,2
30,308,308,6,2,4,2,1
11,321,321,27,1,26,3,2
22,333,333,61,14,47,2,1
3,334,334,35,35,0,1,0
28,357,357,40,40,0,1,0
18,364,364,15,15,0,1,0
13,366,366,56,6,50,3,2
32,367,367,28,28,0,1,0
26,371,371,133,92,41,2,1
21,401,401,38,28,10,2,1
35,441,441,6,6,0,1,0
33,445,445,8,8,0,1,0
20,453,453,7,4,3,2,1
2,458,458,41,41,0,1,0
5,474,474,10,10,0,1,0
10,478,478,63,9,54,4,3
16,498,498,30,30,0,1,0

18,116,116,10,10,0,1,0
17,132,132,1,1,0,1,0
22,140,140,2,2,0,1,0
13,144,144,12,5,7,2,1
36,146,146,24,24,0,1,0
24,189,189,21,21,0,1,0
28,198,198,8,8,0,1,0
20,200,200,32,24,8,2,1
0,217,217,20,20,0,1,0
19,219,219,8,8,0,1,0
32,230,230,28,10,18,3,2
5,250,250,1,1,0,1,0
2,260,260,37,37,0,1,0
35,267,267,25,14,11,2,1
4,268,268,9,5,4,2,1
11,279,279,12,12,0,1,0
27,283,283,8,8,0,1,0
23,284,284,47,3,44,2,1
7,289,289,101,101,0,1,0
15,307,307,31,31,0,1,0
6,313,313,62,30,32,3,2
1,320,320,8,2,6,3,2
25,337,337,25,13,12,4,3
14,342,342,3,3,0,1,0
10,360,360,18,18,0,1,0
9,375,375,2,2,0,1,0
3,378,378,92,92,0,1,0
8,382,382,86,56,30,2,1
31,400,400,24,24,0,1,0
16,409,409,9,9,0,1,0
21,426,426,24,24,0,1,0
29,443,443,33,3,30,2,1
34,453,453,68,8,60,4,3
33,454,454,5,1,4,2,1
30,466,466,190,132,58,4,3
26,481,481,31,10,21,4,3
12,488,488,39,39,0,1,0

30,100,100,5,5,0,1,0
16,102,102,3,3,0,1,0
19,108,108,7,7,0,1,0
20,108,108,4,4,0,1,0
10,120,120,1,1,0,1,0
18,124,124,2,2,0,1,0
38,140,140,1,1,0,1,0
34,152,152,43,28,15,2,1
11,153,153,1,1,0,1,0
15,166,166,9,2,7,2,1
24,176,176,5,5,0,1,0
39,183,183,46,46,0,1,0
25,206,206,20,7,13,2,1
5,209,209,8,8,0,1,0
9,240,240,1,1,0,1,0
37,243,243,14,14,0,1,0
1,243,243,22,22,0,1,0
23,253,253,37,25,12,3,2
14,256,256,22,22,0,1,0
26,257,257,10,1,9,4,3
6,265,265,28,12,16,2,1
33,269,269,1,1,0,1,0
31,281,281,26,26,0,1,0
0,293,293,36,28,8,3,2
28,303,303,27,6,21,4,3
21,310,310,9,4,5,2,1
29,312,312,75,75,0,1,0
2,322,322,40,18,22,3,2
35,323,323,1,1,0,1,0
32,327,327,2,2,0,1,0
27,328,328,75,51,24,3,2
17,338,338,10,2,8,2,1
12,375,375,110,8,102,4,3
3,382,382,75,75,0,1,0
4,406,406,32,32,0,1,0
7,407,407,18,2,16,2,1
13,435,435,46,7,39,4,3
22,441,441,61,9,52,3,2
8,471,471,112,56,56,3,2
36,492,492,38,14,24,4,3

34,133,133,4,4,0,1,0
5,138,138,10,1,9,4,3
30,150,150,35,35,0,1,0
14,157,157,7,3,4,2,1
10,162,162,10,7,3,2,1
31,172,172,6,6,0,1,0
6,184,184,28,28,0,1,0
33,190,190,15,9,6,2,1
18,205,205,12,2,10,3,2
17,230,230,3,3,0,1,0
19,251,251,18,4,14,3,2
16,275,275,14,4,10,3,2
29,316,316,39,39,0,1,0
32,317,317,1,1,0,1,0
4,327,327,1,1,0,1,0
7,332,332,74,11,63,3,2
2,379,379,13,13,0,1,0
24,383,383,118,43,75,4,3
22,386,386,13,5,8,3,2
28,388,388,22,22,0,1,0
20,389,389,8,8,0,1,0
27,389,389,69,69,0,1,0
3,393,393,9,9,0,1,0
15,412,412,48,48,0,1,0
12,424,424,81,41,40,2,1
9,424,424,68,61,7,2,1
21,435,435,76,38,38,4,3
25,456,456,118,118,0,1,0
23,477,477,3,3,0,1,0
0,478,478,31,31,0,1,0
26,485,485,77,77,0,1,0
11,489,489,281,227,54,4,3
8,495,495,3,3,0,1,0
1,496,496,10,7,3,2,1
13,498,498,1,1,0,1,0

35,102,102,1,1,0,1,0
31,111,111,21,21,0,1,0
32,113,113,21,21,0,1,0
33,119,119,3,3,0,1,0
36,136,136,4,4,0,1,0
20,160,160,44,44,0,1,0
22,166,166,5,5,0,1,0
38,170,170,7,7,0,1,0
1,182,182,15,5,10,3,2
4,184,184,5,2,3,2,1
3,189,189,17,17,0,1,0
37,197,197,6,1,5,2,1
26,201,201,9,9,0,1,0
17,207,207,20,20,0,1,0
12,212,212,1,1,0,1,0
30,226,226,4,4,0,1,0
11,241,241,6,1,5,2,1
9,251,251,2,2,0,1,0
23,262,262,30,30,0,1,0
5,264,264,63,33,30,3,2
24,267,267,96,96,0,1,0
14,274,274,31,31,0,1,0
39,299,299,30,20,10,3,2
13,314,314,24,15,9,4,3
0,324,324,63,22,41,2,1
15,337,337,31,31,0,1,0
29,340,340,3,3,0,1,0
18,352,352,7,7,0,1,0
34,355,355,74,74,0,1,0
6,367,367,13,13,0,1,0
21,381,381,68,68,0,1,0
2,387,387,8,3,5,2,1
8,422,422,4,4,0,1,0
40,424,424,65,65,0,1,0
27,430,430,18,18,0,1,0
28,434,434,72,46,26,3,2
7,436,436,14,8,6,3,2
16,444,444,40,40,0,1,0
19,461,461,13,13,0,1,0
10,480,480,18,18,0,1,0
25,497,497,63,41,22,3,2

8,100,100,11,11,0,1,0
31,104,104,2,2,0,1,0
3,106,106,1,1,0,1,0
5,111,111,14,14,0,1,0
24,113,113,12,8,4,2,1
7,115,115,1,1,0,1,0
32,116,116,2,2,0,1,0
14,124,124,18,18,0,1,0
9,135,135,27,6,21,4,3
26,138,138,31,24,7,2,1
0,156,156,37,37,0,1,0
27,165,165,18,10,8,3,2
15,181,181,9,9,0,1,0
17,183,183,10,10,0,1,0
30,190,190,24,14,10,3,2
34,199,199,1,1,0,1,0
20,201,201,15,15,0,1,0
29,208,208,30,30,0,1,0
16,213,213,3,3,0,1,0
1,217,217,20,20,0,1,0
33,246,246,23,1,22,2,1
28,261,261,40,1,39,2,1
4,273,273,62,62,0,1,0
23,293,293,32,17,15,4,3
6,323,323,39,25,14,2,1
22,328,328,23,23,0,1,0
19,333,333,9,9,0,1,0
13,344,344,75,75,0,1,0
2,357,357,9,3,6,2,1
10,360,360,7,7,0,1,0
11,383,383,26,22,4,2,1
25,394,394,65,21,44,3,2
21,402,402,123,75,48,4,3
18,404,404,15,15,0,1,0
12,455,455,59,59,0,1,0

11,103,103,19,13,6,2,1
28,134,134,31,31,0,1,0
12,148,148,16,7,9,3,2
24,153,153,4,4,0,1,0
1,162,162,33,33,0,1,0
17,187,187,1,1,0,1,0
9,191,191,13,9,4,2,1
15,195,195,9,9,0,1,0
41,220,220,35,35,0,1,0
37,246,246,44,35,9,2,1
34,250,250,63,63,0,1,0
23,253,253,9,9,0,1,0
29,271,271,21,9,12,3,2
6,273,273,40,40,0,1,0
5,274,274,3,3,0,1,0
31,277,277,11,11,0,1,0
33,278,278,5,1,4,2,1
22,280,280,1,1,0,1,0
13,284,284,3,3,0,1,0
19,287,287,1,1,0,1,0
8,293,293,6,6,0,1,0
14,294,294,33,18,15,2,1
25,310,310,2,2,0,1,0
20,319,319,23,1,22,2,1
30,322,322,57,57,0,1,0
3,332,332,41,17,24,3,2
2,337,337,10,10,0,1,0
40,338,338,13,13,0,1,0
39,343,343,1,1,0,1,0
32,346,346,22,22,0,1,0
27,359,359,29,14,15,4,3
42,371,371,53,4,49,4,3
0,380,380,31,12,19,2,1
7,390,390,103,66,37,2,1
21,396,396,25,25,0,1,0
38,397,397,24,24,0,1,0
36,398,398,51,51,0,1,0
26,399,399,53,33,20,2,1
10,399,399,5,5,0,1,0
4,404,404,23,23,0,1,0
35,427,427,19,19,0,1,0
18,488,488,36,36,0,1,0
16,491,491,21,12,9,4,3

18,113,113,4,4,0,1,0
31,124,124,4,1,3,2,1
5,135,135,21,21,0,1,0
0,140,140,40,40,0,1,0
28,146,146,11,2,9,2,1
21,148,148,14,10,4,2,1
4,151,151,24,24,0,1,0
11,158,158,1,1,0,1,0
3,173,173,64,34,30,4,3
13,189,189,15,15,0,1,0
14,194,194,3,3,0,1,0
20,199,199,115,115,0,1,0
2,244,244,6,6,0,1,0
30,246,246,76,76,0,1,0
10,260,260,41,41,0,1,0
16,276,276,13,1,12,4,3
29,284,284,1,1,0,1,0
22,306,306,5,5,0,1,0
25,308,308,16,1,15,3,2
15,320,320,23,23,0,1,0
7,325,325,16,16,0,1,0
27,329,329,53,53,0,1,0
12,339,339,36,36,0,1,0
26,348,348,42,42,0,1,0
24,356,356,25,25,0,1,0
17,359,359,19,19,0,1,0
19,366,366,25,25,0,1,0
6,384,384,46,24,22,3,2
8,419,419,15,9,6,2,1
9,439,439,37,16,21,2,1
23,458,458,18,18,0,1,0
1,491,491,84,74,10,2,1

3,106,106,8,1,7,2,1
25,111,111,2,2,0,1,0
22,117,117,2,2,0,1,0
27,134,134,35,35,0,1,0
24,135,135,30,5,25,2,1
10,149,149,21,21,0,1,0
30,182,182,25,17,8,3,2
8,195,195,14,14,0,1,0
2,200,200,44,19,25,4,3
9,208,208,1,1,0,1,0
18,213,213,17,5,12,2,1
17,218,218,42,13,29,2,1
28,231,231,9,2,7,2,1
31,240,240,1,1,0,1,0
5,246,246,37,37,0,1,0
14,279,279,14,14,0,1,0
19,281,281,46,46,0,1,0
13,308,308,8,8,0,1,0
1,308,308,6,3,3,2,1
6,313,313,157,126,31,4,3
23,329,329,8,4,4,2,1
20,335,335,47,16,31,2,1
11,354,354,51,20,31,2,1
29,360,360,28,28,0,1,0
16,361,361,18,18,0,1,0
33,378,378,18,6,12,3,2
26,385,385,50,50,0,1,0
4,401,401,74,47,27,4,3
7,407,407,20,10,10,2,1
12,409,409,39,39,0,1,0
0,409,409,1,1,0,1,0
32,419,419,32,11,21,4,3
21,455,455,66,32,34,3,2
15,458,458,30,30,0,1,0

2,106,106,1,1,0,1,0
31,110,110,3,3,0,1,0
9,115,115,10,10,0,1,0
5,146,146,1,1,0,1,0
8,148,148,2,2,0,1,0
23,151,151,19,7,12,4,3
36,181,181,25,16,9,4,3
34,186,186,1,1,0,1,0
12,221,221,7,7,0,1,0
21,223,223,8,8,0,1,0
32,224,224,40,40,0,1,0
0,224,224,12,12,0,1,0
15,238,238,2,2,0,1,0
7,239,239,60,60,0,1,0
26,265,265,51,23,28,2,1
22,267,267,34,34,0,1,0
27,273,273,48,2,46,2,1
28,278,278,75,63,12,2,1
11,283,283,57,57,0,1,0
19,294,294,27,10,17,2,1
16,302,302,50,50,0,1,0
1,319,319,62,19,43,2,1
17,320,320,22,22,0,1,0
13,323,323,8,4,4,2,1
6,348,348,2,2,0,1,0
35,390,390,24,5,19,3,2
10,392,392,2,2,0,1,0
4,393,393,35,35,0,1,0
25,398,398,52,10,42,3,2
14,401,401,38,38,0,1,0
30,409,409,22,17,5,2,1
24,442,442,24,24,0,1,0
33,461,461,3,3,0,1,0
18,461,461,84,59,25,2,1
3,476,476,147,147,0,1,0
20,490,490,22,22,0,1,0
29,498,498,57,7,50,3,2

36,110,110,22,22,0,1,0
34,114,114,18,18,0,1,0
29,117,117,2,2,0,1,0
30,117,117,37,37,0,1,0
35,118,118,1,1,0,1,0
8,128,128,8,1,7,2,1
2,150,150,4,4,0,1,0
39,180,180,5,5,0,1,0
19,192,192,14,14,0,1,0
6,195,195,1,1,0,1,0
11,210,210,52,21,31,4,3
5,227,227,16,16,0,1,0
40,232,232,16,16,0,1,0
16,251,251,27,6,21,4,3
24,276,276,10,10,0,1,0
10,282,282,5,5,0,1,0
15,296,296,28,28,0,1,0
0,299,299,75,42,33,4,3
23,313,313,9,9,0,1,0
33,317,317,56,20,36,3,2
20,317,317,2,2,0,1,0
31,339,339,27,27,0,1,0
3,341,341,11,11,0,1,0
32,348,348,10,10,0,1,0
26,360,360,57,43,14,3,2
4,361,361,60,60,0,1,0
28,377,377,97,94,3,2,1
38,383,383,39,3,36,2,1
13,384,384,15,15,0,1,0
17,417,417,26,26,0,1,0
22,420,420,13,8,5,2,1
12,438,438,19,11,8,3,2
18,443,443,10,10,0,1,0
1,464,464,7,1,6,2,1
37,471,471,25,17,8,2,1
25,473,473,1,1,0,1,0
7,478,478,56,56,0,1,0
21,483,483,29,4,25,3,2
9,484,484,5,5,0,1,0
27,485,485,59,59,0,1,0
14,494,494,118,75,43,2,1

39,104,104,13,10,3,2,1
15,113,113,10,2,8,2,1
22,113,113,11,7,4,2,1
24,128,128,2,2,0,1,0
16,147,147,5,2,3,2,1
18,153,153,14,4,10,3,2
4,171,171,1,1,0,1,0
2,175,175,5,5,0,1,0
29,184,184,4,4,0,1,0
30,197,197,2,2,0,1,0
0,201,201,5,5,0,1,0
37,220,220,25,14,11,3,2
10,232,232,37,24,13,2,1
7,233,233,15,5,10,3,2
36,242,242,45,12,33,4,3
28,247,247,8,8,0,1,0
23,247,247,15,2,13,2,1
21,277,277,22,4,18,4,3
12,288,288,20,6,14,2,1
1,291,291,5,5,0,1,0
41,294,294,68,68,0,1,0
20,294,294,1,1,0,1,0
34,316,316,39,39,0,1,0
5,322,322,91,87,4,2,1
17,327,327,11,11,0,1,0
25,336,336,53,53,0,1,0
38,340,340,49,7,42,4,3
8,341,341,2,2,0,1,0
6,357,357,31,31,0,1,0
13,367,367,10,10,0,1,0
40,386,386,41,3,38,3,2
35,397,397,78,78,0,1,0
33,415,415,38,38,0,1,0
27,422,422,42,42,0,1,0
11,427,427,23,15,8,3,2
3,445,445,7,7,0,1,0
26,445,445,37,31,6,2,1
9,461,461,113,113,0,1,0
42,475,475,2,2,0,1,0
14,480,480,99,99,0,1,0
19,482,482,4,4,0,1,0
31,483,483,3,3,0,1,0
32,485,485,45,27,18,3,2

41,104,104,2,2,0,1,0
23,120,120,22,22,0,1,0
30,132,132,7,7,0,1,0
5,148,148,28,28,0,1,0
19,151,151,12,12,0,1,0
35,164,164,26,3,23,4,3
18,179,179,2,2,0,1,0
36,192,192,41,13,28,3,2
6,197,197,4,4,0,1,0
31,207,207,12,12,0,1,0
15,221,221,2,2,0,1,0
39,222,222,44,44,0,1,0
7,226,226,21,11,10,2,1
22,258,258,7,7,0,1,0
2,261,261,1,1,0,1,0
13,268,268,11,1,10,3,2
38,298,298,46,34,12,2,1
16,304,304,12,12,0,1,0
17,309,309,1,1,0,1,0
34,333,333,8,8,0,1,0
20,337,337,28,28,0,1,0
1,360,360,10,2,8,2,1
10,369,369,45,45,0,1,0
21,372,372,20,20,0,1,0
27,382,382,5,2,3,2,1
11,403,403,8,8,0,1,0
32,405,405,17,17,0,1,0
14,406,406,70,4,66,3,2
40,409,409,63,22,41,4,3
37,413,413,43,18,25,4,3
29,414,414,34,20,14,3,2
12,419,419,72,72,0,1,0
26,422,422,57,57,0,1,0
28,423,423,1,1,0,1,0
33,424,424,18,2,16,2,1
0,456,456,24,24,0,1,0
25,459,459,98,78,20,2,1
3,463,463,56,14,42,4,3
24,464,464,80,26,54,3,2
8,467,467,36,36,0,1,0
9,470,470,95,41,54,4,3
4,497,497,1,1,0,1,0

14,105,105,7,7,0,1,0
7,110,110,31,31,0,1,0
15,117,117,14,9,5,2,1
20,128,128,2,2,0,1,0
35,132,132,1,1,0,1,0
23,133,133,2,2,0,1,0
24,139,139,67,31,36,3,2
16,145,145,31,16,15,4,3
36,146,146,4,1,3,2,1
0,150,150,1,1,0,1,0
31,166,166,2,2,0,1,0
2,173,173,38,38,0,1,0
19,174,174,6,6,0,1,0
33,200,200,24,12,12,4,3
27,207,207,6,6,0,1,0
8,217,217,24,21,3,2,1
11,221,221,51,20,31,4,3
34,225,225,65,65,0,1,0
29,233,233,52,52,0,1,0
28,256,256,16,4,12,4,3
17,262,262,46,46,0,1,0
30,276,276,64,34,30,4,3
22,289,289,20,20,0,1,0
4,292,292,1,1,0,1,0
32,316,316,19,19,0,1,0
18,326,326,30,6,24,4,3
3,329,329,17,5,12,2,1
9,350,350,10,2,8,3,2
21,358,358,9,9,0,1,0
5,385,385,10,10,0,1,0
10,393,393,27,16,11,4,3
13,424,424,8,8,0,1,0
26,432,432,50,50,0,1,0
25,461,461,12,12,0,1,0
1,475,475,8,4,4,2,1
12,478,478,12,12,0,1,0
6,495,495,23,2,21,4,3

2,110,110,40,40,0,1,0
8,118,118,2,2,0,1,0
20,119,119,22,10,12,2,1
31,122,122,1,1,0,1,0
14,197,197,27,27,0,1,0
16,213,213,38,13,25,4,3
23,220,220,12,12,0,1,0
13,225,225,32,16,16,2,1
0,234,234,9,9,0,1,0
28,257,257,87,87,0,1,0
25,283,283,26,14,12,2,1
30,312,312,15,15,0,1,0
5,318,318,52,52,0,1,0
7,324,324,5,1,4,2,1
21,338,338,61,25,36,3,2
19,338,338,15,1,14,2,1
22,352,352,39,21,18,3,2
3,356,356,51,5,46,3,2
29,357,357,23,3,20,2,1
11,361,361,16,6,10,2,1
32,375,375,6,6,0,1,0
35,378,378,33,33,0,1,0
12,378,378,2,2,0,1,0
15,393,393,9,3,6,2,1
24,402,402,7,1,6,2,1
1,414,414,49,10,39,4,3
6,421,421,25,25,0,1,0
4,425,425,79,69,10,3,2
33,439,439,164,32,132,4,3
26,457,457,4,4,0,1,0
27,459,459,12,12,0,1,0
9,459,459,10,7,3,2,1
18,465,465,63,63,0,1,0
10,468,468,57,45,12,4,3
34,486,486,20,17,3,2,1
17,496,496,11,11,0,1,0

22,103,103,23,23,0,1,0
8,104,104,25,25,0,1,0
20,108,108,5,5,0,1,0
16,121,121,9,9,0,1,0
11,143,143,11,11,0,1,0
18,143,143,5,5,0,1,0
2,161,161,5,5,0,1,0
19,164,164,7,7,0,1,0
9,164,164,5,5,0,1,0
0,168,168,13,6,7,2,1
31,169,169,16,4,12,4,3
32,181,181,4,4,0,1,0
4,228,228,31,31,0,1,0
3,279,279,90,42,48,4,3
10,324,324,4,4,0,1,0
23,326,326,41,41,0,1,0
5,327,327,123,123,0,1,0
17,336,336,8,2,6,2,1
33,342,342,15,12,3,2,1
28,384,384,35,3,32,3,2
30,389,389,110,47,63,3,2
26,395,395,7,3,4,2,1
24,398,398,32,32,0,1,0
25,407,407,58,4,54,3,2
12,421,421,27,27,0,1,0
14,427,427,45,16,29,2,1
15,435,435,41,41,0,1,0
1,453,453,37,37,0,1,0
7,458,458,50,50,0,1,0
21,467,467,17,17,0,1,0
27,478,478,167,167,0,1,0
13,479,479,20,20,0,1,0
6,481,481,1,1,0,1,0
29,488,488,49,13,36,2,1

4,102,102,15,15,0,1,0
32,112,112,1,1,0,1,0
24,122,122,12,12,0,1,0
13,136,136,30,30,0,1,0
15,141,141,6,6,0,1,0
0,148,148,28,28,0,1,0
22,152,152,21,11,10,2,1
10,171,171,1,1,0,1,0
34,195,195,21,16,5,2,1
29,201,201,4,4,0,1,0
21,202,202,8,8,0,1,0
2,212,212,30,30,0,1,0
26,214,214,12,12,0,1,0
16,241,241,6,6,0,1,0
12,249,249,19,13,6,3,2
18,258,258,20,20,0,1,0
35,263,263,42,42,0,1,0
11,282,282,11,11,0,1,0
30,297,297,1,1,0,1,0
9,302,302,3,3,0,1,0
23,323,323,51,7,44,4,3
33,360,360,37,37,0,1,0
20,366,366,27,3,24,4,3
8,372,372,117,117,0,1,0
17,397,397,79,47,32,3,2
14,401,401,4,4,0,1,0
31,413,413,99,59,40,2,1
27,428,428,19,19,0,1,0
5,430,430,61,54,7,2,1
1,432,432,1,1,0,1,0
25,444,444,47,47,0,1,0
7,447,447,24,24,0,1,0
6,454,454,56,7,49,2,1
3,461,461,28,7,21,4,3
19,469,469,119,57,62,3,2
28,481,481,70,70,0,1,0

21,101,101,20,20,0,1,0
16,107,107,11,11,0,1,0
26,114,114,6,6,0,1,0
0,132,132,16,16,0,1,0
27,143,143,14,6,8,3,2
6,144,144,12,1,11,2,1
29,151,151,26,26,0,1,0
4,154,154,14,4,10,3,2
23,183,183,1,1,0,1,0
15,196,196,4,1,3,2,1
7,224,224,138,78,60,3,2
25,231,231,74,74,0,1,0
12,239,239,54,54,0,1,0
17,244,244,7,7,0,1,0
3,267,267,1,1,0,1,0
28,271,271,13,13,0,1,0
1,279,279,6,6,0,1,0
11,301,301,40,27,13,2,1
9,319,319,47,47,0,1,0
18,340,340,14,14,0,1,0
24,343,343,38,38,0,1,0
5,417,417,38,38,0,1,0
20,438,438,25,2,23,3,2
22,440,440,137,77,60,3,2
14,442,442,26,20,6,3,2
19,467,467,13,13,0,1,0
2,471,471,14,5,9,4,3
30,488,488,69,57,12,4,3
8,492,492,47,3,44,3,2
10,493,493,71,13,58,3,2
13,498,498,22,22,0,1,0

7,101,101,6,2,4,2,1
35,109,109,8,8,0,1,0
12,116,116,1,1,0,1,0
21,123,123,1,1,0,1,0
25,151,151,3,3,0,1,0
17,173,173,12,2,10,3,2
8,201,201,3,3,0,1,0
19,207,207,8,8,0,1,0
3,229,229,4,4,0,1,0
28,235,235,55,55,0,1,0
15,241,241,22,22,0,1,0
13,242,242,21,11,10,2,1
38,243,243,36,4,32,2,1
40,252,252,9,9,0,1,0
30,269,269,15,10,5,2,1
9,273,273,2,2,0,1,0
26,275,275,27,18,9,4,3
18,276,276,88,39,49,2,1
39,277,277,46,14,32,4,3
10,280,280,42,36,6,2,1
1,298,298,23,14,9,2,1
22,307,307,11,11,0,1,0
6,314,314,77,20,57,4,3
5,317,317,6,6,0,1,0
23,319,319,33,2,31,3,2
2,337,337,6,3,3,2,1
33,364,364,67,67,0,1,0
0,371,371,7,7,0,1,0
14,386,386,22,14,8,2,1
34,388,388,4,4,0,1,0
20,395,395,108,88,20,2,1
24,412,412,50,50,0,1,0
29,420,420,63,17,46,2,1
16,433,433,39,39,0,1,0
27,434,434,46,11,35,2,1
32,442,442,19,3,16,2,1
37,454,454,62,62,0,1,0
4,456,456,26,9,17,2,1
11,471,471,18,6,12,2,1
36,474,474,30,2,28,4,3
31,491,491,44,44,0,1,0

12,111,111,2,2,0,1,0
30,118,118,12,12,0,1,0
22,127,127,1,1,0,1,0
17,130,130,25,1,24,3,2
38,132,132,44,44,0,1,0
5,134,134,9,9,0,1,0
16,135,135,33,9,24,4,3
33,152,152,54,14,40,2,1
11,166,166,1,1,0,1,0
37,180,180,3,3,0,1,0
23,183,183,17,17,0,1,0
4,232,232,19,9,10,3,2
8,233,233,19,19,0,1,0
41,238,238,4,4,0,1,0
40,243,243,1,1,0,1,0
6,247,247,30,30,0,1,0
31,249,249,16,7,9,3,2
27,256,256,6,6,0,1,0
7,260,260,2,2,0,1,0
26,264,264,16,5,11,4,3
18,265,265,12,12,0,1,0
0,281,281,4,1,3,2,1
36,293,293,18,6,12,3,2
28,302,302,40,19,21,4,3
9,306,306,10,5,5,2,1
21,310,310,31,4,27,2,1
13,310,310,30,30,0,1,0
3,315,315,24,16,8,3,2
32,328,328,16,16,0,1,0
39,343,343,19,7,12,2,1
35,357,357,41,6,35,2,1
24,361,361,37,37,0,1,0
25,368,368,74,64,10,2,1
15,378,378,32,32,0,1,0
14,389,389,4,4,0,1,0
1,402,402,44,30,14,3,2
10,458,458,27,21,6,3,2
34,466,466,45,45,0,1,0
2,477,477,75,53,22,3,2
19,483,483,41,41,0,1,0
29,491,491,25,25,0,1,0
20,497,497,6,6,0,1,0

11,123,123,9,9,0,1,0
17,133,133,1,1,0,1,0
13,150,150,2,2,0,1,0
4,154,154,2,2,0,1,0
6,157,157,20,8,12,2,1
15,177,177,32,32,0,1,0
27,192,192,19,19,0,1,0
3,201,201,19,19,0,1,0
24,207,207,4,4,0,1,0
26,214,214,28,4,24,2,1
23,215,215,36,12,24,3,2
7,225,225,29,29,0,1,0
18,242,242,23,23,0,1,0
28,248,248,10,6,4,2,1
14,254,254,22,22,0,1,0
33,279,279,94,2,92,4,3
10,299,299,46,46,0,1,0
2,310,310,27,27,0,1,0
5,341,341,34,34,0,1,0
22,342,342,62,62,0,1,0
25,345,345,37,34,3,2,1
12,369,369,31,19,12,3,2
0,377,377,72,72,0,1,0
19,390,390,55,55,0,1,0
34,404,404,11,7,4,2,1
8,407,407,130,112,18,4,3
1,427,427,38,27,11,2,1
20,430,430,4,4,0,1,0
9,447,447,17,17,0,1,0
31,450,450,17,17,0,1,0
32,462,462,62,38,24,4,3
29,467,467,81,81,0,1,0
30,490,490,32,32,0,1,0
16,492,492,10,2,8,3,2
21,500,500,28,28,0,1,0

29,121,121,28,28,0,1,0
5,130,130,6,2,4,2,1
1,132,132,1,1,0,1,0
31,164,164,47,36,11,2,1
10,165,165,71,71,0,1,0
25,171,171,16,16,0,1,0
36,172,172,29,29,0,1,0
13,177,177,1,1,0,1,0
33,185,185,18,18,0,1,0
12,195,195,16,16,0,1,0
27,204,204,23,10,13,2,1
22,217,217,14,14,0,1,0
19,232,232,4,4,0,1,0
38,251,251,43,43,0,1,0
2,262,262,4,4,0,1,0
32,277,277,5,5,0,1,0
26,283,283,3,3,0,1,0
3,287,287,107,107,0,1,0
34,295,295,3,3,0,1,0
16,308,308,36,25,11,2,1
6,313,313,19,19,0,1,0
17,319,319,4,4,0,1,0
35,324,324,92,81,11,2,1
11,330,330,72,50,22,2,1
37,333,333,22,2,20,3,2
28,333,333,53,8,45,2,1
18,342,342,7,4,3,2,1
30,373,373,17,17,0,1,0
20,375,375,7,7,0,1,0
21,378,378,4,4,0,1,0
9,393,393,22,12,10,2,1
23,401,401,4,4,0,1,0
14,408,408,17,1,16,2,1
8,435,435,12,12,0,1,0
7,465,465,23,23,0,1,0
0,468,468,53,53,0,1,0
24,470,470,1,1,0,1,0
15,470,470,13,13,0,1,0
4,493,493,30,30,0,1,0

4,104,104,2,2,0,1,0
26,107,107,7,7,0,1,0
13,134,134,3,3,0,1,0
23,136,136,13,13,0,1,0
28,142,142,10,4,6,2,1
0,189,189,31,14,17,2,1
31,194,194,34,34,0,1,0
17,215,215,14,10,4,2,1
29,235,235,5,5,0,1,0
6,250,250,6,3,3,2,1
32,258,258,2,2,0,1,0
25,291,291,49,49,0,1,0
5,293,293,106,13,93,3,2
24,303,303,28,10,18,2,1
14,320,320,4,4,0,1,0
15,326,326,36,36,0,1,0
21,333,333,40,18,22,3,2
12,338,338,114,114,0,1,0
11,347,347,110,20,90,3,2
10,366,366,25,25,0,1,0
22,374,374,44,44,0,1,0
27,374,374,34,34,0,1,0
16,375,375,89,25,64,4,3
3,376,376,23,23,0,1,0
18,418,418,2,2,0,1,0
30,423,423,41,1,40,2,1
20,424,424,8,2,6,2,1
7,442,442,6,6,0,1,0
19,457,457,124,106,18,4,3
2,458,458,16,16,0,1,0
1,469,469,69,61,8,2,1
8,479,479,1,1,0,1,0
9,484,484,105,65,40,2,1

21,101,101,38,5,33,4,3
5,113,113,1,1,0,1,0
23,115,115,1,1,0,1,0
4,119,119,2,2,0,1,0
34,119,119,8,8,0,1,0
36,136,136,4,4,0,1,0
25,157,157,1,1,0,1,0
2,190,190,22,10,12,4,3
16,197,197,10,6,4,2,1
30,202,202,56,19,37,2,1
6,215,215,8,5,3,2,1
0,218,218,13,13,0,1,0
22,229,229,21,7,14,3,2
35,242,242,30,18,12,2,1
32,254,254,5,2,3,2,1
19,255,255,32,32,0,1,0
28,262,262,29,29,0,1,0
24,272,272,10,3,7,2,1
26,272,272,21,21,0,1,0
31,315,315,8,3,5,2,1
8,317,317,20,20,0,1,0
29,351,351,86,29,57,4,3
1,356,356,211,211,0,1,0
9,364,364,10,6,4,2,1
7,374,374,37,5,32,2,1
14,391,391,15,8,7,2,1
20,392,392,61,39,22,4,3
13,430,430,75,49,26,3,2
27,451,451,27,14,13,2,1
15,451,451,40,40,0,1,0
17,455,455,76,24,52,3,2
10,455,455,56,8,48,3,2
11,458,458,9,9,0,1,0
33,459,459,2,2,0,1,0
3,463,463,1,1,0,1,0
12,467,467,1,1,0,1,0
18,479,479,55,55,0,1,0

8,115,115,6,6,0,1,0
13,120,120,10,7,3,2,1
5,125,125,8,2,6,3,2
19,129,129,2,2,0,1,0
4,147,147,1,1,0,1,0
24,170,170,4,1,3,2,1
29,175,175,14,14,0,1,0
26,175,175,11,11,0,1,0
2,182,182,24,24,0,1,0
7,210,210,1,1,0,1,0
21,213,213,53,6,47,2,1
6,216,216,34,3,31,4,3
16,239,239,46,46,0,1,0
32,272,272,5,5,0,1,0
20,310,310,2,2,0,1,0
15,312,312,115,73,42,2,1
10,315,315,48,6,42,4,3
17,327,327,24,7,17,2,1
23,340,340,11,3,8,2,1
27,340,340,207,207,0,1,0
25,346,346,32,32,0,1,0
30,354,354,66,23,43,4,3
31,365,365,1,1,0,1,0
0,379,379,1,1,0,1,0
3,383,383,12,3,9,2,1
12,407,407,40,17,23,2,1
1,412,412,147,38,109,4,3
14,430,430,50,50,0,1,0
33,436,436,27,3,24,3,2
22,437,437,8,8,0,1,0
9,455,455,33,1,32,3,2
11,464,464,48,11,37,2,1
28,483,483,16,8,8,2,1
18,497,497,38,31,7,2,1

18,113,113,25,20,5,2,1
26,113,113,9,4,5,2,1
32,126,126,8,8,0,1,0
14,134,134,46,22,24,2,1
10,150,150,10,10,0,1,0
24,170,170,21,21,0,1,0
5,190,190,29,29,0,1,0
13,216,216,3,3,0,1,0
31,245,245,3,3,0,1,0
22,251,251,14,2,12,4,3
6,252,252,49,21,28,4,3
29,259,259,7,7,0,1,0
27,263,263,58,24,34,3,2
11,266,266,30,26,4,2,1
21,271,271,18,18,0,1,0
1,299,299,29,15,14,2,1
12,307,307,24,24,0,1,0
15,324,324,43,33,10,3,2
8,332,332,7,7,0,1,0
0,335,335,54,54,0,1,0
7,355,355,29,11,18,4,3
19,365,365,15,6,9,4,3
9,390,390,12,12,0,1,0
25,403,403,15,6,9,4,3
17,404,404,36,36,0,1,0
16,404,404,6,6,0,1,0
2,437,437,5,2,3,2,1
23,443,443,63,63,0,1,0
3,447,447,13,13,0,1,0
4,476,476,194,194,0,1,0
20,486,486,111,11,100,4,3
30,489,489,44,44,0,1,0
28,497,497,94,94,0,1,0

36,122,122,5,5,0,1,0
3,126,126,6,3,3,2,1
10,140,140,2,2,0,1,0
9,156,156,3,3,0,1,0
26,156,156,19,19,0,1,0
21,160,160,7,2,5,2,1
2,183,183,12,12,0,1,0
5,228,228,44,44,0,1,0
13,256,256,32,32,0,1,0
32,260,260,23,23,0,1,0
33,275,275,32,32,0,1,0
20,277,277,36,36,0,1,0
23,291,291,40,5,35,3,2
35,292,292,4,4,0,1,0
34,293,293,5,5,0,1,0
6,295,295,1,1,0,1,0
30,304,304,34,22,12,4,3
27,317,317,75,57,18,4,3
4,327,327,12,2,10,2,1
18,357,357,32,12,20,2,1
12,359,359,16,16,0,1,0
24,359,359,36,12,24,2,1
15,360,360,25,25,0,1,0
11,360,360,17,8,9,2,1
1,388,388,75,33,42,2,1
8,405,405,77,38,39,2,1
29,408,408,17,5,12,2,1
14,424,424,65,22,43,2,1
0,433,433,24,8,16,3,2
19,440,440,71,71,0,1,0
31,452,452,9,9,0,1,0
17,468,468,66,46,20,3,2
7,471,471,112,78,34,3,2
28,482,482,155,155,0,1,0
22,495,495,29,11,18,3,2
25,495,495,32,32,0,1,0
16,499,499,38,38,0,1,0

18,110,110,4,4,0,1,0
28,118,118,9,1,8,2,1
12,138,138,20,1,19,2,1
5,142,142,10,10,0,1,0
14,155,155,8,8,0,1,0
13,175,175,60,22,38,3,2
7,197,197,20,4,16,2,1
4,238,238,54,9,45,4,3
3,247,247,37,21,16,3,2
15,252,252,27,12,15,4,3
17,256,256,74,69,5,2,1
22,261,261,30,8,22,3,2
30,268,268,9,9,0,1,0
25,287,287,7,7,0,1,0
2,293,293,23,5,18,2,1
16,297,297,3,3,0,1,0
21,325,325,3,3,0,1,0
0,339,339,72,30,42,2,1
24,347,347,109,22,87,4,3
11,349,349,1,1,0,1,0
32,372,372,37,37,0,1,0
20,372,372,45,21,24,4,3
8,381,381,64,23,41,2,1
10,387,387,35,20,15,4,3
23,388,388,33,15,18,4,3
19,396,396,80,76,4,2,1
31,397,397,70,4,66,3,2
9,410,410,1,1,0,1,0
6,423,423,1,1,0,1,0
29,431,431,34,34,0,1,0
26,432,432,29,29,0,1,0
34,442,442,6,6,0,1,0
1,472,472,19,19,0,1,0
27,486,486,6,6,0,1,0
33,490,490,37,12,25,2,1

12,105,105,8,4,4,2,1
36,114,114,14,14,0,1,0
14,115,115,1,1,0,1,0
26,124,124,13,4,9,4,3
17,132,132,1,1,0,1,0
16,133,133,3,3,0,1,0
1,134,134,34,5,29,2,1
31,135,135,1,1,0,1,0
15,147,147,3,3,0,1,0
35,170,170,9,3,6,2,1
8,181,181,4,4,0,1,0
33,189,189,5,5,0,1,0
37,192,192,4,4,0,1,0
27,199,199,59,15,44,3,2
11,252,252,2,2,0,1,0
23,256,256,3,3,0,1,0
29,256,256,3,3,0,1,0
34,271,271,55,55,0,1,0
0,280,280,2,2,0,1,0
25,297,297,25,19,6,2,1
20,300,300,66,27,39,2,1
19,303,303,91,67,24,4,3
28,314,314,7,7,0,1,0
13,324,324,7,7,0,1,0
38,327,327,14,2,12,4,3
10,332,332,10,5,5,2,1
5,337,337,66,60,6,2,1
9,394,394,145,145,0,1,0
2,402,402,32,32,0,1,0
6,407,407,15,2,13,3,2
7,409,409,6,6,0,1,0
30,411,411,81,81,0,1,0
18,445,445,7,2,5,2,1
32,448,448,38,10,28,4,3
22,453,453,10,10,0,1,0
24,469,469,25,17,8,3,2
21,472,472,222,198,24,4,3
4,482,482,15,2,13,2,1
3,483,483,30,11,19,2,1

17,113,113,9,9,0,1,0
29,117,117,3,3,0,1,0
15,121,121,15,15,0,1,0
13,130,130,4,4,0,1,0
12,144,144,8,8,0,1,0
26,162,162,15,15,0,1,0
27,174,174,44,44,0,1,0
23,194,194,72,66,6,2,1
20,197,197,61,26,35,2,1
32,204,204,17,11,6,3,2
21,215,215,2,2,0,1,0
3,224,224,1,1,0,1,0
28,244,244,8,2,6,2,1
22,262,262,14,14,0,1,0
5,273,273,47,22,25,2,1
18,287,287,14,14,0,1,0
14,289,289,33,33,0,1,0
8,298,298,2,2,0,1,0
0,300,300,88,23,65,4,3
9,308,308,10,10,0,1,0
6,337,337,4,4,0,1,0
33,339,339,8,8,0,1,0
2,344,344,39,39,0,1,0
30,377,377,10,10,0,1,0
31,396,396,4,4,0,1,0
11,416,416,31,17,14,3,2
35,419,419,37,25,12,2,1
7,422,422,52,36,16,3,2
1,444,444,23,18,5,2,1
16,446,446,4,4,0,1,0
4,448,448,209,80,129,4,3
34,450,450,54,28,26,3,2
10,483,483,18,18,0,1,0
19,484,484,49,1,48,2,1
24,488,488,56,56,0,1,0
25,499,499,36,33,3,2,1

28,108,108,14,14,0,1,0
25,121,121,44,44,0,1,0
4,127,127,9,9,0,1,0
38,140,140,3,3,0,1,0
5,148,148,28,28,0,1,0
29,148,148,1,1,0,1,0
27,155,155,6,6,0,1,0
30,163,163,20,20,0,1,0
15,168,168,1,1,0,1,0
22,169,169,5,5,0,1,0
21,171,171,25,25,0,1,0
33,182,182,4,4,0,1,0
35,184,184,5,5,0,1,0
23,189,189,3,3,0,1,0
9,199,199,19,7,12,3,2
36,227,227,5,5,0,1,0
24,247,247,50,50,0,1,0
1,251,251,3,3,0,1,0
14,274,274,1,1,0,1,0
10,276,276,5,5,0,1,0
19,287,287,52,52,0,1,0
8,298,298,23,5,18,3,2
7,300,300,30,15,15,4,3
18,354,354,48,8,40,3,2
0,361,361,11,11,0,1,0
32,368,368,129,42,87,4,3
11,368,368,1,1,0,1,0
6,370,370,74,2,72,4,3
13,385,385,70,70,0,1,0
3,387,387,11,11,0,1,0
20,407,407,11,11,0,1,0
26,409,409,2,2,0,1,0
34,425,425,22,2,20,3,2
12,432,432,21,1,20,3,2
37,433,433,97,97,0,1,0
2,435,435,65,27,38,2,1
17,458,458,78,78,0,1,0
31,466,466,27,21,6,2,1
16,493,493,36,36,0,1,0

19,110,110,13,2,11,2,1
35,126,126,7,2,5,2,1
23,129,129,34,10,24,2,1
11,158,158,1,1,0,1,0
0,161,161,36,36,0,1,0
32,165,165,2,2,0,1,0
20,173,173,9,9,0,1,0
28,202,202,15,15,0,1,0
37,203,203,49,31,18,4,3
18,206,206,9,9,0,1,0
9,229,229,22,13,9,4,3
1,246,246,5,1,4,2,1
2,255,255,37,37,0,1,0
36,272,272,24,1,23,2,1
25,276,276,19,7,12,2,1
5,296,296,14,14,0,1,0
27,303,303,131,102,29,2,1
22,304,304,9,9,0,1,0
21,306,306,35,3,32,3,2
17,310,310,50,50,0,1,0
34,317,317,51,51,0,1,0
33,335,335,27,19,8,3,2
3,353,353,4,4,0,1,0
14,355,355,24,24,0,1,0
12,361,361,20,20,0,1,0
16,366,366,78,51,27,2,1
15,369,369,11,11,0,1,0
10,376,376,1,1,0,1,0
24,399,399,19,19,0,1,0
8,401,401,44,7,37,4,3
4,403,403,145,117,28,4,3
6,412,412,14,1,13,3,2
13,419,419,6,3,3,2,1
31,443,443,15,15,0,1,0
30,456,456,18,18,0,1,0
7,490,490,20,20,0,1,0
26,492,492,14,9,5,2,1
29,498,498,9,2,7,2,1

24,102,102,8,1,7,2,1
11,106,106,42,42,0,1,0
1,120,120,5,5,0,1,0
27,149,149,14,14,0,1,0
8,158,158,6,6,0,1,0
6,159,159,2,2,0,1,0
2,162,162,16,16,0,1,0
31,167,167,5,5,0,1,0
22,184,184,3,3,0,1,0
18,192,192,10,10,0,1,0
34,212,212,4,4,0,1,0
13,224,224,25,25,0,1,0
28,234,234,3,3,0,1,0
0,237,237,4,4,0,1,0
30,247,247,18,9,9,2,1
29,263,263,123,77,46,3,2
7,268,268,79,61,18,3,2
5,276,276,24,24,0,1,0
33,291,291,77,67,10,3,2
15,293,293,12,4,8,3,2
20,296,296,6,6,0,1,0
4,316,316,1,1,0,1,0
14,322,322,5,5,0,1,0
32,350,350,58,26,32,2,1
3,355,355,45,18,27,2,1
17,362,362,7,7,0,1,0
12,387,387,93,42,51,4,3
25,401,401,42,9,33,4,3
9,403,403,5,5,0,1,0
21,405,405,61,1,60,3,2
19,456,456,4,4,0,1,0
23,460,460,25,14,11,4,3
26,468,468,100,83,17,4,3
10,488,488,120,102,18,4,3
16,496,496,9,9,0,1,0

0,118,118,8,8,0,1,0
21,146,146,12,12,0,1,0
20,147,147,6,6,0,1,0
19,159,159,12,12,0,1,0
14,174,174,8,8,0,1,0
17,185,185,33,14,19,2,1
24,188,188,26,26,0,1,0
26,206,206,7,7,0,1,0
34,211,211,124,124,0,1,0
22,217,217,33,33,0,1,0
2,218,218,12,12,0,1,0
15,227,227,27,16,11,2,1
33,249,249,13,13,0,1,0
30,250,250,7,7,0,1,0
25,254,254,2,2,0,1,0
3,257,257,4,4,0,1,0
6,264,264,35,2,33,2,1
1,273,273,77,46,31,3,2
28,299,299,4,4,0,1,0
23,369,369,23,23,0,1,0
13,373,373,52,42,10,3,2
4,387,387,60,60,0,1,0
10,391,391,23,23,0,1,0
7,392,392,85,67,18,4,3
16,398,398,65,65,0,1,0
9,400,400,45,11,34,3,2
8,400,400,24,11,13,2,1
12,418,418,22,11,11,2,1
11,420,420,25,25,0,1,0
31,424,424,4,4,0,1,0
32,429,429,20,1,19,2,1
27,440,440,9,9,0,1,0
29,440,440,62,62,0,1,0
18,458,458,77,77,0,1,0
5,461,461,30,22,8,2,1

13,115,115,17,17,0,1,0
36,125,125,12,6,6,2,1
28,130,130,3,3,0,1,0
17,140,140,1,1,0,1,0
33,149,149,29,29,0,1,0
22,163,163,8,8,0,1,0
11,165,165,20,20,0,1,0
24,170,170,63,16,47,3,2
8,173,173,14,14,0,1,0
26,195,195,7,1,6,2,1
15,211,211,35,20,15,2,1
3,243,243,2,2,0,1,0
29,243,243,107,14,93,4,3
35,246,246,28,28,0,1,0
25,249,249,15,5,10,2,1
34,250,250,21,6,15,4,3
0,258,258,11,11,0,1,0
14,260,260,3,3,0,1,0
6,310,310,7,7,0,1,0
9,310,310,5,5,0,1,0
32,318,318,41,13,28,4,3
7,333,333,15,15,0,1,0
5,346,346,2,2,0,1,0
23,352,352,13,13,0,1,0
12,354,354,1,1,0,1,0
21,357,357,10,4,6,2,1
31,386,386,33,18,15,2,1
1,394,394,6,6,0,1,0
16,395,395,28,3,25,2,1
20,399,399,9,9,0,1,0
37,406,406,16,16,0,1,0
30,406,406,9,9,0,1,0
19,432,432,197,197,0,1,0
18,443,443,10,4,6,3,2
4,443,443,6,6,0,1,0
2,448,448,105,105,0,1,0
10,461,461,143,97,46,3,2
27,479,479,5,5,0,1,0

5,116,116,16,1,15,4,3
8,147,147,25,16,9,2,1
35,154,154,1,1,0,1,0
31,165,165,2,2,0,1,0
10,187,187,11,11,0,1,0
14,189,189,15,15,0,1,0
21,199,199,34,34,0,1,0
27,205,205,83,50,33,4,3
11,234,234,50,50,0,1,0
29,234,234,8,2,6,2,1
23,242,242,19,4,15,4,3
6,248,248,8,8,0,1,0
38,259,259,10,10,0,1,0
19,271,271,36,16,20,2,1
4,280,280,18,5,13,4,3
37,282,282,9,9,0,1,0
16,304,304,3,3,0,1,0
1,311,311,3,3,0,1,0
15,312,312,43,43,0,1,0
2,326,326,18,18,0,1,0
12,328,328,69,1,68,3,2
36,340,340,1,1,0,1,0
13,356,356,21,21,0,1,0
30,361,361,47,2,45,4,3
18,370,370,26,26,0,1,0
17,372,372,40,24,16,3,2
24,375,375,68,41,27,2,1
28,396,396,63,45,18,4,3
33,415,415,22,14,8,3,2
26,422,422,1,1,0,1,0
32,423,423,67,11,56,3,2
22,427,427,10,1,9,4,3
9,451,451,32,10,22,2,1
25,470,470,145,145,0,1,0
7,476,476,23,23,0,1,0
0,480,480,44,44,0,1,0
20,482,482,3,3,0,1,0
34,491,491,14,8,6,2,1
3,494,494,17,11,6,2,1

34,110,110,20,5,15,4,3
35,113,113,4,4,0,1,0
24,113,113,33,3,30,2,1
32,123,123,49,28,21,2,1
13,134,134,24,8,16,3,2
4,137,137,5,5,0,1,0
25,140,140,2,2,0,1,0
16,143,143,10,10,0,1,0
12,145,145,1,1,0,1,0
14,171,171,1,1,0,1,0
5,184,184,15,8,7,2,1
26,197,197,39,30,9,2,1
2,200,200,2,2,0,1,0
20,214,214,14,14,0,1,0
36,229,229,26,2,24,3,2
6,238,238,5,5,0,1,0
19,248,248,4,4,0,1,0
28,264,264,15,1,14,4,3
7,266,266,23,23,0,1,0
30,266,266,24,8,16,3,2
31,270,270,4,1,3,2,1
3,281,281,22,22,0,1,0
23,284,284,4,4,0,1,0
11,288,288,82,52,30,3,2
22,292,292,7,7,0,1,0
21,300,300,22,22,0,1,0
29,311,311,9,9,0,1,0
10,312,312,50,47,3,2,1
1,357,357,26,14,12,4,3
0,380,380,77,77,0,1,0
33,387,387,17,3,14,3,2
9,408,408,91,91,0,1,0
15,410,410,12,2,10,3,2
17,411,411,18,18,0,1,0
8,443,443,5,5,0,1,0
18,444,444,88,12,76,4,3
27,484,484,88,46,42,3,2

12,101,101,19,9,10,3,2
19,112,112,6,3,3,2,1
18,132,132,10,10,0,1,0
2,147,147,5,1,4,2,1
4,162,162,14,3,11,2,1
31,176,176,17,7,10,3,2
34,177,177,20,8,12,4,3
0,194,194,15,15,0,1,0
28,194,194,15,15,0,1,0
17,258,258,7,1,6,2,1
30,263,263,38,38,0,1,0
22,263,263,15,1,14,3,2
15,268,268,26,13,13,2,1
13,276,276,56,36,20,3,2
20,284,284,37,16,21,2,1
6,284,284,17,17,0,1,0
10,292,292,62,5,57,4,3
21,292,292,36,36,0,1,0
8,306,306,21,21,0,1,0
11,315,315,2,2,0,1,0
23,317,317,2,2,0,1,0
27,335,335,84,84,0,1,0
32,342,342,39,39,0,1,0
1,351,351,58,49,9,2,1
33,358,358,69,5,64,3,2
9,395,395,76,41,35,2,1
25,407,407,36,16,20,2,1
14,420,420,1,1,0,1,0
26,440,440,30,30,0,1,0
3,441,441,61,19,42,4,3
5,456,456,1,1,0,1,0
24,457,457,65,65,0,1,0
29,462,462,35,4,31,2,1
16,476,476,69,36,33,4,3
7,484,484,59,13,46,2,1

17,114,114,15,15,0,1,0
21,133,133,10,10,0,1,0
18,142,142,13,13,0,1,0
32,149,149,6,3,3,2,1
2,196,196,1,1,0,1,0
27,208,208,16,16,0,1,0
20,216,216,55,45,10,2,1
19,224,224,1,1,0,1,0
15,229,229,7,2,5,2,1
5,230,230,23,23,0,1,0
14,237,237,32,32,0,1,0
22,237,237,1,1,0,1,0
11,247,247,5,5,0,1,0
29,248,248,19,5,14,3,2
26,262,262,1,1,0,1,0
1,268,268,29,20,9,2,1
30,285,285,13,13,0,1,0
10,291,291,15,5,10,3,2
25,297,297,106,12,94,3,2
6,306,306,55,26,29,2,1
24,327,327,20,8,12,2,1
8,335,335,73,73,0,1,0
12,345,345,74,41,33,4,3
23,410,410,50,24,26,2,1
13,413,413,41,28,13,2,1
4,425,425,142,91,51,4,3
28,428,428,44,11,33,4,3
9,437,437,26,5,21,2,1
16,442,442,155,32,123,4,3
7,448,448,60,6,54,3,2
0,449,449,26,2,24,4,3
3,459,459,39,39,0,1,0
31,476,476,6,2,4,2,1

9,107,107,14,14,0,1,0
5,108,108,6,6,0,1,0
33,124,124,42,24,18,4,3
10,136,136,3,3,0,1,0
1,155,155,5,5,0,1,0
27,173,173,32,13,19,2,1
8,183,183,10,10,0,1,0
21,190,190,30,12,18,2,1
4,206,206,17,17,0,1,0
20,221,221,17,14,3,2,1
22,236,236,9,2,7,2,1
16,253,253,18,5,13,2,1
3,259,259,26,12,14,2,1
32,292,292,11,11,0,1,0
7,300,300,183,135,48,3,2
23,323,323,11,2,9,2,1
17,327,327,62,44,18,4,3
18,334,334,4,4,0,1,0
6,347,347,1,1,0,1,0
11,350,350,8,4,4,2,1
15,355,355,38,38,0,1,0
12,375,375,23,17,6,3,2
0,402,402,66,21,45,4,3
26,411,411,51,51,0,1,0
30,413,413,5,1,4,2,1
28,419,419,35,31,4,2,1
19,438,438,46,46,0,1,0
29,442,442,38,38,0,1,0
31,448,448,31,31,0,1,0
13,455,455,10,6,4,2,1
14,467,467,121,73,48,4,3
25,468,468,61,14,47,2,1
24,490,490,36,36,0,1,0
2,500,500,37,37,0,1,0

6,110,110,1,1,0,1,0
10,130,130,1,1,0,1,0
36,142,142,30,26,4,2,1
39,143,143,14,14,0,1,0
21,170,170,12,12,0,1,0
17,173,173,15,5,10,3,2
29,176,176,5,5,0,1,0
7,188,188,1,1,0,1,0
35,194,194,4,4,0,1,0
30,202,202,27,27,0,1,0
19,207,207,6,6,0,1,0
27,211,211,22,22,0,1,0
8,225,225,8,8,0,1,0
1,256,256,59,59,0,1,0
16,285,285,15,1,14,3,2
0,285,285,50,15,35,2,1
20,287,287,16,16,0,1,0
33,301,301,55,1,54,3,2
28,302,302,5,5,0,1,0
23,304,304,44,44,0,1,0
4,304,304,31,31,0,1,0
37,313,313,2,2,0,1,0
31,313,313,30,30,0,1,0
24,313,313,111,78,33,4,3
2,339,339,10,10,0,1,0
11,341,341,19,19,0,1,0
38,358,358,35,35,0,1,0
3,359,359,33,4,29,3,2
5,361,361,8,8,0,1,0
34,364,364,33,14,19,2,1
9,367,367,16,16,0,1,0
22,405,405,20,20,0,1,0
12,414,414,13,5,8,3,2
13,418,418,27,4,23,2,1
26,420,420,17,5,12,3,2
32,427,427,53,53,0,1,0
18,447,447,247,118,129,4,3
14,447,447,10,10,0,1,0
25,489,489,20,8,12,2,1
15,490,490,13,9,4,2,1

29,100,100,1,1,0,1,0
8,113,113,22,2,20,3,2
35,117,117,8,8,0,1,0
27,131,131,8,8,0,1,0
34,136,136,1,1,0,1,0
26,151,151,10,10,0,1,0
16,167,167,10,10,0,1,0
31,169,169,8,8,0,1,0
36,172,172,24,24,0,1,0
4,184,184,7,7,0,1,0
33,212,212,2,2,0,1,0
11,216,216,10,10,0,1,0
3,218,218,16,4,12,2,1
38,232,232,56,38,18,3,2
32,253,253,36,24,12,4,3
21,263,263,22,10,12,3,2
0,264,264,13,13,0,1,0
7,267,267,4,4,0,1,0
13,286,286,8,8,0,1,0
2,299,299,42,12,30,3,2
30,300,300,8,8,0,1,0
22,317,317,83,5,78,4,3
18,325,325,19,1,18,4,3
9,330,330,57,7,50,2,1
5,338,338,15,6,9,4,3
6,346,346,2,2,0,1,0
17,361,361,37,1,36,3,2
28,361,361,118,118,0,1,0
10,395,395,11,11,0,1,0
39,396,396,8,8,0,1,0
14,417,417,2,2,0,1,0
20,430,430,18,8,10,2,1
1,430,430,1,1,0,1,0
15,444,444,78,36,42,2,1
25,451,451,107,107,0,1,0
23,458,458,31,11,20,2,1
24,462,462,3,3,0,1,0
37,466,466,50,25,25,3,2
19,479,479,200,91,109,4,3
12,500,500,10,10,0,1,0

35,114,114,6,1,5,2,1
27,128,128,31,10,21,4,3
16,129,129,1,1,0,1,0
31,137,137,14,2,12,4,3
22,139,139,22,9,13,2,1
30,146,146,46,46,0,1,0
9,151,151,15,1,14,2,1
36,167,167,30,16,14,3,2
2,169,169,51,51,0,1,0
18,174,174,5,5,0,1,0
7,178,178,9,9,0,1,0
21,184,184,33,6,27,2,1
8,195,195,24,9,15,2,1
10,202,202,10,2,8,2,1
6,239,239,18,18,0,1,0
32,240,240,16,1,15,4,3
28,296,296,27,9,18,4,3
12,308,308,17,7,10,3,2
34,315,315,35,35,0,1,0
14,317,317,20,20,0,1,0
29,335,335,9,1,8,3,2
33,336,336,11,5,6,3,2
13,338,338,22,22,0,1,0
3,346,346,92,14,78,4,3
4,354,354,30,7,23,2,1
11,365,365,25,25,0,1,0
26,369,369,45,37,8,3,2
1,379,379,54,45,9,4,3
15,388,388,47,2,45,4,3
0,406,406,1,1,0,1,0
23,415,415,4,4,0,1,0
5,419,419,14,6,8,3,2
25,448,448,10,3,7,2,1
19,452,452,16,16,0,1,0
17,455,455,75,49,26,3,2
24,457,457,6,6,0,1,0
20,487,487,45,30,15,4,3

23,108,108,10,2,8,2,1
32,122,122,33,24,9,4,3
7,157,157,12,12,0,1,0
25,158,158,9,3,6,2,1
24,181,181,11,11,0,1,0
12,190,190,22,8,14,2,1
20,193,193,2,2,0,1,0
35,209,209,12,12,0,1,0
3,210,210,1,1,0,1,0
38,210,210,24,24,0,1,0
9,214,214,89,89,0,1,0
33,220,220,7,7,0,1,0
2,239,239,7,4,3,2,1
36,252,252,7,7,0,1,0
34,258,258,9,9,0,1,0
5,259,259,6,2,4,2,1
15,259,259,12,12,0,1,0
17,280,280,27,13,14,3,2
37,283,283,84,50,34,3,2
6,286,286,22,22,0,1,0
13,292,292,15,15,0,1,0
29,293,293,69,6,63,4,3
21,297,297,10,10,0,1,0
0,302,302,1,1,0,1,0
10,315,315,1,1,0,1,0
11,324,324,6,6,0,1,0
19,342,342,4,4,0,1,0
14,358,358,28,28,0,1,0
39,365,365,19,19,0,1,0
8,368,368,80,80,0,1,0
1,376,376,64,64,0,1,0
22,394,394,6,2,4,2,1
27,399,399,74,18,56,3,2
18,403,403,29,5,24,2,1
4,407,407,71,54,17,2,1
16,420,420,30,2,28,3,2
26,421,421,4,1,3,2,1
30,449,449,1,1,0,1,0
31,449,449,55,55,0,1,0
28,499,499,84,84,0,1,0

31,116,116,3,3,0,1,0
20,119,119,4,4,0,1,0
27,130,130,8,8,0,1,0
30,131,131,26,22,4,2,1
1,132,132,38,38,0,1,0
21,143,143,11,11,0,1,0
2,148,148,37,37,0,1,0
4,153,153,7,7,0,1,0
0,170,170,1,1,0,1,0
19,183,183,4,4,0,1,0
37,188,188,40,20,20,3,2
40,193,193,12,12,0,1,0
3,218,218,10,2,8,3,2
24,232,232,15,3,12,2,1
26,251,251,3,3,0,1,0
45,258,258,14,14,0,1,0
29,261,261,46,46,0,1,0
32,262,262,59,59,0,1,0
6,271,271,24,12,12,2,1
42,272,272,6,1,5,2,1
28,282,282,14,14,0,1,0
15,291,291,16,16,0,1,0
5,322,322,21,21,0,1,0
9,331,331,46,32,14,2,1
46,352,352,23,23,0,1,0
14,386,386,21,12,9,4,3
7,390,390,18,6,12,2,1
35,392,392,10,7,3,2,1
44,411,411,39,27,12,4,3
8,412,412,44,44,0,1,0
23,428,428,20,14,6,2,1
22,433,433,1,1,0,1,0
34,435,435,26,26,0,1,0
25,445,445,2,2,0,1,0
39,458,458,22,22,0,1,0
16,461,461,20,11,9,2,1
43,466,466,60,60,0,1,0
10,476,476,24,24,0,1,0
33,479,479,75,35,40,3,2
38,480,480,41,41,0,1,0
18,480,480,20,20,0,1,0
17,481,481,18,2,16,2,1
41,485,485,41,41,0,1,0
36,493,493,46,46,0,1,0
11,496,496,19,19,0,1,0
13,497,497,3,3,0,1,0
12,499,499,11,2,9,2,1

37,107,107,9,1,8,2,1
25,120,120,13,13,0,1,0
19,137,137,35,35,0,1,0
34,139,139,8,8,0,1,0
3,147,147,6,2,4,2,1
5,148,148,27,12,15,4,3
24,154,154,21,21,0,1,0
17,157,157,53,53,0,1,0
21,161,161,6,6,0,1,0
7,177,177,4,4,0,1,0
1,181,181,5,5,0,1,0
9,185,185,1,1,0,1,0
13,204,204,44,44,0,1,0
29,217,217,13,13,0,1,0
0,228,228,9,9,0,1,0
11,229,229,46,46,0,1,0
2,240,240,36,36,0,1,0
32,250,250,14,9,5,2,1
23,253,253,21,21,0,1,0
18,254,254,25,25,0,1,0
15,255,255,1,1,0,1,0
22,264,264,84,84,0,1,0
8,277,277,6,3,3,2,1
10,281,281,16,1,15,3,2
16,316,316,11,6,5,2,1
28,316,316,4,4,0,1,0
6,325,325,4,4,0,1,0
27,347,347,54,2,52,3,2
26,370,370,34,24,10,2,1
35,381,381,56,56,0,1,0
36,386,386,35,35,0,1,0
31,388,388,50,25,25,3,2
12,401,401,9,3,6,3,2
30,406,406,9,9,0,1,0
4,421,421,3,3,0,1,0
20,426,426,27,27,0,1,0
33,461,461,69,69,0,1,0
38,471,471,50,3,47,4,3
14,474,474,1,1,0,1,0

0,100,100,4,4,0,1,0
24,121,121,14,14,0,1,0
3,140,140,7,7,0,1,0
13,167,167,8,2,6,2,1
4,171,171,3,3,0,1,0
27,184,184,1,1,0,1,0
1,197,197,14,14,0,1,0
9,198,198,2,2,0,1,0
28,232,232,8,5,3,2,1
31,236,236,5,5,0,1,0
22,239,239,24,19,5,2,1
7,239,239,59,4,55,4,3
29,252,252,34,28,6,3,2
34,256,256,125,78,47,4,3
11,266,266,62,28,34,2,1
8,275,275,26,26,0,1,0
12,280,280,22,22,0,1,0
25,305,305,34,34,0,1,0
17,306,306,9,9,0,1,0
36,311,311,23,23,0,1,0
35,314,314,67,13,54,3,2
18,320,320,14,14,0,1,0
16,322,322,27,13,14,2,1
20,332,332,53,17,36,4,3
21,343,343,7,1,6,2,1
19,350,350,5,5,0,1,0
10,386,386,56,56,0,1,0
2,399,399,6,6,0,1,0
6,400,400,51,7,44,2,1
15,406,406,21,6,15,4,3
14,418,418,32,26,6,2,1
33,422,422,1,1,0,1,0
5,423,423,144,144,0,1,0
32,428,428,20,20,0,1,0
30,434,434,38,38,0,1,0
26,466,466,62,62,0,1,0
23,479,479,37,5,32,3,2

4,118,118,13,13,0,1,0
16,123,123,26,2,24,2,1
0,141,141,5,5,0,1,0
5,156,156,3,3,0,1,0
14,163,163,4,1,3,2,1
37,163,163,6,1,5,2,1
35,178,178,64,64,0,1,0
13,179,179,1,1,0,1,0
39,181,181,15,15,0,1,0
36,201,201,32,11,21,2,1
24,224,224,14,4,10,2,1
9,236,236,52,17,35,2,1
21,245,245,40,40,0,1,0
7,270,270,14,14,0,1,0
38,280,280,2,2,0,1,0
28,282,282,55,55,0,1,0
22,299,299,4,1,3,2,1
40,307,307,15,15,0,1,0
1,320,320,8,8,0,1,0
31,326,326,74,35,39,4,3
10,334,334,83,18,65,3,2
6,338,338,2,2,0,1,0
29,375,375,14,9,5,2,1
23,387,387,51,39,12,4,3
3,391,391,49,38,11,2,1
19,393,393,70,70,0,1,0
12,402,402,1,1,0,1,0
18,408,408,14,14,0,1,0
11,409,409,2,2,0,1,0
2,418,418,16,16,0,1,0
33,433,433,5,5,0,1,0
26,436,436,49,39,10,3,2
25,440,440,60,46,14,4,3
34,440,440,24,6,18,2,1
15,447,447,8,8,0,1,0
8,462,462,21,1,20,2,1
20,470,470,43,35,8,2,1
32,475,475,1,1,0,1,0
17,479,479,62,62,0,1,0
27,489,489,31,31,0,1,0
30,497,497,51,51,0,1,0

28,111,111,23,15,8,3,2
1,122,122,31,27,4,2,1
25,125,125,24,5,19,3,2
18,133,133,11,11,0,1,0
14,141,141,35,35,0,1,0
27,142,142,11,8,3,2,1
2,162,162,37,10,27,4,3
30,178,178,19,4,15,2,1
24,197,197,20,20,0,1,0
34,260,260,89,18,71,3,2
21,260,260,12,9,3,2,1
9,261,261,2,2,0,1,0
10,270,270,17,8,9,2,1
31,278,278,48,6,42,3,2
23,283,283,15,15,0,1,0
12,297,297,23,9,14,2,1
3,323,323,21,18,3,2,1
13,329,329,35,3,32,4,3
0,331,331,6,6,0,1,0
33,343,343,27,27,0,1,0
19,358,358,18,4,14,2,1
17,359,359,52,16,36,4,3
11,372,372,4,4,0,1,0
16,389,389,21,17,4,2,1
5,390,390,113,107,6,2,1
6,415,415,103,35,68,4,3
22,419,419,18,18,0,1,0
29,419,419,4,1,3,2,1
20,423,423,26,26,0,1,0
15,424,424,4,4,0,1,0
32,437,437,29,29,0,1,0
8,442,442,26,26,0,1,0
26,447,447,1,1,0,1,0
4,470,470,28,28,0,1,0
7,485,485,1,1,0,1,0

19,100,100,3,3,0,1,0
8,105,105,4,4,0,1,0
18,110,110,11,11,0,1,0
25,114,114,2,2,0,1,0
16,118,118,1,1,0,1,0
7,140,140,5,2,3,2,1
31,159,159,34,34,0,1,0
1,165,165,3,3,0,1,0
32,171,171,20,20,0,1,0
12,178,178,3,3,0,1,0
26,178,178,22,22,0,1,0
13,179,179,9,4,5,2,1
29,189,189,39,39,0,1,0
11,198,198,4,4,0,1,0
23,209,209,53,7,46,3,2
6,212,212,85,53,32,2,1
2,214,214,48,20,28,2,1
15,218,218,3,3,0,1,0
0,233,233,1,1,0,1,0
17,265,265,21,21,0,1,0
22,287,287,5,5,0,1,0
14,339,339,26,21,5,2,1
20,342,342,60,60,0,1,0
24,350,350,28,13,15,4,3
27,358,358,72,54,18,4,3
3,363,363,173,23,150,4,3
9,391,391,36,36,0,1,0
10,398,398,56,7,49,3,2
4,444,444,86,20,66,4,3
28,450,450,16,16,0,1,0
5,480,480,6,6,0,1,0
21,482,482,41,41,0,1,0
30,495,495,41,10,31,2,1

21,112,112,7,1,6,2,1
40,119,119,6,2,4,2,1
41,122,122,10,3,7,2,1
9,130,130,9,9,0,1,0
15,134,134,2,2,0,1,0
30,149,149,9,9,0,1,0
26,153,153,37,4,33,2,1
34,159,159,34,34,0,1,0
4,169,169,7,1,6,2,1
43,172,172,4,4,0,1,0
22,174,174,13,13,0,1,0
8,188,188,1,1,0,1,0
13,195,195,1,1,0,1,0
1,200,200,17,1,16,2,1
6,202,202,9,3,6,2,1
11,203,203,1,1,0,1,0
7,216,216,2,2,0,1,0
17,219,219,6,6,0,1,0
38,221,221,48,22,26,3,2
28,235,235,13,1,12,4,3
3,237,237,41,41,0,1,0
18,237,237,1,1,0,1,0
36,239,239,18,18,0,1,0
0,240,240,13,13,0,1,0
42,258,258,45,45,0,1,0
29,285,285,12,3,9,4,3
47,297,297,16,16,0,1,0
37,308,308,86,26,60,4,3
16,312,312,16,16,0,1,0
35,339,339,48,39,9,2,1
25,342,342,16,16,0,1,0
45,364,364,15,15,0,1,0
12,364,364,14,14,0,1,0
24,380,380,5,5,0,1,0
39,390,390,4,4,0,1,0
19,406,406,15,6,9,2,1
5,416,416,69,69,0,1,0
2,418,418,24,2,22,3,2
32,422,422,3,3,0,1,0
10,427,427,1,1,0,1,0
33,431,431,6,6,0,1,0
31,439,439,124,38,86,4,3
27,453,453,117,45,72,4,3
23,461,461,41,25,16,3,2
20,465,465,10,1,9,2,1
44,466,466,52,29,23,2,1
14,482,482,2,2,0,1,0
46,498,498,2,2,0,1,0

22,103,103,3,3,0,1,0
28,106,106,23,8,15,4,3
29,110,110,37,37,0,1,0
0,138,138,2,2,0,1,0
11,146,146,15,15,0,1,0
7,158,158,16,16,0,1,0
21,162,162,1,1,0,1,0
3,164,164,1,1,0,1,0
31,164,164,7,1,6,2,1
27,168,168,5,5,0,1,0
16,182,182,3,3,0,1,0
12,192,192,1,1,0,1,0
9,201,201,1,1,0,1,0
33,203,203,8,8,0,1,0
34,209,209,23,23,0,1,0
20,221,221,6,6,0,1,0
14,225,225,20,4,16,2,1
4,226,226,7,1,6,2,1
41,237,237,11,11,0,1,0
5,238,238,4,4,0,1,0
19,248,248,14,14,0,1,0
25,277,277,14,14,0,1,0
17,279,279,18,18,0,1,0
1,302,302,71,71,0,1,0
37,304,304,68,47,21,2,1
15,306,306,12,12,0,1,0
30,312,312,32,32,0,1,0
23,322,322,57,9,48,2,1
18,323,323,62,15,47,2,1
44,353,353,3,3,0,1,0
42,355,355,14,3,11,2,1
35,356,356,80,80,0,1,0
8,382,382,29,29,0,1,0
10,399,399,83,3,80,4,3
36,410,410,12,4,8,3,2
6,421,421,13,13,0,1,0
40,426,426,13,5,8,2,1
13,428,428,1,1,0,1,0
32,429,429,91,47,44,2,1
26,435,435,8,8,0,1,0
43,435,435,7,3,4,2,1
39,446,446,4,4,0,1,0
2,472,472,57,31,26,2,1
38,478,478,56,56,0,1,0
24,500,500,40,25,15,4,3

11,106,106,14,14,0,1,0
4,108,108,5,5,0,1,0
42,110,110,3,3,0,1,0
20,111,111,8,8,0,1,0
1,143,143,25,3,22,2,1
17,151,151,11,5,6,2,1
44,177,177,20,8,12,3,2
31,195,195,24,9,15,4,3
3,203,203,15,15,0,1,0
14,206,206,27,3,24,4,3
5,221,221,11,11,0,1,0
26,224,224,27,27,0,1,0
35,229,229,14,5,9,4,3
30,235,235,16,16,0,1,0
9,235,235,7,1,6,3,2
15,245,245,10,7,3,2,1
18,255,255,2,2,0,1,0
40,272,272,36,36,0,1,0
19,287,287,3,3,0,1,0
24,290,290,7,7,0,1,0
45,293,293,26,26,0,1,0
36,295,295,4,4,0,1,0
27,297,297,9,9,0,1,0
25,329,329,3,3,0,1,0
12,335,335,21,11,10,3,2
7,346,346,60,12,48,3,2
43,350,350,12,8,4,2,1
22,352,352,21,14,7,2,1
10,365,365,29,29,0,1,0
37,374,374,2,2,0,1,0
13,379,379,11,11,0,1,0
23,381,381,33,1,32,3,2
28,392,392,72,72,0,1,0
2,407,407,35,35,0,1,0
38,410,410,65,53,12,2,1
6,414,414,6,6,0,1,0
21,430,430,42,42,0,1,0
32,434,434,23,3,20,3,2
41,438,438,60,24,36,2,1
29,446,446,82,41,41,2,1
16,451,451,15,9,6,2,1
39,462,462,21,3,18,2,1
34,467,467,34,34,0,1,0
8,470,470,13,13,0,1,0
33,476,476,156,156,0,1,0
0,489,489,13,7,6,2,1

2,106,106,2,2,0,1,0
11,128,128,5,1,4,2,1
18,140,140,28,28,0,1,0
20,153,153,1,1,0,1,0
22,157,157,1,1,0,1,0
31,157,157,2,2,0,1,0
41,182,182,30,12,18,4,3
1,191,191,8,8,0,1,0
44,196,196,91,91,0,1,0
5,199,199,2,2,0,1,0
28,207,207,26,26,0,1,0
0,208,208,34,34,0,1,0
4,219,219,22,22,0,1,0
25,226,226,27,4,23,2,1
16,235,235,1,1,0,1,0
9,235,235,16,7,9,4,3
24,242,242,14,14,0,1,0
45,246,246,37,23,14,3,2
42,253,253,11,3,8,3,2
14,255,255,15,15,0,1,0
38,264,264,3,3,0,1,0
12,280,280,4,1,3,2,1
7,283,283,15,4,11,4,3
39,293,293,39,8,31,2,1
43,294,294,6,6,0,1,0
37,311,311,35,35,0,1,0
17,323,323,15,15,0,1,0
15,324,324,14,6,8,3,2
27,332,332,2,2,0,1,0
3,334,334,29,29,0,1,0
13,336,336,16,4,12,2,1
34,339,339,95,48,47,2,1
30,351,351,31,13,18,4,3
33,374,374,7,7,0,1,0
6,391,391,15,1,14,3,2
19,397,397,1,1,0,1,0
32,426,426,15,15,0,1,0
35,431,431,31,31,0,1,0
26,441,441,20,20,0,1,0
21,443,443,1,1,0,1,0
10,449,449,49,3,46,2,1
40,461,461,2,2,0,1,0
29,489,489,9,4,5,2,1
8,490,490,187,139,48,2,1
23,497,497,14,5,9,2,1
36,500,500,40,17,23,2,1

13,114,114,6,6,0,1,0
18,123,123,34,8,26,3,2
17,123,123,13,13,0,1,0
28,124,124,12,12,0,1,0
30,132,132,13,10,3,2,1
2,134,134,1,1,0,1,0
8,151,151,29,26,3,2,1
26,154,154,8,8,0,1,0
3,161,161,6,6,0,1,0
25,179,179,13,4,9,4,3
20,182,182,25,9,16,2,1
4,209,209,58,8,50,3,2
11,218,218,33,4,29,2,1
15,227,227,6,6,0,1,0
21,234,234,5,5,0,1,0
6,241,241,3,3,0,1,0
10,243,243,81,45,36,4,3
29,245,245,32,32,0,1,0
9,280,280,22,7,15,4,3
7,283,283,26,26,0,1,0
22,283,283,48,18,30,4,3
27,313,313,11,11,0,1,0
14,317,317,97,48,49,2,1
19,322,322,5,2,3,2,1
23,377,377,9,5,4,2,1
24,380,380,29,29,0,1,0
5,399,399,103,1,102,4,3
16,400,400,66,66,0,1,0
12,453,453,17,4,13,2,1
31,461,461,12,12,0,1,0
1,487,487,22,22,0,1,0
0,498,498,114,77,37,2,1

17,108,108,1,1,0,1,0
4,114,114,1,1,0,1,0
16,120,120,3,3,0,1,0
26,130,130,3,3,0,1,0
22,140,140,2,2,0,1,0
23,148,148,32,8,24,2,1
28,165,165,11,3,8,3,2
30,177,177,23,5,18,3,2
32,180,180,22,1,21,4,3
3,187,187,26,15,11,2,1
12,202,202,1,1,0,1,0
1,205,205,20,7,13,2,1
11,213,213,61,10,51,4,3
20,232,232,39,39,0,1,0
31,256,256,1,1,0,1,0
33,278,278,89,43,46,3,2
15,289,289,5,5,0,1,0
7,296,296,1,1,0,1,0
5,298,298,39,28,11,2,1
8,301,301,16,4,12,3,2
34,302,302,71,32,39,4,3
2,313,313,53,30,23,3,2
24,338,338,8,2,6,3,2
6,339,339,85,45,40,3,2
19,387,387,90,75,15,4,3
13,410,410,49,49,0,1,0
27,425,425,11,3,8,2,1
9,426,426,1,1,0,1,0
10,432,432,48,48,0,1,0
0,439,439,131,119,12,4,3
29,470,470,10,10,0,1,0
18,472,472,54,14,40,2,1
14,485,485,42,42,0,1,0
25,490,490,52,11,41,2,1
21,493,493,1,1,0,1,0

7,104,104,22,22,0,1,0
16,121,121,1,1,0,1,0
12,134,134,10,1,9,4,3
3,154,154,8,8,0,1,0
31,170,170,23,23,0,1,0
26,183,183,32,7,25,4,3
32,195,195,2,2,0,1,0
19,207,207,10,3,7,2,1
0,211,211,48,48,0,1,0
18,214,214,17,17,0,1,0
2,238,238,32,32,0,1,0
5,239,239,51,9,42,3,2
11,263,263,35,25,10,3,2
20,264,264,41,29,12,4,3
14,279,279,31,7,24,2,1
13,306,306,10,10,0,1,0
4,317,317,17,17,0,1,0
24,327,327,73,73,0,1,0
23,330,330,28,28,0,1,0
9,355,355,75,3,72,3,2
17,355,355,7,7,0,1,0
29,361,361,43,43,0,1,0
28,369,369,7,7,0,1,0
6,394,394,26,10,16,2,1
27,404,404,101,85,16,4,3
30,412,412,6,6,0,1,0
10,425,425,4,1,3,2,1
8,427,427,13,9,4,2,1
15,447,447,22,22,0,1,0
21,461,461,8,8,0,1,0
1,483,483,116,50,66,4,3
25,487,487,117,42,75,4,3
22,496,496,93,39,54,4,3

32,115,115,25,25,0,1,0
2,127,127,9,9,0,1,0
17,146,146,1,1,0,1,0
20,148,148,15,11,4,2,1
23,163,163,5,5,0,1,0
6,175,175,37,7,30,4,3
7,178,178,49,15,34,3,2
33,190,190,3,3,0,1,0
10,196,196,2,2,0,1,0
12,207,207,12,4,8,3,2
19,226,226,57,57,0,1,0
18,229,229,61,61,0,1,0
36,251,251,14,6,8,2,1
3,253,253,27,4,23,2,1
15,254,254,6,6,0,1,0
13,254,254,29,20,9,2,1
22,257,257,37,37,0,1,0
27,266,266,17,7,10,2,1
11,287,287,50,50,0,1,0
29,300,300,21,12,9,3,2
25,300,300,4,4,0,1,0
4,303,303,21,3,18,4,3
26,304,304,29,15,14,3,2
1,316,316,3,3,0,1,0
5,317,317,27,27,0,1,0
30,331,331,25,25,0,1,0
28,338,338,95,95,0,1,0
24,358,358,8,5,3,2,1
21,395,395,67,52,15,4,3
14,428,428,13,4,9,2,1
8,439,439,40,14,26,2,1
31,449,449,11,1,10,2,1
0,462,462,57,6,51,4,3
34,463,463,78,37,41,4,3
35,464,464,11,4,7,2,1
9,469,469,8,8,0,1,0
16,490,490,28,4,24,2,1

25,104,104,2,2,0,1,0
23,135,135,5,5,0,1,0
15,143,143,8,8,0,1,0
17,148,148,4,4,0,1,0
36,151,151,18,18,0,1,0
28,153,153,5,5,0,1,0
31,157,157,14,1,13,4,3
6,163,163,10,10,0,1,0
10,176,176,21,21,0,1,0
38,206,206,25,25,0,1,0
21,224,224,9,9,0,1,0
24,229,229,42,23,19,4,3
32,231,231,35,18,17,2,1
26,273,273,1,1,0,1,0
3,293,293,23,23,0,1,0
37,302,302,65,7,58,3,2
30,307,307,9,9,0,1,0
13,310,310,3,3,0,1,0
16,323,323,99,5,94,3,2
8,330,330,1,1,0,1,0
1,352,352,45,7,38,2,1
4,353,353,27,24,3,2,1
33,367,367,63,6,57,4,3
19,372,372,38,38,0,1,0
39,384,384,7,1,6,2,1
12,385,385,52,52,0,1,0
5,399,399,66,66,0,1,0
2,404,404,26,7,19,2,1
7,407,407,77,77,0,1,0
20,428,428,80,80,0,1,0
14,432,432,11,11,0,1,0
9,441,441,4,4,0,1,0
22,447,447,90,90,0,1,0
29,452,452,43,33,10,2,1
27,456,456,33,24,9,2,1
35,459,459,89,89,0,1,0
34,469,469,44,30,14,3,2
11,472,472,1,1,0,1,0
0,479,479,3,3,0,1,0
18,484,484,6,3,3,2,1

6,126,126,18,18,0,1,0
11,155,155,59,5,54,4,3
5,170,170,43,23,20,2,1
31,172,172,33,33,0,1,0
9,179,179,7,7,0,1,0
30,182,182,5,5,0,1,0
26,193,193,13,8,5,2,1
16,213,213,13,1,12,2,1
20,239,239,14,11,3,2,1
25,256,256,93,79,14,4,3
2,260,260,65,56,9,4,3
22,271,271,8,8,0,1,0
27,278,278,7,7,0,1,0
7,284,284,21,21,0,1,0
17,320,320,73,32,41,2,1
15,340,340,38,8,30,2,1
8,344,344,24,24,0,1,0
12,362,362,1,1,0,1,0
13,380,380,10,1,9,4,3
21,383,383,2,2,0,1,0
19,384,384,20,20,0,1,0
24,391,391,9,9,0,1,0
29,399,399,11,2,9,2,1
10,406,406,42,42,0,1,0
4,407,407,27,27,0,1,0
23,414,414,67,31,36,2,1
18,414,414,23,23,0,1,0
28,417,417,32,32,0,1,0
3,451,451,78,71,7,2,1
0,463,463,2,2,0,1,0
1,465,465,32,4,28,3,2
14,472,472,69,69,0,1,0
32,485,485,125,125,0,1,0

11,118,118,11,8,3,2,1
29,119,119,11,11,0,1,0
23,129,129,10,10,0,1,0
36,138,138,9,9,0,1,0
34,139,139,5,5,0,1,0
7,155,155,39,39,0,1,0
17,183,183,18,18,0,1,0
3,195,195,6,3,3,2,1
21,199,199,62,20,42,3,2
5,207,207,26,26,0,1,0
8,249,249,25,25,0,1,0
35,258,258,11,3,8,3,2
26,262,262,10,4,6,3,2
18,269,269,2,2,0,1,0
28,275,275,56,56,0,1,0
9,277,277,28,3,25,2,1
30,284,284,73,73,0,1,0
10,286,286,70,14,56,3,2
6,289,289,58,19,39,2,1
27,292,292,42,42,0,1,0
15,309,309,41,24,17,2,1
33,310,310,16,16,0,1,0
12,331,331,3,3,0,1,0
13,331,331,20,20,0,1,0
14,340,340,16,7,9,4,3
20,352,352,47,47,0,1,0
4,356,356,10,10,0,1,0
32,359,359,7,7,0,1,0
24,363,363,26,26,0,1,0
31,373,373,13,13,0,1,0
16,374,374,46,46,0,1,0
19,382,382,34,34,0,1,0
0,384,384,5,5,0,1,0
22,413,413,2,2,0,1,0
1,425,425,16,13,3,2,1
2,426,426,3,3,0,1,0
25,454,454,86,86,0,1,0
37,469,469,31,31,0,1,0

7,120,120,36,1,35,2,1
8,133,133,4,4,0,1,0
0,137,137,1,1,0,1,0
33,138,138,14,14,0,1,0
25,140,140,9,9,0,1,0
27,156,156,8,8,0,1,0
29,168,168,26,11,15,2,1
16,168,168,17,17,0,1,0
24,205,205,2,2,0,1,0
9,212,212,6,6,0,1,0
26,213,213,9,5,4,2,1
18,229,229,39,39,0,1,0
5,233,233,1,1,0,1,0
23,237,237,28,4,24,4,3
19,240,240,7,7,0,1,0
32,250,250,102,102,0,1,0
35,252,252,68,26,42,2,1
14,270,270,8,8,0,1,0
30,292,292,12,12,0,1,0
11,293,293,63,45,18,4,3
12,300,300,92,30,62,3,2
22,309,309,12,3,9,4,3
1,333,333,68,64,4,2,1
6,336,336,43,43,0,1,0
17,367,367,12,2,10,2,1
4,385,385,9,5,4,2,1
36,386,386,70,70,0,1,0
3,387,387,14,3,11,2,1
34,392,392,10,5,5,2,1
37,424,424,10,1,9,4,3
21,427,427,38,11,27,4,3
15,456,456,1,1,0,1,0
2,463,463,14,14,0,1,0
28,473,473,32,11,21,2,1
31,473,473,53,14,39,3,2
20,486,486,21,17,4,2,1
13,489,489,22,22,0,1,0
10,495,495,38,38,0,1,0

17,105,105,2,2,0,1,0
28,114,114,7,7,0,1,0
30,127,127,45,45,0,1,0
6,150,150,1,1,0,1,0
5,156,156,3,3,0,1,0
35,158,158,12,12,0,1,0
8,159,159,52,38,14,2,1
18,180,180,15,15,0,1,0
32,184,184,5,5,0,1,0
19,194,194,1,1,0,1,0
31,209,209,44,44,0,1,0
16,217,217,2,2,0,1,0
3,218,218,9,9,0,1,0
0,223,223,18,18,0,1,0
13,224,224,96,96,0,1,0
15,224,224,52,15,37,4,3
14,230,230,6,2,4,2,1
21,239,239,11,1,10,3,2
29,247,247,13,13,0,1,0
4,274,274,24,18,6,2,1
2,284,284,10,10,0,1,0
11,294,294,5,5,0,1,0
38,318,318,6,6,0,1,0
22,321,321,22,22,0,1,0
34,323,323,99,99,0,1,0
25,333,333,17,17,0,1,0
9,341,341,11,11,0,1,0
12,345,345,14,5,9,4,3
20,361,361,4,1,3,2,1
33,391,391,28,8,20,2,1
10,392,392,62,29,33,4,3
1,396,396,36,9,27,2,1
7,400,400,20,20,0,1,0
36,403,403,33,13,20,3,2
23,439,439,13,13,0,1,0
37,441,441,6,6,0,1,0
24,444,444,5,1,4,2,1
27,452,452,88,6,82,3,2
26,468,468,76,76,0,1,0

15,101,101,1,1,0,1,0
21,116,116,12,4,8,2,1
13,136,136,30,10,20,3,2
10,141,141,16,11,5,2,1
42,154,154,13,13,0,1,0
36,182,182,12,4,8,3,2
37,188,188,3,3,0,1,0
29,198,198,3,3,0,1,0
34,225,225,6,6,0,1,0
12,225,225,30,25,5,2,1
17,225,225,12,3,9,4,3
4,237,237,14,14,0,1,0
22,255,255,13,3,10,3,2
27,256,256,26,26,0,1,0
1,259,259,11,1,10,2,1
41,264,264,23,19,4,2,1
8,280,280,4,4,0,1,0
24,292,292,1,1,0,1,0
26,308,308,74,74,0,1,0
7,311,311,11,11,0,1,0
33,313,313,2,2,0,1,0
35,336,336,129,129,0,1,0
2,338,338,24,24,0,1,0
18,341,341,46,46,0,1,0
30,341,341,37,37,0,1,0
40,344,344,38,38,0,1,0
16,356,356,1,1,0,1,0
28,379,379,6,6,0,1,0
9,380,380,1,1,0,1,0
39,386,386,68,14,54,4,3
23,387,387,14,14,0,1,0
20,394,394,13,4,9,4,3
25,400,400,16,2,14,3,2
11,400,400,67,32,35,3,2
14,403,403,18,18,0,1,0
43,424,424,4,4,0,1,0
3,424,424,7,3,4,2,1
38,446,446,20,20,0,1,0
6,447,447,54,54,0,1,0
5,461,461,71,14,57,4,3
19,470,470,7,7,0,1,0
32,471,471,31,19,12,3,2
31,489,489,135,83,52,3,2
0,490,490,60,60,0,1,0

20,104,104,34,34,0,1,0
1,115,115,29,29,0,1,0
2,146,146,17,14,3,2,1
28,161,161,21,21,0,1,0
8,187,187,9,2,7,2,1
5,190,190,15,15,0,1,0
21,194,194,5,5,0,1,0
24,199,199,8,8,0,1,0
22,211,211,19,8,11,2,1
16,251,251,2,2,0,1,0
9,256,256,28,28,0,1,0
6,263,263,38,10,28,3,2
29,269,269,24,24,0,1,0
23,271,271,39,39,0,1,0
17,272,272,9,9,0,1,0
10,273,273,46,14,32,3,2
13,293,293,23,15,8,2,1
18,354,354,44,44,0,1,0
14,356,356,101,50,51,4,3
25,360,360,14,14,0,1,0
12,361,361,7,7,0,1,0
26,362,362,27,15,12,3,2
30,382,382,45,24,21,2,1
7,383,383,39,39,0,1,0
32,393,393,59,14,45,4,3
4,441,441,79,79,0,1,0
19,443,443,72,66,6,3,2
15,445,445,63,6,57,4,3
31,450,450,63,63,0,1,0
3,462,462,22,17,5,2,1
0,466,466,55,14,41,4,3
11,473,473,26,26,0,1,0
27,481,481,1,1,0,1,0

32,105,105,8,8,0,1,0
33,108,108,9,1,8,3,2
28,117,117,4,4,0,1,0
19,117,117,24,17,7,2,1
13,150,150,1,1,0,1,0
10,152,152,15,15,0,1,0
39,175,175,52,52,0,1,0
24,190,190,4,1,3,2,1
20,200,200,63,63,0,1,0
43,208,208,60,33,27,4,3
42,218,218,5,5,0,1,0
25,225,225,12,1,11,2,1
41,226,226,20,6,14,3,2
15,233,233,5,5,0,1,0
37,233,233,6,1,5,2,1
9,243,243,7,7,0,1,0
35,246,246,13,13,0,1,0
40,261,261,20,20,0,1,0
0,269,269,1,1,0,1,0
3,280,280,9,9,0,1,0
2,282,282,20,20,0,1,0
14,284,284,78,38,40,2,1
11,289,289,1,1,0,1,0
18,308,308,43,43,0,1,0
16,309,309,16,16,0,1,0
29,313,313,4,4,0,1,0
5,314,314,26,2,24,2,1
8,331,331,2,2,0,1,0
36,338,338,58,35,23,4,3
30,375,375,24,24,0,1,0
23,381,381,12,12,0,1,0
6,394,394,18,4,14,2,1
21,396,396,4,4,0,1,0
7,398,398,57,5,52,4,3
12,400,400,16,4,12,3,2
17,403,403,24,12,12,3,2
38,404,404,98,14,84,4,3
31,437,437,96,48,48,4,3
34,441,441,5,5,0,1,0
27,448,448,30,12,18,4,3
26,460,460,2,2,0,1,0
22,474,474,2,2,0,1,0
4,492,492,6,6,0,1,0
1,497,497,21,21,0,1,0

14,107,107,12,1,11,2,1
9,117,117,29,3,26,2,1
21,123,123,3,3,0,1,0
5,132,132,1,1,0,1,0
27,138,138,29,29,0,1,0
1,140,140,1,1,0,1,0
8,180,180,35,35,0,1,0
33,188,188,103,103,0,1,0
30,195,195,12,1,11,4,3
20,203,203,15,3,12,2,1
13,229,229,18,18,0,1,0
19,240,240,35,5,30,4,3
17,267,267,13,13,0,1,0
26,278,278,1,1,0,1,0
22,281,281,4,4,0,1,0
15,304,304,105,105,0,1,0
25,309,309,1,1,0,1,0
2,315,315,52,32,20,2,1
23,352,352,40,40,0,1,0
3,355,355,30,4,26,3,2
16,366,366,10,1,9,4,3
18,381,381,2,2,0,1,0
11,381,381,2,2,0,1,0
28,388,388,11,11,0,1,0
32,392,392,7,7,0,1,0
24,414,414,20,20,0,1,0
0,416,416,7,7,0,1,0
6,417,417,11,5,6,3,2
10,425,425,6,6,0,1,0
4,427,427,50,50,0,1,0
7,438,438,123,86,37,4,3
31,471,471,177,177,0,1,0
12,482,482,47,1,46,3,2
29,493,493,46,46,0,1,0

21,103,103,23,23,0,1,0
33,103,103,10,3,7,2,1
32,132,132,3,3,0,1,0
4,163,163,29,29,0,1,0
19,187,187,15,15,0,1,0
29,195,195,37,19,18,3,2
12,201,201,28,19,9,4,3
9,216,216,22,22,0,1,0
18,228,228,17,17,0,1,0
2,248,248,36,36,0,1,0
31,269,269,3,3,0,1,0
8,279,279,69,5,64,3,2
16,279,279,83,36,47,4,3
27,282,282,8,8,0,1,0
24,293,293,45,21,24,2,1
26,306,306,59,59,0,1,0
0,307,307,51,48,3,2,1
17,317,317,70,70,0,1,0
3,323,323,5,2,3,2,1
15,337,337,13,13,0,1,0
7,341,341,5,5,0,1,0
22,365,365,12,8,4,2,1
11,377,377,16,6,10,3,2
23,394,394,15,15,0,1,0
25,430,430,3,3,0,1,0
14,446,446,15,15,0,1,0
5,456,456,196,193,3,2,1
28,458,458,1,1,0,1,0
10,464,464,2,2,0,1,0
20,465,465,3,3,0,1,0
30,466,466,75,11,64,3,2
1,485,485,2,2,0,1,0
6,487,487,73,51,22,3,2
13,495,495,45,45,0,1,0

24,108,108,4,4,0,1,0
13,108,108,21,21,0,1,0
2,114,114,17,17,0,1,0
27,138,138,3,3,0,1,0
28,143,143,3,3,0,1,0
38,155,155,8,8,0,1,0
26,163,163,28,28,0,1,0
16,179,179,22,22,0,1,0
15,183,183,1,1,0,1,0
20,193,193,1,1,0,1,0
31,203,203,8,2,6,2,1
10,209,209,1,1,0,1,0
34,234,234,60,60,0,1,0
7,235,235,40,22,18,2,1
33,243,243,7,7,0,1,0
4,247,247,53,9,44,2,1
5,252,252,76,66,10,2,1
22,270,270,17,17,0,1,0
6,283,283,7,7,0,1,0
19,284,284,14,14,0,1,0
32,291,291,27,23,4,2,1
8,294,294,1,1,0,1,0
3,298,298,15,10,5,2,1
29,299,299,19,19,0,1,0
36,302,302,112,37,75,4,3
21,304,304,54,7,47,2,1
41,313,313,12,12,0,1,0
12,330,330,1,1,0,1,0
39,343,343,3,3,0,1,0
42,350,350,8,3,5,2,1
17,368,368,2,2,0,1,0
0,369,369,13,13,0,1,0
9,369,369,3,3,0,1,0
25,374,374,57,57,0,1,0
23,377,377,28,19,9,4,3
40,389,389,29,10,19,2,1
1,395,395,3,3,0,1,0
18,401,401,32,12,20,2,1
35,402,402,155,122,33,2,1
37,402,402,1,1,0,1,0
14,454,454,2,2,0,1,0
11,456,456,8,8,0,1,0
30,489,489,15,3,12,3,2

9,103,103,25,25,0,1,0
30,103,103,13,13,0,1,0
12,118,118,25,16,9,4,3
0,128,128,1,1,0,1,0
24,130,130,66,44,22,4,3
27,133,133,11,7,4,2,1
37,157,157,17,17,0,1,0
36,160,160,23,23,0,1,0
23,169,169,3,3,0,1,0
3,189,189,2,2,0,1,0
10,211,211,54,36,18,4,3
2,213,213,1,1,0,1,0
28,214,214,4,4,0,1,0
20,225,225,54,54,0,1,0
5,228,228,1,1,0,1,0
35,249,249,4,1,3,2,1
31,251,251,79,64,15,2,1
18,258,258,30,30,0,1,0
14,263,263,30,6,24,2,1
21,274,274,1,1,0,1,0
15,277,277,58,43,15,4,3
16,290,290,1,1,0,1,0
29,295,295,26,26,0,1,0
11,300,300,1,1,0,1,0
17,303,303,1,1,0,1,0
26,326,326,12,12,0,1,0
25,335,335,16,4,12,4,3
13,336,336,6,2,4,2,1
7,340,340,4,4,0,1,0
1,356,356,4,4,0,1,0
38,384,384,80,20,60,3,2
33,387,387,9,9,0,1,0
4,415,415,35,23,12,2,1
19,422,422,34,16,18,4,3
6,424,424,67,67,0,1,0
8,425,425,4,4,0,1,0
32,479,479,31,31,0,1,0
22,494,494,1,1,0,1,0
34,494,494,12,7,5,2,1

9,100,100,46,46,0,1,0
20,129,129,6,6,0,1,0
4,137,137,30,30,0,1,0
28,146,146,12,12,0,1,0
25,159,159,16,10,6,3,2
1,160,160,26,2,24,3,2
3,161,161,30,30,0,1,0
8,180,180,17,3,14,3,2
7,216,216,45,5,40,3,2
29,220,220,10,5,5,2,1
5,221,221,2,2,0,1,0
26,249,249,57,27,30,4,3
6,258,258,39,39,0,1,0
16,262,262,1,1,0,1,0
17,264,264,24,24,0,1,0
22,268,268,15,11,4,2,1
23,275,275,24,4,20,3,2
11,293,293,32,8,24,4,3
15,300,300,20,20,0,1,0
10,314,314,4,4,0,1,0
27,343,343,69,22,47,4,3
13,351,351,117,12,105,4,3
21,374,374,1,1,0,1,0
24,375,375,11,11,0,1,0
14,378,378,73,68,5,2,1
18,416,416,51,51,0,1,0
0,420,420,4,4,0,1,0
30,441,441,53,18,35,2,1
12,459,459,57,13,44,3,2
2,459,459,25,7,18,2,1
19,492,492,11,11,0,1,0

17,120,120,1,1,0,1,0
13,143,143,21,11,10,2,1
33,144,144,14,11,3,2,1
19,144,144,2,2,0,1,0
36,145,145,4,1,3,2,1
7,149,149,48,48,0,1,0
40,157,157,2,2,0,1,0
37,176,176,14,14,0,1,0
10,178,178,14,6,8,2,1
0,179,179,10,10,0,1,0
18,184,184,8,8,0,1,0
23,185,185,44,5,39,2,1
20,227,227,6,6,0,1,0
4,229,229,19,2,17,3,2
5,249,249,14,14,0,1,0
30,262,262,3,3,0,1,0
9,286,286,25,25,0,1,0
21,310,310,79,79,0,1,0
39,317,317,17,1,16,3,2
12,325,325,14,2,12,3,2
24,352,352,19,19,0,1,0
38,357,357,58,58,0,1,0
35,359,359,64,4,60,3,2
25,361,361,64,64,0,1,0
1,364,364,35,35,0,1,0
26,364,364,39,25,14,2,1
14,367,367,1,1,0,1,0
28,387,387,33,17,16,3,2
15,393,393,47,33,14,2,1
31,423,423,8,8,0,1,0
29,425,425,10,6,4,2,1
27,427,427,46,46,0,1,0
8,427,427,17,2,15,2,1
22,430,430,27,27,0,1,0
34,432,432,39,39,0,1,0
32,437,437,135,135,0,1,0
11,438,438,34,34,0,1,0
3,448,448,1,1,0,1,0
16,454,454,12,12,0,1,0
6,456,456,26,7,19,3,2
2,477,477,46,46,0,1,0

28,119,119,12,12,0,1,0
25,121,121,21,21,0,1,0
11,128,128,29,21,8,3,2
14,131,131,17,17,0,1,0
12,153,153,27,16,11,2,1
29,157,157,5,5,0,1,0
0,182,182,2,2,0,1,0
13,184,184,16,16,0,1,0
31,185,185,26,26,0,1,0
5,207,207,19,2,17,2,1
17,214,214,13,13,0,1,0
19,215,215,1,1,0,1,0
26,217,217,5,5,0,1,0
10,226,226,37,37,0,1,0
15,227,227,24,3,21,4,3
24,252,252,29,3,26,2,1
32,270,270,31,31,0,1,0
22,273,273,21,21,0,1,0
33,282,282,11,3,8,3,2
6,289,289,19,15,4,2,1
21,307,307,62,20,42,2,1
1,316,316,20,20,0,1,0
30,329,329,13,13,0,1,0
16,331,331,34,34,0,1,0
7,350,350,62,38,24,4,3
23,354,354,90,90,0,1,0
18,368,368,71,2,69,4,3
9,405,405,48,13,35,2,1
2,411,411,27,20,7,2,1
3,413,413,7,7,0,1,0
20,417,417,52,52,0,1,0
27,434,434,17,7,10,2,1
8,454,454,52,13,39,4,3
4,470,470,89,89,0,1,0

26,104,104,1,1,0,1,0
28,129,129,12,2,10,2,1
33,131,131,14,4,10,3,2
36,147,147,26,11,15,4,3
6,161,161,22,22,0,1,0
4,164,164,8,8,0,1,0
16,179,179,9,9,0,1,0
29,195,195,2,2,0,1,0
34,201,201,4,1,3,2,1
7,203,203,26,26,0,1,0
31,223,223,47,47,0,1,0
19,240,240,70,70,0,1,0
30,243,243,5,5,0,1,0
14,243,243,13,13,0,1,0
15,259,259,1,1,0,1,0
21,277,277,4,4,0,1,0
24,286,286,9,9,0,1,0
5,300,300,38,10,28,2,1
2,301,301,4,4,0,1,0
8,318,318,34,34,0,1,0
23,323,323,61,61,0,1,0
3,328,328,60,11,49,4,3
12,352,352,55,4,51,4,3
17,357,357,85,85,0,1,0
1,385,385,49,49,0,1,0
11,399,399,11,11,0,1,0
0,406,406,48,42,6,3,2
13,406,406,19,7,12,3,2
27,415,415,25,25,0,1,0
9,422,422,53,53,0,1,0
35,422,422,32,14,18,3,2
22,434,434,52,48,4,2,1
25,445,445,11,11,0,1,0
20,459,459,52,52,0,1,0
18,463,463,10,6,4,2,1
10,468,468,42,23,19,2,1
32,478,478,132,102,30,4,3

28,129,129,5,5,0,1,0
11,135,135,1,1,0,1,0
0,151,151,5,5,0,1,0
4,157,157,19,19,0,1,0
19,160,160,21,9,12,3,2
5,199,199,40,40,0,1,0
34,224,224,21,21,0,1,0
7,238,238,22,6,16,3,2
3,255,255,11,4,7,2,1
15,259,259,5,5,0,1,0
36,262,262,22,22,0,1,0
30,268,268,21,21,0,1,0
13,301,301,23,8,15,2,1
25,307,307,42,4,38,2,1
23,310,310,3,3,0,1,0
2,315,315,68,68,0,1,0
8,317,317,55,10,45,4,3
21,317,317,23,10,13,2,1
12,319,319,22,22,0,1,0
18,322,322,137,137,0,1,0
20,338,338,140,41,99,4,3
22,338,338,26,26,0,1,0
9,347,347,11,11,0,1,0
32,374,374,29,29,0,1,0
16,375,375,1,1,0,1,0
26,380,380,81,61,20,4,3
31,386,386,44,18,26,3,2
17,402,402,22,22,0,1,0
1,402,402,32,2,30,2,1
33,411,411,14,9,5,2,1
29,459,459,12,1,11,2,1
35,480,480,88,68,20,3,2
6,485,485,40,3,37,3,2
24,487,487,7,7,0,1,0
27,492,492,16,4,12,2,1
14,493,493,13,13,0,1,0
10,499,499,23,23,0,1,0

16,113,113,3,3,0,1,0
20,115,115,17,3,14,2,1
32,124,124,3,3,0,1,0
36,140,140,2,2,0,1,0
23,156,156,72,72,0,1,0
8,158,158,27,1,26,2,1
17,160,160,24,8,16,2,1
31,175,175,28,28,0,1,0
19,176,176,16,16,0,1,0
18,183,183,3,3,0,1,0
35,187,187,28,25,3,2,1
29,199,199,2,2,0,1,0
28,208,208,11,3,8,3,2
6,224,224,1,1,0,1,0
5,225,225,5,5,0,1,0
34,240,240,22,12,10,2,1
1,253,253,13,13,0,1,0
26,254,254,8,8,0,1,0
7,257,257,12,12,0,1,0
33,275,275,12,6,6,3,2
4,276,276,19,19,0,1,0
3,277,277,17,11,6,3,2
2,290,290,36,11,25,2,1
13,299,299,30,30,0,1,0
15,318,318,43,43,0,1,0
12,319,319,75,75,0,1,0
0,327,327,38,38,0,1,0
22,327,327,39,5,34,3,2
11,339,339,16,16,0,1,0
27,350,350,23,23,0,1,0
30,376,376,68,68,0,1,0
14,382,382,76,76,0,1,0
21,405,405,14,4,10,3,2
9,418,418,75,1,74,3,2
25,423,423,37,37,0,1,0
10,474,474,22,22,0,1,0
24,476,476,34,24,10,2,1

13,141,141,13,1,12,3,2
8,147,147,25,7,18,4,3
1,162,162,10,10,0,1,0
4,202,202,23,23,0,1,0
10,208,208,3,3,0,1,0
16,223,223,2,2,0,1,0
25,223,223,33,33,0,1,0
33,228,228,2,2,0,1,0
19,260,260,84,8,76,4,3
2,262,262,31,19,12,4,3
21,282,282,2,2,0,1,0
6,287,287,9,5,4,2,1
9,290,290,44,44,0,1,0
30,290,290,5,5,0,1,0
26,311,311,41,41,0,1,0
24,317,317,57,57,0,1,0
18,317,317,1,1,0,1,0
27,321,321,5,2,3,2,1
34,322,322,26,12,14,3,2
32,332,332,98,16,82,4,3
22,333,333,31,24,7,2,1
15,337,337,32,12,20,2,1
17,356,356,39,39,0,1,0
14,358,358,25,16,9,4,3
7,369,369,26,26,0,1,0
5,369,369,13,5,8,3,2
3,373,373,5,5,0,1,0
11,395,395,90,28,62,3,2
28,408,408,2,2,0,1,0
20,410,410,88,88,0,1,0
12,419,419,134,17,117,4,3
23,421,421,29,29,0,1,0
29,434,434,7,7,0,1,0
0,454,454,95,95,0,1,0
31,474,474,54,28,26,2,1

27,122,122,4,4,0,1,0
16,122,122,2,2,0,1,0
34,124,124,26,26,0,1,0
10,150,150,5,5,0,1,0
33,161,161,29,25,4,2,1
24,165,165,60,60,0,1,0
21,186,186,4,4,0,1,0
28,191,191,1,1,0,1,0
32,198,198,4,4,0,1,0
23,207,207,1,1,0,1,0
26,210,210,2,2,0,1,0
8,210,210,8,4,4,2,1
25,218,218,66,4,62,4,3
7,223,223,17,17,0,1,0
31,224,224,73,23,50,2,1
1,226,226,1,1,0,1,0
35,229,229,2,2,0,1,0
19,236,236,14,6,8,3,2
30,241,241,6,6,0,1,0
9,268,268,10,10,0,1,0
12,268,268,37,37,0,1,0
17,268,268,62,62,0,1,0
0,280,280,3,3,0,1,0
3,319,319,29,29,0,1,0
13,360,360,52,52,0,1,0
4,363,363,74,74,0,1,0
37,393,393,67,42,25,2,1
39,397,397,3,3,0,1,0
22,404,404,21,18,3,2,1
6,410,410,19,19,0,1,0
15,410,410,40,24,16,2,1
20,416,416,53,53,0,1,0
2,420,420,45,7,38,3,2
14,423,423,20,20,0,1,0
29,453,453,24,24,0,1,0
11,453,453,7,7,0,1,0
38,454,454,22,14,8,2,1
36,455,455,3,3,0,1,0
5,461,461,102,24,78,4,3
18,498,498,16,4,12,4,3

3,109,109,7,1,6,2,1
35,119,119,1,1,0,1,0
27,119,119,3,3,0,1,0
17,138,138,73,73,0,1,0
28,138,138,12,12,0,1,0
25,159,159,5,5,0,1,0
13,167,167,18,5,13,2,1
5,186,186,5,1,4,2,1
10,188,188,33,33,0,1,0
15,188,188,21,21,0,1,0
11,217,217,26,26,0,1,0
33,224,224,41,41,0,1,0
0,243,243,53,53,0,1,0
26,252,252,55,55,0,1,0
8,266,266,53,9,44,3,2
32,288,288,53,53,0,1,0
18,297,297,30,17,13,2,1
22,340,340,80,30,50,3,2
7,349,349,2,2,0,1,0
19,373,373,21,21,0,1,0
1,384,384,38,38,0,1,0
16,400,400,1,1,0,1,0
29,405,405,82,7,75,4,3
30,407,407,92,17,75,3,2
12,411,411,6,6,0,1,0
9,417,417,4,4,0,1,0
4,419,419,18,18,0,1,0
20,420,420,16,16,0,1,0
34,432,432,57,19,38,3,2
23,434,434,21,21,0,1,0
24,446,446,5,5,0,1,0
2,457,457,3,3,0,1,0
21,485,485,7,3,4,2,1
6,487,487,26,13,13,2,1
31,488,488,12,4,8,2,1
14,492,492,10,1,9,4,3

20,101,101,14,14,0,1,0
0,115,115,4,4,0,1,0
29,123,123,16,16,0,1,0
7,140,140,7,7,0,1,0
12,146,146,58,58,0,1,0
14,152,152,10,10,0,1,0
24,155,155,15,5,10,2,1
15,160,160,10,3,7,2,1
11,198,198,20,20,0,1,0
4,202,202,12,12,0,1,0
22,209,209,36,26,10,3,2
13,233,233,64,34,30,2,1
10,241,241,72,14,58,3,2
17,265,265,18,18,0,1,0
9,277,277,70,39,31,2,1
28,279,279,1,1,0,1,0
27,300,300,28,2,26,2,1
32,300,300,93,21,72,3,2
21,331,331,26,16,10,2,1
30,333,333,2,2,0,1,0
31,336,336,6,6,0,1,0
26,336,336,17,17,0,1,0
16,357,357,28,10,18,3,2
23,358,358,101,59,42,4,3
18,370,370,17,1,16,3,2
5,380,380,20,20,0,1,0
33,391,391,39,35,4,2,1
19,396,396,63,31,32,3,2
2,397,397,12,6,6,2,1
25,398,398,12,12,0,1,0
3,422,422,4,1,3,2,1
1,429,429,13,13,0,1,0
34,456,456,28,7,21,4,3
6,459,459,1,1,0,1,0
8,463,463,1,1,0,1,0

17,111,111,14,2,12,4,3
24,141,141,9,3,6,2,1
30,142,142,7,7,0,1,0
3,147,147,17,17,0,1,0
6,165,165,14,14,0,1,0
32,172,172,2,2,0,1,0
16,173,173,58,58,0,1,0
1,179,179,1,1,0,1,0
21,183,183,51,51,0,1,0
20,190,190,38,38,0,1,0
34,200,200,22,22,0,1,0
19,215,215,4,4,0,1,0
4,220,220,16,16,0,1,0
27,224,224,1,1,0,1,0
2,250,250,3,3,0,1,0
23,254,254,24,24,0,1,0
7,268,268,26,11,15,2,1
14,273,273,65,65,0,1,0
18,280,280,8,4,4,2,1
10,281,281,3,3,0,1,0
8,293,293,17,17,0,1,0
15,295,295,29,13,16,2,1
11,296,296,12,12,0,1,0
5,309,309,42,27,15,4,3
22,325,325,14,6,8,2,1
31,326,326,29,25,4,2,1
25,346,346,38,38,0,1,0
0,347,347,32,2,30,4,3
33,367,367,27,27,0,1,0
28,368,368,13,3,10,3,2
26,378,378,124,66,58,4,3
13,384,384,70,70,0,1,0
29,422,422,73,73,0,1,0
12,423,423,19,19,0,1,0
9,462,462,82,82,0,1,0

18,102,102,2,2,0,1,0
27,107,107,47,17,30,3,2
40,119,119,10,1,9,4,3
23,121,121,7,1,6,3,2
22,123,123,6,6,0,1,0
39,125,125,1,1,0,1,0
28,127,127,18,18,0,1,0
2,143,143,10,10,0,1,0
14,147,147,13,13,0,1,0
21,171,171,2,2,0,1,0
10,212,212,11,3,8,2,1
3,220,220,12,12,0,1,0
9,240,240,59,38,21,2,1
29,248,248,18,18,0,1,0
20,260,260,18,8,10,3,2
34,274,274,7,1,6,2,1
26,276,276,11,11,0,1,0
37,280,280,26,14,12,3,2
12,282,282,11,1,10,2,1
38,303,303,17,17,0,1,0
7,309,309,2,2,0,1,0
4,315,315,9,1,8,2,1
33,321,321,9,9,0,1,0
6,323,323,4,1,3,2,1
30,324,324,64,16,48,3,2
25,326,326,25,25,0,1,0
16,333,333,74,5,69,4,3
24,355,355,5,5,0,1,0
13,358,358,16,16,0,1,0
35,358,358,13,7,6,2,1
32,387,387,9,9,0,1,0
31,392,392,15,15,0,1,0
1,399,399,42,42,0,1,0
11,417,417,3,3,0,1,0
42,418,418,93,1,92,3,2
15,431,431,82,10,72,4,3
0,457,457,5,5,0,1,0
17,465,465,139,8,131,4,3
41,469,469,18,6,12,4,3
19,481,481,9,6,3,2,1
5,487,487,27,27,0,1,0
36,493,493,107,107,0,1,0
8,499,499,15,15,0,1,0

4,103,103,1,1,0,1,0
12,106,106,9,9,0,1,0
16,111,111,9,3,6,3,2
30,114,114,5,5,0,1,0
29,120,120,25,25,0,1,0
23,167,167,12,2,10,2,1
32,170,170,20,20,0,1,0
13,172,172,41,26,15,4,3
27,181,181,13,13,0,1,0
22,183,183,14,14,0,1,0
10,207,207,95,33,62,3,2
26,216,216,13,4,9,4,3
20,225,225,1,1,0,1,0
31,231,231,37,31,6,2,1
5,256,256,6,6,0,1,0
9,260,260,51,21,30,2,1
8,296,296,5,5,0,1,0
17,316,316,4,4,0,1,0
3,320,320,12,12,0,1,0
2,332,332,14,14,0,1,0
7,363,363,5,5,0,1,0
28,367,367,149,139,10,2,1
0,367,367,25,7,18,2,1
19,385,385,28,1,27,2,1
25,403,403,63,63,0,1,0
1,424,424,95,95,0,1,0
15,429,429,75,75,0,1,0
18,441,441,13,1,12,3,2
14,441,441,50,50,0,1,0
21,446,446,42,42,0,1,0
33,456,456,3,3,0,1,0
6,471,471,37,37,0,1,0
24,478,478,81,18,63,4,3
11,493,493,10,2,8,3,2

8,111,111,14,14,0,1,0
19,121,121,9,9,0,1,0
34,135,135,7,7,0,1,0
18,160,160,19,19,0,1,0
23,179,179,56,56,0,1,0
24,219,219,9,9,0,1,0
6,222,222,5,5,0,1,0
16,235,235,32,13,19,2,1
33,240,240,10,1,9,4,3
5,243,243,35,35,0,1,0
1,254,254,27,1,26,3,2
37,254,254,1,1,0,1,0
36,266,266,11,11,0,1,0
20,266,266,79,79,0,1,0
9,271,271,18,6,12,2,1
26,279,279,4,1,3,2,1
28,296,296,55,55,0,1,0
2,303,303,59,59,0,1,0
7,309,309,17,17,0,1,0
35,322,322,3,3,0,1,0
13,332,332,13,13,0,1,0
4,333,333,3,3,0,1,0
21,366,366,43,1,42,2,1
10,378,378,31,7,24,2,1
15,393,393,29,17,12,3,2
12,399,399,155,155,0,1,0
31,400,400,30,14,16,2,1
32,412,412,6,6,0,1,0
14,427,427,18,18,0,1,0
29,434,434,68,17,51,4,3
22,443,443,4,1,3,2,1
25,444,444,76,76,0,1,0
3,453,453,16,4,12,4,3
0,455,455,14,11,3,2,1
11,463,463,7,7,0,1,0
27,481,481,12,12,0,1,0
30,484,484,129,81,48,2,1
17,486,486,20,16,4,2,1

0,101,101,8,8,0,1,0
29,109,109,3,3,0,1,0
16,129,129,12,12,0,1,0
8,143,143,16,16,0,1,0
6,155,155,56,21,35,3,2
13,172,172,27,27,0,1,0
35,174,174,6,2,4,2,1
33,175,175,19,12,7,3,2
39,176,176,3,3,0,1,0
21,181,181,19,6,13,2,1
7,199,199,8,8,0,1,0
19,219,219,53,53,0,1,0
9,225,225,1,1,0,1,0
41,233,233,24,11,13,4,3
23,241,241,7,1,6,2,1
3,263,263,30,12,18,2,1
12,272,272,5,5,0,1,0
38,289,289,18,12,6,2,1
4,300,300,13,1,12,2,1
2,310,310,5,5,0,1,0
15,319,319,11,11,0,1,0
26,338,338,94,35,59,4,3
37,339,339,25,25,0,1,0
36,349,349,19,7,12,3,2
10,352,352,22,22,0,1,0
40,357,357,3,3,0,1,0
17,361,361,26,26,0,1,0
18,361,361,5,5,0,1,0
5,371,371,15,7,8,2,1
31,375,375,64,12,52,3,2
34,381,381,8,8,0,1,0
22,400,400,1,1,0,1,0
20,404,404,22,7,15,2,1
11,409,409,4,4,0,1,0
14,429,429,17,17,0,1,0
25,437,437,20,20,0,1,0
1,439,439,25,16,9,4,3
27,439,439,83,59,24,2,1
30,440,440,161,61,100,3,2
24,460,460,15,6,9,2,1
32,464,464,32,20,12,2,1
28,483,483,84,84,0,1,0

21,101,101,15,15,0,1,0
14,107,107,8,8,0,1,0
22,112,112,7,7,0,1,0
41,134,134,9,3,6,2,1
2,136,136,2,2,0,1,0
15,153,153,15,15,0,1,0
6,159,159,18,8,10,2,1
34,160,160,1,1,0,1,0
25,190,190,33,33,0,1,0
0,195,195,21,15,6,2,1
37,206,206,13,13,0,1,0
7,209,209,7,1,6,2,1
38,221,221,28,2,26,2,1
12,237,237,15,15,0,1,0
31,266,266,3,3,0,1,0
24,268,268,14,14,0,1,0
39,270,270,4,1,3,2,1
33,272,272,20,10,10,3,2
9,296,296,63,63,0,1,0
29,300,300,36,7,29,4,3
42,304,304,63,63,0,1,0
13,308,308,37,37,0,1,0
20,308,308,32,22,10,2,1
32,309,309,14,4,10,2,1
16,340,340,2,2,0,1,0
40,355,355,12,2,10,2,1
3,355,355,29,8,21,4,3
35,369,369,174,174,0,1,0
4,391,391,28,28,0,1,0
19,392,392,51,51,0,1,0
8,396,396,12,12,0,1,0
18,406,406,27,9,18,2,1
27,418,418,2,2,0,1,0
36,424,424,34,6,28,3,2
28,435,435,12,3,9,2,1
23,445,445,4,4,0,1,0
1,463,463,34,9,25,2,1
26,463,463,14,14,0,1,0
17,475,475,30,12,18,2,1
11,486,486,12,3,9,2,1
30,492,492,134,108,26,3,2
10,492,492,9,9,0,1,0
5,496,496,10,1,9,2,1

19,100,100,1,1,0,1,0
17,109,109,4,4,0,1,0
42,121,121,3,3,0,1,0
38,122,122,4,4,0,1,0
33,127,127,80,34,46,2,1
21,132,132,22,22,0,1,0
6,133,133,6,1,5,2,1
39,139,139,1,1,0,1,0
15,161,161,2,2,0,1,0
27,161,161,2,2,0,1,0
37,167,167,17,17,0,1,0
29,189,189,13,13,0,1,0
23,193,193,4,4,0,1,0
13,193,193,2,2,0,1,0
20,209,209,22,1,21,4,3
10,209,209,12,12,0,1,0
12,212,212,1,1,0,1,0
22,218,218,4,1,3,2,1
5,221,221,6,6,0,1,0
35,239,239,34,8,26,2,1
2,245,245,35,35,0,1,0
0,255,255,98,58,40,2,1
30,283,283,7,1,6,2,1
40,290,290,56,56,0,1,0
31,291,291,31,22,9,4,3
14,303,303,18,2,16,2,1
9,305,305,4,4,0,1,0
16,323,323,6,6,0,1,0
32,328,328,13,13,0,1,0
18,340,340,5,5,0,1,0
7,346,346,12,7,5,2,1
26,368,368,49,3,46,2,1
34,373,373,28,28,0,1,0
11,382,382,19,6,13,2,1
3,399,399,12,12,0,1,0
8,405,405,43,37,6,3,2
4,420,420,54,54,0,1,0
28,422,422,19,19,0,1,0
1,433,433,15,9,6,2,1
25,463,463,16,7,9,2,1
36,474,474,29,20,9,4,3
24,484,484,130,7,123,4,3
41,500,500,62,47,15,4,3

36,102,102,22,22,0,1,0
9,102,102,11,7,4,2,1
27,117,117,18,5,13,2,1
5,122,122,11,6,5,2,1
25,125,125,10,10,0,1,0
10,137,137,2,2,0,1,0
0,138,138,22,22,0,1,0
7,141,141,13,7,6,3,2
29,147,147,2,2,0,1,0
14,190,190,16,16,0,1,0
30,199,199,2,2,0,1,0
31,201,201,1,1,0,1,0
19,204,204,11,11,0,1,0
13,226,226,35,35,0,1,0
11,258,258,11,11,0,1,0
16,270,270,7,4,3,2,1
12,275,275,48,34,14,3,2
35,285,285,23,19,4,2,1
23,297,297,64,53,11,2,1
3,309,309,54,12,42,3,2
34,313,313,55,55,0,1,0
22,329,329,3,3,0,1,0
18,349,349,34,7,27,2,1
24,350,350,24,24,0,1,0
15,357,357,1,1,0,1,0
20,369,369,92,92,0,1,0
8,370,370,10,6,4,2,1
21,372,372,30,3,27,4,3
2,380,380,38,15,23,3,2
32,396,396,49,37,12,2,1
6,397,397,41,41,0,1,0
28,408,408,41,20,21,2,1
33,426,426,68,54,14,3,2
4,429,429,95,95,0,1,0
26,455,455,18,10,8,2,1
17,469,469,16,16,0,1,0
1,471,471,44,10,34,2,1

5,101,101,1,1,0,1,0
24,109,109,3,3,0,1,0
27,112,112,12,6,6,3,2
16,135,135,1,1,0,1,0
3,138,138,54,54,0,1,0
8,146,146,3,3,0,1,0
0,192,192,19,1,18,3,2
15,196,196,26,26,0,1,0
19,200,200,21,6,15,2,1
33,218,218,26,2,24,2,1
10,227,227,7,7,0,1,0
32,234,234,40,2,38,3,2
31,239,239,35,19,16,2,1
25,261,261,16,6,10,2,1
14,264,264,14,14,0,1,0
11,273,273,78,78,0,1,0
4,280,280,42,32,10,3,2
6,294,294,2,2,0,1,0
34,298,298,55,55,0,1,0
21,312,312,4,4,0,1,0
13,329,329,40,40,0,1,0
23,348,348,50,3,47,4,3
12,353,353,47,47,0,1,0
30,370,370,14,2,12,4,3
28,373,373,6,6,0,1,0
1,382,382,1,1,0,1,0
29,403,403,3,3,0,1,0
17,414,414,66,39,27,2,1
2,437,437,24,24,0,1,0
7,440,440,68,68,0,1,0
9,451,451,69,20,49,2,1
18,458,458,60,60,0,1,0
22,470,470,131,50,81,4,3
26,476,476,47,31,16,2,1
20,487,487,12,3,9,4,3

9,108,108,18,3,15,2,1
26,110,110,4,4,0,1,0
19,147,147,9,9,0,1,0
0,151,151,11,11,0,1,0
30,152,152,2,2,0,1,0
10,177,177,2,2,0,1,0
6,184,184,2,2,0,1,0
37,187,187,39,26,13,2,1
13,198,198,20,10,10,2,1
24,203,203,16,2,14,3,2
11,217,217,13,7,6,2,1
31,223,223,32,10,22,3,2
18,228,228,8,8,0,1,0
1,243,243,71,71,0,1,0
36,252,252,28,28,0,1,0
2,264,264,12,12,0,1,0
23,271,271,43,29,14,3,2
14,285,285,11,1,10,3,2
3,302,302,3,3,0,1,0
28,320,320,19,6,13,2,1
8,327,327,21,3,18,4,3
7,337,337,2,2,0,1,0
5,350,350,57,57,0,1,0
29,350,350,1,1,0,1,0
15,351,351,16,3,13,2,1
21,356,356,24,17,7,2,1
33,363,363,69,57,12,4,3
34,376,376,34,7,27,2,1
4,377,377,63,63,0,1,0
35,378,378,20,20,0,1,0
27,412,412,27,15,12,2,1
17,443,443,70,70,0,1,0
16,450,450,7,7,0,1,0
20,452,452,1,1,0,1,0
22,455,455,21,21,0,1,0
32,463,463,58,58,0,1,0
25,472,472,88,16,72,3,2
12,476,476,99,99,0,1,0
38,479,479,27,27,0,1,0
39,498,498,103,58,45,4,3

21,118,118,43,28,15,2,1
14,122,122,16,2,14,2,1
1,124,124,61,55,6,2,1
11,136,136,27,27,0,1,0
6,156,156,4,4,0,1,0
10,160,160,35,35,0,1,0
27,186,186,22,22,0,1,0
30,202,202,9,9,0,1,0
3,206,206,17,17,0,1,0
12,210,210,5,5,0,1,0
2,212,212,1,1,0,1,0
15,219,219,18,18,0,1,0
28,245,245,26,13,13,2,1
20,251,251,17,17,0,1,0
31,258,258,7,7,0,1,0
13,270,270,26,26,0,1,0
19,274,274,65,65,0,1,0
7,290,290,4,4,0,1,0
5,308,308,6,6,0,1,0
4,316,316,84,18,66,4,3
17,322,322,16,16,0,1,0
22,333,333,72,5,67,4,3
32,344,344,8,8,0,1,0
24,362,362,6,6,0,1,0
23,417,417,13,1,12,3,2
18,422,422,81,75,6,3,2
0,427,427,5,1,4,2,1
29,444,444,11,11,0,1,0
9,455,455,76,58,18,3,2
26,465,465,54,54,0,1,0
25,472,472,49,19,30,3,2
16,489,489,4,4,0,1,0
8,500,500,25,25,0,1,0

16,127,127,2,2,0,1,0
12,132,132,58,58,0,1,0
26,143,143,9,9,0,1,0
27,172,172,17,17,0,1,0
24,180,180,3,3,0,1,0
8,186,186,11,11,0,1,0
18,187,187,1,1,0,1,0
19,194,194,21,21,0,1,0
34,198,198,25,7,18,2,1
17,201,201,2,2,0,1,0
35,207,207,4,1,3,2,1
36,210,210,1,1,0,1,0
32,229,229,23,23,0,1,0
31,230,230,52,52,0,1,0
22,234,234,8,2,6,3,2
1,242,242,50,50,0,1,0
13,243,243,8,4,4,2,1
28,249,249,12,5,7,2,1
5,263,263,19,19,0,1,0
6,267,267,8,2,6,2,1
25,297,297,83,83,0,1,0
29,315,315,2,2,0,1,0
37,330,330,8,8,0,1,0
20,332,332,51,18,33,2,1
21,352,352,2,2,0,1,0
30,372,372,59,15,44,3,2
14,372,372,2,2,0,1,0
0,378,378,135,12,123,4,3
11,388,388,5,5,0,1,0
38,392,392,51,27,24,2,1
15,418,418,1,1,0,1,0
2,422,422,24,24,0,1,0
3,422,422,15,15,0,1,0
9,423,423,41,21,20,3,2
4,424,424,18,12,6,2,1
23,429,429,68,3,65,4,3
7,434,434,11,6,5,2,1
10,436,436,15,15,0,1,0
33,479,479,157,93,64,4,3

9,106,106,12,6,6,3,2
11,106,106,5,5,0,1,0
5,121,121,28,28,0,1,0
15,123,123,19,19,0,1,0
32,133,133,22,22,0,1,0
26,140,140,20,12,8,3,2
2,147,147,25,10,15,2,1
4,148,148,13,13,0,1,0
17,157,157,5,5,0,1,0
13,171,171,4,4,0,1,0
1,177,177,17,2,15,2,1
20,182,182,1,1,0,1,0
27,244,244,16,4,12,4,3
12,266,266,1,1,0,1,0
23,291,291,6,6,0,1,0
30,294,294,100,88,12,3,2
24,304,304,73,19,54,3,2
8,324,324,64,28,36,4,3
6,329,329,110,17,93,4,3
22,333,333,43,9,34,4,3
28,343,343,5,5,0,1,0
29,359,359,54,54,0,1,0
10,377,377,20,4,16,3,2
3,383,383,1,1,0,1,0
19,423,423,30,30,0,1,0
14,424,424,35,26,9,2,1
0,434,434,33,13,20,3,2
25,439,439,31,31,0,1,0
31,445,445,33,24,9,4,3
18,449,449,6,3,3,2,1
16,452,452,40,13,27,2,1
21,469,469,29,6,23,2,1
7,493,493,139,111,28,3,2

7,120,120,40,40,0,1,0
29,143,143,11,7,4,2,1
35,148,148,2,2,0,1,0
10,159,159,26,8,18,4,3
19,167,167,3,3,0,1,0
34,169,169,6,2,4,2,1
4,179,179,5,5,0,1,0
14,204,204,7,7,0,1,0
13,204,204,24,7,17,4,3
22,208,208,1,1,0,1,0
27,226,226,8,2,6,3,2
2,228,228,32,32,0,1,0
12,246,246,14,4,10,2,1
28,262,262,90,75,15,2,1
15,263,263,20,14,6,2,1
17,272,272,1,1,0,1,0
32,279,279,51,51,0,1,0
6,294,294,8,8,0,1,0
24,300,300,52,8,44,3,2
38,301,301,5,5,0,1,0
40,306,306,13,6,7,2,1
39,317,317,19,19,0,1,0
20,319,319,16,10,6,3,2
23,328,328,11,11,0,1,0
16,348,348,1,1,0,1,0
8,352,352,29,23,6,2,1
9,360,360,8,8,0,1,0
1,361,361,11,11,0,1,0
18,376,376,10,10,0,1,0
26,383,383,2,2,0,1,0
36,391,391,137,98,39,2,1
25,391,391,1,1,0,1,0
33,453,453,44,16,28,2,1
37,455,455,124,102,22,2,1
30,458,458,20,5,15,2,1
21,461,461,61,61,0,1,0
0,469,469,27,1,26,2,1
31,472,472,25,25,0,1,0
11,475,475,78,22,56,4,3
5,487,487,22,22,0,1,0
3,495,495,91,91,0,1,0

23,120,120,2,2,0,1,0
13,132,132,3,3,0,1,0
12,134,134,1,1,0,1,0
4,166,166,15,15,0,1,0
19,168,168,16,16,0,1,0
21,171,171,11,11,0,1,0
2,174,174,12,12,0,1,0
6,174,174,5,5,0,1,0
5,177,177,17,5,12,3,2
29,194,194,35,35,0,1,0
3,196,196,18,8,10,2,1
37,204,204,44,2,42,3,2
39,223,223,16,16,0,1,0
1,233,233,10,10,0,1,0
32,233,233,1,1,0,1,0
42,237,237,79,43,36,3,2
0,237,237,44,44,0,1,0
28,259,259,9,9,0,1,0
8,261,261,30,18,12,4,3
40,265,265,14,14,0,1,0
34,278,278,32,4,28,2,1
35,291,291,36,17,19,2,1
10,294,294,8,8,0,1,0
17,306,306,14,14,0,1,0
31,311,311,8,8,0,1,0
7,324,324,64,64,0,1,0
30,329,329,1,1,0,1,0
27,331,331,8,8,0,1,0
26,331,331,73,73,0,1,0
41,331,331,3,3,0,1,0
18,395,395,2,2,0,1,0
15,397,397,21,9,12,4,3
33,408,408,20,16,4,2,1
38,411,411,47,5,42,2,1
14,417,417,59,59,0,1,0
36,423,423,5,5,0,1,0
16,450,450,1,1,0,1,0
9,453,453,49,49,0,1,0
11,460,460,22,1,21,4,3
20,467,467,9,9,0,1,0
22,476,476,50,50,0,1,0
25,491,491,115,115,0,1,0
24,495,495,61,39,22,3,2

38,104,104,2,2,0,1,0
6,109,109,13,5,8,2,1
16,119,119,7,7,0,1,0
22,120,120,8,8,0,1,0
24,128,128,32,17,15,4,3
20,133,133,10,10,0,1,0
34,151,151,19,1,18,2,1
4,165,165,6,3,3,2,1
23,169,169,16,7,9,4,3
18,170,170,37,37,0,1,0
31,210,210,6,1,5,2,1
13,235,235,17,1,16,3,2
17,244,244,10,1,9,2,1
21,250,250,26,9,17,2,1
19,252,252,56,48,8,3,2
11,258,258,19,6,13,2,1
32,267,267,7,1,6,2,1
14,271,271,14,2,12,4,3
0,283,283,23,23,0,1,0
3,293,293,13,5,8,3,2
8,322,322,23,13,10,2,1
15,323,323,8,3,5,2,1
35,342,342,50,20,30,3,2
37,347,347,67,67,0,1,0
36,351,351,46,46,0,1,0
12,366,366,34,34,0,1,0
27,366,366,19,4,15,2,1
25,375,375,64,16,48,4,3
39,376,376,23,23,0,1,0
26,385,385,113,106,7,2,1
1,393,393,3,3,0,1,0
30,412,412,1,1,0,1,0
10,415,415,22,1,21,2,1
2,422,422,3,3,0,1,0
9,434,434,31,11,20,3,2
7,453,453,116,48,68,3,2
33,466,466,8,8,0,1,0
29,475,475,39,39,0,1,0
28,492,492,42,42,0,1,0
5,495,495,10,10,0,1,0

23,105,105,2,2,0,1,0
37,106,106,4,1,3,2,1
29,116,116,17,17,0,1,0
21,124,124,7,7,0,1,0
27,128,128,3,3,0,1,0
10,151,151,11,1,10,2,1
28,154,154,3,3,0,1,0
13,154,154,2,2,0,1,0
11,159,159,8,2,6,2,1
35,164,164,2,2,0,1,0
7,170,170,12,12,0,1,0
33,181,181,14,4,10,2,1
5,197,197,36,36,0,1,0
9,218,218,9,9,0,1,0
24,220,220,13,13,0,1,0
20,222,222,2,2,0,1,0
17,224,224,62,62,0,1,0
16,241,241,29,29,0,1,0
0,247,247,27,27,0,1,0
38,250,250,42,42,0,1,0
3,257,257,1,1,0,1,0
15,265,265,34,26,8,3,2
12,269,269,2,2,0,1,0
1,310,310,32,32,0,1,0
18,314,314,8,8,0,1,0
6,345,345,5,5,0,1,0
36,383,383,6,6,0,1,0
30,384,384,11,11,0,1,0
31,391,391,145,145,0,1,0
25,395,395,35,13,22,2,1
34,397,397,85,45,40,3,2
4,398,398,14,14,0,1,0
19,416,416,85,4,81,4,3
32,417,417,130,124,6,3,2
2,420,420,37,37,0,1,0
22,427,427,40,40,0,1,0
8,428,428,61,61,0,1,0
14,466,466,47,30,17,2,1
26,481,481,46,19,27,4,3

5,102,102,10,1,9,4,3
29,106,106,6,6,0,1,0
31,118,118,2,2,0,1,0
0,121,121,1,1,0,1,0
3,137,137,1,1,0,1,0
33,151,151,18,18,0,1,0
17,169,169,19,19,0,1,0
9,181,181,2,2,0,1,0
14,183,183,7,7,0,1,0
7,192,192,51,33,18,4,3
26,199,199,24,24,0,1,0
21,207,207,8,5,3,2,1
25,207,207,12,12,0,1,0
13,213,213,20,10,10,2,1
12,223,223,39,25,14,2,1
23,238,238,72,26,46,3,2
22,239,239,23,23,0,1,0
35,246,246,11,1,10,3,2
24,249,249,23,23,0,1,0
20,253,253,57,57,0,1,0
37,258,258,41,41,0,1,0
2,265,265,14,14,0,1,0
15,265,265,93,84,9,4,3
18,271,271,12,12,0,1,0
6,289,289,31,3,28,2,1
8,306,306,7,7,0,1,0
19,326,326,9,9,0,1,0
1,334,334,17,5,12,3,2
11,337,337,84,68,16,2,1
28,349,349,31,31,0,1,0
36,349,349,8,8,0,1,0
27,369,369,34,34,0,1,0
34,389,389,91,91,0,1,0
10,395,395,11,1,10,3,2
32,401,401,15,9,6,2,1
30,403,403,11,11,0,1,0
16,484,484,19,12,7,2,1
4,498,498,9,9,0,1,0

7,105,105,13,4,9,4,3
13,113,113,8,2,6,3,2
2,115,115,4,4,0,1,0
0,127,127,44,44,0,1,0
18,162,162,5,5,0,1,0
9,209,209,9,9,0,1,0
30,210,210,32,32,0,1,0
25,213,213,52,52,0,1,0
22,222,222,22,22,0,1,0
14,223,223,16,16,0,1,0
29,226,226,20,8,12,4,3
24,231,231,29,5,24,4,3
27,237,237,5,1,4,2,1
4,262,262,47,3,44,2,1
6,266,266,93,93,0,1,0
26,269,269,1,1,0,1,0
16,272,272,30,20,10,2,1
5,287,287,16,16,0,1,0
21,313,313,31,10,21,4,3
33,325,325,53,19,34,2,1
20,326,326,26,26,0,1,0
3,344,344,19,4,15,4,3
10,349,349,1,1,0,1,0
28,350,350,32,29,3,2,1
19,354,354,7,3,4,2,1
15,359,359,8,8,0,1,0
32,384,384,6,2,4,2,1
8,410,410,38,15,23,2,1
12,416,416,88,42,46,2,1
17,432,432,119,80,39,2,1
1,440,440,43,6,37,2,1
23,458,458,30,14,16,3,2
31,491,491,70,54,16,2,1
11,496,496,22,1,21,4,3

22,102,102,2,2,0,1,0
30,105,105,30,30,0,1,0
21,110,110,47,47,0,1,0
15,139,139,17,17,0,1,0
31,149,149,1,1,0,1,0
12,155,155,10,2,8,2,1
2,163,163,18,18,0,1,0
13,172,172,4,4,0,1,0
24,183,183,2,2,0,1,0
18,197,197,1,1,0,1,0
17,199,199,21,13,8,2,1
11,203,203,1,1,0,1,0
32,216,216,21,21,0,1,0
5,238,238,8,8,0,1,0
0,257,257,57,38,19,2,1
16,264,264,15,15,0,1,0
20,275,275,31,11,20,3,2
27,275,275,52,4,48,4,3
23,292,292,11,11,0,1,0
14,305,305,13,4,9,2,1
25,316,316,32,11,21,2,1
29,316,316,23,23,0,1,0
37,327,327,77,17,60,4,3
38,334,334,21,3,18,4,3
19,337,337,20,20,0,1,0
1,347,347,11,6,5,2,1
6,362,362,27,27,0,1,0
4,374,374,159,64,95,4,3
36,388,388,9,9,0,1,0
34,393,393,9,9,0,1,0
9,421,421,3,3,0,1,0
28,424,424,49,36,13,2,1
3,443,443,80,2,78,4,3
33,448,448,1,1,0,1,0
7,451,451,18,12,6,3,2
26,463,463,41,18,23,2,1
8,472,472,15,5,10,3,2
35,491,491,22,10,12,3,2
10,499,499,24,24,0,1,0

0,118,118,12,12,0,1,0
23,120,120,18,3,15,2,1
35,128,128,24,24,0,1,0
29,134,134,38,12,26,3,2
26,152,152,2,2,0,1,0
14,155,155,16,16,0,1,0
22,159,159,6,6,0,1,0
2,208,208,1,1,0,1,0
28,232,232,4,1,3,2,1
8,234,234,22,22,0,1,0
16,234,234,9,1,8,3,2
27,266,266,5,5,0,1,0
1,267,267,41,4,37,2,1
6,270,270,10,7,3,2,1
5,283,283,57,25,32,2,1
11,312,312,2,2,0,1,0
9,313,313,21,21,0,1,0
20,338,338,36,36,0,1,0
24,342,342,69,69,0,1,0
33,362,362,28,18,10,3,2
17,364,364,46,31,15,4,3
3,367,367,63,57,6,2,1
4,372,372,95,29,66,4,3
32,387,387,76,76,0,1,0
10,419,419,69,2,67,4,3
30,429,429,34,4,30,2,1
13,433,433,27,3,24,2,1
15,437,437,4,1,3,2,1
19,441,441,33,10,23,2,1
31,448,448,72,15,57,4,3
21,470,470,23,16,7,2,1
18,471,471,49,38,11,2,1
7,480,480,85,47,38,3,2
25,485,485,33,33,0,1,0
12,489,489,13,1,12,2,1
34,493,493,7,7,0,1,0

35,101,101,32,26,6,2,1
19,108,108,9,6,3,2,1
39,118,118,32,32,0,1,0
24,126,126,3,3,0,1,0
43,129,129,6,2,4,2,1
9,132,132,3,3,0,1,0
37,141,141,19,19,0,1,0
18,147,147,14,8,6,2,1
2,154,154,10,2,8,3,2
41,156,156,15,5,10,2,1
30,156,156,1,1,0,1,0
10,169,169,7,4,3,2,1
11,180,180,18,18,0,1,0
36,182,182,27,27,0,1,0
14,207,207,15,15,0,1,0
42,208,208,9,9,0,1,0
15,237,237,17,8,9,2,1
7,242,242,2,2,0,1,0
40,244,244,6,6,0,1,0
16,248,248,28,8,20,3,2
13,250,250,12,12,0,1,0
4,263,263,33,33,0,1,0
5,270,270,14,4,10,3,2
12,282,282,29,29,0,1,0
28,283,283,42,12,30,4,3
31,285,285,70,40,30,3,2
8,324,324,61,30,31,2,1
34,334,334,30,16,14,2,1
22,339,339,5,5,0,1,0
20,344,344,2,2,0,1,0
27,345,345,17,17,0,1,0
6,371,371,1,1,0,1,0
38,379,379,14,14,0,1,0
33,393,393,42,42,0,1,0
29,399,399,10,6,4,2,1
26,407,407,5,5,0,1,0
1,417,417,7,2,5,2,1
21,449,449,26,26,0,1,0
17,462,462,14,4,10,2,1
3,463,463,5,2,3,2,1
25,464,464,28,28,0,1,0
32,465,465,16,6,10,3,2
23,470,470,33,28,5,2,1
0,486,486,155,113,42,4,3

22,110,110,4,1,3,2,1
13,113,113,10,2,8,2,1
28,119,119,4,1,3,2,1
5,121,121,12,4,8,2,1
9,128,128,7,7,0,1,0
8,129,129,28,28,0,1,0
12,134,134,1,1,0,1,0
16,149,149,27,17,10,2,1
24,163,163,25,11,14,3,2
30,172,172,3,3,0,1,0
6,183,183,25,10,15,4,3
25,194,194,14,6,8,2,1
3,205,205,9,1,8,3,2
7,231,231,23,23,0,1,0
11,276,276,1,1,0,1,0
18,284,284,58,58,0,1,0
4,305,305,40,40,0,1,0
1,334,334,158,99,59,4,3
31,336,336,18,18,0,1,0
21,340,340,15,5,10,2,1
19,341,341,3,3,0,1,0
32,382,382,32,20,12,4,3
23,382,382,6,6,0,1,0
14,389,389,29,15,14,3,2
26,403,403,95,95,0,1,0
17,407,407,32,17,15,4,3
15,438,438,90,36,54,3,2
0,439,439,99,99,0,1,0
2,446,446,16,6,10,3,2
27,453,453,58,40,18,3,2
29,453,453,101,57,44,3,2
20,478,478,30,18,12,4,3
10,499,499,55,46,9,4,3

23,107,107,2,2,0,1,0
19,112,112,13,1,12,2,1
5,123,123,4,1,3,2,1
34,133,133,2,2,0,1,0
26,163,163,5,5,0,1,0
6,175,175,8,8,0,1,0
3,177,177,2,2,0,1,0
28,178,178,47,27,20,3,2
21,184,184,4,4,0,1,0
27,184,184,35,11,24,4,3
18,199,199,10,10,0,1,0
16,202,202,8,8,0,1,0
30,204,204,56,56,0,1,0
11,232,232,9,6,3,2,1
8,233,233,46,46,0,1,0
0,243,243,52,8,44,3,2
31,255,255,42,4,38,4,3
29,264,264,13,13,0,1,0
35,300,300,13,4,9,2,1
2,312,312,35,8,27,2,1
10,317,317,9,9,0,1,0
13,325,325,3,3,0,1,0
24,335,335,31,1,30,3,2
25,340,340,20,12,8,2,1
20,355,355,4,1,3,2,1
32,358,358,8,8,0,1,0
14,359,359,16,16,0,1,0
22,392,392,5,2,3,2,1
12,394,394,4,4,0,1,0
7,421,421,15,15,0,1,0
38,426,426,4,4,0,1,0
17,431,431,101,101,0,1,0
15,440,440,23,10,13,2,1
33,440,440,122,82,40,2,1
39,444,444,8,8,0,1,0
9,459,459,73,13,60,4,3
36,462,462,118,10,108,4,3
1,468,468,139,139,0,1,0
4,494,494,20,20,0,1,0
37,494,494,21,21,0,1,0

20,116,116,7,7,0,1,0
23,142,142,1,1,0,1,0
5,150,150,7,1,6,3,2
14,152,152,19,19,0,1,0
27,157,157,34,34,0,1,0
4,163,163,3,3,0,1,0
33,171,171,1,1,0,1,0
10,174,174,12,12,0,1,0
22,177,177,13,1,12,4,3
9,223,223,31,3,28,3,2
12,223,223,16,16,0,1,0
25,238,238,16,13,3,2,1
11,257,257,20,20,0,1,0
16,262,262,13,13,0,1,0
8,271,271,7,7,0,1,0
29,282,282,23,5,18,4,3
0,299,299,63,9,54,3,2
26,317,317,7,2,5,2,1
21,320,320,23,19,4,2,1
28,330,330,9,9,0,1,0
31,357,357,24,6,18,3,2
15,370,370,28,28,0,1,0
2,383,383,47,11,36,3,2
18,387,387,12,12,0,1,0
6,397,397,86,23,63,4,3
3,424,424,20,5,15,4,3
17,428,428,7,7,0,1,0
19,437,437,143,126,17,3,2
24,447,447,39,26,13,2,1
32,450,450,72,72,0,1,0
1,464,464,68,68,0,1,0
13,473,473,80,58,22,2,1
30,474,474,220,121,99,4,3
7,492,492,118,118,0,1,0

14,102,102,1,1,0,1,0
33,104,104,5,5,0,1,0
0,107,107,12,12,0,1,0
15,108,108,29,2,27,4,3
23,117,117,9,3,6,2,1
38,138,138,22,6,16,2,1
34,138,138,22,22,0,1,0
19,142,142,26,26,0,1,0
4,171,171,5,2,3,2,1
31,184,184,13,13,0,1,0
26,192,192,28,12,16,2,1
37,197,197,21,6,15,2,1
13,233,233,45,45,0,1,0
27,246,246,27,19,8,2,1
21,259,259,20,20,0,1,0
28,265,265,73,41,32,2,1
7,271,271,25,25,0,1,0
35,274,274,8,8,0,1,0
24,278,278,3,3,0,1,0
17,282,282,28,21,7,2,1
2,291,291,4,4,0,1,0
25,299,299,69,69,0,1,0
36,302,302,47,20,27,4,3
39,311,311,11,6,5,2,1
22,312,312,19,19,0,1,0
6,313,313,3,3,0,1,0
12,327,327,27,15,12,4,3
11,362,362,35,35,0,1,0
18,363,363,35,35,0,1,0
9,381,381,2,2,0,1,0
5,389,389,22,22,0,1,0
10,411,411,7,7,0,1,0
29,413,413,29,19,10,2,1
1,416,416,22,22,0,1,0
20,423,423,44,44,0,1,0
30,443,443,41,18,23,2,1
8,466,466,30,30,0,1,0
16,470,470,63,63,0,1,0
3,471,471,2,2,0,1,0
32,497,497,5,5,0,1,0

35,115,115,11,1,10,3,2
27,127,127,5,5,0,1,0
18,136,136,2,2,0,1,0
24,138,138,1,1,0,1,0
20,138,138,3,3,0,1,0
12,142,142,1,1,0,1,0
15,144,144,15,1,14,2,1
32,149,149,19,1,18,3,2
30,181,181,6,6,0,1,0
17,191,191,45,45,0,1,0
22,195,195,2,2,0,1,0
25,201,201,39,39,0,1,0
21,206,206,48,1,47,2,1
5,216,216,8,8,0,1,0
23,224,224,1,1,0,1,0
3,230,230,37,13,24,3,2
11,236,236,16,10,6,2,1
26,241,241,5,5,0,1,0
29,249,249,1,1,0,1,0
7,251,251,52,6,46,2,1
6,272,272,15,15,0,1,0
4,289,289,32,8,24,3,2
19,299,299,52,7,45,2,1
34,317,317,8,8,0,1,0
2,336,336,30,30,0,1,0
0,351,351,118,40,78,3,2
16,375,375,92,39,53,3,2
9,397,397,4,4,0,1,0
1,400,400,6,6,0,1,0
31,431,431,210,165,45,2,1
33,446,446,112,77,35,2,1
14,450,450,4,4,0,1,0
8,463,463,37,37,0,1,0
13,464,464,13,1,12,2,1
10,471,471,1,1,0,1,0
28,492,492,46,46,0,1,0

20,102,102,9,1,8,3,2
26,104,104,7,2,5,2,1
39,135,135,17,3,14,3,2
16,149,149,7,7,0,1,0
35,154,154,1,1,0,1,0
15,156,156,5,5,0,1,0
4,161,161,11,11,0,1,0
27,163,163,36,13,23,2,1
34,172,172,63,13,50,3,2
8,184,184,5,5,0,1,0
18,203,203,22,22,0,1,0
2,206,206,86,86,0,1,0
30,207,207,16,16,0,1,0
23,214,214,12,3,9,2,1
17,226,226,31,19,12,2,1
32,237,237,26,26,0,1,0
21,250,250,6,6,0,1,0
6,255,255,34,10,24,4,3
28,259,259,49,49,0,1,0
11,260,260,1,1,0,1,0
22,263,263,6,3,3,2,1
14,269,269,8,8,0,1,0
33,285,285,8,2,6,3,2
7,308,308,1,1,0,1,0
0,319,319,45,16,29,2,1
19,331,331,18,5,13,3,2
38,364,364,18,6,12,2,1
12,383,383,10,6,4,2,1
36,391,391,5,5,0,1,0
31,402,402,22,22,0,1,0
3,404,404,53,53,0,1,0
13,422,422,20,1,19,2,1
25,427,427,102,102,0,1,0
10,435,435,19,19,0,1,0
24,446,446,38,2,36,4,3
29,452,452,39,12,27,4,3
37,466,466,22,6,16,3,2
5,467,467,14,14,0,1,0
1,495,495,75,75,0,1,0
9,499,499,28,3,25,2,1

6,115,115,23,14,9,2,1
1,119,119,2,2,0,1,0
4,120,120,8,8,0,1,0
17,134,134,13,1,12,2,1
5,138,138,11,8,3,2,1
10,143,143,7,7,0,1,0
29,143,143,2,2,0,1,0
24,145,145,24,20,4,2,1
26,149,149,40,40,0,1,0
9,153,153,8,8,0,1,0
23,161,161,24,24,0,1,0
16,198,198,1,1,0,1,0
31,219,219,69,69,0,1,0
7,236,236,10,10,0,1,0
21,257,257,66,66,0,1,0
33,265,265,17,17,0,1,0
32,282,282,4,4,0,1,0
0,309,309,23,3,20,3,2
11,313,313,14,14,0,1,0
25,321,321,76,76,0,1,0
12,331,331,22,22,0,1,0
8,332,332,9,9,0,1,0
19,358,358,3,3,0,1,0
22,367,367,28,7,21,4,3
30,370,370,2,2,0,1,0
27,381,381,13,7,6,2,1
18,413,413,36,11,25,4,3
15,423,423,88,88,0,1,0
28,437,437,1,1,0,1,0
3,448,448,192,159,33,2,1
13,463,463,98,98,0,1,0
20,466,466,21,5,16,3,2
2,475,475,58,58,0,1,0
14,488,488,54,9,45,2,1

5,117,117,1,1,0,1,0
2,153,153,17,17,0,1,0
12,181,181,8,8,0,1,0
9,184,184,38,10,28,2,1
23,189,189,10,10,0,1,0
1,200,200,15,15,0,1,0
27,204,204,1,1,0,1,0
8,205,205,1,1,0,1,0
7,219,219,48,48,0,1,0
25,226,226,79,79,0,1,0
17,235,235,50,5,45,2,1
3,250,250,105,30,75,4,3
21,256,256,66,36,30,2,1
29,257,257,61,15,46,3,2
6,263,263,1,1,0,1,0
33,272,272,28,28,0,1,0
20,277,277,4,4,0,1,0
24,338,338,7,4,3,2,1
31,344,344,26,26,0,1,0
28,355,355,9,9,0,1,0
13,366,366,47,24,23,2,1
10,390,390,5,5,0,1,0
14,392,392,168,84,84,3,2
16,400,400,81,2,79,3,2
32,402,402,68,68,0,1,0
26,411,411,9,9,0,1,0
15,413,413,8,2,6,2,1
4,415,415,19,19,0,1,0
22,416,416,8,1,7,3,2
0,436,436,19,19,0,1,0
18,449,449,3,3,0,1,0
30,453,453,15,2,13,2,1
11,482,482,14,14,0,1,0
19,495,495,12,12,0,1,0

5,105,105,10,10,0,1,0
34,111,111,22,22,0,1,0
24,112,112,6,6,0,1,0
3,119,119,10,10,0,1,0
14,151,151,15,8,7,2,1
9,164,164,9,9,0,1,0
36,167,167,30,30,0,1,0
32,181,181,9,9,0,1,0
23,184,184,6,6,0,1,0
21,202,202,11,5,6,3,2
19,208,208,37,37,0,1,0
29,217,217,82,82,0,1,0
0,225,225,8,2,6,2,1
39,230,230,66,66,0,1,0
31,233,233,20,20,0,1,0
4,236,236,9,9,0,1,0
28,236,236,26,20,6,3,2
30,237,237,8,3,5,2,1
27,262,262,3,3,0,1,0
25,267,267,8,8,0,1,0
8,277,277,1,1,0,1,0
10,287,287,29,12,17,2,1
22,294,294,21,21,0,1,0
20,320,320,18,18,0,1,0
16,322,322,79,23,56,3,2
12,331,331,11,11,0,1,0
6,347,347,33,33,0,1,0
26,352,352,2,2,0,1,0
18,353,353,16,16,0,1,0
15,380,380,48,48,0,1,0
38,386,386,11,8,3,2,1
40,400,400,1,1,0,1,0
35,419,419,57,47,10,2,1
33,434,434,8,8,0,1,0
7,457,457,59,1,58,3,2
17,463,463,9,9,0,1,0
37,468,468,11,8,3,2,1
13,469,469,5,5,0,1,0
1,483,483,4,4,0,1,0
41,488,488,98,98,0,1,0
2,490,490,4,4,0,1,0
11,495,495,87,87,0,1,0

29,104,104,12,12,0,1,0
5,105,105,10,10,0,1,0
0,107,107,21,21,0,1,0
10,109,109,37,19,18,2,1
13,126,126,2,2,0,1,0
15,134,134,19,19,0,1,0
33,143,143,26,16,10,3,2
32,144,144,24,19,5,2,1
27,166,166,50,32,18,3,2
36,167,167,1,1,0,1,0
24,217,217,1,1,0,1,0
7,218,218,3,3,0,1,0
3,228,228,10,10,0,1,0
26,237,237,21,21,0,1,0
22,256,256,5,5,0,1,0
9,288,288,18,18,0,1,0
17,289,289,26,26,0,1,0
28,290,290,33,33,0,1,0
11,294,294,12,12,0,1,0
25,301,301,5,5,0,1,0
12,306,306,24,16,8,3,2
8,307,307,10,10,0,1,0
20,323,323,35,35,0,1,0
34,324,324,69,69,0,1,0
1,326,326,9,3,6,2,1
19,345,345,14,14,0,1,0
21,367,367,44,44,0,1,0
18,407,407,3,3,0,1,0
14,416,416,63,13,50,3,2
6,426,426,57,57,0,1,0
4,429,429,20,3,17,2,1
16,435,435,74,52,22,2,1
35,442,442,36,30,6,3,2
30,453,453,18,6,12,3,2
31,455,455,23,23,0,1,0
2,461,461,53,2,51,4,3
23,490,490,82,62,20,3,2

17,108,108,16,16,0,1,0
4,123,123,1,1,0,1,0
2,125,125,7,7,0,1,0
38,126,126,14,3,11,2,1
3,149,149,31,10,21,2,1
6,181,181,8,8,0,1,0
20,187,187,41,25,16,3,2
33,217,217,24,8,16,3,2
16,228,228,31,31,0,1,0
29,229,229,5,1,4,2,1
14,252,252,1,1,0,1,0
10,259,259,13,7,6,3,2
19,259,259,10,10,0,1,0
39,273,273,5,5,0,1,0
35,289,289,21,9,12,4,3
37,296,296,147,92,55,3,2
23,302,302,19,1,18,2,1
13,310,310,20,14,6,3,2
26,326,326,37,37,0,1,0
7,327,327,4,4,0,1,0
34,336,336,19,19,0,1,0
24,344,344,21,9,12,4,3
40,350,350,17,2,15,4,3
18,355,355,11,11,0,1,0
41,360,360,16,16,0,1,0
36,361,361,179,151,28,3,2
22,363,363,29,29,0,1,0
11,367,367,1,1,0,1,0
12,381,381,86,86,0,1,0
1,390,390,15,15,0,1,0
28,392,392,16,16,0,1,0
21,406,406,31,31,0,1,0
31,408,408,9,9,0,1,0
27,409,409,16,16,0,1,0
15,439,439,1,1,0,1,0
32,453,453,15,15,0,1,0
9,457,457,9,1,8,2,1
30,461,461,10,10,0,1,0
0,463,463,37,27,10,2,1
8,469,469,6,6,0,1,0
25,473,473,10,2,8,2,1
5,474,474,85,85,0,1,0

20,101,101,6,6,0,1,0
0,110,110,7,3,4,2,1
28,131,131,28,28,0,1,0
41,146,146,16,16,0,1,0
10,194,194,32,22,10,2,1
8,195,195,5,5,0,1,0
36,197,197,41,3,38,3,2
40,210,210,5,5,0,1,0
9,214,214,3,3,0,1,0
18,222,222,1,1,0,1,0
19,225,225,22,22,0,1,0
37,240,240,20,20,0,1,0
38,240,240,7,7,0,1,0
24,249,249,7,1,6,3,2
32,255,255,17,17,0,1,0
4,257,257,36,17,19,3,2
29,268,268,9,9,0,1,0
26,271,271,61,61,0,1,0
39,275,275,48,48,0,1,0
7,280,280,2,2,0,1,0
12,292,292,5,2,3,2,1
27,295,295,31,31,0,1,0
14,307,307,1,1,0,1,0
6,310,310,16,16,0,1,0
15,340,340,58,36,22,2,1
22,345,345,8,2,6,3,2
13,347,347,29,11,18,4,3
2,350,350,19,19,0,1,0
16,370,370,21,21,0,1,0
3,386,386,16,9,7,2,1
31,387,387,16,4,12,2,1
23,406,406,26,26,0,1,0
25,412,412,54,30,24,4,3
1,414,414,47,35,12,4,3
17,426,426,127,127,0,1,0
11,428,428,53,22,31,2,1
34,430,430,5,2,3,2,1
21,457,457,22,22,0,1,0
33,467,467,111,57,54,3,2
30,479,479,49,49,0,1,0
5,482,482,36,8,28,3,2
35,498,498,3,3,0,1,0

20,105,105,2,2,0,1,0
5,108,108,2,2,0,1,0
0,126,126,49,49,0,1,0
10,139,139,4,4,0,1,0
18,151,151,9,9,0,1,0
15,162,162,25,12,13,2,1
4,194,194,38,38,0,1,0
26,214,214,9,9,0,1,0
2,220,220,53,45,8,3,2
21,224,224,4,4,0,1,0
11,238,238,17,17,0,1,0
3,260,260,14,3,11,4,3
6,266,266,62,62,0,1,0
23,273,273,59,45,14,2,1
12,276,276,42,42,0,1,0
24,279,279,6,6,0,1,0
9,292,292,71,71,0,1,0
14,299,299,21,21,0,1,0
17,310,310,40,14,26,3,2
25,336,336,117,18,99,4,3
13,346,346,68,68,0,1,0
22,355,355,7,7,0,1,0
8,392,392,43,11,32,3,2
27,401,401,64,64,0,1,0
16,435,435,41,26,15,4,3
1,442,442,90,57,33,4,3
19,456,456,31,13,18,2,1
28,466,466,3,3,0,1,0
7,499,499,43,19,24,2,1

16,105,105,10,7,3,2,1
26,107,107,55,55,0,1,0
37,108,108,8,8,0,1,0
28,111,111,1,1,0,1,0
31,120,120,2,2,0,1,0
18,138,138,6,1,5,2,1
15,149,149,13,13,0,1,0
7,154,154,13,13,0,1,0
27,155,155,13,13,0,1,0
5,155,155,1,1,0,1,0
30,165,165,6,6,0,1,0
0,174,174,29,21,8,2,1
3,180,180,5,5,0,1,0
10,189,189,13,13,0,1,0
1,195,195,21,7,14,2,1
8,232,232,24,4,20,2,1
4,234,234,17,9,8,2,1
24,238,238,27,14,13,2,1
6,257,257,21,21,0,1,0
38,269,269,25,25,0,1,0
17,292,292,41,19,22,3,2
25,295,295,24,9,15,3,2
33,301,301,5,5,0,1,0
22,316,316,4,4,0,1,0
20,319,319,24,4,20,2,1
32,323,323,7,7,0,1,0
19,346,346,31,31,0,1,0
14,368,368,49,49,0,1,0
9,371,371,40,40,0,1,0
11,373,373,26,8,18,2,1
12,378,378,45,45,0,1,0
2,390,390,33,33,0,1,0
29,391,391,67,67,0,1,0
36,401,401,28,6,22,2,1
35,424,424,119,47,72,3,2
21,437,437,19,19,0,1,0
34,452,452,49,49,0,1,0
23,472,472,47,47,0,1,0
13,487,487,17,6,11,2,1

13,112,112,4,1,3,2,1
32,121,121,5,5,0,1,0
7,123,123,31,31,0,1,0
5,130,130,20,8,12,2,1
12,136,136,2,2,0,1,0
3,148,148,7,1,6,2,1
30,165,165,9,9,0,1,0
23,207,207,32,32,0,1,0
31,211,211,5,1,4,2,1
28,237,237,11,1,10,3,2
8,240,240,38,38,0,1,0
1,257,257,4,4,0,1,0
17,268,268,7,7,0,1,0
6,276,276,78,78,0,1,0
10,284,284,31,31,0,1,0
11,287,287,65,65,0,1,0
2,289,289,4,4,0,1,0
22,292,292,58,12,46,3,2
18,312,312,48,18,30,2,1
21,344,344,16,5,11,2,1
15,346,346,72,72,0,1,0
33,354,354,14,8,6,2,1
26,355,355,27,27,0,1,0
19,356,356,70,70,0,1,0
29,387,387,103,1,102,4,3
0,397,397,1,1,0,1,0
14,407,407,46,46,0,1,0
25,407,407,25,8,17,2,1
9,429,429,37,7,30,3,2
16,453,453,10,10,0,1,0
24,458,458,63,63,0,1,0
34,462,462,88,69,19,2,1
4,475,475,28,28,0,1,0
20,477,477,20,20,0,1,0
27,500,500,37,9,28,2,1

25,108,108,21,21,0,1,0
19,108,108,28,28,0,1,0
22,122,122,18,18,0,1,0
2,126,126,24,24,0,1,0
31,128,128,4,4,0,1,0
16,133,133,1,1,0,1,0
1,134,134,9,2,7,2,1
20,179,179,3,3,0,1,0
12,187,187,1,1,0,1,0
21,198,198,24,24,0,1,0
34,209,209,11,3,8,2,1
26,225,225,39,39,0,1,0
4,232,232,3,3,0,1,0
29,237,237,36,32,4,2,1
5,277,277,22,22,0,1,0
14,281,281,68,50,18,4,3
32,283,283,24,24,0,1,0
15,313,313,25,5,20,3,2
18,316,316,23,23,0,1,0
8,350,350,159,159,0,1,0
35,352,352,29,1,28,2,1
17,354,354,31,15,16,3,2
11,356,356,15,9,6,3,2
13,359,359,4,4,0,1,0
27,367,367,35,4,31,2,1
30,371,371,23,6,17,2,1
9,374,374,4,4,0,1,0
10,394,394,6,6,0,1,0
3,419,419,10,10,0,1,0
24,423,423,28,13,15,2,1
6,449,449,186,165,21,2,1
7,469,469,17,17,0,1,0
33,473,473,12,2,10,2,1
28,489,489,50,50,0,1,0
23,493,493,48,27,21,3,2
0,499,499,10,10,0,1,0

1,108,108,7,7,0,1,0
2,111,111,17,17,0,1,0
16,112,112,3,3,0,1,0
12,132,132,2,2,0,1,0
19,147,147,28,18,10,3,2
18,161,161,34,9,25,2,1
0,165,165,9,9,0,1,0
17,175,175,8,8,0,1,0
20,184,184,53,44,9,4,3
4,194,194,48,48,0,1,0
14,203,203,1,1,0,1,0
23,234,234,10,10,0,1,0
29,245,245,5,5,0,1,0
25,255,255,18,18,0,1,0
8,274,274,31,21,10,3,2
15,274,274,7,3,4,2,1
7,291,291,34,34,0,1,0
3,305,305,130,130,0,1,0
26,316,316,6,6,0,1,0
10,339,339,77,43,34,3,2
6,348,348,1,1,0,1,0
13,349,349,18,18,0,1,0
24,356,356,52,38,14,3,2
28,360,360,17,3,14,2,1
21,368,368,89,38,51,4,3
22,376,376,127,65,62,4,3
11,394,394,2,2,0,1,0
27,398,398,12,12,0,1,0
30,430,430,16,6,10,3,2
5,433,433,78,48,30,4,3
9,453,453,89,89,0,1,0

37,105,105,5,5,0,1,0
30,106,106,4,4,0,1,0
19,114,114,13,5,8,2,1
7,115,115,5,5,0,1,0
15,119,119,11,1,10,3,2
6,137,137,12,2,10,3,2
1,154,154,1,1,0,1,0
33,166,166,40,40,0,1,0
24,196,196,5,5,0,1,0
23,196,196,16,6,10,2,1
3,199,199,5,5,0,1,0
28,201,201,30,30,0,1,0
34,213,213,9,9,0,1,0
26,220,220,44,23,21,4,3
41,223,223,67,50,17,2,1
11,225,225,1,1,0,1,0
8,242,242,7,7,0,1,0
2,244,244,28,16,12,3,2
21,257,257,4,4,0,1,0
20,269,269,2,2,0,1,0
42,273,273,11,11,0,1,0
29,277,277,72,34,38,2,1
0,279,279,18,13,5,2,1
13,280,280,6,6,0,1,0
18,283,283,14,14,0,1,0
32,313,313,19,1,18,2,1
16,317,317,85,85,0,1,0
17,323,323,7,1,6,2,1
38,338,338,1,1,0,1,0
22,350,350,8,8,0,1,0
39,354,354,10,10,0,1,0
12,360,360,77,38,39,2,1
5,376,376,19,11,8,3,2
4,385,385,30,30,0,1,0
14,393,393,63,53,10,3,2
40,401,401,40,40,0,1,0
9,402,402,1,1,0,1,0
36,404,404,4,4,0,1,0
10,419,419,84,46,38,2,1
25,452,452,43,6,37,2,1
31,467,467,48,5,43,2,1
27,469,469,44,11,33,2,1
35,486,486,16,8,8,2,1

6,103,103,19,19,0,1,0
3,129,129,1,1,0,1,0
11,146,146,14,14,0,1,0
12,147,147,4,4,0,1,0
14,153,153,86,8,78,3,2
1,160,160,1,1,0,1,0
32,179,179,43,5,38,3,2
16,184,184,7,7,0,1,0
23,184,184,2,2,0,1,0
13,195,195,38,38,0,1,0
34,196,196,12,12,0,1,0
29,210,210,100,64,36,4,3
31,215,215,11,11,0,1,0
8,225,225,5,1,4,2,1
28,229,229,4,4,0,1,0
9,250,250,40,40,0,1,0
10,252,252,12,12,0,1,0
33,286,286,14,14,0,1,0
21,290,290,4,4,0,1,0
20,330,330,22,2,20,2,1
5,333,333,8,5,3,2,1
25,345,345,56,56,0,1,0
2,354,354,20,5,15,4,3
24,358,358,6,6,0,1,0
15,363,363,5,5,0,1,0
7,364,364,22,10,12,2,1
26,364,364,50,50,0,1,0
30,366,366,44,44,0,1,0
18,381,381,64,64,0,1,0
27,384,384,24,5,19,2,1
17,385,385,10,4,6,2,1
0,437,437,99,99,0,1,0
22,472,472,20,11,9,2,1
19,488,488,53,35,18,4,3
4,496,496,38,38,0,1,0

34,109,109,1,1,0,1,0
10,111,111,5,1,4,2,1
22,122,122,6,6,0,1,0
15,124,124,43,43,0,1,0
33,163,163,9,9,0,1,0
20,186,186,1,1,0,1,0
1,216,216,32,32,0,1,0
31,222,222,52,2,50,3,2
25,228,228,9,2,7,2,1
11,229,229,10,10,0,1,0
19,231,231,27,12,15,4,3
0,234,234,10,1,9,3,2
28,241,241,13,13,0,1,0
3,244,244,6,6,0,1,0
30,253,253,81,72,9,4,3
2,277,277,21,3,18,3,2
6,284,284,15,15,0,1,0
14,299,299,14,4,10,2,1
13,300,300,77,67,10,3,2
26,305,305,26,8,18,3,2
29,313,313,80,80,0,1,0
5,354,354,24,9,15,4,3
16,363,363,8,2,6,2,1
8,372,372,14,6,8,2,1
24,378,378,81,35,46,2,1
23,388,388,7,7,0,1,0
35,394,394,51,11,40,2,1
7,398,398,97,45,52,3,2
21,405,405,10,5,5,2,1
32,409,409,25,25,0,1,0
17,412,412,38,20,18,4,3
12,424,424,29,17,12,2,1
18,433,433,48,2,46,3,2
27,453,453,23,11,12,3,2
4,458,458,43,43,0,1,0
9,461,461,43,25,18,2,1

19,126,126,30,15,15,2,1
13,158,158,24,24,0,1,0
6,181,181,50,21,29,2,1
3,181,181,3,3,0,1,0
30,201,201,39,39,0,1,0
17,209,209,28,28,0,1,0
9,228,228,15,15,0,1,0
33,245,245,5,5,0,1,0
28,248,248,6,6,0,1,0
5,248,248,21,21,0,1,0
23,264,264,39,39,0,1,0
25,275,275,8,8,0,1,0
22,283,283,28,19,9,2,1
31,284,284,27,21,6,3,2
27,287,287,39,39,0,1,0
0,289,289,19,19,0,1,0
32,299,299,32,24,8,2,1
12,300,300,10,10,0,1,0
7,304,304,75,39,36,3,2
15,304,304,23,23,0,1,0
18,306,306,41,34,7,2,1
34,328,328,21,21,0,1,0
14,330,330,83,83,0,1,0
29,337,337,34,22,12,4,3
24,343,343,1,1,0,1,0
35,360,360,12,12,0,1,0
1,361,361,19,19,0,1,0
20,363,363,57,57,0,1,0
21,373,373,37,37,0,1,0
16,375,375,14,1,13,2,1
2,409,409,16,16,0,1,0
4,432,432,73,73,0,1,0
26,446,446,66,40,26,3,2
11,469,469,33,33,0,1,0
10,482,482,2,2,0,1,0
8,482,482,14,14,0,1,0

28,107,107,2,2,0,1,0
4,117,117,4,4,0,1,0
3,120,120,4,1,3,2,1
30,126,126,15,15,0,1,0
19,138,138,12,12,0,1,0
24,150,150,16,4,12,4,3
1,153,153,17,17,0,1,0
37,170,170,6,6,0,1,0
21,173,173,25,4,21,3,2
14,200,200,34,34,0,1,0
10,203,203,11,11,0,1,0
2,206,206,48,48,0,1,0
18,252,252,6,6,0,1,0
23,256,256,79,67,12,4,3
12,265,265,17,3,14,3,2
29,271,271,2,2,0,1,0
32,274,274,28,28,0,1,0
35,279,279,11,11,0,1,0
20,287,287,54,54,0,1,0
36,294,294,1,1,0,1,0
17,295,295,19,6,13,2,1
34,309,309,3,3,0,1,0
9,314,314,12,12,0,1,0
26,316,316,39,39,0,1,0
7,327,327,4,1,3,2,1
15,336,336,6,6,0,1,0
31,354,354,6,6,0,1,0
33,361,361,69,69,0,1,0
16,368,368,4,4,0,1,0
8,395,395,6,6,0,1,0
6,401,401,82,54,28,2,1
13,408,408,5,5,0,1,0
25,414,414,18,12,6,3,2
0,420,420,76,60,16,2,1
27,461,461,150,150,0,1,0
5,471,471,189,124,65,3,2
22,474,474,26,11,15,2,1
11,476,476,18,3,15,2,1

23,111,111,17,17,0,1,0
15,124,124,15,15,0,1,0
29,138,138,42,42,0,1,0
31,145,145,3,3,0,1,0
28,147,147,28,6,22,3,2
21,160,160,43,16,27,2,1
18,166,166,3,3,0,1,0
9,169,169,33,15,18,3,2
25,182,182,22,22,0,1,0
22,185,185,2,2,0,1,0
30,187,187,6,6,0,1,0
4,189,189,1,1,0,1,0
24,193,193,3,3,0,1,0
16,195,195,9,9,0,1,0
20,198,198,20,4,16,3,2
12,205,205,93,93,0,1,0
11,206,206,19,19,0,1,0
14,207,207,29,29,0,1,0
1,241,241,15,2,13,2,1
19,244,244,6,1,5,2,1
7,248,248,1,1,0,1,0
2,279,279,16,1,15,2,1
10,313,313,52,46,6,2,1
6,318,318,1,1,0,1,0
26,329,329,39,39,0,1,0
32,373,373,38,38,0,1,0
13,401,401,113,33,80,3,2
5,411,411,4,4,0,1,0
27,417,417,49,24,25,2,1
8,435,435,2,2,0,1,0
17,443,443,36,22,14,2,1
3,482,482,92,29,63,4,3
0,492,492,67,26,41,4,3

33,105,105,15,10,5,2,1
6,106,106,5,5,0,1,0
39,121,121,2,2,0,1,0
3,127,127,15,6,9,2,1
9,133,133,18,8,10,3,2
30,156,156,13,13,0,1,0
40,173,173,39,39,0,1,0
20,176,176,1,1,0,1,0
0,194,194,1,1,0,1,0
19,200,200,2,2,0,1,0
10,207,207,9,3,6,3,2
5,209,209,2,2,0,1,0
27,226,226,7,7,0,1,0
14,236,236,14,1,13,2,1
1,269,269,9,3,6,3,2
4,271,271,30,30,0,1,0
36,275,275,110,44,66,4,3
22,289,289,21,21,0,1,0
25,289,289,40,18,22,3,2
12,302,302,24,24,0,1,0
29,304,304,13,13,0,1,0
16,308,308,16,16,0,1,0
11,322,322,37,37,0,1,0
2,327,327,2,2,0,1,0
37,327,327,11,11,0,1,0
32,341,341,29,18,11,2,1
31,345,345,11,6,5,2,1
28,345,345,66,66,0,1,0
8,375,375,4,4,0,1,0
34,378,378,5,5,0,1,0
21,379,379,91,91,0,1,0
15,389,389,2,2,0,1,0
26,404,404,74,74,0,1,0
35,412,412,45,6,39,4,3
18,415,415,114,114,0,1,0
23,424,424,24,16,8,2,1
24,439,439,19,19,0,1,0
38,466,466,4,4,0,1,0
13,476,476,6,6,0,1,0
7,481,481,141,118,23,4,3
17,496,496,31,2,29,2,1

17,106,106,23,23,0,1,0
2,146,146,22,22,0,1,0
25,150,150,20,20,0,1,0
34,159,159,32,32,0,1,0
20,168,168,22,22,0,1,0
29,169,169,6,6,0,1,0
30,171,171,5,5,0,1,0
9,172,172,33,33,0,1,0
7,181,181,13,13,0,1,0
15,182,182,1,1,0,1,0
5,184,184,3,3,0,1,0
32,216,216,5,5,0,1,0
10,228,228,14,14,0,1,0
11,237,237,24,24,0,1,0
13,240,240,16,10,6,3,2
3,245,245,7,4,3,2,1
22,247,247,41,41,0,1,0
39,249,249,12,12,0,1,0
28,260,260,17,4,13,2,1
36,270,270,7,7,0,1,0
8,292,292,5,5,0,1,0
31,293,293,119,81,38,2,1
16,295,295,25,25,0,1,0
35,303,303,15,15,0,1,0
0,308,308,20,11,9,2,1
33,312,312,15,1,14,3,2
6,318,318,27,2,25,2,1
27,323,323,60,60,0,1,0
18,334,334,26,18,8,2,1
19,344,344,7,7,0,1,0
12,361,361,15,7,8,3,2
37,362,362,19,19,0,1,0
4,407,407,81,44,37,3,2
26,407,407,2,2,0,1,0
23,426,426,61,61,0,1,0
38,429,429,78,78,0,1,0
21,461,461,15,3,12,3,2
1,474,474,9,9,0,1,0
24,494,494,17,8,9,2,1
14,500,500,58,15,43,2,1

20,104,104,4,4,0,1,0
24,116,116,15,3,12,4,3
0,121,121,3,3,0,1,0
28,142,142,8,8,0,1,0
25,145,145,14,14,0,1,0
29,160,160,12,2,10,2,1
10,177,177,49,49,0,1,0
23,195,195,6,6,0,1,0
3,204,204,32,14,18,3,2
15,205,205,2,2,0,1,0
16,212,212,33,7,26,2,1
2,213,213,13,13,0,1,0
6,236,236,23,23,0,1,0
26,253,253,39,39,0,1,0
14,257,257,40,40,0,1,0
4,260,260,45,11,34,4,3
19,266,266,1,1,0,1,0
8,295,295,59,59,0,1,0
5,322,322,91,20,71,4,3
12,351,351,9,2,7,3,2
27,372,372,6,6,0,1,0
1,375,375,108,6,102,4,3
13,398,398,145,101,44,2,1
30,413,413,50,5,45,2,1
9,422,422,29,13,16,2,1
22,443,443,48,43,5,2,1
11,445,445,20,20,0,1,0
7,489,489,49,35,14,3,2
21,493,493,50,28,22,3,2
18,495,495,61,24,37,2,1
17,495,495,45,45,0,1,0

25,133,133,21,21,0,1,0
12,134,134,14,11,3,2,1
6,140,140,30,18,12,4,3
0,146,146,22,1,21,4,3
5,151,151,4,4,0,1,0
28,178,178,66,15,51,3,2
19,184,184,1,1,0,1,0
10,229,229,16,16,0,1,0
13,240,240,9,9,0,1,0
23,244,244,68,25,43,2,1
24,245,245,53,53,0,1,0
16,254,254,1,1,0,1,0
26,268,268,32,14,18,3,2
1,271,271,5,5,0,1,0
7,274,274,32,32,0,1,0
22,295,295,38,13,25,4,3
8,327,327,107,74,33,2,1
14,330,330,12,9,3,2,1
18,346,346,48,13,35,2,1
17,361,361,8,8,0,1,0
9,365,365,16,16,0,1,0
4,384,384,107,25,82,3,2
20,407,407,40,16,24,4,3
2,428,428,107,80,27,4,3
11,437,437,36,12,24,4,3
27,439,439,6,6,0,1,0
21,450,450,7,7,0,1,0
3,468,468,143,35,108,4,3
15,474,474,5,5,0,1,0

5,101,101,1,1,0,1,0
34,110,110,1,1,0,1,0
11,120,120,1,1,0,1,0
17,136,136,26,23,3,2,1
16,137,137,1,1,0,1,0
15,137,137,6,6,0,1,0
1,151,151,41,18,23,2,1
29,152,152,2,2,0,1,0
10,155,155,4,1,3,2,1
38,169,169,3,3,0,1,0
8,180,180,53,33,20,2,1
35,189,189,53,14,39,2,1
4,189,189,5,5,0,1,0
33,195,195,12,12,0,1,0
13,197,197,15,15,0,1,0
37,214,214,24,6,18,2,1
19,228,228,25,7,18,3,2
32,253,253,27,27,0,1,0
26,253,253,4,4,0,1,0
31,261,261,53,17,36,2,1
28,262,262,17,7,10,2,1
23,268,268,14,14,0,1,0
2,280,280,3,3,0,1,0
18,280,280,9,9,0,1,0
25,286,286,27,9,18,3,2
36,286,286,28,28,0,1,0
12,287,287,15,6,9,2,1
22,310,310,2,2,0,1,0
20,313,313,25,25,0,1,0
14,320,320,20,3,17,2,1
21,339,339,54,42,12,3,2
0,345,345,39,11,28,3,2
6,354,354,19,12,7,2,1
9,369,369,48,13,35,2,1
3,375,375,48,2,46,3,2
27,461,461,208,67,141,4,3
24,480,480,44,6,38,3,2
7,487,487,37,24,13,2,1
30,500,500,1,1,0,1,0

2,101,101,3,3,0,1,0
23,123,123,4,4,0,1,0
1,128,128,1,1,0,1,0
29,133,133,6,6,0,1,0
18,136,136,8,8,0,1,0
0,147,147,12,1,11,2,1
8,163,163,23,23,0,1,0
5,183,183,21,7,14,3,2
25,206,206,6,6,0,1,0
22,214,214,70,24,46,2,1
35,220,220,19,19,0,1,0
24,253,253,35,35,0,1,0
9,265,265,16,16,0,1,0
12,271,271,5,5,0,1,0
10,278,278,1,1,0,1,0
20,301,301,117,29,88,4,3
31,304,304,40,40,0,1,0
3,310,310,4,4,0,1,0
33,319,319,13,13,0,1,0
34,320,320,2,2,0,1,0
17,324,324,79,62,17,2,1
28,329,329,6,6,0,1,0
16,333,333,17,17,0,1,0
7,338,338,40,10,30,3,2
4,364,364,54,26,28,3,2
19,402,402,22,22,0,1,0
32,403,403,37,34,3,2,1
11,411,411,21,21,0,1,0
14,423,423,6,1,5,2,1
26,441,441,28,28,0,1,0
30,463,463,85,85,0,1,0
27,466,466,43,43,0,1,0
36,472,472,30,30,0,1,0
15,476,476,5,5,0,1,0
13,478,478,207,207,0,1,0
21,482,482,17,17,0,1,0
6,489,489,101,13,88,4,3

5,116,116,4,4,0,1,0
15,134,134,12,2,10,2,1
35,137,137,1,1,0,1,0
32,146,146,48,26,22,2,1
12,153,153,17,1,16,2,1
3,162,162,18,11,7,2,1
34,177,177,42,42,0,1,0
33,181,181,16,16,0,1,0
10,185,185,26,26,0,1,0
22,192,192,3,3,0,1,0
19,199,199,1,1,0,1,0
29,203,203,14,5,9,4,3
8,215,215,7,7,0,1,0
4,222,222,5,5,0,1,0
9,223,223,3,3,0,1,0
7,262,262,73,73,0,1,0
27,279,279,72,72,0,1,0
38,290,290,7,7,0,1,0
11,297,297,59,15,44,3,2
23,305,305,5,5,0,1,0
25,314,314,21,21,0,1,0
36,317,317,3,3,0,1,0
26,321,321,62,49,13,3,2
16,336,336,1,1,0,1,0
1,340,340,23,8,15,4,3
28,344,344,1,1,0,1,0
21,348,348,4,4,0,1,0
0,352,352,56,24,32,2,1
24,376,376,66,26,40,2,1
2,381,381,21,11,10,3,2
31,399,399,69,55,14,3,2
30,426,426,14,14,0,1,0
37,433,433,53,7,46,3,2
17,454,454,35,35,0,1,0
14,467,467,8,8,0,1,0
20,475,475,107,81,26,3,2
18,475,475,2,2,0,1,0
6,488,488,65,25,40,3,2
13,491,491,11,11,0,1,0

20,127,127,8,3,5,2,1
18,158,158,29,21,8,3,2
24,164,164,41,41,0,1,0
11,166,166,4,1,3,2,1
13,167,167,11,11,0,1,0
21,167,167,34,34,0,1,0
22,179,179,8,8,0,1,0
1,182,182,20,20,0,1,0
29,193,193,12,1,11,2,1
26,216,216,42,42,0,1,0
2,230,230,9,9,0,1,0
0,244,244,48,48,0,1,0
25,248,248,14,14,0,1,0
3,259,259,32,6,26,3,2
28,278,278,21,9,12,2,1
8,279,279,85,33,52,3,2
7,284,284,72,72,0,1,0
15,295,295,8,8,0,1,0
4,304,304,48,48,0,1,0
27,324,324,7,7,0,1,0
16,344,344,11,11,0,1,0
14,348,348,2,2,0,1,0
6,351,351,10,10,0,1,0
5,368,368,17,11,6,3,2
19,371,371,94,87,7,2,1
31,395,395,7,7,0,1,0
30,400,400,74,29,45,2,1
23,416,416,31,31,0,1,0
12,426,426,149,111,38,3,2
10,451,451,19,10,9,2,1
17,478,478,38,13,25,2,1
9,488,488,30,25,5,2,1

25,102,102,3,3,0,1,0
29,112,112,8,8,0,1,0
4,124,124,6,6,0,1,0
11,127,127,11,11,0,1,0
17,136,136,12,6,6,2,1
15,145,145,6,6,0,1,0
2,154,154,1,1,0,1,0
37,189,189,28,28,0,1,0
28,211,211,22,22,0,1,0
14,217,217,7,1,6,2,1
12,221,221,28,16,12,4,3
13,227,227,15,15,0,1,0
19,238,238,22,22,0,1,0
0,239,239,40,30,10,2,1
8,239,239,15,15,0,1,0
1,242,242,76,33,43,4,3
23,254,254,3,3,0,1,0
5,258,258,23,11,12,4,3
16,269,269,20,4,16,4,3
21,332,332,17,5,12,4,3
34,334,334,60,60,0,1,0
33,345,345,47,23,24,3,2
18,347,347,6,6,0,1,0
36,356,356,39,39,0,1,0
20,381,381,50,50,0,1,0
10,417,417,74,17,57,3,2
7,420,420,52,20,32,3,2
6,441,441,38,38,0,1,0
30,442,442,14,14,0,1,0
3,451,451,38,38,0,1,0
32,455,455,14,14,0,1,0
27,474,474,85,77,8,3,2
26,475,475,74,8,66,3,2
24,479,479,1,1,0,1,0
35,480,480,102,58,44,4,3
31,481,481,84,84,0,1,0
22,498,498,40,40,0,1,0
9,500,500,8,3,5,2,1

18,104,104,22,9,13,2,1
16,114,114,4,4,0,1,0
19,133,133,32,5,27,2,1
13,156,156,23,12,11,2,1
27,165,165,4,1,3,2,1
17,171,171,16,16,0,1,0
9,177,177,1,1,0,1,0
25,191,191,3,3,0,1,0
23,249,249,17,17,0,1,0
22,264,264,29,29,0,1,0
14,278,278,1,1,0,1,0
12,299,299,94,94,0,1,0
4,299,299,22,16,6,2,1
29,301,301,25,25,0,1,0
10,309,309,8,8,0,1,0
0,329,329,136,103,33,4,3
30,330,330,11,11,0,1,0
11,367,367,84,63,21,4,3
26,369,369,7,1,6,3,2
8,378,378,7,4,3,2,1
24,386,386,94,40,54,3,2
31,396,396,14,14,0,1,0
5,397,397,6,6,0,1,0
3,407,407,32,32,0,1,0
20,418,418,41,41,0,1,0
21,423,423,9,9,0,1,0
1,432,432,5,5,0,1,0
32,437,437,23,10,13,2,1
6,445,445,27,27,0,1,0
15,469,469,60,60,0,1,0
28,483,483,163,28,135,4,3
2,492,492,133,106,27,2,1
7,495,495,67,3,64,3,2

15,109,109,7,1,6,3,2
31,119,119,4,1,3,2,1
2,143,143,60,60,0,1,0
29,155,155,32,24,8,3,2
18,162,162,13,13,0,1,0
23,166,166,1,1,0,1,0
10,173,173,2,2,0,1,0
5,184,184,3,3,0,1,0
30,200,200,20,5,15,4,3
3,214,214,26,8,18,2,1
22,224,224,3,3,0,1,0
19,225,225,14,14,0,1,0
1,255,255,19,19,0,1,0
27,267,267,3,3,0,1,0
11,275,275,64,4,60,3,2
14,328,328,2,2,0,1,0
8,331,331,30,3,27,2,1
25,338,338,80,80,0,1,0
13,349,349,63,24,39,4,3
4,365,365,37,26,11,2,1
9,386,386,42,17,25,2,1
7,410,410,51,29,22,2,1
26,411,411,34,30,4,2,1
20,413,413,88,40,48,2,1
21,420,420,42,33,9,2,1
17,428,428,110,110,0,1,0
24,430,430,55,27,28,3,2
12,443,443,20,9,11,2,1
0,450,450,98,98,0,1,0
16,457,457,43,43,0,1,0
6,475,475,27,12,15,4,3
28,476,476,65,14,51,4,3

25,110,110,5,5,0,1,0
14,135,135,5,5,0,1,0
2,136,136,14,2,12,4,3
18,136,136,26,26,0,1,0
0,170,170,5,2,3,2,1
32,171,171,30,30,0,1,0
28,201,201,8,4,4,2,1
11,209,209,18,18,0,1,0
22,226,226,16,16,0,1,0
21,251,251,8,8,0,1,0
3,253,253,108,108,0,1,0
29,273,273,6,6,0,1,0
24,283,283,6,2,4,2,1
4,305,305,6,6,0,1,0
33,323,323,147,45,102,4,3
8,327,327,11,8,3,2,1
30,332,332,10,10,0,1,0
9,334,334,99,55,44,2,1
10,343,343,36,22,14,2,1
1,349,349,1,1,0,1,0
23,355,355,50,50,0,1,0
17,380,380,29,5,24,2,1
7,387,387,31,19,12,2,1
6,394,394,108,108,0,1,0
31,415,415,1,1,0,1,0
19,417,417,61,61,0,1,0
15,424,424,2,2,0,1,0
20,437,437,14,14,0,1,0
26,440,440,15,15,0,1,0
16,447,447,89,41,48,4,3
27,467,467,60,60,0,1,0
5,479,479,90,6,84,4,3
12,486,486,35,35,0,1,0
13,500,500,21,4,17,2,1

23,109,109,18,18,0,1,0
31,115,115,26,26,0,1,0
29,119,119,11,1,10,3,2
8,121,121,37,37,0,1,0
6,126,126,1,1,0,1,0
14,130,130,4,1,3,2,1
0,131,131,9,1,8,2,1
1,135,135,7,1,6,3,2
7,136,136,1,1,0,1,0
4,136,136,1,1,0,1,0
10,157,157,7,7,0,1,0
16,163,163,19,19,0,1,0
30,176,176,2,2,0,1,0
19,179,179,2,2,0,1,0
25,180,180,8,8,0,1,0
2,217,217,53,27,26,3,2
15,223,223,3,3,0,1,0
13,229,229,15,15,0,1,0
36,230,230,40,40,0,1,0
3,246,246,17,17,0,1,0
18,250,250,22,22,0,1,0
12,270,270,74,2,72,4,3
37,271,271,1,1,0,1,0
11,284,284,35,4,31,2,1
28,302,302,15,3,12,4,3
22,307,307,16,7,9,4,3
5,324,324,32,9,23,3,2
33,325,325,103,41,62,3,2
24,334,334,37,37,0,1,0
34,336,336,14,8,6,2,1
17,347,347,54,14,40,3,2
32,355,355,27,27,0,1,0
9,374,374,7,7,0,1,0
21,386,386,49,49,0,1,0
35,389,389,30,30,0,1,0
20,391,391,19,14,5,2,1
27,414,414,59,10,49,4,3
26,466,466,32,1,31,4,3

0,100,100,28,1,27,4,3
5,107,107,27,27,0,1,0
14,113,113,13,13,0,1,0
15,114,114,5,2,3,2,1
25,120,120,10,10,0,1,0
29,126,126,27,27,0,1,0
4,143,143,1,1,0,1,0
6,147,147,6,6,0,1,0
22,149,149,6,6,0,1,0
3,151,151,43,43,0,1,0
23,158,158,3,3,0,1,0
31,161,161,9,6,3,2,1
32,171,171,2,2,0,1,0
19,214,214,11,11,0,1,0
10,214,214,4,4,0,1,0
35,217,217,35,8,27,4,3
21,239,239,8,4,4,2,1
9,261,261,1,1,0,1,0
28,262,262,10,6,4,2,1
24,272,272,122,110,12,2,1
38,327,327,9,4,5,2,1
13,338,338,21,21,0,1,0
11,339,339,6,2,4,2,1
36,344,344,24,13,11,3,2
30,370,370,13,13,0,1,0
20,380,380,24,24,0,1,0
26,396,396,28,28,0,1,0
27,398,398,106,36,70,3,2
2,399,399,23,6,17,2,1
33,410,410,62,11,51,4,3
8,418,418,14,8,6,3,2
37,446,446,42,42,0,1,0
18,456,456,88,70,18,4,3
7,457,457,29,4,25,3,2
16,460,460,4,4,0,1,0
12,466,466,72,72,0,1,0
17,466,466,15,15,0,1,0
34,470,470,11,11,0,1,0
1,483,483,9,9,0,1,0

1,106,106,8,8,0,1,0
17,108,108,9,1,8,3,2
16,127,127,3,3,0,1,0
21,149,149,18,6,12,3,2
25,153,153,9,6,3,2,1
29,173,173,48,42,6,3,2
11,174,174,13,13,0,1,0
37,192,192,25,25,0,1,0
34,209,209,1,1,0,1,0
4,223,223,5,5,0,1,0
36,232,232,3,3,0,1,0
31,239,239,68,17,51,4,3
22,242,242,1,1,0,1,0
8,245,245,5,5,0,1,0
30,258,258,1,1,0,1,0
0,273,273,22,13,9,2,1
24,294,294,62,8,54,4,3
2,305,305,22,22,0,1,0
38,316,316,29,29,0,1,0
32,350,350,5,1,4,2,1
3,363,363,53,53,0,1,0
15,365,365,55,30,25,2,1
28,374,374,19,19,0,1,0
26,385,385,24,24,0,1,0
14,388,388,21,3,18,4,3
10,407,407,74,74,0,1,0
13,415,415,10,5,5,2,1
35,416,416,59,59,0,1,0
27,420,420,1,1,0,1,0
7,431,431,33,33,0,1,0
18,433,433,105,105,0,1,0
20,445,445,11,11,0,1,0
33,453,453,20,20,0,1,0
6,454,454,60,60,0,1,0
9,459,459,11,11,0,1,0
19,463,463,30,24,6,3,2
12,476,476,44,34,10,3,2
23,492,492,158,77,81,4,3
5,496,496,67,25,42,2,1

9,114,114,7,7,0,1,0
16,116,116,7,1,6,2,1
20,121,121,14,2,12,4,3
21,147,147,9,5,4,2,1
15,150,150,18,18,0,1,0
13,150,150,15,15,0,1,0
19,153,153,5,5,0,1,0
5,157,157,33,23,10,3,2
11,158,158,4,4,0,1,0
1,166,166,8,8,0,1,0
31,171,171,4,1,3,2,1
0,187,187,34,26,8,2,1
3,209,209,40,8,32,3,2
7,211,211,20,20,0,1,0
22,211,211,42,42,0,1,0
6,256,256,4,4,0,1,0
2,258,258,26,26,0,1,0
34,260,260,38,29,9,4,3
10,266,266,92,73,19,2,1
30,290,290,43,23,20,3,2
25,291,291,2,2,0,1,0
14,314,314,35,35,0,1,0
26,332,332,70,70,0,1,0
33,349,349,21,21,0,1,0
23,388,388,7,7,0,1,0
27,399,399,21,21,0,1,0
4,402,402,34,34,0,1,0
28,402,402,136,130,6,2,1
12,407,407,19,19,0,1,0
17,414,414,24,8,16,3,2
32,418,418,76,59,17,2,1
18,458,458,32,9,23,3,2
24,460,460,19,3,16,2,1
29,485,485,36,12,24,2,1
8,494,494,5,1,4,2,1

12,128,128,13,13,0,1,0
18,134,134,13,13,0,1,0
36,142,142,2,2,0,1,0
11,144,144,43,43,0,1,0
27,144,144,29,29,0,1,0
21,146,146,9,1,8,2,1
30,170,170,11,11,0,1,0
37,173,173,1,1,0,1,0
6,182,182,1,1,0,1,0
10,192,192,29,14,15,4,3
15,193,193,24,19,5,2,1
34,201,201,18,18,0,1,0
22,245,245,17,17,0,1,0
17,246,246,11,11,0,1,0
29,302,302,11,1,10,3,2
20,306,306,6,2,4,2,1
14,318,318,77,77,0,1,0
2,318,318,16,10,6,2,1
33,330,330,62,30,32,2,1
24,331,331,16,16,0,1,0
16,332,332,66,66,0,1,0
0,354,354,1,1,0,1,0
35,355,355,55,37,18,2,1
32,355,355,55,16,39,4,3
4,363,363,51,51,0,1,0
19,364,364,4,4,0,1,0
5,372,372,62,62,0,1,0
7,392,392,2,2,0,1,0
23,395,395,227,110,117,4,3
26,400,400,12,6,6,3,2
3,401,401,6,6,0,1,0
1,458,458,5,1,4,2,1
9,476,476,25,25,0,1,0
31,480,480,10,10,0,1,0
8,481,481,35,16,19,2,1
25,484,484,40,40,0,1,0
28,485,485,13,8,5,2,1
13,496,496,5,5,0,1,0

12,105,105,21,21,0,1,0
39,114,114,10,1,9,4,3
41,132,132,5,5,0,1,0
17,139,139,8,8,0,1,0
8,170,170,15,5,10,3,2
27,188,188,9,6,3,2,1
30,197,197,1,1,0,1,0
18,212,212,7,7,0,1,0
38,212,212,37,1,36,2,1
19,213,213,1,1,0,1,0
40,220,220,19,11,8,3,2
14,228,228,1,1,0,1,0
23,246,246,8,8,0,1,0
7,248,248,12,5,7,2,1
31,269,269,32,6,26,3,2
15,271,271,7,2,5,2,1
13,274,274,24,24,0,1,0
20,280,280,21,21,0,1,0
0,295,295,33,33,0,1,0
25,310,310,1,1,0,1,0
37,312,312,100,54,46,3,2
29,314,314,59,28,31,2,1
34,316,316,5,5,0,1,0
2,323,323,30,11,19,2,1
9,325,325,35,35,0,1,0
33,335,335,18,18,0,1,0
16,338,338,14,14,0,1,0
11,353,353,39,18,21,2,1
28,362,362,13,13,0,1,0
5,393,393,50,50,0,1,0
24,419,419,140,113,27,2,1
6,425,425,11,11,0,1,0
26,431,431,31,1,30,2,1
36,447,447,4,4,0,1,0
22,448,448,24,24,0,1,0
32,455,455,5,5,0,1,0
1,472,472,35,30,5,2,1
21,473,473,34,34,0,1,0
10,480,480,17,2,15,2,1
3,482,482,113,27,86,3,2
35,484,484,111,6,105,4,3
4,496,496,29,29,0,1,0

1,101,101,1,1,0,1,0
28,102,102,3,3,0,1,0
39,111,111,5,5,0,1,0
2,114,114,11,4,7,3,2
8,117,117,5,1,4,2,1
10,118,118,1,1,0,1,0
41,124,124,15,1,14,3,2
35,132,132,8,8,0,1,0
30,138,138,2,2,0,1,0
22,145,145,3,3,0,1,0
14,157,157,5,1,4,2,1
5,164,164,45,14,31,2,1
32,173,173,48,9,39,4,3
40,179,179,30,30,0,1,0
20,187,187,7,7,0,1,0
29,188,188,10,7,3,2,1
15,193,193,7,3,4,2,1
21,203,203,21,9,12,3,2
19,221,221,1,1,0,1,0
33,230,230,7,3,4,2,1
36,235,235,74,5,69,4,3
11,240,240,122,116,6,2,1
25,246,246,19,19,0,1,0
17,271,271,17,17,0,1,0
26,278,278,3,3,0,1,0
9,284,284,11,1,10,2,1
24,295,295,43,13,30,2,1
4,320,320,13,13,0,1,0
31,325,325,17,8,9,2,1
34,367,367,57,34,23,2,1
18,389,389,48,24,24,2,1
16,392,392,1,1,0,1,0
0,394,394,18,18,0,1,0
23,400,400,20,20,0,1,0
7,402,402,15,15,0,1,0
12,402,402,13,13,0,1,0
37,403,403,94,42,52,4,3
38,434,434,11,2,9,4,3
13,459,459,80,59,21,4,3
3,467,467,2,2,0,1,0
6,488,488,7,7,0,1,0
27,494,494,18,18,0,1,0

9,102,102,17,17,0,1,0
8,104,104,12,12,0,1,0
2,113,113,17,17,0,1,0
33,137,137,17,17,0,1,0
24,142,142,32,22,10,4,3
6,149,149,4,4,0,1,0
27,160,160,2,2,0,1,0
26,161,161,42,42,0,1,0
13,170,170,6,1,5,2,1
0,185,185,17,6,11,2,1
32,192,192,17,17,0,1,0
12,198,198,39,19,20,3,2
14,202,202,8,2,6,3,2
15,202,202,9,9,0,1,0
17,211,211,83,43,40,3,2
23,213,213,10,10,0,1,0
30,216,216,13,13,0,1,0
19,218,218,33,21,12,4,3
22,219,219,1,1,0,1,0
18,222,222,7,4,3,2,1
1,269,269,8,1,7,2,1
4,306,306,57,57,0,1,0
25,311,311,1,1,0,1,0
29,320,320,1,1,0,1,0
7,338,338,22,10,12,3,2
10,363,363,169,84,85,4,3
28,377,377,40,40,0,1,0
16,382,382,47,17,30,3,2
31,393,393,30,30,0,1,0
5,433,433,43,43,0,1,0
3,433,433,25,21,4,2,1
11,439,439,13,7,6,3,2
21,481,481,39,5,34,2,1
20,500,500,22,8,14,3,2

7,113,113,5,5,0,1,0
16,129,129,17,7,10,2,1
29,153,153,45,45,0,1,0
5,171,171,53,34,19,2,1
8,192,192,30,30,0,1,0
12,200,200,17,2,15,4,3
34,204,204,8,8,0,1,0
22,217,217,7,7,0,1,0
2,233,233,15,3,12,2,1
30,246,246,24,4,20,3,2
9,250,250,10,10,0,1,0
27,251,251,2,2,0,1,0
4,254,254,15,15,0,1,0
3,260,260,2,2,0,1,0
31,265,265,22,22,0,1,0
28,289,289,7,2,5,2,1
10,292,292,1,1,0,1,0
6,294,294,1,1,0,1,0
32,299,299,5,5,0,1,0
20,305,305,3,3,0,1,0
26,308,308,3,3,0,1,0
14,322,322,46,22,24,4,3
23,332,332,9,9,0,1,0
15,350,350,49,49,0,1,0
25,362,362,99,73,26,3,2
21,366,366,117,117,0,1,0
1,375,375,24,4,20,3,2
19,376,376,48,9,39,2,1
13,380,380,102,72,30,4,3
24,393,393,45,45,0,1,0
17,394,394,16,16,0,1,0
11,396,396,100,28,72,3,2
0,437,437,12,12,0,1,0
18,444,444,6,6,0,1,0
33,477,477,141,43,98,3,2

20,105,105,9,3,6,2,1
3,106,106,7,7,0,1,0
7,113,113,8,8,0,1,0
14,113,113,27,20,7,2,1
19,124,124,10,4,6,2,1
34,132,132,4,4,0,1,0
16,147,147,2,2,0,1,0
28,150,150,2,2,0,1,0
30,167,167,5,1,4,2,1
8,182,182,27,20,7,2,1
22,186,186,15,15,0,1,0
31,188,188,91,91,0,1,0
9,193,193,14,11,3,2,1
4,200,200,13,13,0,1,0
27,225,225,6,6,0,1,0
32,230,230,14,7,7,2,1
35,233,233,4,4,0,1,0
41,234,234,2,2,0,1,0
26,239,239,1,1,0,1,0
24,241,241,9,5,4,2,1
23,253,253,22,4,18,4,3
11,265,265,31,4,27,4,3
15,266,266,22,22,0,1,0
37,276,276,18,18,0,1,0
38,292,292,56,27,29,2,1
13,314,314,24,24,0,1,0
21,322,322,2,2,0,1,0
33,327,327,58,58,0,1,0
36,342,342,46,38,8,2,1
0,372,372,5,5,0,1,0
18,378,378,11,3,8,3,2
2,382,382,19,19,0,1,0
25,384,384,7,7,0,1,0
6,409,409,13,13,0,1,0
17,414,414,16,13,3,2,1
1,444,444,6,3,3,2,1
12,453,453,14,14,0,1,0
40,461,461,71,71,0,1,0
39,481,481,16,5,11,2,1
10,490,490,139,133,6,2,1
5,493,493,9,9,0,1,0
29,499,499,175,156,19,2,1

25,111,111,9,3,6,3,2
28,120,120,10,10,0,1,0
23,122,122,35,8,27,4,3
6,126,126,12,12,0,1,0
33,135,135,16,16,0,1,0
21,135,135,10,10,0,1,0
1,144,144,4,4,0,1,0
34,149,149,1,1,0,1,0
11,164,164,44,44,0,1,0
36,166,166,18,18,0,1,0
19,175,175,7,7,0,1,0
8,222,222,3,3,0,1,0
26,228,228,30,30,0,1,0
18,244,244,36,16,20,3,2
27,259,259,49,49,0,1,0
0,288,288,5,5,0,1,0
32,289,289,22,22,0,1,0
14,313,313,23,16,7,2,1
16,326,326,5,5,0,1,0
35,362,362,10,10,0,1,0
20,374,374,18,11,7,2,1
7,376,376,68,68,0,1,0
12,376,376,104,59,45,4,3
4,388,388,9,3,6,3,2
13,391,391,119,56,63,4,3
30,394,394,137,21,116,4,3
9,402,402,18,9,9,3,2
10,453,453,13,13,0,1,0
24,457,457,30,2,28,3,2
22,459,459,45,41,4,2,1
29,467,467,24,19,5,2,1
17,467,467,41,3,38,3,2
3,469,469,14,14,0,1,0
31,473,473,7,1,6,3,2
15,490,490,62,32,30,4,3
2,490,490,15,4,11,2,1
5,490,490,6,1,5,2,1

2,118,118,9,5,4,2,1
21,122,122,5,5,0,1,0
13,124,124,7,7,0,1,0
30,140,140,19,8,11,2,1
0,148,148,22,10,12,3,2
31,149,149,17,14,3,2,1
1,165,165,20,20,0,1,0
18,171,171,33,2,31,2,1
3,172,172,4,4,0,1,0
15,178,178,11,4,7,2,1
26,181,181,33,13,20,2,1
22,198,198,3,3,0,1,0
12,212,212,6,1,5,2,1
27,229,229,1,1,0,1,0
25,246,246,62,62,0,1,0
24,255,255,40,40,0,1,0
20,270,270,45,45,0,1,0
32,303,303,6,1,5,2,1
7,313,313,91,38,53,3,2
10,323,323,11,11,0,1,0
9,335,335,11,11,0,1,0
5,336,336,136,90,46,2,1
16,341,341,40,40,0,1,0
28,366,366,29,29,0,1,0
8,371,371,100,80,20,2,1
4,372,372,19,13,6,3,2
29,428,428,65,56,9,2,1
19,442,442,3,3,0,1,0
11,444,444,7,1,6,2,1
17,460,460,16,16,0,1,0
6,468,468,86,86,0,1,0
14,489,489,31,31,0,1,0
23,495,495,53,17,36,4,3

40,134,134,2,2,0,1,0
0,154,154,4,4,0,1,0
11,157,157,2,2,0,1,0
25,173,173,12,12,0,1,0
27,177,177,38,20,18,3,2
7,202,202,30,12,18,2,1
13,209,209,44,12,32,3,2
23,215,215,1,1,0,1,0
2,241,241,12,6,6,2,1
15,243,243,19,19,0,1,0
35,250,250,2,2,0,1,0
22,256,256,3,3,0,1,0
18,266,266,54,5,49,3,2
28,281,281,20,20,0,1,0
33,290,290,1,1,0,1,0
1,290,290,32,32,0,1,0
24,293,293,77,27,50,4,3
8,303,303,1,1,0,1,0
5,305,305,2,2,0,1,0
29,314,314,47,28,19,2,1
31,322,322,1,1,0,1,0
17,327,327,25,25,0,1,0
37,328,328,46,14,32,3,2
6,332,332,3,3,0,1,0
21,369,369,10,10,0,1,0
36,370,370,60,60,0,1,0
19,371,371,66,66,0,1,0
12,382,382,9,9,0,1,0
26,384,384,3,3,0,1,0
39,387,387,55,55,0,1,0
9,391,391,106,64,42,4,3
32,391,391,77,77,0,1,0
10,394,394,2,2,0,1,0
16,395,395,3,3,0,1,0
38,399,399,52,52,0,1,0
14,416,416,13,13,0,1,0
4,418,418,1,1,0,1,0
30,431,431,9,9,0,1,0
20,433,433,82,35,47,2,1
34,439,439,97,5,92,3,2
3,471,471,57,57,0,1,0

22,104,104,15,6,9,4,3
26,112,112,2,2,0,1,0
19,129,129,6,2,4,2,1
30,144,144,11,11,0,1,0
5,159,159,21,21,0,1,0
24,160,160,9,9,0,1,0
32,171,171,32,32,0,1,0
0,177,177,4,1,3,2,1
20,195,195,4,4,0,1,0
2,210,210,2,2,0,1,0
39,217,217,78,4,74,3,2
10,229,229,8,2,6,3,2
14,235,235,14,6,8,3,2
6,239,239,66,26,40,2,1
23,257,257,5,5,0,1,0
8,257,257,60,33,27,2,1
17,258,258,19,3,16,2,1
31,263,263,4,4,0,1,0
36,266,266,1,1,0,1,0
12,286,286,14,14,0,1,0
9,287,287,18,6,12,2,1
11,287,287,9,5,4,2,1
13,292,292,6,6,0,1,0
37,297,297,48,20,28,2,1
29,302,302,5,5,0,1,0
3,325,325,7,7,0,1,0
33,325,325,10,6,4,2,1
4,329,329,2,2,0,1,0
27,334,334,6,6,0,1,0
16,343,343,69,3,66,3,2
18,347,347,9,9,0,1,0
41,349,349,35,23,12,4,3
7,351,351,47,27,20,2,1
25,355,355,40,40,0,1,0
34,378,378,8,4,4,2,1
1,382,382,33,33,0,1,0
38,389,389,190,49,141,4,3
40,394,394,30,30,0,1,0
42,466,466,43,43,0,1,0
35,472,472,19,10,9,2,1
21,476,476,8,8,0,1,0
28,491,491,1,1,0,1,0
15,494,494,8,8,0,1,0

7,106,106,18,3,15,2,1
26,136,136,41,8,33,4,3
31,143,143,4,4,0,1,0
20,160,160,15,15,0,1,0
25,160,160,8,8,0,1,0
35,161,161,21,21,0,1,0
41,163,163,8,8,0,1,0
42,164,164,16,16,0,1,0
38,166,166,18,18,0,1,0
24,169,169,34,13,21,2,1
21,179,179,1,1,0,1,0
39,228,228,16,16,0,1,0
40,232,232,11,1,10,2,1
17,237,237,10,10,0,1,0
16,239,239,48,48,0,1,0
13,241,241,1,1,0,1,0
28,252,252,16,16,0,1,0
30,259,259,29,6,23,4,3
19,264,264,19,19,0,1,0
9,265,265,3,3,0,1,0
5,268,268,6,6,0,1,0
27,272,272,9,3,6,3,2
6,275,275,15,11,4,2,1
12,276,276,55,55,0,1,0
18,276,276,30,30,0,1,0
37,281,281,5,5,0,1,0
36,289,289,132,132,0,1,0
3,302,302,22,14,8,3,2
10,351,351,1,1,0,1,0
15,354,354,15,15,0,1,0
33,356,356,54,4,50,2,1
14,375,375,26,26,0,1,0
0,378,378,1,1,0,1,0
29,419,419,12,12,0,1,0
2,433,433,8,8,0,1,0
22,439,439,74,74,0,1,0
23,444,444,2,2,0,1,0
34,445,445,41,41,0,1,0
11,450,450,28,20,8,2,1
4,461,461,10,10,0,1,0
1,466,466,50,50,0,1,0
8,466,466,21,21,0,1,0
32,499,499,2,2,0,1,0

34,106,106,7,4,3,2,1
38,122,122,11,11,0,1,0
12,129,129,17,2,15,3,2
18,131,131,10,2,8,3,2
27,137,137,18,18,0,1,0
26,140,140,1,1,0,1,0
41,145,145,8,8,0,1,0
4,149,149,17,11,6,2,1
14,165,165,11,5,6,2,1
2,220,220,1,1,0,1,0
40,233,233,49,19,30,3,2
20,237,237,11,11,0,1,0
15,257,257,12,4,8,3,2
9,268,268,41,21,20,2,1
3,288,288,2,2,0,1,0
5,301,301,34,18,16,2,1
6,302,302,22,9,13,2,1
8,306,306,28,11,17,4,3
19,316,316,5,5,0,1,0
39,328,328,41,18,23,2,1
42,329,329,5,5,0,1,0
25,331,331,64,60,4,2,1
30,335,335,36,36,0,1,0
33,344,344,8,8,0,1,0
0,362,362,25,25,0,1,0
36,364,364,6,6,0,1,0
10,376,376,56,31,25,2,1
21,376,376,38,38,0,1,0
1,392,392,36,36,0,1,0
22,415,415,8,4,4,2,1
7,425,425,6,6,0,1,0
16,427,427,25,25,0,1,0
37,433,433,15,15,0,1,0
13,437,437,30,8,22,3,2
17,442,442,8,4,4,2,1
32,446,446,68,68,0,1,0
24,465,465,64,25,39,2,1
23,467,467,48,12,36,3,2
31,469,469,113,113,0,1,0
11,471,471,15,15,0,1,0
29,490,490,42,5,37,3,2
28,496,496,77,17,60,4,3
35,497,497,60,30,30,3,2

11,103,103,7,7,0,1,0
5,107,107,4,4,0,1,0
12,123,123,18,11,7,2,1
13,125,125,21,21,0,1,0
23,139,139,4,4,0,1,0
15,154,154,2,2,0,1,0
3,155,155,12,12,0,1,0
10,193,193,33,13,20,3,2
17,223,223,59,31,28,3,2
1,228,228,24,24,0,1,0
14,231,231,4,4,0,1,0
19,232,232,8,3,5,2,1
0,263,263,22,22,0,1,0
20,271,271,2,2,0,1,0
2,284,284,35,3,32,3,2
21,304,304,84,84,0,1,0
16,315,315,129,129,0,1,0
7,319,319,81,27,54,4,3
22,335,335,46,46,0,1,0
18,338,338,5,5,0,1,0
30,342,342,34,34,0,1,0
31,352,352,59,59,0,1,0
24,361,361,62,62,0,1,0
29,402,402,13,13,0,1,0
9,412,412,5,5,0,1,0
27,443,443,3,3,0,1,0
4,451,451,149,96,53,4,3
28,460,460,25,25,0,1,0
8,478,478,7,7,0,1,0
26,481,481,14,4,10,3,2
6,485,485,104,20,84,4,3
25,487,487,36,14,22,3,2

7,106,106,6,6,0,1,0
25,111,111,22,22,0,1,0
34,120,120,3,3,0,1,0
32,143,143,40,27,13,2,1
3,146,146,7,4,3,2,1
26,149,149,7,7,0,1,0
30,153,153,28,28,0,1,0
22,158,158,25,25,0,1,0
15,161,161,10,4,6,2,1
0,164,164,29,29,0,1,0
38,170,170,50,50,0,1,0
16,174,174,22,22,0,1,0
1,187,187,43,20,23,4,3
23,195,195,21,21,0,1,0
33,220,220,54,54,0,1,0
10,226,226,8,2,6,3,2
31,231,231,1,1,0,1,0
29,267,267,26,13,13,4,3
4,279,279,3,3,0,1,0
6,280,280,28,24,4,2,1
21,323,323,23,23,0,1,0
12,339,339,23,9,14,3,2
17,355,355,102,45,57,4,3
11,373,373,5,5,0,1,0
28,375,375,23,23,0,1,0
36,379,379,1,1,0,1,0
2,390,390,15,9,6,2,1
37,408,408,14,1,13,2,1
19,421,421,6,6,0,1,0
20,434,434,35,14,21,2,1
27,454,454,3,3,0,1,0
5,455,455,18,18,0,1,0
9,461,461,21,21,0,1,0
14,476,476,136,116,20,3,2
8,477,477,2,2,0,1,0
24,477,477,17,17,0,1,0
13,482,482,33,23,10,2,1
35,489,489,2,2,0,1,0
18,497,497,5,5,0,1,0

19,115,115,20,2,18,2,1
32,126,126,1,1,0,1,0
5,134,134,20,20,0,1,0
8,142,142,46,46,0,1,0
21,155,155,20,20,0,1,0
15,159,159,1,1,0,1,0
7,166,166,8,8,0,1,0
37,168,168,24,24,0,1,0
4,186,186,26,2,24,2,1
11,187,187,7,7,0,1,0
10,188,188,9,3,6,3,2
22,190,190,15,15,0,1,0
16,192,192,7,7,0,1,0
23,203,203,36,36,0,1,0
26,206,206,40,29,11,2,1
24,216,216,24,7,17,2,1
27,227,227,18,11,7,2,1
36,232,232,26,26,0,1,0
13,237,237,28,22,6,3,2
35,248,248,25,20,5,2,1
17,252,252,1,1,0,1,0
9,254,254,25,16,9,4,3
38,282,282,16,16,0,1,0
31,303,303,8,8,0,1,0
20,306,306,7,7,0,1,0
33,307,307,12,12,0,1,0
34,348,348,26,26,0,1,0
3,362,362,11,2,9,2,1
1,380,380,15,15,0,1,0
28,382,382,98,98,0,1,0
14,382,382,26,26,0,1,0
29,425,425,41,26,15,4,3
18,426,426,35,5,30,3,2
2,451,451,22,2,20,3,2
25,460,460,13,13,0,1,0
30,461,461,59,29,30,4,3
0,462,462,111,95,16,2,1
12,484,484,1,1,0,1,0
6,488,488,41,26,15,4,3

13,116,116,2,2,0,1,0
8,145,145,31,31,0,1,0
28,148,148,5,1,4,2,1
22,161,161,9,1,8,3,2
6,165,165,6,6,0,1,0
0,167,167,27,27,0,1,0
18,182,182,11,2,9,4,3
2,208,208,35,35,0,1,0
31,214,214,6,6,0,1,0
1,222,222,3,3,0,1,0
27,233,233,33,33,0,1,0
25,246,246,19,4,15,2,1
4,250,250,39,3,36,2,1
14,261,261,85,48,37,2,1
21,282,282,46,46,0,1,0
26,295,295,13,4,9,2,1
16,297,297,133,115,18,4,3
20,326,326,12,12,0,1,0
23,330,330,9,9,0,1,0
9,353,353,79,9,70,3,2
19,356,356,5,5,0,1,0
11,374,374,12,12,0,1,0
15,377,377,26,26,0,1,0
17,379,379,52,52,0,1,0
30,400,400,37,21,16,2,1
10,411,411,60,60,0,1,0
29,434,434,19,19,0,1,0
3,439,439,5,5,0,1,0
5,473,473,40,40,0,1,0
24,475,475,17,8,9,4,3
12,475,475,1,1,0,1,0
7,488,488,263,247,16,2,1

29,127,127,3,3,0,1,0
6,148,148,51,51,0,1,0
5,149,149,25,16,9,4,3
13,157,157,1,1,0,1,0
8,163,163,3,3,0,1,0
4,176,176,26,6,20,3,2
10,186,186,4,4,0,1,0
27,189,189,12,12,0,1,0
7,199,199,35,5,30,2,1
25,208,208,11,11,0,1,0
23,213,213,10,10,0,1,0
15,220,220,7,7,0,1,0
20,224,224,9,9,0,1,0
32,241,241,14,2,12,3,2
0,248,248,67,58,9,2,1
26,248,248,81,70,11,2,1
12,264,264,11,11,0,1,0
31,279,279,10,10,0,1,0
18,294,294,41,41,0,1,0
1,299,299,24,6,18,3,2
16,330,330,96,51,45,4,3
19,337,337,40,16,24,4,3
21,338,338,34,34,0,1,0
22,348,348,24,24,0,1,0
9,355,355,58,43,15,2,1
24,362,362,7,1,6,3,2
30,392,392,33,4,29,2,1
3,402,402,105,71,34,4,3
2,422,422,27,16,11,2,1
28,452,452,42,32,10,2,1
14,463,463,9,9,0,1,0
11,477,477,9,5,4,2,1
17,477,477,113,20,93,4,3

32,105,105,12,12,0,1,0
21,113,113,5,5,0,1,0
8,129,129,4,4,0,1,0
2,156,156,14,14,0,1,0
36,161,161,35,6,29,2,1
0,174,174,3,3,0,1,0
30,180,180,35,35,0,1,0
17,181,181,4,4,0,1,0
10,184,184,37,19,18,3,2
1,187,187,27,27,0,1,0
28,187,187,3,3,0,1,0
4,201,201,42,5,37,2,1
26,202,202,10,10,0,1,0
25,213,213,11,6,5,2,1
29,235,235,36,4,32,3,2
6,252,252,8,8,0,1,0
23,262,262,8,8,0,1,0
19,265,265,8,1,7,2,1
5,265,265,40,26,14,4,3
18,281,281,16,1,15,4,3
15,286,286,12,12,0,1,0
38,319,319,21,21,0,1,0
11,320,320,37,37,0,1,0
14,335,335,55,7,48,4,3
35,343,343,50,50,0,1,0
16,352,352,23,15,8,2,1
24,360,360,3,3,0,1,0
27,362,362,74,29,45,4,3
9,388,388,6,6,0,1,0
7,392,392,4,4,0,1,0
20,408,408,2,2,0,1,0
39,421,421,49,32,17,3,2
34,428,428,14,3,11,2,1
37,454,454,11,3,8,2,1
31,468,468,32,32,0,1,0
22,476,476,55,51,4,2,1
12,476,476,74,74,0,1,0
3,486,486,96,1,95,4,3
33,489,489,108,108,0,1,0
13,489,489,3,3,0,1,0

21,100,100,17,17,0,1,0
3,107,107,2,2,0,1,0
22,120,120,3,3,0,1,0
29,121,121,17,2,15,3,2
5,122,122,11,1,10,2,1
28,124,124,4,4,0,1,0
2,126,126,4,1,3,2,1
13,137,137,8,8,0,1,0
7,151,151,13,13,0,1,0
17,187,187,12,1,11,2,1
20,198,198,26,13,13,2,1
34,199,199,28,11,17,2,1
26,202,202,5,5,0,1,0
10,220,220,46,25,21,2,1
30,222,222,18,14,4,2,1
32,234,234,22,4,18,3,2
27,262,262,43,4,39,4,3
12,262,262,10,10,0,1,0
1,304,304,16,1,15,4,3
25,308,308,19,19,0,1,0
16,321,321,92,92,0,1,0
8,325,325,111,87,24,4,3
31,374,374,38,24,14,2,1
24,385,385,25,25,0,1,0
4,407,407,51,23,28,2,1
14,419,419,15,9,6,2,1
11,440,440,88,61,27,4,3
6,453,453,29,29,0,1,0
9,455,455,8,4,4,2,1
18,471,471,101,1,100,3,2
23,473,473,103,61,42,4,3
19,480,480,31,9,22,2,1
0,482,482,51,51,0,1,0
15,482,482,19,19,0,1,0
33,486,486,21,21,0,1,0

0,104,104,1,1,0,1,0
7,107,107,4,1,3,2,1
1,109,109,48,48,0,1,0
30,118,118,2,2,0,1,0
27,124,124,20,20,0,1,0
14,144,144,14,14,0,1,0
19,166,166,10,10,0,1,0
26,272,272,54,32,22,2,1
20,292,292,9,9,0,1,0
2,300,300,1,1,0,1,0
21,315,315,8,8,0,1,0
8,318,318,79,31,48,4,3
3,320,320,51,20,31,2,1
24,324,324,85,11,74,3,2
6,326,326,32,32,0,1,0
22,334,334,5,5,0,1,0
5,356,356,40,40,0,1,0
15,369,369,2,2,0,1,0
4,371,371,10,1,9,4,3
23,371,371,107,29,78,3,2
28,386,386,38,38,0,1,0
13,391,391,33,8,25,4,3
25,408,408,6,2,4,2,1
16,428,428,91,91,0,1,0
12,437,437,72,18,54,4,3
18,444,444,4,4,0,1,0
9,447,447,5,5,0,1,0
17,466,466,38,38,0,1,0
11,472,472,42,14,28,3,2
10,489,489,154,22,132,4,3
29,491,491,106,65,41,2,1
31,500,500,21,8,13,3,2

4,132,132,1,1,0,1,0
22,148,148,16,16,0,1,0
9,156,156,1,1,0,1,0
20,168,168,13,6,7,2,1
35,169,169,9,9,0,1,0
5,171,171,1,1,0,1,0
31,188,188,10,10,0,1,0
19,204,204,29,3,26,3,2
23,206,206,10,6,4,2,1
25,214,214,9,9,0,1,0
24,235,235,12,12,0,1,0
6,238,238,7,7,0,1,0
12,272,272,57,57,0,1,0
36,280,280,2,2,0,1,0
14,283,283,6,6,0,1,0
13,336,336,64,56,8,3,2
32,346,346,10,6,4,2,1
29,352,352,87,87,0,1,0
7,357,357,40,40,0,1,0
34,366,366,117,117,0,1,0
1,378,378,23,23,0,1,0
0,379,379,31,31,0,1,0
33,379,379,10,10,0,1,0
30,404,404,56,56,0,1,0
10,411,411,80,28,52,4,3
21,419,419,116,41,75,4,3
28,420,420,33,33,0,1,0
3,425,425,146,130,16,3,2
27,438,438,9,9,0,1,0
15,444,444,36,36,0,1,0
16,446,446,72,15,57,4,3
18,447,447,12,12,0,1,0
26,469,469,56,28,28,2,1
8,480,480,36,36,0,1,0
17,491,491,9,6,3,2,1
2,491,491,50,20,30,2,1
11,493,493,36,31,5,2,1

22,107,107,1,1,0,1,0
16,109,109,18,8,10,2,1
1,128,128,13,13,0,1,0
17,134,134,11,11,0,1,0
6,148,148,4,4,0,1,0
14,168,168,65,65,0,1,0
29,189,189,25,25,0,1,0
18,194,194,2,2,0,1,0
0,208,208,62,23,39,4,3
11,211,211,10,1,9,2,1
27,211,211,26,26,0,1,0
28,217,217,1,1,0,1,0
12,230,230,7,7,0,1,0
5,258,258,1,1,0,1,0
37,269,269,17,17,0,1,0
2,276,276,7,7,0,1,0
15,282,282,11,11,0,1,0
25,295,295,20,9,11,2,1
30,302,302,83,83,0,1,0
24,308,308,50,3,47,4,3
9,321,321,26,3,23,2,1
8,324,324,1,1,0,1,0
36,345,345,1,1,0,1,0
33,348,348,59,28,31,2,1
3,356,356,9,9,0,1,0
35,384,384,5,5,0,1,0
20,423,423,32,32,0,1,0
19,428,428,140,125,15,2,1
10,431,431,2,2,0,1,0
32,433,433,150,150,0,1,0
21,439,439,60,18,42,3,2
26,446,446,16,6,10,3,2
4,459,459,44,24,20,3,2
13,467,467,21,10,11,2,1
23,481,481,31,31,0,1,0
31,487,487,27,6,21,4,3
7,488,488,1,1,0,1,0
34,491,491,40,4,36,4,3

27,120,120,9,9,0,1,0
19,124,124,13,1,12,4,3
35,131,131,55,55,0,1,0
32,153,153,3,3,0,1,0
10,159,159,16,8,8,2,1
20,172,172,27,16,11,2,1
8,193,193,22,4,18,2,1
12,196,196,37,33,4,2,1
33,201,201,25,8,17,3,2
7,204,204,1,1,0,1,0
2,215,215,4,4,0,1,0
30,235,235,26,26,0,1,0
37,238,238,5,2,3,2,1
14,250,250,18,4,14,2,1
26,253,253,18,18,0,1,0
4,260,260,16,6,10,2,1
1,260,260,26,2,24,3,2
24,264,264,4,4,0,1,0
17,272,272,10,10,0,1,0
25,279,279,10,7,3,2,1
9,303,303,109,10,99,4,3
36,305,305,41,41,0,1,0
0,316,316,1,1,0,1,0
5,325,325,33,33,0,1,0
31,331,331,11,11,0,1,0
11,342,342,1,1,0,1,0
18,368,368,17,17,0,1,0
29,379,379,164,164,0,1,0
38,383,383,49,21,28,2,1
16,403,403,13,13,0,1,0
23,413,413,4,1,3,2,1
13,426,426,74,8,66,4,3
15,451,451,33,33,0,1,0
39,454,454,20,12,8,2,1
34,466,466,4,4,0,1,0
28,472,472,29,29,0,1,0
22,473,473,41,20,21,2,1
3,485,485,10,10,0,1,0
21,492,492,5,5,0,1,0
6,495,495,9,9,0,1,0

1,127,127,19,4,15,2,1
16,130,130,10,4,6,2,1
33,132,132,5,5,0,1,0
7,156,156,31,31,0,1,0
20,159,159,30,30,0,1,0
6,164,164,6,6,0,1,0
32,165,165,17,17,0,1,0
23,165,165,15,6,9,2,1
24,170,170,24,16,8,3,2
8,192,192,15,15,0,1,0
27,201,201,59,51,8,2,1
13,241,241,9,1,8,2,1
19,243,243,41,41,0,1,0
2,250,250,17,17,0,1,0
31,277,277,9,1,8,3,2
14,280,280,50,42,8,2,1
3,288,288,107,107,0,1,0
4,297,297,60,5,55,4,3
22,297,297,26,26,0,1,0
12,299,299,28,19,9,4,3
18,304,304,34,34,0,1,0
30,328,328,69,48,21,2,1
29,331,331,4,4,0,1,0
9,338,338,8,8,0,1,0
26,350,350,28,18,10,2,1
5,353,353,1,1,0,1,0
21,371,371,1,1,0,1,0
0,410,410,38,20,18,3,2
10,411,411,25,13,12,3,2
11,423,423,82,82,0,1,0
28,444,444,22,15,7,3,2
25,480,480,41,14,27,4,3
15,481,481,6,6,0,1,0
17,493,493,36,36,0,1,0

27,141,141,20,12,8,3,2
4,151,151,1,1,0,1,0
21,152,152,31,22,9,4,3
10,154,154,10,4,6,3,2
14,155,155,27,13,14,3,2
31,157,157,15,6,9,2,1
1,162,162,12,2,10,3,2
3,167,167,46,13,33,3,2
8,172,172,5,5,0,1,0
29,175,175,20,20,0,1,0
13,186,186,28,28,0,1,0
11,192,192,4,1,3,2,1
41,196,196,23,7,16,2,1
38,203,203,8,8,0,1,0
15,205,205,6,6,0,1,0
32,212,212,14,14,0,1,0
0,222,222,13,5,8,2,1
35,226,226,9,6,3,2,1
26,234,234,23,11,12,2,1
25,235,235,145,108,37,3,2
28,241,241,4,4,0,1,0
37,250,250,14,14,0,1,0
20,256,256,13,13,0,1,0
36,257,257,1,1,0,1,0
22,267,267,1,1,0,1,0
24,280,280,62,16,46,3,2
18,322,322,3,3,0,1,0
12,328,328,56,56,0,1,0
33,334,334,8,2,6,2,1
5,341,341,17,4,13,3,2
30,356,356,31,17,14,2,1
7,366,366,10,10,0,1,0
6,369,369,10,5,5,2,1
9,379,379,9,2,7,2,1
34,388,388,25,25,0,1,0
2,399,399,15,15,0,1,0
19,447,447,22,22,0,1,0
17,467,467,66,66,0,1,0
16,468,468,1,1,0,1,0
40,475,475,1,1,0,1,0
23,486,486,59,59,0,1,0
39,497,497,19,16,3,2,1

5,111,111,22,22,0,1,0
6,119,119,45,4,41,2,1
3,130,130,1,1,0,1,0
0,134,134,9,6,3,2,1
28,147,147,20,20,0,1,0
9,166,166,3,3,0,1,0
7,173,173,20,2,18,3,2
1,175,175,8,5,3,2,1
14,187,187,1,1,0,1,0
24,187,187,4,4,0,1,0
4,201,201,10,10,0,1,0
11,203,203,46,46,0,1,0
8,217,217,12,3,9,3,2
15,227,227,10,4,6,3,2
2,240,240,8,8,0,1,0
30,258,258,8,8,0,1,0
16,268,268,20,11,9,2,1
19,282,282,26,26,0,1,0
27,289,289,24,24,0,1,0
23,313,313,20,20,0,1,0
26,335,335,32,14,18,2,1
31,365,365,14,2,12,4,3
32,373,373,22,22,0,1,0
29,374,374,102,45,57,4,3
21,383,383,54,20,34,4,3
12,399,399,103,45,58,3,2
13,433,433,101,96,5,2,1
25,444,444,37,30,7,2,1
18,469,469,130,54,76,4,3
22,471,471,52,40,12,3,2
17,484,484,17,17,0,1,0
20,499,499,84,40,44,4,3
10,500,500,56,40,16,2,1

3,110,110,2,2,0,1,0
5,110,110,3,3,0,1,0
4,118,118,10,7,3,2,1
28,126,126,12,12,0,1,0
35,152,152,53,17,36,3,2
13,175,175,15,15,0,1,0
19,191,191,45,45,0,1,0
21,207,207,4,4,0,1,0
18,207,207,7,7,0,1,0
1,219,219,56,27,29,4,3
0,227,227,28,20,8,3,2
9,229,229,35,35,0,1,0
31,229,229,7,7,0,1,0
29,247,247,36,6,30,2,1
16,253,253,5,2,3,2,1
33,267,267,1,1,0,1,0
26,268,268,24,24,0,1,0
37,278,278,73,73,0,1,0
27,283,283,5,2,3,2,1
22,288,288,2,2,0,1,0
20,297,297,12,12,0,1,0
17,317,317,26,26,0,1,0
2,323,323,7,7,0,1,0
7,336,336,29,29,0,1,0
36,360,360,16,1,15,2,1
10,381,381,12,12,0,1,0
8,389,389,11,11,0,1,0
24,390,390,37,37,0,1,0
12,412,412,25,13,12,3,2
25,413,413,80,56,24,2,1
30,417,417,52,22,30,4,3
32,428,428,60,60,0,1,0
23,473,473,84,18,66,4,3
15,479,479,86,37,49,2,1
34,480,480,1,1,0,1,0
14,482,482,40,40,0,1,0
11,487,487,24,6,18,4,3
6,494,494,72,57,15,4,3

19,111,111,30,30,0,1,0
18,119,119,2,2,0,1,0
16,130,130,2,2,0,1,0
33,143,143,13,4,9,4,3
10,144,144,4,4,0,1,0
20,146,146,11,11,0,1,0
6,151,151,2,2,0,1,0
36,155,155,13,13,0,1,0
7,163,163,4,4,0,1,0
29,220,220,12,3,9,4,3
22,232,232,3,3,0,1,0
27,243,243,12,12,0,1,0
12,243,243,6,6,0,1,0
34,255,255,33,9,24,3,2
1,265,265,5,5,0,1,0
37,283,283,9,9,0,1,0
32,286,286,16,5,11,4,3
17,289,289,12,12,0,1,0
26,293,293,36,36,0,1,0
40,303,303,19,19,0,1,0
14,314,314,54,54,0,1,0
2,319,319,91,91,0,1,0
13,322,322,61,25,36,4,3
31,323,323,24,24,0,1,0
38,333,333,16,16,0,1,0
11,338,338,32,4,28,2,1
15,350,350,16,7,9,4,3
39,368,368,56,56,0,1,0
35,382,382,155,155,0,1,0
3,384,384,23,23,0,1,0
4,390,390,9,2,7,2,1
5,397,397,45,9,36,4,3
25,411,411,43,5,38,2,1
0,415,415,6,6,0,1,0
28,418,418,109,109,0,1,0
24,428,428,17,17,0,1,0
30,439,439,18,1,17,2,1
23,446,446,8,2,6,2,1
8,480,480,52,33,19,2,1
9,482,482,66,66,0,1,0
21,494,494,9,9,0,1,0

22,101,101,3,3,0,1,0
2,123,123,21,7,14,3,2
11,127,127,1,1,0,1,0
26,171,171,59,59,0,1,0
28,230,230,41,13,28,2,1
8,240,240,83,11,72,4,3
6,255,255,46,19,27,2,1
16,261,261,3,3,0,1,0
12,264,264,12,4,8,3,2
4,284,284,102,80,22,3,2
29,292,292,4,4,0,1,0
3,302,302,10,10,0,1,0
9,311,311,24,24,0,1,0
19,335,335,32,32,0,1,0
18,348,348,34,28,6,2,1
7,356,356,91,70,21,4,3
25,361,361,62,62,0,1,0
23,414,414,1,1,0,1,0
14,418,418,1,1,0,1,0
15,422,422,121,103,18,3,2
13,430,430,107,49,58,3,2
21,444,444,6,6,0,1,0
20,452,452,25,25,0,1,0
17,458,458,3,3,0,1,0
0,460,460,26,8,18,4,3
5,461,461,52,44,8,2,1
24,467,467,17,17,0,1,0
1,474,474,5,1,4,2,1
27,475,475,88,54,34,4,3
10,482,482,92,4,88,3,2

30,103,103,21,4,17,2,1
20,104,104,5,5,0,1,0
3,105,105,9,1,8,3,2
32,109,109,1,1,0,1,0
28,111,111,22,2,20,2,1
35,118,118,1,1,0,1,0
2,135,135,8,5,3,2,1
39,159,159,14,14,0,1,0
17,161,161,17,17,0,1,0
12,161,161,5,5,0,1,0
16,174,174,20,10,10,2,1
22,185,185,11,11,0,1,0
19,193,193,14,14,0,1,0
29,195,195,46,19,27,4,3
40,210,210,25,9,16,3,2
23,232,232,17,11,6,2,1
25,234,234,7,7,0,1,0
21,235,235,21,21,0,1,0
33,249,249,33,33,0,1,0
26,263,263,15,9,6,3,2
5,294,294,6,6,0,1,0
24,300,300,39,5,34,4,3
36,304,304,34,2,32,2,1
9,314,314,61,61,0,1,0
18,335,335,40,24,16,3,2
7,336,336,23,20,3,2,1
14,336,336,19,4,15,2,1
37,368,368,41,34,7,2,1
13,369,369,10,4,6,2,1
27,374,374,18,2,16,3,2
4,384,384,96,96,0,1,0
11,387,387,15,15,0,1,0
34,420,420,34,28,6,3,2
0,454,454,1,1,0,1,0
31,468,468,71,71,0,1,0
1,470,470,20,20,0,1,0
8,489,489,79,79,0,1,0
15,489,489,1,1,0,1,0
6,490,490,40,17,23,2,1
10,490,490,34,34,0,1,0
38,500,500,30,30,0,1,0

19,124,124,5,2,3,2,1
37,131,131,27,27,0,1,0
21,147,147,10,2,8,2,1
10,161,161,20,20,0,1,0
3,193,193,2,2,0,1,0
13,204,204,10,10,0,1,0
25,213,213,26,26,0,1,0
11,214,214,39,39,0,1,0
16,217,217,15,15,0,1,0
29,217,217,50,44,6,3,2
12,221,221,7,4,3,2,1
33,230,230,8,8,0,1,0
4,232,232,2,2,0,1,0
34,232,232,8,1,7,2,1
35,234,234,1,1,0,1,0
22,255,255,23,23,0,1,0
17,265,265,16,16,0,1,0
8,267,267,31,31,0,1,0
36,275,275,6,6,0,1,0
0,342,342,21,5,16,3,2
2,343,343,1,1,0,1,0
23,346,346,17,17,0,1,0
15,354,354,13,13,0,1,0
1,360,360,8,8,0,1,0
18,361,361,152,74,78,4,3
26,375,375,56,56,0,1,0
24,381,381,11,11,0,1,0
28,388,388,73,73,0,1,0
20,392,392,61,50,11,2,1
32,395,395,80,80,0,1,0
9,401,401,80,80,0,1,0
7,437,437,126,77,49,3,2
5,442,442,5,5,0,1,0
27,448,448,33,33,0,1,0
14,451,451,21,21,0,1,0
6,456,456,9,9,0,1,0
31,479,479,53,53,0,1,0
30,490,490,33,33,0,1,0

3,113,113,22,22,0,1,0
14,115,115,8,8,0,1,0
35,121,121,4,1,3,2,1
21,125,125,18,18,0,1,0
25,142,142,1,1,0,1,0
5,149,149,10,10,0,1,0
33,150,150,10,10,0,1,0
16,163,163,3,3,0,1,0
26,164,164,16,16,0,1,0
13,195,195,25,25,0,1,0
19,195,195,10,10,0,1,0
6,195,195,32,14,18,4,3
34,203,203,2,2,0,1,0
1,206,206,1,1,0,1,0
29,256,256,46,37,9,4,3
22,266,266,17,6,11,4,3
32,274,274,13,3,10,2,1
10,282,282,17,2,15,4,3
11,283,283,15,15,0,1,0
18,287,287,15,15,0,1,0
28,303,303,28,28,0,1,0
24,312,312,41,41,0,1,0
17,316,316,21,9,12,2,1
30,328,328,58,58,0,1,0
27,328,328,7,7,0,1,0
12,330,330,20,2,18,3,2
36,341,341,61,34,27,4,3
31,363,363,24,4,20,2,1
8,388,388,40,8,32,3,2
15,390,390,115,83,32,4,3
4,392,392,68,28,40,3,2
7,394,394,52,35,17,2,1
2,399,399,14,14,0,1,0
9,401,401,21,12,9,2,1
23,412,412,68,23,45,2,1
0,470,470,34,8,26,3,2
20,482,482,151,94,57,4,3

3,102,102,9,1,8,3,2
34,116,116,18,18,0,1,0
13,128,128,34,34,0,1,0
32,131,131,8,8,0,1,0
11,134,134,7,7,0,1,0
9,142,142,5,5,0,1,0
8,145,145,24,24,0,1,0
26,155,155,6,6,0,1,0
2,161,161,2,2,0,1,0
28,171,171,31,31,0,1,0
12,200,200,1,1,0,1,0
23,205,205,15,15,0,1,0
18,216,216,75,18,57,4,3
0,221,221,13,13,0,1,0
33,235,235,67,26,41,2,1
36,238,238,4,4,0,1,0
29,239,239,14,4,10,3,2
17,263,263,1,1,0,1,0
27,281,281,1,1,0,1,0
20,289,289,14,6,8,3,2
19,311,311,41,29,12,3,2
14,312,312,12,7,5,2,1
15,335,335,22,11,11,2,1
10,339,339,70,70,0,1,0
31,368,368,2,2,0,1,0
1,387,387,8,4,4,2,1
16,398,398,25,19,6,3,2
25,407,407,31,14,17,2,1
30,410,410,59,59,0,1,0
4,419,419,59,59,0,1,0
5,426,426,44,6,38,3,2
35,439,439,115,59,56,3,2
21,441,441,45,45,0,1,0
24,472,472,86,67,19,2,1
7,482,482,50,50,0,1,0
22,492,492,8,1,7,2,1
6,492,492,13,13,0,1,0

14,133,133,5,1,4,2,1
1,133,133,19,19,0,1,0
22,144,144,1,1,0,1,0
11,148,148,1,1,0,1,0
25,151,151,5,1,4,2,1
6,185,185,49,28,21,2,1
27,188,188,8,3,5,2,1
16,215,215,11,11,0,1,0
0,228,228,57,33,24,4,3
2,241,241,34,34,0,1,0
20,248,248,19,3,16,4,3
10,250,250,13,3,10,2,1
12,259,259,33,33,0,1,0
18,265,265,35,35,0,1,0
4,282,282,194,108,86,4,3
26,284,284,10,1,9,2,1
15,295,295,20,20,0,1,0
21,307,307,46,4,42,3,2
9,308,308,12,12,0,1,0
5,346,346,1,1,0,1,0
7,361,361,46,46,0,1,0
23,365,365,20,20,0,1,0
8,371,371,27,4,23,2,1
3,421,421,30,6,24,4,3
13,448,448,95,67,28,3,2
17,466,466,175,175,0,1,0
19,472,472,172,143,29,2,1
24,495,495,6,6,0,1,0

33,124,124,34,34,0,1,0
18,126,126,16,11,5,2,1
3,131,131,13,10,3,2,1
34,134,134,14,8,6,3,2
23,147,147,5,5,0,1,0
5,155,155,24,24,0,1,0
24,182,182,25,25,0,1,0
12,190,190,23,5,18,4,3
2,197,197,24,24,0,1,0
30,211,211,8,8,0,1,0
31,215,215,29,4,25,3,2
21,231,231,1,1,0,1,0
0,250,250,10,1,9,4,3
4,279,279,3,3,0,1,0
28,280,280,58,58,0,1,0
14,296,296,1,1,0,1,0
17,307,307,2,2,0,1,0
25,344,344,106,106,0,1,0
26,356,356,31,31,0,1,0
29,359,359,42,8,34,3,2
20,363,363,9,5,4,2,1
27,363,363,4,1,3,2,1
19,377,377,26,26,0,1,0
16,390,390,64,24,40,2,1
15,413,413,74,54,20,3,2
13,418,418,43,18,25,4,3
9,421,421,25,16,9,2,1
32,429,429,22,22,0,1,0
7,438,438,75,45,30,4,3
11,472,472,30,13,17,2,1
22,473,473,49,31,18,2,1
8,482,482,16,11,5,2,1
6,493,493,11,11,0,1,0
1,494,494,215,215,0,1,0
10,496,496,10,4,6,3,2

22,100,100,22,22,0,1,0
5,100,100,20,3,17,2,1
39,103,103,2,2,0,1,0
3,106,106,1,1,0,1,0
12,111,111,12,6,6,2,1
2,120,120,20,2,18,2,1
0,122,122,2,2,0,1,0
27,125,125,6,6,0,1,0
21,134,134,2,2,0,1,0
20,163,163,17,17,0,1,0
38,170,170,33,33,0,1,0
34,174,174,5,5,0,1,0
13,195,195,18,5,13,2,1
15,229,229,1,1,0,1,0
31,230,230,39,13,26,3,2
35,233,233,30,9,21,2,1
29,236,236,28,2,26,3,2
4,251,251,1,1,0,1,0
6,251,251,5,2,3,2,1
23,256,256,14,3,11,2,1
11,284,284,67,67,0,1,0
26,297,297,20,10,10,3,2
9,319,319,36,23,13,2,1
17,321,321,26,8,18,4,3
30,328,328,45,22,23,2,1
7,339,339,45,45,0,1,0
25,345,345,36,36,0,1,0
37,350,350,55,15,40,3,2
24,374,374,43,43,0,1,0
32,384,384,36,14,22,2,1
8,390,390,28,28,0,1,0
28,397,397,47,47,0,1,0
33,407,407,3,3,0,1,0
10,416,416,14,1,13,2,1
14,419,419,5,5,0,1,0
1,423,423,50,37,13,2,1
36,454,454,24,8,16,3,2
18,460,460,4,1,3,2,1
19,478,478,113,101,12,2,1
16,483,483,10,10,0,1,0

0,127,127,1,1,0,1,0
15,130,130,19,1,18,3,2
23,149,149,59,3,56,3,2
27,169,169,11,11,0,1,0
5,175,175,19,7,12,4,3
28,207,207,21,21,0,1,0
17,235,235,8,8,0,1,0
18,251,251,29,12,17,2,1
3,262,262,1,1,0,1,0
25,268,268,16,8,8,3,2
20,308,308,38,38,0,1,0
12,321,321,80,80,0,1,0
13,326,326,45,31,14,2,1
2,326,326,49,49,0,1,0
21,339,339,39,39,0,1,0
14,348,348,49,49,0,1,0
1,350,350,7,7,0,1,0
7,354,354,25,22,3,2,1
30,373,373,28,7,21,4,3
8,382,382,86,34,52,4,3
24,412,412,25,25,0,1,0
31,421,421,28,28,0,1,0
10,427,427,24,19,5,2,1
22,432,432,41,41,0,1,0
16,436,436,8,8,0,1,0
6,436,436,29,5,24,2,1
32,437,437,58,58,0,1,0
26,445,445,38,24,14,2,1
11,448,448,55,9,46,2,1
29,469,469,3,3,0,1,0
19,471,471,61,61,0,1,0
9,493,493,80,80,0,1,0
4,500,500,140,23,117,4,3

29,114,114,11,11,0,1,0
12,122,122,10,4,6,3,2
19,127,127,23,23,0,1,0
15,128,128,10,10,0,1,0
0,141,141,5,5,0,1,0
5,177,177,27,27,0,1,0
11,203,203,49,36,13,2,1
31,231,231,14,14,0,1,0
33,240,240,13,13,0,1,0
7,246,246,4,4,0,1,0
17,251,251,4,1,3,2,1
21,265,265,28,2,26,2,1
3,270,270,76,42,34,3,2
10,272,272,21,7,14,3,2
6,273,273,16,16,0,1,0
2,335,335,5,5,0,1,0
27,341,341,21,11,10,2,1
28,343,343,88,88,0,1,0
32,366,366,7,4,3,2,1
4,373,373,58,40,18,3,2
8,393,393,46,46,0,1,0
23,395,395,3,3,0,1,0
9,411,411,89,60,29,2,1
25,413,413,4,4,0,1,0
24,418,418,28,28,0,1,0
18,427,427,7,7,0,1,0
20,444,444,4,4,0,1,0
14,448,448,42,10,32,2,1
13,451,451,21,11,10,3,2
30,457,457,148,112,36,2,1
1,459,459,61,61,0,1,0
26,462,462,174,174,0,1,0
22,469,469,35,35,0,1,0
16,476,476,47,21,26,4,3

0,108,108,1,1,0,1,0
11,121,121,27,27,0,1,0
5,128,128,12,12,0,1,0
24,132,132,16,16,0,1,0
25,136,136,37,19,18,2,1
9,139,139,21,21,0,1,0
15,140,140,36,36,0,1,0
1,169,169,3,3,0,1,0
28,171,171,2,2,0,1,0
7,197,197,16,3,13,2,1
30,197,197,48,20,28,3,2
22,212,212,27,11,16,2,1
6,213,213,7,1,6,2,1
10,218,218,23,23,0,1,0
3,233,233,4,4,0,1,0
20,255,255,11,5,6,2,1
31,258,258,41,11,30,4,3
21,282,282,4,4,0,1,0
23,299,299,9,9,0,1,0
17,326,326,30,30,0,1,0
33,341,341,46,46,0,1,0
19,346,346,13,13,0,1,0
29,347,347,28,28,0,1,0
16,367,367,21,12,9,4,3
12,404,404,8,8,0,1,0
4,404,404,64,32,32,3,2
37,408,408,46,29,17,2,1
34,409,409,23,23,0,1,0
18,421,421,110,71,39,4,3
27,427,427,30,30,0,1,0
8,466,466,59,23,36,4,3
2,474,474,16,16,0,1,0
14,481,481,2,2,0,1,0
13,481,481,11,11,0,1,0
36,490,490,15,1,14,3,2
35,494,494,8,1,7,2,1
26,499,499,138,86,52,3,2
32,500,500,21,21,0,1,0

20,106,106,49,21,28,3,2
3,136,136,19,19,0,1,0
2,152,152,16,16,0,1,0
15,152,152,2,2,0,1,0
11,153,153,55,7,48,4,3
19,155,155,3,3,0,1,0
14,178,178,55,15,40,3,2
12,196,196,10,10,0,1,0
26,204,204,30,27,3,2,1
28,211,211,4,4,0,1,0
8,234,234,1,1,0,1,0
17,241,241,7,7,0,1,0
30,249,249,40,40,0,1,0
7,262,262,8,1,7,2,1
18,279,279,20,2,18,4,3
13,284,284,23,5,18,4,3
33,301,301,42,3,39,2,1
10,319,319,53,53,0,1,0
4,329,329,2,2,0,1,0
5,341,341,17,17,0,1,0
24,353,353,10,10,0,1,0
6,358,358,16,11,5,2,1
23,365,365,73,30,43,4,3
0,375,375,4,4,0,1,0
25,377,377,48,48,0,1,0
1,379,379,37,37,0,1,0
32,384,384,6,3,3,2,1
29,406,406,35,35,0,1,0
16,407,407,2,2,0,1,0
31,433,433,90,44,46,3,2
9,450,450,150,117,33,4,3
27,469,469,5,5,0,1,0
21,476,476,33,17,16,2,1
22,481,481,19,19,0,1,0

4,106,106,12,7,5,2,1
2,127,127,2,2,0,1,0
16,133,133,24,12,12,2,1
0,143,143,9,9,0,1,0
22,144,144,12,6,6,3,2
20,152,152,6,2,4,2,1
10,160,160,11,6,5,2,1
13,179,179,8,8,0,1,0
15,189,189,10,10,0,1,0
12,192,192,15,15,0,1,0
33,193,193,2,2,0,1,0
6,214,214,5,1,4,2,1
1,217,217,41,23,18,3,2
24,221,221,1,1,0,1,0
34,247,247,31,13,18,3,2
26,278,278,42,3,39,2,1
8,291,291,6,6,0,1,0
7,292,292,21,2,19,3,2
29,294,294,4,4,0,1,0
35,298,298,45,15,30,4,3
28,309,309,22,22,0,1,0
17,326,326,79,61,18,3,2
21,337,337,51,40,11,2,1
3,337,337,4,4,0,1,0
14,349,349,137,4,133,4,3
27,359,359,93,9,84,4,3
11,368,368,42,42,0,1,0
31,379,379,28,6,22,2,1
5,385,385,36,10,26,3,2
19,396,396,14,9,5,2,1
23,422,422,8,8,0,1,0
32,444,444,42,42,0,1,0
18,450,450,38,38,0,1,0
25,465,465,210,204,6,3,2
9,471,471,12,3,9,4,3
30,479,479,9,9,0,1,0

37,113,113,1,1,0,1,0
34,127,127,4,1,3,2,1
33,140,140,55,3,52,3,2
14,150,150,22,8,14,3,2
22,157,157,22,13,9,4,3
2,169,169,49,42,7,2,1
23,173,173,7,3,4,2,1
36,177,177,5,2,3,2,1
9,193,193,3,3,0,1,0
16,208,208,14,14,0,1,0
5,211,211,1,1,0,1,0
25,217,217,5,5,0,1,0
26,220,220,24,12,12,3,2
12,229,229,21,21,0,1,0
8,229,229,29,29,0,1,0
17,235,235,24,6,18,3,2
13,248,248,49,41,8,2,1
0,249,249,22,6,16,4,3
11,281,281,3,3,0,1,0
20,281,281,30,6,24,2,1
29,282,282,13,1,12,4,3
38,289,289,8,8,0,1,0
10,293,293,26,26,0,1,0
3,302,302,19,19,0,1,0
19,305,305,22,13,9,4,3
32,308,308,28,10,18,2,1
30,313,313,20,20,0,1,0
35,331,331,19,10,9,4,3
7,332,332,1,1,0,1,0
27,347,347,49,11,38,3,2
1,373,373,50,50,0,1,0
18,375,375,18,1,17,2,1
24,392,392,46,46,0,1,0
28,428,428,51,22,29,3,2
4,435,435,19,2,17,2,1
6,436,436,11,4,7,2,1
31,447,447,101,76,25,4,3
21,448,448,76,2,74,3,2
15,471,471,36,5,31,4,3

15,103,103,21,21,0,1,0
22,119,119,4,4,0,1,0
21,127,127,21,21,0,1,0
0,134,134,1,1,0,1,0
16,151,151,4,4,0,1,0
38,162,162,2,2,0,1,0
7,166,166,11,11,0,1,0
5,169,169,12,12,0,1,0
30,172,172,13,13,0,1,0
9,180,180,13,13,0,1,0
27,193,193,48,34,14,2,1
17,194,194,25,15,10,2,1
29,197,197,2,2,0,1,0
3,200,200,55,5,50,4,3
2,220,220,35,14,21,4,3
6,222,222,1,1,0,1,0
23,228,228,17,2,15,4,3
18,240,240,86,86,0,1,0
24,247,247,7,4,3,2,1
10,249,249,6,3,3,2,1
20,260,260,7,3,4,2,1
36,267,267,3,3,0,1,0
1,273,273,24,11,13,2,1
13,283,283,5,5,0,1,0
34,288,288,59,27,32,3,2
12,307,307,22,16,6,2,1
31,314,314,102,102,0,1,0
8,326,326,39,1,38,2,1
32,344,344,10,10,0,1,0
19,351,351,6,6,0,1,0
4,354,354,12,12,0,1,0
25,357,357,21,21,0,1,0
37,384,384,53,26,27,2,1
11,397,397,8,8,0,1,0
35,404,404,2,2,0,1,0
26,421,421,142,73,69,4,3
14,429,429,5,1,4,2,1
33,472,472,14,14,0,1,0
28,494,494,29,5,24,3,2

9,103,103,6,6,0,1,0
28,110,110,11,2,9,2,1
41,112,112,32,32,0,1,0
23,115,115,6,6,0,1,0
20,122,122,21,21,0,1,0
18,130,130,9,9,0,1,0
29,147,147,3,3,0,1,0
0,149,149,1,1,0,1,0
7,156,156,9,4,5,2,1
15,162,162,11,11,0,1,0
39,163,163,3,3,0,1,0
8,202,202,3,3,0,1,0
13,220,220,73,7,66,3,2
1,229,229,9,9,0,1,0
31,251,251,6,6,0,1,0
14,257,257,1,1,0,1,0
35,269,269,43,43,0,1,0
30,272,272,29,20,9,2,1
17,280,280,19,1,18,3,2
12,296,296,52,52,0,1,0
5,302,302,1,1,0,1,0
22,320,320,1,1,0,1,0
40,320,320,101,101,0,1,0
37,323,323,11,11,0,1,0
19,326,326,45,45,0,1,0
38,328,328,26,8,18,3,2
34,337,337,36,36,0,1,0
24,340,340,4,4,0,1,0
11,353,353,36,12,24,4,3
6,354,354,2,2,0,1,0
25,359,359,113,113,0,1,0
4,365,365,5,5,0,1,0
2,411,411,77,24,53,3,2
16,418,418,10,10,0,1,0
27,420,420,21,21,0,1,0
3,461,461,8,8,0,1,0
26,464,464,3,3,0,1,0
36,467,467,52,40,12,4,3
10,477,477,76,76,0,1,0
21,482,482,15,15,0,1,0
33,489,489,8,8,0,1,0
32,490,490,35,35,0,1,0

4,111,111,1,1,0,1,0
6,119,119,7,7,0,1,0
10,120,120,11,5,6,2,1
13,127,127,2,2,0,1,0
0,149,149,8,8,0,1,0
12,152,152,7,7,0,1,0
31,157,157,1,1,0,1,0
9,166,166,28,28,0,1,0
36,199,199,8,1,7,2,1
22,213,213,13,7,6,3,2
1,213,213,11,11,0,1,0
26,227,227,27,27,0,1,0
20,238,238,57,57,0,1,0
11,242,242,58,22,36,4,3
18,244,244,63,63,0,1,0
8,261,261,24,24,0,1,0
16,262,262,3,3,0,1,0
3,269,269,6,6,0,1,0
35,270,270,41,15,26,2,1
30,274,274,44,44,0,1,0
29,340,340,13,13,0,1,0
27,351,351,14,2,12,2,1
19,377,377,37,37,0,1,0
23,390,390,72,36,36,4,3
7,390,390,13,1,12,3,2
28,393,393,79,54,25,4,3
37,395,395,13,1,12,2,1
33,400,400,133,97,36,4,3
38,403,403,25,17,8,2,1
17,408,408,45,27,18,2,1
21,423,423,90,5,85,4,3
14,435,435,22,3,19,3,2
34,459,459,15,15,0,1,0
2,460,460,1,1,0,1,0
5,464,464,43,21,22,3,2
25,479,479,35,35,0,1,0
15,482,482,27,27,0,1,0
24,500,500,42,42,0,1,0
32,500,500,2,2,0,1,0

38,103,103,10,10,0,1,0
21,111,111,25,25,0,1,0
2,113,113,1,1,0,1,0
9,120,120,3,3,0,1,0
18,167,167,3,3,0,1,0
35,170,170,1,1,0,1,0
36,189,189,10,4,6,2,1
0,216,216,18,3,15,4,3
5,217,217,28,28,0,1,0
22,223,223,3,3,0,1,0
29,236,236,13,13,0,1,0
37,236,236,71,37,34,2,1
3,243,243,1,1,0,1,0
24,248,248,9,9,0,1,0
23,261,261,20,6,14,2,1
20,264,264,32,32,0,1,0
28,273,273,70,40,30,4,3
17,282,282,15,15,0,1,0
31,293,293,65,47,18,3,2
12,295,295,34,34,0,1,0
1,308,308,1,1,0,1,0
39,310,310,76,21,55,3,2
16,342,342,39,39,0,1,0
19,347,347,37,2,35,2,1
7,351,351,16,16,0,1,0
30,369,369,40,40,0,1,0
34,376,376,45,45,0,1,0
33,403,403,54,54,0,1,0
4,407,407,5,2,3,2,1
15,412,412,11,1,10,3,2
27,439,439,2,2,0,1,0
8,462,462,66,22,44,3,2
10,463,463,13,7,6,2,1
11,464,464,93,45,48,2,1
32,465,465,21,8,13,2,1
13,466,466,42,42,0,1,0
6,481,481,51,25,26,3,2
25,491,491,12,1,11,2,1
14,498,498,73,39,34,3,2
26,498,498,21,4,17,4,3

16,112,112,1,1,0,1,0
9,112,112,16,8,8,2,1
11,114,114,23,4,19,2,1
6,117,117,10,6,4,2,1
32,144,144,10,10,0,1,0
7,144,144,6,6,0,1,0
3,153,153,3,3,0,1,0
27,155,155,11,11,0,1,0
36,159,159,37,28,9,2,1
14,168,168,19,19,0,1,0
8,190,190,37,37,0,1,0
33,196,196,6,6,0,1,0
34,206,206,4,4,0,1,0
28,254,254,36,36,0,1,0
0,254,254,7,7,0,1,0
1,254,254,35,35,0,1,0
29,267,267,32,32,0,1,0
37,293,293,14,14,0,1,0
12,294,294,42,19,23,4,3
25,295,295,23,17,6,3,2
20,302,302,7,3,4,2,1
24,319,319,7,7,0,1,0
2,325,325,5,5,0,1,0
23,327,327,44,44,0,1,0
10,336,336,64,17,47,2,1
15,351,351,15,11,4,2,1
19,384,384,86,38,48,3,2
18,385,385,27,11,16,2,1
21,391,391,50,20,30,2,1
17,399,399,8,8,0,1,0
38,418,418,10,10,0,1,0
22,425,425,5,5,0,1,0
26,426,426,152,128,24,2,1
5,427,427,6,6,0,1,0
35,437,437,6,6,0,1,0
13,456,456,31,31,0,1,0
30,467,467,3,3,0,1,0
31,478,478,157,43,114,4,3
4,482,482,8,5,3,2,1

8,101,101,31,19,12,2,1
2,128,128,58,46,12,4,3
5,135,135,19,19,0,1,0
24,145,145,10,6,4,2,1
11,168,168,34,1,33,4,3
19,172,172,31,15,16,2,1
1,173,173,1,1,0,1,0
28,174,174,17,17,0,1,0
9,185,185,18,18,0,1,0
27,228,228,28,28,0,1,0
23,240,240,2,2,0,1,0
6,253,253,24,24,0,1,0
12,264,264,13,1,12,4,3
25,314,314,38,38,0,1,0
29,323,323,30,4,26,3,2
17,337,337,4,4,0,1,0
0,361,361,4,4,0,1,0
13,371,371,34,34,0,1,0
20,387,387,21,12,9,4,3
18,399,399,15,15,0,1,0
31,406,406,26,26,0,1,0
30,413,413,87,57,30,4,3
15,418,418,31,10,21,2,1
3,431,431,47,47,0,1,0
14,435,435,130,130,0,1,0
16,442,442,43,43,0,1,0
22,444,444,19,19,0,1,0
26,452,452,62,62,0,1,0
4,453,453,15,15,0,1,0
21,479,479,53,16,37,2,1
10,493,493,89,29,60,4,3
7,497,497,13,13,0,1,0

27,101,101,3,3,0,1,0
25,106,106,5,5,0,1,0
36,156,156,30,17,13,2,1
33,175,175,6,2,4,2,1
16,178,178,50,21,29,2,1
38,205,205,7,7,0,1,0
17,222,222,24,14,10,3,2
30,226,226,2,2,0,1,0
12,229,229,36,18,18,4,3
10,230,230,48,4,44,3,2
20,239,239,4,4,0,1,0
31,242,242,23,3,20,2,1
2,253,253,12,2,10,2,1
1,276,276,17,14,3,2,1
32,282,282,83,56,27,4,3
19,290,290,40,40,0,1,0
7,294,294,15,11,4,2,1
18,297,297,28,28,0,1,0
13,301,301,40,40,0,1,0
8,308,308,3,3,0,1,0
28,311,311,10,10,0,1,0
14,328,328,1,1,0,1,0
37,341,341,78,51,27,2,1
0,343,343,27,1,26,4,3
35,352,352,5,5,0,1,0
26,360,360,107,53,54,3,2
21,361,361,15,15,0,1,0
22,365,365,73,43,30,4,3
6,368,368,5,5,0,1,0
5,394,394,36,13,23,2,1
15,415,415,14,14,0,1,0
4,428,428,1,1,0,1,0
11,431,431,6,6,0,1,0
3,433,433,68,68,0,1,0
29,466,466,95,74,21,4,3
24,481,481,9,9,0,1,0
34,482,482,18,10,8,3,2
23,487,487,34,34,0,1,0
39,487,487,1,1,0,1,0
9,495,495,29,1,28,3,2

12,113,113,6,3,3,2,1
20,117,117,5,5,0,1,0
0,118,118,9,9,0,1,0
44,120,120,31,31,0,1,0
43,120,120,11,11,0,1,0
37,127,127,10,10,0,1,0
11,129,129,1,1,0,1,0
27,151,151,18,8,10,2,1
10,160,160,2,2,0,1,0
39,164,164,24,24,0,1,0
2,169,169,3,3,0,1,0
26,171,171,3,3,0,1,0
6,184,184,14,2,12,3,2
42,189,189,2,2,0,1,0
38,192,192,14,14,0,1,0
15,203,203,10,7,3,2,1
28,214,214,13,13,0,1,0
18,215,215,6,2,4,2,1
7,264,264,3,3,0,1,0
1,266,266,69,69,0,1,0
13,277,277,23,3,20,3,2
35,282,282,12,12,0,1,0
33,306,306,26,15,11,2,1
17,329,329,1,1,0,1,0
30,335,335,21,21,0,1,0
21,338,338,55,39,16,2,1
34,347,347,121,121,0,1,0
31,355,355,54,30,24,2,1
3,364,364,22,4,18,4,3
14,371,371,1,1,0,1,0
29,394,394,23,23,0,1,0
22,394,394,16,16,0,1,0
5,394,394,21,11,10,3,2
16,406,406,43,43,0,1,0
8,408,408,69,69,0,1,0
32,427,427,33,15,18,2,1
24,429,429,12,7,5,2,1
40,434,434,32,32,0,1,0
41,440,440,1,1,0,1,0
19,462,462,63,48,15,2,1
23,467,467,105,62,43,4,3
36,467,467,45,45,0,1,0
25,479,479,1,1,0,1,0
9,480,480,23,23,0,1,0
4,494,494,16,16,0,1,0

13,108,108,1,1,0,1,0
2,110,110,1,1,0,1,0
23,111,111,11,11,0,1,0
27,125,125,7,7,0,1,0
35,127,127,10,5,5,2,1
12,135,135,19,10,9,4,3
0,143,143,2,2,0,1,0
28,143,143,14,10,4,2,1
31,147,147,3,3,0,1,0
6,149,149,30,30,0,1,0
3,152,152,7,7,0,1,0
20,159,159,57,15,42,2,1
32,166,166,25,25,0,1,0
1,180,180,8,8,0,1,0
25,199,199,7,7,0,1,0
5,215,215,10,1,9,2,1
34,227,227,25,25,0,1,0
19,236,236,36,36,0,1,0
10,240,240,14,3,11,2,1
14,248,248,7,3,4,2,1
16,258,258,1,1,0,1,0
24,262,262,78,33,45,3,2
18,266,266,8,8,0,1,0
39,279,279,5,5,0,1,0
29,281,281,19,19,0,1,0
15,311,311,2,2,0,1,0
37,311,311,41,41,0,1,0
22,323,323,11,11,0,1,0
17,325,325,47,2,45,4,3
9,331,331,25,19,6,3,2
30,363,363,27,27,0,1,0
11,367,367,12,7,5,2,1
38,392,392,23,12,11,2,1
4,403,403,126,21,105,4,3
8,406,406,8,2,6,3,2
21,410,410,12,12,0,1,0
26,418,418,129,120,9,2,1
7,454,454,1,1,0,1,0
40,488,488,34,34,0,1,0
33,489,489,10,10,0,1,0
36,499,499,71,27,44,4,3

13,101,101,2,2,0,1,0
11,126,126,27,1,26,3,2
34,135,135,9,9,0,1,0
16,138,138,18,3,15,2,1
6,146,146,3,3,0,1,0
12,169,169,47,32,15,2,1
22,172,172,1,1,0,1,0
25,193,193,13,13,0,1,0
10,202,202,14,14,0,1,0
26,215,215,5,5,0,1,0
4,225,225,20,20,0,1,0
38,242,242,32,32,0,1,0
17,256,256,15,15,0,1,0
29,266,266,33,33,0,1,0
1,269,269,13,1,12,4,3
21,269,269,46,27,19,2,1
14,271,271,26,26,0,1,0
28,275,275,19,12,7,2,1
23,280,280,8,8,0,1,0
0,296,296,11,8,3,2,1
18,308,308,66,66,0,1,0
7,309,309,7,7,0,1,0
30,315,315,92,41,51,4,3
37,334,334,77,39,38,3,2
8,349,349,2,2,0,1,0
32,380,380,9,9,0,1,0
33,397,397,35,35,0,1,0
19,404,404,3,3,0,1,0
31,410,410,27,27,0,1,0
20,413,413,79,46,33,2,1
15,414,414,27,27,0,1,0
9,418,418,47,47,0,1,0
2,443,443,16,4,12,3,2
5,446,446,28,3,25,2,1
27,450,450,32,8,24,3,2
35,451,451,95,68,27,4,3
24,471,471,64,64,0,1,0
3,476,476,10,1,9,2,1
36,486,486,17,10,7,2,1

38,104,104,10,1,9,4,3
17,110,110,4,4,0,1,0
16,111,111,35,3,32,3,2
19,112,112,7,1,6,2,1
28,114,114,16,16,0,1,0
30,185,185,4,4,0,1,0
21,186,186,9,9,0,1,0
6,194,194,19,19,0,1,0
41,205,205,20,20,0,1,0
0,221,221,59,59,0,1,0
18,225,225,40,40,0,1,0
26,225,225,16,16,0,1,0
35,237,237,30,16,14,2,1
9,245,245,29,9,20,3,2
20,245,245,4,4,0,1,0
22,245,245,1,1,0,1,0
2,251,251,25,25,0,1,0
36,253,253,44,19,25,4,3
39,257,257,42,25,17,4,3
12,258,258,7,7,0,1,0
31,274,274,1,1,0,1,0
7,288,288,20,20,0,1,0
5,292,292,31,31,0,1,0
11,297,297,10,10,0,1,0
24,300,300,29,29,0,1,0
15,323,323,5,5,0,1,0
10,327,327,48,48,0,1,0
25,332,332,4,4,0,1,0
27,332,332,10,1,9,2,1
33,338,338,28,28,0,1,0
40,363,363,34,34,0,1,0
4,375,375,10,10,0,1,0
3,375,375,6,6,0,1,0
29,398,398,33,3,30,2,1
34,399,399,26,5,21,4,3
8,411,411,9,6,3,2,1
37,414,414,3,3,0,1,0
23,426,426,6,6,0,1,0
13,428,428,7,1,6,2,1
1,439,439,22,22,0,1,0
14,474,474,6,6,0,1,0
32,490,490,230,185,45,2,1

28,100,100,4,1,3,2,1
29,109,109,25,25,0,1,0
20,110,110,8,8,0,1,0
15,145,145,48,48,0,1,0
12,159,159,2,2,0,1,0
18,169,169,3,3,0,1,0
22,200,200,5,1,4,2,1
39,204,204,25,25,0,1,0
4,213,213,1,1,0,1,0
1,218,218,35,1,34,3,2
37,250,250,2,2,0,1,0
19,251,251,6,6,0,1,0
10,262,262,19,1,18,4,3
0,280,280,4,4,0,1,0
2,284,284,10,10,0,1,0
7,285,285,53,45,8,3,2
6,301,301,15,9,6,3,2
31,313,313,46,46,0,1,0
24,325,325,70,61,9,4,3
11,333,333,18,18,0,1,0
3,335,335,63,63,0,1,0
33,340,340,8,4,4,2,1
34,355,355,8,8,0,1,0
5,366,366,1,1,0,1,0
30,367,367,60,60,0,1,0
14,372,372,57,57,0,1,0
16,381,381,57,14,43,4,3
36,384,384,2,2,0,1,0
21,384,384,5,5,0,1,0
9,392,392,17,17,0,1,0
8,409,409,34,7,27,2,1
38,409,409,97,97,0,1,0
26,428,428,44,11,33,4,3
32,437,437,14,14,0,1,0
23,438,438,38,15,23,2,1
27,453,453,74,2,72,4,3
25,453,453,31,31,0,1,0
35,472,472,67,59,8,3,2
17,474,474,5,5,0,1,0
13,493,493,60,10,50,3,2

1,108,108,18,4,14,3,2
14,133,133,2,2,0,1,0
26,136,136,2,2,0,1,0
37,138,138,15,12,3,2,1
24,153,153,44,44,0,1,0
13,163,163,48,48,0,1,0
12,169,169,14,14,0,1,0
29,189,189,19,4,15,2,1
27,213,213,5,5,0,1,0
40,213,213,15,9,6,3,2
18,241,241,6,6,0,1,0
39,260,260,55,29,26,2,1
33,260,260,2,2,0,1,0
38,264,264,47,47,0,1,0
16,265,265,20,20,0,1,0
8,273,273,9,9,0,1,0
32,292,292,23,23,0,1,0
0,309,309,6,6,0,1,0
19,312,312,22,22,0,1,0
21,312,312,4,4,0,1,0
36,314,314,23,2,21,2,1
10,328,328,17,9,8,3,2
28,332,332,33,5,28,3,2
22,335,335,19,19,0,1,0
3,341,341,38,30,8,2,1
15,345,345,6,6,0,1,0
25,354,354,66,37,29,2,1
34,363,363,32,17,15,4,3
9,364,364,25,25,0,1,0
30,377,377,109,29,80,3,2
17,383,383,87,14,73,4,3
5,392,392,50,14,36,3,2
31,401,401,3,3,0,1,0
23,413,413,44,44,0,1,0
4,439,439,30,30,0,1,0
35,441,441,5,5,0,1,0
2,450,450,25,25,0,1,0
11,453,453,23,23,0,1,0
20,466,466,16,16,0,1,0
7,472,472,2,2,0,1,0
41,479,479,5,5,0,1,0
6,498,498,13,13,0,1,0

8,104,104,1,1,0,1,0
32,105,105,7,7,0,1,0
0,111,111,2,2,0,1,0
43,114,114,11,11,0,1,0
26,118,118,6,6,0,1,0
39,123,123,7,7,0,1,0
17,134,134,3,3,0,1,0
13,144,144,1,1,0,1,0
40,151,151,33,24,9,4,3
47,166,166,9,9,0,1,0
45,176,176,32,32,0,1,0
38,180,180,40,12,28,3,2
37,183,183,15,15,0,1,0
35,186,186,15,3,12,2,1
44,191,191,28,28,0,1,0
23,204,204,13,13,0,1,0
18,230,230,18,18,0,1,0
48,237,237,8,8,0,1,0
15,249,249,4,4,0,1,0
24,254,254,19,3,16,2,1
28,264,264,12,1,11,2,1
6,264,264,1,1,0,1,0
20,294,294,25,5,20,3,2
14,308,308,37,37,0,1,0
31,309,309,10,10,0,1,0
5,324,324,7,7,0,1,0
4,345,345,39,8,31,2,1
1,351,351,136,34,102,4,3
9,355,355,18,6,12,2,1
34,364,364,19,4,15,2,1
33,367,367,12,9,3,2,1
7,371,371,11,3,8,3,2
3,374,374,11,3,8,2,1
42,376,376,35,4,31,2,1
2,377,377,7,2,5,2,1
10,380,380,1,1,0,1,0
16,384,384,92,58,34,2,1
21,399,399,16,9,7,2,1
12,404,404,4,4,0,1,0
41,405,405,18,18,0,1,0
11,407,407,38,38,0,1,0
30,426,426,4,4,0,1,0
22,426,426,18,18,0,1,0
46,464,464,89,89,0,1,0
29,474,474,6,6,0,1,0
19,495,495,17,17,0,1,0
27,499,499,6,3,3,2,1
36,500,500,86,86,0,1,0
25,500,500,30,30,0,1,0

15,114,114,10,10,0,1,0
27,117,117,7,7,0,1,0
34,117,117,6,6,0,1,0
14,128,128,1,1,0,1,0
33,143,143,22,22,0,1,0
0,150,150,8,8,0,1,0
9,178,178,10,4,6,3,2
25,187,187,3,3,0,1,0
30,203,203,38,38,0,1,0
31,204,204,1,1,0,1,0
36,216,216,22,22,0,1,0
22,216,216,50,23,27,4,3
20,230,230,4,4,0,1,0
11,256,256,3,3,0,1,0
10,262,262,16,10,6,3,2
24,280,280,10,10,0,1,0
3,293,293,3,3,0,1,0
8,297,297,44,8,36,2,1
2,303,303,58,58,0,1,0
17,320,320,12,12,0,1,0
21,338,338,105,21,84,3,2
35,350,350,35,35,0,1,0
29,354,354,38,38,0,1,0
5,360,360,96,19,77,4,3
4,376,376,9,9,0,1,0
6,379,379,17,17,0,1,0
28,386,386,15,15,0,1,0
26,395,395,22,6,16,2,1
13,403,403,45,7,38,3,2
16,415,415,12,1,11,2,1
12,424,424,14,14,0,1,0
19,433,433,112,112,0,1,0
38,436,436,75,64,11,2,1
7,459,459,54,54,0,1,0
1,462,462,22,7,15,2,1
32,474,474,61,33,28,3,2
37,478,478,21,11,10,3,2
18,480,480,89,89,0,1,0
23,489,489,22,10,12,3,2

13,107,107,21,21,0,1,0
14,136,136,26,5,21,4,3
12,144,144,6,1,5,2,1
18,146,146,3,3,0,1,0
35,150,150,35,14,21,4,3
19,157,157,5,5,0,1,0
33,164,164,11,1,10,3,2
36,176,176,20,20,0,1,0
1,186,186,4,4,0,1,0
7,200,200,4,4,0,1,0
27,211,211,7,3,4,2,1
24,247,247,8,4,4,2,1
15,257,257,17,17,0,1,0
16,259,259,6,6,0,1,0
11,266,266,10,10,0,1,0
25,268,268,22,4,18,3,2
0,273,273,1,1,0,1,0
17,292,292,51,42,9,2,1
3,302,302,116,116,0,1,0
6,308,308,14,14,0,1,0
9,316,316,19,19,0,1,0
30,324,324,8,3,5,2,1
21,327,327,2,2,0,1,0
31,331,331,78,28,50,3,2
8,339,339,25,25,0,1,0
20,386,386,113,113,0,1,0
23,403,403,116,116,0,1,0
29,418,418,8,8,0,1,0
22,419,419,104,73,31,2,1
28,431,431,8,8,0,1,0
4,435,435,62,49,13,2,1
34,441,441,28,18,10,2,1
10,443,443,49,1,48,3,2
5,445,445,65,56,9,4,3
26,458,458,3,3,0,1,0
32,465,465,16,10,6,3,2
2,492,492,23,6,17,2,1

17,108,108,10,2,8,3,2
23,110,110,17,6,11,2,1
32,114,114,33,1,32,4,3
31,133,133,25,25,0,1,0
4,140,140,6,6,0,1,0
14,140,140,6,1,5,2,1
8,146,146,5,5,0,1,0
15,170,170,2,2,0,1,0
18,176,176,1,1,0,1,0
21,193,193,10,10,0,1,0
3,195,195,1,1,0,1,0
22,200,200,1,1,0,1,0
6,204,204,8,8,0,1,0
10,212,212,15,15,0,1,0
0,224,224,9,9,0,1,0
1,231,231,12,9,3,2,1
9,236,236,28,28,0,1,0
20,270,270,82,52,30,3,2
2,275,275,10,10,0,1,0
26,288,288,11,11,0,1,0
27,291,291,15,9,6,3,2
37,296,296,43,34,9,4,3
36,297,297,48,48,0,1,0
29,298,298,15,15,0,1,0
25,307,307,1,1,0,1,0
42,310,310,38,38,0,1,0
24,326,326,18,12,6,3,2
38,327,327,7,2,5,2,1
28,330,330,70,34,36,3,2
35,334,334,11,11,0,1,0
11,340,340,26,17,9,2,1
5,341,341,13,1,12,3,2
13,368,368,70,70,0,1,0
16,377,377,36,28,8,2,1
34,384,384,4,4,0,1,0
30,397,397,17,17,0,1,0
33,410,410,77,53,24,4,3
7,416,416,18,14,4,2,1
41,416,416,43,43,0,1,0
19,448,448,19,10,9,2,1
12,454,454,70,70,0,1,0
40,470,470,43,7,36,2,1
39,483,483,38,38,0,1,0

29,114,114,4,4,0,1,0
34,122,122,4,4,0,1,0
27,135,135,21,3,18,2,1
37,139,139,9,9,0,1,0
4,144,144,8,4,4,2,1
7,147,147,8,8,0,1,0
2,170,170,3,3,0,1,0
8,188,188,24,18,6,3,2
17,191,191,15,1,14,2,1
28,192,192,8,3,5,2,1
24,220,220,91,81,10,3,2
20,224,224,44,44,0,1,0
13,241,241,40,13,27,2,1
33,258,258,63,63,0,1,0
36,265,265,3,3,0,1,0
23,265,265,16,4,12,4,3
16,270,270,15,15,0,1,0
3,289,289,8,4,4,2,1
5,299,299,24,15,9,2,1
21,304,304,39,39,0,1,0
19,307,307,41,41,0,1,0
11,314,314,150,150,0,1,0
35,329,329,30,17,13,2,1
6,344,344,36,9,27,4,3
26,365,365,42,42,0,1,0
1,369,369,1,1,0,1,0
30,376,376,8,8,0,1,0
0,378,378,20,8,12,4,3
18,381,381,68,35,33,2,1
25,425,425,56,39,17,2,1
31,450,450,10,6,4,2,1
14,454,454,21,2,19,2,1
12,457,457,17,17,0,1,0
22,460,460,12,12,0,1,0
9,464,464,7,7,0,1,0
10,476,476,1,1,0,1,0
32,476,476,21,21,0,1,0
15,477,477,42,24,18,3,2

8,101,101,29,9,20,2,1
0,102,102,9,9,0,1,0
12,104,104,15,10,5,2,1
28,112,112,17,17,0,1,0
22,119,119,1,1,0,1,0
1,159,159,13,13,0,1,0
10,185,185,24,24,0,1,0
26,190,190,16,16,0,1,0
21,190,190,39,36,3,2,1
17,196,196,1,1,0,1,0
25,229,229,48,5,43,2,1
19,237,237,10,4,6,2,1
11,241,241,5,5,0,1,0
3,244,244,16,16,0,1,0
24,253,253,2,2,0,1,0
13,270,270,49,49,0,1,0
31,278,278,5,1,4,2,1
30,280,280,59,39,20,3,2
6,296,296,34,7,27,4,3
20,312,312,26,26,0,1,0
5,318,318,11,11,0,1,0
2,321,321,35,22,13,2,1
23,341,341,47,27,20,2,1
15,383,383,25,11,14,3,2
34,386,386,28,28,0,1,0
9,390,390,57,57,0,1,0
14,392,392,14,11,3,2,1
27,407,407,11,1,10,3,2
33,442,442,2,2,0,1,0
7,451,451,1,1,0,1,0
16,460,460,69,69,0,1,0
32,467,467,80,72,8,2,1
18,472,472,66,66,0,1,0
4,476,476,69,5,64,3,2
29,485,485,125,77,48,4,3

7,100,100,3,3,0,1,0
1,108,108,11,5,6,2,1
32,114,114,1,1,0,1,0
30,124,124,7,7,0,1,0
22,128,128,20,20,0,1,0
20,136,136,7,7,0,1,0
25,148,148,41,17,24,4,3
6,150,150,2,2,0,1,0
11,169,169,29,2,27,3,2
29,171,171,9,1,8,3,2
26,204,204,2,2,0,1,0
13,212,212,7,7,0,1,0
19,213,213,60,48,12,3,2
5,217,217,24,16,8,3,2
12,219,219,33,1,32,3,2
17,237,237,8,8,0,1,0
16,241,241,4,1,3,2,1
28,260,260,14,14,0,1,0
3,267,267,11,11,0,1,0
0,274,274,127,127,0,1,0
18,275,275,22,6,16,3,2
23,294,294,46,1,45,2,1
4,319,319,46,2,44,2,1
27,342,342,13,3,10,2,1
15,370,370,1,1,0,1,0
2,376,376,1,1,0,1,0
10,381,381,1,1,0,1,0
24,386,386,188,65,123,4,3
9,429,429,148,148,0,1,0
8,434,434,40,32,8,2,1
21,438,438,7,7,0,1,0
14,451,451,45,45,0,1,0
31,464,464,34,34,0,1,0

8,106,106,3,3,0,1,0
14,107,107,4,4,0,1,0
10,147,147,3,3,0,1,0
5,152,152,1,1,0,1,0
0,161,161,24,24,0,1,0
33,169,169,27,27,0,1,0
27,206,206,29,29,0,1,0
15,210,210,4,4,0,1,0
13,211,211,17,4,13,2,1
3,212,212,44,26,18,3,2
26,223,223,10,3,7,2,1
29,227,227,47,26,21,4,3
12,262,262,41,28,13,2,1
25,280,280,25,25,0,1,0
28,287,287,4,4,0,1,0
34,293,293,98,83,15,4,3
2,300,300,1,1,0,1,0
4,301,301,9,9,0,1,0
17,327,327,73,19,54,4,3
16,329,329,14,14,0,1,0
21,343,343,43,43,0,1,0
9,350,350,9,2,7,2,1
31,355,355,43,43,0,1,0
6,363,363,46,16,30,4,3
18,368,368,57,3,54,3,2
35,374,374,20,9,11,2,1
7,382,382,149,56,93,4,3
24,390,390,18,8,10,3,2
30,395,395,17,8,9,4,3
11,395,395,94,33,61,3,2
20,412,412,3,3,0,1,0
19,423,423,49,37,12,2,1
1,436,436,7,7,0,1,0
22,437,437,13,13,0,1,0
23,456,456,58,53,5,2,1
32,485,485,8,4,4,2,1

14,115,115,1,1,0,1,0
6,123,123,16,9,7,2,1
20,129,129,9,9,0,1,0
10,139,139,6,6,0,1,0
0,148,148,6,6,0,1,0
8,163,163,2,2,0,1,0
7,187,187,8,3,5,2,1
30,194,194,28,4,24,3,2
24,204,204,1,1,0,1,0
31,207,207,11,11,0,1,0
16,212,212,30,30,0,1,0
28,226,226,9,4,5,2,1
3,226,226,26,7,19,2,1
25,233,233,24,6,18,2,1
1,235,235,43,17,26,4,3
22,260,260,56,56,0,1,0
19,266,266,14,2,12,3,2
35,271,271,32,17,15,2,1
21,280,280,1,1,0,1,0
34,291,291,68,68,0,1,0
4,300,300,51,51,0,1,0
2,319,319,6,1,5,2,1
9,359,359,84,10,74,3,2
26,360,360,39,16,23,2,1
27,367,367,49,49,0,1,0
17,383,383,41,4,37,2,1
32,395,395,9,9,0,1,0
11,397,397,46,46,0,1,0
33,411,411,102,45,57,3,2
36,418,418,3,3,0,1,0
29,438,438,20,20,0,1,0
18,455,455,62,48,14,2,1
15,456,456,59,59,0,1,0
23,460,460,108,88,20,2,1
13,476,476,8,2,6,2,1
12,479,479,42,12,30,2,1
5,496,496,34,34,0,1,0

6,103,103,1,1,0,1,0
10,126,126,3,3,0,1,0
9,136,136,3,3,0,1,0
27,152,152,12,12,0,1,0
35,162,162,7,2,5,2,1
36,172,172,54,31,23,2,1
5,176,176,5,5,0,1,0
49,178,178,12,12,0,1,0
34,186,186,7,7,0,1,0
14,190,190,18,14,4,2,1
47,195,195,4,1,3,2,1
29,246,246,5,2,3,2,1
24,251,251,13,13,0,1,0
33,252,252,11,1,10,2,1
7,256,256,3,3,0,1,0
26,257,257,1,1,0,1,0
8,272,272,23,10,13,2,1
2,279,279,3,3,0,1,0
32,285,285,19,9,10,2,1
12,292,292,92,46,46,3,2
44,293,293,39,24,15,4,3
0,303,303,6,1,5,2,1
21,306,306,4,4,0,1,0
38,309,309,73,55,18,4,3
46,323,323,19,1,18,2,1
45,333,333,2,2,0,1,0
30,345,345,60,13,47,4,3
25,347,347,5,5,0,1,0
40,371,371,6,6,0,1,0
3,383,383,1,1,0,1,0
20,383,383,29,29,0,1,0
16,391,391,1,1,0,1,0
11,395,395,1,1,0,1,0
42,403,403,8,8,0,1,0
23,405,405,82,82,0,1,0
48,409,409,152,54,98,4,3
41,409,409,85,60,25,2,1
4,414,414,2,2,0,1,0
1,423,423,13,1,12,2,1
22,434,434,19,19,0,1,0
13,443,443,38,38,0,1,0
15,449,449,5,5,0,1,0
31,455,455,16,8,8,2,1
18,466,466,22,4,18,2,1
17,488,488,5,5,0,1,0
19,489,489,68,8,60,3,2
39,493,493,32,32,0,1,0
28,495,495,64,25,39,4,3
37,496,496,54,54,0,1,0
43,497,497,6,6,0,1,0

12,112,112,13,4,9,2,1
14,112,112,1,1,0,1,0
29,112,112,1,1,0,1,0
45,125,125,3,3,0,1,0
34,127,127,4,4,0,1,0
6,130,130,7,1,6,3,2
41,131,131,41,20,21,4,3
22,132,132,1,1,0,1,0
23,140,140,6,6,0,1,0
46,141,141,8,8,0,1,0
36,151,151,9,9,0,1,0
43,161,161,30,30,0,1,0
24,162,162,3,3,0,1,0
32,167,167,25,25,0,1,0
31,189,189,47,33,14,3,2
30,191,191,45,22,23,2,1
0,194,194,2,2,0,1,0
1,205,205,11,8,3,2,1
3,225,225,27,21,6,2,1
38,228,228,17,17,0,1,0
19,238,238,24,24,0,1,0
7,238,238,9,9,0,1,0
47,261,261,12,5,7,2,1
40,263,263,32,19,13,2,1
21,266,266,1,1,0,1,0
15,268,268,27,7,20,2,1
44,296,296,18,1,17,2,1
4,326,326,17,17,0,1,0
42,331,331,8,5,3,2,1
5,343,343,39,6,33,2,1
35,346,346,21,5,16,3,2
16,350,350,26,26,0,1,0
8,357,357,34,34,0,1,0
39,358,358,7,1,6,3,2
28,361,361,5,5,0,1,0
37,366,366,33,23,10,2,1
26,381,381,7,4,3,2,1
9,387,387,8,2,6,3,2
11,400,400,59,59,0,1,0
27,402,402,54,54,0,1,0
18,425,425,33,33,0,1,0
33,429,429,12,2,10,2,1
2,430,430,19,19,0,1,0
13,437,437,39,31,8,3,2
25,442,442,86,5,81,4,3
10,450,450,16,8,8,2,1
20,451,451,1,1,0,1,0
17,466,466,4,4,0,1,0

29,109,109,16,16,0,1,0
15,125,125,28,6,22,2,1
1,140,140,19,5,14,2,1
21,148,148,5,5,0,1,0
20,184,184,11,11,0,1,0
5,206,206,6,6,0,1,0
4,216,216,42,42,0,1,0
34,221,221,51,33,18,4,3
32,222,222,6,6,0,1,0
7,230,230,9,9,0,1,0
13,230,230,27,27,0,1,0
25,242,242,16,16,0,1,0
8,245,245,36,12,24,4,3
23,254,254,11,11,0,1,0
19,255,255,50,31,19,2,1
28,263,263,34,6,28,3,2
11,264,264,21,13,8,3,2
17,267,267,8,1,7,2,1
30,273,273,13,13,0,1,0
22,285,285,39,39,0,1,0
16,319,319,73,21,52,3,2
3,320,320,8,8,0,1,0
14,326,326,12,3,9,2,1
35,332,332,66,24,42,4,3
6,337,337,40,40,0,1,0
31,348,348,75,7,68,3,2
27,364,364,1,1,0,1,0
12,366,366,4,4,0,1,0
24,371,371,5,1,4,2,1
10,391,391,33,6,27,4,3
33,408,408,13,9,4,2,1
9,410,410,19,1,18,4,3
36,429,429,99,39,60,4,3
18,436,436,13,13,0,1,0
26,468,468,14,4,10,3,2
0,472,472,38,18,20,3,2
2,491,491,71,61,10,2,1

17,111,111,6,1,5,2,1
9,124,124,2,2,0,1,0
22,124,124,1,1,0,1,0
30,138,138,30,30,0,1,0
10,140,140,10,1,9,2,1
25,169,169,1,1,0,1,0
0,170,170,32,32,0,1,0
32,173,173,7,7,0,1,0
35,184,184,16,9,7,2,1
36,199,199,7,1,6,2,1
28,208,208,84,26,58,4,3
12,212,212,43,43,0,1,0
29,221,221,37,14,23,4,3
33,238,238,39,39,0,1,0
3,253,253,37,27,10,3,2
8,261,261,44,2,42,4,3
11,270,270,8,8,0,1,0
31,301,301,6,6,0,1,0
13,321,321,101,101,0,1,0
34,325,325,30,9,21,2,1
19,332,332,54,8,46,2,1
1,336,336,22,22,0,1,0
16,337,337,18,18,0,1,0
38,340,340,19,2,17,3,2
20,350,350,32,23,9,4,3
6,362,362,4,4,0,1,0
23,363,363,24,13,11,2,1
37,365,365,20,20,0,1,0
4,371,371,6,6,0,1,0
18,380,380,29,8,21,4,3
15,416,416,22,10,12,2,1
14,423,423,8,2,6,3,2
26,424,424,75,75,0,1,0
7,443,443,20,20,0,1,0
24,455,455,54,54,0,1,0
5,462,462,7,1,6,3,2
27,464,464,10,10,0,1,0
21,470,470,48,48,0,1,0
2,474,474,1,1,0,1,0

20,116,116,3,3,0,1,0
34,142,142,5,5,0,1,0
6,144,144,1,1,0,1,0
21,145,145,14,14,0,1,0
0,149,149,1,1,0,1,0
22,152,152,81,81,0,1,0
8,175,175,12,6,6,2,1
9,181,181,6,3,3,2,1
18,233,233,1,1,0,1,0
28,248,248,7,7,0,1,0
32,251,251,11,11,0,1,0
31,275,275,7,7,0,1,0
29,293,293,7,7,0,1,0
1,296,296,113,38,75,3,2
35,303,303,14,8,6,2,1
26,311,311,9,9,0,1,0
27,317,317,27,27,0,1,0
13,329,329,34,20,14,3,2
3,331,331,18,14,4,2,1
12,336,336,20,2,18,3,2
15,341,341,25,25,0,1,0
36,343,343,23,17,6,3,2
25,351,351,49,24,25,3,2
37,354,354,23,11,12,3,2
19,373,373,47,44,3,2,1
11,388,388,34,34,0,1,0
5,396,396,4,4,0,1,0
7,412,412,6,2,4,2,1
17,439,439,169,169,0,1,0
10,457,457,92,43,49,2,1
16,458,458,6,2,4,2,1
30,465,465,121,11,110,4,3
33,465,465,17,10,7,2,1
4,471,471,15,2,13,2,1
24,477,477,9,9,0,1,0
2,478,478,41,41,0,1,0
14,478,478,26,20,6,2,1
23,484,484,134,130,4,2,1

18,109,109,1,1,0,1,0
22,113,113,22,22,0,1,0
35,128,128,7,7,0,1,0
36,132,132,5,5,0,1,0
12,164,164,24,24,0,1,0
31,173,173,17,17,0,1,0
32,175,175,4,4,0,1,0
10,191,191,13,13,0,1,0
5,196,196,18,7,11,2,1
14,196,196,7,7,0,1,0
33,223,223,36,36,0,1,0
26,245,245,6,2,4,2,1
13,259,259,1,1,0,1,0
20,268,268,12,3,9,2,1
21,273,273,27,27,0,1,0
2,291,291,70,70,0,1,0
25,292,292,18,18,0,1,0
0,299,299,19,19,0,1,0
17,317,317,113,107,6,3,2
23,317,317,157,79,78,4,3
28,323,323,33,6,27,4,3
8,325,325,8,8,0,1,0
30,339,339,87,13,74,4,3
11,339,339,54,54,0,1,0
29,352,352,1,1,0,1,0
24,362,362,37,37,0,1,0
3,395,395,23,11,12,2,1
19,396,396,50,50,0,1,0
4,397,397,3,3,0,1,0
27,401,401,5,1,4,2,1
34,403,403,12,12,0,1,0
6,405,405,59,2,57,4,3
37,414,414,14,4,10,2,1
16,447,447,9,5,4,2,1
1,455,455,17,17,0,1,0
9,456,456,42,16,26,3,2
7,469,469,22,2,20,4,3
15,474,474,32,32,0,1,0

9,127,127,1,1,0,1,0
12,160,160,29,29,0,1,0
16,161,161,7,1,6,3,2
19,176,176,26,12,14,3,2
28,176,176,2,2,0,1,0
36,184,184,20,8,12,3,2
4,199,199,7,7,0,1,0
11,224,224,7,1,6,3,2
5,231,231,11,2,9,2,1
17,243,243,1,1,0,1,0
22,243,243,31,31,0,1,0
2,246,246,11,1,10,3,2
32,256,256,33,7,26,3,2
23,262,262,28,4,24,3,2
6,273,273,30,30,0,1,0
3,291,291,11,11,0,1,0
30,291,291,50,8,42,3,2
13,311,311,57,57,0,1,0
10,313,313,56,56,0,1,0
8,321,321,2,2,0,1,0
0,326,326,43,43,0,1,0
20,342,342,50,4,46,4,3
14,346,346,15,5,10,3,2
21,349,349,36,36,0,1,0
18,360,360,117,114,3,2,1
15,366,366,2,2,0,1,0
31,366,366,19,19,0,1,0
34,371,371,2,2,0,1,0
33,390,390,68,44,24,3,2
24,419,419,43,25,18,4,3
1,421,421,57,57,0,1,0
7,423,423,44,12,32,3,2
29,439,439,54,54,0,1,0
27,444,444,2,2,0,1,0
37,450,450,50,50,0,1,0
25,486,486,81,59,22,2,1
35,494,494,56,17,39,4,3
26,498,498,34,34,0,1,0

32,119,119,4,4,0,1,0
28,124,124,17,7,10,3,2
10,131,131,6,6,0,1,0
29,133,133,28,23,5,2,1
17,147,147,1,1,0,1,0
18,153,153,15,15,0,1,0
11,163,163,51,14,37,2,1
1,164,164,1,1,0,1,0
5,169,169,12,3,9,4,3
16,170,170,22,4,18,3,2
30,197,197,105,43,62,3,2
4,215,215,20,20,0,1,0
34,216,216,44,44,0,1,0
6,223,223,2,2,0,1,0
20,230,230,3,3,0,1,0
12,239,239,34,3,31,2,1
24,241,241,7,7,0,1,0
26,253,253,22,22,0,1,0
25,260,260,6,6,0,1,0
21,268,268,15,15,0,1,0
2,280,280,11,2,9,2,1
9,305,305,41,41,0,1,0
19,326,326,13,13,0,1,0
23,331,331,4,1,3,2,1
22,333,333,53,53,0,1,0
0,341,341,28,28,0,1,0
15,354,354,40,16,24,3,2
3,374,374,37,37,0,1,0
7,382,382,36,36,0,1,0
14,385,385,21,1,20,3,2
27,388,388,33,19,14,3,2
33,395,395,40,40,0,1,0
8,403,403,25,10,15,4,3
13,429,429,136,103,33,2,1
31,449,449,10,10,0,1,0

35,109,109,28,9,19,2,1
3,111,111,2,2,0,1,0
26,116,116,1,1,0,1,0
32,117,117,19,10,9,2,1
1,161,161,11,11,0,1,0
9,163,163,4,4,0,1,0
25,184,184,4,4,0,1,0
20,187,187,14,14,0,1,0
33,195,195,5,5,0,1,0
30,266,266,24,10,14,2,1
13,270,270,27,27,0,1,0
34,272,272,13,13,0,1,0
18,304,304,90,78,12,4,3
16,307,307,30,7,23,2,1
31,316,316,51,25,26,2,1
22,319,319,52,52,0,1,0
12,336,336,66,24,42,3,2
0,358,358,15,11,4,2,1
29,368,368,38,38,0,1,0
14,373,373,66,66,0,1,0
2,382,382,3,3,0,1,0
4,391,391,23,12,11,4,3
10,394,394,113,86,27,4,3
11,398,398,7,7,0,1,0
19,400,400,9,9,0,1,0
23,403,403,9,6,3,2,1
5,440,440,1,1,0,1,0
8,446,446,63,7,56,3,2
37,454,454,10,10,0,1,0
28,456,456,108,66,42,3,2
27,471,471,77,47,30,4,3
17,471,471,1,1,0,1,0
6,472,472,29,29,0,1,0
24,478,478,56,16,40,4,3
7,479,479,84,84,0,1,0
21,480,480,3,3,0,1,0
15,483,483,3,3,0,1,0
36,499,499,75,38,37,2,1

32,111,111,2,2,0,1,0
6,125,125,20,20,0,1,0
1,144,144,29,29,0,1,0
7,144,144,22,2,20,2,1
14,153,153,63,45,18,3,2
21,166,166,24,10,14,3,2
24,171,171,20,20,0,1,0
18,182,182,28,10,18,4,3
27,182,182,14,7,7,2,1
4,184,184,7,7,0,1,0
25,196,196,15,7,8,3,2
12,204,204,4,4,0,1,0
31,225,225,1,1,0,1,0
11,238,238,27,6,21,4,3
5,264,264,15,15,0,1,0
16,273,273,83,48,35,3,2
26,282,282,4,4,0,1,0
3,307,307,35,3,32,3,2
19,309,309,58,21,37,2,1
20,314,314,1,1,0,1,0
2,341,341,11,11,0,1,0
15,355,355,9,9,0,1,0
28,357,357,30,30,0,1,0
8,366,366,44,44,0,1,0
13,373,373,30,30,0,1,0
17,379,379,38,38,0,1,0
30,382,382,50,23,27,2,1
23,406,406,56,56,0,1,0
9,417,417,2,2,0,1,0
29,431,431,39,31,8,3,2
22,438,438,78,78,0,1,0
0,450,450,63,21,42,4,3
10,460,460,73,73,0,1,0

34,133,133,11,11,0,1,0
10,159,159,2,2,0,1,0
35,171,171,1,1,0,1,0
33,180,180,4,4,0,1,0
40,181,181,6,6,0,1,0
36,189,189,69,9,60,4,3
0,199,199,8,5,3,2,1
24,206,206,34,7,27,2,1
1,207,207,2,2,0,1,0
7,216,216,20,20,0,1,0
9,220,220,7,7,0,1,0
22,222,222,7,2,5,2,1
15,234,234,9,2,7,2,1
11,239,239,11,11,0,1,0
21,270,270,26,22,4,2,1
6,279,279,7,7,0,1,0
26,294,294,9,9,0,1,0
19,302,302,30,8,22,3,2
28,303,303,16,16,0,1,0
2,328,328,26,26,0,1,0
16,332,332,11,11,0,1,0
14,350,350,20,2,18,4,3
20,362,362,84,84,0,1,0
32,365,365,4,4,0,1,0
5,368,368,81,35,46,2,1
39,369,369,27,21,6,3,2
25,416,416,33,10,23,2,1
29,420,420,136,22,114,4,3
38,439,439,109,11,98,3,2
4,443,443,30,11,19,2,1
27,448,448,28,15,13,2,1
13,449,449,147,96,51,3,2
30,450,450,61,17,44,2,1
8,464,464,33,3,30,3,2
31,469,469,60,60,0,1,0
12,472,472,2,2,0,1,0
37,479,479,3,3,0,1,0
17,483,483,61,47,14,3,2
23,487,487,3,3,0,1,0
18,490,490,18,18,0,1,0
3,498,498,12,4,8,3,2

23,101,101,13,13,0,1,0
30,105,105,18,18,0,1,0
4,113,113,4,4,0,1,0
32,118,118,2,2,0,1,0
35,119,119,29,29,0,1,0
2,156,156,5,5,0,1,0
3,167,167,36,36,0,1,0
12,183,183,5,5,0,1,0
22,187,187,40,1,39,3,2
25,228,228,37,37,0,1,0
37,236,236,7,3,4,2,1
19,237,237,103,103,0,1,0
17,243,243,44,44,0,1,0
10,245,245,1,1,0,1,0
9,256,256,10,10,0,1,0
0,258,258,8,8,0,1,0
15,267,267,4,4,0,1,0
1,268,268,16,2,14,3,2
18,297,297,40,21,19,2,1
27,307,307,40,30,10,2,1
31,308,308,14,14,0,1,0
5,311,311,34,34,0,1,0
28,311,311,12,3,9,2,1
24,320,320,49,11,38,4,3
7,339,339,16,9,7,2,1
29,340,340,45,45,0,1,0
16,359,359,3,3,0,1,0
26,372,372,44,38,6,2,1
8,384,384,9,9,0,1,0
11,392,392,36,27,9,4,3
13,401,401,76,59,17,2,1
36,405,405,34,34,0,1,0
14,417,417,42,6,36,2,1
20,424,424,17,3,14,2,1
34,431,431,11,1,10,3,2
33,433,433,5,1,4,2,1
6,443,443,10,2,8,3,2
21,450,450,46,33,13,2,1

11,107,107,9,4,5,2,1
6,136,136,13,13,0,1,0
20,147,147,1,1,0,1,0
9,147,147,27,27,0,1,0
10,147,147,42,1,41,2,1
16,164,164,23,23,0,1,0
23,175,175,4,4,0,1,0
17,176,176,12,12,0,1,0
5,181,181,28,28,0,1,0
12,212,212,10,10,0,1,0
0,227,227,77,35,42,3,2
22,254,254,38,38,0,1,0
13,279,279,9,9,0,1,0
3,297,297,25,9,16,3,2
4,300,300,126,85,41,2,1
21,314,314,11,2,9,4,3
24,315,315,6,6,0,1,0
7,332,332,72,18,54,4,3
2,342,342,86,50,36,2,1
15,381,381,119,68,51,4,3
1,458,458,7,2,5,2,1
18,471,471,26,26,0,1,0
19,471,471,60,28,32,2,1
25,477,477,5,5,0,1,0
26,484,484,29,4,25,2,1
8,487,487,109,52,57,4,3
14,500,500,96,66,30,4,3

22,114,114,3,3,0,1,0
17,114,114,15,15,0,1,0
7,117,117,1,1,0,1,0
13,117,117,2,2,0,1,0
19,126,126,10,10,0,1,0
27,133,133,57,9,48,3,2
4,136,136,1,1,0,1,0
20,136,136,22,22,0,1,0
2,137,137,6,6,0,1,0
26,140,140,12,6,6,3,2
8,152,152,49,49,0,1,0
1,154,154,14,9,5,2,1
21,156,156,16,13,3,2,1
14,161,161,8,3,5,2,1
12,165,165,41,32,9,4,3
15,176,176,5,5,0,1,0
18,202,202,6,6,0,1,0
30,217,217,54,10,44,3,2
10,233,233,6,3,3,2,1
29,247,247,11,11,0,1,0
33,264,264,4,4,0,1,0
28,279,279,78,30,48,4,3
5,293,293,53,17,36,4,3
35,294,294,15,15,0,1,0
11,296,296,20,20,0,1,0
9,310,310,1,1,0,1,0
24,321,321,14,2,12,2,1
34,351,351,4,4,0,1,0
0,368,368,1,1,0,1,0
16,404,404,6,6,0,1,0
25,433,433,20,12,8,2,1
31,451,451,24,24,0,1,0
6,454,454,201,129,72,4,3
23,480,480,54,54,0,1,0
3,481,481,58,51,7,2,1
32,499,499,15,1,14,2,1

18,102,102,32,32,0,1,0
15,120,120,4,4,0,1,0
4,148,148,2,2,0,1,0
23,180,180,13,13,0,1,0
2,187,187,26,19,7,2,1
20,189,189,21,21,0,1,0
12,197,197,9,9,0,1,0
19,199,199,2,2,0,1,0
22,215,215,34,20,14,3,2
33,223,223,22,22,0,1,0
27,227,227,27,4,23,3,2
34,230,230,2,2,0,1,0
21,236,236,17,17,0,1,0
35,243,243,44,44,0,1,0
7,247,247,21,6,15,2,1
0,253,253,13,3,10,3,2
1,289,289,50,29,21,2,1
36,301,301,13,13,0,1,0
17,312,312,9,9,0,1,0
9,317,317,22,22,0,1,0
5,319,319,2,2,0,1,0
8,338,338,1,1,0,1,0
30,357,357,122,88,34,2,1
26,361,361,12,2,10,3,2
25,365,365,60,60,0,1,0
31,369,369,29,29,0,1,0
28,374,374,7,3,4,2,1
13,380,380,167,52,115,4,3
29,382,382,36,24,12,2,1
16,382,382,2,2,0,1,0
11,387,387,1,1,0,1,0
24,390,390,51,51,0,1,0
6,422,422,33,13,20,2,1
32,430,430,1,1,0,1,0
3,468,468,137,80,57,4,3
14,478,478,1,1,0,1,0
10,491,491,5,5,0,1,0
37,494,494,47,47,0,1,0

13,100,100,12,5,7,2,1
16,108,108,18,13,5,2,1
17,119,119,9,1,8,2,1
18,131,131,7,4,3,2,1
23,176,176,35,13,22,3,2
4,179,179,47,13,34,3,2
12,191,191,14,5,9,4,3
29,195,195,3,3,0,1,0
11,202,202,4,4,0,1,0
21,209,209,48,48,0,1,0
2,227,227,107,67,40,4,3
8,228,228,9,9,0,1,0
26,240,240,17,1,16,3,2
7,243,243,20,20,0,1,0
31,250,250,29,23,6,2,1
30,254,254,5,1,4,2,1
3,255,255,1,1,0,1,0
22,259,259,2,2,0,1,0
19,266,266,73,73,0,1,0
28,266,266,6,6,0,1,0
32,278,278,10,10,0,1,0
0,291,291,14,14,0,1,0
10,317,317,43,43,0,1,0
1,334,334,56,56,0,1,0
25,340,340,2,2,0,1,0
9,352,352,33,5,28,3,2
15,362,362,12,3,9,4,3
14,373,373,43,9,34,3,2
27,373,373,81,65,16,3,2
6,422,422,65,65,0,1,0
5,425,425,6,6,0,1,0
24,428,428,81,81,0,1,0
20,482,482,53,9,44,4,3

0,109,109,10,4,6,3,2
26,118,118,28,3,25,2,1
4,122,122,8,8,0,1,0
2,130,130,22,13,9,4,3
13,146,146,34,16,18,3,2
14,155,155,18,10,8,3,2
17,205,205,7,1,6,2,1
6,210,210,32,8,24,2,1
33,228,228,61,16,45,2,1
20,230,230,8,8,0,1,0
21,233,233,34,34,0,1,0
22,235,235,16,16,0,1,0
3,242,242,7,7,0,1,0
7,247,247,29,14,15,2,1
10,256,256,1,1,0,1,0
8,282,282,9,1,8,2,1
31,310,310,38,17,21,4,3
9,322,322,30,10,20,3,2
29,324,324,15,15,0,1,0
34,334,334,71,27,44,4,3
19,362,362,65,62,3,2,1
36,363,363,17,17,0,1,0
28,364,364,13,5,8,2,1
23,377,377,3,3,0,1,0
25,387,387,7,4,3,2,1
18,398,398,78,44,34,2,1
5,403,403,13,13,0,1,0
27,404,404,23,23,0,1,0
24,404,404,37,19,18,2,1
30,423,423,44,4,40,4,3
1,447,447,134,88,46,3,2
35,459,459,57,57,0,1,0
15,472,472,41,41,0,1,0
16,475,475,7,4,3,2,1
12,481,481,7,7,0,1,0
11,495,495,10,10,0,1,0
32,496,496,12,4,8,2,1

22,101,101,5,5,0,1,0
2,102,102,7,4,3,2,1
3,112,112,3,3,0,1,0
1,113,113,34,9,25,2,1
19,117,117,8,8,0,1,0
5,136,136,8,8,0,1,0
13,137,137,3,3,0,1,0
25,190,190,35,11,24,4,3
21,197,197,10,2,8,2,1
36,200,200,12,12,0,1,0
37,204,204,28,2,26,2,1
0,205,205,11,11,0,1,0
31,225,225,16,2,14,2,1
11,231,231,12,3,9,4,3
34,232,232,11,1,10,2,1
20,243,243,32,29,3,2,1
16,259,259,14,2,12,3,2
24,267,267,30,30,0,1,0
30,267,267,11,11,0,1,0
6,272,272,67,11,56,4,3
17,300,300,77,77,0,1,0
23,343,343,15,15,0,1,0
9,362,362,9,3,6,2,1
35,362,362,1,1,0,1,0
14,363,363,98,77,21,3,2
33,364,364,86,42,44,2,1
32,391,391,19,19,0,1,0
12,393,393,30,30,0,1,0
18,404,404,25,15,10,3,2
26,410,410,4,4,0,1,0
7,410,410,10,10,0,1,0
15,414,414,6,6,0,1,0
27,419,419,143,78,65,4,3
10,432,432,27,27,0,1,0
8,464,464,20,20,0,1,0
29,464,464,45,21,24,2,1
4,473,473,9,9,0,1,0
28,476,476,81,43,38,3,2

11,103,103,6,6,0,1,0
22,131,131,38,38,0,1,0
15,141,141,16,3,13,2,1
16,150,150,1,1,0,1,0
18,152,152,16,16,0,1,0
10,156,156,47,41,6,3,2
33,165,165,39,5,34,2,1
6,196,196,12,5,7,2,1
7,207,207,11,11,0,1,0
14,226,226,26,15,11,4,3
27,247,247,10,10,0,1,0
31,266,266,5,5,0,1,0
1,267,267,42,42,0,1,0
12,291,291,29,9,20,2,1
13,306,306,1,1,0,1,0
4,343,343,59,21,38,2,1
32,352,352,45,19,26,4,3
29,362,362,29,29,0,1,0
3,373,373,50,21,29,2,1
24,387,387,82,45,37,2,1
0,401,401,37,17,20,2,1
21,407,407,33,29,4,2,1
20,411,411,43,25,18,3,2
9,413,413,4,4,0,1,0
19,430,430,38,6,32,2,1
25,436,436,105,69,36,2,1
23,442,442,51,51,0,1,0
5,447,447,3,3,0,1,0
26,450,450,6,6,0,1,0
30,470,470,3,3,0,1,0
8,470,470,113,20,93,4,3
28,477,477,17,17,0,1,0
17,484,484,11,11,0,1,0
2,498,498,94,51,43,2,1

8,105,105,7,7,0,1,0
32,114,114,22,12,10,2,1
11,147,147,1,1,0,1,0
6,149,149,17,17,0,1,0
35,157,157,21,2,19,2,1
2,159,159,1,1,0,1,0
22,162,162,12,12,0,1,0
28,163,163,49,24,25,3,2
14,168,168,20,11,9,4,3
24,180,180,3,3,0,1,0
15,184,184,18,1,17,2,1
20,187,187,13,13,0,1,0
17,204,204,48,16,32,3,2
25,233,233,7,3,4,2,1
31,251,251,9,4,5,2,1
10,262,262,50,22,28,2,1
21,262,262,14,14,0,1,0
33,266,266,22,22,0,1,0
12,276,276,22,2,20,4,3
16,279,279,40,40,0,1,0
18,300,300,28,28,0,1,0
9,318,318,5,1,4,2,1
27,328,328,4,4,0,1,0
30,331,331,35,30,5,2,1
0,336,336,13,7,6,3,2
37,369,369,8,1,7,2,1
5,372,372,107,33,74,3,2
23,386,386,2,2,0,1,0
1,391,391,3,3,0,1,0
34,391,391,26,26,0,1,0
3,397,397,82,10,72,4,3
13,403,403,29,12,17,2,1
7,416,416,1,1,0,1,0
36,433,433,35,2,33,4,3
29,440,440,124,106,18,2,1
26,441,441,120,120,0,1,0
19,448,448,2,2,0,1,0
4,459,459,6,6,0,1,0

4,106,106,7,7,0,1,0
11,109,109,1,1,0,1,0
24,134,134,1,1,0,1,0
0,138,138,2,2,0,1,0
7,158,158,1,1,0,1,0
31,169,169,7,1,6,3,2
38,172,172,3,3,0,1,0
14,188,188,28,28,0,1,0
13,191,191,35,25,10,3,2
26,212,212,4,1,3,2,1
23,219,219,21,9,12,2,1
27,223,223,21,11,10,2,1
2,235,235,33,4,29,2,1
33,245,245,20,15,5,2,1
3,263,263,91,67,24,4,3
1,266,266,11,11,0,1,0
30,270,270,3,3,0,1,0
32,281,281,59,59,0,1,0
29,284,284,104,92,12,2,1
19,295,295,16,10,6,2,1
17,316,316,1,1,0,1,0
5,322,322,6,6,0,1,0
10,344,344,50,41,9,2,1
12,347,347,1,1,0,1,0
35,375,375,68,68,0,1,0
9,376,376,23,23,0,1,0
8,381,381,16,16,0,1,0
15,407,407,40,20,20,3,2
6,408,408,31,31,0,1,0
28,424,424,15,15,0,1,0
37,430,430,171,76,95,4,3
25,434,434,37,6,31,3,2
22,450,450,40,13,27,3,2
20,464,464,100,100,0,1,0
36,474,474,27,27,0,1,0
21,487,487,6,6,0,1,0
18,487,487,26,26,0,1,0
34,489,489,19,19,0,1,0
16,490,490,37,37,0,1,0

21,103,103,6,2,4,2,1
25,115,115,1,1,0,1,0
17,121,121,20,20,0,1,0
14,125,125,1,1,0,1,0
6,128,128,10,10,0,1,0
9,132,132,4,4,0,1,0
7,135,135,1,1,0,1,0
23,138,138,1,1,0,1,0
35,139,139,13,13,0,1,0
8,140,140,12,12,0,1,0
32,143,143,11,11,0,1,0
38,146,146,8,2,6,3,2
26,152,152,14,14,0,1,0
15,157,157,13,13,0,1,0
28,159,159,28,14,14,2,1
40,175,175,1,1,0,1,0
27,183,183,12,12,0,1,0
3,190,190,23,10,13,2,1
12,191,191,43,43,0,1,0
2,201,201,37,37,0,1,0
1,207,207,13,13,0,1,0
18,272,272,10,1,9,4,3
29,278,278,17,2,15,2,1
11,295,295,16,16,0,1,0
5,321,321,19,11,8,3,2
13,328,328,41,14,27,4,3
34,351,351,67,35,32,3,2
36,372,372,119,119,0,1,0
16,399,399,3,3,0,1,0
10,402,402,26,1,25,2,1
20,406,406,13,7,6,2,1
37,417,417,17,17,0,1,0
24,420,420,39,19,20,2,1
19,423,423,33,12,21,2,1
30,442,442,19,19,0,1,0
4,445,445,47,11,36,3,2
31,472,472,30,18,12,4,3
39,475,475,21,21,0,1,0
22,481,481,19,7,12,3,2
33,485,485,193,178,15,4,3
0,490,490,44,22,22,2,1

0,132,132,9,9,0,1,0
33,140,140,8,8,0,1,0
12,147,147,12,5,7,2,1
7,151,151,1,1,0,1,0
8,151,151,12,12,0,1,0
41,152,152,3,3,0,1,0
31,153,153,11,11,0,1,0
11,168,168,1,1,0,1,0
14,181,181,10,10,0,1,0
29,210,210,14,14,0,1,0
13,212,212,8,8,0,1,0
35,221,221,73,27,46,3,2
37,231,231,6,6,0,1,0
32,236,236,24,12,12,4,3
5,236,236,31,31,0,1,0
24,237,237,2,2,0,1,0
3,240,240,34,10,24,4,3
22,248,248,38,25,13,2,1
4,258,258,49,49,0,1,0
39,270,270,29,3,26,2,1
34,285,285,11,11,0,1,0
26,288,288,6,6,0,1,0
9,290,290,15,1,14,3,2
27,294,294,66,34,32,2,1
16,323,323,20,2,18,3,2
23,329,329,28,14,14,3,2
15,344,344,18,10,8,3,2
2,344,344,30,26,4,2,1
42,345,345,71,10,61,4,3
38,348,348,27,27,0,1,0
25,349,349,11,11,0,1,0
18,367,367,21,21,0,1,0
40,394,394,78,29,49,4,3
36,400,400,17,6,11,2,1
30,413,413,46,21,25,2,1
21,413,413,32,4,28,3,2
6,415,415,1,1,0,1,0
19,424,424,81,81,0,1,0
10,441,441,2,2,0,1,0
20,442,442,52,52,0,1,0
28,465,465,44,44,0,1,0
1,468,468,20,20,0,1,0
17,475,475,5,5,0,1,0

13,102,102,3,3,0,1,0
18,110,110,3,3,0,1,0
7,135,135,41,41,0,1,0
0,138,138,3,3,0,1,0
36,144,144,4,4,0,1,0
24,144,144,4,4,0,1,0
30,151,151,9,9,0,1,0
15,155,155,13,13,0,1,0
25,161,161,5,1,4,2,1
9,161,161,39,39,0,1,0
28,171,171,7,7,0,1,0
22,183,183,29,13,16,3,2
1,211,211,22,22,0,1,0
27,216,216,10,10,0,1,0
32,232,232,46,46,0,1,0
31,233,233,7,7,0,1,0
5,237,237,1,1,0,1,0
35,243,243,49,49,0,1,0
6,299,299,8,8,0,1,0
14,301,301,136,136,0,1,0
19,307,307,2,2,0,1,0
2,331,331,8,8,0,1,0
8,332,332,18,8,10,2,1
23,347,347,3,3,0,1,0
29,372,372,16,16,0,1,0
11,400,400,25,16,9,2,1
21,401,401,24,8,16,2,1
26,411,411,101,66,35,2,1
17,411,411,38,2,36,4,3
20,438,438,34,3,31,2,1
3,440,440,10,10,0,1,0
10,446,446,21,6,15,2,1
34,446,446,202,191,11,2,1
12,447,447,71,31,40,3,2
16,470,470,14,1,13,3,2
4,479,479,7,7,0,1,0
33,493,493,59,49,10,2,1

33,106,106,7,3,4,2,1
27,109,109,5,5,0,1,0
8,117,117,18,3,15,4,3
11,118,118,3,3,0,1,0
4,167,167,37,37,0,1,0
26,177,177,7,7,0,1,0
16,182,182,38,38,0,1,0
9,184,184,1,1,0,1,0
17,203,203,12,12,0,1,0
19,221,221,60,60,0,1,0
10,233,233,10,10,0,1,0
1,245,245,5,5,0,1,0
28,245,245,39,30,9,2,1
29,251,251,1,1,0,1,0
5,272,272,13,4,9,2,1
7,273,273,31,20,11,2,1
3,285,285,12,1,11,2,1
13,286,286,4,4,0,1,0
12,310,310,168,79,89,4,3
23,317,317,17,17,0,1,0
31,327,327,73,52,21,2,1
14,331,331,73,73,0,1,0
24,331,331,2,2,0,1,0
30,332,332,19,16,3,2,1
0,359,359,37,37,0,1,0
20,383,383,5,5,0,1,0
18,398,398,15,10,5,2,1
32,432,432,17,9,8,3,2
25,436,436,172,121,51,4,3
22,442,442,36,36,0,1,0
15,456,456,85,77,8,3,2
6,477,477,8,8,0,1,0
21,497,497,34,34,0,1,0
2,499,499,23,6,17,2,1

5,104,104,17,7,10,2,1
13,109,109,12,12,0,1,0
3,123,123,3,3,0,1,0
28,148,148,4,4,0,1,0
6,176,176,2,2,0,1,0
4,189,189,1,1,0,1,0
36,194,194,35,35,0,1,0
9,195,195,17,5,12,2,1
41,196,196,22,7,15,4,3
23,197,197,18,8,10,2,1
14,199,199,19,19,0,1,0
25,211,211,101,101,0,1,0
26,214,214,20,13,7,2,1
12,221,221,3,3,0,1,0
11,242,242,36,17,19,2,1
16,245,245,21,11,10,2,1
33,246,246,19,19,0,1,0
24,247,247,6,6,0,1,0
15,250,250,7,7,0,1,0
32,271,271,4,4,0,1,0
19,284,284,1,1,0,1,0
29,290,290,3,3,0,1,0
21,292,292,10,10,0,1,0
22,293,293,22,10,12,4,3
42,311,311,2,2,0,1,0
7,317,317,77,39,38,2,1
27,321,321,1,1,0,1,0
30,331,331,34,6,28,2,1
34,345,345,68,11,57,3,2
31,375,375,24,20,4,2,1
18,397,397,66,66,0,1,0
37,413,413,5,5,0,1,0
20,422,422,6,6,0,1,0
40,430,430,46,14,32,2,1
39,431,431,24,11,13,3,2
35,447,447,103,9,94,3,2
0,457,457,1,1,0,1,0
17,466,466,36,6,30,2,1
10,469,469,101,15,86,3,2
1,491,491,3,3,0,1,0
8,492,492,1,1,0,1,0
2,496,496,37,37,0,1,0
38,497,497,32,13,19,2,1

35,141,141,19,15,4,2,1
21,157,157,21,21,0,1,0
23,158,158,4,1,3,2,1
25,173,173,32,32,0,1,0
17,174,174,23,23,0,1,0
9,178,178,16,7,9,2,1
33,181,181,8,8,0,1,0
20,183,183,21,6,15,2,1
3,195,195,11,11,0,1,0
36,202,202,3,3,0,1,0
30,221,221,13,9,4,2,1
29,222,222,1,1,0,1,0
31,230,230,13,2,11,2,1
37,237,237,79,7,72,3,2
18,238,238,13,13,0,1,0
27,241,241,18,4,14,3,2
6,258,258,7,4,3,2,1
24,272,272,23,1,22,3,2
10,295,295,17,17,0,1,0
8,304,304,6,6,0,1,0
26,309,309,50,7,43,2,1
2,332,332,8,8,0,1,0
28,338,338,2,2,0,1,0
4,359,359,16,16,0,1,0
22,369,369,1,1,0,1,0
12,370,370,96,96,0,1,0
19,371,371,6,1,5,2,1
0,402,402,27,9,18,4,3
7,414,414,11,5,6,3,2
13,424,424,10,5,5,2,1
15,430,430,20,11,9,4,3
5,431,431,150,65,85,4,3
34,442,442,151,94,57,4,3
14,445,445,93,49,44,3,2
1,465,465,31,22,9,4,3
11,472,472,66,19,47,4,3
32,486,486,34,34,0,1,0
16,495,495,45,45,0,1,0

22,103,103,2,2,0,1,0
7,107,107,9,5,4,2,1
16,109,109,11,11,0,1,0
34,114,114,4,1,3,2,1
18,118,118,3,3,0,1,0
26,119,119,8,8,0,1,0
33,134,134,49,9,40,2,1
5,138,138,1,1,0,1,0
20,156,156,96,96,0,1,0
0,157,157,1,1,0,1,0
29,193,193,1,1,0,1,0
14,206,206,25,25,0,1,0
11,208,208,1,1,0,1,0
27,217,217,12,12,0,1,0
12,218,218,42,42,0,1,0
25,223,223,15,15,0,1,0
30,269,269,47,6,41,2,1
10,292,292,10,10,0,1,0
15,300,300,53,53,0,1,0
3,307,307,47,47,0,1,0
8,307,307,18,12,6,2,1
35,311,311,9,9,0,1,0
19,327,327,13,13,0,1,0
21,338,338,21,21,0,1,0
32,371,371,7,7,0,1,0
1,371,371,73,61,12,3,2
9,387,387,6,6,0,1,0
2,397,397,10,10,0,1,0
24,418,418,32,3,29,2,1
17,420,420,2,2,0,1,0
31,421,421,69,55,14,2,1
4,423,423,1,1,0,1,0
6,443,443,201,186,15,4,3
28,443,443,2,2,0,1,0
36,455,455,6,6,0,1,0
23,474,474,13,13,0,1,0
13,475,475,65,26,39,2,1

24,108,108,8,8,0,1,0
30,142,142,4,4,0,1,0
28,147,147,35,12,23,2,1
35,148,148,14,1,13,2,1
2,152,152,11,1,10,3,2
3,156,156,6,2,4,2,1
20,169,169,34,3,31,4,3
25,172,172,2,2,0,1,0
34,180,180,2,2,0,1,0
33,181,181,17,3,14,3,2
37,183,183,6,6,0,1,0
16,186,186,15,5,10,3,2
8,203,203,10,4,6,3,2
7,231,231,16,16,0,1,0
10,232,232,6,6,0,1,0
1,247,247,18,18,0,1,0
19,261,261,35,35,0,1,0
15,271,271,1,1,0,1,0
23,303,303,10,5,5,2,1
5,308,308,78,37,41,4,3
38,311,311,2,2,0,1,0
22,313,313,28,13,15,2,1
32,329,329,55,31,24,2,1
13,331,331,1,1,0,1,0
26,332,332,47,26,21,2,1
14,348,348,72,35,37,4,3
12,348,348,7,7,0,1,0
36,355,355,46,46,0,1,0
29,373,373,17,17,0,1,0
18,391,391,32,32,0,1,0
6,407,407,89,32,57,4,3
17,411,411,40,20,20,2,1
0,422,422,51,23,28,2,1
9,431,431,18,18,0,1,0
4,438,438,1,1,0,1,0
11,441,441,3,3,0,1,0
27,455,455,192,140,52,4,3
21,463,463,72,72,0,1,0
31,477,477,40,16,24,3,2

10,106,106,8,8,0,1,0
26,124,124,1,1,0,1,0
37,138,138,1,1,0,1,0
4,139,139,14,4,10,2,1
17,162,162,2,2,0,1,0
6,163,163,29,4,25,2,1
25,166,166,15,15,0,1,0
38,168,168,5,5,0,1,0
12,187,187,13,7,6,3,2
24,189,189,11,4,7,2,1
29,190,190,31,3,28,3,2
0,190,190,8,4,4,2,1
18,197,197,9,9,0,1,0
22,197,197,3,3,0,1,0
35,226,226,19,19,0,1,0
16,238,238,3,3,0,1,0
34,252,252,8,4,4,2,1
3,279,279,1,1,0,1,0
21,299,299,20,20,0,1,0
36,318,318,29,13,16,2,1
1,327,327,10,7,3,2,1
32,344,344,125,31,94,3,2
13,361,361,21,21,0,1,0
15,370,370,83,54,29,2,1
8,384,384,14,4,10,3,2
28,395,395,34,34,0,1,0
27,396,396,34,6,28,2,1
14,405,405,58,51,7,2,1
30,410,410,40,23,17,4,3
2,417,417,30,15,15,2,1
11,433,433,126,126,0,1,0
31,442,442,149,99,50,4,3
9,451,451,31,31,0,1,0
20,453,453,83,83,0,1,0
5,454,454,23,14,9,4,3
33,459,459,59,59,0,1,0
19,461,461,20,2,18,3,2
7,494,494,29,29,0,1,0
23,498,498,40,40,0,1,0

24,101,101,43,43,0,1,0
38,103,103,16,1,15,4,3
17,117,117,4,4,0,1,0
3,121,121,1,1,0,1,0
21,138,138,12,12,0,1,0
25,141,141,15,3,12,2,1
43,149,149,13,13,0,1,0
26,163,163,29,29,0,1,0
30,163,163,4,1,3,2,1
28,191,191,4,1,3,2,1
44,198,198,10,2,8,3,2
16,199,199,5,5,0,1,0
10,201,201,1,1,0,1,0
36,201,201,3,3,0,1,0
15,204,204,8,4,4,2,1
40,211,211,45,18,27,4,3
7,211,211,1,1,0,1,0
0,242,242,15,15,0,1,0
11,247,247,18,18,0,1,0
12,261,261,11,7,4,2,1
18,272,272,18,10,8,3,2
2,272,272,16,3,13,2,1
8,286,286,9,3,6,3,2
34,301,301,13,3,10,2,1
39,306,306,22,22,0,1,0
33,316,316,31,3,28,2,1
9,317,317,1,1,0,1,0
42,320,320,66,66,0,1,0
41,326,326,37,37,0,1,0
20,333,333,9,9,0,1,0
1,342,342,29,17,12,2,1
32,351,351,127,82,45,4,3
6,354,354,3,3,0,1,0
19,377,377,21,21,0,1,0
22,402,402,2,2,0,1,0
14,405,405,43,43,0,1,0
4,420,420,47,22,25,2,1
37,422,422,19,5,14,2,1
5,431,431,33,16,17,2,1
13,438,438,32,14,18,2,1
29,471,471,44,14,30,3,2
23,472,472,2,2,0,1,0
35,477,477,88,88,0,1,0
31,480,480,2,2,0,1,0
27,486,486,21,6,15,4,3

33,113,113,5,5,0,1,0
14,113,113,4,4,0,1,0
15,115,115,3,3,0,1,0
34,119,119,3,3,0,1,0
35,130,130,8,8,0,1,0
1,135,135,13,4,9,2,1
26,141,141,2,2,0,1,0
4,154,154,7,4,3,2,1
37,164,164,43,43,0,1,0
5,174,174,3,3,0,1,0
21,202,202,41,41,0,1,0
28,204,204,25,7,18,2,1
30,212,212,1,1,0,1,0
0,244,244,26,26,0,1,0
29,246,246,9,9,0,1,0
2,247,247,48,48,0,1,0
18,252,252,12,2,10,3,2
19,259,259,43,43,0,1,0
23,269,269,29,19,10,2,1
27,277,277,36,30,6,3,2
16,284,284,76,76,0,1,0
32,295,295,3,3,0,1,0
12,316,316,25,25,0,1,0
10,324,324,39,39,0,1,0
11,337,337,24,12,12,4,3
7,339,339,21,21,0,1,0
17,344,344,1,1,0,1,0
8,360,360,10,10,0,1,0
22,372,372,13,13,0,1,0
36,374,374,81,81,0,1,0
9,396,396,19,13,6,2,1
13,411,411,4,4,0,1,0
24,419,419,90,46,44,3,2
25,447,447,13,13,0,1,0
6,467,467,76,71,5,2,1
31,478,478,121,39,82,3,2
20,481,481,38,28,10,2,1
3,484,484,104,4,100,3,2

22,100,100,5,5,0,1,0
12,118,118,2,2,0,1,0
33,129,129,2,2,0,1,0
15,139,139,12,4,8,2,1
34,141,141,4,4,0,1,0
10,145,145,5,5,0,1,0
23,155,155,6,1,5,2,1
17,192,192,40,22,18,2,1
16,205,205,59,59,0,1,0
0,211,211,7,1,6,2,1
20,226,226,44,44,0,1,0
1,232,232,3,3,0,1,0
26,249,249,31,13,18,3,2
35,255,255,15,3,12,2,1
21,257,257,13,13,0,1,0
11,258,258,1,1,0,1,0
31,267,267,5,5,0,1,0
3,269,269,12,4,8,3,2
28,285,285,28,24,4,2,1
30,293,293,40,12,28,2,1
19,298,298,21,3,18,3,2
4,310,310,55,55,0,1,0
29,325,325,98,16,82,4,3
36,333,333,77,77,0,1,0
27,333,333,34,34,0,1,0
2,336,336,23,23,0,1,0
25,356,356,2,2,0,1,0
8,357,357,13,5,8,3,2
5,371,371,30,9,21,4,3
24,373,373,37,37,0,1,0
14,408,408,33,14,19,2,1
13,411,411,5,5,0,1,0
9,452,452,19,11,8,3,2
18,453,453,76,21,55,4,3
32,475,475,105,45,60,4,3
6,480,480,63,63,0,1,0
7,490,490,135,40,95,4,3

30,109,109,9,1,8,2,1
5,117,117,7,7,0,1,0
11,122,122,22,11,11,2,1
6,133,133,4,4,0,1,0
3,136,136,1,1,0,1,0
24,156,156,12,4,8,2,1
32,164,164,18,8,10,3,2
21,169,169,11,6,5,2,1
10,203,203,6,2,4,2,1
0,209,209,49,35,14,3,2
31,228,228,26,10,16,3,2
13,233,233,4,1,3,2,1
17,234,234,7,7,0,1,0
8,248,248,5,2,3,2,1
7,250,250,18,8,10,2,1
28,261,261,27,27,0,1,0
18,281,281,49,49,0,1,0
25,282,282,46,46,0,1,0
29,310,310,30,30,0,1,0
4,351,351,93,66,27,4,3
14,383,383,30,6,24,4,3
26,402,402,53,53,0,1,0
27,411,411,5,2,3,2,1
12,422,422,64,50,14,3,2
1,428,428,1,1,0,1,0
20,467,467,73,36,37,2,1
22,470,470,62,62,0,1,0
19,482,482,38,38,0,1,0
2,487,487,159,159,0,1,0
9,487,487,159,49,110,4,3
23,492,492,19,12,7,2,1
16,495,495,90,45,45,4,3
15,500,500,45,45,0,1,0

16,102,102,8,5,3,2,1
26,108,108,22,7,15,4,3
35,115,115,6,2,4,2,1
4,117,117,19,19,0,1,0
15,139,139,4,4,0,1,0
6,142,142,21,17,4,2,1
1,144,144,1,1,0,1,0
32,149,149,41,41,0,1,0
24,166,166,5,5,0,1,0
19,192,192,38,38,0,1,0
11,204,204,28,11,17,2,1
20,207,207,2,2,0,1,0
18,219,219,4,4,0,1,0
31,221,221,9,9,0,1,0
14,240,240,39,15,24,3,2
8,261,261,19,19,0,1,0
9,267,267,31,31,0,1,0
29,303,303,58,18,40,4,3
12,330,330,9,9,0,1,0
27,345,345,26,26,0,1,0
21,349,349,32,5,27,3,2
33,353,353,43,10,33,3,2
28,374,374,44,44,0,1,0
5,376,376,28,28,0,1,0
34,386,386,99,99,0,1,0
36,387,387,14,3,11,2,1
10,395,395,23,11,12,3,2
22,405,405,15,8,7,2,1
30,428,428,8,8,0,1,0
2,437,437,1,1,0,1,0
13,439,439,201,148,53,4,3
0,460,460,5,2,3,2,1
17,466,466,1,1,0,1,0
7,477,477,53,53,0,1,0
23,485,485,6,1,5,2,1
3,487,487,61,17,44,4,3
25,500,500,37,20,17,2,1

4,103,103,4,4,0,1,0
0,119,119,5,5,0,1,0
25,141,141,33,4,29,2,1
6,169,169,7,7,0,1,0
29,175,175,9,3,6,2,1
14,187,187,14,14,0,1,0
18,204,204,1,1,0,1,0
31,207,207,6,6,0,1,0
10,210,210,1,1,0,1,0
17,214,214,10,10,0,1,0
28,227,227,33,33,0,1,0
36,228,228,8,2,6,3,2
37,229,229,11,11,0,1,0
20,245,245,64,64,0,1,0
30,264,264,44,30,14,3,2
3,283,283,19,19,0,1,0
21,304,304,9,3,6,2,1
22,304,304,55,49,6,2,1
8,327,327,14,14,0,1,0
13,338,338,37,37,0,1,0
5,354,354,11,7,4,2,1
11,359,359,82,82,0,1,0
34,362,362,33,13,20,3,2
1,399,399,63,63,0,1,0
7,406,406,30,2,28,2,1
24,411,411,61,37,24,2,1
2,414,414,21,5,16,3,2
15,426,426,111,66,45,2,1
12,428,428,73,24,49,4,3
16,432,432,42,23,19,2,1
33,435,435,3,3,0,1,0
23,440,440,4,4,0,1,0
9,440,440,62,45,17,2,1
26,454,454,66,66,0,1,0
32,462,462,42,42,0,1,0
35,462,462,54,16,38,4,3
27,477,477,19,5,14,3,2
19,487,487,57,57,0,1,0

30,102,102,13,8,5,2,1
14,118,118,3,3,0,1,0
23,128,128,15,15,0,1,0
28,139,139,8,2,6,2,1
9,159,159,25,25,0,1,0
17,160,160,1,1,0,1,0
11,167,167,4,4,0,1,0
5,172,172,7,7,0,1,0
29,177,177,20,20,0,1,0
18,178,178,8,5,3,2,1
2,186,186,12,12,0,1,0
3,200,200,11,1,10,3,2
24,234,234,39,39,0,1,0
26,246,246,31,31,0,1,0
15,252,252,22,22,0,1,0
19,265,265,40,26,14,2,1
4,272,272,38,38,0,1,0
25,276,276,1,1,0,1,0
10,291,291,17,3,14,2,1
0,338,338,41,27,14,3,2
31,345,345,36,36,0,1,0
8,356,356,92,46,46,3,2
13,357,357,129,112,17,2,1
12,365,365,59,59,0,1,0
6,396,396,67,58,9,4,3
7,400,400,13,13,0,1,0
27,401,401,85,85,0,1,0
20,416,416,22,13,9,2,1
22,420,420,43,25,18,2,1
16,434,434,145,135,10,3,2
21,471,471,5,5,0,1,0
1,493,493,78,15,63,4,3

2,114,114,28,28,0,1,0
18,158,158,38,38,0,1,0
23,177,177,7,1,6,2,1
26,189,189,3,3,0,1,0
22,192,192,16,4,12,2,1
28,215,215,7,7,0,1,0
8,223,223,45,45,0,1,0
11,237,237,21,15,6,3,2
31,245,245,46,46,0,1,0
0,248,248,41,10,31,2,1
5,254,254,11,1,10,3,2
16,278,278,32,25,7,2,1
32,292,292,8,8,0,1,0
17,293,293,16,16,0,1,0
24,299,299,11,5,6,3,2
10,302,302,3,3,0,1,0
15,317,317,23,23,0,1,0
25,328,328,16,16,0,1,0
30,341,341,8,8,0,1,0
1,343,343,17,17,0,1,0
7,349,349,16,10,6,2,1
27,353,353,31,31,0,1,0
9,353,353,14,3,11,3,2
4,355,355,1,1,0,1,0
14,401,401,219,174,45,4,3
19,414,414,64,64,0,1,0
6,418,418,19,19,0,1,0
3,438,438,3,3,0,1,0
29,462,462,112,54,58,4,3
20,479,479,110,110,0,1,0
21,487,487,68,7,61,4,3
13,492,492,133,133,0,1,0
12,493,493,20,5,15,4,3

15,121,121,17,17,0,1,0
4,124,124,24,24,0,1,0
29,129,129,2,2,0,1,0
7,144,144,32,8,24,4,3
5,145,145,3,3,0,1,0
26,164,164,5,2,3,2,1
31,174,174,3,3,0,1,0
8,193,193,6,6,0,1,0
0,198,198,25,25,0,1,0
3,209,209,14,3,11,2,1
1,210,210,15,9,6,2,1
13,212,212,57,50,7,2,1
2,237,237,11,2,9,3,2
20,265,265,11,11,0,1,0
23,275,275,57,42,15,4,3
9,276,276,1,1,0,1,0
25,291,291,51,51,0,1,0
30,294,294,35,35,0,1,0
17,295,295,8,8,0,1,0
19,313,313,43,10,33,4,3
28,328,328,53,21,32,2,1
36,338,338,125,60,65,4,3
33,357,357,110,110,0,1,0
22,391,391,1,1,0,1,0
34,396,396,37,37,0,1,0
6,399,399,15,15,0,1,0
14,406,406,20,8,12,4,3
35,413,413,2,2,0,1,0
21,414,414,5,5,0,1,0
32,425,425,13,7,6,2,1
24,432,432,25,25,0,1,0
16,436,436,10,10,0,1,0
27,444,444,19,19,0,1,0
10,447,447,49,49,0,1,0
18,489,489,110,73,37,2,1
12,491,491,59,59,0,1,0
11,498,498,9,6,3,2,1

15,102,102,20,10,10,2,1
11,104,104,3,3,0,1,0
41,109,109,4,4,0,1,0
36,126,126,34,2,32,3,2
29,128,128,12,6,6,2,1
10,135,135,4,4,0,1,0
39,144,144,11,1,10,2,1
20,154,154,1,1,0,1,0
18,170,170,10,10,0,1,0
37,179,179,7,7,0,1,0
14,181,181,3,3,0,1,0
30,208,208,5,5,0,1,0
28,209,209,25,4,21,2,1
25,231,231,2,2,0,1,0
26,244,244,16,2,14,2,1
3,250,250,34,34,0,1,0
21,280,280,11,11,0,1,0
23,295,295,89,13,76,4,3
35,308,308,15,15,0,1,0
8,317,317,4,4,0,1,0
9,324,324,56,43,13,2,1
43,341,341,88,46,42,2,1
7,342,342,32,32,0,1,0
34,344,344,65,65,0,1,0
24,346,346,19,11,8,3,2
16,374,374,12,2,10,2,1
1,382,382,14,5,9,4,3
0,393,393,70,32,38,2,1
2,409,409,1,1,0,1,0
32,411,411,12,6,6,2,1
40,413,413,117,9,108,4,3
33,428,428,57,33,24,2,1
13,436,436,4,4,0,1,0
31,439,439,21,6,15,4,3
42,439,439,12,12,0,1,0
4,448,448,34,34,0,1,0
27,451,451,22,2,20,2,1
12,456,456,13,13,0,1,0
38,460,460,21,21,0,1,0
17,463,463,17,17,0,1,0
19,467,467,91,56,35,2,1
6,469,469,4,1,3,2,1
22,489,489,2,2,0,1,0
5,499,499,20,2,18,4,3

1,109,109,12,5,7,2,1
23,134,134,39,39,0,1,0
6,144,144,8,8,0,1,0
10,145,145,10,1,9,4,3
22,172,172,22,22,0,1,0
2,175,175,18,18,0,1,0
0,192,192,26,26,0,1,0
15,195,195,4,4,0,1,0
24,209,209,63,63,0,1,0
28,212,212,2,2,0,1,0
3,228,228,67,67,0,1,0
11,260,260,46,7,39,2,1
35,263,263,17,17,0,1,0
29,272,272,25,11,14,2,1
32,279,279,49,31,18,3,2
34,282,282,2,2,0,1,0
13,284,284,50,38,12,3,2
16,289,289,26,26,0,1,0
5,290,290,22,22,0,1,0
8,297,297,37,37,0,1,0
31,299,299,50,50,0,1,0
17,304,304,1,1,0,1,0
7,320,320,14,14,0,1,0
36,329,329,77,77,0,1,0
18,329,329,39,8,31,2,1
12,332,332,23,2,21,2,1
9,338,338,1,1,0,1,0
26,341,341,22,22,0,1,0
4,343,343,32,14,18,3,2
20,353,353,13,13,0,1,0
19,374,374,9,3,6,2,1
14,384,384,6,6,0,1,0
37,413,413,27,27,0,1,0
21,447,447,1,1,0,1,0
27,463,463,29,29,0,1,0
30,471,471,10,10,0,1,0
33,486,486,7,1,6,2,1
25,495,495,47,47,0,1,0

13,108,108,7,2,5,2,1
26,112,112,4,4,0,1,0
23,113,113,11,11,0,1,0
4,114,114,5,5,0,1,0
16,117,117,7,7,0,1,0
10,117,117,1,1,0,1,0
8,118,118,13,2,11,3,2
33,121,121,11,11,0,1,0
2,132,132,3,3,0,1,0
1,143,143,25,25,0,1,0
17,184,184,11,11,0,1,0
9,197,197,24,1,23,2,1
14,207,207,17,9,8,2,1
5,213,213,9,9,0,1,0
0,217,217,9,4,5,2,1
22,225,225,31,3,28,3,2
36,254,254,19,6,13,2,1
35,259,259,78,48,30,2,1
34,283,283,3,3,0,1,0
31,287,287,9,9,0,1,0
24,291,291,39,11,28,2,1
11,298,298,5,5,0,1,0
30,308,308,35,35,0,1,0
20,310,310,37,37,0,1,0
28,318,318,18,18,0,1,0
21,353,353,106,52,54,4,3
27,354,354,18,11,7,2,1
3,361,361,69,69,0,1,0
12,363,363,23,20,3,2,1
32,376,376,49,49,0,1,0
25,414,414,4,4,0,1,0
7,424,424,12,12,0,1,0
18,451,451,54,10,44,3,2
15,469,469,154,124,30,4,3
19,471,471,62,26,36,2,1
6,472,472,104,59,45,4,3
29,491,491,4,4,0,1,0

28,103,103,13,13,0,1,0
10,113,113,5,5,0,1,0
32,127,127,8,2,6,2,1
19,139,139,12,6,6,2,1
8,141,141,16,16,0,1,0
7,145,145,19,8,11,2,1
20,170,170,14,14,0,1,0
25,204,204,2,2,0,1,0
13,249,249,4,1,3,2,1
37,266,266,33,33,0,1,0
5,269,269,24,3,21,3,2
36,282,282,41,41,0,1,0
16,290,290,18,18,0,1,0
18,298,298,27,14,13,2,1
11,300,300,20,8,12,4,3
3,305,305,65,8,57,4,3
24,310,310,30,19,11,2,1
4,334,334,18,18,0,1,0
22,336,336,59,59,0,1,0
0,337,337,18,18,0,1,0
6,357,357,9,9,0,1,0
9,372,372,69,32,37,4,3
26,397,397,60,53,7,2,1
21,407,407,6,6,0,1,0
33,407,407,22,22,0,1,0
14,416,416,98,98,0,1,0
35,418,418,70,1,69,4,3
30,423,423,67,13,54,3,2
15,432,432,17,13,4,2,1
1,437,437,4,1,3,2,1
29,437,437,5,5,0,1,0
2,438,438,6,6,0,1,0
12,448,448,5,5,0,1,0
27,455,455,97,97,0,1,0
23,459,459,75,15,60,3,2
31,468,468,10,1,9,4,3
17,478,478,126,74,52,4,3
34,492,492,29,29,0,1,0

5,105,105,2,2,0,1,0
13,120,120,9,9,0,1,0
21,124,124,20,5,15,4,3
15,126,126,1,1,0,1,0
23,133,133,1,1,0,1,0
20,134,134,13,13,0,1,0
14,134,134,25,25,0,1,0
8,137,137,15,4,11,3,2
33,140,140,2,2,0,1,0
1,145,145,5,2,3,2,1
7,153,153,1,1,0,1,0
16,184,184,12,6,6,2,1
36,213,213,2,2,0,1,0
31,223,223,38,29,9,4,3
39,230,230,9,5,4,2,1
3,253,253,29,11,18,3,2
10,257,257,9,9,0,1,0
19,257,257,57,3,54,4,3
12,264,264,10,5,5,2,1
27,267,267,3,3,0,1,0
37,286,286,32,11,21,4,3
32,292,292,16,1,15,4,3
42,296,296,1,1,0,1,0
22,308,308,19,16,3,2,1
29,308,308,1,1,0,1,0
17,318,318,1,1,0,1,0
35,323,323,18,5,13,2,1
6,324,324,12,12,0,1,0
18,354,354,22,22,0,1,0
25,366,366,45,7,38,3,2
34,368,368,99,30,69,4,3
2,378,378,15,3,12,3,2
41,380,380,75,36,39,4,3
38,397,397,56,28,28,2,1
28,400,400,30,30,0,1,0
11,405,405,2,2,0,1,0
4,415,415,17,11,6,2,1
24,429,429,97,97,0,1,0
26,461,461,4,4,0,1,0
30,472,472,152,152,0,1,0
0,477,477,28,7,21,2,1
40,489,489,110,48,62,3,2
9,493,493,43,43,0,1,0

19,116,116,6,2,4,2,1
33,119,119,18,18,0,1,0
23,120,120,19,19,0,1,0
12,131,131,28,14,14,3,2
9,132,132,4,4,0,1,0
7,157,157,66,66,0,1,0
10,174,174,5,5,0,1,0
21,225,225,43,43,0,1,0
16,228,228,2,2,0,1,0
28,237,237,17,8,9,2,1
24,238,238,47,44,3,2,1
2,245,245,28,28,0,1,0
4,255,255,21,16,5,2,1
17,261,261,5,2,3,2,1
22,277,277,54,20,34,4,3
13,294,294,29,29,0,1,0
5,301,301,18,1,17,3,2
32,314,314,28,4,24,4,3
11,315,315,22,9,13,2,1
26,322,322,11,5,6,2,1
8,356,356,2,2,0,1,0
18,366,366,12,12,0,1,0
25,368,368,47,41,6,3,2
29,376,376,50,50,0,1,0
1,378,378,96,6,90,3,2
15,401,401,5,1,4,2,1
34,409,409,40,40,0,1,0
0,423,423,2,2,0,1,0
27,434,434,25,4,21,4,3
6,444,444,7,7,0,1,0
14,451,451,69,43,26,3,2
20,473,473,21,21,0,1,0
30,478,478,21,3,18,2,1
3,486,486,111,111,0,1,0
31,498,498,73,73,0,1,0

16,104,104,1,1,0,1,0
30,112,112,2,2,0,1,0
27,148,148,27,27,0,1,0
35,173,173,8,4,4,2,1
2,185,185,20,2,18,3,2
31,201,201,24,24,0,1,0
10,204,204,4,4,0,1,0
25,210,210,10,10,0,1,0
29,212,212,7,7,0,1,0
1,230,230,47,47,0,1,0
15,236,236,29,29,0,1,0
4,238,238,11,3,8,2,1
33,240,240,29,29,0,1,0
21,240,240,57,17,40,3,2
8,241,241,32,32,0,1,0
24,251,251,10,10,0,1,0
9,259,259,104,77,27,4,3
11,264,264,55,22,33,4,3
32,272,272,12,12,0,1,0
23,294,294,42,42,0,1,0
7,297,297,9,9,0,1,0
28,300,300,23,23,0,1,0
3,318,318,14,14,0,1,0
19,322,322,31,5,26,2,1
12,334,334,30,30,0,1,0
22,335,335,13,13,0,1,0
17,342,342,35,35,0,1,0
20,354,354,8,1,7,2,1
26,360,360,48,30,18,2,1
18,372,372,52,42,10,2,1
0,426,426,2,2,0,1,0
5,427,427,31,25,6,3,2
14,428,428,73,73,0,1,0
6,455,455,4,4,0,1,0
34,461,461,134,134,0,1,0
13,466,466,12,3,9,2,1

4,116,116,7,7,0,1,0
33,168,168,9,9,0,1,0
25,184,184,36,6,30,4,3
6,193,193,11,8,3,2,1
17,200,200,12,4,8,2,1
23,203,203,14,8,6,2,1
32,211,211,12,2,10,3,2
22,212,212,3,3,0,1,0
8,216,216,22,16,6,3,2
30,223,223,2,2,0,1,0
26,225,225,2,2,0,1,0
11,244,244,6,6,0,1,0
5,264,264,89,32,57,4,3
10,289,289,46,37,9,4,3
16,290,290,39,24,15,2,1
21,324,324,41,35,6,3,2
28,325,325,80,62,18,3,2
24,325,325,3,3,0,1,0
2,345,345,47,23,24,3,2
3,351,351,1,1,0,1,0
1,354,354,9,9,0,1,0
29,356,356,61,38,23,2,1
31,390,390,53,6,47,2,1
12,394,394,55,55,0,1,0
27,394,394,78,78,0,1,0
19,424,424,145,65,80,4,3
0,433,433,55,55,0,1,0
7,435,435,24,24,0,1,0
13,439,439,156,143,13,2,1
20,442,442,48,24,24,2,1
34,453,453,1,1,0,1,0
18,471,471,12,12,0,1,0
14,479,479,1,1,0,1,0
9,486,486,19,13,6,2,1
15,500,500,23,14,9,2,1

1,100,100,12,12,0,1,0
11,104,104,10,7,3,2,1
26,109,109,19,19,0,1,0
20,130,130,33,33,0,1,0
34,161,161,6,6,0,1,0
2,168,168,6,6,0,1,0
6,171,171,1,1,0,1,0
32,177,177,11,11,0,1,0
4,186,186,1,1,0,1,0
27,186,186,1,1,0,1,0
29,192,192,14,8,6,2,1
9,215,215,1,1,0,1,0
12,218,218,43,14,29,2,1
24,241,241,6,3,3,2,1
28,278,278,16,16,0,1,0
17,287,287,30,1,29,2,1
33,302,302,52,52,0,1,0
5,311,311,60,1,59,4,3
21,315,315,87,87,0,1,0
3,326,326,74,74,0,1,0
18,328,328,57,57,0,1,0
16,330,330,4,4,0,1,0
23,359,359,11,2,9,4,3
0,392,392,12,12,0,1,0
35,404,404,9,9,0,1,0
15,409,409,12,12,0,1,0
10,425,425,110,110,0,1,0
19,438,438,34,7,27,4,3
22,443,443,150,119,31,2,1
30,447,447,19,19,0,1,0
25,454,454,2,2,0,1,0
31,454,454,5,5,0,1,0
13,461,461,55,5,50,3,2
7,465,465,98,59,39,2,1
14,474,474,10,7,3,2,1
8,482,482,63,19,44,3,2

22,118,118,2,2,0,1,0
5,136,136,3,3,0,1,0
38,141,141,6,6,0,1,0
1,142,142,22,1,21,4,3
3,149,149,6,2,4,2,1
2,155,155,6,6,0,1,0
28,157,157,10,10,0,1,0
19,169,169,21,9,12,2,1
36,177,177,23,12,11,2,1
14,188,188,30,27,3,2,1
21,242,242,12,5,7,2,1
8,243,243,59,13,46,3,2
25,248,248,120,120,0,1,0
29,256,256,26,26,0,1,0
11,258,258,11,11,0,1,0
35,284,284,25,5,20,3,2
16,284,284,12,2,10,3,2
0,286,286,8,2,6,2,1
23,294,294,46,12,34,4,3
30,302,302,23,23,0,1,0
13,327,327,1,1,0,1,0
6,333,333,9,9,0,1,0
26,340,340,6,6,0,1,0
4,343,343,17,17,0,1,0
12,349,349,53,53,0,1,0
9,365,365,23,23,0,1,0
17,366,366,1,1,0,1,0
7,368,368,12,5,7,2,1
31,409,409,1,1,0,1,0
32,411,411,44,44,0,1,0
24,420,420,94,52,42,2,1
27,444,444,1,1,0,1,0
20,451,451,14,14,0,1,0
34,458,458,16,2,14,3,2
33,470,470,77,42,35,2,1
37,478,478,34,8,26,3,2
10,485,485,91,49,42,4,3
18,487,487,35,11,24,3,2
15,498,498,142,142,0,1,0

5,122,122,28,28,0,1,0
15,127,127,18,1,17,2,1
16,128,128,28,28,0,1,0
11,130,130,9,9,0,1,0
4,137,137,27,27,0,1,0
0,151,151,1,1,0,1,0
17,169,169,3,3,0,1,0
6,181,181,4,4,0,1,0
22,186,186,11,4,7,3,2
18,188,188,3,3,0,1,0
29,210,210,11,11,0,1,0
19,214,214,38,8,30,2,1
21,237,237,12,4,8,2,1
8,261,261,5,1,4,2,1
24,274,274,20,20,0,1,0
28,282,282,1,1,0,1,0
12,287,287,24,24,0,1,0
27,287,287,24,24,0,1,0
3,287,287,35,35,0,1,0
20,323,323,4,1,3,2,1
31,363,363,72,72,0,1,0
26,366,366,20,11,9,4,3
30,381,381,126,44,82,3,2
10,387,387,23,5,18,3,2
7,389,389,122,47,75,4,3
13,393,393,6,6,0,1,0
14,410,410,1,1,0,1,0
9,425,425,144,81,63,4,3
23,445,445,2,2,0,1,0
1,452,452,36,36,0,1,0
25,464,464,159,33,126,4,3
2,472,472,116,50,66,4,3

25,104,104,11,4,7,2,1
8,106,106,8,8,0,1,0
22,112,112,29,29,0,1,0
14,122,122,21,5,16,3,2
23,128,128,3,3,0,1,0
9,129,129,10,10,0,1,0
28,130,130,9,3,6,2,1
21,152,152,5,5,0,1,0
3,163,163,14,14,0,1,0
10,181,181,3,3,0,1,0
1,184,184,9,9,0,1,0
29,215,215,12,12,0,1,0
0,231,231,17,17,0,1,0
7,255,255,18,18,0,1,0
16,281,281,14,4,10,3,2
18,305,305,14,8,6,3,2
11,310,310,3,3,0,1,0
17,311,311,3,3,0,1,0
6,313,313,14,5,9,2,1
19,335,335,2,2,0,1,0
27,344,344,21,21,0,1,0
26,353,353,12,12,0,1,0
4,360,360,78,34,44,2,1
30,371,371,9,9,0,1,0
20,393,393,142,142,0,1,0
31,435,435,127,94,33,4,3
15,446,446,60,60,0,1,0
24,450,450,2,2,0,1,0
5,454,454,39,27,12,3,2
13,458,458,28,20,8,3,2
32,465,465,43,43,0,1,0
2,493,493,113,51,62,3,2
12,500,500,199,137,62,3,2
33,500,500,149,59,90,3,2

37,134,134,39,39,0,1,0
25,148,148,3,3,0,1,0
3,159,159,1,1,0,1,0
16,176,176,100,71,29,4,3
1,190,190,1,1,0,1,0
22,193,193,4,4,0,1,0
2,200,200,29,14,15,4,3
32,220,220,6,3,3,2,1
11,226,226,12,12,0,1,0
30,232,232,45,45,0,1,0
18,260,260,4,4,0,1,0
26,265,265,42,24,18,2,1
24,266,266,41,41,0,1,0
23,266,266,16,16,0,1,0
35,297,297,34,34,0,1,0
33,299,299,5,2,3,2,1
29,303,303,19,19,0,1,0
31,310,310,16,7,9,2,1
21,312,312,19,1,18,3,2
15,322,322,30,2,28,2,1
8,328,328,1,1,0,1,0
36,335,335,8,8,0,1,0
0,343,343,1,1,0,1,0
14,347,347,29,23,6,2,1
6,350,350,1,1,0,1,0
9,363,363,35,35,0,1,0
34,372,372,103,16,87,4,3
17,375,375,25,25,0,1,0
7,382,382,18,18,0,1,0
10,428,428,3,3,0,1,0
13,440,440,41,38,3,2,1
19,457,457,31,31,0,1,0
12,460,460,84,72,12,4,3
20,461,461,5,5,0,1,0
28,463,463,106,16,90,3,2
27,466,466,27,7,20,3,2
5,477,477,71,22,49,4,3
4,490,490,55,55,0,1,0

20,100,100,18,18,0,1,0
26,134,134,14,8,6,3,2
1,161,161,25,25,0,1,0
14,161,161,21,21,0,1,0
16,173,173,22,22,0,1,0
3,225,225,30,12,18,4,3
21,230,230,29,11,18,3,2
4,233,233,81,5,76,4,3
8,260,260,19,4,15,2,1
23,285,285,2,2,0,1,0
17,288,288,5,5,0,1,0
7,297,297,6,6,0,1,0
22,307,307,17,3,14,3,2
24,356,356,33,1,32,3,2
5,368,368,213,213,0,1,0
15,372,372,33,22,11,2,1
11,389,389,37,37,0,1,0
9,400,400,38,21,17,2,1
10,408,408,76,40,36,4,3
19,419,419,11,11,0,1,0
12,429,429,25,25,0,1,0
2,432,432,47,9,38,3,2
6,432,432,125,65,60,4,3
0,451,451,43,21,22,2,1
13,464,464,17,7,10,3,2
18,475,475,167,81,86,4,3
25,484,484,24,16,8,3,2

19,100,100,11,5,6,3,2
35,109,109,11,6,5,2,1
12,110,110,7,1,6,3,2
10,115,115,6,6,0,1,0
38,127,127,2,2,0,1,0
39,133,133,2,2,0,1,0
40,143,143,20,6,14,3,2
6,145,145,4,4,0,1,0
36,149,149,2,2,0,1,0
24,152,152,9,9,0,1,0
11,179,179,1,1,0,1,0
33,188,188,26,26,0,1,0
18,188,188,43,10,33,4,3
13,192,192,24,24,0,1,0
9,195,195,3,3,0,1,0
5,214,214,9,1,8,3,2
2,219,219,4,4,0,1,0
25,235,235,35,17,18,4,3
0,236,236,58,58,0,1,0
15,251,251,12,12,0,1,0
41,281,281,8,2,6,3,2
31,289,289,87,87,0,1,0
1,294,294,69,3,66,3,2
7,296,296,8,8,0,1,0
22,312,312,11,2,9,4,3
30,318,318,44,9,35,2,1
34,327,327,51,3,48,4,3
17,331,331,22,16,6,3,2
27,335,335,5,5,0,1,0
4,340,340,32,13,19,2,1
16,345,345,11,3,8,3,2
26,350,350,17,3,14,3,2
8,354,354,7,2,5,2,1
3,388,388,9,9,0,1,0
21,393,393,11,3,8,3,2
14,418,418,74,74,0,1,0
28,434,434,155,117,38,2,1
37,449,449,19,3,16,3,2
29,450,450,22,5,17,2,1
32,472,472,38,38,0,1,0
23,475,475,8,3,5,2,1
20,484,484,31,31,0,1,0

20,100,100,8,8,0,1,0
30,101,101,17,17,0,1,0
36,104,104,10,10,0,1,0
28,118,118,3,3,0,1,0
5,135,135,1,1,0,1,0
3,158,158,15,15,0,1,0
6,164,164,6,6,0,1,0
32,170,170,2,2,0,1,0
21,173,173,44,44,0,1,0
9,186,186,2,2,0,1,0
29,197,197,43,43,0,1,0
31,200,200,26,26,0,1,0
10,206,206,1,1,0,1,0
0,223,223,5,5,0,1,0
16,224,224,1,1,0,1,0
26,233,233,29,6,23,4,3
11,266,266,100,8,92,3,2
38,271,271,72,72,0,1,0
23,279,279,18,1,17,3,2
19,283,283,13,4,9,4,3
12,294,294,3,3,0,1,0
22,317,317,13,1,12,2,1
17,333,333,57,57,0,1,0
34,343,343,3,3,0,1,0
35,357,357,23,23,0,1,0
2,365,365,16,16,0,1,0
25,389,389,12,1,11,3,2
24,391,391,80,62,18,3,2
27,391,391,17,17,0,1,0
13,392,392,15,10,5,2,1
15,425,425,37,7,30,4,3
18,455,455,5,5,0,1,0
7,458,458,92,24,68,3,2
33,458,458,122,80,42,3,2
37,464,464,1,1,0,1,0
1,477,477,75,75,0,1,0
4,477,477,3,3,0,1,0
14,480,480,37,3,34,2,1
8,493,493,30,16,14,2,1
39,498,498,35,16,19,2,1

24,149,149,16,1,15,2,1
0,155,155,5,1,4,2,1
19,159,159,2,2,0,1,0
31,182,182,37,37,0,1,0
12,206,206,24,14,10,3,2
3,210,210,5,1,4,2,1
30,213,213,50,14,36,3,2
9,215,215,25,25,0,1,0
13,216,216,12,6,6,3,2
21,245,245,45,7,38,2,1
17,254,254,17,6,11,2,1
8,255,255,79,67,12,3,2
28,271,271,26,26,0,1,0
11,285,285,8,2,6,2,1
22,295,295,10,1,9,4,3
1,313,313,9,9,0,1,0
18,324,324,24,4,20,4,3
26,331,331,42,13,29,2,1
16,338,338,23,23,0,1,0
4,370,370,108,108,0,1,0
14,379,379,87,87,0,1,0
25,380,380,16,1,15,2,1
23,416,416,86,20,66,4,3
5,419,419,3,3,0,1,0
32,428,428,20,20,0,1,0
27,437,437,53,15,38,2,1
7,441,441,101,101,0,1,0
15,444,444,11,2,9,4,3
10,451,451,5,5,0,1,0
20,472,472,39,19,20,3,2
2,474,474,8,2,6,3,2
29,486,486,47,47,0,1,0
6,490,490,149,65,84,4,3

2,102,102,11,3,8,2,1
12,106,106,4,4,0,1,0
29,108,108,3,3,0,1,0
34,110,110,2,2,0,1,0
6,112,112,15,6,9,4,3
0,115,115,14,2,12,2,1
5,118,118,24,3,21,2,1
30,123,123,2,2,0,1,0
22,128,128,24,7,17,2,1
9,174,174,18,18,0,1,0
3,185,185,29,29,0,1,0
32,202,202,17,7,10,2,1
25,212,212,5,5,0,1,0
1,234,234,22,11,11,2,1
23,236,236,19,19,0,1,0
15,253,253,1,1,0,1,0
28,280,280,22,6,16,3,2
31,281,281,6,6,0,1,0
7,282,282,56,11,45,4,3
18,299,299,23,23,0,1,0
33,301,301,6,6,0,1,0
19,311,311,12,6,6,2,1
11,317,317,55,21,34,2,1
21,321,321,160,120,40,4,3
26,329,329,19,10,9,2,1
14,355,355,32,32,0,1,0
24,364,364,54,9,45,4,3
27,375,375,69,69,0,1,0
4,386,386,15,3,12,2,1
17,429,429,111,91,20,2,1
10,438,438,23,2,21,4,3
13,442,442,35,35,0,1,0
8,455,455,67,41,26,3,2
16,472,472,27,27,0,1,0
20,486,486,12,12,0,1,0

15,109,109,2,2,0,1,0
31,109,109,9,9,0,1,0
30,127,127,3,3,0,1,0
6,133,133,1,1,0,1,0
24,178,178,10,4,6,2,1
10,179,179,16,16,0,1,0
5,184,184,25,25,0,1,0
9,184,184,69,69,0,1,0
16,210,210,14,7,7,2,1
17,213,213,6,6,0,1,0
20,216,216,30,30,0,1,0
8,230,230,28,13,15,2,1
4,233,233,23,23,0,1,0
27,242,242,26,23,3,2,1
14,245,245,16,16,0,1,0
23,259,259,52,52,0,1,0
2,264,264,32,32,0,1,0
26,277,277,11,3,8,3,2
34,305,305,15,4,11,2,1
29,317,317,3,3,0,1,0
36,327,327,45,45,0,1,0
0,335,335,54,54,0,1,0
18,338,338,15,6,9,2,1
19,347,347,33,7,26,3,2
1,352,352,41,29,12,4,3
21,364,364,102,99,3,2,1
22,364,364,90,6,84,4,3
25,394,394,8,8,0,1,0
11,415,415,28,28,0,1,0
13,431,431,11,11,0,1,0
35,437,437,9,9,0,1,0
7,439,439,19,19,0,1,0
3,453,453,27,1,26,3,2
32,460,460,82,10,72,4,3
33,467,467,6,2,4,2,1
28,480,480,64,15,49,2,1
12,484,484,75,75,0,1,0

24,111,111,25,25,0,1,0
4,114,114,13,3,10,2,1
0,123,123,10,2,8,3,2
27,128,128,3,3,0,1,0
18,145,145,3,3,0,1,0
3,146,146,9,9,0,1,0
13,149,149,1,1,0,1,0
19,170,170,14,14,0,1,0
7,171,171,30,30,0,1,0
30,178,178,16,10,6,3,2
2,188,188,27,18,9,2,1
5,206,206,5,2,3,2,1
22,211,211,1,1,0,1,0
8,222,222,41,41,0,1,0
36,265,265,66,66,0,1,0
10,267,267,1,1,0,1,0
14,272,272,81,69,12,3,2
21,275,275,13,13,0,1,0
37,285,285,21,21,0,1,0
12,297,297,14,14,0,1,0
23,305,305,4,4,0,1,0
26,309,309,11,11,0,1,0
31,314,314,93,49,44,4,3
34,326,326,14,2,12,4,3
28,333,333,18,18,0,1,0
33,349,349,19,1,18,2,1
35,384,384,15,7,8,2,1
25,392,392,34,28,6,3,2
1,404,404,11,11,0,1,0
20,409,409,7,2,5,2,1
29,420,420,62,19,43,2,1
16,427,427,108,51,57,4,3
17,435,435,18,18,0,1,0
11,444,444,16,16,0,1,0
32,452,452,25,20,5,2,1
38,459,459,133,133,0,1,0
15,463,463,2,2,0,1,0
6,492,492,53,30,23,2,1
9,495,495,35,26,9,4,3

32,108,108,5,5,0,1,0
29,115,115,15,15,0,1,0
26,119,119,7,1,6,2,1
3,148,148,15,15,0,1,0
25,157,157,6,6,0,1,0
11,187,187,1,1,0,1,0
15,189,189,14,14,0,1,0
28,201,201,42,42,0,1,0
18,202,202,3,3,0,1,0
23,218,218,5,5,0,1,0
4,220,220,13,13,0,1,0
20,232,232,93,93,0,1,0
2,245,245,25,7,18,2,1
6,248,248,113,113,0,1,0
16,251,251,45,45,0,1,0
5,280,280,7,7,0,1,0
8,290,290,6,6,0,1,0
22,298,298,24,8,16,3,2
19,313,313,17,7,10,2,1
13,321,321,34,8,26,3,2
21,358,358,69,69,0,1,0
14,381,381,57,57,0,1,0
27,382,382,8,2,6,3,2
17,384,384,9,4,5,2,1
9,384,384,26,11,15,2,1
7,394,394,11,5,6,2,1
30,409,409,33,7,26,3,2
10,410,410,6,6,0,1,0
0,434,434,133,89,44,3,2
1,465,465,132,132,0,1,0
12,481,481,37,3,34,2,1
31,485,485,43,25,18,2,1
24,493,493,63,6,57,4,3

32,104,104,14,5,9,2,1
23,126,126,16,1,15,4,3
14,152,152,11,5,6,2,1
17,157,157,5,1,4,2,1
18,166,166,11,11,0,1,0
4,175,175,10,6,4,2,1
35,176,176,22,16,6,3,2
8,182,182,16,4,12,4,3
22,184,184,12,12,0,1,0
15,196,196,52,44,8,3,2
21,217,217,6,6,0,1,0
27,242,242,25,25,0,1,0
2,243,243,2,2,0,1,0
26,257,257,74,50,24,3,2
12,258,258,5,5,0,1,0
30,259,259,2,2,0,1,0
10,276,276,95,9,86,3,2
6,289,289,25,14,11,2,1
33,301,301,34,34,0,1,0
28,344,344,13,13,0,1,0
20,351,351,121,98,23,2,1
37,351,351,6,6,0,1,0
3,355,355,9,9,0,1,0
1,357,357,48,48,0,1,0
11,384,384,44,44,0,1,0
13,386,386,19,4,15,2,1
29,397,397,47,47,0,1,0
34,399,399,41,23,18,3,2
7,421,421,23,11,12,4,3
25,427,427,11,5,6,2,1
36,444,444,31,16,15,4,3
24,457,457,46,21,25,4,3
19,462,462,3,3,0,1,0
16,468,468,15,15,0,1,0
0,475,475,13,5,8,3,2
31,476,476,14,14,0,1,0
9,494,494,15,15,0,1,0
5,494,494,142,22,120,4,3

5,100,100,1,1,0,1,0
11,111,111,6,2,4,2,1
31,121,121,6,6,0,1,0
24,142,142,4,1,3,2,1
35,156,156,7,7,0,1,0
1,157,157,20,20,0,1,0
3,163,163,30,30,0,1,0
29,200,200,24,24,0,1,0
22,263,263,3,3,0,1,0
15,291,291,39,31,8,2,1
9,303,303,11,1,10,3,2
30,312,312,33,24,9,2,1
13,314,314,15,9,6,2,1
23,318,318,8,8,0,1,0
20,318,318,35,35,0,1,0
28,338,338,88,36,52,3,2
6,339,339,101,16,85,4,3
16,352,352,15,15,0,1,0
21,376,376,27,27,0,1,0
0,379,379,17,9,8,2,1
26,381,381,96,96,0,1,0
10,386,386,9,9,0,1,0
27,414,414,2,2,0,1,0
33,416,416,100,100,0,1,0
32,420,420,10,5,5,2,1
25,434,434,46,46,0,1,0
14,438,438,93,93,0,1,0
2,441,441,112,112,0,1,0
19,443,443,75,53,22,3,2
18,445,445,16,16,0,1,0
12,446,446,12,9,3,2,1
36,448,448,88,40,48,2,1
17,464,464,58,58,0,1,0
7,466,466,1,1,0,1,0
4,480,480,51,51,0,1,0
8,482,482,18,18,0,1,0
34,494,494,8,8,0,1,0

3,106,106,1,1,0,1,0
16,126,126,3,3,0,1,0
1,154,154,1,1,0,1,0
19,159,159,1,1,0,1,0
11,163,163,6,1,5,2,1
17,169,169,6,1,5,2,1
34,178,178,30,14,16,3,2
14,189,189,27,15,12,2,1
26,202,202,57,57,0,1,0
2,203,203,21,21,0,1,0
7,227,227,20,20,0,1,0
22,237,237,49,49,0,1,0
13,261,261,13,3,10,3,2
32,263,263,22,22,0,1,0
18,265,265,9,9,0,1,0
31,267,267,61,7,54,4,3
35,301,301,63,63,0,1,0
4,316,316,17,17,0,1,0
21,322,322,5,5,0,1,0
30,333,333,35,35,0,1,0
27,337,337,23,4,19,2,1
20,339,339,40,2,38,2,1
25,340,340,9,9,0,1,0
29,358,358,6,6,0,1,0
9,382,382,54,45,9,4,3
8,394,394,112,112,0,1,0
5,405,405,56,56,0,1,0
24,411,411,28,5,23,2,1
10,414,414,15,3,12,3,2
6,423,423,225,186,39,4,3
28,451,451,65,65,0,1,0
33,464,464,5,5,0,1,0
23,468,468,17,5,12,3,2
12,480,480,17,14,3,2,1
15,483,483,4,4,0,1,0
0,484,484,37,37,0,1,0

29,108,108,23,23,0,1,0
5,109,109,15,15,0,1,0
24,113,113,14,14,0,1,0
28,120,120,17,5,12,3,2
25,140,140,15,15,0,1,0
14,141,141,4,4,0,1,0
1,156,156,46,4,42,3,2
18,161,161,22,4,18,2,1
27,173,173,7,7,0,1,0
7,218,218,56,17,39,2,1
17,221,221,12,12,0,1,0
19,234,234,13,13,0,1,0
26,238,238,16,16,0,1,0
20,243,243,1,1,0,1,0
2,260,260,13,10,3,2,1
15,265,265,23,5,18,2,1
22,300,300,76,48,28,3,2
16,326,326,45,45,0,1,0
0,331,331,77,64,13,2,1
13,335,335,42,42,0,1,0
23,360,360,3,3,0,1,0
30,360,360,79,79,0,1,0
8,396,396,12,12,0,1,0
21,397,397,18,2,16,3,2
4,397,397,106,7,99,4,3
6,423,423,44,44,0,1,0
12,434,434,28,28,0,1,0
9,434,434,11,11,0,1,0
10,449,449,30,12,18,4,3
3,449,449,24,24,0,1,0
11,471,471,103,62,41,2,1

6,104,104,12,12,0,1,0
32,109,109,10,10,0,1,0
12,119,119,2,2,0,1,0
8,143,143,8,8,0,1,0
15,149,149,3,3,0,1,0
25,151,151,4,4,0,1,0
2,155,155,15,5,10,3,2
4,174,174,7,7,0,1,0
17,188,188,51,51,0,1,0
30,196,196,2,2,0,1,0
5,202,202,33,5,28,3,2
29,211,211,3,3,0,1,0
9,241,241,3,3,0,1,0
18,252,252,16,2,14,3,2
19,259,259,29,29,0,1,0
26,272,272,71,10,61,4,3
22,280,280,24,24,0,1,0
13,290,290,7,3,4,2,1
14,295,295,96,96,0,1,0
27,300,300,15,7,8,2,1
3,312,312,136,123,13,2,1
0,316,316,3,3,0,1,0
20,317,317,9,9,0,1,0
7,345,345,45,42,3,2,1
1,345,345,84,30,54,3,2
23,384,384,16,16,0,1,0
31,403,403,36,9,27,2,1
16,407,407,74,4,70,4,3
24,424,424,51,5,46,3,2
11,450,450,18,18,0,1,0
10,465,465,43,43,0,1,0
28,483,483,96,82,14,2,1
21,486,486,82,42,40,3,2

8,108,108,10,2,8,3,2
25,116,116,1,1,0,1,0
23,122,122,18,18,0,1,0
3,130,130,30,9,21,2,1
27,137,137,3,3,0,1,0
24,154,154,16,16,0,1,0
26,161,161,18,6,12,3,2
9,174,174,7,3,4,2,1
22,187,187,35,19,16,2,1
6,217,217,25,25,0,1,0
7,218,218,42,42,0,1,0
19,219,219,31,5,26,2,1
11,245,245,2,2,0,1,0
16,280,280,62,62,0,1,0
15,288,288,30,9,21,4,3
28,293,293,21,21,0,1,0
17,316,316,42,42,0,1,0
2,317,317,48,48,0,1,0
5,337,337,199,199,0,1,0
10,342,342,23,1,22,2,1
13,363,363,14,14,0,1,0
0,367,367,30,30,0,1,0
12,370,370,4,1,3,2,1
4,391,391,33,22,11,2,1
1,396,396,58,58,0,1,0
14,413,413,4,4,0,1,0
21,419,419,9,9,0,1,0
29,420,420,22,22,0,1,0
20,478,478,49,28,21,2,1
18,483,483,165,104,61,4,3

5,100,100,21,21,0,1,0
17,101,101,24,3,21,2,1
7,122,122,6,3,3,2,1
14,128,128,1,1,0,1,0
6,147,147,12,12,0,1,0
37,147,147,11,11,0,1,0
28,157,157,19,19,0,1,0
34,182,182,2,2,0,1,0
0,185,185,1,1,0,1,0
10,192,192,23,8,15,2,1
11,192,192,1,1,0,1,0
15,201,201,10,10,0,1,0
27,208,208,8,8,0,1,0
3,209,209,20,6,14,3,2
18,209,209,7,4,3,2,1
8,231,231,1,1,0,1,0
16,232,232,6,6,0,1,0
40,240,240,11,1,10,2,1
1,276,276,11,11,0,1,0
39,287,287,12,12,0,1,0
23,294,294,12,1,11,2,1
22,295,295,70,40,30,3,2
30,298,298,1,1,0,1,0
12,299,299,25,1,24,2,1
38,302,302,28,28,0,1,0
26,307,307,70,49,21,4,3
33,308,308,60,60,0,1,0
20,326,326,55,55,0,1,0
35,368,368,61,61,0,1,0
25,376,376,118,88,30,2,1
24,380,380,81,21,60,3,2
9,405,405,33,14,19,2,1
4,422,422,23,14,9,2,1
29,435,435,46,22,24,3,2
2,448,448,20,5,15,2,1
32,451,451,27,9,18,3,2
13,464,464,3,3,0,1,0
21,470,470,12,12,0,1,0
36,471,471,2,2,0,1,0
31,481,481,37,15,22,2,1
19,486,486,65,65,0,1,0

12,110,110,15,3,12,4,3
19,117,117,5,5,0,1,0
29,117,117,28,28,0,1,0
27,125,125,2,2,0,1,0
3,132,132,27,11,16,3,2
22,144,144,10,1,9,4,3
34,146,146,8,8,0,1,0
36,166,166,14,4,10,3,2
17,183,183,11,1,10,3,2
38,191,191,13,13,0,1,0
0,194,194,14,6,8,3,2
37,211,211,5,2,3,2,1
28,221,221,6,3,3,2,1
16,235,235,1,1,0,1,0
13,240,240,13,1,12,4,3
9,243,243,4,4,0,1,0
31,247,247,9,9,0,1,0
26,251,251,44,44,0,1,0
21,253,253,1,1,0,1,0
20,254,254,18,3,15,4,3
8,260,260,1,1,0,1,0
4,309,309,17,4,13,2,1
15,316,316,22,7,15,4,3
40,345,345,8,2,6,2,1
25,353,353,148,52,96,4,3
14,355,355,37,11,26,2,1
5,360,360,12,12,0,1,0
18,363,363,18,3,15,4,3
32,363,363,126,126,0,1,0
1,367,367,4,4,0,1,0
7,370,370,18,18,0,1,0
35,377,377,14,14,0,1,0
30,389,389,11,3,8,2,1
10,395,395,25,7,18,3,2
11,404,404,84,42,42,3,2
41,418,418,9,9,0,1,0
24,423,423,21,21,0,1,0
33,430,430,4,4,0,1,0
39,437,437,73,53,20,2,1
6,444,444,108,14,94,3,2
23,467,467,8,2,6,3,2
42,483,483,28,28,0,1,0
2,500,500,55,55,0,1,0

18,101,101,13,5,8,2,1
35,105,105,4,4,0,1,0
23,110,110,24,3,21,4,3
17,125,125,1,1,0,1,0
13,127,127,17,17,0,1,0
10,128,128,1,1,0,1,0
29,131,131,3,3,0,1,0
1,132,132,27,27,0,1,0
37,148,148,59,47,12,4,3
7,153,153,1,1,0,1,0
0,170,170,44,44,0,1,0
31,173,173,8,5,3,2,1
22,178,178,39,3,36,3,2
6,221,221,60,60,0,1,0
19,239,239,2,2,0,1,0
24,246,246,13,13,0,1,0
11,254,254,5,5,0,1,0
36,257,257,7,7,0,1,0
25,290,290,14,14,0,1,0
14,292,292,12,2,10,2,1
5,300,300,23,17,6,3,2
21,305,305,55,10,45,2,1
3,320,320,6,6,0,1,0
9,329,329,24,5,19,2,1
32,330,330,1,1,0,1,0
20,331,331,3,3,0,1,0
30,341,341,46,46,0,1,0
8,364,364,1,1,0,1,0
34,397,397,31,15,16,2,1
12,410,410,3,3,0,1,0
2,412,412,101,101,0,1,0
15,416,416,36,36,0,1,0
33,418,418,36,18,18,3,2
16,442,442,21,4,17,2,1
4,459,459,71,71,0,1,0
28,485,485,66,47,19,2,1
27,491,491,57,57,0,1,0
26,495,495,11,2,9,4,3

36,103,103,12,3,9,2,1
7,121,121,4,4,0,1,0
0,153,153,30,10,20,2,1
35,162,162,36,36,0,1,0
34,164,164,3,3,0,1,0
31,164,164,17,17,0,1,0
15,177,177,50,50,0,1,0
29,207,207,14,14,0,1,0
13,209,209,5,5,0,1,0
3,215,215,4,4,0,1,0
21,219,219,27,27,0,1,0
38,226,226,16,1,15,2,1
5,228,228,15,4,11,2,1
20,231,231,12,12,0,1,0
8,277,277,1,1,0,1,0
24,295,295,18,6,12,3,2
10,314,314,1,1,0,1,0
17,316,316,83,83,0,1,0
2,326,326,1,1,0,1,0
26,334,334,20,12,8,2,1
30,339,339,50,50,0,1,0
16,360,360,10,10,0,1,0
22,377,377,30,30,0,1,0
28,384,384,32,4,28,2,1
1,389,389,44,44,0,1,0
14,401,401,1,1,0,1,0
33,413,413,8,8,0,1,0
11,416,416,83,35,48,3,2
4,422,422,18,6,12,4,3
18,423,423,89,58,31,3,2
27,432,432,128,12,116,4,3
32,437,437,21,7,14,2,1
37,448,448,34,14,20,2,1
19,460,460,86,86,0,1,0
23,464,464,100,28,72,4,3
25,471,471,13,13,0,1,0
12,477,477,17,17,0,1,0
9,478,478,7,7,0,1,0
6,488,488,12,9,3,2,1

29,104,104,1,1,0,1,0
24,116,116,18,5,13,2,1
21,120,120,6,1,5,2,1
23,125,125,3,3,0,1,0
22,128,128,1,1,0,1,0
4,142,142,7,7,0,1,0
37,147,147,5,5,0,1,0
2,151,151,3,3,0,1,0
0,159,159,21,1,20,2,1
20,167,167,43,43,0,1,0
41,173,173,36,23,13,2,1
39,174,174,31,31,0,1,0
5,178,178,13,13,0,1,0
30,182,182,2,2,0,1,0
17,188,188,12,12,0,1,0
1,205,205,26,17,9,2,1
28,215,215,3,3,0,1,0
18,221,221,13,13,0,1,0
33,248,248,2,2,0,1,0
3,259,259,17,17,0,1,0
11,259,259,5,5,0,1,0
34,276,276,38,38,0,1,0
40,285,285,91,1,90,3,2
35,306,306,10,2,8,3,2
31,311,311,86,86,0,1,0
8,323,323,21,3,18,4,3
10,325,325,2,2,0,1,0
14,328,328,11,6,5,2,1
32,334,334,5,5,0,1,0
16,339,339,89,89,0,1,0
13,355,355,64,64,0,1,0
36,362,362,5,5,0,1,0
27,370,370,19,3,16,3,2
26,371,371,41,41,0,1,0
9,388,388,2,2,0,1,0
25,389,389,80,80,0,1,0
15,397,397,5,5,0,1,0
38,399,399,29,13,16,3,2
19,428,428,60,60,0,1,0
7,450,450,64,43,21,4,3
6,457,457,3,3,0,1,0
12,493,493,2,2,0,1,0

9,117,117,25,25,0,1,0
0,126,126,5,5,0,1,0
23,129,129,10,10,0,1,0
16,130,130,1,1,0,1,0
6,157,157,20,20,0,1,0
2,176,176,5,5,0,1,0
32,184,184,64,2,62,3,2
8,197,197,22,22,0,1,0
10,254,254,6,6,0,1,0
1,260,260,18,10,8,2,1
22,276,276,34,10,24,2,1
35,285,285,8,8,0,1,0
24,301,301,21,21,0,1,0
13,340,340,17,17,0,1,0
3,343,343,61,55,6,2,1
26,361,361,17,9,8,2,1
7,372,372,31,23,8,3,2
12,377,377,30,11,19,2,1
36,379,379,26,26,0,1,0
30,387,387,20,4,16,2,1
31,389,389,108,40,68,4,3
20,407,407,8,8,0,1,0
28,408,408,15,15,0,1,0
17,420,420,45,45,0,1,0
15,420,420,8,8,0,1,0
4,421,421,35,35,0,1,0
18,429,429,34,34,0,1,0
14,432,432,93,86,7,2,1
5,437,437,19,19,0,1,0
21,444,444,9,9,0,1,0
11,453,453,48,30,18,2,1
33,461,461,17,13,4,2,1
34,465,465,1,1,0,1,0
29,472,472,133,133,0,1,0
37,473,473,3,3,0,1,0
25,476,476,88,64,24,2,1
19,486,486,66,66,0,1,0
27,487,487,74,74,0,1,0

16,105,105,1,1,0,1,0
21,117,117,14,1,13,3,2
43,127,127,16,16,0,1,0
29,128,128,11,11,0,1,0
20,149,149,1,1,0,1,0
40,153,153,24,19,5,2,1
12,159,159,4,1,3,2,1
2,191,191,1,1,0,1,0
17,192,192,6,6,0,1,0
11,219,219,2,2,0,1,0
3,223,223,10,2,8,3,2
9,227,227,5,5,0,1,0
36,242,242,2,2,0,1,0
10,251,251,21,21,0,1,0
19,255,255,1,1,0,1,0
18,295,295,33,7,26,2,1
8,299,299,19,4,15,3,2
27,303,303,11,11,0,1,0
25,327,327,5,5,0,1,0
26,332,332,89,35,54,4,3
1,332,332,111,65,46,3,2
24,337,337,13,13,0,1,0
22,346,346,20,15,5,2,1
41,347,347,24,3,21,4,3
23,370,370,11,1,10,2,1
39,374,374,33,1,32,4,3
28,382,382,17,7,10,3,2
37,389,389,72,72,0,1,0
38,392,392,4,4,0,1,0
13,395,395,39,15,24,3,2
30,397,397,131,80,51,4,3
7,399,399,59,38,21,4,3
31,403,403,56,46,10,3,2
5,417,417,7,7,0,1,0
35,419,419,33,21,12,4,3
0,425,425,20,13,7,2,1
42,427,427,13,13,0,1,0
33,449,449,3,3,0,1,0
34,451,451,23,9,14,3,2
6,458,458,5,5,0,1,0
15,458,458,168,124,44,2,1
32,471,471,53,53,0,1,0
4,491,491,43,43,0,1,0
14,497,497,6,6,0,1,0

26,106,106,3,3,0,1,0
0,133,133,10,10,0,1,0
5,139,139,4,4,0,1,0
30,151,151,18,15,3,2,1
35,159,159,18,18,0,1,0
13,160,160,6,6,0,1,0
39,177,177,11,11,0,1,0
11,185,185,5,5,0,1,0
8,195,195,10,10,0,1,0
40,198,198,11,11,0,1,0
20,202,202,13,5,8,3,2
23,203,203,15,15,0,1,0
42,216,216,18,8,10,3,2
38,229,229,13,13,0,1,0
37,230,230,16,16,0,1,0
28,234,234,68,34,34,2,1
19,240,240,11,11,0,1,0
15,261,261,7,7,0,1,0
7,266,266,4,1,3,2,1
12,274,274,1,1,0,1,0
41,278,278,3,3,0,1,0
31,283,283,3,3,0,1,0
6,289,289,42,42,0,1,0
14,306,306,30,30,0,1,0
21,315,315,36,8,28,2,1
25,346,346,15,6,9,4,3
1,371,371,6,6,0,1,0
9,378,378,46,21,25,2,1
33,384,384,11,5,6,2,1
24,398,398,27,27,0,1,0
17,402,402,37,37,0,1,0
43,425,425,8,8,0,1,0
16,431,431,3,3,0,1,0
27,432,432,24,9,15,4,3
2,439,439,114,74,40,4,3
32,440,440,85,31,54,4,3
4,441,441,28,8,20,3,2
22,451,451,52,37,15,4,3
29,458,458,123,69,54,4,3
10,461,461,30,30,0,1,0
44,462,462,104,104,0,1,0
18,470,470,39,39,0,1,0
34,478,478,21,21,0,1,0
3,479,479,17,12,5,2,1
36,493,493,60,10,50,3,2

29,103,103,8,8,0,1,0
28,113,113,20,20,0,1,0
8,123,123,13,13,0,1,0
1,142,142,17,11,6,2,1
21,152,152,11,11,0,1,0
11,161,161,47,21,26,2,1
22,170,170,26,26,0,1,0
23,177,177,7,7,0,1,0
32,185,185,17,3,14,2,1
10,203,203,41,41,0,1,0
6,264,264,1,1,0,1,0
16,266,266,12,12,0,1,0
17,281,281,3,3,0,1,0
24,313,313,26,26,0,1,0
2,316,316,46,30,16,2,1
12,326,326,29,29,0,1,0
4,351,351,16,2,14,3,2
7,358,358,18,14,4,2,1
30,359,359,12,1,11,2,1
27,366,366,2,2,0,1,0
9,371,371,21,5,16,2,1
26,372,372,31,31,0,1,0
25,380,380,31,5,26,2,1
3,399,399,5,5,0,1,0
31,422,422,201,192,9,4,3
20,426,426,9,3,6,3,2
5,427,427,106,106,0,1,0
15,453,453,85,85,0,1,0
0,464,464,53,11,42,4,3
19,470,470,14,6,8,3,2
18,473,473,79,79,0,1,0
14,474,474,130,87,43,4,3
13,498,498,21,13,8,2,1

17,109,109,21,3,18,3,2
7,113,113,7,7,0,1,0
9,142,142,1,1,0,1,0
34,147,147,25,25,0,1,0
19,158,158,1,1,0,1,0
44,159,159,7,2,5,2,1
12,161,161,25,1,24,4,3
23,162,162,6,3,3,2,1
26,169,169,10,4,6,2,1
4,175,175,1,1,0,1,0
28,183,183,15,15,0,1,0
0,188,188,10,10,0,1,0
37,194,194,65,34,31,2,1
33,211,211,69,6,63,4,3
36,218,218,9,9,0,1,0
3,228,228,2,2,0,1,0
20,229,229,22,22,0,1,0
10,235,235,8,8,0,1,0
6,242,242,15,15,0,1,0
15,253,253,32,9,23,2,1
24,281,281,6,6,0,1,0
25,281,281,2,2,0,1,0
38,282,282,31,5,26,2,1
1,292,292,4,4,0,1,0
30,294,294,5,5,0,1,0
14,295,295,32,11,21,2,1
21,298,298,16,10,6,3,2
16,298,298,4,1,3,2,1
13,300,300,50,50,0,1,0
43,306,306,17,17,0,1,0
32,322,322,13,13,0,1,0
40,328,328,21,5,16,2,1
2,379,379,93,90,3,2,1
31,403,403,41,16,25,3,2
39,406,406,25,25,0,1,0
45,417,417,42,42,0,1,0
27,425,425,2,2,0,1,0
41,429,429,41,12,29,2,1
11,445,445,35,35,0,1,0
8,457,457,15,12,3,2,1
18,464,464,28,8,20,3,2
22,466,466,12,2,10,3,2
35,478,478,20,6,14,2,1
42,478,478,28,28,0,1,0
29,480,480,40,10,30,3,2
5,482,482,30,30,0,1,0

30,112,112,26,26,0,1,0
17,123,123,27,7,20,3,2
0,124,124,4,1,3,2,1
35,133,133,20,2,18,3,2
24,150,150,13,1,12,4,3
15,162,162,7,7,0,1,0
20,171,171,23,23,0,1,0
23,174,174,13,1,12,2,1
37,174,174,26,26,0,1,0
7,176,176,1,1,0,1,0
2,215,215,42,14,28,4,3
34,222,222,9,9,0,1,0
3,237,237,50,24,26,3,2
9,242,242,71,71,0,1,0
6,250,250,10,2,8,3,2
31,251,251,4,1,3,2,1
4,255,255,24,4,20,2,1
22,271,271,13,4,9,2,1
26,285,285,29,22,7,2,1
11,308,308,13,13,0,1,0
1,319,319,14,14,0,1,0
27,327,327,30,30,0,1,0
5,334,334,7,4,3,2,1
10,350,350,24,24,0,1,0
12,353,353,39,39,0,1,0
36,354,354,84,28,56,4,3
18,358,358,2,2,0,1,0
29,380,380,66,66,0,1,0
21,396,396,21,9,12,3,2
19,427,427,43,4,39,3,2
38,428,428,8,4,4,2,1
16,429,429,1,1,0,1,0
8,435,435,54,54,0,1,0
14,441,441,3,3,0,1,0
25,442,442,11,11,0,1,0
28,443,443,93,11,82,3,2
33,469,469,5,5,0,1,0
13,470,470,5,2,3,2,1
32,488,488,51,11,40,3,2

9,107,107,22,22,0,1,0
16,113,113,4,4,0,1,0
28,118,118,28,28,0,1,0
2,125,125,10,10,0,1,0
22,159,159,30,8,22,3,2
19,162,162,21,12,9,2,1
33,195,195,2,2,0,1,0
29,214,214,40,1,39,2,1
20,223,223,32,32,0,1,0
32,239,239,9,6,3,2,1
4,248,248,3,3,0,1,0
6,264,264,35,35,0,1,0
30,274,274,1,1,0,1,0
25,279,279,23,23,0,1,0
21,314,314,19,7,12,3,2
23,321,321,22,10,12,3,2
3,323,323,1,1,0,1,0
10,354,354,12,4,8,3,2
7,361,361,57,33,24,3,2
8,389,389,37,20,17,2,1
1,392,392,92,66,26,2,1
11,403,403,47,47,0,1,0
18,424,424,86,53,33,4,3
27,435,435,109,7,102,4,3
5,436,436,14,14,0,1,0
26,436,436,5,5,0,1,0
24,438,438,2,2,0,1,0
15,439,439,66,66,0,1,0
0,441,441,9,9,0,1,0
31,443,443,37,37,0,1,0
14,462,462,166,19,147,4,3
12,464,464,59,53,6,2,1
13,468,468,19,7,12,2,1
17,499,499,48,14,34,2,1

34,128,128,16,16,0,1,0
10,143,143,16,10,6,2,1
12,161,161,1,1,0,1,0
36,170,170,48,31,17,2,1
21,193,193,10,4,6,2,1
18,196,196,29,1,28,3,2
16,206,206,6,6,0,1,0
24,224,224,28,28,0,1,0
17,230,230,37,25,12,2,1
8,237,237,27,27,0,1,0
3,238,238,47,47,0,1,0
28,238,238,8,8,0,1,0
19,245,245,2,2,0,1,0
5,246,246,25,13,12,4,3
7,252,252,12,12,0,1,0
1,253,253,6,6,0,1,0
4,255,255,25,7,18,4,3
32,258,258,8,2,6,2,1
22,269,269,68,32,36,2,1
0,280,280,17,17,0,1,0
14,284,284,12,1,11,2,1
30,295,295,19,19,0,1,0
35,306,306,17,13,4,2,1
29,315,315,15,15,0,1,0
27,322,322,32,32,0,1,0
23,327,327,50,50,0,1,0
6,327,327,40,40,0,1,0
11,329,329,16,16,0,1,0
31,335,335,40,28,12,2,1
26,336,336,23,23,0,1,0
2,372,372,111,53,58,3,2
20,378,378,8,1,7,2,1
9,419,419,44,36,8,3,2
25,424,424,21,2,19,2,1
13,444,444,22,22,0,1,0
33,447,447,109,7,102,4,3
15,456,456,18,1,17,3,2

31,115,115,5,5,0,1,0
8,121,121,10,2,8,2,1
30,152,152,2,2,0,1,0
16,207,207,35,20,15,4,3
21,217,217,20,8,12,2,1
0,230,230,43,43,0,1,0
10,231,231,21,12,9,4,3
24,234,234,43,35,8,3,2
3,258,258,12,12,0,1,0
32,285,285,26,26,0,1,0
19,293,293,9,9,0,1,0
35,306,306,170,134,36,4,3
25,309,309,11,5,6,2,1
11,316,316,27,9,18,3,2
28,319,319,6,6,0,1,0
14,321,321,29,7,22,2,1
1,352,352,54,27,27,4,3
34,355,355,6,6,0,1,0
2,363,363,58,58,0,1,0
4,365,365,1,1,0,1,0
29,369,369,71,71,0,1,0
22,379,379,36,36,0,1,0
13,392,392,11,3,8,3,2
5,401,401,12,12,0,1,0
27,403,403,65,39,26,2,1
17,409,409,18,18,0,1,0
33,410,410,18,18,0,1,0
20,441,441,61,15,46,3,2
26,452,452,10,1,9,3,2
6,458,458,12,5,7,2,1
7,470,470,33,3,30,2,1
23,481,481,35,35,0,1,0
9,481,481,69,69,0,1,0
12,483,483,14,8,6,2,1
18,490,490,16,4,12,4,3
15,497,497,180,160,20,2,1

5,106,106,10,1,9,2,1
34,124,124,10,10,0,1,0
35,126,126,42,42,0,1,0
18,145,145,19,1,18,4,3
17,149,149,7,7,0,1,0
12,165,165,49,49,0,1,0
23,167,167,20,5,15,4,3
25,171,171,2,2,0,1,0
6,174,174,13,13,0,1,0
20,177,177,2,2,0,1,0
9,178,178,3,3,0,1,0
11,223,223,5,5,0,1,0
7,236,236,16,4,12,2,1
36,240,240,17,17,0,1,0
29,248,248,3,3,0,1,0
22,256,256,6,6,0,1,0
32,285,285,11,11,0,1,0
14,288,288,45,37,8,2,1
24,289,289,14,14,0,1,0
27,301,301,9,9,0,1,0
2,319,319,7,7,0,1,0
0,335,335,13,6,7,2,1
19,335,335,49,7,42,2,1
30,364,364,120,73,47,2,1
8,373,373,29,29,0,1,0
3,378,378,49,49,0,1,0
4,403,403,68,68,0,1,0
1,406,406,8,8,0,1,0
26,425,425,11,11,0,1,0
10,440,440,8,8,0,1,0
31,450,450,152,23,129,4,3
13,457,457,5,5,0,1,0
33,464,464,4,4,0,1,0
15,473,473,163,163,0,1,0
16,474,474,31,31,0,1,0
28,475,475,54,21,33,4,3
21,477,477,47,29,18,4,3

23,100,100,7,7,0,1,0
16,102,102,16,16,0,1,0
33,104,104,1,1,0,1,0
32,108,108,34,1,33,2,1
37,110,110,39,3,36,3,2
19,116,116,8,8,0,1,0
38,124,124,5,5,0,1,0
8,152,152,5,5,0,1,0
14,153,153,25,4,21,4,3
24,161,161,7,7,0,1,0
20,166,166,3,3,0,1,0
15,170,170,1,1,0,1,0
26,185,185,27,15,12,2,1
28,189,189,1,1,0,1,0
34,192,192,40,40,0,1,0
36,196,196,11,11,0,1,0
10,201,201,16,16,0,1,0
7,251,251,2,2,0,1,0
12,284,284,9,1,8,3,2
35,289,289,12,2,10,3,2
5,295,295,119,8,111,4,3
6,313,313,1,1,0,1,0
9,320,320,26,20,6,3,2
13,320,320,20,20,0,1,0
2,334,334,77,8,69,3,2
30,335,335,143,89,54,4,3
1,339,339,31,7,24,2,1
3,344,344,11,11,0,1,0
29,347,347,4,4,0,1,0
21,365,365,6,3,3,2,1
0,383,383,40,40,0,1,0
11,414,414,39,1,38,3,2
18,421,421,24,24,0,1,0
17,433,433,22,22,0,1,0
27,434,434,19,10,9,4,3
4,438,438,12,2,10,3,2
22,461,461,2,2,0,1,0
31,491,491,8,2,6,3,2
25,495,495,14,14,0,1,0

29,102,102,5,1,4,2,1
6,144,144,3,3,0,1,0
24,157,157,11,11,0,1,0
28,162,162,13,13,0,1,0
32,164,164,4,4,0,1,0
33,183,183,4,4,0,1,0
4,194,194,15,3,12,4,3
34,195,195,81,2,79,4,3
16,199,199,9,1,8,3,2
18,222,222,3,3,0,1,0
31,235,235,26,3,23,4,3
0,243,243,10,10,0,1,0
20,259,259,23,8,15,2,1
25,280,280,38,38,0,1,0
1,284,284,57,57,0,1,0
10,290,290,71,71,0,1,0
35,299,299,27,8,19,4,3
5,301,301,33,1,32,3,2
19,305,305,88,88,0,1,0
23,315,315,9,9,0,1,0
12,342,342,95,45,50,4,3
27,347,347,26,3,23,2,1
8,359,359,46,46,0,1,0
22,361,361,57,57,0,1,0
3,380,380,13,3,10,2,1
17,405,405,29,15,14,2,1
15,418,418,26,5,21,2,1
26,429,429,52,47,5,2,1
21,441,441,26,26,0,1,0
13,445,445,100,91,9,2,1
7,449,449,25,3,22,2,1
30,460,460,5,2,3,2,1
11,471,471,17,17,0,1,0
9,472,472,13,13,0,1,0
2,474,474,18,18,0,1,0
14,483,483,51,11,40,2,1

17,104,104,2,2,0,1,0
2,117,117,1,1,0,1,0
12,133,133,2,2,0,1,0
18,158,158,18,18,0,1,0
13,163,163,2,2,0,1,0
4,164,164,25,25,0,1,0
7,174,174,17,17,0,1,0
25,183,183,18,7,11,4,3
19,184,184,2,2,0,1,0
10,184,184,7,1,6,2,1
23,199,199,85,61,24,4,3
1,203,203,18,18,0,1,0
6,206,206,37,37,0,1,0
8,213,213,21,21,0,1,0
37,225,225,38,38,0,1,0
35,232,232,18,18,0,1,0
39,237,237,4,4,0,1,0
9,242,242,11,8,3,2,1
22,253,253,16,3,13,2,1
28,261,261,7,7,0,1,0
5,266,266,17,17,0,1,0
11,300,300,22,22,0,1,0
16,322,322,29,17,12,4,3
36,333,333,11,8,3,2,1
3,333,333,42,42,0,1,0
32,334,334,101,19,82,4,3
29,358,358,6,6,0,1,0
33,367,367,51,15,36,3,2
26,369,369,50,22,28,3,2
40,387,387,29,2,27,2,1
38,394,394,14,7,7,2,1
0,407,407,17,4,13,2,1
15,408,408,79,41,38,3,2
31,420,420,18,18,0,1,0
27,425,425,47,47,0,1,0
20,431,431,50,23,27,2,1
24,449,449,5,5,0,1,0
14,450,450,36,36,0,1,0
21,471,471,34,34,0,1,0
34,493,493,19,19,0,1,0
30,495,495,32,24,8,2,1

33,100,100,1,1,0,1,0
7,139,139,15,15,0,1,0
17,142,142,16,16,0,1,0
1,149,149,11,11,0,1,0
20,150,150,3,3,0,1,0
13,183,183,28,28,0,1,0
32,215,215,20,11,9,2,1
24,215,215,17,17,0,1,0
21,232,232,51,30,21,2,1
6,234,234,20,20,0,1,0
10,239,239,77,31,46,3,2
29,264,264,29,29,0,1,0
18,264,264,3,3,0,1,0
8,276,276,11,11,0,1,0
23,281,281,16,8,8,2,1
19,286,286,25,25,0,1,0
28,294,294,11,11,0,1,0
14,299,299,68,27,41,2,1
5,315,315,4,4,0,1,0
12,319,319,7,7,0,1,0
0,327,327,3,3,0,1,0
26,340,340,70,70,0,1,0
9,342,342,37,5,32,2,1
22,343,343,64,4,60,3,2
16,364,364,5,5,0,1,0
25,379,379,45,41,4,2,1
31,380,380,134,44,90,4,3
15,390,390,57,57,0,1,0
27,395,395,30,15,15,4,3
4,426,426,35,13,22,3,2
2,438,438,61,61,0,1,0
30,442,442,19,2,17,2,1
3,453,453,41,41,0,1,0
11,484,484,88,88,0,1,0

7,101,101,9,9,0,1,0
1,114,114,2,2,0,1,0
34,120,120,10,10,0,1,0
9,124,124,18,18,0,1,0
5,127,127,15,15,0,1,0
11,131,131,3,3,0,1,0
20,149,149,14,2,12,4,3
17,151,151,20,5,15,3,2
25,155,155,8,8,0,1,0
37,162,162,5,5,0,1,0
22,165,165,1,1,0,1,0
10,195,195,16,16,0,1,0
28,198,198,9,9,0,1,0
13,199,199,4,4,0,1,0
39,204,204,9,9,0,1,0
35,210,210,8,8,0,1,0
30,214,214,45,45,0,1,0
2,219,219,48,48,0,1,0
38,223,223,20,20,0,1,0
3,251,251,24,2,22,4,3
19,277,277,36,5,31,2,1
8,287,287,12,12,0,1,0
6,309,309,5,5,0,1,0
14,316,316,54,38,16,2,1
0,329,329,4,4,0,1,0
31,334,334,42,27,15,4,3
15,338,338,14,8,6,2,1
23,346,346,17,11,6,2,1
18,354,354,51,51,0,1,0
27,356,356,17,17,0,1,0
36,364,364,177,177,0,1,0
24,370,370,53,16,37,4,3
21,384,384,16,16,0,1,0
16,388,388,30,15,15,3,2
29,405,405,88,11,77,4,3
32,411,411,41,41,0,1,0
4,429,429,2,2,0,1,0
12,434,434,37,17,20,3,2
26,467,467,1,1,0,1,0
33,478,478,25,25,0,1,0

8,103,103,14,14,0,1,0
15,108,108,21,21,0,1,0
4,122,122,7,1,6,3,2
32,124,124,1,1,0,1,0
12,129,129,32,17,15,4,3
25,140,140,25,25,0,1,0
24,149,149,11,3,8,2,1
11,164,164,13,13,0,1,0
22,179,179,6,6,0,1,0
29,183,183,24,17,7,2,1
5,187,187,34,34,0,1,0
33,198,198,7,2,5,2,1
6,212,212,7,7,0,1,0
13,237,237,2,2,0,1,0
7,245,245,6,2,4,2,1
2,251,251,25,25,0,1,0
18,275,275,31,31,0,1,0
3,276,276,9,2,7,2,1
35,283,283,36,7,29,4,3
17,290,290,2,2,0,1,0
31,304,304,19,19,0,1,0
10,306,306,42,42,0,1,0
16,319,319,1,1,0,1,0
26,327,327,2,2,0,1,0
1,332,332,2,2,0,1,0
21,335,335,4,4,0,1,0
9,336,336,60,11,49,3,2
34,339,339,46,14,32,2,1
28,348,348,172,100,72,4,3
20,380,380,34,34,0,1,0
27,422,422,51,51,0,1,0
23,441,441,34,7,27,2,1
30,446,446,2,2,0,1,0
19,452,452,30,12,18,2,1
0,459,459,104,56,48,2,1
14,467,467,17,2,15,2,1
36,489,489,86,86,0,1,0

22,123,123,1,1,0,1,0
38,136,136,14,2,12,3,2
28,141,141,10,6,4,2,1
26,144,144,15,15,0,1,0
3,151,151,16,2,14,3,2
7,156,156,42,26,16,3,2
5,172,172,1,1,0,1,0
37,173,173,2,2,0,1,0
29,182,182,37,18,19,2,1
1,186,186,1,1,0,1,0
36,225,225,25,1,24,4,3
17,250,250,3,3,0,1,0
30,267,267,24,24,0,1,0
24,269,269,51,9,42,4,3
10,269,269,16,1,15,2,1
12,271,271,5,5,0,1,0
33,274,274,17,17,0,1,0
34,298,298,9,9,0,1,0
19,312,312,16,6,10,2,1
0,318,318,48,41,7,2,1
15,320,320,3,3,0,1,0
13,330,330,2,2,0,1,0
40,352,352,57,57,0,1,0
9,359,359,22,22,0,1,0
4,364,364,2,2,0,1,0
25,365,365,7,1,6,2,1
20,366,366,7,3,4,2,1
14,374,374,19,19,0,1,0
43,388,388,10,1,9,2,1
35,393,393,26,26,0,1,0
16,403,403,49,49,0,1,0
11,415,415,3,3,0,1,0
42,415,415,75,21,54,3,2
8,421,421,78,78,0,1,0
31,424,424,117,117,0,1,0
23,430,430,15,15,0,1,0
6,445,445,8,8,0,1,0
41,445,445,34,34,0,1,0
39,450,450,14,14,0,1,0
2,464,464,16,16,0,1,0
18,465,465,71,26,45,2,1
32,472,472,22,1,21,4,3
27,491,491,92,92,0,1,0
21,495,495,99,99,0,1,0

0,102,102,16,11,5,2,1
12,113,113,9,3,6,3,2
16,114,114,1,1,0,1,0
33,119,119,14,14,0,1,0
27,120,120,5,5,0,1,0
13,147,147,14,7,7,2,1
8,154,154,10,1,9,2,1
30,169,169,2,2,0,1,0
29,183,183,15,15,0,1,0
20,198,198,7,7,0,1,0
7,199,199,9,9,0,1,0
9,225,225,1,1,0,1,0
28,226,226,93,36,57,3,2
24,241,241,37,17,20,3,2
4,242,242,15,15,0,1,0
14,252,252,126,90,36,3,2
23,252,252,7,1,6,3,2
18,254,254,29,20,9,2,1
2,257,257,9,9,0,1,0
22,308,308,2,2,0,1,0
17,335,335,84,84,0,1,0
21,345,345,15,1,14,2,1
11,370,370,17,17,0,1,0
19,375,375,2,2,0,1,0
26,377,377,64,64,0,1,0
25,378,378,53,53,0,1,0
6,409,409,9,9,0,1,0
5,409,409,18,18,0,1,0
32,412,412,31,1,30,4,3
1,428,428,56,56,0,1,0
15,450,450,6,2,4,2,1
3,468,468,58,58,0,1,0
34,478,478,10,10,0,1,0
31,485,485,61,61,0,1,0
10,492,492,181,163,18,4,3

25,100,100,1,1,0,1,0
15,110,110,17,17,0,1,0
6,123,123,1,1,0,1,0
11,126,126,11,11,0,1,0
18,146,146,13,13,0,1,0
29,158,158,3,3,0,1,0
19,185,185,22,22,0,1,0
23,188,188,34,9,25,2,1
2,189,189,25,25,0,1,0
0,198,198,95,36,59,4,3
3,200,200,10,10,0,1,0
10,233,233,40,40,0,1,0
20,242,242,7,7,0,1,0
4,255,255,1,1,0,1,0
1,256,256,26,17,9,4,3
13,263,263,29,29,0,1,0
28,272,272,44,44,0,1,0
26,285,285,4,4,0,1,0
21,296,296,6,6,0,1,0
5,305,305,7,7,0,1,0
30,309,309,57,57,0,1,0
16,310,310,77,36,41,2,1
22,322,322,49,49,0,1,0
24,355,355,11,11,0,1,0
9,357,357,21,21,0,1,0
17,362,362,8,8,0,1,0
32,407,407,128,128,0,1,0
31,409,409,25,1,24,4,3
27,422,422,10,1,9,4,3
8,461,461,133,105,28,3,2
14,467,467,26,17,9,4,3
12,469,469,26,18,8,2,1
7,484,484,85,9,76,4,3

18,100,100,16,16,0,1,0
6,101,101,16,5,11,2,1
19,105,105,4,4,0,1,0
2,156,156,12,12,0,1,0
7,158,158,2,2,0,1,0
0,166,166,27,27,0,1,0
17,200,200,31,31,0,1,0
1,227,227,15,15,0,1,0
16,230,230,16,4,12,4,3
14,237,237,54,2,52,3,2
11,238,238,48,48,0,1,0
8,247,247,2,2,0,1,0
13,250,250,5,5,0,1,0
24,271,271,4,4,0,1,0
9,276,276,41,41,0,1,0
28,304,304,43,8,35,2,1
4,329,329,64,64,0,1,0
12,340,340,47,23,24,4,3
22,341,341,73,73,0,1,0
20,375,375,107,41,66,4,3
15,378,378,49,36,13,2,1
10,393,393,74,74,0,1,0
25,419,419,18,18,0,1,0
26,434,434,8,8,0,1,0
29,436,436,115,64,51,4,3
23,450,450,4,4,0,1,0
27,458,458,5,1,4,2,1
3,463,463,82,82,0,1,0
5,482,482,129,65,64,3,2
21,483,483,8,8,0,1,0
30,485,485,13,5,8,2,1

5,114,114,24,9,15,4,3
12,116,116,57,20,37,3,2
25,120,120,1,1,0,1,0
32,130,130,13,2,11,2,1
2,141,141,3,3,0,1,0
21,162,162,16,16,0,1,0
16,179,179,9,9,0,1,0
30,195,195,6,6,0,1,0
8,201,201,12,12,0,1,0
0,213,213,41,30,11,2,1
14,230,230,8,8,0,1,0
7,235,235,10,10,0,1,0
27,237,237,16,16,0,1,0
15,237,237,19,5,14,3,2
4,250,250,45,11,34,3,2
19,259,259,42,15,27,2,1
28,262,262,4,4,0,1,0
13,273,273,25,4,21,2,1
18,286,286,25,25,0,1,0
22,304,304,27,27,0,1,0
6,315,315,3,3,0,1,0
23,338,338,29,29,0,1,0
26,349,349,110,28,82,4,3
29,352,352,17,8,9,4,3
1,358,358,28,28,0,1,0
3,375,375,46,46,0,1,0
9,388,388,32,20,12,2,1
33,396,396,105,41,64,3,2
20,408,408,45,6,39,4,3
10,411,411,35,11,24,3,2
11,440,440,9,3,6,2,1
17,449,449,44,44,0,1,0
31,453,453,33,3,30,4,3
24,455,455,59,59,0,1,0

20,118,118,9,5,4,2,1
41,129,129,3,3,0,1,0
32,138,138,12,12,0,1,0
5,165,165,22,13,9,4,3
27,165,165,6,3,3,2,1
36,182,182,5,5,0,1,0
29,199,199,15,15,0,1,0
42,205,205,3,3,0,1,0
3,205,205,1,1,0,1,0
24,211,211,60,34,26,2,1
4,212,212,25,7,18,4,3
12,217,217,1,1,0,1,0
30,224,224,63,63,0,1,0
15,225,225,6,6,0,1,0
34,244,244,27,27,0,1,0
35,249,249,37,37,0,1,0
7,282,282,4,4,0,1,0
13,285,285,6,6,0,1,0
22,285,285,19,14,5,2,1
9,289,289,8,8,0,1,0
25,289,289,14,6,8,2,1
21,298,298,3,3,0,1,0
16,302,302,9,3,6,2,1
40,339,339,12,12,0,1,0
6,342,342,12,12,0,1,0
28,344,344,53,53,0,1,0
14,346,346,33,33,0,1,0
10,380,380,17,17,0,1,0
23,388,388,33,33,0,1,0
8,396,396,4,1,3,2,1
38,401,401,31,13,18,3,2
2,421,421,24,24,0,1,0
39,426,426,8,8,0,1,0
31,435,435,1,1,0,1,0
33,451,451,146,58,88,3,2
26,452,452,108,108,0,1,0
19,471,471,39,11,28,4,3
18,472,472,2,2,0,1,0
37,474,474,66,66,0,1,0
0,474,474,98,11,87,4,3
1,493,493,1,1,0,1,0
11,496,496,33,33,0,1,0
17,500,500,147,64,83,4,3

8,103,103,1,1,0,1,0
6,105,105,8,8,0,1,0
9,121,121,1,1,0,1,0
15,131,131,1,1,0,1,0
22,143,143,22,10,12,4,3
21,160,160,2,2,0,1,0
14,162,162,23,13,10,3,2
36,169,169,5,5,0,1,0
19,188,188,1,1,0,1,0
2,189,189,24,24,0,1,0
25,203,203,28,13,15,4,3
10,230,230,2,2,0,1,0
28,238,238,18,4,14,2,1
4,250,250,26,26,0,1,0
29,256,256,51,23,28,2,1
26,262,262,12,12,0,1,0
17,265,265,8,4,4,2,1
23,276,276,31,15,16,2,1
16,291,291,17,17,0,1,0
18,316,316,16,16,0,1,0
31,325,325,33,33,0,1,0
24,329,329,72,72,0,1,0
3,333,333,50,50,0,1,0
32,344,344,13,13,0,1,0
12,370,370,30,2,28,2,1
20,378,378,5,5,0,1,0
34,385,385,120,96,24,3,2
27,391,391,15,15,0,1,0
13,392,392,2,2,0,1,0
1,395,395,57,57,0,1,0
30,403,403,13,10,3,2,1
5,410,410,107,11,96,4,3
11,412,412,34,34,0,1,0
35,430,430,71,34,37,2,1
33,435,435,65,26,39,3,2
0,492,492,16,4,12,2,1
7,494,494,209,161,48,4,3

9,129,129,24,14,10,2,1
17,138,138,1,1,0,1,0
23,181,181,11,11,0,1,0
33,182,182,8,8,0,1,0
0,186,186,16,16,0,1,0
36,191,191,3,3,0,1,0
29,201,201,4,4,0,1,0
13,203,203,32,32,0,1,0
35,207,207,5,5,0,1,0
1,229,229,5,5,0,1,0
18,259,259,5,5,0,1,0
12,259,259,11,4,7,2,1
5,302,302,23,15,8,2,1
3,308,308,11,3,8,2,1
10,313,313,31,13,18,4,3
27,318,318,19,13,6,3,2
8,323,323,6,6,0,1,0
30,334,334,42,25,17,2,1
7,338,338,92,92,0,1,0
26,340,340,151,151,0,1,0
20,366,366,37,20,17,2,1
19,369,369,111,16,95,4,3
11,371,371,45,25,20,3,2
28,374,374,13,13,0,1,0
24,394,394,8,8,0,1,0
25,399,399,48,48,0,1,0
34,408,408,9,9,0,1,0
4,412,412,6,6,0,1,0
16,415,415,51,26,25,4,3
22,416,416,26,6,20,3,2
2,417,417,137,71,66,4,3
32,427,427,14,5,9,4,3
6,427,427,68,68,0,1,0
31,438,438,84,62,22,3,2
15,439,439,7,2,5,2,1
21,459,459,68,8,60,4,3
14,467,467,8,8,0,1,0

41,116,116,5,5,0,1,0
35,118,118,9,9,0,1,0
3,123,123,7,7,0,1,0
11,129,129,19,19,0,1,0
22,139,139,1,1,0,1,0
38,139,139,1,1,0,1,0
28,170,170,2,2,0,1,0
19,170,170,6,6,0,1,0
20,178,178,6,6,0,1,0
14,181,181,4,4,0,1,0
31,187,187,5,5,0,1,0
29,197,197,6,6,0,1,0
16,198,198,1,1,0,1,0
13,206,206,30,30,0,1,0
34,214,214,82,75,7,2,1
12,228,228,12,6,6,2,1
25,249,249,17,17,0,1,0
18,252,252,3,3,0,1,0
9,253,253,38,10,28,3,2
2,254,254,25,16,9,3,2
6,255,255,23,2,21,4,3
17,255,255,6,6,0,1,0
5,260,260,12,12,0,1,0
43,278,278,7,7,0,1,0
30,284,284,15,15,0,1,0
8,285,285,21,21,0,1,0
21,288,288,11,11,0,1,0
0,303,303,30,30,0,1,0
27,323,323,5,5,0,1,0
4,332,332,5,5,0,1,0
1,333,333,27,6,21,2,1
15,334,334,41,41,0,1,0
33,338,338,87,29,58,4,3
39,353,353,72,72,0,1,0
10,366,366,70,70,0,1,0
32,378,378,3,3,0,1,0
36,383,383,40,40,0,1,0
24,385,385,19,6,13,2,1
7,387,387,40,22,18,3,2
42,402,402,46,46,0,1,0
26,426,426,13,13,0,1,0
40,442,442,21,21,0,1,0
23,447,447,15,15,0,1,0
37,462,462,186,126,60,4,3

3,105,105,20,20,0,1,0
15,111,111,1,1,0,1,0
37,111,111,8,8,0,1,0
25,136,136,28,28,0,1,0
19,139,139,2,2,0,1,0
29,153,153,18,4,14,4,3
41,163,163,8,8,0,1,0
7,170,170,15,15,0,1,0
30,170,170,12,4,8,2,1
14,172,172,1,1,0,1,0
18,182,182,20,20,0,1,0
32,205,205,37,37,0,1,0
38,212,212,29,29,0,1,0
31,213,213,35,8,27,4,3
0,226,226,6,6,0,1,0
9,234,234,24,24,0,1,0
27,246,246,91,53,38,4,3
10,252,252,11,5,6,2,1
26,260,260,22,1,21,2,1
33,274,274,8,8,0,1,0
22,280,280,6,6,0,1,0
40,294,294,11,7,4,2,1
8,309,309,9,9,0,1,0
5,311,311,5,5,0,1,0
6,325,325,7,7,0,1,0
23,332,332,14,14,0,1,0
13,346,346,23,23,0,1,0
20,347,347,63,5,58,3,2
2,361,361,83,83,0,1,0
36,375,375,59,26,33,2,1
16,379,379,37,15,22,3,2
4,384,384,90,90,0,1,0
11,385,385,12,12,0,1,0
39,387,387,9,9,0,1,0
34,411,411,25,25,0,1,0
17,425,425,11,2,9,2,1
35,447,447,4,1,3,2,1
12,459,459,81,81,0,1,0
1,461,461,6,6,0,1,0
21,480,480,12,12,0,1,0
24,484,484,9,9,0,1,0
28,495,495,27,27,0,1,0

35,100,100,9,9,0,1,0
3,121,121,11,11,0,1,0
32,124,124,1,1,0,1,0
24,124,124,7,7,0,1,0
8,134,134,1,1,0,1,0
11,141,141,1,1,0,1,0
18,164,164,8,8,0,1,0
2,167,167,1,1,0,1,0
44,175,175,7,7,0,1,0
6,216,216,21,4,17,2,1
34,223,223,8,8,0,1,0
1,225,225,3,3,0,1,0
16,237,237,13,13,0,1,0
0,237,237,8,2,6,3,2
30,239,239,81,21,60,4,3
20,271,271,20,20,0,1,0
29,278,278,35,35,0,1,0
19,281,281,9,9,0,1,0
9,281,281,48,8,40,3,2
40,284,284,16,2,14,3,2
17,298,298,34,34,0,1,0
42,302,302,41,29,12,3,2
41,307,307,34,15,19,4,3
33,309,309,17,6,11,2,1
46,317,317,53,53,0,1,0
37,331,331,92,92,0,1,0
5,351,351,7,7,0,1,0
14,376,376,3,3,0,1,0
25,383,383,8,8,0,1,0
36,384,384,26,16,10,2,1
10,395,395,7,7,0,1,0
21,396,396,1,1,0,1,0
38,398,398,37,33,4,2,1
22,408,408,37,13,24,2,1
39,409,409,12,12,0,1,0
45,425,425,34,23,11,2,1
15,428,428,24,24,0,1,0
23,430,430,9,9,0,1,0
27,435,435,41,32,9,2,1
7,441,441,22,22,0,1,0
13,446,446,50,50,0,1,0
26,451,451,42,9,33,4,3
31,457,457,50,5,45,2,1
4,462,462,124,64,60,4,3
28,468,468,17,3,14,3,2
43,480,480,5,5,0,1,0
12,481,481,50,50,0,1,0

30,106,106,1,1,0,1,0
14,107,107,8,4,4,2,1
1,112,112,10,2,8,3,2
7,123,123,27,27,0,1,0
16,130,130,9,9,0,1,0
0,130,130,10,10,0,1,0
10,171,171,34,34,0,1,0
26,194,194,8,2,6,3,2
19,233,233,4,1,3,2,1
2,244,244,8,1,7,2,1
27,251,251,21,6,15,4,3
32,253,253,13,13,0,1,0
4,259,259,24,24,0,1,0
23,263,263,6,6,0,1,0
20,319,319,49,6,43,3,2
3,327,327,9,5,4,2,1
6,330,330,17,3,14,2,1
8,338,338,53,53,0,1,0
29,343,343,29,29,0,1,0
25,353,353,55,55,0,1,0
24,357,357,80,11,69,4,3
28,361,361,47,47,0,1,0
21,391,391,22,22,0,1,0
15,397,397,87,27,60,4,3
9,398,398,67,41,26,2,1
22,428,428,83,35,48,2,1
17,430,430,20,20,0,1,0
12,436,436,90,90,0,1,0
31,445,445,117,117,0,1,0
13,458,458,63,63,0,1,0
5,481,481,45,24,21,4,3
11,489,489,87,77,10,3,2
18,491,491,3,3,0,1,0

25,110,110,8,8,0,1,0
29,119,119,13,5,8,2,1
11,133,133,8,4,4,2,1
21,140,140,3,3,0,1,0
18,149,149,24,15,9,3,2
9,174,174,49,49,0,1,0
13,175,175,5,5,0,1,0
10,176,176,1,1,0,1,0
6,176,176,49,49,0,1,0
3,185,185,1,1,0,1,0
5,191,191,22,4,18,4,3
7,197,197,1,1,0,1,0
24,203,203,37,19,18,4,3
23,204,204,1,1,0,1,0
12,214,214,11,1,10,2,1
14,241,241,16,16,0,1,0
1,244,244,6,6,0,1,0
28,281,281,18,18,0,1,0
20,288,288,48,10,38,3,2
2,295,295,238,124,114,4,3
15,304,304,39,39,0,1,0
0,319,319,9,9,0,1,0
16,348,348,37,10,27,4,3
22,361,361,17,17,0,1,0
19,407,407,77,53,24,3,2
27,409,409,86,86,0,1,0
17,413,413,69,69,0,1,0
26,414,414,43,43,0,1,0
4,444,444,51,39,12,4,3
8,446,446,11,3,8,2,1
30,470,470,3,3,0,1,0

12,105,105,27,27,0,1,0
32,109,109,8,8,0,1,0
25,114,114,27,27,0,1,0
29,119,119,4,1,3,2,1
10,126,126,25,3,22,3,2
0,131,131,1,1,0,1,0
15,163,163,9,9,0,1,0
18,176,176,4,4,0,1,0
3,180,180,14,14,0,1,0
27,180,180,27,5,22,3,2
5,182,182,15,9,6,3,2
28,191,191,2,2,0,1,0
23,214,214,5,5,0,1,0
35,214,214,11,1,10,3,2
8,227,227,4,1,3,2,1
13,234,234,2,2,0,1,0
11,262,262,40,40,0,1,0
36,270,270,21,21,0,1,0
17,278,278,4,4,0,1,0
16,279,279,41,41,0,1,0
26,304,304,95,17,78,4,3
34,316,316,16,4,12,2,1
22,326,326,12,9,3,2,1
33,340,340,3,3,0,1,0
7,357,357,116,109,7,2,1
1,359,359,24,24,0,1,0
21,384,384,37,5,32,2,1
9,388,388,17,12,5,2,1
24,394,394,230,230,0,1,0
30,396,396,9,9,0,1,0
14,398,398,13,1,12,4,3
20,405,405,9,9,0,1,0
4,430,430,56,34,22,3,2
6,437,437,17,17,0,1,0
19,454,454,21,21,0,1,0
2,458,458,58,27,31,4,3
31,483,483,1,1,0,1,0

25,119,119,16,9,7,2,1
24,121,121,26,14,12,2,1
14,129,129,2,2,0,1,0
17,136,136,15,3,12,4,3
11,137,137,18,18,0,1,0
23,151,151,1,1,0,1,0
0,152,152,4,4,0,1,0
21,157,157,1,1,0,1,0
27,162,162,18,18,0,1,0
6,176,176,66,6,60,4,3
18,186,186,13,4,9,2,1
31,213,213,12,12,0,1,0
1,237,237,76,44,32,2,1
32,240,240,14,6,8,2,1
10,263,263,47,1,46,3,2
26,289,289,31,15,16,3,2
13,319,319,21,7,14,4,3
15,325,325,20,4,16,2,1
7,338,338,75,19,56,3,2
30,338,338,8,3,5,2,1
22,343,343,24,5,19,2,1
9,344,344,19,19,0,1,0
16,346,346,16,16,0,1,0
3,351,351,9,9,0,1,0
28,399,399,70,1,69,4,3
2,402,402,21,21,0,1,0
4,403,403,43,23,20,3,2
19,417,417,91,91,0,1,0
20,434,434,158,158,0,1,0
8,441,441,4,4,0,1,0
29,443,443,2,2,0,1,0
5,456,456,80,62,18,2,1
12,496,496,21,21,0,1,0

33,107,107,3,3,0,1,0
23,118,118,17,17,0,1,0
31,133,133,15,15,0,1,0
12,138,138,10,4,6,3,2
30,139,139,6,6,0,1,0
28,139,139,19,9,10,3,2
20,141,141,9,1,8,3,2
3,143,143,24,15,9,2,1
8,151,151,18,9,9,2,1
7,172,172,54,6,48,4,3
27,187,187,54,54,0,1,0
29,190,190,55,55,0,1,0
26,201,201,5,2,3,2,1
13,211,211,19,1,18,4,3
19,217,217,8,3,5,2,1
18,229,229,1,1,0,1,0
1,246,246,23,5,18,4,3
21,272,272,12,3,9,4,3
5,276,276,25,25,0,1,0
17,286,286,29,18,11,2,1
11,305,305,17,17,0,1,0
25,306,306,51,18,33,2,1
4,309,309,3,3,0,1,0
9,311,311,70,46,24,4,3
14,340,340,11,11,0,1,0
15,345,345,42,24,18,2,1
2,414,414,12,12,0,1,0
0,422,422,82,13,69,4,3
16,437,437,18,5,13,2,1
34,440,440,4,4,0,1,0
32,440,440,32,6,26,4,3
36,457,457,72,8,64,4,3
35,458,458,68,64,4,2,1
24,466,466,29,25,4,2,1
22,475,475,7,7,0,1,0
6,477,477,11,2,9,4,3
10,481,481,7,7,0,1,0

32,108,108,8,8,0,1,0
14,110,110,51,51,0,1,0
4,115,115,6,2,4,2,1
15,148,148,1,1,0,1,0
21,151,151,39,18,21,2,1
16,165,165,8,1,7,2,1
33,166,166,7,1,6,2,1
1,173,173,22,22,0,1,0
24,178,178,25,6,19,2,1
0,186,186,17,7,10,3,2
11,194,194,11,11,0,1,0
5,226,226,10,10,0,1,0
25,235,235,6,6,0,1,0
20,241,241,58,58,0,1,0
17,266,266,13,4,9,4,3
19,286,286,27,22,5,2,1
23,295,295,7,7,0,1,0
36,305,305,57,21,36,3,2
8,318,318,28,4,24,2,1
6,321,321,30,2,28,3,2
30,326,326,14,14,0,1,0
26,387,387,62,35,27,4,3
13,389,389,67,67,0,1,0
10,401,401,6,3,3,2,1
27,411,411,24,9,15,4,3
34,416,416,12,12,0,1,0
3,418,418,19,2,17,2,1
9,445,445,106,61,45,4,3
29,449,449,113,88,25,2,1
2,452,452,4,4,0,1,0
12,456,456,26,26,0,1,0
22,463,463,43,43,0,1,0
31,465,465,16,1,15,4,3
18,465,465,19,19,0,1,0
7,474,474,49,49,0,1,0
28,487,487,29,21,8,3,2
35,498,498,9,9,0,1,0

29,102,102,6,6,0,1,0
0,119,119,2,2,0,1,0
34,124,124,17,14,3,2,1
5,128,128,25,14,11,2,1
14,141,141,4,1,3,2,1
20,146,146,23,3,20,2,1
1,151,151,37,37,0,1,0
31,164,164,14,6,8,2,1
28,174,174,30,12,18,4,3
11,186,186,6,6,0,1,0
17,197,197,2,2,0,1,0
30,216,216,4,4,0,1,0
3,234,234,38,38,0,1,0
7,260,260,49,16,33,4,3
27,269,269,38,11,27,2,1
25,269,269,45,45,0,1,0
22,281,281,8,8,0,1,0
26,322,322,3,3,0,1,0
8,331,331,3,3,0,1,0
32,331,331,14,14,0,1,0
13,341,341,1,1,0,1,0
18,344,344,33,1,32,2,1
19,346,346,3,3,0,1,0
24,374,374,28,13,15,4,3
4,375,375,119,57,62,3,2
21,382,382,148,117,31,4,3
15,384,384,20,20,0,1,0
16,407,407,53,53,0,1,0
10,441,441,19,7,12,4,3
12,450,450,67,67,0,1,0
33,479,479,71,48,23,4,3
6,479,479,7,7,0,1,0
23,486,486,44,44,0,1,0
9,487,487,97,82,15,4,3
2,498,498,8,8,0,1,0

33,102,102,16,3,13,4,3
2,120,120,5,5,0,1,0
25,126,126,16,16,0,1,0
24,129,129,4,4,0,1,0
39,130,130,7,4,3,2,1
31,136,136,16,16,0,1,0
4,144,144,11,11,0,1,0
23,147,147,7,7,0,1,0
40,148,148,23,23,0,1,0
11,171,171,34,34,0,1,0
14,172,172,5,5,0,1,0
7,183,183,28,28,0,1,0
27,198,198,19,6,13,2,1
0,199,199,4,4,0,1,0
8,206,206,2,2,0,1,0
41,208,208,8,5,3,2,1
22,219,219,6,6,0,1,0
19,223,223,5,2,3,2,1
35,231,231,11,11,0,1,0
37,233,233,37,37,0,1,0
36,268,268,7,4,3,2,1
42,268,268,22,22,0,1,0
12,281,281,1,1,0,1,0
15,315,315,43,43,0,1,0
21,315,315,28,10,18,4,3
30,352,352,158,158,0,1,0
9,358,358,25,7,18,2,1
34,359,359,6,6,0,1,0
5,363,363,25,25,0,1,0
26,394,394,62,62,0,1,0
32,398,398,52,52,0,1,0
20,402,402,5,1,4,2,1
28,414,414,17,1,16,3,2
16,414,414,39,39,0,1,0
10,422,422,54,15,39,2,1
3,426,426,45,5,40,3,2
1,440,440,20,20,0,1,0
29,458,458,29,17,12,2,1
18,464,464,21,21,0,1,0
43,473,473,21,5,16,3,2
13,475,475,30,30,0,1,0
6,490,490,73,27,46,3,2
38,492,492,1,1,0,1,0
17,498,498,4,4,0,1,0

31,107,107,1,1,0,1,0
15,114,114,9,1,8,2,1
36,117,117,1,1,0,1,0
0,132,132,9,9,0,1,0
33,133,133,11,11,0,1,0
38,135,135,56,32,24,3,2
30,141,141,8,5,3,2,1
4,142,142,5,5,0,1,0
9,147,147,14,11,3,2,1
18,171,171,15,15,0,1,0
21,191,191,14,5,9,2,1
22,211,211,6,6,0,1,0
10,216,216,28,28,0,1,0
34,218,218,57,41,16,3,2
32,219,219,7,7,0,1,0
1,227,227,14,6,8,2,1
13,252,252,29,29,0,1,0
24,253,253,9,2,7,2,1
8,263,263,14,14,0,1,0
6,272,272,1,1,0,1,0
3,307,307,10,6,4,2,1
16,316,316,45,45,0,1,0
28,316,316,3,3,0,1,0
12,323,323,58,37,21,4,3
11,331,331,31,31,0,1,0
20,359,359,33,33,0,1,0
14,361,361,59,21,38,3,2
17,374,374,25,25,0,1,0
5,388,388,40,25,15,4,3
29,390,390,27,3,24,4,3
26,399,399,23,23,0,1,0
25,408,408,152,32,120,4,3
19,412,412,17,5,12,4,3
37,430,430,55,55,0,1,0
23,432,432,29,14,15,2,1
39,439,439,62,62,0,1,0
35,443,443,14,14,0,1,0
2,446,446,18,4,14,2,1
7,447,447,21,9,12,2,1
27,494,494,19,19,0,1,0

1,108,108,3,3,0,1,0
14,115,115,5,5,0,1,0
30,122,122,35,12,23,2,1
33,122,122,17,17,0,1,0
9,162,162,42,42,0,1,0
34,170,170,28,4,24,2,1
32,171,171,39,39,0,1,0
5,203,203,14,14,0,1,0
11,233,233,11,2,9,4,3
25,236,236,11,5,6,2,1
29,275,275,2,2,0,1,0
6,284,284,22,12,10,3,2
0,288,288,12,12,0,1,0
26,300,300,27,6,21,4,3
7,310,310,16,16,0,1,0
28,315,315,24,24,0,1,0
10,329,329,3,3,0,1,0
24,334,334,4,4,0,1,0
15,334,334,31,31,0,1,0
2,346,346,109,109,0,1,0
20,346,346,1,1,0,1,0
13,347,347,5,5,0,1,0
27,350,350,20,5,15,2,1
35,359,359,47,47,0,1,0
12,368,368,1,1,0,1,0
8,384,384,73,73,0,1,0
17,400,400,2,2,0,1,0
22,431,431,84,73,11,3,2
18,453,453,9,3,6,3,2
31,470,470,19,19,0,1,0
16,474,474,69,69,0,1,0
19,475,475,105,58,47,3,2
4,478,478,35,4,31,2,1
23,482,482,34,34,0,1,0
21,488,488,17,5,12,3,2
3,493,493,166,166,0,1,0

1,111,111,4,1,3,2,1
29,117,117,6,2,4,2,1
30,121,121,8,4,4,2,1
4,134,134,5,5,0,1,0
24,174,174,1,1,0,1,0
10,177,177,1,1,0,1,0
11,180,180,7,7,0,1,0
2,186,186,11,2,9,4,3
22,195,195,11,11,0,1,0
17,204,204,42,42,0,1,0
16,237,237,27,21,6,2,1
8,244,244,1,1,0,1,0
12,269,269,28,28,0,1,0
18,282,282,16,2,14,2,1
0,284,284,78,78,0,1,0
21,293,293,13,6,7,2,1
19,297,297,3,3,0,1,0
14,298,298,15,15,0,1,0
28,320,320,48,42,6,2,1
13,320,320,138,129,9,4,3
20,332,332,22,6,16,3,2
27,336,336,6,6,0,1,0
6,339,339,39,6,33,2,1
31,365,365,41,41,0,1,0
7,377,377,56,28,28,4,3
5,382,382,22,22,0,1,0
3,400,400,15,15,0,1,0
15,410,410,213,153,60,4,3
23,456,456,9,1,8,3,2
25,474,474,81,5,76,3,2
26,479,479,54,54,0,1,0
9,486,486,219,204,15,2,1

0,106,106,2,2,0,1,0
34,136,136,3,3,0,1,0
28,138,138,2,2,0,1,0
16,138,138,26,26,0,1,0
11,147,147,4,4,0,1,0
8,150,150,11,11,0,1,0
4,164,164,15,15,0,1,0
2,165,165,2,2,0,1,0
7,171,171,9,9,0,1,0
24,199,199,40,27,13,2,1
9,216,216,10,10,0,1,0
21,229,229,55,49,6,3,2
27,232,232,23,13,10,2,1
40,237,237,19,19,0,1,0
31,237,237,10,10,0,1,0
19,245,245,23,19,4,2,1
3,260,260,46,34,12,4,3
29,261,261,11,11,0,1,0
37,266,266,13,8,5,2,1
25,270,270,124,124,0,1,0
20,290,290,2,2,0,1,0
26,296,296,42,7,35,2,1
1,296,296,11,11,0,1,0
33,313,313,26,26,0,1,0
15,314,314,3,3,0,1,0
14,320,320,2,2,0,1,0
18,328,328,10,3,7,2,1
5,340,340,19,2,17,3,2
30,357,357,24,24,0,1,0
35,370,370,71,68,3,2,1
38,375,375,50,50,0,1,0
36,379,379,36,2,34,2,1
23,392,392,1,1,0,1,0
6,413,413,7,1,6,2,1
17,426,426,103,45,58,3,2
22,443,443,133,111,22,2,1
13,444,444,5,1,4,2,1
32,449,449,8,2,6,3,2
39,461,461,41,41,0,1,0
12,475,475,23,5,18,3,2
10,491,491,7,7,0,1,0

28,102,102,14,3,11,2,1
44,107,107,12,12,0,1,0
7,119,119,1,1,0,1,0
23,122,122,25,25,0,1,0
17,133,133,1,1,0,1,0
11,136,136,7,3,4,2,1
13,170,170,8,2,6,2,1
36,178,178,5,1,4,2,1
38,187,187,19,7,12,2,1
24,188,188,9,1,8,2,1
45,193,193,23,4,19,2,1
29,194,194,60,11,49,2,1
0,200,200,4,4,0,1,0
37,213,213,30,30,0,1,0
21,217,217,14,4,10,3,2
18,222,222,14,8,6,3,2
15,228,228,2,2,0,1,0
25,245,245,6,3,3,2,1
27,259,259,20,14,6,3,2
2,262,262,23,23,0,1,0
30,264,264,16,1,15,2,1
43,268,268,28,28,0,1,0
9,279,279,37,37,0,1,0
40,305,305,30,30,0,1,0
6,306,306,56,56,0,1,0
12,342,342,2,2,0,1,0
5,348,348,48,3,45,4,3
32,363,363,73,73,0,1,0
3,367,367,67,29,38,3,2
41,380,380,16,2,14,2,1
14,387,387,11,11,0,1,0
26,392,392,13,4,9,2,1
10,395,395,25,1,24,3,2
33,397,397,14,4,10,3,2
16,402,402,12,12,0,1,0
8,411,411,6,6,0,1,0
46,422,422,38,38,0,1,0
35,431,431,51,51,0,1,0
39,431,431,14,10,4,2,1
4,442,442,12,3,9,2,1
34,449,449,28,28,0,1,0
22,454,454,9,9,0,1,0
20,462,462,13,13,0,1,0
42,467,467,10,2,8,2,1
19,469,469,27,27,0,1,0
31,472,472,73,73,0,1,0
1,494,494,6,1,5,2,1

23,113,113,4,4,0,1,0
5,148,148,19,9,10,3,2
1,148,148,23,9,14,3,2
24,204,204,9,9,0,1,0
26,209,209,58,24,34,2,1
25,210,210,30,30,0,1,0
10,247,247,4,4,0,1,0
7,248,248,18,1,17,2,1
16,248,248,8,2,6,2,1
3,257,257,34,22,12,3,2
2,279,279,17,11,6,2,1
9,298,298,16,16,0,1,0
11,309,309,92,78,14,3,2
27,339,339,22,22,0,1,0
18,343,343,118,87,31,2,1
13,343,343,9,9,0,1,0
6,356,356,95,95,0,1,0
8,357,357,1,1,0,1,0
22,359,359,97,91,6,3,2
4,364,364,217,163,54,3,2
28,372,372,16,11,5,2,1
12,383,383,28,9,19,2,1
29,411,411,2,2,0,1,0
19,413,413,65,5,60,3,2
17,448,448,46,46,0,1,0
20,452,452,41,8,33,4,3
0,470,470,8,8,0,1,0
14,474,474,23,23,0,1,0
21,499,499,25,4,21,4,3
15,499,499,11,11,0,1,0

27,100,100,11,5,6,2,1
32,105,105,3,3,0,1,0
28,105,105,2,2,0,1,0
15,109,109,33,18,15,4,3
5,110,110,25,25,0,1,0
22,112,112,15,15,0,1,0
19,115,115,27,2,25,2,1
17,117,117,7,4,3,2,1
30,123,123,6,6,0,1,0
21,125,125,16,16,0,1,0
0,150,150,2,2,0,1,0
29,153,153,33,15,18,2,1
24,157,157,3,3,0,1,0
1,170,170,18,18,0,1,0
3,188,188,23,23,0,1,0
13,231,231,9,1,8,3,2
16,238,238,15,3,12,2,1
6,241,241,12,9,3,2,1
8,266,266,3,3,0,1,0
2,269,269,25,21,4,2,1
12,304,304,4,4,0,1,0
4,326,326,8,2,6,3,2
23,330,330,82,72,10,3,2
31,350,350,28,28,0,1,0
9,354,354,15,15,0,1,0
26,362,362,7,7,0,1,0
33,365,365,5,5,0,1,0
20,383,383,66,16,50,3,2
25,386,386,5,5,0,1,0
11,409,409,123,27,96,4,3
18,417,417,91,91,0,1,0
34,428,428,34,34,0,1,0
10,436,436,155,131,24,2,1
14,443,443,15,1,14,3,2
7,486,486,2,2,0,1,0

1,118,118,16,1,15,2,1
30,131,131,18,18,0,1,0
8,133,133,11,1,10,2,1
6,134,134,4,4,0,1,0
5,143,143,23,23,0,1,0
18,158,158,15,4,11,2,1
2,158,158,5,1,4,2,1
13,190,190,22,22,0,1,0
12,211,211,6,1,5,2,1
22,212,212,4,4,0,1,0
27,214,214,35,16,19,2,1
17,231,231,13,4,9,4,3
21,249,249,10,10,0,1,0
25,266,266,31,19,12,4,3
11,267,267,5,5,0,1,0
29,280,280,46,4,42,2,1
16,285,285,31,31,0,1,0
14,308,308,91,48,43,3,2
3,315,315,20,20,0,1,0
26,316,316,59,59,0,1,0
7,317,317,63,63,0,1,0
10,318,318,7,1,6,3,2
19,339,339,70,42,28,3,2
35,356,356,5,5,0,1,0
4,372,372,8,8,0,1,0
32,378,378,66,66,0,1,0
15,404,404,14,14,0,1,0
28,406,406,23,19,4,2,1
9,451,451,105,105,0,1,0
23,455,455,39,39,0,1,0
34,463,463,71,6,65,3,2
24,472,472,45,24,21,4,3
31,480,480,46,46,0,1,0
20,494,494,7,7,0,1,0
0,494,494,81,16,65,3,2
33,494,494,4,1,3,2,1

9,102,102,14,7,7,2,1
33,141,141,71,53,18,4,3
15,180,180,17,17,0,1,0
1,180,180,8,2,6,3,2
23,183,183,5,5,0,1,0
17,237,237,20,20,0,1,0
22,246,246,23,23,0,1,0
16,252,252,10,10,0,1,0
19,253,253,22,15,7,2,1
20,259,259,12,6,6,2,1
37,263,263,18,18,0,1,0
18,266,266,20,8,12,3,2
21,298,298,5,5,0,1,0
10,304,304,15,8,7,2,1
25,304,304,35,9,26,3,2
0,305,305,2,2,0,1,0
4,323,323,79,79,0,1,0
3,329,329,68,68,0,1,0
26,344,344,9,9,0,1,0
28,351,351,34,7,27,4,3
35,353,353,40,5,35,2,1
12,353,353,8,8,0,1,0
7,364,364,4,4,0,1,0
8,367,367,23,23,0,1,0
14,376,376,33,3,30,2,1
30,387,387,106,55,51,4,3
29,388,388,5,5,0,1,0
27,400,400,20,20,0,1,0
36,400,400,24,21,3,2,1
32,434,434,9,6,3,2,1
6,439,439,1,1,0,1,0
2,459,459,1,1,0,1,0
34,461,461,19,3,16,4,3
24,462,462,18,18,0,1,0
11,470,470,11,7,4,2,1
13,474,474,14,14,0,1,0
31,495,495,116,69,47,3,2
5,499,499,245,245,0,1,0

21,105,105,11,4,7,2,1
24,110,110,13,8,5,2,1
31,114,114,12,12,0,1,0
19,129,129,2,2,0,1,0
14,149,149,18,12,6,2,1
7,150,150,21,17,4,2,1
0,156,156,16,16,0,1,0
18,188,188,26,6,20,2,1
25,190,190,6,6,0,1,0
17,195,195,56,11,45,2,1
30,211,211,8,8,0,1,0
2,211,211,3,3,0,1,0
3,217,217,67,25,42,3,2
28,220,220,9,9,0,1,0
20,227,227,64,25,39,4,3
23,252,252,17,17,0,1,0
5,255,255,67,47,20,2,1
29,264,264,6,2,4,2,1
4,275,275,27,19,8,2,1
26,313,313,37,23,14,3,2
15,327,327,45,29,16,3,2
9,348,348,2,2,0,1,0
11,385,385,51,51,0,1,0
6,396,396,70,2,68,3,2
16,410,410,19,10,9,2,1
32,422,422,22,22,0,1,0
8,424,424,33,33,0,1,0
10,437,437,9,9,0,1,0
13,447,447,19,19,0,1,0
22,464,464,71,24,47,2,1
1,468,468,68,23,45,2,1
27,470,470,39,7,32,3,2
12,500,500,78,39,39,3,2

39,112,112,6,6,0,1,0
33,124,124,8,1,7,2,1
21,137,137,17,8,9,2,1
34,140,140,44,8,36,3,2
28,152,152,25,25,0,1,0
15,161,161,2,2,0,1,0
38,176,176,20,20,0,1,0
9,187,187,19,19,0,1,0
26,188,188,1,1,0,1,0
37,205,205,30,2,28,3,2
23,223,223,42,26,16,2,1
10,260,260,13,1,12,2,1
22,263,263,45,45,0,1,0
30,287,287,17,17,0,1,0
19,293,293,43,31,12,3,2
40,309,309,22,15,7,2,1
1,321,321,12,6,6,3,2
18,335,335,2,2,0,1,0
20,335,335,66,31,35,2,1
31,346,346,9,5,4,2,1
36,346,346,61,61,0,1,0
7,346,346,13,5,8,3,2
17,347,347,53,35,18,4,3
2,361,361,35,35,0,1,0
25,361,361,61,11,50,3,2
24,364,364,18,18,0,1,0
0,369,369,7,1,6,2,1
8,370,370,1,1,0,1,0
3,371,371,1,1,0,1,0
14,372,372,17,5,12,3,2
5,377,377,34,17,17,2,1
12,398,398,1,1,0,1,0
6,407,407,24,24,0,1,0
29,420,420,57,31,26,3,2
35,421,421,2,2,0,1,0
27,433,433,13,4,9,3,2
16,442,442,61,61,0,1,0
4,447,447,31,6,25,4,3
11,455,455,58,34,24,3,2
13,464,464,51,12,39,4,3
32,481,481,30,20,10,2,1

19,115,115,1,1,0,1,0
27,121,121,13,13,0,1,0
11,126,126,17,17,0,1,0
32,128,128,10,1,9,4,3
28,155,155,17,14,3,2,1
21,164,164,1,1,0,1,0
0,168,168,5,5,0,1,0
15,195,195,15,15,0,1,0
23,197,197,18,10,8,2,1
33,203,203,7,7,0,1,0
9,207,207,2,2,0,1,0
29,208,208,7,4,3,2,1
20,211,211,2,2,0,1,0
10,234,234,5,1,4,2,1
3,247,247,26,26,0,1,0
2,253,253,144,106,38,3,2
7,254,254,7,7,0,1,0
26,256,256,202,202,0,1,0
17,264,264,13,13,0,1,0
31,286,286,1,1,0,1,0
16,288,288,75,75,0,1,0
24,293,293,32,32,0,1,0
1,326,326,1,1,0,1,0
22,335,335,23,3,20,3,2
34,335,335,24,24,0,1,0
30,359,359,4,4,0,1,0
8,361,361,62,49,13,2,1
13,364,364,1,1,0,1,0
14,367,367,11,5,6,3,2
18,380,380,61,61,0,1,0
5,398,398,4,4,0,1,0
6,410,410,26,26,0,1,0
25,421,421,44,44,0,1,0
4,425,425,39,39,0,1,0
12,461,461,89,19,70,3,2

4,119,119,4,1,3,2,1
6,151,151,52,52,0,1,0
11,160,160,43,23,20,3,2
30,172,172,9,5,4,2,1
21,175,175,14,14,0,1,0
2,184,184,4,4,0,1,0
3,222,222,19,19,0,1,0
20,232,232,9,9,0,1,0
31,249,249,30,8,22,2,1
35,269,269,62,62,0,1,0
33,280,280,39,39,0,1,0
19,280,280,1,1,0,1,0
9,294,294,14,4,10,3,2
1,310,310,29,29,0,1,0
32,320,320,48,34,14,3,2
10,333,333,27,14,13,2,1
34,347,347,1,1,0,1,0
24,358,358,7,3,4,2,1
18,359,359,24,24,0,1,0
28,366,366,41,41,0,1,0
23,381,381,25,11,14,3,2
22,388,388,39,32,7,2,1
13,406,406,32,6,26,3,2
27,408,408,56,17,39,2,1
14,409,409,18,18,0,1,0
7,443,443,15,3,12,3,2
17,450,450,70,70,0,1,0
12,452,452,4,4,0,1,0
16,455,455,52,52,0,1,0
8,468,468,94,46,48,3,2
25,476,476,5,5,0,1,0
15,477,477,28,5,23,3,2
29,492,492,29,23,6,2,1
26,493,493,219,178,41,4,3
5,495,495,29,9,20,2,1
0,499,499,36,18,18,2,1

12,109,109,38,2,36,3,2
19,110,110,1,1,0,1,0
6,117,117,5,5,0,1,0
24,122,122,7,4,3,2,1
9,130,130,6,3,3,2,1
21,145,145,2,2,0,1,0
2,187,187,6,2,4,2,1
8,196,196,28,28,0,1,0
23,202,202,26,5,21,2,1
16,223,223,10,6,4,2,1
18,241,241,30,30,0,1,0
13,264,264,40,40,0,1,0
15,266,266,21,21,0,1,0
28,267,267,10,10,0,1,0
27,275,275,9,2,7,2,1
14,278,278,11,11,0,1,0
4,283,283,58,14,44,2,1
26,288,288,11,11,0,1,0
3,320,320,12,12,0,1,0
29,327,327,41,41,0,1,0
31,350,350,8,2,6,2,1
11,370,370,47,47,0,1,0
30,371,371,8,1,7,2,1
7,386,386,6,6,0,1,0
22,390,390,47,47,0,1,0
0,390,390,140,12,128,4,3
10,394,394,51,42,9,2,1
25,430,430,21,10,11,3,2
17,449,449,33,7,26,2,1
1,456,456,50,47,3,2,1
20,492,492,401,391,10,2,1
5,497,497,27,27,0,1,0

27,112,112,5,2,3,2,1
23,118,118,12,3,9,2,1
33,120,120,18,18,0,1,0
9,121,121,21,21,0,1,0
34,128,128,2,2,0,1,0
2,137,137,37,37,0,1,0
4,143,143,8,8,0,1,0
26,149,149,11,11,0,1,0
25,153,153,7,7,0,1,0
28,170,170,50,50,0,1,0
20,171,171,1,1,0,1,0
17,171,171,1,1,0,1,0
32,188,188,4,4,0,1,0
38,196,196,25,25,0,1,0
24,201,201,8,4,4,2,1
18,211,211,48,48,0,1,0
35,239,239,7,3,4,2,1
19,240,240,8,1,7,2,1
7,250,250,8,1,7,2,1
10,263,263,46,10,36,4,3
22,271,271,7,4,3,2,1
31,276,276,21,21,0,1,0
1,277,277,6,6,0,1,0
40,292,292,71,71,0,1,0
29,320,320,21,21,0,1,0
36,323,323,12,12,0,1,0
15,330,330,30,30,0,1,0
5,358,358,8,1,7,2,1
21,366,366,13,1,12,4,3
8,376,376,27,27,0,1,0
14,393,393,59,41,18,2,1
12,408,408,23,14,9,2,1
3,417,417,32,13,19,4,3
37,444,444,76,30,46,4,3
39,454,454,119,80,39,2,1
13,464,464,4,4,0,1,0
6,472,472,15,5,10,4,3
16,475,475,43,34,9,4,3
11,477,477,46,46,0,1,0
0,490,490,22,22,0,1,0
30,492,492,24,5,19,2,1

12,125,125,22,22,0,1,0
25,149,149,27,6,21,4,3
11,153,153,4,4,0,1,0
24,166,166,11,11,0,1,0
9,170,170,7,3,4,2,1
32,177,177,15,15,0,1,0
2,189,189,22,22,0,1,0
13,240,240,21,21,0,1,0
15,240,240,4,4,0,1,0
8,249,249,49,49,0,1,0
7,263,263,34,34,0,1,0
26,285,285,15,8,7,2,1
5,320,320,1,1,0,1,0
0,320,320,38,38,0,1,0
3,332,332,40,17,23,2,1
28,334,334,24,14,10,3,2
10,339,339,16,7,9,2,1
6,345,345,7,7,0,1,0
29,363,363,18,3,15,4,3
14,377,377,130,115,15,4,3
4,378,378,28,28,0,1,0
30,399,399,36,6,30,4,3
23,399,399,5,5,0,1,0
19,400,400,181,181,0,1,0
20,421,421,54,54,0,1,0
27,425,425,111,111,0,1,0
17,438,438,10,10,0,1,0
21,444,444,22,1,21,4,3
33,476,476,46,46,0,1,0
16,480,480,14,3,11,2,1
22,484,484,64,14,50,3,2
1,486,486,137,10,127,4,3
18,491,491,7,7,0,1,0
31,499,499,14,10,4,2,1

8,115,115,9,9,0,1,0
22,116,116,7,1,6,2,1
21,128,128,3,3,0,1,0
19,130,130,8,8,0,1,0
4,133,133,3,3,0,1,0
28,149,149,57,57,0,1,0
31,162,162,48,48,0,1,0
1,200,200,9,2,7,2,1
13,213,213,21,21,0,1,0
10,238,238,17,4,13,2,1
15,245,245,12,12,0,1,0
14,251,251,31,23,8,2,1
11,252,252,8,8,0,1,0
17,252,252,10,3,7,2,1
9,315,315,83,83,0,1,0
29,331,331,63,48,15,4,3
24,350,350,30,18,12,2,1
23,355,355,31,31,0,1,0
5,363,363,31,31,0,1,0
26,379,379,26,26,0,1,0
2,380,380,106,81,25,3,2
0,385,385,24,24,0,1,0
18,386,386,11,2,9,2,1
30,393,393,14,14,0,1,0
3,417,417,78,78,0,1,0
32,419,419,41,41,0,1,0
16,423,423,20,9,11,2,1
27,427,427,23,14,9,4,3
20,436,436,47,13,34,2,1
7,439,439,126,126,0,1,0
6,447,447,26,26,0,1,0
12,468,468,51,51,0,1,0
25,490,490,61,28,33,2,1

6,101,101,9,9,0,1,0
24,137,137,6,6,0,1,0
17,149,149,51,51,0,1,0
27,201,201,5,5,0,1,0
31,206,206,50,50,0,1,0
15,212,212,17,17,0,1,0
11,216,216,1,1,0,1,0
7,234,234,5,5,0,1,0
5,236,236,20,20,0,1,0
18,239,239,51,38,13,2,1
35,243,243,46,46,0,1,0
23,250,250,1,1,0,1,0
19,250,250,18,10,8,2,1
0,253,253,1,1,0,1,0
29,257,257,9,9,0,1,0
1,311,311,13,13,0,1,0
30,338,338,24,24,0,1,0
22,342,342,9,4,5,2,1
36,342,342,52,14,38,4,3
3,357,357,23,23,0,1,0
12,360,360,22,22,0,1,0
10,361,361,1,1,0,1,0
4,367,367,25,17,8,3,2
13,375,375,105,99,6,2,1
32,376,376,71,49,22,4,3
25,377,377,16,10,6,3,2
16,383,383,10,4,6,3,2
34,385,385,13,13,0,1,0
8,397,397,60,14,46,2,1
9,399,399,1,1,0,1,0
26,423,423,38,23,15,4,3
33,424,424,18,18,0,1,0
28,428,428,142,109,33,4,3
2,430,430,30,8,22,2,1
21,467,467,59,59,0,1,0
14,471,471,92,92,0,1,0
20,492,492,61,4,57,4,3

3,110,110,5,5,0,1,0
19,111,111,25,12,13,4,3
25,121,121,22,13,9,2,1
1,147,147,22,22,0,1,0
10,164,164,20,17,3,2,1
12,202,202,5,5,0,1,0
0,203,203,15,15,0,1,0
22,210,210,15,10,5,2,1
7,213,213,70,70,0,1,0
13,229,229,26,26,0,1,0
30,235,235,39,39,0,1,0
6,242,242,49,22,27,3,2
21,285,285,9,9,0,1,0
26,291,291,7,7,0,1,0
24,299,299,17,6,11,2,1
23,300,300,12,3,9,2,1
20,302,302,41,9,32,2,1
15,318,318,32,32,0,1,0
31,333,333,82,37,45,4,3
29,345,345,65,29,36,3,2
27,357,357,6,2,4,2,1
11,369,369,14,14,0,1,0
28,380,380,46,29,17,4,3
33,393,393,63,63,0,1,0
17,393,393,50,34,16,2,1
14,396,396,20,20,0,1,0
32,405,405,4,1,3,2,1
8,438,438,72,18,54,4,3
9,448,448,21,2,19,2,1
4,451,451,59,10,49,2,1
16,491,491,1,1,0,1,0
5,491,491,43,43,0,1,0
2,491,491,60,28,32,3,2
18,494,494,11,11,0,1,0

25,108,108,5,5,0,1,0
27,126,126,1,1,0,1,0
17,127,127,19,10,9,4,3
7,149,149,3,3,0,1,0
20,160,160,2,2,0,1,0
0,180,180,14,1,13,2,1
6,194,194,24,19,5,2,1
31,224,224,46,34,12,3,2
18,227,227,13,13,0,1,0
22,231,231,33,33,0,1,0
23,243,243,19,12,7,2,1
29,244,244,17,9,8,3,2
12,252,252,1,1,0,1,0
1,256,256,24,3,21,4,3
4,268,268,24,24,0,1,0
16,280,280,19,13,6,2,1
15,281,281,26,5,21,4,3
14,290,290,63,63,0,1,0
11,298,298,37,1,36,2,1
10,303,303,37,37,0,1,0
8,332,332,32,32,0,1,0
24,363,363,26,26,0,1,0
26,387,387,53,53,0,1,0
19,399,399,41,13,28,3,2
3,421,421,40,40,0,1,0
9,424,424,72,18,54,3,2
30,440,440,36,36,0,1,0
21,453,453,182,160,22,3,2
28,454,454,28,25,3,2,1
2,469,469,212,212,0,1,0
32,483,483,25,1,24,3,2
5,489,489,3,3,0,1,0
13,494,494,54,51,3,2,1

13,113,113,47,47,0,1,0
9,139,139,22,22,0,1,0
11,143,143,34,26,8,2,1
18,156,156,32,32,0,1,0
20,159,159,19,3,16,4,3
8,200,200,8,8,0,1,0
1,202,202,25,7,18,4,3
24,209,209,13,1,12,4,3
7,213,213,10,10,0,1,0
29,234,234,3,3,0,1,0
19,274,274,13,13,0,1,0
17,282,282,2,2,0,1,0
23,292,292,3,3,0,1,0
0,310,310,1,1,0,1,0
28,322,322,149,104,45,4,3
15,322,322,2,2,0,1,0
27,347,347,17,17,0,1,0
12,347,347,29,29,0,1,0
3,347,347,102,79,23,2,1
14,348,348,43,19,24,4,3
25,349,349,17,8,9,4,3
30,357,357,28,1,27,4,3
2,382,382,78,41,37,4,3
6,403,403,183,183,0,1,0
21,405,405,58,58,0,1,0
26,411,411,2,2,0,1,0
16,427,427,4,1,3,2,1
5,443,443,42,2,40,3,2
10,463,463,17,17,0,1,0
4,472,472,11,11,0,1,0
22,477,477,14,11,3,2,1

26,100,100,6,6,0,1,0
1,100,100,4,4,0,1,0
23,103,103,2,2,0,1,0
28,117,117,8,2,6,3,2
8,118,118,1,1,0,1,0
4,120,120,19,19,0,1,0
9,177,177,25,25,0,1,0
20,199,199,42,42,0,1,0
0,204,204,14,14,0,1,0
24,204,204,67,67,0,1,0
30,218,218,26,19,7,2,1
16,233,233,39,4,35,2,1
2,261,261,10,2,8,3,2
21,278,278,31,31,0,1,0
11,281,281,62,62,0,1,0
14,292,292,38,24,14,2,1
6,299,299,21,21,0,1,0
19,301,301,4,1,3,2,1
12,326,326,27,27,0,1,0
17,343,343,8,2,6,3,2
5,368,368,20,20,0,1,0
18,396,396,2,2,0,1,0
22,412,412,17,17,0,1,0
3,414,414,53,41,12,2,1
25,428,428,48,48,0,1,0
29,433,433,49,49,0,1,0
15,444,444,78,78,0,1,0
13,450,450,7,7,0,1,0
10,452,452,124,84,40,3,2
7,483,483,249,208,41,3,2
27,488,488,56,56,0,1,0

35,100,100,22,13,9,2,1
22,138,138,3,3,0,1,0
9,169,169,1,1,0,1,0
4,183,183,8,8,0,1,0
34,184,184,12,12,0,1,0
30,190,190,32,32,0,1,0
6,198,198,7,7,0,1,0
3,215,215,13,13,0,1,0
40,219,219,5,5,0,1,0
20,219,219,1,1,0,1,0
7,233,233,1,1,0,1,0
11,234,234,5,5,0,1,0
13,243,243,2,2,0,1,0
27,243,243,16,9,7,2,1
2,245,245,12,12,0,1,0
15,254,254,3,3,0,1,0
16,256,256,89,22,67,3,2
1,265,265,15,15,0,1,0
23,277,277,45,15,30,4,3
0,292,292,129,63,66,4,3
37,307,307,18,4,14,2,1
29,314,314,9,2,7,2,1
28,318,318,17,17,0,1,0
26,325,325,68,68,0,1,0
39,329,329,15,3,12,3,2
24,336,336,54,22,32,2,1
31,339,339,49,49,0,1,0
21,348,348,1,1,0,1,0
10,349,349,116,8,108,4,3
19,359,359,4,1,3,2,1
5,360,360,12,6,6,3,2
36,368,368,19,19,0,1,0
33,377,377,85,85,0,1,0
18,388,388,43,14,29,2,1
14,408,408,22,18,4,2,1
25,431,431,18,9,9,4,3
32,458,458,5,5,0,1,0
8,470,470,17,8,9,4,3
38,478,478,45,45,0,1,0
17,480,480,1,1,0,1,0
12,495,495,52,52,0,1,0

4,101,101,2,2,0,1,0
18,116,116,1,1,0,1,0
21,120,120,4,4,0,1,0
15,133,133,3,3,0,1,0
36,150,150,3,3,0,1,0
33,183,183,15,15,0,1,0
19,189,189,12,2,10,2,1
35,191,191,9,9,0,1,0
17,195,195,40,28,12,3,2
14,211,211,30,23,7,2,1
26,215,215,15,15,0,1,0
31,223,223,2,2,0,1,0
9,232,232,47,20,27,2,1
7,251,251,2,2,0,1,0
2,252,252,21,21,0,1,0
20,273,273,89,59,30,2,1
6,283,283,10,10,0,1,0
12,298,298,12,1,11,2,1
8,310,310,92,59,33,2,1
10,328,328,3,3,0,1,0
34,329,329,15,15,0,1,0
32,334,334,17,7,10,2,1
13,362,362,23,5,18,3,2
37,363,363,108,26,82,4,3
22,371,371,29,29,0,1,0
1,380,380,6,6,0,1,0
30,388,388,42,27,15,2,1
24,392,392,89,50,39,4,3
11,399,399,95,47,48,2,1
5,405,405,35,13,22,2,1
3,410,410,65,27,38,3,2
27,429,429,43,23,20,3,2
25,461,461,24,24,0,1,0
29,464,464,40,16,24,3,2
0,464,464,13,13,0,1,0
16,467,467,36,8,28,3,2
23,479,479,50,2,48,3,2
28,488,488,50,36,14,3,2

22,112,112,3,3,0,1,0
23,113,113,1,1,0,1,0
19,116,116,2,2,0,1,0
34,136,136,6,6,0,1,0
2,150,150,18,18,0,1,0
14,150,150,36,11,25,3,2
5,155,155,3,3,0,1,0
27,201,201,5,2,3,2,1
28,205,205,35,5,30,3,2
36,220,220,47,8,39,4,3
7,227,227,24,24,0,1,0
4,231,231,12,2,10,2,1
17,261,261,5,5,0,1,0
10,268,268,15,15,0,1,0
39,268,268,72,72,0,1,0
0,277,277,83,40,43,3,2
18,283,283,26,26,0,1,0
1,284,284,32,32,0,1,0
8,292,292,4,1,3,2,1
11,300,300,23,4,19,4,3
12,303,303,22,6,16,2,1
21,307,307,4,4,0,1,0
20,316,316,11,11,0,1,0
33,317,317,53,14,39,4,3
37,320,320,18,8,10,3,2
24,335,335,22,4,18,4,3
40,337,337,134,80,54,3,2
13,343,343,11,11,0,1,0
26,351,351,30,3,27,2,1
6,359,359,17,17,0,1,0
32,397,397,10,7,3,2,1
35,413,413,23,17,6,3,2
16,414,414,34,9,25,4,3
31,417,417,18,9,9,2,1
3,426,426,50,30,20,3,2
9,437,437,9,2,7,2,1
38,439,439,54,5,49,2,1
15,441,441,59,59,0,1,0
25,466,466,17,10,7,2,1
29,488,488,21,3,18,4,3
30,494,494,1,1,0,1,0

36,107,107,12,2,10,3,2
31,121,121,22,10,12,4,3
19,152,152,1,1,0,1,0
11,159,159,2,2,0,1,0
29,163,163,4,4,0,1,0
1,170,170,25,5,20,2,1
3,173,173,4,4,0,1,0
16,190,190,4,4,0,1,0
24,192,192,12,12,0,1,0
32,195,195,20,20,0,1,0
26,200,200,16,16,0,1,0
10,225,225,37,9,28,2,1
30,228,228,12,12,0,1,0
41,239,239,14,4,10,2,1
13,252,252,4,4,0,1,0
33,259,259,5,5,0,1,0
7,274,274,43,15,28,3,2
5,278,278,18,12,6,3,2
14,292,292,13,13,0,1,0
20,292,292,19,19,0,1,0
39,301,301,24,24,0,1,0
0,322,322,1,1,0,1,0
15,322,322,5,2,3,2,1
27,328,328,104,104,0,1,0
34,339,339,19,1,18,2,1
22,343,343,74,10,64,3,2
9,356,356,1,1,0,1,0
6,365,365,18,18,0,1,0
18,367,367,7,7,0,1,0
42,368,368,34,23,11,2,1
35,374,374,51,45,6,2,1
44,380,380,31,15,16,4,3
4,393,393,50,7,43,2,1
8,396,396,1,1,0,1,0
23,398,398,1,1,0,1,0
2,429,429,20,20,0,1,0
21,435,435,51,19,32,2,1
17,443,443,87,65,22,3,2
37,454,454,61,46,15,4,3
28,460,460,89,89,0,1,0
12,472,472,25,25,0,1,0
25,473,473,40,10,30,3,2
43,475,475,10,4,6,2,1
38,477,477,3,3,0,1,0
40,494,494,80,80,0,1,0

24,101,101,5,1,4,2,1
20,103,103,3,3,0,1,0
18,150,150,29,29,0,1,0
27,160,160,10,10,0,1,0
6,162,162,33,17,16,3,2
11,183,183,15,15,0,1,0
7,188,188,4,1,3,2,1
8,190,190,29,29,0,1,0
22,202,202,4,1,3,2,1
3,232,232,11,3,8,3,2
23,250,250,43,18,25,3,2
19,252,252,6,6,0,1,0
15,260,260,1,1,0,1,0
9,263,263,97,97,0,1,0
14,270,270,17,17,0,1,0
16,277,277,48,15,33,4,3
1,278,278,75,46,29,2,1
4,333,333,5,5,0,1,0
12,374,374,22,22,0,1,0
28,374,374,11,5,6,2,1
17,385,385,16,9,7,2,1
0,397,397,80,80,0,1,0
21,423,423,124,73,51,4,3
25,431,431,20,10,10,3,2
13,443,443,45,4,41,2,1
5,451,451,70,37,33,4,3
26,455,455,178,120,58,3,2
2,485,485,125,51,74,3,2
10,499,499,54,22,32,4,3

44,109,109,1,1,0,1,0
38,117,117,1,1,0,1,0
37,132,132,23,23,0,1,0
14,138,138,5,5,0,1,0
47,161,161,4,1,3,2,1
40,162,162,34,34,0,1,0
35,169,169,6,6,0,1,0
43,170,170,19,10,9,4,3
0,173,173,1,1,0,1,0
10,176,176,10,10,0,1,0
6,177,177,23,23,0,1,0
16,178,178,16,1,15,2,1
45,196,196,35,35,0,1,0
13,199,199,30,30,0,1,0
50,204,204,16,16,0,1,0
4,209,209,1,1,0,1,0
26,221,221,8,8,0,1,0
15,231,231,6,6,0,1,0
20,239,239,6,6,0,1,0
19,243,243,1,1,0,1,0
49,248,248,11,1,10,2,1
34,249,249,14,14,0,1,0
17,251,251,2,2,0,1,0
42,282,282,131,97,34,3,2
21,302,302,1,1,0,1,0
5,319,319,32,32,0,1,0
39,329,329,21,9,12,4,3
32,331,331,7,1,6,2,1
11,335,335,25,25,0,1,0
29,340,340,33,8,25,2,1
12,362,362,90,90,0,1,0
48,372,372,34,7,27,4,3
33,389,389,5,1,4,2,1
2,395,395,6,6,0,1,0
27,398,398,19,19,0,1,0
18,401,401,2,2,0,1,0
7,404,404,41,41,0,1,0
41,409,409,19,5,14,2,1
23,411,411,4,4,0,1,0
8,415,415,2,2,0,1,0
28,421,421,12,12,0,1,0
25,425,425,1,1,0,1,0
3,429,429,16,16,0,1,0
9,457,457,41,41,0,1,0
46,460,460,77,77,0,1,0
22,461,461,28,4,24,3,2
30,472,472,69,63,6,3,2
31,478,478,7,7,0,1,0
36,481,481,27,27,0,1,0
1,482,482,15,10,5,2,1
24,493,493,44,4,40,3,2

0,104,104,9,9,0,1,0
15,124,124,6,6,0,1,0
31,128,128,25,11,14,3,2
10,129,129,3,3,0,1,0
16,145,145,14,3,11,4,3
19,156,156,8,8,0,1,0
2,160,160,12,12,0,1,0
21,167,167,5,5,0,1,0
24,180,180,50,17,33,4,3
8,214,214,39,39,0,1,0
6,216,216,1,1,0,1,0
28,223,223,99,99,0,1,0
27,225,225,6,6,0,1,0
18,243,243,1,1,0,1,0
3,248,248,1,1,0,1,0
17,254,254,12,6,6,3,2
11,258,258,46,36,10,2,1
7,293,293,40,12,28,2,1
33,315,315,40,40,0,1,0
25,332,332,7,3,4,2,1
32,358,358,46,32,14,2,1
35,369,369,24,24,0,1,0
29,375,375,7,7,0,1,0
23,389,389,24,24,0,1,0
30,394,394,15,15,0,1,0
1,402,402,172,76,96,3,2
4,406,406,68,68,0,1,0
5,419,419,26,26,0,1,0
22,423,423,12,3,9,4,3
9,437,437,29,29,0,1,0
12,465,465,34,34,0,1,0
26,470,470,59,2,57,3,2
20,476,476,18,18,0,1,0
14,481,481,24,24,0,1,0
13,482,482,34,5,29,2,1
34,491,491,71,71,0,1,0

12,101,101,25,25,0,1,0
5,101,101,6,6,0,1,0
25,120,120,16,16,0,1,0
8,148,148,31,1,30,3,2
27,166,166,9,1,8,2,1
22,182,182,13,13,0,1,0
7,186,186,5,5,0,1,0
6,199,199,46,28,18,4,3
21,222,222,43,33,10,3,2
16,227,227,16,16,0,1,0
13,234,234,40,28,12,3,2
1,241,241,48,48,0,1,0
26,256,256,3,3,0,1,0
30,263,263,43,43,0,1,0
28,282,282,18,1,17,2,1
31,286,286,14,14,0,1,0
15,290,290,7,7,0,1,0
2,309,309,28,20,8,2,1
17,310,310,99,99,0,1,0
19,315,315,29,29,0,1,0
20,315,315,16,8,8,3,2
34,322,322,32,32,0,1,0
11,331,331,20,20,0,1,0
4,332,332,33,19,14,2,1
0,375,375,1,1,0,1,0
33,382,382,22,22,0,1,0
9,394,394,29,29,0,1,0
32,400,400,40,40,0,1,0
14,401,401,20,20,0,1,0
29,401,401,16,7,9,2,1
3,411,411,66,57,9,2,1
24,441,441,4,4,0,1,0
18,460,460,116,60,56,4,3
23,467,467,34,7,27,4,3
10,496,496,13,13,0,1,0

5,102,102,6,6,0,1,0
25,113,113,2,2,0,1,0
37,129,129,14,14,0,1,0
24,130,130,10,10,0,1,0
4,152,152,30,30,0,1,0
28,159,159,30,22,8,2,1
16,179,179,30,12,18,4,3
7,192,192,1,1,0,1,0
27,210,210,11,1,10,3,2
12,213,213,57,17,40,4,3
17,229,229,8,2,6,2,1
31,234,234,20,20,0,1,0
13,263,263,1,1,0,1,0
3,266,266,7,7,0,1,0
14,267,267,20,6,14,3,2
19,277,277,6,6,0,1,0
38,287,287,36,15,21,4,3
36,305,305,107,107,0,1,0
20,306,306,45,45,0,1,0
10,310,310,1,1,0,1,0
11,329,329,41,6,35,2,1
29,339,339,20,10,10,2,1
6,342,342,14,14,0,1,0
26,372,372,36,16,20,3,2
33,376,376,10,1,9,4,3
21,384,384,52,52,0,1,0
1,385,385,16,5,11,2,1
22,390,390,1,1,0,1,0
2,391,391,8,4,4,2,1
35,402,402,1,1,0,1,0
18,410,410,23,23,0,1,0
23,417,417,8,2,6,3,2
15,417,417,134,134,0,1,0
30,418,418,34,34,0,1,0
9,428,428,9,9,0,1,0
0,462,462,30,30,0,1,0
8,464,464,48,12,36,2,1
34,465,465,187,187,0,1,0
32,494,494,3,3,0,1,0

1,128,128,10,2,8,3,2
25,146,146,9,1,8,3,2
12,163,163,1,1,0,1,0
6,200,200,13,13,0,1,0
27,200,200,12,5,7,2,1
19,213,213,43,43,0,1,0
15,215,215,69,69,0,1,0
5,222,222,32,32,0,1,0
4,223,223,35,5,30,2,1
11,253,253,20,8,12,4,3
18,258,258,19,19,0,1,0
26,284,284,18,10,8,2,1
23,313,313,52,16,36,4,3
2,326,326,7,7,0,1,0
21,330,330,79,31,48,3,2
28,347,347,48,48,0,1,0
10,358,358,17,17,0,1,0
8,364,364,95,26,69,4,3
7,368,368,250,200,50,2,1
14,372,372,53,53,0,1,0
3,374,374,24,3,21,2,1
20,381,381,1,1,0,1,0
9,403,403,14,4,10,2,1
17,418,418,23,8,15,4,3
24,437,437,50,50,0,1,0
22,442,442,22,22,0,1,0
13,443,443,16,16,0,1,0
16,464,464,10,2,8,2,1
0,476,476,118,118,0,1,0

22,121,121,18,12,6,2,1
1,125,125,4,4,0,1,0
29,133,133,11,11,0,1,0
12,139,139,1,1,0,1,0
0,139,139,11,11,0,1,0
41,156,156,13,5,8,3,2
10,177,177,3,3,0,1,0
20,184,184,13,10,3,2,1
39,193,193,20,20,0,1,0
6,197,197,7,1,6,3,2
38,205,205,44,44,0,1,0
21,208,208,17,17,0,1,0
25,220,220,30,9,21,4,3
19,220,220,14,14,0,1,0
31,229,229,6,6,0,1,0
11,234,234,12,12,0,1,0
43,248,248,9,9,0,1,0
26,249,249,10,10,0,1,0
17,262,262,46,37,9,4,3
7,267,267,26,17,9,4,3
32,267,267,2,2,0,1,0
9,277,277,1,1,0,1,0
35,281,281,15,15,0,1,0
28,286,286,44,17,27,2,1
16,288,288,3,3,0,1,0
13,292,292,26,6,20,2,1
18,331,331,4,4,0,1,0
3,338,338,65,43,22,2,1
23,359,359,1,1,0,1,0
34,365,365,97,84,13,2,1
37,379,379,1,1,0,1,0
2,380,380,26,15,11,2,1
5,388,388,38,38,0,1,0
8,399,399,11,1,10,2,1
27,408,408,22,7,15,4,3
36,416,416,47,47,0,1,0
24,428,428,8,8,0,1,0
40,436,436,101,73,28,2,1
15,440,440,14,14,0,1,0
14,442,442,66,66,0,1,0
33,446,446,69,40,29,2,1
42,450,450,78,78,0,1,0
30,458,458,20,20,0,1,0
4,460,460,46,46,0,1,0

0,127,127,29,22,7,2,1
14,129,129,15,3,12,4,3
2,140,140,17,17,0,1,0
19,154,154,16,7,9,2,1
9,163,163,5,5,0,1,0
7,173,173,48,48,0,1,0
21,173,173,21,11,10,3,2
3,179,179,18,18,0,1,0
28,191,191,29,29,0,1,0
12,194,194,56,34,22,3,2
11,215,215,14,4,10,2,1
5,227,227,4,4,0,1,0
24,235,235,1,1,0,1,0
1,239,239,26,6,20,3,2
8,265,265,58,58,0,1,0
17,293,293,3,3,0,1,0
27,305,305,63,63,0,1,0
13,315,315,50,17,33,2,1
18,328,328,45,45,0,1,0
6,360,360,145,81,64,3,2
4,375,375,11,5,6,3,2
29,376,376,65,62,3,2,1
15,404,404,29,29,0,1,0
23,421,421,14,14,0,1,0
26,422,422,40,40,0,1,0
16,423,423,40,40,0,1,0
25,441,441,17,17,0,1,0
20,450,450,17,17,0,1,0
22,453,453,1,1,0,1,0
10,484,484,98,98,0,1,0

2,127,127,11,2,9,4,3
17,137,137,20,20,0,1,0
14,149,149,30,12,18,3,2
9,155,155,15,4,11,2,1
11,162,162,22,12,10,3,2
0,185,185,9,9,0,1,0
21,196,196,12,4,8,3,2
5,201,201,37,28,9,2,1
27,219,219,18,1,17,2,1
12,221,221,5,5,0,1,0
16,231,231,8,5,3,2,1
19,234,234,32,32,0,1,0
13,247,247,8,8,0,1,0
7,274,274,10,10,0,1,0
20,283,283,70,66,4,2,1
30,316,316,11,11,0,1,0
28,340,340,11,11,0,1,0
8,350,350,33,15,18,4,3
6,359,359,28,7,21,2,1
1,370,370,68,53,15,2,1
32,372,372,31,31,0,1,0
10,383,383,63,63,0,1,0
33,395,395,49,17,32,2,1
18,396,396,7,1,6,2,1
4,404,404,117,117,0,1,0
26,408,408,8,8,0,1,0
22,418,418,16,16,0,1,0
29,441,441,158,150,8,2,1
23,451,451,78,22,56,4,3
15,456,456,5,5,0,1,0
3,468,468,63,17,46,3,2
25,470,470,60,60,0,1,0
24,486,486,7,7,0,1,0
31,500,500,47,47,0,1,0

4,100,100,3,3,0,1,0
3,105,105,23,23,0,1,0
17,108,108,14,14,0,1,0
13,114,114,13,13,0,1,0
27,127,127,5,5,0,1,0
24,132,132,32,5,27,2,1
6,141,141,5,5,0,1,0
23,142,142,10,5,5,2,1
20,152,152,22,22,0,1,0
11,195,195,1,1,0,1,0
8,199,199,4,4,0,1,0
7,215,215,24,16,8,3,2
16,251,251,81,81,0,1,0
19,280,280,6,6,0,1,0
32,287,287,27,13,14,3,2
25,291,291,6,6,0,1,0
15,301,301,85,85,0,1,0
21,303,303,12,12,0,1,0
5,336,336,28,28,0,1,0
28,354,354,1,1,0,1,0
18,358,358,2,2,0,1,0
12,401,401,27,27,0,1,0
9,408,408,2,2,0,1,0
14,427,427,33,33,0,1,0
2,439,439,364,364,0,1,0
31,451,451,60,60,0,1,0
29,456,456,16,16,0,1,0
1,474,474,17,17,0,1,0
22,480,480,94,4,90,4,3
10,481,481,43,16,27,2,1
0,487,487,38,31,7,2,1
30,488,488,26,26,0,1,0
26,493,493,1,1,0,1,0

17,110,110,1,1,0,1,0
31,121,121,2,2,0,1,0
25,144,144,4,4,0,1,0
28,155,155,35,35,0,1,0
16,161,161,20,11,9,2,1
43,167,167,1,1,0,1,0
2,172,172,2,2,0,1,0
42,175,175,37,37,0,1,0
21,177,177,6,2,4,2,1
5,184,184,1,1,0,1,0
24,191,191,53,53,0,1,0
12,195,195,2,2,0,1,0
41,198,198,38,21,17,2,1
23,201,201,20,11,9,2,1
8,208,208,1,1,0,1,0
0,209,209,5,5,0,1,0
39,209,209,8,8,0,1,0
19,210,210,15,15,0,1,0
29,211,211,15,9,6,2,1
3,211,211,10,10,0,1,0
37,231,231,27,12,15,2,1
36,238,238,29,29,0,1,0
34,242,242,4,1,3,2,1
6,260,260,11,11,0,1,0
22,281,281,78,78,0,1,0
38,302,302,47,47,0,1,0
26,310,310,2,2,0,1,0
11,310,310,1,1,0,1,0
40,311,311,20,20,0,1,0
1,337,337,3,3,0,1,0
32,359,359,19,3,16,3,2
45,376,376,25,7,18,2,1
9,376,376,18,6,12,2,1
35,383,383,31,31,0,1,0
20,400,400,16,16,0,1,0
10,405,405,42,42,0,1,0
27,456,456,31,11,20,3,2
13,468,468,8,8,0,1,0
18,472,472,40,40,0,1,0
30,476,476,44,38,6,2,1
7,479,479,108,108,0,1,0
15,480,480,8,8,0,1,0
44,480,480,7,7,0,1,0
14,486,486,17,8,9,2,1
4,492,492,38,26,12,4,3
33,495,495,147,147,0,1,0

7,105,105,12,12,0,1,0
20,107,107,9,9,0,1,0
19,116,116,26,26,0,1,0
4,117,117,16,16,0,1,0
0,119,119,8,8,0,1,0
10,140,140,17,17,0,1,0
28,141,141,11,3,8,2,1
3,159,159,36,20,16,2,1
26,183,183,28,28,0,1,0
11,185,185,19,14,5,2,1
27,204,204,6,6,0,1,0
33,214,214,12,8,4,2,1
24,220,220,11,11,0,1,0
8,226,226,8,8,0,1,0
21,243,243,1,1,0,1,0
35,245,245,27,9,18,3,2
2,251,251,22,17,5,2,1
36,259,259,35,35,0,1,0
5,293,293,19,11,8,2,1
17,311,311,22,22,0,1,0
9,314,314,6,2,4,2,1
22,319,319,4,4,0,1,0
13,334,334,2,2,0,1,0
18,334,334,19,19,0,1,0
29,340,340,83,83,0,1,0
15,343,343,26,26,0,1,0
32,348,348,72,72,0,1,0
34,352,352,34,34,0,1,0
23,360,360,4,4,0,1,0
1,364,364,76,2,74,3,2
6,403,403,88,88,0,1,0
30,439,439,46,29,17,2,1
31,442,442,95,95,0,1,0
14,455,455,29,21,8,2,1
25,477,477,12,12,0,1,0
16,481,481,13,4,9,2,1
12,491,491,49,49,0,1,0

13,105,105,7,7,0,1,0
20,132,132,37,37,0,1,0
12,154,154,16,16,0,1,0
27,182,182,12,12,0,1,0
10,186,186,21,21,0,1,0
31,213,213,66,12,54,4,3
0,215,215,5,5,0,1,0
9,229,229,22,22,0,1,0
3,250,250,4,4,0,1,0
15,252,252,1,1,0,1,0
25,253,253,32,32,0,1,0
18,256,256,31,17,14,3,2
14,312,312,52,52,0,1,0
26,329,329,3,3,0,1,0
30,333,333,1,1,0,1,0
28,347,347,38,2,36,2,1
1,360,360,32,32,0,1,0
21,375,375,21,10,11,2,1
7,376,376,14,14,0,1,0
22,384,384,19,12,7,2,1
4,403,403,59,55,4,2,1
29,414,414,31,27,4,2,1
17,422,422,20,6,14,2,1
24,428,428,70,34,36,3,2
8,432,432,20,1,19,3,2
11,436,436,216,179,37,3,2
2,440,440,43,43,0,1,0
16,443,443,53,43,10,2,1
19,464,464,82,50,32,3,2
6,464,464,113,53,60,4,3
5,471,471,29,29,0,1,0
32,486,486,22,2,20,3,2
23,487,487,31,5,26,3,2

22,110,110,12,9,3,2,1
3,126,126,11,1,10,2,1
11,133,133,4,4,0,1,0
13,145,145,4,4,0,1,0
35,159,159,3,3,0,1,0
15,163,163,19,5,14,2,1
9,165,165,15,15,0,1,0
1,177,177,1,1,0,1,0
27,178,178,48,48,0,1,0
24,180,180,24,15,9,2,1
10,194,194,32,32,0,1,0
19,197,197,1,1,0,1,0
31,197,197,55,31,24,4,3
28,203,203,3,3,0,1,0
12,208,208,7,2,5,2,1
37,210,210,55,55,0,1,0
14,217,217,5,2,3,2,1
21,227,227,17,11,6,2,1
16,249,249,73,73,0,1,0
34,250,250,1,1,0,1,0
8,252,252,21,21,0,1,0
40,254,254,35,35,0,1,0
18,268,268,1,1,0,1,0
29,277,277,3,3,0,1,0
26,278,278,26,26,0,1,0
17,283,283,14,8,6,3,2
30,291,291,8,4,4,2,1
4,334,334,29,29,0,1,0
6,353,353,21,18,3,2,1
23,355,355,5,5,0,1,0
2,362,362,27,9,18,3,2
25,380,380,20,20,0,1,0
38,391,391,13,13,0,1,0
0,394,394,23,23,0,1,0
7,397,397,77,5,72,3,2
5,446,446,27,27,0,1,0
36,450,450,10,3,7,2,1
32,476,476,105,7,98,3,2
20,484,484,34,7,27,4,3
39,496,496,35,35,0,1,0
33,500,500,83,33,50,4,3

29,100,100,13,3,10,3,2
34,109,109,4,4,0,1,0
28,114,114,10,10,0,1,0
17,135,135,2,2,0,1,0
14,141,141,2,2,0,1,0
0,163,163,6,2,4,2,1
4,191,191,38,27,11,2,1
16,197,197,4,4,0,1,0
23,202,202,2,2,0,1,0
7,207,207,46,31,15,2,1
31,214,214,14,4,10,2,1
8,217,217,2,2,0,1,0
5,227,227,20,10,10,2,1
35,238,238,5,5,0,1,0
25,238,238,29,29,0,1,0
22,239,239,2,2,0,1,0
36,259,259,34,34,0,1,0
32,263,263,3,3,0,1,0
27,265,265,7,7,0,1,0
26,270,270,86,86,0,1,0
21,296,296,12,12,0,1,0
2,324,324,20,2,18,2,1
3,336,336,4,4,0,1,0
20,337,337,2,2,0,1,0
24,362,362,38,29,9,4,3
12,381,381,1,1,0,1,0
6,385,385,116,62,54,4,3
18,386,386,82,82,0,1,0
9,386,386,28,7,21,4,3
15,386,386,46,46,0,1,0
1,392,392,25,3,22,3,2
11,436,436,8,8,0,1,0
13,440,440,145,97,48,3,2
19,446,446,67,5,62,3,2
10,469,469,1,1,0,1,0
33,475,475,70,70,0,1,0
30,479,479,202,202,0,1,0

45,111,111,4,4,0,1,0
17,130,130,21,21,0,1,0
3,137,137,7,1,6,3,2
22,144,144,3,3,0,1,0
41,145,145,8,8,0,1,0
34,155,155,23,11,12,3,2
32,167,167,16,16,0,1,0
14,190,190,26,26,0,1,0
1,191,191,7,7,0,1,0
26,196,196,7,7,0,1,0
4,226,226,19,13,6,2,1
36,236,236,14,9,5,2,1
25,239,239,20,20,0,1,0
28,244,244,13,13,0,1,0
18,247,247,4,1,3,2,1
24,250,250,11,11,0,1,0
27,263,263,18,7,11,2,1
30,273,273,8,8,0,1,0
5,275,275,47,1,46,3,2
8,276,276,1,1,0,1,0
11,287,287,49,8,41,2,1
12,292,292,42,33,9,2,1
20,294,294,33,29,4,2,1
16,300,300,30,8,22,2,1
15,315,315,15,15,0,1,0
9,332,332,8,8,0,1,0
13,370,370,12,12,0,1,0
29,377,377,102,79,23,2,1
10,378,378,5,1,4,2,1
37,380,380,38,34,4,2,1
7,386,386,13,1,12,2,1
35,393,393,12,12,0,1,0
42,413,413,110,23,87,4,3
31,416,416,5,5,0,1,0
38,416,416,92,58,34,3,2
39,422,422,17,6,11,2,1
6,432,432,21,6,15,2,1
19,434,434,6,6,0,1,0
33,436,436,27,17,10,2,1
40,450,450,48,9,39,2,1
2,452,452,7,7,0,1,0
43,464,464,13,13,0,1,0
23,477,477,17,17,0,1,0
44,479,479,108,108,0,1,0
21,489,489,20,3,17,2,1
0,489,489,28,5,23,3,2

35,100,100,17,9,8,3,2
28,101,101,1,1,0,1,0
8,102,102,15,2,13,2,1
33,108,108,4,4,0,1,0
21,117,117,6,6,0,1,0
34,119,119,19,7,12,4,3
26,123,123,8,8,0,1,0
31,126,126,23,11,12,3,2
19,143,143,9,9,0,1,0
11,162,162,2,2,0,1,0
3,182,182,3,3,0,1,0
39,184,184,27,3,24,3,2
23,209,209,16,16,0,1,0
29,214,214,3,3,0,1,0
14,215,215,52,6,46,2,1
10,230,230,36,36,0,1,0
7,240,240,4,4,0,1,0
41,242,242,39,27,12,4,3
22,251,251,22,16,6,3,2
24,266,266,2,2,0,1,0
13,280,280,89,51,38,2,1
30,310,310,17,4,13,4,3
37,310,310,56,56,0,1,0
36,321,321,1,1,0,1,0
40,331,331,6,6,0,1,0
2,347,347,4,4,0,1,0
18,359,359,19,1,18,4,3
16,360,360,10,10,0,1,0
0,370,370,35,19,16,2,1
25,373,373,110,10,100,3,2
4,375,375,5,5,0,1,0
9,389,389,39,32,7,2,1
15,405,405,13,13,0,1,0
20,417,417,3,3,0,1,0
6,418,418,42,42,0,1,0
32,442,442,82,35,47,4,3
38,449,449,62,24,38,3,2
1,470,470,41,20,21,4,3
12,474,474,2,2,0,1,0
17,478,478,16,16,0,1,0
5,479,479,23,23,0,1,0
27,480,480,10,10,0,1,0

4,115,115,1,1,0,1,0
10,161,161,2,2,0,1,0
25,175,175,7,7,0,1,0
20,233,233,22,22,0,1,0
28,239,239,24,4,20,4,3
5,246,246,70,1,69,4,3
13,251,251,23,23,0,1,0
22,256,256,6,2,4,2,1
30,263,263,71,8,63,4,3
3,274,274,15,12,3,2,1
31,288,288,54,54,0,1,0
26,296,296,72,72,0,1,0
27,316,316,12,12,0,1,0
6,326,326,1,1,0,1,0
2,337,337,42,3,39,4,3
16,341,341,28,16,12,2,1
29,353,353,25,4,21,4,3
14,391,391,124,86,38,4,3
11,392,392,143,38,105,4,3
12,392,392,1,1,0,1,0
15,394,394,5,5,0,1,0
23,404,404,37,19,18,2,1
8,425,425,1,1,0,1,0
24,434,434,57,37,20,3,2
1,440,440,101,19,82,3,2
0,440,440,114,30,84,4,3
19,442,442,26,26,0,1,0
7,456,456,5,5,0,1,0
32,458,458,13,13,0,1,0
21,482,482,65,44,21,2,1
18,484,484,10,10,0,1,0
9,497,497,18,18,0,1,0
17,497,497,99,21,78,3,2

2,124,124,5,5,0,1,0
27,129,129,24,24,0,1,0
33,135,135,7,1,6,2,1
23,140,140,8,8,0,1,0
7,154,154,28,6,22,2,1
30,163,163,25,25,0,1,0
17,184,184,26,11,15,2,1
0,188,188,27,21,6,2,1
19,192,192,24,6,18,3,2
13,198,198,31,31,0,1,0
37,205,205,6,6,0,1,0
1,221,221,83,44,39,2,1
11,282,282,3,3,0,1,0
22,292,292,70,35,35,2,1
32,298,298,14,14,0,1,0
15,301,301,2,2,0,1,0
29,325,325,9,3,6,3,2
34,331,331,50,50,0,1,0
12,339,339,72,64,8,2,1
14,340,340,19,9,10,3,2
6,348,348,6,6,0,1,0
20,353,353,17,6,11,2,1
10,357,357,8,8,0,1,0
25,359,359,38,9,29,3,2
8,362,362,19,19,0,1,0
36,371,371,5,2,3,2,1
31,390,390,112,16,96,4,3
28,393,393,46,46,0,1,0
5,410,410,16,16,0,1,0
26,416,416,86,29,57,4,3
9,420,420,7,1,6,2,1
35,435,435,5,1,4,2,1
18,455,455,1,1,0,1,0
3,459,459,6,1,5,2,1
24,482,482,22,22,0,1,0
21,491,491,32,2,30,4,3
4,494,494,57,45,12,4,3
16,498,498,37,2,35,4,3

9,108,108,5,5,0,1,0
21,115,115,2,2,0,1,0
14,133,133,9,9,0,1,0
1,139,139,78,78,0,1,0
8,142,142,5,5,0,1,0
6,146,146,43,43,0,1,0
20,168,168,21,21,0,1,0
24,169,169,11,3,8,3,2
13,185,185,12,3,9,4,3
17,203,203,59,29,30,2,1
22,206,206,62,62,0,1,0
29,210,210,24,24,0,1,0
12,227,227,13,4,9,4,3
16,242,242,5,2,3,2,1
27,242,242,2,2,0,1,0
28,255,255,51,5,46,3,2
3,269,269,2,2,0,1,0
2,270,270,61,53,8,2,1
23,277,277,12,5,7,2,1
0,303,303,82,3,79,3,2
5,307,307,10,5,5,2,1
26,312,312,10,10,0,1,0
10,330,330,19,19,0,1,0
30,359,359,103,95,8,2,1
25,382,382,14,14,0,1,0
18,413,413,6,6,0,1,0
7,422,422,24,7,17,4,3
4,430,430,9,2,7,2,1
15,439,439,43,9,34,2,1
19,454,454,24,6,18,4,3
11,497,497,68,47,21,4,3

2,107,107,5,5,0,1,0
3,108,108,1,1,0,1,0
14,127,127,26,26,0,1,0
20,144,144,25,9,16,2,1
29,147,147,2,2,0,1,0
7,180,180,15,15,0,1,0
10,203,203,57,57,0,1,0
21,210,210,9,1,8,2,1
19,250,250,25,19,6,2,1
18,257,257,16,16,0,1,0
4,266,266,3,3,0,1,0
30,274,274,24,24,0,1,0
9,322,322,30,6,24,3,2
22,325,325,55,55,0,1,0
13,329,329,19,19,0,1,0
12,353,353,48,15,33,2,1
11,357,357,24,8,16,2,1
25,358,358,46,46,0,1,0
0,392,392,34,17,17,2,1
24,408,408,58,58,0,1,0
6,430,430,101,86,15,2,1
15,435,435,62,62,0,1,0
27,439,439,126,108,18,4,3
8,444,444,312,276,36,4,3
17,448,448,2,2,0,1,0
1,449,449,20,20,0,1,0
23,451,451,76,76,0,1,0
5,451,451,2,2,0,1,0
28,456,456,5,2,3,2,1
26,490,490,2,2,0,1,0
16,498,498,17,13,4,2,1

16,110,110,23,23,0,1,0
17,112,112,25,3,22,2,1
3,118,118,1,1,0,1,0
29,122,122,4,4,0,1,0
30,124,124,4,4,0,1,0
12,125,125,3,3,0,1,0
5,137,137,9,3,6,2,1
36,144,144,5,5,0,1,0
8,149,149,1,1,0,1,0
24,160,160,9,9,0,1,0
27,168,168,8,4,4,2,1
39,175,175,20,2,18,2,1
32,188,188,15,8,7,2,1
0,189,189,7,7,0,1,0
22,201,201,17,17,0,1,0
6,214,214,4,1,3,2,1
19,228,228,9,9,0,1,0
7,245,245,16,8,8,2,1
28,249,249,31,31,0,1,0
35,268,268,23,2,21,4,3
15,282,282,1,1,0,1,0
1,285,285,8,8,0,1,0
23,286,286,22,11,11,2,1
2,292,292,1,1,0,1,0
11,302,302,59,59,0,1,0
25,321,321,99,99,0,1,0
4,328,328,18,18,0,1,0
13,331,331,23,16,7,2,1
26,342,342,12,12,0,1,0
10,354,354,35,27,8,2,1
38,357,357,72,45,27,2,1
34,365,365,133,66,67,4,3
40,368,368,28,11,17,2,1
31,377,377,48,9,39,4,3
37,378,378,5,5,0,1,0
20,437,437,11,11,0,1,0
33,442,442,16,5,11,2,1
9,450,450,25,9,16,3,2
21,451,451,39,7,32,3,2
14,473,473,171,135,36,4,3
18,479,479,19,19,0,1,0

2,105,105,1,1,0,1,0
23,112,112,19,19,0,1,0
40,120,120,19,19,0,1,0
17,130,130,16,9,7,2,1
18,131,131,11,11,0,1,0
9,135,135,11,11,0,1,0
33,140,140,35,8,27,2,1
8,150,150,45,12,33,2,1
34,150,150,4,4,0,1,0
3,161,161,15,3,12,3,2
10,165,165,5,1,4,2,1
5,168,168,11,11,0,1,0
20,185,185,28,13,15,4,3
11,228,228,6,1,5,2,1
39,231,231,93,75,18,4,3
22,234,234,24,24,0,1,0
36,239,239,32,32,0,1,0
14,248,248,2,2,0,1,0
30,249,249,20,20,0,1,0
38,291,291,14,14,0,1,0
27,295,295,22,22,0,1,0
31,304,304,42,42,0,1,0
42,309,309,22,22,0,1,0
25,311,311,14,11,3,2,1
7,324,324,12,2,10,3,2
16,350,350,3,3,0,1,0
29,374,374,24,4,20,2,1
41,377,377,17,2,15,2,1
35,378,378,19,19,0,1,0
37,385,385,36,24,12,3,2
1,388,388,23,16,7,2,1
12,402,402,5,5,0,1,0
13,412,412,75,19,56,3,2
0,425,425,17,17,0,1,0
21,436,436,14,14,0,1,0
15,437,437,24,24,0,1,0
4,440,440,6,6,0,1,0
6,443,443,9,9,0,1,0
24,448,448,34,34,0,1,0
28,475,475,9,9,0,1,0
19,478,478,9,9,0,1,0
26,490,490,53,53,0,1,0
32,494,494,14,14,0,1,0

9,107,107,4,4,0,1,0
1,112,112,9,9,0,1,0
17,150,150,31,31,0,1,0
2,163,163,7,1,6,2,1
15,165,165,2,2,0,1,0
14,187,187,13,8,5,2,1
11,204,204,49,49,0,1,0
26,206,206,32,20,12,2,1
12,213,213,54,54,0,1,0
4,217,217,11,11,0,1,0
24,226,226,38,38,0,1,0
23,240,240,47,37,10,2,1
6,241,241,15,15,0,1,0
7,268,268,91,91,0,1,0
22,271,271,4,4,0,1,0
13,317,317,7,7,0,1,0
20,318,318,14,14,0,1,0
19,319,319,1,1,0,1,0
27,321,321,1,1,0,1,0
29,328,328,10,10,0,1,0
21,338,338,15,15,0,1,0
33,349,349,47,25,22,2,1
28,363,363,58,17,41,4,3
16,375,375,1,1,0,1,0
18,378,378,94,66,28,2,1
34,398,398,57,47,10,4,3
25,403,403,6,6,0,1,0
8,415,415,24,24,0,1,0
30,421,421,32,32,0,1,0
31,437,437,39,39,0,1,0
32,438,438,70,70,0,1,0
35,475,475,66,7,59,3,2
10,490,490,41,13,28,2,1
5,492,492,69,55,14,3,2
3,498,498,1,1,0,1,0
0,499,499,51,51,0,1,0

8,123,123,1,1,0,1,0
5,133,133,2,2,0,1,0
2,152,152,8,2,6,3,2
1,158,158,19,1,18,4,3
3,158,158,5,5,0,1,0
34,161,161,15,4,11,2,1
33,171,171,1,1,0,1,0
17,182,182,42,11,31,2,1
27,208,208,4,4,0,1,0
22,209,209,66,30,36,2,1
9,224,224,7,7,0,1,0
19,229,229,17,17,0,1,0
30,255,255,75,47,28,3,2
12,256,256,1,1,0,1,0
10,259,259,52,52,0,1,0
21,266,266,41,41,0,1,0
24,279,279,13,2,11,2,1
29,283,283,12,12,0,1,0
20,303,303,12,12,0,1,0
18,315,315,66,66,0,1,0
15,327,327,48,48,0,1,0
11,343,343,52,9,43,2,1
31,344,344,12,12,0,1,0
4,356,356,3,3,0,1,0
28,386,386,30,10,20,2,1
32,406,406,34,34,0,1,0
13,415,415,13,2,11,2,1
16,437,437,85,32,53,3,2
26,439,439,7,7,0,1,0
14,445,445,25,2,23,4,3
23,449,449,34,34,0,1,0
6,467,467,11,11,0,1,0
25,468,468,12,12,0,1,0
7,475,475,168,155,13,2,1
0,484,484,180,180,0,1,0

1,111,111,17,17,0,1,0
28,118,118,23,11,12,4,3
38,121,121,3,3,0,1,0
17,122,122,3,3,0,1,0
10,134,134,1,1,0,1,0
33,137,137,16,10,6,3,2
29,166,166,1,1,0,1,0
0,171,171,11,11,0,1,0
4,182,182,57,6,51,4,3
15,188,188,15,15,0,1,0
5,214,214,9,3,6,3,2
14,217,217,11,6,5,2,1
24,222,222,19,5,14,2,1
8,234,234,9,9,0,1,0
32,241,241,39,23,16,3,2
26,250,250,3,3,0,1,0
35,257,257,12,12,0,1,0
3,273,273,39,23,16,2,1
19,274,274,8,8,0,1,0
13,286,286,36,36,0,1,0
7,302,302,14,3,11,2,1
12,303,303,1,1,0,1,0
2,308,308,25,1,24,4,3
36,308,308,85,85,0,1,0
25,318,318,32,7,25,2,1
6,322,322,30,30,0,1,0
22,356,356,12,12,0,1,0
20,359,359,50,11,39,4,3
27,385,385,5,5,0,1,0
18,403,403,29,1,28,3,2
37,405,405,66,20,46,2,1
40,433,433,61,61,0,1,0
9,438,438,34,34,0,1,0
30,441,441,40,40,0,1,0
23,457,457,7,7,0,1,0
21,457,457,26,4,22,2,1
34,469,469,48,30,18,2,1
31,487,487,47,27,20,2,1
11,492,492,37,37,0,1,0
16,493,493,25,1,24,2,1
39,498,498,93,35,58,3,2

30,106,106,4,4,0,1,0
0,108,108,2,2,0,1,0
24,119,119,2,2,0,1,0
17,166,166,6,6,0,1,0
31,171,171,14,6,8,2,1
5,172,172,9,3,6,3,2
36,173,173,47,6,41,4,3
8,180,180,4,1,3,2,1
7,227,227,12,12,0,1,0
6,230,230,8,2,6,2,1
28,231,231,18,18,0,1,0
9,246,246,22,22,0,1,0
26,246,246,17,17,0,1,0
21,278,278,16,16,0,1,0
23,290,290,29,29,0,1,0
1,295,295,30,4,26,3,2
16,299,299,89,29,60,4,3
25,306,306,97,97,0,1,0
34,318,318,55,3,52,4,3
13,320,320,2,2,0,1,0
12,332,332,62,50,12,3,2
33,342,342,55,55,0,1,0
32,343,343,39,7,32,2,1
37,370,370,30,2,28,3,2
27,387,387,8,8,0,1,0
3,399,399,39,10,29,2,1
20,415,415,52,33,19,4,3
14,422,422,62,57,5,2,1
22,423,423,12,12,0,1,0
11,433,433,23,18,5,2,1
19,442,442,34,34,0,1,0
18,452,452,8,8,0,1,0
35,464,464,7,7,0,1,0
29,473,473,42,42,0,1,0
2,481,481,40,40,0,1,0
15,485,485,18,2,16,2,1
10,497,497,76,12,64,3,2
4,500,500,119,85,34,2,1

44,108,108,3,3,0,1,0
18,116,116,11,11,0,1,0
39,129,129,6,6,0,1,0
38,148,148,16,16,0,1,0
21,155,155,2,2,0,1,0
29,173,173,17,7,10,2,1
6,180,180,9,6,3,2,1
8,194,194,2,2,0,1,0
15,196,196,29,11,18,3,2
36,209,209,11,3,8,2,1
27,219,219,12,12,0,1,0
28,244,244,16,16,0,1,0
24,259,259,40,5,35,2,1
1,261,261,1,1,0,1,0
34,266,266,111,104,7,2,1
20,270,270,42,42,0,1,0
0,274,274,3,3,0,1,0
10,275,275,19,19,0,1,0
31,281,281,12,12,0,1,0
16,283,283,1,1,0,1,0
22,287,287,2,2,0,1,0
32,316,316,17,5,12,4,3
19,326,326,11,3,8,3,2
43,330,330,19,19,0,1,0
33,331,331,14,14,0,1,0
14,342,342,36,14,22,3,2
3,344,344,24,3,21,2,1
17,345,345,1,1,0,1,0
25,354,354,49,20,29,2,1
4,354,354,20,3,17,2,1
7,359,359,10,10,0,1,0
42,362,362,66,66,0,1,0
23,385,385,20,6,14,3,2
12,390,390,28,7,21,2,1
9,399,399,10,10,0,1,0
11,417,417,16,10,6,3,2
30,422,422,3,3,0,1,0
5,440,440,139,103,36,4,3
40,446,446,105,63,42,3,2
37,456,456,35,35,0,1,0
41,458,458,61,26,35,2,1
45,460,460,30,30,0,1,0
13,464,464,22,22,0,1,0
26,466,466,19,9,10,2,1
2,484,484,1,1,0,1,0
35,498,498,67,5,62,3,2

34,109,109,16,2,14,3,2
37,109,109,45,42,3,2,1
36,120,120,1,1,0,1,0
42,126,126,23,13,10,3,2
2,134,134,5,5,0,1,0
17,149,149,18,8,10,2,1
8,151,151,3,3,0,1,0
19,152,152,10,10,0,1,0
29,155,155,28,16,12,4,3
26,159,159,4,4,0,1,0
14,167,167,1,1,0,1,0
4,197,197,68,54,14,3,2
15,200,200,20,8,12,4,3
38,214,214,49,39,10,2,1
21,246,246,27,17,10,2,1
30,246,246,15,3,12,4,3
32,256,256,12,2,10,2,1
24,258,258,35,35,0,1,0
35,259,259,2,2,0,1,0
27,268,268,11,11,0,1,0
1,292,292,2,2,0,1,0
7,298,298,30,30,0,1,0
23,318,318,2,2,0,1,0
0,325,325,6,6,0,1,0
28,333,333,35,35,0,1,0
11,335,335,8,1,7,2,1
40,341,341,1,1,0,1,0
41,344,344,21,21,0,1,0
12,357,357,22,22,0,1,0
33,384,384,13,1,12,2,1
10,387,387,28,6,22,2,1
13,392,392,1,1,0,1,0
6,410,410,1,1,0,1,0
16,432,432,26,2,24,4,3
22,447,447,68,22,46,3,2
39,451,451,12,12,0,1,0
31,454,454,2,2,0,1,0
3,470,470,40,40,0,1,0
20,471,471,54,54,0,1,0
25,472,472,123,72,51,3,2
18,476,476,30,6,24,2,1
9,483,483,14,14,0,1,0
5,496,496,30,18,12,4,3

30,129,129,18,12,6,3,2
16,131,131,21,17,4,2,1
22,142,142,6,6,0,1,0
14,165,165,23,23,0,1,0
37,180,180,14,11,3,2,1
17,190,190,13,1,12,4,3
9,193,193,21,21,0,1,0
18,214,214,1,1,0,1,0
20,239,239,3,3,0,1,0
39,239,239,20,12,8,3,2
3,241,241,4,4,0,1,0
31,255,255,8,2,6,3,2
13,270,270,68,47,21,2,1
12,271,271,18,2,16,3,2
24,276,276,11,11,0,1,0
38,279,279,13,3,10,2,1
23,291,291,15,5,10,2,1
40,293,293,51,23,28,3,2
8,323,323,7,7,0,1,0
2,325,325,1,1,0,1,0
26,327,327,13,1,12,3,2
10,348,348,8,8,0,1,0
6,359,359,2,2,0,1,0
25,359,359,35,35,0,1,0
27,367,367,80,45,35,2,1
36,368,368,11,3,8,2,1
15,374,374,27,27,0,1,0
34,381,381,22,22,0,1,0
7,383,383,2,2,0,1,0
1,391,391,34,28,6,3,2
28,391,391,2,2,0,1,0
43,393,393,46,46,0,1,0
21,411,411,34,34,0,1,0
41,412,412,79,59,20,2,1
5,418,418,34,34,0,1,0
33,440,440,34,34,0,1,0
11,442,442,28,28,0,1,0
32,447,447,12,12,0,1,0
42,457,457,16,16,0,1,0
35,467,467,35,17,18,4,3
29,472,472,188,131,57,4,3
4,488,488,21,11,10,3,2
0,495,495,65,35,30,4,3
19,497,497,60,60,0,1,0

25,104,104,2,2,0,1,0
2,106,106,1,1,0,1,0
3,121,121,11,4,7,2,1
17,130,130,3,3,0,1,0
14,136,136,8,2,6,3,2
8,137,137,6,1,5,2,1
33,145,145,13,13,0,1,0
42,165,165,18,14,4,2,1
22,167,167,8,2,6,3,2
43,178,178,9,4,5,2,1
31,179,179,25,25,0,1,0
26,228,228,30,30,0,1,0
15,237,237,8,8,0,1,0
13,242,242,6,1,5,2,1
11,243,243,2,2,0,1,0
40,252,252,57,57,0,1,0
20,289,289,1,1,0,1,0
34,290,290,26,26,0,1,0
9,298,298,9,3,6,2,1
24,298,298,4,4,0,1,0
32,312,312,3,3,0,1,0
35,316,316,3,3,0,1,0
28,329,329,84,84,0,1,0
1,333,333,14,1,13,2,1
10,346,346,122,10,112,4,3
41,369,369,17,17,0,1,0
30,375,375,27,6,21,2,1
6,376,376,7,7,0,1,0
7,377,377,19,6,13,3,2
5,379,379,72,63,9,4,3
18,396,396,64,64,0,1,0
23,397,397,20,12,8,2,1
37,408,408,16,16,0,1,0
36,413,413,137,37,100,3,2
19,418,418,1,1,0,1,0
39,424,424,6,6,0,1,0
0,440,440,18,6,12,4,3
27,446,446,11,11,0,1,0
16,454,454,34,13,21,2,1
38,466,466,49,15,34,3,2
21,473,473,45,3,42,4,3
4,478,478,42,42,0,1,0
12,490,490,115,61,54,4,3
29,493,493,45,45,0,1,0

16,115,115,5,2,3,2,1
1,116,116,51,51,0,1,0
24,119,119,37,7,30,2,1
21,189,189,13,13,0,1,0
35,193,193,2,2,0,1,0
25,210,210,31,17,14,2,1
8,218,218,6,3,3,2,1
11,221,221,8,8,0,1,0
20,225,225,28,4,24,2,1
27,240,240,29,3,26,3,2
31,253,253,32,25,7,2,1
29,255,255,52,17,35,2,1
30,256,256,8,8,0,1,0
17,262,262,50,50,0,1,0
36,266,266,9,9,0,1,0
13,275,275,15,2,13,2,1
19,281,281,4,1,3,2,1
6,288,288,56,10,46,3,2
3,290,290,31,31,0,1,0
7,298,298,5,1,4,2,1
33,305,305,5,5,0,1,0
5,315,315,11,3,8,3,2
14,340,340,55,9,46,2,1
4,366,366,39,15,24,3,2
32,367,367,11,2,9,4,3
0,378,378,41,24,17,2,1
9,380,380,53,53,0,1,0
18,386,386,18,18,0,1,0
26,395,395,59,12,47,2,1
10,400,400,5,5,0,1,0
28,420,420,12,12,0,1,0
23,440,440,43,7,36,2,1
12,440,440,2,2,0,1,0
15,453,453,13,9,4,2,1
34,457,457,119,94,25,2,1
22,474,474,30,14,16,3,2
2,490,490,23,23,0,1,0

3,106,106,5,2,3,2,1
23,107,107,3,3,0,1,0
26,127,127,13,7,6,3,2
13,129,129,14,9,5,2,1
20,141,141,29,29,0,1,0
34,152,152,2,2,0,1,0
33,169,169,12,7,5,2,1
7,179,179,11,11,0,1,0
17,186,186,45,45,0,1,0
24,186,186,5,5,0,1,0
31,186,186,7,7,0,1,0
4,204,204,25,25,0,1,0
16,220,220,18,18,0,1,0
2,232,232,34,34,0,1,0
12,234,234,26,17,9,2,1
5,264,264,21,21,0,1,0
8,268,268,4,4,0,1,0
28,268,268,56,56,0,1,0
27,276,276,29,24,5,2,1
18,299,299,10,10,0,1,0
11,302,302,4,4,0,1,0
0,309,309,30,5,25,2,1
22,318,318,28,12,16,2,1
6,321,321,33,23,10,2,1
19,343,343,62,16,46,2,1
15,349,349,17,2,15,4,3
29,388,388,39,21,18,4,3
35,412,412,80,80,0,1,0
14,426,426,30,30,0,1,0
10,426,426,10,10,0,1,0
25,433,433,115,32,83,4,3
32,456,456,48,48,0,1,0
1,471,471,57,57,0,1,0
21,483,483,13,13,0,1,0
30,484,484,29,29,0,1,0
9,491,491,152,137,15,4,3

27,115,115,4,4,0,1,0
21,129,129,3,3,0,1,0
19,130,130,47,11,36,3,2
4,137,137,5,5,0,1,0
28,141,141,1,1,0,1,0
5,149,149,37,1,36,2,1
29,153,153,8,2,6,2,1
13,157,157,4,4,0,1,0
0,159,159,15,15,0,1,0
16,160,160,3,3,0,1,0
18,215,215,16,4,12,3,2
26,233,233,89,71,18,4,3
10,235,235,30,4,26,3,2
9,241,241,30,30,0,1,0
23,243,243,17,17,0,1,0
7,246,246,7,1,6,3,2
1,293,293,69,69,0,1,0
3,333,333,94,94,0,1,0
2,337,337,68,68,0,1,0
22,340,340,54,54,0,1,0
12,357,357,9,9,0,1,0
15,383,383,27,17,10,3,2
25,400,400,36,36,0,1,0
11,425,425,4,4,0,1,0
20,453,453,12,12,0,1,0
17,460,460,178,124,54,4,3
14,460,460,1,1,0,1,0
24,471,471,11,11,0,1,0
6,487,487,88,79,9,4,3
8,493,493,114,60,54,4,3

5,102,102,3,3,0,1,0
0,132,132,13,7,6,3,2
31,151,151,3,3,0,1,0
20,166,166,12,12,0,1,0
18,175,175,16,3,13,2,1
1,177,177,42,1,41,2,1
34,206,206,10,10,0,1,0
15,210,210,20,20,0,1,0
6,214,214,26,26,0,1,0
17,220,220,3,3,0,1,0
22,229,229,21,7,14,2,1
8,237,237,1,1,0,1,0
29,237,237,4,4,0,1,0
23,249,249,28,12,16,3,2
12,268,268,11,11,0,1,0
9,271,271,22,14,8,2,1
7,281,281,48,21,27,2,1
25,281,281,13,13,0,1,0
11,287,287,7,4,3,2,1
14,295,295,24,16,8,2,1
32,304,304,149,115,34,2,1
4,305,305,35,35,0,1,0
24,330,330,4,4,0,1,0
13,331,331,45,23,22,2,1
2,332,332,14,14,0,1,0
16,362,362,122,122,0,1,0
10,365,365,37,37,0,1,0
28,386,386,20,13,7,2,1
21,397,397,55,23,32,2,1
27,418,418,66,34,32,3,2
19,423,423,27,27,0,1,0
33,429,429,58,58,0,1,0
35,469,469,58,58,0,1,0
30,473,473,15,15,0,1,0
3,484,484,35,35,0,1,0
26,488,488,63,21,42,2,1

20,112,112,4,4,0,1,0
4,129,129,2,2,0,1,0
34,133,133,1,1,0,1,0
12,145,145,4,4,0,1,0
1,147,147,5,2,3,2,1
16,149,149,8,2,6,2,1
29,152,152,3,3,0,1,0
11,155,155,1,1,0,1,0
36,157,157,15,9,6,2,1
40,161,161,41,41,0,1,0
13,166,166,9,9,0,1,0
39,170,170,3,3,0,1,0
10,193,193,9,5,4,2,1
8,200,200,10,10,0,1,0
26,201,201,2,2,0,1,0
28,215,215,38,34,4,2,1
2,219,219,1,1,0,1,0
19,221,221,9,9,0,1,0
38,240,240,14,4,10,2,1
42,240,240,8,8,0,1,0
9,248,248,4,4,0,1,0
15,283,283,68,68,0,1,0
5,298,298,6,6,0,1,0
0,313,313,108,87,21,4,3
6,321,321,7,1,6,2,1
41,338,338,53,36,17,2,1
24,353,353,34,6,28,3,2
27,354,354,18,18,0,1,0
23,360,360,28,23,5,2,1
21,379,379,6,3,3,2,1
43,391,391,31,31,0,1,0
32,402,402,41,41,0,1,0
35,402,402,2,2,0,1,0
22,407,407,23,23,0,1,0
31,416,416,29,29,0,1,0
44,433,433,56,15,41,4,3
33,433,433,31,31,0,1,0
25,437,437,21,21,0,1,0
18,446,446,18,18,0,1,0
30,453,453,54,26,28,3,2
3,453,453,4,4,0,1,0
7,472,472,7,7,0,1,0
14,492,492,196,196,0,1,0
37,498,498,188,188,0,1,0
17,498,498,12,12,0,1,0

23,100,100,1,1,0,1,0
5,111,111,4,4,0,1,0
1,117,117,2,2,0,1,0
26,124,124,5,5,0,1,0
27,138,138,16,16,0,1,0
32,189,189,4,4,0,1,0
28,196,196,65,11,54,4,3
36,218,218,1,1,0,1,0
37,295,295,119,119,0,1,0
29,298,298,11,1,10,3,2
18,314,314,1,1,0,1,0
38,318,318,6,6,0,1,0
21,324,324,42,20,22,2,1
15,341,341,21,21,0,1,0
3,342,342,43,16,27,4,3
0,344,344,10,7,3,2,1
8,356,356,69,69,0,1,0
22,362,362,11,5,6,3,2
33,364,364,4,4,0,1,0
17,386,386,22,10,12,3,2
6,398,398,55,55,0,1,0
13,398,398,13,4,9,4,3
11,404,404,33,33,0,1,0
39,420,420,46,10,36,2,1
16,429,429,38,22,16,2,1
31,438,438,40,18,22,2,1
19,440,440,76,41,35,2,1
20,443,443,1,1,0,1,0
35,453,453,144,75,69,4,3
25,455,455,20,20,0,1,0
9,467,467,83,39,44,2,1
2,470,470,26,18,8,2,1
34,477,477,14,14,0,1,0
4,481,481,49,30,19,2,1
10,481,481,12,12,0,1,0
12,483,483,1,1,0,1,0
30,488,488,61,11,50,3,2
24,494,494,44,44,0,1,0
7,495,495,47,24,23,2,1
14,498,498,87,87,0,1,0

22,113,113,8,8,0,1,0
20,117,117,14,14,0,1,0
10,142,142,1,1,0,1,0
13,150,150,1,1,0,1,0
12,153,153,24,5,19,3,2
0,161,161,17,9,8,3,2
26,176,176,36,14,22,2,1
29,184,184,4,4,0,1,0
14,196,196,39,39,0,1,0
11,200,200,1,1,0,1,0
6,214,214,49,49,0,1,0
24,240,240,20,20,0,1,0
32,250,250,6,6,0,1,0
8,284,284,35,31,4,2,1
5,284,284,39,39,0,1,0
19,316,316,15,15,0,1,0
3,343,343,13,13,0,1,0
1,356,356,67,8,59,3,2
16,357,357,28,28,0,1,0
4,363,363,59,59,0,1,0
28,365,365,46,14,32,4,3
2,373,373,4,4,0,1,0
31,386,386,5,2,3,2,1
23,413,413,55,16,39,4,3
9,419,419,128,8,120,4,3
33,430,430,9,9,0,1,0
27,434,434,162,154,8,3,2
30,439,439,63,63,0,1,0
25,443,443,44,23,21,4,3
21,468,468,116,74,42,4,3
18,472,472,14,2,12,4,3
15,478,478,33,10,23,2,1
17,487,487,4,4,0,1,0
7,497,497,29,29,0,1,0

27,116,116,4,4,0,1,0
2,120,120,19,19,0,1,0
12,137,137,17,17,0,1,0
41,137,137,7,7,0,1,0
26,137,137,13,13,0,1,0
29,150,150,1,1,0,1,0
40,151,151,12,5,7,2,1
8,175,175,2,2,0,1,0
10,180,180,17,17,0,1,0
22,186,186,15,15,0,1,0
6,189,189,10,10,0,1,0
33,214,214,19,19,0,1,0
39,223,223,101,101,0,1,0
31,242,242,3,3,0,1,0
16,273,273,6,6,0,1,0
25,295,295,10,10,0,1,0
38,300,300,65,24,41,2,1
34,301,301,13,13,0,1,0
21,307,307,6,3,3,2,1
42,313,313,54,54,0,1,0
37,317,317,5,5,0,1,0
0,317,317,4,4,0,1,0
14,324,324,18,10,8,3,2
19,354,354,3,3,0,1,0
28,368,368,5,1,4,2,1
9,371,371,3,3,0,1,0
24,372,372,56,56,0,1,0
13,374,374,1,1,0,1,0
30,381,381,28,9,19,2,1
44,387,387,18,2,16,3,2
7,390,390,31,1,30,2,1
1,398,398,20,10,10,3,2
18,406,406,18,2,16,4,3
20,433,433,2,2,0,1,0
17,437,437,99,99,0,1,0
15,449,449,1,1,0,1,0
4,450,450,20,8,12,3,2
36,459,459,70,70,0,1,0
3,462,462,23,23,0,1,0
43,464,464,36,11,25,2,1
11,468,468,42,42,0,1,0
32,477,477,96,83,13,2,1
35,485,485,52,10,42,3,2
23,491,491,109,109,0,1,0
5,499,499,31,31,0,1,0

23,100,100,5,5,0,1,0
4,106,106,9,3,6,2,1
30,107,107,4,4,0,1,0
24,117,117,1,1,0,1,0
8,137,137,14,14,0,1,0
0,139,139,24,24,0,1,0
29,148,148,8,8,0,1,0
32,152,152,23,19,4,2,1
19,162,162,22,2,20,2,1
3,184,184,38,38,0,1,0
6,184,184,1,1,0,1,0
5,186,186,1,1,0,1,0
9,189,189,26,26,0,1,0
28,194,194,2,2,0,1,0
21,197,197,11,11,0,1,0
25,201,201,28,23,5,2,1
16,214,214,21,21,0,1,0
11,252,252,21,4,17,2,1
20,272,272,10,10,0,1,0
31,283,283,11,3,8,2,1
17,290,290,14,14,0,1,0
2,309,309,11,2,9,2,1
7,311,311,6,6,0,1,0
18,319,319,29,17,12,4,3
27,332,332,16,16,0,1,0
12,350,350,37,25,12,3,2
26,360,360,123,30,93,4,3
13,384,384,12,6,6,2,1
10,400,400,109,109,0,1,0
1,427,427,181,118,63,3,2
22,440,440,112,109,3,2,1
14,461,461,53,42,11,2,1
15,494,494,126,51,75,4,3

38,104,104,3,3,0,1,0
7,107,107,8,8,0,1,0
21,126,126,21,7,14,2,1
11,134,134,2,2,0,1,0
17,139,139,2,2,0,1,0
42,161,161,7,7,0,1,0
26,204,204,21,21,0,1,0
29,208,208,8,1,7,2,1
1,208,208,8,4,4,2,1
10,222,222,2,2,0,1,0
8,237,237,6,6,0,1,0
22,264,264,4,4,0,1,0
16,271,271,1,1,0,1,0
24,273,273,41,30,11,2,1
25,283,283,8,8,0,1,0
37,295,295,14,14,0,1,0
41,301,301,43,4,39,4,3
34,310,310,85,21,64,4,3
31,317,317,36,36,0,1,0
5,331,331,40,14,26,2,1
23,334,334,12,4,8,2,1
20,345,345,16,7,9,4,3
13,353,353,2,2,0,1,0
6,360,360,32,32,0,1,0
18,361,361,43,13,30,4,3
32,364,364,6,6,0,1,0
3,376,376,110,110,0,1,0
44,389,389,6,3,3,2,1
27,390,390,40,40,0,1,0
15,390,390,7,1,6,2,1
9,407,407,6,6,0,1,0
19,407,407,15,9,6,2,1
36,421,421,35,19,16,2,1
40,432,432,22,11,11,2,1
12,435,435,39,39,0,1,0
14,436,436,14,14,0,1,0
43,440,440,87,35,52,3,2
4,443,443,61,5,56,4,3
35,444,444,68,20,48,4,3
30,459,459,45,20,25,3,2
39,471,471,132,86,46,2,1
0,482,482,1,1,0,1,0
2,489,489,59,24,35,4,3
28,489,489,47,42,5,2,1
33,500,500,24,24,0,1,0

2,100,100,1,1,0,1,0
27,105,105,27,8,19,2,1
12,108,108,1,1,0,1,0
30,121,121,1,1,0,1,0
21,144,144,1,1,0,1,0
4,152,152,8,5,3,2,1
1,166,166,11,1,10,2,1
36,166,166,41,41,0,1,0
40,174,174,9,9,0,1,0
16,187,187,1,1,0,1,0
13,192,192,21,14,7,2,1
17,195,195,20,2,18,4,3
28,196,196,45,45,0,1,0
15,199,199,1,1,0,1,0
10,206,206,56,40,16,4,3
11,208,208,1,1,0,1,0
41,208,208,15,15,0,1,0
43,210,210,2,2,0,1,0
39,213,213,36,36,0,1,0
18,223,223,6,3,3,2,1
38,265,265,4,4,0,1,0
35,277,277,46,46,0,1,0
3,284,284,31,11,20,3,2
23,292,292,37,2,35,4,3
29,294,294,3,3,0,1,0
9,298,298,73,27,46,3,2
20,315,315,9,3,6,3,2
32,339,339,10,10,0,1,0
42,348,348,16,1,15,4,3
26,352,352,7,7,0,1,0
14,354,354,40,6,34,3,2
34,384,384,112,46,66,4,3
19,403,403,13,3,10,2,1
24,411,411,29,29,0,1,0
22,413,413,8,8,0,1,0
5,414,414,6,3,3,2,1
33,428,428,14,11,3,2,1
37,434,434,10,10,0,1,0
25,441,441,27,21,6,3,2
31,449,449,73,7,66,4,3
6,461,461,1,1,0,1,0
7,463,463,94,67,27,2,1
0,475,475,39,8,31,2,1
8,484,484,11,11,0,1,0

23,109,109,7,7,0,1,0
13,128,128,25,17,8,3,2
15,133,133,20,20,0,1,0
22,133,133,29,29,0,1,0
31,161,161,2,2,0,1,0
25,161,161,25,3,22,2,1
17,204,204,21,3,18,3,2
3,213,213,22,16,6,3,2
28,225,225,61,61,0,1,0
30,229,229,7,7,0,1,0
20,233,233,50,50,0,1,0
4,237,237,38,38,0,1,0
18,237,237,45,3,42,3,2
29,244,244,9,5,4,2,1
8,258,258,61,19,42,2,1
0,262,262,4,4,0,1,0
19,264,264,24,14,10,3,2
6,264,264,34,12,22,3,2
14,281,281,96,24,72,3,2
33,285,285,57,1,56,3,2
12,286,286,15,5,10,3,2
24,311,311,23,23,0,1,0
5,326,326,52,4,48,4,3
27,339,339,4,4,0,1,0
2,361,361,9,9,0,1,0
7,370,370,9,9,0,1,0
1,373,373,17,17,0,1,0
32,375,375,8,8,0,1,0
10,397,397,17,17,0,1,0
9,436,436,39,18,21,2,1
16,447,447,6,6,0,1,0
26,453,453,14,14,0,1,0
11,466,466,15,9,6,2,1
21,499,499,53,53,0,1,0

24,105,105,3,3,0,1,0
8,140,140,27,27,0,1,0
3,141,141,9,9,0,1,0
20,182,182,12,1,11,2,1
19,184,184,41,20,21,2,1
23,185,185,20,6,14,2,1
11,208,208,2,2,0,1,0
9,238,238,15,1,14,3,2
17,260,260,46,46,0,1,0
5,261,261,26,11,15,4,3
13,283,283,24,24,0,1,0
0,291,291,7,7,0,1,0
12,300,300,107,107,0,1,0
15,309,309,83,43,40,3,2
1,324,324,41,41,0,1,0
25,352,352,4,4,0,1,0
16,354,354,8,1,7,2,1
26,361,361,7,7,0,1,0
2,381,381,47,47,0,1,0
7,385,385,240,192,48,3,2
4,393,393,7,7,0,1,0
18,399,399,51,51,0,1,0
10,407,407,27,19,8,2,1
22,426,426,28,28,0,1,0
21,441,441,23,23,0,1,0
6,442,442,234,160,74,3,2
14,450,450,40,40,0,1,0

12,100,100,8,8,0,1,0
23,143,143,17,5,12,4,3
11,150,150,25,12,13,2,1
2,153,153,31,17,14,2,1
10,177,177,29,29,0,1,0
6,191,191,18,4,14,3,2
20,191,191,20,6,14,3,2
13,200,200,34,34,0,1,0
4,207,207,16,4,12,3,2
0,210,210,44,44,0,1,0
29,232,232,9,6,3,2,1
14,236,236,83,67,16,2,1
17,252,252,3,3,0,1,0
9,253,253,5,5,0,1,0
5,291,291,85,8,77,4,3
7,314,314,72,72,0,1,0
19,333,333,39,39,0,1,0
18,347,347,21,11,10,2,1
16,350,350,159,159,0,1,0
3,354,354,21,21,0,1,0
21,355,355,3,3,0,1,0
25,360,360,2,2,0,1,0
28,366,366,1,1,0,1,0
27,403,403,50,37,13,3,2
15,410,410,4,4,0,1,0
22,410,410,43,43,0,1,0
24,465,465,9,3,6,2,1
1,471,471,14,5,9,2,1
26,476,476,26,26,0,1,0
8,484,484,124,109,15,2,1

4,103,103,6,2,4,2,1
2,117,117,8,4,4,2,1
19,124,124,6,6,0,1,0
24,130,130,6,2,4,2,1
34,131,131,17,17,0,1,0
20,150,150,27,5,22,2,1
25,161,161,9,9,0,1,0
9,172,172,26,8,18,4,3
12,176,176,20,20,0,1,0
5,180,180,21,21,0,1,0
23,184,184,4,4,0,1,0
10,186,186,5,5,0,1,0
6,203,203,64,64,0,1,0
3,233,233,6,1,5,2,1
7,239,239,15,15,0,1,0
32,248,248,9,3,6,2,1
16,262,262,7,7,0,1,0
8,269,269,50,50,0,1,0
14,274,274,22,1,21,4,3
13,281,281,25,10,15,4,3
11,285,285,21,21,0,1,0
31,295,295,8,8,0,1,0
22,312,312,6,6,0,1,0
18,333,333,44,3,41,4,3
33,353,353,47,6,41,2,1
21,355,355,19,19,0,1,0
27,377,377,30,14,16,2,1
29,380,380,32,8,24,2,1
26,384,384,34,34,0,1,0
17,416,416,222,84,138,4,3
15,424,424,37,37,0,1,0
1,432,432,44,44,0,1,0
28,454,454,74,47,27,4,3
0,474,474,103,65,38,3,2
30,495,495,3,3,0,1,0

32,114,114,5,5,0,1,0
17,128,128,1,1,0,1,0
3,131,131,3,3,0,1,0
24,141,141,11,11,0,1,0
10,143,143,20,20,0,1,0
25,154,154,10,10,0,1,0
30,162,162,33,16,17,3,2
23,164,164,33,6,27,4,3
5,186,186,2,2,0,1,0
11,203,203,27,27,0,1,0
9,213,213,10,10,0,1,0
27,221,221,58,58,0,1,0
2,228,228,36,36,0,1,0
4,235,235,1,1,0,1,0
6,242,242,23,5,18,2,1
16,269,269,4,4,0,1,0
29,271,271,59,31,28,3,2
31,303,303,40,1,39,4,3
18,304,304,28,16,12,3,2
15,311,311,57,6,51,4,3
1,326,326,79,3,76,3,2
22,327,327,1,1,0,1,0
12,357,357,3,3,0,1,0
33,362,362,15,2,13,2,1
14,372,372,2,2,0,1,0
13,372,372,22,13,9,4,3
19,389,389,67,23,44,3,2
20,408,408,10,10,0,1,0
7,442,442,186,79,107,4,3
26,446,446,97,91,6,3,2
28,447,447,16,16,0,1,0
8,461,461,26,4,22,2,1
21,468,468,15,15,0,1,0
0,500,500,107,96,11,2,1

24,114,114,12,12,0,1,0
19,118,118,1,1,0,1,0
21,171,171,4,4,0,1,0
11,173,173,1,1,0,1,0
30,180,180,20,20,0,1,0
26,180,180,6,6,0,1,0
8,196,196,6,6,0,1,0
3,199,199,14,1,13,2,1
5,204,204,49,49,0,1,0
23,225,225,4,4,0,1,0
0,239,239,23,11,12,4,3
2,269,269,57,33,24,4,3
4,294,294,62,8,54,4,3
9,295,295,44,34,10,3,2
6,316,316,12,6,6,3,2
15,325,325,12,12,0,1,0
14,361,361,8,8,0,1,0
12,375,375,27,27,0,1,0
20,384,384,34,24,10,3,2
25,384,384,37,37,0,1,0
16,397,397,16,6,10,2,1
10,398,398,54,54,0,1,0
18,407,407,22,22,0,1,0
1,431,431,64,64,0,1,0
28,433,433,22,7,15,2,1
7,440,440,172,96,76,4,3
17,459,459,18,7,11,2,1
27,463,463,163,163,0,1,0
29,482,482,215,215,0,1,0
22,485,485,58,1,57,4,3
13,493,493,91,55,36,2,1

5,109,109,12,2,10,3,2
2,131,131,5,2,3,2,1
14,140,140,6,6,0,1,0
1,143,143,21,6,15,2,1
9,189,189,61,34,27,4,3
8,195,195,16,1,15,4,3
26,197,197,6,3,3,2,1
24,220,220,30,30,0,1,0
10,223,223,93,39,54,3,2
6,244,244,27,27,0,1,0
22,245,245,4,4,0,1,0
21,303,303,9,9,0,1,0
17,322,322,62,62,0,1,0
23,335,335,26,26,0,1,0
27,352,352,10,10,0,1,0
13,360,360,35,23,12,3,2
4,361,361,14,14,0,1,0
29,366,366,42,16,26,2,1
0,394,394,74,36,38,3,2
18,403,403,39,6,33,4,3
25,409,409,7,7,0,1,0
12,412,412,2,2,0,1,0
11,414,414,2,2,0,1,0
16,416,416,9,9,0,1,0
7,448,448,136,72,64,3,2
15,449,449,211,136,75,4,3
3,459,459,18,18,0,1,0
19,472,472,43,43,0,1,0
28,487,487,159,74,85,3,2
20,489,489,16,16,0,1,0

17,141,141,16,6,10,2,1
30,145,145,2,2,0,1,0
20,150,150,57,25,32,2,1
13,158,158,7,3,4,2,1
27,177,177,2,2,0,1,0
7,202,202,5,5,0,1,0
33,203,203,19,5,14,2,1
11,206,206,16,16,0,1,0
0,213,213,13,1,12,2,1
31,241,241,59,59,0,1,0
14,254,254,26,26,0,1,0
23,254,254,41,41,0,1,0
9,279,279,20,20,0,1,0
21,281,281,3,3,0,1,0
26,294,294,8,8,0,1,0
1,300,300,6,6,0,1,0
18,304,304,17,17,0,1,0
12,309,309,103,93,10,3,2
15,311,311,69,25,44,3,2
8,315,315,110,83,27,3,2
4,316,316,54,12,42,3,2
25,320,320,29,29,0,1,0
24,346,346,24,15,9,4,3
5,360,360,63,63,0,1,0
32,365,365,29,29,0,1,0
29,367,367,7,7,0,1,0
10,399,399,20,20,0,1,0
19,418,418,4,4,0,1,0
6,427,427,1,1,0,1,0
2,429,429,7,3,4,2,1
16,430,430,85,70,15,4,3
3,466,466,37,37,0,1,0
22,472,472,88,46,42,2,1
28,480,480,38,38,0,1,0

16,107,107,21,21,0,1,0
3,118,118,10,10,0,1,0
20,129,129,2,2,0,1,0
6,141,141,5,5,0,1,0
29,153,153,13,3,10,2,1
21,199,199,2,2,0,1,0
2,202,202,125,87,38,2,1
1,210,210,50,14,36,4,3
4,215,215,12,12,0,1,0
27,228,228,3,3,0,1,0
15,235,235,56,21,35,2,1
24,235,235,40,23,17,3,2
17,235,235,7,7,0,1,0
28,238,238,36,36,0,1,0
11,246,246,7,7,0,1,0
5,249,249,1,1,0,1,0
7,285,285,38,31,7,2,1
30,286,286,113,113,0,1,0
12,288,288,15,6,9,2,1
10,291,291,6,6,0,1,0
9,313,313,17,4,13,2,1
19,316,316,14,2,12,3,2
26,367,367,33,33,0,1,0
25,387,387,3,3,0,1,0
14,388,388,104,64,40,2,1
0,390,390,25,8,17,2,1
8,407,407,168,168,0,1,0
23,409,409,2,2,0,1,0
13,471,471,28,8,20,3,2
18,472,472,8,8,0,1,0
22,488,488,22,12,10,3,2

31,110,110,1,1,0,1,0
16,120,120,1,1,0,1,0
39,123,123,5,5,0,1,0
2,125,125,6,6,0,1,0
30,125,125,19,7,12,3,2
36,128,128,71,47,24,4,3
25,134,134,5,5,0,1,0
5,141,141,1,1,0,1,0
38,186,186,13,7,6,2,1
4,188,188,9,9,0,1,0
20,201,201,24,24,0,1,0
37,205,205,5,1,4,2,1
19,236,236,5,5,0,1,0
18,244,244,2,2,0,1,0
21,268,268,11,11,0,1,0
28,273,273,7,7,0,1,0
13,282,282,18,18,0,1,0
26,300,300,5,5,0,1,0
34,324,324,41,36,5,2,1
11,337,337,9,5,4,2,1
12,342,342,88,30,58,3,2
29,344,344,1,1,0,1,0
27,355,355,22,22,0,1,0
10,370,370,13,1,12,3,2
9,383,383,65,39,26,2,1
0,388,388,131,85,46,2,1
32,402,402,50,23,27,4,3
3,402,402,8,8,0,1,0
1,405,405,32,8,24,4,3
23,423,423,63,59,4,2,1
22,435,435,47,18,29,2,1
8,436,436,38,26,12,4,3
15,437,437,43,43,0,1,0
24,440,440,38,1,37,3,2
17,448,448,2,2,0,1,0
14,456,456,80,80,0,1,0
35,464,464,43,10,33,4,3
6,465,465,18,18,0,1,0
7,469,469,50,8,42,4,3
33,486,486,75,58,17,2,1

4,122,122,13,13,0,1,0
14,136,136,2,2,0,1,0
18,144,144,12,12,0,1,0
17,153,153,38,38,0,1,0
26,164,164,27,12,15,2,1
24,174,174,1,1,0,1,0
15,179,179,5,5,0,1,0
9,186,186,1,1,0,1,0
8,189,189,21,2,19,4,3
6,191,191,36,1,35,2,1
12,197,197,8,4,4,2,1
20,208,208,33,33,0,1,0
3,237,237,41,41,0,1,0
22,238,238,28,5,23,2,1
0,244,244,8,8,0,1,0
29,254,254,6,6,0,1,0
23,263,263,101,101,0,1,0
21,275,275,23,3,20,2,1
30,305,305,22,8,14,4,3
27,312,312,79,63,16,3,2
25,332,332,39,8,31,2,1
11,350,350,46,46,0,1,0
16,357,357,12,12,0,1,0
28,362,362,4,4,0,1,0
7,386,386,5,1,4,2,1
5,408,408,54,54,0,1,0
10,419,419,185,164,21,4,3
13,445,445,14,5,9,4,3
2,455,455,136,22,114,4,3
1,470,470,60,24,36,4,3
19,484,484,6,6,0,1,0

16,116,116,9,9,0,1,0
10,131,131,31,31,0,1,0
18,132,132,12,8,4,2,1
3,148,148,14,14,0,1,0
33,158,158,64,22,42,4,3
21,162,162,2,2,0,1,0
1,183,183,1,1,0,1,0
7,196,196,49,49,0,1,0
13,220,220,6,3,3,2,1
32,266,266,14,14,0,1,0
9,273,273,11,3,8,2,1
26,294,294,7,7,0,1,0
35,305,305,12,12,0,1,0
28,318,318,3,3,0,1,0
19,354,354,42,42,0,1,0
20,354,354,44,3,41,2,1
29,363,363,56,20,36,2,1
17,372,372,41,41,0,1,0
4,373,373,60,60,0,1,0
22,380,380,89,25,64,3,2
14,380,380,54,20,34,2,1
6,389,389,9,9,0,1,0
30,393,393,36,18,18,4,3
2,417,417,79,79,0,1,0
25,424,424,8,2,6,3,2
12,431,431,1,1,0,1,0
24,437,437,20,20,0,1,0
31,444,444,79,79,0,1,0
0,448,448,6,6,0,1,0
8,456,456,21,2,19,2,1
5,457,457,73,19,54,4,3
23,469,469,86,42,44,3,2
27,470,470,12,7,5,2,1
34,471,471,8,8,0,1,0
11,481,481,58,16,42,3,2
15,492,492,50,32,18,4,3

7,133,133,7,1,6,2,1
9,138,138,40,21,19,2,1
17,147,147,1,1,0,1,0
36,159,159,3,3,0,1,0
27,170,170,54,54,0,1,0
15,175,175,9,9,0,1,0
29,175,175,10,10,0,1,0
32,180,180,3,3,0,1,0
8,198,198,4,4,0,1,0
25,207,207,16,16,0,1,0
28,208,208,44,5,39,4,3
24,211,211,1,1,0,1,0
31,218,218,68,28,40,3,2
21,226,226,42,42,0,1,0
2,263,263,9,9,0,1,0
3,266,266,11,2,9,4,3
13,280,280,44,44,0,1,0
20,285,285,19,19,0,1,0
34,315,315,11,6,5,2,1
4,330,330,4,4,0,1,0
18,341,341,4,4,0,1,0
11,356,356,5,5,0,1,0
6,359,359,13,13,0,1,0
22,407,407,36,36,0,1,0
12,417,417,156,78,78,3,2
35,423,423,31,5,26,2,1
1,427,427,145,13,132,4,3
14,438,438,16,4,12,4,3
23,449,449,52,52,0,1,0
5,450,450,47,15,32,2,1
0,459,459,21,21,0,1,0
19,460,460,90,84,6,2,1
16,460,460,61,12,49,4,3
10,461,461,19,19,0,1,0
26,464,464,6,6,0,1,0
30,466,466,12,12,0,1,0
33,499,499,4,4,0,1,0

32,112,112,3,3,0,1,0
23,114,114,15,1,14,3,2
31,127,127,2,2,0,1,0
20,128,128,8,8,0,1,0
13,130,130,12,12,0,1,0
27,160,160,37,5,32,3,2
33,167,167,20,20,0,1,0
1,168,168,29,5,24,4,3
21,190,190,10,10,0,1,0
5,193,193,13,5,8,2,1
6,205,205,1,1,0,1,0
2,207,207,22,11,11,2,1
25,210,210,7,2,5,2,1
10,231,231,5,5,0,1,0
11,255,255,38,38,0,1,0
22,278,278,65,49,16,3,2
29,282,282,31,1,30,2,1
16,305,305,39,29,10,3,2
9,328,328,24,24,0,1,0
18,335,335,88,88,0,1,0
26,347,347,1,1,0,1,0
19,360,360,1,1,0,1,0
7,376,376,217,175,42,4,3
28,410,410,66,36,30,4,3
17,418,418,54,27,27,2,1
4,421,421,13,3,10,3,2
30,427,427,42,42,0,1,0
3,433,433,6,6,0,1,0
14,437,437,55,4,51,4,3
0,440,440,81,55,26,2,1
12,446,446,3,3,0,1,0
24,452,452,10,10,0,1,0
8,489,489,20,10,10,2,1
15,498,498,67,22,45,4,3

8,101,101,36,12,24,4,3
25,106,106,41,13,28,2,1
24,121,121,20,9,11,2,1
22,126,126,5,1,4,2,1
9,132,132,10,5,5,2,1
7,152,152,1,1,0,1,0
20,168,168,14,9,5,2,1
3,189,189,1,1,0,1,0
13,212,212,88,88,0,1,0
27,213,213,1,1,0,1,0
31,218,218,1,1,0,1,0
29,223,223,11,11,0,1,0
5,231,231,3,3,0,1,0
16,264,264,4,4,0,1,0
0,264,264,9,9,0,1,0
2,275,275,22,22,0,1,0
12,293,293,57,57,0,1,0
11,310,310,21,1,20,2,1
15,313,313,24,6,18,4,3
18,316,316,75,15,60,4,3
10,316,316,105,105,0,1,0
17,332,332,49,49,0,1,0
28,340,340,26,26,0,1,0
21,344,344,75,27,48,4,3
1,360,360,71,21,50,2,1
23,406,406,22,22,0,1,0
26,428,428,61,29,32,3,2
4,435,435,6,6,0,1,0
14,452,452,7,7,0,1,0
30,463,463,15,15,0,1,0
6,476,476,5,5,0,1,0
19,494,494,43,33,10,2,1

4,101,101,19,10,9,4,3
24,106,106,13,13,0,1,0
13,120,120,8,8,0,1,0
28,129,129,12,4,8,3,2
26,139,139,8,8,0,1,0
21,143,143,41,11,30,3,2
1,163,163,10,10,0,1,0
30,164,164,28,9,19,3,2
20,173,173,2,2,0,1,0
10,197,197,16,2,14,3,2
6,207,207,62,12,50,3,2
27,216,216,2,2,0,1,0
15,218,218,29,29,0,1,0
14,231,231,42,42,0,1,0
0,239,239,19,8,11,2,1
5,240,240,9,9,0,1,0
2,255,255,9,9,0,1,0
17,262,262,26,17,9,2,1
23,274,274,9,5,4,2,1
32,280,280,13,13,0,1,0
25,317,317,43,43,0,1,0
9,319,319,28,28,0,1,0
18,321,321,23,9,14,2,1
7,328,328,41,41,0,1,0
3,354,354,13,1,12,4,3
11,409,409,14,7,7,2,1
16,414,414,16,16,0,1,0
22,421,421,18,2,16,3,2
8,445,445,56,56,0,1,0
12,456,456,165,165,0,1,0
29,472,472,84,27,57,4,3
31,481,481,2,2,0,1,0
19,491,491,150,60,90,3,2

4,101,101,5,2,3,2,1
9,106,106,19,19,0,1,0
2,117,117,6,6,0,1,0
15,140,140,4,4,0,1,0
31,140,140,33,33,0,1,0
41,146,146,11,2,9,2,1
32,148,148,33,33,0,1,0
34,170,170,25,18,7,2,1
19,183,183,10,4,6,2,1
7,204,204,5,5,0,1,0
36,205,205,21,1,20,2,1
14,210,210,9,9,0,1,0
3,222,222,2,2,0,1,0
12,227,227,26,26,0,1,0
16,243,243,4,4,0,1,0
25,249,249,33,33,0,1,0
18,271,271,26,26,0,1,0
33,275,275,46,22,24,2,1
39,296,296,9,9,0,1,0
8,306,306,21,15,6,2,1
0,307,307,13,13,0,1,0
17,309,309,6,6,0,1,0
1,314,314,4,4,0,1,0
29,323,323,1,1,0,1,0
20,325,325,52,52,0,1,0
13,328,328,29,29,0,1,0
37,336,336,19,19,0,1,0
24,338,338,47,47,0,1,0
6,344,344,48,48,0,1,0
38,349,349,3,3,0,1,0
30,354,354,29,29,0,1,0
26,371,371,48,18,30,2,1
22,392,392,13,4,9,2,1
11,399,399,9,9,0,1,0
5,416,416,20,20,0,1,0
35,418,418,4,4,0,1,0
10,435,435,83,17,66,3,2
21,444,444,110,70,40,3,2
23,455,455,28,1,27,3,2
27,473,473,19,5,14,2,1
28,483,483,104,29,75,3,2
40,489,489,19,13,6,2,1

20,122,122,1,1,0,1,0
18,124,124,4,4,0,1,0
25,124,124,4,4,0,1,0
36,135,135,16,1,15,4,3
21,161,161,10,6,4,2,1
10,181,181,2,2,0,1,0
11,193,193,25,25,0,1,0
22,195,195,2,2,0,1,0
19,196,196,40,40,0,1,0
16,199,199,53,33,20,2,1
38,200,200,5,5,0,1,0
41,207,207,59,31,28,4,3
40,222,222,12,12,0,1,0
14,226,226,15,1,14,2,1
26,227,227,46,13,33,2,1
12,243,243,41,6,35,2,1
6,244,244,40,18,22,2,1
28,244,244,26,26,0,1,0
4,248,248,5,5,0,1,0
30,259,259,29,29,0,1,0
23,278,278,2,2,0,1,0
7,302,302,13,13,0,1,0
37,314,314,32,6,26,3,2
9,314,314,30,15,15,4,3
8,315,315,55,3,52,3,2
3,328,328,4,1,3,2,1
2,340,340,1,1,0,1,0
35,343,343,28,4,24,4,3
5,368,368,1,1,0,1,0
0,372,372,9,4,5,2,1
32,373,373,3,3,0,1,0
29,376,376,23,1,22,3,2
33,376,376,29,6,23,2,1
1,381,381,25,25,0,1,0
24,399,399,145,80,65,4,3
13,403,403,1,1,0,1,0
27,418,418,18,1,17,2,1
17,448,448,67,25,42,4,3
39,459,459,4,4,0,1,0
34,464,464,13,13,0,1,0
15,465,465,37,1,36,3,2
31,499,499,62,53,9,4,3

29,106,106,6,1,5,2,1
27,138,138,10,10,0,1,0
19,174,174,5,2,3,2,1
11,212,212,7,7,0,1,0
4,214,214,13,13,0,1,0
22,216,216,41,6,35,2,1
18,220,220,12,6,6,3,2
16,240,240,78,45,33,2,1
14,247,247,41,41,0,1,0
15,250,250,9,9,0,1,0
6,261,261,3,3,0,1,0
8,261,261,33,21,12,3,2
31,267,267,54,33,21,4,3
7,268,268,1,1,0,1,0
3,276,276,60,14,46,2,1
36,277,277,12,4,8,2,1
23,281,281,5,5,0,1,0
21,288,288,30,30,0,1,0
5,292,292,6,6,0,1,0
28,293,293,30,11,19,2,1
33,296,296,20,1,19,2,1
35,355,355,2,2,0,1,0
30,362,362,14,4,10,3,2
1,377,377,18,13,5,2,1
26,379,379,138,14,124,4,3
24,390,390,10,10,0,1,0
2,391,391,8,8,0,1,0
0,401,401,108,32,76,3,2
9,425,425,46,46,0,1,0
13,430,430,12,12,0,1,0
34,436,436,26,26,0,1,0
20,439,439,97,47,50,4,3
12,445,445,103,103,0,1,0
10,448,448,1,1,0,1,0
32,452,452,8,8,0,1,0
25,484,484,105,105,0,1,0
17,485,485,19,19,0,1,0

20,109,109,4,4,0,1,0
30,110,110,11,11,0,1,0
26,123,123,32,32,0,1,0
21,127,127,20,20,0,1,0
22,131,131,9,3,6,3,2
7,137,137,26,6,20,3,2
23,145,145,30,30,0,1,0
8,146,146,11,11,0,1,0
36,158,158,12,12,0,1,0
29,168,168,23,23,0,1,0
5,171,171,5,5,0,1,0
14,177,177,12,6,6,3,2
11,185,185,6,6,0,1,0
3,195,195,21,21,0,1,0
28,200,200,9,9,0,1,0
35,204,204,25,25,0,1,0
13,212,212,53,53,0,1,0
15,230,230,32,10,22,3,2
25,252,252,1,1,0,1,0
17,267,267,4,4,0,1,0
34,282,282,37,8,29,4,3
27,286,286,51,33,18,2,1
18,297,297,28,1,27,2,1
10,298,298,70,55,15,2,1
9,333,333,87,32,55,3,2
0,346,346,17,3,14,3,2
24,355,355,19,19,0,1,0
31,391,391,13,1,12,3,2
33,399,399,10,10,0,1,0
32,417,417,63,63,0,1,0
6,424,424,3,3,0,1,0
4,430,430,2,2,0,1,0
19,431,431,1,1,0,1,0
37,437,437,21,21,0,1,0
12,437,437,16,16,0,1,0
16,451,451,30,12,18,4,3
1,463,463,39,39,0,1,0
2,463,463,25,25,0,1,0

21,109,109,14,14,0,1,0
20,116,116,3,3,0,1,0
23,118,118,24,2,22,3,2
9,121,121,4,1,3,2,1
35,124,124,10,2,8,3,2
5,125,125,18,18,0,1,0
31,136,136,19,9,10,3,2
28,138,138,28,16,12,4,3
27,145,145,20,20,0,1,0
29,146,146,9,9,0,1,0
7,153,153,1,1,0,1,0
11,163,163,10,4,6,3,2
16,166,166,23,2,21,2,1
17,195,195,40,40,0,1,0
33,212,212,2,2,0,1,0
24,218,218,9,9,0,1,0
0,247,247,45,9,36,2,1
25,255,255,18,9,9,2,1
15,258,258,30,2,28,3,2
37,306,306,105,15,90,3,2
14,312,312,8,8,0,1,0
2,318,318,28,28,0,1,0
10,343,343,11,11,0,1,0
3,348,348,3,3,0,1,0
34,359,359,12,12,0,1,0
6,369,369,5,5,0,1,0
22,370,370,9,9,0,1,0
32,378,378,39,21,18,3,2
36,381,381,18,10,8,3,2
30,383,383,61,7,54,4,3
1,415,415,27,12,15,4,3
8,419,419,16,16,0,1,0
26,437,437,11,11,0,1,0
4,449,449,15,15,0,1,0
13,477,477,59,59,0,1,0
12,485,485,99,17,82,3,2
18,485,485,123,75,48,4,3
19,488,488,14,14,0,1,0

6,115,115,1,1,0,1,0
4,133,133,3,3,0,1,0
31,147,147,13,13,0,1,0
20,147,147,25,7,18,2,1
10,147,147,6,6,0,1,0
3,163,163,18,3,15,2,1
23,175,175,18,18,0,1,0
9,184,184,1,1,0,1,0
16,188,188,8,3,5,2,1
11,197,197,8,8,0,1,0
39,198,198,64,36,28,3,2
34,200,200,19,5,14,2,1
8,236,236,9,9,0,1,0
0,263,263,16,16,0,1,0
29,269,269,33,19,14,2,1
35,280,280,38,38,0,1,0
5,294,294,13,4,9,2,1
19,300,300,1,1,0,1,0
26,303,303,6,6,0,1,0
28,320,320,10,5,5,2,1
7,320,320,5,5,0,1,0
32,331,331,3,3,0,1,0
37,335,335,27,27,0,1,0
36,336,336,41,37,4,2,1
24,361,361,75,75,0,1,0
27,387,387,16,11,5,2,1
12,388,388,47,47,0,1,0
40,389,389,44,26,18,4,3
18,389,389,20,20,0,1,0
2,389,389,3,3,0,1,0
25,415,415,39,39,0,1,0
38,416,416,10,4,6,2,1
13,424,424,39,7,32,3,2
22,424,424,104,17,87,4,3
33,426,426,38,16,22,2,1
1,426,426,25,13,12,2,1
15,426,426,7,7,0,1,0
21,462,462,67,44,23,2,1
17,478,478,74,74,0,1,0
14,484,484,148,122,26,3,2
30,490,490,67,20,47,4,3

2,111,111,8,3,5,2,1
22,111,111,7,7,0,1,0
16,112,112,4,4,0,1,0
41,120,120,33,33,0,1,0
18,134,134,3,3,0,1,0
27,151,151,31,31,0,1,0
23,164,164,3,3,0,1,0
17,175,175,3,3,0,1,0
42,188,188,11,11,0,1,0
26,195,195,13,3,10,3,2
1,195,195,1,1,0,1,0
6,200,200,1,1,0,1,0
9,214,214,11,8,3,2,1
21,229,229,1,1,0,1,0
35,230,230,35,35,0,1,0
0,241,241,7,7,0,1,0
19,254,254,9,9,0,1,0
33,267,267,36,36,0,1,0
15,271,271,40,17,23,2,1
7,274,274,9,4,5,2,1
8,280,280,57,13,44,3,2
40,298,298,27,16,11,2,1
34,314,314,4,4,0,1,0
3,319,319,8,1,7,2,1
36,324,324,14,5,9,4,3
30,325,325,88,13,75,4,3
29,349,349,24,5,19,2,1
4,353,353,46,46,0,1,0
5,357,357,111,35,76,3,2
37,369,369,46,46,0,1,0
14,378,378,25,25,0,1,0
25,380,380,7,2,5,2,1
12,383,383,69,69,0,1,0
20,391,391,12,1,11,3,2
24,405,405,29,11,18,4,3
39,407,407,9,2,7,2,1
28,418,418,48,48,0,1,0
31,424,424,17,8,9,4,3
13,444,444,24,12,12,4,3
11,446,446,77,77,0,1,0
32,452,452,45,10,35,2,1
38,462,462,17,17,0,1,0
10,483,483,8,8,0,1,0

8,101,101,1,1,0,1,0
29,115,115,26,26,0,1,0
15,117,117,33,33,0,1,0
17,125,125,12,5,7,2,1
28,139,139,2,2,0,1,0
19,150,150,13,13,0,1,0
30,183,183,7,7,0,1,0
0,192,192,88,49,39,4,3
2,204,204,39,39,0,1,0
24,206,206,19,19,0,1,0
12,214,214,4,4,0,1,0
18,214,214,28,28,0,1,0
6,220,220,36,23,13,2,1
9,221,221,31,20,11,2,1
22,241,241,14,1,13,2,1
14,249,249,15,4,11,2,1
3,252,252,6,6,0,1,0
26,272,272,24,4,20,3,2
7,277,277,2,2,0,1,0
4,328,328,30,30,0,1,0
27,336,336,8,8,0,1,0
13,349,349,16,8,8,2,1
10,356,356,19,5,14,4,3
16,359,359,54,54,0,1,0
11,370,370,35,8,27,4,3
5,373,373,35,35,0,1,0
1,375,375,171,171,0,1,0
21,378,378,39,6,33,2,1
20,467,467,32,32,0,1,0
23,469,469,68,40,28,4,3
25,496,496,69,34,35,2,1

9,114,114,10,10,0,1,0
25,130,130,1,1,0,1,0
22,134,134,21,3,18,4,3
28,142,142,10,10,0,1,0
18,165,165,25,25,0,1,0
10,195,195,35,13,22,3,2
23,200,200,34,34,0,1,0
3,201,201,14,14,0,1,0
5,201,201,8,5,3,2,1
26,212,212,14,8,6,3,2
19,212,212,2,2,0,1,0
29,234,234,5,5,0,1,0
0,253,253,3,3,0,1,0
30,269,269,17,17,0,1,0
16,277,277,15,15,0,1,0
11,299,299,23,23,0,1,0
8,317,317,10,1,9,2,1
27,326,326,101,65,36,3,2
12,333,333,33,30,3,2,1
21,333,333,12,12,0,1,0
6,345,345,1,1,0,1,0
2,386,386,10,4,6,3,2
15,396,396,31,2,29,2,1
17,405,405,6,6,0,1,0
1,421,421,37,7,30,2,1
14,424,424,144,72,72,4,3
24,424,424,78,78,0,1,0
32,429,429,97,31,66,4,3
13,435,435,205,175,30,4,3
20,461,461,74,29,45,2,1
7,476,476,84,8,76,3,2
31,487,487,29,29,0,1,0
4,494,494,50,50,0,1,0

17,113,113,7,7,0,1,0
25,136,136,12,2,10,3,2
11,156,156,9,9,0,1,0
14,162,162,7,4,3,2,1
23,167,167,19,9,10,2,1
13,189,189,23,23,0,1,0
8,190,190,6,2,4,2,1
1,207,207,32,32,0,1,0
0,228,228,38,38,0,1,0
18,242,242,6,6,0,1,0
4,243,243,30,7,23,4,3
5,248,248,117,3,114,4,3
21,253,253,57,35,22,2,1
3,254,254,42,10,32,3,2
16,255,255,14,14,0,1,0
7,262,262,1,1,0,1,0
9,266,266,91,91,0,1,0
26,266,266,23,23,0,1,0
22,282,282,28,6,22,3,2
12,283,283,8,8,0,1,0
10,286,286,27,23,4,2,1
24,287,287,13,5,8,3,2
2,313,313,37,37,0,1,0
19,339,339,86,65,21,4,3
29,409,409,42,4,38,4,3
6,433,433,32,12,20,2,1
15,434,434,92,72,20,2,1
20,460,460,63,63,0,1,0
28,472,472,37,37,0,1,0
27,487,487,24,24,0,1,0

33,102,102,14,14,0,1,0
9,117,117,2,2,0,1,0
12,122,122,2,2,0,1,0
17,139,139,1,1,0,1,0
20,143,143,14,2,12,3,2
18,166,166,15,5,10,2,1
29,168,168,7,7,0,1,0
30,172,172,49,49,0,1,0
26,172,172,4,4,0,1,0
4,179,179,1,1,0,1,0
23,185,185,22,2,20,3,2
6,190,190,5,5,0,1,0
42,190,190,11,11,0,1,0
16,195,195,3,3,0,1,0
38,200,200,41,41,0,1,0
36,211,211,19,19,0,1,0
7,250,250,30,7,23,2,1
22,261,261,14,6,8,2,1
34,268,268,6,3,3,2,1
35,281,281,3,3,0,1,0
5,293,293,34,28,6,3,2
19,318,318,6,2,4,2,1
41,323,323,24,14,10,3,2
10,325,325,89,81,8,2,1
37,339,339,47,47,0,1,0
13,340,340,27,27,0,1,0
1,354,354,6,1,5,2,1
2,359,359,1,1,0,1,0
15,362,362,27,27,0,1,0
0,363,363,3,3,0,1,0
11,383,383,2,2,0,1,0
31,399,399,14,14,0,1,0
24,399,399,49,8,41,2,1
39,425,425,26,26,0,1,0
21,431,431,63,26,37,2,1
40,448,448,20,5,15,2,1
27,452,452,69,69,0,1,0
32,467,467,42,42,0,1,0
8,481,481,34,34,0,1,0
3,483,483,90,54,36,3,2
14,486,486,54,14,40,4,3
25,490,490,172,138,34,2,1
28,493,493,6,6,0,1,0

20,108,108,20,20,0,1,0
13,108,108,9,1,8,2,1
15,113,113,1,1,0,1,0
21,113,113,3,3,0,1,0
7,125,125,1,1,0,1,0
25,127,127,15,15,0,1,0
36,154,154,4,4,0,1,0
18,170,170,34,3,31,2,1
24,178,178,9,9,0,1,0
37,179,179,11,11,0,1,0
31,205,205,6,6,0,1,0
28,252,252,39,39,0,1,0
1,252,252,37,37,0,1,0
35,265,265,9,6,3,2,1
14,265,265,19,19,0,1,0
38,273,273,75,26,49,3,2
10,288,288,44,23,21,4,3
33,289,289,39,25,14,2,1
32,292,292,7,4,3,2,1
19,292,292,44,44,0,1,0
27,303,303,35,35,0,1,0
4,330,330,18,7,11,2,1
29,330,330,59,59,0,1,0
23,331,331,8,8,0,1,0
3,337,337,22,22,0,1,0
2,338,338,6,6,0,1,0
8,353,353,42,42,0,1,0
5,355,355,7,7,0,1,0
22,365,365,4,4,0,1,0
11,375,375,24,4,20,2,1
9,376,376,27,27,0,1,0
0,394,394,16,16,0,1,0
34,418,418,146,94,52,3,2
30,428,428,50,44,6,2,1
12,430,430,42,9,33,4,3
16,449,449,46,46,0,1,0
39,474,474,5,5,0,1,0
26,474,474,58,8,50,3,2
6,482,482,1,1,0,1,0
17,499,499,57,57,0,1,0

11,104,104,26,9,17,2,1
12,114,114,1,1,0,1,0
36,136,136,10,10,0,1,0
30,148,148,2,2,0,1,0
13,152,152,26,6,20,4,3
25,159,159,6,6,0,1,0
28,171,171,2,2,0,1,0
0,176,176,9,9,0,1,0
35,191,191,3,3,0,1,0
16,203,203,24,9,15,2,1
15,205,205,9,9,0,1,0
17,211,211,4,4,0,1,0
32,222,222,32,32,0,1,0
21,228,228,7,7,0,1,0
23,252,252,75,46,29,3,2
37,266,266,1,1,0,1,0
19,268,268,42,42,0,1,0
8,281,281,1,1,0,1,0
9,302,302,4,1,3,2,1
24,307,307,15,2,13,2,1
22,310,310,13,9,4,2,1
14,337,337,91,69,22,2,1
34,341,341,198,198,0,1,0
10,346,346,30,8,22,3,2
5,386,386,17,7,10,3,2
2,389,389,10,10,0,1,0
20,421,421,5,5,0,1,0
27,442,442,38,18,20,2,1
18,448,448,35,35,0,1,0
3,449,449,28,28,0,1,0
26,451,451,55,17,38,2,1
38,460,460,16,16,0,1,0
29,460,460,51,24,27,4,3
7,464,464,156,156,0,1,0
33,467,467,61,61,0,1,0
4,468,468,3,3,0,1,0
31,483,483,19,19,0,1,0
1,483,483,5,2,3,2,1
6,493,493,17,14,3,2,1

27,109,109,11,4,7,2,1
14,116,116,1,1,0,1,0
21,130,130,7,7,0,1,0
5,143,143,32,32,0,1,0
3,158,158,30,11,19,2,1
4,195,195,31,31,0,1,0
15,218,218,32,8,24,4,3
33,227,227,33,3,30,4,3
13,240,240,26,26,0,1,0
25,242,242,25,19,6,2,1
0,248,248,6,6,0,1,0
8,255,255,11,11,0,1,0
30,264,264,13,13,0,1,0
20,265,265,6,6,0,1,0
17,275,275,12,12,0,1,0
32,281,281,36,36,0,1,0
24,291,291,6,6,0,1,0
10,295,295,49,49,0,1,0
28,300,300,128,128,0,1,0
29,300,300,108,59,49,2,1
1,301,301,7,7,0,1,0
7,307,307,12,12,0,1,0
16,310,310,6,6,0,1,0
31,327,327,27,6,21,2,1
34,368,368,5,5,0,1,0
23,383,383,36,36,0,1,0
2,394,394,10,10,0,1,0
12,395,395,9,1,8,2,1
26,427,427,51,27,24,4,3
6,449,449,211,149,62,3,2
11,459,459,20,15,5,2,1
19,461,461,15,6,9,2,1
18,472,472,14,11,3,2,1
9,479,479,43,31,12,2,1
22,487,487,3,3,0,1,0

29,101,101,4,4,0,1,0
28,108,108,4,4,0,1,0
7,112,112,11,4,7,2,1
8,120,120,1,1,0,1,0
22,125,125,3,3,0,1,0
23,128,128,6,6,0,1,0
25,129,129,19,19,0,1,0
13,135,135,16,16,0,1,0
4,141,141,3,3,0,1,0
5,147,147,22,22,0,1,0
2,152,152,55,55,0,1,0
0,219,219,19,8,11,2,1
17,234,234,2,2,0,1,0
11,250,250,5,5,0,1,0
14,257,257,11,11,0,1,0
24,257,257,105,57,48,3,2
27,257,257,16,10,6,3,2
30,260,260,11,11,0,1,0
10,291,291,65,39,26,2,1
15,304,304,77,33,44,3,2
26,308,308,10,10,0,1,0
9,363,363,109,109,0,1,0
21,365,365,99,99,0,1,0
12,369,369,33,33,0,1,0
31,370,370,4,4,0,1,0
3,411,411,50,50,0,1,0
1,432,432,64,20,44,3,2
16,446,446,3,3,0,1,0
6,473,473,26,26,0,1,0
20,480,480,133,133,0,1,0
18,480,480,23,23,0,1,0
19,489,489,40,12,28,2,1

5,108,108,35,35,0,1,0
24,118,118,1,1,0,1,0
12,119,119,7,2,5,2,1
19,123,123,26,26,0,1,0
20,136,136,6,6,0,1,0
10,155,155,2,2,0,1,0
32,176,176,11,8,3,2,1
23,230,230,7,7,0,1,0
9,256,256,64,12,52,3,2
2,273,273,17,8,9,4,3
14,279,279,18,18,0,1,0
18,279,279,10,6,4,2,1
17,282,282,24,24,0,1,0
27,286,286,75,75,0,1,0
30,295,295,1,1,0,1,0
29,295,295,75,26,49,2,1
3,307,307,6,6,0,1,0
6,315,315,11,1,10,2,1
11,334,334,19,19,0,1,0
1,342,342,3,3,0,1,0
33,352,352,23,4,19,2,1
13,377,377,44,39,5,2,1
21,379,379,13,13,0,1,0
22,387,387,15,2,13,2,1
16,388,388,10,5,5,2,1
25,395,395,82,82,0,1,0
31,411,411,123,98,25,3,2
8,418,418,57,57,0,1,0
26,427,427,15,12,3,2,1
4,433,433,21,21,0,1,0
7,438,438,222,123,99,4,3
0,447,447,17,3,14,2,1
28,485,485,67,34,33,4,3
15,493,493,30,24,6,2,1

5,101,101,27,27,0,1,0
23,109,109,27,27,0,1,0
20,148,148,5,2,3,2,1
19,150,150,4,4,0,1,0
31,184,184,22,12,10,3,2
36,198,198,42,16,26,2,1
7,211,211,1,1,0,1,0
14,226,226,12,12,0,1,0
22,245,245,6,6,0,1,0
4,267,267,20,20,0,1,0
2,274,274,131,81,50,2,1
26,288,288,1,1,0,1,0
30,315,315,57,27,30,2,1
21,318,318,25,1,24,3,2
10,322,322,2,2,0,1,0
35,344,344,30,9,21,4,3
13,361,361,2,2,0,1,0
8,361,361,40,28,12,3,2
28,362,362,78,40,38,2,1
33,368,368,26,5,21,4,3
16,370,370,26,26,0,1,0
11,371,371,62,62,0,1,0
15,371,371,9,9,0,1,0
27,380,380,12,12,0,1,0
25,409,409,64,25,39,4,3
18,413,413,17,1,16,2,1
9,421,421,13,8,5,2,1
32,442,442,6,1,5,2,1
17,447,447,33,12,21,2,1
12,448,448,47,47,0,1,0
29,448,448,8,8,0,1,0
34,449,449,19,19,0,1,0
3,452,452,12,1,11,2,1
0,452,452,22,14,8,2,1
24,485,485,132,111,21,2,1
6,487,487,15,15,0,1,0
1,494,494,90,27,63,4,3

35,102,102,2,2,0,1,0
27,107,107,2,2,0,1,0
12,107,107,22,22,0,1,0
25,109,109,2,2,0,1,0
6,125,125,10,10,0,1,0
38,137,137,27,4,23,2,1
31,139,139,19,8,11,2,1
18,142,142,1,1,0,1,0
15,164,164,4,4,0,1,0
7,170,170,2,2,0,1,0
26,181,181,1,1,0,1,0
3,183,183,6,6,0,1,0
11,196,196,13,13,0,1,0
4,202,202,3,3,0,1,0
39,211,211,15,3,12,2,1
28,215,215,88,41,47,2,1
30,227,227,57,57,0,1,0
16,230,230,10,10,0,1,0
41,236,236,11,11,0,1,0
42,237,237,10,10,0,1,0
9,245,245,31,7,24,3,2
21,254,254,26,26,0,1,0
22,261,261,19,12,7,2,1
40,279,279,60,30,30,2,1
37,287,287,47,22,25,2,1
36,291,291,11,11,0,1,0
8,298,298,26,2,24,4,3
14,331,331,5,1,4,2,1
10,337,337,36,33,3,2,1
24,340,340,18,18,0,1,0
32,342,342,25,25,0,1,0
19,363,363,25,25,0,1,0
33,363,363,12,4,8,3,2
2,375,375,21,21,0,1,0
34,414,414,22,22,0,1,0
1,438,438,31,31,0,1,0
20,445,445,7,7,0,1,0
43,447,447,26,26,0,1,0
17,449,449,46,30,16,3,2
0,463,463,8,8,0,1,0
5,493,493,162,62,100,4,3
23,494,494,11,11,0,1,0
29,498,498,4,4,0,1,0
13,499,499,29,11,18,3,2

9,100,100,4,4,0,1,0
10,114,114,26,26,0,1,0
4,125,125,5,1,4,2,1
17,128,128,4,1,3,2,1
7,128,128,7,7,0,1,0
0,135,135,2,2,0,1,0
13,148,148,9,9,0,1,0
2,151,151,3,3,0,1,0
32,159,159,29,2,27,4,3
16,165,165,21,1,20,2,1
1,200,200,1,1,0,1,0
22,207,207,4,4,0,1,0
19,227,227,46,46,0,1,0
21,233,233,44,44,0,1,0
3,236,236,11,6,5,2,1
35,245,245,3,3,0,1,0
24,260,260,2,2,0,1,0
23,264,264,1,1,0,1,0
12,267,267,120,120,0,1,0
26,273,273,56,56,0,1,0
20,278,278,19,19,0,1,0
25,311,311,22,22,0,1,0
18,314,314,36,36,0,1,0
29,319,319,21,21,0,1,0
6,321,321,25,3,22,3,2
34,323,323,17,13,4,2,1
5,330,330,20,20,0,1,0
8,333,333,1,1,0,1,0
15,358,358,5,5,0,1,0
28,430,430,12,12,0,1,0
14,442,442,156,80,76,3,2
33,478,478,73,73,0,1,0
11,487,487,87,59,28,2,1
31,489,489,177,79,98,3,2
30,498,498,25,25,0,1,0
27,500,500,22,22,0,1,0

23,108,108,20,8,12,4,3
26,109,109,1,1,0,1,0
20,121,121,1,1,0,1,0
16,125,125,21,6,15,4,3
7,135,135,12,2,10,2,1
15,144,144,7,4,3,2,1
25,165,165,5,1,4,2,1
18,168,168,14,14,0,1,0
5,180,180,10,10,0,1,0
30,192,192,52,52,0,1,0
3,199,199,10,10,0,1,0
29,215,215,3,3,0,1,0
8,215,215,114,82,32,3,2
6,218,218,2,2,0,1,0
28,274,274,14,14,0,1,0
1,283,283,36,36,0,1,0
27,286,286,24,24,0,1,0
10,287,287,12,12,0,1,0
13,344,344,54,15,39,2,1
9,356,356,65,65,0,1,0
4,363,363,41,41,0,1,0
19,389,389,84,84,0,1,0
11,402,402,1,1,0,1,0
2,420,420,159,149,10,4,3
31,429,429,71,71,0,1,0
14,439,439,32,32,0,1,0
22,447,447,16,6,10,2,1
24,462,462,65,11,54,3,2
17,468,468,84,53,31,2,1
0,468,468,3,3,0,1,0
12,469,469,27,27,0,1,0
21,485,485,41,8,33,4,3

25,110,110,12,12,0,1,0
21,113,113,1,1,0,1,0
4,123,123,5,5,0,1,0
19,123,123,6,6,0,1,0
1,130,130,17,17,0,1,0
23,139,139,1,1,0,1,0
36,139,139,43,25,18,3,2
7,141,141,1,1,0,1,0
41,144,144,14,6,8,2,1
16,152,152,1,1,0,1,0
26,158,158,1,1,0,1,0
24,162,162,3,3,0,1,0
42,163,163,14,14,0,1,0
9,166,166,8,8,0,1,0
40,177,177,15,12,3,2,1
6,178,178,7,7,0,1,0
32,185,185,2,2,0,1,0
11,195,195,25,25,0,1,0
39,215,215,20,20,0,1,0
3,219,219,1,1,0,1,0
10,219,219,58,53,5,2,1
0,237,237,2,2,0,1,0
20,253,253,12,12,0,1,0
22,254,254,40,25,15,4,3
38,295,295,10,4,6,2,1
2,337,337,3,3,0,1,0
12,344,344,2,2,0,1,0
15,355,355,20,20,0,1,0
31,358,358,20,13,7,2,1
44,359,359,21,21,0,1,0
14,375,375,2,2,0,1,0
28,382,382,44,44,0,1,0
18,388,388,5,5,0,1,0
35,389,389,67,31,36,3,2
17,418,418,34,34,0,1,0
34,438,438,109,40,69,3,2
8,439,439,166,120,46,3,2
30,440,440,29,6,23,4,3
33,441,441,49,37,12,3,2
37,442,442,51,11,40,2,1
27,451,451,43,43,0,1,0
43,467,467,19,19,0,1,0
13,482,482,68,39,29,2,1
29,488,488,17,8,9,4,3
5,497,497,14,14,0,1,0

5,101,101,19,4,15,2,1
1,102,102,4,4,0,1,0
25,108,108,4,4,0,1,0
35,127,127,11,3,8,2,1
20,143,143,24,24,0,1,0
13,153,153,12,12,0,1,0
14,160,160,11,7,4,2,1
36,171,171,15,9,6,2,1
31,191,191,8,8,0,1,0
32,194,194,12,12,0,1,0
17,197,197,78,41,37,2,1
10,206,206,44,44,0,1,0
8,214,214,2,2,0,1,0
7,232,232,15,15,0,1,0
4,237,237,8,8,0,1,0
29,239,239,26,16,10,3,2
3,247,247,5,5,0,1,0
12,282,282,6,6,0,1,0
11,283,283,6,6,0,1,0
9,286,286,1,1,0,1,0
26,292,292,7,7,0,1,0
0,305,305,40,40,0,1,0
21,318,318,43,19,24,4,3
23,318,318,74,16,58,4,3
24,331,331,33,2,31,2,1
6,361,361,56,22,34,3,2
30,366,366,40,40,0,1,0
34,374,374,90,40,50,4,3
22,392,392,55,25,30,4,3
2,400,400,55,55,0,1,0
19,410,410,8,8,0,1,0
28,421,421,4,4,0,1,0
15,438,438,5,1,4,2,1
16,439,439,41,2,39,4,3
18,447,447,51,51,0,1,0
33,457,457,87,45,42,4,3
27,471,471,20,10,10,2,1

17,100,100,10,4,6,2,1
9,103,103,1,1,0,1,0
21,123,123,1,1,0,1,0
8,123,123,20,20,0,1,0
1,131,131,13,13,0,1,0
11,139,139,12,8,4,2,1
4,141,141,8,8,0,1,0
27,145,145,1,1,0,1,0
19,152,152,30,7,23,2,1
22,171,171,5,2,3,2,1
6,197,197,9,9,0,1,0
23,211,211,3,3,0,1,0
31,212,212,37,37,0,1,0
7,226,226,12,12,0,1,0
20,229,229,9,9,0,1,0
28,238,238,17,5,12,3,2
25,266,266,3,3,0,1,0
13,294,294,65,45,20,3,2
36,314,314,50,50,0,1,0
3,321,321,22,22,0,1,0
34,333,333,36,2,34,3,2
33,334,334,37,11,26,4,3
16,349,349,21,21,0,1,0
26,352,352,111,111,0,1,0
24,353,353,64,64,0,1,0
12,382,382,2,2,0,1,0
2,397,397,72,51,21,4,3
15,401,401,28,19,9,4,3
18,402,402,62,62,0,1,0
0,407,407,77,67,10,3,2
10,413,413,36,3,33,2,1
35,415,415,3,3,0,1,0
32,417,417,2,2,0,1,0
30,452,452,167,89,78,4,3
5,455,455,4,4,0,1,0
14,458,458,65,65,0,1,0
29,463,463,14,14,0,1,0

3,100,100,1,1,0,1,0
1,118,118,9,2,7,2,1
22,159,159,1,1,0,1,0
32,173,173,25,25,0,1,0
0,173,173,12,6,6,3,2
13,181,181,34,14,20,2,1
26,185,185,7,7,0,1,0
24,192,192,9,3,6,2,1
7,193,193,47,30,17,2,1
27,203,203,40,40,0,1,0
33,214,214,6,6,0,1,0
5,237,237,10,10,0,1,0
12,245,245,26,2,24,2,1
19,263,263,76,31,45,4,3
15,276,276,9,4,5,2,1
21,283,283,68,68,0,1,0
9,295,295,47,3,44,2,1
28,300,300,127,127,0,1,0
14,305,305,29,20,9,4,3
25,309,309,2,2,0,1,0
2,328,328,11,11,0,1,0
20,348,348,24,15,9,4,3
10,371,371,146,128,18,4,3
11,372,372,49,4,45,2,1
4,383,383,20,5,15,2,1
23,398,398,13,13,0,1,0
30,419,419,30,1,29,2,1
18,419,419,61,61,0,1,0
29,424,424,17,17,0,1,0
8,429,429,39,39,0,1,0
16,448,448,8,8,0,1,0
31,462,462,2,2,0,1,0
17,481,481,8,8,0,1,0
34,486,486,16,11,5,2,1
6,495,495,29,29,0,1,0

41,100,100,12,12,0,1,0
20,110,110,1,1,0,1,0
36,114,114,39,9,30,4,3
32,119,119,8,8,0,1,0
31,135,135,22,14,8,3,2
15,137,137,22,17,5,2,1
39,153,153,6,6,0,1,0
27,160,160,21,3,18,3,2
1,161,161,1,1,0,1,0
18,166,166,2,2,0,1,0
8,188,188,35,18,17,2,1
44,190,190,6,6,0,1,0
25,192,192,2,2,0,1,0
6,203,203,3,3,0,1,0
19,204,204,6,6,0,1,0
9,206,206,20,20,0,1,0
16,223,223,20,14,6,3,2
0,229,229,8,8,0,1,0
2,232,232,2,2,0,1,0
13,259,259,12,8,4,2,1
21,276,276,24,24,0,1,0
4,276,276,1,1,0,1,0
10,283,283,21,21,0,1,0
17,283,283,35,35,0,1,0
43,293,293,34,34,0,1,0
37,300,300,41,36,5,2,1
45,310,310,7,3,4,2,1
22,327,327,4,4,0,1,0
28,328,328,43,43,0,1,0
34,334,334,22,12,10,2,1
5,338,338,4,1,3,2,1
12,340,340,40,40,0,1,0
14,342,342,1,1,0,1,0
7,365,365,5,5,0,1,0
40,374,374,26,26,0,1,0
23,379,379,55,55,0,1,0
26,403,403,9,9,0,1,0
3,409,409,51,4,47,4,3
11,419,419,20,20,0,1,0
35,421,421,31,18,13,2,1
38,424,424,27,27,0,1,0
24,438,438,21,9,12,4,3
46,450,450,125,125,0,1,0
42,453,453,41,23,18,3,2
29,463,463,52,45,7,2,1
30,470,470,12,12,0,1,0
33,500,500,11,5,6,2,1

13,123,123,28,28,0,1,0
25,133,133,7,7,0,1,0
5,143,143,1,1,0,1,0
33,150,150,10,3,7,2,1
6,162,162,4,4,0,1,0
9,164,164,23,5,18,4,3
28,169,169,4,4,0,1,0
32,175,175,5,5,0,1,0
0,187,187,59,59,0,1,0
19,189,189,6,6,0,1,0
16,195,195,3,3,0,1,0
8,202,202,4,4,0,1,0
30,206,206,30,24,6,2,1
14,207,207,7,7,0,1,0
10,227,227,19,19,0,1,0
21,232,232,46,8,38,2,1
35,265,265,3,3,0,1,0
3,311,311,95,95,0,1,0
20,315,315,2,2,0,1,0
29,316,316,18,12,6,2,1
34,348,348,41,5,36,2,1
15,349,349,26,26,0,1,0
7,392,392,5,5,0,1,0
17,393,393,46,19,27,2,1
27,403,403,56,36,20,2,1
11,403,403,13,13,0,1,0
31,406,406,52,16,36,4,3
22,422,422,202,136,66,3,2
18,427,427,39,39,0,1,0
26,435,435,16,16,0,1,0
12,440,440,42,42,0,1,0
4,453,453,46,46,0,1,0
24,458,458,91,91,0,1,0
1,468,468,51,11,40,3,2
2,484,484,41,23,18,2,1
23,495,495,17,9,8,2,1

3,110,110,19,3,16,3,2
0,121,121,1,1,0,1,0
21,147,147,30,30,0,1,0
12,161,161,4,4,0,1,0
15,167,167,17,17,0,1,0
1,168,168,5,2,3,2,1
27,179,179,4,4,0,1,0
24,193,193,14,14,0,1,0
20,207,207,23,23,0,1,0
9,240,240,50,16,34,4,3
8,243,243,71,17,54,3,2
14,251,251,38,19,19,2,1
16,251,251,1,1,0,1,0
33,277,277,21,21,0,1,0
29,279,279,37,15,22,3,2
7,289,289,26,10,16,2,1
19,316,316,28,28,0,1,0
18,318,318,154,154,0,1,0
30,335,335,49,49,0,1,0
28,347,347,24,2,22,3,2
23,347,347,10,10,0,1,0
26,356,356,18,9,9,2,1
17,362,362,20,20,0,1,0
13,363,363,38,38,0,1,0
34,371,371,7,7,0,1,0
32,375,375,13,2,11,3,2
11,377,377,4,4,0,1,0
31,378,378,16,16,0,1,0
25,409,409,11,11,0,1,0
10,412,412,12,12,0,1,0
2,432,432,115,33,82,4,3
35,440,440,8,8,0,1,0
6,455,455,38,1,37,4,3
22,463,463,93,88,5,2,1
5,463,463,36,16,20,2,1
4,489,489,44,44,0,1,0

30,106,106,7,7,0,1,0
2,108,108,1,1,0,1,0
10,123,123,6,6,0,1,0
23,124,124,27,27,0,1,0
20,131,131,10,10,0,1,0
6,138,138,54,54,0,1,0
29,157,157,2,2,0,1,0
12,180,180,1,1,0,1,0
7,193,193,11,11,0,1,0
19,216,216,20,10,10,3,2
5,220,220,45,22,23,2,1
32,243,243,4,4,0,1,0
0,258,258,11,11,0,1,0
22,270,270,14,4,10,3,2
24,274,274,17,17,0,1,0
13,318,318,72,60,12,2,1
4,323,323,44,44,0,1,0
1,334,334,8,8,0,1,0
11,335,335,53,53,0,1,0
31,353,353,58,58,0,1,0
17,383,383,98,62,36,3,2
15,387,387,13,13,0,1,0
21,394,394,31,31,0,1,0
27,398,398,4,1,3,2,1
28,410,410,127,75,52,4,3
14,413,413,17,3,14,2,1
3,416,416,29,7,22,2,1
9,420,420,105,87,18,4,3
25,439,439,101,65,36,4,3
18,445,445,1,1,0,1,0
33,459,459,35,35,0,1,0
26,475,475,12,12,0,1,0
8,476,476,49,49,0,1,0
16,488,488,42,18,24,4,3

11,111,111,4,4,0,1,0
5,139,139,15,3,12,4,3
12,146,146,16,4,12,2,1
0,163,163,60,39,21,4,3
25,166,166,3,3,0,1,0
7,170,170,1,1,0,1,0
29,171,171,33,33,0,1,0
10,173,173,8,8,0,1,0
28,177,177,34,34,0,1,0
18,187,187,16,16,0,1,0
1,204,204,31,11,20,2,1
26,221,221,17,17,0,1,0
13,222,222,10,4,6,2,1
14,242,242,30,6,24,2,1
19,249,249,3,3,0,1,0
9,268,268,76,58,18,3,2
33,290,290,42,42,0,1,0
15,293,293,34,12,22,4,3
24,307,307,12,12,0,1,0
3,322,322,14,14,0,1,0
27,326,326,40,12,28,2,1
8,347,347,25,7,18,4,3
17,351,351,1,1,0,1,0
4,364,364,11,11,0,1,0
16,378,378,2,2,0,1,0
23,381,381,31,11,20,3,2
21,392,392,75,55,20,2,1
34,399,399,20,8,12,4,3
20,408,408,54,54,0,1,0
30,422,422,17,17,0,1,0
6,431,431,45,45,0,1,0
2,438,438,66,66,0,1,0
22,459,459,23,23,0,1,0
32,460,460,104,58,46,4,3
31,462,462,80,80,0,1,0

31,104,104,4,4,0,1,0
18,118,118,1,1,0,1,0
1,126,126,10,4,6,3,2
10,148,148,11,8,3,2,1
11,155,155,4,4,0,1,0
20,174,174,53,33,20,3,2
33,199,199,7,7,0,1,0
34,219,219,26,26,0,1,0
7,277,277,1,1,0,1,0
15,280,280,30,30,0,1,0
21,288,288,26,26,0,1,0
25,294,294,65,53,12,2,1
32,298,298,77,77,0,1,0
4,315,315,134,74,60,4,3
9,319,319,18,18,0,1,0
0,320,320,70,70,0,1,0
19,335,335,19,19,0,1,0
27,336,336,60,19,41,2,1
23,341,341,6,6,0,1,0
5,343,343,7,7,0,1,0
3,351,351,73,35,38,2,1
28,353,353,80,80,0,1,0
30,367,367,10,10,0,1,0
29,371,371,2,2,0,1,0
16,389,389,17,6,11,2,1
26,393,393,32,32,0,1,0
13,397,397,9,9,0,1,0
8,424,424,10,10,0,1,0
14,425,425,38,14,24,2,1
12,439,439,161,74,87,4,3
17,451,451,17,11,6,3,2
22,455,455,50,50,0,1,0
2,457,457,15,6,9,4,3
24,476,476,11,11,0,1,0
6,489,489,1,1,0,1,0

8,106,106,12,12,0,1,0
13,107,107,4,4,0,1,0
10,113,113,2,2,0,1,0
33,116,116,19,19,0,1,0
6,117,117,3,3,0,1,0
20,121,121,1,1,0,1,0
3,128,128,6,6,0,1,0
32,129,129,2,2,0,1,0
34,229,229,14,4,10,2,1
9,230,230,26,26,0,1,0
26,232,232,13,13,0,1,0
1,244,244,56,56,0,1,0
30,252,252,23,9,14,2,1
4,273,273,16,16,0,1,0
24,277,277,11,11,0,1,0
25,286,286,29,17,12,3,2
14,292,292,171,27,144,4,3
37,294,294,39,9,30,4,3
18,307,307,3,3,0,1,0
35,309,309,10,10,0,1,0
2,317,317,1,1,0,1,0
7,317,317,46,46,0,1,0
27,336,336,28,18,10,2,1
19,345,345,19,5,14,3,2
29,350,350,79,40,39,4,3
22,356,356,4,4,0,1,0
11,379,379,12,9,3,2,1
21,394,394,154,154,0,1,0
12,414,414,45,45,0,1,0
16,419,419,42,42,0,1,0
23,422,422,30,30,0,1,0
36,425,425,125,40,85,4,3
31,430,430,7,7,0,1,0
15,432,432,25,1,24,4,3
5,460,460,17,3,14,2,1
0,475,475,1,1,0,1,0
28,479,479,19,19,0,1,0
17,488,488,12,12,0,1,0

20,106,106,5,5,0,1,0
23,106,106,11,11,0,1,0
19,110,110,33,33,0,1,0
9,112,112,14,14,0,1,0
13,122,122,16,16,0,1,0
25,124,124,26,14,12,3,2
1,149,149,8,8,0,1,0
2,150,150,30,21,9,2,1
0,175,175,45,45,0,1,0
26,252,252,46,46,0,1,0
11,264,264,31,31,0,1,0
14,275,275,31,24,7,2,1
12,277,277,3,3,0,1,0
32,282,282,10,7,3,2,1
27,285,285,8,3,5,2,1
4,290,290,4,4,0,1,0
28,296,296,27,5,22,2,1
5,298,298,24,24,0,1,0
10,310,310,122,122,0,1,0
24,312,312,16,16,0,1,0
21,314,314,10,10,0,1,0
7,336,336,13,4,9,3,2
3,349,349,19,19,0,1,0
6,382,382,43,19,24,2,1
15,425,425,33,33,0,1,0
18,434,434,9,2,7,2,1
31,440,440,37,37,0,1,0
8,445,445,10,5,5,2,1
29,460,460,4,4,0,1,0
33,467,467,34,34,0,1,0
30,467,467,37,37,0,1,0
17,476,476,36,36,0,1,0
22,482,482,193,103,90,4,3
16,485,485,7,7,0,1,0

23,105,105,8,8,0,1,0
18,107,107,21,5,16,2,1
12,128,128,14,2,12,3,2
0,146,146,6,2,4,2,1
27,147,147,21,21,0,1,0
3,150,150,16,4,12,3,2
25,153,153,24,24,0,1,0
31,176,176,54,54,0,1,0
26,193,193,8,8,0,1,0
5,195,195,1,1,0,1,0
10,197,197,14,14,0,1,0
19,199,199,13,5,8,2,1
14,210,210,103,71,32,4,3
20,221,221,14,3,11,2,1
9,224,224,3,3,0,1,0
1,233,233,7,7,0,1,0
16,246,246,26,26,0,1,0
2,270,270,4,1,3,2,1
32,284,284,6,1,5,2,1
11,289,289,1,1,0,1,0
24,291,291,27,11,16,3,2
29,309,309,10,10,0,1,0
15,335,335,44,44,0,1,0
21,351,351,10,10,0,1,0
22,372,372,2,2,0,1,0
13,403,403,21,6,15,4,3
8,408,408,28,4,24,2,1
30,414,414,11,11,0,1,0
7,438,438,161,161,0,1,0
6,438,438,45,14,31,2,1
4,463,463,150,111,39,4,3
17,467,467,41,41,0,1,0
28,474,474,122,107,15,2,1

9,101,101,1,1,0,1,0
33,108,108,32,32,0,1,0
31,121,121,13,13,0,1,0
16,132,132,4,4,0,1,0
25,135,135,17,3,14,3,2
4,136,136,28,22,6,2,1
3,141,141,15,15,0,1,0
13,165,165,15,15,0,1,0
18,168,168,71,53,18,3,2
15,182,182,5,5,0,1,0
11,188,188,11,8,3,2,1
6,194,194,1,1,0,1,0
27,194,194,5,2,3,2,1
19,214,214,21,11,10,2,1
8,215,215,12,12,0,1,0
30,242,242,9,2,7,2,1
17,257,257,5,2,3,2,1
7,264,264,19,19,0,1,0
2,275,275,67,10,57,4,3
24,286,286,21,21,0,1,0
34,308,308,18,3,15,2,1
23,325,325,15,6,9,4,3
14,325,325,29,29,0,1,0
21,326,326,39,12,27,4,3
0,340,340,45,45,0,1,0
1,361,361,57,7,50,3,2
10,374,374,66,4,62,4,3
32,386,386,52,40,12,2,1
28,391,391,55,14,41,2,1
20,406,406,10,10,0,1,0
12,451,451,8,8,0,1,0
22,452,452,18,18,0,1,0
29,455,455,1,1,0,1,0
5,477,477,155,155,0,1,0
26,498,498,30,7,23,2,1

11,115,115,13,3,10,2,1
3,130,130,18,18,0,1,0
19,131,131,5,5,0,1,0
18,134,134,2,2,0,1,0
22,145,145,6,6,0,1,0
16,159,159,13,13,0,1,0
5,176,176,59,41,18,4,3
31,177,177,22,15,7,2,1
4,181,181,37,37,0,1,0
32,195,195,91,23,68,3,2
29,220,220,65,65,0,1,0
34,238,238,16,7,9,4,3
8,241,241,38,17,21,4,3
28,244,244,7,7,0,1,0
33,253,253,30,30,0,1,0
24,258,258,7,1,6,3,2
25,277,277,14,8,6,2,1
23,281,281,7,7,0,1,0
13,290,290,3,3,0,1,0
26,344,344,5,5,0,1,0
15,353,353,13,3,10,2,1
2,366,366,11,1,10,2,1
14,369,369,91,66,25,2,1
9,386,386,26,26,0,1,0
6,388,388,5,1,4,2,1
0,390,390,16,16,0,1,0
17,410,410,39,29,10,2,1
1,423,423,51,21,30,3,2
10,436,436,25,25,0,1,0
12,438,438,64,64,0,1,0
30,442,442,16,16,0,1,0
7,447,447,1,1,0,1,0
21,460,460,117,71,46,3,2
20,471,471,61,61,0,1,0
27,477,477,5,1,4,2,1

30,119,119,2,2,0,1,0
14,125,125,4,4,0,1,0
28,140,140,19,19,0,1,0
16,147,147,12,12,0,1,0
27,167,167,18,18,0,1,0
21,169,169,1,1,0,1,0
12,169,169,1,1,0,1,0
41,171,171,29,6,23,2,1
34,171,171,4,1,3,2,1
20,183,183,20,8,12,3,2
39,187,187,58,16,42,2,1
23,192,192,50,40,10,2,1
0,196,196,3,3,0,1,0
15,197,197,11,11,0,1,0
29,203,203,10,10,0,1,0
32,208,208,6,6,0,1,0
31,224,224,29,29,0,1,0
19,224,224,24,1,23,2,1
13,235,235,10,10,0,1,0
5,236,236,24,24,0,1,0
26,245,245,4,4,0,1,0
4,257,257,15,15,0,1,0
36,282,282,31,31,0,1,0
33,283,283,40,21,19,4,3
40,289,289,56,29,27,4,3
10,302,302,5,5,0,1,0
1,304,304,13,13,0,1,0
24,340,340,47,47,0,1,0
25,367,367,10,1,9,4,3
11,393,393,19,19,0,1,0
2,416,416,31,31,0,1,0
18,417,417,34,34,0,1,0
37,428,428,6,6,0,1,0
3,436,436,14,14,0,1,0
22,441,441,81,29,52,3,2
42,452,452,70,34,36,3,2
9,453,453,1,1,0,1,0
8,458,458,38,12,26,2,1
17,462,462,3,3,0,1,0
35,466,466,58,20,38,2,1
38,466,466,35,35,0,1,0
7,471,471,53,19,34,2,1
6,479,479,50,50,0,1,0

4,100,100,29,29,0,1,0
16,132,132,2,2,0,1,0
29,136,136,34,4,30,4,3
11,156,156,3,3,0,1,0
13,159,159,6,6,0,1,0
3,186,186,8,1,7,3,2
17,187,187,11,11,0,1,0
22,202,202,13,5,8,2,1
28,218,218,83,83,0,1,0
5,218,218,17,17,0,1,0
2,245,245,69,69,0,1,0
21,251,251,37,16,21,4,3
25,254,254,4,1,3,2,1
7,255,255,2,2,0,1,0
20,269,269,37,14,23,2,1
6,282,282,103,103,0,1,0
0,318,318,28,28,0,1,0
10,341,341,36,36,0,1,0
19,345,345,22,10,12,2,1
23,353,353,47,19,28,3,2
1,367,367,103,88,15,4,3
8,384,384,9,9,0,1,0
26,396,396,28,28,0,1,0
27,397,397,13,13,0,1,0
18,398,398,35,6,29,2,1
15,402,402,2,2,0,1,0
24,426,426,106,39,67,4,3
12,453,453,12,5,7,2,1
14,461,461,26,20,6,3,2
9,491,491,108,108,0,1,0

14,106,106,7,7,0,1,0
30,113,113,30,30,0,1,0
32,129,129,3,3,0,1,0
19,146,146,4,1,3,2,1
6,163,163,1,1,0,1,0
13,167,167,8,8,0,1,0
34,174,174,45,45,0,1,0
17,175,175,22,16,6,2,1
7,179,179,4,4,0,1,0
3,180,180,3,3,0,1,0
12,226,226,33,12,21,2,1
4,228,228,58,16,42,3,2
20,229,229,4,4,0,1,0
0,234,234,1,1,0,1,0
15,252,252,1,1,0,1,0
8,268,268,37,17,20,3,2
24,271,271,18,11,7,2,1
5,279,279,21,15,6,2,1
11,279,279,54,54,0,1,0
16,289,289,118,40,78,4,3
9,295,295,23,23,0,1,0
18,297,297,2,2,0,1,0
26,316,316,88,64,24,4,3
1,331,331,31,13,18,4,3
31,332,332,37,28,9,4,3
22,344,344,13,13,0,1,0
2,348,348,4,4,0,1,0
36,378,378,26,11,15,2,1
28,400,400,5,5,0,1,0
35,402,402,67,40,27,2,1
23,411,411,18,9,9,4,3
37,432,432,7,1,6,3,2
33,443,443,31,31,0,1,0
25,459,459,81,81,0,1,0
27,467,467,40,40,0,1,0
29,468,468,49,49,0,1,0
21,480,480,11,11,0,1,0
10,482,482,36,36,0,1,0

9,105,105,7,1,6,3,2
15,135,135,5,5,0,1,0
4,140,140,2,2,0,1,0
28,146,146,23,16,7,2,1
1,148,148,26,20,6,3,2
7,168,168,93,62,31,2,1
11,173,173,5,5,0,1,0
23,199,199,7,7,0,1,0
26,200,200,33,33,0,1,0
13,210,210,20,20,0,1,0
22,215,215,10,10,0,1,0
6,254,254,42,42,0,1,0
20,258,258,29,2,27,4,3
27,279,279,16,16,0,1,0
17,296,296,18,1,17,3,2
24,331,331,28,10,18,2,1
12,341,341,113,18,95,4,3
18,341,341,96,73,23,3,2
14,348,348,41,14,27,2,1
0,366,366,69,17,52,4,3
16,414,414,58,20,38,3,2
5,415,415,41,35,6,2,1
19,419,419,23,23,0,1,0
21,436,436,1,1,0,1,0
3,436,436,14,1,13,4,3
25,444,444,9,3,6,2,1
8,457,457,124,31,93,4,3
2,460,460,44,32,12,2,1
10,496,496,69,69,0,1,0

27,104,104,9,1,8,2,1
4,109,109,2,2,0,1,0
19,124,124,9,9,0,1,0
0,125,125,1,1,0,1,0
32,141,141,7,7,0,1,0
34,145,145,15,15,0,1,0
38,153,153,8,1,7,2,1
22,162,162,3,3,0,1,0
37,163,163,63,29,34,2,1
12,172,172,110,69,41,2,1
18,177,177,9,2,7,2,1
15,182,182,1,1,0,1,0
29,187,187,10,3,7,2,1
20,202,202,1,1,0,1,0
28,210,210,42,42,0,1,0
6,212,212,8,2,6,2,1
2,222,222,24,4,20,3,2
23,223,223,10,10,0,1,0
31,238,238,10,10,0,1,0
39,249,249,87,87,0,1,0
9,258,258,7,7,0,1,0
7,267,267,15,1,14,3,2
14,282,282,22,4,18,2,1
10,284,284,3,3,0,1,0
35,296,296,1,1,0,1,0
13,333,333,13,13,0,1,0
3,361,361,43,12,31,2,1
36,367,367,39,12,27,2,1
26,398,398,28,5,23,2,1
8,400,400,54,27,27,4,3
17,404,404,35,19,16,3,2
25,407,407,24,4,20,4,3
1,409,409,4,4,0,1,0
33,419,419,2,2,0,1,0
21,423,423,4,1,3,2,1
11,433,433,109,109,0,1,0
24,442,442,81,45,36,2,1
5,448,448,1,1,0,1,0
16,473,473,15,15,0,1,0
30,477,477,14,14,0,1,0

24,116,116,40,40,0,1,0
39,119,119,2,2,0,1,0
4,121,121,2,2,0,1,0
16,133,133,5,5,0,1,0
34,148,148,3,3,0,1,0
38,168,168,32,5,27,2,1
20,171,171,23,23,0,1,0
29,181,181,12,12,0,1,0
14,183,183,12,12,0,1,0
10,186,186,12,3,9,4,3
33,192,192,10,10,0,1,0
5,199,199,5,1,4,2,1
2,202,202,3,3,0,1,0
15,218,218,8,3,5,2,1
8,221,221,43,33,10,2,1
0,222,222,27,3,24,4,3
36,229,229,10,10,0,1,0
13,234,234,8,8,0,1,0
1,241,241,1,1,0,1,0
35,250,250,39,39,0,1,0
30,262,262,13,13,0,1,0
17,271,271,7,7,0,1,0
28,280,280,15,2,13,2,1
26,309,309,20,20,0,1,0
9,326,326,60,30,30,4,3
41,337,337,7,7,0,1,0
22,345,345,5,5,0,1,0
27,383,383,68,68,0,1,0
37,395,395,6,1,5,2,1
7,395,395,3,3,0,1,0
19,397,397,16,2,14,2,1
25,415,415,90,42,48,4,3
32,434,434,24,24,0,1,0
11,443,443,48,48,0,1,0
12,448,448,88,88,0,1,0
6,456,456,45,45,0,1,0
18,461,461,71,49,22,3,2
23,465,465,8,8,0,1,0
31,470,470,50,50,0,1,0
40,472,472,91,71,20,2,1
21,482,482,31,31,0,1,0
3,493,493,69,62,7,2,1

0,103,103,1,1,0,1,0
38,115,115,18,13,5,2,1
17,128,128,30,30,0,1,0
37,130,130,30,30,0,1,0
4,132,132,6,6,0,1,0
18,138,138,9,9,0,1,0
32,175,175,6,6,0,1,0
36,182,182,8,8,0,1,0
28,207,207,20,20,0,1,0
9,209,209,4,4,0,1,0
13,237,237,4,4,0,1,0
24,238,238,7,7,0,1,0
11,254,254,8,8,0,1,0
6,255,255,27,14,13,2,1
25,258,258,14,14,0,1,0
30,281,281,6,1,5,2,1
22,295,295,12,12,0,1,0
16,309,309,19,19,0,1,0
10,333,333,16,6,10,3,2
3,333,333,130,130,0,1,0
1,345,345,1,1,0,1,0
8,353,353,42,42,0,1,0
19,368,368,4,4,0,1,0
21,381,381,19,19,0,1,0
7,390,390,42,42,0,1,0
26,403,403,38,32,6,3,2
14,409,409,2,2,0,1,0
31,416,416,91,77,14,3,2
2,422,422,25,25,0,1,0
34,423,423,11,5,6,2,1
23,436,436,101,35,66,4,3
5,457,457,100,18,82,4,3
27,459,459,13,13,0,1,0
35,459,459,56,56,0,1,0
33,469,469,6,2,4,2,1
29,479,479,2,2,0,1,0
15,480,480,17,17,0,1,0
12,488,488,63,45,18,2,1
39,492,492,192,177,15,4,3
20,500,500,18,12,6,2,1

26,111,111,5,5,0,1,0
19,118,118,16,16,0,1,0
25,124,124,35,8,27,3,2
2,143,143,30,19,11,2,1
10,162,162,10,6,4,2,1
9,208,208,44,31,13,2,1
13,236,236,18,6,12,3,2
20,240,240,9,2,7,2,1
7,272,272,63,63,0,1,0
11,276,276,24,24,0,1,0
6,280,280,55,37,18,2,1
27,287,287,28,11,17,2,1
18,291,291,16,16,0,1,0
29,298,298,66,66,0,1,0
12,299,299,84,44,40,3,2
17,313,313,14,14,0,1,0
4,330,330,5,5,0,1,0
32,343,343,38,38,0,1,0
1,344,344,28,20,8,2,1
21,349,349,23,23,0,1,0
23,357,357,97,19,78,4,3
15,380,380,20,20,0,1,0
22,392,392,23,23,0,1,0
16,393,393,39,3,36,3,2
34,400,400,13,13,0,1,0
0,406,406,3,3,0,1,0
33,416,416,38,38,0,1,0
3,417,417,67,6,61,4,3
31,418,418,22,22,0,1,0
24,429,429,17,17,0,1,0
28,445,445,68,51,17,2,1
8,461,461,3,3,0,1,0
5,461,461,7,7,0,1,0
14,482,482,4,4,0,1,0
30,486,486,19,19,0,1,0

3,102,102,6,6,0,1,0
14,104,104,1,1,0,1,0
11,106,106,2,2,0,1,0
18,146,146,42,17,25,2,1
9,157,157,5,5,0,1,0
17,171,171,2,2,0,1,0
1,179,179,1,1,0,1,0
4,195,195,3,3,0,1,0
10,201,201,2,2,0,1,0
7,213,213,43,43,0,1,0
31,228,228,5,5,0,1,0
13,228,228,29,2,27,4,3
34,233,233,28,23,5,2,1
23,246,246,9,3,6,3,2
27,257,257,31,31,0,1,0
21,289,289,94,52,42,4,3
24,296,296,20,11,9,4,3
20,300,300,15,10,5,2,1
19,302,302,11,11,0,1,0
36,309,309,31,4,27,2,1
38,330,330,55,55,0,1,0
2,359,359,36,36,0,1,0
35,363,363,49,7,42,3,2
16,368,368,14,1,13,2,1
22,374,374,31,11,20,2,1
8,384,384,112,68,44,4,3
6,393,393,97,66,31,2,1
30,402,402,31,31,0,1,0
12,406,406,9,9,0,1,0
37,440,440,48,48,0,1,0
32,446,446,25,25,0,1,0
5,454,454,49,49,0,1,0
15,468,468,18,8,10,2,1
0,473,473,44,8,36,4,3
25,474,474,28,13,15,2,1
33,474,474,51,23,28,4,3
26,482,482,107,107,0,1,0
28,491,491,4,4,0,1,0
29,492,492,3,3,0,1,0

7,101,101,22,22,0,1,0
18,103,103,7,7,0,1,0
17,107,107,9,1,8,3,2
2,113,113,16,16,0,1,0
10,113,113,10,1,9,4,3
35,131,131,23,23,0,1,0
15,132,132,18,4,14,3,2
22,138,138,15,6,9,4,3
39,149,149,9,3,6,3,2
37,151,151,40,19,21,4,3
25,154,154,32,32,0,1,0
38,155,155,4,4,0,1,0
16,156,156,3,3,0,1,0
33,172,172,1,1,0,1,0
13,210,210,19,5,14,2,1
21,257,257,1,1,0,1,0
20,269,269,4,4,0,1,0
19,281,281,58,53,5,2,1
28,287,287,8,8,0,1,0
27,288,288,24,19,5,2,1
34,292,292,18,18,0,1,0
5,317,317,2,2,0,1,0
12,320,320,2,2,0,1,0
30,329,329,52,52,0,1,0
29,360,360,37,37,0,1,0
9,362,362,16,16,0,1,0
32,363,363,8,8,0,1,0
1,373,373,16,6,10,3,2
14,378,378,5,2,3,2,1
4,380,380,93,3,90,3,2
31,385,385,3,3,0,1,0
23,389,389,77,77,0,1,0
8,405,405,5,5,0,1,0
36,409,409,28,28,0,1,0
24,433,433,87,87,0,1,0
6,459,459,65,35,30,2,1
3,459,459,66,37,29,2,1
0,466,466,29,15,14,2,1
26,474,474,28,28,0,1,0
11,483,483,6,6,0,1,0

7,101,101,5,5,0,1,0
18,116,116,8,8,0,1,0
28,122,122,2,2,0,1,0
29,131,131,7,3,4,2,1
24,140,140,15,15,0,1,0
1,179,179,5,2,3,2,1
22,187,187,53,47,6,2,1
19,187,187,20,20,0,1,0
6,188,188,7,7,0,1,0
9,196,196,1,1,0,1,0
36,196,196,16,16,0,1,0
15,202,202,2,2,0,1,0
27,208,208,23,2,21,2,1
31,229,229,31,31,0,1,0
20,242,242,92,56,36,4,3
8,248,248,7,4,3,2,1
37,252,252,30,18,12,3,2
3,265,265,2,2,0,1,0
23,268,268,9,9,0,1,0
16,274,274,32,11,21,3,2
2,281,281,31,31,0,1,0
5,294,294,7,1,6,3,2
26,299,299,51,51,0,1,0
14,317,317,73,73,0,1,0
21,338,338,19,19,0,1,0
4,350,350,3,3,0,1,0
35,357,357,7,1,6,3,2
30,361,361,13,13,0,1,0
33,363,363,36,10,26,3,2
12,363,363,29,21,8,2,1
32,363,363,4,4,0,1,0
0,371,371,68,68,0,1,0
17,376,376,19,19,0,1,0
38,415,415,17,5,12,3,2
11,449,449,4,4,0,1,0
13,455,455,13,13,0,1,0
34,456,456,87,28,59,4,3
25,458,458,124,124,0,1,0
10,492,492,118,91,27,4,3

17,109,109,29,14,15,2,1
16,115,115,4,1,3,2,1
4,171,171,70,7,63,4,3
10,196,196,11,1,10,3,2
2,198,198,103,14,89,4,3
8,205,205,40,40,0,1,0
24,252,252,63,42,21,4,3
11,262,262,8,2,6,2,1
5,275,275,23,23,0,1,0
6,287,287,2,2,0,1,0
21,288,288,21,8,13,2,1
15,314,314,73,1,72,3,2
19,350,350,21,21,0,1,0
20,359,359,23,1,22,4,3
0,363,363,139,28,111,4,3
9,365,365,13,13,0,1,0
26,367,367,15,15,0,1,0
12,371,371,25,21,4,2,1
23,375,375,1,1,0,1,0
1,381,381,54,48,6,2,1
25,406,406,17,9,8,3,2
3,412,412,24,7,17,4,3
18,449,449,123,102,21,4,3
7,465,465,3,3,0,1,0
14,467,467,29,29,0,1,0
13,476,476,92,59,33,2,1
22,478,478,25,25,0,1,0

0,151,151,46,46,0,1,0
12,165,165,56,6,50,2,1
16,179,179,35,35,0,1,0
7,181,181,15,15,0,1,0
23,184,184,13,13,0,1,0
28,190,190,10,4,6,2,1
25,197,197,7,4,3,2,1
21,204,204,40,25,15,4,3
22,221,221,29,21,8,2,1
19,233,233,6,6,0,1,0
29,240,240,30,24,6,2,1
17,244,244,17,5,12,3,2
2,247,247,25,15,10,2,1
10,260,260,29,29,0,1,0
9,285,285,26,26,0,1,0
31,297,297,22,22,0,1,0
5,317,317,27,27,0,1,0
20,322,322,6,6,0,1,0
3,351,351,28,18,10,3,2
1,360,360,17,8,9,3,2
15,392,392,103,103,0,1,0
14,396,396,37,10,27,2,1
30,402,402,2,2,0,1,0
27,412,412,9,9,0,1,0
11,414,414,146,39,107,4,3
8,420,420,38,11,27,4,3
24,428,428,49,49,0,1,0
6,439,439,9,2,7,3,2
13,443,443,10,2,8,3,2
4,459,459,33,33,0,1,0
18,477,477,127,112,15,4,3
26,493,493,38,38,0,1,0

2,104,104,3,3,0,1,0
0,106,106,3,3,0,1,0
19,112,112,4,4,0,1,0
25,126,126,17,5,12,4,3
30,129,129,38,38,0,1,0
22,131,131,17,17,0,1,0
4,139,139,4,4,0,1,0
17,140,140,21,21,0,1,0
13,194,194,47,47,0,1,0
21,200,200,17,17,0,1,0
34,206,206,9,3,6,2,1
24,211,211,5,5,0,1,0
32,233,233,16,16,0,1,0
38,237,237,39,39,0,1,0
9,248,248,17,1,16,3,2
6,248,248,13,13,0,1,0
20,255,255,41,41,0,1,0
10,259,259,27,27,0,1,0
39,260,260,9,1,8,3,2
35,264,264,21,21,0,1,0
31,266,266,53,53,0,1,0
23,272,272,3,3,0,1,0
16,312,312,2,2,0,1,0
41,315,315,13,13,0,1,0
8,322,322,15,15,0,1,0
33,332,332,16,16,0,1,0
7,339,339,19,19,0,1,0
40,347,347,5,5,0,1,0
14,350,350,61,22,39,4,3
1,360,360,42,42,0,1,0
5,371,371,68,30,38,2,1
11,372,372,14,14,0,1,0
3,378,378,5,5,0,1,0
26,381,381,8,8,0,1,0
18,412,412,15,9,6,3,2
36,457,457,155,149,6,3,2
37,457,457,22,22,0,1,0
12,464,464,1,1,0,1,0
27,468,468,33,33,0,1,0
28,496,496,28,28,0,1,0
29,497,497,76,76,0,1,0
15,500,500,1,1,0,1,0

24,102,102,12,8,4,2,1
19,104,104,11,11,0,1,0
34,113,113,7,7,0,1,0
31,130,130,11,2,9,4,3
14,140,140,20,5,15,4,3
33,151,151,24,5,19,2,1
17,158,158,12,4,8,2,1
28,164,164,47,10,37,3,2
21,184,184,4,4,0,1,0
0,196,196,21,15,6,2,1
25,210,210,9,9,0,1,0
1,229,229,44,44,0,1,0
5,231,231,4,4,0,1,0
13,265,265,3,3,0,1,0
32,267,267,10,1,9,4,3
29,275,275,42,42,0,1,0
30,287,287,16,16,0,1,0
8,297,297,1,1,0,1,0
18,300,300,27,15,12,4,3
10,332,332,28,28,0,1,0
6,342,342,83,11,72,3,2
15,370,370,6,6,0,1,0
11,382,382,44,44,0,1,0
22,399,399,13,13,0,1,0
16,402,402,16,8,8,2,1
4,437,437,42,10,32,4,3
9,440,440,22,22,0,1,0
20,442,442,37,37,0,1,0
26,447,447,83,83,0,1,0
7,447,447,104,44,60,4,3
12,466,466,93,88,5,2,1
27,475,475,105,18,87,4,3
23,477,477,15,15,0,1,0
3,478,478,58,58,0,1,0
2,499,499,65,65,0,1,0

24,117,117,22,4,18,4,3
7,124,124,2,2,0,1,0
32,124,124,3,3,0,1,0
18,132,132,3,3,0,1,0
21,137,137,8,8,0,1,0
22,160,160,27,27,0,1,0
13,162,162,2,2,0,1,0
19,245,245,49,49,0,1,0
2,249,249,6,6,0,1,0
4,252,252,55,55,0,1,0
29,253,253,5,2,3,2,1
23,261,261,7,7,0,1,0
17,267,267,38,32,6,3,2
10,318,318,2,2,0,1,0
5,321,321,17,7,10,3,2
1,330,330,115,71,44,3,2
27,336,336,16,8,8,3,2
20,345,345,4,4,0,1,0
25,349,349,60,4,56,3,2
16,351,351,20,8,12,4,3
12,378,378,4,4,0,1,0
14,379,379,6,3,3,2,1
6,387,387,31,31,0,1,0
28,392,392,12,1,11,3,2
0,406,406,164,155,9,2,1
30,407,407,49,4,45,4,3
15,412,412,112,15,97,4,3
3,414,414,30,16,14,2,1
26,427,427,75,75,0,1,0
9,435,435,139,55,84,4,3
8,469,469,90,76,14,3,2
11,493,493,14,4,10,2,1
31,497,497,52,52,0,1,0

20,102,102,13,13,0,1,0
0,112,112,2,2,0,1,0
11,153,153,41,9,32,3,2
6,156,156,36,4,32,3,2
5,164,164,26,26,0,1,0
18,173,173,8,8,0,1,0
29,187,187,59,59,0,1,0
30,200,200,16,16,0,1,0
14,208,208,11,1,10,2,1
23,271,271,8,2,6,2,1
8,272,272,35,26,9,2,1
3,288,288,14,2,12,3,2
1,291,291,36,36,0,1,0
27,336,336,60,26,34,4,3
16,345,345,13,1,12,4,3
28,354,354,36,36,0,1,0
2,370,370,40,40,0,1,0
15,391,391,10,10,0,1,0
7,391,391,11,2,9,2,1
22,402,402,19,19,0,1,0
17,416,416,143,143,0,1,0
31,435,435,19,8,11,2,1
12,438,438,37,37,0,1,0
25,453,453,74,74,0,1,0
32,458,458,10,6,4,2,1
13,458,458,1,1,0,1,0
4,463,463,143,110,33,2,1
21,464,464,1,1,0,1,0
10,466,466,17,17,0,1,0
24,480,480,24,24,0,1,0
19,485,485,8,8,0,1,0
9,493,493,100,100,0,1,0
26,494,494,97,73,24,2,1

0,101,101,1,1,0,1,0
4,136,136,7,1,6,3,2
26,142,142,16,4,12,3,2
33,148,148,2,2,0,1,0
16,156,156,23,23,0,1,0
3,163,163,2,2,0,1,0
35,179,179,17,11,6,3,2
21,184,184,1,1,0,1,0
36,185,185,2,2,0,1,0
23,227,227,1,1,0,1,0
30,229,229,15,3,12,3,2
15,231,231,62,62,0,1,0
9,234,234,124,52,72,4,3
11,267,267,3,3,0,1,0
7,274,274,25,25,0,1,0
8,277,277,11,11,0,1,0
29,277,277,13,2,11,2,1
14,284,284,3,3,0,1,0
31,303,303,10,10,0,1,0
1,328,328,1,1,0,1,0
25,337,337,5,1,4,2,1
17,350,350,14,14,0,1,0
19,370,370,17,17,0,1,0
32,378,378,93,48,45,2,1
13,390,390,94,39,55,3,2
28,402,402,14,14,0,1,0
5,411,411,28,13,15,2,1
22,433,433,27,27,0,1,0
34,439,439,12,3,9,4,3
27,443,443,30,30,0,1,0
6,443,443,4,1,3,2,1
12,445,445,27,27,0,1,0
10,465,465,35,35,0,1,0
24,479,479,145,97,48,4,3
37,483,483,104,24,80,3,2
38,487,487,234,201,33,2,1
2,492,492,10,3,7,2,1
20,494,494,21,14,7,2,1
18,499,499,11,2,9,4,3

11,134,134,32,32,0,1,0
29,139,139,32,1,31,3,2
3,147,147,5,5,0,1,0
20,151,151,2,2,0,1,0
15,152,152,14,14,0,1,0
5,156,156,13,13,0,1,0
14,163,163,2,2,0,1,0
21,165,165,19,8,11,4,3
25,208,208,12,1,11,2,1
28,218,218,13,13,0,1,0
17,246,246,8,3,5,2,1
8,250,250,38,22,16,2,1
16,254,254,28,19,9,4,3
2,263,263,82,72,10,3,2
4,301,301,2,2,0,1,0
7,316,316,28,1,27,2,1
24,335,335,37,37,0,1,0
22,339,339,178,121,57,4,3
32,356,356,62,17,45,2,1
9,361,361,16,6,10,2,1
13,375,375,27,27,0,1,0
0,381,381,125,125,0,1,0
23,401,401,15,15,0,1,0
31,404,404,13,13,0,1,0
30,406,406,20,5,15,4,3
27,416,416,11,3,8,2,1
6,421,421,5,5,0,1,0
26,432,432,36,36,0,1,0
33,446,446,21,2,19,2,1
1,455,455,111,111,0,1,0
18,460,460,21,7,14,3,2
19,468,468,41,41,0,1,0
12,470,470,36,18,18,3,2
10,481,481,3,3,0,1,0

26,100,100,35,35,0,1,0
5,100,100,1,1,0,1,0
29,106,106,3,3,0,1,0
8,124,124,31,31,0,1,0
20,125,125,4,4,0,1,0
30,127,127,11,8,3,2,1
6,131,131,12,12,0,1,0
0,132,132,3,3,0,1,0
12,139,139,17,6,11,2,1
28,148,148,6,6,0,1,0
3,161,161,20,6,14,2,1
25,164,164,17,17,0,1,0
19,165,165,17,1,16,3,2
1,182,182,2,2,0,1,0
2,183,183,62,4,58,3,2
23,205,205,8,1,7,2,1
11,236,236,46,46,0,1,0
17,256,256,21,21,0,1,0
15,269,269,13,1,12,3,2
10,271,271,18,3,15,4,3
4,277,277,65,35,30,4,3
18,280,280,28,28,0,1,0
14,291,291,24,24,0,1,0
7,309,309,12,3,9,4,3
16,335,335,7,1,6,3,2
21,379,379,1,1,0,1,0
9,395,395,14,14,0,1,0
33,409,409,53,53,0,1,0
22,416,416,70,70,0,1,0
27,416,416,26,26,0,1,0
32,430,430,189,162,27,4,3
31,439,439,5,5,0,1,0
24,493,493,17,17,0,1,0
13,498,498,64,16,48,4,3

16,108,108,8,2,6,2,1
17,115,115,5,5,0,1,0
1,124,124,1,1,0,1,0
11,136,136,1,1,0,1,0
20,142,142,5,5,0,1,0
49,153,153,19,19,0,1,0
12,164,164,6,6,0,1,0
0,176,176,1,1,0,1,0
37,176,176,6,6,0,1,0
3,191,191,4,4,0,1,0
5,192,192,19,6,13,2,1
42,202,202,3,3,0,1,0
46,207,207,13,13,0,1,0
21,211,211,1,1,0,1,0
40,218,218,37,13,24,4,3
9,221,221,9,9,0,1,0
36,224,224,21,21,0,1,0
22,228,228,2,2,0,1,0
52,231,231,4,4,0,1,0
7,234,234,45,20,25,2,1
24,236,236,27,27,0,1,0
10,237,237,13,13,0,1,0
38,249,249,15,15,0,1,0
41,249,249,14,14,0,1,0
25,255,255,2,2,0,1,0
44,263,263,40,7,33,2,1
18,280,280,1,1,0,1,0
14,285,285,2,2,0,1,0
43,297,297,53,53,0,1,0
13,311,311,45,21,24,2,1
45,316,316,40,34,6,3,2
2,319,319,1,1,0,1,0
6,322,322,21,21,0,1,0
19,340,340,6,6,0,1,0
29,351,351,1,1,0,1,0
50,352,352,31,11,20,2,1
34,371,371,32,32,0,1,0
39,374,374,49,49,0,1,0
31,379,379,47,27,20,3,2
8,393,393,45,45,0,1,0
54,421,421,38,1,37,3,2
26,428,428,24,14,10,3,2
23,429,429,36,10,26,3,2
32,450,450,45,41,4,2,1
33,453,453,8,8,0,1,0
51,453,453,19,19,0,1,0
48,455,455,29,29,0,1,0
30,460,460,26,4,22,3,2
27,464,464,4,4,0,1,0
15,465,465,8,8,0,1,0
35,482,482,11,2,9,2,1
53,487,487,84,20,64,3,2
4,490,490,2,2,0,1,0
47,496,496,120,27,93,4,3
28,499,499,9,9,0,1,0

1,109,109,4,4,0,1,0
30,114,114,33,3,30,3,2
39,129,129,1,1,0,1,0
4,131,131,4,1,3,2,1
24,133,133,3,3,0,1,0
15,141,141,4,4,0,1,0
35,149,149,16,16,0,1,0
19,153,153,7,7,0,1,0
18,157,157,1,1,0,1,0
16,179,179,1,1,0,1,0
3,188,188,6,6,0,1,0
23,191,191,14,14,0,1,0
0,224,224,1,1,0,1,0
28,224,224,55,46,9,2,1
31,233,233,6,6,0,1,0
27,244,244,17,5,12,4,3
32,255,255,3,3,0,1,0
7,266,266,72,72,0,1,0
2,289,289,4,4,0,1,0
11,291,291,38,27,11,2,1
26,296,296,38,11,27,4,3
25,297,297,23,1,22,2,1
20,311,311,53,53,0,1,0
38,343,343,14,14,0,1,0
8,364,364,72,23,49,2,1
9,369,369,101,75,26,2,1
33,373,373,63,24,39,4,3
10,395,395,73,47,26,3,2
37,396,396,66,30,36,4,3
6,402,402,1,1,0,1,0
22,423,423,51,51,0,1,0
36,431,431,42,32,10,2,1
14,441,441,60,19,41,2,1
29,444,444,58,16,42,2,1
21,446,446,5,1,4,2,1
5,467,467,10,10,0,1,0
12,485,485,11,11,0,1,0
13,488,488,55,48,7,2,1
17,496,496,31,31,0,1,0
34,498,498,27,27,0,1,0

18,110,110,1,1,0,1,0
27,111,111,10,10,0,1,0
39,114,114,8,8,0,1,0
17,115,115,21,15,6,2,1
36,120,120,14,14,0,1,0
29,139,139,9,9,0,1,0
21,140,140,1,1,0,1,0
26,152,152,19,19,0,1,0
13,167,167,4,4,0,1,0
1,176,176,3,3,0,1,0
6,202,202,34,34,0,1,0
0,209,209,26,26,0,1,0
16,225,225,9,2,7,2,1
31,261,261,5,5,0,1,0
24,263,263,96,11,85,4,3
8,272,272,7,7,0,1,0
23,279,279,24,24,0,1,0
2,281,281,16,16,0,1,0
37,290,290,25,25,0,1,0
38,311,311,13,13,0,1,0
3,314,314,5,1,4,2,1
15,317,317,8,8,0,1,0
20,322,322,43,43,0,1,0
5,327,327,1,1,0,1,0
28,345,345,50,50,0,1,0
32,348,348,8,8,0,1,0
10,358,358,2,2,0,1,0
11,358,358,144,43,101,4,3
4,360,360,33,33,0,1,0
33,363,363,38,38,0,1,0
7,382,382,7,7,0,1,0
35,392,392,26,13,13,2,1
34,394,394,25,10,15,2,1
12,395,395,2,2,0,1,0
25,409,409,26,16,10,2,1
9,419,419,48,24,24,3,2
40,458,458,60,40,20,2,1
22,464,464,43,32,11,2,1
14,475,475,70,10,60,4,3
19,484,484,44,44,0,1,0
30,498,498,88,79,9,4,3

31,104,104,21,9,12,3,2
0,139,139,3,3,0,1,0
12,158,158,32,32,0,1,0
25,166,166,31,31,0,1,0
5,211,211,62,62,0,1,0
16,217,217,49,38,11,2,1
19,224,224,31,31,0,1,0
30,252,252,10,7,3,2,1
8,253,253,22,22,0,1,0
9,255,255,20,16,4,2,1
17,255,255,1,1,0,1,0
3,265,265,15,15,0,1,0
10,285,285,15,15,0,1,0
21,291,291,27,3,24,3,2
22,301,301,24,24,0,1,0
32,311,311,21,21,0,1,0
14,318,318,17,1,16,2,1
26,325,325,3,3,0,1,0
7,334,334,7,2,5,2,1
20,344,344,26,5,21,4,3
2,359,359,21,9,12,4,3
4,365,365,8,8,0,1,0
28,393,393,5,5,0,1,0
15,396,396,23,4,19,3,2
1,396,396,20,7,13,2,1
6,410,410,39,16,23,2,1
23,424,424,9,9,0,1,0
29,424,424,149,93,56,3,2
27,437,437,8,8,0,1,0
13,451,451,300,156,144,4,3
11,467,467,20,20,0,1,0
18,470,470,84,78,6,3,2
24,488,488,32,32,0,1,0

11,104,104,8,2,6,3,2
21,107,107,33,9,24,4,3
12,109,109,2,2,0,1,0
13,136,136,6,6,0,1,0
14,137,137,5,5,0,1,0
37,141,141,9,3,6,2,1
8,186,186,43,43,0,1,0
5,191,191,22,22,0,1,0
10,202,202,9,9,0,1,0
24,206,206,20,20,0,1,0
6,211,211,10,10,0,1,0
30,216,216,36,36,0,1,0
35,224,224,44,44,0,1,0
20,239,239,46,7,39,4,3
36,247,247,8,8,0,1,0
23,252,252,51,42,9,4,3
22,256,256,18,5,13,2,1
33,280,280,9,2,7,2,1
27,284,284,42,10,32,3,2
32,287,287,18,18,0,1,0
0,317,317,1,1,0,1,0
9,328,328,97,48,49,3,2
7,348,348,30,30,0,1,0
31,357,357,17,3,14,2,1
18,362,362,16,16,0,1,0
25,365,365,2,2,0,1,0
15,371,371,10,10,0,1,0
38,375,375,44,44,0,1,0
1,382,382,46,46,0,1,0
2,399,399,26,6,20,3,2
19,416,416,13,3,10,2,1
29,422,422,99,44,55,4,3
4,425,425,3,3,0,1,0
26,432,432,5,2,3,2,1
16,451,451,1,1,0,1,0
34,468,468,6,6,0,1,0
17,479,479,143,80,63,4,3
28,488,488,13,5,8,2,1
3,488,488,7,7,0,1,0

28,102,102,5,5,0,1,0
19,104,104,16,8,8,2,1
15,109,109,10,10,0,1,0
7,116,116,1,1,0,1,0
18,124,124,11,11,0,1,0
17,128,128,6,6,0,1,0
27,128,128,1,1,0,1,0
16,132,132,2,2,0,1,0
11,138,138,17,6,11,2,1
14,147,147,11,3,8,2,1
36,149,149,1,1,0,1,0
39,149,149,3,3,0,1,0
20,173,173,1,1,0,1,0
35,175,175,15,15,0,1,0
40,187,187,79,40,39,2,1
1,192,192,24,14,10,2,1
0,223,223,59,10,49,2,1
6,281,281,10,3,7,2,1
34,282,282,56,56,0,1,0
12,291,291,30,30,0,1,0
25,294,294,16,4,12,3,2
31,295,295,39,39,0,1,0
3,298,298,1,1,0,1,0
23,304,304,51,31,20,3,2
37,313,313,43,29,14,3,2
10,325,325,35,35,0,1,0
5,330,330,22,1,21,2,1
38,344,344,3,3,0,1,0
2,363,363,24,24,0,1,0
22,365,365,19,7,12,3,2
29,373,373,37,9,28,3,2
24,386,386,20,20,0,1,0
4,400,400,20,4,16,2,1
41,413,413,25,25,0,1,0
8,429,429,5,1,4,2,1
9,451,451,29,5,24,3,2
30,454,454,75,75,0,1,0
21,462,462,2,2,0,1,0
13,475,475,34,34,0,1,0
26,482,482,3,3,0,1,0
32,487,487,150,118,32,3,2
33,498,498,9,9,0,1,0

12,105,105,1,1,0,1,0
34,111,111,2,2,0,1,0
8,114,114,6,1,5,2,1
41,118,118,10,10,0,1,0
29,195,195,15,15,0,1,0
15,196,196,4,4,0,1,0
31,204,204,4,4,0,1,0
16,205,205,8,5,3,2,1
3,219,219,49,49,0,1,0
2,227,227,4,4,0,1,0
37,262,262,42,42,0,1,0
26,264,264,9,9,0,1,0
20,266,266,10,1,9,2,1
11,271,271,39,28,11,2,1
6,291,291,23,23,0,1,0
36,295,295,38,38,0,1,0
17,297,297,36,36,0,1,0
10,301,301,12,9,3,2,1
21,302,302,6,6,0,1,0
39,303,303,35,8,27,2,1
0,317,317,2,2,0,1,0
5,330,330,2,2,0,1,0
13,337,337,32,32,0,1,0
4,341,341,25,25,0,1,0
38,360,360,64,16,48,4,3
25,367,367,20,20,0,1,0
33,375,375,72,45,27,4,3
7,386,386,22,15,7,2,1
22,386,386,46,46,0,1,0
32,401,401,79,75,4,2,1
14,408,408,13,13,0,1,0
40,412,412,31,21,10,4,3
9,429,429,65,65,0,1,0
35,431,431,98,98,0,1,0
28,432,432,19,3,16,2,1
42,436,436,7,7,0,1,0
23,437,437,47,47,0,1,0
30,438,438,85,85,0,1,0
18,452,452,49,39,10,3,2
1,463,463,23,8,15,2,1
19,466,466,49,49,0,1,0
24,496,496,42,42,0,1,0
27,497,497,9,9,0,1,0

27,102,102,1,1,0,1,0
30,107,107,14,4,10,3,2
34,113,113,8,5,3,2,1
4,135,135,6,2,4,2,1
26,144,144,5,5,0,1,0
16,151,151,18,18,0,1,0
25,151,151,26,26,0,1,0
31,154,154,15,7,8,3,2
5,176,176,49,1,48,3,2
17,184,184,14,14,0,1,0
19,212,212,26,26,0,1,0
2,214,214,4,4,0,1,0
18,225,225,31,31,0,1,0
6,230,230,40,40,0,1,0
33,252,252,13,10,3,2,1
21,253,253,6,3,3,2,1
8,254,254,36,24,12,2,1
15,261,261,11,11,0,1,0
0,280,280,25,25,0,1,0
1,310,310,13,13,0,1,0
20,322,322,83,5,78,4,3
29,340,340,18,11,7,2,1
7,345,345,5,5,0,1,0
11,355,355,58,47,11,2,1
3,357,357,55,37,18,2,1
32,371,371,146,131,15,4,3
12,382,382,3,3,0,1,0
23,386,386,42,42,0,1,0
35,407,407,45,13,32,2,1
14,412,412,71,9,62,4,3
22,457,457,11,11,0,1,0
36,467,467,21,21,0,1,0
28,473,473,37,9,28,3,2
10,473,473,16,16,0,1,0
9,479,479,14,14,0,1,0
13,487,487,30,30,0,1,0
24,489,489,32,32,0,1,0

29,107,107,1,1,0,1,0
28,133,133,8,2,6,2,1
13,142,142,2,2,0,1,0
22,154,154,12,12,0,1,0
12,174,174,3,3,0,1,0
2,218,218,17,5,12,2,1
9,220,220,75,16,59,3,2
15,221,221,17,17,0,1,0
1,227,227,29,29,0,1,0
23,228,228,15,3,12,4,3
6,232,232,25,25,0,1,0
26,282,282,10,10,0,1,0
8,286,286,9,3,6,3,2
11,294,294,11,3,8,2,1
27,299,299,69,6,63,4,3
14,300,300,16,4,12,2,1
16,344,344,5,5,0,1,0
25,349,349,71,50,21,4,3
19,349,349,13,1,12,4,3
3,388,388,22,10,12,4,3
24,390,390,15,15,0,1,0
30,401,401,21,5,16,2,1
17,403,403,68,34,34,2,1
10,423,423,154,116,38,4,3
7,427,427,39,39,0,1,0
5,452,452,44,44,0,1,0
20,453,453,79,1,78,3,2
32,466,466,52,37,15,2,1
4,471,471,119,59,60,3,2
21,476,476,235,235,0,1,0
18,478,478,11,11,0,1,0
0,483,483,27,27,0,1,0
33,491,491,3,3,0,1,0
31,495,495,18,5,13,4,3

38,129,129,12,12,0,1,0
35,149,149,4,4,0,1,0
0,154,154,16,16,0,1,0
15,154,154,2,2,0,1,0
47,158,158,20,20,0,1,0
23,166,166,6,6,0,1,0
24,167,167,7,7,0,1,0
43,176,176,9,9,0,1,0
36,178,178,2,2,0,1,0
2,180,180,1,1,0,1,0
18,181,181,1,1,0,1,0
31,181,181,21,21,0,1,0
26,187,187,2,2,0,1,0
14,193,193,32,32,0,1,0
5,195,195,11,11,0,1,0
1,204,204,1,1,0,1,0
40,209,209,94,94,0,1,0
37,227,227,16,11,5,2,1
33,234,234,76,69,7,2,1
21,235,235,3,3,0,1,0
27,237,237,19,19,0,1,0
25,242,242,13,13,0,1,0
11,262,262,14,14,0,1,0
16,264,264,11,11,0,1,0
3,280,280,36,36,0,1,0
4,292,292,24,2,22,2,1
46,305,305,28,28,0,1,0
32,305,305,7,4,3,2,1
30,308,308,33,33,0,1,0
34,309,309,14,14,0,1,0
39,346,346,37,16,21,4,3
45,357,357,8,8,0,1,0
41,363,363,58,40,18,2,1
9,370,370,9,1,8,2,1
8,370,370,4,4,0,1,0
19,382,382,65,65,0,1,0
29,414,414,4,4,0,1,0
44,430,430,6,6,0,1,0
17,446,446,9,1,8,2,1
7,462,462,209,89,120,4,3
10,474,474,1,1,0,1,0
22,475,475,13,8,5,2,1
13,481,481,27,7,20,3,2
28,483,483,28,28,0,1,0
12,495,495,24,24,0,1,0
6,497,497,9,9,0,1,0
42,498,498,1,1,0,1,0
20,499,499,4,4,0,1,0

40,105,105,12,5,7,2,1
13,113,113,2,2,0,1,0
20,116,116,11,2,9,2,1
16,138,138,5,5,0,1,0
10,145,145,3,3,0,1,0
25,152,152,3,3,0,1,0
19,167,167,6,3,3,2,1
12,193,193,8,8,0,1,0
31,200,200,28,28,0,1,0
29,217,217,13,5,8,3,2
17,237,237,21,21,0,1,0
35,238,238,75,63,12,3,2
26,259,259,10,6,4,2,1
2,276,276,1,1,0,1,0
1,284,284,90,11,79,4,3
24,293,293,47,5,42,3,2
32,298,298,1,1,0,1,0
18,314,314,5,2,3,2,1
3,319,319,11,11,0,1,0
6,321,321,8,8,0,1,0
34,321,321,16,16,0,1,0
28,350,350,14,14,0,1,0
21,360,360,26,12,14,2,1
33,361,361,8,8,0,1,0
23,363,363,14,14,0,1,0
36,368,368,14,7,7,2,1
14,391,391,26,26,0,1,0
8,394,394,99,24,75,4,3
39,396,396,67,17,50,2,1
15,400,400,17,7,10,2,1
22,435,435,7,1,6,3,2
38,440,440,38,10,28,2,1
41,443,443,191,137,54,4,3
4,443,443,33,33,0,1,0
27,452,452,30,30,0,1,0
9,452,452,129,129,0,1,0
0,455,455,10,10,0,1,0
30,460,460,20,13,7,2,1
5,479,479,71,23,48,3,2
37,483,483,16,4,12,3,2
7,495,495,20,3,17,2,1
11,498,498,6,6,0,1,0

18,128,128,14,14,0,1,0
33,140,140,13,13,0,1,0
21,163,163,15,15,0,1,0
7,187,187,31,31,0,1,0
11,197,197,3,3,0,1,0
9,237,237,90,46,44,2,1
4,239,239,17,17,0,1,0
14,274,274,2,2,0,1,0
0,283,283,4,4,0,1,0
29,285,285,86,86,0,1,0
19,287,287,87,75,12,4,3
31,291,291,2,2,0,1,0
1,294,294,21,7,14,3,2
16,295,295,2,2,0,1,0
13,317,317,6,6,0,1,0
27,321,321,17,17,0,1,0
5,321,321,25,3,22,3,2
30,324,324,8,8,0,1,0
22,329,329,12,6,6,2,1
25,338,338,48,48,0,1,0
28,343,343,10,10,0,1,0
24,349,349,20,20,0,1,0
32,354,354,13,13,0,1,0
26,365,365,22,22,0,1,0
3,372,372,64,7,57,4,3
2,383,383,12,12,0,1,0
23,408,408,77,77,0,1,0
20,426,426,121,100,21,2,1
17,438,438,4,4,0,1,0
10,454,454,48,48,0,1,0
6,456,456,104,65,39,4,3
15,464,464,49,49,0,1,0
12,475,475,53,1,52,4,3
8,491,491,111,87,24,4,3

6,103,103,3,3,0,1,0
15,138,138,1,1,0,1,0
9,141,141,64,42,22,3,2
12,159,159,7,3,4,2,1
8,195,195,20,6,14,2,1
33,215,215,78,60,18,2,1
23,216,216,11,11,0,1,0
20,242,242,4,4,0,1,0
3,242,242,10,6,4,2,1
32,242,242,2,2,0,1,0
25,254,254,36,27,9,4,3
4,254,254,6,6,0,1,0
38,255,255,14,14,0,1,0
5,265,265,1,1,0,1,0
18,269,269,12,12,0,1,0
36,273,273,39,39,0,1,0
13,300,300,19,19,0,1,0
22,318,318,30,30,0,1,0
28,340,340,11,7,4,2,1
30,353,353,6,3,3,2,1
26,356,356,18,8,10,3,2
2,360,360,77,39,38,3,2
31,364,364,9,1,8,3,2
19,368,368,55,37,18,3,2
10,371,371,50,43,7,2,1
37,387,387,10,4,6,2,1
27,398,398,20,20,0,1,0
1,400,400,7,2,5,2,1
24,423,423,57,57,0,1,0
17,431,431,10,1,9,4,3
11,436,436,4,4,0,1,0
14,445,445,27,27,0,1,0
16,452,452,143,38,105,4,3
21,467,467,143,143,0,1,0
0,467,467,20,7,13,3,2
35,472,472,25,25,0,1,0
7,479,479,2,2,0,1,0
29,495,495,31,7,24,4,3
34,500,500,108,108,0,1,0

10,103,103,18,10,8,3,2
18,104,104,9,9,0,1,0
22,134,134,24,24,0,1,0
7,149,149,8,8,0,1,0
13,167,167,4,4,0,1,0
27,168,168,5,5,0,1,0
15,168,168,21,21,0,1,0
25,169,169,28,22,6,3,2
28,181,181,3,3,0,1,0
12,201,201,30,30,0,1,0
3,205,205,41,41,0,1,0
14,213,213,26,26,0,1,0
16,237,237,14,9,5,2,1
2,268,268,20,20,0,1,0
20,269,269,92,92,0,1,0
21,272,272,1,1,0,1,0
24,286,286,2,2,0,1,0
26,327,327,10,4,6,3,2
19,329,329,9,9,0,1,0
17,346,346,84,52,32,4,3
9,347,347,84,2,82,3,2
29,348,348,41,41,0,1,0
30,362,362,77,77,0,1,0
11,369,369,90,68,22,2,1
0,372,372,65,65,0,1,0
31,374,374,17,17,0,1,0
5,379,379,1,1,0,1,0
23,383,383,9,9,0,1,0
4,386,386,26,26,0,1,0
8,388,388,119,107,12,4,3
6,459,459,4,4,0,1,0
1,467,467,39,39,0,1,0

36,112,112,15,15,0,1,0
33,158,158,20,20,0,1,0
9,163,163,1,1,0,1,0
12,206,206,12,12,0,1,0
14,210,210,51,51,0,1,0
31,219,219,28,5,23,3,2
22,219,219,89,89,0,1,0
16,231,231,16,6,10,3,2
7,232,232,6,6,0,1,0
19,238,238,10,10,0,1,0
25,238,238,11,11,0,1,0
18,250,250,12,5,7,2,1
27,250,250,21,21,0,1,0
24,276,276,24,24,0,1,0
1,283,283,8,4,4,2,1
0,286,286,92,76,16,2,1
32,303,303,25,19,6,3,2
30,308,308,16,12,4,2,1
10,336,336,25,12,13,2,1
11,336,336,17,17,0,1,0
34,341,341,76,76,0,1,0
6,352,352,5,5,0,1,0
5,361,361,38,38,0,1,0
28,364,364,33,15,18,4,3
4,380,380,49,25,24,2,1
13,382,382,51,51,0,1,0
21,406,406,48,18,30,4,3
8,411,411,2,2,0,1,0
35,420,420,3,3,0,1,0
20,423,423,22,22,0,1,0
2,431,431,68,30,38,4,3
29,438,438,35,3,32,2,1
23,441,441,24,24,0,1,0
26,442,442,11,3,8,3,2
17,484,484,43,3,40,2,1
3,485,485,117,117,0,1,0
15,495,495,1,1,0,1,0

16,104,104,17,17,0,1,0
14,106,106,1,1,0,1,0
1,133,133,6,6,0,1,0
26,148,148,16,16,0,1,0
21,168,168,2,2,0,1,0
11,177,177,9,9,0,1,0
0,198,198,9,3,6,2,1
7,219,219,1,1,0,1,0
25,275,275,13,7,6,3,2
29,278,278,92,74,18,2,1
19,280,280,8,8,0,1,0
24,284,284,7,2,5,2,1
13,291,291,64,16,48,4,3
31,307,307,22,3,19,2,1
6,308,308,62,58,4,2,1
4,314,314,23,5,18,2,1
2,317,317,6,6,0,1,0
22,327,327,46,46,0,1,0
17,328,328,19,5,14,2,1
30,343,343,44,44,0,1,0
27,346,346,51,35,16,2,1
9,363,363,51,45,6,2,1
12,391,391,1,1,0,1,0
20,399,399,90,12,78,3,2
5,411,411,40,40,0,1,0
8,427,427,147,147,0,1,0
3,430,430,219,219,0,1,0
10,441,441,22,6,16,2,1
28,457,457,7,7,0,1,0
15,471,471,57,38,19,2,1
23,474,474,18,4,14,3,2
18,483,483,77,58,19,2,1

19,126,126,7,7,0,1,0
22,135,135,3,3,0,1,0
29,146,146,27,27,0,1,0
37,148,148,1,1,0,1,0
5,151,151,2,2,0,1,0
15,156,156,1,1,0,1,0
21,162,162,5,5,0,1,0
7,166,166,52,16,36,4,3
20,169,169,80,54,26,2,1
26,170,170,1,1,0,1,0
17,177,177,16,16,0,1,0
0,198,198,6,6,0,1,0
36,207,207,3,3,0,1,0
12,230,230,60,32,28,2,1
24,234,234,46,18,28,4,3
31,256,256,9,3,6,2,1
18,293,293,35,26,9,4,3
9,298,298,6,6,0,1,0
33,300,300,54,10,44,3,2
11,328,328,12,12,0,1,0
14,328,328,19,19,0,1,0
23,335,335,80,30,50,2,1
32,338,338,2,2,0,1,0
10,365,365,15,15,0,1,0
34,377,377,5,5,0,1,0
3,404,404,165,54,111,4,3
8,413,413,61,61,0,1,0
4,427,427,2,2,0,1,0
28,428,428,95,60,35,4,3
30,431,431,15,3,12,4,3
6,449,449,3,3,0,1,0
2,454,454,6,6,0,1,0
25,456,456,3,3,0,1,0
1,470,470,17,17,0,1,0
27,471,471,33,33,0,1,0
16,473,473,26,26,0,1,0
13,479,479,42,42,0,1,0
35,480,480,48,48,0,1,0

10,108,108,57,57,0,1,0
24,121,121,2,2,0,1,0
33,135,135,15,15,0,1,0
0,149,149,16,16,0,1,0
28,149,149,13,13,0,1,0
19,150,150,1,1,0,1,0
14,179,179,8,8,0,1,0
17,190,190,15,15,0,1,0
4,199,199,14,9,5,2,1
23,227,227,41,4,37,2,1
7,235,235,17,4,13,3,2
21,242,242,18,2,16,3,2
16,246,246,33,33,0,1,0
32,251,251,24,9,15,2,1
34,282,282,78,57,21,4,3
29,282,282,2,2,0,1,0
31,291,291,42,19,23,2,1
26,298,298,19,7,12,4,3
3,301,301,1,1,0,1,0
1,304,304,25,25,0,1,0
20,307,307,72,72,0,1,0
5,314,314,35,13,22,3,2
11,325,325,22,22,0,1,0
9,333,333,1,1,0,1,0
18,349,349,9,9,0,1,0
35,349,349,27,27,0,1,0
15,360,360,13,10,3,2,1
30,414,414,66,22,44,4,3
6,422,422,65,59,6,3,2
2,428,428,77,77,0,1,0
12,442,442,5,5,0,1,0
22,443,443,73,73,0,1,0
13,450,450,31,1,30,4,3
25,470,470,7,7,0,1,0
8,484,484,10,4,6,2,1
27,486,486,51,51,0,1,0
36,493,493,12,3,9,2,1

25,101,101,3,3,0,1,0
17,103,103,2,2,0,1,0
16,110,110,6,6,0,1,0
28,111,111,40,16,24,3,2
6,119,119,17,1,16,3,2
14,140,140,13,3,10,4,3
27,177,177,10,1,9,4,3
21,178,178,24,24,0,1,0
12,199,199,46,46,0,1,0
7,206,206,13,13,0,1,0
20,210,210,15,15,0,1,0
29,228,228,76,76,0,1,0
13,241,241,23,23,0,1,0
8,298,298,89,89,0,1,0
24,302,302,1,1,0,1,0
3,308,308,26,26,0,1,0
22,329,329,14,14,0,1,0
9,331,331,56,56,0,1,0
18,353,353,22,22,0,1,0
23,356,356,40,40,0,1,0
15,369,369,11,11,0,1,0
0,397,397,2,2,0,1,0
5,427,427,82,82,0,1,0
4,427,427,69,61,8,3,2
30,442,442,82,82,0,1,0
1,458,458,17,17,0,1,0
26,478,478,31,31,0,1,0
2,479,479,150,15,135,4,3
19,482,482,44,37,7,2,1
10,482,482,22,22,0,1,0
11,498,498,30,30,0,1,0

6,103,103,1,1,0,1,0
23,108,108,6,6,0,1,0
41,136,136,2,2,0,1,0
34,144,144,38,38,0,1,0
39,155,155,18,10,8,3,2
35,161,161,2,2,0,1,0
2,174,174,9,9,0,1,0
17,179,179,14,5,9,4,3
22,182,182,15,6,9,2,1
5,187,187,2,2,0,1,0
19,193,193,7,7,0,1,0
24,216,216,2,2,0,1,0
0,234,234,33,11,22,3,2
18,242,242,15,3,12,4,3
37,265,265,10,10,0,1,0
26,274,274,28,28,0,1,0
10,278,278,16,7,9,4,3
14,301,301,7,7,0,1,0
16,312,312,17,17,0,1,0
3,315,315,6,6,0,1,0
15,324,324,48,48,0,1,0
36,328,328,5,1,4,2,1
30,333,333,57,30,27,4,3
11,334,334,20,1,19,2,1
38,335,335,22,22,0,1,0
8,343,343,42,39,3,2,1
4,343,343,53,53,0,1,0
12,351,351,76,56,20,2,1
31,352,352,103,37,66,4,3
32,358,358,10,10,0,1,0
9,386,386,61,61,0,1,0
21,412,412,57,42,15,4,3
25,418,418,74,74,0,1,0
1,419,419,42,22,20,3,2
27,423,423,37,37,0,1,0
20,428,428,1,1,0,1,0
13,450,450,1,1,0,1,0
28,480,480,40,28,12,4,3
40,482,482,6,3,3,2,1
29,492,492,29,7,22,2,1
33,497,497,140,26,114,4,3
7,499,499,10,10,0,1,0

15,114,114,7,7,0,1,0
17,135,135,8,8,0,1,0
29,147,147,1,1,0,1,0
5,168,168,4,4,0,1,0
19,170,170,33,33,0,1,0
20,184,184,10,10,0,1,0
34,188,188,27,4,23,4,3
37,200,200,4,4,0,1,0
33,215,215,25,13,12,3,2
12,224,224,2,2,0,1,0
4,247,247,40,16,24,4,3
28,260,260,22,12,10,2,1
10,263,263,38,38,0,1,0
27,277,277,48,7,41,2,1
24,287,287,37,37,0,1,0
36,288,288,70,70,0,1,0
30,315,315,95,25,70,4,3
38,327,327,39,39,0,1,0
1,336,336,25,1,24,3,2
6,339,339,35,14,21,4,3
22,362,362,3,3,0,1,0
16,365,365,21,1,20,3,2
25,380,380,69,69,0,1,0
32,389,389,25,13,12,2,1
14,392,392,2,2,0,1,0
31,392,392,13,13,0,1,0
35,398,398,12,12,0,1,0
7,424,424,14,14,0,1,0
9,431,431,206,188,18,4,3
8,435,435,57,57,0,1,0
3,444,444,6,6,0,1,0
21,446,446,35,35,0,1,0
13,453,453,1,1,0,1,0
23,478,478,2,2,0,1,0
2,486,486,16,16,0,1,0
18,487,487,20,2,18,4,3
11,489,489,4,4,0,1,0
26,491,491,47,47,0,1,0
0,499,499,57,7,50,3,2

7,101,101,4,4,0,1,0
13,108,108,7,7,0,1,0
32,119,119,10,10,0,1,0
16,127,127,7,4,3,2,1
27,128,128,1,1,0,1,0
20,131,131,9,3,6,3,2
26,133,133,2,2,0,1,0
15,137,137,7,1,6,2,1
18,161,161,4,4,0,1,0
30,174,174,119,35,84,3,2
29,178,178,7,7,0,1,0
6,188,188,5,5,0,1,0
23,193,193,4,4,0,1,0
10,208,208,11,11,0,1,0
0,214,214,4,4,0,1,0
9,217,217,88,88,0,1,0
1,218,218,37,37,0,1,0
35,222,222,6,1,5,2,1
19,224,224,11,11,0,1,0
12,248,248,2,2,0,1,0
3,290,290,30,30,0,1,0
11,324,324,2,2,0,1,0
33,347,347,32,32,0,1,0
34,359,359,74,12,62,3,2
5,392,392,8,8,0,1,0
14,412,412,12,12,0,1,0
25,431,431,10,10,0,1,0
2,436,436,91,91,0,1,0
24,445,445,69,69,0,1,0
17,446,446,43,22,21,2,1
28,446,446,27,27,0,1,0
4,454,454,34,34,0,1,0
8,465,465,172,28,144,4,3
22,476,476,13,13,0,1,0
21,482,482,40,27,13,2,1
31,487,487,84,46,38,2,1

27,103,103,8,2,6,2,1
12,103,103,24,24,0,1,0
8,106,106,1,1,0,1,0
35,107,107,1,1,0,1,0
20,109,109,4,4,0,1,0
15,116,116,1,1,0,1,0
1,123,123,1,1,0,1,0
7,155,155,3,3,0,1,0
4,162,162,9,4,5,2,1
11,168,168,11,11,0,1,0
25,172,172,8,8,0,1,0
21,182,182,1,1,0,1,0
17,187,187,17,17,0,1,0
39,192,192,23,23,0,1,0
0,194,194,1,1,0,1,0
5,216,216,5,5,0,1,0
19,219,219,2,2,0,1,0
32,234,234,26,26,0,1,0
31,238,238,50,50,0,1,0
38,248,248,7,1,6,2,1
3,254,254,62,25,37,2,1
30,287,287,7,7,0,1,0
26,288,288,15,5,10,3,2
28,289,289,22,14,8,2,1
42,302,302,3,3,0,1,0
9,308,308,9,9,0,1,0
24,311,311,84,26,58,4,3
2,329,329,12,12,0,1,0
34,340,340,10,10,0,1,0
23,341,341,12,12,0,1,0
43,352,352,21,3,18,2,1
14,352,352,11,11,0,1,0
22,360,360,31,19,12,3,2
37,385,385,30,22,8,3,2
13,385,385,80,8,72,4,3
33,404,404,26,26,0,1,0
40,408,408,176,176,0,1,0
18,410,410,24,24,0,1,0
41,426,426,97,41,56,3,2
6,436,436,1,1,0,1,0
36,452,452,72,24,48,4,3
29,457,457,32,10,22,3,2
10,467,467,52,11,41,3,2
16,495,495,36,8,28,3,2

13,109,109,14,14,0,1,0
12,117,117,19,2,17,2,1
17,120,120,2,2,0,1,0
2,133,133,11,11,0,1,0
7,152,152,42,29,13,2,1
27,155,155,22,2,20,3,2
23,170,170,40,3,37,2,1
29,171,171,15,15,0,1,0
28,195,195,38,38,0,1,0
1,196,196,2,2,0,1,0
25,219,219,18,3,15,4,3
24,235,235,19,6,13,2,1
3,265,265,16,4,12,3,2
0,266,266,7,4,3,2,1
14,276,276,38,4,34,2,1
15,285,285,33,22,11,2,1
19,286,286,42,36,6,3,2
4,289,289,61,61,0,1,0
21,294,294,6,1,5,2,1
5,294,294,88,62,26,2,1
30,326,326,4,4,0,1,0
26,343,343,21,11,10,3,2
18,396,396,59,59,0,1,0
6,405,405,5,5,0,1,0
10,419,419,125,25,100,3,2
16,420,420,7,2,5,2,1
9,425,425,34,34,0,1,0
11,428,428,16,6,10,2,1
8,445,445,109,109,0,1,0
22,498,498,72,66,6,2,1
20,500,500,33,4,29,2,1

37,121,121,9,3,6,2,1
11,125,125,3,3,0,1,0
5,131,131,1,1,0,1,0
22,138,138,1,1,0,1,0
25,143,143,31,31,0,1,0
20,147,147,5,5,0,1,0
2,150,150,5,5,0,1,0
16,155,155,18,18,0,1,0
19,169,169,3,3,0,1,0
34,185,185,69,41,28,2,1
32,200,200,11,1,10,3,2
4,201,201,23,23,0,1,0
35,203,203,47,1,46,2,1
1,205,205,16,7,9,2,1
21,228,228,11,11,0,1,0
10,228,228,13,13,0,1,0
8,233,233,44,44,0,1,0
36,234,234,10,10,0,1,0
38,245,245,17,7,10,2,1
12,252,252,11,11,0,1,0
23,252,252,2,2,0,1,0
18,263,263,48,16,32,2,1
13,266,266,18,10,8,2,1
3,273,273,14,1,13,2,1
26,274,274,16,1,15,2,1
17,327,327,69,6,63,4,3
33,340,340,44,3,41,3,2
31,360,360,56,56,0,1,0
29,366,366,12,4,8,2,1
14,380,380,76,76,0,1,0
9,383,383,14,14,0,1,0
15,395,395,11,11,0,1,0
0,405,405,21,21,0,1,0
24,418,418,11,1,10,2,1
27,419,419,34,9,25,2,1
28,432,432,45,29,16,3,2
6,436,436,69,13,56,3,2
7,464,464,48,28,20,2,1
30,476,476,60,24,36,3,2

9,102,102,5,2,3,2,1
16,110,110,5,5,0,1,0
22,118,118,17,10,7,2,1
18,132,132,1,1,0,1,0
28,136,136,11,5,6,2,1
2,137,137,36,4,32,2,1
12,170,170,21,21,0,1,0
26,213,213,34,34,0,1,0
23,214,214,17,1,16,4,3
10,217,217,44,6,38,2,1
8,226,226,1,1,0,1,0
19,245,245,31,31,0,1,0
4,261,261,20,5,15,4,3
11,269,269,40,40,0,1,0
7,280,280,22,22,0,1,0
24,291,291,34,13,21,4,3
27,297,297,18,15,3,2,1
17,298,298,2,2,0,1,0
29,306,306,51,20,31,2,1
20,306,306,23,1,22,3,2
6,338,338,48,12,36,3,2
1,347,347,22,22,0,1,0
15,364,364,17,17,0,1,0
14,400,400,6,2,4,2,1
5,419,419,205,171,34,3,2
3,455,455,61,61,0,1,0
25,461,461,176,176,0,1,0
21,463,463,89,41,48,3,2
13,494,494,4,1,3,2,1
0,498,498,74,17,57,4,3

35,104,104,1,1,0,1,0
17,105,105,6,6,0,1,0
7,118,118,3,3,0,1,0
0,129,129,7,1,6,2,1
3,130,130,17,3,14,2,1
8,137,137,10,10,0,1,0
21,139,139,11,5,6,2,1
38,141,141,25,25,0,1,0
24,146,146,6,6,0,1,0
16,159,159,3,3,0,1,0
15,161,161,18,8,10,3,2
1,174,174,11,3,8,2,1
13,175,175,19,19,0,1,0
20,177,177,3,3,0,1,0
10,177,177,10,10,0,1,0
25,212,212,71,66,5,2,1
33,215,215,67,29,38,2,1
23,221,221,69,17,52,3,2
12,239,239,8,5,3,2,1
30,271,271,1,1,0,1,0
29,286,286,5,5,0,1,0
9,286,286,16,12,4,2,1
28,288,288,2,2,0,1,0
14,293,293,1,1,0,1,0
32,299,299,3,3,0,1,0
31,319,319,52,52,0,1,0
11,330,330,15,15,0,1,0
6,339,339,8,2,6,3,2
18,342,342,73,40,33,4,3
34,361,361,9,2,7,2,1
22,370,370,20,14,6,2,1
4,376,376,9,9,0,1,0
5,410,410,112,14,98,3,2
37,420,420,9,3,6,2,1
2,443,443,148,114,34,3,2
26,445,445,49,10,39,2,1
36,464,464,40,40,0,1,0
19,479,479,39,39,0,1,0
27,480,480,34,6,28,2,1

15,100,100,9,9,0,1,0
8,109,109,10,10,0,1,0
7,113,113,43,31,12,2,1
24,121,121,3,3,0,1,0
17,150,150,25,22,3,2,1
11,160,160,12,1,11,2,1
12,173,173,2,2,0,1,0
6,188,188,86,86,0,1,0
18,196,196,32,3,29,2,1
0,221,221,1,1,0,1,0
9,225,225,9,5,4,2,1
20,230,230,24,16,8,3,2
14,231,231,41,41,0,1,0
23,233,233,5,2,3,2,1
21,258,258,1,1,0,1,0
5,258,258,1,1,0,1,0
2,267,267,79,41,38,4,3
1,328,328,173,155,18,4,3
3,341,341,43,35,8,3,2
16,401,401,17,17,0,1,0
19,423,423,20,2,18,4,3
13,448,448,73,73,0,1,0
10,451,451,113,98,15,2,1
4,452,452,176,128,48,4,3
22,483,483,3,3,0,1,0

14,101,101,2,2,0,1,0
0,106,106,4,1,3,2,1
18,113,113,4,4,0,1,0
12,181,181,22,22,0,1,0
33,185,185,15,1,14,2,1
10,198,198,1,1,0,1,0
22,198,198,7,7,0,1,0
25,205,205,17,13,4,2,1
28,207,207,28,4,24,3,2
15,221,221,12,2,10,2,1
24,248,248,8,8,0,1,0
29,249,249,37,7,30,4,3
34,261,261,8,8,0,1,0
6,273,273,6,6,0,1,0
35,274,274,19,7,12,4,3
32,282,282,13,7,6,3,2
19,290,290,30,6,24,4,3
3,299,299,14,14,0,1,0
13,302,302,3,3,0,1,0
8,303,303,18,18,0,1,0
4,321,321,10,10,0,1,0
17,324,324,105,105,0,1,0
27,335,335,35,17,18,4,3
21,346,346,21,9,12,2,1
11,350,350,209,111,98,3,2
23,353,353,47,47,0,1,0
20,355,355,22,4,18,4,3
16,371,371,21,3,18,4,3
1,383,383,25,11,14,2,1
26,423,423,237,209,28,2,1
30,426,426,21,21,0,1,0
7,451,451,1,1,0,1,0
5,452,452,69,14,55,3,2
9,459,459,1,1,0,1,0
31,474,474,36,36,0,1,0
2,495,495,96,63,33,4,3

23,130,130,5,2,3,2,1
25,133,133,1,1,0,1,0
32,133,133,13,13,0,1,0
16,148,148,9,9,0,1,0
27,148,148,17,17,0,1,0
9,154,154,63,15,48,3,2
24,156,156,41,26,15,3,2
14,170,170,20,9,11,2,1
15,177,177,7,7,0,1,0
30,184,184,48,48,0,1,0
33,202,202,12,2,10,4,3
3,218,218,22,14,8,3,2
20,235,235,2,2,0,1,0
7,249,249,1,1,0,1,0
10,253,253,28,28,0,1,0
29,272,272,44,40,4,2,1
11,283,283,2,2,0,1,0
8,286,286,16,16,0,1,0
0,295,295,26,10,16,2,1
4,308,308,11,1,10,2,1
17,310,310,44,2,42,4,3
13,334,334,1,1,0,1,0
22,343,343,57,57,0,1,0
21,359,359,49,44,5,2,1
19,369,369,39,39,0,1,0
18,377,377,11,7,4,2,1
34,388,388,18,2,16,3,2
26,403,403,24,3,21,4,3
28,416,416,95,77,18,4,3
5,422,422,70,43,27,2,1
35,430,430,11,3,8,2,1
31,436,436,13,13,0,1,0
2,437,437,22,22,0,1,0
12,442,442,120,59,61,4,3
1,469,469,50,28,22,3,2
6,479,479,15,3,12,4,3

29,103,103,18,18,0,1,0
28,118,118,18,1,17,2,1
27,139,139,18,18,0,1,0
32,151,151,1,1,0,1,0
20,173,173,41,41,0,1,0
8,174,174,22,22,0,1,0
2,177,177,16,16,0,1,0
12,185,185,3,3,0,1,0
19,206,206,35,35,0,1,0
31,227,227,38,8,30,3,2
5,232,232,40,31,9,2,1
4,237,237,5,2,3,2,1
30,246,246,31,25,6,3,2
18,250,250,16,8,8,2,1
34,263,263,16,1,15,2,1
23,265,265,26,26,0,1,0
9,295,295,34,8,26,2,1
22,295,295,12,12,0,1,0
10,302,302,35,11,24,2,1
35,305,305,42,42,0,1,0
1,308,308,14,14,0,1,0
3,329,329,69,51,18,4,3
0,358,358,107,107,0,1,0
7,412,412,72,72,0,1,0
16,415,415,7,7,0,1,0
13,424,424,14,5,9,3,2
24,425,425,21,21,0,1,0
21,439,439,2,2,0,1,0
6,443,443,39,8,31,2,1
17,445,445,72,40,32,2,1
15,445,445,1,1,0,1,0
14,448,448,39,39,0,1,0
33,459,459,20,6,14,3,2
11,470,470,12,4,8,2,1
26,482,482,39,16,23,2,1
25,498,498,49,20,29,2,1

20,121,121,9,9,0,1,0
14,125,125,6,6,0,1,0
28,134,134,20,20,0,1,0
5,139,139,10,10,0,1,0
19,156,156,2,2,0,1,0
39,160,160,14,14,0,1,0
7,163,163,5,5,0,1,0
18,168,168,13,2,11,2,1
2,204,204,18,18,0,1,0
23,213,213,5,5,0,1,0
12,214,214,9,2,7,2,1
24,225,225,12,2,10,2,1
35,257,257,3,3,0,1,0
9,257,257,2,2,0,1,0
4,270,270,2,2,0,1,0
29,271,271,21,21,0,1,0
6,273,273,59,59,0,1,0
41,275,275,5,5,0,1,0
26,286,286,17,8,9,4,3
13,309,309,22,22,0,1,0
40,309,309,23,23,0,1,0
32,314,314,64,64,0,1,0
16,324,324,15,15,0,1,0
25,330,330,39,9,30,3,2
3,341,341,5,2,3,2,1
1,351,351,30,5,25,2,1
27,358,358,100,32,68,4,3
10,375,375,32,11,21,4,3
11,379,379,87,71,16,2,1
31,403,403,73,73,0,1,0
8,408,408,24,6,18,3,2
36,415,415,7,3,4,2,1
38,425,425,44,44,0,1,0
34,428,428,67,43,24,4,3
30,435,435,6,6,0,1,0
33,438,438,77,77,0,1,0
0,440,440,1,1,0,1,0
17,450,450,28,13,15,4,3
37,470,470,23,20,3,2,1
15,474,474,89,13,76,3,2
21,480,480,75,33,42,4,3
22,488,488,49,9,40,2,1

7,103,103,2,2,0,1,0
13,117,117,5,5,0,1,0
16,119,119,3,3,0,1,0
37,147,147,14,8,6,3,2
24,175,175,45,45,0,1,0
15,176,176,18,18,0,1,0
14,177,177,10,2,8,2,1
33,178,178,6,6,0,1,0
6,185,185,38,2,36,2,1
5,189,189,20,6,14,3,2
0,198,198,7,7,0,1,0
30,206,206,66,56,10,2,1
1,224,224,15,5,10,3,2
8,234,234,3,3,0,1,0
28,237,237,39,39,0,1,0
38,254,254,12,12,0,1,0
3,257,257,5,5,0,1,0
22,274,274,3,3,0,1,0
26,298,298,6,6,0,1,0
35,312,312,61,18,43,2,1
21,316,316,33,33,0,1,0
27,320,320,15,3,12,4,3
29,340,340,2,2,0,1,0
31,349,349,3,3,0,1,0
2,355,355,71,23,48,3,2
4,358,358,5,5,0,1,0
18,368,368,8,8,0,1,0
10,383,383,57,57,0,1,0
12,383,383,98,17,81,4,3
9,394,394,24,24,0,1,0
32,397,397,3,3,0,1,0
23,402,402,132,132,0,1,0
25,402,402,54,54,0,1,0
11,436,436,21,8,13,4,3
17,443,443,5,2,3,2,1
19,449,449,17,17,0,1,0
36,453,453,37,37,0,1,0
39,463,463,28,20,8,2,1
20,478,478,94,55,39,4,3
34,484,484,11,11,0,1,0
40,491,491,4,4,0,1,0

30,114,114,19,14,5,2,1
11,115,115,14,9,5,2,1
29,116,116,6,6,0,1,0
15,128,128,45,4,41,4,3
21,138,138,61,27,34,3,2
32,146,146,6,6,0,1,0
2,157,157,15,15,0,1,0
6,160,160,2,2,0,1,0
7,161,161,1,1,0,1,0
28,169,169,15,15,0,1,0
31,186,186,25,9,16,3,2
8,187,187,23,9,14,2,1
24,235,235,7,7,0,1,0
27,238,238,16,16,0,1,0
33,246,246,4,4,0,1,0
0,257,257,32,32,0,1,0
23,269,269,6,6,0,1,0
25,322,322,9,9,0,1,0
13,336,336,6,1,5,2,1
10,338,338,20,14,6,2,1
26,367,367,2,2,0,1,0
9,368,368,37,37,0,1,0
12,369,369,112,75,37,4,3
17,382,382,3,3,0,1,0
16,388,388,99,21,78,3,2
22,392,392,26,26,0,1,0
4,394,394,10,4,6,3,2
19,395,395,86,41,45,2,1
1,397,397,27,3,24,3,2
14,402,402,111,111,0,1,0
3,410,410,39,39,0,1,0
5,413,413,9,6,3,2,1
20,414,414,1,1,0,1,0
18,485,485,93,69,24,4,3

2,100,100,1,1,0,1,0
4,109,109,7,7,0,1,0
32,125,125,1,1,0,1,0
22,151,151,2,2,0,1,0
6,151,151,62,14,48,3,2
27,168,168,32,24,8,2,1
10,172,172,10,10,0,1,0
9,187,187,1,1,0,1,0
0,203,203,15,15,0,1,0
18,208,208,17,4,13,2,1
5,227,227,23,23,0,1,0
23,264,264,6,6,0,1,0
28,266,266,3,3,0,1,0
15,269,269,84,33,51,3,2
8,278,278,1,1,0,1,0
31,286,286,28,28,0,1,0
3,295,295,72,72,0,1,0
24,299,299,14,14,0,1,0
13,304,304,8,8,0,1,0
7,308,308,99,99,0,1,0
17,313,313,67,34,33,2,1
25,328,328,4,4,0,1,0
20,334,334,41,23,18,4,3
19,349,349,58,58,0,1,0
29,355,355,68,17,51,4,3
1,369,369,14,2,12,2,1
12,383,383,9,5,4,2,1
21,388,388,18,18,0,1,0
14,418,418,37,37,0,1,0
30,437,437,22,6,16,3,2
26,444,444,89,17,72,4,3
33,452,452,157,157,0,1,0
16,467,467,7,1,6,3,2
11,485,485,10,3,7,2,1

36,123,123,6,6,0,1,0
39,124,124,14,14,0,1,0
24,126,126,8,8,0,1,0
9,126,126,5,5,0,1,0
11,127,127,27,27,0,1,0
31,133,133,1,1,0,1,0
1,145,145,15,1,14,2,1
21,147,147,11,2,9,4,3
19,163,163,5,5,0,1,0
37,171,171,85,17,68,3,2
32,180,180,1,1,0,1,0
4,196,196,12,12,0,1,0
17,201,201,1,1,0,1,0
12,201,201,1,1,0,1,0
2,204,204,16,16,0,1,0
38,205,205,27,18,9,2,1
14,214,214,25,25,0,1,0
29,220,220,1,1,0,1,0
35,228,228,1,1,0,1,0
8,228,228,6,2,4,2,1
30,231,231,65,65,0,1,0
0,231,231,8,8,0,1,0
16,265,265,45,11,34,2,1
7,277,277,13,3,10,3,2
22,281,281,40,14,26,2,1
23,294,294,14,14,0,1,0
26,298,298,6,6,0,1,0
20,301,301,13,3,10,2,1
15,348,348,6,6,0,1,0
34,383,383,99,59,40,3,2
13,384,384,46,46,0,1,0
5,411,411,52,3,49,4,3
28,411,411,18,18,0,1,0
18,418,418,70,40,30,3,2
33,433,433,8,8,0,1,0
3,435,435,2,2,0,1,0
10,439,439,76,16,60,3,2
40,458,458,48,3,45,4,3
6,459,459,1,1,0,1,0
27,482,482,79,45,34,3,2
25,489,489,15,6,9,2,1

9,107,107,1,1,0,1,0
3,108,108,2,2,0,1,0
22,120,120,1,1,0,1,0
41,139,139,3,3,0,1,0
39,146,146,3,3,0,1,0
24,147,147,59,41,18,2,1
21,147,147,8,8,0,1,0
32,152,152,24,24,0,1,0
23,157,157,7,7,0,1,0
42,164,164,24,12,12,3,2
15,168,168,7,7,0,1,0
25,191,191,10,2,8,3,2
1,244,244,13,13,0,1,0
35,274,274,1,1,0,1,0
11,277,277,1,1,0,1,0
31,283,283,68,68,0,1,0
8,290,290,13,13,0,1,0
27,293,293,5,5,0,1,0
6,294,294,20,20,0,1,0
2,294,294,1,1,0,1,0
18,294,294,1,1,0,1,0
4,310,310,23,13,10,2,1
34,320,320,99,30,69,3,2
29,332,332,12,2,10,2,1
38,334,334,64,64,0,1,0
28,360,360,16,16,0,1,0
7,381,381,27,6,21,4,3
5,382,382,161,161,0,1,0
30,383,383,41,41,0,1,0
10,408,408,33,9,24,3,2
17,411,411,75,25,50,4,3
0,429,429,1,1,0,1,0
12,431,431,2,2,0,1,0
26,433,433,71,60,11,2,1
33,440,440,10,3,7,2,1
14,440,440,10,10,0,1,0
13,445,445,2,2,0,1,0
16,446,446,35,8,27,4,3
36,462,462,4,1,3,2,1
40,462,462,96,37,59,3,2
19,465,465,20,20,0,1,0
20,490,490,32,14,18,3,2
37,495,495,40,40,0,1,0

28,146,146,7,7,0,1,0
13,147,147,11,1,10,2,1
25,148,148,24,15,9,2,1
2,161,161,8,8,0,1,0
32,192,192,42,12,30,2,1
5,195,195,7,7,0,1,0
35,199,199,15,9,6,2,1
30,201,201,5,5,0,1,0
0,203,203,11,1,10,3,2
33,227,227,14,2,12,2,1
37,234,234,79,79,0,1,0
12,241,241,27,6,21,2,1
10,252,252,5,5,0,1,0
23,260,260,2,2,0,1,0
29,261,261,24,4,20,2,1
14,278,278,52,52,0,1,0
26,283,283,16,16,0,1,0
24,302,302,21,21,0,1,0
3,305,305,6,6,0,1,0
19,316,316,29,6,23,2,1
18,317,317,45,45,0,1,0
7,333,333,4,4,0,1,0
36,336,336,21,21,0,1,0
22,349,349,3,3,0,1,0
27,353,353,51,43,8,2,1
11,354,354,51,3,48,3,2
1,372,372,4,1,3,2,1
16,373,373,27,1,26,3,2
31,377,377,22,22,0,1,0
21,392,392,21,21,0,1,0
6,392,392,18,6,12,3,2
4,406,406,3,3,0,1,0
9,415,415,36,14,22,2,1
17,427,427,121,38,83,4,3
34,454,454,88,25,63,4,3
15,487,487,154,144,10,3,2
8,487,487,17,17,0,1,0
20,489,489,81,81,0,1,0

20,112,112,3,3,0,1,0
28,113,113,4,1,3,2,1
2,117,117,13,13,0,1,0
8,134,134,19,14,5,2,1
10,134,134,8,8,0,1,0
5,135,135,6,6,0,1,0
1,140,140,5,2,3,2,1
16,145,145,6,6,0,1,0
12,151,151,1,1,0,1,0
26,158,158,16,1,15,2,1
15,162,162,58,9,49,3,2
19,180,180,7,7,0,1,0
31,186,186,23,5,18,3,2
13,198,198,17,17,0,1,0
9,205,205,1,1,0,1,0
24,230,230,74,54,20,3,2
29,241,241,28,7,21,2,1
14,241,241,6,6,0,1,0
4,241,241,20,3,17,2,1
3,252,252,1,1,0,1,0
18,276,276,62,62,0,1,0
34,280,280,21,21,0,1,0
23,282,282,26,16,10,3,2
17,296,296,55,6,49,4,3
22,297,297,5,5,0,1,0
7,309,309,166,166,0,1,0
35,313,313,37,28,9,2,1
11,337,337,6,6,0,1,0
6,356,356,14,10,4,2,1
0,357,357,7,7,0,1,0
21,383,383,7,7,0,1,0
30,413,413,20,3,17,3,2
32,427,427,18,18,0,1,0
27,433,433,104,2,102,4,3
33,446,446,65,65,0,1,0
25,487,487,28,11,17,2,1

18,129,129,1,1,0,1,0
16,186,186,1,1,0,1,0
27,189,189,17,17,0,1,0
42,189,189,35,21,14,3,2
35,192,192,4,4,0,1,0
39,201,201,30,4,26,2,1
41,206,206,36,36,0,1,0
33,220,220,35,15,20,3,2
2,225,225,132,59,73,4,3
6,237,237,17,9,8,2,1
38,246,246,48,2,46,2,1
28,252,252,41,34,7,2,1
9,267,267,1,1,0,1,0
23,267,267,11,11,0,1,0
20,289,289,6,6,0,1,0
15,290,290,39,39,0,1,0
12,293,293,5,5,0,1,0
17,311,311,5,5,0,1,0
25,356,356,2,2,0,1,0
14,366,366,28,28,0,1,0
19,366,366,5,2,3,2,1
24,378,378,13,5,8,2,1
11,381,381,6,6,0,1,0
37,390,390,19,19,0,1,0
21,392,392,15,1,14,2,1
26,394,394,10,6,4,2,1
5,402,402,19,19,0,1,0
4,408,408,17,17,0,1,0
22,412,412,26,26,0,1,0
40,413,413,11,11,0,1,0
13,416,416,6,6,0,1,0
1,418,418,16,5,11,2,1
36,418,418,52,52,0,1,0
34,434,434,8,8,0,1,0
29,452,452,37,7,30,4,3
32,457,457,22,2,20,3,2
7,457,457,27,3,24,4,3
31,459,459,51,51,0,1,0
30,467,467,96,12,84,4,3
3,474,474,1,1,0,1,0
8,487,487,175,126,49,2,1
0,495,495,2,2,0,1,0
10,500,500,44,44,0,1,0

4,120,120,2,2,0,1,0
22,132,132,13,4,9,3,2
21,139,139,5,5,0,1,0
12,154,154,1,1,0,1,0
19,166,166,18,6,12,2,1
38,167,167,31,31,0,1,0
36,169,169,1,1,0,1,0
34,171,171,24,24,0,1,0
11,181,181,47,47,0,1,0
7,182,182,11,11,0,1,0
20,187,187,17,6,11,2,1
24,210,210,9,9,0,1,0
5,213,213,28,28,0,1,0
27,218,218,17,17,0,1,0
25,218,218,27,27,0,1,0
9,220,220,24,15,9,2,1
2,224,224,13,7,6,2,1
26,232,232,49,49,0,1,0
39,250,250,28,21,7,2,1
13,252,252,69,29,40,2,1
32,314,314,32,32,0,1,0
17,325,325,1,1,0,1,0
6,342,342,5,5,0,1,0
30,354,354,25,25,0,1,0
15,363,363,9,9,0,1,0
37,387,387,22,22,0,1,0
0,397,397,2,2,0,1,0
35,426,426,29,18,11,2,1
14,429,429,5,5,0,1,0
8,434,434,24,2,22,3,2
31,436,436,55,55,0,1,0
29,438,438,92,92,0,1,0
33,442,442,36,36,0,1,0
23,448,448,3,3,0,1,0
1,456,456,13,13,0,1,0
16,466,466,23,5,18,4,3
18,468,468,23,23,0,1,0
3,472,472,108,48,60,3,2
40,482,482,39,11,28,3,2
28,487,487,62,49,13,2,1
10,487,487,41,41,0,1,0

2,101,101,1,1,0,1,0
11,114,114,5,5,0,1,0
1,135,135,10,10,0,1,0
22,143,143,6,6,0,1,0
4,175,175,39,27,12,3,2
27,180,180,4,4,0,1,0
8,185,185,30,18,12,2,1
29,215,215,30,7,23,4,3
36,217,217,7,7,0,1,0
35,232,232,38,9,29,2,1
34,233,233,5,5,0,1,0
0,248,248,12,4,8,3,2
9,249,249,37,20,17,2,1
30,270,270,9,6,3,2,1
25,288,288,41,41,0,1,0
19,292,292,58,8,50,3,2
20,295,295,16,16,0,1,0
26,296,296,20,20,0,1,0
12,303,303,83,83,0,1,0
14,313,313,17,13,4,2,1
6,317,317,38,6,32,2,1
3,337,337,32,32,0,1,0
18,360,360,2,2,0,1,0
32,379,379,22,1,21,4,3
21,380,380,12,12,0,1,0
10,391,391,60,60,0,1,0
13,397,397,5,2,3,2,1
16,425,425,40,25,15,4,3
7,432,432,59,59,0,1,0
17,438,438,4,4,0,1,0
33,442,442,199,160,39,4,3
24,448,448,6,6,0,1,0
15,450,450,1,1,0,1,0
31,482,482,57,57,0,1,0
5,485,485,65,50,15,4,3
23,493,493,20,6,14,2,1
28,498,498,103,49,54,4,3

17,122,122,3,3,0,1,0
16,157,157,31,25,6,2,1
1,171,171,16,7,9,2,1
5,171,171,25,25,0,1,0
4,173,173,16,2,14,2,1
2,181,181,12,12,0,1,0
0,186,186,7,7,0,1,0
32,206,206,1,1,0,1,0
18,213,213,8,8,0,1,0
21,243,243,36,36,0,1,0
24,259,259,3,3,0,1,0
23,260,260,54,5,49,4,3
3,275,275,62,62,0,1,0
31,278,278,42,42,0,1,0
13,296,296,15,15,0,1,0
9,299,299,39,39,0,1,0
8,310,310,26,4,22,3,2
34,310,310,34,34,0,1,0
22,313,313,87,39,48,3,2
27,333,333,23,11,12,3,2
28,335,335,4,4,0,1,0
25,336,336,48,15,33,2,1
20,337,337,36,2,34,4,3
33,364,364,76,46,30,4,3
19,369,369,4,4,0,1,0
11,373,373,13,13,0,1,0
15,375,375,59,52,7,2,1
7,398,398,45,15,30,4,3
26,402,402,1,1,0,1,0
14,410,410,52,8,44,3,2
29,419,419,50,42,8,2,1
30,421,421,77,42,35,2,1
10,456,456,31,31,0,1,0
6,460,460,1,1,0,1,0
12,461,461,81,81,0,1,0

29,108,108,9,9,0,1,0
12,120,120,5,5,0,1,0
33,132,132,16,16,0,1,0
19,137,137,16,16,0,1,0
11,138,138,1,1,0,1,0
15,139,139,17,17,0,1,0
26,156,156,2,2,0,1,0
4,164,164,29,15,14,3,2
18,180,180,4,4,0,1,0
34,185,185,4,4,0,1,0
2,187,187,48,22,26,4,3
1,189,189,5,5,0,1,0
9,203,203,24,2,22,4,3
30,204,204,57,57,0,1,0
16,219,219,33,33,0,1,0
22,227,227,10,5,5,2,1
32,230,230,16,16,0,1,0
14,266,266,7,7,0,1,0
20,273,273,2,2,0,1,0
25,294,294,51,43,8,2,1
3,307,307,63,58,5,2,1
10,311,311,21,21,0,1,0
28,319,319,60,60,0,1,0
23,320,320,15,2,13,2,1
6,321,321,18,9,9,4,3
17,324,324,11,1,10,3,2
7,325,325,3,3,0,1,0
13,340,340,10,6,4,2,1
5,346,346,62,62,0,1,0
0,348,348,95,67,28,2,1
21,373,373,43,43,0,1,0
31,394,394,91,51,40,4,3
27,396,396,37,37,0,1,0
24,415,415,79,38,41,4,3
8,438,438,25,25,0,1,0

10,101,101,1,1,0,1,0
35,102,102,8,8,0,1,0
34,117,117,2,2,0,1,0
31,137,137,10,1,9,4,3
20,148,148,7,3,4,2,1
18,159,159,1,1,0,1,0
29,167,167,15,15,0,1,0
26,180,180,32,32,0,1,0
28,196,196,2,2,0,1,0
12,215,215,9,9,0,1,0
4,217,217,26,26,0,1,0
17,222,222,7,4,3,2,1
6,230,230,13,13,0,1,0
27,236,236,57,20,37,2,1
36,243,243,7,7,0,1,0
24,248,248,6,6,0,1,0
33,249,249,76,30,46,2,1
22,250,250,28,1,27,4,3
0,260,260,19,9,10,2,1
9,264,264,34,14,20,2,1
19,267,267,23,23,0,1,0
23,273,273,2,2,0,1,0
15,275,275,26,26,0,1,0
21,284,284,71,39,32,2,1
30,298,298,22,22,0,1,0
25,313,313,4,4,0,1,0
14,324,324,28,19,9,2,1
5,328,328,4,4,0,1,0
3,335,335,69,51,18,3,2
16,362,362,1,1,0,1,0
1,369,369,35,35,0,1,0
2,407,407,21,3,18,4,3
8,407,407,11,6,5,2,1
11,416,416,52,6,46,2,1
13,427,427,114,17,97,4,3
32,439,439,9,6,3,2,1
7,460,460,129,129,0,1,0
37,494,494,135,27,108,4,3

23,100,100,21,16,5,2,1
16,108,108,3,3,0,1,0
21,112,112,26,26,0,1,0
18,113,113,17,17,0,1,0
9,125,125,21,21,0,1,0
4,137,137,19,19,0,1,0
6,162,162,3,3,0,1,0
13,166,166,14,14,0,1,0
7,185,185,32,32,0,1,0
19,242,242,67,67,0,1,0
3,243,243,12,12,0,1,0
14,278,278,19,19,0,1,0
1,278,278,160,43,117,4,3
11,283,283,5,5,0,1,0
10,287,287,85,57,28,2,1
20,296,296,12,12,0,1,0
24,296,296,24,24,0,1,0
22,336,336,30,30,0,1,0
5,339,339,30,30,0,1,0
12,347,347,13,9,4,2,1
17,359,359,31,7,24,4,3
15,368,368,3,3,0,1,0
2,407,407,2,2,0,1,0
26,408,408,24,24,0,1,0
27,413,413,3,3,0,1,0
0,438,438,24,24,0,1,0
25,441,441,21,7,14,2,1
8,479,479,113,19,94,4,3
28,496,496,160,106,54,4,3

23,105,105,1,1,0,1,0
1,106,106,1,1,0,1,0
19,109,109,5,5,0,1,0
7,112,112,6,3,3,2,1
3,125,125,18,7,11,2,1
27,139,139,17,17,0,1,0
30,140,140,11,1,10,2,1
6,147,147,22,22,0,1,0
14,151,151,39,14,25,2,1
9,165,165,19,3,16,3,2
11,193,193,34,34,0,1,0
20,233,233,16,16,0,1,0
26,235,235,21,9,12,3,2
17,245,245,29,29,0,1,0
24,248,248,7,7,0,1,0
29,251,251,30,6,24,2,1
25,254,254,26,26,0,1,0
13,276,276,1,1,0,1,0
18,286,286,20,4,16,3,2
8,316,316,41,41,0,1,0
4,343,343,29,12,17,2,1
10,381,381,36,36,0,1,0
32,410,410,41,13,28,2,1
16,410,410,20,20,0,1,0
31,425,425,208,144,64,3,2
21,443,443,51,51,0,1,0
22,448,448,21,5,16,2,1
28,459,459,74,11,63,4,3
5,473,473,73,73,0,1,0
12,474,474,59,26,33,4,3
2,490,490,15,15,0,1,0
0,495,495,137,137,0,1,0
15,498,498,10,10,0,1,0

12,101,101,18,18,0,1,0
19,108,108,16,8,8,3,2
24,140,140,5,2,3,2,1
27,171,171,23,5,18,4,3
32,182,182,69,56,13,2,1
31,202,202,6,6,0,1,0
0,203,203,4,1,3,2,1
3,220,220,1,1,0,1,0
11,224,224,15,15,0,1,0
1,227,227,48,21,27,2,1
13,230,230,57,35,22,2,1
14,251,251,4,1,3,2,1
29,259,259,34,34,0,1,0
7,264,264,8,8,0,1,0
2,285,285,84,84,0,1,0
6,292,292,35,35,0,1,0
21,293,293,2,2,0,1,0
9,295,295,22,10,12,4,3
20,308,308,77,17,60,3,2
25,308,308,12,12,0,1,0
17,374,374,7,7,0,1,0
4,382,382,80,35,45,4,3
30,403,403,2,2,0,1,0
5,412,412,98,32,66,4,3
23,440,440,12,3,9,4,3
8,454,454,29,29,0,1,0
18,460,460,37,37,0,1,0
26,471,471,5,5,0,1,0
15,474,474,17,9,8,3,2
22,474,474,9,9,0,1,0
10,476,476,13,13,0,1,0
16,483,483,178,125,53,4,3
28,485,485,60,11,49,4,3

20,113,113,2,2,0,1,0
24,134,134,4,4,0,1,0
0,146,146,7,7,0,1,0
11,170,170,1,1,0,1,0
13,197,197,14,14,0,1,0
35,208,208,3,3,0,1,0
2,213,213,4,1,3,2,1
6,221,221,1,1,0,1,0
32,224,224,34,1,33,2,1
21,243,243,50,27,23,4,3
18,250,250,9,1,8,2,1
5,265,265,10,1,9,4,3
29,268,268,21,1,20,3,2
28,294,294,144,72,72,4,3
26,298,298,21,5,16,2,1
10,307,307,124,65,59,4,3
33,339,339,7,7,0,1,0
17,342,342,22,22,0,1,0
3,353,353,41,41,0,1,0
27,356,356,7,7,0,1,0
23,359,359,24,6,18,2,1
31,362,362,29,29,0,1,0
1,365,365,43,7,36,2,1
19,366,366,13,6,7,2,1
16,370,370,1,1,0,1,0
14,370,370,117,39,78,3,2
7,389,389,28,17,11,2,1
8,389,389,86,86,0,1,0
22,428,428,101,86,15,2,1
15,432,432,96,37,59,4,3
9,438,438,6,6,0,1,0
12,444,444,9,4,5,2,1
4,447,447,5,1,4,2,1
34,456,456,32,32,0,1,0
25,456,456,54,54,0,1,0
36,485,485,25,25,0,1,0
30,492,492,38,10,28,4,3

22,104,104,1,1,0,1,0
23,106,106,6,6,0,1,0
1,110,110,3,3,0,1,0
38,111,111,3,3,0,1,0
20,121,121,5,2,3,2,1
11,138,138,1,1,0,1,0
5,138,138,6,3,3,2,1
19,142,142,6,6,0,1,0
33,151,151,10,1,9,4,3
37,155,155,13,13,0,1,0
2,158,158,36,4,32,3,2
26,188,188,2,2,0,1,0
17,196,196,24,24,0,1,0
21,207,207,63,63,0,1,0
3,225,225,31,31,0,1,0
30,234,234,6,6,0,1,0
4,239,239,64,49,15,2,1
27,251,251,17,17,0,1,0
16,253,253,15,15,0,1,0
40,261,261,22,4,18,4,3
35,276,276,35,35,0,1,0
7,280,280,2,2,0,1,0
32,281,281,31,31,0,1,0
34,290,290,37,37,0,1,0
9,294,294,11,11,0,1,0
24,323,323,49,13,36,3,2
10,325,325,9,6,3,2,1
39,364,364,41,41,0,1,0
8,382,382,6,6,0,1,0
6,395,395,3,3,0,1,0
12,411,411,59,59,0,1,0
14,414,414,70,34,36,4,3
0,417,417,5,2,3,2,1
36,422,422,190,64,126,4,3
29,426,426,75,35,40,4,3
28,428,428,42,42,0,1,0
25,435,435,2,2,0,1,0
15,445,445,13,5,8,3,2
13,465,465,25,22,3,2,1
31,471,471,26,26,0,1,0
18,480,480,7,7,0,1,0

16,100,100,5,5,0,1,0
8,112,112,4,1,3,2,1
14,135,135,1,1,0,1,0
18,135,135,16,4,12,4,3
0,145,145,51,39,12,3,2
6,163,163,18,18,0,1,0
33,179,179,23,23,0,1,0
10,206,206,8,8,0,1,0
11,240,240,8,3,5,2,1
15,249,249,13,13,0,1,0
30,251,251,8,4,4,2,1
9,274,274,69,69,0,1,0
31,274,274,12,9,3,2,1
4,274,274,53,41,12,4,3
13,275,275,6,6,0,1,0
3,275,275,42,42,0,1,0
20,291,291,99,27,72,3,2
19,304,304,31,13,18,2,1
5,321,321,38,38,0,1,0
21,323,323,5,5,0,1,0
28,329,329,4,4,0,1,0
32,335,335,32,12,20,2,1
24,340,340,8,3,5,2,1
26,360,360,39,4,35,2,1
2,362,362,27,3,24,3,2
29,401,401,80,80,0,1,0
7,402,402,18,9,9,2,1
25,410,410,54,54,0,1,0
22,429,429,15,15,0,1,0
12,436,436,57,57,0,1,0
23,445,445,2,2,0,1,0
27,459,459,127,46,81,4,3
1,464,464,85,40,45,4,3
17,491,491,54,14,40,2,1

14,110,110,20,20,0,1,0
33,115,115,37,1,36,4,3
30,132,132,22,1,21,2,1
0,136,136,5,5,0,1,0
42,145,145,2,2,0,1,0
8,171,171,2,2,0,1,0
29,183,183,42,3,39,2,1
25,185,185,34,34,0,1,0
19,196,196,91,50,41,4,3
23,199,199,2,2,0,1,0
2,199,199,41,3,38,3,2
38,201,201,17,17,0,1,0
28,209,209,11,11,0,1,0
24,219,219,20,16,4,2,1
9,221,221,8,8,0,1,0
11,227,227,1,1,0,1,0
13,229,229,10,10,0,1,0
22,230,230,7,7,0,1,0
1,242,242,1,1,0,1,0
31,261,261,7,7,0,1,0
40,263,263,37,16,21,4,3
20,275,275,26,26,0,1,0
34,282,282,1,1,0,1,0
35,285,285,40,23,17,2,1
15,297,297,8,8,0,1,0
27,299,299,3,3,0,1,0
3,325,325,7,1,6,2,1
37,337,337,17,17,0,1,0
39,340,340,51,51,0,1,0
18,350,350,3,3,0,1,0
41,359,359,3,3,0,1,0
32,364,364,3,3,0,1,0
36,368,368,58,34,24,4,3
5,400,400,4,4,0,1,0
12,435,435,8,3,5,2,1
4,445,445,28,7,21,4,3
17,455,455,3,3,0,1,0
10,458,458,117,117,0,1,0
16,467,467,10,2,8,2,1
26,472,472,44,26,18,3,2
7,486,486,14,14,0,1,0
21,494,494,34,34,0,1,0
6,496,496,28,28,0,1,0

19,109,109,2,2,0,1,0
18,115,115,13,8,5,2,1
2,120,120,16,10,6,3,2
24,144,144,15,1,14,3,2
10,153,153,5,5,0,1,0
3,167,167,4,4,0,1,0
8,169,169,17,17,0,1,0
27,181,181,13,7,6,3,2
14,182,182,13,3,10,4,3
26,199,199,10,10,0,1,0
1,214,214,35,2,33,4,3
35,214,214,25,6,19,2,1
13,223,223,54,50,4,2,1
15,230,230,16,16,0,1,0
31,231,231,39,8,31,4,3
7,247,247,36,28,8,3,2
29,267,267,7,7,0,1,0
21,288,288,6,6,0,1,0
16,299,299,28,1,27,4,3
30,299,299,13,3,10,2,1
36,316,316,43,43,0,1,0
20,333,333,32,13,19,3,2
23,336,336,25,13,12,4,3
33,341,341,1,1,0,1,0
34,342,342,25,13,12,2,1
11,344,344,100,24,76,3,2
25,346,346,29,29,0,1,0
12,352,352,14,6,8,2,1
9,386,386,1,1,0,1,0
5,398,398,34,34,0,1,0
17,428,428,6,6,0,1,0
0,452,452,18,12,6,3,2
37,461,461,146,32,114,4,3
28,473,473,112,87,25,2,1
22,478,478,10,10,0,1,0
6,488,488,42,12,30,3,2
4,491,491,19,19,0,1,0
32,493,493,90,90,0,1,0

26,128,128,24,6,18,4,3
11,153,153,9,9,0,1,0
33,155,155,3,3,0,1,0
1,157,157,2,2,0,1,0
27,166,166,23,23,0,1,0
28,167,167,28,1,27,4,3
9,175,175,1,1,0,1,0
19,180,180,3,3,0,1,0
24,181,181,3,3,0,1,0
13,197,197,2,2,0,1,0
10,209,209,12,3,9,2,1
7,209,209,1,1,0,1,0
36,209,209,9,9,0,1,0
16,210,210,2,2,0,1,0
5,223,223,26,2,24,4,3
29,235,235,66,66,0,1,0
25,235,235,35,5,30,4,3
32,236,236,30,30,0,1,0
31,243,243,36,36,0,1,0
39,273,273,2,2,0,1,0
4,289,289,67,25,42,3,2
2,315,315,1,1,0,1,0
18,318,318,14,6,8,2,1
34,346,346,18,12,6,2,1
38,358,358,15,1,14,2,1
12,362,362,66,66,0,1,0
30,374,374,50,17,33,2,1
6,384,384,49,49,0,1,0
14,388,388,43,22,21,4,3
23,388,388,39,24,15,4,3
17,413,413,2,2,0,1,0
3,422,422,150,150,0,1,0
0,433,433,8,8,0,1,0
21,436,436,78,78,0,1,0
35,439,439,19,19,0,1,0
22,444,444,21,9,12,4,3
15,450,450,2,2,0,1,0
37,450,450,60,10,50,4,3
8,455,455,72,51,21,4,3
20,485,485,43,40,3,2,1

10,120,120,19,1,18,4,3
33,124,124,2,2,0,1,0
31,135,135,30,30,0,1,0
16,138,138,1,1,0,1,0
2,163,163,21,21,0,1,0
15,166,166,25,4,21,4,3
5,188,188,4,4,0,1,0
18,196,196,28,28,0,1,0
30,206,206,15,15,0,1,0
20,211,211,8,8,0,1,0
0,228,228,25,25,0,1,0
32,234,234,9,1,8,3,2
14,239,239,28,20,8,2,1
24,242,242,2,2,0,1,0
3,248,248,34,34,0,1,0
6,256,256,7,7,0,1,0
28,279,279,70,70,0,1,0
7,282,282,51,16,35,4,3
26,290,290,2,2,0,1,0
13,302,302,3,3,0,1,0
36,311,311,39,23,16,3,2
23,325,325,40,27,13,2,1
27,351,351,9,9,0,1,0
34,364,364,102,102,0,1,0
8,385,385,9,1,8,3,2
9,394,394,33,33,0,1,0
25,399,399,6,6,0,1,0
17,414,414,56,11,45,4,3
21,421,421,137,128,9,4,3
19,433,433,11,3,8,3,2
12,450,450,14,14,0,1,0
29,454,454,43,43,0,1,0
11,466,466,33,33,0,1,0
22,472,472,76,76,0,1,0
1,473,473,10,6,4,2,1
4,491,491,120,76,44,2,1
35,496,496,5,5,0,1,0

24,103,103,25,13,12,4,3
20,134,134,12,12,0,1,0
26,139,139,14,14,0,1,0
8,147,147,12,12,0,1,0
4,154,154,7,7,0,1,0
12,184,184,46,46,0,1,0
28,195,195,10,10,0,1,0
16,219,219,2,2,0,1,0
3,235,235,28,8,20,3,2
15,238,238,24,24,0,1,0
18,238,238,20,20,0,1,0
22,239,239,16,16,0,1,0
19,242,242,16,10,6,3,2
23,255,255,21,21,0,1,0
10,262,262,12,12,0,1,0
13,295,295,23,1,22,3,2
1,298,298,64,64,0,1,0
0,317,317,19,10,9,2,1
5,320,320,55,4,51,3,2
25,361,361,73,60,13,2,1
27,373,373,2,2,0,1,0
32,388,388,1,1,0,1,0
2,391,391,1,1,0,1,0
14,408,408,49,49,0,1,0
11,433,433,45,25,20,3,2
7,446,446,53,48,5,2,1
9,452,452,148,126,22,2,1
17,472,472,110,110,0,1,0
29,482,482,45,9,36,3,2
21,487,487,2,2,0,1,0
6,492,492,30,30,0,1,0
30,496,496,99,25,74,4,3
31,499,499,102,102,0,1,0

23,106,106,15,15,0,1,0
8,109,109,1,1,0,1,0
20,124,124,35,35,0,1,0
30,134,134,18,14,4,2,1
12,138,138,30,17,13,2,1
25,161,161,48,48,0,1,0
1,185,185,6,1,5,2,1
18,188,188,6,3,3,2,1
26,195,195,8,8,0,1,0
29,201,201,18,2,16,3,2
10,233,233,5,1,4,2,1
4,247,247,9,6,3,2,1
0,255,255,17,17,0,1,0
6,260,260,18,2,16,3,2
17,271,271,36,16,20,2,1
22,274,274,28,28,0,1,0
5,276,276,23,7,16,2,1
27,283,283,38,38,0,1,0
3,285,285,39,39,0,1,0
21,291,291,27,11,16,2,1
33,297,297,34,14,20,2,1
9,305,305,99,99,0,1,0
28,313,313,36,36,0,1,0
2,319,319,35,19,16,2,1
19,343,343,12,12,0,1,0
24,355,355,2,2,0,1,0
14,363,363,108,2,106,4,3
32,368,368,3,3,0,1,0
13,419,419,33,33,0,1,0
31,457,457,1,1,0,1,0
15,471,471,32,4,28,2,1
11,481,481,47,13,34,3,2
16,482,482,24,24,0,1,0
7,491,491,50,39,11,2,1
34,494,494,38,8,30,2,1

42,101,101,6,6,0,1,0
16,106,106,11,11,0,1,0
43,108,108,8,8,0,1,0
4,154,154,22,6,16,2,1
6,157,157,7,7,0,1,0
41,169,169,13,13,0,1,0
5,187,187,5,5,0,1,0
17,189,189,2,2,0,1,0
32,198,198,34,12,22,2,1
26,199,199,11,6,5,2,1
12,199,199,10,10,0,1,0
37,201,201,11,11,0,1,0
14,205,205,29,29,0,1,0
1,214,214,13,1,12,2,1
3,215,215,5,5,0,1,0
23,221,221,27,6,21,3,2
39,226,226,52,52,0,1,0
19,230,230,7,1,6,2,1
29,245,245,14,9,5,2,1
7,250,250,40,8,32,3,2
31,251,251,12,12,0,1,0
40,262,262,32,26,6,2,1
28,265,265,8,8,0,1,0
24,268,268,67,19,48,4,3
10,271,271,19,19,0,1,0
15,294,294,1,1,0,1,0
44,298,298,84,20,64,4,3
27,307,307,52,52,0,1,0
9,315,315,9,9,0,1,0
2,320,320,8,8,0,1,0
30,322,322,29,15,14,3,2
21,342,342,14,14,0,1,0
46,369,369,15,15,0,1,0
18,386,386,5,5,0,1,0
25,388,388,2,2,0,1,0
38,390,390,4,1,3,2,1
45,390,390,58,58,0,1,0
33,406,406,57,34,23,2,1
22,407,407,8,8,0,1,0
35,411,411,70,9,61,4,3
0,415,415,24,17,7,2,1
34,420,420,2,2,0,1,0
11,436,436,1,1,0,1,0
13,441,441,21,21,0,1,0
36,443,443,30,19,11,2,1
8,482,482,7,1,6,3,2
20,484,484,25,9,16,2,1

14,102,102,14,14,0,1,0
17,127,127,7,2,5,2,1
21,130,130,6,6,0,1,0
11,166,166,11,11,0,1,0
34,167,167,20,14,6,2,1
8,168,168,1,1,0,1,0
32,193,193,32,32,0,1,0
10,206,206,79,49,30,4,3
2,212,212,4,4,0,1,0
3,213,213,14,2,12,2,1
15,221,221,1,1,0,1,0
0,230,230,19,19,0,1,0
24,236,236,22,12,10,3,2
7,252,252,33,33,0,1,0
31,254,254,26,26,0,1,0
38,257,257,4,4,0,1,0
9,302,302,11,1,10,3,2
28,307,307,1,1,0,1,0
25,326,326,117,101,16,3,2
16,327,327,25,25,0,1,0
5,340,340,13,4,9,2,1
29,350,350,9,9,0,1,0
23,369,369,26,18,8,3,2
30,372,372,64,64,0,1,0
36,373,373,31,1,30,2,1
18,380,380,12,8,4,2,1
33,410,410,6,6,0,1,0
13,418,418,12,3,9,2,1
12,418,418,4,4,0,1,0
6,420,420,16,1,15,4,3
20,420,420,84,33,51,3,2
26,428,428,41,26,15,2,1
35,433,433,75,54,21,2,1
4,441,441,88,30,58,3,2
27,448,448,59,59,0,1,0
37,462,462,1,1,0,1,0
1,470,470,88,73,15,2,1
22,482,482,75,60,15,2,1
19,485,485,2,2,0,1,0

1,102,102,1,1,0,1,0
10,104,104,4,4,0,1,0
18,114,114,2,2,0,1,0
36,138,138,8,8,0,1,0
41,153,153,2,2,0,1,0
17,156,156,11,4,7,2,1
21,171,171,22,8,14,2,1
42,179,179,36,21,15,4,3
34,198,198,17,17,0,1,0
13,202,202,22,22,0,1,0
3,203,203,6,6,0,1,0
38,205,205,7,7,0,1,0
26,233,233,5,5,0,1,0
43,241,241,2,2,0,1,0
9,243,243,12,2,10,3,2
28,244,244,202,132,70,3,2
45,252,252,7,7,0,1,0
24,266,266,12,2,10,2,1
39,272,272,11,5,6,2,1
23,275,275,12,12,0,1,0
5,277,277,33,5,28,2,1
40,288,288,7,2,5,2,1
14,289,289,2,2,0,1,0
11,297,297,18,18,0,1,0
12,303,303,17,1,16,2,1
16,305,305,44,9,35,4,3
6,345,345,1,1,0,1,0
15,350,350,21,21,0,1,0
35,370,370,24,21,3,2,1
31,380,380,41,11,30,4,3
29,398,398,17,5,12,2,1
33,411,411,5,5,0,1,0
19,418,418,1,1,0,1,0
7,429,429,51,51,0,1,0
32,430,430,41,35,6,3,2
37,431,431,15,6,9,2,1
0,442,442,8,8,0,1,0
25,445,445,99,99,0,1,0
22,462,462,4,4,0,1,0
20,468,468,110,76,34,3,2
8,476,476,32,32,0,1,0
4,477,477,46,46,0,1,0
27,482,482,3,3,0,1,0
30,486,486,35,35,0,1,0
44,489,489,40,40,0,1,0
2,490,490,6,6,0,1,0

39,118,118,10,10,0,1,0
34,119,119,2,2,0,1,0
15,136,136,12,12,0,1,0
27,143,143,38,38,0,1,0
35,167,167,26,26,0,1,0
40,170,170,13,13,0,1,0
20,175,175,11,11,0,1,0
8,187,187,29,29,0,1,0
11,202,202,1,1,0,1,0
13,208,208,1,1,0,1,0
25,209,209,14,3,11,2,1
38,223,223,2,2,0,1,0
29,227,227,20,10,10,4,3
10,258,258,14,14,0,1,0
33,271,271,16,12,4,2,1
19,274,274,29,29,0,1,0
28,293,293,29,21,8,2,1
14,304,304,11,2,9,4,3
6,317,317,1,1,0,1,0
1,324,324,31,5,26,3,2
4,339,339,13,13,0,1,0
26,346,346,19,19,0,1,0
21,352,352,42,42,0,1,0
23,355,355,103,103,0,1,0
3,360,360,17,17,0,1,0
32,360,360,41,41,0,1,0
0,370,370,3,3,0,1,0
37,395,395,52,52,0,1,0
7,396,396,5,5,0,1,0
12,410,410,40,40,0,1,0
30,414,414,28,7,21,2,1
17,422,422,50,30,20,2,1
22,430,430,25,25,0,1,0
16,435,435,52,52,0,1,0
36,440,440,54,24,30,4,3
24,449,449,36,18,18,4,3
5,457,457,72,72,0,1,0
2,461,461,110,110,0,1,0
31,468,468,23,17,6,3,2
9,472,472,44,16,28,3,2
18,475,475,39,39,0,1,0

0,106,106,4,4,0,1,0
37,106,106,5,5,0,1,0
2,118,118,8,8,0,1,0
40,120,120,13,13,0,1,0
29,129,129,11,11,0,1,0
21,130,130,4,4,0,1,0
41,139,139,23,23,0,1,0
12,144,144,6,6,0,1,0
34,156,156,2,2,0,1,0
5,157,157,5,5,0,1,0
15,160,160,1,1,0,1,0
25,166,166,40,1,39,2,1
23,172,172,1,1,0,1,0
16,172,172,6,6,0,1,0
33,184,184,13,13,0,1,0
18,217,217,11,11,0,1,0
36,233,233,24,20,4,2,1
30,235,235,73,73,0,1,0
43,257,257,5,5,0,1,0
1,257,257,10,2,8,2,1
19,260,260,2,2,0,1,0
20,279,279,21,21,0,1,0
26,305,305,91,91,0,1,0
13,305,305,23,15,8,3,2
38,325,325,2,2,0,1,0
11,326,326,2,2,0,1,0
9,326,326,72,42,30,2,1
22,327,327,18,18,0,1,0
17,331,331,66,15,51,4,3
42,335,335,26,19,7,2,1
32,345,345,40,5,35,2,1
10,350,350,20,20,0,1,0
27,391,391,23,23,0,1,0
14,408,408,6,6,0,1,0
3,416,416,12,4,8,2,1
28,418,418,4,4,0,1,0
4,427,427,12,12,0,1,0
31,431,431,32,18,14,3,2
7,447,447,100,43,57,4,3
39,452,452,81,81,0,1,0
24,462,462,16,16,0,1,0
6,472,472,43,43,0,1,0
8,491,491,48,26,22,2,1
35,496,496,45,2,43,2,1

19,137,137,38,29,9,2,1
29,137,137,13,6,7,2,1
32,139,139,18,7,11,2,1
10,141,141,11,5,6,3,2
22,158,158,9,9,0,1,0
5,169,169,14,5,9,2,1
4,173,173,2,2,0,1,0
30,182,182,30,16,14,3,2
17,183,183,22,6,16,4,3
26,187,187,41,41,0,1,0
7,203,203,24,24,0,1,0
20,208,208,2,2,0,1,0
25,216,216,18,18,0,1,0
3,237,237,24,24,0,1,0
11,243,243,11,8,3,2,1
34,247,247,41,29,12,3,2
21,266,266,59,59,0,1,0
31,278,278,3,3,0,1,0
15,292,292,18,8,10,2,1
27,298,298,17,17,0,1,0
18,316,316,5,5,0,1,0
12,359,359,15,3,12,3,2
23,359,359,3,3,0,1,0
2,360,360,43,43,0,1,0
28,372,372,35,10,25,2,1
14,375,375,23,23,0,1,0
1,383,383,89,13,76,3,2
24,399,399,26,26,0,1,0
6,410,410,53,53,0,1,0
13,428,428,88,88,0,1,0
0,445,445,33,9,24,3,2
33,464,464,21,3,18,2,1
9,467,467,52,48,4,2,1
16,470,470,30,30,0,1,0
8,481,481,127,115,12,3,2

14,128,128,16,16,0,1,0
23,130,130,2,2,0,1,0
27,143,143,2,2,0,1,0
24,145,145,2,2,0,1,0
35,167,167,8,8,0,1,0
6,178,178,26,13,13,2,1
34,193,193,14,14,0,1,0
26,204,204,5,5,0,1,0
7,207,207,19,19,0,1,0
10,210,210,6,6,0,1,0
9,228,228,16,6,10,3,2
3,235,235,14,14,0,1,0
4,251,251,4,4,0,1,0
0,256,256,1,1,0,1,0
21,260,260,49,49,0,1,0
20,264,264,69,33,36,4,3
12,285,285,22,1,21,2,1
19,296,296,21,12,9,4,3
16,306,306,4,4,0,1,0
17,307,307,37,37,0,1,0
29,310,310,4,4,0,1,0
31,330,330,44,17,27,4,3
8,333,333,41,8,33,4,3
33,349,349,42,4,38,2,1
13,355,355,125,54,71,4,3
22,367,367,57,57,0,1,0
2,394,394,71,71,0,1,0
18,397,397,34,14,20,3,2
28,435,435,23,1,22,3,2
25,437,437,207,122,85,3,2
11,449,449,2,2,0,1,0
5,456,456,149,118,31,4,3
30,463,463,34,34,0,1,0
15,480,480,19,1,18,4,3
32,492,492,13,13,0,1,0
1,494,494,12,5,7,2,1

34,107,107,1,1,0,1,0
24,110,110,3,3,0,1,0
10,152,152,35,21,14,3,2
33,171,171,76,42,34,2,1
27,183,183,34,34,0,1,0
31,186,186,7,7,0,1,0
28,205,205,9,5,4,2,1
25,208,208,39,39,0,1,0
4,218,218,6,6,0,1,0
17,245,245,35,14,21,4,3
22,259,259,9,4,5,2,1
30,260,260,30,24,6,3,2
3,264,264,83,83,0,1,0
8,267,267,30,22,8,3,2
23,292,292,23,12,11,3,2
15,301,301,1,1,0,1,0
35,303,303,24,2,22,2,1
21,313,313,29,1,28,2,1
5,313,313,45,11,34,3,2
12,316,316,68,28,40,2,1
26,317,317,29,2,27,4,3
0,338,338,55,11,44,2,1
13,339,339,1,1,0,1,0
2,359,359,52,52,0,1,0
16,385,385,9,9,0,1,0
18,403,403,59,59,0,1,0
9,416,416,20,20,0,1,0
14,432,432,13,13,0,1,0
32,435,435,19,10,9,4,3
19,446,446,33,33,0,1,0
11,449,449,1,1,0,1,0
20,450,450,1,1,0,1,0
7,493,493,2,2,0,1,0
1,494,494,22,14,8,2,1
29,495,495,74,74,0,1,0
6,498,498,74,74,0,1,0

4,104,104,11,1,10,2,1
36,132,132,6,6,0,1,0
9,145,145,24,9,15,2,1
13,147,147,27,6,21,2,1
33,157,157,9,9,0,1,0
19,167,167,7,7,0,1,0
24,179,179,20,20,0,1,0
38,185,185,1,1,0,1,0
31,186,186,22,22,0,1,0
42,187,187,7,7,0,1,0
15,225,225,22,22,0,1,0
2,230,230,14,6,8,3,2
37,235,235,67,43,24,4,3
34,245,245,7,7,0,1,0
28,263,263,19,11,8,2,1
40,267,267,56,56,0,1,0
27,268,268,8,8,0,1,0
39,276,276,72,39,33,4,3
7,281,281,28,15,13,2,1
10,286,286,1,1,0,1,0
22,288,288,16,16,0,1,0
23,300,300,7,7,0,1,0
20,316,316,56,56,0,1,0
11,317,317,8,8,0,1,0
32,355,355,45,3,42,2,1
6,356,356,31,16,15,4,3
3,360,360,1,1,0,1,0
17,362,362,9,9,0,1,0
41,371,371,14,4,10,2,1
12,374,374,15,15,0,1,0
30,387,387,19,14,5,2,1
16,425,425,11,11,0,1,0
1,427,427,52,4,48,4,3
0,430,430,7,3,4,2,1
35,438,438,41,41,0,1,0
18,439,439,7,7,0,1,0
8,476,476,5,1,4,2,1
21,483,483,4,4,0,1,0
5,490,490,102,102,0,1,0
25,491,491,33,33,0,1,0
26,493,493,13,13,0,1,0
14,496,496,43,20,23,2,1
29,500,500,140,140,0,1,0

11,101,101,4,4,0,1,0
7,115,115,2,2,0,1,0
28,119,119,2,2,0,1,0
23,155,155,42,5,37,4,3
24,157,157,7,7,0,1,0
36,170,170,43,43,0,1,0
22,195,195,6,6,0,1,0
9,218,218,15,15,0,1,0
33,220,220,36,24,12,4,3
18,233,233,6,6,0,1,0
13,236,236,12,12,0,1,0
4,241,241,39,39,0,1,0
16,246,246,4,4,0,1,0
27,254,254,33,12,21,2,1
1,263,263,20,20,0,1,0
31,263,263,14,14,0,1,0
14,272,272,3,3,0,1,0
0,276,276,75,75,0,1,0
32,278,278,1,1,0,1,0
5,293,293,22,5,17,2,1
26,293,293,11,1,10,3,2
20,298,298,12,9,3,2,1
34,301,301,47,33,14,3,2
29,302,302,22,3,19,2,1
25,317,317,34,6,28,3,2
35,325,325,65,65,0,1,0
10,331,331,30,30,0,1,0
2,352,352,11,11,0,1,0
15,377,377,95,2,93,4,3
19,432,432,1,1,0,1,0
6,445,445,13,7,6,2,1
8,452,452,6,6,0,1,0
30,452,452,48,32,16,3,2
21,460,460,73,52,21,4,3
12,469,469,63,16,47,2,1
3,496,496,203,203,0,1,0
17,499,499,13,13,0,1,0

7,100,100,7,7,0,1,0
1,105,105,3,3,0,1,0
26,111,111,24,24,0,1,0
31,116,116,14,3,11,2,1
21,124,124,7,7,0,1,0
6,132,132,1,1,0,1,0
16,157,157,15,2,13,2,1
11,170,170,26,26,0,1,0
28,173,173,5,5,0,1,0
8,177,177,12,4,8,3,2
27,234,234,6,6,0,1,0
5,260,260,1,1,0,1,0
4,273,273,119,72,47,4,3
19,273,273,48,48,0,1,0
33,274,274,86,67,19,2,1
29,284,284,1,1,0,1,0
22,285,285,8,8,0,1,0
3,296,296,1,1,0,1,0
14,302,302,5,5,0,1,0
13,311,311,46,46,0,1,0
15,331,331,58,38,20,2,1
20,333,333,72,26,46,4,3
0,339,339,19,19,0,1,0
2,340,340,35,35,0,1,0
17,390,390,15,3,12,2,1
18,393,393,54,20,34,2,1
9,404,404,79,40,39,4,3
23,432,432,17,17,0,1,0
12,449,449,53,40,13,2,1
30,456,456,31,22,9,4,3
32,461,461,58,40,18,4,3
25,472,472,66,66,0,1,0
10,488,488,107,77,30,4,3
24,495,495,2,2,0,1,0

25,105,105,8,5,3,2,1
26,115,115,5,1,4,2,1
18,140,140,19,4,15,4,3
14,140,140,24,24,0,1,0
28,158,158,1,1,0,1,0
12,160,160,49,11,38,3,2
16,162,162,19,3,16,2,1
30,189,189,6,6,0,1,0
4,191,191,6,3,3,2,1
21,193,193,18,10,8,2,1
19,193,193,61,39,22,3,2
8,205,205,24,1,23,4,3
23,211,211,75,25,50,4,3
0,230,230,71,71,0,1,0
17,235,235,57,57,0,1,0
24,236,236,19,6,13,2,1
11,243,243,35,35,0,1,0
31,280,280,13,1,12,4,3
3,294,294,34,34,0,1,0
6,300,300,5,5,0,1,0
10,304,304,10,1,9,4,3
20,305,305,56,56,0,1,0
2,311,311,4,4,0,1,0
1,327,327,48,28,20,3,2
5,345,345,16,9,7,2,1
32,351,351,29,12,17,2,1
22,360,360,1,1,0,1,0
33,361,361,2,2,0,1,0
27,365,365,10,2,8,3,2
7,437,437,74,74,0,1,0
9,478,478,26,11,15,4,3
15,479,479,24,19,5,2,1
29,480,480,5,5,0,1,0
13,487,487,38,16,22,2,1

0,122,122,34,34,0,1,0
16,122,122,60,60,0,1,0
25,133,133,12,2,10,2,1
23,135,135,1,1,0,1,0
18,149,149,14,14,0,1,0
30,159,159,2,2,0,1,0
32,169,169,19,19,0,1,0
17,173,173,11,4,7,2,1
1,176,176,8,8,0,1,0
13,193,193,12,12,0,1,0
28,194,194,2,2,0,1,0
15,207,207,27,24,3,2,1
4,211,211,2,2,0,1,0
8,216,216,2,2,0,1,0
9,218,218,5,5,0,1,0
34,226,226,36,36,0,1,0
12,275,275,10,10,0,1,0
11,279,279,19,19,0,1,0
6,300,300,13,4,9,4,3
33,301,301,13,6,7,2,1
7,301,301,49,26,23,2,1
35,319,319,27,3,24,2,1
5,328,328,11,3,8,3,2
2,343,343,1,1,0,1,0
29,350,350,26,26,0,1,0
31,359,359,95,69,26,2,1
19,363,363,17,7,10,2,1
20,384,384,76,40,36,4,3
21,398,398,53,35,18,3,2
10,399,399,35,35,0,1,0
26,446,446,80,2,78,4,3
24,448,448,31,10,21,4,3
3,463,463,115,115,0,1,0
22,467,467,66,35,31,2,1
27,492,492,54,25,29,4,3
14,495,495,3,3,0,1,0

8,106,106,1,1,0,1,0
0,133,133,4,4,0,1,0
3,134,134,113,113,0,1,0
27,137,137,11,1,10,2,1
2,141,141,7,7,0,1,0
12,142,142,8,8,0,1,0
5,154,154,4,4,0,1,0
18,158,158,8,1,7,2,1
13,159,159,1,1,0,1,0
7,166,166,13,13,0,1,0
19,170,170,3,3,0,1,0
14,176,176,24,19,5,2,1
6,178,178,2,2,0,1,0
16,191,191,24,24,0,1,0
24,194,194,35,12,23,2,1
23,224,224,62,56,6,3,2
22,249,249,11,11,0,1,0
26,275,275,3,3,0,1,0
25,312,312,1,1,0,1,0
17,318,318,5,2,3,2,1
15,394,394,57,18,39,2,1
10,398,398,111,3,108,4,3
20,418,418,34,17,17,2,1
11,423,423,44,8,36,4,3
4,448,448,254,208,46,2,1
21,448,448,99,41,58,4,3
1,467,467,68,30,38,3,2
9,489,489,20,20,0,1,0

26,113,113,11,11,0,1,0
19,122,122,1,1,0,1,0
11,127,127,63,36,27,2,1
23,134,134,5,5,0,1,0
28,149,149,19,19,0,1,0
25,152,152,6,6,0,1,0
12,161,161,1,1,0,1,0
30,192,192,10,10,0,1,0
14,194,194,7,7,0,1,0
20,224,224,39,2,37,2,1
5,241,241,2,2,0,1,0
9,286,286,7,7,0,1,0
15,299,299,22,19,3,2,1
31,308,308,14,6,8,3,2
7,336,336,25,25,0,1,0
10,347,347,60,45,15,2,1
8,367,367,1,1,0,1,0
2,374,374,9,1,8,2,1
1,380,380,105,84,21,4,3
6,388,388,140,107,33,2,1
13,388,388,42,42,0,1,0
17,393,393,192,139,53,4,3
21,406,406,31,22,9,4,3
16,412,412,90,83,7,2,1
4,446,446,59,13,46,3,2
3,447,447,5,5,0,1,0
29,458,458,28,7,21,2,1
24,465,465,45,7,38,3,2
27,472,472,24,24,0,1,0
0,483,483,50,32,18,3,2
18,492,492,25,25,0,1,0
22,494,494,54,28,26,2,1

30,103,103,11,2,9,4,3
7,113,113,1,1,0,1,0
21,124,124,9,9,0,1,0
32,156,156,16,4,12,3,2
15,158,158,42,24,18,2,1
1,164,164,5,5,0,1,0
37,175,175,7,3,4,2,1
23,176,176,8,1,7,2,1
40,176,176,4,4,0,1,0
14,178,178,8,2,6,2,1
42,181,181,22,22,0,1,0
22,184,184,10,3,7,2,1
39,198,198,8,8,0,1,0
5,206,206,44,44,0,1,0
38,244,244,4,1,3,2,1
17,262,262,2,2,0,1,0
29,268,268,116,94,22,3,2
45,278,278,55,24,31,2,1
11,279,279,4,4,0,1,0
4,282,282,18,1,17,2,1
19,296,296,49,13,36,4,3
8,302,302,10,10,0,1,0
13,305,305,6,6,0,1,0
25,338,338,1,1,0,1,0
33,349,349,87,39,48,2,1
31,350,350,88,49,39,4,3
3,353,353,10,10,0,1,0
6,358,358,8,8,0,1,0
35,363,363,3,3,0,1,0
24,367,367,3,3,0,1,0
26,375,375,6,3,3,2,1
41,378,378,14,10,4,2,1
2,382,382,9,9,0,1,0
10,384,384,6,6,0,1,0
34,390,390,1,1,0,1,0
36,405,405,8,8,0,1,0
28,413,413,23,1,22,2,1
43,418,418,11,7,4,2,1
27,421,421,24,19,5,2,1
16,434,434,20,2,18,4,3
44,436,436,25,25,0,1,0
20,438,438,64,64,0,1,0
12,440,440,32,32,0,1,0
9,470,470,27,27,0,1,0
46,473,473,52,52,0,1,0
0,479,479,84,76,8,3,2
18,489,489,16,7,9,4,3

14,125,125,9,9,0,1,0
5,125,125,5,5,0,1,0
21,129,129,6,6,0,1,0
17,135,135,10,7,3,2,1
26,165,165,14,14,0,1,0
0,216,216,12,12,0,1,0
2,216,216,15,9,6,2,1
19,223,223,9,5,4,2,1
20,232,232,61,61,0,1,0
3,238,238,15,1,14,3,2
6,244,244,83,54,29,2,1
15,254,254,4,4,0,1,0
11,254,254,46,12,34,2,1
13,255,255,60,60,0,1,0
16,261,261,36,28,8,3,2
28,284,284,3,3,0,1,0
1,288,288,51,51,0,1,0
4,311,311,59,59,0,1,0
12,312,312,100,40,60,4,3
27,313,313,23,23,0,1,0
24,325,325,45,45,0,1,0
29,327,327,50,50,0,1,0
18,330,330,30,30,0,1,0
8,343,343,8,8,0,1,0
10,382,382,39,12,27,2,1
30,409,409,49,49,0,1,0
9,433,433,46,46,0,1,0
25,456,456,38,8,30,3,2
7,469,469,62,36,26,4,3
22,469,469,30,30,0,1,0
23,472,472,66,48,18,4,3

13,104,104,5,2,3,2,1
5,120,120,12,4,8,3,2
7,127,127,4,4,0,1,0
19,138,138,1,1,0,1,0
15,138,138,1,1,0,1,0
3,140,140,11,11,0,1,0
24,140,140,21,3,18,3,2
16,152,152,2,2,0,1,0
33,167,167,37,16,21,2,1
20,172,172,4,4,0,1,0
29,175,175,14,14,0,1,0
28,192,192,8,8,0,1,0
9,196,196,22,22,0,1,0
37,197,197,42,42,0,1,0
34,224,224,8,8,0,1,0
8,240,240,21,21,0,1,0
35,253,253,27,1,26,2,1
36,255,255,72,72,0,1,0
21,259,259,14,2,12,3,2
18,288,288,13,5,8,3,2
12,289,289,127,127,0,1,0
1,325,325,36,36,0,1,0
2,329,329,9,9,0,1,0
25,330,330,8,8,0,1,0
27,331,331,28,28,0,1,0
10,332,332,40,2,38,2,1
4,334,334,15,15,0,1,0
14,342,342,23,9,14,2,1
0,358,358,80,49,31,2,1
11,374,374,65,28,37,4,3
6,382,382,22,18,4,2,1
30,411,411,27,27,0,1,0
23,412,412,25,20,5,2,1
22,421,421,13,1,12,2,1
17,428,428,2,2,0,1,0
26,464,464,38,38,0,1,0
32,464,464,5,5,0,1,0
31,467,467,124,58,66,4,3

35,102,102,3,3,0,1,0
29,114,114,15,15,0,1,0
9,116,116,3,3,0,1,0
31,118,118,3,3,0,1,0
37,131,131,23,23,0,1,0
17,140,140,7,7,0,1,0
25,168,168,9,9,0,1,0
30,188,188,41,41,0,1,0
1,192,192,18,1,17,2,1
19,195,195,15,7,8,3,2
22,199,199,21,21,0,1,0
20,208,208,5,5,0,1,0
27,221,221,30,30,0,1,0
8,230,230,47,8,39,4,3
12,244,244,23,5,18,4,3
5,245,245,20,20,0,1,0
6,257,257,23,5,18,3,2
3,258,258,17,11,6,3,2
34,296,296,46,46,0,1,0
15,331,331,44,8,36,4,3
33,348,348,27,7,20,3,2
28,371,371,70,70,0,1,0
16,378,378,1,1,0,1,0
4,380,380,22,4,18,4,3
23,384,384,40,40,0,1,0
7,391,391,2,2,0,1,0
10,391,391,41,1,40,2,1
14,410,410,6,6,0,1,0
26,442,442,2,2,0,1,0
11,445,445,47,36,11,4,3
32,446,446,72,72,0,1,0
21,461,461,60,23,37,2,1
0,466,466,36,2,34,3,2
2,467,467,116,85,31,2,1
18,485,485,125,125,0,1,0
24,487,487,31,19,12,4,3
13,489,489,6,6,0,1,0
36,492,492,25,25,0,1,0

5,120,120,5,5,0,1,0
31,121,121,7,7,0,1,0
22,127,127,5,1,4,2,1
10,127,127,1,1,0,1,0
4,160,160,2,2,0,1,0
3,180,180,1,1,0,1,0
13,185,185,48,26,22,4,3
2,188,188,27,27,0,1,0
34,194,194,15,11,4,2,1
16,199,199,9,1,8,2,1
7,209,209,43,28,15,4,3
8,215,215,1,1,0,1,0
18,227,227,27,27,0,1,0
11,236,236,9,4,5,2,1
39,237,237,14,2,12,3,2
15,238,238,24,8,16,2,1
17,268,268,6,6,0,1,0
36,269,269,66,66,0,1,0
35,270,270,16,2,14,2,1
23,273,273,28,17,11,2,1
42,277,277,23,4,19,2,1
44,278,278,16,4,12,3,2
25,282,282,72,72,0,1,0
26,287,287,17,17,0,1,0
20,291,291,3,3,0,1,0
41,302,302,42,26,16,3,2
24,319,319,15,15,0,1,0
38,333,333,83,25,58,3,2
43,342,342,76,53,23,2,1
19,344,344,16,10,6,2,1
1,349,349,7,1,6,2,1
37,357,357,67,67,0,1,0
28,365,365,38,38,0,1,0
32,374,374,2,2,0,1,0
0,381,381,1,1,0,1,0
30,397,397,25,3,22,2,1
9,398,398,2,2,0,1,0
14,402,402,43,43,0,1,0
33,405,405,3,3,0,1,0
12,420,420,30,16,14,3,2
21,421,421,4,4,0,1,0
40,457,457,37,37,0,1,0
6,477,477,9,1,8,3,2
29,480,480,7,7,0,1,0
27,497,497,53,3,50,3,2

30,119,119,21,15,6,2,1
15,141,141,1,1,0,1,0
37,162,162,15,15,0,1,0
8,173,173,2,2,0,1,0
26,176,176,1,1,0,1,0
16,197,197,6,6,0,1,0
7,208,208,21,12,9,2,1
27,218,218,24,14,10,2,1
2,245,245,104,89,15,4,3
9,247,247,2,2,0,1,0
33,257,257,35,15,20,3,2
12,259,259,17,17,0,1,0
24,263,263,6,6,0,1,0
3,271,271,30,30,0,1,0
5,278,278,5,2,3,2,1
35,280,280,72,48,24,4,3
14,283,283,13,13,0,1,0
42,289,289,18,9,9,4,3
21,290,290,1,1,0,1,0
20,291,291,1,1,0,1,0
17,295,295,21,21,0,1,0
32,297,297,11,1,10,3,2
23,316,316,80,52,28,2,1
29,325,325,20,20,0,1,0
39,332,332,22,3,19,2,1
19,334,334,18,7,11,2,1
18,339,339,18,18,0,1,0
36,355,355,12,12,0,1,0
22,364,364,10,10,0,1,0
11,365,365,6,2,4,2,1
4,370,370,60,60,0,1,0
6,378,378,2,2,0,1,0
31,394,394,53,53,0,1,0
25,396,396,16,4,12,2,1
0,398,398,1,1,0,1,0
38,419,419,1,1,0,1,0
28,423,423,5,5,0,1,0
13,430,430,1,1,0,1,0
1,446,446,4,4,0,1,0
34,461,461,129,72,57,4,3
41,487,487,23,23,0,1,0
40,491,491,134,38,96,4,3
10,494,494,144,63,81,4,3

26,102,102,9,9,0,1,0
32,107,107,5,5,0,1,0
7,122,122,2,2,0,1,0
17,122,122,21,21,0,1,0
12,146,146,4,4,0,1,0
5,150,150,42,20,22,2,1
29,150,150,11,11,0,1,0
15,172,172,3,3,0,1,0
10,177,177,54,10,44,3,2
13,184,184,19,19,0,1,0
20,196,196,2,2,0,1,0
27,200,200,29,29,0,1,0
28,233,233,24,20,4,2,1
25,289,289,24,24,0,1,0
21,293,293,27,27,0,1,0
19,310,310,69,69,0,1,0
14,313,313,22,22,0,1,0
9,322,322,10,10,0,1,0
1,348,348,48,48,0,1,0
2,358,358,3,3,0,1,0
18,385,385,61,51,10,2,1
0,388,388,9,9,0,1,0
3,420,420,17,17,0,1,0
24,421,421,28,28,0,1,0
23,423,423,42,42,0,1,0
22,431,431,35,35,0,1,0
31,432,432,111,111,0,1,0
30,442,442,14,4,10,2,1
16,461,461,46,33,13,4,3
6,462,462,59,59,0,1,0
8,463,463,105,60,45,4,3
11,471,471,37,3,34,4,3
4,496,496,162,162,0,1,0

26,113,113,23,23,0,1,0
35,123,123,8,1,7,2,1
14,125,125,5,5,0,1,0
21,126,126,2,2,0,1,0
36,136,136,23,23,0,1,0
28,140,140,6,6,0,1,0
31,152,152,33,21,12,3,2
17,164,164,3,3,0,1,0
27,169,169,52,52,0,1,0
32,173,173,11,11,0,1,0
6,186,186,7,7,0,1,0
25,191,191,5,5,0,1,0
12,212,212,11,11,0,1,0
10,231,231,93,93,0,1,0
8,237,237,8,2,6,3,2
4,238,238,23,23,0,1,0
29,247,247,7,7,0,1,0
23,251,251,2,2,0,1,0
13,256,256,24,17,7,2,1
1,257,257,36,36,0,1,0
18,270,270,10,10,0,1,0
19,277,277,18,13,5,2,1
24,341,341,64,27,37,2,1
3,348,348,20,20,0,1,0
7,349,349,118,53,65,4,3
11,359,359,10,10,0,1,0
34,364,364,37,13,24,4,3
0,376,376,38,38,0,1,0
33,386,386,19,19,0,1,0
2,407,407,52,18,34,3,2
5,409,409,14,14,0,1,0
20,410,410,95,84,11,2,1
30,433,433,13,8,5,2,1
16,453,453,31,31,0,1,0
22,465,465,14,14,0,1,0
15,473,473,18,18,0,1,0
9,476,476,28,28,0,1,0

29,107,107,29,1,28,4,3
19,112,112,22,22,0,1,0
20,123,123,22,22,0,1,0
33,135,135,9,4,5,2,1
25,138,138,36,30,6,3,2
18,142,142,26,26,0,1,0
16,153,153,2,2,0,1,0
7,156,156,50,50,0,1,0
32,160,160,5,5,0,1,0
24,175,175,17,5,12,3,2
13,205,205,8,8,0,1,0
28,208,208,13,13,0,1,0
11,259,259,6,1,5,2,1
4,261,261,3,3,0,1,0
12,280,280,4,1,3,2,1
30,291,291,3,3,0,1,0
22,333,333,30,18,12,4,3
5,345,345,50,50,0,1,0
23,350,350,24,8,16,2,1
21,361,361,48,48,0,1,0
10,379,379,61,61,0,1,0
6,389,389,37,37,0,1,0
26,390,390,30,30,0,1,0
14,396,396,125,77,48,4,3
0,405,405,9,9,0,1,0
27,413,413,1,1,0,1,0
9,417,417,68,59,9,2,1
2,446,446,49,27,22,4,3
3,451,451,41,15,26,2,1
8,472,472,2,2,0,1,0
17,477,477,6,3,3,2,1
31,477,477,42,4,38,2,1
1,481,481,12,4,8,3,2
15,496,496,129,129,0,1,0

14,103,103,5,5,0,1,0
21,114,114,4,4,0,1,0
28,151,151,2,2,0,1,0
26,152,152,14,11,3,2,1
3,155,155,7,7,0,1,0
7,170,170,17,17,0,1,0
9,183,183,9,9,0,1,0
34,186,186,5,5,0,1,0
30,195,195,50,10,40,4,3
29,223,223,7,1,6,3,2
19,230,230,5,5,0,1,0
37,235,235,73,61,12,4,3
22,242,242,19,19,0,1,0
2,244,244,1,1,0,1,0
1,246,246,41,23,18,4,3
18,252,252,11,11,0,1,0
36,269,269,36,36,0,1,0
12,284,284,11,11,0,1,0
20,284,284,9,2,7,2,1
13,297,297,32,12,20,4,3
11,297,297,37,28,9,2,1
38,299,299,5,5,0,1,0
25,307,307,23,23,0,1,0
31,315,315,19,19,0,1,0
35,319,319,19,6,13,2,1
32,322,322,44,40,4,2,1
0,324,324,27,27,0,1,0
33,325,325,46,46,0,1,0
16,332,332,1,1,0,1,0
5,350,350,57,33,24,3,2
6,366,366,94,70,24,3,2
15,406,406,21,3,18,3,2
27,425,425,59,46,13,2,1
17,430,430,17,17,0,1,0
10,438,438,141,141,0,1,0
24,447,447,100,20,80,3,2
4,470,470,42,6,36,2,1
23,484,484,7,4,3,2,1
8,495,495,5,5,0,1,0

12,117,117,8,2,6,3,2
27,129,129,17,17,0,1,0
10,130,130,36,36,0,1,0
33,132,132,3,3,0,1,0
35,138,138,20,20,0,1,0
3,142,142,18,10,8,2,1
0,156,156,5,5,0,1,0
15,163,163,3,3,0,1,0
24,163,163,3,3,0,1,0
19,172,172,2,2,0,1,0
34,198,198,41,41,0,1,0
17,216,216,40,4,36,4,3
16,217,217,1,1,0,1,0
18,217,217,56,12,44,3,2
31,225,225,17,17,0,1,0
22,234,234,54,54,0,1,0
6,249,249,7,7,0,1,0
30,251,251,2,2,0,1,0
21,259,259,4,4,0,1,0
2,262,262,20,20,0,1,0
29,271,271,73,73,0,1,0
20,275,275,25,25,0,1,0
5,284,284,77,27,50,3,2
4,288,288,33,14,19,2,1
23,292,292,56,26,30,3,2
26,302,302,5,5,0,1,0
13,306,306,39,21,18,3,2
7,341,341,32,32,0,1,0
11,421,421,90,32,58,3,2
1,432,432,22,22,0,1,0
28,467,467,46,46,0,1,0
32,472,472,16,1,15,4,3
8,481,481,13,1,12,4,3
14,484,484,15,15,0,1,0
25,488,488,7,7,0,1,0
9,497,497,28,28,0,1,0

20,111,111,1,1,0,1,0
34,111,111,5,5,0,1,0
33,130,130,17,17,0,1,0
10,153,153,17,17,0,1,0
28,161,161,52,52,0,1,0
17,174,174,9,9,0,1,0
22,178,178,4,1,3,2,1
23,184,184,103,56,47,2,1
8,192,192,56,56,0,1,0
3,226,226,33,5,28,2,1
13,230,230,1,1,0,1,0
16,258,258,14,14,0,1,0
30,267,267,32,14,18,4,3
29,267,267,23,23,0,1,0
14,286,286,53,4,49,2,1
7,293,293,24,17,7,2,1
21,294,294,4,4,0,1,0
26,295,295,1,1,0,1,0
11,298,298,4,4,0,1,0
27,312,312,7,7,0,1,0
36,340,340,5,5,0,1,0
0,344,344,2,2,0,1,0
5,353,353,46,6,40,3,2
4,375,375,2,2,0,1,0
19,379,379,58,58,0,1,0
6,381,381,16,16,0,1,0
25,391,391,16,3,13,2,1
9,397,397,25,25,0,1,0
18,411,411,13,13,0,1,0
1,417,417,50,27,23,2,1
32,441,441,38,38,0,1,0
24,442,442,30,13,17,2,1
15,444,444,121,11,110,4,3
31,455,455,34,34,0,1,0
12,463,463,54,42,12,3,2
2,476,476,35,18,17,2,1
35,495,495,37,37,0,1,0

24,101,101,2,2,0,1,0
23,101,101,7,2,5,2,1
33,102,102,4,4,0,1,0
50,110,110,23,23,0,1,0
41,128,128,22,10,12,4,3
6,135,135,2,2,0,1,0
17,143,143,4,4,0,1,0
38,150,150,21,21,0,1,0
46,155,155,22,1,21,2,1
22,159,159,2,2,0,1,0
20,161,161,67,53,14,3,2
49,169,169,6,2,4,2,1
31,171,171,10,10,0,1,0
7,180,180,1,1,0,1,0
8,182,182,3,3,0,1,0
19,183,183,8,8,0,1,0
27,213,213,17,7,10,3,2
11,221,221,33,33,0,1,0
18,256,256,18,18,0,1,0
47,274,274,5,5,0,1,0
35,278,278,2,2,0,1,0
2,288,288,19,19,0,1,0
42,294,294,1,1,0,1,0
16,325,325,9,5,4,2,1
29,326,326,1,1,0,1,0
34,329,329,128,51,77,3,2
28,331,331,1,1,0,1,0
9,334,334,23,23,0,1,0
37,351,351,21,21,0,1,0
36,355,355,47,47,0,1,0
12,377,377,3,3,0,1,0
32,377,377,9,9,0,1,0
0,380,380,2,2,0,1,0
43,393,393,77,11,66,4,3
13,397,397,43,43,0,1,0
40,401,401,27,4,23,2,1
5,407,407,31,31,0,1,0
4,419,419,38,9,29,2,1
14,420,420,33,33,0,1,0
25,425,425,13,13,0,1,0
26,432,432,8,8,0,1,0
30,437,437,39,13,26,3,2
48,441,441,2,2,0,1,0
45,451,451,78,4,74,3,2
44,459,459,11,11,0,1,0
10,472,472,13,1,12,3,2
1,472,472,19,19,0,1,0
39,479,479,16,1,15,4,3
21,484,484,1,1,0,1,0
3,484,484,3,3,0,1,0
15,499,499,21,9,12,2,1

22,102,102,3,3,0,1,0
10,106,106,39,39,0,1,0
14,113,113,1,1,0,1,0
4,115,115,16,6,10,2,1
7,129,129,2,2,0,1,0
3,147,147,6,6,0,1,0
15,148,148,7,7,0,1,0
0,153,153,38,38,0,1,0
18,177,177,43,6,37,2,1
24,251,251,11,11,0,1,0
25,259,259,19,4,15,4,3
17,259,259,49,49,0,1,0
11,270,270,11,11,0,1,0
12,298,298,7,7,0,1,0
5,316,316,21,8,13,2,1
8,326,326,58,33,25,2,1
27,364,364,15,15,0,1,0
13,370,370,43,9,34,4,3
6,376,376,114,114,0,1,0
20,379,379,21,21,0,1,0
16,379,379,45,45,0,1,0
26,397,397,38,20,18,3,2
9,405,405,36,36,0,1,0
1,413,413,148,148,0,1,0
23,423,423,42,16,26,3,2
2,435,435,158,119,39,2,1
19,438,438,12,12,0,1,0
21,440,440,97,28,69,4,3

21,103,103,1,1,0,1,0
28,104,104,4,4,0,1,0
6,106,106,3,3,0,1,0
26,135,135,24,24,0,1,0
34,163,163,1,1,0,1,0
30,201,201,61,47,14,3,2
20,213,213,17,17,0,1,0
36,216,216,64,64,0,1,0
25,224,224,59,59,0,1,0
15,239,239,8,5,3,2,1
8,255,255,30,30,0,1,0
19,266,266,101,101,0,1,0
24,293,293,4,1,3,2,1
5,300,300,12,12,0,1,0
4,303,303,112,67,45,4,3
12,304,304,19,19,0,1,0
10,305,305,10,10,0,1,0
37,312,312,12,3,9,2,1
2,318,318,4,4,0,1,0
0,319,319,28,9,19,4,3
22,341,341,4,4,0,1,0
13,388,388,11,7,4,2,1
9,389,389,18,3,15,4,3
32,394,394,40,26,14,2,1
11,401,401,12,2,10,2,1
16,412,412,13,8,5,2,1
18,427,427,52,9,43,2,1
31,436,436,16,16,0,1,0
29,442,442,51,45,6,3,2
14,447,447,31,31,0,1,0
27,448,448,29,29,0,1,0
23,454,454,78,30,48,4,3
17,454,454,87,5,82,3,2
35,454,454,44,44,0,1,0
3,459,459,13,3,10,3,2
7,466,466,37,13,24,3,2
33,474,474,7,7,0,1,0
1,476,476,5,5,0,1,0

18,115,115,8,3,5,2,1
1,123,123,15,15,0,1,0
24,131,131,26,26,0,1,0
2,134,134,33,33,0,1,0
0,139,139,8,8,0,1,0
11,177,177,7,1,6,3,2
37,180,180,15,8,7,2,1
13,198,198,85,55,30,2,1
3,201,201,13,4,9,2,1
20,208,208,16,1,15,2,1
5,231,231,10,10,0,1,0
31,237,237,19,5,14,3,2
39,254,254,15,15,0,1,0
6,258,258,42,30,12,3,2
17,273,273,22,22,0,1,0
33,278,278,42,23,19,2,1
21,279,279,29,19,10,3,2
9,280,280,1,1,0,1,0
19,286,286,7,3,4,2,1
27,292,292,48,48,0,1,0
7,294,294,15,15,0,1,0
15,308,308,8,8,0,1,0
26,326,326,124,38,86,3,2
36,328,328,3,3,0,1,0
16,330,330,2,2,0,1,0
4,341,341,21,21,0,1,0
22,368,368,11,8,3,2,1
32,374,374,21,14,7,2,1
38,389,389,39,39,0,1,0
23,392,392,42,12,30,4,3
28,397,397,26,12,14,2,1
35,414,414,26,8,18,2,1
8,421,421,12,12,0,1,0
29,426,426,82,82,0,1,0
34,438,438,31,31,0,1,0
12,456,456,9,9,0,1,0
30,456,456,2,2,0,1,0
25,459,459,12,12,0,1,0
40,477,477,8,8,0,1,0
14,480,480,17,17,0,1,0
10,482,482,9,3,6,3,2

6,133,133,1,1,0,1,0
30,133,133,3,3,0,1,0
24,136,136,9,9,0,1,0
34,154,154,3,3,0,1,0
14,162,162,2,2,0,1,0
35,163,163,19,11,8,2,1
33,166,166,10,2,8,2,1
25,178,178,2,2,0,1,0
23,180,180,8,8,0,1,0
1,189,189,3,3,0,1,0
7,211,211,17,2,15,3,2
2,230,230,15,7,8,2,1
11,235,235,2,2,0,1,0
37,236,236,57,57,0,1,0
19,240,240,6,3,3,2,1
31,248,248,32,15,17,2,1
9,248,248,22,16,6,3,2
29,249,249,2,2,0,1,0
13,254,254,8,1,7,2,1
0,258,258,14,8,6,3,2
27,265,265,24,14,10,2,1
26,279,279,71,62,9,2,1
28,286,286,14,14,0,1,0
22,327,327,44,20,24,4,3
42,327,327,24,8,16,3,2
17,329,329,27,27,0,1,0
4,338,338,4,4,0,1,0
10,346,346,39,39,0,1,0
18,354,354,8,5,3,2,1
3,357,357,55,23,32,2,1
16,381,381,1,1,0,1,0
41,394,394,46,19,27,4,3
40,396,396,85,85,0,1,0
8,400,400,2,2,0,1,0
39,406,406,7,7,0,1,0
15,422,422,35,35,0,1,0
38,432,432,98,4,94,3,2
43,446,446,45,33,12,3,2
32,456,456,190,106,84,4,3
12,461,461,30,23,7,2,1
36,469,469,16,16,0,1,0
21,476,476,26,22,4,2,1
5,479,479,63,16,47,4,3
45,487,487,7,7,0,1,0
20,496,496,19,4,15,4,3
44,499,499,3,3,0,1,0
46,500,500,3,3,0,1,0

5,103,103,9,3,6,3,2
0,107,107,10,1,9,2,1
36,125,125,6,2,4,2,1
21,127,127,3,3,0,1,0
30,130,130,7,7,0,1,0
11,156,156,7,7,0,1,0
32,162,162,10,10,0,1,0
24,171,171,6,6,0,1,0
9,171,171,6,6,0,1,0
8,174,174,19,15,4,2,1
16,184,184,4,4,0,1,0
4,194,194,4,4,0,1,0
26,217,217,5,5,0,1,0
34,229,229,61,37,24,3,2
10,232,232,2,2,0,1,0
1,235,235,42,24,18,3,2
14,236,236,5,5,0,1,0
2,239,239,29,29,0,1,0
33,239,239,52,52,0,1,0
29,243,243,7,7,0,1,0
18,299,299,18,5,13,2,1
13,306,306,1,1,0,1,0
12,310,310,66,51,15,2,1
35,311,311,46,46,0,1,0
23,313,313,35,35,0,1,0
27,319,319,128,80,48,4,3
28,320,320,1,1,0,1,0
3,341,341,145,133,12,4,3
17,358,358,20,3,17,2,1
25,391,391,20,20,0,1,0
37,396,396,5,5,0,1,0
31,416,416,33,33,0,1,0
6,422,422,8,8,0,1,0
19,437,437,2,2,0,1,0
20,455,455,88,88,0,1,0
7,461,461,34,20,14,2,1
22,464,464,42,42,0,1,0
15,465,465,95,5,90,4,3

3,113,113,20,5,15,2,1
23,123,123,2,2,0,1,0
25,124,124,12,12,0,1,0
11,127,127,15,15,0,1,0
39,133,133,27,7,20,2,1
24,137,137,33,17,16,3,2
38,167,167,12,12,0,1,0
4,173,173,51,4,47,2,1
35,193,193,26,12,14,2,1
34,196,196,2,2,0,1,0
31,204,204,15,15,0,1,0
22,209,209,12,12,0,1,0
6,222,222,3,3,0,1,0
12,224,224,2,2,0,1,0
14,254,254,24,24,0,1,0
2,258,258,2,2,0,1,0
21,272,272,7,7,0,1,0
29,275,275,10,10,0,1,0
33,317,317,15,15,0,1,0
37,320,320,2,2,0,1,0
27,322,322,100,1,99,4,3
36,323,323,56,35,21,2,1
32,326,326,30,30,0,1,0
13,331,331,73,73,0,1,0
10,333,333,1,1,0,1,0
16,333,333,5,5,0,1,0
18,337,337,61,5,56,4,3
17,342,342,53,53,0,1,0
26,382,382,45,45,0,1,0
28,394,394,57,15,42,4,3
5,406,406,14,3,11,2,1
19,408,408,37,37,0,1,0
1,414,414,23,13,10,2,1
0,426,426,15,15,0,1,0
9,438,438,20,14,6,3,2
8,444,444,21,21,0,1,0
20,475,475,67,19,48,2,1
15,479,479,2,2,0,1,0
30,484,484,7,7,0,1,0
7,496,496,17,5,12,2,1

8,101,101,5,5,0,1,0
2,105,105,3,3,0,1,0
34,106,106,2,2,0,1,0
40,113,113,2,2,0,1,0
29,114,114,13,3,10,3,2
13,123,123,1,1,0,1,0
43,147,147,19,3,16,2,1
38,159,159,1,1,0,1,0
18,165,165,25,16,9,4,3
28,169,169,35,35,0,1,0
37,174,174,22,22,0,1,0
17,196,196,17,17,0,1,0
21,203,203,5,2,3,2,1
7,209,209,12,12,0,1,0
3,223,223,6,6,0,1,0
4,231,231,5,5,0,1,0
27,234,234,16,16,0,1,0
26,244,244,16,16,0,1,0
11,244,244,11,1,10,3,2
20,257,257,25,16,9,2,1
24,257,257,12,12,0,1,0
33,261,261,32,32,0,1,0
32,267,267,50,50,0,1,0
1,317,317,3,3,0,1,0
23,332,332,20,20,0,1,0
31,335,335,17,1,16,4,3
16,348,348,23,23,0,1,0
12,360,360,11,11,0,1,0
15,367,367,125,125,0,1,0
42,379,379,11,11,0,1,0
19,380,380,8,2,6,3,2
30,417,417,14,14,0,1,0
5,419,419,47,20,27,3,2
14,423,423,35,35,0,1,0
44,436,436,13,13,0,1,0
9,436,436,30,30,0,1,0
41,439,439,36,29,7,2,1
39,447,447,19,2,17,2,1
35,454,454,201,188,13,4,3
25,454,454,45,23,22,4,3
6,461,461,2,2,0,1,0
22,467,467,55,55,0,1,0
0,470,470,34,19,15,4,3
36,473,473,59,23,36,4,3
10,474,474,4,4,0,1,0

0,103,103,4,4,0,1,0
15,131,131,3,3,0,1,0
25,136,136,2,2,0,1,0
40,171,171,6,6,0,1,0
7,180,180,75,75,0,1,0
16,185,185,3,3,0,1,0
14,187,187,11,11,0,1,0
3,194,194,5,5,0,1,0
11,195,195,22,5,17,3,2
20,199,199,1,1,0,1,0
30,202,202,20,4,16,2,1
1,208,208,27,3,24,3,2
22,223,223,4,4,0,1,0
18,240,240,40,22,18,4,3
37,240,240,1,1,0,1,0
12,248,248,23,23,0,1,0
26,273,273,5,5,0,1,0
8,279,279,23,5,18,4,3
9,281,281,32,32,0,1,0
10,286,286,48,48,0,1,0
5,290,290,36,31,5,2,1
35,290,290,20,20,0,1,0
29,291,291,73,33,40,4,3
6,313,313,6,1,5,2,1
23,314,314,6,6,0,1,0
31,328,328,11,11,0,1,0
13,343,343,14,14,0,1,0
4,348,348,20,5,15,4,3
17,353,353,7,1,6,3,2
2,360,360,6,2,4,2,1
27,362,362,32,17,15,4,3
32,368,368,17,17,0,1,0
34,387,387,3,3,0,1,0
21,393,393,4,4,0,1,0
39,398,398,14,1,13,2,1
19,403,403,11,11,0,1,0
24,418,418,103,20,83,4,3
28,445,445,45,45,0,1,0
33,447,447,12,12,0,1,0
36,461,461,2,2,0,1,0
41,487,487,254,244,10,3,2
38,489,489,114,114,0,1,0

33,104,104,8,8,0,1,0
8,109,109,11,4,7,2,1
7,109,109,2,2,0,1,0
19,114,114,4,4,0,1,0
27,116,116,22,4,18,4,3
35,148,148,9,6,3,2,1
31,171,171,3,3,0,1,0
26,173,173,30,25,5,2,1
2,173,173,1,1,0,1,0
13,188,188,32,3,29,2,1
4,191,191,6,6,0,1,0
14,202,202,10,2,8,3,2
34,216,216,26,26,0,1,0
23,277,277,15,15,0,1,0
0,280,280,61,61,0,1,0
22,294,294,44,29,15,4,3
30,307,307,2,2,0,1,0
16,309,309,10,5,5,2,1
25,323,323,4,1,3,2,1
5,325,325,17,17,0,1,0
29,326,326,27,1,26,2,1
3,327,327,40,21,19,3,2
18,341,341,67,4,63,4,3
12,342,342,29,9,20,2,1
20,345,345,44,44,0,1,0
21,352,352,8,5,3,2,1
1,376,376,45,7,38,3,2
24,396,396,22,22,0,1,0
11,402,402,24,20,4,2,1
15,415,415,38,38,0,1,0
10,417,417,31,3,28,3,2
32,421,421,61,31,30,2,1
9,449,449,49,49,0,1,0
28,458,458,70,2,68,4,3
6,467,467,68,50,18,2,1
36,468,468,165,79,86,3,2
17,492,492,58,58,0,1,0

24,110,110,6,6,0,1,0
36,136,136,29,29,0,1,0
13,146,146,4,4,0,1,0
11,154,154,9,9,0,1,0
0,160,160,39,5,34,2,1
20,176,176,13,13,0,1,0
33,178,178,3,3,0,1,0
18,180,180,18,5,13,2,1
25,181,181,47,47,0,1,0
3,202,202,23,23,0,1,0
12,207,207,8,1,7,2,1
16,210,210,11,2,9,2,1
15,210,210,16,16,0,1,0
34,220,220,8,8,0,1,0
4,238,238,10,10,0,1,0
31,242,242,45,45,0,1,0
8,242,242,20,20,0,1,0
38,249,249,37,37,0,1,0
5,286,286,15,4,11,2,1
9,288,288,2,2,0,1,0
17,297,297,72,45,27,4,3
14,301,301,28,28,0,1,0
23,309,309,32,32,0,1,0
19,311,311,23,13,10,3,2
10,321,321,5,5,0,1,0
27,321,321,3,3,0,1,0
22,336,336,3,3,0,1,0
37,353,353,12,5,7,2,1
6,360,360,4,4,0,1,0
40,364,364,9,9,0,1,0
29,375,375,120,100,20,3,2
30,375,375,20,8,12,3,2
21,379,379,12,7,5,2,1
7,388,388,100,62,38,3,2
39,403,403,17,17,0,1,0
35,405,405,1,1,0,1,0
32,427,427,86,86,0,1,0
1,459,459,27,13,14,2,1
28,464,464,49,4,45,2,1
26,483,483,7,2,5,2,1
2,488,488,20,20,0,1,0

15,112,112,5,5,0,1,0
17,119,119,6,6,0,1,0
30,128,128,18,1,17,3,2
16,141,141,4,4,0,1,0
18,144,144,21,21,0,1,0
33,159,159,12,12,0,1,0
25,163,163,7,7,0,1,0
12,166,166,1,1,0,1,0
24,186,186,23,6,17,2,1
28,189,189,28,14,14,3,2
37,193,193,8,8,0,1,0
1,204,204,10,2,8,2,1
2,208,208,33,33,0,1,0
5,237,237,17,17,0,1,0
21,241,241,33,33,0,1,0
19,255,255,19,8,11,2,1
0,255,255,16,2,14,3,2
39,265,265,26,26,0,1,0
7,278,278,24,24,0,1,0
34,278,278,16,9,7,2,1
27,285,285,23,23,0,1,0
26,306,306,44,44,0,1,0
13,328,328,20,20,0,1,0
3,334,334,40,40,0,1,0
20,344,344,10,2,8,2,1
22,347,347,24,24,0,1,0
4,362,362,19,19,0,1,0
32,362,362,13,4,9,2,1
8,366,366,6,2,4,2,1
23,378,378,36,36,0,1,0
38,384,384,155,141,14,3,2
14,388,388,151,139,12,4,3
11,396,396,4,4,0,1,0
6,413,413,17,17,0,1,0
31,415,415,25,25,0,1,0
36,427,427,28,4,24,4,3
35,428,428,18,9,9,4,3
10,450,450,58,58,0,1,0
29,463,463,55,10,45,4,3
9,479,479,19,13,6,3,2

16,106,106,5,5,0,1,0
36,109,109,1,1,0,1,0
21,113,113,4,4,0,1,0
8,145,145,3,3,0,1,0
35,146,146,6,6,0,1,0
31,148,148,1,1,0,1,0
27,153,153,22,2,20,3,2
13,163,163,13,4,9,2,1
0,166,166,18,18,0,1,0
19,173,173,23,3,20,2,1
10,175,175,10,3,7,2,1
33,184,184,19,11,8,3,2
30,187,187,50,50,0,1,0
7,201,201,9,9,0,1,0
24,227,227,30,30,0,1,0
32,228,228,12,7,5,2,1
11,233,233,35,5,30,4,3
20,243,243,31,31,0,1,0
34,262,262,24,24,0,1,0
29,271,271,58,26,32,2,1
25,271,271,32,23,9,4,3
5,274,274,3,3,0,1,0
1,305,305,65,62,3,2,1
26,315,315,19,19,0,1,0
14,323,323,39,39,0,1,0
22,349,349,59,59,0,1,0
17,350,350,125,5,120,4,3
12,371,371,5,5,0,1,0
4,380,380,105,12,93,4,3
2,389,389,57,57,0,1,0
15,393,393,1,1,0,1,0
9,400,400,6,2,4,2,1
6,429,429,7,7,0,1,0
23,453,453,52,52,0,1,0
3,463,463,30,17,13,2,1
18,473,473,26,10,16,2,1
28,474,474,10,10,0,1,0

27,100,100,25,25,0,1,0
31,131,131,9,6,3,2,1
24,134,134,12,2,10,3,2
14,145,145,9,2,7,2,1
19,161,161,5,5,0,1,0
4,163,163,6,6,0,1,0
32,166,166,14,14,0,1,0
29,172,172,5,5,0,1,0
33,230,230,50,50,0,1,0
12,237,237,6,6,0,1,0
26,251,251,7,7,0,1,0
22,271,271,7,2,5,2,1
3,277,277,53,22,31,2,1
9,282,282,32,5,27,2,1
13,302,302,5,5,0,1,0
20,312,312,22,22,0,1,0
23,357,357,179,56,123,4,3
5,362,362,21,21,0,1,0
10,376,376,7,7,0,1,0
1,389,389,97,55,42,2,1
21,391,391,15,8,7,2,1
18,406,406,38,14,24,2,1
30,423,423,53,9,44,3,2
6,430,430,1,1,0,1,0
25,437,437,34,34,0,1,0
11,452,452,24,24,0,1,0
16,460,460,9,3,6,2,1
2,463,463,127,70,57,4,3
15,464,464,11,11,0,1,0
8,465,465,94,58,36,3,2
28,467,467,9,3,6,2,1
7,481,481,67,19,48,2,1
0,484,484,162,148,14,3,2
17,492,492,29,6,23,2,1

0,101,101,13,1,12,3,2
16,107,107,1,1,0,1,0
20,113,113,10,3,7,2,1
27,113,113,6,1,5,2,1
15,146,146,1,1,0,1,0
23,151,151,15,8,7,2,1
21,160,160,18,8,10,2,1
1,163,163,21,21,0,1,0
31,169,169,12,12,0,1,0
12,173,173,6,6,0,1,0
7,178,178,6,6,0,1,0
9,199,199,10,10,0,1,0
34,200,200,13,13,0,1,0
10,203,203,17,5,12,3,2
24,233,233,7,7,0,1,0
6,250,250,55,5,50,2,1
18,263,263,7,1,6,2,1
11,265,265,3,3,0,1,0
26,268,268,6,1,5,2,1
3,272,272,3,3,0,1,0
32,299,299,58,58,0,1,0
28,301,301,30,16,14,3,2
35,316,316,10,10,0,1,0
2,318,318,14,14,0,1,0
19,321,321,78,78,0,1,0
8,326,326,1,1,0,1,0
14,343,343,1,1,0,1,0
4,353,353,33,21,12,2,1
25,363,363,7,7,0,1,0
22,387,387,41,41,0,1,0
17,389,389,193,103,90,3,2
33,390,390,132,111,21,4,3
13,410,410,167,118,49,2,1
29,448,448,59,59,0,1,0
5,486,486,17,3,14,3,2
30,496,496,52,30,22,3,2

25,112,112,18,18,0,1,0
4,115,115,4,4,0,1,0
10,117,117,7,7,0,1,0
38,123,123,1,1,0,1,0
27,130,130,31,9,22,2,1
34,140,140,2,2,0,1,0
6,150,150,15,15,0,1,0
30,163,163,2,2,0,1,0
12,166,166,10,3,7,2,1
2,172,172,3,3,0,1,0
9,172,172,2,2,0,1,0
39,173,173,24,24,0,1,0
29,186,186,5,1,4,2,1
14,189,189,8,8,0,1,0
7,190,190,19,7,12,4,3
18,214,214,2,2,0,1,0
1,234,234,13,13,0,1,0
36,235,235,35,35,0,1,0
35,243,243,49,49,0,1,0
3,245,245,4,4,0,1,0
15,282,282,8,8,0,1,0
19,307,307,39,8,31,2,1
23,325,325,25,18,7,2,1
28,333,333,50,50,0,1,0
32,354,354,22,22,0,1,0
16,360,360,12,3,9,4,3
17,364,364,44,33,11,2,1
20,387,387,51,15,36,3,2
37,391,391,66,18,48,4,3
24,401,401,102,48,54,4,3
13,406,406,4,4,0,1,0
11,418,418,60,18,42,4,3
21,420,420,24,24,0,1,0
22,431,431,3,3,0,1,0
0,444,444,81,81,0,1,0
26,444,444,23,6,17,2,1
5,444,444,59,59,0,1,0
33,454,454,29,4,25,4,3
40,481,481,11,11,0,1,0
8,487,487,156,118,38,2,1
31,488,488,16,16,0,1,0

14,110,110,12,12,0,1,0
0,115,115,29,29,0,1,0
12,121,121,1,1,0,1,0
18,137,137,5,5,0,1,0
7,167,167,2,2,0,1,0
19,174,174,40,7,33,2,1
11,175,175,9,9,0,1,0
28,189,189,7,7,0,1,0
17,211,211,46,36,10,2,1
9,216,216,73,73,0,1,0
13,234,234,51,51,0,1,0
24,239,239,45,45,0,1,0
23,266,266,11,11,0,1,0
5,291,291,3,3,0,1,0
2,301,301,12,12,0,1,0
8,305,305,14,14,0,1,0
1,322,322,93,21,72,4,3
27,326,326,49,31,18,4,3
22,342,342,1,1,0,1,0
25,358,358,82,82,0,1,0
6,376,376,39,8,31,4,3
20,385,385,8,8,0,1,0
15,390,390,15,7,8,2,1
4,392,392,218,202,16,2,1
10,398,398,29,29,0,1,0
3,417,417,34,2,32,3,2
21,421,421,15,15,0,1,0
16,472,472,102,102,0,1,0
26,497,497,3,3,0,1,0

6,125,125,11,11,0,1,0
17,132,132,6,3,3,2,1
5,132,132,45,45,0,1,0
7,153,153,10,2,8,3,2
27,157,157,42,42,0,1,0
21,172,172,26,8,18,2,1
23,184,184,14,14,0,1,0
12,191,191,13,13,0,1,0
18,218,218,14,2,12,3,2
9,235,235,25,25,0,1,0
31,235,235,7,7,0,1,0
4,236,236,51,8,43,3,2
30,240,240,5,5,0,1,0
36,245,245,8,8,0,1,0
25,245,245,18,18,0,1,0
13,246,246,12,12,0,1,0
1,254,254,14,5,9,4,3
33,269,269,8,8,0,1,0
11,317,317,30,30,0,1,0
14,322,322,29,11,18,3,2
24,342,342,82,67,15,4,3
10,348,348,29,15,14,2,1
16,354,354,11,11,0,1,0
26,363,363,28,4,24,4,3
0,365,365,4,4,0,1,0
15,365,365,48,48,0,1,0
20,369,369,71,37,34,2,1
32,379,379,33,33,0,1,0
8,412,412,41,41,0,1,0
28,417,417,4,4,0,1,0
37,430,430,37,34,3,2,1
19,446,446,15,15,0,1,0
22,467,467,130,19,111,4,3
29,470,470,24,6,18,4,3
3,470,470,15,7,8,2,1
34,480,480,47,47,0,1,0
2,494,494,48,48,0,1,0
35,498,498,16,5,11,2,1

0,126,126,4,4,0,1,0
16,127,127,40,40,0,1,0
15,136,136,3,3,0,1,0
23,156,156,15,15,0,1,0
2,164,164,2,2,0,1,0
10,165,165,10,10,0,1,0
17,198,198,33,3,30,4,3
31,201,201,4,1,3,2,1
25,245,245,16,16,0,1,0
19,261,261,2,2,0,1,0
26,264,264,61,34,27,4,3
28,266,266,22,12,10,2,1
6,266,266,17,17,0,1,0
22,289,289,41,32,9,4,3
29,317,317,2,2,0,1,0
27,319,319,29,17,12,3,2
7,322,322,75,75,0,1,0
32,324,324,18,2,16,3,2
1,349,349,5,5,0,1,0
8,360,360,92,92,0,1,0
12,369,369,6,6,0,1,0
3,396,396,48,16,32,2,1
13,397,397,56,56,0,1,0
4,423,423,58,58,0,1,0
18,425,425,29,11,18,3,2
11,425,425,243,117,126,4,3
21,433,433,22,22,0,1,0
14,444,444,21,14,7,3,2
5,451,451,36,17,19,2,1
20,472,472,96,71,25,2,1
24,479,479,16,16,0,1,0
9,488,488,8,8,0,1,0
30,497,497,94,86,8,2,1

28,108,108,1,1,0,1,0
19,113,113,3,3,0,1,0
26,135,135,31,19,12,4,3
17,142,142,50,11,39,3,2
35,152,152,7,7,0,1,0
21,156,156,35,25,10,3,2
6,177,177,8,2,6,3,2
11,187,187,1,1,0,1,0
12,209,209,38,13,25,2,1
37,234,234,68,26,42,3,2
20,246,246,9,9,0,1,0
8,248,248,1,1,0,1,0
27,287,287,54,54,0,1,0
4,305,305,1,1,0,1,0
22,305,305,61,61,0,1,0
10,306,306,79,79,0,1,0
1,315,315,1,1,0,1,0
7,322,322,73,73,0,1,0
32,323,323,27,27,0,1,0
15,329,329,5,5,0,1,0
29,342,342,2,2,0,1,0
5,355,355,1,1,0,1,0
23,361,361,5,5,0,1,0
34,375,375,35,35,0,1,0
31,378,378,81,39,42,4,3
3,383,383,32,32,0,1,0
2,402,402,13,13,0,1,0
0,405,405,3,3,0,1,0
13,407,407,97,63,34,3,2
24,417,417,36,36,0,1,0
25,430,430,16,16,0,1,0
30,446,446,19,19,0,1,0
33,451,451,11,4,7,2,1
16,452,452,116,53,63,4,3
18,453,453,24,10,14,3,2
14,460,460,3,3,0,1,0
9,473,473,3,3,0,1,0
36,491,491,6,6,0,1,0

11,108,108,1,1,0,1,0
28,110,110,39,39,0,1,0
21,113,113,4,4,0,1,0
8,119,119,22,22,0,1,0
32,120,120,9,9,0,1,0
22,178,178,54,39,15,4,3
5,192,192,1,1,0,1,0
12,233,233,7,7,0,1,0
20,235,235,7,7,0,1,0
15,268,268,43,43,0,1,0
36,271,271,38,2,36,4,3
0,275,275,12,4,8,2,1
25,278,278,5,5,0,1,0
27,288,288,63,57,6,3,2
29,309,309,5,5,0,1,0
9,310,310,4,1,3,2,1
31,317,317,8,8,0,1,0
3,340,340,4,1,3,2,1
4,341,341,52,35,17,2,1
33,346,346,20,20,0,1,0
7,349,349,106,106,0,1,0
23,351,351,31,31,0,1,0
19,360,360,50,50,0,1,0
13,383,383,27,17,10,3,2
16,392,392,56,56,0,1,0
26,393,393,3,3,0,1,0
6,394,394,13,1,12,2,1
39,401,401,25,25,0,1,0
1,409,409,62,62,0,1,0
34,412,412,6,1,5,2,1
37,415,415,4,4,0,1,0
10,421,421,36,8,28,2,1
17,443,443,42,10,32,3,2
35,445,445,10,1,9,2,1
24,470,470,101,68,33,4,3
30,470,470,74,74,0,1,0
2,474,474,49,49,0,1,0
14,479,479,1,1,0,1,0
18,491,491,2,2,0,1,0
38,496,496,24,8,16,3,2

32,100,100,14,14,0,1,0
0,102,102,3,3,0,1,0
4,110,110,13,7,6,3,2
1,132,132,6,6,0,1,0
7,151,151,33,33,0,1,0
26,166,166,33,33,0,1,0
27,172,172,23,23,0,1,0
17,172,172,17,17,0,1,0
22,175,175,17,11,6,3,2
28,193,193,53,7,46,3,2
20,195,195,21,21,0,1,0
9,196,196,11,11,0,1,0
11,202,202,55,55,0,1,0
2,203,203,6,3,3,2,1
15,212,212,23,1,22,3,2
3,218,218,26,26,0,1,0
6,248,248,19,19,0,1,0
24,257,257,4,4,0,1,0
18,259,259,8,2,6,3,2
8,273,273,6,3,3,2,1
33,284,284,66,32,34,3,2
21,284,284,18,18,0,1,0
14,293,293,8,8,0,1,0
19,302,302,21,4,17,2,1
25,302,302,41,7,34,3,2
12,323,323,12,12,0,1,0
34,325,325,9,1,8,3,2
36,331,331,9,9,0,1,0
29,335,335,21,6,15,4,3
30,365,365,6,3,3,2,1
35,401,401,24,24,0,1,0
31,417,417,67,50,17,2,1
16,436,436,63,2,61,3,2
5,437,437,67,67,0,1,0
13,459,459,78,78,0,1,0
10,467,467,20,20,0,1,0
23,487,487,8,8,0,1,0

16,121,121,4,4,0,1,0
30,129,129,62,26,36,3,2
20,146,146,1,1,0,1,0
5,150,150,11,11,0,1,0
4,150,150,31,11,20,3,2
13,156,156,18,9,9,2,1
24,171,171,2,2,0,1,0
22,173,173,49,49,0,1,0
19,179,179,2,2,0,1,0
9,179,179,53,6,47,2,1
10,180,180,19,14,5,2,1
21,200,200,1,1,0,1,0
17,204,204,4,4,0,1,0
7,211,211,1,1,0,1,0
28,225,225,1,1,0,1,0
1,265,265,10,10,0,1,0
3,286,286,1,1,0,1,0
18,309,309,35,35,0,1,0
31,322,322,18,18,0,1,0
2,332,332,43,43,0,1,0
11,334,334,75,55,20,3,2
25,338,338,14,14,0,1,0
6,358,358,55,1,54,4,3
32,384,384,112,40,72,4,3
23,417,417,69,69,0,1,0
0,429,429,28,16,12,3,2
12,452,452,10,10,0,1,0
26,474,474,66,28,38,2,1
14,476,476,106,106,0,1,0
8,480,480,67,67,0,1,0
27,487,487,32,32,0,1,0
29,496,496,46,36,10,3,2
15,497,497,9,9,0,1,0

41,124,124,47,47,0,1,0
40,126,126,2,2,0,1,0
11,129,129,9,1,8,3,2
33,182,182,5,2,3,2,1
35,183,183,38,38,0,1,0
37,183,183,49,49,0,1,0
32,190,190,15,5,10,3,2
1,200,200,17,17,0,1,0
30,222,222,13,4,9,2,1
29,231,231,3,3,0,1,0
10,250,250,41,41,0,1,0
19,254,254,9,9,0,1,0
20,254,254,4,4,0,1,0
13,259,259,18,8,10,2,1
14,262,262,67,67,0,1,0
5,274,274,1,1,0,1,0
25,297,297,92,77,15,4,3
0,305,305,3,3,0,1,0
15,314,314,34,34,0,1,0
24,319,319,31,10,21,4,3
31,324,324,9,3,6,3,2
16,329,329,44,44,0,1,0
8,330,330,2,2,0,1,0
18,333,333,5,2,3,2,1
3,353,353,22,2,20,4,3
23,360,360,20,3,17,4,3
27,369,369,23,23,0,1,0
4,375,375,13,10,3,2,1
6,380,380,45,22,23,2,1
12,387,387,2,2,0,1,0
7,393,393,18,4,14,2,1
39,397,397,5,5,0,1,0
2,399,399,16,16,0,1,0
38,404,404,14,14,0,1,0
9,439,439,29,29,0,1,0
21,439,439,34,22,12,3,2
36,440,440,8,2,6,2,1
42,448,448,22,7,15,2,1
26,463,463,20,20,0,1,0
22,470,470,83,49,34,4,3
34,472,472,50,28,22,3,2
28,474,474,60,22,38,2,1
17,494,494,25,25,0,1,0

33,105,105,10,10,0,1,0
23,125,125,4,1,3,2,1
20,131,131,10,10,0,1,0
28,137,137,16,2,14,2,1
10,144,144,15,15,0,1,0
6,166,166,36,36,0,1,0
31,168,168,12,12,0,1,0
13,173,173,1,1,0,1,0
18,181,181,22,22,0,1,0
36,183,183,3,3,0,1,0
15,186,186,3,3,0,1,0
8,188,188,3,3,0,1,0
11,195,195,4,4,0,1,0
37,215,215,11,11,0,1,0
30,235,235,15,15,0,1,0
4,246,246,2,2,0,1,0
0,254,254,16,2,14,3,2
29,263,263,43,28,15,3,2
3,273,273,15,15,0,1,0
14,277,277,10,2,8,2,1
39,279,279,48,48,0,1,0
41,284,284,4,4,0,1,0
1,299,299,6,1,5,2,1
7,305,305,24,24,0,1,0
12,319,319,9,9,0,1,0
21,327,327,26,26,0,1,0
17,352,352,98,62,36,4,3
34,377,377,88,18,70,3,2
32,385,385,81,81,0,1,0
38,388,388,47,47,0,1,0
22,403,403,52,52,0,1,0
25,404,404,13,2,11,3,2
16,412,412,149,149,0,1,0
35,419,419,13,2,11,2,1
24,438,438,52,52,0,1,0
40,452,452,19,19,0,1,0
19,458,458,5,5,0,1,0
27,472,472,126,126,0,1,0
26,479,479,7,7,0,1,0
5,481,481,1,1,0,1,0
2,483,483,12,12,0,1,0
9,499,499,8,3,5,2,1

28,106,106,3,3,0,1,0
27,118,118,23,5,18,4,3
21,144,144,14,14,0,1,0
23,150,150,6,6,0,1,0
14,153,153,6,6,0,1,0
16,166,166,5,1,4,2,1
9,172,172,2,2,0,1,0
11,183,183,41,41,0,1,0
33,202,202,9,3,6,3,2
29,203,203,6,6,0,1,0
20,206,206,12,12,0,1,0
17,207,207,7,1,6,2,1
18,210,210,50,3,47,2,1
26,225,225,3,3,0,1,0
31,228,228,1,1,0,1,0
6,230,230,13,10,3,2,1
4,239,239,10,10,0,1,0
1,241,241,13,13,0,1,0
5,243,243,37,9,28,2,1
10,271,271,11,3,8,3,2
7,294,294,70,23,47,2,1
30,314,314,56,3,53,3,2
19,326,326,41,41,0,1,0
22,339,339,26,26,0,1,0
34,348,348,36,36,0,1,0
32,357,357,145,136,9,4,3
2,364,364,59,59,0,1,0
12,365,365,5,5,0,1,0
25,373,373,57,17,40,3,2
15,389,389,22,22,0,1,0
24,405,405,42,34,8,3,2
35,410,410,26,14,12,4,3
8,425,425,34,19,15,2,1
0,446,446,90,6,84,4,3
13,455,455,48,48,0,1,0
3,464,464,10,10,0,1,0
36,496,496,59,59,0,1,0

35,111,111,15,15,0,1,0
12,111,111,15,15,0,1,0
2,113,113,4,1,3,2,1
19,121,121,5,2,3,2,1
11,124,124,38,38,0,1,0
5,136,136,6,3,3,2,1
22,145,145,4,1,3,2,1
0,156,156,15,15,0,1,0
16,160,160,6,6,0,1,0
7,161,161,3,3,0,1,0
32,178,178,11,11,0,1,0
27,194,194,74,17,57,4,3
24,194,194,7,1,6,3,2
30,195,195,14,14,0,1,0
36,197,197,5,5,0,1,0
39,207,207,14,14,0,1,0
15,219,219,2,2,0,1,0
26,222,222,40,40,0,1,0
37,227,227,45,45,0,1,0
10,243,243,2,2,0,1,0
3,264,264,22,6,16,3,2
20,294,294,21,21,0,1,0
18,301,301,31,7,24,4,3
13,304,304,17,2,15,2,1
6,316,316,1,1,0,1,0
14,337,337,56,56,0,1,0
4,342,342,11,1,10,3,2
28,370,370,4,4,0,1,0
25,375,375,8,8,0,1,0
17,387,387,50,50,0,1,0
33,394,394,120,120,0,1,0
8,396,396,4,4,0,1,0
9,406,406,5,5,0,1,0
23,408,408,51,35,16,2,1
38,408,408,25,8,17,2,1
31,419,419,28,28,0,1,0
34,436,436,19,19,0,1,0
29,445,445,10,4,6,3,2
1,448,448,130,61,69,4,3
21,483,483,54,33,21,2,1

38,113,113,21,14,7,2,1
16,130,130,4,4,0,1,0
39,140,140,6,6,0,1,0
2,143,143,1,1,0,1,0
33,145,145,8,2,6,3,2
12,152,152,1,1,0,1,0
13,166,166,5,5,0,1,0
15,174,174,1,1,0,1,0
21,175,175,14,14,0,1,0
37,178,178,9,1,8,3,2
23,189,189,22,22,0,1,0
5,213,213,2,2,0,1,0
11,216,216,11,5,6,3,2
14,217,217,7,7,0,1,0
8,221,221,45,15,30,4,3
34,228,228,12,2,10,2,1
17,231,231,12,12,0,1,0
7,232,232,1,1,0,1,0
42,240,240,3,3,0,1,0
3,241,241,3,3,0,1,0
24,259,259,6,3,3,2,1
30,261,261,45,45,0,1,0
4,267,267,5,5,0,1,0
10,285,285,22,12,10,2,1
6,289,289,7,7,0,1,0
18,293,293,5,5,0,1,0
20,296,296,44,44,0,1,0
29,306,306,84,84,0,1,0
27,308,308,54,16,38,3,2
41,325,325,54,11,43,4,3
35,337,337,22,13,9,2,1
28,344,344,40,40,0,1,0
44,356,356,18,18,0,1,0
19,359,359,10,10,0,1,0
36,368,368,15,5,10,3,2
22,374,374,31,31,0,1,0
26,379,379,52,1,51,4,3
43,387,387,80,80,0,1,0
31,389,389,45,45,0,1,0
32,438,438,13,7,6,2,1
1,453,453,74,74,0,1,0
9,455,455,106,97,9,4,3
40,470,470,9,9,0,1,0
0,473,473,64,64,0,1,0
25,473,473,34,34,0,1,0

28,143,143,9,2,7,2,1
20,157,157,12,12,0,1,0
22,165,165,6,6,0,1,0
11,167,167,11,2,9,4,3
4,168,168,3,3,0,1,0
19,172,172,10,10,0,1,0
30,172,172,58,34,24,2,1
26,188,188,35,35,0,1,0
5,193,193,48,48,0,1,0
12,199,199,38,38,0,1,0
9,200,200,2,2,0,1,0
32,202,202,77,77,0,1,0
10,210,210,17,17,0,1,0
7,219,219,55,9,46,3,2
14,220,220,4,1,3,2,1
0,248,248,52,52,0,1,0
2,248,248,1,1,0,1,0
33,270,270,2,2,0,1,0
25,304,304,31,2,29,4,3
18,315,315,24,3,21,2,1
17,318,318,13,4,9,4,3
1,320,320,11,5,6,3,2
15,325,325,3,3,0,1,0
13,328,328,49,49,0,1,0
21,329,329,9,6,3,2,1
27,329,329,32,32,0,1,0
31,376,376,56,56,0,1,0
29,379,379,3,3,0,1,0
8,393,393,19,19,0,1,0
24,404,404,51,30,21,2,1
3,404,404,57,39,18,4,3
16,434,434,27,16,11,2,1
6,466,466,150,9,141,4,3
23,479,479,1,1,0,1,0

26,106,106,3,3,0,1,0
31,108,108,3,3,0,1,0
11,115,115,40,10,30,4,3
20,115,115,22,22,0,1,0
12,134,134,1,1,0,1,0
9,138,138,38,16,22,3,2
29,143,143,13,13,0,1,0
27,145,145,31,31,0,1,0
6,152,152,18,3,15,2,1
28,169,169,43,1,42,2,1
23,175,175,8,8,0,1,0
15,225,225,4,4,0,1,0
16,228,228,17,8,9,4,3
18,234,234,1,1,0,1,0
19,236,236,20,20,0,1,0
14,286,286,31,31,0,1,0
33,300,300,24,7,17,2,1
8,313,313,8,8,0,1,0
30,340,340,21,21,0,1,0
35,351,351,51,51,0,1,0
4,351,351,5,2,3,2,1
24,357,357,56,56,0,1,0
7,362,362,110,77,33,2,1
34,395,395,29,5,24,3,2
25,404,404,1,1,0,1,0
0,411,411,4,4,0,1,0
1,421,421,49,49,0,1,0
36,429,429,22,8,14,2,1
3,441,441,7,3,4,2,1
2,447,447,10,10,0,1,0
13,461,461,22,22,0,1,0
21,464,464,34,17,17,2,1
32,473,473,95,17,78,4,3
22,481,481,28,21,7,2,1
17,481,481,11,2,9,4,3
10,481,481,27,27,0,1,0
5,494,494,105,51,54,4,3

15,114,114,27,11,16,2,1
26,118,118,1,1,0,1,0
14,133,133,16,16,0,1,0
19,135,135,2,2,0,1,0
4,158,158,3,3,0,1,0
2,177,177,7,7,0,1,0
17,191,191,37,23,14,3,2
3,194,194,46,46,0,1,0
28,195,195,24,24,0,1,0
8,222,222,27,27,0,1,0
18,237,237,17,1,16,2,1
30,246,246,20,20,0,1,0
7,256,256,8,8,0,1,0
34,279,279,6,6,0,1,0
27,287,287,5,5,0,1,0
25,320,320,3,3,0,1,0
35,321,321,74,34,40,3,2
13,328,328,11,1,10,2,1
12,334,334,59,59,0,1,0
29,350,350,75,24,51,4,3
20,353,353,37,37,0,1,0
5,355,355,71,71,0,1,0
22,362,362,142,55,87,4,3
10,388,388,12,12,0,1,0
24,399,399,3,3,0,1,0
33,401,401,97,37,60,3,2
16,404,404,37,10,27,4,3
21,421,421,24,24,0,1,0
6,426,426,25,25,0,1,0
9,428,428,44,1,43,3,2
32,465,465,6,6,0,1,0
1,469,469,8,8,0,1,0
0,472,472,21,9,12,4,3
11,483,483,24,10,14,2,1
31,497,497,11,5,6,2,1
23,498,498,98,98,0,1,0

9,102,102,16,2,14,2,1
21,114,114,20,20,0,1,0
1,121,121,11,11,0,1,0
5,123,123,4,4,0,1,0
19,132,132,1,1,0,1,0
16,148,148,3,3,0,1,0
12,150,150,2,2,0,1,0
30,155,155,1,1,0,1,0
33,177,177,8,4,4,2,1
37,182,182,8,8,0,1,0
17,190,190,7,7,0,1,0
18,199,199,37,37,0,1,0
10,209,209,1,1,0,1,0
15,214,214,42,18,24,2,1
11,221,221,6,6,0,1,0
24,231,231,35,35,0,1,0
32,240,240,7,2,5,2,1
34,255,255,43,43,0,1,0
2,264,264,11,11,0,1,0
27,268,268,1,1,0,1,0
36,269,269,31,31,0,1,0
29,276,276,16,3,13,3,2
13,277,277,23,2,21,2,1
26,312,312,108,54,54,3,2
7,330,330,30,17,13,2,1
14,331,331,13,1,12,4,3
22,348,348,6,6,0,1,0
3,367,367,34,18,16,2,1
25,374,374,77,15,62,4,3
28,375,375,33,24,9,2,1
20,405,405,29,29,0,1,0
38,410,410,38,38,0,1,0
35,431,431,53,32,21,2,1
0,439,439,30,30,0,1,0
8,451,451,88,66,22,2,1
31,453,453,6,6,0,1,0
23,454,454,71,71,0,1,0
4,457,457,22,22,0,1,0
6,465,465,139,64,75,4,3

28,102,102,1,1,0,1,0
14,106,106,27,27,0,1,0
25,113,113,1,1,0,1,0
22,137,137,1,1,0,1,0
4,175,175,33,22,11,2,1
31,177,177,12,12,0,1,0
13,187,187,2,2,0,1,0
21,191,191,1,1,0,1,0
23,200,200,36,36,0,1,0
10,230,230,36,12,24,4,3
11,237,237,4,4,0,1,0
3,266,266,7,7,0,1,0
5,274,274,34,23,11,2,1
16,301,301,11,11,0,1,0
1,304,304,49,31,18,3,2
18,308,308,4,4,0,1,0
7,332,332,73,73,0,1,0
20,338,338,4,1,3,2,1
9,346,346,4,4,0,1,0
24,357,357,13,4,9,4,3
26,363,363,102,40,62,3,2
6,370,370,17,17,0,1,0
15,386,386,2,2,0,1,0
8,391,391,48,24,24,3,2
30,392,392,41,41,0,1,0
12,414,414,76,76,0,1,0
29,422,422,46,46,0,1,0
19,434,434,67,67,0,1,0
17,445,445,135,132,3,2,1
27,450,450,113,113,0,1,0
2,470,470,15,3,12,2,1
0,477,477,241,241,0,1,0

28,121,121,2,2,0,1,0
20,125,125,3,3,0,1,0
7,125,125,15,6,9,4,3
22,167,167,3,3,0,1,0
30,183,183,24,16,8,3,2
24,222,222,1,1,0,1,0
25,224,224,25,25,0,1,0
13,239,239,29,20,9,4,3
27,249,249,34,26,8,2,1
0,253,253,38,35,3,2,1
15,263,263,12,12,0,1,0
29,267,267,6,1,5,2,1
18,298,298,17,17,0,1,0
19,303,303,21,21,0,1,0
26,314,314,3,3,0,1,0
2,337,337,63,31,32,4,3
32,346,346,60,60,0,1,0
16,359,359,11,11,0,1,0
14,363,363,34,4,30,4,3
5,378,378,54,38,16,3,2
31,381,381,1,1,0,1,0
12,393,393,22,22,0,1,0
8,394,394,22,1,21,4,3
9,409,409,89,89,0,1,0
1,413,413,82,15,67,4,3
4,426,426,3,3,0,1,0
21,429,429,92,64,28,2,1
3,432,432,11,11,0,1,0
6,433,433,31,31,0,1,0
23,452,452,37,2,35,3,2
10,452,452,79,79,0,1,0
33,456,456,79,79,0,1,0
34,468,468,18,12,6,2,1
17,482,482,8,2,6,3,2
35,483,483,267,243,24,2,1
11,488,488,42,42,0,1,0

7,111,111,54,12,42,4,3
19,119,119,2,2,0,1,0
29,123,123,28,17,11,2,1
2,132,132,2,2,0,1,0
18,134,134,7,7,0,1,0
1,135,135,35,35,0,1,0
4,153,153,4,4,0,1,0
30,165,165,19,19,0,1,0
3,168,168,28,28,0,1,0
12,173,173,32,4,28,3,2
23,180,180,18,18,0,1,0
27,185,185,47,36,11,2,1
17,202,202,34,9,25,3,2
15,218,218,32,32,0,1,0
33,223,223,14,5,9,4,3
20,223,223,1,1,0,1,0
32,268,268,31,15,16,2,1
22,277,277,26,26,0,1,0
28,301,301,11,11,0,1,0
14,313,313,2,2,0,1,0
11,316,316,48,9,39,4,3
21,337,337,15,1,14,3,2
8,360,360,48,8,40,3,2
26,360,360,60,31,29,2,1
0,361,361,26,26,0,1,0
6,363,363,1,1,0,1,0
9,378,378,3,3,0,1,0
25,412,412,23,23,0,1,0
13,421,421,15,6,9,4,3
10,441,441,29,29,0,1,0
31,467,467,81,81,0,1,0
5,475,475,20,20,0,1,0
16,486,486,45,23,22,2,1
24,491,491,27,27,0,1,0

33,111,111,1,1,0,1,0
20,121,121,7,1,6,2,1
15,126,126,12,12,0,1,0
1,127,127,2,2,0,1,0
28,128,128,13,13,0,1,0
31,148,148,11,3,8,3,2
6,154,154,14,9,5,2,1
7,181,181,28,16,12,4,3
25,184,184,5,5,0,1,0
17,190,190,1,1,0,1,0
27,206,206,20,12,8,2,1
16,217,217,26,8,18,4,3
18,226,226,26,10,16,2,1
22,241,241,26,6,20,3,2
26,257,257,18,2,16,3,2
12,264,264,102,102,0,1,0
10,291,291,46,46,0,1,0
32,308,308,6,6,0,1,0
9,331,331,14,3,11,2,1
34,332,332,21,3,18,3,2
11,343,343,23,23,0,1,0
2,350,350,53,27,26,2,1
24,362,362,119,53,66,3,2
3,364,364,1,1,0,1,0
8,366,366,24,24,0,1,0
14,379,379,38,38,0,1,0
19,381,381,9,1,8,2,1
30,406,406,181,94,87,4,3
13,414,414,74,20,54,4,3
23,422,422,47,17,30,3,2
5,427,427,27,27,0,1,0
21,441,441,8,8,0,1,0
0,459,459,7,3,4,2,1
29,460,460,73,73,0,1,0
4,496,496,48,48,0,1,0

4,116,116,4,4,0,1,0
24,136,136,11,5,6,2,1
26,140,140,21,15,6,2,1
20,144,144,15,15,0,1,0
22,160,160,24,12,12,3,2
1,164,164,22,8,14,3,2
30,170,170,12,12,0,1,0
32,176,176,6,6,0,1,0
5,179,179,36,28,8,3,2
8,196,196,13,6,7,2,1
7,209,209,1,1,0,1,0
21,223,223,13,13,0,1,0
29,235,235,25,25,0,1,0
10,247,247,23,23,0,1,0
36,255,255,12,12,0,1,0
25,269,269,31,31,0,1,0
18,270,270,50,37,13,4,3
13,271,271,37,37,0,1,0
23,290,290,43,4,39,4,3
15,292,292,3,3,0,1,0
3,295,295,24,24,0,1,0
35,324,324,29,2,27,4,3
11,328,328,2,2,0,1,0
9,341,341,46,13,33,2,1
2,344,344,14,11,3,2,1
17,361,361,23,16,7,2,1
33,361,361,9,9,0,1,0
12,371,371,7,4,3,2,1
27,390,390,57,57,0,1,0
31,395,395,20,11,9,4,3
14,401,401,122,58,64,3,2
19,411,411,66,66,0,1,0
34,436,436,19,19,0,1,0
0,440,440,33,5,28,3,2
28,447,447,114,30,84,4,3
16,455,455,56,56,0,1,0
6,474,474,41,41,0,1,0

4,109,109,2,2,0,1,0
0,141,141,12,12,0,1,0
22,147,147,6,6,0,1,0
19,162,162,18,3,15,2,1
34,169,169,31,19,12,3,2
6,182,182,10,10,0,1,0
9,183,183,11,11,0,1,0
27,185,185,24,9,15,2,1
13,190,190,12,12,0,1,0
10,203,203,14,14,0,1,0
11,204,204,47,47,0,1,0
36,234,234,15,8,7,2,1
28,246,246,62,43,19,2,1
21,249,249,3,3,0,1,0
26,261,261,2,2,0,1,0
32,267,267,4,4,0,1,0
5,269,269,15,15,0,1,0
7,281,281,13,9,4,2,1
24,322,322,52,52,0,1,0
37,322,322,43,43,0,1,0
8,323,323,1,1,0,1,0
25,324,324,101,23,78,4,3
16,324,324,51,51,0,1,0
35,328,328,40,25,15,2,1
15,346,346,52,5,47,4,3
3,353,353,77,68,9,4,3
18,354,354,58,58,0,1,0
2,364,364,15,15,0,1,0
20,383,383,14,5,9,2,1
12,404,404,17,17,0,1,0
1,420,420,34,10,24,4,3
14,427,427,58,58,0,1,0
31,438,438,9,9,0,1,0
33,446,446,3,3,0,1,0
17,462,462,8,2,6,2,1
23,477,477,4,4,0,1,0
29,495,495,12,12,0,1,0
30,497,497,154,154,0,1,0

4,124,124,4,4,0,1,0
8,139,139,13,13,0,1,0
2,147,147,12,12,0,1,0
27,182,182,5,5,0,1,0
11,188,188,130,98,32,2,1
9,210,210,22,22,0,1,0
10,234,234,16,8,8,3,2
22,253,253,28,1,27,4,3
0,260,260,10,4,6,3,2
5,263,263,9,6,3,2,1
17,273,273,45,45,0,1,0
25,274,274,9,3,6,2,1
7,281,281,12,12,0,1,0
24,290,290,40,12,28,2,1
19,292,292,40,40,0,1,0
28,306,306,31,31,0,1,0
30,310,310,30,30,0,1,0
14,334,334,82,82,0,1,0
1,339,339,69,69,0,1,0
12,347,347,96,67,29,2,1
23,361,361,79,40,39,2,1
16,372,372,1,1,0,1,0
15,372,372,6,6,0,1,0
13,402,402,96,1,95,4,3
3,404,404,36,24,12,4,3
26,416,416,35,8,27,2,1
20,430,430,4,4,0,1,0
21,442,442,25,5,20,3,2
18,454,454,37,1,36,4,3
6,470,470,21,21,0,1,0
29,492,492,31,10,21,4,3

32,133,133,14,2,12,4,3
5,133,133,18,8,10,2,1
11,147,147,8,8,0,1,0
29,154,154,12,12,0,1,0
27,192,192,32,28,4,2,1
10,195,195,9,9,0,1,0
19,214,214,1,1,0,1,0
13,242,242,11,11,0,1,0
22,252,252,12,8,4,2,1
31,255,255,20,2,18,2,1
2,256,256,67,52,15,4,3
12,259,259,6,1,5,2,1
9,263,263,4,4,0,1,0
3,271,271,41,41,0,1,0
25,290,290,12,6,6,3,2
16,296,296,12,2,10,2,1
21,307,307,58,58,0,1,0
6,330,330,128,128,0,1,0
23,337,337,8,8,0,1,0
0,342,342,135,135,0,1,0
15,348,348,1,1,0,1,0
26,349,349,69,55,14,2,1
18,354,354,14,7,7,2,1
30,363,363,70,28,42,2,1
28,378,378,41,2,39,4,3
4,386,386,6,6,0,1,0
24,388,388,80,80,0,1,0
20,404,404,34,21,13,2,1
14,434,434,35,28,7,2,1
8,438,438,57,7,50,3,2
17,442,442,42,42,0,1,0
33,456,456,49,49,0,1,0
34,470,470,35,35,0,1,0
1,485,485,7,3,4,2,1
7,497,497,1,1,0,1,0

20,103,103,1,1,0,1,0
26,128,128,15,1,14,2,1
23,150,150,10,10,0,1,0
13,152,152,61,61,0,1,0
7,164,164,8,8,0,1,0
1,210,210,50,50,0,1,0
16,216,216,23,13,10,2,1
6,228,228,2,2,0,1,0
17,241,241,1,1,0,1,0
12,277,277,34,34,0,1,0
2,310,310,62,12,50,2,1
19,310,310,16,16,0,1,0
9,325,325,11,11,0,1,0
5,330,330,50,50,0,1,0
15,351,351,156,156,0,1,0
14,355,355,8,1,7,3,2
24,383,383,10,10,0,1,0
21,406,406,20,20,0,1,0
8,433,433,219,177,42,2,1
0,444,444,62,62,0,1,0
18,457,457,46,22,24,2,1
10,466,466,3,3,0,1,0
11,473,473,105,15,90,3,2
3,474,474,152,125,27,4,3
25,474,474,10,10,0,1,0
4,491,491,92,92,0,1,0
22,497,497,20,2,18,4,3

15,105,105,1,1,0,1,0
14,110,110,2,2,0,1,0
5,135,135,19,19,0,1,0
28,144,144,27,2,25,2,1
22,165,165,85,85,0,1,0
3,205,205,83,77,6,2,1
13,212,212,3,3,0,1,0
27,241,241,9,9,0,1,0
8,254,254,42,25,17,2,1
4,260,260,10,10,0,1,0
9,287,287,52,28,24,3,2
17,292,292,2,2,0,1,0
16,298,298,19,19,0,1,0
26,311,311,17,17,0,1,0
0,322,322,40,16,24,3,2
20,335,335,16,16,0,1,0
21,361,361,19,9,10,3,2
2,379,379,34,34,0,1,0
10,389,389,94,26,68,3,2
19,407,407,54,54,0,1,0
23,422,422,49,13,36,2,1
6,425,425,8,3,5,2,1
30,437,437,25,25,0,1,0
29,439,439,7,1,6,2,1
18,447,447,16,8,8,3,2
12,458,458,116,116,0,1,0
7,459,459,6,3,3,2,1
1,470,470,59,59,0,1,0
11,488,488,2,2,0,1,0
25,498,498,106,80,26,3,2
24,500,500,129,129,0,1,0

47,113,113,10,10,0,1,0
2,119,119,7,7,0,1,0
29,121,121,4,4,0,1,0
10,134,134,22,22,0,1,0
4,134,134,2,2,0,1,0
14,136,136,3,3,0,1,0
27,163,163,1,1,0,1,0
26,170,170,12,6,6,3,2
45,200,200,14,14,0,1,0
0,210,210,18,18,0,1,0
39,222,222,11,11,0,1,0
8,224,224,52,42,10,3,2
17,241,241,10,10,0,1,0
15,252,252,1,1,0,1,0
16,259,259,54,54,0,1,0
3,293,293,3,3,0,1,0
36,302,302,20,20,0,1,0
46,304,304,47,47,0,1,0
9,315,315,5,5,0,1,0
25,316,316,33,24,9,4,3
42,324,324,15,15,0,1,0
23,330,330,1,1,0,1,0
5,336,336,21,12,9,4,3
40,336,336,10,2,8,2,1
30,342,342,30,30,0,1,0
31,351,351,24,20,4,2,1
32,369,369,102,102,0,1,0
19,386,386,46,10,36,4,3
41,387,387,36,16,20,2,1
18,388,388,11,11,0,1,0
11,391,391,13,9,4,2,1
1,394,394,15,6,9,4,3
35,407,407,20,20,0,1,0
44,408,408,33,33,0,1,0
43,413,413,104,53,51,4,3
7,417,417,13,1,12,2,1
28,421,421,10,3,7,2,1
22,428,428,38,38,0,1,0
6,430,430,31,8,23,2,1
13,440,440,16,4,12,4,3
34,452,452,96,74,22,3,2
12,452,452,18,18,0,1,0
21,457,457,19,3,16,2,1
37,458,458,42,42,0,1,0
24,459,459,49,22,27,4,3
33,463,463,47,34,13,2,1
20,472,472,4,4,0,1,0
38,482,482,7,7,0,1,0

11,101,101,19,19,0,1,0
32,120,120,15,4,11,2,1
18,132,132,23,23,0,1,0
5,142,142,13,8,5,2,1
41,146,146,6,6,0,1,0
24,155,155,49,22,27,4,3
20,185,185,17,3,14,3,2
4,192,192,9,9,0,1,0
7,205,205,2,2,0,1,0
19,206,206,16,16,0,1,0
9,207,207,12,12,0,1,0
36,208,208,34,34,0,1,0
25,232,232,6,6,0,1,0
37,235,235,18,13,5,2,1
35,237,237,37,21,16,3,2
10,248,248,3,3,0,1,0
38,250,250,5,5,0,1,0
6,251,251,29,29,0,1,0
21,256,256,8,8,0,1,0
15,266,266,1,1,0,1,0
0,275,275,14,14,0,1,0
23,301,301,30,30,0,1,0
26,303,303,84,84,0,1,0
27,319,319,33,10,23,2,1
31,321,321,3,3,0,1,0
2,324,324,8,5,3,2,1
14,337,337,34,34,0,1,0
22,349,349,2,2,0,1,0
28,361,361,78,53,25,4,3
16,367,367,44,44,0,1,0
39,370,370,11,8,3,2,1
3,385,385,74,74,0,1,0
17,399,399,2,2,0,1,0
12,400,400,31,31,0,1,0
33,418,418,8,8,0,1,0
29,418,418,7,1,6,3,2
8,429,429,14,14,0,1,0
30,452,452,75,44,31,4,3
34,478,478,20,20,0,1,0
13,478,478,38,38,0,1,0
1,478,478,54,10,44,2,1
40,497,497,15,15,0,1,0

16,118,118,11,11,0,1,0
24,120,120,43,43,0,1,0
18,132,132,11,2,9,2,1
11,140,140,2,2,0,1,0
20,148,148,23,9,14,3,2
4,179,179,50,45,5,2,1
9,179,179,14,2,12,2,1
30,182,182,45,45,0,1,0
31,187,187,4,1,3,2,1
8,208,208,34,6,28,3,2
6,229,229,15,15,0,1,0
29,251,251,4,1,3,2,1
15,273,273,12,6,6,2,1
13,279,279,46,46,0,1,0
5,279,279,91,91,0,1,0
19,312,312,30,30,0,1,0
21,314,314,19,19,0,1,0
3,349,349,17,17,0,1,0
27,350,350,45,45,0,1,0
12,357,357,26,26,0,1,0
26,360,360,15,9,6,2,1
0,363,363,48,48,0,1,0
2,373,373,58,31,27,4,3
28,392,392,12,5,7,2,1
10,414,414,38,38,0,1,0
1,434,434,65,65,0,1,0
25,437,437,102,81,21,2,1
22,438,438,16,6,10,2,1
7,464,464,27,27,0,1,0
23,466,466,44,8,36,4,3
14,497,497,24,24,0,1,0
17,497,497,26,15,11,2,1

29,112,112,1,1,0,1,0
30,112,112,4,4,0,1,0
1,117,117,5,5,0,1,0
6,163,163,9,9,0,1,0
21,163,163,14,6,8,3,2
2,169,169,33,21,12,4,3
0,189,189,13,10,3,2,1
9,197,197,12,2,10,3,2
18,206,206,13,8,5,2,1
23,218,218,48,48,0,1,0
26,239,239,29,29,0,1,0
11,254,254,68,25,43,4,3
28,272,272,95,65,30,3,2
31,276,276,9,9,0,1,0
3,294,294,45,45,0,1,0
16,295,295,9,9,0,1,0
33,300,300,13,1,12,3,2
5,343,343,54,54,0,1,0
19,356,356,60,27,33,2,1
7,365,365,27,1,26,2,1
8,366,366,52,21,31,4,3
24,396,396,1,1,0,1,0
22,402,402,41,11,30,2,1
32,406,406,21,5,16,3,2
27,419,419,83,83,0,1,0
10,432,432,68,68,0,1,0
25,452,452,84,66,18,2,1
12,455,455,43,43,0,1,0
20,463,463,35,30,5,2,1
17,471,471,28,10,18,3,2
14,484,484,77,41,36,4,3
13,487,487,27,24,3,2,1
4,492,492,56,29,27,2,1
15,495,495,2,2,0,1,0

27,118,118,13,13,0,1,0
18,161,161,14,14,0,1,0
34,165,165,9,9,0,1,0
22,166,166,16,10,6,2,1
30,170,170,4,4,0,1,0
10,172,172,2,2,0,1,0
19,196,196,32,22,10,2,1
14,198,198,15,9,6,2,1
23,204,204,21,6,15,4,3
36,207,207,26,23,3,2,1
9,224,224,13,1,12,2,1
28,226,226,4,4,0,1,0
6,268,268,4,4,0,1,0
20,269,269,29,29,0,1,0
15,278,278,24,8,16,2,1
4,280,280,21,11,10,3,2
5,314,314,37,7,30,4,3
31,315,315,29,13,16,3,2
17,326,326,79,30,49,2,1
16,333,333,65,15,50,3,2
2,349,349,8,8,0,1,0
29,358,358,9,9,0,1,0
1,379,379,37,23,14,3,2
26,401,401,9,9,0,1,0
33,415,415,8,2,6,2,1
35,420,420,84,52,32,3,2
0,428,428,39,39,0,1,0
24,439,439,7,7,0,1,0
32,446,446,212,212,0,1,0
3,450,450,85,85,0,1,0
12,452,452,51,12,39,4,3
13,465,465,19,19,0,1,0
21,470,470,23,23,0,1,0
7,472,472,107,52,55,4,3
8,480,480,28,28,0,1,0
11,482,482,1,1,0,1,0
25,495,495,65,24,41,4,3

23,117,117,2,2,0,1,0
10,118,118,22,13,9,4,3
3,121,121,1,1,0,1,0
32,134,134,15,15,0,1,0
8,153,153,12,12,0,1,0
13,154,154,1,1,0,1,0
27,158,158,1,1,0,1,0
31,160,160,3,3,0,1,0
26,163,163,15,15,0,1,0
20,169,169,6,6,0,1,0
21,176,176,14,4,10,2,1
29,201,201,21,21,0,1,0
34,206,206,88,58,30,4,3
18,219,219,11,11,0,1,0
14,221,221,79,67,12,4,3
37,232,232,115,115,0,1,0
0,234,234,1,1,0,1,0
22,268,268,4,1,3,2,1
5,284,284,11,6,5,2,1
36,293,293,2,2,0,1,0
30,297,297,8,8,0,1,0
28,316,316,10,6,4,2,1
35,324,324,36,36,0,1,0
2,337,337,17,9,8,2,1
15,341,341,41,41,0,1,0
11,344,344,30,30,0,1,0
17,345,345,4,4,0,1,0
4,358,358,8,8,0,1,0
6,368,368,14,14,0,1,0
7,368,368,14,4,10,2,1
24,389,389,67,62,5,2,1
16,390,390,63,9,54,4,3
33,398,398,12,12,0,1,0
9,448,448,154,113,41,2,1
19,453,453,61,11,50,4,3
1,484,484,12,12,0,1,0
12,489,489,19,19,0,1,0
25,499,499,26,26,0,1,0

11,146,146,24,10,14,2,1
7,177,177,35,35,0,1,0
8,178,178,3,3,0,1,0
22,179,179,30,3,27,4,3
28,181,181,31,31,0,1,0
12,186,186,3,3,0,1,0
29,218,218,13,3,10,2,1
33,219,219,10,4,6,3,2
16,225,225,41,41,0,1,0
14,241,241,4,4,0,1,0
0,252,252,41,41,0,1,0
20,272,272,10,5,5,2,1
15,276,276,36,3,33,4,3
9,276,276,15,3,12,3,2
2,279,279,15,4,11,3,2
17,287,287,9,9,0,1,0
1,306,306,43,17,26,2,1
18,307,307,4,1,3,2,1
19,311,311,4,4,0,1,0
35,315,315,119,87,32,3,2
13,325,325,66,32,34,2,1
24,349,349,53,3,50,3,2
31,351,351,7,7,0,1,0
25,365,365,24,10,14,3,2
34,367,367,15,6,9,2,1
27,428,428,43,43,0,1,0
10,432,432,12,9,3,2,1
30,438,438,83,10,73,4,3
21,441,441,42,32,10,2,1
32,447,447,11,2,9,4,3
36,452,452,46,8,38,2,1
26,452,452,30,6,24,4,3
23,453,453,46,46,0,1,0
3,468,468,17,17,0,1,0
6,483,483,120,1,119,4,3
4,484,484,30,30,0,1,0
5,494,494,22,1,21,4,3

30,103,103,18,18,0,1,0
35,140,140,4,4,0,1,0
6,151,151,11,7,4,2,1
38,154,154,7,7,0,1,0
29,156,156,27,9,18,2,1
23,195,195,8,8,0,1,0
31,206,206,16,7,9,4,3
28,206,206,50,50,0,1,0
17,208,208,14,2,12,3,2
0,209,209,12,3,9,2,1
36,211,211,6,3,3,2,1
5,215,215,9,9,0,1,0
11,219,219,18,12,6,3,2
13,219,219,16,16,0,1,0
14,230,230,6,2,4,2,1
34,246,246,84,72,12,2,1
3,253,253,54,32,22,2,1
21,257,257,38,17,21,2,1
10,259,259,1,1,0,1,0
2,284,284,37,37,0,1,0
16,288,288,16,16,0,1,0
8,289,289,24,4,20,2,1
4,325,325,45,13,32,3,2
9,325,325,34,34,0,1,0
19,332,332,37,37,0,1,0
18,338,338,6,6,0,1,0
27,343,343,37,37,0,1,0
15,352,352,24,24,0,1,0
1,362,362,19,19,0,1,0
20,363,363,4,4,0,1,0
24,366,366,46,7,39,2,1
33,393,393,48,12,36,2,1
7,410,410,93,51,42,3,2
12,427,427,70,20,50,2,1
37,456,456,8,8,0,1,0
22,456,456,10,10,0,1,0
25,461,461,45,45,0,1,0
32,472,472,26,5,21,4,3
26,476,476,1,1,0,1,0

31,114,114,9,9,0,1,0
4,132,132,35,11,24,3,2
19,146,146,6,6,0,1,0
7,147,147,2,2,0,1,0
3,152,152,34,34,0,1,0
23,167,167,8,8,0,1,0
16,180,180,8,4,4,2,1
12,200,200,32,32,0,1,0
6,225,225,4,4,0,1,0
18,257,257,1,1,0,1,0
10,264,264,55,55,0,1,0
24,272,272,59,59,0,1,0
17,279,279,26,2,24,2,1
8,290,290,33,33,0,1,0
9,299,299,75,27,48,4,3
13,307,307,4,1,3,2,1
32,309,309,22,12,10,2,1
30,327,327,94,26,68,3,2
11,334,334,5,5,0,1,0
1,338,338,14,14,0,1,0
26,353,353,42,1,41,2,1
22,361,361,30,4,26,2,1
25,372,372,93,65,28,2,1
0,382,382,35,35,0,1,0
15,385,385,28,16,12,4,3
14,396,396,28,28,0,1,0
27,425,425,23,8,15,2,1
5,427,427,8,5,3,2,1
21,431,431,32,32,0,1,0
2,441,441,99,65,34,3,2
20,446,446,42,42,0,1,0
28,455,455,55,50,5,2,1
29,456,456,40,40,0,1,0
33,475,475,31,8,23,2,1

11,106,106,11,11,0,1,0
5,109,109,24,3,21,4,3
7,121,121,1,1,0,1,0
23,137,137,34,28,6,3,2
32,162,162,6,6,0,1,0
15,186,186,17,13,4,2,1
2,194,194,6,6,0,1,0
21,233,233,3,3,0,1,0
30,234,234,10,2,8,2,1
1,238,238,60,53,7,2,1
29,250,250,65,65,0,1,0
14,263,263,35,17,18,2,1
10,279,279,8,8,0,1,0
16,280,280,17,17,0,1,0
0,308,308,22,11,11,2,1
31,313,313,8,8,0,1,0
20,318,318,20,2,18,2,1
19,322,322,5,2,3,2,1
6,324,324,36,30,6,2,1
17,326,326,68,68,0,1,0
8,332,332,80,80,0,1,0
28,343,343,27,15,12,2,1
22,358,358,1,1,0,1,0
18,361,361,115,53,62,4,3
13,371,371,8,4,4,2,1
12,426,426,53,53,0,1,0
27,437,437,2,2,0,1,0
24,441,441,77,77,0,1,0
9,443,443,78,78,0,1,0
25,453,453,9,4,5,2,1
26,479,479,82,41,41,2,1
4,484,484,7,1,6,3,2
3,494,494,130,82,48,4,3

22,115,115,3,3,0,1,0
30,120,120,4,1,3,2,1
19,128,128,4,4,0,1,0
23,133,133,3,3,0,1,0
15,136,136,21,21,0,1,0
31,146,146,21,21,0,1,0
28,172,172,18,18,0,1,0
24,192,192,5,1,4,2,1
32,197,197,28,28,0,1,0
37,202,202,35,35,0,1,0
6,206,206,19,1,18,3,2
21,252,252,19,8,11,2,1
16,256,256,10,10,0,1,0
29,259,259,22,22,0,1,0
20,269,269,1,1,0,1,0
12,310,310,93,57,36,4,3
17,320,320,23,23,0,1,0
0,329,329,20,10,10,3,2
11,334,334,11,11,0,1,0
10,343,343,40,16,24,4,3
36,366,366,44,23,21,4,3
8,396,396,19,5,14,2,1
13,401,401,56,56,0,1,0
5,412,412,64,64,0,1,0
34,431,431,51,51,0,1,0
33,431,431,151,94,57,4,3
3,443,443,1,1,0,1,0
9,457,457,55,55,0,1,0
35,461,461,63,18,45,2,1
14,462,462,109,60,49,4,3
18,467,467,25,2,23,4,3
26,469,469,25,25,0,1,0
25,473,473,83,83,0,1,0
4,480,480,5,5,0,1,0
7,484,484,5,2,3,2,1
1,484,484,20,5,15,4,3
27,490,490,23,23,0,1,0
2,492,492,43,28,15,2,1

3,124,124,1,1,0,1,0
37,127,127,23,6,17,4,3
4,146,146,1,1,0,1,0
27,148,148,8,4,4,2,1
10,161,161,14,7,7,2,1
22,163,163,1,1,0,1,0
13,178,178,31,31,0,1,0
35,188,188,10,10,0,1,0
1,190,190,2,2,0,1,0
24,193,193,24,9,15,4,3
33,199,199,6,6,0,1,0
32,200,200,10,7,3,2,1
34,218,218,2,2,0,1,0
5,248,248,20,20,0,1,0
12,253,253,39,39,0,1,0
20,265,265,109,19,90,4,3
29,270,270,41,21,20,2,1
16,273,273,22,10,12,3,2
25,276,276,5,5,0,1,0
36,277,277,5,2,3,2,1
18,277,277,8,5,3,2,1
19,284,284,36,36,0,1,0
30,292,292,9,4,5,2,1
2,304,304,6,6,0,1,0
8,315,315,16,2,14,2,1
21,320,320,60,60,0,1,0
17,326,326,36,15,21,2,1
7,354,354,72,72,0,1,0
0,363,363,21,21,0,1,0
15,365,365,31,31,0,1,0
31,370,370,52,52,0,1,0
14,376,376,97,97,0,1,0
9,381,381,6,6,0,1,0
26,383,383,24,8,16,2,1
11,391,391,73,73,0,1,0
28,397,397,45,45,0,1,0
6,437,437,25,25,0,1,0
23,484,484,95,83,12,4,3

20,101,101,3,3,0,1,0
32,103,103,7,7,0,1,0
23,103,103,19,19,0,1,0
18,115,115,6,6,0,1,0
6,119,119,9,9,0,1,0
36,128,128,4,4,0,1,0
8,136,136,5,5,0,1,0
24,144,144,15,15,0,1,0
29,157,157,2,2,0,1,0
30,164,164,4,4,0,1,0
10,165,165,29,19,10,3,2
12,174,174,35,35,0,1,0
14,188,188,27,9,18,4,3
26,210,210,11,11,0,1,0
1,220,220,6,6,0,1,0
4,221,221,11,4,7,2,1
21,232,232,16,16,0,1,0
27,258,258,49,49,0,1,0
0,262,262,12,12,0,1,0
31,263,263,18,6,12,4,3
22,287,287,70,4,66,3,2
7,292,292,33,33,0,1,0
28,320,320,10,10,0,1,0
13,324,324,36,26,10,2,1
11,331,331,72,72,0,1,0
9,354,354,9,9,0,1,0
33,361,361,83,3,80,3,2
34,363,363,166,166,0,1,0
2,393,393,23,23,0,1,0
19,398,398,1,1,0,1,0
35,410,410,10,1,9,4,3
15,457,457,57,57,0,1,0
16,465,465,52,52,0,1,0
25,474,474,9,9,0,1,0
17,475,475,50,27,23,2,1
5,481,481,63,63,0,1,0
3,494,494,1,1,0,1,0

18,120,120,7,7,0,1,0
35,131,131,4,4,0,1,0
29,133,133,26,8,18,4,3
13,164,164,31,25,6,2,1
14,170,170,8,8,0,1,0
0,194,194,12,12,0,1,0
5,197,197,33,33,0,1,0
25,202,202,17,17,0,1,0
1,211,211,68,21,47,2,1
12,218,218,34,19,15,4,3
27,221,221,38,38,0,1,0
9,225,225,22,15,7,2,1
17,238,238,1,1,0,1,0
31,257,257,10,2,8,3,2
30,266,266,27,27,0,1,0
7,269,269,19,19,0,1,0
11,277,277,49,1,48,4,3
20,309,309,15,15,0,1,0
6,327,327,13,3,10,2,1
10,330,330,27,6,21,4,3
24,336,336,21,21,0,1,0
28,349,349,51,51,0,1,0
26,364,364,9,1,8,3,2
8,389,389,22,22,0,1,0
4,394,394,53,53,0,1,0
34,408,408,60,60,0,1,0
15,415,415,67,20,47,3,2
16,417,417,6,3,3,2,1
32,423,423,35,19,16,3,2
33,430,430,16,5,11,2,1
21,449,449,86,17,69,4,3
2,458,458,9,9,0,1,0
19,467,467,75,31,44,3,2
22,481,481,36,36,0,1,0
3,486,486,1,1,0,1,0
23,487,487,89,44,45,4,3

7,102,102,22,22,0,1,0
13,104,104,5,5,0,1,0
20,104,104,5,1,4,2,1
23,105,105,26,6,20,2,1
8,120,120,2,2,0,1,0
34,131,131,10,7,3,2,1
24,157,157,17,12,5,2,1
5,163,163,4,4,0,1,0
2,166,166,61,52,9,4,3
31,166,166,21,8,13,2,1
4,196,196,10,10,0,1,0
15,206,206,46,18,28,2,1
35,217,217,44,44,0,1,0
27,221,221,50,9,41,4,3
22,275,275,6,2,4,2,1
21,282,282,27,27,0,1,0
3,329,329,20,20,0,1,0
32,332,332,1,1,0,1,0
10,338,338,15,15,0,1,0
14,344,344,55,55,0,1,0
18,347,347,46,17,29,4,3
6,356,356,17,17,0,1,0
11,376,376,3,3,0,1,0
29,382,382,65,58,7,2,1
12,400,400,39,39,0,1,0
33,424,424,7,7,0,1,0
17,437,437,70,70,0,1,0
19,443,443,60,24,36,4,3
26,446,446,102,70,32,3,2
1,447,447,35,35,0,1,0
25,462,462,6,1,5,2,1
30,462,462,5,5,0,1,0
0,462,462,24,24,0,1,0
36,470,470,15,15,0,1,0
28,472,472,37,37,0,1,0
16,480,480,1,1,0,1,0
9,486,486,5,5,0,1,0

6,121,121,8,2,6,2,1
29,133,133,1,1,0,1,0
22,161,161,17,7,10,2,1
8,172,172,1,1,0,1,0
21,180,180,28,16,12,3,2
5,182,182,12,12,0,1,0
0,213,213,12,12,0,1,0
15,214,214,18,18,0,1,0
31,221,221,42,38,4,2,1
13,225,225,15,9,6,3,2
23,226,226,37,37,0,1,0
3,233,233,21,1,20,2,1
2,238,238,71,56,15,4,3
30,246,246,82,82,0,1,0
9,254,254,5,5,0,1,0
17,322,322,26,26,0,1,0
10,322,322,69,69,0,1,0
19,336,336,10,10,0,1,0
28,342,342,10,10,0,1,0
1,349,349,2,2,0,1,0
25,361,361,14,14,0,1,0
33,366,366,38,38,0,1,0
16,366,366,4,4,0,1,0
7,394,394,64,64,0,1,0
24,401,401,39,39,0,1,0
27,401,401,15,6,9,4,3
14,404,404,244,148,96,4,3
4,423,423,6,2,4,2,1
18,433,433,105,105,0,1,0
20,450,450,39,39,0,1,0
12,456,456,4,4,0,1,0
11,477,477,20,20,0,1,0
26,491,491,31,31,0,1,0
32,495,495,24,8,16,3,2

13,105,105,25,25,0,1,0
26,106,106,11,7,4,2,1
12,107,107,3,3,0,1,0
27,125,125,2,2,0,1,0
23,128,128,42,42,0,1,0
17,150,150,15,15,0,1,0
18,179,179,19,19,0,1,0
8,189,189,7,7,0,1,0
25,210,210,26,16,10,3,2
1,237,237,35,21,14,2,1
20,263,263,13,1,12,3,2
19,267,267,22,13,9,4,3
21,290,290,39,15,24,4,3
5,310,310,18,12,6,2,1
14,321,321,45,6,39,2,1
24,332,332,13,1,12,4,3
11,337,337,11,11,0,1,0
22,337,337,54,54,0,1,0
15,350,350,11,1,10,2,1
16,356,356,17,17,0,1,0
31,365,365,29,5,24,2,1
29,369,369,15,15,0,1,0
3,370,370,46,46,0,1,0
9,382,382,188,110,78,4,3
0,382,382,54,9,45,3,2
6,410,410,31,13,18,2,1
28,422,422,105,15,90,3,2
2,426,426,7,7,0,1,0
7,466,466,5,2,3,2,1
30,474,474,5,5,0,1,0
10,477,477,81,33,48,3,2
4,500,500,115,83,32,4,3

17,106,106,14,14,0,1,0
9,129,129,12,12,0,1,0
20,135,135,8,8,0,1,0
19,139,139,11,6,5,2,1
30,169,169,23,7,16,2,1
3,174,174,11,11,0,1,0
18,178,178,5,5,0,1,0
36,178,178,5,1,4,2,1
35,201,201,3,3,0,1,0
33,202,202,32,32,0,1,0
14,214,214,15,15,0,1,0
13,219,219,9,9,0,1,0
6,224,224,3,3,0,1,0
7,226,226,1,1,0,1,0
37,227,227,3,3,0,1,0
38,231,231,31,31,0,1,0
11,241,241,27,27,0,1,0
12,248,248,2,2,0,1,0
8,255,255,87,87,0,1,0
27,260,260,27,1,26,3,2
15,261,261,90,5,85,4,3
1,270,270,47,13,34,3,2
28,298,298,5,5,0,1,0
29,300,300,2,2,0,1,0
0,308,308,4,4,0,1,0
2,309,309,10,10,0,1,0
22,316,316,38,29,9,4,3
10,318,318,24,8,16,3,2
23,339,339,78,10,68,4,3
16,344,344,2,2,0,1,0
32,347,347,36,36,0,1,0
25,361,361,47,19,28,2,1
39,378,378,20,8,12,2,1
34,381,381,46,13,33,4,3
5,385,385,13,8,5,2,1
4,430,430,18,8,10,3,2
21,449,449,16,6,10,3,2
26,467,467,173,173,0,1,0
31,481,481,33,21,12,2,1
24,488,488,7,1,6,2,1

4,107,107,11,5,6,3,2
3,112,112,3,3,0,1,0
7,123,123,7,7,0,1,0
15,124,124,7,7,0,1,0
36,139,139,9,6,3,2,1
37,151,151,11,1,10,2,1
0,155,155,32,24,8,2,1
34,160,160,3,3,0,1,0
22,177,177,13,13,0,1,0
32,193,193,18,9,9,4,3
26,202,202,48,38,10,3,2
6,215,215,41,5,36,3,2
25,236,236,6,6,0,1,0
8,239,239,12,12,0,1,0
21,251,251,13,10,3,2,1
38,255,255,33,21,12,4,3
9,257,257,3,3,0,1,0
33,281,281,4,4,0,1,0
31,297,297,5,5,0,1,0
12,301,301,24,10,14,2,1
10,320,320,43,13,30,2,1
1,329,329,1,1,0,1,0
16,329,329,2,2,0,1,0
27,341,341,27,27,0,1,0
2,344,344,5,5,0,1,0
35,346,346,31,28,3,2,1
24,357,357,46,16,30,2,1
14,358,358,85,61,24,4,3
13,362,362,22,22,0,1,0
5,393,393,1,1,0,1,0
29,419,419,124,80,44,4,3
20,425,425,19,19,0,1,0
11,428,428,15,6,9,2,1
23,461,461,14,5,9,2,1
30,464,464,83,57,26,2,1
19,464,464,160,41,119,4,3
18,479,479,21,12,9,4,3
17,485,485,45,23,22,2,1
28,497,497,116,68,48,3,2

33,126,126,14,14,0,1,0
29,157,157,15,6,9,4,3
13,157,157,28,20,8,2,1
17,161,161,1,1,0,1,0
4,175,175,2,2,0,1,0
20,178,178,4,4,0,1,0
23,195,195,30,7,23,2,1
35,198,198,22,22,0,1,0
10,208,208,29,29,0,1,0
14,241,241,4,4,0,1,0
1,243,243,36,30,6,2,1
2,248,248,26,6,20,2,1
28,248,248,41,41,0,1,0
9,275,275,9,1,8,3,2
27,277,277,43,5,38,3,2
8,292,292,99,24,75,4,3
16,313,313,17,17,0,1,0
32,366,366,19,19,0,1,0
30,368,368,71,53,18,2,1
22,375,375,22,12,10,3,2
37,387,387,73,73,0,1,0
21,393,393,38,16,22,3,2
34,396,396,49,49,0,1,0
7,418,418,88,55,33,3,2
15,419,419,37,37,0,1,0
26,422,422,4,4,0,1,0
0,427,427,21,21,0,1,0
19,430,430,59,23,36,3,2
5,434,434,2,2,0,1,0
25,445,445,45,12,33,4,3
11,458,458,46,4,42,2,1
3,471,471,15,1,14,2,1
24,472,472,17,17,0,1,0
31,477,477,46,15,31,2,1
6,487,487,7,7,0,1,0
12,490,490,60,60,0,1,0
36,495,495,28,28,0,1,0
18,498,498,5,5,0,1,0

2,103,103,3,3,0,1,0
22,113,113,13,13,0,1,0
10,126,126,16,16,0,1,0
4,127,127,13,13,0,1,0
5,133,133,28,28,0,1,0
30,139,139,8,8,0,1,0
19,153,153,11,2,9,2,1
36,158,158,17,17,0,1,0
35,163,163,2,2,0,1,0
17,165,165,2,2,0,1,0
13,199,199,42,42,0,1,0
34,202,202,46,46,0,1,0
18,218,218,26,26,0,1,0
20,218,218,10,1,9,2,1
6,220,220,4,4,0,1,0
11,233,233,18,18,0,1,0
15,240,240,1,1,0,1,0
29,243,243,48,16,32,3,2
24,245,245,56,38,18,2,1
33,259,259,25,25,0,1,0
3,272,272,6,6,0,1,0
16,291,291,17,17,0,1,0
14,300,300,25,25,0,1,0
32,312,312,5,5,0,1,0
9,332,332,40,40,0,1,0
12,334,334,23,15,8,2,1
7,338,338,50,11,39,4,3
1,345,345,96,96,0,1,0
31,365,365,12,6,6,2,1
25,378,378,127,35,92,4,3
21,395,395,19,19,0,1,0
23,401,401,73,6,67,4,3
8,404,404,7,7,0,1,0
26,469,469,14,14,0,1,0
28,481,481,12,9,3,2,1
27,488,488,3,3,0,1,0
0,488,488,46,23,23,4,3

20,109,109,3,3,0,1,0
14,117,117,4,1,3,2,1
11,122,122,34,4,30,3,2
22,124,124,1,1,0,1,0
6,124,124,1,1,0,1,0
28,125,125,31,9,22,2,1
7,125,125,31,1,30,2,1
13,136,136,15,1,14,3,2
9,149,149,6,3,3,2,1
33,153,153,32,32,0,1,0
1,199,199,32,32,0,1,0
19,212,212,11,11,0,1,0
27,243,243,1,1,0,1,0
2,246,246,18,8,10,2,1
0,247,247,50,9,41,3,2
8,265,265,3,3,0,1,0
15,268,268,13,13,0,1,0
26,280,280,7,1,6,3,2
29,283,283,18,10,8,2,1
34,293,293,24,16,8,3,2
23,327,327,77,70,7,2,1
32,339,339,2,2,0,1,0
30,350,350,52,52,0,1,0
24,378,378,42,18,24,4,3
4,384,384,13,13,0,1,0
25,391,391,138,114,24,4,3
17,407,407,9,5,4,2,1
21,410,410,8,2,6,3,2
31,417,417,89,89,0,1,0
10,435,435,10,10,0,1,0
5,437,437,15,15,0,1,0
16,458,458,50,29,21,4,3
36,475,475,12,3,9,4,3
18,476,476,93,93,0,1,0
35,480,480,1,1,0,1,0
3,481,481,52,15,37,2,1
12,486,486,29,29,0,1,0

13,108,108,33,33,0,1,0
29,108,108,13,4,9,2,1
15,114,114,5,5,0,1,0
21,125,125,5,1,4,2,1
26,136,136,18,2,16,3,2
6,145,145,41,41,0,1,0
19,146,146,3,3,0,1,0
9,147,147,54,45,9,4,3
28,153,153,2,2,0,1,0
25,162,162,4,4,0,1,0
24,182,182,37,17,20,2,1
7,212,212,24,6,18,2,1
27,215,215,96,96,0,1,0
18,219,219,32,10,22,2,1
10,255,255,22,22,0,1,0
0,255,255,31,5,26,3,2
4,256,256,59,59,0,1,0
20,256,256,2,2,0,1,0
3,261,261,10,1,9,4,3
5,298,298,20,6,14,4,3
22,313,313,6,2,4,2,1
11,339,339,11,3,8,3,2
16,383,383,16,4,12,4,3
30,391,391,60,60,0,1,0
17,399,399,13,13,0,1,0
8,416,416,57,50,7,2,1
1,476,476,16,16,0,1,0
12,479,479,54,54,0,1,0
2,493,493,88,88,0,1,0
14,495,495,30,30,0,1,0
23,500,500,16,16,0,1,0

23,108,108,1,1,0,1,0
4,129,129,6,6,0,1,0
28,139,139,24,6,18,2,1
20,139,139,18,7,11,2,1
12,141,141,18,18,0,1,0
31,160,160,3,3,0,1,0
25,175,175,4,4,0,1,0
38,207,207,38,38,0,1,0
7,212,212,30,23,7,2,1
34,266,266,11,11,0,1,0
24,280,280,70,48,22,4,3
29,282,282,11,3,8,3,2
30,310,310,11,11,0,1,0
3,314,314,12,12,0,1,0
17,320,320,62,59,3,2,1
32,323,323,97,77,20,3,2
9,323,323,31,31,0,1,0
10,325,325,30,2,28,4,3
21,329,329,11,11,0,1,0
22,330,330,12,1,11,2,1
2,333,333,5,5,0,1,0
27,343,343,40,40,0,1,0
1,348,348,36,36,0,1,0
14,356,356,2,2,0,1,0
15,381,381,61,31,30,3,2
26,399,399,64,64,0,1,0
6,399,399,7,7,0,1,0
36,431,431,82,44,38,2,1
33,431,431,43,43,0,1,0
35,433,433,22,10,12,4,3
5,437,437,17,11,6,3,2
19,438,438,67,1,66,3,2
16,445,445,74,32,42,3,2
11,449,449,13,13,0,1,0
0,454,454,11,11,0,1,0
8,454,454,1,1,0,1,0
18,461,461,39,39,0,1,0
37,485,485,37,37,0,1,0
13,498,498,70,23,47,4,3

2,109,109,27,27,0,1,0
23,110,110,23,23,0,1,0
3,112,112,31,31,0,1,0
21,126,126,11,11,0,1,0
13,135,135,3,3,0,1,0
0,159,159,2,2,0,1,0
22,170,170,25,25,0,1,0
9,182,182,5,5,0,1,0
18,184,184,22,22,0,1,0
12,210,210,5,5,0,1,0
4,229,229,6,6,0,1,0
8,241,241,15,12,3,2,1
16,241,241,32,32,0,1,0
15,250,250,15,15,0,1,0
24,257,257,8,2,6,2,1
7,262,262,44,31,13,2,1
1,287,287,137,41,96,4,3
11,300,300,42,42,0,1,0
20,311,311,9,9,0,1,0
19,339,339,25,10,15,4,3
10,374,374,50,50,0,1,0
5,380,380,189,119,70,3,2
27,389,389,11,11,0,1,0
17,447,447,21,21,0,1,0
25,448,448,192,74,118,4,3
26,448,448,21,21,0,1,0
6,481,481,3,3,0,1,0
14,484,484,39,11,28,2,1

20,110,110,13,4,9,4,3
35,112,112,16,16,0,1,0
9,114,114,4,4,0,1,0
13,117,117,10,4,6,2,1
22,133,133,41,11,30,2,1
26,142,142,9,4,5,2,1
34,144,144,33,33,0,1,0
27,159,159,13,13,0,1,0
37,173,173,23,23,0,1,0
16,175,175,2,2,0,1,0
8,182,182,8,8,0,1,0
0,191,191,9,9,0,1,0
1,193,193,68,47,21,4,3
24,203,203,14,14,0,1,0
14,206,206,5,2,3,2,1
23,209,209,2,2,0,1,0
25,223,223,11,11,0,1,0
18,234,234,23,23,0,1,0
6,248,248,1,1,0,1,0
11,257,257,60,16,44,2,1
36,271,271,28,23,5,2,1
4,276,276,3,3,0,1,0
10,292,292,41,41,0,1,0
3,293,293,5,5,0,1,0
5,299,299,12,3,9,2,1
28,300,300,18,6,12,3,2
33,318,318,67,5,62,3,2
29,330,330,22,5,17,2,1
32,341,341,11,11,0,1,0
17,356,356,13,4,9,2,1
19,377,377,1,1,0,1,0
21,379,379,25,1,24,4,3
12,388,388,45,45,0,1,0
30,419,419,77,18,59,3,2
2,442,442,60,14,46,2,1
38,462,462,1,1,0,1,0
15,462,462,100,100,0,1,0
7,476,476,15,15,0,1,0
31,478,478,15,15,0,1,0

31,101,101,21,21,0,1,0
19,108,108,16,11,5,2,1
13,111,111,3,3,0,1,0
38,113,113,4,4,0,1,0
1,137,137,1,1,0,1,0
33,146,146,10,10,0,1,0
32,161,161,24,24,0,1,0
20,172,172,5,5,0,1,0
29,193,193,18,18,0,1,0
4,201,201,52,41,11,2,1
36,201,201,6,1,5,2,1
28,228,228,36,14,22,3,2
25,235,235,11,11,0,1,0
14,239,239,23,23,0,1,0
23,255,255,46,14,32,3,2
15,277,277,40,40,0,1,0
41,307,307,32,10,22,4,3
9,309,309,18,5,13,2,1
11,310,310,53,10,43,3,2
3,310,310,7,2,5,2,1
16,321,321,3,3,0,1,0
22,340,340,28,28,0,1,0
7,341,341,28,28,0,1,0
24,370,370,36,17,19,2,1
27,374,374,75,75,0,1,0
18,375,375,7,7,0,1,0
12,378,378,13,13,0,1,0
17,388,388,13,13,0,1,0
5,392,392,2,2,0,1,0
34,400,400,14,14,0,1,0
2,408,408,6,6,0,1,0
8,408,408,13,13,0,1,0
30,417,417,44,11,33,2,1
21,443,443,121,40,81,4,3
26,447,447,77,17,60,3,2
35,451,451,39,39,0,1,0
0,454,454,3,3,0,1,0
6,459,459,1,1,0,1,0
40,475,475,30,30,0,1,0
10,479,479,32,32,0,1,0
37,487,487,93,33,60,3,2
39,500,500,1,1,0,1,0

18,119,119,22,22,0,1,0
17,124,124,10,10,0,1,0
4,149,149,127,19,108,4,3
23,150,150,8,5,3,2,1
0,181,181,29,1,28,3,2
8,192,192,18,18,0,1,0
13,209,209,52,52,0,1,0
19,215,215,22,10,12,4,3
28,222,222,7,7,0,1,0
11,238,238,28,28,0,1,0
21,255,255,3,3,0,1,0
1,256,256,20,17,3,2,1
29,264,264,17,17,0,1,0
24,272,272,13,13,0,1,0
16,272,272,55,55,0,1,0
12,285,285,56,33,23,2,1
2,290,290,1,1,0,1,0
22,294,294,12,12,0,1,0
30,295,295,9,9,0,1,0
5,327,327,4,4,0,1,0
3,329,329,2,2,0,1,0
14,353,353,61,61,0,1,0
15,376,376,15,15,0,1,0
20,384,384,48,48,0,1,0
9,414,414,18,18,0,1,0
6,415,415,56,56,0,1,0
27,440,440,107,24,83,4,3
7,485,485,49,49,0,1,0
26,488,488,69,27,42,3,2
25,493,493,5,5,0,1,0
10,497,497,1,1,0,1,0

0,108,108,26,6,20,3,2
20,124,124,3,3,0,1,0
26,126,126,18,18,0,1,0
5,163,163,50,3,47,2,1
13,176,176,9,1,8,3,2
23,177,177,33,33,0,1,0
29,189,189,11,11,0,1,0
2,204,204,1,1,0,1,0
17,220,220,60,17,43,3,2
27,230,230,24,24,0,1,0
9,260,260,18,18,0,1,0
16,305,305,9,9,0,1,0
12,314,314,7,7,0,1,0
10,315,315,140,38,102,4,3
4,322,322,1,1,0,1,0
21,324,324,43,43,0,1,0
6,331,331,78,78,0,1,0
19,335,335,19,19,0,1,0
11,364,364,24,24,0,1,0
24,368,368,123,80,43,2,1
14,393,393,1,1,0,1,0
8,409,409,17,17,0,1,0
18,419,419,12,7,5,2,1
22,428,428,56,34,22,2,1
3,440,440,117,117,0,1,0
1,453,453,12,7,5,2,1
7,465,465,45,45,0,1,0
28,468,468,51,51,0,1,0
25,485,485,35,35,0,1,0
15,500,500,41,41,0,1,0

51,123,123,5,1,4,2,1
18,137,137,1,1,0,1,0
4,152,152,2,2,0,1,0
19,152,152,10,4,6,2,1
30,153,153,1,1,0,1,0
22,154,154,2,2,0,1,0
43,155,155,34,3,31,3,2
9,157,157,7,7,0,1,0
7,157,157,8,8,0,1,0
20,161,161,1,1,0,1,0
5,167,167,13,13,0,1,0
21,167,167,7,7,0,1,0
44,196,196,66,54,12,3,2
32,204,204,3,3,0,1,0
8,204,204,15,12,3,2,1
46,215,215,26,26,0,1,0
34,221,221,5,5,0,1,0
14,229,229,6,6,0,1,0
26,230,230,4,1,3,2,1
40,232,232,24,8,16,4,3
11,234,234,12,2,10,2,1
10,243,243,28,28,0,1,0
38,270,270,37,37,0,1,0
47,282,282,41,41,0,1,0
0,285,285,7,7,0,1,0
13,288,288,5,2,3,2,1
23,293,293,1,1,0,1,0
52,307,307,22,22,0,1,0
31,308,308,16,16,0,1,0
24,308,308,44,6,38,2,1
12,321,321,50,50,0,1,0
6,344,344,29,29,0,1,0
29,350,350,19,13,6,2,1
49,352,352,26,26,0,1,0
48,353,353,16,4,12,3,2
25,355,355,4,4,0,1,0
39,355,355,28,1,27,4,3
42,368,368,36,36,0,1,0
16,371,371,3,3,0,1,0
45,371,371,8,8,0,1,0
28,392,392,1,1,0,1,0
37,411,411,4,1,3,2,1
1,421,421,59,59,0,1,0
41,423,423,34,34,0,1,0
17,444,444,3,3,0,1,0
36,448,448,72,54,18,4,3
33,451,451,48,18,30,3,2
35,467,467,26,6,20,3,2
3,470,470,2,2,0,1,0
15,471,471,64,28,36,3,2
27,474,474,3,3,0,1,0
50,480,480,17,17,0,1,0
2,481,481,95,55,40,3,2

22,115,115,5,2,3,2,1
13,123,123,6,6,0,1,0
0,123,123,29,29,0,1,0
23,127,127,1,1,0,1,0
18,129,129,28,28,0,1,0
7,158,158,23,15,8,3,2
25,161,161,1,1,0,1,0
32,169,169,3,3,0,1,0
1,184,184,4,4,0,1,0
21,188,188,19,19,0,1,0
2,188,188,8,8,0,1,0
28,193,193,9,1,8,2,1
19,215,215,70,62,8,3,2
31,238,238,92,43,49,4,3
12,238,238,39,31,8,2,1
4,257,257,39,39,0,1,0
14,265,265,18,2,16,3,2
3,286,286,19,19,0,1,0
9,302,302,84,63,21,4,3
24,329,329,36,24,12,3,2
6,330,330,36,36,0,1,0
33,349,349,22,22,0,1,0
5,353,353,4,4,0,1,0
15,363,363,86,65,21,2,1
8,368,368,43,43,0,1,0
16,380,380,8,8,0,1,0
26,409,409,40,17,23,2,1
11,443,443,7,1,6,3,2
20,466,466,14,10,4,2,1
17,467,467,36,28,8,3,2
29,469,469,33,33,0,1,0
27,489,489,61,61,0,1,0
10,497,497,44,44,0,1,0
30,499,499,46,41,5,2,1

32,108,108,30,16,14,3,2
26,119,119,16,10,6,2,1
15,120,120,9,9,0,1,0
30,127,127,10,10,0,1,0
19,130,130,9,9,0,1,0
5,167,167,4,4,0,1,0
21,175,175,9,3,6,3,2
2,195,195,18,18,0,1,0
1,196,196,20,20,0,1,0
27,200,200,35,25,10,2,1
9,216,216,21,21,0,1,0
25,222,222,46,16,30,4,3
12,235,235,6,6,0,1,0
34,238,238,10,1,9,2,1
13,245,245,24,24,0,1,0
23,251,251,15,15,0,1,0
16,256,256,91,21,70,3,2
4,272,272,22,22,0,1,0
22,273,273,6,1,5,2,1
3,279,279,18,2,16,3,2
18,284,284,17,3,14,4,3
0,285,285,43,43,0,1,0
20,294,294,10,1,9,3,2
8,295,295,1,1,0,1,0
33,349,349,11,5,6,3,2
31,353,353,20,5,15,4,3
10,360,360,12,12,0,1,0
17,366,366,6,6,0,1,0
29,378,378,45,45,0,1,0
28,419,419,160,121,39,2,1
11,430,430,1,1,0,1,0
7,430,430,78,64,14,3,2
6,433,433,14,14,0,1,0
35,449,449,28,28,0,1,0
36,470,470,21,21,0,1,0
24,476,476,2,2,0,1,0
14,483,483,149,144,5,2,1

37,109,109,11,4,7,2,1
8,135,135,2,2,0,1,0
34,140,140,10,10,0,1,0
0,141,141,19,9,10,2,1
21,147,147,4,4,0,1,0
15,156,156,3,3,0,1,0
25,168,168,10,10,0,1,0
10,176,176,42,42,0,1,0
24,177,177,21,21,0,1,0
38,177,177,8,2,6,2,1
22,187,187,1,1,0,1,0
28,188,188,5,5,0,1,0
11,196,196,18,1,17,4,3
27,201,201,18,18,0,1,0
23,202,202,6,6,0,1,0
14,227,227,12,3,9,4,3
29,236,236,14,10,4,2,1
36,241,241,21,21,0,1,0
30,251,251,29,29,0,1,0
7,262,262,1,1,0,1,0
40,269,269,13,4,9,4,3
12,270,270,10,10,0,1,0
33,272,272,4,4,0,1,0
2,274,274,52,52,0,1,0
20,283,283,30,30,0,1,0
31,298,298,47,1,46,2,1
9,310,310,4,4,0,1,0
41,312,312,69,69,0,1,0
18,317,317,33,1,32,3,2
35,328,328,34,11,23,2,1
1,330,330,35,35,0,1,0
13,331,331,16,5,11,4,3
39,334,334,82,82,0,1,0
26,359,359,34,34,0,1,0
17,359,359,53,53,0,1,0
19,409,409,40,30,10,2,1
4,411,411,15,15,0,1,0
3,433,433,43,43,0,1,0
16,460,460,1,1,0,1,0
6,462,462,86,10,76,3,2
32,465,465,84,24,60,4,3
5,481,481,4,4,0,1,0

30,110,110,2,2,0,1,0
8,116,116,14,2,12,2,1
20,120,120,7,7,0,1,0
27,131,131,41,15,26,3,2
6,132,132,16,5,11,2,1
2,145,145,30,7,23,2,1
19,150,150,22,22,0,1,0
3,151,151,1,1,0,1,0
23,165,165,2,2,0,1,0
26,198,198,33,33,0,1,0
14,215,215,11,11,0,1,0
32,221,221,7,7,0,1,0
31,243,243,84,45,39,2,1
24,275,275,9,3,6,3,2
9,280,280,4,4,0,1,0
28,305,305,34,34,0,1,0
25,315,315,5,5,0,1,0
22,319,319,22,8,14,3,2
21,339,339,54,54,0,1,0
33,343,343,28,28,0,1,0
11,364,364,50,16,34,2,1
16,369,369,26,26,0,1,0
12,371,371,46,36,10,3,2
5,374,374,46,34,12,4,3
1,395,395,22,22,0,1,0
7,398,398,6,6,0,1,0
10,426,426,186,119,67,3,2
18,437,437,83,5,78,3,2
13,441,441,59,59,0,1,0
4,444,444,37,23,14,2,1
17,459,459,1,1,0,1,0
29,473,473,8,8,0,1,0
15,490,490,41,41,0,1,0
0,498,498,44,32,12,4,3

30,101,101,3,3,0,1,0
6,108,108,3,3,0,1,0
26,111,111,1,1,0,1,0
39,121,121,8,8,0,1,0
19,138,138,6,3,3,2,1
7,148,148,22,1,21,2,1
41,148,148,7,4,3,2,1
35,155,155,19,4,15,4,3
14,159,159,10,5,5,2,1
31,164,164,10,2,8,3,2
4,180,180,18,18,0,1,0
11,186,186,1,1,0,1,0
29,191,191,77,77,0,1,0
18,197,197,21,21,0,1,0
33,209,209,14,14,0,1,0
22,227,227,13,13,0,1,0
2,242,242,34,34,0,1,0
34,254,254,17,17,0,1,0
15,254,254,3,3,0,1,0
40,255,255,16,2,14,3,2
10,269,269,6,2,4,2,1
12,292,292,5,5,0,1,0
28,292,292,106,13,93,4,3
1,296,296,3,3,0,1,0
17,303,303,14,3,11,2,1
32,309,309,19,19,0,1,0
16,365,365,17,17,0,1,0
0,369,369,4,4,0,1,0
3,374,374,19,1,18,2,1
27,383,383,42,42,0,1,0
42,384,384,10,2,8,3,2
25,389,389,30,17,13,2,1
23,398,398,137,23,114,4,3
8,405,405,4,4,0,1,0
5,419,419,73,73,0,1,0
13,430,430,47,47,0,1,0
38,432,432,85,85,0,1,0
24,434,434,10,6,4,2,1
20,442,442,22,8,14,2,1
37,448,448,3,3,0,1,0
21,485,485,80,35,45,4,3
36,489,489,30,2,28,3,2
9,499,499,9,6,3,2,1

28,128,128,5,5,0,1,0
9,135,135,14,14,0,1,0
5,143,143,29,29,0,1,0
2,148,148,1,1,0,1,0
4,149,149,12,12,0,1,0
16,151,151,19,9,10,3,2
41,152,152,18,7,11,4,3
11,157,157,2,2,0,1,0
23,165,165,3,3,0,1,0
34,172,172,16,16,0,1,0
20,175,175,1,1,0,1,0
32,178,178,7,1,6,2,1
24,183,183,19,19,0,1,0
25,194,194,11,11,0,1,0
1,201,201,21,3,18,4,3
10,209,209,6,6,0,1,0
26,210,210,6,3,3,2,1
38,213,213,19,12,7,2,1
14,216,216,33,6,27,2,1
33,229,229,69,69,0,1,0
12,254,254,18,18,0,1,0
37,268,268,73,49,24,3,2
30,269,269,17,8,9,4,3
21,270,270,20,12,8,2,1
19,282,282,5,5,0,1,0
35,294,294,41,23,18,2,1
31,301,301,16,16,0,1,0
17,303,303,28,28,0,1,0
29,309,309,3,3,0,1,0
18,339,339,9,9,0,1,0
8,343,343,24,24,0,1,0
7,344,344,41,41,0,1,0
13,367,367,34,4,30,4,3
40,389,389,6,2,4,2,1
22,430,430,57,8,49,2,1
6,439,439,91,91,0,1,0
0,447,447,4,4,0,1,0
39,471,471,27,17,10,2,1
36,478,478,158,78,80,4,3
27,480,480,10,10,0,1,0
15,492,492,8,5,3,2,1
3,499,499,17,7,10,3,2

17,102,102,38,38,0,1,0
24,103,103,2,2,0,1,0
26,106,106,2,2,0,1,0
1,109,109,3,3,0,1,0
13,111,111,6,3,3,2,1
15,112,112,10,10,0,1,0
25,113,113,12,12,0,1,0
22,115,115,20,6,14,3,2
3,119,119,22,22,0,1,0
7,120,120,8,8,0,1,0
23,121,121,13,13,0,1,0
10,126,126,6,6,0,1,0
33,133,133,38,20,18,3,2
32,134,134,36,16,20,2,1
36,136,136,3,3,0,1,0
31,212,212,8,8,0,1,0
39,220,220,1,1,0,1,0
2,223,223,40,13,27,4,3
16,232,232,8,5,3,2,1
0,233,233,4,4,0,1,0
12,247,247,2,2,0,1,0
29,265,265,2,2,0,1,0
5,267,267,8,1,7,2,1
4,276,276,1,1,0,1,0
21,282,282,31,31,0,1,0
38,283,283,76,12,64,4,3
14,300,300,10,10,0,1,0
37,315,315,35,20,15,4,3
34,322,322,91,27,64,3,2
19,349,349,3,3,0,1,0
20,354,354,22,22,0,1,0
40,355,355,6,6,0,1,0
41,387,387,124,124,0,1,0
6,407,407,9,6,3,2,1
8,410,410,45,3,42,3,2
28,413,413,11,11,0,1,0
11,423,423,4,4,0,1,0
30,436,436,6,6,0,1,0
27,471,471,7,1,6,2,1
18,478,478,22,2,20,3,2
35,481,481,7,3,4,2,1
9,496,496,4,4,0,1,0

3,101,101,1,1,0,1,0
2,114,114,10,10,0,1,0
30,114,114,24,24,0,1,0
21,180,180,13,2,11,2,1
31,188,188,21,5,16,2,1
5,192,192,2,2,0,1,0
34,202,202,50,50,0,1,0
11,207,207,2,2,0,1,0
36,211,211,9,1,8,3,2
10,214,214,32,32,0,1,0
9,227,227,15,7,8,2,1
14,236,236,24,4,20,2,1
33,242,242,3,3,0,1,0
0,268,268,21,21,0,1,0
16,273,273,5,1,4,2,1
25,284,284,19,19,0,1,0
15,293,293,35,2,33,2,1
37,295,295,40,40,0,1,0
6,332,332,3,3,0,1,0
7,339,339,96,26,70,3,2
4,349,349,49,49,0,1,0
12,363,363,79,79,0,1,0
19,366,366,57,57,0,1,0
20,366,366,25,25,0,1,0
35,385,385,92,16,76,3,2
18,390,390,33,11,22,2,1
26,406,406,82,82,0,1,0
13,419,419,12,12,0,1,0
32,429,429,42,5,37,4,3
28,430,430,19,1,18,3,2
38,434,434,7,2,5,2,1
23,452,452,103,79,24,4,3
1,454,454,10,1,9,4,3
22,467,467,7,7,0,1,0
24,470,470,11,11,0,1,0
8,471,471,54,2,52,3,2
17,475,475,12,12,0,1,0
29,485,485,14,14,0,1,0
27,495,495,18,18,0,1,0

10,131,131,11,11,0,1,0
5,156,156,14,2,12,2,1
17,159,159,4,4,0,1,0
12,163,163,12,6,6,2,1
0,169,169,4,4,0,1,0
26,213,213,37,37,0,1,0
18,228,228,129,129,0,1,0
22,229,229,17,9,8,3,2
20,239,239,19,19,0,1,0
7,251,251,9,4,5,2,1
15,265,265,12,5,7,2,1
27,272,272,19,10,9,4,3
14,281,281,24,24,0,1,0
13,287,287,9,9,0,1,0
11,290,290,154,154,0,1,0
23,295,295,7,7,0,1,0
3,299,299,79,35,44,3,2
21,307,307,11,3,8,3,2
1,309,309,32,11,21,4,3
2,315,315,41,41,0,1,0
4,316,316,17,6,11,3,2
8,388,388,70,8,62,4,3
28,390,390,6,6,0,1,0
9,398,398,66,41,25,2,1
29,428,428,21,3,18,4,3
19,479,479,126,91,35,2,1
16,487,487,36,30,6,3,2
24,493,493,58,58,0,1,0
6,497,497,70,4,66,3,2
25,498,498,14,4,10,2,1

17,104,104,9,9,0,1,0
21,114,114,19,14,5,2,1
3,124,124,3,3,0,1,0
16,133,133,25,20,5,2,1
18,136,136,4,4,0,1,0
22,154,154,7,7,0,1,0
12,157,157,54,54,0,1,0
11,177,177,2,2,0,1,0
9,178,178,13,13,0,1,0
26,184,184,2,2,0,1,0
29,194,194,40,10,30,2,1
6,233,233,11,3,8,2,1
0,236,236,2,2,0,1,0
10,253,253,97,10,87,4,3
24,281,281,4,4,0,1,0
31,285,285,29,1,28,2,1
13,305,305,30,30,0,1,0
28,309,309,21,2,19,2,1
5,325,325,3,3,0,1,0
14,337,337,93,45,48,4,3
4,361,361,5,5,0,1,0
25,384,384,12,5,7,2,1
8,405,405,24,24,0,1,0
2,406,406,152,23,129,4,3
15,427,427,45,45,0,1,0
7,431,431,142,7,135,4,3
19,450,450,62,62,0,1,0
20,463,463,10,10,0,1,0
1,463,463,12,12,0,1,0
27,478,478,22,17,5,2,1
30,489,489,77,77,0,1,0
23,494,494,77,77,0,1,0

6,103,103,2,2,0,1,0
15,112,112,3,3,0,1,0
4,114,114,1,1,0,1,0
38,137,137,8,8,0,1,0
14,137,137,1,1,0,1,0
17,139,139,17,1,16,3,2
9,146,146,10,6,4,2,1
26,146,146,12,12,0,1,0
33,152,152,15,15,0,1,0
18,172,172,18,9,9,4,3
24,173,173,4,4,0,1,0
35,202,202,13,13,0,1,0
34,220,220,52,52,0,1,0
3,229,229,39,6,33,4,3
22,233,233,37,37,0,1,0
25,238,238,10,3,7,2,1
11,241,241,13,13,0,1,0
30,245,245,24,24,0,1,0
5,254,254,5,5,0,1,0
0,260,260,27,27,0,1,0
1,272,272,58,58,0,1,0
29,277,277,56,56,0,1,0
28,303,303,45,45,0,1,0
12,329,329,22,22,0,1,0
21,330,330,74,74,0,1,0
13,334,334,14,5,9,4,3
2,377,377,43,7,36,3,2
20,383,383,90,90,0,1,0
36,392,392,56,56,0,1,0
7,403,403,6,6,0,1,0
16,417,417,20,7,13,2,1
19,423,423,103,21,82,3,2
23,438,438,6,6,0,1,0
31,451,451,23,23,0,1,0
27,459,459,22,10,12,3,2
37,464,464,62,18,44,2,1
32,467,467,9,9,0,1,0
10,486,486,30,30,0,1,0
8,487,487,28,20,8,2,1

5,108,108,11,4,7,2,1
32,108,108,11,11,0,1,0
2,111,111,3,3,0,1,0
3,120,120,29,29,0,1,0
9,123,123,2,2,0,1,0
13,144,144,1,1,0,1,0
8,148,148,64,56,8,3,2
26,161,161,11,3,8,3,2
20,163,163,2,2,0,1,0
36,163,163,33,33,0,1,0
34,166,166,21,11,10,3,2
16,169,169,7,7,0,1,0
24,194,194,46,12,34,3,2
18,196,196,9,4,5,2,1
35,214,214,2,2,0,1,0
30,219,219,16,6,10,3,2
21,223,223,9,9,0,1,0
28,227,227,22,16,6,2,1
25,250,250,28,6,22,3,2
15,252,252,15,5,10,3,2
27,278,278,53,53,0,1,0
17,280,280,23,23,0,1,0
0,316,316,1,1,0,1,0
4,332,332,11,11,0,1,0
22,333,333,20,2,18,3,2
14,343,343,11,11,0,1,0
37,348,348,53,34,19,2,1
1,383,383,22,1,21,4,3
29,393,393,18,18,0,1,0
23,399,399,56,56,0,1,0
10,399,399,53,53,0,1,0
33,402,402,41,41,0,1,0
6,416,416,77,1,76,4,3
11,427,427,13,13,0,1,0
7,431,431,83,5,78,3,2
12,462,462,15,15,0,1,0
19,469,469,17,17,0,1,0
38,477,477,22,22,0,1,0
31,480,480,15,2,13,2,1

31,103,103,17,5,12,3,2
24,108,108,1,1,0,1,0
25,139,139,48,48,0,1,0
11,155,155,1,1,0,1,0
3,184,184,16,6,10,3,2
7,205,205,57,57,0,1,0
5,214,214,4,4,0,1,0
10,217,217,14,4,10,3,2
19,233,233,30,30,0,1,0
16,235,235,5,5,0,1,0
29,235,235,23,8,15,2,1
1,237,237,9,9,0,1,0
4,253,253,28,28,0,1,0
38,256,256,39,39,0,1,0
2,263,263,18,7,11,4,3
17,268,268,11,6,5,2,1
32,306,306,9,9,0,1,0
34,309,309,29,29,0,1,0
26,326,326,32,32,0,1,0
21,328,328,10,10,0,1,0
18,330,330,38,23,15,4,3
22,333,333,28,28,0,1,0
28,351,351,15,15,0,1,0
15,356,356,6,6,0,1,0
37,373,373,84,37,47,4,3
30,374,374,60,60,0,1,0
8,389,389,49,9,40,2,1
6,390,390,78,30,48,2,1
14,402,402,32,32,0,1,0
13,405,405,18,18,0,1,0
27,436,436,30,21,9,4,3
35,441,441,44,38,6,2,1
9,454,454,15,15,0,1,0
23,480,480,27,21,6,2,1
12,483,483,73,16,57,4,3
36,484,484,9,9,0,1,0
33,485,485,33,33,0,1,0
20,488,488,56,2,54,3,2
0,488,488,28,23,5,2,1

23,129,129,8,8,0,1,0
36,166,166,9,1,8,3,2
24,167,167,43,43,0,1,0
7,180,180,28,9,19,3,2
37,183,183,58,58,0,1,0
14,190,190,13,1,12,4,3
11,199,199,29,3,26,3,2
22,227,227,51,51,0,1,0
21,234,234,23,2,21,4,3
35,246,246,30,18,12,4,3
0,247,247,1,1,0,1,0
12,250,250,15,15,0,1,0
3,255,255,58,28,30,4,3
16,274,274,22,2,20,2,1
15,287,287,28,18,10,2,1
1,299,299,14,6,8,3,2
19,302,302,12,1,11,2,1
29,314,314,96,92,4,2,1
32,319,319,5,5,0,1,0
9,349,349,28,9,19,2,1
20,369,369,3,3,0,1,0
28,385,385,21,14,7,2,1
5,387,387,42,42,0,1,0
2,392,392,44,44,0,1,0
38,410,410,2,2,0,1,0
13,418,418,18,4,14,3,2
27,421,421,34,6,28,3,2
18,423,423,18,10,8,2,1
10,453,453,138,90,48,4,3
17,454,454,19,7,12,2,1
4,456,456,1,1,0,1,0
30,463,463,18,18,0,1,0
31,465,465,12,12,0,1,0
25,470,470,26,26,0,1,0
8,471,471,33,15,18,3,2
34,471,471,20,20,0,1,0
6,483,483,30,30,0,1,0
33,485,485,25,25,0,1,0
26,500,500,8,8,0,1,0

20,111,111,1,1,0,1,0
17,115,115,14,14,0,1,0
15,157,157,17,2,15,2,1
1,160,160,68,68,0,1,0
27,162,162,45,24,21,2,1
28,163,163,20,2,18,2,1
22,194,194,42,42,0,1,0
29,209,209,14,14,0,1,0
21,210,210,21,21,0,1,0
3,217,217,8,8,0,1,0
0,236,236,27,9,18,2,1
2,236,236,65,4,61,4,3
13,238,238,7,7,0,1,0
24,264,264,33,14,19,2,1
7,303,303,139,139,0,1,0
18,310,310,4,1,3,2,1
16,317,317,57,57,0,1,0
6,326,326,5,5,0,1,0
9,327,327,12,3,9,2,1
10,341,341,11,1,10,3,2
4,347,347,2,2,0,1,0
19,353,353,2,2,0,1,0
8,355,355,31,11,20,2,1
23,384,384,20,20,0,1,0
11,394,394,45,26,19,3,2
12,415,415,62,62,0,1,0
26,443,443,34,34,0,1,0
5,466,466,23,23,0,1,0
14,474,474,8,3,5,2,1
25,477,477,51,51,0,1,0
30,492,492,108,67,41,2,1

8,123,123,16,7,9,4,3
35,126,126,2,2,0,1,0
25,129,129,20,15,5,2,1
31,134,134,40,29,11,2,1
19,137,137,5,1,4,2,1
23,146,146,1,1,0,1,0
0,162,162,2,2,0,1,0
6,167,167,88,78,10,3,2
38,201,201,8,8,0,1,0
33,206,206,10,10,0,1,0
11,220,220,1,1,0,1,0
32,225,225,24,3,21,2,1
28,228,228,2,2,0,1,0
22,234,234,20,20,0,1,0
27,234,234,11,11,0,1,0
29,240,240,78,33,45,4,3
3,285,285,29,29,0,1,0
9,306,306,34,34,0,1,0
5,317,317,20,20,0,1,0
7,322,322,1,1,0,1,0
40,352,352,24,5,19,2,1
15,359,359,1,1,0,1,0
17,361,361,15,15,0,1,0
13,386,386,43,43,0,1,0
14,387,387,40,17,23,2,1
36,393,393,40,40,0,1,0
10,399,399,18,3,15,2,1
16,405,405,1,1,0,1,0
21,417,417,43,43,0,1,0
4,428,428,38,7,31,2,1
34,428,428,72,72,0,1,0
20,434,434,10,10,0,1,0
30,440,440,17,17,0,1,0
1,440,440,37,9,28,3,2
18,450,450,41,41,0,1,0
2,460,460,8,8,0,1,0
39,477,477,71,21,50,3,2
24,482,482,31,31,0,1,0
12,489,489,6,2,4,2,1
26,491,491,77,14,63,4,3
37,496,496,23,23,0,1,0

11,107,107,4,4,0,1,0
27,118,118,8,4,4,2,1
18,123,123,29,20,9,4,3
2,138,138,1,1,0,1,0
19,142,142,12,3,9,4,3
12,152,152,28,4,24,4,3
3,178,178,31,27,4,2,1
35,191,191,4,4,0,1,0
32,191,191,10,10,0,1,0
14,199,199,27,27,0,1,0
0,202,202,24,2,22,4,3
24,204,204,12,12,0,1,0
22,213,213,7,1,6,3,2
30,225,225,71,35,36,3,2
31,232,232,72,72,0,1,0
13,245,245,30,18,12,4,3
10,248,248,10,10,0,1,0
26,254,254,11,11,0,1,0
23,254,254,23,23,0,1,0
7,277,277,37,2,35,2,1
4,298,298,55,55,0,1,0
20,330,330,53,21,32,2,1
15,336,336,4,4,0,1,0
16,337,337,53,53,0,1,0
8,347,347,11,11,0,1,0
25,349,349,6,6,0,1,0
29,351,351,39,39,0,1,0
21,351,351,4,4,0,1,0
6,356,356,1,1,0,1,0
5,361,361,28,3,25,2,1
28,381,381,60,32,28,2,1
34,397,397,6,6,0,1,0
33,403,403,19,1,18,2,1
17,433,433,41,19,22,2,1
9,450,450,83,83,0,1,0
1,478,478,49,49,0,1,0

16,104,104,2,2,0,1,0
34,107,107,1,1,0,1,0
35,115,115,5,5,0,1,0
32,121,121,2,2,0,1,0
15,125,125,19,19,0,1,0
2,139,139,7,3,4,2,1
28,166,166,11,11,0,1,0
36,182,182,9,9,0,1,0
6,185,185,2,2,0,1,0
0,188,188,52,4,48,3,2
1,199,199,33,19,14,2,1
10,202,202,87,58,29,2,1
17,211,211,15,15,0,1,0
14,218,218,20,11,9,2,1
20,228,228,56,56,0,1,0
31,240,240,8,8,0,1,0
30,256,256,13,1,12,3,2
22,292,292,23,10,13,2,1
5,310,310,2,2,0,1,0
18,316,316,8,8,0,1,0
8,321,321,80,63,17,2,1
26,326,326,32,6,26,3,2
7,328,328,6,6,0,1,0
25,328,328,31,27,4,2,1
19,346,346,18,8,10,3,2
12,347,347,1,1,0,1,0
27,362,362,51,51,0,1,0
9,395,395,4,4,0,1,0
4,398,398,31,21,10,2,1
24,419,419,3,3,0,1,0
11,428,428,25,17,8,3,2
29,451,451,215,194,21,2,1
3,454,454,30,30,0,1,0
21,460,460,45,35,10,3,2
33,484,484,34,12,22,2,1
13,491,491,9,9,0,1,0
23,492,492,104,72,32,3,2

32,104,104,3,3,0,1,0
34,106,106,1,1,0,1,0
28,109,109,5,1,4,2,1
2,121,121,1,1,0,1,0
27,134,134,38,10,28,3,2
9,138,138,3,3,0,1,0
18,153,153,5,5,0,1,0
4,156,156,20,3,17,2,1
11,159,159,6,6,0,1,0
39,169,169,9,9,0,1,0
30,169,169,8,8,0,1,0
20,183,183,35,35,0,1,0
5,187,187,5,5,0,1,0
25,192,192,5,5,0,1,0
41,194,194,53,53,0,1,0
7,195,195,11,2,9,4,3
37,196,196,7,1,6,3,2
12,214,214,6,2,4,2,1
33,220,220,16,1,15,2,1
24,229,229,31,16,15,4,3
17,242,242,32,32,0,1,0
3,262,262,5,2,3,2,1
13,267,267,1,1,0,1,0
22,273,273,24,24,0,1,0
10,274,274,18,18,0,1,0
36,290,290,17,17,0,1,0
16,300,300,34,4,30,3,2
40,309,309,27,9,18,2,1
6,315,315,47,4,43,2,1
31,330,330,42,42,0,1,0
21,335,335,16,16,0,1,0
38,348,348,42,42,0,1,0
0,365,365,19,19,0,1,0
19,367,367,27,27,0,1,0
14,393,393,2,2,0,1,0
15,396,396,104,54,50,3,2
1,422,422,96,33,63,4,3
29,447,447,13,13,0,1,0
35,449,449,87,52,35,2,1
8,455,455,1,1,0,1,0
26,460,460,93,93,0,1,0
23,474,474,13,7,6,3,2

37,119,119,13,3,10,2,1
44,131,131,13,13,0,1,0
41,133,133,8,8,0,1,0
34,135,135,34,34,0,1,0
2,136,136,5,5,0,1,0
30,147,147,7,2,5,2,1
38,149,149,5,1,4,2,1
32,165,165,2,2,0,1,0
5,181,181,5,2,3,2,1
14,188,188,19,19,0,1,0
23,191,191,7,7,0,1,0
42,193,193,27,27,0,1,0
26,196,196,10,10,0,1,0
29,197,197,24,11,13,2,1
16,208,208,17,17,0,1,0
28,221,221,5,5,0,1,0
11,233,233,5,5,0,1,0
9,241,241,53,43,10,3,2
35,242,242,32,4,28,2,1
36,246,246,125,73,52,4,3
13,252,252,19,19,0,1,0
27,266,266,30,30,0,1,0
40,275,275,3,3,0,1,0
15,287,287,22,5,17,2,1
39,292,292,8,8,0,1,0
1,296,296,32,11,21,4,3
17,296,296,17,14,3,2,1
21,303,303,49,4,45,4,3
10,311,311,2,2,0,1,0
3,322,322,1,1,0,1,0
12,324,324,16,1,15,4,3
4,356,356,12,4,8,2,1
0,365,365,2,2,0,1,0
31,380,380,24,24,0,1,0
33,380,380,1,1,0,1,0
8,385,385,61,35,26,3,2
20,413,413,50,37,13,2,1
7,421,421,69,69,0,1,0
18,426,426,1,1,0,1,0
6,428,428,1,1,0,1,0
22,437,437,67,33,34,2,1
24,438,438,7,7,0,1,0
43,448,448,42,42,0,1,0
19,468,468,12,12,0,1,0
25,469,469,2,2,0,1,0

7,108,108,3,3,0,1,0
11,109,109,13,13,0,1,0
9,114,114,12,12,0,1,0
20,145,145,5,1,4,2,1
30,153,153,1,1,0,1,0
13,162,162,1,1,0,1,0
21,165,165,10,10,0,1,0
12,205,205,4,4,0,1,0
3,207,207,41,12,29,2,1
34,212,212,20,10,10,2,1
23,216,216,33,1,32,3,2
40,217,217,61,61,0,1,0
18,218,218,1,1,0,1,0
8,238,238,1,1,0,1,0
32,248,248,29,29,0,1,0
29,249,249,62,62,0,1,0
6,249,249,3,3,0,1,0
16,252,252,1,1,0,1,0
37,264,264,10,1,9,4,3
25,278,278,20,20,0,1,0
26,279,279,4,1,3,2,1
27,288,288,4,4,0,1,0
38,292,292,8,1,7,2,1
0,293,293,76,48,28,2,1
44,294,294,35,8,27,4,3
4,302,302,14,8,6,2,1
15,315,315,1,1,0,1,0
24,324,324,4,4,0,1,0
31,337,337,49,5,44,3,2
14,337,337,81,13,68,4,3
5,347,347,64,50,14,3,2
43,353,353,1,1,0,1,0
19,362,362,8,8,0,1,0
36,367,367,31,7,24,4,3
28,378,378,56,7,49,3,2
2,390,390,13,13,0,1,0
17,390,390,9,6,3,2,1
39,395,395,10,2,8,2,1
22,401,401,44,24,20,2,1
35,402,402,63,63,0,1,0
33,410,410,15,6,9,2,1
41,422,422,100,80,20,3,2
1,437,437,4,4,0,1,0
10,452,452,11,11,0,1,0
42,482,482,26,26,0,1,0

27,100,100,12,12,0,1,0
14,100,100,17,8,9,2,1
30,107,107,14,3,11,2,1
25,110,110,7,1,6,3,2
5,123,123,3,3,0,1,0
26,129,129,18,18,0,1,0
20,140,140,15,2,13,2,1
24,143,143,1,1,0,1,0
2,158,158,1,1,0,1,0
0,172,172,9,3,6,3,2
1,196,196,17,17,0,1,0
35,212,212,27,27,0,1,0
32,219,219,18,18,0,1,0
9,253,253,11,2,9,4,3
23,257,257,67,17,50,3,2
13,258,258,9,9,0,1,0
4,276,276,37,37,0,1,0
28,297,297,19,7,12,2,1
22,324,324,14,14,0,1,0
19,334,334,94,94,0,1,0
12,340,340,10,4,6,2,1
3,342,342,19,19,0,1,0
8,343,343,67,67,0,1,0
16,344,344,33,33,0,1,0
21,399,399,8,8,0,1,0
15,403,403,7,1,6,2,1
17,413,413,123,54,69,4,3
6,420,420,178,121,57,4,3
7,422,422,18,11,7,2,1
11,441,441,37,13,24,3,2
31,464,464,36,36,0,1,0
34,471,471,12,12,0,1,0
10,474,474,3,3,0,1,0
29,475,475,14,14,0,1,0
18,490,490,27,27,0,1,0
33,490,490,100,100,0,1,0

4,116,116,47,18,29,2,1
6,120,120,14,1,13,4,3
5,132,132,1,1,0,1,0
22,143,143,5,1,4,2,1
28,148,148,4,4,0,1,0
3,149,149,30,18,12,2,1
32,157,157,13,1,12,4,3
12,163,163,13,5,8,2,1
9,178,178,32,32,0,1,0
1,182,182,1,1,0,1,0
20,185,185,6,3,3,2,1
31,200,200,12,2,10,3,2
11,226,226,39,39,0,1,0
29,241,241,5,5,0,1,0
0,245,245,9,9,0,1,0
18,269,269,2,2,0,1,0
15,275,275,34,34,0,1,0
14,276,276,34,9,25,2,1
25,283,283,76,66,10,2,1
27,291,291,33,8,25,2,1
13,311,311,82,32,50,2,1
10,333,333,1,1,0,1,0
23,343,343,15,9,6,3,2
8,351,351,23,5,18,3,2
16,377,377,53,23,30,4,3
24,398,398,6,6,0,1,0
2,406,406,6,6,0,1,0
17,414,414,23,23,0,1,0
19,437,437,264,210,54,4,3
30,450,450,9,9,0,1,0
7,456,456,1,1,0,1,0
21,483,483,44,7,37,3,2
26,487,487,22,16,6,2,1
33,500,500,84,84,0,1,0

4,120,120,3,3,0,1,0
1,136,136,3,3,0,1,0
38,142,142,5,5,0,1,0
21,152,152,8,8,0,1,0
3,179,179,36,6,30,4,3
29,181,181,13,13,0,1,0
28,190,190,27,5,22,2,1
14,214,214,34,34,0,1,0
35,220,220,49,20,29,2,1
32,222,222,25,25,0,1,0
34,234,234,23,9,14,2,1
26,236,236,4,4,0,1,0
15,244,244,7,1,6,3,2
6,250,250,9,9,0,1,0
11,273,273,8,2,6,3,2
17,275,275,3,3,0,1,0
33,277,277,53,32,21,4,3
39,278,278,43,19,24,4,3
22,286,286,6,6,0,1,0
24,288,288,52,52,0,1,0
16,302,302,66,36,30,4,3
31,304,304,3,3,0,1,0
19,316,316,30,30,0,1,0
23,322,322,24,24,0,1,0
27,327,327,53,34,19,2,1
2,363,363,49,31,18,4,3
18,366,366,37,8,29,3,2
5,380,380,59,54,5,2,1
7,405,405,27,27,0,1,0
25,412,412,26,26,0,1,0
36,415,415,6,6,0,1,0
0,418,418,18,18,0,1,0
12,447,447,4,4,0,1,0
20,469,469,26,26,0,1,0
8,474,474,24,24,0,1,0
9,485,485,21,10,11,2,1
37,487,487,102,102,0,1,0
30,489,489,23,13,10,2,1
10,497,497,5,5,0,1,0
13,500,500,127,127,0,1,0

4,107,107,9,9,0,1,0
11,120,120,11,11,0,1,0
1,127,127,29,5,24,3,2
9,148,148,13,13,0,1,0
14,153,153,2,2,0,1,0
24,171,171,17,5,12,3,2
13,179,179,65,23,42,3,2
21,184,184,11,11,0,1,0
31,188,188,23,23,0,1,0
35,216,216,14,3,11,2,1
20,222,222,32,32,0,1,0
10,231,231,10,10,0,1,0
32,234,234,8,1,7,2,1
33,265,265,32,4,28,3,2
36,273,273,7,7,0,1,0
28,274,274,36,9,27,4,3
34,281,281,5,5,0,1,0
30,289,289,3,3,0,1,0
0,297,297,5,5,0,1,0
5,299,299,101,39,62,4,3
29,307,307,185,152,33,2,1
18,309,309,3,3,0,1,0
26,321,321,61,13,48,4,3
16,354,354,18,6,12,3,2
15,357,357,37,3,34,2,1
22,385,385,7,1,6,2,1
7,386,386,30,30,0,1,0
6,389,389,39,15,24,4,3
23,407,407,25,25,0,1,0
8,413,413,29,29,0,1,0
3,426,426,17,8,9,2,1
27,429,429,9,9,0,1,0
25,447,447,26,26,0,1,0
17,461,461,1,1,0,1,0
19,469,469,25,10,15,4,3
12,469,469,37,16,21,2,1
2,487,487,1,1,0,1,0

0,100,100,23,5,18,4,3
39,115,115,38,38,0,1,0
25,117,117,9,9,0,1,0
13,133,133,8,8,0,1,0
15,143,143,1,1,0,1,0
12,147,147,20,5,15,3,2
3,160,160,14,14,0,1,0
30,174,174,6,6,0,1,0
21,195,195,4,4,0,1,0
2,196,196,5,5,0,1,0
34,199,199,77,26,51,3,2
36,206,206,5,5,0,1,0
11,214,214,26,3,23,4,3
18,225,225,2,2,0,1,0
35,226,226,23,14,9,4,3
7,234,234,29,29,0,1,0
1,241,241,2,2,0,1,0
31,242,242,15,15,0,1,0
16,244,244,19,19,0,1,0
17,244,244,3,3,0,1,0
8,248,248,4,4,0,1,0
28,259,259,31,23,8,2,1
40,261,261,28,7,21,4,3
32,268,268,19,8,11,2,1
27,269,269,33,1,32,3,2
23,288,288,9,1,8,3,2
29,295,295,2,2,0,1,0
5,304,304,23,17,6,3,2
22,315,315,53,53,0,1,0
33,318,318,10,10,0,1,0
19,320,320,14,6,8,3,2
6,367,367,34,2,32,4,3
20,379,379,17,1,16,3,2
37,381,381,27,27,0,1,0
4,387,387,22,13,9,2,1
24,425,425,89,89,0,1,0
14,428,428,56,56,0,1,0
38,430,430,9,1,8,3,2
9,474,474,111,71,40,3,2
26,492,492,14,14,0,1,0
10,498,498,9,5,4,2,1

16,116,116,33,21,12,3,2
5,117,117,6,2,4,2,1
28,129,129,23,6,17,2,1
29,133,133,18,18,0,1,0
10,138,138,22,22,0,1,0
13,146,146,66,63,3,2,1
33,170,170,33,7,26,3,2
9,174,174,1,1,0,1,0
0,193,193,36,36,0,1,0
31,196,196,11,11,0,1,0
32,201,201,4,4,0,1,0
2,225,225,6,6,0,1,0
3,226,226,3,3,0,1,0
21,229,229,11,11,0,1,0
18,258,258,23,18,5,2,1
4,297,297,52,6,46,2,1
14,298,298,29,29,0,1,0
22,318,318,22,2,20,3,2
26,353,353,26,26,0,1,0
15,354,354,16,16,0,1,0
1,356,356,2,2,0,1,0
20,360,360,31,12,19,2,1
7,384,384,78,31,47,2,1
12,416,416,19,19,0,1,0
8,417,417,20,20,0,1,0
23,420,420,38,32,6,3,2
25,421,421,3,3,0,1,0
17,424,424,47,47,0,1,0
24,437,437,72,72,0,1,0
27,475,475,67,67,0,1,0
30,480,480,17,3,14,3,2
19,482,482,26,26,0,1,0
11,495,495,19,4,15,4,3
6,499,499,124,91,33,4,3

22,111,111,5,5,0,1,0
2,119,119,1,1,0,1,0
29,119,119,12,1,11,2,1
16,121,121,25,25,0,1,0
30,156,156,24,4,20,2,1
5,158,158,81,81,0,1,0
19,168,168,30,30,0,1,0
7,183,183,10,10,0,1,0
10,184,184,5,5,0,1,0
12,201,201,36,31,5,2,1
6,218,218,27,9,18,2,1
33,236,236,10,10,0,1,0
25,262,262,15,15,0,1,0
18,266,266,4,4,0,1,0
15,280,280,3,3,0,1,0
1,302,302,2,2,0,1,0
20,311,311,59,38,21,4,3
21,311,311,1,1,0,1,0
31,311,311,8,2,6,2,1
23,316,316,64,64,0,1,0
24,329,329,2,2,0,1,0
11,341,341,29,19,10,2,1
32,347,347,60,60,0,1,0
28,366,366,52,52,0,1,0
26,369,369,33,24,9,2,1
14,373,373,120,120,0,1,0
17,378,378,70,22,48,4,3
4,398,398,68,41,27,2,1
13,407,407,30,30,0,1,0
0,417,417,1,1,0,1,0
8,426,426,21,13,8,2,1
27,476,476,6,6,0,1,0
3,485,485,66,66,0,1,0
9,495,495,19,19,0,1,0

17,116,116,11,11,0,1,0
0,122,122,1,1,0,1,0
31,139,139,7,7,0,1,0
27,154,154,24,24,0,1,0
7,189,189,18,18,0,1,0
6,193,193,13,13,0,1,0
12,204,204,1,1,0,1,0
10,205,205,49,13,36,4,3
14,210,210,19,7,12,3,2
28,213,213,21,21,0,1,0
1,259,259,55,20,35,2,1
26,261,261,6,3,3,2,1
34,272,272,15,15,0,1,0
37,273,273,89,19,70,4,3
4,282,282,82,7,75,4,3
8,290,290,38,10,28,3,2
33,299,299,35,35,0,1,0
3,327,327,32,29,3,2,1
5,334,334,1,1,0,1,0
15,342,342,30,30,0,1,0
25,367,367,9,1,8,3,2
2,374,374,15,5,10,3,2
9,379,379,6,1,5,2,1
30,384,384,18,11,7,2,1
29,386,386,25,14,11,2,1
22,392,392,4,4,0,1,0
36,393,393,32,32,0,1,0
19,396,396,10,1,9,4,3
24,416,416,38,34,4,2,1
20,417,417,8,8,0,1,0
11,428,428,54,42,12,3,2
35,433,433,168,168,0,1,0
13,443,443,12,4,8,2,1
32,472,472,90,90,0,1,0
18,477,477,11,5,6,2,1
23,481,481,25,25,0,1,0
16,482,482,58,58,0,1,0
21,491,491,17,11,6,2,1

33,104,104,43,43,0,1,0
8,140,140,5,5,0,1,0
35,142,142,8,8,0,1,0
4,162,162,14,14,0,1,0
29,164,164,6,1,5,2,1
17,170,170,53,53,0,1,0
1,175,175,16,16,0,1,0
3,202,202,7,7,0,1,0
2,208,208,12,7,5,2,1
30,213,213,2,2,0,1,0
21,219,219,26,20,6,3,2
11,230,230,6,6,0,1,0
18,252,252,13,13,0,1,0
15,273,273,87,87,0,1,0
26,280,280,11,11,0,1,0
24,287,287,54,36,18,4,3
28,289,289,20,20,0,1,0
5,302,302,24,6,18,3,2
9,314,314,5,5,0,1,0
25,314,314,10,4,6,2,1
22,316,316,7,7,0,1,0
23,327,327,101,101,0,1,0
19,372,372,44,44,0,1,0
32,386,386,39,39,0,1,0
16,391,391,27,27,0,1,0
20,391,391,5,2,3,2,1
31,392,392,39,30,9,4,3
6,398,398,41,5,36,2,1
0,411,411,4,4,0,1,0
13,437,437,87,87,0,1,0
12,447,447,35,35,0,1,0
36,452,452,33,19,14,3,2
27,473,473,53,53,0,1,0
34,486,486,7,2,5,2,1
14,487,487,39,15,24,2,1
7,493,493,16,5,11,2,1
10,498,498,61,61,0,1,0

3,100,100,3,3,0,1,0
28,117,117,2,2,0,1,0
25,120,120,7,1,6,3,2
23,130,130,6,6,0,1,0
20,144,144,1,1,0,1,0
17,145,145,13,13,0,1,0
18,157,157,2,2,0,1,0
22,167,167,32,32,0,1,0
5,172,172,22,22,0,1,0
16,195,195,7,7,0,1,0
0,210,210,11,6,5,2,1
1,258,258,15,5,10,2,1
2,260,260,4,1,3,2,1
15,268,268,3,3,0,1,0
27,279,279,21,11,10,3,2
24,313,313,121,81,40,2,1
13,328,328,90,90,0,1,0
21,331,331,117,32,85,4,3
11,345,345,70,16,54,3,2
26,372,372,25,25,0,1,0
6,380,380,40,40,0,1,0
19,396,396,49,49,0,1,0
30,404,404,76,18,58,3,2
29,417,417,63,6,57,4,3
14,425,425,8,2,6,2,1
10,430,430,22,22,0,1,0
32,466,466,2,2,0,1,0
31,475,475,12,12,0,1,0
9,481,481,142,17,125,4,3
8,489,489,40,40,0,1,0
7,492,492,13,3,10,3,2
4,492,492,226,97,129,4,3
12,497,497,1,1,0,1,0

22,121,121,9,9,0,1,0
23,123,123,34,34,0,1,0
34,128,128,5,5,0,1,0
6,142,142,5,1,4,2,1
28,146,146,3,3,0,1,0
21,151,151,10,5,5,2,1
0,156,156,22,8,14,3,2
9,165,165,20,20,0,1,0
7,165,165,25,1,24,3,2
24,181,181,8,8,0,1,0
26,186,186,14,8,6,2,1
29,194,194,8,8,0,1,0
30,201,201,10,10,0,1,0
11,205,205,41,41,0,1,0
16,221,221,18,18,0,1,0
2,230,230,1,1,0,1,0
35,242,242,39,39,0,1,0
17,269,269,57,47,10,2,1
20,272,272,37,4,33,2,1
37,278,278,41,22,19,2,1
1,293,293,2,2,0,1,0
19,305,305,20,20,0,1,0
15,319,319,14,7,7,2,1
36,336,336,38,8,30,4,3
13,368,368,41,41,0,1,0
14,375,375,2,2,0,1,0
32,375,375,8,8,0,1,0
33,382,382,16,13,3,2,1
10,383,383,35,11,24,4,3
31,386,386,60,44,16,3,2
12,396,396,27,12,15,2,1
5,418,418,22,10,12,3,2
25,422,422,145,119,26,3,2
8,435,435,94,19,75,4,3
18,455,455,72,72,0,1,0
3,457,457,5,1,4,2,1
27,464,464,18,18,0,1,0
4,471,471,11,11,0,1,0

25,141,141,6,6,0,1,0
26,146,146,2,2,0,1,0
29,158,158,19,12,7,2,1
3,162,162,34,34,0,1,0
13,168,168,48,3,45,4,3
12,201,201,16,1,15,4,3
31,212,212,8,8,0,1,0
19,219,219,25,25,0,1,0
28,222,222,11,1,10,3,2
9,234,234,24,18,6,2,1
11,257,257,10,10,0,1,0
15,259,259,1,1,0,1,0
30,276,276,27,27,0,1,0
5,280,280,5,5,0,1,0
22,290,290,16,7,9,4,3
0,315,315,57,38,19,3,2
35,320,320,33,33,0,1,0
21,338,338,31,31,0,1,0
27,349,349,51,51,0,1,0
16,350,350,56,15,41,2,1
1,375,375,15,3,12,2,1
4,379,379,3,3,0,1,0
18,386,386,23,23,0,1,0
14,388,388,39,39,0,1,0
10,397,397,22,2,20,2,1
7,406,406,16,16,0,1,0
20,417,417,35,13,22,4,3
8,428,428,75,60,15,4,3
33,452,452,70,49,21,2,1
32,471,471,8,8,0,1,0
34,473,473,153,75,78,3,2
17,478,478,20,9,11,2,1
6,479,479,1,1,0,1,0
24,480,480,141,110,31,2,1
23,495,495,11,11,0,1,0
2,500,500,130,69,61,4,3

16,118,118,5,2,3,2,1
14,139,139,10,10,0,1,0
26,157,157,17,17,0,1,0
21,171,171,8,8,0,1,0
22,183,183,17,17,0,1,0
17,208,208,1,1,0,1,0
5,215,215,45,45,0,1,0
0,221,221,46,34,12,4,3
2,227,227,36,10,26,2,1
4,229,229,23,23,0,1,0
7,230,230,1,1,0,1,0
15,251,251,16,8,8,3,2
27,261,261,17,17,0,1,0
8,271,271,23,23,0,1,0
20,286,286,40,18,22,3,2
23,289,289,30,30,0,1,0
1,322,322,138,66,72,4,3
6,323,323,47,33,14,2,1
24,327,327,28,1,27,4,3
25,346,346,10,5,5,2,1
28,376,376,107,41,66,3,2
11,380,380,58,58,0,1,0
3,427,427,55,33,22,2,1
10,431,431,28,28,0,1,0
19,446,446,83,83,0,1,0
13,452,452,37,37,0,1,0
9,462,462,124,92,32,2,1
18,475,475,21,5,16,4,3
12,483,483,113,79,34,3,2

22,103,103,4,4,0,1,0
13,103,103,4,4,0,1,0
14,117,117,1,1,0,1,0
27,141,141,4,4,0,1,0
38,175,175,27,27,0,1,0
21,194,194,11,11,0,1,0
11,195,195,41,41,0,1,0
0,207,207,1,1,0,1,0
9,220,220,17,17,0,1,0
15,234,234,33,13,20,2,1
8,245,245,19,19,0,1,0
16,245,245,15,1,14,2,1
24,245,245,18,18,0,1,0
17,250,250,3,3,0,1,0
1,251,251,5,5,0,1,0
42,254,254,41,41,0,1,0
36,257,257,31,16,15,2,1
23,268,268,9,9,0,1,0
12,280,280,8,8,0,1,0
10,293,293,4,1,3,2,1
31,306,306,32,22,10,3,2
26,317,317,1,1,0,1,0
32,325,325,21,1,20,2,1
3,351,351,23,23,0,1,0
28,366,366,25,25,0,1,0
35,386,386,3,3,0,1,0
19,390,390,45,34,11,2,1
20,392,392,1,1,0,1,0
30,409,409,15,12,3,2,1
18,410,410,5,5,0,1,0
33,421,421,39,3,36,4,3
6,423,423,90,9,81,4,3
25,430,430,39,12,27,2,1
41,433,433,36,20,16,3,2
5,448,448,19,19,0,1,0
39,455,455,85,85,0,1,0
29,458,458,97,3,94,3,2
7,466,466,126,3,123,4,3
4,468,468,32,7,25,2,1
37,469,469,70,70,0,1,0
34,470,470,88,88,0,1,0
40,482,482,41,15,26,3,2
2,498,498,57,57,0,1,0

7,100,100,6,6,0,1,0
9,107,107,16,4,12,3,2
21,140,140,12,12,0,1,0
18,162,162,26,26,0,1,0
28,163,163,23,23,0,1,0
19,179,179,8,8,0,1,0
10,210,210,11,11,0,1,0
1,211,211,6,3,3,2,1
16,217,217,47,25,22,3,2
2,221,221,30,30,0,1,0
33,230,230,24,24,0,1,0
13,237,237,16,16,0,1,0
37,252,252,26,26,0,1,0
0,255,255,65,11,54,4,3
5,258,258,12,8,4,2,1
25,265,265,16,4,12,4,3
30,274,274,35,8,27,4,3
3,279,279,41,7,34,2,1
35,284,284,25,25,0,1,0
15,315,315,18,18,0,1,0
32,316,316,19,9,10,2,1
6,321,321,10,1,9,2,1
38,326,326,38,8,30,3,2
8,327,327,1,1,0,1,0
27,364,364,20,1,19,4,3
11,369,369,19,19,0,1,0
34,378,378,30,20,10,3,2
4,413,413,3,3,0,1,0
23,425,425,49,15,34,3,2
29,437,437,44,12,32,2,1
12,437,437,26,26,0,1,0
17,443,443,21,12,9,2,1
24,445,445,62,32,30,4,3
36,453,453,23,8,15,4,3
31,483,483,11,11,0,1,0
14,491,491,42,42,0,1,0
20,493,493,47,8,39,4,3
26,495,495,147,126,21,2,1
22,498,498,43,26,17,2,1

12,107,107,2,2,0,1,0
0,108,108,1,1,0,1,0
2,109,109,5,5,0,1,0
30,122,122,3,3,0,1,0
41,130,130,4,4,0,1,0
45,135,135,24,10,14,3,2
5,138,138,1,1,0,1,0
21,144,144,11,5,6,2,1
23,146,146,2,2,0,1,0
25,153,153,11,11,0,1,0
7,162,162,62,62,0,1,0
44,171,171,11,3,8,2,1
6,180,180,3,3,0,1,0
43,185,185,1,1,0,1,0
33,196,196,13,5,8,2,1
19,233,233,7,7,0,1,0
17,243,243,7,3,4,2,1
14,252,252,10,10,0,1,0
28,269,269,23,15,8,2,1
24,269,269,9,9,0,1,0
38,269,269,9,9,0,1,0
9,272,272,42,34,8,2,1
1,273,273,16,2,14,3,2
13,280,280,3,3,0,1,0
42,286,286,160,160,0,1,0
15,306,306,74,74,0,1,0
16,308,308,19,19,0,1,0
27,316,316,18,18,0,1,0
36,332,332,67,67,0,1,0
18,340,340,5,5,0,1,0
4,353,353,7,7,0,1,0
32,371,371,44,44,0,1,0
31,373,373,9,1,8,3,2
3,396,396,24,14,10,2,1
26,403,403,2,2,0,1,0
39,411,411,60,37,23,2,1
20,438,438,29,20,9,4,3
40,449,449,2,2,0,1,0
34,452,452,43,43,0,1,0
35,462,462,18,18,0,1,0
11,467,467,29,29,0,1,0
37,471,471,5,1,4,2,1
22,486,486,17,1,16,3,2
29,487,487,76,76,0,1,0
46,490,490,37,1,36,2,1
8,492,492,33,33,0,1,0
10,500,500,14,3,11,2,1

36,105,105,6,1,5,2,1
20,107,107,5,5,0,1,0
2,110,110,8,4,4,2,1
23,131,131,5,5,0,1,0
21,139,139,25,7,18,4,3
26,140,140,15,15,0,1,0
11,152,152,16,6,10,3,2
10,155,155,10,1,9,2,1
25,186,186,16,4,12,4,3
0,207,207,1,1,0,1,0
34,219,219,22,2,20,3,2
6,236,236,13,13,0,1,0
17,246,246,13,3,10,2,1
14,254,254,53,17,36,4,3
3,259,259,59,59,0,1,0
4,266,266,5,5,0,1,0
28,266,266,17,12,5,2,1
9,272,272,1,1,0,1,0
12,280,280,43,43,0,1,0
35,292,292,51,51,0,1,0
33,301,301,90,39,51,4,3
18,302,302,57,34,23,4,3
13,321,321,42,13,29,2,1
22,362,362,32,26,6,2,1
32,370,370,19,2,17,2,1
5,374,374,17,17,0,1,0
29,386,386,50,3,47,2,1
27,422,422,36,10,26,2,1
24,458,458,64,6,58,3,2
30,465,465,7,7,0,1,0
15,468,468,17,5,12,2,1
31,472,472,22,22,0,1,0
7,473,473,17,17,0,1,0
16,486,486,12,12,0,1,0
8,489,489,125,110,15,4,3
19,493,493,64,36,28,3,2
1,499,499,58,8,50,3,2

12,107,107,13,13,0,1,0
11,107,107,20,12,8,3,2
38,113,113,2,2,0,1,0
15,119,119,1,1,0,1,0
26,121,121,3,3,0,1,0
22,122,122,10,10,0,1,0
24,138,138,1,1,0,1,0
0,148,148,6,6,0,1,0
5,154,154,36,30,6,2,1
14,183,183,1,1,0,1,0
31,189,189,18,18,0,1,0
9,210,210,16,16,0,1,0
29,213,213,7,7,0,1,0
30,218,218,16,16,0,1,0
33,227,227,33,11,22,2,1
8,237,237,25,9,16,2,1
2,248,248,4,1,3,2,1
1,252,252,26,26,0,1,0
3,255,255,46,46,0,1,0
20,258,258,28,20,8,3,2
27,274,274,13,3,10,2,1
32,286,286,86,86,0,1,0
18,307,307,15,7,8,2,1
13,340,340,9,2,7,2,1
23,371,371,48,48,0,1,0
17,388,388,10,10,0,1,0
35,400,400,5,5,0,1,0
21,401,401,105,105,0,1,0
4,404,404,16,3,13,3,2
19,411,411,77,17,60,4,3
6,413,413,23,3,20,3,2
10,435,435,4,4,0,1,0
34,441,441,27,27,0,1,0
7,446,446,78,32,46,3,2
25,456,456,17,17,0,1,0
28,473,473,46,16,30,2,1
36,474,474,121,121,0,1,0
16,478,478,23,23,0,1,0
37,486,486,75,75,0,1,0

32,108,108,7,7,0,1,0
8,110,110,3,3,0,1,0
33,119,119,4,4,0,1,0
38,120,120,16,16,0,1,0
20,156,156,43,43,0,1,0
23,164,164,8,8,0,1,0
34,183,183,147,62,85,4,3
27,214,214,11,2,9,2,1
11,224,224,35,35,0,1,0
9,228,228,10,1,9,3,2
14,229,229,2,2,0,1,0
7,239,239,6,6,0,1,0
22,247,247,40,3,37,2,1
17,250,250,8,8,0,1,0
10,251,251,5,1,4,2,1
24,255,255,35,16,19,3,2
1,264,264,19,19,0,1,0
39,273,273,12,12,0,1,0
41,277,277,15,3,12,3,2
12,322,322,53,3,50,2,1
19,327,327,19,4,15,4,3
5,341,341,30,30,0,1,0
28,350,350,20,10,10,3,2
29,359,359,14,4,10,3,2
36,371,371,55,44,11,4,3
31,384,384,1,1,0,1,0
21,393,393,74,59,15,4,3
26,403,403,3,3,0,1,0
35,414,414,47,11,36,3,2
30,415,415,12,12,0,1,0
40,427,427,10,4,6,2,1
4,427,427,1,1,0,1,0
13,438,438,25,25,0,1,0
18,442,442,1,1,0,1,0
3,444,444,4,4,0,1,0
16,444,444,21,5,16,3,2
25,445,445,32,32,0,1,0
2,459,459,21,21,0,1,0
37,464,464,5,5,0,1,0
15,464,464,1,1,0,1,0
0,471,471,8,5,3,2,1
6,473,473,53,53,0,1,0
42,474,474,70,22,48,4,3

15,100,100,12,7,5,2,1
12,115,115,5,5,0,1,0
21,115,115,14,14,0,1,0
5,120,120,1,1,0,1,0
28,121,121,3,3,0,1,0
23,144,144,16,5,11,2,1
16,168,168,18,18,0,1,0
38,169,169,17,17,0,1,0
20,172,172,15,15,0,1,0
2,176,176,13,13,0,1,0
31,186,186,9,6,3,2,1
17,203,203,11,11,0,1,0
14,207,207,3,3,0,1,0
34,208,208,5,5,0,1,0
24,266,266,58,25,33,2,1
33,275,275,2,2,0,1,0
26,291,291,13,6,7,2,1
18,325,325,41,5,36,3,2
11,360,360,11,11,0,1,0
0,366,366,4,1,3,2,1
9,368,368,83,68,15,4,3
19,370,370,37,37,0,1,0
30,372,372,17,17,0,1,0
8,379,379,51,8,43,2,1
4,382,382,81,18,63,4,3
36,389,389,8,2,6,2,1
29,392,392,85,85,0,1,0
3,398,398,51,51,0,1,0
35,399,399,90,30,60,4,3
25,418,418,42,33,9,4,3
13,421,421,86,68,18,4,3
37,442,442,154,146,8,3,2
10,454,454,1,1,0,1,0
1,459,459,31,3,28,4,3
6,463,463,20,20,0,1,0
7,472,472,5,5,0,1,0
22,482,482,24,9,15,2,1
32,489,489,34,15,19,2,1
27,494,494,26,4,22,2,1

8,105,105,16,10,6,3,2
29,121,121,20,1,19,2,1
20,131,131,7,7,0,1,0
16,132,132,22,19,3,2,1
32,137,137,14,2,12,4,3
4,138,138,20,8,12,4,3
19,139,139,3,3,0,1,0
26,158,158,9,6,3,2,1
24,162,162,5,5,0,1,0
27,189,189,19,4,15,2,1
11,194,194,22,6,16,2,1
0,197,197,37,10,27,2,1
18,199,199,16,5,11,2,1
1,203,203,25,25,0,1,0
28,213,213,3,3,0,1,0
13,224,224,3,3,0,1,0
2,232,232,14,9,5,2,1
22,240,240,16,16,0,1,0
30,272,272,39,24,15,4,3
10,293,293,14,14,0,1,0
3,307,307,13,13,0,1,0
17,311,311,118,118,0,1,0
14,324,324,33,33,0,1,0
23,340,340,3,3,0,1,0
25,349,349,24,24,0,1,0
15,350,350,31,31,0,1,0
5,418,418,153,83,70,3,2
21,423,423,115,61,54,3,2
9,435,435,38,38,0,1,0
6,443,443,33,33,0,1,0
7,470,470,35,35,0,1,0
31,487,487,16,5,11,2,1
12,497,497,106,76,30,4,3

23,148,148,11,11,0,1,0
16,149,149,5,2,3,2,1
24,153,153,3,3,0,1,0
19,159,159,12,12,0,1,0
17,159,159,102,102,0,1,0
26,174,174,4,4,0,1,0
11,182,182,7,7,0,1,0
15,183,183,30,30,0,1,0
27,184,184,17,17,0,1,0
20,197,197,9,5,4,2,1
30,210,210,3,3,0,1,0
29,235,235,17,17,0,1,0
5,255,255,1,1,0,1,0
25,272,272,51,51,0,1,0
31,280,280,60,2,58,3,2
13,281,281,18,14,4,2,1
6,282,282,18,6,12,4,3
21,349,349,9,2,7,2,1
12,357,357,121,121,0,1,0
1,366,366,111,75,36,2,1
2,388,388,21,8,13,2,1
18,407,407,4,4,0,1,0
4,410,410,139,86,53,4,3
8,426,426,51,46,5,2,1
3,430,430,37,17,20,2,1
22,439,439,20,20,0,1,0
7,459,459,29,3,26,4,3
28,459,459,47,39,8,3,2
10,464,464,85,85,0,1,0
0,468,468,4,1,3,2,1
9,480,480,65,47,18,4,3
14,495,495,2,2,0,1,0

23,109,109,6,6,0,1,0
35,115,115,3,3,0,1,0
25,120,120,15,15,0,1,0
30,120,120,26,8,18,4,3
3,126,126,2,2,0,1,0
41,146,146,8,8,0,1,0
37,149,149,40,40,0,1,0
24,168,168,1,1,0,1,0
1,208,208,41,17,24,3,2
10,210,210,17,17,0,1,0
14,213,213,1,1,0,1,0
40,220,220,12,1,11,2,1
38,227,227,63,24,39,3,2
5,240,240,7,7,0,1,0
39,243,243,10,10,0,1,0
20,247,247,4,4,0,1,0
33,257,257,7,7,0,1,0
16,263,263,10,10,0,1,0
11,264,264,35,35,0,1,0
21,273,273,35,35,0,1,0
27,273,273,21,21,0,1,0
36,283,283,24,24,0,1,0
17,306,306,8,8,0,1,0
15,314,314,2,2,0,1,0
13,316,316,2,2,0,1,0
18,372,372,43,1,42,4,3
2,391,391,23,2,21,4,3
9,398,398,79,10,69,4,3
26,409,409,54,33,21,4,3
34,409,409,80,39,41,2,1
0,413,413,31,28,3,2,1
7,418,418,22,14,8,3,2
22,424,424,52,52,0,1,0
8,428,428,104,74,30,2,1
31,432,432,12,12,0,1,0
12,432,432,12,5,7,2,1
19,451,451,8,8,0,1,0
4,459,459,28,28,0,1,0
6,488,488,48,24,24,2,1
32,489,489,29,5,24,4,3
29,489,489,81,33,48,3,2
28,489,489,1,1,0,1,0

1,102,102,6,3,3,2,1
17,104,104,18,18,0,1,0
31,105,105,11,1,10,3,2
18,106,106,6,6,0,1,0
4,121,121,7,1,6,2,1
30,138,138,10,4,6,3,2
13,141,141,22,4,18,2,1
32,152,152,9,9,0,1,0
19,190,190,6,2,4,2,1
20,193,193,45,45,0,1,0
10,195,195,38,38,0,1,0
5,212,212,36,9,27,4,3
8,217,217,44,18,26,3,2
0,217,217,15,15,0,1,0
22,227,227,13,1,12,2,1
16,232,232,9,9,0,1,0
21,233,233,40,40,0,1,0
2,234,234,36,36,0,1,0
28,238,238,22,10,12,4,3
9,239,239,20,4,16,3,2
7,245,245,7,3,4,2,1
23,252,252,65,19,46,2,1
24,259,259,19,8,11,2,1
3,286,286,1,1,0,1,0
26,295,295,40,40,0,1,0
6,301,301,60,60,0,1,0
11,327,327,9,4,5,2,1
29,355,355,1,1,0,1,0
27,382,382,10,4,6,2,1
15,385,385,45,19,26,3,2
25,392,392,2,2,0,1,0
12,452,452,6,6,0,1,0
14,459,459,122,80,42,3,2
33,467,467,118,46,72,4,3

28,101,101,3,3,0,1,0
6,120,120,22,13,9,2,1
10,134,134,34,10,24,4,3
4,142,142,5,5,0,1,0
30,146,146,41,8,33,4,3
18,157,157,6,6,0,1,0
11,175,175,47,47,0,1,0
2,200,200,6,6,0,1,0
31,206,206,29,29,0,1,0
20,213,213,2,2,0,1,0
14,215,215,9,9,0,1,0
8,218,218,6,6,0,1,0
3,239,239,5,5,0,1,0
15,260,260,2,2,0,1,0
22,271,271,36,36,0,1,0
25,274,274,25,25,0,1,0
12,294,294,14,7,7,2,1
9,295,295,22,1,21,3,2
7,305,305,22,2,20,3,2
0,313,313,48,48,0,1,0
23,336,336,83,5,78,4,3
17,389,389,35,9,26,3,2
1,413,413,145,90,55,4,3
32,419,419,20,2,18,4,3
13,424,424,75,75,0,1,0
16,428,428,39,1,38,3,2
27,429,429,65,57,8,2,1
5,444,444,29,12,17,4,3
29,453,453,33,5,28,2,1
21,474,474,126,68,58,3,2
19,481,481,21,21,0,1,0
26,483,483,13,13,0,1,0
24,497,497,33,15,18,4,3

30,103,103,2,2,0,1,0
24,122,122,3,3,0,1,0
18,154,154,53,33,20,2,1
3,156,156,1,1,0,1,0
15,163,163,7,7,0,1,0
0,182,182,36,36,0,1,0
29,194,194,92,92,0,1,0
7,225,225,32,32,0,1,0
8,229,229,1,1,0,1,0
14,239,239,52,25,27,2,1
25,248,248,10,10,0,1,0
11,258,258,65,34,31,2,1
22,265,265,13,13,0,1,0
20,267,267,34,8,26,2,1
23,271,271,23,23,0,1,0
6,292,292,86,11,75,4,3
21,302,302,33,11,22,2,1
10,315,315,35,16,19,4,3
26,319,319,2,2,0,1,0
17,345,345,8,2,6,2,1
12,358,358,5,5,0,1,0
27,381,381,55,15,40,4,3
19,403,403,8,2,6,3,2
31,409,409,29,29,0,1,0
2,428,428,3,3,0,1,0
13,437,437,50,50,0,1,0
5,443,443,12,9,3,2,1
4,443,443,1,1,0,1,0
28,462,462,16,6,10,3,2
16,473,473,69,42,27,2,1
32,479,479,15,1,14,2,1
1,483,483,64,64,0,1,0
33,492,492,50,50,0,1,0
34,494,494,65,65,0,1,0
9,500,500,45,45,0,1,0

2,115,115,37,1,36,2,1
13,118,118,4,4,0,1,0
3,123,123,2,2,0,1,0
31,149,149,21,21,0,1,0
18,151,151,17,8,9,4,3
30,167,167,22,19,3,2,1
24,167,167,6,2,4,2,1
14,175,175,4,1,3,2,1
29,221,221,56,51,5,2,1
16,247,247,3,3,0,1,0
7,257,257,74,4,70,3,2
21,274,274,34,34,0,1,0
23,278,278,9,3,6,3,2
27,317,317,12,12,0,1,0
28,335,335,108,12,96,4,3
6,358,358,21,9,12,2,1
9,370,370,27,18,9,4,3
19,391,391,82,28,54,4,3
5,395,395,107,60,47,2,1
1,401,401,82,82,0,1,0
11,403,403,39,9,30,4,3
20,405,405,38,38,0,1,0
32,419,419,22,22,0,1,0
0,430,430,71,71,0,1,0
12,433,433,6,6,0,1,0
4,435,435,33,5,28,3,2
15,443,443,23,23,0,1,0
25,448,448,56,7,49,2,1
17,457,457,2,2,0,1,0
26,465,465,1,1,0,1,0
10,477,477,68,35,33,3,2
8,483,483,9,6,3,2,1
22,487,487,43,43,0,1,0

16,127,127,10,1,9,2,1
3,136,136,28,1,27,4,3
15,136,136,10,10,0,1,0
2,158,158,14,14,0,1,0
29,172,172,36,6,30,3,2
9,179,179,15,15,0,1,0
24,184,184,7,7,0,1,0
12,199,199,38,20,18,4,3
0,223,223,20,20,0,1,0
11,233,233,15,1,14,2,1
14,295,295,7,1,6,2,1
22,343,343,17,17,0,1,0
18,350,350,12,7,5,2,1
27,361,361,3,3,0,1,0
20,372,372,99,67,32,2,1
4,372,372,91,91,0,1,0
26,373,373,11,11,0,1,0
25,376,376,22,22,0,1,0
19,399,399,25,25,0,1,0
5,407,407,68,15,53,3,2
1,409,409,89,89,0,1,0
7,429,429,23,11,12,3,2
28,432,432,38,17,21,4,3
6,434,434,193,114,79,4,3
8,460,460,27,27,0,1,0
10,487,487,41,29,12,3,2
21,492,492,96,96,0,1,0
17,496,496,21,5,16,3,2
13,500,500,22,1,21,4,3
23,500,500,170,140,30,4,3

10,104,104,4,4,0,1,0
36,119,119,7,7,0,1,0
1,151,151,19,3,16,3,2
14,152,152,16,16,0,1,0
7,160,160,19,10,9,4,3
8,177,177,7,1,6,3,2
26,198,198,11,11,0,1,0
6,204,204,37,14,23,2,1
34,206,206,117,117,0,1,0
24,207,207,3,3,0,1,0
15,210,210,2,2,0,1,0
25,228,228,63,38,25,2,1
5,232,232,21,21,0,1,0
31,232,232,10,10,0,1,0
30,242,242,73,23,50,3,2
32,243,243,5,1,4,2,1
35,247,247,10,4,6,2,1
4,249,249,2,2,0,1,0
28,257,257,6,6,0,1,0
22,300,300,17,17,0,1,0
16,303,303,28,28,0,1,0
33,306,306,20,20,0,1,0
13,328,328,13,13,0,1,0
2,331,331,24,6,18,4,3
12,352,352,100,57,43,4,3
18,362,362,13,7,6,2,1
11,364,364,30,30,0,1,0
3,382,382,47,23,24,4,3
17,394,394,120,120,0,1,0
9,423,423,13,5,8,2,1
21,435,435,5,2,3,2,1
19,439,439,53,53,0,1,0
29,440,440,20,4,16,2,1
27,458,458,36,2,34,3,2
0,468,468,9,2,7,2,1
20,483,483,21,11,10,3,2
23,498,498,4,4,0,1,0

28,105,105,9,3,6,3,2
4,110,110,13,7,6,2,1
26,111,111,23,3,20,3,2
22,112,112,7,7,0,1,0
10,115,115,1,1,0,1,0
13,123,123,15,15,0,1,0
24,130,130,25,25,0,1,0
30,145,145,14,14,0,1,0
34,147,147,3,3,0,1,0
27,157,157,9,9,0,1,0
2,171,171,13,13,0,1,0
20,182,182,6,6,0,1,0
3,183,183,24,8,16,3,2
33,190,190,12,12,0,1,0
9,200,200,1,1,0,1,0
12,219,219,38,38,0,1,0
25,225,225,8,1,7,2,1
21,267,267,1,1,0,1,0
15,290,290,1,1,0,1,0
0,309,309,23,8,15,4,3
19,319,319,11,11,0,1,0
14,324,324,88,88,0,1,0
16,326,326,3,3,0,1,0
5,335,335,9,1,8,3,2
1,363,363,32,32,0,1,0
8,381,381,15,15,0,1,0
31,382,382,42,42,0,1,0
29,391,391,94,59,35,4,3
17,399,399,58,58,0,1,0
23,403,403,46,30,16,3,2
6,404,404,40,3,37,2,1
32,438,438,40,4,36,2,1
7,443,443,106,40,66,3,2
11,457,457,144,112,32,4,3
18,466,466,123,108,15,4,3

16,101,101,6,6,0,1,0
18,137,137,2,2,0,1,0
5,140,140,21,3,18,2,1
1,149,149,19,19,0,1,0
23,155,155,3,3,0,1,0
4,156,156,23,2,21,4,3
8,163,163,6,1,5,2,1
13,165,165,1,1,0,1,0
22,170,170,22,22,0,1,0
30,171,171,24,24,0,1,0
33,188,188,36,30,6,3,2
20,193,193,52,20,32,3,2
26,194,194,15,3,12,2,1
34,209,209,2,2,0,1,0
3,213,213,71,16,55,4,3
32,226,226,3,3,0,1,0
2,229,229,7,7,0,1,0
31,241,241,5,5,0,1,0
19,260,260,3,3,0,1,0
10,296,296,12,3,9,2,1
7,320,320,8,8,0,1,0
14,327,327,1,1,0,1,0
9,333,333,8,2,6,3,2
24,355,355,3,3,0,1,0
6,362,362,9,9,0,1,0
37,366,366,11,5,6,3,2
35,368,368,39,21,18,2,1
28,374,374,12,12,0,1,0
25,393,393,15,15,0,1,0
29,396,396,64,56,8,3,2
12,405,405,48,3,45,2,1
15,450,450,105,105,0,1,0
11,459,459,26,26,0,1,0
27,472,472,95,95,0,1,0
21,473,473,108,36,72,3,2
36,473,473,73,49,24,4,3
17,475,475,147,69,78,3,2
0,494,494,25,25,0,1,0

18,107,107,5,1,4,2,1
35,108,108,33,24,9,4,3
28,110,110,2,2,0,1,0
31,116,116,2,2,0,1,0
29,119,119,23,23,0,1,0
23,127,127,38,38,0,1,0
8,132,132,21,11,10,2,1
17,146,146,1,1,0,1,0
3,162,162,11,11,0,1,0
5,182,182,14,14,0,1,0
25,194,194,11,11,0,1,0
16,200,200,13,13,0,1,0
12,218,218,26,26,0,1,0
32,220,220,17,11,6,3,2
34,253,253,14,9,5,2,1
22,264,264,7,7,0,1,0
15,313,313,59,35,24,2,1
1,315,315,24,5,19,2,1
9,315,315,7,7,0,1,0
10,316,316,46,46,0,1,0
11,339,339,15,15,0,1,0
14,357,357,10,10,0,1,0
7,363,363,14,4,10,2,1
13,365,365,32,19,13,2,1
2,367,367,3,3,0,1,0
6,371,371,8,8,0,1,0
21,378,378,48,48,0,1,0
26,399,399,20,20,0,1,0
19,401,401,59,23,36,2,1
27,419,419,15,15,0,1,0
4,426,426,41,15,26,3,2
38,431,431,16,16,0,1,0
33,433,433,64,50,14,2,1
36,456,456,11,8,3,2,1
37,461,461,78,25,53,4,3
24,467,467,79,69,10,3,2
30,474,474,14,5,9,2,1
20,479,479,125,79,46,3,2
0,483,483,46,46,0,1,0

27,100,100,20,20,0,1,0
6,106,106,7,7,0,1,0
15,130,130,7,7,0,1,0
26,144,144,6,6,0,1,0
9,147,147,1,1,0,1,0
21,153,153,16,16,0,1,0
25,156,156,5,5,0,1,0
31,180,180,36,24,12,4,3
4,203,203,25,25,0,1,0
12,214,214,37,37,0,1,0
3,239,239,14,14,0,1,0
2,241,241,23,23,0,1,0
13,249,249,3,3,0,1,0
33,253,253,11,11,0,1,0
20,263,263,37,37,0,1,0
23,264,264,31,31,0,1,0
34,288,288,34,34,0,1,0
30,294,294,48,37,11,2,1
28,327,327,89,89,0,1,0
0,337,337,67,67,0,1,0
14,358,358,70,28,42,4,3
29,358,358,22,4,18,3,2
22,367,367,53,37,16,3,2
16,370,370,40,33,7,2,1
10,375,375,36,36,0,1,0
11,376,376,52,1,51,4,3
7,388,388,5,5,0,1,0
19,390,390,24,24,0,1,0
24,408,408,13,4,9,2,1
32,420,420,11,11,0,1,0
17,432,432,27,27,0,1,0
1,455,455,14,14,0,1,0
5,457,457,120,120,0,1,0
18,482,482,10,1,9,4,3
8,500,500,85,49,36,4,3

5,117,117,34,3,31,2,1
15,120,120,3,3,0,1,0
13,130,130,23,23,0,1,0
30,138,138,10,10,0,1,0
23,149,149,19,19,0,1,0
2,165,165,8,2,6,3,2
14,166,166,18,8,10,3,2
1,178,178,14,14,0,1,0
3,180,180,28,28,0,1,0
11,191,191,23,23,0,1,0
16,218,218,46,46,0,1,0
8,228,228,19,4,15,2,1
24,248,248,28,22,6,2,1
7,255,255,4,1,3,2,1
26,306,306,64,41,23,2,1
20,310,310,14,14,0,1,0
19,322,322,44,28,16,2,1
29,324,324,30,30,0,1,0
4,327,327,49,49,0,1,0
22,331,331,15,15,0,1,0
6,349,349,9,5,4,2,1
25,372,372,9,2,7,2,1
12,381,381,75,39,36,4,3
17,406,406,14,14,0,1,0
0,421,421,118,52,66,3,2
28,450,450,15,15,0,1,0
9,466,466,29,8,21,3,2
27,472,472,6,2,4,2,1
31,474,474,24,24,0,1,0
21,475,475,27,7,20,2,1
18,494,494,215,176,39,4,3
10,500,500,59,59,0,1,0

6,100,100,5,1,4,2,1
27,106,106,6,6,0,1,0
25,129,129,6,6,0,1,0
9,156,156,9,1,8,3,2
5,182,182,1,1,0,1,0
39,183,183,10,10,0,1,0
11,184,184,12,12,0,1,0
23,186,186,39,29,10,2,1
28,195,195,11,7,4,2,1
2,206,206,8,3,5,2,1
19,212,212,5,1,4,2,1
26,225,225,31,31,0,1,0
4,230,230,24,20,4,2,1
1,244,244,11,11,0,1,0
31,254,254,8,8,0,1,0
29,260,260,14,14,0,1,0
7,292,292,21,1,20,3,2
17,297,297,30,12,18,2,1
37,300,300,26,26,0,1,0
22,312,312,15,3,12,4,3
15,314,314,3,3,0,1,0
20,316,316,88,69,19,2,1
12,317,317,8,8,0,1,0
24,344,344,64,3,61,4,3
34,379,379,62,40,22,2,1
14,386,386,41,26,15,2,1
10,398,398,73,73,0,1,0
36,398,398,33,19,14,3,2
0,402,402,45,3,42,2,1
32,411,411,105,33,72,4,3
3,420,420,39,1,38,4,3
16,421,421,29,13,16,2,1
33,424,424,43,32,11,2,1
21,425,425,118,118,0,1,0
38,437,437,33,33,0,1,0
35,441,441,38,38,0,1,0
8,447,447,6,3,3,2,1
13,447,447,26,26,0,1,0
30,449,449,46,36,10,3,2
18,496,496,6,6,0,1,0

14,102,102,19,2,17,2,1
28,117,117,36,9,27,4,3
27,127,127,23,11,12,3,2
12,134,134,6,6,0,1,0
9,154,154,23,16,7,2,1
34,157,157,61,61,0,1,0
16,158,158,13,10,3,2,1
4,174,174,1,1,0,1,0
10,203,203,12,12,0,1,0
19,204,204,5,1,4,2,1
5,215,215,20,6,14,2,1
26,222,222,23,6,17,2,1
22,246,246,20,20,0,1,0
6,258,258,1,1,0,1,0
2,261,261,65,11,54,4,3
8,301,301,29,29,0,1,0
0,303,303,5,5,0,1,0
21,312,312,24,24,0,1,0
11,322,322,7,7,0,1,0
3,353,353,34,14,20,2,1
29,363,363,71,17,54,3,2
33,406,406,12,12,0,1,0
7,409,409,40,8,32,3,2
15,410,410,142,31,111,4,3
23,420,420,32,32,0,1,0
30,425,425,4,4,0,1,0
13,430,430,97,97,0,1,0
18,431,431,29,29,0,1,0
1,435,435,7,7,0,1,0
25,443,443,12,12,0,1,0
35,446,446,19,1,18,4,3
32,461,461,45,23,22,2,1
31,462,462,5,5,0,1,0
20,465,465,26,8,18,4,3
24,477,477,27,27,0,1,0
17,494,494,5,2,3,2,1

8,107,107,12,3,9,4,3
31,129,129,49,49,0,1,0
28,131,131,15,9,6,3,2
18,153,153,7,7,0,1,0
17,164,164,44,14,30,3,2
9,173,173,3,3,0,1,0
19,177,177,4,4,0,1,0
25,205,205,10,10,0,1,0
4,219,219,16,6,10,3,2
11,236,236,74,5,69,4,3
7,244,244,52,52,0,1,0
23,244,244,7,7,0,1,0
2,247,247,51,5,46,3,2
26,274,274,31,31,0,1,0
3,308,308,9,5,4,2,1
30,308,308,58,19,39,2,1
14,331,331,10,10,0,1,0
21,333,333,65,58,7,2,1
5,358,358,184,148,36,3,2
0,370,370,6,1,5,2,1
32,375,375,69,56,13,2,1
16,404,404,24,24,0,1,0
20,435,435,6,6,0,1,0
12,435,435,40,17,23,2,1
6,438,438,37,7,30,3,2
13,443,443,2,2,0,1,0
1,451,451,33,9,24,3,2
27,458,458,14,2,12,2,1
10,473,473,10,3,7,2,1
29,473,473,12,12,0,1,0
22,486,486,23,23,0,1,0
24,487,487,5,5,0,1,0
15,492,492,34,34,0,1,0

29,102,102,15,3,12,4,3
33,106,106,16,16,0,1,0
24,115,115,10,10,0,1,0
1,120,120,2,2,0,1,0
6,124,124,21,8,13,2,1
20,138,138,1,1,0,1,0
32,142,142,3,3,0,1,0
27,144,144,14,14,0,1,0
12,174,174,29,2,27,4,3
35,186,186,3,3,0,1,0
5,209,209,13,1,12,3,2
9,217,217,1,1,0,1,0
19,240,240,26,2,24,2,1
34,256,256,30,2,28,3,2
10,285,285,13,13,0,1,0
26,297,297,49,31,18,4,3
15,302,302,85,59,26,2,1
30,327,327,17,17,0,1,0
17,337,337,75,37,38,2,1
23,338,338,40,40,0,1,0
21,356,356,14,14,0,1,0
8,364,364,10,10,0,1,0
2,367,367,6,2,4,2,1
18,369,369,62,9,53,3,2
13,379,379,57,24,33,2,1
3,384,384,39,23,16,3,2
22,407,407,26,26,0,1,0
28,416,416,63,3,60,3,2
0,431,431,101,101,0,1,0
31,433,433,109,109,0,1,0
14,467,467,7,1,6,3,2
11,475,475,56,56,0,1,0
25,484,484,35,10,25,2,1
4,492,492,13,1,12,2,1
16,498,498,52,52,0,1,0
7,499,499,19,19,0,1,0

23,115,115,6,3,3,2,1
30,125,125,16,4,12,4,3
18,133,133,8,8,0,1,0
16,140,140,28,5,23,2,1
26,155,155,1,1,0,1,0
37,166,166,16,13,3,2,1
22,167,167,10,1,9,2,1
33,185,185,42,28,14,2,1
15,196,196,1,1,0,1,0
29,214,214,5,5,0,1,0
1,215,215,8,8,0,1,0
13,216,216,26,26,0,1,0
21,222,222,7,7,0,1,0
8,225,225,31,8,23,2,1
3,228,228,90,12,78,3,2
32,255,255,4,4,0,1,0
14,272,272,2,2,0,1,0
20,284,284,50,29,21,4,3
11,289,289,3,3,0,1,0
35,302,302,102,57,45,4,3
5,309,309,6,6,0,1,0
2,323,323,18,18,0,1,0
7,329,329,3,3,0,1,0
10,349,349,18,14,4,2,1
4,350,350,18,18,0,1,0
31,351,351,45,45,0,1,0
25,371,371,12,12,0,1,0
12,382,382,20,20,0,1,0
6,386,386,113,113,0,1,0
27,393,393,41,17,24,4,3
19,408,408,100,86,14,2,1
9,420,420,9,4,5,2,1
34,434,434,43,27,16,2,1
28,447,447,50,50,0,1,0
0,448,448,2,2,0,1,0
17,474,474,12,12,0,1,0
24,487,487,86,45,41,3,2
36,493,493,12,12,0,1,0

25,102,102,27,3,24,2,1
24,126,126,12,3,9,4,3
16,143,143,2,2,0,1,0
19,149,149,2,2,0,1,0
5,151,151,13,3,10,3,2
13,214,214,4,4,0,1,0
10,218,218,36,36,0,1,0
20,255,255,4,4,0,1,0
9,260,260,5,5,0,1,0
18,280,280,48,8,40,2,1
8,284,284,226,129,97,4,3
6,302,302,29,1,28,3,2
4,304,304,28,1,27,3,2
12,318,318,43,43,0,1,0
22,320,320,80,42,38,2,1
7,329,329,151,118,33,4,3
0,338,338,27,13,14,2,1
2,340,340,47,47,0,1,0
14,360,360,7,7,0,1,0
21,372,372,27,21,6,3,2
23,395,395,31,31,0,1,0
3,420,420,18,18,0,1,0
15,432,432,9,3,6,3,2
17,438,438,32,5,27,2,1
1,477,477,6,3,3,2,1
11,478,478,146,103,43,2,1
26,495,495,51,51,0,1,0

25,113,113,6,2,4,2,1
29,122,122,1,1,0,1,0
35,130,130,9,9,0,1,0
40,135,135,15,15,0,1,0
7,147,147,9,9,0,1,0
18,172,172,8,8,0,1,0
42,175,175,2,2,0,1,0
2,179,179,29,7,22,2,1
37,184,184,21,12,9,4,3
27,197,197,22,22,0,1,0
10,198,198,2,2,0,1,0
6,200,200,9,9,0,1,0
32,201,201,21,21,0,1,0
15,209,209,25,2,23,2,1
22,246,246,15,15,0,1,0
26,246,246,19,19,0,1,0
21,252,252,4,4,0,1,0
3,262,262,21,8,13,2,1
14,277,277,60,6,54,4,3
1,279,279,21,21,0,1,0
13,280,280,1,1,0,1,0
34,288,288,4,4,0,1,0
23,288,288,32,14,18,2,1
17,294,294,4,4,0,1,0
41,304,304,44,44,0,1,0
31,307,307,18,8,10,2,1
24,310,310,53,15,38,3,2
36,342,342,5,5,0,1,0
20,351,351,22,22,0,1,0
30,358,358,72,35,37,3,2
5,374,374,35,18,17,2,1
11,386,386,30,30,0,1,0
28,396,396,28,22,6,2,1
16,406,406,9,3,6,3,2
4,421,421,53,53,0,1,0
19,430,430,7,1,6,3,2
33,455,455,28,25,3,2,1
9,466,466,69,33,36,3,2
38,470,470,12,12,0,1,0
39,470,470,276,276,0,1,0
0,475,475,1,1,0,1,0
12,481,481,19,19,0,1,0
8,498,498,10,2,8,2,1

15,118,118,8,2,6,2,1
0,124,124,16,2,14,2,1
14,127,127,9,9,0,1,0
12,131,131,7,7,0,1,0
42,152,152,24,24,0,1,0
3,153,153,4,4,0,1,0
20,186,186,34,20,14,2,1
9,194,194,13,6,7,2,1
22,201,201,10,2,8,3,2
19,217,217,5,5,0,1,0
18,218,218,28,28,0,1,0
35,224,224,17,1,16,2,1
32,228,228,49,49,0,1,0
27,232,232,14,14,0,1,0
38,234,234,10,10,0,1,0
31,237,237,7,7,0,1,0
28,253,253,41,14,27,4,3
25,258,258,6,6,0,1,0
21,279,279,3,3,0,1,0
11,284,284,34,34,0,1,0
16,293,293,41,7,34,2,1
29,301,301,49,21,28,2,1
8,312,312,30,30,0,1,0
33,316,316,1,1,0,1,0
2,328,328,4,4,0,1,0
1,336,336,72,67,5,2,1
34,337,337,7,7,0,1,0
41,342,342,19,10,9,2,1
36,356,356,34,34,0,1,0
24,371,371,25,25,0,1,0
4,375,375,9,1,8,3,2
6,380,380,8,8,0,1,0
13,382,382,63,6,57,4,3
23,384,384,4,4,0,1,0
10,384,384,19,19,0,1,0
39,386,386,99,48,51,4,3
37,388,388,2,2,0,1,0
30,397,397,12,12,0,1,0
17,418,418,10,1,9,2,1
26,427,427,22,10,12,2,1
5,432,432,9,9,0,1,0
7,445,445,2,2,0,1,0
43,453,453,12,9,3,2,1
40,489,489,185,124,61,3,2

18,124,124,34,4,30,2,1
16,127,127,38,38,0,1,0
34,152,152,10,4,6,2,1
21,154,154,46,46,0,1,0
14,169,169,6,6,0,1,0
28,203,203,28,2,26,3,2
37,218,218,103,33,70,3,2
20,219,219,7,7,0,1,0
33,222,222,3,3,0,1,0
10,235,235,6,2,4,2,1
36,237,237,1,1,0,1,0
27,252,252,3,3,0,1,0
24,257,257,1,1,0,1,0
32,285,285,16,4,12,4,3
26,291,291,37,37,0,1,0
1,292,292,15,1,14,2,1
8,293,293,19,19,0,1,0
25,294,294,26,9,17,2,1
35,318,318,54,54,0,1,0
31,318,318,6,6,0,1,0
11,328,328,3,3,0,1,0
23,329,329,51,51,0,1,0
15,330,330,35,25,10,2,1
4,340,340,8,8,0,1,0
12,341,341,16,16,0,1,0
9,349,349,8,8,0,1,0
5,350,350,21,21,0,1,0
3,354,354,7,7,0,1,0
6,362,362,6,6,0,1,0
38,371,371,8,8,0,1,0
0,374,374,4,1,3,2,1
13,383,383,7,7,0,1,0
22,393,393,8,8,0,1,0
7,395,395,1,1,0,1,0
30,417,417,105,3,102,4,3
17,444,444,133,105,28,3,2
39,480,480,26,26,0,1,0
2,492,492,35,10,25,2,1
19,493,493,6,6,0,1,0
29,498,498,83,83,0,1,0

17,109,109,3,3,0,1,0
1,132,132,10,2,8,2,1
26,167,167,18,1,17,3,2
21,168,168,34,7,27,2,1
24,186,186,21,5,16,3,2
19,186,186,11,1,10,2,1
12,193,193,8,8,0,1,0
6,220,220,20,20,0,1,0
9,246,246,2,2,0,1,0
27,256,256,19,8,11,3,2
2,268,268,139,92,47,2,1
4,268,268,44,44,0,1,0
8,275,275,13,13,0,1,0
28,291,291,24,24,0,1,0
23,300,300,4,4,0,1,0
30,306,306,28,28,0,1,0
18,310,310,61,13,48,4,3
10,313,313,37,37,0,1,0
15,318,318,66,54,12,2,1
16,327,327,16,4,12,2,1
25,356,356,10,4,6,3,2
0,376,376,106,49,57,4,3
14,377,377,51,51,0,1,0
7,378,378,105,105,0,1,0
29,383,383,12,12,0,1,0
11,386,386,35,3,32,2,1
20,391,391,65,65,0,1,0
3,412,412,13,13,0,1,0
5,438,438,25,15,10,3,2
13,459,459,86,86,0,1,0
22,485,485,28,28,0,1,0

3,105,105,5,5,0,1,0
25,107,107,1,1,0,1,0
37,113,113,4,1,3,2,1
31,125,125,17,2,15,4,3
38,132,132,24,24,0,1,0
9,145,145,13,8,5,2,1
8,152,152,46,46,0,1,0
30,163,163,37,9,28,3,2
42,164,164,42,16,26,2,1
11,175,175,3,3,0,1,0
39,185,185,60,60,0,1,0
5,186,186,3,3,0,1,0
1,206,206,5,5,0,1,0
14,225,225,48,48,0,1,0
21,237,237,44,26,18,2,1
33,242,242,3,3,0,1,0
6,253,253,2,2,0,1,0
24,279,279,20,20,0,1,0
19,283,283,1,1,0,1,0
4,284,284,8,8,0,1,0
0,295,295,19,19,0,1,0
12,296,296,22,3,19,2,1
20,307,307,15,12,3,2,1
18,308,308,14,14,0,1,0
10,322,322,18,18,0,1,0
13,336,336,24,24,0,1,0
35,341,341,2,2,0,1,0
26,342,342,43,13,30,3,2
22,353,353,25,11,14,3,2
36,396,396,28,16,12,3,2
2,404,404,50,50,0,1,0
7,411,411,28,28,0,1,0
40,418,418,19,10,9,4,3
29,419,419,31,22,9,4,3
43,430,430,42,20,22,3,2
41,450,450,22,22,0,1,0
28,452,452,4,4,0,1,0
23,453,453,6,6,0,1,0
32,461,461,17,17,0,1,0
17,473,473,8,2,6,3,2
15,474,474,40,7,33,2,1
16,491,491,26,20,6,3,2
27,494,494,43,37,6,2,1
34,495,495,27,27,0,1,0

32,120,120,32,21,11,2,1
5,121,121,27,16,11,2,1
14,150,150,31,16,15,2,1
36,164,164,5,5,0,1,0
9,167,167,10,10,0,1,0
27,168,168,1,1,0,1,0
31,168,168,6,6,0,1,0
13,186,186,38,38,0,1,0
0,210,210,2,2,0,1,0
12,212,212,39,39,0,1,0
7,226,226,10,10,0,1,0
30,238,238,42,42,0,1,0
23,250,250,14,4,10,3,2
1,273,273,3,3,0,1,0
26,278,278,42,42,0,1,0
21,280,280,18,14,4,2,1
20,286,286,12,3,9,2,1
19,311,311,20,20,0,1,0
39,324,324,30,5,25,3,2
16,332,332,19,10,9,4,3
37,343,343,44,25,19,2,1
15,366,366,26,26,0,1,0
11,369,369,18,18,0,1,0
38,371,371,4,4,0,1,0
28,381,381,55,6,49,2,1
33,381,381,3,3,0,1,0
24,388,388,17,17,0,1,0
25,394,394,51,27,24,4,3
34,398,398,145,46,99,4,3
35,400,400,33,33,0,1,0
4,404,404,20,14,6,2,1
22,427,427,42,20,22,3,2
29,437,437,6,1,5,2,1
18,439,439,54,54,0,1,0
3,452,452,20,20,0,1,0
10,465,465,21,15,6,2,1
6,467,467,41,14,27,4,3
2,474,474,19,7,12,3,2
17,489,489,3,3,0,1,0
8,495,495,58,50,8,2,1

34,103,103,18,18,0,1,0
37,110,110,9,9,0,1,0
2,118,118,59,59,0,1,0
32,122,122,14,14,0,1,0
22,157,157,16,2,14,3,2
5,166,166,16,16,0,1,0
4,171,171,7,7,0,1,0
7,173,173,1,1,0,1,0
16,174,174,21,21,0,1,0
36,187,187,19,1,18,3,2
9,194,194,5,5,0,1,0
27,195,195,14,14,0,1,0
13,204,204,41,41,0,1,0
15,215,215,14,6,8,2,1
0,242,242,34,19,15,4,3
30,259,259,20,11,9,3,2
24,261,261,55,55,0,1,0
29,264,264,39,15,24,4,3
18,267,267,27,27,0,1,0
19,274,274,3,3,0,1,0
28,279,279,26,26,0,1,0
14,283,283,46,2,44,2,1
25,284,284,32,32,0,1,0
35,304,304,24,24,0,1,0
11,328,328,25,15,10,4,3
17,338,338,1,1,0,1,0
23,339,339,32,17,15,2,1
6,361,361,8,8,0,1,0
1,367,367,25,2,23,2,1
21,378,378,15,15,0,1,0
26,412,412,20,9,11,2,1
10,432,432,11,5,6,2,1
38,442,442,59,59,0,1,0
3,449,449,9,3,6,2,1
12,464,464,9,9,0,1,0
8,474,474,31,7,24,2,1
20,480,480,15,3,12,2,1
31,482,482,23,23,0,1,0
33,489,489,52,52,0,1,0

16,126,126,27,27,0,1,0
5,127,127,19,19,0,1,0
22,152,152,22,22,0,1,0
9,162,162,37,8,29,2,1
17,165,165,31,31,0,1,0
15,167,167,25,4,21,2,1
20,168,168,5,2,3,2,1
21,179,179,20,20,0,1,0
23,200,200,52,52,0,1,0
7,209,209,16,8,8,3,2
11,219,219,72,72,0,1,0
1,220,220,35,24,11,2,1
28,238,238,3,3,0,1,0
27,307,307,11,11,0,1,0
30,312,312,48,33,15,2,1
18,332,332,17,11,6,3,2
8,340,340,37,37,0,1,0
25,349,349,39,9,30,3,2
29,349,349,9,9,0,1,0
10,350,350,2,2,0,1,0
19,356,356,31,31,0,1,0
0,374,374,40,40,0,1,0
12,386,386,6,6,0,1,0
24,417,417,14,2,12,2,1
31,419,419,36,36,0,1,0
6,420,420,2,2,0,1,0
3,431,431,114,40,74,3,2
26,432,432,19,19,0,1,0
14,443,443,47,19,28,3,2
13,475,475,69,53,16,2,1
2,482,482,76,76,0,1,0
4,494,494,24,3,21,4,3

16,147,147,12,12,0,1,0
22,171,171,39,39,0,1,0
2,172,172,47,47,0,1,0
26,191,191,12,12,0,1,0
25,215,215,92,64,28,2,1
33,224,224,25,25,0,1,0
39,226,226,4,1,3,2,1
11,240,240,27,19,8,2,1
17,241,241,36,36,0,1,0
27,244,244,1,1,0,1,0
12,249,249,3,3,0,1,0
37,257,257,12,2,10,2,1
28,262,262,48,48,0,1,0
30,263,263,13,13,0,1,0
8,281,281,24,6,18,2,1
29,286,286,28,28,0,1,0
14,300,300,12,12,0,1,0
18,320,320,1,1,0,1,0
21,341,341,32,5,27,2,1
24,344,344,28,28,0,1,0
20,346,346,2,2,0,1,0
32,347,347,13,13,0,1,0
10,356,356,13,8,5,2,1
1,364,364,31,31,0,1,0
19,374,374,39,25,14,2,1
34,387,387,65,19,46,3,2
7,389,389,13,13,0,1,0
35,399,399,42,42,0,1,0
5,418,418,38,38,0,1,0
15,428,428,58,12,46,4,3
3,432,432,25,17,8,2,1
6,444,444,38,38,0,1,0
13,450,450,4,4,0,1,0
23,452,452,2,2,0,1,0
38,454,454,51,6,45,2,1
31,455,455,15,15,0,1,0
0,461,461,8,8,0,1,0
4,465,465,1,1,0,1,0
9,490,490,140,134,6,3,2
36,498,498,28,10,18,4,3

22,111,111,15,15,0,1,0
0,123,123,3,3,0,1,0
26,129,129,15,5,10,3,2
7,145,145,1,1,0,1,0
37,145,145,27,27,0,1,0
9,159,159,43,43,0,1,0
10,165,165,6,6,0,1,0
27,175,175,40,1,39,3,2
8,178,178,7,1,6,2,1
24,189,189,22,22,0,1,0
12,192,192,1,1,0,1,0
4,193,193,10,10,0,1,0
28,199,199,56,56,0,1,0
16,218,218,34,24,10,2,1
23,221,221,14,14,0,1,0
21,237,237,14,14,0,1,0
6,240,240,5,5,0,1,0
5,246,246,1,1,0,1,0
14,259,259,8,8,0,1,0
3,264,264,34,34,0,1,0
13,265,265,51,29,22,2,1
30,266,266,5,5,0,1,0
34,272,272,28,28,0,1,0
18,315,315,35,35,0,1,0
17,319,319,89,43,46,3,2
20,345,345,30,30,0,1,0
11,365,365,18,18,0,1,0
33,409,409,27,11,16,3,2
36,418,418,7,4,3,2,1
19,419,419,69,69,0,1,0
1,426,426,45,45,0,1,0
35,432,432,4,4,0,1,0
29,436,436,89,31,58,3,2
25,457,457,36,24,12,2,1
32,467,467,13,8,5,2,1
2,477,477,1,1,0,1,0
15,480,480,59,59,0,1,0
31,486,486,22,13,9,4,3

2,106,106,34,13,21,4,3
46,118,118,2,2,0,1,0
9,132,132,13,13,0,1,0
35,133,133,10,10,0,1,0
14,135,135,11,3,8,2,1
52,139,139,51,51,0,1,0
22,141,141,4,1,3,2,1
6,142,142,3,3,0,1,0
15,142,142,1,1,0,1,0
49,143,143,5,5,0,1,0
40,150,150,3,3,0,1,0
34,152,152,26,2,24,3,2
37,164,164,11,11,0,1,0
39,194,194,20,9,11,2,1
26,196,196,1,1,0,1,0
18,196,196,11,1,10,3,2
31,198,198,2,2,0,1,0
44,204,204,3,3,0,1,0
17,209,209,6,6,0,1,0
24,218,218,11,11,0,1,0
7,225,225,2,2,0,1,0
50,245,245,32,23,9,4,3
5,248,248,1,1,0,1,0
25,249,249,27,12,15,2,1
11,254,254,13,13,0,1,0
30,259,259,1,1,0,1,0
13,267,267,50,18,32,3,2
47,280,280,88,37,51,4,3
19,290,290,3,3,0,1,0
38,292,292,3,3,0,1,0
8,303,303,9,9,0,1,0
43,328,328,4,4,0,1,0
32,330,330,8,8,0,1,0
28,331,331,12,12,0,1,0
53,334,334,24,24,0,1,0
16,343,343,7,4,3,2,1
45,348,348,22,7,15,2,1
29,354,354,1,1,0,1,0
1,361,361,1,1,0,1,0
4,365,365,12,6,6,2,1
48,367,367,34,34,0,1,0
0,378,378,1,1,0,1,0
36,381,381,12,12,0,1,0
3,381,381,12,12,0,1,0
27,382,382,24,9,15,4,3
51,384,384,36,36,0,1,0
20,387,387,3,3,0,1,0
12,393,393,4,4,0,1,0
42,401,401,34,19,15,4,3
41,420,420,133,101,32,2,1
33,464,464,44,44,0,1,0
23,478,478,16,16,0,1,0
10,492,492,14,14,0,1,0
21,496,496,26,26,0,1,0

12,122,122,4,4,0,1,0
29,124,124,19,5,14,2,1
21,138,138,6,2,4,2,1
28,141,141,3,3,0,1,0
19,157,157,22,22,0,1,0
27,161,161,81,53,28,2,1
24,166,166,6,1,5,2,1
3,179,179,67,46,21,2,1
25,190,190,13,2,11,2,1
16,213,213,9,5,4,2,1
32,213,213,11,2,9,2,1
7,224,224,4,4,0,1,0
6,242,242,7,1,6,3,2
26,248,248,39,39,0,1,0
11,251,251,16,4,12,2,1
13,256,256,11,11,0,1,0
15,262,262,24,24,0,1,0
4,288,288,22,13,9,3,2
18,293,293,25,2,23,2,1
14,321,321,9,9,0,1,0
35,330,330,33,1,32,3,2
1,331,331,77,77,0,1,0
23,334,334,3,3,0,1,0
37,348,348,29,29,0,1,0
34,359,359,52,8,44,3,2
30,368,368,68,8,60,3,2
20,385,385,5,2,3,2,1
17,398,398,37,37,0,1,0
2,399,399,24,24,0,1,0
9,423,423,38,38,0,1,0
33,431,431,62,62,0,1,0
31,432,432,2,2,0,1,0
0,437,437,7,7,0,1,0
8,453,453,31,3,28,2,1
22,461,461,53,53,0,1,0
10,483,483,89,4,85,3,2
5,485,485,16,16,0,1,0
36,491,491,1,1,0,1,0

10,102,102,19,1,18,3,2
18,111,111,6,2,4,2,1
7,119,119,10,10,0,1,0
25,146,146,16,16,0,1,0
14,150,150,21,16,5,2,1
28,157,157,33,33,0,1,0
8,163,163,2,2,0,1,0
36,185,185,4,4,0,1,0
5,222,222,4,4,0,1,0
32,238,238,10,10,0,1,0
23,292,292,35,1,34,2,1
30,301,301,2,2,0,1,0
6,323,323,10,10,0,1,0
11,329,329,1,1,0,1,0
16,329,329,1,1,0,1,0
4,331,331,56,41,15,2,1
29,342,342,16,4,12,4,3
26,344,344,57,47,10,3,2
27,344,344,31,21,10,3,2
1,350,350,29,2,27,2,1
34,359,359,75,53,22,3,2
13,364,364,46,46,0,1,0
0,372,372,32,32,0,1,0
17,377,377,23,8,15,4,3
33,396,396,14,2,12,3,2
24,400,400,21,12,9,4,3
3,406,406,73,54,19,2,1
22,414,414,17,11,6,3,2
31,419,419,20,20,0,1,0
9,424,424,78,78,0,1,0
15,433,433,135,67,68,3,2
35,448,448,20,20,0,1,0
21,461,461,9,1,8,3,2
12,468,468,33,11,22,3,2
19,489,489,181,162,19,2,1
20,492,492,99,99,0,1,0
2,495,495,1,1,0,1,0

0,102,102,11,11,0,1,0
23,138,138,6,6,0,1,0
21,147,147,5,5,0,1,0
16,157,157,40,18,22,3,2
13,204,204,61,61,0,1,0
4,212,212,7,1,6,2,1
3,224,224,19,19,0,1,0
17,228,228,50,50,0,1,0
5,267,267,32,32,0,1,0
18,293,293,26,26,0,1,0
25,299,299,8,5,3,2,1
26,308,308,37,37,0,1,0
14,328,328,13,1,12,4,3
27,331,331,13,13,0,1,0
28,343,343,13,1,12,2,1
2,351,351,40,13,27,2,1
15,373,373,10,7,3,2,1
11,382,382,196,196,0,1,0
19,387,387,82,40,42,4,3
24,390,390,46,46,0,1,0
7,400,400,117,117,0,1,0
12,411,411,12,12,0,1,0
20,413,413,1,1,0,1,0
10,432,432,1,1,0,1,0
6,438,438,54,24,30,4,3
8,463,463,7,3,4,2,1
29,476,476,10,3,7,3,2
9,479,479,45,45,0,1,0
22,483,483,106,83,23,2,1
1,495,495,149,101,48,3,2

37,103,103,4,4,0,1,0
35,105,105,6,1,5,2,1
31,134,134,1,1,0,1,0
2,142,142,1,1,0,1,0
13,150,150,7,7,0,1,0
32,178,178,4,4,0,1,0
23,183,183,9,5,4,2,1
12,188,188,19,19,0,1,0
9,188,188,5,5,0,1,0
18,196,196,21,21,0,1,0
22,198,198,17,1,16,4,3
5,217,217,15,15,0,1,0
4,222,222,20,8,12,2,1
19,222,222,15,15,0,1,0
34,223,223,6,6,0,1,0
38,225,225,76,76,0,1,0
17,239,239,33,33,0,1,0
10,270,270,4,4,0,1,0
7,270,270,6,6,0,1,0
8,321,321,4,4,0,1,0
0,333,333,133,110,23,2,1
27,336,336,4,4,0,1,0
3,337,337,15,9,6,2,1
25,364,364,131,131,0,1,0
26,372,372,35,26,9,4,3
24,418,418,46,46,0,1,0
28,419,419,77,1,76,3,2
14,431,431,37,37,0,1,0
6,459,459,20,20,0,1,0
30,463,463,30,30,0,1,0
21,467,467,20,20,0,1,0
29,470,470,67,13,54,4,3
15,474,474,120,20,100,3,2
20,477,477,14,10,4,2,1
1,489,489,20,20,0,1,0
36,492,492,3,3,0,1,0
33,494,494,94,86,8,3,2
11,495,495,12,12,0,1,0
16,495,495,88,56,32,3,2

9,127,127,7,7,0,1,0
7,132,132,6,6,0,1,0
40,143,143,19,6,13,2,1
33,147,147,3,3,0,1,0
14,161,161,28,28,0,1,0
36,166,166,66,56,10,3,2
43,186,186,1,1,0,1,0
21,198,198,12,12,0,1,0
17,209,209,24,24,0,1,0
38,235,235,48,8,40,3,2
37,247,247,5,5,0,1,0
29,256,256,68,35,33,4,3
31,259,259,6,6,0,1,0
24,266,266,13,5,8,3,2
39,276,276,28,28,0,1,0
4,282,282,27,13,14,2,1
19,287,287,22,22,0,1,0
32,310,310,56,56,0,1,0
34,327,327,38,32,6,3,2
20,339,339,19,19,0,1,0
28,348,348,12,12,0,1,0
11,352,352,33,19,14,3,2
6,360,360,19,8,11,2,1
23,367,367,32,6,26,2,1
25,370,370,4,4,0,1,0
26,383,383,2,2,0,1,0
15,385,385,52,27,25,2,1
42,387,387,1,1,0,1,0
22,389,389,6,6,0,1,0
10,396,396,1,1,0,1,0
44,399,399,20,20,0,1,0
5,400,400,34,15,19,4,3
1,400,400,8,8,0,1,0
16,436,436,45,45,0,1,0
2,441,441,29,9,20,2,1
0,448,448,30,1,29,2,1
12,465,465,60,38,22,2,1
35,470,470,10,10,0,1,0
8,470,470,59,59,0,1,0
3,472,472,5,5,0,1,0
41,479,479,18,3,15,4,3
27,498,498,102,10,92,3,2
13,499,499,14,3,11,2,1
30,500,500,4,4,0,1,0
18,500,500,19,3,16,3,2

24,105,105,3,3,0,1,0
9,114,114,17,3,14,3,2
25,138,138,2,2,0,1,0
16,138,138,23,11,12,3,2
32,142,142,28,4,24,4,3
26,165,165,3,3,0,1,0
30,168,168,23,23,0,1,0
8,168,168,16,1,15,2,1
37,205,205,15,6,9,2,1
35,206,206,29,29,0,1,0
28,206,206,2,2,0,1,0
27,217,217,52,10,42,3,2
12,220,220,9,1,8,2,1
15,221,221,19,6,13,2,1
1,229,229,18,18,0,1,0
22,231,231,41,41,0,1,0
34,248,248,16,6,10,2,1
19,251,251,25,25,0,1,0
0,254,254,38,14,24,3,2
18,259,259,15,7,8,2,1
14,267,267,27,11,16,2,1
13,276,276,4,4,0,1,0
23,280,280,32,23,9,4,3
3,292,292,29,29,0,1,0
36,296,296,73,73,0,1,0
21,307,307,37,7,30,4,3
7,310,310,11,11,0,1,0
6,319,319,2,2,0,1,0
10,339,339,1,1,0,1,0
11,341,341,6,6,0,1,0
20,357,357,1,1,0,1,0
5,361,361,108,102,6,2,1
38,374,374,26,26,0,1,0
31,434,434,40,40,0,1,0
29,443,443,12,12,0,1,0
4,464,464,44,44,0,1,0
33,470,470,36,36,0,1,0
2,472,472,25,25,0,1,0
17,495,495,74,62,12,4,3

38,102,102,4,4,0,1,0
28,109,109,10,10,0,1,0
26,122,122,7,7,0,1,0
20,125,125,1,1,0,1,0
24,128,128,5,5,0,1,0
36,141,141,5,2,3,2,1
16,148,148,2,2,0,1,0
21,149,149,42,42,0,1,0
31,154,154,6,6,0,1,0
29,158,158,3,3,0,1,0
9,206,206,11,11,0,1,0
35,222,222,16,4,12,4,3
1,226,226,3,3,0,1,0
34,228,228,27,9,18,4,3
7,262,262,2,2,0,1,0
5,268,268,38,20,18,4,3
3,269,269,8,8,0,1,0
19,270,270,31,23,8,3,2
8,272,272,6,1,5,2,1
23,283,283,40,40,0,1,0
18,297,297,76,76,0,1,0
22,329,329,24,12,12,3,2
27,338,338,81,42,39,4,3
17,353,353,29,29,0,1,0
10,357,357,4,4,0,1,0
6,363,363,34,12,22,3,2
30,364,364,22,22,0,1,0
15,368,368,50,27,23,2,1
11,369,369,11,7,4,2,1
0,381,381,74,74,0,1,0
39,383,383,68,68,0,1,0
40,391,391,36,28,8,2,1
12,404,404,21,21,0,1,0
2,424,424,10,10,0,1,0
14,434,434,2,2,0,1,0
33,438,438,134,111,23,2,1
13,462,462,67,67,0,1,0
37,467,467,93,93,0,1,0
4,484,484,7,2,5,2,1
32,486,486,50,35,15,2,1
25,487,487,3,3,0,1,0

10,101,101,2,2,0,1,0
22,103,103,22,22,0,1,0
2,110,110,8,8,0,1,0
11,113,113,4,4,0,1,0
12,161,161,10,10,0,1,0
14,174,174,1,1,0,1,0
4,180,180,20,6,14,2,1
16,182,182,52,52,0,1,0
35,187,187,18,1,17,4,3
18,221,221,2,2,0,1,0
15,226,226,27,5,22,3,2
0,231,231,28,10,18,3,2
5,232,232,53,8,45,2,1
13,240,240,8,8,0,1,0
19,247,247,35,35,0,1,0
30,263,263,9,2,7,2,1
29,267,267,7,7,0,1,0
3,268,268,1,1,0,1,0
20,301,301,16,16,0,1,0
33,308,308,9,9,0,1,0
32,313,313,54,3,51,4,3
23,313,313,24,9,15,4,3
34,313,313,103,91,12,3,2
8,317,317,55,44,11,2,1
31,322,322,25,7,18,4,3
24,368,368,102,59,43,4,3
6,375,375,23,10,13,2,1
9,411,411,34,26,8,3,2
36,421,421,18,18,0,1,0
1,429,429,45,12,33,4,3
28,438,438,8,8,0,1,0
37,442,442,28,6,22,3,2
26,448,448,16,7,9,2,1
21,452,452,5,1,4,2,1
27,466,466,15,15,0,1,0
7,475,475,35,30,5,2,1
17,480,480,2,2,0,1,0
38,485,485,69,57,12,3,2
25,494,494,75,75,0,1,0

32,108,108,34,34,0,1,0
17,115,115,16,16,0,1,0
3,122,122,2,2,0,1,0
12,124,124,26,10,16,2,1
18,127,127,6,6,0,1,0
14,132,132,1,1,0,1,0
1,137,137,11,7,4,2,1
36,143,143,17,17,0,1,0
35,146,146,2,2,0,1,0
2,159,159,5,5,0,1,0
22,161,161,4,4,0,1,0
16,162,162,14,14,0,1,0
20,181,181,56,44,12,4,3
13,194,194,28,6,22,3,2
19,225,225,17,5,12,2,1
15,235,235,2,2,0,1,0
29,237,237,33,11,22,3,2
30,244,244,4,4,0,1,0
11,256,256,34,34,0,1,0
0,265,265,24,4,20,4,3
34,268,268,15,15,0,1,0
7,274,274,37,37,0,1,0
31,287,287,7,2,5,2,1
4,289,289,3,3,0,1,0
9,292,292,3,3,0,1,0
6,312,312,32,32,0,1,0
8,339,339,40,40,0,1,0
38,355,355,32,2,30,2,1
28,369,369,141,141,0,1,0
37,391,391,30,30,0,1,0
5,397,397,16,2,14,2,1
10,425,425,4,4,0,1,0
21,437,437,22,22,0,1,0
26,453,453,18,18,0,1,0
24,456,456,5,5,0,1,0
23,458,458,72,72,0,1,0
25,475,475,14,14,0,1,0
27,477,477,20,20,0,1,0
33,494,494,121,121,0,1,0

8,103,103,12,5,7,2,1
10,111,111,4,1,3,2,1
35,112,112,15,15,0,1,0
1,122,122,10,10,0,1,0
2,122,122,9,9,0,1,0
14,146,146,5,5,0,1,0
26,155,155,8,8,0,1,0
27,166,166,21,1,20,3,2
30,174,174,12,4,8,3,2
4,187,187,19,7,12,3,2
32,209,209,9,9,0,1,0
16,250,250,19,4,15,4,3
33,255,255,1,1,0,1,0
11,258,258,43,13,30,2,1
22,261,261,27,27,0,1,0
9,268,268,27,8,19,2,1
12,271,271,68,22,46,3,2
25,297,297,27,13,14,2,1
18,299,299,5,1,4,2,1
6,300,300,20,20,0,1,0
29,303,303,57,36,21,4,3
5,310,310,25,25,0,1,0
36,315,315,49,11,38,4,3
15,320,320,28,28,0,1,0
20,327,327,38,32,6,2,1
17,343,343,101,47,54,4,3
7,378,378,2,2,0,1,0
13,392,392,9,6,3,2,1
23,399,399,64,26,38,3,2
37,412,412,42,23,19,2,1
3,436,436,54,54,0,1,0
0,436,436,18,4,14,2,1
28,437,437,88,34,54,4,3
24,443,443,5,5,0,1,0
31,444,444,1,1,0,1,0
21,468,468,55,55,0,1,0
19,483,483,11,1,10,2,1
34,486,486,75,62,13,2,1

29,133,133,22,2,20,4,3
2,145,145,17,17,0,1,0
27,150,150,11,11,0,1,0
32,151,151,15,12,3,2,1
17,168,168,21,21,0,1,0
24,191,191,11,11,0,1,0
0,192,192,20,5,15,4,3
5,229,229,13,13,0,1,0
10,236,236,6,6,0,1,0
23,245,245,21,21,0,1,0
35,265,265,45,35,10,2,1
8,268,268,6,6,0,1,0
16,280,280,14,14,0,1,0
26,286,286,23,23,0,1,0
9,301,301,51,6,45,4,3
34,327,327,61,35,26,2,1
22,329,329,56,56,0,1,0
7,330,330,11,11,0,1,0
3,331,331,69,69,0,1,0
13,333,333,24,24,0,1,0
21,342,342,52,31,21,3,2
15,343,343,30,21,9,2,1
4,344,344,9,9,0,1,0
20,349,349,14,1,13,3,2
14,393,393,66,66,0,1,0
1,395,395,13,13,0,1,0
18,397,397,15,15,0,1,0
6,405,405,106,106,0,1,0
25,407,407,21,21,0,1,0
31,422,422,121,55,66,4,3
12,431,431,102,61,41,4,3
11,435,435,2,2,0,1,0
30,445,445,6,6,0,1,0
28,455,455,18,18,0,1,0
19,465,465,56,48,8,3,2
33,482,482,4,1,3,2,1

8,107,107,24,9,15,4,3
31,128,128,10,10,0,1,0
4,132,132,14,14,0,1,0
30,134,134,45,45,0,1,0
10,137,137,14,5,9,2,1
6,152,152,8,8,0,1,0
33,155,155,11,2,9,4,3
22,165,165,32,2,30,2,1
19,191,191,7,7,0,1,0
9,194,194,11,2,9,2,1
27,196,196,1,1,0,1,0
35,204,204,15,1,14,3,2
34,209,209,17,17,0,1,0
18,230,230,18,2,16,4,3
26,245,245,22,18,4,2,1
28,247,247,20,6,14,3,2
29,255,255,50,10,40,2,1
13,262,262,29,22,7,2,1
1,291,291,39,39,0,1,0
16,301,301,1,1,0,1,0
14,302,302,87,87,0,1,0
20,303,303,25,20,5,2,1
15,304,304,103,103,0,1,0
25,330,330,37,37,0,1,0
17,335,335,6,3,3,2,1
32,362,362,61,61,0,1,0
0,366,366,29,16,13,2,1
21,376,376,47,47,0,1,0
12,399,399,7,7,0,1,0
11,399,399,17,6,11,2,1
2,426,426,78,60,18,2,1
23,430,430,4,1,3,2,1
5,437,437,15,15,0,1,0
3,484,484,4,1,3,2,1
24,491,491,9,9,0,1,0
7,500,500,1,1,0,1,0

2,101,101,23,2,21,2,1
25,118,118,9,3,6,3,2
5,124,124,5,5,0,1,0
22,132,132,4,4,0,1,0
21,147,147,13,13,0,1,0
26,167,167,48,48,0,1,0
32,173,173,2,2,0,1,0
18,194,194,8,8,0,1,0
17,214,214,54,36,18,4,3
24,220,220,3,3,0,1,0
9,255,255,42,2,40,3,2
28,258,258,2,2,0,1,0
13,268,268,14,14,0,1,0
19,277,277,42,42,0,1,0
1,280,280,22,22,0,1,0
14,294,294,23,5,18,4,3
0,305,305,26,6,20,3,2
23,308,308,31,16,15,4,3
15,315,315,40,26,14,2,1
31,317,317,109,53,56,3,2
27,327,327,47,47,0,1,0
7,333,333,3,3,0,1,0
16,340,340,12,12,0,1,0
4,349,349,15,1,14,2,1
20,366,366,48,26,22,3,2
10,370,370,67,67,0,1,0
12,380,380,18,6,12,4,3
3,390,390,26,7,19,2,1
6,393,393,20,20,0,1,0
30,395,395,11,11,0,1,0
33,400,400,48,7,41,2,1
35,401,401,10,10,0,1,0
29,410,410,80,8,72,3,2
8,430,430,16,16,0,1,0
11,466,466,104,104,0,1,0
34,491,491,20,20,0,1,0

29,114,114,15,5,10,3,2
8,120,120,37,37,0,1,0
30,126,126,17,7,10,3,2
23,128,128,25,25,0,1,0
17,144,144,8,2,6,2,1
20,150,150,1,1,0,1,0
7,180,180,13,5,8,3,2
11,189,189,15,15,0,1,0
21,217,217,12,5,7,2,1
3,228,228,35,35,0,1,0
5,236,236,35,27,8,2,1
2,257,257,22,16,6,2,1
10,260,260,46,46,0,1,0
24,271,271,7,7,0,1,0
14,315,315,137,137,0,1,0
19,316,316,50,50,0,1,0
1,331,331,34,34,0,1,0
13,339,339,30,30,0,1,0
4,352,352,47,11,36,4,3
27,360,360,19,19,0,1,0
12,371,371,8,5,3,2,1
16,372,372,70,34,36,2,1
18,377,377,20,4,16,2,1
6,396,396,56,12,44,2,1
0,434,434,43,43,0,1,0
26,442,442,4,4,0,1,0
28,446,446,4,4,0,1,0
15,452,452,14,5,9,2,1
25,455,455,12,7,5,2,1
9,478,478,133,133,0,1,0
22,496,496,90,58,32,3,2

15,122,122,2,2,0,1,0
11,129,129,10,5,5,2,1
16,144,144,20,20,0,1,0
28,187,187,13,2,11,2,1
25,195,195,11,11,0,1,0
6,208,208,19,19,0,1,0
32,210,210,31,19,12,2,1
20,215,215,29,29,0,1,0
31,219,219,48,16,32,2,1
1,224,224,10,10,0,1,0
12,255,255,1,1,0,1,0
13,259,259,53,53,0,1,0
21,264,264,31,10,21,4,3
10,285,285,24,24,0,1,0
17,298,298,22,19,3,2,1
30,304,304,23,3,20,2,1
2,307,307,37,6,31,3,2
27,314,314,1,1,0,1,0
4,323,323,56,37,19,2,1
34,327,327,13,13,0,1,0
26,331,331,53,53,0,1,0
9,339,339,49,49,0,1,0
35,361,361,98,82,16,3,2
19,362,362,22,22,0,1,0
8,377,377,11,1,10,3,2
0,378,378,59,23,36,4,3
22,389,389,4,1,3,2,1
14,391,391,42,42,0,1,0
23,407,407,17,17,0,1,0
29,421,421,82,34,48,4,3
7,440,440,15,15,0,1,0
33,452,452,37,13,24,3,2
24,462,462,5,2,3,2,1
18,471,471,62,10,52,3,2
5,482,482,109,109,0,1,0
3,494,494,37,37,0,1,0

22,110,110,6,6,0,1,0
1,121,121,48,48,0,1,0
26,141,141,5,5,0,1,0
21,145,145,8,8,0,1,0
27,169,169,2,2,0,1,0
12,173,173,22,22,0,1,0
20,186,186,7,4,3,2,1
24,189,189,21,15,6,2,1
15,199,199,11,11,0,1,0
3,212,212,28,28,0,1,0
25,224,224,42,42,0,1,0
32,255,255,7,7,0,1,0
28,280,280,5,1,4,2,1
0,284,284,6,6,0,1,0
33,289,289,12,3,9,4,3
2,300,300,8,8,0,1,0
18,308,308,7,1,6,3,2
16,317,317,7,7,0,1,0
17,317,317,81,81,0,1,0
10,323,323,17,10,7,2,1
14,339,339,41,22,19,2,1
6,349,349,17,17,0,1,0
11,366,366,12,12,0,1,0
9,374,374,67,17,50,4,3
29,377,377,35,35,0,1,0
13,402,402,82,82,0,1,0
31,404,404,250,169,81,4,3
23,409,409,41,3,38,2,1
5,412,412,96,92,4,2,1
8,425,425,16,16,0,1,0
4,429,429,13,7,6,2,1
19,444,444,16,16,0,1,0
30,465,465,54,54,0,1,0
7,467,467,48,48,0,1,0

31,111,111,5,5,0,1,0
4,130,130,6,6,0,1,0
16,132,132,9,4,5,2,1
32,159,159,1,1,0,1,0
20,165,165,1,1,0,1,0
25,170,170,31,31,0,1,0
27,191,191,5,5,0,1,0
5,193,193,63,63,0,1,0
26,196,196,58,54,4,2,1
24,216,216,8,8,0,1,0
6,218,218,1,1,0,1,0
30,219,219,2,2,0,1,0
11,224,224,1,1,0,1,0
0,233,233,26,4,22,2,1
34,236,236,1,1,0,1,0
19,252,252,15,5,10,3,2
12,255,255,1,1,0,1,0
18,257,257,1,1,0,1,0
23,264,264,24,24,0,1,0
37,304,304,32,32,0,1,0
36,321,321,20,20,0,1,0
3,335,335,75,75,0,1,0
22,345,345,122,116,6,3,2
9,349,349,84,84,0,1,0
7,350,350,50,50,0,1,0
2,359,359,66,22,44,2,1
8,363,363,1,1,0,1,0
29,380,380,25,25,0,1,0
10,423,423,25,4,21,4,3
28,426,426,47,5,42,4,3
14,428,428,62,62,0,1,0
35,436,436,108,68,40,3,2
17,458,458,6,2,4,2,1
33,459,459,15,15,0,1,0
21,464,464,71,56,15,2,1
13,468,468,39,39,0,1,0
1,484,484,36,25,11,2,1
15,499,499,2,2,0,1,0

21,103,103,12,12,0,1,0
0,111,111,6,6,0,1,0
15,131,131,8,1,7,2,1
4,133,133,21,21,0,1,0
13,155,155,6,6,0,1,0
28,172,172,10,3,7,2,1
5,174,174,20,2,18,4,3
3,177,177,3,3,0,1,0
7,183,183,3,3,0,1,0
33,218,218,8,8,0,1,0
17,233,233,44,44,0,1,0
6,241,241,14,10,4,2,1
26,245,245,53,21,32,2,1
24,248,248,12,12,0,1,0
12,257,257,13,13,0,1,0
27,259,259,15,15,0,1,0
19,289,289,13,13,0,1,0
10,299,299,12,2,10,3,2
32,310,310,16,16,0,1,0
25,311,311,49,49,0,1,0
14,336,336,29,20,9,2,1
9,338,338,60,36,24,4,3
35,361,361,16,16,0,1,0
20,369,369,123,123,0,1,0
2,371,371,19,19,0,1,0
1,374,374,17,17,0,1,0
23,399,399,16,3,13,2,1
16,412,412,59,59,0,1,0
34,439,439,28,28,0,1,0
8,460,460,20,20,0,1,0
22,461,461,3,3,0,1,0
31,464,464,20,20,0,1,0
11,466,466,212,180,32,3,2
30,474,474,25,25,0,1,0
29,483,483,190,180,10,3,2
36,486,486,30,30,0,1,0
18,497,497,1,1,0,1,0

28,104,104,6,6,0,1,0
3,114,114,13,4,9,4,3
26,114,114,40,24,16,2,1
14,130,130,19,7,12,4,3
6,142,142,8,4,4,2,1
30,155,155,5,1,4,2,1
33,156,156,4,4,0,1,0
1,158,158,2,2,0,1,0
10,171,171,10,10,0,1,0
4,181,181,1,1,0,1,0
20,188,188,26,26,0,1,0
22,203,203,8,8,0,1,0
16,203,203,80,80,0,1,0
0,210,210,29,8,21,4,3
19,221,221,3,3,0,1,0
9,228,228,75,45,30,4,3
13,239,239,1,1,0,1,0
31,251,251,29,29,0,1,0
8,282,282,12,5,7,2,1
17,283,283,5,5,0,1,0
32,297,297,2,2,0,1,0
25,308,308,52,52,0,1,0
12,317,317,27,27,0,1,0
27,328,328,6,6,0,1,0
35,334,334,36,12,24,2,1
21,356,356,52,34,18,3,2
15,363,363,1,1,0,1,0
2,396,396,12,3,9,4,3
23,405,405,6,6,0,1,0
24,409,409,34,16,18,4,3
18,425,425,183,99,84,4,3
7,425,425,95,35,60,4,3
29,431,431,5,1,4,2,1
11,435,435,6,6,0,1,0
34,472,472,29,17,12,4,3
5,479,479,61,61,0,1,0

14,103,103,13,4,9,2,1
27,135,135,16,16,0,1,0
4,136,136,1,1,0,1,0
25,147,147,2,2,0,1,0
24,151,151,9,9,0,1,0
13,153,153,33,4,29,4,3
1,178,178,1,1,0,1,0
12,187,187,31,10,21,2,1
32,192,192,30,20,10,3,2
7,202,202,31,31,0,1,0
23,217,217,9,9,0,1,0
16,227,227,52,3,49,2,1
6,261,261,38,38,0,1,0
33,283,283,31,31,0,1,0
17,284,284,27,18,9,2,1
26,288,288,66,24,42,2,1
9,289,289,7,2,5,2,1
3,291,291,6,3,3,2,1
28,294,294,4,4,0,1,0
20,300,300,2,2,0,1,0
31,309,309,2,2,0,1,0
2,319,319,39,7,32,3,2
0,321,321,21,8,13,2,1
29,337,337,14,14,0,1,0
18,349,349,120,120,0,1,0
10,352,352,22,6,16,3,2
11,360,360,128,11,117,4,3
21,424,424,17,2,15,2,1
8,429,429,8,8,0,1,0
34,440,440,25,25,0,1,0
30,440,440,26,26,0,1,0
22,446,446,182,182,0,1,0
5,452,452,12,12,0,1,0
19,464,464,13,3,10,2,1
15,467,467,26,6,20,3,2

21,115,115,26,26,0,1,0
16,117,117,1,1,0,1,0
8,128,128,3,3,0,1,0
27,139,139,6,6,0,1,0
14,141,141,18,14,4,2,1
26,159,159,7,2,5,2,1
29,173,173,14,3,11,2,1
1,187,187,15,11,4,2,1
12,195,195,15,15,0,1,0
34,207,207,25,25,0,1,0
28,228,228,9,9,0,1,0
17,249,249,42,42,0,1,0
25,260,260,16,6,10,3,2
24,261,261,25,25,0,1,0
15,263,263,40,40,0,1,0
19,265,265,21,11,10,2,1
10,267,267,21,21,0,1,0
23,268,268,11,7,4,2,1
32,270,270,32,9,23,4,3
13,283,283,31,11,20,2,1
4,300,300,80,80,0,1,0
7,309,309,40,40,0,1,0
3,313,313,30,1,29,4,3
30,344,344,43,43,0,1,0
11,345,345,3,3,0,1,0
22,353,353,7,7,0,1,0
35,353,353,52,52,0,1,0
0,378,378,33,8,25,2,1
31,383,383,2,2,0,1,0
33,391,391,26,26,0,1,0
36,399,399,58,31,27,4,3
18,427,427,66,66,0,1,0
9,440,440,23,5,18,2,1
5,449,449,6,2,4,2,1
20,462,462,173,116,57,3,2
6,464,464,12,12,0,1,0
2,483,483,68,68,0,1,0

10,113,113,29,24,5,2,1
18,128,128,2,2,0,1,0
31,134,134,13,13,0,1,0
9,145,145,2,2,0,1,0
21,149,149,4,4,0,1,0
17,150,150,6,6,0,1,0
8,164,164,24,6,18,2,1
20,178,178,5,5,0,1,0
33,186,186,33,33,0,1,0
24,187,187,10,2,8,3,2
19,205,205,11,3,8,2,1
5,218,218,15,15,0,1,0
6,245,245,63,63,0,1,0
14,248,248,4,4,0,1,0
27,249,249,7,1,6,3,2
7,254,254,2,2,0,1,0
22,265,265,2,2,0,1,0
3,276,276,4,4,0,1,0
0,277,277,82,4,78,3,2
28,298,298,151,64,87,4,3
25,300,300,6,6,0,1,0
23,309,309,61,19,42,2,1
15,310,310,9,1,8,2,1
1,348,348,14,14,0,1,0
35,357,357,16,16,0,1,0
38,357,357,21,21,0,1,0
29,359,359,26,2,24,2,1
2,372,372,23,23,0,1,0
4,375,375,34,14,20,2,1
34,375,375,91,62,29,3,2
13,393,393,13,13,0,1,0
16,398,398,13,7,6,3,2
32,410,410,30,17,13,2,1
36,424,424,40,16,24,4,3
11,434,434,1,1,0,1,0
26,454,454,23,7,16,3,2
37,478,478,12,2,10,2,1
30,481,481,30,30,0,1,0
12,489,489,146,103,43,2,1

23,101,101,4,4,0,1,0
19,104,104,4,1,3,2,1
34,121,121,26,26,0,1,0
5,127,127,4,4,0,1,0
13,140,140,12,1,11,3,2
22,143,143,16,12,4,2,1
0,145,145,2,2,0,1,0
20,163,163,5,5,0,1,0
16,164,164,4,4,0,1,0
8,175,175,7,7,0,1,0
1,179,179,1,1,0,1,0
12,188,188,33,10,23,2,1
35,203,203,17,1,16,2,1
11,235,235,28,28,0,1,0
25,260,260,4,4,0,1,0
28,266,266,26,26,0,1,0
31,276,276,29,29,0,1,0
36,284,284,1,1,0,1,0
2,294,294,4,4,0,1,0
21,296,296,19,10,9,3,2
18,324,324,31,31,0,1,0
26,334,334,124,124,0,1,0
27,337,337,4,4,0,1,0
9,362,362,118,37,81,3,2
30,377,377,6,2,4,2,1
6,381,381,18,6,12,3,2
15,391,391,44,44,0,1,0
7,396,396,93,93,0,1,0
4,399,399,10,5,5,2,1
10,416,416,87,66,21,4,3
33,429,429,15,6,9,4,3
3,433,433,75,21,54,3,2
14,444,444,30,1,29,2,1
29,471,471,235,118,117,4,3
17,483,483,1,1,0,1,0
24,487,487,40,40,0,1,0
32,498,498,8,2,6,3,2

34,136,136,51,51,0,1,0
24,151,151,26,26,0,1,0
36,153,153,5,5,0,1,0
3,158,158,7,4,3,2,1
9,171,171,14,14,0,1,0
21,181,181,34,10,24,3,2
30,185,185,13,13,0,1,0
33,189,189,36,36,0,1,0
17,203,203,15,3,12,2,1
4,228,228,26,26,0,1,0
23,240,240,5,5,0,1,0
14,240,240,2,2,0,1,0
0,242,242,69,69,0,1,0
13,253,253,31,31,0,1,0
25,254,254,104,104,0,1,0
28,271,271,5,5,0,1,0
35,282,282,14,11,3,2,1
7,305,305,17,17,0,1,0
1,306,306,6,6,0,1,0
39,307,307,4,4,0,1,0
8,317,317,9,9,0,1,0
15,328,328,28,28,0,1,0
10,341,341,13,9,4,2,1
11,343,343,36,36,0,1,0
16,345,345,6,6,0,1,0
32,345,345,3,3,0,1,0
18,355,355,15,10,5,2,1
2,361,361,6,6,0,1,0
31,361,361,22,22,0,1,0
29,371,371,61,30,31,2,1
12,401,401,4,1,3,2,1
38,401,401,34,5,29,3,2
20,416,416,6,6,0,1,0
37,428,428,14,14,0,1,0
27,444,444,19,19,0,1,0
6,462,462,25,25,0,1,0
19,465,465,170,170,0,1,0
22,473,473,42,42,0,1,0
26,483,483,1,1,0,1,0
5,488,488,17,17,0,1,0

17,103,103,23,11,12,2,1
22,141,141,13,13,0,1,0
20,144,144,16,16,0,1,0
19,144,144,5,5,0,1,0
24,149,149,7,2,5,2,1
10,172,172,6,6,0,1,0
7,181,181,17,17,0,1,0
21,206,206,1,1,0,1,0
23,211,211,13,7,6,2,1
25,212,212,37,37,0,1,0
4,231,231,21,21,0,1,0
32,244,244,2,2,0,1,0
28,247,247,44,20,24,2,1
31,259,259,56,56,0,1,0
18,268,268,38,38,0,1,0
3,290,290,22,22,0,1,0
0,292,292,2,2,0,1,0
11,325,325,77,23,54,4,3
8,329,329,1,1,0,1,0
27,381,381,3,3,0,1,0
15,386,386,5,5,0,1,0
5,398,398,75,46,29,4,3
6,415,415,24,3,21,4,3
12,420,420,84,51,33,4,3
33,422,422,1,1,0,1,0
26,424,424,29,7,22,3,2
1,430,430,23,23,0,1,0
9,439,439,164,164,0,1,0
16,445,445,97,77,20,4,3
30,457,457,55,15,40,3,2
13,469,469,115,115,0,1,0
2,478,478,60,38,22,2,1
14,486,486,1,1,0,1,0
29,497,497,62,58,4,2,1

31,126,126,9,9,0,1,0
15,137,137,36,4,32,4,3
7,141,141,13,13,0,1,0
9,156,156,9,9,0,1,0
27,157,157,24,5,19,2,1
29,178,178,15,15,0,1,0
34,208,208,12,12,0,1,0
21,215,215,20,4,16,3,2
23,218,218,37,3,34,3,2
6,225,225,42,12,30,2,1
2,236,236,30,30,0,1,0
26,237,237,23,9,14,2,1
17,254,254,8,8,0,1,0
28,258,258,24,18,6,3,2
3,258,258,7,1,6,3,2
30,259,259,34,3,31,2,1
14,281,281,32,32,0,1,0
20,306,306,17,3,14,4,3
22,306,306,26,22,4,2,1
35,323,323,63,63,0,1,0
11,325,325,19,3,16,3,2
19,335,335,13,1,12,3,2
0,336,336,63,63,0,1,0
38,348,348,4,4,0,1,0
33,361,361,96,96,0,1,0
13,361,361,6,6,0,1,0
5,379,379,11,3,8,3,2
18,383,383,15,4,11,2,1
8,389,389,57,52,5,2,1
10,416,416,1,1,0,1,0
36,424,424,82,19,63,3,2
37,437,437,33,7,26,2,1
24,442,442,14,2,12,3,2
25,442,442,6,6,0,1,0
16,448,448,53,25,28,2,1
32,448,448,7,7,0,1,0
4,463,463,25,7,18,3,2
1,470,470,12,8,4,2,1
12,472,472,62,62,0,1,0

35,101,101,1,1,0,1,0
2,106,106,6,6,0,1,0
7,107,107,6,6,0,1,0
9,112,112,2,2,0,1,0
34,131,131,23,23,0,1,0
20,134,134,4,1,3,2,1
18,134,134,23,23,0,1,0
5,139,139,10,10,0,1,0
25,148,148,16,16,0,1,0
13,160,160,1,1,0,1,0
11,193,193,65,39,26,2,1
1,195,195,36,36,0,1,0
17,224,224,5,5,0,1,0
14,236,236,45,1,44,2,1
16,240,240,32,20,12,3,2
12,278,278,23,23,0,1,0
19,285,285,4,4,0,1,0
32,295,295,16,2,14,4,3
6,318,318,10,10,0,1,0
26,320,320,10,2,8,3,2
29,351,351,51,33,18,2,1
0,359,359,50,2,48,3,2
36,371,371,39,17,22,2,1
38,373,373,68,45,23,2,1
37,390,390,7,7,0,1,0
28,400,400,6,2,4,2,1
10,402,402,10,10,0,1,0
23,408,408,50,38,12,4,3
33,418,418,32,15,17,2,1
4,441,441,4,4,0,1,0
15,442,442,81,81,0,1,0
27,446,446,79,33,46,3,2
30,460,460,19,19,0,1,0
21,464,464,15,15,0,1,0
3,470,470,2,2,0,1,0
22,474,474,155,126,29,4,3
8,482,482,19,19,0,1,0
31,493,493,75,75,0,1,0
24,495,495,21,3,18,4,3

22,109,109,15,15,0,1,0
6,138,138,30,5,25,3,2
33,141,141,14,14,0,1,0
20,151,151,22,18,4,2,1
14,156,156,3,3,0,1,0
5,167,167,11,11,0,1,0
32,168,168,12,12,0,1,0
15,185,185,35,35,0,1,0
9,189,189,26,4,22,3,2
12,205,205,28,16,12,4,3
17,210,210,37,37,0,1,0
10,228,228,9,9,0,1,0
8,234,234,75,75,0,1,0
29,235,235,51,35,16,3,2
23,244,244,22,14,8,3,2
25,265,265,6,6,0,1,0
26,275,275,40,4,36,2,1
4,287,287,3,3,0,1,0
2,289,289,90,80,10,2,1
3,304,304,7,1,6,3,2
7,315,315,5,5,0,1,0
21,316,316,16,2,14,2,1
0,325,325,40,40,0,1,0
11,338,338,18,8,10,3,2
34,351,351,7,7,0,1,0
27,353,353,16,10,6,3,2
1,361,361,3,3,0,1,0
24,370,370,69,69,0,1,0
18,383,383,33,33,0,1,0
19,403,403,20,20,0,1,0
30,413,413,91,64,27,4,3
13,416,416,50,50,0,1,0
28,425,425,14,14,0,1,0
31,442,442,14,10,4,2,1
16,495,495,5,5,0,1,0

0,106,106,9,1,8,2,1
11,108,108,1,1,0,1,0
3,142,142,3,3,0,1,0
21,149,149,12,6,6,2,1
32,152,152,25,25,0,1,0
29,159,159,13,7,6,2,1
5,161,161,2,2,0,1,0
37,171,171,2,2,0,1,0
9,172,172,15,15,0,1,0
40,174,174,16,16,0,1,0
27,190,190,5,5,0,1,0
30,195,195,4,4,0,1,0
10,199,199,6,3,3,2,1
23,213,213,3,3,0,1,0
6,216,216,34,4,30,2,1
8,231,231,31,22,9,2,1
20,247,247,35,35,0,1,0
4,251,251,52,42,10,2,1
28,270,270,47,47,0,1,0
41,282,282,31,4,27,4,3
1,282,282,42,42,0,1,0
17,294,294,6,6,0,1,0
33,346,346,13,13,0,1,0
38,349,349,59,59,0,1,0
2,354,354,24,15,9,3,2
7,357,357,44,44,0,1,0
18,362,362,15,9,6,2,1
26,373,373,5,1,4,2,1
39,375,375,69,13,56,3,2
22,378,378,7,4,3,2,1
31,385,385,2,2,0,1,0
19,397,397,15,15,0,1,0
24,409,409,5,5,0,1,0
13,413,413,19,13,6,2,1
36,428,428,145,37,108,4,3
15,429,429,3,3,0,1,0
25,429,429,1,1,0,1,0
14,444,444,92,92,0,1,0
35,475,475,1,1,0,1,0
16,475,475,24,24,0,1,0
34,485,485,187,145,42,4,3
12,498,498,27,12,15,4,3

44,120,120,19,19,0,1,0
18,127,127,2,2,0,1,0
31,128,128,15,15,0,1,0
26,142,142,4,4,0,1,0
2,173,173,33,33,0,1,0
24,185,185,10,10,0,1,0
35,193,193,1,1,0,1,0
12,196,196,4,4,0,1,0
5,199,199,1,1,0,1,0
25,203,203,22,22,0,1,0
0,212,212,13,13,0,1,0
17,217,217,10,10,0,1,0
29,219,219,2,2,0,1,0
8,224,224,37,5,32,3,2
40,228,228,19,10,9,2,1
43,239,239,9,1,8,2,1
14,242,242,27,4,23,2,1
22,245,245,4,4,0,1,0
38,255,255,23,6,17,2,1
20,261,261,13,4,9,2,1
21,273,273,39,22,17,2,1
27,274,274,3,3,0,1,0
30,283,283,1,1,0,1,0
32,292,292,17,17,0,1,0
36,292,292,10,3,7,2,1
39,295,295,94,32,62,3,2
37,301,301,37,37,0,1,0
9,310,310,14,1,13,2,1
3,313,313,72,30,42,2,1
11,338,338,3,3,0,1,0
33,352,352,44,44,0,1,0
19,353,353,1,1,0,1,0
4,361,361,46,46,0,1,0
41,367,367,97,97,0,1,0
42,379,379,55,55,0,1,0
15,403,403,16,16,0,1,0
7,404,404,35,10,25,3,2
23,408,408,5,5,0,1,0
34,415,415,80,6,74,4,3
28,419,419,23,3,20,2,1
16,426,426,26,11,15,4,3
13,456,456,31,3,28,2,1
6,457,457,17,17,0,1,0
10,464,464,7,3,4,2,1
1,496,496,26,7,19,2,1

29,100,100,21,13,8,2,1
28,119,119,8,8,0,1,0
36,124,124,46,23,23,2,1
21,126,126,12,4,8,2,1
26,137,137,18,3,15,2,1
34,141,141,9,1,8,3,2
25,151,151,1,1,0,1,0
0,184,184,8,4,4,2,1
30,186,186,7,7,0,1,0
5,190,190,47,31,16,3,2
4,203,203,3,3,0,1,0
19,204,204,22,17,5,2,1
10,208,208,17,17,0,1,0
33,214,214,15,15,0,1,0
7,225,225,8,2,6,2,1
2,229,229,16,16,0,1,0
20,256,256,26,26,0,1,0
18,265,265,7,3,4,2,1
23,275,275,24,7,17,2,1
24,309,309,70,70,0,1,0
35,311,311,10,1,9,4,3
3,314,314,9,9,0,1,0
1,323,323,6,6,0,1,0
12,326,326,23,13,10,2,1
9,336,336,1,1,0,1,0
27,338,338,26,1,25,4,3
22,344,344,63,47,16,2,1
32,357,357,29,29,0,1,0
8,386,386,13,13,0,1,0
15,392,392,1,1,0,1,0
31,398,398,4,4,0,1,0
14,406,406,23,23,0,1,0
16,416,416,51,51,0,1,0
38,422,422,59,59,0,1,0
6,423,423,17,17,0,1,0
37,429,429,2,2,0,1,0
39,453,453,83,83,0,1,0
11,459,459,20,20,0,1,0
13,475,475,142,46,96,3,2
17,477,477,36,3,33,3,2
40,480,480,18,10,8,2,1

3,118,118,28,18,10,2,1
6,138,138,12,7,5,2,1
33,150,150,24,13,11,2,1
37,156,156,12,12,0,1,0
10,172,172,11,11,0,1,0
27,193,193,16,16,0,1,0
30,200,200,55,27,28,2,1
4,210,210,22,22,0,1,0
24,219,219,1,1,0,1,0
8,222,222,9,1,8,3,2
39,224,224,4,4,0,1,0
29,234,234,18,2,16,3,2
34,235,235,17,11,6,2,1
20,256,256,11,11,0,1,0
18,267,267,12,12,0,1,0
35,270,270,22,1,21,4,3
12,270,270,34,14,20,3,2
36,274,274,34,24,10,2,1
15,279,279,3,3,0,1,0
22,283,283,80,4,76,4,3
31,335,335,43,31,12,4,3
11,345,345,30,30,0,1,0
5,350,350,54,54,0,1,0
38,363,363,55,17,38,4,3
32,369,369,2,2,0,1,0
26,382,382,48,29,19,2,1
7,384,384,22,2,20,3,2
19,413,413,64,64,0,1,0
17,419,419,26,14,12,2,1
16,422,422,9,5,4,2,1
9,438,438,5,2,3,2,1
23,441,441,12,12,0,1,0
0,448,448,66,66,0,1,0
2,474,474,65,27,38,3,2
21,479,479,24,10,14,3,2
14,482,482,12,12,0,1,0
13,483,483,51,51,0,1,0
1,486,486,14,1,13,2,1
28,488,488,13,13,0,1,0
25,492,492,57,19,38,4,3

2,103,103,8,8,0,1,0
33,109,109,19,16,3,2,1
26,120,120,1,1,0,1,0
29,131,131,19,2,17,3,2
34,137,137,18,18,0,1,0
4,144,144,12,12,0,1,0
8,145,145,11,6,5,2,1
18,152,152,35,29,6,2,1
31,169,169,21,5,16,2,1
6,190,190,1,1,0,1,0
32,203,203,33,6,27,4,3
16,204,204,46,46,0,1,0
13,204,204,17,17,0,1,0
20,211,211,6,6,0,1,0
1,211,211,3,3,0,1,0
27,213,213,1,1,0,1,0
19,220,220,20,20,0,1,0
21,224,224,16,6,10,2,1
25,227,227,6,3,3,2,1
30,239,239,119,119,0,1,0
15,252,252,9,9,0,1,0
0,271,271,14,14,0,1,0
3,300,300,81,59,22,2,1
5,314,314,9,9,0,1,0
7,329,329,24,24,0,1,0
23,359,359,10,10,0,1,0
22,368,368,20,20,0,1,0
11,396,396,89,89,0,1,0
14,398,398,28,9,19,2,1
28,406,406,2,2,0,1,0
17,409,409,9,9,0,1,0
24,415,415,15,3,12,2,1
9,419,419,75,58,17,4,3
10,429,429,109,75,34,2,1
12,474,474,23,23,0,1,0

21,102,102,5,5,0,1,0
31,112,112,15,15,0,1,0
26,131,131,5,5,0,1,0
15,135,135,4,4,0,1,0
5,158,158,20,6,14,2,1
0,163,163,13,9,4,2,1
11,177,177,62,62,0,1,0
12,177,177,1,1,0,1,0
14,180,180,1,1,0,1,0
23,194,194,4,4,0,1,0
27,216,216,22,22,0,1,0
4,223,223,29,29,0,1,0
10,243,243,43,34,9,4,3
30,244,244,38,38,0,1,0
28,279,279,1,1,0,1,0
20,286,286,15,15,0,1,0
16,289,289,8,8,0,1,0
6,302,302,39,9,30,2,1
9,334,334,1,1,0,1,0
24,334,334,53,20,33,2,1
7,349,349,83,23,60,3,2
8,367,367,47,39,8,2,1
33,381,381,15,15,0,1,0
3,385,385,3,3,0,1,0
22,392,392,34,20,14,2,1
13,415,415,136,39,97,4,3
34,425,425,12,2,10,2,1
29,436,436,65,32,33,2,1
32,443,443,53,53,0,1,0
17,445,445,23,23,0,1,0
25,446,446,25,2,23,2,1
2,447,447,5,2,3,2,1
18,449,449,218,218,0,1,0
1,466,466,12,12,0,1,0
19,469,469,50,26,24,2,1

23,120,120,21,1,20,3,2
28,145,145,9,9,0,1,0
12,148,148,12,5,7,2,1
24,169,169,23,11,12,4,3
16,185,185,7,7,0,1,0
11,200,200,33,22,11,2,1
7,229,229,1,1,0,1,0
5,232,232,11,11,0,1,0
3,236,236,46,18,28,3,2
32,262,262,28,28,0,1,0
2,271,271,6,6,0,1,0
20,273,273,68,68,0,1,0
22,281,281,5,5,0,1,0
31,283,283,36,21,15,4,3
9,298,298,34,6,28,3,2
27,306,306,69,28,41,3,2
6,322,322,38,4,34,2,1
17,325,325,9,9,0,1,0
15,343,343,15,15,0,1,0
14,344,344,1,1,0,1,0
30,360,360,130,82,48,3,2
25,371,371,51,7,44,3,2
1,381,381,79,38,41,2,1
8,418,418,184,116,68,4,3
4,432,432,74,8,66,4,3
29,432,432,2,2,0,1,0
26,436,436,20,20,0,1,0
10,443,443,1,1,0,1,0
0,463,463,70,42,28,3,2
13,466,466,37,37,0,1,0
19,480,480,6,3,3,2,1
21,481,481,17,17,0,1,0
18,496,496,12,12,0,1,0

9,109,109,13,2,11,4,3
38,114,114,7,2,5,2,1
3,181,181,10,7,3,2,1
15,181,181,9,3,6,3,2
20,183,183,3,3,0,1,0
28,186,186,1,1,0,1,0
6,200,200,12,12,0,1,0
8,204,204,1,1,0,1,0
18,232,232,23,11,12,3,2
14,243,243,5,5,0,1,0
34,247,247,11,4,7,2,1
5,260,260,5,5,0,1,0
10,273,273,6,6,0,1,0
21,280,280,93,93,0,1,0
25,295,295,27,27,0,1,0
26,303,303,2,2,0,1,0
39,304,304,4,4,0,1,0
37,325,325,113,62,51,4,3
4,327,327,13,5,8,2,1
22,334,334,36,36,0,1,0
32,343,343,127,82,45,2,1
23,356,356,1,1,0,1,0
7,365,365,27,27,0,1,0
2,370,370,29,29,0,1,0
31,371,371,26,26,0,1,0
13,376,376,41,41,0,1,0
12,383,383,88,34,54,3,2
1,388,388,1,1,0,1,0
11,388,388,22,22,0,1,0
36,388,388,24,10,14,2,1
24,392,392,3,3,0,1,0
19,396,396,10,1,9,2,1
30,409,409,31,31,0,1,0
27,448,448,126,126,0,1,0
16,474,474,76,42,34,3,2
17,478,478,72,24,48,3,2
33,488,488,106,40,66,4,3
35,490,490,19,11,8,3,2
29,491,491,14,1,13,4,3
0,491,491,37,37,0,1,0

12,119,119,5,5,0,1,0
25,121,121,1,1,0,1,0
32,134,134,52,52,0,1,0
13,135,135,2,2,0,1,0
18,135,135,3,3,0,1,0
31,160,160,27,9,18,2,1
4,163,163,21,21,0,1,0
16,177,177,8,4,4,2,1
7,192,192,15,15,0,1,0
22,192,192,7,7,0,1,0
5,212,212,53,12,41,3,2
11,214,214,24,24,0,1,0
15,228,228,50,41,9,4,3
28,269,269,46,28,18,3,2
10,316,316,43,43,0,1,0
23,325,325,37,37,0,1,0
9,325,325,14,14,0,1,0
29,351,351,19,1,18,3,2
30,357,357,74,14,60,3,2
8,363,363,14,14,0,1,0
14,368,368,39,1,38,3,2
20,377,377,36,36,0,1,0
17,387,387,5,5,0,1,0
3,391,391,12,12,0,1,0
6,412,412,43,43,0,1,0
27,439,439,47,47,0,1,0
2,444,444,28,28,0,1,0
24,452,452,31,31,0,1,0
19,460,460,31,7,24,3,2
1,462,462,19,19,0,1,0
26,473,473,19,19,0,1,0
0,478,478,293,170,123,4,3
21,499,499,2,2,0,1,0

32,104,104,2,2,0,1,0
27,112,112,6,1,5,2,1
8,121,121,1,1,0,1,0
12,122,122,7,4,3,2,1
4,124,124,6,1,5,2,1
26,126,126,2,2,0,1,0
44,127,127,15,15,0,1,0
33,142,142,16,8,8,3,2
30,143,143,9,9,0,1,0
16,165,165,3,3,0,1,0
31,178,178,15,3,12,3,2
45,189,189,4,4,0,1,0
9,191,191,15,12,3,2,1
15,206,206,12,7,5,2,1
3,211,211,4,4,0,1,0
7,220,220,10,10,0,1,0
38,228,228,13,1,12,2,1
6,229,229,9,5,4,2,1
10,233,233,27,27,0,1,0
42,234,234,22,15,7,2,1
35,235,235,13,4,9,2,1
36,249,249,45,17,28,4,3
43,257,257,2,2,0,1,0
18,266,266,33,12,21,3,2
41,268,268,25,4,21,4,3
14,269,269,29,29,0,1,0
19,273,273,8,8,0,1,0
28,275,275,50,41,9,2,1
22,282,282,2,2,0,1,0
5,287,287,16,10,6,2,1
34,309,309,18,18,0,1,0
1,331,331,14,14,0,1,0
39,333,333,102,27,75,4,3
11,354,354,26,26,0,1,0
25,366,366,29,29,0,1,0
20,367,367,25,6,19,2,1
0,410,410,38,38,0,1,0
13,428,428,12,3,9,2,1
17,437,437,41,18,23,2,1
40,446,446,29,29,0,1,0
29,457,457,55,9,46,2,1
21,464,464,65,26,39,4,3
37,472,472,95,76,19,2,1
23,477,477,2,2,0,1,0
24,487,487,63,63,0,1,0
2,499,499,86,65,21,4,3

36,119,119,5,5,0,1,0
14,131,131,4,4,0,1,0
20,136,136,13,13,0,1,0
29,144,144,14,14,0,1,0
31,148,148,14,6,8,3,2
15,164,164,18,18,0,1,0
28,171,171,10,10,0,1,0
3,173,173,12,12,0,1,0
27,176,176,7,7,0,1,0
2,183,183,18,18,0,1,0
5,196,196,1,1,0,1,0
13,211,211,7,3,4,2,1
40,213,213,4,4,0,1,0
33,229,229,3,3,0,1,0
8,230,230,10,10,0,1,0
16,237,237,9,9,0,1,0
23,249,249,35,3,32,2,1
32,253,253,13,13,0,1,0
19,261,261,17,17,0,1,0
18,268,268,3,3,0,1,0
26,271,271,30,30,0,1,0
37,274,274,45,45,0,1,0
4,294,294,12,12,0,1,0
38,307,307,105,85,20,3,2
17,333,333,5,5,0,1,0
22,335,335,61,37,24,4,3
25,339,339,14,6,8,3,2
30,355,355,49,49,0,1,0
35,364,364,39,6,33,4,3
0,364,364,14,14,0,1,0
21,367,367,23,23,0,1,0
1,399,399,103,103,0,1,0
10,401,401,134,121,13,2,1
6,426,426,34,7,27,4,3
11,433,433,52,52,0,1,0
34,434,434,99,12,87,4,3
39,451,451,28,28,0,1,0
12,454,454,14,14,0,1,0
7,456,456,1,1,0,1,0
9,472,472,18,18,0,1,0
24,492,492,40,40,0,1,0

2,105,105,1,1,0,1,0
26,105,105,28,7,21,2,1
10,112,112,9,9,0,1,0
9,114,114,34,27,7,2,1
11,115,115,1,1,0,1,0
25,120,120,5,5,0,1,0
15,143,143,3,3,0,1,0
17,170,170,39,21,18,2,1
16,178,178,25,7,18,3,2
31,186,186,53,53,0,1,0
19,200,200,2,2,0,1,0
13,220,220,31,31,0,1,0
0,260,260,55,55,0,1,0
28,270,270,6,6,0,1,0
5,270,270,34,10,24,4,3
12,299,299,121,21,100,3,2
8,342,342,3,3,0,1,0
6,349,349,21,4,17,2,1
24,353,353,37,4,33,2,1
18,360,360,27,13,14,3,2
14,365,365,4,4,0,1,0
27,374,374,27,27,0,1,0
32,379,379,78,24,54,4,3
22,390,390,12,5,7,2,1
4,401,401,1,1,0,1,0
21,409,409,11,11,0,1,0
7,414,414,24,6,18,3,2
29,417,417,36,36,0,1,0
30,420,420,27,18,9,4,3
3,439,439,23,23,0,1,0
23,442,442,50,50,0,1,0
1,449,449,147,66,81,4,3
20,477,477,19,11,8,3,2

28,108,108,2,2,0,1,0
4,123,123,1,1,0,1,0
11,131,131,26,26,0,1,0
35,162,162,23,23,0,1,0
0,179,179,2,2,0,1,0
24,227,227,5,5,0,1,0
29,243,243,16,7,9,4,3
1,262,262,64,39,25,3,2
5,269,269,5,5,0,1,0
2,271,271,1,1,0,1,0
14,297,297,31,28,3,2,1
21,304,304,7,4,3,2,1
15,314,314,30,23,7,2,1
20,315,315,52,52,0,1,0
34,319,319,102,30,72,4,3
17,342,342,27,27,0,1,0
27,344,344,59,59,0,1,0
16,348,348,50,13,37,2,1
18,353,353,27,27,0,1,0
19,354,354,3,3,0,1,0
9,358,358,21,21,0,1,0
23,372,372,75,49,26,4,3
22,386,386,50,47,3,2,1
10,408,408,1,1,0,1,0
25,409,409,15,15,0,1,0
13,412,412,51,34,17,2,1
7,417,417,16,6,10,3,2
32,423,423,72,72,0,1,0
12,430,430,84,78,6,2,1
36,459,459,18,18,0,1,0
3,462,462,62,62,0,1,0
30,468,468,38,11,27,2,1
8,470,470,79,43,36,4,3
33,472,472,40,35,5,2,1
26,478,478,47,9,38,2,1
31,491,491,24,24,0,1,0
6,494,494,48,2,46,2,1

13,111,111,6,6,0,1,0
24,126,126,11,1,10,2,1
3,146,146,35,13,22,3,2
32,221,221,50,14,36,4,3
17,224,224,3,3,0,1,0
11,227,227,8,8,0,1,0
22,232,232,11,11,0,1,0
0,235,235,29,9,20,3,2
15,267,267,2,2,0,1,0
26,275,275,17,17,0,1,0
2,279,279,9,9,0,1,0
34,280,280,50,32,18,4,3
28,280,280,1,1,0,1,0
4,285,285,37,37,0,1,0
10,289,289,8,8,0,1,0
7,296,296,71,71,0,1,0
29,312,312,21,21,0,1,0
1,329,329,2,2,0,1,0
30,337,337,1,1,0,1,0
21,343,343,2,2,0,1,0
36,355,355,34,10,24,3,2
12,382,382,123,123,0,1,0
31,393,393,30,15,15,4,3
9,393,393,15,15,0,1,0
25,406,406,73,73,0,1,0
35,406,406,42,42,0,1,0
6,410,410,12,2,10,3,2
16,425,425,38,38,0,1,0
14,431,431,2,2,0,1,0
23,456,456,83,83,0,1,0
27,456,456,139,97,42,4,3
8,457,457,1,1,0,1,0
20,474,474,49,22,27,2,1
33,477,477,4,1,3,2,1
18,479,479,163,80,83,4,3
5,479,479,14,2,12,3,2
37,480,480,46,46,0,1,0
19,491,491,18,7,11,2,1

8,104,104,11,11,0,1,0
27,111,111,22,8,14,2,1
28,123,123,1,1,0,1,0
20,128,128,62,43,19,3,2
33,153,153,7,7,0,1,0
1,159,159,11,11,0,1,0
2,166,166,9,3,6,3,2
13,178,178,31,10,21,2,1
15,181,181,38,18,20,2,1
24,205,205,15,15,0,1,0
9,224,224,16,6,10,3,2
31,258,258,13,13,0,1,0
14,263,263,14,14,0,1,0
4,263,263,6,6,0,1,0
10,281,281,13,13,0,1,0
30,294,294,25,10,15,4,3
0,297,297,9,9,0,1,0
11,318,318,57,9,48,4,3
22,339,339,3,3,0,1,0
3,352,352,84,80,4,2,1
23,363,363,33,14,19,4,3
26,389,389,22,10,12,3,2
25,401,401,22,22,0,1,0
21,413,413,15,15,0,1,0
19,415,415,60,60,0,1,0
6,424,424,165,111,54,3,2
29,425,425,43,43,0,1,0
12,438,438,3,3,0,1,0
7,443,443,7,1,6,3,2
5,450,450,61,61,0,1,0
17,452,452,24,24,0,1,0
16,482,482,75,75,0,1,0
18,488,488,51,51,0,1,0
32,491,491,43,43,0,1,0

32,106,106,14,14,0,1,0
24,114,114,12,2,10,4,3
19,134,134,1,1,0,1,0
8,138,138,3,3,0,1,0
27,152,152,7,7,0,1,0
21,152,152,18,6,12,4,3
2,157,157,7,3,4,2,1
36,157,157,31,3,28,3,2
29,168,168,5,5,0,1,0
28,176,176,68,59,9,2,1
37,180,180,51,51,0,1,0
33,183,183,12,6,6,2,1
25,184,184,14,14,0,1,0
4,196,196,17,17,0,1,0
9,198,198,12,12,0,1,0
1,225,225,1,1,0,1,0
34,226,226,24,10,14,2,1
26,232,232,1,1,0,1,0
23,254,254,12,6,6,2,1
12,268,268,17,6,11,4,3
6,270,270,31,4,27,4,3
20,279,279,12,12,0,1,0
14,293,293,70,45,25,2,1
15,303,303,50,18,32,2,1
3,306,306,33,18,15,4,3
16,317,317,32,14,18,4,3
30,323,323,25,4,21,4,3
35,331,331,3,3,0,1,0
13,340,340,16,16,0,1,0
22,340,340,34,34,0,1,0
31,343,343,10,2,8,3,2
7,364,364,12,12,0,1,0
0,378,378,67,44,23,2,1
5,419,419,86,50,36,3,2
18,467,467,33,33,0,1,0
11,470,470,85,64,21,4,3
17,478,478,20,20,0,1,0
10,478,478,16,16,0,1,0

31,112,112,24,18,6,3,2
21,115,115,14,14,0,1,0
33,123,123,32,32,0,1,0
6,137,137,1,1,0,1,0
36,149,149,17,17,0,1,0
18,171,171,1,1,0,1,0
12,171,171,15,6,9,4,3
13,174,174,18,18,0,1,0
4,179,179,43,43,0,1,0
3,188,188,9,1,8,3,2
24,202,202,51,51,0,1,0
7,204,204,3,3,0,1,0
29,211,211,3,3,0,1,0
27,214,214,21,7,14,3,2
39,230,230,22,7,15,4,3
41,263,263,11,11,0,1,0
8,283,283,58,58,0,1,0
32,283,283,25,7,18,4,3
15,286,286,9,9,0,1,0
2,287,287,6,6,0,1,0
34,313,313,1,1,0,1,0
26,314,314,18,10,8,2,1
19,315,315,20,6,14,4,3
9,322,322,39,13,26,2,1
35,332,332,7,7,0,1,0
14,346,346,10,10,0,1,0
37,346,346,23,8,15,4,3
30,350,350,58,11,47,4,3
17,363,363,27,24,3,2,1
22,363,363,4,4,0,1,0
20,374,374,25,15,10,3,2
23,397,397,21,21,0,1,0
28,422,422,4,4,0,1,0
25,422,422,85,25,60,3,2
0,426,426,18,18,0,1,0
5,427,427,26,26,0,1,0
10,438,438,26,4,22,2,1
11,449,449,24,10,14,3,2
38,460,460,2,2,0,1,0
1,468,468,30,30,0,1,0
16,485,485,105,27,78,4,3
40,499,499,62,62,0,1,0

15,104,104,4,4,0,1,0
20,107,107,23,8,15,4,3
17,107,107,7,1,6,2,1
36,123,123,3,3,0,1,0
25,128,128,4,4,0,1,0
7,130,130,5,5,0,1,0
39,140,140,1,1,0,1,0
35,158,158,3,3,0,1,0
38,160,160,26,26,0,1,0
31,160,160,9,9,0,1,0
37,162,162,16,1,15,4,3
29,167,167,92,65,27,3,2
33,172,172,55,55,0,1,0
16,196,196,5,5,0,1,0
22,198,198,8,8,0,1,0
4,208,208,1,1,0,1,0
28,214,214,24,12,12,4,3
34,216,216,12,4,8,2,1
18,221,221,20,20,0,1,0
11,234,234,1,1,0,1,0
1,239,239,13,9,4,2,1
5,258,258,99,25,74,3,2
6,261,261,17,13,4,2,1
12,268,268,56,56,0,1,0
32,269,269,6,6,0,1,0
26,282,282,5,5,0,1,0
30,300,300,19,19,0,1,0
0,322,322,26,13,13,2,1
13,324,324,31,31,0,1,0
24,325,325,24,16,8,2,1
9,327,327,4,4,0,1,0
27,338,338,15,9,6,2,1
21,352,352,12,12,0,1,0
10,366,366,41,35,6,2,1
19,388,388,7,7,0,1,0
8,397,397,23,23,0,1,0
14,405,405,58,58,0,1,0
23,410,410,58,7,51,4,3
2,411,411,21,5,16,4,3
3,478,478,1,1,0,1,0

8,102,102,34,34,0,1,0
30,122,122,1,1,0,1,0
31,133,133,6,6,0,1,0
16,145,145,11,11,0,1,0
27,158,158,61,61,0,1,0
1,162,162,3,3,0,1,0
9,194,194,2,2,0,1,0
26,194,194,22,10,12,4,3
34,203,203,7,7,0,1,0
29,210,210,2,2,0,1,0
37,222,222,12,12,0,1,0
28,224,224,9,9,0,1,0
19,240,240,32,32,0,1,0
39,284,284,30,30,0,1,0
21,303,303,14,14,0,1,0
38,304,304,2,2,0,1,0
10,314,314,14,14,0,1,0
35,320,320,36,36,0,1,0
13,320,320,21,21,0,1,0
6,321,321,30,16,14,3,2
18,326,326,19,4,15,2,1
4,329,329,10,10,0,1,0
24,342,342,9,9,0,1,0
5,357,357,84,84,0,1,0
22,359,359,17,17,0,1,0
0,374,374,2,2,0,1,0
11,375,375,41,2,39,4,3
7,406,406,53,3,50,2,1
25,420,420,229,149,80,4,3
32,422,422,29,29,0,1,0
2,429,429,20,14,6,2,1
17,435,435,1,1,0,1,0
20,446,446,18,1,17,2,1
14,450,450,20,20,0,1,0
33,453,453,18,6,12,3,2
3,455,455,57,22,35,2,1
15,481,481,10,10,0,1,0
36,486,486,18,6,12,4,3
12,491,491,65,65,0,1,0
23,492,492,76,4,72,4,3

8,117,117,6,3,3,2,1
32,126,126,6,6,0,1,0
30,127,127,14,5,9,4,3
27,132,132,3,3,0,1,0
3,134,134,9,6,3,2,1
7,173,173,43,5,38,3,2
12,197,197,12,3,9,2,1
15,212,212,34,34,0,1,0
2,250,250,35,35,0,1,0
26,251,251,10,10,0,1,0
24,266,266,22,22,0,1,0
11,314,314,1,1,0,1,0
14,318,318,56,31,25,2,1
20,325,325,1,1,0,1,0
28,336,336,108,41,67,4,3
0,348,348,22,4,18,4,3
19,348,348,41,41,0,1,0
16,367,367,1,1,0,1,0
29,368,368,43,43,0,1,0
10,370,370,45,35,10,3,2
21,378,378,19,1,18,3,2
23,379,379,10,10,0,1,0
13,384,384,20,20,0,1,0
33,386,386,16,7,9,4,3
25,431,431,61,3,58,4,3
35,433,433,54,54,0,1,0
5,433,433,43,33,10,2,1
4,435,435,104,91,13,2,1
22,444,444,11,5,6,3,2
6,448,448,17,8,9,2,1
9,449,449,15,10,5,2,1
17,459,459,50,5,45,4,3
31,461,461,105,73,32,2,1
18,467,467,13,10,3,2,1
36,486,486,114,16,98,3,2
1,490,490,53,53,0,1,0
34,493,493,49,43,6,2,1

36,116,116,12,12,0,1,0
0,123,123,1,1,0,1,0
3,131,131,25,25,0,1,0
23,151,151,50,50,0,1,0
34,156,156,5,5,0,1,0
25,156,156,40,20,20,3,2
19,171,171,8,8,0,1,0
2,172,172,11,11,0,1,0
29,173,173,8,1,7,2,1
22,194,194,37,37,0,1,0
24,199,199,6,6,0,1,0
21,207,207,5,5,0,1,0
20,221,221,4,4,0,1,0
26,226,226,7,7,0,1,0
30,234,234,20,20,0,1,0
16,262,262,30,8,22,3,2
28,266,266,41,19,22,3,2
5,271,271,3,3,0,1,0
35,273,273,3,3,0,1,0
9,292,292,8,8,0,1,0
31,293,293,3,3,0,1,0
8,298,298,1,1,0,1,0
37,309,309,51,9,42,4,3
14,309,309,54,21,33,4,3
6,310,310,55,48,7,2,1
33,330,330,10,10,0,1,0
32,347,347,14,14,0,1,0
1,350,350,1,1,0,1,0
10,358,358,6,6,0,1,0
4,374,374,145,145,0,1,0
15,375,375,48,48,0,1,0
27,407,407,117,117,0,1,0
7,427,427,9,9,0,1,0
11,438,438,5,5,0,1,0
12,452,452,67,67,0,1,0
17,456,456,31,31,0,1,0
18,477,477,5,5,0,1,0
13,499,499,95,89,6,2,1

21,104,104,9,9,0,1,0
27,104,104,5,1,4,2,1
7,122,122,18,9,9,2,1
20,158,158,27,27,0,1,0
28,159,159,16,16,0,1,0
33,165,165,13,5,8,2,1
23,175,175,2,2,0,1,0
25,178,178,22,22,0,1,0
30,188,188,28,28,0,1,0
22,193,193,8,8,0,1,0
11,242,242,8,8,0,1,0
32,243,243,41,41,0,1,0
8,251,251,13,13,0,1,0
1,266,266,5,2,3,2,1
15,267,267,49,49,0,1,0
10,270,270,14,14,0,1,0
2,272,272,19,19,0,1,0
4,277,277,4,4,0,1,0
19,292,292,22,4,18,2,1
17,328,328,16,16,0,1,0
31,343,343,9,9,0,1,0
9,346,346,28,28,0,1,0
24,350,350,107,66,41,4,3
6,354,354,5,5,0,1,0
0,373,373,46,21,25,3,2
3,421,421,116,69,47,4,3
16,454,454,69,69,0,1,0
29,459,459,16,2,14,3,2
12,462,462,142,37,105,4,3
14,466,466,145,28,117,4,3
5,474,474,19,19,0,1,0
26,478,478,22,22,0,1,0
13,494,494,38,38,0,1,0
18,497,497,82,82,0,1,0

31,118,118,4,4,0,1,0
1,122,122,1,1,0,1,0
24,124,124,5,5,0,1,0
25,132,132,7,7,0,1,0
15,133,133,13,5,8,2,1
26,136,136,19,19,0,1,0
4,139,139,1,1,0,1,0
7,143,143,3,3,0,1,0
38,159,159,27,27,0,1,0
37,169,169,16,8,8,3,2
22,178,178,4,4,0,1,0
23,186,186,4,4,0,1,0
35,188,188,2,2,0,1,0
29,198,198,17,2,15,4,3
3,201,201,59,59,0,1,0
34,206,206,2,2,0,1,0
20,235,235,12,3,9,4,3
36,236,236,23,17,6,3,2
11,241,241,21,21,0,1,0
30,276,276,92,34,58,3,2
32,285,285,21,15,6,3,2
17,326,326,10,5,5,2,1
28,326,326,35,4,31,2,1
6,337,337,2,2,0,1,0
27,337,337,12,1,11,2,1
33,350,350,108,3,105,4,3
9,356,356,15,5,10,2,1
14,371,371,36,36,0,1,0
2,376,376,42,32,10,2,1
21,393,393,23,15,8,3,2
10,405,405,50,50,0,1,0
19,436,436,3,3,0,1,0
0,446,446,15,15,0,1,0
18,447,447,23,12,11,2,1
12,450,450,25,5,20,2,1
39,453,453,96,22,74,3,2
16,455,455,147,147,0,1,0
13,457,457,7,1,6,3,2
8,465,465,120,20,100,3,2
5,467,467,10,1,9,4,3

16,109,109,15,12,3,2,1
11,123,123,20,20,0,1,0
3,138,138,2,2,0,1,0
23,139,139,29,29,0,1,0
2,154,154,26,26,0,1,0
19,163,163,15,15,0,1,0
14,166,166,20,20,0,1,0
26,171,171,5,5,0,1,0
10,181,181,1,1,0,1,0
0,185,185,81,81,0,1,0
6,189,189,29,5,24,4,3
32,197,197,7,7,0,1,0
22,205,205,9,2,7,2,1
5,242,242,23,23,0,1,0
25,258,258,10,6,4,2,1
13,269,269,24,12,12,4,3
31,272,272,1,1,0,1,0
9,277,277,10,10,0,1,0
20,328,328,28,4,24,2,1
27,331,331,47,18,29,3,2
30,333,333,3,3,0,1,0
28,343,343,131,90,41,4,3
15,352,352,31,31,0,1,0
1,353,353,50,50,0,1,0
29,360,360,27,5,22,2,1
8,365,365,44,9,35,2,1
4,375,375,35,12,23,2,1
17,379,379,57,57,0,1,0
21,398,398,16,2,14,3,2
12,441,441,61,50,11,2,1
18,460,460,76,24,52,3,2
7,488,488,12,12,0,1,0
24,500,500,52,52,0,1,0

10,105,105,15,15,0,1,0
15,139,139,8,1,7,2,1
25,140,140,21,21,0,1,0
14,146,146,5,5,0,1,0
2,162,162,52,52,0,1,0
11,187,187,42,15,27,2,1
13,196,196,22,14,8,2,1
6,225,225,9,9,0,1,0
27,241,241,3,3,0,1,0
20,255,255,3,3,0,1,0
21,264,264,33,33,0,1,0
12,280,280,10,10,0,1,0
19,296,296,4,4,0,1,0
0,329,329,42,4,38,2,1
4,334,334,42,42,0,1,0
18,369,369,19,14,5,2,1
24,372,372,92,26,66,4,3
16,390,390,22,12,10,2,1
7,402,402,117,75,42,3,2
17,403,403,29,29,0,1,0
22,404,404,24,24,0,1,0
9,406,406,74,13,61,4,3
3,423,423,68,8,60,3,2
8,423,423,76,76,0,1,0
5,436,436,23,19,4,2,1
1,454,454,145,55,90,4,3
26,459,459,138,107,31,3,2
23,497,497,64,64,0,1,0

29,106,106,3,3,0,1,0
4,122,122,1,1,0,1,0
24,147,147,1,1,0,1,0
20,152,152,19,19,0,1,0
26,171,171,5,2,3,2,1
22,175,175,15,3,12,2,1
12,190,190,3,3,0,1,0
14,206,206,1,1,0,1,0
27,213,213,44,11,33,4,3
7,227,227,27,27,0,1,0
33,231,231,57,5,52,4,3
32,232,232,26,12,14,2,1
3,257,257,24,24,0,1,0
34,278,278,8,8,0,1,0
13,292,292,3,3,0,1,0
17,293,293,12,12,0,1,0
5,303,303,87,30,57,4,3
16,305,305,1,1,0,1,0
23,308,308,72,58,14,3,2
1,313,313,102,57,45,3,2
21,335,335,7,7,0,1,0
31,352,352,44,44,0,1,0
0,353,353,65,38,27,4,3
18,356,356,28,4,24,4,3
9,359,359,79,65,14,2,1
28,363,363,12,12,0,1,0
19,364,364,58,18,40,3,2
25,380,380,45,30,15,2,1
11,395,395,6,2,4,2,1
2,425,425,45,29,16,2,1
8,427,427,114,105,9,4,3
35,452,452,5,5,0,1,0
30,479,479,88,88,0,1,0
10,483,483,21,21,0,1,0
6,496,496,25,16,9,4,3
15,498,498,4,1,3,2,1

10,114,114,2,2,0,1,0
21,119,119,6,6,0,1,0
11,144,144,18,18,0,1,0
4,148,148,1,1,0,1,0
16,154,154,3,3,0,1,0
9,162,162,13,4,9,4,3
2,165,165,9,9,0,1,0
13,174,174,7,7,0,1,0
36,184,184,8,8,0,1,0
20,195,195,37,37,0,1,0
3,202,202,11,2,9,4,3
31,208,208,10,10,0,1,0
23,240,240,33,33,0,1,0
35,258,258,22,16,6,2,1
26,267,267,4,4,0,1,0
15,274,274,39,39,0,1,0
17,277,277,76,76,0,1,0
8,282,282,14,14,0,1,0
6,290,290,9,1,8,2,1
19,300,300,16,16,0,1,0
33,304,304,32,17,15,4,3
32,333,333,39,2,37,3,2
28,336,336,151,151,0,1,0
30,346,346,34,34,0,1,0
22,356,356,12,12,0,1,0
27,363,363,19,16,3,2,1
12,388,388,36,2,34,3,2
18,400,400,7,7,0,1,0
7,420,420,14,1,13,2,1
14,422,422,33,15,18,3,2
5,430,430,100,64,36,2,1
34,444,444,118,103,15,4,3
0,459,459,57,9,48,3,2
24,469,469,29,29,0,1,0
29,477,477,21,21,0,1,0
25,483,483,29,20,9,4,3
37,490,490,33,33,0,1,0
1,495,495,42,22,20,2,1
38,499,499,49,49,0,1,0

3,100,100,5,5,0,1,0
16,101,101,3,3,0,1,0
5,102,102,1,1,0,1,0
28,117,117,12,12,0,1,0
8,128,128,16,16,0,1,0
32,134,134,12,1,11,4,3
25,141,141,11,8,3,2,1
22,142,142,5,2,3,2,1
33,148,148,6,6,0,1,0
18,159,159,5,5,0,1,0
9,160,160,37,37,0,1,0
40,161,161,31,10,21,2,1
23,166,166,2,2,0,1,0
31,168,168,24,9,15,4,3
41,175,175,5,5,0,1,0
2,192,192,19,7,12,4,3
17,198,198,26,26,0,1,0
35,204,204,27,27,0,1,0
14,206,206,14,14,0,1,0
7,218,218,15,3,12,2,1
12,252,252,13,5,8,3,2
30,255,255,9,3,6,3,2
1,262,262,13,1,12,3,2
19,269,269,33,17,16,2,1
10,278,278,1,1,0,1,0
36,283,283,13,13,0,1,0
39,339,339,34,1,33,4,3
21,344,344,17,17,0,1,0
42,354,354,27,27,0,1,0
43,356,356,32,2,30,2,1
13,361,361,3,3,0,1,0
24,377,377,64,16,48,4,3
0,389,389,18,18,0,1,0
11,398,398,51,51,0,1,0
27,415,415,14,6,8,3,2
34,428,428,16,16,0,1,0
29,435,435,121,118,3,2,1
15,445,445,28,22,6,2,1
38,453,453,142,34,108,4,3
37,455,455,2,2,0,1,0
6,459,459,22,22,0,1,0
20,460,460,23,1,22,4,3
4,465,465,20,1,19,2,1
26,466,466,41,15,26,3,2

3,106,106,12,12,0,1,0
27,158,158,18,10,8,3,2
15,163,163,14,2,12,4,3
28,184,184,25,25,0,1,0
26,206,206,9,9,0,1,0
7,221,221,59,59,0,1,0
20,222,222,55,24,31,2,1
18,257,257,44,44,0,1,0
12,258,258,46,27,19,3,2
21,282,282,44,44,0,1,0
4,286,286,7,7,0,1,0
13,293,293,31,8,23,2,1
1,294,294,13,13,0,1,0
2,330,330,35,17,18,2,1
11,360,360,27,6,21,4,3
29,385,385,11,5,6,2,1
24,403,403,8,8,0,1,0
17,405,405,30,30,0,1,0
25,406,406,128,102,26,3,2
30,409,409,27,6,21,3,2
23,418,418,39,39,0,1,0
22,430,430,13,13,0,1,0
9,457,457,134,126,8,3,2
14,467,467,56,17,39,4,3
6,468,468,34,34,0,1,0
19,470,470,7,7,0,1,0
8,471,471,66,66,0,1,0
5,472,472,99,19,80,3,2
0,479,479,67,39,28,3,2
16,485,485,3,3,0,1,0
10,487,487,67,67,0,1,0

26,106,106,9,5,4,2,1
2,114,114,24,24,0,1,0
16,134,134,13,13,0,1,0
20,138,138,2,2,0,1,0
0,147,147,13,13,0,1,0
32,147,147,5,5,0,1,0
11,196,196,8,8,0,1,0
35,204,204,8,8,0,1,0
14,211,211,9,9,0,1,0
9,237,237,15,9,6,2,1
34,245,245,41,5,36,4,3
8,285,285,11,11,0,1,0
21,288,288,84,27,57,4,3
23,298,298,60,54,6,2,1
7,308,308,2,2,0,1,0
5,313,313,20,8,12,4,3
22,327,327,72,28,44,3,2
17,327,327,56,56,0,1,0
18,337,337,2,2,0,1,0
19,343,343,34,34,0,1,0
13,346,346,2,2,0,1,0
10,348,348,109,89,20,3,2
31,350,350,3,3,0,1,0
24,355,355,15,15,0,1,0
1,356,356,24,6,18,4,3
12,367,367,1,1,0,1,0
6,370,370,47,35,12,2,1
15,381,381,113,64,49,3,2
30,399,399,49,10,39,4,3
4,447,447,34,16,18,4,3
3,458,458,41,41,0,1,0
33,465,465,35,35,0,1,0
29,479,479,4,4,0,1,0
28,486,486,74,74,0,1,0
27,486,486,72,10,62,3,2
25,493,493,55,55,0,1,0

25,116,116,13,13,0,1,0
8,140,140,2,2,0,1,0
26,143,143,17,1,16,2,1
31,144,144,19,12,7,2,1
17,153,153,26,9,17,2,1
14,165,165,10,10,0,1,0
20,185,185,2,2,0,1,0
0,186,186,54,6,48,2,1
32,192,192,18,18,0,1,0
16,244,244,5,5,0,1,0
3,266,266,33,33,0,1,0
27,279,279,64,64,0,1,0
2,282,282,39,10,29,2,1
9,285,285,39,39,0,1,0
10,294,294,5,5,0,1,0
7,295,295,138,90,48,3,2
34,298,298,49,49,0,1,0
28,308,308,101,5,96,3,2
12,314,314,7,4,3,2,1
15,332,332,28,28,0,1,0
21,342,342,42,9,33,2,1
22,342,342,32,26,6,3,2
30,345,345,5,5,0,1,0
29,378,378,24,8,16,2,1
11,386,386,2,2,0,1,0
24,403,403,8,5,3,2,1
19,420,420,60,60,0,1,0
18,425,425,47,24,23,4,3
4,430,430,15,15,0,1,0
13,447,447,3,3,0,1,0
23,465,465,9,4,5,2,1
35,465,465,20,20,0,1,0
1,484,484,10,10,0,1,0
6,493,493,35,35,0,1,0
5,495,495,60,3,57,4,3
33,497,497,8,2,6,3,2

13,122,122,3,3,0,1,0
23,146,146,5,5,0,1,0
6,147,147,26,22,4,2,1
2,158,158,1,1,0,1,0
27,175,175,8,3,5,2,1
0,193,193,8,8,0,1,0
24,200,200,13,13,0,1,0
19,216,216,74,74,0,1,0
8,224,224,14,2,12,3,2
20,225,225,17,17,0,1,0
29,256,256,44,44,0,1,0
25,269,269,25,7,18,4,3
11,286,286,48,42,6,2,1
5,287,287,53,9,44,2,1
9,308,308,32,17,15,2,1
28,328,328,8,2,6,3,2
1,348,348,33,19,14,3,2
32,352,352,4,4,0,1,0
22,365,365,67,10,57,4,3
26,381,381,40,30,10,2,1
10,382,382,19,8,11,2,1
17,411,411,97,69,28,3,2
12,415,415,136,113,23,4,3
4,425,425,104,56,48,3,2
31,427,427,74,74,0,1,0
16,440,440,31,5,26,3,2
21,451,451,6,6,0,1,0
15,454,454,22,2,20,2,1
3,454,454,78,48,30,4,3
30,454,454,7,7,0,1,0
33,473,473,16,10,6,2,1
7,488,488,36,36,0,1,0
18,490,490,65,65,0,1,0
14,499,499,11,5,6,3,2

23,110,110,12,12,0,1,0
33,115,115,1,1,0,1,0
31,127,127,18,18,0,1,0
28,127,127,6,6,0,1,0
13,134,134,6,6,0,1,0
24,144,144,39,39,0,1,0
10,171,171,119,32,87,4,3
2,176,176,13,1,12,3,2
32,184,184,9,9,0,1,0
18,252,252,1,1,0,1,0
4,258,258,18,6,12,2,1
30,284,284,14,1,13,2,1
1,292,292,17,5,12,2,1
27,330,330,43,43,0,1,0
12,336,336,31,17,14,3,2
20,350,350,53,53,0,1,0
16,353,353,134,80,54,3,2
7,366,366,9,3,6,2,1
6,381,381,34,34,0,1,0
26,383,383,64,64,0,1,0
0,401,401,1,1,0,1,0
17,420,420,13,10,3,2,1
3,422,422,26,26,0,1,0
21,429,429,60,13,47,4,3
15,433,433,1,1,0,1,0
19,456,456,2,2,0,1,0
8,465,465,87,9,78,4,3
5,466,466,117,57,60,3,2
22,478,478,49,16,33,4,3
25,478,478,21,21,0,1,0
14,479,479,25,25,0,1,0
11,479,479,27,27,0,1,0
29,492,492,7,7,0,1,0
9,493,493,19,3,16,3,2

19,106,106,23,23,0,1,0
21,108,108,8,8,0,1,0
6,114,114,1,1,0,1,0
32,114,114,4,4,0,1,0
10,128,128,7,4,3,2,1
7,131,131,1,1,0,1,0
9,134,134,10,1,9,4,3
13,144,144,27,15,12,3,2
4,167,167,11,11,0,1,0
17,189,189,13,13,0,1,0
18,193,193,58,58,0,1,0
25,197,197,14,5,9,2,1
16,197,197,13,1,12,3,2
28,205,205,23,13,10,3,2
30,216,216,1,1,0,1,0
27,234,234,2,2,0,1,0
1,239,239,132,132,0,1,0
2,239,239,55,55,0,1,0
24,239,239,13,13,0,1,0
20,255,255,31,31,0,1,0
0,261,261,37,37,0,1,0
29,275,275,93,57,36,3,2
22,303,303,29,29,0,1,0
26,324,324,4,4,0,1,0
12,342,342,1,1,0,1,0
5,371,371,21,21,0,1,0
14,414,414,24,24,0,1,0
11,422,422,79,53,26,2,1
23,425,425,52,52,0,1,0
8,426,426,27,15,12,3,2
15,429,429,40,4,36,3,2
31,433,433,13,13,0,1,0
3,436,436,48,31,17,2,1

30,109,109,7,7,0,1,0
15,123,123,11,11,0,1,0
12,151,151,7,7,0,1,0
16,160,160,9,9,0,1,0
31,167,167,11,11,0,1,0
7,179,179,11,5,6,2,1
29,179,179,26,7,19,2,1
4,196,196,7,7,0,1,0
6,196,196,30,30,0,1,0
24,237,237,3,3,0,1,0
32,258,258,26,8,18,3,2
33,287,287,8,8,0,1,0
3,288,288,72,72,0,1,0
14,290,290,43,15,28,2,1
22,295,295,47,17,30,2,1
11,305,305,22,18,4,2,1
23,311,311,38,26,12,4,3
28,320,320,5,1,4,2,1
19,325,325,47,39,8,3,2
26,327,327,8,8,0,1,0
5,331,331,54,44,10,2,1
25,360,360,127,19,108,4,3
21,382,382,16,16,0,1,0
13,400,400,1,1,0,1,0
1,419,419,37,37,0,1,0
20,428,428,8,8,0,1,0
0,428,428,167,167,0,1,0
8,455,455,77,2,75,3,2
10,459,459,2,2,0,1,0
9,466,466,42,25,17,4,3
18,480,480,62,19,43,2,1
17,483,483,55,33,22,4,3
27,492,492,117,31,86,3,2
2,493,493,18,18,0,1,0

6,104,104,1,1,0,1,0
29,108,108,34,24,10,3,2
1,114,114,1,1,0,1,0
24,129,129,15,5,10,2,1
28,130,130,6,3,3,2,1
19,130,130,15,5,10,2,1
4,134,134,1,1,0,1,0
23,135,135,8,2,6,3,2
3,171,171,16,16,0,1,0
30,205,205,64,61,3,2,1
22,219,219,16,7,9,2,1
15,229,229,1,1,0,1,0
0,263,263,49,9,40,3,2
11,264,264,1,1,0,1,0
7,282,282,22,3,19,3,2
27,301,301,30,30,0,1,0
17,309,309,2,2,0,1,0
16,315,315,11,8,3,2,1
14,328,328,63,36,27,2,1
31,336,336,3,3,0,1,0
18,339,339,4,4,0,1,0
25,359,359,12,1,11,4,3
5,393,393,153,76,77,3,2
21,407,407,49,49,0,1,0
13,411,411,25,5,20,3,2
12,421,421,149,30,119,4,3
8,448,448,21,5,16,2,1
9,478,478,123,80,43,4,3
10,483,483,146,110,36,3,2
2,489,489,2,2,0,1,0
26,490,490,43,35,8,2,1
20,496,496,96,28,68,3,2

34,103,103,11,11,0,1,0
13,103,103,9,9,0,1,0
2,109,109,8,8,0,1,0
8,119,119,4,4,0,1,0
9,126,126,17,17,0,1,0
20,148,148,8,8,0,1,0
21,151,151,1,1,0,1,0
7,151,151,3,3,0,1,0
37,155,155,3,3,0,1,0
24,170,170,49,49,0,1,0
42,175,175,63,63,0,1,0
6,179,179,22,22,0,1,0
35,182,182,11,1,10,4,3
12,197,197,4,4,0,1,0
38,198,198,3,3,0,1,0
3,205,205,15,3,12,4,3
40,206,206,8,5,3,2,1
4,208,208,8,8,0,1,0
16,212,212,18,18,0,1,0
11,215,215,2,2,0,1,0
18,220,220,7,2,5,2,1
27,222,222,44,44,0,1,0
14,240,240,1,1,0,1,0
32,249,249,13,4,9,4,3
17,308,308,31,31,0,1,0
39,309,309,11,11,0,1,0
0,335,335,32,9,23,4,3
33,349,349,82,82,0,1,0
26,352,352,3,3,0,1,0
19,380,380,11,11,0,1,0
28,388,388,65,5,60,3,2
36,396,396,48,36,12,4,3
15,408,408,88,88,0,1,0
25,415,415,51,51,0,1,0
41,417,417,48,48,0,1,0
30,426,426,19,7,12,2,1
5,445,445,40,6,34,3,2
22,449,449,4,4,0,1,0
31,465,465,26,11,15,4,3
29,468,468,35,2,33,4,3
10,471,471,79,19,60,4,3
23,472,472,1,1,0,1,0
1,486,486,5,1,4,2,1

19,105,105,21,7,14,3,2
3,122,122,1,1,0,1,0
11,123,123,14,14,0,1,0
27,128,128,7,3,4,2,1
10,153,153,22,17,5,2,1
20,163,163,5,2,3,2,1
23,176,176,1,1,0,1,0
17,186,186,59,43,16,2,1
28,196,196,40,8,32,2,1
14,200,200,57,17,40,2,1
29,207,207,3,3,0,1,0
12,239,239,14,5,9,4,3
5,256,256,49,4,45,4,3
2,274,274,22,22,0,1,0
9,279,279,56,47,9,4,3
0,330,330,1,1,0,1,0
15,330,330,35,32,3,2,1
30,331,331,85,69,16,2,1
22,344,344,3,3,0,1,0
33,345,345,51,51,0,1,0
16,350,350,39,12,27,4,3
6,357,357,49,49,0,1,0
31,369,369,2,2,0,1,0
1,386,386,21,21,0,1,0
4,388,388,44,44,0,1,0
8,393,393,56,24,32,3,2
25,395,395,23,14,9,4,3
18,426,426,53,53,0,1,0
13,433,433,12,12,0,1,0
34,442,442,45,19,26,2,1
32,445,445,58,40,18,4,3
7,452,452,11,11,0,1,0
26,472,472,1,1,0,1,0
24,481,481,41,5,36,2,1
21,489,489,42,42,0,1,0

20,119,119,33,2,31,2,1
17,139,139,10,4,6,2,1
31,159,159,6,6,0,1,0
14,167,167,7,7,0,1,0
18,174,174,28,19,9,4,3
2,191,191,15,1,14,2,1
27,201,201,2,2,0,1,0
30,204,204,60,60,0,1,0
12,208,208,4,4,0,1,0
11,217,217,13,8,5,2,1
6,226,226,2,2,0,1,0
28,227,227,15,11,4,2,1
33,232,232,20,20,0,1,0
19,237,237,17,17,0,1,0
24,267,267,21,21,0,1,0
36,270,270,113,113,0,1,0
21,297,297,6,6,0,1,0
9,299,299,1,1,0,1,0
16,308,308,1,1,0,1,0
3,309,309,120,101,19,2,1
10,311,311,103,103,0,1,0
0,311,311,2,2,0,1,0
35,315,315,16,16,0,1,0
37,330,330,1,1,0,1,0
29,354,354,8,2,6,2,1
15,360,360,1,1,0,1,0
8,360,360,5,5,0,1,0
4,368,368,87,63,24,4,3
13,373,373,9,6,3,2,1
22,391,391,7,7,0,1,0
7,393,393,25,14,11,2,1
5,396,396,25,6,19,4,3
23,404,404,98,59,39,4,3
1,410,410,63,63,0,1,0
25,417,417,31,7,24,3,2
32,422,422,22,12,10,2,1
34,433,433,8,3,5,2,1
26,453,453,25,11,14,2,1

14,103,103,5,1,4,2,1
7,105,105,15,6,9,2,1
35,110,110,34,19,15,4,3
28,137,137,20,14,6,2,1
12,146,146,5,5,0,1,0
1,156,156,25,25,0,1,0
15,168,168,1,1,0,1,0
39,184,184,6,6,0,1,0
25,209,209,10,10,0,1,0
21,215,215,10,10,0,1,0
37,215,215,4,4,0,1,0
32,227,227,4,4,0,1,0
23,234,234,37,37,0,1,0
6,239,239,6,1,5,2,1
40,245,245,15,15,0,1,0
31,253,253,46,46,0,1,0
36,256,256,4,1,3,2,1
13,296,296,29,29,0,1,0
17,299,299,8,8,0,1,0
19,303,303,15,4,11,2,1
2,307,307,5,1,4,2,1
26,335,335,14,8,6,3,2
33,340,340,152,142,10,2,1
10,345,345,80,4,76,4,3
22,351,351,24,24,0,1,0
24,352,352,2,2,0,1,0
38,352,352,40,12,28,2,1
34,367,367,30,30,0,1,0
27,379,379,12,12,0,1,0
29,385,385,14,4,10,2,1
30,406,406,39,11,28,3,2
0,411,411,14,14,0,1,0
9,433,433,53,17,36,4,3
20,434,434,14,8,6,2,1
11,441,441,100,100,0,1,0
3,465,465,83,2,81,4,3
16,470,470,10,10,0,1,0
5,473,473,5,5,0,1,0
8,477,477,51,51,0,1,0
4,487,487,19,19,0,1,0
18,495,495,37,37,0,1,0

22,117,117,8,8,0,1,0
16,128,128,5,5,0,1,0
11,142,142,8,8,0,1,0
21,146,146,2,2,0,1,0
26,149,149,31,26,5,2,1
35,152,152,21,7,14,3,2
6,178,178,4,1,3,2,1
17,186,186,16,16,0,1,0
5,192,192,32,7,25,2,1
30,197,197,19,19,0,1,0
15,213,213,17,7,10,2,1
24,215,215,1,1,0,1,0
18,234,234,20,20,0,1,0
9,236,236,19,19,0,1,0
14,238,238,75,17,58,4,3
33,253,253,18,3,15,4,3
28,269,269,38,38,0,1,0
10,284,284,8,3,5,2,1
7,291,291,4,4,0,1,0
37,300,300,11,11,0,1,0
8,305,305,8,8,0,1,0
19,311,311,111,6,105,4,3
2,316,316,23,4,19,2,1
34,338,338,124,124,0,1,0
25,352,352,5,1,4,2,1
3,356,356,41,2,39,2,1
4,356,356,20,20,0,1,0
0,362,362,1,1,0,1,0
20,366,366,9,9,0,1,0
31,387,387,27,13,14,2,1
27,398,398,91,64,27,2,1
13,427,427,8,8,0,1,0
23,438,438,6,6,0,1,0
36,443,443,100,100,0,1,0
29,450,450,5,5,0,1,0
1,464,464,79,57,22,3,2
32,476,476,48,48,0,1,0
12,478,478,5,2,3,2,1

25,118,118,1,1,0,1,0
14,126,126,5,5,0,1,0
29,127,127,23,7,16,3,2
23,142,142,2,2,0,1,0
40,145,145,25,25,0,1,0
38,151,151,9,9,0,1,0
17,173,173,8,4,4,2,1
21,187,187,28,2,26,2,1
11,191,191,17,14,3,2,1
28,208,208,35,35,0,1,0
37,210,210,28,12,16,3,2
32,217,217,7,2,5,2,1
30,227,227,5,1,4,2,1
15,229,229,1,1,0,1,0
4,248,248,2,2,0,1,0
1,257,257,67,58,9,4,3
7,262,262,14,14,0,1,0
13,263,263,1,1,0,1,0
5,271,271,51,32,19,2,1
0,280,280,62,12,50,3,2
6,282,282,46,46,0,1,0
12,308,308,13,13,0,1,0
27,320,320,69,69,0,1,0
9,322,322,3,3,0,1,0
24,327,327,36,36,0,1,0
8,357,357,45,23,22,3,2
35,358,358,80,45,35,2,1
10,364,364,10,1,9,4,3
19,378,378,8,8,0,1,0
34,381,381,30,6,24,3,2
22,383,383,11,11,0,1,0
31,391,391,34,22,12,4,3
3,408,408,20,8,12,4,3
20,412,412,13,13,0,1,0
18,414,414,79,79,0,1,0
33,425,425,88,75,13,2,1
16,425,425,1,1,0,1,0
26,426,426,7,1,6,2,1
36,439,439,16,16,0,1,0
39,471,471,39,39,0,1,0
2,485,485,22,22,0,1,0

12,122,122,33,21,12,3,2
20,149,149,39,32,7,2,1
14,165,165,1,1,0,1,0
3,196,196,22,14,8,3,2
15,197,197,2,2,0,1,0
8,215,215,20,20,0,1,0
16,216,216,24,12,12,2,1
24,227,227,1,1,0,1,0
11,229,229,6,6,0,1,0
0,255,255,250,221,29,2,1
23,281,281,48,48,0,1,0
7,296,296,27,27,0,1,0
25,324,324,43,21,22,2,1
21,339,339,19,19,0,1,0
22,343,343,1,1,0,1,0
4,361,361,74,47,27,4,3
1,374,374,55,55,0,1,0
9,393,393,46,46,0,1,0
17,412,412,6,6,0,1,0
13,423,423,17,7,10,2,1
2,427,427,44,14,30,4,3
18,429,429,234,234,0,1,0
5,429,429,6,6,0,1,0
26,446,446,17,17,0,1,0
10,456,456,7,7,0,1,0
6,459,459,26,26,0,1,0
19,492,492,7,7,0,1,0

5,108,108,9,9,0,1,0
18,110,110,3,3,0,1,0
25,115,115,26,2,24,4,3
26,119,119,3,3,0,1,0
11,121,121,12,8,4,2,1
21,125,125,22,22,0,1,0
22,128,128,4,4,0,1,0
42,140,140,6,6,0,1,0
37,148,148,12,4,8,2,1
33,151,151,6,6,0,1,0
17,156,156,19,19,0,1,0
20,158,158,1,1,0,1,0
2,171,171,13,5,8,2,1
7,177,177,9,9,0,1,0
12,190,190,5,5,0,1,0
40,201,201,66,66,0,1,0
38,206,206,39,39,0,1,0
0,211,211,2,2,0,1,0
9,231,231,7,1,6,3,2
43,243,243,10,4,6,3,2
31,244,244,17,17,0,1,0
28,251,251,10,10,0,1,0
27,261,261,4,4,0,1,0
3,275,275,30,22,8,3,2
29,299,299,94,52,42,2,1
39,307,307,56,5,51,4,3
13,313,313,1,1,0,1,0
19,316,316,43,17,26,4,3
34,346,346,34,4,30,2,1
10,351,351,42,42,0,1,0
16,355,355,18,2,16,2,1
1,357,357,24,24,0,1,0
36,388,388,82,13,69,4,3
32,406,406,9,2,7,2,1
23,416,416,18,10,8,3,2
24,429,429,8,8,0,1,0
44,436,436,8,3,5,2,1
14,444,444,50,8,42,3,2
6,456,456,1,1,0,1,0
15,456,456,10,10,0,1,0
41,478,478,38,38,0,1,0
35,481,481,20,11,9,2,1
8,488,488,58,30,28,2,1
4,494,494,6,1,5,2,1
30,500,500,12,2,10,4,3

17,136,136,1,1,0,1,0
2,138,138,4,1,3,2,1
13,143,143,1,1,0,1,0
0,144,144,11,1,10,3,2
5,145,145,10,10,0,1,0
31,156,156,15,15,0,1,0
10,157,157,5,5,0,1,0
9,204,204,32,22,10,3,2
15,211,211,25,7,18,3,2
22,213,213,42,38,4,2,1
32,218,218,13,2,11,2,1
7,224,224,76,27,49,2,1
36,226,226,7,7,0,1,0
11,240,240,8,8,0,1,0
28,243,243,12,12,0,1,0
20,260,260,2,2,0,1,0
12,297,297,1,1,0,1,0
6,306,306,34,34,0,1,0
30,307,307,11,11,0,1,0
16,316,316,9,9,0,1,0
23,323,323,4,4,0,1,0
29,330,330,28,28,0,1,0
37,330,330,11,1,10,3,2
18,350,350,15,15,0,1,0
27,363,363,6,6,0,1,0
8,368,368,36,5,31,2,1
3,381,381,49,37,12,3,2
25,386,386,15,3,12,4,3
35,396,396,13,13,0,1,0
4,397,397,40,19,21,2,1
26,400,400,14,5,9,2,1
33,406,406,18,8,10,3,2
14,407,407,84,84,0,1,0
24,418,418,61,15,46,3,2
21,428,428,68,68,0,1,0
1,436,436,18,18,0,1,0
34,451,451,339,339,0,1,0
19,494,494,85,6,79,4,3

12,103,103,9,9,0,1,0
32,107,107,8,8,0,1,0
23,115,115,7,7,0,1,0
1,126,126,15,10,5,2,1
9,127,127,17,17,0,1,0
17,144,144,32,32,0,1,0
21,154,154,4,4,0,1,0
15,183,183,7,7,0,1,0
30,188,188,62,62,0,1,0
26,192,192,14,4,10,3,2
5,194,194,27,9,18,4,3
0,198,198,95,50,45,2,1
3,200,200,21,7,14,2,1
27,201,201,73,73,0,1,0
7,221,221,6,6,0,1,0
11,243,243,6,1,5,2,1
18,250,250,43,13,30,3,2
31,254,254,9,9,0,1,0
16,258,258,1,1,0,1,0
24,264,264,27,9,18,2,1
13,294,294,8,8,0,1,0
6,305,305,11,11,0,1,0
25,309,309,23,23,0,1,0
20,325,325,18,4,14,4,3
28,349,349,11,11,0,1,0
22,388,388,58,58,0,1,0
4,399,399,135,83,52,3,2
14,401,401,23,23,0,1,0
8,416,416,36,19,17,2,1
2,422,422,29,1,28,3,2
19,468,468,14,14,0,1,0
29,471,471,8,8,0,1,0
10,480,480,34,20,14,3,2

34,117,117,21,21,0,1,0
28,142,142,10,10,0,1,0
37,145,145,21,21,0,1,0
19,160,160,5,5,0,1,0
17,175,175,34,34,0,1,0
25,177,177,2,2,0,1,0
10,202,202,9,9,0,1,0
26,213,213,15,6,9,4,3
36,224,224,16,13,3,2,1
21,227,227,68,44,24,3,2
1,250,250,25,10,15,4,3
2,260,260,11,4,7,2,1
14,297,297,30,1,29,2,1
11,313,313,52,52,0,1,0
31,323,323,32,32,0,1,0
5,330,330,24,24,0,1,0
4,332,332,16,10,6,2,1
22,342,342,6,2,4,2,1
27,349,349,9,9,0,1,0
3,352,352,15,7,8,3,2
20,356,356,52,28,24,4,3
13,377,377,31,5,26,2,1
29,378,378,29,18,11,2,1
7,381,381,62,27,35,2,1
6,385,385,59,13,46,2,1
35,391,391,32,32,0,1,0
24,397,397,4,4,0,1,0
16,400,400,23,23,0,1,0
9,407,407,1,1,0,1,0
18,418,418,49,49,0,1,0
12,427,427,51,14,37,2,1
8,429,429,33,33,0,1,0
32,451,451,164,121,43,2,1
0,455,455,52,28,24,4,3
23,472,472,25,2,23,4,3
30,480,480,51,36,15,2,1
33,482,482,5,5,0,1,0
15,495,495,36,36,0,1,0

28,101,101,12,12,0,1,0
21,103,103,7,2,5,2,1
24,108,108,8,8,0,1,0
34,117,117,2,2,0,1,0
2,128,128,4,4,0,1,0
15,130,130,6,6,0,1,0
37,146,146,48,48,0,1,0
17,151,151,17,17,0,1,0
0,164,164,5,5,0,1,0
27,165,165,16,16,0,1,0
25,166,166,16,16,0,1,0
23,166,166,10,10,0,1,0
9,167,167,2,2,0,1,0
19,167,167,23,7,16,2,1
16,182,182,2,2,0,1,0
8,202,202,8,8,0,1,0
14,244,244,73,61,12,4,3
7,269,269,13,3,10,2,1
11,276,276,41,9,32,3,2
1,283,283,73,73,0,1,0
33,285,285,8,1,7,2,1
36,309,309,10,4,6,3,2
10,309,309,70,8,62,3,2
4,314,314,8,8,0,1,0
18,316,316,20,20,0,1,0
12,317,317,5,2,3,2,1
30,351,351,7,1,6,2,1
26,376,376,76,20,56,3,2
20,381,381,49,49,0,1,0
29,388,388,19,19,0,1,0
39,393,393,92,2,90,4,3
22,401,401,8,1,7,2,1
32,407,407,5,5,0,1,0
31,432,432,48,7,41,2,1
6,440,440,1,1,0,1,0
35,442,442,11,1,10,3,2
13,442,442,7,1,6,3,2
38,451,451,142,40,102,4,3
3,484,484,13,13,0,1,0
5,500,500,27,27,0,1,0

10,106,106,28,4,24,2,1
1,114,114,4,4,0,1,0
8,123,123,4,1,3,2,1
32,164,164,14,7,7,2,1
15,165,165,24,11,13,2,1
20,182,182,3,3,0,1,0
9,213,213,5,5,0,1,0
21,222,222,25,25,0,1,0
13,231,231,22,11,11,2,1
18,231,231,49,46,3,2,1
14,240,240,33,33,0,1,0
23,241,241,16,16,0,1,0
12,250,250,4,4,0,1,0
5,261,261,1,1,0,1,0
33,273,273,57,45,12,4,3
16,282,282,9,9,0,1,0
11,289,289,10,10,0,1,0
17,297,297,29,15,14,3,2
7,306,306,27,27,0,1,0
28,323,323,4,1,3,2,1
25,337,337,28,11,17,2,1
19,344,344,7,1,6,3,2
0,349,349,2,2,0,1,0
24,356,356,28,19,9,2,1
6,358,358,81,29,52,4,3
29,363,363,36,36,0,1,0
26,379,379,88,26,62,3,2
2,383,383,167,122,45,2,1
3,391,391,43,25,18,3,2
22,393,393,1,1,0,1,0
30,398,398,78,78,0,1,0
31,407,407,42,25,17,2,1
4,415,415,62,47,15,2,1
27,434,434,75,53,22,2,1

21,101,101,3,3,0,1,0
4,108,108,38,29,9,2,1
7,119,119,18,18,0,1,0
11,126,126,3,3,0,1,0
6,147,147,3,3,0,1,0
0,157,157,1,1,0,1,0
30,176,176,1,1,0,1,0
14,183,183,27,27,0,1,0
5,210,210,4,4,0,1,0
25,242,242,23,6,17,4,3
15,251,251,43,40,3,2,1
26,258,258,17,17,0,1,0
24,261,261,22,22,0,1,0
8,283,283,100,100,0,1,0
17,291,291,43,3,40,2,1
23,300,300,9,3,6,2,1
12,303,303,46,46,0,1,0
10,303,303,45,15,30,4,3
13,350,350,99,70,29,2,1
9,360,360,82,20,62,3,2
29,370,370,10,5,5,2,1
16,381,381,5,5,0,1,0
3,415,415,14,1,13,2,1
2,418,418,10,10,0,1,0
1,438,438,127,64,63,4,3
27,442,442,33,33,0,1,0
20,448,448,67,1,66,3,2
28,463,463,159,159,0,1,0
19,468,468,55,31,24,2,1
18,472,472,1,1,0,1,0
22,495,495,23,6,17,4,3

5,112,112,4,4,0,1,0
4,113,113,18,8,10,2,1
26,115,115,2,2,0,1,0
24,121,121,11,11,0,1,0
20,124,124,6,6,0,1,0
36,124,124,3,3,0,1,0
27,133,133,41,36,5,2,1
8,147,147,26,26,0,1,0
14,166,166,40,13,27,4,3
10,176,176,22,22,0,1,0
2,181,181,2,2,0,1,0
32,208,208,21,21,0,1,0
6,222,222,43,43,0,1,0
29,223,223,35,35,0,1,0
16,223,223,11,6,5,2,1
31,244,244,48,48,0,1,0
12,249,249,8,4,4,2,1
33,252,252,2,2,0,1,0
28,257,257,32,6,26,3,2
11,271,271,34,4,30,4,3
18,277,277,5,5,0,1,0
22,285,285,122,122,0,1,0
30,287,287,36,6,30,4,3
17,298,298,9,9,0,1,0
1,328,328,7,7,0,1,0
21,347,347,5,5,0,1,0
23,361,361,8,8,0,1,0
34,368,368,6,2,4,2,1
0,390,390,1,1,0,1,0
13,403,403,35,35,0,1,0
9,405,405,14,3,11,2,1
3,414,414,13,6,7,2,1
25,416,416,5,5,0,1,0
15,418,418,12,3,9,4,3
35,431,431,47,47,0,1,0
37,451,451,16,6,10,2,1
19,480,480,21,6,15,4,3
7,496,496,176,101,75,4,3

0,111,111,2,2,0,1,0
16,121,121,19,16,3,2,1
1,139,139,14,14,0,1,0
2,177,177,6,6,0,1,0
12,182,182,3,3,0,1,0
27,188,188,10,10,0,1,0
21,191,191,68,42,26,2,1
31,198,198,1,1,0,1,0
8,203,203,17,9,8,3,2
28,208,208,10,10,0,1,0
24,218,218,47,44,3,2,1
32,235,235,11,1,10,3,2
20,235,235,8,2,6,3,2
3,242,242,15,15,0,1,0
29,247,247,12,12,0,1,0
17,255,255,16,13,3,2,1
9,259,259,19,19,0,1,0
22,263,263,66,37,29,2,1
10,288,288,52,26,26,2,1
11,289,289,34,34,0,1,0
7,299,299,171,148,23,4,3
4,327,327,125,100,25,2,1
6,351,351,31,7,24,4,3
13,357,357,8,3,5,2,1
19,374,374,30,15,15,4,3
18,390,390,27,27,0,1,0
5,394,394,1,1,0,1,0
25,404,404,11,11,0,1,0
30,428,428,19,19,0,1,0
15,430,430,47,47,0,1,0
23,443,443,74,74,0,1,0
14,487,487,23,13,10,2,1
26,490,490,31,31,0,1,0

1,108,108,2,2,0,1,0
10,135,135,10,4,6,2,1
28,138,138,13,10,3,2,1
21,148,148,5,5,0,1,0
29,158,158,3,3,0,1,0
27,163,163,10,10,0,1,0
5,180,180,3,3,0,1,0
31,182,182,28,21,7,2,1
17,190,190,27,2,25,4,3
23,227,227,9,6,3,2,1
13,248,248,56,56,0,1,0
34,256,256,6,6,0,1,0
38,259,259,6,6,0,1,0
8,260,260,3,3,0,1,0
9,320,320,14,5,9,4,3
25,333,333,2,2,0,1,0
32,335,335,49,19,30,2,1
16,349,349,39,39,0,1,0
11,350,350,20,2,18,4,3
33,360,360,42,19,23,2,1
0,366,366,66,52,14,2,1
2,368,368,19,19,0,1,0
37,389,389,37,37,0,1,0
20,400,400,65,20,45,2,1
26,400,400,100,100,0,1,0
35,402,402,17,17,0,1,0
24,411,411,81,81,0,1,0
19,417,417,35,7,28,3,2
22,417,417,18,2,16,3,2
6,431,431,1,1,0,1,0
15,433,433,32,23,9,2,1
7,446,446,161,112,49,4,3
36,452,452,152,131,21,4,3
4,454,454,22,4,18,4,3
40,463,463,9,9,0,1,0
39,465,465,77,68,9,2,1
14,465,465,10,10,0,1,0
3,471,471,10,10,0,1,0
30,493,493,23,23,0,1,0
18,494,494,1,1,0,1,0
12,497,497,7,1,6,2,1

35,101,101,22,5,17,2,1
18,111,111,1,1,0,1,0
28,114,114,8,1,7,2,1
16,136,136,32,32,0,1,0
26,153,153,16,16,0,1,0
5,157,157,5,1,4,2,1
4,160,160,35,26,9,4,3
31,170,170,38,35,3,2,1
6,183,183,21,7,14,3,2
30,193,193,2,2,0,1,0
15,214,214,10,10,0,1,0
1,216,216,19,11,8,2,1
12,217,217,6,6,0,1,0
9,222,222,48,40,8,2,1
21,238,238,34,14,20,2,1
33,253,253,24,4,20,3,2
11,262,262,10,6,4,2,1
0,264,264,27,7,20,2,1
22,273,273,30,2,28,2,1
29,303,303,8,8,0,1,0
19,308,308,48,23,25,2,1
23,313,313,28,17,11,4,3
34,325,325,79,79,0,1,0
7,345,345,31,31,0,1,0
25,349,349,4,4,0,1,0
8,383,383,7,7,0,1,0
14,405,405,42,42,0,1,0
20,412,412,9,9,0,1,0
10,413,413,39,39,0,1,0
27,430,430,66,37,29,2,1
2,432,432,27,4,23,4,3
13,448,448,22,22,0,1,0
24,451,451,47,31,16,3,2
32,468,468,28,20,8,3,2
17,468,468,34,34,0,1,0
3,496,496,95,27,68,4,3

9,100,100,12,12,0,1,0
34,103,103,4,4,0,1,0
22,120,120,2,2,0,1,0
28,132,132,4,4,0,1,0
18,149,149,1,1,0,1,0
42,149,149,11,11,0,1,0
0,159,159,22,22,0,1,0
24,177,177,6,6,0,1,0
44,184,184,6,3,3,2,1
35,187,187,4,4,0,1,0
5,190,190,36,11,25,2,1
29,194,194,8,8,0,1,0
1,195,195,7,1,6,2,1
6,198,198,8,8,0,1,0
27,200,200,10,10,0,1,0
19,209,209,4,4,0,1,0
13,247,247,25,2,23,2,1
21,264,264,12,12,0,1,0
16,266,266,11,11,0,1,0
40,275,275,72,30,42,2,1
32,276,276,21,5,16,2,1
30,283,283,6,6,0,1,0
14,290,290,5,2,3,2,1
2,326,326,13,10,3,2,1
26,335,335,14,14,0,1,0
36,335,335,41,24,17,2,1
37,343,343,21,3,18,2,1
45,362,362,6,6,0,1,0
7,386,386,40,40,0,1,0
33,387,387,68,8,60,4,3
39,400,400,2,2,0,1,0
8,402,402,57,20,37,2,1
23,410,410,14,1,13,2,1
31,413,413,89,21,68,3,2
20,414,414,13,13,0,1,0
3,415,415,33,33,0,1,0
15,415,415,38,38,0,1,0
43,445,445,73,73,0,1,0
46,453,453,61,61,0,1,0
41,454,454,19,19,0,1,0
38,484,484,159,99,60,4,3
11,484,484,2,2,0,1,0
12,486,486,1,1,0,1,0
4,490,490,11,11,0,1,0
25,493,493,36,36,0,1,0
10,493,493,80,1,79,4,3
17,497,497,45,45,0,1,0

8,143,143,24,24,0,1,0
17,156,156,8,2,6,3,2
21,160,160,9,5,4,2,1
3,182,182,26,7,19,2,1
27,188,188,10,10,0,1,0
18,196,196,30,15,15,4,3
11,198,198,7,7,0,1,0
23,222,222,22,22,0,1,0
7,229,229,23,23,0,1,0
33,233,233,11,1,10,2,1
15,254,254,28,12,16,3,2
31,263,263,12,12,0,1,0
19,267,267,16,2,14,3,2
14,267,267,29,16,13,2,1
9,285,285,48,48,0,1,0
25,289,289,41,3,38,4,3
24,290,290,43,43,0,1,0
10,302,302,18,18,0,1,0
2,317,317,67,47,20,3,2
16,336,336,8,8,0,1,0
6,350,350,92,92,0,1,0
30,355,355,17,2,15,2,1
1,365,365,15,15,0,1,0
28,376,376,86,68,18,4,3
13,393,393,53,35,18,2,1
4,419,419,26,26,0,1,0
32,419,419,47,47,0,1,0
26,443,443,3,3,0,1,0
5,473,473,20,10,10,2,1
12,477,477,30,30,0,1,0
29,484,484,91,34,57,4,3
22,490,490,19,19,0,1,0
0,491,491,45,3,42,4,3
20,498,498,167,92,75,4,3

25,104,104,13,13,0,1,0
30,114,114,16,16,0,1,0
4,118,118,11,11,0,1,0
29,126,126,37,15,22,2,1
20,128,128,4,4,0,1,0
12,136,136,19,1,18,3,2
28,138,138,10,4,6,2,1
13,145,145,27,20,7,2,1
32,153,153,14,4,10,2,1
17,171,171,64,4,60,4,3
2,199,199,4,4,0,1,0
31,207,207,20,20,0,1,0
0,208,208,4,4,0,1,0
5,225,225,49,33,16,2,1
34,235,235,23,11,12,2,1
19,244,244,1,1,0,1,0
7,248,248,19,7,12,3,2
24,252,252,22,8,14,3,2
35,252,252,8,2,6,2,1
26,262,262,4,1,3,2,1
23,272,272,25,2,23,2,1
10,277,277,13,13,0,1,0
33,281,281,29,29,0,1,0
14,285,285,70,6,64,4,3
16,314,314,13,13,0,1,0
1,315,315,12,3,9,4,3
15,348,348,19,19,0,1,0
27,351,351,22,22,0,1,0
21,356,356,13,4,9,4,3
3,404,404,8,2,6,3,2
18,417,417,20,20,0,1,0
6,430,430,20,20,0,1,0
8,453,453,10,10,0,1,0
9,464,464,55,11,44,3,2
11,472,472,19,8,11,2,1
22,488,488,202,90,112,4,3

25,111,111,3,3,0,1,0
2,117,117,53,29,24,2,1
9,125,125,2,2,0,1,0
0,140,140,1,1,0,1,0
5,158,158,8,8,0,1,0
27,168,168,2,2,0,1,0
1,190,190,40,40,0,1,0
28,213,213,40,28,12,4,3
11,217,217,23,9,14,2,1
17,219,219,33,4,29,2,1
33,223,223,34,20,14,3,2
23,225,225,10,10,0,1,0
30,291,291,3,3,0,1,0
7,292,292,5,2,3,2,1
14,300,300,25,5,20,4,3
10,319,319,7,7,0,1,0
32,322,322,132,115,17,2,1
20,326,326,64,64,0,1,0
13,343,343,53,19,34,3,2
6,350,350,86,27,59,4,3
26,358,358,34,34,0,1,0
3,367,367,86,59,27,4,3
34,377,377,13,13,0,1,0
24,378,378,39,3,36,3,2
19,409,409,1,1,0,1,0
16,432,432,2,2,0,1,0
18,432,432,63,63,0,1,0
22,439,439,22,1,21,2,1
4,440,440,20,20,0,1,0
15,448,448,40,40,0,1,0
8,467,467,18,18,0,1,0
29,469,469,56,47,9,2,1
12,479,479,11,11,0,1,0
21,495,495,17,6,11,4,3
31,497,497,26,26,0,1,0

19,106,106,1,1,0,1,0
17,122,122,4,4,0,1,0
29,124,124,21,5,16,2,1
13,166,166,18,18,0,1,0
7,196,196,26,9,17,2,1
22,208,208,21,21,0,1,0
16,210,210,52,52,0,1,0
15,213,213,4,1,3,2,1
8,225,225,70,70,0,1,0
9,228,228,65,49,16,2,1
6,245,245,14,10,4,2,1
23,254,254,5,5,0,1,0
11,280,280,6,6,0,1,0
5,283,283,1,1,0,1,0
20,284,284,2,2,0,1,0
2,287,287,57,57,0,1,0
3,289,289,25,1,24,4,3
32,338,338,64,7,57,4,3
25,355,355,37,22,15,4,3
21,361,361,2,2,0,1,0
24,405,405,82,8,74,4,3
31,405,405,48,48,0,1,0
0,410,410,119,7,112,4,3
27,413,413,9,9,0,1,0
26,428,428,21,9,12,2,1
14,460,460,34,34,0,1,0
12,464,464,15,3,12,4,3
1,470,470,51,30,21,2,1
10,473,473,39,31,8,3,2
28,481,481,56,12,44,3,2
18,482,482,155,33,122,4,3
30,486,486,47,47,0,1,0
4,494,494,4,4,0,1,0

5,107,107,1,1,0,1,0
26,111,111,28,28,0,1,0
34,116,116,2,2,0,1,0
12,140,140,10,4,6,3,2
28,144,144,23,23,0,1,0
30,151,151,11,1,10,3,2
27,161,161,44,6,38,4,3
11,180,180,8,8,0,1,0
6,184,184,10,10,0,1,0
23,185,185,18,18,0,1,0
38,192,192,9,3,6,3,2
7,198,198,8,3,5,2,1
31,200,200,4,4,0,1,0
36,202,202,3,3,0,1,0
3,209,209,1,1,0,1,0
8,215,215,14,1,13,2,1
22,260,260,34,34,0,1,0
1,296,296,18,18,0,1,0
32,298,298,28,28,0,1,0
35,299,299,18,7,11,4,3
2,308,308,1,1,0,1,0
18,313,313,2,2,0,1,0
4,332,332,87,5,82,3,2
33,341,341,34,34,0,1,0
14,343,343,4,4,0,1,0
13,348,348,77,68,9,2,1
29,356,356,43,43,0,1,0
16,356,356,66,15,51,3,2
10,391,391,65,32,33,2,1
17,395,395,17,2,15,4,3
0,403,403,86,20,66,4,3
20,438,438,21,4,17,2,1
37,443,443,83,59,24,4,3
9,453,453,2,2,0,1,0
25,459,459,41,31,10,2,1
24,459,459,46,46,0,1,0
19,476,476,123,67,56,4,3
21,489,489,6,6,0,1,0
15,496,496,13,5,8,2,1

31,113,113,15,4,11,2,1
16,118,118,1,1,0,1,0
2,125,125,2,2,0,1,0
6,129,129,31,31,0,1,0
25,137,137,7,2,5,2,1
26,139,139,1,1,0,1,0
20,140,140,13,13,0,1,0
13,145,145,3,3,0,1,0
34,158,158,25,25,0,1,0
33,165,165,20,20,0,1,0
27,166,166,2,2,0,1,0
29,182,182,16,16,0,1,0
18,227,227,5,5,0,1,0
15,248,248,83,35,48,4,3
10,264,264,10,4,6,3,2
32,326,326,31,31,0,1,0
24,340,340,16,16,0,1,0
23,345,345,73,73,0,1,0
4,348,348,36,17,19,2,1
12,354,354,67,4,63,4,3
21,356,356,11,11,0,1,0
1,366,366,55,55,0,1,0
22,391,391,32,32,0,1,0
11,408,408,34,34,0,1,0
9,414,414,16,16,0,1,0
17,424,424,113,113,0,1,0
19,430,430,74,74,0,1,0
14,448,448,6,6,0,1,0
30,456,456,25,25,0,1,0
8,464,464,15,12,3,2,1
28,465,465,90,87,3,2,1
5,470,470,5,5,0,1,0
0,478,478,135,48,87,4,3
3,479,479,81,52,29,2,1
7,486,486,37,21,16,3,2

18,111,111,10,10,0,1,0
0,136,136,10,10,0,1,0
14,155,155,6,6,0,1,0
30,165,165,26,26,0,1,0
17,176,176,27,27,0,1,0
33,180,180,15,15,0,1,0
34,197,197,5,5,0,1,0
3,208,208,12,7,5,2,1
27,210,210,36,36,0,1,0
8,216,216,24,24,0,1,0
16,224,224,17,17,0,1,0
21,234,234,33,33,0,1,0
1,244,244,32,8,24,2,1
15,247,247,13,13,0,1,0
10,254,254,6,6,0,1,0
26,255,255,35,35,0,1,0
7,259,259,19,19,0,1,0
12,268,268,45,45,0,1,0
6,270,270,9,2,7,2,1
4,273,273,24,24,0,1,0
9,303,303,18,18,0,1,0
35,303,303,129,93,36,2,1
32,314,314,3,3,0,1,0
28,318,318,5,5,0,1,0
24,325,325,23,23,0,1,0
13,344,344,8,1,7,2,1
31,373,373,39,9,30,3,2
5,384,384,57,2,55,3,2
20,389,389,28,28,0,1,0
11,389,389,136,103,33,4,3
23,394,394,3,3,0,1,0
36,397,397,28,28,0,1,0
25,408,408,65,43,22,3,2
19,456,456,21,21,0,1,0
22,470,470,57,33,24,2,1
29,481,481,3,3,0,1,0
2,496,496,27,20,7,2,1

4,112,112,12,2,10,3,2
0,126,126,1,1,0,1,0
39,140,140,4,4,0,1,0
34,158,158,56,48,8,3,2
3,176,176,29,18,11,2,1
29,176,176,40,40,0,1,0
37,177,177,33,33,0,1,0
21,202,202,3,3,0,1,0
11,205,205,22,22,0,1,0
26,217,217,26,26,0,1,0
8,234,234,27,27,0,1,0
6,248,248,16,2,14,2,1
9,248,248,19,9,10,3,2
38,252,252,25,25,0,1,0
33,259,259,26,26,0,1,0
19,284,284,8,8,0,1,0
22,306,306,14,2,12,4,3
7,310,310,1,1,0,1,0
23,322,322,15,15,0,1,0
15,323,323,86,79,7,2,1
27,327,327,1,1,0,1,0
17,329,329,6,6,0,1,0
16,341,341,88,50,38,3,2
31,345,345,18,18,0,1,0
10,371,371,57,57,0,1,0
1,374,374,12,6,6,3,2
12,382,382,79,31,48,2,1
2,398,398,23,2,21,2,1
36,401,401,54,9,45,3,2
14,402,402,19,4,15,4,3
24,407,407,7,1,6,2,1
18,408,408,5,5,0,1,0
5,409,409,1,1,0,1,0
25,422,422,18,1,17,3,2
13,425,425,4,4,0,1,0
35,467,467,50,50,0,1,0
28,470,470,113,78,35,3,2
30,479,479,5,5,0,1,0
32,490,490,6,6,0,1,0
20,496,496,24,24,0,1,0

5,114,114,2,2,0,1,0
19,123,123,23,23,0,1,0
10,134,134,17,7,10,3,2
40,152,152,26,26,0,1,0
3,159,159,8,8,0,1,0
22,159,159,14,14,0,1,0
6,163,163,6,2,4,2,1
7,163,163,8,2,6,3,2
15,178,178,8,1,7,2,1
23,188,188,3,3,0,1,0
37,188,188,39,39,0,1,0
35,224,224,5,5,0,1,0
11,239,239,28,4,24,2,1
38,247,247,40,40,0,1,0
25,248,248,44,14,30,4,3
4,262,262,11,11,0,1,0
29,264,264,35,8,27,4,3
31,271,271,25,20,5,2,1
26,272,272,3,3,0,1,0
34,276,276,31,2,29,2,1
9,283,283,21,21,0,1,0
28,294,294,5,5,0,1,0
32,298,298,2,2,0,1,0
18,302,302,6,1,5,2,1
14,303,303,51,8,43,4,3
13,313,313,1,1,0,1,0
24,317,317,17,1,16,2,1
1,326,326,32,32,0,1,0
27,326,326,14,4,10,3,2
36,339,339,56,41,15,4,3
8,344,344,35,35,0,1,0
39,354,354,21,21,0,1,0
16,364,364,7,7,0,1,0
17,373,373,24,9,15,2,1
42,385,385,118,103,15,4,3
30,397,397,47,17,30,2,1
0,429,429,50,12,38,2,1
2,439,439,1,1,0,1,0
20,459,459,84,27,57,4,3
12,459,459,9,1,8,3,2
33,476,476,15,9,6,2,1
21,486,486,50,50,0,1,0
41,495,495,1,1,0,1,0

10,114,114,23,23,0,1,0
8,129,129,4,4,0,1,0
24,130,130,1,1,0,1,0
15,149,149,5,5,0,1,0
9,150,150,6,6,0,1,0
14,161,161,7,7,0,1,0
23,171,171,41,22,19,2,1
27,182,182,6,6,0,1,0
28,206,206,2,2,0,1,0
26,215,215,1,1,0,1,0
7,221,221,14,4,10,2,1
21,230,230,24,24,0,1,0
12,251,251,7,1,6,3,2
11,261,261,21,8,13,2,1
16,267,267,21,4,17,2,1
13,280,280,51,19,32,2,1
5,286,286,21,21,0,1,0
25,295,295,48,48,0,1,0
20,315,315,37,37,0,1,0
34,318,318,63,31,32,2,1
0,324,324,108,60,48,2,1
3,334,334,9,5,4,2,1
29,335,335,40,40,0,1,0
6,349,349,5,5,0,1,0
30,352,352,66,6,60,4,3
32,358,358,23,23,0,1,0
22,388,388,35,35,0,1,0
18,408,408,35,18,17,2,1
2,437,437,185,133,52,3,2
35,437,437,101,101,0,1,0
4,441,441,37,17,20,3,2
33,472,472,48,38,10,2,1
1,480,480,19,19,0,1,0
17,487,487,12,12,0,1,0
19,499,499,29,21,8,3,2
31,499,499,9,9,0,1,0

31,101,101,10,10,0,1,0
11,102,102,10,10,0,1,0
30,107,107,3,3,0,1,0
10,109,109,7,7,0,1,0
5,119,119,3,3,0,1,0
32,130,130,11,11,0,1,0
0,139,139,32,9,23,2,1
34,158,158,4,4,0,1,0
26,160,160,36,36,0,1,0
23,163,163,1,1,0,1,0
15,181,181,15,15,0,1,0
9,194,194,56,13,43,2,1
8,217,217,4,4,0,1,0
29,235,235,11,6,5,2,1
2,279,279,57,27,30,3,2
16,280,280,16,16,0,1,0
3,292,292,79,79,0,1,0
13,294,294,11,8,3,2,1
27,296,296,40,40,0,1,0
17,304,304,3,3,0,1,0
24,323,323,13,13,0,1,0
20,344,344,27,9,18,4,3
28,355,355,125,43,82,3,2
12,395,395,11,6,5,2,1
21,407,407,86,47,39,4,3
6,414,414,15,3,12,2,1
18,415,415,10,2,8,2,1
25,417,417,12,12,0,1,0
4,417,417,8,8,0,1,0
14,420,420,60,16,44,4,3
33,426,426,116,116,0,1,0
7,438,438,5,5,0,1,0
22,444,444,35,5,30,4,3
1,452,452,84,14,70,3,2
19,491,491,50,50,0,1,0

33,106,106,19,19,0,1,0
21,110,110,2,2,0,1,0
31,139,139,9,1,8,2,1
14,146,146,25,25,0,1,0
32,153,153,50,50,0,1,0
11,159,159,1,1,0,1,0
24,161,161,3,3,0,1,0
35,188,188,9,9,0,1,0
25,192,192,15,11,4,2,1
12,205,205,8,8,0,1,0
22,222,222,6,6,0,1,0
13,226,226,18,18,0,1,0
16,230,230,15,3,12,2,1
8,240,240,7,4,3,2,1
29,245,245,67,26,41,2,1
27,252,252,28,1,27,2,1
37,266,266,48,48,0,1,0
6,266,266,59,59,0,1,0
4,290,290,9,9,0,1,0
10,294,294,87,20,67,3,2
28,311,311,3,3,0,1,0
34,311,311,61,46,15,4,3
30,322,322,17,17,0,1,0
2,338,338,19,6,13,2,1
3,344,344,7,1,6,2,1
26,353,353,42,42,0,1,0
5,355,355,38,35,3,2,1
0,360,360,1,1,0,1,0
36,361,361,4,4,0,1,0
7,398,398,10,10,0,1,0
19,399,399,45,45,0,1,0
23,405,405,38,11,27,2,1
20,423,423,14,4,10,2,1
1,427,427,4,4,0,1,0
9,436,436,63,24,39,4,3
17,464,464,99,23,76,3,2
18,476,476,33,33,0,1,0
15,499,499,50,50,0,1,0

3,103,103,8,5,3,2,1
6,104,104,16,2,14,2,1
7,121,121,27,20,7,2,1
26,137,137,22,2,20,2,1
33,138,138,38,38,0,1,0
25,138,138,48,23,25,2,1
42,140,140,18,6,12,2,1
2,144,144,25,18,7,2,1
40,152,152,2,2,0,1,0
24,168,168,8,2,6,3,2
12,174,174,6,1,5,2,1
15,213,213,21,21,0,1,0
16,237,237,1,1,0,1,0
5,242,242,14,2,12,3,2
30,242,242,38,38,0,1,0
27,252,252,5,5,0,1,0
23,257,257,2,2,0,1,0
38,266,266,12,12,0,1,0
39,278,278,1,1,0,1,0
18,295,295,1,1,0,1,0
32,302,302,24,14,10,3,2
34,308,308,27,27,0,1,0
9,325,325,61,61,0,1,0
13,329,329,7,7,0,1,0
28,338,338,60,10,50,3,2
14,342,342,1,1,0,1,0
0,346,346,34,34,0,1,0
10,352,352,15,15,0,1,0
1,355,355,41,10,31,4,3
20,358,358,10,2,8,2,1
22,358,358,3,3,0,1,0
21,370,370,22,22,0,1,0
4,375,375,66,38,28,3,2
11,377,377,10,3,7,2,1
37,388,388,41,2,39,4,3
36,404,404,5,1,4,2,1
41,415,415,21,21,0,1,0
19,418,418,15,3,12,4,3
29,438,438,10,2,8,2,1
31,452,452,28,14,14,2,1
17,452,452,46,22,24,4,3
8,461,461,7,7,0,1,0
35,491,491,44,14,30,2,1

41,100,100,7,3,4,2,1
14,101,101,1,1,0,1,0
9,105,105,8,2,6,3,2
38,107,107,9,3,6,3,2
1,109,109,4,4,0,1,0
29,123,123,23,23,0,1,0
4,128,128,8,5,3,2,1
26,131,131,1,1,0,1,0
22,134,134,21,10,11,2,1
28,134,134,3,3,0,1,0
39,136,136,5,5,0,1,0
34,150,150,5,5,0,1,0
27,153,153,7,7,0,1,0
35,198,198,5,5,0,1,0
42,203,203,64,40,24,4,3
10,207,207,3,3,0,1,0
0,208,208,9,4,5,2,1
3,227,227,22,22,0,1,0
23,231,231,17,13,4,2,1
31,241,241,1,1,0,1,0
32,253,253,63,50,13,2,1
19,259,259,41,11,30,2,1
24,266,266,9,9,0,1,0
43,267,267,39,16,23,2,1
40,287,287,1,1,0,1,0
33,292,292,118,114,4,2,1
13,299,299,42,16,26,2,1
21,317,317,18,2,16,2,1
11,322,322,18,18,0,1,0
25,326,326,10,10,0,1,0
12,335,335,13,2,11,3,2
37,345,345,17,3,14,2,1
7,357,357,41,41,0,1,0
18,358,358,16,16,0,1,0
5,365,365,17,17,0,1,0
44,399,399,6,6,0,1,0
36,415,415,66,66,0,1,0
30,419,419,6,6,0,1,0
8,419,419,47,30,17,2,1
6,425,425,4,4,0,1,0
16,447,447,12,12,0,1,0
15,468,468,64,64,0,1,0
2,475,475,44,44,0,1,0
17,480,480,31,31,0,1,0
20,491,491,31,31,0,1,0

32,102,102,6,6,0,1,0
22,104,104,10,10,0,1,0
30,109,109,17,17,0,1,0
17,109,109,9,9,0,1,0
2,112,112,14,8,6,2,1
14,113,113,39,39,0,1,0
20,123,123,4,1,3,2,1
31,126,126,5,5,0,1,0
4,150,150,18,18,0,1,0
5,150,150,24,5,19,2,1
19,159,159,1,1,0,1,0
25,168,168,7,1,6,2,1
12,170,170,78,15,63,4,3
10,176,176,17,17,0,1,0
8,214,214,6,6,0,1,0
3,231,231,1,1,0,1,0
26,265,265,41,8,33,4,3
0,277,277,21,21,0,1,0
15,286,286,64,19,45,3,2
29,287,287,21,21,0,1,0
27,288,288,5,5,0,1,0
21,290,290,10,6,4,2,1
16,293,293,10,10,0,1,0
7,321,321,22,7,15,2,1
11,338,338,41,13,28,4,3
6,345,345,5,5,0,1,0
13,345,345,19,10,9,4,3
23,358,358,56,56,0,1,0
9,361,361,11,11,0,1,0
18,379,379,143,53,90,4,3
28,389,389,55,40,15,4,3
24,468,468,61,31,30,2,1
1,480,480,50,4,46,3,2

20,103,103,13,5,8,3,2
18,110,110,18,18,0,1,0
23,117,117,4,4,0,1,0
22,121,121,1,1,0,1,0
24,150,150,3,3,0,1,0
27,156,156,21,21,0,1,0
6,172,172,2,2,0,1,0
17,173,173,3,3,0,1,0
33,211,211,3,3,0,1,0
31,240,240,50,50,0,1,0
15,240,240,13,13,0,1,0
19,241,241,3,3,0,1,0
12,267,267,11,11,0,1,0
11,277,277,20,20,0,1,0
25,284,284,46,8,38,3,2
35,288,288,57,36,21,2,1
28,294,294,17,7,10,3,2
8,306,306,19,19,0,1,0
9,326,326,76,28,48,2,1
4,342,342,126,114,12,3,2
3,346,346,12,3,9,2,1
16,350,350,6,6,0,1,0
14,353,353,36,36,0,1,0
29,368,368,35,8,27,4,3
36,385,385,28,12,16,2,1
0,404,404,44,8,36,2,1
2,409,409,57,57,0,1,0
7,410,410,37,4,33,4,3
21,412,412,91,8,83,4,3
32,413,413,27,27,0,1,0
1,422,422,14,14,0,1,0
10,439,439,38,38,0,1,0
30,455,455,72,72,0,1,0
34,459,459,2,2,0,1,0
26,473,473,115,115,0,1,0
13,496,496,46,46,0,1,0
5,496,496,37,28,9,4,3

37,102,102,4,4,0,1,0
27,103,103,19,19,0,1,0
11,106,106,4,4,0,1,0
1,110,110,2,2,0,1,0
34,113,113,15,15,0,1,0
7,114,114,8,8,0,1,0
29,118,118,7,7,0,1,0
24,119,119,30,18,12,4,3
2,125,125,3,3,0,1,0
23,137,137,8,2,6,2,1
39,138,138,3,3,0,1,0
3,153,153,14,4,10,3,2
32,168,168,8,8,0,1,0
6,172,172,1,1,0,1,0
17,178,178,14,5,9,2,1
8,211,211,14,5,9,4,3
5,242,242,9,9,0,1,0
33,286,286,24,24,0,1,0
9,305,305,4,4,0,1,0
13,347,347,21,21,0,1,0
26,353,353,106,16,90,4,3
20,362,362,6,6,0,1,0
35,371,371,30,30,0,1,0
10,373,373,20,14,6,3,2
30,377,377,30,30,0,1,0
4,401,401,33,16,17,2,1
12,401,401,6,6,0,1,0
18,410,410,171,150,21,4,3
14,415,415,20,20,0,1,0
22,437,437,79,31,48,2,1
36,439,439,27,4,23,2,1
21,451,451,40,11,29,2,1
31,452,452,6,3,3,2,1
16,452,452,101,11,90,4,3
25,459,459,34,25,9,2,1
38,465,465,45,6,39,2,1
15,477,477,19,19,0,1,0
28,478,478,97,62,35,4,3
0,482,482,28,28,0,1,0
40,482,482,29,4,25,2,1
19,494,494,37,16,21,4,3

28,107,107,3,3,0,1,0
33,107,107,3,3,0,1,0
19,111,111,3,3,0,1,0
1,115,115,5,5,0,1,0
18,122,122,5,5,0,1,0
30,128,128,1,1,0,1,0
13,135,135,7,1,6,2,1
24,144,144,8,8,0,1,0
25,164,164,3,3,0,1,0
27,179,179,56,56,0,1,0
39,185,185,4,4,0,1,0
10,192,192,43,10,33,3,2
37,196,196,31,21,10,3,2
4,207,207,6,1,5,2,1
31,211,211,11,5,6,2,1
34,213,213,23,23,0,1,0
2,216,216,22,22,0,1,0
20,222,222,6,1,5,2,1
3,240,240,1,1,0,1,0
16,252,252,31,2,29,3,2
35,255,255,13,13,0,1,0
22,276,276,1,1,0,1,0
21,283,283,44,16,28,2,1
26,357,357,81,81,0,1,0
5,370,370,18,11,7,2,1
9,376,376,13,5,8,2,1
8,379,379,5,2,3,2,1
38,380,380,32,23,9,2,1
12,388,388,54,40,14,2,1
23,391,391,109,109,0,1,0
0,397,397,71,71,0,1,0
7,402,402,81,58,23,2,1
32,408,408,13,13,0,1,0
11,415,415,58,40,18,4,3
29,432,432,72,10,62,3,2
14,437,437,33,3,30,3,2
17,439,439,29,7,22,2,1
15,449,449,9,3,6,2,1
40,453,453,5,5,0,1,0
36,457,457,92,92,0,1,0
6,462,462,24,3,21,4,3

23,105,105,26,7,19,2,1
11,106,106,3,3,0,1,0
15,133,133,9,9,0,1,0
18,133,133,5,5,0,1,0
8,158,158,30,1,29,2,1
10,159,159,43,43,0,1,0
20,188,188,6,2,4,2,1
21,198,198,44,44,0,1,0
1,202,202,1,1,0,1,0
24,207,207,18,18,0,1,0
14,223,223,94,94,0,1,0
19,224,224,74,38,36,2,1
16,229,229,9,3,6,3,2
2,273,273,8,3,5,2,1
25,276,276,4,4,0,1,0
32,283,283,2,2,0,1,0
22,310,310,2,2,0,1,0
28,310,310,15,15,0,1,0
6,318,318,31,25,6,2,1
7,328,328,33,21,12,4,3
0,402,402,26,4,22,2,1
31,405,405,39,39,0,1,0
27,422,422,19,19,0,1,0
3,422,422,5,5,0,1,0
13,428,428,45,18,27,4,3
17,429,429,8,4,4,2,1
5,440,440,26,26,0,1,0
33,448,448,6,6,0,1,0
4,453,453,1,1,0,1,0
26,455,455,212,164,48,4,3
30,473,473,11,6,5,2,1
12,484,484,72,72,0,1,0
29,494,494,50,50,0,1,0
9,497,497,99,99,0,1,0

31,108,108,18,18,0,1,0
16,116,116,25,1,24,4,3
7,121,121,31,22,9,4,3
23,129,129,15,15,0,1,0
2,162,162,2,2,0,1,0
6,162,162,27,14,13,2,1
11,170,170,17,17,0,1,0
14,199,199,21,21,0,1,0
13,206,206,3,3,0,1,0
20,207,207,11,11,0,1,0
8,217,217,7,1,6,2,1
21,217,217,5,1,4,2,1
28,230,230,1,1,0,1,0
34,243,243,23,23,0,1,0
3,246,246,17,17,0,1,0
9,269,269,25,25,0,1,0
24,301,301,18,18,0,1,0
32,302,302,5,5,0,1,0
30,310,310,30,15,15,2,1
29,320,320,13,13,0,1,0
26,323,323,54,8,46,2,1
17,335,335,75,75,0,1,0
33,335,335,18,9,9,4,3
4,345,345,3,3,0,1,0
10,363,363,37,37,0,1,0
0,390,390,89,15,74,3,2
18,397,397,105,51,54,3,2
5,411,411,2,2,0,1,0
22,415,415,23,23,0,1,0
15,423,423,81,19,62,3,2
12,424,424,47,25,22,2,1
1,466,466,44,44,0,1,0
27,487,487,97,31,66,3,2
25,489,489,80,69,11,2,1
19,489,489,12,4,8,3,2

13,101,101,22,22,0,1,0
17,106,106,5,5,0,1,0
0,108,108,7,7,0,1,0
22,122,122,2,2,0,1,0
28,128,128,6,6,0,1,0
18,132,132,11,5,6,2,1
26,134,134,36,36,0,1,0
8,154,154,12,2,10,2,1
2,155,155,2,2,0,1,0
32,174,174,55,11,44,2,1
27,180,180,13,4,9,4,3
14,204,204,25,25,0,1,0
1,206,206,22,22,0,1,0
30,228,228,50,50,0,1,0
4,229,229,5,5,0,1,0
25,254,254,17,17,0,1,0
19,277,277,9,9,0,1,0
21,280,280,1,1,0,1,0
12,282,282,12,12,0,1,0
31,285,285,62,11,51,4,3
10,288,288,77,77,0,1,0
6,322,322,8,8,0,1,0
11,338,338,34,22,12,2,1
7,341,341,65,65,0,1,0
16,348,348,42,42,0,1,0
9,357,357,9,9,0,1,0
15,360,360,43,43,0,1,0
34,380,380,25,19,6,3,2
5,395,395,96,61,35,2,1
29,400,400,40,18,22,3,2
23,417,417,14,5,9,4,3
33,437,437,23,23,0,1,0
20,444,444,65,49,16,2,1
3,470,470,20,20,0,1,0
24,488,488,32,12,20,3,2

26,104,104,2,2,0,1,0
8,114,114,1,1,0,1,0
9,127,127,6,6,0,1,0
17,134,134,22,22,0,1,0
14,152,152,7,2,5,2,1
18,167,167,9,9,0,1,0
0,197,197,4,4,0,1,0
19,214,214,11,3,8,3,2
28,260,260,2,2,0,1,0
30,273,273,59,32,27,2,1
29,276,276,14,14,0,1,0
7,278,278,34,6,28,3,2
4,284,284,40,40,0,1,0
24,294,294,5,5,0,1,0
23,330,330,83,48,35,2,1
31,340,340,71,71,0,1,0
6,355,355,5,5,0,1,0
2,355,355,24,2,22,3,2
5,360,360,111,111,0,1,0
25,368,368,87,9,78,4,3
11,370,370,154,121,33,2,1
1,376,376,51,51,0,1,0
21,389,389,78,42,36,3,2
10,404,404,21,11,10,3,2
16,406,406,11,1,10,2,1
3,409,409,21,17,4,2,1
12,424,424,105,105,0,1,0
27,436,436,29,29,0,1,0
22,439,439,83,83,0,1,0
20,449,449,11,11,0,1,0
15,477,477,5,5,0,1,0
13,478,478,81,33,48,3,2

26,116,116,21,21,0,1,0
0,127,127,7,7,0,1,0
41,127,127,10,3,7,2,1
12,129,129,1,1,0,1,0
34,130,130,1,1,0,1,0
19,135,135,8,1,7,2,1
11,143,143,9,9,0,1,0
10,144,144,25,25,0,1,0
2,150,150,9,9,0,1,0
33,152,152,10,10,0,1,0
28,155,155,7,7,0,1,0
3,188,188,7,7,0,1,0
17,199,199,29,13,16,2,1
14,201,201,13,2,11,2,1
6,221,221,39,39,0,1,0
24,224,224,22,3,19,2,1
40,237,237,4,4,0,1,0
31,246,246,19,19,0,1,0
4,248,248,33,33,0,1,0
15,248,248,1,1,0,1,0
18,249,249,7,1,6,3,2
16,254,254,16,16,0,1,0
35,291,291,6,3,3,2,1
1,314,314,13,9,4,2,1
27,315,315,38,17,21,4,3
8,343,343,24,24,0,1,0
36,351,351,7,2,5,2,1
20,366,366,21,21,0,1,0
13,368,368,34,25,9,4,3
22,399,399,1,1,0,1,0
29,400,400,58,35,23,2,1
32,415,415,8,8,0,1,0
37,420,420,14,5,9,4,3
7,441,441,77,35,42,2,1
21,459,459,6,6,0,1,0
25,477,477,140,140,0,1,0
38,477,477,26,26,0,1,0
39,478,478,174,174,0,1,0
23,480,480,21,4,17,2,1
30,481,481,91,28,63,4,3
9,481,481,46,34,12,4,3
5,487,487,68,68,0,1,0

33,107,107,6,6,0,1,0
18,109,109,2,2,0,1,0
13,111,111,3,3,0,1,0
34,121,121,2,2,0,1,0
10,125,125,20,3,17,3,2
6,125,125,1,1,0,1,0
0,134,134,1,1,0,1,0
38,135,135,2,2,0,1,0
21,137,137,2,2,0,1,0
3,140,140,9,9,0,1,0
20,163,163,24,6,18,4,3
35,163,163,1,1,0,1,0
7,174,174,11,11,0,1,0
16,181,181,17,17,0,1,0
39,188,188,32,8,24,3,2
25,193,193,62,62,0,1,0
26,201,201,23,23,0,1,0
43,207,207,28,28,0,1,0
44,215,215,22,22,0,1,0
32,248,248,18,18,0,1,0
27,250,250,53,41,12,2,1
41,251,251,87,31,56,3,2
29,300,300,35,35,0,1,0
36,308,308,24,24,0,1,0
17,314,314,18,7,11,2,1
8,332,332,28,5,23,2,1
9,336,336,5,5,0,1,0
14,359,359,5,5,0,1,0
28,368,368,33,29,4,2,1
4,381,381,10,1,9,4,3
23,382,382,32,12,20,2,1
22,389,389,9,9,0,1,0
1,401,401,3,3,0,1,0
2,403,403,18,6,12,3,2
30,409,409,12,2,10,2,1
15,419,419,27,5,22,3,2
42,435,435,120,81,39,4,3
5,462,462,14,14,0,1,0
24,474,474,13,13,0,1,0
37,476,476,1,1,0,1,0
12,476,476,125,125,0,1,0
19,487,487,9,9,0,1,0
40,490,490,36,36,0,1,0
31,500,500,22,17,5,2,1
11,500,500,1,1,0,1,0

3,107,107,1,1,0,1,0
27,134,134,3,3,0,1,0
1,150,150,16,7,9,4,3
32,157,157,12,12,0,1,0
17,181,181,9,3,6,3,2
35,183,183,5,5,0,1,0
6,188,188,12,12,0,1,0
4,200,200,28,28,0,1,0
23,209,209,8,8,0,1,0
34,239,239,19,19,0,1,0
24,253,253,61,55,6,3,2
5,259,259,2,2,0,1,0
18,270,270,10,10,0,1,0
14,271,271,23,11,12,4,3
20,273,273,18,18,0,1,0
33,282,282,20,6,14,3,2
9,284,284,1,1,0,1,0
7,344,344,34,16,18,4,3
21,349,349,18,2,16,2,1
31,361,361,100,100,0,1,0
19,361,361,3,3,0,1,0
2,362,362,18,18,0,1,0
8,371,371,137,137,0,1,0
0,382,382,149,93,56,4,3
28,385,385,56,44,12,2,1
25,392,392,3,3,0,1,0
30,401,401,90,48,42,4,3
16,413,413,22,22,0,1,0
12,418,418,2,2,0,1,0
22,421,421,59,19,40,2,1
37,433,433,12,6,6,3,2
10,443,443,17,17,0,1,0
15,460,460,29,22,7,2,1
11,468,468,59,59,0,1,0
13,477,477,46,12,34,2,1
26,482,482,38,29,9,2,1
36,490,490,29,1,28,3,2
29,491,491,94,94,0,1,0

18,104,104,4,4,0,1,0
9,105,105,2,2,0,1,0
19,108,108,2,2,0,1,0
10,127,127,1,1,0,1,0
0,135,135,1,1,0,1,0
29,137,137,16,1,15,4,3
23,139,139,15,15,0,1,0
6,142,142,13,13,0,1,0
31,169,169,23,23,0,1,0
41,193,193,9,2,7,2,1
33,202,202,17,2,15,4,3
42,222,222,23,23,0,1,0
24,225,225,24,24,0,1,0
25,226,226,24,24,0,1,0
39,241,241,78,39,39,3,2
32,243,243,16,16,0,1,0
40,245,245,24,24,0,1,0
21,248,248,21,21,0,1,0
7,280,280,9,9,0,1,0
37,285,285,21,21,0,1,0
13,287,287,13,1,12,3,2
26,297,297,20,20,0,1,0
30,309,309,10,10,0,1,0
8,325,325,38,14,24,3,2
38,329,329,19,10,9,2,1
2,337,337,18,18,0,1,0
1,338,338,18,12,6,2,1
12,357,357,25,11,14,2,1
4,362,362,8,4,4,2,1
5,369,369,61,8,53,4,3
28,384,384,16,4,12,2,1
15,389,389,31,14,17,4,3
22,397,397,4,4,0,1,0
3,418,418,4,4,0,1,0
14,442,442,8,2,6,2,1
36,449,449,18,18,0,1,0
11,452,452,129,115,14,3,2
17,458,458,105,93,12,2,1
35,460,460,71,71,0,1,0
34,465,465,11,11,0,1,0
20,480,480,34,34,0,1,0
16,487,487,29,10,19,2,1
27,488,488,129,129,0,1,0

24,128,128,9,5,4,2,1
23,143,143,2,2,0,1,0
19,150,150,10,2,8,3,2
17,150,150,6,6,0,1,0
1,165,165,4,1,3,2,1
25,170,170,62,14,48,3,2
28,172,172,23,23,0,1,0
8,180,180,50,50,0,1,0
14,223,223,1,1,0,1,0
29,230,230,12,8,4,2,1
22,248,248,32,32,0,1,0
3,251,251,1,1,0,1,0
18,259,259,17,17,0,1,0
2,263,263,18,2,16,2,1
12,264,264,19,19,0,1,0
21,275,275,13,13,0,1,0
26,276,276,1,1,0,1,0
13,295,295,28,28,0,1,0
0,305,305,17,7,10,3,2
16,315,315,77,77,0,1,0
11,322,322,7,3,4,2,1
27,325,325,51,11,40,2,1
30,337,337,7,7,0,1,0
31,356,356,55,55,0,1,0
20,362,362,16,16,0,1,0
33,368,368,32,32,0,1,0
5,397,397,89,5,84,4,3
7,400,400,24,24,0,1,0
15,403,403,27,27,0,1,0
32,424,424,65,56,9,4,3
9,426,426,4,4,0,1,0
4,434,434,18,18,0,1,0
10,440,440,289,251,38,3,2
6,491,491,58,18,40,2,1

1,137,137,1,1,0,1,0
16,138,138,11,2,9,4,3
17,142,142,15,15,0,1,0
19,152,152,4,4,0,1,0
24,156,156,10,10,0,1,0
10,164,164,38,38,0,1,0
26,169,169,45,45,0,1,0
0,187,187,9,6,3,2,1
18,191,191,35,1,34,3,2
21,217,217,6,6,0,1,0
8,217,217,29,11,18,4,3
13,219,219,24,24,0,1,0
9,225,225,3,3,0,1,0
14,230,230,24,4,20,2,1
12,293,293,10,10,0,1,0
2,296,296,13,4,9,2,1
4,312,312,22,22,0,1,0
5,341,341,42,27,15,2,1
27,357,357,4,4,0,1,0
3,361,361,25,25,0,1,0
7,371,371,206,109,97,4,3
20,371,371,63,9,54,3,2
22,398,398,48,45,3,2,1
15,400,400,28,28,0,1,0
25,412,412,16,16,0,1,0
28,460,460,31,13,18,3,2
11,463,463,195,195,0,1,0
30,467,467,29,29,0,1,0
6,470,470,23,23,0,1,0
29,480,480,31,31,0,1,0
23,499,499,133,91,42,4,3

29,101,101,7,7,0,1,0
41,108,108,5,5,0,1,0
40,140,140,16,16,0,1,0
27,160,160,9,9,0,1,0
19,169,169,18,18,0,1,0
30,186,186,14,14,0,1,0
8,190,190,14,14,0,1,0
12,193,193,56,19,37,2,1
15,200,200,1,1,0,1,0
1,201,201,19,19,0,1,0
3,207,207,12,2,10,3,2
25,215,215,1,1,0,1,0
32,225,225,14,4,10,2,1
4,242,242,3,3,0,1,0
24,251,251,4,4,0,1,0
16,253,253,1,1,0,1,0
20,282,282,10,10,0,1,0
18,288,288,7,7,0,1,0
35,289,289,42,24,18,3,2
45,293,293,24,7,17,2,1
22,303,303,21,21,0,1,0
36,333,333,12,3,9,3,2
42,338,338,20,20,0,1,0
14,349,349,19,19,0,1,0
7,355,355,85,85,0,1,0
37,359,359,33,4,29,2,1
2,362,362,8,2,6,3,2
10,364,364,1,1,0,1,0
13,374,374,30,30,0,1,0
17,389,389,12,12,0,1,0
6,415,415,1,1,0,1,0
33,421,421,53,53,0,1,0
0,430,430,76,13,63,4,3
44,434,434,12,7,5,2,1
31,439,439,130,117,13,2,1
28,442,442,18,18,0,1,0
11,444,444,8,8,0,1,0
21,446,446,17,17,0,1,0
34,453,453,172,130,42,4,3
9,453,453,4,4,0,1,0
26,472,472,15,15,0,1,0
39,479,479,31,1,30,4,3
38,483,483,47,47,0,1,0
5,487,487,80,50,30,4,3
43,499,499,8,8,0,1,0
23,500,500,43,43,0,1,0

16,114,114,5,5,0,1,0
28,129,129,7,1,6,2,1
12,142,142,41,13,28,3,2
4,142,142,20,10,10,3,2
20,168,168,34,34,0,1,0
19,171,171,8,8,0,1,0
5,196,196,3,3,0,1,0
9,203,203,22,22,0,1,0
2,211,211,35,8,27,2,1
13,212,212,5,5,0,1,0
21,220,220,23,23,0,1,0
10,225,225,168,93,75,4,3
23,249,249,1,1,0,1,0
26,282,282,58,58,0,1,0
8,286,286,17,17,0,1,0
7,305,305,15,15,0,1,0
17,323,323,15,2,13,2,1
6,328,328,23,5,18,4,3
22,342,342,1,1,0,1,0
14,346,346,37,28,9,4,3
1,361,361,39,24,15,2,1
25,362,362,54,33,21,4,3
11,364,364,86,39,47,2,1
0,369,369,36,28,8,2,1
29,376,376,82,15,67,4,3
18,398,398,40,12,28,3,2
15,402,402,20,8,12,3,2
3,412,412,1,1,0,1,0
27,435,435,10,10,0,1,0
24,474,474,84,2,82,3,2

24,103,103,5,5,0,1,0
22,113,113,6,6,0,1,0
31,123,123,1,1,0,1,0
15,125,125,5,2,3,2,1
7,129,129,6,6,0,1,0
3,150,150,7,2,5,2,1
16,162,162,29,29,0,1,0
30,178,178,12,3,9,4,3
2,188,188,25,13,12,2,1
14,190,190,29,29,0,1,0
20,201,201,18,18,0,1,0
34,232,232,36,20,16,2,1
26,263,263,28,18,10,2,1
5,276,276,128,128,0,1,0
4,279,279,38,28,10,2,1
27,282,282,87,54,33,4,3
35,292,292,67,31,36,2,1
32,293,293,21,14,7,2,1
9,303,303,1,1,0,1,0
33,316,316,6,6,0,1,0
10,324,324,16,16,0,1,0
23,326,326,48,36,12,4,3
8,327,327,17,17,0,1,0
21,331,331,12,12,0,1,0
25,339,339,13,5,8,3,2
28,340,340,44,44,0,1,0
13,341,341,16,7,9,4,3
29,343,343,22,14,8,2,1
19,359,359,52,23,29,2,1
6,412,412,1,1,0,1,0
18,420,420,51,51,0,1,0
12,439,439,34,34,0,1,0
11,475,475,8,8,0,1,0
0,489,489,125,125,0,1,0
1,494,494,6,6,0,1,0
17,500,500,44,23,21,4,3

5,105,105,7,7,0,1,0
27,106,106,15,15,0,1,0
14,120,120,4,4,0,1,0
26,120,120,18,2,16,2,1
4,124,124,11,11,0,1,0
28,138,138,20,20,0,1,0
17,141,141,6,6,0,1,0
11,155,155,32,32,0,1,0
12,156,156,16,16,0,1,0
23,173,173,9,9,0,1,0
15,193,193,7,7,0,1,0
32,212,212,5,2,3,2,1
3,228,228,21,21,0,1,0
24,228,228,16,16,0,1,0
18,242,242,7,2,5,2,1
9,273,273,4,4,0,1,0
19,280,280,22,22,0,1,0
13,331,331,3,3,0,1,0
7,333,333,84,62,22,3,2
20,336,336,38,38,0,1,0
8,342,342,12,6,6,2,1
30,359,359,9,9,0,1,0
6,373,373,165,149,16,2,1
16,382,382,85,85,0,1,0
0,391,391,18,18,0,1,0
29,402,402,26,26,0,1,0
25,429,429,2,2,0,1,0
10,439,439,57,57,0,1,0
22,446,446,192,156,36,2,1
31,455,455,47,12,35,2,1
21,456,456,44,8,36,3,2
1,464,464,107,29,78,4,3
2,483,483,27,12,15,2,1

20,120,120,4,4,0,1,0
32,127,127,9,9,0,1,0
9,133,133,2,2,0,1,0
30,140,140,41,10,31,4,3
35,173,173,10,1,9,2,1
18,182,182,18,18,0,1,0
4,189,189,16,7,9,4,3
13,198,198,10,10,0,1,0
33,219,219,2,2,0,1,0
15,222,222,13,3,10,3,2
0,234,234,17,17,0,1,0
24,236,236,8,8,0,1,0
1,246,246,5,2,3,2,1
22,246,246,28,28,0,1,0
6,262,262,1,1,0,1,0
3,266,266,59,44,15,2,1
5,267,267,8,8,0,1,0
19,268,268,21,3,18,3,2
12,288,288,41,41,0,1,0
23,300,300,6,6,0,1,0
11,308,308,60,55,5,2,1
31,320,320,33,33,0,1,0
37,328,328,124,115,9,4,3
2,329,329,48,33,15,2,1
36,333,333,28,10,18,4,3
39,378,378,65,29,36,4,3
16,383,383,24,8,16,2,1
21,390,390,44,44,0,1,0
27,420,420,2,2,0,1,0
28,423,423,55,8,47,2,1
14,425,425,15,8,7,2,1
25,426,426,61,61,0,1,0
7,437,437,43,34,9,4,3
10,438,438,93,60,33,2,1
38,445,445,31,31,0,1,0
29,458,458,13,6,7,2,1
8,464,464,12,2,10,3,2
34,473,473,35,35,0,1,0
17,486,486,1,1,0,1,0
26,489,489,23,23,0,1,0

29,117,117,28,8,20,3,2
26,123,123,13,13,0,1,0
9,128,128,3,3,0,1,0
27,132,132,5,5,0,1,0
0,140,140,3,3,0,1,0
1,150,150,3,3,0,1,0
18,165,165,6,6,0,1,0
37,165,165,1,1,0,1,0
35,191,191,19,5,14,2,1
14,197,197,26,26,0,1,0
30,203,203,16,16,0,1,0
43,213,213,1,1,0,1,0
41,220,220,45,45,0,1,0
21,228,228,29,11,18,3,2
44,229,229,31,31,0,1,0
40,229,229,2,2,0,1,0
28,237,237,15,15,0,1,0
42,240,240,19,9,10,3,2
45,257,257,7,7,0,1,0
17,269,269,9,4,5,2,1
6,276,276,4,4,0,1,0
46,282,282,79,63,16,3,2
20,282,282,15,3,12,2,1
15,284,284,21,21,0,1,0
23,290,290,2,2,0,1,0
32,298,298,9,9,0,1,0
7,311,311,45,45,0,1,0
38,312,312,16,16,0,1,0
12,314,314,1,1,0,1,0
5,347,347,8,1,7,2,1
11,391,391,13,4,9,4,3
13,401,401,17,17,0,1,0
22,406,406,9,3,6,2,1
33,413,413,33,5,28,2,1
4,414,414,58,24,34,3,2
24,415,415,17,11,6,2,1
3,419,419,82,82,0,1,0
19,423,423,2,2,0,1,0
2,423,423,46,46,0,1,0
34,431,431,70,70,0,1,0
25,435,435,20,20,0,1,0
16,438,438,91,43,48,4,3
10,445,445,9,9,0,1,0
31,447,447,28,28,0,1,0
8,462,462,10,3,7,2,1
36,467,467,124,124,0,1,0
39,480,480,12,5,7,3,2

22,103,103,27,5,22,2,1
34,109,109,3,3,0,1,0
17,117,117,13,4,9,2,1
30,131,131,2,2,0,1,0
18,137,137,7,7,0,1,0
29,145,145,53,3,50,2,1
19,169,169,1,1,0,1,0
25,169,169,2,2,0,1,0
38,172,172,18,18,0,1,0
40,180,180,16,7,9,2,1
36,190,190,31,9,22,2,1
20,205,205,18,18,0,1,0
33,211,211,13,9,4,2,1
10,213,213,22,2,20,2,1
21,228,228,4,4,0,1,0
23,235,235,4,4,0,1,0
13,247,247,39,39,0,1,0
15,257,257,23,23,0,1,0
11,260,260,9,9,0,1,0
16,262,262,41,41,0,1,0
14,267,267,24,24,0,1,0
35,270,270,33,33,0,1,0
6,273,273,15,5,10,3,2
3,276,276,31,31,0,1,0
7,278,278,3,3,0,1,0
1,287,287,8,8,0,1,0
12,324,324,12,7,5,2,1
28,343,343,50,46,4,2,1
2,353,353,4,4,0,1,0
31,356,356,78,31,47,3,2
24,361,361,21,21,0,1,0
37,365,365,39,15,24,3,2
27,369,369,21,21,0,1,0
8,369,369,13,13,0,1,0
42,370,370,63,9,54,3,2
4,376,376,46,46,0,1,0
0,396,396,5,5,0,1,0
41,420,420,2,2,0,1,0
26,421,421,39,39,0,1,0
9,423,423,26,26,0,1,0
39,430,430,34,4,30,2,1
43,445,445,3,3,0,1,0
32,453,453,3,3,0,1,0
5,485,485,29,21,8,2,1

30,118,118,3,3,0,1,0
35,124,124,28,28,0,1,0
21,127,127,6,6,0,1,0
7,131,131,25,2,23,2,1
28,147,147,54,12,42,2,1
18,166,166,13,7,6,3,2
26,173,173,37,37,0,1,0
1,188,188,1,1,0,1,0
24,189,189,6,6,0,1,0
5,198,198,11,11,0,1,0
11,215,215,14,8,6,2,1
22,215,215,20,20,0,1,0
19,231,231,14,1,13,3,2
14,241,241,11,11,0,1,0
10,246,246,5,1,4,2,1
34,260,260,35,16,19,4,3
9,262,262,16,16,0,1,0
0,282,282,5,5,0,1,0
36,290,290,6,2,4,2,1
2,290,290,64,14,50,2,1
15,314,314,72,72,0,1,0
16,326,326,124,44,80,3,2
12,360,360,55,55,0,1,0
3,369,369,15,15,0,1,0
25,375,375,61,13,48,2,1
33,381,381,52,10,42,3,2
8,383,383,12,12,0,1,0
4,383,383,61,10,51,4,3
29,395,395,14,14,0,1,0
6,401,401,10,10,0,1,0
31,411,411,1,1,0,1,0
17,411,411,7,1,6,2,1
13,432,432,2,2,0,1,0
23,448,448,17,17,0,1,0
27,460,460,18,14,4,2,1
32,470,470,73,25,48,4,3
20,478,478,20,2,18,2,1

11,101,101,19,19,0,1,0
12,148,148,19,4,15,2,1
17,152,152,21,5,16,2,1
13,155,155,2,2,0,1,0
21,186,186,4,4,0,1,0
28,191,191,61,61,0,1,0
22,191,191,8,8,0,1,0
20,196,196,9,2,7,2,1
27,224,224,15,15,0,1,0
8,231,231,21,21,0,1,0
14,240,240,7,7,0,1,0
18,251,251,29,14,15,2,1
10,255,255,40,22,18,4,3
5,287,287,96,96,0,1,0
23,291,291,1,1,0,1,0
29,295,295,95,50,45,2,1
25,312,312,60,33,27,2,1
0,315,315,54,54,0,1,0
6,349,349,93,83,10,2,1
9,358,358,58,2,56,4,3
19,363,363,66,66,0,1,0
2,363,363,1,1,0,1,0
16,370,370,17,3,14,2,1
24,415,415,15,15,0,1,0
7,435,435,9,6,3,2,1
15,452,452,30,30,0,1,0
1,460,460,5,5,0,1,0
4,468,468,160,136,24,3,2
26,468,468,31,31,0,1,0
3,475,475,26,26,0,1,0

24,106,106,3,3,0,1,0
29,106,106,6,3,3,2,1
5,113,113,3,3,0,1,0
21,128,128,17,17,0,1,0
14,140,140,3,3,0,1,0
18,169,169,1,1,0,1,0
20,170,170,2,2,0,1,0
23,211,211,10,1,9,2,1
1,216,216,42,28,14,2,1
30,216,216,17,6,11,2,1
36,231,231,59,21,38,3,2
34,245,245,57,7,50,2,1
31,248,248,27,27,0,1,0
2,264,264,37,37,0,1,0
28,269,269,4,4,0,1,0
33,291,291,31,31,0,1,0
25,300,300,5,5,0,1,0
6,306,306,37,37,0,1,0
27,344,344,33,12,21,2,1
16,348,348,8,8,0,1,0
22,361,361,86,8,78,3,2
11,363,363,44,14,30,3,2
35,370,370,69,69,0,1,0
10,372,372,8,5,3,2,1
26,374,374,73,51,22,3,2
0,381,381,45,45,0,1,0
13,389,389,36,24,12,2,1
4,398,398,30,30,0,1,0
19,411,411,13,13,0,1,0
17,411,411,13,13,0,1,0
15,422,422,10,4,6,2,1
8,430,430,57,57,0,1,0
9,456,456,25,5,20,3,2
32,466,466,3,3,0,1,0
12,474,474,9,3,6,2,1
3,485,485,83,61,22,3,2
7,486,486,199,199,0,1,0

15,103,103,21,5,16,2,1
26,111,111,4,4,0,1,0
18,116,116,12,3,9,2,1
11,128,128,1,1,0,1,0
30,128,128,14,14,0,1,0
29,132,132,9,9,0,1,0
2,134,134,30,18,12,3,2
17,143,143,7,7,0,1,0
28,149,149,10,6,4,2,1
32,164,164,10,10,0,1,0
21,167,167,24,24,0,1,0
27,177,177,51,51,0,1,0
5,178,178,23,23,0,1,0
6,180,180,4,4,0,1,0
14,181,181,25,25,0,1,0
13,207,207,29,21,8,3,2
1,217,217,35,9,26,3,2
16,242,242,18,3,15,4,3
23,244,244,1,1,0,1,0
7,291,291,31,12,19,2,1
3,305,305,47,31,16,2,1
12,314,314,28,28,0,1,0
22,331,331,54,27,27,3,2
33,337,337,82,15,67,4,3
0,351,351,10,2,8,2,1
24,352,352,14,9,5,2,1
10,356,356,20,20,0,1,0
9,372,372,51,25,26,3,2
31,443,443,5,5,0,1,0
20,450,450,1,1,0,1,0
19,452,452,126,126,0,1,0
4,456,456,40,40,0,1,0
8,477,477,59,42,17,2,1
25,499,499,53,53,0,1,0

11,100,100,12,12,0,1,0
29,116,116,3,3,0,1,0
30,117,117,5,5,0,1,0
19,124,124,18,1,17,2,1
33,133,133,2,2,0,1,0
0,140,140,3,3,0,1,0
1,143,143,12,6,6,3,2
21,168,168,7,7,0,1,0
28,209,209,7,1,6,3,2
15,219,219,3,3,0,1,0
23,224,224,6,6,0,1,0
9,229,229,44,3,41,2,1
8,265,265,9,9,0,1,0
18,267,267,19,19,0,1,0
26,273,273,141,111,30,4,3
4,285,285,1,1,0,1,0
31,294,294,33,4,29,3,2
16,302,302,15,1,14,2,1
24,333,333,45,45,0,1,0
27,362,362,73,8,65,4,3
7,369,369,1,1,0,1,0
17,378,378,13,13,0,1,0
6,378,378,15,15,0,1,0
10,385,385,39,6,33,4,3
2,397,397,133,99,34,2,1
14,411,411,65,61,4,2,1
25,415,415,118,16,102,4,3
5,462,462,165,126,39,4,3
32,467,467,28,28,0,1,0
3,474,474,36,7,29,2,1
12,478,478,112,112,0,1,0
13,491,491,14,14,0,1,0
20,496,496,7,7,0,1,0
22,499,499,9,1,8,2,1

40,118,118,14,10,4,2,1
9,159,159,10,10,0,1,0
6,172,172,25,1,24,3,2
1,179,179,4,4,0,1,0
31,190,190,37,27,10,3,2
30,204,204,1,1,0,1,0
21,221,221,14,14,0,1,0
18,223,223,5,5,0,1,0
34,238,238,4,4,0,1,0
10,250,250,13,4,9,4,3
16,264,264,13,7,6,2,1
7,264,264,13,9,4,2,1
26,269,269,17,13,4,2,1
35,272,272,3,3,0,1,0
28,284,284,18,10,8,3,2
15,285,285,91,91,0,1,0
8,295,295,2,2,0,1,0
14,310,310,2,2,0,1,0
27,316,316,32,17,15,2,1
4,317,317,1,1,0,1,0
0,323,323,45,25,20,3,2
38,333,333,93,93,0,1,0
17,375,375,21,15,6,3,2
36,376,376,108,78,30,4,3
37,383,383,50,50,0,1,0
23,383,383,9,9,0,1,0
3,384,384,14,14,0,1,0
11,393,393,27,9,18,2,1
20,395,395,85,85,0,1,0
22,399,399,30,16,14,3,2
32,403,403,32,32,0,1,0
12,424,424,10,2,8,2,1
13,427,427,72,72,0,1,0
24,445,445,53,7,46,2,1
5,447,447,6,6,0,1,0
25,455,455,15,15,0,1,0
39,457,457,112,61,51,3,2
2,470,470,53,53,0,1,0
33,473,473,9,9,0,1,0
29,479,479,17,6,11,2,1
19,493,493,44,44,0,1,0

16,101,101,17,17,0,1,0
34,115,115,15,11,4,2,1
24,133,133,7,7,0,1,0
5,136,136,23,23,0,1,0
1,138,138,3,3,0,1,0
14,146,146,4,4,0,1,0
17,167,167,16,16,0,1,0
30,177,177,2,2,0,1,0
23,187,187,24,2,22,2,1
8,191,191,48,4,44,3,2
3,193,193,18,4,14,3,2
25,217,217,15,15,0,1,0
7,221,221,34,23,11,2,1
6,232,232,4,4,0,1,0
22,243,243,44,28,16,2,1
20,243,243,1,1,0,1,0
2,256,256,16,16,0,1,0
32,268,268,9,4,5,2,1
15,283,283,16,16,0,1,0
28,313,313,28,28,0,1,0
13,317,317,33,23,10,3,2
9,323,323,9,3,6,3,2
31,350,350,26,8,18,2,1
19,371,371,39,39,0,1,0
4,398,398,23,23,0,1,0
29,402,402,49,11,38,3,2
26,409,409,4,4,0,1,0
33,424,424,30,23,7,2,1
0,446,446,8,5,3,2,1
12,447,447,146,106,40,3,2
10,449,449,32,32,0,1,0
18,451,451,44,44,0,1,0
27,470,470,64,64,0,1,0
11,478,478,83,83,0,1,0
21,490,490,208,193,15,4,3

24,119,119,19,8,11,2,1
27,125,125,16,7,9,2,1
3,128,128,16,1,15,2,1
21,128,128,5,5,0,1,0
29,129,129,12,12,0,1,0
4,141,141,18,2,16,2,1
31,151,151,7,7,0,1,0
18,177,177,34,34,0,1,0
23,179,179,9,9,0,1,0
20,181,181,36,36,0,1,0
15,184,184,25,25,0,1,0
14,185,185,5,1,4,2,1
2,207,207,26,4,22,2,1
30,213,213,13,13,0,1,0
10,232,232,27,14,13,4,3
17,259,259,7,3,4,2,1
28,294,294,41,41,0,1,0
16,295,295,36,36,0,1,0
35,298,298,9,6,3,2,1
11,311,311,4,4,0,1,0
8,312,312,7,7,0,1,0
34,318,318,56,56,0,1,0
22,341,341,18,18,0,1,0
12,355,355,2,2,0,1,0
19,360,360,4,4,0,1,0
1,364,364,100,100,0,1,0
33,370,370,21,3,18,2,1
0,376,376,19,19,0,1,0
32,384,384,53,44,9,2,1
13,403,403,63,63,0,1,0
7,425,425,41,20,21,2,1
9,430,430,50,18,32,2,1
5,435,435,16,16,0,1,0
26,445,445,117,90,27,4,3
25,470,470,86,2,84,3,2
6,475,475,16,2,14,2,1
36,484,484,4,4,0,1,0

5,119,119,1,1,0,1,0
24,142,142,3,3,0,1,0
35,188,188,2,2,0,1,0
6,188,188,13,13,0,1,0
0,192,192,61,61,0,1,0
8,212,212,32,22,10,3,2
16,217,217,3,3,0,1,0
36,231,231,55,55,0,1,0
20,245,245,4,4,0,1,0
1,251,251,93,93,0,1,0
3,265,265,21,7,14,4,3
26,277,277,12,8,4,2,1
23,277,277,5,5,0,1,0
33,284,284,46,33,13,2,1
22,306,306,33,33,0,1,0
25,312,312,28,28,0,1,0
34,319,319,39,7,32,2,1
30,331,331,87,87,0,1,0
28,335,335,33,28,5,2,1
2,336,336,18,18,0,1,0
12,336,336,17,17,0,1,0
15,339,339,2,2,0,1,0
18,341,341,27,27,0,1,0
32,390,390,2,2,0,1,0
10,396,396,12,12,0,1,0
17,399,399,40,40,0,1,0
38,400,400,1,1,0,1,0
7,403,403,68,68,0,1,0
31,407,407,65,20,45,4,3
19,410,410,34,10,24,2,1
27,415,415,58,58,0,1,0
21,430,430,60,4,56,3,2
11,434,434,12,4,8,3,2
37,451,451,68,38,30,3,2
9,455,455,13,3,10,3,2
14,470,470,3,3,0,1,0
4,474,474,30,30,0,1,0
13,484,484,38,38,0,1,0
29,493,493,29,4,25,3,2

9,123,123,2,2,0,1,0
37,129,129,25,25,0,1,0
8,132,132,8,8,0,1,0
1,153,153,6,1,5,2,1
28,157,157,25,25,0,1,0
22,164,164,4,4,0,1,0
41,167,167,8,8,0,1,0
7,168,168,7,2,5,2,1
2,170,170,31,31,0,1,0
15,172,172,2,2,0,1,0
4,190,190,4,4,0,1,0
26,221,221,33,21,12,4,3
24,222,222,86,6,80,3,2
16,232,232,13,13,0,1,0
3,238,238,8,8,0,1,0
30,242,242,16,16,0,1,0
14,254,254,52,21,31,2,1
38,268,268,18,18,0,1,0
31,273,273,1,1,0,1,0
10,273,273,76,5,71,4,3
34,279,279,64,23,41,4,3
21,285,285,8,8,0,1,0
39,303,303,38,38,0,1,0
12,307,307,20,8,12,3,2
23,311,311,1,1,0,1,0
5,318,318,39,39,0,1,0
27,336,336,58,22,36,3,2
13,349,349,1,1,0,1,0
20,350,350,21,9,12,2,1
33,354,354,33,4,29,2,1
11,361,361,22,16,6,2,1
40,383,383,3,3,0,1,0
19,393,393,26,26,0,1,0
17,398,398,3,3,0,1,0
36,400,400,10,1,9,4,3
6,403,403,16,4,12,3,2
32,406,406,1,1,0,1,0
29,410,410,13,9,4,2,1
0,423,423,152,152,0,1,0
35,428,428,1,1,0,1,0
25,437,437,31,31,0,1,0
18,452,452,7,2,5,2,1

21,118,118,6,6,0,1,0
13,150,150,5,5,0,1,0
23,165,165,14,14,0,1,0
10,191,191,15,15,0,1,0
25,212,212,19,19,0,1,0
31,215,215,29,29,0,1,0
3,239,239,99,99,0,1,0
22,246,246,7,7,0,1,0
29,266,266,19,4,15,2,1
20,266,266,16,8,8,2,1
4,288,288,11,11,0,1,0
12,299,299,18,18,0,1,0
33,319,319,57,57,0,1,0
9,326,326,52,52,0,1,0
11,327,327,20,14,6,2,1
0,335,335,75,15,60,4,3
6,338,338,5,5,0,1,0
17,340,340,10,10,0,1,0
14,356,356,22,22,0,1,0
7,357,357,61,35,26,2,1
19,369,369,4,4,0,1,0
32,409,409,117,60,57,4,3
16,416,416,71,67,4,2,1
30,418,418,11,4,7,2,1
1,425,425,44,44,0,1,0
5,442,442,12,2,10,2,1
18,448,448,109,25,84,4,3
27,454,454,30,30,0,1,0
8,455,455,96,8,88,3,2
15,457,457,63,28,35,2,1
2,476,476,2,2,0,1,0
24,483,483,43,43,0,1,0
26,485,485,84,12,72,4,3
28,491,491,20,2,18,3,2

9,104,104,4,1,3,2,1
25,127,127,6,6,0,1,0
11,128,128,1,1,0,1,0
40,134,134,2,2,0,1,0
24,138,138,1,1,0,1,0
30,139,139,10,5,5,2,1
31,156,156,10,10,0,1,0
0,159,159,5,5,0,1,0
18,171,171,5,5,0,1,0
12,187,187,10,10,0,1,0
44,216,216,1,1,0,1,0
21,223,223,1,1,0,1,0
1,227,227,6,3,3,2,1
43,237,237,15,8,7,2,1
10,244,244,33,19,14,2,1
36,249,249,20,1,19,2,1
16,286,286,14,8,6,2,1
19,290,290,1,1,0,1,0
37,299,299,18,18,0,1,0
38,315,315,49,49,0,1,0
5,332,332,1,1,0,1,0
23,337,337,46,25,21,4,3
28,339,339,1,1,0,1,0
22,344,344,65,39,26,2,1
13,345,345,4,4,0,1,0
39,361,361,271,238,33,2,1
34,363,363,2,2,0,1,0
29,363,363,15,4,11,2,1
45,369,369,22,22,0,1,0
33,380,380,3,3,0,1,0
7,386,386,108,56,52,4,3
4,396,396,1,1,0,1,0
26,400,400,15,5,10,2,1
32,403,403,25,13,12,3,2
35,409,409,38,14,24,4,3
42,424,424,64,27,37,2,1
41,429,429,63,30,33,4,3
14,463,463,7,3,4,2,1
2,471,471,62,62,0,1,0
15,473,473,1,1,0,1,0
3,474,474,24,12,12,2,1
27,476,476,81,81,0,1,0
20,477,477,140,140,0,1,0
6,481,481,11,1,10,2,1
8,484,484,1,1,0,1,0
17,500,500,10,10,0,1,0

18,101,101,5,5,0,1,0
14,105,105,1,1,0,1,0
7,109,109,1,1,0,1,0
27,136,136,4,4,0,1,0
22,145,145,13,9,4,2,1
44,162,162,5,2,3,2,1
21,168,168,16,16,0,1,0
34,169,169,2,2,0,1,0
16,192,192,5,2,3,2,1
40,199,199,10,10,0,1,0
24,204,204,6,6,0,1,0
23,220,220,6,6,0,1,0
8,221,221,8,8,0,1,0
42,233,233,11,1,10,2,1
20,241,241,52,22,30,2,1
4,255,255,8,8,0,1,0
38,257,257,34,17,17,4,3
31,261,261,5,5,0,1,0
25,267,267,29,29,0,1,0
26,269,269,13,1,12,2,1
37,285,285,97,97,0,1,0
2,295,295,6,6,0,1,0
30,301,301,22,22,0,1,0
45,304,304,20,20,0,1,0
15,309,309,28,9,19,2,1
35,324,324,21,18,3,2,1
13,330,330,29,12,17,2,1
29,333,333,97,52,45,3,2
10,335,335,35,35,0,1,0
9,356,356,3,3,0,1,0
39,362,362,39,22,17,2,1
43,363,363,60,4,56,3,2
11,381,381,31,21,10,2,1
46,383,383,53,53,0,1,0
12,394,394,28,18,10,3,2
41,406,406,17,5,12,2,1
19,409,409,1,1,0,1,0
5,411,411,36,36,0,1,0
3,419,419,14,6,8,2,1
0,425,425,63,20,43,2,1
1,432,432,5,1,4,2,1
36,443,443,44,41,3,2,1
33,467,467,57,57,0,1,0
32,468,468,16,7,9,2,1
17,468,468,35,27,8,3,2
28,473,473,37,20,17,2,1
6,489,489,47,24,23,2,1

49,108,108,24,24,0,1,0
32,113,113,23,14,9,4,3
47,114,114,5,5,0,1,0
20,129,129,4,1,3,2,1
13,136,136,3,3,0,1,0
43,143,143,2,2,0,1,0
27,149,149,36,23,13,2,1
25,175,175,26,17,9,4,3
48,179,179,31,24,7,2,1
34,183,183,25,25,0,1,0
19,188,188,5,5,0,1,0
36,192,192,11,3,8,2,1
24,196,196,9,3,6,2,1
22,217,217,1,1,0,1,0
10,222,222,12,3,9,2,1
7,226,226,7,3,4,2,1
2,229,229,17,3,14,3,2
1,230,230,40,40,0,1,0
41,235,235,31,3,28,4,3
8,235,235,4,4,0,1,0
40,246,246,16,8,8,2,1
14,280,280,2,2,0,1,0
35,285,285,20,14,6,2,1
37,293,293,15,15,0,1,0
18,301,301,7,2,5,2,1
11,315,315,34,34,0,1,0
33,322,322,9,6,3,2,1
5,323,323,15,15,0,1,0
21,340,340,24,24,0,1,0
15,346,346,48,48,0,1,0
3,363,363,1,1,0,1,0
28,371,371,1,1,0,1,0
12,373,373,32,14,18,4,3
4,377,377,1,1,0,1,0
45,377,377,34,22,12,3,2
17,388,388,27,27,0,1,0
6,394,394,6,3,3,2,1
46,408,408,71,65,6,2,1
23,409,409,8,8,0,1,0
0,414,414,18,18,0,1,0
44,447,447,73,27,46,3,2
9,453,453,39,11,28,3,2
29,467,467,7,7,0,1,0
30,467,467,29,29,0,1,0
42,470,470,3,3,0,1,0
38,475,475,43,17,26,2,1
31,475,475,6,1,5,2,1
39,482,482,57,25,32,2,1
16,490,490,40,40,0,1,0
26,498,498,19,1,18,4,3

14,103,103,7,2,5,2,1
30,104,104,2,2,0,1,0
2,149,149,3,3,0,1,0
18,166,166,9,9,0,1,0
16,182,182,30,30,0,1,0
33,184,184,11,11,0,1,0
15,190,190,4,4,0,1,0
20,199,199,1,1,0,1,0
19,204,204,16,16,0,1,0
0,210,210,41,33,8,2,1
4,218,218,50,41,9,4,3
9,232,232,9,9,0,1,0
5,235,235,40,40,0,1,0
10,265,265,2,2,0,1,0
29,277,277,25,11,14,3,2
26,283,283,28,4,24,2,1
23,293,293,36,23,13,2,1
6,323,323,1,1,0,1,0
28,331,331,37,37,0,1,0
25,332,332,51,46,5,2,1
22,333,333,31,7,24,2,1
12,337,337,21,3,18,2,1
8,339,339,32,32,0,1,0
3,389,389,32,32,0,1,0
13,400,400,65,65,0,1,0
11,405,405,122,122,0,1,0
32,409,409,12,9,3,2,1
17,448,448,74,74,0,1,0
31,469,469,9,6,3,2,1
21,472,472,30,30,0,1,0
1,489,489,53,32,21,2,1
27,494,494,148,103,45,4,3
7,495,495,119,86,33,2,1
24,498,498,106,70,36,2,1

5,111,111,39,39,0,1,0
9,137,137,13,13,0,1,0
19,142,142,3,3,0,1,0
31,151,151,6,6,0,1,0
34,176,176,30,3,27,4,3
12,190,190,2,2,0,1,0
22,203,203,33,1,32,2,1
2,206,206,3,3,0,1,0
20,222,222,41,41,0,1,0
33,225,225,80,80,0,1,0
7,241,241,1,1,0,1,0
10,257,257,9,1,8,3,2
30,258,258,24,10,14,2,1
28,281,281,1,1,0,1,0
32,297,297,9,9,0,1,0
4,308,308,13,13,0,1,0
17,314,314,59,59,0,1,0
14,332,332,2,2,0,1,0
23,338,338,65,65,0,1,0
3,349,349,11,11,0,1,0
35,349,349,21,21,0,1,0
16,352,352,46,28,18,4,3
15,373,373,17,2,15,4,3
8,388,388,13,5,8,2,1
1,392,392,108,108,0,1,0
18,397,397,6,6,0,1,0
11,401,401,30,2,28,3,2
24,401,401,39,39,0,1,0
0,403,403,111,4,107,4,3
13,414,414,23,3,20,3,2
21,422,422,45,45,0,1,0
26,422,422,10,10,0,1,0
27,425,425,91,44,47,2,1
29,439,439,7,7,0,1,0
25,485,485,23,2,21,3,2
6,493,493,66,24,42,2,1

12,111,111,1,1,0,1,0
16,141,141,41,41,0,1,0
9,155,155,1,1,0,1,0
37,161,161,27,15,12,2,1
20,169,169,40,24,16,2,1
27,193,193,4,4,0,1,0
33,194,194,7,3,4,2,1
31,198,198,6,6,0,1,0
10,213,213,31,9,22,2,1
21,240,240,11,2,9,4,3
28,247,247,15,3,12,3,2
1,274,274,7,1,6,3,2
18,279,279,30,22,8,2,1
25,279,279,23,23,0,1,0
23,299,299,81,49,32,2,1
24,314,314,12,12,0,1,0
29,320,320,24,5,19,3,2
14,326,326,70,61,9,2,1
3,328,328,26,26,0,1,0
34,338,338,9,9,0,1,0
8,344,344,55,47,8,2,1
35,345,345,71,71,0,1,0
19,348,348,1,1,0,1,0
15,368,368,2,2,0,1,0
13,379,379,18,8,10,4,3
5,386,386,24,24,0,1,0
22,396,396,6,6,0,1,0
0,398,398,3,3,0,1,0
17,408,408,101,41,60,4,3
11,426,426,3,3,0,1,0
30,429,429,16,4,12,4,3
4,456,456,13,2,11,2,1
7,465,465,91,91,0,1,0
6,466,466,44,28,16,3,2
26,481,481,1,1,0,1,0
36,486,486,106,13,93,4,3
2,499,499,32,7,25,4,3
32,500,500,130,116,14,3,2

0,109,109,1,1,0,1,0
18,109,109,1,1,0,1,0
19,136,136,13,9,4,2,1
1,146,146,1,1,0,1,0
27,154,154,16,2,14,2,1
11,173,173,11,11,0,1,0
5,182,182,6,3,3,2,1
20,195,195,38,38,0,1,0
29,204,204,20,20,0,1,0
22,217,217,73,61,12,4,3
28,220,220,6,6,0,1,0
24,224,224,4,4,0,1,0
16,226,226,23,23,0,1,0
14,243,243,8,3,5,2,1
31,258,258,4,4,0,1,0
32,265,265,9,9,0,1,0
15,300,300,22,22,0,1,0
8,318,318,50,42,8,3,2
3,333,333,57,57,0,1,0
21,341,341,109,79,30,3,2
33,348,348,23,23,0,1,0
6,394,394,116,68,48,4,3
7,426,426,46,34,12,2,1
13,434,434,51,42,9,4,3
10,450,450,113,106,7,2,1
30,457,457,65,32,33,4,3
25,469,469,60,12,48,4,3
26,483,483,45,45,0,1,0
9,484,484,58,58,0,1,0
17,490,490,8,4,4,2,1
2,492,492,47,47,0,1,0
4,494,494,102,102,0,1,0
23,495,495,17,17,0,1,0
12,500,500,30,21,9,2,1

13,112,112,5,5,0,1,0
21,126,126,4,4,0,1,0
15,142,142,2,2,0,1,0
24,149,149,29,29,0,1,0
2,169,169,5,5,0,1,0
16,174,174,24,15,9,4,3
0,202,202,29,6,23,2,1
6,202,202,35,6,29,4,3
8,214,214,36,36,0,1,0
23,276,276,79,22,57,4,3
11,284,284,37,19,18,2,1
17,321,321,24,24,0,1,0
7,322,322,20,20,0,1,0
5,329,329,18,6,12,2,1
27,336,336,10,1,9,4,3
30,338,338,29,29,0,1,0
18,342,342,81,3,78,3,2
19,349,349,4,4,0,1,0
14,358,358,18,18,0,1,0
1,374,374,107,101,6,3,2
20,388,388,54,54,0,1,0
22,396,396,33,33,0,1,0
3,403,403,103,70,33,4,3
9,421,421,125,119,6,3,2
29,429,429,17,17,0,1,0
26,430,430,61,31,30,4,3
12,445,445,28,28,0,1,0
4,451,451,8,8,0,1,0
10,459,459,55,55,0,1,0
28,464,464,56,35,21,4,3
25,499,499,54,10,44,2,1

7,109,109,11,11,0,1,0
0,142,142,2,2,0,1,0
11,146,146,13,9,4,2,1
18,175,175,11,8,3,2,1
15,192,192,32,32,0,1,0
33,194,194,8,1,7,2,1
32,202,202,6,2,4,2,1
25,211,211,22,9,13,2,1
23,215,215,22,22,0,1,0
20,219,219,14,14,0,1,0
13,248,248,2,2,0,1,0
17,252,252,71,47,24,4,3
12,277,277,31,31,0,1,0
22,286,286,8,8,0,1,0
2,293,293,50,4,46,2,1
3,317,317,36,22,14,2,1
35,320,320,60,60,0,1,0
24,323,323,97,19,78,4,3
26,333,333,123,123,0,1,0
19,339,339,17,17,0,1,0
10,375,375,10,10,0,1,0
16,388,388,100,100,0,1,0
30,395,395,7,7,0,1,0
28,404,404,6,2,4,2,1
9,421,421,25,5,20,3,2
1,423,423,5,5,0,1,0
8,430,430,112,112,0,1,0
34,437,437,40,24,16,3,2
27,451,451,55,32,23,3,2
6,456,456,1,1,0,1,0
29,461,461,60,24,36,2,1
5,465,465,6,6,0,1,0
14,477,477,30,30,0,1,0
4,477,477,24,3,21,4,3
31,480,480,27,12,15,4,3
21,492,492,24,10,14,3,2

16,130,130,16,9,7,2,1
0,145,145,6,1,5,2,1
8,153,153,23,23,0,1,0
12,158,158,13,13,0,1,0
35,163,163,16,16,0,1,0
15,165,165,1,1,0,1,0
9,185,185,46,12,34,4,3
7,220,220,25,25,0,1,0
11,230,230,28,28,0,1,0
33,243,243,15,15,0,1,0
31,244,244,5,1,4,2,1
29,245,245,6,6,0,1,0
19,264,264,15,15,0,1,0
1,272,272,42,9,33,2,1
14,273,273,7,1,6,3,2
6,289,289,15,15,0,1,0
10,312,312,41,41,0,1,0
27,324,324,4,4,0,1,0
3,346,346,33,4,29,2,1
34,357,357,7,7,0,1,0
23,361,361,2,2,0,1,0
32,368,368,199,115,84,4,3
26,372,372,56,12,44,3,2
5,389,389,1,1,0,1,0
4,405,405,23,5,18,3,2
21,409,409,71,55,16,2,1
17,412,412,8,2,6,3,2
25,419,419,28,11,17,4,3
28,421,421,14,14,0,1,0
18,426,426,64,4,60,3,2
22,441,441,19,5,14,3,2
2,441,441,44,44,0,1,0
20,442,442,9,9,0,1,0
13,450,450,125,125,0,1,0
24,489,489,125,33,92,3,2
30,490,490,43,43,0,1,0

3,105,105,1,1,0,1,0
9,116,116,3,3,0,1,0
22,120,120,1,1,0,1,0
41,126,126,2,2,0,1,0
28,132,132,4,4,0,1,0
14,150,150,1,1,0,1,0
27,151,151,2,2,0,1,0
36,161,161,23,23,0,1,0
1,166,166,35,35,0,1,0
39,171,171,46,46,0,1,0
37,174,174,1,1,0,1,0
33,189,189,2,2,0,1,0
10,194,194,1,1,0,1,0
42,199,199,2,2,0,1,0
32,200,200,2,2,0,1,0
21,219,219,12,12,0,1,0
6,231,231,13,13,0,1,0
30,248,248,90,36,54,4,3
38,250,250,40,14,26,2,1
23,265,265,17,17,0,1,0
29,267,267,60,60,0,1,0
2,297,297,7,4,3,2,1
5,302,302,43,43,0,1,0
24,303,303,12,12,0,1,0
8,305,305,3,3,0,1,0
34,317,317,85,47,38,2,1
19,322,322,5,5,0,1,0
25,339,339,38,38,0,1,0
16,344,344,8,8,0,1,0
18,377,377,21,1,20,2,1
26,387,387,10,2,8,2,1
0,416,416,65,8,57,3,2
15,422,422,47,9,38,3,2
31,427,427,8,8,0,1,0
35,433,433,40,40,0,1,0
4,435,435,14,9,5,2,1
17,455,455,13,1,12,3,2
7,458,458,189,177,12,4,3
11,459,459,27,27,0,1,0
13,460,460,15,15,0,1,0
20,461,461,91,91,0,1,0
12,462,462,10,10,0,1,0
40,487,487,33,3,30,4,3

26,103,103,2,2,0,1,0
21,107,107,13,5,8,3,2
31,127,127,12,1,11,2,1
18,157,157,1,1,0,1,0
35,170,170,13,13,0,1,0
34,172,172,3,3,0,1,0
16,212,212,34,18,16,3,2
25,233,233,15,11,4,2,1
2,238,238,18,18,0,1,0
33,258,258,22,15,7,2,1
0,259,259,74,41,33,2,1
24,262,262,18,12,6,2,1
11,287,287,37,9,28,2,1
20,306,306,2,2,0,1,0
36,315,315,14,14,0,1,0
12,319,319,1,1,0,1,0
19,319,319,22,22,0,1,0
23,335,335,103,103,0,1,0
8,351,351,14,10,4,2,1
27,356,356,3,3,0,1,0
29,361,361,107,107,0,1,0
3,363,363,11,5,6,2,1
9,369,369,4,4,0,1,0
7,376,376,43,24,19,2,1
14,391,391,40,40,0,1,0
10,393,393,92,36,56,3,2
28,394,394,17,5,12,4,3
15,400,400,36,24,12,2,1
13,454,454,37,37,0,1,0
32,455,455,44,44,0,1,0
30,459,459,9,9,0,1,0
22,461,461,182,119,63,4,3
6,473,473,40,40,0,1,0
5,477,477,41,41,0,1,0
17,481,481,94,67,27,2,1
1,485,485,20,20,0,1,0
4,495,495,17,8,9,2,1

11,106,106,31,31,0,1,0
31,108,108,2,2,0,1,0
24,157,157,4,4,0,1,0
1,159,159,1,1,0,1,0
30,163,163,1,1,0,1,0
28,182,182,41,23,18,3,2
6,192,192,38,21,17,2,1
36,200,200,49,49,0,1,0
0,222,222,1,1,0,1,0
9,223,223,44,19,25,2,1
4,245,245,40,25,15,3,2
13,249,249,46,46,0,1,0
5,253,253,34,34,0,1,0
29,255,255,47,23,24,3,2
14,259,259,3,3,0,1,0
3,263,263,20,20,0,1,0
18,264,264,16,16,0,1,0
32,289,289,7,7,0,1,0
17,292,292,19,19,0,1,0
22,293,293,5,5,0,1,0
2,318,318,19,19,0,1,0
16,328,328,1,1,0,1,0
35,332,332,19,7,12,3,2
37,336,336,94,94,0,1,0
15,338,338,11,6,5,2,1
21,343,343,24,24,0,1,0
7,343,343,5,5,0,1,0
34,355,355,40,40,0,1,0
19,361,361,29,29,0,1,0
27,367,367,1,1,0,1,0
25,377,377,23,4,19,2,1
10,380,380,1,1,0,1,0
33,384,384,50,50,0,1,0
26,412,412,42,42,0,1,0
8,416,416,74,38,36,2,1
12,427,427,16,6,10,2,1
23,450,450,86,86,0,1,0
20,497,497,39,24,15,2,1

19,112,112,11,11,0,1,0
1,114,114,1,1,0,1,0
7,138,138,56,50,6,2,1
21,161,161,18,18,0,1,0
20,207,207,44,44,0,1,0
22,207,207,18,18,0,1,0
25,209,209,11,11,0,1,0
16,221,221,4,1,3,2,1
15,247,247,6,6,0,1,0
11,250,250,47,2,45,4,3
5,272,272,22,22,0,1,0
9,276,276,58,58,0,1,0
6,284,284,82,82,0,1,0
4,315,315,98,12,86,3,2
10,326,326,18,18,0,1,0
12,333,333,3,3,0,1,0
23,340,340,22,22,0,1,0
26,359,359,8,2,6,2,1
17,371,371,80,80,0,1,0
3,379,379,10,2,8,3,2
14,382,382,34,34,0,1,0
13,425,425,128,128,0,1,0
27,432,432,107,107,0,1,0
24,434,434,7,7,0,1,0
18,454,454,7,7,0,1,0
0,457,457,1,1,0,1,0
8,467,467,104,20,84,4,3
2,486,486,119,56,63,4,3

13,106,106,18,10,8,3,2
21,127,127,2,2,0,1,0
4,130,130,15,12,3,2,1
28,142,142,3,3,0,1,0
6,155,155,12,5,7,2,1
16,157,157,16,11,5,2,1
24,159,159,28,28,0,1,0
7,189,189,34,20,14,3,2
23,189,189,29,4,25,2,1
15,198,198,14,8,6,3,2
17,198,198,31,31,0,1,0
11,206,206,20,11,9,4,3
0,217,217,38,15,23,2,1
10,218,218,15,6,9,2,1
12,229,229,1,1,0,1,0
20,240,240,5,5,0,1,0
22,289,289,104,104,0,1,0
30,289,289,12,12,0,1,0
25,293,293,27,27,0,1,0
1,338,338,116,70,46,3,2
27,339,339,35,25,10,2,1
18,349,349,104,12,92,3,2
26,399,399,30,30,0,1,0
14,401,401,32,28,4,2,1
29,406,406,1,1,0,1,0
5,422,422,17,4,13,2,1
2,429,429,128,83,45,4,3
9,431,431,17,17,0,1,0
3,477,477,50,39,11,2,1
31,478,478,8,2,6,3,2
8,488,488,42,42,0,1,0
19,489,489,23,8,15,3,2

27,101,101,17,17,0,1,0
34,106,106,2,2,0,1,0
31,112,112,27,27,0,1,0
38,123,123,32,26,6,2,1
11,131,131,28,6,22,2,1
13,145,145,8,8,0,1,0
30,147,147,4,4,0,1,0
10,153,153,1,1,0,1,0
36,155,155,14,4,10,3,2
39,163,163,20,16,4,2,1
3,163,163,7,7,0,1,0
9,167,167,11,11,0,1,0
35,172,172,15,4,11,2,1
29,183,183,23,5,18,3,2
37,201,201,9,2,7,2,1
14,207,207,22,1,21,4,3
40,211,211,8,8,0,1,0
6,226,226,11,2,9,4,3
21,228,228,49,40,9,2,1
1,268,268,73,49,24,4,3
4,272,272,1,1,0,1,0
22,272,272,6,6,0,1,0
15,273,273,3,3,0,1,0
16,277,277,1,1,0,1,0
7,278,278,25,5,20,3,2
28,280,280,27,27,0,1,0
26,304,304,17,3,14,3,2
24,317,317,40,40,0,1,0
19,318,318,8,8,0,1,0
8,342,342,18,2,16,2,1
33,342,342,10,5,5,2,1
2,360,360,21,21,0,1,0
23,367,367,57,57,0,1,0
0,380,380,48,48,0,1,0
5,393,393,3,3,0,1,0
18,433,433,1,1,0,1,0
32,437,437,4,1,3,2,1
12,438,438,6,3,3,2,1
17,440,440,137,41,96,3,2
25,461,461,73,73,0,1,0
20,494,494,23,5,18,3,2

4,111,111,36,21,15,4,3
5,142,142,9,9,0,1,0
13,149,149,4,4,0,1,0
7,172,172,66,28,38,2,1
1,182,182,80,80,0,1,0
9,185,185,15,8,7,2,1
29,235,235,56,56,0,1,0
14,244,244,9,9,0,1,0
3,249,249,2,2,0,1,0
27,258,258,4,4,0,1,0
11,274,274,34,16,18,4,3
17,282,282,2,2,0,1,0
15,294,294,24,24,0,1,0
16,301,301,58,31,27,4,3
24,354,354,26,5,21,4,3
30,355,355,10,10,0,1,0
12,377,377,11,11,0,1,0
20,388,388,12,12,0,1,0
28,396,396,16,12,4,2,1
2,396,396,19,6,13,2,1
10,401,401,27,27,0,1,0
6,404,404,24,10,14,2,1
22,415,415,229,211,18,4,3
8,422,422,29,3,26,2,1
21,436,436,7,7,0,1,0
23,461,461,51,51,0,1,0
18,463,463,21,1,20,2,1
26,471,471,43,27,16,2,1
0,483,483,50,50,0,1,0
25,488,488,91,91,0,1,0
19,499,499,28,28,0,1,0

25,102,102,3,3,0,1,0
26,124,124,33,25,8,3,2
6,128,128,15,15,0,1,0
16,133,133,7,1,6,2,1
8,145,145,46,46,0,1,0
14,171,171,41,5,36,3,2
13,177,177,2,2,0,1,0
19,180,180,13,1,12,3,2
0,205,205,2,2,0,1,0
3,207,207,49,49,0,1,0
31,225,225,7,7,0,1,0
2,241,241,64,19,45,2,1
4,251,251,10,10,0,1,0
17,271,271,6,6,0,1,0
24,280,280,67,67,0,1,0
5,283,283,20,6,14,2,1
32,284,284,4,4,0,1,0
1,287,287,47,47,0,1,0
27,339,339,26,9,17,2,1
28,348,348,42,42,0,1,0
30,350,350,35,35,0,1,0
10,365,365,13,6,7,2,1
9,371,371,54,18,36,4,3
18,371,371,3,3,0,1,0
21,403,403,33,33,0,1,0
22,405,405,123,29,94,4,3
15,410,410,22,7,15,4,3
23,438,438,62,39,23,2,1
29,443,443,3,3,0,1,0
12,446,446,24,24,0,1,0
11,448,448,21,12,9,4,3
20,456,456,96,62,34,2,1
7,490,490,24,24,0,1,0

8,104,104,25,19,6,3,2
9,121,121,6,6,0,1,0
4,133,133,24,16,8,2,1
2,163,163,10,10,0,1,0
3,176,176,65,27,38,2,1
14,190,190,21,21,0,1,0
19,230,230,17,1,16,2,1
22,232,232,10,10,0,1,0
20,242,242,22,5,17,2,1
26,252,252,11,11,0,1,0
23,253,253,48,20,28,4,3
10,261,261,12,12,0,1,0
0,275,275,12,12,0,1,0
18,284,284,48,48,0,1,0
7,289,289,3,3,0,1,0
21,293,293,15,12,3,2,1
29,318,318,10,10,0,1,0
1,336,336,4,4,0,1,0
15,346,346,14,8,6,2,1
28,350,350,11,11,0,1,0
17,353,353,5,5,0,1,0
16,356,356,21,21,0,1,0
24,356,356,97,13,84,3,2
25,360,360,6,6,0,1,0
6,363,363,14,11,3,2,1
27,373,373,117,79,38,3,2
5,380,380,54,54,0,1,0
13,399,399,84,44,40,3,2
11,454,454,26,26,0,1,0
30,477,477,29,29,0,1,0
12,480,480,264,218,46,2,1

6,101,101,6,6,0,1,0
27,102,102,11,6,5,2,1
13,105,105,16,2,14,4,3
4,118,118,3,3,0,1,0
41,129,129,3,3,0,1,0
23,154,154,1,1,0,1,0
2,156,156,6,6,0,1,0
16,157,157,7,7,0,1,0
11,174,174,21,10,11,2,1
5,178,178,5,5,0,1,0
1,181,181,9,9,0,1,0
14,187,187,13,1,12,3,2
19,197,197,6,6,0,1,0
25,218,218,18,18,0,1,0
35,221,221,18,18,0,1,0
7,224,224,8,8,0,1,0
17,242,242,17,5,12,3,2
24,243,243,7,7,0,1,0
15,250,250,1,1,0,1,0
3,265,265,1,1,0,1,0
32,277,277,16,4,12,3,2
10,283,283,10,4,6,2,1
9,284,284,11,11,0,1,0
37,286,286,5,5,0,1,0
40,307,307,22,22,0,1,0
18,319,319,164,157,7,2,1
29,328,328,1,1,0,1,0
39,333,333,13,10,3,2,1
22,363,363,13,13,0,1,0
26,400,400,25,13,12,4,3
20,417,417,13,13,0,1,0
36,429,429,15,7,8,2,1
0,432,432,82,82,0,1,0
38,435,435,94,64,30,4,3
28,452,452,23,23,0,1,0
8,456,456,39,17,22,4,3
33,457,457,155,155,0,1,0
34,468,468,150,143,7,2,1
21,479,479,19,3,16,3,2
12,479,479,44,1,43,2,1
31,493,493,97,21,76,4,3
30,497,497,54,39,15,2,1

12,101,101,3,3,0,1,0
1,113,113,21,21,0,1,0
27,123,123,8,8,0,1,0
21,125,125,8,8,0,1,0
16,131,131,78,78,0,1,0
20,137,137,34,2,32,3,2
7,143,143,13,4,9,2,1
24,149,149,5,5,0,1,0
8,149,149,6,6,0,1,0
6,152,152,1,1,0,1,0
28,161,161,4,4,0,1,0
25,201,201,3,3,0,1,0
32,213,213,2,2,0,1,0
19,245,245,2,2,0,1,0
3,246,246,9,9,0,1,0
4,254,254,170,170,0,1,0
2,266,266,3,3,0,1,0
29,289,289,19,1,18,3,2
26,296,296,23,7,16,2,1
30,301,301,28,28,0,1,0
5,307,307,20,20,0,1,0
14,309,309,61,61,0,1,0
15,333,333,41,41,0,1,0
31,370,370,20,20,0,1,0
17,373,373,63,24,39,2,1
33,375,375,2,2,0,1,0
9,382,382,31,31,0,1,0
18,388,388,9,9,0,1,0
0,421,421,34,3,31,4,3
10,422,422,26,15,11,2,1
22,457,457,52,52,0,1,0
13,458,458,5,5,0,1,0
11,463,463,51,51,0,1,0
23,491,491,90,49,41,2,1

0,105,105,25,13,12,2,1
9,113,113,17,17,0,1,0
23,123,123,11,11,0,1,0
24,140,140,16,16,0,1,0
22,154,154,3,3,0,1,0
3,159,159,7,7,0,1,0
8,170,170,1,1,0,1,0
28,175,175,13,1,12,2,1
21,204,204,1,1,0,1,0
13,205,205,52,49,3,2,1
17,223,223,8,8,0,1,0
16,227,227,26,26,0,1,0
27,238,238,26,13,13,3,2
32,255,255,12,12,0,1,0
30,256,256,58,58,0,1,0
5,261,261,85,27,58,4,3
10,274,274,29,14,15,4,3
20,293,293,49,49,0,1,0
12,303,303,3,3,0,1,0
29,311,311,22,8,14,3,2
31,312,312,4,4,0,1,0
7,350,350,62,28,34,3,2
19,352,352,28,28,0,1,0
25,356,356,25,25,0,1,0
15,360,360,74,74,0,1,0
6,364,364,2,2,0,1,0
14,365,365,17,17,0,1,0
11,378,378,8,3,5,2,1
18,384,384,28,20,8,3,2
2,398,398,70,31,39,2,1
1,419,419,12,1,11,2,1
33,447,447,43,18,25,4,3
4,465,465,4,4,0,1,0
26,498,498,218,142,76,4,3

10,112,112,8,8,0,1,0
24,124,124,5,5,0,1,0
22,145,145,1,1,0,1,0
36,158,158,63,63,0,1,0
16,177,177,5,5,0,1,0
0,179,179,7,1,6,2,1
29,179,179,18,18,0,1,0
13,199,199,57,15,42,4,3
27,249,249,6,6,0,1,0
28,258,258,6,6,0,1,0
33,259,259,5,2,3,2,1
6,259,259,9,9,0,1,0
20,260,260,24,24,0,1,0
37,265,265,8,1,7,3,2
11,265,265,3,3,0,1,0
1,266,266,33,28,5,2,1
14,268,268,41,6,35,2,1
8,272,272,17,5,12,3,2
30,273,273,66,16,50,4,3
18,289,289,45,26,19,2,1
2,297,297,14,1,13,2,1
9,300,300,4,1,3,2,1
4,332,332,27,27,0,1,0
17,355,355,21,9,12,3,2
25,371,371,53,47,6,3,2
15,373,373,21,21,0,1,0
35,387,387,96,96,0,1,0
23,392,392,42,6,36,4,3
31,404,404,55,55,0,1,0
7,409,409,7,7,0,1,0
26,418,418,15,5,10,2,1
34,427,427,22,22,0,1,0
3,429,429,23,23,0,1,0
5,450,450,12,12,0,1,0
21,467,467,62,62,0,1,0
32,478,478,3,3,0,1,0
12,492,492,132,132,0,1,0
19,498,498,105,105,0,1,0

1,103,103,1,1,0,1,0
2,127,127,2,2,0,1,0
22,129,129,11,8,3,2,1
16,150,150,15,15,0,1,0
3,162,162,21,21,0,1,0
23,181,181,2,2,0,1,0
28,185,185,28,12,16,3,2
31,186,186,34,34,0,1,0
5,200,200,17,17,0,1,0
37,203,203,1,1,0,1,0
9,209,209,18,6,12,3,2
13,220,220,8,8,0,1,0
30,228,228,5,2,3,2,1
36,230,230,15,2,13,3,2
24,250,250,1,1,0,1,0
0,265,265,97,76,21,4,3
4,266,266,10,4,6,3,2
35,329,329,38,26,12,3,2
26,330,330,41,17,24,3,2
6,332,332,3,3,0,1,0
17,340,340,14,14,0,1,0
12,343,343,8,8,0,1,0
19,347,347,44,44,0,1,0
29,364,364,21,11,10,2,1
27,368,368,99,99,0,1,0
14,400,400,39,11,28,2,1
11,406,406,4,4,0,1,0
38,418,418,9,9,0,1,0
33,419,419,31,9,22,2,1
34,429,429,10,2,8,3,2
15,433,433,19,19,0,1,0
25,437,437,171,104,67,4,3
20,441,441,91,13,78,4,3
10,442,442,40,40,0,1,0
32,447,447,44,23,21,4,3
8,453,453,14,14,0,1,0
18,457,457,69,46,23,2,1
21,466,466,58,36,22,2,1
7,467,467,49,38,11,2,1

28,105,105,29,29,0,1,0
22,107,107,11,11,0,1,0
0,107,107,19,4,15,2,1
12,119,119,5,2,3,2,1
23,133,133,1,1,0,1,0
25,139,139,19,19,0,1,0
27,139,139,3,3,0,1,0
32,151,151,20,12,8,3,2
31,170,170,12,12,0,1,0
29,190,190,33,33,0,1,0
21,202,202,26,26,0,1,0
19,213,213,8,2,6,3,2
7,242,242,24,24,0,1,0
13,266,266,10,2,8,2,1
30,274,274,4,4,0,1,0
9,340,340,1,1,0,1,0
2,341,341,27,27,0,1,0
10,352,352,63,27,36,2,1
4,379,379,4,1,3,2,1
15,379,379,94,37,57,4,3
11,381,381,13,7,6,2,1
3,381,381,208,208,0,1,0
26,387,387,48,7,41,2,1
16,395,395,1,1,0,1,0
1,402,402,16,16,0,1,0
33,408,408,125,21,104,4,3
17,414,414,57,57,0,1,0
20,417,417,19,19,0,1,0
14,425,425,40,17,23,2,1
24,440,440,9,6,3,2,1
6,450,450,11,11,0,1,0
8,462,462,61,61,0,1,0
5,472,472,26,26,0,1,0
18,488,488,53,43,10,3,2

10,135,135,1,1,0,1,0
28,136,136,4,4,0,1,0
17,137,137,27,27,0,1,0
13,149,149,35,16,19,2,1
20,181,181,44,44,0,1,0
29,188,188,34,1,33,2,1
11,198,198,18,12,6,3,2
23,199,199,36,11,25,2,1
4,205,205,7,7,0,1,0
21,206,206,4,4,0,1,0
2,243,243,51,51,0,1,0
18,245,245,41,41,0,1,0
3,245,245,6,2,4,2,1
32,248,248,3,3,0,1,0
12,256,256,7,7,0,1,0
9,273,273,14,2,12,4,3
8,298,298,50,50,0,1,0
33,311,311,11,11,0,1,0
27,320,320,28,9,19,2,1
34,331,331,2,2,0,1,0
7,334,334,33,16,17,2,1
6,340,340,17,2,15,3,2
5,349,349,2,2,0,1,0
26,352,352,35,16,19,2,1
16,364,364,20,5,15,4,3
0,373,373,88,88,0,1,0
22,379,379,74,74,0,1,0
24,386,386,52,52,0,1,0
31,416,416,46,46,0,1,0
25,418,418,76,67,9,4,3
19,423,423,33,18,15,4,3
35,427,427,25,4,21,2,1
14,438,438,45,45,0,1,0
30,442,442,7,3,4,2,1
15,450,450,17,17,0,1,0
1,500,500,85,85,0,1,0

11,112,112,1,1,0,1,0
7,118,118,7,7,0,1,0
26,125,125,9,9,0,1,0
20,133,133,9,1,8,3,2
25,134,134,33,15,18,4,3
14,147,147,1,1,0,1,0
12,150,150,18,18,0,1,0
9,150,150,5,5,0,1,0
13,153,153,49,34,15,2,1
8,159,159,14,6,8,2,1
36,160,160,8,8,0,1,0
16,179,179,14,14,0,1,0
19,208,208,37,37,0,1,0
2,212,212,64,34,30,2,1
4,241,241,12,12,0,1,0
27,243,243,65,49,16,2,1
10,261,261,27,6,21,2,1
38,264,264,35,15,20,3,2
29,276,276,14,14,0,1,0
35,279,279,20,20,0,1,0
18,281,281,11,11,0,1,0
6,313,313,9,9,0,1,0
23,322,322,4,4,0,1,0
17,342,342,27,17,10,2,1
21,362,362,4,4,0,1,0
33,390,390,18,18,0,1,0
31,395,395,41,15,26,2,1
15,398,398,34,1,33,3,2
28,401,401,52,4,48,3,2
24,428,428,7,7,0,1,0
32,441,441,1,1,0,1,0
22,446,446,68,37,31,2,1
34,457,457,25,25,0,1,0
1,462,462,9,9,0,1,0
5,462,462,24,4,20,2,1
0,470,470,13,13,0,1,0
3,476,476,27,8,19,2,1
37,496,496,97,97,0,1,0
30,499,499,114,106,8,2,1

29,111,111,23,20,3,2,1
15,116,116,25,25,0,1,0
34,120,120,3,3,0,1,0
6,162,162,1,1,0,1,0
26,178,178,51,51,0,1,0
8,182,182,30,30,0,1,0
19,195,195,34,34,0,1,0
13,198,198,1,1,0,1,0
0,203,203,8,8,0,1,0
4,221,221,23,23,0,1,0
25,231,231,11,11,0,1,0
30,238,238,44,14,30,4,3
37,239,239,46,46,0,1,0
33,262,262,4,4,0,1,0
5,268,268,1,1,0,1,0
10,276,276,2,2,0,1,0
24,279,279,17,17,0,1,0
1,283,283,132,82,50,2,1
20,285,285,39,39,0,1,0
22,319,319,39,11,28,2,1
32,335,335,17,5,12,3,2
23,344,344,49,7,42,2,1
7,354,354,44,44,0,1,0
17,355,355,31,13,18,3,2
2,356,356,36,36,0,1,0
36,366,366,73,34,39,4,3
21,371,371,2,2,0,1,0
31,376,376,35,20,15,2,1
35,394,394,12,6,6,2,1
16,394,394,35,2,33,2,1
18,406,406,22,22,0,1,0
11,435,435,2,2,0,1,0
28,447,447,11,11,0,1,0
3,453,453,20,10,10,2,1
14,460,460,11,11,0,1,0
27,464,464,6,6,0,1,0
12,482,482,41,26,15,2,1
9,487,487,1,1,0,1,0

5,100,100,29,9,20,4,3
13,105,105,2,2,0,1,0
27,112,112,15,5,10,3,2
28,135,135,2,2,0,1,0
24,146,146,7,7,0,1,0
36,155,155,4,4,0,1,0
31,157,157,26,17,9,4,3
15,164,164,51,47,4,2,1
14,175,175,5,1,4,2,1
26,202,202,4,4,0,1,0
22,224,224,42,42,0,1,0
6,231,231,10,10,0,1,0
20,231,231,4,4,0,1,0
9,246,246,15,7,8,3,2
4,250,250,35,35,0,1,0
10,266,266,24,24,0,1,0
30,298,298,26,10,16,3,2
21,303,303,11,11,0,1,0
32,317,317,42,19,23,2,1
17,319,319,16,13,3,2,1
34,322,322,7,7,0,1,0
16,356,356,6,6,0,1,0
19,364,364,101,35,66,3,2
3,378,378,25,16,9,2,1
35,392,392,60,38,22,2,1
33,392,392,84,59,25,2,1
11,398,398,2,2,0,1,0
25,412,412,58,58,0,1,0
18,420,420,52,52,0,1,0
1,423,423,19,19,0,1,0
0,425,425,49,49,0,1,0
23,442,442,19,4,15,2,1
12,446,446,95,95,0,1,0
29,449,449,51,42,9,4,3
2,455,455,23,23,0,1,0
8,464,464,1,1,0,1,0
7,487,487,63,48,15,2,1

20,109,109,16,16,0,1,0
13,112,112,13,2,11,2,1
10,132,132,4,1,3,2,1
32,140,140,1,1,0,1,0
18,143,143,3,3,0,1,0
9,147,147,19,19,0,1,0
11,152,152,3,3,0,1,0
26,161,161,21,21,0,1,0
3,169,169,2,2,0,1,0
2,174,174,9,9,0,1,0
0,182,182,35,24,11,2,1
35,193,193,20,20,0,1,0
14,194,194,38,38,0,1,0
30,209,209,2,2,0,1,0
28,209,209,73,73,0,1,0
4,221,221,3,3,0,1,0
33,226,226,17,17,0,1,0
16,228,228,35,35,0,1,0
12,246,246,3,3,0,1,0
27,255,255,70,7,63,4,3
1,263,263,42,42,0,1,0
21,266,266,7,2,5,2,1
34,276,276,2,2,0,1,0
19,295,295,36,8,28,2,1
23,303,303,2,2,0,1,0
29,334,334,6,6,0,1,0
31,357,357,66,66,0,1,0
15,406,406,12,2,10,3,2
8,417,417,16,10,6,2,1
7,441,441,189,171,18,3,2
22,448,448,75,18,57,4,3
6,449,449,41,41,0,1,0
5,460,460,11,7,4,2,1
24,465,465,46,46,0,1,0
17,471,471,49,49,0,1,0
25,485,485,48,25,23,2,1

2,114,114,6,3,3,2,1
18,126,126,11,5,6,2,1
11,142,142,9,9,0,1,0
17,148,148,6,2,4,2,1
36,159,159,1,1,0,1,0
22,159,159,24,20,4,2,1
19,160,160,10,10,0,1,0
31,171,171,7,7,0,1,0
21,198,198,24,24,0,1,0
15,210,210,13,6,7,2,1
35,216,216,94,48,46,3,2
5,219,219,1,1,0,1,0
16,220,220,1,1,0,1,0
29,224,224,8,2,6,2,1
1,225,225,28,28,0,1,0
7,228,228,51,51,0,1,0
23,240,240,14,14,0,1,0
0,244,244,19,4,15,4,3
25,250,250,19,19,0,1,0
14,270,270,18,18,0,1,0
4,272,272,56,7,49,2,1
24,301,301,25,3,22,3,2
13,322,322,89,39,50,4,3
30,323,323,11,1,10,3,2
9,337,337,19,1,18,3,2
12,342,342,7,7,0,1,0
20,367,367,56,56,0,1,0
28,380,380,12,2,10,3,2
10,390,390,58,58,0,1,0
33,394,394,38,38,0,1,0
27,408,408,13,4,9,2,1
26,421,421,72,18,54,3,2
3,431,431,32,27,5,2,1
32,458,458,53,12,41,2,1
34,462,462,59,31,28,2,1
6,474,474,15,15,0,1,0
8,498,498,90,18,72,4,3

34,102,102,8,3,5,2,1
6,107,107,2,2,0,1,0
28,111,111,12,3,9,4,3
3,120,120,1,1,0,1,0
19,137,137,33,33,0,1,0
18,146,146,7,2,5,2,1
23,146,146,2,2,0,1,0
21,168,168,34,34,0,1,0
1,187,187,26,26,0,1,0
31,215,215,55,55,0,1,0
0,228,228,6,6,0,1,0
25,233,233,58,16,42,3,2
2,235,235,7,7,0,1,0
11,271,271,24,24,0,1,0
32,280,280,8,1,7,2,1
22,286,286,73,73,0,1,0
15,294,294,10,7,3,2,1
29,308,308,24,24,0,1,0
26,327,327,14,8,6,3,2
27,340,340,23,23,0,1,0
17,344,344,55,55,0,1,0
9,350,350,64,64,0,1,0
4,356,356,211,130,81,4,3
30,364,364,14,14,0,1,0
7,367,367,49,34,15,4,3
33,393,393,24,24,0,1,0
35,394,394,4,4,0,1,0
20,404,404,11,5,6,2,1
10,406,406,13,5,8,3,2
8,407,407,33,28,5,2,1
12,408,408,14,14,0,1,0
16,414,414,2,2,0,1,0
13,424,424,40,2,38,2,1
14,435,435,21,1,20,3,2
24,441,441,16,16,0,1,0
5,487,487,45,31,14,3,2

30,101,101,22,22,0,1,0
20,104,104,12,12,0,1,0
3,124,124,3,3,0,1,0
29,126,126,3,3,0,1,0
0,130,130,1,1,0,1,0
32,134,134,36,36,0,1,0
34,139,139,2,2,0,1,0
10,152,152,1,1,0,1,0
12,163,163,4,4,0,1,0
4,168,168,19,19,0,1,0
15,175,175,16,16,0,1,0
9,180,180,51,51,0,1,0
26,186,186,17,17,0,1,0
6,202,202,3,3,0,1,0
19,227,227,31,31,0,1,0
33,230,230,11,3,8,3,2
2,231,231,14,14,0,1,0
31,233,233,14,14,0,1,0
16,239,239,43,43,0,1,0
28,242,242,55,55,0,1,0
1,244,244,57,40,17,2,1
21,289,289,48,48,0,1,0
17,291,291,3,3,0,1,0
13,309,309,14,14,0,1,0
8,314,314,14,9,5,2,1
35,336,336,24,14,10,3,2
25,383,383,3,3,0,1,0
22,398,398,15,15,0,1,0
14,407,407,65,65,0,1,0
11,415,415,87,67,20,2,1
7,434,434,81,5,76,3,2
5,435,435,46,32,14,3,2
23,448,448,54,54,0,1,0
18,449,449,7,7,0,1,0
24,477,477,101,56,45,4,3
27,480,480,4,4,0,1,0

5,102,102,11,5,6,3,2
3,104,104,3,3,0,1,0
4,120,120,8,4,4,2,1
12,122,122,19,19,0,1,0
8,136,136,7,7,0,1,0
38,136,136,9,9,0,1,0
33,139,139,31,31,0,1,0
36,141,141,38,18,20,2,1
35,141,141,9,3,6,3,2
21,151,151,5,5,0,1,0
20,177,177,1,1,0,1,0
17,204,204,49,49,0,1,0
32,204,204,27,11,16,2,1
16,207,207,7,7,0,1,0
2,211,211,7,7,0,1,0
22,212,212,9,5,4,2,1
30,214,214,1,1,0,1,0
10,215,215,36,5,31,2,1
1,226,226,1,1,0,1,0
7,229,229,37,37,0,1,0
0,230,230,17,4,13,2,1
13,260,260,21,21,0,1,0
18,264,264,18,11,7,2,1
31,276,276,40,40,0,1,0
11,277,277,1,1,0,1,0
24,315,315,26,26,0,1,0
34,334,334,31,2,29,2,1
40,344,344,11,11,0,1,0
6,365,365,3,3,0,1,0
37,366,366,7,7,0,1,0
28,376,376,36,36,0,1,0
15,382,382,51,51,0,1,0
9,384,384,9,9,0,1,0
29,387,387,14,2,12,4,3
41,412,412,50,5,45,4,3
23,415,415,36,3,33,2,1
14,418,418,41,41,0,1,0
27,419,419,48,48,0,1,0
39,434,434,29,29,0,1,0
19,454,454,42,42,0,1,0
25,473,473,112,10,102,4,3
26,490,490,19,19,0,1,0

13,114,114,10,10,0,1,0
12,114,114,1,1,0,1,0
30,125,125,5,5,0,1,0
3,132,132,13,13,0,1,0
22,141,141,27,12,15,4,3
5,150,150,13,1,12,3,2
35,153,153,6,6,0,1,0
6,159,159,7,2,5,2,1
19,166,166,19,19,0,1,0
24,171,171,10,10,0,1,0
18,174,174,45,45,0,1,0
7,177,177,15,1,14,3,2
23,181,181,34,4,30,3,2
20,216,216,15,1,14,3,2
28,220,220,29,7,22,4,3
8,230,230,6,3,3,2,1
29,240,240,14,2,12,4,3
10,246,246,1,1,0,1,0
34,277,277,4,4,0,1,0
14,283,283,12,12,0,1,0
32,291,291,8,8,0,1,0
17,291,291,42,42,0,1,0
0,300,300,1,1,0,1,0
21,302,302,9,9,0,1,0
2,306,306,1,1,0,1,0
31,326,326,29,23,6,2,1
9,338,338,17,3,14,3,2
16,343,343,184,184,0,1,0
4,354,354,84,45,39,4,3
15,356,356,71,71,0,1,0
26,369,369,76,76,0,1,0
25,381,381,27,27,0,1,0
11,389,389,7,7,0,1,0
27,410,410,73,10,63,3,2
1,473,473,59,59,0,1,0
33,497,497,32,18,14,3,2

7,103,103,9,6,3,2,1
26,136,136,9,2,7,2,1
8,140,140,5,5,0,1,0
27,142,142,11,3,8,3,2
4,156,156,33,9,24,3,2
2,182,182,85,49,36,3,2
24,182,182,7,1,6,2,1
12,191,191,22,4,18,4,3
13,200,200,6,6,0,1,0
19,227,227,1,1,0,1,0
14,231,231,55,13,42,3,2
28,248,248,35,35,0,1,0
5,256,256,24,24,0,1,0
21,260,260,26,2,24,4,3
20,261,261,32,32,0,1,0
29,276,276,10,10,0,1,0
15,329,329,9,2,7,2,1
1,331,331,16,7,9,4,3
6,338,338,66,54,12,4,3
10,339,339,11,11,0,1,0
17,351,351,96,96,0,1,0
16,355,355,80,38,42,4,3
23,377,377,12,6,6,3,2
3,378,378,133,86,47,2,1
18,398,398,80,32,48,3,2
0,440,440,37,5,32,4,3
25,465,465,13,13,0,1,0
22,466,466,39,39,0,1,0
9,467,467,18,12,6,2,1
11,480,480,74,44,30,4,3

15,103,103,6,6,0,1,0
10,111,111,1,1,0,1,0
19,114,114,5,5,0,1,0
7,171,171,16,1,15,3,2
31,174,174,7,1,6,2,1
26,177,177,42,1,41,2,1
3,181,181,8,4,4,2,1
25,189,189,20,20,0,1,0
27,230,230,2,2,0,1,0
2,236,236,1,1,0,1,0
12,245,245,52,14,38,3,2
1,249,249,72,40,32,2,1
11,261,261,25,11,14,3,2
33,264,264,52,40,12,3,2
0,274,274,62,20,42,4,3
18,275,275,33,5,28,3,2
30,292,292,109,109,0,1,0
21,293,293,12,6,6,2,1
24,374,374,2,2,0,1,0
16,377,377,41,21,20,2,1
23,379,379,15,2,13,2,1
32,398,398,1,1,0,1,0
9,402,402,21,4,17,2,1
17,402,402,43,43,0,1,0
28,412,412,56,32,24,4,3
20,414,414,1,1,0,1,0
6,414,414,9,9,0,1,0
4,421,421,60,32,28,3,2
8,431,431,62,34,28,2,1
34,441,441,86,86,0,1,0
35,444,444,16,1,15,2,1
13,468,468,33,33,0,1,0
14,476,476,39,6,33,4,3
29,479,479,90,33,57,4,3
5,489,489,19,11,8,3,2
22,499,499,31,1,30,2,1

23,107,107,22,7,15,2,1
3,108,108,9,9,0,1,0
14,134,134,6,6,0,1,0
19,137,137,5,5,0,1,0
12,152,152,44,19,25,2,1
18,162,162,7,1,6,2,1
25,163,163,18,1,17,4,3
6,173,173,27,10,17,2,1
5,182,182,44,39,5,2,1
32,186,186,6,6,0,1,0
0,197,197,7,7,0,1,0
29,224,224,36,10,26,3,2
9,227,227,4,4,0,1,0
10,230,230,26,18,8,3,2
16,248,248,23,23,0,1,0
7,253,253,9,9,0,1,0
20,254,254,5,1,4,2,1
28,258,258,52,52,0,1,0
21,269,269,53,22,31,2,1
30,283,283,18,18,0,1,0
22,333,333,8,1,7,2,1
2,348,348,58,58,0,1,0
1,349,349,134,54,80,3,2
4,352,352,2,2,0,1,0
17,375,375,11,11,0,1,0
26,394,394,55,55,0,1,0
24,417,417,47,4,43,4,3
15,424,424,101,101,0,1,0
11,438,438,3,3,0,1,0
13,452,452,88,88,0,1,0
27,455,455,23,23,0,1,0
8,476,476,12,12,0,1,0
31,494,494,40,5,35,4,3

5,131,131,11,2,9,4,3
2,141,141,25,19,6,3,2
0,158,158,43,29,14,2,1
19,161,161,22,6,16,3,2
30,177,177,12,7,5,2,1
3,205,205,6,6,0,1,0
8,224,224,9,9,0,1,0
10,281,281,10,10,0,1,0
24,301,301,8,1,7,2,1
28,307,307,45,12,33,2,1
21,311,311,22,22,0,1,0
26,321,321,33,3,30,3,2
25,323,323,45,24,21,2,1
14,324,324,30,18,12,3,2
16,326,326,7,3,4,2,1
17,327,327,28,3,25,2,1
11,344,344,120,84,36,4,3
12,345,345,46,16,30,4,3
15,349,349,90,17,73,3,2
13,370,370,46,46,0,1,0
9,373,373,54,54,0,1,0
18,375,375,13,1,12,4,3
4,391,391,26,16,10,3,2
1,394,394,1,1,0,1,0
27,394,394,10,10,0,1,0
7,401,401,90,27,63,4,3
23,420,420,51,45,6,3,2
29,421,421,8,8,0,1,0
6,423,423,103,43,60,4,3
20,430,430,33,21,12,2,1
22,468,468,133,119,14,2,1

13,126,126,2,2,0,1,0
12,128,128,21,21,0,1,0
27,148,148,17,1,16,3,2
23,189,189,22,22,0,1,0
35,194,194,4,4,0,1,0
5,205,205,18,5,13,2,1
14,214,214,4,4,0,1,0
17,217,217,29,3,26,3,2
28,223,223,7,7,0,1,0
4,238,238,12,1,11,4,3
31,262,262,8,8,0,1,0
38,263,263,31,31,0,1,0
11,263,263,16,16,0,1,0
1,266,266,66,66,0,1,0
30,279,279,13,13,0,1,0
26,292,292,7,7,0,1,0
0,310,310,52,3,49,2,1
8,313,313,66,66,0,1,0
20,331,331,15,15,0,1,0
33,338,338,2,2,0,1,0
3,355,355,14,5,9,2,1
32,356,356,201,81,120,4,3
22,359,359,86,38,48,4,3
34,369,369,30,30,0,1,0
7,371,371,1,1,0,1,0
29,372,372,55,21,34,3,2
10,373,373,1,1,0,1,0
2,392,392,40,40,0,1,0
6,394,394,21,21,0,1,0
19,412,412,16,1,15,3,2
36,422,422,10,2,8,3,2
16,425,425,6,6,0,1,0
24,426,426,15,15,0,1,0
21,434,434,55,40,15,4,3
25,436,436,34,8,26,2,1
37,447,447,9,9,0,1,0
15,452,452,106,51,55,4,3
18,461,461,1,1,0,1,0
9,484,484,53,53,0,1,0

22,117,117,2,2,0,1,0
1,119,119,18,18,0,1,0
28,141,141,24,1,23,2,1
0,142,142,1,1,0,1,0
11,148,148,15,3,12,4,3
30,152,152,1,1,0,1,0
27,155,155,10,10,0,1,0
2,158,158,48,48,0,1,0
26,160,160,3,3,0,1,0
3,168,168,5,5,0,1,0
23,201,201,55,5,50,2,1
18,220,220,61,61,0,1,0
25,226,226,27,11,16,2,1
10,229,229,97,67,30,3,2
24,254,254,123,51,72,4,3
7,257,257,18,4,14,2,1
8,260,260,20,20,0,1,0
9,275,275,37,3,34,3,2
21,290,290,4,4,0,1,0
6,297,297,57,48,9,4,3
17,303,303,3,3,0,1,0
20,314,314,9,2,7,2,1
13,327,327,15,15,0,1,0
4,361,361,16,9,7,2,1
5,376,376,69,6,63,4,3
16,386,386,2,2,0,1,0
14,452,452,38,38,0,1,0
19,464,464,59,59,0,1,0
12,465,465,18,5,13,2,1
15,493,493,5,2,3,2,1
29,494,494,32,6,26,3,2
31,495,495,29,22,7,2,1

27,101,101,45,45,0,1,0
0,106,106,2,2,0,1,0
2,108,108,8,4,4,2,1
18,132,132,3,3,0,1,0
35,138,138,5,1,4,2,1
12,158,158,1,1,0,1,0
29,165,165,20,20,0,1,0
31,173,173,5,5,0,1,0
8,187,187,12,6,6,3,2
9,199,199,105,59,46,2,1
26,201,201,34,34,0,1,0
5,204,204,15,15,0,1,0
4,221,221,4,4,0,1,0
39,225,225,2,2,0,1,0
14,229,229,4,1,3,2,1
23,232,232,13,3,10,3,2
6,239,239,21,21,0,1,0
32,244,244,9,9,0,1,0
25,264,264,16,3,13,2,1
43,271,271,7,7,0,1,0
19,278,278,1,1,0,1,0
36,293,293,31,21,10,3,2
21,302,302,55,55,0,1,0
13,310,310,10,10,0,1,0
28,314,314,43,27,16,2,1
1,315,315,30,1,29,2,1
34,330,330,11,11,0,1,0
41,330,330,46,46,0,1,0
30,332,332,2,2,0,1,0
33,335,335,26,10,16,2,1
37,346,346,18,10,8,2,1
11,351,351,12,3,9,2,1
15,365,365,6,6,0,1,0
20,402,402,7,7,0,1,0
3,404,404,28,1,27,3,2
10,409,409,16,16,0,1,0
40,412,412,145,100,45,4,3
16,437,437,31,31,0,1,0
7,445,445,10,3,7,2,1
38,451,451,14,14,0,1,0
24,466,466,60,40,20,3,2
17,473,473,16,16,0,1,0
22,474,474,14,14,0,1,0
42,491,491,17,17,0,1,0

28,104,104,17,10,7,2,1
32,108,108,33,4,29,2,1
12,147,147,24,18,6,3,2
22,159,159,21,3,18,2,1
31,161,161,19,2,17,4,3
38,184,184,5,5,0,1,0
25,185,185,10,10,0,1,0
27,197,197,33,22,11,2,1
19,198,198,63,28,35,4,3
33,205,205,11,5,6,2,1
18,231,231,26,5,21,4,3
2,233,233,1,1,0,1,0
5,249,249,13,4,9,2,1
11,257,257,67,67,0,1,0
30,260,260,20,4,16,3,2
6,278,278,20,20,0,1,0
26,279,279,20,20,0,1,0
24,280,280,27,27,0,1,0
13,282,282,21,21,0,1,0
16,297,297,9,9,0,1,0
15,308,308,1,1,0,1,0
35,334,334,42,42,0,1,0
7,335,335,23,1,22,4,3
17,336,336,8,1,7,2,1
39,340,340,13,5,8,2,1
1,351,351,26,14,12,4,3
4,376,376,9,4,5,2,1
9,377,377,42,17,25,4,3
36,423,423,103,85,18,2,1
20,428,428,1,1,0,1,0
0,444,444,9,9,0,1,0
23,452,452,44,12,32,3,2
34,455,455,13,1,12,3,2
29,456,456,11,11,0,1,0
8,463,463,30,30,0,1,0
10,464,464,21,7,14,2,1
37,469,469,6,6,0,1,0
3,480,480,98,48,50,4,3
14,485,485,18,3,15,2,1
21,496,496,17,17,0,1,0

39,127,127,34,34,0,1,0
30,133,133,6,2,4,2,1
1,137,137,1,1,0,1,0
38,142,142,13,13,0,1,0
10,143,143,6,6,0,1,0
33,146,146,5,1,4,2,1
14,181,181,1,1,0,1,0
37,212,212,12,12,0,1,0
29,217,217,4,4,0,1,0
32,255,255,34,34,0,1,0
36,279,279,33,33,0,1,0
22,285,285,127,127,0,1,0
9,289,289,18,8,10,2,1
34,299,299,28,28,0,1,0
4,304,304,15,15,0,1,0
13,307,307,72,72,0,1,0
18,311,311,88,16,72,4,3
16,312,312,1,1,0,1,0
24,319,319,30,1,29,2,1
27,321,321,25,5,20,4,3
2,322,322,28,12,16,3,2
0,332,332,71,11,60,4,3
23,344,344,25,25,0,1,0
3,391,391,62,8,54,3,2
12,400,400,23,23,0,1,0
35,402,402,41,24,17,2,1
26,404,404,4,4,0,1,0
8,409,409,98,98,0,1,0
25,415,415,4,4,0,1,0
15,417,417,24,24,0,1,0
31,417,417,51,37,14,2,1
6,425,425,8,2,6,2,1
21,445,445,15,3,12,3,2
5,450,450,34,22,12,2,1
20,452,452,12,5,7,2,1
7,452,452,46,21,25,2,1
11,464,464,12,9,3,2,1
19,477,477,5,5,0,1,0
17,477,477,3,3,0,1,0
28,478,478,23,23,0,1,0

9,102,102,17,17,0,1,0
34,108,108,6,6,0,1,0
8,115,115,19,19,0,1,0
0,143,143,6,6,0,1,0
25,163,163,12,6,6,2,1
16,169,169,8,8,0,1,0
10,178,178,7,7,0,1,0
39,178,178,17,3,14,3,2
21,186,186,2,2,0,1,0
30,187,187,9,1,8,2,1
7,189,189,16,3,13,2,1
24,194,194,27,27,0,1,0
19,197,197,18,18,0,1,0
32,203,203,13,13,0,1,0
28,219,219,33,4,29,2,1
13,223,223,3,3,0,1,0
37,234,234,42,26,16,3,2
6,236,236,42,42,0,1,0
15,244,244,22,22,0,1,0
17,246,246,31,31,0,1,0
33,280,280,10,10,0,1,0
12,281,281,1,1,0,1,0
38,287,287,47,7,40,2,1
26,288,288,77,41,36,3,2
1,308,308,27,27,0,1,0
36,311,311,22,3,19,2,1
23,331,331,51,1,50,3,2
40,339,339,13,2,11,2,1
35,351,351,4,4,0,1,0
5,362,362,14,3,11,2,1
14,365,365,67,47,20,2,1
22,378,378,9,9,0,1,0
20,388,388,21,5,16,3,2
4,443,443,62,62,0,1,0
18,443,443,30,3,27,2,1
11,446,446,8,3,5,2,1
27,449,449,27,11,16,3,2
3,467,467,38,38,0,1,0
2,484,484,23,23,0,1,0
29,489,489,26,4,22,3,2
31,497,497,89,67,22,2,1

14,101,101,7,7,0,1,0
16,107,107,1,1,0,1,0
9,134,134,4,4,0,1,0
21,160,160,9,9,0,1,0
28,167,167,12,12,0,1,0
22,185,185,9,1,8,3,2
6,188,188,11,2,9,4,3
4,196,196,32,32,0,1,0
37,217,217,24,24,0,1,0
17,237,237,24,24,0,1,0
27,239,239,6,2,4,2,1
36,243,243,31,10,21,4,3
26,250,250,24,6,18,3,2
0,255,255,7,2,5,2,1
23,262,262,59,13,46,3,2
19,279,279,20,20,0,1,0
18,294,294,11,7,4,2,1
34,300,300,33,3,30,4,3
7,318,318,22,14,8,2,1
32,324,324,27,13,14,2,1
15,329,329,20,12,8,3,2
29,354,354,28,28,0,1,0
5,355,355,7,7,0,1,0
20,383,383,43,14,29,2,1
31,400,400,13,13,0,1,0
3,401,401,21,1,20,3,2
12,426,426,28,19,9,2,1
11,431,431,23,5,18,4,3
33,436,436,88,37,51,4,3
2,439,439,14,8,6,3,2
35,451,451,42,42,0,1,0
13,452,452,122,89,33,4,3
8,458,458,59,47,12,2,1
10,466,466,22,1,21,3,2
30,467,467,19,19,0,1,0
25,476,476,18,5,13,2,1
1,493,493,214,175,39,2,1
24,496,496,141,96,45,4,3

2,104,104,4,1,3,2,1
30,108,108,28,28,0,1,0
21,110,110,24,24,0,1,0
11,119,119,5,5,0,1,0
26,122,122,7,7,0,1,0
7,144,144,18,18,0,1,0
32,151,151,6,6,0,1,0
38,159,159,3,3,0,1,0
39,165,165,28,28,0,1,0
10,209,209,10,10,0,1,0
36,210,210,5,5,0,1,0
12,212,212,19,19,0,1,0
17,220,220,9,5,4,2,1
14,243,243,33,33,0,1,0
31,263,263,24,24,0,1,0
23,272,272,5,5,0,1,0
20,287,287,28,28,0,1,0
18,301,301,1,1,0,1,0
33,309,309,38,24,14,2,1
22,347,347,86,44,42,2,1
5,348,348,9,4,5,2,1
8,348,348,22,10,12,2,1
29,349,349,101,15,86,3,2
35,352,352,35,6,29,2,1
9,361,361,7,7,0,1,0
16,377,377,1,1,0,1,0
25,388,388,16,1,15,2,1
28,388,388,12,12,0,1,0
15,399,399,67,49,18,2,1
37,401,401,17,17,0,1,0
3,412,412,66,40,26,3,2
1,416,416,26,26,0,1,0
19,421,421,18,8,10,2,1
4,433,433,3,3,0,1,0
34,435,435,38,5,33,4,3
40,436,436,154,10,144,4,3
6,439,439,4,1,3,2,1
0,454,454,29,29,0,1,0
24,488,488,23,23,0,1,0
13,492,492,44,14,30,3,2
27,497,497,23,23,0,1,0

11,134,134,10,10,0,1,0
10,142,142,7,7,0,1,0
22,146,146,9,9,0,1,0
20,151,151,19,7,12,2,1
27,163,163,3,3,0,1,0
26,166,166,18,6,12,3,2
3,198,198,8,8,0,1,0
1,229,229,29,29,0,1,0
4,242,242,13,8,5,2,1
2,249,249,245,218,27,4,3
5,259,259,82,51,31,2,1
14,272,272,59,40,19,3,2
0,289,289,8,8,0,1,0
24,290,290,20,8,12,3,2
16,306,306,5,5,0,1,0
19,317,317,23,11,12,3,2
6,340,340,14,14,0,1,0
15,346,346,19,1,18,3,2
9,353,353,49,49,0,1,0
7,358,358,24,12,12,2,1
18,383,383,10,2,8,3,2
17,403,403,79,29,50,4,3
12,409,409,24,24,0,1,0
8,463,463,2,2,0,1,0
25,471,471,78,65,13,2,1
21,480,480,138,138,0,1,0
23,496,496,1,1,0,1,0
13,500,500,117,42,75,4,3

26,131,131,2,2,0,1,0
32,146,146,19,19,0,1,0
17,153,153,16,16,0,1,0
21,167,167,30,30,0,1,0
14,193,193,1,1,0,1,0
29,196,196,2,2,0,1,0
11,206,206,3,3,0,1,0
10,208,208,13,13,0,1,0
27,210,210,8,8,0,1,0
30,227,227,15,15,0,1,0
5,249,249,8,8,0,1,0
15,254,254,17,1,16,2,1
24,260,260,48,42,6,2,1
22,262,262,33,33,0,1,0
33,266,266,8,8,0,1,0
20,269,269,1,1,0,1,0
2,272,272,37,34,3,2,1
9,272,272,35,6,29,2,1
28,297,297,39,39,0,1,0
19,299,299,4,4,0,1,0
3,306,306,91,91,0,1,0
8,317,317,1,1,0,1,0
25,354,354,31,21,10,2,1
16,354,354,83,83,0,1,0
4,363,363,23,19,4,2,1
13,377,377,20,12,8,3,2
7,385,385,205,205,0,1,0
6,395,395,37,10,27,4,3
31,412,412,132,81,51,3,2
0,421,421,10,6,4,2,1
1,496,496,121,87,34,3,2
23,497,497,9,9,0,1,0
18,498,498,73,73,0,1,0
12,499,499,22,22,0,1,0

28,108,108,5,5,0,1,0
9,117,117,15,10,5,2,1
8,118,118,1,1,0,1,0
11,124,124,19,1,18,2,1
30,124,124,20,2,18,2,1
17,136,136,10,10,0,1,0
31,139,139,15,6,9,2,1
32,150,150,26,16,10,3,2
25,150,150,16,12,4,2,1
7,154,154,18,3,15,4,3
33,166,166,26,5,21,4,3
4,166,166,7,7,0,1,0
16,198,198,27,27,0,1,0
21,220,220,3,3,0,1,0
3,230,230,16,16,0,1,0
14,245,245,3,3,0,1,0
22,259,259,6,1,5,2,1
18,299,299,34,1,33,3,2
5,312,312,63,11,52,3,2
6,343,343,19,19,0,1,0
24,352,352,112,112,0,1,0
27,362,362,45,31,14,3,2
10,367,367,59,52,7,2,1
29,389,389,24,16,8,3,2
13,396,396,147,140,7,2,1
12,397,397,69,69,0,1,0
20,417,417,28,14,14,3,2
15,436,436,82,77,5,2,1
23,437,437,61,22,39,2,1
2,454,454,34,34,0,1,0
19,465,465,1,1,0,1,0
26,479,479,7,7,0,1,0
1,486,486,14,14,0,1,0
0,487,487,7,2,5,2,1

6,105,105,3,3,0,1,0
34,123,123,8,8,0,1,0
25,123,123,16,16,0,1,0
27,124,124,2,2,0,1,0
24,151,151,33,33,0,1,0
15,157,157,6,6,0,1,0
32,166,166,6,3,3,2,1
19,202,202,26,26,0,1,0
2,205,205,3,3,0,1,0
5,247,247,9,9,0,1,0
31,250,250,9,9,0,1,0
36,260,260,54,54,0,1,0
28,269,269,7,7,0,1,0
12,280,280,8,8,0,1,0
29,286,286,21,5,16,2,1
26,297,297,11,3,8,3,2
11,304,304,26,26,0,1,0
4,320,320,18,6,12,3,2
14,336,336,5,5,0,1,0
33,348,348,36,36,0,1,0
22,358,358,4,4,0,1,0
13,364,364,20,15,5,2,1
7,365,365,208,164,44,2,1
30,373,373,112,46,66,3,2
16,374,374,12,12,0,1,0
20,374,374,25,7,18,3,2
17,402,402,24,14,10,2,1
18,406,406,48,48,0,1,0
8,410,410,14,3,11,2,1
10,414,414,25,5,20,3,2
23,436,436,10,10,0,1,0
0,460,460,46,7,39,4,3
21,465,465,114,114,0,1,0
9,475,475,88,4,84,3,2
35,479,479,52,52,0,1,0
3,484,484,85,85,0,1,0
1,494,494,53,53,0,1,0

29,106,106,32,32,0,1,0
11,111,111,11,11,0,1,0
28,128,128,3,3,0,1,0
0,134,134,12,3,9,2,1
14,175,175,37,1,36,4,3
32,201,201,12,12,0,1,0
16,209,209,19,11,8,3,2
15,223,223,12,1,11,4,3
4,233,233,10,10,0,1,0
20,235,235,7,2,5,2,1
26,244,244,42,12,30,3,2
5,257,257,12,12,0,1,0
23,259,259,24,9,15,4,3
30,269,269,6,6,0,1,0
9,274,274,71,71,0,1,0
21,275,275,51,51,0,1,0
7,280,280,21,5,16,3,2
25,285,285,5,5,0,1,0
6,308,308,8,3,5,2,1
35,347,347,34,34,0,1,0
31,371,371,19,19,0,1,0
3,380,380,7,7,0,1,0
8,384,384,81,51,30,4,3
1,384,384,47,34,13,2,1
24,387,387,6,6,0,1,0
33,389,389,19,19,0,1,0
2,391,391,4,4,0,1,0
18,409,409,122,11,111,4,3
34,416,416,10,5,5,2,1
27,419,419,30,2,28,2,1
17,430,430,36,36,0,1,0
10,453,453,1,1,0,1,0
13,455,455,103,103,0,1,0
12,460,460,61,28,33,4,3
19,469,469,64,4,60,3,2
22,469,469,87,87,0,1,0

23,101,101,6,6,0,1,0
16,105,105,4,4,0,1,0
26,115,115,12,12,0,1,0
29,118,118,12,12,0,1,0
1,124,124,7,7,0,1,0
8,130,130,15,4,11,2,1
19,135,135,1,1,0,1,0
39,159,159,11,11,0,1,0
21,161,161,6,6,0,1,0
4,166,166,3,3,0,1,0
10,178,178,8,8,0,1,0
24,198,198,5,5,0,1,0
5,219,219,17,17,0,1,0
20,221,221,4,1,3,2,1
11,221,221,47,41,6,3,2
18,222,222,57,20,37,3,2
9,223,223,13,13,0,1,0
25,224,224,20,20,0,1,0
27,228,228,28,16,12,3,2
36,249,249,19,19,0,1,0
12,284,284,42,42,0,1,0
14,291,291,5,2,3,2,1
32,312,312,59,59,0,1,0
3,315,315,38,8,30,4,3
7,321,321,12,12,0,1,0
17,335,335,1,1,0,1,0
2,346,346,14,14,0,1,0
31,350,350,54,34,20,3,2
38,354,354,61,31,30,3,2
34,364,364,50,50,0,1,0
37,372,372,27,27,0,1,0
35,373,373,8,2,6,2,1
30,387,387,3,3,0,1,0
28,388,388,96,34,62,3,2
15,413,413,53,53,0,1,0
13,436,436,7,3,4,2,1
0,437,437,65,40,25,2,1
22,440,440,44,44,0,1,0
33,470,470,39,39,0,1,0
6,481,481,98,98,0,1,0

15,105,105,1,1,0,1,0
19,112,112,6,6,0,1,0
20,124,124,16,4,12,2,1
39,143,143,3,3,0,1,0
37,146,146,8,4,4,2,1
44,155,155,13,2,11,2,1
35,156,156,4,4,0,1,0
26,159,159,2,2,0,1,0
27,189,189,4,1,3,2,1
30,195,195,21,21,0,1,0
29,216,216,13,2,11,2,1
23,231,231,17,8,9,2,1
18,232,232,19,19,0,1,0
0,233,233,25,25,0,1,0
43,235,235,6,6,0,1,0
14,237,237,21,3,18,3,2
2,238,238,23,3,20,2,1
1,242,242,15,1,14,2,1
32,250,250,9,3,6,2,1
42,252,252,27,27,0,1,0
11,255,255,85,21,64,3,2
3,272,272,8,8,0,1,0
4,282,282,5,5,0,1,0
38,292,292,48,48,0,1,0
9,298,298,8,8,0,1,0
12,313,313,19,10,9,2,1
13,327,327,9,4,5,2,1
45,347,347,119,103,16,2,1
36,357,357,12,2,10,2,1
21,360,360,26,17,9,2,1
8,375,375,1,1,0,1,0
28,375,375,27,5,22,2,1
25,379,379,24,24,0,1,0
40,385,385,16,12,4,2,1
24,390,390,15,15,0,1,0
17,407,407,52,52,0,1,0
7,440,440,22,22,0,1,0
31,447,447,23,23,0,1,0
5,449,449,8,8,0,1,0
10,451,451,24,24,0,1,0
22,454,454,32,23,9,4,3
16,457,457,17,17,0,1,0
6,471,471,17,5,12,2,1
34,477,477,82,61,21,2,1
41,489,489,15,15,0,1,0
33,499,499,203,156,47,4,3

17,107,107,1,1,0,1,0
1,117,117,5,5,0,1,0
34,135,135,6,6,0,1,0
15,137,137,4,4,0,1,0
18,140,140,1,1,0,1,0
36,142,142,52,43,9,2,1
27,144,144,11,5,6,2,1
32,144,144,5,5,0,1,0
20,170,170,1,1,0,1,0
7,188,188,39,39,0,1,0
10,193,193,3,3,0,1,0
12,211,211,44,44,0,1,0
30,215,215,27,27,0,1,0
16,232,232,26,6,20,2,1
3,236,236,90,90,0,1,0
41,236,236,49,49,0,1,0
43,255,255,24,24,0,1,0
11,256,256,12,8,4,2,1
39,266,266,46,15,31,2,1
23,274,274,3,3,0,1,0
44,275,275,14,14,0,1,0
21,286,286,27,27,0,1,0
37,297,297,8,8,0,1,0
31,298,298,28,1,27,4,3
25,308,308,15,5,10,2,1
40,325,325,35,35,0,1,0
33,326,326,5,5,0,1,0
29,331,331,4,4,0,1,0
22,344,344,5,5,0,1,0
26,345,345,27,3,24,3,2
9,350,350,5,5,0,1,0
19,374,374,10,10,0,1,0
35,383,383,78,6,72,4,3
5,407,407,59,45,14,2,1
0,415,415,3,3,0,1,0
45,415,415,29,14,15,4,3
14,425,425,45,13,32,3,2
6,436,436,26,2,24,4,3
42,438,438,12,12,0,1,0
24,463,463,1,1,0,1,0
8,474,474,6,6,0,1,0
38,475,475,2,2,0,1,0
2,476,476,7,7,0,1,0
13,479,479,8,8,0,1,0
4,487,487,6,6,0,1,0
28,498,498,91,68,23,2,1

23,113,113,4,4,0,1,0
2,116,116,3,3,0,1,0
32,121,121,12,12,0,1,0
28,134,134,2,2,0,1,0
0,150,150,12,12,0,1,0
25,157,157,14,14,0,1,0
8,179,179,75,57,18,4,3
30,187,187,11,11,0,1,0
31,193,193,19,1,18,2,1
24,207,207,77,77,0,1,0
6,212,212,2,2,0,1,0
14,214,214,22,22,0,1,0
10,222,222,41,29,12,4,3
20,245,245,4,4,0,1,0
11,258,258,6,6,0,1,0
29,268,268,12,12,0,1,0
9,270,270,21,21,0,1,0
19,277,277,17,8,9,4,3
27,283,283,4,1,3,2,1
22,286,286,30,30,0,1,0
15,306,306,113,76,37,2,1
5,333,333,28,28,0,1,0
12,365,365,3,3,0,1,0
3,403,403,165,165,0,1,0
18,404,404,9,1,8,3,2
7,409,409,46,32,14,2,1
4,436,436,16,8,8,3,2
13,436,436,31,17,14,2,1
21,442,442,17,2,15,3,2
17,453,453,4,4,0,1,0
16,473,473,21,5,16,2,1
26,486,486,173,173,0,1,0
1,490,490,78,78,0,1,0

4,100,100,19,19,0,1,0
8,111,111,19,19,0,1,0
29,111,111,38,38,0,1,0
35,116,116,13,1,12,2,1
2,129,129,16,6,10,3,2
33,141,141,17,9,8,2,1
34,143,143,4,4,0,1,0
0,145,145,33,21,12,4,3
24,170,170,20,12,8,3,2
26,172,172,23,23,0,1,0
32,176,176,1,1,0,1,0
18,198,198,13,13,0,1,0
19,198,198,16,16,0,1,0
21,203,203,23,12,11,2,1
20,228,228,57,57,0,1,0
36,230,230,47,23,24,2,1
12,247,247,5,5,0,1,0
11,247,247,1,1,0,1,0
25,250,250,13,2,11,2,1
9,254,254,33,33,0,1,0
13,255,255,91,91,0,1,0
28,290,290,14,14,0,1,0
7,322,322,31,31,0,1,0
5,333,333,14,14,0,1,0
27,335,335,2,2,0,1,0
6,364,364,10,4,6,2,1
30,374,374,55,13,42,3,2
22,383,383,18,18,0,1,0
10,390,390,1,1,0,1,0
31,416,416,9,9,0,1,0
16,426,426,8,8,0,1,0
15,427,427,11,11,0,1,0
17,439,439,12,4,8,3,2
14,463,463,35,17,18,2,1
3,483,483,75,59,16,3,2
23,489,489,7,7,0,1,0
1,498,498,20,20,0,1,0

8,108,108,1,1,0,1,0
27,112,112,34,15,19,3,2
31,127,127,9,9,0,1,0
5,131,131,2,2,0,1,0
0,153,153,9,9,0,1,0
4,161,161,34,20,14,2,1
18,170,170,14,4,10,2,1
17,175,175,42,24,18,2,1
16,185,185,15,15,0,1,0
24,203,203,4,4,0,1,0
30,208,208,3,3,0,1,0
13,216,216,20,20,0,1,0
12,221,221,25,1,24,3,2
25,223,223,1,1,0,1,0
1,232,232,29,8,21,4,3
26,234,234,3,3,0,1,0
23,277,277,30,16,14,2,1
28,278,278,42,9,33,4,3
6,304,304,13,2,11,3,2
9,307,307,119,47,72,4,3
33,308,308,43,43,0,1,0
29,319,319,28,16,12,3,2
20,320,320,17,17,0,1,0
2,333,333,9,1,8,3,2
34,344,344,70,70,0,1,0
19,366,366,57,18,39,2,1
7,381,381,3,3,0,1,0
14,394,394,10,10,0,1,0
22,419,419,40,40,0,1,0
35,428,428,74,50,24,3,2
21,436,436,3,3,0,1,0
3,452,452,13,9,4,2,1
11,482,482,6,6,0,1,0
15,489,489,35,35,0,1,0
10,489,489,124,124,0,1,0
32,495,495,76,76,0,1,0

20,123,123,9,9,0,1,0
24,123,123,16,16,0,1,0
5,125,125,47,47,0,1,0
18,129,129,13,13,0,1,0
17,133,133,2,2,0,1,0
8,134,134,3,3,0,1,0
0,141,141,4,4,0,1,0
26,154,154,25,25,0,1,0
28,161,161,28,12,16,2,1
11,170,170,12,12,0,1,0
9,172,172,2,2,0,1,0
25,222,222,8,2,6,2,1
7,232,232,36,19,17,2,1
21,235,235,5,5,0,1,0
3,243,243,19,19,0,1,0
31,248,248,26,26,0,1,0
23,249,249,22,22,0,1,0
14,251,251,9,9,0,1,0
22,257,257,18,18,0,1,0
1,267,267,33,33,0,1,0
27,283,283,21,5,16,3,2
6,319,319,30,6,24,4,3
10,340,340,67,61,6,2,1
29,360,360,23,23,0,1,0
32,360,360,40,19,21,2,1
19,360,360,91,74,17,2,1
15,375,375,31,31,0,1,0
4,378,378,51,15,36,3,2
2,396,396,2,2,0,1,0
16,469,469,84,42,42,2,1
30,477,477,49,8,41,4,3
12,485,485,125,14,111,4,3
13,488,488,103,103,0,1,0

14,109,109,15,7,8,3,2
22,111,111,37,37,0,1,0
27,113,113,1,1,0,1,0
18,133,133,17,6,11,2,1
10,133,133,4,4,0,1,0
23,139,139,18,13,5,2,1
17,142,142,13,13,0,1,0
21,146,146,9,9,0,1,0
34,170,170,7,4,3,2,1
13,187,187,5,5,0,1,0
36,189,189,13,13,0,1,0
20,214,214,28,5,23,4,3
11,232,232,28,28,0,1,0
12,239,239,51,5,46,3,2
4,245,245,1,1,0,1,0
29,247,247,45,10,35,2,1
24,255,255,15,3,12,3,2
1,272,272,77,77,0,1,0
2,273,273,34,34,0,1,0
28,276,276,4,1,3,2,1
35,291,291,11,11,0,1,0
7,300,300,12,5,7,2,1
9,312,312,55,55,0,1,0
8,315,315,12,12,0,1,0
0,315,315,48,30,18,4,3
30,327,327,45,34,11,2,1
31,342,342,13,13,0,1,0
26,348,348,4,4,0,1,0
16,367,367,3,3,0,1,0
19,391,391,22,22,0,1,0
3,393,393,25,25,0,1,0
32,411,411,122,34,88,4,3
6,418,418,11,11,0,1,0
33,424,424,11,3,8,3,2
5,453,453,4,1,3,2,1
15,458,458,60,60,0,1,0
25,498,498,105,105,0,1,0

4,100,100,1,1,0,1,0
13,102,102,7,3,4,2,1
10,134,134,3,3,0,1,0
23,137,137,2,2,0,1,0
32,155,155,5,1,4,2,1
34,169,169,7,7,0,1,0
2,171,171,12,6,6,2,1
22,180,180,37,13,24,3,2
27,185,185,36,36,0,1,0
0,192,192,10,6,4,2,1
26,203,203,9,9,0,1,0
18,209,209,36,16,20,3,2
17,224,224,17,17,0,1,0
9,233,233,58,19,39,2,1
25,251,251,5,5,0,1,0
3,253,253,8,2,6,2,1
8,266,266,43,43,0,1,0
15,289,289,1,1,0,1,0
14,304,304,40,12,28,2,1
20,312,312,9,9,0,1,0
7,329,329,23,23,0,1,0
21,347,347,18,18,0,1,0
16,348,348,39,39,0,1,0
5,353,353,8,8,0,1,0
12,360,360,21,21,0,1,0
1,360,360,13,2,11,2,1
33,368,368,41,41,0,1,0
24,384,384,10,2,8,2,1
30,388,388,47,47,0,1,0
19,404,404,24,12,12,4,3
29,417,417,56,44,12,2,1
31,446,446,52,52,0,1,0
6,468,468,195,151,44,4,3
28,480,480,187,162,25,2,1
11,499,499,142,142,0,1,0

15,101,101,1,1,0,1,0
30,106,106,1,1,0,1,0
17,112,112,11,7,4,2,1
32,117,117,20,20,0,1,0
34,144,144,3,3,0,1,0
38,168,168,22,22,0,1,0
22,170,170,18,18,0,1,0
3,173,173,35,9,26,2,1
1,179,179,25,4,21,4,3
11,181,181,1,1,0,1,0
5,183,183,15,15,0,1,0
31,200,200,25,25,0,1,0
26,203,203,47,47,0,1,0
6,204,204,16,16,0,1,0
12,209,209,13,13,0,1,0
19,214,214,4,4,0,1,0
16,238,238,2,2,0,1,0
0,250,250,4,4,0,1,0
14,257,257,26,26,0,1,0
23,279,279,26,14,12,3,2
24,291,291,10,3,7,2,1
29,293,293,22,10,12,2,1
40,303,303,30,1,29,2,1
2,304,304,9,9,0,1,0
9,311,311,1,1,0,1,0
18,313,313,12,12,0,1,0
10,326,326,20,20,0,1,0
33,367,367,18,6,12,4,3
21,370,370,22,11,11,4,3
13,383,383,22,22,0,1,0
36,391,391,8,8,0,1,0
41,398,398,50,9,41,2,1
35,402,402,12,7,5,2,1
7,426,426,25,1,24,4,3
20,433,433,19,19,0,1,0
25,443,443,30,30,0,1,0
37,455,455,85,64,21,4,3
39,457,457,95,61,34,3,2
8,463,463,179,100,79,3,2
27,467,467,113,44,69,4,3
4,487,487,20,20,0,1,0
28,491,491,6,1,5,2,1

3,115,115,15,6,9,4,3
13,122,122,2,2,0,1,0
25,132,132,1,1,0,1,0
6,135,135,18,6,12,2,1
34,147,147,6,6,0,1,0
29,150,150,8,8,0,1,0
22,153,153,6,3,3,2,1
7,170,170,2,2,0,1,0
4,178,178,6,6,0,1,0
30,189,189,29,6,23,2,1
32,195,195,2,2,0,1,0
28,196,196,72,23,49,4,3
23,200,200,53,39,14,3,2
15,214,214,40,40,0,1,0
18,223,223,18,2,16,3,2
14,226,226,2,2,0,1,0
9,226,226,46,46,0,1,0
10,227,227,15,5,10,3,2
24,231,231,37,37,0,1,0
19,250,250,1,1,0,1,0
20,265,265,3,3,0,1,0
31,296,296,67,34,33,4,3
36,335,335,9,1,8,2,1
16,346,346,45,45,0,1,0
21,349,349,30,21,9,4,3
27,366,366,23,2,21,4,3
1,366,366,9,9,0,1,0
12,387,387,72,30,42,4,3
26,393,393,2,2,0,1,0
33,415,415,102,87,15,4,3
5,433,433,38,38,0,1,0
0,434,434,57,15,42,4,3
17,439,439,1,1,0,1,0
2,441,441,9,2,7,2,1
8,461,461,46,46,0,1,0
35,491,491,37,10,27,4,3
11,497,497,123,123,0,1,0

29,106,106,2,2,0,1,0
23,112,112,12,12,0,1,0
5,138,138,9,4,5,2,1
32,153,153,5,5,0,1,0
8,155,155,1,1,0,1,0
2,158,158,15,15,0,1,0
15,173,173,60,14,46,2,1
11,177,177,1,1,0,1,0
12,178,178,13,13,0,1,0
30,205,205,25,13,12,2,1
14,205,205,17,8,9,2,1
1,208,208,49,5,44,2,1
7,209,209,86,77,9,4,3
27,213,213,3,3,0,1,0
26,214,214,20,20,0,1,0
13,219,219,11,11,0,1,0
10,228,228,22,22,0,1,0
21,232,232,14,2,12,3,2
17,250,250,11,11,0,1,0
31,278,278,6,6,0,1,0
9,283,283,12,12,0,1,0
35,302,302,4,4,0,1,0
16,310,310,1,1,0,1,0
6,324,324,5,2,3,2,1
0,329,329,42,6,36,4,3
28,392,392,18,18,0,1,0
24,411,411,12,12,0,1,0
22,438,438,20,20,0,1,0
19,451,451,10,10,0,1,0
33,451,451,104,56,48,3,2
20,454,454,132,38,94,3,2
25,464,464,70,27,43,4,3
34,471,471,129,129,0,1,0
18,474,474,126,6,120,4,3
4,475,475,3,3,0,1,0
3,492,492,47,47,0,1,0

4,114,114,13,3,10,4,3
21,117,117,5,5,0,1,0
27,118,118,21,14,7,2,1
29,119,119,2,2,0,1,0
18,124,124,5,5,0,1,0
12,146,146,80,45,35,2,1
8,155,155,14,4,10,2,1
25,161,161,36,3,33,4,3
3,169,169,13,13,0,1,0
0,182,182,28,28,0,1,0
11,197,197,1,1,0,1,0
22,200,200,7,7,0,1,0
14,201,201,14,14,0,1,0
10,203,203,6,6,0,1,0
20,204,204,14,14,0,1,0
16,225,225,24,6,18,4,3
26,264,264,3,3,0,1,0
31,268,268,15,15,0,1,0
24,283,283,9,9,0,1,0
5,303,303,16,12,4,2,1
2,348,348,82,56,26,3,2
28,350,350,40,6,34,3,2
13,365,365,28,10,18,2,1
1,366,366,88,25,63,4,3
15,369,369,22,22,0,1,0
23,371,371,108,1,107,4,3
6,380,380,2,2,0,1,0
30,398,398,6,2,4,2,1
9,418,418,8,2,6,3,2
7,419,419,10,10,0,1,0
32,452,452,83,83,0,1,0
17,457,457,167,89,78,3,2
19,486,486,2,2,0,1,0
33,491,491,24,24,0,1,0

33,101,101,5,5,0,1,0
10,102,102,2,2,0,1,0
3,117,117,4,4,0,1,0
4,123,123,1,1,0,1,0
41,140,140,1,1,0,1,0
7,145,145,3,3,0,1,0
37,159,159,6,6,0,1,0
27,160,160,8,8,0,1,0
35,163,163,31,31,0,1,0
11,167,167,6,3,3,2,1
45,169,169,33,2,31,2,1
34,189,189,15,6,9,4,3
12,191,191,8,8,0,1,0
39,196,196,17,5,12,2,1
20,230,230,36,36,0,1,0
0,230,230,29,29,0,1,0
15,235,235,2,2,0,1,0
1,239,239,13,1,12,4,3
38,241,241,45,30,15,4,3
13,242,242,23,7,16,3,2
29,249,249,14,4,10,2,1
14,273,273,3,3,0,1,0
28,277,277,13,13,0,1,0
42,280,280,8,8,0,1,0
31,286,286,2,2,0,1,0
23,345,345,51,8,43,2,1
6,345,345,27,23,4,2,1
36,359,359,2,2,0,1,0
5,365,365,30,30,0,1,0
18,375,375,38,38,0,1,0
21,379,379,13,13,0,1,0
30,380,380,46,13,33,4,3
26,382,382,5,5,0,1,0
32,384,384,29,29,0,1,0
17,396,396,59,15,44,2,1
43,409,409,89,51,38,2,1
9,434,434,80,80,0,1,0
19,441,441,48,48,0,1,0
25,442,442,4,4,0,1,0
16,444,444,46,46,0,1,0
40,445,445,126,114,12,2,1
24,445,445,5,5,0,1,0
44,454,454,47,31,16,2,1
8,457,457,14,14,0,1,0
46,458,458,49,11,38,3,2
22,484,484,1,1,0,1,0
2,497,497,19,13,6,3,2

20,112,112,22,15,7,2,1
5,114,114,10,1,9,2,1
16,115,115,9,6,3,2,1
27,125,125,25,6,19,2,1
10,155,155,35,1,34,2,1
1,155,155,1,1,0,1,0
15,167,167,6,6,0,1,0
29,176,176,32,32,0,1,0
22,186,186,4,4,0,1,0
2,208,208,8,8,0,1,0
28,213,213,26,2,24,3,2
0,218,218,31,31,0,1,0
3,222,222,32,32,0,1,0
25,224,224,24,16,8,2,1
7,227,227,4,4,0,1,0
9,229,229,83,65,18,2,1
17,238,238,4,4,0,1,0
11,239,239,44,44,0,1,0
6,265,265,22,12,10,3,2
23,268,268,36,28,8,3,2
13,281,281,18,18,0,1,0
12,286,286,10,4,6,3,2
24,295,295,5,5,0,1,0
32,295,295,5,5,0,1,0
21,298,298,7,7,0,1,0
14,300,300,16,16,0,1,0
4,303,303,10,10,0,1,0
8,303,303,64,22,42,2,1
31,314,314,8,3,5,2,1
18,354,354,103,79,24,3,2
33,429,429,118,16,102,4,3
30,435,435,27,13,14,2,1
26,450,450,33,12,21,4,3
19,469,469,22,10,12,3,2
34,477,477,14,2,12,4,3

14,101,101,3,3,0,1,0
21,130,130,9,9,0,1,0
29,137,137,1,1,0,1,0
26,145,145,19,19,0,1,0
17,194,194,14,5,9,2,1
12,211,211,7,7,0,1,0
8,211,211,7,7,0,1,0
23,217,217,7,1,6,3,2
6,226,226,9,9,0,1,0
19,250,250,21,3,18,4,3
22,275,275,27,27,0,1,0
13,276,276,38,38,0,1,0
10,307,307,24,11,13,2,1
16,321,321,20,20,0,1,0
4,330,330,11,11,0,1,0
27,355,355,57,43,14,3,2
5,369,369,61,21,40,3,2
11,372,372,29,11,18,4,3
1,386,386,10,2,8,2,1
20,389,389,45,45,0,1,0
28,414,414,37,31,6,2,1
15,417,417,110,83,27,2,1
2,423,423,154,23,131,4,3
0,438,438,41,23,18,4,3
18,447,447,44,44,0,1,0
25,457,457,48,27,21,4,3
7,463,463,25,25,0,1,0
24,465,465,84,18,66,3,2
30,470,470,24,18,6,2,1
3,479,479,246,246,0,1,0
9,480,480,73,29,44,2,1
31,491,491,91,82,9,4,3

20,107,107,8,8,0,1,0
26,115,115,4,4,0,1,0
14,130,130,8,8,0,1,0
23,134,134,16,5,11,4,3
29,135,135,10,10,0,1,0
28,140,140,10,10,0,1,0
24,169,169,13,13,0,1,0
7,187,187,1,1,0,1,0
30,188,188,4,4,0,1,0
13,205,205,47,21,26,3,2
8,207,207,1,1,0,1,0
1,227,227,29,21,8,2,1
22,243,243,75,75,0,1,0
6,248,248,19,12,7,2,1
27,249,249,70,28,42,4,3
31,266,266,7,7,0,1,0
32,281,281,52,52,0,1,0
25,296,296,6,6,0,1,0
16,303,303,9,9,0,1,0
21,305,305,77,43,34,3,2
3,334,334,25,2,23,4,3
9,345,345,11,2,9,4,3
15,347,347,92,29,63,4,3
11,360,360,30,7,23,4,3
18,373,373,46,28,18,4,3
17,376,376,18,1,17,3,2
12,376,376,200,158,42,2,1
10,382,382,20,20,0,1,0
2,392,392,14,14,0,1,0
19,409,409,20,20,0,1,0
5,411,411,21,10,11,2,1
4,436,436,16,16,0,1,0
33,436,436,23,16,7,2,1
0,447,447,60,60,0,1,0

12,107,107,7,1,6,2,1
18,134,134,2,2,0,1,0
5,143,143,3,3,0,1,0
33,150,150,9,2,7,2,1
2,157,157,9,3,6,3,2
0,182,182,14,3,11,4,3
14,186,186,13,1,12,3,2
3,188,188,18,18,0,1,0
7,194,194,1,1,0,1,0
27,203,203,17,17,0,1,0
44,211,211,45,45,0,1,0
24,213,213,28,28,0,1,0
39,222,222,9,9,0,1,0
31,234,234,22,17,5,2,1
28,246,246,24,24,0,1,0
29,263,263,22,17,5,2,1
37,266,266,12,12,0,1,0
4,268,268,15,15,0,1,0
22,274,274,4,4,0,1,0
43,275,275,37,4,33,4,3
17,281,281,51,51,0,1,0
9,296,296,6,3,3,2,1
30,299,299,85,77,8,3,2
34,312,312,5,5,0,1,0
25,315,315,8,8,0,1,0
13,333,333,17,6,11,3,2
32,345,345,20,20,0,1,0
1,357,357,10,1,9,2,1
36,361,361,115,115,0,1,0
10,365,365,26,26,0,1,0
40,372,372,24,11,13,3,2
19,381,381,36,6,30,4,3
45,390,390,31,7,24,3,2
21,396,396,22,5,17,2,1
20,402,402,1,1,0,1,0
6,423,423,4,4,0,1,0
35,434,434,62,42,20,3,2
26,434,434,25,25,0,1,0
8,439,439,52,2,50,3,2
15,466,466,68,68,0,1,0
41,470,470,24,15,9,2,1
38,479,479,11,1,10,3,2
42,480,480,11,11,0,1,0
16,489,489,51,1,50,3,2
11,494,494,25,7,18,3,2
23,500,500,48,48,0,1,0

21,111,111,2,2,0,1,0
22,115,115,1,1,0,1,0
2,122,122,1,1,0,1,0
24,124,124,13,2,11,2,1
30,141,141,37,37,0,1,0
33,152,152,16,16,0,1,0
25,162,162,20,20,0,1,0
16,162,162,6,6,0,1,0
36,163,163,44,44,0,1,0
39,178,178,1,1,0,1,0
7,182,182,1,1,0,1,0
19,187,187,22,4,18,4,3
9,202,202,2,2,0,1,0
27,205,205,1,1,0,1,0
44,214,214,19,19,0,1,0
1,238,238,1,1,0,1,0
42,243,243,12,12,0,1,0
40,243,243,12,4,8,2,1
11,251,251,3,3,0,1,0
10,256,256,22,22,0,1,0
20,258,258,8,2,6,3,2
15,281,281,13,13,0,1,0
41,286,286,70,66,4,2,1
45,292,292,94,39,55,3,2
4,295,295,28,13,15,4,3
18,313,313,10,10,0,1,0
43,313,313,30,30,0,1,0
13,322,322,7,7,0,1,0
35,333,333,25,25,0,1,0
38,345,345,30,11,19,2,1
37,348,348,8,8,0,1,0
29,357,357,11,2,9,4,3
6,367,367,39,3,36,2,1
23,377,377,101,58,43,2,1
14,378,378,44,44,0,1,0
3,399,399,26,2,24,4,3
0,410,410,26,26,0,1,0
32,412,412,3,3,0,1,0
8,441,441,4,4,0,1,0
5,443,443,17,3,14,2,1
17,444,444,82,82,0,1,0
26,450,450,46,46,0,1,0
34,462,462,24,17,7,2,1
12,462,462,34,34,0,1,0
28,466,466,4,4,0,1,0
46,468,468,32,32,0,1,0
31,490,490,2,2,0,1,0

0,105,105,1,1,0,1,0
29,123,123,3,3,0,1,0
19,137,137,39,6,33,2,1
11,144,144,2,2,0,1,0
8,157,157,1,1,0,1,0
20,157,157,1,1,0,1,0
17,157,157,13,13,0,1,0
24,173,173,22,17,5,2,1
28,182,182,25,3,22,3,2
31,201,201,26,26,0,1,0
9,217,217,128,12,116,4,3
15,219,219,10,2,8,3,2
5,226,226,61,61,0,1,0
2,262,262,20,20,0,1,0
10,262,262,26,14,12,2,1
6,264,264,43,22,21,4,3
26,274,274,18,5,13,2,1
25,278,278,19,19,0,1,0
22,286,286,56,56,0,1,0
30,302,302,13,13,0,1,0
21,333,333,5,5,0,1,0
4,366,366,68,53,15,2,1
23,367,367,32,32,0,1,0
12,371,371,23,2,21,4,3
1,375,375,23,23,0,1,0
14,402,402,5,5,0,1,0
27,409,409,47,20,27,4,3
7,410,410,56,29,27,4,3
16,414,414,132,132,0,1,0
3,419,419,31,3,28,4,3
13,450,450,24,2,22,3,2
18,475,475,39,39,0,1,0

3,123,123,36,36,0,1,0
34,125,125,2,2,0,1,0
35,163,163,13,3,10,3,2
26,166,166,9,3,6,2,1
28,177,177,16,16,0,1,0
31,196,196,8,8,0,1,0
15,211,211,1,1,0,1,0
10,211,211,18,18,0,1,0
25,212,212,22,13,9,2,1
12,212,212,13,13,0,1,0
1,212,212,1,1,0,1,0
16,223,223,62,20,42,4,3
29,224,224,6,6,0,1,0
6,248,248,38,29,9,4,3
7,260,260,10,10,0,1,0
30,271,271,10,10,0,1,0
9,282,282,9,1,8,2,1
14,292,292,48,48,0,1,0
8,296,296,7,2,5,2,1
11,298,298,6,3,3,2,1
4,328,328,47,33,14,3,2
22,329,329,127,127,0,1,0
32,349,349,39,13,26,3,2
2,363,363,10,5,5,2,1
23,377,377,42,14,28,3,2
24,392,392,20,20,0,1,0
21,404,404,184,34,150,4,3
13,406,406,4,4,0,1,0
18,410,410,19,19,0,1,0
27,416,416,11,1,10,3,2
20,420,420,5,5,0,1,0
17,428,428,85,85,0,1,0
5,440,440,110,60,50,4,3
33,477,477,71,22,49,2,1
19,487,487,18,18,0,1,0
0,489,489,7,7,0,1,0

22,113,113,16,16,0,1,0
23,116,116,17,1,16,3,2
24,121,121,18,18,0,1,0
31,143,143,27,27,0,1,0
11,145,145,23,23,0,1,0
25,160,160,30,6,24,3,2
12,178,178,1,1,0,1,0
4,196,196,5,1,4,2,1
28,214,214,22,22,0,1,0
8,230,230,63,63,0,1,0
9,252,252,1,1,0,1,0
3,273,273,35,1,34,3,2
20,302,302,17,17,0,1,0
7,319,319,3,3,0,1,0
14,328,328,1,1,0,1,0
27,330,330,87,87,0,1,0
0,354,354,17,9,8,2,1
2,361,361,29,29,0,1,0
5,372,372,127,79,48,2,1
29,374,374,43,43,0,1,0
16,402,402,1,1,0,1,0
21,408,408,14,2,12,3,2
10,409,409,5,2,3,2,1
17,414,414,72,14,58,3,2
30,435,435,28,28,0,1,0
19,442,442,37,4,33,4,3
13,442,442,115,115,0,1,0
6,449,449,121,81,40,2,1
18,462,462,8,5,3,2,1
26,464,464,35,10,25,4,3
1,467,467,86,86,0,1,0
15,473,473,19,13,6,2,1

10,103,103,3,3,0,1,0
34,105,105,2,2,0,1,0
4,126,126,15,3,12,3,2
21,161,161,4,4,0,1,0
35,173,173,16,10,6,3,2
1,176,176,15,2,13,2,1
25,184,184,20,10,10,2,1
3,197,197,3,3,0,1,0
39,202,202,1,1,0,1,0
16,205,205,6,6,0,1,0
23,209,209,39,6,33,2,1
38,211,211,68,60,8,3,2
22,213,213,8,3,5,2,1
9,221,221,23,18,5,2,1
13,232,232,17,17,0,1,0
14,233,233,31,16,15,2,1
8,245,245,4,4,0,1,0
19,258,258,9,9,0,1,0
5,262,262,11,11,0,1,0
37,291,291,9,9,0,1,0
12,292,292,4,1,3,2,1
31,295,295,100,4,96,3,2
32,297,297,19,19,0,1,0
42,326,326,54,54,0,1,0
29,337,337,18,18,0,1,0
11,344,344,2,2,0,1,0
18,357,357,6,1,5,2,1
24,358,358,134,134,0,1,0
17,368,368,25,25,0,1,0
0,369,369,31,31,0,1,0
36,370,370,46,46,0,1,0
26,384,384,7,1,6,3,2
33,389,389,1,1,0,1,0
41,402,402,110,110,0,1,0
27,411,411,11,11,0,1,0
20,435,435,19,8,11,2,1
15,448,448,21,21,0,1,0
28,457,457,5,5,0,1,0
7,469,469,22,7,15,2,1
2,469,469,69,69,0,1,0
6,479,479,12,12,0,1,0
30,483,483,47,21,26,2,1
40,500,500,38,38,0,1,0

9,109,109,20,8,12,4,3
31,112,112,7,7,0,1,0
10,113,113,21,14,7,2,1
3,122,122,8,8,0,1,0
4,161,161,25,25,0,1,0
14,197,197,6,2,4,2,1
0,202,202,8,8,0,1,0
27,219,219,36,1,35,2,1
21,234,234,28,28,0,1,0
23,267,267,8,8,0,1,0
18,273,273,12,12,0,1,0
8,274,274,33,9,24,4,3
13,279,279,16,6,10,2,1
17,290,290,46,46,0,1,0
22,315,315,20,20,0,1,0
1,316,316,12,6,6,3,2
12,316,316,112,89,23,4,3
15,325,325,27,27,0,1,0
28,342,342,6,6,0,1,0
11,344,344,55,1,54,4,3
7,349,349,76,73,3,2,1
6,349,349,27,27,0,1,0
29,350,350,32,3,29,4,3
25,375,375,19,19,0,1,0
20,382,382,72,47,25,2,1
30,385,385,25,4,21,4,3
24,397,397,17,17,0,1,0
16,402,402,41,11,30,4,3
19,424,424,177,93,84,4,3
2,435,435,38,26,12,4,3
26,438,438,44,44,0,1,0
5,442,442,27,27,0,1,0

34,102,102,19,19,0,1,0
0,125,125,4,4,0,1,0
7,143,143,9,9,0,1,0
26,149,149,25,20,5,2,1
1,150,150,11,5,6,2,1
27,151,151,13,4,9,4,3
38,165,165,12,12,0,1,0
14,166,166,24,21,3,2,1
15,171,171,10,4,6,2,1
36,178,178,1,1,0,1,0
11,179,179,16,16,0,1,0
37,181,181,26,26,0,1,0
32,189,189,16,16,0,1,0
19,198,198,30,14,16,2,1
22,206,206,1,1,0,1,0
18,221,221,4,4,0,1,0
31,223,223,37,37,0,1,0
2,228,228,2,2,0,1,0
17,233,233,11,11,0,1,0
12,242,242,20,20,0,1,0
4,261,261,42,7,35,2,1
30,269,269,56,23,33,4,3
33,275,275,32,28,4,2,1
24,279,279,12,12,0,1,0
25,282,282,31,31,0,1,0
39,288,288,12,12,0,1,0
13,303,303,34,34,0,1,0
10,304,304,50,50,0,1,0
5,313,313,33,21,12,4,3
6,389,389,104,104,0,1,0
21,413,413,6,6,0,1,0
3,424,424,30,9,21,2,1
16,429,429,19,19,0,1,0
28,436,436,68,68,0,1,0
9,449,449,25,25,0,1,0
29,461,461,1,1,0,1,0
8,466,466,14,11,3,2,1
35,468,468,60,60,0,1,0
20,493,493,3,3,0,1,0
23,497,497,58,58,0,1,0

2,100,100,1,1,0,1,0
26,120,120,45,45,0,1,0
41,121,121,15,7,8,3,2
24,124,124,8,3,5,2,1
23,129,129,6,6,0,1,0
20,141,141,4,4,0,1,0
8,158,158,30,20,10,3,2
34,159,159,7,7,0,1,0
0,178,178,6,6,0,1,0
28,183,183,7,7,0,1,0
6,194,194,6,6,0,1,0
1,218,218,2,2,0,1,0
15,226,226,8,3,5,2,1
12,238,238,14,14,0,1,0
17,246,246,14,2,12,3,2
9,248,248,2,2,0,1,0
19,257,257,4,1,3,2,1
13,258,258,37,16,21,2,1
25,283,283,21,21,0,1,0
21,284,284,56,56,0,1,0
7,304,304,72,16,56,3,2
42,314,314,12,12,0,1,0
10,322,322,11,11,0,1,0
18,325,325,3,3,0,1,0
5,327,327,20,11,9,2,1
35,332,332,15,8,7,2,1
38,347,347,14,14,0,1,0
36,359,359,44,44,0,1,0
30,368,368,7,7,0,1,0
37,373,373,11,11,0,1,0
27,380,380,24,2,22,3,2
14,382,382,5,2,3,2,1
29,382,382,7,2,5,2,1
16,397,397,6,6,0,1,0
33,399,399,215,215,0,1,0
3,401,401,54,26,28,3,2
31,417,417,104,82,22,3,2
22,420,420,45,45,0,1,0
32,445,445,1,1,0,1,0
39,449,449,2,2,0,1,0
43,456,456,2,2,0,1,0
11,468,468,78,9,69,4,3
4,497,497,11,2,9,2,1
40,498,498,37,37,0,1,0

13,108,108,1,1,0,1,0
4,109,109,10,5,5,2,1
8,109,109,19,19,0,1,0
30,110,110,13,7,6,2,1
24,110,110,3,3,0,1,0
15,116,116,20,20,0,1,0
17,123,123,5,5,0,1,0
32,124,124,5,5,0,1,0
29,140,140,56,33,23,2,1
3,160,160,2,2,0,1,0
28,171,171,11,6,5,2,1
26,186,186,29,29,0,1,0
25,191,191,32,2,30,2,1
5,270,270,20,20,0,1,0
18,299,299,28,28,0,1,0
21,303,303,65,65,0,1,0
22,307,307,22,22,0,1,0
23,309,309,7,3,4,2,1
1,312,312,45,45,0,1,0
16,321,321,7,7,0,1,0
12,325,325,60,60,0,1,0
0,329,329,10,10,0,1,0
31,372,372,8,3,5,2,1
11,376,376,29,22,7,2,1
7,382,382,99,35,64,4,3
27,389,389,19,3,16,2,1
2,392,392,59,59,0,1,0
20,394,394,36,36,0,1,0
19,440,440,29,21,8,2,1
9,450,450,107,107,0,1,0
6,452,452,37,10,27,2,1
10,465,465,46,46,0,1,0
14,470,470,82,8,74,4,3

25,102,102,4,4,0,1,0
2,139,139,51,18,33,2,1
31,140,140,3,3,0,1,0
7,145,145,1,1,0,1,0
10,148,148,8,8,0,1,0
19,155,155,9,9,0,1,0
8,190,190,9,9,0,1,0
34,190,190,24,24,0,1,0
12,196,196,39,22,17,4,3
11,222,222,9,9,0,1,0
22,241,241,29,23,6,2,1
29,276,276,61,45,16,2,1
13,283,283,1,1,0,1,0
33,283,283,55,8,47,3,2
17,292,292,33,33,0,1,0
35,313,313,7,7,0,1,0
21,317,317,28,28,0,1,0
18,324,324,38,38,0,1,0
28,328,328,50,50,0,1,0
27,345,345,114,61,53,3,2
1,354,354,56,8,48,4,3
6,359,359,20,20,0,1,0
20,382,382,5,5,0,1,0
16,400,400,4,1,3,2,1
24,401,401,2,2,0,1,0
9,408,408,20,20,0,1,0
32,436,436,9,9,0,1,0
0,439,439,15,15,0,1,0
23,439,439,3,3,0,1,0
26,440,440,82,73,9,4,3
30,440,440,78,78,0,1,0
36,447,447,9,9,0,1,0
4,467,467,49,49,0,1,0
5,482,482,13,13,0,1,0
15,482,482,67,67,0,1,0
37,491,491,38,38,0,1,0
3,491,491,94,94,0,1,0
14,492,492,13,13,0,1,0

19,113,113,32,32,0,1,0
16,113,113,5,5,0,1,0
9,122,122,12,2,10,2,1
26,160,160,1,1,0,1,0
5,166,166,16,16,0,1,0
3,171,171,17,17,0,1,0
14,179,179,48,25,23,2,1
28,196,196,27,27,0,1,0
32,204,204,24,24,0,1,0
35,206,206,19,19,0,1,0
18,227,227,19,19,0,1,0
10,229,229,37,37,0,1,0
31,232,232,4,4,0,1,0
33,258,258,5,5,0,1,0
15,270,270,55,6,49,2,1
6,270,270,12,6,6,2,1
4,287,287,52,52,0,1,0
23,292,292,2,2,0,1,0
27,308,308,33,33,0,1,0
30,319,319,1,1,0,1,0
17,324,324,26,26,0,1,0
22,340,340,44,23,21,3,2
12,352,352,31,31,0,1,0
34,358,358,30,30,0,1,0
2,362,362,4,4,0,1,0
25,366,366,164,140,24,3,2
29,383,383,74,74,0,1,0
13,385,385,59,18,41,2,1
21,396,396,3,3,0,1,0
1,430,430,46,26,20,3,2
11,431,431,27,27,0,1,0
7,455,455,19,19,0,1,0
0,461,461,16,1,15,2,1
20,474,474,6,6,0,1,0
8,485,485,13,13,0,1,0
24,500,500,48,48,0,1,0

28,100,100,14,14,0,1,0
20,116,116,20,1,19,3,2
5,136,136,44,44,0,1,0
24,140,140,35,14,21,2,1
9,150,150,10,6,4,2,1
8,195,195,8,8,0,1,0
1,203,203,46,46,0,1,0
25,209,209,10,10,0,1,0
17,217,217,24,13,11,2,1
35,222,222,7,7,0,1,0
29,247,247,63,23,40,2,1
12,265,265,1,1,0,1,0
30,272,272,8,8,0,1,0
2,277,277,28,28,0,1,0
32,299,299,16,16,0,1,0
0,307,307,4,4,0,1,0
26,314,314,15,7,8,3,2
6,326,326,21,21,0,1,0
23,326,326,19,19,0,1,0
18,336,336,49,49,0,1,0
13,339,339,48,48,0,1,0
10,344,344,8,8,0,1,0
4,344,344,15,6,9,4,3
15,370,370,100,11,89,3,2
31,371,371,35,21,14,2,1
14,374,374,18,18,0,1,0
19,374,374,10,5,5,2,1
11,377,377,23,2,21,4,3
16,384,384,15,15,0,1,0
33,395,395,10,10,0,1,0
34,396,396,78,10,68,3,2
27,402,402,70,70,0,1,0
21,409,409,27,1,26,3,2
3,430,430,91,86,5,2,1
22,493,493,11,11,0,1,0
7,499,499,7,7,0,1,0

22,108,108,7,1,6,3,2
15,111,111,14,14,0,1,0
34,112,112,5,5,0,1,0
28,143,143,13,1,12,2,1
23,147,147,6,6,0,1,0
14,162,162,43,43,0,1,0
20,171,171,16,9,7,2,1
36,191,191,18,18,0,1,0
25,194,194,50,10,40,3,2
2,194,194,4,4,0,1,0
30,202,202,3,3,0,1,0
24,205,205,22,2,20,4,3
0,210,210,9,9,0,1,0
5,222,222,5,5,0,1,0
12,226,226,1,1,0,1,0
26,234,234,16,16,0,1,0
27,243,243,51,51,0,1,0
6,248,248,38,19,19,2,1
31,274,274,29,24,5,2,1
11,277,277,8,8,0,1,0
37,280,280,33,33,0,1,0
32,281,281,10,10,0,1,0
21,301,301,43,43,0,1,0
3,319,319,8,8,0,1,0
17,340,340,50,14,36,4,3
10,342,342,34,34,0,1,0
33,359,359,80,80,0,1,0
16,367,367,25,25,0,1,0
9,406,406,2,2,0,1,0
7,410,410,22,4,18,2,1
19,411,411,41,8,33,2,1
4,424,424,186,136,50,2,1
29,430,430,16,16,0,1,0
1,438,438,17,7,10,3,2
35,444,444,41,19,22,3,2
18,449,449,10,7,3,2,1
8,453,453,24,12,12,2,1
13,474,474,41,12,29,2,1

29,103,103,22,22,0,1,0
31,126,126,15,6,9,4,3
18,149,149,14,14,0,1,0
39,155,155,6,6,0,1,0
2,157,157,1,1,0,1,0
4,158,158,14,2,12,2,1
28,162,162,25,25,0,1,0
3,176,176,13,13,0,1,0
12,183,183,34,4,30,4,3
33,243,243,16,16,0,1,0
17,259,259,12,12,0,1,0
16,268,268,1,1,0,1,0
13,273,273,16,12,4,2,1
10,277,277,12,5,7,3,2
25,300,300,83,83,0,1,0
22,302,302,1,1,0,1,0
24,314,314,17,17,0,1,0
34,319,319,3,3,0,1,0
21,325,325,4,4,0,1,0
5,325,325,41,41,0,1,0
40,338,338,59,59,0,1,0
7,357,357,35,16,19,2,1
23,365,365,21,21,0,1,0
11,376,376,117,117,0,1,0
15,376,376,7,2,5,2,1
6,382,382,63,63,0,1,0
26,384,384,26,26,0,1,0
1,386,386,12,12,0,1,0
36,396,396,7,7,0,1,0
20,399,399,21,2,19,2,1
35,407,407,56,56,0,1,0
38,418,418,11,11,0,1,0
0,444,444,19,1,18,4,3
9,447,447,25,18,7,2,1
30,448,448,17,1,16,3,2
19,464,464,16,16,0,1,0
8,465,465,11,11,0,1,0
32,470,470,163,104,59,4,3
27,481,481,6,3,3,2,1
14,485,485,109,27,82,4,3
37,498,498,12,1,11,4,3

12,110,110,1,1,0,1,0
15,133,133,3,3,0,1,0
30,139,139,20,10,10,3,2
8,141,141,19,4,15,4,3
31,142,142,3,3,0,1,0
32,148,148,29,29,0,1,0
29,152,152,1,1,0,1,0
21,165,165,1,1,0,1,0
1,177,177,11,11,0,1,0
23,187,187,10,10,0,1,0
0,189,189,6,1,5,2,1
14,209,209,31,5,26,2,1
35,213,213,60,60,0,1,0
24,219,219,35,7,28,3,2
18,223,223,1,1,0,1,0
11,231,231,39,36,3,2,1
13,258,258,23,20,3,2,1
27,263,263,53,53,0,1,0
34,281,281,2,2,0,1,0
17,282,282,34,34,0,1,0
3,322,322,16,10,6,2,1
7,325,325,23,5,18,4,3
19,338,338,3,3,0,1,0
26,339,339,14,14,0,1,0
9,347,347,32,29,3,2,1
25,353,353,80,74,6,3,2
20,370,370,89,36,53,3,2
10,386,386,60,60,0,1,0
6,395,395,8,8,0,1,0
4,403,403,41,32,9,2,1
2,404,404,44,38,6,3,2
28,443,443,6,1,5,2,1
16,456,456,118,82,36,4,3
5,463,463,73,67,6,3,2
22,493,493,73,73,0,1,0
33,500,500,39,39,0,1,0

20,119,119,22,22,0,1,0
27,123,123,1,1,0,1,0
22,127,127,12,12,0,1,0
13,129,129,8,8,0,1,0
6,133,133,16,11,5,2,1
31,133,133,1,1,0,1,0
19,175,175,14,2,12,3,2
11,177,177,21,21,0,1,0
23,184,184,21,17,4,2,1
14,187,187,43,43,0,1,0
12,211,211,4,4,0,1,0
4,216,216,3,3,0,1,0
15,229,229,57,38,19,4,3
2,250,250,1,1,0,1,0
1,258,258,28,23,5,2,1
9,273,273,3,3,0,1,0
17,300,300,59,59,0,1,0
30,303,303,71,71,0,1,0
28,319,319,9,1,8,2,1
25,321,321,26,26,0,1,0
33,329,329,13,9,4,2,1
8,335,335,66,45,21,4,3
24,364,364,29,29,0,1,0
16,367,367,16,16,0,1,0
7,385,385,44,26,18,2,1
5,386,386,12,7,5,2,1
18,407,407,26,26,0,1,0
10,416,416,95,53,42,2,1
0,439,439,82,32,50,3,2
26,443,443,174,117,57,3,2
29,447,447,44,44,0,1,0
3,469,469,51,51,0,1,0
32,481,481,23,17,6,3,2
21,489,489,17,17,0,1,0

23,118,118,21,21,0,1,0
13,157,157,32,23,9,4,3
26,182,182,3,3,0,1,0
16,183,183,16,16,0,1,0
12,194,194,8,8,0,1,0
6,211,211,23,23,0,1,0
0,218,218,41,9,32,2,1
25,226,226,60,13,47,3,2
15,231,231,1,1,0,1,0
24,244,244,57,57,0,1,0
18,318,318,10,7,3,2,1
8,335,335,133,20,113,4,3
19,353,353,27,19,8,2,1
14,359,359,57,3,54,4,3
20,363,363,29,29,0,1,0
3,388,388,149,45,104,4,3
9,403,403,26,26,0,1,0
22,403,403,39,39,0,1,0
1,420,420,13,13,0,1,0
17,421,421,2,2,0,1,0
5,427,427,172,172,0,1,0
4,427,427,17,17,0,1,0
11,429,429,16,16,0,1,0
2,443,443,74,74,0,1,0
21,446,446,99,99,0,1,0
10,493,493,18,11,7,2,1
7,495,495,41,41,0,1,0

24,111,111,10,1,9,3,2
22,131,131,14,11,3,2,1
26,133,133,9,9,0,1,0
7,141,141,1,1,0,1,0
5,156,156,44,44,0,1,0
10,184,184,7,7,0,1,0
23,192,192,13,13,0,1,0
8,213,213,28,3,25,2,1
9,220,220,2,2,0,1,0
18,232,232,77,77,0,1,0
34,237,237,18,1,17,2,1
14,250,250,38,2,36,4,3
11,251,251,24,6,18,4,3
32,277,277,4,1,3,2,1
6,281,281,98,50,48,4,3
27,294,294,2,2,0,1,0
2,305,305,15,10,5,2,1
21,344,344,10,1,9,4,3
3,349,349,27,2,25,2,1
29,364,364,78,44,34,3,2
35,388,388,20,20,0,1,0
13,399,399,52,52,0,1,0
1,414,414,28,19,9,2,1
19,419,419,31,16,15,4,3
31,429,429,64,34,30,4,3
16,430,430,81,45,36,4,3
15,432,432,14,14,0,1,0
25,432,432,52,52,0,1,0
20,436,436,5,5,0,1,0
4,454,454,53,53,0,1,0
33,459,459,55,31,24,4,3
28,462,462,12,8,4,2,1
17,471,471,17,17,0,1,0
12,472,472,8,8,0,1,0
30,487,487,134,102,32,2,1
0,497,497,11,11,0,1,0

8,104,104,2,2,0,1,0
32,141,141,11,11,0,1,0
27,146,146,6,3,3,2,1
35,147,147,1,1,0,1,0
24,149,149,19,19,0,1,0
1,152,152,22,22,0,1,0
21,160,160,7,7,0,1,0
18,163,163,38,3,35,2,1
33,168,168,8,4,4,2,1
19,185,185,24,24,0,1,0
23,190,190,15,3,12,4,3
16,195,195,48,48,0,1,0
25,197,197,7,7,0,1,0
26,204,204,4,1,3,2,1
0,205,205,14,7,7,2,1
7,228,228,2,2,0,1,0
31,271,271,23,18,5,2,1
11,294,294,51,51,0,1,0
2,326,326,2,2,0,1,0
29,358,358,75,75,0,1,0
6,361,361,73,73,0,1,0
28,374,374,2,2,0,1,0
13,377,377,30,9,21,4,3
4,380,380,76,54,22,2,1
9,412,412,20,8,12,3,2
3,413,413,19,19,0,1,0
34,418,418,152,131,21,4,3
10,425,425,39,39,0,1,0
17,434,434,9,9,0,1,0
20,438,438,43,43,0,1,0
15,439,439,11,11,0,1,0
22,445,445,56,56,0,1,0
12,462,462,127,120,7,2,1
14,493,493,64,29,35,2,1
30,497,497,56,56,0,1,0
5,497,497,8,4,4,2,1

34,109,109,12,12,0,1,0
40,117,117,2,2,0,1,0
36,119,119,3,3,0,1,0
1,126,126,12,1,11,2,1
28,130,130,4,4,0,1,0
5,132,132,8,1,7,2,1
25,160,160,7,7,0,1,0
9,170,170,29,29,0,1,0
20,173,173,4,4,0,1,0
6,180,180,1,1,0,1,0
14,203,203,7,7,0,1,0
32,210,210,45,45,0,1,0
13,217,217,13,7,6,2,1
18,227,227,13,4,9,4,3
35,228,228,41,41,0,1,0
39,229,229,9,9,0,1,0
26,233,233,22,7,15,4,3
7,272,272,23,10,13,2,1
22,273,273,20,11,9,2,1
10,289,289,41,41,0,1,0
21,298,298,1,1,0,1,0
37,335,335,126,57,69,4,3
38,337,337,16,16,0,1,0
2,369,369,100,76,24,4,3
15,369,369,22,22,0,1,0
24,382,382,30,30,0,1,0
16,401,401,10,4,6,3,2
23,406,406,62,62,0,1,0
33,415,415,27,12,15,4,3
17,419,419,13,13,0,1,0
11,425,425,56,56,0,1,0
30,427,427,11,11,0,1,0
12,433,433,23,4,19,2,1
4,440,440,25,15,10,2,1
31,455,455,115,78,37,4,3
3,465,465,52,52,0,1,0
29,470,470,16,16,0,1,0
8,475,475,37,21,16,3,2
19,484,484,82,82,0,1,0
27,486,486,26,26,0,1,0
0,496,496,2,2,0,1,0

27,116,116,8,8,0,1,0
12,123,123,1,1,0,1,0
8,131,131,2,2,0,1,0
23,182,182,89,59,30,3,2
17,195,195,31,2,29,2,1
19,195,195,5,5,0,1,0
5,205,205,28,28,0,1,0
33,216,216,8,2,6,2,1
11,240,240,173,50,123,4,3
30,255,255,39,39,0,1,0
26,272,272,20,10,10,2,1
24,277,277,28,7,21,4,3
13,280,280,15,6,9,2,1
22,288,288,9,4,5,2,1
1,301,301,30,8,22,3,2
16,302,302,5,5,0,1,0
7,305,305,2,2,0,1,0
31,316,316,33,21,12,2,1
20,324,324,42,16,26,4,3
4,324,324,41,41,0,1,0
3,337,337,46,6,40,3,2
15,341,341,18,15,3,2,1
21,342,342,18,18,0,1,0
14,348,348,9,9,0,1,0
18,360,360,15,15,0,1,0
6,382,382,16,16,0,1,0
25,385,385,9,9,0,1,0
32,395,395,15,15,0,1,0
28,402,402,62,59,3,2,1
0,415,415,36,4,32,2,1
9,445,445,12,12,0,1,0
10,462,462,97,29,68,3,2
2,484,484,26,26,0,1,0
29,496,496,66,66,0,1,0

5,108,108,7,1,6,2,1
30,122,122,40,27,13,2,1
31,134,134,5,1,4,2,1
2,140,140,7,3,4,2,1
20,161,161,2,2,0,1,0
8,166,166,7,7,0,1,0
29,177,177,3,3,0,1,0
12,237,237,25,25,0,1,0
33,242,242,26,26,0,1,0
0,249,249,20,8,12,3,2
26,252,252,25,25,0,1,0
25,256,256,6,6,0,1,0
32,266,266,9,9,0,1,0
11,267,267,6,6,0,1,0
9,272,272,83,63,20,2,1
14,284,284,9,3,6,2,1
6,286,286,33,33,0,1,0
7,298,298,31,31,0,1,0
28,320,320,57,23,34,3,2
27,329,329,6,6,0,1,0
10,345,345,62,62,0,1,0
19,349,349,60,60,0,1,0
16,368,368,34,34,0,1,0
23,396,396,23,8,15,4,3
13,406,406,72,15,57,4,3
24,406,406,5,5,0,1,0
18,412,412,115,115,0,1,0
4,416,416,44,10,34,2,1
1,421,421,81,81,0,1,0
15,429,429,11,1,10,2,1
3,451,451,38,38,0,1,0
22,452,452,97,97,0,1,0
35,488,488,17,8,9,4,3
21,495,495,23,8,15,4,3
17,497,497,11,11,0,1,0
34,497,497,81,81,0,1,0

38,101,101,6,1,5,2,1
33,105,105,16,16,0,1,0
39,121,121,16,6,10,3,2
11,126,126,24,3,21,4,3
14,148,148,10,10,0,1,0
19,155,155,10,4,6,3,2
36,156,156,50,50,0,1,0
30,158,158,14,14,0,1,0
41,162,162,12,2,10,2,1
20,170,170,4,4,0,1,0
37,180,180,8,4,4,2,1
32,184,184,12,12,0,1,0
23,200,200,19,19,0,1,0
29,231,231,6,6,0,1,0
8,231,231,48,48,0,1,0
15,260,260,13,13,0,1,0
35,268,268,7,4,3,2,1
27,276,276,28,28,0,1,0
24,286,286,5,5,0,1,0
13,289,289,29,3,26,3,2
4,302,302,28,28,0,1,0
34,304,304,9,9,0,1,0
40,308,308,82,41,41,2,1
6,311,311,1,1,0,1,0
26,311,311,29,29,0,1,0
25,316,316,18,18,0,1,0
1,346,346,1,1,0,1,0
21,355,355,39,39,0,1,0
5,372,372,30,12,18,2,1
2,378,378,8,8,0,1,0
22,385,385,9,9,0,1,0
16,389,389,22,7,15,4,3
18,417,417,2,2,0,1,0
9,425,425,7,7,0,1,0
12,429,429,14,14,0,1,0
7,438,438,59,59,0,1,0
31,451,451,82,82,0,1,0
3,452,452,14,2,12,3,2
28,461,461,49,15,34,2,1
42,470,470,13,13,0,1,0
0,484,484,1,1,0,1,0
17,485,485,75,75,0,1,0
10,498,498,108,36,72,3,2

32,102,102,27,21,6,2,1
0,115,115,25,7,18,3,2
19,140,140,3,3,0,1,0
17,182,182,8,2,6,3,2
26,184,184,1,1,0,1,0
27,198,198,62,9,53,4,3
20,219,219,8,1,7,2,1
30,231,231,29,14,15,4,3
16,238,238,38,38,0,1,0
13,247,247,45,45,0,1,0
10,253,253,23,23,0,1,0
3,262,262,14,14,0,1,0
18,312,312,54,23,31,2,1
5,325,325,97,64,33,4,3
6,329,329,10,2,8,2,1
15,340,340,12,12,0,1,0
23,341,341,25,25,0,1,0
9,358,358,61,51,10,3,2
28,366,366,15,15,0,1,0
4,383,383,53,53,0,1,0
29,388,388,27,7,20,3,2
31,393,393,10,4,6,2,1
14,394,394,7,2,5,2,1
24,395,395,99,15,84,3,2
8,398,398,3,3,0,1,0
7,416,416,36,12,24,3,2
12,449,449,149,149,0,1,0
1,450,450,35,35,0,1,0
22,457,457,19,19,0,1,0
2,483,483,30,30,0,1,0
25,497,497,19,7,12,3,2
21,498,498,60,6,54,4,3
11,499,499,18,18,0,1,0

0,100,100,2,2,0,1,0
23,109,109,1,1,0,1,0
30,146,146,3,3,0,1,0
29,173,173,58,58,0,1,0
21,177,177,11,5,6,3,2
16,183,183,15,15,0,1,0
20,210,210,45,45,0,1,0
9,238,238,106,75,31,2,1
15,251,251,58,58,0,1,0
10,256,256,45,5,40,3,2
24,260,260,9,9,0,1,0
6,286,286,9,9,0,1,0
22,291,291,78,54,24,3,2
4,297,297,69,65,4,2,1
27,308,308,5,2,3,2,1
31,320,320,4,4,0,1,0
3,322,322,10,10,0,1,0
28,327,327,12,2,10,2,1
12,368,368,24,24,0,1,0
19,368,368,35,35,0,1,0
17,371,371,23,23,0,1,0
8,380,380,51,38,13,2,1
26,382,382,12,3,9,2,1
5,390,390,143,14,129,4,3
1,408,408,23,19,4,2,1
7,416,416,21,3,18,3,2
2,447,447,26,4,22,3,2
25,449,449,16,16,0,1,0
14,454,454,10,6,4,2,1
18,460,460,123,91,32,3,2
13,479,479,14,7,7,2,1
11,490,490,51,51,0,1,0

4,105,105,11,11,0,1,0
19,107,107,2,2,0,1,0
25,115,115,8,3,5,2,1
9,120,120,18,18,0,1,0
26,158,158,3,3,0,1,0
13,170,170,10,10,0,1,0
7,173,173,2,2,0,1,0
31,178,178,38,14,24,4,3
5,186,186,70,70,0,1,0
0,199,199,27,27,0,1,0
23,199,199,14,14,0,1,0
17,205,205,32,8,24,2,1
30,238,238,13,13,0,1,0
22,257,257,14,14,0,1,0
12,260,260,18,2,16,2,1
11,274,274,22,13,9,2,1
24,296,296,52,1,51,3,2
27,299,299,6,6,0,1,0
14,303,303,10,10,0,1,0
18,304,304,119,32,87,4,3
21,366,366,72,15,57,4,3
32,374,374,25,4,21,2,1
28,384,384,10,10,0,1,0
16,385,385,7,7,0,1,0
3,391,391,2,2,0,1,0
6,391,391,45,21,24,2,1
29,412,412,67,1,66,3,2
15,441,441,123,123,0,1,0
33,443,443,24,12,12,4,3
1,450,450,22,9,13,2,1
8,482,482,149,49,100,3,2
20,486,486,35,16,19,2,1
10,489,489,3,3,0,1,0
2,494,494,9,9,0,1,0

0,102,102,1,1,0,1,0
27,137,137,14,14,0,1,0
19,137,137,14,14,0,1,0
5,171,171,8,8,0,1,0
20,171,171,10,5,5,2,1
2,184,184,22,22,0,1,0
28,203,203,47,7,40,3,2
4,258,258,204,96,108,4,3
17,262,262,29,11,18,2,1
14,270,270,9,9,0,1,0
13,306,306,4,4,0,1,0
6,333,333,14,14,0,1,0
22,339,339,36,9,27,4,3
12,346,346,44,44,0,1,0
29,353,353,77,5,72,3,2
16,360,360,11,2,9,4,3
15,377,377,37,37,0,1,0
18,379,379,68,12,56,3,2
25,398,398,23,15,8,3,2
3,409,409,103,103,0,1,0
21,424,424,1,1,0,1,0
11,448,448,50,50,0,1,0
7,448,448,25,25,0,1,0
9,460,460,31,8,23,3,2
10,469,469,80,80,0,1,0
8,469,469,37,37,0,1,0
24,472,472,116,116,0,1,0
1,478,478,27,27,0,1,0
26,491,491,46,46,0,1,0
23,496,496,10,10,0,1,0

31,104,104,7,3,4,2,1
24,113,113,41,19,22,3,2
1,118,118,10,3,7,2,1
13,128,128,1,1,0,1,0
28,132,132,24,4,20,3,2
15,153,153,3,3,0,1,0
37,162,162,3,3,0,1,0
9,164,164,23,23,0,1,0
23,166,166,9,9,0,1,0
14,170,170,6,1,5,2,1
0,175,175,4,4,0,1,0
22,178,178,1,1,0,1,0
19,191,191,6,1,5,2,1
12,208,208,7,1,6,3,2
29,210,210,20,11,9,4,3
10,215,215,9,9,0,1,0
21,221,221,17,17,0,1,0
17,232,232,12,12,0,1,0
16,252,252,69,69,0,1,0
3,255,255,40,15,25,3,2
7,315,315,12,12,0,1,0
26,315,315,48,14,34,4,3
39,316,316,2,2,0,1,0
32,322,322,61,1,60,4,3
38,331,331,6,6,0,1,0
33,343,343,64,64,0,1,0
36,361,361,6,6,0,1,0
11,390,390,14,14,0,1,0
8,392,392,111,17,94,3,2
2,410,410,72,53,19,3,2
20,417,417,22,22,0,1,0
25,429,429,44,44,0,1,0
27,430,430,75,75,0,1,0
30,431,431,68,68,0,1,0
34,437,437,17,1,16,2,1
5,443,443,22,10,12,2,1
35,444,444,9,9,0,1,0
6,460,460,53,53,0,1,0
4,463,463,5,2,3,2,1
18,498,498,33,33,0,1,0

37,106,106,4,4,0,1,0
22,112,112,3,3,0,1,0
32,135,135,3,3,0,1,0
3,169,169,14,14,0,1,0
35,176,176,16,16,0,1,0
4,206,206,10,10,0,1,0
28,207,207,24,5,19,2,1
18,231,231,31,11,20,3,2
1,235,235,1,1,0,1,0
21,237,237,4,4,0,1,0
11,242,242,26,26,0,1,0
30,259,259,41,41,0,1,0
15,289,289,9,9,0,1,0
36,298,298,46,46,0,1,0
29,299,299,60,25,35,3,2
25,311,311,6,6,0,1,0
10,319,319,30,2,28,3,2
19,324,324,36,36,0,1,0
17,326,326,50,6,44,2,1
9,330,330,58,25,33,4,3
14,332,332,29,29,0,1,0
13,351,351,13,13,0,1,0
6,355,355,56,11,45,2,1
27,360,360,85,41,44,2,1
5,373,373,49,4,45,2,1
12,374,374,31,10,21,2,1
33,391,391,50,33,17,3,2
23,401,401,15,15,0,1,0
7,407,407,17,17,0,1,0
0,426,426,65,56,9,4,3
24,450,450,84,48,36,2,1
31,451,451,31,31,0,1,0
8,458,458,29,1,28,3,2
34,458,458,32,10,22,3,2
26,462,462,44,44,0,1,0
20,464,464,81,18,63,4,3
16,472,472,20,1,19,4,3
2,491,491,31,11,20,2,1

27,108,108,22,6,16,2,1
6,128,128,25,25,0,1,0
30,134,134,1,1,0,1,0
12,160,160,3,3,0,1,0
14,163,163,6,3,3,2,1
15,183,183,6,3,3,2,1
16,208,208,1,1,0,1,0
9,216,216,50,50,0,1,0
36,229,229,5,5,0,1,0
22,256,256,1,1,0,1,0
2,269,269,36,8,28,2,1
35,279,279,69,23,46,2,1
18,281,281,54,54,0,1,0
10,283,283,16,16,0,1,0
24,283,283,45,45,0,1,0
17,293,293,9,1,8,2,1
28,294,294,12,12,0,1,0
25,304,304,14,2,12,2,1
32,320,320,23,23,0,1,0
26,322,322,45,45,0,1,0
33,326,326,3,3,0,1,0
5,346,346,20,20,0,1,0
7,368,368,16,16,0,1,0
31,371,371,108,51,57,4,3
3,386,386,10,7,3,2,1
8,400,400,30,21,9,4,3
13,412,412,58,58,0,1,0
19,416,416,25,25,0,1,0
23,448,448,32,4,28,2,1
1,472,472,48,24,24,4,3
34,477,477,93,29,64,3,2
21,481,481,9,3,6,3,2
29,483,483,90,90,0,1,0
20,487,487,27,16,11,4,3
0,488,488,162,107,55,3,2
11,490,490,6,1,5,2,1
4,498,498,39,39,0,1,0

25,100,100,9,9,0,1,0
28,101,101,3,3,0,1,0
21,126,126,11,11,0,1,0
23,131,131,34,16,18,3,2
2,132,132,15,15,0,1,0
26,135,135,20,6,14,3,2
27,136,136,14,14,0,1,0
8,137,137,17,17,0,1,0
9,143,143,1,1,0,1,0
7,149,149,11,11,0,1,0
17,151,151,6,3,3,2,1
11,152,152,9,9,0,1,0
20,183,183,13,13,0,1,0
31,196,196,49,49,0,1,0
30,204,204,31,31,0,1,0
4,233,233,85,53,32,3,2
6,266,266,1,1,0,1,0
0,271,271,5,2,3,2,1
19,303,303,56,5,51,4,3
3,318,318,51,16,35,3,2
14,326,326,4,4,0,1,0
24,350,350,3,3,0,1,0
15,356,356,50,8,42,3,2
10,369,369,51,51,0,1,0
13,377,377,18,4,14,2,1
16,410,410,9,9,0,1,0
12,418,418,130,40,90,4,3
18,440,440,16,16,0,1,0
22,451,451,28,11,17,2,1
29,456,456,69,23,46,3,2
5,464,464,24,19,5,2,1
1,471,471,154,34,120,4,3

0,103,103,18,18,0,1,0
9,117,117,25,10,15,2,1
5,120,120,28,28,0,1,0
12,120,120,16,16,0,1,0
13,122,122,1,1,0,1,0
31,127,127,10,6,4,2,1
18,130,130,1,1,0,1,0
28,154,154,17,12,5,2,1
8,162,162,13,7,6,2,1
23,169,169,23,1,22,3,2
32,199,199,23,16,7,2,1
15,201,201,23,23,0,1,0
11,227,227,6,6,0,1,0
19,240,240,55,29,26,3,2
34,241,241,12,12,0,1,0
27,263,263,7,7,0,1,0
4,273,273,38,38,0,1,0
10,289,289,42,20,22,2,1
2,293,293,70,41,29,3,2
20,294,294,28,28,0,1,0
22,295,295,70,20,50,3,2
17,298,298,20,5,15,2,1
3,301,301,1,1,0,1,0
21,358,358,23,1,22,2,1
24,375,375,10,10,0,1,0
7,421,421,40,18,22,2,1
1,443,443,18,8,10,3,2
26,444,444,89,89,0,1,0
14,461,461,10,10,0,1,0
25,462,462,14,1,13,3,2
33,464,464,44,44,0,1,0
30,470,470,8,8,0,1,0
16,477,477,23,1,22,3,2
29,488,488,122,102,20,3,2
6,495,495,42,28,14,2,1

31,100,100,6,6,0,1,0
16,122,122,6,6,0,1,0
20,132,132,13,13,0,1,0
3,141,141,47,23,24,3,2
9,141,141,10,4,6,2,1
5,149,149,4,1,3,2,1
26,154,154,8,8,0,1,0
25,160,160,22,10,12,4,3
32,169,169,35,35,0,1,0
2,181,181,39,24,15,4,3
1,185,185,9,3,6,3,2
33,206,206,15,15,0,1,0
11,235,235,3,3,0,1,0
4,244,244,16,8,8,2,1
14,246,246,49,49,0,1,0
24,256,256,3,3,0,1,0
18,259,259,38,38,0,1,0
0,277,277,25,5,20,3,2
34,279,279,36,36,0,1,0
21,300,300,9,4,5,2,1
7,302,302,38,38,0,1,0
6,317,317,11,3,8,3,2
30,356,356,17,17,0,1,0
27,372,372,2,2,0,1,0
12,383,383,50,32,18,3,2
29,395,395,98,98,0,1,0
8,412,412,26,26,0,1,0
10,412,412,33,33,0,1,0
15,421,421,39,39,0,1,0
13,430,430,49,49,0,1,0
17,442,442,21,21,0,1,0
23,453,453,34,34,0,1,0
19,456,456,89,42,47,3,2
22,458,458,13,4,9,4,3
28,466,466,16,16,0,1,0
35,497,497,125,94,31,3,2

3,108,108,11,11,0,1,0
12,126,126,28,28,0,1,0
13,159,159,21,4,17,3,2
9,187,187,95,74,21,4,3
1,192,192,57,57,0,1,0
18,217,217,46,46,0,1,0
22,220,220,1,1,0,1,0
4,246,246,8,8,0,1,0
17,248,248,1,1,0,1,0
15,256,256,26,10,16,3,2
19,268,268,6,6,0,1,0
25,270,270,6,6,0,1,0
7,292,292,18,18,0,1,0
24,316,316,25,25,0,1,0
16,318,318,10,4,6,3,2
21,333,333,54,54,0,1,0
27,337,337,15,2,13,2,1
6,356,356,23,7,16,2,1
0,363,363,15,6,9,2,1
11,394,394,13,5,8,2,1
8,411,411,56,24,32,3,2
20,438,438,209,209,0,1,0
14,452,452,34,34,0,1,0
26,453,453,75,23,52,3,2
5,453,453,99,25,74,3,2
2,454,454,84,84,0,1,0
23,456,456,4,1,3,2,1
10,469,469,72,68,4,2,1
28,487,487,18,7,11,2,1

10,100,100,6,6,0,1,0
33,103,103,11,1,10,2,1
17,126,126,1,1,0,1,0
28,130,130,10,10,0,1,0
30,141,141,19,7,12,2,1
18,150,150,12,12,0,1,0
26,155,155,24,12,12,4,3
13,162,162,5,5,0,1,0
24,174,174,23,9,14,2,1
7,195,195,39,24,15,2,1
23,203,203,12,12,0,1,0
4,210,210,5,5,0,1,0
16,213,213,1,1,0,1,0
3,248,248,8,2,6,2,1
6,262,262,2,2,0,1,0
12,269,269,89,44,45,4,3
31,282,282,47,47,0,1,0
0,285,285,4,1,3,2,1
14,327,327,73,9,64,4,3
22,367,367,32,23,9,2,1
9,372,372,8,2,6,2,1
11,372,372,12,2,10,3,2
8,376,376,38,38,0,1,0
27,382,382,42,18,24,4,3
36,395,395,1,1,0,1,0
20,405,405,39,39,0,1,0
21,408,408,133,133,0,1,0
2,418,418,114,46,68,3,2
1,424,424,81,36,45,4,3
19,427,427,77,68,9,4,3
5,450,450,62,62,0,1,0
35,451,451,32,5,27,4,3
34,459,459,34,31,3,2,1
29,470,470,6,6,0,1,0
32,493,493,14,14,0,1,0
25,495,495,11,8,3,2,1
15,499,499,15,6,9,2,1

35,112,112,13,7,6,2,1
11,125,125,34,28,6,2,1
31,157,157,3,3,0,1,0
8,159,159,25,12,13,2,1
21,159,159,2,2,0,1,0
6,172,172,6,1,5,2,1
10,175,175,14,14,0,1,0
16,185,185,26,5,21,4,3
33,257,257,12,12,0,1,0
1,261,261,2,2,0,1,0
38,276,276,63,31,32,3,2
19,277,277,25,17,8,2,1
3,283,283,30,7,23,3,2
18,285,285,16,12,4,2,1
2,290,290,36,12,24,3,2
25,301,301,118,54,64,3,2
14,307,307,12,6,6,3,2
23,327,327,20,3,17,2,1
37,345,345,117,67,50,2,1
22,347,347,20,20,0,1,0
34,355,355,16,16,0,1,0
26,365,365,30,30,0,1,0
13,375,375,12,12,0,1,0
30,389,389,10,1,9,2,1
9,406,406,18,18,0,1,0
27,415,415,47,44,3,2,1
28,415,415,45,4,41,2,1
29,423,423,42,42,0,1,0
17,433,433,10,10,0,1,0
24,438,438,10,10,0,1,0
5,449,449,33,33,0,1,0
15,454,454,26,18,8,2,1
7,456,456,9,9,0,1,0
20,462,462,33,1,32,3,2
32,463,463,7,7,0,1,0
12,486,486,117,117,0,1,0
36,487,487,23,23,0,1,0
4,491,491,12,12,0,1,0
0,495,495,53,42,11,4,3

34,102,102,1,1,0,1,0
39,123,123,7,7,0,1,0
20,141,141,4,4,0,1,0
32,142,142,12,3,9,4,3
24,167,167,2,2,0,1,0
31,167,167,23,11,12,2,1
33,172,172,89,89,0,1,0
23,173,173,16,16,0,1,0
3,178,178,35,9,26,3,2
37,179,179,32,32,0,1,0
15,199,199,19,19,0,1,0
26,220,220,23,23,0,1,0
28,259,259,24,24,0,1,0
29,275,275,39,39,0,1,0
11,290,290,20,5,15,4,3
9,295,295,35,35,0,1,0
14,316,316,5,5,0,1,0
30,318,318,46,46,0,1,0
41,318,318,40,2,38,4,3
25,336,336,30,3,27,2,1
36,343,343,6,3,3,2,1
38,352,352,29,29,0,1,0
35,353,353,3,3,0,1,0
5,359,359,40,22,18,2,1
7,361,361,12,5,7,2,1
10,377,377,29,29,0,1,0
2,377,377,55,17,38,2,1
27,378,378,8,8,0,1,0
6,384,384,9,9,0,1,0
21,386,386,8,3,5,2,1
13,393,393,7,7,0,1,0
0,405,405,75,35,40,3,2
40,406,406,7,7,0,1,0
18,416,416,26,3,23,4,3
16,425,425,2,2,0,1,0
8,436,436,86,2,84,3,2
4,441,441,2,2,0,1,0
12,468,468,48,18,30,2,1
1,471,471,21,21,0,1,0
19,472,472,19,12,7,2,1
22,484,484,50,50,0,1,0
17,490,490,6,2,4,2,1

37,120,120,5,5,0,1,0
4,131,131,2,2,0,1,0
35,133,133,3,3,0,1,0
5,138,138,2,2,0,1,0
29,139,139,28,28,0,1,0
18,165,165,19,4,15,4,3
10,167,167,3,3,0,1,0
27,183,183,12,4,8,2,1
33,186,186,26,1,25,2,1
19,190,190,1,1,0,1,0
28,192,192,23,3,20,3,2
1,197,197,1,1,0,1,0
31,200,200,61,41,20,3,2
20,207,207,12,12,0,1,0
21,210,210,29,29,0,1,0
11,212,212,5,5,0,1,0
14,230,230,95,95,0,1,0
9,230,230,9,9,0,1,0
34,232,232,9,9,0,1,0
23,255,255,15,4,11,2,1
3,278,278,7,7,0,1,0
13,308,308,40,4,36,4,3
30,313,313,23,1,22,3,2
16,315,315,11,1,10,2,1
17,317,317,80,51,29,4,3
7,329,329,13,13,0,1,0
0,343,343,1,1,0,1,0
6,366,366,42,18,24,3,2
24,374,374,29,29,0,1,0
15,375,375,15,15,0,1,0
2,389,389,27,15,12,4,3
26,392,392,18,1,17,2,1
12,397,397,96,73,23,2,1
32,407,407,8,8,0,1,0
8,414,414,3,3,0,1,0
36,418,418,76,76,0,1,0
38,420,420,97,79,18,2,1
25,440,440,25,25,0,1,0
22,441,441,28,28,0,1,0
39,500,500,43,5,38,2,1

11,101,101,6,6,0,1,0
26,107,107,20,20,0,1,0
25,107,107,11,5,6,3,2
21,120,120,12,12,0,1,0
20,124,124,6,6,0,1,0
19,134,134,5,5,0,1,0
3,135,135,2,2,0,1,0
0,138,138,1,1,0,1,0
35,148,148,13,13,0,1,0
10,155,155,7,7,0,1,0
16,160,160,12,3,9,4,3
1,215,215,9,3,6,2,1
4,223,223,22,2,20,3,2
22,227,227,27,8,19,2,1
33,230,230,73,73,0,1,0
17,234,234,11,11,0,1,0
30,237,237,11,11,0,1,0
13,244,244,29,3,26,2,1
6,274,274,33,23,10,2,1
14,296,296,39,39,0,1,0
9,314,314,1,1,0,1,0
27,325,325,38,22,16,2,1
32,333,333,27,27,0,1,0
5,336,336,45,31,14,2,1
7,344,344,1,1,0,1,0
15,364,364,29,29,0,1,0
18,396,396,41,41,0,1,0
8,396,396,70,1,69,4,3
31,399,399,17,17,0,1,0
36,411,411,100,88,12,4,3
23,416,416,22,22,0,1,0
34,423,423,3,3,0,1,0
24,433,433,27,3,24,3,2
2,436,436,230,182,48,4,3
12,442,442,6,3,3,2,1
29,446,446,49,49,0,1,0
28,471,471,40,6,34,3,2

29,104,104,2,2,0,1,0
19,104,104,15,15,0,1,0
2,104,104,54,4,50,3,2
23,110,110,9,9,0,1,0
22,119,119,20,16,4,2,1
5,127,127,28,8,20,3,2
28,186,186,59,42,17,4,3
25,190,190,34,12,22,3,2
20,194,194,1,1,0,1,0
14,202,202,40,40,0,1,0
10,214,214,20,20,0,1,0
21,219,219,18,13,5,2,1
18,248,248,13,13,0,1,0
3,271,271,22,22,0,1,0
15,272,272,5,5,0,1,0
8,277,277,40,2,38,2,1
6,277,277,56,50,6,3,2
26,283,283,35,35,0,1,0
7,301,301,25,11,14,3,2
27,336,336,3,3,0,1,0
9,362,362,9,9,0,1,0
16,424,424,10,3,7,2,1
17,426,426,105,105,0,1,0
1,432,432,23,17,6,3,2
4,446,446,75,68,7,2,1
24,461,461,36,36,0,1,0
0,468,468,31,5,26,3,2
13,473,473,4,1,3,2,1
12,479,479,46,46,0,1,0
11,484,484,70,70,0,1,0

33,105,105,21,21,0,1,0
37,107,107,10,10,0,1,0
43,110,110,30,30,0,1,0
14,111,111,1,1,0,1,0
29,121,121,4,4,0,1,0
41,127,127,6,6,0,1,0
19,140,140,1,1,0,1,0
11,141,141,7,3,4,2,1
8,150,150,10,10,0,1,0
38,165,165,2,2,0,1,0
6,167,167,2,2,0,1,0
0,177,177,12,12,0,1,0
39,187,187,3,3,0,1,0
21,203,203,6,6,0,1,0
4,212,212,1,1,0,1,0
2,215,215,7,2,5,2,1
35,224,224,4,1,3,2,1
24,233,233,4,4,0,1,0
16,236,236,10,10,0,1,0
34,249,249,46,17,29,2,1
26,255,255,12,4,8,3,2
15,266,266,8,8,0,1,0
12,269,269,11,3,8,3,2
20,287,287,17,17,0,1,0
3,293,293,17,17,0,1,0
42,304,304,48,4,44,4,3
23,334,334,1,1,0,1,0
40,340,340,108,48,60,3,2
27,352,352,48,48,0,1,0
9,355,355,101,78,23,2,1
1,363,363,33,33,0,1,0
32,365,365,19,7,12,4,3
31,369,369,17,17,0,1,0
30,381,381,49,49,0,1,0
25,392,392,1,1,0,1,0
22,394,394,37,5,32,2,1
13,405,405,22,22,0,1,0
36,414,414,35,35,0,1,0
10,420,420,27,18,9,4,3
28,429,429,1,1,0,1,0
7,430,430,25,25,0,1,0
18,456,456,70,22,48,4,3
17,481,481,108,66,42,3,2
5,495,495,121,121,0,1,0

28,119,119,30,30,0,1,0
33,138,138,24,9,15,4,3
32,140,140,27,12,15,2,1
11,164,164,29,29,0,1,0
20,185,185,3,3,0,1,0
24,201,201,8,2,6,2,1
14,205,205,22,14,8,2,1
22,210,210,13,8,5,2,1
19,211,211,24,24,0,1,0
16,216,216,16,9,7,2,1
2,226,226,17,17,0,1,0
30,288,288,4,4,0,1,0
27,291,291,48,48,0,1,0
23,293,293,68,68,0,1,0
18,293,293,11,6,5,2,1
17,300,300,4,4,0,1,0
8,320,320,4,4,0,1,0
26,332,332,3,3,0,1,0
1,342,342,59,59,0,1,0
12,345,345,15,3,12,4,3
7,346,346,66,66,0,1,0
9,356,356,19,19,0,1,0
10,371,371,5,1,4,2,1
31,390,390,22,22,0,1,0
13,395,395,17,5,12,2,1
15,403,403,74,48,26,3,2
3,404,404,6,6,0,1,0
21,430,430,37,10,27,4,3
4,435,435,103,85,18,3,2
5,445,445,104,104,0,1,0
0,449,449,62,62,0,1,0
25,459,459,40,40,0,1,0
29,467,467,16,6,10,2,1
6,472,472,15,15,0,1,0
34,496,496,126,35,91,4,3

14,123,123,12,1,11,2,1
17,130,130,1,1,0,1,0
9,138,138,4,4,0,1,0
1,149,149,27,20,7,2,1
32,155,155,19,3,16,2,1
25,187,187,2,2,0,1,0
15,189,189,26,26,0,1,0
0,199,199,7,3,4,2,1
19,201,201,46,46,0,1,0
22,203,203,9,4,5,2,1
29,203,203,24,13,11,2,1
31,203,203,23,5,18,2,1
10,206,206,14,4,10,3,2
16,207,207,15,10,5,2,1
3,223,223,59,44,15,4,3
24,223,223,13,13,0,1,0
23,226,226,61,61,0,1,0
2,246,246,4,1,3,2,1
20,248,248,8,8,0,1,0
38,261,261,9,9,0,1,0
18,278,278,11,1,10,3,2
8,307,307,1,1,0,1,0
6,310,310,20,20,0,1,0
34,312,312,6,6,0,1,0
33,323,323,56,56,0,1,0
27,329,329,25,9,16,2,1
35,330,330,11,11,0,1,0
5,334,334,29,12,17,2,1
11,334,334,15,15,0,1,0
4,351,351,6,3,3,2,1
7,373,373,42,42,0,1,0
30,375,375,3,3,0,1,0
37,392,392,1,1,0,1,0
26,421,421,22,3,19,3,2
28,438,438,203,63,140,4,3
21,443,443,11,3,8,2,1
12,458,458,108,93,15,4,3
36,464,464,69,25,44,4,3
39,464,464,41,41,0,1,0
13,478,478,1,1,0,1,0

14,110,110,6,6,0,1,0
9,112,112,5,5,0,1,0
8,126,126,6,2,4,2,1
7,135,135,5,1,4,2,1
36,156,156,79,64,15,4,3
18,159,159,1,1,0,1,0
1,163,163,1,1,0,1,0
16,167,167,16,4,12,2,1
17,183,183,4,4,0,1,0
27,192,192,3,3,0,1,0
25,202,202,49,13,36,2,1
32,205,205,41,41,0,1,0
15,230,230,8,8,0,1,0
6,230,230,38,26,12,2,1
35,237,237,6,1,5,2,1
10,253,253,45,29,16,2,1
0,254,254,24,14,10,3,2
24,258,258,15,15,0,1,0
4,269,269,50,16,34,4,3
5,274,274,6,6,0,1,0
19,293,293,31,31,0,1,0
33,324,324,17,17,0,1,0
2,325,325,24,3,21,4,3
26,333,333,33,6,27,4,3
21,355,355,40,16,24,4,3
13,359,359,23,9,14,2,1
20,363,363,4,4,0,1,0
34,367,367,4,4,0,1,0
29,368,368,18,18,0,1,0
11,374,374,3,3,0,1,0
39,377,377,11,3,8,2,1
12,396,396,58,27,31,2,1
30,397,397,13,13,0,1,0
38,403,403,9,3,6,2,1
37,414,414,38,38,0,1,0
28,416,416,2,2,0,1,0
23,432,432,55,7,48,3,2
31,438,438,31,31,0,1,0
3,453,453,95,11,84,4,3
40,480,480,93,3,90,4,3
22,499,499,38,12,26,3,2

22,105,105,1,1,0,1,0
21,107,107,6,6,0,1,0
4,111,111,34,15,19,2,1
34,119,119,5,1,4,2,1
37,131,131,28,28,0,1,0
16,132,132,5,5,0,1,0
28,145,145,20,20,0,1,0
6,149,149,2,2,0,1,0
31,151,151,8,8,0,1,0
7,166,166,2,2,0,1,0
10,174,174,1,1,0,1,0
24,176,176,34,14,20,2,1
3,202,202,29,1,28,3,2
8,208,208,28,28,0,1,0
32,229,229,2,2,0,1,0
12,234,234,20,20,0,1,0
30,241,241,38,38,0,1,0
13,250,250,1,1,0,1,0
19,251,251,6,6,0,1,0
39,256,256,108,14,94,3,2
15,268,268,8,1,7,2,1
20,289,289,7,3,4,2,1
35,294,294,19,19,0,1,0
11,295,295,1,1,0,1,0
14,307,307,3,3,0,1,0
26,312,312,65,65,0,1,0
29,319,319,3,3,0,1,0
33,322,322,2,2,0,1,0
1,355,355,11,1,10,2,1
25,369,369,6,1,5,2,1
36,381,381,25,16,9,4,3
5,385,385,50,50,0,1,0
23,389,389,55,19,36,4,3
27,396,396,1,1,0,1,0
17,400,400,37,29,8,2,1
40,426,426,37,7,30,3,2
2,437,437,17,17,0,1,0
0,445,445,56,56,0,1,0
38,453,453,5,5,0,1,0
9,458,458,176,80,96,3,2
18,492,492,49,15,34,3,2

40,107,107,9,9,0,1,0
21,110,110,2,2,0,1,0
13,113,113,1,1,0,1,0
34,114,114,6,6,0,1,0
16,128,128,2,2,0,1,0
36,134,134,31,31,0,1,0
1,139,139,20,3,17,2,1
18,140,140,4,1,3,2,1
24,144,144,4,4,0,1,0
22,149,149,5,5,0,1,0
4,159,159,13,13,0,1,0
38,172,172,2,2,0,1,0
15,180,180,1,1,0,1,0
28,194,194,12,7,5,2,1
32,210,210,9,9,0,1,0
12,222,222,3,3,0,1,0
3,231,231,13,13,0,1,0
41,237,237,39,28,11,2,1
8,241,241,44,6,38,2,1
43,242,242,16,16,0,1,0
31,260,260,15,15,0,1,0
30,278,278,15,15,0,1,0
10,279,279,35,21,14,2,1
7,289,289,10,4,6,2,1
6,293,293,9,5,4,2,1
37,297,297,34,34,0,1,0
5,299,299,6,2,4,2,1
45,313,313,63,63,0,1,0
33,317,317,57,22,35,2,1
27,343,343,4,1,3,2,1
11,347,347,3,3,0,1,0
25,380,380,14,3,11,2,1
2,395,395,32,18,14,2,1
0,413,413,16,7,9,2,1
42,420,420,10,10,0,1,0
44,420,420,97,97,0,1,0
23,421,421,8,8,0,1,0
17,423,423,153,112,41,4,3
35,423,423,21,4,17,4,3
29,425,425,44,44,0,1,0
19,435,435,10,7,3,2,1
9,435,435,81,57,24,4,3
20,444,444,27,15,12,3,2
14,472,472,62,62,0,1,0
39,492,492,50,34,16,2,1
26,497,497,8,8,0,1,0

35,109,109,19,1,18,3,2
23,117,117,15,15,0,1,0
34,143,143,9,3,6,2,1
5,143,143,2,2,0,1,0
14,148,148,25,1,24,3,2
27,160,160,62,36,26,4,3
24,171,171,3,3,0,1,0
10,206,206,11,11,0,1,0
21,207,207,12,12,0,1,0
25,239,239,52,36,16,2,1
22,268,268,5,5,0,1,0
13,291,291,75,1,74,4,3
15,303,303,47,1,46,2,1
33,313,313,83,37,46,2,1
18,320,320,6,6,0,1,0
20,329,329,87,66,21,2,1
30,337,337,12,7,5,2,1
4,339,339,16,5,11,4,3
16,351,351,13,4,9,2,1
28,353,353,3,3,0,1,0
19,358,358,28,10,18,3,2
0,361,361,10,10,0,1,0
26,373,373,17,9,8,3,2
31,376,376,4,4,0,1,0
3,386,386,22,22,0,1,0
6,387,387,6,1,5,2,1
17,393,393,60,60,0,1,0
1,408,408,190,190,0,1,0
8,419,419,9,9,0,1,0
12,428,428,2,2,0,1,0
9,448,448,50,41,9,4,3
2,457,457,5,1,4,2,1
7,480,480,1,1,0,1,0
11,486,486,96,81,15,4,3
32,488,488,3,3,0,1,0
29,500,500,19,15,4,2,1

19,111,111,28,28,0,1,0
24,142,142,19,15,4,2,1
6,143,143,9,3,6,3,2
14,148,148,32,14,18,4,3
32,150,150,54,22,32,3,2
20,185,185,86,86,0,1,0
18,191,191,24,24,0,1,0
2,203,203,1,1,0,1,0
11,207,207,22,22,0,1,0
34,212,212,13,3,10,3,2
5,225,225,24,24,0,1,0
17,262,262,24,24,0,1,0
21,262,262,19,16,3,2,1
35,269,269,31,31,0,1,0
25,277,277,12,7,5,2,1
1,281,281,13,13,0,1,0
28,282,282,10,7,3,2,1
26,291,291,19,4,15,4,3
33,299,299,17,17,0,1,0
15,304,304,12,12,0,1,0
30,322,322,3,3,0,1,0
0,331,331,37,4,33,4,3
8,365,365,14,14,0,1,0
27,366,366,18,18,0,1,0
4,386,386,13,13,0,1,0
12,392,392,110,74,36,4,3
16,395,395,15,2,13,3,2
36,437,437,26,26,0,1,0
22,438,438,1,1,0,1,0
10,447,447,75,17,58,4,3
31,452,452,1,1,0,1,0
23,469,469,14,1,13,3,2
3,470,470,31,31,0,1,0
7,474,474,1,1,0,1,0
9,485,485,116,23,93,4,3
13,491,491,12,12,0,1,0
29,496,496,13,10,3,2,1

25,101,101,5,5,0,1,0
23,112,112,2,2,0,1,0
20,157,157,11,11,0,1,0
6,161,161,9,9,0,1,0
30,198,198,68,8,60,4,3
9,203,203,30,1,29,2,1
0,211,211,9,1,8,2,1
7,212,212,42,42,0,1,0
27,214,214,15,10,5,2,1
5,225,225,3,3,0,1,0
11,225,225,24,18,6,2,1
18,227,227,17,9,8,2,1
33,241,241,74,24,50,2,1
4,243,243,36,12,24,4,3
24,243,243,4,4,0,1,0
2,262,262,39,30,9,4,3
26,297,297,42,10,32,3,2
32,305,305,12,2,10,2,1
29,314,314,38,16,22,3,2
3,329,329,64,64,0,1,0
14,329,329,30,2,28,3,2
15,332,332,12,7,5,2,1
31,342,342,2,2,0,1,0
22,343,343,46,20,26,2,1
13,385,385,30,30,0,1,0
12,400,400,134,73,61,4,3
8,402,402,9,6,3,2,1
17,402,402,8,8,0,1,0
1,424,424,21,21,0,1,0
28,432,432,38,38,0,1,0
16,450,450,9,9,0,1,0
10,476,476,63,24,39,4,3
21,480,480,57,23,34,2,1
19,490,490,96,96,0,1,0

28,102,102,17,6,11,2,1
20,120,120,1,1,0,1,0
12,129,129,1,1,0,1,0
2,149,149,4,4,0,1,0
5,158,158,1,1,0,1,0
8,164,164,33,27,6,2,1
36,170,170,15,15,0,1,0
16,186,186,5,5,0,1,0
19,189,189,17,5,12,2,1
27,200,200,5,5,0,1,0
35,214,214,14,14,0,1,0
30,225,225,41,41,0,1,0
15,230,230,27,12,15,4,3
11,246,246,53,53,0,1,0
18,255,255,72,31,41,2,1
21,257,257,51,23,28,3,2
17,272,272,2,2,0,1,0
24,294,294,16,4,12,2,1
26,298,298,16,16,0,1,0
4,301,301,5,5,0,1,0
32,303,303,13,13,0,1,0
29,308,308,2,2,0,1,0
31,337,337,120,92,28,3,2
10,338,338,174,174,0,1,0
23,344,344,4,4,0,1,0
34,373,373,41,20,21,3,2
6,379,379,2,2,0,1,0
3,380,380,1,1,0,1,0
13,384,384,4,4,0,1,0
22,429,429,56,6,50,3,2
9,441,441,20,2,18,2,1
14,442,442,20,12,8,2,1
25,452,452,3,3,0,1,0
1,459,459,30,30,0,1,0
33,460,460,107,23,84,4,3
0,472,472,48,37,11,2,1
7,499,499,52,52,0,1,0

3,114,114,30,30,0,1,0
21,117,117,7,7,0,1,0
22,121,121,5,5,0,1,0
37,141,141,17,3,14,3,2
9,153,153,30,30,0,1,0
19,157,157,12,12,0,1,0
32,172,172,10,10,0,1,0
29,186,186,136,125,11,2,1
14,193,193,10,1,9,2,1
0,195,195,10,10,0,1,0
7,211,211,22,22,0,1,0
2,213,213,13,5,8,3,2
10,214,214,19,19,0,1,0
6,215,215,17,17,0,1,0
34,219,219,2,2,0,1,0
12,247,247,4,4,0,1,0
36,250,250,11,11,0,1,0
13,260,260,2,2,0,1,0
18,263,263,12,5,7,2,1
20,281,281,42,42,0,1,0
4,283,283,14,8,6,3,2
27,285,285,63,16,47,3,2
33,304,304,1,1,0,1,0
16,313,313,16,7,9,4,3
15,316,316,34,34,0,1,0
8,333,333,17,17,0,1,0
25,339,339,7,4,3,2,1
17,354,354,41,19,22,3,2
30,369,369,2,2,0,1,0
1,389,389,89,89,0,1,0
35,397,397,5,5,0,1,0
24,418,418,3,3,0,1,0
31,421,421,28,28,0,1,0
11,427,427,1,1,0,1,0
5,446,446,70,37,33,2,1
23,460,460,13,13,0,1,0
26,471,471,101,101,0,1,0
28,480,480,20,20,0,1,0

4,101,101,1,1,0,1,0
32,104,104,1,1,0,1,0
27,114,114,22,22,0,1,0
15,137,137,11,8,3,2,1
38,170,170,6,6,0,1,0
16,173,173,68,68,0,1,0
1,174,174,19,1,18,4,3
20,193,193,18,18,0,1,0
33,204,204,30,10,20,3,2
29,211,211,3,3,0,1,0
23,212,212,71,71,0,1,0
21,214,214,33,33,0,1,0
8,226,226,32,32,0,1,0
17,256,256,38,38,0,1,0
35,275,275,14,2,12,3,2
36,287,287,2,2,0,1,0
37,292,292,25,13,12,4,3
13,293,293,12,8,4,2,1
10,294,294,8,1,7,2,1
19,298,298,1,1,0,1,0
5,322,322,19,10,9,4,3
6,327,327,10,10,0,1,0
24,329,329,98,22,76,3,2
7,334,334,62,16,46,3,2
26,341,341,49,37,12,4,3
22,349,349,19,19,0,1,0
2,372,372,34,34,0,1,0
31,397,397,65,65,0,1,0
14,414,414,29,29,0,1,0
11,418,418,34,34,0,1,0
0,419,419,18,18,0,1,0
34,420,420,16,16,0,1,0
28,422,422,1,1,0,1,0
25,454,454,42,37,5,2,1
9,457,457,21,21,0,1,0
30,470,470,7,7,0,1,0
3,473,473,29,18,11,2,1
12,485,485,4,4,0,1,0
18,498,498,38,38,0,1,0

14,103,103,12,12,0,1,0
30,104,104,2,2,0,1,0
29,173,173,34,16,18,4,3
26,187,187,3,3,0,1,0
1,188,188,54,54,0,1,0
19,212,212,17,17,0,1,0
9,219,219,30,18,12,3,2
13,219,219,24,24,0,1,0
23,236,236,7,7,0,1,0
28,237,237,22,22,0,1,0
5,238,238,55,31,24,3,2
25,241,241,33,21,12,2,1
7,243,243,52,52,0,1,0
11,245,245,11,11,0,1,0
32,248,248,29,29,0,1,0
10,254,254,6,6,0,1,0
16,270,270,5,5,0,1,0
0,275,275,28,10,18,2,1
12,282,282,43,36,7,2,1
6,283,283,5,5,0,1,0
15,300,300,2,2,0,1,0
3,314,314,13,4,9,4,3
2,327,327,45,27,18,4,3
18,366,366,11,3,8,2,1
33,371,371,72,72,0,1,0
27,378,378,44,2,42,3,2
8,443,443,61,61,0,1,0
31,452,452,94,94,0,1,0
24,464,464,40,40,0,1,0
22,465,465,7,7,0,1,0
21,473,473,22,22,0,1,0
17,474,474,31,31,0,1,0
20,478,478,177,99,78,4,3
4,499,499,21,21,0,1,0

30,105,105,3,3,0,1,0
8,146,146,19,4,15,2,1
23,147,147,24,24,0,1,0
28,156,156,14,2,12,4,3
29,159,159,3,3,0,1,0
2,162,162,1,1,0,1,0
10,162,162,12,12,0,1,0
1,165,165,100,66,34,2,1
25,180,180,13,13,0,1,0
24,187,187,7,7,0,1,0
27,188,188,7,4,3,2,1
16,224,224,9,9,0,1,0
0,233,233,120,28,92,4,3
13,234,234,12,12,0,1,0
20,269,269,23,14,9,2,1
9,272,272,21,21,0,1,0
31,297,297,35,35,0,1,0
12,299,299,3,3,0,1,0
7,303,303,3,3,0,1,0
22,307,307,20,20,0,1,0
15,317,317,92,12,80,3,2
26,351,351,2,2,0,1,0
5,354,354,36,36,0,1,0
4,364,364,13,3,10,2,1
3,399,399,24,24,0,1,0
19,407,407,45,29,16,2,1
11,421,421,29,19,10,3,2
18,435,435,62,62,0,1,0
17,435,435,23,23,0,1,0
21,470,470,37,13,24,3,2
6,485,485,28,14,14,2,1
14,493,493,199,141,58,4,3

36,114,114,30,30,0,1,0
23,127,127,17,17,0,1,0
18,128,128,3,3,0,1,0
0,129,129,3,3,0,1,0
26,132,132,3,3,0,1,0
20,137,137,27,27,0,1,0
28,167,167,4,4,0,1,0
16,182,182,22,19,3,2,1
14,205,205,7,7,0,1,0
1,206,206,1,1,0,1,0
33,210,210,19,10,9,4,3
11,219,219,1,1,0,1,0
2,220,220,3,3,0,1,0
21,223,223,65,65,0,1,0
3,233,233,19,19,0,1,0
6,255,255,2,2,0,1,0
30,257,257,48,37,11,2,1
35,268,268,22,22,0,1,0
24,271,271,6,6,0,1,0
39,292,292,19,1,18,3,2
38,298,298,39,29,10,3,2
5,300,300,17,9,8,3,2
7,300,300,18,18,0,1,0
10,304,304,25,14,11,2,1
37,327,327,2,2,0,1,0
27,327,327,41,41,0,1,0
9,337,337,72,13,59,3,2
15,340,340,33,33,0,1,0
31,343,343,34,34,0,1,0
29,375,375,35,35,0,1,0
25,395,395,29,7,22,2,1
4,411,411,36,10,26,2,1
8,413,413,51,51,0,1,0
34,422,422,10,10,0,1,0
12,448,448,63,24,39,2,1
32,452,452,40,6,34,3,2
13,464,464,1,1,0,1,0
19,469,469,62,62,0,1,0
17,471,471,1,1,0,1,0
22,474,474,145,145,0,1,0

34,107,107,1,1,0,1,0
16,122,122,11,1,10,2,1
39,135,135,44,21,23,2,1
11,146,146,4,4,0,1,0
28,151,151,7,7,0,1,0
0,159,159,12,12,0,1,0
33,173,173,37,22,15,2,1
36,179,179,27,10,17,4,3
7,195,195,3,3,0,1,0
3,197,197,24,24,0,1,0
14,203,203,38,14,24,3,2
12,230,230,6,3,3,2,1
17,231,231,11,11,0,1,0
29,231,231,60,60,0,1,0
18,249,249,28,2,26,4,3
23,251,251,19,19,0,1,0
1,254,254,7,7,0,1,0
31,265,265,12,12,0,1,0
2,265,265,1,1,0,1,0
32,267,267,11,11,0,1,0
8,268,268,51,51,0,1,0
19,289,289,6,6,0,1,0
10,290,290,4,4,0,1,0
30,290,290,12,12,0,1,0
37,292,292,10,2,8,3,2
26,300,300,9,9,0,1,0
5,307,307,28,28,0,1,0
24,309,309,54,54,0,1,0
27,340,340,52,4,48,3,2
9,346,346,7,3,4,2,1
21,378,378,123,50,73,4,3
40,385,385,17,17,0,1,0
35,390,390,5,5,0,1,0
4,427,427,8,8,0,1,0
38,428,428,46,46,0,1,0
15,446,446,14,4,10,4,3
13,447,447,28,10,18,4,3
25,466,466,32,32,0,1,0
6,471,471,11,1,10,3,2
22,475,475,10,10,0,1,0
20,488,488,121,5,116,4,3

33,113,113,1,1,0,1,0
7,114,114,33,33,0,1,0
35,114,114,14,14,0,1,0
16,145,145,11,11,0,1,0
17,149,149,7,7,0,1,0
8,160,160,10,6,4,2,1
15,163,163,1,1,0,1,0
30,166,166,2,2,0,1,0
4,189,189,11,6,5,2,1
0,192,192,63,63,0,1,0
5,209,209,58,48,10,3,2
12,226,226,24,24,0,1,0
25,244,244,6,6,0,1,0
36,251,251,2,2,0,1,0
27,258,258,64,29,35,2,1
22,264,264,3,3,0,1,0
6,287,287,34,8,26,2,1
21,299,299,10,10,0,1,0
24,302,302,11,3,8,2,1
13,303,303,33,21,12,2,1
3,316,316,2,2,0,1,0
23,316,316,9,5,4,2,1
2,344,344,8,8,0,1,0
32,356,356,37,37,0,1,0
11,370,370,4,4,0,1,0
26,377,377,1,1,0,1,0
20,384,384,65,36,29,4,3
10,385,385,77,74,3,2,1
28,419,419,9,4,5,2,1
29,419,419,145,112,33,4,3
14,442,442,2,2,0,1,0
18,447,447,2,2,0,1,0
1,455,455,7,2,5,2,1
9,455,455,26,23,3,2,1
31,479,479,143,17,126,4,3
19,484,484,159,159,0,1,0
34,494,494,17,17,0,1,0

7,124,124,2,2,0,1,0
25,130,130,4,4,0,1,0
31,163,163,15,11,4,2,1
0,164,164,8,5,3,2,1
10,174,174,10,10,0,1,0
4,187,187,51,51,0,1,0
17,193,193,14,2,12,2,1
11,194,194,14,14,0,1,0
19,196,196,10,10,0,1,0
37,198,198,48,17,31,2,1
20,202,202,3,3,0,1,0
28,205,205,8,8,0,1,0
39,209,209,5,5,0,1,0
8,220,220,1,1,0,1,0
26,226,226,41,41,0,1,0
21,229,229,5,2,3,2,1
16,239,239,9,9,0,1,0
23,242,242,33,33,0,1,0
13,245,245,11,11,0,1,0
9,249,249,52,52,0,1,0
15,283,283,48,48,0,1,0
12,286,286,39,32,7,2,1
14,290,290,1,1,0,1,0
34,296,296,5,5,0,1,0
36,297,297,3,3,0,1,0
1,299,299,111,24,87,4,3
22,304,304,15,1,14,4,3
3,307,307,9,6,3,2,1
38,320,320,24,4,20,3,2
24,329,329,24,3,21,2,1
29,344,344,23,23,0,1,0
33,345,345,56,56,0,1,0
32,366,366,34,34,0,1,0
27,380,380,38,10,28,3,2
40,417,417,86,20,66,4,3
18,423,423,6,6,0,1,0
30,432,432,104,93,11,2,1
6,441,441,41,38,3,2,1
2,443,443,4,1,3,2,1
5,445,445,1,1,0,1,0
35,495,495,23,23,0,1,0

22,109,109,11,2,9,4,3
9,115,115,1,1,0,1,0
8,125,125,4,4,0,1,0
14,133,133,15,15,0,1,0
3,149,149,52,52,0,1,0
7,152,152,62,36,26,2,1
26,156,156,15,15,0,1,0
27,161,161,23,23,0,1,0
16,174,174,7,7,0,1,0
21,191,191,16,16,0,1,0
17,199,199,37,37,0,1,0
32,201,201,37,37,0,1,0
20,210,210,33,6,27,2,1
2,216,216,15,4,11,2,1
12,225,225,1,1,0,1,0
29,228,228,7,7,0,1,0
36,231,231,63,27,36,2,1
15,242,242,6,6,0,1,0
35,262,262,5,5,0,1,0
30,265,265,41,41,0,1,0
1,274,274,6,6,0,1,0
19,292,292,5,5,0,1,0
33,312,312,6,6,0,1,0
4,324,324,55,55,0,1,0
23,331,331,9,9,0,1,0
10,346,346,3,3,0,1,0
18,378,378,39,39,0,1,0
11,388,388,11,11,0,1,0
34,406,406,30,24,6,3,2
5,414,414,27,10,17,2,1
31,417,417,91,5,86,3,2
6,423,423,21,21,0,1,0
25,436,436,73,23,50,2,1
28,439,439,21,3,18,3,2
24,463,463,9,1,8,3,2
0,483,483,44,30,14,3,2
13,495,495,14,14,0,1,0

1,114,114,1,1,0,1,0
3,135,135,8,8,0,1,0
25,150,150,36,36,0,1,0
7,189,189,23,23,0,1,0
5,192,192,9,1,8,2,1
11,205,205,16,16,0,1,0
6,206,206,22,22,0,1,0
26,225,225,3,3,0,1,0
10,226,226,4,4,0,1,0
20,248,248,21,21,0,1,0
14,261,261,155,155,0,1,0
0,292,292,1,1,0,1,0
33,307,307,32,3,29,2,1
18,324,324,32,32,0,1,0
12,324,324,4,4,0,1,0
22,343,343,28,10,18,4,3
17,351,351,107,75,32,4,3
15,353,353,34,6,28,2,1
35,356,356,102,62,40,2,1
8,359,359,6,1,5,2,1
34,371,371,17,5,12,4,3
28,373,373,4,1,3,2,1
32,384,384,53,39,14,3,2
30,384,384,26,17,9,2,1
19,385,385,14,14,0,1,0
23,391,391,96,96,0,1,0
24,394,394,7,7,0,1,0
9,406,406,56,47,9,2,1
13,411,411,34,19,15,2,1
2,417,417,8,8,0,1,0
4,433,433,32,6,26,3,2
29,451,451,73,73,0,1,0
16,459,459,9,1,8,2,1
31,462,462,20,20,0,1,0
21,497,497,19,5,14,3,2
27,499,499,55,55,0,1,0

15,111,111,1,1,0,1,0
36,115,115,56,2,54,3,2
7,116,116,23,3,20,2,1
3,118,118,4,4,0,1,0
10,137,137,14,1,13,2,1
22,149,149,1,1,0,1,0
39,154,154,7,7,0,1,0
27,166,166,4,4,0,1,0
2,171,171,9,3,6,2,1
38,176,176,28,28,0,1,0
11,180,180,1,1,0,1,0
6,191,191,54,20,34,3,2
32,216,216,25,25,0,1,0
26,217,217,8,8,0,1,0
45,223,223,8,2,6,2,1
8,224,224,16,4,12,2,1
13,228,228,5,5,0,1,0
33,234,234,7,7,0,1,0
14,241,241,42,42,0,1,0
25,250,250,22,22,0,1,0
1,251,251,7,3,4,2,1
37,257,257,11,2,9,2,1
44,258,258,2,2,0,1,0
28,266,266,2,2,0,1,0
24,270,270,3,3,0,1,0
35,275,275,22,3,19,4,3
5,284,284,2,2,0,1,0
4,289,289,7,3,4,2,1
34,303,303,43,43,0,1,0
31,303,303,9,9,0,1,0
43,306,306,8,8,0,1,0
16,356,356,5,5,0,1,0
17,364,364,10,10,0,1,0
0,372,372,10,2,8,2,1
46,375,375,12,12,0,1,0
41,386,386,29,2,27,2,1
40,391,391,28,28,0,1,0
42,399,399,60,5,55,4,3
12,402,402,4,4,0,1,0
30,406,406,63,5,58,3,2
23,409,409,71,29,42,4,3
47,455,455,69,69,0,1,0
20,460,460,35,11,24,4,3
9,461,461,16,16,0,1,0
19,462,462,15,2,13,2,1
18,462,462,59,59,0,1,0
21,480,480,7,7,0,1,0
29,492,492,38,38,0,1,0

23,105,105,3,3,0,1,0
18,106,106,16,3,13,2,1
22,108,108,1,1,0,1,0
40,130,130,29,29,0,1,0
29,142,142,8,8,0,1,0
35,175,175,19,2,17,2,1
33,177,177,23,4,19,2,1
20,183,183,18,18,0,1,0
1,184,184,8,4,4,2,1
26,197,197,49,49,0,1,0
36,201,201,8,3,5,2,1
13,203,203,35,35,0,1,0
43,218,218,42,42,0,1,0
7,228,228,13,13,0,1,0
31,228,228,9,9,0,1,0
25,234,234,7,7,0,1,0
17,237,237,33,12,21,4,3
38,238,238,23,14,9,4,3
21,244,244,6,6,0,1,0
2,246,246,1,1,0,1,0
4,246,246,6,6,0,1,0
10,250,250,52,10,42,2,1
6,271,271,10,10,0,1,0
15,297,297,2,2,0,1,0
27,315,315,1,1,0,1,0
3,332,332,116,116,0,1,0
39,335,335,35,35,0,1,0
12,336,336,6,6,0,1,0
32,337,337,32,32,0,1,0
8,338,338,2,2,0,1,0
41,345,345,3,3,0,1,0
42,346,346,3,3,0,1,0
28,367,367,70,70,0,1,0
19,390,390,47,5,42,4,3
37,403,403,38,28,10,3,2
24,413,413,5,5,0,1,0
30,416,416,16,4,12,4,3
11,430,430,4,4,0,1,0
0,443,443,5,5,0,1,0
5,451,451,49,49,0,1,0
9,464,464,8,8,0,1,0
14,474,474,4,4,0,1,0
16,485,485,53,2,51,4,3
34,490,490,74,74,0,1,0

5,107,107,1,1,0,1,0
17,117,117,8,8,0,1,0
29,135,135,1,1,0,1,0
12,158,158,24,5,19,2,1
0,162,162,6,3,3,2,1
35,178,178,4,4,0,1,0
34,195,195,12,3,9,2,1
11,205,205,28,8,20,2,1
30,213,213,17,17,0,1,0
3,221,221,6,6,0,1,0
27,223,223,5,1,4,2,1
18,230,230,10,10,0,1,0
6,235,235,41,1,40,4,3
25,240,240,78,56,22,3,2
13,262,262,1,1,0,1,0
7,266,266,1,1,0,1,0
28,293,293,62,62,0,1,0
10,298,298,37,17,20,3,2
32,301,301,78,78,0,1,0
21,301,301,13,1,12,4,3
9,304,304,20,9,11,2,1
23,304,304,34,34,0,1,0
2,324,324,20,5,15,2,1
33,359,359,21,21,0,1,0
4,374,374,25,4,21,4,3
8,408,408,112,97,15,4,3
20,415,415,11,7,4,2,1
26,426,426,21,21,0,1,0
14,447,447,116,53,63,4,3
24,457,457,122,122,0,1,0
16,463,463,86,59,27,4,3
22,474,474,10,10,0,1,0
15,478,478,50,12,38,2,1
31,487,487,30,30,0,1,0
1,489,489,26,14,12,3,2
19,491,491,77,51,26,3,2

33,106,106,21,21,0,1,0
22,116,116,9,9,0,1,0
37,117,117,16,10,6,2,1
18,124,124,1,1,0,1,0
14,138,138,20,20,0,1,0
36,170,170,4,4,0,1,0
21,199,199,6,6,0,1,0
3,204,204,11,11,0,1,0
9,218,218,31,31,0,1,0
10,227,227,5,5,0,1,0
13,244,244,3,3,0,1,0
15,255,255,5,5,0,1,0
17,283,283,37,26,11,2,1
5,285,285,25,25,0,1,0
32,288,288,27,27,0,1,0
1,301,301,35,27,8,3,2
24,302,302,15,2,13,3,2
19,303,303,5,5,0,1,0
30,316,316,23,13,10,3,2
11,318,318,17,3,14,3,2
2,333,333,19,19,0,1,0
27,342,342,49,41,8,3,2
34,344,344,24,24,0,1,0
26,354,354,24,10,14,4,3
20,370,370,70,47,23,2,1
6,370,370,5,5,0,1,0
12,373,373,11,11,0,1,0
31,381,381,30,30,0,1,0
25,389,389,56,6,50,2,1
7,389,389,31,31,0,1,0
0,409,409,129,33,96,4,3
28,427,427,163,163,0,1,0
8,429,429,39,39,0,1,0
35,439,439,11,6,5,2,1
16,441,441,1,1,0,1,0
29,443,443,7,4,3,2,1
23,451,451,17,3,14,2,1
4,475,475,192,174,18,4,3

16,120,120,11,11,0,1,0
12,127,127,3,3,0,1,0
4,149,149,6,6,0,1,0
20,152,152,9,9,0,1,0
1,158,158,2,2,0,1,0
7,166,166,3,3,0,1,0
5,193,193,46,41,5,2,1
33,194,194,6,6,0,1,0
25,206,206,41,41,0,1,0
30,223,223,23,15,8,2,1
11,248,248,26,10,16,2,1
24,250,250,13,13,0,1,0
28,262,262,1,1,0,1,0
35,269,269,19,19,0,1,0
17,276,276,12,12,0,1,0
31,283,283,28,28,0,1,0
36,290,290,64,1,63,4,3
15,297,297,14,14,0,1,0
2,307,307,111,82,29,2,1
18,329,329,37,4,33,2,1
19,337,337,55,42,13,2,1
10,345,345,6,6,0,1,0
8,362,362,77,28,49,4,3
32,363,363,38,16,22,3,2
29,366,366,23,23,0,1,0
9,383,383,24,3,21,2,1
21,387,387,58,6,52,3,2
34,393,393,13,13,0,1,0
22,400,400,42,42,0,1,0
27,415,415,9,9,0,1,0
26,416,416,146,146,0,1,0
13,420,420,54,34,20,2,1
6,426,426,1,1,0,1,0
0,428,428,25,25,0,1,0
14,470,470,69,33,36,2,1
23,490,490,1,1,0,1,0
3,491,491,38,28,10,2,1

1,105,105,14,2,12,4,3
2,114,114,3,3,0,1,0
39,126,126,6,6,0,1,0
25,137,137,1,1,0,1,0
26,159,159,28,28,0,1,0
38,161,161,21,21,0,1,0
29,163,163,10,10,0,1,0
23,173,173,19,7,12,3,2
36,211,211,10,2,8,3,2
18,219,219,27,4,23,2,1
16,227,227,10,10,0,1,0
22,245,245,11,2,9,4,3
27,255,255,10,10,0,1,0
6,258,258,1,1,0,1,0
14,261,261,18,18,0,1,0
8,266,266,11,11,0,1,0
3,270,270,3,3,0,1,0
0,271,271,21,21,0,1,0
9,285,285,4,4,0,1,0
15,295,295,53,53,0,1,0
4,296,296,19,10,9,4,3
35,309,309,75,51,24,4,3
12,326,326,8,2,6,3,2
13,356,356,22,22,0,1,0
10,362,362,49,32,17,2,1
32,363,363,43,43,0,1,0
11,370,370,10,2,8,2,1
5,372,372,67,3,64,3,2
28,380,380,63,38,25,2,1
20,383,383,15,15,0,1,0
37,396,396,32,18,14,2,1
33,401,401,16,6,10,2,1
30,405,405,80,66,14,2,1
24,406,406,19,19,0,1,0
19,420,420,62,62,0,1,0
17,426,426,48,48,0,1,0
34,426,426,55,52,3,2,1
40,438,438,15,4,11,2,1
31,458,458,72,30,42,3,2
7,484,484,12,7,5,2,1
21,497,497,108,108,0,1,0

2,101,101,11,11,0,1,0
18,113,113,4,4,0,1,0
3,118,118,4,4,0,1,0
4,145,145,36,2,34,2,1
8,154,154,38,33,5,2,1
9,160,160,8,8,0,1,0
12,171,171,1,1,0,1,0
17,174,174,35,35,0,1,0
27,176,176,1,1,0,1,0
35,179,179,2,2,0,1,0
26,183,183,7,1,6,2,1
33,188,188,10,10,0,1,0
19,199,199,44,16,28,2,1
10,216,216,14,8,6,2,1
20,237,237,6,1,5,2,1
16,251,251,21,7,14,3,2
11,253,253,34,34,0,1,0
23,258,258,53,53,0,1,0
36,297,297,7,7,0,1,0
28,312,312,74,74,0,1,0
30,359,359,46,46,0,1,0
7,372,372,52,52,0,1,0
21,384,384,87,87,0,1,0
25,392,392,14,14,0,1,0
32,395,395,52,52,0,1,0
13,402,402,30,18,12,4,3
22,424,424,34,6,28,2,1
5,431,431,5,5,0,1,0
34,432,432,66,66,0,1,0
15,446,446,45,45,0,1,0
29,450,450,22,5,17,2,1
1,455,455,1,1,0,1,0
0,455,455,30,30,0,1,0
14,459,459,8,2,6,2,1
24,478,478,85,28,57,4,3
31,481,481,11,2,9,2,1
6,495,495,87,87,0,1,0

5,100,100,1,1,0,1,0
24,106,106,2,2,0,1,0
19,106,106,7,7,0,1,0
38,113,113,3,3,0,1,0
4,117,117,23,5,18,4,3
41,139,139,23,12,11,2,1
14,144,144,4,4,0,1,0
0,151,151,4,4,0,1,0
36,153,153,5,1,4,2,1
12,154,154,44,15,29,4,3
3,161,161,25,25,0,1,0
18,164,164,1,1,0,1,0
2,182,182,1,1,0,1,0
13,187,187,13,13,0,1,0
40,190,190,3,3,0,1,0
44,202,202,14,8,6,2,1
10,209,209,36,36,0,1,0
20,210,210,13,13,0,1,0
26,212,212,7,7,0,1,0
15,222,222,3,3,0,1,0
8,253,253,15,9,6,2,1
28,259,259,80,80,0,1,0
1,260,260,14,14,0,1,0
42,263,263,9,9,0,1,0
23,278,278,37,4,33,4,3
9,282,282,9,9,0,1,0
34,299,299,9,9,0,1,0
21,306,306,9,9,0,1,0
6,309,309,27,9,18,3,2
43,312,312,17,2,15,3,2
25,313,313,5,5,0,1,0
11,340,340,11,11,0,1,0
39,345,345,19,13,6,3,2
27,358,358,46,5,41,2,1
7,360,360,6,2,4,2,1
22,361,361,5,2,3,2,1
31,368,368,27,3,24,3,2
32,390,390,56,18,38,3,2
37,407,407,11,2,9,2,1
16,414,414,40,8,32,4,3
17,443,443,36,15,21,4,3
29,450,450,169,133,36,3,2
33,460,460,55,43,12,4,3
35,476,476,78,66,12,4,3
30,492,492,6,1,5,2,1

2,102,102,4,4,0,1,0
7,104,104,9,3,6,2,1
41,111,111,2,2,0,1,0
35,122,122,1,1,0,1,0
34,136,136,2,2,0,1,0
15,149,149,5,5,0,1,0
24,178,178,37,37,0,1,0
0,191,191,12,12,0,1,0
33,192,192,37,37,0,1,0
6,224,224,1,1,0,1,0
42,228,228,32,32,0,1,0
20,230,230,12,12,0,1,0
18,241,241,1,1,0,1,0
28,241,241,47,27,20,2,1
13,248,248,4,4,0,1,0
27,251,251,43,12,31,4,3
5,251,251,5,5,0,1,0
4,269,269,57,19,38,2,1
38,277,277,16,16,0,1,0
25,279,279,17,4,13,2,1
8,301,301,69,12,57,4,3
12,303,303,11,3,8,3,2
37,315,315,1,1,0,1,0
31,318,318,80,75,5,2,1
26,329,329,84,52,32,2,1
22,358,358,26,26,0,1,0
30,361,361,13,6,7,2,1
11,368,368,34,34,0,1,0
10,378,378,81,72,9,2,1
14,381,381,3,3,0,1,0
1,399,399,9,1,8,2,1
19,406,406,10,10,0,1,0
29,411,411,19,11,8,3,2
39,413,413,82,60,22,2,1
9,413,413,15,1,14,3,2
40,418,418,31,31,0,1,0
17,427,427,45,45,0,1,0
23,449,449,62,62,0,1,0
32,473,473,42,42,0,1,0
16,485,485,13,13,0,1,0
36,489,489,9,9,0,1,0
3,492,492,26,14,12,3,2
21,494,494,3,3,0,1,0

4,110,110,12,1,11,2,1
13,111,111,32,32,0,1,0
8,127,127,1,1,0,1,0
3,128,128,20,12,8,3,2
22,130,130,9,9,0,1,0
14,134,134,1,1,0,1,0
9,145,145,3,3,0,1,0
16,151,151,2,2,0,1,0
11,153,153,4,1,3,2,1
31,177,177,3,3,0,1,0
18,195,195,2,2,0,1,0
1,225,225,12,6,6,3,2
6,239,239,32,32,0,1,0
34,245,245,104,84,20,2,1
15,255,255,10,2,8,2,1
2,257,257,55,11,44,2,1
24,259,259,74,74,0,1,0
28,299,299,13,6,7,2,1
26,301,301,11,11,0,1,0
29,305,305,5,5,0,1,0
20,305,305,7,1,6,2,1
33,339,339,30,30,0,1,0
5,357,357,54,9,45,2,1
12,383,383,9,9,0,1,0
10,385,385,88,62,26,3,2
25,396,396,20,20,0,1,0
32,397,397,25,25,0,1,0
0,399,399,130,130,0,1,0
7,404,404,1,1,0,1,0
27,414,414,51,51,0,1,0
17,418,418,6,2,4,2,1
21,433,433,27,7,20,2,1
23,446,446,102,30,72,3,2
19,451,451,8,8,0,1,0
30,476,476,125,58,67,4,3

7,115,115,19,1,18,3,2
5,116,116,20,11,9,2,1
3,130,130,5,5,0,1,0
0,152,152,12,12,0,1,0
26,154,154,13,5,8,2,1
10,160,160,36,5,31,4,3
16,183,183,31,19,12,3,2
31,188,188,1,1,0,1,0
2,190,190,5,5,0,1,0
8,193,193,81,75,6,2,1
1,196,196,13,13,0,1,0
4,221,221,5,5,0,1,0
27,231,231,28,25,3,2,1
29,252,252,68,39,29,3,2
17,263,263,51,42,9,2,1
15,272,272,18,4,14,3,2
25,274,274,60,3,57,4,3
23,294,294,11,11,0,1,0
21,299,299,42,42,0,1,0
22,319,319,12,12,0,1,0
18,344,344,44,44,0,1,0
14,356,356,61,61,0,1,0
6,357,357,67,61,6,3,2
20,364,364,17,17,0,1,0
24,416,416,9,9,0,1,0
12,425,425,70,70,0,1,0
28,442,442,10,2,8,2,1
30,444,444,5,5,0,1,0
13,445,445,60,52,8,3,2
9,456,456,22,22,0,1,0
19,463,463,40,16,24,3,2
11,471,471,24,2,22,3,2

2,102,102,4,4,0,1,0
26,110,110,10,10,0,1,0
27,111,111,12,2,10,2,1
25,121,121,15,15,0,1,0
28,126,126,11,6,5,2,1
10,137,137,18,18,0,1,0
22,137,137,19,19,0,1,0
24,155,155,22,22,0,1,0
1,173,173,21,21,0,1,0
11,186,186,1,1,0,1,0
21,195,195,38,11,27,2,1
15,224,224,1,1,0,1,0
14,225,225,19,8,11,4,3
4,245,245,19,1,18,2,1
13,287,287,7,4,3,2,1
18,292,292,1,1,0,1,0
19,294,294,28,28,0,1,0
31,305,305,50,50,0,1,0
35,314,314,47,36,11,2,1
7,334,334,1,1,0,1,0
17,337,337,28,9,19,2,1
6,347,347,60,33,27,4,3
23,348,348,5,5,0,1,0
8,362,362,108,74,34,3,2
33,366,366,8,8,0,1,0
29,384,384,1,1,0,1,0
16,397,397,46,14,32,3,2
0,403,403,63,33,30,4,3
32,417,417,63,15,48,4,3
9,425,425,95,68,27,4,3
3,430,430,33,33,0,1,0
34,444,444,28,19,9,2,1
5,446,446,3,3,0,1,0
20,471,471,63,63,0,1,0
12,485,485,85,85,0,1,0
30,491,491,71,14,57,4,3

36,102,102,1,1,0,1,0
2,118,118,23,3,20,2,1
28,143,143,9,9,0,1,0
37,158,158,9,9,0,1,0
30,162,162,4,1,3,2,1
32,166,166,28,13,15,4,3
24,168,168,10,10,0,1,0
4,173,173,5,5,0,1,0
8,185,185,5,5,0,1,0
22,194,194,48,14,34,3,2
6,241,241,18,3,15,2,1
23,258,258,5,2,3,2,1
33,270,270,80,53,27,4,3
39,273,273,31,31,0,1,0
31,278,278,13,13,0,1,0
25,286,286,45,15,30,3,2
1,289,289,4,4,0,1,0
9,293,293,4,4,0,1,0
12,295,295,7,7,0,1,0
20,302,302,2,2,0,1,0
29,303,303,6,3,3,2,1
35,304,304,45,16,29,4,3
34,306,306,13,13,0,1,0
16,309,309,3,3,0,1,0
13,315,315,28,7,21,2,1
26,328,328,81,42,39,4,3
14,329,329,21,7,14,2,1
10,338,338,12,6,6,2,1
11,339,339,27,27,0,1,0
27,347,347,22,22,0,1,0
5,367,367,60,60,0,1,0
18,370,370,179,71,108,4,3
17,377,377,90,19,71,4,3
15,403,403,31,13,18,3,2
38,418,418,24,1,23,4,3
3,422,422,13,5,8,3,2
7,435,435,22,9,13,2,1
19,462,462,22,22,0,1,0
0,462,462,3,3,0,1,0
21,490,490,20,20,0,1,0

12,113,113,3,3,0,1,0
32,118,118,17,17,0,1,0
29,120,120,7,7,0,1,0
24,122,122,9,6,3,2,1
30,128,128,4,4,0,1,0
25,129,129,4,4,0,1,0
15,140,140,27,5,22,2,1
31,157,157,20,7,13,2,1
17,157,157,33,23,10,3,2
16,171,171,25,3,22,2,1
14,173,173,7,7,0,1,0
8,176,176,2,2,0,1,0
2,193,193,32,32,0,1,0
0,217,217,3,3,0,1,0
1,229,229,47,47,0,1,0
20,261,261,47,24,23,2,1
11,295,295,23,23,0,1,0
5,310,310,75,75,0,1,0
19,318,318,13,3,10,3,2
7,321,321,14,8,6,2,1
3,334,334,20,20,0,1,0
28,362,362,73,61,12,3,2
18,385,385,6,2,4,2,1
6,394,394,7,7,0,1,0
26,395,395,37,37,0,1,0
22,409,409,5,2,3,2,1
21,434,434,36,2,34,2,1
27,453,453,71,47,24,4,3
23,459,459,23,4,19,2,1
10,482,482,114,5,109,4,3
4,494,494,95,80,15,4,3
13,496,496,79,64,15,4,3
9,496,496,153,45,108,4,3

18,118,118,13,7,6,2,1
1,127,127,19,3,16,3,2
30,129,129,1,1,0,1,0
8,162,162,19,8,11,2,1
10,170,170,30,30,0,1,0
9,184,184,8,8,0,1,0
31,189,189,11,2,9,2,1
19,210,210,22,6,16,2,1
20,220,220,2,2,0,1,0
16,226,226,28,6,22,2,1
5,235,235,15,4,11,2,1
4,240,240,10,4,6,3,2
15,240,240,1,1,0,1,0
0,242,242,72,72,0,1,0
29,249,249,3,3,0,1,0
13,257,257,13,13,0,1,0
14,262,262,11,6,5,2,1
11,281,281,14,2,12,2,1
2,283,283,15,4,11,2,1
33,303,303,47,27,20,2,1
12,306,306,26,26,0,1,0
3,316,316,12,12,0,1,0
7,335,335,27,27,0,1,0
25,341,341,3,3,0,1,0
23,367,367,42,26,16,3,2
34,392,392,158,101,57,4,3
28,400,400,107,107,0,1,0
24,412,412,55,10,45,2,1
26,420,420,5,5,0,1,0
6,424,424,22,22,0,1,0
27,453,453,18,18,0,1,0
22,459,459,21,21,0,1,0
21,477,477,20,2,18,3,2
35,480,480,94,16,78,4,3
17,491,491,163,154,9,4,3
32,493,493,63,59,4,2,1

16,114,114,1,1,0,1,0
20,130,130,11,1,10,3,2
5,131,131,5,5,0,1,0
19,139,139,3,3,0,1,0
27,142,142,90,61,29,2,1
24,171,171,24,19,5,2,1
31,173,173,3,3,0,1,0
10,205,205,8,8,0,1,0
15,218,218,12,12,0,1,0
11,219,219,30,30,0,1,0
36,231,231,8,8,0,1,0
0,255,255,38,38,0,1,0
13,279,279,15,15,0,1,0
38,281,281,3,3,0,1,0
4,298,298,5,1,4,2,1
12,312,312,52,2,50,2,1
17,313,313,47,9,38,3,2
37,315,315,114,96,18,4,3
9,328,328,32,32,0,1,0
35,332,332,40,40,0,1,0
33,334,334,14,14,0,1,0
28,356,356,37,37,0,1,0
21,361,361,6,2,4,2,1
1,376,376,53,35,18,3,2
30,377,377,40,40,0,1,0
34,381,381,36,3,33,2,1
26,385,385,15,4,11,2,1
32,391,391,24,9,15,2,1
8,393,393,17,17,0,1,0
29,411,411,7,7,0,1,0
6,425,425,9,9,0,1,0
7,473,473,173,173,0,1,0
3,478,478,28,28,0,1,0
14,482,482,1,1,0,1,0
18,484,484,62,62,0,1,0
25,488,488,4,4,0,1,0
23,491,491,1,1,0,1,0
22,491,491,11,5,6,3,2
2,498,498,12,1,11,2,1

14,114,114,10,10,0,1,0
21,152,152,18,18,0,1,0
17,153,153,3,3,0,1,0
8,155,155,1,1,0,1,0
25,163,163,1,1,0,1,0
29,163,163,16,2,14,3,2
20,173,173,10,2,8,2,1
27,197,197,27,27,0,1,0
32,204,204,4,4,0,1,0
5,216,216,7,7,0,1,0
6,219,219,25,25,0,1,0
30,222,222,44,26,18,3,2
0,226,226,1,1,0,1,0
33,237,237,18,2,16,3,2
38,239,239,6,6,0,1,0
43,258,258,32,32,0,1,0
31,264,264,9,9,0,1,0
19,284,284,2,2,0,1,0
26,298,298,5,2,3,2,1
40,298,298,14,14,0,1,0
39,299,299,40,40,0,1,0
28,300,300,13,2,11,2,1
35,317,317,16,16,0,1,0
23,327,327,2,2,0,1,0
42,329,329,39,21,18,4,3
11,330,330,50,50,0,1,0
37,331,331,53,10,43,4,3
24,337,337,46,27,19,2,1
7,357,357,27,10,17,2,1
36,359,359,15,5,10,3,2
34,371,371,116,52,64,3,2
18,383,383,56,27,29,2,1
12,402,402,51,36,15,4,3
2,409,409,26,26,0,1,0
41,427,427,82,39,43,2,1
10,431,431,14,2,12,2,1
22,446,446,49,39,10,2,1
1,454,454,19,19,0,1,0
9,460,460,8,8,0,1,0
44,469,469,5,5,0,1,0
3,471,471,12,12,0,1,0
15,474,474,30,6,24,3,2
13,478,478,17,2,15,2,1
16,489,489,65,2,63,4,3
4,494,494,81,81,0,1,0

4,129,129,29,29,0,1,0
16,141,141,39,30,9,4,3
18,146,146,2,2,0,1,0
17,162,162,25,25,0,1,0
9,167,167,17,4,13,2,1
23,189,189,2,2,0,1,0
12,193,193,5,2,3,2,1
8,195,195,29,3,26,3,2
6,223,223,17,3,14,2,1
27,240,240,27,24,3,2,1
19,242,242,25,25,0,1,0
35,265,265,11,2,9,4,3
22,272,272,6,1,5,2,1
31,276,276,76,50,26,2,1
26,281,281,38,31,7,2,1
2,289,289,13,13,0,1,0
5,295,295,17,17,0,1,0
14,296,296,64,40,24,3,2
30,300,300,32,32,0,1,0
21,306,306,22,22,0,1,0
28,317,317,49,28,21,4,3
15,372,372,3,3,0,1,0
11,386,386,36,36,0,1,0
0,410,410,39,17,22,2,1
1,427,427,36,36,0,1,0
33,427,427,58,36,22,2,1
34,442,442,23,23,0,1,0
32,444,444,11,4,7,2,1
13,446,446,3,3,0,1,0
10,446,446,63,54,9,4,3
20,451,451,150,138,12,2,1
29,465,465,5,5,0,1,0
3,470,470,2,2,0,1,0
24,475,475,26,10,16,2,1
25,486,486,83,13,70,3,2
7,493,493,21,10,11,2,1

1,106,106,8,8,0,1,0
0,110,110,5,1,4,2,1
35,113,113,1,1,0,1,0
19,116,116,1,1,0,1,0
38,117,117,6,6,0,1,0
29,166,166,9,9,0,1,0
34,169,169,32,32,0,1,0
9,173,173,17,17,0,1,0
5,176,176,4,1,3,2,1
17,181,181,35,32,3,2,1
25,187,187,7,1,6,3,2
41,202,202,5,5,0,1,0
40,209,209,46,4,42,4,3
12,211,211,62,22,40,2,1
16,224,224,8,2,6,3,2
28,225,225,74,74,0,1,0
36,239,239,26,11,15,2,1
22,244,244,2,2,0,1,0
21,267,267,17,17,0,1,0
14,289,289,8,8,0,1,0
30,319,319,46,38,8,2,1
13,325,325,35,35,0,1,0
4,330,330,24,24,0,1,0
26,339,339,42,42,0,1,0
3,346,346,8,8,0,1,0
7,348,348,2,2,0,1,0
11,357,357,10,7,3,2,1
27,367,367,7,2,5,2,1
10,372,372,78,70,8,2,1
2,381,381,2,2,0,1,0
39,383,383,31,13,18,3,2
32,386,386,10,10,0,1,0
8,405,405,34,4,30,2,1
31,420,420,45,13,32,3,2
23,435,435,52,24,28,3,2
18,439,439,41,15,26,2,1
20,439,439,42,42,0,1,0
33,448,448,29,1,28,3,2
37,467,467,56,56,0,1,0
24,468,468,60,60,0,1,0
15,484,484,21,4,17,2,1
6,487,487,20,4,16,2,1

10,126,126,19,19,0,1,0
15,127,127,8,8,0,1,0
1,135,135,42,30,12,2,1
7,151,151,3,3,0,1,0
23,156,156,5,2,3,2,1
4,164,164,5,2,3,2,1
33,199,199,43,43,0,1,0
29,200,200,20,20,0,1,0
21,235,235,20,4,16,3,2
9,269,269,40,32,8,3,2
20,279,279,12,12,0,1,0
19,290,290,13,3,10,3,2
8,301,301,18,4,14,3,2
31,304,304,103,70,33,2,1
25,307,307,3,3,0,1,0
26,336,336,29,7,22,3,2
16,337,337,27,1,26,3,2
11,346,346,24,24,0,1,0
24,367,367,8,8,0,1,0
27,389,389,71,71,0,1,0
13,391,391,88,88,0,1,0
5,398,398,10,10,0,1,0
17,420,420,62,15,47,2,1
30,421,421,70,54,16,4,3
28,427,427,22,22,0,1,0
14,437,437,18,2,16,3,2
2,440,440,32,16,16,3,2
12,444,444,84,84,0,1,0
32,457,457,49,22,27,2,1
3,465,465,119,89,30,3,2
0,474,474,13,13,0,1,0
6,486,486,54,54,0,1,0
18,490,490,54,40,14,3,2
22,492,492,4,4,0,1,0

31,115,115,24,2,22,3,2
9,127,127,19,10,9,2,1
30,136,136,17,5,12,2,1
16,136,136,14,14,0,1,0
11,150,150,16,1,15,2,1
20,154,154,1,1,0,1,0
12,155,155,7,1,6,2,1
10,187,187,9,1,8,3,2
4,194,194,5,5,0,1,0
3,215,215,104,94,10,2,1
7,237,237,35,35,0,1,0
17,250,250,6,6,0,1,0
8,273,273,26,26,0,1,0
21,280,280,29,29,0,1,0
26,287,287,74,2,72,3,2
27,311,311,39,39,0,1,0
23,321,321,31,22,9,4,3
14,327,327,42,42,0,1,0
1,340,340,3,3,0,1,0
32,344,344,26,6,20,2,1
2,357,357,14,14,0,1,0
25,370,370,67,43,24,4,3
22,370,370,55,55,0,1,0
28,373,373,26,9,17,2,1
0,389,389,27,27,0,1,0
6,393,393,56,19,37,3,2
24,416,416,12,12,0,1,0
19,417,417,39,9,30,4,3
13,424,424,1,1,0,1,0
29,435,435,27,27,0,1,0
15,445,445,29,5,24,3,2
33,452,452,46,46,0,1,0
5,453,453,110,110,0,1,0
18,455,455,10,10,0,1,0

11,102,102,4,4,0,1,0
7,123,123,6,6,0,1,0
3,131,131,6,2,4,2,1
4,133,133,1,1,0,1,0
25,140,140,45,7,38,2,1
26,143,143,2,2,0,1,0
9,149,149,18,7,11,2,1
27,175,175,3,3,0,1,0
24,194,194,16,7,9,4,3
31,213,213,4,4,0,1,0
28,220,220,41,41,0,1,0
35,236,236,18,18,0,1,0
12,236,236,6,3,3,2,1
16,260,260,43,3,40,2,1
10,269,269,3,3,0,1,0
17,286,286,26,26,0,1,0
22,303,303,70,22,48,4,3
8,322,322,36,12,24,4,3
14,322,322,7,1,6,2,1
23,347,347,31,31,0,1,0
5,359,359,113,113,0,1,0
21,359,359,6,6,0,1,0
1,364,364,4,4,0,1,0
18,365,365,41,13,28,2,1
20,390,390,15,1,14,3,2
32,401,401,4,4,0,1,0
15,405,405,18,9,9,2,1
6,411,411,172,85,87,4,3
33,417,417,4,1,3,2,1
29,424,424,102,84,18,4,3
19,439,439,24,6,18,3,2
30,452,452,65,65,0,1,0
13,461,461,28,12,16,3,2
36,463,463,76,49,27,2,1
34,463,463,50,24,26,2,1
2,470,470,28,28,0,1,0
0,494,494,45,45,0,1,0

17,100,100,9,9,0,1,0
22,103,103,12,3,9,4,3
0,114,114,38,34,4,2,1
5,115,115,17,1,16,3,2
2,138,138,2,2,0,1,0
33,168,168,12,12,0,1,0
21,178,178,63,63,0,1,0
10,184,184,4,4,0,1,0
6,206,206,2,2,0,1,0
13,209,209,47,13,34,2,1
20,209,209,2,2,0,1,0
26,221,221,7,2,5,2,1
3,226,226,9,9,0,1,0
12,230,230,2,2,0,1,0
30,236,236,44,36,8,2,1
23,249,249,12,12,0,1,0
15,255,255,6,6,0,1,0
19,275,275,51,51,0,1,0
27,281,281,39,22,17,2,1
1,295,295,40,6,34,2,1
8,326,326,48,20,28,2,1
35,342,342,11,1,10,2,1
28,350,350,6,6,0,1,0
16,357,357,22,5,17,2,1
29,364,364,83,83,0,1,0
25,396,396,11,5,6,3,2
14,400,400,8,8,0,1,0
18,414,414,15,15,0,1,0
36,421,421,27,1,26,3,2
32,431,431,7,7,0,1,0
4,452,452,11,2,9,4,3
31,469,469,138,33,105,4,3
24,471,471,48,19,29,2,1
34,474,474,42,42,0,1,0
7,480,480,99,46,53,3,2
11,483,483,21,14,7,2,1
37,494,494,4,4,0,1,0
9,498,498,13,5,8,3,2

34,123,123,12,12,0,1,0
16,142,142,14,14,0,1,0
18,146,146,38,6,32,2,1
6,147,147,11,4,7,2,1
30,153,153,13,6,7,2,1
10,156,156,18,12,6,3,2
4,158,158,1,1,0,1,0
35,199,199,32,17,15,4,3
26,203,203,8,8,0,1,0
23,204,204,11,5,6,3,2
1,224,224,31,4,27,4,3
32,237,237,1,1,0,1,0
13,252,252,1,1,0,1,0
12,253,253,9,9,0,1,0
5,260,260,17,17,0,1,0
11,300,300,66,32,34,2,1
27,304,304,47,1,46,3,2
24,304,304,23,3,20,2,1
22,305,305,15,6,9,2,1
15,307,307,29,5,24,3,2
28,309,309,94,23,71,4,3
36,310,310,1,1,0,1,0
17,331,331,21,1,20,3,2
8,349,349,2,2,0,1,0
25,383,383,2,2,0,1,0
7,384,384,16,1,15,4,3
31,401,401,22,4,18,4,3
29,419,419,66,66,0,1,0
14,424,424,3,3,0,1,0
9,434,434,43,3,40,2,1
21,452,452,101,56,45,4,3
20,460,460,72,32,40,3,2
3,462,462,133,133,0,1,0
33,462,462,19,7,12,3,2
2,463,463,50,26,24,4,3
0,465,465,35,1,34,3,2
19,489,489,84,2,82,3,2

20,100,100,7,1,6,3,2
0,105,105,20,11,9,2,1
6,111,111,14,9,5,2,1
30,128,128,9,5,4,2,1
14,143,143,7,2,5,2,1
27,153,153,24,7,17,2,1
1,162,162,24,24,0,1,0
29,176,176,13,3,10,3,2
33,209,209,5,5,0,1,0
19,225,225,10,3,7,2,1
22,231,231,9,9,0,1,0
7,258,258,49,43,6,3,2
31,289,289,29,29,0,1,0
3,298,298,96,26,70,3,2
15,302,302,38,38,0,1,0
11,307,307,69,69,0,1,0
23,331,331,43,18,25,2,1
8,344,344,9,1,8,2,1
16,368,368,13,1,12,2,1
17,376,376,5,5,0,1,0
32,382,382,110,110,0,1,0
10,395,395,1,1,0,1,0
5,406,406,56,29,27,4,3
4,416,416,36,12,24,4,3
12,431,431,20,1,19,2,1
18,433,433,42,8,34,3,2
21,436,436,44,44,0,1,0
25,438,438,85,85,0,1,0
9,456,456,7,7,0,1,0
26,458,458,31,31,0,1,0
28,459,459,137,99,38,3,2
2,467,467,3,3,0,1,0
13,472,472,49,11,38,3,2
24,492,492,13,13,0,1,0

25,100,100,5,5,0,1,0
8,112,112,43,8,35,4,3
12,128,128,7,7,0,1,0
38,139,139,29,29,0,1,0
2,148,148,48,42,6,2,1
16,150,150,5,5,0,1,0
27,152,152,17,10,7,2,1
28,155,155,17,17,0,1,0
33,156,156,3,3,0,1,0
15,160,160,7,7,0,1,0
4,161,161,25,19,6,3,2
19,210,210,17,3,14,3,2
22,211,211,2,2,0,1,0
21,223,223,3,3,0,1,0
24,239,239,38,38,0,1,0
14,241,241,18,3,15,4,3
36,266,266,27,27,0,1,0
31,270,270,58,32,26,2,1
20,281,281,23,23,0,1,0
18,295,295,12,2,10,3,2
9,324,324,12,12,0,1,0
10,331,331,18,7,11,3,2
11,333,333,2,2,0,1,0
5,371,371,1,1,0,1,0
13,385,385,45,45,0,1,0
34,392,392,55,31,24,4,3
1,401,401,37,7,30,2,1
3,422,422,28,16,12,2,1
29,452,452,70,37,33,4,3
17,452,452,3,3,0,1,0
35,454,454,26,6,20,3,2
23,462,462,93,93,0,1,0
26,462,462,55,33,22,2,1
37,463,463,25,12,13,2,1
32,469,469,39,2,37,2,1
7,474,474,34,34,0,1,0
6,476,476,27,27,0,1,0
0,484,484,9,9,0,1,0
30,488,488,12,4,8,3,2

14,110,110,8,8,0,1,0
0,131,131,4,4,0,1,0
8,133,133,6,6,0,1,0
4,136,136,6,2,4,2,1
34,152,152,1,1,0,1,0
32,153,153,2,2,0,1,0
13,154,154,1,1,0,1,0
38,155,155,19,9,10,3,2
35,156,156,15,11,4,2,1
7,167,167,3,3,0,1,0
12,199,199,18,18,0,1,0
22,211,211,23,13,10,3,2
23,214,214,63,63,0,1,0
18,214,214,1,1,0,1,0
11,228,228,5,5,0,1,0
40,259,259,39,5,34,3,2
25,260,260,100,100,0,1,0
19,261,261,13,3,10,2,1
26,263,263,18,1,17,2,1
2,266,266,1,1,0,1,0
39,277,277,1,1,0,1,0
24,282,282,18,18,0,1,0
29,284,284,21,6,15,2,1
31,317,317,14,10,4,2,1
30,342,342,29,29,0,1,0
28,346,346,6,6,0,1,0
27,346,346,37,13,24,4,3
42,355,355,15,15,0,1,0
20,358,358,12,4,8,3,2
5,360,360,1,1,0,1,0
3,368,368,62,62,0,1,0
15,372,372,67,67,0,1,0
21,398,398,3,3,0,1,0
1,399,399,11,11,0,1,0
33,400,400,70,25,45,2,1
41,415,415,53,53,0,1,0
36,421,421,32,18,14,3,2
16,438,438,16,4,12,4,3
10,457,457,1,1,0,1,0
6,469,469,131,101,30,3,2
9,472,472,25,25,0,1,0
17,472,472,73,61,12,2,1
37,486,486,122,110,12,2,1

19,102,102,10,3,7,2,1
20,108,108,3,3,0,1,0
12,112,112,14,14,0,1,0
25,122,122,2,2,0,1,0
0,131,131,17,17,0,1,0
14,134,134,2,2,0,1,0
1,135,135,1,1,0,1,0
3,152,152,29,29,0,1,0
13,159,159,68,68,0,1,0
28,164,164,4,4,0,1,0
30,174,174,18,6,12,3,2
18,185,185,31,17,14,3,2
21,223,223,25,25,0,1,0
32,227,227,2,2,0,1,0
6,248,248,6,6,0,1,0
23,259,259,54,54,0,1,0
5,282,282,65,65,0,1,0
29,303,303,15,15,0,1,0
4,318,318,6,6,0,1,0
7,321,321,19,11,8,3,2
22,332,332,2,2,0,1,0
27,339,339,84,13,71,4,3
16,357,357,30,30,0,1,0
26,389,389,64,26,38,3,2
24,392,392,12,12,0,1,0
17,396,396,82,52,30,2,1
9,397,397,14,14,0,1,0
31,412,412,16,16,0,1,0
11,450,450,15,15,0,1,0
2,451,451,28,10,18,3,2
10,454,454,65,43,22,2,1
8,455,455,136,113,23,4,3
15,495,495,122,29,93,3,2

1,101,101,1,1,0,1,0
0,107,107,2,2,0,1,0
4,126,126,28,28,0,1,0
11,140,140,14,14,0,1,0
2,146,146,11,4,7,2,1
25,174,174,84,84,0,1,0
29,174,174,1,1,0,1,0
24,179,179,10,10,0,1,0
28,180,180,2,2,0,1,0
32,182,182,5,5,0,1,0
19,184,184,1,1,0,1,0
7,201,201,38,38,0,1,0
35,226,226,2,2,0,1,0
21,254,254,13,13,0,1,0
15,264,264,50,23,27,2,1
6,279,279,3,3,0,1,0
22,306,306,45,45,0,1,0
18,312,312,4,4,0,1,0
16,323,323,23,10,13,3,2
13,323,323,6,3,3,2,1
26,326,326,24,24,0,1,0
38,331,331,69,63,6,3,2
5,352,352,11,11,0,1,0
12,365,365,6,6,0,1,0
10,376,376,7,7,0,1,0
14,378,378,3,3,0,1,0
17,380,380,26,26,0,1,0
31,383,383,49,13,36,3,2
8,389,389,63,14,49,4,3
30,395,395,25,20,5,2,1
34,408,408,28,28,0,1,0
36,433,433,9,9,0,1,0
9,449,449,182,182,0,1,0
3,452,452,34,34,0,1,0
20,459,459,42,7,35,2,1
23,478,478,11,11,0,1,0
37,480,480,73,73,0,1,0
27,482,482,19,19,0,1,0
33,486,486,130,130,0,1,0

30,101,101,4,4,0,1,0
33,110,110,1,1,0,1,0
20,111,111,13,1,12,2,1
21,116,116,8,8,0,1,0
37,122,122,2,2,0,1,0
35,133,133,24,24,0,1,0
22,133,133,13,13,0,1,0
27,135,135,3,3,0,1,0
1,140,140,10,10,0,1,0
32,149,149,6,6,0,1,0
29,181,181,1,1,0,1,0
2,183,183,3,3,0,1,0
28,192,192,5,5,0,1,0
12,201,201,1,1,0,1,0
34,228,228,12,12,0,1,0
23,229,229,62,62,0,1,0
24,230,230,9,9,0,1,0
25,238,238,34,34,0,1,0
15,245,245,47,47,0,1,0
10,247,247,20,14,6,2,1
8,253,253,89,89,0,1,0
3,267,267,42,42,0,1,0
5,325,325,21,3,18,2,1
11,340,340,22,22,0,1,0
16,343,343,8,8,0,1,0
26,344,344,68,68,0,1,0
31,351,351,40,40,0,1,0
14,364,364,8,8,0,1,0
17,394,394,14,14,0,1,0
9,412,412,22,7,15,2,1
6,413,413,22,22,0,1,0
13,418,418,17,9,8,3,2
18,420,420,14,14,0,1,0
0,455,455,11,11,0,1,0
4,464,464,26,16,10,2,1
7,470,470,76,76,0,1,0
39,475,475,150,54,96,4,3
38,494,494,68,32,36,3,2
36,497,497,73,73,0,1,0
19,498,498,56,56,0,1,0

3,101,101,17,17,0,1,0
33,102,102,5,5,0,1,0
2,105,105,3,3,0,1,0
16,109,109,2,2,0,1,0
29,139,139,8,1,7,2,1
4,143,143,1,1,0,1,0
11,144,144,4,4,0,1,0
20,151,151,16,12,4,2,1
9,151,151,4,1,3,2,1
0,165,165,12,3,9,2,1
32,167,167,29,29,0,1,0
35,173,173,10,4,6,2,1
25,195,195,9,9,0,1,0
8,219,219,84,32,52,3,2
26,228,228,18,9,9,4,3
37,263,263,20,20,0,1,0
6,270,270,13,6,7,3,2
21,275,275,1,1,0,1,0
38,277,277,16,6,10,3,2
28,298,298,16,11,5,2,1
1,306,306,13,4,9,3,2
31,315,315,31,31,0,1,0
19,320,320,9,1,8,3,2
34,337,337,110,43,67,4,3
24,343,343,64,64,0,1,0
36,359,359,27,27,0,1,0
30,360,360,24,20,4,2,1
17,372,372,19,9,10,2,1
7,388,388,66,28,38,3,2
5,402,402,4,4,0,1,0
14,407,407,67,67,0,1,0
27,413,413,57,36,21,3,2
10,415,415,2,2,0,1,0
15,428,428,55,55,0,1,0
22,432,432,1,1,0,1,0
39,462,462,2,2,0,1,0
12,462,462,21,21,0,1,0
13,464,464,26,26,0,1,0
23,471,471,123,93,30,2,1
18,476,476,99,53,46,3,2
40,500,500,12,12,0,1,0

0,105,105,5,1,4,2,1
17,120,120,47,47,0,1,0
24,123,123,9,9,0,1,0
10,141,141,4,1,3,2,1
8,147,147,3,3,0,1,0
6,151,151,11,11,0,1,0
33,157,157,12,12,0,1,0
25,179,179,11,11,0,1,0
40,181,181,8,1,7,2,1
34,184,184,20,2,18,2,1
27,187,187,20,5,15,2,1
13,200,200,35,35,0,1,0
32,201,201,15,15,0,1,0
22,202,202,9,9,0,1,0
4,241,241,29,25,4,2,1
23,244,244,31,8,23,2,1
39,269,269,58,3,55,4,3
15,290,290,17,17,0,1,0
29,301,301,2,2,0,1,0
38,302,302,113,50,63,3,2
36,308,308,6,6,0,1,0
9,314,314,10,10,0,1,0
20,316,316,23,23,0,1,0
28,331,331,27,27,0,1,0
11,331,331,6,6,0,1,0
7,335,335,4,1,3,2,1
14,338,338,22,12,10,3,2
30,377,377,5,5,0,1,0
5,381,381,60,44,16,2,1
16,398,398,14,4,10,3,2
3,408,408,32,20,12,2,1
1,410,410,3,3,0,1,0
31,418,418,70,66,4,2,1
21,422,422,4,4,0,1,0
37,425,425,56,21,35,4,3
19,437,437,35,9,26,2,1
12,447,447,22,22,0,1,0
2,458,458,82,35,47,2,1
35,469,469,20,7,13,4,3
18,485,485,24,24,0,1,0
26,490,490,54,42,12,2,1

27,121,121,12,3,9,2,1
25,127,127,5,5,0,1,0
20,135,135,4,4,0,1,0
22,136,136,1,1,0,1,0
3,160,160,15,15,0,1,0
38,166,166,21,21,0,1,0
5,189,189,10,7,3,2,1
12,189,189,10,10,0,1,0
30,204,204,31,1,30,2,1
37,224,224,20,2,18,2,1
21,235,235,15,5,10,3,2
9,247,247,37,13,24,4,3
28,261,261,26,3,23,2,1
8,266,266,1,1,0,1,0
13,266,266,8,4,4,2,1
2,283,283,14,14,0,1,0
24,286,286,73,73,0,1,0
31,304,304,50,50,0,1,0
0,306,306,121,121,0,1,0
26,321,321,3,3,0,1,0
7,325,325,20,20,0,1,0
18,333,333,25,25,0,1,0
23,366,366,1,1,0,1,0
1,368,368,15,15,0,1,0
29,370,370,22,10,12,4,3
4,375,375,37,37,0,1,0
15,406,406,59,59,0,1,0
11,408,408,14,14,0,1,0
6,414,414,44,9,35,2,1
36,419,419,4,1,3,2,1
14,429,429,59,10,49,2,1
10,438,438,55,23,32,3,2
19,443,443,39,28,11,2,1
34,443,443,94,58,36,4,3
35,449,449,53,53,0,1,0
32,471,471,96,36,60,4,3
17,474,474,2,2,0,1,0
16,480,480,14,11,3,2,1
33,499,499,61,52,9,2,1

18,101,101,11,2,9,2,1
7,114,114,1,1,0,1,0
26,120,120,2,2,0,1,0
1,124,124,6,6,0,1,0
29,125,125,1,1,0,1,0
20,128,128,1,1,0,1,0
38,129,129,14,14,0,1,0
35,129,129,5,1,4,2,1
31,131,131,11,11,0,1,0
36,139,139,47,47,0,1,0
5,142,142,10,10,0,1,0
22,146,146,7,7,0,1,0
3,154,154,10,2,8,2,1
23,157,157,7,7,0,1,0
21,175,175,30,13,17,3,2
28,180,180,17,17,0,1,0
19,183,183,6,6,0,1,0
32,195,195,32,32,0,1,0
25,205,205,53,45,8,3,2
42,229,229,36,36,0,1,0
16,235,235,1,1,0,1,0
9,251,251,40,15,25,4,3
13,267,267,14,2,12,4,3
6,274,274,37,37,0,1,0
0,282,282,2,2,0,1,0
33,293,293,38,21,17,2,1
8,299,299,35,8,27,2,1
40,352,352,10,1,9,2,1
4,356,356,3,3,0,1,0
17,361,361,25,25,0,1,0
12,365,365,22,5,17,2,1
37,371,371,41,2,39,2,1
30,375,375,26,19,7,2,1
43,381,381,38,5,33,2,1
15,401,401,5,5,0,1,0
24,422,422,2,2,0,1,0
27,433,433,60,60,0,1,0
34,440,440,42,20,22,3,2
14,463,463,38,38,0,1,0
41,473,473,45,35,10,3,2
39,477,477,28,28,0,1,0
10,480,480,18,3,15,4,3
2,499,499,89,23,66,4,3
11,500,500,6,6,0,1,0

30,112,112,11,1,10,2,1
24,126,126,21,11,10,2,1
12,135,135,19,19,0,1,0
27,150,150,13,2,11,2,1
25,156,156,2,2,0,1,0
14,157,157,7,7,0,1,0
0,158,158,1,1,0,1,0
19,161,161,19,19,0,1,0
22,184,184,45,45,0,1,0
8,190,190,14,14,0,1,0
1,202,202,19,19,0,1,0
26,220,220,35,35,0,1,0
11,244,244,6,3,3,2,1
3,250,250,27,27,0,1,0
21,258,258,1,1,0,1,0
2,271,271,1,1,0,1,0
9,300,300,18,11,7,2,1
33,302,302,19,19,0,1,0
10,312,312,1,1,0,1,0
17,349,349,11,11,0,1,0
16,380,380,93,43,50,3,2
5,397,397,10,10,0,1,0
7,403,403,46,20,26,2,1
34,405,405,9,3,6,3,2
28,418,418,149,149,0,1,0
32,421,421,50,50,0,1,0
4,435,435,39,21,18,4,3
18,450,450,96,23,73,4,3
6,457,457,153,49,104,4,3
29,465,465,60,48,12,2,1
23,468,468,4,4,0,1,0
31,491,491,5,5,0,1,0
20,492,492,1,1,0,1,0
15,493,493,174,158,16,2,1
13,500,500,41,41,0,1,0

17,107,107,2,2,0,1,0
3,109,109,5,5,0,1,0
34,121,121,2,2,0,1,0
14,132,132,4,4,0,1,0
40,143,143,2,2,0,1,0
7,154,154,15,15,0,1,0
19,164,164,15,15,0,1,0
35,193,193,27,27,0,1,0
18,218,218,25,25,0,1,0
2,228,228,8,8,0,1,0
4,243,243,18,7,11,2,1
36,249,249,69,23,46,4,3
9,260,260,8,4,4,2,1
5,267,267,39,39,0,1,0
24,277,277,39,39,0,1,0
39,281,281,3,3,0,1,0
11,282,282,1,1,0,1,0
37,284,284,38,10,28,3,2
25,306,306,35,17,18,2,1
23,314,314,10,10,0,1,0
28,319,319,23,19,4,2,1
29,334,334,12,4,8,3,2
1,342,342,42,28,14,3,2
6,358,358,5,5,0,1,0
27,376,376,62,44,18,3,2
33,377,377,44,18,26,3,2
20,381,381,20,20,0,1,0
10,392,392,110,9,101,4,3
41,414,414,25,25,0,1,0
31,420,420,12,6,6,3,2
13,422,422,33,14,19,2,1
15,422,422,11,2,9,4,3
30,428,428,59,31,28,3,2
43,442,442,65,65,0,1,0
12,452,452,11,3,8,2,1
21,455,455,14,6,8,3,2
38,457,457,179,179,0,1,0
0,467,467,4,4,0,1,0
26,477,477,21,14,7,2,1
16,483,483,4,4,0,1,0
22,484,484,58,15,43,2,1
8,486,486,29,12,17,4,3
42,490,490,11,11,0,1,0
32,491,491,11,11,0,1,0

14,104,104,27,27,0,1,0
15,121,121,13,1,12,3,2
22,123,123,2,2,0,1,0
37,124,124,14,14,0,1,0
12,133,133,1,1,0,1,0
21,153,153,14,14,0,1,0
31,156,156,27,27,0,1,0
13,156,156,11,7,4,2,1
0,167,167,1,1,0,1,0
16,170,170,60,60,0,1,0
34,175,175,12,12,0,1,0
3,203,203,12,12,0,1,0
17,208,208,16,1,15,4,3
1,227,227,14,1,13,2,1
4,228,228,25,6,19,2,1
7,233,233,40,27,13,2,1
28,233,233,1,1,0,1,0
10,243,243,30,23,7,2,1
27,245,245,1,1,0,1,0
30,254,254,3,3,0,1,0
6,257,257,36,36,0,1,0
18,266,266,26,26,0,1,0
25,267,267,9,9,0,1,0
2,276,276,6,6,0,1,0
8,291,291,15,6,9,4,3
36,291,291,6,1,5,2,1
32,331,331,5,1,4,2,1
20,344,344,1,1,0,1,0
23,345,345,2,2,0,1,0
5,349,349,1,1,0,1,0
26,358,358,22,22,0,1,0
33,373,373,70,70,0,1,0
19,373,373,14,14,0,1,0
35,374,374,215,215,0,1,0
24,376,376,152,152,0,1,0
11,421,421,17,9,8,3,2
9,434,434,1,1,0,1,0
29,448,448,26,26,0,1,0

30,115,115,4,4,0,1,0
19,133,133,1,1,0,1,0
14,136,136,1,1,0,1,0
9,163,163,2,2,0,1,0
10,177,177,1,1,0,1,0
7,180,180,18,9,9,4,3
18,187,187,2,2,0,1,0
0,219,219,45,15,30,4,3
12,229,229,36,7,29,2,1
24,231,231,101,55,46,3,2
16,264,264,8,8,0,1,0
33,271,271,48,48,0,1,0
1,279,279,29,29,0,1,0
26,287,287,4,4,0,1,0
31,296,296,53,21,32,3,2
23,299,299,14,14,0,1,0
6,302,302,22,22,0,1,0
11,325,325,2,2,0,1,0
21,331,331,9,3,6,2,1
4,340,340,64,64,0,1,0
25,341,341,54,54,0,1,0
28,348,348,55,24,31,4,3
20,383,383,23,8,15,4,3
34,388,388,65,22,43,2,1
2,405,405,64,1,63,3,2
3,416,416,8,8,0,1,0
13,417,417,171,119,52,4,3
8,430,430,75,49,26,3,2
27,441,441,4,4,0,1,0
32,441,441,35,16,19,2,1
22,449,449,40,40,0,1,0
35,450,450,34,34,0,1,0
29,455,455,48,48,0,1,0
17,459,459,15,6,9,2,1
5,490,490,39,39,0,1,0
15,494,494,19,1,18,3,2

0,113,113,32,32,0,1,0
1,114,114,16,16,0,1,0
27,128,128,14,14,0,1,0
32,132,132,7,7,0,1,0
11,200,200,42,28,14,3,2
14,217,217,17,17,0,1,0
22,223,223,6,6,0,1,0
15,248,248,9,9,0,1,0
2,251,251,28,25,3,2,1
5,274,274,6,6,0,1,0
8,292,292,46,38,8,3,2
7,297,297,77,77,0,1,0
4,304,304,24,24,0,1,0
13,310,310,3,3,0,1,0
3,330,330,5,5,0,1,0
33,347,347,18,18,0,1,0
17,369,369,55,7,48,4,3
18,374,374,107,107,0,1,0
28,380,380,51,51,0,1,0
23,381,381,6,6,0,1,0
26,384,384,12,12,0,1,0
10,392,392,42,34,8,3,2
16,414,414,2,2,0,1,0
25,459,459,63,63,0,1,0
29,459,459,16,16,0,1,0
19,460,460,60,60,0,1,0
24,470,470,62,62,0,1,0
21,473,473,23,14,9,4,3
30,481,481,40,32,8,2,1
12,483,483,27,15,12,2,1
9,483,483,7,7,0,1,0
20,486,486,130,45,85,4,3
6,489,489,108,21,87,4,3
31,495,495,65,23,42,4,3

7,103,103,24,12,12,4,3
8,108,108,37,10,27,2,1
0,117,117,1,1,0,1,0
17,141,141,2,2,0,1,0
32,170,170,8,8,0,1,0
2,199,199,1,1,0,1,0
23,225,225,1,1,0,1,0
27,235,235,12,5,7,2,1
33,242,242,40,2,38,4,3
13,255,255,1,1,0,1,0
10,282,282,12,12,0,1,0
24,293,293,7,7,0,1,0
19,299,299,86,86,0,1,0
34,301,301,2,2,0,1,0
9,303,303,51,51,0,1,0
15,304,304,8,1,7,2,1
29,323,323,26,8,18,3,2
4,337,337,22,22,0,1,0
21,345,345,124,124,0,1,0
16,358,358,8,8,0,1,0
22,363,363,39,39,0,1,0
25,363,363,10,10,0,1,0
6,382,382,69,30,39,2,1
26,384,384,8,1,7,2,1
11,387,387,20,10,10,2,1
30,390,390,76,76,0,1,0
20,407,407,103,64,39,4,3
3,420,420,134,53,81,4,3
31,436,436,57,9,48,2,1
5,440,440,105,44,61,4,3
14,440,440,1,1,0,1,0
1,443,443,20,5,15,2,1
18,459,459,10,6,4,2,1
12,467,467,21,8,13,4,3
28,472,472,17,5,12,3,2

25,108,108,5,5,0,1,0
31,109,109,6,6,0,1,0
11,112,112,6,6,0,1,0
8,115,115,24,17,7,2,1
7,119,119,27,27,0,1,0
32,121,121,10,7,3,2,1
10,150,150,1,1,0,1,0
15,151,151,20,20,0,1,0
2,169,169,2,2,0,1,0
6,169,169,9,2,7,2,1
28,173,173,4,4,0,1,0
20,174,174,17,3,14,2,1
19,179,179,21,1,20,3,2
12,189,189,8,8,0,1,0
24,216,216,5,5,0,1,0
34,231,231,34,34,0,1,0
37,247,247,38,38,0,1,0
16,248,248,57,18,39,2,1
29,263,263,6,6,0,1,0
23,270,270,17,17,0,1,0
21,275,275,13,1,12,3,2
18,289,289,30,2,28,3,2
22,302,302,81,67,14,3,2
17,317,317,2,2,0,1,0
36,342,342,111,33,78,3,2
33,367,367,8,2,6,3,2
35,370,370,21,21,0,1,0
14,381,381,5,5,0,1,0
13,385,385,78,47,31,2,1
5,419,419,22,22,0,1,0
27,421,421,35,11,24,3,2
4,421,421,59,30,29,4,3
9,433,433,4,4,0,1,0
3,450,450,30,30,0,1,0
1,488,488,39,13,26,2,1
26,496,496,66,18,48,3,2
30,497,497,99,51,48,4,3
0,499,499,23,23,0,1,0

1,103,103,5,5,0,1,0
25,119,119,16,16,0,1,0
27,134,134,8,8,0,1,0
23,145,145,9,3,6,3,2
13,146,146,22,7,15,4,3
10,163,163,39,3,36,3,2
33,170,170,18,7,11,2,1
15,177,177,37,37,0,1,0
20,178,178,18,18,0,1,0
21,183,183,6,6,0,1,0
17,185,185,2,2,0,1,0
3,200,200,6,2,4,2,1
7,202,202,6,6,0,1,0
18,207,207,67,67,0,1,0
28,213,213,31,31,0,1,0
2,217,217,30,30,0,1,0
11,219,219,21,1,20,3,2
12,245,245,12,12,0,1,0
4,245,245,52,52,0,1,0
26,271,271,29,29,0,1,0
9,272,272,21,21,0,1,0
29,285,285,15,15,0,1,0
0,295,295,1,1,0,1,0
14,322,322,18,18,0,1,0
35,353,353,85,54,31,2,1
32,359,359,69,69,0,1,0
19,376,376,33,4,29,2,1
31,384,384,12,2,10,3,2
5,390,390,7,1,6,2,1
34,402,402,24,24,0,1,0
22,404,404,21,7,14,3,2
30,411,411,42,34,8,2,1
36,438,438,93,3,90,3,2
8,476,476,14,11,3,2,1
16,488,488,4,4,0,1,0
24,495,495,33,33,0,1,0
6,497,497,37,30,7,2,1

30,112,112,1,1,0,1,0
33,119,119,1,1,0,1,0
5,150,150,52,13,39,4,3
27,151,151,16,16,0,1,0
1,211,211,13,4,9,2,1
4,216,216,7,7,0,1,0
9,237,237,10,10,0,1,0
6,237,237,90,15,75,4,3
3,247,247,1,1,0,1,0
14,249,249,50,50,0,1,0
35,249,249,8,2,6,3,2
19,266,266,29,14,15,2,1
11,278,278,4,1,3,2,1
26,294,294,30,10,20,2,1
34,298,298,97,97,0,1,0
12,307,307,69,69,0,1,0
10,311,311,1,1,0,1,0
17,320,320,13,13,0,1,0
8,330,330,12,12,0,1,0
25,332,332,2,2,0,1,0
31,349,349,10,10,0,1,0
32,355,355,26,17,9,2,1
29,356,356,14,14,0,1,0
22,357,357,50,1,49,2,1
21,374,374,25,25,0,1,0
0,379,379,1,1,0,1,0
24,379,379,83,68,15,4,3
2,398,398,38,38,0,1,0
20,399,399,65,5,60,4,3
18,435,435,95,62,33,2,1
28,461,461,66,46,20,3,2
15,467,467,63,24,39,2,1
7,469,469,3,3,0,1,0
13,474,474,33,18,15,4,3
16,480,480,51,18,33,4,3
23,490,490,22,2,20,3,2

13,115,115,7,3,4,2,1
39,116,116,22,14,8,2,1
29,118,118,10,10,0,1,0
4,123,123,1,1,0,1,0
33,132,132,17,10,7,2,1
11,139,139,10,2,8,3,2
22,144,144,19,19,0,1,0
21,153,153,15,15,0,1,0
31,174,174,27,27,0,1,0
20,192,192,6,6,0,1,0
27,203,203,3,3,0,1,0
38,209,209,16,16,0,1,0
8,212,212,2,2,0,1,0
9,215,215,47,19,28,4,3
3,226,226,3,3,0,1,0
30,232,232,51,51,0,1,0
23,242,242,21,21,0,1,0
24,243,243,17,9,8,2,1
5,266,266,66,38,28,3,2
25,272,272,5,5,0,1,0
37,278,278,13,10,3,2,1
14,293,293,22,9,13,2,1
16,299,299,10,3,7,2,1
2,312,312,15,7,8,3,2
7,338,338,25,25,0,1,0
34,343,343,79,79,0,1,0
26,345,345,51,27,24,4,3
18,377,377,56,24,32,3,2
40,394,394,6,6,0,1,0
6,401,401,46,46,0,1,0
32,402,402,21,21,0,1,0
15,417,417,5,5,0,1,0
1,418,418,5,2,3,2,1
17,421,421,23,3,20,4,3
0,426,426,101,101,0,1,0
28,427,427,100,97,3,2,1
36,436,436,30,30,0,1,0
10,468,468,14,8,6,2,1
19,471,471,7,7,0,1,0
35,476,476,3,3,0,1,0
12,483,483,29,5,24,2,1

11,100,100,7,7,0,1,0
31,108,108,7,4,3,2,1
22,112,112,19,12,7,2,1
4,133,133,17,17,0,1,0
6,174,174,26,26,0,1,0
12,186,186,5,5,0,1,0
21,190,190,12,5,7,2,1
1,215,215,40,40,0,1,0
0,228,228,6,2,4,2,1
18,234,234,2,2,0,1,0
33,244,244,21,5,16,3,2
15,246,246,38,38,0,1,0
8,257,257,13,13,0,1,0
28,304,304,4,4,0,1,0
5,314,314,29,5,24,4,3
30,316,316,3,3,0,1,0
37,331,331,50,50,0,1,0
9,336,336,26,2,24,4,3
17,342,342,18,18,0,1,0
25,344,344,2,2,0,1,0
23,366,366,47,47,0,1,0
32,371,371,72,22,50,3,2
29,376,376,25,6,19,2,1
36,377,377,14,14,0,1,0
26,399,399,24,7,17,2,1
14,400,400,19,4,15,4,3
19,401,401,20,20,0,1,0
35,417,417,44,24,20,3,2
2,423,423,26,20,6,3,2
7,425,425,79,79,0,1,0
16,429,429,27,6,21,4,3
27,431,431,82,29,53,3,2
10,435,435,7,7,0,1,0
3,441,441,141,47,94,4,3
20,443,443,72,64,8,3,2
24,454,454,17,4,13,4,3
34,479,479,139,16,123,4,3
13,489,489,17,17,0,1,0

4,146,146,20,20,0,1,0
36,146,146,3,3,0,1,0
37,147,147,2,2,0,1,0
19,149,149,30,30,0,1,0
26,149,149,15,15,0,1,0
34,164,164,2,2,0,1,0
12,165,165,27,27,0,1,0
17,190,190,19,16,3,2,1
10,198,198,27,3,24,2,1
31,204,204,62,54,8,2,1
11,216,216,5,5,0,1,0
7,218,218,11,2,9,2,1
24,227,227,41,27,14,2,1
16,235,235,1,1,0,1,0
28,243,243,12,6,6,3,2
33,244,244,2,2,0,1,0
18,249,249,29,11,18,2,1
25,259,259,11,11,0,1,0
22,266,266,130,96,34,3,2
9,271,271,10,1,9,2,1
21,275,275,21,21,0,1,0
38,282,282,17,17,0,1,0
30,302,302,13,6,7,2,1
20,306,306,52,52,0,1,0
32,307,307,110,110,0,1,0
23,315,315,2,2,0,1,0
29,330,330,16,16,0,1,0
8,331,331,1,1,0,1,0
15,360,360,11,11,0,1,0
35,370,370,8,8,0,1,0
5,439,439,18,9,9,2,1
1,454,454,45,45,0,1,0
13,456,456,27,2,25,2,1
2,464,464,24,24,0,1,0
14,468,468,22,22,0,1,0
3,472,472,64,32,32,2,1
0,480,480,33,17,16,2,1
27,488,488,2,2,0,1,0
6,493,493,63,30,33,2,1

6,100,100,20,20,0,1,0
32,130,130,9,9,0,1,0
12,144,144,20,8,12,2,1
36,151,151,22,1,21,2,1
7,154,154,17,17,0,1,0
0,157,157,10,10,0,1,0
23,173,173,16,16,0,1,0
22,173,173,2,2,0,1,0
21,174,174,8,3,5,2,1
5,205,205,5,2,3,2,1
30,210,210,33,18,15,4,3
28,218,218,13,13,0,1,0
31,221,221,25,15,10,2,1
4,238,238,21,3,18,4,3
25,250,250,1,1,0,1,0
18,263,263,18,18,0,1,0
14,265,265,1,1,0,1,0
19,271,271,69,36,33,2,1
34,272,272,106,35,71,3,2
35,278,278,26,2,24,3,2
10,283,283,1,1,0,1,0
17,312,312,113,73,40,2,1
15,336,336,29,25,4,2,1
13,343,343,28,11,17,2,1
2,349,349,4,4,0,1,0
26,364,364,18,1,17,2,1
16,369,369,47,47,0,1,0
27,386,386,1,1,0,1,0
11,395,395,14,5,9,2,1
20,398,398,22,22,0,1,0
24,408,408,68,2,66,4,3
9,421,421,3,3,0,1,0
33,436,436,32,3,29,2,1
8,448,448,71,8,63,4,3
29,467,467,28,12,16,2,1
1,475,475,92,92,0,1,0
3,486,486,17,17,0,1,0

30,100,100,2,2,0,1,0
33,114,114,15,5,10,2,1
23,121,121,4,4,0,1,0
18,140,140,23,23,0,1,0
2,150,150,9,9,0,1,0
4,154,154,18,18,0,1,0
27,160,160,14,4,10,4,3
10,160,160,12,12,0,1,0
21,164,164,3,3,0,1,0
20,167,167,10,10,0,1,0
25,189,189,16,16,0,1,0
0,191,191,20,20,0,1,0
19,235,235,16,16,0,1,0
17,257,257,6,6,0,1,0
9,264,264,4,4,0,1,0
5,265,265,1,1,0,1,0
24,295,295,2,2,0,1,0
16,301,301,1,1,0,1,0
6,307,307,25,8,17,3,2
36,315,315,30,30,0,1,0
3,319,319,75,11,64,3,2
15,328,328,7,7,0,1,0
32,336,336,65,65,0,1,0
37,337,337,20,1,19,2,1
7,348,348,53,53,0,1,0
8,352,352,6,6,0,1,0
31,354,354,43,43,0,1,0
34,359,359,47,47,0,1,0
35,391,391,7,1,6,2,1
11,416,416,56,49,7,2,1
26,424,424,19,9,10,2,1
29,429,429,28,11,17,2,1
12,429,429,27,1,26,3,2
14,432,432,110,104,6,3,2
28,454,454,40,40,0,1,0
39,456,456,24,24,0,1,0
1,464,464,41,41,0,1,0
22,481,481,94,94,0,1,0
13,491,491,20,11,9,4,3
38,494,494,200,188,12,2,1

29,103,103,29,29,0,1,0
27,153,153,24,3,21,4,3
20,176,176,32,5,27,4,3
19,179,179,1,1,0,1,0
36,186,186,29,8,21,3,2
13,189,189,33,11,22,3,2
9,220,220,6,6,0,1,0
33,222,222,13,13,0,1,0
34,227,227,2,2,0,1,0
35,234,234,8,8,0,1,0
15,245,245,46,10,36,4,3
32,249,249,53,9,44,3,2
28,259,259,20,16,4,2,1
16,265,265,15,7,8,2,1
30,266,266,16,16,0,1,0
18,266,266,9,9,0,1,0
11,268,268,43,10,33,4,3
37,269,269,26,9,17,2,1
25,273,273,62,62,0,1,0
3,280,280,67,67,0,1,0
12,280,280,22,22,0,1,0
31,294,294,11,7,4,2,1
22,300,300,43,37,6,2,1
23,317,317,7,7,0,1,0
7,338,338,10,10,0,1,0
0,345,345,41,41,0,1,0
39,352,352,2,2,0,1,0
17,369,369,5,5,0,1,0
38,375,375,40,40,0,1,0
5,391,391,31,19,12,4,3
2,397,397,5,5,0,1,0
24,400,400,2,2,0,1,0
1,404,404,1,1,0,1,0
6,407,407,53,53,0,1,0
8,408,408,3,3,0,1,0
4,412,412,46,17,29,2,1
26,416,416,63,63,0,1,0
21,442,442,24,8,16,4,3
14,447,447,33,5,28,3,2
10,468,468,10,3,7,2,1

14,100,100,28,7,21,4,3
11,110,110,11,7,4,2,1
25,143,143,6,6,0,1,0
27,146,146,10,1,9,4,3
33,157,157,41,41,0,1,0
31,167,167,1,1,0,1,0
15,170,170,9,4,5,2,1
10,190,190,60,39,21,4,3
28,201,201,20,4,16,3,2
4,201,201,19,12,7,2,1
18,221,221,2,2,0,1,0
22,225,225,30,2,28,2,1
32,228,228,1,1,0,1,0
6,229,229,19,2,17,2,1
30,269,269,42,14,28,3,2
3,270,270,30,30,0,1,0
12,270,270,66,46,20,2,1
7,271,271,1,1,0,1,0
5,280,280,47,21,26,2,1
13,285,285,25,25,0,1,0
1,330,330,9,9,0,1,0
17,348,348,58,58,0,1,0
20,350,350,19,1,18,3,2
26,351,351,10,10,0,1,0
16,408,408,25,10,15,2,1
24,440,440,156,134,22,3,2
2,441,441,2,2,0,1,0
9,458,458,17,17,0,1,0
8,458,458,16,16,0,1,0
19,464,464,96,92,4,2,1
23,467,467,2,2,0,1,0
29,481,481,30,16,14,2,1
21,484,484,52,52,0,1,0
0,492,492,78,30,48,4,3

19,141,141,14,14,0,1,0
20,166,166,15,2,13,2,1
3,169,169,26,26,0,1,0
6,172,172,1,1,0,1,0
21,180,180,37,13,24,4,3
11,182,182,5,5,0,1,0
27,182,182,28,20,8,3,2
2,190,190,26,4,22,3,2
4,202,202,68,21,47,4,3
23,208,208,6,6,0,1,0
10,244,244,19,9,10,2,1
14,258,258,89,32,57,4,3
5,271,271,96,36,60,4,3
12,283,283,9,9,0,1,0
26,305,305,32,32,0,1,0
8,316,316,182,182,0,1,0
13,328,328,13,13,0,1,0
15,356,356,22,22,0,1,0
25,366,366,22,4,18,2,1
24,368,368,2,2,0,1,0
28,370,370,62,19,43,2,1
16,400,400,54,27,27,2,1
7,420,420,15,15,0,1,0
17,424,424,18,8,10,3,2
30,435,435,66,66,0,1,0
18,446,446,11,2,9,2,1
1,449,449,4,4,0,1,0
31,455,455,3,3,0,1,0
9,464,464,4,4,0,1,0
29,479,479,59,59,0,1,0
22,490,490,12,12,0,1,0
0,497,497,4,4,0,1,0

14,110,110,5,5,0,1,0
8,111,111,13,5,8,2,1
37,113,113,27,27,0,1,0
45,114,114,3,3,0,1,0
4,124,124,1,1,0,1,0
24,127,127,18,18,0,1,0
21,134,134,6,2,4,2,1
33,155,155,10,10,0,1,0
39,178,178,1,1,0,1,0
15,187,187,9,3,6,2,1
23,190,190,18,18,0,1,0
6,190,190,6,6,0,1,0
1,193,193,5,5,0,1,0
20,196,196,11,11,0,1,0
32,200,200,3,3,0,1,0
27,204,204,37,28,9,2,1
9,215,215,5,5,0,1,0
19,220,220,2,2,0,1,0
26,231,231,19,19,0,1,0
36,233,233,2,2,0,1,0
42,262,262,52,24,28,3,2
28,288,288,13,3,10,3,2
25,292,292,22,3,19,2,1
3,293,293,46,22,24,2,1
18,307,307,2,2,0,1,0
31,313,313,72,44,28,2,1
43,317,317,39,39,0,1,0
12,360,360,2,2,0,1,0
40,364,364,1,1,0,1,0
44,366,366,61,32,29,2,1
17,377,377,52,44,8,2,1
10,403,403,45,6,39,4,3
41,403,403,28,12,16,2,1
7,405,405,3,3,0,1,0
13,410,410,41,11,30,3,2
29,429,429,7,7,0,1,0
38,436,436,91,91,0,1,0
30,442,442,79,52,27,2,1
11,443,443,15,15,0,1,0
16,453,453,45,27,18,4,3
0,453,453,38,38,0,1,0
5,474,474,15,15,0,1,0
34,491,491,19,1,18,2,1
22,494,494,13,2,11,2,1
2,495,495,9,1,8,3,2
35,497,497,98,44,54,3,2

10,123,123,1,1,0,1,0
30,135,135,12,1,11,2,1
25,136,136,9,9,0,1,0
0,141,141,2,2,0,1,0
17,145,145,8,5,3,2,1
6,154,154,12,3,9,4,3
3,159,159,5,1,4,2,1
31,168,168,21,17,4,2,1
24,179,179,11,11,0,1,0
29,213,213,40,16,24,4,3
9,225,225,42,42,0,1,0
11,245,245,15,15,0,1,0
28,247,247,34,34,0,1,0
32,255,255,26,26,0,1,0
16,266,266,66,52,14,3,2
21,272,272,2,2,0,1,0
5,276,276,61,61,0,1,0
8,296,296,3,3,0,1,0
4,300,300,17,17,0,1,0
7,307,307,214,201,13,2,1
13,322,322,14,6,8,3,2
18,337,337,48,48,0,1,0
22,369,369,82,44,38,2,1
2,408,408,92,46,46,2,1
15,409,409,31,19,12,2,1
20,414,414,35,6,29,4,3
14,420,420,1,1,0,1,0
27,443,443,42,42,0,1,0
26,450,450,5,2,3,2,1
19,452,452,21,12,9,4,3
12,462,462,75,75,0,1,0
1,488,488,2,2,0,1,0
23,492,492,41,30,11,2,1

7,112,112,11,11,0,1,0
30,118,118,7,2,5,2,1
9,119,119,1,1,0,1,0
23,136,136,3,3,0,1,0
4,141,141,7,7,0,1,0
8,143,143,10,10,0,1,0
5,152,152,12,12,0,1,0
6,157,157,8,8,0,1,0
29,158,158,12,12,0,1,0
1,160,160,45,45,0,1,0
20,179,179,2,2,0,1,0
24,185,185,3,3,0,1,0
28,185,185,55,55,0,1,0
34,203,203,11,11,0,1,0
11,219,219,4,1,3,2,1
19,221,221,8,8,0,1,0
3,225,225,5,5,0,1,0
17,226,226,21,12,9,4,3
13,234,234,91,17,74,4,3
12,235,235,8,8,0,1,0
10,240,240,4,4,0,1,0
27,256,256,9,9,0,1,0
21,258,258,6,6,0,1,0
22,278,278,60,40,20,2,1
0,322,322,30,30,0,1,0
26,386,386,51,5,46,3,2
35,388,388,9,6,3,2,1
16,389,389,79,79,0,1,0
18,399,399,26,26,0,1,0
14,406,406,19,9,10,2,1
25,421,421,31,31,0,1,0
2,440,440,62,62,0,1,0
33,442,442,27,27,0,1,0
15,446,446,49,49,0,1,0
31,478,478,16,16,0,1,0
32,482,482,287,197,90,4,3

14,102,102,2,2,0,1,0
36,114,114,18,2,16,3,2
12,119,119,3,3,0,1,0
6,125,125,3,3,0,1,0
27,134,134,17,17,0,1,0
21,141,141,16,12,4,2,1
39,151,151,13,8,5,2,1
37,152,152,5,5,0,1,0
31,156,156,8,8,0,1,0
1,159,159,28,22,6,3,2
18,180,180,6,3,3,2,1
28,187,187,14,14,0,1,0
10,197,197,12,12,0,1,0
11,206,206,23,23,0,1,0
5,213,213,12,6,6,2,1
4,218,218,18,18,0,1,0
9,233,233,22,16,6,2,1
25,236,236,53,29,24,3,2
38,260,260,30,1,29,4,3
40,265,265,20,20,0,1,0
2,271,271,17,9,8,2,1
24,283,283,39,24,15,2,1
7,299,299,7,1,6,3,2
16,310,310,1,1,0,1,0
26,319,319,24,24,0,1,0
35,341,341,11,11,0,1,0
30,353,353,13,13,0,1,0
33,354,354,79,79,0,1,0
19,355,355,10,1,9,3,2
29,371,371,34,34,0,1,0
41,376,376,167,79,88,3,2
42,377,377,30,20,10,3,2
43,378,378,19,19,0,1,0
8,398,398,51,51,0,1,0
22,400,400,8,2,6,2,1
20,402,402,5,5,0,1,0
17,415,415,38,38,0,1,0
23,421,421,30,8,22,4,3
3,421,421,49,21,28,2,1
0,451,451,10,10,0,1,0
32,471,471,23,3,20,3,2
13,480,480,13,5,8,2,1
34,488,488,19,8,11,2,1
15,491,491,17,17,0,1,0

38,102,102,11,11,0,1,0
11,110,110,5,5,0,1,0
33,116,116,4,1,3,2,1
17,116,116,20,1,19,2,1
35,121,121,2,2,0,1,0
26,122,122,2,2,0,1,0
14,124,124,18,18,0,1,0
0,177,177,7,3,4,2,1
6,177,177,47,4,43,4,3
19,191,191,7,1,6,3,2
10,237,237,10,10,0,1,0
18,239,239,8,8,0,1,0
41,244,244,3,3,0,1,0
1,244,244,1,1,0,1,0
2,263,263,27,8,19,2,1
5,275,275,29,29,0,1,0
9,279,279,12,12,0,1,0
40,283,283,38,38,0,1,0
31,287,287,53,25,28,3,2
36,298,298,8,8,0,1,0
4,304,304,6,6,0,1,0
34,339,339,68,24,44,3,2
25,360,360,23,11,12,4,3
15,363,363,38,38,0,1,0
20,371,371,20,13,7,2,1
37,374,374,7,7,0,1,0
3,379,379,18,18,0,1,0
21,384,384,4,4,0,1,0
32,395,395,81,11,70,3,2
16,404,404,24,24,0,1,0
13,405,405,66,66,0,1,0
8,438,438,46,43,3,2,1
12,441,441,1,1,0,1,0
7,449,449,27,1,26,2,1
27,449,449,58,58,0,1,0
24,462,462,87,31,56,4,3
30,467,467,105,79,26,2,1
29,473,473,80,80,0,1,0
22,494,494,57,57,0,1,0
39,496,496,45,21,24,4,3
28,497,497,9,4,5,2,1
23,498,498,12,2,10,2,1

35,103,103,27,2,25,3,2
38,112,112,1,1,0,1,0
17,125,125,2,2,0,1,0
4,134,134,4,4,0,1,0
26,138,138,2,2,0,1,0
40,141,141,5,5,0,1,0
7,149,149,35,35,0,1,0
11,163,163,5,5,0,1,0
22,164,164,10,10,0,1,0
20,196,196,17,17,0,1,0
28,212,212,18,18,0,1,0
32,221,221,17,13,4,2,1
23,226,226,51,39,12,2,1
33,249,249,3,3,0,1,0
6,255,255,12,12,0,1,0
1,263,263,13,13,0,1,0
14,279,279,25,16,9,4,3
24,288,288,51,5,46,2,1
36,296,296,63,63,0,1,0
13,297,297,1,1,0,1,0
39,302,302,12,12,0,1,0
37,302,302,30,30,0,1,0
8,317,317,33,17,16,2,1
15,333,333,2,2,0,1,0
31,334,334,28,12,16,3,2
34,350,350,36,28,8,3,2
16,352,352,47,47,0,1,0
3,357,357,6,6,0,1,0
9,358,358,11,11,0,1,0
0,368,368,16,9,7,2,1
2,395,395,20,20,0,1,0
5,408,408,1,1,0,1,0
18,419,419,33,9,24,4,3
12,427,427,99,57,42,4,3
10,440,440,17,17,0,1,0
25,445,445,131,50,81,4,3
30,468,468,5,5,0,1,0
27,478,478,42,5,37,2,1
19,483,483,115,85,30,3,2
21,486,486,86,79,7,2,1
29,491,491,2,2,0,1,0

6,101,101,22,1,21,2,1
20,131,131,20,20,0,1,0
27,145,145,7,7,0,1,0
8,156,156,10,6,4,2,1
13,184,184,4,4,0,1,0
39,197,197,3,3,0,1,0
17,198,198,9,9,0,1,0
26,216,216,75,23,52,3,2
7,222,222,42,42,0,1,0
16,225,225,3,3,0,1,0
12,271,271,14,4,10,2,1
1,294,294,18,6,12,2,1
37,297,297,5,5,0,1,0
24,308,308,21,2,19,2,1
9,309,309,26,16,10,3,2
0,311,311,38,31,7,2,1
36,314,314,1,1,0,1,0
18,317,317,19,19,0,1,0
19,322,322,13,13,0,1,0
21,328,328,6,6,0,1,0
28,329,329,30,17,13,2,1
25,332,332,1,1,0,1,0
10,342,342,1,1,0,1,0
31,353,353,100,40,60,4,3
4,358,358,17,11,6,3,2
30,358,358,132,90,42,3,2
11,363,363,23,17,6,2,1
40,374,374,10,10,0,1,0
15,385,385,1,1,0,1,0
14,398,398,22,4,18,2,1
33,407,407,4,4,0,1,0
2,421,421,30,30,0,1,0
22,454,454,14,14,0,1,0
29,461,461,62,32,30,3,2
34,466,466,7,7,0,1,0
32,476,476,21,16,5,2,1
3,478,478,6,6,0,1,0
5,479,479,178,141,37,4,3
38,494,494,157,128,29,3,2
23,499,499,7,7,0,1,0
35,500,500,11,11,0,1,0

5,124,124,10,10,0,1,0
17,132,132,14,14,0,1,0
19,143,143,36,36,0,1,0
1,144,144,10,10,0,1,0
24,167,167,14,14,0,1,0
16,173,173,20,6,14,3,2
12,189,189,1,1,0,1,0
3,190,190,18,1,17,2,1
30,192,192,11,11,0,1,0
23,217,217,2,2,0,1,0
14,223,223,70,24,46,2,1
29,230,230,112,100,12,3,2
10,237,237,1,1,0,1,0
26,245,245,8,1,7,2,1
15,251,251,19,4,15,4,3
13,260,260,55,28,27,4,3
28,261,261,22,4,18,2,1
9,282,282,9,3,6,3,2
11,317,317,66,66,0,1,0
20,336,336,23,23,0,1,0
27,356,356,6,1,5,2,1
0,358,358,45,18,27,4,3
25,373,373,19,19,0,1,0
8,386,386,16,4,12,3,2
7,386,386,2,2,0,1,0
31,386,386,2,2,0,1,0
21,414,414,37,4,33,4,3
32,415,415,3,3,0,1,0
22,421,421,40,26,14,3,2
33,425,425,57,14,43,2,1
2,425,425,156,156,0,1,0
18,448,448,59,26,33,4,3
6,451,451,22,22,0,1,0
4,473,473,56,20,36,2,1

17,131,131,7,2,5,2,1
29,145,145,46,46,0,1,0
25,155,155,18,18,0,1,0
16,155,155,1,1,0,1,0
7,159,159,1,1,0,1,0
28,180,180,25,25,0,1,0
18,186,186,2,2,0,1,0
22,190,190,2,2,0,1,0
5,198,198,7,7,0,1,0
31,198,198,17,4,13,2,1
4,219,219,33,33,0,1,0
19,227,227,13,13,0,1,0
9,232,232,25,25,0,1,0
1,245,245,12,12,0,1,0
6,245,245,49,49,0,1,0
0,251,251,67,67,0,1,0
10,269,269,1,1,0,1,0
33,283,283,9,9,0,1,0
15,325,325,21,1,20,2,1
26,334,334,34,34,0,1,0
24,339,339,65,65,0,1,0
13,344,344,44,9,35,2,1
20,346,346,53,44,9,2,1
8,350,350,47,47,0,1,0
30,356,356,56,40,16,3,2
27,361,361,79,19,60,3,2
3,365,365,22,2,20,3,2
2,388,388,107,107,0,1,0
32,433,433,49,10,39,4,3
11,440,440,125,125,0,1,0
12,446,446,7,7,0,1,0
21,464,464,33,33,0,1,0
14,488,488,10,10,0,1,0
23,490,490,4,1,3,2,1

29,141,141,8,2,6,3,2
17,145,145,8,2,6,3,2
12,172,172,1,1,0,1,0
8,174,174,25,7,18,3,2
24,178,178,2,2,0,1,0
5,185,185,9,9,0,1,0
23,187,187,11,11,0,1,0
22,191,191,22,13,9,2,1
25,199,199,23,23,0,1,0
30,200,200,7,7,0,1,0
14,216,216,52,52,0,1,0
18,227,227,24,24,0,1,0
0,239,239,6,3,3,2,1
33,241,241,3,3,0,1,0
1,246,246,10,10,0,1,0
2,248,248,74,74,0,1,0
6,252,252,47,40,7,2,1
26,259,259,51,51,0,1,0
9,260,260,12,12,0,1,0
19,269,269,15,15,0,1,0
20,278,278,14,9,5,2,1
4,281,281,11,4,7,2,1
31,284,284,73,35,38,4,3
3,311,311,4,4,0,1,0
16,327,327,34,7,27,2,1
13,332,332,107,107,0,1,0
11,336,336,11,2,9,2,1
34,339,339,33,33,0,1,0
15,358,358,15,9,6,3,2
27,371,371,142,130,12,4,3
32,404,404,5,5,0,1,0
28,416,416,64,41,23,2,1
7,419,419,59,11,48,4,3
10,421,421,30,30,0,1,0
21,500,500,33,33,0,1,0

19,100,100,11,11,0,1,0
16,111,111,20,5,15,4,3
32,133,133,6,3,3,2,1
28,135,135,5,5,0,1,0
11,141,141,9,9,0,1,0
4,143,143,5,5,0,1,0
29,160,160,5,5,0,1,0
6,170,170,3,3,0,1,0
20,172,172,6,6,0,1,0
2,177,177,16,16,0,1,0
30,177,177,60,53,7,2,1
12,187,187,10,10,0,1,0
8,212,212,22,22,0,1,0
0,232,232,35,7,28,3,2
17,239,239,91,43,48,3,2
31,245,245,5,1,4,2,1
14,247,247,8,8,0,1,0
34,277,277,5,5,0,1,0
18,278,278,29,29,0,1,0
9,279,279,12,1,11,2,1
1,283,283,24,24,0,1,0
33,295,295,108,72,36,2,1
35,302,302,13,5,8,2,1
24,304,304,22,22,0,1,0
22,317,317,3,3,0,1,0
7,321,321,1,1,0,1,0
26,326,326,61,48,13,2,1
10,327,327,24,24,0,1,0
13,368,368,20,20,0,1,0
5,371,371,56,30,26,3,2
27,375,375,37,37,0,1,0
23,375,375,45,45,0,1,0
21,425,425,69,69,0,1,0
36,466,466,33,33,0,1,0
15,477,477,9,1,8,2,1
3,491,491,79,17,62,3,2
25,499,499,34,16,18,2,1

20,110,110,3,3,0,1,0
26,185,185,2,2,0,1,0
21,188,188,1,1,0,1,0
15,192,192,18,12,6,2,1
22,207,207,47,35,12,3,2
2,222,222,25,25,0,1,0
16,224,224,23,14,9,2,1
17,231,231,39,12,27,4,3
5,242,242,15,15,0,1,0
4,258,258,58,58,0,1,0
32,269,269,20,12,8,2,1
27,288,288,49,49,0,1,0
11,289,289,7,7,0,1,0
9,308,308,32,32,0,1,0
14,308,308,3,3,0,1,0
10,319,319,1,1,0,1,0
18,320,320,54,54,0,1,0
23,321,321,25,16,9,4,3
30,340,340,40,16,24,3,2
33,344,344,64,64,0,1,0
1,367,367,40,40,0,1,0
34,377,377,31,27,4,2,1
19,386,386,31,31,0,1,0
29,388,388,37,37,0,1,0
7,393,393,15,15,0,1,0
3,403,403,13,13,0,1,0
13,426,426,7,7,0,1,0
25,468,468,19,3,16,3,2
8,469,469,54,4,50,2,1
24,475,475,58,53,5,2,1
28,482,482,13,7,6,2,1
0,487,487,33,33,0,1,0
12,487,487,83,49,34,4,3
6,496,496,257,241,16,3,2
31,499,499,79,24,55,4,3

0,110,110,14,14,0,1,0
30,117,117,28,12,16,3,2
31,120,120,1,1,0,1,0
26,120,120,3,3,0,1,0
19,142,142,6,6,0,1,0
12,159,159,9,9,0,1,0
16,166,166,6,6,0,1,0
29,193,193,36,36,0,1,0
14,215,215,30,30,0,1,0
23,229,229,2,2,0,1,0
17,278,278,29,29,0,1,0
5,279,279,83,83,0,1,0
9,282,282,48,48,0,1,0
6,316,316,4,4,0,1,0
24,326,326,80,80,0,1,0
28,329,329,24,2,22,3,2
3,333,333,15,15,0,1,0
11,374,374,90,10,80,3,2
8,378,378,11,2,9,4,3
13,386,386,98,98,0,1,0
10,389,389,57,37,20,3,2
18,406,406,21,7,14,3,2
2,421,421,12,12,0,1,0
25,422,422,4,1,3,2,1
4,443,443,84,64,20,3,2
15,460,460,77,77,0,1,0
21,465,465,62,18,44,3,2
1,473,473,78,30,48,4,3
7,475,475,19,7,12,3,2
27,482,482,11,11,0,1,0
22,484,484,54,54,0,1,0
20,490,490,116,46,70,4,3

40,121,121,7,7,0,1,0
3,138,138,19,19,0,1,0
36,138,138,34,11,23,2,1
25,147,147,2,2,0,1,0
20,163,163,6,6,0,1,0
16,166,166,3,3,0,1,0
10,169,169,9,1,8,3,2
1,175,175,6,6,0,1,0
12,197,197,27,16,11,2,1
6,207,207,7,7,0,1,0
26,212,212,6,6,0,1,0
7,220,220,1,1,0,1,0
41,221,221,72,72,0,1,0
34,224,224,8,8,0,1,0
0,228,228,8,8,0,1,0
37,243,243,22,15,7,2,1
9,247,247,41,41,0,1,0
24,259,259,85,67,18,4,3
32,285,285,21,11,10,2,1
8,291,291,32,32,0,1,0
29,299,299,26,26,0,1,0
15,299,299,40,40,0,1,0
5,316,316,2,2,0,1,0
28,330,330,29,20,9,4,3
13,332,332,5,5,0,1,0
21,357,357,25,25,0,1,0
18,360,360,34,34,0,1,0
38,375,375,38,38,0,1,0
22,379,379,16,4,12,2,1
33,381,381,10,6,4,2,1
27,388,388,29,3,26,2,1
11,396,396,23,23,0,1,0
42,420,420,47,15,32,2,1
4,434,434,17,7,10,2,1
17,438,438,18,18,0,1,0
35,440,440,123,77,46,2,1
19,449,449,11,11,0,1,0
39,461,461,47,16,31,2,1
2,462,462,45,45,0,1,0
31,470,470,5,5,0,1,0
30,477,477,40,16,24,2,1
23,484,484,10,10,0,1,0
14,491,491,32,32,0,1,0

31,106,106,10,1,9,2,1
36,115,115,4,4,0,1,0
34,119,119,10,2,8,3,2
25,137,137,30,30,0,1,0
16,139,139,3,3,0,1,0
8,139,139,1,1,0,1,0
4,147,147,43,5,38,3,2
30,169,169,31,13,18,2,1
17,180,180,27,27,0,1,0
22,194,194,105,105,0,1,0
21,196,196,6,6,0,1,0
18,210,210,11,11,0,1,0
13,212,212,22,10,12,4,3
37,234,234,4,4,0,1,0
32,252,252,6,6,0,1,0
0,283,283,18,18,0,1,0
15,290,290,29,11,18,3,2
2,301,301,3,3,0,1,0
7,322,322,38,18,20,2,1
35,333,333,4,1,3,2,1
28,341,341,25,10,15,2,1
1,343,343,56,37,19,2,1
9,354,354,8,8,0,1,0
33,355,355,15,15,0,1,0
20,362,362,33,8,25,3,2
23,372,372,12,12,0,1,0
27,390,390,70,54,16,3,2
6,395,395,55,34,21,2,1
19,427,427,102,19,83,4,3
11,431,431,3,3,0,1,0
14,431,431,1,1,0,1,0
3,431,431,47,35,12,3,2
38,433,433,41,3,38,2,1
12,433,433,1,1,0,1,0
24,462,462,49,23,26,2,1
29,485,485,17,4,13,2,1
26,491,491,16,7,9,2,1
5,491,491,5,1,4,2,1
10,495,495,48,30,18,4,3

36,104,104,22,16,6,3,2
39,111,111,12,4,8,2,1
9,130,130,1,1,0,1,0
25,131,131,1,1,0,1,0
3,139,139,1,1,0,1,0
2,141,141,12,12,0,1,0
13,163,163,10,10,0,1,0
21,174,174,9,9,0,1,0
45,185,185,49,49,0,1,0
10,192,192,4,1,3,2,1
47,198,198,47,47,0,1,0
23,201,201,17,17,0,1,0
40,208,208,3,3,0,1,0
31,209,209,6,2,4,2,1
1,210,210,1,1,0,1,0
35,210,210,14,14,0,1,0
8,234,234,19,3,16,3,2
38,248,248,7,7,0,1,0
15,262,262,7,7,0,1,0
4,267,267,8,8,0,1,0
16,267,267,16,9,7,2,1
0,270,270,13,13,0,1,0
18,280,280,6,6,0,1,0
44,286,286,14,2,12,3,2
24,297,297,95,13,82,3,2
14,307,307,36,36,0,1,0
41,324,324,22,13,9,2,1
26,328,328,13,8,5,2,1
46,339,339,67,67,0,1,0
37,341,341,6,6,0,1,0
7,356,356,5,5,0,1,0
28,395,395,37,2,35,4,3
17,397,397,44,44,0,1,0
43,403,403,74,2,72,4,3
19,405,405,29,29,0,1,0
29,406,406,25,25,0,1,0
42,408,408,1,1,0,1,0
33,409,409,19,9,10,2,1
32,409,409,31,31,0,1,0
27,423,423,48,48,0,1,0
6,425,425,23,5,18,2,1
22,435,435,2,2,0,1,0
30,456,456,35,25,10,2,1
11,463,463,15,15,0,1,0
20,465,465,29,29,0,1,0
12,470,470,33,15,18,4,3
34,494,494,81,27,54,4,3
5,495,495,18,11,7,2,1

38,102,102,14,6,8,3,2
8,109,109,19,19,0,1,0
29,141,141,16,16,0,1,0
10,160,160,1,1,0,1,0
35,173,173,7,7,0,1,0
20,216,216,6,3,3,2,1
36,221,221,17,17,0,1,0
39,229,229,18,4,14,3,2
17,245,245,10,10,0,1,0
9,248,248,37,37,0,1,0
30,249,249,31,31,0,1,0
31,251,251,15,15,0,1,0
6,259,259,5,2,3,2,1
26,260,260,39,23,16,3,2
14,265,265,3,3,0,1,0
3,267,267,14,6,8,2,1
16,287,287,62,62,0,1,0
19,289,289,20,20,0,1,0
2,296,296,2,2,0,1,0
11,299,299,92,62,30,4,3
12,300,300,1,1,0,1,0
25,307,307,11,11,0,1,0
4,310,310,3,3,0,1,0
34,316,316,1,1,0,1,0
23,320,320,11,3,8,2,1
21,329,329,72,30,42,4,3
37,339,339,74,74,0,1,0
28,348,348,3,3,0,1,0
33,356,356,49,37,12,4,3
22,366,366,29,12,17,2,1
0,400,400,35,35,0,1,0
15,433,433,35,27,8,3,2
5,463,463,35,35,0,1,0
7,465,465,39,15,24,3,2
13,468,468,32,5,27,2,1
27,478,478,27,27,0,1,0
24,481,481,133,83,50,3,2
32,487,487,98,50,48,4,3
1,496,496,18,18,0,1,0
18,499,499,28,28,0,1,0

10,102,102,1,1,0,1,0
27,108,108,29,29,0,1,0
16,130,130,1,1,0,1,0
0,138,138,8,8,0,1,0
24,142,142,1,1,0,1,0
33,158,158,11,11,0,1,0
12,159,159,29,11,18,4,3
4,186,186,28,6,22,2,1
2,197,197,4,4,0,1,0
30,219,219,8,8,0,1,0
26,222,222,5,5,0,1,0
23,251,251,6,6,0,1,0
8,269,269,4,4,0,1,0
35,282,282,37,9,28,3,2
20,295,295,54,4,50,3,2
21,295,295,4,4,0,1,0
3,311,311,9,9,0,1,0
32,321,321,11,4,7,3,2
6,321,321,106,54,52,3,2
31,326,326,70,70,0,1,0
13,335,335,15,5,10,3,2
15,357,357,16,6,10,3,2
25,368,368,68,68,0,1,0
28,369,369,37,37,0,1,0
37,371,371,58,20,38,2,1
9,377,377,72,64,8,3,2
29,391,391,3,3,0,1,0
14,398,398,10,10,0,1,0
11,409,409,24,19,5,2,1
7,420,420,18,8,10,2,1
22,427,427,7,7,0,1,0
36,428,428,12,2,10,3,2
19,438,438,48,48,0,1,0
5,441,441,8,8,0,1,0
34,461,461,118,88,30,4,3
38,470,470,122,6,116,4,3
1,474,474,53,13,40,2,1
17,488,488,26,26,0,1,0
18,497,497,57,23,34,2,1

32,111,111,26,14,12,3,2
30,112,112,13,9,4,2,1
7,117,117,1,1,0,1,0
0,118,118,2,2,0,1,0
8,124,124,35,35,0,1,0
3,139,139,13,5,8,2,1
23,149,149,2,2,0,1,0
39,154,154,18,18,0,1,0
5,157,157,1,1,0,1,0
17,166,166,1,1,0,1,0
35,179,179,22,6,16,2,1
29,192,192,16,16,0,1,0
16,196,196,1,1,0,1,0
41,210,210,12,3,9,4,3
24,214,214,5,5,0,1,0
33,237,237,10,2,8,2,1
38,252,252,9,2,7,2,1
14,276,276,1,1,0,1,0
11,294,294,22,22,0,1,0
21,299,299,15,1,14,2,1
43,310,310,21,21,0,1,0
10,342,342,5,5,0,1,0
22,351,351,77,77,0,1,0
27,351,351,15,3,12,4,3
18,361,361,64,24,40,3,2
12,363,363,6,1,5,2,1
36,371,371,110,100,10,3,2
42,394,394,15,15,0,1,0
1,394,394,5,5,0,1,0
26,395,395,100,86,14,3,2
13,398,398,3,3,0,1,0
4,408,408,18,9,9,4,3
6,414,414,53,53,0,1,0
31,415,415,37,33,4,2,1
40,421,421,36,4,32,3,2
2,443,443,60,26,34,4,3
15,452,452,61,21,40,3,2
19,456,456,28,28,0,1,0
20,459,459,14,8,6,2,1
9,460,460,22,7,15,4,3
37,465,465,61,53,8,3,2
34,469,469,5,5,0,1,0
28,481,481,8,8,0,1,0
25,487,487,91,51,40,3,2

3,109,109,1,1,0,1,0
8,112,112,39,39,0,1,0
12,124,124,23,23,0,1,0
27,125,125,1,1,0,1,0
24,140,140,1,1,0,1,0
29,152,152,14,14,0,1,0
18,160,160,20,20,0,1,0
6,169,169,8,8,0,1,0
0,195,195,31,31,0,1,0
26,198,198,11,11,0,1,0
7,215,215,57,49,8,3,2
15,218,218,45,45,0,1,0
19,221,221,2,2,0,1,0
9,231,231,8,8,0,1,0
28,253,253,42,42,0,1,0
23,267,267,19,13,6,2,1
11,275,275,29,29,0,1,0
1,283,283,28,13,15,2,1
10,303,303,14,2,12,2,1
22,305,305,37,37,0,1,0
30,316,316,14,7,7,2,1
21,343,343,157,46,111,4,3
17,346,346,25,7,18,4,3
14,347,347,9,9,0,1,0
25,351,351,1,1,0,1,0
13,388,388,67,43,24,4,3
20,402,402,41,41,0,1,0
2,481,481,122,105,17,4,3
16,483,483,45,45,0,1,0
5,493,493,94,57,37,2,1
4,496,496,30,16,14,3,2

10,103,103,6,6,0,1,0
16,115,115,13,2,11,2,1
18,117,117,23,23,0,1,0
0,118,118,4,4,0,1,0
32,129,129,7,7,0,1,0
7,131,131,1,1,0,1,0
23,132,132,8,2,6,3,2
24,133,133,6,6,0,1,0
40,134,134,25,4,21,4,3
33,134,134,17,6,11,2,1
2,141,141,11,11,0,1,0
15,145,145,5,1,4,2,1
21,171,171,8,8,0,1,0
28,177,177,8,8,0,1,0
8,195,195,3,3,0,1,0
13,211,211,13,1,12,3,2
17,218,218,3,3,0,1,0
5,237,237,48,48,0,1,0
36,244,244,23,13,10,3,2
20,250,250,5,5,0,1,0
27,259,259,3,3,0,1,0
41,260,260,3,3,0,1,0
29,267,267,1,1,0,1,0
37,275,275,25,25,0,1,0
14,323,323,56,32,24,3,2
11,323,323,90,90,0,1,0
38,343,343,6,6,0,1,0
31,369,369,35,14,21,4,3
25,371,371,8,8,0,1,0
30,373,373,130,130,0,1,0
6,397,397,3,3,0,1,0
39,398,398,71,45,26,3,2
4,399,399,17,8,9,4,3
12,403,403,6,6,0,1,0
26,406,406,196,155,41,2,1
9,408,408,75,33,42,4,3
35,423,423,9,1,8,2,1
1,429,429,1,1,0,1,0
3,433,433,12,7,5,2,1
42,460,460,19,19,0,1,0
34,477,477,1,1,0,1,0
19,491,491,41,41,0,1,0
22,493,493,1,1,0,1,0

29,113,113,23,23,0,1,0
30,113,113,1,1,0,1,0
3,127,127,33,33,0,1,0
0,133,133,1,1,0,1,0
14,159,159,3,3,0,1,0
27,161,161,9,9,0,1,0
4,163,163,1,1,0,1,0
23,169,169,16,16,0,1,0
7,177,177,28,25,3,2,1
17,180,180,33,33,0,1,0
6,199,199,73,46,27,2,1
21,201,201,56,48,8,2,1
26,222,222,10,4,6,3,2
20,229,229,8,2,6,2,1
22,252,252,32,32,0,1,0
2,254,254,37,13,24,2,1
12,297,297,9,9,0,1,0
18,330,330,4,4,0,1,0
28,331,331,26,12,14,4,3
15,342,342,110,66,44,2,1
13,358,358,12,1,11,4,3
25,373,373,29,29,0,1,0
1,377,377,78,50,28,3,2
8,380,380,4,4,0,1,0
19,395,395,34,34,0,1,0
24,441,441,26,26,0,1,0
11,459,459,68,40,28,3,2
5,464,464,3,3,0,1,0
9,484,484,45,5,40,4,3
10,495,495,180,180,0,1,0
16,499,499,68,60,8,2,1

16,100,100,8,1,7,2,1
34,104,104,19,9,10,2,1
36,104,104,12,3,9,4,3
6,107,107,2,2,0,1,0
5,132,132,15,15,0,1,0
45,141,141,13,1,12,2,1
11,144,144,37,37,0,1,0
14,157,157,5,2,3,2,1
9,175,175,1,1,0,1,0
37,189,189,10,10,0,1,0
19,190,190,8,8,0,1,0
1,194,194,1,1,0,1,0
0,197,197,12,5,7,2,1
40,205,205,2,2,0,1,0
39,218,218,26,26,0,1,0
32,234,234,16,16,0,1,0
28,239,239,12,12,0,1,0
25,243,243,3,3,0,1,0
8,257,257,5,5,0,1,0
4,257,257,6,6,0,1,0
38,264,264,27,12,15,2,1
30,293,293,22,22,0,1,0
22,302,302,22,22,0,1,0
33,303,303,42,42,0,1,0
29,309,309,11,11,0,1,0
27,322,322,7,7,0,1,0
35,331,331,8,8,0,1,0
2,369,369,3,3,0,1,0
47,376,376,36,3,33,4,3
13,376,376,7,7,0,1,0
44,384,384,13,10,3,2,1
41,385,385,16,16,0,1,0
48,392,392,23,23,0,1,0
26,393,393,21,21,0,1,0
49,402,402,10,10,0,1,0
18,407,407,15,15,0,1,0
46,410,410,63,63,0,1,0
43,428,428,128,11,117,4,3
31,433,433,106,76,30,4,3
23,443,443,7,7,0,1,0
21,447,447,20,20,0,1,0
7,452,452,12,3,9,2,1
20,453,453,61,33,28,3,2
17,460,460,29,29,0,1,0
12,463,463,22,22,0,1,0
24,465,465,14,14,0,1,0
42,466,466,100,59,41,2,1
15,478,478,45,18,27,4,3
3,480,480,25,3,22,4,3
10,499,499,3,3,0,1,0

26,114,114,4,4,0,1,0
19,126,126,6,1,5,2,1
9,140,140,18,6,12,4,3
14,149,149,17,17,0,1,0
24,150,150,7,7,0,1,0
31,171,171,23,23,0,1,0
5,192,192,12,12,0,1,0
27,207,207,21,21,0,1,0
3,210,210,2,2,0,1,0
17,221,221,49,29,20,2,1
20,246,246,150,119,31,2,1
16,248,248,22,22,0,1,0
1,264,264,72,33,39,4,3
10,269,269,23,23,0,1,0
12,274,274,129,96,33,2,1
21,281,281,12,12,0,1,0
0,281,281,1,1,0,1,0
25,281,281,2,2,0,1,0
32,297,297,6,6,0,1,0
7,310,310,61,25,36,3,2
22,311,311,29,29,0,1,0
4,323,323,17,2,15,4,3
15,352,352,2,2,0,1,0
8,369,369,9,9,0,1,0
23,375,375,43,43,0,1,0
11,400,400,96,60,36,4,3
28,415,415,45,45,0,1,0
13,425,425,46,13,33,4,3
6,437,437,7,1,6,3,2
29,449,449,17,17,0,1,0
2,461,461,9,9,0,1,0
30,489,489,56,28,28,2,1
18,492,492,5,2,3,2,1

33,112,112,36,25,11,2,1
10,123,123,11,7,4,2,1
8,135,135,18,6,12,3,2
6,151,151,1,1,0,1,0
14,160,160,1,1,0,1,0
11,164,164,8,1,7,2,1
35,169,169,40,14,26,3,2
13,174,174,63,63,0,1,0
24,175,175,8,8,0,1,0
7,227,227,22,22,0,1,0
34,229,229,32,32,0,1,0
23,234,234,17,17,0,1,0
5,265,265,7,3,4,2,1
25,270,270,20,16,4,2,1
0,296,296,9,3,6,3,2
15,338,338,24,24,0,1,0
22,348,348,15,15,0,1,0
1,352,352,6,6,0,1,0
28,382,382,157,141,16,3,2
20,386,386,2,2,0,1,0
26,387,387,41,41,0,1,0
16,391,391,118,95,23,2,1
2,392,392,83,83,0,1,0
12,399,399,44,17,27,2,1
4,407,407,7,7,0,1,0
29,408,408,2,2,0,1,0
19,412,412,24,24,0,1,0
37,427,427,8,8,0,1,0
27,436,436,20,11,9,4,3
17,443,443,3,3,0,1,0
30,455,455,14,2,12,4,3
9,455,455,27,27,0,1,0
32,461,461,85,73,12,2,1
21,465,465,26,14,12,4,3
18,492,492,44,44,0,1,0
36,493,493,4,1,3,2,1
31,495,495,15,15,0,1,0
3,498,498,29,8,21,4,3

9,106,106,9,3,6,3,2
39,123,123,12,12,0,1,0
2,127,127,6,1,5,2,1
23,135,135,1,1,0,1,0
16,135,135,39,18,21,2,1
3,148,148,5,5,0,1,0
45,151,151,26,3,23,2,1
33,169,169,20,10,10,3,2
25,172,172,4,4,0,1,0
13,172,172,4,4,0,1,0
10,175,175,1,1,0,1,0
41,182,182,5,5,0,1,0
26,183,183,6,1,5,2,1
24,184,184,5,5,0,1,0
21,187,187,12,9,3,2,1
12,206,206,26,26,0,1,0
44,212,212,9,5,4,2,1
37,231,231,1,1,0,1,0
30,237,237,72,14,58,3,2
6,243,243,20,20,0,1,0
29,248,248,33,7,26,2,1
11,248,248,36,3,33,2,1
31,249,249,46,36,10,2,1
42,285,285,20,20,0,1,0
14,292,292,10,4,6,3,2
27,301,301,6,3,3,2,1
19,313,313,2,2,0,1,0
46,316,316,7,7,0,1,0
17,317,317,2,2,0,1,0
15,320,320,4,4,0,1,0
20,325,325,17,3,14,3,2
32,326,326,4,4,0,1,0
34,331,331,8,8,0,1,0
40,335,335,15,15,0,1,0
38,369,369,45,45,0,1,0
8,369,369,78,72,6,3,2
4,385,385,26,3,23,2,1
0,397,397,5,5,0,1,0
18,399,399,16,16,0,1,0
22,415,415,72,72,0,1,0
5,425,425,3,3,0,1,0
43,448,448,33,18,15,2,1
36,469,469,129,117,12,3,2
1,471,471,13,7,6,2,1
7,483,483,37,33,4,2,1
35,496,496,54,54,0,1,0
28,500,500,30,18,12,3,2

35,109,109,2,2,0,1,0
0,112,112,7,7,0,1,0
6,114,114,14,14,0,1,0
3,116,116,24,24,0,1,0
18,132,132,9,9,0,1,0
37,175,175,44,5,39,2,1
9,192,192,6,6,0,1,0
11,194,194,4,4,0,1,0
13,215,215,11,5,6,2,1
33,234,234,15,15,0,1,0
24,239,239,24,2,22,2,1
36,241,241,29,15,14,3,2
15,256,256,90,39,51,4,3
8,258,258,1,1,0,1,0
28,268,268,30,3,27,2,1
22,283,283,132,24,108,4,3
7,300,300,17,3,14,3,2
23,312,312,3,3,0,1,0
5,324,324,28,22,6,2,1
16,339,339,1,1,0,1,0
29,339,339,32,8,24,2,1
30,343,343,4,1,3,2,1
14,360,360,45,45,0,1,0
21,361,361,40,6,34,3,2
2,365,365,18,15,3,2,1
34,369,369,28,3,25,2,1
26,389,389,18,18,0,1,0
19,391,391,10,10,0,1,0
10,399,399,44,44,0,1,0
20,409,409,66,49,17,2,1
17,427,427,6,6,0,1,0
12,438,438,31,4,27,4,3
27,443,443,6,6,0,1,0
31,463,463,51,11,40,3,2
32,464,464,24,24,0,1,0
25,477,477,5,5,0,1,0
4,477,477,39,39,0,1,0
1,486,486,126,88,38,3,2

11,109,109,2,2,0,1,0
10,110,110,3,3,0,1,0
34,111,111,3,3,0,1,0
1,115,115,11,1,10,3,2
15,118,118,5,5,0,1,0
12,120,120,12,4,8,3,2
17,144,144,14,14,0,1,0
27,159,159,17,3,14,2,1
30,176,176,46,22,24,4,3
19,194,194,15,15,0,1,0
26,202,202,12,12,0,1,0
16,213,213,19,19,0,1,0
9,216,216,7,7,0,1,0
4,223,223,6,1,5,2,1
22,225,225,9,9,0,1,0
25,238,238,6,6,0,1,0
29,242,242,9,3,6,3,2
21,252,252,43,13,30,2,1
28,267,267,72,72,0,1,0
3,295,295,27,27,0,1,0
2,305,305,25,25,0,1,0
23,322,322,21,21,0,1,0
8,324,324,4,4,0,1,0
18,363,363,42,6,36,3,2
6,382,382,9,9,0,1,0
31,393,393,19,19,0,1,0
33,394,394,81,30,51,3,2
32,410,410,13,4,9,2,1
5,415,415,7,3,4,2,1
14,434,434,133,84,49,2,1
13,452,452,258,243,15,4,3
0,469,469,87,36,51,4,3
24,472,472,45,45,0,1,0
20,490,490,55,17,38,3,2
7,499,499,40,28,12,3,2

26,103,103,20,15,5,2,1
36,103,103,3,3,0,1,0
39,111,111,14,14,0,1,0
33,138,138,8,5,3,2,1
31,143,143,17,17,0,1,0
11,157,157,21,21,0,1,0
5,160,160,4,4,0,1,0
16,164,164,7,1,6,3,2
19,186,186,20,20,0,1,0
7,189,189,17,17,0,1,0
32,191,191,3,3,0,1,0
14,193,193,9,3,6,2,1
37,207,207,42,39,3,2,1
24,229,229,1,1,0,1,0
28,233,233,13,3,10,4,3
17,240,240,20,14,6,3,2
18,246,246,59,59,0,1,0
6,250,250,21,21,0,1,0
15,255,255,20,14,6,3,2
13,260,260,32,32,0,1,0
20,268,268,40,14,26,2,1
9,291,291,4,4,0,1,0
27,310,310,14,6,8,3,2
25,312,312,91,61,30,4,3
30,314,314,14,4,10,2,1
22,334,334,65,31,34,2,1
12,351,351,5,5,0,1,0
21,357,357,29,29,0,1,0
29,359,359,47,14,33,4,3
34,371,371,22,22,0,1,0
23,371,371,21,13,8,2,1
10,383,383,12,6,6,2,1
1,388,388,17,5,12,3,2
3,393,393,79,79,0,1,0
4,429,429,49,11,38,2,1
8,436,436,10,10,0,1,0
35,440,440,70,2,68,3,2
0,458,458,23,23,0,1,0
2,460,460,11,2,9,2,1
38,469,469,25,25,0,1,0

23,133,133,6,3,3,2,1
6,137,137,32,2,30,2,1
0,145,145,3,3,0,1,0
29,150,150,9,9,0,1,0
22,155,155,55,4,51,4,3
36,168,168,2,2,0,1,0
34,168,168,12,2,10,3,2
35,171,171,17,5,12,2,1
2,177,177,19,15,4,2,1
16,181,181,5,5,0,1,0
7,194,194,13,13,0,1,0
19,202,202,22,22,0,1,0
20,203,203,17,5,12,4,3
32,215,215,11,11,0,1,0
37,225,225,2,2,0,1,0
1,229,229,1,1,0,1,0
3,278,278,20,20,0,1,0
24,290,290,2,2,0,1,0
18,291,291,22,17,5,2,1
26,294,294,64,64,0,1,0
10,331,331,54,4,50,3,2
5,332,332,42,42,0,1,0
25,338,338,116,94,22,2,1
12,346,346,11,7,4,2,1
14,357,357,108,6,102,4,3
17,372,372,10,10,0,1,0
9,386,386,23,13,10,3,2
27,392,392,14,14,0,1,0
15,413,413,10,1,9,2,1
11,414,414,11,11,0,1,0
13,417,417,8,8,0,1,0
21,422,422,11,11,0,1,0
33,424,424,65,47,18,3,2
30,429,429,24,24,0,1,0
28,431,431,5,5,0,1,0
31,468,468,92,92,0,1,0
8,484,484,52,32,20,4,3
4,489,489,97,97,0,1,0

16,116,116,2,2,0,1,0
32,128,128,2,2,0,1,0
0,150,150,31,3,28,3,2
33,153,153,33,33,0,1,0
27,155,155,18,6,12,4,3
34,160,160,16,16,0,1,0
2,164,164,5,5,0,1,0
28,170,170,4,4,0,1,0
7,188,188,18,18,0,1,0
6,202,202,9,6,3,2,1
31,207,207,9,9,0,1,0
20,209,209,16,1,15,2,1
22,211,211,11,11,0,1,0
18,215,215,2,2,0,1,0
10,223,223,9,9,0,1,0
1,232,232,34,2,32,2,1
26,244,244,82,65,17,2,1
25,249,249,87,70,17,3,2
29,254,254,56,56,0,1,0
15,254,254,1,1,0,1,0
11,267,267,34,34,0,1,0
30,288,288,23,23,0,1,0
8,321,321,115,25,90,4,3
9,331,331,11,11,0,1,0
17,339,339,3,3,0,1,0
12,354,354,40,20,20,2,1
4,365,365,63,53,10,2,1
24,371,371,44,44,0,1,0
14,381,381,78,26,52,4,3
21,387,387,3,3,0,1,0
3,400,400,26,23,3,2,1
19,433,433,29,7,22,2,1
5,438,438,18,12,6,3,2
23,446,446,3,3,0,1,0
13,449,449,46,5,41,4,3

11,108,108,7,7,0,1,0
3,111,111,26,26,0,1,0
16,125,125,2,2,0,1,0
8,127,127,14,14,0,1,0
17,128,128,51,45,6,2,1
4,132,132,3,3,0,1,0
7,139,139,7,1,6,2,1
27,146,146,8,8,0,1,0
13,148,148,28,3,25,2,1
26,172,172,7,7,0,1,0
6,173,173,8,8,0,1,0
20,180,180,27,3,24,4,3
2,189,189,5,2,3,2,1
12,193,193,26,26,0,1,0
23,262,262,24,4,20,2,1
25,270,270,18,14,4,2,1
0,303,303,122,87,35,4,3
9,319,319,3,3,0,1,0
1,362,362,266,230,36,3,2
22,372,372,4,4,0,1,0
24,374,374,48,18,30,2,1
15,377,377,29,21,8,2,1
14,380,380,30,30,0,1,0
18,422,422,53,13,40,3,2
10,440,440,9,9,0,1,0
5,450,450,74,74,0,1,0
19,488,488,44,35,9,4,3
21,498,498,57,57,0,1,0

26,100,100,6,6,0,1,0
25,124,124,13,4,9,4,3
10,134,134,1,1,0,1,0
11,159,159,1,1,0,1,0
33,160,160,6,6,0,1,0
28,163,163,54,24,30,4,3
17,173,173,13,13,0,1,0
15,180,180,11,11,0,1,0
5,182,182,3,3,0,1,0
35,194,194,81,3,78,4,3
8,219,219,22,22,0,1,0
3,220,220,41,29,12,4,3
21,225,225,13,13,0,1,0
9,236,236,1,1,0,1,0
30,241,241,42,42,0,1,0
1,247,247,98,98,0,1,0
24,248,248,7,7,0,1,0
6,265,265,15,15,0,1,0
12,269,269,2,2,0,1,0
4,287,287,68,2,66,4,3
34,301,301,18,18,0,1,0
23,337,337,6,2,4,2,1
13,378,378,120,67,53,3,2
29,392,392,96,20,76,3,2
32,397,397,24,11,13,2,1
2,412,412,16,7,9,2,1
0,443,443,65,65,0,1,0
16,446,446,7,7,0,1,0
7,446,446,41,41,0,1,0
22,455,455,27,1,26,3,2
19,457,457,29,29,0,1,0
20,478,478,6,6,0,1,0
18,478,478,18,1,17,2,1
27,479,479,18,2,16,3,2
14,490,490,17,11,6,3,2
31,494,494,17,10,7,2,1

24,126,126,16,1,15,2,1
37,162,162,29,14,15,2,1
22,173,173,3,3,0,1,0
15,175,175,7,1,6,3,2
20,193,193,4,4,0,1,0
5,204,204,3,3,0,1,0
3,214,214,46,24,22,2,1
0,215,215,47,47,0,1,0
28,225,225,28,28,0,1,0
32,245,245,25,11,14,2,1
12,247,247,12,1,11,2,1
21,267,267,7,7,0,1,0
1,272,272,8,8,0,1,0
26,276,276,21,21,0,1,0
14,291,291,199,199,0,1,0
23,292,292,75,75,0,1,0
31,297,297,27,27,0,1,0
25,297,297,18,18,0,1,0
6,297,297,1,1,0,1,0
4,302,302,2,2,0,1,0
7,322,322,4,4,0,1,0
17,322,322,3,3,0,1,0
38,329,329,14,4,10,3,2
36,332,332,26,26,0,1,0
11,341,341,59,21,38,2,1
16,346,346,26,26,0,1,0
33,347,347,10,4,6,2,1
9,348,348,7,7,0,1,0
29,368,368,6,1,5,2,1
10,378,378,4,1,3,2,1
34,405,405,20,20,0,1,0
8,419,419,48,28,20,3,2
30,421,421,17,17,0,1,0
19,422,422,4,4,0,1,0
27,425,425,73,25,48,3,2
2,450,450,18,15,3,2,1
18,458,458,14,5,9,2,1
35,475,475,165,122,43,2,1
13,493,493,14,14,0,1,0

26,104,104,6,3,3,2,1
40,110,110,13,13,0,1,0
5,133,133,6,1,5,2,1
9,146,146,3,3,0,1,0
23,162,162,13,3,10,3,2
20,162,162,11,3,8,3,2
28,191,191,36,36,0,1,0
10,204,204,1,1,0,1,0
24,232,232,52,37,15,2,1
39,235,235,5,1,4,2,1
4,240,240,35,14,21,4,3
0,240,240,26,26,0,1,0
8,244,244,30,3,27,3,2
30,250,250,43,16,27,4,3
11,252,252,37,37,0,1,0
36,263,263,49,1,48,2,1
35,273,273,24,24,0,1,0
14,277,277,9,1,8,3,2
16,286,286,9,4,5,2,1
12,290,290,1,1,0,1,0
3,291,291,1,1,0,1,0
6,295,295,3,3,0,1,0
18,299,299,14,4,10,3,2
17,304,304,63,50,13,2,1
32,309,309,20,20,0,1,0
1,317,317,10,4,6,3,2
25,320,320,8,4,4,2,1
15,321,321,17,5,12,3,2
34,322,322,9,9,0,1,0
41,329,329,51,51,0,1,0
22,369,369,81,4,77,3,2
37,373,373,22,5,17,2,1
38,376,376,16,16,0,1,0
27,395,395,28,28,0,1,0
31,418,418,59,17,42,4,3
21,434,434,37,37,0,1,0
33,447,447,68,68,0,1,0
13,447,447,58,53,5,2,1
29,476,476,19,5,14,2,1
7,476,476,18,6,12,4,3
19,479,479,59,59,0,1,0
2,500,500,23,12,11,4,3

9,108,108,24,24,0,1,0
15,120,120,9,1,8,2,1
2,136,136,2,2,0,1,0
22,163,163,18,15,3,2,1
14,208,208,71,59,12,2,1
0,233,233,87,87,0,1,0
23,245,245,6,6,0,1,0
24,280,280,9,3,6,3,2
12,301,301,66,48,18,3,2
17,304,304,24,21,3,2,1
13,309,309,18,6,12,3,2
3,316,316,103,73,30,2,1
20,336,336,11,11,0,1,0
5,340,340,207,207,0,1,0
6,353,353,86,77,9,4,3
7,392,392,8,8,0,1,0
21,397,397,19,19,0,1,0
16,412,412,154,92,62,3,2
10,421,421,9,9,0,1,0
8,424,424,1,1,0,1,0
18,435,435,46,21,25,2,1
4,464,464,80,80,0,1,0
25,472,472,27,11,16,3,2
11,491,491,7,7,0,1,0
1,491,491,21,21,0,1,0
19,494,494,12,12,0,1,0

5,115,115,3,3,0,1,0
1,123,123,6,6,0,1,0
32,129,129,18,8,10,2,1
20,134,134,10,1,9,2,1
19,138,138,11,2,9,4,3
10,144,144,1,1,0,1,0
18,148,148,29,29,0,1,0
16,160,160,35,16,19,2,1
30,161,161,32,22,10,3,2
17,182,182,10,10,0,1,0
29,188,188,16,16,0,1,0
27,196,196,3,3,0,1,0
8,220,220,1,1,0,1,0
4,262,262,23,1,22,4,3
3,265,265,61,52,9,2,1
22,288,288,35,26,9,4,3
26,291,291,4,4,0,1,0
13,343,343,21,6,15,4,3
0,343,343,163,127,36,4,3
14,352,352,30,24,6,2,1
21,353,353,58,13,45,4,3
15,361,361,71,52,19,3,2
33,382,382,44,44,0,1,0
11,388,388,4,4,0,1,0
6,392,392,113,47,66,3,2
2,395,395,80,80,0,1,0
31,411,411,79,79,0,1,0
23,437,437,5,5,0,1,0
9,446,446,22,10,12,2,1
25,462,462,33,19,14,2,1
28,463,463,1,1,0,1,0
24,488,488,39,9,30,2,1
12,489,489,8,3,5,2,1
7,498,498,6,6,0,1,0

14,102,102,11,11,0,1,0
16,123,123,1,1,0,1,0
31,149,149,16,16,0,1,0
34,153,153,18,18,0,1,0
21,156,156,25,16,9,2,1
28,166,166,10,10,0,1,0
6,197,197,18,15,3,2,1
0,209,209,21,4,17,3,2
36,211,211,7,7,0,1,0
1,211,211,13,13,0,1,0
19,219,219,83,5,78,3,2
33,221,221,9,9,0,1,0
2,231,231,99,48,51,4,3
3,238,238,12,5,7,2,1
8,239,239,16,8,8,3,2
23,254,254,8,2,6,3,2
18,261,261,25,5,20,3,2
25,286,286,5,5,0,1,0
35,302,302,7,7,0,1,0
22,340,340,7,7,0,1,0
32,352,352,32,23,9,2,1
20,382,382,120,42,78,3,2
10,386,386,1,1,0,1,0
30,390,390,42,42,0,1,0
11,391,391,2,2,0,1,0
24,404,404,4,1,3,2,1
7,404,404,65,65,0,1,0
12,406,406,1,1,0,1,0
5,409,409,113,41,72,4,3
9,420,420,16,5,11,2,1
29,428,428,43,43,0,1,0
17,450,450,4,4,0,1,0
15,454,454,78,78,0,1,0
13,464,464,40,40,0,1,0
26,486,486,67,67,0,1,0
27,488,488,41,41,0,1,0
4,494,494,19,11,8,2,1

20,101,101,1,1,0,1,0
14,112,112,3,3,0,1,0
34,122,122,6,3,3,2,1
5,133,133,1,1,0,1,0
18,134,134,17,12,5,2,1
26,151,151,9,9,0,1,0
35,161,161,6,6,0,1,0
21,176,176,4,1,3,2,1
19,181,181,1,1,0,1,0
3,205,205,22,22,0,1,0
13,211,211,22,9,13,2,1
7,212,212,1,1,0,1,0
4,226,226,6,6,0,1,0
12,240,240,16,16,0,1,0
36,242,242,2,2,0,1,0
32,247,247,49,49,0,1,0
17,249,249,18,18,0,1,0
40,269,269,47,20,27,2,1
10,270,270,8,8,0,1,0
9,271,271,48,48,0,1,0
37,289,289,50,42,8,2,1
38,307,307,10,10,0,1,0
25,307,307,33,33,0,1,0
30,311,311,13,5,8,2,1
15,318,318,20,20,0,1,0
41,336,336,52,52,0,1,0
28,337,337,112,21,91,3,2
29,347,347,77,37,40,3,2
1,357,357,37,4,33,2,1
27,371,371,45,45,0,1,0
33,426,426,10,10,0,1,0
6,430,430,15,15,0,1,0
16,433,433,34,3,31,2,1
22,438,438,10,1,9,2,1
0,439,439,1,1,0,1,0
24,450,450,20,7,13,2,1
31,473,473,13,13,0,1,0
39,479,479,13,13,0,1,0
11,480,480,90,10,80,3,2
2,491,491,4,4,0,1,0
23,494,494,115,61,54,4,3
8,495,495,138,12,126,4,3

19,102,102,24,17,7,2,1
5,102,102,2,2,0,1,0
1,103,103,15,6,9,2,1
20,141,141,14,1,13,2,1
29,160,160,3,3,0,1,0
0,173,173,13,13,0,1,0
3,184,184,6,6,0,1,0
38,222,222,27,27,0,1,0
23,222,222,3,3,0,1,0
14,226,226,55,55,0,1,0
6,231,231,9,9,0,1,0
24,248,248,5,5,0,1,0
11,250,250,76,25,51,4,3
22,295,295,19,10,9,4,3
35,299,299,23,6,17,2,1
21,302,302,56,29,27,4,3
32,335,335,3,3,0,1,0
12,338,338,7,7,0,1,0
27,339,339,72,72,0,1,0
8,353,353,34,10,24,2,1
2,354,354,45,7,38,3,2
28,360,360,82,18,64,4,3
17,363,363,16,16,0,1,0
13,363,363,3,3,0,1,0
4,369,369,1,1,0,1,0
18,378,378,22,22,0,1,0
16,379,379,24,24,0,1,0
7,413,413,6,6,0,1,0
30,414,414,48,29,19,2,1
34,418,418,12,4,8,2,1
31,420,420,18,1,17,2,1
37,456,456,85,85,0,1,0
9,464,464,55,55,0,1,0
33,472,472,74,74,0,1,0
10,474,474,22,19,3,2,1
15,480,480,5,5,0,1,0
36,489,489,48,48,0,1,0
25,490,490,26,16,10,3,2
26,500,500,96,96,0,1,0

0,109,109,5,5,0,1,0
24,115,115,3,3,0,1,0
10,131,131,27,27,0,1,0
26,133,133,3,3,0,1,0
6,159,159,1,1,0,1,0
20,182,182,25,25,0,1,0
14,225,225,11,5,6,3,2
4,233,233,74,41,33,4,3
23,246,246,82,56,26,3,2
5,247,247,25,25,0,1,0
22,262,262,28,28,0,1,0
9,272,272,93,3,90,3,2
1,292,292,22,7,15,4,3
31,300,300,6,6,0,1,0
11,306,306,10,7,3,2,1
25,313,313,11,6,5,2,1
3,316,316,1,1,0,1,0
30,318,318,19,19,0,1,0
7,341,341,32,22,10,3,2
8,346,346,24,24,0,1,0
21,360,360,64,64,0,1,0
13,385,385,162,119,43,2,1
12,390,390,2,2,0,1,0
2,405,405,13,4,9,4,3
15,412,412,42,42,0,1,0
32,421,421,61,61,0,1,0
18,421,421,19,15,4,2,1
29,441,441,59,59,0,1,0
17,443,443,51,40,11,2,1
19,446,446,78,8,70,3,2
28,453,453,10,10,0,1,0
16,453,453,67,67,0,1,0
27,476,476,10,10,0,1,0

19,117,117,13,5,8,3,2
21,119,119,8,8,0,1,0
2,124,124,4,4,0,1,0
0,130,130,1,1,0,1,0
17,133,133,10,4,6,2,1
30,137,137,14,14,0,1,0
10,142,142,30,30,0,1,0
22,159,159,23,23,0,1,0
15,163,163,47,15,32,2,1
4,178,178,67,53,14,3,2
13,194,194,16,16,0,1,0
11,200,200,10,7,3,2,1
28,208,208,39,12,27,2,1
16,231,231,1,1,0,1,0
8,232,232,41,17,24,4,3
32,236,236,65,65,0,1,0
24,256,256,26,18,8,2,1
3,263,263,72,23,49,4,3
18,265,265,21,4,17,2,1
1,298,298,24,6,18,2,1
26,304,304,32,6,26,3,2
31,336,336,17,17,0,1,0
25,344,344,12,12,0,1,0
6,355,355,30,30,0,1,0
23,363,363,48,11,37,2,1
29,369,369,8,8,0,1,0
12,390,390,71,71,0,1,0
20,404,404,18,18,0,1,0
5,409,409,36,16,20,3,2
14,447,447,42,42,0,1,0
27,463,463,10,10,0,1,0
7,470,470,3,3,0,1,0
9,487,487,27,12,15,4,3

18,107,107,2,2,0,1,0
12,109,109,1,1,0,1,0
17,133,133,25,25,0,1,0
3,158,158,49,35,14,2,1
27,183,183,41,33,8,2,1
2,194,194,28,28,0,1,0
22,194,194,19,11,8,2,1
15,209,209,3,3,0,1,0
11,216,216,25,25,0,1,0
1,219,219,45,21,24,4,3
6,222,222,17,9,8,2,1
23,232,232,17,17,0,1,0
14,236,236,4,4,0,1,0
21,242,242,2,2,0,1,0
25,249,249,32,10,22,3,2
0,268,268,19,19,0,1,0
5,313,313,1,1,0,1,0
20,314,314,77,30,47,2,1
4,324,324,144,16,128,4,3
16,364,364,44,44,0,1,0
19,397,397,77,47,30,2,1
7,418,418,81,46,35,3,2
26,424,424,6,6,0,1,0
10,443,443,45,45,0,1,0
13,454,454,115,15,100,3,2
24,484,484,8,8,0,1,0
9,486,486,134,50,84,4,3
8,500,500,38,1,37,2,1

29,111,111,1,1,0,1,0
0,113,113,4,4,0,1,0
23,114,114,13,13,0,1,0
17,119,119,50,9,41,2,1
37,153,153,23,23,0,1,0
35,178,178,13,13,0,1,0
27,199,199,23,5,18,4,3
9,206,206,38,38,0,1,0
21,210,210,10,10,0,1,0
24,219,219,7,3,4,2,1
34,221,221,65,27,38,2,1
2,226,226,6,6,0,1,0
16,229,229,22,17,5,2,1
30,234,234,19,19,0,1,0
25,236,236,11,11,0,1,0
33,245,245,53,39,14,3,2
26,249,249,7,4,3,2,1
32,254,254,45,45,0,1,0
5,260,260,12,12,0,1,0
13,268,268,9,9,0,1,0
38,280,280,85,85,0,1,0
15,308,308,35,6,29,2,1
20,320,320,28,12,16,2,1
22,349,349,7,1,6,3,2
12,356,356,22,22,0,1,0
19,361,361,31,14,17,2,1
36,406,406,17,3,14,2,1
3,408,408,18,6,12,4,3
6,411,411,1,1,0,1,0
31,417,417,21,4,17,2,1
28,437,437,19,9,10,3,2
7,461,461,9,9,0,1,0
1,464,464,60,46,14,3,2
4,465,465,22,13,9,2,1
8,468,468,8,8,0,1,0
18,475,475,118,80,38,3,2
14,489,489,9,9,0,1,0
10,494,494,21,1,20,2,1
11,497,497,21,9,12,2,1

8,102,102,7,7,0,1,0
11,105,105,1,1,0,1,0
7,154,154,1,1,0,1,0
27,160,160,4,4,0,1,0
12,172,172,40,1,39,4,3
10,199,199,1,1,0,1,0
9,199,199,14,6,8,3,2
17,206,206,3,3,0,1,0
14,206,206,62,52,10,3,2
35,215,215,2,2,0,1,0
40,216,216,78,78,0,1,0
34,222,222,1,1,0,1,0
36,238,238,39,6,33,2,1
0,251,251,17,17,0,1,0
1,262,262,63,63,0,1,0
16,272,272,1,1,0,1,0
24,284,284,35,35,0,1,0
6,285,285,38,38,0,1,0
3,289,289,1,1,0,1,0
19,311,311,16,16,0,1,0
37,327,327,32,5,27,4,3
33,335,335,29,29,0,1,0
13,336,336,32,32,0,1,0
32,346,346,86,86,0,1,0
39,348,348,141,98,43,3,2
5,348,348,13,13,0,1,0
18,356,356,45,5,40,3,2
30,359,359,3,3,0,1,0
29,359,359,10,10,0,1,0
15,362,362,22,4,18,4,3
23,367,367,3,3,0,1,0
31,409,409,39,7,32,3,2
22,409,409,43,43,0,1,0
28,416,416,14,2,12,4,3
21,418,418,4,4,0,1,0
38,433,433,14,14,0,1,0
4,443,443,20,8,12,3,2
26,449,449,38,16,22,2,1
25,458,458,4,4,0,1,0
20,473,473,1,1,0,1,0
2,490,490,54,10,44,2,1

15,102,102,9,9,0,1,0
36,107,107,4,4,0,1,0
33,118,118,12,8,4,2,1
39,132,132,22,22,0,1,0
10,134,134,5,5,0,1,0
30,138,138,3,3,0,1,0
1,156,156,1,1,0,1,0
19,159,159,11,3,8,2,1
40,163,163,25,10,15,4,3
22,164,164,1,1,0,1,0
23,208,208,26,19,7,2,1
4,209,209,21,3,18,3,2
24,214,214,23,23,0,1,0
5,220,220,9,2,7,2,1
29,243,243,18,10,8,3,2
12,247,247,7,7,0,1,0
14,257,257,1,1,0,1,0
18,264,264,5,2,3,2,1
3,265,265,4,4,0,1,0
21,287,287,1,1,0,1,0
7,310,310,46,34,12,4,3
13,311,311,87,39,48,4,3
9,313,313,37,37,0,1,0
16,318,318,5,2,3,2,1
0,323,323,15,6,9,2,1
17,329,329,54,38,16,4,3
37,334,334,28,28,0,1,0
38,342,342,87,81,6,3,2
35,343,343,6,6,0,1,0
28,344,344,8,8,0,1,0
25,349,349,8,8,0,1,0
26,355,355,28,10,18,3,2
27,361,361,15,15,0,1,0
32,361,361,27,27,0,1,0
31,383,383,60,43,17,2,1
2,420,420,28,28,0,1,0
11,437,437,4,1,3,2,1
20,449,449,108,62,46,2,1
41,452,452,140,71,69,4,3
6,464,464,65,39,26,3,2
34,485,485,55,1,54,3,2
8,485,485,14,14,0,1,0

7,114,114,21,21,0,1,0
17,121,121,14,14,0,1,0
20,138,138,16,10,6,3,2
13,143,143,3,3,0,1,0
9,159,159,11,11,0,1,0
2,166,166,34,27,7,2,1
25,180,180,8,5,3,2,1
3,204,204,15,1,14,2,1
11,216,216,35,35,0,1,0
22,216,216,16,3,13,2,1
31,217,217,22,22,0,1,0
14,225,225,1,1,0,1,0
15,226,226,9,9,0,1,0
0,238,238,37,37,0,1,0
19,239,239,50,7,43,2,1
28,244,244,18,18,0,1,0
4,259,259,2,2,0,1,0
29,283,283,56,56,0,1,0
12,298,298,86,50,36,2,1
24,304,304,52,34,18,4,3
30,308,308,17,3,14,3,2
27,321,321,20,15,5,2,1
1,331,331,42,10,32,3,2
16,389,389,43,17,26,4,3
21,392,392,13,13,0,1,0
26,402,402,6,2,4,2,1
10,406,406,21,21,0,1,0
8,416,416,128,60,68,3,2
5,423,423,42,42,0,1,0
23,428,428,171,57,114,4,3
18,471,471,3,3,0,1,0
6,471,471,24,24,0,1,0

24,105,105,6,6,0,1,0
32,109,109,4,4,0,1,0
12,116,116,1,1,0,1,0
30,119,119,41,41,0,1,0
33,127,127,22,22,0,1,0
17,134,134,1,1,0,1,0
18,162,162,18,5,13,2,1
35,166,166,4,4,0,1,0
28,175,175,33,18,15,4,3
9,178,178,1,1,0,1,0
15,209,209,65,65,0,1,0
21,218,218,26,26,0,1,0
22,222,222,53,35,18,4,3
2,247,247,4,4,0,1,0
20,254,254,5,5,0,1,0
37,261,261,14,4,10,3,2
3,290,290,7,7,0,1,0
26,302,302,23,13,10,3,2
10,306,306,10,6,4,2,1
16,316,316,34,34,0,1,0
13,328,328,27,27,0,1,0
14,331,331,9,9,0,1,0
25,355,355,68,40,28,3,2
7,356,356,38,35,3,2,1
1,356,356,11,11,0,1,0
6,377,377,40,40,0,1,0
8,391,391,1,1,0,1,0
39,397,397,20,20,0,1,0
38,406,406,53,53,0,1,0
4,415,415,176,176,0,1,0
11,429,429,25,25,0,1,0
5,441,441,51,48,3,2,1
19,457,457,29,4,25,4,3
23,461,461,54,9,45,3,2
34,463,463,1,1,0,1,0
36,470,470,31,31,0,1,0
27,475,475,8,4,4,2,1
0,482,482,11,11,0,1,0
31,487,487,29,5,24,2,1
29,492,492,14,14,0,1,0

28,106,106,3,3,0,1,0
39,116,116,1,1,0,1,0
31,122,122,44,44,0,1,0
1,124,124,8,4,4,2,1
23,156,156,12,12,0,1,0
16,163,163,8,8,0,1,0
10,166,166,35,23,12,4,3
21,175,175,7,7,0,1,0
18,189,189,19,12,7,2,1
41,191,191,31,31,0,1,0
35,231,231,54,54,0,1,0
25,244,244,6,6,0,1,0
29,251,251,6,2,4,2,1
19,253,253,18,18,0,1,0
20,306,306,7,7,0,1,0
7,318,318,2,2,0,1,0
4,319,319,67,23,44,2,1
15,323,323,3,3,0,1,0
38,324,324,3,3,0,1,0
6,327,327,25,10,15,2,1
32,328,328,10,10,0,1,0
12,328,328,51,51,0,1,0
27,330,330,52,52,0,1,0
40,339,339,21,21,0,1,0
13,360,360,28,28,0,1,0
5,378,378,39,18,21,4,3
9,379,379,13,4,9,2,1
26,387,387,42,42,0,1,0
3,397,397,17,17,0,1,0
33,407,407,15,1,14,2,1
8,414,414,79,79,0,1,0
36,421,421,14,14,0,1,0
11,441,441,12,12,0,1,0
22,449,449,43,1,42,2,1
24,452,452,45,6,39,4,3
30,457,457,13,7,6,3,2
17,459,459,3,3,0,1,0
14,459,459,1,1,0,1,0
0,461,461,44,44,0,1,0
37,476,476,108,108,0,1,0
34,477,477,104,104,0,1,0
2,491,491,18,13,5,2,1

18,107,107,8,8,0,1,0
8,112,112,8,8,0,1,0
21,126,126,10,7,3,2,1
0,133,133,50,30,20,3,2
2,148,148,31,31,0,1,0
20,160,160,11,11,0,1,0
29,161,161,19,19,0,1,0
22,190,190,10,10,0,1,0
13,198,198,10,10,0,1,0
30,232,232,38,16,22,3,2
4,234,234,79,79,0,1,0
3,237,237,10,3,7,2,1
10,243,243,13,10,3,2,1
26,281,281,21,5,16,3,2
16,291,291,17,2,15,4,3
19,299,299,25,25,0,1,0
14,315,315,45,7,38,2,1
9,357,357,94,94,0,1,0
31,366,366,22,22,0,1,0
11,397,397,43,43,0,1,0
15,412,412,2,2,0,1,0
25,420,420,92,92,0,1,0
27,450,450,42,14,28,3,2
7,452,452,2,2,0,1,0
5,455,455,32,15,17,2,1
23,457,457,87,47,40,3,2
12,464,464,46,6,40,3,2
6,467,467,1,1,0,1,0
24,469,469,39,39,0,1,0
17,473,473,58,16,42,3,2
28,480,480,74,47,27,4,3
1,484,484,55,35,20,2,1

18,118,118,9,9,0,1,0
1,125,125,1,1,0,1,0
24,149,149,12,7,5,2,1
23,153,153,9,9,0,1,0
0,191,191,55,55,0,1,0
31,200,200,29,5,24,3,2
12,230,230,24,24,0,1,0
14,232,232,8,8,0,1,0
29,232,232,34,7,27,4,3
2,234,234,63,15,48,3,2
10,235,235,30,22,8,2,1
17,239,239,37,8,29,2,1
32,241,241,6,6,0,1,0
26,270,270,45,45,0,1,0
4,278,278,41,18,23,2,1
8,305,305,8,8,0,1,0
13,310,310,62,43,19,2,1
28,327,327,5,5,0,1,0
30,335,335,39,21,18,4,3
16,346,346,32,32,0,1,0
20,347,347,9,4,5,2,1
27,364,364,20,20,0,1,0
3,420,420,151,119,32,3,2
15,422,422,84,54,30,4,3
19,435,435,42,42,0,1,0
6,437,437,36,27,9,4,3
21,444,444,43,37,6,3,2
25,445,445,18,3,15,4,3
9,448,448,1,1,0,1,0
11,458,458,3,3,0,1,0
7,458,458,11,11,0,1,0
5,471,471,58,21,37,2,1
22,480,480,114,114,0,1,0

6,121,121,57,42,15,4,3
1,132,132,6,2,4,2,1
28,141,141,12,6,6,3,2
16,153,153,27,27,0,1,0
9,168,168,7,7,0,1,0
23,181,181,14,2,12,2,1
24,197,197,4,4,0,1,0
20,210,210,3,3,0,1,0
22,236,236,11,2,9,4,3
3,245,245,125,125,0,1,0
26,248,248,94,94,0,1,0
5,253,253,72,63,9,4,3
4,258,258,29,29,0,1,0
21,260,260,18,8,10,2,1
27,298,298,5,5,0,1,0
7,315,315,22,4,18,3,2
13,317,317,86,86,0,1,0
14,360,360,3,3,0,1,0
17,377,377,47,23,24,2,1
0,377,377,10,10,0,1,0
18,404,404,92,50,42,4,3
8,423,423,46,3,43,2,1
19,429,429,24,24,0,1,0
11,431,431,30,30,0,1,0
25,464,464,7,7,0,1,0
12,469,469,79,79,0,1,0
10,476,476,2,2,0,1,0
15,491,491,5,1,4,2,1
2,493,493,62,26,36,3,2

16,110,110,9,9,0,1,0
4,115,115,20,16,4,2,1
14,121,121,20,8,12,2,1
17,142,142,2,2,0,1,0
21,158,158,9,2,7,2,1
18,182,182,6,6,0,1,0
32,187,187,19,16,3,2,1
29,200,200,20,20,0,1,0
10,201,201,13,5,8,2,1
8,225,225,38,27,11,2,1
2,234,234,9,9,0,1,0
7,253,253,53,22,31,2,1
27,255,255,24,24,0,1,0
31,264,264,22,1,21,2,1
33,277,277,12,12,0,1,0
30,290,290,108,108,0,1,0
34,314,314,5,5,0,1,0
28,318,318,78,50,28,3,2
15,319,319,3,3,0,1,0
12,334,334,88,88,0,1,0
26,339,339,29,29,0,1,0
6,341,341,49,49,0,1,0
24,361,361,24,24,0,1,0
20,366,366,21,2,19,2,1
3,374,374,14,2,12,2,1
23,378,378,14,14,0,1,0
0,402,402,28,16,12,4,3
19,407,407,11,11,0,1,0
35,441,441,51,20,31,2,1
1,449,449,28,28,0,1,0
11,456,456,20,2,18,2,1
13,461,461,63,63,0,1,0
9,463,463,22,7,15,4,3
25,471,471,78,78,0,1,0
22,483,483,62,28,34,2,1
5,492,492,37,1,36,2,1

10,106,106,1,1,0,1,0
7,119,119,1,1,0,1,0
29,127,127,1,1,0,1,0
28,147,147,8,8,0,1,0
16,149,149,1,1,0,1,0
17,153,153,1,1,0,1,0
30,154,154,41,10,31,3,2
32,157,157,23,23,0,1,0
24,164,164,20,13,7,2,1
37,169,169,8,8,0,1,0
6,172,172,19,19,0,1,0
21,176,176,13,13,0,1,0
11,177,177,29,29,0,1,0
8,179,179,17,17,0,1,0
0,188,188,36,26,10,2,1
20,188,188,20,20,0,1,0
35,216,216,6,1,5,2,1
3,218,218,33,33,0,1,0
14,220,220,12,12,0,1,0
4,222,222,8,8,0,1,0
19,223,223,19,19,0,1,0
18,233,233,20,4,16,4,3
5,236,236,30,12,18,4,3
12,261,261,19,7,12,3,2
9,266,266,25,2,23,4,3
33,271,271,7,7,0,1,0
26,281,281,35,35,0,1,0
15,308,308,12,12,0,1,0
2,326,326,51,51,0,1,0
22,360,360,41,41,0,1,0
34,368,368,91,82,9,2,1
13,399,399,79,7,72,3,2
23,404,404,16,2,14,3,2
25,411,411,57,57,0,1,0
27,418,418,41,1,40,3,2
31,433,433,78,4,74,4,3
36,437,437,13,10,3,2,1
1,449,449,50,50,0,1,0

31,119,119,4,4,0,1,0
29,124,124,1,1,0,1,0
24,128,128,11,2,9,4,3
25,135,135,10,1,9,4,3
15,150,150,8,8,0,1,0
17,159,159,43,43,0,1,0
3,197,197,8,8,0,1,0
26,212,212,32,32,0,1,0
20,237,237,8,8,0,1,0
2,250,250,17,7,10,2,1
1,256,256,6,6,0,1,0
18,265,265,4,4,0,1,0
9,272,272,47,24,23,2,1
0,282,282,72,72,0,1,0
4,293,293,78,38,40,3,2
11,309,309,64,41,23,3,2
8,310,310,18,18,0,1,0
7,319,319,79,34,45,4,3
10,320,320,53,16,37,2,1
5,322,322,17,17,0,1,0
30,350,350,32,32,0,1,0
23,351,351,14,8,6,2,1
22,362,362,5,5,0,1,0
28,365,365,38,38,0,1,0
19,368,368,61,13,48,3,2
16,382,382,30,30,0,1,0
27,415,415,160,111,49,3,2
21,417,417,57,28,29,2,1
14,423,423,42,20,22,3,2
13,434,434,24,24,0,1,0
6,446,446,59,59,0,1,0
12,492,492,27,27,0,1,0

26,105,105,2,2,0,1,0
31,108,108,1,1,0,1,0
21,110,110,37,37,0,1,0
16,139,139,1,1,0,1,0
17,159,159,3,3,0,1,0
22,164,164,4,4,0,1,0
10,174,174,21,11,10,2,1
2,181,181,22,6,16,2,1
25,200,200,4,4,0,1,0
0,208,208,42,15,27,4,3
6,213,213,41,11,30,2,1
20,230,230,31,10,21,2,1
15,259,259,15,15,0,1,0
4,275,275,4,4,0,1,0
28,306,306,2,2,0,1,0
7,308,308,6,6,0,1,0
19,310,310,41,41,0,1,0
33,311,311,61,13,48,3,2
18,346,346,61,61,0,1,0
1,361,361,13,13,0,1,0
30,373,373,102,93,9,2,1
23,390,390,1,1,0,1,0
29,392,392,55,55,0,1,0
34,398,398,74,74,0,1,0
12,439,439,21,21,0,1,0
24,441,441,37,17,20,3,2
3,443,443,30,15,15,2,1
11,445,445,189,189,0,1,0
27,451,451,12,12,0,1,0
32,452,452,20,4,16,3,2
14,455,455,40,7,33,2,1
8,460,460,51,51,0,1,0
5,463,463,2,2,0,1,0
9,464,464,11,5,6,3,2
13,489,489,128,19,109,4,3

19,143,143,27,27,0,1,0
29,152,152,22,19,3,2,1
36,157,157,4,4,0,1,0
31,183,183,25,11,14,3,2
18,186,186,32,32,0,1,0
11,195,195,3,3,0,1,0
25,195,195,14,14,0,1,0
20,206,206,53,26,27,2,1
28,206,206,24,3,21,4,3
32,213,213,5,5,0,1,0
22,214,214,25,25,0,1,0
27,214,214,72,20,52,3,2
1,214,214,5,2,3,2,1
35,231,231,45,45,0,1,0
10,232,232,5,1,4,2,1
8,234,234,38,38,0,1,0
39,245,245,4,1,3,2,1
15,246,246,8,8,0,1,0
40,255,255,11,6,5,2,1
26,268,268,28,14,14,3,2
12,270,270,15,15,0,1,0
9,274,274,16,16,0,1,0
7,277,277,1,1,0,1,0
5,292,292,26,26,0,1,0
23,324,324,17,8,9,2,1
16,347,347,1,1,0,1,0
38,355,355,52,8,44,2,1
0,360,360,23,15,8,3,2
24,371,371,26,10,16,2,1
2,385,385,29,29,0,1,0
4,390,390,24,12,12,4,3
33,391,391,18,9,9,4,3
14,407,407,58,10,48,2,1
17,416,416,6,6,0,1,0
21,417,417,22,22,0,1,0
6,440,440,8,2,6,2,1
3,449,449,5,5,0,1,0
30,450,450,89,45,44,4,3
13,450,450,73,73,0,1,0
37,457,457,26,20,6,2,1
34,476,476,30,10,20,2,1

9,111,111,3,3,0,1,0
0,157,157,7,3,4,2,1
28,160,160,8,8,0,1,0
19,168,168,3,3,0,1,0
21,173,173,44,12,32,2,1
5,224,224,5,2,3,2,1
8,245,245,14,2,12,2,1
7,257,257,3,3,0,1,0
25,271,271,22,14,8,2,1
14,272,272,28,28,0,1,0
24,288,288,27,27,0,1,0
29,293,293,5,5,0,1,0
2,304,304,110,48,62,3,2
13,320,320,47,2,45,2,1
32,324,324,93,28,65,4,3
6,326,326,56,56,0,1,0
1,331,331,70,70,0,1,0
4,332,332,20,8,12,2,1
17,333,333,8,8,0,1,0
30,334,334,8,8,0,1,0
12,349,349,1,1,0,1,0
22,364,364,43,43,0,1,0
10,378,378,20,20,0,1,0
16,378,378,44,44,0,1,0
23,379,379,95,56,39,4,3
18,423,423,8,5,3,2,1
15,441,441,17,17,0,1,0
26,447,447,24,8,16,3,2
20,447,447,55,55,0,1,0
27,458,458,20,2,18,4,3
31,462,462,101,56,45,4,3
3,463,463,67,67,0,1,0
11,473,473,182,43,139,4,3

4,103,103,16,2,14,3,2
34,104,104,1,1,0,1,0
23,107,107,7,1,6,3,2
22,134,134,20,20,0,1,0
9,135,135,1,1,0,1,0
2,138,138,24,9,15,4,3
26,138,138,6,6,0,1,0
31,143,143,1,1,0,1,0
15,145,145,1,1,0,1,0
30,148,148,6,6,0,1,0
32,149,149,18,18,0,1,0
36,153,153,6,6,0,1,0
14,164,164,4,4,0,1,0
6,167,167,11,11,0,1,0
27,193,193,6,6,0,1,0
17,195,195,12,12,0,1,0
5,197,197,42,42,0,1,0
3,212,212,4,4,0,1,0
12,249,249,27,27,0,1,0
21,264,264,27,27,0,1,0
1,270,270,31,14,17,3,2
37,290,290,129,107,22,3,2
35,324,324,87,3,84,3,2
11,337,337,2,2,0,1,0
24,343,343,41,3,38,2,1
25,364,364,20,20,0,1,0
20,373,373,8,4,4,2,1
8,387,387,50,35,15,4,3
7,402,402,50,38,12,3,2
28,413,413,101,8,93,4,3
33,425,425,27,20,7,2,1
29,438,438,14,6,8,3,2
38,439,439,7,7,0,1,0
19,472,472,28,8,20,3,2
0,484,484,19,19,0,1,0
18,486,486,139,69,70,3,2
16,486,486,45,20,25,2,1
13,491,491,39,20,19,2,1
10,498,498,7,1,6,2,1

7,106,106,32,8,24,4,3
21,106,106,27,27,0,1,0
0,120,120,5,2,3,2,1
22,135,135,25,18,7,2,1
15,139,139,13,13,0,1,0
16,165,165,8,8,0,1,0
18,169,169,7,4,3,2,1
24,178,178,19,19,0,1,0
28,186,186,37,14,23,3,2
26,218,218,5,5,0,1,0
5,236,236,82,44,38,3,2
14,246,246,42,42,0,1,0
17,250,250,27,3,24,4,3
20,253,253,29,23,6,2,1
9,278,278,13,13,0,1,0
29,310,310,65,12,53,4,3
13,314,314,24,19,5,2,1
23,317,317,13,13,0,1,0
32,349,349,17,17,0,1,0
27,361,361,15,15,0,1,0
8,370,370,36,8,28,2,1
4,377,377,4,4,0,1,0
30,390,390,75,44,31,2,1
11,396,396,92,18,74,4,3
6,406,406,24,24,0,1,0
2,412,412,52,52,0,1,0
12,417,417,21,4,17,2,1
10,421,421,71,25,46,3,2
1,429,429,1,1,0,1,0
3,434,434,31,11,20,3,2
19,466,466,7,7,0,1,0
31,475,475,49,35,14,4,3
25,482,482,8,8,0,1,0

19,102,102,6,6,0,1,0
12,106,106,3,3,0,1,0
5,121,121,4,4,0,1,0
29,156,156,2,2,0,1,0
23,160,160,35,24,11,2,1
25,161,161,47,47,0,1,0
18,166,166,4,4,0,1,0
14,166,166,9,9,0,1,0
0,198,198,1,1,0,1,0
4,217,217,39,15,24,4,3
11,223,223,41,21,20,3,2
26,229,229,43,2,41,2,1
22,233,233,4,4,0,1,0
13,243,243,5,5,0,1,0
21,261,261,10,10,0,1,0
20,271,271,21,9,12,2,1
3,282,282,60,60,0,1,0
28,286,286,32,32,0,1,0
2,303,303,5,5,0,1,0
6,305,305,19,19,0,1,0
9,327,327,58,58,0,1,0
7,332,332,66,66,0,1,0
1,335,335,135,81,54,3,2
27,373,373,86,75,11,3,2
17,390,390,49,49,0,1,0
16,403,403,19,11,8,3,2
8,425,425,86,5,81,3,2
10,433,433,55,55,0,1,0
24,475,475,16,1,15,4,3
15,491,491,132,57,75,3,2

13,106,106,8,8,0,1,0
38,108,108,24,9,15,4,3
26,122,122,4,4,0,1,0
15,123,123,10,2,8,3,2
27,128,128,22,22,0,1,0
36,152,152,5,5,0,1,0
2,157,157,4,4,0,1,0
1,157,157,6,6,0,1,0
29,164,164,16,16,0,1,0
22,165,165,10,10,0,1,0
34,169,169,8,2,6,3,2
28,179,179,12,12,0,1,0
24,185,185,36,36,0,1,0
37,193,193,33,6,27,4,3
14,195,195,12,2,10,3,2
41,197,197,32,32,0,1,0
6,200,200,22,22,0,1,0
9,213,213,3,3,0,1,0
11,240,240,40,40,0,1,0
39,243,243,54,54,0,1,0
30,244,244,16,10,6,2,1
42,247,247,3,3,0,1,0
25,254,254,18,18,0,1,0
33,262,262,10,10,0,1,0
20,276,276,8,8,0,1,0
5,280,280,7,7,0,1,0
0,288,288,9,1,8,3,2
31,288,288,21,21,0,1,0
23,334,334,25,13,12,4,3
12,345,345,38,38,0,1,0
32,355,355,47,1,46,4,3
18,393,393,29,11,18,3,2
17,400,400,29,29,0,1,0
16,435,435,17,13,4,2,1
10,442,442,52,7,45,4,3
19,453,453,50,50,0,1,0
40,457,457,50,50,0,1,0
7,461,461,11,6,5,2,1
8,466,466,29,3,26,2,1
35,487,487,52,52,0,1,0
3,493,493,16,9,7,2,1
21,496,496,28,10,18,3,2
4,498,498,57,22,35,2,1

13,121,121,19,8,11,2,1
30,121,121,15,15,0,1,0
6,139,139,1,1,0,1,0
5,141,141,3,3,0,1,0
16,145,145,32,32,0,1,0
14,147,147,6,6,0,1,0
18,157,157,14,14,0,1,0
3,171,171,4,4,0,1,0
28,185,185,47,47,0,1,0
19,211,211,21,21,0,1,0
15,233,233,19,19,0,1,0
11,237,237,80,80,0,1,0
25,267,267,6,3,3,2,1
21,288,288,24,24,0,1,0
9,290,290,24,12,12,3,2
29,302,302,22,7,15,4,3
32,304,304,17,8,9,2,1
20,305,305,4,4,0,1,0
1,312,312,3,3,0,1,0
24,316,316,67,67,0,1,0
17,317,317,35,35,0,1,0
31,336,336,20,2,18,4,3
4,351,351,116,38,78,4,3
22,358,358,17,3,14,3,2
23,376,376,64,64,0,1,0
27,396,396,4,4,0,1,0
26,405,405,46,5,41,4,3
12,409,409,23,23,0,1,0
8,411,411,7,7,0,1,0
10,438,438,12,4,8,2,1
2,444,444,99,1,98,4,3
0,460,460,82,20,62,4,3
7,491,491,144,144,0,1,0

21,105,105,24,24,0,1,0
20,108,108,5,5,0,1,0
30,121,121,14,14,0,1,0
15,125,125,3,3,0,1,0
0,127,127,12,1,11,2,1
16,138,138,3,3,0,1,0
6,139,139,5,1,4,2,1
10,149,149,2,2,0,1,0
4,164,164,9,9,0,1,0
32,208,208,20,20,0,1,0
7,236,236,62,62,0,1,0
31,247,247,25,25,0,1,0
1,271,271,32,32,0,1,0
33,273,273,78,27,51,4,3
8,280,280,91,82,9,4,3
12,297,297,74,74,0,1,0
26,325,325,46,7,39,4,3
13,327,327,53,5,48,4,3
22,356,356,11,11,0,1,0
2,373,373,11,11,0,1,0
24,386,386,25,12,13,2,1
14,387,387,9,9,0,1,0
11,391,391,55,42,13,2,1
5,418,418,61,61,0,1,0
25,421,421,11,6,5,2,1
19,432,432,37,17,20,2,1
34,441,441,5,5,0,1,0
17,447,447,118,55,63,4,3
29,450,450,10,10,0,1,0
3,451,451,8,8,0,1,0
23,455,455,34,6,28,3,2
18,462,462,7,7,0,1,0
28,469,469,41,41,0,1,0
9,476,476,40,40,0,1,0
27,485,485,67,35,32,2,1

11,100,100,1,1,0,1,0
2,116,116,22,6,16,3,2
15,158,158,12,12,0,1,0
31,177,177,10,10,0,1,0
7,185,185,24,24,0,1,0
20,185,185,15,15,0,1,0
25,193,193,11,1,10,4,3
0,195,195,14,5,9,2,1
6,197,197,17,9,8,3,2
34,217,217,11,11,0,1,0
35,238,238,5,5,0,1,0
22,241,241,12,12,0,1,0
21,242,242,37,5,32,3,2
1,246,246,11,2,9,2,1
19,252,252,12,7,5,2,1
30,258,258,6,3,3,2,1
13,268,268,62,62,0,1,0
29,279,279,57,57,0,1,0
12,282,282,5,5,0,1,0
17,284,284,6,6,0,1,0
26,290,290,24,10,14,3,2
24,292,292,4,4,0,1,0
3,294,294,1,1,0,1,0
23,319,319,113,113,0,1,0
18,328,328,67,67,0,1,0
8,330,330,65,23,42,2,1
4,346,346,23,23,0,1,0
14,346,346,20,11,9,4,3
32,346,346,23,23,0,1,0
28,399,399,27,10,17,2,1
5,427,427,90,90,0,1,0
27,464,464,89,41,48,2,1
9,468,468,56,56,0,1,0
33,489,489,51,18,33,2,1
16,490,490,117,24,93,4,3
10,491,491,14,2,12,2,1

29,117,117,4,1,3,2,1
3,128,128,1,1,0,1,0
6,150,150,16,16,0,1,0
17,157,157,20,5,15,3,2
16,158,158,20,20,0,1,0
0,162,162,27,27,0,1,0
11,164,164,1,1,0,1,0
35,164,164,16,16,0,1,0
19,166,166,9,9,0,1,0
31,174,174,6,6,0,1,0
1,213,213,34,34,0,1,0
13,224,224,44,44,0,1,0
5,267,267,7,7,0,1,0
32,270,270,14,14,0,1,0
30,279,279,14,5,9,2,1
7,281,281,34,34,0,1,0
14,298,298,16,16,0,1,0
22,325,325,43,34,9,4,3
10,335,335,34,22,12,2,1
37,348,348,14,14,0,1,0
36,359,359,63,63,0,1,0
4,366,366,18,18,0,1,0
9,379,379,57,13,44,3,2
27,381,381,38,22,16,3,2
25,397,397,57,27,30,2,1
28,402,402,5,5,0,1,0
21,406,406,22,14,8,2,1
23,407,407,11,11,0,1,0
24,417,417,74,39,35,3,2
18,427,427,6,6,0,1,0
12,440,440,3,3,0,1,0
2,447,447,104,44,60,4,3
15,455,455,27,19,8,2,1
34,460,460,97,97,0,1,0
26,464,464,137,63,74,4,3
20,485,485,48,48,0,1,0
33,490,490,44,44,0,1,0
8,496,496,19,19,0,1,0

9,101,101,10,4,6,2,1
20,102,102,2,2,0,1,0
26,125,125,4,4,0,1,0
7,125,125,1,1,0,1,0
32,128,128,22,22,0,1,0
33,138,138,3,3,0,1,0
29,139,139,5,5,0,1,0
18,140,140,18,18,0,1,0
35,157,157,31,13,18,2,1
14,160,160,3,3,0,1,0
3,165,165,7,1,6,3,2
19,173,173,5,5,0,1,0
23,206,206,4,4,0,1,0
15,213,213,7,2,5,2,1
24,219,219,11,2,9,2,1
10,236,236,30,30,0,1,0
1,249,249,8,2,6,3,2
30,257,257,25,10,15,4,3
21,261,261,6,6,0,1,0
6,268,268,68,50,18,4,3
27,272,272,5,5,0,1,0
17,274,274,23,1,22,3,2
5,294,294,54,54,0,1,0
36,311,311,32,2,30,3,2
13,329,329,19,19,0,1,0
8,335,335,34,4,30,2,1
4,336,336,125,107,18,2,1
16,372,372,26,1,25,2,1
37,378,378,114,114,0,1,0
22,386,386,94,94,0,1,0
25,399,399,54,3,51,4,3
11,403,403,1,1,0,1,0
31,405,405,108,108,0,1,0
12,427,427,39,39,0,1,0
34,432,432,44,44,0,1,0
0,451,451,29,29,0,1,0
2,457,457,2,2,0,1,0
28,492,492,7,7,0,1,0

13,102,102,11,11,0,1,0
34,120,120,3,3,0,1,0
36,120,120,4,4,0,1,0
27,150,150,37,21,16,2,1
7,154,154,9,9,0,1,0
30,166,166,21,21,0,1,0
4,179,179,21,21,0,1,0
14,181,181,26,26,0,1,0
22,203,203,14,4,10,3,2
11,203,203,10,10,0,1,0
20,203,203,12,3,9,2,1
16,222,222,1,1,0,1,0
6,227,227,79,79,0,1,0
25,227,227,6,6,0,1,0
1,279,279,50,50,0,1,0
23,292,292,6,3,3,2,1
32,294,294,19,19,0,1,0
17,309,309,19,19,0,1,0
15,310,310,23,23,0,1,0
38,312,312,81,66,15,4,3
31,327,327,27,27,0,1,0
12,336,336,38,38,0,1,0
29,343,343,2,2,0,1,0
0,347,347,3,3,0,1,0
18,361,361,3,3,0,1,0
21,362,362,4,4,0,1,0
26,375,375,45,27,18,2,1
24,377,377,6,1,5,2,1
33,380,380,119,119,0,1,0
9,381,381,32,32,0,1,0
37,433,433,51,9,42,4,3
19,444,444,1,1,0,1,0
28,460,460,82,73,9,2,1
8,470,470,2,2,0,1,0
3,476,476,39,1,38,3,2
35,476,476,61,61,0,1,0
10,489,489,1,1,0,1,0
5,489,489,137,83,54,3,2
2,490,490,7,7,0,1,0

33,102,102,9,9,0,1,0
29,115,115,3,3,0,1,0
4,121,121,22,8,14,3,2
15,122,122,6,6,0,1,0
14,147,147,8,8,0,1,0
17,150,150,26,26,0,1,0
9,161,161,35,1,34,2,1
11,167,167,7,7,0,1,0
1,184,184,22,22,0,1,0
7,192,192,6,6,0,1,0
27,197,197,17,9,8,3,2
35,199,199,12,12,0,1,0
16,224,224,16,16,0,1,0
25,228,228,3,3,0,1,0
34,255,255,78,51,27,4,3
24,265,265,15,15,0,1,0
23,283,283,29,29,0,1,0
18,287,287,21,7,14,2,1
32,288,288,31,6,25,2,1
13,307,307,24,24,0,1,0
19,309,309,31,17,14,3,2
0,311,311,61,28,33,2,1
31,312,312,43,43,0,1,0
12,332,332,78,6,72,3,2
2,336,336,1,1,0,1,0
22,343,343,4,4,0,1,0
3,347,347,3,3,0,1,0
26,349,349,27,27,0,1,0
20,385,385,52,25,27,4,3
28,431,431,13,7,6,2,1
10,437,437,39,32,7,2,1
6,437,437,35,28,7,2,1
5,446,446,75,29,46,2,1
21,477,477,165,150,15,3,2
30,487,487,42,42,0,1,0
8,493,493,3,3,0,1,0

19,109,109,7,7,0,1,0
41,115,115,3,3,0,1,0
11,132,132,3,3,0,1,0
5,135,135,45,23,22,2,1
39,137,137,8,8,0,1,0
30,156,156,9,4,5,2,1
26,156,156,9,3,6,2,1
42,170,170,18,18,0,1,0
14,172,172,38,25,13,2,1
7,175,175,18,18,0,1,0
8,187,187,1,1,0,1,0
37,189,189,6,6,0,1,0
2,195,195,20,20,0,1,0
20,210,210,4,4,0,1,0
27,213,213,20,11,9,4,3
40,218,218,8,3,5,2,1
0,219,219,2,2,0,1,0
22,221,221,18,18,0,1,0
1,239,239,2,2,0,1,0
29,240,240,39,1,38,2,1
12,242,242,39,29,10,3,2
32,245,245,20,1,19,3,2
15,250,250,15,9,6,2,1
6,316,316,32,13,19,2,1
17,326,326,21,6,15,4,3
33,372,372,77,41,36,4,3
28,392,392,70,70,0,1,0
35,400,400,38,26,12,2,1
36,403,403,104,5,99,4,3
16,427,427,1,1,0,1,0
10,431,431,36,36,0,1,0
38,441,441,25,5,20,3,2
18,451,451,48,48,0,1,0
3,469,469,9,6,3,2,1
9,476,476,22,22,0,1,0
24,481,481,11,11,0,1,0
34,483,483,65,65,0,1,0
25,484,484,90,65,25,4,3
13,484,484,18,18,0,1,0
23,485,485,5,2,3,2,1
4,490,490,10,10,0,1,0
31,494,494,5,5,0,1,0
21,497,497,48,2,46,3,2

25,115,115,14,1,13,4,3
16,117,117,5,5,0,1,0
0,120,120,1,1,0,1,0
33,150,150,16,8,8,3,2
32,153,153,39,28,11,2,1
37,154,154,8,8,0,1,0
39,170,170,7,7,0,1,0
21,180,180,17,5,12,2,1
12,213,213,3,3,0,1,0
26,219,219,29,29,0,1,0
14,220,220,17,17,0,1,0
11,226,226,14,1,13,2,1
28,231,231,5,1,4,2,1
20,232,232,10,10,0,1,0
40,250,250,6,2,4,2,1
6,269,269,6,6,0,1,0
23,273,273,84,36,48,3,2
4,279,279,44,44,0,1,0
31,285,285,26,26,0,1,0
5,310,310,12,5,7,2,1
24,322,322,15,15,0,1,0
10,326,326,27,27,0,1,0
13,351,351,19,19,0,1,0
18,386,386,63,9,54,4,3
29,387,387,14,1,13,2,1
15,389,389,71,71,0,1,0
3,418,418,4,4,0,1,0
38,433,433,107,74,33,4,3
19,435,435,47,4,43,4,3
34,435,435,39,12,27,4,3
27,453,453,56,38,18,4,3
2,457,457,13,13,0,1,0
36,458,458,23,1,22,4,3
9,465,465,79,68,11,2,1
22,469,469,7,7,0,1,0
8,475,475,37,37,0,1,0
30,481,481,14,14,0,1,0
17,485,485,133,85,48,2,1
1,486,486,5,5,0,1,0
35,488,488,27,27,0,1,0
7,488,488,31,31,0,1,0

39,118,118,1,1,0,1,0
43,121,121,35,28,7,2,1
41,137,137,16,16,0,1,0
14,150,150,14,14,0,1,0
27,150,150,16,16,0,1,0
44,157,157,1,1,0,1,0
11,160,160,3,3,0,1,0
4,172,172,5,5,0,1,0
15,186,186,7,7,0,1,0
5,201,201,1,1,0,1,0
36,201,201,15,3,12,2,1
31,202,202,1,1,0,1,0
32,211,211,49,49,0,1,0
13,229,229,8,8,0,1,0
37,243,243,4,4,0,1,0
17,245,245,13,13,0,1,0
24,253,253,13,13,0,1,0
33,259,259,34,34,0,1,0
0,273,273,1,1,0,1,0
9,275,275,6,3,3,2,1
2,280,280,36,7,29,2,1
25,290,290,42,42,0,1,0
35,307,307,5,5,0,1,0
38,313,313,69,37,32,3,2
8,330,330,2,2,0,1,0
34,330,330,99,99,0,1,0
19,339,339,55,55,0,1,0
6,353,353,16,16,0,1,0
12,364,364,16,10,6,3,2
21,394,394,46,46,0,1,0
10,413,413,16,10,6,2,1
7,436,436,34,27,7,2,1
3,439,439,26,26,0,1,0
22,445,445,1,1,0,1,0
26,453,453,88,58,30,4,3
20,455,455,37,25,12,3,2
40,457,457,36,36,0,1,0
18,465,465,16,9,7,2,1
30,469,469,6,2,4,2,1
1,480,480,27,27,0,1,0
28,489,489,1,1,0,1,0
23,491,491,11,11,0,1,0
29,494,494,2,2,0,1,0
42,495,495,111,111,0,1,0
16,497,497,118,118,0,1,0

17,109,109,14,14,0,1,0
20,110,110,10,10,0,1,0
34,117,117,21,21,0,1,0
1,142,142,7,7,0,1,0
28,153,153,27,9,18,2,1
5,160,160,75,75,0,1,0
23,162,162,36,36,0,1,0
30,170,170,6,6,0,1,0
11,185,185,10,1,9,4,3
13,195,195,14,4,10,3,2
36,203,203,2,2,0,1,0
21,210,210,37,37,0,1,0
15,216,216,6,6,0,1,0
25,225,225,35,35,0,1,0
3,228,228,9,3,6,3,2
18,242,242,3,3,0,1,0
33,245,245,28,14,14,3,2
27,246,246,4,4,0,1,0
26,251,251,39,39,0,1,0
10,256,256,56,48,8,2,1
8,292,292,1,1,0,1,0
9,312,312,9,1,8,2,1
31,328,328,18,8,10,2,1
29,338,338,34,34,0,1,0
2,344,344,6,6,0,1,0
12,355,355,41,8,33,2,1
24,366,366,65,44,21,2,1
6,374,374,7,7,0,1,0
22,380,380,5,5,0,1,0
7,385,385,66,15,51,4,3
14,393,393,24,24,0,1,0
16,399,399,4,4,0,1,0
35,399,399,32,17,15,3,2
32,408,408,5,5,0,1,0
0,483,483,60,35,25,2,1
19,484,484,33,3,30,4,3
4,493,493,89,16,73,3,2

31,106,106,6,2,4,2,1
18,146,146,21,9,12,4,3
21,163,163,2,2,0,1,0
10,175,175,22,2,20,2,1
23,189,189,40,9,31,4,3
6,199,199,21,21,0,1,0
30,202,202,21,6,15,4,3
29,223,223,11,11,0,1,0
0,226,226,30,13,17,2,1
26,229,229,4,1,3,2,1
25,233,233,19,19,0,1,0
27,244,244,1,1,0,1,0
28,265,265,5,5,0,1,0
4,271,271,24,14,10,2,1
8,293,293,1,1,0,1,0
14,319,319,6,6,0,1,0
9,325,325,1,1,0,1,0
19,347,347,23,23,0,1,0
17,361,361,33,15,18,4,3
15,367,367,28,28,0,1,0
5,371,371,2,2,0,1,0
22,372,372,35,35,0,1,0
20,379,379,6,6,0,1,0
11,406,406,24,2,22,3,2
32,413,413,8,2,6,2,1
12,450,450,37,37,0,1,0
1,462,462,45,45,0,1,0
2,466,466,40,18,22,3,2
3,488,488,232,197,35,3,2
16,493,493,82,64,18,4,3
13,494,494,206,101,105,4,3
24,497,497,303,186,117,4,3
7,498,498,51,51,0,1,0

4,108,108,2,2,0,1,0
0,112,112,5,1,4,2,1
7,118,118,4,4,0,1,0
5,123,123,1,1,0,1,0
33,125,125,4,4,0,1,0
6,126,126,5,2,3,2,1
23,126,126,4,4,0,1,0
30,142,142,29,29,0,1,0
11,145,145,1,1,0,1,0
20,161,161,16,7,9,4,3
26,187,187,12,3,9,3,2
38,197,197,71,71,0,1,0
28,206,206,14,8,6,3,2
21,219,219,13,13,0,1,0
34,226,226,12,2,10,2,1
31,227,227,56,2,54,4,3
14,230,230,1,1,0,1,0
3,239,239,46,46,0,1,0
12,240,240,55,55,0,1,0
37,240,240,3,3,0,1,0
2,245,245,11,11,0,1,0
32,250,250,21,2,19,2,1
29,259,259,49,49,0,1,0
35,290,290,34,1,33,3,2
27,308,308,52,52,0,1,0
10,315,315,38,8,30,3,2
17,316,316,19,9,10,3,2
22,322,322,23,23,0,1,0
9,324,324,38,17,21,4,3
8,344,344,60,60,0,1,0
18,370,370,6,6,0,1,0
13,381,381,67,67,0,1,0
25,383,383,21,15,6,3,2
19,399,399,20,5,15,2,1
16,469,469,1,1,0,1,0
24,477,477,9,9,0,1,0
1,478,478,172,172,0,1,0
15,479,479,3,3,0,1,0
36,500,500,3,3,0,1,0

12,116,116,33,33,0,1,0
11,146,146,1,1,0,1,0
13,148,148,55,33,22,3,2
27,159,159,7,1,6,3,2
19,173,173,15,15,0,1,0
15,179,179,22,4,18,2,1
29,201,201,32,12,20,3,2
4,206,206,15,15,0,1,0
25,227,227,6,6,0,1,0
20,232,232,10,1,9,3,2
17,236,236,2,2,0,1,0
31,238,238,6,2,4,2,1
21,259,259,32,20,12,2,1
0,281,281,22,22,0,1,0
1,287,287,9,9,0,1,0
7,322,322,38,23,15,2,1
2,323,323,14,2,12,2,1
6,336,336,22,22,0,1,0
18,338,338,85,38,47,3,2
24,346,346,40,40,0,1,0
3,349,349,76,28,48,4,3
28,354,354,15,15,0,1,0
32,357,357,1,1,0,1,0
16,362,362,33,33,0,1,0
26,364,364,1,1,0,1,0
23,376,376,171,163,8,2,1
10,376,376,5,1,4,2,1
22,385,385,18,6,12,3,2
30,413,413,79,79,0,1,0
8,417,417,88,55,33,2,1
5,422,422,32,5,27,2,1
14,441,441,10,3,7,2,1
9,461,461,87,38,49,2,1

4,111,111,21,9,12,4,3
20,114,114,8,8,0,1,0
27,136,136,17,17,0,1,0
3,141,141,19,19,0,1,0
37,141,141,2,2,0,1,0
38,157,157,48,48,0,1,0
17,159,159,15,15,0,1,0
23,171,171,7,7,0,1,0
26,213,213,4,4,0,1,0
13,222,222,29,29,0,1,0
12,227,227,15,15,0,1,0
19,230,230,11,2,9,2,1
7,279,279,68,34,34,3,2
36,287,287,33,33,0,1,0
31,295,295,15,15,0,1,0
14,308,308,1,1,0,1,0
6,311,311,1,1,0,1,0
10,321,321,25,25,0,1,0
21,323,323,15,15,0,1,0
33,331,331,16,16,0,1,0
30,334,334,10,6,4,2,1
24,351,351,48,4,44,2,1
15,353,353,86,86,0,1,0
32,354,354,73,57,16,3,2
2,369,369,5,2,3,2,1
35,372,372,6,1,5,2,1
1,376,376,45,45,0,1,0
18,386,386,29,8,21,2,1
16,386,386,24,24,0,1,0
25,393,393,66,66,0,1,0
11,396,396,8,5,3,2,1
29,409,409,27,27,0,1,0
0,413,413,20,5,15,2,1
8,419,419,36,36,0,1,0
9,431,431,1,1,0,1,0
5,435,435,33,27,6,2,1
34,470,470,115,91,24,2,1
22,491,491,3,3,0,1,0
28,493,493,92,51,41,2,1

9,117,117,48,30,18,4,3
14,130,130,24,14,10,2,1
19,149,149,11,4,7,2,1
15,152,152,13,4,9,2,1
30,157,157,13,13,0,1,0
12,174,174,27,12,15,4,3
0,175,175,13,2,11,2,1
3,183,183,15,11,4,2,1
27,217,217,20,20,0,1,0
26,221,221,85,45,40,2,1
10,233,233,18,3,15,4,3
18,239,239,46,8,38,3,2
24,239,239,12,6,6,2,1
17,242,242,17,17,0,1,0
20,255,255,10,7,3,2,1
7,279,279,9,3,6,2,1
1,297,297,16,1,15,2,1
6,320,320,18,8,10,3,2
22,329,329,62,4,58,4,3
29,345,345,3,3,0,1,0
11,355,355,44,8,36,2,1
8,370,370,90,90,0,1,0
21,372,372,43,43,0,1,0
4,380,380,40,40,0,1,0
16,381,381,22,22,0,1,0
13,420,420,53,53,0,1,0
5,436,436,119,119,0,1,0
25,442,442,11,7,4,2,1
28,468,468,22,16,6,2,1
23,481,481,8,1,7,2,1
2,492,492,56,8,48,2,1

21,104,104,6,1,5,2,1
16,105,105,16,4,12,2,1
8,115,115,1,1,0,1,0
34,127,127,42,42,0,1,0
24,153,153,6,6,0,1,0
14,175,175,23,23,0,1,0
27,211,211,10,3,7,2,1
2,219,219,5,5,0,1,0
20,226,226,25,25,0,1,0
33,227,227,34,34,0,1,0
38,232,232,46,7,39,2,1
12,237,237,33,18,15,3,2
11,251,251,11,3,8,2,1
32,257,257,28,28,0,1,0
36,259,259,12,12,0,1,0
17,261,261,67,40,27,4,3
31,261,261,22,1,21,2,1
10,288,288,13,8,5,2,1
18,303,303,20,16,4,2,1
13,347,347,7,7,0,1,0
0,347,347,65,65,0,1,0
23,349,349,23,5,18,2,1
28,352,352,13,7,6,3,2
6,359,359,40,6,34,2,1
25,361,361,16,16,0,1,0
30,372,372,23,9,14,3,2
35,375,375,12,12,0,1,0
5,388,388,33,33,0,1,0
7,389,389,25,10,15,2,1
19,390,390,3,3,0,1,0
3,394,394,23,15,8,3,2
37,422,422,92,69,23,4,3
9,431,431,53,53,0,1,0
1,436,436,48,38,10,2,1
22,468,468,66,29,37,4,3
15,469,469,17,17,0,1,0
4,472,472,10,10,0,1,0
26,479,479,28,28,0,1,0
29,491,491,55,8,47,2,1

28,107,107,1,1,0,1,0
34,108,108,37,37,0,1,0
4,116,116,1,1,0,1,0
18,117,117,5,2,3,2,1
31,121,121,16,16,0,1,0
16,136,136,12,12,0,1,0
20,164,164,51,21,30,2,1
33,168,168,18,18,0,1,0
0,176,176,6,6,0,1,0
38,178,178,17,14,3,2,1
12,192,192,11,11,0,1,0
21,196,196,17,13,4,2,1
5,196,196,1,1,0,1,0
17,203,203,10,2,8,3,2
36,205,205,13,8,5,2,1
3,208,208,24,3,21,4,3
22,229,229,11,11,0,1,0
6,235,235,6,6,0,1,0
19,240,240,2,2,0,1,0
41,246,246,13,3,10,3,2
24,247,247,9,9,0,1,0
43,272,272,22,22,0,1,0
40,284,284,45,45,0,1,0
9,298,298,11,3,8,2,1
2,310,310,119,88,31,3,2
32,318,318,22,22,0,1,0
8,342,342,23,1,22,2,1
1,345,345,19,19,0,1,0
15,356,356,24,24,0,1,0
10,363,363,8,8,0,1,0
39,371,371,4,4,0,1,0
26,372,372,17,9,8,3,2
11,389,389,2,2,0,1,0
27,396,396,13,1,12,2,1
25,411,411,24,24,0,1,0
23,417,417,20,20,0,1,0
7,429,429,2,2,0,1,0
35,444,444,28,5,23,2,1
37,450,450,79,79,0,1,0
42,456,456,39,2,37,4,3
13,465,465,13,7,6,3,2
29,473,473,129,55,74,3,2
14,484,484,52,52,0,1,0
30,494,494,24,24,0,1,0

22,100,100,3,3,0,1,0
35,105,105,11,3,8,2,1
39,119,119,2,2,0,1,0
26,158,158,11,11,0,1,0
38,164,164,1,1,0,1,0
20,164,164,1,1,0,1,0
43,164,164,33,33,0,1,0
9,166,166,4,4,0,1,0
46,166,166,8,1,7,2,1
29,167,167,12,12,0,1,0
2,167,167,4,1,3,2,1
6,184,184,3,3,0,1,0
34,192,192,18,18,0,1,0
14,204,204,12,12,0,1,0
41,207,207,31,1,30,2,1
11,210,210,17,17,0,1,0
32,212,212,5,5,0,1,0
28,215,215,16,9,7,2,1
31,227,227,17,17,0,1,0
33,228,228,14,14,0,1,0
8,228,228,26,26,0,1,0
40,232,232,8,8,0,1,0
45,243,243,40,40,0,1,0
37,250,250,26,4,22,2,1
0,254,254,6,6,0,1,0
13,264,264,1,1,0,1,0
19,267,267,25,25,0,1,0
5,268,268,2,2,0,1,0
25,286,286,1,1,0,1,0
36,286,286,15,3,12,2,1
17,302,302,23,23,0,1,0
21,322,322,4,4,0,1,0
4,335,335,11,11,0,1,0
47,347,347,12,12,0,1,0
23,363,363,95,95,0,1,0
30,375,375,3,3,0,1,0
42,378,378,144,33,111,4,3
27,382,382,78,56,22,3,2
15,392,392,12,12,0,1,0
44,412,412,118,1,117,4,3
7,421,421,23,23,0,1,0
10,445,445,9,9,0,1,0
18,457,457,27,15,12,2,1
12,475,475,5,5,0,1,0
3,486,486,2,2,0,1,0
16,490,490,36,12,24,2,1
1,493,493,5,5,0,1,0
24,497,497,124,93,31,2,1

1,124,124,58,58,0,1,0
20,128,128,5,5,0,1,0
23,130,130,11,11,0,1,0
12,145,145,4,4,0,1,0
9,159,159,1,1,0,1,0
4,199,199,29,29,0,1,0
19,208,208,3,3,0,1,0
14,209,209,4,4,0,1,0
11,217,217,29,29,0,1,0
25,223,223,6,3,3,2,1
24,250,250,104,92,12,3,2
21,281,281,10,10,0,1,0
3,308,308,29,11,18,4,3
2,339,339,101,39,62,3,2
15,340,340,12,12,0,1,0
10,354,354,81,81,0,1,0
27,391,391,45,15,30,2,1
8,395,395,12,12,0,1,0
13,413,413,106,106,0,1,0
22,415,415,8,4,4,2,1
7,421,421,34,11,23,2,1
18,431,431,53,7,46,3,2
6,436,436,1,1,0,1,0
26,467,467,120,60,60,4,3
0,469,469,133,133,0,1,0
5,475,475,14,14,0,1,0
16,484,484,50,50,0,1,0
28,487,487,29,16,13,2,1
17,489,489,44,44,0,1,0
29,495,495,53,53,0,1,0

5,137,137,8,8,0,1,0
4,156,156,42,39,3,2,1
28,176,176,3,3,0,1,0
15,189,189,42,42,0,1,0
18,206,206,1,1,0,1,0
21,207,207,31,9,22,2,1
26,212,212,7,2,5,2,1
19,218,218,1,1,0,1,0
30,229,229,113,14,99,4,3
24,229,229,4,4,0,1,0
17,248,248,1,1,0,1,0
12,264,264,17,8,9,4,3
3,286,286,6,6,0,1,0
23,298,298,6,6,0,1,0
25,310,310,21,21,0,1,0
16,314,314,49,33,16,2,1
11,336,336,31,31,0,1,0
29,340,340,6,6,0,1,0
7,342,342,28,4,24,4,3
27,349,349,68,68,0,1,0
2,357,357,4,4,0,1,0
14,359,359,6,6,0,1,0
22,370,370,96,96,0,1,0
10,372,372,114,91,23,2,1
6,398,398,115,47,68,3,2
0,416,416,145,16,129,4,3
13,434,434,6,6,0,1,0
9,434,434,1,1,0,1,0
31,435,435,11,11,0,1,0
20,447,447,59,59,0,1,0
1,462,462,75,3,72,3,2
8,466,466,37,37,0,1,0

27,105,105,3,3,0,1,0
5,110,110,7,7,0,1,0
4,166,166,2,2,0,1,0
32,175,175,25,12,13,4,3
6,182,182,11,1,10,3,2
37,195,195,4,4,0,1,0
33,204,204,11,3,8,2,1
17,213,213,5,5,0,1,0
20,232,232,34,2,32,2,1
24,246,246,5,5,0,1,0
25,247,247,21,1,20,3,2
8,252,252,57,39,18,3,2
16,257,257,19,1,18,4,3
13,257,257,5,5,0,1,0
0,275,275,55,16,39,4,3
36,288,288,33,14,19,2,1
35,296,296,22,15,7,2,1
30,315,315,102,92,10,3,2
38,315,315,42,28,14,3,2
39,323,323,27,5,22,3,2
2,335,335,15,9,6,3,2
28,341,341,28,28,0,1,0
12,359,359,12,4,8,3,2
11,360,360,37,19,18,4,3
19,362,362,2,2,0,1,0
21,362,362,52,52,0,1,0
22,396,396,69,5,64,3,2
15,397,397,1,1,0,1,0
34,401,401,12,12,0,1,0
40,402,402,182,62,120,4,3
1,405,405,9,9,0,1,0
23,435,435,26,26,0,1,0
41,440,440,17,17,0,1,0
18,440,440,10,4,6,2,1
26,442,442,10,7,3,2,1
10,443,443,1,1,0,1,0
14,453,453,73,32,41,2,1
29,458,458,52,9,43,2,1
31,464,464,11,3,8,3,2
3,464,464,24,24,0,1,0
9,467,467,39,39,0,1,0
7,493,493,32,32,0,1,0

18,114,114,3,3,0,1,0
4,143,143,2,2,0,1,0
11,148,148,4,4,0,1,0
27,161,161,8,8,0,1,0
19,161,161,46,37,9,2,1
16,166,166,5,5,0,1,0
10,168,168,7,7,0,1,0
8,196,196,36,18,18,4,3
22,199,199,12,12,0,1,0
26,214,214,47,24,23,2,1
1,228,228,89,89,0,1,0
5,272,272,15,15,0,1,0
13,299,299,77,77,0,1,0
17,320,320,52,52,0,1,0
6,329,329,190,121,69,4,3
3,336,336,13,13,0,1,0
20,353,353,2,2,0,1,0
15,361,361,39,39,0,1,0
14,376,376,58,19,39,4,3
7,398,398,95,19,76,3,2
2,421,421,30,30,0,1,0
12,429,429,2,2,0,1,0
25,431,431,9,9,0,1,0
21,463,463,22,22,0,1,0
9,479,479,56,29,27,4,3
0,480,480,55,2,53,3,2
24,488,488,87,19,68,3,2
23,489,489,76,7,69,4,3

11,106,106,8,8,0,1,0
28,110,110,6,6,0,1,0
29,116,116,51,39,12,4,3
7,120,120,16,16,0,1,0
36,124,124,16,8,8,2,1
38,135,135,3,3,0,1,0
30,149,149,4,4,0,1,0
31,157,157,14,14,0,1,0
14,181,181,6,6,0,1,0
15,203,203,1,1,0,1,0
35,221,221,30,30,0,1,0
6,237,237,22,18,4,2,1
39,270,270,27,6,21,4,3
34,273,273,24,16,8,3,2
2,289,289,25,7,18,2,1
9,300,300,24,6,18,2,1
10,312,312,1,1,0,1,0
37,324,324,32,32,0,1,0
16,330,330,25,7,18,2,1
3,333,333,38,38,0,1,0
23,343,343,7,3,4,2,1
21,345,345,12,12,0,1,0
24,346,346,5,5,0,1,0
26,347,347,8,5,3,2,1
4,349,349,40,40,0,1,0
0,365,365,123,32,91,4,3
8,373,373,7,1,6,3,2
32,378,378,3,3,0,1,0
13,387,387,17,17,0,1,0
12,403,403,4,4,0,1,0
1,406,406,79,51,28,2,1
20,413,413,22,22,0,1,0
27,416,416,33,1,32,3,2
5,421,421,3,3,0,1,0
17,428,428,41,41,0,1,0
33,436,436,36,10,26,2,1
18,452,452,30,12,18,4,3
19,465,465,59,59,0,1,0
25,494,494,55,55,0,1,0
22,497,497,155,59,96,3,2

36,107,107,5,1,4,2,1
27,110,110,10,6,4,2,1
6,111,111,14,2,12,3,2
17,126,126,5,5,0,1,0
32,132,132,19,19,0,1,0
7,133,133,5,5,0,1,0
18,141,141,4,4,0,1,0
29,147,147,27,27,0,1,0
21,185,185,104,104,0,1,0
37,209,209,30,20,10,3,2
11,210,210,21,4,17,2,1
10,212,212,1,1,0,1,0
26,233,233,12,12,0,1,0
3,244,244,25,6,19,2,1
12,247,247,69,57,12,4,3
15,260,260,49,35,14,3,2
8,262,262,1,1,0,1,0
28,276,276,18,18,0,1,0
24,280,280,10,10,0,1,0
5,286,286,14,11,3,2,1
16,287,287,40,40,0,1,0
23,294,294,18,18,0,1,0
33,306,306,55,55,0,1,0
9,314,314,39,23,16,3,2
19,331,331,9,9,0,1,0
1,334,334,16,9,7,2,1
14,348,348,12,4,8,3,2
34,352,352,4,4,0,1,0
31,354,354,5,1,4,2,1
30,370,370,2,2,0,1,0
20,396,396,44,44,0,1,0
35,405,405,26,26,0,1,0
4,419,419,18,18,0,1,0
22,420,420,16,7,9,4,3
13,423,423,8,3,5,2,1
0,479,479,3,3,0,1,0
25,483,483,16,16,0,1,0
2,485,485,195,168,27,4,3

21,105,105,5,5,0,1,0
7,107,107,2,2,0,1,0
13,108,108,22,22,0,1,0
18,143,143,23,23,0,1,0
17,225,225,20,20,0,1,0
35,232,232,41,10,31,2,1
8,234,234,75,24,51,3,2
0,242,242,12,9,3,2,1
33,247,247,2,2,0,1,0
29,247,247,4,1,3,2,1
16,248,248,11,11,0,1,0
31,263,263,4,4,0,1,0
14,283,283,8,8,0,1,0
24,283,283,22,8,14,3,2
11,287,287,23,23,0,1,0
6,288,288,17,7,10,2,1
1,292,292,61,31,30,3,2
4,320,320,58,30,28,3,2
27,330,330,10,10,0,1,0
26,334,334,104,43,61,3,2
5,335,335,1,1,0,1,0
15,340,340,44,4,40,3,2
19,342,342,97,9,88,3,2
32,343,343,57,57,0,1,0
10,348,348,36,30,6,3,2
3,368,368,1,1,0,1,0
34,373,373,16,2,14,3,2
20,390,390,64,64,0,1,0
22,395,395,68,26,42,3,2
12,398,398,103,98,5,2,1
25,437,437,1,1,0,1,0
2,475,475,9,9,0,1,0
9,481,481,1,1,0,1,0
30,490,490,11,11,0,1,0
23,494,494,54,54,0,1,0
28,494,494,12,12,0,1,0

20,106,106,4,4,0,1,0
29,108,108,1,1,0,1,0
24,115,115,30,15,15,4,3
27,118,118,3,3,0,1,0
25,123,123,5,5,0,1,0
32,126,126,21,2,19,2,1
4,139,139,1,1,0,1,0
3,172,172,1,1,0,1,0
10,172,172,7,1,6,3,2
23,185,185,8,5,3,2,1
21,190,190,49,49,0,1,0
34,195,195,3,3,0,1,0
37,203,203,17,9,8,3,2
2,210,210,1,1,0,1,0
36,221,221,8,8,0,1,0
40,223,223,65,48,17,2,1
16,224,224,11,11,0,1,0
35,237,237,8,3,5,2,1
13,238,238,8,1,7,2,1
30,252,252,40,40,0,1,0
28,299,299,16,16,0,1,0
17,320,320,28,13,15,2,1
9,324,324,2,2,0,1,0
6,327,327,5,5,0,1,0
38,331,331,22,3,19,2,1
15,332,332,11,11,0,1,0
31,348,348,44,44,0,1,0
1,353,353,3,3,0,1,0
33,359,359,35,20,15,2,1
8,399,399,16,13,3,2,1
11,403,403,29,25,4,2,1
26,409,409,53,41,12,2,1
19,435,435,23,9,14,3,2
14,439,439,135,107,28,3,2
39,446,446,2,2,0,1,0
22,449,449,115,65,50,3,2
18,455,455,35,35,0,1,0
12,458,458,38,27,11,2,1
41,467,467,114,52,62,3,2
5,468,468,24,24,0,1,0
0,472,472,97,5,92,3,2
7,495,495,14,3,11,2,1

26,109,109,4,4,0,1,0
34,127,127,9,9,0,1,0
13,149,149,5,1,4,2,1
4,152,152,4,4,0,1,0
7,171,171,1,1,0,1,0
27,203,203,28,19,9,4,3
10,220,220,48,18,30,4,3
23,228,228,3,3,0,1,0
15,230,230,6,6,0,1,0
8,239,239,21,21,0,1,0
2,247,247,53,41,12,3,2
33,256,256,33,33,0,1,0
30,256,256,2,2,0,1,0
28,263,263,8,8,0,1,0
11,287,287,22,9,13,3,2
12,288,288,17,17,0,1,0
17,304,304,49,25,24,2,1
16,312,312,25,25,0,1,0
32,331,331,107,43,64,3,2
19,333,333,40,19,21,4,3
0,334,334,32,32,0,1,0
31,345,345,5,5,0,1,0
3,350,350,97,16,81,4,3
25,356,356,14,2,12,2,1
18,378,378,29,13,16,2,1
6,385,385,33,15,18,4,3
9,404,404,58,40,18,3,2
29,414,414,37,17,20,2,1
14,444,444,6,6,0,1,0
22,448,448,82,74,8,2,1
5,451,451,31,19,12,4,3
1,473,473,60,60,0,1,0
24,478,478,76,63,13,2,1
20,478,478,156,15,141,4,3
21,490,490,3,3,0,1,0
35,492,492,34,34,0,1,0

25,113,113,4,4,0,1,0
10,116,116,1,1,0,1,0
31,134,134,7,3,4,2,1
16,139,139,8,8,0,1,0
11,156,156,34,34,0,1,0
1,164,164,21,21,0,1,0
27,165,165,34,34,0,1,0
21,184,184,30,6,24,3,2
18,211,211,3,3,0,1,0
26,214,214,6,3,3,2,1
6,215,215,43,43,0,1,0
13,223,223,15,15,0,1,0
35,227,227,25,25,0,1,0
7,228,228,1,1,0,1,0
0,234,234,1,1,0,1,0
23,242,242,28,28,0,1,0
8,248,248,24,24,0,1,0
29,270,270,37,3,34,2,1
12,275,275,30,11,19,2,1
9,282,282,8,8,0,1,0
24,291,291,52,52,0,1,0
5,303,303,1,1,0,1,0
30,310,310,19,19,0,1,0
36,316,316,6,3,3,2,1
4,316,316,121,72,49,2,1
15,328,328,95,17,78,3,2
2,361,361,3,3,0,1,0
32,385,385,42,39,3,2,1
28,396,396,5,5,0,1,0
22,402,402,109,109,0,1,0
20,427,427,71,71,0,1,0
19,462,462,16,16,0,1,0
33,474,474,44,44,0,1,0
14,476,476,32,2,30,4,3
34,494,494,19,3,16,3,2
17,496,496,51,42,9,2,1
3,500,500,6,6,0,1,0

13,100,100,12,3,9,4,3
7,100,100,5,5,0,1,0
34,106,106,3,3,0,1,0
37,115,115,7,7,0,1,0
10,128,128,1,1,0,1,0
36,129,129,15,15,0,1,0
18,164,164,35,35,0,1,0
24,172,172,37,25,12,4,3
32,178,178,1,1,0,1,0
29,180,180,41,41,0,1,0
4,183,183,19,1,18,2,1
6,209,209,17,17,0,1,0
22,221,221,50,23,27,4,3
14,224,224,5,5,0,1,0
11,246,246,14,11,3,2,1
21,255,255,17,17,0,1,0
15,259,259,32,3,29,2,1
28,265,265,16,16,0,1,0
3,268,268,9,9,0,1,0
12,273,273,24,16,8,2,1
20,275,275,57,3,54,3,2
26,326,326,11,3,8,2,1
39,361,361,24,24,0,1,0
31,366,366,47,31,16,2,1
5,367,367,18,1,17,2,1
25,375,375,1,1,0,1,0
0,376,376,7,7,0,1,0
1,385,385,36,21,15,4,3
2,389,389,20,20,0,1,0
33,401,401,53,2,51,4,3
30,408,408,10,10,0,1,0
19,413,413,8,2,6,3,2
35,427,427,9,1,8,2,1
16,433,433,57,57,0,1,0
38,433,433,73,73,0,1,0
8,459,459,30,30,0,1,0
23,466,466,92,92,0,1,0
17,476,476,6,6,0,1,0
9,478,478,88,16,72,3,2
27,482,482,62,62,0,1,0

4,101,101,1,1,0,1,0
44,119,119,3,3,0,1,0
41,121,121,11,3,8,2,1
37,131,131,45,30,15,2,1
39,142,142,32,1,31,2,1
31,162,162,2,2,0,1,0
5,203,203,11,11,0,1,0
16,207,207,50,8,42,3,2
42,220,220,30,30,0,1,0
15,222,222,13,13,0,1,0
13,230,230,5,5,0,1,0
22,233,233,5,5,0,1,0
36,250,250,2,2,0,1,0
33,252,252,9,9,0,1,0
35,263,263,32,28,4,2,1
19,267,267,11,2,9,4,3
18,275,275,1,1,0,1,0
17,279,279,31,19,12,2,1
0,298,298,8,8,0,1,0
38,308,308,20,20,0,1,0
11,312,312,29,29,0,1,0
1,316,316,49,49,0,1,0
32,368,368,5,5,0,1,0
24,380,380,4,1,3,2,1
21,383,383,12,12,0,1,0
10,384,384,36,6,30,4,3
28,387,387,22,2,20,3,2
34,391,391,56,4,52,3,2
7,392,392,12,5,7,2,1
20,403,403,28,2,26,2,1
12,410,410,48,48,0,1,0
8,422,422,44,17,27,2,1
23,422,422,24,11,13,2,1
2,426,426,44,23,21,4,3
9,433,433,2,2,0,1,0
25,452,452,49,49,0,1,0
43,455,455,73,73,0,1,0
30,459,459,80,65,15,2,1
26,459,459,71,43,28,3,2
27,474,474,15,11,4,2,1
3,478,478,6,6,0,1,0
14,483,483,11,11,0,1,0
6,486,486,21,21,0,1,0
40,488,488,16,16,0,1,0
29,500,500,79,79,0,1,0

36,110,110,27,27,0,1,0
12,119,119,35,35,0,1,0
29,121,121,9,9,0,1,0
4,143,143,1,1,0,1,0
20,144,144,18,18,0,1,0
3,153,153,22,13,9,2,1
21,163,163,49,49,0,1,0
22,187,187,48,44,4,2,1
25,209,209,1,1,0,1,0
30,249,249,11,11,0,1,0
27,257,257,12,12,0,1,0
19,264,264,1,1,0,1,0
33,266,266,47,17,30,3,2
1,270,270,34,8,26,2,1
34,291,291,6,6,0,1,0
28,296,296,76,1,75,4,3
7,297,297,10,10,0,1,0
11,312,312,10,5,5,2,1
2,315,315,1,1,0,1,0
5,334,334,10,10,0,1,0
9,336,336,109,13,96,4,3
8,337,337,35,21,14,3,2
32,338,338,17,17,0,1,0
23,357,357,6,6,0,1,0
16,359,359,8,8,0,1,0
26,381,381,22,1,21,4,3
13,386,386,7,7,0,1,0
10,424,424,40,40,0,1,0
37,443,443,31,15,16,3,2
31,443,443,31,17,14,3,2
6,451,451,37,37,0,1,0
14,462,462,38,13,25,2,1
15,462,462,56,56,0,1,0
0,468,468,14,14,0,1,0
38,472,472,32,16,16,2,1
17,477,477,44,8,36,4,3
24,479,479,27,4,23,2,1
18,491,491,16,16,0,1,0
35,495,495,7,7,0,1,0

3,126,126,7,7,0,1,0
33,127,127,5,5,0,1,0
34,128,128,15,11,4,2,1
2,132,132,38,38,0,1,0
15,158,158,6,6,0,1,0
5,179,179,2,2,0,1,0
28,185,185,31,11,20,3,2
12,194,194,25,13,12,2,1
27,214,214,4,4,0,1,0
31,281,281,24,24,0,1,0
0,292,292,1,1,0,1,0
18,300,300,33,6,27,4,3
35,305,305,31,31,0,1,0
9,313,313,94,94,0,1,0
22,313,313,29,18,11,2,1
11,314,314,21,11,10,2,1
16,315,315,15,15,0,1,0
20,320,320,1,1,0,1,0
8,321,321,3,3,0,1,0
13,326,326,21,2,19,2,1
30,336,336,12,12,0,1,0
23,339,339,38,5,33,2,1
25,341,341,10,10,0,1,0
32,346,346,7,4,3,2,1
21,351,351,19,19,0,1,0
26,357,357,77,20,57,4,3
14,364,364,29,29,0,1,0
24,373,373,156,99,57,4,3
7,391,391,41,41,0,1,0
17,398,398,4,4,0,1,0
29,407,407,15,5,10,3,2
4,418,418,77,77,0,1,0
19,421,421,75,75,0,1,0
6,424,424,134,134,0,1,0
1,461,461,32,23,9,2,1
10,468,468,11,11,0,1,0

24,117,117,18,3,15,4,3
6,118,118,2,2,0,1,0
3,120,120,9,9,0,1,0
15,142,142,12,12,0,1,0
9,145,145,32,2,30,4,3
20,147,147,10,10,0,1,0
29,160,160,8,8,0,1,0
19,171,171,4,4,0,1,0
4,182,182,2,2,0,1,0
18,188,188,11,5,6,3,2
10,202,202,11,11,0,1,0
16,224,224,15,4,11,2,1
26,239,239,9,1,8,2,1
8,256,256,12,12,0,1,0
12,311,311,2,2,0,1,0
27,313,313,87,9,78,4,3
7,332,332,198,180,18,4,3
28,334,334,32,32,0,1,0
25,344,344,12,12,0,1,0
0,359,359,18,18,0,1,0
14,368,368,74,59,15,4,3
23,377,377,59,19,40,3,2
1,385,385,8,8,0,1,0
21,395,395,61,61,0,1,0
2,418,418,104,92,12,4,3
5,422,422,56,56,0,1,0
30,431,431,4,4,0,1,0
11,449,449,145,145,0,1,0
13,468,468,8,8,0,1,0
22,486,486,67,10,57,3,2
17,494,494,99,99,0,1,0

7,108,108,19,19,0,1,0
3,111,111,1,1,0,1,0
16,113,113,2,2,0,1,0
32,115,115,19,19,0,1,0
21,125,125,18,2,16,4,3
23,130,130,10,7,3,2,1
31,135,135,6,6,0,1,0
9,147,147,27,12,15,2,1
17,180,180,24,24,0,1,0
4,204,204,9,9,0,1,0
8,205,205,1,1,0,1,0
24,228,228,4,4,0,1,0
27,233,233,12,4,8,3,2
5,244,244,56,42,14,2,1
15,274,274,64,12,52,4,3
0,287,287,70,2,68,3,2
10,289,289,11,11,0,1,0
33,292,292,24,24,0,1,0
14,297,297,7,7,0,1,0
29,343,343,95,95,0,1,0
19,360,360,26,23,3,2,1
13,384,384,15,5,10,3,2
22,388,388,27,18,9,2,1
25,395,395,24,3,21,2,1
12,398,398,41,41,0,1,0
11,408,408,86,86,0,1,0
18,425,425,2,2,0,1,0
28,449,449,39,19,20,2,1
2,455,455,61,35,26,2,1
6,464,464,19,13,6,3,2
20,470,470,82,28,54,4,3
30,487,487,7,4,3,2,1
26,492,492,170,170,0,1,0
1,494,494,44,13,31,3,2

31,116,116,6,6,0,1,0
10,118,118,1,1,0,1,0
36,120,120,18,8,10,3,2
11,120,120,6,1,5,2,1
35,129,129,16,16,0,1,0
4,130,130,28,28,0,1,0
20,135,135,2,2,0,1,0
38,153,153,12,12,0,1,0
21,160,160,49,27,22,3,2
13,175,175,1,1,0,1,0
19,199,199,18,18,0,1,0
8,202,202,11,11,0,1,0
7,213,213,9,1,8,3,2
24,218,218,30,30,0,1,0
40,220,220,2,2,0,1,0
2,236,236,2,2,0,1,0
12,252,252,21,21,0,1,0
15,255,255,24,24,0,1,0
18,258,258,10,2,8,3,2
32,260,260,36,36,0,1,0
0,266,266,12,4,8,3,2
39,268,268,91,66,25,4,3
1,306,306,44,44,0,1,0
26,329,329,13,1,12,3,2
3,350,350,27,27,0,1,0
34,354,354,56,16,40,2,1
23,358,358,67,67,0,1,0
6,369,369,7,1,6,3,2
28,387,387,4,4,0,1,0
27,391,391,21,4,17,2,1
30,406,406,36,36,0,1,0
29,416,416,58,26,32,4,3
33,419,419,34,34,0,1,0
16,431,431,38,8,30,4,3
37,438,438,7,7,0,1,0
25,458,458,67,23,44,2,1
41,460,460,30,30,0,1,0
17,466,466,43,43,0,1,0
9,475,475,24,24,0,1,0
5,479,479,1,1,0,1,0
22,484,484,36,22,14,3,2
14,500,500,4,4,0,1,0

9,101,101,5,5,0,1,0
2,102,102,1,1,0,1,0
27,105,105,4,4,0,1,0
17,108,108,8,3,5,2,1
7,111,111,9,2,7,2,1
21,125,125,40,20,20,3,2
18,156,156,11,11,0,1,0
8,163,163,10,10,0,1,0
19,173,173,27,27,0,1,0
22,217,217,15,1,14,2,1
20,224,224,22,22,0,1,0
13,227,227,7,7,0,1,0
29,227,227,30,22,8,3,2
1,240,240,46,28,18,4,3
14,245,245,10,10,0,1,0
15,255,255,15,15,0,1,0
6,308,308,44,5,39,4,3
3,319,319,121,55,66,4,3
30,347,347,83,6,77,4,3
26,366,366,20,20,0,1,0
0,372,372,45,13,32,2,1
16,379,379,60,10,50,4,3
33,384,384,3,3,0,1,0
5,415,415,7,1,6,2,1
24,419,419,12,3,9,2,1
10,425,425,15,6,9,2,1
32,429,429,13,13,0,1,0
23,430,430,3,3,0,1,0
31,442,442,61,13,48,2,1
11,443,443,46,46,0,1,0
25,449,449,33,24,9,4,3
12,450,450,112,60,52,3,2
28,473,473,73,73,0,1,0
4,479,479,111,68,43,4,3

20,100,100,10,7,3,2,1
13,125,125,13,13,0,1,0
2,128,128,1,1,0,1,0
28,141,141,13,13,0,1,0
12,160,160,1,1,0,1,0
10,163,163,41,20,21,4,3
26,176,176,3,3,0,1,0
11,178,178,15,6,9,2,1
31,191,191,25,3,22,3,2
24,201,201,9,4,5,2,1
22,201,201,58,6,52,3,2
8,212,212,69,69,0,1,0
18,228,228,5,5,0,1,0
29,231,231,4,4,0,1,0
34,248,248,7,7,0,1,0
14,248,248,36,23,13,2,1
30,276,276,12,12,0,1,0
3,299,299,7,7,0,1,0
17,308,308,13,13,0,1,0
32,349,349,53,23,30,4,3
7,352,352,38,38,0,1,0
23,367,367,12,12,0,1,0
27,398,398,57,15,42,4,3
16,408,408,12,5,7,2,1
21,410,410,64,32,32,2,1
15,424,424,106,24,82,3,2
5,433,433,1,1,0,1,0
4,446,446,14,4,10,3,2
6,447,447,2,2,0,1,0
0,455,455,162,126,36,2,1
33,477,477,139,113,26,4,3
1,486,486,16,13,3,2,1
9,489,489,19,19,0,1,0
19,490,490,60,12,48,4,3
25,492,492,60,60,0,1,0

15,103,103,2,2,0,1,0
4,109,109,8,8,0,1,0
22,118,118,6,2,4,2,1
31,120,120,11,11,0,1,0
26,152,152,13,13,0,1,0
11,170,170,15,10,5,2,1
33,198,198,11,1,10,2,1
12,206,206,1,1,0,1,0
34,216,216,23,11,12,3,2
7,233,233,1,1,0,1,0
14,250,250,13,13,0,1,0
23,253,253,9,9,0,1,0
32,257,257,55,41,14,2,1
2,260,260,7,7,0,1,0
21,265,265,27,27,0,1,0
18,277,277,71,71,0,1,0
27,288,288,8,2,6,3,2
0,290,290,30,30,0,1,0
28,296,296,20,4,16,4,3
10,298,298,14,14,0,1,0
5,306,306,19,13,6,3,2
3,314,314,41,41,0,1,0
24,321,321,3,3,0,1,0
16,355,355,46,11,35,2,1
6,387,387,30,2,28,2,1
36,391,391,53,40,13,2,1
25,392,392,46,8,38,3,2
38,398,398,66,6,60,4,3
1,401,401,32,5,27,4,3
8,414,414,1,1,0,1,0
13,419,419,114,9,105,4,3
30,421,421,72,55,17,2,1
29,439,439,84,75,9,4,3
19,470,470,2,2,0,1,0
20,474,474,4,4,0,1,0
9,484,484,81,45,36,4,3
17,488,488,93,93,0,1,0
35,491,491,34,3,31,4,3
37,496,496,65,16,49,2,1

12,127,127,14,7,7,2,1
34,127,127,41,41,0,1,0
23,129,129,21,21,0,1,0
29,136,136,17,17,0,1,0
30,143,143,42,22,20,3,2
26,146,146,3,3,0,1,0
20,153,153,9,3,6,3,2
4,156,156,4,1,3,2,1
10,176,176,1,1,0,1,0
5,178,178,83,83,0,1,0
21,180,180,15,4,11,2,1
14,193,193,1,1,0,1,0
25,197,197,3,3,0,1,0
13,203,203,5,2,3,2,1
18,216,216,9,9,0,1,0
16,221,221,7,7,0,1,0
0,231,231,28,22,6,2,1
3,244,244,7,2,5,2,1
9,257,257,35,25,10,3,2
33,278,278,11,7,4,2,1
32,299,299,13,4,9,4,3
6,303,303,12,12,0,1,0
17,304,304,45,31,14,3,2
7,305,305,34,7,27,4,3
8,314,314,19,19,0,1,0
35,339,339,42,21,21,4,3
19,353,353,49,49,0,1,0
37,356,356,2,2,0,1,0
15,358,358,12,12,0,1,0
2,361,361,41,41,0,1,0
28,370,370,74,74,0,1,0
24,389,389,1,1,0,1,0
22,401,401,60,60,0,1,0
31,416,416,9,9,0,1,0
1,416,416,54,54,0,1,0
11,442,442,13,13,0,1,0
36,449,449,55,55,0,1,0
27,465,465,18,18,0,1,0

21,129,129,11,11,0,1,0
10,131,131,9,9,0,1,0
31,143,143,6,6,0,1,0
11,163,163,8,2,6,3,2
5,171,171,2,2,0,1,0
22,177,177,28,28,0,1,0
19,202,202,3,3,0,1,0
14,208,208,44,6,38,2,1
26,214,214,20,20,0,1,0
32,228,228,53,34,19,2,1
12,230,230,25,5,20,2,1
6,240,240,95,68,27,3,2
25,248,248,30,30,0,1,0
3,259,259,67,67,0,1,0
15,270,270,21,21,0,1,0
23,277,277,7,7,0,1,0
16,285,285,18,6,12,4,3
8,290,290,16,16,0,1,0
30,300,300,8,8,0,1,0
4,328,328,18,18,0,1,0
13,349,349,58,23,35,2,1
20,357,357,114,65,49,2,1
0,391,391,4,4,0,1,0
17,400,400,37,37,0,1,0
24,408,408,5,5,0,1,0
18,420,420,11,3,8,2,1
7,422,422,57,1,56,3,2
27,423,423,3,3,0,1,0
29,424,424,185,177,8,3,2
28,425,425,4,4,0,1,0
1,453,453,35,2,33,4,3
9,455,455,51,9,42,2,1
2,474,474,42,7,35,2,1

15,133,133,4,4,0,1,0
26,133,133,19,13,6,3,2
22,139,139,3,3,0,1,0
2,144,144,15,15,0,1,0
23,145,145,27,27,0,1,0
25,180,180,6,6,0,1,0
12,183,183,55,49,6,2,1
21,183,183,1,1,0,1,0
3,186,186,31,31,0,1,0
6,187,187,9,9,0,1,0
14,214,214,33,12,21,4,3
33,232,232,15,2,13,3,2
5,234,234,2,2,0,1,0
19,247,247,8,8,0,1,0
13,261,261,20,20,0,1,0
24,277,277,23,23,0,1,0
27,284,284,35,35,0,1,0
4,294,294,2,2,0,1,0
35,313,313,42,42,0,1,0
30,321,321,50,50,0,1,0
34,323,323,22,22,0,1,0
8,327,327,18,4,14,3,2
28,330,330,1,1,0,1,0
11,334,334,97,87,10,3,2
9,337,337,18,8,10,3,2
7,345,345,28,28,0,1,0
29,385,385,7,7,0,1,0
0,400,400,20,20,0,1,0
32,418,418,125,109,16,3,2
10,422,422,26,26,0,1,0
31,425,425,130,74,56,3,2
18,433,433,3,3,0,1,0
16,433,433,50,9,41,4,3
1,440,440,41,38,3,2,1
20,481,481,64,64,0,1,0
36,494,494,14,1,13,2,1
17,500,500,49,49,0,1,0

25,109,109,11,1,10,3,2
16,137,137,15,15,0,1,0
4,163,163,10,10,0,1,0
29,174,174,7,7,0,1,0
37,175,175,7,7,0,1,0
11,178,178,2,2,0,1,0
27,179,179,6,6,0,1,0
14,187,187,5,2,3,2,1
33,194,194,13,4,9,2,1
18,207,207,6,6,0,1,0
19,209,209,69,69,0,1,0
0,215,215,1,1,0,1,0
31,215,215,13,4,9,4,3
9,215,215,3,3,0,1,0
39,222,222,1,1,0,1,0
7,222,222,39,19,20,3,2
17,236,236,14,2,12,4,3
28,236,236,19,6,13,2,1
24,242,242,21,21,0,1,0
38,276,276,10,10,0,1,0
26,293,293,25,25,0,1,0
32,295,295,54,43,11,2,1
12,296,296,6,6,0,1,0
30,319,319,6,6,0,1,0
10,329,329,35,8,27,2,1
20,337,337,7,7,0,1,0
2,374,374,30,30,0,1,0
1,394,394,9,9,0,1,0
15,395,395,6,6,0,1,0
3,399,399,66,66,0,1,0
22,403,403,4,4,0,1,0
5,425,425,29,21,8,3,2
34,428,428,29,23,6,3,2
21,451,451,84,84,0,1,0
13,470,470,36,4,32,4,3
35,477,477,232,186,46,2,1
8,485,485,1,1,0,1,0
36,491,491,205,179,26,2,1
23,494,494,15,5,10,2,1
6,497,497,107,107,0,1,0

37,100,100,26,2,24,4,3
3,113,113,1,1,0,1,0
14,114,114,8,8,0,1,0
38,118,118,1,1,0,1,0
18,129,129,3,3,0,1,0
35,131,131,32,21,11,2,1
13,149,149,22,22,0,1,0
24,189,189,16,16,0,1,0
10,194,194,1,1,0,1,0
22,195,195,2,2,0,1,0
25,200,200,10,5,5,2,1
34,206,206,40,32,8,2,1
9,214,214,13,9,4,2,1
5,250,250,1,1,0,1,0
6,251,251,17,17,0,1,0
0,255,255,36,16,20,2,1
4,257,257,2,2,0,1,0
1,263,263,18,18,0,1,0
29,271,271,52,2,50,2,1
12,279,279,68,68,0,1,0
21,297,297,6,1,5,2,1
30,362,362,44,44,0,1,0
16,394,394,88,88,0,1,0
28,395,395,5,5,0,1,0
40,397,397,81,19,62,3,2
8,400,400,10,10,0,1,0
32,409,409,2,2,0,1,0
31,415,415,47,17,30,2,1
36,415,415,29,22,7,2,1
19,415,415,63,3,60,4,3
27,433,433,23,23,0,1,0
7,435,435,49,49,0,1,0
15,437,437,39,39,0,1,0
20,443,443,4,4,0,1,0
23,453,453,9,9,0,1,0
2,453,453,16,1,15,2,1
11,453,453,45,6,39,4,3
26,468,468,56,56,0,1,0
39,478,478,12,12,0,1,0
33,494,494,31,3,28,3,2
17,498,498,88,64,24,2,1

28,119,119,10,1,9,2,1
32,128,128,8,8,0,1,0
17,130,130,18,3,15,4,3
2,141,141,1,1,0,1,0
7,141,141,14,2,12,4,3
6,143,143,5,2,3,2,1
33,154,154,43,11,32,2,1
25,161,161,5,5,0,1,0
1,173,173,7,7,0,1,0
8,193,193,1,1,0,1,0
16,210,210,1,1,0,1,0
5,216,216,18,13,5,2,1
12,218,218,51,51,0,1,0
34,218,218,52,28,24,3,2
20,224,224,1,1,0,1,0
4,249,249,4,4,0,1,0
13,257,257,27,27,0,1,0
40,260,260,26,26,0,1,0
9,291,291,36,1,35,2,1
21,294,294,6,6,0,1,0
27,296,296,64,52,12,4,3
38,299,299,5,5,0,1,0
19,306,306,35,35,0,1,0
36,312,312,67,20,47,3,2
24,313,313,5,5,0,1,0
26,316,316,6,2,4,2,1
30,320,320,12,4,8,2,1
22,333,333,61,61,0,1,0
35,343,343,15,6,9,4,3
29,360,360,3,3,0,1,0
14,367,367,17,17,0,1,0
15,404,404,24,24,0,1,0
0,411,411,38,38,0,1,0
11,415,415,30,30,0,1,0
10,417,417,50,50,0,1,0
31,449,449,73,56,17,2,1
39,449,449,67,4,63,4,3
3,462,462,71,39,32,3,2
18,466,466,20,20,0,1,0
37,475,475,63,63,0,1,0
23,484,484,9,9,0,1,0

15,110,110,4,1,3,2,1
26,112,112,24,13,11,2,1
9,130,130,12,12,0,1,0
32,133,133,4,4,0,1,0
7,136,136,20,20,0,1,0
23,148,148,11,11,0,1,0
17,169,169,36,33,3,2,1
22,180,180,11,2,9,4,3
19,195,195,30,14,16,2,1
11,201,201,85,61,24,2,1
5,209,209,2,2,0,1,0
16,216,216,2,2,0,1,0
2,257,257,22,5,17,3,2
6,262,262,3,3,0,1,0
4,277,277,48,12,36,3,2
8,278,278,13,1,12,3,2
13,301,301,8,8,0,1,0
12,301,301,6,6,0,1,0
28,313,313,13,13,0,1,0
24,328,328,45,10,35,2,1
10,342,342,124,25,99,4,3
25,399,399,17,17,0,1,0
21,400,400,18,18,0,1,0
27,422,422,19,19,0,1,0
1,429,429,30,17,13,2,1
14,432,432,64,58,6,3,2
30,433,433,138,94,44,2,1
29,441,441,52,43,9,2,1
18,451,451,44,20,24,2,1
3,475,475,16,2,14,2,1
31,478,478,12,12,0,1,0
20,483,483,88,40,48,4,3
0,498,498,75,27,48,3,2

21,109,109,8,2,6,3,2
17,114,114,20,20,0,1,0
33,116,116,3,3,0,1,0
12,119,119,21,21,0,1,0
5,120,120,2,2,0,1,0
11,138,138,16,16,0,1,0
24,142,142,14,2,12,2,1
35,151,151,10,10,0,1,0
23,157,157,19,4,15,4,3
38,174,174,28,28,0,1,0
1,190,190,13,5,8,2,1
25,196,196,6,6,0,1,0
4,210,210,17,17,0,1,0
18,218,218,5,1,4,2,1
27,228,228,45,5,40,3,2
28,230,230,5,5,0,1,0
10,239,239,69,69,0,1,0
32,268,268,6,3,3,2,1
3,282,282,12,12,0,1,0
2,292,292,5,5,0,1,0
19,297,297,3,3,0,1,0
16,313,313,64,64,0,1,0
39,349,349,1,1,0,1,0
20,350,350,39,23,16,2,1
13,357,357,42,42,0,1,0
6,377,377,2,2,0,1,0
8,382,382,16,2,14,2,1
9,384,384,10,10,0,1,0
37,387,387,2,2,0,1,0
36,391,391,72,24,48,4,3
14,403,403,47,43,4,2,1
30,409,409,14,1,13,3,2
0,420,420,17,17,0,1,0
31,427,427,91,91,0,1,0
29,439,439,79,33,46,2,1
15,464,464,13,2,11,2,1
22,466,466,74,65,9,4,3
26,473,473,79,19,60,4,3
34,493,493,72,34,38,2,1
7,498,498,10,4,6,2,1

23,105,105,31,31,0,1,0
25,105,105,1,1,0,1,0
4,121,121,25,25,0,1,0
15,131,131,9,9,0,1,0
27,150,150,24,21,3,2,1
20,164,164,28,28,0,1,0
28,170,170,1,1,0,1,0
22,217,217,10,10,0,1,0
30,253,253,24,24,0,1,0
2,257,257,37,5,32,2,1
19,266,266,16,16,0,1,0
29,281,281,169,113,56,3,2
7,282,282,28,28,0,1,0
11,284,284,39,31,8,2,1
5,310,310,21,10,11,4,3
0,310,310,7,2,5,2,1
6,311,311,166,86,80,3,2
10,313,313,10,4,6,3,2
16,345,345,4,4,0,1,0
17,356,356,15,7,8,2,1
8,386,386,14,14,0,1,0
1,394,394,9,9,0,1,0
18,402,402,3,3,0,1,0
9,408,408,50,5,45,4,3
13,435,435,30,16,14,2,1
21,453,453,53,53,0,1,0
24,487,487,6,6,0,1,0
26,490,490,10,3,7,2,1
12,492,492,131,81,50,4,3
3,497,497,55,55,0,1,0
14,499,499,21,14,7,2,1

10,116,116,27,15,12,3,2
18,154,154,6,6,0,1,0
2,157,157,4,1,3,2,1
22,171,171,3,3,0,1,0
36,181,181,87,54,33,4,3
23,197,197,7,7,0,1,0
20,205,205,51,51,0,1,0
29,209,209,24,24,0,1,0
19,223,223,19,8,11,2,1
8,226,226,37,14,23,2,1
13,245,245,9,2,7,2,1
27,247,247,33,24,9,2,1
30,248,248,15,11,4,2,1
26,250,250,39,10,29,2,1
6,269,269,18,12,6,2,1
5,281,281,1,1,0,1,0
17,282,282,1,1,0,1,0
21,295,295,2,2,0,1,0
9,302,302,2,2,0,1,0
37,320,320,2,2,0,1,0
28,326,326,55,15,40,2,1
15,328,328,24,15,9,2,1
33,347,347,1,1,0,1,0
14,348,348,131,119,12,3,2
31,356,356,29,8,21,3,2
11,361,361,82,13,69,4,3
35,371,371,23,3,20,2,1
0,375,375,2,2,0,1,0
1,380,380,40,3,37,4,3
4,382,382,8,5,3,2,1
32,407,407,18,10,8,3,2
25,419,419,3,3,0,1,0
34,420,420,54,54,0,1,0
16,436,436,78,61,17,2,1
3,438,438,17,17,0,1,0
12,463,463,26,26,0,1,0
24,482,482,36,2,34,2,1
7,493,493,27,17,10,2,1

6,108,108,5,5,0,1,0
18,123,123,1,1,0,1,0
14,134,134,6,6,0,1,0
15,134,134,5,5,0,1,0
4,139,139,16,8,8,3,2
5,139,139,2,2,0,1,0
21,142,142,39,30,9,4,3
10,143,143,29,9,20,3,2
36,153,153,13,13,0,1,0
39,164,164,3,3,0,1,0
16,174,174,29,22,7,2,1
37,175,175,3,3,0,1,0
12,181,181,2,2,0,1,0
33,205,205,5,5,0,1,0
31,207,207,42,14,28,3,2
1,237,237,8,8,0,1,0
0,238,238,7,7,0,1,0
38,242,242,3,3,0,1,0
11,259,259,21,21,0,1,0
8,281,281,38,8,30,3,2
34,282,282,52,52,0,1,0
25,286,286,147,99,48,4,3
35,296,296,51,13,38,3,2
30,297,297,8,8,0,1,0
26,338,338,6,6,0,1,0
28,359,359,13,13,0,1,0
32,360,360,14,6,8,2,1
22,360,360,90,58,32,3,2
24,368,368,36,36,0,1,0
20,394,394,58,58,0,1,0
17,416,416,9,1,8,3,2
19,424,424,27,27,0,1,0
2,424,424,27,27,0,1,0
7,430,430,44,21,23,4,3
29,436,436,2,2,0,1,0
9,479,479,5,2,3,2,1
13,483,483,53,53,0,1,0
3,492,492,40,28,12,2,1
23,497,497,10,1,9,2,1
27,500,500,58,13,45,4,3

11,108,108,6,6,0,1,0
32,117,117,7,7,0,1,0
25,120,120,2,2,0,1,0
1,125,125,17,14,3,2,1
36,131,131,1,1,0,1,0
5,143,143,17,8,9,4,3
34,184,184,2,2,0,1,0
38,188,188,8,3,5,2,1
16,212,212,19,3,16,3,2
6,235,235,2,2,0,1,0
12,239,239,14,14,0,1,0
15,252,252,55,55,0,1,0
24,270,270,62,6,56,3,2
21,282,282,28,19,9,3,2
23,295,295,16,16,0,1,0
13,300,300,87,63,24,4,3
0,324,324,52,52,0,1,0
26,330,330,3,3,0,1,0
9,335,335,5,5,0,1,0
18,335,335,13,13,0,1,0
20,364,364,31,31,0,1,0
28,368,368,120,99,21,2,1
30,379,379,4,4,0,1,0
10,384,384,43,23,20,3,2
19,408,408,44,26,18,4,3
22,414,414,12,12,0,1,0
8,417,417,10,2,8,2,1
2,419,419,21,21,0,1,0
29,420,420,9,5,4,2,1
17,427,427,13,1,12,3,2
3,428,428,58,58,0,1,0
4,438,438,1,1,0,1,0
7,438,438,13,13,0,1,0
31,456,456,16,16,0,1,0
27,466,466,183,183,0,1,0
35,466,466,5,1,4,2,1
14,472,472,16,8,8,3,2
37,489,489,181,181,0,1,0
33,493,493,49,49,0,1,0

24,100,100,15,15,0,1,0
7,156,156,13,2,11,2,1
27,157,157,7,7,0,1,0
14,168,168,10,10,0,1,0
11,169,169,12,12,0,1,0
29,179,179,8,8,0,1,0
10,208,208,21,6,15,4,3
23,209,209,17,5,12,2,1
8,217,217,35,23,12,4,3
5,223,223,8,8,0,1,0
28,228,228,11,11,0,1,0
9,230,230,24,24,0,1,0
2,233,233,118,118,0,1,0
18,244,244,16,16,0,1,0
13,284,284,14,8,6,2,1
30,285,285,129,129,0,1,0
16,286,286,49,49,0,1,0
4,319,319,57,7,50,2,1
21,322,322,55,24,31,2,1
12,338,338,62,12,50,2,1
19,342,342,16,16,0,1,0
22,362,362,19,6,13,2,1
26,371,371,55,55,0,1,0
6,374,374,11,11,0,1,0
20,405,405,22,8,14,2,1
33,411,411,28,20,8,2,1
1,434,434,15,6,9,2,1
32,438,438,4,4,0,1,0
17,450,450,31,1,30,2,1
0,452,452,20,20,0,1,0
15,471,471,47,47,0,1,0
31,480,480,16,16,0,1,0
3,485,485,29,29,0,1,0
25,496,496,61,23,38,3,2

6,101,101,4,4,0,1,0
1,106,106,9,1,8,3,2
13,120,120,17,17,0,1,0
23,153,153,5,1,4,2,1
22,157,157,12,12,0,1,0
4,163,163,15,2,13,4,3
2,170,170,53,20,33,2,1
21,180,180,71,59,12,4,3
5,210,210,38,38,0,1,0
17,235,235,14,6,8,2,1
15,246,246,1,1,0,1,0
11,248,248,54,19,35,4,3
14,275,275,9,9,0,1,0
16,276,276,6,6,0,1,0
7,280,280,29,29,0,1,0
9,282,282,83,23,60,3,2
26,298,298,29,29,0,1,0
10,301,301,3,3,0,1,0
24,307,307,75,75,0,1,0
8,323,323,5,2,3,2,1
0,374,374,195,130,65,4,3
19,409,409,1,1,0,1,0
27,426,426,7,7,0,1,0
12,431,431,39,39,0,1,0
20,432,432,61,61,0,1,0
3,449,449,71,71,0,1,0
25,473,473,42,30,12,2,1
18,488,488,75,36,39,4,3

7,101,101,1,1,0,1,0
34,120,120,5,5,0,1,0
40,158,158,37,37,0,1,0
35,159,159,4,4,0,1,0
18,163,163,7,7,0,1,0
36,189,189,91,91,0,1,0
3,191,191,107,37,70,3,2
26,194,194,11,5,6,2,1
25,204,204,35,17,18,2,1
10,212,212,6,6,0,1,0
13,238,238,27,18,9,2,1
17,245,245,5,5,0,1,0
6,251,251,17,17,0,1,0
23,251,251,24,20,4,2,1
31,263,263,4,4,0,1,0
14,270,270,8,2,6,2,1
39,293,293,30,30,0,1,0
20,314,314,2,2,0,1,0
24,314,314,51,5,46,4,3
4,314,314,7,2,5,2,1
12,315,315,63,63,0,1,0
38,321,321,20,13,7,2,1
33,332,332,4,4,0,1,0
21,338,338,30,3,27,4,3
1,341,341,2,2,0,1,0
27,349,349,20,20,0,1,0
30,361,361,4,1,3,2,1
5,370,370,5,5,0,1,0
41,381,381,22,22,0,1,0
22,381,381,30,30,0,1,0
0,381,381,7,7,0,1,0
19,387,387,21,16,5,2,1
37,392,392,17,17,0,1,0
16,393,393,6,6,0,1,0
9,410,410,24,18,6,2,1
32,412,412,30,6,24,3,2
29,418,418,20,20,0,1,0
8,429,429,18,10,8,2,1
15,433,433,9,9,0,1,0
2,468,468,14,2,12,3,2
28,488,488,90,24,66,3,2
11,499,499,90,80,10,2,1

27,131,131,2,2,0,1,0
0,141,141,42,42,0,1,0
32,153,153,1,1,0,1,0
33,154,154,4,4,0,1,0
4,159,159,10,1,9,4,3
31,178,178,24,24,0,1,0
24,181,181,6,6,0,1,0
16,209,209,35,35,0,1,0
11,229,229,2,2,0,1,0
26,235,235,20,20,0,1,0
2,236,236,10,10,0,1,0
34,247,247,22,4,18,3,2
18,262,262,4,4,0,1,0
14,290,290,30,21,9,4,3
29,297,297,32,12,20,3,2
30,303,303,38,3,35,2,1
28,312,312,36,20,16,2,1
10,322,322,62,25,37,2,1
21,323,323,8,1,7,2,1
23,344,344,82,82,0,1,0
17,357,357,35,23,12,3,2
9,380,380,87,55,32,4,3
25,385,385,13,7,6,3,2
20,388,388,258,258,0,1,0
3,404,404,18,1,17,2,1
5,407,407,7,7,0,1,0
1,440,440,66,24,42,4,3
8,444,444,45,45,0,1,0
7,453,453,65,36,29,2,1
35,461,461,21,21,0,1,0
19,475,475,4,4,0,1,0
22,480,480,33,10,23,2,1
12,483,483,33,28,5,2,1
15,485,485,14,14,0,1,0
6,495,495,22,22,0,1,0
13,499,499,1,1,0,1,0

26,104,104,5,5,0,1,0
3,121,121,9,2,7,2,1
20,131,131,13,7,6,3,2
4,133,133,12,12,0,1,0
17,147,147,15,15,0,1,0
7,153,153,37,29,8,3,2
37,154,154,29,29,0,1,0
6,159,159,2,2,0,1,0
31,159,159,31,31,0,1,0
12,161,161,8,2,6,2,1
33,162,162,47,47,0,1,0
36,164,164,2,2,0,1,0
11,196,196,6,6,0,1,0
8,207,207,1,1,0,1,0
14,237,237,27,5,22,3,2
0,243,243,1,1,0,1,0
34,248,248,10,2,8,3,2
16,259,259,32,32,0,1,0
29,266,266,44,44,0,1,0
9,271,271,37,37,0,1,0
23,277,277,2,2,0,1,0
19,287,287,14,14,0,1,0
10,304,304,36,36,0,1,0
2,324,324,45,45,0,1,0
28,328,328,22,22,0,1,0
18,329,329,19,5,14,3,2
30,348,348,7,7,0,1,0
25,363,363,26,26,0,1,0
1,363,363,2,2,0,1,0
5,369,369,25,21,4,2,1
22,393,393,7,2,5,2,1
24,409,409,13,13,0,1,0
13,440,440,19,2,17,2,1
15,459,459,155,131,24,3,2
21,477,477,118,104,14,3,2
35,477,477,16,16,0,1,0
27,478,478,68,14,54,4,3
32,492,492,84,21,63,4,3

7,101,101,11,3,8,2,1
0,109,109,4,1,3,2,1
3,136,136,19,14,5,2,1
11,137,137,4,4,0,1,0
31,151,151,19,19,0,1,0
33,155,155,11,7,4,2,1
5,171,171,18,18,0,1,0
21,176,176,4,4,0,1,0
13,179,179,17,17,0,1,0
8,192,192,85,44,41,4,3
4,225,225,1,1,0,1,0
29,233,233,25,25,0,1,0
14,248,248,6,6,0,1,0
32,266,266,4,4,0,1,0
26,266,266,44,44,0,1,0
20,280,280,6,1,5,2,1
28,310,310,97,82,15,4,3
9,343,343,20,8,12,4,3
27,343,343,1,1,0,1,0
17,348,348,36,3,33,2,1
2,353,353,14,14,0,1,0
6,355,355,107,107,0,1,0
22,374,374,29,29,0,1,0
16,378,378,20,2,18,3,2
23,389,389,40,40,0,1,0
10,395,395,35,30,5,2,1
19,396,396,20,20,0,1,0
24,405,405,6,6,0,1,0
1,405,405,37,17,20,2,1
18,407,407,134,14,120,4,3
25,411,411,85,85,0,1,0
30,423,423,18,18,0,1,0
15,449,449,87,19,68,3,2
12,473,473,20,11,9,2,1

23,130,130,7,7,0,1,0
31,132,132,6,6,0,1,0
6,132,132,2,2,0,1,0
32,140,140,25,19,6,2,1
21,145,145,5,2,3,2,1
30,164,164,1,1,0,1,0
27,176,176,37,37,0,1,0
2,186,186,12,4,8,2,1
29,217,217,31,13,18,2,1
16,218,218,43,7,36,4,3
18,221,221,1,1,0,1,0
3,246,246,13,1,12,3,2
14,247,247,38,38,0,1,0
25,251,251,37,7,30,2,1
24,262,262,37,37,0,1,0
33,264,264,6,2,4,2,1
8,298,298,34,34,0,1,0
11,301,301,4,4,0,1,0
22,312,312,31,22,9,2,1
15,329,329,43,1,42,2,1
9,341,341,31,31,0,1,0
37,356,356,37,17,20,2,1
34,374,374,4,4,0,1,0
5,375,375,4,4,0,1,0
17,376,376,49,49,0,1,0
13,383,383,21,21,0,1,0
12,401,401,4,1,3,2,1
35,406,406,47,47,0,1,0
28,409,409,8,8,0,1,0
26,410,410,60,60,0,1,0
10,430,430,27,27,0,1,0
1,445,445,22,22,0,1,0
36,445,445,63,57,6,3,2
4,455,455,71,31,40,4,3
0,457,457,69,42,27,4,3
7,469,469,128,44,84,4,3
20,487,487,99,99,0,1,0
19,492,492,32,32,0,1,0

12,111,111,1,1,0,1,0
4,115,115,23,23,0,1,0
14,122,122,5,1,4,2,1
15,138,138,13,4,9,4,3
13,138,138,19,19,0,1,0
16,139,139,22,22,0,1,0
20,152,152,3,3,0,1,0
30,162,162,9,9,0,1,0
34,167,167,13,13,0,1,0
2,210,210,53,11,42,4,3
31,211,211,44,8,36,4,3
17,224,224,5,5,0,1,0
0,225,225,11,1,10,4,3
3,235,235,8,2,6,3,2
19,236,236,7,7,0,1,0
35,241,241,8,3,5,2,1
32,265,265,12,2,10,2,1
21,285,285,11,11,0,1,0
11,286,286,9,9,0,1,0
28,295,295,84,42,42,4,3
29,307,307,7,7,0,1,0
9,313,313,2,2,0,1,0
8,319,319,74,4,70,4,3
22,331,331,13,3,10,2,1
24,336,336,3,3,0,1,0
5,353,353,28,1,27,3,2
25,377,377,22,16,6,3,2
37,381,381,2,2,0,1,0
10,408,408,18,18,0,1,0
33,412,412,54,44,10,2,1
27,416,416,42,9,33,4,3
36,423,423,107,50,57,4,3
38,454,454,136,136,0,1,0
26,462,462,62,62,0,1,0
23,465,465,15,3,12,3,2
7,465,465,25,21,4,2,1
18,474,474,12,7,5,2,1
1,479,479,66,66,0,1,0
6,481,481,71,35,36,4,3

36,109,109,22,10,12,2,1
14,118,118,1,1,0,1,0
0,120,120,1,1,0,1,0
9,139,139,23,16,7,2,1
30,158,158,10,10,0,1,0
5,174,174,7,7,0,1,0
32,181,181,72,72,0,1,0
28,184,184,8,8,0,1,0
23,191,191,1,1,0,1,0
8,195,195,55,19,36,3,2
29,205,205,12,8,4,2,1
4,208,208,40,40,0,1,0
3,234,234,24,24,0,1,0
25,234,234,27,1,26,3,2
35,235,235,16,8,8,3,2
10,258,258,30,1,29,4,3
26,261,261,33,21,12,3,2
17,286,286,2,2,0,1,0
33,290,290,40,25,15,2,1
21,291,291,50,50,0,1,0
7,305,305,1,1,0,1,0
37,321,321,6,6,0,1,0
16,328,328,12,5,7,2,1
34,352,352,16,1,15,4,3
11,368,368,47,47,0,1,0
2,375,375,1,1,0,1,0
19,396,396,7,7,0,1,0
6,400,400,12,1,11,2,1
18,407,407,70,40,30,2,1
15,414,414,2,2,0,1,0
22,415,415,25,25,0,1,0
31,428,428,14,14,0,1,0
1,439,439,15,15,0,1,0
13,450,450,76,76,0,1,0
20,453,453,61,61,0,1,0
12,468,468,131,131,0,1,0
24,470,470,8,2,6,3,2
27,479,479,71,16,55,3,2

5,134,134,28,10,18,2,1
8,150,150,41,29,12,2,1
1,157,157,27,27,0,1,0
18,161,161,27,3,24,4,3
7,162,162,1,1,0,1,0
11,171,171,9,9,0,1,0
15,172,172,12,12,0,1,0
31,186,186,1,1,0,1,0
3,204,204,32,8,24,2,1
20,207,207,24,24,0,1,0
6,228,228,1,1,0,1,0
21,233,233,53,5,48,4,3
35,251,251,9,2,7,2,1
29,256,256,1,1,0,1,0
28,280,280,2,2,0,1,0
4,283,283,55,55,0,1,0
9,288,288,1,1,0,1,0
24,302,302,18,18,0,1,0
2,305,305,1,1,0,1,0
13,313,313,5,5,0,1,0
32,327,327,27,27,0,1,0
34,336,336,65,65,0,1,0
25,349,349,112,7,105,4,3
19,355,355,71,71,0,1,0
14,361,361,17,11,6,2,1
30,367,367,9,2,7,2,1
27,401,401,15,2,13,2,1
12,402,402,90,32,58,4,3
23,417,417,64,64,0,1,0
0,422,422,121,121,0,1,0
16,462,462,7,7,0,1,0
26,471,471,65,65,0,1,0
17,473,473,14,14,0,1,0
10,474,474,18,18,0,1,0
33,483,483,27,6,21,2,1
22,497,497,1,1,0,1,0

20,128,128,5,5,0,1,0
22,131,131,25,25,0,1,0
25,131,131,21,4,17,3,2
30,143,143,10,10,0,1,0
23,145,145,10,10,0,1,0
11,162,162,10,10,0,1,0
18,170,170,20,14,6,2,1
29,173,173,21,21,0,1,0
32,179,179,3,3,0,1,0
26,186,186,16,16,0,1,0
19,190,190,16,16,0,1,0
15,191,191,18,18,0,1,0
24,198,198,9,2,7,2,1
5,228,228,23,17,6,2,1
21,232,232,46,16,30,2,1
10,233,233,39,7,32,3,2
0,256,256,32,32,0,1,0
12,265,265,65,65,0,1,0
7,265,265,60,60,0,1,0
4,266,266,25,1,24,2,1
17,271,271,44,44,0,1,0
27,291,291,2,2,0,1,0
14,326,326,62,19,43,2,1
28,328,328,8,8,0,1,0
3,339,339,18,18,0,1,0
6,361,361,3,3,0,1,0
9,408,408,22,22,0,1,0
13,420,420,74,74,0,1,0
8,438,438,31,31,0,1,0
31,455,455,16,16,0,1,0
33,458,458,136,136,0,1,0
2,467,467,49,49,0,1,0
16,492,492,53,53,0,1,0
1,495,495,16,4,12,2,1

11,107,107,10,10,0,1,0
9,115,115,1,1,0,1,0
21,161,161,27,27,0,1,0
23,193,193,7,7,0,1,0
7,201,201,1,1,0,1,0
28,204,204,5,1,4,2,1
6,213,213,17,17,0,1,0
27,215,215,31,13,18,4,3
25,220,220,17,7,10,2,1
4,221,221,2,2,0,1,0
13,267,267,22,22,0,1,0
20,275,275,41,41,0,1,0
19,300,300,8,8,0,1,0
29,302,302,73,73,0,1,0
2,310,310,30,30,0,1,0
15,343,343,1,1,0,1,0
18,347,347,56,41,15,4,3
24,348,348,11,5,6,2,1
1,348,348,6,1,5,2,1
26,354,354,31,3,28,3,2
17,357,357,7,1,6,3,2
3,374,374,85,85,0,1,0
14,386,386,60,2,58,3,2
16,400,400,125,24,101,4,3
8,432,432,30,14,16,3,2
10,455,455,75,62,13,2,1
0,472,472,471,362,109,4,3
22,482,482,17,4,13,2,1
12,496,496,40,40,0,1,0
5,497,497,16,16,0,1,0

7,109,109,9,9,0,1,0
12,114,114,6,6,0,1,0
0,169,169,3,3,0,1,0
4,170,170,1,1,0,1,0
25,181,181,49,45,4,2,1
30,189,189,15,1,14,3,2
16,199,199,8,2,6,3,2
6,210,210,9,6,3,2,1
14,213,213,37,13,24,3,2
17,216,216,1,1,0,1,0
1,231,231,15,15,0,1,0
35,232,232,37,9,28,3,2
22,235,235,27,27,0,1,0
36,242,242,13,8,5,2,1
31,246,246,5,5,0,1,0
24,255,255,28,11,17,2,1
38,295,295,84,84,0,1,0
2,295,295,10,10,0,1,0
5,304,304,117,102,15,4,3
27,307,307,4,4,0,1,0
21,313,313,16,16,0,1,0
11,320,320,69,69,0,1,0
23,330,330,6,2,4,2,1
37,348,348,8,2,6,3,2
8,350,350,3,3,0,1,0
33,360,360,26,26,0,1,0
9,370,370,21,12,9,2,1
3,382,382,21,5,16,2,1
32,382,382,85,1,84,3,2
20,399,399,80,68,12,4,3
26,413,413,12,1,11,2,1
15,419,419,45,12,33,2,1
19,441,441,2,2,0,1,0
29,443,443,53,9,44,2,1
18,458,458,57,57,0,1,0
13,476,476,8,8,0,1,0
28,495,495,38,38,0,1,0
10,497,497,54,51,3,2,1
34,500,500,55,55,0,1,0

20,107,107,20,16,4,2,1
0,138,138,1,1,0,1,0
9,191,191,12,12,0,1,0
26,193,193,61,11,50,2,1
17,194,194,8,8,0,1,0
1,237,237,14,14,0,1,0
31,252,252,1,1,0,1,0
10,252,252,143,139,4,2,1
14,256,256,14,5,9,4,3
30,302,302,12,12,0,1,0
22,324,324,22,17,5,2,1
11,331,331,81,60,21,4,3
25,340,340,35,35,0,1,0
27,344,344,9,1,8,3,2
18,377,377,29,29,0,1,0
13,394,394,90,60,30,4,3
4,395,395,110,81,29,4,3
19,398,398,50,32,18,4,3
16,401,401,140,140,0,1,0
5,402,402,9,9,0,1,0
6,410,410,52,18,34,2,1
3,420,420,10,4,6,3,2
8,447,447,49,49,0,1,0
24,449,449,7,7,0,1,0
23,450,450,42,30,12,4,3
2,450,450,18,18,0,1,0
29,456,456,38,38,0,1,0
12,472,472,9,3,6,3,2
28,472,472,69,55,14,3,2
15,473,473,6,6,0,1,0
7,484,484,5,5,0,1,0
21,498,498,46,26,20,3,2

24,122,122,7,1,6,3,2
5,126,126,1,1,0,1,0
30,148,148,68,68,0,1,0
7,163,163,7,3,4,2,1
4,174,174,16,16,0,1,0
6,185,185,25,19,6,3,2
28,203,203,8,8,0,1,0
15,231,231,2,2,0,1,0
27,233,233,23,23,0,1,0
8,243,243,180,180,0,1,0
20,251,251,13,13,0,1,0
17,254,254,18,18,0,1,0
3,255,255,27,27,0,1,0
0,263,263,50,27,23,2,1
22,271,271,8,2,6,2,1
26,272,272,12,12,0,1,0
1,272,272,1,1,0,1,0
18,289,289,96,47,49,2,1
14,297,297,46,34,12,2,1
21,301,301,74,7,67,4,3
9,329,329,12,8,4,2,1
23,341,341,35,11,24,2,1
13,359,359,113,113,0,1,0
25,365,365,1,1,0,1,0
31,376,376,47,47,0,1,0
10,389,389,14,14,0,1,0
12,401,401,33,17,16,2,1
19,428,428,5,5,0,1,0
29,429,429,2,2,0,1,0
2,449,449,2,2,0,1,0
16,470,470,1,1,0,1,0
11,482,482,4,1,3,2,1

19,110,110,7,7,0,1,0
36,129,129,1,1,0,1,0
6,131,131,8,8,0,1,0
25,134,134,2,2,0,1,0
26,164,164,27,27,0,1,0
33,168,168,30,21,9,4,3
16,201,201,2,2,0,1,0
29,218,218,25,10,15,2,1
18,232,232,4,1,3,2,1
37,236,236,43,43,0,1,0
3,241,241,47,4,43,4,3
10,286,286,107,59,48,4,3
5,293,293,18,5,13,2,1
11,316,316,33,24,9,2,1
7,344,344,4,4,0,1,0
34,345,345,1,1,0,1,0
17,353,353,6,6,0,1,0
21,356,356,113,44,69,4,3
30,359,359,12,12,0,1,0
39,376,376,13,10,3,2,1
8,388,388,19,19,0,1,0
38,393,393,18,18,0,1,0
12,394,394,8,3,5,2,1
15,394,394,1,1,0,1,0
22,410,410,89,61,28,2,1
2,414,414,47,47,0,1,0
28,415,415,8,2,6,2,1
1,424,424,10,10,0,1,0
27,431,431,110,110,0,1,0
24,437,437,58,22,36,3,2
20,437,437,18,18,0,1,0
13,463,463,24,24,0,1,0
32,472,472,98,98,0,1,0
23,476,476,79,17,62,3,2
35,478,478,15,6,9,2,1
4,480,480,41,31,10,3,2
9,481,481,10,1,9,3,2
14,483,483,44,44,0,1,0
31,493,493,12,12,0,1,0
0,495,495,34,34,0,1,0

34,109,109,1,1,0,1,0
10,119,119,3,3,0,1,0
9,124,124,30,30,0,1,0
2,124,124,5,2,3,2,1
15,127,127,18,18,0,1,0
36,138,138,4,4,0,1,0
37,141,141,27,27,0,1,0
32,170,170,23,5,18,3,2
22,175,175,22,5,17,2,1
26,180,180,33,33,0,1,0
33,207,207,8,8,0,1,0
25,211,211,21,21,0,1,0
3,220,220,9,9,0,1,0
13,221,221,3,3,0,1,0
14,226,226,7,4,3,2,1
7,244,244,10,2,8,3,2
35,252,252,24,24,0,1,0
1,282,282,45,45,0,1,0
6,286,286,71,52,19,2,1
27,287,287,65,25,40,2,1
30,335,335,16,16,0,1,0
23,343,343,31,1,30,3,2
0,355,355,61,45,16,2,1
21,356,356,12,12,0,1,0
17,359,359,61,20,41,2,1
20,363,363,73,22,51,4,3
11,364,364,34,9,25,3,2
19,374,374,4,4,0,1,0
28,389,389,35,3,32,3,2
12,410,410,16,16,0,1,0
24,413,413,7,7,0,1,0
5,421,421,47,47,0,1,0
29,433,433,13,13,0,1,0
18,434,434,33,23,10,3,2
31,435,435,81,60,21,4,3
16,440,440,10,10,0,1,0
8,459,459,53,53,0,1,0
4,484,484,3,3,0,1,0

13,114,114,8,8,0,1,0
10,117,117,8,8,0,1,0
18,130,130,1,1,0,1,0
32,138,138,7,7,0,1,0
19,142,142,7,2,5,2,1
9,152,152,25,19,6,2,1
6,180,180,21,13,8,2,1
16,184,184,11,11,0,1,0
29,213,213,4,4,0,1,0
4,218,218,27,27,0,1,0
23,230,230,95,64,31,2,1
14,240,240,14,14,0,1,0
21,240,240,33,10,23,2,1
3,262,262,2,2,0,1,0
17,280,280,104,104,0,1,0
12,281,281,70,70,0,1,0
26,286,286,14,14,0,1,0
11,316,316,18,18,0,1,0
5,331,331,6,3,3,2,1
31,354,354,103,33,70,3,2
1,361,361,23,23,0,1,0
15,367,367,72,72,0,1,0
7,375,375,76,13,63,4,3
27,380,380,35,35,0,1,0
25,395,395,34,34,0,1,0
33,401,401,29,4,25,2,1
30,413,413,7,3,4,2,1
24,426,426,11,11,0,1,0
28,434,434,8,8,0,1,0
34,436,436,31,6,25,2,1
22,442,442,22,16,6,2,1
0,471,471,120,120,0,1,0
20,478,478,3,3,0,1,0
2,479,479,12,3,9,2,1
8,491,491,33,33,0,1,0

8,118,118,28,28,0,1,0
26,123,123,3,3,0,1,0
24,126,126,5,5,0,1,0
23,142,142,3,3,0,1,0
10,154,154,18,18,0,1,0
22,154,154,13,7,6,3,2
7,159,159,39,39,0,1,0
5,164,164,16,9,7,2,1
30,170,170,32,8,24,3,2
4,230,230,19,19,0,1,0
0,236,236,14,14,0,1,0
11,273,273,1,1,0,1,0
34,278,278,9,3,6,2,1
35,290,290,9,3,6,3,2
3,290,290,5,5,0,1,0
18,301,301,35,15,20,3,2
12,304,304,14,14,0,1,0
14,306,306,2,2,0,1,0
2,309,309,16,6,10,3,2
13,314,314,53,53,0,1,0
6,318,318,26,26,0,1,0
20,320,320,23,23,0,1,0
28,322,322,36,13,23,4,3
25,328,328,66,54,12,2,1
31,334,334,35,35,0,1,0
17,339,339,36,27,9,4,3
29,351,351,117,44,73,4,3
16,410,410,45,45,0,1,0
9,420,420,11,11,0,1,0
21,432,432,106,106,0,1,0
15,452,452,56,18,38,3,2
1,458,458,101,101,0,1,0
32,467,467,15,8,7,3,2
33,474,474,17,3,14,3,2
19,477,477,21,21,0,1,0
27,500,500,59,29,30,4,3

7,118,118,1,1,0,1,0
12,119,119,8,8,0,1,0
23,132,132,7,1,6,3,2
16,138,138,11,11,0,1,0
29,139,139,7,7,0,1,0
13,139,139,5,1,4,2,1
28,165,165,1,1,0,1,0
3,175,175,19,3,16,3,2
17,190,190,7,7,0,1,0
20,192,192,1,1,0,1,0
6,202,202,21,7,14,3,2
11,204,204,20,13,7,2,1
24,214,214,24,14,10,2,1
18,239,239,28,28,0,1,0
19,242,242,83,38,45,2,1
10,243,243,38,17,21,2,1
5,266,266,11,3,8,3,2
4,307,307,68,68,0,1,0
2,314,314,35,35,0,1,0
8,339,339,1,1,0,1,0
14,366,366,98,98,0,1,0
27,366,366,11,11,0,1,0
0,368,368,83,49,34,3,2
31,374,374,6,1,5,2,1
15,376,376,6,6,0,1,0
9,396,396,239,140,99,4,3
25,397,397,110,63,47,2,1
21,417,417,22,10,12,4,3
26,439,439,58,12,46,2,1
1,489,489,9,9,0,1,0
30,494,494,19,19,0,1,0
22,497,497,94,60,34,2,1

6,111,111,1,1,0,1,0
27,116,116,26,26,0,1,0
32,118,118,14,5,9,2,1
2,143,143,14,9,5,2,1
5,152,152,6,6,0,1,0
3,157,157,15,15,0,1,0
24,176,176,20,4,16,2,1
34,190,190,12,5,7,2,1
4,196,196,3,3,0,1,0
12,205,205,17,17,0,1,0
23,213,213,1,1,0,1,0
37,225,225,1,1,0,1,0
17,232,232,24,9,15,4,3
29,262,262,1,1,0,1,0
11,262,262,1,1,0,1,0
10,277,277,26,4,22,2,1
8,283,283,73,73,0,1,0
25,285,285,24,24,0,1,0
21,298,298,18,5,13,2,1
26,299,299,12,5,7,2,1
22,318,318,22,9,13,2,1
30,324,324,139,81,58,4,3
16,327,327,14,14,0,1,0
0,353,353,7,1,6,2,1
36,370,370,39,39,0,1,0
18,372,372,1,1,0,1,0
13,381,381,152,152,0,1,0
20,398,398,1,1,0,1,0
38,400,400,32,32,0,1,0
14,405,405,33,33,0,1,0
15,405,405,14,8,6,3,2
28,446,446,13,13,0,1,0
1,447,447,29,8,21,4,3
19,453,453,117,117,0,1,0
35,461,461,32,14,18,4,3
7,476,476,25,25,0,1,0
31,485,485,126,126,0,1,0
9,489,489,21,7,14,3,2
33,496,496,40,40,0,1,0

0,104,104,1,1,0,1,0
21,117,117,1,1,0,1,0
41,124,124,4,4,0,1,0
22,130,130,3,3,0,1,0
2,131,131,14,14,0,1,0
11,143,143,7,7,0,1,0
20,168,168,50,27,23,4,3
38,172,172,15,15,0,1,0
28,178,178,14,10,4,2,1
44,212,212,1,1,0,1,0
45,216,216,3,3,0,1,0
10,219,219,2,2,0,1,0
9,219,219,7,1,6,2,1
19,222,222,23,23,0,1,0
17,245,245,1,1,0,1,0
3,250,250,5,5,0,1,0
31,252,252,2,2,0,1,0
34,266,266,14,14,0,1,0
18,292,292,25,2,23,4,3
25,298,298,32,27,5,2,1
4,303,303,18,18,0,1,0
26,315,315,14,14,0,1,0
37,329,329,114,6,108,4,3
43,330,330,40,17,23,2,1
39,330,330,43,43,0,1,0
29,336,336,76,54,22,3,2
32,342,342,30,21,9,2,1
30,354,354,37,1,36,4,3
36,364,364,29,22,7,2,1
33,367,367,16,3,13,2,1
6,378,378,5,5,0,1,0
23,381,381,7,7,0,1,0
14,392,392,31,5,26,2,1
12,396,396,47,23,24,3,2
27,404,404,11,11,0,1,0
16,409,409,30,30,0,1,0
8,413,413,5,1,4,2,1
13,415,415,40,34,6,2,1
5,443,443,8,8,0,1,0
1,445,445,1,1,0,1,0
7,446,446,68,32,36,3,2
40,449,449,60,60,0,1,0
15,475,475,102,75,27,4,3
35,477,477,126,108,18,4,3
42,488,488,8,8,0,1,0
24,500,500,8,8,0,1,0

2,111,111,1,1,0,1,0
37,116,116,1,1,0,1,0
26,123,123,5,1,4,2,1
19,128,128,2,2,0,1,0
0,131,131,6,6,0,1,0
15,145,145,23,3,20,2,1
25,150,150,2,2,0,1,0
13,173,173,26,17,9,2,1
31,198,198,14,14,0,1,0
8,201,201,24,14,10,2,1
32,203,203,10,10,0,1,0
12,211,211,14,6,8,2,1
16,228,228,4,4,0,1,0
7,231,231,19,19,0,1,0
39,238,238,73,3,70,3,2
3,271,271,1,1,0,1,0
36,277,277,17,9,8,3,2
20,291,291,33,21,12,2,1
1,305,305,2,2,0,1,0
38,318,318,15,3,12,4,3
24,325,325,25,25,0,1,0
10,354,354,37,37,0,1,0
6,377,377,13,4,9,2,1
4,391,391,84,84,0,1,0
5,392,392,20,20,0,1,0
11,393,393,65,39,26,2,1
21,405,405,25,1,24,4,3
14,411,411,50,50,0,1,0
33,419,419,14,5,9,2,1
23,426,426,37,14,23,2,1
18,440,440,19,19,0,1,0
27,442,442,14,14,0,1,0
22,443,443,12,4,8,2,1
29,447,447,74,18,56,3,2
35,459,459,127,52,75,4,3
34,466,466,103,80,23,2,1
30,472,472,141,129,12,4,3
17,472,472,28,23,5,2,1
9,485,485,76,54,22,3,2
28,489,489,10,10,0,1,0

42,102,102,1,1,0,1,0
38,105,105,13,4,9,2,1
0,117,117,5,5,0,1,0
41,118,118,2,2,0,1,0
15,121,121,2,2,0,1,0
8,139,139,5,5,0,1,0
1,145,145,19,19,0,1,0
28,145,145,18,8,10,3,2
35,146,146,16,4,12,3,2
13,160,160,5,2,3,2,1
30,168,168,2,2,0,1,0
20,171,171,13,13,0,1,0
21,173,173,3,3,0,1,0
27,185,185,2,2,0,1,0
40,205,205,4,4,0,1,0
5,211,211,21,21,0,1,0
12,270,270,59,33,26,2,1
22,291,291,1,1,0,1,0
26,291,291,2,2,0,1,0
17,293,293,2,2,0,1,0
7,296,296,17,17,0,1,0
25,309,309,4,4,0,1,0
10,312,312,5,2,3,2,1
33,319,319,58,58,0,1,0
23,330,330,36,36,0,1,0
37,334,334,3,3,0,1,0
6,340,340,34,4,30,2,1
31,357,357,78,78,0,1,0
36,362,362,115,63,52,3,2
44,362,362,7,4,3,2,1
43,373,373,7,7,0,1,0
14,375,375,1,1,0,1,0
24,377,377,5,5,0,1,0
4,380,380,161,161,0,1,0
3,391,391,16,1,15,4,3
11,418,418,34,34,0,1,0
18,437,437,1,1,0,1,0
32,443,443,21,12,9,2,1
39,443,443,190,146,44,4,3
19,451,451,26,5,21,4,3
29,452,452,26,26,0,1,0
34,455,455,56,56,0,1,0
16,474,474,22,22,0,1,0
2,479,479,49,49,0,1,0
9,500,500,25,7,18,4,3

35,121,121,2,2,0,1,0
8,126,126,1,1,0,1,0
31,136,136,16,1,15,4,3
24,141,141,18,8,10,2,1
17,145,145,12,12,0,1,0
27,162,162,35,35,0,1,0
38,169,169,11,2,9,2,1
26,195,195,17,17,0,1,0
37,196,196,3,3,0,1,0
30,199,199,6,6,0,1,0
15,199,199,32,6,26,3,2
9,207,207,24,24,0,1,0
12,211,211,2,2,0,1,0
6,216,216,27,27,0,1,0
3,217,217,21,9,12,2,1
11,218,218,19,4,15,2,1
10,220,220,7,7,0,1,0
18,221,221,28,2,26,3,2
4,245,245,111,23,88,3,2
39,248,248,83,83,0,1,0
13,249,249,13,13,0,1,0
14,253,253,5,5,0,1,0
29,268,268,5,5,0,1,0
20,286,286,1,1,0,1,0
40,307,307,5,5,0,1,0
7,331,331,5,5,0,1,0
32,333,333,23,7,16,3,2
33,333,333,153,65,88,4,3
0,343,343,19,19,0,1,0
25,347,347,42,3,39,4,3
16,377,377,1,1,0,1,0
5,379,379,48,12,36,2,1
28,418,418,4,4,0,1,0
34,421,421,2,2,0,1,0
36,430,430,43,23,20,4,3
21,436,436,1,1,0,1,0
22,448,448,8,8,0,1,0
2,455,455,75,11,64,3,2
19,455,455,16,8,8,2,1
1,482,482,4,1,3,2,1
23,491,491,14,14,0,1,0

1,123,123,21,1,20,2,1
12,126,126,36,13,23,2,1
7,127,127,5,5,0,1,0
21,141,141,25,25,0,1,0
30,144,144,11,7,4,2,1
25,149,149,27,27,0,1,0
17,156,156,12,4,8,2,1
5,202,202,25,25,0,1,0
14,213,213,42,42,0,1,0
10,215,215,41,9,32,3,2
11,224,224,7,7,0,1,0
29,231,231,4,4,0,1,0
27,261,261,36,36,0,1,0
28,269,269,1,1,0,1,0
16,282,282,21,21,0,1,0
2,287,287,36,20,16,4,3
20,313,313,2,2,0,1,0
13,316,316,7,7,0,1,0
8,321,321,9,9,0,1,0
34,324,324,8,8,0,1,0
18,345,345,39,39,0,1,0
26,345,345,114,76,38,2,1
31,346,346,4,4,0,1,0
9,350,350,18,18,0,1,0
4,373,373,42,42,0,1,0
24,436,436,15,15,0,1,0
32,436,436,17,17,0,1,0
0,441,441,47,47,0,1,0
22,447,447,132,102,30,4,3
23,449,449,15,15,0,1,0
19,449,449,40,40,0,1,0
33,452,452,81,45,36,2,1
3,462,462,12,6,6,3,2
6,472,472,22,22,0,1,0
15,478,478,81,81,0,1,0

12,116,116,6,6,0,1,0
6,133,133,5,5,0,1,0
21,138,138,2,2,0,1,0
9,161,161,3,3,0,1,0
10,163,163,1,1,0,1,0
19,173,173,1,1,0,1,0
18,197,197,19,2,17,4,3
3,213,213,4,4,0,1,0
25,216,216,13,6,7,2,1
30,244,244,1,1,0,1,0
15,253,253,6,6,0,1,0
1,253,253,28,22,6,2,1
16,254,254,45,45,0,1,0
7,263,263,22,22,0,1,0
13,265,265,9,9,0,1,0
31,265,265,33,27,6,2,1
0,267,267,17,3,14,2,1
23,268,268,21,7,14,2,1
27,284,284,10,2,8,2,1
17,294,294,47,47,0,1,0
20,305,305,34,8,26,2,1
36,318,318,14,2,12,2,1
35,325,325,139,110,29,2,1
2,330,330,122,94,28,4,3
4,344,344,20,2,18,2,1
34,350,350,55,11,44,2,1
26,368,368,20,20,0,1,0
28,368,368,1,1,0,1,0
8,417,417,21,14,7,2,1
32,422,422,69,36,33,2,1
22,428,428,18,14,4,2,1
11,449,449,24,24,0,1,0
24,455,455,21,21,0,1,0
14,467,467,159,153,6,3,2
29,483,483,153,123,30,4,3
33,489,489,72,56,16,2,1
5,491,491,25,25,0,1,0

26,102,102,15,3,12,4,3
34,119,119,19,19,0,1,0
24,139,139,12,12,0,1,0
9,145,145,10,10,0,1,0
6,148,148,5,5,0,1,0
23,148,148,1,1,0,1,0
18,157,157,3,3,0,1,0
20,176,176,12,12,0,1,0
3,193,193,22,1,21,4,3
13,193,193,17,17,0,1,0
31,196,196,15,15,0,1,0
33,201,201,11,11,0,1,0
27,211,211,44,44,0,1,0
22,222,222,18,15,3,2,1
15,228,228,83,83,0,1,0
2,232,232,63,63,0,1,0
32,238,238,20,20,0,1,0
25,243,243,49,7,42,4,3
7,254,254,17,17,0,1,0
19,281,281,59,59,0,1,0
30,282,282,11,11,0,1,0
35,294,294,27,27,0,1,0
8,306,306,8,8,0,1,0
5,338,338,5,5,0,1,0
11,338,338,29,29,0,1,0
14,387,387,27,19,8,3,2
1,404,404,10,5,5,2,1
0,405,405,70,4,66,3,2
4,420,420,44,44,0,1,0
10,422,422,101,101,0,1,0
29,430,430,70,10,60,4,3
17,441,441,6,6,0,1,0
28,453,453,13,5,8,3,2
16,456,456,5,5,0,1,0
21,462,462,53,53,0,1,0
12,484,484,15,15,0,1,0

21,101,101,8,8,0,1,0
1,110,110,8,8,0,1,0
23,128,128,3,3,0,1,0
32,131,131,3,3,0,1,0
30,136,136,28,21,7,2,1
22,170,170,10,5,5,2,1
19,185,185,31,4,27,2,1
4,198,198,1,1,0,1,0
14,201,201,31,31,0,1,0
16,211,211,25,25,0,1,0
13,228,228,9,9,0,1,0
26,235,235,1,1,0,1,0
12,244,244,10,4,6,3,2
24,249,249,19,19,0,1,0
33,256,256,21,9,12,3,2
25,259,259,33,13,20,4,3
10,271,271,27,27,0,1,0
3,273,273,33,33,0,1,0
18,302,302,11,11,0,1,0
9,320,320,70,70,0,1,0
6,321,321,67,1,66,4,3
34,325,325,39,6,33,3,2
27,327,327,62,62,0,1,0
7,338,338,8,4,4,2,1
28,351,351,40,40,0,1,0
15,359,359,42,2,40,4,3
5,366,366,17,9,8,2,1
2,393,393,19,9,10,2,1
20,418,418,45,45,0,1,0
11,428,428,191,167,24,2,1
0,440,440,9,9,0,1,0
29,447,447,139,52,87,4,3
8,462,462,10,4,6,2,1
31,496,496,49,3,46,3,2
17,498,498,8,8,0,1,0

37,100,100,19,15,4,2,1
18,100,100,3,3,0,1,0
27,126,126,6,6,0,1,0
28,145,145,9,4,5,2,1
12,148,148,21,12,9,2,1
7,192,192,5,5,0,1,0
20,197,197,7,7,0,1,0
13,221,221,4,1,3,2,1
15,235,235,75,15,60,4,3
3,237,237,1,1,0,1,0
31,242,242,13,13,0,1,0
24,253,253,102,16,86,4,3
8,261,261,1,1,0,1,0
16,268,268,38,38,0,1,0
5,275,275,70,22,48,4,3
9,286,286,5,5,0,1,0
22,295,295,14,14,0,1,0
38,296,296,11,2,9,2,1
1,299,299,5,5,0,1,0
2,304,304,63,1,62,3,2
19,332,332,19,3,16,3,2
36,338,338,6,6,0,1,0
0,344,344,9,9,0,1,0
11,363,363,8,2,6,3,2
17,367,367,71,31,40,3,2
30,370,370,107,74,33,4,3
6,380,380,40,7,33,2,1
34,380,380,33,33,0,1,0
14,402,402,27,7,20,2,1
25,426,426,15,15,0,1,0
21,426,426,89,89,0,1,0
29,438,438,10,7,3,2,1
35,450,450,15,15,0,1,0
26,461,461,23,20,3,2,1
10,466,466,38,1,37,4,3
23,474,474,37,4,33,2,1
33,479,479,64,64,0,1,0
32,480,480,14,14,0,1,0
4,483,483,15,15,0,1,0

4,123,123,8,2,6,2,1
28,145,145,24,24,0,1,0
14,148,148,2,2,0,1,0
6,159,159,19,19,0,1,0
16,184,184,35,35,0,1,0
9,208,208,3,3,0,1,0
12,210,210,10,10,0,1,0
17,220,220,22,18,4,2,1
18,221,221,9,9,0,1,0
0,224,224,110,66,44,3,2
25,245,245,42,42,0,1,0
1,268,268,17,5,12,3,2
15,270,270,100,14,86,3,2
19,290,290,3,3,0,1,0
8,291,291,109,85,24,4,3
22,301,301,17,17,0,1,0
11,311,311,83,83,0,1,0
30,316,316,35,9,26,2,1
10,320,320,19,19,0,1,0
27,329,329,14,14,0,1,0
26,336,336,7,1,6,3,2
2,363,363,46,16,30,2,1
3,363,363,1,1,0,1,0
13,372,372,33,33,0,1,0
24,373,373,31,1,30,2,1
29,405,405,62,62,0,1,0
20,424,424,23,23,0,1,0
5,430,430,72,43,29,2,1
23,433,433,62,62,0,1,0
7,469,469,2,2,0,1,0
21,475,475,6,6,0,1,0

26,102,102,9,9,0,1,0
14,112,112,9,9,0,1,0
8,195,195,51,51,0,1,0
30,195,195,22,1,21,2,1
7,197,197,52,40,12,4,3
20,224,224,35,21,14,3,2
13,234,234,1,1,0,1,0
2,241,241,87,87,0,1,0
25,263,263,56,56,0,1,0
0,264,264,24,18,6,2,1
29,287,287,19,19,0,1,0
17,322,322,13,13,0,1,0
12,326,326,26,26,0,1,0
21,328,328,17,10,7,2,1
18,331,331,34,25,9,4,3
9,334,334,19,11,8,2,1
24,334,334,107,107,0,1,0
1,342,342,97,58,39,4,3
22,345,345,81,56,25,3,2
6,373,373,79,40,39,4,3
27,375,375,14,4,10,3,2
23,387,387,52,52,0,1,0
19,390,390,18,18,0,1,0
5,391,391,1,1,0,1,0
3,392,392,29,29,0,1,0
28,421,421,23,23,0,1,0
10,425,425,27,27,0,1,0
11,442,442,13,3,10,3,2
4,470,470,10,4,6,3,2
16,474,474,12,6,6,3,2
15,478,478,32,6,26,2,1

26,113,113,12,12,0,1,0
31,115,115,21,21,0,1,0
11,116,116,3,3,0,1,0
18,141,141,28,9,19,2,1
22,148,148,43,16,27,2,1
23,163,163,4,4,0,1,0
5,174,174,39,39,0,1,0
7,181,181,62,18,44,3,2
13,203,203,29,10,19,2,1
24,211,211,12,12,0,1,0
12,212,212,25,25,0,1,0
10,220,220,9,9,0,1,0
6,242,242,40,40,0,1,0
29,248,248,27,27,0,1,0
21,251,251,18,18,0,1,0
8,262,262,31,31,0,1,0
15,269,269,51,51,0,1,0
19,279,279,21,21,0,1,0
1,282,282,5,5,0,1,0
27,308,308,16,11,5,2,1
17,312,312,2,2,0,1,0
0,325,325,9,5,4,2,1
30,327,327,21,21,0,1,0
2,328,328,28,28,0,1,0
3,341,341,71,61,10,3,2
14,360,360,88,88,0,1,0
4,364,364,84,80,4,2,1
16,365,365,10,10,0,1,0
25,370,370,7,3,4,2,1
20,394,394,38,38,0,1,0
28,408,408,11,2,9,2,1
9,500,500,27,11,16,2,1

26,104,104,3,3,0,1,0
0,104,104,19,1,18,3,2
32,111,111,22,22,0,1,0
31,136,136,14,14,0,1,0
23,142,142,20,20,0,1,0
24,148,148,2,2,0,1,0
28,155,155,6,2,4,2,1
42,158,158,4,4,0,1,0
19,158,158,11,11,0,1,0
13,192,192,1,1,0,1,0
27,192,192,25,25,0,1,0
25,215,215,25,22,3,2,1
17,223,223,39,26,13,2,1
37,227,227,19,9,10,3,2
30,233,233,8,5,3,2,1
12,238,238,32,9,23,2,1
9,242,242,2,2,0,1,0
15,267,267,14,6,8,3,2
34,272,272,30,7,23,2,1
20,286,286,17,17,0,1,0
18,286,286,6,6,0,1,0
22,287,287,27,27,0,1,0
11,288,288,10,3,7,2,1
41,289,289,48,48,0,1,0
10,293,293,44,44,0,1,0
21,325,325,30,30,0,1,0
8,332,332,1,1,0,1,0
36,341,341,75,40,35,2,1
3,344,344,113,86,27,4,3
1,347,347,6,6,0,1,0
35,363,363,19,2,17,2,1
2,365,365,30,18,12,4,3
14,375,375,9,5,4,2,1
5,377,377,5,2,3,2,1
40,403,403,28,28,0,1,0
6,421,421,1,1,0,1,0
39,421,421,25,22,3,2,1
29,443,443,25,13,12,4,3
33,451,451,5,5,0,1,0
16,462,462,10,4,6,3,2
7,462,462,10,10,0,1,0
38,483,483,163,106,57,4,3
4,487,487,26,14,12,4,3

28,106,106,35,35,0,1,0
36,115,115,9,4,5,2,1
29,116,116,1,1,0,1,0
5,119,119,2,2,0,1,0
25,125,125,8,8,0,1,0
8,139,139,40,12,28,2,1
31,162,162,3,3,0,1,0
15,202,202,2,2,0,1,0
2,205,205,51,51,0,1,0
0,206,206,11,5,6,3,2
14,209,209,74,59,15,2,1
20,231,231,10,10,0,1,0
16,248,248,9,3,6,3,2
4,253,253,1,1,0,1,0
34,253,253,12,3,9,2,1
3,257,257,11,2,9,4,3
24,264,264,51,3,48,4,3
33,277,277,79,18,61,3,2
21,279,279,42,5,37,4,3
13,291,291,5,5,0,1,0
6,296,296,9,1,8,2,1
27,298,298,1,1,0,1,0
38,307,307,15,15,0,1,0
1,331,331,18,2,16,2,1
9,335,335,47,11,36,4,3
12,347,347,1,1,0,1,0
11,351,351,78,39,39,2,1
37,393,393,46,46,0,1,0
32,395,395,89,89,0,1,0
26,408,408,22,22,0,1,0
18,411,411,5,5,0,1,0
10,423,423,2,2,0,1,0
22,464,464,27,27,0,1,0
23,471,471,56,14,42,4,3
17,471,471,9,9,0,1,0
7,472,472,52,18,34,3,2
30,476,476,2,2,0,1,0
19,486,486,45,45,0,1,0
35,498,498,16,7,9,2,1

38,111,111,14,7,7,2,1
22,144,144,11,11,0,1,0
39,159,159,39,24,15,4,3
3,162,162,33,9,24,2,1
31,164,164,18,3,15,4,3
21,191,191,5,5,0,1,0
37,193,193,8,8,0,1,0
29,221,221,56,42,14,2,1
9,240,240,22,14,8,2,1
32,240,240,5,5,0,1,0
36,248,248,19,19,0,1,0
33,249,249,12,12,0,1,0
15,251,251,21,16,5,2,1
11,256,256,21,21,0,1,0
10,256,256,2,2,0,1,0
26,273,273,1,1,0,1,0
27,275,275,21,15,6,3,2
4,277,277,16,16,0,1,0
19,284,284,1,1,0,1,0
8,315,315,35,13,22,3,2
25,317,317,1,1,0,1,0
12,320,320,47,3,44,2,1
40,332,332,28,28,0,1,0
7,332,332,10,10,0,1,0
0,334,334,47,35,12,3,2
2,339,339,13,1,12,2,1
5,352,352,34,34,0,1,0
14,357,357,54,40,14,2,1
1,363,363,9,6,3,2,1
30,367,367,9,9,0,1,0
43,378,378,53,53,0,1,0
13,385,385,7,7,0,1,0
18,400,400,14,6,8,2,1
28,412,412,21,21,0,1,0
42,412,412,58,58,0,1,0
35,439,439,26,26,0,1,0
24,447,447,21,21,0,1,0
16,451,451,11,11,0,1,0
20,452,452,19,4,15,2,1
23,455,455,6,6,0,1,0
17,460,460,1,1,0,1,0
34,473,473,136,136,0,1,0
41,481,481,21,21,0,1,0
6,499,499,122,33,89,4,3

25,108,108,2,2,0,1,0
17,132,132,36,36,0,1,0
5,135,135,19,14,5,2,1
12,137,137,1,1,0,1,0
38,137,137,3,3,0,1,0
18,146,146,8,8,0,1,0
2,149,149,6,6,0,1,0
26,163,163,57,57,0,1,0
22,168,168,3,3,0,1,0
35,173,173,7,7,0,1,0
20,183,183,47,47,0,1,0
0,203,203,1,1,0,1,0
39,226,226,7,4,3,2,1
31,234,234,21,9,12,4,3
30,236,236,11,11,0,1,0
8,236,236,33,25,8,3,2
28,256,256,36,36,0,1,0
6,256,256,33,27,6,3,2
36,257,257,23,3,20,3,2
34,261,261,49,37,12,3,2
21,269,269,81,63,18,3,2
4,276,276,5,1,4,2,1
15,287,287,3,3,0,1,0
24,307,307,46,16,30,3,2
33,317,317,42,30,12,3,2
13,322,322,32,32,0,1,0
19,323,323,8,4,4,2,1
23,363,363,14,1,13,2,1
29,365,365,9,9,0,1,0
11,385,385,5,5,0,1,0
14,385,385,10,10,0,1,0
3,393,393,3,3,0,1,0
9,409,409,10,10,0,1,0
27,416,416,91,91,0,1,0
7,417,417,49,49,0,1,0
1,423,423,14,2,12,4,3
41,459,459,28,28,0,1,0
16,474,474,7,7,0,1,0
32,475,475,80,80,0,1,0
10,478,478,4,4,0,1,0
37,495,495,4,4,0,1,0
40,500,500,28,19,9,2,1

6,102,102,2,2,0,1,0
23,109,109,32,32,0,1,0
8,119,119,21,18,3,2,1
31,120,120,5,5,0,1,0
29,160,160,38,8,30,3,2
9,181,181,14,14,0,1,0
25,187,187,9,3,6,2,1
27,192,192,5,5,0,1,0
13,196,196,13,5,8,2,1
33,216,216,44,30,14,2,1
7,224,224,12,12,0,1,0
14,226,226,1,1,0,1,0
4,248,248,2,2,0,1,0
3,248,248,45,45,0,1,0
16,253,253,37,37,0,1,0
5,270,270,24,4,20,3,2
20,270,270,27,27,0,1,0
22,282,282,31,15,16,4,3
10,283,283,26,12,14,2,1
11,294,294,17,17,0,1,0
32,297,297,44,2,42,4,3
0,309,309,15,15,0,1,0
26,321,321,8,2,6,3,2
34,330,330,1,1,0,1,0
17,336,336,7,7,0,1,0
15,340,340,172,160,12,4,3
30,351,351,7,1,6,2,1
2,353,353,8,8,0,1,0
21,356,356,46,43,3,2,1
28,367,367,1,1,0,1,0
12,393,393,10,10,0,1,0
24,397,397,23,23,0,1,0
1,414,414,94,78,16,4,3
18,449,449,162,12,150,4,3
19,492,492,4,1,3,2,1

14,120,120,2,2,0,1,0
13,123,123,29,29,0,1,0
27,146,146,13,13,0,1,0
16,162,162,19,14,5,2,1
32,163,163,2,2,0,1,0
33,165,165,6,6,0,1,0
29,166,166,73,54,19,2,1
6,169,169,4,4,0,1,0
17,171,171,4,4,0,1,0
12,224,224,60,60,0,1,0
21,224,224,16,16,0,1,0
24,228,228,1,1,0,1,0
1,253,253,9,9,0,1,0
20,267,267,8,8,0,1,0
30,268,268,11,11,0,1,0
22,269,269,36,1,35,2,1
19,296,296,13,13,0,1,0
5,302,302,26,26,0,1,0
15,312,312,16,16,0,1,0
34,317,317,53,53,0,1,0
4,326,326,33,33,0,1,0
3,339,339,31,19,12,4,3
31,348,348,11,1,10,2,1
8,365,365,42,34,8,2,1
0,369,369,74,28,46,3,2
9,376,376,28,20,8,2,1
10,383,383,106,106,0,1,0
11,388,388,1,1,0,1,0
2,409,409,27,18,9,4,3
35,428,428,71,71,0,1,0
7,433,433,2,2,0,1,0
23,434,434,4,4,0,1,0
25,441,441,72,72,0,1,0
36,459,459,15,1,14,3,2
26,479,479,138,104,34,2,1
28,494,494,36,36,0,1,0
18,499,499,5,5,0,1,0

4,110,110,19,11,8,3,2
10,112,112,2,2,0,1,0
8,112,112,1,1,0,1,0
5,114,114,2,2,0,1,0
0,129,129,42,42,0,1,0
6,129,129,14,14,0,1,0
37,138,138,4,4,0,1,0
20,182,182,13,4,9,4,3
26,183,183,16,16,0,1,0
7,190,190,4,4,0,1,0
18,197,197,16,16,0,1,0
29,208,208,4,4,0,1,0
11,210,210,5,5,0,1,0
12,213,213,16,9,7,2,1
14,225,225,108,90,18,3,2
25,239,239,19,2,17,2,1
27,246,246,4,1,3,2,1
38,252,252,13,13,0,1,0
1,259,259,5,5,0,1,0
33,301,301,18,18,0,1,0
36,303,303,36,36,0,1,0
21,329,329,1,1,0,1,0
28,348,348,113,21,92,4,3
22,360,360,16,16,0,1,0
9,372,372,40,16,24,4,3
35,386,386,9,9,0,1,0
2,396,396,3,3,0,1,0
30,405,405,95,75,20,2,1
3,406,406,46,46,0,1,0
23,412,412,75,67,8,3,2
32,434,434,122,80,42,3,2
13,437,437,17,17,0,1,0
17,438,438,6,1,5,2,1
19,444,444,33,33,0,1,0
34,458,458,56,32,24,4,3
15,459,459,2,2,0,1,0
31,480,480,18,6,12,4,3
16,487,487,9,9,0,1,0
24,492,492,56,56,0,1,0

26,112,112,4,1,3,2,1
0,113,113,20,12,8,3,2
14,125,125,5,5,0,1,0
3,135,135,3,3,0,1,0
4,149,149,2,2,0,1,0
23,161,161,21,21,0,1,0
11,166,166,6,6,0,1,0
21,184,184,3,3,0,1,0
31,188,188,26,6,20,3,2
18,222,222,15,15,0,1,0
19,234,234,16,16,0,1,0
9,236,236,5,5,0,1,0
34,246,246,69,27,42,3,2
15,257,257,19,1,18,4,3
25,259,259,207,195,12,3,2
2,284,284,60,20,40,4,3
5,286,286,7,1,6,2,1
24,306,306,13,13,0,1,0
20,308,308,7,7,0,1,0
33,313,313,15,15,0,1,0
29,313,313,16,6,10,2,1
22,337,337,20,3,17,3,2
28,339,339,7,1,6,3,2
16,349,349,78,74,4,2,1
30,356,356,2,2,0,1,0
36,368,368,9,5,4,2,1
35,386,386,13,5,8,3,2
8,400,400,2,2,0,1,0
10,417,417,15,7,8,3,2
27,448,448,9,3,6,3,2
7,452,452,120,99,21,4,3
32,462,462,16,8,8,3,2
13,465,465,47,47,0,1,0
6,466,466,51,51,0,1,0
12,476,476,34,13,21,4,3
1,481,481,138,138,0,1,0
17,482,482,8,8,0,1,0

5,118,118,39,17,22,3,2
0,119,119,38,38,0,1,0
28,141,141,28,10,18,3,2
12,157,157,1,1,0,1,0
14,181,181,34,34,0,1,0
35,186,186,9,9,0,1,0
2,187,187,49,23,26,2,1
13,190,190,1,1,0,1,0
17,197,197,32,32,0,1,0
18,220,220,5,5,0,1,0
34,222,222,22,22,0,1,0
21,245,245,6,6,0,1,0
1,254,254,13,5,8,3,2
27,265,265,54,54,0,1,0
22,268,268,1,1,0,1,0
30,283,283,10,4,6,3,2
20,283,283,20,20,0,1,0
15,286,286,27,13,14,4,3
29,295,295,87,1,86,3,2
32,303,303,17,9,8,3,2
6,333,333,8,8,0,1,0
3,344,344,43,25,18,4,3
31,357,357,25,25,0,1,0
16,365,365,9,9,0,1,0
8,366,366,8,2,6,2,1
19,383,383,22,22,0,1,0
33,383,383,19,5,14,2,1
23,390,390,8,8,0,1,0
11,401,401,19,10,9,2,1
10,404,404,17,17,0,1,0
26,437,437,133,63,70,3,2
4,456,456,1,1,0,1,0
24,465,465,74,74,0,1,0
25,471,471,51,51,0,1,0
7,472,472,31,3,28,2,1
9,488,488,14,14,0,1,0

25,102,102,2,2,0,1,0
0,115,115,29,29,0,1,0
17,159,159,18,8,10,3,2
15,162,162,13,13,0,1,0
30,163,163,1,1,0,1,0
22,178,178,49,23,26,3,2
11,189,189,13,5,8,3,2
3,191,191,12,12,0,1,0
13,206,206,7,2,5,2,1
10,214,214,62,44,18,2,1
18,231,231,22,6,16,3,2
19,233,233,1,1,0,1,0
33,233,233,14,5,9,2,1
31,239,239,41,25,16,3,2
2,244,244,14,5,9,4,3
6,247,247,13,13,0,1,0
24,254,254,33,33,0,1,0
21,255,255,80,80,0,1,0
8,271,271,1,1,0,1,0
37,293,293,4,4,0,1,0
20,304,304,73,73,0,1,0
35,309,309,10,10,0,1,0
36,315,315,61,61,0,1,0
16,317,317,39,20,19,4,3
4,344,344,4,1,3,2,1
34,354,354,56,56,0,1,0
23,361,361,40,40,0,1,0
7,379,379,29,29,0,1,0
28,380,380,3,3,0,1,0
14,384,384,6,6,0,1,0
27,399,399,29,29,0,1,0
5,407,407,4,4,0,1,0
26,438,438,3,3,0,1,0
29,451,451,7,7,0,1,0
32,451,451,6,6,0,1,0
1,451,451,48,26,22,2,1
9,476,476,7,7,0,1,0
12,486,486,161,89,72,3,2

2,107,107,13,6,7,2,1
29,117,117,4,1,3,2,1
12,137,137,2,2,0,1,0
13,140,140,5,5,0,1,0
28,166,166,23,8,15,4,3
0,174,174,17,17,0,1,0
10,199,199,45,27,18,3,2
20,208,208,50,50,0,1,0
17,225,225,5,5,0,1,0
33,232,232,1,1,0,1,0
14,245,245,1,1,0,1,0
22,247,247,2,2,0,1,0
25,265,265,82,34,48,2,1
5,272,272,33,33,0,1,0
3,287,287,15,5,10,2,1
16,292,292,11,11,0,1,0
18,303,303,5,5,0,1,0
6,360,360,18,18,0,1,0
15,364,364,110,96,14,3,2
30,379,379,57,3,54,4,3
26,382,382,2,2,0,1,0
21,389,389,40,4,36,4,3
7,392,392,80,80,0,1,0
24,395,395,6,6,0,1,0
8,396,396,49,49,0,1,0
32,400,400,38,26,12,2,1
9,414,414,85,4,81,4,3
11,415,415,36,36,0,1,0
31,424,424,19,19,0,1,0
23,443,443,5,5,0,1,0
27,444,444,134,109,25,2,1
4,449,449,11,11,0,1,0
19,468,468,142,53,89,4,3
1,470,470,62,62,0,1,0

6,114,114,2,2,0,1,0
20,118,118,1,1,0,1,0
16,128,128,1,1,0,1,0
0,134,134,12,12,0,1,0
41,146,146,4,4,0,1,0
8,149,149,16,16,0,1,0
24,156,156,23,13,10,3,2
9,159,159,4,4,0,1,0
31,160,160,2,2,0,1,0
29,177,177,59,15,44,3,2
22,179,179,48,39,9,2,1
5,180,180,7,3,4,2,1
4,183,183,49,49,0,1,0
36,183,183,1,1,0,1,0
7,207,207,2,2,0,1,0
1,210,210,3,3,0,1,0
38,221,221,19,4,15,2,1
11,225,225,8,8,0,1,0
35,238,238,7,1,6,2,1
17,242,242,2,2,0,1,0
34,274,274,1,1,0,1,0
37,284,284,20,20,0,1,0
10,304,304,29,29,0,1,0
12,314,314,15,15,0,1,0
15,314,314,17,7,10,3,2
39,332,332,13,5,8,2,1
32,333,333,11,4,7,2,1
14,337,337,17,1,16,3,2
23,357,357,45,45,0,1,0
27,375,375,32,32,0,1,0
40,391,391,24,7,17,4,3
43,395,395,47,35,12,2,1
42,396,396,125,74,51,4,3
25,408,408,28,28,0,1,0
2,415,415,1,1,0,1,0
30,416,416,6,6,0,1,0
13,421,421,16,8,8,3,2
18,429,429,13,13,0,1,0
19,430,430,53,53,0,1,0
3,440,440,29,14,15,4,3
28,446,446,93,5,88,3,2
33,466,466,8,8,0,1,0
26,467,467,171,83,88,3,2
21,485,485,26,3,23,2,1

18,126,126,13,3,10,2,1
28,126,126,35,35,0,1,0
23,132,132,12,12,0,1,0
35,136,136,3,3,0,1,0
36,149,149,17,5,12,4,3
14,158,158,15,3,12,3,2
0,163,163,3,3,0,1,0
11,167,167,9,4,5,2,1
34,177,177,14,6,8,2,1
20,204,204,6,6,0,1,0
10,209,209,3,3,0,1,0
40,230,230,4,4,0,1,0
9,231,231,21,9,12,4,3
26,246,246,9,9,0,1,0
25,249,249,9,5,4,2,1
32,253,253,9,5,4,2,1
33,259,259,6,6,0,1,0
21,263,263,3,3,0,1,0
29,275,275,28,28,0,1,0
37,276,276,40,4,36,3,2
8,277,277,17,9,8,2,1
17,278,278,18,18,0,1,0
12,306,306,1,1,0,1,0
22,309,309,33,33,0,1,0
42,320,320,25,25,0,1,0
44,321,321,8,1,7,3,2
41,330,330,47,47,0,1,0
39,339,339,54,20,34,2,1
3,344,344,66,24,42,4,3
27,346,346,28,9,19,2,1
2,354,354,25,25,0,1,0
13,372,372,1,1,0,1,0
7,406,406,29,29,0,1,0
5,416,416,52,52,0,1,0
24,416,416,64,64,0,1,0
19,430,430,12,12,0,1,0
15,435,435,11,11,0,1,0
30,437,437,44,4,40,3,2
31,439,439,19,19,0,1,0
1,441,441,125,125,0,1,0
4,445,445,1,1,0,1,0
6,451,451,4,4,0,1,0
16,452,452,10,10,0,1,0
43,453,453,93,93,0,1,0
38,487,487,90,83,7,2,1

23,109,109,8,8,0,1,0
22,115,115,8,4,4,2,1
17,131,131,5,1,4,2,1
27,136,136,2,2,0,1,0
24,153,153,33,33,0,1,0
20,166,166,5,5,0,1,0
3,196,196,9,5,4,2,1
16,208,208,10,1,9,2,1
2,211,211,10,5,5,2,1
8,222,222,23,23,0,1,0
37,223,223,21,21,0,1,0
18,237,237,68,51,17,2,1
10,239,239,16,16,0,1,0
26,239,239,36,36,0,1,0
13,248,248,3,3,0,1,0
32,270,270,2,2,0,1,0
11,290,290,9,1,8,3,2
35,291,291,49,49,0,1,0
34,309,309,28,28,0,1,0
31,313,313,27,27,0,1,0
29,313,313,2,2,0,1,0
1,322,322,56,20,36,4,3
33,339,339,13,13,0,1,0
21,355,355,5,5,0,1,0
14,357,357,15,15,0,1,0
12,363,363,55,55,0,1,0
38,374,374,222,175,47,3,2
25,377,377,8,8,0,1,0
6,387,387,11,5,6,2,1
36,411,411,1,1,0,1,0
7,420,420,24,17,7,2,1
28,429,429,71,31,40,2,1
15,441,441,65,65,0,1,0
0,449,449,10,4,6,2,1
19,459,459,53,53,0,1,0
9,463,463,53,53,0,1,0
5,490,490,55,55,0,1,0
4,500,500,63,48,15,2,1
30,500,500,16,16,0,1,0

19,100,100,1,1,0,1,0
33,171,171,27,27,0,1,0
2,173,173,33,33,0,1,0
17,206,206,20,20,0,1,0
23,207,207,14,14,0,1,0
30,222,222,4,1,3,2,1
16,236,236,52,18,34,3,2
32,247,247,5,5,0,1,0
27,254,254,1,1,0,1,0
26,262,262,18,18,0,1,0
28,277,277,34,34,0,1,0
8,278,278,8,8,0,1,0
15,284,284,20,8,12,3,2
5,295,295,70,70,0,1,0
6,300,300,6,6,0,1,0
34,301,301,76,46,30,4,3
7,315,315,24,24,0,1,0
3,320,320,20,8,12,3,2
29,327,327,59,59,0,1,0
25,333,333,33,33,0,1,0
37,342,342,23,23,0,1,0
31,364,364,6,6,0,1,0
14,385,385,14,14,0,1,0
36,385,385,40,40,0,1,0
12,386,386,6,6,0,1,0
18,391,391,3,3,0,1,0
0,397,397,14,2,12,4,3
21,404,404,34,34,0,1,0
22,411,411,51,51,0,1,0
20,413,413,23,23,0,1,0
1,418,418,8,8,0,1,0
10,418,418,94,89,5,2,1
13,455,455,1,1,0,1,0
4,468,468,2,2,0,1,0
9,476,476,118,118,0,1,0
35,476,476,5,1,4,2,1
24,485,485,181,156,25,3,2
11,497,497,97,43,54,3,2

4,107,107,17,5,12,2,1
6,115,115,85,79,6,2,1
31,127,127,4,4,0,1,0
18,128,128,8,2,6,2,1
3,130,130,8,8,0,1,0
12,136,136,1,1,0,1,0
30,152,152,4,4,0,1,0
27,153,153,39,39,0,1,0
0,154,154,22,17,5,2,1
11,202,202,19,19,0,1,0
1,222,222,12,3,9,2,1
10,227,227,31,31,0,1,0
2,240,240,1,1,0,1,0
28,240,240,1,1,0,1,0
22,243,243,14,14,0,1,0
33,244,244,92,68,24,3,2
23,254,254,15,15,0,1,0
16,268,268,57,7,50,3,2
26,272,272,1,1,0,1,0
7,329,329,1,1,0,1,0
5,339,339,45,45,0,1,0
19,343,343,44,44,0,1,0
24,345,345,9,9,0,1,0
32,359,359,77,77,0,1,0
15,364,364,9,5,4,2,1
9,366,366,12,3,9,2,1
21,383,383,8,4,4,2,1
13,407,407,8,8,0,1,0
20,428,428,75,75,0,1,0
25,436,436,20,13,7,2,1
14,439,439,57,57,0,1,0
29,445,445,44,44,0,1,0
8,459,459,27,27,0,1,0
17,460,460,16,16,0,1,0

3,100,100,16,13,3,2,1
37,101,101,1,1,0,1,0
39,113,113,7,1,6,3,2
20,116,116,5,5,0,1,0
15,126,126,2,2,0,1,0
10,142,142,4,4,0,1,0
22,146,146,6,2,4,2,1
42,157,157,5,2,3,2,1
26,163,163,3,3,0,1,0
8,185,185,20,20,0,1,0
38,199,199,9,9,0,1,0
4,203,203,3,3,0,1,0
23,218,218,2,2,0,1,0
31,220,220,7,4,3,2,1
25,241,241,42,18,24,3,2
17,250,250,20,20,0,1,0
11,270,270,12,1,11,2,1
16,285,285,11,11,0,1,0
13,286,286,21,21,0,1,0
36,288,288,4,1,3,2,1
28,290,290,2,2,0,1,0
1,297,297,1,1,0,1,0
33,320,320,63,63,0,1,0
5,363,363,14,8,6,2,1
30,366,366,112,112,0,1,0
27,373,373,52,1,51,3,2
32,376,376,58,16,42,3,2
12,377,377,10,10,0,1,0
0,387,387,64,16,48,3,2
6,392,392,1,1,0,1,0
41,395,395,33,33,0,1,0
21,400,400,17,2,15,2,1
43,433,433,95,66,29,2,1
24,435,435,3,3,0,1,0
44,438,438,130,130,0,1,0
29,438,438,51,5,46,3,2
9,443,443,165,132,33,2,1
19,448,448,27,4,23,2,1
35,459,459,9,6,3,2,1
2,464,464,28,19,9,4,3
7,465,465,7,7,0,1,0
40,466,466,14,4,10,3,2
34,472,472,37,21,16,3,2
14,477,477,68,33,35,4,3
18,485,485,7,1,6,2,1

13,103,103,24,24,0,1,0
24,103,103,13,13,0,1,0
6,109,109,18,18,0,1,0
20,176,176,10,5,5,2,1
0,183,183,1,1,0,1,0
11,191,191,57,11,46,2,1
29,193,193,24,12,12,2,1
1,196,196,18,18,0,1,0
18,198,198,11,3,8,3,2
7,205,205,16,11,5,2,1
28,206,206,14,14,0,1,0
10,235,235,5,5,0,1,0
16,251,251,53,53,0,1,0
17,251,251,16,10,6,2,1
30,265,265,31,31,0,1,0
27,271,271,17,2,15,2,1
31,310,310,32,26,6,3,2
8,319,319,59,59,0,1,0
19,369,369,79,79,0,1,0
2,369,369,21,21,0,1,0
22,380,380,14,14,0,1,0
4,422,422,15,9,6,2,1
14,433,433,38,38,0,1,0
9,434,434,5,5,0,1,0
21,443,443,81,81,0,1,0
5,463,463,44,2,42,2,1
25,464,464,4,4,0,1,0
12,476,476,209,59,150,4,3
23,478,478,51,51,0,1,0
3,480,480,41,17,24,2,1
15,499,499,17,11,6,3,2
26,500,500,87,51,36,4,3

16,110,110,5,5,0,1,0
13,113,113,1,1,0,1,0
31,116,116,15,3,12,3,2
36,121,121,5,5,0,1,0
3,129,129,24,14,10,3,2
19,138,138,19,9,10,2,1
9,157,157,2,2,0,1,0
33,159,159,9,9,0,1,0
26,163,163,36,17,19,2,1
7,178,178,1,1,0,1,0
14,188,188,1,1,0,1,0
28,189,189,3,3,0,1,0
4,203,203,29,29,0,1,0
18,207,207,28,7,21,4,3
22,211,211,33,33,0,1,0
21,214,214,1,1,0,1,0
27,214,214,56,26,30,2,1
5,217,217,58,32,26,2,1
23,222,222,1,1,0,1,0
39,239,239,32,32,0,1,0
38,250,250,1,1,0,1,0
15,268,268,2,2,0,1,0
34,269,269,64,64,0,1,0
40,278,278,11,11,0,1,0
10,279,279,11,8,3,2,1
42,280,280,28,14,14,2,1
29,315,315,19,1,18,3,2
8,320,320,36,36,0,1,0
11,326,326,34,24,10,3,2
30,344,344,55,55,0,1,0
17,353,353,1,1,0,1,0
32,363,363,9,9,0,1,0
41,385,385,73,66,7,2,1
6,389,389,3,3,0,1,0
37,391,391,1,1,0,1,0
20,437,437,25,7,18,4,3
35,438,438,28,28,0,1,0
12,445,445,69,55,14,2,1
1,447,447,10,10,0,1,0
2,452,452,66,66,0,1,0
24,453,453,14,14,0,1,0
0,484,484,1,1,0,1,0
25,499,499,46,25,21,2,1

25,100,100,9,9,0,1,0
23,108,108,6,6,0,1,0
31,120,120,7,7,0,1,0
6,131,131,4,1,3,2,1
32,137,137,24,3,21,2,1
20,137,137,14,6,8,3,2
14,142,142,6,3,3,2,1
18,152,152,11,8,3,2,1
30,158,158,24,24,0,1,0
19,171,171,9,9,0,1,0
26,180,180,45,13,32,3,2
22,184,184,26,20,6,3,2
4,196,196,14,14,0,1,0
9,197,197,14,9,5,2,1
29,203,203,57,5,52,3,2
2,210,210,1,1,0,1,0
35,215,215,10,10,0,1,0
27,224,224,1,1,0,1,0
1,238,238,25,25,0,1,0
3,243,243,3,3,0,1,0
15,248,248,8,2,6,3,2
13,250,250,161,32,129,4,3
5,267,267,59,59,0,1,0
17,284,284,41,41,0,1,0
8,301,301,19,13,6,2,1
11,313,313,7,4,3,2,1
34,334,334,11,11,0,1,0
21,341,341,85,85,0,1,0
10,343,343,25,25,0,1,0
16,389,389,11,1,10,3,2
28,393,393,6,2,4,2,1
7,401,401,27,27,0,1,0
12,410,410,64,40,24,4,3
33,431,431,11,11,0,1,0
0,467,467,6,6,0,1,0
24,492,492,19,5,14,2,1

20,105,105,4,1,3,2,1
23,111,111,9,1,8,3,2
18,112,112,11,1,10,2,1
9,157,157,15,15,0,1,0
25,196,196,71,31,40,4,3
8,198,198,17,17,0,1,0
15,200,200,15,15,0,1,0
16,221,221,16,9,7,2,1
5,231,231,9,2,7,2,1
17,232,232,3,3,0,1,0
26,242,242,3,3,0,1,0
13,272,272,28,5,23,3,2
10,274,274,15,9,6,3,2
19,282,282,18,18,0,1,0
27,289,289,11,11,0,1,0
1,320,320,21,21,0,1,0
7,329,329,9,2,7,2,1
14,342,342,4,4,0,1,0
28,362,362,20,6,14,3,2
21,387,387,25,6,19,2,1
0,391,391,134,134,0,1,0
6,394,394,35,35,0,1,0
22,400,400,91,64,27,4,3
3,422,422,321,180,141,4,3
12,432,432,9,9,0,1,0
11,432,432,114,73,41,4,3
24,439,439,105,12,93,4,3
2,447,447,70,70,0,1,0
4,475,475,40,40,0,1,0

7,104,104,1,1,0,1,0
19,117,117,13,13,0,1,0
32,121,121,76,76,0,1,0
2,121,121,11,11,0,1,0
6,125,125,4,4,0,1,0
34,141,141,4,4,0,1,0
29,147,147,1,1,0,1,0
23,152,152,10,10,0,1,0
1,153,153,10,10,0,1,0
39,161,161,4,4,0,1,0
33,170,170,4,4,0,1,0
41,171,171,7,7,0,1,0
5,174,174,13,7,6,2,1
16,178,178,4,1,3,2,1
42,192,192,35,14,21,2,1
4,198,198,22,22,0,1,0
30,214,214,11,1,10,4,3
9,219,219,30,18,12,4,3
17,220,220,25,16,9,4,3
13,238,238,15,15,0,1,0
3,241,241,8,3,5,2,1
22,245,245,4,4,0,1,0
27,247,247,1,1,0,1,0
21,273,273,1,1,0,1,0
35,276,276,58,41,17,2,1
25,282,282,5,2,3,2,1
14,284,284,8,8,0,1,0
0,300,300,19,7,12,3,2
20,310,310,26,1,25,2,1
12,327,327,24,24,0,1,0
28,342,342,14,14,0,1,0
11,364,364,64,21,43,2,1
18,373,373,4,4,0,1,0
36,386,386,20,20,0,1,0
24,395,395,7,3,4,2,1
8,403,403,14,14,0,1,0
40,435,435,91,56,35,2,1
10,436,436,23,2,21,4,3
38,451,451,22,22,0,1,0
15,454,454,141,34,107,4,3
31,463,463,35,35,0,1,0
37,468,468,28,6,22,4,3
26,489,489,69,23,46,4,3

25,107,107,30,30,0,1,0
26,134,134,19,19,0,1,0
18,136,136,3,3,0,1,0
29,150,150,48,18,30,4,3
5,165,165,12,4,8,3,2
24,170,170,15,15,0,1,0
1,197,197,45,45,0,1,0
2,211,211,42,34,8,2,1
31,215,215,23,12,11,2,1
30,228,228,43,43,0,1,0
8,231,231,18,4,14,2,1
27,238,238,5,5,0,1,0
15,246,246,2,2,0,1,0
32,248,248,16,16,0,1,0
11,263,263,6,1,5,2,1
13,280,280,66,66,0,1,0
21,293,293,22,9,13,4,3
3,314,314,18,15,3,2,1
6,329,329,3,3,0,1,0
14,331,331,4,4,0,1,0
16,332,332,35,19,16,2,1
7,332,332,23,13,10,2,1
19,352,352,23,23,0,1,0
28,363,363,25,25,0,1,0
20,377,377,1,1,0,1,0
12,389,389,42,42,0,1,0
17,396,396,2,2,0,1,0
4,401,401,27,27,0,1,0
22,422,422,48,48,0,1,0
0,428,428,7,7,0,1,0
10,430,430,187,159,28,3,2
9,448,448,86,28,58,3,2
23,453,453,78,50,28,2,1

33,111,111,2,2,0,1,0
27,120,120,5,5,0,1,0
21,136,136,8,2,6,3,2
30,154,154,44,44,0,1,0
10,174,174,49,15,34,3,2
13,182,182,23,23,0,1,0
23,215,215,53,53,0,1,0
15,220,220,123,93,30,3,2
1,222,222,2,2,0,1,0
26,225,225,2,2,0,1,0
4,228,228,1,1,0,1,0
18,230,230,44,44,0,1,0
25,232,232,1,1,0,1,0
14,238,238,2,2,0,1,0
29,259,259,38,6,32,3,2
19,266,266,36,5,31,2,1
7,282,282,11,11,0,1,0
16,300,300,10,3,7,2,1
8,303,303,14,2,12,2,1
3,319,319,88,78,10,3,2
11,340,340,12,2,10,2,1
28,363,363,9,9,0,1,0
6,367,367,3,3,0,1,0
5,377,377,35,25,10,2,1
0,406,406,7,1,6,3,2
2,409,409,44,44,0,1,0
31,409,409,80,42,38,3,2
32,410,410,26,26,0,1,0
24,449,449,1,1,0,1,0
17,454,454,42,38,4,2,1
12,464,464,82,4,78,4,3
22,467,467,15,15,0,1,0
9,472,472,6,6,0,1,0
20,496,496,123,41,82,3,2

11,124,124,23,8,15,4,3
29,141,141,15,15,0,1,0
3,150,150,1,1,0,1,0
4,155,155,10,10,0,1,0
18,158,158,10,3,7,2,1
24,175,175,10,10,0,1,0
15,178,178,7,2,5,2,1
7,200,200,24,24,0,1,0
30,205,205,32,2,30,2,1
22,206,206,3,3,0,1,0
17,213,213,9,9,0,1,0
8,223,223,38,38,0,1,0
1,225,225,6,6,0,1,0
5,236,236,129,129,0,1,0
20,253,253,63,47,16,2,1
14,263,263,30,3,27,4,3
21,266,266,39,33,6,3,2
19,292,292,38,38,0,1,0
12,331,331,22,10,12,3,2
2,341,341,2,2,0,1,0
25,352,352,15,15,0,1,0
10,353,353,29,17,12,2,1
0,361,361,79,79,0,1,0
27,376,376,4,4,0,1,0
28,378,378,57,6,51,3,2
13,412,412,119,119,0,1,0
26,436,436,12,12,0,1,0
23,438,438,74,74,0,1,0
6,457,457,117,50,67,4,3
16,473,473,14,2,12,3,2
9,475,475,24,24,0,1,0

37,105,105,9,9,0,1,0
6,123,123,16,16,0,1,0
29,131,131,7,7,0,1,0
23,146,146,28,28,0,1,0
19,150,150,8,8,0,1,0
35,153,153,6,6,0,1,0
25,153,153,3,3,0,1,0
17,157,157,1,1,0,1,0
32,160,160,9,9,0,1,0
21,180,180,11,2,9,2,1
20,182,182,18,18,0,1,0
26,182,182,29,29,0,1,0
38,220,220,11,2,9,4,3
14,221,221,2,2,0,1,0
41,230,230,1,1,0,1,0
5,248,248,9,9,0,1,0
10,308,308,1,1,0,1,0
13,310,310,2,2,0,1,0
36,340,340,10,10,0,1,0
11,350,350,31,27,4,2,1
16,357,357,6,1,5,2,1
12,363,363,77,65,12,4,3
24,367,367,3,3,0,1,0
28,381,381,56,56,0,1,0
1,382,382,24,24,0,1,0
22,382,382,46,46,0,1,0
39,393,393,19,19,0,1,0
8,399,399,15,15,0,1,0
2,407,407,66,22,44,2,1
27,412,412,59,59,0,1,0
18,416,416,4,4,0,1,0
40,440,440,112,112,0,1,0
7,440,440,64,64,0,1,0
15,452,452,4,4,0,1,0
4,456,456,18,7,11,2,1
33,461,461,225,191,34,2,1
9,471,471,69,27,42,4,3
3,477,477,28,28,0,1,0
30,490,490,10,10,0,1,0
34,491,491,69,11,58,3,2
31,494,494,50,41,9,4,3
0,498,498,47,47,0,1,0

14,145,145,48,24,24,4,3
15,157,157,20,16,4,2,1
12,165,165,42,30,12,4,3
6,185,185,38,3,35,2,1
26,199,199,12,12,0,1,0
3,202,202,22,1,21,4,3
30,225,225,25,25,0,1,0
22,243,243,105,33,72,3,2
32,248,248,24,24,0,1,0
7,248,248,11,11,0,1,0
10,251,251,30,14,16,2,1
29,260,260,15,12,3,2,1
18,267,267,49,24,25,3,2
25,274,274,15,3,12,2,1
2,284,284,14,14,0,1,0
27,291,291,3,3,0,1,0
4,293,293,6,6,0,1,0
23,304,304,6,3,3,2,1
5,314,314,13,13,0,1,0
13,338,338,3,3,0,1,0
28,371,371,9,9,0,1,0
19,372,372,69,69,0,1,0
0,375,375,27,27,0,1,0
24,382,382,20,16,4,2,1
9,397,397,21,21,0,1,0
33,407,407,49,28,21,4,3
21,427,427,62,62,0,1,0
11,428,428,87,87,0,1,0
20,454,454,3,3,0,1,0
17,461,461,47,47,0,1,0
1,467,467,55,5,50,3,2
16,472,472,23,12,11,2,1
8,496,496,24,24,0,1,0
31,500,500,59,59,0,1,0

7,102,102,15,12,3,2,1
25,143,143,4,4,0,1,0
32,144,144,17,17,0,1,0
34,147,147,42,42,0,1,0
6,158,158,14,14,0,1,0
28,162,162,24,24,0,1,0
5,164,164,39,39,0,1,0
13,182,182,5,5,0,1,0
1,187,187,37,19,18,3,2
4,196,196,15,8,7,2,1
21,202,202,5,5,0,1,0
30,204,204,2,2,0,1,0
10,220,220,5,5,0,1,0
26,226,226,37,21,16,3,2
19,236,236,30,18,12,3,2
23,242,242,43,43,0,1,0
3,247,247,6,6,0,1,0
15,260,260,24,24,0,1,0
27,262,262,5,5,0,1,0
29,286,286,1,1,0,1,0
12,336,336,45,5,40,3,2
18,339,339,39,17,22,3,2
2,355,355,49,49,0,1,0
22,364,364,20,20,0,1,0
9,365,365,10,10,0,1,0
0,373,373,4,4,0,1,0
16,410,410,77,43,34,3,2
8,411,411,60,60,0,1,0
31,429,429,87,74,13,2,1
20,436,436,39,8,31,4,3
11,438,438,104,104,0,1,0
14,448,448,2,2,0,1,0
33,448,448,11,1,10,3,2
24,475,475,112,112,0,1,0
17,495,495,2,2,0,1,0

8,106,106,1,1,0,1,0
1,109,109,9,2,7,2,1
26,109,109,21,9,12,2,1
29,114,114,7,7,0,1,0
31,121,121,2,2,0,1,0
2,128,128,8,5,3,2,1
22,146,146,35,35,0,1,0
16,158,158,56,29,27,4,3
27,183,183,21,21,0,1,0
14,196,196,13,13,0,1,0
23,203,203,1,1,0,1,0
17,207,207,17,17,0,1,0
38,237,237,20,13,7,2,1
6,240,240,61,29,32,3,2
7,280,280,29,29,0,1,0
36,292,292,9,6,3,2,1
9,295,295,4,4,0,1,0
0,296,296,11,11,0,1,0
32,303,303,29,29,0,1,0
28,304,304,10,10,0,1,0
24,305,305,27,15,12,3,2
20,318,318,9,9,0,1,0
21,318,318,38,20,18,4,3
5,329,329,11,7,4,2,1
4,339,339,25,11,14,2,1
33,341,341,133,133,0,1,0
10,342,342,60,60,0,1,0
35,342,342,16,16,0,1,0
13,344,344,15,15,0,1,0
3,382,382,18,18,0,1,0
37,390,390,70,42,28,2,1
15,402,402,33,33,0,1,0
11,423,423,18,18,0,1,0
25,444,444,36,36,0,1,0
12,453,453,19,19,0,1,0
34,465,465,20,1,19,2,1
18,477,477,67,5,62,3,2
19,498,498,14,8,6,2,1
30,499,499,4,4,0,1,0

38,116,116,9,9,0,1,0
37,124,124,1,1,0,1,0
12,126,126,2,2,0,1,0
35,135,135,4,4,0,1,0
2,156,156,11,1,10,2,1
15,179,179,46,46,0,1,0
27,206,206,18,12,6,2,1
20,207,207,13,13,0,1,0
0,211,211,5,5,0,1,0
31,253,253,3,3,0,1,0
17,258,258,12,12,0,1,0
26,259,259,24,4,20,2,1
11,273,273,16,16,0,1,0
16,275,275,2,2,0,1,0
22,276,276,26,18,8,2,1
33,282,282,30,16,14,2,1
7,283,283,37,37,0,1,0
21,287,287,1,1,0,1,0
34,288,288,55,8,47,2,1
9,299,299,19,1,18,2,1
8,300,300,73,23,50,2,1
39,317,317,17,11,6,2,1
5,320,320,9,9,0,1,0
4,333,333,1,1,0,1,0
30,334,334,2,2,0,1,0
36,350,350,14,14,0,1,0
25,359,359,82,39,43,2,1
14,377,377,98,98,0,1,0
32,384,384,53,53,0,1,0
3,385,385,13,13,0,1,0
10,387,387,115,46,69,4,3
1,388,388,16,16,0,1,0
13,392,392,4,1,3,2,1
23,397,397,11,2,9,4,3
29,430,430,147,23,124,4,3
6,446,446,21,17,4,2,1
28,456,456,108,39,69,4,3
18,469,469,26,14,12,4,3
24,469,469,28,28,0,1,0
19,486,486,21,18,3,2,1

9,105,105,28,28,0,1,0
32,120,120,6,3,3,2,1
19,139,139,16,5,11,2,1
20,158,158,12,2,10,3,2
30,167,167,30,30,0,1,0
28,183,183,7,4,3,2,1
14,191,191,7,7,0,1,0
12,210,210,2,2,0,1,0
25,224,224,28,28,0,1,0
23,233,233,15,3,12,3,2
16,270,270,2,2,0,1,0
8,276,276,10,1,9,4,3
2,277,277,51,51,0,1,0
27,308,308,10,10,0,1,0
22,340,340,31,25,6,3,2
29,356,356,8,4,4,2,1
4,371,371,171,171,0,1,0
10,371,371,36,36,0,1,0
7,377,377,53,18,35,2,1
3,385,385,36,15,21,4,3
18,388,388,237,206,31,2,1
26,404,404,61,61,0,1,0
0,408,408,32,6,26,3,2
31,423,423,20,12,8,3,2
24,433,433,17,1,16,3,2
15,444,444,36,36,0,1,0
17,445,445,17,17,0,1,0
11,458,458,8,8,0,1,0
6,458,458,90,21,69,4,3
5,460,460,58,58,0,1,0
13,464,464,9,9,0,1,0
21,470,470,30,17,13,2,1
1,473,473,18,6,12,2,1

26,116,116,16,16,0,1,0
27,118,118,23,2,21,4,3
10,131,131,5,5,0,1,0
23,159,159,43,40,3,2,1
12,163,163,12,4,8,2,1
11,188,188,1,1,0,1,0
24,189,189,22,22,0,1,0
6,194,194,58,58,0,1,0
20,199,199,50,34,16,2,1
18,225,225,8,8,0,1,0
13,230,230,30,30,0,1,0
14,234,234,4,4,0,1,0
19,267,267,48,48,0,1,0
0,273,273,67,34,33,4,3
25,278,278,8,8,0,1,0
16,311,311,5,5,0,1,0
9,322,322,21,21,0,1,0
8,350,350,138,138,0,1,0
7,367,367,94,94,0,1,0
15,406,406,2,2,0,1,0
1,417,417,1,1,0,1,0
21,420,420,9,9,0,1,0
22,437,437,53,25,28,2,1
3,462,462,63,63,0,1,0
4,473,473,155,109,46,3,2
5,482,482,27,27,0,1,0
17,491,491,101,90,11,2,1
2,499,499,9,9,0,1,0

5,114,114,5,5,0,1,0
19,115,115,3,3,0,1,0
7,118,118,5,1,4,2,1
14,143,143,2,2,0,1,0
38,176,176,3,3,0,1,0
2,180,180,41,15,26,3,2
17,190,190,23,20,3,2,1
31,201,201,54,54,0,1,0
10,208,208,42,42,0,1,0
32,210,210,3,3,0,1,0
20,218,218,12,12,0,1,0
15,222,222,1,1,0,1,0
0,231,231,10,4,6,3,2
21,233,233,87,48,39,4,3
29,234,234,16,16,0,1,0
18,240,240,10,6,4,2,1
39,246,246,10,10,0,1,0
13,257,257,37,37,0,1,0
9,258,258,26,4,22,2,1
26,259,259,37,11,26,2,1
33,260,260,50,12,38,3,2
16,276,276,1,1,0,1,0
35,277,277,17,17,0,1,0
3,280,280,9,9,0,1,0
30,331,331,77,37,40,2,1
25,334,334,31,17,14,2,1
24,355,355,86,38,48,4,3
22,356,356,4,4,0,1,0
23,400,400,20,7,13,2,1
1,417,417,31,18,13,2,1
37,432,432,16,1,15,4,3
28,453,453,115,115,0,1,0
4,454,454,15,15,0,1,0
6,462,462,5,5,0,1,0
12,464,464,22,10,12,2,1
36,469,469,25,15,10,2,1
11,486,486,22,22,0,1,0
34,493,493,13,7,6,2,1
27,494,494,14,2,12,3,2
8,498,498,57,47,10,3,2

10,107,107,11,4,7,2,1
29,110,110,9,9,0,1,0
25,122,122,40,40,0,1,0
3,125,125,33,4,29,2,1
22,126,126,1,1,0,1,0
31,148,148,7,7,0,1,0
1,158,158,12,1,11,2,1
23,214,214,53,44,9,2,1
24,239,239,29,29,0,1,0
9,244,244,5,1,4,2,1
13,247,247,32,2,30,2,1
20,260,260,7,1,6,2,1
17,272,272,30,17,13,2,1
0,294,294,14,9,5,2,1
28,295,295,50,50,0,1,0
16,296,296,5,2,3,2,1
2,306,306,19,6,13,2,1
15,307,307,51,35,16,2,1
7,319,319,26,12,14,3,2
26,319,319,24,9,15,2,1
27,336,336,22,22,0,1,0
11,340,340,38,38,0,1,0
19,341,341,26,26,0,1,0
30,373,373,15,15,0,1,0
21,398,398,8,8,0,1,0
12,402,402,73,73,0,1,0
14,408,408,34,34,0,1,0
18,421,421,64,30,34,2,1
4,425,425,61,19,42,2,1
5,458,458,181,163,18,4,3
6,480,480,14,5,9,2,1
8,488,488,76,50,26,2,1

11,100,100,6,6,0,1,0
12,115,115,17,5,12,4,3
3,122,122,12,12,0,1,0
22,127,127,23,11,12,3,2
14,144,144,10,10,0,1,0
25,147,147,3,3,0,1,0
28,149,149,33,33,0,1,0
24,212,212,16,2,14,3,2
8,226,226,53,53,0,1,0
9,236,236,38,38,0,1,0
5,239,239,37,2,35,2,1
13,242,242,63,6,57,4,3
26,259,259,17,1,16,4,3
6,289,289,8,8,0,1,0
19,318,318,54,38,16,2,1
0,332,332,104,104,0,1,0
29,341,341,34,8,26,3,2
23,344,344,12,12,0,1,0
17,408,408,25,1,24,2,1
16,408,408,2,2,0,1,0
15,413,413,26,26,0,1,0
18,417,417,29,29,0,1,0
1,428,428,48,22,26,2,1
20,434,434,21,2,19,2,1
21,447,447,12,12,0,1,0
27,473,473,99,56,43,2,1
2,476,476,107,107,0,1,0
10,477,477,22,22,0,1,0
4,481,481,136,112,24,2,1
7,488,488,45,19,26,2,1

34,105,105,17,8,9,2,1
11,107,107,18,8,10,3,2
5,108,108,2,2,0,1,0
1,121,121,4,1,3,2,1
2,132,132,15,15,0,1,0
6,136,136,1,1,0,1,0
12,161,161,6,6,0,1,0
3,183,183,18,13,5,2,1
13,188,188,53,53,0,1,0
22,222,222,16,16,0,1,0
32,234,234,14,14,0,1,0
30,247,247,6,6,0,1,0
19,252,252,34,25,9,2,1
23,260,260,7,7,0,1,0
28,266,266,16,1,15,4,3
33,274,274,20,20,0,1,0
21,278,278,32,32,0,1,0
10,285,285,1,1,0,1,0
0,291,291,46,46,0,1,0
7,316,316,35,35,0,1,0
36,321,321,7,4,3,2,1
16,326,326,9,9,0,1,0
20,348,348,38,22,16,2,1
24,350,350,1,1,0,1,0
9,353,353,35,16,19,2,1
4,400,400,16,7,9,2,1
8,410,410,15,15,0,1,0
27,415,415,69,5,64,3,2
35,419,419,17,8,9,2,1
18,420,420,3,3,0,1,0
25,430,430,18,18,0,1,0
37,444,444,174,174,0,1,0
29,451,451,16,6,10,2,1
15,452,452,10,5,5,2,1
14,455,455,155,25,130,4,3
17,470,470,29,22,7,2,1
26,476,476,197,99,98,4,3
31,492,492,4,4,0,1,0

16,101,101,28,28,0,1,0
21,134,134,2,2,0,1,0
25,147,147,16,10,6,2,1
34,165,165,26,1,25,4,3
4,169,169,7,1,6,3,2
8,170,170,1,1,0,1,0
33,184,184,57,3,54,3,2
22,186,186,34,20,14,3,2
0,199,199,7,7,0,1,0
15,218,218,8,4,4,2,1
10,231,231,31,25,6,3,2
14,250,250,10,10,0,1,0
3,260,260,7,1,6,2,1
35,260,260,19,19,0,1,0
36,269,269,29,14,15,2,1
31,276,276,14,6,8,2,1
29,288,288,33,17,16,2,1
1,299,299,64,23,41,2,1
28,306,306,3,3,0,1,0
30,316,316,51,12,39,4,3
12,317,317,1,1,0,1,0
24,336,336,54,8,46,4,3
7,341,341,25,25,0,1,0
32,358,358,1,1,0,1,0
11,366,366,81,1,80,3,2
18,376,376,2,2,0,1,0
27,408,408,1,1,0,1,0
5,417,417,27,27,0,1,0
13,423,423,71,44,27,4,3
20,428,428,12,12,0,1,0
17,461,461,16,16,0,1,0
9,472,472,15,5,10,2,1
2,481,481,70,34,36,2,1
23,493,493,25,25,0,1,0
37,494,494,9,9,0,1,0
26,495,495,137,122,15,4,3
6,495,495,36,29,7,2,1
19,498,498,84,42,42,3,2

12,105,105,18,18,0,1,0
0,132,132,7,1,6,2,1
16,138,138,22,22,0,1,0
9,139,139,5,5,0,1,0
33,158,158,15,15,0,1,0
30,168,168,14,14,0,1,0
20,176,176,26,4,22,3,2
17,194,194,7,7,0,1,0
31,214,214,10,10,0,1,0
2,221,221,10,4,6,2,1
8,241,241,15,9,6,2,1
32,243,243,14,14,0,1,0
3,247,247,37,8,29,2,1
15,250,250,7,7,0,1,0
18,265,265,50,50,0,1,0
25,280,280,47,20,27,4,3
21,280,280,10,3,7,3,2
14,297,297,12,9,3,2,1
7,300,300,43,9,34,2,1
28,305,305,12,12,0,1,0
1,318,318,4,4,0,1,0
27,326,326,42,42,0,1,0
5,335,335,56,56,0,1,0
26,364,364,50,26,24,3,2
29,376,376,12,12,0,1,0
23,399,399,8,2,6,2,1
4,422,422,13,13,0,1,0
11,443,443,142,87,55,4,3
10,444,444,1,1,0,1,0
13,479,479,90,90,0,1,0
6,486,486,171,171,0,1,0
22,488,488,21,1,20,2,1
19,496,496,128,76,52,3,2
24,499,499,77,77,0,1,0

4,122,122,6,6,0,1,0
16,128,128,15,15,0,1,0
27,137,137,27,9,18,3,2
13,139,139,1,1,0,1,0
21,164,164,36,36,0,1,0
24,182,182,8,8,0,1,0
5,182,182,15,15,0,1,0
1,203,203,2,2,0,1,0
33,211,211,22,22,0,1,0
2,229,229,5,5,0,1,0
31,236,236,8,8,0,1,0
28,240,240,9,3,6,3,2
25,241,241,12,9,3,2,1
22,265,265,2,2,0,1,0
3,270,270,1,1,0,1,0
9,271,271,52,45,7,2,1
42,275,275,75,6,69,4,3
23,276,276,6,6,0,1,0
19,290,290,1,1,0,1,0
29,291,291,10,10,0,1,0
32,298,298,58,44,14,2,1
18,302,302,26,4,22,4,3
8,313,313,17,17,0,1,0
17,320,320,1,1,0,1,0
40,348,348,69,1,68,4,3
37,360,360,16,16,0,1,0
41,365,365,78,78,0,1,0
30,373,373,14,14,0,1,0
34,379,379,3,3,0,1,0
35,384,384,27,27,0,1,0
14,397,397,117,30,87,4,3
6,405,405,44,44,0,1,0
0,418,418,27,1,26,3,2
36,419,419,9,4,5,2,1
15,428,428,101,6,95,4,3
39,432,432,23,8,15,3,2
38,441,441,35,35,0,1,0
20,473,473,12,12,0,1,0
26,480,480,86,6,80,4,3
7,485,485,46,46,0,1,0
11,486,486,20,20,0,1,0
10,494,494,3,3,0,1,0
12,496,496,3,3,0,1,0

25,104,104,2,2,0,1,0
13,115,115,2,2,0,1,0
9,116,116,12,12,0,1,0
32,129,129,9,9,0,1,0
21,142,142,3,3,0,1,0
39,149,149,2,2,0,1,0
12,154,154,1,1,0,1,0
24,158,158,26,20,6,2,1
38,162,162,19,19,0,1,0
15,174,174,2,2,0,1,0
10,176,176,10,1,9,2,1
4,182,182,37,19,18,4,3
27,189,189,25,25,0,1,0
0,190,190,15,6,9,2,1
17,195,195,30,1,29,2,1
42,197,197,11,2,9,4,3
36,222,222,26,17,9,2,1
41,232,232,33,33,0,1,0
2,238,238,11,11,0,1,0
14,250,250,13,13,0,1,0
8,258,258,1,1,0,1,0
28,259,259,13,13,0,1,0
37,265,265,27,27,0,1,0
5,283,283,14,11,3,2,1
40,297,297,7,7,0,1,0
22,334,334,29,12,17,2,1
26,344,344,4,4,0,1,0
11,352,352,106,70,36,4,3
33,373,373,32,14,18,4,3
34,390,390,52,14,38,3,2
30,395,395,259,178,81,4,3
35,398,398,14,3,11,2,1
20,413,413,49,49,0,1,0
16,438,438,7,1,6,2,1
18,447,447,14,14,0,1,0
1,452,452,15,15,0,1,0
23,462,462,33,28,5,2,1
3,463,463,26,26,0,1,0
6,475,475,23,23,0,1,0
7,479,479,32,20,12,4,3
19,490,490,1,1,0,1,0
31,492,492,17,17,0,1,0
29,492,492,21,3,18,2,1

10,100,100,3,3,0,1,0
12,101,101,13,1,12,3,2
17,104,104,2,2,0,1,0
1,114,114,16,1,15,4,3
25,152,152,14,2,12,2,1
21,164,164,32,32,0,1,0
11,167,167,11,11,0,1,0
19,179,179,17,2,15,4,3
6,214,214,17,8,9,4,3
24,240,240,59,5,54,4,3
18,243,243,8,8,0,1,0
13,250,250,50,50,0,1,0
15,254,254,10,4,6,2,1
9,255,255,20,11,9,2,1
0,255,255,5,1,4,2,1
35,258,258,71,56,15,2,1
34,273,273,15,15,0,1,0
14,274,274,20,2,18,3,2
2,284,284,46,26,20,2,1
4,286,286,44,9,35,2,1
31,290,290,31,31,0,1,0
16,291,291,10,10,0,1,0
28,295,295,11,11,0,1,0
27,300,300,9,9,0,1,0
33,328,328,19,7,12,4,3
5,328,328,1,1,0,1,0
32,343,343,26,26,0,1,0
20,382,382,9,9,0,1,0
7,385,385,21,8,13,2,1
8,416,416,96,96,0,1,0
23,418,418,27,27,0,1,0
29,418,418,20,20,0,1,0
30,423,423,122,122,0,1,0
3,444,444,130,116,14,2,1
22,475,475,32,5,27,4,3
26,485,485,23,8,15,2,1

10,106,106,1,1,0,1,0
7,108,108,13,7,6,3,2
38,108,108,19,19,0,1,0
41,112,112,1,1,0,1,0
36,132,132,34,34,0,1,0
19,154,154,3,3,0,1,0
5,159,159,20,14,6,3,2
31,164,164,27,27,0,1,0
4,197,197,4,1,3,2,1
23,208,208,42,14,28,3,2
33,218,218,3,3,0,1,0
3,220,220,12,1,11,2,1
28,224,224,3,3,0,1,0
12,225,225,2,2,0,1,0
22,230,230,8,8,0,1,0
24,241,241,2,2,0,1,0
30,254,254,9,9,0,1,0
2,256,256,3,3,0,1,0
17,266,266,23,5,18,3,2
39,274,274,38,38,0,1,0
34,279,279,27,27,0,1,0
0,291,291,12,9,3,2,1
35,293,293,13,13,0,1,0
13,313,313,1,1,0,1,0
16,331,331,4,4,0,1,0
8,344,344,8,5,3,2,1
29,347,347,103,20,83,4,3
9,352,352,36,27,9,4,3
25,364,364,38,38,0,1,0
14,376,376,28,2,26,2,1
21,377,377,63,44,19,4,3
20,396,396,84,32,52,3,2
1,398,398,35,35,0,1,0
11,414,414,68,68,0,1,0
15,419,419,25,25,0,1,0
32,425,425,60,22,38,2,1
27,429,429,37,32,5,2,1
26,432,432,80,80,0,1,0
40,454,454,24,24,0,1,0
6,462,462,47,32,15,4,3
37,472,472,7,1,6,3,2
18,483,483,28,28,0,1,0

8,100,100,15,6,9,4,3
26,143,143,63,39,24,3,2
6,152,152,1,1,0,1,0
29,158,158,47,47,0,1,0
23,167,167,6,3,3,2,1
22,181,181,24,24,0,1,0
15,186,186,4,4,0,1,0
13,196,196,20,20,0,1,0
14,212,212,18,18,0,1,0
24,229,229,16,16,0,1,0
21,243,243,54,54,0,1,0
11,244,244,9,9,0,1,0
9,250,250,6,6,0,1,0
18,262,262,6,6,0,1,0
7,268,268,77,55,22,3,2
17,291,291,32,32,0,1,0
3,301,301,95,20,75,4,3
25,312,312,3,3,0,1,0
1,336,336,22,22,0,1,0
20,338,338,50,11,39,4,3
32,366,366,2,2,0,1,0
2,374,374,36,10,26,2,1
16,379,379,13,1,12,3,2
28,380,380,51,51,0,1,0
5,393,393,100,84,16,3,2
33,394,394,14,14,0,1,0
19,395,395,6,6,0,1,0
4,404,404,5,5,0,1,0
27,421,421,29,29,0,1,0
31,423,423,10,1,9,2,1
30,434,434,7,7,0,1,0
10,446,446,4,4,0,1,0
0,479,479,47,20,27,2,1
12,479,479,115,44,71,4,3

26,105,105,11,5,6,2,1
13,126,126,7,4,3,2,1
8,127,127,4,4,0,1,0
5,152,152,8,8,0,1,0
11,183,183,46,46,0,1,0
10,189,189,13,13,0,1,0
20,208,208,3,3,0,1,0
4,209,209,19,19,0,1,0
21,211,211,28,13,15,4,3
22,215,215,4,4,0,1,0
9,215,215,4,4,0,1,0
14,222,222,9,3,6,3,2
1,236,236,42,42,0,1,0
3,245,245,22,22,0,1,0
15,262,262,9,3,6,3,2
2,287,287,4,4,0,1,0
37,321,321,16,16,0,1,0
30,333,333,49,49,0,1,0
28,336,336,4,1,3,2,1
25,352,352,19,3,16,3,2
27,369,369,113,113,0,1,0
17,377,377,12,4,8,2,1
38,388,388,2,2,0,1,0
18,393,393,19,14,5,2,1
19,394,394,152,98,54,4,3
34,399,399,51,30,21,4,3
32,407,407,77,29,48,3,2
6,410,410,18,18,0,1,0
36,415,415,77,77,0,1,0
7,422,422,71,37,34,3,2
33,422,422,49,27,22,4,3
23,440,440,111,72,39,4,3
16,440,440,38,38,0,1,0
29,469,469,18,2,16,3,2
12,471,471,8,8,0,1,0
24,473,473,32,32,0,1,0
31,480,480,8,8,0,1,0
0,486,486,39,39,0,1,0
35,492,492,3,3,0,1,0

3,101,101,13,8,5,2,1
9,118,118,19,19,0,1,0
30,122,122,10,10,0,1,0
0,136,136,1,1,0,1,0
26,140,140,19,3,16,3,2
19,145,145,14,6,8,3,2
23,147,147,1,1,0,1,0
13,154,154,10,10,0,1,0
11,183,183,19,19,0,1,0
27,183,183,6,6,0,1,0
15,185,185,1,1,0,1,0
33,190,190,12,12,0,1,0
4,191,191,36,36,0,1,0
2,224,224,11,11,0,1,0
29,227,227,32,23,9,4,3
8,229,229,12,12,0,1,0
7,243,243,26,26,0,1,0
32,264,264,3,3,0,1,0
14,281,281,36,36,0,1,0
16,285,285,94,94,0,1,0
6,302,302,2,2,0,1,0
5,302,302,38,24,14,3,2
17,336,336,27,18,9,2,1
1,350,350,17,17,0,1,0
28,358,358,161,161,0,1,0
31,373,373,3,3,0,1,0
22,388,388,2,2,0,1,0
21,398,398,57,4,53,4,3
10,407,407,74,74,0,1,0
20,439,439,86,31,55,4,3
25,459,459,52,52,0,1,0
34,469,469,77,57,20,3,2
12,483,483,55,13,42,4,3
24,485,485,5,5,0,1,0
18,487,487,40,11,29,2,1

9,112,112,6,6,0,1,0
2,116,116,11,11,0,1,0
4,119,119,52,19,33,4,3
28,119,119,3,3,0,1,0
22,149,149,53,17,36,2,1
15,150,150,11,11,0,1,0
30,206,206,36,8,28,3,2
26,225,225,23,10,13,4,3
14,257,257,2,2,0,1,0
13,263,263,61,1,60,4,3
5,266,266,65,65,0,1,0
6,278,278,20,20,0,1,0
24,307,307,6,6,0,1,0
7,309,309,58,21,37,2,1
20,317,317,27,27,0,1,0
31,321,321,29,29,0,1,0
18,334,334,30,30,0,1,0
0,334,334,25,25,0,1,0
25,344,344,9,9,0,1,0
3,356,356,15,3,12,4,3
1,370,370,1,1,0,1,0
23,383,383,74,22,52,4,3
12,389,389,1,1,0,1,0
8,418,418,7,4,3,2,1
16,463,463,29,17,12,3,2
10,476,476,14,8,6,3,2
19,478,478,46,18,28,3,2
27,480,480,59,32,27,4,3
17,483,483,21,18,3,2,1
11,483,483,151,151,0,1,0
29,483,483,61,61,0,1,0
21,497,497,71,23,48,4,3

37,100,100,3,3,0,1,0
30,102,102,13,13,0,1,0
21,116,116,45,18,27,4,3
29,120,120,23,23,0,1,0
22,132,132,44,1,43,4,3
23,146,146,15,15,0,1,0
28,160,160,11,4,7,2,1
15,181,181,18,18,0,1,0
6,192,192,7,3,4,2,1
3,211,211,63,15,48,3,2
20,214,214,1,1,0,1,0
10,237,237,30,27,3,2,1
8,245,245,9,1,8,3,2
33,261,261,7,7,0,1,0
16,262,262,15,12,3,2,1
4,264,264,84,62,22,3,2
12,275,275,10,10,0,1,0
35,281,281,20,20,0,1,0
17,285,285,1,1,0,1,0
25,293,293,13,13,0,1,0
13,309,309,15,7,8,3,2
34,311,311,4,1,3,2,1
32,339,339,70,31,39,3,2
27,344,344,3,3,0,1,0
14,349,349,71,60,11,2,1
2,352,352,14,1,13,2,1
7,364,364,20,6,14,2,1
0,372,372,29,21,8,2,1
5,382,382,2,2,0,1,0
26,398,398,15,8,7,2,1
36,400,400,15,15,0,1,0
9,402,402,43,19,24,3,2
19,408,408,22,19,3,2,1
1,411,411,47,12,35,2,1
11,412,412,22,22,0,1,0
31,449,449,45,45,0,1,0
24,472,472,24,11,13,2,1
18,488,488,14,2,12,2,1

4,119,119,34,34,0,1,0
2,137,137,55,55,0,1,0
36,144,144,18,9,9,2,1
29,157,157,7,3,4,2,1
8,162,162,13,6,7,2,1
27,178,178,3,3,0,1,0
10,183,183,5,2,3,2,1
18,193,193,1,1,0,1,0
22,195,195,1,1,0,1,0
35,198,198,12,2,10,2,1
16,207,207,23,23,0,1,0
0,241,241,50,50,0,1,0
32,243,243,51,5,46,3,2
1,252,252,15,15,0,1,0
3,255,255,9,9,0,1,0
26,264,264,12,12,0,1,0
34,274,274,68,35,33,3,2
28,283,283,79,18,61,4,3
15,287,287,9,9,0,1,0
17,291,291,4,4,0,1,0
11,308,308,63,36,27,4,3
23,326,326,2,2,0,1,0
13,343,343,3,3,0,1,0
6,353,353,9,5,4,2,1
14,358,358,22,22,0,1,0
20,378,378,7,7,0,1,0
30,401,401,5,5,0,1,0
19,422,422,1,1,0,1,0
37,425,425,42,2,40,3,2
5,426,426,33,17,16,3,2
31,436,436,10,10,0,1,0
33,450,450,143,143,0,1,0
9,473,473,19,19,0,1,0
25,476,476,39,39,0,1,0
21,477,477,34,10,24,3,2
7,488,488,34,18,16,2,1
12,489,489,26,26,0,1,0
24,499,499,85,43,42,4,3

21,123,123,16,16,0,1,0
6,138,138,23,23,0,1,0
15,141,141,36,26,10,3,2
9,142,142,1,1,0,1,0
31,176,176,5,1,4,2,1
10,178,178,24,4,20,2,1
7,187,187,9,1,8,3,2
17,191,191,42,42,0,1,0
27,203,203,60,16,44,3,2
29,207,207,1,1,0,1,0
8,209,209,6,6,0,1,0
33,228,228,38,38,0,1,0
0,229,229,3,3,0,1,0
4,241,241,14,14,0,1,0
1,263,263,17,3,14,2,1
14,271,271,1,1,0,1,0
18,284,284,35,7,28,2,1
19,286,286,23,13,10,3,2
22,292,292,30,5,25,2,1
3,302,302,54,35,19,2,1
13,308,308,10,4,6,2,1
35,312,312,8,8,0,1,0
30,336,336,60,45,15,2,1
26,341,341,12,12,0,1,0
2,369,369,42,4,38,2,1
16,391,391,1,1,0,1,0
25,395,395,155,143,12,4,3
20,430,430,16,16,0,1,0
23,453,453,21,11,10,3,2
24,468,468,13,13,0,1,0
28,470,470,14,14,0,1,0
11,482,482,103,59,44,3,2
12,487,487,75,57,18,2,1
34,489,489,30,30,0,1,0
5,493,493,53,53,0,1,0
32,496,496,35,35,0,1,0

5,100,100,14,14,0,1,0
28,103,103,1,1,0,1,0
37,109,109,7,7,0,1,0
10,123,123,31,31,0,1,0
17,125,125,10,10,0,1,0
7,126,126,1,1,0,1,0
24,133,133,24,2,22,3,2
21,155,155,12,4,8,2,1
20,177,177,10,10,0,1,0
31,196,196,2,2,0,1,0
6,209,209,38,13,25,2,1
2,215,215,1,1,0,1,0
16,219,219,33,3,30,2,1
30,228,228,2,2,0,1,0
25,238,238,15,10,5,2,1
23,242,242,21,21,0,1,0
27,245,245,7,7,0,1,0
3,247,247,61,61,0,1,0
34,253,253,136,52,84,3,2
11,257,257,53,37,16,2,1
13,260,260,7,7,0,1,0
4,302,302,1,1,0,1,0
22,309,309,3,3,0,1,0
33,339,339,43,43,0,1,0
29,357,357,53,3,50,4,3
14,369,369,37,13,24,3,2
15,402,402,34,12,22,2,1
26,404,404,36,21,15,4,3
0,413,413,23,3,20,4,3
12,424,424,2,2,0,1,0
1,430,430,21,21,0,1,0
32,435,435,22,22,0,1,0
35,440,440,90,39,51,4,3
19,455,455,7,7,0,1,0
18,463,463,21,21,0,1,0
9,472,472,43,43,0,1,0
8,474,474,26,1,25,2,1
36,492,492,44,23,21,4,3

24,117,117,7,7,0,1,0
7,118,118,15,11,4,2,1
1,124,124,12,3,9,4,3
4,166,166,13,9,4,2,1
14,192,192,14,14,0,1,0
3,194,194,24,14,10,3,2
2,203,203,2,2,0,1,0
5,204,204,44,44,0,1,0
9,205,205,8,1,7,2,1
8,212,212,10,10,0,1,0
31,224,224,5,2,3,2,1
22,274,274,43,43,0,1,0
25,287,287,27,5,22,2,1
20,289,289,16,4,12,4,3
32,299,299,3,3,0,1,0
18,299,299,55,8,47,2,1
17,322,322,50,50,0,1,0
27,330,330,156,87,69,4,3
30,342,342,17,17,0,1,0
19,346,346,3,3,0,1,0
16,363,363,100,100,0,1,0
28,367,367,22,8,14,2,1
21,369,369,79,79,0,1,0
15,371,371,15,15,0,1,0
35,378,378,47,47,0,1,0
29,379,379,17,17,0,1,0
26,399,399,30,30,0,1,0
6,414,414,1,1,0,1,0
36,424,424,4,4,0,1,0
0,432,432,6,2,4,2,1
23,462,462,106,106,0,1,0
34,462,462,28,28,0,1,0
11,465,465,19,19,0,1,0
33,485,485,41,41,0,1,0
12,489,489,34,26,8,3,2
10,496,496,6,6,0,1,0
13,500,500,98,50,48,4,3

16,101,101,7,1,6,2,1
14,105,105,17,17,0,1,0
34,106,106,10,10,0,1,0
6,109,109,23,9,14,2,1
32,112,112,40,3,37,2,1
4,116,116,33,33,0,1,0
23,120,120,26,10,16,3,2
19,137,137,1,1,0,1,0
3,140,140,2,2,0,1,0
22,148,148,25,5,20,2,1
24,148,148,48,42,6,2,1
30,158,158,14,4,10,3,2
35,185,185,2,2,0,1,0
13,188,188,22,14,8,2,1
18,206,206,21,6,15,4,3
15,217,217,7,1,6,2,1
11,224,224,8,8,0,1,0
26,228,228,14,14,0,1,0
27,259,259,9,1,8,3,2
5,261,261,14,14,0,1,0
1,266,266,19,5,14,3,2
17,271,271,14,14,0,1,0
21,274,274,6,1,5,2,1
31,294,294,29,9,20,3,2
10,300,300,3,3,0,1,0
20,312,312,37,19,18,2,1
25,322,322,20,11,9,2,1
0,352,352,61,7,54,3,2
28,363,363,8,8,0,1,0
9,382,382,68,50,18,3,2
33,385,385,18,2,16,3,2
7,408,408,27,3,24,4,3
8,459,459,71,11,60,3,2
2,469,469,21,21,0,1,0
12,481,481,34,26,8,2,1
29,491,491,6,6,0,1,0

8,113,113,2,2,0,1,0
13,113,113,7,7,0,1,0
9,147,147,10,2,8,3,2
33,156,156,10,10,0,1,0
4,172,172,46,46,0,1,0
21,179,179,16,16,0,1,0
14,195,195,45,45,0,1,0
5,196,196,3,3,0,1,0
28,196,196,17,17,0,1,0
16,197,197,14,4,10,2,1
30,202,202,11,5,6,2,1
20,209,209,4,1,3,2,1
34,237,237,41,41,0,1,0
1,245,245,1,1,0,1,0
29,253,253,88,88,0,1,0
7,253,253,9,9,0,1,0
18,255,255,24,4,20,3,2
26,260,260,12,12,0,1,0
31,288,288,61,61,0,1,0
37,289,289,67,29,38,2,1
36,299,299,10,1,9,4,3
23,316,316,42,15,27,3,2
25,321,321,18,18,0,1,0
35,335,335,25,7,18,2,1
11,353,353,71,35,36,3,2
12,362,362,33,25,8,2,1
17,368,368,25,15,10,2,1
19,376,376,68,16,52,3,2
3,385,385,4,4,0,1,0
0,389,389,5,5,0,1,0
27,397,397,7,7,0,1,0
10,400,400,19,19,0,1,0
6,401,401,42,4,38,2,1
22,425,425,46,13,33,3,2
15,425,425,89,89,0,1,0
24,456,456,7,3,4,2,1
32,468,468,32,32,0,1,0
2,474,474,5,2,3,2,1

23,102,102,2,2,0,1,0
30,102,102,4,4,0,1,0
8,107,107,24,3,21,4,3
15,124,124,28,11,17,2,1
19,216,216,1,1,0,1,0
2,228,228,9,9,0,1,0
3,248,248,4,4,0,1,0
31,255,255,6,6,0,1,0
1,258,258,19,19,0,1,0
17,279,279,15,15,0,1,0
25,282,282,9,4,5,2,1
5,298,298,8,8,0,1,0
29,326,326,108,12,96,3,2
24,326,326,18,18,0,1,0
26,333,333,35,15,20,3,2
7,337,337,34,34,0,1,0
4,338,338,52,52,0,1,0
12,347,347,8,8,0,1,0
13,353,353,57,57,0,1,0
11,360,360,16,16,0,1,0
20,372,372,159,159,0,1,0
32,373,373,73,18,55,4,3
21,381,381,40,6,34,2,1
16,383,383,65,34,31,3,2
22,396,396,9,2,7,2,1
28,398,398,5,5,0,1,0
9,403,403,60,30,30,3,2
27,422,422,9,9,0,1,0
33,457,457,49,18,31,2,1
10,469,469,8,5,3,2,1
6,472,472,13,13,0,1,0
18,473,473,45,45,0,1,0
0,492,492,243,181,62,3,2
14,500,500,15,15,0,1,0

13,108,108,11,11,0,1,0
34,132,132,10,10,0,1,0
1,160,160,14,14,0,1,0
2,164,164,4,4,0,1,0
26,173,173,6,6,0,1,0
6,183,183,1,1,0,1,0
22,192,192,29,29,0,1,0
31,192,192,13,5,8,2,1
10,203,203,23,23,0,1,0
27,215,215,6,6,0,1,0
5,240,240,77,68,9,4,3
8,245,245,34,7,27,4,3
16,263,263,1,1,0,1,0
15,266,266,10,6,4,2,1
3,276,276,7,4,3,2,1
9,291,291,95,49,46,3,2
4,316,316,19,4,15,2,1
24,324,324,18,18,0,1,0
25,354,354,36,24,12,2,1
20,358,358,33,3,30,3,2
30,364,364,48,48,0,1,0
32,375,375,7,7,0,1,0
12,375,375,26,26,0,1,0
28,377,377,11,11,0,1,0
18,377,377,17,17,0,1,0
21,380,380,106,106,0,1,0
11,395,395,70,70,0,1,0
23,417,417,2,2,0,1,0
19,434,434,57,57,0,1,0
14,435,435,50,32,18,3,2
0,443,443,30,3,27,4,3
33,444,444,151,151,0,1,0
35,444,444,51,51,0,1,0
29,454,454,59,23,36,3,2
7,473,473,10,3,7,2,1
17,483,483,51,51,0,1,0

2,102,102,5,1,4,2,1
29,105,105,4,4,0,1,0
11,112,112,1,1,0,1,0
37,118,118,43,3,40,4,3
6,126,126,8,4,4,2,1
14,127,127,1,1,0,1,0
9,137,137,17,4,13,2,1
32,139,139,34,25,9,4,3
23,140,140,5,5,0,1,0
13,154,154,12,3,9,2,1
16,168,168,3,3,0,1,0
5,179,179,6,2,4,2,1
40,214,214,5,5,0,1,0
3,221,221,16,16,0,1,0
43,225,225,8,8,0,1,0
24,236,236,1,1,0,1,0
41,240,240,10,7,3,2,1
25,244,244,11,11,0,1,0
20,248,248,36,36,0,1,0
34,253,253,69,69,0,1,0
38,260,260,54,14,40,3,2
7,275,275,3,3,0,1,0
42,287,287,7,7,0,1,0
4,294,294,6,6,0,1,0
44,295,295,21,21,0,1,0
8,303,303,1,1,0,1,0
18,337,337,72,38,34,4,3
31,360,360,12,12,0,1,0
36,363,363,2,2,0,1,0
17,392,392,71,71,0,1,0
33,395,395,99,57,42,4,3
12,396,396,40,8,32,3,2
26,413,413,36,36,0,1,0
35,416,416,1,1,0,1,0
10,419,419,48,48,0,1,0
28,433,433,27,2,25,2,1
27,442,442,2,2,0,1,0
39,443,443,57,57,0,1,0
30,449,449,13,13,0,1,0
21,451,451,65,65,0,1,0
19,454,454,2,2,0,1,0
22,457,457,60,15,45,4,3
15,468,468,6,6,0,1,0
1,470,470,3,3,0,1,0
0,472,472,40,18,22,2,1

2,101,101,19,1,18,3,2
26,137,137,4,4,0,1,0
9,152,152,17,17,0,1,0
18,168,168,6,6,0,1,0
5,176,176,34,34,0,1,0
20,186,186,47,6,41,2,1
17,199,199,24,17,7,2,1
33,208,208,2,2,0,1,0
12,210,210,39,14,25,2,1
11,234,234,19,19,0,1,0
28,237,237,44,44,0,1,0
1,237,237,1,1,0,1,0
15,246,246,23,23,0,1,0
25,251,251,14,14,0,1,0
10,255,255,37,37,0,1,0
23,262,262,4,4,0,1,0
31,267,267,89,53,36,3,2
4,269,269,18,18,0,1,0
19,282,282,28,13,15,4,3
6,297,297,39,39,0,1,0
32,313,313,17,5,12,4,3
29,332,332,7,7,0,1,0
7,335,335,25,4,21,2,1
3,338,338,39,18,21,2,1
30,357,357,14,14,0,1,0
14,367,367,13,2,11,2,1
8,385,385,15,15,0,1,0
27,390,390,5,5,0,1,0
13,391,391,52,5,47,4,3
16,411,411,54,54,0,1,0
21,427,427,99,90,9,4,3
22,461,461,56,17,39,4,3
24,464,464,41,41,0,1,0
0,470,470,95,43,52,3,2

4,100,100,3,3,0,1,0
20,103,103,24,9,15,4,3
19,106,106,2,2,0,1,0
14,116,116,3,3,0,1,0
18,118,118,30,2,28,3,2
34,155,155,6,6,0,1,0
6,163,163,34,34,0,1,0
21,184,184,17,11,6,2,1
15,195,195,6,2,4,2,1
37,199,199,15,10,5,2,1
1,215,215,26,8,18,3,2
13,224,224,17,17,0,1,0
16,226,226,1,1,0,1,0
2,229,229,25,25,0,1,0
27,251,251,24,24,0,1,0
9,258,258,62,20,42,4,3
0,266,266,10,10,0,1,0
22,274,274,46,24,22,2,1
5,277,277,1,1,0,1,0
25,279,279,28,19,9,4,3
28,295,295,20,20,0,1,0
36,297,297,16,16,0,1,0
24,302,302,54,24,30,3,2
7,318,318,5,5,0,1,0
3,323,323,31,24,7,2,1
31,331,331,8,8,0,1,0
35,348,348,79,40,39,4,3
12,349,349,27,27,0,1,0
10,354,354,24,3,21,4,3
11,367,367,99,48,51,4,3
32,370,370,9,9,0,1,0
26,373,373,26,5,21,2,1
23,377,377,31,16,15,2,1
30,385,385,3,3,0,1,0
33,404,404,34,34,0,1,0
17,410,410,45,45,0,1,0
8,467,467,2,2,0,1,0
29,479,479,104,72,32,3,2

32,108,108,19,19,0,1,0
22,121,121,2,2,0,1,0
25,124,124,22,22,0,1,0
24,131,131,22,13,9,4,3
4,137,137,20,20,0,1,0
11,185,185,12,12,0,1,0
19,210,210,33,21,12,2,1
16,237,237,16,2,14,3,2
21,243,243,35,16,19,2,1
0,255,255,24,24,0,1,0
17,257,257,13,13,0,1,0
7,258,258,6,6,0,1,0
29,279,279,38,20,18,2,1
10,281,281,19,11,8,3,2
26,285,285,4,4,0,1,0
33,293,293,15,15,0,1,0
18,301,301,16,12,4,2,1
34,308,308,1,1,0,1,0
6,311,311,14,10,4,2,1
8,325,325,90,90,0,1,0
2,330,330,23,13,10,2,1
20,336,336,18,13,5,2,1
1,341,341,110,99,11,2,1
23,345,345,34,13,21,2,1
28,359,359,25,17,8,2,1
12,378,378,37,19,18,3,2
13,391,391,20,20,0,1,0
5,405,405,44,36,8,3,2
31,424,424,51,8,43,4,3
3,426,426,113,105,8,2,1
27,444,444,70,58,12,4,3
30,455,455,85,85,0,1,0
9,459,459,4,4,0,1,0
15,471,471,34,34,0,1,0
14,496,496,10,10,0,1,0

27,120,120,44,44,0,1,0
23,135,135,5,5,0,1,0
4,137,137,3,3,0,1,0
2,157,157,5,5,0,1,0
1,164,164,67,67,0,1,0
18,201,201,5,2,3,2,1
21,204,204,28,28,0,1,0
20,213,213,13,8,5,2,1
17,243,243,18,8,10,3,2
8,245,245,17,7,10,2,1
12,261,261,76,76,0,1,0
26,263,263,26,26,0,1,0
11,270,270,21,21,0,1,0
24,287,287,5,5,0,1,0
13,292,292,1,1,0,1,0
19,295,295,20,20,0,1,0
3,321,321,5,5,0,1,0
22,324,324,12,12,0,1,0
32,325,325,22,5,17,2,1
9,332,332,55,31,24,2,1
15,349,349,1,1,0,1,0
5,353,353,42,42,0,1,0
33,374,374,16,2,14,3,2
16,379,379,56,56,0,1,0
7,402,402,49,49,0,1,0
30,411,411,23,23,0,1,0
10,419,419,99,99,0,1,0
29,429,429,115,115,0,1,0
6,455,455,43,43,0,1,0
14,468,468,19,8,11,2,1
0,480,480,48,48,0,1,0
28,480,480,54,54,0,1,0
31,489,489,95,42,53,4,3
25,493,493,11,2,9,4,3

29,101,101,6,6,0,1,0
31,107,107,12,12,0,1,0
21,126,126,25,25,0,1,0
4,126,126,3,3,0,1,0
25,131,131,45,45,0,1,0
18,135,135,11,11,0,1,0
23,136,136,9,3,6,2,1
38,147,147,21,3,18,3,2
30,158,158,2,2,0,1,0
17,179,179,17,17,0,1,0
22,185,185,9,9,0,1,0
24,192,192,10,2,8,3,2
20,214,214,10,10,0,1,0
36,219,219,24,24,0,1,0
5,228,228,5,5,0,1,0
7,228,228,18,18,0,1,0
28,235,235,19,19,0,1,0
13,237,237,1,1,0,1,0
35,255,255,3,3,0,1,0
3,257,257,15,15,0,1,0
34,264,264,73,61,12,2,1
10,306,306,62,53,9,2,1
6,312,312,17,5,12,3,2
26,320,320,26,26,0,1,0
9,348,348,58,58,0,1,0
32,370,370,29,5,24,2,1
8,402,402,27,27,0,1,0
1,407,407,11,8,3,2,1
33,408,408,13,13,0,1,0
19,434,434,102,102,0,1,0
16,440,440,70,30,40,3,2
12,441,441,2,2,0,1,0
14,446,446,1,1,0,1,0
11,456,456,66,66,0,1,0
0,467,467,42,42,0,1,0
39,478,478,72,72,0,1,0
27,478,478,78,78,0,1,0
2,482,482,3,3,0,1,0
37,484,484,18,4,14,3,2
15,499,499,19,19,0,1,0

10,128,128,2,2,0,1,0
28,136,136,7,7,0,1,0
17,140,140,8,8,0,1,0
38,159,159,23,3,20,3,2
8,165,165,34,34,0,1,0
19,172,172,23,5,18,3,2
1,179,179,8,8,0,1,0
3,185,185,21,21,0,1,0
21,201,201,6,2,4,2,1
2,201,201,44,31,13,2,1
4,203,203,1,1,0,1,0
15,205,205,14,8,6,2,1
12,214,214,15,9,6,2,1
0,215,215,9,1,8,2,1
30,246,246,15,9,6,3,2
36,254,254,7,3,4,2,1
26,265,265,27,27,0,1,0
14,289,289,16,7,9,4,3
20,294,294,46,46,0,1,0
5,296,296,1,1,0,1,0
7,299,299,7,7,0,1,0
32,302,302,10,4,6,2,1
11,304,304,1,1,0,1,0
23,307,307,5,5,0,1,0
22,312,312,10,10,0,1,0
16,314,314,46,46,0,1,0
13,345,345,100,12,88,3,2
9,352,352,26,26,0,1,0
31,379,379,20,20,0,1,0
29,380,380,145,145,0,1,0
39,382,382,139,79,60,4,3
6,406,406,14,2,12,3,2
25,407,407,1,1,0,1,0
34,414,414,54,23,31,2,1
24,442,442,14,14,0,1,0
18,446,446,5,1,4,2,1
35,448,448,32,32,0,1,0
27,468,468,80,80,0,1,0
37,471,471,56,56,0,1,0
33,496,496,22,4,18,4,3

35,100,100,49,15,34,4,3
25,111,111,7,1,6,3,2
9,119,119,14,14,0,1,0
3,131,131,49,7,42,4,3
15,141,141,10,10,0,1,0
27,150,150,4,1,3,2,1
20,163,163,28,20,8,2,1
30,167,167,28,10,18,3,2
13,176,176,22,22,0,1,0
36,178,178,13,13,0,1,0
34,208,208,1,1,0,1,0
17,221,221,7,7,0,1,0
18,233,233,1,1,0,1,0
22,233,233,5,5,0,1,0
28,242,242,9,9,0,1,0
10,255,255,22,22,0,1,0
8,267,267,10,1,9,4,3
32,272,272,11,11,0,1,0
7,285,285,21,7,14,2,1
12,300,300,14,2,12,3,2
24,308,308,53,25,28,2,1
1,324,324,18,18,0,1,0
4,333,333,9,9,0,1,0
23,352,352,55,55,0,1,0
26,369,369,20,6,14,3,2
31,383,383,28,21,7,2,1
11,390,390,21,21,0,1,0
0,395,395,88,28,60,4,3
19,413,413,7,7,0,1,0
2,416,416,14,5,9,2,1
5,417,417,16,1,15,2,1
6,417,417,62,24,38,2,1
38,438,438,30,21,9,2,1
29,444,444,125,81,44,2,1
33,450,450,12,12,0,1,0
16,450,450,19,19,0,1,0
14,477,477,12,12,0,1,0
37,477,477,13,13,0,1,0
21,492,492,26,3,23,4,3

18,101,101,2,2,0,1,0
16,110,110,24,3,21,4,3
9,113,113,3,3,0,1,0
10,128,128,7,1,6,2,1
14,144,144,23,23,0,1,0
22,151,151,28,28,0,1,0
17,153,153,33,33,0,1,0
23,162,162,34,7,27,4,3
31,180,180,14,14,0,1,0
6,184,184,10,10,0,1,0
1,192,192,9,9,0,1,0
13,208,208,10,1,9,2,1
33,211,211,8,1,7,2,1
0,217,217,48,48,0,1,0
3,222,222,29,4,25,2,1
29,257,257,5,5,0,1,0
27,260,260,11,11,0,1,0
20,280,280,5,5,0,1,0
2,287,287,12,12,0,1,0
30,290,290,69,17,52,4,3
28,309,309,4,4,0,1,0
24,331,331,56,56,0,1,0
4,342,342,1,1,0,1,0
5,354,354,49,49,0,1,0
21,369,369,11,11,0,1,0
11,373,373,19,9,10,3,2
7,379,379,1,1,0,1,0
32,383,383,58,9,49,4,3
12,399,399,36,36,0,1,0
19,400,400,50,41,9,4,3
26,427,427,28,12,16,3,2
8,443,443,303,294,9,4,3
25,463,463,6,1,5,2,1
15,493,493,24,24,0,1,0

29,104,104,2,2,0,1,0
12,109,109,11,11,0,1,0
22,119,119,5,2,3,2,1
4,151,151,65,27,38,3,2
3,158,158,60,60,0,1,0
21,179,179,18,5,13,2,1
20,185,185,32,32,0,1,0
28,197,197,66,66,0,1,0
6,214,214,1,1,0,1,0
19,215,215,5,2,3,2,1
8,225,225,18,18,0,1,0
27,226,226,5,5,0,1,0
25,244,244,8,8,0,1,0
16,248,248,29,29,0,1,0
17,260,260,1,1,0,1,0
0,275,275,41,41,0,1,0
5,281,281,1,1,0,1,0
11,301,301,3,3,0,1,0
26,340,340,63,48,15,4,3
24,347,347,50,40,10,3,2
14,347,347,34,8,26,2,1
9,352,352,40,4,36,2,1
7,360,360,26,26,0,1,0
13,442,442,4,4,0,1,0
2,442,442,64,13,51,4,3
23,454,454,15,15,0,1,0
32,455,455,37,2,35,4,3
31,456,456,75,5,70,3,2
10,469,469,56,24,32,2,1
30,474,474,9,9,0,1,0
15,482,482,50,23,27,3,2
18,483,483,119,35,84,4,3
1,484,484,42,42,0,1,0

30,107,107,5,1,4,2,1
6,132,132,62,62,0,1,0
10,154,154,30,24,6,2,1
7,156,156,1,1,0,1,0
1,169,169,17,17,0,1,0
22,183,183,1,1,0,1,0
16,212,212,23,23,0,1,0
25,214,214,70,70,0,1,0
9,231,231,1,1,0,1,0
15,234,234,9,9,0,1,0
29,237,237,38,34,4,2,1
19,241,241,4,4,0,1,0
28,255,255,5,1,4,2,1
31,282,282,21,21,0,1,0
32,285,285,11,11,0,1,0
23,296,296,12,12,0,1,0
21,314,314,5,5,0,1,0
11,337,337,62,23,39,2,1
27,338,338,56,56,0,1,0
4,341,341,14,14,0,1,0
14,343,343,50,6,44,4,3
0,357,357,5,5,0,1,0
8,360,360,32,32,0,1,0
20,361,361,19,6,13,2,1
18,375,375,176,88,88,3,2
13,452,452,112,76,36,4,3
3,453,453,2,2,0,1,0
17,459,459,82,82,0,1,0
2,462,462,77,25,52,3,2
26,468,468,22,22,0,1,0
24,480,480,13,13,0,1,0
5,493,493,50,50,0,1,0
12,494,494,16,16,0,1,0

21,102,102,5,5,0,1,0
15,110,110,1,1,0,1,0
10,128,128,4,4,0,1,0
7,130,130,10,10,0,1,0
22,140,140,8,8,0,1,0
9,157,157,17,5,12,2,1
25,164,164,5,2,3,2,1
2,164,164,12,7,5,2,1
3,191,191,14,14,0,1,0
12,195,195,13,13,0,1,0
35,209,209,3,3,0,1,0
37,240,240,40,32,8,2,1
28,259,259,5,5,0,1,0
32,280,280,72,72,0,1,0
41,281,281,6,6,0,1,0
17,282,282,35,35,0,1,0
24,285,285,2,2,0,1,0
13,290,290,1,1,0,1,0
1,291,291,38,38,0,1,0
27,292,292,67,45,22,3,2
39,298,298,40,24,16,3,2
34,304,304,57,30,27,2,1
5,314,314,39,11,28,3,2
20,329,329,15,1,14,2,1
11,333,333,66,66,0,1,0
16,335,335,19,11,8,2,1
31,341,341,1,1,0,1,0
18,343,343,33,33,0,1,0
14,344,344,3,3,0,1,0
8,364,364,3,3,0,1,0
4,370,370,18,10,8,2,1
19,390,390,62,62,0,1,0
36,393,393,28,6,22,4,3
33,394,394,2,2,0,1,0
30,407,407,9,9,0,1,0
43,421,421,13,13,0,1,0
0,434,434,49,49,0,1,0
26,445,445,90,71,19,2,1
23,455,455,18,18,0,1,0
6,463,463,29,19,10,3,2
42,465,465,19,16,3,2,1
40,466,466,17,9,8,3,2
38,493,493,50,24,26,3,2
29,499,499,143,143,0,1,0

19,105,105,4,1,3,2,1
28,110,110,11,11,0,1,0
23,114,114,3,3,0,1,0
10,117,117,4,4,0,1,0
15,129,129,2,2,0,1,0
26,134,134,16,16,0,1,0
17,144,144,34,7,27,2,1
30,153,153,10,1,9,3,2
25,156,156,1,1,0,1,0
29,158,158,23,23,0,1,0
33,167,167,63,51,12,4,3
21,222,222,41,5,36,2,1
20,229,229,4,4,0,1,0
14,231,231,9,9,0,1,0
34,232,232,33,33,0,1,0
12,290,290,13,5,8,3,2
32,291,291,6,6,0,1,0
5,312,312,36,36,0,1,0
3,312,312,4,4,0,1,0
18,323,323,50,50,0,1,0
2,327,327,4,4,0,1,0
8,334,334,30,30,0,1,0
7,340,340,4,4,0,1,0
16,341,341,105,90,15,2,1
31,370,370,9,9,0,1,0
6,391,391,12,12,0,1,0
24,398,398,4,4,0,1,0
27,400,400,3,3,0,1,0
22,441,441,78,57,21,4,3
11,457,457,104,59,45,2,1
0,459,459,91,31,60,4,3
4,475,475,79,22,57,4,3
9,481,481,1,1,0,1,0
1,495,495,174,142,32,2,1
13,497,497,71,71,0,1,0

25,122,122,4,4,0,1,0
31,185,185,37,37,0,1,0
14,188,188,13,13,0,1,0
29,199,199,7,1,6,3,2
22,208,208,13,4,9,2,1
8,219,219,43,43,0,1,0
18,219,219,11,3,8,3,2
15,230,230,25,7,18,4,3
5,231,231,56,56,0,1,0
9,237,237,51,51,0,1,0
17,254,254,16,16,0,1,0
10,288,288,21,21,0,1,0
21,288,288,32,32,0,1,0
11,293,293,33,33,0,1,0
19,304,304,20,2,18,3,2
6,332,332,14,14,0,1,0
0,333,333,39,33,6,3,2
16,354,354,24,14,10,3,2
26,375,375,24,3,21,4,3
32,405,405,65,53,12,4,3
23,409,409,1,1,0,1,0
12,411,411,114,8,106,4,3
4,413,413,1,1,0,1,0
7,414,414,63,59,4,2,1
27,415,415,51,18,33,2,1
24,422,422,11,7,4,2,1
20,431,431,72,4,68,4,3
13,440,440,37,13,24,3,2
1,444,444,21,5,16,3,2
33,454,454,10,10,0,1,0
3,464,464,2,2,0,1,0
28,478,478,152,105,47,4,3
2,491,491,28,10,18,2,1
30,498,498,129,103,26,2,1

35,129,129,16,16,0,1,0
11,135,135,4,4,0,1,0
29,136,136,26,4,22,3,2
27,161,161,25,25,0,1,0
12,169,169,11,11,0,1,0
31,177,177,6,3,3,2,1
7,189,189,12,12,0,1,0
6,189,189,56,56,0,1,0
14,190,190,22,22,0,1,0
37,195,195,3,3,0,1,0
33,200,200,5,5,0,1,0
22,212,212,4,1,3,2,1
13,221,221,7,1,6,3,2
17,228,228,22,22,0,1,0
9,241,241,1,1,0,1,0
23,253,253,5,5,0,1,0
4,256,256,105,82,23,2,1
20,259,259,1,1,0,1,0
36,265,265,39,39,0,1,0
26,273,273,27,9,18,3,2
39,296,296,148,113,35,4,3
21,303,303,14,14,0,1,0
3,314,314,35,1,34,3,2
2,314,314,15,15,0,1,0
38,338,338,42,6,36,3,2
30,342,342,10,10,0,1,0
34,353,353,17,17,0,1,0
16,364,364,14,1,13,2,1
5,364,364,36,10,26,2,1
25,376,376,34,34,0,1,0
24,391,391,7,2,5,2,1
28,396,396,45,26,19,2,1
1,403,403,19,7,12,2,1
10,416,416,12,12,0,1,0
18,446,446,10,10,0,1,0
8,450,450,22,22,0,1,0
15,458,458,32,12,20,4,3
0,477,477,42,4,38,3,2
32,486,486,43,43,0,1,0
19,499,499,18,18,0,1,0

17,101,101,6,3,3,2,1
27,101,101,5,5,0,1,0
12,153,153,2,2,0,1,0
34,159,159,2,2,0,1,0
0,168,168,4,4,0,1,0
10,171,171,11,3,8,3,2
25,190,190,18,1,17,2,1
8,202,202,4,4,0,1,0
5,256,256,22,3,19,4,3
6,262,262,37,37,0,1,0
32,266,266,40,25,15,2,1
2,269,269,6,6,0,1,0
19,303,303,29,21,8,3,2
3,314,314,68,38,30,4,3
23,331,331,8,8,0,1,0
33,338,338,17,8,9,4,3
14,352,352,95,33,62,3,2
31,362,362,106,34,72,3,2
21,378,378,1,1,0,1,0
7,378,378,1,1,0,1,0
16,387,387,67,67,0,1,0
29,390,390,86,38,48,4,3
9,411,411,182,182,0,1,0
22,428,428,52,52,0,1,0
26,439,439,34,4,30,4,3
15,447,447,32,5,27,2,1
28,448,448,43,43,0,1,0
20,469,469,40,40,0,1,0
4,471,471,42,6,36,3,2
13,475,475,5,1,4,2,1
24,482,482,91,62,29,2,1
18,489,489,53,53,0,1,0
11,489,489,23,23,0,1,0
1,494,494,53,5,48,2,1
30,500,500,49,49,0,1,0

27,104,104,10,10,0,1,0
13,117,117,6,2,4,2,1
0,122,122,5,1,4,2,1
33,138,138,5,5,0,1,0
11,176,176,36,9,27,4,3
26,183,183,37,37,0,1,0
21,215,215,52,17,35,4,3
4,216,216,15,15,0,1,0
10,233,233,21,21,0,1,0
8,235,235,4,1,3,2,1
12,237,237,20,11,9,4,3
31,243,243,33,33,0,1,0
2,256,256,24,24,0,1,0
29,267,267,86,86,0,1,0
28,275,275,3,3,0,1,0
7,311,311,1,1,0,1,0
5,312,312,33,1,32,3,2
34,323,323,65,29,36,3,2
17,331,331,37,22,15,2,1
14,337,337,1,1,0,1,0
19,339,339,12,9,3,2,1
39,339,339,36,2,34,3,2
16,340,340,5,2,3,2,1
20,341,341,3,3,0,1,0
37,344,344,10,1,9,4,3
30,348,348,85,85,0,1,0
3,355,355,11,2,9,4,3
18,359,359,24,24,0,1,0
36,394,394,13,13,0,1,0
9,404,404,17,17,0,1,0
25,405,405,39,39,0,1,0
1,416,416,44,17,27,4,3
6,417,417,79,43,36,3,2
32,424,424,6,6,0,1,0
24,429,429,7,1,6,2,1
22,437,437,20,10,10,2,1
38,438,438,29,29,0,1,0
23,444,444,17,9,8,2,1
35,458,458,63,34,29,2,1
40,461,461,24,24,0,1,0
15,480,480,69,69,0,1,0

5,108,108,2,2,0,1,0
26,132,132,2,2,0,1,0
1,144,144,6,6,0,1,0
3,170,170,26,11,15,4,3
29,194,194,2,2,0,1,0
11,199,199,31,31,0,1,0
13,200,200,37,11,26,3,2
25,205,205,9,9,0,1,0
15,216,216,13,13,0,1,0
0,227,227,38,38,0,1,0
14,231,231,44,16,28,3,2
33,246,246,4,1,3,2,1
18,252,252,19,1,18,3,2
28,253,253,104,14,90,4,3
12,262,262,2,2,0,1,0
27,264,264,70,32,38,4,3
24,265,265,17,9,8,2,1
2,286,286,1,1,0,1,0
4,302,302,65,17,48,2,1
19,310,310,77,30,47,3,2
21,326,326,6,6,0,1,0
7,331,331,142,88,54,4,3
22,365,365,31,6,25,2,1
31,372,372,64,64,0,1,0
16,378,378,31,31,0,1,0
30,382,382,46,28,18,4,3
8,403,403,21,21,0,1,0
10,431,431,28,28,0,1,0
6,432,432,22,22,0,1,0
20,478,478,46,3,43,2,1
23,482,482,46,46,0,1,0
17,484,484,1,1,0,1,0
9,492,492,3,3,0,1,0
32,497,497,6,6,0,1,0

0,106,106,19,3,16,3,2
7,108,108,2,2,0,1,0
31,127,127,1,1,0,1,0
17,145,145,25,10,15,4,3
13,152,152,3,3,0,1,0
20,181,181,33,33,0,1,0
5,187,187,74,74,0,1,0
19,188,188,25,19,6,2,1
3,205,205,1,1,0,1,0
29,222,222,2,2,0,1,0
33,251,251,1,1,0,1,0
8,256,256,26,5,21,4,3
10,259,259,12,6,6,2,1
24,260,260,17,4,13,4,3
21,275,275,3,3,0,1,0
4,276,276,63,63,0,1,0
9,282,282,40,24,16,2,1
23,282,282,11,11,0,1,0
26,297,297,13,13,0,1,0
18,319,319,67,67,0,1,0
2,321,321,10,10,0,1,0
28,336,336,27,27,0,1,0
34,343,343,3,3,0,1,0
15,357,357,68,68,0,1,0
16,376,376,19,19,0,1,0
22,382,382,77,77,0,1,0
32,389,389,7,7,0,1,0
12,400,400,16,4,12,2,1
11,404,404,32,8,24,3,2
14,440,440,8,2,6,3,2
27,450,450,124,124,0,1,0
6,453,453,23,13,10,3,2
25,471,471,21,7,14,2,1
35,482,482,18,18,0,1,0
1,491,491,18,18,0,1,0
30,491,491,226,169,57,4,3

24,113,113,6,2,4,2,1
4,113,113,24,24,0,1,0
13,124,124,40,40,0,1,0
15,145,145,4,4,0,1,0
5,157,157,23,12,11,2,1
18,162,162,3,3,0,1,0
12,169,169,4,4,0,1,0
9,179,179,37,4,33,3,2
26,207,207,15,15,0,1,0
19,217,217,49,43,6,2,1
28,227,227,2,2,0,1,0
16,241,241,37,33,4,2,1
17,295,295,17,9,8,3,2
10,315,315,32,32,0,1,0
0,320,320,1,1,0,1,0
22,326,326,33,29,4,2,1
11,331,331,39,39,0,1,0
6,334,334,6,6,0,1,0
14,335,335,12,2,10,2,1
27,343,343,2,2,0,1,0
23,364,364,6,6,0,1,0
1,366,366,269,181,88,4,3
21,378,378,26,26,0,1,0
3,383,383,24,12,12,3,2
2,390,390,19,19,0,1,0
29,414,414,61,12,49,3,2
8,436,436,10,10,0,1,0
7,457,457,58,58,0,1,0
25,487,487,242,203,39,4,3
20,496,496,2,2,0,1,0

15,114,114,12,12,0,1,0
37,128,128,1,1,0,1,0
36,145,145,25,1,24,2,1
29,152,152,13,4,9,4,3
3,163,163,40,40,0,1,0
33,183,183,54,54,0,1,0
4,206,206,2,2,0,1,0
5,213,213,10,10,0,1,0
7,224,224,5,5,0,1,0
12,246,246,6,6,0,1,0
20,250,250,38,38,0,1,0
35,263,263,16,2,14,3,2
16,267,267,65,65,0,1,0
0,269,269,30,30,0,1,0
24,272,272,31,10,21,2,1
6,273,273,2,2,0,1,0
31,289,289,8,3,5,2,1
10,293,293,23,23,0,1,0
34,296,296,37,13,24,4,3
2,297,297,1,1,0,1,0
23,298,298,30,20,10,2,1
11,300,300,6,3,3,2,1
8,306,306,8,8,0,1,0
19,307,307,8,2,6,3,2
22,314,314,7,1,6,3,2
26,321,321,56,56,0,1,0
14,323,323,90,58,32,3,2
9,326,326,50,50,0,1,0
28,339,339,9,9,0,1,0
21,377,377,39,39,0,1,0
32,386,386,13,13,0,1,0
18,390,390,58,40,18,4,3
17,397,397,49,49,0,1,0
27,440,440,99,13,86,3,2
13,467,467,37,10,27,2,1
25,482,482,15,15,0,1,0
1,494,494,24,4,20,2,1
30,496,496,36,36,0,1,0

30,104,104,14,6,8,3,2
34,106,106,1,1,0,1,0
31,122,122,13,13,0,1,0
8,124,124,14,14,0,1,0
28,139,139,32,10,22,3,2
18,146,146,24,24,0,1,0
20,156,156,5,1,4,2,1
14,163,163,19,19,0,1,0
10,166,166,2,2,0,1,0
37,171,171,56,13,43,3,2
35,175,175,5,5,0,1,0
17,176,176,22,22,0,1,0
0,203,203,4,1,3,2,1
23,203,203,20,20,0,1,0
3,217,217,16,13,3,2,1
19,248,248,20,5,15,2,1
15,273,273,70,22,48,2,1
33,282,282,6,2,4,2,1
9,296,296,50,26,24,2,1
1,313,313,28,7,21,3,2
22,314,314,3,3,0,1,0
36,319,319,38,23,15,4,3
4,328,328,2,2,0,1,0
29,337,337,25,25,0,1,0
6,357,357,27,1,26,2,1
13,377,377,26,26,0,1,0
21,379,379,36,36,0,1,0
5,380,380,11,11,0,1,0
11,394,394,33,11,22,3,2
25,433,433,11,2,9,4,3
26,435,435,59,50,9,2,1
7,441,441,16,16,0,1,0
12,446,446,79,6,73,3,2
16,457,457,33,9,24,3,2
32,468,468,56,43,13,2,1
24,481,481,29,29,0,1,0
27,488,488,107,55,52,3,2
2,489,489,17,17,0,1,0

15,102,102,5,2,3,2,1
2,159,159,38,10,28,3,2
33,175,175,30,30,0,1,0
21,184,184,4,4,0,1,0
23,213,213,2,2,0,1,0
22,223,223,5,2,3,2,1
18,224,224,48,48,0,1,0
20,235,235,72,72,0,1,0
13,247,247,1,1,0,1,0
5,249,249,2,2,0,1,0
10,261,261,23,23,0,1,0
3,263,263,5,5,0,1,0
26,265,265,43,43,0,1,0
17,267,267,26,26,0,1,0
24,290,290,2,2,0,1,0
0,296,296,1,1,0,1,0
31,302,302,64,52,12,2,1
6,314,314,10,10,0,1,0
8,325,325,20,8,12,3,2
28,327,327,2,2,0,1,0
27,352,352,5,5,0,1,0
7,354,354,25,20,5,2,1
1,354,354,86,55,31,3,2
36,356,356,45,45,0,1,0
25,361,361,17,17,0,1,0
30,362,362,101,8,93,4,3
14,392,392,14,14,0,1,0
32,407,407,25,25,0,1,0
12,418,418,15,15,0,1,0
9,437,437,129,129,0,1,0
11,437,437,63,53,10,3,2
19,450,450,32,32,0,1,0
16,451,451,22,18,4,2,1
29,472,472,39,17,22,4,3
4,478,478,54,54,0,1,0
35,480,480,66,33,33,2,1
34,499,499,48,38,10,2,1

11,125,125,18,18,0,1,0
3,129,129,38,38,0,1,0
33,139,139,50,10,40,2,1
20,144,144,8,4,4,2,1
7,153,153,11,7,4,2,1
9,154,154,25,16,9,4,3
4,155,155,5,5,0,1,0
1,157,157,1,1,0,1,0
32,169,169,10,1,9,4,3
17,179,179,9,9,0,1,0
24,181,181,11,11,0,1,0
25,204,204,14,4,10,2,1
31,216,216,13,3,10,4,3
18,220,220,28,28,0,1,0
8,230,230,3,3,0,1,0
5,239,239,20,20,0,1,0
34,244,244,19,19,0,1,0
21,286,286,26,3,23,2,1
28,310,310,10,10,0,1,0
15,317,317,7,3,4,2,1
23,323,323,34,3,31,2,1
16,330,330,9,9,0,1,0
22,332,332,7,7,0,1,0
10,355,355,33,11,22,3,2
27,359,359,66,66,0,1,0
29,380,380,60,60,0,1,0
0,408,408,44,17,27,4,3
26,414,414,68,68,0,1,0
6,415,415,97,61,36,4,3
30,432,432,30,30,0,1,0
13,438,438,64,64,0,1,0
12,456,456,2,2,0,1,0
14,469,469,15,15,0,1,0
2,491,491,161,143,18,4,3
19,495,495,49,10,39,4,3

12,104,104,18,10,8,3,2
22,123,123,27,27,0,1,0
8,134,134,24,6,18,3,2
24,138,138,11,5,6,2,1
2,139,139,39,39,0,1,0
26,145,145,11,11,0,1,0
16,146,146,2,2,0,1,0
31,148,148,1,1,0,1,0
34,173,173,36,36,0,1,0
30,174,174,41,41,0,1,0
28,185,185,11,11,0,1,0
20,203,203,26,26,0,1,0
19,204,204,6,6,0,1,0
9,205,205,4,4,0,1,0
1,212,212,10,10,0,1,0
32,224,224,3,3,0,1,0
15,274,274,16,6,10,2,1
37,294,294,4,4,0,1,0
7,295,295,4,1,3,2,1
18,345,345,1,1,0,1,0
11,364,364,23,23,0,1,0
4,372,372,9,5,4,2,1
29,379,379,118,32,86,4,3
27,391,391,7,7,0,1,0
36,394,394,1,1,0,1,0
21,405,405,37,21,16,3,2
25,427,427,1,1,0,1,0
35,447,447,93,3,90,3,2
0,449,449,15,7,8,2,1
13,454,454,47,47,0,1,0
5,458,458,24,6,18,4,3
14,458,458,169,40,129,4,3
3,471,471,17,17,0,1,0
23,472,472,12,12,0,1,0
17,475,475,36,21,15,3,2
10,478,478,32,9,23,2,1
6,480,480,76,18,58,3,2
33,492,492,73,21,52,4,3

27,105,105,10,3,7,2,1
15,108,108,7,7,0,1,0
22,108,108,15,15,0,1,0
4,116,116,4,1,3,2,1
28,121,121,22,7,15,2,1
26,129,129,4,1,3,2,1
6,140,140,39,20,19,2,1
25,147,147,56,56,0,1,0
2,152,152,29,29,0,1,0
12,167,167,15,15,0,1,0
13,203,203,10,1,9,2,1
33,238,238,37,9,28,2,1
30,246,246,17,5,12,4,3
31,265,265,36,36,0,1,0
1,308,308,75,4,71,4,3
0,311,311,71,50,21,4,3
23,312,312,44,44,0,1,0
29,315,315,1,1,0,1,0
8,322,322,40,14,26,3,2
14,353,353,25,10,15,2,1
7,361,361,14,14,0,1,0
32,366,366,17,17,0,1,0
18,375,375,79,51,28,2,1
20,382,382,25,25,0,1,0
16,414,414,9,9,0,1,0
11,420,420,26,11,15,4,3
3,420,420,1,1,0,1,0
17,430,430,6,6,0,1,0
10,440,440,79,23,56,3,2
9,462,462,1,1,0,1,0
24,482,482,51,24,27,2,1
19,489,489,13,2,11,2,1
21,493,493,1,1,0,1,0
5,497,497,71,71,0,1,0

17,101,101,1,1,0,1,0
4,110,110,11,11,0,1,0
5,112,112,18,6,12,3,2
35,116,116,8,5,3,2,1
31,130,130,12,12,0,1,0
14,136,136,12,2,10,3,2
20,150,150,13,13,0,1,0
41,158,158,16,1,15,4,3
15,169,169,7,7,0,1,0
9,180,180,13,13,0,1,0
32,188,188,14,5,9,4,3
16,189,189,9,9,0,1,0
10,195,195,11,2,9,4,3
1,196,196,3,3,0,1,0
19,203,203,27,21,6,2,1
39,218,218,1,1,0,1,0
43,219,219,4,4,0,1,0
45,226,226,39,9,30,4,3
34,230,230,13,13,0,1,0
21,234,234,1,1,0,1,0
23,242,242,42,42,0,1,0
26,244,244,7,7,0,1,0
11,266,266,7,1,6,2,1
38,278,278,38,5,33,2,1
36,282,282,9,5,4,2,1
42,297,297,17,17,0,1,0
40,302,302,109,2,107,4,3
37,325,325,44,30,14,3,2
30,330,330,5,5,0,1,0
33,348,348,8,1,7,2,1
25,352,352,54,54,0,1,0
22,354,354,5,5,0,1,0
12,366,366,30,30,0,1,0
3,389,389,20,8,12,4,3
7,389,389,15,1,14,2,1
28,389,389,20,20,0,1,0
13,390,390,50,21,29,2,1
18,397,397,5,5,0,1,0
46,404,404,4,4,0,1,0
44,410,410,162,87,75,4,3
6,415,415,10,10,0,1,0
2,421,421,6,3,3,2,1
27,454,454,30,20,10,4,3
29,456,456,35,13,22,2,1
8,459,459,25,19,6,3,2
0,475,475,9,9,0,1,0
24,500,500,24,24,0,1,0

10,132,132,23,9,14,2,1
28,150,150,9,9,0,1,0
4,159,159,10,10,0,1,0
3,171,171,61,49,12,2,1
20,178,178,18,3,15,4,3
15,183,183,19,19,0,1,0
23,190,190,25,25,0,1,0
27,192,192,13,13,0,1,0
1,199,199,35,35,0,1,0
9,202,202,1,1,0,1,0
13,243,243,12,12,0,1,0
14,256,256,99,14,85,4,3
7,274,274,78,26,52,4,3
25,278,278,81,37,44,3,2
21,289,289,18,18,0,1,0
19,338,338,40,24,16,2,1
18,376,376,13,9,4,2,1
12,378,378,35,35,0,1,0
11,383,383,55,22,33,4,3
16,392,392,7,7,0,1,0
2,401,401,28,14,14,2,1
8,423,423,172,124,48,3,2
6,434,434,4,1,3,2,1
17,439,439,35,35,0,1,0
22,443,443,47,47,0,1,0
26,448,448,25,13,12,2,1
0,465,465,45,45,0,1,0
5,468,468,7,4,3,2,1
24,485,485,33,33,0,1,0
29,488,488,5,5,0,1,0

41,101,101,3,3,0,1,0
16,104,104,8,8,0,1,0
32,107,107,17,17,0,1,0
2,107,107,5,5,0,1,0
19,111,111,1,1,0,1,0
18,118,118,2,2,0,1,0
33,119,119,2,2,0,1,0
10,124,124,1,1,0,1,0
43,124,124,14,5,9,4,3
25,126,126,10,10,0,1,0
17,127,127,8,4,4,2,1
21,131,131,5,2,3,2,1
29,134,134,17,6,11,2,1
13,146,146,21,3,18,3,2
39,151,151,25,25,0,1,0
31,159,159,14,7,7,2,1
7,178,178,2,2,0,1,0
27,182,182,1,1,0,1,0
38,202,202,5,5,0,1,0
4,206,206,7,1,6,3,2
20,210,210,11,6,5,2,1
23,233,233,31,19,12,3,2
5,234,234,8,1,7,3,2
0,250,250,3,3,0,1,0
11,261,261,4,4,0,1,0
37,315,315,53,53,0,1,0
30,317,317,38,2,36,3,2
14,326,326,36,36,0,1,0
28,331,331,24,24,0,1,0
6,349,349,8,8,0,1,0
9,349,349,54,54,0,1,0
12,359,359,34,10,24,3,2
36,410,410,122,95,27,2,1
22,430,430,23,2,21,4,3
42,433,433,55,3,52,3,2
3,448,448,48,8,40,3,2
8,448,448,19,9,10,2,1
35,458,458,2,2,0,1,0
15,465,465,101,101,0,1,0
1,469,469,63,32,31,2,1
24,472,472,28,28,0,1,0
34,477,477,67,13,54,4,3
40,479,479,81,45,36,4,3
26,484,484,15,15,0,1,0
44,484,484,9,9,0,1,0

6,109,109,8,8,0,1,0
12,139,139,30,30,0,1,0
14,143,143,4,4,0,1,0
7,152,152,5,5,0,1,0
21,154,154,18,8,10,2,1
22,157,157,3,3,0,1,0
27,170,170,9,4,5,2,1
20,175,175,18,18,0,1,0
32,180,180,7,3,4,2,1
16,189,189,12,12,0,1,0
13,191,191,19,3,16,2,1
5,191,191,10,4,6,3,2
33,203,203,8,8,0,1,0
30,213,213,59,12,47,2,1
2,253,253,22,22,0,1,0
23,264,264,7,1,6,3,2
25,268,268,3,3,0,1,0
11,281,281,74,28,46,4,3
3,282,282,25,25,0,1,0
34,308,308,10,2,8,3,2
15,309,309,3,3,0,1,0
9,316,316,86,53,33,2,1
31,357,357,57,57,0,1,0
19,364,364,22,8,14,2,1
24,378,378,8,2,6,3,2
10,379,379,36,36,0,1,0
26,400,400,105,105,0,1,0
8,403,403,26,15,11,2,1
18,424,424,25,25,0,1,0
17,432,432,116,91,25,2,1
1,437,437,34,34,0,1,0
28,456,456,52,9,43,2,1
29,456,456,75,41,34,3,2
4,466,466,98,52,46,4,3
0,468,468,32,15,17,2,1

31,101,101,6,6,0,1,0
1,105,105,5,5,0,1,0
4,106,106,3,3,0,1,0
12,114,114,1,1,0,1,0
0,121,121,1,1,0,1,0
28,132,132,4,4,0,1,0
26,135,135,13,13,0,1,0
18,139,139,7,4,3,2,1
35,151,151,10,7,3,2,1
3,163,163,49,44,5,2,1
5,166,166,20,20,0,1,0
33,200,200,6,6,0,1,0
21,207,207,59,45,14,2,1
19,218,218,16,2,14,3,2
15,222,222,2,2,0,1,0
24,235,235,1,1,0,1,0
6,236,236,5,1,4,2,1
23,247,247,19,19,0,1,0
7,250,250,16,16,0,1,0
9,254,254,38,24,14,3,2
34,263,263,23,5,18,2,1
32,267,267,9,4,5,2,1
11,297,297,38,8,30,2,1
22,311,311,27,27,0,1,0
20,321,321,9,9,0,1,0
13,322,322,22,22,0,1,0
38,352,352,24,8,16,3,2
27,371,371,11,11,0,1,0
16,394,394,62,46,16,2,1
2,400,400,16,16,0,1,0
29,401,401,3,3,0,1,0
40,402,402,17,17,0,1,0
36,432,432,159,159,0,1,0
39,439,439,40,25,15,2,1
17,443,443,1,1,0,1,0
8,447,447,37,9,28,2,1
10,458,458,1,1,0,1,0
30,460,460,1,1,0,1,0
25,476,476,214,214,0,1,0
37,476,476,137,104,33,2,1
14,486,486,19,19,0,1,0

3,129,129,33,33,0,1,0
8,130,130,4,4,0,1,0
33,137,137,4,4,0,1,0
28,146,146,1,1,0,1,0
14,169,169,16,16,0,1,0
30,190,190,54,54,0,1,0
4,195,195,2,2,0,1,0
31,205,205,9,9,0,1,0
27,207,207,24,20,4,2,1
2,213,213,9,9,0,1,0
38,231,231,26,9,17,2,1
0,232,232,8,4,4,2,1
25,246,246,80,80,0,1,0
16,258,258,53,27,26,3,2
9,270,270,31,5,26,2,1
5,291,291,23,23,0,1,0
12,294,294,13,13,0,1,0
29,298,298,8,1,7,2,1
37,320,320,23,7,16,3,2
1,346,346,18,6,12,4,3
22,362,362,81,81,0,1,0
10,375,375,7,7,0,1,0
32,378,378,113,75,38,3,2
18,379,379,113,113,0,1,0
15,384,384,88,88,0,1,0
34,394,394,13,2,11,2,1
21,394,394,41,41,0,1,0
35,406,406,4,1,3,2,1
17,410,410,23,23,0,1,0
26,412,412,8,8,0,1,0
36,420,420,30,30,0,1,0
19,422,422,24,18,6,2,1
6,426,426,3,3,0,1,0
11,457,457,3,3,0,1,0
20,479,479,36,36,0,1,0
23,489,489,17,17,0,1,0
7,490,490,25,25,0,1,0
24,496,496,11,11,0,1,0
13,498,498,19,7,12,2,1

26,114,114,9,9,0,1,0
30,121,121,25,25,0,1,0
7,122,122,2,2,0,1,0
24,128,128,7,7,0,1,0
16,133,133,11,11,0,1,0
11,134,134,11,3,8,3,2
31,164,164,5,5,0,1,0
3,175,175,14,5,9,4,3
8,176,176,11,11,0,1,0
32,187,187,10,2,8,3,2
19,208,208,83,83,0,1,0
33,209,209,23,23,0,1,0
6,211,211,14,9,5,2,1
5,213,213,18,18,0,1,0
4,222,222,1,1,0,1,0
27,254,254,12,12,0,1,0
25,290,290,44,14,30,4,3
14,298,298,14,8,6,2,1
21,300,300,11,2,9,2,1
17,331,331,21,21,0,1,0
22,336,336,45,45,0,1,0
1,352,352,107,33,74,3,2
15,369,369,72,31,41,2,1
23,388,388,10,10,0,1,0
9,393,393,113,81,32,2,1
10,397,397,9,9,0,1,0
28,398,398,62,11,51,4,3
18,402,402,37,26,11,2,1
12,411,411,39,18,21,2,1
13,412,412,120,33,87,4,3
2,437,437,23,23,0,1,0
29,456,456,49,16,33,4,3
0,486,486,54,23,31,2,1
20,489,489,5,5,0,1,0

4,124,124,1,1,0,1,0
13,129,129,4,4,0,1,0
29,131,131,68,64,4,2,1
32,143,143,12,12,0,1,0
5,146,146,24,9,15,2,1
8,158,158,1,1,0,1,0
14,172,172,11,3,8,2,1
6,179,179,1,1,0,1,0
15,187,187,1,1,0,1,0
7,204,204,1,1,0,1,0
11,224,224,32,18,14,3,2
19,251,251,43,29,14,3,2
18,255,255,9,9,0,1,0
23,259,259,12,12,0,1,0
31,260,260,10,10,0,1,0
27,282,282,59,11,48,3,2
2,309,309,106,56,50,3,2
17,318,318,10,5,5,2,1
20,347,347,31,5,26,4,3
12,372,372,11,11,0,1,0
25,379,379,81,81,0,1,0
1,380,380,152,64,88,3,2
16,381,381,5,5,0,1,0
10,385,385,199,136,63,4,3
30,385,385,35,7,28,2,1
21,430,430,64,56,8,3,2
26,436,436,18,6,12,3,2
9,437,437,11,2,9,2,1
0,438,438,1,1,0,1,0
28,439,439,4,4,0,1,0
22,440,440,16,16,0,1,0
3,459,459,26,21,5,2,1
24,475,475,26,22,4,2,1

17,106,106,1,1,0,1,0
5,155,155,27,27,0,1,0
22,157,157,33,15,18,2,1
0,160,160,36,12,24,2,1
11,162,162,44,44,0,1,0
21,163,163,38,6,32,3,2
1,165,165,4,1,3,2,1
29,171,171,9,9,0,1,0
7,192,192,8,3,5,2,1
18,207,207,23,1,22,4,3
10,217,217,29,2,27,4,3
16,224,224,26,2,24,2,1
27,269,269,84,84,0,1,0
15,289,289,44,28,16,3,2
14,289,289,11,11,0,1,0
30,302,302,5,5,0,1,0
19,311,311,6,6,0,1,0
25,320,320,55,12,43,2,1
3,322,322,54,54,0,1,0
26,337,337,15,15,0,1,0
6,340,340,134,122,12,3,2
20,363,363,72,72,0,1,0
13,366,366,29,29,0,1,0
9,377,377,24,15,9,4,3
4,381,381,13,13,0,1,0
23,383,383,11,11,0,1,0
2,406,406,27,20,7,2,1
24,408,408,1,1,0,1,0
12,411,411,50,2,48,4,3
8,414,414,34,34,0,1,0
28,447,447,20,20,0,1,0

1,116,116,11,11,0,1,0
27,118,118,18,18,0,1,0
28,119,119,9,5,4,2,1
25,126,126,3,3,0,1,0
13,158,158,10,10,0,1,0
24,170,170,25,25,0,1,0
17,173,173,6,1,5,2,1
5,197,197,5,1,4,2,1
9,205,205,1,1,0,1,0
23,215,215,2,2,0,1,0
14,231,231,78,78,0,1,0
34,235,235,42,21,21,4,3
37,249,249,2,2,0,1,0
26,263,263,14,14,0,1,0
11,270,270,77,5,72,3,2
0,274,274,16,4,12,2,1
35,279,279,32,2,30,4,3
15,287,287,5,5,0,1,0
10,291,291,2,2,0,1,0
31,295,295,142,134,8,2,1
7,296,296,16,16,0,1,0
22,301,301,16,7,9,2,1
20,306,306,15,3,12,3,2
29,308,308,40,27,13,2,1
32,309,309,18,2,16,3,2
2,310,310,1,1,0,1,0
6,327,327,17,17,0,1,0
33,348,348,16,16,0,1,0
4,355,355,82,13,69,4,3
38,373,373,10,10,0,1,0
19,399,399,3,3,0,1,0
21,428,428,99,31,68,4,3
16,431,431,41,41,0,1,0
12,455,455,90,21,69,3,2
3,456,456,19,19,0,1,0
30,471,471,5,5,0,1,0
36,485,485,20,20,0,1,0
8,487,487,68,60,8,2,1
18,491,491,1,1,0,1,0

21,104,104,6,6,0,1,0
33,107,107,15,15,0,1,0
2,108,108,16,8,8,2,1
22,109,109,40,40,0,1,0
14,112,112,1,1,0,1,0
18,125,125,6,6,0,1,0
9,133,133,1,1,0,1,0
23,133,133,3,3,0,1,0
35,142,142,12,9,3,2,1
5,146,146,22,22,0,1,0
1,158,158,27,27,0,1,0
0,169,169,9,1,8,2,1
6,211,211,1,1,0,1,0
38,217,217,27,5,22,3,2
26,229,229,38,38,0,1,0
19,229,229,65,15,50,2,1
3,231,231,8,8,0,1,0
32,247,247,20,20,0,1,0
10,258,258,4,1,3,2,1
8,279,279,11,5,6,2,1
27,287,287,3,3,0,1,0
16,290,290,68,12,56,3,2
7,293,293,6,6,0,1,0
24,317,317,27,27,0,1,0
4,318,318,21,21,0,1,0
31,324,324,17,17,0,1,0
37,349,349,12,12,0,1,0
12,354,354,3,3,0,1,0
17,377,377,84,34,50,3,2
15,378,378,1,1,0,1,0
11,395,395,33,18,15,4,3
29,403,403,36,16,20,2,1
30,415,415,21,21,0,1,0
13,421,421,9,3,6,3,2
34,432,432,12,12,0,1,0
28,454,454,132,105,27,2,1
20,487,487,86,62,24,3,2
25,491,491,8,2,6,3,2
36,499,499,74,74,0,1,0

4,116,116,5,5,0,1,0
9,159,159,21,21,0,1,0
3,185,185,15,15,0,1,0
19,202,202,28,28,0,1,0
20,215,215,4,4,0,1,0
22,219,219,29,23,6,2,1
25,223,223,27,3,24,4,3
34,228,228,2,2,0,1,0
15,238,238,3,3,0,1,0
6,238,238,31,31,0,1,0
24,242,242,9,5,4,2,1
21,245,245,82,30,52,3,2
16,257,257,8,8,0,1,0
8,270,270,61,61,0,1,0
33,271,271,16,1,15,2,1
28,279,279,49,8,41,2,1
27,305,305,31,10,21,4,3
12,323,323,28,4,24,2,1
29,325,325,26,26,0,1,0
7,331,331,42,42,0,1,0
5,334,334,28,28,0,1,0
32,340,340,8,3,5,2,1
17,342,342,42,5,37,3,2
30,379,379,7,7,0,1,0
11,382,382,42,16,26,2,1
31,413,413,41,11,30,4,3
10,432,432,33,33,0,1,0
14,439,439,1,1,0,1,0
23,443,443,64,64,0,1,0
1,445,445,74,74,0,1,0
18,451,451,39,39,0,1,0
2,456,456,33,13,20,2,1
13,479,479,110,110,0,1,0
26,481,481,62,26,36,4,3
0,487,487,94,69,25,3,2

38,105,105,4,4,0,1,0
30,114,114,1,1,0,1,0
4,120,120,14,6,8,3,2
23,173,173,27,11,16,3,2
32,177,177,45,45,0,1,0
19,193,193,6,6,0,1,0
20,197,197,10,7,3,2,1
9,208,208,4,1,3,2,1
37,209,209,19,19,0,1,0
31,215,215,11,3,8,3,2
34,229,229,25,15,10,2,1
21,233,233,19,5,14,2,1
7,235,235,31,24,7,2,1
3,251,251,25,25,0,1,0
6,253,253,14,6,8,2,1
22,261,261,46,46,0,1,0
35,261,261,48,2,46,4,3
15,266,266,24,24,0,1,0
25,269,269,72,63,9,4,3
14,282,282,25,25,0,1,0
11,290,290,39,39,0,1,0
5,294,294,117,113,4,2,1
36,313,313,3,3,0,1,0
28,321,321,11,11,0,1,0
16,331,331,5,5,0,1,0
13,336,336,8,8,0,1,0
26,338,338,29,17,12,3,2
1,345,345,37,37,0,1,0
2,346,346,14,14,0,1,0
24,362,362,39,1,38,4,3
18,369,369,2,2,0,1,0
10,422,422,22,22,0,1,0
27,452,452,11,6,5,2,1
29,456,456,3,3,0,1,0
8,466,466,41,41,0,1,0
0,470,470,51,9,42,4,3
33,471,471,69,65,4,2,1
17,494,494,49,49,0,1,0
12,499,499,23,9,14,2,1

34,100,100,1,1,0,1,0
13,103,103,6,6,0,1,0
32,107,107,6,6,0,1,0
6,119,119,2,2,0,1,0
33,131,131,1,1,0,1,0
25,151,151,6,6,0,1,0
24,154,154,26,26,0,1,0
11,172,172,8,5,3,2,1
2,179,179,29,16,13,2,1
10,180,180,2,2,0,1,0
20,190,190,9,3,6,3,2
23,190,190,12,5,7,2,1
26,214,214,9,3,6,2,1
5,219,219,7,1,6,3,2
27,261,261,66,47,19,2,1
0,294,294,22,22,0,1,0
37,295,295,25,25,0,1,0
1,312,312,1,1,0,1,0
9,317,317,17,9,8,2,1
18,318,318,10,10,0,1,0
14,342,342,116,71,45,2,1
21,362,362,31,31,0,1,0
35,373,373,80,80,0,1,0
22,380,380,21,21,0,1,0
15,390,390,23,23,0,1,0
17,391,391,28,23,5,2,1
28,397,397,32,24,8,2,1
39,407,407,12,12,0,1,0
16,407,407,74,74,0,1,0
7,407,407,7,7,0,1,0
38,408,408,45,35,10,2,1
12,411,411,40,34,6,3,2
4,415,415,24,24,0,1,0
30,430,430,92,41,51,4,3
36,439,439,26,26,0,1,0
8,441,441,13,13,0,1,0
29,462,462,24,24,0,1,0
19,465,465,41,27,14,3,2
31,476,476,29,1,28,3,2
3,481,481,57,4,53,3,2
41,488,488,99,15,84,4,3
40,493,493,75,75,0,1,0

5,107,107,17,6,11,2,1
9,107,107,6,6,0,1,0
20,116,116,4,4,0,1,0
19,116,116,2,2,0,1,0
32,127,127,1,1,0,1,0
30,144,144,38,20,18,4,3
15,147,147,23,23,0,1,0
13,147,147,8,1,7,2,1
31,148,148,2,2,0,1,0
8,155,155,29,19,10,2,1
28,158,158,15,15,0,1,0
0,198,198,12,5,7,2,1
24,216,216,14,4,10,2,1
27,230,230,5,5,0,1,0
4,237,237,33,13,20,3,2
36,254,254,54,54,0,1,0
10,284,284,53,53,0,1,0
22,284,284,29,15,14,3,2
35,302,302,127,1,126,4,3
29,311,311,15,9,6,2,1
12,334,334,9,9,0,1,0
7,337,337,1,1,0,1,0
25,337,337,60,40,20,3,2
17,354,354,59,59,0,1,0
14,362,362,15,10,5,2,1
33,419,419,5,5,0,1,0
23,422,422,5,5,0,1,0
3,425,425,19,4,15,2,1
34,433,433,15,10,5,2,1
1,435,435,68,68,0,1,0
26,444,444,3,3,0,1,0
11,450,450,27,12,15,4,3
2,465,465,41,27,14,2,1
6,474,474,6,2,4,2,1
18,476,476,28,28,0,1,0
21,485,485,19,6,13,2,1
37,490,490,131,90,41,2,1
16,499,499,66,66,0,1,0

31,142,142,33,33,0,1,0
6,171,171,25,14,11,2,1
5,173,173,1,1,0,1,0
3,211,211,19,1,18,3,2
23,226,226,35,35,0,1,0
21,247,247,3,3,0,1,0
7,252,252,23,23,0,1,0
28,257,257,27,1,26,2,1
8,265,265,3,3,0,1,0
16,282,282,15,2,13,4,3
15,298,298,3,3,0,1,0
17,303,303,6,6,0,1,0
26,309,309,23,10,13,4,3
2,319,319,111,111,0,1,0
9,320,320,18,18,0,1,0
14,323,323,49,49,0,1,0
1,348,348,45,8,37,2,1
29,353,353,34,34,0,1,0
27,365,365,12,12,0,1,0
24,373,373,19,10,9,4,3
0,376,376,17,2,15,4,3
11,395,395,103,103,0,1,0
32,399,399,5,5,0,1,0
13,402,402,8,8,0,1,0
22,407,407,26,12,14,2,1
20,424,424,51,51,0,1,0
10,436,436,23,17,6,2,1
19,442,442,28,28,0,1,0
33,442,442,79,51,28,3,2
4,459,459,56,11,45,4,3
30,472,472,24,16,8,3,2
12,477,477,124,116,8,2,1
25,478,478,30,30,0,1,0
18,494,494,219,159,60,4,3

8,101,101,1,1,0,1,0
25,102,102,3,3,0,1,0
26,122,122,1,1,0,1,0
13,123,123,5,5,0,1,0
3,125,125,51,20,31,2,1
17,135,135,16,16,0,1,0
12,155,155,20,20,0,1,0
7,161,161,6,6,0,1,0
34,165,165,1,1,0,1,0
32,172,172,18,18,0,1,0
5,190,190,13,1,12,3,2
20,229,229,72,39,33,4,3
31,243,243,14,8,6,2,1
29,252,252,60,11,49,2,1
1,259,259,25,25,0,1,0
35,262,262,8,8,0,1,0
24,262,262,4,4,0,1,0
0,268,268,16,10,6,3,2
6,269,269,48,2,46,2,1
30,281,281,4,4,0,1,0
11,286,286,4,4,0,1,0
28,316,316,36,13,23,2,1
10,340,340,22,22,0,1,0
2,342,342,64,16,48,2,1
16,346,346,8,8,0,1,0
22,356,356,15,6,9,4,3
9,384,384,23,23,0,1,0
19,435,435,79,44,35,2,1
27,443,443,139,139,0,1,0
4,444,444,10,10,0,1,0
15,444,444,44,31,13,4,3
23,450,450,31,11,20,3,2
14,460,460,86,86,0,1,0
18,460,460,35,2,33,4,3
33,481,481,40,40,0,1,0
21,491,491,69,69,0,1,0

14,113,113,8,3,5,2,1
24,155,155,20,10,10,2,1
22,161,161,24,24,0,1,0
33,173,173,37,37,0,1,0
7,178,178,1,1,0,1,0
23,194,194,43,10,33,4,3
4,201,201,40,40,0,1,0
31,214,214,12,9,3,2,1
9,252,252,1,1,0,1,0
26,261,261,25,25,0,1,0
15,274,274,84,72,12,4,3
10,274,274,45,17,28,3,2
30,285,285,18,18,0,1,0
25,285,285,6,6,0,1,0
13,286,286,19,19,0,1,0
12,294,294,6,6,0,1,0
28,326,326,16,16,0,1,0
21,329,329,76,4,72,4,3
3,344,344,3,3,0,1,0
32,349,349,1,1,0,1,0
19,362,362,139,139,0,1,0
5,375,375,17,6,11,2,1
29,378,378,28,24,4,2,1
11,402,402,25,25,0,1,0
1,412,412,82,22,60,3,2
2,447,447,180,112,68,3,2
27,448,448,19,13,6,2,1
0,468,468,9,9,0,1,0
16,468,468,7,7,0,1,0
20,483,483,8,1,7,2,1
18,490,490,8,8,0,1,0
6,494,494,105,105,0,1,0
17,494,494,29,3,26,2,1
8,497,497,8,3,5,2,1

22,114,114,1,1,0,1,0
9,115,115,53,53,0,1,0
26,125,125,15,15,0,1,0
1,125,125,20,11,9,4,3
15,133,133,2,2,0,1,0
6,155,155,25,25,0,1,0
2,160,160,4,1,3,2,1
33,176,176,3,3,0,1,0
13,177,177,1,1,0,1,0
25,197,197,5,1,4,2,1
7,208,208,12,12,0,1,0
8,210,210,6,6,0,1,0
27,234,234,34,34,0,1,0
29,243,243,47,16,31,4,3
20,244,244,18,18,0,1,0
3,251,251,14,2,12,3,2
31,260,260,32,2,30,3,2
0,268,268,4,4,0,1,0
30,292,292,8,8,0,1,0
14,311,311,40,22,18,2,1
12,315,315,9,9,0,1,0
17,331,331,40,40,0,1,0
23,342,342,62,62,0,1,0
10,344,344,49,35,14,3,2
4,344,344,36,36,0,1,0
24,352,352,67,67,0,1,0
28,355,355,56,56,0,1,0
34,378,378,16,16,0,1,0
5,409,409,83,11,72,4,3
35,416,416,21,21,0,1,0
21,436,436,45,45,0,1,0
11,464,464,39,39,0,1,0
32,476,476,130,130,0,1,0
18,481,481,28,28,0,1,0
19,489,489,22,22,0,1,0
16,493,493,3,3,0,1,0

0,104,104,3,3,0,1,0
11,149,149,9,9,0,1,0
10,156,156,11,11,0,1,0
26,161,161,1,1,0,1,0
17,173,173,21,21,0,1,0
4,181,181,22,2,20,3,2
6,217,217,31,24,7,2,1
27,230,230,26,20,6,2,1
1,258,258,102,52,50,3,2
31,268,268,3,3,0,1,0
28,269,269,12,12,0,1,0
16,274,274,50,50,0,1,0
19,281,281,18,18,0,1,0
13,283,283,70,70,0,1,0
20,294,294,14,14,0,1,0
7,298,298,15,15,0,1,0
24,301,301,9,3,6,3,2
14,312,312,20,20,0,1,0
12,312,312,1,1,0,1,0
23,316,316,66,26,40,2,1
21,340,340,30,6,24,3,2
22,362,362,34,4,30,2,1
15,382,382,106,106,0,1,0
30,399,399,27,27,0,1,0
3,407,407,9,1,8,3,2
8,421,421,13,13,0,1,0
25,425,425,63,12,51,4,3
32,434,434,27,27,0,1,0
5,455,455,2,2,0,1,0
18,459,459,64,56,8,2,1
9,461,461,232,172,60,4,3
29,469,469,58,44,14,2,1
2,490,490,28,1,27,4,3

37,115,115,7,7,0,1,0
32,148,148,43,13,30,3,2
22,166,166,10,4,6,2,1
2,169,169,1,1,0,1,0
18,175,175,21,3,18,3,2
8,179,179,1,1,0,1,0
33,215,215,61,54,7,2,1
23,219,219,15,5,10,2,1
12,228,228,8,8,0,1,0
10,241,241,12,6,6,3,2
5,274,274,22,22,0,1,0
20,296,296,3,3,0,1,0
14,302,302,17,17,0,1,0
34,314,314,76,76,0,1,0
30,320,320,41,41,0,1,0
27,325,325,49,29,20,2,1
39,339,339,43,2,41,2,1
19,349,349,7,7,0,1,0
21,352,352,14,14,0,1,0
29,359,359,25,16,9,2,1
17,362,362,32,2,30,4,3
0,384,384,62,62,0,1,0
16,389,389,4,4,0,1,0
31,396,396,46,46,0,1,0
38,397,397,2,2,0,1,0
35,398,398,11,11,0,1,0
4,412,412,3,3,0,1,0
25,414,414,31,31,0,1,0
26,414,414,8,3,5,2,1
1,418,418,21,21,0,1,0
3,427,427,67,36,31,2,1
15,430,430,201,141,60,4,3
13,458,458,61,53,8,3,2
36,459,459,12,12,0,1,0
28,480,480,9,9,0,1,0
7,480,480,21,21,0,1,0
6,485,485,66,46,20,2,1
24,494,494,30,30,0,1,0
9,494,494,14,2,12,3,2
11,497,497,47,4,43,2,1

13,109,109,2,2,0,1,0
11,110,110,18,18,0,1,0
4,124,124,9,3,6,2,1
24,126,126,10,10,0,1,0
3,134,134,6,3,3,2,1
7,168,168,25,25,0,1,0
9,194,194,37,37,0,1,0
22,203,203,11,1,10,3,2
5,225,225,114,60,54,4,3
20,254,254,26,26,0,1,0
30,257,257,22,16,6,3,2
17,260,260,26,26,0,1,0
15,271,271,22,22,0,1,0
32,273,273,34,12,22,4,3
28,318,318,13,1,12,4,3
8,339,339,21,21,0,1,0
33,340,340,6,1,5,2,1
19,349,349,33,33,0,1,0
0,351,351,1,1,0,1,0
21,353,353,4,4,0,1,0
16,362,362,48,6,42,2,1
29,375,375,66,66,0,1,0
18,378,378,58,58,0,1,0
10,405,405,95,89,6,3,2
25,409,409,118,118,0,1,0
6,434,434,56,8,48,4,3
27,443,443,19,19,0,1,0
2,447,447,20,20,0,1,0
1,456,456,23,23,0,1,0
12,463,463,10,10,0,1,0
26,478,478,32,16,16,3,2
23,487,487,4,4,0,1,0
14,491,491,14,8,6,2,1
31,497,497,126,119,7,2,1

33,106,106,8,8,0,1,0
20,118,118,7,7,0,1,0
13,128,128,1,1,0,1,0
1,131,131,1,1,0,1,0
30,139,139,11,11,0,1,0
10,148,148,1,1,0,1,0
16,168,168,11,11,0,1,0
27,168,168,68,35,33,4,3
35,177,177,19,8,11,2,1
39,208,208,10,10,0,1,0
18,210,210,10,10,0,1,0
24,211,211,33,33,0,1,0
32,219,219,20,7,13,2,1
5,225,225,10,6,4,2,1
25,265,265,3,3,0,1,0
29,273,273,66,50,16,2,1
26,279,279,25,9,16,2,1
28,295,295,10,10,0,1,0
14,298,298,1,1,0,1,0
34,304,304,3,3,0,1,0
0,306,306,36,16,20,3,2
31,308,308,6,6,0,1,0
4,332,332,7,2,5,2,1
7,335,335,49,27,22,2,1
9,336,336,70,49,21,2,1
19,346,346,8,8,0,1,0
21,351,351,109,23,86,4,3
6,369,369,13,13,0,1,0
36,373,373,3,3,0,1,0
17,384,384,65,65,0,1,0
37,387,387,58,58,0,1,0
2,390,390,45,29,16,3,2
8,402,402,54,54,0,1,0
3,424,424,3,3,0,1,0
12,427,427,16,16,0,1,0
22,428,428,13,4,9,4,3
38,453,453,48,48,0,1,0
15,461,461,75,75,0,1,0
23,466,466,85,44,41,4,3
11,489,489,34,19,15,4,3

27,102,102,3,3,0,1,0
29,103,103,7,4,3,2,1
15,117,117,8,3,5,2,1
9,119,119,6,6,0,1,0
1,125,125,3,3,0,1,0
16,133,133,17,8,9,4,3
25,138,138,11,11,0,1,0
11,140,140,17,17,0,1,0
21,159,159,7,1,6,3,2
19,160,160,9,9,0,1,0
20,184,184,42,42,0,1,0
13,191,191,32,32,0,1,0
22,193,193,5,5,0,1,0
10,194,194,72,27,45,2,1
14,197,197,21,18,3,2,1
28,211,211,51,12,39,3,2
24,215,215,10,1,9,2,1
17,243,243,10,10,0,1,0
3,249,249,60,60,0,1,0
5,250,250,10,10,0,1,0
6,274,274,1,1,0,1,0
2,302,302,10,10,0,1,0
8,312,312,7,7,0,1,0
18,326,326,2,2,0,1,0
33,332,332,13,13,0,1,0
32,344,344,19,3,16,3,2
4,353,353,20,20,0,1,0
35,397,397,135,80,55,3,2
23,399,399,3,3,0,1,0
26,407,407,9,9,0,1,0
34,412,412,109,105,4,2,1
31,428,428,16,1,15,4,3
30,464,464,112,103,9,2,1
12,482,482,146,110,36,3,2
7,486,486,9,9,0,1,0
0,496,496,2,2,0,1,0

20,104,104,8,8,0,1,0
29,105,105,13,13,0,1,0
4,140,140,1,1,0,1,0
12,148,148,29,29,0,1,0
10,161,161,40,25,15,4,3
7,167,167,33,33,0,1,0
1,170,170,25,25,0,1,0
0,177,177,25,3,22,2,1
5,187,187,59,19,40,2,1
11,207,207,20,12,8,2,1
8,224,224,19,13,6,2,1
16,241,241,39,23,16,4,3
19,252,252,11,11,0,1,0
18,257,257,5,1,4,2,1
25,279,279,25,13,12,4,3
28,285,285,15,15,0,1,0
6,317,317,31,31,0,1,0
14,351,351,18,4,14,2,1
3,371,371,16,16,0,1,0
17,377,377,4,4,0,1,0
24,379,379,1,1,0,1,0
13,413,413,55,13,42,3,2
21,420,420,73,9,64,3,2
15,429,429,59,38,21,4,3
31,438,438,12,12,0,1,0
9,449,449,35,2,33,3,2
27,450,450,75,75,0,1,0
26,453,453,8,5,3,2,1
22,454,454,71,71,0,1,0
30,459,459,228,228,0,1,0
23,462,462,12,2,10,2,1
2,496,496,7,1,6,2,1

3,107,107,20,20,0,1,0
22,112,112,27,1,26,3,2
1,116,116,2,2,0,1,0
26,122,122,3,3,0,1,0
4,124,124,17,17,0,1,0
31,129,129,12,12,0,1,0
36,138,138,48,15,33,3,2
18,140,140,18,18,0,1,0
13,141,141,19,4,15,4,3
19,145,145,6,6,0,1,0
8,161,161,4,4,0,1,0
6,173,173,1,1,0,1,0
16,178,178,11,11,0,1,0
21,181,181,13,13,0,1,0
12,187,187,6,1,5,2,1
40,188,188,5,5,0,1,0
38,198,198,110,14,96,4,3
5,202,202,3,3,0,1,0
32,219,219,22,6,16,2,1
24,229,229,11,11,0,1,0
28,241,241,38,38,0,1,0
25,243,243,26,2,24,3,2
20,248,248,34,34,0,1,0
37,253,253,10,1,9,2,1
7,276,276,2,2,0,1,0
14,279,279,38,26,12,3,2
30,289,289,11,11,0,1,0
10,297,297,13,7,6,3,2
9,315,315,24,24,0,1,0
29,315,315,29,29,0,1,0
0,359,359,3,3,0,1,0
27,360,360,44,28,16,2,1
39,362,362,6,6,0,1,0
34,372,372,8,8,0,1,0
11,390,390,32,32,0,1,0
17,392,392,30,18,12,4,3
15,406,406,5,2,3,2,1
35,429,429,1,1,0,1,0
2,474,474,60,60,0,1,0
23,489,489,14,14,0,1,0
33,495,495,7,7,0,1,0

31,105,105,21,9,12,3,2
18,115,115,8,5,3,2,1
12,125,125,9,3,6,3,2
7,139,139,7,4,3,2,1
10,140,140,1,1,0,1,0
28,143,143,26,7,19,4,3
23,177,177,1,1,0,1,0
1,187,187,14,14,0,1,0
0,215,215,1,1,0,1,0
3,218,218,17,2,15,2,1
4,232,232,76,76,0,1,0
13,238,238,18,18,0,1,0
8,250,250,17,17,0,1,0
34,251,251,32,8,24,4,3
35,252,252,16,16,0,1,0
22,252,252,26,2,24,2,1
30,255,255,83,51,32,4,3
26,316,316,20,20,0,1,0
29,319,319,58,21,37,4,3
20,328,328,23,9,14,3,2
9,328,328,104,5,99,4,3
32,333,333,1,1,0,1,0
15,340,340,6,1,5,2,1
33,349,349,36,36,0,1,0
24,369,369,63,63,0,1,0
19,371,371,2,2,0,1,0
16,396,396,87,33,54,3,2
27,417,417,60,60,0,1,0
2,424,424,1,1,0,1,0
11,430,430,2,2,0,1,0
21,464,464,6,1,5,2,1
14,476,476,10,3,7,2,1
5,484,484,42,42,0,1,0
17,484,484,46,25,21,4,3
6,490,490,136,136,0,1,0
25,498,498,3,3,0,1,0

16,110,110,2,2,0,1,0
3,120,120,1,1,0,1,0
12,120,120,4,1,3,2,1
20,128,128,1,1,0,1,0
25,130,130,29,18,11,2,1
30,162,162,6,6,0,1,0
4,166,166,6,6,0,1,0
39,172,172,18,18,0,1,0
8,180,180,58,58,0,1,0
11,186,186,34,34,0,1,0
33,190,190,11,11,0,1,0
40,203,203,81,81,0,1,0
32,213,213,6,6,0,1,0
1,222,222,15,5,10,2,1
38,229,229,21,21,0,1,0
0,242,242,11,1,10,2,1
2,244,244,27,1,26,4,3
36,249,249,1,1,0,1,0
24,257,257,37,37,0,1,0
5,269,269,11,11,0,1,0
13,284,284,25,9,16,2,1
42,299,299,23,3,20,2,1
6,300,300,20,4,16,3,2
10,310,310,28,28,0,1,0
19,312,312,7,7,0,1,0
22,316,316,1,1,0,1,0
31,344,344,27,6,21,2,1
28,345,345,35,5,30,4,3
21,357,357,54,54,0,1,0
9,366,366,70,4,66,3,2
26,390,390,27,10,17,2,1
29,393,393,31,28,3,2,1
41,403,403,6,6,0,1,0
18,423,423,1,1,0,1,0
34,426,426,4,4,0,1,0
27,445,445,27,27,0,1,0
14,447,447,32,17,15,4,3
23,452,452,1,1,0,1,0
37,462,462,100,100,0,1,0
35,465,465,86,8,78,4,3
15,479,479,26,26,0,1,0
7,492,492,12,12,0,1,0
17,495,495,8,1,7,2,1

16,102,102,3,3,0,1,0
8,110,110,12,12,0,1,0
3,110,110,17,5,12,4,3
13,126,126,1,1,0,1,0
11,177,177,26,16,10,3,2
19,191,191,19,3,16,2,1
5,198,198,19,19,0,1,0
14,204,204,6,6,0,1,0
1,226,226,16,16,0,1,0
27,231,231,63,50,13,2,1
26,254,254,2,2,0,1,0
20,257,257,19,8,11,2,1
9,266,266,5,5,0,1,0
4,284,284,56,56,0,1,0
10,286,286,19,2,17,2,1
23,286,286,13,13,0,1,0
15,331,331,70,6,64,3,2
17,344,344,88,38,50,2,1
6,363,363,10,2,8,3,2
25,368,368,21,6,15,4,3
22,392,392,95,95,0,1,0
2,407,407,345,287,58,3,2
18,436,436,48,36,12,2,1
0,467,467,47,15,32,3,2
24,470,470,50,50,0,1,0
12,476,476,27,27,0,1,0
21,488,488,12,12,0,1,0
7,497,497,89,68,21,4,3

2,100,100,1,1,0,1,0
12,111,111,3,3,0,1,0
4,126,126,1,1,0,1,0
5,155,155,29,15,14,3,2
9,182,182,19,19,0,1,0
20,185,185,7,7,0,1,0
10,191,191,30,22,8,3,2
24,194,194,7,2,5,2,1
21,197,197,5,5,0,1,0
3,198,198,8,1,7,2,1
43,204,204,15,15,0,1,0
16,205,205,15,7,8,3,2
6,217,217,17,17,0,1,0
35,223,223,25,25,0,1,0
0,231,231,1,1,0,1,0
34,233,233,19,10,9,4,3
29,236,236,20,11,9,4,3
13,236,236,24,24,0,1,0
31,253,253,53,53,0,1,0
23,272,272,27,27,0,1,0
22,287,287,3,3,0,1,0
27,298,298,17,5,12,4,3
26,304,304,23,23,0,1,0
18,324,324,70,22,48,4,3
1,331,331,26,26,0,1,0
42,336,336,15,15,0,1,0
11,343,343,35,4,31,4,3
15,346,346,5,5,0,1,0
7,347,347,13,13,0,1,0
41,358,358,17,17,0,1,0
17,360,360,19,19,0,1,0
32,366,366,23,12,11,2,1
38,381,381,59,24,35,3,2
36,382,382,67,54,13,2,1
14,384,384,3,3,0,1,0
8,398,398,41,13,28,2,1
40,403,403,21,1,20,3,2
30,410,410,50,50,0,1,0
19,442,442,20,13,7,2,1
33,464,464,73,59,14,2,1
25,471,471,67,63,4,2,1
37,472,472,140,14,126,4,3
28,482,482,6,1,5,2,1
39,493,493,4,4,0,1,0

2,111,111,14,8,6,3,2
24,122,122,9,9,0,1,0
10,127,127,12,12,0,1,0
20,139,139,14,14,0,1,0
35,153,153,6,2,4,2,1
39,157,157,12,12,0,1,0
18,168,168,8,8,0,1,0
12,169,169,9,9,0,1,0
19,174,174,1,1,0,1,0
34,197,197,14,8,6,3,2
3,200,200,29,8,21,4,3
40,206,206,72,18,54,4,3
9,214,214,24,24,0,1,0
7,232,232,1,1,0,1,0
32,261,261,2,2,0,1,0
31,293,293,39,39,0,1,0
30,302,302,25,20,5,2,1
23,324,324,4,4,0,1,0
27,325,325,31,12,19,3,2
26,326,326,6,6,0,1,0
0,327,327,21,21,0,1,0
17,333,333,3,3,0,1,0
8,338,338,6,6,0,1,0
37,361,361,21,3,18,4,3
1,372,372,35,35,0,1,0
33,372,372,71,57,14,2,1
13,394,394,45,45,0,1,0
11,408,408,16,4,12,3,2
21,419,419,27,17,10,4,3
28,422,422,25,10,15,2,1
38,424,424,35,35,0,1,0
4,428,428,17,17,0,1,0
16,438,438,92,21,71,4,3
14,438,438,34,34,0,1,0
5,440,440,1,1,0,1,0
36,444,444,69,57,12,4,3
25,452,452,143,108,35,3,2
15,456,456,143,73,70,4,3
29,456,456,5,5,0,1,0
22,465,465,4,4,0,1,0
6,468,468,27,1,26,3,2

2,104,104,7,7,0,1,0
24,115,115,18,3,15,4,3
10,131,131,16,16,0,1,0
0,150,150,18,18,0,1,0
29,161,161,1,1,0,1,0
17,177,177,1,1,0,1,0
5,180,180,24,10,14,3,2
26,184,184,10,10,0,1,0
8,194,194,37,37,0,1,0
6,215,215,16,6,10,2,1
25,222,222,9,9,0,1,0
21,235,235,3,3,0,1,0
15,245,245,4,1,3,2,1
19,247,247,14,2,12,3,2
34,253,253,4,4,0,1,0
22,262,262,22,7,15,4,3
20,263,263,55,55,0,1,0
27,271,271,26,26,0,1,0
3,290,290,13,9,4,2,1
13,297,297,5,5,0,1,0
37,299,299,2,2,0,1,0
30,304,304,28,28,0,1,0
7,344,344,30,30,0,1,0
33,345,345,9,9,0,1,0
31,352,352,35,6,29,2,1
11,358,358,20,5,15,4,3
4,372,372,107,85,22,3,2
23,383,383,21,13,8,2,1
35,398,398,22,10,12,4,3
1,448,448,90,29,61,4,3
14,462,462,49,39,10,2,1
12,473,473,9,4,5,2,1
18,478,478,64,64,0,1,0
32,488,488,14,1,13,2,1
36,489,489,229,183,46,4,3
9,493,493,29,23,6,3,2
28,494,494,159,69,90,4,3
16,498,498,2,2,0,1,0

18,113,113,7,7,0,1,0
7,113,113,15,15,0,1,0
32,118,118,5,5,0,1,0
9,143,143,22,22,0,1,0
6,146,146,29,29,0,1,0
27,200,200,36,3,33,4,3
12,221,221,12,12,0,1,0
8,239,239,1,1,0,1,0
25,247,247,1,1,0,1,0
10,257,257,17,11,6,2,1
29,269,269,42,42,0,1,0
15,284,284,70,70,0,1,0
23,288,288,9,9,0,1,0
20,291,291,16,16,0,1,0
28,299,299,24,13,11,2,1
13,299,299,8,8,0,1,0
26,303,303,6,6,0,1,0
1,305,305,49,37,12,4,3
4,312,312,93,93,0,1,0
22,316,316,23,8,15,2,1
21,318,318,16,16,0,1,0
14,331,331,39,39,0,1,0
19,333,333,40,31,9,2,1
24,353,353,44,44,0,1,0
30,363,363,14,14,0,1,0
5,396,396,51,21,30,2,1
0,421,421,98,98,0,1,0
2,424,424,44,4,40,2,1
3,438,438,1,1,0,1,0
31,462,462,122,98,24,3,2
11,473,473,57,57,0,1,0
16,477,477,109,109,0,1,0
17,496,496,26,26,0,1,0

0,110,110,33,33,0,1,0
23,113,113,9,5,4,2,1
7,131,131,3,3,0,1,0
14,131,131,11,11,0,1,0
25,138,138,5,2,3,2,1
26,150,150,22,22,0,1,0
17,159,159,26,26,0,1,0
18,169,169,3,3,0,1,0
24,211,211,8,8,0,1,0
19,220,220,24,19,5,2,1
3,226,226,5,5,0,1,0
12,232,232,10,10,0,1,0
10,242,242,54,46,8,2,1
22,247,247,28,22,6,2,1
20,251,251,48,48,0,1,0
11,275,275,34,34,0,1,0
1,289,289,43,43,0,1,0
13,315,315,17,17,0,1,0
16,318,318,84,84,0,1,0
21,341,341,50,46,4,2,1
9,348,348,5,2,3,2,1
29,382,382,70,32,38,3,2
27,417,417,55,37,18,4,3
8,434,434,151,151,0,1,0
28,444,444,6,6,0,1,0
15,447,447,11,11,0,1,0
2,460,460,1,1,0,1,0
5,464,464,155,120,35,2,1
6,476,476,97,97,0,1,0
4,490,490,28,6,22,2,1

15,110,110,2,2,0,1,0
20,114,114,36,25,11,2,1
13,121,121,9,3,6,2,1
0,141,141,45,45,0,1,0
17,163,163,24,15,9,4,3
29,165,165,15,15,0,1,0
32,173,173,12,12,0,1,0
22,174,174,8,4,4,2,1
30,187,187,32,3,29,2,1
28,195,195,28,28,0,1,0
1,201,201,11,11,0,1,0
5,208,208,2,2,0,1,0
8,213,213,5,5,0,1,0
4,247,247,1,1,0,1,0
11,263,263,1,1,0,1,0
18,276,276,23,23,0,1,0
14,280,280,80,14,66,3,2
10,291,291,15,7,8,2,1
3,356,356,15,15,0,1,0
23,381,381,38,8,30,2,1
6,416,416,171,90,81,4,3
24,417,417,1,1,0,1,0
25,417,417,1,1,0,1,0
2,428,428,85,53,32,3,2
19,433,433,19,19,0,1,0
9,450,450,56,36,20,3,2
7,462,462,80,80,0,1,0
16,467,467,2,2,0,1,0
21,469,469,4,4,0,1,0
31,470,470,23,23,0,1,0
27,482,482,249,249,0,1,0
12,488,488,12,4,8,3,2
26,493,493,10,10,0,1,0

35,100,100,2,2,0,1,0
15,112,112,1,1,0,1,0
33,116,116,13,4,9,2,1
26,135,135,21,1,20,3,2
23,138,138,4,4,0,1,0
40,142,142,1,1,0,1,0
39,145,145,24,24,0,1,0
5,160,160,1,1,0,1,0
0,163,163,2,2,0,1,0
16,177,177,8,8,0,1,0
36,178,178,5,5,0,1,0
14,184,184,22,13,9,2,1
4,200,200,15,15,0,1,0
42,209,209,13,13,0,1,0
25,214,214,5,5,0,1,0
46,231,231,9,9,0,1,0
2,246,246,23,5,18,2,1
32,277,277,19,8,11,4,3
22,281,281,13,2,11,2,1
43,287,287,3,3,0,1,0
34,295,295,58,58,0,1,0
8,301,301,30,30,0,1,0
20,304,304,1,1,0,1,0
1,304,304,8,8,0,1,0
3,329,329,97,74,23,2,1
18,358,358,9,5,4,2,1
28,365,365,10,10,0,1,0
17,365,365,6,6,0,1,0
38,382,382,68,35,33,2,1
29,394,394,12,12,0,1,0
37,396,396,23,17,6,2,1
21,397,397,47,47,0,1,0
13,411,411,51,51,0,1,0
30,414,414,30,6,24,4,3
19,416,416,11,11,0,1,0
41,425,425,16,16,0,1,0
12,426,426,6,6,0,1,0
10,428,428,39,21,18,3,2
27,432,432,24,8,16,3,2
45,437,437,92,92,0,1,0
7,450,450,45,4,41,2,1
6,451,451,8,1,7,2,1
24,461,461,20,11,9,2,1
11,462,462,17,17,0,1,0
44,464,464,91,65,26,2,1
31,469,469,164,140,24,4,3
9,478,478,31,31,0,1,0

20,116,116,4,4,0,1,0
27,121,121,21,21,0,1,0
35,130,130,4,4,0,1,0
8,134,134,9,9,0,1,0
23,166,166,14,14,0,1,0
31,177,177,46,2,44,3,2
14,182,182,8,8,0,1,0
24,193,193,50,50,0,1,0
25,199,199,5,5,0,1,0
18,203,203,15,1,14,2,1
2,203,203,28,16,12,2,1
5,207,207,21,21,0,1,0
4,251,251,1,1,0,1,0
11,252,252,3,3,0,1,0
9,252,252,50,8,42,4,3
10,256,256,4,4,0,1,0
29,268,268,9,9,0,1,0
1,274,274,21,21,0,1,0
19,278,278,45,45,0,1,0
22,284,284,21,6,15,4,3
12,286,286,10,4,6,2,1
15,298,298,92,11,81,3,2
16,301,301,15,15,0,1,0
17,327,327,45,38,7,2,1
13,334,334,79,17,62,4,3
3,337,337,9,9,0,1,0
0,345,345,38,6,32,2,1
30,360,360,108,108,0,1,0
6,361,361,10,2,8,2,1
7,362,362,50,14,36,4,3
33,408,408,10,10,0,1,0
36,410,410,61,61,0,1,0
34,420,420,39,39,0,1,0
26,422,422,2,2,0,1,0
32,437,437,3,3,0,1,0
28,447,447,4,1,3,2,1
21,461,461,51,15,36,4,3

28,101,101,8,8,0,1,0
31,117,117,3,3,0,1,0
18,117,117,6,1,5,2,1
10,122,122,23,3,20,2,1
15,133,133,4,4,0,1,0
13,147,147,6,6,0,1,0
24,167,167,41,19,22,3,2
36,170,170,81,81,0,1,0
5,194,194,13,13,0,1,0
23,198,198,10,10,0,1,0
14,212,212,9,9,0,1,0
22,226,226,7,7,0,1,0
4,243,243,23,23,0,1,0
0,246,246,26,13,13,2,1
3,250,250,13,1,12,3,2
1,254,254,17,8,9,3,2
21,263,263,14,14,0,1,0
2,274,274,47,30,17,2,1
33,297,297,16,16,0,1,0
20,299,299,33,21,12,2,1
29,299,299,12,12,0,1,0
37,310,310,29,25,4,2,1
32,344,344,12,4,8,3,2
38,357,357,29,6,23,4,3
35,368,368,15,6,9,2,1
12,370,370,15,15,0,1,0
16,372,372,20,1,19,2,1
9,373,373,4,1,3,2,1
11,394,394,2,2,0,1,0
8,400,400,39,39,0,1,0
30,403,403,24,6,18,4,3
26,411,411,48,48,0,1,0
17,417,417,46,46,0,1,0
25,442,442,32,32,0,1,0
34,442,442,4,4,0,1,0
27,455,455,125,59,66,3,2
19,466,466,10,5,5,2,1
7,477,477,205,205,0,1,0
6,478,478,5,5,0,1,0

20,104,104,13,13,0,1,0
22,110,110,19,1,18,3,2
10,115,115,31,3,28,3,2
0,154,154,42,10,32,3,2
9,160,160,17,17,0,1,0
21,179,179,11,7,4,2,1
17,179,179,16,8,8,3,2
11,207,207,49,49,0,1,0
14,212,212,7,1,6,3,2
5,222,222,35,23,12,2,1
25,230,230,31,31,0,1,0
27,235,235,5,5,0,1,0
29,272,272,4,4,0,1,0
7,292,292,54,54,0,1,0
1,293,293,3,3,0,1,0
13,300,300,1,1,0,1,0
8,304,304,50,2,48,2,1
19,316,316,27,1,26,3,2
16,322,322,40,8,32,3,2
23,344,344,3,3,0,1,0
2,347,347,6,6,0,1,0
15,367,367,62,62,0,1,0
26,378,378,88,88,0,1,0
6,384,384,15,3,12,2,1
24,426,426,8,1,7,2,1
4,426,426,16,16,0,1,0
28,459,459,20,20,0,1,0
3,477,477,145,118,27,4,3
18,480,480,9,9,0,1,0
12,490,490,234,210,24,4,3

5,114,114,24,2,22,3,2
9,115,115,16,16,0,1,0
11,131,131,1,1,0,1,0
29,143,143,19,19,0,1,0
23,146,146,9,9,0,1,0
8,149,149,11,11,0,1,0
2,158,158,14,4,10,3,2
22,161,161,23,3,20,3,2
27,204,204,67,18,49,4,3
18,213,213,19,19,0,1,0
32,214,214,2,2,0,1,0
15,223,223,2,2,0,1,0
30,228,228,41,41,0,1,0
19,234,234,6,6,0,1,0
33,239,239,10,4,6,3,2
13,250,250,4,4,0,1,0
3,256,256,35,35,0,1,0
12,277,277,81,73,8,2,1
16,324,324,71,71,0,1,0
26,333,333,47,47,0,1,0
10,345,345,8,8,0,1,0
31,350,350,20,3,17,3,2
6,363,363,49,32,17,2,1
28,367,367,17,17,0,1,0
20,372,372,48,12,36,2,1
25,378,378,3,3,0,1,0
14,385,385,81,37,44,3,2
17,400,400,2,2,0,1,0
0,406,406,19,14,5,2,1
34,407,407,14,14,0,1,0
4,423,423,34,18,16,3,2
21,427,427,82,47,35,3,2
24,451,451,93,77,16,2,1
1,478,478,22,22,0,1,0
7,490,490,33,33,0,1,0

26,169,169,35,20,15,4,3
9,182,182,41,5,36,3,2
10,193,193,15,15,0,1,0
30,195,195,11,4,7,2,1
4,198,198,46,46,0,1,0
28,199,199,61,61,0,1,0
18,204,204,48,24,24,2,1
6,216,216,72,22,50,2,1
20,239,239,16,16,0,1,0
23,296,296,31,7,24,3,2
16,301,301,14,11,3,2,1
21,304,304,1,1,0,1,0
22,313,313,10,10,0,1,0
11,325,325,24,21,3,2,1
14,327,327,11,2,9,2,1
3,355,355,17,11,6,2,1
5,357,357,92,58,34,3,2
25,375,375,33,15,18,4,3
17,388,388,15,7,8,3,2
13,395,395,42,6,36,2,1
29,396,396,20,3,17,2,1
15,402,402,53,53,0,1,0
19,406,406,49,49,0,1,0
24,409,409,45,45,0,1,0
7,420,420,13,13,0,1,0
12,436,436,10,7,3,2,1
8,437,437,11,4,7,2,1
2,459,459,5,2,3,2,1
1,462,462,120,69,51,4,3
0,468,468,95,62,33,2,1
27,480,480,44,44,0,1,0

23,120,120,9,9,0,1,0
29,128,128,20,20,0,1,0
19,154,154,11,11,0,1,0
12,169,169,17,17,0,1,0
14,177,177,1,1,0,1,0
13,178,178,102,26,76,3,2
24,196,196,7,7,0,1,0
25,222,222,5,5,0,1,0
10,228,228,10,2,8,2,1
11,230,230,93,45,48,3,2
20,233,233,20,12,8,3,2
9,254,254,29,20,9,4,3
18,254,254,62,10,52,3,2
8,265,265,4,4,0,1,0
16,284,284,18,18,0,1,0
0,288,288,7,1,6,3,2
30,294,294,41,41,0,1,0
2,299,299,149,22,127,4,3
15,316,316,2,2,0,1,0
26,331,331,1,1,0,1,0
3,339,339,25,25,0,1,0
27,369,369,23,9,14,3,2
7,372,372,4,4,0,1,0
5,386,386,24,24,0,1,0
6,390,390,27,16,11,2,1
17,391,391,6,6,0,1,0
22,434,434,38,12,26,3,2
21,435,435,78,6,72,4,3
1,454,454,37,2,35,2,1
28,462,462,6,6,0,1,0
4,463,463,142,40,102,4,3

17,109,109,5,1,4,2,1
3,124,124,5,5,0,1,0
29,138,138,14,14,0,1,0
12,149,149,6,6,0,1,0
31,150,150,1,1,0,1,0
22,153,153,22,7,15,3,2
10,180,180,29,1,28,3,2
1,182,182,12,12,0,1,0
8,198,198,7,7,0,1,0
9,206,206,1,1,0,1,0
16,208,208,5,2,3,2,1
40,212,212,27,27,0,1,0
38,215,215,47,47,0,1,0
37,219,219,2,2,0,1,0
28,221,221,23,13,10,3,2
34,236,236,7,7,0,1,0
42,237,237,1,1,0,1,0
6,241,241,31,31,0,1,0
26,242,242,88,88,0,1,0
35,246,246,29,5,24,3,2
39,253,253,87,87,0,1,0
11,258,258,53,53,0,1,0
33,284,284,12,4,8,3,2
24,299,299,12,12,0,1,0
2,309,309,4,4,0,1,0
41,316,316,20,20,0,1,0
15,327,327,14,14,0,1,0
18,327,327,54,18,36,4,3
27,343,343,27,2,25,3,2
21,344,344,8,5,3,2,1
13,364,364,15,15,0,1,0
36,370,370,57,6,51,4,3
7,373,373,7,7,0,1,0
32,375,375,3,3,0,1,0
4,377,377,66,66,0,1,0
20,385,385,11,11,0,1,0
25,415,415,14,14,0,1,0
23,416,416,11,5,6,2,1
0,422,422,22,22,0,1,0
19,423,423,30,26,4,2,1
5,452,452,91,47,44,3,2
14,464,464,4,4,0,1,0
30,486,486,12,12,0,1,0

5,126,126,1,1,0,1,0
10,132,132,4,4,0,1,0
3,134,134,8,8,0,1,0
35,139,139,13,13,0,1,0
29,155,155,30,30,0,1,0
15,176,176,11,11,0,1,0
28,191,191,50,50,0,1,0
7,192,192,28,28,0,1,0
30,204,204,5,5,0,1,0
34,206,206,13,8,5,2,1
36,208,208,1,1,0,1,0
25,216,216,5,1,4,2,1
23,232,232,22,18,4,2,1
19,234,234,12,2,10,4,3
8,235,235,53,53,0,1,0
13,271,271,47,9,38,3,2
17,276,276,12,2,10,3,2
33,284,284,72,22,50,3,2
24,285,285,4,1,3,2,1
11,288,288,7,7,0,1,0
16,300,300,21,7,14,4,3
31,312,312,15,15,0,1,0
4,314,314,123,48,75,4,3
2,318,318,23,23,0,1,0
22,344,344,47,47,0,1,0
27,375,375,3,3,0,1,0
9,379,379,26,10,16,2,1
0,392,392,16,4,12,2,1
20,406,406,120,85,35,2,1
14,414,414,66,11,55,4,3
18,420,420,4,4,0,1,0
1,449,449,27,27,0,1,0
6,468,468,26,18,8,2,1
21,476,476,7,7,0,1,0
12,483,483,48,9,39,2,1
26,485,485,77,35,42,2,1
32,491,491,49,5,44,3,2

21,105,105,14,3,11,2,1
4,109,109,21,18,3,2,1
18,111,111,11,3,8,2,1
28,122,122,16,16,0,1,0
29,144,144,4,4,0,1,0
32,154,154,22,7,15,2,1
20,157,157,20,10,10,2,1
15,161,161,7,7,0,1,0
5,169,169,34,3,31,2,1
30,185,185,45,5,40,3,2
26,185,185,7,7,0,1,0
2,195,195,16,16,0,1,0
22,196,196,5,5,0,1,0
0,203,203,5,5,0,1,0
9,222,222,16,16,0,1,0
17,226,226,5,5,0,1,0
7,263,263,16,5,11,2,1
14,277,277,23,3,20,2,1
19,279,279,27,27,0,1,0
12,288,288,46,34,12,2,1
24,314,314,10,10,0,1,0
10,336,336,147,90,57,4,3
25,367,367,21,21,0,1,0
16,373,373,1,1,0,1,0
33,379,379,181,112,69,4,3
11,382,382,55,3,52,3,2
23,388,388,21,6,15,4,3
31,391,391,40,4,36,3,2
27,450,450,18,8,10,3,2
13,456,456,20,2,18,2,1
3,460,460,55,55,0,1,0
6,475,475,3,3,0,1,0
8,480,480,44,44,0,1,0
1,481,481,19,19,0,1,0

30,111,111,33,8,25,2,1
17,112,112,1,1,0,1,0
3,122,122,1,1,0,1,0
21,123,123,2,2,0,1,0
33,129,129,4,4,0,1,0
5,170,170,8,8,0,1,0
16,198,198,8,8,0,1,0
27,204,204,1,1,0,1,0
15,224,224,2,2,0,1,0
20,250,250,6,6,0,1,0
8,259,259,29,29,0,1,0
11,261,261,36,36,0,1,0
6,271,271,70,28,42,2,1
2,275,275,8,5,3,2,1
28,289,289,85,85,0,1,0
22,290,290,50,50,0,1,0
14,322,322,46,14,32,3,2
1,353,353,16,1,15,2,1
0,359,359,1,1,0,1,0
26,375,375,103,74,29,3,2
12,376,376,73,53,20,4,3
24,381,381,8,8,0,1,0
29,392,392,12,12,0,1,0
13,396,396,36,17,19,3,2
10,397,397,17,4,13,4,3
23,406,406,8,8,0,1,0
32,413,413,12,12,0,1,0
7,425,425,50,50,0,1,0
31,436,436,76,5,71,4,3
18,444,444,92,9,83,4,3
19,448,448,73,19,54,3,2
9,457,457,221,188,33,2,1
4,484,484,38,38,0,1,0
25,496,496,21,21,0,1,0

29,100,100,4,1,3,2,1
14,101,101,7,3,4,2,1
31,104,104,6,2,4,2,1
24,152,152,49,23,26,3,2
18,158,158,45,15,30,3,2
13,159,159,29,25,4,2,1
30,160,160,18,18,0,1,0
22,172,172,3,3,0,1,0
12,175,175,40,8,32,3,2
6,180,180,1,1,0,1,0
7,183,183,1,1,0,1,0
16,185,185,50,50,0,1,0
27,193,193,4,4,0,1,0
17,198,198,1,1,0,1,0
3,205,205,17,1,16,2,1
10,210,210,24,10,14,2,1
2,211,211,16,13,3,2,1
4,223,223,30,30,0,1,0
15,230,230,45,45,0,1,0
20,243,243,5,2,3,2,1
0,284,284,10,1,9,2,1
11,307,307,29,21,8,3,2
28,329,329,110,47,63,4,3
5,335,335,59,59,0,1,0
23,336,336,36,2,34,2,1
1,375,375,36,36,0,1,0
19,375,375,10,2,8,2,1
26,379,379,2,2,0,1,0
8,403,403,94,79,15,4,3
9,427,427,31,13,18,2,1
25,458,458,10,3,7,2,1
33,471,471,59,59,0,1,0
32,472,472,19,11,8,3,2
21,484,484,17,17,0,1,0

8,101,101,6,6,0,1,0
18,103,103,6,6,0,1,0
7,107,107,11,11,0,1,0
16,107,107,1,1,0,1,0
21,146,146,24,4,20,2,1
3,166,166,27,27,0,1,0
25,168,168,5,2,3,2,1
28,172,172,6,2,4,2,1
4,189,189,10,10,0,1,0
15,197,197,3,3,0,1,0
13,226,226,81,60,21,2,1
22,247,247,55,55,0,1,0
9,254,254,4,1,3,2,1
30,277,277,2,2,0,1,0
10,278,278,53,53,0,1,0
11,304,304,7,2,5,2,1
17,312,312,31,1,30,4,3
31,320,320,24,24,0,1,0
24,334,334,10,10,0,1,0
19,344,344,78,12,66,4,3
35,345,345,53,22,31,2,1
33,355,355,26,18,8,3,2
14,364,364,19,6,13,2,1
5,381,381,17,9,8,2,1
32,390,390,155,101,54,4,3
0,391,391,50,50,0,1,0
26,398,398,42,19,23,2,1
2,418,418,4,4,0,1,0
34,425,425,54,54,0,1,0
36,445,445,3,3,0,1,0
12,445,445,176,176,0,1,0
29,451,451,22,12,10,2,1
23,452,452,11,11,0,1,0
6,453,453,11,6,5,2,1
1,456,456,1,1,0,1,0
20,465,465,10,10,0,1,0
27,472,472,37,37,0,1,0

2,102,102,21,6,15,4,3
30,103,103,2,2,0,1,0
5,111,111,10,4,6,2,1
29,113,113,20,1,19,3,2
15,127,127,1,1,0,1,0
35,154,154,25,4,21,2,1
17,163,163,8,8,0,1,0
20,167,167,1,1,0,1,0
19,200,200,26,26,0,1,0
1,202,202,17,17,0,1,0
22,207,207,16,7,9,2,1
31,208,208,19,1,18,4,3
32,211,211,5,1,4,2,1
6,211,211,11,8,3,2,1
7,217,217,15,15,0,1,0
28,221,221,34,24,10,3,2
25,230,230,13,13,0,1,0
4,236,236,49,37,12,2,1
11,251,251,1,1,0,1,0
21,255,255,7,4,3,2,1
0,265,265,33,33,0,1,0
27,279,279,8,8,0,1,0
34,296,296,139,112,27,2,1
12,309,309,11,5,6,3,2
3,326,326,41,34,7,2,1
26,363,363,48,48,0,1,0
13,379,379,35,2,33,2,1
24,380,380,6,6,0,1,0
18,390,390,30,2,28,3,2
23,409,409,7,7,0,1,0
8,413,413,3,3,0,1,0
14,431,431,80,80,0,1,0
33,458,458,84,84,0,1,0
10,471,471,51,51,0,1,0
16,499,499,31,27,4,2,1
9,500,500,147,69,78,4,3

30,103,103,5,5,0,1,0
7,110,110,13,9,4,2,1
5,115,115,8,2,6,2,1
11,122,122,26,26,0,1,0
29,154,154,9,9,0,1,0
2,175,175,19,2,17,2,1
24,208,208,34,25,9,4,3
4,219,219,24,7,17,2,1
12,219,219,28,28,0,1,0
13,243,243,7,7,0,1,0
28,243,243,6,6,0,1,0
20,246,246,31,31,0,1,0
33,254,254,3,3,0,1,0
26,262,262,9,9,0,1,0
31,264,264,53,35,18,3,2
9,268,268,1,1,0,1,0
32,293,293,1,1,0,1,0
8,298,298,16,16,0,1,0
23,319,319,6,6,0,1,0
16,323,323,13,13,0,1,0
14,324,324,103,63,40,3,2
3,326,326,20,1,19,4,3
18,333,333,29,29,0,1,0
21,340,340,125,105,20,2,1
10,360,360,21,21,0,1,0
27,399,399,186,138,48,4,3
22,418,418,27,21,6,2,1
25,446,446,6,6,0,1,0
1,455,455,1,1,0,1,0
15,455,455,121,121,0,1,0
19,458,458,3,3,0,1,0
17,472,472,44,44,0,1,0
6,480,480,23,23,0,1,0
0,486,486,104,104,0,1,0

21,100,100,9,9,0,1,0
37,109,109,25,25,0,1,0
24,114,114,18,2,16,2,1
6,121,121,6,6,0,1,0
13,153,153,5,5,0,1,0
29,175,175,27,27,0,1,0
26,187,187,1,1,0,1,0
33,220,220,1,1,0,1,0
32,222,222,1,1,0,1,0
5,227,227,2,2,0,1,0
0,254,254,25,1,24,4,3
34,269,269,10,2,8,3,2
25,273,273,24,24,0,1,0
18,279,279,61,3,58,3,2
2,286,286,49,6,43,2,1
27,306,306,45,45,0,1,0
3,321,321,46,8,38,3,2
28,336,336,20,20,0,1,0
30,339,339,5,1,4,2,1
20,356,356,53,2,51,4,3
14,375,375,14,2,12,4,3
15,392,392,10,10,0,1,0
1,397,397,81,57,24,4,3
9,398,398,36,24,12,4,3
10,405,405,1,1,0,1,0
8,416,416,6,2,4,2,1
12,421,421,37,22,15,4,3
11,423,423,117,117,0,1,0
4,437,437,21,21,0,1,0
22,451,451,31,31,0,1,0
35,453,453,131,131,0,1,0
36,459,459,58,9,49,2,1
19,463,463,2,2,0,1,0
23,474,474,17,17,0,1,0
16,477,477,68,39,29,4,3
7,477,477,22,1,21,2,1
17,480,480,47,37,10,2,1
31,480,480,86,86,0,1,0

26,109,109,19,19,0,1,0
2,118,118,4,4,0,1,0
14,125,125,21,21,0,1,0
21,144,144,5,1,4,2,1
4,153,153,57,57,0,1,0
16,163,163,13,13,0,1,0
11,176,176,6,6,0,1,0
0,185,185,82,82,0,1,0
25,199,199,6,6,0,1,0
10,212,212,65,65,0,1,0
5,219,219,2,2,0,1,0
19,228,228,15,9,6,3,2
24,258,258,8,2,6,2,1
6,281,281,32,8,24,3,2
22,284,284,20,6,14,3,2
20,305,305,109,34,75,3,2
17,319,319,40,40,0,1,0
23,328,328,13,13,0,1,0
18,355,355,44,22,22,3,2
7,360,360,61,11,50,4,3
1,380,380,161,113,48,4,3
9,409,409,17,17,0,1,0
27,420,420,6,6,0,1,0
15,458,458,24,18,6,2,1
8,462,462,5,5,0,1,0
3,468,468,86,46,40,3,2
13,470,470,26,8,18,4,3
12,475,475,41,4,37,4,3

31,105,105,1,1,0,1,0
4,114,114,13,5,8,3,2
5,123,123,31,31,0,1,0
30,129,129,2,2,0,1,0
17,132,132,14,14,0,1,0
6,134,134,3,3,0,1,0
3,137,137,24,13,11,2,1
34,155,155,20,20,0,1,0
35,171,171,33,11,22,2,1
32,175,175,41,41,0,1,0
22,189,189,4,4,0,1,0
28,190,190,4,1,3,2,1
18,219,219,6,6,0,1,0
33,220,220,11,11,0,1,0
21,277,277,13,1,12,3,2
36,290,290,72,15,57,4,3
16,293,293,23,7,16,3,2
10,305,305,7,3,4,2,1
26,327,327,32,8,24,3,2
27,340,340,3,3,0,1,0
8,346,346,5,1,4,2,1
23,348,348,70,70,0,1,0
9,350,350,1,1,0,1,0
37,358,358,12,12,0,1,0
11,369,369,9,9,0,1,0
13,394,394,31,20,11,4,3
20,396,396,77,77,0,1,0
14,400,400,56,2,54,3,2
19,407,407,15,15,0,1,0
24,423,423,32,9,23,2,1
15,433,433,55,3,52,3,2
0,438,438,11,2,9,3,2
12,444,444,123,118,5,2,1
7,467,467,5,1,4,2,1
1,475,475,97,97,0,1,0
29,485,485,55,55,0,1,0
2,495,495,30,6,24,4,3
25,500,500,70,18,52,3,2

33,112,112,29,29,0,1,0
2,119,119,1,1,0,1,0
19,119,119,8,2,6,3,2
23,129,129,4,4,0,1,0
36,154,154,23,6,17,2,1
7,194,194,4,1,3,2,1
12,217,217,17,11,6,3,2
26,220,220,9,9,0,1,0
18,232,232,30,11,19,4,3
28,235,235,8,8,0,1,0
3,235,235,1,1,0,1,0
14,240,240,17,17,0,1,0
10,268,268,18,11,7,2,1
31,273,273,7,7,0,1,0
15,279,279,19,10,9,2,1
16,298,298,52,25,27,2,1
13,310,310,4,4,0,1,0
21,312,312,49,33,16,2,1
24,327,327,28,21,7,2,1
5,333,333,21,6,15,4,3
27,334,334,27,27,0,1,0
0,336,336,63,63,0,1,0
17,346,346,59,25,34,2,1
30,375,375,46,46,0,1,0
32,377,377,98,22,76,3,2
11,390,390,5,5,0,1,0
1,400,400,94,88,6,3,2
25,416,416,7,7,0,1,0
37,427,427,89,80,9,2,1
29,438,438,14,14,0,1,0
4,439,439,18,18,0,1,0
6,439,439,108,44,64,3,2
20,448,448,10,10,0,1,0
35,449,449,70,70,0,1,0
22,450,450,33,23,10,3,2
8,488,488,13,13,0,1,0
9,490,490,57,1,56,3,2
34,500,500,40,24,16,2,1

5,116,116,1,1,0,1,0
1,122,122,4,4,0,1,0
40,126,126,11,1,10,3,2
14,137,137,3,3,0,1,0
31,149,149,16,1,15,4,3
18,155,155,20,5,15,4,3
33,157,157,7,4,3,2,1
34,169,169,15,3,12,4,3
25,188,188,53,53,0,1,0
13,192,192,10,2,8,3,2
41,195,195,10,10,0,1,0
42,200,200,14,14,0,1,0
24,201,201,38,29,9,2,1
23,203,203,11,8,3,2,1
9,204,204,1,1,0,1,0
35,223,223,13,13,0,1,0
39,226,226,28,12,16,3,2
20,239,239,32,32,0,1,0
16,242,242,55,55,0,1,0
32,243,243,90,42,48,3,2
30,244,244,57,37,20,2,1
0,260,260,24,24,0,1,0
37,263,263,13,1,12,3,2
36,273,273,3,3,0,1,0
8,274,274,18,18,0,1,0
15,304,304,1,1,0,1,0
3,312,312,64,64,0,1,0
6,346,346,22,10,12,4,3
29,347,347,1,1,0,1,0
7,356,356,25,25,0,1,0
22,360,360,38,12,26,2,1
38,387,387,47,47,0,1,0
28,411,411,6,2,4,2,1
11,412,412,16,2,14,3,2
19,422,422,37,8,29,3,2
10,438,438,37,22,15,2,1
26,441,441,19,9,10,2,1
17,450,450,3,3,0,1,0
4,462,462,7,3,4,2,1
27,477,477,37,16,21,3,2
21,479,479,37,37,0,1,0
12,484,484,16,16,0,1,0
2,491,491,1,1,0,1,0

35,103,103,52,52,0,1,0
25,123,123,30,30,0,1,0
3,174,174,3,3,0,1,0
37,223,223,1,1,0,1,0
27,224,224,5,5,0,1,0
0,237,237,35,30,5,2,1
38,259,259,3,3,0,1,0
16,271,271,24,16,8,3,2
13,271,271,2,2,0,1,0
1,272,272,70,47,23,2,1
26,276,276,14,14,0,1,0
2,283,283,44,1,43,2,1
14,288,288,28,2,26,3,2
10,293,293,1,1,0,1,0
23,294,294,69,69,0,1,0
29,294,294,20,12,8,3,2
18,298,298,40,29,11,2,1
17,301,301,4,4,0,1,0
24,314,314,8,8,0,1,0
7,324,324,19,19,0,1,0
5,338,338,97,97,0,1,0
36,343,343,37,37,0,1,0
9,348,348,8,2,6,3,2
30,353,353,29,5,24,3,2
31,363,363,57,57,0,1,0
12,367,367,21,9,12,2,1
32,370,370,13,13,0,1,0
33,383,383,8,8,0,1,0
4,384,384,28,28,0,1,0
22,411,411,38,38,0,1,0
6,412,412,26,8,18,3,2
11,413,413,21,11,10,2,1
21,413,413,22,7,15,4,3
15,414,414,15,15,0,1,0
20,418,418,30,30,0,1,0
34,437,437,17,17,0,1,0
19,467,467,3,3,0,1,0
28,468,468,41,41,0,1,0
8,482,482,73,52,21,4,3

33,100,100,24,21,3,2,1
4,104,104,17,3,14,3,2
23,105,105,13,13,0,1,0
2,137,137,19,13,6,2,1
28,142,142,3,3,0,1,0
26,146,146,10,6,4,2,1
21,150,150,25,25,0,1,0
3,164,164,12,4,8,3,2
17,167,167,18,18,0,1,0
25,189,189,7,7,0,1,0
39,192,192,8,4,4,2,1
24,200,200,28,28,0,1,0
0,223,223,13,1,12,2,1
37,225,225,14,14,0,1,0
14,228,228,16,4,12,3,2
1,237,237,12,12,0,1,0
12,237,237,2,2,0,1,0
22,237,237,14,14,0,1,0
13,256,256,10,10,0,1,0
34,278,278,10,2,8,2,1
32,280,280,61,61,0,1,0
10,284,284,16,16,0,1,0
5,297,297,38,38,0,1,0
20,314,314,30,30,0,1,0
11,328,328,54,54,0,1,0
15,354,354,9,9,0,1,0
9,357,357,63,53,10,2,1
35,375,375,4,4,0,1,0
19,385,385,11,11,0,1,0
16,390,390,3,3,0,1,0
7,395,395,19,19,0,1,0
8,408,408,33,12,21,2,1
38,411,411,5,5,0,1,0
29,436,436,58,33,25,2,1
18,438,438,12,12,0,1,0
6,439,439,40,11,29,2,1
31,448,448,106,48,58,4,3
30,464,464,58,58,0,1,0
36,472,472,88,2,86,3,2
27,499,499,42,42,0,1,0

14,102,102,1,1,0,1,0
10,118,118,15,2,13,2,1
17,120,120,1,1,0,1,0
25,127,127,7,7,0,1,0
0,131,131,32,11,21,3,2
37,133,133,4,4,0,1,0
23,133,133,22,22,0,1,0
33,136,136,12,6,6,2,1
22,150,150,18,18,0,1,0
9,170,170,19,2,17,4,3
13,172,172,32,2,30,4,3
24,188,188,46,16,30,3,2
34,213,213,17,5,12,4,3
12,213,213,21,1,20,2,1
1,271,271,83,27,56,3,2
7,290,290,1,1,0,1,0
5,295,295,16,16,0,1,0
2,300,300,1,1,0,1,0
26,310,310,27,27,0,1,0
29,311,311,43,7,36,4,3
11,333,333,20,20,0,1,0
31,350,350,61,27,34,3,2
18,365,365,4,4,0,1,0
15,368,368,44,44,0,1,0
21,385,385,21,21,0,1,0
6,387,387,3,3,0,1,0
28,391,391,107,66,41,2,1
20,415,415,24,24,0,1,0
32,435,435,13,3,10,3,2
27,439,439,8,5,3,2,1
19,440,440,77,62,15,2,1
36,452,452,78,66,12,4,3
30,464,464,12,2,10,2,1
4,468,468,40,10,30,2,1
35,478,478,6,6,0,1,0
3,480,480,5,1,4,2,1
16,490,490,54,54,0,1,0
8,491,491,34,34,0,1,0

10,107,107,15,15,0,1,0
23,109,109,4,1,3,2,1
9,110,110,8,8,0,1,0
2,113,113,19,5,14,3,2
24,117,117,41,41,0,1,0
22,120,120,24,2,22,2,1
11,123,123,21,21,0,1,0
19,136,136,3,3,0,1,0
32,142,142,10,2,8,2,1
18,159,159,10,10,0,1,0
4,161,161,8,8,0,1,0
15,166,166,41,23,18,3,2
14,169,169,62,44,18,3,2
12,177,177,12,3,9,4,3
26,187,187,1,1,0,1,0
3,207,207,8,8,0,1,0
27,213,213,1,1,0,1,0
20,222,222,9,3,6,3,2
1,260,260,13,1,12,3,2
31,272,272,2,2,0,1,0
30,277,277,41,41,0,1,0
29,278,278,66,6,60,3,2
16,304,304,52,22,30,4,3
17,305,305,10,3,7,2,1
25,312,312,39,39,0,1,0
6,313,313,30,30,0,1,0
21,337,337,12,9,3,2,1
0,391,391,55,26,29,2,1
13,415,415,36,36,0,1,0
7,431,431,84,31,53,3,2
28,436,436,21,21,0,1,0
5,451,451,11,6,5,2,1
8,477,477,64,41,23,2,1

27,102,102,13,4,9,4,3
22,103,103,19,14,5,2,1
7,150,150,23,6,17,2,1
18,152,152,16,16,0,1,0
5,157,157,10,4,6,3,2
3,159,159,43,19,24,3,2
19,188,188,18,18,0,1,0
26,192,192,3,3,0,1,0
6,201,201,23,15,8,3,2
10,207,207,28,12,16,2,1
11,238,238,40,14,26,4,3
29,246,246,45,12,33,4,3
21,266,266,30,30,0,1,0
20,266,266,5,5,0,1,0
8,270,270,8,3,5,2,1
0,275,275,59,59,0,1,0
16,280,280,23,11,12,4,3
24,288,288,7,7,0,1,0
30,294,294,33,24,9,4,3
1,307,307,81,81,0,1,0
12,317,317,14,14,0,1,0
23,318,318,71,71,0,1,0
4,382,382,43,43,0,1,0
17,399,399,51,51,0,1,0
28,399,399,14,14,0,1,0
9,411,411,69,69,0,1,0
13,461,461,12,3,9,2,1
25,462,462,110,92,18,4,3
15,482,482,18,3,15,4,3
2,491,491,32,17,15,4,3
14,494,494,46,6,40,3,2

22,105,105,6,6,0,1,0
17,107,107,1,1,0,1,0
7,108,108,9,9,0,1,0
31,131,131,7,2,5,2,1
4,137,137,4,1,3,2,1
20,142,142,2,2,0,1,0
19,143,143,21,21,0,1,0
35,171,171,5,5,0,1,0
3,197,197,25,25,0,1,0
27,197,197,61,6,55,4,3
34,202,202,1,1,0,1,0
30,204,204,5,5,0,1,0
16,215,215,16,16,0,1,0
29,221,221,22,9,13,2,1
10,221,221,5,2,3,2,1
9,240,240,3,3,0,1,0
11,256,256,15,6,9,2,1
25,257,257,5,5,0,1,0
32,262,262,23,23,0,1,0
26,266,266,19,19,0,1,0
23,272,272,37,37,0,1,0
12,284,284,1,1,0,1,0
6,305,305,100,87,13,2,1
14,325,325,6,1,5,2,1
0,325,325,38,38,0,1,0
18,341,341,4,4,0,1,0
37,342,342,6,6,0,1,0
39,352,352,87,69,18,4,3
13,355,355,43,43,0,1,0
41,375,375,92,18,74,4,3
36,404,404,37,9,28,2,1
40,407,407,64,8,56,4,3
1,410,410,14,7,7,2,1
5,419,419,28,28,0,1,0
8,425,425,89,89,0,1,0
33,427,427,11,11,0,1,0
28,437,437,26,6,20,3,2
15,448,448,10,10,0,1,0
38,456,456,113,97,16,3,2
2,467,467,44,44,0,1,0
24,491,491,21,21,0,1,0
21,494,494,3,3,0,1,0

0,110,110,4,4,0,1,0
3,117,117,3,3,0,1,0
36,134,134,25,13,12,4,3
24,136,136,62,35,27,2,1
8,137,137,12,5,7,2,1
1,156,156,16,16,0,1,0
26,163,163,6,6,0,1,0
10,173,173,25,25,0,1,0
30,175,175,15,3,12,2,1
22,195,195,22,22,0,1,0
20,203,203,18,3,15,4,3
17,205,205,23,16,7,2,1
4,211,211,24,12,12,4,3
39,218,218,3,3,0,1,0
9,228,228,1,1,0,1,0
41,235,235,32,20,12,4,3
29,238,238,17,17,0,1,0
6,243,243,1,1,0,1,0
11,244,244,25,19,6,2,1
37,304,304,6,6,0,1,0
16,313,313,47,47,0,1,0
40,321,321,2,2,0,1,0
2,322,322,26,26,0,1,0
18,335,335,2,2,0,1,0
34,338,338,30,30,0,1,0
13,357,357,41,41,0,1,0
25,363,363,1,1,0,1,0
23,368,368,23,5,18,4,3
27,394,394,32,32,0,1,0
12,402,402,8,8,0,1,0
28,419,419,25,25,0,1,0
38,428,428,23,23,0,1,0
21,441,441,10,4,6,2,1
35,447,447,132,79,53,4,3
31,457,457,45,33,12,4,3
33,457,457,26,13,13,2,1
7,457,457,9,6,3,2,1
32,473,473,40,21,19,2,1
15,478,478,62,26,36,2,1
5,482,482,59,59,0,1,0
14,482,482,56,56,0,1,0
19,499,499,11,8,3,2,1

15,128,128,13,13,0,1,0
12,139,139,3,3,0,1,0
3,146,146,46,46,0,1,0
5,151,151,16,16,0,1,0
2,162,162,23,10,13,2,1
6,165,165,4,1,3,2,1
7,169,169,8,8,0,1,0
20,205,205,43,43,0,1,0
28,214,214,4,4,0,1,0
37,215,215,7,7,0,1,0
30,234,234,28,28,0,1,0
24,240,240,12,6,6,3,2
36,244,244,27,13,14,3,2
31,249,249,6,6,0,1,0
13,264,264,5,5,0,1,0
29,268,268,55,11,44,3,2
19,282,282,53,53,0,1,0
26,300,300,3,3,0,1,0
34,313,313,65,65,0,1,0
9,322,322,14,5,9,4,3
27,322,322,32,2,30,4,3
38,362,362,139,57,82,3,2
22,377,377,62,62,0,1,0
16,383,383,6,1,5,2,1
18,386,386,85,85,0,1,0
25,408,408,2,2,0,1,0
32,412,412,25,8,17,2,1
11,413,413,15,15,0,1,0
33,422,422,11,1,10,2,1
35,427,427,40,40,0,1,0
8,427,427,6,6,0,1,0
0,433,433,11,2,9,2,1
10,443,443,6,1,5,2,1
1,444,444,70,42,28,3,2
17,447,447,5,5,0,1,0
14,451,451,1,1,0,1,0
21,461,461,86,86,0,1,0
23,475,475,16,16,0,1,0
4,483,483,43,23,20,3,2

0,106,106,12,3,9,4,3
9,140,140,16,4,12,4,3
26,200,200,4,4,0,1,0
15,205,205,2,2,0,1,0
17,208,208,14,6,8,2,1
16,213,213,3,3,0,1,0
19,215,215,13,13,0,1,0
24,221,221,7,3,4,2,1
37,246,246,21,3,18,4,3
1,251,251,19,19,0,1,0
23,251,251,18,18,0,1,0
14,251,251,20,3,17,2,1
36,263,263,1,1,0,1,0
34,275,275,100,100,0,1,0
30,290,290,26,8,18,2,1
10,295,295,1,1,0,1,0
28,298,298,43,25,18,4,3
32,298,298,37,29,8,2,1
4,298,298,15,15,0,1,0
12,307,307,18,8,10,4,3
7,311,311,15,15,0,1,0
8,317,317,31,31,0,1,0
22,320,320,14,14,0,1,0
20,331,331,14,2,12,3,2
18,338,338,86,27,59,4,3
39,342,342,6,3,3,2,1
3,350,350,49,44,5,2,1
11,373,373,35,35,0,1,0
13,399,399,30,30,0,1,0
21,401,401,62,33,29,2,1
40,404,404,51,51,0,1,0
27,407,407,53,53,0,1,0
5,413,413,4,4,0,1,0
6,425,425,34,1,33,2,1
25,426,426,116,83,33,2,1
2,442,442,19,14,5,2,1
33,443,443,17,6,11,4,3
41,459,459,18,1,17,2,1
38,479,479,23,5,18,4,3
35,487,487,12,12,0,1,0
29,487,487,23,2,21,2,1
31,489,489,108,41,67,4,3

16,106,106,2,2,0,1,0
4,108,108,4,1,3,2,1
30,111,111,22,22,0,1,0
20,113,113,1,1,0,1,0
28,119,119,41,41,0,1,0
34,141,141,35,35,0,1,0
8,172,172,4,1,3,2,1
18,177,177,6,2,4,2,1
0,180,180,15,15,0,1,0
19,188,188,15,15,0,1,0
10,190,190,2,2,0,1,0
13,208,208,16,16,0,1,0
31,221,221,47,47,0,1,0
21,245,245,31,11,20,2,1
1,261,261,13,1,12,2,1
14,267,267,42,42,0,1,0
5,279,279,35,35,0,1,0
3,283,283,34,34,0,1,0
29,283,283,5,2,3,2,1
7,286,286,21,21,0,1,0
6,292,292,30,12,18,2,1
2,294,294,62,62,0,1,0
37,309,309,14,5,9,2,1
26,331,331,68,8,60,4,3
15,337,337,89,33,56,3,2
24,345,345,6,6,0,1,0
17,353,353,55,41,14,2,1
23,358,358,8,8,0,1,0
35,383,383,8,8,0,1,0
12,395,395,32,13,19,2,1
36,402,402,7,7,0,1,0
27,420,420,38,38,0,1,0
9,437,437,26,8,18,3,2
33,460,460,46,25,21,4,3
25,462,462,20,7,13,2,1
32,469,469,30,4,26,3,2
22,473,473,27,18,9,4,3
11,483,483,18,18,0,1,0

9,127,127,1,1,0,1,0
35,136,136,22,13,9,4,3
17,148,148,30,30,0,1,0
7,149,149,7,7,0,1,0
12,163,163,4,1,3,2,1
25,168,168,13,13,0,1,0
10,171,171,12,12,0,1,0
4,178,178,28,12,16,2,1
8,181,181,7,7,0,1,0
19,183,183,2,2,0,1,0
15,189,189,12,12,0,1,0
18,191,191,32,32,0,1,0
14,199,199,12,12,0,1,0
28,206,206,10,4,6,2,1
13,210,210,3,3,0,1,0
16,212,212,11,11,0,1,0
1,227,227,38,11,27,2,1
30,230,230,24,3,21,3,2
33,264,264,20,20,0,1,0
23,271,271,53,50,3,2,1
38,275,275,38,38,0,1,0
2,287,287,59,43,16,3,2
5,290,290,11,4,7,2,1
6,296,296,4,4,0,1,0
22,305,305,9,9,0,1,0
26,319,319,10,1,9,4,3
21,335,335,63,42,21,4,3
29,337,337,23,23,0,1,0
27,356,356,46,34,12,3,2
3,360,360,21,2,19,2,1
36,365,365,10,3,7,2,1
37,375,375,23,23,0,1,0
20,392,392,86,61,25,2,1
11,423,423,60,44,16,2,1
31,429,429,3,3,0,1,0
0,431,431,17,10,7,2,1
34,436,436,23,23,0,1,0
32,462,462,179,41,138,4,3
24,464,464,20,6,14,3,2

21,132,132,42,42,0,1,0
18,151,151,7,1,6,3,2
28,155,155,9,9,0,1,0
20,157,157,6,6,0,1,0
17,166,166,46,46,0,1,0
6,173,173,36,36,0,1,0
2,178,178,26,6,20,2,1
12,185,185,3,3,0,1,0
8,186,186,7,7,0,1,0
14,194,194,1,1,0,1,0
33,201,201,28,2,26,3,2
23,218,218,4,4,0,1,0
15,252,252,31,31,0,1,0
30,273,273,9,6,3,2,1
1,294,294,8,8,0,1,0
0,298,298,75,25,50,4,3
35,307,307,21,7,14,3,2
27,338,338,34,34,0,1,0
19,342,342,27,12,15,2,1
10,345,345,36,28,8,2,1
7,346,346,9,9,0,1,0
4,367,367,2,2,0,1,0
25,368,368,21,21,0,1,0
24,390,390,15,15,0,1,0
32,400,400,5,5,0,1,0
16,404,404,34,34,0,1,0
26,409,409,73,5,68,3,2
11,417,417,25,21,4,2,1
3,419,419,25,7,18,2,1
5,425,425,58,58,0,1,0
34,429,429,138,8,130,4,3
22,432,432,6,6,0,1,0
9,436,436,54,6,48,2,1
31,437,437,125,101,24,4,3
13,456,456,51,51,0,1,0
29,473,473,16,16,0,1,0

23,104,104,29,6,23,2,1
11,119,119,18,18,0,1,0
17,143,143,6,6,0,1,0
20,153,153,46,19,27,3,2
9,165,165,7,7,0,1,0
27,172,172,25,25,0,1,0
7,176,176,16,8,8,3,2
1,180,180,29,29,0,1,0
32,182,182,6,3,3,2,1
8,199,199,75,62,13,2,1
22,205,205,4,4,0,1,0
6,214,214,8,8,0,1,0
14,221,221,26,26,0,1,0
5,226,226,1,1,0,1,0
15,248,248,10,10,0,1,0
18,262,262,33,33,0,1,0
29,275,275,22,22,0,1,0
0,284,284,5,2,3,2,1
12,311,311,10,10,0,1,0
24,336,336,6,1,5,2,1
2,337,337,27,11,16,3,2
25,340,340,21,4,17,2,1
30,344,344,25,25,0,1,0
4,346,346,65,2,63,3,2
28,363,363,8,8,0,1,0
21,371,371,17,1,16,2,1
13,386,386,110,72,38,3,2
31,409,409,64,56,8,3,2
10,410,410,12,3,9,4,3
19,412,412,35,13,22,3,2
3,420,420,79,37,42,3,2
26,459,459,135,35,100,3,2
16,491,491,5,5,0,1,0

27,114,114,3,3,0,1,0
30,128,128,9,9,0,1,0
34,173,173,49,3,46,3,2
24,177,177,37,7,30,2,1
33,194,194,1,1,0,1,0
3,208,208,36,36,0,1,0
31,209,209,12,12,0,1,0
9,215,215,1,1,0,1,0
15,223,223,93,64,29,3,2
32,229,229,15,5,10,3,2
21,231,231,32,13,19,2,1
2,234,234,11,11,0,1,0
28,235,235,25,12,13,2,1
23,255,255,13,4,9,2,1
8,257,257,32,21,11,2,1
16,262,262,15,6,9,2,1
20,273,273,28,28,0,1,0
1,293,293,63,12,51,3,2
4,296,296,54,54,0,1,0
0,299,299,31,3,28,3,2
26,308,308,27,27,0,1,0
5,314,314,43,43,0,1,0
29,333,333,65,65,0,1,0
14,335,335,11,11,0,1,0
11,339,339,9,6,3,2,1
13,366,366,30,7,23,2,1
6,374,374,51,51,0,1,0
18,394,394,72,51,21,3,2
17,438,438,75,75,0,1,0
19,450,450,16,10,6,2,1
25,462,462,9,4,5,2,1
10,481,481,3,3,0,1,0
12,489,489,14,8,6,3,2
7,489,489,14,6,8,2,1
22,497,497,14,14,0,1,0

5,101,101,18,8,10,3,2
16,102,102,1,1,0,1,0
3,106,106,4,4,0,1,0
31,109,109,26,26,0,1,0
27,111,111,28,1,27,2,1
13,123,123,3,3,0,1,0
10,136,136,28,19,9,2,1
2,141,141,9,9,0,1,0
36,144,144,8,8,0,1,0
4,175,175,2,2,0,1,0
18,177,177,1,1,0,1,0
22,179,179,7,3,4,2,1
26,208,208,2,2,0,1,0
34,225,225,7,7,0,1,0
23,260,260,74,20,54,3,2
33,270,270,6,6,0,1,0
9,278,278,34,11,23,2,1
37,309,309,31,31,0,1,0
11,318,318,16,16,0,1,0
14,327,327,5,5,0,1,0
1,337,337,111,111,0,1,0
32,340,340,31,2,29,2,1
30,349,349,28,13,15,4,3
17,356,356,5,5,0,1,0
28,361,361,1,1,0,1,0
8,368,368,40,40,0,1,0
19,387,387,7,7,0,1,0
7,387,387,1,1,0,1,0
29,397,397,7,7,0,1,0
24,412,412,105,28,77,4,3
20,424,424,33,9,24,4,3
35,430,430,60,33,27,4,3
15,444,444,193,193,0,1,0
12,446,446,42,42,0,1,0
25,449,449,22,22,0,1,0
21,479,479,39,39,0,1,0
0,495,495,32,20,12,3,2
6,496,496,5,5,0,1,0

6,101,101,10,2,8,3,2
13,108,108,4,4,0,1,0
42,120,120,11,11,0,1,0
39,126,126,40,30,10,2,1
28,135,135,30,30,0,1,0
22,151,151,2,2,0,1,0
35,163,163,24,5,19,2,1
3,171,171,2,2,0,1,0
2,181,181,15,15,0,1,0
29,193,193,25,17,8,3,2
19,205,205,6,2,4,2,1
10,210,210,17,1,16,2,1
7,211,211,34,34,0,1,0
44,213,213,2,2,0,1,0
24,221,221,3,3,0,1,0
27,228,228,10,10,0,1,0
30,230,230,8,4,4,2,1
8,233,233,28,28,0,1,0
36,238,238,16,16,0,1,0
25,240,240,1,1,0,1,0
41,254,254,30,30,0,1,0
38,255,255,4,1,3,2,1
31,267,267,6,6,0,1,0
15,276,276,19,7,12,3,2
11,284,284,55,38,17,2,1
9,295,295,17,17,0,1,0
20,308,308,17,17,0,1,0
12,320,320,16,12,4,2,1
33,329,329,66,2,64,3,2
32,340,340,5,5,0,1,0
21,344,344,15,15,0,1,0
5,354,354,41,2,39,4,3
4,359,359,5,5,0,1,0
43,368,368,41,27,14,3,2
34,368,368,56,33,23,2,1
37,379,379,7,7,0,1,0
23,380,380,24,24,0,1,0
26,382,382,34,5,29,2,1
0,401,401,62,62,0,1,0
45,411,411,53,31,22,3,2
1,414,414,4,4,0,1,0
40,423,423,15,15,0,1,0
16,451,451,4,4,0,1,0
14,452,452,25,25,0,1,0
18,482,482,35,7,28,2,1
17,498,498,27,27,0,1,0

14,103,103,1,1,0,1,0
25,107,107,16,8,8,3,2
30,110,110,13,13,0,1,0
12,114,114,2,2,0,1,0
6,129,129,6,1,5,2,1
5,136,136,4,1,3,2,1
22,151,151,21,21,0,1,0
33,152,152,1,1,0,1,0
28,184,184,13,7,6,3,2
20,187,187,5,5,0,1,0
26,195,195,99,99,0,1,0
7,199,199,3,3,0,1,0
37,203,203,4,1,3,2,1
4,203,203,6,6,0,1,0
13,222,222,25,19,6,3,2
3,227,227,17,3,14,4,3
19,230,230,4,4,0,1,0
34,238,238,3,3,0,1,0
1,242,242,12,12,0,1,0
15,250,250,1,1,0,1,0
27,283,283,2,2,0,1,0
31,286,286,12,12,0,1,0
16,288,288,17,17,0,1,0
9,336,336,57,57,0,1,0
17,337,337,18,18,0,1,0
23,338,338,29,13,16,2,1
35,358,358,34,34,0,1,0
39,361,361,36,36,0,1,0
21,363,363,73,73,0,1,0
10,376,376,82,64,18,3,2
11,379,379,30,27,3,2,1
2,393,393,82,43,39,4,3
32,394,394,36,16,20,2,1
29,418,418,84,30,54,4,3
24,425,425,42,42,0,1,0
36,425,425,14,14,0,1,0
38,437,437,23,23,0,1,0
8,449,449,1,1,0,1,0
18,456,456,152,90,62,4,3
0,491,491,21,21,0,1,0

15,112,112,19,19,0,1,0
26,118,118,1,1,0,1,0
31,150,150,11,11,0,1,0
4,172,172,25,25,0,1,0
22,187,187,30,16,14,3,2
18,191,191,10,10,0,1,0
1,193,193,18,2,16,3,2
34,201,201,30,5,25,2,1
8,210,210,26,26,0,1,0
24,222,222,26,26,0,1,0
28,224,224,31,15,16,4,3
2,225,225,52,14,38,3,2
17,260,260,34,26,8,2,1
35,280,280,18,18,0,1,0
32,295,295,18,18,0,1,0
12,308,308,18,2,16,3,2
7,317,317,1,1,0,1,0
0,326,326,9,3,6,2,1
36,332,332,28,4,24,4,3
14,333,333,44,9,35,2,1
3,335,335,40,40,0,1,0
13,336,336,5,2,3,2,1
6,339,339,31,31,0,1,0
16,340,340,50,38,12,3,2
20,341,341,56,23,33,4,3
11,369,369,25,4,21,4,3
21,395,395,7,7,0,1,0
37,427,427,20,20,0,1,0
25,427,427,11,2,9,2,1
33,443,443,4,1,3,2,1
10,449,449,5,5,0,1,0
30,453,453,27,4,23,2,1
19,456,456,17,2,15,4,3
5,459,459,65,2,63,4,3
29,468,468,55,25,30,4,3
23,468,468,66,17,49,2,1
27,472,472,186,135,51,4,3
9,482,482,1,1,0,1,0

32,100,100,2,2,0,1,0
26,102,102,12,12,0,1,0
2,120,120,1,1,0,1,0
24,120,120,7,7,0,1,0
11,134,134,3,3,0,1,0
14,146,146,14,3,11,2,1
3,163,163,1,1,0,1,0
9,168,168,12,12,0,1,0
16,184,184,13,13,0,1,0
12,186,186,4,4,0,1,0
34,186,186,40,40,0,1,0
6,189,189,4,4,0,1,0
37,218,218,26,26,0,1,0
18,230,230,9,1,8,3,2
8,232,232,43,43,0,1,0
22,244,244,7,4,3,2,1
17,246,246,14,14,0,1,0
20,254,254,50,50,0,1,0
29,264,264,21,4,17,4,3
19,267,267,45,18,27,4,3
21,277,277,40,40,0,1,0
4,280,280,2,2,0,1,0
23,297,297,11,11,0,1,0
25,299,299,19,4,15,4,3
27,321,321,56,35,21,4,3
35,329,329,46,20,26,2,1
28,329,329,78,22,56,3,2
5,337,337,57,17,40,2,1
15,340,340,23,23,0,1,0
1,345,345,16,1,15,4,3
7,366,366,44,12,32,2,1
10,382,382,82,56,26,2,1
39,394,394,46,46,0,1,0
33,409,409,16,2,14,3,2
36,433,433,14,14,0,1,0
40,448,448,102,58,44,2,1
30,458,458,24,24,0,1,0
0,478,478,13,13,0,1,0
13,482,482,5,5,0,1,0
38,485,485,5,5,0,1,0
31,491,491,49,49,0,1,0

21,140,140,13,13,0,1,0
28,173,173,1,1,0,1,0
10,203,203,26,15,11,2,1
2,207,207,13,3,10,3,2
3,215,215,4,4,0,1,0
14,233,233,15,5,10,2,1
8,241,241,12,12,0,1,0
35,254,254,56,31,25,2,1
12,271,271,25,4,21,4,3
22,273,273,7,1,6,3,2
20,283,283,10,10,0,1,0
24,299,299,1,1,0,1,0
6,307,307,11,11,0,1,0
34,319,319,2,2,0,1,0
27,320,320,117,39,78,4,3
23,326,326,10,10,0,1,0
36,343,343,47,4,43,2,1
29,370,370,16,2,14,3,2
18,378,378,55,55,0,1,0
9,379,379,23,23,0,1,0
25,382,382,41,41,0,1,0
7,387,387,7,7,0,1,0
26,399,399,9,9,0,1,0
1,404,404,80,68,12,4,3
0,404,404,81,57,24,2,1
31,407,407,133,39,94,3,2
5,419,419,120,21,99,4,3
30,428,428,89,89,0,1,0
16,437,437,74,27,47,2,1
4,444,444,4,4,0,1,0
11,450,450,25,3,22,3,2
32,450,450,48,48,0,1,0
17,462,462,17,1,16,3,2
13,477,477,6,6,0,1,0
19,489,489,9,9,0,1,0
15,491,491,77,77,0,1,0
33,498,498,32,32,0,1,0

23,107,107,4,1,3,2,1
31,131,131,10,10,0,1,0
27,136,136,6,6,0,1,0
0,151,151,3,3,0,1,0
15,164,164,1,1,0,1,0
32,173,173,8,4,4,2,1
35,184,184,15,15,0,1,0
12,187,187,7,7,0,1,0
13,200,200,9,1,8,2,1
6,210,210,7,4,3,2,1
11,213,213,10,1,9,3,2
29,227,227,2,2,0,1,0
33,231,231,12,4,8,2,1
26,239,239,73,61,12,3,2
3,266,266,38,38,0,1,0
14,279,279,13,13,0,1,0
2,281,281,62,29,33,4,3
7,285,285,42,42,0,1,0
36,293,293,12,7,5,2,1
30,295,295,90,50,40,2,1
16,297,297,18,18,0,1,0
25,299,299,19,10,9,2,1
9,322,322,18,18,0,1,0
34,324,324,23,23,0,1,0
4,347,347,21,21,0,1,0
24,359,359,15,15,0,1,0
8,368,368,125,78,47,4,3
1,372,372,25,25,0,1,0
21,378,378,69,33,36,4,3
28,379,379,86,86,0,1,0
19,384,384,92,63,29,4,3
18,414,414,12,6,6,2,1
10,445,445,140,100,40,3,2
5,477,477,40,40,0,1,0
20,481,481,2,2,0,1,0
17,485,485,21,21,0,1,0
22,493,493,6,6,0,1,0

32,112,112,5,5,0,1,0
11,115,115,2,2,0,1,0
8,119,119,8,8,0,1,0
33,121,121,7,7,0,1,0
13,135,135,1,1,0,1,0
0,143,143,3,3,0,1,0
1,156,156,55,55,0,1,0
35,170,170,42,42,0,1,0
6,171,171,5,5,0,1,0
22,172,172,8,8,0,1,0
19,187,187,44,44,0,1,0
34,206,206,7,3,4,2,1
18,206,206,11,11,0,1,0
3,212,212,58,58,0,1,0
29,218,218,16,16,0,1,0
5,222,222,38,16,22,3,2
14,226,226,16,6,10,2,1
26,238,238,11,11,0,1,0
15,253,253,3,3,0,1,0
24,287,287,50,50,0,1,0
12,289,289,7,7,0,1,0
17,308,308,47,3,44,4,3
9,308,308,16,16,0,1,0
30,325,325,96,96,0,1,0
21,337,337,116,116,0,1,0
10,338,338,14,2,12,4,3
27,341,341,7,7,0,1,0
23,364,364,11,11,0,1,0
2,370,370,49,10,39,2,1
20,402,402,22,22,0,1,0
25,405,405,27,23,4,2,1
7,433,433,58,15,43,3,2
4,446,446,30,30,0,1,0
31,451,451,4,4,0,1,0
16,464,464,82,41,41,4,3
28,488,488,5,5,0,1,0

46,101,101,2,2,0,1,0
3,113,113,2,2,0,1,0
39,121,121,31,31,0,1,0
29,143,143,44,28,16,2,1
40,145,145,24,6,18,2,1
2,164,164,54,11,43,3,2
27,165,165,4,4,0,1,0
45,181,181,12,12,0,1,0
31,186,186,48,37,11,2,1
26,191,191,21,21,0,1,0
33,208,208,13,13,0,1,0
9,215,215,7,2,5,2,1
32,227,227,41,32,9,2,1
28,231,231,1,1,0,1,0
19,236,236,15,15,0,1,0
41,240,240,8,8,0,1,0
8,271,271,2,2,0,1,0
4,274,274,20,1,19,4,3
22,278,278,15,9,6,2,1
20,289,289,15,6,9,4,3
17,301,301,3,3,0,1,0
35,310,310,28,28,0,1,0
34,313,313,15,15,0,1,0
15,322,322,4,4,0,1,0
24,338,338,3,3,0,1,0
18,366,366,3,3,0,1,0
23,370,370,34,34,0,1,0
5,378,378,35,8,27,4,3
0,380,380,25,25,0,1,0
30,392,392,34,34,0,1,0
42,402,402,25,18,7,2,1
38,410,410,22,14,8,3,2
12,414,414,48,48,0,1,0
36,420,420,15,7,8,3,2
13,428,428,21,8,13,2,1
25,443,443,42,42,0,1,0
7,444,444,5,2,3,2,1
37,445,445,3,3,0,1,0
6,447,447,83,83,0,1,0
16,458,458,10,10,0,1,0
21,465,465,21,21,0,1,0
11,469,469,47,6,41,4,3
1,469,469,1,1,0,1,0
10,472,472,15,15,0,1,0
43,477,477,45,45,0,1,0
44,493,493,6,6,0,1,0
14,500,500,44,25,19,2,1

24,100,100,2,2,0,1,0
2,106,106,6,6,0,1,0
5,125,125,7,7,0,1,0
10,132,132,46,26,20,3,2
8,138,138,16,1,15,2,1
31,144,144,17,17,0,1,0
15,150,150,4,4,0,1,0
20,156,156,15,15,0,1,0
16,158,158,25,25,0,1,0
3,194,194,4,4,0,1,0
12,213,213,29,15,14,3,2
9,234,234,17,17,0,1,0
36,244,244,22,13,9,4,3
32,282,282,66,66,0,1,0
17,288,288,22,10,12,3,2
7,295,295,1,1,0,1,0
23,298,298,15,2,13,3,2
28,310,310,74,26,48,4,3
0,329,329,20,20,0,1,0
4,339,339,4,4,0,1,0
1,358,358,77,52,25,2,1
14,372,372,20,20,0,1,0
21,378,378,24,24,0,1,0
29,378,378,57,57,0,1,0
25,391,391,33,19,14,2,1
37,392,392,108,69,39,2,1
33,401,401,7,7,0,1,0
22,406,406,12,12,0,1,0
26,427,427,23,23,0,1,0
27,441,441,5,5,0,1,0
6,443,443,52,17,35,4,3
19,445,445,3,3,0,1,0
13,453,453,46,46,0,1,0
11,467,467,48,21,27,2,1
34,467,467,20,20,0,1,0
18,469,469,28,28,0,1,0
35,481,481,15,7,8,3,2
30,492,492,112,112,0,1,0

36,104,104,21,21,0,1,0
15,112,112,6,6,0,1,0
18,117,117,11,4,7,2,1
14,124,124,1,1,0,1,0
29,134,134,18,4,14,3,2
27,139,139,17,17,0,1,0
17,140,140,54,54,0,1,0
12,147,147,10,4,6,2,1
11,152,152,15,1,14,3,2
38,168,168,14,2,12,4,3
41,198,198,37,31,6,2,1
7,203,203,1,1,0,1,0
35,214,214,17,8,9,4,3
4,217,217,18,5,13,2,1
40,217,217,1,1,0,1,0
25,225,225,21,21,0,1,0
37,230,230,48,26,22,3,2
13,248,248,4,1,3,2,1
43,251,251,26,13,13,2,1
19,252,252,21,18,3,2,1
0,257,257,1,1,0,1,0
20,270,270,16,7,9,2,1
32,288,288,30,30,0,1,0
31,290,290,8,8,0,1,0
23,336,336,10,7,3,2,1
30,342,342,7,7,0,1,0
42,348,348,95,41,54,4,3
5,349,349,3,3,0,1,0
1,349,349,8,1,7,2,1
33,351,351,1,1,0,1,0
10,365,365,17,17,0,1,0
22,367,367,38,26,12,2,1
39,368,368,18,5,13,3,2
6,371,371,4,4,0,1,0
2,382,382,7,7,0,1,0
34,383,383,6,1,5,2,1
16,387,387,23,9,14,3,2
26,426,426,38,38,0,1,0
3,433,433,14,14,0,1,0
8,437,437,53,53,0,1,0
24,451,451,77,69,8,2,1
28,463,463,58,7,51,4,3
9,466,466,8,8,0,1,0
21,482,482,53,53,0,1,0

26,104,104,8,8,0,1,0
10,110,110,3,3,0,1,0
23,116,116,61,61,0,1,0
16,130,130,9,9,0,1,0
24,132,132,18,18,0,1,0
5,166,166,58,27,31,2,1
4,185,185,5,5,0,1,0
27,192,192,3,3,0,1,0
1,194,194,5,5,0,1,0
9,198,198,12,12,0,1,0
25,211,211,28,28,0,1,0
17,219,219,17,17,0,1,0
15,224,224,57,57,0,1,0
36,244,244,3,3,0,1,0
28,263,263,57,29,28,2,1
20,263,263,9,2,7,2,1
7,276,276,8,3,5,2,1
30,285,285,6,6,0,1,0
11,291,291,44,23,21,4,3
32,304,304,13,3,10,2,1
22,307,307,9,3,6,3,2
12,312,312,2,2,0,1,0
0,323,323,32,32,0,1,0
14,325,325,99,67,32,2,1
6,342,342,1,1,0,1,0
35,367,367,25,25,0,1,0
29,371,371,49,49,0,1,0
31,379,379,38,6,32,3,2
3,383,383,2,2,0,1,0
18,385,385,14,2,12,2,1
21,390,390,11,11,0,1,0
13,418,418,32,8,24,2,1
34,421,421,82,82,0,1,0
2,440,440,29,29,0,1,0
19,443,443,9,9,0,1,0
33,496,496,21,21,0,1,0
8,500,500,66,15,51,4,3

10,116,116,1,1,0,1,0
20,118,118,12,12,0,1,0
26,131,131,26,26,0,1,0
36,149,149,10,3,7,2,1
13,171,171,41,2,39,2,1
3,181,181,1,1,0,1,0
15,213,213,6,6,0,1,0
17,215,215,9,9,0,1,0
38,219,219,12,12,0,1,0
34,228,228,17,17,0,1,0
11,230,230,8,8,0,1,0
12,231,231,19,14,5,2,1
16,233,233,1,1,0,1,0
1,239,239,19,3,16,3,2
29,239,239,10,4,6,3,2
24,257,257,2,2,0,1,0
28,269,269,15,15,0,1,0
25,273,273,48,48,0,1,0
4,282,282,29,23,6,2,1
0,286,286,1,1,0,1,0
35,299,299,56,56,0,1,0
6,303,303,40,40,0,1,0
19,317,317,6,6,0,1,0
5,317,317,85,35,50,3,2
32,322,322,18,11,7,2,1
39,337,337,15,7,8,2,1
33,383,383,14,14,0,1,0
23,396,396,150,112,38,3,2
8,402,402,50,50,0,1,0
21,403,403,51,51,0,1,0
2,406,406,58,19,39,2,1
27,442,442,11,11,0,1,0
37,446,446,23,23,0,1,0
30,452,452,8,8,0,1,0
7,452,452,23,23,0,1,0
9,460,460,10,7,3,2,1
18,478,478,35,35,0,1,0
31,486,486,73,25,48,4,3
14,488,488,53,53,0,1,0
22,494,494,107,89,18,4,3

2,118,118,14,14,0,1,0
29,126,126,6,6,0,1,0
30,140,140,1,1,0,1,0
9,152,152,4,1,3,2,1
20,162,162,56,56,0,1,0
3,171,171,11,11,0,1,0
27,187,187,7,7,0,1,0
0,221,221,33,33,0,1,0
13,221,221,45,11,34,3,2
17,229,229,15,15,0,1,0
31,234,234,69,24,45,4,3
22,238,238,20,20,0,1,0
5,242,242,29,29,0,1,0
16,256,256,18,18,0,1,0
8,265,265,20,20,0,1,0
7,328,328,8,8,0,1,0
26,336,336,4,4,0,1,0
14,337,337,93,43,50,3,2
25,341,341,52,16,36,4,3
6,344,344,43,43,0,1,0
10,348,348,57,15,42,2,1
28,365,365,63,49,14,2,1
15,375,375,14,14,0,1,0
12,378,378,66,23,43,3,2
24,383,383,20,15,5,2,1
4,408,408,44,14,30,3,2
19,409,409,59,29,30,2,1
11,444,444,63,51,12,4,3
32,446,446,70,19,51,4,3
1,448,448,14,14,0,1,0
23,469,469,9,1,8,3,2
21,469,469,15,15,0,1,0
18,483,483,46,46,0,1,0

20,118,118,1,1,0,1,0
11,136,136,8,8,0,1,0
38,138,138,17,17,0,1,0
34,152,152,3,3,0,1,0
9,156,156,14,14,0,1,0
8,159,159,25,18,7,2,1
22,160,160,22,4,18,3,2
2,161,161,1,1,0,1,0
32,174,174,22,10,12,4,3
7,176,176,1,1,0,1,0
5,181,181,29,20,9,2,1
37,189,189,25,25,0,1,0
17,191,191,2,2,0,1,0
25,203,203,20,20,0,1,0
28,208,208,7,3,4,2,1
39,221,221,24,24,0,1,0
31,250,250,84,76,8,2,1
36,287,287,61,61,0,1,0
33,293,293,14,14,0,1,0
21,299,299,7,1,6,3,2
41,308,308,1,1,0,1,0
6,310,310,36,33,3,2,1
27,341,341,1,1,0,1,0
40,341,341,77,54,23,3,2
26,346,346,9,1,8,3,2
29,362,362,8,8,0,1,0
15,377,377,73,13,60,3,2
1,381,381,67,33,34,3,2
18,390,390,4,4,0,1,0
3,398,398,20,7,13,3,2
24,423,423,9,9,0,1,0
16,427,427,4,4,0,1,0
42,434,434,102,10,92,4,3
0,453,453,8,2,6,3,2
14,456,456,18,18,0,1,0
12,459,459,66,26,40,2,1
13,460,460,1,1,0,1,0
10,471,471,64,64,0,1,0
4,478,478,15,15,0,1,0
23,488,488,81,61,20,2,1
19,488,488,15,15,0,1,0
35,489,489,36,36,0,1,0
30,491,491,3,3,0,1,0

37,100,100,20,20,0,1,0
22,107,107,9,9,0,1,0
4,107,107,10,10,0,1,0
34,127,127,7,2,5,2,1
5,152,152,4,1,3,2,1
1,162,162,19,19,0,1,0
25,173,173,2,2,0,1,0
3,194,194,20,20,0,1,0
13,207,207,33,33,0,1,0
24,208,208,14,11,3,2,1
12,219,219,1,1,0,1,0
31,249,249,23,23,0,1,0
36,250,250,22,12,10,3,2
20,264,264,32,32,0,1,0
29,269,269,7,1,6,2,1
15,277,277,64,19,45,4,3
11,278,278,21,6,15,4,3
7,282,282,22,22,0,1,0
30,287,287,60,20,40,3,2
16,288,288,36,36,0,1,0
10,291,291,10,3,7,2,1
18,309,309,54,54,0,1,0
23,317,317,51,3,48,3,2
17,351,351,2,2,0,1,0
35,353,353,20,20,0,1,0
19,379,379,56,18,38,4,3
28,394,394,39,39,0,1,0
0,396,396,4,1,3,2,1
33,397,397,184,138,46,3,2
2,403,403,31,11,20,3,2
21,404,404,14,6,8,3,2
26,406,406,8,8,0,1,0
9,423,423,24,24,0,1,0
14,439,439,54,23,31,2,1
32,456,456,6,6,0,1,0
27,461,461,2,2,0,1,0
38,482,482,80,80,0,1,0
8,494,494,15,15,0,1,0
6,500,500,4,4,0,1,0

