8,105,105,5,5,0,1,0
13,116,116,18,18,0,1,0
9,122,122,4,4,0,1,0
10,137,137,7,7,0,1,0
12,145,145,18,3,15,4,3
6,197,197,14,7,7,3,2
7,243,243,33,15,18,3,2
2,303,303,17,1,16,2,1
4,308,308,65,65,0,1,0
0,313,313,19,1,18,4,3
1,314,314,1,1,0,1,0
5,323,323,11,11,0,1,0
15,363,363,24,12,12,4,3
11,374,374,1,1,0,1,0
14,415,415,57,57,0,1,0
16,417,417,117,57,60,4,3
3,457,457,68,33,35,2,1

6,111,111,11,1,10,3,2
9,112,112,10,10,0,1,0
5,152,152,50,50,0,1,0
8,187,187,8,2,6,2,1
10,199,199,44,34,10,3,2
2,240,240,14,14,0,1,0
4,257,257,63,22,41,2,1
0,307,307,1,1,0,1,0
1,319,319,9,3,6,3,2
3,323,323,12,7,5,2,1
12,342,342,1,1,0,1,0
11,363,363,46,46,0,1,0
13,366,366,52,7,45,4,3
7,402,402,77,65,12,2,1

4,100,100,20,17,3,2,1
17,101,101,2,2,0,1,0
16,108,108,5,5,0,1,0
12,131,131,54,23,31,4,3
9,140,140,12,12,0,1,0
5,151,151,18,18,0,1,0
14,168,168,19,3,16,3,2
2,168,168,18,6,12,3,2
7,196,196,7,1,6,2,1
8,237,237,13,13,0,1,0
3,252,252,22,22,0,1,0
13,263,263,17,17,0,1,0
6,293,293,10,7,3,2,1
1,386,386,8,8,0,1,0
10,394,394,20,20,0,1,0
0,398,398,2,2,0,1,0
15,400,400,33,29,4,2,1
11,449,449,40,2,38,2,1

14,140,140,19,8,11,2,1
5,193,193,8,4,4,2,1
12,197,197,69,15,54,4,3
9,208,208,11,11,0,1,0
4,230,230,1,1,0,1,0
0,232,232,4,4,0,1,0
1,275,275,25,8,17,2,1
13,286,286,14,1,13,4,3
8,321,321,36,36,0,1,0
7,331,331,6,6,0,1,0
6,332,332,123,81,42,4,3
2,337,337,61,43,18,4,3
3,384,384,30,4,26,2,1
11,418,418,1,1,0,1,0
10,427,427,49,29,20,2,1

12,111,111,3,3,0,1,0
8,117,117,5,5,0,1,0
9,121,121,9,3,6,3,2
15,170,170,60,18,42,4,3
14,198,198,44,34,10,2,1
4,200,200,13,6,7,2,1
6,206,206,13,1,12,4,3
13,208,208,17,17,0,1,0
10,209,209,8,8,0,1,0
5,272,272,48,19,29,2,1
11,276,276,9,1,8,3,2
0,283,283,15,5,10,2,1
3,329,329,1,1,0,1,0
7,371,371,108,18,90,4,3
2,470,470,43,20,23,2,1
1,498,498,7,7,0,1,0

14,101,101,2,2,0,1,0
18,106,106,30,9,21,4,3
2,110,110,5,5,0,1,0
17,146,146,22,8,14,3,2
4,151,151,8,8,0,1,0
11,165,165,25,25,0,1,0
10,242,242,1,1,0,1,0
16,285,285,6,6,0,1,0
8,313,313,19,1,18,3,2
13,324,324,33,33,0,1,0
15,349,349,69,3,66,4,3
1,353,353,26,5,21,4,3
7,400,400,35,2,33,2,1
3,453,453,9,3,6,3,2
6,453,453,22,10,12,4,3
12,459,459,18,18,0,1,0
9,474,474,102,77,25,2,1
0,482,482,6,6,0,1,0
5,499,499,15,1,14,2,1

8,106,106,24,12,12,2,1
5,124,124,1,1,0,1,0
3,147,147,21,6,15,2,1
9,204,204,15,15,0,1,0
4,210,210,33,17,16,2,1
2,223,223,28,28,0,1,0
11,255,255,26,1,25,2,1
14,261,261,30,18,12,3,2
12,287,287,20,20,0,1,0
13,290,290,1,1,0,1,0
6,292,292,40,24,16,2,1
0,380,380,22,6,16,2,1
7,396,396,35,3,32,3,2
10,446,446,100,100,0,1,0
1,496,496,42,4,38,2,1

4,105,105,21,14,7,2,1
11,178,178,2,2,0,1,0
9,179,179,10,10,0,1,0
6,183,183,10,10,0,1,0
13,183,183,15,3,12,4,3
1,201,201,18,18,0,1,0
8,215,215,3,3,0,1,0
7,264,264,2,2,0,1,0
12,305,305,8,8,0,1,0
10,323,323,97,97,0,1,0
14,327,327,28,28,0,1,0
15,416,416,104,104,0,1,0
0,429,429,21,17,4,2,1
5,432,432,2,2,0,1,0
2,474,474,22,22,0,1,0
3,477,477,161,161,0,1,0

1,105,105,2,2,0,1,0
12,109,109,10,5,5,2,1
6,128,128,1,1,0,1,0
2,143,143,1,1,0,1,0
7,158,158,17,17,0,1,0
10,179,179,5,1,4,2,1
4,210,210,7,7,0,1,0
16,235,235,29,4,25,4,3
15,240,240,25,8,17,4,3
18,241,241,11,11,0,1,0
3,251,251,26,26,0,1,0
0,254,254,21,11,10,2,1
14,313,313,7,1,6,2,1
8,347,347,16,10,6,2,1
17,349,349,16,16,0,1,0
20,354,354,157,157,0,1,0
13,389,389,10,6,4,2,1
5,407,407,30,30,0,1,0
9,448,448,15,11,4,2,1
11,463,463,66,46,20,3,2
19,477,477,12,12,0,1,0

14,110,110,5,2,3,2,1
3,152,152,26,26,0,1,0
15,178,178,31,6,25,2,1
5,197,197,5,1,4,2,1
0,260,260,21,9,12,2,1
6,263,263,35,35,0,1,0
1,283,283,9,4,5,2,1
11,322,322,2,2,0,1,0
13,341,341,5,5,0,1,0
4,355,355,11,11,0,1,0
9,396,396,158,158,0,1,0
8,402,402,3,3,0,1,0
10,449,449,16,10,6,2,1
7,456,456,19,12,7,2,1
12,457,457,61,61,0,1,0
2,480,480,134,134,0,1,0

13,186,186,5,5,0,1,0
8,193,193,17,17,0,1,0
4,197,197,22,22,0,1,0
0,204,204,48,48,0,1,0
11,207,207,6,6,0,1,0
6,233,233,1,1,0,1,0
7,262,262,17,17,0,1,0
14,269,269,62,33,29,2,1
10,273,273,87,42,45,4,3
3,297,297,5,5,0,1,0
12,408,408,41,41,0,1,0
1,445,445,53,53,0,1,0
5,470,470,31,7,24,3,2
9,474,474,10,4,6,3,2
2,498,498,91,91,0,1,0

7,103,103,2,2,0,1,0
10,132,132,2,2,0,1,0
13,172,172,6,6,0,1,0
2,174,174,14,5,9,2,1
1,175,175,41,41,0,1,0
11,243,243,33,33,0,1,0
12,259,259,55,55,0,1,0
0,275,275,17,3,14,2,1
9,286,286,34,34,0,1,0
6,287,287,15,15,0,1,0
17,300,300,27,27,0,1,0
16,314,314,21,21,0,1,0
15,316,316,61,7,54,3,2
3,334,334,2,2,0,1,0
5,363,363,3,3,0,1,0
14,370,370,30,30,0,1,0
4,440,440,65,65,0,1,0
8,463,463,29,29,0,1,0

4,103,103,31,14,17,3,2
15,109,109,3,3,0,1,0
7,116,116,4,4,0,1,0
13,154,154,30,30,0,1,0
8,161,161,3,3,0,1,0
12,165,165,50,16,34,2,1
0,173,173,30,30,0,1,0
11,213,213,18,9,9,2,1
3,233,233,4,1,3,2,1
5,242,242,15,15,0,1,0
14,304,304,55,16,39,4,3
1,330,330,11,11,0,1,0
2,341,341,39,20,19,2,1
6,408,408,20,4,16,3,2
9,415,415,3,3,0,1,0
10,499,499,9,9,0,1,0

13,122,122,2,2,0,1,0
17,141,141,6,6,0,1,0
5,175,175,28,28,0,1,0
4,175,175,12,12,0,1,0
16,212,212,65,28,37,3,2
15,229,229,1,1,0,1,0
19,239,239,64,34,30,4,3
7,260,260,5,5,0,1,0
8,270,270,32,32,0,1,0
9,276,276,9,9,0,1,0
11,314,314,5,5,0,1,0
3,349,349,26,26,0,1,0
6,391,391,7,7,0,1,0
10,427,427,2,2,0,1,0
1,434,434,10,10,0,1,0
18,435,435,30,30,0,1,0
2,452,452,28,28,0,1,0
12,460,460,54,54,0,1,0
14,473,473,52,52,0,1,0
0,490,490,42,42,0,1,0

5,149,149,1,1,0,1,0
15,167,167,12,2,10,2,1
16,225,225,36,15,21,4,3
3,227,227,12,5,7,2,1
4,230,230,3,3,0,1,0
9,241,241,1,1,0,1,0
14,264,264,2,2,0,1,0
22,294,294,29,15,14,2,1
12,343,343,1,1,0,1,0
8,343,343,4,4,0,1,0
1,346,346,40,40,0,1,0
17,354,354,26,6,20,3,2
0,379,379,66,12,54,3,2
20,388,388,2,2,0,1,0
2,403,403,6,6,0,1,0
11,411,411,14,14,0,1,0
10,412,412,19,5,14,3,2
13,412,412,31,21,10,2,1
21,422,422,157,157,0,1,0
6,427,427,24,9,15,2,1
19,438,438,21,6,15,4,3
18,457,457,24,19,5,2,1
7,469,469,54,8,46,3,2

0,115,115,6,6,0,1,0
7,117,117,4,1,3,2,1
11,126,126,12,12,0,1,0
12,165,165,3,3,0,1,0
2,258,258,3,3,0,1,0
10,261,261,41,41,0,1,0
1,270,270,17,5,12,3,2
5,295,295,3,3,0,1,0
9,327,327,20,12,8,3,2
14,328,328,50,34,16,3,2
3,369,369,31,31,0,1,0
6,402,402,93,61,32,3,2
8,426,426,69,69,0,1,0
4,456,456,42,11,31,2,1
13,485,485,41,41,0,1,0
16,492,492,121,102,19,2,1
15,500,500,28,28,0,1,0

0,105,105,16,16,0,1,0
6,107,107,7,3,4,2,1
8,117,117,5,5,0,1,0
10,160,160,13,13,0,1,0
1,174,174,42,42,0,1,0
2,222,222,40,40,0,1,0
13,247,247,20,20,0,1,0
12,300,300,31,28,3,2,1
11,305,305,39,6,33,2,1
7,319,319,114,101,13,2,1
3,368,368,39,39,0,1,0
9,397,397,8,8,0,1,0
5,400,400,11,11,0,1,0
4,425,425,15,3,12,2,1

14,154,154,1,1,0,1,0
12,177,177,21,3,18,4,3
9,188,188,9,9,0,1,0
7,196,196,26,20,6,3,2
6,206,206,6,6,0,1,0
11,223,223,33,33,0,1,0
4,225,225,21,11,10,2,1
5,277,277,9,9,0,1,0
2,306,306,42,42,0,1,0
8,363,363,32,32,0,1,0
10,364,364,5,5,0,1,0
3,368,368,47,47,0,1,0
15,375,375,47,47,0,1,0
13,379,379,136,76,60,4,3
0,419,419,5,5,0,1,0
1,486,486,72,12,60,4,3

22,123,123,5,5,0,1,0
18,133,133,9,9,0,1,0
8,164,164,23,23,0,1,0
2,170,170,2,2,0,1,0
9,209,209,13,13,0,1,0
12,215,215,20,2,18,3,2
14,216,216,5,5,0,1,0
3,220,220,10,1,9,2,1
15,252,252,2,2,0,1,0
19,257,257,25,25,0,1,0
6,259,259,3,3,0,1,0
11,272,272,7,3,4,2,1
20,282,282,81,27,54,4,3
17,286,286,31,31,0,1,0
16,319,319,4,4,0,1,0
1,343,343,4,1,3,2,1
13,351,351,17,17,0,1,0
0,409,409,12,6,6,3,2
7,429,429,107,83,24,4,3
21,447,447,89,19,70,3,2
5,465,465,13,13,0,1,0
10,493,493,6,6,0,1,0
4,499,499,1,1,0,1,0

6,104,104,8,2,6,3,2
13,121,121,1,1,0,1,0
11,157,157,17,17,0,1,0
4,172,172,17,8,9,4,3
9,211,211,39,39,0,1,0
10,227,227,28,20,8,3,2
3,250,250,24,24,0,1,0
8,266,266,26,2,24,3,2
2,271,271,14,14,0,1,0
7,287,287,53,14,39,4,3
0,356,356,12,1,11,2,1
5,358,358,88,58,30,4,3
12,382,382,43,35,8,2,1
1,461,461,93,12,81,4,3

7,143,143,4,4,0,1,0
1,183,183,36,6,30,3,2
5,192,192,2,2,0,1,0
13,195,195,5,5,0,1,0
0,285,285,4,1,3,2,1
16,304,304,64,64,0,1,0
2,315,315,27,27,0,1,0
15,320,320,10,10,0,1,0
12,351,351,41,33,8,2,1
4,386,386,114,11,103,4,3
11,402,402,62,62,0,1,0
6,406,406,8,8,0,1,0
8,412,412,7,7,0,1,0
14,412,412,28,25,3,2,1
3,413,413,8,8,0,1,0
10,471,471,97,59,38,3,2
9,497,497,57,57,0,1,0

5,133,133,12,12,0,1,0
13,165,165,2,2,0,1,0
8,200,200,11,11,0,1,0
9,233,233,54,18,36,3,2
12,239,239,52,52,0,1,0
7,260,260,19,2,17,2,1
6,300,300,54,6,48,4,3
2,328,328,2,2,0,1,0
0,341,341,67,67,0,1,0
11,370,370,26,12,14,2,1
1,375,375,91,72,19,2,1
10,434,434,66,40,26,2,1
3,483,483,12,4,8,3,2
4,499,499,30,30,0,1,0

6,151,151,6,1,5,2,1
8,167,167,14,7,7,2,1
17,167,167,9,9,0,1,0
13,189,189,37,21,16,3,2
7,196,196,15,15,0,1,0
19,231,231,33,30,3,2,1
4,254,254,23,12,11,2,1
14,279,279,2,2,0,1,0
3,332,332,86,86,0,1,0
9,339,339,15,15,0,1,0
18,358,358,10,6,4,2,1
15,398,398,111,45,66,4,3
2,399,399,5,5,0,1,0
12,412,412,12,2,10,3,2
10,419,419,16,16,0,1,0
1,422,422,29,14,15,2,1
5,455,455,7,7,0,1,0
16,459,459,48,48,0,1,0
11,470,470,3,3,0,1,0
0,479,479,18,18,0,1,0

13,100,100,3,3,0,1,0
5,102,102,7,2,5,2,1
10,155,155,7,7,0,1,0
9,163,163,15,15,0,1,0
0,180,180,16,10,6,3,2
18,182,182,49,49,0,1,0
20,198,198,8,8,0,1,0
21,274,274,26,26,0,1,0
19,276,276,29,29,0,1,0
15,288,288,14,6,8,2,1
1,313,313,1,1,0,1,0
17,316,316,65,19,46,4,3
14,339,339,7,7,0,1,0
4,356,356,26,26,0,1,0
8,358,358,9,2,7,2,1
6,397,397,41,41,0,1,0
7,413,413,33,23,10,2,1
3,449,449,61,40,21,4,3
11,454,454,3,3,0,1,0
12,468,468,10,10,0,1,0
2,472,472,3,3,0,1,0
16,491,491,22,22,0,1,0

1,106,106,17,7,10,3,2
14,112,112,13,13,0,1,0
12,161,161,54,54,0,1,0
9,189,189,6,6,0,1,0
2,203,203,16,7,9,4,3
4,213,213,2,2,0,1,0
11,281,281,16,9,7,2,1
8,293,293,34,34,0,1,0
13,295,295,39,9,30,4,3
3,302,302,45,12,33,2,1
10,341,341,38,6,32,2,1
5,347,347,16,4,12,2,1
7,411,411,57,57,0,1,0
6,419,419,42,14,28,3,2
0,433,433,2,2,0,1,0
15,464,464,15,8,7,2,1

3,105,105,2,2,0,1,0
10,111,111,21,21,0,1,0
4,112,112,17,1,16,3,2
7,117,117,9,1,8,3,2
9,130,130,15,15,0,1,0
15,266,266,35,3,32,3,2
2,270,270,36,36,0,1,0
16,288,288,22,7,15,4,3
12,318,318,48,48,0,1,0
13,362,362,19,9,10,3,2
6,381,381,39,14,25,2,1
14,382,382,31,13,18,3,2
1,389,389,7,4,3,2,1
5,432,432,7,2,5,2,1
8,466,466,77,7,70,3,2
0,475,475,1,1,0,1,0
11,500,500,65,65,0,1,0

11,129,129,21,7,14,3,2
0,157,157,3,3,0,1,0
1,182,182,87,21,66,4,3
2,195,195,37,34,3,2,1
4,212,212,13,13,0,1,0
10,225,225,1,1,0,1,0
9,226,226,16,16,0,1,0
8,423,423,6,3,3,2,1
6,424,424,24,24,0,1,0
7,424,424,8,3,5,2,1
5,470,470,229,197,32,3,2
3,480,480,27,27,0,1,0

7,110,110,3,3,0,1,0
14,147,147,1,1,0,1,0
15,163,163,14,14,0,1,0
13,166,166,4,4,0,1,0
1,178,178,18,12,6,2,1
3,196,196,26,9,17,2,1
11,214,214,82,17,65,4,3
9,298,298,56,8,48,4,3
6,321,321,39,26,13,2,1
12,358,358,12,12,0,1,0
2,375,375,16,16,0,1,0
10,378,378,36,36,0,1,0
5,417,417,47,47,0,1,0
8,446,446,33,33,0,1,0
4,460,460,12,12,0,1,0
0,493,493,80,35,45,2,1

15,100,100,27,27,0,1,0
7,129,129,9,9,0,1,0
2,136,136,9,9,0,1,0
5,147,147,14,14,0,1,0
1,208,208,6,1,5,2,1
0,222,222,8,8,0,1,0
16,225,225,28,7,21,4,3
3,260,260,1,1,0,1,0
9,278,278,37,37,0,1,0
8,317,317,81,81,0,1,0
6,368,368,32,32,0,1,0
12,371,371,8,4,4,2,1
11,395,395,7,4,3,2,1
14,439,439,66,3,63,3,2
13,468,468,74,74,0,1,0
10,499,499,38,38,0,1,0
4,500,500,14,2,12,4,3

13,103,103,11,11,0,1,0
4,175,175,11,11,0,1,0
6,194,194,11,11,0,1,0
9,195,195,25,19,6,3,2
15,262,262,16,16,0,1,0
14,286,286,40,40,0,1,0
1,287,287,4,4,0,1,0
16,315,315,52,18,34,2,1
3,316,316,9,9,0,1,0
7,323,323,38,38,0,1,0
12,333,333,39,23,16,3,2
2,368,368,16,8,8,2,1
11,370,370,56,10,46,3,2
10,428,428,31,31,0,1,0
0,436,436,57,33,24,3,2
8,441,441,44,44,0,1,0
5,445,445,53,53,0,1,0

5,132,132,17,17,0,1,0
10,169,169,16,16,0,1,0
4,195,195,53,11,42,2,1
6,203,203,31,23,8,2,1
7,233,233,38,4,34,3,2
11,290,290,11,11,0,1,0
8,300,300,91,65,26,2,1
0,327,327,67,67,0,1,0
3,337,337,3,3,0,1,0
12,383,383,11,11,0,1,0
1,437,437,5,5,0,1,0
9,446,446,24,24,0,1,0
2,474,474,12,12,0,1,0
13,494,494,64,22,42,4,3

8,111,111,5,5,0,1,0
10,154,154,32,32,0,1,0
0,158,158,2,2,0,1,0
5,168,168,18,9,9,2,1
1,180,180,22,22,0,1,0
14,203,203,30,30,0,1,0
12,208,208,48,48,0,1,0
7,240,240,64,64,0,1,0
2,327,327,37,37,0,1,0
3,345,345,3,3,0,1,0
11,395,395,3,3,0,1,0
9,424,424,56,7,49,2,1
6,446,446,57,57,0,1,0
13,455,455,21,21,0,1,0
4,475,475,21,7,14,2,1

4,108,108,28,28,0,1,0
2,152,152,1,1,0,1,0
10,153,153,25,25,0,1,0
6,178,178,20,11,9,3,2
11,226,226,23,14,9,4,3
8,240,240,15,7,8,3,2
9,252,252,43,6,37,2,1
0,322,322,4,4,0,1,0
5,379,379,39,27,12,2,1
1,443,443,159,153,6,3,2
3,480,480,81,1,80,3,2
7,499,499,49,49,0,1,0

5,176,176,2,2,0,1,0
13,192,192,44,44,0,1,0
4,208,208,6,3,3,2,1
8,239,239,4,4,0,1,0
12,264,264,25,13,12,4,3
0,270,270,37,18,19,2,1
14,278,278,59,59,0,1,0
9,292,292,4,4,0,1,0
10,306,306,6,6,0,1,0
6,308,308,10,10,0,1,0
18,322,322,19,1,18,2,1
16,339,339,20,3,17,2,1
15,359,359,55,55,0,1,0
11,378,378,3,3,0,1,0
3,393,393,21,9,12,2,1
1,396,396,74,71,3,2,1
7,420,420,41,41,0,1,0
17,450,450,3,3,0,1,0
2,471,471,92,85,7,2,1

15,111,111,4,4,0,1,0
19,118,118,31,21,10,3,2
2,122,122,7,7,0,1,0
6,126,126,12,12,0,1,0
9,139,139,9,9,0,1,0
5,145,145,1,1,0,1,0
22,168,168,3,3,0,1,0
20,173,173,19,3,16,2,1
13,176,176,10,5,5,2,1
7,211,211,29,20,9,4,3
11,212,212,3,3,0,1,0
18,281,281,52,24,28,2,1
3,293,293,18,9,9,4,3
4,303,303,21,21,0,1,0
1,304,304,12,4,8,3,2
21,327,327,24,24,0,1,0
16,336,336,48,38,10,2,1
14,347,347,17,17,0,1,0
12,349,349,7,7,0,1,0
17,397,397,10,10,0,1,0
8,411,411,6,6,0,1,0
10,440,440,22,22,0,1,0
0,495,495,17,17,0,1,0

8,101,101,1,1,0,1,0
14,106,106,41,13,28,4,3
4,121,121,9,3,6,3,2
0,133,133,5,5,0,1,0
7,148,148,8,2,6,3,2
3,183,183,12,6,6,3,2
13,199,199,14,10,4,2,1
10,273,273,44,44,0,1,0
11,275,275,21,12,9,4,3
6,286,286,17,8,9,2,1
16,307,307,14,14,0,1,0
1,318,318,32,32,0,1,0
5,391,391,72,72,0,1,0
9,392,392,11,6,5,2,1
2,395,395,74,46,28,3,2
12,433,433,29,29,0,1,0
15,471,471,5,1,4,2,1

8,138,138,24,24,0,1,0
0,154,154,35,5,30,4,3
11,172,172,22,22,0,1,0
3,174,174,18,3,15,4,3
9,178,178,21,21,0,1,0
6,200,200,18,5,13,2,1
12,261,261,8,8,0,1,0
5,264,264,7,7,0,1,0
10,266,266,9,3,6,2,1
4,322,322,20,9,11,2,1
1,347,347,31,27,4,2,1
14,372,372,5,5,0,1,0
13,389,389,125,82,43,4,3
2,475,475,27,27,0,1,0
7,481,481,70,70,0,1,0

7,111,111,47,5,42,4,3
10,137,137,4,1,3,2,1
3,142,142,11,2,9,4,3
2,146,146,7,7,0,1,0
15,155,155,11,11,0,1,0
9,179,179,43,43,0,1,0
1,311,311,6,6,0,1,0
13,340,340,7,7,0,1,0
4,351,351,5,5,0,1,0
0,411,411,12,1,11,2,1
5,416,416,12,12,0,1,0
8,432,432,67,67,0,1,0
12,458,458,59,19,40,2,1
11,480,480,47,47,0,1,0
14,481,481,110,103,7,2,1
6,487,487,3,3,0,1,0

13,101,101,19,3,16,3,2
4,107,107,28,28,0,1,0
1,130,130,1,1,0,1,0
10,130,130,1,1,0,1,0
11,134,134,4,4,0,1,0
2,141,141,12,12,0,1,0
14,188,188,22,22,0,1,0
17,209,209,14,14,0,1,0
18,237,237,4,1,3,2,1
19,270,270,46,10,36,4,3
6,297,297,1,1,0,1,0
15,302,302,26,12,14,2,1
8,303,303,12,2,10,2,1
12,350,350,40,40,0,1,0
5,358,358,27,27,0,1,0
16,360,360,60,60,0,1,0
7,376,376,17,17,0,1,0
9,424,424,12,1,11,2,1
3,498,498,34,12,22,2,1
0,500,500,17,17,0,1,0

0,145,145,6,1,5,2,1
11,147,147,46,46,0,1,0
12,180,180,9,9,0,1,0
3,189,189,29,25,4,2,1
6,251,251,17,5,12,4,3
1,256,256,59,29,30,3,2
7,288,288,4,4,0,1,0
2,289,289,69,69,0,1,0
5,299,299,2,2,0,1,0
9,320,320,31,16,15,4,3
13,320,320,26,8,18,3,2
10,455,455,111,78,33,2,1
4,475,475,30,30,0,1,0
8,499,499,8,8,0,1,0

6,101,101,1,1,0,1,0
22,108,108,2,2,0,1,0
15,112,112,3,3,0,1,0
14,114,114,7,7,0,1,0
12,119,119,5,5,0,1,0
19,152,152,6,2,4,2,1
16,178,178,15,15,0,1,0
21,217,217,51,4,47,4,3
3,223,223,9,1,8,2,1
2,224,224,35,30,5,2,1
17,245,245,63,63,0,1,0
0,252,252,8,3,5,2,1
9,256,256,16,3,13,2,1
13,314,314,10,10,0,1,0
4,314,314,48,48,0,1,0
18,314,314,24,24,0,1,0
7,339,339,1,1,0,1,0
20,346,346,35,35,0,1,0
11,349,349,16,16,0,1,0
5,415,415,21,17,4,2,1
1,443,443,27,8,19,3,2
10,454,454,11,11,0,1,0
8,465,465,3,3,0,1,0

12,175,175,30,4,26,2,1
0,210,210,25,25,0,1,0
8,214,214,2,2,0,1,0
5,247,247,30,30,0,1,0
11,250,250,4,4,0,1,0
10,293,293,42,42,0,1,0
1,323,323,1,1,0,1,0
6,326,326,27,1,26,3,2
3,331,331,17,17,0,1,0
2,369,369,3,3,0,1,0
7,384,384,154,154,0,1,0
13,399,399,28,28,0,1,0
9,405,405,1,1,0,1,0
4,439,439,183,113,70,3,2

3,134,134,10,10,0,1,0
8,161,161,7,7,0,1,0
1,180,180,4,4,0,1,0
0,198,198,77,77,0,1,0
13,201,201,6,6,0,1,0
4,212,212,3,3,0,1,0
6,259,259,28,28,0,1,0
15,270,270,54,54,0,1,0
2,316,316,26,26,0,1,0
5,318,318,15,15,0,1,0
9,323,323,20,20,0,1,0
14,324,324,91,91,0,1,0
7,329,329,8,8,0,1,0
12,386,386,85,25,60,4,3
11,391,391,1,1,0,1,0
10,448,448,8,8,0,1,0

12,106,106,40,40,0,1,0
7,127,127,6,6,0,1,0
6,135,135,6,3,3,2,1
5,162,162,5,5,0,1,0
13,200,200,11,11,0,1,0
10,214,214,6,6,0,1,0
8,243,243,13,10,3,2,1
0,251,251,39,7,32,3,2
3,254,254,18,18,0,1,0
18,269,269,17,1,16,2,1
16,309,309,53,36,17,2,1
9,336,336,30,15,15,4,3
2,339,339,2,2,0,1,0
1,348,348,6,6,0,1,0
15,384,384,27,27,0,1,0
14,423,423,31,31,0,1,0
17,430,430,4,4,0,1,0
4,463,463,43,43,0,1,0
11,467,467,77,77,0,1,0

10,165,165,22,12,10,3,2
11,174,174,2,2,0,1,0
2,203,203,1,1,0,1,0
5,210,210,24,24,0,1,0
6,211,211,17,3,14,2,1
1,213,213,3,3,0,1,0
18,223,223,29,29,0,1,0
8,225,225,17,17,0,1,0
3,230,230,5,2,3,2,1
15,232,232,16,8,8,3,2
12,328,328,67,24,43,2,1
7,334,334,37,37,0,1,0
13,376,376,70,24,46,2,1
9,381,381,26,10,16,2,1
16,424,424,27,19,8,3,2
17,442,442,9,3,6,2,1
0,468,468,57,11,46,2,1
14,483,483,66,38,28,3,2
4,486,486,23,23,0,1,0

1,156,156,15,12,3,2,1
5,163,163,13,2,11,2,1
0,176,176,10,10,0,1,0
15,186,186,11,1,10,2,1
6,191,191,45,28,17,2,1
2,219,219,3,3,0,1,0
10,248,248,1,1,0,1,0
3,282,282,20,2,18,2,1
17,317,317,2,2,0,1,0
8,329,329,22,7,15,2,1
18,357,357,53,27,26,2,1
14,368,368,6,6,0,1,0
11,386,386,7,3,4,2,1
7,391,391,16,16,0,1,0
16,398,398,37,1,36,3,2
13,459,459,62,36,26,3,2
4,483,483,25,8,17,2,1
12,489,489,173,89,84,4,3
9,496,496,33,6,27,2,1

3,118,118,17,5,12,2,1
7,210,210,2,2,0,1,0
6,216,216,19,3,16,3,2
9,232,232,23,18,5,2,1
10,248,248,14,4,10,3,2
1,280,280,8,8,0,1,0
16,347,347,33,33,0,1,0
0,358,358,15,15,0,1,0
11,375,375,2,2,0,1,0
2,380,380,25,25,0,1,0
8,388,388,39,39,0,1,0
15,415,415,71,14,57,4,3
12,418,418,4,1,3,2,1
13,420,420,91,70,21,4,3
4,426,426,22,22,0,1,0
14,460,460,121,121,0,1,0
5,474,474,83,13,70,3,2

12,141,141,38,6,32,4,3
3,156,156,7,7,0,1,0
6,179,179,10,3,7,2,1
9,194,194,40,16,24,3,2
13,194,194,6,6,0,1,0
2,221,221,71,71,0,1,0
1,260,260,36,8,28,2,1
7,268,268,13,13,0,1,0
15,285,285,34,34,0,1,0
11,328,328,16,16,0,1,0
0,335,335,14,14,0,1,0
4,380,380,31,10,21,4,3
8,393,393,5,5,0,1,0
5,410,410,23,7,16,3,2
14,454,454,51,51,0,1,0
10,479,479,13,7,6,3,2

10,119,119,4,4,0,1,0
4,256,256,21,13,8,2,1
7,258,258,101,20,81,3,2
3,277,277,39,1,38,2,1
8,277,277,31,21,10,3,2
0,373,373,104,44,60,4,3
11,404,404,28,10,18,4,3
5,410,410,34,15,19,2,1
2,438,438,65,10,55,4,3
6,471,471,33,3,30,4,3
1,475,475,73,59,14,3,2
9,484,484,26,26,0,1,0

5,115,115,26,26,0,1,0
11,122,122,3,3,0,1,0
16,126,126,17,17,0,1,0
4,130,130,15,15,0,1,0
12,146,146,22,1,21,4,3
15,173,173,22,22,0,1,0
13,183,183,36,7,29,2,1
8,223,223,1,1,0,1,0
0,246,246,25,25,0,1,0
9,268,268,17,1,16,4,3
6,301,301,1,1,0,1,0
14,304,304,54,54,0,1,0
10,324,324,3,3,0,1,0
3,342,342,20,20,0,1,0
7,395,395,3,3,0,1,0
1,413,413,19,19,0,1,0
2,432,432,76,76,0,1,0

4,102,102,12,12,0,1,0
18,129,129,36,9,27,4,3
11,130,130,7,7,0,1,0
6,206,206,13,13,0,1,0
15,268,268,40,30,10,2,1
14,269,269,15,6,9,4,3
16,332,332,54,30,24,2,1
8,339,339,51,39,12,3,2
17,341,341,4,4,0,1,0
5,344,344,47,21,26,2,1
7,344,344,13,13,0,1,0
13,345,345,26,26,0,1,0
3,361,361,18,18,0,1,0
1,365,365,1,1,0,1,0
9,383,383,9,5,4,2,1
2,389,389,37,33,4,2,1
10,420,420,27,14,13,2,1
0,468,468,3,3,0,1,0
12,493,493,41,41,0,1,0

0,181,181,24,24,0,1,0
13,192,192,30,30,0,1,0
2,226,226,6,6,0,1,0
14,251,251,6,6,0,1,0
15,291,291,1,1,0,1,0
4,303,303,3,3,0,1,0
9,308,308,13,7,6,2,1
7,320,320,12,12,0,1,0
8,338,338,45,21,24,2,1
6,359,359,13,13,0,1,0
12,401,401,103,80,23,4,3
16,418,418,40,40,0,1,0
1,438,438,142,142,0,1,0
5,445,445,25,25,0,1,0
10,471,471,15,15,0,1,0
3,473,473,1,1,0,1,0
11,484,484,116,116,0,1,0

10,102,102,16,16,0,1,0
8,119,119,9,1,8,2,1
2,128,128,7,7,0,1,0
13,137,137,16,6,10,2,1
6,160,160,19,19,0,1,0
9,174,174,12,12,0,1,0
5,204,204,48,48,0,1,0
4,253,253,7,7,0,1,0
12,264,264,4,1,3,2,1
11,281,281,21,21,0,1,0
3,304,304,39,25,14,3,2
0,406,406,68,68,0,1,0
7,441,441,136,58,78,3,2
1,469,469,34,22,12,4,3

8,125,125,1,1,0,1,0
3,145,145,1,1,0,1,0
0,150,150,2,2,0,1,0
18,193,193,10,10,0,1,0
13,213,213,35,35,0,1,0
17,230,230,17,2,15,4,3
14,254,254,64,64,0,1,0
6,262,262,1,1,0,1,0
9,266,266,30,16,14,3,2
10,281,281,25,25,0,1,0
2,296,296,8,8,0,1,0
7,350,350,76,68,8,2,1
4,389,389,33,33,0,1,0
12,392,392,37,37,0,1,0
11,399,399,1,1,0,1,0
16,407,407,40,6,34,2,1
5,416,416,89,89,0,1,0
1,423,423,9,9,0,1,0
15,449,449,37,24,13,2,1

6,105,105,1,1,0,1,0
7,162,162,16,10,6,2,1
5,164,164,64,2,62,3,2
9,217,217,31,5,26,3,2
4,224,224,11,1,10,3,2
2,294,294,9,9,0,1,0
11,351,351,15,15,0,1,0
12,388,388,22,22,0,1,0
1,407,407,41,41,0,1,0
10,413,413,31,8,23,2,1
8,471,471,185,151,34,2,1
0,489,489,108,12,96,3,2
3,497,497,5,5,0,1,0

4,127,127,28,3,25,2,1
13,137,137,14,14,0,1,0
6,153,153,14,14,0,1,0
3,181,181,23,23,0,1,0
7,223,223,8,2,6,3,2
9,264,264,23,3,20,3,2
11,264,264,15,15,0,1,0
12,266,266,42,42,0,1,0
5,383,383,1,1,0,1,0
0,393,393,73,28,45,3,2
8,423,423,18,2,16,2,1
10,426,426,141,47,94,3,2
1,438,438,40,40,0,1,0
2,465,465,40,40,0,1,0

6,131,131,1,1,0,1,0
14,175,175,6,6,0,1,0
9,186,186,2,2,0,1,0
17,194,194,6,6,0,1,0
7,212,212,4,1,3,2,1
8,216,216,2,2,0,1,0
5,217,217,1,1,0,1,0
21,240,240,41,12,29,2,1
12,272,272,38,38,0,1,0
18,283,283,8,8,0,1,0
19,321,321,106,31,75,4,3
4,325,325,13,13,0,1,0
0,328,328,34,12,22,2,1
16,332,332,18,12,6,2,1
15,362,362,30,30,0,1,0
1,390,390,54,45,9,4,3
11,397,397,32,32,0,1,0
13,398,398,6,2,4,2,1
10,399,399,40,40,0,1,0
3,422,422,40,40,0,1,0
20,433,433,51,1,50,3,2
2,480,480,3,3,0,1,0

2,115,115,30,3,27,3,2
3,181,181,6,6,0,1,0
13,189,189,5,5,0,1,0
11,197,197,23,5,18,3,2
15,238,238,83,83,0,1,0
12,304,304,40,40,0,1,0
4,313,313,18,14,4,2,1
10,327,327,9,1,8,3,2
14,366,366,54,54,0,1,0
6,371,371,18,6,12,3,2
7,373,373,2,2,0,1,0
1,385,385,30,12,18,3,2
9,391,391,7,7,0,1,0
5,431,431,20,20,0,1,0
0,451,451,24,5,19,2,1
8,492,492,107,59,48,3,2

15,131,131,5,5,0,1,0
4,191,191,5,5,0,1,0
10,195,195,1,1,0,1,0
16,199,199,19,19,0,1,0
5,205,205,49,49,0,1,0
2,218,218,6,6,0,1,0
7,242,242,23,17,6,2,1
19,266,266,38,7,31,2,1
13,273,273,13,13,0,1,0
0,299,299,13,13,0,1,0
12,305,305,6,6,0,1,0
1,350,350,15,6,9,4,3
20,353,353,17,6,11,2,1
9,376,376,16,16,0,1,0
17,383,383,32,10,22,3,2
18,427,427,65,65,0,1,0
8,427,427,13,13,0,1,0
6,451,451,11,11,0,1,0
3,457,457,7,7,0,1,0
11,463,463,66,66,0,1,0
14,482,482,121,89,32,3,2

3,108,108,4,4,0,1,0
0,122,122,21,21,0,1,0
12,129,129,1,1,0,1,0
4,157,157,6,6,0,1,0
5,160,160,2,2,0,1,0
13,176,176,2,2,0,1,0
6,217,217,16,16,0,1,0
10,240,240,19,10,9,4,3
11,383,383,106,31,75,4,3
2,415,415,80,40,40,3,2
8,429,429,19,19,0,1,0
15,440,440,131,111,20,3,2
7,444,444,30,30,0,1,0
1,467,467,76,58,18,3,2
9,470,470,14,4,10,3,2
14,499,499,55,55,0,1,0

18,102,102,2,2,0,1,0
13,123,123,2,2,0,1,0
17,126,126,12,2,10,3,2
10,149,149,3,3,0,1,0
19,153,153,43,43,0,1,0
7,163,163,14,1,13,2,1
16,191,191,1,1,0,1,0
12,199,199,1,1,0,1,0
8,205,205,2,2,0,1,0
2,226,226,1,1,0,1,0
20,264,264,19,19,0,1,0
4,283,283,1,1,0,1,0
0,289,289,2,2,0,1,0
14,349,349,32,32,0,1,0
9,374,374,14,2,12,2,1
1,380,380,53,3,50,3,2
3,412,412,140,119,21,2,1
11,432,432,31,5,26,2,1
15,432,432,109,109,0,1,0
6,470,470,24,24,0,1,0
5,495,495,5,5,0,1,0

4,101,101,3,3,0,1,0
14,113,113,3,3,0,1,0
11,115,115,20,20,0,1,0
7,141,141,26,6,20,2,1
9,152,152,3,3,0,1,0
16,179,179,28,28,0,1,0
15,185,185,17,5,12,3,2
12,238,238,48,36,12,4,3
3,314,314,21,21,0,1,0
13,331,331,20,2,18,2,1
10,335,335,38,38,0,1,0
6,343,343,23,23,0,1,0
8,366,366,58,58,0,1,0
5,382,382,20,13,7,2,1
2,392,392,26,2,24,3,2
0,410,410,56,44,12,3,2
1,413,413,10,3,7,2,1

11,114,114,46,39,7,2,1
10,121,121,7,7,0,1,0
0,125,125,9,9,0,1,0
15,220,220,6,6,0,1,0
13,313,313,9,9,0,1,0
2,327,327,75,36,39,2,1
6,328,328,2,2,0,1,0
4,340,340,35,23,12,4,3
1,373,373,1,1,0,1,0
12,395,395,74,74,0,1,0
16,410,410,25,3,22,2,1
17,420,420,17,17,0,1,0
7,424,424,29,29,0,1,0
14,448,448,26,26,0,1,0
8,469,469,62,35,27,4,3
9,471,471,34,7,27,2,1
3,488,488,13,13,0,1,0
5,492,492,18,18,0,1,0

11,204,204,57,57,0,1,0
4,211,211,1,1,0,1,0
9,236,236,14,14,0,1,0
5,260,260,12,12,0,1,0
10,270,270,32,32,0,1,0
8,277,277,16,12,4,2,1
0,278,278,55,1,54,4,3
3,325,325,94,22,72,3,2
7,381,381,77,17,60,3,2
13,417,417,34,22,12,2,1
2,422,422,83,3,80,4,3
12,438,438,5,1,4,2,1
1,441,441,4,1,3,2,1
6,492,492,28,28,0,1,0

12,158,158,10,10,0,1,0
10,167,167,11,11,0,1,0
7,179,179,13,13,0,1,0
9,223,223,39,16,23,2,1
2,354,354,12,5,7,3,2
13,372,372,101,17,84,3,2
3,380,380,1,1,0,1,0
4,387,387,13,7,6,3,2
6,401,401,17,17,0,1,0
11,409,409,11,11,0,1,0
0,428,428,63,63,0,1,0
1,449,449,238,190,48,4,3
8,459,459,64,19,45,2,1
5,461,461,5,5,0,1,0

5,114,114,24,9,15,2,1
11,117,117,7,7,0,1,0
14,133,133,9,9,0,1,0
6,142,142,9,9,0,1,0
4,201,201,4,4,0,1,0
8,281,281,8,5,3,2,1
1,299,299,11,8,3,2,1
7,305,305,7,2,5,2,1
9,320,320,156,152,4,2,1
12,339,339,33,33,0,1,0
0,412,412,113,91,22,2,1
3,423,423,29,29,0,1,0
2,461,461,48,48,0,1,0
10,496,496,15,10,5,2,1
13,498,498,21,1,20,4,3

13,100,100,24,24,0,1,0
4,114,114,5,5,0,1,0
11,130,130,17,17,0,1,0
5,155,155,3,3,0,1,0
15,159,159,3,3,0,1,0
2,201,201,1,1,0,1,0
16,205,205,5,2,3,2,1
0,211,211,9,1,8,3,2
1,213,213,49,4,45,2,1
8,250,250,17,7,10,3,2
10,338,338,53,23,30,2,1
9,347,347,4,4,0,1,0
3,354,354,79,15,64,3,2
6,380,380,49,39,10,2,1
12,388,388,81,19,62,3,2
14,459,459,19,19,0,1,0
7,469,469,14,2,12,4,3

4,132,132,3,3,0,1,0
0,137,137,15,5,10,2,1
3,138,138,87,87,0,1,0
7,239,239,27,19,8,3,2
11,250,250,3,3,0,1,0
5,253,253,8,8,0,1,0
2,272,272,1,1,0,1,0
1,281,281,1,1,0,1,0
9,296,296,47,47,0,1,0
6,408,408,139,139,0,1,0
12,411,411,5,5,0,1,0
10,437,437,25,25,0,1,0
8,487,487,56,7,49,4,3

5,112,112,9,9,0,1,0
14,123,123,6,6,0,1,0
16,128,128,48,48,0,1,0
7,171,171,1,1,0,1,0
2,177,177,1,1,0,1,0
11,188,188,23,16,7,2,1
15,282,282,53,26,27,4,3
10,309,309,13,13,0,1,0
3,318,318,7,7,0,1,0
12,329,329,7,2,5,2,1
8,349,349,18,18,0,1,0
6,358,358,15,7,8,2,1
0,365,365,147,147,0,1,0
9,390,390,63,39,24,4,3
4,457,457,2,2,0,1,0
1,473,473,12,12,0,1,0
13,487,487,11,4,7,2,1

11,132,132,58,11,47,2,1
5,186,186,6,6,0,1,0
14,196,196,5,5,0,1,0
17,197,197,14,2,12,4,3
0,255,255,1,1,0,1,0
3,260,260,25,3,22,3,2
2,265,265,13,13,0,1,0
9,307,307,31,27,4,2,1
6,334,334,29,29,0,1,0
8,345,345,48,21,27,4,3
16,349,349,10,10,0,1,0
10,402,402,30,30,0,1,0
7,405,405,32,24,8,3,2
4,415,415,57,11,46,4,3
13,428,428,18,18,0,1,0
12,430,430,62,62,0,1,0
1,449,449,1,1,0,1,0
15,499,499,31,31,0,1,0

6,127,127,19,19,0,1,0
12,146,146,3,3,0,1,0
4,156,156,32,16,16,3,2
10,220,220,49,49,0,1,0
13,223,223,16,16,0,1,0
1,252,252,43,20,23,2,1
9,286,286,3,3,0,1,0
11,321,321,95,59,36,4,3
8,328,328,44,32,12,3,2
7,342,342,19,19,0,1,0
2,356,356,6,3,3,2,1
5,428,428,26,26,0,1,0
3,448,448,4,4,0,1,0
0,464,464,88,88,0,1,0

1,125,125,3,3,0,1,0
19,152,152,24,24,0,1,0
17,152,152,19,19,0,1,0
11,178,178,4,4,0,1,0
14,198,198,37,37,0,1,0
6,213,213,7,7,0,1,0
18,219,219,5,5,0,1,0
12,227,227,48,23,25,2,1
3,254,254,7,7,0,1,0
9,269,269,15,15,0,1,0
2,323,323,51,23,28,3,2
7,323,323,6,6,0,1,0
4,338,338,19,19,0,1,0
0,349,349,3,3,0,1,0
15,374,374,37,1,36,3,2
5,385,385,1,1,0,1,0
13,413,413,21,21,0,1,0
16,433,433,75,39,36,3,2
8,447,447,25,25,0,1,0
10,466,466,60,36,24,3,2

7,109,109,20,4,16,3,2
14,115,115,1,1,0,1,0
3,137,137,2,2,0,1,0
1,169,169,5,5,0,1,0
4,180,180,5,5,0,1,0
2,189,189,1,1,0,1,0
8,200,200,1,1,0,1,0
5,230,230,30,30,0,1,0
11,247,247,1,1,0,1,0
17,295,295,62,62,0,1,0
12,354,354,34,19,15,4,3
16,357,357,92,66,26,2,1
0,359,359,48,48,0,1,0
10,371,371,5,5,0,1,0
6,371,371,8,8,0,1,0
15,391,391,71,71,0,1,0
13,487,487,24,24,0,1,0
9,497,497,117,59,58,3,2

15,121,121,14,11,3,2,1
10,163,163,9,9,0,1,0
14,167,167,17,1,16,2,1
16,199,199,39,39,0,1,0
8,206,206,27,27,0,1,0
11,228,228,1,1,0,1,0
17,253,253,63,63,0,1,0
9,328,328,13,13,0,1,0
7,345,345,37,37,0,1,0
4,346,346,59,59,0,1,0
6,366,366,8,8,0,1,0
12,372,372,48,33,15,4,3
2,373,373,22,22,0,1,0
3,379,379,15,10,5,2,1
13,394,394,6,6,0,1,0
1,475,475,39,39,0,1,0
0,477,477,7,7,0,1,0
5,491,491,40,6,34,4,3

8,107,107,6,6,0,1,0
7,115,115,10,10,0,1,0
4,150,150,28,28,0,1,0
5,196,196,19,10,9,4,3
2,299,299,57,33,24,4,3
0,314,314,93,9,84,3,2
3,387,387,88,47,41,2,1
6,435,435,152,152,0,1,0
10,443,443,12,12,0,1,0
1,444,444,39,15,24,3,2
9,493,493,6,6,0,1,0

11,121,121,28,8,20,2,1
4,126,126,38,38,0,1,0
9,144,144,18,18,0,1,0
6,157,157,1,1,0,1,0
2,174,174,22,8,14,3,2
1,192,192,10,1,9,3,2
8,234,234,15,15,0,1,0
0,257,257,42,20,22,3,2
13,309,309,54,31,23,3,2
5,336,336,25,25,0,1,0
3,395,395,28,28,0,1,0
10,416,416,52,15,37,4,3
12,421,421,35,7,28,2,1
7,450,450,3,3,0,1,0
14,454,454,6,2,4,2,1

5,109,109,13,13,0,1,0
2,179,179,12,12,0,1,0
11,184,184,1,1,0,1,0
6,258,258,96,63,33,3,2
12,301,301,4,4,0,1,0
7,335,335,73,73,0,1,0
9,341,341,1,1,0,1,0
8,354,354,15,6,9,4,3
10,364,364,58,58,0,1,0
1,396,396,1,1,0,1,0
4,437,437,128,65,63,4,3
0,461,461,114,40,74,3,2
3,462,462,37,1,36,3,2

4,100,100,6,6,0,1,0
14,135,135,8,8,0,1,0
0,145,145,11,11,0,1,0
15,164,164,10,10,0,1,0
12,165,165,30,30,0,1,0
7,173,173,21,21,0,1,0
13,174,174,6,6,0,1,0
3,175,175,10,10,0,1,0
11,242,242,79,63,16,3,2
2,284,284,9,9,0,1,0
8,302,302,57,57,0,1,0
9,324,324,3,3,0,1,0
5,327,327,2,2,0,1,0
16,398,398,44,44,0,1,0
10,399,399,20,20,0,1,0
1,474,474,49,49,0,1,0
6,478,478,71,43,28,4,3

4,127,127,3,3,0,1,0
8,272,272,63,63,0,1,0
9,301,301,9,9,0,1,0
3,304,304,62,62,0,1,0
10,304,304,5,5,0,1,0
2,306,306,68,16,52,4,3
0,362,362,72,42,30,2,1
1,435,435,66,66,0,1,0
5,439,439,19,19,0,1,0
6,447,447,54,54,0,1,0
7,450,450,126,126,0,1,0
11,454,454,39,39,0,1,0

7,112,112,8,8,0,1,0
11,127,127,15,9,6,2,1
6,128,128,15,15,0,1,0
0,182,182,13,4,9,4,3
1,295,295,98,98,0,1,0
4,336,336,58,36,22,2,1
5,345,345,84,84,0,1,0
9,351,351,73,29,44,3,2
3,416,416,14,6,8,3,2
8,421,421,17,17,0,1,0
2,425,425,81,15,66,4,3
10,426,426,8,8,0,1,0

0,119,119,3,3,0,1,0
15,121,121,5,5,0,1,0
12,121,121,31,31,0,1,0
9,127,127,11,11,0,1,0
17,192,192,34,5,29,2,1
6,199,199,1,1,0,1,0
10,203,203,15,7,8,3,2
8,211,211,24,24,0,1,0
11,248,248,5,2,3,2,1
5,284,284,27,15,12,3,2
2,298,298,40,17,23,2,1
1,329,329,18,18,0,1,0
4,331,331,1,1,0,1,0
14,395,395,26,26,0,1,0
16,403,403,37,37,0,1,0
7,431,431,18,10,8,2,1
3,447,447,66,14,52,3,2
13,482,482,70,50,20,2,1
18,486,486,18,8,10,3,2

4,123,123,2,2,0,1,0
5,146,146,4,1,3,2,1
3,181,181,6,6,0,1,0
7,190,190,9,1,8,3,2
8,195,195,19,19,0,1,0
14,224,224,67,37,30,4,3
10,277,277,22,3,19,2,1
2,279,279,63,23,40,3,2
12,283,283,29,21,8,3,2
1,296,296,1,1,0,1,0
11,305,305,9,9,0,1,0
0,375,375,136,107,29,2,1
6,377,377,33,1,32,3,2
9,434,434,29,8,21,4,3
13,444,444,62,26,36,4,3

10,116,116,44,44,0,1,0
11,123,123,4,4,0,1,0
7,133,133,8,5,3,2,1
12,144,144,10,10,0,1,0
8,172,172,28,18,10,3,2
3,207,207,3,3,0,1,0
6,215,215,1,1,0,1,0
14,255,255,19,19,0,1,0
16,266,266,24,7,17,2,1
13,291,291,22,22,0,1,0
9,309,309,9,9,0,1,0
4,310,310,31,19,12,3,2
1,339,339,4,4,0,1,0
2,383,383,131,73,58,3,2
15,398,398,38,23,15,2,1
5,450,450,18,18,0,1,0
0,450,450,17,17,0,1,0

16,125,125,14,14,0,1,0
9,150,150,5,5,0,1,0
17,160,160,13,13,0,1,0
2,161,161,1,1,0,1,0
1,164,164,2,2,0,1,0
11,165,165,27,9,18,2,1
15,180,180,19,19,0,1,0
12,190,190,15,15,0,1,0
8,243,243,36,24,12,4,3
6,265,265,2,2,0,1,0
14,270,270,59,41,18,4,3
3,305,305,1,1,0,1,0
0,399,399,89,89,0,1,0
10,409,409,58,58,0,1,0
13,456,456,27,27,0,1,0
5,462,462,30,30,0,1,0
7,491,491,53,53,0,1,0
4,498,498,26,26,0,1,0

9,104,104,2,2,0,1,0
0,130,130,14,14,0,1,0
8,180,180,2,2,0,1,0
11,208,208,4,4,0,1,0
2,222,222,92,92,0,1,0
7,257,257,58,12,46,3,2
3,290,290,1,1,0,1,0
5,308,308,29,15,14,2,1
4,323,323,29,5,24,4,3
6,325,325,59,59,0,1,0
10,379,379,128,29,99,4,3
1,414,414,38,28,10,2,1
12,485,485,9,9,0,1,0

12,124,124,24,24,0,1,0
0,138,138,7,7,0,1,0
9,166,166,18,12,6,2,1
13,218,218,40,7,33,4,3
11,240,240,9,9,0,1,0
3,250,250,5,5,0,1,0
15,253,253,30,30,0,1,0
14,274,274,4,4,0,1,0
7,289,289,37,37,0,1,0
8,296,296,8,8,0,1,0
5,353,353,137,131,6,3,2
1,356,356,2,2,0,1,0
10,361,361,55,55,0,1,0
4,376,376,1,1,0,1,0
6,417,417,8,8,0,1,0
2,420,420,67,58,9,2,1

13,108,108,25,25,0,1,0
10,139,139,4,1,3,2,1
7,145,145,28,19,9,4,3
4,154,154,11,11,0,1,0
6,206,206,72,72,0,1,0
1,214,214,25,10,15,2,1
9,221,221,12,12,0,1,0
0,265,265,11,11,0,1,0
8,290,290,37,21,16,2,1
3,343,343,19,19,0,1,0
12,362,362,10,10,0,1,0
2,383,383,53,53,0,1,0
11,436,436,69,15,54,4,3
5,480,480,15,15,0,1,0

2,137,137,2,2,0,1,0
4,154,154,30,30,0,1,0
1,185,185,1,1,0,1,0
6,189,189,62,12,50,2,1
13,205,205,31,9,22,2,1
12,212,212,67,45,22,3,2
5,233,233,8,8,0,1,0
11,285,285,39,39,0,1,0
10,309,309,8,8,0,1,0
3,313,313,14,14,0,1,0
9,338,338,2,2,0,1,0
14,399,399,28,23,5,2,1
0,421,421,73,73,0,1,0
7,434,434,3,3,0,1,0
8,472,472,49,49,0,1,0

9,102,102,3,3,0,1,0
5,121,121,2,2,0,1,0
4,155,155,1,1,0,1,0
6,161,161,19,19,0,1,0
14,163,163,5,5,0,1,0
20,163,163,24,24,0,1,0
16,172,172,3,3,0,1,0
10,177,177,13,13,0,1,0
21,187,187,26,11,15,2,1
11,198,198,3,3,0,1,0
7,215,215,11,8,3,2,1
22,220,220,19,4,15,2,1
8,241,241,25,5,20,3,2
19,256,256,50,50,0,1,0
15,262,262,1,1,0,1,0
12,286,286,55,8,47,2,1
2,287,287,1,1,0,1,0
0,359,359,5,5,0,1,0
13,392,392,18,18,0,1,0
3,420,420,22,22,0,1,0
17,479,479,74,74,0,1,0
18,487,487,38,2,36,4,3
1,492,492,23,11,12,2,1

3,136,136,25,9,16,3,2
4,140,140,24,19,5,2,1
12,202,202,8,8,0,1,0
0,212,212,5,5,0,1,0
5,215,215,4,4,0,1,0
8,326,326,21,21,0,1,0
2,337,337,81,81,0,1,0
10,342,342,74,39,35,3,2
6,381,381,38,22,16,3,2
11,385,385,13,13,0,1,0
7,388,388,138,66,72,4,3
1,390,390,65,17,48,2,1
9,405,405,1,1,0,1,0

11,118,118,3,3,0,1,0
2,123,123,4,1,3,2,1
16,133,133,13,13,0,1,0
12,161,161,3,3,0,1,0
1,179,179,7,2,5,2,1
0,180,180,3,3,0,1,0
4,186,186,12,12,0,1,0
6,223,223,28,25,3,2,1
13,230,230,40,40,0,1,0
18,242,242,26,26,0,1,0
3,242,242,13,13,0,1,0
17,276,276,17,17,0,1,0
10,288,288,8,8,0,1,0
15,347,347,44,44,0,1,0
5,361,361,4,1,3,2,1
8,365,365,8,8,0,1,0
7,386,386,31,31,0,1,0
9,391,391,43,23,20,2,1
19,414,414,73,73,0,1,0
20,430,430,99,99,0,1,0
14,436,436,8,8,0,1,0

8,113,113,3,3,0,1,0
0,129,129,2,2,0,1,0
1,148,148,56,46,10,2,1
13,165,165,1,1,0,1,0
2,192,192,12,5,7,2,1
3,212,212,27,27,0,1,0
11,218,218,14,14,0,1,0
6,228,228,8,8,0,1,0
9,309,309,34,31,3,2,1
5,378,378,42,22,20,3,2
12,385,385,22,22,0,1,0
4,394,394,28,28,0,1,0
10,427,427,130,52,78,4,3
7,447,447,108,64,44,2,1

1,116,116,1,1,0,1,0
16,119,119,4,4,0,1,0
15,222,222,40,40,0,1,0
6,223,223,26,26,0,1,0
17,293,293,57,57,0,1,0
13,308,308,59,41,18,3,2
7,310,310,17,6,11,2,1
10,323,323,4,4,0,1,0
11,326,326,8,5,3,2,1
12,336,336,27,27,0,1,0
9,345,345,2,2,0,1,0
3,370,370,74,74,0,1,0
14,373,373,12,12,0,1,0
2,389,389,5,5,0,1,0
8,402,402,81,81,0,1,0
18,446,446,46,37,9,2,1
4,448,448,3,3,0,1,0
5,489,489,39,3,36,4,3
0,499,499,39,39,0,1,0

6,116,116,13,13,0,1,0
13,186,186,13,13,0,1,0
14,202,202,45,13,32,4,3
0,315,315,121,121,0,1,0
10,321,321,7,1,6,2,1
9,328,328,77,77,0,1,0
1,333,333,20,20,0,1,0
4,340,340,1,1,0,1,0
2,356,356,32,32,0,1,0
7,369,369,3,3,0,1,0
8,376,376,63,63,0,1,0
11,390,390,26,18,8,2,1
5,424,424,13,13,0,1,0
12,431,431,12,12,0,1,0
3,466,466,53,44,9,4,3

7,101,101,5,1,4,2,1
15,119,119,12,12,0,1,0
1,125,125,22,15,7,2,1
12,135,135,12,12,0,1,0
20,150,150,10,10,0,1,0
14,160,160,14,3,11,3,2
9,228,228,3,3,0,1,0
3,246,246,16,6,10,2,1
18,270,270,4,4,0,1,0
6,273,273,8,1,7,2,1
2,320,320,7,1,6,2,1
8,350,350,3,3,0,1,0
4,351,351,19,19,0,1,0
10,375,375,47,13,34,2,1
11,381,381,1,1,0,1,0
16,409,409,187,187,0,1,0
0,440,440,54,54,0,1,0
19,461,461,27,3,24,4,3
5,466,466,17,17,0,1,0
13,468,468,3,3,0,1,0
17,489,489,16,8,8,2,1

2,112,112,49,46,3,2,1
9,125,125,26,26,0,1,0
8,131,131,10,4,6,2,1
1,151,151,12,12,0,1,0
0,292,292,1,1,0,1,0
7,339,339,51,51,0,1,0
4,370,370,58,58,0,1,0
3,411,411,11,11,0,1,0
11,421,421,50,41,9,4,3
12,421,421,8,5,3,2,1
10,429,429,52,52,0,1,0
6,438,438,51,51,0,1,0
5,470,470,46,7,39,2,1

1,120,120,7,3,4,2,1
5,150,150,25,25,0,1,0
9,188,188,72,33,39,4,3
8,195,195,3,3,0,1,0
3,271,271,31,31,0,1,0
4,294,294,18,18,0,1,0
7,316,316,5,5,0,1,0
2,364,364,128,128,0,1,0
0,386,386,151,151,0,1,0
6,462,462,26,26,0,1,0

13,134,134,6,6,0,1,0
4,144,144,1,1,0,1,0
7,187,187,1,1,0,1,0
12,187,187,15,15,0,1,0
0,194,194,19,2,17,2,1
15,222,222,42,42,0,1,0
16,232,232,19,19,0,1,0
5,243,243,67,49,18,4,3
17,262,262,5,5,0,1,0
2,301,301,41,26,15,4,3
6,362,362,17,17,0,1,0
14,403,403,60,42,18,4,3
9,404,404,26,13,13,2,1
8,439,439,12,12,0,1,0
10,451,451,18,3,15,4,3
1,462,462,31,5,26,4,3
3,481,481,16,16,0,1,0
11,494,494,126,12,114,4,3

16,102,102,9,9,0,1,0
14,160,160,15,15,0,1,0
3,174,174,20,20,0,1,0
13,186,186,11,1,10,2,1
9,189,189,13,9,4,2,1
4,195,195,26,8,18,4,3
5,225,225,7,7,0,1,0
0,231,231,18,9,9,2,1
12,246,246,22,2,20,2,1
1,287,287,28,15,13,2,1
6,290,290,38,38,0,1,0
15,301,301,47,47,0,1,0
7,305,305,10,10,0,1,0
10,332,332,53,2,51,4,3
11,346,346,59,59,0,1,0
2,462,462,34,34,0,1,0
8,463,463,20,9,11,2,1

18,142,142,6,6,0,1,0
10,143,143,2,2,0,1,0
19,156,156,18,18,0,1,0
11,160,160,5,5,0,1,0
20,164,164,11,3,8,3,2
9,171,171,11,7,4,2,1
6,184,184,3,3,0,1,0
17,203,203,76,34,42,4,3
22,209,209,8,8,0,1,0
0,217,217,16,1,15,4,3
1,276,276,4,4,0,1,0
16,278,278,24,24,0,1,0
4,302,302,9,9,0,1,0
15,323,323,43,32,11,2,1
12,336,336,8,8,0,1,0
21,347,347,26,26,0,1,0
7,360,360,10,4,6,2,1
3,376,376,6,6,0,1,0
13,411,411,18,18,0,1,0
2,432,432,16,16,0,1,0
14,435,435,44,41,3,2,1
23,448,448,50,50,0,1,0
8,471,471,41,5,36,2,1
5,495,495,1,1,0,1,0

9,102,102,2,2,0,1,0
11,129,129,7,7,0,1,0
5,151,151,2,2,0,1,0
6,158,158,7,1,6,2,1
13,186,186,24,12,12,4,3
15,205,205,39,15,24,3,2
7,217,217,36,16,20,2,1
8,233,233,12,12,0,1,0
17,252,252,27,9,18,3,2
4,277,277,6,6,0,1,0
18,289,289,21,2,19,2,1
16,319,319,51,29,22,4,3
2,322,322,47,47,0,1,0
1,337,337,65,65,0,1,0
12,353,353,30,30,0,1,0
0,391,391,1,1,0,1,0
14,448,448,33,11,22,2,1
10,469,469,35,7,28,2,1
3,481,481,8,5,3,2,1

14,107,107,3,3,0,1,0
9,120,120,2,2,0,1,0
12,120,120,7,1,6,2,1
22,127,127,50,50,0,1,0
4,170,170,4,4,0,1,0
2,173,173,20,20,0,1,0
13,214,214,17,17,0,1,0
17,218,218,2,2,0,1,0
21,270,270,43,43,0,1,0
5,283,283,1,1,0,1,0
20,295,295,45,31,14,2,1
3,307,307,3,3,0,1,0
18,337,337,11,11,0,1,0
16,344,344,4,4,0,1,0
19,369,369,19,10,9,4,3
11,383,383,18,9,9,4,3
0,444,444,75,14,61,3,2
1,448,448,25,25,0,1,0
6,465,465,9,9,0,1,0
8,479,479,24,13,11,2,1
7,480,480,13,5,8,3,2
15,497,497,47,8,39,2,1
10,499,499,2,2,0,1,0

7,124,124,4,4,0,1,0
10,126,126,4,4,0,1,0
0,140,140,9,1,8,3,2
5,152,152,7,4,3,2,1
9,196,196,2,2,0,1,0
13,308,308,12,7,5,2,1
16,342,342,18,9,9,2,1
2,363,363,55,55,0,1,0
6,380,380,1,1,0,1,0
11,383,383,60,60,0,1,0
17,416,416,133,109,24,2,1
15,439,439,50,50,0,1,0
3,439,439,80,22,58,3,2
14,451,451,28,12,16,2,1
12,454,454,29,22,7,2,1
8,486,486,105,34,71,4,3
1,491,491,33,25,8,2,1
4,500,500,1,1,0,1,0

7,112,112,21,21,0,1,0
8,241,241,51,29,22,2,1
1,278,278,65,28,37,2,1
13,333,333,68,36,32,2,1
0,351,351,1,1,0,1,0
4,365,365,143,98,45,4,3
9,370,370,3,3,0,1,0
5,371,371,35,4,31,4,3
11,394,394,69,53,16,3,2
3,395,395,19,19,0,1,0
12,413,413,1,1,0,1,0
10,440,440,10,10,0,1,0
6,459,459,6,6,0,1,0
2,486,486,8,4,4,2,1

4,107,107,20,6,14,3,2
7,119,119,10,7,3,2,1
3,141,141,6,6,0,1,0
11,169,169,14,8,6,3,2
6,181,181,4,4,0,1,0
2,219,219,1,1,0,1,0
8,240,240,51,10,41,2,1
1,338,338,62,1,61,3,2
12,414,414,72,67,5,2,1
9,420,420,63,5,58,3,2
0,438,438,96,81,15,4,3
10,469,469,40,16,24,2,1
5,481,481,79,25,54,3,2

0,145,145,15,15,0,1,0
8,170,170,46,46,0,1,0
4,176,176,11,11,0,1,0
1,274,274,110,65,45,4,3
9,280,280,23,23,0,1,0
11,297,297,30,30,0,1,0
5,399,399,82,30,52,3,2
10,455,455,17,5,12,3,2
3,460,460,8,8,0,1,0
7,480,480,35,35,0,1,0
6,486,486,21,21,0,1,0
2,491,491,107,107,0,1,0

8,102,102,8,8,0,1,0
9,112,112,10,10,0,1,0
12,178,178,65,65,0,1,0
13,184,184,12,12,0,1,0
0,201,201,12,3,9,4,3
4,243,243,4,4,0,1,0
16,269,269,4,4,0,1,0
6,274,274,71,71,0,1,0
1,313,313,10,10,0,1,0
10,317,317,38,14,24,4,3
7,387,387,5,5,0,1,0
3,409,409,11,11,0,1,0
5,431,431,45,15,30,3,2
2,459,459,1,1,0,1,0
17,465,465,16,5,11,3,2
14,473,473,29,11,18,4,3
15,474,474,108,21,87,4,3
11,493,493,19,13,6,3,2

1,103,103,3,3,0,1,0
9,115,115,3,3,0,1,0
11,148,148,9,9,0,1,0
6,168,168,25,16,9,2,1
0,218,218,10,10,0,1,0
2,268,268,7,7,0,1,0
7,281,281,6,6,0,1,0
3,310,310,17,8,9,2,1
8,364,364,30,6,24,4,3
10,414,414,173,91,82,3,2
4,420,420,271,256,15,4,3
5,445,445,30,9,21,3,2

13,176,176,23,23,0,1,0
2,194,194,17,8,9,4,3
3,215,215,9,2,7,2,1
11,222,222,2,2,0,1,0
10,227,227,6,6,0,1,0
7,282,282,63,63,0,1,0
8,330,330,34,34,0,1,0
4,375,375,114,114,0,1,0
1,383,383,22,5,17,2,1
9,403,403,123,111,12,4,3
12,440,440,7,1,6,2,1
5,449,449,20,8,12,4,3
0,462,462,11,11,0,1,0
6,471,471,114,114,0,1,0

8,129,129,9,9,0,1,0
7,143,143,11,11,0,1,0
11,151,151,17,17,0,1,0
9,185,185,8,8,0,1,0
15,212,212,81,81,0,1,0
12,218,218,14,14,0,1,0
5,223,223,11,11,0,1,0
3,272,272,7,7,0,1,0
13,281,281,33,33,0,1,0
0,286,286,51,24,27,4,3
14,299,299,2,2,0,1,0
6,317,317,4,1,3,2,1
1,347,347,113,53,60,4,3
2,395,395,1,1,0,1,0
10,426,426,39,23,16,2,1
4,437,437,26,26,0,1,0

6,117,117,20,11,9,4,3
8,127,127,3,3,0,1,0
2,133,133,7,7,0,1,0
9,142,142,35,35,0,1,0
14,225,225,27,3,24,4,3
3,227,227,15,15,0,1,0
15,234,234,2,2,0,1,0
10,266,266,17,12,5,2,1
13,275,275,88,88,0,1,0
7,302,302,31,31,0,1,0
12,325,325,16,6,10,2,1
4,353,353,29,6,23,2,1
0,396,396,17,6,11,2,1
1,396,396,17,17,0,1,0
11,412,412,2,2,0,1,0
5,496,496,110,100,10,3,2

18,102,102,31,23,8,2,1
19,107,107,15,15,0,1,0
14,109,109,4,4,0,1,0
3,118,118,12,12,0,1,0
9,135,135,1,1,0,1,0
7,154,154,1,1,0,1,0
16,195,195,12,12,0,1,0
10,205,205,42,21,21,2,1
8,208,208,18,10,8,3,2
11,209,209,15,15,0,1,0
22,228,228,13,13,0,1,0
0,247,247,24,24,0,1,0
5,278,278,3,3,0,1,0
21,297,297,3,3,0,1,0
4,308,308,7,7,0,1,0
15,334,334,13,8,5,2,1
12,343,343,3,3,0,1,0
1,375,375,2,2,0,1,0
2,408,408,8,8,0,1,0
20,423,423,91,21,70,3,2
17,448,448,14,14,0,1,0
6,456,456,26,16,10,2,1
13,483,483,12,12,0,1,0

1,101,101,1,1,0,1,0
2,103,103,2,2,0,1,0
17,106,106,23,23,0,1,0
7,137,137,4,4,0,1,0
13,143,143,2,2,0,1,0
9,162,162,20,16,4,2,1
14,179,179,29,29,0,1,0
4,204,204,12,12,0,1,0
12,304,304,3,3,0,1,0
15,314,314,53,53,0,1,0
8,375,375,3,3,0,1,0
16,376,376,32,20,12,4,3
0,402,402,42,12,30,3,2
11,411,411,67,67,0,1,0
5,420,420,97,74,23,2,1
10,447,447,32,32,0,1,0
3,495,495,35,35,0,1,0
6,499,499,37,37,0,1,0

13,138,138,3,3,0,1,0
4,157,157,3,3,0,1,0
5,180,180,2,2,0,1,0
8,217,217,29,29,0,1,0
12,290,290,12,3,9,4,3
7,292,292,5,1,4,2,1
14,329,329,124,41,83,4,3
9,336,336,5,2,3,2,1
3,359,359,2,2,0,1,0
2,391,391,15,15,0,1,0
1,417,417,64,64,0,1,0
10,422,422,33,33,0,1,0
11,425,425,62,62,0,1,0
6,446,446,75,22,53,4,3
0,452,452,175,151,24,2,1

3,156,156,35,35,0,1,0
7,166,166,3,3,0,1,0
10,201,201,20,20,0,1,0
6,227,227,37,37,0,1,0
2,243,243,13,13,0,1,0
9,256,256,3,3,0,1,0
11,265,265,74,54,20,3,2
5,268,268,54,54,0,1,0
8,271,271,11,3,8,3,2
0,298,298,63,63,0,1,0
12,300,300,62,62,0,1,0
4,382,382,10,2,8,3,2
1,471,471,40,40,0,1,0

4,118,118,11,4,7,2,1
9,120,120,1,1,0,1,0
14,155,155,41,41,0,1,0
11,167,167,21,12,9,2,1
10,213,213,4,4,0,1,0
3,282,282,7,7,0,1,0
1,302,302,26,21,5,2,1
5,320,320,105,43,62,3,2
7,349,349,34,11,23,2,1
13,381,381,52,52,0,1,0
6,386,386,16,7,9,4,3
2,411,411,35,10,25,4,3
15,427,427,76,10,66,4,3
12,430,430,34,22,12,4,3
8,443,443,1,1,0,1,0
0,448,448,19,19,0,1,0

6,113,113,4,1,3,2,1
4,136,136,4,4,0,1,0
8,172,172,1,1,0,1,0
1,174,174,9,6,3,2,1
7,179,179,15,15,0,1,0
15,187,187,12,12,0,1,0
16,224,224,67,32,35,2,1
5,238,238,30,30,0,1,0
12,300,300,51,51,0,1,0
0,351,351,23,17,6,3,2
11,355,355,9,3,6,3,2
3,369,369,11,2,9,2,1
13,412,412,23,14,9,2,1
9,429,429,55,55,0,1,0
17,436,436,83,29,54,4,3
10,437,437,105,11,94,3,2
2,439,439,2,2,0,1,0
14,464,464,4,1,3,2,1

12,116,116,6,3,3,2,1
11,149,149,20,20,0,1,0
0,155,155,3,3,0,1,0
15,180,180,27,27,0,1,0
10,193,193,39,39,0,1,0
1,208,208,29,29,0,1,0
5,251,251,21,17,4,2,1
8,293,293,46,46,0,1,0
2,302,302,19,19,0,1,0
16,384,384,33,33,0,1,0
3,384,384,24,6,18,2,1
6,385,385,44,44,0,1,0
13,411,411,31,31,0,1,0
9,436,436,11,11,0,1,0
4,448,448,1,1,0,1,0
7,478,478,64,52,12,4,3
14,500,500,59,1,58,3,2

15,120,120,14,5,9,4,3
5,124,124,2,2,0,1,0
13,124,124,9,3,6,2,1
8,125,125,24,24,0,1,0
2,150,150,2,2,0,1,0
16,201,201,8,2,6,2,1
9,241,241,14,6,8,3,2
14,244,244,1,1,0,1,0
7,258,258,9,4,5,2,1
1,316,316,29,8,21,4,3
4,323,323,41,3,38,3,2
11,362,362,100,70,30,3,2
3,384,384,32,24,8,3,2
10,389,389,102,94,8,3,2
12,395,395,17,17,0,1,0
0,487,487,70,4,66,4,3
6,492,492,20,20,0,1,0

20,120,120,13,13,0,1,0
4,122,122,12,12,0,1,0
8,130,130,10,1,9,2,1
5,156,156,27,11,16,3,2
0,167,167,1,1,0,1,0
7,192,192,12,12,0,1,0
11,242,242,7,1,6,3,2
19,249,249,4,4,0,1,0
14,250,250,25,25,0,1,0
6,292,292,23,13,10,3,2
16,297,297,7,2,5,2,1
10,327,327,1,1,0,1,0
1,341,341,21,21,0,1,0
18,372,372,49,49,0,1,0
12,400,400,3,3,0,1,0
3,417,417,45,45,0,1,0
9,429,429,29,29,0,1,0
13,433,433,10,10,0,1,0
2,462,462,3,3,0,1,0
15,478,478,14,8,6,3,2
17,498,498,203,146,57,4,3

4,125,125,3,3,0,1,0
6,152,152,1,1,0,1,0
3,157,157,20,11,9,4,3
5,170,170,3,3,0,1,0
9,187,187,1,1,0,1,0
15,314,314,23,23,0,1,0
0,323,323,9,9,0,1,0
13,323,323,30,26,4,2,1
2,339,339,10,10,0,1,0
8,385,385,51,51,0,1,0
1,392,392,149,116,33,2,1
11,407,407,7,3,4,2,1
14,442,442,114,114,0,1,0
7,445,445,24,24,0,1,0
16,464,464,22,10,12,3,2
12,472,472,35,35,0,1,0
10,495,495,121,121,0,1,0

14,147,147,2,2,0,1,0
5,176,176,1,1,0,1,0
7,198,198,47,47,0,1,0
1,227,227,30,30,0,1,0
2,234,234,23,23,0,1,0
13,243,243,8,8,0,1,0
4,272,272,16,1,15,2,1
12,328,328,85,19,66,4,3
9,368,368,67,24,43,2,1
11,392,392,40,40,0,1,0
3,429,429,29,18,11,2,1
10,455,455,23,11,12,4,3
0,457,457,27,27,0,1,0
6,463,463,67,37,30,4,3
8,485,485,84,37,47,3,2

4,156,156,12,9,3,2,1
14,161,161,36,36,0,1,0
2,190,190,3,3,0,1,0
10,219,219,29,29,0,1,0
11,253,253,31,31,0,1,0
3,278,278,19,7,12,4,3
5,302,302,100,40,60,4,3
9,346,346,18,18,0,1,0
7,350,350,60,60,0,1,0
0,394,394,15,4,11,2,1
13,394,394,2,2,0,1,0
6,434,434,37,1,36,2,1
1,437,437,6,6,0,1,0
8,476,476,42,42,0,1,0
12,477,477,90,90,0,1,0

10,144,144,9,1,8,2,1
13,156,156,34,22,12,3,2
11,184,184,38,31,7,2,1
2,188,188,5,5,0,1,0
15,209,209,51,9,42,2,1
8,211,211,12,12,0,1,0
12,275,275,2,2,0,1,0
14,286,286,14,14,0,1,0
16,318,318,9,1,8,3,2
9,355,355,12,5,7,2,1
1,372,372,10,1,9,2,1
4,407,407,49,49,0,1,0
5,421,421,51,51,0,1,0
0,433,433,75,75,0,1,0
3,470,470,52,52,0,1,0
6,481,481,11,11,0,1,0
7,486,486,53,53,0,1,0

14,133,133,10,10,0,1,0
4,176,176,1,1,0,1,0
7,202,202,2,2,0,1,0
12,203,203,23,3,20,4,3
6,219,219,28,17,11,2,1
10,244,244,90,30,60,4,3
1,250,250,13,13,0,1,0
8,292,292,65,65,0,1,0
2,294,294,8,2,6,2,1
5,313,313,43,43,0,1,0
9,336,336,19,19,0,1,0
11,354,354,41,41,0,1,0
3,363,363,62,43,19,2,1
15,415,415,21,5,16,2,1
13,457,457,15,4,11,4,3
0,484,484,23,2,21,4,3

13,109,109,1,1,0,1,0
1,149,149,12,12,0,1,0
2,164,164,7,7,0,1,0
4,173,173,43,43,0,1,0
9,291,291,62,50,12,4,3
0,303,303,21,21,0,1,0
14,305,305,15,3,12,4,3
10,326,326,71,71,0,1,0
12,389,389,95,62,33,4,3
6,408,408,57,41,16,2,1
8,444,444,19,19,0,1,0
7,495,495,11,11,0,1,0
3,496,496,40,4,36,3,2
5,497,497,58,58,0,1,0
11,500,500,18,18,0,1,0

6,118,118,1,1,0,1,0
13,133,133,5,5,0,1,0
7,138,138,14,5,9,4,3
9,180,180,19,12,7,2,1
4,194,194,7,3,4,2,1
5,233,233,80,80,0,1,0
11,248,248,5,5,0,1,0
1,264,264,32,18,14,2,1
2,264,264,10,4,6,2,1
8,271,271,40,27,13,2,1
12,351,351,29,29,0,1,0
10,356,356,52,24,28,3,2
14,399,399,108,108,0,1,0
3,404,404,58,58,0,1,0
0,480,480,7,4,3,2,1

0,101,101,6,6,0,1,0
9,104,104,33,33,0,1,0
3,123,123,24,24,0,1,0
10,129,129,5,5,0,1,0
5,143,143,25,25,0,1,0
1,163,163,15,15,0,1,0
4,193,193,6,6,0,1,0
2,238,238,47,47,0,1,0
8,264,264,45,30,15,4,3
7,337,337,2,2,0,1,0
6,342,342,16,6,10,2,1
13,346,346,5,5,0,1,0
12,347,347,18,4,14,2,1
11,424,424,23,23,0,1,0
14,482,482,81,15,66,3,2

10,108,108,25,10,15,4,3
1,110,110,7,3,4,2,1
0,187,187,40,40,0,1,0
3,190,190,11,11,0,1,0
8,196,196,14,7,7,2,1
9,280,280,24,24,0,1,0
4,318,318,28,11,17,3,2
5,323,323,12,2,10,2,1
6,335,335,6,6,0,1,0
15,339,339,1,1,0,1,0
13,396,396,22,22,0,1,0
14,407,407,84,84,0,1,0
2,437,437,20,20,0,1,0
12,452,452,81,81,0,1,0
7,473,473,98,84,14,2,1
11,474,474,21,9,12,4,3

11,132,132,8,8,0,1,0
0,150,150,8,8,0,1,0
8,223,223,14,2,12,3,2
6,251,251,25,25,0,1,0
9,315,315,28,4,24,2,1
4,347,347,90,90,0,1,0
1,349,349,13,4,9,2,1
5,423,423,64,64,0,1,0
3,428,428,172,123,49,2,1
7,451,451,101,101,0,1,0
10,456,456,58,58,0,1,0
2,479,479,24,16,8,3,2

19,110,110,4,4,0,1,0
4,121,121,24,15,9,4,3
18,130,130,26,2,24,2,1
9,185,185,1,1,0,1,0
16,192,192,27,27,0,1,0
17,216,216,3,3,0,1,0
14,243,243,54,54,0,1,0
20,302,302,10,1,9,4,3
10,335,335,28,28,0,1,0
0,340,340,5,1,4,2,1
7,348,348,11,2,9,4,3
6,363,363,21,2,19,2,1
8,372,372,11,11,0,1,0
2,401,401,4,4,0,1,0
1,405,405,29,29,0,1,0
13,438,438,4,4,0,1,0
15,441,441,76,36,40,2,1
11,445,445,49,49,0,1,0
12,455,455,44,5,39,4,3
3,459,459,32,32,0,1,0
5,477,477,6,6,0,1,0

0,113,113,1,1,0,1,0
14,140,140,35,9,26,3,2
8,158,158,3,3,0,1,0
5,163,163,17,10,7,2,1
3,208,208,1,1,0,1,0
13,267,267,21,21,0,1,0
11,281,281,30,8,22,3,2
10,295,295,83,83,0,1,0
9,301,301,12,1,11,2,1
4,345,345,21,4,17,3,2
6,375,375,54,26,28,2,1
12,406,406,15,15,0,1,0
7,427,427,69,69,0,1,0
2,449,449,21,21,0,1,0
1,490,490,132,3,129,4,3

6,168,168,6,6,0,1,0
7,180,180,25,25,0,1,0
1,199,199,16,8,8,2,1
11,216,216,7,7,0,1,0
8,256,256,117,69,48,4,3
5,268,268,19,19,0,1,0
10,288,288,13,13,0,1,0
3,391,391,66,44,22,3,2
4,394,394,66,45,21,4,3
2,421,421,50,15,35,2,1
9,472,472,18,18,0,1,0
0,487,487,129,115,14,2,1

8,109,109,2,2,0,1,0
10,168,168,2,2,0,1,0
11,187,187,8,8,0,1,0
9,206,206,50,50,0,1,0
3,211,211,23,23,0,1,0
12,219,219,45,25,20,3,2
14,241,241,26,1,25,2,1
16,263,263,38,38,0,1,0
17,282,282,21,21,0,1,0
13,289,289,28,9,19,2,1
6,314,314,32,32,0,1,0
1,363,363,13,13,0,1,0
4,368,368,15,15,0,1,0
2,382,382,68,14,54,4,3
15,400,400,56,56,0,1,0
0,414,414,4,4,0,1,0
7,435,435,22,22,0,1,0
5,461,461,1,1,0,1,0

16,104,104,4,4,0,1,0
14,104,104,3,3,0,1,0
4,104,104,8,8,0,1,0
10,108,108,10,10,0,1,0
15,155,155,87,14,73,4,3
3,179,179,15,9,6,2,1
0,266,266,11,3,8,2,1
12,278,278,7,2,5,2,1
9,328,328,25,12,13,2,1
7,350,350,9,9,0,1,0
8,353,353,20,17,3,2,1
2,371,371,23,13,10,2,1
18,399,399,29,29,0,1,0
11,404,404,21,21,0,1,0
5,407,407,48,48,0,1,0
13,412,412,34,14,20,3,2
1,440,440,47,47,0,1,0
6,471,471,4,1,3,2,1
17,490,490,4,4,0,1,0

5,135,135,6,6,0,1,0
0,225,225,3,3,0,1,0
11,234,234,72,2,70,3,2
9,246,246,5,5,0,1,0
10,282,282,26,9,17,2,1
2,294,294,38,38,0,1,0
7,328,328,44,44,0,1,0
12,347,347,39,7,32,2,1
6,356,356,43,43,0,1,0
8,366,366,9,9,0,1,0
3,425,425,8,8,0,1,0
4,425,425,8,8,0,1,0
1,438,438,253,166,87,4,3

11,101,101,27,7,20,2,1
13,103,103,14,14,0,1,0
7,128,128,1,1,0,1,0
0,137,137,4,4,0,1,0
6,141,141,4,4,0,1,0
4,148,148,46,10,36,4,3
12,174,174,36,36,0,1,0
1,208,208,13,13,0,1,0
2,239,239,23,23,0,1,0
3,260,260,67,67,0,1,0
14,303,303,13,4,9,4,3
9,366,366,25,25,0,1,0
8,480,480,32,32,0,1,0
5,494,494,7,4,3,2,1
10,500,500,14,14,0,1,0

5,127,127,6,6,0,1,0
15,131,131,6,6,0,1,0
6,173,173,25,25,0,1,0
8,182,182,2,2,0,1,0
9,197,197,6,6,0,1,0
13,209,209,6,2,4,2,1
3,219,219,17,17,0,1,0
4,256,256,3,3,0,1,0
11,262,262,22,19,3,2,1
2,297,297,13,3,10,3,2
10,309,309,35,35,0,1,0
1,325,325,13,13,0,1,0
0,344,344,33,21,12,4,3
16,380,380,115,59,56,3,2
12,389,389,57,23,34,3,2
14,432,432,19,19,0,1,0
17,432,432,51,51,0,1,0
7,444,444,45,45,0,1,0
18,450,450,59,59,0,1,0

17,165,165,2,2,0,1,0
15,171,171,16,12,4,2,1
4,211,211,5,5,0,1,0
0,230,230,6,6,0,1,0
9,232,232,39,39,0,1,0
5,236,236,7,7,0,1,0
10,258,258,19,7,12,3,2
8,278,278,3,3,0,1,0
3,292,292,3,3,0,1,0
14,304,304,1,1,0,1,0
1,321,321,10,10,0,1,0
16,324,324,12,12,0,1,0
7,328,328,6,3,3,2,1
12,347,347,10,10,0,1,0
2,381,381,68,41,27,2,1
13,394,394,103,31,72,4,3
6,441,441,103,103,0,1,0
11,479,479,178,98,80,3,2

12,104,104,3,3,0,1,0
9,153,153,4,4,0,1,0
15,153,153,18,11,7,2,1
0,166,166,20,20,0,1,0
16,169,169,50,32,18,2,1
2,181,181,9,9,0,1,0
4,196,196,15,15,0,1,0
7,203,203,11,11,0,1,0
6,218,218,13,13,0,1,0
11,233,233,7,2,5,2,1
14,276,276,14,14,0,1,0
3,283,283,4,4,0,1,0
5,295,295,20,2,18,2,1
8,323,323,43,43,0,1,0
13,327,327,27,27,0,1,0
1,391,391,80,80,0,1,0
10,464,464,98,98,0,1,0

9,134,134,18,18,0,1,0
3,147,147,16,16,0,1,0
14,159,159,8,8,0,1,0
4,206,206,13,1,12,2,1
8,221,221,13,4,9,4,3
7,238,238,34,4,30,2,1
13,253,253,7,7,0,1,0
10,264,264,138,138,0,1,0
6,291,291,17,17,0,1,0
12,308,308,4,4,0,1,0
1,372,372,15,15,0,1,0
11,398,398,3,3,0,1,0
0,493,493,70,21,49,2,1
5,497,497,107,49,58,4,3
2,498,498,15,15,0,1,0

23,113,113,5,5,0,1,0
9,118,118,4,4,0,1,0
15,130,130,3,3,0,1,0
3,175,175,1,1,0,1,0
1,176,176,22,5,17,2,1
4,184,184,5,5,0,1,0
8,198,198,5,5,0,1,0
10,199,199,5,5,0,1,0
22,275,275,37,37,0,1,0
5,277,277,18,18,0,1,0
18,316,316,37,7,30,3,2
7,319,319,16,16,0,1,0
19,329,329,28,21,7,2,1
2,329,329,4,1,3,2,1
14,341,341,51,4,47,3,2
13,343,343,33,1,32,3,2
6,383,383,7,7,0,1,0
20,392,392,34,34,0,1,0
0,393,393,3,3,0,1,0
16,428,428,6,6,0,1,0
21,428,428,107,14,93,4,3
17,429,429,42,6,36,3,2
12,462,462,7,7,0,1,0
11,487,487,53,53,0,1,0

0,115,115,12,12,0,1,0
5,127,127,3,3,0,1,0
1,163,163,8,5,3,2,1
2,225,225,81,39,42,3,2
15,283,283,44,44,0,1,0
13,296,296,22,22,0,1,0
8,309,309,3,3,0,1,0
10,311,311,16,2,14,3,2
9,313,313,23,9,14,4,3
3,388,388,12,12,0,1,0
11,404,404,53,45,8,3,2
6,407,407,5,5,0,1,0
4,426,426,39,16,23,2,1
12,450,450,19,19,0,1,0
14,488,488,139,139,0,1,0
7,493,493,60,60,0,1,0

12,134,134,32,32,0,1,0
1,135,135,1,1,0,1,0
15,151,151,30,30,0,1,0
5,155,155,18,18,0,1,0
11,195,195,4,4,0,1,0
16,205,205,10,1,9,4,3
7,254,254,49,49,0,1,0
17,259,259,1,1,0,1,0
10,271,271,27,27,0,1,0
2,290,290,5,5,0,1,0
3,316,316,1,1,0,1,0
9,321,321,75,75,0,1,0
13,336,336,46,30,16,3,2
8,341,341,10,10,0,1,0
4,373,373,1,1,0,1,0
0,394,394,3,3,0,1,0
6,398,398,36,28,8,3,2
14,496,496,86,44,42,4,3

11,144,144,3,3,0,1,0
2,157,157,9,2,7,2,1
7,157,157,7,7,0,1,0
10,181,181,2,2,0,1,0
3,192,192,7,7,0,1,0
19,197,197,28,28,0,1,0
18,200,200,53,37,16,3,2
15,206,206,23,23,0,1,0
17,218,218,3,3,0,1,0
16,225,225,7,7,0,1,0
9,228,228,22,22,0,1,0
14,251,251,45,45,0,1,0
1,308,308,3,3,0,1,0
0,310,310,6,6,0,1,0
8,324,324,27,3,24,3,2
4,377,377,46,23,23,2,1
5,406,406,98,98,0,1,0
6,410,410,1,1,0,1,0
12,430,430,24,13,11,2,1
13,459,459,33,33,0,1,0

14,113,113,3,3,0,1,0
10,129,129,2,2,0,1,0
3,159,159,15,15,0,1,0
9,163,163,18,3,15,2,1
12,196,196,30,21,9,2,1
1,238,238,53,53,0,1,0
4,257,257,26,26,0,1,0
7,268,268,18,18,0,1,0
13,279,279,4,1,3,2,1
2,331,331,38,1,37,3,2
6,339,339,8,3,5,2,1
11,358,358,138,82,56,4,3
0,415,415,9,9,0,1,0
8,438,438,48,48,0,1,0
5,456,456,72,21,51,4,3

5,194,194,7,7,0,1,0
2,201,201,1,1,0,1,0
10,205,205,19,19,0,1,0
8,213,213,22,22,0,1,0
11,230,230,30,9,21,2,1
0,248,248,22,22,0,1,0
4,271,271,21,9,12,3,2
6,309,309,18,8,10,2,1
7,353,353,81,12,69,4,3
12,371,371,117,117,0,1,0
9,381,381,7,7,0,1,0
3,427,427,45,3,42,4,3
14,431,431,18,6,12,4,3
13,436,436,31,19,12,3,2
15,443,443,5,5,0,1,0
1,447,447,35,35,0,1,0
16,461,461,70,40,30,2,1

6,132,132,12,2,10,3,2
2,150,150,22,9,13,3,2
5,151,151,16,10,6,2,1
4,256,256,19,19,0,1,0
12,262,262,6,6,0,1,0
1,265,265,1,1,0,1,0
0,272,272,57,57,0,1,0
3,272,272,25,1,24,2,1
9,282,282,6,6,0,1,0
8,305,305,10,10,0,1,0
14,350,350,16,16,0,1,0
10,377,377,12,2,10,2,1
16,388,388,35,5,30,3,2
15,393,393,112,112,0,1,0
7,398,398,10,1,9,4,3
13,432,432,97,64,33,4,3
11,444,444,48,4,44,2,1

4,132,132,4,4,0,1,0
13,177,177,64,64,0,1,0
6,183,183,13,7,6,2,1
16,213,213,31,31,0,1,0
3,222,222,4,4,0,1,0
15,239,239,23,23,0,1,0
7,240,240,30,12,18,2,1
8,365,365,4,1,3,2,1
14,366,366,10,10,0,1,0
17,369,369,34,24,10,2,1
1,371,371,1,1,0,1,0
18,418,418,15,15,0,1,0
5,434,434,26,26,0,1,0
10,437,437,69,69,0,1,0
12,441,441,22,10,12,4,3
9,452,452,15,15,0,1,0
11,465,465,32,4,28,4,3
0,468,468,12,12,0,1,0
2,474,474,94,68,26,2,1

13,163,163,9,9,0,1,0
14,182,182,65,29,36,2,1
9,197,197,10,1,9,4,3
1,239,239,90,76,14,3,2
16,250,250,37,10,27,2,1
0,279,279,15,3,12,3,2
2,289,289,21,21,0,1,0
10,312,312,2,2,0,1,0
7,314,314,19,19,0,1,0
8,317,317,14,14,0,1,0
5,321,321,17,7,10,2,1
3,343,343,4,4,0,1,0
15,351,351,16,16,0,1,0
17,352,352,18,4,14,2,1
4,376,376,8,8,0,1,0
11,384,384,22,22,0,1,0
12,486,486,47,47,0,1,0
6,499,499,26,26,0,1,0

17,108,108,10,10,0,1,0
0,123,123,1,1,0,1,0
12,157,157,2,2,0,1,0
11,166,166,6,3,3,2,1
5,217,217,13,2,11,2,1
16,219,219,35,35,0,1,0
9,241,241,31,22,9,4,3
7,247,247,32,32,0,1,0
10,279,279,3,3,0,1,0
3,324,324,61,25,36,3,2
18,338,338,4,1,3,2,1
13,353,353,11,1,10,2,1
1,382,382,9,1,8,3,2
8,430,430,58,48,10,3,2
2,469,469,9,6,3,2,1
6,485,485,19,8,11,4,3
14,492,492,128,113,15,4,3
15,495,495,123,123,0,1,0
4,497,497,12,12,0,1,0

23,100,100,5,5,0,1,0
9,134,134,1,1,0,1,0
7,154,154,33,19,14,2,1
8,164,164,1,1,0,1,0
4,200,200,1,1,0,1,0
13,231,231,11,5,6,2,1
2,235,235,18,18,0,1,0
3,240,240,1,1,0,1,0
17,250,250,8,8,0,1,0
21,260,260,32,8,24,2,1
24,262,262,104,104,0,1,0
15,278,278,1,1,0,1,0
18,289,289,45,45,0,1,0
22,308,308,4,4,0,1,0
0,312,312,9,9,0,1,0
6,366,366,22,2,20,3,2
14,386,386,2,2,0,1,0
20,390,390,25,11,14,3,2
11,393,393,4,4,0,1,0
12,395,395,6,2,4,2,1
10,410,410,66,66,0,1,0
5,426,426,5,5,0,1,0
16,436,436,17,17,0,1,0
19,438,438,5,5,0,1,0
1,461,461,35,15,20,2,1

7,128,128,1,1,0,1,0
3,170,170,5,5,0,1,0
0,196,196,6,6,0,1,0
10,219,219,56,8,48,4,3
1,223,223,26,14,12,3,2
14,223,223,21,16,5,2,1
12,229,229,58,14,44,2,1
16,263,263,18,11,7,2,1
13,285,285,12,12,0,1,0
6,296,296,4,4,0,1,0
9,301,301,109,51,58,3,2
2,338,338,28,28,0,1,0
8,350,350,10,7,3,2,1
4,444,444,31,31,0,1,0
5,459,459,27,27,0,1,0
11,459,459,43,38,5,2,1
15,479,479,1,1,0,1,0

3,101,101,2,2,0,1,0
4,111,111,16,13,3,2,1
2,115,115,5,5,0,1,0
12,123,123,8,8,0,1,0
5,159,159,7,7,0,1,0
0,169,169,48,9,39,4,3
15,203,203,90,90,0,1,0
8,224,224,8,2,6,3,2
6,234,234,29,29,0,1,0
17,260,260,23,7,16,2,1
7,280,280,1,1,0,1,0
16,287,287,29,29,0,1,0
13,364,364,7,3,4,2,1
14,403,403,17,11,6,2,1
10,409,409,19,19,0,1,0
1,411,411,14,14,0,1,0
11,441,441,24,20,4,2,1
9,476,476,10,2,8,3,2

0,145,145,1,1,0,1,0
9,183,183,16,6,10,3,2
12,218,218,2,2,0,1,0
4,224,224,9,9,0,1,0
3,232,232,60,44,16,3,2
8,237,237,10,5,5,2,1
6,253,253,31,31,0,1,0
14,255,255,49,21,28,3,2
10,329,329,87,27,60,4,3
5,332,332,16,16,0,1,0
11,349,349,51,51,0,1,0
1,363,363,47,4,43,2,1
13,377,377,26,2,24,4,3
2,445,445,68,9,59,4,3
7,451,451,19,13,6,2,1

3,134,134,6,3,3,2,1
14,144,144,12,12,0,1,0
8,155,155,19,10,9,4,3
6,186,186,18,6,12,4,3
4,219,219,4,4,0,1,0
11,239,239,21,3,18,4,3
16,253,253,77,19,58,3,2
13,290,290,23,23,0,1,0
2,320,320,8,8,0,1,0
12,330,330,39,15,24,3,2
9,352,352,22,22,0,1,0
7,385,385,47,47,0,1,0
1,404,404,28,19,9,2,1
15,406,406,13,13,0,1,0
5,408,408,5,1,4,2,1
10,479,479,53,27,26,2,1
0,489,489,111,53,58,4,3

12,111,111,18,18,0,1,0
1,134,134,1,1,0,1,0
4,144,144,11,11,0,1,0
11,160,160,20,3,17,2,1
7,161,161,3,3,0,1,0
9,189,189,35,35,0,1,0
6,253,253,2,2,0,1,0
3,302,302,66,66,0,1,0
13,309,309,7,4,3,2,1
2,323,323,15,6,9,2,1
8,370,370,74,6,68,3,2
10,433,433,47,47,0,1,0
5,446,446,13,13,0,1,0
0,491,491,205,138,67,4,3

10,107,107,23,9,14,2,1
15,134,134,14,1,13,2,1
8,139,139,46,46,0,1,0
7,173,173,11,11,0,1,0
11,184,184,18,18,0,1,0
12,200,200,14,14,0,1,0
0,216,216,40,40,0,1,0
1,252,252,8,8,0,1,0
6,325,325,34,13,21,4,3
2,340,340,9,2,7,3,2
9,344,344,6,1,5,2,1
4,430,430,10,10,0,1,0
5,443,443,10,10,0,1,0
14,445,445,138,45,93,4,3
3,468,468,8,4,4,2,1
13,474,474,5,5,0,1,0

20,112,112,16,6,10,3,2
18,118,118,18,18,0,1,0
9,122,122,4,4,0,1,0
17,136,136,11,1,10,3,2
8,138,138,1,1,0,1,0
11,151,151,12,1,11,2,1
10,160,160,2,2,0,1,0
4,164,164,30,30,0,1,0
7,211,211,1,1,0,1,0
2,219,219,3,3,0,1,0
5,259,259,8,8,0,1,0
16,278,278,56,56,0,1,0
3,280,280,12,12,0,1,0
6,294,294,19,19,0,1,0
13,324,324,23,23,0,1,0
1,366,366,18,3,15,4,3
21,373,373,27,7,20,2,1
12,378,378,68,35,33,2,1
15,382,382,25,17,8,3,2
19,402,402,44,40,4,2,1
0,468,468,9,9,0,1,0
14,492,492,5,5,0,1,0

11,107,107,12,12,0,1,0
2,128,128,3,3,0,1,0
1,141,141,14,14,0,1,0
3,143,143,8,5,3,2,1
12,189,189,11,11,0,1,0
4,194,194,21,21,0,1,0
5,196,196,46,16,30,4,3
9,212,212,15,15,0,1,0
15,234,234,78,40,38,2,1
14,237,237,11,11,0,1,0
8,348,348,1,1,0,1,0
17,354,354,37,7,30,4,3
13,375,375,49,49,0,1,0
7,398,398,4,4,0,1,0
6,403,403,49,49,0,1,0
10,404,404,25,20,5,2,1
0,420,420,5,5,0,1,0
16,430,430,13,13,0,1,0

7,124,124,6,6,0,1,0
0,136,136,1,1,0,1,0
9,185,185,46,4,42,4,3
11,220,220,11,11,0,1,0
14,242,242,15,15,0,1,0
6,284,284,49,49,0,1,0
13,290,290,66,23,43,2,1
4,318,318,28,28,0,1,0
2,329,329,22,22,0,1,0
8,330,330,55,55,0,1,0
10,366,366,6,6,0,1,0
12,374,374,14,8,6,2,1
3,384,384,83,83,0,1,0
1,426,426,52,9,43,4,3
5,441,441,38,12,26,3,2

8,190,190,26,26,0,1,0
3,264,264,97,29,68,3,2
9,271,271,46,16,30,3,2
1,280,280,63,63,0,1,0
5,292,292,15,5,10,3,2
2,321,321,59,45,14,2,1
10,347,347,20,3,17,2,1
6,351,351,22,13,9,4,3
0,429,429,11,11,0,1,0
7,434,434,43,10,33,2,1
4,448,448,104,56,48,4,3

6,130,130,43,21,22,2,1
9,144,144,2,2,0,1,0
1,177,177,2,2,0,1,0
4,208,208,1,1,0,1,0
3,243,243,11,6,5,2,1
2,254,254,58,22,36,4,3
8,288,288,62,62,0,1,0
7,298,298,4,4,0,1,0
0,330,330,93,93,0,1,0
12,391,391,17,17,0,1,0
10,445,445,64,4,60,4,3
11,461,461,25,25,0,1,0
5,480,480,110,44,66,4,3

0,115,115,5,2,3,2,1
8,156,156,2,2,0,1,0
9,164,164,1,1,0,1,0
13,181,181,27,27,0,1,0
4,225,225,43,19,24,4,3
11,227,227,27,27,0,1,0
1,244,244,20,20,0,1,0
2,254,254,14,4,10,3,2
12,261,261,34,1,33,4,3
10,281,281,25,25,0,1,0
6,315,315,18,18,0,1,0
3,318,318,27,27,0,1,0
15,373,373,65,65,0,1,0
5,391,391,50,50,0,1,0
14,465,465,69,33,36,4,3
7,498,498,75,48,27,2,1

9,101,101,9,1,8,3,2
8,127,127,1,1,0,1,0
3,156,156,10,10,0,1,0
15,156,156,12,7,5,2,1
10,187,187,20,7,13,2,1
12,193,193,2,2,0,1,0
13,236,236,23,14,9,2,1
16,261,261,37,37,0,1,0
2,265,265,110,110,0,1,0
0,286,286,9,9,0,1,0
5,292,292,6,6,0,1,0
7,350,350,9,9,0,1,0
14,387,387,117,23,94,4,3
6,434,434,18,18,0,1,0
11,440,440,33,7,26,2,1
4,443,443,14,9,5,2,1
1,500,500,39,39,0,1,0

16,103,103,13,13,0,1,0
11,116,116,1,1,0,1,0
13,182,182,7,1,6,2,1
12,213,213,3,3,0,1,0
6,224,224,2,2,0,1,0
9,250,250,23,12,11,2,1
7,268,268,47,47,0,1,0
10,280,280,11,3,8,3,2
19,304,304,25,25,0,1,0
5,317,317,71,29,42,4,3
0,326,326,1,1,0,1,0
20,327,327,7,1,6,2,1
8,353,353,13,6,7,2,1
15,400,400,158,38,120,4,3
4,449,449,10,6,4,2,1
18,450,450,12,3,9,3,2
1,456,456,57,15,42,3,2
3,467,467,6,1,5,2,1
17,476,476,16,8,8,3,2
2,482,482,1,1,0,1,0
14,490,490,62,38,24,4,3

6,100,100,17,4,13,4,3
13,113,113,21,21,0,1,0
9,134,134,13,13,0,1,0
7,154,154,19,19,0,1,0
1,161,161,17,17,0,1,0
2,176,176,23,11,12,2,1
14,275,275,21,3,18,2,1
10,303,303,68,44,24,4,3
11,332,332,40,40,0,1,0
8,354,354,22,1,21,2,1
4,361,361,33,5,28,2,1
5,385,385,19,7,12,3,2
3,399,399,29,29,0,1,0
0,434,434,26,17,9,2,1
12,435,435,21,4,17,2,1

6,106,106,9,9,0,1,0
4,169,169,14,14,0,1,0
3,180,180,7,7,0,1,0
11,186,186,10,4,6,3,2
8,192,192,31,31,0,1,0
10,205,205,38,16,22,2,1
14,230,230,18,3,15,4,3
5,236,236,32,20,12,4,3
13,249,249,31,15,16,3,2
1,261,261,10,10,0,1,0
9,271,271,14,14,0,1,0
2,300,300,83,34,49,3,2
0,312,312,14,14,0,1,0
12,443,443,73,46,27,2,1
7,448,448,44,44,0,1,0

3,110,110,20,16,4,2,1
1,148,148,2,2,0,1,0
4,155,155,27,27,0,1,0
7,211,211,30,30,0,1,0
10,267,267,48,48,0,1,0
12,292,292,5,2,3,2,1
9,318,318,18,18,0,1,0
6,343,343,39,39,0,1,0
0,405,405,50,50,0,1,0
11,419,419,12,12,0,1,0
5,420,420,37,37,0,1,0
2,430,430,46,46,0,1,0
8,440,440,165,165,0,1,0
13,470,470,5,1,4,2,1

3,168,168,23,17,6,2,1
0,241,241,39,11,28,2,1
1,243,243,3,3,0,1,0
8,315,315,6,6,0,1,0
7,320,320,52,52,0,1,0
12,323,323,17,8,9,4,3
4,337,337,33,8,25,2,1
6,390,390,91,22,69,4,3
5,399,399,55,19,36,2,1
11,413,413,127,1,126,4,3
2,454,454,10,10,0,1,0
9,467,467,80,39,41,2,1
13,474,474,24,24,0,1,0
10,499,499,23,23,0,1,0

5,103,103,3,3,0,1,0
13,104,104,1,1,0,1,0
1,132,132,4,4,0,1,0
3,157,157,13,13,0,1,0
22,168,168,17,17,0,1,0
18,181,181,8,8,0,1,0
2,199,199,26,26,0,1,0
19,200,200,25,17,8,3,2
4,221,221,9,9,0,1,0
0,250,250,17,7,10,3,2
6,257,257,29,1,28,3,2
21,267,267,25,4,21,4,3
15,282,282,16,16,0,1,0
10,302,302,2,2,0,1,0
7,314,314,28,19,9,4,3
20,319,319,133,125,8,2,1
12,367,367,18,18,0,1,0
11,370,370,1,1,0,1,0
14,372,372,19,19,0,1,0
9,386,386,10,10,0,1,0
8,399,399,6,6,0,1,0
17,411,411,6,6,0,1,0
16,499,499,10,2,8,3,2

12,124,124,16,7,9,2,1
3,247,247,50,1,49,3,2
6,252,252,14,14,0,1,0
4,269,269,10,5,5,2,1
13,320,320,5,5,0,1,0
0,337,337,67,67,0,1,0
1,357,357,29,21,8,3,2
5,362,362,28,28,0,1,0
7,392,392,5,5,0,1,0
11,405,405,135,135,0,1,0
10,431,431,60,23,37,2,1
9,436,436,29,29,0,1,0
14,455,455,17,17,0,1,0
2,467,467,63,45,18,4,3
8,486,486,45,38,7,2,1

0,162,162,14,5,9,4,3
7,168,168,22,22,0,1,0
2,187,187,27,27,0,1,0
6,202,202,13,13,0,1,0
4,203,203,18,9,9,4,3
9,216,216,22,22,0,1,0
5,243,243,10,10,0,1,0
10,279,279,76,76,0,1,0
8,343,343,26,26,0,1,0
3,350,350,151,63,88,3,2
11,358,358,11,8,3,2,1
1,359,359,4,4,0,1,0
12,482,482,66,66,0,1,0

7,118,118,20,4,16,2,1
14,129,129,26,5,21,4,3
11,172,172,4,4,0,1,0
0,178,178,39,28,11,2,1
9,217,217,26,26,0,1,0
3,242,242,28,20,8,3,2
5,263,263,35,35,0,1,0
1,296,296,24,4,20,3,2
13,298,298,35,35,0,1,0
6,346,346,3,3,0,1,0
12,347,347,46,1,45,4,3
2,416,416,23,10,13,2,1
4,443,443,9,9,0,1,0
10,448,448,18,18,0,1,0
8,474,474,85,85,0,1,0

8,100,100,7,7,0,1,0
10,148,148,71,14,57,4,3
1,167,167,46,46,0,1,0
12,179,179,6,6,0,1,0
5,227,227,23,23,0,1,0
3,236,236,8,8,0,1,0
11,269,269,28,28,0,1,0
7,272,272,20,20,0,1,0
13,278,278,13,13,0,1,0
0,285,285,11,11,0,1,0
6,316,316,72,72,0,1,0
4,344,344,38,35,3,2,1
2,395,395,5,1,4,2,1
9,414,414,4,4,0,1,0

6,106,106,3,3,0,1,0
1,170,170,9,9,0,1,0
8,220,220,26,11,15,4,3
13,243,243,28,28,0,1,0
14,246,246,3,3,0,1,0
9,258,258,82,82,0,1,0
2,277,277,53,53,0,1,0
7,324,324,58,36,22,2,1
0,338,338,32,32,0,1,0
4,349,349,5,5,0,1,0
12,391,391,5,5,0,1,0
10,392,392,26,8,18,3,2
3,396,396,46,1,45,4,3
5,416,416,52,52,0,1,0
11,437,437,71,4,67,3,2

10,137,137,14,7,7,2,1
2,164,164,18,3,15,4,3
13,176,176,13,13,0,1,0
11,183,183,18,9,9,2,1
1,212,212,16,2,14,3,2
4,264,264,8,8,0,1,0
5,287,287,3,3,0,1,0
8,287,287,15,15,0,1,0
7,289,289,32,26,6,3,2
14,371,371,64,7,57,4,3
12,386,386,73,73,0,1,0
0,388,388,16,3,13,2,1
3,389,389,88,12,76,3,2
9,413,413,27,21,6,2,1
16,488,488,57,6,51,4,3
15,489,489,30,18,12,3,2
6,492,492,39,39,0,1,0

6,105,105,12,6,6,3,2
12,114,114,19,19,0,1,0
2,142,142,1,1,0,1,0
8,151,151,2,2,0,1,0
7,160,160,18,2,16,2,1
10,192,192,18,9,9,3,2
0,203,203,2,2,0,1,0
15,277,277,21,21,0,1,0
4,337,337,4,1,3,2,1
5,360,360,156,117,39,4,3
13,366,366,120,120,0,1,0
9,372,372,25,15,10,3,2
11,412,412,6,6,0,1,0
14,414,414,27,27,0,1,0
3,429,429,2,2,0,1,0
1,471,471,45,24,21,4,3

16,109,109,15,4,11,3,2
4,157,157,1,1,0,1,0
7,164,164,30,30,0,1,0
15,164,164,51,51,0,1,0
5,176,176,22,22,0,1,0
10,185,185,2,2,0,1,0
0,212,212,17,17,0,1,0
1,214,214,9,9,0,1,0
12,231,231,15,3,12,2,1
2,277,277,51,51,0,1,0
14,287,287,27,6,21,4,3
3,307,307,5,5,0,1,0
11,332,332,63,63,0,1,0
8,349,349,2,2,0,1,0
6,365,365,43,38,5,2,1
9,390,390,16,3,13,2,1
13,399,399,4,4,0,1,0

7,116,116,23,15,8,2,1
11,135,135,5,5,0,1,0
2,161,161,9,5,4,2,1
10,184,184,18,7,11,3,2
0,233,233,58,41,17,2,1
12,302,302,73,73,0,1,0
3,331,331,2,2,0,1,0
9,350,350,34,34,0,1,0
6,365,365,76,76,0,1,0
13,392,392,22,3,19,2,1
1,399,399,11,11,0,1,0
5,405,405,18,14,4,2,1
4,411,411,86,47,39,2,1
8,457,457,40,13,27,4,3

8,117,117,2,2,0,1,0
12,139,139,12,12,0,1,0
9,142,142,14,14,0,1,0
5,156,156,1,1,0,1,0
10,178,178,3,3,0,1,0
4,237,237,67,37,30,3,2
3,296,296,77,77,0,1,0
11,311,311,56,56,0,1,0
7,329,329,31,31,0,1,0
0,360,360,13,13,0,1,0
6,388,388,124,124,0,1,0
1,482,482,56,56,0,1,0
2,489,489,49,20,29,2,1

10,135,135,5,5,0,1,0
5,189,189,21,11,10,3,2
14,194,194,41,41,0,1,0
0,207,207,5,5,0,1,0
8,212,212,49,21,28,2,1
6,214,214,6,6,0,1,0
4,271,271,48,48,0,1,0
13,285,285,53,15,38,3,2
11,289,289,69,69,0,1,0
3,323,323,52,19,33,2,1
7,325,325,8,5,3,2,1
1,365,365,2,2,0,1,0
2,387,387,1,1,0,1,0
12,408,408,42,39,3,2,1
9,433,433,16,16,0,1,0
16,458,458,7,7,0,1,0
15,492,492,11,11,0,1,0

5,115,115,2,2,0,1,0
8,138,138,19,8,11,2,1
6,177,177,13,6,7,2,1
12,194,194,14,14,0,1,0
2,235,235,20,14,6,2,1
13,286,286,128,128,0,1,0
4,291,291,4,1,3,2,1
1,298,298,2,2,0,1,0
0,301,301,75,52,23,2,1
10,306,306,3,3,0,1,0
15,352,352,33,33,0,1,0
14,361,361,26,26,0,1,0
3,383,383,79,44,35,2,1
9,404,404,27,15,12,2,1
7,414,414,6,6,0,1,0
11,443,443,21,9,12,4,3

11,129,129,26,19,7,2,1
12,159,159,10,10,0,1,0
14,164,164,22,4,18,3,2
2,165,165,14,14,0,1,0
10,193,193,55,55,0,1,0
15,205,205,8,8,0,1,0
8,266,266,6,6,0,1,0
6,271,271,1,1,0,1,0
1,277,277,61,47,14,2,1
3,309,309,56,56,0,1,0
5,349,349,30,30,0,1,0
13,357,357,22,4,18,4,3
9,406,406,14,14,0,1,0
0,458,458,20,10,10,3,2
4,461,461,56,28,28,3,2
7,483,483,19,13,6,2,1

0,123,123,22,22,0,1,0
7,144,144,11,11,0,1,0
9,195,195,18,2,16,3,2
10,209,209,10,10,0,1,0
5,224,224,22,22,0,1,0
11,226,226,19,3,16,3,2
13,243,243,8,8,0,1,0
4,247,247,9,9,0,1,0
6,250,250,40,40,0,1,0
14,277,277,20,7,13,2,1
12,282,282,75,75,0,1,0
16,308,308,67,67,0,1,0
8,320,320,1,1,0,1,0
15,457,457,44,8,36,2,1
1,465,465,45,6,39,4,3
3,469,469,15,12,3,2,1
2,479,479,14,14,0,1,0

0,104,104,1,1,0,1,0
11,118,118,9,9,0,1,0
1,145,145,36,18,18,2,1
14,180,180,46,5,41,2,1
10,230,230,20,20,0,1,0
7,241,241,4,1,3,2,1
8,289,289,1,1,0,1,0
3,291,291,78,48,30,2,1
5,329,329,47,47,0,1,0
12,355,355,42,32,10,2,1
13,367,367,37,37,0,1,0
2,377,377,36,10,26,2,1
9,405,405,72,72,0,1,0
4,437,437,8,8,0,1,0
6,467,467,1,1,0,1,0

13,152,152,4,4,0,1,0
8,156,156,28,28,0,1,0
3,160,160,6,6,0,1,0
0,183,183,40,35,5,2,1
15,242,242,28,1,27,4,3
14,262,262,4,4,0,1,0
11,294,294,44,6,38,3,2
1,303,303,21,21,0,1,0
9,320,320,87,45,42,4,3
12,355,355,83,83,0,1,0
6,374,374,32,32,0,1,0
10,393,393,2,2,0,1,0
4,422,422,9,9,0,1,0
2,443,443,36,24,12,2,1
7,485,485,48,3,45,4,3
5,500,500,5,1,4,2,1

10,119,119,28,3,25,2,1
9,178,178,20,20,0,1,0
4,199,199,1,1,0,1,0
1,225,225,2,2,0,1,0
2,250,250,8,4,4,2,1
8,255,255,1,1,0,1,0
5,311,311,134,95,39,4,3
13,318,318,3,3,0,1,0
7,321,321,37,37,0,1,0
0,331,331,19,4,15,2,1
6,374,374,87,87,0,1,0
11,378,378,74,74,0,1,0
3,429,429,15,2,13,2,1
12,483,483,64,26,38,4,3

6,124,124,1,1,0,1,0
3,186,186,4,4,0,1,0
4,214,214,7,1,6,2,1
12,214,214,35,35,0,1,0
15,221,221,13,13,0,1,0
0,231,231,40,40,0,1,0
17,248,248,22,13,9,4,3
2,281,281,2,2,0,1,0
11,304,304,10,10,0,1,0
1,307,307,7,1,6,3,2
14,320,320,3,3,0,1,0
10,322,322,31,14,17,2,1
8,341,341,54,54,0,1,0
9,396,396,71,25,46,3,2
5,443,443,37,21,16,3,2
13,461,461,172,168,4,2,1
7,491,491,9,9,0,1,0
16,494,494,39,4,35,2,1

11,128,128,10,10,0,1,0
6,182,182,24,14,10,3,2
9,189,189,53,53,0,1,0
3,237,237,16,1,15,4,3
10,252,252,3,3,0,1,0
2,267,267,33,28,5,2,1
7,280,280,24,24,0,1,0
13,290,290,1,1,0,1,0
0,300,300,11,11,0,1,0
8,305,305,9,9,0,1,0
5,332,332,5,5,0,1,0
4,382,382,22,7,15,4,3
14,425,425,61,61,0,1,0
1,464,464,132,123,9,4,3
12,487,487,129,51,78,4,3

10,119,119,28,12,16,2,1
7,129,129,4,4,0,1,0
8,182,182,33,33,0,1,0
0,197,197,27,27,0,1,0
15,199,199,3,3,0,1,0
9,206,206,21,5,16,2,1
14,209,209,59,59,0,1,0
5,233,233,32,32,0,1,0
11,255,255,1,1,0,1,0
3,339,339,1,1,0,1,0
12,364,364,28,28,0,1,0
2,377,377,5,5,0,1,0
4,426,426,56,18,38,3,2
16,440,440,47,47,0,1,0
6,443,443,22,10,12,3,2
13,484,484,46,8,38,3,2
1,485,485,9,9,0,1,0

1,108,108,4,1,3,2,1
5,126,126,11,5,6,2,1
0,144,144,27,27,0,1,0
15,181,181,22,1,21,2,1
7,204,204,16,16,0,1,0
16,242,242,21,3,18,3,2
8,257,257,11,1,10,3,2
4,326,326,10,4,6,3,2
9,332,332,7,7,0,1,0
13,336,336,25,15,10,4,3
12,359,359,35,17,18,3,2
11,403,403,57,45,12,3,2
10,431,431,10,10,0,1,0
3,441,441,32,10,22,3,2
2,442,442,2,2,0,1,0
17,463,463,65,57,8,2,1
18,473,473,58,27,31,3,2
14,474,474,78,78,0,1,0
6,475,475,35,10,25,2,1

8,102,102,1,1,0,1,0
7,127,127,35,14,21,3,2
0,143,143,13,13,0,1,0
5,146,146,1,1,0,1,0
18,182,182,7,4,3,2,1
13,188,188,1,1,0,1,0
17,194,194,56,13,43,2,1
3,220,220,5,5,0,1,0
6,222,222,9,1,8,3,2
2,243,243,5,5,0,1,0
15,244,244,4,1,3,2,1
4,326,326,11,8,3,2,1
1,332,332,11,11,0,1,0
9,342,342,3,3,0,1,0
11,354,354,14,11,3,2,1
12,403,403,26,26,0,1,0
21,435,435,84,84,0,1,0
16,437,437,111,43,68,4,3
14,455,455,54,35,19,2,1
10,472,472,14,14,0,1,0
19,476,476,7,1,6,2,1
20,499,499,4,4,0,1,0

1,108,108,19,19,0,1,0
11,160,160,27,19,8,2,1
13,166,166,63,63,0,1,0
0,171,171,9,9,0,1,0
8,183,183,20,20,0,1,0
5,214,214,13,2,11,2,1
4,215,215,32,32,0,1,0
7,274,274,1,1,0,1,0
15,286,286,10,6,4,2,1
6,305,305,36,36,0,1,0
12,363,363,59,59,0,1,0
16,371,371,2,2,0,1,0
9,400,400,1,1,0,1,0
3,408,408,43,43,0,1,0
2,444,444,6,1,5,2,1
10,485,485,5,1,4,2,1
17,491,491,5,5,0,1,0
14,494,494,25,25,0,1,0

1,105,105,16,13,3,2,1
9,107,107,3,3,0,1,0
8,140,140,29,11,18,2,1
13,161,161,15,15,0,1,0
4,227,227,28,6,22,2,1
2,251,251,16,16,0,1,0
10,299,299,1,1,0,1,0
3,341,341,19,19,0,1,0
11,375,375,19,19,0,1,0
0,392,392,31,31,0,1,0
5,434,434,10,4,6,3,2
6,437,437,133,89,44,3,2
12,494,494,25,25,0,1,0
7,500,500,191,191,0,1,0

10,145,145,47,47,0,1,0
11,175,175,17,1,16,3,2
9,239,239,14,14,0,1,0
8,262,262,23,9,14,2,1
6,286,286,14,1,13,2,1
7,335,335,6,6,0,1,0
2,340,340,125,125,0,1,0
4,383,383,71,26,45,2,1
0,445,445,19,19,0,1,0
5,451,451,83,69,14,3,2
3,473,473,8,5,3,2,1
1,486,486,92,92,0,1,0

4,141,141,23,23,0,1,0
13,155,155,9,9,0,1,0
1,174,174,50,50,0,1,0
12,183,183,25,25,0,1,0
11,193,193,32,32,0,1,0
5,257,257,13,3,10,2,1
7,340,340,8,2,6,3,2
3,363,363,31,11,20,2,1
2,366,366,34,18,16,3,2
9,366,366,32,17,15,4,3
6,455,455,24,13,11,2,1
0,460,460,32,32,0,1,0
10,464,464,95,75,20,4,3
8,476,476,66,66,0,1,0

9,178,178,5,2,3,2,1
12,205,205,31,31,0,1,0
10,209,209,20,20,0,1,0
13,211,211,47,47,0,1,0
14,211,211,18,18,0,1,0
6,271,271,12,12,0,1,0
15,285,285,38,38,0,1,0
3,303,303,26,9,17,4,3
11,355,355,35,8,27,4,3
4,356,356,111,6,105,4,3
8,362,362,7,7,0,1,0
1,373,373,11,5,6,2,1
5,388,388,8,8,0,1,0
7,440,440,24,6,18,3,2
2,468,468,6,6,0,1,0
0,495,495,110,110,0,1,0

7,114,114,37,37,0,1,0
12,122,122,3,3,0,1,0
8,131,131,12,6,6,3,2
0,161,161,21,10,11,2,1
14,214,214,8,8,0,1,0
11,236,236,56,10,46,2,1
13,246,246,7,1,6,3,2
9,262,262,23,23,0,1,0
1,269,269,25,25,0,1,0
10,348,348,107,83,24,4,3
3,361,361,9,9,0,1,0
4,409,409,37,37,0,1,0
2,411,411,36,22,14,2,1
6,413,413,21,13,8,3,2
5,476,476,3,3,0,1,0

12,127,127,22,22,0,1,0
6,142,142,13,2,11,2,1
3,149,149,1,1,0,1,0
5,152,152,3,3,0,1,0
16,169,169,28,28,0,1,0
9,193,193,9,3,6,3,2
4,214,214,33,19,14,3,2
1,230,230,33,22,11,2,1
15,245,245,26,14,12,3,2
17,337,337,75,41,34,3,2
11,339,339,27,27,0,1,0
2,378,378,47,47,0,1,0
14,400,400,21,21,0,1,0
7,422,422,41,41,0,1,0
10,439,439,4,1,3,2,1
13,455,455,9,1,8,3,2
8,467,467,28,22,6,3,2
0,481,481,23,23,0,1,0

10,181,181,10,10,0,1,0
8,212,212,9,9,0,1,0
4,227,227,11,7,4,2,1
9,295,295,57,1,56,3,2
0,318,318,37,3,34,3,2
1,338,338,97,29,68,3,2
6,361,361,35,35,0,1,0
5,384,384,45,45,0,1,0
11,403,403,38,17,21,4,3
2,405,405,20,2,18,4,3
12,457,457,22,15,7,2,1
7,482,482,136,136,0,1,0
3,493,493,90,90,0,1,0

12,144,144,23,2,21,4,3
13,162,162,26,14,12,4,3
5,172,172,28,5,23,4,3
6,220,220,13,7,6,2,1
2,244,244,58,14,44,2,1
9,249,249,11,11,0,1,0
3,304,304,37,8,29,2,1
1,321,321,31,20,11,2,1
4,338,338,19,3,16,2,1
0,343,343,23,23,0,1,0
8,367,367,116,74,42,4,3
10,384,384,19,7,12,2,1
7,442,442,17,17,0,1,0
11,488,488,23,5,18,3,2

9,147,147,2,2,0,1,0
12,187,187,14,14,0,1,0
4,192,192,53,48,5,2,1
5,207,207,28,28,0,1,0
1,241,241,10,2,8,3,2
11,269,269,35,35,0,1,0
2,270,270,3,3,0,1,0
6,347,347,27,1,26,3,2
3,353,353,38,26,12,4,3
13,375,375,31,3,28,3,2
8,388,388,49,49,0,1,0
14,396,396,135,82,53,4,3
0,401,401,56,51,5,2,1
10,407,407,16,2,14,2,1
7,485,485,6,2,4,2,1

9,124,124,4,4,0,1,0
4,156,156,1,1,0,1,0
10,157,157,7,7,0,1,0
15,162,162,37,37,0,1,0
2,188,188,2,2,0,1,0
5,212,212,19,5,14,3,2
7,214,214,47,2,45,4,3
3,244,244,4,4,0,1,0
14,269,269,30,18,12,3,2
0,301,301,4,4,0,1,0
11,318,318,6,6,0,1,0
6,323,323,86,86,0,1,0
1,372,372,4,4,0,1,0
13,388,388,115,70,45,4,3
12,444,444,12,2,10,3,2
16,496,496,43,43,0,1,0
8,499,499,69,31,38,3,2

8,109,109,6,6,0,1,0
0,156,156,1,1,0,1,0
4,173,173,13,9,4,2,1
12,185,185,12,12,0,1,0
3,217,217,38,15,23,4,3
11,230,230,91,91,0,1,0
1,266,266,3,3,0,1,0
10,285,285,24,8,16,3,2
5,286,286,9,9,0,1,0
6,392,392,173,85,88,4,3
9,443,443,10,6,4,2,1
7,466,466,45,3,42,3,2
2,484,484,29,29,0,1,0
13,484,484,49,37,12,4,3

19,107,107,22,22,0,1,0
1,112,112,30,13,17,2,1
9,171,171,1,1,0,1,0
6,179,179,4,4,0,1,0
11,186,186,5,5,0,1,0
2,273,273,1,1,0,1,0
18,329,329,1,1,0,1,0
0,338,338,8,3,5,2,1
3,356,356,26,5,21,4,3
5,357,357,2,2,0,1,0
15,366,366,1,1,0,1,0
4,374,374,1,1,0,1,0
14,384,384,40,12,28,3,2
17,396,396,69,41,28,3,2
12,411,411,58,37,21,2,1
10,412,412,77,77,0,1,0
16,419,419,68,2,66,4,3
13,439,439,71,46,25,3,2
7,441,441,3,3,0,1,0
8,469,469,16,9,7,2,1

15,121,121,20,1,19,2,1
14,162,162,36,36,0,1,0
13,164,164,4,4,0,1,0
6,182,182,14,6,8,3,2
8,198,198,16,16,0,1,0
1,199,199,12,6,6,2,1
5,222,222,1,1,0,1,0
3,266,266,11,11,0,1,0
7,286,286,4,4,0,1,0
0,287,287,36,36,0,1,0
9,288,288,16,16,0,1,0
4,336,336,11,11,0,1,0
16,385,385,91,1,90,4,3
11,391,391,12,12,0,1,0
2,416,416,129,48,81,4,3
12,422,422,34,10,24,2,1
10,426,426,24,6,18,2,1

11,109,109,10,10,0,1,0
10,115,115,5,5,0,1,0
4,148,148,5,5,0,1,0
7,162,162,27,27,0,1,0
1,174,174,6,3,3,2,1
9,208,208,4,4,0,1,0
14,212,212,109,61,48,2,1
6,220,220,1,1,0,1,0
13,229,229,16,6,10,2,1
8,283,283,16,1,15,2,1
2,408,408,132,32,100,4,3
3,411,411,13,13,0,1,0
12,436,436,8,8,0,1,0
5,456,456,48,48,0,1,0
0,458,458,46,46,0,1,0

12,150,150,8,8,0,1,0
22,157,157,1,1,0,1,0
13,166,166,1,1,0,1,0
18,194,194,6,6,0,1,0
21,217,217,58,15,43,2,1
2,221,221,3,3,0,1,0
11,235,235,14,8,6,3,2
14,242,242,20,10,10,2,1
6,260,260,26,26,0,1,0
7,264,264,18,2,16,2,1
0,266,266,16,16,0,1,0
10,292,292,1,1,0,1,0
9,317,317,10,2,8,2,1
19,333,333,22,4,18,3,2
16,349,349,113,98,15,4,3
15,351,351,2,2,0,1,0
17,375,375,1,1,0,1,0
1,423,423,13,13,0,1,0
5,436,436,60,46,14,3,2
4,454,454,6,1,5,2,1
8,465,465,3,3,0,1,0
20,494,494,56,25,31,2,1
3,498,498,65,21,44,2,1

7,100,100,2,2,0,1,0
3,163,163,16,16,0,1,0
10,187,187,12,12,0,1,0
1,198,198,17,17,0,1,0
13,204,204,7,7,0,1,0
5,214,214,32,23,9,4,3
14,214,214,68,68,0,1,0
16,240,240,34,23,11,2,1
11,249,249,5,5,0,1,0
9,280,280,8,4,4,2,1
8,281,281,25,25,0,1,0
12,302,302,13,13,0,1,0
6,305,305,13,7,6,2,1
2,316,316,1,1,0,1,0
17,321,321,77,77,0,1,0
15,396,396,6,6,0,1,0
4,398,398,58,12,46,2,1
0,462,462,34,34,0,1,0

3,110,110,19,5,14,2,1
4,133,133,1,1,0,1,0
16,139,139,8,8,0,1,0
13,174,174,15,3,12,3,2
1,204,204,21,21,0,1,0
8,215,215,5,5,0,1,0
15,265,265,46,46,0,1,0
11,285,285,15,5,10,2,1
5,285,285,38,14,24,2,1
0,287,287,19,14,5,2,1
10,312,312,32,32,0,1,0
2,341,341,13,13,0,1,0
12,351,351,50,50,0,1,0
14,360,360,71,71,0,1,0
6,385,385,6,6,0,1,0
9,484,484,51,51,0,1,0
7,489,489,66,40,26,3,2

2,106,106,6,6,0,1,0
14,133,133,9,9,0,1,0
4,150,150,9,9,0,1,0
13,214,214,7,7,0,1,0
1,224,224,5,5,0,1,0
10,236,236,20,20,0,1,0
9,278,278,10,10,0,1,0
15,284,284,84,38,46,4,3
3,289,289,18,18,0,1,0
12,298,298,68,4,64,3,2
8,312,312,106,6,100,3,2
11,318,318,23,13,10,2,1
5,348,348,43,30,13,2,1
6,374,374,26,26,0,1,0
0,382,382,23,16,7,2,1
7,496,496,4,4,0,1,0

15,117,117,5,5,0,1,0
7,118,118,9,9,0,1,0
3,121,121,1,1,0,1,0
14,125,125,4,1,3,2,1
16,163,163,35,35,0,1,0
17,172,172,17,2,15,2,1
20,175,175,11,2,9,4,3
2,194,194,5,1,4,2,1
18,198,198,20,12,8,2,1
11,200,200,5,1,4,2,1
8,215,215,1,1,0,1,0
10,255,255,25,25,0,1,0
4,306,306,17,17,0,1,0
13,335,335,20,20,0,1,0
9,353,353,18,18,0,1,0
19,362,362,96,91,5,2,1
1,364,364,5,5,0,1,0
6,383,383,73,21,52,3,2
5,422,422,34,34,0,1,0
12,427,427,47,47,0,1,0
0,473,473,1,1,0,1,0

9,163,163,2,2,0,1,0
6,175,175,14,2,12,2,1
10,182,182,3,3,0,1,0
15,230,230,28,1,27,2,1
20,258,258,2,2,0,1,0
2,275,275,51,18,33,4,3
12,313,313,4,1,3,2,1
8,328,328,17,4,13,2,1
16,352,352,25,25,0,1,0
7,355,355,29,29,0,1,0
5,363,363,23,23,0,1,0
17,367,367,92,8,84,3,2
14,386,386,69,69,0,1,0
4,412,412,48,48,0,1,0
18,423,423,35,1,34,3,2
19,423,423,42,42,0,1,0
1,436,436,11,5,6,2,1
0,454,454,40,17,23,2,1
13,455,455,13,13,0,1,0
11,465,465,17,12,5,2,1
3,497,497,1,1,0,1,0

7,130,130,6,1,5,2,1
4,144,144,26,2,24,4,3
9,155,155,6,6,0,1,0
2,173,173,15,15,0,1,0
3,173,173,6,3,3,2,1
13,204,204,72,72,0,1,0
1,247,247,32,15,17,3,2
6,257,257,1,1,0,1,0
8,282,282,25,25,0,1,0
5,303,303,52,52,0,1,0
10,350,350,34,34,0,1,0
12,350,350,24,2,22,2,1
11,354,354,54,12,42,2,1
0,443,443,26,26,0,1,0
15,465,465,34,18,16,2,1
14,473,473,15,15,0,1,0

8,102,102,5,2,3,2,1
0,114,114,9,9,0,1,0
1,163,163,9,3,6,3,2
12,167,167,17,17,0,1,0
13,180,180,34,2,32,3,2
10,183,183,27,10,17,2,1
6,213,213,3,3,0,1,0
9,231,231,13,3,10,3,2
4,247,247,61,61,0,1,0
11,306,306,36,36,0,1,0
14,311,311,49,27,22,2,1
7,403,403,54,54,0,1,0
5,447,447,19,19,0,1,0
3,450,450,48,18,30,3,2
2,476,476,59,59,0,1,0

4,115,115,1,1,0,1,0
8,138,138,10,1,9,4,3
10,212,212,7,7,0,1,0
12,235,235,30,30,0,1,0
17,246,246,34,34,0,1,0
16,262,262,19,10,9,4,3
9,307,307,1,1,0,1,0
0,338,338,5,5,0,1,0
11,345,345,30,3,27,4,3
6,352,352,62,62,0,1,0
2,363,363,31,31,0,1,0
15,364,364,77,62,15,2,1
3,366,366,20,20,0,1,0
14,379,379,28,28,0,1,0
13,403,403,42,42,0,1,0
7,448,448,9,9,0,1,0
1,486,486,109,74,35,2,1
5,487,487,54,54,0,1,0

2,114,114,36,36,0,1,0
7,153,153,29,29,0,1,0
9,200,200,7,7,0,1,0
8,202,202,3,3,0,1,0
1,224,224,1,1,0,1,0
13,242,242,74,30,44,3,2
11,255,255,23,3,20,3,2
10,357,357,35,20,15,4,3
4,377,377,11,11,0,1,0
6,383,383,61,61,0,1,0
0,391,391,15,5,10,2,1
3,452,452,100,82,18,4,3
12,466,466,39,39,0,1,0
5,473,473,15,10,5,2,1

2,106,106,23,8,15,4,3
3,141,141,1,1,0,1,0
11,141,141,54,33,21,2,1
4,150,150,12,12,0,1,0
10,154,154,25,25,0,1,0
12,170,170,1,1,0,1,0
7,192,192,6,6,0,1,0
1,196,196,13,13,0,1,0
8,243,243,5,5,0,1,0
14,289,289,59,49,10,2,1
15,298,298,11,11,0,1,0
13,376,376,9,3,6,3,2
9,391,391,2,2,0,1,0
16,401,401,57,57,0,1,0
0,413,413,17,17,0,1,0
6,424,424,8,8,0,1,0
17,447,447,6,6,0,1,0
5,490,490,76,64,12,2,1

4,101,101,2,2,0,1,0
2,147,147,2,2,0,1,0
9,170,170,5,5,0,1,0
5,189,189,11,11,0,1,0
15,199,199,15,15,0,1,0
18,201,201,48,39,9,4,3
6,248,248,12,4,8,3,2
10,260,260,20,1,19,2,1
1,265,265,57,57,0,1,0
17,324,324,18,18,0,1,0
3,335,335,20,10,10,2,1
16,371,371,7,7,0,1,0
8,377,377,18,11,7,2,1
13,395,395,103,103,0,1,0
11,422,422,48,48,0,1,0
7,427,427,44,44,0,1,0
12,430,430,44,36,8,3,2
0,486,486,8,8,0,1,0
14,499,499,28,28,0,1,0

16,178,178,7,7,0,1,0
7,191,191,16,1,15,4,3
13,193,193,35,15,20,2,1
10,227,227,3,3,0,1,0
2,262,262,4,4,0,1,0
11,267,267,12,4,8,3,2
14,281,281,104,36,68,3,2
12,330,330,3,3,0,1,0
9,346,346,84,84,0,1,0
1,346,346,12,3,9,2,1
3,356,356,51,21,30,4,3
0,367,367,22,4,18,3,2
17,383,383,49,49,0,1,0
18,385,385,13,9,4,2,1
6,396,396,31,31,0,1,0
15,419,419,22,22,0,1,0
5,427,427,32,2,30,4,3
4,443,443,4,4,0,1,0
8,464,464,1,1,0,1,0

6,239,239,24,2,22,2,1
8,255,255,24,24,0,1,0
1,263,263,2,2,0,1,0
4,294,294,9,9,0,1,0
2,325,325,121,121,0,1,0
9,375,375,33,14,19,2,1
5,411,411,49,49,0,1,0
7,420,420,77,57,20,3,2
3,433,433,77,77,0,1,0
0,435,435,106,73,33,4,3
10,455,455,89,89,0,1,0

16,119,119,8,3,5,2,1
2,123,123,1,1,0,1,0
3,156,156,22,22,0,1,0
4,165,165,5,5,0,1,0
15,252,252,51,51,0,1,0
1,271,271,25,25,0,1,0
0,282,282,1,1,0,1,0
9,286,286,85,21,64,3,2
12,306,306,79,79,0,1,0
8,309,309,41,41,0,1,0
10,318,318,12,9,3,2,1
11,357,357,56,47,9,4,3
7,364,364,4,4,0,1,0
5,367,367,17,17,0,1,0
17,375,375,3,3,0,1,0
14,389,389,8,8,0,1,0
6,441,441,1,1,0,1,0
13,478,478,44,44,0,1,0

15,112,112,22,22,0,1,0
13,121,121,14,3,11,2,1
17,153,153,5,5,0,1,0
16,162,162,25,25,0,1,0
12,182,182,15,4,11,2,1
18,237,237,41,41,0,1,0
0,257,257,1,1,0,1,0
14,273,273,35,35,0,1,0
8,277,277,9,1,8,3,2
19,287,287,19,19,0,1,0
1,289,289,44,41,3,2,1
9,297,297,7,7,0,1,0
7,313,313,16,16,0,1,0
11,317,317,5,1,4,2,1
2,368,368,27,17,10,3,2
6,374,374,5,5,0,1,0
20,387,387,27,27,0,1,0
5,421,421,2,2,0,1,0
10,461,461,17,8,9,4,3
3,471,471,76,76,0,1,0
4,479,479,18,7,11,2,1

14,194,194,28,28,0,1,0
11,200,200,5,2,3,2,1
2,217,217,1,1,0,1,0
6,245,245,1,1,0,1,0
9,245,245,22,1,21,3,2
12,273,273,28,28,0,1,0
3,298,298,14,6,8,3,2
13,302,302,15,15,0,1,0
8,311,311,43,13,30,2,1
10,395,395,105,67,38,3,2
5,414,414,13,5,8,2,1
7,426,426,64,15,49,3,2
4,456,456,176,176,0,1,0
0,462,462,22,22,0,1,0
1,467,467,61,61,0,1,0

0,146,146,1,1,0,1,0
11,147,147,13,13,0,1,0
9,163,163,21,13,8,3,2
10,186,186,6,6,0,1,0
4,207,207,14,14,0,1,0
3,273,273,30,13,17,2,1
7,278,278,104,104,0,1,0
14,282,282,87,87,0,1,0
1,289,289,18,6,12,2,1
13,310,310,16,16,0,1,0
2,319,319,30,6,24,3,2
15,336,336,5,5,0,1,0
5,409,409,4,4,0,1,0
12,423,423,79,79,0,1,0
6,443,443,1,1,0,1,0
8,470,470,35,13,22,2,1

13,111,111,20,8,12,2,1
7,127,127,14,14,0,1,0
8,145,145,37,37,0,1,0
0,159,159,8,8,0,1,0
3,187,187,2,2,0,1,0
11,193,193,7,1,6,2,1
6,289,289,126,78,48,4,3
12,290,290,36,28,8,3,2
4,297,297,12,12,0,1,0
9,355,355,17,17,0,1,0
5,401,401,58,58,0,1,0
1,411,411,12,12,0,1,0
2,439,439,39,39,0,1,0
10,494,494,34,4,30,3,2

14,108,108,2,2,0,1,0
15,135,135,5,5,0,1,0
3,193,193,5,1,4,2,1
7,204,204,13,7,6,3,2
0,250,250,37,24,13,2,1
11,271,271,69,31,38,2,1
16,272,272,12,2,10,2,1
8,355,355,13,1,12,2,1
9,370,370,63,19,44,4,3
10,377,377,1,1,0,1,0
12,395,395,102,12,90,4,3
5,403,403,63,63,0,1,0
6,415,415,45,37,8,2,1
13,423,423,84,63,21,2,1
2,466,466,25,15,10,3,2
1,472,472,13,13,0,1,0
4,500,500,6,6,0,1,0

3,102,102,15,15,0,1,0
5,121,121,19,19,0,1,0
7,217,217,63,63,0,1,0
4,297,297,51,9,42,4,3
0,298,298,1,1,0,1,0
6,320,320,26,26,0,1,0
13,351,351,1,1,0,1,0
1,369,369,46,4,42,3,2
9,402,402,29,29,0,1,0
10,405,405,30,15,15,4,3
11,425,425,46,22,24,3,2
8,435,435,107,107,0,1,0
12,435,435,7,7,0,1,0
2,452,452,52,40,12,4,3

18,103,103,7,4,3,2,1
11,105,105,11,4,7,2,1
10,115,115,8,8,0,1,0
17,181,181,33,12,21,2,1
4,197,197,8,8,0,1,0
12,217,217,26,11,15,4,3
13,224,224,34,34,0,1,0
2,260,260,4,4,0,1,0
3,296,296,9,1,8,2,1
8,326,326,26,26,0,1,0
14,350,350,35,14,21,4,3
9,366,366,7,1,6,3,2
6,398,398,47,3,44,3,2
5,435,435,91,47,44,3,2
7,456,456,21,13,8,2,1
15,468,468,76,76,0,1,0
0,474,474,7,7,0,1,0
1,476,476,26,19,7,2,1
16,477,477,16,16,0,1,0

3,102,102,7,7,0,1,0
5,136,136,11,11,0,1,0
2,143,143,1,1,0,1,0
11,144,144,7,7,0,1,0
15,168,168,6,6,0,1,0
14,187,187,46,14,32,2,1
13,190,190,5,5,0,1,0
9,243,243,59,17,42,4,3
8,253,253,52,52,0,1,0
7,278,278,19,1,18,3,2
4,343,343,23,12,11,2,1
6,343,343,7,2,5,2,1
12,378,378,66,66,0,1,0
10,411,411,35,35,0,1,0
1,455,455,2,2,0,1,0
16,460,460,89,38,51,4,3
0,475,475,17,17,0,1,0

4,107,107,4,1,3,2,1
7,110,110,5,1,4,2,1
11,186,186,14,14,0,1,0
9,188,188,30,3,27,2,1
0,266,266,14,4,10,2,1
10,287,287,30,30,0,1,0
8,294,294,22,1,21,3,2
3,361,361,30,1,29,2,1
12,368,368,45,45,0,1,0
6,414,414,98,98,0,1,0
2,422,422,79,53,26,2,1
1,468,468,54,54,0,1,0
5,481,481,156,128,28,2,1

12,174,174,1,1,0,1,0
17,232,232,14,2,12,4,3
8,245,245,11,5,6,3,2
9,256,256,4,4,0,1,0
6,259,259,32,32,0,1,0
11,292,292,107,32,75,4,3
7,328,328,34,10,24,4,3
1,365,365,3,3,0,1,0
16,373,373,14,14,0,1,0
14,383,383,33,15,18,4,3
4,384,384,69,54,15,2,1
0,398,398,67,28,39,2,1
13,405,405,98,4,94,3,2
10,443,443,9,9,0,1,0
15,452,452,6,6,0,1,0
2,458,458,41,41,0,1,0
5,492,492,19,19,0,1,0
3,493,493,4,1,3,2,1

1,114,114,5,1,4,2,1
4,243,243,30,3,27,3,2
5,243,243,25,25,0,1,0
8,343,343,8,1,7,2,1
10,357,357,34,34,0,1,0
0,358,358,17,17,0,1,0
9,365,365,3,3,0,1,0
3,369,369,9,3,6,3,2
7,382,382,180,174,6,2,1
2,399,399,184,157,27,2,1
6,406,406,8,8,0,1,0
12,491,491,65,65,0,1,0
11,496,496,29,14,15,3,2

15,102,102,35,35,0,1,0
14,103,103,1,1,0,1,0
13,104,104,2,2,0,1,0
3,114,114,8,8,0,1,0
0,126,126,3,3,0,1,0
17,149,149,13,13,0,1,0
9,187,187,2,2,0,1,0
10,189,189,3,3,0,1,0
16,201,201,18,13,5,2,1
11,201,201,48,48,0,1,0
6,278,278,4,4,0,1,0
8,290,290,9,3,6,3,2
2,353,353,23,2,21,2,1
7,366,366,1,1,0,1,0
1,405,405,19,19,0,1,0
4,420,420,201,201,0,1,0
12,459,459,18,3,15,4,3
5,473,473,20,20,0,1,0

9,123,123,22,16,6,3,2
4,188,188,3,3,0,1,0
15,190,190,22,7,15,2,1
8,198,198,12,12,0,1,0
1,207,207,4,1,3,2,1
12,220,220,1,1,0,1,0
17,220,220,19,3,16,2,1
11,226,226,1,1,0,1,0
3,235,235,1,1,0,1,0
0,247,247,2,2,0,1,0
16,294,294,35,7,28,3,2
10,350,350,37,37,0,1,0
14,367,367,53,23,30,4,3
19,368,368,33,33,0,1,0
18,386,386,61,61,0,1,0
2,404,404,75,75,0,1,0
13,418,418,53,2,51,4,3
7,427,427,34,34,0,1,0
20,435,435,42,35,7,2,1
6,474,474,1,1,0,1,0
5,492,492,3,3,0,1,0

0,138,138,1,1,0,1,0
11,156,156,59,59,0,1,0
12,189,189,30,30,0,1,0
8,191,191,2,2,0,1,0
9,224,224,13,13,0,1,0
10,224,224,3,3,0,1,0
2,236,236,18,11,7,2,1
6,262,262,20,20,0,1,0
1,378,378,114,32,82,3,2
7,380,380,46,19,27,2,1
4,385,385,40,5,35,2,1
5,408,408,32,28,4,2,1
3,442,442,103,65,38,2,1

4,103,103,21,21,0,1,0
11,106,106,11,1,10,2,1
0,134,134,40,33,7,2,1
1,166,166,20,3,17,2,1
2,184,184,1,1,0,1,0
7,188,188,4,4,0,1,0
14,225,225,4,4,0,1,0
8,245,245,9,3,6,2,1
13,293,293,18,12,6,2,1
3,299,299,3,3,0,1,0
6,337,337,29,24,5,2,1
10,383,383,17,17,0,1,0
5,408,408,23,23,0,1,0
9,420,420,80,3,77,3,2
12,422,422,151,112,39,3,2

0,125,125,12,4,8,3,2
18,127,127,4,4,0,1,0
17,127,127,23,9,14,2,1
1,137,137,1,1,0,1,0
15,193,193,11,11,0,1,0
2,227,227,36,36,0,1,0
7,229,229,2,2,0,1,0
12,229,229,13,13,0,1,0
6,256,256,37,37,0,1,0
19,268,268,72,72,0,1,0
5,275,275,44,23,21,2,1
9,279,279,1,1,0,1,0
4,280,280,18,18,0,1,0
8,289,289,14,11,3,2,1
10,314,314,10,10,0,1,0
3,327,327,4,4,0,1,0
11,328,328,3,3,0,1,0
14,356,356,60,15,45,4,3
13,430,430,19,14,5,2,1
16,490,490,29,29,0,1,0

11,105,105,9,1,8,2,1
14,119,119,17,1,16,3,2
12,152,152,12,12,0,1,0
4,173,173,17,6,11,2,1
7,209,209,2,2,0,1,0
16,221,221,63,15,48,3,2
1,275,275,18,4,14,2,1
5,279,279,4,4,0,1,0
0,284,284,29,11,18,3,2
8,290,290,15,15,0,1,0
9,330,330,18,18,0,1,0
13,331,331,15,6,9,2,1
20,352,352,43,22,21,4,3
17,380,380,17,8,9,4,3
19,381,381,48,4,44,3,2
10,398,398,40,40,0,1,0
18,402,402,24,24,0,1,0
15,405,405,13,13,0,1,0
2,417,417,10,2,8,2,1
3,457,457,30,17,13,4,3
6,491,491,3,3,0,1,0

7,103,103,1,1,0,1,0
11,113,113,50,50,0,1,0
12,123,123,4,4,0,1,0
4,152,152,28,2,26,3,2
9,184,184,35,35,0,1,0
0,207,207,24,6,18,4,3
2,225,225,59,35,24,4,3
10,269,269,28,28,0,1,0
3,296,296,42,20,22,3,2
6,337,337,15,5,10,3,2
5,357,357,3,3,0,1,0
1,412,412,36,7,29,4,3
8,460,460,1,1,0,1,0

1,112,112,35,5,30,2,1
6,126,126,14,9,5,2,1
13,173,173,10,5,5,2,1
11,235,235,22,8,14,2,1
3,301,301,9,1,8,2,1
2,307,307,20,5,15,3,2
8,315,315,62,4,58,4,3
7,325,325,2,2,0,1,0
10,356,356,11,11,0,1,0
12,356,356,91,22,69,4,3
9,362,362,52,18,34,3,2
5,363,363,9,4,5,2,1
4,366,366,6,1,5,2,1
0,390,390,92,92,0,1,0
14,455,455,15,15,0,1,0

13,139,139,6,1,5,2,1
15,149,149,25,16,9,2,1
19,155,155,43,23,20,2,1
17,162,162,15,2,13,2,1
10,175,175,15,15,0,1,0
5,192,192,18,6,12,2,1
16,202,202,8,8,0,1,0
2,202,202,1,1,0,1,0
0,212,212,34,10,24,3,2
12,257,257,22,7,15,4,3
3,259,259,12,3,9,2,1
18,270,270,28,28,0,1,0
9,344,344,4,4,0,1,0
6,369,369,70,70,0,1,0
8,437,437,1,1,0,1,0
11,457,457,19,19,0,1,0
14,460,460,45,42,3,2,1
7,465,465,9,9,0,1,0
4,470,470,1,1,0,1,0
1,497,497,29,26,3,2,1

15,116,116,6,1,5,2,1
7,122,122,7,7,0,1,0
3,125,125,7,7,0,1,0
9,136,136,6,6,0,1,0
18,172,172,40,36,4,2,1
13,176,176,2,2,0,1,0
17,196,196,10,7,3,2,1
0,202,202,16,16,0,1,0
19,214,214,4,4,0,1,0
12,218,218,1,1,0,1,0
5,221,221,10,7,3,2,1
10,227,227,3,3,0,1,0
6,241,241,19,19,0,1,0
11,319,319,83,1,82,3,2
20,375,375,9,9,0,1,0
8,384,384,6,6,0,1,0
4,406,406,11,11,0,1,0
2,421,421,15,6,9,2,1
16,447,447,50,11,39,4,3
14,457,457,151,97,54,3,2
1,498,498,37,13,24,4,3

6,102,102,14,14,0,1,0
17,108,108,27,27,0,1,0
14,120,120,1,1,0,1,0
9,128,128,11,11,0,1,0
7,149,149,8,8,0,1,0
18,171,171,21,4,17,2,1
12,172,172,5,5,0,1,0
0,208,208,20,4,16,3,2
3,224,224,19,11,8,3,2
16,247,247,21,15,6,3,2
13,253,253,42,42,0,1,0
15,267,267,42,39,3,2,1
8,282,282,2,2,0,1,0
4,305,305,60,31,29,2,1
10,315,315,2,2,0,1,0
11,325,325,7,7,0,1,0
5,371,371,5,5,0,1,0
2,378,378,23,11,12,3,2
1,496,496,18,18,0,1,0

11,101,101,25,21,4,2,1
0,141,141,30,30,0,1,0
3,212,212,23,23,0,1,0
8,219,219,11,11,0,1,0
9,224,224,11,11,0,1,0
1,271,271,93,93,0,1,0
10,282,282,11,11,0,1,0
2,319,319,4,4,0,1,0
7,371,371,8,8,0,1,0
6,407,407,93,30,63,4,3
4,410,410,51,28,23,2,1
5,445,445,76,46,30,3,2

2,130,130,25,17,8,3,2
14,133,133,19,19,0,1,0
15,135,135,22,7,15,4,3
5,160,160,1,1,0,1,0
4,187,187,9,1,8,3,2
6,205,205,26,14,12,4,3
10,277,277,22,11,11,2,1
13,278,278,2,2,0,1,0
1,308,308,11,11,0,1,0
12,345,345,132,60,72,4,3
9,380,380,11,4,7,2,1
7,399,399,102,30,72,4,3
11,422,422,4,4,0,1,0
0,425,425,42,24,18,4,3
3,473,473,4,1,3,2,1
8,498,498,14,14,0,1,0

5,135,135,22,22,0,1,0
4,145,145,8,8,0,1,0
3,156,156,32,32,0,1,0
1,164,164,4,4,0,1,0
13,289,289,32,4,28,2,1
15,297,297,24,11,13,2,1
11,300,300,176,176,0,1,0
16,308,308,2,2,0,1,0
8,320,320,48,40,8,2,1
12,354,354,3,3,0,1,0
9,388,388,25,2,23,2,1
10,431,431,6,6,0,1,0
14,434,434,1,1,0,1,0
0,450,450,2,2,0,1,0
6,471,471,16,6,10,2,1
2,482,482,27,27,0,1,0
7,488,488,22,22,0,1,0

12,105,105,28,14,14,2,1
1,107,107,7,7,0,1,0
13,131,131,2,2,0,1,0
9,162,162,12,12,0,1,0
8,182,182,13,13,0,1,0
10,200,200,30,18,12,2,1
6,210,210,1,1,0,1,0
0,231,231,8,8,0,1,0
5,247,247,33,26,7,2,1
11,262,262,37,37,0,1,0
16,269,269,57,57,0,1,0
14,299,299,9,3,6,2,1
7,332,332,26,26,0,1,0
2,340,340,4,4,0,1,0
4,351,351,9,9,0,1,0
15,394,394,41,41,0,1,0
3,433,433,66,66,0,1,0
17,495,495,25,25,0,1,0

1,187,187,9,9,0,1,0
11,217,217,21,14,7,2,1
6,251,251,3,3,0,1,0
5,253,253,88,88,0,1,0
7,280,280,67,22,45,2,1
3,287,287,15,15,0,1,0
13,293,293,6,6,0,1,0
9,305,305,19,19,0,1,0
8,331,331,8,3,5,2,1
10,346,346,119,69,50,2,1
2,375,375,49,49,0,1,0
0,429,429,45,45,0,1,0
12,473,473,11,11,0,1,0
4,483,483,51,11,40,2,1

11,115,115,25,1,24,2,1
7,179,179,20,20,0,1,0
3,180,180,8,3,5,2,1
17,211,211,36,22,14,3,2
10,225,225,6,6,0,1,0
2,249,249,31,13,18,3,2
5,265,265,25,25,0,1,0
13,265,265,29,17,12,2,1
1,275,275,48,9,39,4,3
4,283,283,4,4,0,1,0
8,336,336,54,38,16,2,1
15,350,350,15,15,0,1,0
9,371,371,4,4,0,1,0
16,378,378,13,13,0,1,0
6,385,385,4,4,0,1,0
14,396,396,23,20,3,2,1
0,454,454,14,4,10,2,1
12,499,499,90,60,30,3,2

1,133,133,43,43,0,1,0
8,162,162,37,37,0,1,0
2,164,164,12,12,0,1,0
5,167,167,2,2,0,1,0
4,193,193,26,16,10,3,2
12,228,228,51,3,48,4,3
9,261,261,1,1,0,1,0
3,285,285,32,32,0,1,0
11,288,288,5,5,0,1,0
6,321,321,13,13,0,1,0
0,377,377,40,6,34,3,2
10,403,403,24,24,0,1,0
13,429,429,107,70,37,2,1
7,437,437,15,5,10,3,2

15,119,119,2,2,0,1,0
10,157,157,6,6,0,1,0
12,173,173,38,38,0,1,0
7,197,197,2,2,0,1,0
16,214,214,34,21,13,2,1
2,221,221,19,7,12,2,1
3,228,228,7,7,0,1,0
5,272,272,56,56,0,1,0
13,280,280,73,55,18,4,3
6,288,288,13,3,10,2,1
11,318,318,33,33,0,1,0
0,326,326,51,51,0,1,0
1,417,417,22,22,0,1,0
9,422,422,6,6,0,1,0
4,464,464,1,1,0,1,0
14,481,481,9,9,0,1,0
8,495,495,98,54,44,2,1

7,116,116,1,1,0,1,0
3,148,148,36,26,10,2,1
9,164,164,18,18,0,1,0
4,188,188,36,6,30,4,3
13,194,194,8,8,0,1,0
10,240,240,18,18,0,1,0
5,264,264,30,30,0,1,0
12,272,272,39,17,22,3,2
6,369,369,11,11,0,1,0
0,377,377,11,8,3,2,1
8,404,404,49,34,15,2,1
14,420,420,95,44,51,3,2
11,459,459,46,23,23,2,1
1,470,470,87,87,0,1,0
2,489,489,3,3,0,1,0

17,111,111,12,12,0,1,0
12,122,122,22,22,0,1,0
9,159,159,3,3,0,1,0
4,173,173,22,22,0,1,0
13,209,209,13,10,3,2,1
6,217,217,6,6,0,1,0
10,228,228,16,16,0,1,0
8,229,229,1,1,0,1,0
7,231,231,13,13,0,1,0
1,307,307,8,8,0,1,0
2,332,332,14,14,0,1,0
3,337,337,75,31,44,2,1
11,341,341,7,2,5,2,1
0,363,363,3,3,0,1,0
14,393,393,4,1,3,2,1
16,452,452,119,119,0,1,0
5,466,466,82,55,27,2,1
15,482,482,40,20,20,3,2
18,486,486,51,51,0,1,0

6,103,103,16,16,0,1,0
10,121,121,17,9,8,2,1
0,125,125,41,2,39,2,1
8,142,142,33,9,24,2,1
12,199,199,3,3,0,1,0
5,265,265,42,17,25,2,1
4,367,367,8,8,0,1,0
9,372,372,15,11,4,2,1
11,381,381,48,48,0,1,0
7,388,388,44,44,0,1,0
1,461,461,27,6,21,3,2
2,469,469,15,15,0,1,0
3,484,484,98,80,18,4,3

11,111,111,1,1,0,1,0
10,124,124,5,5,0,1,0
14,142,142,29,25,4,2,1
15,154,154,50,50,0,1,0
2,164,164,10,10,0,1,0
7,169,169,22,22,0,1,0
12,175,175,3,3,0,1,0
0,211,211,30,18,12,4,3
13,260,260,15,3,12,4,3
8,282,282,35,3,32,3,2
9,314,314,53,53,0,1,0
1,322,322,2,2,0,1,0
6,368,368,44,44,0,1,0
5,394,394,17,17,0,1,0
3,456,456,78,21,57,4,3
4,459,459,2,2,0,1,0

2,162,162,50,50,0,1,0
5,175,175,9,9,0,1,0
9,187,187,17,12,5,2,1
1,264,264,47,29,18,2,1
7,340,340,30,30,0,1,0
10,370,370,92,20,72,4,3
3,371,371,52,11,41,4,3
8,402,402,56,56,0,1,0
6,449,449,51,51,0,1,0
0,468,468,52,23,29,3,2
11,480,480,38,23,15,3,2
4,499,499,31,31,0,1,0

11,115,115,40,29,11,2,1
9,135,135,14,14,0,1,0
12,152,152,4,4,0,1,0
4,156,156,19,19,0,1,0
1,158,158,20,4,16,3,2
13,228,228,33,6,27,2,1
0,234,234,14,14,0,1,0
7,278,278,31,31,0,1,0
2,279,279,70,33,37,2,1
6,284,284,9,9,0,1,0
8,361,361,2,2,0,1,0
3,377,377,78,78,0,1,0
5,435,435,2,2,0,1,0
10,469,469,37,5,32,3,2

18,114,114,13,3,10,2,1
19,114,114,32,11,21,2,1
8,121,121,6,6,0,1,0
0,124,124,2,2,0,1,0
12,149,149,1,1,0,1,0
6,210,210,1,1,0,1,0
10,221,221,3,3,0,1,0
4,227,227,4,4,0,1,0
3,246,246,22,22,0,1,0
2,251,251,11,2,9,2,1
5,269,269,31,16,15,4,3
14,314,314,31,18,13,2,1
9,317,317,25,5,20,3,2
16,336,336,9,6,3,2,1
20,348,348,6,2,4,2,1
15,364,364,40,40,0,1,0
13,387,387,25,25,0,1,0
17,411,411,71,71,0,1,0
7,454,454,9,9,0,1,0
11,457,457,1,1,0,1,0
1,498,498,139,97,42,4,3

8,102,102,3,3,0,1,0
2,112,112,11,5,6,2,1
9,137,137,8,2,6,3,2
14,140,140,7,7,0,1,0
11,143,143,7,7,0,1,0
20,172,172,13,5,8,3,2
5,182,182,13,7,6,2,1
12,279,279,41,17,24,4,3
15,280,280,5,2,3,2,1
17,285,285,7,7,0,1,0
22,286,286,3,3,0,1,0
1,295,295,13,13,0,1,0
0,315,315,19,19,0,1,0
16,330,330,7,7,0,1,0
23,337,337,25,25,0,1,0
4,345,345,2,2,0,1,0
3,377,377,12,12,0,1,0
10,379,379,13,1,12,3,2
18,432,432,25,25,0,1,0
19,443,443,67,25,42,4,3
6,456,456,9,9,0,1,0
13,486,486,29,9,20,3,2
7,492,492,2,2,0,1,0
21,495,495,207,155,52,3,2

11,120,120,10,10,0,1,0
3,186,186,27,27,0,1,0
4,210,210,2,2,0,1,0
6,233,233,67,22,45,2,1
17,235,235,32,32,0,1,0
14,247,247,27,27,0,1,0
10,251,251,2,2,0,1,0
1,252,252,17,17,0,1,0
9,295,295,33,33,0,1,0
8,303,303,7,7,0,1,0
2,358,358,1,1,0,1,0
13,365,365,143,87,56,3,2
16,378,378,18,14,4,2,1
12,386,386,18,8,10,4,3
7,393,393,29,1,28,3,2
5,395,395,21,21,0,1,0
0,405,405,8,8,0,1,0
15,416,416,1,1,0,1,0

8,102,102,17,17,0,1,0
1,142,142,16,2,14,2,1
7,168,168,11,11,0,1,0
3,180,180,1,1,0,1,0
17,195,195,49,18,31,2,1
11,207,207,12,2,10,3,2
9,208,208,8,8,0,1,0
6,226,226,18,8,10,2,1
12,297,297,1,1,0,1,0
10,301,301,3,3,0,1,0
18,332,332,78,2,76,4,3
14,348,348,14,14,0,1,0
16,365,365,39,22,17,2,1
15,406,406,28,20,8,3,2
5,407,407,23,23,0,1,0
0,420,420,4,4,0,1,0
4,421,421,42,42,0,1,0
13,429,429,45,35,10,2,1
2,446,446,45,45,0,1,0

11,107,107,5,5,0,1,0
13,107,107,2,2,0,1,0
3,112,112,8,5,3,2,1
8,133,133,18,3,15,2,1
9,205,205,19,19,0,1,0
5,243,243,30,27,3,2,1
1,244,244,42,26,16,2,1
12,261,261,57,57,0,1,0
7,346,346,48,29,19,2,1
4,398,398,44,26,18,4,3
6,415,415,87,87,0,1,0
0,480,480,13,10,3,2,1
10,495,495,80,48,32,3,2
2,499,499,43,11,32,3,2

18,109,109,21,21,0,1,0
2,113,113,1,1,0,1,0
4,125,125,1,1,0,1,0
0,140,140,1,1,0,1,0
7,174,174,17,17,0,1,0
8,193,193,19,13,6,2,1
19,212,212,58,1,57,4,3
5,248,248,7,7,0,1,0
16,271,271,39,30,9,2,1
20,283,283,12,6,6,2,1
11,321,321,23,23,0,1,0
9,368,368,38,29,9,2,1
12,379,379,1,1,0,1,0
15,384,384,38,38,0,1,0
14,395,395,1,1,0,1,0
21,419,419,12,12,0,1,0
13,422,422,14,4,10,3,2
6,431,431,42,42,0,1,0
1,438,438,4,4,0,1,0
10,448,448,25,17,8,3,2
3,449,449,35,15,20,3,2
17,470,470,18,9,9,4,3
22,499,499,47,47,0,1,0

10,139,139,35,3,32,2,1
7,200,200,8,4,4,2,1
1,240,240,19,19,0,1,0
0,267,267,54,42,12,4,3
13,272,272,28,5,23,2,1
11,279,279,12,7,5,2,1
6,301,301,6,6,0,1,0
12,329,329,115,1,114,4,3
3,341,341,7,2,5,2,1
8,415,415,12,12,0,1,0
4,437,437,39,24,15,2,1
5,452,452,43,21,22,2,1
9,460,460,3,3,0,1,0
2,465,465,119,65,54,3,2
14,476,476,12,12,0,1,0

6,104,104,16,16,0,1,0
17,124,124,10,10,0,1,0
15,136,136,17,7,10,3,2
3,145,145,14,14,0,1,0
10,183,183,18,18,0,1,0
1,185,185,6,6,0,1,0
7,188,188,4,4,0,1,0
2,244,244,3,3,0,1,0
9,264,264,7,4,3,2,1
20,301,301,24,24,0,1,0
13,307,307,7,7,0,1,0
0,345,345,49,1,48,3,2
5,353,353,5,5,0,1,0
14,359,359,20,3,17,2,1
12,388,388,8,8,0,1,0
4,389,389,18,18,0,1,0
19,442,442,115,115,0,1,0
18,449,449,7,7,0,1,0
8,469,469,37,17,20,2,1
16,485,485,97,29,68,4,3
11,486,486,18,18,0,1,0

14,160,160,26,26,0,1,0
17,161,161,5,5,0,1,0
8,188,188,13,5,8,2,1
15,191,191,7,1,6,2,1
2,229,229,2,2,0,1,0
0,230,230,11,1,10,3,2
1,262,262,16,7,9,3,2
3,292,292,10,1,9,2,1
11,295,295,138,105,33,4,3
4,302,302,72,54,18,2,1
6,311,311,53,41,12,4,3
16,320,320,10,10,0,1,0
5,344,344,7,1,6,3,2
13,377,377,23,23,0,1,0
12,413,413,8,4,4,2,1
9,415,415,25,1,24,3,2
10,434,434,29,18,11,2,1
7,483,483,12,12,0,1,0

9,108,108,3,3,0,1,0
6,123,123,32,32,0,1,0
7,160,160,3,3,0,1,0
15,169,169,37,17,20,3,2
4,189,189,8,8,0,1,0
14,231,231,27,20,7,2,1
5,259,259,6,1,5,2,1
0,263,263,7,7,0,1,0
10,278,278,31,31,0,1,0
13,404,404,38,11,27,4,3
8,410,410,23,16,7,2,1
1,412,412,3,3,0,1,0
2,412,412,141,120,21,2,1
3,419,419,10,10,0,1,0
12,449,449,3,3,0,1,0
11,465,465,112,61,51,3,2

1,109,109,25,25,0,1,0
10,144,144,8,8,0,1,0
4,269,269,8,1,7,2,1
0,278,278,18,18,0,1,0
6,298,298,7,7,0,1,0
9,362,362,155,149,6,3,2
7,398,398,27,27,0,1,0
2,417,417,100,100,0,1,0
5,433,433,60,60,0,1,0
3,434,434,116,86,30,2,1
8,497,497,34,34,0,1,0

1,130,130,9,4,5,2,1
20,138,138,31,7,24,2,1
3,142,142,10,2,8,2,1
16,200,200,46,46,0,1,0
18,228,228,5,1,4,2,1
17,265,265,18,18,0,1,0
11,274,274,32,4,28,2,1
2,281,281,41,11,30,2,1
6,292,292,25,25,0,1,0
5,314,314,3,3,0,1,0
21,332,332,79,34,45,4,3
7,399,399,9,9,0,1,0
12,412,412,43,11,32,2,1
19,416,416,9,9,0,1,0
13,430,430,25,25,0,1,0
4,442,442,15,15,0,1,0
10,449,449,8,1,7,2,1
9,487,487,13,8,5,2,1
14,487,487,1,1,0,1,0
0,489,489,12,9,3,2,1
8,497,497,7,2,5,2,1
15,500,500,5,5,0,1,0

10,103,103,10,4,6,3,2
13,106,106,8,8,0,1,0
4,149,149,20,20,0,1,0
11,244,244,60,52,8,3,2
14,289,289,4,4,0,1,0
0,294,294,52,52,0,1,0
9,300,300,16,16,0,1,0
1,314,314,12,12,0,1,0
12,318,318,65,21,44,3,2
5,335,335,50,34,16,2,1
6,339,339,8,8,0,1,0
2,353,353,24,19,5,2,1
3,391,391,33,6,27,2,1
8,402,402,52,34,18,2,1
7,465,465,59,59,0,1,0

4,118,118,32,32,0,1,0
10,148,148,14,14,0,1,0
3,190,190,26,26,0,1,0
8,196,196,39,39,0,1,0
11,258,258,19,2,17,4,3
5,266,266,25,25,0,1,0
13,301,301,39,5,34,3,2
2,314,314,7,7,0,1,0
14,326,326,16,2,14,4,3
1,353,353,17,17,0,1,0
6,385,385,32,3,29,4,3
9,385,385,30,16,14,4,3
7,389,389,34,20,14,3,2
0,410,410,24,2,22,3,2
12,447,447,86,77,9,2,1

13,100,100,25,25,0,1,0
11,118,118,3,3,0,1,0
10,178,178,16,16,0,1,0
0,186,186,32,32,0,1,0
2,239,239,3,3,0,1,0
3,255,255,30,30,0,1,0
7,326,326,77,61,16,2,1
4,327,327,32,32,0,1,0
9,344,344,11,11,0,1,0
1,348,348,23,23,0,1,0
6,365,365,54,45,9,4,3
5,399,399,75,21,54,4,3
12,406,406,24,24,0,1,0
8,459,459,59,59,0,1,0

12,113,113,2,2,0,1,0
14,138,138,39,39,0,1,0
0,156,156,7,2,5,2,1
4,168,168,2,2,0,1,0
8,180,180,33,33,0,1,0
2,211,211,49,38,11,2,1
13,264,264,18,11,7,2,1
7,280,280,57,57,0,1,0
6,292,292,7,7,0,1,0
11,318,318,69,24,45,4,3
3,355,355,1,1,0,1,0
1,381,381,2,2,0,1,0
5,464,464,129,129,0,1,0
9,485,485,7,7,0,1,0
10,485,485,16,16,0,1,0

1,122,122,3,3,0,1,0
9,146,146,33,17,16,2,1
13,179,179,37,37,0,1,0
14,191,191,40,14,26,3,2
15,241,241,39,36,3,2,1
6,247,247,14,14,0,1,0
4,250,250,28,12,16,3,2
5,252,252,51,7,44,2,1
16,317,317,23,23,0,1,0
11,318,318,2,2,0,1,0
8,322,322,10,10,0,1,0
2,326,326,13,1,12,2,1
3,375,375,16,16,0,1,0
12,404,404,44,4,40,2,1
0,408,408,26,11,15,2,1
7,421,421,1,1,0,1,0
10,482,482,23,23,0,1,0

20,109,109,5,5,0,1,0
12,121,121,4,4,0,1,0
15,131,131,13,4,9,4,3
17,161,161,2,2,0,1,0
19,187,187,13,13,0,1,0
7,213,213,13,13,0,1,0
2,242,242,20,20,0,1,0
18,249,249,71,71,0,1,0
9,251,251,5,5,0,1,0
4,292,292,12,12,0,1,0
13,320,320,26,2,24,2,1
6,341,341,8,8,0,1,0
16,347,347,95,95,0,1,0
14,351,351,11,2,9,2,1
3,360,360,94,70,24,3,2
11,369,369,31,16,15,4,3
5,370,370,4,1,3,2,1
10,400,400,11,4,7,2,1
8,444,444,19,9,10,2,1
1,459,459,1,1,0,1,0
0,481,481,15,15,0,1,0

12,106,106,9,9,0,1,0
9,124,124,5,5,0,1,0
0,168,168,2,2,0,1,0
11,181,181,5,5,0,1,0
3,191,191,15,1,14,3,2
1,217,217,2,2,0,1,0
8,219,219,1,1,0,1,0
10,232,232,27,27,0,1,0
4,283,283,46,46,0,1,0
6,299,299,30,30,0,1,0
5,372,372,65,65,0,1,0
7,395,395,29,23,6,3,2
16,404,404,121,96,25,2,1
15,422,422,82,57,25,4,3
13,441,441,34,7,27,2,1
2,447,447,68,38,30,4,3
14,472,472,7,7,0,1,0

5,109,109,9,3,6,2,1
1,114,114,25,6,19,2,1
3,133,133,8,8,0,1,0
9,141,141,17,17,0,1,0
0,146,146,17,17,0,1,0
8,193,193,1,1,0,1,0
7,196,196,18,18,0,1,0
6,305,305,83,42,41,2,1
2,337,337,138,11,127,4,3
4,361,361,74,74,0,1,0
10,386,386,17,17,0,1,0

3,129,129,4,4,0,1,0
11,180,180,3,3,0,1,0
15,185,185,13,2,11,2,1
7,192,192,2,2,0,1,0
10,237,237,4,4,0,1,0
18,238,238,28,28,0,1,0
17,254,254,63,13,50,4,3
6,260,260,1,1,0,1,0
1,273,273,15,5,10,2,1
9,281,281,42,24,18,2,1
2,317,317,36,28,8,2,1
13,337,337,32,32,0,1,0
5,352,352,99,93,6,2,1
8,365,365,31,31,0,1,0
4,370,370,14,14,0,1,0
0,375,375,1,1,0,1,0
14,387,387,52,52,0,1,0
16,482,482,35,35,0,1,0
12,497,497,39,33,6,3,2

11,124,124,16,12,4,2,1
6,125,125,18,4,14,2,1
13,147,147,12,12,0,1,0
4,160,160,1,1,0,1,0
8,161,161,5,5,0,1,0
10,236,236,12,12,0,1,0
1,251,251,1,1,0,1,0
0,267,267,67,39,28,3,2
12,268,268,55,11,44,2,1
5,275,275,29,29,0,1,0
14,343,343,8,8,0,1,0
2,375,375,86,86,0,1,0
9,386,386,62,38,24,4,3
3,395,395,9,9,0,1,0
15,415,415,67,67,0,1,0
7,487,487,5,5,0,1,0

10,115,115,5,2,3,2,1
15,117,117,2,2,0,1,0
3,124,124,2,2,0,1,0
20,155,155,4,4,0,1,0
6,155,155,7,7,0,1,0
11,216,216,3,3,0,1,0
0,216,216,4,4,0,1,0
17,240,240,14,1,13,2,1
12,253,253,20,20,0,1,0
13,266,266,1,1,0,1,0
5,296,296,25,4,21,2,1
1,370,370,27,27,0,1,0
2,373,373,30,30,0,1,0
19,394,394,2,2,0,1,0
9,420,420,21,15,6,2,1
14,437,437,125,95,30,3,2
4,446,446,9,3,6,2,1
18,446,446,27,27,0,1,0
16,459,459,165,36,129,4,3
8,461,461,111,15,96,4,3
7,465,465,15,15,0,1,0

5,159,159,9,9,0,1,0
0,199,199,8,1,7,2,1
10,204,204,37,37,0,1,0
2,207,207,43,4,39,4,3
8,227,227,59,59,0,1,0
1,268,268,7,7,0,1,0
9,276,276,10,3,7,2,1
11,283,283,19,19,0,1,0
4,300,300,2,2,0,1,0
12,308,308,15,1,14,4,3
13,333,333,35,20,15,4,3
6,382,382,130,94,36,4,3
7,395,395,45,45,0,1,0
3,418,418,52,52,0,1,0

6,104,104,5,5,0,1,0
7,110,110,9,4,5,2,1
9,123,123,9,3,6,2,1
10,138,138,2,2,0,1,0
13,173,173,2,2,0,1,0
1,174,174,29,29,0,1,0
14,242,242,4,4,0,1,0
15,269,269,112,81,31,2,1
12,279,279,13,4,9,2,1
2,288,288,1,1,0,1,0
3,289,289,2,2,0,1,0
4,351,351,36,8,28,3,2
0,364,364,39,39,0,1,0
11,375,375,90,45,45,4,3
5,440,440,1,1,0,1,0
8,486,486,137,23,114,4,3

14,107,107,21,1,20,2,1
8,132,132,59,13,46,3,2
4,134,134,1,1,0,1,0
2,139,139,9,9,0,1,0
5,142,142,6,6,0,1,0
12,156,156,46,46,0,1,0
1,162,162,5,5,0,1,0
13,170,170,5,1,4,2,1
3,223,223,21,21,0,1,0
11,245,245,15,15,0,1,0
6,250,250,4,4,0,1,0
7,264,264,14,2,12,3,2
10,457,457,44,24,20,3,2
0,463,463,22,22,0,1,0
15,470,470,10,7,3,2,1
9,483,483,54,54,0,1,0

7,114,114,6,6,0,1,0
12,166,166,14,14,0,1,0
13,168,168,12,12,0,1,0
3,182,182,38,38,0,1,0
0,216,216,7,3,4,2,1
15,260,260,36,36,0,1,0
5,298,298,37,37,0,1,0
6,333,333,1,1,0,1,0
2,335,335,41,10,31,2,1
14,351,351,24,24,0,1,0
8,375,375,16,4,12,2,1
4,399,399,22,8,14,3,2
11,426,426,44,38,6,2,1
16,433,433,112,4,108,4,3
9,439,439,26,26,0,1,0
1,473,473,48,48,0,1,0
10,491,491,43,10,33,4,3

19,105,105,7,3,4,2,1
13,113,113,12,2,10,3,2
20,145,145,44,44,0,1,0
4,191,191,11,11,0,1,0
16,198,198,42,42,0,1,0
22,232,232,12,1,11,3,2
9,271,271,30,30,0,1,0
14,273,273,2,2,0,1,0
1,284,284,5,5,0,1,0
8,291,291,38,38,0,1,0
12,313,313,1,1,0,1,0
11,315,315,10,2,8,2,1
10,323,323,10,4,6,2,1
5,325,325,21,15,6,3,2
15,358,358,27,11,16,2,1
18,368,368,10,6,4,2,1
21,368,368,38,38,0,1,0
7,391,391,7,3,4,2,1
3,414,414,3,3,0,1,0
6,415,415,2,2,0,1,0
17,428,428,25,4,21,2,1
2,437,437,18,7,11,2,1
0,452,452,42,42,0,1,0

11,106,106,6,1,5,2,1
12,113,113,45,45,0,1,0
4,120,120,3,3,0,1,0
5,131,131,11,1,10,2,1
9,170,170,4,4,0,1,0
3,175,175,29,3,26,2,1
2,210,210,1,1,0,1,0
14,255,255,12,4,8,3,2
10,256,256,15,15,0,1,0
17,299,299,4,4,0,1,0
13,326,326,33,15,18,2,1
6,354,354,78,78,0,1,0
15,434,434,69,3,66,3,2
7,444,444,6,6,0,1,0
1,452,452,30,30,0,1,0
8,455,455,34,17,17,2,1
0,475,475,32,32,0,1,0
16,485,485,23,12,11,2,1

11,150,150,3,3,0,1,0
8,169,169,24,6,18,3,2
6,173,173,14,1,13,2,1
9,178,178,19,19,0,1,0
1,179,179,5,5,0,1,0
7,195,195,4,4,0,1,0
10,218,218,80,53,27,4,3
4,250,250,23,23,0,1,0
0,266,266,98,5,93,4,3
2,339,339,80,66,14,2,1
12,360,360,28,28,0,1,0
5,441,441,12,12,0,1,0
3,476,476,24,5,19,3,2

5,126,126,11,11,0,1,0
0,128,128,3,3,0,1,0
11,134,134,14,4,10,3,2
4,208,208,35,35,0,1,0
7,239,239,20,16,4,2,1
8,267,267,76,63,13,2,1
1,387,387,18,6,12,3,2
2,459,459,135,40,95,3,2
10,462,462,59,38,21,4,3
6,472,472,49,23,26,4,3
3,497,497,134,21,113,4,3
9,497,497,12,1,11,2,1

4,129,129,7,1,6,3,2
13,131,131,33,33,0,1,0
11,192,192,35,15,20,2,1
0,208,208,23,23,0,1,0
14,240,240,2,2,0,1,0
3,246,246,41,41,0,1,0
9,296,296,3,3,0,1,0
1,314,314,16,5,11,2,1
16,321,321,40,40,0,1,0
8,326,326,69,69,0,1,0
2,334,334,10,4,6,2,1
10,373,373,2,2,0,1,0
6,380,380,20,20,0,1,0
7,385,385,36,30,6,2,1
5,429,429,9,9,0,1,0
12,429,429,83,22,61,3,2
15,448,448,21,11,10,2,1

2,101,101,11,11,0,1,0
4,102,102,2,2,0,1,0
0,103,103,1,1,0,1,0
12,147,147,47,6,41,3,2
5,186,186,4,4,0,1,0
10,191,191,12,12,0,1,0
14,194,194,16,16,0,1,0
13,204,204,26,26,0,1,0
17,224,224,8,4,4,2,1
1,240,240,27,27,0,1,0
3,242,242,7,7,0,1,0
16,285,285,37,11,26,3,2
15,286,286,35,9,26,2,1
11,295,295,1,1,0,1,0
7,304,304,24,24,0,1,0
6,346,346,25,14,11,2,1
9,427,427,7,7,0,1,0
8,465,465,127,10,117,4,3

7,108,108,8,3,5,2,1
2,124,124,17,17,0,1,0
0,141,141,17,17,0,1,0
5,170,170,13,5,8,2,1
3,195,195,12,12,0,1,0
8,209,209,61,61,0,1,0
4,210,210,51,32,19,2,1
11,261,261,8,8,0,1,0
13,277,277,9,4,5,2,1
1,363,363,13,1,12,2,1
10,378,378,24,24,0,1,0
12,432,432,137,60,77,4,3
6,462,462,59,28,31,4,3
9,463,463,1,1,0,1,0

11,104,104,22,11,11,2,1
10,114,114,7,4,3,2,1
1,126,126,3,3,0,1,0
7,154,154,26,10,16,3,2
2,163,163,11,11,0,1,0
5,208,208,10,10,0,1,0
9,235,235,22,6,16,2,1
0,298,298,16,16,0,1,0
14,308,308,18,18,0,1,0
6,316,316,21,6,15,4,3
12,316,316,18,18,0,1,0
15,343,343,84,64,20,2,1
8,376,376,64,1,63,4,3
4,430,430,20,20,0,1,0
3,462,462,72,72,0,1,0
13,472,472,42,3,39,4,3

18,137,137,1,1,0,1,0
14,142,142,6,6,0,1,0
10,153,153,2,2,0,1,0
4,202,202,9,9,0,1,0
2,229,229,13,6,7,2,1
11,234,234,7,7,0,1,0
12,234,234,16,16,0,1,0
13,240,240,1,1,0,1,0
5,245,245,13,13,0,1,0
9,298,298,20,20,0,1,0
16,300,300,12,6,6,3,2
15,322,322,36,36,0,1,0
3,331,331,37,4,33,4,3
8,331,331,6,2,4,2,1
17,356,356,98,73,25,2,1
21,363,363,13,13,0,1,0
19,384,384,129,60,69,4,3
7,391,391,44,14,30,2,1
1,432,432,37,19,18,3,2
0,457,457,43,43,0,1,0
6,480,480,2,2,0,1,0
20,487,487,3,3,0,1,0

3,116,116,14,14,0,1,0
11,160,160,37,37,0,1,0
5,168,168,51,26,25,2,1
8,192,192,33,13,20,3,2
7,209,209,1,1,0,1,0
6,245,245,10,10,0,1,0
9,272,272,3,3,0,1,0
1,290,290,30,6,24,2,1
2,299,299,154,154,0,1,0
0,348,348,7,7,0,1,0
10,361,361,19,1,18,2,1
4,416,416,17,17,0,1,0

2,134,134,4,1,3,2,1
12,151,151,3,3,0,1,0
4,165,165,24,24,0,1,0
1,240,240,40,26,14,3,2
0,376,376,120,52,68,3,2
3,428,428,10,2,8,3,2
11,429,429,223,143,80,3,2
10,441,441,12,12,0,1,0
9,445,445,22,22,0,1,0
6,461,461,69,25,44,3,2
5,480,480,56,16,40,2,1
8,493,493,10,3,7,2,1
7,497,497,12,2,10,3,2

10,102,102,1,1,0,1,0
3,181,181,20,20,0,1,0
4,239,239,29,11,18,4,3
1,240,240,76,45,31,3,2
0,247,247,9,9,0,1,0
7,260,260,1,1,0,1,0
6,287,287,39,4,35,2,1
8,288,288,49,49,0,1,0
11,322,322,41,41,0,1,0
5,359,359,11,11,0,1,0
12,370,370,2,2,0,1,0
9,397,397,146,90,56,4,3
2,466,466,87,87,0,1,0

9,104,104,2,2,0,1,0
1,126,126,1,1,0,1,0
8,173,173,9,1,8,3,2
15,219,219,17,7,10,3,2
16,239,239,25,25,0,1,0
11,259,259,97,97,0,1,0
7,291,291,1,1,0,1,0
5,314,314,31,31,0,1,0
3,327,327,109,96,13,2,1
12,335,335,19,19,0,1,0
0,346,346,9,1,8,3,2
13,368,368,20,20,0,1,0
6,444,444,24,24,0,1,0
10,455,455,57,10,47,2,1
4,456,456,92,92,0,1,0
14,459,459,8,1,7,2,1
2,469,469,4,4,0,1,0

6,108,108,12,12,0,1,0
14,109,109,29,29,0,1,0
4,115,115,2,2,0,1,0
13,135,135,24,24,0,1,0
5,136,136,14,14,0,1,0
11,148,148,1,1,0,1,0
7,151,151,8,8,0,1,0
0,177,177,14,14,0,1,0
17,182,182,8,2,6,2,1
8,241,241,4,1,3,2,1
18,262,262,15,9,6,2,1
1,285,285,8,8,0,1,0
10,303,303,49,49,0,1,0
15,377,377,19,19,0,1,0
3,386,386,23,9,14,3,2
16,452,452,98,48,50,4,3
12,467,467,5,2,3,2,1
2,468,468,53,53,0,1,0
9,473,473,24,3,21,4,3

14,100,100,7,1,6,3,2
4,106,106,9,3,6,2,1
6,133,133,9,1,8,2,1
7,167,167,1,1,0,1,0
3,176,176,14,14,0,1,0
2,182,182,3,3,0,1,0
18,187,187,6,1,5,2,1
0,196,196,9,9,0,1,0
13,212,212,37,37,0,1,0
11,215,215,9,9,0,1,0
15,241,241,44,7,37,2,1
12,287,287,54,54,0,1,0
1,290,290,10,10,0,1,0
9,369,369,42,42,0,1,0
10,397,397,55,55,0,1,0
17,427,427,9,9,0,1,0
8,437,437,58,58,0,1,0
5,444,444,17,1,16,3,2
16,457,457,68,40,28,2,1

8,214,214,18,10,8,2,1
7,229,229,55,46,9,4,3
12,244,244,1,1,0,1,0
0,283,283,20,15,5,2,1
10,292,292,74,74,0,1,0
2,308,308,2,2,0,1,0
5,346,346,79,67,12,2,1
11,355,355,73,37,36,3,2
6,360,360,1,1,0,1,0
9,450,450,8,2,6,2,1
1,481,481,149,29,120,4,3
3,487,487,50,1,49,3,2
4,497,497,42,42,0,1,0

14,135,135,1,1,0,1,0
6,153,153,21,8,13,2,1
11,154,154,2,2,0,1,0
13,210,210,24,5,19,2,1
10,222,222,58,58,0,1,0
9,224,224,8,8,0,1,0
8,248,248,28,28,0,1,0
1,253,253,5,5,0,1,0
7,266,266,5,2,3,2,1
4,286,286,3,3,0,1,0
2,332,332,29,6,23,2,1
5,398,398,38,18,20,2,1
15,405,405,99,21,78,4,3
12,411,411,55,15,40,3,2
0,422,422,14,14,0,1,0
3,473,473,136,136,0,1,0

13,103,103,17,12,5,2,1
5,118,118,4,4,0,1,0
9,125,125,1,1,0,1,0
20,138,138,1,1,0,1,0
10,162,162,8,8,0,1,0
18,166,166,5,1,4,2,1
6,187,187,1,1,0,1,0
8,215,215,5,5,0,1,0
17,228,228,52,52,0,1,0
7,316,316,53,2,51,4,3
11,316,316,10,10,0,1,0
4,327,327,13,13,0,1,0
3,352,352,20,11,9,4,3
14,370,370,25,8,17,4,3
1,373,373,6,6,0,1,0
0,415,415,5,5,0,1,0
12,421,421,38,16,22,2,1
19,439,439,102,102,0,1,0
16,457,457,5,5,0,1,0
15,464,464,113,84,29,2,1
2,481,481,49,21,28,2,1

10,149,149,3,3,0,1,0
7,175,175,38,35,3,2,1
8,225,225,19,19,0,1,0
1,254,254,3,3,0,1,0
2,257,257,53,3,50,2,1
4,261,261,43,17,26,3,2
11,288,288,26,26,0,1,0
3,298,298,47,11,36,4,3
9,375,375,42,42,0,1,0
13,397,397,103,103,0,1,0
5,399,399,1,1,0,1,0
0,410,410,104,86,18,4,3
12,438,438,15,12,3,2,1
6,447,447,2,2,0,1,0

1,164,164,5,5,0,1,0
6,178,178,20,8,12,3,2
14,180,180,9,5,4,2,1
0,185,185,36,36,0,1,0
13,206,206,3,3,0,1,0
8,210,210,40,2,38,3,2
11,329,329,66,20,46,2,1
5,359,359,15,15,0,1,0
10,370,370,82,16,66,3,2
9,373,373,39,13,26,3,2
12,373,373,12,12,0,1,0
2,375,375,28,28,0,1,0
7,430,430,73,73,0,1,0
3,468,468,67,67,0,1,0
4,495,495,17,17,0,1,0

0,105,105,5,5,0,1,0
7,129,129,15,15,0,1,0
11,137,137,27,3,24,2,1
1,153,153,41,27,14,2,1
15,158,158,12,1,11,3,2
2,173,173,5,5,0,1,0
4,213,213,11,11,0,1,0
12,233,233,40,40,0,1,0
17,240,240,25,25,0,1,0
5,265,265,4,4,0,1,0
3,282,282,23,23,0,1,0
16,312,312,12,6,6,2,1
13,320,320,56,56,0,1,0
10,344,344,29,15,14,2,1
8,353,353,5,5,0,1,0
6,397,397,12,2,10,3,2
9,459,459,29,14,15,2,1
14,477,477,30,13,17,2,1

4,159,159,31,31,0,1,0
1,179,179,6,6,0,1,0
0,192,192,51,5,46,3,2
7,219,219,70,4,66,3,2
5,222,222,1,1,0,1,0
3,270,270,67,67,0,1,0
8,304,304,31,31,0,1,0
9,327,327,22,14,8,3,2
2,331,331,18,18,0,1,0
10,364,364,17,17,0,1,0
11,374,374,11,1,10,3,2
12,402,402,19,7,12,4,3
6,439,439,87,87,0,1,0

14,172,172,6,3,3,2,1
6,191,191,16,12,4,2,1
1,217,217,56,10,46,3,2
8,219,219,5,2,3,2,1
13,240,240,24,24,0,1,0
2,245,245,4,4,0,1,0
16,246,246,49,1,48,4,3
5,283,283,5,5,0,1,0
12,299,299,13,13,0,1,0
10,353,353,7,4,3,2,1
7,370,370,43,43,0,1,0
11,377,377,73,73,0,1,0
0,380,380,21,21,0,1,0
3,391,391,21,5,16,3,2
9,399,399,40,40,0,1,0
15,465,465,103,57,46,2,1
4,491,491,38,38,0,1,0

3,118,118,14,2,12,4,3
10,173,173,11,11,0,1,0
13,179,179,3,3,0,1,0
9,185,185,17,6,11,2,1
2,197,197,10,10,0,1,0
16,216,216,20,5,15,4,3
1,250,250,5,1,4,2,1
7,265,265,1,1,0,1,0
18,266,266,79,58,21,2,1
11,294,294,3,3,0,1,0
20,300,300,70,14,56,3,2
14,316,316,18,5,13,3,2
4,317,317,18,18,0,1,0
19,321,321,8,8,0,1,0
15,325,325,20,20,0,1,0
8,342,342,80,80,0,1,0
0,362,362,8,8,0,1,0
12,395,395,5,5,0,1,0
5,406,406,5,5,0,1,0
17,448,448,20,2,18,2,1
6,459,459,41,41,0,1,0

3,114,114,17,2,15,2,1
4,126,126,12,6,6,2,1
8,142,142,46,46,0,1,0
6,154,154,1,1,0,1,0
14,160,160,8,1,7,2,1
0,207,207,16,4,12,3,2
7,260,260,19,3,16,2,1
13,264,264,52,27,25,2,1
12,302,302,10,10,0,1,0
2,335,335,11,1,10,4,3
11,357,357,26,26,0,1,0
9,430,430,52,52,0,1,0
10,437,437,9,9,0,1,0
5,446,446,142,102,40,4,3
1,476,476,23,10,13,2,1

6,100,100,7,4,3,2,1
14,194,194,14,2,12,3,2
9,195,195,8,8,0,1,0
2,205,205,6,3,3,2,1
1,236,236,3,3,0,1,0
10,254,254,18,18,0,1,0
16,275,275,53,53,0,1,0
8,286,286,1,1,0,1,0
13,311,311,7,2,5,2,1
7,357,357,136,64,72,3,2
12,370,370,55,30,25,2,1
5,402,402,14,4,10,3,2
15,417,417,96,42,54,4,3
4,423,423,49,49,0,1,0
11,457,457,35,9,26,2,1
0,486,486,30,21,9,4,3
3,496,496,26,14,12,3,2

4,106,106,3,3,0,1,0
12,110,110,2,2,0,1,0
16,144,144,29,19,10,3,2
18,217,217,36,36,0,1,0
1,225,225,34,4,30,4,3
7,248,248,14,4,10,3,2
6,259,259,2,2,0,1,0
9,275,275,3,3,0,1,0
14,275,275,2,2,0,1,0
15,283,283,71,71,0,1,0
3,289,289,40,40,0,1,0
17,296,296,34,34,0,1,0
2,308,308,55,41,14,2,1
13,339,339,18,18,0,1,0
10,409,409,15,15,0,1,0
11,437,437,2,2,0,1,0
5,459,459,11,1,10,3,2
0,466,466,27,27,0,1,0
8,484,484,52,32,20,3,2

7,128,128,7,7,0,1,0
10,141,141,24,20,4,2,1
2,145,145,32,25,7,2,1
12,147,147,3,3,0,1,0
9,172,172,22,22,0,1,0
11,193,193,6,6,0,1,0
5,195,195,17,2,15,2,1
8,216,216,31,5,26,2,1
13,244,244,23,14,9,2,1
1,247,247,41,41,0,1,0
0,304,304,47,25,22,2,1
4,309,309,4,4,0,1,0
14,326,326,75,75,0,1,0
6,341,341,29,5,24,3,2
3,400,400,8,8,0,1,0

2,110,110,1,1,0,1,0
8,132,132,7,7,0,1,0
10,132,132,15,15,0,1,0
12,138,138,30,20,10,3,2
1,153,153,26,12,14,3,2
3,171,171,8,2,6,2,1
13,259,259,48,48,0,1,0
0,293,293,27,27,0,1,0
4,333,333,41,41,0,1,0
9,377,377,46,29,17,2,1
11,405,405,38,28,10,3,2
6,422,422,48,48,0,1,0
14,430,430,14,8,6,2,1
5,460,460,72,72,0,1,0
7,460,460,41,13,28,3,2

8,100,100,10,10,0,1,0
7,109,109,36,23,13,2,1
2,117,117,1,1,0,1,0
0,122,122,3,3,0,1,0
9,167,167,5,5,0,1,0
12,207,207,30,30,0,1,0
4,212,212,13,13,0,1,0
1,279,279,142,57,85,4,3
13,287,287,30,30,0,1,0
6,372,372,49,49,0,1,0
11,397,397,41,41,0,1,0
5,444,444,5,1,4,2,1
3,468,468,26,26,0,1,0
10,485,485,4,4,0,1,0

12,115,115,6,6,0,1,0
13,123,123,14,14,0,1,0
1,126,126,3,3,0,1,0
9,132,132,37,4,33,4,3
0,221,221,2,2,0,1,0
7,259,259,3,3,0,1,0
6,268,268,25,6,19,3,2
17,278,278,43,43,0,1,0
2,283,283,6,6,0,1,0
15,339,339,29,17,12,3,2
4,340,340,28,10,18,4,3
11,374,374,24,24,0,1,0
16,383,383,116,85,31,2,1
5,399,399,27,27,0,1,0
10,430,430,18,18,0,1,0
8,442,442,71,71,0,1,0
3,473,473,4,1,3,2,1
14,494,494,18,18,0,1,0

6,104,104,6,6,0,1,0
4,130,130,56,14,42,2,1
11,131,131,2,2,0,1,0
1,146,146,17,10,7,2,1
2,191,191,14,8,6,3,2
3,210,210,21,2,19,2,1
8,290,290,12,7,5,2,1
9,349,349,33,33,0,1,0
10,356,356,102,102,0,1,0
5,383,383,12,8,4,2,1
0,384,384,19,2,17,2,1
12,397,397,95,95,0,1,0
7,460,460,37,37,0,1,0

6,165,165,4,4,0,1,0
11,201,201,12,5,7,2,1
2,230,230,8,8,0,1,0
3,242,242,132,129,3,2,1
10,265,265,4,1,3,2,1
1,335,335,59,53,6,3,2
8,394,394,115,70,45,4,3
4,410,410,2,2,0,1,0
9,423,423,74,74,0,1,0
5,437,437,38,38,0,1,0
7,474,474,77,39,38,4,3
0,494,494,20,13,7,2,1

5,162,162,24,24,0,1,0
9,173,173,15,8,7,2,1
8,187,187,65,2,63,4,3
2,320,320,78,32,46,3,2
11,350,350,7,7,0,1,0
0,371,371,5,5,0,1,0
6,400,400,12,6,6,3,2
1,426,426,56,56,0,1,0
3,440,440,88,60,28,2,1
4,453,453,96,53,43,2,1
10,458,458,20,12,8,3,2
7,489,489,66,54,12,4,3

4,107,107,10,1,9,2,1
2,144,144,17,17,0,1,0
10,158,158,2,2,0,1,0
1,171,171,10,1,9,2,1
3,204,204,19,19,0,1,0
14,221,221,36,36,0,1,0
12,283,283,8,3,5,2,1
9,305,305,55,47,8,2,1
6,309,309,16,16,0,1,0
8,315,315,1,1,0,1,0
7,342,342,83,83,0,1,0
13,381,381,9,9,0,1,0
5,417,417,52,52,0,1,0
0,494,494,9,9,0,1,0
11,500,500,200,113,87,4,3

1,126,126,52,52,0,1,0
2,191,191,1,1,0,1,0
5,203,203,53,53,0,1,0
10,209,209,30,30,0,1,0
11,285,285,12,12,0,1,0
4,352,352,17,11,6,2,1
8,403,403,40,1,39,2,1
6,406,406,80,20,60,3,2
7,406,406,80,80,0,1,0
12,423,423,42,42,0,1,0
9,429,429,13,13,0,1,0
3,441,441,11,11,0,1,0
0,477,477,24,24,0,1,0

3,120,120,13,13,0,1,0
12,135,135,1,1,0,1,0
9,166,166,5,5,0,1,0
7,175,175,5,2,3,2,1
16,200,200,23,23,0,1,0
2,248,248,29,12,17,4,3
6,262,262,1,1,0,1,0
4,262,262,47,18,29,2,1
5,263,263,43,43,0,1,0
11,300,300,65,30,35,2,1
15,327,327,80,80,0,1,0
14,331,331,14,6,8,2,1
0,358,358,1,1,0,1,0
8,407,407,23,2,21,2,1
1,478,478,53,53,0,1,0
10,483,483,15,15,0,1,0
13,497,497,75,11,64,4,3

3,147,147,28,16,12,3,2
10,154,154,18,18,0,1,0
5,244,244,2,2,0,1,0
4,272,272,33,33,0,1,0
8,277,277,61,61,0,1,0
2,299,299,42,17,25,2,1
0,333,333,139,126,13,4,3
9,382,382,69,9,60,4,3
6,443,443,53,53,0,1,0
7,468,468,19,19,0,1,0
1,499,499,28,21,7,2,1

9,133,133,1,1,0,1,0
11,155,155,44,23,21,2,1
3,168,168,23,23,0,1,0
7,212,212,15,12,3,2,1
2,237,237,3,3,0,1,0
4,244,244,69,69,0,1,0
10,245,245,66,66,0,1,0
0,251,251,17,17,0,1,0
5,258,258,3,3,0,1,0
6,284,284,13,13,0,1,0
8,314,314,16,16,0,1,0
1,354,354,62,4,58,3,2
14,381,381,28,28,0,1,0
12,488,488,52,52,0,1,0
13,497,497,10,4,6,3,2

8,101,101,11,2,9,4,3
10,208,208,27,27,0,1,0
15,208,208,13,13,0,1,0
6,210,210,32,32,0,1,0
4,234,234,1,1,0,1,0
0,275,275,19,19,0,1,0
3,282,282,21,21,0,1,0
12,316,316,64,53,11,2,1
14,330,330,23,23,0,1,0
13,341,341,12,6,6,2,1
9,377,377,7,2,5,2,1
16,383,383,91,91,0,1,0
18,392,392,12,12,0,1,0
7,436,436,46,18,28,2,1
17,459,459,77,42,35,2,1
2,479,479,4,4,0,1,0
5,485,485,13,13,0,1,0
11,497,497,13,13,0,1,0
1,498,498,38,10,28,3,2

1,173,173,21,21,0,1,0
9,185,185,7,7,0,1,0
8,207,207,6,6,0,1,0
6,222,222,25,11,14,3,2
5,328,328,14,4,10,2,1
4,349,349,26,15,11,2,1
2,385,385,77,22,55,3,2
0,402,402,48,35,13,2,1
3,405,405,146,56,90,3,2
10,479,479,105,13,92,3,2
7,481,481,142,111,31,2,1

5,139,139,20,20,0,1,0
4,142,142,28,28,0,1,0
8,255,255,27,6,21,4,3
0,256,256,19,5,14,3,2
11,264,264,8,2,6,2,1
2,273,273,31,17,14,3,2
6,279,279,2,2,0,1,0
9,286,286,54,7,47,2,1
1,301,301,115,115,0,1,0
10,409,409,135,85,50,3,2
7,454,454,3,3,0,1,0
3,455,455,17,7,10,3,2

6,105,105,17,3,14,3,2
0,118,118,5,5,0,1,0
12,167,167,8,8,0,1,0
13,172,172,31,11,20,2,1
11,201,201,67,25,42,4,3
14,238,238,24,24,0,1,0
7,247,247,11,11,0,1,0
3,263,263,2,2,0,1,0
9,270,270,15,12,3,2,1
1,304,304,52,52,0,1,0
8,382,382,35,35,0,1,0
15,396,396,31,31,0,1,0
2,401,401,88,28,60,3,2
5,451,451,12,2,10,3,2
10,468,468,11,11,0,1,0
4,497,497,18,18,0,1,0

3,151,151,15,15,0,1,0
6,224,224,52,7,45,2,1
8,225,225,3,3,0,1,0
13,257,257,3,3,0,1,0
12,258,258,14,14,0,1,0
5,272,272,19,9,10,2,1
9,308,308,66,36,30,4,3
1,344,344,12,9,3,2,1
11,367,367,67,20,47,2,1
0,374,374,41,32,9,4,3
10,383,383,7,7,0,1,0
7,394,394,126,126,0,1,0
2,419,419,18,18,0,1,0
4,457,457,98,78,20,2,1

12,121,121,3,3,0,1,0
9,152,152,9,9,0,1,0
8,157,157,38,1,37,2,1
4,168,168,38,12,26,3,2
14,177,177,9,3,6,3,2
5,250,250,11,4,7,2,1
7,262,262,24,15,9,4,3
3,269,269,41,41,0,1,0
1,292,292,1,1,0,1,0
13,322,322,66,66,0,1,0
0,405,405,21,10,11,2,1
6,426,426,33,17,16,3,2
10,469,469,108,48,60,4,3
2,475,475,74,74,0,1,0
11,496,496,1,1,0,1,0

8,101,101,5,5,0,1,0
7,120,120,7,7,0,1,0
5,127,127,8,5,3,2,1
10,134,134,11,11,0,1,0
15,138,138,56,43,13,2,1
19,147,147,6,6,0,1,0
11,189,189,10,10,0,1,0
2,211,211,23,3,20,3,2
14,256,256,9,3,6,2,1
13,305,305,27,20,7,2,1
0,345,345,3,3,0,1,0
4,360,360,1,1,0,1,0
9,382,382,6,6,0,1,0
12,384,384,10,7,3,2,1
17,418,418,21,21,0,1,0
1,433,433,60,28,32,2,1
16,453,453,22,2,20,2,1
6,465,465,46,46,0,1,0
18,468,468,69,14,55,3,2
3,470,470,45,37,8,3,2

15,108,108,2,2,0,1,0
4,127,127,4,1,3,2,1
1,184,184,4,4,0,1,0
5,230,230,2,2,0,1,0
14,241,241,20,20,0,1,0
16,251,251,25,25,0,1,0
13,251,251,59,14,45,4,3
3,255,255,35,35,0,1,0
8,274,274,10,10,0,1,0
9,293,293,1,1,0,1,0
2,307,307,40,10,30,2,1
17,325,325,45,2,43,2,1
7,353,353,45,45,0,1,0
12,364,364,28,28,0,1,0
0,401,401,11,5,6,3,2
6,411,411,81,18,63,4,3
10,415,415,33,33,0,1,0
11,495,495,82,64,18,2,1

3,119,119,15,10,5,2,1
0,123,123,18,8,10,2,1
18,161,161,9,9,0,1,0
2,187,187,41,33,8,3,2
12,205,205,12,12,0,1,0
1,235,235,20,20,0,1,0
11,285,285,7,7,0,1,0
10,311,311,19,19,0,1,0
9,327,327,1,1,0,1,0
8,351,351,4,4,0,1,0
6,376,376,1,1,0,1,0
13,419,419,122,89,33,3,2
17,453,453,49,49,0,1,0
5,454,454,10,7,3,2,1
7,458,458,45,13,32,3,2
4,461,461,1,1,0,1,0
15,472,472,32,32,0,1,0
14,488,488,36,25,11,2,1
16,497,497,78,61,17,2,1

11,117,117,7,1,6,3,2
3,121,121,15,9,6,3,2
8,145,145,3,3,0,1,0
12,153,153,50,40,10,2,1
6,176,176,4,4,0,1,0
10,203,203,56,56,0,1,0
0,207,207,46,46,0,1,0
5,211,211,11,11,0,1,0
2,233,233,43,43,0,1,0
13,319,319,2,2,0,1,0
7,320,320,11,2,9,4,3
4,386,386,43,13,30,2,1
14,395,395,38,38,0,1,0
1,452,452,22,14,8,3,2
9,482,482,12,12,0,1,0

17,117,117,6,3,3,2,1
12,124,124,1,1,0,1,0
7,223,223,13,9,4,2,1
3,256,256,3,3,0,1,0
1,263,263,30,30,0,1,0
11,288,288,1,1,0,1,0
2,315,315,7,7,0,1,0
6,324,324,16,16,0,1,0
4,336,336,47,12,35,2,1
5,341,341,75,75,0,1,0
13,358,358,19,19,0,1,0
10,361,361,8,3,5,2,1
0,413,413,6,6,0,1,0
14,428,428,104,104,0,1,0
16,448,448,154,28,126,4,3
9,465,465,54,54,0,1,0
8,468,468,15,5,10,3,2
15,499,499,57,57,0,1,0

10,104,104,5,5,0,1,0
8,117,117,1,1,0,1,0
1,126,126,12,3,9,2,1
4,153,153,12,12,0,1,0
11,242,242,36,36,0,1,0
2,243,243,3,3,0,1,0
9,275,275,4,4,0,1,0
6,340,340,181,37,144,4,3
7,437,437,17,3,14,2,1
12,437,437,11,11,0,1,0
5,462,462,47,17,30,4,3
0,463,463,223,130,93,4,3
3,494,494,16,16,0,1,0

13,113,113,10,10,0,1,0
0,119,119,18,14,4,2,1
8,128,128,10,2,8,3,2
11,162,162,5,5,0,1,0
6,175,175,14,5,9,4,3
12,176,176,6,6,0,1,0
5,248,248,59,20,39,3,2
10,258,258,32,17,15,2,1
9,312,312,96,96,0,1,0
1,316,316,2,2,0,1,0
4,411,411,86,86,0,1,0
7,416,416,4,4,0,1,0
14,420,420,63,63,0,1,0
3,474,474,49,43,6,2,1
2,489,489,2,2,0,1,0

3,103,103,2,2,0,1,0
15,114,114,7,7,0,1,0
5,133,133,5,5,0,1,0
12,140,140,67,22,45,2,1
18,144,144,5,5,0,1,0
14,166,166,2,2,0,1,0
6,202,202,2,2,0,1,0
9,247,247,41,41,0,1,0
16,258,258,54,16,38,4,3
8,264,264,7,4,3,2,1
7,305,305,7,3,4,2,1
13,321,321,4,4,0,1,0
2,347,347,24,24,0,1,0
17,360,360,1,1,0,1,0
1,378,378,42,14,28,3,2
0,392,392,12,12,0,1,0
11,395,395,87,26,61,4,3
4,446,446,27,12,15,2,1
10,495,495,14,14,0,1,0

3,124,124,7,1,6,3,2
2,133,133,11,11,0,1,0
5,159,159,3,3,0,1,0
8,296,296,36,36,0,1,0
7,377,377,65,65,0,1,0
1,429,429,276,276,0,1,0
4,442,442,29,29,0,1,0
0,451,451,71,8,63,3,2
6,471,471,142,69,73,4,3

18,105,105,12,4,8,3,2
7,131,131,8,8,0,1,0
16,133,133,6,2,4,2,1
1,155,155,1,1,0,1,0
14,190,190,25,9,16,3,2
15,192,192,29,17,12,3,2
13,243,243,13,6,7,2,1
8,291,291,11,4,7,2,1
2,311,311,27,11,16,2,1
5,311,311,3,3,0,1,0
9,338,338,11,5,6,3,2
11,359,359,33,1,32,2,1
12,368,368,99,57,42,4,3
3,398,398,43,43,0,1,0
6,415,415,24,24,0,1,0
4,416,416,12,12,0,1,0
10,433,433,49,49,0,1,0
0,442,442,74,36,38,3,2
17,467,467,27,27,0,1,0

2,146,146,13,2,11,3,2
17,147,147,8,3,5,2,1
18,150,150,5,2,3,2,1
12,173,173,1,1,0,1,0
22,173,173,23,6,17,2,1
19,181,181,7,3,4,2,1
8,196,196,20,20,0,1,0
11,209,209,6,3,3,2,1
21,225,225,57,39,18,4,3
3,225,225,10,10,0,1,0
14,236,236,1,1,0,1,0
4,294,294,22,22,0,1,0
5,313,313,1,1,0,1,0
10,326,326,4,4,0,1,0
13,342,342,3,3,0,1,0
7,351,351,21,21,0,1,0
1,360,360,21,21,0,1,0
0,369,369,46,27,19,2,1
9,378,378,29,29,0,1,0
6,396,396,33,33,0,1,0
20,403,403,13,13,0,1,0
16,423,423,117,30,87,4,3
15,483,483,12,12,0,1,0

5,115,115,1,1,0,1,0
12,158,158,25,22,3,2,1
1,214,214,12,12,0,1,0
9,219,219,1,1,0,1,0
7,232,232,23,11,12,4,3
17,234,234,4,4,0,1,0
6,244,244,9,3,6,3,2
11,267,267,15,12,3,2,1
8,269,269,13,10,3,2,1
16,273,273,11,11,0,1,0
13,298,298,25,3,22,3,2
15,301,301,134,134,0,1,0
2,376,376,9,9,0,1,0
18,380,380,10,10,0,1,0
10,381,381,30,30,0,1,0
3,428,428,106,98,8,3,2
0,443,443,9,9,0,1,0
14,468,468,21,21,0,1,0
4,474,474,58,58,0,1,0

20,100,100,13,13,0,1,0
15,131,131,37,5,32,3,2
9,147,147,1,1,0,1,0
13,156,156,47,36,11,2,1
11,164,164,5,2,3,2,1
19,193,193,6,6,0,1,0
8,211,211,1,1,0,1,0
6,240,240,5,5,0,1,0
10,251,251,5,5,0,1,0
1,253,253,20,11,9,2,1
4,293,293,29,29,0,1,0
18,323,323,25,25,0,1,0
3,327,327,3,3,0,1,0
7,425,425,37,31,6,2,1
12,434,434,2,2,0,1,0
14,437,437,47,47,0,1,0
16,440,440,28,28,0,1,0
17,450,450,54,54,0,1,0
0,461,461,16,8,8,2,1
2,473,473,2,2,0,1,0
5,481,481,48,48,0,1,0

0,108,108,19,11,8,3,2
7,110,110,18,18,0,1,0
1,114,114,5,5,0,1,0
12,127,127,5,2,3,2,1
3,187,187,3,3,0,1,0
6,188,188,24,12,12,4,3
13,266,266,42,42,0,1,0
10,267,267,14,14,0,1,0
4,407,407,79,37,42,2,1
5,407,407,99,58,41,2,1
11,426,426,5,5,0,1,0
8,445,445,107,59,48,3,2
9,480,480,70,54,16,3,2
2,490,490,1,1,0,1,0

2,117,117,4,4,0,1,0
1,121,121,1,1,0,1,0
0,141,141,43,13,30,3,2
11,155,155,13,13,0,1,0
7,192,192,54,54,0,1,0
8,205,205,30,30,0,1,0
6,270,270,18,10,8,3,2
5,288,288,39,39,0,1,0
10,290,290,10,7,3,2,1
13,296,296,26,6,20,2,1
12,330,330,2,2,0,1,0
4,347,347,41,23,18,2,1
9,404,404,70,70,0,1,0
3,487,487,66,66,0,1,0

3,101,101,1,1,0,1,0
17,142,142,5,5,0,1,0
7,154,154,24,1,23,3,2
15,168,168,12,12,0,1,0
8,174,174,2,2,0,1,0
1,177,177,30,12,18,3,2
14,198,198,46,8,38,3,2
4,213,213,18,18,0,1,0
16,275,275,8,8,0,1,0
20,291,291,75,43,32,2,1
0,295,295,7,3,4,2,1
2,299,299,23,5,18,2,1
19,314,314,25,11,14,3,2
13,320,320,1,1,0,1,0
5,345,345,6,6,0,1,0
18,347,347,38,14,24,2,1
9,409,409,7,2,5,2,1
6,416,416,1,1,0,1,0
12,452,452,9,9,0,1,0
11,460,460,74,74,0,1,0
10,479,479,24,24,0,1,0

11,119,119,29,3,26,2,1
2,195,195,13,6,7,2,1
8,206,206,12,3,9,2,1
12,233,233,19,19,0,1,0
6,277,277,11,11,0,1,0
3,282,282,66,18,48,3,2
1,306,306,10,3,7,2,1
10,323,323,34,3,31,2,1
7,345,345,56,35,21,4,3
9,357,357,44,44,0,1,0
5,396,396,19,19,0,1,0
4,419,419,112,19,93,4,3
0,420,420,64,64,0,1,0

11,103,103,33,8,25,4,3
6,119,119,7,2,5,2,1
5,144,144,6,6,0,1,0
7,157,157,43,21,22,2,1
3,227,227,62,24,38,2,1
8,303,303,8,8,0,1,0
10,324,324,7,7,0,1,0
2,402,402,21,16,5,2,1
1,419,419,21,21,0,1,0
0,428,428,8,3,5,2,1
4,444,444,181,175,6,2,1
9,486,486,40,9,31,4,3

3,119,119,9,9,0,1,0
7,153,153,17,17,0,1,0
9,182,182,10,10,0,1,0
4,208,208,6,6,0,1,0
15,213,213,1,1,0,1,0
11,244,244,42,42,0,1,0
1,316,316,26,26,0,1,0
12,324,324,24,14,10,3,2
8,329,329,12,2,10,3,2
13,362,362,120,120,0,1,0
5,373,373,43,27,16,3,2
0,398,398,73,73,0,1,0
6,398,398,51,18,33,2,1
10,461,461,45,45,0,1,0
14,480,480,37,37,0,1,0
2,495,495,20,4,16,3,2

6,101,101,1,1,0,1,0
9,114,114,1,1,0,1,0
12,116,116,2,2,0,1,0
16,147,147,9,4,5,2,1
5,154,154,7,7,0,1,0
4,204,204,1,1,0,1,0
0,216,216,8,2,6,3,2
11,219,219,8,8,0,1,0
8,234,234,6,6,0,1,0
17,267,267,4,1,3,2,1
1,308,308,101,81,20,3,2
14,359,359,201,201,0,1,0
2,401,401,7,3,4,2,1
13,407,407,12,2,10,3,2
3,427,427,1,1,0,1,0
7,439,439,44,44,0,1,0
10,462,462,102,102,0,1,0
15,473,473,41,41,0,1,0

3,110,110,10,10,0,1,0
5,167,167,4,4,0,1,0
20,181,181,12,2,10,3,2
6,196,196,18,15,3,2,1
12,218,218,10,10,0,1,0
8,242,242,10,4,6,3,2
2,251,251,11,5,6,2,1
7,260,260,14,14,0,1,0
4,288,288,8,8,0,1,0
17,298,298,53,41,12,2,1
10,309,309,3,3,0,1,0
16,332,332,13,13,0,1,0
14,333,333,23,23,0,1,0
15,352,352,47,13,34,3,2
13,355,355,8,1,7,2,1
19,430,430,84,58,26,3,2
11,447,447,73,25,48,4,3
9,462,462,23,23,0,1,0
18,469,469,61,61,0,1,0
1,470,470,62,62,0,1,0
0,490,490,3,3,0,1,0

12,115,115,19,8,11,4,3
5,129,129,4,1,3,2,1
14,129,129,9,9,0,1,0
6,148,148,1,1,0,1,0
9,174,174,23,6,17,2,1
3,210,210,32,17,15,4,3
4,211,211,23,15,8,3,2
15,254,254,27,27,0,1,0
17,264,264,82,82,0,1,0
8,347,347,5,2,3,2,1
1,382,382,9,1,8,3,2
10,421,421,65,45,20,2,1
0,442,442,68,68,0,1,0
13,442,442,8,8,0,1,0
2,445,445,1,1,0,1,0
11,445,445,57,24,33,4,3
16,445,445,5,5,0,1,0
7,476,476,10,10,0,1,0

9,144,144,24,9,15,4,3
0,174,174,15,15,0,1,0
11,267,267,23,2,21,4,3
3,289,289,56,5,51,4,3
5,308,308,91,74,17,2,1
6,366,366,55,27,28,2,1
1,411,411,87,87,0,1,0
8,429,429,7,1,6,3,2
4,460,460,1,1,0,1,0
12,467,467,62,62,0,1,0
2,477,477,6,6,0,1,0
7,483,483,15,15,0,1,0
10,491,491,112,112,0,1,0

3,190,190,24,2,22,2,1
1,229,229,89,89,0,1,0
11,238,238,17,5,12,3,2
0,259,259,59,59,0,1,0
12,318,318,16,16,0,1,0
5,337,337,10,10,0,1,0
7,344,344,120,36,84,3,2
6,351,351,20,8,12,4,3
4,354,354,9,1,8,2,1
8,368,368,45,20,25,2,1
2,435,435,1,1,0,1,0
10,441,441,48,48,0,1,0
9,492,492,25,25,0,1,0

2,154,154,11,1,10,3,2
6,173,173,1,1,0,1,0
9,185,185,8,2,6,3,2
17,187,187,2,2,0,1,0
18,206,206,2,2,0,1,0
3,212,212,16,16,0,1,0
8,229,229,1,1,0,1,0
15,241,241,83,54,29,4,3
14,245,245,15,15,0,1,0
4,251,251,13,3,10,3,2
16,277,277,22,22,0,1,0
10,327,327,27,27,0,1,0
0,340,340,11,1,10,3,2
12,351,351,45,45,0,1,0
13,388,388,71,49,22,2,1
11,397,397,4,4,0,1,0
7,450,450,119,119,0,1,0
1,484,484,12,5,7,2,1
5,496,496,67,1,66,4,3

11,119,119,1,1,0,1,0
13,127,127,2,2,0,1,0
3,149,149,14,2,12,4,3
7,155,155,2,2,0,1,0
0,160,160,3,3,0,1,0
4,164,164,14,14,0,1,0
16,173,173,18,18,0,1,0
18,226,226,75,45,30,3,2
5,239,239,1,1,0,1,0
17,242,242,40,25,15,3,2
8,245,245,39,2,37,2,1
9,283,283,27,27,0,1,0
10,287,287,13,13,0,1,0
19,362,362,17,17,0,1,0
14,365,365,28,28,0,1,0
12,380,380,47,47,0,1,0
2,429,429,18,2,16,3,2
1,450,450,41,41,0,1,0
20,471,471,7,7,0,1,0
6,495,495,3,3,0,1,0
15,496,496,37,37,0,1,0

12,116,116,1,1,0,1,0
10,143,143,23,8,15,4,3
11,158,158,19,19,0,1,0
1,171,171,10,10,0,1,0
8,207,207,10,7,3,2,1
0,237,237,3,3,0,1,0
6,243,243,20,4,16,3,2
16,271,271,4,4,0,1,0
17,281,281,88,34,54,3,2
3,338,338,37,37,0,1,0
2,349,349,33,33,0,1,0
5,359,359,20,20,0,1,0
13,367,367,63,63,0,1,0
14,411,411,37,22,15,4,3
4,416,416,26,26,0,1,0
9,470,470,45,45,0,1,0
15,490,490,46,28,18,2,1
7,497,497,13,13,0,1,0

6,107,107,22,13,9,4,3
10,121,121,5,5,0,1,0
9,137,137,7,7,0,1,0
5,167,167,3,3,0,1,0
1,220,220,4,1,3,2,1
8,224,224,18,12,6,2,1
7,244,244,17,8,9,4,3
4,318,318,109,104,5,2,1
3,320,320,186,168,18,4,3
0,354,354,61,23,38,2,1
2,398,398,12,4,8,3,2

11,112,112,4,4,0,1,0
13,131,131,11,1,10,2,1
9,172,172,32,22,10,3,2
18,180,180,40,40,0,1,0
3,181,181,2,2,0,1,0
5,182,182,2,2,0,1,0
15,185,185,16,2,14,3,2
8,186,186,7,7,0,1,0
6,240,240,5,5,0,1,0
1,273,273,14,14,0,1,0
12,332,332,12,12,0,1,0
17,332,332,28,8,20,2,1
16,343,343,12,6,6,2,1
4,357,357,21,21,0,1,0
10,390,390,1,1,0,1,0
19,406,406,70,29,41,2,1
14,407,407,52,18,34,3,2
2,416,416,15,15,0,1,0
0,438,438,13,1,12,2,1
7,467,467,133,133,0,1,0

2,118,118,1,1,0,1,0
16,147,147,18,9,9,3,2
5,162,162,2,2,0,1,0
12,167,167,2,2,0,1,0
15,243,243,34,20,14,2,1
1,255,255,67,60,7,2,1
7,258,258,7,7,0,1,0
13,262,262,7,1,6,3,2
4,270,270,57,57,0,1,0
9,322,322,30,30,0,1,0
11,370,370,30,14,16,3,2
10,378,378,61,61,0,1,0
14,385,385,105,6,99,4,3
6,389,389,9,9,0,1,0
8,424,424,39,1,38,2,1
0,492,492,30,30,0,1,0
3,494,494,5,2,3,2,1

11,106,106,8,8,0,1,0
5,139,139,12,1,11,2,1
8,181,181,5,5,0,1,0
7,215,215,28,28,0,1,0
3,256,256,56,56,0,1,0
6,279,279,9,9,0,1,0
12,281,281,12,4,8,2,1
9,337,337,11,3,8,3,2
13,347,347,92,92,0,1,0
2,399,399,34,34,0,1,0
0,405,405,135,135,0,1,0
4,406,406,1,1,0,1,0
1,459,459,20,3,17,4,3
10,498,498,121,121,0,1,0

15,145,145,12,3,9,2,1
14,287,287,61,5,56,3,2
13,304,304,24,24,0,1,0
5,308,308,15,3,12,2,1
11,310,310,36,17,19,2,1
0,327,327,13,1,12,4,3
7,395,395,25,25,0,1,0
8,396,396,13,13,0,1,0
16,414,414,55,55,0,1,0
12,419,419,17,12,5,2,1
9,421,421,4,4,0,1,0
4,431,431,1,1,0,1,0
2,446,446,54,54,0,1,0
6,457,457,28,28,0,1,0
3,481,481,96,96,0,1,0
10,487,487,71,53,18,3,2
1,500,500,112,34,78,4,3

5,175,175,4,1,3,2,1
16,190,190,16,16,0,1,0
11,245,245,41,41,0,1,0
7,279,279,43,1,42,4,3
14,322,322,2,2,0,1,0
6,331,331,4,4,0,1,0
13,346,346,29,29,0,1,0
17,393,393,56,56,0,1,0
10,403,403,14,5,9,4,3
8,407,407,64,2,62,4,3
9,436,436,3,3,0,1,0
4,452,452,9,9,0,1,0
2,459,459,8,8,0,1,0
3,472,472,20,20,0,1,0
1,478,478,158,41,117,4,3
0,479,479,1,1,0,1,0
15,491,491,15,15,0,1,0
12,497,497,148,103,45,2,1

10,109,109,3,3,0,1,0
1,110,110,8,2,6,2,1
12,120,120,22,7,15,2,1
3,133,133,3,3,0,1,0
7,137,137,27,27,0,1,0
11,177,177,1,1,0,1,0
0,218,218,46,31,15,2,1
14,266,266,41,41,0,1,0
9,271,271,58,21,37,3,2
4,359,359,1,1,0,1,0
15,363,363,36,29,7,2,1
5,384,384,51,30,21,2,1
6,406,406,23,23,0,1,0
13,414,414,53,11,42,3,2
8,465,465,40,19,21,4,3
2,468,468,9,9,0,1,0

8,110,110,1,1,0,1,0
20,138,138,45,21,24,4,3
2,163,163,6,6,0,1,0
17,177,177,11,11,0,1,0
9,186,186,5,2,3,2,1
10,200,200,5,5,0,1,0
19,221,221,12,1,11,2,1
3,250,250,3,3,0,1,0
16,260,260,9,9,0,1,0
14,261,261,9,4,5,2,1
13,279,279,6,6,0,1,0
0,280,280,3,3,0,1,0
11,288,288,6,6,0,1,0
7,328,328,46,46,0,1,0
6,333,333,55,51,4,2,1
21,390,390,21,21,0,1,0
18,442,442,53,3,50,2,1
12,444,444,11,4,7,2,1
4,461,461,36,36,0,1,0
15,476,476,75,24,51,3,2
1,479,479,67,60,7,2,1
5,480,480,27,27,0,1,0

10,146,146,8,1,7,2,1
4,163,163,8,8,0,1,0
2,164,164,18,18,0,1,0
3,191,191,15,15,0,1,0
8,191,191,2,2,0,1,0
13,216,216,62,1,61,4,3
11,223,223,15,15,0,1,0
1,252,252,42,32,10,2,1
7,262,262,6,6,0,1,0
6,318,318,15,15,0,1,0
0,345,345,11,11,0,1,0
12,347,347,25,13,12,3,2
5,365,365,108,108,0,1,0
9,380,380,102,102,0,1,0
14,423,423,25,25,0,1,0

18,103,103,14,4,10,3,2
10,114,114,10,10,0,1,0
6,120,120,3,3,0,1,0
12,136,136,20,5,15,2,1
3,144,144,2,2,0,1,0
8,179,179,4,4,0,1,0
15,179,179,15,9,6,2,1
13,190,190,4,4,0,1,0
5,212,212,8,3,5,2,1
1,230,230,2,2,0,1,0
14,269,269,56,5,51,4,3
17,274,274,13,10,3,2,1
11,303,303,54,54,0,1,0
4,337,337,3,3,0,1,0
2,375,375,24,18,6,3,2
16,383,383,21,21,0,1,0
9,405,405,4,1,3,2,1
0,415,415,42,42,0,1,0
19,421,421,44,11,33,2,1
20,440,440,81,81,0,1,0
7,479,479,38,38,0,1,0

7,134,134,19,19,0,1,0
8,139,139,42,24,18,4,3
2,159,159,26,8,18,3,2
4,172,172,16,5,11,2,1
5,258,258,13,13,0,1,0
11,262,262,1,1,0,1,0
6,280,280,16,6,10,2,1
3,300,300,18,13,5,2,1
9,301,301,10,10,0,1,0
13,310,310,41,41,0,1,0
0,318,318,12,12,0,1,0
12,321,321,26,2,24,3,2
10,328,328,60,60,0,1,0
1,402,402,79,79,0,1,0
14,408,408,33,6,27,2,1

0,138,138,16,16,0,1,0
13,164,164,2,2,0,1,0
7,227,227,18,18,0,1,0
14,235,235,5,5,0,1,0
12,266,266,45,15,30,4,3
5,269,269,25,7,18,3,2
11,273,273,71,71,0,1,0
3,279,279,2,2,0,1,0
4,289,289,22,4,18,2,1
2,303,303,117,117,0,1,0
1,328,328,7,7,0,1,0
8,334,334,19,19,0,1,0
10,358,358,88,88,0,1,0
6,394,394,10,6,4,2,1
9,431,431,20,12,8,2,1

0,130,130,8,8,0,1,0
11,137,137,2,2,0,1,0
14,148,148,5,2,3,2,1
4,179,179,44,24,20,2,1
7,240,240,30,3,27,2,1
5,265,265,24,24,0,1,0
6,290,290,39,39,0,1,0
2,292,292,6,6,0,1,0
1,321,321,1,1,0,1,0
9,355,355,142,127,15,4,3
3,359,359,44,44,0,1,0
13,447,447,85,85,0,1,0
12,482,482,23,23,0,1,0
8,492,492,56,56,0,1,0
10,492,492,4,4,0,1,0

4,102,102,17,17,0,1,0
2,120,120,1,1,0,1,0
5,124,124,2,2,0,1,0
18,137,137,8,1,7,2,1
13,156,156,17,17,0,1,0
17,162,162,32,25,7,2,1
11,165,165,3,3,0,1,0
14,184,184,19,19,0,1,0
15,221,221,10,10,0,1,0
12,245,245,70,14,56,3,2
6,277,277,10,10,0,1,0
8,322,322,23,23,0,1,0
0,384,384,29,13,16,2,1
9,384,384,2,2,0,1,0
1,385,385,24,7,17,2,1
3,403,403,31,31,0,1,0
10,432,432,55,9,46,2,1
16,445,445,9,1,8,2,1
7,458,458,64,64,0,1,0

12,175,175,4,4,0,1,0
4,185,185,28,28,0,1,0
10,190,190,58,58,0,1,0
0,221,221,1,1,0,1,0
13,222,222,13,13,0,1,0
2,249,249,32,32,0,1,0
9,261,261,13,6,7,3,2
11,285,285,99,56,43,2,1
6,287,287,28,19,9,4,3
3,388,388,16,11,5,2,1
8,440,440,7,1,6,3,2
1,456,456,22,22,0,1,0
7,467,467,9,9,0,1,0
5,476,476,158,129,29,2,1

10,102,102,5,5,0,1,0
4,200,200,19,19,0,1,0
15,221,221,11,8,3,2,1
7,260,260,30,3,27,4,3
16,314,314,17,11,6,2,1
11,322,322,123,39,84,3,2
0,322,322,9,6,3,2,1
5,324,324,23,15,8,3,2
6,358,358,53,53,0,1,0
9,371,371,26,18,8,3,2
14,394,394,61,61,0,1,0
1,402,402,10,10,0,1,0
13,402,402,13,13,0,1,0
12,412,412,39,39,0,1,0
3,431,431,31,31,0,1,0
8,440,440,6,6,0,1,0
2,456,456,75,25,50,2,1

7,105,105,2,2,0,1,0
2,116,116,7,7,0,1,0
1,153,153,14,14,0,1,0
9,167,167,9,3,6,3,2
15,200,200,31,12,19,2,1
0,207,207,7,4,3,2,1
8,217,217,12,12,0,1,0
5,223,223,10,5,5,2,1
10,234,234,32,32,0,1,0
6,246,246,23,3,20,4,3
11,306,306,27,11,16,3,2
14,307,307,21,21,0,1,0
17,358,358,42,42,0,1,0
3,382,382,35,2,33,4,3
13,431,431,97,41,56,4,3
12,434,434,25,6,19,2,1
16,449,449,43,43,0,1,0
4,479,479,59,59,0,1,0

8,115,115,10,10,0,1,0
2,127,127,17,7,10,2,1
10,127,127,6,6,0,1,0
13,245,245,5,5,0,1,0
14,246,246,20,4,16,2,1
16,251,251,103,33,70,3,2
6,256,256,1,1,0,1,0
9,282,282,73,73,0,1,0
4,290,290,2,2,0,1,0
17,300,300,15,9,6,3,2
7,322,322,2,2,0,1,0
15,363,363,30,4,26,2,1
0,381,381,16,16,0,1,0
5,390,390,23,23,0,1,0
3,396,396,8,8,0,1,0
1,420,420,57,11,46,3,2
11,429,429,64,64,0,1,0
12,493,493,10,6,4,2,1

2,171,171,48,48,0,1,0
0,193,193,4,4,0,1,0
1,203,203,36,36,0,1,0
3,248,248,52,6,46,2,1
9,250,250,21,1,20,3,2
11,252,252,11,11,0,1,0
12,274,274,50,3,47,4,3
6,372,372,123,123,0,1,0
8,392,392,32,32,0,1,0
5,406,406,14,1,13,4,3
4,464,464,36,3,33,4,3
10,483,483,11,11,0,1,0
7,497,497,33,33,0,1,0

12,123,123,5,1,4,2,1
15,132,132,32,18,14,3,2
2,140,140,25,25,0,1,0
8,141,141,1,1,0,1,0
18,148,148,26,6,20,2,1
17,157,157,10,10,0,1,0
3,177,177,38,2,36,4,3
1,190,190,4,1,3,2,1
16,197,197,5,5,0,1,0
14,239,239,23,23,0,1,0
9,249,249,15,15,0,1,0
4,299,299,2,2,0,1,0
0,305,305,23,7,16,3,2
13,307,307,34,24,10,3,2
6,380,380,3,3,0,1,0
10,397,397,20,20,0,1,0
19,423,423,45,23,22,3,2
11,425,425,21,9,12,2,1
7,450,450,22,19,3,2,1
5,465,465,19,19,0,1,0

12,157,157,46,15,31,3,2
0,170,170,8,5,3,2,1
1,187,187,3,3,0,1,0
8,207,207,29,11,18,3,2
6,225,225,77,77,0,1,0
13,286,286,1,1,0,1,0
3,306,306,31,8,23,2,1
7,314,314,30,30,0,1,0
9,351,351,24,24,0,1,0
10,380,380,39,39,0,1,0
14,415,415,5,5,0,1,0
4,434,434,1,1,0,1,0
11,457,457,89,8,81,4,3
2,479,479,36,36,0,1,0
5,490,490,60,60,0,1,0

17,104,104,11,1,10,3,2
18,165,165,2,2,0,1,0
0,173,173,1,1,0,1,0
14,189,189,15,15,0,1,0
1,197,197,11,3,8,2,1
9,207,207,18,7,11,2,1
15,225,225,20,10,10,2,1
8,245,245,58,58,0,1,0
3,247,247,4,4,0,1,0
4,298,298,47,47,0,1,0
6,302,302,13,13,0,1,0
5,309,309,16,16,0,1,0
12,365,365,125,125,0,1,0
7,370,370,5,5,0,1,0
13,375,375,23,17,6,2,1
16,375,375,48,48,0,1,0
2,420,420,2,2,0,1,0
10,494,494,14,2,12,3,2
11,497,497,50,11,39,2,1

2,127,127,1,1,0,1,0
14,137,137,39,18,21,4,3
8,153,153,7,7,0,1,0
12,165,165,27,27,0,1,0
15,170,170,17,17,0,1,0
6,227,227,35,35,0,1,0
13,234,234,13,13,0,1,0
3,241,241,5,5,0,1,0
1,246,246,26,21,5,2,1
5,277,277,41,41,0,1,0
7,308,308,32,11,21,4,3
9,408,408,38,38,0,1,0
11,421,421,16,16,0,1,0
0,441,441,40,35,5,2,1
10,453,453,35,35,0,1,0
4,456,456,58,58,0,1,0

6,151,151,6,6,0,1,0
2,201,201,6,6,0,1,0
17,204,204,9,4,5,2,1
7,225,225,1,1,0,1,0
1,233,233,6,2,4,2,1
19,245,245,9,9,0,1,0
3,248,248,1,1,0,1,0
0,283,283,4,1,3,2,1
4,293,293,1,1,0,1,0
5,341,341,5,5,0,1,0
16,361,361,26,6,20,3,2
11,370,370,7,7,0,1,0
10,376,376,62,62,0,1,0
12,403,403,59,59,0,1,0
15,411,411,17,5,12,3,2
9,413,413,41,12,29,3,2
18,463,463,84,62,22,3,2
13,471,471,36,36,0,1,0
14,474,474,177,151,26,3,2
8,481,481,77,77,0,1,0
20,492,492,29,29,0,1,0

4,247,247,100,54,46,2,1
5,261,261,28,28,0,1,0
8,278,278,11,8,3,2,1
3,308,308,11,11,0,1,0
6,320,320,54,6,48,4,3
0,359,359,41,41,0,1,0
2,368,368,20,4,16,2,1
7,395,395,1,1,0,1,0
1,412,412,283,283,0,1,0

15,163,163,8,1,7,2,1
10,164,164,27,2,25,3,2
1,202,202,5,5,0,1,0
3,208,208,21,21,0,1,0
8,214,214,10,5,5,2,1
7,219,219,7,7,0,1,0
9,240,240,10,10,0,1,0
2,246,246,21,3,18,4,3
13,259,259,3,3,0,1,0
5,281,281,29,29,0,1,0
11,290,290,65,38,27,4,3
4,317,317,62,62,0,1,0
14,321,321,42,13,29,2,1
12,395,395,75,75,0,1,0
0,438,438,18,6,12,4,3
6,448,448,77,77,0,1,0

14,173,173,56,56,0,1,0
7,205,205,21,13,8,2,1
12,227,227,7,1,6,2,1
15,237,237,13,13,0,1,0
9,240,240,14,4,10,2,1
18,263,263,14,1,13,2,1
13,263,263,18,18,0,1,0
0,278,278,1,1,0,1,0
10,293,293,4,4,0,1,0
17,300,300,57,20,37,4,3
1,376,376,24,24,0,1,0
11,401,401,12,8,4,2,1
3,418,418,81,39,42,4,3
5,429,429,99,72,27,2,1
16,435,435,41,30,11,4,3
4,438,438,20,20,0,1,0
6,440,440,4,4,0,1,0
2,482,482,17,13,4,2,1
8,497,497,8,2,6,3,2

4,100,100,3,3,0,1,0
15,101,101,13,5,8,2,1
1,103,103,15,15,0,1,0
5,120,120,41,41,0,1,0
12,174,174,23,10,13,2,1
8,186,186,3,3,0,1,0
2,202,202,1,1,0,1,0
3,210,210,3,3,0,1,0
13,231,231,30,30,0,1,0
9,259,259,38,2,36,2,1
11,263,263,4,4,0,1,0
0,289,289,53,30,23,2,1
10,374,374,57,27,30,2,1
7,381,381,16,8,8,2,1
14,414,414,47,4,43,2,1
6,497,497,11,11,0,1,0

4,126,126,9,9,0,1,0
5,132,132,22,1,21,2,1
6,160,160,4,4,0,1,0
2,175,175,59,11,48,2,1
7,184,184,6,6,0,1,0
1,322,322,124,124,0,1,0
10,351,351,66,62,4,2,1
8,374,374,10,10,0,1,0
9,439,439,136,91,45,4,3
3,453,453,14,14,0,1,0
0,466,466,22,22,0,1,0

4,106,106,5,5,0,1,0
15,148,148,25,5,20,3,2
7,151,151,5,2,3,2,1
0,189,189,10,3,7,2,1
12,196,196,3,3,0,1,0
18,216,216,19,6,13,2,1
3,243,243,1,1,0,1,0
14,256,256,24,12,12,3,2
1,287,287,19,19,0,1,0
6,299,299,10,10,0,1,0
11,306,306,16,16,0,1,0
20,310,310,1,1,0,1,0
2,310,310,1,1,0,1,0
19,323,323,73,73,0,1,0
13,359,359,6,6,0,1,0
17,365,365,20,1,19,2,1
9,367,367,1,1,0,1,0
8,396,396,31,31,0,1,0
5,419,419,38,23,15,4,3
21,431,431,84,84,0,1,0
10,449,449,96,96,0,1,0
16,462,462,37,37,0,1,0

8,129,129,2,2,0,1,0
13,168,168,15,15,0,1,0
6,205,205,19,7,12,2,1
5,246,246,27,27,0,1,0
4,249,249,34,10,24,2,1
1,315,315,47,23,24,3,2
14,324,324,11,5,6,3,2
2,382,382,17,17,0,1,0
12,401,401,139,31,108,4,3
7,413,413,4,4,0,1,0
0,415,415,2,2,0,1,0
11,419,419,9,9,0,1,0
10,421,421,85,85,0,1,0
9,486,486,51,6,45,4,3
3,490,490,124,58,66,4,3

13,139,139,26,5,21,2,1
10,148,148,1,1,0,1,0
4,193,193,27,14,13,2,1
2,196,196,1,1,0,1,0
5,200,200,47,29,18,4,3
3,209,209,18,18,0,1,0
6,210,210,3,3,0,1,0
9,238,238,60,60,0,1,0
7,255,255,20,5,15,4,3
11,286,286,29,29,0,1,0
0,291,291,54,34,20,2,1
1,308,308,2,2,0,1,0
15,322,322,6,6,0,1,0
14,431,431,18,18,0,1,0
12,435,435,91,67,24,2,1
8,438,438,22,1,21,4,3

7,126,126,41,5,36,4,3
3,199,199,11,5,6,3,2
6,220,220,4,4,0,1,0
11,226,226,23,23,0,1,0
0,244,244,29,29,0,1,0
10,294,294,22,22,0,1,0
13,307,307,33,33,0,1,0
1,313,313,3,3,0,1,0
14,319,319,113,23,90,4,3
9,338,338,28,19,9,2,1
12,391,391,3,3,0,1,0
2,396,396,52,52,0,1,0
4,400,400,34,7,27,4,3
8,430,430,35,15,20,3,2
5,438,438,27,27,0,1,0

12,110,110,9,1,8,3,2
1,127,127,1,1,0,1,0
11,134,134,18,18,0,1,0
5,162,162,16,16,0,1,0
2,176,176,40,2,38,2,1
4,176,176,2,2,0,1,0
0,312,312,10,10,0,1,0
9,383,383,83,31,52,3,2
14,415,415,28,10,18,3,2
13,438,438,23,7,16,4,3
8,449,449,87,44,43,4,3
6,453,453,67,29,38,3,2
10,490,490,35,35,0,1,0
3,493,493,109,74,35,2,1
7,500,500,27,5,22,2,1

9,171,171,20,20,0,1,0
11,188,188,1,1,0,1,0
8,207,207,6,6,0,1,0
3,230,230,26,26,0,1,0
12,248,248,119,119,0,1,0
0,261,261,1,1,0,1,0
5,296,296,52,49,3,2,1
2,307,307,44,44,0,1,0
1,360,360,42,31,11,2,1
13,365,365,12,5,7,2,1
6,402,402,53,3,50,2,1
7,432,432,37,29,8,2,1
4,469,469,55,29,26,2,1
10,469,469,31,31,0,1,0

11,159,159,46,16,30,3,2
4,176,176,50,50,0,1,0
1,188,188,55,55,0,1,0
2,287,287,41,41,0,1,0
10,297,297,41,41,0,1,0
0,300,300,21,21,0,1,0
7,352,352,33,33,0,1,0
8,352,352,34,34,0,1,0
9,385,385,5,5,0,1,0
6,427,427,67,33,34,2,1
5,451,451,8,3,5,2,1
3,492,492,6,6,0,1,0

5,111,111,8,2,6,2,1
3,123,123,7,7,0,1,0
2,137,137,2,2,0,1,0
4,138,138,42,42,0,1,0
8,176,176,3,3,0,1,0
10,195,195,6,6,0,1,0
14,243,243,1,1,0,1,0
15,253,253,4,4,0,1,0
11,276,276,155,116,39,4,3
6,280,280,6,6,0,1,0
0,354,354,56,32,24,4,3
13,415,415,57,51,6,3,2
12,434,434,11,4,7,2,1
7,469,469,68,68,0,1,0
1,486,486,6,6,0,1,0
9,498,498,18,11,7,2,1

9,101,101,12,12,0,1,0
0,243,243,27,13,14,3,2
2,315,315,5,5,0,1,0
11,323,323,145,145,0,1,0
6,324,324,36,32,4,2,1
15,326,326,3,3,0,1,0
3,349,349,15,9,6,3,2
8,361,361,14,7,7,2,1
1,365,365,9,9,0,1,0
12,374,374,37,37,0,1,0
5,392,392,11,2,9,2,1
14,402,402,27,15,12,4,3
13,413,413,28,19,9,2,1
4,437,437,157,157,0,1,0
7,484,484,34,34,0,1,0
10,493,493,2,2,0,1,0

17,131,131,63,63,0,1,0
14,135,135,2,2,0,1,0
3,151,151,3,3,0,1,0
9,200,200,7,7,0,1,0
0,202,202,12,12,0,1,0
12,218,218,6,6,0,1,0
4,251,251,37,9,28,3,2
8,266,266,1,1,0,1,0
10,267,267,29,29,0,1,0
1,274,274,1,1,0,1,0
6,284,284,14,14,0,1,0
11,290,290,14,7,7,2,1
7,305,305,11,11,0,1,0
13,320,320,21,21,0,1,0
16,375,375,61,41,20,2,1
2,398,398,16,8,8,2,1
5,435,435,109,71,38,3,2
15,462,462,18,18,0,1,0
18,468,468,12,4,8,2,1

0,132,132,14,2,12,3,2
13,135,135,2,2,0,1,0
8,147,147,1,1,0,1,0
6,148,148,12,6,6,3,2
17,179,179,3,3,0,1,0
14,224,224,42,42,0,1,0
4,250,250,8,1,7,2,1
3,257,257,45,3,42,2,1
15,273,273,17,17,0,1,0
7,297,297,17,5,12,4,3
12,310,310,26,26,0,1,0
11,336,336,138,33,105,4,3
5,341,341,32,24,8,2,1
10,369,369,32,15,17,2,1
16,382,382,12,12,0,1,0
2,424,424,21,21,0,1,0
1,471,471,32,8,24,4,3
9,475,475,21,5,16,2,1

9,122,122,7,3,4,2,1
10,127,127,9,9,0,1,0
7,152,152,5,5,0,1,0
13,197,197,3,3,0,1,0
1,304,304,45,8,37,3,2
12,332,332,15,15,0,1,0
4,351,351,8,2,6,3,2
6,352,352,3,3,0,1,0
8,361,361,140,32,108,4,3
2,367,367,123,29,94,3,2
11,372,372,77,77,0,1,0
0,377,377,38,20,18,2,1
5,392,392,50,16,34,2,1
3,488,488,28,28,0,1,0

19,119,119,27,27,0,1,0
0,153,153,12,7,5,2,1
4,157,157,7,7,0,1,0
13,169,169,11,11,0,1,0
16,179,179,6,6,0,1,0
14,193,193,42,28,14,2,1
6,197,197,22,7,15,4,3
1,226,226,1,1,0,1,0
18,272,272,6,1,5,2,1
10,341,341,4,4,0,1,0
7,354,354,76,61,15,4,3
12,365,365,5,5,0,1,0
5,390,390,12,7,5,2,1
2,391,391,72,42,30,4,3
3,395,395,7,7,0,1,0
11,410,410,11,5,6,3,2
9,448,448,4,4,0,1,0
15,456,456,89,42,47,2,1
17,490,490,29,15,14,2,1
8,495,495,27,27,0,1,0

3,104,104,8,8,0,1,0
14,116,116,8,8,0,1,0
5,126,126,8,8,0,1,0
10,131,131,17,9,8,3,2
8,161,161,7,7,0,1,0
12,161,161,8,8,0,1,0
2,197,197,1,1,0,1,0
16,212,212,20,20,0,1,0
0,226,226,1,1,0,1,0
1,248,248,15,15,0,1,0
6,260,260,23,4,19,4,3
9,310,310,1,1,0,1,0
17,342,342,92,44,48,4,3
15,344,344,19,19,0,1,0
11,355,355,44,44,0,1,0
19,383,383,26,6,20,3,2
13,400,400,8,8,0,1,0
4,461,461,50,50,0,1,0
18,493,493,118,77,41,2,1
7,497,497,23,23,0,1,0

12,125,125,17,5,12,3,2
13,149,149,4,4,0,1,0
1,166,166,4,4,0,1,0
10,170,170,43,43,0,1,0
11,202,202,53,12,41,2,1
3,205,205,34,12,22,3,2
0,212,212,15,4,11,2,1
5,261,261,48,48,0,1,0
4,314,314,8,2,6,3,2
9,349,349,4,4,0,1,0
8,382,382,45,18,27,4,3
6,418,418,64,34,30,2,1
7,435,435,12,1,11,3,2
15,483,483,54,23,31,2,1
2,484,484,16,5,11,2,1
14,494,494,7,1,6,2,1

14,109,109,10,7,3,2,1
11,172,172,17,9,8,2,1
15,186,186,15,15,0,1,0
7,201,201,15,1,14,3,2
9,224,224,90,90,0,1,0
3,242,242,41,33,8,2,1
12,243,243,14,14,0,1,0
5,278,278,18,18,0,1,0
2,296,296,19,19,0,1,0
6,326,326,6,3,3,2,1
8,339,339,98,98,0,1,0
0,352,352,12,4,8,2,1
4,352,352,12,12,0,1,0
10,356,356,16,4,12,2,1
13,381,381,14,4,10,2,1
1,405,405,21,21,0,1,0

12,104,104,15,15,0,1,0
10,120,120,10,6,4,2,1
15,159,159,17,1,16,2,1
1,163,163,7,7,0,1,0
5,206,206,29,29,0,1,0
13,206,206,10,10,0,1,0
14,208,208,36,6,30,3,2
3,212,212,22,22,0,1,0
0,277,277,18,18,0,1,0
6,282,282,41,23,18,4,3
4,318,318,55,55,0,1,0
8,344,344,10,10,0,1,0
11,366,366,84,54,30,4,3
2,371,371,37,37,0,1,0
9,385,385,13,13,0,1,0
7,412,412,1,1,0,1,0

2,158,158,18,18,0,1,0
7,171,171,5,1,4,2,1
8,202,202,19,7,12,3,2
0,221,221,36,1,35,2,1
9,222,222,121,121,0,1,0
3,234,234,79,79,0,1,0
10,242,242,8,5,3,2,1
6,269,269,7,7,0,1,0
5,319,319,4,1,3,2,1
1,350,350,17,1,16,3,2
11,351,351,4,4,0,1,0
12,418,418,31,3,28,2,1
4,422,422,53,53,0,1,0

13,100,100,6,6,0,1,0
14,109,109,22,22,0,1,0
5,111,111,1,1,0,1,0
4,119,119,20,20,0,1,0
7,122,122,2,2,0,1,0
1,130,130,35,35,0,1,0
2,132,132,2,2,0,1,0
3,165,165,3,3,0,1,0
12,234,234,20,20,0,1,0
6,264,264,21,21,0,1,0
8,344,344,21,21,0,1,0
9,362,362,52,45,7,2,1
0,374,374,84,84,0,1,0
10,470,470,26,26,0,1,0
11,485,485,99,3,96,4,3

3,105,105,43,31,12,2,1
7,169,169,7,7,0,1,0
8,173,173,53,23,30,2,1
5,189,189,3,3,0,1,0
0,270,270,19,8,11,2,1
11,290,290,29,24,5,2,1
4,339,339,32,5,27,4,3
6,389,389,70,70,0,1,0
10,419,419,22,22,0,1,0
2,424,424,14,14,0,1,0
9,439,439,52,33,19,2,1
1,492,492,96,63,33,4,3

13,107,107,2,2,0,1,0
10,127,127,12,12,0,1,0
9,173,173,42,42,0,1,0
12,214,214,36,36,0,1,0
3,229,229,43,43,0,1,0
5,246,246,8,8,0,1,0
0,264,264,49,49,0,1,0
1,278,278,30,30,0,1,0
8,307,307,37,9,28,2,1
2,452,452,102,48,54,4,3
6,469,469,28,28,0,1,0
4,475,475,1,1,0,1,0
11,478,478,80,80,0,1,0
7,500,500,3,3,0,1,0

14,100,100,4,4,0,1,0
4,110,110,2,2,0,1,0
5,164,164,11,11,0,1,0
13,166,166,23,15,8,3,2
11,166,166,30,17,13,2,1
3,179,179,4,1,3,2,1
8,225,225,14,8,6,2,1
16,251,251,66,17,49,4,3
7,256,256,15,15,0,1,0
2,259,259,3,3,0,1,0
15,303,303,15,9,6,2,1
17,338,338,19,19,0,1,0
10,383,383,36,36,0,1,0
9,389,389,63,63,0,1,0
0,410,410,118,21,97,4,3
1,420,420,1,1,0,1,0
6,477,477,7,7,0,1,0
12,496,496,40,14,26,3,2

2,113,113,9,1,8,3,2
9,115,115,1,1,0,1,0
0,121,121,9,3,6,3,2
6,160,160,5,5,0,1,0
20,163,163,27,4,23,2,1
10,167,167,6,3,3,2,1
1,176,176,4,4,0,1,0
16,176,176,24,24,0,1,0
11,184,184,4,4,0,1,0
12,200,200,42,42,0,1,0
8,220,220,2,2,0,1,0
13,221,221,22,22,0,1,0
5,243,243,16,16,0,1,0
3,258,258,1,1,0,1,0
17,274,274,5,2,3,2,1
15,275,275,53,53,0,1,0
18,279,279,7,3,4,2,1
7,358,358,10,10,0,1,0
14,361,361,33,33,0,1,0
4,386,386,43,43,0,1,0
19,415,415,74,8,66,4,3

18,117,117,2,2,0,1,0
12,123,123,3,3,0,1,0
3,146,146,11,11,0,1,0
5,164,164,3,3,0,1,0
2,185,185,15,15,0,1,0
14,192,192,15,12,3,2,1
13,227,227,4,4,0,1,0
1,232,232,1,1,0,1,0
19,239,239,1,1,0,1,0
9,249,249,11,11,0,1,0
8,252,252,4,1,3,2,1
17,262,262,8,8,0,1,0
10,267,267,44,44,0,1,0
6,288,288,8,8,0,1,0
0,318,318,13,4,9,4,3
4,333,333,24,24,0,1,0
20,366,366,199,130,69,4,3
15,403,403,31,22,9,4,3
16,409,409,27,27,0,1,0
11,457,457,45,9,36,2,1
7,494,494,57,57,0,1,0

11,104,104,9,9,0,1,0
8,130,130,1,1,0,1,0
2,180,180,30,30,0,1,0
9,185,185,6,6,0,1,0
14,222,222,89,89,0,1,0
1,259,259,1,1,0,1,0
6,262,262,28,28,0,1,0
5,307,307,62,12,50,2,1
13,337,337,1,1,0,1,0
7,362,362,1,1,0,1,0
15,374,374,35,35,0,1,0
3,379,379,69,43,26,3,2
12,396,396,32,32,0,1,0
4,427,427,5,5,0,1,0
0,451,451,10,10,0,1,0
16,465,465,42,42,0,1,0
17,486,486,32,11,21,3,2
10,488,488,31,10,21,4,3

1,107,107,7,7,0,1,0
8,148,148,11,11,0,1,0
3,185,185,29,11,18,4,3
10,202,202,40,40,0,1,0
9,303,303,51,36,15,4,3
7,324,324,23,1,22,2,1
0,378,378,129,129,0,1,0
6,396,396,71,71,0,1,0
4,410,410,1,1,0,1,0
5,434,434,52,52,0,1,0
2,437,437,105,12,93,4,3

6,108,108,4,4,0,1,0
14,137,137,36,12,24,4,3
4,177,177,10,10,0,1,0
0,240,240,28,19,9,4,3
7,274,274,38,38,0,1,0
10,282,282,15,15,0,1,0
5,293,293,17,3,14,2,1
9,295,295,17,17,0,1,0
8,304,304,33,19,14,2,1
12,311,311,19,1,18,3,2
1,386,386,13,9,4,2,1
3,420,420,18,18,0,1,0
11,444,444,117,42,75,4,3
13,444,444,3,3,0,1,0
2,477,477,151,78,73,4,3

7,104,104,11,7,4,2,1
0,120,120,15,15,0,1,0
9,266,266,5,5,0,1,0
2,332,332,39,39,0,1,0
6,342,342,33,25,8,3,2
3,371,371,146,47,99,4,3
4,385,385,30,20,10,3,2
5,387,387,105,27,78,3,2
10,416,416,1,1,0,1,0
11,418,418,106,34,72,4,3
8,443,443,29,1,28,3,2
1,500,500,44,7,37,2,1

9,100,100,6,3,3,2,1
4,103,103,12,8,4,2,1
16,147,147,17,17,0,1,0
17,156,156,6,6,0,1,0
11,216,216,1,1,0,1,0
1,219,219,15,9,6,2,1
2,223,223,37,37,0,1,0
8,228,228,3,3,0,1,0
10,297,297,12,12,0,1,0
3,303,303,37,37,0,1,0
5,319,319,4,1,3,2,1
6,349,349,25,25,0,1,0
0,387,387,47,47,0,1,0
14,400,400,81,44,37,4,3
15,452,452,2,2,0,1,0
13,453,453,200,200,0,1,0
7,454,454,5,1,4,2,1
12,480,480,3,3,0,1,0

4,132,132,42,5,37,3,2
0,167,167,17,17,0,1,0
10,206,206,6,3,3,2,1
15,210,210,65,18,47,2,1
12,213,213,22,22,0,1,0
9,214,214,9,9,0,1,0
1,222,222,18,11,7,2,1
3,253,253,6,6,0,1,0
8,289,289,17,5,12,3,2
2,310,310,1,1,0,1,0
13,329,329,43,43,0,1,0
5,351,351,44,44,0,1,0
6,396,396,19,19,0,1,0
11,413,413,29,29,0,1,0
7,422,422,17,17,0,1,0
14,423,423,56,56,0,1,0

8,131,131,20,14,6,3,2
3,155,155,5,2,3,2,1
2,156,156,18,18,0,1,0
0,212,212,122,98,24,2,1
7,287,287,17,17,0,1,0
5,294,294,80,26,54,4,3
9,297,297,48,48,0,1,0
10,364,364,46,12,34,2,1
6,423,423,5,5,0,1,0
1,468,468,37,37,0,1,0
4,497,497,17,17,0,1,0

1,136,136,1,1,0,1,0
3,169,169,1,1,0,1,0
4,215,215,44,44,0,1,0
14,217,217,2,2,0,1,0
7,220,220,19,10,9,2,1
5,262,262,70,34,36,2,1
11,269,269,10,2,8,3,2
6,321,321,57,33,24,4,3
0,337,337,12,2,10,2,1
12,386,386,2,2,0,1,0
13,399,399,63,63,0,1,0
10,405,405,106,7,99,3,2
9,434,434,97,7,90,3,2
2,467,467,8,8,0,1,0
8,484,484,58,14,44,3,2

11,128,128,30,30,0,1,0
12,144,144,4,4,0,1,0
1,157,157,2,2,0,1,0
0,162,162,3,3,0,1,0
10,196,196,1,1,0,1,0
8,231,231,22,10,12,2,1
14,231,231,4,4,0,1,0
6,275,275,20,2,18,4,3
5,310,310,37,27,10,3,2
3,347,347,25,25,0,1,0
4,396,396,19,7,12,2,1
7,418,418,28,19,9,2,1
13,446,446,65,41,24,4,3
9,456,456,133,37,96,3,2
2,487,487,190,133,57,4,3

12,111,111,12,6,6,3,2
2,158,158,5,1,4,2,1
13,161,161,14,14,0,1,0
14,179,179,30,30,0,1,0
9,183,183,30,30,0,1,0
1,191,191,14,14,0,1,0
6,204,204,1,1,0,1,0
0,235,235,4,1,3,2,1
4,256,256,32,16,16,2,1
8,331,331,10,6,4,2,1
16,347,347,71,71,0,1,0
5,403,403,34,34,0,1,0
3,405,405,86,54,32,4,3
10,449,449,42,15,27,4,3
11,456,456,64,16,48,3,2
15,459,459,8,8,0,1,0
7,471,471,27,5,22,3,2

7,175,175,17,17,0,1,0
4,198,198,5,5,0,1,0
1,200,200,1,1,0,1,0
11,204,204,43,37,6,3,2
10,217,217,10,5,5,2,1
18,223,223,5,5,0,1,0
14,223,223,5,5,0,1,0
13,228,228,35,35,0,1,0
6,237,237,14,14,0,1,0
17,243,243,65,65,0,1,0
15,284,284,55,25,30,3,2
2,328,328,6,6,0,1,0
12,334,334,28,28,0,1,0
5,376,376,26,26,0,1,0
0,401,401,1,1,0,1,0
8,427,427,47,23,24,3,2
16,432,432,29,29,0,1,0
9,435,435,14,14,0,1,0
3,470,470,59,59,0,1,0

10,108,108,15,15,0,1,0
2,126,126,2,2,0,1,0
5,137,137,25,25,0,1,0
13,143,143,5,5,0,1,0
9,146,146,22,22,0,1,0
12,181,181,7,7,0,1,0
15,198,198,9,1,8,2,1
0,294,294,17,5,12,3,2
16,294,294,11,1,10,2,1
7,301,301,40,40,0,1,0
4,307,307,1,1,0,1,0
3,331,331,32,17,15,4,3
6,396,396,40,40,0,1,0
1,430,430,22,10,12,4,3
14,431,431,8,8,0,1,0
11,440,440,220,205,15,2,1
8,443,443,4,1,3,2,1

11,106,106,10,4,6,3,2
17,165,165,1,1,0,1,0
2,172,172,6,6,0,1,0
13,178,178,24,24,0,1,0
5,203,203,12,12,0,1,0
16,276,276,40,9,31,2,1
15,285,285,31,31,0,1,0
7,289,289,33,33,0,1,0
4,313,313,20,20,0,1,0
0,322,322,11,3,8,3,2
8,326,326,13,13,0,1,0
10,340,340,17,17,0,1,0
14,364,364,36,18,18,4,3
9,413,413,20,9,11,4,3
3,471,471,56,56,0,1,0
12,481,481,107,9,98,4,3
1,485,485,15,5,10,2,1
6,490,490,101,47,54,3,2

0,106,106,12,3,9,4,3
9,150,150,18,6,12,2,1
3,202,202,38,26,12,2,1
11,266,266,42,22,20,3,2
10,279,279,24,24,0,1,0
4,291,291,21,12,9,4,3
5,358,358,41,33,8,3,2
12,366,366,4,4,0,1,0
2,391,391,12,12,0,1,0
8,393,393,33,19,14,2,1
14,428,428,41,41,0,1,0
13,430,430,111,12,99,4,3
7,438,438,46,32,14,2,1
1,448,448,4,1,3,2,1
6,470,470,79,73,6,3,2

4,108,108,14,6,8,3,2
10,197,197,23,17,6,3,2
3,202,202,52,7,45,4,3
1,249,249,55,37,18,2,1
6,250,250,9,2,7,2,1
0,375,375,21,21,0,1,0
8,400,400,37,37,0,1,0
2,454,454,122,76,46,3,2
9,457,457,3,3,0,1,0
7,468,468,37,37,0,1,0
5,498,498,175,148,27,2,1

14,113,113,8,8,0,1,0
0,118,118,5,5,0,1,0
13,126,126,24,4,20,2,1
2,135,135,31,31,0,1,0
15,147,147,18,6,12,3,2
4,199,199,17,9,8,3,2
3,209,209,31,31,0,1,0
7,234,234,18,18,0,1,0
1,235,235,1,1,0,1,0
9,332,332,9,2,7,2,1
10,358,358,12,5,7,2,1
6,373,373,20,4,16,2,1
5,374,374,18,18,0,1,0
11,378,378,93,71,22,3,2
8,380,380,43,4,39,4,3
12,380,380,46,2,44,2,1

4,118,118,24,24,0,1,0
7,124,124,26,26,0,1,0
8,143,143,1,1,0,1,0
6,153,153,19,3,16,2,1
0,182,182,26,20,6,3,2
10,185,185,34,34,0,1,0
1,187,187,12,12,0,1,0
13,224,224,23,23,0,1,0
5,272,272,43,43,0,1,0
11,319,319,17,17,0,1,0
2,349,349,33,33,0,1,0
12,379,379,86,60,26,2,1
3,391,391,6,6,0,1,0
9,405,405,13,3,10,3,2

12,104,104,1,1,0,1,0
1,119,119,15,15,0,1,0
9,194,194,1,1,0,1,0
4,210,210,26,26,0,1,0
6,268,268,1,1,0,1,0
11,297,297,127,16,111,4,3
2,376,376,123,19,104,4,3
5,390,390,32,1,31,3,2
7,399,399,31,31,0,1,0
0,404,404,45,45,0,1,0
8,429,429,60,6,54,4,3
10,433,433,66,21,45,2,1
3,470,470,15,15,0,1,0

15,126,126,3,3,0,1,0
11,130,130,34,34,0,1,0
1,165,165,27,27,0,1,0
3,176,176,19,19,0,1,0
13,195,195,25,25,0,1,0
0,212,212,17,3,14,3,2
6,213,213,11,4,7,2,1
10,226,226,28,3,25,3,2
14,244,244,3,3,0,1,0
8,302,302,20,16,4,2,1
5,322,322,28,15,13,2,1
7,375,375,5,5,0,1,0
16,377,377,40,27,13,2,1
9,385,385,27,20,7,2,1
2,397,397,50,21,29,2,1
12,492,492,80,38,42,2,1
4,494,494,18,1,17,2,1

7,198,198,71,63,8,3,2
0,208,208,24,24,0,1,0
4,240,240,17,4,13,2,1
10,259,259,14,14,0,1,0
11,329,329,24,6,18,2,1
6,337,337,10,10,0,1,0
1,344,344,124,34,90,3,2
3,351,351,76,22,54,3,2
2,372,372,15,6,9,2,1
8,456,456,6,6,0,1,0
5,463,463,80,80,0,1,0
9,479,479,52,52,0,1,0

13,120,120,13,2,11,2,1
10,137,137,21,21,0,1,0
9,160,160,10,10,0,1,0
7,162,162,4,4,0,1,0
6,174,174,1,1,0,1,0
12,184,184,32,24,8,2,1
1,248,248,4,4,0,1,0
5,299,299,7,7,0,1,0
11,357,357,8,5,3,2,1
8,369,369,100,94,6,2,1
0,442,442,11,3,8,2,1
2,457,457,19,19,0,1,0
3,490,490,15,3,12,3,2
4,496,496,328,328,0,1,0

3,216,216,29,29,0,1,0
2,237,237,58,58,0,1,0
5,303,303,25,8,17,2,1
4,329,329,98,43,55,4,3
10,331,331,7,1,6,2,1
8,351,351,3,3,0,1,0
7,355,355,6,6,0,1,0
6,357,357,38,38,0,1,0
9,423,423,212,192,20,3,2
11,458,458,33,33,0,1,0
0,466,466,2,2,0,1,0
1,475,475,57,35,22,2,1

6,128,128,7,7,0,1,0
0,146,146,34,34,0,1,0
1,189,189,2,2,0,1,0
14,208,208,12,12,0,1,0
2,225,225,13,13,0,1,0
9,225,225,6,6,0,1,0
10,247,247,41,29,12,2,1
3,344,344,39,3,36,4,3
7,371,371,39,15,24,2,1
12,372,372,60,60,0,1,0
11,410,410,104,104,0,1,0
8,412,412,34,34,0,1,0
13,413,413,26,26,0,1,0
5,470,470,49,1,48,3,2
4,493,493,60,60,0,1,0

17,116,116,10,4,6,3,2
20,130,130,3,3,0,1,0
5,142,142,15,15,0,1,0
8,151,151,5,5,0,1,0
19,192,192,1,1,0,1,0
16,211,211,7,1,6,2,1
3,236,236,3,3,0,1,0
11,242,242,4,4,0,1,0
13,242,242,18,18,0,1,0
15,264,264,11,11,0,1,0
0,277,277,21,15,6,2,1
22,285,285,42,9,33,2,1
12,294,294,1,1,0,1,0
21,333,333,13,13,0,1,0
18,365,365,179,55,124,4,3
9,376,376,40,24,16,3,2
4,381,381,8,8,0,1,0
7,411,411,35,35,0,1,0
14,423,423,3,3,0,1,0
1,434,434,10,10,0,1,0
10,470,470,10,4,6,3,2
6,474,474,15,1,14,3,2
2,492,492,71,66,5,2,1

9,112,112,25,25,0,1,0
1,124,124,10,10,0,1,0
11,179,179,9,1,8,2,1
6,190,190,18,18,0,1,0
4,194,194,30,13,17,4,3
7,204,204,40,40,0,1,0
0,210,210,33,7,26,2,1
3,292,292,50,4,46,2,1
10,315,315,23,17,6,2,1
5,407,407,90,90,0,1,0
2,421,421,7,7,0,1,0
8,457,457,64,10,54,3,2
12,470,470,18,18,0,1,0

12,130,130,18,18,0,1,0
3,134,134,1,1,0,1,0
13,175,175,21,13,8,2,1
9,193,193,8,8,0,1,0
5,197,197,8,2,6,3,2
7,208,208,17,17,0,1,0
16,224,224,13,9,4,2,1
15,342,342,52,2,50,2,1
0,367,367,12,12,0,1,0
4,373,373,95,20,75,4,3
14,396,396,28,18,10,3,2
2,443,443,70,70,0,1,0
6,468,468,19,9,10,3,2
1,471,471,47,47,0,1,0
10,473,473,57,16,41,4,3
11,483,483,75,61,14,3,2
8,485,485,21,11,10,2,1

12,150,150,22,22,0,1,0
5,158,158,26,10,16,3,2
11,197,197,13,3,10,3,2
0,198,198,7,7,0,1,0
10,198,198,49,49,0,1,0
3,267,267,20,6,14,3,2
9,281,281,8,8,0,1,0
7,292,292,28,15,13,2,1
2,377,377,11,5,6,2,1
1,431,431,51,51,0,1,0
13,442,442,82,82,0,1,0
8,452,452,21,8,13,2,1
4,455,455,28,4,24,3,2
6,492,492,156,156,0,1,0

9,106,106,11,11,0,1,0
2,117,117,26,26,0,1,0
6,150,150,23,23,0,1,0
10,181,181,4,4,0,1,0
1,209,209,8,8,0,1,0
7,264,264,71,71,0,1,0
8,441,441,92,11,81,4,3
4,445,445,2,2,0,1,0
5,449,449,25,13,12,4,3
3,476,476,61,61,0,1,0
0,499,499,206,86,120,4,3

14,126,126,18,3,15,4,3
3,152,152,8,2,6,2,1
11,310,310,28,28,0,1,0
4,330,330,133,99,34,3,2
6,349,349,20,20,0,1,0
5,350,350,35,35,0,1,0
9,361,361,28,28,0,1,0
12,378,378,86,22,64,3,2
0,404,404,27,27,0,1,0
2,415,415,10,1,9,2,1
7,426,426,13,3,10,3,2
13,444,444,62,62,0,1,0
1,468,468,31,6,25,2,1
10,481,481,56,52,4,2,1
8,499,499,9,9,0,1,0

2,110,110,9,4,5,2,1
12,111,111,10,5,5,2,1
13,143,143,4,4,0,1,0
0,151,151,1,1,0,1,0
7,174,174,3,3,0,1,0
3,223,223,8,8,0,1,0
5,294,294,42,42,0,1,0
1,330,330,3,3,0,1,0
10,337,337,33,29,4,2,1
15,342,342,24,6,18,2,1
18,354,354,10,3,7,2,1
17,375,375,65,29,36,4,3
11,378,378,86,86,0,1,0
9,413,413,10,10,0,1,0
14,447,447,28,28,0,1,0
4,469,469,2,2,0,1,0
6,496,496,4,4,0,1,0
8,497,497,72,6,66,4,3
16,499,499,179,179,0,1,0

13,109,109,5,5,0,1,0
7,111,111,20,4,16,4,3
10,140,140,21,11,10,2,1
4,151,151,1,1,0,1,0
9,157,157,5,5,0,1,0
11,160,160,15,15,0,1,0
12,214,214,19,19,0,1,0
2,321,321,23,15,8,3,2
0,338,338,1,1,0,1,0
3,349,349,134,51,83,4,3
8,366,366,84,2,82,3,2
1,404,404,37,37,0,1,0
6,411,411,37,37,0,1,0
5,461,461,71,71,0,1,0

6,115,115,31,31,0,1,0
1,122,122,7,7,0,1,0
9,158,158,14,14,0,1,0
12,215,215,23,1,22,3,2
7,273,273,44,8,36,3,2
11,280,280,1,1,0,1,0
0,286,286,91,91,0,1,0
3,324,324,16,16,0,1,0
2,340,340,21,21,0,1,0
8,426,426,60,60,0,1,0
5,460,460,59,54,5,2,1
10,485,485,23,14,9,4,3
4,495,495,92,62,30,4,3

6,193,193,5,5,0,1,0
8,213,213,62,62,0,1,0
2,268,268,48,48,0,1,0
0,271,271,35,35,0,1,0
13,285,285,22,10,12,2,1
5,297,297,65,39,26,3,2
4,302,302,8,8,0,1,0
3,330,330,24,24,0,1,0
10,333,333,31,3,28,3,2
11,357,357,20,20,0,1,0
1,422,422,64,60,4,2,1
7,451,451,73,40,33,4,3
12,454,454,34,34,0,1,0
9,472,472,28,7,21,4,3

7,107,107,19,19,0,1,0
5,109,109,2,2,0,1,0
3,123,123,8,8,0,1,0
8,126,126,18,18,0,1,0
11,128,128,4,4,0,1,0
6,176,176,4,4,0,1,0
12,226,226,61,61,0,1,0
9,246,246,20,20,0,1,0
15,320,320,15,10,5,2,1
10,341,341,53,44,9,4,3
1,373,373,53,53,0,1,0
4,377,377,22,12,10,3,2
0,404,404,33,6,27,4,3
2,420,420,41,41,0,1,0
13,443,443,30,19,11,2,1
14,447,447,71,14,57,4,3

6,126,126,12,5,7,2,1
11,136,136,52,52,0,1,0
10,171,171,6,6,0,1,0
9,196,196,29,19,10,2,1
4,275,275,30,30,0,1,0
0,351,351,18,18,0,1,0
3,356,356,96,96,0,1,0
7,364,364,4,4,0,1,0
2,385,385,74,74,0,1,0
12,420,420,9,9,0,1,0
5,425,425,70,27,43,3,2
8,436,436,56,56,0,1,0
1,448,448,6,6,0,1,0

3,122,122,21,21,0,1,0
6,124,124,19,19,0,1,0
11,128,128,7,3,4,2,1
0,181,181,8,2,6,2,1
13,182,182,2,2,0,1,0
5,263,263,44,9,35,2,1
4,269,269,38,38,0,1,0
7,296,296,6,6,0,1,0
8,357,357,47,28,19,2,1
9,418,418,60,60,0,1,0
12,426,426,157,37,120,4,3
1,438,438,6,6,0,1,0
2,441,441,39,39,0,1,0
10,452,452,36,36,0,1,0
14,481,481,9,9,0,1,0

10,166,166,15,5,10,2,1
4,187,187,53,16,37,2,1
1,196,196,3,3,0,1,0
9,199,199,2,2,0,1,0
6,221,221,2,2,0,1,0
5,230,230,50,20,30,4,3
2,244,244,45,26,19,2,1
3,266,266,20,2,18,4,3
12,336,336,78,21,57,4,3
13,343,343,71,39,32,4,3
8,376,376,35,6,29,4,3
7,404,404,64,13,51,4,3
11,434,434,10,10,0,1,0
0,488,488,8,1,7,2,1

7,117,117,2,2,0,1,0
12,133,133,11,2,9,4,3
1,137,137,2,2,0,1,0
2,180,180,30,30,0,1,0
4,213,213,4,4,0,1,0
14,253,253,36,30,6,2,1
0,292,292,23,23,0,1,0
5,359,359,50,50,0,1,0
6,384,384,1,1,0,1,0
3,390,390,103,63,40,3,2
10,403,403,49,25,24,2,1
8,424,424,19,5,14,2,1
16,444,444,141,141,0,1,0
13,458,458,15,2,13,2,1
15,459,459,1,1,0,1,0
11,474,474,53,53,0,1,0
9,496,496,27,27,0,1,0

11,107,107,8,4,4,2,1
10,140,140,3,3,0,1,0
12,155,155,40,31,9,4,3
7,165,165,38,38,0,1,0
5,271,271,30,30,0,1,0
0,288,288,18,18,0,1,0
1,297,297,139,123,16,3,2
3,360,360,38,26,12,4,3
6,385,385,23,5,18,3,2
9,441,441,30,12,18,4,3
8,485,485,49,23,26,2,1
4,493,493,12,9,3,2,1
2,497,497,16,16,0,1,0

11,127,127,24,24,0,1,0
1,133,133,21,6,15,2,1
7,245,245,16,16,0,1,0
9,252,252,43,14,29,2,1
2,273,273,21,21,0,1,0
3,331,331,92,64,28,3,2
4,334,334,37,1,36,3,2
12,336,336,11,11,0,1,0
0,360,360,11,11,0,1,0
10,430,430,2,2,0,1,0
8,436,436,65,65,0,1,0
6,453,453,91,91,0,1,0
5,482,482,71,23,48,3,2

10,100,100,6,6,0,1,0
7,164,164,5,5,0,1,0
15,183,183,4,1,3,2,1
2,192,192,10,10,0,1,0
0,196,196,9,9,0,1,0
13,202,202,36,36,0,1,0
9,203,203,23,15,8,3,2
11,205,205,40,12,28,2,1
4,300,300,56,56,0,1,0
6,312,312,78,78,0,1,0
5,330,330,13,13,0,1,0
1,371,371,22,22,0,1,0
3,448,448,9,9,0,1,0
14,449,449,107,107,0,1,0
12,494,494,3,3,0,1,0
8,500,500,59,59,0,1,0

12,102,102,14,14,0,1,0
9,117,117,6,6,0,1,0
1,125,125,1,1,0,1,0
4,183,183,64,49,15,4,3
5,188,188,5,2,3,2,1
2,193,193,14,6,8,2,1
0,267,267,13,1,12,3,2
7,293,293,18,18,0,1,0
8,296,296,10,1,9,4,3
11,358,358,21,21,0,1,0
3,372,372,31,4,27,4,3
10,373,373,30,3,27,4,3
16,379,379,3,3,0,1,0
15,435,435,17,8,9,4,3
13,461,461,216,198,18,2,1
14,477,477,9,9,0,1,0
6,498,498,35,35,0,1,0

8,107,107,9,9,0,1,0
13,128,128,21,5,16,3,2
2,143,143,1,1,0,1,0
7,173,173,6,6,0,1,0
11,235,235,17,4,13,2,1
5,285,285,16,3,13,4,3
14,348,348,19,19,0,1,0
4,362,362,10,1,9,4,3
15,385,385,70,46,24,3,2
10,405,405,12,1,11,4,3
1,417,417,27,13,14,2,1
12,420,420,62,62,0,1,0
6,438,438,53,53,0,1,0
3,445,445,64,64,0,1,0
9,456,456,73,73,0,1,0
0,498,498,131,92,39,4,3

10,155,155,2,2,0,1,0
4,157,157,1,1,0,1,0
6,162,162,22,22,0,1,0
0,203,203,70,70,0,1,0
12,215,215,9,9,0,1,0
13,215,215,75,28,47,2,1
1,233,233,27,1,26,3,2
11,240,240,19,19,0,1,0
3,261,261,12,9,3,2,1
8,287,287,28,28,0,1,0
2,307,307,37,27,10,3,2
7,370,370,8,4,4,2,1
5,403,403,14,5,9,2,1
9,489,489,103,48,55,3,2

8,139,139,37,3,34,2,1
11,168,168,1,1,0,1,0
4,221,221,77,77,0,1,0
0,233,233,47,47,0,1,0
10,246,246,14,6,8,3,2
5,357,357,16,7,9,4,3
7,367,367,7,7,0,1,0
1,426,426,35,31,4,2,1
3,444,444,22,9,13,2,1
9,460,460,63,63,0,1,0
6,467,467,144,94,50,2,1
2,473,473,35,1,34,2,1
12,487,487,12,12,0,1,0

11,104,104,10,10,0,1,0
14,133,133,21,21,0,1,0
1,173,173,8,4,4,2,1
4,178,178,15,15,0,1,0
0,199,199,2,2,0,1,0
6,204,204,45,45,0,1,0
9,256,256,4,4,0,1,0
8,257,257,11,11,0,1,0
15,278,278,38,38,0,1,0
2,317,317,33,33,0,1,0
7,369,369,40,40,0,1,0
5,396,396,55,55,0,1,0
12,410,410,99,99,0,1,0
10,456,456,18,18,0,1,0
3,462,462,22,7,15,2,1
13,471,471,60,30,30,4,3

12,112,112,12,12,0,1,0
10,127,127,8,8,0,1,0
3,157,157,27,27,0,1,0
5,169,169,2,2,0,1,0
0,183,183,15,15,0,1,0
13,188,188,22,22,0,1,0
2,203,203,42,42,0,1,0
1,225,225,34,12,22,3,2
9,263,263,25,25,0,1,0
11,295,295,75,39,36,2,1
6,297,297,14,14,0,1,0
7,339,339,31,31,0,1,0
8,383,383,17,4,13,2,1
4,441,441,17,1,16,3,2
14,492,492,67,67,0,1,0

0,117,117,9,9,0,1,0
6,119,119,14,1,13,4,3
5,122,122,7,7,0,1,0
3,171,171,17,11,6,2,1
8,173,173,10,10,0,1,0
7,203,203,11,11,0,1,0
1,220,220,29,26,3,2,1
4,256,256,10,10,0,1,0
11,261,261,25,4,21,3,2
9,264,264,11,1,10,2,1
14,301,301,3,3,0,1,0
15,327,327,54,20,34,2,1
2,332,332,56,56,0,1,0
13,337,337,127,118,9,2,1
10,372,372,19,7,12,2,1
12,447,447,33,33,0,1,0

12,103,103,29,13,16,2,1
13,123,123,27,9,18,3,2
14,147,147,11,11,0,1,0
11,204,204,26,8,18,2,1
16,238,238,6,6,0,1,0
10,239,239,3,3,0,1,0
0,248,248,30,30,0,1,0
8,260,260,37,4,33,3,2
1,294,294,13,13,0,1,0
4,295,295,7,7,0,1,0
6,300,300,26,26,0,1,0
9,327,327,41,16,25,3,2
2,332,332,58,58,0,1,0
5,389,389,6,1,5,2,1
3,395,395,1,1,0,1,0
15,402,402,33,9,24,3,2
7,406,406,27,27,0,1,0

11,102,102,29,29,0,1,0
5,144,144,28,12,16,3,2
1,179,179,7,7,0,1,0
9,199,199,27,27,0,1,0
7,251,251,14,14,0,1,0
12,288,288,51,22,29,2,1
8,308,308,14,14,0,1,0
6,359,359,27,19,8,2,1
3,362,362,24,24,0,1,0
10,388,388,16,11,5,2,1
2,415,415,28,25,3,2,1
0,423,423,173,63,110,4,3
4,496,496,15,2,13,2,1

4,101,101,10,10,0,1,0
10,106,106,9,9,0,1,0
9,153,153,5,5,0,1,0
13,154,154,7,7,0,1,0
0,179,179,9,9,0,1,0
3,179,179,6,6,0,1,0
8,187,187,62,29,33,4,3
5,243,243,17,17,0,1,0
1,257,257,29,9,20,3,2
11,330,330,37,37,0,1,0
14,350,350,13,13,0,1,0
12,414,414,71,71,0,1,0
2,443,443,18,12,6,2,1
7,451,451,140,72,68,3,2
6,494,494,42,12,30,2,1

10,219,219,6,6,0,1,0
5,270,270,2,2,0,1,0
4,323,323,20,20,0,1,0
0,344,344,109,27,82,3,2
7,370,370,27,27,0,1,0
9,393,393,47,3,44,3,2
1,400,400,86,40,46,3,2
12,405,405,127,50,77,4,3
8,412,412,52,44,8,2,1
6,416,416,36,8,28,4,3
11,421,421,26,18,8,3,2
2,438,438,80,77,3,2,1
3,453,453,8,8,0,1,0

11,102,102,14,14,0,1,0
2,104,104,6,2,4,2,1
18,163,163,48,48,0,1,0
10,187,187,21,21,0,1,0
4,207,207,1,1,0,1,0
12,214,214,16,5,11,2,1
8,245,245,13,13,0,1,0
14,256,256,28,22,6,2,1
15,269,269,16,16,0,1,0
7,285,285,43,43,0,1,0
0,288,288,1,1,0,1,0
6,294,294,1,1,0,1,0
5,298,298,7,7,0,1,0
13,300,300,10,10,0,1,0
17,384,384,91,58,33,4,3
9,390,390,27,10,17,2,1
1,448,448,5,5,0,1,0
16,449,449,3,3,0,1,0
3,465,465,84,15,69,4,3

13,112,112,8,2,6,3,2
5,140,140,1,1,0,1,0
2,148,148,9,9,0,1,0
8,156,156,42,2,40,2,1
6,190,190,11,5,6,2,1
11,261,261,36,8,28,2,1
3,289,289,28,4,24,4,3
1,292,292,77,65,12,2,1
4,355,355,2,2,0,1,0
9,371,371,10,10,0,1,0
7,417,417,88,35,53,4,3
10,419,419,23,23,0,1,0
0,465,465,46,1,45,4,3
14,471,471,58,58,0,1,0
12,477,477,65,65,0,1,0

6,109,109,4,4,0,1,0
8,115,115,23,23,0,1,0
2,117,117,17,17,0,1,0
17,125,125,13,13,0,1,0
11,137,137,2,2,0,1,0
0,149,149,17,5,12,2,1
9,161,161,5,5,0,1,0
10,182,182,8,2,6,3,2
3,200,200,3,3,0,1,0
16,206,206,1,1,0,1,0
1,216,216,4,4,0,1,0
15,220,220,70,70,0,1,0
5,251,251,1,1,0,1,0
19,293,293,2,2,0,1,0
4,327,327,19,19,0,1,0
13,400,400,85,53,32,2,1
7,446,446,49,26,23,2,1
14,467,467,6,6,0,1,0
12,497,497,5,5,0,1,0
18,500,500,77,41,36,2,1

6,107,107,14,4,10,3,2
10,115,115,17,17,0,1,0
5,147,147,38,38,0,1,0
11,158,158,29,29,0,1,0
0,165,165,15,15,0,1,0
4,198,198,10,10,0,1,0
8,238,238,7,7,0,1,0
2,239,239,23,11,12,2,1
13,311,311,86,68,18,2,1
7,317,317,44,8,36,4,3
14,348,348,14,14,0,1,0
1,349,349,7,7,0,1,0
9,351,351,24,24,0,1,0
12,477,477,33,33,0,1,0
3,486,486,7,7,0,1,0

11,111,111,14,2,12,4,3
6,126,126,1,1,0,1,0
8,148,148,5,2,3,2,1
17,168,168,7,7,0,1,0
4,187,187,20,7,13,2,1
1,216,216,3,3,0,1,0
18,235,235,12,12,0,1,0
2,265,265,10,10,0,1,0
12,271,271,21,21,0,1,0
7,292,292,2,2,0,1,0
9,295,295,26,8,18,2,1
15,301,301,14,10,4,2,1
10,329,329,1,1,0,1,0
19,380,380,67,50,17,2,1
5,389,389,36,36,0,1,0
21,397,397,111,3,108,4,3
3,450,450,17,5,12,4,3
13,453,453,50,50,0,1,0
0,481,481,15,15,0,1,0
14,482,482,13,10,3,2,1
20,489,489,2,2,0,1,0
16,495,495,107,93,14,3,2

9,104,104,31,14,17,2,1
1,126,126,12,12,0,1,0
13,161,161,8,8,0,1,0
2,192,192,8,1,7,2,1
5,198,198,8,8,0,1,0
11,204,204,14,3,11,2,1
14,225,225,2,2,0,1,0
10,281,281,14,2,12,3,2
8,285,285,32,12,20,2,1
12,288,288,67,5,62,3,2
0,380,380,18,6,12,4,3
3,407,407,113,109,4,2,1
7,435,435,36,36,0,1,0
4,477,477,13,5,8,3,2
6,494,494,93,93,0,1,0

1,214,214,8,8,0,1,0
12,217,217,61,31,30,3,2
5,235,235,8,8,0,1,0
7,245,245,24,24,0,1,0
3,257,257,128,128,0,1,0
10,275,275,87,54,33,4,3
4,305,305,27,27,0,1,0
9,313,313,3,3,0,1,0
0,325,325,12,12,0,1,0
6,326,326,11,6,5,2,1
13,333,333,7,7,0,1,0
11,350,350,24,5,19,2,1
2,441,441,32,20,12,4,3
8,496,496,7,7,0,1,0

9,109,109,2,2,0,1,0
1,114,114,20,2,18,2,1
2,238,238,31,31,0,1,0
13,253,253,66,26,40,3,2
12,263,263,30,3,27,2,1
8,298,298,8,8,0,1,0
11,301,301,101,93,8,2,1
10,319,319,11,11,0,1,0
6,368,368,20,20,0,1,0
5,374,374,78,78,0,1,0
0,410,410,32,2,30,4,3
3,450,450,56,10,46,3,2
4,457,457,14,14,0,1,0
7,487,487,11,4,7,3,2

3,126,126,3,3,0,1,0
17,162,162,40,18,22,2,1
10,177,177,1,1,0,1,0
4,188,188,40,13,27,4,3
1,212,212,22,7,15,2,1
8,215,215,22,22,0,1,0
14,216,216,58,20,38,4,3
9,224,224,37,5,32,3,2
11,282,282,24,24,0,1,0
13,320,320,3,3,0,1,0
5,335,335,23,11,12,2,1
12,337,337,65,65,0,1,0
2,347,347,3,3,0,1,0
0,365,365,8,8,0,1,0
15,378,378,2,2,0,1,0
7,396,396,14,10,4,2,1
6,427,427,24,24,0,1,0
16,500,500,1,1,0,1,0

9,112,112,3,3,0,1,0
6,124,124,40,40,0,1,0
1,151,151,5,2,3,2,1
10,178,178,1,1,0,1,0
0,203,203,48,17,31,2,1
4,254,254,61,49,12,2,1
11,319,319,98,5,93,4,3
8,347,347,36,29,7,2,1
3,382,382,13,3,10,2,1
2,429,429,111,47,64,3,2
5,430,430,19,5,14,2,1
7,434,434,6,2,4,2,1

11,130,130,10,4,6,3,2
4,143,143,5,5,0,1,0
9,153,153,14,14,0,1,0
13,169,169,22,10,12,3,2
7,191,191,19,4,15,4,3
8,220,220,1,1,0,1,0
16,238,238,9,1,8,3,2
0,287,287,13,7,6,3,2
10,297,297,13,13,0,1,0
3,329,329,37,37,0,1,0
2,337,337,37,37,0,1,0
5,381,381,8,8,0,1,0
14,400,400,48,17,31,2,1
6,405,405,78,68,10,2,1
12,454,454,88,1,87,4,3
15,456,456,12,12,0,1,0
1,462,462,22,22,0,1,0
17,481,481,111,15,96,4,3

5,149,149,10,10,0,1,0
0,190,190,28,11,17,2,1
8,195,195,1,1,0,1,0
11,244,244,85,30,55,3,2
9,330,330,27,17,10,2,1
7,400,400,17,17,0,1,0
2,417,417,143,137,6,2,1
6,420,420,58,58,0,1,0
1,428,428,13,4,9,2,1
4,443,443,51,2,49,2,1
10,481,481,31,8,23,2,1
3,495,495,51,51,0,1,0
12,500,500,64,10,54,3,2

5,122,122,15,2,13,2,1
8,127,127,5,5,0,1,0
7,143,143,5,5,0,1,0
17,165,165,32,32,0,1,0
15,198,198,32,8,24,2,1
4,214,214,1,1,0,1,0
2,219,219,6,6,0,1,0
16,283,283,52,22,30,2,1
14,308,308,20,2,18,2,1
19,339,339,32,32,0,1,0
13,350,350,10,10,0,1,0
0,353,353,29,29,0,1,0
3,365,365,61,61,0,1,0
6,384,384,38,16,22,2,1
10,388,388,10,10,0,1,0
9,401,401,37,37,0,1,0
18,403,403,36,31,5,2,1
11,419,419,25,25,0,1,0
12,478,478,10,10,0,1,0
1,492,492,12,7,5,2,1

7,114,114,4,4,0,1,0
0,123,123,23,23,0,1,0
11,154,154,2,2,0,1,0
10,156,156,1,1,0,1,0
9,177,177,10,10,0,1,0
1,193,193,10,10,0,1,0
2,204,204,1,1,0,1,0
15,278,278,41,41,0,1,0
4,305,305,16,16,0,1,0
13,307,307,17,17,0,1,0
14,351,351,136,103,33,2,1
12,385,385,72,72,0,1,0
3,399,399,25,25,0,1,0
6,407,407,101,53,48,3,2
8,415,415,15,15,0,1,0
16,416,416,8,8,0,1,0
5,440,440,31,31,0,1,0

11,100,100,5,5,0,1,0
3,107,107,11,11,0,1,0
9,117,117,10,10,0,1,0
12,121,121,4,4,0,1,0
15,159,159,52,52,0,1,0
5,170,170,1,1,0,1,0
13,254,254,17,17,0,1,0
0,256,256,33,4,29,2,1
2,264,264,70,40,30,4,3
7,267,267,50,26,24,3,2
10,342,342,18,2,16,3,2
14,364,364,74,17,57,4,3
1,367,367,5,5,0,1,0
4,374,374,22,22,0,1,0
6,427,427,7,1,6,3,2
8,439,439,10,10,0,1,0

9,106,106,11,3,8,2,1
2,127,127,7,7,0,1,0
13,141,141,17,17,0,1,0
11,158,158,9,9,0,1,0
6,162,162,5,5,0,1,0
8,175,175,11,1,10,3,2
14,196,196,21,21,0,1,0
10,244,244,90,90,0,1,0
5,245,245,9,9,0,1,0
1,304,304,26,26,0,1,0
4,304,304,51,39,12,4,3
15,318,318,9,9,0,1,0
12,321,321,10,10,0,1,0
0,436,436,76,34,42,2,1
3,452,452,27,27,0,1,0
7,491,491,65,20,45,4,3

8,135,135,4,4,0,1,0
16,139,139,3,3,0,1,0
17,146,146,30,3,27,4,3
1,208,208,54,54,0,1,0
6,247,247,25,13,12,3,2
10,251,251,40,40,0,1,0
11,254,254,3,3,0,1,0
14,261,261,102,61,41,2,1
9,285,285,1,1,0,1,0
2,294,294,15,1,14,2,1
12,350,350,2,2,0,1,0
5,361,361,28,5,23,2,1
3,436,436,13,13,0,1,0
7,448,448,1,1,0,1,0
4,456,456,25,13,12,3,2
18,468,468,3,3,0,1,0
13,473,473,11,11,0,1,0
15,482,482,77,5,72,3,2
0,497,497,11,3,8,2,1

6,113,113,10,4,6,2,1
5,119,119,36,26,10,2,1
4,127,127,32,32,0,1,0
2,162,162,50,50,0,1,0
9,209,209,21,8,13,2,1
3,289,289,11,11,0,1,0
7,321,321,37,25,12,2,1
0,343,343,41,41,0,1,0
11,365,365,7,7,0,1,0
1,367,367,31,31,0,1,0
8,384,384,55,46,9,2,1
10,497,497,27,3,24,3,2

3,123,123,6,6,0,1,0
6,128,128,14,5,9,2,1
11,141,141,34,34,0,1,0
0,151,151,12,12,0,1,0
8,236,236,19,19,0,1,0
7,247,247,52,34,18,3,2
1,288,288,122,104,18,3,2
2,392,392,64,64,0,1,0
4,412,412,35,2,33,4,3
10,412,412,1,1,0,1,0
5,474,474,58,58,0,1,0
9,493,493,25,25,0,1,0

0,121,121,21,21,0,1,0
2,123,123,1,1,0,1,0
11,139,139,20,20,0,1,0
14,141,141,10,1,9,2,1
7,186,186,1,1,0,1,0
5,195,195,13,13,0,1,0
13,230,230,60,1,59,3,2
17,234,234,35,5,30,3,2
10,239,239,2,2,0,1,0
18,240,240,35,35,0,1,0
1,287,287,17,3,14,3,2
15,308,308,20,10,10,3,2
12,354,354,10,10,0,1,0
4,430,430,2,2,0,1,0
9,441,441,53,35,18,3,2
8,451,451,13,13,0,1,0
6,461,461,21,5,16,3,2
16,481,481,45,45,0,1,0
3,486,486,66,17,49,4,3

1,111,111,23,23,0,1,0
11,177,177,21,3,18,4,3
8,198,198,11,11,0,1,0
7,235,235,8,8,0,1,0
9,259,259,78,30,48,4,3
10,306,306,11,5,6,3,2
0,341,341,21,5,16,3,2
5,382,382,138,57,81,4,3
2,384,384,14,14,0,1,0
12,416,416,40,40,0,1,0
4,421,421,44,10,34,2,1
3,428,428,13,1,12,2,1
6,448,448,76,76,0,1,0

6,105,105,40,40,0,1,0
3,109,109,7,7,0,1,0
2,119,119,22,22,0,1,0
5,130,130,16,16,0,1,0
7,135,135,3,3,0,1,0
0,161,161,1,1,0,1,0
9,180,180,5,5,0,1,0
11,242,242,33,33,0,1,0
10,251,251,83,47,36,3,2
4,281,281,11,11,0,1,0
12,323,323,9,9,0,1,0
8,369,369,47,33,14,3,2
13,380,380,54,21,33,2,1
1,436,436,2,2,0,1,0

4,107,107,2,2,0,1,0
5,165,165,3,3,0,1,0
3,185,185,7,4,3,2,1
6,213,213,130,109,21,2,1
9,225,225,17,17,0,1,0
10,247,247,10,2,8,2,1
0,291,291,87,19,68,3,2
1,309,309,137,57,80,4,3
2,324,324,7,2,5,2,1
8,326,326,11,5,6,3,2
7,464,464,8,8,0,1,0

0,152,152,1,1,0,1,0
14,202,202,1,1,0,1,0
18,253,253,34,34,0,1,0
6,269,269,5,5,0,1,0
9,272,272,3,3,0,1,0
3,300,300,1,1,0,1,0
16,336,336,4,4,0,1,0
7,338,338,7,7,0,1,0
5,340,340,11,11,0,1,0
2,358,358,24,24,0,1,0
17,370,370,17,17,0,1,0
12,371,371,116,86,30,2,1
15,410,410,31,31,0,1,0
8,430,430,70,19,51,4,3
1,450,450,15,15,0,1,0
4,461,461,191,179,12,2,1
13,486,486,108,98,10,2,1
11,487,487,3,3,0,1,0
10,489,489,12,12,0,1,0

0,108,108,1,1,0,1,0
7,114,114,7,7,0,1,0
3,117,117,18,11,7,2,1
2,188,188,3,3,0,1,0
5,197,197,1,1,0,1,0
11,204,204,5,5,0,1,0
6,260,260,48,38,10,2,1
9,299,299,84,35,49,2,1
8,302,302,12,3,9,2,1
10,334,334,27,3,24,4,3
13,399,399,38,38,0,1,0
1,401,401,87,87,0,1,0
15,444,444,25,25,0,1,0
4,458,458,53,50,3,2,1
14,476,476,83,11,72,4,3
12,494,494,48,48,0,1,0

6,136,136,4,1,3,2,1
13,169,169,41,41,0,1,0
1,193,193,36,22,14,4,3
9,199,199,12,8,4,2,1
7,236,236,66,66,0,1,0
4,237,237,11,1,10,3,2
5,243,243,1,1,0,1,0
12,251,251,7,7,0,1,0
8,315,315,51,51,0,1,0
11,325,325,8,2,6,3,2
3,364,364,77,47,30,4,3
2,383,383,124,60,64,3,2
0,435,435,2,2,0,1,0
10,473,473,8,8,0,1,0

0,156,156,14,14,0,1,0
2,157,157,61,55,6,3,2
12,166,166,2,2,0,1,0
5,200,200,6,6,0,1,0
3,296,296,24,24,0,1,0
9,339,339,78,78,0,1,0
4,353,353,62,17,45,2,1
8,360,360,13,13,0,1,0
11,385,385,55,55,0,1,0
13,397,397,91,91,0,1,0
7,426,426,9,1,8,2,1
6,434,434,13,10,3,2,1
1,445,445,3,3,0,1,0
10,478,478,66,20,46,3,2

18,136,136,17,17,0,1,0
6,140,140,16,16,0,1,0
9,176,176,1,1,0,1,0
7,225,225,8,5,3,2,1
0,258,258,4,4,0,1,0
12,263,263,110,110,0,1,0
3,268,268,1,1,0,1,0
17,282,282,2,2,0,1,0
8,310,310,63,63,0,1,0
14,332,332,10,10,0,1,0
16,344,344,59,34,25,2,1
15,375,375,21,21,0,1,0
11,394,394,5,5,0,1,0
5,404,404,16,5,11,2,1
13,449,449,4,1,3,2,1
4,459,459,42,42,0,1,0
2,461,461,16,16,0,1,0
1,471,471,100,43,57,4,3
10,478,478,16,16,0,1,0

1,119,119,7,1,6,2,1
18,125,125,7,7,0,1,0
3,143,143,6,6,0,1,0
9,145,145,15,3,12,3,2
2,148,148,1,1,0,1,0
14,192,192,6,6,0,1,0
8,217,217,1,1,0,1,0
21,225,225,3,3,0,1,0
15,304,304,80,80,0,1,0
13,315,315,1,1,0,1,0
11,318,318,7,7,0,1,0
16,329,329,42,8,34,2,1
20,330,330,89,59,30,4,3
19,376,376,6,6,0,1,0
7,424,424,26,6,20,3,2
12,435,435,27,27,0,1,0
6,440,440,29,11,18,2,1
5,444,444,94,38,56,3,2
10,471,471,36,36,0,1,0
4,473,473,3,3,0,1,0
0,474,474,21,21,0,1,0
17,495,495,34,34,0,1,0

7,114,114,1,1,0,1,0
1,127,127,21,10,11,4,3
5,204,204,6,6,0,1,0
6,204,204,20,20,0,1,0
8,293,293,149,140,9,4,3
2,340,340,53,53,0,1,0
3,343,343,14,2,12,2,1
0,443,443,213,213,0,1,0
9,458,458,33,18,15,4,3
4,491,491,29,29,0,1,0

6,131,131,15,15,0,1,0
11,168,168,9,2,7,2,1
10,173,173,43,43,0,1,0
8,210,210,9,1,8,2,1
3,216,216,31,31,0,1,0
2,301,301,24,20,4,2,1
0,335,335,34,34,0,1,0
1,357,357,1,1,0,1,0
4,369,369,72,72,0,1,0
12,370,370,32,32,0,1,0
13,384,384,74,26,48,4,3
9,385,385,46,46,0,1,0
5,386,386,64,64,0,1,0
7,400,400,27,27,0,1,0

14,116,116,8,8,0,1,0
11,123,123,3,3,0,1,0
10,219,219,63,63,0,1,0
7,222,222,26,26,0,1,0
2,261,261,46,8,38,2,1
9,284,284,19,19,0,1,0
0,291,291,38,9,29,2,1
13,307,307,79,39,40,3,2
6,352,352,37,7,30,2,1
1,385,385,26,26,0,1,0
5,397,397,18,18,0,1,0
3,413,413,39,35,4,2,1
4,447,447,29,29,0,1,0
8,449,449,40,1,39,4,3
12,475,475,12,4,8,2,1

12,106,106,3,3,0,1,0
5,125,125,9,9,0,1,0
10,136,136,32,32,0,1,0
8,158,158,12,1,11,4,3
3,256,256,36,15,21,4,3
1,267,267,39,9,30,2,1
0,286,286,13,13,0,1,0
4,290,290,12,4,8,2,1
11,311,311,59,22,37,2,1
6,353,353,72,72,0,1,0
7,402,402,13,1,12,4,3
2,411,411,19,9,10,2,1
15,428,428,37,25,12,3,2
14,436,436,14,14,0,1,0
13,450,450,13,4,9,3,2
9,473,473,98,98,0,1,0

9,105,105,3,3,0,1,0
4,107,107,15,15,0,1,0
1,118,118,4,4,0,1,0
15,136,136,26,26,0,1,0
12,169,169,12,12,0,1,0
11,193,193,26,10,16,2,1
5,226,226,12,12,0,1,0
0,254,254,31,23,8,2,1
6,254,254,3,3,0,1,0
14,260,260,9,3,6,2,1
3,329,329,40,13,27,4,3
7,344,344,45,45,0,1,0
10,348,348,74,36,38,4,3
13,427,427,62,29,33,4,3
8,463,463,61,15,46,2,1
2,482,482,27,27,0,1,0

0,105,105,5,5,0,1,0
12,106,106,5,2,3,2,1
7,113,113,13,5,8,2,1
2,178,178,14,2,12,2,1
11,234,234,17,5,12,3,2
5,281,281,33,33,0,1,0
3,285,285,4,4,0,1,0
10,289,289,80,41,39,4,3
9,290,290,16,4,12,3,2
6,322,322,21,9,12,2,1
8,360,360,64,64,0,1,0
4,392,392,21,9,12,4,3
1,438,438,215,215,0,1,0

7,149,149,23,23,0,1,0
1,171,171,3,3,0,1,0
9,186,186,10,10,0,1,0
17,214,214,8,2,6,3,2
15,216,216,2,2,0,1,0
0,233,233,1,1,0,1,0
13,252,252,51,51,0,1,0
8,253,253,16,4,12,2,1
12,261,261,1,1,0,1,0
10,282,282,26,26,0,1,0
5,303,303,31,21,10,3,2
16,316,316,26,16,10,3,2
3,319,319,36,36,0,1,0
6,350,350,28,28,0,1,0
11,406,406,130,53,77,4,3
4,422,422,4,4,0,1,0
2,445,445,50,16,34,3,2
14,464,464,72,72,0,1,0

0,118,118,10,10,0,1,0
14,125,125,1,1,0,1,0
6,160,160,17,9,8,2,1
13,167,167,61,61,0,1,0
9,177,177,29,29,0,1,0
3,188,188,12,12,0,1,0
10,207,207,60,60,0,1,0
2,217,217,3,3,0,1,0
12,230,230,20,20,0,1,0
1,236,236,5,5,0,1,0
15,259,259,10,4,6,3,2
11,283,283,3,3,0,1,0
7,329,329,20,14,6,2,1
4,352,352,53,53,0,1,0
16,358,358,7,7,0,1,0
8,364,364,10,10,0,1,0
5,489,489,55,46,9,4,3

7,118,118,8,8,0,1,0
11,136,136,41,41,0,1,0
1,146,146,19,19,0,1,0
6,216,216,24,24,0,1,0
0,226,226,5,5,0,1,0
13,238,238,14,14,0,1,0
4,241,241,29,29,0,1,0
5,334,334,60,60,0,1,0
12,336,336,9,9,0,1,0
10,359,359,16,7,9,4,3
3,371,371,70,70,0,1,0
8,389,389,29,29,0,1,0
2,391,391,20,20,0,1,0
9,394,394,97,46,51,4,3

19,115,115,23,8,15,4,3
11,148,148,9,3,6,2,1
15,160,160,26,5,21,4,3
12,185,185,9,3,6,2,1
18,199,199,17,17,0,1,0
13,249,249,18,1,17,2,1
24,265,265,32,4,28,2,1
4,281,281,30,30,0,1,0
14,286,286,7,7,0,1,0
17,308,308,5,5,0,1,0
21,312,312,45,33,12,4,3
9,315,315,2,2,0,1,0
8,317,317,11,11,0,1,0
6,332,332,3,3,0,1,0
0,350,350,4,4,0,1,0
2,355,355,19,19,0,1,0
1,356,356,27,27,0,1,0
5,369,369,2,2,0,1,0
3,370,370,17,5,12,3,2
10,407,407,1,1,0,1,0
20,414,414,27,27,0,1,0
7,422,422,7,7,0,1,0
16,429,429,21,21,0,1,0
23,459,459,19,19,0,1,0
22,482,482,74,74,0,1,0

12,115,115,19,19,0,1,0
1,146,146,12,12,0,1,0
5,223,223,20,11,9,4,3
13,229,229,12,12,0,1,0
6,279,279,9,9,0,1,0
9,305,305,32,2,30,4,3
10,380,380,13,8,5,2,1
2,396,396,63,27,36,2,1
3,398,398,45,20,25,2,1
0,400,400,47,47,0,1,0
8,422,422,32,10,22,3,2
7,444,444,2,2,0,1,0
4,480,480,99,42,57,4,3
11,494,494,185,128,57,4,3

4,125,125,1,1,0,1,0
2,150,150,1,1,0,1,0
5,174,174,11,5,6,3,2
0,232,232,16,16,0,1,0
11,240,240,14,1,13,2,1
3,254,254,89,79,10,3,2
8,285,285,6,6,0,1,0
12,305,305,66,2,64,3,2
10,306,306,55,46,9,2,1
15,308,308,28,28,0,1,0
6,311,311,1,1,0,1,0
7,341,341,45,9,36,3,2
13,344,344,13,13,0,1,0
9,368,368,82,56,26,3,2
14,378,378,2,2,0,1,0
1,489,489,73,31,42,4,3

1,127,127,33,33,0,1,0
7,128,128,21,5,16,3,2
9,139,139,49,49,0,1,0
3,220,220,18,12,6,3,2
0,235,235,7,7,0,1,0
8,274,274,1,1,0,1,0
11,386,386,2,2,0,1,0
6,399,399,35,10,25,2,1
2,432,432,178,149,29,2,1
5,434,434,30,20,10,2,1
10,481,481,65,65,0,1,0
4,491,491,9,9,0,1,0

6,108,108,1,1,0,1,0
14,138,138,29,29,0,1,0
2,172,172,45,45,0,1,0
7,195,195,23,11,12,2,1
1,216,216,3,3,0,1,0
5,237,237,10,10,0,1,0
13,252,252,12,1,11,3,2
8,259,259,67,67,0,1,0
3,265,265,41,41,0,1,0
10,277,277,5,5,0,1,0
11,279,279,3,3,0,1,0
12,321,321,36,18,18,4,3
4,359,359,25,3,22,4,3
9,378,378,60,22,38,3,2
0,441,441,58,22,36,4,3

3,109,109,20,8,12,3,2
1,130,130,3,3,0,1,0
11,136,136,7,2,5,2,1
6,179,179,6,6,0,1,0
7,216,216,29,29,0,1,0
4,331,331,80,67,13,2,1
9,352,352,24,9,15,2,1
10,372,372,146,74,72,4,3
2,428,428,60,36,24,3,2
8,464,464,12,12,0,1,0
0,472,472,100,28,72,4,3
5,487,487,51,51,0,1,0

4,117,117,1,1,0,1,0
11,142,142,17,9,8,3,2
15,153,153,6,2,4,2,1
3,162,162,4,4,0,1,0
2,193,193,6,6,0,1,0
16,217,217,10,10,0,1,0
5,218,218,9,9,0,1,0
12,269,269,61,31,30,2,1
0,345,345,14,14,0,1,0
8,374,374,92,1,91,4,3
7,378,378,18,18,0,1,0
14,380,380,93,26,67,4,3
9,399,399,7,7,0,1,0
6,402,402,20,8,12,3,2
10,450,450,108,18,90,3,2
13,463,463,12,12,0,1,0
1,473,473,26,26,0,1,0
17,485,485,53,53,0,1,0

0,115,115,5,5,0,1,0
5,119,119,1,1,0,1,0
8,134,134,5,5,0,1,0
4,149,149,99,99,0,1,0
7,174,174,17,6,11,2,1
1,177,177,3,3,0,1,0
2,240,240,11,11,0,1,0
9,280,280,22,2,20,3,2
10,308,308,39,7,32,2,1
13,347,347,149,11,138,4,3
11,371,371,6,6,0,1,0
6,399,399,4,1,3,2,1
3,456,456,5,5,0,1,0
12,484,484,13,5,8,2,1

15,158,158,24,12,12,3,2
10,170,170,41,17,24,4,3
16,197,197,9,3,6,3,2
12,226,226,33,12,21,4,3
14,232,232,9,1,8,3,2
7,236,236,18,18,0,1,0
1,256,256,5,5,0,1,0
8,260,260,24,8,16,2,1
11,264,264,32,32,0,1,0
3,292,292,76,76,0,1,0
4,346,346,4,4,0,1,0
0,347,347,6,6,0,1,0
13,415,415,31,7,24,3,2
2,448,448,2,2,0,1,0
5,449,449,84,84,0,1,0
9,450,450,56,56,0,1,0
6,459,459,4,4,0,1,0

15,103,103,13,13,0,1,0
17,156,156,27,1,26,3,2
20,185,185,25,13,12,3,2
5,193,193,11,11,0,1,0
14,201,201,1,1,0,1,0
13,210,210,8,8,0,1,0
19,217,217,3,3,0,1,0
2,240,240,7,7,0,1,0
6,242,242,22,13,9,2,1
21,247,247,21,21,0,1,0
11,264,264,43,43,0,1,0
3,273,273,17,5,12,2,1
10,308,308,12,12,0,1,0
4,351,351,1,1,0,1,0
12,383,383,3,3,0,1,0
18,391,391,47,7,40,2,1
8,401,401,36,30,6,2,1
22,410,410,82,82,0,1,0
1,435,435,8,8,0,1,0
7,450,450,9,9,0,1,0
16,454,454,40,6,34,3,2
9,464,464,5,5,0,1,0
0,464,464,20,20,0,1,0

0,136,136,35,35,0,1,0
5,155,155,6,6,0,1,0
7,164,164,10,10,0,1,0
6,234,234,19,7,12,2,1
1,253,253,15,6,9,4,3
13,285,285,18,18,0,1,0
4,288,288,31,9,22,3,2
12,304,304,27,27,0,1,0
9,307,307,20,20,0,1,0
10,329,329,115,115,0,1,0
8,333,333,9,2,7,2,1
3,447,447,13,5,8,3,2
2,457,457,105,33,72,3,2
11,493,493,77,77,0,1,0

7,169,169,1,1,0,1,0
17,194,194,60,50,10,2,1
4,203,203,4,4,0,1,0
8,223,223,5,5,0,1,0
2,286,286,9,9,0,1,0
9,286,286,38,33,5,2,1
0,289,289,33,5,28,2,1
16,308,308,4,1,3,2,1
6,355,355,20,20,0,1,0
12,356,356,34,28,6,2,1
10,359,359,78,73,5,2,1
15,363,363,98,90,8,3,2
1,372,372,16,16,0,1,0
14,381,381,6,6,0,1,0
18,397,397,4,1,3,2,1
11,451,451,51,29,22,2,1
13,458,458,44,18,26,2,1
3,478,478,5,5,0,1,0
5,480,480,17,1,16,3,2

2,102,102,13,7,6,2,1
10,103,103,18,18,0,1,0
1,118,118,4,4,0,1,0
0,139,139,40,16,24,3,2
11,195,195,21,21,0,1,0
3,218,218,57,29,28,2,1
4,241,241,22,4,18,3,2
6,246,246,35,8,27,4,3
7,247,247,4,4,0,1,0
8,277,277,27,27,0,1,0
5,379,379,36,36,0,1,0
9,479,479,83,39,44,3,2

10,127,127,54,20,34,4,3
0,146,146,14,14,0,1,0
7,216,216,18,18,0,1,0
9,257,257,20,4,16,3,2
3,304,304,17,3,14,3,2
1,306,306,12,12,0,1,0
2,331,331,49,49,0,1,0
5,339,339,4,1,3,2,1
12,347,347,21,3,18,4,3
4,352,352,159,86,73,4,3
6,406,406,42,42,0,1,0
8,434,434,23,7,16,2,1
11,449,449,4,4,0,1,0

10,123,123,2,2,0,1,0
0,166,166,34,21,13,2,1
6,193,193,25,25,0,1,0
1,215,215,23,23,0,1,0
7,222,222,62,19,43,4,3
2,253,253,9,2,7,2,1
8,297,297,2,2,0,1,0
4,404,404,141,54,87,4,3
5,405,405,5,5,0,1,0
9,423,423,11,11,0,1,0
3,462,462,210,210,0,1,0

9,106,106,1,1,0,1,0
16,174,174,2,2,0,1,0
13,186,186,42,42,0,1,0
1,204,204,8,8,0,1,0
18,241,241,4,4,0,1,0
10,243,243,7,7,0,1,0
8,262,262,6,6,0,1,0
2,270,270,2,2,0,1,0
19,289,289,39,16,23,2,1
3,304,304,85,58,27,4,3
17,305,305,86,41,45,4,3
7,334,334,3,3,0,1,0
0,350,350,9,9,0,1,0
5,353,353,27,13,14,3,2
15,363,363,34,34,0,1,0
14,428,428,22,22,0,1,0
6,431,431,17,10,7,3,2
11,452,452,48,21,27,2,1
4,460,460,23,23,0,1,0
12,472,472,50,38,12,2,1

13,116,116,5,5,0,1,0
8,118,118,18,18,0,1,0
15,130,130,19,5,14,2,1
10,141,141,31,31,0,1,0
14,147,147,10,3,7,2,1
4,196,196,18,2,16,2,1
0,234,234,4,4,0,1,0
9,256,256,19,19,0,1,0
6,311,311,42,14,28,2,1
5,323,323,49,13,36,4,3
12,334,334,28,28,0,1,0
2,336,336,53,53,0,1,0
3,379,379,25,14,11,4,3
7,382,382,12,1,11,3,2
11,446,446,81,34,47,3,2
1,463,463,2,2,0,1,0

7,100,100,2,2,0,1,0
0,111,111,21,18,3,2,1
1,140,140,24,10,14,2,1
15,146,146,5,5,0,1,0
9,175,175,30,6,24,4,3
10,184,184,11,11,0,1,0
12,200,200,28,16,12,3,2
3,242,242,12,12,0,1,0
14,263,263,103,49,54,4,3
13,266,266,4,1,3,2,1
8,271,271,20,20,0,1,0
2,274,274,32,32,0,1,0
6,298,298,7,7,0,1,0
11,310,310,2,2,0,1,0
4,312,312,10,6,4,2,1
5,371,371,47,47,0,1,0

8,127,127,6,2,4,2,1
6,132,132,54,54,0,1,0
0,136,136,2,2,0,1,0
5,146,146,1,1,0,1,0
15,266,266,3,3,0,1,0
16,271,271,27,27,0,1,0
14,286,286,3,3,0,1,0
11,334,334,7,7,0,1,0
12,369,369,45,45,0,1,0
9,369,369,6,6,0,1,0
2,381,381,19,3,16,2,1
10,420,420,50,50,0,1,0
3,439,439,32,8,24,2,1
7,473,473,6,1,5,2,1
4,474,474,78,70,8,3,2
13,492,492,209,162,47,4,3
1,496,496,3,3,0,1,0

4,101,101,4,4,0,1,0
2,108,108,9,9,0,1,0
11,148,148,1,1,0,1,0
10,155,155,4,4,0,1,0
16,165,165,10,10,0,1,0
13,173,173,89,56,33,4,3
1,191,191,15,15,0,1,0
6,204,204,9,6,3,2,1
12,212,212,2,2,0,1,0
8,252,252,50,31,19,2,1
3,261,261,31,28,3,2,1
9,261,261,18,9,9,4,3
15,303,303,27,13,14,3,2
7,399,399,28,28,0,1,0
5,431,431,23,23,0,1,0
0,437,437,10,10,0,1,0
17,445,445,41,31,10,2,1
14,465,465,19,19,0,1,0

15,121,121,41,41,0,1,0
14,138,138,5,5,0,1,0
12,144,144,8,3,5,2,1
6,182,182,44,13,31,4,3
17,217,217,28,28,0,1,0
8,266,266,8,8,0,1,0
13,274,274,9,1,8,2,1
3,274,274,7,1,6,2,1
4,322,322,53,17,36,4,3
0,342,342,9,9,0,1,0
11,402,402,16,10,6,3,2
2,402,402,3,3,0,1,0
7,404,404,83,14,69,4,3
16,445,445,82,40,42,2,1
5,458,458,12,12,0,1,0
1,483,483,1,1,0,1,0
10,490,490,33,33,0,1,0
9,499,499,2,2,0,1,0

8,102,102,9,9,0,1,0
15,138,138,12,12,0,1,0
14,208,208,43,8,35,2,1
7,210,210,9,9,0,1,0
6,214,214,64,64,0,1,0
11,243,243,6,6,0,1,0
13,262,262,2,2,0,1,0
2,292,292,4,4,0,1,0
3,308,308,12,9,3,2,1
9,375,375,4,4,0,1,0
4,378,378,41,41,0,1,0
5,378,378,11,11,0,1,0
1,392,392,6,6,0,1,0
10,400,400,35,30,5,2,1
0,402,402,27,3,24,2,1
17,408,408,82,82,0,1,0
16,415,415,27,27,0,1,0
12,428,428,94,94,0,1,0

3,127,127,2,2,0,1,0
10,276,276,46,46,0,1,0
0,396,396,125,43,82,4,3
1,401,401,62,16,46,3,2
11,413,413,48,10,38,3,2
4,422,422,100,100,0,1,0
6,423,423,58,37,21,2,1
8,423,423,31,31,0,1,0
2,428,428,25,5,20,2,1
5,431,431,9,1,8,3,2
7,438,438,42,2,40,3,2
9,484,484,4,4,0,1,0
12,497,497,105,78,27,2,1

8,170,170,16,10,6,2,1
13,184,184,9,9,0,1,0
6,209,209,15,3,12,3,2
9,252,252,15,15,0,1,0
11,254,254,12,5,7,2,1
0,259,259,36,1,35,4,3
12,262,262,1,1,0,1,0
3,265,265,3,3,0,1,0
2,316,316,39,22,17,4,3
16,358,358,25,25,0,1,0
7,398,398,23,9,14,2,1
14,408,408,26,26,0,1,0
5,423,423,62,62,0,1,0
10,441,441,90,84,6,3,2
15,455,455,169,121,48,4,3
4,464,464,20,20,0,1,0
1,473,473,27,27,0,1,0

4,107,107,4,4,0,1,0
0,127,127,22,22,0,1,0
9,144,144,7,7,0,1,0
3,159,159,3,3,0,1,0
7,168,168,11,11,0,1,0
12,189,189,48,6,42,4,3
11,250,250,43,14,29,3,2
5,297,297,13,13,0,1,0
2,317,317,21,21,0,1,0
10,343,343,17,17,0,1,0
8,344,344,47,15,32,2,1
13,449,449,42,38,4,2,1
6,450,450,27,15,12,4,3
1,468,468,188,188,0,1,0

10,178,178,42,6,36,4,3
8,202,202,11,11,0,1,0
1,204,204,17,17,0,1,0
5,245,245,27,2,25,2,1
4,281,281,69,44,25,2,1
0,301,301,18,5,13,2,1
6,307,307,77,5,72,4,3
2,359,359,50,29,21,4,3
3,379,379,104,56,48,4,3
7,384,384,14,6,8,2,1
11,413,413,32,32,0,1,0
9,453,453,24,2,22,2,1

7,131,131,13,13,0,1,0
3,240,240,10,10,0,1,0
1,248,248,177,177,0,1,0
0,263,263,23,23,0,1,0
2,279,279,39,39,0,1,0
6,342,342,89,54,35,4,3
8,397,397,9,9,0,1,0
5,402,402,63,63,0,1,0
4,480,480,44,4,40,4,3

14,126,126,4,4,0,1,0
5,143,143,25,25,0,1,0
11,205,205,24,24,0,1,0
0,216,216,24,24,0,1,0
7,217,217,34,19,15,4,3
8,331,331,48,39,9,4,3
13,331,331,16,7,9,2,1
9,338,338,35,8,27,4,3
12,353,353,39,39,0,1,0
10,362,362,93,6,87,4,3
2,369,369,4,4,0,1,0
1,405,405,13,7,6,2,1
6,423,423,2,2,0,1,0
4,491,491,43,43,0,1,0
3,494,494,111,99,12,4,3

8,109,109,1,1,0,1,0
3,158,158,11,11,0,1,0
9,186,186,9,9,0,1,0
7,232,232,22,22,0,1,0
11,246,246,17,5,12,4,3
6,265,265,63,63,0,1,0
4,312,312,115,115,0,1,0
5,312,312,33,2,31,2,1
0,322,322,10,10,0,1,0
2,368,368,81,31,50,3,2
1,379,379,43,43,0,1,0
10,414,414,102,102,0,1,0

3,153,153,1,1,0,1,0
9,153,153,35,35,0,1,0
7,156,156,16,16,0,1,0
2,188,188,41,29,12,3,2
8,224,224,1,1,0,1,0
11,240,240,9,9,0,1,0
10,259,259,38,38,0,1,0
1,283,283,5,5,0,1,0
12,344,344,8,8,0,1,0
6,368,368,4,4,0,1,0
13,414,414,113,6,107,4,3
4,430,430,47,11,36,3,2
0,467,467,152,82,70,3,2
5,475,475,54,54,0,1,0

3,114,114,1,1,0,1,0
11,122,122,1,1,0,1,0
4,127,127,3,3,0,1,0
10,135,135,6,6,0,1,0
16,173,173,6,6,0,1,0
17,183,183,2,2,0,1,0
7,253,253,32,15,17,2,1
14,256,256,151,74,77,4,3
9,307,307,14,14,0,1,0
1,310,310,79,52,27,4,3
6,322,322,10,2,8,2,1
5,349,349,16,7,9,2,1
15,357,357,47,30,17,2,1
18,408,408,10,10,0,1,0
13,426,426,5,5,0,1,0
12,435,435,3,3,0,1,0
8,449,449,27,27,0,1,0
0,457,457,9,9,0,1,0
2,468,468,62,47,15,3,2

12,103,103,2,2,0,1,0
7,113,113,1,1,0,1,0
1,122,122,8,5,3,2,1
8,134,134,5,5,0,1,0
0,142,142,5,5,0,1,0
2,142,142,11,11,0,1,0
14,142,142,12,12,0,1,0
15,153,153,14,5,9,2,1
10,165,165,15,3,12,3,2
17,191,191,33,20,13,2,1
6,204,204,42,42,0,1,0
11,286,286,34,17,17,2,1
19,325,325,43,36,7,2,1
16,353,353,29,17,12,4,3
4,376,376,5,5,0,1,0
3,394,394,5,5,0,1,0
20,415,415,19,3,16,3,2
13,450,450,4,4,0,1,0
5,473,473,49,49,0,1,0
9,484,484,1,1,0,1,0
18,488,488,99,87,12,4,3

5,108,108,2,2,0,1,0
0,114,114,31,31,0,1,0
3,114,114,1,1,0,1,0
12,133,133,6,6,0,1,0
14,149,149,16,3,13,2,1
7,198,198,2,2,0,1,0
8,245,245,101,101,0,1,0
2,252,252,56,56,0,1,0
6,296,296,24,20,4,2,1
13,315,315,56,35,21,4,3
4,325,325,51,51,0,1,0
9,419,419,16,16,0,1,0
11,427,427,5,5,0,1,0
10,436,436,9,9,0,1,0
1,495,495,17,17,0,1,0

3,122,122,35,3,32,2,1
9,127,127,22,12,10,3,2
5,197,197,1,1,0,1,0
6,247,247,48,2,46,3,2
2,256,256,18,18,0,1,0
8,259,259,51,13,38,3,2
7,272,272,10,1,9,4,3
12,274,274,10,10,0,1,0
4,319,319,33,33,0,1,0
0,366,366,38,38,0,1,0
11,413,413,14,14,0,1,0
10,450,450,64,64,0,1,0
1,458,458,106,6,100,3,2

9,161,161,13,1,12,3,2
5,176,176,5,5,0,1,0
13,184,184,29,29,0,1,0
3,211,211,35,35,0,1,0
2,272,272,7,7,0,1,0
6,273,273,47,1,46,3,2
4,302,302,14,6,8,3,2
0,306,306,71,59,12,2,1
7,327,327,31,31,0,1,0
10,334,334,115,93,22,3,2
1,428,428,56,20,36,4,3
11,473,473,55,9,46,2,1
12,487,487,6,1,5,2,1
8,498,498,2,2,0,1,0

0,175,175,40,3,37,2,1
5,208,208,21,2,19,2,1
1,233,233,86,86,0,1,0
8,270,270,79,79,0,1,0
2,296,296,19,19,0,1,0
7,315,315,27,9,18,3,2
4,339,339,20,14,6,2,1
3,356,356,29,1,28,3,2
10,409,409,35,32,3,2,1
9,434,434,48,48,0,1,0
6,454,454,30,1,29,2,1
11,460,460,32,8,24,3,2

13,103,103,25,1,24,3,2
0,149,149,4,4,0,1,0
12,151,151,26,23,3,2,1
1,254,254,45,35,10,3,2
5,259,259,38,4,34,2,1
11,260,260,72,6,66,4,3
15,268,268,1,1,0,1,0
10,303,303,1,1,0,1,0
7,313,313,19,19,0,1,0
6,327,327,7,7,0,1,0
9,327,327,34,2,32,3,2
2,414,414,62,57,5,2,1
14,423,423,5,2,3,2,1
3,433,433,81,81,0,1,0
4,468,468,7,1,6,3,2
8,497,497,8,1,7,2,1

4,125,125,1,1,0,1,0
13,255,255,32,25,7,2,1
18,280,280,18,18,0,1,0
14,289,289,25,25,0,1,0
2,307,307,4,1,3,2,1
17,310,310,5,5,0,1,0
0,316,316,17,17,0,1,0
1,339,339,1,1,0,1,0
6,353,353,6,6,0,1,0
16,362,362,49,12,37,2,1
10,371,371,38,14,24,2,1
7,384,384,13,4,9,2,1
15,397,397,108,81,27,2,1
11,430,430,12,6,6,3,2
5,445,445,37,4,33,4,3
8,452,452,112,5,107,4,3
9,458,458,3,3,0,1,0
3,478,478,98,47,51,4,3
12,481,481,54,9,45,2,1

13,113,113,16,4,12,4,3
10,130,130,15,15,0,1,0
11,151,151,17,7,10,3,2
9,173,173,10,10,0,1,0
2,211,211,12,12,0,1,0
4,223,223,1,1,0,1,0
1,249,249,7,2,5,2,1
5,252,252,7,2,5,2,1
3,277,277,3,3,0,1,0
6,277,277,149,149,0,1,0
7,298,298,22,6,16,3,2
12,446,446,85,85,0,1,0
0,463,463,63,63,0,1,0
8,498,498,61,61,0,1,0

8,110,110,10,7,3,2,1
6,131,131,35,31,4,2,1
4,186,186,32,32,0,1,0
0,188,188,18,18,0,1,0
9,231,231,27,20,7,2,1
7,258,258,62,62,0,1,0
1,283,283,7,7,0,1,0
12,291,291,70,70,0,1,0
5,322,322,65,17,48,3,2
2,338,338,7,7,0,1,0
13,390,390,4,4,0,1,0
11,401,401,44,10,34,3,2
3,429,429,10,2,8,3,2
10,493,493,2,2,0,1,0

7,126,126,8,8,0,1,0
13,135,135,1,1,0,1,0
10,181,181,21,7,14,2,1
3,233,233,56,6,50,2,1
8,240,240,60,28,32,2,1
2,270,270,84,84,0,1,0
12,323,323,74,56,18,3,2
11,354,354,4,4,0,1,0
4,359,359,26,8,18,2,1
0,365,365,24,12,12,3,2
1,398,398,20,20,0,1,0
6,406,406,18,12,6,3,2
5,444,444,8,8,0,1,0
9,465,465,64,64,0,1,0

7,103,103,9,9,0,1,0
10,111,111,13,13,0,1,0
8,125,125,14,14,0,1,0
11,152,152,15,11,4,2,1
4,199,199,3,3,0,1,0
5,221,221,84,9,75,4,3
3,241,241,53,2,51,4,3
0,263,263,12,1,11,2,1
1,402,402,39,8,31,2,1
6,435,435,104,74,30,4,3
12,458,458,39,15,24,2,1
9,461,461,39,3,36,3,2
2,462,462,20,11,9,4,3

8,104,104,1,1,0,1,0
11,116,116,1,1,0,1,0
12,118,118,2,2,0,1,0
15,156,156,8,1,7,2,1
10,192,192,104,18,86,3,2
3,202,202,4,1,3,2,1
16,209,209,2,2,0,1,0
14,219,219,34,13,21,2,1
5,230,230,40,40,0,1,0
1,235,235,2,2,0,1,0
0,265,265,29,4,25,2,1
13,265,265,9,9,0,1,0
6,306,306,15,15,0,1,0
9,407,407,87,78,9,4,3
4,433,433,16,16,0,1,0
7,470,470,54,13,41,2,1
2,475,475,31,22,9,2,1

9,108,108,2,2,0,1,0
7,144,144,32,32,0,1,0
13,152,152,30,30,0,1,0
12,166,166,4,1,3,2,1
0,199,199,10,10,0,1,0
15,199,199,15,7,8,3,2
2,215,215,18,4,14,3,2
5,248,248,3,3,0,1,0
8,313,313,21,2,19,4,3
14,340,340,46,19,27,4,3
17,345,345,26,26,0,1,0
18,347,347,13,4,9,4,3
10,355,355,13,1,12,4,3
3,409,409,17,5,12,2,1
4,422,422,18,18,0,1,0
16,427,427,116,103,13,2,1
1,429,429,1,1,0,1,0
11,470,470,100,100,0,1,0
6,470,470,5,5,0,1,0

12,106,106,19,19,0,1,0
7,151,151,2,2,0,1,0
6,179,179,26,11,15,4,3
1,192,192,22,22,0,1,0
3,201,201,6,6,0,1,0
0,202,202,24,24,0,1,0
8,236,236,47,28,19,2,1
9,255,255,16,16,0,1,0
4,322,322,23,6,17,2,1
5,326,326,103,55,48,3,2
13,364,364,18,18,0,1,0
10,404,404,47,20,27,2,1
11,404,404,79,28,51,4,3
2,428,428,2,2,0,1,0

14,206,206,14,14,0,1,0
7,228,228,1,1,0,1,0
0,259,259,23,8,15,4,3
8,293,293,87,87,0,1,0
11,308,308,6,6,0,1,0
13,319,319,72,72,0,1,0
3,359,359,32,23,9,4,3
4,359,359,33,33,0,1,0
1,372,372,125,103,22,2,1
2,376,376,12,4,8,3,2
6,427,427,15,10,5,2,1
5,464,464,57,57,0,1,0
12,468,468,9,4,5,2,1
9,476,476,58,58,0,1,0
10,482,482,29,29,0,1,0

2,116,116,7,7,0,1,0
12,130,130,4,4,0,1,0
14,133,133,15,3,12,2,1
9,139,139,14,14,0,1,0
1,159,159,45,31,14,3,2
0,174,174,14,14,0,1,0
7,194,194,18,6,12,4,3
4,212,212,5,5,0,1,0
6,214,214,43,20,23,3,2
11,220,220,16,16,0,1,0
10,230,230,31,5,26,2,1
13,269,269,25,9,16,3,2
3,348,348,11,3,8,3,2
8,355,355,94,40,54,4,3
5,438,438,14,2,12,3,2

5,145,145,23,13,10,2,1
7,166,166,5,5,0,1,0
9,169,169,6,6,0,1,0
3,173,173,5,5,0,1,0
2,261,261,5,2,3,2,1
8,264,264,36,29,7,2,1
11,280,280,20,2,18,4,3
13,286,286,5,5,0,1,0
6,317,317,27,27,0,1,0
10,341,341,2,2,0,1,0
0,380,380,21,3,18,2,1
4,423,423,146,137,9,4,3
1,452,452,50,50,0,1,0
12,498,498,256,210,46,4,3

8,140,140,37,37,0,1,0
7,194,194,9,2,7,2,1
1,228,228,13,13,0,1,0
15,233,233,24,24,0,1,0
12,258,258,9,9,0,1,0
14,263,263,49,11,38,3,2
0,281,281,29,29,0,1,0
5,309,309,9,9,0,1,0
2,339,339,71,41,30,3,2
13,357,357,65,65,0,1,0
10,384,384,77,66,11,2,1
9,385,385,1,1,0,1,0
4,387,387,14,7,7,2,1
6,407,407,1,1,0,1,0
3,481,481,25,3,22,2,1
11,484,484,49,15,34,2,1

16,102,102,3,3,0,1,0
7,108,108,11,11,0,1,0
6,112,112,15,15,0,1,0
17,114,114,10,10,0,1,0
5,130,130,22,22,0,1,0
2,143,143,3,3,0,1,0
12,150,150,18,2,16,2,1
3,170,170,1,1,0,1,0
14,209,209,30,30,0,1,0
1,241,241,17,17,0,1,0
8,315,315,18,18,0,1,0
15,331,331,15,7,8,3,2
11,332,332,33,25,8,3,2
9,347,347,1,1,0,1,0
4,351,351,8,1,7,2,1
13,389,389,116,76,40,3,2
10,442,442,94,94,0,1,0
0,456,456,1,1,0,1,0

3,116,116,19,5,14,3,2
9,140,140,26,18,8,3,2
11,157,157,1,1,0,1,0
7,177,177,34,34,0,1,0
0,233,233,75,23,52,4,3
10,263,263,7,7,0,1,0
4,331,331,33,1,32,2,1
1,342,342,62,4,58,3,2
8,374,374,56,10,46,4,3
6,398,398,43,6,37,2,1
5,422,422,61,23,38,2,1
2,446,446,15,1,14,2,1

1,106,106,6,3,3,2,1
6,118,118,3,3,0,1,0
7,143,143,18,18,0,1,0
13,153,153,1,1,0,1,0
16,158,158,12,1,11,3,2
10,179,179,1,1,0,1,0
17,203,203,21,8,13,2,1
18,216,216,98,14,84,3,2
11,224,224,12,2,10,2,1
12,238,238,16,16,0,1,0
5,250,250,21,21,0,1,0
19,285,285,5,5,0,1,0
0,307,307,28,28,0,1,0
4,318,318,16,11,5,2,1
8,327,327,30,30,0,1,0
14,368,368,34,2,32,3,2
3,368,368,15,15,0,1,0
15,374,374,24,8,16,3,2
9,455,455,44,12,32,3,2
2,456,456,6,6,0,1,0

10,102,102,4,4,0,1,0
16,123,123,44,40,4,2,1
1,126,126,9,9,0,1,0
14,148,148,8,8,0,1,0
15,161,161,31,5,26,3,2
11,217,217,16,16,0,1,0
3,265,265,25,1,24,3,2
7,278,278,27,27,0,1,0
12,304,304,24,24,0,1,0
8,322,322,17,17,0,1,0
13,340,340,5,5,0,1,0
0,401,401,12,6,6,3,2
5,430,430,62,62,0,1,0
4,444,444,2,2,0,1,0
2,450,450,9,9,0,1,0
6,477,477,127,79,48,3,2
9,487,487,10,1,9,2,1

1,110,110,7,7,0,1,0
4,186,186,1,1,0,1,0
3,190,190,34,34,0,1,0
5,203,203,21,21,0,1,0
6,203,203,9,9,0,1,0
8,239,239,44,44,0,1,0
9,299,299,66,66,0,1,0
7,307,307,49,16,33,2,1
13,317,317,26,26,0,1,0
0,322,322,20,8,12,4,3
11,391,391,15,15,0,1,0
12,391,391,52,52,0,1,0
10,447,447,8,8,0,1,0
14,464,464,63,1,62,3,2
2,493,493,91,67,24,4,3

15,181,181,20,13,7,2,1
8,193,193,9,9,0,1,0
14,195,195,58,20,38,3,2
16,226,226,37,20,17,3,2
1,260,260,3,3,0,1,0
10,328,328,8,8,0,1,0
12,343,343,12,9,3,2,1
5,358,358,48,48,0,1,0
7,386,386,21,21,0,1,0
4,407,407,12,1,11,2,1
6,411,411,59,59,0,1,0
0,419,419,35,35,0,1,0
3,440,440,83,60,23,2,1
11,450,450,51,1,50,3,2
13,454,454,31,31,0,1,0
2,461,461,27,7,20,3,2
9,469,469,24,24,0,1,0

19,122,122,23,7,16,2,1
12,128,128,12,12,0,1,0
17,150,150,3,3,0,1,0
2,151,151,21,21,0,1,0
16,178,178,45,12,33,2,1
4,222,222,10,3,7,2,1
5,227,227,22,22,0,1,0
3,257,257,8,8,0,1,0
11,299,299,6,2,4,2,1
8,308,308,6,6,0,1,0
1,341,341,9,9,0,1,0
6,344,344,14,14,0,1,0
7,349,349,20,20,0,1,0
13,378,378,23,23,0,1,0
0,438,438,19,8,11,2,1
15,442,442,7,7,0,1,0
9,467,467,42,11,31,2,1
14,472,472,6,2,4,2,1
20,482,482,127,22,105,4,3
18,487,487,32,23,9,2,1
10,499,499,18,3,15,4,3

11,171,171,12,12,0,1,0
1,187,187,21,7,14,2,1
9,224,224,16,7,9,2,1
4,265,265,26,22,4,2,1
6,280,280,55,55,0,1,0
5,304,304,28,28,0,1,0
10,320,320,8,8,0,1,0
3,384,384,126,32,94,3,2
0,399,399,32,32,0,1,0
2,424,424,77,50,27,4,3
7,474,474,3,3,0,1,0
8,486,486,172,58,114,4,3

3,112,112,13,1,12,2,1
2,118,118,2,2,0,1,0
4,129,129,7,7,0,1,0
0,143,143,34,2,32,2,1
15,216,216,3,3,0,1,0
13,221,221,2,2,0,1,0
12,236,236,25,16,9,4,3
1,241,241,1,1,0,1,0
10,325,325,48,20,28,3,2
9,362,362,12,12,0,1,0
7,379,379,2,2,0,1,0
8,401,401,117,29,88,3,2
14,437,437,143,143,0,1,0
6,485,485,24,24,0,1,0
11,498,498,85,65,20,2,1
5,500,500,13,1,12,3,2

8,101,101,1,1,0,1,0
6,160,160,13,3,10,2,1
13,177,177,37,19,18,3,2
3,189,189,5,2,3,2,1
16,243,243,35,35,0,1,0
11,262,262,20,20,0,1,0
14,268,268,9,9,0,1,0
9,269,269,34,15,19,2,1
4,283,283,31,4,27,4,3
10,307,307,15,5,10,3,2
5,318,318,19,7,12,2,1
0,402,402,61,42,19,2,1
1,418,418,18,18,0,1,0
12,428,428,110,110,0,1,0
7,434,434,65,47,18,3,2
2,447,447,20,15,5,2,1
15,496,496,21,21,0,1,0

4,100,100,5,5,0,1,0
10,130,130,21,7,14,2,1
12,148,148,1,1,0,1,0
8,150,150,13,13,0,1,0
14,192,192,49,1,48,2,1
9,196,196,57,57,0,1,0
6,225,225,12,8,4,2,1
1,229,229,65,43,22,3,2
5,242,242,12,12,0,1,0
2,254,254,21,21,0,1,0
3,331,331,8,5,3,2,1
15,355,355,4,4,0,1,0
13,356,356,15,15,0,1,0
11,430,430,21,9,12,2,1
7,451,451,66,66,0,1,0
0,471,471,12,12,0,1,0

2,109,109,7,7,0,1,0
5,110,110,12,6,6,2,1
15,152,152,4,4,0,1,0
12,196,196,21,21,0,1,0
7,203,203,5,1,4,2,1
9,217,217,4,1,3,2,1
14,230,230,22,12,10,3,2
1,289,289,28,5,23,2,1
3,289,289,31,5,26,3,2
0,297,297,15,15,0,1,0
4,303,303,21,21,0,1,0
11,315,315,16,10,6,3,2
17,317,317,53,53,0,1,0
18,370,370,81,6,75,4,3
6,378,378,32,32,0,1,0
10,448,448,33,6,27,4,3
8,471,471,25,25,0,1,0
16,491,491,60,18,42,2,1
13,495,495,38,22,16,2,1

9,118,118,15,15,0,1,0
11,127,127,4,1,3,2,1
15,157,157,34,34,0,1,0
8,163,163,2,2,0,1,0
2,171,171,16,16,0,1,0
3,171,171,2,2,0,1,0
12,171,171,2,2,0,1,0
0,222,222,1,1,0,1,0
6,223,223,13,7,6,2,1
4,226,226,31,5,26,3,2
10,243,243,1,1,0,1,0
13,250,250,91,4,87,4,3
16,256,256,27,1,26,3,2
5,270,270,30,4,26,2,1
14,289,289,26,26,0,1,0
1,311,311,68,68,0,1,0
7,460,460,14,14,0,1,0

9,147,147,25,14,11,2,1
10,225,225,61,16,45,4,3
13,243,243,29,29,0,1,0
1,244,244,17,6,11,4,3
4,253,253,8,8,0,1,0
0,264,264,43,43,0,1,0
3,264,264,14,4,10,3,2
8,287,287,26,14,12,4,3
11,296,296,10,10,0,1,0
14,297,297,4,1,3,2,1
7,306,306,28,10,18,2,1
2,365,365,4,1,3,2,1
5,411,411,58,8,50,2,1
6,423,423,64,64,0,1,0
12,484,484,30,30,0,1,0
15,492,492,70,70,0,1,0

7,103,103,5,5,0,1,0
3,104,104,25,25,0,1,0
0,163,163,15,15,0,1,0
1,183,183,24,24,0,1,0
11,186,186,47,47,0,1,0
5,212,212,1,1,0,1,0
8,284,284,14,14,0,1,0
6,330,330,67,67,0,1,0
10,343,343,25,25,0,1,0
12,412,412,78,78,0,1,0
2,437,437,5,5,0,1,0
4,442,442,142,65,77,4,3
9,452,452,2,2,0,1,0

0,148,148,2,2,0,1,0
1,213,213,13,9,4,2,1
7,247,247,27,27,0,1,0
4,257,257,8,4,4,2,1
2,275,275,40,40,0,1,0
12,316,316,76,30,46,3,2
9,363,363,47,47,0,1,0
6,383,383,18,4,14,2,1
5,402,402,65,41,24,3,2
10,417,417,27,27,0,1,0
8,431,431,13,13,0,1,0
3,473,473,184,184,0,1,0
11,499,499,95,95,0,1,0

17,115,115,6,1,5,2,1
16,122,122,11,11,0,1,0
8,138,138,5,5,0,1,0
9,169,169,11,11,0,1,0
5,183,183,3,3,0,1,0
6,188,188,24,10,14,3,2
11,217,217,38,8,30,2,1
12,273,273,45,45,0,1,0
2,296,296,14,14,0,1,0
7,319,319,3,3,0,1,0
13,345,345,29,1,28,3,2
0,352,352,76,15,61,3,2
15,378,378,61,61,0,1,0
10,397,397,54,23,31,2,1
14,417,417,37,18,19,2,1
1,484,484,32,32,0,1,0
3,489,489,24,24,0,1,0
4,499,499,16,16,0,1,0

8,103,103,10,1,9,2,1
1,149,149,1,1,0,1,0
6,149,149,11,11,0,1,0
15,200,200,7,1,6,2,1
4,203,203,33,33,0,1,0
16,211,211,47,8,39,3,2
5,222,222,7,4,3,2,1
3,267,267,8,4,4,2,1
9,284,284,18,9,9,4,3
10,309,309,5,5,0,1,0
2,327,327,2,2,0,1,0
13,338,338,38,38,0,1,0
12,359,359,44,11,33,2,1
0,360,360,113,113,0,1,0
7,434,434,7,7,0,1,0
14,496,496,55,12,43,3,2
11,499,499,97,43,54,4,3

3,126,126,1,1,0,1,0
4,195,195,1,1,0,1,0
0,201,201,36,36,0,1,0
15,203,203,20,9,11,3,2
5,246,246,4,4,0,1,0
6,274,274,1,1,0,1,0
14,274,274,116,77,39,3,2
10,324,324,46,28,18,3,2
1,355,355,89,41,48,3,2
13,391,391,22,22,0,1,0
7,410,410,26,6,20,3,2
2,417,417,72,18,54,4,3
9,433,433,20,20,0,1,0
12,445,445,18,18,0,1,0
8,460,460,47,47,0,1,0
11,477,477,3,3,0,1,0

11,114,114,35,26,9,4,3
3,121,121,9,9,0,1,0
8,144,144,2,2,0,1,0
5,152,152,45,5,40,3,2
10,218,218,7,7,0,1,0
12,244,244,7,4,3,2,1
9,277,277,6,6,0,1,0
2,281,281,7,7,0,1,0
1,299,299,42,23,19,2,1
13,356,356,9,9,0,1,0
14,370,370,142,79,63,4,3
4,414,414,5,5,0,1,0
6,439,439,56,19,37,2,1
0,486,486,39,39,0,1,0
7,486,486,22,22,0,1,0

1,149,149,29,2,27,3,2
4,158,158,9,9,0,1,0
3,216,216,35,11,24,2,1
12,223,223,33,17,16,3,2
14,224,224,3,3,0,1,0
5,259,259,3,3,0,1,0
9,272,272,63,63,0,1,0
7,305,305,21,21,0,1,0
13,334,334,35,35,0,1,0
11,372,372,21,21,0,1,0
10,381,381,18,10,8,2,1
6,392,392,29,1,28,4,3
2,407,407,4,1,3,2,1
0,415,415,54,54,0,1,0
8,434,434,40,40,0,1,0
15,475,475,99,90,9,4,3

4,133,133,47,11,36,2,1
3,141,141,1,1,0,1,0
7,203,203,1,1,0,1,0
13,223,223,13,10,3,2,1
2,231,231,55,55,0,1,0
1,237,237,3,3,0,1,0
8,257,257,8,8,0,1,0
9,263,263,20,2,18,3,2
0,271,271,16,16,0,1,0
10,278,278,70,45,25,2,1
6,303,303,9,9,0,1,0
15,337,337,4,1,3,2,1
12,354,354,43,43,0,1,0
5,362,362,24,21,3,2,1
11,429,429,14,8,6,2,1
14,455,455,118,46,72,4,3

5,139,139,4,4,0,1,0
8,168,168,6,6,0,1,0
14,195,195,10,10,0,1,0
9,201,201,20,10,10,2,1
1,214,214,48,27,21,2,1
2,258,258,21,21,0,1,0
13,260,260,3,3,0,1,0
7,265,265,42,42,0,1,0
12,286,286,21,21,0,1,0
15,291,291,68,40,28,2,1
11,293,293,49,49,0,1,0
10,303,303,53,7,46,2,1
4,348,348,1,1,0,1,0
3,434,434,21,15,6,3,2
6,459,459,4,4,0,1,0
0,474,474,102,102,0,1,0

8,118,118,6,2,4,2,1
13,122,122,2,2,0,1,0
1,129,129,37,7,30,4,3
6,177,177,12,3,9,4,3
5,195,195,44,44,0,1,0
9,219,219,28,28,0,1,0
0,232,232,7,4,3,2,1
14,274,274,11,3,8,3,2
11,319,319,28,28,0,1,0
3,389,389,6,1,5,2,1
2,398,398,15,3,12,4,3
12,404,404,131,17,114,4,3
7,405,405,48,20,28,2,1
4,442,442,8,2,6,2,1
10,466,466,80,29,51,4,3

0,104,104,3,3,0,1,0
13,114,114,12,12,0,1,0
14,167,167,11,2,9,2,1
1,178,178,31,31,0,1,0
4,259,259,16,4,12,2,1
9,264,264,6,6,0,1,0
2,267,267,1,1,0,1,0
11,313,313,24,10,14,3,2
8,315,315,27,23,4,2,1
12,337,337,145,145,0,1,0
5,363,363,89,26,63,4,3
10,388,388,17,17,0,1,0
3,420,420,21,21,0,1,0
7,452,452,35,19,16,3,2
6,459,459,24,24,0,1,0
15,469,469,34,34,0,1,0
16,493,493,10,4,6,2,1

9,108,108,18,3,15,4,3
3,198,198,47,47,0,1,0
5,202,202,6,6,0,1,0
14,210,210,9,1,8,2,1
6,220,220,16,7,9,2,1
7,241,241,5,2,3,2,1
0,277,277,9,1,8,3,2
1,319,319,17,17,0,1,0
15,362,362,37,37,0,1,0
12,370,370,8,8,0,1,0
10,397,397,19,19,0,1,0
4,406,406,117,117,0,1,0
11,452,452,3,3,0,1,0
2,454,454,21,9,12,4,3
13,477,477,202,177,25,2,1
8,480,480,10,2,8,2,1

11,147,147,7,2,5,2,1
14,184,184,23,4,19,2,1
7,212,212,47,17,30,4,3
16,222,222,7,7,0,1,0
18,231,231,10,10,0,1,0
8,253,253,7,1,6,2,1
12,258,258,28,28,0,1,0
3,266,266,30,30,0,1,0
13,288,288,64,64,0,1,0
2,304,304,3,3,0,1,0
10,328,328,27,27,0,1,0
17,358,358,26,26,0,1,0
0,384,384,4,4,0,1,0
4,393,393,7,3,4,2,1
5,399,399,6,6,0,1,0
9,406,406,44,20,24,3,2
15,420,420,87,87,0,1,0
1,439,439,17,8,9,4,3
6,455,455,52,52,0,1,0

10,203,203,43,43,0,1,0
12,204,204,2,2,0,1,0
7,219,219,30,30,0,1,0
5,237,237,15,15,0,1,0
6,240,240,82,82,0,1,0
0,323,323,14,14,0,1,0
9,363,363,14,14,0,1,0
11,385,385,9,9,0,1,0
8,405,405,20,20,0,1,0
1,445,445,48,8,40,3,2
2,450,450,44,2,42,2,1
4,450,450,109,14,95,3,2
3,491,491,122,92,30,4,3

11,179,179,42,15,27,2,1
9,187,187,3,3,0,1,0
6,210,210,1,1,0,1,0
3,272,272,69,43,26,3,2
5,285,285,21,6,15,2,1
12,285,285,12,6,6,3,2
8,291,291,11,7,4,2,1
1,380,380,74,74,0,1,0
2,398,398,11,3,8,3,2
13,408,408,13,13,0,1,0
10,414,414,108,30,78,4,3
4,442,442,1,1,0,1,0
0,471,471,45,45,0,1,0
14,488,488,94,4,90,4,3
7,492,492,73,35,38,3,2

12,117,117,11,11,0,1,0
9,154,154,24,12,12,4,3
5,161,161,6,6,0,1,0
16,162,162,7,7,0,1,0
15,166,166,30,9,21,4,3
7,184,184,12,12,0,1,0
0,211,211,7,1,6,2,1
14,254,254,2,2,0,1,0
4,261,261,7,7,0,1,0
6,262,262,23,23,0,1,0
17,306,306,24,24,0,1,0
13,380,380,30,10,20,4,3
3,395,395,8,8,0,1,0
1,436,436,11,11,0,1,0
18,449,449,54,54,0,1,0
11,459,459,38,38,0,1,0
10,467,467,1,1,0,1,0
8,472,472,31,31,0,1,0
19,477,477,148,76,72,3,2
2,500,500,56,56,0,1,0

8,192,192,7,1,6,2,1
6,196,196,2,2,0,1,0
7,203,203,2,2,0,1,0
12,227,227,123,57,66,4,3
10,250,250,13,13,0,1,0
0,258,258,67,44,23,2,1
5,319,319,9,1,8,3,2
9,330,330,45,45,0,1,0
3,375,375,36,7,29,2,1
2,380,380,125,125,0,1,0
1,420,420,31,21,10,2,1
4,449,449,7,1,6,3,2
11,449,449,11,11,0,1,0

13,115,115,3,3,0,1,0
4,117,117,2,2,0,1,0
1,154,154,17,8,9,2,1
16,168,168,5,5,0,1,0
5,181,181,17,17,0,1,0
12,184,184,84,84,0,1,0
3,187,187,14,1,13,2,1
6,193,193,13,1,12,3,2
10,236,236,12,12,0,1,0
0,236,236,39,9,30,2,1
9,250,250,21,8,13,3,2
8,276,276,7,7,0,1,0
15,303,303,15,4,11,2,1
14,309,309,24,7,17,2,1
17,375,375,49,49,0,1,0
11,391,391,11,11,0,1,0
18,444,444,22,9,13,2,1
2,458,458,27,27,0,1,0
7,475,475,12,12,0,1,0

3,201,201,1,1,0,1,0
6,213,213,30,6,24,3,2
12,241,241,65,65,0,1,0
10,259,259,1,1,0,1,0
0,293,293,45,35,10,2,1
2,296,296,36,36,0,1,0
13,334,334,106,56,50,3,2
8,343,343,19,19,0,1,0
5,348,348,61,51,10,2,1
9,355,355,24,2,22,4,3
1,408,408,80,56,24,2,1
7,422,422,24,7,17,2,1
4,451,451,4,4,0,1,0
11,483,483,19,5,14,3,2

8,178,178,17,17,0,1,0
2,225,225,105,58,47,2,1
1,229,229,8,5,3,2,1
4,244,244,19,7,12,3,2
10,290,290,24,8,16,4,3
5,300,300,34,34,0,1,0
6,350,350,57,57,0,1,0
9,367,367,7,7,0,1,0
3,372,372,5,5,0,1,0
7,401,401,107,19,88,3,2
0,435,435,125,125,0,1,0

11,120,120,19,19,0,1,0
9,170,170,1,1,0,1,0
5,190,190,15,10,5,2,1
8,190,190,27,27,0,1,0
6,195,195,22,2,20,4,3
1,213,213,18,4,14,2,1
10,229,229,7,1,6,3,2
14,235,235,64,64,0,1,0
7,371,371,40,8,32,3,2
12,425,425,6,6,0,1,0
2,431,431,72,48,24,2,1
4,444,444,55,9,46,3,2
13,448,448,86,86,0,1,0
0,479,479,5,5,0,1,0
3,488,488,56,56,0,1,0

17,109,109,15,15,0,1,0
8,110,110,1,1,0,1,0
11,183,183,12,8,4,2,1
9,224,224,9,9,0,1,0
2,287,287,28,18,10,2,1
1,299,299,13,7,6,3,2
15,315,315,2,2,0,1,0
6,323,323,52,27,25,2,1
13,326,326,22,16,6,2,1
14,390,390,23,14,9,4,3
4,401,401,12,1,11,2,1
12,405,405,136,34,102,4,3
0,408,408,49,49,0,1,0
3,409,409,62,46,16,2,1
18,466,466,18,18,0,1,0
5,477,477,12,2,10,2,1
16,482,482,83,83,0,1,0
7,484,484,27,20,7,2,1
10,490,490,2,2,0,1,0

10,120,120,20,16,4,2,1
6,166,166,11,11,0,1,0
2,167,167,28,28,0,1,0
11,170,170,23,23,0,1,0
7,177,177,32,32,0,1,0
9,203,203,26,20,6,3,2
5,217,217,74,28,46,2,1
0,250,250,8,4,4,2,1
8,274,274,18,13,5,2,1
1,278,278,7,7,0,1,0
4,350,350,82,82,0,1,0
12,397,397,30,4,26,2,1
3,442,442,1,1,0,1,0

5,113,113,5,5,0,1,0
9,135,135,1,1,0,1,0
7,144,144,28,28,0,1,0
1,186,186,25,25,0,1,0
0,204,204,5,5,0,1,0
12,216,216,55,27,28,3,2
6,218,218,1,1,0,1,0
10,234,234,14,14,0,1,0
2,242,242,9,9,0,1,0
13,247,247,20,14,6,3,2
11,297,297,66,44,22,3,2
14,322,322,54,54,0,1,0
3,337,337,34,13,21,4,3
4,372,372,97,80,17,2,1
8,396,396,8,8,0,1,0

8,147,147,8,8,0,1,0
3,204,204,2,2,0,1,0
12,247,247,14,6,8,3,2
0,267,267,16,11,5,2,1
9,315,315,77,39,38,3,2
11,321,321,22,22,0,1,0
6,325,325,85,55,30,2,1
4,338,338,9,3,6,2,1
1,349,349,64,51,13,2,1
5,366,366,11,11,0,1,0
13,393,393,94,60,34,2,1
7,396,396,46,46,0,1,0
14,423,423,56,3,53,4,3
10,440,440,8,8,0,1,0
2,489,489,56,56,0,1,0

9,110,110,10,4,6,3,2
0,133,133,1,1,0,1,0
1,157,157,22,14,8,2,1
6,173,173,7,7,0,1,0
4,175,175,43,12,31,2,1
3,185,185,7,3,4,2,1
7,190,190,3,3,0,1,0
8,221,221,5,5,0,1,0
11,231,231,1,1,0,1,0
12,241,241,17,3,14,2,1
17,255,255,8,8,0,1,0
10,300,300,8,8,0,1,0
14,326,326,9,9,0,1,0
15,326,326,88,39,49,3,2
13,351,351,54,54,0,1,0
16,372,372,93,25,68,4,3
2,413,413,31,23,8,3,2
5,418,418,42,32,10,2,1

11,142,142,11,11,0,1,0
2,146,146,2,2,0,1,0
14,195,195,26,26,0,1,0
5,216,216,48,25,23,3,2
0,218,218,19,3,16,2,1
8,234,234,114,63,51,4,3
1,253,253,1,1,0,1,0
4,260,260,19,19,0,1,0
12,264,264,3,3,0,1,0
9,268,268,15,15,0,1,0
10,275,275,10,10,0,1,0
13,294,294,5,5,0,1,0
6,296,296,92,92,0,1,0
7,325,325,29,12,17,2,1
3,414,414,1,1,0,1,0

14,117,117,10,10,0,1,0
1,130,130,8,8,0,1,0
3,139,139,2,2,0,1,0
15,152,152,57,8,49,2,1
13,174,174,13,13,0,1,0
8,177,177,27,16,11,4,3
9,198,198,21,21,0,1,0
16,239,239,30,30,0,1,0
0,256,256,4,4,0,1,0
7,287,287,3,3,0,1,0
11,311,311,19,19,0,1,0
4,323,323,32,27,5,2,1
17,358,358,33,33,0,1,0
2,363,363,59,59,0,1,0
6,421,421,15,15,0,1,0
12,433,433,3,3,0,1,0
5,465,465,45,33,12,4,3
10,470,470,22,13,9,4,3

5,151,151,2,2,0,1,0
9,246,246,37,15,22,4,3
7,303,303,103,103,0,1,0
8,326,326,38,38,0,1,0
2,357,357,95,8,87,4,3
1,369,369,30,30,0,1,0
11,416,416,14,14,0,1,0
6,418,418,33,33,0,1,0
4,423,423,96,54,42,4,3
0,453,453,91,85,6,3,2
3,483,483,13,7,6,2,1
10,494,494,40,15,25,2,1

6,113,113,4,4,0,1,0
2,149,149,18,8,10,2,1
7,174,174,46,46,0,1,0
11,204,204,5,5,0,1,0
4,261,261,21,1,20,3,2
0,278,278,125,31,94,3,2
5,326,326,140,2,138,4,3
1,328,328,13,13,0,1,0
3,333,333,37,14,23,2,1
9,358,358,9,4,5,2,1
8,432,432,3,3,0,1,0
10,485,485,14,10,4,2,1

13,113,113,6,1,5,2,1
3,118,118,4,4,0,1,0
1,119,119,14,14,0,1,0
20,163,163,48,1,47,2,1
12,168,168,7,7,0,1,0
9,179,179,5,5,0,1,0
19,209,209,27,1,26,3,2
15,220,220,9,9,0,1,0
7,226,226,2,2,0,1,0
0,230,230,11,11,0,1,0
8,230,230,26,26,0,1,0
5,236,236,2,2,0,1,0
14,253,253,32,32,0,1,0
11,256,256,1,1,0,1,0
4,260,260,12,12,0,1,0
2,279,279,10,10,0,1,0
17,333,333,10,1,9,2,1
18,333,333,21,1,20,2,1
10,344,344,20,20,0,1,0
16,395,395,98,53,45,4,3
21,419,419,5,5,0,1,0
6,424,424,33,30,3,2,1

4,107,107,1,1,0,1,0
9,113,113,2,2,0,1,0
1,129,129,32,32,0,1,0
0,170,170,13,13,0,1,0
10,181,181,12,5,7,2,1
12,182,182,56,56,0,1,0
8,190,190,1,1,0,1,0
7,191,191,39,25,14,3,2
2,208,208,1,1,0,1,0
6,210,210,12,12,0,1,0
13,236,236,15,1,14,2,1
11,300,300,48,48,0,1,0
5,362,362,24,12,12,2,1
3,467,467,160,113,47,3,2

4,119,119,12,12,0,1,0
6,128,128,5,5,0,1,0
11,139,139,2,2,0,1,0
3,152,152,5,5,0,1,0
18,187,187,35,32,3,2,1
14,210,210,33,18,15,2,1
15,217,217,67,42,25,2,1
17,251,251,19,9,10,3,2
8,258,258,30,13,17,4,3
0,298,298,12,12,0,1,0
20,302,302,7,7,0,1,0
12,321,321,34,34,0,1,0
5,341,341,6,6,0,1,0
1,357,357,6,2,4,2,1
2,364,364,3,3,0,1,0
9,393,393,9,9,0,1,0
7,399,399,10,10,0,1,0
10,400,400,60,53,7,2,1
13,472,472,52,8,44,3,2
19,474,474,12,3,9,4,3
16,496,496,17,12,5,2,1

0,114,114,14,14,0,1,0
5,124,124,1,1,0,1,0
4,144,144,5,2,3,2,1
12,218,218,18,18,0,1,0
6,222,222,28,2,26,2,1
16,227,227,38,38,0,1,0
8,244,244,23,13,10,2,1
14,251,251,25,18,7,2,1
1,269,269,15,15,0,1,0
11,271,271,31,31,0,1,0
15,278,278,5,5,0,1,0
7,318,318,53,53,0,1,0
2,424,424,10,6,4,2,1
10,426,426,5,5,0,1,0
3,430,430,11,1,10,4,3
13,471,471,150,145,5,2,1
9,486,486,70,24,46,3,2

10,111,111,10,10,0,1,0
13,130,130,9,6,3,2,1
1,137,137,8,8,0,1,0
2,143,143,20,9,11,2,1
5,153,153,15,3,12,4,3
9,201,201,10,10,0,1,0
14,206,206,15,4,11,2,1
12,248,248,12,12,0,1,0
4,253,253,14,8,6,2,1
15,256,256,23,23,0,1,0
0,285,285,5,5,0,1,0
16,290,290,89,85,4,2,1
17,299,299,44,32,12,4,3
8,325,325,5,5,0,1,0
18,342,342,29,26,3,2,1
7,415,415,37,22,15,4,3
6,431,431,14,1,13,2,1
3,442,442,14,14,0,1,0
11,463,463,57,57,0,1,0

20,127,127,14,8,6,2,1
5,147,147,22,22,0,1,0
10,158,158,9,5,4,2,1
1,170,170,1,1,0,1,0
13,180,180,16,4,12,3,2
14,208,208,17,17,0,1,0
21,234,234,9,9,0,1,0
8,253,253,9,3,6,2,1
11,257,257,7,7,0,1,0
6,281,281,2,2,0,1,0
12,293,293,2,2,0,1,0
15,307,307,39,6,33,4,3
16,321,321,130,56,74,3,2
18,327,327,23,1,22,2,1
0,341,341,5,5,0,1,0
3,349,349,27,17,10,2,1
7,352,352,10,10,0,1,0
4,372,372,43,43,0,1,0
2,374,374,23,23,0,1,0
9,382,382,18,18,0,1,0
19,447,447,25,25,0,1,0
17,452,452,3,3,0,1,0

8,129,129,41,41,0,1,0
2,140,140,23,1,22,2,1
3,148,148,30,30,0,1,0
1,241,241,1,1,0,1,0
13,300,300,9,9,0,1,0
6,331,331,78,34,44,3,2
5,338,338,22,6,16,2,1
10,343,343,23,23,0,1,0
4,347,347,24,14,10,3,2
7,363,363,26,26,0,1,0
11,373,373,60,14,46,3,2
12,416,416,32,32,0,1,0
0,480,480,29,29,0,1,0
9,481,481,44,3,41,2,1

9,104,104,41,41,0,1,0
4,151,151,24,24,0,1,0
5,160,160,14,8,6,3,2
3,172,172,13,13,0,1,0
7,176,176,10,1,9,4,3
10,203,203,2,2,0,1,0
11,206,206,23,23,0,1,0
0,272,272,95,11,84,4,3
6,294,294,14,6,8,3,2
2,333,333,56,56,0,1,0
8,358,358,39,39,0,1,0
1,389,389,21,21,0,1,0

1,114,114,1,1,0,1,0
11,117,117,23,11,12,2,1
8,121,121,31,17,14,2,1
3,178,178,47,14,33,4,3
10,199,199,3,3,0,1,0
13,215,215,2,2,0,1,0
9,297,297,17,17,0,1,0
0,298,298,19,5,14,4,3
14,364,364,90,46,44,3,2
4,372,372,6,6,0,1,0
7,378,378,97,58,39,4,3
2,402,402,43,19,24,2,1
5,414,414,16,4,12,4,3
6,426,426,20,20,0,1,0
12,445,445,20,20,0,1,0

16,105,105,1,1,0,1,0
4,123,123,2,2,0,1,0
9,148,148,11,11,0,1,0
3,184,184,20,20,0,1,0
2,196,196,30,15,15,2,1
10,203,203,31,7,24,2,1
7,229,229,23,23,0,1,0
15,238,238,28,28,0,1,0
17,239,239,53,53,0,1,0
1,248,248,2,2,0,1,0
5,324,324,2,2,0,1,0
0,333,333,35,35,0,1,0
6,347,347,1,1,0,1,0
14,400,400,62,62,0,1,0
12,415,415,65,43,22,3,2
11,417,417,55,55,0,1,0
13,442,442,9,9,0,1,0
8,491,491,37,37,0,1,0

12,100,100,10,10,0,1,0
0,127,127,28,7,21,2,1
7,157,157,25,18,7,2,1
2,164,164,4,4,0,1,0
11,191,191,6,3,3,2,1
9,236,236,4,4,0,1,0
6,242,242,30,14,16,2,1
3,296,296,54,54,0,1,0
10,319,319,74,51,23,2,1
8,321,321,50,50,0,1,0
4,363,363,6,6,0,1,0
5,411,411,50,18,32,3,2
1,477,477,112,64,48,3,2

13,115,115,1,1,0,1,0
2,128,128,3,3,0,1,0
15,162,162,1,1,0,1,0
0,170,170,1,1,0,1,0
8,225,225,1,1,0,1,0
10,226,226,91,15,76,4,3
9,235,235,15,5,10,3,2
14,264,264,9,9,0,1,0
1,266,266,34,34,0,1,0
11,287,287,44,29,15,2,1
4,304,304,31,31,0,1,0
3,312,312,20,11,9,4,3
5,354,354,37,25,12,4,3
7,394,394,7,7,0,1,0
12,422,422,65,45,20,3,2
6,452,452,159,159,0,1,0

3,105,105,1,1,0,1,0
13,139,139,25,3,22,3,2
6,140,140,46,27,19,2,1
10,271,271,22,22,0,1,0
2,283,283,15,15,0,1,0
5,297,297,31,2,29,3,2
11,310,310,60,6,54,4,3
15,317,317,4,4,0,1,0
0,347,347,58,43,15,2,1
4,352,352,16,16,0,1,0
1,385,385,1,1,0,1,0
12,418,418,69,69,0,1,0
7,419,419,26,2,24,4,3
14,452,452,39,3,36,3,2
9,456,456,43,43,0,1,0
8,495,495,14,14,0,1,0

5,170,170,13,4,9,2,1
1,187,187,15,5,10,2,1
17,199,199,21,21,0,1,0
8,207,207,9,9,0,1,0
2,217,217,14,5,9,2,1
4,259,259,1,1,0,1,0
15,299,299,90,74,16,4,3
7,302,302,40,40,0,1,0
16,307,307,33,33,0,1,0
11,364,364,24,7,17,2,1
6,374,374,5,5,0,1,0
9,389,389,18,8,10,3,2
12,412,412,35,7,28,2,1
14,448,448,5,1,4,2,1
0,450,450,128,56,72,3,2
3,455,455,12,6,6,2,1
10,481,481,14,14,0,1,0
13,481,481,64,23,41,2,1

0,114,114,6,2,4,2,1
2,135,135,2,2,0,1,0
6,147,147,22,22,0,1,0
5,200,200,41,13,28,3,2
14,208,208,16,16,0,1,0
12,232,232,9,3,6,2,1
10,270,270,3,3,0,1,0
3,293,293,7,1,6,3,2
11,307,307,38,38,0,1,0
8,318,318,34,18,16,3,2
7,344,344,83,83,0,1,0
9,384,384,23,23,0,1,0
13,465,465,185,185,0,1,0
1,488,488,26,26,0,1,0
4,491,491,30,30,0,1,0

5,134,134,4,4,0,1,0
4,135,135,4,1,3,2,1
2,167,167,17,3,14,3,2
12,168,168,16,16,0,1,0
15,180,180,1,1,0,1,0
10,184,184,2,2,0,1,0
7,231,231,35,11,24,3,2
8,250,250,44,44,0,1,0
13,266,266,51,37,14,3,2
11,284,284,21,7,14,3,2
3,289,289,38,38,0,1,0
16,289,289,2,2,0,1,0
14,290,290,127,96,31,2,1
9,338,338,40,40,0,1,0
1,356,356,7,7,0,1,0
17,362,362,2,2,0,1,0
6,380,380,11,11,0,1,0
0,464,464,3,3,0,1,0

1,119,119,32,32,0,1,0
2,127,127,16,4,12,2,1
8,157,157,20,10,10,2,1
4,168,168,23,5,18,3,2
12,170,170,16,16,0,1,0
10,220,220,79,1,78,3,2
6,233,233,25,7,18,3,2
11,250,250,10,3,7,2,1
0,311,311,56,56,0,1,0
9,407,407,21,7,14,3,2
5,453,453,19,12,7,2,1
3,481,481,23,23,0,1,0
7,485,485,18,18,0,1,0

0,101,101,1,1,0,1,0
10,138,138,7,4,3,2,1
12,142,142,9,6,3,2,1
19,148,148,11,11,0,1,0
18,160,160,9,1,8,2,1
8,166,166,18,18,0,1,0
14,205,205,12,12,0,1,0
6,243,243,19,19,0,1,0
1,312,312,10,10,0,1,0
4,331,331,6,6,0,1,0
21,351,351,81,45,36,4,3
11,356,356,30,30,0,1,0
20,359,359,45,33,12,4,3
9,371,371,29,29,0,1,0
13,375,375,1,1,0,1,0
7,377,377,17,6,11,2,1
16,384,384,3,3,0,1,0
5,390,390,29,29,0,1,0
17,400,400,89,41,48,2,1
3,424,424,40,40,0,1,0
2,428,428,1,1,0,1,0
15,487,487,47,47,0,1,0

15,100,100,23,7,16,2,1
16,133,133,5,5,0,1,0
7,141,141,11,11,0,1,0
2,184,184,1,1,0,1,0
6,188,188,18,18,0,1,0
11,194,194,11,11,0,1,0
4,197,197,33,2,31,2,1
1,235,235,16,16,0,1,0
10,242,242,11,1,10,3,2
12,253,253,21,3,18,2,1
9,270,270,7,7,0,1,0
0,318,318,8,8,0,1,0
13,430,430,116,23,93,4,3
14,436,436,27,21,6,3,2
3,459,459,73,69,4,2,1
8,460,460,58,44,14,2,1
17,467,467,34,34,0,1,0
5,479,479,2,2,0,1,0

15,153,153,16,16,0,1,0
11,200,200,23,23,0,1,0
10,211,211,15,15,0,1,0
3,222,222,21,17,4,2,1
14,230,230,3,3,0,1,0
7,233,233,14,14,0,1,0
8,236,236,13,13,0,1,0
13,239,239,11,11,0,1,0
16,289,289,9,9,0,1,0
12,293,293,134,26,108,4,3
17,316,316,15,11,4,2,1
1,330,330,21,21,0,1,0
9,375,375,62,62,0,1,0
2,391,391,28,24,4,2,1
5,395,395,16,16,0,1,0
0,395,395,32,10,22,3,2
4,467,467,40,40,0,1,0
6,494,494,6,6,0,1,0

12,135,135,3,3,0,1,0
1,156,156,7,1,6,3,2
13,240,240,43,43,0,1,0
0,247,247,64,42,22,3,2
6,261,261,2,2,0,1,0
3,268,268,56,56,0,1,0
2,299,299,21,11,10,2,1
10,342,342,17,12,5,2,1
4,374,374,63,20,43,2,1
8,385,385,142,98,44,2,1
14,390,390,7,3,4,2,1
7,394,394,1,1,0,1,0
9,423,423,27,27,0,1,0
11,435,435,47,11,36,2,1
5,437,437,17,17,0,1,0

11,108,108,3,3,0,1,0
5,114,114,1,1,0,1,0
7,136,136,1,1,0,1,0
4,150,150,16,16,0,1,0
6,164,164,3,3,0,1,0
13,178,178,10,1,9,4,3
3,229,229,15,15,0,1,0
12,236,236,82,82,0,1,0
0,245,245,30,30,0,1,0
14,284,284,27,13,14,2,1
8,291,291,116,29,87,4,3
9,294,294,31,31,0,1,0
1,325,325,13,3,10,3,2
10,350,350,56,56,0,1,0
2,480,480,16,8,8,3,2
15,500,500,13,3,10,3,2

2,105,105,5,5,0,1,0
16,107,107,8,8,0,1,0
10,108,108,14,14,0,1,0
5,161,161,8,2,6,2,1
3,162,162,12,1,11,2,1
12,191,191,10,1,9,2,1
4,217,217,1,1,0,1,0
17,242,242,45,13,32,2,1
6,246,246,13,13,0,1,0
0,281,281,32,14,18,2,1
1,288,288,31,31,0,1,0
11,304,304,43,15,28,3,2
14,323,323,103,103,0,1,0
8,324,324,10,10,0,1,0
13,361,361,1,1,0,1,0
15,370,370,15,15,0,1,0
9,384,384,36,13,23,2,1
7,499,499,52,52,0,1,0

11,129,129,7,7,0,1,0
1,146,146,2,2,0,1,0
3,161,161,64,58,6,2,1
7,163,163,26,26,0,1,0
9,178,178,26,10,16,3,2
5,215,215,9,9,0,1,0
6,288,288,81,50,31,3,2
10,289,289,12,12,0,1,0
12,300,300,34,34,0,1,0
0,312,312,65,65,0,1,0
8,356,356,8,8,0,1,0
2,427,427,14,14,0,1,0
4,499,499,54,8,46,2,1

2,110,110,37,37,0,1,0
8,125,125,15,4,11,3,2
7,146,146,13,5,8,2,1
5,180,180,49,49,0,1,0
12,183,183,1,1,0,1,0
11,191,191,46,40,6,3,2
1,251,251,13,1,12,3,2
6,263,263,15,12,3,2,1
0,270,270,6,6,0,1,0
4,299,299,29,13,16,3,2
3,437,437,9,9,0,1,0
10,459,459,132,30,102,4,3
9,473,473,8,8,0,1,0

2,106,106,14,14,0,1,0
1,107,107,67,27,40,3,2
7,168,168,3,3,0,1,0
0,189,189,9,9,0,1,0
5,270,270,29,29,0,1,0
8,318,318,31,31,0,1,0
9,336,336,84,34,50,3,2
3,347,347,5,5,0,1,0
4,442,442,1,1,0,1,0
6,445,445,144,144,0,1,0

10,100,100,3,3,0,1,0
2,152,152,11,11,0,1,0
13,167,167,21,21,0,1,0
3,216,216,15,15,0,1,0
8,218,218,14,2,12,2,1
1,222,222,17,14,3,2,1
9,245,245,9,1,8,3,2
7,256,256,24,24,0,1,0
16,256,256,21,5,16,3,2
6,261,261,58,58,0,1,0
5,287,287,18,18,0,1,0
12,310,310,125,89,36,2,1
14,369,369,2,2,0,1,0
4,383,383,16,16,0,1,0
11,403,403,64,26,38,3,2
15,405,405,4,4,0,1,0
0,472,472,29,5,24,4,3

12,113,113,19,19,0,1,0
16,137,137,16,16,0,1,0
8,186,186,1,1,0,1,0
3,217,217,14,14,0,1,0
10,239,239,78,29,49,2,1
5,259,259,43,33,10,2,1
1,293,293,15,15,0,1,0
4,330,330,1,1,0,1,0
2,331,331,1,1,0,1,0
13,367,367,115,16,99,4,3
9,374,374,2,2,0,1,0
14,381,381,26,26,0,1,0
7,398,398,4,4,0,1,0
0,403,403,20,20,0,1,0
17,405,405,15,5,10,2,1
11,447,447,2,2,0,1,0
15,453,453,49,49,0,1,0
6,463,463,54,54,0,1,0

14,120,120,14,14,0,1,0
2,122,122,5,1,4,2,1
6,125,125,7,7,0,1,0
8,153,153,4,4,0,1,0
15,189,189,25,12,13,2,1
11,207,207,19,19,0,1,0
17,271,271,15,9,6,3,2
1,286,286,8,8,0,1,0
3,301,301,68,68,0,1,0
4,302,302,17,1,16,2,1
10,313,313,7,1,6,3,2
13,358,358,37,37,0,1,0
5,370,370,4,4,0,1,0
18,373,373,20,9,11,2,1
7,420,420,18,6,12,2,1
12,425,425,61,5,56,3,2
16,458,458,96,75,21,2,1
0,460,460,47,15,32,2,1
9,494,494,49,49,0,1,0

5,143,143,2,2,0,1,0
13,157,157,14,5,9,4,3
12,220,220,50,50,0,1,0
10,244,244,29,4,25,2,1
6,290,290,5,5,0,1,0
0,291,291,14,2,12,4,3
7,337,337,135,41,94,4,3
4,339,339,30,30,0,1,0
8,340,340,34,34,0,1,0
11,341,341,18,1,17,2,1
14,359,359,44,11,33,4,3
9,391,391,39,39,0,1,0
1,407,407,51,44,7,2,1
2,473,473,17,17,0,1,0
3,485,485,35,35,0,1,0

6,151,151,6,6,0,1,0
3,154,154,11,11,0,1,0
9,154,154,22,22,0,1,0
10,197,197,16,7,9,2,1
1,198,198,6,6,0,1,0
12,208,208,11,5,6,2,1
8,210,210,7,7,0,1,0
2,219,219,35,21,14,3,2
0,226,226,17,17,0,1,0
13,236,236,67,62,5,2,1
5,253,253,38,28,10,2,1
7,276,276,12,12,0,1,0
11,294,294,53,9,44,4,3
4,419,419,117,117,0,1,0

6,102,102,15,15,0,1,0
9,111,111,15,15,0,1,0
11,139,139,14,2,12,4,3
3,174,174,5,5,0,1,0
8,175,175,19,9,10,2,1
16,270,270,66,40,26,4,3
1,282,282,1,1,0,1,0
15,307,307,64,64,0,1,0
12,307,307,2,2,0,1,0
14,345,345,10,10,0,1,0
4,393,393,38,38,0,1,0
10,416,416,49,37,12,2,1
5,458,458,58,58,0,1,0
7,459,459,4,4,0,1,0
0,461,461,5,5,0,1,0
13,473,473,50,17,33,4,3
2,482,482,68,68,0,1,0

5,105,105,8,8,0,1,0
8,121,121,14,14,0,1,0
11,166,166,9,9,0,1,0
7,200,200,58,58,0,1,0
6,253,253,1,1,0,1,0
3,285,285,59,17,42,3,2
10,289,289,67,7,60,4,3
9,345,345,13,7,6,2,1
1,359,359,11,11,0,1,0
0,365,365,14,8,6,3,2
4,370,370,4,4,0,1,0
2,412,412,212,212,0,1,0

14,161,161,13,13,0,1,0
10,165,165,8,8,0,1,0
15,212,212,20,4,16,2,1
6,241,241,1,1,0,1,0
16,259,259,13,13,0,1,0
9,303,303,41,1,40,4,3
13,340,340,26,26,0,1,0
17,343,343,76,76,0,1,0
4,357,357,17,11,6,3,2
0,359,359,74,28,46,4,3
5,363,363,16,11,5,2,1
12,366,366,96,60,36,3,2
2,373,373,11,11,0,1,0
11,440,440,12,2,10,2,1
3,483,483,9,3,6,2,1
7,485,485,33,17,16,2,1
8,488,488,23,23,0,1,0
1,495,495,76,66,10,2,1

4,106,106,1,1,0,1,0
6,110,110,16,16,0,1,0
15,139,139,48,48,0,1,0
12,142,142,4,4,0,1,0
0,165,165,1,1,0,1,0
16,177,177,7,7,0,1,0
2,181,181,39,3,36,2,1
9,219,219,6,1,5,2,1
13,232,232,30,4,26,3,2
8,258,258,12,12,0,1,0
7,309,309,19,19,0,1,0
11,329,329,24,24,0,1,0
14,338,338,33,24,9,4,3
1,390,390,72,64,8,2,1
5,416,416,27,27,0,1,0
3,419,419,18,10,8,3,2
10,426,426,45,2,43,2,1

10,127,127,13,4,9,2,1
5,145,145,1,1,0,1,0
3,165,165,1,1,0,1,0
0,188,188,30,30,0,1,0
4,194,194,23,5,18,4,3
13,207,207,39,39,0,1,0
6,238,238,3,3,0,1,0
16,288,288,33,13,20,2,1
7,299,299,46,39,7,2,1
11,311,311,8,8,0,1,0
15,321,321,73,37,36,4,3
8,334,334,43,43,0,1,0
9,373,373,3,3,0,1,0
12,385,385,24,18,6,3,2
2,424,424,52,52,0,1,0
14,462,462,42,42,0,1,0
1,491,491,42,42,0,1,0

16,101,101,4,4,0,1,0
18,103,103,10,1,9,2,1
11,119,119,18,18,0,1,0
10,120,120,1,1,0,1,0
15,143,143,13,1,12,4,3
7,193,193,12,12,0,1,0
17,203,203,24,24,0,1,0
14,211,211,26,5,21,2,1
19,283,283,28,12,16,3,2
5,284,284,3,3,0,1,0
1,303,303,3,3,0,1,0
3,327,327,1,1,0,1,0
0,355,355,14,1,13,2,1
8,374,374,9,3,6,3,2
2,398,398,14,14,0,1,0
12,401,401,1,1,0,1,0
4,418,418,62,26,36,4,3
6,421,421,54,44,10,3,2
9,438,438,68,68,0,1,0
20,453,453,113,21,92,4,3
13,480,480,11,5,6,2,1

15,235,235,13,5,8,2,1
2,244,244,45,45,0,1,0
1,308,308,17,1,16,3,2
4,323,323,16,16,0,1,0
3,325,325,37,37,0,1,0
0,362,362,49,49,0,1,0
6,370,370,56,56,0,1,0
8,381,381,12,12,0,1,0
12,398,398,18,18,0,1,0
14,423,423,25,25,0,1,0
16,427,427,98,62,36,3,2
11,434,434,77,77,0,1,0
7,437,437,28,1,27,2,1
10,454,454,29,29,0,1,0
9,465,465,1,1,0,1,0
13,474,474,86,54,32,4,3
5,489,489,7,7,0,1,0

11,107,107,8,1,7,2,1
15,113,113,15,3,12,4,3
19,148,148,4,1,3,2,1
13,189,189,12,12,0,1,0
12,201,201,1,1,0,1,0
7,207,207,11,2,9,2,1
20,234,234,22,16,6,2,1
0,272,272,4,4,0,1,0
23,293,293,18,1,17,3,2
17,298,298,83,6,77,4,3
2,300,300,4,4,0,1,0
18,324,324,84,2,82,3,2
10,352,352,19,10,9,4,3
4,363,363,4,1,3,2,1
14,374,374,9,9,0,1,0
21,394,394,7,7,0,1,0
16,395,395,16,6,10,3,2
3,397,397,38,38,0,1,0
5,402,402,6,6,0,1,0
6,416,416,30,30,0,1,0
9,434,434,19,19,0,1,0
8,459,459,29,29,0,1,0
1,459,459,11,11,0,1,0
22,485,485,35,35,0,1,0

6,134,134,14,8,6,2,1
4,172,172,3,3,0,1,0
5,202,202,22,22,0,1,0
2,205,205,44,12,32,2,1
11,214,214,61,13,48,2,1
8,224,224,1,1,0,1,0
10,231,231,42,1,41,4,3
0,285,285,57,57,0,1,0
9,315,315,26,26,0,1,0
12,388,388,37,37,0,1,0
3,441,441,90,90,0,1,0
7,478,478,26,12,14,3,2
1,497,497,28,28,0,1,0

10,186,186,43,7,36,2,1
4,193,193,13,4,9,2,1
6,226,226,18,18,0,1,0
8,262,262,74,34,40,3,2
0,304,304,7,7,0,1,0
3,316,316,6,6,0,1,0
9,353,353,12,12,0,1,0
2,385,385,160,102,58,3,2
1,391,391,134,54,80,3,2
7,418,418,15,15,0,1,0
5,487,487,40,40,0,1,0

8,121,121,14,14,0,1,0
3,169,169,15,6,9,2,1
1,212,212,7,1,6,2,1
7,218,218,42,20,22,2,1
5,238,238,1,1,0,1,0
15,257,257,18,9,9,2,1
13,290,290,9,1,8,2,1
0,311,311,35,35,0,1,0
2,312,312,11,11,0,1,0
10,344,344,18,18,0,1,0
9,377,377,82,52,30,4,3
14,427,427,23,1,22,3,2
11,433,433,94,11,83,4,3
4,464,464,39,19,20,2,1
6,464,464,64,64,0,1,0
12,487,487,82,82,0,1,0

4,116,116,14,2,12,3,2
8,116,116,33,33,0,1,0
13,122,122,5,5,0,1,0
5,143,143,4,4,0,1,0
6,159,159,5,5,0,1,0
15,172,172,26,18,8,2,1
0,176,176,20,10,10,2,1
11,185,185,31,31,0,1,0
7,192,192,24,6,18,2,1
3,228,228,6,6,0,1,0
9,256,256,46,46,0,1,0
14,343,343,22,22,0,1,0
10,444,444,12,12,0,1,0
1,484,484,23,16,7,2,1
12,487,487,91,28,63,4,3
2,491,491,12,12,0,1,0

9,103,103,2,2,0,1,0
1,140,140,13,13,0,1,0
0,198,198,50,50,0,1,0
3,240,240,14,14,0,1,0
8,240,240,27,9,18,3,2
2,285,285,10,5,5,2,1
4,296,296,100,100,0,1,0
6,382,382,21,21,0,1,0
12,392,392,156,6,150,4,3
11,407,407,27,11,16,2,1
7,443,443,10,10,0,1,0
5,488,488,12,3,9,2,1
10,495,495,65,21,44,2,1

17,102,102,7,7,0,1,0
0,142,142,7,3,4,2,1
20,189,189,39,39,0,1,0
9,205,205,9,1,8,2,1
16,214,214,77,44,33,2,1
8,223,223,17,17,0,1,0
4,248,248,11,11,0,1,0
19,266,266,9,9,0,1,0
15,289,289,17,17,0,1,0
13,293,293,7,7,0,1,0
10,295,295,13,13,0,1,0
12,295,295,19,1,18,2,1
18,315,315,25,25,0,1,0
6,321,321,1,1,0,1,0
11,381,381,47,47,0,1,0
5,381,381,4,4,0,1,0
1,415,415,19,19,0,1,0
7,426,426,29,29,0,1,0
14,452,452,6,6,0,1,0
3,477,477,10,10,0,1,0
2,479,479,88,43,45,4,3

16,144,144,6,6,0,1,0
3,168,168,22,10,12,4,3
12,193,193,22,22,0,1,0
9,206,206,29,10,19,2,1
5,232,232,40,40,0,1,0
17,240,240,13,13,0,1,0
13,242,242,19,19,0,1,0
8,245,245,1,1,0,1,0
0,252,252,1,1,0,1,0
15,255,255,2,2,0,1,0
7,260,260,16,5,11,2,1
4,277,277,2,2,0,1,0
2,281,281,21,11,10,3,2
10,284,284,5,1,4,2,1
1,346,346,37,37,0,1,0
11,396,396,55,55,0,1,0
14,435,435,167,56,111,4,3
6,475,475,38,38,0,1,0

6,110,110,8,8,0,1,0
10,118,118,13,13,0,1,0
11,152,152,11,11,0,1,0
3,157,157,2,2,0,1,0
14,164,164,17,17,0,1,0
7,207,207,9,9,0,1,0
12,214,214,33,15,18,2,1
16,258,258,33,27,6,2,1
9,316,316,2,2,0,1,0
2,325,325,33,6,27,2,1
5,326,326,12,12,0,1,0
13,359,359,31,10,21,4,3
4,411,411,46,24,22,2,1
1,425,425,54,54,0,1,0
0,426,426,92,48,44,3,2
15,430,430,69,59,10,3,2
8,491,491,36,29,7,2,1

11,119,119,10,2,8,3,2
5,121,121,12,12,0,1,0
14,141,141,38,2,36,3,2
0,147,147,42,8,34,3,2
6,152,152,1,1,0,1,0
1,167,167,1,1,0,1,0
12,212,212,1,1,0,1,0
8,228,228,66,66,0,1,0
10,249,249,4,4,0,1,0
7,273,273,22,22,0,1,0
2,365,365,25,2,23,2,1
13,376,376,50,8,42,2,1
4,406,406,19,4,15,4,3
9,442,442,12,12,0,1,0
3,446,446,93,71,22,3,2

3,110,110,11,2,9,2,1
4,113,113,5,5,0,1,0
2,115,115,2,2,0,1,0
12,120,120,39,1,38,3,2
9,170,170,14,6,8,3,2
14,188,188,2,2,0,1,0
6,200,200,13,6,7,2,1
5,220,220,17,12,5,2,1
8,243,243,62,62,0,1,0
0,336,336,32,32,0,1,0
1,388,388,20,20,0,1,0
10,392,392,26,19,7,2,1
7,421,421,7,7,0,1,0
11,432,432,55,8,47,2,1
16,473,473,11,11,0,1,0
13,477,477,38,38,0,1,0
15,489,489,86,68,18,4,3

14,114,114,2,2,0,1,0
4,161,161,10,10,0,1,0
0,176,176,6,6,0,1,0
6,182,182,37,26,11,2,1
10,206,206,2,2,0,1,0
15,214,214,1,1,0,1,0
11,246,246,38,29,9,4,3
9,254,254,24,4,20,2,1
2,276,276,13,13,0,1,0
13,304,304,65,49,16,2,1
5,309,309,43,20,23,2,1
16,334,334,2,2,0,1,0
7,373,373,18,18,0,1,0
1,420,420,46,46,0,1,0
8,436,436,6,2,4,2,1
3,463,463,23,15,8,2,1
12,497,497,202,90,112,4,3

15,124,124,28,28,0,1,0
11,182,182,26,26,0,1,0
12,211,211,32,32,0,1,0
10,257,257,39,1,38,2,1
16,261,261,57,9,48,4,3
6,263,263,35,29,6,3,2
1,266,266,3,3,0,1,0
8,274,274,1,1,0,1,0
13,298,298,13,13,0,1,0
17,299,299,3,3,0,1,0
5,344,344,6,6,0,1,0
7,353,353,11,1,10,3,2
14,355,355,8,2,6,3,2
3,387,387,58,6,52,3,2
2,412,412,26,26,0,1,0
4,414,414,26,26,0,1,0
9,461,461,7,7,0,1,0
0,498,498,81,63,18,2,1

8,140,140,11,11,0,1,0
12,233,233,8,8,0,1,0
3,265,265,31,12,19,2,1
14,284,284,45,24,21,4,3
9,311,311,48,48,0,1,0
1,326,326,6,2,4,2,1
10,374,374,35,28,7,2,1
2,378,378,75,75,0,1,0
5,389,389,20,9,11,4,3
7,395,395,69,31,38,3,2
11,415,415,25,25,0,1,0
6,419,419,44,44,0,1,0
13,429,429,101,101,0,1,0
4,484,484,53,14,39,2,1
0,487,487,13,9,4,2,1

4,113,113,19,19,0,1,0
0,178,178,3,3,0,1,0
11,185,185,54,54,0,1,0
1,196,196,28,28,0,1,0
7,209,209,33,11,22,2,1
9,225,225,20,4,16,3,2
6,237,237,55,55,0,1,0
13,259,259,8,8,0,1,0
12,286,286,8,8,0,1,0
2,296,296,60,60,0,1,0
3,367,367,1,1,0,1,0
10,400,400,26,5,21,2,1
5,416,416,15,6,9,4,3
8,416,416,64,47,17,2,1

4,108,108,23,23,0,1,0
17,140,140,18,7,11,4,3
12,143,143,15,15,0,1,0
14,146,146,13,13,0,1,0
10,211,211,1,1,0,1,0
8,256,256,67,25,42,4,3
0,273,273,1,1,0,1,0
9,284,284,5,5,0,1,0
7,286,286,17,12,5,2,1
5,326,326,14,2,12,2,1
6,328,328,31,21,10,2,1
2,372,372,1,1,0,1,0
1,374,374,35,19,16,2,1
16,390,390,62,43,19,3,2
13,396,396,88,46,42,3,2
3,427,427,4,4,0,1,0
11,436,436,43,43,0,1,0
15,497,497,8,8,0,1,0

16,103,103,18,2,16,4,3
12,113,113,26,4,22,2,1
3,144,144,37,4,33,2,1
1,159,159,3,3,0,1,0
10,197,197,15,12,3,2,1
7,202,202,17,17,0,1,0
8,205,205,8,8,0,1,0
0,242,242,1,1,0,1,0
4,325,325,1,1,0,1,0
5,333,333,26,26,0,1,0
13,334,334,60,38,22,3,2
6,350,350,20,20,0,1,0
14,409,409,28,28,0,1,0
11,419,419,14,14,0,1,0
2,433,433,55,15,40,3,2
9,472,472,63,63,0,1,0
15,487,487,25,25,0,1,0

8,111,111,7,3,4,2,1
2,144,144,37,5,32,3,2
10,145,145,18,18,0,1,0
5,162,162,11,2,9,2,1
9,179,179,9,9,0,1,0
3,191,191,9,9,0,1,0
6,206,206,40,6,34,3,2
11,314,314,33,33,0,1,0
0,315,315,31,31,0,1,0
1,339,339,2,2,0,1,0
4,447,447,145,52,93,4,3
7,478,478,108,90,18,3,2
12,496,496,29,29,0,1,0

15,137,137,3,3,0,1,0
13,158,158,17,2,15,4,3
11,168,168,16,6,10,2,1
0,174,174,63,13,50,3,2
2,177,177,1,1,0,1,0
5,181,181,22,22,0,1,0
14,182,182,25,25,0,1,0
12,192,192,10,10,0,1,0
9,237,237,4,4,0,1,0
16,283,283,42,9,33,2,1
1,312,312,41,8,33,2,1
8,401,401,49,12,37,4,3
10,416,416,105,78,27,3,2
6,421,421,12,3,9,3,2
3,425,425,1,1,0,1,0
7,442,442,3,3,0,1,0
4,455,455,2,2,0,1,0

8,190,190,14,3,11,2,1
4,198,198,2,2,0,1,0
13,207,207,12,6,6,2,1
9,263,263,25,11,14,3,2
11,291,291,61,31,30,4,3
5,304,304,37,1,36,2,1
1,306,306,78,78,0,1,0
12,357,357,29,5,24,2,1
0,371,371,3,3,0,1,0
3,393,393,82,39,43,2,1
6,415,415,57,57,0,1,0
10,443,443,44,44,0,1,0
2,459,459,28,10,18,4,3
7,498,498,95,53,42,2,1

6,116,116,3,3,0,1,0
12,143,143,7,7,0,1,0
9,173,173,3,3,0,1,0
5,210,210,51,51,0,1,0
11,232,232,79,52,27,4,3
10,296,296,46,39,7,2,1
1,334,334,24,24,0,1,0
8,336,336,48,48,0,1,0
4,337,337,40,40,0,1,0
0,380,380,109,109,0,1,0
7,389,389,11,5,6,2,1
13,420,420,33,3,30,3,2
2,422,422,4,4,0,1,0
3,485,485,24,24,0,1,0

11,116,116,3,3,0,1,0
3,130,130,1,1,0,1,0
6,144,144,12,3,9,4,3
12,168,168,9,2,7,2,1
14,168,168,3,3,0,1,0
10,221,221,1,1,0,1,0
4,257,257,1,1,0,1,0
7,267,267,45,7,38,2,1
1,285,285,1,1,0,1,0
19,286,286,9,1,8,2,1
15,291,291,89,71,18,4,3
13,294,294,13,6,7,2,1
18,304,304,70,36,34,3,2
17,341,341,27,27,0,1,0
5,344,344,25,25,0,1,0
9,349,349,61,27,34,3,2
16,376,376,39,39,0,1,0
8,463,463,7,4,3,2,1
0,472,472,82,82,0,1,0
2,477,477,8,8,0,1,0

14,107,107,6,6,0,1,0
1,136,136,2,2,0,1,0
4,137,137,21,21,0,1,0
5,142,142,2,2,0,1,0
10,157,157,5,5,0,1,0
16,157,157,5,5,0,1,0
12,175,175,17,2,15,2,1
17,265,265,109,40,69,3,2
2,291,291,2,2,0,1,0
7,326,326,12,4,8,3,2
3,370,370,8,8,0,1,0
6,375,375,54,36,18,2,1
8,397,397,101,11,90,4,3
15,446,446,66,66,0,1,0
0,457,457,22,1,21,4,3
9,468,468,36,28,8,2,1
11,472,472,4,4,0,1,0
13,477,477,32,32,0,1,0

8,109,109,12,12,0,1,0
4,110,110,4,4,0,1,0
2,142,142,5,5,0,1,0
7,252,252,4,4,0,1,0
1,260,260,58,58,0,1,0
0,278,278,8,2,6,3,2
16,288,288,12,12,0,1,0
5,305,305,25,25,0,1,0
11,305,305,9,9,0,1,0
13,313,313,11,11,0,1,0
3,323,323,2,2,0,1,0
9,328,328,24,24,0,1,0
18,333,333,51,51,0,1,0
12,337,337,31,23,8,2,1
14,362,362,51,51,0,1,0
15,382,382,100,28,72,4,3
6,396,396,22,5,17,2,1
19,439,439,74,25,49,3,2
10,478,478,7,2,5,2,1
17,487,487,4,4,0,1,0

0,126,126,25,25,0,1,0
12,130,130,24,24,0,1,0
13,199,199,15,15,0,1,0
2,234,234,23,3,20,2,1
9,249,249,17,8,9,2,1
1,266,266,43,43,0,1,0
3,326,326,36,36,0,1,0
6,338,338,14,5,9,2,1
4,342,342,1,1,0,1,0
7,354,354,25,25,0,1,0
11,379,379,26,4,22,2,1
10,396,396,6,6,0,1,0
14,404,404,53,8,45,4,3
8,410,410,110,20,90,3,2
5,438,438,52,10,42,4,3

15,125,125,4,4,0,1,0
17,126,126,9,4,5,2,1
6,135,135,23,15,8,2,1
0,144,144,11,11,0,1,0
1,154,154,1,1,0,1,0
3,229,229,11,5,6,2,1
11,271,271,12,12,0,1,0
4,275,275,39,39,0,1,0
16,328,328,75,75,0,1,0
12,335,335,45,1,44,3,2
8,369,369,9,9,0,1,0
10,390,390,73,16,57,4,3
9,421,421,6,6,0,1,0
2,441,441,12,12,0,1,0
7,476,476,14,14,0,1,0
13,490,490,9,1,8,3,2
18,490,490,55,43,12,4,3
14,493,493,108,16,92,3,2
5,496,496,15,15,0,1,0

12,120,120,11,11,0,1,0
0,136,136,16,16,0,1,0
9,136,136,1,1,0,1,0
21,139,139,10,10,0,1,0
8,180,180,1,1,0,1,0
20,193,193,49,49,0,1,0
2,210,210,10,10,0,1,0
13,215,215,4,4,0,1,0
19,221,221,1,1,0,1,0
17,264,264,8,1,7,2,1
3,272,272,11,11,0,1,0
10,303,303,11,5,6,2,1
6,314,314,16,16,0,1,0
11,323,323,1,1,0,1,0
7,326,326,21,12,9,4,3
14,335,335,45,1,44,3,2
18,342,342,23,4,19,2,1
1,352,352,57,15,42,4,3
4,372,372,5,5,0,1,0
5,372,372,3,3,0,1,0
15,397,397,10,10,0,1,0
16,463,463,164,164,0,1,0

9,105,105,1,1,0,1,0
18,129,129,55,49,6,2,1
7,180,180,8,5,3,2,1
17,245,245,31,2,29,2,1
11,274,274,4,4,0,1,0
14,305,305,47,9,38,3,2
15,314,314,28,28,0,1,0
16,321,321,27,27,0,1,0
3,340,340,4,4,0,1,0
13,359,359,18,18,0,1,0
0,361,361,1,1,0,1,0
2,372,372,1,1,0,1,0
20,407,407,30,24,6,2,1
19,415,415,3,3,0,1,0
5,418,418,39,13,26,2,1
1,438,438,23,23,0,1,0
12,440,440,79,17,62,4,3
10,442,442,5,5,0,1,0
8,443,443,24,24,0,1,0
21,443,443,3,3,0,1,0
6,448,448,1,1,0,1,0
4,458,458,55,55,0,1,0

3,112,112,5,5,0,1,0
12,112,112,16,16,0,1,0
9,178,178,1,1,0,1,0
4,179,179,6,3,3,2,1
5,187,187,7,7,0,1,0
17,220,220,14,14,0,1,0
8,222,222,9,4,5,2,1
2,235,235,17,8,9,3,2
11,237,237,40,28,12,4,3
7,249,249,13,4,9,4,3
13,268,268,10,10,0,1,0
6,277,277,2,2,0,1,0
15,287,287,19,8,11,2,1
16,335,335,118,56,62,3,2
19,361,361,38,11,27,2,1
1,363,363,2,2,0,1,0
10,364,364,70,70,0,1,0
0,373,373,1,1,0,1,0
14,406,406,22,22,0,1,0
18,468,468,61,14,47,2,1

10,101,101,2,2,0,1,0
7,125,125,34,2,32,4,3
2,148,148,20,20,0,1,0
11,153,153,17,11,6,3,2
12,205,205,27,27,0,1,0
8,211,211,31,12,19,4,3
1,221,221,26,26,0,1,0
5,256,256,45,45,0,1,0
9,289,289,11,11,0,1,0
0,306,306,9,9,0,1,0
6,473,473,47,26,21,2,1
3,489,489,53,32,21,2,1
4,497,497,117,117,0,1,0

22,135,135,14,14,0,1,0
13,143,143,23,4,19,2,1
15,157,157,5,5,0,1,0
1,159,159,8,8,0,1,0
18,162,162,7,2,5,2,1
9,178,178,9,3,6,3,2
12,192,192,1,1,0,1,0
10,219,219,27,17,10,2,1
2,221,221,1,1,0,1,0
8,233,233,6,6,0,1,0
7,245,245,13,13,0,1,0
11,277,277,1,1,0,1,0
21,278,278,23,5,18,2,1
20,289,289,29,29,0,1,0
4,295,295,5,1,4,2,1
16,396,396,51,13,38,3,2
5,397,397,13,13,0,1,0
0,408,408,51,51,0,1,0
19,434,434,61,49,12,3,2
3,461,461,9,1,8,3,2
6,476,476,29,29,0,1,0
14,479,479,18,18,0,1,0
17,490,490,107,107,0,1,0

17,164,164,6,6,0,1,0
0,165,165,6,6,0,1,0
4,209,209,24,24,0,1,0
5,236,236,18,18,0,1,0
1,267,267,5,5,0,1,0
10,269,269,17,7,10,3,2
11,273,273,8,8,0,1,0
12,273,273,44,8,36,2,1
16,300,300,17,17,0,1,0
7,314,314,43,43,0,1,0
9,314,314,24,24,0,1,0
14,354,354,102,29,73,3,2
3,356,356,25,9,16,3,2
8,368,368,20,8,12,4,3
2,414,414,17,17,0,1,0
6,422,422,48,22,26,3,2
15,447,447,28,10,18,4,3
13,486,486,86,30,56,3,2

6,147,147,6,3,3,2,1
10,157,157,26,17,9,4,3
13,161,161,7,4,3,2,1
8,208,208,14,14,0,1,0
0,209,209,17,17,0,1,0
2,229,229,27,27,0,1,0
3,236,236,14,14,0,1,0
11,257,257,9,9,0,1,0
5,273,273,14,10,4,2,1
15,275,275,30,7,23,2,1
12,277,277,14,9,5,2,1
9,320,320,34,34,0,1,0
7,356,356,34,22,12,2,1
1,358,358,6,6,0,1,0
14,389,389,122,122,0,1,0
16,424,424,98,98,0,1,0
4,441,441,1,1,0,1,0
17,499,499,17,17,0,1,0

16,109,109,7,2,5,2,1
13,158,158,2,2,0,1,0
4,181,181,6,6,0,1,0
14,200,200,19,19,0,1,0
10,201,201,3,3,0,1,0
2,232,232,15,3,12,3,2
5,236,236,34,26,8,2,1
0,245,245,41,11,30,4,3
3,277,277,1,1,0,1,0
12,295,295,1,1,0,1,0
1,307,307,26,26,0,1,0
9,355,355,10,6,4,2,1
6,431,431,32,32,0,1,0
11,440,440,22,22,0,1,0
7,450,450,70,2,68,4,3
8,466,466,21,4,17,2,1
15,493,493,281,262,19,2,1

10,110,110,7,7,0,1,0
2,136,136,18,18,0,1,0
3,168,168,6,3,3,2,1
9,259,259,6,6,0,1,0
11,268,268,23,4,19,4,3
8,270,270,19,19,0,1,0
7,276,276,9,9,0,1,0
14,302,302,35,35,0,1,0
19,311,311,45,45,0,1,0
18,316,316,40,2,38,2,1
6,369,369,8,8,0,1,0
5,371,371,4,4,0,1,0
17,372,372,24,9,15,2,1
0,379,379,31,4,27,3,2
16,382,382,24,24,0,1,0
13,403,403,85,41,44,2,1
15,413,413,35,4,31,2,1
4,420,420,44,44,0,1,0
1,454,454,7,2,5,2,1
12,498,498,61,28,33,2,1

5,110,110,7,7,0,1,0
0,184,184,3,3,0,1,0
4,207,207,10,10,0,1,0
9,219,219,1,1,0,1,0
15,224,224,37,1,36,4,3
8,235,235,4,4,0,1,0
13,237,237,8,5,3,2,1
11,238,238,5,5,0,1,0
17,242,242,76,34,42,3,2
1,258,258,1,1,0,1,0
14,293,293,11,5,6,3,2
3,370,370,6,3,3,2,1
7,373,373,83,15,68,3,2
12,387,387,92,62,30,4,3
6,469,469,63,17,46,3,2
16,483,483,3,3,0,1,0
2,490,490,10,2,8,3,2
10,495,495,126,75,51,4,3

0,117,117,13,13,0,1,0
10,140,140,2,2,0,1,0
8,184,184,10,1,9,2,1
15,238,238,39,39,0,1,0
14,238,238,6,1,5,2,1
9,293,293,26,5,21,4,3
5,294,294,20,7,13,2,1
12,333,333,25,7,18,4,3
3,335,335,3,3,0,1,0
7,351,351,24,24,0,1,0
16,406,406,27,27,0,1,0
4,409,409,80,80,0,1,0
2,433,433,24,10,14,2,1
6,469,469,18,18,0,1,0
11,488,488,10,4,6,2,1
1,490,490,56,56,0,1,0
13,500,500,223,185,38,2,1

9,139,139,8,8,0,1,0
5,154,154,1,1,0,1,0
13,155,155,48,30,18,2,1
2,163,163,65,65,0,1,0
0,190,190,10,10,0,1,0
14,202,202,2,2,0,1,0
12,246,246,33,33,0,1,0
4,321,321,28,16,12,2,1
3,323,323,10,6,4,2,1
8,325,325,22,1,21,4,3
10,330,330,42,5,37,3,2
1,355,355,33,33,0,1,0
7,362,362,23,16,7,2,1
11,426,426,47,47,0,1,0
6,427,427,29,15,14,2,1

21,101,101,3,3,0,1,0
15,130,130,55,31,24,4,3
13,133,133,1,1,0,1,0
8,136,136,2,2,0,1,0
7,159,159,2,2,0,1,0
18,173,173,6,6,0,1,0
3,187,187,17,17,0,1,0
14,197,197,4,4,0,1,0
20,241,241,19,19,0,1,0
2,275,275,28,8,20,3,2
6,330,330,9,6,3,2,1
5,349,349,63,63,0,1,0
10,367,367,5,5,0,1,0
17,368,368,11,11,0,1,0
19,370,370,15,15,0,1,0
12,372,372,20,20,0,1,0
0,419,419,11,1,10,3,2
1,432,432,27,27,0,1,0
16,453,453,83,2,81,4,3
11,479,479,11,5,6,3,2
4,481,481,79,63,16,3,2
9,500,500,2,2,0,1,0

6,124,124,5,5,0,1,0
9,143,143,1,1,0,1,0
0,185,185,20,7,13,2,1
11,201,201,10,4,6,3,2
5,237,237,19,2,17,2,1
12,262,262,25,21,4,2,1
1,275,275,68,50,18,4,3
7,284,284,93,93,0,1,0
8,295,295,47,14,33,4,3
10,314,314,43,43,0,1,0
4,333,333,17,17,0,1,0
2,334,334,90,58,32,2,1
3,334,334,16,2,14,2,1

11,137,137,1,1,0,1,0
12,149,149,9,1,8,2,1
14,173,173,15,15,0,1,0
15,228,228,10,10,0,1,0
10,229,229,63,13,50,2,1
9,312,312,37,15,22,3,2
3,360,360,7,1,6,3,2
0,369,369,35,35,0,1,0
4,389,389,33,24,9,2,1
2,392,392,17,5,12,3,2
13,393,393,69,29,40,2,1
1,394,394,16,2,14,3,2
6,394,394,63,63,0,1,0
7,426,426,73,5,68,3,2
8,444,444,1,1,0,1,0
16,454,454,78,78,0,1,0
5,497,497,33,29,4,2,1

6,119,119,8,2,6,2,1
2,127,127,7,2,5,2,1
4,157,157,22,14,8,2,1
1,172,172,15,15,0,1,0
3,173,173,26,26,0,1,0
11,182,182,3,3,0,1,0
14,207,207,16,16,0,1,0
7,270,270,36,36,0,1,0
12,303,303,24,24,0,1,0
13,336,336,90,90,0,1,0
0,356,356,35,32,3,2,1
10,367,367,4,4,0,1,0
9,432,432,87,87,0,1,0
8,435,435,69,26,43,2,1
5,461,461,33,33,0,1,0

9,147,147,7,7,0,1,0
2,148,148,22,22,0,1,0
13,189,189,35,35,0,1,0
12,211,211,1,1,0,1,0
11,220,220,67,67,0,1,0
10,222,222,6,6,0,1,0
0,227,227,16,8,8,3,2
6,258,258,54,2,52,3,2
7,291,291,51,12,39,4,3
8,294,294,22,22,0,1,0
4,347,347,21,21,0,1,0
1,375,375,71,71,0,1,0
5,430,430,14,10,4,2,1
3,499,499,45,6,39,4,3

2,105,105,13,5,8,2,1
5,158,158,43,43,0,1,0
7,161,161,10,10,0,1,0
0,169,169,24,24,0,1,0
1,190,190,27,7,20,3,2
9,287,287,37,1,36,3,2
8,291,291,15,2,13,2,1
4,305,305,78,78,0,1,0
10,346,346,72,21,51,4,3
11,390,390,15,1,14,3,2
3,418,418,57,15,42,4,3
6,491,491,28,1,27,2,1

1,160,160,23,23,0,1,0
13,183,183,17,1,16,2,1
8,193,193,39,13,26,2,1
4,269,269,17,2,15,3,2
3,287,287,9,3,6,3,2
2,292,292,25,25,0,1,0
6,337,337,1,1,0,1,0
12,345,345,48,48,0,1,0
5,389,389,25,25,0,1,0
7,408,408,68,68,0,1,0
14,413,413,47,6,41,2,1
15,422,422,13,1,12,3,2
11,438,438,28,11,17,3,2
9,444,444,31,1,30,3,2
10,446,446,134,134,0,1,0
0,449,449,20,20,0,1,0

7,111,111,6,6,0,1,0
15,130,130,5,5,0,1,0
10,172,172,6,6,0,1,0
9,177,177,18,8,10,3,2
14,196,196,14,1,13,2,1
11,208,208,30,30,0,1,0
5,227,227,4,4,0,1,0
4,265,265,7,7,0,1,0
12,269,269,54,54,0,1,0
1,312,312,22,22,0,1,0
13,335,335,9,9,0,1,0
3,341,341,23,23,0,1,0
8,396,396,25,16,9,4,3
0,416,416,32,25,7,2,1
2,425,425,48,48,0,1,0
16,434,434,130,119,11,2,1
6,459,459,98,2,96,4,3

4,102,102,3,3,0,1,0
10,105,105,1,1,0,1,0
22,122,122,1,1,0,1,0
14,168,168,5,5,0,1,0
11,174,174,11,11,0,1,0
24,198,198,9,5,4,2,1
3,204,204,19,19,0,1,0
0,220,220,1,1,0,1,0
2,223,223,13,13,0,1,0
19,244,244,8,8,0,1,0
7,269,269,26,26,0,1,0
20,287,287,10,10,0,1,0
6,296,296,1,1,0,1,0
21,306,306,141,131,10,2,1
26,323,323,35,27,8,3,2
16,332,332,5,5,0,1,0
5,354,354,3,3,0,1,0
17,359,359,20,20,0,1,0
25,365,365,42,42,0,1,0
1,384,384,18,4,14,3,2
8,387,387,35,11,24,4,3
9,398,398,5,5,0,1,0
18,401,401,3,3,0,1,0
12,431,431,37,37,0,1,0
15,474,474,9,9,0,1,0
13,486,486,20,20,0,1,0
23,495,495,20,20,0,1,0

4,119,119,8,2,6,3,2
13,143,143,33,33,0,1,0
8,181,181,32,20,12,4,3
10,189,189,9,1,8,3,2
2,245,245,1,1,0,1,0
12,269,269,27,4,23,2,1
1,284,284,1,1,0,1,0
5,286,286,14,14,0,1,0
3,289,289,19,19,0,1,0
7,314,314,11,11,0,1,0
14,324,324,17,17,0,1,0
15,344,344,4,4,0,1,0
11,362,362,13,1,12,3,2
6,386,386,115,16,99,4,3
0,435,435,45,7,38,3,2
9,484,484,160,113,47,2,1

1,116,116,4,4,0,1,0
2,120,120,6,6,0,1,0
16,122,122,6,6,0,1,0
14,149,149,16,4,12,4,3
6,156,156,18,18,0,1,0
18,193,193,2,2,0,1,0
13,195,195,9,2,7,2,1
0,217,217,4,4,0,1,0
11,232,232,7,7,0,1,0
3,247,247,18,18,0,1,0
10,266,266,9,1,8,3,2
7,285,285,18,18,0,1,0
12,297,297,139,60,79,4,3
15,300,300,34,34,0,1,0
9,326,326,27,27,0,1,0
8,338,338,41,41,0,1,0
5,365,365,37,34,3,2,1
4,441,441,35,35,0,1,0
17,482,482,11,11,0,1,0

3,119,119,6,6,0,1,0
0,124,124,7,7,0,1,0
10,157,157,19,8,11,4,3
11,262,262,1,1,0,1,0
5,263,263,17,17,0,1,0
13,265,265,4,4,0,1,0
8,309,309,23,10,13,2,1
16,316,316,11,11,0,1,0
15,317,317,118,61,57,3,2
12,355,355,46,46,0,1,0
14,364,364,48,48,0,1,0
6,370,370,55,35,20,2,1
1,390,390,17,17,0,1,0
2,418,418,46,22,24,4,3
7,431,431,53,53,0,1,0
4,437,437,54,54,0,1,0
9,483,483,3,3,0,1,0

6,126,126,23,2,21,4,3
10,142,142,55,1,54,3,2
9,169,169,8,8,0,1,0
11,195,195,8,1,7,2,1
0,206,206,5,1,4,2,1
2,266,266,32,17,15,4,3
5,273,273,19,5,14,2,1
13,313,313,13,5,8,2,1
12,319,319,14,14,0,1,0
1,354,354,54,54,0,1,0
7,418,418,93,90,3,2,1
3,429,429,4,4,0,1,0
8,439,439,45,45,0,1,0
4,450,450,9,9,0,1,0
14,451,451,69,30,39,4,3

0,100,100,15,7,8,3,2
15,111,111,21,5,16,3,2
11,123,123,4,4,0,1,0
8,161,161,9,5,4,2,1
12,212,212,24,24,0,1,0
9,248,248,1,1,0,1,0
4,259,259,1,1,0,1,0
10,293,293,26,26,0,1,0
1,312,312,12,12,0,1,0
13,313,313,39,2,37,2,1
6,320,320,7,3,4,2,1
3,347,347,86,86,0,1,0
2,368,368,13,13,0,1,0
16,393,393,95,86,9,4,3
14,421,421,14,14,0,1,0
7,427,427,35,35,0,1,0
5,472,472,77,19,58,3,2

14,154,154,8,8,0,1,0
18,156,156,1,1,0,1,0
1,161,161,8,4,4,2,1
13,175,175,14,14,0,1,0
3,183,183,3,3,0,1,0
16,184,184,93,34,59,4,3
8,224,224,5,2,3,2,1
2,262,262,30,30,0,1,0
9,332,332,18,9,9,4,3
11,351,351,92,86,6,2,1
15,381,381,30,14,16,3,2
17,412,412,1,1,0,1,0
0,414,414,18,7,11,2,1
6,416,416,41,21,20,2,1
12,416,416,37,27,10,3,2
10,421,421,10,10,0,1,0
7,426,426,46,6,40,2,1
4,446,446,1,1,0,1,0
5,491,491,3,3,0,1,0

13,157,157,6,1,5,2,1
3,162,162,17,17,0,1,0
11,172,172,10,3,7,2,1
5,212,212,39,28,11,2,1
8,253,253,47,47,0,1,0
0,321,321,59,59,0,1,0
6,323,323,23,23,0,1,0
12,339,339,53,53,0,1,0
15,341,341,30,30,0,1,0
4,344,344,6,6,0,1,0
7,366,366,3,3,0,1,0
9,393,393,81,81,0,1,0
1,397,397,1,1,0,1,0
10,450,450,97,39,58,3,2
2,459,459,20,5,15,4,3
14,483,483,23,14,9,2,1

8,107,107,2,2,0,1,0
16,117,117,2,2,0,1,0
3,119,119,13,4,9,2,1
10,138,138,14,14,0,1,0
2,141,141,1,1,0,1,0
13,166,166,9,9,0,1,0
18,185,185,28,20,8,3,2
15,188,188,13,13,0,1,0
20,208,208,15,1,14,3,2
4,303,303,17,8,9,2,1
0,315,315,46,46,0,1,0
6,335,335,50,50,0,1,0
9,341,341,3,3,0,1,0
14,344,344,10,1,9,4,3
17,405,405,157,28,129,4,3
12,409,409,21,21,0,1,0
5,420,420,5,5,0,1,0
1,436,436,10,10,0,1,0
7,438,438,27,14,13,2,1
11,451,451,1,1,0,1,0
19,476,476,43,43,0,1,0

6,100,100,15,2,13,4,3
3,129,129,8,8,0,1,0
0,137,137,1,1,0,1,0
5,167,167,5,5,0,1,0
12,172,172,8,8,0,1,0
2,173,173,14,14,0,1,0
15,190,190,14,4,10,2,1
10,223,223,48,18,30,3,2
7,225,225,4,4,0,1,0
1,232,232,25,25,0,1,0
9,235,235,40,20,20,3,2
11,249,249,59,27,32,2,1
4,265,265,42,42,0,1,0
14,271,271,6,2,4,2,1
13,365,365,19,15,4,2,1
8,411,411,77,56,21,2,1

0,116,116,6,3,3,2,1
14,122,122,27,2,25,2,1
17,156,156,4,4,0,1,0
4,162,162,3,3,0,1,0
1,211,211,29,29,0,1,0
8,241,241,22,22,0,1,0
3,249,249,51,51,0,1,0
12,254,254,20,20,0,1,0
9,294,294,2,2,0,1,0
13,297,297,97,25,72,3,2
15,312,312,28,28,0,1,0
5,325,325,20,9,11,2,1
2,370,370,11,3,8,3,2
16,407,407,24,24,0,1,0
11,410,410,9,9,0,1,0
10,449,449,46,11,35,2,1
7,459,459,38,11,27,4,3
6,463,463,7,7,0,1,0

7,109,109,9,9,0,1,0
0,143,143,3,3,0,1,0
3,180,180,34,34,0,1,0
4,222,222,22,10,12,2,1
1,257,257,48,48,0,1,0
5,271,271,20,20,0,1,0
10,302,302,28,28,0,1,0
12,373,373,2,2,0,1,0
6,379,379,5,5,0,1,0
11,393,393,179,101,78,4,3
8,397,397,58,58,0,1,0
2,445,445,97,31,66,4,3
13,484,484,2,2,0,1,0
9,491,491,13,13,0,1,0

3,106,106,3,3,0,1,0
11,132,132,9,1,8,3,2
7,135,135,6,6,0,1,0
20,168,168,6,1,5,2,1
18,182,182,14,4,10,2,1
15,187,187,17,17,0,1,0
8,238,238,1,1,0,1,0
2,248,248,10,10,0,1,0
9,276,276,4,4,0,1,0
1,291,291,32,3,29,2,1
10,303,303,51,9,42,4,3
6,309,309,3,3,0,1,0
16,338,338,17,11,6,3,2
13,350,350,32,25,7,2,1
5,362,362,1,1,0,1,0
12,374,374,28,28,0,1,0
14,377,377,134,23,111,4,3
4,402,402,23,23,0,1,0
17,428,428,67,4,63,4,3
0,468,468,41,34,7,2,1
19,486,486,22,22,0,1,0

5,121,121,9,9,0,1,0
2,148,148,1,1,0,1,0
13,155,155,15,15,0,1,0
20,169,169,3,3,0,1,0
7,182,182,1,1,0,1,0
19,214,214,16,3,13,3,2
17,227,227,49,49,0,1,0
0,265,265,11,1,10,2,1
4,281,281,16,7,9,4,3
1,291,291,41,41,0,1,0
15,318,318,82,79,3,2,1
8,352,352,7,4,3,2,1
12,353,353,76,24,52,4,3
10,398,398,3,3,0,1,0
16,413,413,31,31,0,1,0
3,428,428,5,5,0,1,0
9,450,450,15,2,13,4,3
11,458,458,10,7,3,2,1
18,487,487,82,82,0,1,0
6,490,490,35,17,18,2,1
14,498,498,3,3,0,1,0

4,138,138,3,3,0,1,0
6,140,140,9,9,0,1,0
2,170,170,3,3,0,1,0
9,203,203,19,19,0,1,0
8,214,214,18,4,14,3,2
7,243,243,6,6,0,1,0
12,285,285,19,19,0,1,0
3,332,332,88,14,74,3,2
5,335,335,1,1,0,1,0
0,356,356,34,34,0,1,0
1,372,372,148,43,105,4,3
10,450,450,33,6,27,2,1
11,489,489,200,200,0,1,0

3,104,104,2,2,0,1,0
4,117,117,12,12,0,1,0
16,117,117,9,9,0,1,0
7,130,130,2,2,0,1,0
6,145,145,6,6,0,1,0
12,187,187,1,1,0,1,0
2,193,193,12,3,9,4,3
13,202,202,31,31,0,1,0
9,242,242,16,16,0,1,0
8,245,245,5,5,0,1,0
17,259,259,16,16,0,1,0
1,298,298,47,23,24,3,2
10,306,306,30,27,3,2,1
5,318,318,15,15,0,1,0
14,343,343,24,5,19,2,1
0,377,377,9,3,6,3,2
11,379,379,56,12,44,2,1
15,382,382,157,109,48,3,2
18,389,389,16,4,12,3,2

2,101,101,9,9,0,1,0
14,166,166,3,3,0,1,0
12,193,193,18,12,6,3,2
3,212,212,6,2,4,2,1
6,221,221,48,48,0,1,0
13,243,243,29,29,0,1,0
8,260,260,18,18,0,1,0
4,264,264,33,33,0,1,0
11,284,284,7,7,0,1,0
15,330,330,44,11,33,2,1
9,334,334,46,46,0,1,0
5,351,351,9,1,8,3,2
10,433,433,127,93,34,4,3
0,435,435,14,14,0,1,0
1,442,442,13,7,6,3,2
7,479,479,89,43,46,3,2

4,129,129,14,14,0,1,0
1,140,140,49,31,18,2,1
0,158,158,8,5,3,2,1
7,230,230,26,12,14,3,2
5,261,261,24,24,0,1,0
9,285,285,12,12,0,1,0
8,289,289,140,65,75,4,3
6,301,301,16,7,9,2,1
11,341,341,6,6,0,1,0
12,392,392,28,2,26,2,1
2,430,430,9,9,0,1,0
3,459,459,82,82,0,1,0
10,494,494,15,15,0,1,0

15,109,109,31,31,0,1,0
6,116,116,13,7,6,3,2
9,179,179,23,23,0,1,0
12,265,265,31,31,0,1,0
5,266,266,13,13,0,1,0
1,272,272,12,12,0,1,0
4,323,323,53,53,0,1,0
7,331,331,30,30,0,1,0
13,357,357,41,14,27,2,1
17,381,381,70,34,36,4,3
0,392,392,25,25,0,1,0
16,436,436,9,3,6,2,1
10,466,466,40,18,22,3,2
2,467,467,19,19,0,1,0
3,476,476,3,3,0,1,0
8,488,488,8,8,0,1,0
11,493,493,10,3,7,2,1
14,494,494,35,5,30,4,3

1,136,136,4,4,0,1,0
11,173,173,54,54,0,1,0
13,195,195,8,8,0,1,0
5,278,278,33,33,0,1,0
2,312,312,20,5,15,2,1
10,330,330,8,8,0,1,0
4,334,334,57,14,43,2,1
6,345,345,14,4,10,3,2
3,352,352,19,19,0,1,0
14,376,376,7,2,5,2,1
7,391,391,23,23,0,1,0
12,429,429,23,23,0,1,0
0,451,451,119,19,100,3,2
8,473,473,106,91,15,2,1
9,494,494,70,70,0,1,0

11,126,126,8,3,5,2,1
2,155,155,20,6,14,3,2
1,162,162,29,1,28,3,2
4,189,189,23,23,0,1,0
3,247,247,54,16,38,2,1
10,266,266,8,8,0,1,0
8,278,278,14,14,0,1,0
6,283,283,49,49,0,1,0
12,361,361,113,75,38,3,2
5,374,374,6,6,0,1,0
7,442,442,47,5,42,2,1
0,458,458,63,26,37,2,1
9,499,499,38,38,0,1,0

7,101,101,27,2,25,2,1
6,104,104,2,2,0,1,0
16,136,136,7,1,6,3,2
4,231,231,12,12,0,1,0
1,258,258,5,1,4,2,1
3,276,276,51,20,31,4,3
9,276,276,13,13,0,1,0
14,288,288,84,69,15,4,3
0,301,301,41,41,0,1,0
11,320,320,40,21,19,2,1
8,322,322,6,6,0,1,0
10,371,371,54,34,20,3,2
13,380,380,28,28,0,1,0
2,389,389,21,3,18,4,3
15,404,404,26,3,23,2,1
12,454,454,28,28,0,1,0
5,491,491,1,1,0,1,0

17,102,102,23,2,21,3,2
16,143,143,3,3,0,1,0
1,149,149,38,2,36,4,3
7,150,150,1,1,0,1,0
2,165,165,1,1,0,1,0
4,169,169,15,6,9,2,1
9,186,186,3,3,0,1,0
14,204,204,22,2,20,2,1
13,207,207,39,39,0,1,0
8,208,208,21,11,10,2,1
15,213,213,32,32,0,1,0
5,226,226,21,7,14,3,2
3,274,274,9,9,0,1,0
12,319,319,5,5,0,1,0
10,386,386,6,6,0,1,0
6,388,388,47,8,39,2,1
0,398,398,26,26,0,1,0
11,400,400,46,6,40,3,2

18,109,109,5,1,4,2,1
17,118,118,9,9,0,1,0
15,118,118,7,7,0,1,0
8,119,119,1,1,0,1,0
13,169,169,2,2,0,1,0
12,175,175,5,5,0,1,0
2,182,182,8,8,0,1,0
9,201,201,29,29,0,1,0
4,210,210,43,43,0,1,0
1,226,226,8,8,0,1,0
10,249,249,19,19,0,1,0
3,302,302,8,5,3,2,1
16,308,308,30,4,26,4,3
7,322,322,14,14,0,1,0
6,355,355,20,5,15,4,3
11,358,358,31,31,0,1,0
5,371,371,7,7,0,1,0
20,427,427,28,10,18,3,2
14,439,439,92,10,82,4,3
19,444,444,115,103,12,4,3
0,478,478,9,9,0,1,0

5,112,112,2,2,0,1,0
18,140,140,5,5,0,1,0
17,140,140,1,1,0,1,0
16,163,163,54,54,0,1,0
12,177,177,16,4,12,3,2
19,183,183,5,5,0,1,0
11,196,196,1,1,0,1,0
8,255,255,28,28,0,1,0
10,277,277,20,14,6,2,1
3,306,306,31,2,29,2,1
1,311,311,1,1,0,1,0
7,327,327,21,6,15,4,3
13,327,327,4,4,0,1,0
2,384,384,10,10,0,1,0
14,421,421,146,98,48,4,3
15,433,433,24,24,0,1,0
0,443,443,2,2,0,1,0
6,465,465,56,14,42,2,1
9,474,474,20,20,0,1,0
4,493,493,71,71,0,1,0

1,104,104,4,4,0,1,0
0,130,130,1,1,0,1,0
5,165,165,15,5,10,3,2
4,192,192,2,2,0,1,0
8,251,251,15,15,0,1,0
7,259,259,8,1,7,2,1
6,261,261,31,31,0,1,0
9,281,281,87,47,40,3,2
11,313,313,2,2,0,1,0
2,361,361,31,1,30,3,2
16,381,381,74,35,39,4,3
15,409,409,64,4,60,4,3
12,415,415,113,35,78,4,3
10,426,426,5,5,0,1,0
3,438,438,22,22,0,1,0
13,445,445,43,43,0,1,0
14,475,475,33,33,0,1,0

9,104,104,30,30,0,1,0
0,130,130,13,3,10,2,1
3,171,171,8,2,6,2,1
6,171,171,45,45,0,1,0
15,242,242,26,16,10,2,1
4,252,252,13,13,0,1,0
7,268,268,14,1,13,2,1
12,275,275,91,91,0,1,0
8,284,284,5,5,0,1,0
2,294,294,44,44,0,1,0
11,299,299,4,4,0,1,0
10,352,352,3,3,0,1,0
14,374,374,13,13,0,1,0
1,378,378,29,9,20,2,1
5,411,411,18,18,0,1,0
13,458,458,13,1,12,4,3

4,158,158,3,3,0,1,0
12,161,161,7,7,0,1,0
16,169,169,12,4,8,3,2
13,247,247,23,23,0,1,0
0,262,262,36,27,9,4,3
6,266,266,4,4,0,1,0
11,268,268,85,47,38,2,1
14,321,321,50,50,0,1,0
15,326,326,43,43,0,1,0
5,345,345,3,3,0,1,0
2,405,405,37,37,0,1,0
8,422,422,74,59,15,2,1
10,425,425,1,1,0,1,0
1,444,444,10,4,6,3,2
9,456,456,64,52,12,4,3
7,478,478,17,9,8,2,1
3,497,497,77,17,60,3,2

12,103,103,26,26,0,1,0
15,118,118,7,1,6,2,1
8,149,149,9,4,5,2,1
5,157,157,6,6,0,1,0
4,176,176,27,3,24,3,2
6,192,192,3,3,0,1,0
13,205,205,7,7,0,1,0
2,313,313,8,2,6,3,2
0,314,314,102,20,82,4,3
7,362,362,31,31,0,1,0
1,374,374,29,29,0,1,0
14,417,417,21,3,18,2,1
10,428,428,22,14,8,2,1
11,468,468,33,33,0,1,0
3,484,484,11,5,6,2,1
9,484,484,145,145,0,1,0

2,111,111,17,14,3,2,1
9,120,120,4,4,0,1,0
5,123,123,20,10,10,2,1
8,140,140,22,4,18,3,2
12,148,148,37,37,0,1,0
6,255,255,6,6,0,1,0
7,255,255,9,9,0,1,0
0,288,288,88,30,58,3,2
10,334,334,100,100,0,1,0
1,372,372,2,2,0,1,0
11,374,374,6,6,0,1,0
3,379,379,46,32,14,2,1
4,489,489,28,19,9,4,3

18,105,105,18,18,0,1,0
7,116,116,3,3,0,1,0
2,122,122,1,1,0,1,0
21,127,127,12,12,0,1,0
8,132,132,1,1,0,1,0
13,144,144,1,1,0,1,0
1,167,167,15,3,12,4,3
12,182,182,1,1,0,1,0
16,200,200,22,22,0,1,0
11,250,250,19,10,9,4,3
0,261,261,6,6,0,1,0
15,273,273,34,12,22,3,2
4,278,278,16,16,0,1,0
9,279,279,38,38,0,1,0
17,323,323,73,10,63,4,3
19,337,337,5,1,4,2,1
14,343,343,29,3,26,2,1
5,387,387,18,18,0,1,0
3,404,404,5,5,0,1,0
20,486,486,36,4,32,3,2
6,496,496,42,1,41,2,1
10,499,499,68,68,0,1,0

2,125,125,1,1,0,1,0
11,180,180,3,3,0,1,0
14,210,210,37,37,0,1,0
10,285,285,8,8,0,1,0
13,286,286,7,7,0,1,0
5,298,298,15,15,0,1,0
1,331,331,52,41,11,2,1
3,356,356,31,1,30,3,2
7,359,359,30,12,18,3,2
6,360,360,64,24,40,3,2
9,371,371,1,1,0,1,0
4,401,401,87,66,21,3,2
12,418,418,59,31,28,3,2
8,434,434,182,168,14,2,1
0,446,446,9,9,0,1,0

0,110,110,31,31,0,1,0
2,122,122,1,1,0,1,0
8,145,145,17,17,0,1,0
14,155,155,43,34,9,2,1
10,157,157,31,31,0,1,0
9,250,250,20,20,0,1,0
11,250,250,6,2,4,2,1
4,256,256,9,1,8,3,2
7,293,293,48,4,44,2,1
12,354,354,39,39,0,1,0
6,363,363,2,2,0,1,0
3,414,414,92,72,20,3,2
13,429,429,2,2,0,1,0
1,432,432,15,1,14,3,2
5,436,436,22,14,8,2,1

1,193,193,115,5,110,4,3
11,198,198,70,70,0,1,0
7,205,205,1,1,0,1,0
4,356,356,1,1,0,1,0
5,379,379,10,10,0,1,0
10,410,410,2,2,0,1,0
2,411,411,14,14,0,1,0
0,428,428,11,11,0,1,0
3,439,439,63,41,22,2,1
6,452,452,37,37,0,1,0
9,478,478,34,4,30,3,2
8,483,483,130,90,40,2,1

4,158,158,11,3,8,3,2
13,188,188,77,40,37,4,3
6,246,246,7,3,4,2,1
11,251,251,7,7,0,1,0
7,277,277,9,9,0,1,0
14,285,285,13,13,0,1,0
3,314,314,33,33,0,1,0
9,329,329,6,6,0,1,0
2,355,355,36,36,0,1,0
10,365,365,59,47,12,2,1
8,383,383,42,42,0,1,0
1,418,418,8,8,0,1,0
12,432,432,17,17,0,1,0
0,443,443,117,66,51,4,3
5,495,495,90,28,62,4,3

3,110,110,1,1,0,1,0
8,140,140,11,11,0,1,0
18,163,163,21,5,16,2,1
19,174,174,16,9,7,2,1
5,198,198,21,21,0,1,0
17,200,200,10,4,6,2,1
7,207,207,7,7,0,1,0
1,226,226,10,10,0,1,0
16,263,263,96,34,62,4,3
20,268,268,24,17,7,3,2
6,275,275,20,20,0,1,0
11,327,327,10,4,6,3,2
2,365,365,14,14,0,1,0
21,390,390,32,9,23,2,1
0,392,392,15,6,9,4,3
15,400,400,38,10,28,3,2
13,417,417,66,52,14,2,1
9,433,433,5,5,0,1,0
4,443,443,14,14,0,1,0
14,457,457,3,3,0,1,0
10,473,473,21,6,15,2,1
22,483,483,2,2,0,1,0
12,490,490,1,1,0,1,0

13,118,118,4,4,0,1,0
3,125,125,12,6,6,2,1
2,136,136,16,8,8,3,2
9,150,150,8,8,0,1,0
4,182,182,4,4,0,1,0
6,191,191,55,43,12,4,3
5,281,281,23,14,9,4,3
12,322,322,139,16,123,4,3
10,324,324,1,1,0,1,0
1,351,351,66,66,0,1,0
8,399,399,58,11,47,2,1
0,400,400,3,3,0,1,0
7,400,400,11,4,7,2,1
11,436,436,53,53,0,1,0

7,130,130,8,8,0,1,0
3,149,149,11,11,0,1,0
13,204,204,12,12,0,1,0
14,211,211,34,34,0,1,0
16,242,242,2,2,0,1,0
5,256,256,19,9,10,3,2
11,260,260,12,12,0,1,0
2,267,267,12,8,4,2,1
10,269,269,43,43,0,1,0
0,291,291,29,29,0,1,0
15,294,294,100,2,98,4,3
12,321,321,13,10,3,2,1
4,372,372,5,1,4,2,1
8,390,390,47,11,36,3,2
1,403,403,40,34,6,2,1
9,411,411,35,35,0,1,0
6,438,438,56,19,37,4,3

15,117,117,3,3,0,1,0
16,131,131,4,4,0,1,0
3,157,157,12,12,0,1,0
0,168,168,18,18,0,1,0
12,175,175,21,7,14,3,2
8,180,180,12,12,0,1,0
14,186,186,12,2,10,3,2
4,192,192,26,26,0,1,0
7,284,284,19,19,0,1,0
5,288,288,3,3,0,1,0
2,325,325,2,2,0,1,0
13,334,334,179,76,103,4,3
11,345,345,1,1,0,1,0
9,351,351,27,12,15,3,2
1,404,404,56,15,41,3,2
17,415,415,9,1,8,3,2
6,445,445,8,3,5,2,1
18,481,481,9,5,4,2,1
10,487,487,46,25,21,4,3

8,174,174,31,31,0,1,0
4,180,180,5,1,4,2,1
13,193,193,77,77,0,1,0
7,195,195,7,3,4,2,1
11,210,210,5,5,0,1,0
6,246,246,2,2,0,1,0
16,263,263,34,15,19,3,2
15,293,293,19,1,18,4,3
1,313,313,69,12,57,4,3
2,329,329,10,10,0,1,0
12,352,352,57,52,5,2,1
10,383,383,12,4,8,3,2
3,395,395,75,15,60,3,2
9,415,415,18,9,9,2,1
0,441,441,24,24,0,1,0
5,461,461,6,6,0,1,0
14,481,481,1,1,0,1,0

5,111,111,4,4,0,1,0
7,140,140,9,9,0,1,0
4,170,170,27,17,10,3,2
9,201,201,10,3,7,2,1
11,213,213,7,3,4,2,1
0,267,267,34,23,11,2,1
12,303,303,32,8,24,4,3
13,303,303,102,102,0,1,0
3,311,311,43,36,7,2,1
10,330,330,7,4,3,2,1
15,331,331,60,12,48,3,2
6,347,347,18,10,8,2,1
1,348,348,54,15,39,4,3
14,402,402,34,34,0,1,0
2,420,420,23,4,19,2,1
8,445,445,6,2,4,2,1

9,106,106,7,7,0,1,0
12,117,117,14,1,13,2,1
15,131,131,8,8,0,1,0
7,157,157,1,1,0,1,0
3,161,161,1,1,0,1,0
11,169,169,18,7,11,3,2
1,203,203,27,27,0,1,0
14,218,218,56,4,52,3,2
6,383,383,8,8,0,1,0
16,387,387,45,13,32,3,2
10,396,396,21,3,18,4,3
8,399,399,68,68,0,1,0
4,423,423,31,2,29,3,2
5,424,424,31,18,13,2,1
0,436,436,20,20,0,1,0
2,438,438,92,92,0,1,0
13,454,454,46,10,36,3,2

2,128,128,8,8,0,1,0
5,145,145,3,3,0,1,0
10,166,166,20,12,8,3,2
12,172,172,6,6,0,1,0
14,180,180,24,2,22,2,1
8,202,202,23,17,6,3,2
6,212,212,46,46,0,1,0
13,213,213,22,22,0,1,0
4,223,223,17,5,12,3,2
3,244,244,49,2,47,2,1
7,328,328,54,54,0,1,0
1,378,378,3,3,0,1,0
11,427,427,23,23,0,1,0
0,457,457,24,10,14,3,2
9,471,471,119,57,62,3,2

4,131,131,4,1,3,2,1
12,140,140,8,8,0,1,0
6,141,141,2,2,0,1,0
16,173,173,28,28,0,1,0
0,176,176,4,4,0,1,0
5,207,207,6,6,0,1,0
3,282,282,4,4,0,1,0
7,287,287,81,81,0,1,0
13,346,346,45,30,15,4,3
14,368,368,29,16,13,2,1
15,377,377,106,94,12,4,3
9,379,379,29,1,28,3,2
1,424,424,29,29,0,1,0
11,427,427,11,11,0,1,0
8,428,428,35,35,0,1,0
2,457,457,83,19,64,3,2
10,478,478,36,4,32,3,2

0,102,102,19,1,18,4,3
8,159,159,3,3,0,1,0
11,281,281,20,5,15,2,1
3,303,303,3,3,0,1,0
6,324,324,1,1,0,1,0
9,328,328,90,36,54,3,2
2,363,363,37,15,22,3,2
1,366,366,16,16,0,1,0
7,391,391,94,67,27,2,1
12,394,394,10,10,0,1,0
14,423,423,85,39,46,3,2
13,441,441,88,76,12,3,2
4,451,451,95,95,0,1,0
10,460,460,8,8,0,1,0
5,468,468,2,2,0,1,0

13,127,127,22,15,7,2,1
5,135,135,41,41,0,1,0
3,171,171,3,3,0,1,0
10,172,172,36,36,0,1,0
0,189,189,5,5,0,1,0
8,239,239,26,1,25,4,3
11,308,308,28,28,0,1,0
1,310,310,13,7,6,3,2
7,314,314,73,9,64,4,3
6,335,335,18,18,0,1,0
15,358,358,43,43,0,1,0
12,411,411,65,15,50,3,2
14,438,438,15,9,6,3,2
4,456,456,5,5,0,1,0
2,482,482,3,3,0,1,0
9,495,495,13,3,10,2,1

5,150,150,3,3,0,1,0
9,152,152,3,3,0,1,0
7,236,236,22,15,7,2,1
3,255,255,25,11,14,3,2
10,313,313,4,4,0,1,0
0,348,348,62,19,43,3,2
13,402,402,27,8,19,2,1
4,410,410,97,74,23,2,1
15,424,424,124,16,108,4,3
1,427,427,15,3,12,3,2
12,431,431,36,36,0,1,0
6,434,434,20,20,0,1,0
8,488,488,39,39,0,1,0
11,490,490,115,115,0,1,0
14,493,493,51,51,0,1,0
2,500,500,7,7,0,1,0

16,156,156,18,4,14,3,2
1,156,156,2,2,0,1,0
10,165,165,14,14,0,1,0
12,178,178,62,6,56,4,3
4,184,184,6,6,0,1,0
17,196,196,16,16,0,1,0
9,213,213,8,8,0,1,0
0,238,238,27,27,0,1,0
2,264,264,1,1,0,1,0
11,266,266,19,19,0,1,0
8,274,274,20,20,0,1,0
5,280,280,18,5,13,3,2
13,315,315,56,56,0,1,0
15,363,363,1,1,0,1,0
7,385,385,3,3,0,1,0
3,406,406,89,48,41,2,1
14,457,457,7,7,0,1,0
6,458,458,71,71,0,1,0

6,108,108,2,2,0,1,0
2,149,149,18,18,0,1,0
3,179,179,4,4,0,1,0
18,183,183,35,35,0,1,0
14,190,190,41,29,12,2,1
4,245,245,1,1,0,1,0
17,265,265,3,3,0,1,0
8,283,283,1,1,0,1,0
1,290,290,9,9,0,1,0
9,298,298,9,9,0,1,0
20,306,306,32,11,21,2,1
12,308,308,56,42,14,3,2
15,340,340,10,2,8,2,1
5,413,413,31,31,0,1,0
19,413,413,48,12,36,3,2
13,432,432,49,23,26,2,1
0,465,465,63,35,28,2,1
16,467,467,65,65,0,1,0
10,469,469,19,13,6,3,2
11,483,483,3,3,0,1,0
7,490,490,9,9,0,1,0

13,116,116,13,13,0,1,0
3,120,120,8,8,0,1,0
5,122,122,22,22,0,1,0
11,140,140,1,1,0,1,0
8,204,204,18,18,0,1,0
1,219,219,15,15,0,1,0
4,228,228,52,52,0,1,0
9,275,275,26,26,0,1,0
6,309,309,53,53,0,1,0
2,324,324,4,4,0,1,0
10,372,372,54,23,31,2,1
14,415,415,36,20,16,2,1
7,418,418,21,12,9,4,3
0,436,436,10,4,6,2,1
12,449,449,128,13,115,4,3

5,104,104,1,1,0,1,0
8,115,115,3,3,0,1,0
12,157,157,27,9,18,3,2
16,172,172,16,16,0,1,0
11,178,178,15,7,8,3,2
4,191,191,9,3,6,2,1
13,193,193,34,19,15,4,3
7,209,209,63,3,60,4,3
10,242,242,5,5,0,1,0
14,265,265,31,7,24,4,3
0,289,289,8,8,0,1,0
6,317,317,29,21,8,2,1
9,359,359,4,4,0,1,0
17,376,376,20,1,19,2,1
15,421,421,63,48,15,4,3
3,437,437,10,10,0,1,0
2,473,473,57,57,0,1,0
1,484,484,18,18,0,1,0
18,486,486,27,27,0,1,0

16,109,109,13,5,8,3,2
4,123,123,4,1,3,2,1
15,130,130,21,21,0,1,0
11,138,138,18,8,10,3,2
10,161,161,5,5,0,1,0
1,180,180,26,26,0,1,0
0,214,214,12,4,8,2,1
7,220,220,3,3,0,1,0
5,237,237,19,19,0,1,0
12,248,248,62,24,38,4,3
14,254,254,24,24,0,1,0
8,266,266,34,15,19,2,1
13,300,300,11,2,9,2,1
3,341,341,4,4,0,1,0
9,352,352,46,46,0,1,0
6,400,400,34,34,0,1,0
2,425,425,51,30,21,2,1

7,105,105,9,9,0,1,0
6,108,108,3,3,0,1,0
9,109,109,12,12,0,1,0
12,116,116,2,2,0,1,0
1,210,210,24,20,4,2,1
11,252,252,14,1,13,2,1
2,290,290,28,28,0,1,0
0,297,297,58,26,32,2,1
4,310,310,23,5,18,4,3
3,327,327,70,34,36,4,3
8,343,343,167,110,57,4,3
10,363,363,14,4,10,3,2
5,492,492,52,52,0,1,0

9,114,114,3,3,0,1,0
12,124,124,27,27,0,1,0
4,128,128,11,3,8,2,1
8,129,129,16,11,5,2,1
10,208,208,10,10,0,1,0
3,235,235,56,34,22,3,2
7,236,236,30,30,0,1,0
6,257,257,58,58,0,1,0
11,295,295,32,32,0,1,0
0,332,332,29,11,18,4,3
13,352,352,61,61,0,1,0
5,389,389,11,11,0,1,0
1,454,454,4,1,3,2,1
2,495,495,63,27,36,3,2

9,148,148,4,4,0,1,0
13,190,190,2,2,0,1,0
10,206,206,1,1,0,1,0
3,216,216,12,12,0,1,0
0,231,231,7,2,5,2,1
11,278,278,1,1,0,1,0
6,319,319,26,23,3,2,1
12,325,325,21,21,0,1,0
5,368,368,46,18,28,2,1
1,417,417,36,24,12,2,1
4,438,438,111,99,12,4,3
7,440,440,210,210,0,1,0
8,454,454,103,103,0,1,0
2,472,472,80,80,0,1,0

0,180,180,41,41,0,1,0
7,181,181,42,5,37,2,1
1,184,184,25,25,0,1,0
12,209,209,1,1,0,1,0
8,228,228,51,51,0,1,0
9,261,261,9,9,0,1,0
13,333,333,5,5,0,1,0
4,336,336,1,1,0,1,0
2,355,355,20,20,0,1,0
10,366,366,16,7,9,2,1
5,381,381,32,32,0,1,0
14,393,393,53,53,0,1,0
11,429,429,152,5,147,4,3
3,472,472,2,2,0,1,0
6,494,494,29,29,0,1,0

12,139,139,14,5,9,2,1
8,165,165,12,12,0,1,0
10,187,187,8,8,0,1,0
16,197,197,17,8,9,2,1
11,205,205,6,1,5,2,1
1,294,294,9,9,0,1,0
5,301,301,37,12,25,4,3
0,315,315,6,6,0,1,0
13,325,325,51,3,48,3,2
14,341,341,3,3,0,1,0
9,343,343,46,46,0,1,0
15,355,355,141,96,45,4,3
7,357,357,79,48,31,2,1
2,365,365,10,2,8,3,2
4,393,393,9,3,6,2,1
6,399,399,6,6,0,1,0
3,459,459,62,14,48,3,2

5,147,147,9,9,0,1,0
3,165,165,11,3,8,2,1
4,170,170,7,7,0,1,0
13,174,174,26,4,22,3,2
6,191,191,31,17,14,4,3
7,191,191,5,5,0,1,0
12,230,230,10,10,0,1,0
14,244,244,74,37,37,2,1
9,260,260,3,3,0,1,0
8,318,318,61,61,0,1,0
2,330,330,22,8,14,3,2
0,373,373,47,47,0,1,0
10,398,398,10,10,0,1,0
11,417,417,38,38,0,1,0
1,499,499,125,75,50,3,2

5,123,123,18,18,0,1,0
2,183,183,27,3,24,3,2
11,188,188,14,14,0,1,0
10,204,204,63,35,28,3,2
4,253,253,37,37,0,1,0
15,258,258,11,3,8,3,2
7,269,269,1,1,0,1,0
0,294,294,17,17,0,1,0
13,307,307,57,15,42,2,1
6,308,308,9,9,0,1,0
12,328,328,11,1,10,2,1
8,382,382,40,40,0,1,0
14,412,412,6,6,0,1,0
1,425,425,22,8,14,2,1
3,441,441,50,17,33,2,1
9,499,499,76,76,0,1,0

2,173,173,23,23,0,1,0
6,189,189,1,1,0,1,0
13,195,195,15,15,0,1,0
16,200,200,2,2,0,1,0
3,222,222,19,19,0,1,0
9,239,239,26,26,0,1,0
7,251,251,16,16,0,1,0
10,280,280,13,1,12,3,2
14,310,310,159,159,0,1,0
1,354,354,9,9,0,1,0
8,357,357,11,11,0,1,0
0,362,362,10,1,9,2,1
12,371,371,11,11,0,1,0
15,373,373,30,14,16,3,2
5,377,377,115,115,0,1,0
11,494,494,29,29,0,1,0
4,500,500,9,9,0,1,0

12,108,108,3,3,0,1,0
0,226,226,19,7,12,3,2
6,231,231,9,9,0,1,0
3,238,238,5,5,0,1,0
7,241,241,7,7,0,1,0
9,249,249,5,2,3,2,1
17,270,270,9,9,0,1,0
2,309,309,30,18,12,3,2
15,321,321,16,5,11,2,1
8,342,342,5,1,4,2,1
5,367,367,36,36,0,1,0
4,379,379,7,4,3,2,1
19,387,387,42,14,28,4,3
1,390,390,99,96,3,2,1
18,394,394,6,6,0,1,0
10,396,396,15,5,10,3,2
16,424,424,50,50,0,1,0
13,445,445,208,169,39,2,1
11,468,468,30,30,0,1,0
14,492,492,10,5,5,2,1

7,138,138,12,12,0,1,0
13,146,146,7,4,3,2,1
3,167,167,40,40,0,1,0
5,173,173,17,8,9,4,3
4,190,190,12,12,0,1,0
0,236,236,18,18,0,1,0
11,284,284,76,76,0,1,0
2,341,341,64,64,0,1,0
9,394,394,29,21,8,3,2
8,409,409,96,24,72,4,3
14,414,414,9,6,3,2,1
1,424,424,11,8,3,2,1
10,443,443,69,33,36,3,2
12,443,443,3,3,0,1,0
6,492,492,11,11,0,1,0

8,111,111,16,16,0,1,0
10,119,119,16,16,0,1,0
13,128,128,9,4,5,2,1
9,145,145,8,8,0,1,0
7,153,153,1,1,0,1,0
14,169,169,3,3,0,1,0
15,180,180,74,64,10,3,2
3,187,187,37,10,27,4,3
11,216,216,2,2,0,1,0
4,238,238,12,12,0,1,0
6,255,255,10,5,5,2,1
1,266,266,21,21,0,1,0
2,308,308,1,1,0,1,0
0,379,379,22,11,11,2,1
5,390,390,65,17,48,2,1
16,455,455,19,5,14,2,1
12,456,456,61,56,5,2,1

15,127,127,23,15,8,3,2
10,143,143,7,2,5,2,1
12,183,183,36,36,0,1,0
1,196,196,7,7,0,1,0
4,201,201,35,35,0,1,0
0,215,215,2,2,0,1,0
17,236,236,16,16,0,1,0
2,254,254,63,34,29,2,1
5,277,277,1,1,0,1,0
16,281,281,43,6,37,2,1
11,288,288,11,11,0,1,0
13,322,322,5,5,0,1,0
3,334,334,17,17,0,1,0
14,420,420,67,1,66,3,2
7,424,424,25,25,0,1,0
6,437,437,47,47,0,1,0
8,445,445,2,2,0,1,0
9,475,475,31,3,28,2,1

1,112,112,4,4,0,1,0
9,130,130,18,18,0,1,0
3,148,148,25,25,0,1,0
12,198,198,13,3,10,3,2
6,205,205,33,33,0,1,0
11,231,231,10,10,0,1,0
8,243,243,54,54,0,1,0
0,267,267,25,1,24,2,1
5,301,301,25,25,0,1,0
10,309,309,15,6,9,2,1
7,413,413,56,56,0,1,0
4,460,460,98,98,0,1,0
2,494,494,103,80,23,2,1

5,105,105,18,2,16,3,2
10,133,133,37,10,27,4,3
9,149,149,8,8,0,1,0
6,152,152,18,10,8,2,1
8,162,162,10,10,0,1,0
0,166,166,13,4,9,2,1
11,179,179,40,29,11,2,1
12,208,208,29,7,22,4,3
1,294,294,19,19,0,1,0
14,297,297,17,1,16,3,2
7,305,305,33,6,27,4,3
4,345,345,43,22,21,4,3
2,427,427,35,29,6,3,2
3,457,457,25,25,0,1,0
13,491,491,2,2,0,1,0

15,112,112,17,17,0,1,0
11,152,152,28,7,21,2,1
3,158,158,1,1,0,1,0
16,159,159,1,1,0,1,0
10,190,190,7,3,4,2,1
13,191,191,42,24,18,4,3
9,209,209,2,2,0,1,0
1,250,250,14,14,0,1,0
0,279,279,1,1,0,1,0
14,316,316,53,53,0,1,0
7,321,321,55,29,26,2,1
4,335,335,23,23,0,1,0
12,342,342,19,19,0,1,0
6,363,363,35,25,10,2,1
8,373,373,26,26,0,1,0
2,486,486,84,18,66,4,3
5,494,494,73,11,62,4,3

12,106,106,25,1,24,4,3
5,107,107,4,4,0,1,0
11,109,109,7,7,0,1,0
13,118,118,11,11,0,1,0
2,186,186,4,4,0,1,0
7,186,186,2,2,0,1,0
10,191,191,46,46,0,1,0
1,225,225,18,13,5,2,1
4,228,228,52,4,48,3,2
9,267,267,28,13,15,4,3
8,306,306,22,22,0,1,0
0,334,334,8,8,0,1,0
3,387,387,119,101,18,3,2
6,432,432,41,2,39,4,3
14,446,446,4,4,0,1,0

8,170,170,10,10,0,1,0
0,171,171,40,12,28,3,2
5,195,195,48,48,0,1,0
4,202,202,27,5,22,2,1
6,232,232,3,3,0,1,0
2,260,260,15,8,7,2,1
9,272,272,70,1,69,4,3
1,308,308,130,83,47,4,3
10,338,338,11,3,8,2,1
3,396,396,35,35,0,1,0
7,400,400,29,29,0,1,0

8,118,118,2,2,0,1,0
1,123,123,6,6,0,1,0
13,139,139,28,28,0,1,0
7,148,148,38,38,0,1,0
3,154,154,6,6,0,1,0
11,166,166,24,19,5,2,1
12,175,175,11,1,10,2,1
4,211,211,8,4,4,2,1
16,211,211,33,13,20,2,1
5,227,227,8,3,5,2,1
2,258,258,2,2,0,1,0
14,259,259,29,29,0,1,0
15,298,298,1,1,0,1,0
6,411,411,30,30,0,1,0
9,425,425,7,7,0,1,0
0,471,471,87,2,85,4,3
17,473,473,65,5,60,3,2
10,485,485,41,41,0,1,0

14,105,105,12,3,9,2,1
1,118,118,7,7,0,1,0
5,119,119,1,1,0,1,0
15,135,135,8,8,0,1,0
4,199,199,3,3,0,1,0
13,226,226,8,8,0,1,0
12,245,245,48,48,0,1,0
9,271,271,17,17,0,1,0
11,288,288,20,17,3,2,1
3,332,332,5,5,0,1,0
7,339,339,46,46,0,1,0
0,345,345,122,100,22,3,2
8,349,349,28,28,0,1,0
10,378,378,107,71,36,3,2
6,426,426,28,22,6,3,2
2,475,475,33,21,12,4,3

8,143,143,21,15,6,2,1
9,166,166,6,3,3,2,1
1,240,240,49,49,0,1,0
11,257,257,6,3,3,2,1
2,294,294,3,3,0,1,0
5,294,294,90,90,0,1,0
3,298,298,86,86,0,1,0
7,314,314,54,54,0,1,0
4,320,320,1,1,0,1,0
0,369,369,109,77,32,2,1
10,377,377,17,17,0,1,0
6,498,498,43,40,3,2,1

5,105,105,1,1,0,1,0
8,112,112,10,4,6,2,1
4,116,116,27,27,0,1,0
14,119,119,26,26,0,1,0
0,209,209,9,9,0,1,0
3,210,210,37,19,18,2,1
1,230,230,20,10,10,2,1
10,243,243,4,4,0,1,0
11,244,244,40,40,0,1,0
12,324,324,98,53,45,4,3
2,335,335,14,14,0,1,0
13,349,349,6,6,0,1,0
6,439,439,39,16,23,2,1
9,448,448,7,1,6,3,2
7,490,490,60,15,45,4,3

10,137,137,15,15,0,1,0
6,152,152,41,36,5,2,1
4,163,163,13,13,0,1,0
12,214,214,37,28,9,4,3
3,230,230,23,23,0,1,0
11,294,294,88,43,45,2,1
14,323,323,20,6,14,3,2
13,343,343,9,9,0,1,0
0,345,345,7,7,0,1,0
1,352,352,21,9,12,2,1
2,409,409,41,41,0,1,0
9,420,420,36,36,0,1,0
5,435,435,47,11,36,3,2
8,492,492,25,25,0,1,0
7,500,500,32,32,0,1,0

5,187,187,51,51,0,1,0
3,213,213,26,11,15,4,3
1,226,226,44,44,0,1,0
2,227,227,1,1,0,1,0
7,261,261,10,10,0,1,0
6,271,271,22,9,13,2,1
4,281,281,28,4,24,4,3
10,281,281,1,1,0,1,0
11,353,353,78,33,45,4,3
13,383,383,9,6,3,2,1
0,402,402,11,1,10,3,2
9,417,417,47,21,26,3,2
12,429,429,146,41,105,4,3
8,444,444,31,20,11,2,1

12,117,117,38,2,36,4,3
2,137,137,53,29,24,3,2
6,137,137,3,3,0,1,0
1,173,173,2,2,0,1,0
7,215,215,15,15,0,1,0
5,217,217,4,4,0,1,0
8,283,283,8,8,0,1,0
14,295,295,26,26,0,1,0
4,311,311,2,2,0,1,0
0,355,355,35,35,0,1,0
10,404,404,56,56,0,1,0
13,416,416,30,30,0,1,0
9,417,417,31,5,26,3,2
11,480,480,40,27,13,2,1
3,481,481,91,91,0,1,0

19,108,108,22,10,12,3,2
20,130,130,33,9,24,3,2
4,166,166,20,20,0,1,0
9,170,170,15,15,0,1,0
3,210,210,19,7,12,3,2
1,218,218,35,35,0,1,0
0,218,218,2,2,0,1,0
6,229,229,1,1,0,1,0
14,231,231,20,20,0,1,0
10,240,240,5,1,4,2,1
2,243,243,4,4,0,1,0
12,258,258,1,1,0,1,0
15,262,262,13,3,10,2,1
7,277,277,19,19,0,1,0
16,306,306,34,34,0,1,0
17,358,358,14,14,0,1,0
11,370,370,48,48,0,1,0
8,389,389,13,7,6,3,2
18,391,391,30,30,0,1,0
5,416,416,11,11,0,1,0
13,436,436,12,12,0,1,0

18,110,110,25,17,8,3,2
15,114,114,3,3,0,1,0
17,172,172,50,50,0,1,0
20,175,175,9,9,0,1,0
1,182,182,47,47,0,1,0
19,212,212,23,17,6,2,1
6,213,213,16,6,10,3,2
12,224,224,1,1,0,1,0
10,289,289,4,4,0,1,0
3,305,305,11,11,0,1,0
4,343,343,48,48,0,1,0
7,381,381,2,2,0,1,0
11,388,388,29,29,0,1,0
9,401,401,8,8,0,1,0
13,403,403,17,8,9,2,1
2,424,424,10,4,6,3,2
8,431,431,36,36,0,1,0
0,448,448,5,5,0,1,0
14,452,452,30,30,0,1,0
5,486,486,6,6,0,1,0
16,495,495,27,27,0,1,0

5,117,117,1,1,0,1,0
19,172,172,13,5,8,2,1
4,195,195,1,1,0,1,0
16,213,213,52,52,0,1,0
10,224,224,27,27,0,1,0
8,225,225,1,1,0,1,0
3,258,258,15,15,0,1,0
18,258,258,30,20,10,2,1
12,263,263,16,5,11,2,1
21,293,293,32,22,10,3,2
20,305,305,13,13,0,1,0
14,314,314,3,3,0,1,0
13,315,315,1,1,0,1,0
9,323,323,71,71,0,1,0
11,363,363,15,15,0,1,0
6,371,371,32,32,0,1,0
7,384,384,24,24,0,1,0
1,409,409,39,12,27,2,1
2,420,420,10,7,3,2,1
0,423,423,1,1,0,1,0
17,467,467,55,55,0,1,0
15,480,480,51,51,0,1,0

10,207,207,10,5,5,2,1
9,258,258,63,21,42,4,3
3,274,274,25,16,9,4,3
0,285,285,35,14,21,3,2
2,320,320,22,8,14,3,2
13,325,325,44,16,28,3,2
14,354,354,25,25,0,1,0
1,356,356,78,71,7,2,1
5,378,378,60,60,0,1,0
4,383,383,14,14,0,1,0
12,384,384,30,3,27,3,2
11,396,396,28,18,10,3,2
7,416,416,24,24,0,1,0
6,431,431,20,12,8,3,2
8,452,452,73,43,30,2,1

3,169,169,8,8,0,1,0
10,196,196,33,3,30,2,1
6,225,225,44,24,20,2,1
12,228,228,8,1,7,2,1
9,254,254,6,6,0,1,0
4,258,258,3,3,0,1,0
11,264,264,31,15,16,2,1
13,278,278,5,5,0,1,0
1,331,331,24,2,22,3,2
8,336,336,91,49,42,3,2
2,337,337,44,12,32,2,1
7,423,423,76,40,36,4,3
0,443,443,60,60,0,1,0
5,498,498,105,105,0,1,0

2,202,202,33,33,0,1,0
5,207,207,17,17,0,1,0
9,209,209,40,40,0,1,0
3,227,227,30,30,0,1,0
6,234,234,35,35,0,1,0
8,255,255,7,7,0,1,0
10,362,362,40,40,0,1,0
1,398,398,46,37,9,2,1
7,425,425,83,6,77,4,3
0,429,429,167,132,35,2,1
4,460,460,25,25,0,1,0

16,162,162,13,13,0,1,0
11,169,169,1,1,0,1,0
2,171,171,5,1,4,2,1
0,188,188,3,3,0,1,0
18,199,199,28,13,15,4,3
8,202,202,27,27,0,1,0
12,217,217,3,3,0,1,0
10,226,226,4,4,0,1,0
3,248,248,6,6,0,1,0
15,317,317,43,43,0,1,0
6,323,323,16,3,13,2,1
17,342,342,4,4,0,1,0
13,382,382,113,73,40,2,1
14,405,405,56,56,0,1,0
5,432,432,33,33,0,1,0
4,470,470,47,47,0,1,0
1,478,478,95,37,58,3,2
9,481,481,72,72,0,1,0
7,494,494,2,2,0,1,0

18,112,112,12,12,0,1,0
17,125,125,32,22,10,2,1
7,155,155,12,7,5,2,1
1,179,179,4,4,0,1,0
12,181,181,13,1,12,4,3
10,186,186,9,9,0,1,0
3,195,195,8,8,0,1,0
2,206,206,1,1,0,1,0
9,263,263,62,62,0,1,0
14,266,266,14,6,8,2,1
4,275,275,22,22,0,1,0
15,279,279,27,8,19,2,1
8,318,318,48,48,0,1,0
16,345,345,68,8,60,4,3
19,359,359,13,13,0,1,0
5,359,359,16,7,9,2,1
13,413,413,29,7,22,3,2
0,421,421,1,1,0,1,0
6,493,493,10,10,0,1,0
11,500,500,1,1,0,1,0

11,118,118,7,3,4,2,1
0,168,168,34,4,30,4,3
4,168,168,11,5,6,3,2
9,191,191,44,3,41,4,3
5,259,259,32,11,21,3,2
1,271,271,37,2,35,4,3
13,276,276,3,3,0,1,0
2,316,316,20,20,0,1,0
6,327,327,42,30,12,4,3
8,349,349,34,34,0,1,0
7,354,354,76,64,12,3,2
3,388,388,32,32,0,1,0
12,398,398,46,46,0,1,0
10,457,457,39,27,12,3,2

14,102,102,2,2,0,1,0
11,163,163,83,20,63,4,3
8,168,168,9,1,8,3,2
10,172,172,10,10,0,1,0
9,210,210,16,16,0,1,0
7,312,312,41,27,14,3,2
3,358,358,11,11,0,1,0
4,372,372,39,39,0,1,0
0,388,388,19,19,0,1,0
2,399,399,5,5,0,1,0
6,400,400,67,33,34,4,3
5,431,431,4,1,3,2,1
1,442,442,131,89,42,2,1
13,476,476,5,5,0,1,0
12,487,487,45,10,35,2,1

12,177,177,16,4,12,3,2
2,210,210,1,1,0,1,0
4,248,248,41,41,0,1,0
13,261,261,15,4,11,3,2
8,269,269,1,1,0,1,0
1,318,318,30,30,0,1,0
11,340,340,107,50,57,4,3
5,371,371,58,8,50,3,2
0,424,424,46,46,0,1,0
6,425,425,94,75,19,2,1
3,437,437,22,22,0,1,0
7,457,457,99,33,66,3,2
9,461,461,36,36,0,1,0
10,470,470,24,24,0,1,0

0,112,112,1,1,0,1,0
4,123,123,14,14,0,1,0
5,140,140,26,12,14,2,1
2,201,201,4,4,0,1,0
10,338,338,1,1,0,1,0
6,341,341,20,20,0,1,0
1,355,355,90,90,0,1,0
9,357,357,126,67,59,3,2
7,376,376,11,5,6,2,1
8,387,387,59,23,36,4,3
13,391,391,13,13,0,1,0
12,423,423,80,80,0,1,0
11,469,469,23,16,7,2,1
3,475,475,76,76,0,1,0

5,164,164,16,16,0,1,0
7,210,210,16,16,0,1,0
11,291,291,32,32,0,1,0
6,349,349,10,10,0,1,0
10,375,375,20,20,0,1,0
1,379,379,24,10,14,3,2
12,411,411,140,114,26,2,1
0,451,451,97,31,66,4,3
3,451,451,1,1,0,1,0
2,458,458,193,127,66,3,2
9,469,469,41,41,0,1,0
4,476,476,3,3,0,1,0
8,485,485,55,13,42,3,2

12,102,102,9,5,4,2,1
0,117,117,9,3,6,3,2
10,158,158,13,7,6,2,1
9,183,183,45,35,10,2,1
5,216,216,32,3,29,2,1
2,257,257,90,55,35,2,1
4,258,258,18,18,0,1,0
6,293,293,33,33,0,1,0
3,359,359,11,6,5,2,1
1,366,366,47,23,24,4,3
8,390,390,52,52,0,1,0
7,438,438,53,53,0,1,0
11,482,482,17,10,7,2,1

12,105,105,2,2,0,1,0
11,146,146,5,5,0,1,0
2,174,174,39,3,36,3,2
3,236,236,20,3,17,2,1
13,240,240,30,14,16,2,1
0,262,262,18,18,0,1,0
1,313,313,8,2,6,3,2
5,332,332,44,44,0,1,0
6,439,439,93,93,0,1,0
7,439,439,23,23,0,1,0
4,440,440,24,24,0,1,0
9,493,493,37,37,0,1,0
10,496,496,14,14,0,1,0
8,498,498,238,214,24,4,3

11,116,116,4,4,0,1,0
5,128,128,10,10,0,1,0
6,134,134,9,6,3,2,1
16,138,138,9,9,0,1,0
12,216,216,16,13,3,2,1
2,240,240,6,6,0,1,0
3,282,282,3,3,0,1,0
4,308,308,39,7,32,2,1
1,320,320,18,18,0,1,0
8,320,320,101,67,34,2,1
15,321,321,54,54,0,1,0
9,324,324,5,2,3,2,1
13,330,330,73,73,0,1,0
0,373,373,19,3,16,2,1
14,383,383,63,36,27,4,3
10,449,449,39,39,0,1,0
7,455,455,25,25,0,1,0

8,147,147,10,1,9,2,1
13,151,151,15,3,12,3,2
0,176,176,1,1,0,1,0
14,192,192,9,9,0,1,0
2,210,210,23,14,9,4,3
12,234,234,3,3,0,1,0
16,244,244,63,14,49,3,2
9,249,249,7,7,0,1,0
7,261,261,27,27,0,1,0
6,296,296,30,11,19,2,1
3,310,310,24,24,0,1,0
15,373,373,59,32,27,4,3
1,374,374,42,3,39,4,3
4,397,397,26,26,0,1,0
10,433,433,13,3,10,2,1
17,433,433,77,38,39,4,3
11,433,433,33,33,0,1,0
18,450,450,27,27,0,1,0
5,452,452,11,11,0,1,0

9,132,132,19,19,0,1,0
1,162,162,5,5,0,1,0
13,171,171,29,29,0,1,0
7,177,177,4,4,0,1,0
6,220,220,4,1,3,2,1
8,237,237,8,8,0,1,0
10,251,251,1,1,0,1,0
2,314,314,58,10,48,4,3
4,346,346,72,21,51,3,2
12,348,348,92,53,39,2,1
0,354,354,26,26,0,1,0
3,377,377,79,69,10,2,1
5,396,396,31,17,14,3,2
11,441,441,78,3,75,4,3

5,101,101,3,3,0,1,0
1,107,107,2,2,0,1,0
9,118,118,4,4,0,1,0
2,210,210,23,1,22,3,2
13,214,214,9,9,0,1,0
7,241,241,46,39,7,2,1
10,261,261,60,29,31,2,1
3,337,337,1,1,0,1,0
14,339,339,12,8,4,2,1
0,341,341,49,42,7,2,1
11,369,369,24,13,11,2,1
8,380,380,142,142,0,1,0
12,405,405,13,13,0,1,0
6,416,416,31,31,0,1,0
4,500,500,117,27,90,3,2

15,104,104,4,4,0,1,0
2,104,104,8,8,0,1,0
1,109,109,2,2,0,1,0
9,155,155,6,6,0,1,0
5,162,162,5,5,0,1,0
3,164,164,23,11,12,4,3
12,186,186,13,13,0,1,0
10,231,231,13,13,0,1,0
4,252,252,12,12,0,1,0
13,277,277,58,58,0,1,0
7,283,283,16,16,0,1,0
0,329,329,27,27,0,1,0
11,363,363,42,27,15,4,3
8,381,381,13,13,0,1,0
16,403,403,3,3,0,1,0
17,407,407,124,73,51,3,2
6,418,418,43,3,40,3,2
14,430,430,11,11,0,1,0
18,465,465,73,41,32,3,2

11,100,100,14,6,8,2,1
4,190,190,10,2,8,2,1
0,206,206,24,4,20,3,2
12,226,226,5,5,0,1,0
15,230,230,37,37,0,1,0
1,235,235,30,30,0,1,0
3,283,283,33,33,0,1,0
6,330,330,5,5,0,1,0
17,338,338,37,11,26,2,1
9,347,347,5,5,0,1,0
10,349,349,19,11,8,2,1
16,360,360,71,17,54,3,2
8,414,414,60,60,0,1,0
14,414,414,37,6,31,2,1
2,421,421,21,21,0,1,0
7,428,428,24,9,15,4,3
5,459,459,25,25,0,1,0
13,461,461,45,16,29,2,1

3,121,121,28,28,0,1,0
10,126,126,1,1,0,1,0
12,128,128,7,3,4,2,1
9,140,140,4,4,0,1,0
5,147,147,2,2,0,1,0
1,149,149,1,1,0,1,0
2,177,177,5,5,0,1,0
14,208,208,72,2,70,3,2
0,223,223,25,1,24,3,2
11,279,279,52,6,46,3,2
4,310,310,26,20,6,3,2
17,326,326,25,9,16,3,2
7,336,336,37,37,0,1,0
13,338,338,3,3,0,1,0
8,343,343,60,60,0,1,0
6,365,365,1,1,0,1,0
16,387,387,24,24,0,1,0
15,437,437,34,34,0,1,0

3,105,105,7,7,0,1,0
15,164,164,10,10,0,1,0
10,170,170,15,9,6,2,1
1,172,172,1,1,0,1,0
5,177,177,16,16,0,1,0
2,182,182,17,5,12,4,3
16,271,271,7,2,5,2,1
12,281,281,1,1,0,1,0
0,292,292,12,12,0,1,0
6,317,317,41,41,0,1,0
13,323,323,73,73,0,1,0
17,328,328,20,20,0,1,0
11,347,347,87,87,0,1,0
9,449,449,39,39,0,1,0
8,475,475,38,26,12,4,3
7,476,476,18,18,0,1,0
4,486,486,41,21,20,2,1
14,488,488,91,84,7,2,1

9,116,116,1,1,0,1,0
0,121,121,10,10,0,1,0
10,143,143,4,4,0,1,0
7,161,161,17,17,0,1,0
8,226,226,53,30,23,2,1
2,292,292,8,3,5,2,1
4,332,332,68,68,0,1,0
6,333,333,74,29,45,3,2
3,412,412,60,60,0,1,0
5,448,448,6,6,0,1,0
1,490,490,267,150,117,4,3

7,108,108,1,1,0,1,0
1,127,127,3,3,0,1,0
13,149,149,8,8,0,1,0
17,165,165,44,44,0,1,0
19,185,185,13,8,5,2,1
22,237,237,3,3,0,1,0
10,266,266,12,6,6,3,2
11,273,273,13,5,8,2,1
16,307,307,31,31,0,1,0
20,307,307,1,1,0,1,0
15,319,319,7,7,0,1,0
14,325,325,3,3,0,1,0
21,334,334,54,38,16,2,1
0,335,335,7,2,5,2,1
18,336,336,86,8,78,3,2
8,339,339,77,45,32,3,2
12,344,344,16,16,0,1,0
9,350,350,14,8,6,3,2
3,396,396,12,2,10,3,2
6,452,452,5,5,0,1,0
2,473,473,44,44,0,1,0
5,479,479,2,2,0,1,0
4,486,486,8,5,3,2,1
23,496,496,21,2,19,2,1

1,101,101,16,7,9,4,3
6,120,120,16,16,0,1,0
7,312,312,32,29,3,2,1
2,337,337,29,29,0,1,0
5,355,355,57,57,0,1,0
4,426,426,136,118,18,4,3
8,432,432,4,4,0,1,0
9,449,449,32,26,6,3,2
0,465,465,259,259,0,1,0
3,470,470,9,9,0,1,0

8,109,109,15,10,5,2,1
1,138,138,22,22,0,1,0
13,151,151,8,8,0,1,0
15,202,202,24,12,12,3,2
3,239,239,27,19,8,3,2
4,273,273,21,9,12,2,1
0,277,277,14,14,0,1,0
6,286,286,3,3,0,1,0
9,304,304,19,19,0,1,0
7,322,322,10,1,9,2,1
2,335,335,13,13,0,1,0
14,361,361,139,139,0,1,0
5,362,362,66,24,42,3,2
11,456,456,8,2,6,3,2
12,469,469,38,38,0,1,0
10,483,483,44,44,0,1,0

1,137,137,5,5,0,1,0
0,217,217,22,3,19,4,3
18,219,219,9,4,5,2,1
10,224,224,5,5,0,1,0
3,233,233,27,23,4,2,1
17,241,241,11,5,6,3,2
2,259,259,37,37,0,1,0
7,276,276,1,1,0,1,0
13,278,278,19,19,0,1,0
16,295,295,12,2,10,3,2
14,334,334,178,81,97,4,3
8,345,345,5,5,0,1,0
12,370,370,6,6,0,1,0
6,420,420,16,1,15,4,3
4,430,430,5,2,3,2,1
5,438,438,20,20,0,1,0
9,466,466,98,85,13,2,1
15,468,468,32,5,27,2,1
11,495,495,29,29,0,1,0

5,139,139,4,1,3,2,1
14,164,164,5,5,0,1,0
6,168,168,23,23,0,1,0
1,186,186,2,2,0,1,0
9,226,226,6,2,4,2,1
2,291,291,37,23,14,2,1
10,356,356,92,19,73,4,3
15,380,380,7,7,0,1,0
0,389,389,6,6,0,1,0
17,401,401,60,32,28,3,2
13,404,404,4,4,0,1,0
16,412,412,55,34,21,2,1
7,421,421,2,2,0,1,0
8,436,436,8,8,0,1,0
12,446,446,189,73,116,4,3
3,463,463,36,23,13,2,1
11,466,466,19,19,0,1,0
4,471,471,46,31,15,2,1

3,120,120,15,4,11,2,1
9,120,120,38,38,0,1,0
6,123,123,10,10,0,1,0
13,157,157,1,1,0,1,0
5,171,171,25,9,16,2,1
0,224,224,3,3,0,1,0
2,239,239,1,1,0,1,0
4,239,239,90,90,0,1,0
10,239,239,35,35,0,1,0
7,277,277,33,33,0,1,0
11,345,345,48,48,0,1,0
1,415,415,25,25,0,1,0
12,434,434,17,5,12,4,3
8,498,498,25,5,20,2,1

20,105,105,2,2,0,1,0
16,126,126,7,7,0,1,0
1,144,144,1,1,0,1,0
7,185,185,24,2,22,3,2
17,214,214,21,3,18,3,2
12,231,231,15,15,0,1,0
4,241,241,1,1,0,1,0
0,258,258,3,3,0,1,0
13,279,279,7,7,0,1,0
19,288,288,143,143,0,1,0
18,310,310,10,10,0,1,0
3,335,335,6,6,0,1,0
5,342,342,19,6,13,2,1
11,347,347,10,2,8,3,2
6,400,400,21,21,0,1,0
15,421,421,9,1,8,2,1
8,437,437,52,34,18,4,3
2,461,461,1,1,0,1,0
9,464,464,127,23,104,4,3
10,478,478,4,4,0,1,0
14,499,499,50,50,0,1,0

8,124,124,13,9,4,2,1
4,156,156,9,9,0,1,0
5,165,165,7,7,0,1,0
1,180,180,1,1,0,1,0
2,214,214,68,68,0,1,0
0,294,294,2,2,0,1,0
12,299,299,56,56,0,1,0
14,323,323,25,11,14,2,1
11,368,368,91,86,5,2,1
10,379,379,20,6,14,2,1
7,381,381,118,78,40,2,1
13,389,389,6,6,0,1,0
9,414,414,52,52,0,1,0
3,483,483,12,12,0,1,0
6,494,494,18,18,0,1,0

0,132,132,1,1,0,1,0
15,150,150,13,13,0,1,0
8,192,192,3,3,0,1,0
1,213,213,49,19,30,2,1
6,215,215,6,6,0,1,0
10,219,219,17,17,0,1,0
14,245,245,6,6,0,1,0
3,294,294,22,22,0,1,0
12,343,343,31,1,30,4,3
11,370,370,12,12,0,1,0
5,388,388,3,3,0,1,0
7,409,409,47,47,0,1,0
2,414,414,44,28,16,2,1
9,425,425,6,1,5,2,1
17,436,436,103,103,0,1,0
13,465,465,92,48,44,3,2
4,482,482,61,46,15,2,1
16,482,482,68,68,0,1,0

14,175,175,19,19,0,1,0
1,181,181,1,1,0,1,0
2,205,205,20,20,0,1,0
7,218,218,10,3,7,2,1
0,225,225,23,11,12,4,3
8,237,237,17,17,0,1,0
6,254,254,2,2,0,1,0
5,263,263,62,53,9,2,1
10,282,282,70,70,0,1,0
12,283,283,41,23,18,3,2
11,355,355,8,8,0,1,0
3,376,376,73,73,0,1,0
9,420,420,12,12,0,1,0
16,449,449,7,4,3,2,1
4,460,460,5,1,4,2,1
15,464,464,7,7,0,1,0
13,468,468,122,26,96,4,3

10,109,109,1,1,0,1,0
4,122,122,1,1,0,1,0
5,137,137,8,2,6,3,2
18,141,141,18,6,12,4,3
20,150,150,9,9,0,1,0
8,165,165,1,1,0,1,0
17,178,178,14,14,0,1,0
0,194,194,6,6,0,1,0
3,205,205,12,12,0,1,0
9,261,261,43,25,18,2,1
16,262,262,3,3,0,1,0
14,275,275,44,44,0,1,0
19,315,315,110,101,9,4,3
11,329,329,4,4,0,1,0
12,330,330,30,30,0,1,0
13,341,341,44,44,0,1,0
15,396,396,13,7,6,3,2
1,401,401,78,78,0,1,0
6,415,415,1,1,0,1,0
7,475,475,12,5,7,2,1
2,492,492,5,5,0,1,0

13,121,121,2,2,0,1,0
3,186,186,6,3,3,2,1
8,198,198,9,9,0,1,0
4,219,219,35,35,0,1,0
0,222,222,7,4,3,2,1
2,228,228,10,2,8,3,2
1,246,246,11,2,9,2,1
14,250,250,15,15,0,1,0
11,263,263,22,1,21,4,3
10,339,339,27,27,0,1,0
16,340,340,137,95,42,2,1
9,362,362,5,1,4,2,1
5,430,430,56,56,0,1,0
7,450,450,79,67,12,3,2
12,458,458,1,1,0,1,0
15,467,467,77,73,4,2,1
6,479,479,60,60,0,1,0

9,100,100,1,1,0,1,0
2,104,104,5,5,0,1,0
13,115,115,9,9,0,1,0
16,131,131,3,3,0,1,0
10,167,167,9,3,6,3,2
5,190,190,2,2,0,1,0
8,191,191,3,3,0,1,0
14,210,210,13,4,9,4,3
18,273,273,8,8,0,1,0
3,274,274,1,1,0,1,0
4,336,336,35,35,0,1,0
15,338,338,77,77,0,1,0
11,378,378,22,22,0,1,0
0,386,386,49,9,40,2,1
17,390,390,59,44,15,2,1
12,413,413,103,13,90,4,3
7,418,418,46,2,44,3,2
6,435,435,62,16,46,2,1
1,454,454,53,53,0,1,0

1,152,152,1,1,0,1,0
4,154,154,2,2,0,1,0
9,161,161,7,1,6,3,2
12,168,168,4,4,0,1,0
6,179,179,38,14,24,3,2
16,219,219,5,2,3,2,1
13,224,224,1,1,0,1,0
14,271,271,95,29,66,3,2
7,283,283,6,2,4,2,1
3,289,289,56,11,45,4,3
0,312,312,1,1,0,1,0
11,337,337,39,2,37,2,1
10,341,341,88,3,85,4,3
2,354,354,20,20,0,1,0
8,383,383,50,50,0,1,0
5,427,427,53,23,30,3,2
15,476,476,18,18,0,1,0

4,109,109,9,9,0,1,0
11,149,149,18,18,0,1,0
3,154,154,7,7,0,1,0
12,171,171,5,5,0,1,0
17,218,218,48,48,0,1,0
0,233,233,28,28,0,1,0
15,242,242,16,16,0,1,0
13,259,259,23,23,0,1,0
6,268,268,16,6,10,2,1
18,280,280,59,29,30,4,3
16,283,283,49,4,45,4,3
2,351,351,3,3,0,1,0
9,361,361,1,1,0,1,0
7,370,370,27,8,19,2,1
5,405,405,6,6,0,1,0
14,410,410,11,11,0,1,0
1,441,441,36,36,0,1,0
8,469,469,72,72,0,1,0
10,492,492,21,13,8,3,2

7,131,131,1,1,0,1,0
15,180,180,3,3,0,1,0
17,182,182,15,8,7,2,1
4,226,226,1,1,0,1,0
9,230,230,3,3,0,1,0
18,232,232,44,8,36,2,1
13,238,238,34,15,19,2,1
6,248,248,5,5,0,1,0
11,251,251,18,18,0,1,0
20,285,285,6,6,0,1,0
8,297,297,7,7,0,1,0
10,298,298,7,1,6,3,2
3,346,346,11,11,0,1,0
14,349,349,4,4,0,1,0
0,349,349,60,60,0,1,0
16,360,360,97,64,33,2,1
5,405,405,63,63,0,1,0
1,427,427,10,6,4,2,1
19,436,436,98,98,0,1,0
12,478,478,40,12,28,3,2
2,495,495,14,2,12,4,3

10,102,102,16,2,14,3,2
1,173,173,23,23,0,1,0
8,177,177,23,3,20,2,1
11,302,302,43,31,12,2,1
4,314,314,80,80,0,1,0
12,353,353,38,4,34,3,2
0,384,384,114,57,57,4,3
6,385,385,84,52,32,2,1
2,387,387,30,18,12,2,1
9,407,407,22,22,0,1,0
5,447,447,2,2,0,1,0
3,456,456,16,16,0,1,0
7,469,469,5,5,0,1,0

1,101,101,4,4,0,1,0
6,141,141,6,6,0,1,0
0,184,184,10,4,6,2,1
12,213,213,28,13,15,4,3
3,232,232,82,39,43,3,2
10,249,249,14,14,0,1,0
2,256,256,8,8,0,1,0
9,315,315,68,28,40,2,1
7,335,335,2,2,0,1,0
15,379,379,71,5,66,4,3
14,381,381,28,28,0,1,0
13,399,399,43,37,6,2,1
8,408,408,54,54,0,1,0
4,411,411,34,20,14,2,1
5,427,427,25,7,18,2,1
11,460,460,19,3,16,3,2

6,107,107,3,3,0,1,0
2,109,109,3,3,0,1,0
10,154,154,1,1,0,1,0
7,155,155,22,9,13,4,3
4,163,163,5,5,0,1,0
0,234,234,22,1,21,4,3
1,252,252,80,36,44,2,1
12,253,253,61,50,11,2,1
3,317,317,41,7,34,4,3
8,320,320,116,116,0,1,0
9,348,348,21,3,18,2,1
13,419,419,15,15,0,1,0
11,429,429,29,11,18,4,3
5,447,447,16,4,12,3,2
14,478,478,19,19,0,1,0

7,199,199,8,8,0,1,0
12,203,203,18,18,0,1,0
9,214,214,91,69,22,2,1
2,245,245,9,3,6,2,1
11,294,294,33,4,29,2,1
1,308,308,76,52,24,3,2
5,338,338,96,96,0,1,0
6,367,367,45,15,30,3,2
0,410,410,79,73,6,2,1
4,410,410,1,1,0,1,0
3,474,474,19,19,0,1,0
10,476,476,8,8,0,1,0
8,495,495,6,6,0,1,0

14,108,108,15,15,0,1,0
12,110,110,3,3,0,1,0
17,114,114,25,25,0,1,0
7,129,129,1,1,0,1,0
6,146,146,9,9,0,1,0
15,216,216,1,1,0,1,0
0,224,224,2,2,0,1,0
3,229,229,2,2,0,1,0
8,231,231,4,4,0,1,0
5,243,243,74,27,47,2,1
2,260,260,23,15,8,3,2
10,267,267,29,29,0,1,0
13,307,307,51,15,36,4,3
1,350,350,44,44,0,1,0
4,390,390,9,9,0,1,0
11,436,436,76,62,14,3,2
9,442,442,21,21,0,1,0
16,447,447,37,3,34,3,2

6,110,110,4,4,0,1,0
2,141,141,14,3,11,2,1
12,180,180,11,11,0,1,0
14,202,202,9,9,0,1,0
3,242,242,2,2,0,1,0
10,273,273,22,22,0,1,0
13,308,308,38,19,19,2,1
7,331,331,16,16,0,1,0
1,343,343,124,100,24,3,2
0,360,360,13,13,0,1,0
9,411,411,33,2,31,2,1
11,467,467,24,24,0,1,0
4,474,474,3,3,0,1,0
8,488,488,180,126,54,4,3
5,490,490,100,25,75,3,2

9,237,237,42,42,0,1,0
7,245,245,24,24,0,1,0
5,285,285,10,1,9,4,3
12,288,288,8,4,4,2,1
10,299,299,38,38,0,1,0
11,321,321,33,13,20,2,1
8,376,376,52,52,0,1,0
2,398,398,2,2,0,1,0
13,414,414,5,5,0,1,0
3,429,429,57,57,0,1,0
4,436,436,17,17,0,1,0
0,454,454,31,31,0,1,0
14,463,463,102,102,0,1,0
1,491,491,135,125,10,2,1
6,494,494,73,73,0,1,0

1,105,105,1,1,0,1,0
12,107,107,3,3,0,1,0
5,150,150,22,14,8,2,1
9,186,186,12,12,0,1,0
8,211,211,89,67,22,2,1
3,259,259,51,51,0,1,0
4,309,309,59,35,24,4,3
2,321,321,61,17,44,2,1
6,338,338,91,60,31,2,1
0,363,363,25,25,0,1,0
10,389,389,4,4,0,1,0
7,397,397,5,5,0,1,0
11,455,455,3,3,0,1,0

0,136,136,17,9,8,2,1
2,138,138,2,2,0,1,0
8,139,139,12,12,0,1,0
3,146,146,3,3,0,1,0
11,158,158,21,21,0,1,0
4,162,162,20,20,0,1,0
7,166,166,40,21,19,2,1
10,204,204,19,16,3,2,1
9,228,228,18,3,15,4,3
5,242,242,36,36,0,1,0
6,344,344,1,1,0,1,0
12,363,363,32,20,12,4,3
15,386,386,1,1,0,1,0
14,430,430,63,1,62,3,2
1,452,452,17,17,0,1,0
13,487,487,131,107,24,4,3

6,139,139,6,6,0,1,0
9,145,145,6,6,0,1,0
2,239,239,11,11,0,1,0
5,284,284,34,34,0,1,0
13,290,290,76,76,0,1,0
11,298,298,1,1,0,1,0
10,358,358,50,50,0,1,0
12,382,382,19,4,15,4,3
3,390,390,40,40,0,1,0
14,419,419,55,55,0,1,0
8,430,430,78,57,21,4,3
4,446,446,42,42,0,1,0
7,450,450,35,35,0,1,0
1,455,455,123,93,30,4,3
0,474,474,22,22,0,1,0

6,104,104,17,8,9,4,3
9,133,133,13,1,12,4,3
8,153,153,23,23,0,1,0
2,198,198,8,2,6,3,2
5,241,241,26,26,0,1,0
3,268,268,34,12,22,2,1
10,278,278,21,1,20,2,1
4,303,303,38,38,0,1,0
0,330,330,122,122,0,1,0
7,361,361,28,2,26,3,2
1,392,392,12,5,7,3,2
11,437,437,1,1,0,1,0
12,443,443,115,45,70,3,2

6,124,124,2,2,0,1,0
5,162,162,7,1,6,2,1
13,194,194,45,45,0,1,0
4,235,235,13,8,5,2,1
11,262,262,5,5,0,1,0
8,281,281,58,18,40,3,2
1,291,291,32,26,6,2,1
10,313,313,7,7,0,1,0
14,321,321,70,46,24,3,2
12,337,337,32,32,0,1,0
7,375,375,56,19,37,3,2
0,398,398,69,64,5,2,1
2,459,459,49,20,29,3,2
3,459,459,67,67,0,1,0
9,497,497,10,7,3,2,1

1,108,108,32,32,0,1,0
11,117,117,9,9,0,1,0
12,141,141,22,22,0,1,0
6,225,225,8,8,0,1,0
0,228,228,40,2,38,2,1
4,317,317,1,1,0,1,0
2,325,325,25,1,24,3,2
9,335,335,13,13,0,1,0
7,358,358,6,6,0,1,0
5,369,369,55,10,45,2,1
3,386,386,39,39,0,1,0
8,405,405,147,147,0,1,0
10,430,430,57,7,50,2,1

10,142,142,5,5,0,1,0
9,194,194,3,3,0,1,0
2,196,196,22,22,0,1,0
4,208,208,64,44,20,3,2
3,276,276,14,14,0,1,0
6,287,287,42,42,0,1,0
11,295,295,57,57,0,1,0
7,316,316,33,33,0,1,0
0,404,404,94,28,66,4,3
1,421,421,42,17,25,2,1
5,439,439,86,49,37,2,1
8,450,450,55,4,51,4,3

1,103,103,3,3,0,1,0
0,116,116,6,6,0,1,0
13,213,213,33,33,0,1,0
14,228,228,33,33,0,1,0
4,243,243,3,3,0,1,0
7,247,247,22,22,0,1,0
11,269,269,54,47,7,2,1
9,280,280,29,16,13,2,1
12,300,300,7,1,6,3,2
10,322,322,22,22,0,1,0
2,337,337,125,88,37,2,1
6,355,355,9,1,8,2,1
3,366,366,58,58,0,1,0
5,427,427,27,15,12,2,1
8,434,434,50,11,39,2,1

2,185,185,32,32,0,1,0
9,186,186,13,4,9,4,3
11,186,186,59,44,15,4,3
7,240,240,1,1,0,1,0
0,303,303,40,3,37,2,1
10,326,326,22,22,0,1,0
8,406,406,54,21,33,4,3
4,438,438,120,120,0,1,0
5,458,458,20,1,19,4,3
6,469,469,84,42,42,3,2
3,487,487,100,52,48,4,3
1,493,493,8,1,7,2,1

6,105,105,5,2,3,2,1
1,131,131,5,5,0,1,0
12,163,163,19,5,14,2,1
5,192,192,14,14,0,1,0
3,193,193,29,29,0,1,0
13,202,202,51,8,43,4,3
7,206,206,37,37,0,1,0
11,277,277,21,21,0,1,0
0,306,306,29,29,0,1,0
8,327,327,49,13,36,2,1
2,328,328,106,106,0,1,0
10,463,463,11,11,0,1,0
4,468,468,37,37,0,1,0
9,473,473,8,8,0,1,0

9,117,117,3,3,0,1,0
13,125,125,4,1,3,2,1
16,140,140,16,10,6,2,1
11,141,141,21,5,16,2,1
10,154,154,15,8,7,2,1
4,245,245,2,2,0,1,0
15,261,261,82,78,4,2,1
6,272,272,28,4,24,4,3
12,273,273,42,42,0,1,0
17,285,285,12,12,0,1,0
0,308,308,71,47,24,3,2
1,355,355,26,26,0,1,0
5,384,384,15,15,0,1,0
3,399,399,2,2,0,1,0
14,405,405,3,3,0,1,0
2,409,409,32,5,27,4,3
8,463,463,62,62,0,1,0
7,496,496,3,3,0,1,0

7,126,126,2,2,0,1,0
17,139,139,8,2,6,3,2
8,165,165,6,2,4,2,1
14,202,202,27,27,0,1,0
20,226,226,66,66,0,1,0
21,246,246,10,10,0,1,0
4,248,248,22,22,0,1,0
1,251,251,10,10,0,1,0
6,279,279,2,2,0,1,0
15,307,307,8,8,0,1,0
0,350,350,55,33,22,2,1
5,364,364,14,14,0,1,0
12,368,368,11,4,7,2,1
10,371,371,31,7,24,4,3
16,383,383,54,4,50,3,2
19,404,404,3,3,0,1,0
9,417,417,19,8,11,2,1
3,430,430,9,5,4,2,1
2,431,431,14,5,9,2,1
11,477,477,29,29,0,1,0
13,481,481,5,2,3,2,1
18,487,487,119,63,56,3,2

3,135,135,2,2,0,1,0
16,165,165,7,7,0,1,0
7,205,205,38,38,0,1,0
2,206,206,21,21,0,1,0
11,234,234,32,12,20,4,3
17,235,235,24,24,0,1,0
0,242,242,12,4,8,2,1
20,263,263,9,9,0,1,0
13,277,277,9,9,0,1,0
8,289,289,24,6,18,3,2
10,344,344,9,5,4,2,1
5,354,354,8,8,0,1,0
15,356,356,27,27,0,1,0
9,401,401,6,6,0,1,0
14,423,423,70,6,64,3,2
12,437,437,36,6,30,2,1
18,450,450,11,1,10,2,1
4,451,451,5,5,0,1,0
19,465,465,170,44,126,4,3
1,468,468,18,12,6,2,1
6,470,470,1,1,0,1,0

14,118,118,4,4,0,1,0
8,184,184,28,28,0,1,0
10,255,255,6,6,0,1,0
4,269,269,31,2,29,2,1
6,283,283,10,1,9,4,3
17,285,285,2,2,0,1,0
13,291,291,36,36,0,1,0
0,293,293,19,19,0,1,0
2,300,300,37,17,20,2,1
7,300,300,2,2,0,1,0
9,329,329,29,7,22,2,1
5,350,350,14,14,0,1,0
15,365,365,163,121,42,4,3
11,395,395,49,9,40,3,2
12,402,402,10,3,7,2,1
3,445,445,51,51,0,1,0
1,463,463,17,14,3,2,1
16,495,495,28,28,0,1,0

4,131,131,39,36,3,2,1
2,139,139,4,4,0,1,0
7,162,162,1,1,0,1,0
3,168,168,14,14,0,1,0
0,185,185,5,5,0,1,0
5,189,189,27,8,19,3,2
13,200,200,39,23,16,2,1
8,210,210,6,3,3,2,1
1,278,278,53,53,0,1,0
9,319,319,19,19,0,1,0
12,357,357,67,67,0,1,0
6,391,391,12,4,8,3,2
10,435,435,90,77,13,2,1
11,470,470,60,60,0,1,0

9,103,103,20,20,0,1,0
8,113,113,39,14,25,3,2
5,130,130,6,6,0,1,0
6,200,200,24,24,0,1,0
1,226,226,36,10,26,2,1
3,274,274,84,18,66,3,2
10,313,313,12,12,0,1,0
7,329,329,10,10,0,1,0
4,359,359,57,48,9,4,3
11,402,402,18,15,3,2,1
0,413,413,24,24,0,1,0
2,478,478,57,57,0,1,0

7,100,100,2,2,0,1,0
4,104,104,4,4,0,1,0
1,105,105,3,3,0,1,0
13,166,166,16,16,0,1,0
11,183,183,42,42,0,1,0
12,195,195,39,6,33,4,3
3,214,214,71,19,52,3,2
8,226,226,2,2,0,1,0
5,288,288,14,14,0,1,0
6,298,298,44,8,36,3,2
2,344,344,22,22,0,1,0
9,351,351,33,24,9,4,3
10,420,420,67,20,47,2,1
0,430,430,54,54,0,1,0
14,484,484,10,1,9,4,3

3,148,148,19,3,16,4,3
13,194,194,16,8,8,3,2
1,242,242,26,26,0,1,0
15,242,242,45,45,0,1,0
14,267,267,9,5,4,2,1
11,294,294,18,2,16,3,2
6,298,298,2,2,0,1,0
7,304,304,2,2,0,1,0
12,315,315,1,1,0,1,0
10,323,323,113,26,87,4,3
4,370,370,21,1,20,3,2
2,392,392,40,12,28,3,2
5,402,402,36,14,22,2,1
9,418,418,40,22,18,3,2
8,450,450,79,19,60,4,3
0,454,454,58,58,0,1,0

11,105,105,23,23,0,1,0
2,133,133,2,2,0,1,0
14,209,209,3,3,0,1,0
6,211,211,24,18,6,2,1
12,223,223,2,2,0,1,0
9,260,260,26,26,0,1,0
15,267,267,77,4,73,4,3
7,282,282,26,16,10,3,2
10,333,333,22,3,19,2,1
13,352,352,41,7,34,3,2
3,354,354,42,17,25,2,1
1,361,361,60,20,40,3,2
0,435,435,31,4,27,4,3
5,469,469,57,9,48,2,1
4,496,496,15,8,7,2,1
8,499,499,36,24,12,4,3

9,105,105,6,2,4,2,1
12,135,135,16,6,10,2,1
14,273,273,46,4,42,2,1
5,316,316,3,3,0,1,0
8,321,321,12,12,0,1,0
4,323,323,54,26,28,3,2
2,326,326,4,4,0,1,0
1,365,365,30,3,27,4,3
7,371,371,17,17,0,1,0
11,376,376,31,13,18,2,1
6,421,421,64,64,0,1,0
13,428,428,96,54,42,3,2
10,429,429,52,52,0,1,0
3,461,461,72,56,16,3,2
0,474,474,83,83,0,1,0

5,135,135,15,3,12,2,1
7,165,165,3,3,0,1,0
15,167,167,13,13,0,1,0
2,192,192,52,12,40,2,1
1,208,208,9,9,0,1,0
12,288,288,20,10,10,2,1
13,301,301,82,82,0,1,0
8,327,327,5,5,0,1,0
10,340,340,9,9,0,1,0
9,367,367,85,19,66,4,3
4,404,404,44,16,28,3,2
6,424,424,24,9,15,4,3
11,465,465,23,23,0,1,0
14,489,489,41,41,0,1,0
3,496,496,42,42,0,1,0
0,500,500,46,46,0,1,0

2,104,104,31,31,0,1,0
13,126,126,6,6,0,1,0
5,157,157,17,17,0,1,0
11,191,191,53,37,16,2,1
4,198,198,5,5,0,1,0
10,214,214,39,39,0,1,0
7,238,238,4,1,3,2,1
1,330,330,49,49,0,1,0
9,360,360,17,17,0,1,0
8,384,384,52,52,0,1,0
0,396,396,19,2,17,4,3
3,400,400,13,13,0,1,0
12,423,423,48,17,31,4,3
6,476,476,67,10,57,4,3

12,105,105,3,3,0,1,0
0,120,120,21,9,12,2,1
7,132,132,38,38,0,1,0
1,218,218,27,27,0,1,0
13,222,222,37,19,18,3,2
6,247,247,24,3,21,4,3
10,287,287,24,8,16,2,1
9,292,292,5,5,0,1,0
4,296,296,15,15,0,1,0
8,398,398,83,17,66,4,3
3,415,415,20,20,0,1,0
5,420,420,42,15,27,2,1
11,437,437,10,6,4,2,1
2,472,472,98,44,54,4,3

11,109,109,5,5,0,1,0
5,156,156,46,46,0,1,0
3,185,185,1,1,0,1,0
13,240,240,44,44,0,1,0
4,243,243,21,3,18,3,2
9,285,285,24,24,0,1,0
14,300,300,122,122,0,1,0
6,320,320,18,18,0,1,0
10,336,336,16,16,0,1,0
0,357,357,31,31,0,1,0
7,363,363,22,11,11,2,1
1,400,400,21,8,13,2,1
15,400,400,2,2,0,1,0
8,414,414,9,9,0,1,0
12,466,466,54,10,44,2,1
16,494,494,4,1,3,2,1
2,495,495,27,27,0,1,0

16,144,144,51,51,0,1,0
0,177,177,2,2,0,1,0
5,219,219,18,4,14,3,2
6,223,223,30,9,21,4,3
3,233,233,43,43,0,1,0
7,243,243,10,10,0,1,0
12,272,272,55,55,0,1,0
9,273,273,22,22,0,1,0
1,279,279,4,4,0,1,0
11,307,307,6,6,0,1,0
4,342,342,5,5,0,1,0
14,347,347,18,18,0,1,0
10,379,379,6,6,0,1,0
15,379,379,26,5,21,3,2
8,401,401,36,26,10,3,2
2,449,449,67,41,26,3,2
13,458,458,47,47,0,1,0

5,101,101,5,5,0,1,0
18,135,135,2,2,0,1,0
9,154,154,20,20,0,1,0
10,160,160,1,1,0,1,0
2,185,185,25,7,18,3,2
8,199,199,1,1,0,1,0
12,231,231,19,19,0,1,0
13,231,231,35,4,31,3,2
11,257,257,1,1,0,1,0
16,271,271,19,19,0,1,0
14,278,278,44,2,42,2,1
1,281,281,13,13,0,1,0
15,282,282,86,37,49,4,3
0,309,309,15,15,0,1,0
4,325,325,56,56,0,1,0
3,340,340,11,3,8,2,1
17,345,345,14,2,12,3,2
7,353,353,13,2,11,2,1
6,357,357,49,49,0,1,0

5,163,163,49,25,24,4,3
3,169,169,15,9,6,3,2
4,174,174,1,1,0,1,0
1,179,179,30,16,14,3,2
7,185,185,5,2,3,2,1
6,349,349,37,37,0,1,0
11,352,352,73,36,37,2,1
10,356,356,43,35,8,3,2
12,373,373,3,3,0,1,0
8,384,384,10,10,0,1,0
9,401,401,127,40,87,4,3
0,441,441,91,91,0,1,0
2,487,487,16,7,9,4,3

10,125,125,4,4,0,1,0
5,144,144,4,4,0,1,0
12,165,165,3,3,0,1,0
7,173,173,37,37,0,1,0
14,180,180,63,63,0,1,0
1,206,206,1,1,0,1,0
11,237,237,23,1,22,2,1
13,243,243,33,33,0,1,0
18,269,269,12,12,0,1,0
15,336,336,15,15,0,1,0
2,338,338,14,14,0,1,0
16,382,382,36,21,15,2,1
17,388,388,49,49,0,1,0
3,398,398,25,25,0,1,0
0,444,444,1,1,0,1,0
6,449,449,18,18,0,1,0
8,472,472,42,9,33,2,1
9,478,478,82,82,0,1,0
4,482,482,10,3,7,2,1

13,111,111,8,8,0,1,0
11,113,113,13,13,0,1,0
0,161,161,7,7,0,1,0
1,179,179,21,15,6,2,1
10,209,209,1,1,0,1,0
16,237,237,48,48,0,1,0
8,238,238,31,31,0,1,0
17,244,244,57,57,0,1,0
3,256,256,12,12,0,1,0
2,273,273,27,14,13,2,1
14,277,277,5,5,0,1,0
9,295,295,25,6,19,2,1
5,309,309,28,22,6,3,2
7,325,325,45,45,0,1,0
12,332,332,49,14,35,2,1
6,423,423,13,13,0,1,0
15,446,446,13,13,0,1,0
4,499,499,7,1,6,2,1

5,114,114,6,6,0,1,0
12,124,124,16,16,0,1,0
1,134,134,34,4,30,2,1
10,189,189,1,1,0,1,0
14,201,201,14,5,9,2,1
6,207,207,4,4,0,1,0
9,222,222,72,39,33,4,3
0,282,282,26,26,0,1,0
2,339,339,39,39,0,1,0
7,353,353,1,1,0,1,0
11,365,365,9,9,0,1,0
3,406,406,14,1,13,2,1
13,462,462,101,101,0,1,0
8,469,469,20,8,12,2,1
4,474,474,109,43,66,4,3

17,101,101,8,8,0,1,0
2,104,104,5,5,0,1,0
7,107,107,2,2,0,1,0
14,185,185,6,1,5,2,1
5,216,216,38,20,18,4,3
12,265,265,19,19,0,1,0
16,269,269,42,42,0,1,0
0,283,283,12,12,0,1,0
6,344,344,28,28,0,1,0
15,348,348,111,81,30,2,1
3,359,359,4,4,0,1,0
18,406,406,59,59,0,1,0
8,407,407,5,5,0,1,0
13,415,415,6,6,0,1,0
4,437,437,1,1,0,1,0
10,453,453,33,21,12,2,1
1,454,454,3,3,0,1,0
11,465,465,85,37,48,3,2
9,467,467,68,32,36,3,2

12,105,105,3,3,0,1,0
1,152,152,9,9,0,1,0
5,160,160,17,1,16,2,1
9,183,183,6,6,0,1,0
3,197,197,56,56,0,1,0
8,268,268,15,1,14,2,1
10,270,270,2,2,0,1,0
2,293,293,25,8,17,2,1
7,308,308,136,136,0,1,0
6,369,369,48,48,0,1,0
0,377,377,96,96,0,1,0
11,463,463,54,54,0,1,0
4,467,467,6,6,0,1,0

15,108,108,7,3,4,2,1
10,141,141,22,5,17,3,2
3,157,157,14,8,6,2,1
8,165,165,12,3,9,4,3
11,179,179,8,8,0,1,0
7,210,210,1,1,0,1,0
1,212,212,1,1,0,1,0
4,255,255,23,23,0,1,0
9,294,294,55,55,0,1,0
5,339,339,103,79,24,2,1
14,357,357,73,42,31,4,3
13,367,367,33,33,0,1,0
6,392,392,5,2,3,2,1
12,456,456,31,31,0,1,0
0,474,474,32,1,31,4,3
2,489,489,78,18,60,3,2

9,159,159,22,9,13,2,1
2,161,161,11,11,0,1,0
1,181,181,34,34,0,1,0
8,258,258,35,35,0,1,0
13,305,305,49,13,36,3,2
10,322,322,58,13,45,4,3
3,364,364,49,3,46,3,2
7,368,368,22,5,17,2,1
0,379,379,54,21,33,4,3
4,390,390,61,4,57,4,3
11,410,410,18,18,0,1,0
6,413,413,31,6,25,3,2
12,478,478,44,44,0,1,0
5,492,492,18,18,0,1,0

13,118,118,11,6,5,2,1
1,189,189,45,45,0,1,0
2,204,204,1,1,0,1,0
10,215,215,37,37,0,1,0
6,253,253,43,43,0,1,0
9,300,300,15,15,0,1,0
11,363,363,42,22,20,2,1
7,370,370,55,6,49,2,1
0,374,374,15,5,10,2,1
12,379,379,26,26,0,1,0
14,416,416,16,8,8,3,2
8,428,428,21,9,12,4,3
3,438,438,18,18,0,1,0
16,453,453,62,62,0,1,0
15,458,458,84,66,18,4,3
4,459,459,10,10,0,1,0
5,482,482,18,18,0,1,0

1,113,113,10,6,4,2,1
14,129,129,7,7,0,1,0
5,151,151,2,2,0,1,0
16,169,169,11,11,0,1,0
10,189,189,3,3,0,1,0
3,215,215,15,15,0,1,0
4,216,216,10,2,8,3,2
15,218,218,7,7,0,1,0
17,243,243,8,2,6,2,1
0,283,283,43,19,24,2,1
11,290,290,16,16,0,1,0
7,306,306,19,19,0,1,0
12,421,421,228,194,34,3,2
9,429,429,28,2,26,3,2
2,432,432,4,4,0,1,0
8,436,436,37,37,0,1,0
6,475,475,94,45,49,2,1
13,485,485,15,6,9,4,3

3,113,113,2,2,0,1,0
2,117,117,21,3,18,2,1
14,123,123,16,16,0,1,0
12,165,165,32,29,3,2,1
15,171,171,26,26,0,1,0
10,182,182,6,2,4,2,1
11,195,195,4,4,0,1,0
6,266,266,37,8,29,2,1
9,279,279,60,60,0,1,0
4,315,315,1,1,0,1,0
8,316,316,3,3,0,1,0
17,347,347,43,22,21,2,1
7,354,354,6,6,0,1,0
18,355,355,31,12,19,2,1
16,375,375,11,3,8,3,2
1,402,402,2,2,0,1,0
13,406,406,39,5,34,3,2
5,433,433,42,31,11,2,1
0,483,483,33,3,30,3,2

4,111,111,15,1,14,3,2
8,111,111,1,1,0,1,0
2,131,131,9,3,6,2,1
3,214,214,43,43,0,1,0
0,286,286,30,10,20,3,2
15,327,327,26,26,0,1,0
7,328,328,1,1,0,1,0
13,336,336,41,41,0,1,0
12,347,347,84,42,42,2,1
11,363,363,33,17,16,3,2
5,388,388,5,2,3,2,1
9,463,463,50,30,20,2,1
10,468,468,57,33,24,4,3
1,475,475,26,26,0,1,0
14,484,484,21,3,18,4,3
6,500,500,108,108,0,1,0

10,122,122,18,6,12,4,3
8,154,154,1,1,0,1,0
9,165,165,24,10,14,4,3
2,194,194,1,1,0,1,0
16,237,237,14,14,0,1,0
7,259,259,11,11,0,1,0
1,270,270,2,2,0,1,0
13,275,275,6,6,0,1,0
5,359,359,4,4,0,1,0
14,361,361,13,4,9,4,3
0,367,367,24,24,0,1,0
11,392,392,25,18,7,2,1
4,409,409,94,57,37,2,1
3,432,432,19,19,0,1,0
15,436,436,14,8,6,2,1
12,447,447,201,175,26,3,2
6,470,470,116,60,56,3,2

11,130,130,4,4,0,1,0
4,142,142,21,11,10,3,2
10,164,164,16,13,3,2,1
9,177,177,28,14,14,3,2
0,226,226,1,1,0,1,0
7,228,228,15,15,0,1,0
5,287,287,1,1,0,1,0
14,310,310,11,2,9,4,3
12,341,341,64,64,0,1,0
15,362,362,42,33,9,4,3
8,413,413,68,2,66,3,2
1,439,439,45,45,0,1,0
13,447,447,82,67,15,2,1
2,452,452,3,3,0,1,0
3,474,474,142,60,82,4,3
6,487,487,3,3,0,1,0

0,110,110,29,29,0,1,0
11,129,129,6,3,3,2,1
13,167,167,1,1,0,1,0
4,172,172,4,1,3,2,1
3,182,182,12,3,9,3,2
8,232,232,6,3,3,2,1
2,286,286,14,6,8,2,1
1,329,329,9,3,6,2,1
6,334,334,123,123,0,1,0
12,369,369,67,30,37,3,2
7,419,419,194,110,84,4,3
9,420,420,15,3,12,3,2
10,424,424,24,24,0,1,0
5,463,463,2,2,0,1,0

16,116,116,8,8,0,1,0
4,174,174,3,3,0,1,0
0,183,183,25,7,18,3,2
13,186,186,14,2,12,2,1
9,195,195,4,4,0,1,0
10,212,212,23,7,16,3,2
12,270,270,6,2,4,2,1
6,273,273,8,8,0,1,0
15,308,308,42,28,14,2,1
11,314,314,79,1,78,4,3
5,355,355,5,5,0,1,0
8,366,366,25,25,0,1,0
2,379,379,149,72,77,3,2
14,398,398,62,25,37,2,1
7,400,400,4,1,3,2,1
3,437,437,44,35,9,4,3
1,443,443,5,5,0,1,0

9,108,108,4,4,0,1,0
6,111,111,18,18,0,1,0
2,221,221,69,69,0,1,0
5,296,296,5,2,3,2,1
8,328,328,34,25,9,4,3
4,386,386,7,1,6,3,2
7,400,400,25,13,12,2,1
3,409,409,36,19,17,4,3
1,442,442,167,125,42,4,3
0,462,462,11,11,0,1,0
10,479,479,199,142,57,4,3

1,131,131,7,7,0,1,0
14,138,138,28,28,0,1,0
15,165,165,25,16,9,4,3
3,167,167,1,1,0,1,0
0,197,197,36,24,12,3,2
17,251,251,5,1,4,2,1
10,284,284,4,4,0,1,0
9,285,285,20,20,0,1,0
7,287,287,10,10,0,1,0
11,287,287,13,4,9,4,3
12,301,301,79,55,24,3,2
2,302,302,2,2,0,1,0
4,312,312,74,15,59,3,2
8,376,376,61,35,26,3,2
13,401,401,40,28,12,3,2
5,413,413,13,13,0,1,0
16,440,440,14,1,13,3,2
6,481,481,1,1,0,1,0

2,129,129,30,18,12,4,3
14,153,153,3,3,0,1,0
1,158,158,23,7,16,2,1
11,209,209,81,81,0,1,0
10,221,221,14,4,10,3,2
4,252,252,4,4,0,1,0
3,287,287,2,2,0,1,0
15,291,291,51,51,0,1,0
6,297,297,31,4,27,4,3
13,301,301,25,17,8,2,1
8,306,306,4,4,0,1,0
9,358,358,13,9,4,2,1
12,367,367,19,4,15,4,3
5,406,406,73,17,56,3,2
7,455,455,10,4,6,2,1
0,485,485,40,40,0,1,0

6,116,116,16,16,0,1,0
5,138,138,10,10,0,1,0
12,139,139,33,33,0,1,0
0,168,168,1,1,0,1,0
15,190,190,2,2,0,1,0
9,204,204,61,61,0,1,0
3,233,233,43,43,0,1,0
2,256,256,7,7,0,1,0
1,343,343,15,15,0,1,0
8,361,361,34,34,0,1,0
4,395,395,23,11,12,3,2
14,438,438,14,14,0,1,0
7,457,457,81,9,72,4,3
11,474,474,4,4,0,1,0
10,478,478,10,1,9,2,1
13,490,490,99,53,46,4,3

9,120,120,16,16,0,1,0
2,126,126,10,10,0,1,0
4,136,136,12,4,8,3,2
5,185,185,31,7,24,4,3
6,219,219,32,32,0,1,0
8,265,265,100,100,0,1,0
10,289,289,3,3,0,1,0
0,326,326,20,6,14,3,2
1,333,333,84,80,4,2,1
12,339,339,15,15,0,1,0
3,397,397,61,22,39,4,3
7,454,454,11,1,10,3,2
11,491,491,37,37,0,1,0

3,104,104,13,13,0,1,0
15,112,112,1,1,0,1,0
6,136,136,16,16,0,1,0
17,167,167,38,38,0,1,0
4,176,176,1,1,0,1,0
7,190,190,16,10,6,3,2
12,207,207,10,4,6,3,2
8,240,240,1,1,0,1,0
5,289,289,8,8,0,1,0
14,298,298,4,4,0,1,0
16,368,368,3,3,0,1,0
9,372,372,47,5,42,4,3
1,396,396,50,50,0,1,0
2,402,402,57,57,0,1,0
10,434,434,2,2,0,1,0
13,436,436,29,29,0,1,0
11,455,455,203,95,108,4,3
0,477,477,18,18,0,1,0

10,158,158,4,4,0,1,0
19,175,175,9,4,5,2,1
13,198,198,80,80,0,1,0
1,208,208,14,4,10,2,1
0,227,227,14,1,13,2,1
15,228,228,2,2,0,1,0
8,241,241,11,11,0,1,0
11,297,297,25,25,0,1,0
9,322,322,8,5,3,2,1
3,345,345,22,10,12,4,3
17,365,365,13,3,10,3,2
5,392,392,43,21,22,2,1
2,399,399,56,2,54,3,2
16,416,416,9,2,7,2,1
14,438,438,105,105,0,1,0
18,461,461,23,23,0,1,0
7,463,463,7,7,0,1,0
4,465,465,17,2,15,2,1
12,467,467,18,18,0,1,0
6,473,473,42,42,0,1,0

8,106,106,4,4,0,1,0
12,114,114,47,1,46,2,1
3,125,125,1,1,0,1,0
14,178,178,5,5,0,1,0
2,243,243,84,21,63,4,3
10,251,251,16,1,15,2,1
5,256,256,38,38,0,1,0
11,308,308,18,18,0,1,0
1,312,312,21,14,7,2,1
4,328,328,10,10,0,1,0
13,333,333,44,22,22,2,1
6,392,392,4,4,0,1,0
9,456,456,36,36,0,1,0
7,477,477,37,37,0,1,0
0,500,500,57,57,0,1,0

0,105,105,1,1,0,1,0
2,111,111,32,32,0,1,0
5,113,113,3,3,0,1,0
3,187,187,9,9,0,1,0
9,191,191,4,4,0,1,0
10,214,214,15,15,0,1,0
12,332,332,48,2,46,2,1
1,376,376,149,119,30,3,2
8,379,379,23,11,12,2,1
4,404,404,15,5,10,2,1
11,426,426,38,12,26,3,2
6,474,474,139,139,0,1,0
7,481,481,62,62,0,1,0

8,118,118,3,3,0,1,0
17,147,147,29,5,24,4,3
3,153,153,1,1,0,1,0
0,156,156,12,12,0,1,0
10,158,158,15,10,5,2,1
5,183,183,8,4,4,2,1
12,187,187,3,3,0,1,0
2,252,252,1,1,0,1,0
6,267,267,3,3,0,1,0
4,289,289,26,21,5,2,1
15,292,292,12,2,10,2,1
11,317,317,13,13,0,1,0
13,333,333,22,6,16,2,1
16,366,366,15,9,6,3,2
18,400,400,127,92,35,2,1
7,420,420,8,2,6,3,2
14,457,457,43,22,21,2,1
9,478,478,76,60,16,2,1
19,495,495,25,25,0,1,0
1,499,499,107,84,23,4,3

1,141,141,15,10,5,2,1
6,196,196,24,6,18,4,3
2,243,243,99,99,0,1,0
0,269,269,26,26,0,1,0
9,297,297,70,70,0,1,0
8,298,298,13,3,10,2,1
5,306,306,4,4,0,1,0
7,335,335,71,17,54,3,2
10,358,358,46,46,0,1,0
4,397,397,22,15,7,2,1
3,414,414,79,79,0,1,0

19,163,163,1,1,0,1,0
14,167,167,3,3,0,1,0
4,169,169,1,1,0,1,0
20,201,201,29,29,0,1,0
8,206,206,8,8,0,1,0
18,206,206,20,8,12,3,2
12,239,239,8,8,0,1,0
11,242,242,17,17,0,1,0
17,244,244,54,7,47,2,1
13,261,261,43,17,26,2,1
15,290,290,81,76,5,2,1
0,311,311,23,4,19,2,1
7,316,316,4,4,0,1,0
1,364,364,8,8,0,1,0
9,373,373,19,19,0,1,0
2,402,402,38,19,19,2,1
6,411,411,28,8,20,3,2
10,413,413,3,3,0,1,0
3,453,453,3,3,0,1,0
16,466,466,23,8,15,4,3
5,477,477,72,28,44,4,3

19,100,100,3,3,0,1,0
2,135,135,5,5,0,1,0
10,154,154,10,10,0,1,0
14,154,154,5,5,0,1,0
5,204,204,5,5,0,1,0
17,241,241,2,2,0,1,0
15,283,283,53,53,0,1,0
18,304,304,117,72,45,2,1
1,309,309,50,24,26,2,1
0,314,314,3,3,0,1,0
7,324,324,17,5,12,3,2
4,330,330,16,16,0,1,0
8,390,390,6,6,0,1,0
6,393,393,53,35,18,2,1
11,428,428,22,12,10,2,1
3,429,429,21,21,0,1,0
13,452,452,10,10,0,1,0
16,482,482,72,63,9,4,3
12,495,495,37,10,27,3,2
9,498,498,38,38,0,1,0

3,102,102,2,2,0,1,0
11,104,104,13,13,0,1,0
14,118,118,10,10,0,1,0
1,162,162,11,11,0,1,0
7,225,225,20,20,0,1,0
6,228,228,25,25,0,1,0
10,238,238,2,2,0,1,0
9,255,255,54,54,0,1,0
8,265,265,14,8,6,3,2
5,304,304,16,12,4,2,1
0,374,374,34,12,22,2,1
13,380,380,72,65,7,2,1
15,402,402,141,64,77,3,2
4,409,409,32,27,5,2,1
12,437,437,13,13,0,1,0
16,445,445,8,3,5,2,1
2,491,491,14,14,0,1,0

13,111,111,7,7,0,1,0
15,118,118,5,5,0,1,0
4,135,135,1,1,0,1,0
9,142,142,1,1,0,1,0
18,148,148,22,16,6,2,1
16,181,181,20,2,18,3,2
11,188,188,10,4,6,3,2
5,209,209,30,14,16,3,2
3,241,241,23,8,15,4,3
10,256,256,46,2,44,4,3
8,274,274,11,11,0,1,0
17,330,330,42,42,0,1,0
1,339,339,11,11,0,1,0
12,362,362,55,55,0,1,0
0,403,403,55,51,4,2,1
7,412,412,41,41,0,1,0
6,453,453,1,1,0,1,0
14,487,487,83,58,25,2,1
2,490,490,3,3,0,1,0

12,108,108,2,2,0,1,0
6,163,163,24,24,0,1,0
4,188,188,38,38,0,1,0
7,213,213,56,56,0,1,0
11,246,246,32,32,0,1,0
10,255,255,23,3,20,2,1
2,332,332,2,2,0,1,0
9,361,361,44,17,27,2,1
8,403,403,30,6,24,2,1
13,457,457,55,55,0,1,0
0,459,459,27,27,0,1,0
3,472,472,159,92,67,4,3
1,490,490,3,3,0,1,0
5,499,499,23,14,9,2,1

12,101,101,8,8,0,1,0
2,101,101,2,2,0,1,0
14,155,155,10,10,0,1,0
16,173,173,23,23,0,1,0
11,174,174,18,5,13,2,1
6,175,175,1,1,0,1,0
1,200,200,2,2,0,1,0
7,200,200,1,1,0,1,0
4,207,207,10,10,0,1,0
5,213,213,17,17,0,1,0
10,305,305,26,26,0,1,0
17,366,366,37,37,0,1,0
8,376,376,19,7,12,2,1
15,394,394,78,36,42,4,3
0,398,398,40,4,36,2,1
13,420,420,85,64,21,4,3
9,429,429,95,95,0,1,0
18,475,475,15,15,0,1,0
3,494,494,35,1,34,2,1

17,130,130,6,6,0,1,0
16,165,165,16,4,12,3,2
7,216,216,7,7,0,1,0
18,223,223,30,30,0,1,0
15,302,302,1,1,0,1,0
2,304,304,33,26,7,2,1
5,304,304,39,39,0,1,0
9,307,307,25,18,7,2,1
6,321,321,35,32,3,2,1
10,331,331,25,12,13,2,1
3,357,357,20,20,0,1,0
13,362,362,31,31,0,1,0
8,394,394,7,7,0,1,0
0,406,406,17,17,0,1,0
4,416,416,6,6,0,1,0
11,451,451,24,12,12,4,3
12,462,462,33,33,0,1,0
14,463,463,170,76,94,3,2
1,498,498,41,26,15,2,1

8,171,171,33,33,0,1,0
10,188,188,31,22,9,4,3
2,204,204,5,1,4,2,1
1,276,276,29,29,0,1,0
13,304,304,28,11,17,2,1
4,314,314,87,87,0,1,0
12,334,334,39,39,0,1,0
5,342,342,42,42,0,1,0
0,377,377,13,3,10,3,2
3,410,410,37,19,18,2,1
6,415,415,22,6,16,2,1
7,417,417,39,11,28,2,1
14,419,419,50,46,4,2,1
11,462,462,33,33,0,1,0
9,489,489,26,26,0,1,0

0,138,138,3,3,0,1,0
3,170,170,7,7,0,1,0
5,260,260,83,83,0,1,0
1,300,300,20,20,0,1,0
4,302,302,36,36,0,1,0
11,308,308,22,22,0,1,0
13,317,317,32,32,0,1,0
9,338,338,30,30,0,1,0
14,347,347,69,69,0,1,0
10,381,381,7,7,0,1,0
8,401,401,28,4,24,2,1
2,415,415,27,3,24,3,2
7,455,455,40,40,0,1,0
12,471,471,122,114,8,3,2
6,477,477,38,38,0,1,0

8,110,110,2,2,0,1,0
16,133,133,4,4,0,1,0
18,151,151,9,6,3,2,1
12,155,155,6,6,0,1,0
3,156,156,18,18,0,1,0
11,185,185,24,24,0,1,0
5,195,195,1,1,0,1,0
10,221,221,4,4,0,1,0
9,223,223,23,23,0,1,0
4,255,255,62,47,15,2,1
1,271,271,8,8,0,1,0
2,297,297,7,7,0,1,0
14,361,361,173,173,0,1,0
6,407,407,11,2,9,4,3
7,428,428,16,16,0,1,0
13,447,447,15,15,0,1,0
0,461,461,7,7,0,1,0
17,469,469,4,4,0,1,0
15,493,493,56,35,21,4,3
19,499,499,45,45,0,1,0

13,122,122,21,4,17,2,1
9,130,130,4,1,3,2,1
7,132,132,34,16,18,2,1
0,217,217,4,4,0,1,0
3,240,240,41,41,0,1,0
2,253,253,46,46,0,1,0
6,261,261,16,16,0,1,0
4,315,315,17,2,15,2,1
5,346,346,4,4,0,1,0
11,376,376,11,3,8,3,2
15,396,396,30,30,0,1,0
14,404,404,20,20,0,1,0
10,412,412,86,86,0,1,0
8,429,429,6,6,0,1,0
1,471,471,1,1,0,1,0
16,482,482,6,6,0,1,0
12,498,498,134,71,63,4,3

18,102,102,4,4,0,1,0
1,165,165,8,2,6,3,2
13,173,173,1,1,0,1,0
12,180,180,6,1,5,2,1
10,205,205,1,1,0,1,0
0,230,230,18,18,0,1,0
16,292,292,23,23,0,1,0
3,302,302,6,6,0,1,0
6,324,324,7,1,6,2,1
7,332,332,1,1,0,1,0
2,356,356,57,32,25,4,3
19,382,382,66,54,12,4,3
8,423,423,46,14,32,3,2
17,429,429,163,143,20,3,2
4,430,430,22,22,0,1,0
9,444,444,9,6,3,2,1
5,462,462,24,12,12,4,3
11,479,479,96,72,24,4,3
15,495,495,16,16,0,1,0
14,500,500,53,50,3,2,1

7,107,107,7,7,0,1,0
9,110,110,18,18,0,1,0
4,201,201,33,2,31,2,1
5,240,240,6,6,0,1,0
8,272,272,38,38,0,1,0
1,288,288,59,38,21,4,3
3,320,320,54,54,0,1,0
10,402,402,28,28,0,1,0
6,428,428,83,62,21,4,3
2,482,482,198,144,54,4,3
0,496,496,8,5,3,2,1

1,129,129,26,12,14,3,2
4,156,156,8,4,4,2,1
6,163,163,4,4,0,1,0
10,195,195,25,6,19,2,1
7,198,198,6,6,0,1,0
9,249,249,12,12,0,1,0
12,267,267,34,18,16,3,2
5,275,275,43,43,0,1,0
14,324,324,56,56,0,1,0
8,381,381,22,22,0,1,0
3,392,392,13,7,6,3,2
13,392,392,85,17,68,3,2
0,425,425,35,35,0,1,0
11,454,454,28,10,18,2,1
2,463,463,103,82,21,4,3

5,100,100,7,7,0,1,0
1,136,136,4,4,0,1,0
2,143,143,20,20,0,1,0
11,161,161,11,7,4,2,1
15,221,221,89,44,45,4,3
4,314,314,5,5,0,1,0
16,336,336,4,4,0,1,0
6,353,353,19,19,0,1,0
0,376,376,47,1,46,3,2
13,385,385,80,45,35,3,2
7,386,386,13,3,10,2,1
10,403,403,7,7,0,1,0
12,414,414,25,25,0,1,0
8,441,441,66,66,0,1,0
9,445,445,81,81,0,1,0
14,445,445,18,12,6,3,2
3,449,449,1,1,0,1,0

13,120,120,22,10,12,4,3
12,156,156,40,22,18,4,3
2,169,169,37,19,18,4,3
7,172,172,3,3,0,1,0
8,192,192,5,2,3,2,1
9,192,192,14,14,0,1,0
1,193,193,16,8,8,3,2
11,207,207,46,4,42,4,3
5,219,219,26,26,0,1,0
3,255,255,83,80,3,2,1
4,296,296,1,1,0,1,0
0,344,344,10,10,0,1,0
14,350,350,4,4,0,1,0
10,373,373,16,10,6,2,1
6,444,444,4,4,0,1,0

24,108,108,19,19,0,1,0
12,111,111,1,1,0,1,0
19,123,123,6,6,0,1,0
8,129,129,1,1,0,1,0
17,131,131,11,11,0,1,0
21,136,136,2,2,0,1,0
4,144,144,1,1,0,1,0
16,152,152,8,8,0,1,0
10,218,218,10,4,6,3,2
0,235,235,5,1,4,2,1
23,260,260,17,4,13,2,1
14,280,280,16,16,0,1,0
11,290,290,43,43,0,1,0
3,293,293,5,1,4,2,1
6,322,322,20,2,18,2,1
18,379,379,29,29,0,1,0
7,422,422,3,3,0,1,0
15,423,423,20,20,0,1,0
9,441,441,41,38,3,2,1
5,444,444,18,18,0,1,0
1,455,455,26,26,0,1,0
20,459,459,177,138,39,4,3
22,460,460,22,22,0,1,0
13,498,498,3,3,0,1,0
2,499,499,19,11,8,3,2

3,100,100,5,5,0,1,0
12,170,170,23,23,0,1,0
8,191,191,13,13,0,1,0
1,198,198,19,11,8,2,1
6,291,291,5,5,0,1,0
5,316,316,49,11,38,3,2
13,316,316,6,6,0,1,0
11,329,329,26,26,0,1,0
0,364,364,98,67,31,4,3
7,377,377,6,6,0,1,0
14,386,386,85,49,36,2,1
4,403,403,26,1,25,2,1
10,403,403,57,10,47,2,1
2,462,462,62,14,48,2,1
9,477,477,70,38,32,2,1

10,103,103,16,16,0,1,0
0,127,127,5,5,0,1,0
1,142,142,27,8,19,3,2
6,158,158,2,2,0,1,0
7,164,164,30,30,0,1,0
14,167,167,30,30,0,1,0
3,197,197,24,16,8,2,1
9,210,210,13,13,0,1,0
13,288,288,8,4,4,2,1
5,340,340,18,6,12,4,3
8,348,348,15,15,0,1,0
2,381,381,27,27,0,1,0
4,385,385,34,9,25,2,1
11,397,397,106,58,48,2,1
15,397,397,32,4,28,2,1
12,427,427,20,20,0,1,0

0,115,115,27,27,0,1,0
11,173,173,26,14,12,3,2
12,198,198,2,2,0,1,0
2,256,256,51,21,30,2,1
7,271,271,10,10,0,1,0
6,274,274,65,47,18,3,2
8,290,290,43,43,0,1,0
10,301,301,42,15,27,4,3
1,318,318,27,1,26,3,2
5,379,379,15,9,6,3,2
3,393,393,71,23,48,4,3
9,434,434,39,23,16,2,1
4,494,494,31,31,0,1,0

3,150,150,1,1,0,1,0
4,156,156,3,3,0,1,0
10,172,172,63,63,0,1,0
5,193,193,8,1,7,2,1
11,196,196,2,2,0,1,0
13,209,209,1,1,0,1,0
2,213,213,9,9,0,1,0
9,254,254,12,5,7,2,1
6,339,339,61,61,0,1,0
14,347,347,41,41,0,1,0
15,355,355,80,56,24,2,1
1,372,372,93,64,29,2,1
0,383,383,18,18,0,1,0
12,401,401,18,18,0,1,0
8,457,457,80,24,56,3,2
7,500,500,20,20,0,1,0

16,135,135,15,1,14,2,1
6,144,144,9,2,7,2,1
7,162,162,12,12,0,1,0
11,173,173,29,9,20,2,1
10,186,186,1,1,0,1,0
19,198,198,17,8,9,2,1
1,200,200,1,1,0,1,0
20,207,207,54,54,0,1,0
14,274,274,52,52,0,1,0
3,295,295,1,1,0,1,0
12,298,298,22,4,18,3,2
5,334,334,44,38,6,3,2
2,337,337,13,13,0,1,0
15,373,373,9,1,8,3,2
4,399,399,13,13,0,1,0
18,444,444,55,40,15,2,1
0,474,474,38,9,29,2,1
17,476,476,10,10,0,1,0
8,484,484,29,9,20,3,2
9,489,489,5,1,4,2,1
13,494,494,28,28,0,1,0

15,102,102,32,32,0,1,0
14,216,216,1,1,0,1,0
8,218,218,2,2,0,1,0
1,220,220,7,7,0,1,0
5,225,225,33,33,0,1,0
12,247,247,45,25,20,2,1
17,283,283,10,4,6,3,2
11,308,308,19,4,15,4,3
9,318,318,55,1,54,4,3
6,332,332,44,44,0,1,0
4,337,337,41,31,10,2,1
10,360,360,19,19,0,1,0
0,390,390,4,4,0,1,0
16,417,417,40,40,0,1,0
7,421,421,13,13,0,1,0
2,430,430,7,3,4,2,1
13,468,468,56,56,0,1,0
3,495,495,38,29,9,2,1

3,101,101,14,14,0,1,0
16,138,138,2,2,0,1,0
13,172,172,10,3,7,2,1
12,196,196,5,5,0,1,0
11,203,203,7,7,0,1,0
4,227,227,8,8,0,1,0
6,244,244,2,2,0,1,0
2,249,249,5,1,4,2,1
5,276,276,17,3,14,3,2
18,283,283,32,32,0,1,0
14,284,284,62,62,0,1,0
19,299,299,66,3,63,3,2
9,317,317,1,1,0,1,0
1,391,391,101,53,48,2,1
0,411,411,33,33,0,1,0
8,437,437,8,8,0,1,0
20,466,466,13,13,0,1,0
17,470,470,26,26,0,1,0
10,488,488,9,9,0,1,0
7,494,494,20,20,0,1,0
15,496,496,79,79,0,1,0

4,101,101,6,6,0,1,0
14,158,158,5,5,0,1,0
5,181,181,1,1,0,1,0
15,194,194,21,13,8,2,1
17,212,212,60,60,0,1,0
7,242,242,76,76,0,1,0
11,291,291,46,2,44,3,2
16,296,296,69,69,0,1,0
0,300,300,3,3,0,1,0
12,300,300,1,1,0,1,0
8,345,345,1,1,0,1,0
2,360,360,26,26,0,1,0
6,362,362,44,6,38,3,2
10,376,376,5,5,0,1,0
9,384,384,7,1,6,2,1
13,436,436,2,2,0,1,0
1,464,464,83,59,24,4,3
3,499,499,3,3,0,1,0

1,111,111,2,2,0,1,0
12,118,118,33,33,0,1,0
8,119,119,24,24,0,1,0
10,125,125,5,5,0,1,0
15,160,160,1,1,0,1,0
9,179,179,9,1,8,2,1
0,217,217,13,13,0,1,0
3,266,266,2,2,0,1,0
6,281,281,69,15,54,4,3
5,313,313,62,26,36,4,3
2,363,363,11,11,0,1,0
11,365,365,3,3,0,1,0
13,368,368,35,13,22,2,1
14,379,379,129,129,0,1,0
4,490,490,17,7,10,3,2
7,491,491,6,6,0,1,0

4,138,138,25,25,0,1,0
6,171,171,2,2,0,1,0
13,185,185,6,6,0,1,0
10,190,190,7,7,0,1,0
8,245,245,2,2,0,1,0
7,273,273,50,27,23,2,1
11,276,276,42,42,0,1,0
9,296,296,137,137,0,1,0
2,355,355,87,42,45,4,3
5,378,378,36,18,18,2,1
3,422,422,1,1,0,1,0
0,427,427,34,8,26,3,2
12,427,427,9,9,0,1,0
14,445,445,44,16,28,3,2
1,489,489,1,1,0,1,0

13,121,121,7,7,0,1,0
9,122,122,4,4,0,1,0
11,126,126,2,2,0,1,0
17,126,126,15,3,12,3,2
18,162,162,32,8,24,4,3
14,217,217,1,1,0,1,0
0,245,245,58,58,0,1,0
1,252,252,19,7,12,4,3
5,255,255,7,1,6,3,2
10,266,266,1,1,0,1,0
15,274,274,15,8,7,2,1
12,345,345,22,22,0,1,0
2,411,411,22,19,3,2,1
8,433,433,26,20,6,2,1
7,439,439,2,2,0,1,0
3,446,446,3,3,0,1,0
4,449,449,73,13,60,4,3
6,451,451,57,57,0,1,0
16,464,464,145,142,3,2,1

10,138,138,53,53,0,1,0
8,173,173,3,3,0,1,0
13,180,180,33,11,22,2,1
12,210,210,22,22,0,1,0
7,295,295,7,2,5,2,1
14,333,333,3,3,0,1,0
5,343,343,3,3,0,1,0
1,372,372,25,15,10,3,2
2,381,381,22,22,0,1,0
11,399,399,16,16,0,1,0
0,437,437,46,4,42,4,3
3,468,468,207,207,0,1,0
6,480,480,40,40,0,1,0
9,485,485,35,35,0,1,0
4,498,498,7,7,0,1,0

5,115,115,17,11,6,2,1
1,194,194,37,37,0,1,0
8,206,206,37,9,28,3,2
6,272,272,17,2,15,3,2
4,306,306,19,3,16,2,1
7,318,318,7,1,6,2,1
2,352,352,27,5,22,2,1
9,360,360,66,66,0,1,0
11,388,388,63,31,32,2,1
10,418,418,22,22,0,1,0
3,431,431,150,150,0,1,0
0,463,463,57,48,9,2,1

18,123,123,2,2,0,1,0
3,134,134,1,1,0,1,0
10,153,153,3,3,0,1,0
15,213,213,39,39,0,1,0
6,224,224,19,19,0,1,0
13,244,244,6,6,0,1,0
17,274,274,42,8,34,3,2
16,294,294,16,7,9,3,2
2,333,333,10,2,8,3,2
5,364,364,40,24,16,3,2
8,376,376,79,79,0,1,0
4,397,397,6,6,0,1,0
0,415,415,24,6,18,3,2
12,426,426,85,85,0,1,0
14,449,449,81,81,0,1,0
7,477,477,42,28,14,2,1
9,477,477,17,9,8,2,1
1,493,493,45,45,0,1,0
11,495,495,25,25,0,1,0

7,218,218,1,1,0,1,0
14,228,228,36,36,0,1,0
0,265,265,19,19,0,1,0
1,273,273,98,24,74,3,2
4,299,299,31,31,0,1,0
11,306,306,34,34,0,1,0
10,320,320,3,3,0,1,0
13,323,323,23,5,18,2,1
5,326,326,6,6,0,1,0
3,354,354,34,34,0,1,0
2,381,381,4,4,0,1,0
15,383,383,72,72,0,1,0
12,436,436,98,98,0,1,0
6,449,449,46,46,0,1,0
8,463,463,16,10,6,3,2
9,470,470,22,22,0,1,0

13,149,149,4,4,0,1,0
11,191,191,2,2,0,1,0
0,216,216,12,12,0,1,0
8,244,244,9,9,0,1,0
4,249,249,32,32,0,1,0
12,250,250,62,57,5,2,1
14,262,262,17,17,0,1,0
5,281,281,15,6,9,4,3
17,282,282,109,79,30,4,3
10,284,284,17,17,0,1,0
7,313,313,27,27,0,1,0
2,338,338,3,3,0,1,0
1,340,340,48,48,0,1,0
9,360,360,17,11,6,2,1
3,409,409,29,24,5,2,1
16,451,451,11,11,0,1,0
15,454,454,26,2,24,2,1
6,467,467,53,21,32,3,2

11,187,187,2,2,0,1,0
0,195,195,44,25,19,2,1
12,215,215,19,19,0,1,0
10,224,224,19,19,0,1,0
8,238,238,14,14,0,1,0
5,272,272,54,33,21,2,1
6,277,277,38,30,8,2,1
7,292,292,82,82,0,1,0
3,341,341,9,4,5,2,1
1,370,370,1,1,0,1,0
9,399,399,46,46,0,1,0
2,438,438,64,2,62,4,3
13,438,438,76,76,0,1,0
4,465,465,30,22,8,2,1

6,103,103,5,5,0,1,0
10,178,178,5,5,0,1,0
14,184,184,1,1,0,1,0
21,206,206,6,6,0,1,0
2,218,218,4,4,0,1,0
20,235,235,21,21,0,1,0
22,247,247,25,25,0,1,0
9,249,249,17,5,12,4,3
11,252,252,1,1,0,1,0
7,275,275,6,6,0,1,0
5,293,293,10,2,8,2,1
19,314,314,48,48,0,1,0
1,317,317,1,1,0,1,0
8,330,330,37,37,0,1,0
16,341,341,28,15,13,2,1
4,382,382,33,33,0,1,0
17,415,415,150,63,87,4,3
0,430,430,55,34,21,4,3
3,446,446,59,31,28,3,2
15,461,461,1,1,0,1,0
23,464,464,21,21,0,1,0
13,488,488,12,4,8,2,1
18,497,497,16,2,14,3,2
12,498,498,1,1,0,1,0

7,128,128,15,15,0,1,0
10,172,172,1,1,0,1,0
17,173,173,5,5,0,1,0
5,185,185,1,1,0,1,0
3,225,225,4,1,3,2,1
14,226,226,1,1,0,1,0
9,239,239,23,3,20,4,3
15,246,246,5,5,0,1,0
4,261,261,21,21,0,1,0
11,278,278,5,5,0,1,0
18,284,284,90,90,0,1,0
6,296,296,21,7,14,2,1
0,327,327,39,3,36,3,2
8,344,344,22,4,18,4,3
16,385,385,21,21,0,1,0
13,418,418,36,36,0,1,0
12,466,466,140,118,22,3,2
1,481,481,49,27,22,4,3
2,499,499,53,53,0,1,0

0,108,108,4,4,0,1,0
4,270,270,38,20,18,3,2
13,348,348,21,21,0,1,0
16,398,398,23,1,22,2,1
10,401,401,59,59,0,1,0
2,421,421,28,16,12,3,2
7,441,441,30,30,0,1,0
9,447,447,1,1,0,1,0
11,450,450,72,72,0,1,0
3,457,457,8,8,0,1,0
12,464,464,5,5,0,1,0
15,467,467,146,146,0,1,0
8,475,475,111,96,15,4,3
6,487,487,47,47,0,1,0
14,493,493,29,29,0,1,0
1,497,497,47,20,27,4,3
5,499,499,22,8,14,3,2

10,113,113,13,4,9,4,3
8,115,115,11,2,9,4,3
18,118,118,5,5,0,1,0
19,132,132,20,15,5,2,1
3,137,137,24,17,7,2,1
4,141,141,8,2,6,3,2
15,143,143,5,2,3,2,1
17,164,164,68,68,0,1,0
16,173,173,5,5,0,1,0
9,174,174,9,9,0,1,0
11,201,201,6,6,0,1,0
13,240,240,1,1,0,1,0
5,253,253,1,1,0,1,0
20,291,291,18,18,0,1,0
0,306,306,7,1,6,2,1
2,361,361,17,4,13,2,1
14,364,364,7,2,5,2,1
22,375,375,37,37,0,1,0
1,405,405,20,12,8,2,1
7,410,410,25,7,18,2,1
6,424,424,3,3,0,1,0
21,479,479,11,11,0,1,0
12,481,481,15,6,9,2,1

10,146,146,27,27,0,1,0
4,171,171,26,26,0,1,0
11,180,180,27,27,0,1,0
5,185,185,4,4,0,1,0
0,189,189,3,3,0,1,0
6,216,216,12,9,3,2,1
3,285,285,126,126,0,1,0
2,309,309,14,5,9,4,3
1,328,328,21,1,20,2,1
9,338,338,61,37,24,3,2
8,356,356,37,37,0,1,0
13,364,364,60,60,0,1,0
14,368,368,1,1,0,1,0
12,466,466,10,4,6,2,1
7,494,494,2,2,0,1,0

9,111,111,9,4,5,2,1
2,136,136,1,1,0,1,0
1,191,191,8,2,6,2,1
0,207,207,33,33,0,1,0
11,233,233,58,58,0,1,0
14,257,257,37,4,33,2,1
4,287,287,5,1,4,2,1
3,293,293,80,32,48,3,2
15,309,309,2,2,0,1,0
7,323,323,26,26,0,1,0
16,333,333,8,3,5,2,1
13,346,346,26,26,0,1,0
10,378,378,49,28,21,2,1
12,386,386,71,17,54,4,3
6,403,403,7,1,6,3,2
5,423,423,19,10,9,2,1
8,445,445,36,14,22,3,2

16,103,103,12,8,4,2,1
7,120,120,5,5,0,1,0
8,141,141,8,8,0,1,0
9,171,171,7,7,0,1,0
18,173,173,37,7,30,4,3
3,187,187,11,3,8,2,1
1,199,199,11,11,0,1,0
5,214,214,7,7,0,1,0
12,244,244,6,6,0,1,0
2,251,251,2,2,0,1,0
17,278,278,3,3,0,1,0
14,282,282,83,78,5,2,1
11,337,337,43,4,39,2,1
15,351,351,34,4,30,3,2
10,359,359,32,32,0,1,0
4,408,408,69,69,0,1,0
6,446,446,11,11,0,1,0
0,451,451,44,44,0,1,0
13,453,453,30,11,19,2,1

11,140,140,17,17,0,1,0
7,146,146,21,21,0,1,0
13,196,196,42,20,22,2,1
1,202,202,6,6,0,1,0
9,208,208,24,16,8,3,2
8,242,242,26,26,0,1,0
6,255,255,8,8,0,1,0
2,294,294,68,68,0,1,0
5,318,318,29,20,9,2,1
14,341,341,49,49,0,1,0
3,367,367,5,5,0,1,0
10,380,380,41,1,40,3,2
0,381,381,51,23,28,3,2
4,390,390,49,49,0,1,0
12,399,399,3,3,0,1,0

1,123,123,5,5,0,1,0
7,195,195,11,11,0,1,0
8,206,206,28,28,0,1,0
5,242,242,4,4,0,1,0
6,257,257,19,19,0,1,0
9,261,261,9,9,0,1,0
13,277,277,8,8,0,1,0
10,298,298,35,35,0,1,0
0,305,305,46,13,33,4,3
11,321,321,133,105,28,2,1
4,354,354,144,65,79,4,3
12,372,372,8,8,0,1,0
3,421,421,41,41,0,1,0
2,486,486,8,8,0,1,0

10,208,208,6,6,0,1,0
1,213,213,107,56,51,3,2
9,261,261,29,29,0,1,0
5,317,317,59,59,0,1,0
7,329,329,10,10,0,1,0
2,349,349,65,38,27,4,3
6,369,369,88,50,38,3,2
4,371,371,8,3,5,2,1
8,393,393,76,56,20,2,1
0,418,418,31,31,0,1,0
3,460,460,18,18,0,1,0

19,122,122,12,12,0,1,0
8,170,170,14,10,4,2,1
14,184,184,4,4,0,1,0
0,203,203,10,3,7,2,1
11,210,210,7,7,0,1,0
18,217,217,57,11,46,4,3
16,218,218,26,17,9,2,1
9,261,261,14,14,0,1,0
13,268,268,7,2,5,2,1
5,284,284,75,30,45,4,3
3,301,301,1,1,0,1,0
15,311,311,64,64,0,1,0
17,320,320,26,16,10,2,1
1,345,345,6,6,0,1,0
6,357,357,54,10,44,3,2
12,377,377,3,3,0,1,0
4,385,385,3,3,0,1,0
2,389,389,25,25,0,1,0
10,411,411,16,16,0,1,0
7,486,486,14,14,0,1,0

5,125,125,49,15,34,2,1
1,126,126,23,9,14,2,1
3,187,187,3,3,0,1,0
9,273,273,23,23,0,1,0
6,297,297,6,3,3,2,1
7,331,331,21,9,12,3,2
2,365,365,146,51,95,4,3
4,410,410,39,39,0,1,0
8,471,471,67,67,0,1,0
0,472,472,103,103,0,1,0

13,117,117,34,34,0,1,0
3,191,191,14,14,0,1,0
15,206,206,5,1,4,2,1
6,231,231,1,1,0,1,0
1,233,233,21,21,0,1,0
11,246,246,29,20,9,2,1
4,266,266,10,10,0,1,0
9,272,272,20,3,17,2,1
0,308,308,5,5,0,1,0
14,340,340,7,7,0,1,0
7,351,351,17,7,10,2,1
10,448,448,96,48,48,4,3
12,462,462,34,34,0,1,0
2,476,476,16,16,0,1,0
8,478,478,39,21,18,3,2
5,499,499,208,132,76,3,2

6,206,206,18,12,6,2,1
1,236,236,41,41,0,1,0
0,249,249,39,4,35,2,1
9,256,256,6,6,0,1,0
5,314,314,10,10,0,1,0
4,317,317,61,61,0,1,0
2,327,327,45,45,0,1,0
10,393,393,92,19,73,4,3
3,410,410,137,62,75,4,3
7,419,419,62,34,28,3,2
8,484,484,45,3,42,3,2

1,108,108,2,2,0,1,0
13,109,109,4,4,0,1,0
6,147,147,15,15,0,1,0
16,149,149,17,5,12,4,3
7,164,164,15,6,9,2,1
12,168,168,1,1,0,1,0
4,205,205,6,6,0,1,0
5,215,215,12,2,10,2,1
8,218,218,22,13,9,4,3
0,245,245,35,20,15,2,1
15,291,291,43,8,35,2,1
2,324,324,19,19,0,1,0
14,333,333,37,4,33,2,1
10,348,348,4,4,0,1,0
9,363,363,24,24,0,1,0
11,363,363,30,30,0,1,0
18,366,366,1,1,0,1,0
17,386,386,87,81,6,2,1
19,406,406,74,74,0,1,0
3,456,456,18,18,0,1,0

9,100,100,16,7,9,2,1
2,209,209,16,16,0,1,0
12,223,223,15,7,8,3,2
4,237,237,24,24,0,1,0
6,322,322,51,51,0,1,0
10,329,329,27,27,0,1,0
0,368,368,11,3,8,3,2
7,377,377,6,6,0,1,0
8,379,379,77,21,56,3,2
1,384,384,9,4,5,2,1
13,446,446,94,10,84,3,2
5,463,463,58,58,0,1,0
3,480,480,137,137,0,1,0
11,486,486,38,20,18,4,3

12,159,159,13,13,0,1,0
7,167,167,18,18,0,1,0
17,167,167,41,29,12,3,2
9,174,174,23,23,0,1,0
3,178,178,1,1,0,1,0
1,180,180,2,2,0,1,0
8,210,210,4,4,0,1,0
14,220,220,33,2,31,2,1
10,238,238,2,2,0,1,0
11,281,281,42,9,33,4,3
15,329,329,19,19,0,1,0
13,336,336,36,21,15,4,3
0,368,368,77,5,72,4,3
4,377,377,1,1,0,1,0
2,384,384,26,26,0,1,0
6,417,417,41,41,0,1,0
5,433,433,61,10,51,4,3
16,434,434,10,10,0,1,0

5,111,111,15,15,0,1,0
11,115,115,6,6,0,1,0
15,129,129,2,2,0,1,0
4,181,181,12,12,0,1,0
6,198,198,2,2,0,1,0
8,198,198,7,7,0,1,0
9,223,223,28,25,3,2,1
1,230,230,8,5,3,2,1
10,236,236,32,20,12,2,1
0,285,285,3,3,0,1,0
12,292,292,58,58,0,1,0
16,333,333,23,17,6,2,1
2,347,347,71,39,32,2,1
13,381,381,25,5,20,3,2
3,416,416,27,5,22,2,1
7,471,471,55,55,0,1,0
14,479,479,132,42,90,4,3

2,133,133,22,4,18,3,2
17,137,137,18,18,0,1,0
0,163,163,8,8,0,1,0
15,181,181,13,13,0,1,0
14,189,189,47,32,15,2,1
11,232,232,5,5,0,1,0
3,255,255,22,16,6,2,1
7,271,271,5,1,4,2,1
1,272,272,44,44,0,1,0
6,321,321,6,2,4,2,1
16,346,346,35,32,3,2,1
10,356,356,9,3,6,3,2
13,372,372,72,72,0,1,0
5,393,393,64,64,0,1,0
8,401,401,41,33,8,2,1
12,417,417,18,7,11,2,1
4,448,448,4,4,0,1,0
9,462,462,1,1,0,1,0

8,123,123,1,1,0,1,0
4,149,149,6,6,0,1,0
11,177,177,8,8,0,1,0
10,205,205,17,17,0,1,0
3,252,252,47,7,40,3,2
2,319,319,75,75,0,1,0
5,329,329,54,54,0,1,0
12,343,343,33,33,0,1,0
0,356,356,38,38,0,1,0
1,360,360,25,25,0,1,0
7,398,398,60,60,0,1,0
9,412,412,24,1,23,2,1
6,442,442,167,26,141,4,3

2,104,104,12,12,0,1,0
0,106,106,15,7,8,2,1
9,107,107,4,1,3,2,1
7,125,125,5,5,0,1,0
10,170,170,7,7,0,1,0
5,177,177,8,8,0,1,0
1,189,189,12,2,10,3,2
3,210,210,22,18,4,2,1
12,213,213,116,51,65,3,2
13,218,218,30,21,9,4,3
14,274,274,1,1,0,1,0
16,281,281,11,11,0,1,0
4,371,371,20,4,16,3,2
15,395,395,13,13,0,1,0
6,420,420,11,11,0,1,0
8,422,422,73,6,67,4,3
11,425,425,6,6,0,1,0

3,111,111,3,3,0,1,0
7,115,115,5,5,0,1,0
14,128,128,6,3,3,2,1
9,196,196,13,1,12,2,1
13,217,217,5,5,0,1,0
8,229,229,19,19,0,1,0
2,234,234,50,20,30,4,3
10,260,260,115,115,0,1,0
6,286,286,9,9,0,1,0
15,331,331,44,38,6,2,1
4,344,344,5,5,0,1,0
11,374,374,1,1,0,1,0
0,381,381,11,11,0,1,0
12,391,391,39,39,0,1,0
5,398,398,61,61,0,1,0
1,464,464,95,41,54,3,2

12,142,142,34,17,17,2,1
4,171,171,16,16,0,1,0
9,198,198,10,10,0,1,0
11,208,208,33,7,26,2,1
3,253,253,29,22,7,2,1
10,274,274,10,2,8,3,2
5,329,329,52,31,21,4,3
0,340,340,3,3,0,1,0
6,340,340,19,19,0,1,0
2,404,404,74,41,33,4,3
1,428,428,104,65,39,2,1
7,441,441,60,60,0,1,0
8,447,447,64,40,24,4,3

11,120,120,2,2,0,1,0
5,122,122,11,2,9,3,2
4,125,125,16,16,0,1,0
16,159,159,44,44,0,1,0
10,194,194,36,36,0,1,0
9,205,205,8,8,0,1,0
2,263,263,60,60,0,1,0
0,297,297,52,26,26,2,1
13,299,299,38,20,18,4,3
14,384,384,16,3,13,2,1
6,411,411,22,13,9,2,1
1,441,441,2,2,0,1,0
8,461,461,22,15,7,2,1
15,480,480,41,41,0,1,0
3,488,488,2,2,0,1,0
7,492,492,17,7,10,3,2
12,494,494,41,5,36,4,3

3,108,108,7,7,0,1,0
10,109,109,20,20,0,1,0
6,162,162,17,9,8,3,2
7,185,185,16,16,0,1,0
1,281,281,114,52,62,3,2
0,284,284,23,23,0,1,0
9,325,325,3,3,0,1,0
4,331,331,86,5,81,4,3
8,333,333,5,5,0,1,0
2,375,375,96,96,0,1,0
5,474,474,72,72,0,1,0

1,118,118,1,1,0,1,0
13,159,159,6,6,0,1,0
0,202,202,54,10,44,3,2
9,216,216,2,2,0,1,0
3,260,260,31,21,10,2,1
12,282,282,19,10,9,4,3
2,340,340,14,14,0,1,0
11,346,346,70,36,34,3,2
10,372,372,118,49,69,4,3
7,379,379,75,29,46,3,2
5,401,401,11,11,0,1,0
14,409,409,20,20,0,1,0
6,437,437,11,4,7,2,1
15,443,443,57,44,13,2,1
4,454,454,12,12,0,1,0
8,496,496,44,15,29,4,3

6,115,115,16,7,9,4,3
10,116,116,9,9,0,1,0
11,126,126,6,2,4,2,1
15,136,136,29,21,8,3,2
7,157,157,8,8,0,1,0
16,191,191,2,2,0,1,0
3,211,211,22,22,0,1,0
1,216,216,11,11,0,1,0
5,278,278,28,28,0,1,0
9,288,288,21,21,0,1,0
13,304,304,34,5,29,2,1
2,316,316,21,21,0,1,0
4,329,329,39,39,0,1,0
0,362,362,2,2,0,1,0
8,457,457,42,18,24,2,1
14,473,473,18,18,0,1,0
12,495,495,160,160,0,1,0

10,143,143,4,4,0,1,0
6,168,168,25,11,14,2,1
7,179,179,10,7,3,2,1
4,198,198,2,2,0,1,0
8,205,205,15,5,10,3,2
11,213,213,45,45,0,1,0
9,221,221,48,29,19,2,1
1,242,242,3,3,0,1,0
2,309,309,68,68,0,1,0
0,328,328,34,16,18,4,3
3,331,331,20,20,0,1,0
12,434,434,37,37,0,1,0
5,483,483,190,156,34,3,2

6,147,147,11,11,0,1,0
1,151,151,4,4,0,1,0
12,153,153,1,1,0,1,0
8,162,162,26,2,24,4,3
7,185,185,3,3,0,1,0
9,186,186,24,24,0,1,0
13,339,339,133,133,0,1,0
2,361,361,34,28,6,2,1
5,384,384,120,48,72,4,3
4,396,396,1,1,0,1,0
0,399,399,33,33,0,1,0
11,409,409,11,3,8,3,2
3,424,424,89,42,47,2,1
10,484,484,42,28,14,2,1

14,102,102,4,4,0,1,0
0,158,158,1,1,0,1,0
13,164,164,13,9,4,2,1
10,229,229,35,5,30,3,2
15,292,292,10,10,0,1,0
5,294,294,47,7,40,4,3
2,304,304,42,42,0,1,0
8,332,332,4,4,0,1,0
11,336,336,11,2,9,4,3
7,363,363,8,8,0,1,0
3,366,366,53,53,0,1,0
9,372,372,111,111,0,1,0
4,379,379,12,12,0,1,0
12,390,390,68,28,40,3,2
6,411,411,28,6,22,3,2
1,491,491,108,108,0,1,0

11,123,123,4,1,3,2,1
0,129,129,17,17,0,1,0
2,157,157,12,6,6,2,1
9,175,175,8,8,0,1,0
14,185,185,10,10,0,1,0
10,228,228,3,3,0,1,0
19,230,230,19,7,12,3,2
6,241,241,23,4,19,3,2
13,244,244,20,20,0,1,0
20,275,275,89,74,15,4,3
12,295,295,17,17,0,1,0
17,302,302,29,29,0,1,0
1,314,314,29,23,6,3,2
3,335,335,16,16,0,1,0
8,353,353,25,15,10,3,2
4,358,358,3,3,0,1,0
18,376,376,58,41,17,2,1
7,394,394,12,12,0,1,0
15,412,412,32,10,22,3,2
5,435,435,8,8,0,1,0
16,485,485,10,10,0,1,0

15,100,100,7,1,6,2,1
1,162,162,1,1,0,1,0
0,181,181,51,27,24,4,3
17,206,206,6,6,0,1,0
12,238,238,99,83,16,2,1
6,252,252,60,26,34,2,1
2,278,278,8,4,4,2,1
8,327,327,12,6,6,2,1
9,338,338,10,10,0,1,0
16,381,381,37,1,36,4,3
10,388,388,11,11,0,1,0
5,394,394,2,2,0,1,0
3,395,395,2,2,0,1,0
7,396,396,27,15,12,2,1
14,399,399,29,23,6,2,1
13,400,400,42,36,6,2,1
4,465,465,34,22,12,4,3
11,489,489,12,12,0,1,0

14,180,180,16,16,0,1,0
5,233,233,15,3,12,3,2
15,245,245,30,30,0,1,0
8,250,250,19,19,0,1,0
11,287,287,86,68,18,3,2
10,306,306,28,15,13,4,3
4,321,321,1,1,0,1,0
13,327,327,1,1,0,1,0
2,341,341,55,55,0,1,0
12,349,349,70,70,0,1,0
3,356,356,105,105,0,1,0
1,372,372,11,1,10,3,2
0,442,442,1,1,0,1,0
6,443,443,37,30,7,2,1
9,487,487,3,3,0,1,0
7,498,498,43,27,16,3,2

7,147,147,9,9,0,1,0
6,180,180,26,9,17,2,1
12,181,181,19,19,0,1,0
8,201,201,21,1,20,3,2
11,223,223,48,34,14,3,2
10,330,330,28,28,0,1,0
13,332,332,7,7,0,1,0
9,366,366,100,73,27,4,3
14,397,397,1,1,0,1,0
15,399,399,43,43,0,1,0
3,402,402,51,18,33,2,1
1,408,408,10,6,4,2,1
0,415,415,64,6,58,4,3
2,440,440,24,24,0,1,0
5,450,450,27,6,21,2,1
4,497,497,36,21,15,2,1

3,126,126,52,37,15,2,1
7,149,149,3,3,0,1,0
0,175,175,1,1,0,1,0
1,228,228,28,8,20,3,2
5,247,247,14,4,10,3,2
8,248,248,28,8,20,2,1
9,294,294,29,12,17,3,2
4,296,296,15,15,0,1,0
10,309,309,99,75,24,2,1
6,364,364,74,60,14,3,2
2,367,367,57,24,33,4,3
11,422,422,11,11,0,1,0
12,486,486,15,15,0,1,0

6,176,176,13,2,11,2,1
5,212,212,30,20,10,3,2
10,217,217,16,4,12,4,3
11,217,217,38,38,0,1,0
12,272,272,15,15,0,1,0
7,276,276,17,17,0,1,0
0,387,387,15,2,13,3,2
3,400,400,2,2,0,1,0
8,415,415,109,33,76,3,2
4,441,441,88,88,0,1,0
9,450,450,54,19,35,2,1
2,451,451,9,9,0,1,0
13,465,465,30,30,0,1,0
1,471,471,152,31,121,4,3

3,131,131,20,20,0,1,0
4,132,132,49,30,19,2,1
1,142,142,19,4,15,4,3
7,190,190,4,4,0,1,0
5,193,193,8,8,0,1,0
2,210,210,3,3,0,1,0
11,239,239,6,6,0,1,0
10,248,248,12,8,4,2,1
0,330,330,44,44,0,1,0
6,356,356,184,184,0,1,0
9,415,415,21,1,20,2,1
8,476,476,50,50,0,1,0

2,120,120,26,26,0,1,0
15,159,159,45,45,0,1,0
14,168,168,2,2,0,1,0
9,192,192,34,34,0,1,0
0,211,211,1,1,0,1,0
8,215,215,10,7,3,2,1
4,217,217,11,11,0,1,0
7,223,223,28,11,17,2,1
6,232,232,23,3,20,3,2
11,258,258,36,36,0,1,0
13,298,298,7,7,0,1,0
1,328,328,28,28,0,1,0
12,339,339,38,38,0,1,0
10,444,444,30,14,16,2,1
3,456,456,1,1,0,1,0
5,486,486,83,44,39,3,2

4,129,129,17,6,11,2,1
5,139,139,32,32,0,1,0
8,161,161,7,1,6,3,2
11,204,204,76,76,0,1,0
7,230,230,23,17,6,3,2
2,236,236,3,3,0,1,0
6,288,288,42,42,0,1,0
3,302,302,18,6,12,4,3
1,363,363,72,42,30,4,3
12,422,422,22,3,19,2,1
0,425,425,74,6,68,3,2
10,464,464,38,38,0,1,0
9,493,493,9,6,3,2,1

15,166,166,14,14,0,1,0
6,172,172,9,9,0,1,0
3,204,204,28,4,24,3,2
12,210,210,75,70,5,2,1
9,246,246,4,4,0,1,0
11,271,271,13,5,8,3,2
7,278,278,10,10,0,1,0
5,290,290,15,8,7,2,1
2,300,300,16,16,0,1,0
8,310,310,29,29,0,1,0
4,326,326,13,2,11,2,1
16,329,329,58,58,0,1,0
13,394,394,7,3,4,2,1
14,422,422,28,28,0,1,0
0,428,428,93,46,47,4,3
1,474,474,50,7,43,4,3
10,481,481,30,18,12,3,2

5,121,121,30,18,12,4,3
7,143,143,27,27,0,1,0
1,145,145,72,29,43,3,2
2,183,183,7,7,0,1,0
11,214,214,3,3,0,1,0
6,260,260,10,10,0,1,0
9,346,346,50,50,0,1,0
4,370,370,8,8,0,1,0
3,396,396,79,41,38,2,1
0,416,416,19,19,0,1,0
8,425,425,36,20,16,3,2
10,489,489,47,47,0,1,0

5,106,106,20,20,0,1,0
6,111,111,3,3,0,1,0
7,115,115,11,8,3,2,1
9,156,156,22,8,14,2,1
8,217,217,10,10,0,1,0
2,218,218,46,46,0,1,0
3,223,223,37,37,0,1,0
4,241,241,1,1,0,1,0
12,251,251,47,7,40,4,3
0,258,258,19,1,18,2,1
11,287,287,6,6,0,1,0
1,325,325,13,5,8,3,2
13,353,353,66,34,32,2,1
10,354,354,57,7,50,3,2
14,439,439,30,7,23,4,3

10,119,119,1,1,0,1,0
8,165,165,3,3,0,1,0
5,178,178,7,7,0,1,0
3,186,186,5,5,0,1,0
11,215,215,9,1,8,3,2
7,221,221,13,13,0,1,0
13,221,221,49,4,45,2,1
4,232,232,21,17,4,2,1
16,236,236,29,29,0,1,0
0,247,247,49,49,0,1,0
17,263,263,46,46,0,1,0
6,275,275,7,2,5,2,1
2,364,364,29,29,0,1,0
14,364,364,39,39,0,1,0
18,371,371,32,2,30,2,1
9,399,399,33,33,0,1,0
19,400,400,8,8,0,1,0
15,401,401,31,31,0,1,0
12,425,425,11,11,0,1,0
1,484,484,51,12,39,2,1

10,165,165,8,8,0,1,0
12,165,165,21,21,0,1,0
4,168,168,12,1,11,2,1
0,225,225,9,9,0,1,0
2,268,268,27,27,0,1,0
7,287,287,21,21,0,1,0
13,328,328,49,3,46,4,3
9,340,340,21,21,0,1,0
1,387,387,48,48,0,1,0
6,432,432,16,6,10,2,1
8,434,434,75,57,18,3,2
11,436,436,79,59,20,4,3
5,441,441,127,28,99,4,3
3,466,466,65,35,30,4,3

5,103,103,4,4,0,1,0
7,106,106,2,2,0,1,0
10,148,148,1,1,0,1,0
1,198,198,34,8,26,2,1
4,208,208,14,5,9,2,1
3,214,214,31,31,0,1,0
6,231,231,38,14,24,3,2
13,309,309,30,14,16,2,1
12,360,360,119,41,78,3,2
0,367,367,20,2,18,4,3
11,380,380,45,24,21,2,1
2,406,406,65,65,0,1,0
9,430,430,3,3,0,1,0
8,481,481,112,18,94,3,2

1,105,105,1,1,0,1,0
0,113,113,20,20,0,1,0
2,114,114,13,13,0,1,0
3,154,154,35,35,0,1,0
12,186,186,15,15,0,1,0
10,199,199,22,9,13,2,1
9,256,256,37,37,0,1,0
7,268,268,44,22,22,3,2
11,271,271,59,2,57,4,3
4,323,323,12,12,0,1,0
5,327,327,73,73,0,1,0
6,356,356,5,5,0,1,0
8,407,407,9,1,8,3,2
13,448,448,33,12,21,2,1

2,115,115,5,1,4,2,1
15,150,150,13,13,0,1,0
5,178,178,37,37,0,1,0
0,225,225,2,2,0,1,0
6,229,229,8,8,0,1,0
10,247,247,25,25,0,1,0
9,252,252,13,13,0,1,0
13,258,258,35,35,0,1,0
7,261,261,25,12,13,2,1
12,278,278,13,4,9,2,1
3,345,345,82,52,30,4,3
11,375,375,128,41,87,4,3
8,408,408,7,7,0,1,0
1,411,411,3,3,0,1,0
4,442,442,66,54,12,3,2
14,489,489,22,22,0,1,0

7,139,139,13,13,0,1,0
2,144,144,34,22,12,3,2
1,160,160,11,11,0,1,0
0,181,181,30,30,0,1,0
14,249,249,25,25,0,1,0
6,254,254,1,1,0,1,0
5,260,260,16,11,5,2,1
11,286,286,72,72,0,1,0
13,290,290,5,5,0,1,0
4,310,310,12,12,0,1,0
10,352,352,2,2,0,1,0
9,359,359,31,9,22,3,2
16,375,375,54,34,20,3,2
8,379,379,13,8,5,2,1
15,389,389,11,11,0,1,0
3,438,438,5,5,0,1,0
12,485,485,126,69,57,3,2

14,157,157,14,14,0,1,0
5,166,166,16,16,0,1,0
2,170,170,2,2,0,1,0
6,187,187,9,2,7,2,1
10,212,212,42,21,21,4,3
7,237,237,40,40,0,1,0
4,243,243,47,15,32,4,3
0,269,269,4,4,0,1,0
13,311,311,18,18,0,1,0
15,317,317,34,30,4,2,1
16,318,318,101,59,42,2,1
12,323,323,9,9,0,1,0
9,411,411,6,6,0,1,0
3,436,436,78,66,12,4,3
8,448,448,1,1,0,1,0
1,448,448,32,11,21,2,1
11,456,456,7,7,0,1,0

0,149,149,38,21,17,2,1
5,217,217,53,34,19,4,3
4,223,223,16,16,0,1,0
1,250,250,119,50,69,4,3
9,360,360,143,109,34,3,2
3,372,372,7,7,0,1,0
6,404,404,13,4,9,4,3
7,407,407,10,10,0,1,0
8,415,415,8,2,6,3,2
2,461,461,32,21,11,4,3

18,192,192,14,6,8,2,1
4,193,193,12,12,0,1,0
0,210,210,15,4,11,2,1
5,236,236,6,3,3,2,1
9,250,250,2,2,0,1,0
7,257,257,2,2,0,1,0
6,309,309,35,14,21,2,1
1,314,314,28,28,0,1,0
10,320,320,15,15,0,1,0
15,321,321,162,51,111,4,3
13,327,327,1,1,0,1,0
16,342,342,18,18,0,1,0
11,343,343,87,5,82,4,3
14,414,414,9,2,7,2,1
2,416,416,9,9,0,1,0
12,420,420,5,5,0,1,0
3,457,457,22,22,0,1,0
8,473,473,25,9,16,3,2
17,488,488,71,54,17,2,1

10,151,151,10,10,0,1,0
12,153,153,32,32,0,1,0
16,183,183,35,35,0,1,0
11,188,188,6,6,0,1,0
7,201,201,25,25,0,1,0
9,203,203,18,6,12,3,2
6,204,204,37,23,14,3,2
0,253,253,50,50,0,1,0
13,279,279,17,4,13,3,2
1,351,351,12,12,0,1,0
8,352,352,24,1,23,2,1
15,401,401,41,11,30,4,3
4,425,425,8,8,0,1,0
5,448,448,27,17,10,2,1
3,452,452,10,2,8,2,1
2,482,482,4,4,0,1,0
14,488,488,74,74,0,1,0

7,139,139,11,11,0,1,0
13,176,176,65,7,58,3,2
2,200,200,6,6,0,1,0
5,223,223,30,30,0,1,0
3,258,258,37,37,0,1,0
17,280,280,10,10,0,1,0
11,296,296,13,13,0,1,0
16,297,297,10,10,0,1,0
14,304,304,4,4,0,1,0
6,321,321,10,10,0,1,0
0,331,331,73,73,0,1,0
10,355,355,34,34,0,1,0
9,392,392,9,3,6,3,2
8,401,401,4,4,0,1,0
15,405,405,66,66,0,1,0
12,415,415,63,63,0,1,0
1,419,419,11,11,0,1,0
4,454,454,3,3,0,1,0

15,111,111,1,1,0,1,0
7,115,115,10,1,9,2,1
1,143,143,4,4,0,1,0
4,144,144,20,20,0,1,0
0,174,174,6,3,3,2,1
17,219,219,6,2,4,2,1
6,246,246,27,27,0,1,0
14,252,252,2,2,0,1,0
16,255,255,20,10,10,2,1
13,284,284,48,13,35,2,1
3,286,286,1,1,0,1,0
8,294,294,43,43,0,1,0
5,303,303,3,3,0,1,0
2,306,306,40,40,0,1,0
10,374,374,6,6,0,1,0
11,385,385,187,187,0,1,0
9,433,433,42,2,40,4,3
12,458,458,17,2,15,2,1

6,100,100,9,9,0,1,0
12,107,107,11,11,0,1,0
8,140,140,1,1,0,1,0
7,152,152,11,11,0,1,0
10,236,236,74,74,0,1,0
2,352,352,5,5,0,1,0
0,399,399,72,72,0,1,0
4,409,409,96,96,0,1,0
13,429,429,74,74,0,1,0
5,435,435,42,42,0,1,0
9,453,453,41,1,40,2,1
3,467,467,85,56,29,4,3
1,470,470,3,3,0,1,0
11,482,482,29,13,16,3,2

13,159,159,9,9,0,1,0
5,163,163,2,2,0,1,0
8,189,189,37,37,0,1,0
14,200,200,18,3,15,2,1
10,219,219,84,17,67,4,3
0,238,238,20,20,0,1,0
9,357,357,11,11,0,1,0
6,365,365,11,1,10,3,2
12,376,376,4,4,0,1,0
4,398,398,13,13,0,1,0
11,431,431,30,30,0,1,0
2,454,454,5,1,4,2,1
7,465,465,188,107,81,4,3
3,476,476,9,6,3,2,1
15,486,486,85,71,14,3,2
1,500,500,7,2,5,2,1

1,210,210,4,1,3,2,1
6,260,260,57,37,20,2,1
0,278,278,94,20,74,3,2
10,281,281,24,24,0,1,0
3,302,302,9,3,6,2,1
2,405,405,168,137,31,4,3
4,412,412,33,13,20,3,2
9,435,435,145,145,0,1,0
5,443,443,4,4,0,1,0
7,454,454,21,21,0,1,0
8,487,487,17,17,0,1,0

2,104,104,2,2,0,1,0
12,120,120,11,11,0,1,0
4,123,123,4,4,0,1,0
17,123,123,5,5,0,1,0
5,165,165,3,3,0,1,0
8,176,176,5,5,0,1,0
7,194,194,34,10,24,3,2
3,206,206,12,7,5,2,1
13,224,224,21,3,18,4,3
9,251,251,9,9,0,1,0
15,254,254,68,53,15,4,3
14,278,278,29,29,0,1,0
1,320,320,57,7,50,3,2
6,326,326,13,13,0,1,0
16,326,326,52,20,32,2,1
11,379,379,29,20,9,2,1
18,395,395,23,5,18,4,3
0,435,435,30,30,0,1,0
10,473,473,33,33,0,1,0

9,121,121,4,4,0,1,0
14,134,134,51,44,7,2,1
6,199,199,9,9,0,1,0
13,229,229,7,2,5,2,1
7,269,269,53,11,42,2,1
8,270,270,1,1,0,1,0
12,275,275,4,4,0,1,0
3,344,344,2,2,0,1,0
2,350,350,11,11,0,1,0
16,376,376,4,4,0,1,0
10,392,392,36,18,18,3,2
15,423,423,18,18,0,1,0
4,426,426,128,128,0,1,0
1,438,438,35,35,0,1,0
0,463,463,45,11,34,3,2
5,479,479,4,4,0,1,0
11,488,488,119,38,81,4,3

6,100,100,9,9,0,1,0
15,121,121,1,1,0,1,0
14,127,127,24,12,12,4,3
11,168,168,1,1,0,1,0
5,182,182,1,1,0,1,0
0,183,183,30,24,6,3,2
18,200,200,23,23,0,1,0
7,201,201,3,3,0,1,0
13,206,206,4,4,0,1,0
16,219,219,34,7,27,2,1
9,249,249,29,19,10,2,1
12,266,266,26,26,0,1,0
1,280,280,1,1,0,1,0
20,283,283,33,33,0,1,0
4,295,295,3,3,0,1,0
19,351,351,50,13,37,2,1
8,367,367,3,3,0,1,0
17,404,404,37,37,0,1,0
3,413,413,25,25,0,1,0
10,428,428,41,12,29,2,1
2,451,451,50,26,24,4,3

12,113,113,22,8,14,3,2
9,141,141,30,30,0,1,0
5,157,157,40,40,0,1,0
2,201,201,13,13,0,1,0
3,270,270,6,3,3,2,1
10,301,301,8,8,0,1,0
6,317,317,11,5,6,3,2
11,326,326,78,78,0,1,0
7,333,333,6,6,0,1,0
4,353,353,13,13,0,1,0
8,381,381,35,35,0,1,0
1,428,428,136,76,60,4,3
0,432,432,46,28,18,2,1

9,130,130,3,3,0,1,0
14,163,163,7,7,0,1,0
12,169,169,27,27,0,1,0
7,183,183,7,7,0,1,0
3,232,232,22,10,12,3,2
11,252,252,79,1,78,4,3
5,260,260,27,17,10,2,1
0,315,315,6,6,0,1,0
10,338,338,10,10,0,1,0
4,339,339,35,35,0,1,0
13,375,375,24,24,0,1,0
2,378,378,72,72,0,1,0
6,415,415,49,38,11,2,1
8,422,422,17,5,12,4,3
15,436,436,82,25,57,3,2
1,440,440,41,41,0,1,0

7,124,124,3,3,0,1,0
3,145,145,19,19,0,1,0
0,191,191,1,1,0,1,0
15,200,200,33,33,0,1,0
13,201,201,29,23,6,3,2
14,241,241,9,9,0,1,0
11,245,245,43,43,0,1,0
9,249,249,10,10,0,1,0
8,348,348,50,50,0,1,0
12,389,389,20,20,0,1,0
5,398,398,15,15,0,1,0
2,412,412,35,12,23,2,1
1,430,430,50,50,0,1,0
16,438,438,28,8,20,3,2
6,440,440,65,15,50,2,1
10,442,442,80,80,0,1,0
4,478,478,34,10,24,3,2

2,107,107,1,1,0,1,0
7,116,116,11,11,0,1,0
12,125,125,2,2,0,1,0
14,142,142,41,41,0,1,0
1,152,152,16,13,3,2,1
8,185,185,3,3,0,1,0
10,203,203,56,56,0,1,0
3,242,242,18,12,6,2,1
5,246,246,5,5,0,1,0
9,304,304,7,7,0,1,0
13,347,347,43,1,42,2,1
11,423,423,31,31,0,1,0
0,427,427,170,170,0,1,0
6,455,455,2,2,0,1,0
4,460,460,45,3,42,2,1

12,103,103,1,1,0,1,0
0,160,160,6,2,4,2,1
1,170,170,9,9,0,1,0
6,180,180,5,5,0,1,0
8,216,216,56,40,16,3,2
3,234,234,101,101,0,1,0
10,316,316,1,1,0,1,0
5,323,323,15,15,0,1,0
7,349,349,6,6,0,1,0
2,380,380,32,2,30,4,3
11,409,409,3,3,0,1,0
4,426,426,44,44,0,1,0
9,444,444,188,122,66,3,2
13,461,461,3,3,0,1,0
14,487,487,51,5,46,2,1

7,106,106,4,1,3,2,1
20,108,108,3,3,0,1,0
5,113,113,1,1,0,1,0
4,130,130,8,8,0,1,0
14,147,147,32,32,0,1,0
1,162,162,18,18,0,1,0
6,215,215,3,3,0,1,0
2,250,250,6,6,0,1,0
16,261,261,58,27,31,2,1
17,264,264,2,2,0,1,0
11,336,336,2,2,0,1,0
10,340,340,19,5,14,2,1
19,356,356,70,65,5,2,1
13,385,385,11,5,6,2,1
9,398,398,61,24,37,2,1
12,431,431,14,4,10,3,2
0,433,433,99,99,0,1,0
3,435,435,6,6,0,1,0
8,443,443,11,11,0,1,0
15,456,456,12,4,8,2,1
18,465,465,55,30,25,2,1

4,104,104,32,32,0,1,0
9,188,188,49,49,0,1,0
12,206,206,50,45,5,2,1
5,272,272,4,4,0,1,0
8,311,311,16,16,0,1,0
11,345,345,44,14,30,3,2
6,369,369,20,4,16,3,2
0,382,382,3,3,0,1,0
10,407,407,21,15,6,3,2
3,453,453,79,79,0,1,0
7,453,453,11,11,0,1,0
1,479,479,116,88,28,4,3
2,483,483,27,27,0,1,0

15,169,169,23,9,14,3,2
7,172,172,12,6,6,3,2
5,173,173,28,28,0,1,0
10,189,189,25,25,0,1,0
13,222,222,44,44,0,1,0
3,262,262,2,2,0,1,0
9,287,287,28,28,0,1,0
6,338,338,8,2,6,2,1
4,349,349,19,19,0,1,0
8,351,351,39,9,30,3,2
0,367,367,22,22,0,1,0
14,367,367,10,10,0,1,0
12,390,390,77,77,0,1,0
1,411,411,78,78,0,1,0
2,440,440,54,44,10,2,1
11,494,494,12,2,10,3,2

2,248,248,15,15,0,1,0
7,248,248,13,13,0,1,0
0,254,254,116,96,20,3,2
3,351,351,54,39,15,2,1
1,366,366,48,26,22,2,1
9,375,375,28,13,15,2,1
4,410,410,85,66,19,2,1
8,411,411,12,5,7,2,1
10,420,420,40,40,0,1,0
5,422,422,78,45,33,2,1
6,490,490,80,57,23,2,1

7,111,111,1,1,0,1,0
4,123,123,20,9,11,2,1
2,125,125,4,1,3,2,1
15,145,145,8,2,6,3,2
9,166,166,17,17,0,1,0
1,284,284,35,3,32,4,3
6,296,296,23,23,0,1,0
0,307,307,10,6,4,2,1
10,311,311,48,48,0,1,0
12,334,334,25,15,10,3,2
13,343,343,27,11,16,2,1
3,348,348,82,82,0,1,0
5,380,380,37,37,0,1,0
8,406,406,13,13,0,1,0
14,407,407,74,35,39,2,1
11,431,431,72,42,30,3,2

1,100,100,12,12,0,1,0
7,157,157,39,39,0,1,0
8,183,183,26,26,0,1,0
12,215,215,15,15,0,1,0
4,257,257,36,12,24,2,1
11,325,325,23,15,8,3,2
10,343,343,27,3,24,2,1
0,384,384,30,30,0,1,0
6,438,438,58,58,0,1,0
9,443,443,31,13,18,2,1
3,460,460,93,93,0,1,0
5,489,489,9,3,6,3,2
2,490,490,119,87,32,2,1

1,114,114,8,1,7,2,1
4,114,114,8,8,0,1,0
7,122,122,2,2,0,1,0
8,141,141,7,7,0,1,0
15,148,148,7,7,0,1,0
13,188,188,1,1,0,1,0
12,218,218,23,23,0,1,0
17,236,236,69,29,40,3,2
5,253,253,8,8,0,1,0
2,297,297,35,20,15,4,3
11,307,307,40,7,33,4,3
16,311,311,68,68,0,1,0
3,340,340,51,51,0,1,0
6,369,369,28,4,24,2,1
14,432,432,8,8,0,1,0
9,439,439,4,1,3,2,1
0,442,442,88,19,69,4,3
10,444,444,5,5,0,1,0

13,116,116,5,2,3,2,1
20,147,147,19,5,14,2,1
6,175,175,11,11,0,1,0
17,192,192,9,9,0,1,0
19,207,207,5,5,0,1,0
18,213,213,16,16,0,1,0
14,214,214,45,45,0,1,0
11,226,226,1,1,0,1,0
3,229,229,43,43,0,1,0
15,269,269,58,28,30,4,3
9,296,296,11,11,0,1,0
1,332,332,6,6,0,1,0
5,339,339,10,6,4,2,1
0,383,383,16,16,0,1,0
10,397,397,51,51,0,1,0
2,424,424,11,11,0,1,0
7,437,437,6,6,0,1,0
8,439,439,47,47,0,1,0
12,458,458,24,19,5,2,1
4,468,468,23,7,16,3,2
16,500,500,55,38,17,2,1

7,112,112,15,4,11,2,1
12,117,117,1,1,0,1,0
1,128,128,1,1,0,1,0
10,130,130,14,3,11,2,1
4,158,158,2,2,0,1,0
6,165,165,13,13,0,1,0
5,202,202,5,5,0,1,0
14,209,209,2,2,0,1,0
11,225,225,62,62,0,1,0
8,319,319,87,30,57,4,3
0,346,346,60,36,24,2,1
2,358,358,73,42,31,2,1
3,369,369,64,32,32,2,1
9,421,421,9,9,0,1,0
13,480,480,61,51,10,2,1

7,118,118,1,1,0,1,0
5,122,122,26,16,10,3,2
10,128,128,20,11,9,2,1
6,159,159,3,3,0,1,0
16,160,160,1,1,0,1,0
3,168,168,16,6,10,3,2
8,208,208,8,1,7,2,1
15,258,258,35,35,0,1,0
11,273,273,67,52,15,2,1
1,282,282,3,3,0,1,0
14,293,293,21,1,20,3,2
2,343,343,12,12,0,1,0
9,347,347,29,29,0,1,0
4,366,366,72,72,0,1,0
12,401,401,29,9,20,3,2
13,411,411,52,28,24,4,3
0,426,426,43,1,42,2,1

6,109,109,4,4,0,1,0
4,110,110,12,12,0,1,0
15,151,151,42,42,0,1,0
11,238,238,10,10,0,1,0
8,288,288,8,2,6,2,1
10,292,292,24,9,15,2,1
12,315,315,13,5,8,2,1
2,338,338,5,5,0,1,0
9,353,353,89,38,51,4,3
7,354,354,83,9,74,3,2
0,375,375,40,40,0,1,0
3,375,375,24,24,0,1,0
14,473,473,26,23,3,2,1
13,476,476,28,28,0,1,0
1,494,494,50,6,44,2,1
5,498,498,54,28,26,2,1

8,112,112,26,14,12,3,2
12,113,113,29,29,0,1,0
14,132,132,9,3,6,3,2
9,137,137,6,2,4,2,1
13,143,143,40,40,0,1,0
2,186,186,4,4,0,1,0
7,221,221,8,8,0,1,0
4,235,235,12,6,6,3,2
1,236,236,14,1,13,2,1
10,249,249,2,2,0,1,0
0,271,271,56,56,0,1,0
6,288,288,25,19,6,3,2
15,352,352,55,55,0,1,0
11,382,382,2,2,0,1,0
3,402,402,32,32,0,1,0
5,461,461,16,16,0,1,0

0,107,107,22,22,0,1,0
11,234,234,54,3,51,4,3
6,258,258,22,1,21,2,1
9,258,258,3,3,0,1,0
3,268,268,4,4,0,1,0
2,270,270,2,2,0,1,0
7,290,290,45,45,0,1,0
10,302,302,10,10,0,1,0
8,345,345,44,12,32,2,1
16,363,363,9,9,0,1,0
5,402,402,13,4,9,4,3
4,418,418,24,3,21,2,1
15,434,434,65,6,59,4,3
12,440,440,144,129,15,4,3
13,440,440,10,2,8,3,2
1,470,470,49,49,0,1,0
14,489,489,10,10,0,1,0

2,111,111,24,9,15,2,1
14,136,136,58,58,0,1,0
12,158,158,16,16,0,1,0
4,251,251,13,1,12,4,3
10,254,254,29,29,0,1,0
16,268,268,13,13,0,1,0
6,319,319,1,1,0,1,0
3,336,336,28,4,24,3,2
5,388,388,12,12,0,1,0
9,393,393,31,31,0,1,0
7,396,396,74,8,66,4,3
15,415,415,9,1,8,2,1
0,424,424,4,4,0,1,0
1,432,432,11,1,10,4,3
11,438,438,19,9,10,2,1
8,465,465,53,53,0,1,0
13,485,485,29,8,21,4,3

0,123,123,5,5,0,1,0
2,133,133,31,31,0,1,0
8,151,151,26,19,7,2,1
4,201,201,15,15,0,1,0
7,201,201,28,28,0,1,0
10,242,242,27,27,0,1,0
1,300,300,1,1,0,1,0
12,353,353,11,11,0,1,0
11,355,355,49,49,0,1,0
9,376,376,16,16,0,1,0
6,377,377,68,63,5,2,1
3,384,384,108,3,105,4,3
5,453,453,76,19,57,3,2

4,179,179,13,13,0,1,0
5,207,207,10,10,0,1,0
11,235,235,49,32,17,2,1
3,275,275,14,8,6,2,1
8,325,325,19,1,18,2,1
9,333,333,54,42,12,4,3
7,386,386,9,9,0,1,0
2,428,428,33,33,0,1,0
10,433,433,101,89,12,2,1
0,451,451,148,148,0,1,0
1,455,455,125,125,0,1,0
6,498,498,39,39,0,1,0

7,155,155,17,17,0,1,0
2,178,178,20,20,0,1,0
8,213,213,49,35,14,3,2
12,231,231,21,17,4,2,1
3,278,278,92,92,0,1,0
9,293,293,32,25,7,2,1
10,302,302,70,19,51,4,3
1,310,310,17,17,0,1,0
5,325,325,80,34,46,2,1
0,378,378,18,18,0,1,0
4,410,410,4,4,0,1,0
11,443,443,3,3,0,1,0
6,478,478,16,16,0,1,0

6,121,121,13,4,9,2,1
1,156,156,30,9,21,4,3
11,160,160,37,37,0,1,0
7,192,192,26,3,23,4,3
9,192,192,33,33,0,1,0
5,274,274,8,8,0,1,0
0,277,277,7,2,5,2,1
2,363,363,45,16,29,2,1
8,372,372,3,3,0,1,0
3,427,427,37,19,18,2,1
10,445,445,60,23,37,4,3
4,471,471,176,122,54,4,3

0,101,101,27,16,11,2,1
6,114,114,15,15,0,1,0
14,117,117,16,16,0,1,0
3,129,129,1,1,0,1,0
13,160,160,7,7,0,1,0
9,178,178,2,2,0,1,0
8,218,218,32,4,28,2,1
2,227,227,1,1,0,1,0
12,296,296,17,17,0,1,0
1,380,380,3,3,0,1,0
11,388,388,45,45,0,1,0
7,417,417,6,2,4,2,1
5,470,470,18,8,10,2,1
10,484,484,149,149,0,1,0
4,499,499,165,76,89,4,3

0,132,132,29,17,12,2,1
15,173,173,66,1,65,4,3
9,187,187,8,2,6,2,1
1,233,233,1,1,0,1,0
10,266,266,9,9,0,1,0
16,277,277,32,11,21,2,1
13,303,303,1,1,0,1,0
12,316,316,17,11,6,2,1
14,388,388,87,8,79,3,2
4,398,398,27,3,24,3,2
7,400,400,25,25,0,1,0
2,452,452,118,88,30,4,3
11,465,465,1,1,0,1,0
8,489,489,11,1,10,2,1
3,497,497,54,54,0,1,0
6,497,497,5,5,0,1,0
5,498,498,1,1,0,1,0

3,119,119,1,1,0,1,0
8,119,119,30,30,0,1,0
0,183,183,6,6,0,1,0
2,194,194,2,2,0,1,0
12,216,216,3,3,0,1,0
10,245,245,44,19,25,2,1
7,299,299,8,8,0,1,0
9,314,314,37,37,0,1,0
5,318,318,105,105,0,1,0
1,362,362,13,6,7,2,1
6,446,446,7,4,3,2,1
4,473,473,182,59,123,4,3
11,489,489,99,99,0,1,0

13,123,123,8,8,0,1,0
10,177,177,44,14,30,2,1
7,203,203,3,3,0,1,0
4,231,231,65,38,27,4,3
5,293,293,1,1,0,1,0
0,298,298,23,10,13,4,3
8,298,298,44,44,0,1,0
1,323,323,2,2,0,1,0
11,347,347,42,42,0,1,0
2,371,371,94,94,0,1,0
6,385,385,63,63,0,1,0
3,405,405,2,2,0,1,0
9,418,418,22,22,0,1,0
12,467,467,6,6,0,1,0
14,493,493,84,17,67,4,3

15,100,100,33,33,0,1,0
17,141,141,15,15,0,1,0
3,148,148,2,2,0,1,0
11,152,152,5,5,0,1,0
10,162,162,11,11,0,1,0
9,214,214,4,4,0,1,0
16,224,224,1,1,0,1,0
12,243,243,42,4,38,2,1
2,273,273,38,26,12,3,2
0,320,320,6,6,0,1,0
6,343,343,15,15,0,1,0
14,358,358,4,4,0,1,0
4,363,363,65,60,5,2,1
5,379,379,59,59,0,1,0
1,384,384,9,9,0,1,0
8,412,412,40,5,35,3,2
13,420,420,67,37,30,2,1
7,454,454,20,20,0,1,0

4,101,101,7,7,0,1,0
16,116,116,38,22,16,2,1
3,122,122,9,9,0,1,0
15,145,145,26,26,0,1,0
2,171,171,5,5,0,1,0
11,178,178,9,9,0,1,0
8,198,198,2,2,0,1,0
1,229,229,14,2,12,3,2
0,329,329,26,26,0,1,0
9,338,338,34,34,0,1,0
5,364,364,82,82,0,1,0
6,390,390,53,18,35,2,1
14,436,436,12,12,0,1,0
10,458,458,45,14,31,2,1
13,470,470,8,8,0,1,0
12,478,478,55,46,9,4,3
7,490,490,9,9,0,1,0

1,107,107,33,33,0,1,0
2,125,125,4,1,3,2,1
10,126,126,19,4,15,4,3
9,166,166,50,50,0,1,0
13,178,178,22,5,17,2,1
0,188,188,9,9,0,1,0
7,213,213,2,2,0,1,0
11,300,300,26,6,20,2,1
5,320,320,49,49,0,1,0
3,332,332,48,42,6,3,2
12,341,341,3,3,0,1,0
6,383,383,26,26,0,1,0
4,470,470,22,22,0,1,0
8,489,489,64,56,8,2,1

12,151,151,5,5,0,1,0
8,164,164,16,4,12,4,3
13,167,167,44,44,0,1,0
9,189,189,13,13,0,1,0
18,204,204,57,19,38,4,3
0,248,248,5,5,0,1,0
10,257,257,23,19,4,2,1
5,265,265,1,1,0,1,0
16,324,324,5,5,0,1,0
4,339,339,57,31,26,2,1
2,367,367,4,4,0,1,0
15,401,401,9,1,8,3,2
11,402,402,20,20,0,1,0
14,435,435,58,58,0,1,0
1,438,438,27,1,26,3,2
7,442,442,33,33,0,1,0
17,444,444,28,14,14,3,2
6,463,463,11,2,9,2,1
3,479,479,63,63,0,1,0

6,103,103,25,25,0,1,0
5,106,106,29,10,19,2,1
9,114,114,29,2,27,2,1
12,153,153,2,2,0,1,0
4,199,199,14,14,0,1,0
13,210,210,8,8,0,1,0
2,211,211,2,2,0,1,0
3,225,225,34,34,0,1,0
0,351,351,9,9,0,1,0
8,388,388,103,47,56,4,3
7,401,401,30,3,27,4,3
10,464,464,11,1,10,3,2
1,492,492,17,17,0,1,0
11,492,492,69,43,26,3,2

12,106,106,13,13,0,1,0
15,122,122,10,7,3,2,1
14,146,146,32,32,0,1,0
4,148,148,4,1,3,2,1
7,183,183,4,4,0,1,0
16,193,193,11,11,0,1,0
18,266,266,55,55,0,1,0
10,278,278,3,3,0,1,0
11,281,281,4,4,0,1,0
13,288,288,10,10,0,1,0
8,318,318,29,29,0,1,0
1,320,320,55,55,0,1,0
9,354,354,48,48,0,1,0
3,361,361,5,5,0,1,0
5,395,395,46,46,0,1,0
2,397,397,16,16,0,1,0
19,401,401,36,7,29,2,1
17,416,416,55,55,0,1,0
0,416,416,14,14,0,1,0
6,429,429,1,1,0,1,0

8,149,149,15,6,9,4,3
0,157,157,30,30,0,1,0
3,165,165,19,19,0,1,0
6,210,210,17,5,12,2,1
10,268,268,31,15,16,2,1
11,312,312,25,7,18,2,1
7,363,363,5,5,0,1,0
5,368,368,1,1,0,1,0
9,382,382,127,57,70,3,2
12,419,419,3,3,0,1,0
13,439,439,71,45,26,3,2
1,442,442,109,93,16,3,2
2,457,457,43,43,0,1,0
4,469,469,34,7,27,4,3

6,112,112,44,44,0,1,0
4,113,113,39,15,24,3,2
1,115,115,6,3,3,2,1
0,128,128,8,3,5,2,1
11,166,166,17,17,0,1,0
5,174,174,6,1,5,2,1
2,198,198,17,17,0,1,0
12,278,278,12,12,0,1,0
8,309,309,12,12,0,1,0
3,319,319,71,31,40,2,1
9,389,389,22,8,14,3,2
10,490,490,70,28,42,3,2
7,491,491,19,19,0,1,0

10,166,166,9,9,0,1,0
12,200,200,22,22,0,1,0
0,213,213,10,10,0,1,0
2,231,231,35,35,0,1,0
5,269,269,77,77,0,1,0
13,270,270,41,41,0,1,0
8,281,281,46,46,0,1,0
4,336,336,8,1,7,2,1
11,344,344,78,78,0,1,0
6,357,357,3,3,0,1,0
9,362,362,33,33,0,1,0
1,384,384,93,93,0,1,0
7,443,443,8,8,0,1,0
3,478,478,20,7,13,2,1

13,130,130,5,2,3,2,1
0,159,159,4,1,3,2,1
4,172,172,42,42,0,1,0
11,242,242,30,30,0,1,0
3,246,246,44,44,0,1,0
1,250,250,6,1,5,2,1
8,251,251,97,7,90,4,3
12,260,260,7,7,0,1,0
7,285,285,7,7,0,1,0
9,370,370,1,1,0,1,0
6,402,402,53,31,22,2,1
5,407,407,29,29,0,1,0
10,417,417,66,66,0,1,0
2,477,477,49,49,0,1,0
14,492,492,37,19,18,4,3

2,117,117,5,1,4,2,1
19,158,158,10,7,3,2,1
8,177,177,26,26,0,1,0
15,213,213,76,76,0,1,0
3,255,255,5,5,0,1,0
10,272,272,2,2,0,1,0
0,303,303,15,15,0,1,0
9,322,322,7,7,0,1,0
6,338,338,65,22,43,2,1
12,359,359,11,2,9,4,3
17,361,361,37,14,23,2,1
7,366,366,55,55,0,1,0
4,380,380,6,3,3,2,1
5,410,410,14,14,0,1,0
16,421,421,80,80,0,1,0
13,438,438,10,2,8,2,1
18,441,441,24,15,9,2,1
14,455,455,9,9,0,1,0
1,474,474,6,6,0,1,0
11,484,484,38,14,24,4,3

9,105,105,4,4,0,1,0
16,112,112,13,13,0,1,0
8,122,122,5,5,0,1,0
3,123,123,19,10,9,4,3
13,153,153,79,31,48,2,1
12,182,182,2,2,0,1,0
11,215,215,7,7,0,1,0
17,298,298,5,5,0,1,0
7,304,304,4,4,0,1,0
1,307,307,3,3,0,1,0
5,314,314,38,6,32,2,1
2,327,327,34,34,0,1,0
15,350,350,29,29,0,1,0
14,354,354,15,15,0,1,0
4,363,363,54,11,43,2,1
6,405,405,19,19,0,1,0
0,413,413,46,13,33,4,3
10,482,482,6,3,3,2,1

6,105,105,7,1,6,3,2
12,153,153,22,22,0,1,0
9,187,187,4,4,0,1,0
2,193,193,42,26,16,2,1
3,216,216,2,2,0,1,0
5,222,222,18,18,0,1,0
8,262,262,44,44,0,1,0
0,300,300,30,6,24,2,1
7,314,314,32,17,15,4,3
11,382,382,19,1,18,4,3
10,393,393,76,76,0,1,0
1,406,406,49,49,0,1,0
14,410,410,23,23,0,1,0
13,453,453,82,55,27,4,3
4,498,498,52,52,0,1,0

12,129,129,49,49,0,1,0
0,133,133,3,3,0,1,0
1,182,182,66,66,0,1,0
5,256,256,7,7,0,1,0
6,263,263,36,21,15,2,1
8,264,264,6,6,0,1,0
9,289,289,30,30,0,1,0
10,305,305,8,8,0,1,0
4,311,311,17,3,14,2,1
2,317,317,53,7,46,2,1
13,338,338,9,1,8,2,1
3,356,356,11,11,0,1,0
11,358,358,33,7,26,2,1
7,440,440,70,12,58,3,2

3,157,157,43,1,42,3,2
1,199,199,20,20,0,1,0
11,222,222,3,3,0,1,0
2,226,226,37,25,12,4,3
0,246,246,21,3,18,3,2
5,254,254,37,37,0,1,0
12,301,301,54,54,0,1,0
6,327,327,154,138,16,3,2
7,347,347,18,18,0,1,0
10,403,403,23,1,22,3,2
8,415,415,2,2,0,1,0
9,423,423,15,15,0,1,0
4,492,492,17,17,0,1,0

4,107,107,25,25,0,1,0
8,167,167,13,13,0,1,0
10,218,218,23,23,0,1,0
3,231,231,20,1,19,4,3
0,316,316,39,9,30,3,2
6,328,328,27,27,0,1,0
12,340,340,21,21,0,1,0
2,375,375,42,42,0,1,0
5,397,397,75,51,24,4,3
1,405,405,23,23,0,1,0
11,416,416,72,24,48,2,1
7,440,440,77,44,33,4,3
9,450,450,62,51,11,2,1

10,105,105,10,3,7,2,1
9,125,125,5,1,4,2,1
5,133,133,8,8,0,1,0
1,147,147,78,70,8,2,1
3,235,235,9,9,0,1,0
2,249,249,56,31,25,3,2
8,281,281,12,12,0,1,0
4,327,327,109,57,52,4,3
6,372,372,28,10,18,2,1
0,442,442,3,3,0,1,0
7,449,449,77,77,0,1,0

11,110,110,12,12,0,1,0
14,135,135,1,1,0,1,0
6,194,194,19,19,0,1,0
4,271,271,3,3,0,1,0
9,315,315,27,27,0,1,0
15,318,318,28,28,0,1,0
2,338,338,16,16,0,1,0
13,349,349,64,39,25,2,1
0,382,382,32,32,0,1,0
12,389,389,120,120,0,1,0
8,398,398,7,2,5,2,1
1,400,400,46,26,20,2,1
10,409,409,13,13,0,1,0
5,410,410,38,12,26,3,2
7,440,440,54,54,0,1,0
3,486,486,104,88,16,3,2

12,137,137,3,3,0,1,0
7,173,173,4,4,0,1,0
15,183,183,15,4,11,4,3
2,205,205,3,3,0,1,0
3,226,226,36,36,0,1,0
5,228,228,8,8,0,1,0
1,257,257,29,11,18,2,1
10,282,282,54,54,0,1,0
14,285,285,59,9,50,2,1
6,292,292,3,3,0,1,0
0,354,354,111,96,15,2,1
4,359,359,23,17,6,2,1
9,388,388,60,60,0,1,0
11,400,400,43,11,32,3,2
8,473,473,32,8,24,4,3
13,497,497,24,24,0,1,0

3,168,168,12,6,6,2,1
11,193,193,8,8,0,1,0
1,220,220,20,20,0,1,0
2,263,263,8,2,6,2,1
4,265,265,6,6,0,1,0
12,293,293,18,12,6,3,2
0,308,308,33,9,24,4,3
7,358,358,28,23,5,2,1
8,370,370,26,5,21,4,3
13,375,375,46,46,0,1,0
6,408,408,49,6,43,2,1
10,454,454,131,114,17,2,1
9,466,466,67,12,55,4,3
5,496,496,178,55,123,4,3

9,104,104,1,1,0,1,0
10,115,115,4,4,0,1,0
15,125,125,3,3,0,1,0
20,172,172,36,17,19,2,1
4,191,191,9,2,7,2,1
0,198,198,9,3,6,2,1
3,215,215,16,16,0,1,0
19,217,217,47,13,34,2,1
21,218,218,14,4,10,2,1
1,246,246,42,42,0,1,0
11,253,253,2,2,0,1,0
7,254,254,1,1,0,1,0
2,254,254,6,6,0,1,0
14,288,288,6,6,0,1,0
16,326,326,63,49,14,3,2
17,340,340,18,4,14,4,3
8,376,376,16,2,14,3,2
18,388,388,23,3,20,3,2
5,399,399,84,84,0,1,0
12,451,451,5,5,0,1,0
13,459,459,11,11,0,1,0
6,468,468,35,15,20,2,1

14,142,142,10,4,6,2,1
0,160,160,41,25,16,2,1
13,187,187,21,21,0,1,0
3,190,190,31,31,0,1,0
11,223,223,16,8,8,2,1
2,254,254,2,2,0,1,0
4,275,275,16,16,0,1,0
12,287,287,14,14,0,1,0
5,374,374,23,4,19,2,1
9,392,392,51,16,35,2,1
1,395,395,33,33,0,1,0
8,406,406,10,10,0,1,0
6,413,413,63,63,0,1,0
10,490,490,176,176,0,1,0
7,496,496,9,9,0,1,0

11,202,202,4,4,0,1,0
7,213,213,1,1,0,1,0
8,214,214,39,25,14,3,2
13,216,216,16,5,11,4,3
12,218,218,7,1,6,3,2
14,247,247,86,56,30,4,3
3,265,265,28,28,0,1,0
6,285,285,5,5,0,1,0
9,313,313,18,18,0,1,0
5,316,316,19,19,0,1,0
0,332,332,70,49,21,4,3
1,433,433,58,58,0,1,0
2,435,435,114,30,84,3,2
10,435,435,44,2,42,3,2
4,498,498,3,3,0,1,0

16,113,113,4,4,0,1,0
17,124,124,38,38,0,1,0
13,130,130,6,6,0,1,0
15,149,149,4,4,0,1,0
4,153,153,14,2,12,3,2
9,175,175,16,16,0,1,0
8,176,176,6,6,0,1,0
2,176,176,1,1,0,1,0
3,203,203,28,28,0,1,0
5,212,212,4,4,0,1,0
6,217,217,9,9,0,1,0
11,225,225,9,9,0,1,0
7,234,234,5,5,0,1,0
1,282,282,36,10,26,3,2
19,323,323,35,14,21,4,3
18,324,324,14,8,6,3,2
0,387,387,12,12,0,1,0
10,396,396,6,6,0,1,0
20,429,429,17,5,12,2,1
12,436,436,39,39,0,1,0
14,446,446,4,4,0,1,0
21,447,447,116,24,92,3,2

7,156,156,41,7,34,3,2
5,169,169,12,12,0,1,0
10,185,185,10,10,0,1,0
12,222,222,21,21,0,1,0
8,247,247,59,24,35,2,1
14,253,253,10,10,0,1,0
4,300,300,24,24,0,1,0
11,305,305,16,16,0,1,0
13,306,306,9,9,0,1,0
2,319,319,19,19,0,1,0
3,367,367,71,34,37,2,1
6,403,403,34,8,26,2,1
9,408,408,124,124,0,1,0
1,467,467,9,1,8,3,2
0,477,477,17,17,0,1,0

14,127,127,20,20,0,1,0
16,150,150,3,3,0,1,0
13,168,168,2,2,0,1,0
3,185,185,18,13,5,2,1
5,186,186,9,1,8,3,2
4,197,197,43,1,42,2,1
2,215,215,8,1,7,2,1
12,229,229,58,58,0,1,0
10,255,255,26,26,0,1,0
0,268,268,13,7,6,2,1
15,279,279,50,12,38,2,1
1,319,319,5,5,0,1,0
11,337,337,18,18,0,1,0
9,359,359,33,28,5,2,1
6,373,373,1,1,0,1,0
8,396,396,6,2,4,2,1
7,398,398,49,49,0,1,0
17,449,449,65,65,0,1,0

0,100,100,28,17,11,2,1
5,103,103,8,8,0,1,0
7,104,104,1,1,0,1,0
16,154,154,12,12,0,1,0
12,165,165,18,3,15,4,3
15,169,169,13,13,0,1,0
14,196,196,34,18,16,2,1
9,227,227,31,31,0,1,0
2,243,243,14,14,0,1,0
10,245,245,13,5,8,3,2
18,248,248,13,7,6,3,2
4,281,281,2,2,0,1,0
3,299,299,7,1,6,3,2
8,306,306,20,20,0,1,0
6,327,327,23,6,17,3,2
1,345,345,5,5,0,1,0
13,395,395,82,82,0,1,0
11,440,440,3,3,0,1,0
17,495,495,56,56,0,1,0

9,104,104,9,9,0,1,0
5,123,123,10,4,6,2,1
10,159,159,17,17,0,1,0
3,205,205,14,8,6,2,1
6,205,205,8,8,0,1,0
8,268,268,28,16,12,3,2
13,303,303,66,61,5,2,1
4,339,339,48,48,0,1,0
14,358,358,24,1,23,2,1
12,377,377,11,2,9,4,3
7,389,389,9,9,0,1,0
0,417,417,35,35,0,1,0
2,462,462,162,162,0,1,0
1,487,487,6,1,5,2,1
11,494,494,102,12,90,3,2

9,120,120,24,1,23,4,3
4,130,130,35,19,16,3,2
6,181,181,3,3,0,1,0
12,185,185,17,2,15,2,1
7,246,246,55,43,12,3,2
3,254,254,26,26,0,1,0
8,255,255,13,1,12,2,1
1,296,296,16,4,12,4,3
11,382,382,21,8,13,2,1
13,418,418,71,3,68,3,2
10,435,435,12,12,0,1,0
5,448,448,55,55,0,1,0
2,485,485,85,31,54,4,3
0,495,495,30,16,14,2,1

7,134,134,14,4,10,2,1
5,136,136,4,4,0,1,0
0,146,146,14,7,7,2,1
1,206,206,48,24,24,4,3
3,228,228,28,28,0,1,0
4,260,260,88,88,0,1,0
2,356,356,124,49,75,4,3
9,371,371,9,9,0,1,0
10,377,377,23,23,0,1,0
6,428,428,20,20,0,1,0
8,458,458,96,96,0,1,0

2,172,172,1,1,0,1,0
9,181,181,34,34,0,1,0
8,289,289,16,3,13,2,1
1,345,345,117,99,18,4,3
4,363,363,10,3,7,2,1
5,411,411,103,103,0,1,0
3,414,414,1,1,0,1,0
12,416,416,85,85,0,1,0
6,427,427,60,60,0,1,0
11,431,431,12,3,9,4,3
10,460,460,82,16,66,4,3
7,481,481,8,8,0,1,0
0,492,492,87,87,0,1,0

13,133,133,9,9,0,1,0
3,141,141,9,9,0,1,0
10,204,204,3,3,0,1,0
1,215,215,53,37,16,3,2
9,224,224,71,71,0,1,0
6,298,298,12,12,0,1,0
14,308,308,53,21,32,3,2
4,349,349,76,70,6,2,1
2,358,358,14,14,0,1,0
5,376,376,65,53,12,2,1
7,391,391,7,7,0,1,0
8,395,395,47,17,30,4,3
11,396,396,25,1,24,4,3
12,433,433,24,24,0,1,0
0,456,456,1,1,0,1,0

16,116,116,1,1,0,1,0
15,124,124,8,2,6,3,2
14,148,148,48,11,37,4,3
9,194,194,6,3,3,2,1
5,249,249,84,84,0,1,0
3,279,279,3,3,0,1,0
7,282,282,12,12,0,1,0
11,313,313,33,33,0,1,0
10,352,352,12,12,0,1,0
6,360,360,21,18,3,2,1
12,390,390,23,13,10,2,1
0,414,414,40,10,30,2,1
8,421,421,16,16,0,1,0
4,423,423,11,4,7,2,1
13,461,461,106,106,0,1,0
1,469,469,45,45,0,1,0
2,496,496,33,33,0,1,0

7,131,131,10,10,0,1,0
12,156,156,36,36,0,1,0
2,163,163,13,13,0,1,0
11,191,191,29,29,0,1,0
1,208,208,27,19,8,3,2
6,211,211,34,34,0,1,0
4,216,216,9,1,8,3,2
9,264,264,17,17,0,1,0
13,352,352,39,24,15,2,1
8,369,369,1,1,0,1,0
3,434,434,1,1,0,1,0
5,434,434,107,62,45,4,3
10,461,461,83,67,16,3,2
0,487,487,68,47,21,4,3

8,221,221,38,5,33,2,1
3,240,240,1,1,0,1,0
9,297,297,33,5,28,2,1
0,335,335,18,18,0,1,0
17,336,336,45,1,44,2,1
13,341,341,1,1,0,1,0
14,346,346,43,29,14,3,2
12,349,349,20,2,18,2,1
2,360,360,1,1,0,1,0
16,371,371,87,87,0,1,0
1,374,374,35,35,0,1,0
5,375,375,30,2,28,3,2
6,412,412,84,44,40,3,2
10,444,444,21,12,9,2,1
7,475,475,14,8,6,2,1
11,475,475,90,90,0,1,0
15,478,478,31,24,7,2,1
4,480,480,1,1,0,1,0

1,100,100,2,2,0,1,0
17,103,103,15,1,14,3,2
3,117,117,9,9,0,1,0
10,117,117,1,1,0,1,0
15,120,120,8,8,0,1,0
13,122,122,14,2,12,3,2
5,131,131,3,3,0,1,0
7,173,173,1,1,0,1,0
14,200,200,52,52,0,1,0
9,203,203,7,7,0,1,0
6,210,210,1,1,0,1,0
8,219,219,26,13,13,2,1
16,243,243,24,24,0,1,0
11,285,285,12,12,0,1,0
18,288,288,10,1,9,2,1
12,351,351,37,16,21,2,1
2,383,383,89,89,0,1,0
0,399,399,47,7,40,3,2
4,460,460,54,30,24,4,3

5,105,105,6,6,0,1,0
16,113,113,2,2,0,1,0
3,119,119,20,20,0,1,0
8,129,129,5,5,0,1,0
1,176,176,19,19,0,1,0
6,186,186,37,37,0,1,0
15,282,282,34,34,0,1,0
14,291,291,92,65,27,2,1
7,296,296,3,3,0,1,0
2,311,311,62,21,41,2,1
12,315,315,19,19,0,1,0
11,334,334,4,4,0,1,0
9,351,351,4,4,0,1,0
10,371,371,102,56,46,2,1
13,422,422,3,3,0,1,0
0,435,435,1,1,0,1,0
4,450,450,3,3,0,1,0

8,111,111,14,5,9,2,1
14,154,154,42,42,0,1,0
13,258,258,43,22,21,4,3
1,262,262,11,11,0,1,0
12,264,264,19,1,18,3,2
4,269,269,25,25,0,1,0
6,391,391,42,42,0,1,0
3,414,414,21,9,12,4,3
10,443,443,18,18,0,1,0
5,457,457,8,8,0,1,0
7,462,462,111,17,94,4,3
2,467,467,28,28,0,1,0
11,477,477,2,2,0,1,0
0,486,486,93,41,52,3,2
9,486,486,64,38,26,2,1

14,128,128,6,6,0,1,0
13,163,163,14,3,11,2,1
3,189,189,17,17,0,1,0
9,219,219,30,9,21,2,1
4,222,222,30,30,0,1,0
5,226,226,46,16,30,4,3
8,265,265,10,10,0,1,0
1,267,267,27,14,13,2,1
10,301,301,32,32,0,1,0
12,331,331,77,50,27,4,3
7,333,333,17,7,10,3,2
2,382,382,2,2,0,1,0
11,405,405,69,69,0,1,0
0,496,496,11,11,0,1,0
6,500,500,96,30,66,3,2

2,124,124,10,6,4,2,1
16,129,129,7,4,3,2,1
17,155,155,18,8,10,3,2
12,170,170,2,2,0,1,0
18,195,195,32,7,25,2,1
13,223,223,21,8,13,4,3
3,224,224,4,4,0,1,0
19,260,260,9,1,8,3,2
6,296,296,8,8,0,1,0
1,299,299,25,4,21,3,2
0,323,323,16,16,0,1,0
11,370,370,7,7,0,1,0
10,379,379,45,45,0,1,0
9,415,415,50,16,34,3,2
5,440,440,58,58,0,1,0
4,444,444,9,4,5,2,1
15,464,464,39,18,21,4,3
7,465,465,49,18,31,2,1
8,477,477,7,7,0,1,0
14,493,493,135,123,12,4,3

4,115,115,2,2,0,1,0
13,116,116,45,28,17,2,1
12,134,134,1,1,0,1,0
10,141,141,2,2,0,1,0
0,175,175,3,3,0,1,0
3,178,178,45,36,9,4,3
6,182,182,45,14,31,4,3
1,188,188,1,1,0,1,0
16,243,243,10,1,9,4,3
11,309,309,56,33,23,4,3
5,350,350,20,5,15,4,3
7,412,412,5,1,4,2,1
15,428,428,54,54,0,1,0
8,443,443,11,11,0,1,0
2,486,486,67,49,18,3,2
14,493,493,29,29,0,1,0
9,495,495,14,14,0,1,0

2,112,112,14,14,0,1,0
5,122,122,7,7,0,1,0
10,123,123,2,2,0,1,0
8,177,177,33,15,18,4,3
12,186,186,3,3,0,1,0
9,202,202,2,2,0,1,0
0,215,215,68,68,0,1,0
13,220,220,16,3,13,2,1
4,326,326,39,3,36,4,3
1,397,397,12,3,9,4,3
11,443,443,67,41,26,2,1
3,457,457,49,38,11,3,2
6,462,462,21,14,7,2,1
7,467,467,170,162,8,2,1

10,137,137,7,7,0,1,0
4,148,148,7,1,6,3,2
12,156,156,16,2,14,2,1
6,159,159,9,3,6,2,1
13,222,222,18,10,8,2,1
15,223,223,39,39,0,1,0
0,233,233,19,19,0,1,0
2,233,233,8,5,3,2,1
17,240,240,9,3,6,2,1
7,274,274,4,4,0,1,0
3,317,317,26,12,14,2,1
14,326,326,34,34,0,1,0
18,333,333,66,66,0,1,0
16,402,402,45,32,13,2,1
11,413,413,15,3,12,4,3
8,422,422,7,1,6,3,2
1,454,454,107,79,28,2,1
9,472,472,60,55,5,2,1
5,473,473,9,9,0,1,0

9,134,134,3,3,0,1,0
1,150,150,15,12,3,2,1
0,171,171,29,29,0,1,0
6,172,172,35,35,0,1,0
4,202,202,14,14,0,1,0
10,203,203,22,8,14,3,2
11,249,249,10,10,0,1,0
3,250,250,43,43,0,1,0
7,290,290,73,49,24,4,3
2,342,342,70,70,0,1,0
12,372,372,37,25,12,3,2
8,394,394,32,6,26,2,1
5,446,446,38,30,8,3,2

4,148,148,1,1,0,1,0
12,164,164,15,15,0,1,0
8,166,166,7,7,0,1,0
1,174,174,2,2,0,1,0
11,255,255,30,30,0,1,0
7,260,260,9,9,0,1,0
2,264,264,7,7,0,1,0
13,278,278,5,5,0,1,0
9,282,282,38,38,0,1,0
0,343,343,82,82,0,1,0
6,366,366,125,52,73,4,3
3,420,420,42,42,0,1,0
5,420,420,18,9,9,2,1
10,470,470,72,33,39,2,1
14,481,481,123,20,103,4,3

12,117,117,32,32,0,1,0
13,118,118,15,10,5,2,1
14,129,129,5,5,0,1,0
2,163,163,14,14,0,1,0
9,220,220,25,15,10,2,1
4,258,258,16,4,12,2,1
3,268,268,11,11,0,1,0
7,285,285,12,12,0,1,0
5,286,286,18,6,12,2,1
15,324,324,51,51,0,1,0
6,329,329,42,34,8,3,2
10,365,365,28,28,0,1,0
1,385,385,42,42,0,1,0
0,390,390,54,54,0,1,0
11,465,465,55,10,45,2,1
16,482,482,13,1,12,3,2
8,488,488,9,1,8,3,2

7,151,151,50,50,0,1,0
1,164,164,20,20,0,1,0
2,172,172,30,30,0,1,0
9,184,184,18,18,0,1,0
11,199,199,27,27,0,1,0
8,220,220,26,13,13,2,1
6,279,279,12,5,7,2,1
4,286,286,3,3,0,1,0
10,312,312,17,17,0,1,0
5,317,317,117,117,0,1,0
3,424,424,28,15,13,2,1
12,483,483,18,18,0,1,0
0,497,497,29,29,0,1,0

8,114,114,4,1,3,2,1
10,149,149,26,26,0,1,0
1,169,169,1,1,0,1,0
13,186,186,37,33,4,2,1
5,228,228,26,17,9,2,1
11,232,232,10,1,9,4,3
12,262,262,63,18,45,2,1
16,271,271,28,28,0,1,0
2,318,318,76,48,28,3,2
0,325,325,2,2,0,1,0
14,331,331,17,1,16,2,1
3,362,362,55,10,45,3,2
4,367,367,3,3,0,1,0
15,393,393,2,2,0,1,0
7,423,423,6,6,0,1,0
6,435,435,65,62,3,2,1
9,499,499,38,14,24,3,2

10,157,157,28,28,0,1,0
9,165,165,23,23,0,1,0
1,177,177,17,4,13,3,2
4,205,205,22,16,6,2,1
6,244,244,34,34,0,1,0
12,328,328,8,8,0,1,0
3,337,337,38,38,0,1,0
2,342,342,40,40,0,1,0
5,413,413,28,28,0,1,0
11,427,427,111,60,51,4,3
7,457,457,21,11,10,4,3
0,467,467,140,35,105,4,3
8,496,496,12,8,4,2,1

9,117,117,2,2,0,1,0
0,155,155,17,17,0,1,0
8,160,160,73,73,0,1,0
3,209,209,1,1,0,1,0
13,210,210,5,5,0,1,0
10,268,268,12,3,9,4,3
7,278,278,3,3,0,1,0
6,282,282,14,4,10,3,2
5,316,316,47,23,24,3,2
11,320,320,42,6,36,2,1
2,343,343,54,4,50,3,2
4,346,346,111,9,102,4,3
1,415,415,4,4,0,1,0
12,480,480,66,57,9,2,1

6,111,111,7,7,0,1,0
0,113,113,18,18,0,1,0
13,167,167,23,5,18,4,3
15,180,180,36,36,0,1,0
9,214,214,36,15,21,4,3
5,258,258,80,62,18,3,2
11,273,273,36,31,5,2,1
2,287,287,7,7,0,1,0
1,289,289,42,42,0,1,0
8,296,296,3,3,0,1,0
3,351,351,4,1,3,2,1
14,353,353,13,13,0,1,0
4,410,410,21,9,12,3,2
12,420,420,46,46,0,1,0
10,480,480,14,14,0,1,0
7,494,494,14,4,10,2,1

0,102,102,12,12,0,1,0
8,148,148,40,25,15,2,1
12,184,184,18,18,0,1,0
9,197,197,20,20,0,1,0
1,236,236,4,4,0,1,0
2,290,290,159,159,0,1,0
7,324,324,28,6,22,3,2
13,330,330,12,12,0,1,0
10,357,357,49,15,34,4,3
3,409,409,11,6,5,2,1
4,422,422,28,3,25,3,2
6,461,461,8,8,0,1,0
5,474,474,4,4,0,1,0
11,480,480,40,30,10,2,1

7,107,107,2,2,0,1,0
14,112,112,9,9,0,1,0
9,128,128,1,1,0,1,0
8,181,181,23,3,20,3,2
11,224,224,84,84,0,1,0
5,228,228,1,1,0,1,0
6,245,245,57,25,32,3,2
4,255,255,9,5,4,2,1
16,278,278,10,10,0,1,0
1,279,279,5,5,0,1,0
0,346,346,19,19,0,1,0
12,370,370,19,10,9,4,3
3,373,373,45,36,9,4,3
2,418,418,49,49,0,1,0
13,437,437,11,11,0,1,0
10,440,440,28,14,14,3,2
15,466,466,10,10,0,1,0
17,475,475,108,9,99,4,3

10,101,101,3,3,0,1,0
11,107,107,34,34,0,1,0
3,123,123,21,9,12,4,3
6,165,165,15,5,10,4,3
16,166,166,11,11,0,1,0
7,174,174,20,2,18,4,3
5,175,175,4,4,0,1,0
15,241,241,28,15,13,2,1
9,243,243,5,5,0,1,0
4,271,271,1,1,0,1,0
12,293,293,18,4,14,3,2
13,384,384,36,14,22,2,1
8,397,397,50,50,0,1,0
1,411,411,32,12,20,2,1
14,412,412,54,54,0,1,0
0,413,413,1,1,0,1,0
2,485,485,84,42,42,4,3

19,118,118,6,6,0,1,0
8,139,139,5,2,3,2,1
3,162,162,5,5,0,1,0
17,181,181,5,5,0,1,0
10,198,198,36,36,0,1,0
18,234,234,16,13,3,2,1
6,249,249,13,1,12,3,2
0,249,249,36,3,33,4,3
9,293,293,7,4,3,2,1
4,311,311,21,6,15,2,1
5,311,311,3,3,0,1,0
16,321,321,24,4,20,4,3
1,324,324,11,11,0,1,0
11,357,357,1,1,0,1,0
13,390,390,9,9,0,1,0
7,397,397,49,8,41,2,1
2,438,438,31,11,20,2,1
12,451,451,11,11,0,1,0
14,460,460,180,88,92,3,2
15,471,471,83,78,5,2,1

9,119,119,32,32,0,1,0
0,129,129,6,6,0,1,0
6,132,132,2,2,0,1,0
10,143,143,19,19,0,1,0
7,182,182,5,5,0,1,0
5,248,248,20,20,0,1,0
8,306,306,2,2,0,1,0
11,324,324,93,93,0,1,0
4,358,358,25,25,0,1,0
3,383,383,216,176,40,3,2
2,396,396,1,1,0,1,0
1,434,434,51,51,0,1,0

14,107,107,14,14,0,1,0
12,178,178,6,3,3,2,1
2,214,214,2,2,0,1,0
7,243,243,14,14,0,1,0
9,257,257,24,3,21,4,3
11,329,329,9,9,0,1,0
0,332,332,29,29,0,1,0
6,371,371,32,4,28,2,1
13,392,392,16,16,0,1,0
5,424,424,30,30,0,1,0
4,437,437,31,31,0,1,0
1,467,467,108,6,102,4,3
8,469,469,23,7,16,2,1
15,476,476,16,9,7,2,1
3,484,484,67,67,0,1,0
10,491,491,221,221,0,1,0

9,153,153,16,16,0,1,0
2,157,157,4,1,3,2,1
11,169,169,59,59,0,1,0
0,182,182,18,6,12,2,1
12,192,192,1,1,0,1,0
7,200,200,1,1,0,1,0
1,214,214,37,37,0,1,0
8,218,218,2,2,0,1,0
5,242,242,48,48,0,1,0
14,244,244,27,3,24,4,3
3,349,349,27,27,0,1,0
6,350,350,31,31,0,1,0
4,397,397,50,47,3,2,1
10,437,437,60,10,50,4,3
15,457,457,1,1,0,1,0
13,479,479,54,12,42,4,3

15,139,139,14,14,0,1,0
13,150,150,8,8,0,1,0
3,152,152,1,1,0,1,0
10,205,205,15,3,12,4,3
11,216,216,48,48,0,1,0
14,227,227,43,21,22,3,2
1,265,265,10,4,6,2,1
9,294,294,6,6,0,1,0
4,337,337,1,1,0,1,0
5,376,376,200,106,94,4,3
12,395,395,61,61,0,1,0
7,430,430,18,4,14,3,2
2,441,441,1,1,0,1,0
8,446,446,2,2,0,1,0
6,448,448,16,16,0,1,0
0,456,456,63,54,9,4,3

12,100,100,7,4,3,2,1
9,190,190,8,8,0,1,0
7,228,228,8,8,0,1,0
16,228,228,11,11,0,1,0
13,236,236,4,4,0,1,0
17,313,313,100,12,88,3,2
2,334,334,62,62,0,1,0
11,358,358,72,40,32,3,2
6,367,367,18,18,0,1,0
5,378,378,32,1,31,3,2
0,394,394,31,31,0,1,0
4,397,397,1,1,0,1,0
8,399,399,58,53,5,2,1
10,428,428,60,14,46,3,2
3,445,445,10,1,9,2,1
14,467,467,39,39,0,1,0
15,470,470,32,13,19,3,2
1,496,496,8,2,6,3,2

5,134,134,3,3,0,1,0
0,155,155,22,22,0,1,0
19,160,160,24,14,10,2,1
15,169,169,3,3,0,1,0
2,181,181,5,1,4,2,1
16,201,201,3,3,0,1,0
1,260,260,34,34,0,1,0
4,307,307,40,2,38,3,2
18,318,318,18,18,0,1,0
10,318,318,3,3,0,1,0
13,366,366,62,40,22,2,1
17,369,369,81,21,60,3,2
9,370,370,1,1,0,1,0
7,416,416,19,3,16,2,1
12,440,440,10,4,6,2,1
6,444,444,40,40,0,1,0
3,449,449,36,36,0,1,0
14,449,449,81,69,12,4,3
11,453,453,21,13,8,2,1
8,465,465,24,24,0,1,0

1,122,122,11,2,9,2,1
3,183,183,3,3,0,1,0
4,249,249,11,2,9,2,1
10,265,265,34,9,25,3,2
12,268,268,63,63,0,1,0
2,297,297,30,30,0,1,0
0,313,313,70,70,0,1,0
9,383,383,13,13,0,1,0
13,397,397,1,1,0,1,0
8,403,403,77,77,0,1,0
11,404,404,83,29,54,4,3
5,450,450,116,106,10,3,2
7,466,466,6,6,0,1,0
6,498,498,34,34,0,1,0

18,123,123,39,35,4,2,1
3,142,142,1,1,0,1,0
13,160,160,9,9,0,1,0
8,168,168,3,3,0,1,0
15,171,171,4,1,3,2,1
17,184,184,33,33,0,1,0
4,321,321,38,8,30,4,3
19,324,324,17,17,0,1,0
10,327,327,9,9,0,1,0
0,346,346,50,50,0,1,0
7,347,347,58,31,27,4,3
14,387,387,48,48,0,1,0
2,429,429,5,5,0,1,0
5,432,432,2,2,0,1,0
1,436,436,55,20,35,4,3
12,444,444,20,4,16,3,2
16,475,475,30,30,0,1,0
6,495,495,9,1,8,2,1
9,500,500,46,46,0,1,0
11,500,500,11,11,0,1,0

3,125,125,40,40,0,1,0
4,134,134,1,1,0,1,0
2,168,168,37,7,30,2,1
10,174,174,9,9,0,1,0
9,177,177,13,10,3,2,1
1,243,243,45,45,0,1,0
13,289,289,44,20,24,2,1
7,290,290,37,37,0,1,0
12,333,333,33,18,15,4,3
8,396,396,96,60,36,2,1
5,425,425,5,5,0,1,0
6,445,445,2,2,0,1,0
0,487,487,25,25,0,1,0
11,495,495,34,8,26,3,2

3,139,139,11,11,0,1,0
10,140,140,19,19,0,1,0
8,185,185,4,4,0,1,0
2,257,257,5,5,0,1,0
6,280,280,38,38,0,1,0
0,296,296,95,13,82,4,3
12,346,346,6,6,0,1,0
5,357,357,5,2,3,2,1
13,381,381,81,81,0,1,0
11,392,392,101,67,34,3,2
4,430,430,27,19,8,3,2
7,464,464,27,19,8,3,2
9,483,483,53,5,48,4,3
1,492,492,84,8,76,3,2

6,123,123,17,17,0,1,0
12,123,123,6,6,0,1,0
3,124,124,20,20,0,1,0
10,191,191,6,6,0,1,0
5,216,216,4,4,0,1,0
0,223,223,7,7,0,1,0
4,231,231,52,8,44,3,2
1,233,233,2,2,0,1,0
9,324,324,39,39,0,1,0
7,334,334,55,55,0,1,0
8,346,346,6,6,0,1,0
13,355,355,2,2,0,1,0
11,374,374,158,158,0,1,0
2,470,470,105,57,48,4,3

6,217,217,17,7,10,3,2
7,220,220,79,31,48,2,1
5,254,254,10,10,0,1,0
2,259,259,18,4,14,2,1
10,275,275,12,12,0,1,0
4,289,289,25,25,0,1,0
12,358,358,30,16,14,3,2
8,365,365,11,11,0,1,0
3,369,369,24,24,0,1,0
11,403,403,71,71,0,1,0
13,429,429,28,5,23,2,1
0,433,433,70,20,50,2,1
9,442,442,24,24,0,1,0
1,498,498,150,59,91,4,3

4,104,104,4,4,0,1,0
5,127,127,14,14,0,1,0
8,153,153,1,1,0,1,0
2,204,204,50,50,0,1,0
3,260,260,18,3,15,4,3
7,265,265,23,23,0,1,0
0,277,277,23,23,0,1,0
12,308,308,33,8,25,2,1
1,315,315,48,10,38,2,1
11,328,328,49,32,17,4,3
6,383,383,5,5,0,1,0
15,391,391,19,19,0,1,0
9,420,420,21,21,0,1,0
10,437,437,48,10,38,3,2
14,455,455,42,42,0,1,0
13,497,497,126,126,0,1,0

10,102,102,28,22,6,2,1
4,108,108,7,3,4,2,1
7,115,115,1,1,0,1,0
2,128,128,5,5,0,1,0
8,138,138,32,4,28,2,1
3,228,228,1,1,0,1,0
12,256,256,37,19,18,4,3
0,308,308,92,92,0,1,0
1,431,431,18,18,0,1,0
6,441,441,15,8,7,2,1
11,451,451,34,34,0,1,0
9,453,453,9,3,6,3,2
14,472,472,77,8,69,4,3
15,476,476,28,28,0,1,0
5,489,489,41,21,20,3,2
13,493,493,38,38,0,1,0

7,138,138,30,30,0,1,0
2,143,143,2,2,0,1,0
4,185,185,11,11,0,1,0
0,203,203,90,90,0,1,0
9,303,303,14,14,0,1,0
10,326,326,108,63,45,4,3
5,349,349,30,12,18,3,2
11,360,360,14,14,0,1,0
8,450,450,16,16,0,1,0
3,452,452,1,1,0,1,0
1,488,488,139,55,84,4,3
6,489,489,28,28,0,1,0

13,105,105,20,5,15,2,1
2,124,124,3,3,0,1,0
1,154,154,19,5,14,2,1
14,171,171,30,30,0,1,0
7,186,186,25,7,18,3,2
0,199,199,17,5,12,2,1
5,264,264,29,29,0,1,0
4,267,267,1,1,0,1,0
11,288,288,3,3,0,1,0
12,293,293,1,1,0,1,0
15,298,298,61,7,54,3,2
8,302,302,20,20,0,1,0
9,331,331,3,3,0,1,0
6,377,377,17,9,8,2,1
3,400,400,84,84,0,1,0
10,448,448,98,86,12,4,3

3,159,159,28,16,12,3,2
11,164,164,34,34,0,1,0
7,180,180,27,27,0,1,0
4,207,207,11,3,8,3,2
6,252,252,12,12,0,1,0
12,274,274,47,3,44,4,3
8,281,281,32,18,14,2,1
0,299,299,74,10,64,3,2
2,314,314,17,17,0,1,0
10,378,378,7,7,0,1,0
1,419,419,32,32,0,1,0
9,455,455,49,15,34,3,2
5,456,456,88,24,64,4,3

8,109,109,17,1,16,2,1
9,113,113,50,50,0,1,0
1,115,115,28,28,0,1,0
0,133,133,11,11,0,1,0
4,133,133,5,5,0,1,0
6,151,151,11,11,0,1,0
13,158,158,2,2,0,1,0
3,185,185,31,31,0,1,0
2,200,200,5,2,3,2,1
7,256,256,30,30,0,1,0
10,324,324,17,3,14,2,1
11,346,346,38,38,0,1,0
12,362,362,14,10,4,2,1
14,386,386,2,2,0,1,0
5,404,404,22,2,20,2,1

12,103,103,28,28,0,1,0
8,108,108,5,5,0,1,0
9,161,161,36,18,18,2,1
0,184,184,41,4,37,4,3
11,194,194,19,9,10,3,2
1,199,199,10,10,0,1,0
13,207,207,19,19,0,1,0
7,288,288,21,21,0,1,0
2,339,339,38,38,0,1,0
5,351,351,62,62,0,1,0
6,397,397,61,43,18,4,3
10,470,470,9,9,0,1,0
3,472,472,29,29,0,1,0
4,496,496,12,5,7,2,1

4,150,150,13,10,3,2,1
11,168,168,16,12,4,2,1
12,194,194,2,2,0,1,0
9,255,255,7,7,0,1,0
13,291,291,113,104,9,4,3
7,305,305,39,15,24,4,3
1,315,315,3,3,0,1,0
2,334,334,13,13,0,1,0
5,339,339,98,98,0,1,0
3,388,388,59,59,0,1,0
0,393,393,78,78,0,1,0
6,410,410,11,11,0,1,0
8,435,435,7,7,0,1,0
10,452,452,67,35,32,2,1

6,131,131,4,1,3,2,1
14,136,136,6,3,3,2,1
13,158,158,32,23,9,4,3
4,193,193,1,1,0,1,0
0,299,299,28,28,0,1,0
10,323,323,2,2,0,1,0
2,334,334,96,39,57,4,3
1,338,338,36,5,31,4,3
7,369,369,27,27,0,1,0
3,377,377,10,10,0,1,0
12,387,387,51,6,45,4,3
8,429,429,19,12,7,2,1
15,451,451,124,55,69,4,3
11,474,474,27,5,22,2,1
5,479,479,64,19,45,2,1
9,488,488,46,30,16,3,2

11,108,108,6,2,4,2,1
1,189,189,9,9,0,1,0
3,231,231,10,10,0,1,0
7,251,251,30,10,20,3,2
0,319,319,25,13,12,4,3
10,337,337,1,1,0,1,0
9,340,340,16,16,0,1,0
16,357,357,18,18,0,1,0
2,375,375,7,1,6,3,2
4,421,421,101,53,48,3,2
14,427,427,28,1,27,4,3
15,428,428,199,107,92,3,2
5,435,435,29,29,0,1,0
8,444,444,31,23,8,2,1
6,461,461,32,16,16,3,2
12,461,461,42,9,33,4,3
13,478,478,41,41,0,1,0

4,139,139,6,6,0,1,0
11,158,158,41,41,0,1,0
1,185,185,23,14,9,2,1
8,237,237,24,24,0,1,0
2,241,241,51,5,46,2,1
7,269,269,11,1,10,3,2
13,315,315,9,1,8,2,1
5,324,324,87,87,0,1,0
0,361,361,1,1,0,1,0
10,382,382,60,60,0,1,0
6,389,389,46,38,8,3,2
3,440,440,14,14,0,1,0
9,476,476,26,9,17,4,3
12,478,478,79,9,70,4,3

5,118,118,4,4,0,1,0
11,124,124,40,40,0,1,0
6,162,162,16,16,0,1,0
8,208,208,3,3,0,1,0
3,235,235,17,17,0,1,0
9,290,290,18,12,6,2,1
10,320,320,62,4,58,3,2
0,323,323,95,43,52,4,3
2,370,370,57,57,0,1,0
4,427,427,73,73,0,1,0
1,436,436,48,4,44,2,1
7,449,449,42,42,0,1,0

5,117,117,10,4,6,3,2
0,135,135,9,6,3,2,1
9,154,154,2,2,0,1,0
17,176,176,28,28,0,1,0
6,180,180,54,41,13,2,1
10,187,187,15,3,12,4,3
4,197,197,1,1,0,1,0
14,223,223,17,6,11,2,1
15,229,229,7,1,6,2,1
11,242,242,4,4,0,1,0
8,280,280,28,1,27,4,3
18,281,281,30,30,0,1,0
7,289,289,3,3,0,1,0
3,292,292,1,1,0,1,0
19,305,305,2,2,0,1,0
2,308,308,5,2,3,2,1
1,459,459,26,11,15,4,3
16,478,478,23,1,22,2,1
12,486,486,23,8,15,4,3
13,495,495,190,70,120,4,3

2,105,105,13,13,0,1,0
10,148,148,6,6,0,1,0
0,183,183,17,3,14,3,2
9,195,195,9,9,0,1,0
15,226,226,6,6,0,1,0
5,227,227,5,2,3,2,1
14,276,276,50,50,0,1,0
12,285,285,35,23,12,3,2
8,300,300,50,50,0,1,0
7,315,315,27,9,18,4,3
11,315,315,63,63,0,1,0
6,359,359,3,3,0,1,0
16,419,419,76,76,0,1,0
13,459,459,25,25,0,1,0
3,465,465,11,6,5,2,1
1,487,487,1,1,0,1,0
4,499,499,116,28,88,3,2

13,103,103,20,20,0,1,0
4,174,174,12,12,0,1,0
7,229,229,48,48,0,1,0
3,233,233,1,1,0,1,0
9,250,250,64,36,28,3,2
12,251,251,4,4,0,1,0
5,304,304,2,2,0,1,0
0,337,337,52,8,44,2,1
10,357,357,36,36,0,1,0
11,374,374,14,14,0,1,0
2,381,381,90,30,60,4,3
14,408,408,3,3,0,1,0
6,414,414,48,24,24,2,1
1,425,425,2,2,0,1,0
8,496,496,102,12,90,3,2

4,151,151,5,5,0,1,0
1,164,164,9,9,0,1,0
13,166,166,4,4,0,1,0
0,217,217,8,8,0,1,0
6,241,241,37,37,0,1,0
9,244,244,3,3,0,1,0
7,245,245,33,33,0,1,0
2,259,259,21,10,11,2,1
11,276,276,39,6,33,4,3
8,310,310,11,2,9,2,1
3,325,325,25,25,0,1,0
12,329,329,14,14,0,1,0
14,431,431,101,92,9,2,1
5,495,495,115,49,66,4,3
10,500,500,160,52,108,4,3

10,110,110,19,19,0,1,0
11,112,112,45,33,12,3,2
4,121,121,3,3,0,1,0
5,153,153,16,2,14,3,2
8,160,160,11,11,0,1,0
2,175,175,21,21,0,1,0
3,223,223,31,31,0,1,0
13,281,281,9,9,0,1,0
7,285,285,21,21,0,1,0
9,323,323,1,1,0,1,0
6,378,378,57,57,0,1,0
12,378,378,27,27,0,1,0
0,472,472,95,14,81,4,3
1,472,472,29,29,0,1,0

8,101,101,3,3,0,1,0
12,126,126,3,3,0,1,0
2,148,148,25,25,0,1,0
3,159,159,4,1,3,2,1
0,164,164,21,3,18,3,2
5,182,182,4,4,0,1,0
6,190,190,17,5,12,2,1
4,356,356,36,3,33,4,3
11,419,419,3,3,0,1,0
9,422,422,64,14,50,3,2
14,422,422,144,20,124,4,3
13,428,428,71,71,0,1,0
1,467,467,14,2,12,4,3
16,468,468,3,3,0,1,0
10,481,481,80,8,72,4,3
15,487,487,49,20,29,4,3
7,498,498,28,16,12,2,1

0,202,202,48,48,0,1,0
8,204,204,37,37,0,1,0
9,240,240,36,2,34,2,1
7,253,253,1,1,0,1,0
3,267,267,21,9,12,4,3
10,337,337,1,1,0,1,0
1,338,338,108,108,0,1,0
2,418,418,69,60,9,4,3
4,426,426,72,72,0,1,0
6,474,474,26,26,0,1,0
5,478,478,117,117,0,1,0

5,124,124,22,6,16,2,1
8,163,163,13,4,9,2,1
0,197,197,12,8,4,2,1
16,199,199,5,5,0,1,0
6,200,200,12,12,0,1,0
18,237,237,13,13,0,1,0
11,243,243,68,68,0,1,0
14,264,264,5,5,0,1,0
1,284,284,14,2,12,3,2
3,292,292,1,1,0,1,0
15,304,304,95,95,0,1,0
2,317,317,1,1,0,1,0
17,368,368,11,3,8,3,2
10,370,370,1,1,0,1,0
9,434,434,1,1,0,1,0
12,456,456,29,29,0,1,0
7,476,476,34,34,0,1,0
4,478,478,5,5,0,1,0
13,490,490,152,58,94,4,3

15,114,114,20,9,11,4,3
6,191,191,9,4,5,2,1
7,241,241,3,3,0,1,0
9,251,251,25,20,5,2,1
8,252,252,44,44,0,1,0
12,253,253,10,5,5,2,1
2,320,320,18,3,15,2,1
5,347,347,79,79,0,1,0
1,357,357,16,2,14,4,3
10,359,359,76,26,50,3,2
0,380,380,1,1,0,1,0
3,399,399,46,46,0,1,0
13,417,417,43,4,39,4,3
11,436,436,30,30,0,1,0
4,474,474,57,20,37,2,1
14,486,486,54,38,16,3,2

10,106,106,1,1,0,1,0
5,126,126,24,3,21,4,3
8,175,175,22,22,0,1,0
7,200,200,5,5,0,1,0
0,238,238,33,23,10,2,1
4,246,246,37,10,27,2,1
6,260,260,8,8,0,1,0
1,351,351,60,35,25,2,1
9,383,383,52,52,0,1,0
2,467,467,157,157,0,1,0
3,470,470,2,2,0,1,0
11,476,476,144,144,0,1,0

2,125,125,4,4,0,1,0
14,133,133,35,30,5,2,1
1,174,174,5,5,0,1,0
10,194,194,21,21,0,1,0
0,255,255,27,27,0,1,0
13,279,279,37,37,0,1,0
6,303,303,51,2,49,2,1
4,345,345,87,87,0,1,0
12,361,361,54,48,6,3,2
8,363,363,27,27,0,1,0
9,396,396,1,1,0,1,0
11,432,432,1,1,0,1,0
3,453,453,5,5,0,1,0
5,473,473,11,11,0,1,0
7,473,473,50,28,22,3,2
15,478,478,73,2,71,4,3

3,102,102,5,5,0,1,0
6,165,165,21,21,0,1,0
13,209,209,14,14,0,1,0
14,262,262,26,26,0,1,0
2,282,282,1,1,0,1,0
10,314,314,58,58,0,1,0
4,319,319,10,10,0,1,0
11,334,334,34,16,18,4,3
0,381,381,30,14,16,2,1
8,382,382,44,44,0,1,0
1,404,404,88,70,18,4,3
9,405,405,21,21,0,1,0
12,411,411,77,5,72,4,3
7,451,451,11,11,0,1,0
5,493,493,133,16,117,4,3

14,145,145,11,11,0,1,0
6,153,153,39,25,14,2,1
4,179,179,11,3,8,2,1
7,189,189,1,1,0,1,0
9,233,233,9,1,8,2,1
12,235,235,27,27,0,1,0
8,279,279,65,65,0,1,0
1,309,309,23,8,15,4,3
3,354,354,38,38,0,1,0
0,394,394,15,15,0,1,0
11,406,406,11,11,0,1,0
10,411,411,36,27,9,4,3
13,427,427,101,62,39,4,3
2,473,473,91,82,9,4,3
5,497,497,33,33,0,1,0

11,114,114,8,2,6,3,2
8,137,137,1,1,0,1,0
14,137,137,18,6,12,3,2
1,147,147,22,22,0,1,0
13,149,149,14,14,0,1,0
9,179,179,27,6,21,2,1
10,206,206,8,2,6,3,2
15,335,335,26,26,0,1,0
0,343,343,48,36,12,4,3
18,379,379,53,22,31,2,1
2,389,389,44,20,24,4,3
6,390,390,1,1,0,1,0
4,393,393,13,13,0,1,0
17,404,404,4,4,0,1,0
7,406,406,18,14,4,2,1
16,415,415,5,5,0,1,0
5,472,472,8,8,0,1,0
3,496,496,19,5,14,3,2
12,498,498,174,174,0,1,0

4,148,148,18,18,0,1,0
1,152,152,4,4,0,1,0
10,156,156,10,10,0,1,0
2,199,199,44,3,41,2,1
11,200,200,17,11,6,3,2
9,244,244,15,10,5,2,1
12,245,245,66,46,20,3,2
8,258,258,16,16,0,1,0
6,260,260,5,5,0,1,0
7,281,281,18,6,12,4,3
15,283,283,3,3,0,1,0
5,314,314,35,35,0,1,0
14,339,339,5,5,0,1,0
0,455,455,10,10,0,1,0
16,457,457,80,23,57,4,3
13,460,460,91,91,0,1,0
3,500,500,47,47,0,1,0

8,120,120,13,13,0,1,0
6,142,142,4,4,0,1,0
0,153,153,1,1,0,1,0
20,156,156,4,4,0,1,0
5,160,160,15,15,0,1,0
11,166,166,18,5,13,2,1
15,187,187,45,45,0,1,0
14,187,187,24,10,14,3,2
3,190,190,8,8,0,1,0
19,195,195,11,11,0,1,0
16,206,206,14,9,5,2,1
7,231,231,3,3,0,1,0
13,314,314,19,15,4,2,1
1,351,351,23,8,15,4,3
9,390,390,1,1,0,1,0
12,402,402,43,15,28,2,1
2,431,431,58,17,41,2,1
10,442,442,5,2,3,2,1
4,447,447,9,9,0,1,0
17,448,448,106,39,67,3,2
18,472,472,28,2,26,2,1

14,127,127,21,21,0,1,0
6,176,176,8,8,0,1,0
0,183,183,14,8,6,2,1
13,241,241,20,8,12,4,3
7,244,244,13,13,0,1,0
2,265,265,28,13,15,2,1
11,279,279,51,13,38,3,2
3,292,292,17,17,0,1,0
1,362,362,44,44,0,1,0
12,385,385,31,15,16,4,3
5,386,386,57,6,51,4,3
4,402,402,51,27,24,3,2
10,455,455,87,87,0,1,0
8,457,457,30,30,0,1,0
9,470,470,50,50,0,1,0
15,474,474,3,3,0,1,0

3,100,100,7,7,0,1,0
12,147,147,19,19,0,1,0
9,174,174,39,39,0,1,0
10,180,180,29,1,28,2,1
7,207,207,66,4,62,3,2
5,314,314,29,17,12,3,2
11,316,316,15,3,12,3,2
2,326,326,22,22,0,1,0
4,379,379,32,18,14,3,2
0,384,384,34,22,12,3,2
14,387,387,60,51,9,4,3
6,399,399,3,3,0,1,0
1,407,407,30,30,0,1,0
8,445,445,38,35,3,2,1
13,466,466,4,1,3,2,1

4,121,121,26,26,0,1,0
9,130,130,19,14,5,2,1
0,132,132,3,3,0,1,0
8,181,181,1,1,0,1,0
6,202,202,1,1,0,1,0
16,212,212,24,24,0,1,0
15,250,250,57,57,0,1,0
7,258,258,22,8,14,3,2
11,270,270,56,25,31,4,3
3,290,290,13,7,6,3,2
1,318,318,1,1,0,1,0
12,339,339,38,6,32,2,1
5,380,380,1,1,0,1,0
13,387,387,14,14,0,1,0
14,423,423,17,17,0,1,0
10,456,456,31,17,14,3,2
2,492,492,133,133,0,1,0

9,204,204,24,12,12,2,1
7,208,208,11,2,9,2,1
10,230,230,4,4,0,1,0
15,239,239,14,2,12,4,3
4,259,259,13,13,0,1,0
12,261,261,28,16,12,2,1
13,283,283,24,2,22,2,1
8,289,289,7,1,6,3,2
5,297,297,31,7,24,3,2
2,311,311,86,5,81,4,3
3,316,316,31,13,18,2,1
14,317,317,55,18,37,2,1
11,361,361,90,90,0,1,0
0,410,410,6,6,0,1,0
6,442,442,19,19,0,1,0
1,482,482,66,66,0,1,0

3,120,120,10,4,6,3,2
5,134,134,4,4,0,1,0
10,137,137,23,23,0,1,0
1,169,169,15,15,0,1,0
9,181,181,16,16,0,1,0
2,185,185,8,3,5,2,1
11,190,190,33,33,0,1,0
6,239,239,14,2,12,3,2
4,272,272,2,2,0,1,0
13,272,272,43,43,0,1,0
14,286,286,26,4,22,3,2
0,353,353,138,48,90,3,2
8,364,364,11,11,0,1,0
12,377,377,38,14,24,2,1
7,464,464,46,46,0,1,0

4,132,132,22,16,6,2,1
10,142,142,14,4,10,2,1
0,183,183,31,5,26,2,1
11,187,187,48,48,0,1,0
7,217,217,15,3,12,4,3
1,310,310,65,65,0,1,0
2,327,327,25,25,0,1,0
5,416,416,48,16,32,2,1
8,420,420,4,4,0,1,0
6,428,428,67,67,0,1,0
9,441,441,47,47,0,1,0
3,473,473,85,75,10,2,1

6,191,191,2,2,0,1,0
0,229,229,6,6,0,1,0
11,230,230,34,34,0,1,0
8,231,231,64,64,0,1,0
4,239,239,17,17,0,1,0
5,248,248,50,4,46,2,1
9,256,256,17,1,16,3,2
12,348,348,83,67,16,3,2
1,368,368,34,34,0,1,0
10,386,386,6,6,0,1,0
7,408,408,22,15,7,2,1
2,430,430,156,72,84,4,3
3,460,460,22,22,0,1,0

5,169,169,1,1,0,1,0
6,177,177,2,2,0,1,0
0,191,191,8,8,0,1,0
11,201,201,7,2,5,2,1
10,202,202,1,1,0,1,0
3,204,204,5,5,0,1,0
1,210,210,17,2,15,2,1
13,232,232,17,2,15,2,1
15,234,234,45,26,19,2,1
12,235,235,1,1,0,1,0
17,259,259,8,2,6,3,2
8,276,276,6,6,0,1,0
19,293,293,9,9,0,1,0
16,305,305,1,1,0,1,0
7,326,326,65,12,53,3,2
20,380,380,91,16,75,4,3
2,441,441,67,59,8,3,2
4,443,443,60,60,0,1,0
9,448,448,6,6,0,1,0
18,450,450,28,28,0,1,0
14,500,500,127,73,54,3,2

15,107,107,3,3,0,1,0
17,145,145,58,54,4,2,1
13,186,186,6,6,0,1,0
16,195,195,4,4,0,1,0
9,197,197,31,16,15,4,3
4,277,277,15,15,0,1,0
7,280,280,14,14,0,1,0
1,284,284,23,23,0,1,0
3,298,298,6,6,0,1,0
11,307,307,6,6,0,1,0
10,337,337,6,3,3,2,1
14,342,342,1,1,0,1,0
18,347,347,67,19,48,3,2
2,361,361,22,22,0,1,0
0,362,362,23,23,0,1,0
12,464,464,69,69,0,1,0
5,475,475,66,36,30,2,1
8,477,477,45,17,28,3,2
6,495,495,22,13,9,4,3

16,111,111,20,1,19,2,1
9,176,176,24,24,0,1,0
0,177,177,3,3,0,1,0
5,177,177,1,1,0,1,0
2,232,232,1,1,0,1,0
14,234,234,5,5,0,1,0
13,243,243,24,24,0,1,0
18,285,285,48,8,40,2,1
8,302,302,9,9,0,1,0
3,306,306,17,1,16,3,2
6,313,313,60,25,35,4,3
17,315,315,35,1,34,3,2
7,349,349,40,40,0,1,0
15,362,362,39,12,27,4,3
1,364,364,12,12,0,1,0
4,408,408,18,18,0,1,0
10,437,437,62,2,60,3,2
12,460,460,60,8,52,3,2
11,464,464,13,13,0,1,0

12,105,105,3,3,0,1,0
2,154,154,28,18,10,2,1
8,177,177,1,1,0,1,0
10,201,201,4,4,0,1,0
9,250,250,13,8,5,2,1
14,260,260,22,8,14,2,1
0,265,265,73,73,0,1,0
3,272,272,3,3,0,1,0
13,293,293,72,72,0,1,0
11,332,332,34,34,0,1,0
15,344,344,6,6,0,1,0
6,364,364,25,16,9,4,3
1,367,367,30,15,15,2,1
7,368,368,3,3,0,1,0
16,382,382,115,65,50,3,2
5,434,434,26,26,0,1,0
4,455,455,17,17,0,1,0
17,486,486,16,16,0,1,0

12,101,101,12,1,11,3,2
5,105,105,16,16,0,1,0
3,107,107,1,1,0,1,0
7,108,108,8,8,0,1,0
6,126,126,1,1,0,1,0
8,126,126,20,20,0,1,0
1,180,180,57,19,38,4,3
2,193,193,15,15,0,1,0
13,199,199,11,5,6,3,2
15,202,202,68,34,34,2,1
11,255,255,11,11,0,1,0
10,283,283,8,8,0,1,0
4,329,329,1,1,0,1,0
9,364,364,31,31,0,1,0
14,380,380,56,10,46,2,1
0,468,468,2,2,0,1,0

8,123,123,30,30,0,1,0
3,204,204,76,76,0,1,0
1,248,248,28,6,22,3,2
9,248,248,1,1,0,1,0
6,273,273,27,27,0,1,0
5,274,274,25,11,14,2,1
2,314,314,72,40,32,3,2
10,351,351,38,33,5,2,1
7,413,413,70,67,3,2,1
4,458,458,48,48,0,1,0
0,500,500,45,24,21,2,1

12,140,140,18,12,6,3,2
6,251,251,13,7,6,2,1
1,261,261,1,1,0,1,0
9,292,292,72,72,0,1,0
11,332,332,4,4,0,1,0
8,355,355,47,47,0,1,0
4,378,378,49,49,0,1,0
13,420,420,30,21,9,4,3
2,449,449,25,1,24,2,1
3,458,458,152,99,53,4,3
5,472,472,101,22,79,4,3
10,472,472,57,57,0,1,0
0,476,476,7,7,0,1,0
7,480,480,47,47,0,1,0

4,141,141,1,1,0,1,0
12,164,164,16,16,0,1,0
14,197,197,18,12,6,3,2
5,217,217,28,22,6,3,2
9,232,232,1,1,0,1,0
3,248,248,63,63,0,1,0
0,278,278,6,6,0,1,0
10,291,291,22,22,0,1,0
8,299,299,40,40,0,1,0
7,333,333,8,8,0,1,0
2,360,360,32,32,0,1,0
11,375,375,11,11,0,1,0
16,383,383,40,6,34,4,3
1,393,393,2,2,0,1,0
17,411,411,84,18,66,3,2
15,417,417,89,89,0,1,0
13,474,474,34,5,29,2,1
6,487,487,29,26,3,2,1

11,104,104,27,1,26,3,2
1,114,114,29,29,0,1,0
9,124,124,16,11,5,2,1
10,146,146,10,2,8,3,2
6,170,170,3,3,0,1,0
7,189,189,9,6,3,2,1
12,195,195,45,45,0,1,0
0,230,230,11,11,0,1,0
5,263,263,4,4,0,1,0
8,344,344,14,2,12,3,2
3,348,348,1,1,0,1,0
2,378,378,116,74,42,3,2
4,436,436,69,59,10,3,2
13,486,486,23,23,0,1,0

15,119,119,4,4,0,1,0
2,127,127,4,1,3,2,1
3,130,130,19,19,0,1,0
0,218,218,1,1,0,1,0
9,244,244,1,1,0,1,0
13,263,263,55,55,0,1,0
4,276,276,34,9,25,2,1
1,278,278,24,14,10,3,2
11,297,297,2,2,0,1,0
16,304,304,56,56,0,1,0
18,329,329,26,26,0,1,0
8,353,353,46,3,43,2,1
10,361,361,6,6,0,1,0
14,364,364,15,5,10,2,1
7,380,380,1,1,0,1,0
12,387,387,10,7,3,2,1
17,425,425,103,64,39,4,3
6,429,429,33,33,0,1,0
5,478,478,83,52,31,3,2

4,102,102,8,4,4,2,1
0,105,105,1,1,0,1,0
12,121,121,37,19,18,4,3
11,122,122,6,6,0,1,0
14,218,218,28,28,0,1,0
8,304,304,4,4,0,1,0
5,346,346,3,3,0,1,0
2,379,379,16,11,5,2,1
1,388,388,24,24,0,1,0
6,391,391,70,70,0,1,0
9,396,396,38,38,0,1,0
10,448,448,9,9,0,1,0
7,463,463,139,16,123,4,3
3,491,491,60,51,9,4,3
13,493,493,100,88,12,3,2

8,114,114,21,5,16,3,2
4,140,140,3,3,0,1,0
9,158,158,17,1,16,3,2
7,178,178,32,32,0,1,0
0,207,207,25,6,19,2,1
3,212,212,51,36,15,4,3
11,264,264,6,6,0,1,0
13,270,270,46,28,18,4,3
6,308,308,2,2,0,1,0
10,339,339,33,33,0,1,0
1,389,389,2,2,0,1,0
12,395,395,22,6,16,3,2
5,449,449,72,6,66,4,3
2,467,467,115,69,46,4,3

12,118,118,24,24,0,1,0
0,130,130,25,11,14,3,2
10,240,240,15,15,0,1,0
14,255,255,8,8,0,1,0
11,269,269,53,53,0,1,0
8,285,285,41,41,0,1,0
1,296,296,19,14,5,2,1
6,358,358,14,7,7,2,1
9,360,360,34,34,0,1,0
2,385,385,17,17,0,1,0
4,402,402,91,29,62,3,2
7,427,427,23,2,21,3,2
3,449,449,53,12,41,2,1
5,449,449,28,2,26,3,2
13,463,463,39,18,21,4,3

14,143,143,26,26,0,1,0
3,211,211,21,17,4,2,1
12,229,229,24,24,0,1,0
9,263,263,16,4,12,3,2
10,294,294,77,47,30,4,3
13,332,332,1,1,0,1,0
11,342,342,21,21,0,1,0
4,344,344,110,110,0,1,0
0,352,352,13,13,0,1,0
5,354,354,16,6,10,2,1
7,357,357,12,12,0,1,0
6,381,381,2,2,0,1,0
8,405,405,11,11,0,1,0
1,421,421,7,7,0,1,0
15,497,497,69,60,9,4,3
2,500,500,109,41,68,3,2

9,159,159,39,13,26,2,1
12,171,171,26,12,14,2,1
1,187,187,37,37,0,1,0
6,210,210,1,1,0,1,0
5,215,215,27,12,15,4,3
11,220,220,16,16,0,1,0
0,257,257,2,2,0,1,0
3,266,266,13,6,7,2,1
2,297,297,5,5,0,1,0
13,298,298,25,10,15,4,3
7,299,299,6,6,0,1,0
10,354,354,57,57,0,1,0
14,374,374,19,1,18,4,3
8,375,375,19,1,18,4,3
4,388,388,148,27,121,4,3

9,154,154,13,1,12,4,3
1,181,181,18,18,0,1,0
4,186,186,83,83,0,1,0
5,187,187,69,51,18,4,3
8,204,204,24,9,15,2,1
2,218,218,2,2,0,1,0
10,244,244,42,15,27,4,3
6,259,259,1,1,0,1,0
3,284,284,57,42,15,4,3
0,306,306,14,3,11,2,1
7,329,329,11,11,0,1,0
11,473,473,15,15,0,1,0

1,122,122,11,1,10,4,3
7,125,125,9,5,4,2,1
0,140,140,67,31,36,2,1
2,145,145,17,17,0,1,0
6,199,199,16,1,15,4,3
10,254,254,44,34,10,3,2
4,266,266,20,2,18,4,3
9,291,291,40,6,34,3,2
11,312,312,18,8,10,2,1
8,357,357,84,2,82,3,2
5,423,423,23,8,15,4,3
3,478,478,19,7,12,2,1

10,107,107,6,1,5,2,1
12,110,110,2,2,0,1,0
5,150,150,13,13,0,1,0
9,174,174,14,14,0,1,0
2,203,203,1,1,0,1,0
16,211,211,7,2,5,2,1
15,315,315,32,26,6,3,2
3,324,324,22,5,17,2,1
11,342,342,21,21,0,1,0
14,389,389,57,57,0,1,0
0,393,393,104,104,0,1,0
8,398,398,21,21,0,1,0
4,402,402,1,1,0,1,0
13,410,410,165,90,75,4,3
7,414,414,9,9,0,1,0
1,424,424,41,6,35,2,1
6,491,491,61,11,50,3,2

11,113,113,7,1,6,3,2
0,178,178,1,1,0,1,0
10,188,188,3,3,0,1,0
2,201,201,46,38,8,2,1
12,276,276,21,21,0,1,0
9,280,280,48,28,20,2,1
4,314,314,13,13,0,1,0
8,321,321,2,2,0,1,0
5,339,339,33,16,17,2,1
13,364,364,13,13,0,1,0
3,427,427,46,16,30,2,1
1,458,458,123,84,39,4,3
6,465,465,24,12,12,3,2
7,483,483,217,181,36,2,1

2,105,105,1,1,0,1,0
1,106,106,11,11,0,1,0
15,110,110,42,42,0,1,0
0,147,147,1,1,0,1,0
18,162,162,5,5,0,1,0
10,180,180,13,3,10,3,2
17,186,186,42,31,11,2,1
9,220,220,26,14,12,3,2
16,240,240,29,29,0,1,0
14,245,245,2,2,0,1,0
12,255,255,9,5,4,2,1
6,265,265,6,1,5,2,1
7,305,305,27,27,0,1,0
4,314,314,33,33,0,1,0
13,364,364,5,5,0,1,0
8,379,379,14,11,3,2,1
5,393,393,12,8,4,2,1
3,433,433,48,31,17,2,1
11,461,461,44,41,3,2,1

9,143,143,11,7,4,2,1
14,217,217,5,5,0,1,0
16,220,220,13,13,0,1,0
13,233,233,73,73,0,1,0
3,240,240,25,25,0,1,0
11,241,241,16,16,0,1,0
6,261,261,47,47,0,1,0
1,271,271,5,5,0,1,0
2,329,329,8,8,0,1,0
15,345,345,21,7,14,3,2
4,384,384,94,94,0,1,0
12,387,387,29,29,0,1,0
10,409,409,87,30,57,4,3
0,432,432,5,5,0,1,0
7,469,469,11,11,0,1,0
8,475,475,22,22,0,1,0
5,484,484,35,35,0,1,0

10,120,120,31,31,0,1,0
9,184,184,51,1,50,3,2
7,201,201,12,2,10,2,1
4,248,248,6,6,0,1,0
0,327,327,25,25,0,1,0
6,354,354,14,5,9,2,1
3,393,393,63,37,26,2,1
5,443,443,37,37,0,1,0
1,452,452,141,96,45,4,3
2,462,462,117,69,48,3,2
8,493,493,35,11,24,4,3

3,107,107,32,13,19,3,2
1,217,217,33,33,0,1,0
4,292,292,33,33,0,1,0
10,326,326,16,16,0,1,0
7,346,346,23,8,15,2,1
13,356,356,94,20,74,3,2
6,366,366,50,50,0,1,0
2,425,425,17,17,0,1,0
11,425,425,16,7,9,4,3
0,433,433,13,13,0,1,0
8,441,441,67,67,0,1,0
12,463,463,40,33,7,2,1
5,476,476,15,6,9,4,3
9,491,491,76,76,0,1,0

1,209,209,25,15,10,3,2
7,245,245,70,24,46,3,2
11,267,267,86,86,0,1,0
9,306,306,15,15,0,1,0
6,339,339,23,7,16,3,2
10,343,343,11,11,0,1,0
4,347,347,11,11,0,1,0
0,370,370,5,5,0,1,0
5,391,391,86,73,13,2,1
12,404,404,15,15,0,1,0
3,446,446,73,39,34,2,1
2,483,483,122,122,0,1,0
8,494,494,7,4,3,2,1

7,110,110,4,1,3,2,1
13,119,119,34,34,0,1,0
4,138,138,4,4,0,1,0
12,149,149,17,4,13,2,1
5,157,157,19,1,18,4,3
16,194,194,1,1,0,1,0
14,216,216,28,2,26,3,2
10,231,231,21,21,0,1,0
11,244,244,27,27,0,1,0
15,269,269,6,6,0,1,0
1,288,288,9,9,0,1,0
8,289,289,27,6,21,2,1
9,301,301,9,9,0,1,0
0,388,388,72,51,21,4,3
3,407,407,29,17,12,2,1
2,482,482,12,12,0,1,0
6,483,483,43,14,29,2,1
17,495,495,74,74,0,1,0

10,120,120,2,2,0,1,0
3,131,131,10,10,0,1,0
7,150,150,1,1,0,1,0
5,214,214,2,2,0,1,0
8,264,264,86,47,39,3,2
13,265,265,2,2,0,1,0
11,277,277,8,2,6,2,1
14,297,297,118,86,32,4,3
2,311,311,3,3,0,1,0
0,335,335,6,6,0,1,0
16,335,335,58,58,0,1,0
1,351,351,13,4,9,2,1
12,353,353,46,46,0,1,0
15,403,403,1,1,0,1,0
4,405,405,59,59,0,1,0
18,414,414,10,7,3,2,1
6,435,435,2,2,0,1,0
17,443,443,34,34,0,1,0
9,458,458,56,26,30,2,1

12,109,109,7,7,0,1,0
10,153,153,17,17,0,1,0
1,190,190,9,3,6,2,1
7,216,216,8,8,0,1,0
6,257,257,38,6,32,3,2
5,281,281,6,6,0,1,0
13,289,289,21,21,0,1,0
2,295,295,46,46,0,1,0
3,308,308,104,58,46,3,2
4,366,366,13,13,0,1,0
0,391,391,8,8,0,1,0
11,404,404,64,10,54,3,2
14,433,433,8,5,3,2,1
9,439,439,154,50,104,4,3
8,455,455,19,19,0,1,0

1,121,121,1,1,0,1,0
0,154,154,60,36,24,4,3
11,156,156,34,12,22,2,1
9,286,286,9,4,5,2,1
10,312,312,38,11,27,2,1
6,349,349,4,1,3,2,1
4,357,357,60,60,0,1,0
3,390,390,46,46,0,1,0
8,393,393,31,4,27,4,3
7,414,414,5,5,0,1,0
5,431,431,146,47,99,4,3
2,491,491,58,8,50,3,2

10,108,108,33,33,0,1,0
7,117,117,4,1,3,2,1
1,140,140,35,15,20,4,3
0,156,156,27,3,24,2,1
4,188,188,7,7,0,1,0
2,222,222,6,6,0,1,0
3,227,227,72,29,43,3,2
8,312,312,6,6,0,1,0
9,322,322,35,32,3,2,1
5,328,328,35,35,0,1,0
6,370,370,77,13,64,4,3
11,468,468,17,17,0,1,0

12,125,125,4,4,0,1,0
0,249,249,23,20,3,2,1
10,249,249,43,43,0,1,0
7,266,266,22,22,0,1,0
4,322,322,28,28,0,1,0
9,322,322,29,29,0,1,0
13,322,322,8,8,0,1,0
6,345,345,16,3,13,2,1
11,346,346,25,7,18,4,3
3,350,350,17,17,0,1,0
5,385,385,80,72,8,2,1
2,422,422,124,95,29,4,3
8,438,438,148,105,43,4,3
1,500,500,13,13,0,1,0

13,167,167,19,7,12,3,2
2,175,175,4,4,0,1,0
5,221,221,1,1,0,1,0
16,221,221,21,21,0,1,0
10,224,224,25,1,24,4,3
8,224,224,1,1,0,1,0
3,250,250,30,20,10,3,2
14,256,256,8,8,0,1,0
12,279,279,28,28,0,1,0
9,306,306,1,1,0,1,0
11,309,309,46,46,0,1,0
15,327,327,70,70,0,1,0
0,363,363,67,10,57,4,3
6,387,387,11,11,0,1,0
7,402,402,50,32,18,4,3
4,439,439,30,2,28,3,2
1,444,444,107,21,86,3,2

17,104,104,8,8,0,1,0
27,192,192,9,2,7,2,1
11,195,195,4,1,3,2,1
9,200,200,1,1,0,1,0
24,219,219,2,2,0,1,0
23,224,224,50,25,25,3,2
6,225,225,11,1,10,3,2
22,232,232,63,45,18,4,3
1,234,234,1,1,0,1,0
2,268,268,2,2,0,1,0
15,269,269,1,1,0,1,0
8,290,290,14,14,0,1,0
20,296,296,25,25,0,1,0
21,305,305,5,5,0,1,0
14,308,308,6,6,0,1,0
19,324,324,1,1,0,1,0
25,340,340,7,1,6,3,2
12,352,352,23,9,14,3,2
26,394,394,89,62,27,2,1
16,396,396,6,6,0,1,0
3,402,402,1,1,0,1,0
7,425,425,20,9,11,2,1
5,426,426,54,37,17,2,1
0,435,435,5,5,0,1,0
10,450,450,10,10,0,1,0
13,462,462,13,13,0,1,0
18,479,479,35,17,18,4,3
4,494,494,44,44,0,1,0

8,114,114,17,17,0,1,0
5,184,184,16,16,0,1,0
3,192,192,3,3,0,1,0
12,240,240,46,46,0,1,0
2,298,298,19,7,12,2,1
6,319,319,1,1,0,1,0
10,349,349,29,29,0,1,0
9,373,373,58,58,0,1,0
0,382,382,31,31,0,1,0
7,396,396,72,69,3,2,1
1,398,398,158,106,52,3,2
4,422,422,66,26,40,3,2
11,435,435,22,22,0,1,0

2,157,157,14,5,9,3,2
3,200,200,20,2,18,2,1
8,230,230,19,10,9,4,3
4,300,300,109,109,0,1,0
11,300,300,26,20,6,3,2
6,323,323,8,8,0,1,0
0,352,352,61,25,36,2,1
13,396,396,17,17,0,1,0
10,402,402,86,40,46,3,2
1,430,430,13,1,12,2,1
9,430,430,73,3,70,3,2
12,438,438,44,44,0,1,0
7,482,482,55,23,32,3,2
5,488,488,10,10,0,1,0

5,129,129,45,45,0,1,0
6,147,147,39,15,24,4,3
3,184,184,5,5,0,1,0
9,280,280,27,27,0,1,0
11,347,347,2,2,0,1,0
2,353,353,40,22,18,2,1
4,374,374,42,17,25,2,1
1,382,382,33,33,0,1,0
7,397,397,1,1,0,1,0
12,421,421,14,9,5,2,1
10,446,446,41,14,27,2,1
0,468,468,54,50,4,2,1
8,473,473,147,118,29,2,1

8,126,126,3,3,0,1,0
4,144,144,13,13,0,1,0
16,154,154,2,2,0,1,0
9,160,160,2,2,0,1,0
14,164,164,26,26,0,1,0
2,165,165,7,7,0,1,0
22,179,179,6,6,0,1,0
15,195,195,3,3,0,1,0
6,205,205,3,3,0,1,0
12,214,214,26,26,0,1,0
10,243,243,2,2,0,1,0
18,244,244,57,7,50,4,3
7,269,269,23,23,0,1,0
11,273,273,7,7,0,1,0
17,302,302,49,49,0,1,0
20,317,317,26,26,0,1,0
21,327,327,85,37,48,3,2
0,375,375,1,1,0,1,0
3,381,381,31,31,0,1,0
13,399,399,45,45,0,1,0
1,437,437,2,2,0,1,0
19,457,457,15,8,7,2,1
5,471,471,1,1,0,1,0

16,124,124,4,4,0,1,0
6,127,127,7,7,0,1,0
12,139,139,13,1,12,4,3
8,156,156,5,5,0,1,0
10,188,188,41,41,0,1,0
3,199,199,17,3,14,3,2
1,252,252,4,4,0,1,0
15,252,252,12,1,11,4,3
14,280,280,85,11,74,3,2
18,311,311,16,6,10,3,2
7,324,324,25,25,0,1,0
4,326,326,42,8,34,3,2
0,353,353,34,13,21,2,1
5,354,354,14,14,0,1,0
17,376,376,42,42,0,1,0
2,428,428,2,2,0,1,0
11,431,431,2,2,0,1,0
9,464,464,20,3,17,3,2
13,481,481,82,45,37,2,1

4,121,121,1,1,0,1,0
8,137,137,18,4,14,3,2
10,220,220,17,17,0,1,0
7,246,246,7,7,0,1,0
6,269,269,23,7,16,2,1
9,288,288,73,73,0,1,0
2,292,292,79,45,34,2,1
3,313,313,24,24,0,1,0
11,344,344,49,7,42,3,2
1,358,358,44,44,0,1,0
0,366,366,44,44,0,1,0
12,417,417,43,43,0,1,0
5,449,449,91,91,0,1,0

5,139,139,36,36,0,1,0
6,161,161,4,4,0,1,0
11,177,177,3,3,0,1,0
3,215,215,14,14,0,1,0
2,220,220,12,12,0,1,0
1,276,276,89,89,0,1,0
7,324,324,95,56,39,2,1
9,350,350,52,52,0,1,0
8,410,410,87,87,0,1,0
4,412,412,25,25,0,1,0
10,473,473,22,22,0,1,0
0,491,491,20,20,0,1,0
12,497,497,33,7,26,3,2

14,107,107,7,7,0,1,0
8,128,128,47,11,36,2,1
13,224,224,52,39,13,2,1
2,246,246,8,2,6,3,2
10,254,254,74,74,0,1,0
1,290,290,14,14,0,1,0
11,290,290,10,10,0,1,0
0,339,339,2,2,0,1,0
5,347,347,25,25,0,1,0
9,362,362,3,3,0,1,0
7,368,368,11,5,6,2,1
3,388,388,3,3,0,1,0
6,439,439,63,33,30,2,1
4,445,445,43,4,39,4,3
15,460,460,53,53,0,1,0
12,465,465,29,29,0,1,0

6,138,138,1,1,0,1,0
12,144,144,24,24,0,1,0
7,166,166,3,3,0,1,0
11,175,175,14,8,6,2,1
10,192,192,6,1,5,2,1
8,246,246,5,5,0,1,0
14,304,304,78,15,63,3,2
9,309,309,79,79,0,1,0
13,310,310,2,2,0,1,0
1,312,312,2,2,0,1,0
4,379,379,55,27,28,2,1
2,383,383,1,1,0,1,0
3,402,402,98,2,96,4,3
0,436,436,68,68,0,1,0
5,443,443,98,98,0,1,0

1,102,102,8,8,0,1,0
5,117,117,7,1,6,3,2
15,162,162,12,3,9,4,3
18,220,220,37,11,26,3,2
16,248,248,22,22,0,1,0
6,286,286,57,57,0,1,0
9,329,329,8,8,0,1,0
12,339,339,77,68,9,2,1
17,355,355,41,13,28,3,2
3,364,364,16,4,12,3,2
0,389,389,10,10,0,1,0
8,403,403,14,14,0,1,0
11,410,410,32,2,30,3,2
10,411,411,1,1,0,1,0
13,456,456,9,4,5,2,1
7,473,473,86,79,7,2,1
4,482,482,7,7,0,1,0
14,492,492,60,60,0,1,0
2,496,496,29,29,0,1,0

2,102,102,3,3,0,1,0
3,107,107,14,14,0,1,0
11,156,156,15,15,0,1,0
1,181,181,31,18,13,2,1
6,188,188,79,61,18,3,2
8,262,262,17,17,0,1,0
7,272,272,25,13,12,3,2
5,311,311,33,17,16,4,3
10,385,385,7,7,0,1,0
4,396,396,175,175,0,1,0
0,487,487,14,6,8,2,1
9,500,500,6,6,0,1,0

1,102,102,3,3,0,1,0
9,112,112,37,1,36,4,3
2,121,121,1,1,0,1,0
4,178,178,39,12,27,2,1
3,214,214,29,29,0,1,0
14,245,245,22,2,20,3,2
11,251,251,17,2,15,4,3
7,252,252,25,25,0,1,0
5,282,282,3,3,0,1,0
0,330,330,58,40,18,2,1
13,333,333,55,55,0,1,0
8,381,381,28,4,24,4,3
6,385,385,19,9,10,3,2
10,439,439,3,3,0,1,0
15,448,448,7,7,0,1,0
12,461,461,63,42,21,4,3

5,122,122,9,9,0,1,0
13,132,132,14,3,11,2,1
2,149,149,18,18,0,1,0
3,179,179,9,4,5,2,1
8,221,221,17,17,0,1,0
1,226,226,19,19,0,1,0
9,250,250,8,8,0,1,0
6,308,308,17,17,0,1,0
10,375,375,143,86,57,4,3
4,411,411,100,9,91,4,3
11,416,416,49,23,26,2,1
7,417,417,15,4,11,2,1
12,424,424,2,2,0,1,0
0,463,463,64,20,44,2,1
14,490,490,47,47,0,1,0

12,124,124,13,13,0,1,0
4,129,129,5,5,0,1,0
8,162,162,10,10,0,1,0
1,164,164,3,3,0,1,0
5,165,165,3,3,0,1,0
3,168,168,39,39,0,1,0
9,192,192,48,20,28,3,2
7,262,262,49,49,0,1,0
13,267,267,50,18,32,3,2
15,349,349,39,39,0,1,0
2,352,352,45,45,0,1,0
11,364,364,14,8,6,2,1
6,367,367,36,36,0,1,0
14,372,372,22,9,13,2,1
10,384,384,23,11,12,2,1
0,485,485,11,11,0,1,0

10,133,133,20,20,0,1,0
5,136,136,34,14,20,3,2
7,166,166,1,1,0,1,0
6,195,195,8,8,0,1,0
16,220,220,45,45,0,1,0
1,226,226,22,13,9,2,1
8,226,226,1,1,0,1,0
12,250,250,75,75,0,1,0
17,268,268,32,32,0,1,0
13,316,316,5,5,0,1,0
2,361,361,17,11,6,3,2
14,375,375,4,4,0,1,0
11,385,385,53,5,48,4,3
9,433,433,42,18,24,4,3
3,446,446,16,6,10,2,1
0,454,454,24,5,19,2,1
4,460,460,9,1,8,3,2
15,470,470,12,12,0,1,0

5,132,132,1,1,0,1,0
4,134,134,16,16,0,1,0
3,144,144,4,4,0,1,0
11,170,170,24,24,0,1,0
7,213,213,22,10,12,2,1
1,242,242,72,72,0,1,0
10,328,328,110,34,76,3,2
9,367,367,13,13,0,1,0
8,398,398,32,32,0,1,0
0,417,417,23,23,0,1,0
2,420,420,127,83,44,2,1
6,474,474,53,37,16,4,3

6,138,138,9,9,0,1,0
2,152,152,2,2,0,1,0
0,156,156,8,3,5,2,1
5,174,174,13,13,0,1,0
14,190,190,7,7,0,1,0
1,256,256,18,2,16,2,1
12,274,274,32,32,0,1,0
15,282,282,39,7,32,2,1
7,336,336,85,72,13,2,1
9,362,362,9,3,6,3,2
11,382,382,35,13,22,2,1
16,388,388,44,44,0,1,0
8,402,402,1,1,0,1,0
13,458,458,82,70,12,4,3
4,467,467,25,25,0,1,0
10,474,474,64,64,0,1,0
3,486,486,94,73,21,2,1

12,106,106,18,2,16,2,1
9,113,113,15,15,0,1,0
14,277,277,65,55,10,2,1
4,297,297,6,6,0,1,0
10,299,299,16,16,0,1,0
8,327,327,1,1,0,1,0
11,339,339,9,9,0,1,0
3,386,386,92,14,78,3,2
6,387,387,5,5,0,1,0
16,391,391,22,22,0,1,0
5,406,406,25,5,20,2,1
0,428,428,3,3,0,1,0
7,430,430,58,8,50,3,2
15,439,439,105,51,54,4,3
1,441,441,40,40,0,1,0
13,446,446,13,4,9,2,1
2,493,493,51,51,0,1,0

4,112,112,20,6,14,2,1
13,153,153,2,2,0,1,0
1,204,204,46,46,0,1,0
8,206,206,14,14,0,1,0
2,218,218,29,11,18,3,2
0,246,246,9,9,0,1,0
6,263,263,26,8,18,4,3
9,331,331,9,4,5,2,1
11,378,378,134,32,102,4,3
10,408,408,98,75,23,2,1
5,420,420,52,52,0,1,0
7,475,475,49,5,44,3,2
3,494,494,2,2,0,1,0
12,497,497,3,3,0,1,0

0,132,132,1,1,0,1,0
6,178,178,70,70,0,1,0
9,187,187,9,9,0,1,0
8,257,257,42,18,24,2,1
3,335,335,124,67,57,4,3
10,351,351,10,10,0,1,0
2,359,359,123,123,0,1,0
4,376,376,44,26,18,4,3
5,416,416,17,17,0,1,0
7,451,451,10,10,0,1,0
1,471,471,38,38,0,1,0

14,134,134,35,23,12,3,2
0,183,183,2,2,0,1,0
1,237,237,24,24,0,1,0
11,263,263,9,3,6,3,2
8,270,270,30,6,24,2,1
4,279,279,4,4,0,1,0
7,279,279,15,15,0,1,0
15,295,295,3,3,0,1,0
13,342,342,10,10,0,1,0
2,406,406,49,30,19,2,1
3,417,417,144,120,24,3,2
12,417,417,7,1,6,2,1
9,442,442,80,16,64,4,3
5,451,451,10,2,8,3,2
10,458,458,126,107,19,2,1
6,460,460,11,11,0,1,0

10,108,108,7,1,6,3,2
12,207,207,48,30,18,4,3
6,210,210,4,4,0,1,0
0,218,218,40,40,0,1,0
4,228,228,5,5,0,1,0
9,229,229,22,10,12,2,1
3,331,331,108,68,40,2,1
11,400,400,86,2,84,3,2
2,413,413,35,35,0,1,0
8,437,437,56,44,12,2,1
5,442,442,10,10,0,1,0
1,466,466,75,38,37,2,1
7,477,477,26,26,0,1,0

9,107,107,2,2,0,1,0
2,117,117,10,4,6,3,2
13,120,120,17,12,5,2,1
8,125,125,32,32,0,1,0
14,149,149,6,6,0,1,0
10,172,172,13,4,9,2,1
11,200,200,41,17,24,2,1
4,216,216,4,4,0,1,0
0,267,267,26,26,0,1,0
12,290,290,25,7,18,4,3
7,339,339,13,13,0,1,0
1,397,397,98,76,22,4,3
6,439,439,40,40,0,1,0
5,455,455,88,14,74,3,2
3,481,481,15,15,0,1,0

8,133,133,9,9,0,1,0
11,145,145,12,4,8,2,1
3,185,185,40,40,0,1,0
10,230,230,70,1,69,4,3
13,274,274,37,11,26,2,1
7,300,300,11,11,0,1,0
9,341,341,48,6,42,4,3
1,343,343,43,43,0,1,0
5,378,378,7,7,0,1,0
15,411,411,7,7,0,1,0
4,412,412,76,34,42,4,3
12,418,418,17,14,3,2,1
0,430,430,19,5,14,2,1
6,444,444,30,3,27,4,3
14,464,464,42,3,39,2,1
2,474,474,21,2,19,2,1

10,100,100,5,5,0,1,0
9,172,172,35,35,0,1,0
3,173,173,8,8,0,1,0
14,208,208,27,27,0,1,0
13,208,208,30,30,0,1,0
2,229,229,6,1,5,2,1
5,229,229,26,10,16,2,1
8,264,264,60,12,48,2,1
16,276,276,3,3,0,1,0
15,285,285,9,1,8,2,1
6,288,288,9,9,0,1,0
12,289,289,122,84,38,2,1
0,304,304,18,12,6,2,1
11,417,417,13,13,0,1,0
4,417,417,18,18,0,1,0
1,440,440,9,9,0,1,0
7,497,497,16,16,0,1,0

13,123,123,37,11,26,3,2
5,163,163,2,2,0,1,0
11,226,226,30,30,0,1,0
10,230,230,1,1,0,1,0
12,237,237,30,30,0,1,0
8,284,284,19,19,0,1,0
7,339,339,4,4,0,1,0
6,341,341,2,2,0,1,0
9,357,357,61,6,55,4,3
0,405,405,29,29,0,1,0
3,418,418,81,5,76,4,3
2,436,436,78,1,77,3,2
1,443,443,9,6,3,2,1
4,471,471,150,9,141,4,3

13,103,103,2,2,0,1,0
12,142,142,25,1,24,4,3
3,188,188,28,25,3,2,1
9,191,191,2,2,0,1,0
11,194,194,3,3,0,1,0
10,205,205,106,106,0,1,0
2,227,227,20,5,15,4,3
6,281,281,10,7,3,2,1
5,301,301,63,12,51,4,3
8,312,312,17,8,9,2,1
1,369,369,66,54,12,3,2
0,387,387,5,5,0,1,0
4,392,392,9,3,6,3,2
7,395,395,20,6,14,2,1
14,415,415,5,5,0,1,0
15,429,429,29,1,28,2,1

1,146,146,56,56,0,1,0
4,164,164,7,1,6,3,2
5,189,189,4,4,0,1,0
12,190,190,21,21,0,1,0
9,212,212,14,14,0,1,0
0,222,222,4,4,0,1,0
3,246,246,27,27,0,1,0
14,284,284,11,11,0,1,0
8,293,293,12,2,10,3,2
10,304,304,6,6,0,1,0
11,322,322,111,111,0,1,0
7,325,325,18,15,3,2,1
16,336,336,22,22,0,1,0
15,349,349,44,10,34,3,2
2,358,358,22,4,18,2,1
13,371,371,39,39,0,1,0
6,425,425,1,1,0,1,0

0,137,137,2,2,0,1,0
5,141,141,1,1,0,1,0
11,239,239,19,19,0,1,0
1,257,257,92,4,88,3,2
12,282,282,5,5,0,1,0
7,283,283,14,14,0,1,0
8,309,309,3,3,0,1,0
2,359,359,6,1,5,2,1
4,361,361,106,48,58,3,2
14,366,366,18,18,0,1,0
13,377,377,99,51,48,3,2
9,413,413,76,29,47,2,1
10,420,420,87,47,40,3,2
6,429,429,15,15,0,1,0
3,454,454,12,6,6,2,1

15,127,127,5,5,0,1,0
10,135,135,13,13,0,1,0
5,154,154,5,5,0,1,0
14,189,189,8,2,6,3,2
17,191,191,8,3,5,2,1
0,237,237,2,2,0,1,0
13,239,239,69,38,31,2,1
6,264,264,2,2,0,1,0
7,311,311,22,8,14,3,2
12,321,321,55,17,38,3,2
16,365,365,32,32,0,1,0
1,389,389,62,62,0,1,0
4,394,394,15,15,0,1,0
9,422,422,32,14,18,3,2
2,432,432,1,1,0,1,0
3,433,433,50,9,41,2,1
8,445,445,88,45,43,2,1
11,481,481,69,69,0,1,0

2,132,132,9,5,4,2,1
15,164,164,7,7,0,1,0
10,171,171,60,60,0,1,0
7,219,219,18,18,0,1,0
5,225,225,6,6,0,1,0
9,249,249,6,3,3,2,1
16,264,264,37,37,0,1,0
11,285,285,4,4,0,1,0
0,290,290,18,11,7,2,1
6,314,314,14,14,0,1,0
4,342,342,10,10,0,1,0
12,350,350,50,50,0,1,0
14,358,358,17,17,0,1,0
13,425,425,34,34,0,1,0
8,427,427,115,108,7,2,1
3,455,455,1,1,0,1,0
1,457,457,89,89,0,1,0

8,109,109,7,7,0,1,0
14,117,117,10,2,8,3,2
13,140,140,33,13,20,3,2
0,146,146,11,1,10,2,1
12,147,147,25,4,21,2,1
1,163,163,2,2,0,1,0
9,180,180,4,4,0,1,0
16,193,193,10,6,4,2,1
17,195,195,15,15,0,1,0
5,222,222,21,21,0,1,0
19,260,260,70,52,18,2,1
11,314,314,1,1,0,1,0
3,333,333,23,23,0,1,0
4,364,364,32,4,28,3,2
6,447,447,7,1,6,2,1
2,456,456,6,6,0,1,0
15,465,465,18,4,14,3,2
18,483,483,32,12,20,3,2
7,490,490,82,13,69,4,3
10,496,496,5,5,0,1,0

11,118,118,7,7,0,1,0
8,149,149,11,11,0,1,0
9,218,218,9,5,4,2,1
6,220,220,3,3,0,1,0
1,235,235,1,1,0,1,0
3,246,246,32,23,9,2,1
12,247,247,40,16,24,4,3
7,259,259,30,12,18,3,2
0,321,321,54,54,0,1,0
15,322,322,12,12,0,1,0
4,338,338,35,14,21,4,3
17,351,351,11,11,0,1,0
10,363,363,7,7,0,1,0
5,436,436,3,3,0,1,0
2,437,437,55,8,47,2,1
13,468,468,141,51,90,3,2
14,473,473,32,6,26,2,1
16,476,476,76,76,0,1,0

5,184,184,41,1,40,3,2
2,244,244,17,3,14,2,1
8,267,267,32,32,0,1,0
12,291,291,57,57,0,1,0
7,298,298,25,25,0,1,0
9,313,313,20,20,0,1,0
4,317,317,1,1,0,1,0
3,344,344,17,17,0,1,0
6,363,363,14,8,6,2,1
11,417,417,25,25,0,1,0
0,425,425,8,8,0,1,0
10,448,448,110,38,72,4,3
1,472,472,207,96,111,4,3

5,108,108,1,1,0,1,0
14,116,116,2,2,0,1,0
13,135,135,5,5,0,1,0
3,221,221,38,38,0,1,0
11,228,228,7,7,0,1,0
0,229,229,34,34,0,1,0
10,234,234,4,4,0,1,0
1,297,297,25,25,0,1,0
6,321,321,42,42,0,1,0
12,339,339,46,46,0,1,0
4,351,351,9,9,0,1,0
7,370,370,13,13,0,1,0
9,379,379,4,4,0,1,0
15,412,412,76,76,0,1,0
2,437,437,54,54,0,1,0
17,447,447,2,2,0,1,0
18,448,448,168,43,125,4,3
16,483,483,29,5,24,3,2
8,494,494,8,4,4,2,1

11,100,100,11,11,0,1,0
6,129,129,1,1,0,1,0
4,133,133,5,5,0,1,0
5,170,170,15,15,0,1,0
10,198,198,31,21,10,2,1
15,246,246,107,74,33,4,3
8,278,278,60,60,0,1,0
7,279,279,12,12,0,1,0
14,291,291,4,4,0,1,0
12,322,322,17,17,0,1,0
1,338,338,21,21,0,1,0
3,392,392,21,5,16,2,1
13,422,422,19,19,0,1,0
9,452,452,1,1,0,1,0
0,453,453,108,99,9,4,3
2,497,497,27,14,13,2,1

8,163,163,17,5,12,2,1
4,167,167,14,14,0,1,0
6,176,176,1,1,0,1,0
3,208,208,6,6,0,1,0
11,228,228,4,4,0,1,0
0,232,232,7,1,6,3,2
7,241,241,74,74,0,1,0
1,259,259,165,87,78,4,3
5,300,300,20,1,19,3,2
2,392,392,9,9,0,1,0
9,440,440,84,15,69,3,2
10,453,453,55,21,34,2,1

2,107,107,7,3,4,2,1
9,191,191,15,2,13,2,1
0,247,247,33,33,0,1,0
15,298,298,25,25,0,1,0
1,320,320,5,5,0,1,0
14,327,327,1,1,0,1,0
6,385,385,54,54,0,1,0
7,394,394,12,3,9,4,3
5,400,400,54,24,30,4,3
4,401,401,80,8,72,3,2
12,403,403,49,22,27,4,3
8,426,426,14,14,0,1,0
3,429,429,21,21,0,1,0
13,436,436,92,92,0,1,0
11,453,453,11,11,0,1,0
10,455,455,131,131,0,1,0

12,109,109,9,9,0,1,0
2,116,116,32,32,0,1,0
0,130,130,2,2,0,1,0
14,178,178,21,21,0,1,0
15,190,190,2,2,0,1,0
13,207,207,25,25,0,1,0
16,217,217,15,15,0,1,0
10,228,228,2,2,0,1,0
1,230,230,30,14,16,3,2
6,270,270,2,2,0,1,0
8,278,278,6,3,3,2,1
3,347,347,11,4,7,2,1
11,358,358,40,26,14,3,2
5,390,390,1,1,0,1,0
7,408,408,44,44,0,1,0
4,470,470,4,4,0,1,0
17,473,473,145,145,0,1,0
9,484,484,94,1,93,4,3

20,109,109,4,4,0,1,0
4,113,113,2,2,0,1,0
15,127,127,1,1,0,1,0
11,158,158,5,5,0,1,0
13,182,182,15,3,12,2,1
10,211,211,25,25,0,1,0
12,215,215,13,13,0,1,0
19,228,228,47,47,0,1,0
3,241,241,15,7,8,3,2
0,262,262,3,3,0,1,0
2,309,309,6,6,0,1,0
18,312,312,6,6,0,1,0
14,329,329,42,42,0,1,0
17,337,337,6,6,0,1,0
21,339,339,9,9,0,1,0
5,358,358,1,1,0,1,0
1,367,367,21,21,0,1,0
16,395,395,51,37,14,2,1
8,415,415,56,56,0,1,0
6,415,415,5,5,0,1,0
22,446,446,170,170,0,1,0
9,458,458,2,2,0,1,0
7,486,486,26,26,0,1,0

11,104,104,1,1,0,1,0
9,139,139,20,6,14,2,1
19,144,144,21,21,0,1,0
14,150,150,1,1,0,1,0
16,155,155,8,2,6,2,1
12,158,158,9,9,0,1,0
7,185,185,3,3,0,1,0
18,195,195,8,8,0,1,0
2,196,196,6,6,0,1,0
0,198,198,9,9,0,1,0
5,214,214,24,24,0,1,0
6,224,224,1,1,0,1,0
10,227,227,47,14,33,2,1
20,295,295,13,13,0,1,0
21,296,296,18,18,0,1,0
15,298,298,5,5,0,1,0
3,309,309,3,3,0,1,0
22,325,325,118,36,82,4,3
17,350,350,10,10,0,1,0
4,384,384,7,1,6,2,1
1,416,416,5,5,0,1,0
13,436,436,11,3,8,2,1
23,479,479,62,4,58,3,2
8,496,496,18,18,0,1,0

5,119,119,1,1,0,1,0
6,168,168,6,6,0,1,0
4,246,246,62,62,0,1,0
16,247,247,6,6,0,1,0
10,247,247,1,1,0,1,0
8,249,249,33,33,0,1,0
15,272,272,87,68,19,3,2
3,290,290,48,38,10,2,1
9,294,294,7,7,0,1,0
7,339,339,27,27,0,1,0
2,389,389,10,10,0,1,0
14,398,398,38,22,16,2,1
0,402,402,2,2,0,1,0
13,444,444,66,1,65,3,2
11,468,468,3,3,0,1,0
1,473,473,34,26,8,3,2
12,489,489,104,43,61,4,3

14,102,102,20,20,0,1,0
13,108,108,13,13,0,1,0
4,121,121,3,3,0,1,0
10,129,129,1,1,0,1,0
3,173,173,68,68,0,1,0
8,227,227,46,16,30,2,1
12,227,227,67,67,0,1,0
0,266,266,1,1,0,1,0
6,282,282,13,9,4,2,1
15,308,308,19,19,0,1,0
5,311,311,3,3,0,1,0
11,331,331,34,4,30,2,1
9,362,362,12,12,0,1,0
1,387,387,18,12,6,2,1
7,417,417,26,26,0,1,0
2,425,425,6,6,0,1,0

0,101,101,27,2,25,3,2
9,109,109,3,3,0,1,0
5,132,132,33,5,28,3,2
7,133,133,6,6,0,1,0
14,139,139,25,25,0,1,0
10,168,168,61,29,32,2,1
13,211,211,8,1,7,2,1
3,245,245,21,21,0,1,0
11,286,286,22,22,0,1,0
6,346,346,27,27,0,1,0
4,390,390,4,4,0,1,0
12,422,422,13,13,0,1,0
2,440,440,9,9,0,1,0
8,447,447,45,45,0,1,0
1,499,499,25,15,10,2,1

2,103,103,1,1,0,1,0
5,126,126,1,1,0,1,0
4,181,181,15,7,8,2,1
0,194,194,4,4,0,1,0
11,223,223,2,2,0,1,0
19,247,247,22,1,21,2,1
10,256,256,2,2,0,1,0
18,295,295,3,3,0,1,0
12,306,306,35,16,19,2,1
14,306,306,67,67,0,1,0
7,320,320,86,44,42,4,3
16,335,335,32,12,20,3,2
15,339,339,48,40,8,3,2
6,390,390,7,7,0,1,0
1,439,439,74,74,0,1,0
17,443,443,4,4,0,1,0
9,444,444,9,4,5,2,1
3,449,449,8,2,6,2,1
20,454,454,113,23,90,3,2
8,474,474,22,22,0,1,0
13,495,495,4,4,0,1,0

10,117,117,16,16,0,1,0
5,135,135,2,2,0,1,0
7,136,136,4,1,3,2,1
6,159,159,19,19,0,1,0
3,167,167,10,1,9,4,3
8,208,208,55,19,36,4,3
9,216,216,38,38,0,1,0
1,285,285,14,4,10,3,2
16,295,295,37,19,18,3,2
4,297,297,2,2,0,1,0
12,316,316,6,1,5,2,1
13,340,340,26,26,0,1,0
0,353,353,14,5,9,4,3
2,368,368,15,15,0,1,0
15,384,384,57,41,16,3,2
14,412,412,111,64,47,2,1
11,418,418,13,3,10,3,2

4,102,102,1,1,0,1,0
6,140,140,4,4,0,1,0
8,191,191,2,2,0,1,0
14,198,198,2,2,0,1,0
5,199,199,11,11,0,1,0
15,244,244,51,36,15,4,3
12,253,253,39,10,29,2,1
1,260,260,27,27,0,1,0
11,277,277,32,4,28,3,2
3,303,303,9,9,0,1,0
9,345,345,51,51,0,1,0
17,364,364,44,44,0,1,0
2,374,374,13,10,3,2,1
16,380,380,35,35,0,1,0
18,383,383,4,4,0,1,0
13,422,422,91,61,30,4,3
10,432,432,23,23,0,1,0
7,472,472,62,5,57,4,3
0,481,481,40,40,0,1,0

5,108,108,4,4,0,1,0
4,164,164,27,27,0,1,0
12,210,210,11,11,0,1,0
7,231,231,19,19,0,1,0
2,282,282,30,30,0,1,0
3,294,294,14,9,5,2,1
1,301,301,40,40,0,1,0
11,312,312,58,2,56,3,2
14,317,317,7,7,0,1,0
0,323,323,14,14,0,1,0
8,347,347,1,1,0,1,0
13,410,410,95,50,45,4,3
6,414,414,78,78,0,1,0
10,436,436,115,81,34,2,1
9,438,438,21,21,0,1,0

9,138,138,10,10,0,1,0
6,171,171,11,1,10,2,1
1,205,205,42,4,38,2,1
7,230,230,15,15,0,1,0
5,281,281,74,74,0,1,0
2,317,317,187,187,0,1,0
0,339,339,2,2,0,1,0
4,429,429,71,29,42,3,2
8,438,438,46,38,8,3,2
3,464,464,36,10,26,2,1

6,150,150,23,23,0,1,0
3,171,171,23,9,14,2,1
11,221,221,10,10,0,1,0
7,253,253,10,10,0,1,0
10,283,283,69,43,26,3,2
5,325,325,6,6,0,1,0
1,345,345,7,4,3,2,1
0,347,347,143,97,46,3,2
12,369,369,39,39,0,1,0
4,376,376,3,3,0,1,0
8,390,390,64,18,46,3,2
9,417,417,25,10,15,2,1
2,476,476,99,99,0,1,0

1,117,117,18,18,0,1,0
4,120,120,1,1,0,1,0
3,155,155,7,2,5,2,1
14,156,156,7,4,3,2,1
9,169,169,7,7,0,1,0
11,181,181,7,7,0,1,0
7,202,202,38,38,0,1,0
6,227,227,22,13,9,2,1
8,308,308,12,12,0,1,0
2,360,360,1,1,0,1,0
0,363,363,75,3,72,4,3
13,379,379,52,52,0,1,0
5,399,399,40,24,16,3,2
10,420,420,71,71,0,1,0
12,486,486,168,168,0,1,0

11,106,106,18,3,15,4,3
0,145,145,15,15,0,1,0
13,166,166,14,14,0,1,0
5,170,170,2,2,0,1,0
15,190,190,54,54,0,1,0
4,276,276,60,4,56,3,2
10,290,290,31,13,18,2,1
6,294,294,44,13,31,2,1
7,295,295,2,2,0,1,0
2,297,297,1,1,0,1,0
1,350,350,16,16,0,1,0
14,368,368,30,10,20,3,2
3,374,374,5,5,0,1,0
12,397,397,12,6,6,2,1
9,461,461,40,40,0,1,0
16,470,470,28,4,24,3,2
8,474,474,77,77,0,1,0

14,124,124,7,7,0,1,0
2,134,134,24,3,21,2,1
7,143,143,3,3,0,1,0
8,237,237,21,21,0,1,0
0,239,239,55,55,0,1,0
11,284,284,5,1,4,2,1
9,304,304,25,25,0,1,0
3,317,317,19,19,0,1,0
1,320,320,2,2,0,1,0
4,353,353,22,22,0,1,0
13,385,385,33,18,15,2,1
5,400,400,26,26,0,1,0
12,406,406,44,23,21,2,1
16,425,425,30,30,0,1,0
15,439,439,203,185,18,4,3
6,461,461,4,4,0,1,0
10,482,482,5,5,0,1,0

4,117,117,1,1,0,1,0
15,168,168,2,2,0,1,0
9,227,227,19,1,18,2,1
1,235,235,1,1,0,1,0
6,264,264,3,3,0,1,0
13,273,273,23,23,0,1,0
17,303,303,9,9,0,1,0
10,328,328,30,26,4,2,1
12,332,332,70,70,0,1,0
0,359,359,27,27,0,1,0
2,379,379,73,40,33,4,3
8,380,380,31,24,7,2,1
11,380,380,38,3,35,4,3
18,400,400,7,7,0,1,0
3,401,401,38,2,36,3,2
7,404,404,1,1,0,1,0
5,413,413,23,1,22,3,2
14,449,449,55,55,0,1,0
16,461,461,153,135,18,3,2

4,148,148,12,12,0,1,0
12,155,155,14,2,12,4,3
2,162,162,31,31,0,1,0
10,207,207,21,9,12,4,3
1,228,228,44,24,20,2,1
9,248,248,28,28,0,1,0
11,265,265,5,5,0,1,0
6,269,269,69,56,13,2,1
7,278,278,71,71,0,1,0
8,296,296,19,1,18,3,2
13,310,310,53,53,0,1,0
0,419,419,14,4,10,3,2
3,419,419,17,17,0,1,0
5,438,438,3,3,0,1,0

10,103,103,14,7,7,2,1
2,114,114,9,9,0,1,0
9,155,155,10,7,3,2,1
7,205,205,3,3,0,1,0
1,207,207,11,11,0,1,0
3,234,234,52,52,0,1,0
6,250,250,28,28,0,1,0
0,255,255,1,1,0,1,0
14,326,326,36,14,22,3,2
4,376,376,84,84,0,1,0
12,377,377,145,88,57,4,3
5,392,392,5,5,0,1,0
11,398,398,1,1,0,1,0
16,403,403,5,5,0,1,0
8,405,405,6,6,0,1,0
15,405,405,36,36,0,1,0
13,454,454,36,36,0,1,0

4,152,152,9,1,8,3,2
15,160,160,4,4,0,1,0
14,181,181,29,29,0,1,0
6,211,211,11,11,0,1,0
8,221,221,15,8,7,2,1
7,223,223,3,3,0,1,0
2,262,262,4,1,3,2,1
11,264,264,18,1,17,2,1
12,336,336,66,27,39,2,1
3,354,354,78,78,0,1,0
1,356,356,30,30,0,1,0
13,381,381,70,70,0,1,0
5,382,382,4,4,0,1,0
9,392,392,81,81,0,1,0
0,398,398,29,9,20,3,2
10,479,479,38,38,0,1,0
16,499,499,49,49,0,1,0

3,100,100,2,2,0,1,0
18,105,105,4,4,0,1,0
2,121,121,7,7,0,1,0
19,125,125,12,9,3,2,1
10,143,143,3,3,0,1,0
14,187,187,26,26,0,1,0
15,190,190,24,5,19,2,1
11,217,217,2,2,0,1,0
1,226,226,10,10,0,1,0
4,227,227,4,4,0,1,0
13,245,245,54,15,39,2,1
16,249,249,17,17,0,1,0
8,256,256,4,4,0,1,0
17,265,265,37,37,0,1,0
9,327,327,2,2,0,1,0
6,333,333,6,6,0,1,0
12,422,422,194,116,78,3,2
7,441,441,27,27,0,1,0
0,452,452,8,8,0,1,0
5,473,473,25,11,14,3,2

2,102,102,13,13,0,1,0
9,134,134,1,1,0,1,0
5,191,191,8,8,0,1,0
8,193,193,55,25,30,3,2
12,266,266,12,12,0,1,0
13,283,283,4,4,0,1,0
10,298,298,23,23,0,1,0
1,350,350,18,18,0,1,0
0,362,362,40,2,38,4,3
11,403,403,2,2,0,1,0
7,433,433,165,97,68,4,3
4,481,481,26,17,9,4,3
3,486,486,19,19,0,1,0
6,495,495,186,84,102,4,3

10,134,134,26,26,0,1,0
2,146,146,10,1,9,2,1
9,149,149,26,26,0,1,0
5,160,160,2,2,0,1,0
11,175,175,11,1,10,2,1
3,181,181,27,11,16,3,2
7,184,184,13,13,0,1,0
12,239,239,17,17,0,1,0
0,255,255,37,29,8,3,2
1,263,263,69,27,42,4,3
4,313,313,51,51,0,1,0
8,363,363,63,25,38,3,2
6,375,375,26,26,0,1,0

3,136,136,7,1,6,2,1
8,139,139,7,7,0,1,0
9,169,169,29,29,0,1,0
2,192,192,31,31,0,1,0
1,211,211,13,9,4,2,1
5,260,260,42,9,33,2,1
0,285,285,63,63,0,1,0
7,285,285,71,18,53,4,3
10,285,285,6,6,0,1,0
4,306,306,17,13,4,2,1
11,375,375,25,25,0,1,0
12,377,377,29,5,24,4,3
13,379,379,66,66,0,1,0
6,414,414,37,37,0,1,0

9,101,101,3,3,0,1,0
13,119,119,2,2,0,1,0
8,158,158,1,1,0,1,0
4,159,159,2,2,0,1,0
15,160,160,9,2,7,3,2
1,182,182,31,2,29,2,1
10,226,226,22,13,9,4,3
6,229,229,16,16,0,1,0
0,230,230,44,44,0,1,0
7,247,247,30,30,0,1,0
3,253,253,1,1,0,1,0
5,257,257,2,2,0,1,0
2,260,260,50,27,23,2,1
11,269,269,88,88,0,1,0
12,430,430,14,14,0,1,0
14,458,458,12,12,0,1,0
16,460,460,123,103,20,3,2

5,106,106,4,4,0,1,0
12,110,110,4,4,0,1,0
8,133,133,3,3,0,1,0
13,184,184,2,2,0,1,0
0,198,198,4,4,0,1,0
14,205,205,18,18,0,1,0
1,226,226,32,32,0,1,0
2,250,250,95,17,78,4,3
16,258,258,57,54,3,2,1
3,273,273,14,14,0,1,0
15,315,315,108,88,20,3,2
7,336,336,6,2,4,2,1
6,358,358,4,4,0,1,0
9,361,361,3,3,0,1,0
11,377,377,38,28,10,3,2
10,472,472,7,7,0,1,0
4,481,481,53,17,36,4,3

18,137,137,68,38,30,3,2
3,163,163,17,2,15,4,3
8,232,232,11,7,4,2,1
2,261,261,17,17,0,1,0
9,270,270,8,1,7,2,1
4,303,303,1,1,0,1,0
14,306,306,17,11,6,2,1
16,315,315,23,23,0,1,0
12,319,319,6,6,0,1,0
11,331,331,76,51,25,2,1
13,348,348,41,5,36,4,3
1,351,351,42,36,6,3,2
6,373,373,19,19,0,1,0
17,388,388,13,5,8,2,1
5,394,394,2,2,0,1,0
0,404,404,6,6,0,1,0
7,424,424,50,50,0,1,0
10,458,458,6,3,3,2,1
15,492,492,10,7,3,2,1

8,106,106,16,11,5,2,1
0,185,185,25,25,0,1,0
14,200,200,29,3,26,2,1
12,215,215,9,9,0,1,0
5,217,217,8,5,3,2,1
9,227,227,65,11,54,3,2
7,235,235,15,5,10,3,2
2,255,255,35,35,0,1,0
13,259,259,35,4,31,2,1
3,281,281,12,12,0,1,0
10,291,291,13,5,8,2,1
11,295,295,5,5,0,1,0
6,347,347,53,53,0,1,0
1,362,362,53,53,0,1,0
4,428,428,37,9,28,2,1

15,127,127,13,13,0,1,0
9,139,139,29,14,15,4,3
4,157,157,17,14,3,2,1
14,184,184,17,17,0,1,0
6,185,185,12,12,0,1,0
5,186,186,6,6,0,1,0
12,208,208,26,20,6,2,1
3,215,215,4,4,0,1,0
13,250,250,57,34,23,4,3
2,282,282,3,3,0,1,0
8,298,298,32,32,0,1,0
17,328,328,16,16,0,1,0
11,338,338,25,12,13,2,1
16,341,341,49,1,48,3,2
0,348,348,38,38,0,1,0
1,383,383,23,15,8,2,1
7,396,396,13,10,3,2,1
10,444,444,21,5,16,2,1

10,104,104,1,1,0,1,0
16,207,207,1,1,0,1,0
19,225,225,24,24,0,1,0
18,226,226,31,31,0,1,0
3,236,236,22,10,12,2,1
4,239,239,1,1,0,1,0
6,240,240,5,5,0,1,0
14,246,246,37,21,16,2,1
15,252,252,22,11,11,2,1
7,261,261,10,2,8,3,2
9,284,284,49,23,26,2,1
11,303,303,18,4,14,3,2
0,343,343,38,30,8,3,2
1,361,361,17,17,0,1,0
12,367,367,5,5,0,1,0
17,375,375,28,16,12,4,3
13,409,409,20,20,0,1,0
8,447,447,2,2,0,1,0
2,470,470,22,4,18,3,2
20,489,489,121,37,84,4,3
5,496,496,65,20,45,3,2

7,109,109,3,3,0,1,0
2,128,128,7,7,0,1,0
0,129,129,11,11,0,1,0
15,144,144,15,15,0,1,0
1,162,162,4,4,0,1,0
12,169,169,10,10,0,1,0
5,197,197,4,4,0,1,0
19,203,203,11,11,0,1,0
6,212,212,8,5,3,2,1
13,329,329,68,14,54,4,3
8,332,332,10,7,3,2,1
3,365,365,3,3,0,1,0
18,374,374,54,54,0,1,0
9,411,411,18,11,7,2,1
16,425,425,8,8,0,1,0
14,459,459,44,44,0,1,0
11,484,484,67,29,38,4,3
17,487,487,91,61,30,4,3
4,496,496,64,64,0,1,0
10,500,500,71,11,60,3,2

11,131,131,25,21,4,2,1
6,144,144,3,3,0,1,0
3,197,197,10,10,0,1,0
7,206,206,16,16,0,1,0
9,279,279,10,10,0,1,0
10,299,299,5,5,0,1,0
4,359,359,26,14,12,2,1
0,384,384,121,121,0,1,0
2,411,411,53,25,28,3,2
8,480,480,128,128,0,1,0
5,487,487,82,82,0,1,0
12,493,493,104,56,48,3,2
1,496,496,32,20,12,3,2

17,127,127,27,27,0,1,0
9,129,129,44,44,0,1,0
16,130,130,12,12,0,1,0
11,244,244,21,21,0,1,0
13,251,251,26,2,24,2,1
7,253,253,1,1,0,1,0
0,283,283,1,1,0,1,0
3,297,297,5,5,0,1,0
5,324,324,18,15,3,2,1
12,349,349,76,28,48,4,3
6,379,379,3,3,0,1,0
8,388,388,6,6,0,1,0
4,416,416,78,78,0,1,0
15,416,416,9,3,6,2,1
10,425,425,52,52,0,1,0
14,437,437,36,36,0,1,0
2,444,444,5,5,0,1,0
1,462,462,16,16,0,1,0

13,136,136,6,6,0,1,0
3,203,203,4,4,0,1,0
18,210,210,46,5,41,2,1
5,216,216,16,16,0,1,0
2,261,261,7,7,0,1,0
7,263,263,34,34,0,1,0
21,264,264,19,19,0,1,0
4,275,275,11,11,0,1,0
9,287,287,12,4,8,3,2
16,290,290,1,1,0,1,0
10,312,312,1,1,0,1,0
22,342,342,89,41,48,4,3
1,389,389,16,6,10,3,2
12,415,415,66,66,0,1,0
17,418,418,8,8,0,1,0
19,419,419,62,40,22,3,2
11,422,422,7,1,6,3,2
20,429,429,39,2,37,2,1
15,433,433,11,3,8,2,1
0,474,474,3,3,0,1,0
6,482,482,59,32,27,4,3
14,490,490,2,2,0,1,0
8,495,495,23,13,10,3,2

1,103,103,15,15,0,1,0
15,130,130,6,6,0,1,0
5,132,132,8,8,0,1,0
11,141,141,13,13,0,1,0
8,173,173,2,2,0,1,0
17,190,190,35,35,0,1,0
16,204,204,22,22,0,1,0
13,213,213,24,24,0,1,0
3,232,232,22,4,18,2,1
14,278,278,22,16,6,2,1
0,293,293,34,34,0,1,0
2,312,312,12,6,6,2,1
7,316,316,7,7,0,1,0
10,331,331,18,18,0,1,0
6,356,356,1,1,0,1,0
9,365,365,56,8,48,3,2
18,415,415,1,1,0,1,0
12,451,451,126,87,39,4,3
4,488,488,4,4,0,1,0

6,134,134,17,17,0,1,0
8,146,146,17,13,4,2,1
1,160,160,27,2,25,2,1
7,201,201,6,6,0,1,0
0,227,227,24,13,11,2,1
14,266,266,21,3,18,3,2
2,270,270,9,9,0,1,0
10,286,286,10,10,0,1,0
3,296,296,1,1,0,1,0
5,320,320,33,33,0,1,0
15,339,339,73,30,43,2,1
11,440,440,94,40,54,3,2
13,473,473,65,65,0,1,0
9,482,482,9,3,6,3,2
4,486,486,56,56,0,1,0
12,497,497,57,21,36,4,3

3,118,118,51,51,0,1,0
2,135,135,9,4,5,2,1
7,186,186,37,9,28,2,1
9,260,260,52,9,43,2,1
10,267,267,14,14,0,1,0
5,309,309,9,2,7,2,1
6,309,309,23,2,21,4,3
8,348,348,28,4,24,2,1
4,350,350,9,3,6,2,1
0,357,357,25,25,0,1,0
1,363,363,38,11,27,4,3
11,403,403,56,2,54,4,3
13,453,453,50,50,0,1,0
12,500,500,15,15,0,1,0

11,110,110,11,2,9,4,3
2,119,119,1,1,0,1,0
10,126,126,10,10,0,1,0
0,173,173,69,50,19,2,1
5,202,202,33,5,28,4,3
6,296,296,48,48,0,1,0
12,344,344,19,4,15,4,3
3,364,364,61,61,0,1,0
7,385,385,21,21,0,1,0
1,410,410,15,8,7,2,1
9,462,462,165,107,58,3,2
4,464,464,13,3,10,2,1
8,488,488,2,2,0,1,0

3,104,104,14,11,3,2,1
0,127,127,51,51,0,1,0
2,134,134,2,2,0,1,0
5,151,151,23,23,0,1,0
4,209,209,5,1,4,2,1
8,218,218,3,3,0,1,0
9,265,265,7,7,0,1,0
10,336,336,20,20,0,1,0
7,368,368,42,42,0,1,0
13,386,386,69,69,0,1,0
6,398,398,12,12,0,1,0
1,409,409,18,3,15,4,3
11,453,453,179,108,71,4,3
12,498,498,13,10,3,2,1

6,137,137,7,1,6,3,2
12,157,157,11,5,6,2,1
15,163,163,4,4,0,1,0
10,171,171,5,5,0,1,0
1,264,264,36,25,11,2,1
16,267,267,11,11,0,1,0
13,277,277,154,22,132,4,3
9,289,289,30,11,19,2,1
8,296,296,11,11,0,1,0
3,297,297,5,2,3,2,1
11,319,319,25,25,0,1,0
7,331,331,5,5,0,1,0
4,341,341,31,31,0,1,0
2,364,364,11,3,8,2,1
5,376,376,46,40,6,2,1
0,417,417,83,83,0,1,0
14,498,498,6,2,4,2,1

11,146,146,30,12,18,3,2
12,158,158,7,7,0,1,0
0,159,159,48,48,0,1,0
1,166,166,1,1,0,1,0
4,189,189,32,6,26,2,1
9,200,200,45,24,21,4,3
2,207,207,19,19,0,1,0
7,207,207,19,11,8,3,2
5,214,214,34,34,0,1,0
6,231,231,11,11,0,1,0
13,332,332,59,2,57,4,3
3,350,350,9,9,0,1,0
8,365,365,18,6,12,3,2
10,379,379,7,1,6,3,2

11,121,121,24,4,20,2,1
12,151,151,32,17,15,4,3
3,156,156,15,1,14,3,2
9,211,211,23,4,19,2,1
7,252,252,1,1,0,1,0
5,253,253,4,4,0,1,0
6,282,282,6,6,0,1,0
0,301,301,39,27,12,4,3
14,355,355,78,78,0,1,0
13,364,364,10,4,6,2,1
4,411,411,80,29,51,4,3
1,413,413,39,39,0,1,0
8,435,435,11,11,0,1,0
10,461,461,9,3,6,2,1
15,487,487,11,11,0,1,0
2,500,500,110,2,108,4,3

8,113,113,1,1,0,1,0
7,222,222,9,9,0,1,0
10,277,277,39,25,14,2,1
1,282,282,35,35,0,1,0
9,285,285,1,1,0,1,0
4,325,325,169,86,83,4,3
0,341,341,8,8,0,1,0
5,346,346,58,58,0,1,0
11,368,368,116,34,82,3,2
6,370,370,53,53,0,1,0
2,371,371,20,13,7,2,1
3,381,381,31,23,8,3,2

12,101,101,6,6,0,1,0
18,106,106,11,11,0,1,0
13,119,119,11,3,8,3,2
17,162,162,5,2,3,2,1
5,168,168,1,1,0,1,0
6,172,172,14,14,0,1,0
3,220,220,5,5,0,1,0
2,221,221,38,38,0,1,0
10,261,261,9,9,0,1,0
15,273,273,45,45,0,1,0
1,275,275,37,4,33,2,1
7,331,331,31,14,17,3,2
16,351,351,6,6,0,1,0
4,377,377,10,10,0,1,0
9,414,414,7,7,0,1,0
11,418,418,62,47,15,4,3
0,461,461,4,4,0,1,0
14,470,470,165,154,11,2,1
8,496,496,28,18,10,3,2

16,106,106,18,14,4,2,1
4,122,122,2,2,0,1,0
8,137,137,12,12,0,1,0
3,159,159,1,1,0,1,0
9,163,163,1,1,0,1,0
1,193,193,5,5,0,1,0
18,198,198,18,18,0,1,0
15,206,206,12,12,0,1,0
13,222,222,9,9,0,1,0
14,238,238,36,36,0,1,0
6,249,249,7,7,0,1,0
10,273,273,25,25,0,1,0
2,275,275,30,30,0,1,0
11,311,311,1,1,0,1,0
12,338,338,47,27,20,3,2
17,353,353,108,108,0,1,0
5,366,366,37,37,0,1,0
19,376,376,2,2,0,1,0
7,392,392,28,4,24,4,3
0,425,425,49,31,18,2,1

3,111,111,39,3,36,2,1
8,142,142,5,1,4,2,1
2,166,166,13,13,0,1,0
4,243,243,32,32,0,1,0
0,285,285,47,25,22,3,2
12,309,309,11,11,0,1,0
11,315,315,35,11,24,4,3
7,415,415,25,5,20,3,2
5,425,425,30,30,0,1,0
9,429,429,69,12,57,4,3
1,449,449,2,2,0,1,0
6,461,461,26,26,0,1,0
10,479,479,169,85,84,3,2

8,116,116,9,9,0,1,0
7,123,123,4,4,0,1,0
14,130,130,7,7,0,1,0
0,161,161,61,44,17,2,1
12,175,175,22,2,20,3,2
9,206,206,10,10,0,1,0
10,250,250,3,3,0,1,0
13,251,251,10,10,0,1,0
1,275,275,44,6,38,2,1
11,281,281,137,87,50,3,2
4,314,314,2,2,0,1,0
5,340,340,24,24,0,1,0
6,351,351,10,10,0,1,0
15,459,459,22,8,14,3,2
3,470,470,18,15,3,2,1
2,493,493,4,4,0,1,0

15,115,115,22,22,0,1,0
16,122,122,28,28,0,1,0
3,123,123,1,1,0,1,0
8,128,128,5,1,4,2,1
11,153,153,3,3,0,1,0
0,257,257,31,31,0,1,0
2,270,270,3,3,0,1,0
4,279,279,9,9,0,1,0
13,292,292,58,32,26,2,1
10,293,293,26,16,10,3,2
12,321,321,6,6,0,1,0
14,349,349,31,31,0,1,0
6,356,356,72,22,50,2,1
7,366,366,65,14,51,4,3
1,389,389,36,36,0,1,0
9,397,397,1,1,0,1,0
17,463,463,35,11,24,2,1
5,487,487,13,13,0,1,0

14,172,172,10,1,9,4,3
9,200,200,31,19,12,4,3
12,203,203,20,20,0,1,0
2,239,239,33,19,14,2,1
5,247,247,12,12,0,1,0
6,254,254,23,7,16,3,2
10,273,273,21,2,19,2,1
13,295,295,82,49,33,4,3
4,345,345,94,76,18,4,3
3,379,379,17,17,0,1,0
7,405,405,7,7,0,1,0
1,408,408,9,9,0,1,0
0,454,454,27,9,18,4,3
15,461,461,17,11,6,3,2
8,469,469,51,25,26,3,2
11,486,486,52,52,0,1,0

2,119,119,13,13,0,1,0
16,128,128,13,13,0,1,0
1,150,150,19,12,7,2,1
4,177,177,27,4,23,2,1
17,188,188,6,6,0,1,0
13,245,245,45,45,0,1,0
14,269,269,23,19,4,2,1
18,293,293,11,11,0,1,0
15,302,302,21,21,0,1,0
10,308,308,21,21,0,1,0
6,312,312,34,26,8,3,2
5,321,321,11,11,0,1,0
12,338,338,104,94,10,3,2
11,342,342,3,3,0,1,0
0,349,349,1,1,0,1,0
9,369,369,22,3,19,2,1
8,439,439,25,25,0,1,0
7,473,473,17,5,12,4,3
3,487,487,18,6,12,3,2

0,110,110,30,30,0,1,0
8,126,126,1,1,0,1,0
3,127,127,8,8,0,1,0
11,150,150,34,34,0,1,0
9,191,191,14,3,11,2,1
13,209,209,44,44,0,1,0
10,244,244,9,3,6,3,2
14,249,249,27,3,24,4,3
5,275,275,1,1,0,1,0
7,289,289,14,2,12,3,2
1,307,307,74,74,0,1,0
6,373,373,12,12,0,1,0
2,422,422,29,29,0,1,0
4,440,440,31,11,20,2,1
12,483,483,74,62,12,4,3

13,202,202,6,6,0,1,0
9,209,209,8,8,0,1,0
0,220,220,14,14,0,1,0
12,226,226,5,5,0,1,0
2,233,233,1,1,0,1,0
10,255,255,77,69,8,2,1
16,264,264,85,50,35,2,1
6,313,313,58,58,0,1,0
14,315,315,5,5,0,1,0
3,329,329,8,4,4,2,1
8,339,339,5,1,4,2,1
1,352,352,11,11,0,1,0
15,398,398,22,22,0,1,0
11,416,416,28,7,21,2,1
7,419,419,125,125,0,1,0
4,473,473,2,2,0,1,0
5,488,488,67,67,0,1,0

5,100,100,3,3,0,1,0
14,129,129,27,17,10,2,1
4,149,149,20,10,10,3,2
9,153,153,12,12,0,1,0
19,158,158,18,18,0,1,0
10,164,164,3,3,0,1,0
8,173,173,6,2,4,2,1
13,180,180,1,1,0,1,0
0,188,188,6,3,3,2,1
12,195,195,13,13,0,1,0
2,203,203,27,27,0,1,0
16,224,224,28,22,6,2,1
18,303,303,22,4,18,3,2
1,307,307,18,18,0,1,0
6,346,346,47,10,37,2,1
3,377,377,1,1,0,1,0
7,389,389,5,5,0,1,0
20,433,433,5,2,3,2,1
17,450,450,90,90,0,1,0
15,452,452,38,16,22,3,2
11,464,464,29,10,19,3,2

11,145,145,52,52,0,1,0
6,149,149,17,17,0,1,0
10,225,225,8,4,4,2,1
5,285,285,8,2,6,3,2
1,294,294,25,20,5,2,1
9,324,324,6,6,0,1,0
2,358,358,7,7,0,1,0
8,360,360,92,80,12,4,3
3,376,376,16,16,0,1,0
7,435,435,1,1,0,1,0
0,449,449,74,28,46,4,3
4,486,486,238,186,52,3,2

0,145,145,5,5,0,1,0
11,194,194,39,30,9,2,1
9,213,213,9,3,6,3,2
3,214,214,13,13,0,1,0
4,231,231,81,81,0,1,0
1,234,234,65,65,0,1,0
5,236,236,1,1,0,1,0
6,268,268,10,10,0,1,0
10,274,274,6,6,0,1,0
2,311,311,11,3,8,3,2
8,378,378,108,103,5,2,1
13,465,465,57,57,0,1,0
7,467,467,51,51,0,1,0
12,472,472,12,12,0,1,0

5,138,138,11,3,8,3,2
15,192,192,42,2,40,2,1
2,199,199,4,4,0,1,0
13,245,245,4,1,3,2,1
12,260,260,17,17,0,1,0
3,286,286,33,33,0,1,0
4,288,288,15,1,14,4,3
11,288,288,6,3,3,2,1
1,312,312,23,23,0,1,0
0,334,334,44,10,34,3,2
7,355,355,11,11,0,1,0
10,363,363,166,124,42,4,3
9,477,477,31,31,0,1,0
16,481,481,3,3,0,1,0
8,487,487,34,7,27,4,3
14,492,492,12,12,0,1,0
6,500,500,81,81,0,1,0

15,101,101,6,6,0,1,0
1,125,125,9,9,0,1,0
4,144,144,2,2,0,1,0
0,203,203,49,2,47,2,1
6,209,209,2,2,0,1,0
3,246,246,23,23,0,1,0
14,246,246,11,11,0,1,0
11,269,269,6,6,0,1,0
9,272,272,1,1,0,1,0
13,280,280,83,33,50,2,1
8,329,329,12,12,0,1,0
10,378,378,40,40,0,1,0
17,416,416,38,38,0,1,0
12,432,432,8,1,7,2,1
5,439,439,33,33,0,1,0
2,475,475,6,6,0,1,0
16,486,486,137,122,15,3,2
7,495,495,68,23,45,2,1

0,112,112,14,11,3,2,1
7,143,143,14,8,6,3,2
8,194,194,43,43,0,1,0
2,208,208,42,2,40,3,2
5,237,237,4,4,0,1,0
9,297,297,5,5,0,1,0
3,299,299,92,92,0,1,0
4,342,342,7,7,0,1,0
6,345,345,73,15,58,3,2
10,418,418,100,90,10,3,2
1,432,432,63,63,0,1,0
11,495,495,5,2,3,2,1

14,122,122,2,2,0,1,0
18,123,123,4,4,0,1,0
13,135,135,8,8,0,1,0
15,136,136,8,4,4,2,1
17,140,140,40,40,0,1,0
8,151,151,1,1,0,1,0
11,170,170,7,4,3,2,1
9,178,178,14,14,0,1,0
6,188,188,1,1,0,1,0
12,241,241,45,45,0,1,0
5,259,259,16,5,11,2,1
0,260,260,22,22,0,1,0
4,278,278,33,33,0,1,0
10,278,278,12,12,0,1,0
1,330,330,6,6,0,1,0
3,353,353,9,3,6,2,1
7,360,360,2,2,0,1,0
20,387,387,39,39,0,1,0
19,413,413,118,22,96,4,3
16,433,433,17,11,6,2,1
2,497,497,34,34,0,1,0

1,144,144,4,4,0,1,0
4,183,183,6,6,0,1,0
18,184,184,14,14,0,1,0
21,196,196,31,31,0,1,0
12,242,242,5,2,3,2,1
16,256,256,32,5,27,4,3
7,257,257,5,5,0,1,0
20,258,258,47,47,0,1,0
10,261,261,6,6,0,1,0
5,273,273,1,1,0,1,0
9,333,333,52,49,3,2,1
2,339,339,1,1,0,1,0
19,341,341,42,3,39,4,3
15,346,346,17,17,0,1,0
14,354,354,30,8,22,3,2
17,413,413,41,41,0,1,0
0,433,433,17,17,0,1,0
11,441,441,31,11,20,2,1
6,455,455,48,7,41,3,2
8,485,485,21,21,0,1,0
3,486,486,66,30,36,2,1
13,497,497,18,8,10,3,2

12,124,124,2,2,0,1,0
2,145,145,5,5,0,1,0
7,165,165,43,34,9,2,1
8,167,167,2,2,0,1,0
13,180,180,5,5,0,1,0
3,203,203,24,2,22,2,1
10,219,219,11,11,0,1,0
1,239,239,65,65,0,1,0
9,292,292,121,59,62,3,2
11,317,317,13,13,0,1,0
5,392,392,23,23,0,1,0
0,460,460,9,9,0,1,0
4,475,475,56,56,0,1,0
6,491,491,88,88,0,1,0

8,113,113,4,4,0,1,0
12,136,136,16,16,0,1,0
6,147,147,9,9,0,1,0
4,184,184,10,7,3,2,1
7,213,213,12,12,0,1,0
3,275,275,105,72,33,4,3
11,282,282,3,3,0,1,0
5,310,310,45,17,28,2,1
1,321,321,21,9,12,4,3
10,364,364,61,2,59,4,3
13,400,400,90,66,24,4,3
0,415,415,8,1,7,2,1
9,425,425,86,86,0,1,0
2,447,447,33,33,0,1,0

6,155,155,4,4,0,1,0
2,185,185,1,1,0,1,0
12,201,201,25,9,16,2,1
4,204,204,45,3,42,3,2
3,243,243,34,2,32,3,2
1,275,275,90,12,78,3,2
0,303,303,1,1,0,1,0
5,357,357,37,37,0,1,0
8,386,386,77,77,0,1,0
7,416,416,5,5,0,1,0
11,437,437,4,4,0,1,0
9,440,440,175,175,0,1,0
10,481,481,18,18,0,1,0

17,110,110,22,22,0,1,0
13,114,114,6,3,3,2,1
0,120,120,6,6,0,1,0
15,135,135,3,3,0,1,0
10,138,138,4,4,0,1,0
21,165,165,3,3,0,1,0
22,195,195,23,23,0,1,0
18,240,240,82,82,0,1,0
4,268,268,11,11,0,1,0
11,282,282,34,12,22,3,2
2,291,291,3,3,0,1,0
19,313,313,31,7,24,3,2
12,330,330,25,4,21,2,1
5,332,332,22,22,0,1,0
7,358,358,19,1,18,3,2
1,366,366,11,11,0,1,0
6,400,400,21,21,0,1,0
8,401,401,34,34,0,1,0
16,407,407,10,1,9,2,1
14,410,410,3,3,0,1,0
20,422,422,5,5,0,1,0
9,468,468,45,45,0,1,0
3,479,479,5,5,0,1,0

5,108,108,15,9,6,2,1
6,115,115,3,3,0,1,0
8,176,176,22,1,21,2,1
4,179,179,8,2,6,3,2
3,181,181,12,12,0,1,0
9,181,181,12,12,0,1,0
7,201,201,16,7,9,4,3
12,201,201,7,7,0,1,0
13,207,207,8,2,6,3,2
14,287,287,1,1,0,1,0
0,301,301,38,17,21,4,3
1,316,316,83,68,15,4,3
10,366,366,186,142,44,2,1
2,375,375,21,5,16,2,1
11,492,492,18,18,0,1,0

7,115,115,24,24,0,1,0
13,127,127,16,6,10,3,2
5,173,173,13,13,0,1,0
15,173,173,30,6,24,3,2
8,228,228,1,1,0,1,0
12,248,248,54,27,27,4,3
1,265,265,17,8,9,4,3
11,295,295,8,8,0,1,0
3,329,329,75,75,0,1,0
14,352,352,4,1,3,2,1
10,355,355,33,15,18,3,2
6,426,426,7,7,0,1,0
9,440,440,72,44,28,2,1
0,441,441,4,4,0,1,0
4,451,451,72,72,0,1,0
2,462,462,16,16,0,1,0

7,172,172,16,8,8,3,2
4,196,196,2,2,0,1,0
8,225,225,30,1,29,2,1
15,233,233,26,8,18,3,2
1,258,258,1,1,0,1,0
2,271,271,16,5,11,3,2
5,296,296,5,2,3,2,1
6,310,310,66,66,0,1,0
13,319,319,27,18,9,2,1
11,324,324,33,15,18,3,2
10,330,330,17,17,0,1,0
14,339,339,10,10,0,1,0
12,413,413,101,68,33,2,1
3,461,461,20,20,0,1,0
0,475,475,108,77,31,3,2
9,499,499,92,92,0,1,0

11,119,119,13,5,8,2,1
10,196,196,46,28,18,4,3
12,238,238,78,78,0,1,0
5,245,245,11,3,8,2,1
13,254,254,2,2,0,1,0
6,275,275,13,13,0,1,0
4,278,278,2,2,0,1,0
9,285,285,6,6,0,1,0
14,290,290,14,14,0,1,0
1,295,295,1,1,0,1,0
15,316,316,21,21,0,1,0
2,360,360,30,30,0,1,0
3,389,389,28,10,18,2,1
0,397,397,75,75,0,1,0
7,450,450,74,74,0,1,0
8,461,461,87,35,52,4,3

7,121,121,5,5,0,1,0
0,144,144,3,3,0,1,0
1,147,147,51,51,0,1,0
6,157,157,13,13,0,1,0
10,193,193,99,23,76,3,2
12,199,199,1,1,0,1,0
13,286,286,13,13,0,1,0
8,323,323,1,1,0,1,0
11,323,323,20,2,18,4,3
4,400,400,8,8,0,1,0
5,416,416,35,27,8,3,2
3,460,460,54,54,0,1,0
2,468,468,61,23,38,4,3
9,494,494,70,59,11,2,1

5,135,135,8,8,0,1,0
9,148,148,4,4,0,1,0
10,153,153,59,20,39,2,1
3,202,202,1,1,0,1,0
11,273,273,26,5,21,2,1
1,339,339,31,12,19,2,1
4,362,362,99,57,42,4,3
8,370,370,33,33,0,1,0
0,417,417,14,4,10,3,2
12,456,456,18,4,14,3,2
7,478,478,46,37,9,4,3
6,481,481,38,38,0,1,0
2,500,500,171,66,105,4,3

19,110,110,10,1,9,2,1
17,121,121,7,7,0,1,0
4,135,135,1,1,0,1,0
18,153,153,71,71,0,1,0
11,162,162,1,1,0,1,0
7,171,171,41,41,0,1,0
13,172,172,4,4,0,1,0
21,185,185,7,7,0,1,0
0,191,191,4,4,0,1,0
16,197,197,14,9,5,2,1
5,245,245,7,1,6,2,1
6,287,287,2,2,0,1,0
12,291,291,36,7,29,2,1
10,324,324,21,6,15,2,1
8,343,343,8,8,0,1,0
15,368,368,6,6,0,1,0
2,404,404,27,27,0,1,0
14,409,409,11,11,0,1,0
9,412,412,15,15,0,1,0
20,418,418,34,34,0,1,0
1,423,423,25,25,0,1,0
3,452,452,30,30,0,1,0

5,167,167,1,1,0,1,0
4,180,180,6,6,0,1,0
2,182,182,13,13,0,1,0
7,239,239,1,1,0,1,0
12,240,240,55,55,0,1,0
0,247,247,47,47,0,1,0
1,271,271,55,55,0,1,0
16,332,332,52,2,50,2,1
10,336,336,11,11,0,1,0
9,362,362,2,2,0,1,0
6,411,411,1,1,0,1,0
14,422,422,83,11,72,3,2
3,443,443,85,45,40,2,1
8,448,448,42,42,0,1,0
15,452,452,32,32,0,1,0
11,455,455,5,2,3,2,1
13,495,495,55,41,14,3,2

7,153,153,4,4,0,1,0
4,162,162,10,4,6,3,2
6,190,190,68,44,24,2,1
9,203,203,48,48,0,1,0
1,226,226,31,7,24,3,2
3,287,287,8,1,7,2,1
10,309,309,25,17,8,2,1
5,314,314,68,40,28,3,2
2,330,330,46,46,0,1,0
12,339,339,18,18,0,1,0
11,379,379,6,6,0,1,0
8,388,388,18,18,0,1,0
0,403,403,88,88,0,1,0

9,120,120,4,4,0,1,0
1,148,148,3,3,0,1,0
3,181,181,16,7,9,4,3
6,225,225,1,1,0,1,0
14,243,243,2,2,0,1,0
13,245,245,11,11,0,1,0
19,282,282,77,62,15,4,3
4,309,309,34,1,33,4,3
2,313,313,37,20,17,2,1
10,325,325,27,27,0,1,0
15,341,341,14,1,13,2,1
18,345,345,19,19,0,1,0
5,346,346,22,22,0,1,0
8,346,346,11,4,7,2,1
12,354,354,13,9,4,2,1
16,373,373,81,9,72,3,2
0,389,389,22,22,0,1,0
7,389,389,24,24,0,1,0
11,439,439,41,11,30,4,3
17,478,478,82,42,40,3,2

12,102,102,9,9,0,1,0
16,111,111,8,8,0,1,0
4,127,127,16,7,9,2,1
6,224,224,17,7,10,3,2
0,227,227,25,18,7,2,1
5,239,239,3,3,0,1,0
14,241,241,10,1,9,2,1
15,246,246,27,27,0,1,0
10,306,306,55,55,0,1,0
1,347,347,21,21,0,1,0
11,402,402,107,32,75,4,3
13,403,403,24,3,21,2,1
7,439,439,55,25,30,2,1
3,442,442,58,58,0,1,0
2,444,444,12,8,4,2,1
8,474,474,49,49,0,1,0
9,484,484,14,4,10,2,1

9,154,154,8,8,0,1,0
11,162,162,14,4,10,3,2
10,200,200,3,3,0,1,0
8,203,203,30,5,25,2,1
0,207,207,12,12,0,1,0
7,240,240,43,13,30,2,1
14,249,249,32,2,30,3,2
4,275,275,16,16,0,1,0
1,296,296,24,24,0,1,0
2,306,306,41,41,0,1,0
13,312,312,5,5,0,1,0
3,350,350,32,32,0,1,0
6,436,436,73,33,40,2,1
12,488,488,184,67,117,4,3
5,490,490,17,17,0,1,0

10,110,110,3,3,0,1,0
8,114,114,28,4,24,3,2
6,230,230,8,8,0,1,0
7,243,243,51,51,0,1,0
2,247,247,21,7,14,3,2
11,265,265,14,14,0,1,0
4,417,417,1,1,0,1,0
13,436,436,28,28,0,1,0
5,451,451,126,66,60,4,3
12,471,471,65,65,0,1,0
0,474,474,37,37,0,1,0
9,475,475,35,7,28,3,2
1,489,489,124,31,93,4,3
3,498,498,34,34,0,1,0

4,109,109,1,1,0,1,0
6,123,123,4,4,0,1,0
15,155,155,19,10,9,2,1
16,164,164,9,1,8,2,1
5,183,183,61,35,26,3,2
3,190,190,40,19,21,2,1
1,202,202,4,4,0,1,0
10,225,225,22,22,0,1,0
13,307,307,85,67,18,3,2
9,311,311,4,4,0,1,0
7,314,314,19,15,4,2,1
12,342,342,29,23,6,2,1
2,387,387,23,23,0,1,0
8,412,412,25,8,17,2,1
0,422,422,1,1,0,1,0
11,461,461,48,48,0,1,0
14,471,471,32,32,0,1,0

3,115,115,12,6,6,3,2
10,125,125,8,8,0,1,0
0,128,128,3,3,0,1,0
12,138,138,50,17,33,4,3
4,189,189,7,1,6,3,2
8,192,192,12,12,0,1,0
16,193,193,35,3,32,3,2
7,283,283,20,20,0,1,0
1,290,290,4,4,0,1,0
15,291,291,24,24,0,1,0
2,317,317,28,28,0,1,0
6,400,400,86,59,27,4,3
5,400,400,47,47,0,1,0
13,401,401,27,27,0,1,0
11,420,420,14,2,12,2,1
17,443,443,31,31,0,1,0
14,458,458,7,7,0,1,0
9,477,477,2,2,0,1,0

6,165,165,88,88,0,1,0
8,196,196,1,1,0,1,0
5,207,207,26,18,8,2,1
0,213,213,6,3,3,2,1
9,242,242,17,17,0,1,0
11,268,268,11,7,4,2,1
4,273,273,61,61,0,1,0
1,327,327,36,22,14,3,2
3,376,376,103,43,60,4,3
12,407,407,29,29,0,1,0
10,420,420,32,32,0,1,0
7,468,468,8,4,4,2,1
2,488,488,20,20,0,1,0

12,149,149,1,1,0,1,0
5,150,150,12,12,0,1,0
7,198,198,4,4,0,1,0
4,215,215,29,29,0,1,0
10,233,233,17,10,7,2,1
0,307,307,33,25,8,3,2
1,316,316,39,39,0,1,0
2,336,336,44,23,21,4,3
9,340,340,7,1,6,2,1
3,368,368,6,6,0,1,0
11,369,369,95,5,90,3,2
14,424,424,54,54,0,1,0
6,451,451,85,40,45,4,3
8,465,465,129,129,0,1,0
13,486,486,24,24,0,1,0

5,103,103,1,1,0,1,0
24,116,116,1,1,0,1,0
3,128,128,7,7,0,1,0
1,132,132,5,5,0,1,0
17,199,199,10,4,6,2,1
13,224,224,14,14,0,1,0
14,240,240,11,11,0,1,0
22,249,249,33,9,24,3,2
20,266,266,6,2,4,2,1
21,298,298,80,42,38,3,2
11,304,304,14,14,0,1,0
0,321,321,51,21,30,3,2
23,339,339,23,23,0,1,0
16,342,342,16,7,9,2,1
2,371,371,12,5,7,2,1
6,380,380,9,9,0,1,0
18,389,389,63,10,53,4,3
15,392,392,23,12,11,2,1
9,395,395,20,20,0,1,0
19,397,397,58,4,54,3,2
12,453,453,4,1,3,2,1
10,458,458,38,16,22,2,1
4,469,469,2,2,0,1,0
7,469,469,4,4,0,1,0
8,471,471,10,4,6,3,2

16,158,158,4,4,0,1,0
14,184,184,20,20,0,1,0
5,212,212,7,1,6,2,1
17,229,229,49,49,0,1,0
8,246,246,15,1,14,2,1
2,289,289,10,2,8,3,2
18,308,308,18,6,12,3,2
12,316,316,28,18,10,2,1
11,343,343,27,6,21,4,3
6,363,363,11,3,8,3,2
7,378,378,1,1,0,1,0
15,390,390,83,83,0,1,0
3,396,396,17,17,0,1,0
9,407,407,17,9,8,2,1
10,450,450,85,1,84,4,3
0,454,454,60,60,0,1,0
13,475,475,52,52,0,1,0
1,476,476,60,45,15,2,1
4,492,492,15,3,12,3,2

1,153,153,15,1,14,3,2
5,162,162,35,35,0,1,0
8,166,166,4,4,0,1,0
13,170,170,32,26,6,2,1
7,171,171,3,3,0,1,0
12,180,180,9,9,0,1,0
0,208,208,20,14,6,3,2
4,249,249,6,6,0,1,0
9,261,261,58,17,41,2,1
2,281,281,26,16,10,3,2
15,316,316,39,39,0,1,0
14,317,317,22,22,0,1,0
6,363,363,14,14,0,1,0
3,428,428,84,59,25,3,2
10,462,462,71,38,33,2,1
11,470,470,1,1,0,1,0

7,135,135,11,2,9,2,1
20,142,142,7,1,6,3,2
0,154,154,4,4,0,1,0
16,164,164,6,6,0,1,0
9,193,193,1,1,0,1,0
18,201,201,31,21,10,2,1
6,208,208,31,11,20,3,2
10,221,221,1,1,0,1,0
1,228,228,26,22,4,2,1
12,242,242,17,5,12,2,1
15,260,260,37,37,0,1,0
8,260,260,1,1,0,1,0
2,278,278,8,8,0,1,0
19,285,285,2,2,0,1,0
5,353,353,24,8,16,3,2
4,356,356,21,5,16,3,2
3,393,393,48,33,15,4,3
17,422,422,126,126,0,1,0
13,457,457,13,13,0,1,0
11,479,479,19,19,0,1,0
14,480,480,62,45,17,2,1

0,104,104,27,27,0,1,0
7,142,142,10,10,0,1,0
15,163,163,17,17,0,1,0
2,183,183,8,8,0,1,0
5,205,205,9,5,4,2,1
11,236,236,32,32,0,1,0
12,269,269,17,17,0,1,0
1,271,271,1,1,0,1,0
9,295,295,53,32,21,4,3
4,311,311,37,25,12,2,1
14,365,365,49,49,0,1,0
13,372,372,6,3,3,2,1
10,383,383,68,46,22,3,2
3,440,440,57,57,0,1,0
6,456,456,51,6,45,3,2
8,474,474,9,9,0,1,0

10,100,100,27,2,25,2,1
9,125,125,11,11,0,1,0
8,144,144,12,12,0,1,0
13,172,172,1,1,0,1,0
3,174,174,1,1,0,1,0
5,183,183,20,20,0,1,0
7,269,269,6,6,0,1,0
12,276,276,8,4,4,2,1
15,285,285,70,70,0,1,0
0,359,359,24,10,14,3,2
2,376,376,23,23,0,1,0
1,388,388,44,34,10,2,1
11,392,392,41,32,9,4,3
4,444,444,90,69,21,4,3
14,473,473,34,34,0,1,0
6,479,479,66,23,43,4,3

7,114,114,29,29,0,1,0
0,142,142,1,1,0,1,0
5,178,178,6,6,0,1,0
12,181,181,11,11,0,1,0
3,224,224,10,1,9,4,3
11,233,233,21,15,6,2,1
1,275,275,90,48,42,3,2
4,333,333,115,88,27,4,3
8,360,360,28,10,18,3,2
6,365,365,11,3,8,3,2
2,374,374,16,16,0,1,0
10,415,415,57,57,0,1,0
9,463,463,74,14,60,4,3

1,101,101,13,13,0,1,0
11,116,116,3,3,0,1,0
0,118,118,4,1,3,2,1
6,118,118,1,1,0,1,0
10,133,133,1,1,0,1,0
17,134,134,2,2,0,1,0
19,137,137,1,1,0,1,0
9,140,140,6,6,0,1,0
18,202,202,50,50,0,1,0
13,222,222,31,31,0,1,0
5,225,225,15,10,5,2,1
21,225,225,35,11,24,3,2
14,233,233,9,9,0,1,0
20,244,244,1,1,0,1,0
7,246,246,1,1,0,1,0
15,253,253,42,9,33,2,1
4,258,258,7,7,0,1,0
8,283,283,9,2,7,3,2
2,328,328,3,3,0,1,0
12,378,378,37,7,30,4,3
3,456,456,64,27,37,2,1
16,499,499,111,22,89,4,3

5,144,144,15,15,0,1,0
6,205,205,87,87,0,1,0
10,240,240,5,5,0,1,0
3,260,260,14,4,10,3,2
9,262,262,12,12,0,1,0
4,324,324,55,14,41,4,3
11,330,330,56,56,0,1,0
12,370,370,17,8,9,2,1
2,374,374,64,64,0,1,0
1,378,378,12,12,0,1,0
7,378,378,35,3,32,3,2
8,481,481,4,1,3,2,1
0,486,486,132,33,99,4,3

7,106,106,9,1,8,3,2
14,176,176,15,15,0,1,0
5,188,188,13,13,0,1,0
2,203,203,18,18,0,1,0
9,237,237,34,2,32,3,2
15,258,258,1,1,0,1,0
12,317,317,17,2,15,4,3
13,331,331,27,16,11,2,1
1,334,334,2,2,0,1,0
11,342,342,1,1,0,1,0
0,345,345,18,4,14,3,2
16,350,350,92,74,18,4,3
6,387,387,42,12,30,2,1
10,422,422,14,1,13,2,1
3,428,428,28,28,0,1,0
18,436,436,60,42,18,2,1
4,441,441,4,4,0,1,0
8,478,478,66,17,49,2,1
17,495,495,90,90,0,1,0

15,113,113,5,5,0,1,0
16,115,115,1,1,0,1,0
5,159,159,4,4,0,1,0
3,207,207,14,14,0,1,0
14,212,212,32,32,0,1,0
4,230,230,68,6,62,3,2
8,244,244,9,9,0,1,0
13,256,256,48,45,3,2,1
9,299,299,7,7,0,1,0
1,302,302,13,1,12,3,2
12,308,308,95,92,3,2,1
7,319,319,5,1,4,2,1
2,357,357,21,7,14,3,2
17,402,402,41,8,33,4,3
11,440,440,5,5,0,1,0
10,472,472,21,21,0,1,0
6,497,497,8,8,0,1,0
0,500,500,87,87,0,1,0

1,130,130,12,12,0,1,0
4,179,179,10,10,0,1,0
0,195,195,2,2,0,1,0
12,248,248,3,3,0,1,0
5,326,326,16,16,0,1,0
6,344,344,7,7,0,1,0
8,393,393,97,23,74,3,2
2,435,435,19,19,0,1,0
11,448,448,21,21,0,1,0
3,452,452,249,169,80,3,2
7,473,473,11,11,0,1,0
10,476,476,210,93,117,4,3
9,500,500,10,10,0,1,0

16,120,120,21,21,0,1,0
1,132,132,3,3,0,1,0
3,149,149,8,8,0,1,0
15,162,162,35,14,21,4,3
9,174,174,1,1,0,1,0
2,191,191,22,1,21,4,3
11,214,214,13,13,0,1,0
5,239,239,8,8,0,1,0
18,258,258,33,33,0,1,0
0,259,259,26,5,21,4,3
17,260,260,7,7,0,1,0
20,268,268,8,5,3,2,1
8,278,278,10,3,7,2,1
10,281,281,70,34,36,4,3
12,284,284,3,3,0,1,0
13,313,313,3,3,0,1,0
6,320,320,3,3,0,1,0
7,324,324,27,27,0,1,0
4,342,342,4,1,3,2,1
14,412,412,46,13,33,2,1
19,468,468,60,29,31,3,2

3,135,135,8,8,0,1,0
11,136,136,7,4,3,2,1
8,184,184,22,22,0,1,0
2,196,196,8,8,0,1,0
12,231,231,22,22,0,1,0
5,270,270,8,5,3,2,1
4,288,288,6,6,0,1,0
1,293,293,44,44,0,1,0
7,309,309,27,27,0,1,0
14,376,376,52,52,0,1,0
10,390,390,28,16,12,2,1
9,413,413,51,51,0,1,0
6,430,430,24,4,20,3,2
13,442,442,93,9,84,3,2
0,476,476,170,32,138,4,3

6,100,100,8,8,0,1,0
4,105,105,10,10,0,1,0
0,112,112,2,2,0,1,0
13,121,121,8,4,4,2,1
8,161,161,3,3,0,1,0
10,194,194,1,1,0,1,0
2,201,201,38,38,0,1,0
12,323,323,64,64,0,1,0
11,345,345,77,57,20,2,1
3,369,369,67,67,0,1,0
5,381,381,12,6,6,2,1
7,398,398,12,12,0,1,0
9,434,434,28,24,4,2,1
14,459,459,111,69,42,4,3
1,488,488,86,65,21,4,3

2,109,109,10,10,0,1,0
8,143,143,3,3,0,1,0
5,196,196,8,8,0,1,0
9,236,236,66,8,58,3,2
13,247,247,5,5,0,1,0
10,262,262,68,68,0,1,0
6,300,300,87,39,48,3,2
7,304,304,37,37,0,1,0
4,322,322,1,1,0,1,0
3,349,349,107,72,35,2,1
1,357,357,17,17,0,1,0
12,393,393,15,12,3,2,1
0,406,406,9,9,0,1,0
11,463,463,35,35,0,1,0

10,128,128,9,9,0,1,0
11,149,149,8,2,6,2,1
7,173,173,16,6,10,3,2
0,180,180,9,9,0,1,0
8,215,215,29,29,0,1,0
2,250,250,54,54,0,1,0
5,285,285,27,20,7,2,1
1,313,313,130,112,18,4,3
6,319,319,46,46,0,1,0
4,364,364,37,37,0,1,0
3,399,399,7,7,0,1,0
9,441,441,99,55,44,4,3

0,123,123,1,1,0,1,0
2,149,149,5,5,0,1,0
8,161,161,16,16,0,1,0
11,179,179,22,22,0,1,0
9,197,197,32,13,19,2,1
10,214,214,15,7,8,2,1
3,297,297,2,2,0,1,0
15,344,344,5,5,0,1,0
13,349,349,4,4,0,1,0
12,361,361,127,41,86,3,2
7,386,386,73,35,38,2,1
1,441,441,1,1,0,1,0
5,443,443,49,49,0,1,0
6,454,454,71,71,0,1,0
14,462,462,37,1,36,4,3
4,484,484,94,75,19,4,3

0,108,108,1,1,0,1,0
16,173,173,3,3,0,1,0
2,178,178,4,4,0,1,0
15,194,194,107,81,26,3,2
7,210,210,5,5,0,1,0
3,210,210,1,1,0,1,0
9,220,220,11,11,0,1,0
4,251,251,55,21,34,2,1
12,271,271,9,9,0,1,0
5,319,319,14,4,10,2,1
6,326,326,64,64,0,1,0
10,332,332,31,19,12,4,3
13,375,375,25,9,16,2,1
11,441,441,13,13,0,1,0
8,447,447,15,15,0,1,0
14,455,455,9,9,0,1,0
1,497,497,100,20,80,3,2

1,166,166,10,6,4,2,1
14,204,204,19,19,0,1,0
12,210,210,9,9,0,1,0
2,269,269,56,42,14,3,2
9,285,285,14,9,5,2,1
15,289,289,37,14,23,2,1
6,294,294,11,3,8,2,1
11,308,308,45,45,0,1,0
13,328,328,63,33,30,4,3
0,351,351,14,14,0,1,0
7,383,383,43,43,0,1,0
8,404,404,10,1,9,2,1
10,419,419,69,4,65,4,3
3,423,423,23,8,15,4,3
5,427,427,1,1,0,1,0
4,489,489,128,128,0,1,0

5,106,106,7,2,5,2,1
11,114,114,8,8,0,1,0
9,131,131,12,12,0,1,0
4,170,170,59,15,44,2,1
13,172,172,6,6,0,1,0
8,188,188,33,30,3,2,1
7,248,248,7,7,0,1,0
0,277,277,14,14,0,1,0
2,302,302,1,1,0,1,0
10,318,318,132,110,22,2,1
1,326,326,40,3,37,2,1
3,336,336,12,12,0,1,0
12,462,462,1,1,0,1,0
6,478,478,84,66,18,4,3

0,105,105,4,4,0,1,0
9,120,120,4,4,0,1,0
10,171,171,15,11,4,2,1
16,173,173,15,15,0,1,0
6,210,210,36,21,15,4,3
5,223,223,12,12,0,1,0
4,258,258,16,16,0,1,0
3,272,272,31,31,0,1,0
15,300,300,45,30,15,4,3
13,333,333,44,44,0,1,0
7,348,348,45,45,0,1,0
1,359,359,30,30,0,1,0
8,373,373,18,18,0,1,0
12,403,403,51,51,0,1,0
11,457,457,58,58,0,1,0
2,471,471,33,12,21,2,1
14,500,500,51,51,0,1,0

9,116,116,1,1,0,1,0
0,122,122,2,2,0,1,0
20,123,123,33,33,0,1,0
2,145,145,4,4,0,1,0
13,147,147,2,2,0,1,0
25,184,184,11,11,0,1,0
14,215,215,1,1,0,1,0
26,229,229,16,16,0,1,0
19,229,229,1,1,0,1,0
4,253,253,4,4,0,1,0
5,266,266,5,5,0,1,0
23,268,268,1,1,0,1,0
1,290,290,14,11,3,2,1
7,333,333,17,3,14,3,2
21,349,349,127,82,45,2,1
15,357,357,6,2,4,2,1
22,358,358,11,11,0,1,0
16,362,362,40,10,30,3,2
6,372,372,7,7,0,1,0
24,377,377,6,2,4,2,1
18,382,382,12,8,4,2,1
8,420,420,65,65,0,1,0
11,434,434,32,4,28,3,2
3,445,445,29,17,12,4,3
17,446,446,37,24,13,2,1
12,455,455,6,6,0,1,0
10,493,493,13,1,12,2,1

23,112,112,18,18,0,1,0
16,117,117,5,5,0,1,0
20,131,131,10,1,9,2,1
15,168,168,26,26,0,1,0
1,181,181,1,1,0,1,0
2,189,189,33,33,0,1,0
5,209,209,7,3,4,2,1
4,223,223,22,22,0,1,0
10,233,233,9,9,0,1,0
7,252,252,6,6,0,1,0
21,268,268,30,11,19,2,1
11,292,292,10,4,6,3,2
12,300,300,7,7,0,1,0
9,312,312,15,4,11,2,1
18,343,343,61,61,0,1,0
24,347,347,8,5,3,2,1
14,353,353,2,2,0,1,0
19,363,363,37,37,0,1,0
22,395,395,66,23,43,2,1
6,402,402,3,3,0,1,0
0,425,425,4,4,0,1,0
17,474,474,1,1,0,1,0
13,474,474,25,8,17,2,1
8,483,483,21,21,0,1,0
3,486,486,1,1,0,1,0

0,110,110,6,6,0,1,0
7,234,234,63,30,33,2,1
13,262,262,9,5,4,2,1
14,267,267,80,70,10,2,1
4,272,272,1,1,0,1,0
2,297,297,1,1,0,1,0
9,309,309,64,42,22,2,1
8,314,314,50,36,14,2,1
11,357,357,11,11,0,1,0
3,371,371,11,11,0,1,0
10,405,405,1,1,0,1,0
1,411,411,96,45,51,4,3
6,450,450,53,53,0,1,0
12,458,458,35,35,0,1,0
5,464,464,42,3,39,2,1

8,158,158,22,22,0,1,0
2,222,222,7,3,4,2,1
11,237,237,1,1,0,1,0
9,274,274,60,47,13,2,1
12,297,297,64,40,24,2,1
7,325,325,4,4,0,1,0
3,335,335,81,56,25,2,1
4,414,414,48,48,0,1,0
6,430,430,87,87,0,1,0
5,446,446,36,36,0,1,0
0,464,464,13,13,0,1,0
10,464,464,8,8,0,1,0
1,469,469,142,106,36,3,2

6,140,140,42,42,0,1,0
0,172,172,8,8,0,1,0
5,237,237,9,9,0,1,0
3,254,254,14,14,0,1,0
1,282,282,127,127,0,1,0
8,315,315,11,5,6,2,1
10,336,336,27,12,15,3,2
2,346,346,87,60,27,4,3
4,403,403,38,34,4,2,1
9,472,472,14,14,0,1,0
7,474,474,113,29,84,3,2

11,184,184,24,3,21,2,1
1,192,192,9,9,0,1,0
0,237,237,28,28,0,1,0
6,264,264,14,2,12,4,3
3,280,280,175,139,36,4,3
8,288,288,10,5,5,2,1
9,294,294,3,3,0,1,0
7,309,309,139,92,47,2,1
2,327,327,1,1,0,1,0
4,447,447,4,4,0,1,0
10,458,458,53,29,24,2,1
5,478,478,10,4,6,3,2

1,121,121,1,1,0,1,0
17,135,135,5,2,3,2,1
9,136,136,2,2,0,1,0
10,168,168,13,5,8,3,2
12,194,194,12,12,0,1,0
7,197,197,19,10,9,2,1
0,244,244,3,3,0,1,0
4,306,306,16,7,9,4,3
8,312,312,4,4,0,1,0
5,336,336,62,62,0,1,0
14,353,353,28,28,0,1,0
2,361,361,1,1,0,1,0
18,390,390,127,10,117,4,3
11,429,429,22,22,0,1,0
6,429,429,14,14,0,1,0
16,435,435,87,6,81,4,3
15,442,442,17,1,16,2,1
13,451,451,32,11,21,4,3
3,456,456,117,60,57,4,3

11,138,138,4,4,0,1,0
1,170,170,1,1,0,1,0
4,175,175,35,17,18,2,1
6,211,211,6,3,3,2,1
0,214,214,39,39,0,1,0
5,226,226,31,31,0,1,0
7,304,304,29,6,23,2,1
9,306,306,87,31,56,4,3
8,311,311,67,67,0,1,0
3,313,313,23,9,14,2,1
2,393,393,135,135,0,1,0
10,452,452,12,12,0,1,0

16,103,103,1,1,0,1,0
9,109,109,6,2,4,2,1
17,111,111,19,19,0,1,0
7,135,135,33,33,0,1,0
10,141,141,6,6,0,1,0
19,178,178,9,9,0,1,0
6,207,207,10,10,0,1,0
5,241,241,15,15,0,1,0
2,318,318,6,6,0,1,0
13,322,322,100,100,0,1,0
1,327,327,13,13,0,1,0
12,372,372,45,45,0,1,0
0,378,378,14,8,6,2,1
11,389,389,8,8,0,1,0
14,449,449,7,7,0,1,0
18,462,462,36,36,0,1,0
8,467,467,19,19,0,1,0
4,474,474,5,5,0,1,0
15,484,484,92,17,75,4,3
3,489,489,30,25,5,2,1

11,105,105,4,4,0,1,0
0,142,142,27,27,0,1,0
13,192,192,28,2,26,3,2
3,196,196,18,10,8,3,2
7,216,216,7,7,0,1,0
1,219,219,5,5,0,1,0
4,250,250,32,32,0,1,0
5,261,261,30,5,25,4,3
10,292,292,80,36,44,2,1
6,313,313,9,9,0,1,0
9,313,313,87,5,82,3,2
14,343,343,13,1,12,3,2
2,361,361,69,12,57,4,3
12,428,428,5,1,4,2,1
8,499,499,15,15,0,1,0

1,128,128,9,1,8,2,1
14,182,182,40,40,0,1,0
12,215,215,13,3,10,3,2
16,260,260,18,18,0,1,0
0,269,269,21,10,11,2,1
5,276,276,1,1,0,1,0
4,298,298,63,39,24,3,2
15,360,360,10,1,9,4,3
11,365,365,92,12,80,3,2
9,366,366,63,42,21,4,3
6,379,379,18,6,12,3,2
8,407,407,16,8,8,2,1
3,424,424,8,8,0,1,0
13,431,431,26,26,0,1,0
10,435,435,54,54,0,1,0
7,443,443,31,3,28,2,1
2,476,476,43,43,0,1,0

7,141,141,7,1,6,3,2
5,181,181,7,1,6,3,2
2,206,206,79,10,69,4,3
6,215,215,4,4,0,1,0
8,247,247,9,9,0,1,0
3,278,278,24,24,0,1,0
0,279,279,8,8,0,1,0
1,281,281,37,11,26,3,2
11,283,283,100,91,9,4,3
12,334,334,30,6,24,3,2
10,338,338,53,53,0,1,0
4,379,379,51,51,0,1,0
9,443,443,48,48,0,1,0

2,103,103,2,2,0,1,0
5,103,103,12,12,0,1,0
20,107,107,25,12,13,2,1
4,110,110,8,3,5,2,1
12,141,141,2,2,0,1,0
19,147,147,16,2,14,3,2
0,172,172,1,1,0,1,0
13,175,175,20,14,6,3,2
6,178,178,6,6,0,1,0
18,209,209,60,10,50,2,1
16,225,225,22,22,0,1,0
1,283,283,3,3,0,1,0
9,298,298,38,38,0,1,0
8,304,304,11,11,0,1,0
3,305,305,4,1,3,2,1
14,352,352,9,9,0,1,0
7,446,446,12,2,10,2,1
17,451,451,8,8,0,1,0
15,461,461,23,23,0,1,0
10,471,471,98,46,52,4,3
11,493,493,3,3,0,1,0

18,108,108,18,15,3,2,1
2,110,110,1,1,0,1,0
3,133,133,7,7,0,1,0
8,165,165,2,2,0,1,0
21,178,178,30,30,0,1,0
17,254,254,13,4,9,4,3
7,256,256,49,17,32,4,3
15,266,266,17,3,14,3,2
11,270,270,13,13,0,1,0
6,293,293,10,7,3,2,1
22,313,313,65,11,54,4,3
0,327,327,18,8,10,2,1
9,333,333,16,16,0,1,0
20,371,371,40,1,39,2,1
16,379,379,4,1,3,2,1
14,405,405,18,18,0,1,0
5,408,408,17,8,9,4,3
10,417,417,10,10,0,1,0
12,438,438,12,12,0,1,0
4,440,440,14,2,12,2,1
1,441,441,13,7,6,3,2
23,476,476,18,18,0,1,0
13,496,496,39,36,3,2,1
19,496,496,37,37,0,1,0

8,105,105,19,11,8,3,2
2,120,120,29,11,18,2,1
14,122,122,34,1,33,4,3
5,136,136,13,7,6,2,1
7,140,140,22,7,15,4,3
9,190,190,5,5,0,1,0
6,203,203,1,1,0,1,0
3,234,234,2,2,0,1,0
12,275,275,53,19,34,2,1
0,295,295,33,33,0,1,0
4,368,368,41,16,25,2,1
1,371,371,26,26,0,1,0
11,397,397,18,18,0,1,0
10,424,424,37,21,16,3,2
13,443,443,2,2,0,1,0

4,120,120,2,2,0,1,0
7,149,149,3,3,0,1,0
10,186,186,24,1,23,2,1
8,207,207,28,1,27,4,3
6,279,279,20,14,6,3,2
9,292,292,41,41,0,1,0
0,302,302,110,71,39,2,1
1,360,360,77,20,57,4,3
5,460,460,138,117,21,4,3
2,462,462,13,6,7,2,1
3,474,474,92,83,9,4,3

14,110,110,10,10,0,1,0
15,172,172,29,5,24,2,1
16,176,176,16,16,0,1,0
0,191,191,12,12,0,1,0
7,219,219,23,23,0,1,0
19,236,236,12,12,0,1,0
1,271,271,23,3,20,3,2
8,276,276,1,1,0,1,0
2,315,315,8,8,0,1,0
13,323,323,36,36,0,1,0
11,328,328,30,12,18,3,2
18,337,337,95,68,27,4,3
9,351,351,8,8,0,1,0
12,361,361,42,42,0,1,0
5,368,368,11,2,9,3,2
20,416,416,11,11,0,1,0
17,425,425,47,47,0,1,0
10,434,434,3,3,0,1,0
6,451,451,26,14,12,2,1
4,484,484,37,10,27,3,2
3,487,487,4,4,0,1,0

9,116,116,10,10,0,1,0
8,131,131,15,5,10,2,1
5,140,140,22,7,15,4,3
10,155,155,8,1,7,2,1
1,178,178,54,22,32,2,1
11,234,234,15,1,14,4,3
2,301,301,23,8,15,2,1
3,316,316,51,51,0,1,0
4,318,318,27,27,0,1,0
6,324,324,134,74,60,3,2
7,324,324,4,4,0,1,0
0,472,472,9,9,0,1,0
12,499,499,38,14,24,4,3

1,128,128,15,15,0,1,0
2,146,146,1,1,0,1,0
8,170,170,25,1,24,4,3
0,171,171,19,19,0,1,0
4,186,186,31,31,0,1,0
3,191,191,17,9,8,3,2
13,210,210,7,2,5,2,1
10,232,232,18,18,0,1,0
6,234,234,65,65,0,1,0
11,248,248,36,36,0,1,0
5,266,266,9,9,0,1,0
7,276,276,14,14,0,1,0
9,428,428,106,50,56,4,3
12,465,465,51,43,8,3,2

4,104,104,6,6,0,1,0
3,137,137,2,2,0,1,0
13,172,172,50,34,16,3,2
2,210,210,3,3,0,1,0
8,223,223,7,4,3,2,1
12,242,242,5,5,0,1,0
6,258,258,4,4,0,1,0
0,264,264,62,46,16,3,2
10,297,297,28,24,4,2,1
11,298,298,10,10,0,1,0
1,300,300,60,11,49,2,1
9,307,307,15,4,11,2,1
14,320,320,95,95,0,1,0
5,360,360,24,24,0,1,0
7,443,443,88,14,74,3,2

6,119,119,11,11,0,1,0
14,148,148,6,6,0,1,0
13,168,168,55,10,45,4,3
12,177,177,2,2,0,1,0
5,178,178,14,2,12,2,1
2,189,189,15,15,0,1,0
4,194,194,16,16,0,1,0
11,218,218,21,21,0,1,0
15,306,306,19,19,0,1,0
1,320,320,4,4,0,1,0
9,343,343,24,2,22,2,1
0,344,344,1,1,0,1,0
8,388,388,116,79,37,4,3
3,414,414,32,8,24,2,1
7,432,432,33,33,0,1,0
10,477,477,101,101,0,1,0

3,125,125,67,52,15,3,2
10,165,165,18,4,14,2,1
1,176,176,1,1,0,1,0
5,218,218,32,32,0,1,0
11,255,255,29,29,0,1,0
0,280,280,37,31,6,2,1
6,349,349,34,34,0,1,0
9,385,385,47,13,34,2,1
4,427,427,38,38,0,1,0
8,428,428,62,32,30,4,3
7,485,485,40,13,27,2,1
2,491,491,19,19,0,1,0

2,105,105,5,5,0,1,0
13,116,116,51,51,0,1,0
15,127,127,7,7,0,1,0
9,147,147,14,9,5,2,1
10,175,175,5,5,0,1,0
1,191,191,1,1,0,1,0
3,277,277,22,22,0,1,0
5,297,297,1,1,0,1,0
8,299,299,11,1,10,3,2
6,310,310,75,75,0,1,0
12,337,337,36,8,28,2,1
14,384,384,7,7,0,1,0
7,424,424,8,8,0,1,0
0,430,430,58,17,41,2,1
16,463,463,45,1,44,2,1
11,465,465,35,25,10,3,2
4,497,497,71,71,0,1,0

13,147,147,6,6,0,1,0
9,202,202,24,24,0,1,0
1,203,203,16,16,0,1,0
3,236,236,1,1,0,1,0
19,288,288,12,12,0,1,0
17,293,293,71,21,50,2,1
18,293,293,55,55,0,1,0
10,349,349,8,8,0,1,0
0,351,351,4,1,3,2,1
14,361,361,53,14,39,4,3
16,362,362,44,44,0,1,0
5,422,422,27,27,0,1,0
4,423,423,29,19,10,3,2
6,450,450,13,2,11,2,1
15,461,461,14,14,0,1,0
11,466,466,32,32,0,1,0
2,492,492,107,107,0,1,0
8,493,493,22,14,8,2,1
7,495,495,32,32,0,1,0
12,498,498,4,1,3,2,1

11,107,107,8,8,0,1,0
3,111,111,17,4,13,4,3
7,115,115,3,3,0,1,0
10,145,145,16,3,13,2,1
15,145,145,4,4,0,1,0
2,177,177,19,1,18,2,1
0,246,246,4,4,0,1,0
14,247,247,41,41,0,1,0
9,256,256,65,23,42,3,2
5,289,289,10,4,6,2,1
6,304,304,23,23,0,1,0
4,353,353,35,35,0,1,0
8,356,356,45,28,17,2,1
12,357,357,44,44,0,1,0
13,386,386,19,4,15,2,1
1,417,417,68,68,0,1,0

4,100,100,23,12,11,2,1
14,123,123,5,5,0,1,0
8,134,134,3,3,0,1,0
16,145,145,12,8,4,2,1
13,149,149,24,19,5,2,1
2,165,165,8,5,3,2,1
10,174,174,14,14,0,1,0
0,180,180,22,22,0,1,0
9,188,188,11,11,0,1,0
7,196,196,2,2,0,1,0
6,210,210,11,11,0,1,0
5,219,219,1,1,0,1,0
1,333,333,49,25,24,3,2
12,336,336,8,8,0,1,0
15,343,343,17,14,3,2,1
3,374,374,10,10,0,1,0
11,393,393,16,5,11,2,1
17,451,451,188,165,23,2,1

7,100,100,7,7,0,1,0
12,127,127,28,25,3,2,1
4,194,194,13,13,0,1,0
9,205,205,5,5,0,1,0
10,229,229,5,5,0,1,0
11,230,230,11,4,7,2,1
0,244,244,76,58,18,2,1
5,313,313,114,114,0,1,0
3,314,314,1,1,0,1,0
2,336,336,17,17,0,1,0
1,370,370,2,2,0,1,0
6,382,382,105,85,20,3,2
8,427,427,66,48,18,3,2

0,113,113,28,28,0,1,0
5,131,131,12,12,0,1,0
14,132,132,5,5,0,1,0
1,187,187,1,1,0,1,0
6,239,239,4,4,0,1,0
10,252,252,18,18,0,1,0
12,264,264,77,8,69,4,3
2,266,266,14,6,8,3,2
7,288,288,5,5,0,1,0
8,305,305,34,25,9,4,3
16,310,310,10,1,9,4,3
4,311,311,49,49,0,1,0
15,338,338,34,34,0,1,0
13,430,430,87,21,66,3,2
11,432,432,50,50,0,1,0
17,439,439,15,15,0,1,0
3,469,469,2,2,0,1,0
9,495,495,13,13,0,1,0

2,104,104,7,7,0,1,0
11,151,151,20,12,8,2,1
13,155,155,10,2,8,2,1
14,186,186,55,55,0,1,0
6,200,200,27,27,0,1,0
7,204,204,7,7,0,1,0
15,296,296,8,8,0,1,0
3,297,297,58,7,51,4,3
8,317,317,12,12,0,1,0
12,334,334,24,13,11,2,1
16,397,397,31,31,0,1,0
1,400,400,16,16,0,1,0
5,426,426,27,27,0,1,0
9,440,440,19,19,0,1,0
10,457,457,67,50,17,4,3
4,468,468,49,31,18,3,2
0,488,488,39,39,0,1,0

7,151,151,3,3,0,1,0
14,153,153,17,17,0,1,0
8,178,178,20,8,12,4,3
1,200,200,37,16,21,4,3
12,224,224,23,1,22,3,2
16,247,247,26,26,0,1,0
10,251,251,4,4,0,1,0
3,254,254,41,5,36,4,3
11,310,310,12,12,0,1,0
4,340,340,19,19,0,1,0
5,343,343,9,9,0,1,0
13,364,364,10,10,0,1,0
9,369,369,32,32,0,1,0
6,391,391,18,5,13,2,1
2,405,405,21,7,14,3,2
0,422,422,17,7,10,2,1
17,458,458,161,80,81,3,2
15,496,496,37,37,0,1,0

5,102,102,6,6,0,1,0
0,124,124,3,3,0,1,0
3,146,146,22,3,19,2,1
11,153,153,19,3,16,3,2
7,188,188,6,2,4,2,1
2,209,209,64,28,36,2,1
4,243,243,28,8,20,2,1
9,375,375,131,56,75,3,2
10,381,381,53,53,0,1,0
6,390,390,40,28,12,4,3
1,396,396,17,14,3,2,1
8,405,405,56,8,48,4,3
13,413,413,7,7,0,1,0
12,494,494,5,5,0,1,0

17,101,101,17,9,8,3,2
0,121,121,13,4,9,2,1
7,157,157,1,1,0,1,0
11,169,169,16,16,0,1,0
13,172,172,15,15,0,1,0
15,182,182,52,28,24,3,2
4,219,219,9,9,0,1,0
2,227,227,20,20,0,1,0
16,252,252,6,6,0,1,0
8,262,262,1,1,0,1,0
20,271,271,13,2,11,2,1
9,291,291,29,29,0,1,0
18,309,309,15,15,0,1,0
6,321,321,6,6,0,1,0
10,322,322,4,4,0,1,0
19,342,342,4,4,0,1,0
14,407,407,91,91,0,1,0
1,408,408,15,15,0,1,0
5,425,425,39,9,30,4,3
12,460,460,25,15,10,3,2
3,487,487,29,8,21,4,3

8,113,113,5,5,0,1,0
6,190,190,16,16,0,1,0
9,221,221,6,6,0,1,0
0,243,243,42,3,39,4,3
2,277,277,6,6,0,1,0
12,322,322,100,52,48,2,1
7,348,348,46,46,0,1,0
1,353,353,55,55,0,1,0
10,421,421,65,65,0,1,0
3,432,432,118,100,18,4,3
5,452,452,70,22,48,4,3
4,464,464,11,3,8,2,1
11,468,468,30,6,24,2,1

19,114,114,19,9,10,2,1
1,115,115,2,2,0,1,0
11,125,125,6,6,0,1,0
13,138,138,35,23,12,4,3
6,144,144,8,8,0,1,0
17,146,146,9,9,0,1,0
2,221,221,4,4,0,1,0
0,221,221,1,1,0,1,0
10,223,223,48,48,0,1,0
7,230,230,35,1,34,3,2
5,264,264,15,5,10,3,2
12,264,264,1,1,0,1,0
15,309,309,40,23,17,2,1
8,315,315,8,8,0,1,0
3,367,367,37,37,0,1,0
9,382,382,21,21,0,1,0
18,413,413,4,4,0,1,0
14,435,435,40,40,0,1,0
16,481,481,52,52,0,1,0
4,485,485,24,24,0,1,0

3,111,111,16,16,0,1,0
11,127,127,7,7,0,1,0
2,136,136,11,2,9,4,3
0,172,172,16,16,0,1,0
9,195,195,25,17,8,2,1
1,207,207,88,76,12,4,3
12,216,216,34,19,15,2,1
7,340,340,116,82,34,3,2
4,356,356,8,8,0,1,0
5,416,416,15,10,5,2,1
8,453,453,2,2,0,1,0
6,458,458,21,5,16,4,3
10,460,460,37,2,35,2,1

11,119,119,5,5,0,1,0
3,150,150,1,1,0,1,0
15,155,155,14,14,0,1,0
8,157,157,29,29,0,1,0
5,238,238,1,1,0,1,0
9,243,243,48,22,26,2,1
16,250,250,8,8,0,1,0
6,281,281,49,49,0,1,0
4,305,305,8,8,0,1,0
1,315,315,12,12,0,1,0
10,333,333,5,5,0,1,0
12,469,469,43,43,0,1,0
13,475,475,252,128,124,4,3
7,479,479,61,61,0,1,0
0,489,489,16,16,0,1,0
2,489,489,5,2,3,2,1
14,495,495,6,6,0,1,0

8,121,121,7,7,0,1,0
2,137,137,9,3,6,2,1
10,170,170,12,4,8,3,2
15,207,207,32,13,19,2,1
13,217,217,14,8,6,3,2
3,233,233,15,3,12,4,3
6,258,258,35,35,0,1,0
11,259,259,78,78,0,1,0
7,263,263,60,60,0,1,0
5,279,279,5,5,0,1,0
14,305,305,4,4,0,1,0
12,366,366,20,12,8,3,2
4,400,400,54,54,0,1,0
1,406,406,16,16,0,1,0
0,410,410,23,2,21,3,2
9,492,492,76,76,0,1,0

4,102,102,1,1,0,1,0
9,106,106,9,9,0,1,0
10,147,147,14,14,0,1,0
3,152,152,22,22,0,1,0
8,153,153,11,2,9,2,1
0,173,173,15,6,9,2,1
2,257,257,8,8,0,1,0
7,257,257,18,4,14,3,2
6,265,265,2,2,0,1,0
5,359,359,161,59,102,4,3
11,381,381,44,20,24,4,3
1,439,439,35,35,0,1,0
12,488,488,181,133,48,4,3

9,103,103,1,1,0,1,0
12,113,113,27,7,20,3,2
8,154,154,41,41,0,1,0
2,189,189,1,1,0,1,0
13,198,198,18,18,0,1,0
11,240,240,18,18,0,1,0
15,241,241,9,9,0,1,0
3,315,315,11,1,10,2,1
7,324,324,31,23,8,2,1
14,376,376,88,88,0,1,0
6,394,394,14,14,0,1,0
5,412,412,7,7,0,1,0
0,434,434,72,31,41,2,1
1,446,446,74,66,8,3,2
4,456,456,7,7,0,1,0
10,462,462,61,34,27,4,3

13,195,195,29,1,28,3,2
0,202,202,22,22,0,1,0
14,219,219,19,3,16,2,1
4,274,274,12,2,10,3,2
7,323,323,37,37,0,1,0
1,332,332,24,24,0,1,0
11,346,346,34,34,0,1,0
8,356,356,13,13,0,1,0
15,386,386,67,36,31,2,1
10,398,398,4,4,0,1,0
12,404,404,67,51,16,2,1
5,416,416,1,1,0,1,0
3,433,433,49,42,7,2,1
6,449,449,2,2,0,1,0
2,449,449,124,70,54,4,3
9,454,454,13,13,0,1,0
16,483,483,60,34,26,3,2

9,106,106,2,2,0,1,0
17,176,176,14,14,0,1,0
12,184,184,7,3,4,2,1
16,197,197,13,13,0,1,0
11,249,249,8,2,6,2,1
1,266,266,36,36,0,1,0
19,277,277,13,13,0,1,0
13,278,278,49,49,0,1,0
8,278,278,5,5,0,1,0
14,299,299,84,3,81,4,3
15,331,331,18,18,0,1,0
2,344,344,12,12,0,1,0
10,350,350,16,16,0,1,0
7,356,356,40,12,28,3,2
0,379,379,14,14,0,1,0
18,380,380,44,22,22,3,2
6,406,406,45,16,29,2,1
4,451,451,46,46,0,1,0
5,489,489,47,47,0,1,0
3,500,500,10,10,0,1,0

0,121,121,29,9,20,3,2
4,139,139,11,1,10,3,2
11,152,152,9,9,0,1,0
2,194,194,1,1,0,1,0
14,208,208,20,20,0,1,0
10,218,218,42,42,0,1,0
6,227,227,10,10,0,1,0
5,278,278,36,36,0,1,0
8,314,314,1,1,0,1,0
7,402,402,33,33,0,1,0
9,422,422,61,16,45,4,3
3,437,437,57,1,56,3,2
13,442,442,134,89,45,4,3
12,451,451,5,2,3,2,1
1,455,455,42,42,0,1,0

10,142,142,1,1,0,1,0
1,163,163,10,3,7,2,1
11,172,172,22,22,0,1,0
9,181,181,29,13,16,2,1
12,247,247,43,43,0,1,0
6,261,261,29,29,0,1,0
0,267,267,23,1,22,2,1
2,268,268,14,14,0,1,0
8,293,293,64,64,0,1,0
13,301,301,9,6,3,2,1
5,317,317,5,5,0,1,0
3,330,330,66,66,0,1,0
14,360,360,37,15,22,2,1
7,379,379,93,21,72,3,2
4,446,446,13,10,3,2,1

5,117,117,3,3,0,1,0
14,120,120,1,1,0,1,0
3,128,128,6,6,0,1,0
11,143,143,4,4,0,1,0
7,157,157,22,4,18,2,1
13,159,159,38,38,0,1,0
15,176,176,11,11,0,1,0
0,180,180,7,7,0,1,0
6,197,197,12,9,3,2,1
12,213,213,77,77,0,1,0
16,218,218,7,1,6,2,1
8,249,249,29,12,17,2,1
9,255,255,22,14,8,3,2
1,323,323,3,3,0,1,0
2,328,328,10,10,0,1,0
10,438,438,52,18,34,2,1
17,470,470,43,43,0,1,0
4,478,478,61,61,0,1,0

6,120,120,20,20,0,1,0
11,145,145,15,9,6,2,1
2,175,175,9,1,8,2,1
8,213,213,16,16,0,1,0
1,221,221,72,57,15,2,1
9,253,253,17,3,14,3,2
10,268,268,12,2,10,3,2
3,313,313,22,22,0,1,0
7,372,372,85,13,72,3,2
4,424,424,135,63,72,4,3
5,478,478,65,18,47,2,1
0,495,495,18,15,3,2,1

0,100,100,14,14,0,1,0
2,117,117,22,4,18,2,1
5,121,121,5,5,0,1,0
13,194,194,35,14,21,2,1
1,209,209,42,14,28,2,1
4,276,276,23,23,0,1,0
9,300,300,6,6,0,1,0
11,319,319,14,11,3,2,1
3,322,322,11,11,0,1,0
6,379,379,26,14,12,2,1
8,382,382,1,1,0,1,0
10,383,383,4,4,0,1,0
14,425,425,169,169,0,1,0
15,458,458,17,17,0,1,0
12,461,461,55,2,53,4,3
7,491,491,21,21,0,1,0

12,142,142,66,66,0,1,0
15,150,150,15,15,0,1,0
10,152,152,10,10,0,1,0
5,169,169,12,12,0,1,0
4,188,188,28,28,0,1,0
14,204,204,13,3,10,2,1
9,211,211,5,5,0,1,0
17,247,247,10,2,8,3,2
3,284,284,6,6,0,1,0
0,325,325,59,19,40,3,2
2,328,328,1,1,0,1,0
8,386,386,4,4,0,1,0
13,400,400,28,28,0,1,0
7,419,419,54,23,31,2,1
16,433,433,8,8,0,1,0
1,442,442,26,26,0,1,0
6,450,450,40,15,25,2,1
11,498,498,26,26,0,1,0

5,107,107,9,9,0,1,0
9,107,107,2,2,0,1,0
16,180,180,19,10,9,4,3
7,228,228,39,30,9,4,3
2,229,229,4,4,0,1,0
11,232,232,70,56,14,2,1
1,261,261,44,4,40,2,1
10,273,273,56,51,5,2,1
8,330,330,57,21,36,2,1
0,348,348,23,15,8,3,2
14,363,363,16,16,0,1,0
6,371,371,9,6,3,2,1
15,386,386,22,10,12,3,2
13,389,389,14,14,0,1,0
3,441,441,13,1,12,4,3
12,466,466,29,8,21,2,1
4,478,478,24,4,20,2,1

17,101,101,11,1,10,2,1
9,113,113,17,2,15,4,3
3,126,126,6,6,0,1,0
14,149,149,12,12,0,1,0
0,149,149,13,4,9,4,3
11,160,160,16,16,0,1,0
13,169,169,31,7,24,4,3
15,212,212,4,4,0,1,0
5,213,213,4,4,0,1,0
8,261,261,17,6,11,2,1
1,284,284,42,30,12,4,3
2,301,301,3,3,0,1,0
6,322,322,19,3,16,2,1
10,323,323,33,33,0,1,0
12,333,333,70,31,39,2,1
7,352,352,1,1,0,1,0
4,436,436,48,4,44,2,1
16,481,481,55,37,18,2,1

7,111,111,10,1,9,2,1
18,122,122,34,34,0,1,0
14,156,156,6,6,0,1,0
9,162,162,1,1,0,1,0
17,168,168,58,58,0,1,0
0,168,168,1,1,0,1,0
3,174,174,4,4,0,1,0
2,275,275,31,22,9,4,3
10,286,286,11,2,9,2,1
8,365,365,19,4,15,4,3
11,403,403,46,46,0,1,0
4,409,409,60,44,16,2,1
13,432,432,5,1,4,2,1
5,445,445,42,18,24,4,3
12,459,459,30,22,8,2,1
15,461,461,6,6,0,1,0
6,475,475,1,1,0,1,0
1,485,485,56,37,19,2,1
16,490,490,32,32,0,1,0

2,145,145,2,2,0,1,0
9,181,181,29,9,20,3,2
8,190,190,1,1,0,1,0
0,311,311,12,6,6,3,2
6,372,372,27,1,26,2,1
3,381,381,192,170,22,2,1
7,381,381,48,14,34,3,2
12,431,431,55,25,30,3,2
1,440,440,63,6,57,4,3
4,447,447,37,37,0,1,0
5,463,463,9,9,0,1,0
10,472,472,121,39,82,3,2
11,492,492,31,31,0,1,0

14,134,134,9,9,0,1,0
4,167,167,4,4,0,1,0
0,199,199,25,5,20,3,2
2,202,202,45,45,0,1,0
12,235,235,8,8,0,1,0
6,251,251,35,35,0,1,0
10,319,319,83,83,0,1,0
5,334,334,10,4,6,2,1
1,360,360,11,3,8,2,1
13,370,370,30,14,16,3,2
8,384,384,129,129,0,1,0
11,384,384,5,5,0,1,0
7,444,444,86,12,74,3,2
3,446,446,16,3,13,2,1
9,458,458,8,3,5,2,1

12,116,116,6,6,0,1,0
0,123,123,3,3,0,1,0
19,138,138,52,16,36,3,2
8,142,142,10,10,0,1,0
15,161,161,20,10,10,3,2
7,180,180,6,1,5,2,1
5,190,190,1,1,0,1,0
11,196,196,56,24,32,2,1
14,204,204,13,13,0,1,0
9,208,208,34,34,0,1,0
3,221,221,7,7,0,1,0
18,269,269,11,11,0,1,0
6,296,296,4,4,0,1,0
16,324,324,1,1,0,1,0
17,384,384,37,27,10,2,1
1,412,412,4,1,3,2,1
10,423,423,15,6,9,2,1
4,429,429,4,4,0,1,0
13,431,431,46,46,0,1,0
2,493,493,34,3,31,4,3

12,114,114,22,13,9,2,1
11,154,154,18,18,0,1,0
1,167,167,1,1,0,1,0
0,184,184,1,1,0,1,0
14,218,218,31,10,21,2,1
8,253,253,19,11,8,3,2
5,268,268,11,1,10,2,1
4,288,288,26,26,0,1,0
13,320,320,9,1,8,3,2
2,327,327,122,32,90,4,3
3,352,352,25,3,22,2,1
7,352,352,10,1,9,2,1
10,411,411,45,36,9,4,3
9,439,439,61,35,26,3,2
6,441,441,49,5,44,3,2
15,496,496,42,42,0,1,0

5,118,118,19,19,0,1,0
1,148,148,13,13,0,1,0
10,163,163,9,9,0,1,0
2,277,277,42,34,8,3,2
3,317,317,25,25,0,1,0
7,324,324,24,24,0,1,0
0,354,354,24,5,19,2,1
9,382,382,66,66,0,1,0
8,388,388,65,35,30,3,2
12,415,415,112,63,49,3,2
4,423,423,107,33,74,3,2
6,427,427,15,15,0,1,0
11,477,477,18,10,8,2,1

7,102,102,33,21,12,3,2
0,153,153,16,16,0,1,0
5,162,162,17,2,15,3,2
4,193,193,7,7,0,1,0
3,196,196,5,5,0,1,0
8,197,197,1,1,0,1,0
9,289,289,10,10,0,1,0
1,290,290,39,39,0,1,0
10,291,291,70,70,0,1,0
2,306,306,87,87,0,1,0
13,372,372,19,19,0,1,0
6,428,428,48,48,0,1,0
11,443,443,62,62,0,1,0
12,498,498,10,10,0,1,0

15,114,114,27,27,0,1,0
3,119,119,29,5,24,3,2
17,148,148,3,3,0,1,0
12,150,150,12,7,5,2,1
9,155,155,1,1,0,1,0
7,164,164,8,8,0,1,0
18,208,208,36,36,0,1,0
2,218,218,1,1,0,1,0
6,227,227,32,32,0,1,0
10,283,283,35,35,0,1,0
1,296,296,7,3,4,2,1
8,353,353,22,22,0,1,0
14,379,379,10,3,7,2,1
11,381,381,21,21,0,1,0
5,400,400,2,2,0,1,0
0,405,405,30,30,0,1,0
4,436,436,6,6,0,1,0
13,438,438,31,14,17,2,1
16,469,469,99,99,0,1,0

8,101,101,18,18,0,1,0
2,132,132,34,31,3,2,1
6,139,139,14,7,7,2,1
3,165,165,40,40,0,1,0
11,212,212,10,4,6,2,1
1,220,220,27,5,22,3,2
4,222,222,8,8,0,1,0
9,268,268,19,19,0,1,0
0,307,307,43,25,18,3,2
5,370,370,1,1,0,1,0
12,413,413,68,43,25,2,1
10,446,446,91,45,46,3,2
7,450,450,21,9,12,4,3

0,116,116,2,2,0,1,0
18,117,117,6,6,0,1,0
16,117,117,12,12,0,1,0
4,151,151,6,6,0,1,0
12,154,154,1,1,0,1,0
10,158,158,3,3,0,1,0
19,179,179,31,31,0,1,0
9,196,196,27,7,20,2,1
3,240,240,39,39,0,1,0
14,255,255,9,9,0,1,0
7,258,258,15,15,0,1,0
13,259,259,1,1,0,1,0
17,265,265,54,48,6,3,2
2,291,291,6,6,0,1,0
1,294,294,9,9,0,1,0
11,351,351,45,45,0,1,0
8,371,371,27,27,0,1,0
6,394,394,26,15,11,2,1
15,396,396,26,26,0,1,0
21,451,451,65,65,0,1,0
5,465,465,1,1,0,1,0
20,499,499,41,24,17,2,1

15,124,124,2,2,0,1,0
17,155,155,27,27,0,1,0
9,186,186,8,8,0,1,0
2,238,238,7,7,0,1,0
16,257,257,15,9,6,2,1
5,268,268,48,48,0,1,0
14,273,273,20,5,15,4,3
12,304,304,55,46,9,4,3
11,321,321,2,2,0,1,0
6,329,329,33,33,0,1,0
3,337,337,3,3,0,1,0
7,369,369,54,54,0,1,0
1,391,391,41,41,0,1,0
10,399,399,5,2,3,2,1
18,426,426,34,16,18,4,3
4,439,439,53,19,34,2,1
13,451,451,107,29,78,3,2
8,491,491,21,7,14,2,1
0,492,492,3,3,0,1,0

1,121,121,14,1,13,2,1
2,210,210,7,2,5,2,1
8,234,234,34,10,24,2,1
0,247,247,52,19,33,4,3
9,263,263,28,28,0,1,0
12,297,297,26,26,0,1,0
3,324,324,11,6,5,2,1
13,325,325,54,54,0,1,0
11,328,328,67,67,0,1,0
6,381,381,44,39,5,2,1
4,383,383,8,8,0,1,0
15,383,383,30,11,19,2,1
7,387,387,7,7,0,1,0
5,418,418,45,9,36,2,1
14,426,426,26,26,0,1,0
10,490,490,52,18,34,3,2

0,137,137,10,10,0,1,0
8,153,153,25,16,9,4,3
4,160,160,9,9,0,1,0
14,164,164,5,5,0,1,0
1,165,165,8,1,7,2,1
15,167,167,9,9,0,1,0
10,169,169,3,3,0,1,0
5,197,197,16,12,4,2,1
6,222,222,29,14,15,4,3
12,233,233,1,1,0,1,0
2,267,267,16,16,0,1,0
3,295,295,7,7,0,1,0
7,300,300,11,1,10,3,2
18,314,314,31,31,0,1,0
9,346,346,10,1,9,2,1
19,352,352,42,26,16,2,1
13,367,367,78,78,0,1,0
17,396,396,13,1,12,2,1
16,480,480,125,80,45,4,3
11,486,486,37,18,19,2,1

8,153,153,29,19,10,2,1
6,164,164,47,2,45,4,3
4,186,186,80,80,0,1,0
9,214,214,6,6,0,1,0
1,250,250,1,1,0,1,0
10,299,299,2,2,0,1,0
0,324,324,86,86,0,1,0
7,326,326,35,2,33,4,3
2,344,344,1,1,0,1,0
11,435,435,59,35,24,4,3
5,445,445,26,18,8,2,1
3,487,487,48,48,0,1,0

12,145,145,5,5,0,1,0
1,154,154,7,4,3,2,1
9,193,193,29,29,0,1,0
14,194,194,27,15,12,3,2
8,221,221,8,8,0,1,0
5,224,224,1,1,0,1,0
11,229,229,16,7,9,3,2
4,279,279,124,124,0,1,0
13,298,298,81,18,63,4,3
2,309,309,26,26,0,1,0
0,381,381,7,7,0,1,0
7,388,388,49,9,40,3,2
6,414,414,2,2,0,1,0
10,451,451,49,49,0,1,0
3,488,488,36,36,0,1,0

2,110,110,7,7,0,1,0
8,112,112,5,5,0,1,0
4,121,121,13,13,0,1,0
5,123,123,11,7,4,2,1
12,257,257,10,5,5,2,1
1,288,288,20,20,0,1,0
10,317,317,150,94,56,3,2
14,319,319,48,48,0,1,0
3,324,324,62,18,44,4,3
6,331,331,34,20,14,3,2
11,358,358,3,3,0,1,0
9,374,374,31,13,18,2,1
7,395,395,51,3,48,4,3
13,413,413,7,7,0,1,0
0,465,465,22,4,18,3,2

2,104,104,8,8,0,1,0
11,134,134,32,32,0,1,0
6,149,149,49,49,0,1,0
14,154,154,4,4,0,1,0
1,163,163,1,1,0,1,0
4,188,188,2,2,0,1,0
15,262,262,3,3,0,1,0
8,313,313,35,17,18,4,3
5,342,342,1,1,0,1,0
10,358,358,7,7,0,1,0
9,366,366,60,60,0,1,0
3,384,384,40,2,38,3,2
12,389,389,15,6,9,4,3
13,425,425,135,43,92,3,2
0,439,439,13,10,3,2,1
7,493,493,64,37,27,4,3

3,123,123,1,1,0,1,0
8,151,151,25,25,0,1,0
2,218,218,16,10,6,2,1
10,278,278,15,15,0,1,0
1,355,355,96,24,72,4,3
6,392,392,60,60,0,1,0
7,412,412,103,35,68,3,2
5,421,421,57,5,52,3,2
4,433,433,192,192,0,1,0
11,437,437,10,4,6,2,1
9,441,441,11,11,0,1,0
0,453,453,3,3,0,1,0

19,142,142,39,39,0,1,0
3,258,258,4,4,0,1,0
18,258,258,49,20,29,2,1
15,264,264,73,17,56,3,2
14,270,270,15,4,11,2,1
9,280,280,6,1,5,2,1
7,295,295,39,25,14,2,1
1,296,296,33,19,14,2,1
20,296,296,6,6,0,1,0
10,310,310,20,20,0,1,0
4,317,317,54,21,33,2,1
16,326,326,11,7,4,2,1
13,352,352,4,4,0,1,0
8,361,361,7,3,4,2,1
21,362,362,1,1,0,1,0
2,371,371,20,20,0,1,0
17,403,403,6,3,3,2,1
5,448,448,30,22,8,3,2
11,456,456,22,4,18,4,3
12,461,461,13,1,12,3,2
0,465,465,1,1,0,1,0
6,484,484,1,1,0,1,0

7,103,103,6,6,0,1,0
8,106,106,17,8,9,2,1
10,126,126,1,1,0,1,0
14,146,146,10,10,0,1,0
15,185,185,8,8,0,1,0
4,191,191,6,6,0,1,0
3,209,209,1,1,0,1,0
5,255,255,1,1,0,1,0
11,259,259,63,18,45,4,3
18,275,275,8,8,0,1,0
12,302,302,22,22,0,1,0
0,324,324,32,8,24,3,2
2,334,334,5,5,0,1,0
13,400,400,5,5,0,1,0
6,409,409,19,19,0,1,0
17,420,420,16,2,14,3,2
16,443,443,54,54,0,1,0
1,443,443,18,9,9,4,3
19,446,446,222,222,0,1,0
9,467,467,9,9,0,1,0

4,109,109,7,7,0,1,0
16,125,125,4,4,0,1,0
11,158,158,48,39,9,2,1
2,168,168,39,27,12,3,2
8,188,188,1,1,0,1,0
3,193,193,6,2,4,2,1
15,288,288,4,4,0,1,0
13,309,309,1,1,0,1,0
5,324,324,31,11,20,3,2
0,338,338,44,44,0,1,0
6,339,339,26,5,21,4,3
10,372,372,26,26,0,1,0
17,376,376,83,14,69,4,3
1,398,398,2,2,0,1,0
12,401,401,70,19,51,3,2
14,418,418,27,27,0,1,0
7,452,452,8,8,0,1,0
9,455,455,34,20,14,2,1

17,110,110,9,9,0,1,0
14,116,116,19,19,0,1,0
18,127,127,34,6,28,3,2
1,147,147,7,3,4,2,1
5,207,207,2,2,0,1,0
11,248,248,21,21,0,1,0
7,251,251,9,5,4,2,1
13,260,260,32,8,24,4,3
9,271,271,22,22,0,1,0
0,284,284,2,2,0,1,0
12,293,293,52,52,0,1,0
8,305,305,33,33,0,1,0
4,312,312,24,24,0,1,0
16,353,353,12,12,0,1,0
2,354,354,30,30,0,1,0
15,400,400,59,13,46,2,1
3,401,401,21,21,0,1,0
19,455,455,3,3,0,1,0
10,473,473,5,2,3,2,1
6,483,483,12,12,0,1,0

6,103,103,10,4,6,3,2
11,116,116,13,1,12,2,1
12,117,117,20,14,6,3,2
16,181,181,4,4,0,1,0
14,239,239,61,19,42,2,1
3,246,246,42,42,0,1,0
1,258,258,11,11,0,1,0
17,281,281,14,14,0,1,0
0,295,295,8,8,0,1,0
5,295,295,18,1,17,4,3
9,341,341,38,20,18,2,1
7,345,345,5,5,0,1,0
10,366,366,22,10,12,4,3
4,371,371,1,1,0,1,0
13,406,406,62,41,21,4,3
8,420,420,5,5,0,1,0
2,429,429,87,53,34,3,2
15,475,475,27,13,14,3,2

2,117,117,2,2,0,1,0
11,138,138,13,1,12,2,1
5,169,169,1,1,0,1,0
0,189,189,1,1,0,1,0
15,214,214,8,8,0,1,0
18,221,221,3,3,0,1,0
17,221,221,57,51,6,2,1
4,264,264,1,1,0,1,0
1,275,275,6,6,0,1,0
3,302,302,36,36,0,1,0
13,306,306,9,9,0,1,0
16,315,315,29,5,24,3,2
10,323,323,7,7,0,1,0
20,387,387,3,3,0,1,0
9,394,394,13,13,0,1,0
14,397,397,147,147,0,1,0
8,399,399,9,9,0,1,0
12,409,409,11,2,9,2,1
6,437,437,173,47,126,4,3
19,446,446,14,9,5,2,1
7,495,495,2,2,0,1,0

0,114,114,30,30,0,1,0
3,147,147,17,4,13,2,1
6,155,155,1,1,0,1,0
13,172,172,19,19,0,1,0
2,243,243,2,2,0,1,0
16,259,259,20,13,7,2,1
5,270,270,11,11,0,1,0
14,281,281,123,114,9,2,1
18,302,302,14,14,0,1,0
15,303,303,11,11,0,1,0
10,338,338,6,6,0,1,0
9,347,347,11,3,8,2,1
4,348,348,17,17,0,1,0
8,349,349,1,1,0,1,0
17,409,409,33,6,27,4,3
12,411,411,9,5,4,2,1
1,427,427,6,6,0,1,0
7,449,449,102,74,28,3,2
11,490,490,12,2,10,2,1

1,134,134,1,1,0,1,0
11,194,194,11,11,0,1,0
3,208,208,45,23,22,3,2
10,209,209,17,1,16,3,2
9,225,225,15,1,14,2,1
0,260,260,87,33,54,3,2
8,402,402,140,140,0,1,0
7,426,426,23,3,20,2,1
6,460,460,44,1,43,2,1
2,471,471,42,42,0,1,0
4,475,475,73,31,42,3,2
5,486,486,54,6,48,4,3

14,109,109,12,12,0,1,0
16,135,135,24,24,0,1,0
11,154,154,6,6,0,1,0
8,171,171,1,1,0,1,0
7,180,180,6,6,0,1,0
12,204,204,24,24,0,1,0
3,212,212,43,43,0,1,0
18,216,216,1,1,0,1,0
17,217,217,21,15,6,2,1
1,223,223,2,2,0,1,0
2,289,289,2,2,0,1,0
10,322,322,43,43,0,1,0
4,332,332,8,8,0,1,0
6,336,336,30,30,0,1,0
5,360,360,12,12,0,1,0
0,368,368,38,4,34,2,1
13,387,387,37,37,0,1,0
15,398,398,86,28,58,4,3
9,408,408,51,51,0,1,0

5,127,127,15,15,0,1,0
0,145,145,5,5,0,1,0
3,160,160,4,4,0,1,0
2,164,164,8,8,0,1,0
11,244,244,39,13,26,3,2
7,268,268,97,10,87,4,3
10,277,277,127,113,14,2,1
4,280,280,23,23,0,1,0
14,342,342,2,2,0,1,0
6,344,344,24,24,0,1,0
9,359,359,43,31,12,4,3
8,403,403,14,14,0,1,0
12,409,409,10,2,8,3,2
1,452,452,28,9,19,2,1
13,489,489,3,3,0,1,0

0,109,109,13,13,0,1,0
11,134,134,44,7,37,4,3
3,136,136,1,1,0,1,0
8,145,145,18,18,0,1,0
1,149,149,3,3,0,1,0
2,175,175,42,42,0,1,0
12,198,198,11,5,6,2,1
4,200,200,11,11,0,1,0
14,224,224,18,8,10,2,1
6,264,264,13,13,0,1,0
9,324,324,18,3,15,2,1
5,343,343,6,6,0,1,0
7,387,387,113,65,48,3,2
10,461,461,17,17,0,1,0
13,479,479,67,34,33,2,1

10,105,105,22,9,13,2,1
2,127,127,9,9,0,1,0
9,221,221,23,8,15,2,1
11,253,253,14,14,0,1,0
16,264,264,62,62,0,1,0
6,266,266,1,1,0,1,0
7,282,282,25,11,14,3,2
4,291,291,5,5,0,1,0
1,292,292,5,5,0,1,0
17,310,310,16,4,12,3,2
0,312,312,37,37,0,1,0
5,318,318,4,4,0,1,0
14,331,331,13,13,0,1,0
13,350,350,47,47,0,1,0
18,376,376,37,22,15,4,3
12,398,398,83,83,0,1,0
15,432,432,19,19,0,1,0
8,435,435,33,1,32,3,2
3,475,475,14,4,10,2,1

10,134,134,9,2,7,2,1
0,156,156,5,5,0,1,0
7,162,162,6,6,0,1,0
11,187,187,41,41,0,1,0
8,217,217,58,31,27,4,3
9,241,241,19,19,0,1,0
1,276,276,5,5,0,1,0
5,283,283,5,5,0,1,0
6,388,388,50,5,45,2,1
4,420,420,175,121,54,4,3
3,429,429,41,41,0,1,0
2,437,437,104,104,0,1,0

13,118,118,1,1,0,1,0
11,168,168,85,7,78,3,2
2,172,172,28,28,0,1,0
4,198,198,23,23,0,1,0
1,208,208,39,31,8,2,1
9,213,213,26,26,0,1,0
5,216,216,1,1,0,1,0
15,218,218,2,2,0,1,0
14,226,226,7,1,6,3,2
6,312,312,14,2,12,4,3
7,344,344,7,7,0,1,0
3,350,350,8,8,0,1,0
10,399,399,42,42,0,1,0
8,438,438,60,27,33,4,3
12,468,468,18,18,0,1,0
0,485,485,51,51,0,1,0

13,176,176,35,18,17,2,1
9,215,215,11,11,0,1,0
15,226,226,48,48,0,1,0
2,239,239,27,27,0,1,0
0,247,247,2,2,0,1,0
4,250,250,38,20,18,2,1
5,263,263,18,18,0,1,0
8,279,279,4,4,0,1,0
14,303,303,8,8,0,1,0
11,340,340,78,63,15,4,3
10,363,363,8,3,5,2,1
7,415,415,10,10,0,1,0
3,433,433,8,4,4,2,1
1,463,463,149,149,0,1,0
12,467,467,33,33,0,1,0
6,473,473,39,7,32,2,1

12,140,140,48,48,0,1,0
7,149,149,24,3,21,2,1
13,152,152,31,23,8,3,2
11,152,152,16,16,0,1,0
15,166,166,1,1,0,1,0
4,193,193,12,12,0,1,0
3,214,214,8,8,0,1,0
16,236,236,13,13,0,1,0
8,285,285,8,2,6,2,1
1,370,370,7,7,0,1,0
6,373,373,2,2,0,1,0
9,390,390,23,7,16,2,1
2,407,407,132,79,53,4,3
14,443,443,22,22,0,1,0
10,452,452,24,24,0,1,0
0,466,466,48,48,0,1,0
5,481,481,1,1,0,1,0

8,139,139,1,1,0,1,0
3,147,147,30,30,0,1,0
5,156,156,19,19,0,1,0
12,196,196,26,26,0,1,0
4,223,223,14,14,0,1,0
2,235,235,31,4,27,4,3
13,241,241,4,4,0,1,0
0,255,255,19,3,16,3,2
10,299,299,45,45,0,1,0
11,318,318,100,82,18,4,3
6,327,327,61,43,18,3,2
7,394,394,66,39,27,4,3
1,407,407,8,8,0,1,0
9,443,443,10,5,5,2,1

7,111,111,13,13,0,1,0
9,117,117,1,1,0,1,0
4,120,120,4,4,0,1,0
10,130,130,21,16,5,2,1
11,159,159,43,43,0,1,0
2,249,249,38,38,0,1,0
13,320,320,22,22,0,1,0
3,323,323,23,1,22,2,1
8,414,414,26,26,0,1,0
0,440,440,37,37,0,1,0
5,446,446,71,56,15,4,3
12,450,450,57,57,0,1,0
6,486,486,28,16,12,3,2
1,500,500,121,73,48,4,3

9,102,102,43,12,31,3,2
10,109,109,5,5,0,1,0
7,142,142,2,2,0,1,0
3,198,198,11,11,0,1,0
11,200,200,17,17,0,1,0
13,203,203,1,1,0,1,0
6,231,231,17,7,10,2,1
12,258,258,28,7,21,2,1
5,318,318,59,59,0,1,0
2,337,337,49,25,24,2,1
8,361,361,51,5,46,3,2
1,377,377,78,54,24,2,1
0,430,430,40,8,32,3,2
4,468,468,19,19,0,1,0

0,126,126,33,33,0,1,0
6,151,151,5,5,0,1,0
1,216,216,71,35,36,4,3
2,219,219,46,46,0,1,0
3,302,302,26,26,0,1,0
4,325,325,7,7,0,1,0
5,368,368,32,21,11,4,3
7,380,380,36,30,6,3,2
8,432,432,161,161,0,1,0
9,474,474,56,56,0,1,0

8,101,101,4,1,3,2,1
15,139,139,6,6,0,1,0
17,145,145,17,17,0,1,0
3,154,154,14,14,0,1,0
10,251,251,1,1,0,1,0
1,286,286,23,23,0,1,0
14,291,291,18,3,15,2,1
12,313,313,54,54,0,1,0
6,321,321,86,13,73,3,2
16,334,334,60,35,25,2,1
11,343,343,48,42,6,3,2
2,366,366,11,2,9,3,2
0,388,388,12,8,4,2,1
4,393,393,46,32,14,3,2
13,398,398,39,18,21,4,3
5,415,415,2,2,0,1,0
9,464,464,49,49,0,1,0
7,493,493,16,16,0,1,0

4,132,132,1,1,0,1,0
6,132,132,4,4,0,1,0
8,140,140,26,16,10,2,1
13,165,165,59,59,0,1,0
3,198,198,9,9,0,1,0
9,215,215,2,2,0,1,0
10,227,227,2,2,0,1,0
1,232,232,16,13,3,2,1
12,276,276,51,42,9,2,1
15,279,279,20,20,0,1,0
2,376,376,23,23,0,1,0
7,392,392,94,94,0,1,0
11,418,418,69,29,40,3,2
0,425,425,15,4,11,4,3
14,434,434,1,1,0,1,0
5,439,439,49,49,0,1,0
16,461,461,7,2,5,2,1
17,482,482,6,6,0,1,0

7,144,144,3,3,0,1,0
9,184,184,58,58,0,1,0
1,204,204,25,18,7,2,1
5,245,245,25,25,0,1,0
2,276,276,17,5,12,3,2
0,302,302,186,45,141,4,3
6,307,307,49,11,38,2,1
8,355,355,19,8,11,2,1
3,410,410,17,17,0,1,0
4,499,499,60,12,48,3,2

16,102,102,1,1,0,1,0
3,110,110,1,1,0,1,0
8,124,124,5,5,0,1,0
12,137,137,5,2,3,2,1
7,155,155,6,1,5,2,1
18,174,174,75,30,45,4,3
19,218,218,19,2,17,2,1
5,220,220,13,9,4,2,1
14,288,288,46,16,30,3,2
2,300,300,112,112,0,1,0
15,304,304,14,14,0,1,0
6,313,313,9,6,3,2,1
4,315,315,2,2,0,1,0
17,334,334,9,1,8,3,2
9,344,344,3,3,0,1,0
11,352,352,26,14,12,2,1
13,408,408,22,8,14,3,2
0,475,475,3,3,0,1,0
1,494,494,30,9,21,2,1
10,498,498,31,9,22,3,2

7,131,131,5,5,0,1,0
4,139,139,60,60,0,1,0
11,157,157,49,31,18,4,3
0,164,164,1,1,0,1,0
3,170,170,6,6,0,1,0
1,256,256,14,8,6,3,2
13,272,272,8,3,5,2,1
6,275,275,50,38,12,2,1
12,310,310,26,6,20,2,1
8,329,329,12,12,0,1,0
5,408,408,24,12,12,4,3
9,472,472,112,23,89,4,3
10,489,489,38,38,0,1,0
2,499,499,16,8,8,3,2

12,117,117,11,11,0,1,0
4,199,199,2,2,0,1,0
1,218,218,11,11,0,1,0
13,237,237,41,41,0,1,0
7,240,240,4,4,0,1,0
10,252,252,25,25,0,1,0
5,281,281,94,83,11,2,1
11,288,288,56,56,0,1,0
8,295,295,14,8,6,3,2
0,370,370,31,9,22,3,2
2,411,411,26,26,0,1,0
14,413,413,36,36,0,1,0
6,418,418,25,8,17,2,1
15,437,437,16,7,9,2,1
9,446,446,16,16,0,1,0
16,447,447,58,58,0,1,0
3,461,461,46,46,0,1,0

13,106,106,26,26,0,1,0
4,110,110,21,21,0,1,0
16,142,142,25,17,8,3,2
6,160,160,13,4,9,2,1
10,203,203,22,22,0,1,0
0,252,252,6,6,0,1,0
8,266,266,1,1,0,1,0
2,284,284,13,13,0,1,0
9,285,285,37,30,7,2,1
3,297,297,27,17,10,2,1
11,314,314,20,20,0,1,0
7,337,337,31,31,0,1,0
12,341,341,1,1,0,1,0
15,345,345,56,56,0,1,0
14,354,354,19,19,0,1,0
5,359,359,30,10,20,2,1
1,383,383,23,23,0,1,0

5,102,102,1,1,0,1,0
2,107,107,19,19,0,1,0
7,107,107,8,8,0,1,0
8,158,158,9,9,0,1,0
13,185,185,9,6,3,2,1
6,200,200,1,1,0,1,0
14,210,210,12,12,0,1,0
1,221,221,1,1,0,1,0
3,292,292,75,9,66,4,3
16,302,302,14,6,8,3,2
9,326,326,62,62,0,1,0
12,342,342,3,3,0,1,0
0,359,359,3,3,0,1,0
15,369,369,101,11,90,4,3
10,413,413,137,74,63,4,3
11,427,427,19,7,12,2,1
4,445,445,8,8,0,1,0

3,100,100,4,1,3,2,1
8,201,201,7,1,6,2,1
13,216,216,101,81,20,2,1
11,241,241,2,2,0,1,0
5,307,307,30,2,28,3,2
1,309,309,1,1,0,1,0
12,310,310,12,12,0,1,0
9,337,337,9,9,0,1,0
7,347,347,22,9,13,3,2
10,370,370,7,1,6,3,2
14,391,391,86,56,30,4,3
6,433,433,55,55,0,1,0
0,441,441,150,92,58,3,2
4,443,443,52,52,0,1,0
2,448,448,5,5,0,1,0

3,106,106,20,20,0,1,0
13,139,139,4,1,3,2,1
5,142,142,3,3,0,1,0
8,170,170,20,4,16,3,2
12,209,209,23,14,9,2,1
9,225,225,39,11,28,3,2
6,241,241,15,15,0,1,0
2,302,302,16,9,7,2,1
10,311,311,54,54,0,1,0
7,317,317,31,31,0,1,0
11,345,345,25,25,0,1,0
1,369,369,70,22,48,4,3
15,418,418,54,54,0,1,0
14,456,456,58,2,56,3,2
0,466,466,11,1,10,3,2
4,479,479,23,23,0,1,0

7,104,104,22,6,16,2,1
5,131,131,1,1,0,1,0
8,154,154,15,15,0,1,0
10,238,238,20,15,5,2,1
4,282,282,1,1,0,1,0
2,296,296,88,32,56,4,3
9,313,313,13,13,0,1,0
0,359,359,28,4,24,4,3
11,421,421,45,13,32,2,1
12,427,427,42,42,0,1,0
13,427,427,74,44,30,2,1
3,436,436,38,14,24,2,1
6,470,470,25,25,0,1,0
1,477,477,131,11,120,4,3

7,110,110,8,8,0,1,0
9,118,118,14,8,6,2,1
8,128,128,41,1,40,3,2
2,135,135,5,5,0,1,0
13,152,152,31,13,18,3,2
0,170,170,56,20,36,3,2
6,172,172,14,3,11,2,1
5,178,178,17,17,0,1,0
3,185,185,27,12,15,2,1
11,224,224,9,1,8,2,1
14,247,247,13,1,12,2,1
4,297,297,9,9,0,1,0
10,312,312,10,10,0,1,0
1,451,451,5,5,0,1,0
12,487,487,26,26,0,1,0

11,115,115,20,20,0,1,0
2,187,187,32,32,0,1,0
6,208,208,3,3,0,1,0
7,208,208,5,5,0,1,0
14,217,217,9,9,0,1,0
4,227,227,8,1,7,2,1
0,237,237,25,25,0,1,0
1,347,347,124,1,123,4,3
8,351,351,23,20,3,2,1
9,356,356,18,18,0,1,0
13,365,365,102,63,39,4,3
3,371,371,5,5,0,1,0
10,384,384,2,2,0,1,0
5,472,472,38,9,29,3,2
12,474,474,93,93,0,1,0

15,113,113,16,4,12,4,3
5,124,124,19,19,0,1,0
3,224,224,1,1,0,1,0
2,226,226,9,9,0,1,0
8,227,227,38,6,32,3,2
4,274,274,26,4,22,2,1
14,284,284,69,12,57,4,3
6,292,292,4,4,0,1,0
12,295,295,12,12,0,1,0
0,303,303,24,24,0,1,0
11,308,308,4,4,0,1,0
7,312,312,12,4,8,2,1
13,327,327,98,98,0,1,0
10,352,352,1,1,0,1,0
9,386,386,72,48,24,3,2
1,407,407,9,9,0,1,0
17,425,425,28,16,12,4,3
16,495,495,4,4,0,1,0

8,129,129,1,1,0,1,0
2,135,135,28,7,21,4,3
5,142,142,8,8,0,1,0
9,168,168,41,21,20,3,2
0,215,215,6,6,0,1,0
6,220,220,7,7,0,1,0
4,235,235,20,20,0,1,0
3,411,411,22,22,0,1,0
7,467,467,159,154,5,2,1
1,469,469,267,267,0,1,0

13,103,103,16,16,0,1,0
10,114,114,4,4,0,1,0
4,128,128,6,6,0,1,0
3,142,142,7,4,3,2,1
17,163,163,67,67,0,1,0
2,167,167,14,5,9,2,1
16,173,173,2,2,0,1,0
1,180,180,7,7,0,1,0
18,320,320,9,9,0,1,0
8,367,367,14,2,12,3,2
5,386,386,115,115,0,1,0
9,396,396,3,3,0,1,0
6,401,401,21,1,20,2,1
14,401,401,2,2,0,1,0
7,406,406,17,17,0,1,0
15,406,406,81,81,0,1,0
12,411,411,2,2,0,1,0
11,421,421,1,1,0,1,0
0,464,464,50,50,0,1,0

14,125,125,10,10,0,1,0
8,148,148,9,9,0,1,0
17,191,191,33,1,32,4,3
15,200,200,1,1,0,1,0
13,201,201,16,6,10,3,2
20,213,213,32,1,31,4,3
18,244,244,17,2,15,3,2
3,268,268,3,3,0,1,0
16,270,270,66,12,54,3,2
5,302,302,8,8,0,1,0
9,302,302,9,3,6,3,2
2,321,321,15,15,0,1,0
12,368,368,30,30,0,1,0
11,400,400,21,6,15,2,1
19,416,416,32,3,29,2,1
0,423,423,35,24,11,2,1
10,434,434,27,27,0,1,0
7,441,441,44,44,0,1,0
4,461,461,18,18,0,1,0
21,492,492,46,16,30,2,1
1,494,494,15,15,0,1,0
6,500,500,10,10,0,1,0

7,112,112,14,14,0,1,0
9,132,132,3,3,0,1,0
5,166,166,35,35,0,1,0
2,232,232,7,7,0,1,0
3,318,318,22,22,0,1,0
6,324,324,84,42,42,2,1
1,335,335,148,106,42,3,2
8,346,346,9,9,0,1,0
0,435,435,144,144,0,1,0
4,473,473,51,51,0,1,0

10,130,130,30,4,26,2,1
9,131,131,31,24,7,2,1
5,195,195,47,47,0,1,0
4,274,274,12,12,0,1,0
0,304,304,30,2,28,3,2
11,342,342,14,14,0,1,0
8,349,349,20,20,0,1,0
2,386,386,5,1,4,2,1
1,436,436,31,31,0,1,0
12,445,445,62,7,55,3,2
13,468,468,18,18,0,1,0
7,480,480,36,4,32,2,1
6,485,485,41,19,22,3,2
3,498,498,124,124,0,1,0

2,195,195,49,22,27,4,3
1,231,231,7,7,0,1,0
6,250,250,28,28,0,1,0
13,290,290,86,67,19,2,1
0,293,293,42,18,24,2,1
10,301,301,12,4,8,3,2
11,311,311,21,9,12,3,2
7,388,388,51,3,48,2,1
12,404,404,45,45,0,1,0
4,411,411,58,58,0,1,0
5,430,430,9,9,0,1,0
8,443,443,20,20,0,1,0
3,473,473,48,12,36,3,2
9,488,488,59,30,29,2,1

4,105,105,2,2,0,1,0
9,143,143,11,2,9,4,3
10,190,190,25,25,0,1,0
3,208,208,59,43,16,3,2
8,258,258,3,3,0,1,0
7,286,286,61,30,31,2,1
6,298,298,8,8,0,1,0
11,311,311,22,22,0,1,0
1,366,366,108,56,52,4,3
2,394,394,35,26,9,4,3
5,460,460,132,50,82,4,3
0,482,482,55,6,49,2,1

12,117,117,15,15,0,1,0
5,147,147,28,13,15,2,1
8,183,183,18,18,0,1,0
9,276,276,54,40,14,3,2
1,286,286,8,3,5,2,1
14,341,341,101,23,78,4,3
6,368,368,56,56,0,1,0
10,373,373,17,17,0,1,0
11,379,379,19,9,10,2,1
0,439,439,29,9,20,2,1
15,462,462,36,36,0,1,0
3,469,469,44,7,37,2,1
7,472,472,13,13,0,1,0
4,480,480,38,1,37,4,3
2,483,483,32,1,31,2,1
13,495,495,11,11,0,1,0

2,133,133,2,2,0,1,0
15,139,139,34,34,0,1,0
16,151,151,26,26,0,1,0
0,164,164,3,3,0,1,0
11,165,165,2,2,0,1,0
8,178,178,24,8,16,3,2
14,212,212,14,2,12,3,2
4,213,213,24,20,4,2,1
13,242,242,1,1,0,1,0
9,244,244,47,47,0,1,0
5,272,272,20,5,15,4,3
17,293,293,7,1,6,3,2
10,333,333,38,38,0,1,0
7,334,334,12,12,0,1,0
12,402,402,120,70,50,3,2
1,413,413,31,4,27,2,1
3,461,461,8,8,0,1,0
6,467,467,6,3,3,2,1

0,111,111,5,5,0,1,0
9,113,113,8,8,0,1,0
1,178,178,38,38,0,1,0
4,197,197,9,9,0,1,0
11,226,226,2,2,0,1,0
10,244,244,2,2,0,1,0
5,257,257,10,10,0,1,0
6,279,279,32,32,0,1,0
19,331,331,1,1,0,1,0
12,341,341,16,16,0,1,0
14,416,416,2,2,0,1,0
17,422,422,29,9,20,3,2
18,440,440,123,90,33,2,1
2,445,445,22,22,0,1,0
8,452,452,8,8,0,1,0
3,455,455,54,54,0,1,0
7,463,463,11,3,8,3,2
13,465,465,15,3,12,4,3
16,489,489,29,8,21,4,3
15,497,497,179,93,86,4,3

10,122,122,16,2,14,2,1
1,161,161,16,2,14,2,1
3,166,166,5,5,0,1,0
11,186,186,30,6,24,2,1
14,191,191,16,16,0,1,0
13,214,214,40,40,0,1,0
4,236,236,61,49,12,2,1
2,247,247,1,1,0,1,0
8,303,303,5,5,0,1,0
7,307,307,17,17,0,1,0
5,318,318,54,13,41,2,1
12,329,329,54,54,0,1,0
6,410,410,38,2,36,2,1
9,446,446,31,31,0,1,0
0,485,485,45,45,0,1,0

9,108,108,15,6,9,4,3
12,116,116,3,3,0,1,0
13,160,160,2,2,0,1,0
2,168,168,27,27,0,1,0
4,247,247,11,6,5,2,1
6,276,276,14,2,12,4,3
7,292,292,24,13,11,2,1
11,307,307,53,53,0,1,0
3,334,334,8,8,0,1,0
5,396,396,26,10,16,2,1
14,396,396,83,29,54,4,3
8,428,428,51,51,0,1,0
0,432,432,2,2,0,1,0
1,478,478,176,81,95,4,3
10,486,486,70,70,0,1,0

4,115,115,10,10,0,1,0
0,193,193,24,8,16,3,2
9,194,194,14,1,13,4,3
13,197,197,2,2,0,1,0
6,200,200,18,18,0,1,0
5,273,273,9,9,0,1,0
3,298,298,15,15,0,1,0
10,343,343,40,40,0,1,0
11,369,369,24,24,0,1,0
7,388,388,2,2,0,1,0
8,389,389,84,70,14,2,1
2,398,398,138,122,16,3,2
12,464,464,151,151,0,1,0
1,465,465,34,28,6,2,1

7,135,135,8,8,0,1,0
2,147,147,21,21,0,1,0
3,149,149,6,6,0,1,0
9,157,157,40,40,0,1,0
1,160,160,60,36,24,3,2
6,275,275,11,11,0,1,0
0,307,307,23,23,0,1,0
13,342,342,14,4,10,2,1
5,348,348,18,18,0,1,0
11,391,391,13,7,6,2,1
12,409,409,4,1,3,2,1
8,410,410,68,2,66,3,2
10,457,457,115,22,93,4,3
4,480,480,37,37,0,1,0

10,107,107,5,5,0,1,0
19,117,117,2,2,0,1,0
13,134,134,45,18,27,2,1
16,141,141,9,9,0,1,0
14,149,149,11,3,8,2,1
17,159,159,3,3,0,1,0
0,166,166,17,17,0,1,0
9,169,169,27,27,0,1,0
5,205,205,10,2,8,3,2
8,222,222,1,1,0,1,0
7,229,229,27,3,24,4,3
2,263,263,9,9,0,1,0
4,277,277,26,26,0,1,0
12,291,291,15,3,12,3,2
18,291,291,72,72,0,1,0
1,337,337,19,3,16,2,1
3,366,366,6,6,0,1,0
6,387,387,26,26,0,1,0
15,387,387,22,22,0,1,0
11,403,403,1,1,0,1,0

13,143,143,1,1,0,1,0
0,195,195,3,3,0,1,0
11,221,221,7,7,0,1,0
6,231,231,21,15,6,3,2
3,234,234,70,70,0,1,0
2,243,243,6,6,0,1,0
12,248,248,12,12,0,1,0
5,311,311,99,67,32,3,2
9,342,342,15,15,0,1,0
7,343,343,29,29,0,1,0
8,357,357,62,3,59,3,2
10,385,385,164,68,96,3,2
1,404,404,11,3,8,3,2
4,463,463,13,13,0,1,0

8,101,101,4,4,0,1,0
12,109,109,26,5,21,4,3
11,119,119,14,4,10,3,2
3,149,149,16,4,12,4,3
14,177,177,32,32,0,1,0
5,210,210,27,8,19,2,1
6,217,217,33,23,10,3,2
1,270,270,4,4,0,1,0
10,290,290,9,9,0,1,0
7,315,315,11,4,7,2,1
13,320,320,14,14,0,1,0
9,322,322,58,58,0,1,0
4,392,392,14,3,11,2,1
2,466,466,49,44,5,2,1
0,483,483,107,96,11,2,1

11,111,111,19,7,12,4,3
0,145,145,7,3,4,2,1
10,226,226,9,9,0,1,0
7,271,271,7,7,0,1,0
4,301,301,33,33,0,1,0
9,305,305,29,2,27,4,3
12,323,323,90,39,51,4,3
2,332,332,62,14,48,2,1
6,353,353,63,63,0,1,0
1,354,354,28,28,0,1,0
14,355,355,71,11,60,4,3
13,364,364,2,2,0,1,0
5,368,368,45,45,0,1,0
8,387,387,8,8,0,1,0
3,395,395,20,20,0,1,0

10,118,118,13,5,8,2,1
13,123,123,3,3,0,1,0
12,163,163,57,57,0,1,0
4,164,164,10,1,9,2,1
9,189,189,11,2,9,4,3
15,193,193,9,2,7,2,1
2,206,206,38,35,3,2,1
16,259,259,23,23,0,1,0
14,272,272,13,8,5,2,1
7,300,300,22,8,14,2,1
6,379,379,10,3,7,2,1
1,397,397,34,34,0,1,0
3,426,426,39,24,15,2,1
11,437,437,66,25,41,4,3
5,454,454,2,2,0,1,0
0,458,458,57,57,0,1,0
8,463,463,42,42,0,1,0

2,108,108,1,1,0,1,0
9,171,171,1,1,0,1,0
4,240,240,1,1,0,1,0
15,260,260,16,4,12,4,3
14,264,264,43,43,0,1,0
11,280,280,81,29,52,3,2
6,292,292,12,4,8,2,1
1,316,316,69,69,0,1,0
7,318,318,22,22,0,1,0
0,324,324,4,4,0,1,0
12,333,333,30,22,8,2,1
5,370,370,33,18,15,4,3
3,399,399,55,50,5,2,1
13,429,429,37,6,31,2,1
10,430,430,14,14,0,1,0
16,440,440,35,2,33,2,1
8,482,482,87,72,15,2,1
17,487,487,21,3,18,4,3

5,116,116,23,23,0,1,0
6,236,236,4,1,3,2,1
11,236,236,34,7,27,2,1
7,239,239,32,8,24,3,2
2,250,250,1,1,0,1,0
10,286,286,9,9,0,1,0
8,319,319,14,14,0,1,0
14,319,319,22,1,21,4,3
0,327,327,85,45,40,3,2
13,330,330,10,10,0,1,0
9,334,334,74,54,20,3,2
4,367,367,9,9,0,1,0
12,401,401,109,91,18,4,3
3,465,465,7,7,0,1,0
1,500,500,75,56,19,2,1

5,121,121,44,7,37,2,1
10,163,163,31,31,0,1,0
6,181,181,10,4,6,3,2
15,189,189,31,31,0,1,0
4,204,204,17,12,5,2,1
1,244,244,14,14,0,1,0
9,277,277,6,6,0,1,0
11,295,295,62,19,43,2,1
14,351,351,7,7,0,1,0
8,358,358,37,37,0,1,0
12,360,360,63,21,42,3,2
0,409,409,16,8,8,3,2
7,410,410,18,12,6,3,2
2,423,423,19,15,4,2,1
13,451,451,13,10,3,2,1
3,452,452,5,5,0,1,0

14,182,182,2,2,0,1,0
17,189,189,38,38,0,1,0
6,216,216,27,3,24,2,1
15,245,245,52,52,0,1,0
8,247,247,39,15,24,3,2
16,265,265,34,1,33,4,3
2,265,265,2,2,0,1,0
4,272,272,4,4,0,1,0
7,289,289,21,21,0,1,0
1,340,340,25,19,6,3,2
9,356,356,5,2,3,2,1
13,364,364,2,2,0,1,0
12,369,369,41,41,0,1,0
10,379,379,34,14,20,3,2
11,390,390,55,43,12,2,1
5,394,394,13,7,6,3,2
0,418,418,73,15,58,3,2
3,420,420,16,2,14,3,2

2,108,108,7,2,5,2,1
1,118,118,3,3,0,1,0
7,135,135,49,49,0,1,0
10,165,165,4,4,0,1,0
8,186,186,3,3,0,1,0
3,259,259,24,24,0,1,0
9,261,261,34,4,30,2,1
0,303,303,40,40,0,1,0
5,368,368,32,32,0,1,0
11,397,397,70,25,45,2,1
4,413,413,165,143,22,2,1
12,427,427,29,17,12,4,3
6,452,452,18,12,6,3,2

1,128,128,15,15,0,1,0
9,148,148,7,7,0,1,0
0,221,221,15,15,0,1,0
11,233,233,7,7,0,1,0
8,272,272,135,9,126,4,3
6,275,275,46,29,17,2,1
12,293,293,12,1,11,2,1
7,333,333,59,59,0,1,0
13,341,341,4,4,0,1,0
14,348,348,11,11,0,1,0
5,370,370,9,1,8,2,1
3,375,375,36,2,34,3,2
2,410,410,16,3,13,2,1
10,426,426,67,3,64,3,2
4,443,443,50,14,36,4,3

8,116,116,17,5,12,4,3
4,120,120,1,1,0,1,0
5,143,143,11,11,0,1,0
15,151,151,13,13,0,1,0
2,175,175,4,4,0,1,0
14,199,199,23,17,6,3,2
16,218,218,7,7,0,1,0
17,221,221,18,18,0,1,0
0,254,254,62,2,60,4,3
6,287,287,13,13,0,1,0
10,290,290,8,1,7,2,1
3,290,290,12,12,0,1,0
11,339,339,63,16,47,2,1
13,339,339,54,30,24,4,3
12,368,368,57,27,30,4,3
9,406,406,7,7,0,1,0
7,436,436,13,13,0,1,0
1,464,464,65,39,26,2,1

9,113,113,11,11,0,1,0
0,188,188,2,2,0,1,0
10,216,216,38,38,0,1,0
6,225,225,13,13,0,1,0
11,257,257,11,11,0,1,0
12,343,343,13,13,0,1,0
3,352,352,11,6,5,2,1
5,405,405,10,10,0,1,0
7,443,443,110,50,60,4,3
2,450,450,104,80,24,2,1
1,460,460,145,145,0,1,0
8,461,461,72,72,0,1,0
4,489,489,92,64,28,2,1

17,123,123,22,10,12,4,3
12,136,136,13,9,4,2,1
0,172,172,1,1,0,1,0
13,180,180,1,1,0,1,0
10,194,194,12,2,10,4,3
2,236,236,11,1,10,3,2
16,257,257,57,57,0,1,0
8,334,334,40,40,0,1,0
15,335,335,75,24,51,4,3
9,352,352,27,27,0,1,0
11,388,388,21,21,0,1,0
7,393,393,119,119,0,1,0
1,436,436,21,8,13,2,1
14,442,442,15,15,0,1,0
5,467,467,20,20,0,1,0
6,472,472,8,4,4,2,1
4,473,473,37,9,28,4,3
3,490,490,1,1,0,1,0

3,103,103,1,1,0,1,0
6,117,117,13,1,12,4,3
14,131,131,1,1,0,1,0
21,132,132,10,10,0,1,0
17,143,143,25,15,10,2,1
9,159,159,1,1,0,1,0
10,188,188,6,3,3,2,1
23,200,200,18,18,0,1,0
4,228,228,8,8,0,1,0
11,241,241,1,1,0,1,0
5,250,250,4,4,0,1,0
0,269,269,21,2,19,2,1
2,274,274,18,6,12,3,2
1,293,293,53,4,49,2,1
15,310,310,6,6,0,1,0
7,319,319,13,7,6,3,2
22,331,331,49,24,25,4,3
13,352,352,11,2,9,4,3
18,384,384,11,11,0,1,0
19,432,432,13,13,0,1,0
12,475,475,59,9,50,4,3
16,484,484,16,2,14,2,1
20,488,488,131,45,86,4,3
8,493,493,3,3,0,1,0

7,109,109,25,12,13,2,1
3,135,135,24,6,18,4,3
9,239,239,42,42,0,1,0
1,240,240,57,57,0,1,0
5,260,260,8,8,0,1,0
10,277,277,26,17,9,4,3
6,285,285,16,13,3,2,1
0,302,302,76,42,34,2,1
4,309,309,9,9,0,1,0
8,310,310,1,1,0,1,0
13,336,336,65,65,0,1,0
11,340,340,33,33,0,1,0
2,461,461,8,8,0,1,0
12,492,492,11,11,0,1,0

5,160,160,7,1,6,3,2
1,171,171,29,29,0,1,0
12,212,212,7,7,0,1,0
10,215,215,3,3,0,1,0
9,230,230,48,48,0,1,0
0,273,273,12,3,9,4,3
2,318,318,8,8,0,1,0
8,324,324,149,149,0,1,0
7,341,341,11,11,0,1,0
3,351,351,59,29,30,4,3
13,369,369,11,1,10,3,2
4,398,398,34,6,28,3,2
11,429,429,16,16,0,1,0
6,452,452,120,48,72,3,2

9,114,114,4,4,0,1,0
4,159,159,8,8,0,1,0
10,163,163,9,3,6,3,2
3,212,212,1,1,0,1,0
11,233,233,6,6,0,1,0
5,267,267,19,11,8,3,2
8,272,272,111,77,34,2,1
1,373,373,115,32,83,4,3
2,383,383,6,6,0,1,0
12,386,386,64,64,0,1,0
0,417,417,147,76,71,4,3
7,426,426,16,8,8,2,1
6,452,452,40,40,0,1,0

11,113,113,5,2,3,2,1
12,154,154,1,1,0,1,0
10,157,157,56,4,52,3,2
15,187,187,6,6,0,1,0
0,189,189,16,3,13,4,3
13,196,196,9,4,5,2,1
14,255,255,58,24,34,3,2
8,289,289,10,6,4,2,1
4,307,307,28,6,22,2,1
1,378,378,25,25,0,1,0
3,395,395,39,39,0,1,0
6,416,416,8,3,5,2,1
7,420,420,78,36,42,4,3
9,470,470,52,52,0,1,0
2,471,471,95,6,89,4,3
5,486,486,10,3,7,2,1

9,105,105,8,8,0,1,0
1,222,222,5,5,0,1,0
4,246,246,15,15,0,1,0
17,253,253,10,10,0,1,0
6,274,274,12,12,0,1,0
2,296,296,57,57,0,1,0
14,296,296,101,101,0,1,0
7,322,322,7,7,0,1,0
13,339,339,12,12,0,1,0
12,355,355,52,29,23,2,1
11,394,394,5,5,0,1,0
5,423,423,55,44,11,4,3
0,434,434,13,13,0,1,0
15,447,447,53,43,10,3,2
16,473,473,55,55,0,1,0
10,494,494,2,2,0,1,0
8,497,497,102,102,0,1,0
3,498,498,7,7,0,1,0

2,121,121,20,8,12,4,3
6,132,132,2,2,0,1,0
4,141,141,5,5,0,1,0
12,151,151,13,13,0,1,0
16,191,191,4,4,0,1,0
9,196,196,12,12,0,1,0
13,215,215,34,34,0,1,0
14,289,289,56,56,0,1,0
15,310,310,58,36,22,2,1
7,318,318,7,7,0,1,0
1,357,357,45,27,18,3,2
5,375,375,50,17,33,4,3
0,384,384,28,8,20,2,1
3,388,388,3,3,0,1,0
8,441,441,72,35,37,3,2
10,455,455,5,5,0,1,0
11,481,481,75,49,26,2,1

9,102,102,3,3,0,1,0
12,133,133,16,16,0,1,0
14,143,143,1,1,0,1,0
6,180,180,24,14,10,3,2
11,214,214,36,36,0,1,0
4,222,222,1,1,0,1,0
10,280,280,15,3,12,3,2
5,290,290,3,3,0,1,0
3,298,298,103,21,82,4,3
16,304,304,48,48,0,1,0
8,323,323,10,10,0,1,0
15,371,371,89,89,0,1,0
7,396,396,28,4,24,3,2
13,396,396,46,46,0,1,0
1,420,420,7,7,0,1,0
17,442,442,1,1,0,1,0
2,469,469,29,29,0,1,0
0,471,471,21,21,0,1,0

2,209,209,9,9,0,1,0
11,213,213,8,8,0,1,0
12,226,226,16,5,11,2,1
13,270,270,3,3,0,1,0
9,309,309,17,5,12,4,3
1,312,312,67,1,66,4,3
5,315,315,28,28,0,1,0
8,329,329,26,26,0,1,0
6,339,339,53,53,0,1,0
10,362,362,78,78,0,1,0
4,376,376,24,24,0,1,0
3,411,411,35,35,0,1,0
0,439,439,65,19,46,4,3
7,448,448,154,76,78,4,3

6,118,118,18,18,0,1,0
4,123,123,24,2,22,2,1
10,164,164,2,2,0,1,0
0,169,169,64,28,36,3,2
11,187,187,32,32,0,1,0
1,192,192,20,3,17,2,1
3,236,236,1,1,0,1,0
7,283,283,11,8,3,2,1
2,306,306,4,4,0,1,0
8,310,310,76,76,0,1,0
5,350,350,37,21,16,2,1
12,385,385,20,8,12,4,3
9,447,447,63,17,46,3,2

0,117,117,10,5,5,2,1
2,140,140,56,21,35,3,2
8,248,248,14,14,0,1,0
4,259,259,30,30,0,1,0
3,326,326,64,51,13,2,1
9,410,410,55,55,0,1,0
1,411,411,132,87,45,4,3
7,416,416,4,4,0,1,0
6,481,481,40,40,0,1,0
5,485,485,104,98,6,3,2

2,104,104,1,1,0,1,0
10,163,163,12,12,0,1,0
3,170,170,39,39,0,1,0
13,204,204,6,2,4,2,1
6,266,266,7,7,0,1,0
5,292,292,12,12,0,1,0
8,320,320,3,3,0,1,0
11,320,320,7,7,0,1,0
1,326,326,18,4,14,4,3
0,334,334,43,3,40,2,1
14,410,410,4,1,3,2,1
12,411,411,200,182,18,4,3
9,457,457,82,15,67,4,3
4,460,460,101,65,36,3,2
7,462,462,42,4,38,3,2

3,169,169,16,11,5,2,1
2,189,189,1,1,0,1,0
13,193,193,16,16,0,1,0
6,222,222,20,20,0,1,0
12,241,241,70,2,68,3,2
5,263,263,1,1,0,1,0
16,268,268,42,30,12,2,1
10,290,290,28,2,26,2,1
0,294,294,26,26,0,1,0
8,352,352,33,33,0,1,0
15,372,372,15,15,0,1,0
11,377,377,36,8,28,2,1
14,462,462,26,6,20,3,2
7,479,479,59,59,0,1,0
1,485,485,17,11,6,3,2
4,487,487,30,6,24,4,3
9,496,496,102,102,0,1,0

2,112,112,27,27,0,1,0
11,118,118,18,9,9,2,1
3,149,149,8,5,3,2,1
12,168,168,16,16,0,1,0
10,195,195,37,37,0,1,0
8,197,197,21,21,0,1,0
7,214,214,46,8,38,4,3
0,231,231,14,2,12,2,1
9,311,311,6,2,4,2,1
1,374,374,29,29,0,1,0
6,391,391,15,3,12,3,2
5,398,398,112,50,62,3,2
4,450,450,39,11,28,2,1

10,135,135,13,13,0,1,0
2,170,170,4,4,0,1,0
11,174,174,11,7,4,2,1
8,276,276,20,12,8,2,1
3,297,297,102,84,18,4,3
4,326,326,11,2,9,4,3
9,333,333,18,4,14,3,2
7,357,357,4,4,0,1,0
5,360,360,118,49,69,4,3
6,361,361,69,59,10,2,1
0,441,441,170,74,96,3,2
1,498,498,8,8,0,1,0

7,161,161,7,7,0,1,0
9,191,191,14,6,8,3,2
8,221,221,8,8,0,1,0
11,262,262,104,76,28,2,1
3,288,288,19,13,6,2,1
6,318,318,41,35,6,3,2
12,319,319,48,48,0,1,0
5,345,345,94,36,58,3,2
1,364,364,17,4,13,2,1
0,397,397,42,16,26,3,2
13,405,405,9,9,0,1,0
4,409,409,4,4,0,1,0
10,417,417,27,27,0,1,0
14,467,467,32,14,18,3,2
2,468,468,60,60,0,1,0

11,105,105,3,3,0,1,0
15,131,131,4,4,0,1,0
4,133,133,3,3,0,1,0
8,176,176,14,14,0,1,0
5,203,203,73,67,6,2,1
10,212,212,39,21,18,2,1
9,225,225,3,3,0,1,0
1,233,233,1,1,0,1,0
16,240,240,48,20,28,3,2
13,259,259,48,21,27,4,3
2,272,272,15,15,0,1,0
12,347,347,47,47,0,1,0
7,376,376,15,15,0,1,0
6,393,393,26,16,10,3,2
3,419,419,54,40,14,2,1
0,464,464,15,1,14,3,2
14,480,480,25,10,15,4,3

6,109,109,3,3,0,1,0
4,232,232,2,2,0,1,0
2,253,253,49,5,44,3,2
11,253,253,5,5,0,1,0
0,258,258,43,43,0,1,0
1,284,284,45,5,40,3,2
13,309,309,30,14,16,3,2
15,350,350,46,25,21,4,3
5,358,358,11,1,10,3,2
9,401,401,108,108,0,1,0
10,403,403,32,29,3,2,1
7,438,438,10,5,5,2,1
3,445,445,63,34,29,2,1
12,453,453,36,6,30,3,2
14,464,464,61,31,30,4,3
8,484,484,25,25,0,1,0

7,134,134,18,18,0,1,0
0,140,140,14,14,0,1,0
13,157,157,27,7,20,3,2
14,160,160,8,8,0,1,0
10,176,176,37,22,15,4,3
9,178,178,8,8,0,1,0
12,186,186,14,14,0,1,0
2,197,197,34,34,0,1,0
3,250,250,58,58,0,1,0
1,306,306,5,5,0,1,0
5,350,350,41,41,0,1,0
8,360,360,93,93,0,1,0
11,402,402,3,3,0,1,0
4,441,441,1,1,0,1,0
6,497,497,14,2,12,3,2

10,107,107,2,2,0,1,0
8,117,117,11,11,0,1,0
7,224,224,29,26,3,2,1
11,306,306,44,24,20,2,1
3,334,334,63,24,39,4,3
4,352,352,74,74,0,1,0
9,392,392,119,65,54,3,2
0,400,400,58,26,32,3,2
2,408,408,22,22,0,1,0
5,428,428,40,40,0,1,0
1,449,449,92,11,81,4,3
6,480,480,16,10,6,3,2

13,115,115,2,2,0,1,0
6,163,163,22,22,0,1,0
3,167,167,6,6,0,1,0
11,182,182,6,6,0,1,0
2,207,207,1,1,0,1,0
8,295,295,51,51,0,1,0
7,355,355,14,2,12,3,2
15,383,383,2,2,0,1,0
1,385,385,17,17,0,1,0
9,388,388,46,22,24,2,1
14,408,408,171,108,63,4,3
5,440,440,60,36,24,4,3
12,440,440,36,24,12,4,3
0,447,447,25,9,16,3,2
10,455,455,60,60,0,1,0
4,456,456,81,81,0,1,0

8,127,127,26,26,0,1,0
0,178,178,35,26,9,4,3
6,180,180,23,17,6,3,2
9,210,210,64,64,0,1,0
3,338,338,54,38,16,2,1
2,409,409,15,15,0,1,0
5,414,414,10,4,6,2,1
4,417,417,1,1,0,1,0
11,420,420,35,35,0,1,0
12,422,422,9,9,0,1,0
1,431,431,164,26,138,4,3
10,485,485,28,28,0,1,0
7,489,489,5,5,0,1,0

13,123,123,11,1,10,2,1
6,129,129,1,1,0,1,0
8,134,134,31,31,0,1,0
7,204,204,25,3,22,2,1
0,208,208,27,27,0,1,0
4,222,222,1,1,0,1,0
15,229,229,50,38,12,4,3
1,277,277,24,7,17,2,1
10,277,277,23,23,0,1,0
3,331,331,9,9,0,1,0
2,333,333,64,64,0,1,0
12,340,340,44,5,39,4,3
14,411,411,80,47,33,4,3
5,434,434,1,1,0,1,0
9,441,441,1,1,0,1,0
11,478,478,44,20,24,4,3

1,144,144,3,3,0,1,0
2,144,144,1,1,0,1,0
4,148,148,22,10,12,2,1
3,173,173,2,2,0,1,0
8,221,221,17,5,12,2,1
14,238,238,30,30,0,1,0
6,286,286,95,95,0,1,0
9,289,289,83,21,62,4,3
10,290,290,27,27,0,1,0
11,366,366,31,31,0,1,0
0,393,393,17,17,0,1,0
12,421,421,25,4,21,3,2
7,423,423,59,59,0,1,0
13,431,431,35,30,5,2,1
5,474,474,47,6,41,2,1

2,155,155,8,8,0,1,0
15,158,158,29,29,0,1,0
8,176,176,3,3,0,1,0
13,177,177,16,6,10,2,1
9,217,217,11,11,0,1,0
5,245,245,99,99,0,1,0
11,275,275,3,3,0,1,0
12,310,310,80,80,0,1,0
6,314,314,20,20,0,1,0
3,335,335,65,65,0,1,0
1,347,347,1,1,0,1,0
4,363,363,22,22,0,1,0
7,379,379,1,1,0,1,0
0,439,439,3,3,0,1,0
14,448,448,63,6,57,4,3
10,488,488,37,31,6,2,1

4,101,101,1,1,0,1,0
14,135,135,1,1,0,1,0
12,155,155,27,8,19,3,2
8,203,203,24,5,19,2,1
1,214,214,7,7,0,1,0
6,232,232,32,32,0,1,0
19,262,262,14,14,0,1,0
9,273,273,13,13,0,1,0
0,286,286,14,7,7,2,1
16,290,290,13,4,9,4,3
2,316,316,19,19,0,1,0
11,320,320,8,1,7,2,1
7,321,321,9,9,0,1,0
17,378,378,13,13,0,1,0
3,393,393,25,17,8,3,2
10,408,408,3,3,0,1,0
15,416,416,110,60,50,3,2
18,430,430,111,15,96,3,2
13,487,487,72,46,26,4,3
5,493,493,26,26,0,1,0

13,169,169,3,3,0,1,0
11,187,187,7,1,6,2,1
0,221,221,29,29,0,1,0
6,232,232,3,3,0,1,0
15,268,268,11,11,0,1,0
1,284,284,14,14,0,1,0
8,295,295,1,1,0,1,0
16,340,340,73,37,36,4,3
5,348,348,26,12,14,3,2
12,390,390,40,40,0,1,0
17,395,395,107,107,0,1,0
10,405,405,31,3,28,3,2
9,429,429,65,65,0,1,0
3,446,446,17,8,9,4,3
18,463,463,13,7,6,3,2
14,470,470,63,63,0,1,0
2,482,482,1,1,0,1,0
7,484,484,7,7,0,1,0
4,489,489,104,44,60,3,2

6,142,142,5,5,0,1,0
5,163,163,17,8,9,2,1
1,173,173,20,20,0,1,0
0,192,192,1,1,0,1,0
3,204,204,19,3,16,2,1
8,249,249,6,3,3,2,1
11,249,249,22,2,20,3,2
14,259,259,73,9,64,3,2
12,267,267,83,57,26,3,2
9,306,306,23,11,12,4,3
4,383,383,50,14,36,2,1
10,461,461,4,4,0,1,0
7,469,469,139,89,50,3,2
2,476,476,10,1,9,4,3
13,497,497,13,13,0,1,0

9,123,123,16,4,12,3,2
11,132,132,3,3,0,1,0
2,145,145,33,33,0,1,0
5,152,152,1,1,0,1,0
4,158,158,6,6,0,1,0
8,177,177,4,4,0,1,0
17,191,191,30,9,21,2,1
12,200,200,5,5,0,1,0
3,307,307,22,1,21,2,1
15,359,359,27,27,0,1,0
10,376,376,10,5,5,2,1
7,391,391,63,45,18,2,1
14,393,393,40,13,27,4,3
19,416,416,49,49,0,1,0
0,418,418,12,12,0,1,0
1,429,429,15,4,11,2,1
18,437,437,5,5,0,1,0
6,451,451,3,3,0,1,0
13,482,482,98,38,60,3,2
16,498,498,70,44,26,4,3

0,132,132,5,5,0,1,0
11,146,146,3,3,0,1,0
14,182,182,23,23,0,1,0
15,182,182,15,12,3,2,1
3,228,228,61,61,0,1,0
1,230,230,4,4,0,1,0
2,248,248,16,9,7,2,1
6,252,252,25,25,0,1,0
9,261,261,53,21,32,2,1
10,268,268,8,8,0,1,0
5,277,277,16,4,12,2,1
13,296,296,69,41,28,3,2
7,298,298,14,9,5,2,1
12,325,325,41,23,18,2,1
4,335,335,1,1,0,1,0
8,496,496,103,69,34,3,2

7,198,198,51,51,0,1,0
11,244,244,27,8,19,4,3
2,248,248,35,35,0,1,0
9,266,266,16,16,0,1,0
8,273,273,40,3,37,2,1
0,340,340,129,129,0,1,0
13,370,370,71,6,65,4,3
5,382,382,2,2,0,1,0
4,391,391,60,60,0,1,0
10,440,440,17,17,0,1,0
6,460,460,1,1,0,1,0
1,461,461,18,9,9,4,3
12,469,469,4,4,0,1,0
3,495,495,40,40,0,1,0

6,149,149,22,3,19,2,1
11,162,162,14,14,0,1,0
3,174,174,13,13,0,1,0
7,263,263,6,6,0,1,0
1,313,313,50,50,0,1,0
4,325,325,10,10,0,1,0
10,351,351,26,26,0,1,0
0,402,402,44,25,19,2,1
9,442,442,46,46,0,1,0
5,449,449,42,4,38,3,2
2,451,451,150,31,119,4,3
12,466,466,61,61,0,1,0
8,468,468,117,85,32,2,1

6,113,113,1,1,0,1,0
18,116,116,11,11,0,1,0
17,128,128,10,1,9,2,1
16,131,131,24,24,0,1,0
1,143,143,19,19,0,1,0
4,162,162,5,1,4,2,1
20,182,182,6,3,3,2,1
10,183,183,29,20,9,4,3
5,199,199,2,2,0,1,0
8,207,207,8,8,0,1,0
14,239,239,2,2,0,1,0
15,244,244,46,46,0,1,0
2,295,295,11,11,0,1,0
9,297,297,15,7,8,2,1
21,336,336,70,51,19,4,3
13,342,342,24,24,0,1,0
3,376,376,2,2,0,1,0
0,396,396,21,21,0,1,0
19,437,437,14,14,0,1,0
7,447,447,79,79,0,1,0
12,450,450,1,1,0,1,0
11,460,460,9,6,3,2,1

12,127,127,10,10,0,1,0
6,160,160,14,10,4,2,1
9,184,184,34,29,5,2,1
7,225,225,14,2,12,4,3
4,242,242,33,3,30,2,1
5,276,276,65,65,0,1,0
0,304,304,36,29,7,2,1
13,328,328,78,6,72,4,3
8,329,329,31,10,21,2,1
3,379,379,2,2,0,1,0
10,398,398,17,17,0,1,0
11,409,409,49,17,32,2,1
1,445,445,72,72,0,1,0
2,457,457,26,4,22,3,2

1,125,125,18,18,0,1,0
15,151,151,14,14,0,1,0
4,165,165,7,7,0,1,0
10,165,165,8,8,0,1,0
3,188,188,1,1,0,1,0
17,192,192,28,22,6,3,2
7,237,237,11,11,0,1,0
8,296,296,16,16,0,1,0
16,332,332,149,149,0,1,0
6,388,388,92,5,87,4,3
0,397,397,5,1,4,2,1
13,397,397,13,13,0,1,0
5,401,401,43,12,31,2,1
2,423,423,22,22,0,1,0
11,432,432,5,5,0,1,0
9,440,440,24,24,0,1,0
14,456,456,29,29,0,1,0
12,495,495,10,10,0,1,0

12,102,102,6,6,0,1,0
10,111,111,24,14,10,2,1
11,125,125,10,10,0,1,0
13,181,181,3,3,0,1,0
1,252,252,69,69,0,1,0
7,294,294,2,2,0,1,0
6,298,298,31,22,9,4,3
5,306,306,7,7,0,1,0
0,330,330,6,1,5,2,1
8,365,365,28,18,10,3,2
4,367,367,16,8,8,2,1
9,373,373,16,16,0,1,0
3,394,394,27,15,12,3,2
15,407,407,141,121,20,2,1
14,461,461,26,26,0,1,0
2,463,463,87,87,0,1,0

6,101,101,1,1,0,1,0
0,115,115,4,4,0,1,0
11,206,206,53,53,0,1,0
5,226,226,85,51,34,2,1
15,254,254,57,18,39,2,1
8,261,261,6,6,0,1,0
4,290,290,22,9,13,2,1
9,358,358,2,2,0,1,0
14,366,366,25,17,8,3,2
1,430,430,19,19,0,1,0
13,434,434,21,21,0,1,0
3,455,455,34,34,0,1,0
2,463,463,17,17,0,1,0
10,472,472,47,21,26,2,1
7,485,485,59,23,36,2,1
16,487,487,22,22,0,1,0
12,497,497,33,33,0,1,0

9,122,122,5,5,0,1,0
12,159,159,16,12,4,2,1
8,161,161,5,5,0,1,0
7,168,168,40,40,0,1,0
10,230,230,34,34,0,1,0
14,248,248,44,36,8,3,2
2,266,266,25,25,0,1,0
6,289,289,2,2,0,1,0
3,339,339,7,7,0,1,0
0,346,346,34,34,0,1,0
4,358,358,9,9,0,1,0
13,362,362,9,9,0,1,0
5,412,412,34,2,32,3,2
15,423,423,31,31,0,1,0
11,469,469,120,120,0,1,0
1,500,500,102,6,96,4,3

15,141,141,15,15,0,1,0
9,142,142,15,15,0,1,0
12,157,157,23,23,0,1,0
4,250,250,6,6,0,1,0
10,275,275,72,72,0,1,0
8,279,279,57,30,27,2,1
5,316,316,20,14,6,2,1
6,334,334,57,27,30,2,1
1,368,368,45,28,17,2,1
11,392,392,6,6,0,1,0
0,417,417,1,1,0,1,0
2,418,418,36,36,0,1,0
3,429,429,3,3,0,1,0
13,451,451,72,8,64,3,2
7,473,473,57,57,0,1,0
14,477,477,9,9,0,1,0

0,100,100,1,1,0,1,0
13,129,129,7,3,4,2,1
5,151,151,36,36,0,1,0
12,162,162,10,10,0,1,0
2,183,183,3,3,0,1,0
8,238,238,50,7,43,3,2
4,315,315,56,56,0,1,0
6,325,325,72,30,42,3,2
9,332,332,7,1,6,2,1
3,408,408,22,3,19,3,2
11,420,420,43,43,0,1,0
1,431,431,36,30,6,2,1
10,435,435,66,27,39,4,3
7,436,436,93,21,72,3,2

3,100,100,14,14,0,1,0
8,136,136,17,12,5,2,1
12,146,146,9,4,5,2,1
5,151,151,12,5,7,2,1
0,202,202,2,2,0,1,0
6,207,207,19,3,16,2,1
4,230,230,4,1,3,2,1
10,253,253,50,50,0,1,0
9,305,305,12,12,0,1,0
14,342,342,57,20,37,2,1
13,359,359,42,42,0,1,0
1,380,380,19,6,13,2,1
11,463,463,49,7,42,3,2
2,483,483,30,4,26,3,2
7,496,496,174,118,56,4,3

7,117,117,15,9,6,2,1
5,158,158,11,11,0,1,0
0,215,215,7,7,0,1,0
2,228,228,11,11,0,1,0
10,231,231,15,15,0,1,0
6,240,240,107,9,98,4,3
1,249,249,5,5,0,1,0
3,308,308,84,62,22,2,1
8,377,377,15,15,0,1,0
9,385,385,32,4,28,2,1
12,415,415,10,10,0,1,0
11,437,437,13,13,0,1,0
4,472,472,169,169,0,1,0

2,144,144,13,4,9,2,1
13,166,166,31,31,0,1,0
10,180,180,2,2,0,1,0
5,234,234,9,4,5,2,1
6,261,261,37,29,8,2,1
7,276,276,40,22,18,3,2
3,329,329,75,75,0,1,0
12,351,351,20,1,19,4,3
4,391,391,11,2,9,2,1
9,434,434,54,20,34,2,1
11,442,442,100,100,0,1,0
1,445,445,80,80,0,1,0
0,476,476,46,43,3,2,1
8,493,493,28,28,0,1,0

14,116,116,11,2,9,2,1
0,183,183,7,7,0,1,0
8,183,183,13,13,0,1,0
1,187,187,19,19,0,1,0
10,199,199,18,8,10,2,1
2,286,286,28,22,6,2,1
11,290,290,98,98,0,1,0
12,298,298,34,34,0,1,0
7,309,309,4,4,0,1,0
5,311,311,36,5,31,4,3
9,356,356,21,7,14,3,2
4,359,359,80,9,71,3,2
6,454,454,94,32,62,3,2
3,456,456,2,2,0,1,0
13,472,472,24,8,16,3,2

2,106,106,21,21,0,1,0
10,111,111,16,3,13,2,1
3,154,154,4,4,0,1,0
8,157,157,3,3,0,1,0
9,264,264,65,65,0,1,0
12,303,303,34,28,6,3,2
14,310,310,3,3,0,1,0
13,319,319,85,85,0,1,0
5,331,331,13,13,0,1,0
7,343,343,4,4,0,1,0
0,367,367,57,15,42,3,2
11,373,373,6,6,0,1,0
1,417,417,89,31,58,3,2
4,447,447,9,5,4,2,1
6,462,462,63,63,0,1,0

11,128,128,39,39,0,1,0
1,141,141,1,1,0,1,0
6,155,155,4,4,0,1,0
3,185,185,1,1,0,1,0
0,237,237,31,31,0,1,0
13,258,258,8,8,0,1,0
12,268,268,17,11,6,3,2
5,283,283,70,70,0,1,0
9,288,288,33,33,0,1,0
7,302,302,4,4,0,1,0
15,364,364,99,99,0,1,0
8,426,426,14,7,7,2,1
14,448,448,35,35,0,1,0
17,454,454,13,13,0,1,0
4,460,460,75,75,0,1,0
2,461,461,1,1,0,1,0
10,478,478,28,1,27,4,3
16,500,500,18,1,17,4,3

10,172,172,4,1,3,2,1
5,217,217,5,2,3,2,1
3,247,247,50,50,0,1,0
7,268,268,11,8,3,2,1
1,287,287,41,41,0,1,0
11,314,314,21,5,16,2,1
2,323,323,63,63,0,1,0
9,340,340,55,23,32,3,2
6,386,386,120,76,44,2,1
8,468,468,88,79,9,2,1
0,480,480,108,108,0,1,0
4,500,500,18,18,0,1,0

9,131,131,8,3,5,2,1
7,148,148,2,2,0,1,0
4,157,157,1,1,0,1,0
11,188,188,36,18,18,3,2
12,234,234,86,66,20,3,2
15,238,238,7,7,0,1,0
10,240,240,20,4,16,3,2
13,243,243,2,2,0,1,0
8,264,264,7,3,4,2,1
16,310,310,41,41,0,1,0
2,348,348,27,9,18,4,3
14,382,382,16,16,0,1,0
1,398,398,22,22,0,1,0
0,405,405,57,26,31,2,1
3,419,419,1,1,0,1,0
6,455,455,105,105,0,1,0
17,468,468,22,5,17,3,2
5,492,492,51,22,29,4,3

5,127,127,1,1,0,1,0
1,223,223,13,5,8,3,2
13,298,298,12,12,0,1,0
3,302,302,32,2,30,4,3
9,303,303,46,46,0,1,0
7,305,305,24,24,0,1,0
0,310,310,108,108,0,1,0
8,315,315,20,2,18,4,3
4,332,332,28,28,0,1,0
11,414,414,95,63,32,4,3
10,422,422,29,15,14,3,2
6,450,450,8,3,5,2,1
12,489,489,86,56,30,4,3
2,490,490,87,66,21,2,1

8,114,114,1,1,0,1,0
3,133,133,12,12,0,1,0
9,147,147,2,2,0,1,0
5,150,150,3,3,0,1,0
14,157,157,14,14,0,1,0
7,177,177,36,26,10,2,1
1,188,188,1,1,0,1,0
13,194,194,20,20,0,1,0
17,208,208,44,20,24,4,3
18,208,208,7,7,0,1,0
4,240,240,5,5,0,1,0
12,247,247,67,53,14,3,2
0,302,302,48,38,10,3,2
6,338,338,74,74,0,1,0
10,382,382,12,4,8,3,2
11,409,409,5,1,4,2,1
16,425,425,7,7,0,1,0
15,476,476,40,10,30,3,2
2,484,484,8,8,0,1,0

11,163,163,8,2,6,2,1
1,184,184,14,14,0,1,0
10,189,189,20,20,0,1,0
4,200,200,31,15,16,2,1
5,213,213,23,6,17,2,1
6,219,219,6,2,4,2,1
7,237,237,5,5,0,1,0
14,243,243,11,11,0,1,0
9,244,244,2,2,0,1,0
2,282,282,4,4,0,1,0
13,302,302,3,3,0,1,0
12,310,310,105,57,48,4,3
8,344,344,18,18,0,1,0
18,365,365,15,15,0,1,0
3,372,372,25,25,0,1,0
15,405,405,72,15,57,4,3
17,429,429,82,24,58,3,2
16,450,450,5,5,0,1,0
0,467,467,54,12,42,4,3

0,107,107,7,7,0,1,0
6,117,117,1,1,0,1,0
2,124,124,2,2,0,1,0
7,130,130,7,1,6,3,2
8,148,148,12,9,3,2,1
17,171,171,29,4,25,2,1
4,185,185,30,30,0,1,0
3,198,198,11,11,0,1,0
10,263,263,45,22,23,2,1
12,275,275,9,6,3,2,1
9,288,288,3,3,0,1,0
5,300,300,26,26,0,1,0
1,352,352,16,10,6,2,1
13,365,365,28,28,0,1,0
16,405,405,24,24,0,1,0
14,423,423,67,67,0,1,0
15,434,434,63,63,0,1,0
11,475,475,21,11,10,3,2
18,477,477,82,40,42,4,3

0,106,106,5,5,0,1,0
19,122,122,31,31,0,1,0
2,134,134,10,10,0,1,0
7,141,141,8,3,5,2,1
4,178,178,8,8,0,1,0
1,183,183,22,5,17,2,1
15,218,218,10,7,3,2,1
18,274,274,53,53,0,1,0
9,274,274,18,3,15,2,1
8,313,313,39,10,29,2,1
6,334,334,13,13,0,1,0
3,363,363,36,36,0,1,0
11,374,374,13,5,8,3,2
16,379,379,36,36,0,1,0
5,390,390,4,4,0,1,0
14,428,428,18,18,0,1,0
13,444,444,81,28,53,3,2
17,451,451,1,1,0,1,0
10,490,490,19,19,0,1,0
12,494,494,22,6,16,3,2

0,119,119,9,9,0,1,0
10,128,128,9,9,0,1,0
11,139,139,2,2,0,1,0
2,143,143,10,10,0,1,0
5,190,190,25,13,12,4,3
3,227,227,1,1,0,1,0
15,269,269,9,9,0,1,0
6,298,298,12,3,9,4,3
1,307,307,9,3,6,3,2
8,349,349,106,66,40,2,1
4,355,355,5,5,0,1,0
16,356,356,36,36,0,1,0
9,356,356,19,19,0,1,0
12,364,364,167,103,64,3,2
7,410,410,32,32,0,1,0
13,416,416,39,36,3,2,1
14,491,491,20,20,0,1,0

8,111,111,19,19,0,1,0
10,124,124,11,6,5,2,1
3,144,144,2,2,0,1,0
4,186,186,38,27,11,2,1
1,187,187,3,3,0,1,0
5,221,221,5,5,0,1,0
11,230,230,6,6,0,1,0
6,247,247,5,5,0,1,0
7,260,260,29,10,19,2,1
16,317,317,18,18,0,1,0
14,329,329,102,102,0,1,0
12,350,350,18,13,5,2,1
15,354,354,2,2,0,1,0
0,362,362,22,22,0,1,0
9,397,397,1,1,0,1,0
2,400,400,36,36,0,1,0
13,458,458,158,130,28,2,1
17,464,464,8,8,0,1,0

12,116,116,1,1,0,1,0
5,122,122,11,11,0,1,0
3,232,232,22,17,5,2,1
1,275,275,44,9,35,2,1
0,304,304,12,3,9,4,3
4,311,311,58,8,50,3,2
2,321,321,5,5,0,1,0
13,330,330,107,47,60,4,3
8,361,361,4,4,0,1,0
7,405,405,70,70,0,1,0
10,417,417,8,4,4,2,1
11,418,418,52,22,30,3,2
9,429,429,87,45,42,2,1
6,451,451,19,19,0,1,0
14,500,500,59,11,48,2,1

7,113,113,20,20,0,1,0
4,121,121,14,14,0,1,0
10,130,130,1,1,0,1,0
0,179,179,3,3,0,1,0
5,187,187,30,25,5,2,1
12,205,205,22,22,0,1,0
9,232,232,7,7,0,1,0
2,253,253,9,3,6,2,1
6,258,258,10,10,0,1,0
19,296,296,50,50,0,1,0
14,300,300,61,61,0,1,0
3,315,315,1,1,0,1,0
17,321,321,66,23,43,4,3
16,354,354,18,18,0,1,0
15,365,365,49,17,32,3,2
13,383,383,6,6,0,1,0
18,395,395,14,14,0,1,0
1,420,420,11,5,6,3,2
11,479,479,19,7,12,2,1
8,486,486,21,12,9,2,1

7,117,117,22,22,0,1,0
2,135,135,2,2,0,1,0
14,183,183,34,34,0,1,0
6,203,203,52,7,45,3,2
10,216,216,9,9,0,1,0
9,259,259,1,1,0,1,0
12,277,277,18,18,0,1,0
11,309,309,95,23,72,4,3
0,326,326,1,1,0,1,0
5,353,353,21,21,0,1,0
3,379,379,14,2,12,3,2
15,390,390,27,2,25,3,2
1,394,394,16,16,0,1,0
13,410,410,58,58,0,1,0
4,432,432,19,15,4,2,1
8,494,494,78,6,72,4,3

10,134,134,10,10,0,1,0
17,137,137,7,7,0,1,0
14,158,158,3,3,0,1,0
9,204,204,11,2,9,2,1
11,213,213,3,3,0,1,0
15,234,234,42,30,12,2,1
5,264,264,17,7,10,3,2
4,291,291,13,13,0,1,0
6,294,294,17,2,15,2,1
0,306,306,20,12,8,3,2
16,378,378,28,1,27,4,3
3,395,395,17,17,0,1,0
13,405,405,8,8,0,1,0
8,421,421,40,40,0,1,0
7,436,436,31,31,0,1,0
12,476,476,217,123,94,3,2
2,480,480,68,17,51,4,3
1,485,485,45,45,0,1,0

3,111,111,11,11,0,1,0
12,144,144,24,8,16,2,1
8,177,177,12,7,5,2,1
11,205,205,10,2,8,2,1
5,220,220,1,1,0,1,0
6,241,241,20,6,14,3,2
14,246,246,115,94,21,2,1
1,276,276,20,11,9,4,3
10,278,278,2,2,0,1,0
2,313,313,68,19,49,3,2
9,315,315,4,4,0,1,0
13,330,330,4,4,0,1,0
17,350,350,11,11,0,1,0
7,356,356,41,8,33,2,1
18,368,368,1,1,0,1,0
15,380,380,42,15,27,2,1
0,392,392,6,3,3,2,1
16,418,418,9,9,0,1,0
4,488,488,30,3,27,4,3

14,110,110,4,4,0,1,0
10,114,114,5,5,0,1,0
7,173,173,15,15,0,1,0
9,189,189,7,4,3,2,1
15,253,253,96,96,0,1,0
11,258,258,8,8,0,1,0
3,314,314,12,2,10,2,1
0,328,328,10,10,0,1,0
8,377,377,4,4,0,1,0
4,395,395,29,9,20,2,1
2,434,434,1,1,0,1,0
5,442,442,88,12,76,3,2
13,446,446,98,98,0,1,0
12,466,466,34,3,31,2,1
6,484,484,159,99,60,4,3
1,488,488,15,15,0,1,0

12,109,109,10,2,8,2,1
11,142,142,2,2,0,1,0
17,145,145,28,4,24,3,2
13,151,151,3,3,0,1,0
1,155,155,1,1,0,1,0
16,232,232,26,26,0,1,0
7,259,259,11,1,10,3,2
3,288,288,25,25,0,1,0
9,325,325,37,37,0,1,0
2,327,327,25,25,0,1,0
15,346,346,43,43,0,1,0
0,394,394,46,34,12,2,1
14,421,421,32,7,25,2,1
18,437,437,88,43,45,4,3
10,443,443,26,26,0,1,0
4,460,460,17,17,0,1,0
5,468,468,99,1,98,3,2
6,474,474,19,11,8,2,1
8,480,480,1,1,0,1,0

6,116,116,7,7,0,1,0
0,141,141,35,23,12,3,2
9,149,149,24,8,16,2,1
2,208,208,8,8,0,1,0
10,211,211,24,24,0,1,0
3,216,216,23,8,15,3,2
1,230,230,42,2,40,3,2
8,294,294,33,33,0,1,0
12,320,320,31,31,0,1,0
7,332,332,69,28,41,2,1
4,410,410,16,3,13,2,1
11,414,414,26,16,10,3,2
5,482,482,90,56,34,4,3

5,110,110,15,15,0,1,0
6,116,116,52,52,0,1,0
4,153,153,15,11,4,2,1
11,199,199,12,3,9,4,3
0,239,239,17,8,9,2,1
8,240,240,9,2,7,2,1
12,278,278,10,10,0,1,0
1,280,280,1,1,0,1,0
2,295,295,19,19,0,1,0
7,322,322,21,4,17,4,3
9,376,376,51,51,0,1,0
3,445,445,190,84,106,4,3
10,493,493,16,16,0,1,0

6,105,105,31,31,0,1,0
12,156,156,16,16,0,1,0
5,165,165,9,9,0,1,0
2,208,208,1,1,0,1,0
7,230,230,36,14,22,2,1
1,273,273,3,3,0,1,0
13,297,297,46,1,45,4,3
8,338,338,20,20,0,1,0
3,356,356,6,6,0,1,0
0,366,366,52,52,0,1,0
4,367,367,45,21,24,2,1
10,407,407,21,5,16,2,1
9,415,415,28,28,0,1,0
11,423,423,26,26,0,1,0
14,469,469,148,77,71,4,3

15,105,105,24,24,0,1,0
9,125,125,5,5,0,1,0
6,164,164,25,13,12,4,3
12,203,203,5,5,0,1,0
10,250,250,32,32,0,1,0
0,254,254,2,2,0,1,0
11,261,261,30,8,22,3,2
3,262,262,7,7,0,1,0
1,273,273,35,21,14,3,2
8,281,281,64,30,34,2,1
7,293,293,46,31,15,2,1
5,351,351,23,10,13,2,1
13,395,395,38,38,0,1,0
4,456,456,13,6,7,3,2
14,493,493,89,50,39,4,3
2,496,496,4,4,0,1,0

9,102,102,3,3,0,1,0
3,157,157,5,5,0,1,0
13,210,210,38,9,29,2,1
8,228,228,8,8,0,1,0
2,229,229,37,31,6,3,2
12,232,232,15,5,10,2,1
7,249,249,32,32,0,1,0
0,286,286,19,6,13,2,1
4,300,300,103,103,0,1,0
6,309,309,58,52,6,3,2
10,325,325,105,105,0,1,0
1,351,351,3,3,0,1,0
11,352,352,18,18,0,1,0
5,398,398,1,1,0,1,0

7,142,142,3,3,0,1,0
10,196,196,3,3,0,1,0
12,325,325,9,3,6,3,2
11,347,347,59,59,0,1,0
3,359,359,52,22,30,3,2
1,365,365,20,11,9,4,3
2,373,373,28,28,0,1,0
8,373,373,82,2,80,3,2
9,379,379,55,55,0,1,0
0,387,387,97,52,45,2,1
4,391,391,36,28,8,2,1
6,405,405,89,69,20,3,2
5,414,414,76,76,0,1,0

0,103,103,2,2,0,1,0
13,146,146,28,28,0,1,0
1,163,163,11,6,5,2,1
14,178,178,10,4,6,3,2
10,193,193,4,1,3,2,1
9,194,194,7,7,0,1,0
7,230,230,2,2,0,1,0
6,232,232,1,1,0,1,0
3,306,306,79,48,31,4,3
12,338,338,83,34,49,2,1
11,339,339,81,21,60,4,3
5,357,357,1,1,0,1,0
15,396,396,9,1,8,3,2
2,414,414,12,3,9,2,1
8,436,436,17,1,16,2,1
4,467,467,174,104,70,3,2

6,116,116,6,6,0,1,0
5,129,129,9,9,0,1,0
15,188,188,12,4,8,3,2
17,201,201,39,39,0,1,0
9,222,222,38,38,0,1,0
10,225,225,1,1,0,1,0
14,232,232,21,21,0,1,0
12,234,234,1,1,0,1,0
11,236,236,17,17,0,1,0
3,244,244,2,2,0,1,0
18,253,253,35,8,27,2,1
8,285,285,11,2,9,4,3
16,290,290,66,66,0,1,0
2,291,291,20,20,0,1,0
1,314,314,3,3,0,1,0
13,380,380,36,36,0,1,0
0,400,400,110,5,105,4,3
7,429,429,9,9,0,1,0
4,460,460,5,2,3,2,1

0,177,177,28,9,19,2,1
8,197,197,6,6,0,1,0
7,227,227,48,8,40,3,2
1,231,231,31,22,9,4,3
3,279,279,13,5,8,2,1
9,321,321,12,12,0,1,0
5,339,339,106,18,88,3,2
12,341,341,19,10,9,4,3
11,408,408,70,2,68,3,2
10,409,409,123,42,81,4,3
4,412,412,10,10,0,1,0
13,429,429,2,2,0,1,0
2,479,479,54,2,52,3,2
6,496,496,6,6,0,1,0

14,154,154,7,7,0,1,0
15,177,177,44,18,26,3,2
5,183,183,16,7,9,2,1
11,193,193,32,8,24,3,2
10,216,216,11,11,0,1,0
17,256,256,3,3,0,1,0
4,258,258,12,12,0,1,0
6,269,269,100,92,8,3,2
12,288,288,81,81,0,1,0
3,292,292,23,16,7,2,1
0,303,303,15,15,0,1,0
16,313,313,17,6,11,2,1
13,393,393,1,1,0,1,0
1,395,395,3,3,0,1,0
8,434,434,4,1,3,2,1
9,444,444,4,4,0,1,0
2,485,485,2,2,0,1,0
7,492,492,44,34,10,3,2

11,134,134,3,3,0,1,0
1,147,147,32,32,0,1,0
13,165,165,8,8,0,1,0
17,200,200,2,2,0,1,0
9,216,216,1,1,0,1,0
2,218,218,35,29,6,3,2
8,223,223,6,1,5,2,1
14,232,232,124,48,76,3,2
15,270,270,17,17,0,1,0
10,288,288,41,41,0,1,0
4,294,294,33,33,0,1,0
12,323,323,36,36,0,1,0
0,330,330,23,23,0,1,0
5,331,331,3,3,0,1,0
6,386,386,3,3,0,1,0
3,402,402,6,6,0,1,0
7,443,443,16,4,12,3,2
16,478,478,12,3,9,2,1

8,140,140,2,2,0,1,0
3,145,145,1,1,0,1,0
0,199,199,75,75,0,1,0
15,205,205,16,16,0,1,0
16,208,208,12,12,0,1,0
9,258,258,2,2,0,1,0
12,266,266,21,21,0,1,0
7,326,326,7,1,6,3,2
14,375,375,3,3,0,1,0
5,389,389,7,1,6,3,2
13,391,391,136,114,22,3,2
2,392,392,15,4,11,2,1
1,398,398,13,1,12,4,3
4,408,408,26,26,0,1,0
10,411,411,19,19,0,1,0
11,414,414,55,55,0,1,0
17,417,417,46,46,0,1,0
6,439,439,77,77,0,1,0

1,112,112,1,1,0,1,0
5,119,119,21,6,15,2,1
12,139,139,30,22,8,2,1
8,145,145,12,12,0,1,0
2,173,173,4,4,0,1,0
3,212,212,40,40,0,1,0
14,244,244,7,1,6,3,2
9,249,249,25,25,0,1,0
13,273,273,53,16,37,3,2
6,313,313,29,29,0,1,0
0,335,335,10,10,0,1,0
11,418,418,21,21,0,1,0
10,455,455,42,32,10,3,2
4,472,472,60,27,33,4,3
15,485,485,65,65,0,1,0
7,499,499,38,38,0,1,0

9,102,102,20,13,7,2,1
0,110,110,7,2,5,2,1
10,153,153,15,15,0,1,0
15,202,202,6,6,0,1,0
2,220,220,6,6,0,1,0
3,225,225,16,16,0,1,0
1,239,239,17,11,6,3,2
5,249,249,1,1,0,1,0
14,268,268,20,2,18,2,1
8,286,286,17,17,0,1,0
4,287,287,18,2,16,3,2
6,343,343,16,1,15,2,1
12,388,388,19,1,18,2,1
7,405,405,160,103,57,3,2
11,413,413,143,143,0,1,0
13,445,445,12,9,3,2,1

10,110,110,1,1,0,1,0
11,123,123,1,1,0,1,0
6,131,131,2,2,0,1,0
4,190,190,9,9,0,1,0
5,190,190,1,1,0,1,0
16,206,206,29,29,0,1,0
2,231,231,17,17,0,1,0
14,246,246,45,6,39,2,1
0,252,252,49,49,0,1,0
8,259,259,51,7,44,2,1
1,270,270,14,4,10,3,2
15,320,320,32,32,0,1,0
12,356,356,27,2,25,2,1
3,361,361,72,72,0,1,0
9,396,396,1,1,0,1,0
7,417,417,3,3,0,1,0
17,449,449,76,52,24,3,2
13,450,450,62,18,44,2,1

17,112,112,12,5,7,2,1
16,119,119,20,12,8,2,1
6,137,137,6,6,0,1,0
11,187,187,45,45,0,1,0
3,196,196,11,5,6,3,2
2,201,201,11,11,0,1,0
4,208,208,5,5,0,1,0
12,217,217,15,15,0,1,0
1,272,272,17,5,12,3,2
14,280,280,12,12,0,1,0
8,303,303,12,4,8,2,1
5,355,355,22,22,0,1,0
7,364,364,22,22,0,1,0
10,421,421,40,40,0,1,0
13,457,457,25,25,0,1,0
9,474,474,83,83,0,1,0
15,490,490,66,43,23,4,3
0,496,496,64,33,31,2,1

5,108,108,1,1,0,1,0
3,126,126,9,9,0,1,0
11,128,128,10,2,8,3,2
2,163,163,8,8,0,1,0
15,182,182,27,11,16,3,2
12,191,191,17,17,0,1,0
9,246,246,77,65,12,4,3
8,279,279,8,8,0,1,0
13,296,296,120,120,0,1,0
10,305,305,10,1,9,2,1
1,312,312,19,19,0,1,0
16,322,322,9,9,0,1,0
0,382,382,7,7,0,1,0
7,385,385,6,6,0,1,0
6,422,422,67,29,38,2,1
4,436,436,33,33,0,1,0
14,486,486,14,8,6,2,1

11,113,113,3,3,0,1,0
6,123,123,27,5,22,3,2
14,167,167,4,4,0,1,0
15,181,181,22,22,0,1,0
7,182,182,7,7,0,1,0
2,185,185,3,3,0,1,0
5,187,187,12,12,0,1,0
10,223,223,40,40,0,1,0
8,265,265,16,16,0,1,0
1,295,295,57,4,53,4,3
0,319,319,12,12,0,1,0
3,341,341,31,31,0,1,0
9,370,370,72,51,21,4,3
12,375,375,11,2,9,3,2
13,427,427,103,3,100,3,2
4,453,453,37,28,9,4,3

3,113,113,18,18,0,1,0
0,134,134,4,4,0,1,0
2,144,144,5,5,0,1,0
4,182,182,14,7,7,2,1
1,189,189,95,71,24,2,1
11,190,190,36,20,16,2,1
5,241,241,32,32,0,1,0
8,278,278,27,27,0,1,0
10,331,331,57,57,0,1,0
6,346,346,27,27,0,1,0
9,364,364,11,11,0,1,0
7,499,499,54,45,9,4,3

11,101,101,20,20,0,1,0
0,114,114,4,4,0,1,0
4,148,148,4,4,0,1,0
13,158,158,29,29,0,1,0
1,166,166,3,3,0,1,0
17,171,171,13,6,7,2,1
6,180,180,15,6,9,4,3
3,185,185,3,3,0,1,0
9,186,186,17,14,3,2,1
8,217,217,34,27,7,2,1
16,268,268,8,8,0,1,0
12,271,271,23,23,0,1,0
2,283,283,26,26,0,1,0
5,319,319,58,58,0,1,0
7,361,361,17,13,4,2,1
15,424,424,8,3,5,2,1
14,460,460,105,60,45,2,1
10,494,494,26,12,14,3,2

8,156,156,42,12,30,4,3
2,168,168,10,2,8,3,2
4,175,175,3,3,0,1,0
3,186,186,9,9,0,1,0
15,224,224,15,1,14,2,1
6,230,230,59,49,10,2,1
5,245,245,10,4,6,3,2
13,275,275,22,22,0,1,0
14,276,276,19,7,12,3,2
12,290,290,43,2,41,2,1
1,316,316,10,10,0,1,0
11,321,321,27,10,17,2,1
0,381,381,22,7,15,4,3
7,412,412,10,1,9,2,1
10,421,421,25,3,22,4,3
9,485,485,146,14,132,4,3

14,100,100,13,13,0,1,0
16,117,117,2,2,0,1,0
2,135,135,15,3,12,3,2
19,143,143,18,6,12,3,2
1,146,146,25,25,0,1,0
18,172,172,16,16,0,1,0
10,186,186,4,4,0,1,0
7,187,187,5,1,4,2,1
11,190,190,8,2,6,3,2
12,200,200,21,21,0,1,0
4,231,231,1,1,0,1,0
13,260,260,28,11,17,2,1
0,343,343,9,2,7,2,1
15,380,380,119,80,39,2,1
17,400,400,13,4,9,4,3
8,416,416,59,59,0,1,0
5,450,450,27,27,0,1,0
6,477,477,1,1,0,1,0
9,485,485,35,13,22,3,2
3,487,487,9,1,8,3,2

17,109,109,10,3,7,2,1
18,163,163,14,3,11,4,3
0,191,191,25,12,13,4,3
14,196,196,36,32,4,2,1
10,225,225,14,14,0,1,0
3,232,232,5,5,0,1,0
1,234,234,11,5,6,3,2
16,271,271,5,5,0,1,0
13,325,325,131,78,53,3,2
11,326,326,12,12,0,1,0
5,369,369,1,1,0,1,0
4,388,388,15,4,11,2,1
6,388,388,18,18,0,1,0
12,394,394,3,3,0,1,0
2,406,406,9,3,6,3,2
9,437,437,35,19,16,3,2
8,438,438,8,8,0,1,0
15,442,442,10,10,0,1,0
7,490,490,145,69,76,4,3

1,139,139,21,9,12,3,2
5,146,146,14,14,0,1,0
10,154,154,3,3,0,1,0
4,159,159,10,10,0,1,0
8,168,168,43,43,0,1,0
3,177,177,9,2,7,3,2
6,187,187,9,9,0,1,0
11,195,195,63,23,40,2,1
7,198,198,8,3,5,2,1
0,218,218,50,50,0,1,0
9,303,303,12,3,9,4,3
2,315,315,98,2,96,3,2

2,107,107,9,9,0,1,0
11,107,107,2,2,0,1,0
9,147,147,33,3,30,4,3
3,164,164,27,13,14,3,2
10,171,171,44,44,0,1,0
7,230,230,29,29,0,1,0
15,249,249,9,9,0,1,0
8,256,256,6,6,0,1,0
1,266,266,21,2,19,3,2
14,275,275,23,23,0,1,0
5,286,286,50,50,0,1,0
0,289,289,32,13,19,2,1
6,349,349,1,1,0,1,0
12,359,359,66,19,47,4,3
13,368,368,3,3,0,1,0
4,477,477,18,18,0,1,0

15,126,126,24,8,16,3,2
8,202,202,18,8,10,3,2
17,254,254,10,10,0,1,0
11,258,258,41,13,28,3,2
13,302,302,22,22,0,1,0
3,309,309,23,23,0,1,0
5,309,309,19,19,0,1,0
2,327,327,27,27,0,1,0
4,344,344,3,3,0,1,0
1,359,359,6,6,0,1,0
10,419,419,10,2,8,3,2
6,441,441,45,45,0,1,0
9,447,447,4,4,0,1,0
12,447,447,90,44,46,4,3
0,448,448,21,7,14,3,2
7,463,463,133,4,129,4,3
14,476,476,48,48,0,1,0
16,487,487,24,24,0,1,0

6,147,147,8,5,3,2,1
5,170,170,3,3,0,1,0
0,174,174,15,11,4,2,1
9,196,196,39,39,0,1,0
2,225,225,68,16,52,4,3
10,226,226,36,29,7,2,1
13,315,315,20,2,18,3,2
3,319,319,1,1,0,1,0
1,323,323,34,34,0,1,0
12,391,391,22,1,21,4,3
8,412,412,13,13,0,1,0
7,429,429,56,23,33,2,1
14,434,434,88,7,81,4,3
4,451,451,46,28,18,3,2
11,480,480,49,16,33,4,3

10,118,118,17,17,0,1,0
8,138,138,1,1,0,1,0
14,178,178,42,16,26,3,2
6,260,260,26,26,0,1,0
2,280,280,12,3,9,4,3
13,291,291,44,44,0,1,0
3,313,313,37,7,30,2,1
1,329,329,63,63,0,1,0
5,340,340,26,26,0,1,0
7,379,379,91,91,0,1,0
0,394,394,9,9,0,1,0
4,394,394,4,1,3,2,1
11,424,424,97,16,81,4,3
9,462,462,14,14,0,1,0
12,467,467,8,8,0,1,0

14,109,109,6,6,0,1,0
13,140,140,40,21,19,2,1
10,167,167,20,17,3,2,1
9,238,238,9,9,0,1,0
4,245,245,48,28,20,3,2
12,254,254,37,37,0,1,0
7,276,276,17,1,16,2,1
11,304,304,39,21,18,4,3
2,350,350,8,2,6,2,1
1,352,352,62,62,0,1,0
3,368,368,26,26,0,1,0
0,402,402,11,11,0,1,0
6,407,407,35,23,12,4,3
5,410,410,66,21,45,4,3
8,431,431,21,21,0,1,0

12,116,116,2,2,0,1,0
0,129,129,13,13,0,1,0
8,183,183,50,32,18,2,1
3,205,205,7,2,5,2,1
14,221,221,5,5,0,1,0
13,228,228,30,2,28,2,1
11,242,242,24,14,10,3,2
7,282,282,51,40,11,2,1
1,308,308,60,60,0,1,0
4,364,364,89,89,0,1,0
10,417,417,29,29,0,1,0
5,420,420,2,2,0,1,0
9,442,442,93,93,0,1,0
2,461,461,10,10,0,1,0
6,465,465,10,10,0,1,0

13,111,111,16,16,0,1,0
3,139,139,12,12,0,1,0
8,155,155,44,31,13,2,1
10,159,159,33,33,0,1,0
15,185,185,7,7,0,1,0
11,261,261,10,1,9,2,1
14,297,297,71,71,0,1,0
7,317,317,22,22,0,1,0
2,337,337,7,7,0,1,0
9,402,402,21,21,0,1,0
5,417,417,67,10,57,4,3
6,443,443,43,8,35,2,1
1,463,463,24,1,23,4,3
0,478,478,8,8,0,1,0
12,496,496,48,2,46,2,1
4,500,500,7,7,0,1,0

5,102,102,12,8,4,2,1
14,120,120,5,2,3,2,1
4,159,159,6,6,0,1,0
6,165,165,4,4,0,1,0
0,203,203,12,12,0,1,0
12,223,223,38,3,35,3,2
10,228,228,27,27,0,1,0
3,244,244,95,55,40,3,2
2,268,268,14,14,0,1,0
11,287,287,62,62,0,1,0
1,288,288,32,32,0,1,0
8,337,337,20,20,0,1,0
9,368,368,30,5,25,2,1
13,405,405,50,50,0,1,0
7,454,454,4,4,0,1,0

5,161,161,11,2,9,2,1
4,180,180,1,1,0,1,0
13,203,203,57,57,0,1,0
2,227,227,36,9,27,2,1
1,243,243,66,4,62,4,3
8,303,303,79,79,0,1,0
12,322,322,4,4,0,1,0
9,334,334,37,11,26,3,2
6,340,340,15,9,6,2,1
0,380,380,60,60,0,1,0
11,415,415,15,7,8,3,2
10,439,439,43,43,0,1,0
3,478,478,46,27,19,4,3
7,499,499,6,6,0,1,0

13,165,165,22,22,0,1,0
2,189,189,16,16,0,1,0
8,211,211,16,16,0,1,0
3,218,218,1,1,0,1,0
10,274,274,27,27,0,1,0
12,295,295,52,42,10,3,2
0,345,345,1,1,0,1,0
6,345,345,39,33,6,2,1
14,360,360,58,19,39,2,1
4,395,395,43,43,0,1,0
11,431,431,70,19,51,4,3
5,453,453,35,35,0,1,0
9,489,489,2,2,0,1,0
7,494,494,45,18,27,2,1
1,495,495,158,109,49,2,1

4,102,102,12,2,10,2,1
5,116,116,32,25,7,2,1
11,127,127,13,9,4,2,1
13,138,138,5,2,3,2,1
7,186,186,2,2,0,1,0
3,219,219,24,24,0,1,0
9,224,224,50,41,9,2,1
0,230,230,20,12,8,2,1
6,231,231,16,8,8,3,2
2,271,271,6,6,0,1,0
1,278,278,34,34,0,1,0
8,296,296,98,98,0,1,0
12,301,301,17,8,9,2,1
10,399,399,21,12,9,4,3

5,102,102,14,6,8,2,1
7,119,119,8,8,0,1,0
4,132,132,3,3,0,1,0
14,135,135,12,2,10,3,2
1,158,158,19,19,0,1,0
8,164,164,5,5,0,1,0
11,175,175,50,50,0,1,0
17,181,181,36,32,4,2,1
6,238,238,23,11,12,3,2
3,295,295,21,21,0,1,0
0,342,342,10,4,6,2,1
2,345,345,5,5,0,1,0
16,357,357,24,16,8,3,2
10,415,415,13,7,6,3,2
12,415,415,36,4,32,2,1
9,472,472,85,12,73,4,3
13,476,476,29,29,0,1,0
15,481,481,14,14,0,1,0

6,125,125,13,13,0,1,0
2,136,136,4,4,0,1,0
11,189,189,8,8,0,1,0
3,214,214,9,3,6,3,2
9,218,218,12,3,9,4,3
13,263,263,3,3,0,1,0
0,272,272,57,24,33,4,3
12,273,273,51,51,0,1,0
16,282,282,25,20,5,2,1
14,301,301,2,2,0,1,0
17,314,314,143,2,141,4,3
15,327,327,5,5,0,1,0
7,337,337,43,43,0,1,0
10,382,382,6,6,0,1,0
4,412,412,6,6,0,1,0
1,425,425,47,12,35,2,1
8,427,427,28,11,17,2,1
5,447,447,12,12,0,1,0

4,112,112,18,18,0,1,0
3,146,146,16,4,12,3,2
9,171,171,1,1,0,1,0
10,200,200,51,19,32,2,1
6,205,205,36,10,26,3,2
5,283,283,40,40,0,1,0
2,311,311,43,13,30,2,1
0,360,360,26,22,4,2,1
7,360,360,18,18,0,1,0
1,376,376,181,154,27,4,3
8,418,418,10,6,4,2,1

11,103,103,13,13,0,1,0
15,137,137,6,6,0,1,0
13,163,163,9,9,0,1,0
5,191,191,27,27,0,1,0
3,221,221,22,15,7,2,1
0,263,263,5,5,0,1,0
7,271,271,8,8,0,1,0
12,286,286,140,101,39,4,3
6,323,323,35,35,0,1,0
14,329,329,1,1,0,1,0
1,330,330,10,4,6,2,1
9,354,354,29,1,28,3,2
4,357,357,29,20,9,4,3
2,378,378,37,37,0,1,0
10,467,467,44,2,42,4,3
8,477,477,8,8,0,1,0
17,479,479,17,17,0,1,0
16,490,490,32,20,12,4,3

12,138,138,6,6,0,1,0
15,148,148,1,1,0,1,0
1,151,151,9,9,0,1,0
8,157,157,1,1,0,1,0
0,212,212,3,3,0,1,0
10,281,281,45,3,42,3,2
9,289,289,65,65,0,1,0
16,300,300,18,18,0,1,0
3,341,341,16,11,5,2,1
2,411,411,20,8,12,2,1
4,417,417,30,30,0,1,0
13,443,443,66,36,30,2,1
7,444,444,102,102,0,1,0
11,450,450,171,93,78,4,3
5,465,465,16,11,5,2,1
14,480,480,7,7,0,1,0
6,484,484,32,32,0,1,0

3,109,109,4,4,0,1,0
8,198,198,14,14,0,1,0
5,211,211,26,5,21,4,3
12,242,242,2,2,0,1,0
11,246,246,7,7,0,1,0
2,248,248,48,26,22,3,2
0,249,249,5,5,0,1,0
6,266,266,61,61,0,1,0
7,330,330,134,84,50,2,1
9,356,356,7,7,0,1,0
10,475,475,22,8,14,2,1
4,480,480,125,125,0,1,0
1,496,496,84,5,79,4,3

11,104,104,3,3,0,1,0
13,108,108,1,1,0,1,0
5,128,128,5,5,0,1,0
8,140,140,20,13,7,2,1
4,167,167,7,7,0,1,0
15,188,188,17,9,8,3,2
10,291,291,116,108,8,2,1
7,344,344,14,8,6,2,1
12,345,345,14,2,12,2,1
3,400,400,10,10,0,1,0
14,427,427,51,4,47,2,1
1,431,431,18,18,0,1,0
6,461,461,49,49,0,1,0
2,488,488,169,142,27,2,1
0,498,498,11,11,0,1,0
9,498,498,67,9,58,3,2

9,109,109,4,4,0,1,0
2,156,156,20,2,18,3,2
6,192,192,11,2,9,4,3
0,270,270,99,80,19,2,1
7,287,287,2,2,0,1,0
5,293,293,8,8,0,1,0
1,323,323,14,14,0,1,0
3,357,357,92,92,0,1,0
4,375,375,2,2,0,1,0
10,417,417,178,73,105,4,3
8,441,441,59,59,0,1,0
11,442,442,56,36,20,2,1

12,141,141,3,3,0,1,0
11,156,156,1,1,0,1,0
8,166,166,20,20,0,1,0
10,167,167,21,21,0,1,0
7,206,206,21,7,14,2,1
15,206,206,16,16,0,1,0
0,214,214,3,3,0,1,0
3,294,294,1,1,0,1,0
2,297,297,72,58,14,3,2
1,301,301,42,42,0,1,0
5,320,320,11,11,0,1,0
9,322,322,92,92,0,1,0
14,329,329,93,24,69,4,3
6,342,342,35,13,22,3,2
4,386,386,18,3,15,4,3
13,414,414,9,9,0,1,0

5,165,165,7,7,0,1,0
3,263,263,73,43,30,4,3
1,289,289,78,78,0,1,0
10,295,295,14,2,12,2,1
6,296,296,54,14,40,3,2
8,357,357,62,12,50,2,1
9,366,366,105,6,99,4,3
4,422,422,3,3,0,1,0
0,449,449,37,6,31,2,1
2,477,477,82,41,41,3,2
7,495,495,35,35,0,1,0

5,126,126,18,18,0,1,0
12,143,143,1,1,0,1,0
19,207,207,16,7,9,4,3
17,218,218,14,14,0,1,0
14,233,233,14,14,0,1,0
11,235,235,2,2,0,1,0
4,310,310,5,2,3,2,1
0,337,337,7,7,0,1,0
2,342,342,45,45,0,1,0
10,346,346,30,30,0,1,0
13,358,358,124,115,9,2,1
1,360,360,8,4,4,2,1
6,361,361,21,9,12,3,2
3,363,363,6,6,0,1,0
15,373,373,29,3,26,3,2
8,402,402,42,42,0,1,0
18,416,416,37,37,0,1,0
7,429,429,61,61,0,1,0
16,461,461,44,23,21,4,3
9,500,500,24,24,0,1,0

12,105,105,14,14,0,1,0
3,143,143,4,4,0,1,0
1,148,148,10,10,0,1,0
2,201,201,16,8,8,3,2
4,206,206,42,16,26,4,3
8,245,245,3,3,0,1,0
9,247,247,5,5,0,1,0
5,257,257,22,9,13,3,2
6,370,370,162,78,84,4,3
0,404,404,137,56,81,4,3
11,457,457,60,60,0,1,0
10,479,479,12,12,0,1,0
7,492,492,26,26,0,1,0

11,102,102,24,6,18,2,1
3,125,125,7,7,0,1,0
10,207,207,38,38,0,1,0
4,234,234,55,55,0,1,0
12,236,236,30,30,0,1,0
0,286,286,109,31,78,3,2
8,287,287,20,20,0,1,0
5,327,327,29,29,0,1,0
6,382,382,8,8,0,1,0
1,395,395,2,2,0,1,0
7,403,403,25,12,13,2,1
2,435,435,6,1,5,2,1
13,454,454,16,2,14,2,1
9,464,464,48,28,20,3,2

7,124,124,1,1,0,1,0
0,129,129,43,9,34,3,2
3,161,161,3,3,0,1,0
5,179,179,11,11,0,1,0
13,184,184,32,26,6,2,1
8,228,228,12,12,0,1,0
11,235,235,9,6,3,2,1
14,248,248,36,36,0,1,0
2,270,270,11,4,7,2,1
1,328,328,71,71,0,1,0
4,363,363,7,7,0,1,0
9,388,388,63,48,15,2,1
6,441,441,22,13,9,2,1
12,445,445,5,1,4,2,1
15,455,455,55,1,54,4,3
10,458,458,73,41,32,2,1

7,110,110,10,2,8,2,1
8,167,167,7,7,0,1,0
9,201,201,9,9,0,1,0
3,232,232,2,2,0,1,0
12,238,238,17,5,12,3,2
5,254,254,19,14,5,2,1
10,289,289,43,13,30,2,1
13,295,295,3,3,0,1,0
14,328,328,17,8,9,4,3
11,344,344,145,111,34,3,2
0,375,375,77,64,13,2,1
1,392,392,15,15,0,1,0
6,409,409,75,75,0,1,0
4,474,474,43,2,41,4,3
15,476,476,44,28,16,2,1
2,482,482,12,6,6,3,2
16,499,499,6,3,3,2,1

1,167,167,7,7,0,1,0
12,203,203,13,13,0,1,0
2,327,327,1,1,0,1,0
3,332,332,145,121,24,3,2
5,335,335,1,1,0,1,0
7,339,339,5,5,0,1,0
6,362,362,29,29,0,1,0
8,373,373,49,49,0,1,0
10,410,410,53,53,0,1,0
9,452,452,69,69,0,1,0
0,468,468,127,127,0,1,0
4,492,492,23,11,12,4,3
11,500,500,118,101,17,2,1

5,149,149,27,1,26,4,3
4,180,180,18,14,4,2,1
1,198,198,73,41,32,3,2
0,200,200,76,76,0,1,0
9,236,236,45,7,38,3,2
3,246,246,1,1,0,1,0
7,262,262,33,4,29,2,1
6,263,263,37,37,0,1,0
2,336,336,18,18,0,1,0
8,439,439,35,26,9,2,1

19,168,168,25,25,0,1,0
13,228,228,8,8,0,1,0
3,238,238,8,8,0,1,0
2,256,256,6,6,0,1,0
5,272,272,7,1,6,2,1
16,284,284,80,14,66,4,3
18,312,312,87,87,0,1,0
0,321,321,21,3,18,3,2
9,358,358,25,19,6,3,2
12,371,371,46,46,0,1,0
8,400,400,24,16,8,2,1
10,405,405,13,13,0,1,0
6,412,412,37,13,24,3,2
15,440,440,25,2,23,3,2
11,459,459,25,25,0,1,0
17,460,460,5,1,4,2,1
4,463,463,5,1,4,2,1
1,480,480,47,47,0,1,0
7,489,489,56,56,0,1,0
14,491,491,3,3,0,1,0

5,114,114,1,1,0,1,0
10,142,142,11,4,7,2,1
7,177,177,4,4,0,1,0
6,236,236,21,6,15,2,1
8,239,239,39,35,4,2,1
4,284,284,52,20,32,2,1
13,315,315,3,3,0,1,0
11,332,332,44,44,0,1,0
12,349,349,44,44,0,1,0
9,362,362,103,81,22,2,1
2,363,363,99,78,21,4,3
0,414,414,13,13,0,1,0
1,430,430,25,25,0,1,0
3,446,446,71,71,0,1,0

3,112,112,46,28,18,3,2
0,126,126,1,1,0,1,0
7,164,164,55,55,0,1,0
2,198,198,4,4,0,1,0
6,237,237,56,53,3,2,1
1,260,260,81,81,0,1,0
10,295,295,3,3,0,1,0
5,309,309,4,4,0,1,0
11,323,323,31,17,14,3,2
4,326,326,17,9,8,3,2
8,386,386,22,4,18,2,1
9,441,441,28,28,0,1,0

9,115,115,8,4,4,2,1
18,130,130,34,34,0,1,0
4,133,133,9,4,5,2,1
13,136,136,5,5,0,1,0
2,151,151,5,5,0,1,0
8,169,169,16,16,0,1,0
20,175,175,2,2,0,1,0
6,202,202,2,2,0,1,0
1,232,232,15,5,10,3,2
15,267,267,15,9,6,3,2
11,274,274,6,6,0,1,0
17,335,335,29,20,9,2,1
12,385,385,5,5,0,1,0
0,393,393,24,24,0,1,0
14,399,399,3,3,0,1,0
5,412,412,13,13,0,1,0
7,428,428,66,66,0,1,0
3,429,429,44,14,30,4,3
16,432,432,49,35,14,3,2
19,444,444,124,124,0,1,0
10,484,484,20,20,0,1,0

3,101,101,11,11,0,1,0
0,103,103,2,2,0,1,0
5,104,104,1,1,0,1,0
19,108,108,9,2,7,2,1
16,117,117,5,5,0,1,0
18,144,144,10,1,9,4,3
7,157,157,4,4,0,1,0
8,188,188,24,2,22,2,1
4,190,190,2,2,0,1,0
13,218,218,38,26,12,2,1
17,280,280,99,27,72,4,3
1,304,304,17,17,0,1,0
11,316,316,1,1,0,1,0
6,328,328,7,2,5,2,1
10,380,380,30,22,8,3,2
2,392,392,49,26,23,2,1
15,406,406,22,22,0,1,0
12,422,422,81,54,27,2,1
14,476,476,20,6,14,3,2
9,483,483,11,11,0,1,0

12,111,111,20,8,12,4,3
5,117,117,29,16,13,2,1
6,126,126,9,2,7,2,1
16,139,139,3,3,0,1,0
1,162,162,6,6,0,1,0
3,165,165,8,2,6,2,1
10,197,197,9,9,0,1,0
4,201,201,3,3,0,1,0
18,235,235,12,5,7,2,1
11,271,271,3,3,0,1,0
13,272,272,93,57,36,4,3
14,273,273,3,3,0,1,0
17,279,279,9,9,0,1,0
8,331,331,7,7,0,1,0
9,437,437,27,27,0,1,0
15,450,450,80,80,0,1,0
7,462,462,57,5,52,4,3
2,463,463,54,12,42,4,3
0,482,482,2,2,0,1,0

13,129,129,1,1,0,1,0
2,130,130,5,5,0,1,0
1,157,157,6,6,0,1,0
10,159,159,9,9,0,1,0
3,166,166,27,12,15,4,3
14,196,196,16,16,0,1,0
0,203,203,27,27,0,1,0
8,206,206,7,7,0,1,0
11,265,265,26,19,7,2,1
5,266,266,22,22,0,1,0
12,327,327,15,15,0,1,0
6,349,349,5,5,0,1,0
7,367,367,1,1,0,1,0
9,415,415,55,55,0,1,0
4,444,444,131,71,60,4,3
15,485,485,191,104,87,4,3

9,118,118,2,2,0,1,0
14,138,138,21,2,19,3,2
11,150,150,11,3,8,3,2
4,159,159,21,21,0,1,0
15,159,159,7,1,6,2,1
0,189,189,3,3,0,1,0
6,194,194,36,20,16,3,2
16,214,214,7,7,0,1,0
2,218,218,3,3,0,1,0
12,239,239,17,8,9,4,3
13,310,310,127,60,67,4,3
3,324,324,2,2,0,1,0
10,340,340,51,14,37,2,1
17,362,362,12,1,11,2,1
1,385,385,2,2,0,1,0
8,441,441,1,1,0,1,0
5,477,477,112,112,0,1,0
7,492,492,19,10,9,4,3

