13,125,125,2,2,0,1,0
16,142,142,3,3,0,1,0
11,169,169,12,12,0,1,0
9,175,175,1,1,0,1,0
19,181,181,65,1,64,3,2
20,189,189,3,3,0,1,0
14,197,197,4,4,0,1,0
2,209,209,6,6,0,1,0
4,211,211,10,10,0,1,0
1,218,218,21,21,0,1,0
12,250,250,27,27,0,1,0
6,266,266,23,7,16,2,1
17,298,298,8,8,0,1,0
7,303,303,37,24,13,2,1
3,316,316,6,3,3,2,1
8,355,355,6,6,0,1,0
10,397,397,3,3,0,1,0
18,409,409,78,54,24,2,1
5,423,423,10,4,6,3,2
0,455,455,15,15,0,1,0
15,477,477,40,19,21,4,3
21,485,485,8,8,0,1,0

10,100,100,2,2,0,1,0
5,101,101,3,3,0,1,0
11,150,150,35,4,31,4,3
12,200,200,4,1,3,2,1
3,204,204,21,6,15,4,3
2,289,289,52,52,0,1,0
6,293,293,40,4,36,3,2
1,327,327,104,104,0,1,0
0,336,336,8,8,0,1,0
4,343,343,16,1,15,4,3
7,375,375,114,14,100,3,2
9,436,436,1,1,0,1,0
8,438,438,1,1,0,1,0

5,106,106,1,1,0,1,0
9,154,154,7,7,0,1,0
17,188,188,34,34,0,1,0
18,204,204,20,2,18,3,2
6,220,220,3,3,0,1,0
1,277,277,31,15,16,3,2
12,295,295,28,28,0,1,0
16,301,301,2,2,0,1,0
10,384,384,24,24,0,1,0
15,395,395,2,2,0,1,0
0,400,400,10,4,6,3,2
4,400,400,1,1,0,1,0
11,415,415,14,14,0,1,0
7,441,441,22,22,0,1,0
2,442,442,19,16,3,2,1
8,453,453,62,14,48,3,2
14,480,480,93,54,39,4,3
19,480,480,31,31,0,1,0
13,497,497,82,17,65,3,2
3,500,500,37,2,35,3,2

3,127,127,5,5,0,1,0
11,140,140,24,24,0,1,0
12,154,154,5,5,0,1,0
14,158,158,3,3,0,1,0
4,179,179,18,10,8,2,1
8,205,205,22,22,0,1,0
1,247,247,6,6,0,1,0
15,260,260,26,9,17,2,1
7,275,275,4,4,0,1,0
13,289,289,49,39,10,3,2
10,326,326,1,1,0,1,0
5,333,333,82,33,49,2,1
2,343,343,21,11,10,3,2
6,422,422,2,2,0,1,0
0,462,462,47,19,28,2,1
9,489,489,111,45,66,4,3

15,104,104,7,7,0,1,0
0,141,141,1,1,0,1,0
13,157,157,12,12,0,1,0
11,158,158,8,8,0,1,0
1,172,172,11,11,0,1,0
3,205,205,23,23,0,1,0
10,232,232,14,10,4,2,1
9,235,235,18,18,0,1,0
6,258,258,17,6,11,2,1
12,298,298,88,62,26,3,2
5,320,320,5,5,0,1,0
4,322,322,1,1,0,1,0
14,348,348,31,31,0,1,0
7,349,349,108,88,20,3,2
8,354,354,37,37,0,1,0
2,482,482,10,1,9,4,3

1,112,112,7,7,0,1,0
14,123,123,24,10,14,2,1
5,128,128,21,6,15,4,3
3,140,140,5,1,4,2,1
2,161,161,3,3,0,1,0
9,170,170,11,11,0,1,0
13,170,170,24,16,8,3,2
11,179,179,32,8,24,2,1
6,195,195,26,6,20,3,2
8,204,204,7,7,0,1,0
0,257,257,13,13,0,1,0
12,280,280,27,15,12,2,1
4,296,296,58,58,0,1,0
10,313,313,4,4,0,1,0
7,450,450,18,18,0,1,0

7,126,126,6,6,0,1,0
10,136,136,6,6,0,1,0
5,151,151,21,21,0,1,0
4,181,181,4,4,0,1,0
2,204,204,10,10,0,1,0
8,221,221,72,72,0,1,0
1,240,240,30,22,8,3,2
6,295,295,9,9,0,1,0
3,336,336,75,18,57,4,3
9,406,406,47,47,0,1,0
0,433,433,132,102,30,4,3

0,130,130,11,11,0,1,0
13,152,152,2,2,0,1,0
7,171,171,6,6,0,1,0
10,212,212,1,1,0,1,0
16,235,235,47,47,0,1,0
8,239,239,12,12,0,1,0
5,258,258,77,25,52,4,3
4,265,265,10,10,0,1,0
17,287,287,4,4,0,1,0
12,320,320,3,3,0,1,0
9,338,338,10,10,0,1,0
18,363,363,88,88,0,1,0
6,366,366,30,30,0,1,0
3,375,375,1,1,0,1,0
15,406,406,20,20,0,1,0
2,406,406,16,16,0,1,0
1,429,429,5,5,0,1,0
19,469,469,42,42,0,1,0
20,473,473,33,5,28,3,2
11,479,479,1,1,0,1,0
14,492,492,23,23,0,1,0

12,100,100,1,1,0,1,0
11,118,118,18,14,4,2,1
10,122,122,18,18,0,1,0
9,140,140,20,8,12,2,1
3,141,141,11,3,8,3,2
4,150,150,9,9,0,1,0
6,165,165,4,4,0,1,0
2,204,204,1,1,0,1,0
7,247,247,10,10,0,1,0
14,327,327,58,43,15,2,1
0,339,339,1,1,0,1,0
5,366,366,85,40,45,3,2
8,366,366,29,29,0,1,0
13,440,440,10,10,0,1,0
1,461,461,119,20,99,4,3

9,100,100,21,15,6,3,2
6,132,132,4,4,0,1,0
10,133,133,6,6,0,1,0
2,148,148,2,2,0,1,0
7,174,174,82,48,34,4,3
13,183,183,7,1,6,2,1
8,215,215,20,20,0,1,0
3,229,229,4,4,0,1,0
5,308,308,23,23,0,1,0
11,308,308,63,13,50,4,3
14,355,355,8,5,3,2,1
12,474,474,48,15,33,4,3
1,488,488,8,8,0,1,0
4,490,490,15,9,6,2,1
0,495,495,25,8,17,2,1

0,118,118,2,2,0,1,0
11,152,152,5,5,0,1,0
1,160,160,1,1,0,1,0
16,163,163,21,5,16,2,1
3,224,224,8,8,0,1,0
8,237,237,25,3,22,4,3
15,272,272,33,1,32,2,1
14,321,321,14,14,0,1,0
7,327,327,35,29,6,3,2
5,355,355,3,3,0,1,0
13,365,365,78,24,54,4,3
2,378,378,32,32,0,1,0
9,382,382,31,31,0,1,0
6,423,423,81,61,20,3,2
4,461,461,29,21,8,2,1
12,477,477,38,38,0,1,0
10,498,498,46,46,0,1,0

10,108,108,19,19,0,1,0
3,141,141,1,1,0,1,0
1,146,146,9,9,0,1,0
2,292,292,26,26,0,1,0
8,335,335,39,39,0,1,0
12,341,341,88,45,43,4,3
0,351,351,1,1,0,1,0
7,357,357,39,39,0,1,0
9,393,393,8,8,0,1,0
5,399,399,40,10,30,3,2
4,401,401,30,30,0,1,0
13,452,452,8,8,0,1,0
11,456,456,24,10,14,3,2
14,469,469,33,30,3,2,1
6,492,492,126,21,105,4,3

2,104,104,1,1,0,1,0
19,128,128,12,12,0,1,0
21,136,136,5,5,0,1,0
17,150,150,13,1,12,3,2
1,172,172,8,8,0,1,0
3,177,177,1,1,0,1,0
9,181,181,2,2,0,1,0
10,187,187,15,3,12,2,1
16,203,203,47,26,21,2,1
14,205,205,3,3,0,1,0
12,213,213,17,17,0,1,0
15,256,256,17,3,14,2,1
20,285,285,41,41,0,1,0
4,291,291,40,19,21,2,1
11,324,324,13,1,12,4,3
18,328,328,20,12,8,2,1
8,390,390,10,10,0,1,0
13,414,414,4,4,0,1,0
5,431,431,55,14,41,3,2
7,439,439,27,27,0,1,0
0,455,455,9,1,8,2,1
6,468,468,16,6,10,2,1

10,120,120,16,16,0,1,0
5,190,190,73,60,13,2,1
6,227,227,3,3,0,1,0
1,255,255,67,33,34,3,2
8,300,300,5,5,0,1,0
4,348,348,3,3,0,1,0
3,364,364,80,80,0,1,0
7,366,366,51,51,0,1,0
9,374,374,5,5,0,1,0
2,409,409,78,12,66,4,3
0,440,440,12,12,0,1,0

13,108,108,11,11,0,1,0
7,114,114,5,5,0,1,0
17,143,143,3,3,0,1,0
9,173,173,8,8,0,1,0
2,199,199,14,14,0,1,0
1,204,204,7,7,0,1,0
5,234,234,33,33,0,1,0
11,241,241,49,27,22,4,3
16,274,274,7,7,0,1,0
12,292,292,36,3,33,2,1
6,319,319,10,10,0,1,0
8,326,326,3,3,0,1,0
4,334,334,33,33,0,1,0
0,339,339,31,31,0,1,0
3,350,350,44,3,41,2,1
14,455,455,45,13,32,2,1
10,478,478,4,4,0,1,0
15,499,499,71,41,30,4,3

2,125,125,8,8,0,1,0
9,165,165,28,28,0,1,0
4,197,197,1,1,0,1,0
5,266,266,18,6,12,2,1
3,290,290,140,140,0,1,0
7,312,312,39,3,36,2,1
8,338,338,5,5,0,1,0
6,346,346,111,9,102,4,3
0,411,411,6,6,0,1,0
1,418,418,58,58,0,1,0
10,483,483,5,5,0,1,0

6,155,155,47,25,22,2,1
0,169,169,25,18,7,2,1
4,214,214,3,3,0,1,0
3,289,289,29,6,23,2,1
12,300,300,10,4,6,2,1
7,320,320,26,26,0,1,0
11,340,340,33,33,0,1,0
9,347,347,92,77,15,2,1
5,369,369,20,2,18,4,3
1,395,395,20,20,0,1,0
8,439,439,11,11,0,1,0
13,476,476,14,14,0,1,0
10,488,488,85,85,0,1,0
2,491,491,17,17,0,1,0

14,153,153,19,10,9,4,3
7,181,181,13,5,8,3,2
20,204,204,6,6,0,1,0
9,207,207,6,6,0,1,0
18,218,218,54,54,0,1,0
17,223,223,15,5,10,3,2
19,287,287,3,3,0,1,0
15,292,292,30,3,27,4,3
16,301,301,40,33,7,2,1
6,303,303,9,9,0,1,0
5,327,327,4,4,0,1,0
3,329,329,23,2,21,4,3
2,342,342,21,21,0,1,0
10,361,361,34,34,0,1,0
13,371,371,5,5,0,1,0
11,420,420,14,11,3,2,1
12,436,436,25,25,0,1,0
0,461,461,45,10,35,2,1
4,481,481,31,31,0,1,0
1,484,484,4,4,0,1,0
8,487,487,29,11,18,3,2

6,148,148,26,7,19,4,3
0,162,162,3,3,0,1,0
13,175,175,2,2,0,1,0
5,178,178,36,24,12,4,3
12,183,183,26,2,24,4,3
2,201,201,31,23,8,3,2
10,227,227,12,2,10,3,2
3,275,275,11,5,6,3,2
9,387,387,75,35,40,2,1
7,413,413,8,8,0,1,0
4,427,427,28,9,19,2,1
11,479,479,81,60,21,4,3
1,480,480,24,24,0,1,0
8,497,497,62,52,10,3,2

4,100,100,1,1,0,1,0
7,108,108,34,34,0,1,0
11,202,202,5,5,0,1,0
9,206,206,12,12,0,1,0
6,212,212,2,2,0,1,0
2,221,221,19,19,0,1,0
8,270,270,1,1,0,1,0
15,280,280,59,59,0,1,0
1,289,289,9,9,0,1,0
0,303,303,14,6,8,2,1
14,333,333,1,1,0,1,0
5,340,340,15,15,0,1,0
12,373,373,32,8,24,3,2
3,416,416,65,21,44,3,2
10,463,463,28,6,22,3,2
13,490,490,130,17,113,4,3

3,112,112,9,9,0,1,0
11,117,117,22,4,18,3,2
5,124,124,19,19,0,1,0
4,128,128,19,7,12,2,1
1,135,135,7,1,6,2,1
7,187,187,19,11,8,3,2
6,224,224,4,4,0,1,0
8,285,285,47,17,30,2,1
10,333,333,24,24,0,1,0
0,340,340,141,141,0,1,0
2,422,422,2,2,0,1,0
9,456,456,9,3,6,3,2

6,121,121,6,6,0,1,0
1,135,135,2,2,0,1,0
0,139,139,9,4,5,2,1
5,141,141,19,19,0,1,0
12,161,161,22,22,0,1,0
13,200,200,28,15,13,2,1
10,227,227,9,9,0,1,0
17,293,293,28,28,0,1,0
3,305,305,8,8,0,1,0
9,319,319,19,19,0,1,0
14,335,335,46,1,45,2,1
8,355,355,8,5,3,2,1
4,364,364,29,11,18,3,2
16,382,382,34,8,26,2,1
15,417,417,36,10,26,2,1
7,420,420,59,59,0,1,0
11,433,433,13,7,6,3,2
2,473,473,34,16,18,2,1

4,116,116,4,1,3,2,1
10,123,123,6,6,0,1,0
0,145,145,10,6,4,2,1
14,181,181,9,9,0,1,0
1,183,183,15,4,11,2,1
5,225,225,31,28,3,2,1
6,227,227,14,14,0,1,0
8,271,271,14,10,4,2,1
11,293,293,17,17,0,1,0
15,326,326,53,53,0,1,0
9,353,353,11,1,10,3,2
13,357,357,67,13,54,4,3
12,361,361,63,63,0,1,0
7,410,410,90,28,62,3,2
3,415,415,14,10,4,2,1
2,477,477,5,5,0,1,0

0,108,108,6,6,0,1,0
7,177,177,2,2,0,1,0
5,180,180,18,18,0,1,0
9,191,191,40,40,0,1,0
12,213,213,1,1,0,1,0
8,223,223,6,6,0,1,0
11,243,243,7,7,0,1,0
3,302,302,20,20,0,1,0
4,346,346,104,45,59,4,3
6,371,371,71,5,66,4,3
10,401,401,98,66,32,2,1
1,461,461,1,1,0,1,0
2,464,464,83,47,36,4,3

6,164,164,13,13,0,1,0
5,207,207,15,7,8,3,2
11,269,269,12,12,0,1,0
0,277,277,96,66,30,4,3
9,285,285,30,19,11,4,3
3,306,306,53,53,0,1,0
10,345,345,9,9,0,1,0
7,351,351,24,10,14,3,2
2,357,357,22,22,0,1,0
4,454,454,43,43,0,1,0
1,463,463,12,12,0,1,0
8,491,491,157,127,30,3,2

11,120,120,12,12,0,1,0
4,140,140,14,5,9,2,1
3,143,143,5,5,0,1,0
16,148,148,47,16,31,2,1
8,164,164,12,3,9,3,2
10,183,183,9,9,0,1,0
18,184,184,8,2,6,3,2
13,189,189,17,17,0,1,0
5,199,199,12,2,10,2,1
15,211,211,2,2,0,1,0
1,245,245,9,9,0,1,0
7,268,268,12,2,10,3,2
0,322,322,49,49,0,1,0
14,330,330,11,11,0,1,0
12,387,387,19,19,0,1,0
9,388,388,11,11,0,1,0
17,456,456,77,77,0,1,0
6,461,461,9,9,0,1,0
2,471,471,2,2,0,1,0

7,140,140,10,10,0,1,0
6,187,187,2,2,0,1,0
12,199,199,3,3,0,1,0
3,252,252,54,33,21,4,3
9,266,266,7,7,0,1,0
13,266,266,38,10,28,3,2
1,289,289,31,5,26,3,2
0,296,296,65,27,38,4,3
8,307,307,129,11,118,4,3
4,322,322,24,24,0,1,0
11,329,329,4,4,0,1,0
5,385,385,2,2,0,1,0
2,393,393,27,3,24,2,1
10,480,480,11,11,0,1,0

8,151,151,6,6,0,1,0
9,151,151,1,1,0,1,0
3,172,172,31,11,20,3,2
6,202,202,30,4,26,4,3
0,240,240,9,9,0,1,0
10,253,253,33,33,0,1,0
12,285,285,6,6,0,1,0
1,289,289,1,1,0,1,0
5,334,334,13,9,4,2,1
4,358,358,72,43,29,2,1
2,362,362,87,17,70,3,2
7,368,368,133,128,5,2,1
11,500,500,6,2,4,2,1

4,102,102,22,9,13,2,1
0,124,124,4,1,3,2,1
7,165,165,28,28,0,1,0
11,168,168,5,5,0,1,0
8,193,193,48,26,22,3,2
9,212,212,8,2,6,3,2
1,217,217,1,1,0,1,0
3,223,223,32,32,0,1,0
12,354,354,47,47,0,1,0
6,429,429,61,61,0,1,0
13,459,459,39,39,0,1,0
2,466,466,67,67,0,1,0
10,481,481,8,8,0,1,0
5,498,498,10,10,0,1,0

2,102,102,2,2,0,1,0
12,132,132,13,13,0,1,0
16,161,161,33,25,8,2,1
4,245,245,4,4,0,1,0
15,245,245,8,8,0,1,0
10,261,261,26,19,7,2,1
14,273,273,9,9,0,1,0
0,276,276,1,1,0,1,0
9,297,297,10,10,0,1,0
3,304,304,10,10,0,1,0
5,310,310,22,19,3,2,1
8,315,315,2,2,0,1,0
7,354,354,71,71,0,1,0
13,403,403,32,6,26,3,2
17,426,426,31,7,24,3,2
6,473,473,62,20,42,3,2
1,482,482,42,42,0,1,0
11,488,488,94,59,35,2,1

14,134,134,4,1,3,2,1
9,152,152,38,38,0,1,0
2,199,199,21,3,18,2,1
11,262,262,78,44,34,4,3
0,267,267,32,32,0,1,0
4,324,324,40,40,0,1,0
12,363,363,20,11,9,4,3
8,375,375,5,2,3,2,1
13,377,377,11,4,7,2,1
5,389,389,8,8,0,1,0
3,400,400,4,4,0,1,0
10,405,405,15,15,0,1,0
6,444,444,46,46,0,1,0
1,457,457,17,17,0,1,0
7,467,467,84,76,8,3,2

7,107,107,11,1,10,2,1
0,132,132,4,4,0,1,0
4,138,138,13,2,11,3,2
9,145,145,34,34,0,1,0
10,145,145,12,7,5,2,1
1,179,179,25,13,12,2,1
13,201,201,29,13,16,2,1
11,303,303,33,33,0,1,0
5,324,324,11,11,0,1,0
14,356,356,1,1,0,1,0
8,445,445,21,15,6,3,2
3,446,446,5,1,4,2,1
2,466,466,33,21,12,4,3
12,470,470,45,45,0,1,0
6,486,486,109,103,6,2,1

8,219,219,30,15,15,4,3
7,228,228,15,6,9,4,3
10,262,262,23,23,0,1,0
2,263,263,86,86,0,1,0
1,277,277,1,1,0,1,0
9,294,294,5,5,0,1,0
5,350,350,84,15,69,4,3
0,383,383,130,104,26,2,1
6,385,385,43,43,0,1,0
3,423,423,13,3,10,3,2
4,488,488,26,26,0,1,0

1,137,137,35,35,0,1,0
6,202,202,3,3,0,1,0
0,216,216,15,15,0,1,0
4,228,228,75,75,0,1,0
2,292,292,110,110,0,1,0
8,300,300,53,37,16,2,1
5,315,315,8,8,0,1,0
9,326,326,10,10,0,1,0
3,397,397,17,17,0,1,0
7,404,404,36,36,0,1,0

5,125,125,7,7,0,1,0
6,126,126,5,5,0,1,0
4,148,148,3,3,0,1,0
8,169,169,24,24,0,1,0
15,180,180,22,8,14,2,1
1,188,188,5,5,0,1,0
11,263,263,22,6,16,3,2
13,284,284,94,29,65,4,3
0,288,288,22,4,18,3,2
2,304,304,28,13,15,4,3
16,325,325,14,11,3,2,1
3,421,421,17,17,0,1,0
14,428,428,26,3,23,2,1
12,476,476,1,1,0,1,0
9,476,476,75,58,17,2,1
7,480,480,24,18,6,2,1
10,489,489,34,34,0,1,0

12,131,131,47,40,7,2,1
5,143,143,23,17,6,3,2
11,162,162,12,12,0,1,0
1,187,187,26,13,13,2,1
6,192,192,16,12,4,2,1
4,198,198,17,17,0,1,0
9,208,208,22,22,0,1,0
8,215,215,11,11,0,1,0
2,226,226,1,1,0,1,0
3,356,356,53,53,0,1,0
13,358,358,27,7,20,2,1
14,399,399,29,7,22,3,2
10,400,400,4,4,0,1,0
0,410,410,9,1,8,3,2
15,434,434,6,6,0,1,0
7,486,486,3,3,0,1,0

9,104,104,11,8,3,2,1
8,118,118,17,17,0,1,0
11,134,134,15,15,0,1,0
3,177,177,11,7,4,2,1
7,231,231,17,17,0,1,0
12,247,247,24,24,0,1,0
6,255,255,17,2,15,2,1
10,264,264,27,27,0,1,0
13,286,286,25,4,21,2,1
0,288,288,4,1,3,2,1
2,306,306,15,15,0,1,0
4,408,408,152,143,9,4,3
5,409,409,42,42,0,1,0
1,498,498,18,18,0,1,0

3,146,146,2,2,0,1,0
8,163,163,4,4,0,1,0
0,179,179,7,4,3,2,1
7,204,204,11,11,0,1,0
10,267,267,44,44,0,1,0
9,339,339,7,7,0,1,0
12,378,378,6,6,0,1,0
5,384,384,19,19,0,1,0
1,388,388,64,64,0,1,0
6,399,399,94,70,24,2,1
2,484,484,7,7,0,1,0
4,494,494,207,57,150,4,3
11,498,498,100,100,0,1,0

16,109,109,16,6,10,2,1
6,110,110,2,2,0,1,0
18,129,129,8,8,0,1,0
4,161,161,26,26,0,1,0
8,161,161,15,15,0,1,0
5,170,170,19,10,9,4,3
13,223,223,35,14,21,4,3
14,232,232,28,24,4,2,1
2,277,277,23,2,21,4,3
10,293,293,3,3,0,1,0
9,323,323,17,6,11,3,2
7,348,348,1,1,0,1,0
17,362,362,9,9,0,1,0
11,383,383,3,3,0,1,0
3,410,410,50,24,26,2,1
0,433,433,7,3,4,2,1
15,438,438,52,52,0,1,0
12,457,457,41,12,29,2,1
1,488,488,11,11,0,1,0

16,176,176,12,7,5,2,1
0,186,186,16,7,9,4,3
6,216,216,1,1,0,1,0
4,247,247,1,1,0,1,0
19,247,247,21,9,12,2,1
10,269,269,4,1,3,2,1
1,353,353,28,28,0,1,0
3,359,359,7,7,0,1,0
13,391,391,4,4,0,1,0
14,392,392,69,69,0,1,0
20,392,392,33,33,0,1,0
9,398,398,12,12,0,1,0
8,399,399,11,11,0,1,0
2,406,406,72,33,39,2,1
17,419,419,36,5,31,2,1
12,429,429,40,40,0,1,0
11,458,458,6,6,0,1,0
7,465,465,45,45,0,1,0
15,465,465,63,3,60,3,2
18,469,469,35,35,0,1,0
5,470,470,21,2,19,2,1

1,139,139,2,2,0,1,0
3,163,163,2,2,0,1,0
9,163,163,32,32,0,1,0
8,192,192,29,29,0,1,0
12,218,218,9,9,0,1,0
2,229,229,9,3,6,3,2
4,236,236,1,1,0,1,0
11,254,254,33,33,0,1,0
13,325,325,39,1,38,3,2
10,327,327,34,34,0,1,0
6,333,333,75,75,0,1,0
7,354,354,1,1,0,1,0
0,367,367,83,83,0,1,0
5,399,399,11,11,0,1,0
14,457,457,28,20,8,3,2
15,465,465,29,5,24,4,3

13,110,110,16,16,0,1,0
1,115,115,9,3,6,3,2
8,125,125,2,2,0,1,0
15,151,151,2,2,0,1,0
7,156,156,28,28,0,1,0
0,173,173,7,1,6,2,1
12,257,257,17,17,0,1,0
4,258,258,42,16,26,3,2
2,266,266,19,10,9,2,1
3,272,272,7,7,0,1,0
5,291,291,26,10,16,3,2
6,318,318,14,2,12,3,2
10,411,411,111,39,72,3,2
14,471,471,44,31,13,2,1
11,472,472,36,36,0,1,0
9,481,481,21,21,0,1,0

3,168,168,4,1,3,2,1
8,236,236,18,18,0,1,0
2,237,237,61,61,0,1,0
5,272,272,6,6,0,1,0
6,296,296,53,53,0,1,0
0,300,300,77,77,0,1,0
10,343,343,77,77,0,1,0
1,404,404,67,15,52,3,2
9,414,414,2,2,0,1,0
4,428,428,27,27,0,1,0
7,432,432,62,52,10,3,2

5,127,127,5,5,0,1,0
9,135,135,1,1,0,1,0
6,230,230,29,4,25,2,1
1,248,248,1,1,0,1,0
0,331,331,65,41,24,2,1
2,331,331,27,12,15,4,3
3,339,339,41,41,0,1,0
11,380,380,76,24,52,3,2
12,386,386,24,14,10,2,1
4,401,401,105,2,103,4,3
7,442,442,17,17,0,1,0
8,443,443,113,113,0,1,0
10,495,495,9,5,4,2,1

3,119,119,3,3,0,1,0
13,160,160,26,7,19,2,1
4,182,182,24,24,0,1,0
7,191,191,1,1,0,1,0
16,201,201,13,13,0,1,0
0,218,218,13,13,0,1,0
8,249,249,18,18,0,1,0
15,281,281,73,11,62,4,3
9,282,282,6,2,4,2,1
12,302,302,6,6,0,1,0
14,342,342,5,2,3,2,1
11,346,346,39,39,0,1,0
10,378,378,31,7,24,4,3
6,391,391,44,40,4,2,1
1,440,440,67,26,41,2,1
2,449,449,51,22,29,4,3
5,453,453,3,3,0,1,0

2,246,246,5,5,0,1,0
3,263,263,38,3,35,2,1
10,268,268,20,20,0,1,0
12,277,277,13,10,3,2,1
8,308,308,70,4,66,3,2
11,353,353,6,6,0,1,0
6,364,364,103,103,0,1,0
9,413,413,21,21,0,1,0
1,418,418,54,54,0,1,0
4,418,418,4,4,0,1,0
7,455,455,5,5,0,1,0
0,468,468,40,26,14,3,2
5,489,489,153,80,73,3,2

9,108,108,3,3,0,1,0
10,160,160,16,16,0,1,0
15,172,172,6,6,0,1,0
5,173,173,6,3,3,2,1
2,181,181,7,7,0,1,0
17,182,182,21,4,17,4,3
16,233,233,6,6,0,1,0
0,262,262,31,31,0,1,0
4,281,281,8,4,4,2,1
7,288,288,24,9,15,4,3
14,291,291,31,31,0,1,0
12,311,311,11,11,0,1,0
11,364,364,25,25,0,1,0
8,390,390,2,2,0,1,0
6,403,403,61,32,29,2,1
13,448,448,146,83,63,4,3
3,459,459,25,25,0,1,0
1,475,475,28,28,0,1,0

2,116,116,36,26,10,3,2
9,154,154,26,26,0,1,0
7,161,161,20,20,0,1,0
13,177,177,30,4,26,4,3
6,182,182,26,26,0,1,0
0,186,186,21,21,0,1,0
5,201,201,2,2,0,1,0
4,223,223,8,1,7,2,1
10,274,274,1,1,0,1,0
11,280,280,23,23,0,1,0
8,295,295,5,5,0,1,0
12,349,349,54,11,43,2,1
1,433,433,19,19,0,1,0
3,469,469,23,14,9,2,1

3,115,115,12,2,10,3,2
2,125,125,6,6,0,1,0
7,142,142,13,13,0,1,0
9,189,189,20,20,0,1,0
6,201,201,2,2,0,1,0
8,201,201,11,11,0,1,0
4,230,230,45,45,0,1,0
13,245,245,21,1,20,2,1
1,246,246,42,30,12,2,1
0,285,285,3,3,0,1,0
11,399,399,15,15,0,1,0
10,412,412,56,46,10,2,1
5,433,433,31,31,0,1,0
12,453,453,112,112,0,1,0
14,497,497,24,24,0,1,0

10,115,115,14,14,0,1,0
5,169,169,6,6,0,1,0
7,171,171,15,15,0,1,0
1,226,226,18,2,16,2,1
4,228,228,23,11,12,4,3
0,274,274,78,78,0,1,0
12,279,279,46,33,13,2,1
8,298,298,62,41,21,4,3
3,301,301,3,3,0,1,0
13,428,428,9,9,0,1,0
11,435,435,16,6,10,2,1
9,441,441,34,11,23,2,1
6,487,487,51,21,30,2,1
2,494,494,42,1,41,2,1

6,104,104,2,2,0,1,0
5,108,108,4,4,0,1,0
7,136,136,32,32,0,1,0
10,146,146,23,7,16,3,2
1,195,195,7,7,0,1,0
2,229,229,33,33,0,1,0
0,301,301,99,38,61,4,3
4,357,357,39,20,19,2,1
11,406,406,83,83,0,1,0
9,425,425,13,3,10,2,1
3,486,486,41,41,0,1,0
8,497,497,19,9,10,2,1

5,131,131,1,1,0,1,0
8,190,190,1,1,0,1,0
10,227,227,7,7,0,1,0
3,234,234,28,28,0,1,0
14,244,244,24,24,0,1,0
9,265,265,1,1,0,1,0
0,299,299,13,13,0,1,0
11,302,302,28,12,16,2,1
12,320,320,105,29,76,3,2
2,321,321,1,1,0,1,0
13,350,350,54,27,27,4,3
7,352,352,25,25,0,1,0
1,376,376,25,25,0,1,0
6,392,392,60,60,0,1,0
4,408,408,97,97,0,1,0

2,103,103,8,2,6,3,2
3,124,124,1,1,0,1,0
5,141,141,14,4,10,3,2
14,144,144,4,4,0,1,0
13,177,177,7,4,3,2,1
8,186,186,49,49,0,1,0
4,250,250,1,1,0,1,0
11,295,295,59,59,0,1,0
10,303,303,13,1,12,2,1
9,307,307,14,14,0,1,0
1,389,389,80,20,60,4,3
7,389,389,30,2,28,3,2
12,407,407,41,24,17,2,1
0,409,409,92,60,32,3,2
6,456,456,2,2,0,1,0

0,143,143,3,3,0,1,0
2,156,156,9,9,0,1,0
11,174,174,5,5,0,1,0
8,190,190,22,22,0,1,0
7,204,204,10,7,3,2,1
9,334,334,61,10,51,4,3
1,338,338,40,40,0,1,0
10,347,347,77,77,0,1,0
5,376,376,19,4,15,2,1
4,386,386,163,85,78,3,2
6,431,431,29,20,9,3,2
3,463,463,38,5,33,2,1

9,170,170,2,2,0,1,0
5,255,255,20,8,12,4,3
6,263,263,14,14,0,1,0
3,302,302,13,13,0,1,0
4,313,313,82,62,20,2,1
7,342,342,28,21,7,2,1
0,349,349,64,22,42,2,1
1,392,392,194,194,0,1,0
8,466,466,86,32,54,4,3
2,480,480,11,4,7,2,1

6,121,121,7,3,4,2,1
0,182,182,27,2,25,4,3
12,192,192,4,1,3,2,1
5,199,199,16,16,0,1,0
9,204,204,32,32,0,1,0
10,288,288,2,2,0,1,0
8,298,298,35,17,18,2,1
11,326,326,24,3,21,4,3
7,350,350,100,76,24,4,3
2,371,371,45,24,21,3,2
4,390,390,61,61,0,1,0
1,481,481,66,19,47,2,1
3,495,495,28,28,0,1,0

2,168,168,1,1,0,1,0
8,200,200,64,64,0,1,0
5,214,214,63,37,26,2,1
11,237,237,4,1,3,2,1
4,242,242,39,15,24,3,2
1,255,255,46,46,0,1,0
0,256,256,9,3,6,2,1
7,280,280,3,3,0,1,0
10,291,291,17,9,8,2,1
14,327,327,62,19,43,2,1
12,333,333,14,14,0,1,0
6,386,386,2,2,0,1,0
3,389,389,4,4,0,1,0
13,435,435,32,26,6,2,1
9,488,488,6,1,5,2,1

10,101,101,12,6,6,3,2
1,155,155,14,14,0,1,0
5,201,201,7,2,5,2,1
12,218,218,21,6,15,2,1
4,234,234,33,33,0,1,0
6,246,246,27,19,8,2,1
2,306,306,73,73,0,1,0
8,340,340,2,2,0,1,0
0,390,390,48,19,29,2,1
7,394,394,5,5,0,1,0
3,403,403,30,3,27,4,3
11,422,422,136,127,9,2,1
9,468,468,21,13,8,2,1

14,109,109,6,6,0,1,0
5,155,155,4,4,0,1,0
3,164,164,29,29,0,1,0
1,188,188,10,7,3,2,1
2,212,212,39,39,0,1,0
8,218,218,1,1,0,1,0
11,299,299,25,25,0,1,0
0,346,346,40,40,0,1,0
10,351,351,55,42,13,4,3
7,379,379,47,47,0,1,0
13,401,401,46,46,0,1,0
9,463,463,6,2,4,2,1
4,469,469,6,3,3,2,1
12,494,494,143,65,78,3,2
6,497,497,5,1,4,2,1

4,112,112,15,15,0,1,0
8,157,157,3,3,0,1,0
11,211,211,3,3,0,1,0
12,254,254,59,59,0,1,0
9,265,265,1,1,0,1,0
7,316,316,6,3,3,2,1
0,317,317,38,17,21,4,3
10,326,326,14,11,3,2,1
5,353,353,9,9,0,1,0
2,401,401,37,37,0,1,0
6,449,449,175,160,15,4,3
3,473,473,151,151,0,1,0
1,492,492,5,5,0,1,0

3,110,110,32,17,15,2,1
1,150,150,5,5,0,1,0
9,152,152,7,7,0,1,0
8,187,187,65,65,0,1,0
12,215,215,19,19,0,1,0
4,249,249,8,8,0,1,0
10,258,258,24,24,0,1,0
0,327,327,6,1,5,2,1
2,378,378,30,4,26,2,1
5,385,385,95,16,79,4,3
7,413,413,21,6,15,4,3
6,439,439,16,6,10,3,2
11,450,450,22,22,0,1,0

3,204,204,73,27,46,3,2
8,206,206,26,26,0,1,0
10,211,211,17,14,3,2,1
7,227,227,15,15,0,1,0
1,271,271,58,22,36,3,2
4,287,287,7,7,0,1,0
11,304,304,49,17,32,2,1
0,354,354,30,30,0,1,0
2,375,375,8,2,6,3,2
6,382,382,15,5,10,2,1
9,419,419,34,17,17,2,1
5,423,423,67,30,37,2,1

5,214,214,50,50,0,1,0
11,232,232,6,2,4,2,1
1,258,258,66,44,22,4,3
9,310,310,1,1,0,1,0
7,326,326,56,56,0,1,0
8,336,336,7,7,0,1,0
6,344,344,109,13,96,4,3
10,353,353,19,19,0,1,0
2,398,398,19,19,0,1,0
3,422,422,59,59,0,1,0
4,444,444,1,1,0,1,0
0,445,445,10,2,8,3,2
12,483,483,56,56,0,1,0

1,116,116,10,10,0,1,0
11,120,120,14,14,0,1,0
0,145,145,19,19,0,1,0
15,166,166,44,44,0,1,0
10,178,178,6,6,0,1,0
14,219,219,6,6,0,1,0
4,263,263,10,10,0,1,0
13,274,274,16,7,9,4,3
12,282,282,36,36,0,1,0
6,283,283,73,1,72,4,3
7,318,318,9,1,8,2,1
5,374,374,11,4,7,2,1
9,430,430,36,36,0,1,0
8,434,434,31,31,0,1,0
3,476,476,5,5,0,1,0
2,479,479,23,14,9,4,3

7,179,179,10,1,9,3,2
5,211,211,10,10,0,1,0
1,254,254,25,12,13,2,1
0,271,271,42,42,0,1,0
11,276,276,15,1,14,3,2
4,311,311,1,1,0,1,0
2,316,316,35,23,12,3,2
3,369,369,123,39,84,4,3
9,419,419,85,85,0,1,0
8,456,456,106,97,9,2,1
10,474,474,15,2,13,2,1
6,494,494,45,2,43,2,1

5,133,133,6,1,5,2,1
10,154,154,1,1,0,1,0
2,172,172,1,1,0,1,0
16,186,186,47,47,0,1,0
3,195,195,8,4,4,2,1
15,256,256,9,9,0,1,0
6,302,302,52,26,26,2,1
11,308,308,16,1,15,2,1
13,311,311,52,52,0,1,0
17,330,330,7,2,5,2,1
4,347,347,5,1,4,2,1
12,416,416,52,32,20,3,2
0,436,436,22,1,21,4,3
14,449,449,25,25,0,1,0
9,449,449,48,48,0,1,0
7,466,466,51,33,18,2,1
8,473,473,1,1,0,1,0
1,492,492,73,11,62,3,2

6,103,103,13,13,0,1,0
10,236,236,28,12,16,2,1
3,253,253,1,1,0,1,0
13,265,265,6,2,4,2,1
12,277,277,28,14,14,3,2
2,311,311,115,50,65,4,3
5,331,331,21,5,16,3,2
4,335,335,25,25,0,1,0
7,360,360,10,4,6,3,2
0,422,422,3,3,0,1,0
8,425,425,5,5,0,1,0
11,463,463,68,7,61,4,3
9,475,475,134,134,0,1,0
1,491,491,30,11,19,4,3

3,135,135,2,2,0,1,0
8,151,151,28,16,12,2,1
6,161,161,37,25,12,3,2
1,168,168,15,15,0,1,0
0,205,205,79,48,31,2,1
11,256,256,40,10,30,3,2
5,274,274,10,10,0,1,0
10,313,313,19,7,12,2,1
2,352,352,5,5,0,1,0
9,439,439,5,5,0,1,0
4,449,449,89,71,18,3,2
7,466,466,16,16,0,1,0

10,102,102,9,9,0,1,0
6,104,104,15,7,8,3,2
0,118,118,54,15,39,2,1
5,139,139,23,23,0,1,0
2,145,145,11,2,9,4,3
3,167,167,14,14,0,1,0
1,176,176,15,15,0,1,0
8,180,180,4,4,0,1,0
4,231,231,31,15,16,2,1
9,243,243,32,20,12,4,3
7,407,407,14,2,12,4,3

12,115,115,5,2,3,2,1
4,124,124,4,4,0,1,0
3,189,189,7,7,0,1,0
11,251,251,6,6,0,1,0
9,265,265,62,20,42,4,3
7,283,283,8,2,6,2,1
1,291,291,55,55,0,1,0
8,301,301,79,28,51,4,3
6,311,311,16,8,8,3,2
0,407,407,52,22,30,4,3
13,410,410,26,26,0,1,0
2,418,418,103,103,0,1,0
10,452,452,26,14,12,3,2
5,485,485,9,3,6,3,2

10,116,116,12,12,0,1,0
1,159,159,2,2,0,1,0
14,207,207,36,36,0,1,0
9,209,209,20,10,10,2,1
6,211,211,9,9,0,1,0
11,213,213,21,21,0,1,0
13,245,245,10,10,0,1,0
5,263,263,11,5,6,2,1
12,264,264,11,5,6,3,2
3,308,308,41,10,31,2,1
7,357,357,11,8,3,2,1
16,366,366,42,28,14,3,2
15,366,366,114,80,34,4,3
18,387,387,8,8,0,1,0
8,447,447,18,2,16,2,1
0,474,474,20,20,0,1,0
4,477,477,21,21,0,1,0
2,480,480,8,3,5,2,1
17,482,482,6,6,0,1,0

4,120,120,24,18,6,2,1
11,156,156,55,37,18,4,3
0,163,163,24,24,0,1,0
13,166,166,1,1,0,1,0
10,211,211,5,5,0,1,0
3,217,217,2,2,0,1,0
14,231,231,26,26,0,1,0
5,310,310,17,3,14,3,2
7,319,319,5,5,0,1,0
2,369,369,20,20,0,1,0
9,372,372,18,2,16,3,2
1,398,398,83,25,58,3,2
6,406,406,5,5,0,1,0
12,415,415,51,51,0,1,0
8,427,427,21,17,4,2,1

8,109,109,2,2,0,1,0
6,111,111,18,10,8,3,2
9,210,210,50,15,35,2,1
2,211,211,21,9,12,3,2
10,261,261,67,67,0,1,0
11,277,277,2,2,0,1,0
3,307,307,154,71,83,4,3
4,317,317,5,5,0,1,0
0,416,416,21,21,0,1,0
1,438,438,15,15,0,1,0
5,454,454,4,4,0,1,0
7,489,489,14,14,0,1,0

10,117,117,5,2,3,2,1
8,201,201,36,20,16,2,1
2,272,272,54,17,37,2,1
0,285,285,16,16,0,1,0
3,287,287,35,23,12,4,3
9,317,317,60,48,12,4,3
11,318,318,19,10,9,4,3
4,346,346,40,40,0,1,0
6,351,351,20,20,0,1,0
1,382,382,48,48,0,1,0
13,402,402,3,3,0,1,0
12,428,428,97,61,36,3,2
5,492,492,13,3,10,3,2
7,494,494,5,5,0,1,0

6,126,126,13,13,0,1,0
11,151,151,36,36,0,1,0
3,168,168,1,1,0,1,0
2,186,186,6,6,0,1,0
8,212,212,31,31,0,1,0
12,286,286,24,16,8,2,1
14,343,343,33,4,29,4,3
10,369,369,18,18,0,1,0
4,399,399,27,8,19,2,1
1,426,426,83,83,0,1,0
13,430,430,55,18,37,2,1
5,439,439,10,4,6,3,2
9,439,439,20,20,0,1,0
0,474,474,8,5,3,2,1
7,490,490,55,55,0,1,0
15,493,493,36,31,5,2,1

5,133,133,16,6,10,2,1
2,145,145,18,18,0,1,0
1,163,163,19,7,12,2,1
16,177,177,13,13,0,1,0
4,215,215,1,1,0,1,0
9,219,219,4,1,3,2,1
6,229,229,7,7,0,1,0
7,280,280,2,2,0,1,0
14,295,295,6,6,0,1,0
15,331,331,1,1,0,1,0
3,333,333,76,35,41,2,1
11,334,334,3,3,0,1,0
0,358,358,17,6,11,2,1
10,372,372,97,97,0,1,0
13,396,396,97,49,48,3,2
8,443,443,2,2,0,1,0
12,463,463,48,48,0,1,0

8,110,110,12,1,11,3,2
6,222,222,22,13,9,2,1
7,224,224,9,9,0,1,0
5,226,226,8,8,0,1,0
4,243,243,61,61,0,1,0
13,244,244,64,34,30,2,1
9,269,269,13,13,0,1,0
1,289,289,33,33,0,1,0
12,357,357,8,8,0,1,0
10,440,440,26,26,0,1,0
11,455,455,78,61,17,4,3
3,472,472,47,47,0,1,0
2,491,491,8,4,4,2,1
0,492,492,42,42,0,1,0

8,125,125,13,1,12,3,2
12,129,129,5,5,0,1,0
1,180,180,10,2,8,3,2
7,201,201,21,21,0,1,0
0,247,247,34,34,0,1,0
2,254,254,30,30,0,1,0
11,257,257,40,9,31,4,3
10,284,284,35,8,27,2,1
13,300,300,9,6,3,2,1
9,313,313,55,7,48,4,3
4,348,348,20,20,0,1,0
5,378,378,41,41,0,1,0
14,425,425,36,17,19,2,1
3,494,494,50,4,46,3,2
6,499,499,10,10,0,1,0

10,107,107,5,2,3,2,1
3,119,119,3,3,0,1,0
1,152,152,4,4,0,1,0
12,169,169,17,17,0,1,0
5,194,194,11,4,7,2,1
4,239,239,40,26,14,2,1
9,252,252,1,1,0,1,0
15,259,259,8,4,4,2,1
14,291,291,1,1,0,1,0
16,313,313,23,23,0,1,0
7,320,320,6,6,0,1,0
17,356,356,24,24,0,1,0
8,361,361,27,27,0,1,0
11,362,362,157,127,30,4,3
0,362,362,2,2,0,1,0
6,386,386,50,50,0,1,0
2,402,402,59,59,0,1,0
13,416,416,2,2,0,1,0

5,124,124,3,3,0,1,0
4,132,132,1,1,0,1,0
1,137,137,3,3,0,1,0
17,199,199,15,15,0,1,0
7,242,242,23,23,0,1,0
10,252,252,13,2,11,2,1
12,265,265,3,3,0,1,0
8,266,266,20,20,0,1,0
15,270,270,79,79,0,1,0
0,270,270,6,6,0,1,0
9,310,310,24,3,21,4,3
18,339,339,6,6,0,1,0
14,339,339,21,21,0,1,0
16,359,359,20,5,15,2,1
3,396,396,27,1,26,2,1
13,423,423,83,83,0,1,0
6,450,450,80,80,0,1,0
2,490,490,33,33,0,1,0
11,498,498,6,6,0,1,0

7,112,112,18,18,0,1,0
4,114,114,10,10,0,1,0
0,173,173,4,4,0,1,0
8,217,217,2,2,0,1,0
9,235,235,16,7,9,4,3
10,306,306,18,3,15,2,1
3,373,373,82,82,0,1,0
2,389,389,91,24,67,4,3
6,419,419,7,4,3,2,1
5,440,440,141,141,0,1,0
1,454,454,102,29,73,3,2

14,100,100,11,11,0,1,0
4,103,103,6,6,0,1,0
7,114,114,5,5,0,1,0
0,137,137,3,3,0,1,0
11,184,184,37,37,0,1,0
6,188,188,31,15,16,3,2
12,211,211,38,38,0,1,0
1,220,220,15,8,7,2,1
3,251,251,22,22,0,1,0
13,303,303,31,31,0,1,0
15,357,357,10,5,5,2,1
10,358,358,6,3,3,2,1
2,367,367,56,56,0,1,0
5,384,384,25,10,15,2,1
9,424,424,11,6,5,2,1
16,462,462,37,2,35,2,1
8,481,481,6,1,5,2,1

9,112,112,3,3,0,1,0
19,114,114,1,1,0,1,0
0,121,121,1,1,0,1,0
11,160,160,22,6,16,2,1
13,204,204,80,3,77,4,3
6,234,234,10,10,0,1,0
5,239,239,55,55,0,1,0
18,243,243,6,6,0,1,0
7,278,278,1,1,0,1,0
1,294,294,3,3,0,1,0
17,300,300,53,53,0,1,0
15,308,308,22,12,10,2,1
16,314,314,5,5,0,1,0
8,365,365,12,4,8,2,1
10,372,372,11,11,0,1,0
3,380,380,9,9,0,1,0
2,445,445,21,9,12,2,1
4,447,447,46,46,0,1,0
12,461,461,3,3,0,1,0
14,487,487,13,9,4,2,1

11,112,112,7,2,5,2,1
0,117,117,3,3,0,1,0
8,146,146,3,3,0,1,0
15,179,179,8,8,0,1,0
1,190,190,33,14,19,2,1
16,202,202,28,10,18,4,3
2,213,213,29,29,0,1,0
17,234,234,33,33,0,1,0
13,261,261,11,2,9,4,3
9,333,333,33,24,9,4,3
12,335,335,80,80,0,1,0
10,350,350,1,1,0,1,0
3,355,355,8,8,0,1,0
5,392,392,5,5,0,1,0
4,404,404,31,31,0,1,0
7,425,425,47,16,31,3,2
6,459,459,9,1,8,2,1
14,480,480,24,20,4,2,1

14,133,133,1,1,0,1,0
9,136,136,1,1,0,1,0
2,152,152,21,7,14,2,1
10,178,178,7,3,4,2,1
8,222,222,32,32,0,1,0
4,228,228,3,3,0,1,0
1,244,244,24,24,0,1,0
11,359,359,135,75,60,4,3
13,360,360,19,19,0,1,0
0,414,414,20,10,10,2,1
5,451,451,72,29,43,2,1
3,476,476,19,13,6,2,1
7,495,495,10,10,0,1,0
12,496,496,46,46,0,1,0
6,499,499,91,61,30,4,3

10,104,104,20,20,0,1,0
9,111,111,22,22,0,1,0
2,181,181,3,3,0,1,0
12,184,184,12,12,0,1,0
3,191,191,1,1,0,1,0
7,203,203,34,11,23,2,1
11,217,217,12,12,0,1,0
6,237,237,2,2,0,1,0
8,316,316,40,40,0,1,0
1,318,318,1,1,0,1,0
13,341,341,55,25,30,4,3
4,355,355,17,17,0,1,0
14,360,360,57,57,0,1,0
16,368,368,5,5,0,1,0
5,395,395,7,7,0,1,0
0,456,456,53,53,0,1,0
15,471,471,32,7,25,2,1

7,104,104,14,5,9,4,3
4,147,147,18,12,6,3,2
11,153,153,14,14,0,1,0
12,162,162,2,2,0,1,0
10,168,168,4,4,0,1,0
16,250,250,9,1,8,3,2
3,261,261,14,14,0,1,0
8,267,267,1,1,0,1,0
17,273,273,34,1,33,4,3
9,308,308,8,2,6,2,1
1,315,315,31,3,28,3,2
0,348,348,12,1,11,2,1
14,408,408,65,65,0,1,0
5,426,426,49,37,12,3,2
15,445,445,9,9,0,1,0
2,461,461,4,4,0,1,0
13,469,469,128,78,50,2,1
6,497,497,40,40,0,1,0

10,110,110,2,2,0,1,0
15,131,131,21,21,0,1,0
8,139,139,7,7,0,1,0
9,153,153,22,16,6,3,2
2,165,165,5,5,0,1,0
11,174,174,41,13,28,3,2
12,192,192,18,6,12,2,1
7,224,224,27,11,16,3,2
14,302,302,36,36,0,1,0
3,327,327,32,32,0,1,0
4,346,346,49,3,46,3,2
13,347,347,2,2,0,1,0
6,373,373,6,6,0,1,0
16,419,419,39,27,12,4,3
0,455,455,1,1,0,1,0
1,460,460,44,44,0,1,0
5,487,487,1,1,0,1,0

11,129,129,16,16,0,1,0
16,185,185,29,12,17,2,1
9,189,189,9,9,0,1,0
13,212,212,18,6,12,4,3
4,215,215,22,7,15,4,3
14,216,216,1,1,0,1,0
17,266,266,26,18,8,2,1
7,272,272,8,1,7,2,1
1,277,277,37,33,4,2,1
5,309,309,71,65,6,3,2
0,327,327,15,2,13,3,2
3,344,344,8,8,0,1,0
8,394,394,21,21,0,1,0
6,412,412,13,13,0,1,0
10,439,439,1,1,0,1,0
2,488,488,1,1,0,1,0
15,491,491,8,8,0,1,0
12,500,500,116,116,0,1,0

4,129,129,9,5,4,2,1
8,146,146,3,3,0,1,0
1,155,155,19,19,0,1,0
5,157,157,7,7,0,1,0
0,177,177,19,19,0,1,0
2,187,187,63,63,0,1,0
10,190,190,43,39,4,2,1
3,250,250,6,6,0,1,0
11,315,315,16,16,0,1,0
7,385,385,18,18,0,1,0
12,402,402,92,74,18,2,1
9,439,439,32,10,22,3,2
6,467,467,31,31,0,1,0

0,147,147,4,4,0,1,0
6,147,147,22,6,16,2,1
3,152,152,8,8,0,1,0
9,159,159,14,14,0,1,0
1,163,163,11,11,0,1,0
11,190,190,37,16,21,4,3
5,196,196,16,16,0,1,0
12,237,237,12,4,8,2,1
8,274,274,20,3,17,2,1
2,295,295,39,39,0,1,0
13,375,375,33,33,0,1,0
7,419,419,57,57,0,1,0
14,426,426,53,53,0,1,0
10,482,482,45,45,0,1,0
4,494,494,27,3,24,2,1

2,122,122,2,2,0,1,0
3,203,203,32,32,0,1,0
5,235,235,7,7,0,1,0
6,237,237,20,20,0,1,0
4,289,289,71,71,0,1,0
7,303,303,3,3,0,1,0
10,304,304,2,2,0,1,0
1,306,306,18,10,8,3,2
0,309,309,17,3,14,3,2
13,323,323,20,20,0,1,0
15,340,340,22,22,0,1,0
11,342,342,24,24,0,1,0
9,361,361,67,62,5,2,1
12,388,388,28,28,0,1,0
14,414,414,103,103,0,1,0
8,473,473,21,21,0,1,0

10,143,143,15,15,0,1,0
4,165,165,31,10,21,4,3
0,169,169,4,4,0,1,0
11,194,194,38,38,0,1,0
5,212,212,5,5,0,1,0
7,249,249,15,1,14,2,1
1,264,264,15,15,0,1,0
14,273,273,10,10,0,1,0
9,280,280,41,41,0,1,0
8,363,363,24,24,0,1,0
12,391,391,50,38,12,4,3
13,456,456,17,17,0,1,0
3,481,481,31,4,27,4,3
2,487,487,44,44,0,1,0
6,495,495,97,54,43,4,3

12,102,102,6,6,0,1,0
14,119,119,40,6,34,2,1
10,129,129,4,1,3,2,1
3,211,211,11,11,0,1,0
7,223,223,2,2,0,1,0
13,280,280,19,13,6,3,2
1,292,292,1,1,0,1,0
6,349,349,14,14,0,1,0
16,351,351,8,2,6,2,1
9,371,371,30,22,8,2,1
5,378,378,53,53,0,1,0
8,394,394,57,17,40,2,1
4,404,404,4,4,0,1,0
17,426,426,37,7,30,4,3
2,457,457,36,36,0,1,0
15,460,460,19,19,0,1,0
11,469,469,51,51,0,1,0
0,476,476,56,56,0,1,0

9,117,117,7,7,0,1,0
1,148,148,13,13,0,1,0
4,172,172,24,19,5,2,1
8,172,172,4,4,0,1,0
5,195,195,14,14,0,1,0
10,234,234,24,9,15,2,1
6,313,313,19,3,16,4,3
3,351,351,70,20,50,3,2
12,358,358,59,23,36,4,3
0,370,370,68,68,0,1,0
11,378,378,36,4,32,4,3
2,393,393,7,7,0,1,0
7,404,404,84,84,0,1,0

1,112,112,2,2,0,1,0
6,121,121,14,14,0,1,0
11,122,122,1,1,0,1,0
15,137,137,20,1,19,2,1
14,153,153,14,14,0,1,0
19,198,198,26,26,0,1,0
5,201,201,9,9,0,1,0
8,235,235,11,11,0,1,0
0,274,274,8,8,0,1,0
9,284,284,10,10,0,1,0
17,309,309,6,6,0,1,0
12,323,323,51,3,48,4,3
13,324,324,61,61,0,1,0
7,339,339,25,1,24,4,3
4,385,385,19,4,15,2,1
2,396,396,35,2,33,2,1
16,403,403,9,9,0,1,0
3,432,432,9,1,8,3,2
10,445,445,6,6,0,1,0
18,494,494,56,17,39,4,3

6,108,108,4,4,0,1,0
16,144,144,2,2,0,1,0
11,244,244,2,2,0,1,0
3,257,257,9,9,0,1,0
12,273,273,7,7,0,1,0
5,304,304,37,37,0,1,0
2,306,306,36,16,20,3,2
15,321,321,54,15,39,4,3
14,322,322,4,4,0,1,0
8,334,334,20,20,0,1,0
7,338,338,10,10,0,1,0
1,346,346,20,11,9,4,3
9,358,358,51,1,50,3,2
4,370,370,5,5,0,1,0
10,373,373,29,3,26,2,1
13,418,418,170,166,4,2,1
0,426,426,37,37,0,1,0

7,104,104,1,1,0,1,0
8,106,106,4,4,0,1,0
3,150,150,3,3,0,1,0
9,161,161,4,4,0,1,0
11,193,193,28,28,0,1,0
1,249,249,35,8,27,4,3
0,252,252,21,10,11,2,1
14,278,278,27,27,0,1,0
12,281,281,30,22,8,3,2
4,289,289,18,18,0,1,0
10,343,343,20,1,19,2,1
6,389,389,42,30,12,4,3
2,396,396,69,69,0,1,0
15,404,404,11,5,6,3,2
16,414,414,65,60,5,2,1
5,452,452,20,20,0,1,0
13,497,497,60,1,59,3,2

1,100,100,6,6,0,1,0
10,115,115,1,1,0,1,0
5,123,123,19,5,14,3,2
9,152,152,22,19,3,2,1
11,212,212,9,9,0,1,0
6,274,274,38,20,18,4,3
3,321,321,29,18,11,2,1
4,326,326,45,8,37,2,1
2,338,338,3,3,0,1,0
12,363,363,69,69,0,1,0
8,366,366,41,2,39,4,3
7,464,464,33,33,0,1,0
0,483,483,120,63,57,4,3

1,125,125,16,16,0,1,0
8,139,139,2,2,0,1,0
9,146,146,47,11,36,3,2
7,161,161,17,17,0,1,0
10,200,200,19,12,7,2,1
4,294,294,1,1,0,1,0
6,399,399,39,8,31,2,1
5,401,401,45,45,0,1,0
12,403,403,11,2,9,2,1
2,445,445,9,9,0,1,0
3,446,446,10,10,0,1,0
0,476,476,151,151,0,1,0
13,487,487,46,46,0,1,0
11,499,499,27,27,0,1,0

4,104,104,6,6,0,1,0
1,111,111,32,15,17,2,1
0,142,142,2,2,0,1,0
6,142,142,7,7,0,1,0
15,147,147,9,3,6,3,2
9,156,156,1,1,0,1,0
8,190,190,20,20,0,1,0
14,248,248,16,16,0,1,0
7,298,298,33,21,12,2,1
11,302,302,57,57,0,1,0
3,317,317,11,5,6,3,2
5,436,436,17,5,12,2,1
2,438,438,2,2,0,1,0
12,442,442,123,60,63,4,3
10,451,451,30,30,0,1,0
13,487,487,23,23,0,1,0

4,126,126,4,4,0,1,0
10,186,186,9,9,0,1,0
6,221,221,27,27,0,1,0
1,225,225,17,1,16,2,1
13,291,291,13,8,5,2,1
2,310,310,19,19,0,1,0
5,321,321,87,58,29,2,1
7,345,345,29,29,0,1,0
8,352,352,2,2,0,1,0
11,355,355,105,105,0,1,0
9,357,357,30,3,27,2,1
12,386,386,58,11,47,4,3
3,461,461,61,61,0,1,0
0,482,482,4,4,0,1,0

10,112,112,10,10,0,1,0
11,141,141,25,25,0,1,0
3,189,189,2,2,0,1,0
13,193,193,4,4,0,1,0
1,209,209,74,74,0,1,0
4,224,224,14,4,10,3,2
2,248,248,16,16,0,1,0
12,318,318,4,4,0,1,0
5,319,319,6,6,0,1,0
7,379,379,26,14,12,2,1
0,418,418,26,26,0,1,0
8,425,425,1,1,0,1,0
9,457,457,156,33,123,4,3
6,499,499,64,47,17,2,1

4,154,154,2,2,0,1,0
2,171,171,28,28,0,1,0
10,204,204,8,8,0,1,0
0,224,224,24,24,0,1,0
11,246,246,14,14,0,1,0
8,285,285,11,11,0,1,0
12,304,304,9,9,0,1,0
5,332,332,75,75,0,1,0
9,396,396,57,57,0,1,0
3,398,398,65,65,0,1,0
6,408,408,86,86,0,1,0
7,463,463,88,10,78,4,3
1,494,494,14,4,10,3,2

5,109,109,4,4,0,1,0
9,120,120,25,9,16,3,2
6,182,182,2,2,0,1,0
8,224,224,23,23,0,1,0
10,265,265,11,11,0,1,0
7,277,277,75,45,30,4,3
1,280,280,28,18,10,2,1
0,356,356,21,18,3,2,1
2,411,411,162,138,24,3,2
4,441,441,44,44,0,1,0
11,455,455,23,23,0,1,0
3,477,477,23,23,0,1,0

2,138,138,6,3,3,2,1
17,153,153,18,1,17,2,1
6,168,168,13,5,8,2,1
12,230,230,24,19,5,2,1
4,273,273,14,4,10,2,1
7,274,274,5,5,0,1,0
1,278,278,25,10,15,4,3
9,293,293,45,37,8,2,1
11,298,298,2,2,0,1,0
16,322,322,27,27,0,1,0
15,330,330,29,29,0,1,0
13,331,331,102,15,87,4,3
10,339,339,16,3,13,2,1
3,354,354,22,22,0,1,0
5,396,396,21,21,0,1,0
8,407,407,20,14,6,3,2
14,435,435,3,3,0,1,0
0,449,449,25,25,0,1,0

10,105,105,5,5,0,1,0
1,166,166,74,74,0,1,0
4,213,213,15,11,4,2,1
7,251,251,8,2,6,3,2
5,257,257,75,12,63,4,3
3,278,278,28,28,0,1,0
8,297,297,44,16,28,3,2
9,393,393,17,11,6,2,1
6,468,468,38,38,0,1,0
2,478,478,29,29,0,1,0
0,496,496,47,8,39,3,2

9,107,107,1,1,0,1,0
15,114,114,12,12,0,1,0
8,133,133,4,4,0,1,0
4,204,204,28,28,0,1,0
5,214,214,2,2,0,1,0
1,306,306,35,23,12,3,2
13,372,372,28,16,12,3,2
7,402,402,69,32,37,2,1
0,408,408,23,23,0,1,0
11,413,413,32,14,18,4,3
12,430,430,67,20,47,2,1
6,432,432,2,2,0,1,0
14,444,444,114,42,72,3,2
2,447,447,45,33,12,2,1
10,465,465,15,15,0,1,0
3,474,474,39,36,3,2,1

12,172,172,23,23,0,1,0
2,207,207,1,1,0,1,0
10,230,230,28,21,7,2,1
1,238,238,17,9,8,3,2
6,298,298,20,20,0,1,0
4,341,341,43,15,28,3,2
13,347,347,9,9,0,1,0
9,369,369,40,16,24,4,3
11,403,403,39,3,36,4,3
7,414,414,37,5,32,2,1
5,436,436,51,51,0,1,0
3,461,461,27,5,22,2,1
14,476,476,71,71,0,1,0
0,483,483,81,38,43,2,1
8,495,495,36,36,0,1,0

1,140,140,2,2,0,1,0
7,191,191,5,5,0,1,0
10,198,198,4,4,0,1,0
2,210,210,1,1,0,1,0
15,296,296,88,70,18,3,2
6,375,375,23,23,0,1,0
16,397,397,2,2,0,1,0
12,417,417,49,49,0,1,0
3,423,423,2,2,0,1,0
9,436,436,46,11,35,3,2
11,450,450,31,31,0,1,0
13,460,460,12,12,0,1,0
14,478,478,84,57,27,4,3
5,485,485,65,65,0,1,0
0,496,496,39,39,0,1,0
8,498,498,84,73,11,2,1
4,499,499,51,27,24,2,1

4,127,127,3,3,0,1,0
5,127,127,15,6,9,2,1
18,155,155,39,39,0,1,0
8,157,157,1,1,0,1,0
10,179,179,11,11,0,1,0
20,212,212,41,7,34,3,2
15,221,221,1,1,0,1,0
9,227,227,1,1,0,1,0
1,241,241,1,1,0,1,0
19,266,266,29,29,0,1,0
0,275,275,1,1,0,1,0
2,292,292,9,2,7,2,1
11,311,311,7,7,0,1,0
6,380,380,10,10,0,1,0
14,387,387,29,29,0,1,0
3,403,403,22,22,0,1,0
16,415,415,9,2,7,2,1
7,436,436,59,59,0,1,0
12,488,488,76,22,54,4,3
17,491,491,27,9,18,2,1
13,494,494,27,3,24,4,3

5,114,114,10,10,0,1,0
9,150,150,12,7,5,2,1
3,164,164,19,19,0,1,0
6,174,174,4,4,0,1,0
12,189,189,13,13,0,1,0
1,200,200,25,16,9,2,1
14,265,265,20,15,5,2,1
7,276,276,30,3,27,2,1
8,302,302,2,2,0,1,0
11,308,308,23,4,19,2,1
15,329,329,45,45,0,1,0
2,338,338,10,10,0,1,0
13,408,408,18,18,0,1,0
10,457,457,60,27,33,2,1
4,469,469,48,48,0,1,0
0,495,495,11,1,10,3,2
16,498,498,90,53,37,3,2

5,154,154,5,1,4,2,1
8,154,154,62,32,30,4,3
3,194,194,18,4,14,2,1
9,224,224,2,2,0,1,0
0,316,316,74,74,0,1,0
6,325,325,5,5,0,1,0
2,365,365,125,125,0,1,0
1,389,389,48,48,0,1,0
7,422,422,36,36,0,1,0
4,492,492,37,1,36,2,1

9,117,117,23,23,0,1,0
7,121,121,15,15,0,1,0
10,223,223,37,37,0,1,0
2,247,247,37,37,0,1,0
8,276,276,17,17,0,1,0
4,304,304,21,18,3,2,1
0,412,412,62,54,8,2,1
6,437,437,14,2,12,3,2
3,443,443,54,54,0,1,0
11,470,470,7,1,6,2,1
1,487,487,103,103,0,1,0
5,493,493,59,59,0,1,0

7,110,110,19,13,6,3,2
1,122,122,2,2,0,1,0
15,134,134,18,8,10,2,1
5,145,145,1,1,0,1,0
8,150,150,14,4,10,3,2
11,161,161,10,10,0,1,0
2,188,188,27,19,8,3,2
6,209,209,1,1,0,1,0
9,218,218,11,11,0,1,0
4,232,232,9,9,0,1,0
3,270,270,8,8,0,1,0
14,301,301,1,1,0,1,0
0,320,320,37,5,32,2,1
16,349,349,22,12,10,2,1
10,362,362,11,4,7,2,1
13,385,385,8,8,0,1,0
17,403,403,88,88,0,1,0
12,411,411,86,26,60,3,2

9,164,164,6,3,3,2,1
6,178,178,2,2,0,1,0
3,233,233,15,7,8,2,1
12,236,236,3,3,0,1,0
20,244,244,23,23,0,1,0
17,251,251,10,10,0,1,0
16,295,295,98,98,0,1,0
2,297,297,8,8,0,1,0
5,310,310,8,8,0,1,0
0,322,322,18,12,6,3,2
14,330,330,25,25,0,1,0
19,331,331,17,17,0,1,0
15,348,348,9,9,0,1,0
4,363,363,61,27,34,2,1
10,363,363,13,13,0,1,0
7,381,381,12,12,0,1,0
11,393,393,25,5,20,3,2
1,419,419,35,35,0,1,0
18,433,433,40,40,0,1,0
8,440,440,19,19,0,1,0
13,490,490,20,2,18,4,3

13,108,108,5,5,0,1,0
7,181,181,7,2,5,2,1
5,211,211,29,5,24,4,3
9,223,223,64,30,34,2,1
0,227,227,12,3,9,4,3
6,237,237,19,7,12,2,1
11,242,242,5,5,0,1,0
1,250,250,14,1,13,3,2
8,274,274,18,7,11,2,1
3,288,288,42,6,36,3,2
10,347,347,29,8,21,4,3
2,351,351,65,15,50,3,2
12,431,431,68,68,0,1,0
4,434,434,3,3,0,1,0
14,474,474,26,15,11,2,1

1,109,109,33,11,22,3,2
2,131,131,18,14,4,2,1
7,136,136,29,3,26,2,1
3,210,210,20,20,0,1,0
0,282,282,24,5,19,4,3
4,322,322,26,19,7,2,1
9,324,324,18,4,14,3,2
11,370,370,2,2,0,1,0
10,371,371,80,48,32,3,2
8,425,425,47,14,33,4,3
6,436,436,19,11,8,2,1
5,495,495,34,34,0,1,0

7,112,112,5,5,0,1,0
0,181,181,36,36,0,1,0
2,196,196,32,32,0,1,0
11,232,232,1,1,0,1,0
12,234,234,18,10,8,2,1
1,263,263,21,15,6,2,1
14,273,273,12,8,4,2,1
15,298,298,15,9,6,2,1
4,307,307,1,1,0,1,0
13,320,320,85,79,6,2,1
5,338,338,1,1,0,1,0
9,359,359,80,80,0,1,0
3,417,417,53,17,36,3,2
8,423,423,19,19,0,1,0
10,446,446,22,22,0,1,0
6,484,484,18,4,14,2,1

4,188,188,24,8,16,2,1
8,212,212,40,16,24,2,1
7,225,225,26,2,24,3,2
9,254,254,32,1,31,3,2
2,259,259,60,2,58,3,2
10,268,268,11,2,9,4,3
11,316,316,16,16,0,1,0
1,363,363,45,45,0,1,0
6,409,409,5,5,0,1,0
0,421,421,46,22,24,2,1
5,430,430,76,76,0,1,0
3,454,454,49,49,0,1,0

4,138,138,13,5,8,2,1
3,152,152,1,1,0,1,0
1,187,187,2,2,0,1,0
2,188,188,24,24,0,1,0
5,189,189,1,1,0,1,0
13,203,203,50,50,0,1,0
6,229,229,72,24,48,3,2
0,230,230,33,33,0,1,0
10,281,281,18,12,6,3,2
7,384,384,4,1,3,2,1
12,405,405,23,23,0,1,0
11,423,423,42,32,10,3,2
8,434,434,84,68,16,3,2
9,450,450,18,18,0,1,0

11,127,127,2,2,0,1,0
2,204,204,47,47,0,1,0
0,249,249,11,11,0,1,0
3,250,250,17,10,7,2,1
8,259,259,40,40,0,1,0
1,301,301,42,14,28,2,1
4,348,348,42,42,0,1,0
6,362,362,5,5,0,1,0
7,362,362,57,33,24,3,2
10,364,364,10,10,0,1,0
12,408,408,127,51,76,4,3
5,415,415,35,35,0,1,0
13,426,426,17,17,0,1,0
9,486,486,3,3,0,1,0

16,167,167,14,5,9,4,3
10,183,183,28,28,0,1,0
11,201,201,49,33,16,2,1
7,237,237,13,13,0,1,0
2,281,281,18,18,0,1,0
9,313,313,3,3,0,1,0
1,324,324,15,5,10,3,2
14,330,330,10,7,3,2,1
13,340,340,15,5,10,2,1
12,372,372,55,55,0,1,0
0,439,439,37,37,0,1,0
3,452,452,1,1,0,1,0
15,469,469,2,2,0,1,0
8,479,479,53,53,0,1,0
5,481,481,69,69,0,1,0
4,483,483,27,21,6,2,1
6,496,496,64,16,48,2,1

2,109,109,6,6,0,1,0
1,114,114,11,11,0,1,0
7,146,146,25,5,20,2,1
14,155,155,3,3,0,1,0
0,158,158,11,11,0,1,0
5,193,193,9,9,0,1,0
11,198,198,25,25,0,1,0
8,224,224,11,11,0,1,0
3,254,254,27,2,25,4,3
4,282,282,1,1,0,1,0
10,308,308,18,18,0,1,0
15,355,355,3,3,0,1,0
12,438,438,3,3,0,1,0
13,440,440,152,72,80,3,2
9,462,462,67,1,66,4,3
6,488,488,51,51,0,1,0

8,119,119,9,9,0,1,0
9,125,125,1,1,0,1,0
10,165,165,19,4,15,2,1
5,181,181,8,5,3,2,1
2,195,195,25,12,13,2,1
6,201,201,8,8,0,1,0
11,212,212,24,24,0,1,0
1,216,216,12,12,0,1,0
14,253,253,29,1,28,2,1
13,298,298,21,21,0,1,0
0,337,337,60,60,0,1,0
12,353,353,78,70,8,2,1
4,365,365,78,78,0,1,0
7,372,372,6,6,0,1,0
3,430,430,11,11,0,1,0

2,125,125,1,1,0,1,0
13,137,137,12,12,0,1,0
8,151,151,3,3,0,1,0
10,200,200,17,6,11,2,1
9,242,242,40,7,33,2,1
11,288,288,25,25,0,1,0
3,290,290,12,12,0,1,0
1,350,350,24,24,0,1,0
12,352,352,34,7,27,2,1
5,376,376,67,20,47,2,1
15,378,378,30,30,0,1,0
0,418,418,64,22,42,2,1
7,425,425,57,35,22,2,1
4,436,436,42,8,34,3,2
6,472,472,2,2,0,1,0
14,472,472,53,53,0,1,0

11,121,121,12,12,0,1,0
14,135,135,3,3,0,1,0
4,163,163,15,3,12,2,1
15,178,178,21,15,6,2,1
13,188,188,37,37,0,1,0
16,219,219,27,27,0,1,0
6,233,233,23,23,0,1,0
17,233,233,29,18,11,2,1
8,261,261,16,16,0,1,0
7,302,302,3,3,0,1,0
1,332,332,9,9,0,1,0
0,370,370,34,34,0,1,0
5,372,372,16,16,0,1,0
12,379,379,12,8,4,2,1
10,383,383,16,16,0,1,0
9,418,418,19,19,0,1,0
2,471,471,42,32,10,3,2
3,488,488,49,35,14,3,2

6,143,143,11,11,0,1,0
2,150,150,21,4,17,2,1
11,242,242,1,1,0,1,0
3,391,391,27,27,0,1,0
5,403,403,6,6,0,1,0
12,426,426,12,4,8,3,2
8,432,432,73,23,50,2,1
10,442,442,52,52,0,1,0
0,466,466,187,113,74,3,2
7,470,470,71,63,8,2,1
4,484,484,18,12,6,3,2
1,487,487,19,2,17,2,1
9,488,488,80,32,48,3,2

12,107,107,9,2,7,2,1
5,125,125,15,15,0,1,0
11,132,132,5,1,4,2,1
14,155,155,14,14,0,1,0
4,174,174,5,5,0,1,0
1,186,186,33,24,9,4,3
7,196,196,1,1,0,1,0
8,227,227,4,4,0,1,0
15,256,256,14,14,0,1,0
6,258,258,18,18,0,1,0
10,280,280,60,15,45,2,1
13,396,396,29,23,6,2,1
9,397,397,10,10,0,1,0
0,433,433,29,29,0,1,0
2,438,438,76,46,30,4,3
3,441,441,8,8,0,1,0
16,489,489,80,10,70,3,2

5,161,161,13,13,0,1,0
4,171,171,12,8,4,2,1
3,193,193,2,2,0,1,0
6,233,233,34,12,22,2,1
12,275,275,18,18,0,1,0
1,289,289,40,40,0,1,0
9,295,295,20,20,0,1,0
8,299,299,60,60,0,1,0
7,305,305,7,2,5,2,1
13,371,371,98,98,0,1,0
11,374,374,14,14,0,1,0
2,396,396,39,29,10,3,2
0,406,406,55,20,35,2,1
10,432,432,4,4,0,1,0
14,460,460,29,10,19,2,1

8,101,101,13,4,9,2,1
3,114,114,5,2,3,2,1
2,122,122,16,16,0,1,0
6,161,161,11,5,6,2,1
10,184,184,20,20,0,1,0
5,269,269,36,36,0,1,0
4,302,302,29,29,0,1,0
9,319,319,6,6,0,1,0
7,409,409,65,65,0,1,0
1,446,446,28,28,0,1,0
11,482,482,47,47,0,1,0
0,492,492,181,89,92,4,3

9,104,104,11,11,0,1,0
0,146,146,21,17,4,2,1
7,168,168,8,3,5,2,1
3,201,201,1,1,0,1,0
2,218,218,1,1,0,1,0
10,218,218,2,2,0,1,0
1,262,262,60,60,0,1,0
6,298,298,37,25,12,2,1
4,346,346,110,12,98,3,2
8,403,403,81,81,0,1,0
5,413,413,53,9,44,2,1
11,468,468,44,44,0,1,0

7,116,116,42,42,0,1,0
3,150,150,8,4,4,2,1
12,199,199,5,5,0,1,0
5,203,203,75,22,53,4,3
9,207,207,38,7,31,4,3
2,280,280,7,7,0,1,0
1,333,333,16,16,0,1,0
11,336,336,4,4,0,1,0
0,383,383,45,24,21,4,3
6,392,392,8,8,0,1,0
4,393,393,35,6,29,2,1
8,464,464,44,20,24,4,3
10,464,464,6,6,0,1,0

12,128,128,5,2,3,2,1
10,130,130,7,7,0,1,0
9,144,144,29,29,0,1,0
6,165,165,19,19,0,1,0
7,197,197,3,3,0,1,0
8,225,225,1,1,0,1,0
11,248,248,45,33,12,4,3
5,342,342,32,15,17,2,1
0,354,354,46,46,0,1,0
3,387,387,31,16,15,4,3
4,419,419,5,5,0,1,0
13,445,445,100,45,55,4,3
1,485,485,16,16,0,1,0
2,498,498,118,101,17,4,3

1,131,131,11,11,0,1,0
6,131,131,2,2,0,1,0
8,141,141,25,4,21,2,1
5,159,159,1,1,0,1,0
10,175,175,47,32,15,4,3
7,231,231,21,21,0,1,0
2,236,236,5,5,0,1,0
13,282,282,55,3,52,4,3
9,284,284,3,3,0,1,0
16,332,332,4,4,0,1,0
14,370,370,45,45,0,1,0
15,417,417,10,10,0,1,0
3,435,435,97,49,48,4,3
11,436,436,34,34,0,1,0
4,440,440,20,20,0,1,0
0,476,476,14,14,0,1,0
12,498,498,5,5,0,1,0

7,122,122,14,14,0,1,0
6,147,147,7,1,6,2,1
1,148,148,24,8,16,2,1
5,182,182,4,4,0,1,0
2,212,212,94,58,36,2,1
10,227,227,64,64,0,1,0
4,291,291,41,26,15,4,3
0,304,304,7,3,4,2,1
9,400,400,14,14,0,1,0
3,412,412,30,30,0,1,0
8,483,483,38,38,0,1,0

2,112,112,26,13,13,4,3
4,130,130,22,22,0,1,0
9,140,140,12,12,0,1,0
13,167,167,29,29,0,1,0
11,184,184,14,1,13,2,1
5,209,209,6,3,3,2,1
7,281,281,5,1,4,2,1
10,287,287,86,11,75,4,3
12,366,366,19,6,13,2,1
1,385,385,8,4,4,2,1
6,394,394,38,17,21,4,3
0,433,433,15,2,13,2,1
3,464,464,55,29,26,2,1
8,500,500,5,5,0,1,0

8,171,171,6,6,0,1,0
6,173,173,11,11,0,1,0
10,191,191,21,1,20,3,2
7,235,235,18,18,0,1,0
9,236,236,43,34,9,2,1
11,251,251,21,21,0,1,0
5,293,293,48,48,0,1,0
1,355,355,3,3,0,1,0
0,435,435,30,30,0,1,0
3,438,438,9,9,0,1,0
2,465,465,147,55,92,4,3
4,476,476,137,35,102,4,3

0,125,125,1,1,0,1,0
8,200,200,2,2,0,1,0
2,202,202,2,2,0,1,0
4,232,232,3,3,0,1,0
9,281,281,99,69,30,4,3
5,283,283,2,2,0,1,0
14,300,300,8,2,6,3,2
3,316,316,53,31,22,2,1
16,324,324,21,21,0,1,0
13,342,342,48,48,0,1,0
11,388,388,40,24,16,3,2
15,408,408,126,126,0,1,0
6,419,419,28,10,18,3,2
10,440,440,21,21,0,1,0
7,447,447,1,1,0,1,0
12,450,450,9,1,8,2,1
1,455,455,30,18,12,2,1

6,135,135,11,11,0,1,0
10,135,135,6,6,0,1,0
4,157,157,11,3,8,3,2
9,199,199,8,8,0,1,0
11,238,238,1,1,0,1,0
13,240,240,95,45,50,3,2
12,314,314,30,30,0,1,0
1,350,350,10,10,0,1,0
3,375,375,1,1,0,1,0
5,399,399,46,46,0,1,0
8,411,411,39,39,0,1,0
14,412,412,16,2,14,2,1
7,423,423,120,13,107,4,3
0,438,438,32,13,19,3,2
2,450,450,21,1,20,2,1

14,101,101,14,14,0,1,0
13,114,114,3,3,0,1,0
1,218,218,13,13,0,1,0
4,225,225,47,47,0,1,0
2,247,247,17,11,6,3,2
6,249,249,13,2,11,2,1
0,276,276,1,1,0,1,0
3,277,277,20,11,9,4,3
15,288,288,20,20,0,1,0
17,289,289,64,64,0,1,0
8,295,295,15,15,0,1,0
16,313,313,31,31,0,1,0
7,333,333,23,23,0,1,0
5,343,343,21,21,0,1,0
10,355,355,2,2,0,1,0
11,381,381,6,2,4,2,1
9,421,421,14,4,10,3,2
12,475,475,25,3,22,4,3
18,488,488,53,5,48,4,3

4,142,142,56,56,0,1,0
9,188,188,27,3,24,3,2
0,221,221,4,1,3,2,1
15,258,258,13,3,10,4,3
13,294,294,13,3,10,3,2
6,316,316,16,16,0,1,0
3,328,328,3,3,0,1,0
10,342,342,31,31,0,1,0
8,354,354,10,10,0,1,0
2,375,375,17,9,8,3,2
1,387,387,4,1,3,2,1
5,387,387,35,35,0,1,0
7,403,403,22,22,0,1,0
11,407,407,21,21,0,1,0
14,419,419,50,23,27,2,1
12,445,445,94,94,0,1,0

0,100,100,10,10,0,1,0
3,109,109,1,1,0,1,0
11,122,122,18,18,0,1,0
9,137,137,6,2,4,2,1
4,181,181,7,7,0,1,0
1,182,182,2,2,0,1,0
2,200,200,25,4,21,4,3
15,208,208,11,5,6,2,1
10,226,226,18,3,15,4,3
8,250,250,3,3,0,1,0
16,308,308,27,27,0,1,0
13,401,401,85,46,39,2,1
14,407,407,21,21,0,1,0
6,437,437,105,105,0,1,0
5,444,444,1,1,0,1,0
12,446,446,37,7,30,3,2
7,479,479,58,58,0,1,0

10,155,155,14,7,7,2,1
7,165,165,7,1,6,2,1
5,212,212,16,2,14,3,2
4,213,213,27,12,15,4,3
0,332,332,2,2,0,1,0
11,352,352,45,5,40,2,1
3,362,362,16,5,11,2,1
1,365,365,161,59,102,4,3
2,391,391,33,33,0,1,0
9,400,400,30,30,0,1,0
6,404,404,34,34,0,1,0
8,437,437,96,82,14,2,1

12,101,101,15,15,0,1,0
22,104,104,1,1,0,1,0
10,110,110,1,1,0,1,0
4,118,118,5,5,0,1,0
14,123,123,2,2,0,1,0
3,142,142,4,4,0,1,0
11,213,213,23,23,0,1,0
9,217,217,2,2,0,1,0
16,234,234,23,23,0,1,0
8,237,237,1,1,0,1,0
19,299,299,77,31,46,3,2
20,321,321,24,3,21,4,3
1,338,338,33,18,15,2,1
6,346,346,6,6,0,1,0
0,361,361,8,3,5,2,1
7,364,364,4,4,0,1,0
15,367,367,36,24,12,3,2
18,374,374,11,3,8,3,2
5,384,384,3,3,0,1,0
2,397,397,22,6,16,3,2
13,427,427,11,11,0,1,0
17,440,440,55,55,0,1,0
21,488,488,57,57,0,1,0

6,148,148,17,17,0,1,0
2,167,167,53,53,0,1,0
10,207,207,23,23,0,1,0
0,257,257,1,1,0,1,0
8,280,280,2,2,0,1,0
11,338,338,9,6,3,2,1
9,400,400,134,134,0,1,0
1,413,413,63,53,10,2,1
5,428,428,31,31,0,1,0
7,458,458,21,1,20,3,2
3,489,489,53,33,20,3,2
4,492,492,58,50,8,3,2

12,156,156,1,1,0,1,0
5,166,166,62,62,0,1,0
15,209,209,35,35,0,1,0
16,244,244,13,7,6,2,1
6,282,282,1,1,0,1,0
11,288,288,41,41,0,1,0
13,316,316,77,38,39,4,3
10,332,332,11,11,0,1,0
4,342,342,21,21,0,1,0
14,343,343,23,6,17,2,1
2,396,396,12,4,8,2,1
1,414,414,1,1,0,1,0
3,431,431,2,2,0,1,0
8,442,442,10,2,8,3,2
9,447,447,11,11,0,1,0
7,455,455,57,15,42,4,3
0,462,462,24,24,0,1,0

5,151,151,25,25,0,1,0
1,158,158,31,17,14,3,2
8,195,195,10,2,8,2,1
6,219,219,11,11,0,1,0
10,246,246,2,2,0,1,0
7,247,247,25,25,0,1,0
2,295,295,46,23,23,4,3
4,313,313,1,1,0,1,0
9,335,335,36,12,24,4,3
3,443,443,32,32,0,1,0
0,471,471,51,51,0,1,0
12,478,478,47,9,38,4,3
11,494,494,145,108,37,4,3

9,138,138,3,3,0,1,0
11,199,199,62,18,44,3,2
2,217,217,7,7,0,1,0
5,231,231,10,10,0,1,0
1,248,248,28,16,12,2,1
12,268,268,17,11,6,3,2
14,274,274,22,15,7,2,1
10,298,298,6,6,0,1,0
7,340,340,14,3,11,2,1
15,358,358,23,11,12,3,2
13,372,372,56,44,12,4,3
8,388,388,32,3,29,2,1
4,405,405,20,20,0,1,0
3,416,416,45,45,0,1,0
0,434,434,29,29,0,1,0
6,480,480,79,25,54,4,3

1,115,115,9,9,0,1,0
4,146,146,11,3,8,2,1
10,169,169,3,3,0,1,0
6,253,253,52,52,0,1,0
7,254,254,80,20,60,4,3
2,256,256,9,6,3,2,1
11,309,309,10,10,0,1,0
0,343,343,113,82,31,2,1
9,450,450,38,21,17,2,1
5,465,465,2,2,0,1,0
3,473,473,87,39,48,3,2
8,491,491,26,7,19,2,1

7,126,126,21,6,15,2,1
2,145,145,47,15,32,3,2
6,158,158,1,1,0,1,0
8,201,201,2,2,0,1,0
1,255,255,16,16,0,1,0
5,328,328,18,18,0,1,0
0,336,336,37,10,27,4,3
9,367,367,33,27,6,2,1
10,447,447,26,26,0,1,0
3,456,456,93,93,0,1,0
4,486,486,157,157,0,1,0

9,100,100,5,5,0,1,0
10,172,172,2,2,0,1,0
4,185,185,9,9,0,1,0
0,206,206,22,8,14,3,2
1,213,213,100,49,51,4,3
2,326,326,8,8,0,1,0
6,337,337,42,15,27,4,3
5,341,341,81,6,75,4,3
3,387,387,39,39,0,1,0
7,455,455,68,68,0,1,0
8,470,470,43,25,18,2,1

7,130,130,41,28,13,2,1
0,133,133,10,10,0,1,0
3,157,157,2,2,0,1,0
5,157,157,4,1,3,2,1
10,203,203,14,14,0,1,0
14,250,250,28,9,19,2,1
2,291,291,10,10,0,1,0
13,304,304,86,20,66,4,3
9,314,314,1,1,0,1,0
4,405,405,71,71,0,1,0
12,412,412,4,4,0,1,0
6,422,422,1,1,0,1,0
11,425,425,17,17,0,1,0
8,440,440,86,86,0,1,0
1,488,488,29,17,12,2,1

7,159,159,6,6,0,1,0
1,163,163,2,2,0,1,0
8,204,204,20,2,18,2,1
9,235,235,24,10,14,3,2
6,271,271,6,6,0,1,0
5,292,292,54,54,0,1,0
0,307,307,25,8,17,2,1
10,310,310,22,22,0,1,0
3,390,390,19,8,11,2,1
11,393,393,66,66,0,1,0
4,406,406,16,16,0,1,0
2,439,439,137,41,96,4,3
13,466,466,22,22,0,1,0
12,499,499,96,64,32,2,1

5,122,122,10,2,8,2,1
8,128,128,5,5,0,1,0
10,168,168,3,3,0,1,0
0,180,180,2,2,0,1,0
9,219,219,9,9,0,1,0
15,237,237,31,1,30,3,2
3,250,250,6,1,5,2,1
14,252,252,47,35,12,4,3
17,285,285,2,2,0,1,0
19,288,288,2,2,0,1,0
18,293,293,14,14,0,1,0
16,308,308,40,40,0,1,0
13,311,311,64,31,33,4,3
6,313,313,1,1,0,1,0
2,382,382,90,65,25,2,1
7,398,398,8,8,0,1,0
12,403,403,8,2,6,3,2
11,407,407,74,29,45,2,1
4,427,427,5,1,4,2,1
1,439,439,6,6,0,1,0

1,168,168,2,2,0,1,0
8,173,173,21,6,15,4,3
3,186,186,18,18,0,1,0
6,187,187,15,7,8,3,2
2,298,298,35,35,0,1,0
10,321,321,7,1,6,2,1
0,381,381,182,152,30,3,2
5,410,410,13,13,0,1,0
4,435,435,10,10,0,1,0
9,447,447,187,82,105,4,3
7,448,448,8,5,3,2,1

10,195,195,9,9,0,1,0
8,211,211,1,1,0,1,0
3,219,219,24,3,21,4,3
1,236,236,42,27,15,4,3
4,260,260,24,5,19,2,1
2,312,312,30,30,0,1,0
7,324,324,5,2,3,2,1
9,350,350,80,63,17,2,1
6,400,400,6,6,0,1,0
11,438,438,56,32,24,4,3
5,444,444,122,122,0,1,0
0,449,449,102,92,10,2,1

12,136,136,1,1,0,1,0
4,210,210,11,1,10,2,1
3,224,224,17,17,0,1,0
8,249,249,2,2,0,1,0
6,270,270,6,6,0,1,0
7,315,315,30,26,4,2,1
0,318,318,17,17,0,1,0
10,325,325,118,4,114,4,3
11,339,339,15,15,0,1,0
1,354,354,107,89,18,4,3
9,373,373,5,5,0,1,0
13,400,400,71,10,61,3,2
2,443,443,82,82,0,1,0
5,452,452,4,4,0,1,0

4,141,141,32,32,0,1,0
8,167,167,9,9,0,1,0
3,183,183,26,26,0,1,0
6,185,185,28,6,22,3,2
9,222,222,6,6,0,1,0
1,223,223,8,8,0,1,0
5,285,285,20,8,12,2,1
7,331,331,28,9,19,4,3
0,403,403,3,3,0,1,0
2,482,482,249,125,124,4,3
10,487,487,49,49,0,1,0

1,104,104,1,1,0,1,0
12,118,118,21,21,0,1,0
11,168,168,3,3,0,1,0
6,185,185,16,16,0,1,0
9,214,214,8,8,0,1,0
16,259,259,11,8,3,2,1
5,259,259,35,35,0,1,0
8,277,277,10,10,0,1,0
2,294,294,14,14,0,1,0
7,295,295,35,35,0,1,0
0,361,361,12,12,0,1,0
14,433,433,92,24,68,3,2
10,434,434,13,3,10,3,2
3,451,451,49,49,0,1,0
4,467,467,41,41,0,1,0
13,499,499,86,74,12,4,3
15,500,500,31,5,26,2,1

0,135,135,4,1,3,2,1
6,203,203,44,19,25,2,1
16,213,213,4,4,0,1,0
14,218,218,70,70,0,1,0
2,271,271,8,4,4,2,1
10,289,289,4,4,0,1,0
13,310,310,17,17,0,1,0
11,319,319,54,54,0,1,0
3,334,334,14,5,9,2,1
5,362,362,32,8,24,2,1
7,400,400,9,3,6,2,1
1,413,413,66,60,6,2,1
17,419,419,4,4,0,1,0
12,432,432,37,2,35,3,2
15,437,437,22,22,0,1,0
4,439,439,37,37,0,1,0
9,487,487,7,7,0,1,0
8,499,499,1,1,0,1,0

9,127,127,4,4,0,1,0
13,128,128,36,3,33,2,1
5,132,132,25,1,24,2,1
12,189,189,24,24,0,1,0
2,226,226,46,14,32,2,1
4,233,233,20,20,0,1,0
8,253,253,9,9,0,1,0
10,319,319,16,7,9,4,3
6,340,340,29,9,20,4,3
1,343,343,3,3,0,1,0
11,381,381,69,47,22,3,2
3,390,390,28,16,12,3,2
7,396,396,6,6,0,1,0
0,437,437,25,25,0,1,0

7,106,106,4,4,0,1,0
8,116,116,24,14,10,3,2
10,123,123,11,11,0,1,0
13,134,134,2,2,0,1,0
6,144,144,7,1,6,3,2
14,206,206,6,6,0,1,0
3,279,279,58,58,0,1,0
9,283,283,9,9,0,1,0
0,367,367,7,7,0,1,0
4,379,379,69,30,39,2,1
12,403,403,72,72,0,1,0
1,411,411,73,73,0,1,0
5,411,411,1,1,0,1,0
2,459,459,12,4,8,2,1
11,484,484,85,85,0,1,0

9,103,103,1,1,0,1,0
3,140,140,1,1,0,1,0
6,157,157,23,23,0,1,0
10,169,169,6,6,0,1,0
0,221,221,134,32,102,4,3
4,267,267,5,5,0,1,0
11,267,267,58,35,23,2,1
2,309,309,11,5,6,3,2
1,323,323,11,11,0,1,0
7,408,408,9,9,0,1,0
5,461,461,99,47,52,3,2
8,482,482,34,34,0,1,0

0,111,111,15,15,0,1,0
10,111,111,7,1,6,2,1
9,166,166,23,23,0,1,0
5,196,196,8,2,6,2,1
1,215,215,32,8,24,4,3
13,248,248,66,66,0,1,0
12,250,250,18,18,0,1,0
6,280,280,37,11,26,2,1
14,288,288,9,1,8,3,2
11,349,349,16,12,4,2,1
15,358,358,37,17,20,3,2
7,376,376,16,16,0,1,0
4,395,395,32,24,8,2,1
8,442,442,2,2,0,1,0
2,466,466,10,4,6,3,2
3,488,488,46,25,21,4,3

8,199,199,14,14,0,1,0
11,224,224,41,26,15,2,1
1,248,248,6,6,0,1,0
0,254,254,110,110,0,1,0
12,258,258,46,46,0,1,0
9,283,283,11,11,0,1,0
2,359,359,53,53,0,1,0
6,367,367,14,14,0,1,0
4,392,392,21,4,17,2,1
7,407,407,46,13,33,2,1
10,409,409,39,29,10,3,2
3,411,411,9,1,8,3,2
5,456,456,9,3,6,3,2

7,120,120,2,2,0,1,0
2,121,121,2,2,0,1,0
0,176,176,71,55,16,3,2
6,247,247,27,27,0,1,0
10,265,265,13,3,10,3,2
11,289,289,21,17,4,2,1
9,297,297,41,14,27,4,3
4,391,391,49,49,0,1,0
3,392,392,22,22,0,1,0
5,393,393,18,8,10,2,1
12,423,423,107,107,0,1,0
8,455,455,35,1,34,3,2
1,458,458,25,3,22,2,1

5,125,125,25,25,0,1,0
6,206,206,46,46,0,1,0
9,213,213,6,6,0,1,0
1,219,219,11,11,0,1,0
4,233,233,2,2,0,1,0
8,250,250,31,31,0,1,0
3,252,252,14,14,0,1,0
7,280,280,23,3,20,2,1
10,342,342,17,3,14,4,3
2,422,422,124,94,30,3,2
0,478,478,145,19,126,4,3

14,103,103,16,2,14,3,2
6,120,120,4,4,0,1,0
9,136,136,7,7,0,1,0
12,205,205,8,8,0,1,0
18,214,214,16,16,0,1,0
0,239,239,42,42,0,1,0
7,246,246,8,5,3,2,1
19,248,248,14,4,10,2,1
11,251,251,8,8,0,1,0
5,282,282,1,1,0,1,0
4,324,324,6,6,0,1,0
15,330,330,13,13,0,1,0
13,363,363,40,19,21,4,3
8,371,371,1,1,0,1,0
16,375,375,46,18,28,3,2
3,406,406,14,6,8,2,1
10,450,450,18,2,16,3,2
17,462,462,71,7,64,3,2
2,473,473,13,3,10,3,2
1,498,498,106,91,15,4,3

7,109,109,7,7,0,1,0
13,132,132,4,4,0,1,0
11,139,139,31,16,15,4,3
5,153,153,6,6,0,1,0
6,175,175,14,5,9,4,3
3,184,184,9,3,6,3,2
14,198,198,1,1,0,1,0
1,203,203,7,7,0,1,0
10,229,229,55,55,0,1,0
2,256,256,1,1,0,1,0
9,310,310,52,52,0,1,0
8,325,325,6,6,0,1,0
0,353,353,85,1,84,3,2
12,394,394,13,13,0,1,0
4,459,459,90,2,88,3,2

3,134,134,23,23,0,1,0
6,156,156,20,20,0,1,0
13,174,174,18,18,0,1,0
8,201,201,1,1,0,1,0
0,284,284,6,6,0,1,0
9,287,287,3,3,0,1,0
4,310,310,8,8,0,1,0
10,324,324,28,23,5,2,1
15,327,327,12,12,0,1,0
11,331,331,8,8,0,1,0
16,340,340,49,49,0,1,0
2,344,344,13,13,0,1,0
14,363,363,43,6,37,2,1
12,426,426,84,45,39,4,3
7,432,432,24,24,0,1,0
5,432,432,61,14,47,2,1
1,473,473,49,40,9,2,1

10,104,104,16,16,0,1,0
8,163,163,2,2,0,1,0
11,178,178,10,10,0,1,0
6,240,240,40,40,0,1,0
13,241,241,11,11,0,1,0
15,268,268,16,8,8,3,2
1,317,317,7,1,6,3,2
14,332,332,28,20,8,3,2
12,367,367,86,72,14,3,2
3,389,389,38,38,0,1,0
2,406,406,62,6,56,4,3
5,416,416,70,70,0,1,0
7,419,419,15,15,0,1,0
4,461,461,5,1,4,2,1
0,491,491,18,18,0,1,0
9,500,500,43,2,41,2,1

10,143,143,4,4,0,1,0
2,193,193,37,25,12,3,2
1,221,221,59,59,0,1,0
4,228,228,22,22,0,1,0
7,246,246,88,2,86,3,2
0,289,289,25,25,0,1,0
5,317,317,16,16,0,1,0
6,352,352,19,19,0,1,0
9,356,356,7,7,0,1,0
11,358,358,43,1,42,3,2
8,466,466,40,40,0,1,0
3,467,467,29,29,0,1,0

6,114,114,6,6,0,1,0
13,117,117,7,7,0,1,0
9,181,181,16,10,6,2,1
7,186,186,17,17,0,1,0
5,195,195,10,10,0,1,0
12,196,196,56,56,0,1,0
17,213,213,2,2,0,1,0
15,224,224,4,4,0,1,0
10,252,252,1,1,0,1,0
0,274,274,10,10,0,1,0
4,287,287,8,8,0,1,0
11,356,356,28,28,0,1,0
16,362,362,63,11,52,3,2
3,368,368,18,14,4,2,1
18,388,388,54,13,41,2,1
14,413,413,12,12,0,1,0
2,475,475,84,84,0,1,0
8,476,476,15,5,10,3,2
1,496,496,6,6,0,1,0

12,111,111,12,3,9,4,3
4,112,112,27,27,0,1,0
10,165,165,21,21,0,1,0
5,177,177,9,9,0,1,0
9,225,225,21,21,0,1,0
1,228,228,15,10,5,2,1
7,228,228,9,9,0,1,0
6,233,233,4,4,0,1,0
3,248,248,38,12,26,2,1
13,303,303,20,20,0,1,0
8,323,323,58,58,0,1,0
11,365,365,27,27,0,1,0
14,365,365,23,23,0,1,0
0,376,376,44,44,0,1,0
2,476,476,9,1,8,2,1

1,101,101,22,22,0,1,0
7,178,178,21,3,18,3,2
0,206,206,84,23,61,4,3
4,236,236,10,10,0,1,0
10,260,260,22,2,20,3,2
8,284,284,40,40,0,1,0
2,322,322,22,22,0,1,0
6,334,334,3,3,0,1,0
9,335,335,87,87,0,1,0
3,430,430,3,3,0,1,0
5,468,468,27,27,0,1,0

16,106,106,21,7,14,2,1
13,112,112,7,3,4,2,1
7,123,123,25,2,23,2,1
2,141,141,1,1,0,1,0
5,180,180,39,16,23,2,1
15,186,186,5,5,0,1,0
3,215,215,15,15,0,1,0
12,219,219,12,8,4,2,1
4,228,228,1,1,0,1,0
10,266,266,67,18,49,2,1
0,328,328,11,11,0,1,0
14,367,367,26,26,0,1,0
6,368,368,2,2,0,1,0
1,402,402,12,12,0,1,0
9,463,463,4,1,3,2,1
11,492,492,24,24,0,1,0
8,500,500,61,57,4,2,1

9,111,111,2,2,0,1,0
1,136,136,37,15,22,3,2
12,167,167,1,1,0,1,0
0,173,173,26,26,0,1,0
10,212,212,9,9,0,1,0
5,216,216,1,1,0,1,0
2,261,261,5,5,0,1,0
13,291,291,29,29,0,1,0
4,321,321,54,23,31,2,1
3,365,365,2,2,0,1,0
6,408,408,17,17,0,1,0
7,440,440,17,17,0,1,0
14,445,445,5,5,0,1,0
11,461,461,85,41,44,3,2
8,495,495,176,121,55,4,3

2,134,134,1,1,0,1,0
9,148,148,36,30,6,3,2
0,168,168,4,4,0,1,0
4,169,169,1,1,0,1,0
13,224,224,8,8,0,1,0
12,229,229,19,5,14,3,2
7,261,261,45,45,0,1,0
8,269,269,36,20,16,3,2
3,398,398,91,53,38,3,2
5,439,439,35,11,24,2,1
11,458,458,15,6,9,4,3
6,479,479,53,53,0,1,0
1,485,485,119,119,0,1,0
10,487,487,3,3,0,1,0

9,104,104,8,2,6,2,1
2,146,146,49,49,0,1,0
11,177,177,17,2,15,4,3
12,177,177,10,10,0,1,0
10,178,178,31,5,26,2,1
7,185,185,8,8,0,1,0
8,301,301,10,6,4,2,1
1,329,329,10,10,0,1,0
4,351,351,12,12,0,1,0
3,358,358,79,79,0,1,0
5,358,358,15,15,0,1,0
6,439,439,109,69,40,4,3
0,461,461,18,9,9,4,3

11,119,119,12,6,6,3,2
6,142,142,12,12,0,1,0
7,178,178,27,15,12,4,3
8,191,191,19,6,13,2,1
1,212,212,15,7,8,2,1
2,214,214,5,5,0,1,0
10,223,223,14,14,0,1,0
0,226,226,24,24,0,1,0
9,242,242,15,3,12,2,1
12,270,270,26,26,0,1,0
13,348,348,50,50,0,1,0
4,366,366,90,66,24,4,3
3,377,377,32,32,0,1,0
5,496,496,42,42,0,1,0

13,135,135,7,7,0,1,0
9,191,191,32,3,29,2,1
5,194,194,27,5,22,3,2
14,254,254,2,2,0,1,0
8,268,268,2,2,0,1,0
3,283,283,19,19,0,1,0
4,291,291,1,1,0,1,0
10,362,362,39,13,26,3,2
6,379,379,38,15,23,4,3
2,408,408,13,13,0,1,0
11,412,412,26,26,0,1,0
1,413,413,42,36,6,2,1
7,431,431,41,11,30,2,1
12,453,453,138,138,0,1,0
0,485,485,79,46,33,2,1

6,149,149,17,17,0,1,0
5,170,170,8,4,4,2,1
10,194,194,45,45,0,1,0
3,195,195,23,1,22,3,2
4,219,219,19,19,0,1,0
1,221,221,19,19,0,1,0
13,233,233,15,3,12,4,3
0,279,279,14,6,8,2,1
12,311,311,5,5,0,1,0
15,314,314,40,40,0,1,0
8,330,330,25,15,10,2,1
14,355,355,67,19,48,2,1
2,415,415,2,2,0,1,0
9,435,435,13,2,11,4,3
7,463,463,55,31,24,3,2
11,499,499,27,8,19,2,1

8,194,194,13,13,0,1,0
6,233,233,29,29,0,1,0
0,264,264,29,29,0,1,0
3,275,275,18,1,17,2,1
10,292,292,3,3,0,1,0
4,300,300,79,44,35,2,1
1,308,308,22,22,0,1,0
2,326,326,63,63,0,1,0
7,341,341,115,115,0,1,0
11,395,395,27,27,0,1,0
5,426,426,16,16,0,1,0
9,450,450,30,19,11,2,1

1,124,124,19,4,15,2,1
7,125,125,12,4,8,3,2
11,136,136,8,8,0,1,0
5,183,183,35,35,0,1,0
2,191,191,15,15,0,1,0
8,202,202,13,13,0,1,0
10,257,257,15,15,0,1,0
4,258,258,5,5,0,1,0
0,352,352,40,36,4,2,1
3,356,356,2,2,0,1,0
9,358,358,90,90,0,1,0
12,413,413,73,18,55,4,3
6,469,469,65,65,0,1,0
13,479,479,5,2,3,2,1

11,106,106,9,9,0,1,0
5,132,132,35,35,0,1,0
10,156,156,7,7,0,1,0
2,205,205,31,14,17,2,1
1,208,208,5,5,0,1,0
3,212,212,13,8,5,2,1
8,270,270,13,1,12,4,3
12,295,295,6,6,0,1,0
9,311,311,14,3,11,2,1
7,416,416,7,7,0,1,0
4,425,425,35,8,27,2,1
6,484,484,223,92,131,4,3
0,492,492,58,55,3,2,1

3,118,118,19,19,0,1,0
5,146,146,1,1,0,1,0
13,174,174,4,1,3,2,1
7,193,193,11,11,0,1,0
9,262,262,1,1,0,1,0
10,262,262,22,22,0,1,0
12,272,272,29,29,0,1,0
11,287,287,34,34,0,1,0
14,356,356,41,5,36,4,3
16,369,369,86,23,63,4,3
0,395,395,70,70,0,1,0
6,425,425,2,2,0,1,0
1,433,433,43,19,24,4,3
8,445,445,62,59,3,2,1
15,479,479,15,2,13,2,1
4,485,485,11,11,0,1,0
2,493,493,15,6,9,4,3

9,100,100,3,3,0,1,0
1,157,157,60,60,0,1,0
8,249,249,97,73,24,2,1
7,252,252,4,1,3,2,1
2,280,280,30,18,12,4,3
6,335,335,9,9,0,1,0
5,356,356,4,1,3,2,1
4,384,384,90,50,40,3,2
3,408,408,1,1,0,1,0
0,487,487,103,56,47,4,3

2,113,113,1,1,0,1,0
1,138,138,2,2,0,1,0
8,149,149,1,1,0,1,0
18,169,169,20,6,14,3,2
7,185,185,4,4,0,1,0
0,194,194,50,41,9,4,3
11,196,196,7,7,0,1,0
12,229,229,1,1,0,1,0
10,243,243,1,1,0,1,0
3,252,252,9,3,6,2,1
19,261,261,12,7,5,2,1
21,264,264,6,6,0,1,0
13,275,275,4,4,0,1,0
20,286,286,17,17,0,1,0
15,318,318,92,70,22,2,1
17,367,367,48,48,0,1,0
4,368,368,19,11,8,2,1
6,386,386,9,9,0,1,0
14,401,401,16,8,8,2,1
5,423,423,53,53,0,1,0
9,429,429,25,16,9,4,3
16,490,490,23,23,0,1,0

0,105,105,1,1,0,1,0
1,142,142,8,2,6,2,1
8,155,155,1,1,0,1,0
17,157,157,21,21,0,1,0
3,176,176,13,5,8,2,1
20,183,183,2,2,0,1,0
9,191,191,5,5,0,1,0
4,218,218,7,7,0,1,0
5,246,246,14,4,10,3,2
13,264,264,15,3,12,3,2
6,284,284,8,8,0,1,0
14,287,287,74,49,25,2,1
19,314,314,15,15,0,1,0
12,320,320,45,39,6,3,2
10,322,322,11,5,6,2,1
2,381,381,48,48,0,1,0
18,394,394,50,30,20,3,2
11,445,445,4,4,0,1,0
16,452,452,41,41,0,1,0
15,477,477,21,21,0,1,0
7,490,490,23,23,0,1,0

4,169,169,36,36,0,1,0
6,174,174,75,40,35,3,2
3,181,181,34,34,0,1,0
12,187,187,5,5,0,1,0
7,232,232,4,1,3,2,1
2,275,275,20,20,0,1,0
11,292,292,4,4,0,1,0
1,318,318,58,22,36,3,2
10,345,345,32,10,22,2,1
8,421,421,28,28,0,1,0
9,427,427,27,9,18,4,3
0,429,429,18,4,14,3,2
5,436,436,1,1,0,1,0

7,106,106,12,12,0,1,0
9,112,112,21,21,0,1,0
4,120,120,45,15,30,4,3
3,151,151,2,2,0,1,0
8,171,171,1,1,0,1,0
10,177,177,8,3,5,2,1
1,293,293,10,4,6,2,1
12,383,383,13,8,5,2,1
2,390,390,41,41,0,1,0
0,395,395,13,13,0,1,0
5,407,407,15,7,8,3,2
13,416,416,135,102,33,2,1
6,468,468,49,49,0,1,0
11,476,476,4,4,0,1,0

7,120,120,17,17,0,1,0
3,128,128,1,1,0,1,0
11,148,148,9,9,0,1,0
12,171,171,25,25,0,1,0
10,193,193,7,7,0,1,0
4,224,224,125,74,51,4,3
6,306,306,29,29,0,1,0
2,383,383,15,9,6,2,1
1,389,389,15,15,0,1,0
9,417,417,77,77,0,1,0
5,421,421,3,3,0,1,0
0,434,434,22,17,5,2,1
8,495,495,25,25,0,1,0

10,140,140,25,25,0,1,0
1,141,141,12,12,0,1,0
9,148,148,13,13,0,1,0
5,159,159,12,3,9,4,3
0,280,280,2,2,0,1,0
2,298,298,15,2,13,2,1
11,324,324,44,2,42,4,3
3,345,345,166,166,0,1,0
8,350,350,58,25,33,2,1
4,381,381,30,6,24,4,3
7,438,438,18,18,0,1,0
6,463,463,17,6,11,2,1

9,101,101,26,1,25,4,3
12,156,156,9,9,0,1,0
2,178,178,51,51,0,1,0
1,210,210,24,24,0,1,0
13,223,223,53,13,40,2,1
5,225,225,8,8,0,1,0
7,262,262,4,1,3,2,1
3,269,269,39,39,0,1,0
4,305,305,19,19,0,1,0
11,352,352,6,1,5,2,1
0,357,357,7,3,4,2,1
10,463,463,49,25,24,3,2
6,476,476,18,18,0,1,0
8,490,490,12,1,11,2,1

7,129,129,4,1,3,2,1
1,135,135,1,1,0,1,0
4,162,162,29,5,24,4,3
10,182,182,1,1,0,1,0
8,189,189,58,17,41,4,3
5,243,243,12,12,0,1,0
2,324,324,38,32,6,3,2
3,345,345,76,67,9,2,1
11,364,364,36,31,5,2,1
9,396,396,9,2,7,2,1
0,416,416,54,6,48,4,3
6,417,417,85,85,0,1,0
12,468,468,23,5,18,4,3

3,104,104,6,6,0,1,0
15,127,127,10,1,9,2,1
13,157,157,4,4,0,1,0
8,174,174,30,30,0,1,0
7,178,178,1,1,0,1,0
16,199,199,3,3,0,1,0
12,200,200,2,2,0,1,0
9,210,210,24,24,0,1,0
6,219,219,10,10,0,1,0
1,224,224,1,1,0,1,0
11,236,236,2,2,0,1,0
0,317,317,3,3,0,1,0
2,332,332,72,72,0,1,0
5,335,335,3,3,0,1,0
4,365,365,14,14,0,1,0
17,378,378,4,4,0,1,0
10,386,386,8,8,0,1,0
14,451,451,161,161,0,1,0
18,469,469,104,104,0,1,0

2,127,127,11,2,9,4,3
8,191,191,13,7,6,2,1
12,193,193,25,25,0,1,0
9,205,205,13,13,0,1,0
0,269,269,14,5,9,2,1
1,283,283,20,20,0,1,0
7,285,285,7,7,0,1,0
4,318,318,19,1,18,3,2
11,322,322,36,8,28,2,1
10,332,332,24,24,0,1,0
14,350,350,11,11,0,1,0
6,382,382,102,102,0,1,0
5,393,393,46,46,0,1,0
13,449,449,104,79,25,2,1
3,487,487,11,1,10,2,1

11,113,113,41,41,0,1,0
13,113,113,6,6,0,1,0
5,116,116,5,5,0,1,0
16,132,132,10,1,9,2,1
12,164,164,14,14,0,1,0
4,176,176,18,18,0,1,0
10,178,178,5,5,0,1,0
6,206,206,20,3,17,2,1
8,209,209,8,8,0,1,0
0,232,232,1,1,0,1,0
7,244,244,1,1,0,1,0
2,248,248,20,6,14,2,1
9,319,319,24,24,0,1,0
3,330,330,65,65,0,1,0
15,366,366,16,16,0,1,0
1,376,376,22,13,9,2,1
14,391,391,29,29,0,1,0

7,126,126,8,8,0,1,0
1,138,138,13,1,12,3,2
8,159,159,4,4,0,1,0
4,165,165,7,7,0,1,0
10,213,213,23,23,0,1,0
6,329,329,67,11,56,3,2
9,339,339,57,49,8,2,1
2,341,341,67,49,18,4,3
3,373,373,114,53,61,3,2
0,395,395,42,42,0,1,0
5,406,406,44,8,36,4,3

8,116,116,1,1,0,1,0
11,123,123,2,2,0,1,0
5,174,174,8,8,0,1,0
4,199,199,7,7,0,1,0
15,201,201,12,12,0,1,0
14,213,213,11,11,0,1,0
3,244,244,34,31,3,2,1
0,268,268,10,4,6,3,2
13,283,283,39,39,0,1,0
7,296,296,18,18,0,1,0
6,303,303,59,35,24,4,3
10,314,314,18,1,17,2,1
12,327,327,128,53,75,4,3
2,398,398,18,8,10,3,2
1,402,402,16,9,7,2,1
9,432,432,16,4,12,4,3
16,472,472,11,1,10,2,1
17,478,478,14,1,13,2,1

3,141,141,19,1,18,3,2
7,209,209,15,9,6,3,2
8,242,242,19,14,5,2,1
0,277,277,45,45,0,1,0
9,296,296,53,3,50,2,1
12,328,328,45,39,6,2,1
5,338,338,42,42,0,1,0
4,400,400,80,11,69,3,2
2,402,402,22,1,21,3,2
10,406,406,10,10,0,1,0
6,408,408,21,6,15,2,1
11,431,431,74,56,18,4,3
1,449,449,12,12,0,1,0

10,120,120,4,4,0,1,0
6,147,147,11,3,8,3,2
12,163,163,34,28,6,2,1
1,187,187,10,10,0,1,0
8,210,210,34,34,0,1,0
9,272,272,29,2,27,2,1
5,298,298,37,37,0,1,0
2,361,361,5,5,0,1,0
3,365,365,113,47,66,4,3
11,368,368,14,14,0,1,0
0,369,369,21,21,0,1,0
4,435,435,62,62,0,1,0
7,444,444,41,41,0,1,0

11,137,137,3,3,0,1,0
1,152,152,13,13,0,1,0
8,169,169,9,9,0,1,0
0,218,218,52,52,0,1,0
9,220,220,50,14,36,3,2
12,268,268,7,7,0,1,0
6,274,274,53,53,0,1,0
5,307,307,5,5,0,1,0
2,398,398,22,22,0,1,0
7,446,446,38,16,22,2,1
4,450,450,24,24,0,1,0
3,459,459,116,44,72,4,3
10,488,488,53,53,0,1,0

14,115,115,4,4,0,1,0
0,175,175,17,3,14,3,2
15,185,185,26,3,23,2,1
6,196,196,5,5,0,1,0
13,259,259,6,6,0,1,0
2,279,279,1,1,0,1,0
10,301,301,68,62,6,2,1
9,305,305,54,13,41,2,1
11,306,306,22,14,8,2,1
3,310,310,3,3,0,1,0
5,323,323,31,31,0,1,0
7,324,324,58,58,0,1,0
8,334,334,62,28,34,3,2
12,380,380,14,1,13,4,3
1,468,468,7,7,0,1,0
4,493,493,44,20,24,4,3

11,101,101,10,10,0,1,0
0,107,107,5,5,0,1,0
7,115,115,6,6,0,1,0
1,147,147,29,29,0,1,0
9,155,155,34,34,0,1,0
10,158,158,11,1,10,3,2
4,180,180,21,21,0,1,0
8,207,207,16,16,0,1,0
3,209,209,59,54,5,2,1
13,210,210,43,43,0,1,0
12,215,215,1,1,0,1,0
5,349,349,1,1,0,1,0
6,375,375,2,2,0,1,0
2,388,388,19,16,3,2,1

12,118,118,4,4,0,1,0
0,144,144,10,5,5,2,1
7,145,145,2,2,0,1,0
14,186,186,30,30,0,1,0
3,200,200,6,6,0,1,0
6,231,231,16,16,0,1,0
1,239,239,19,10,9,2,1
2,274,274,53,53,0,1,0
13,290,290,17,17,0,1,0
10,309,309,16,16,0,1,0
11,309,309,27,27,0,1,0
9,310,310,26,26,0,1,0
4,333,333,22,4,18,4,3
5,350,350,27,27,0,1,0
8,414,414,8,4,4,2,1
16,437,437,71,23,48,4,3
15,498,498,79,79,0,1,0

7,122,122,16,7,9,2,1
2,138,138,1,1,0,1,0
3,156,156,16,1,15,4,3
12,167,167,5,5,0,1,0
13,206,206,13,13,0,1,0
9,212,212,9,3,6,2,1
10,273,273,4,4,0,1,0
8,318,318,3,3,0,1,0
0,330,330,92,37,55,4,3
14,360,360,180,159,21,2,1
1,384,384,14,2,12,3,2
5,431,431,1,1,0,1,0
6,452,452,1,1,0,1,0
11,455,455,21,21,0,1,0
4,477,477,67,24,43,2,1

16,101,101,4,4,0,1,0
3,110,110,1,1,0,1,0
15,110,110,3,3,0,1,0
1,149,149,8,8,0,1,0
0,166,166,14,14,0,1,0
8,175,175,1,1,0,1,0
13,220,220,24,24,0,1,0
6,249,249,3,3,0,1,0
18,272,272,66,66,0,1,0
14,278,278,8,8,0,1,0
12,311,311,17,17,0,1,0
2,343,343,42,32,10,2,1
19,354,354,21,21,0,1,0
9,357,357,22,22,0,1,0
4,367,367,71,34,37,2,1
17,392,392,83,83,0,1,0
5,395,395,16,1,15,4,3
11,463,463,7,7,0,1,0
10,475,475,20,8,12,4,3
7,491,491,3,3,0,1,0

16,141,141,2,2,0,1,0
4,178,178,11,11,0,1,0
13,189,189,22,11,11,4,3
2,199,199,40,31,9,4,3
11,225,225,2,2,0,1,0
1,233,233,16,16,0,1,0
3,243,243,8,2,6,2,1
10,252,252,6,6,0,1,0
12,252,252,14,14,0,1,0
7,253,253,6,6,0,1,0
6,259,259,1,1,0,1,0
15,265,265,63,16,47,3,2
5,276,276,23,23,0,1,0
0,286,286,13,13,0,1,0
18,290,290,32,6,26,4,3
17,313,313,53,37,16,3,2
8,417,417,44,44,0,1,0
9,439,439,19,16,3,2,1
14,482,482,2,2,0,1,0

7,115,115,20,12,8,2,1
2,142,142,11,5,6,2,1
6,158,158,9,9,0,1,0
8,168,168,40,35,5,2,1
4,190,190,37,37,0,1,0
5,221,221,16,2,14,3,2
0,253,253,30,18,12,2,1
1,296,296,37,37,0,1,0
11,309,309,27,27,0,1,0
10,390,390,56,11,45,4,3
12,398,398,2,2,0,1,0
9,430,430,4,4,0,1,0
3,431,431,49,49,0,1,0

3,122,122,23,23,0,1,0
8,130,130,5,5,0,1,0
1,293,293,42,8,34,2,1
5,297,297,18,1,17,3,2
9,314,314,36,36,0,1,0
4,360,360,2,2,0,1,0
2,367,367,63,48,15,4,3
7,381,381,72,44,28,3,2
11,410,410,33,19,14,3,2
6,421,421,89,75,14,3,2
10,430,430,7,2,5,2,1
0,445,445,85,85,0,1,0

1,177,177,24,5,19,2,1
0,201,201,1,1,0,1,0
6,207,207,44,5,39,4,3
7,226,226,13,13,0,1,0
9,242,242,6,6,0,1,0
10,280,280,29,29,0,1,0
8,306,306,95,73,22,3,2
11,315,315,24,14,10,3,2
13,318,318,10,3,7,2,1
2,328,328,41,41,0,1,0
4,331,331,33,33,0,1,0
5,352,352,18,8,10,2,1
3,359,359,26,26,0,1,0
12,414,414,46,11,35,2,1

12,101,101,8,8,0,1,0
8,102,102,1,1,0,1,0
3,109,109,11,7,4,2,1
5,122,122,6,2,4,2,1
2,138,138,6,6,0,1,0
15,146,146,29,29,0,1,0
4,150,150,10,10,0,1,0
17,203,203,37,3,34,2,1
7,231,231,27,27,0,1,0
1,258,258,12,12,0,1,0
11,286,286,23,23,0,1,0
10,310,310,9,6,3,2,1
0,310,310,11,2,9,2,1
9,318,318,62,62,0,1,0
13,341,341,39,39,0,1,0
16,369,369,21,1,20,4,3
14,394,394,2,2,0,1,0
6,492,492,4,4,0,1,0

19,104,104,6,6,0,1,0
13,107,107,5,5,0,1,0
0,124,124,7,3,4,2,1
4,126,126,1,1,0,1,0
3,136,136,6,6,0,1,0
2,189,189,30,23,7,2,1
18,205,205,25,25,0,1,0
11,216,216,9,9,0,1,0
6,221,221,18,18,0,1,0
5,244,244,4,4,0,1,0
12,265,265,21,21,0,1,0
15,287,287,64,55,9,4,3
16,295,295,26,5,21,2,1
20,323,323,10,10,0,1,0
17,330,330,55,55,0,1,0
8,335,335,1,1,0,1,0
14,351,351,9,6,3,2,1
9,385,385,15,15,0,1,0
10,390,390,1,1,0,1,0
7,444,444,29,29,0,1,0
1,463,463,27,27,0,1,0

0,140,140,1,1,0,1,0
5,175,175,41,22,19,2,1
15,179,179,48,48,0,1,0
7,183,183,4,1,3,2,1
1,219,219,2,2,0,1,0
8,219,219,3,3,0,1,0
11,257,257,25,21,4,2,1
9,271,271,8,8,0,1,0
6,278,278,53,37,16,3,2
13,305,305,5,5,0,1,0
14,371,371,74,52,22,2,1
2,389,389,47,47,0,1,0
4,442,442,20,2,18,2,1
10,443,443,13,13,0,1,0
3,458,458,27,27,0,1,0
12,492,492,35,35,0,1,0

4,108,108,2,2,0,1,0
5,109,109,2,2,0,1,0
12,111,111,5,1,4,2,1
2,132,132,15,15,0,1,0
3,144,144,1,1,0,1,0
6,195,195,1,1,0,1,0
7,264,264,37,34,3,2,1
9,305,305,22,4,18,4,3
13,341,341,10,1,9,2,1
1,376,376,119,75,44,2,1
14,379,379,9,3,6,3,2
11,380,380,43,43,0,1,0
0,381,381,31,12,19,2,1
8,452,452,154,111,43,4,3
10,453,453,40,28,12,4,3

3,138,138,9,1,8,3,2
4,168,168,10,2,8,3,2
5,183,183,5,5,0,1,0
8,183,183,20,6,14,2,1
10,213,213,29,29,0,1,0
13,233,233,6,6,0,1,0
12,274,274,8,8,0,1,0
1,312,312,1,1,0,1,0
11,344,344,66,60,6,2,1
2,352,352,110,14,96,3,2
7,354,354,8,8,0,1,0
0,396,396,1,1,0,1,0
9,400,400,28,28,0,1,0
14,442,442,22,4,18,3,2
15,459,459,94,8,86,3,2
6,497,497,50,50,0,1,0

13,135,135,10,10,0,1,0
12,139,139,3,3,0,1,0
14,141,141,9,9,0,1,0
0,177,177,9,9,0,1,0
1,181,181,21,3,18,3,2
3,206,206,36,3,33,2,1
5,296,296,29,29,0,1,0
15,307,307,30,21,9,4,3
10,358,358,17,17,0,1,0
6,365,365,4,4,0,1,0
4,381,381,59,59,0,1,0
11,415,415,79,73,6,2,1
8,432,432,1,1,0,1,0
2,441,441,14,2,12,3,2
9,442,442,101,101,0,1,0
7,446,446,28,8,20,3,2

1,114,114,7,7,0,1,0
3,116,116,15,3,12,4,3
8,167,167,2,2,0,1,0
7,172,172,18,18,0,1,0
13,173,173,21,7,14,3,2
6,175,175,24,24,0,1,0
11,180,180,3,3,0,1,0
5,194,194,8,8,0,1,0
0,224,224,12,12,0,1,0
4,275,275,12,12,0,1,0
10,292,292,11,11,0,1,0
2,423,423,56,8,48,4,3
9,451,451,42,27,15,4,3
12,461,461,142,95,47,2,1
14,470,470,57,9,48,2,1

2,117,117,9,9,0,1,0
9,147,147,35,35,0,1,0
8,166,166,26,26,0,1,0
5,185,185,23,23,0,1,0
6,339,339,29,2,27,4,3
1,340,340,94,94,0,1,0
10,367,367,25,1,24,4,3
3,368,368,123,74,49,2,1
4,387,387,6,6,0,1,0
0,427,427,6,6,0,1,0
7,496,496,11,3,8,2,1

15,117,117,14,3,11,3,2
8,161,161,2,2,0,1,0
9,213,213,47,2,45,3,2
6,228,228,35,35,0,1,0
14,243,243,28,18,10,2,1
10,248,248,6,3,3,2,1
7,294,294,1,1,0,1,0
2,311,311,27,27,0,1,0
3,360,360,12,12,0,1,0
12,364,364,4,4,0,1,0
4,409,409,20,20,0,1,0
16,418,418,2,2,0,1,0
5,444,444,34,34,0,1,0
0,464,464,27,5,22,3,2
11,474,474,52,52,0,1,0
1,474,474,5,5,0,1,0
13,485,485,160,160,0,1,0

8,139,139,3,3,0,1,0
7,144,144,6,2,4,2,1
2,187,187,1,1,0,1,0
17,236,236,4,4,0,1,0
18,260,260,28,28,0,1,0
9,261,261,4,4,0,1,0
6,262,262,51,9,42,4,3
11,305,305,1,1,0,1,0
0,324,324,2,2,0,1,0
12,361,361,2,2,0,1,0
15,372,372,99,99,0,1,0
5,378,378,22,22,0,1,0
14,390,390,10,10,0,1,0
19,407,407,21,21,0,1,0
3,409,409,2,2,0,1,0
4,423,423,90,90,0,1,0
1,431,431,23,23,0,1,0
16,433,433,45,21,24,4,3
13,460,460,64,22,42,4,3
10,466,466,37,37,0,1,0

12,130,130,10,10,0,1,0
10,219,219,15,15,0,1,0
2,232,232,2,2,0,1,0
6,259,259,2,2,0,1,0
0,262,262,24,24,0,1,0
8,266,266,4,4,0,1,0
1,332,332,6,3,3,2,1
11,337,337,75,39,36,4,3
4,342,342,31,20,11,2,1
7,361,361,152,147,5,2,1
3,387,387,1,1,0,1,0
13,392,392,51,43,8,2,1
9,401,401,23,23,0,1,0
14,423,423,61,61,0,1,0
5,494,494,30,30,0,1,0

9,100,100,9,6,3,2,1
13,117,117,7,7,0,1,0
12,170,170,12,1,11,2,1
2,171,171,21,5,16,3,2
15,184,184,12,3,9,4,3
10,211,211,72,72,0,1,0
4,221,221,23,20,3,2,1
5,255,255,25,25,0,1,0
0,260,260,24,21,3,2,1
14,296,296,3,3,0,1,0
6,310,310,2,2,0,1,0
11,326,326,43,43,0,1,0
3,338,338,1,1,0,1,0
16,411,411,15,15,0,1,0
8,425,425,45,15,30,3,2
1,471,471,15,3,12,4,3
7,476,476,24,24,0,1,0

7,106,106,2,2,0,1,0
12,137,137,1,1,0,1,0
1,138,138,1,1,0,1,0
6,207,207,32,32,0,1,0
2,220,220,10,1,9,4,3
10,241,241,68,68,0,1,0
4,264,264,5,1,4,2,1
0,280,280,8,8,0,1,0
5,301,301,128,30,98,4,3
8,325,325,96,66,30,4,3
13,329,329,24,24,0,1,0
9,341,341,7,3,4,2,1
14,453,453,13,13,0,1,0
3,465,465,1,1,0,1,0
11,470,470,3,3,0,1,0

10,118,118,2,2,0,1,0
4,138,138,2,2,0,1,0
14,150,150,2,2,0,1,0
17,190,190,12,12,0,1,0
8,216,216,13,10,3,2,1
21,245,245,7,1,6,3,2
9,293,293,1,1,0,1,0
0,293,293,8,8,0,1,0
1,300,300,3,3,0,1,0
20,310,310,23,19,4,2,1
11,319,319,1,1,0,1,0
7,322,322,13,13,0,1,0
24,333,333,7,7,0,1,0
6,341,341,2,2,0,1,0
18,344,344,31,31,0,1,0
12,358,358,64,64,0,1,0
23,361,361,89,89,0,1,0
19,365,365,63,63,0,1,0
3,389,389,20,14,6,2,1
5,422,422,41,41,0,1,0
22,442,442,34,16,18,4,3
15,448,448,15,6,9,2,1
2,472,472,19,4,15,2,1
16,488,488,17,6,11,2,1
13,498,498,3,3,0,1,0

3,113,113,2,2,0,1,0
10,149,149,5,5,0,1,0
7,163,163,48,6,42,3,2
9,164,164,3,3,0,1,0
4,173,173,1,1,0,1,0
11,176,176,21,18,3,2,1
5,201,201,10,10,0,1,0
1,203,203,12,3,9,3,2
14,235,235,26,26,0,1,0
13,303,303,45,45,0,1,0
15,323,323,40,28,12,2,1
0,401,401,29,29,0,1,0
8,432,432,29,29,0,1,0
2,433,433,4,4,0,1,0
6,443,443,56,15,41,2,1
12,483,483,78,78,0,1,0

0,103,103,1,1,0,1,0
11,116,116,6,6,0,1,0
9,117,117,16,11,5,2,1
14,142,142,8,5,3,2,1
8,166,166,9,3,6,2,1
6,177,177,57,37,20,2,1
12,188,188,8,3,5,2,1
15,191,191,1,1,0,1,0
7,198,198,12,12,0,1,0
2,204,204,3,3,0,1,0
10,218,218,37,37,0,1,0
1,225,225,12,2,10,3,2
13,322,322,84,33,51,4,3
3,364,364,15,3,12,2,1
4,453,453,44,44,0,1,0
5,495,495,24,2,22,3,2

12,120,120,2,2,0,1,0
3,124,124,5,5,0,1,0
4,174,174,33,33,0,1,0
0,266,266,48,26,22,2,1
2,322,322,44,29,15,4,3
7,332,332,3,3,0,1,0
14,340,340,6,1,5,2,1
9,371,371,53,53,0,1,0
13,403,403,7,7,0,1,0
5,417,417,26,9,17,2,1
11,426,426,109,109,0,1,0
8,430,430,73,37,36,3,2
6,431,431,14,14,0,1,0
1,488,488,25,25,0,1,0
10,499,499,48,48,0,1,0

1,104,104,4,4,0,1,0
11,106,106,2,2,0,1,0
9,124,124,7,7,0,1,0
0,135,135,38,32,6,2,1
20,193,193,54,54,0,1,0
17,193,193,2,2,0,1,0
15,193,193,1,1,0,1,0
8,212,212,5,5,0,1,0
10,249,249,10,10,0,1,0
7,251,251,7,2,5,2,1
14,273,273,2,2,0,1,0
21,286,286,10,10,0,1,0
19,334,334,11,11,0,1,0
6,334,334,7,7,0,1,0
2,346,346,11,3,8,3,2
3,375,375,3,3,0,1,0
18,378,378,95,51,44,2,1
13,379,379,32,14,18,2,1
12,420,420,12,4,8,2,1
4,465,465,7,2,5,2,1
5,474,474,9,9,0,1,0
16,491,491,48,48,0,1,0

7,102,102,7,1,6,3,2
5,107,107,26,26,0,1,0
1,122,122,1,1,0,1,0
11,137,137,11,1,10,3,2
10,167,167,12,1,11,2,1
9,198,198,3,3,0,1,0
4,301,301,42,3,39,4,3
0,317,317,10,10,0,1,0
3,327,327,47,26,21,2,1
8,383,383,23,9,14,2,1
2,393,393,55,33,22,2,1
6,454,454,94,94,0,1,0
12,479,479,102,102,0,1,0

4,237,237,10,10,0,1,0
9,238,238,12,12,0,1,0
6,275,275,76,76,0,1,0
0,291,291,18,18,0,1,0
3,301,301,15,1,14,2,1
8,315,315,39,10,29,2,1
10,395,395,35,35,0,1,0
7,400,400,56,56,0,1,0
11,447,447,10,10,0,1,0
2,453,453,126,126,0,1,0
5,465,465,5,5,0,1,0
1,482,482,130,97,33,4,3

10,162,162,10,6,4,2,1
2,178,178,2,2,0,1,0
7,211,211,2,2,0,1,0
4,216,216,11,11,0,1,0
11,239,239,25,17,8,2,1
0,257,257,71,62,9,4,3
12,300,300,10,2,8,2,1
9,304,304,105,46,59,3,2
14,311,311,18,18,0,1,0
5,323,323,9,5,4,2,1
6,332,332,31,2,29,2,1
3,455,455,5,5,0,1,0
13,462,462,6,6,0,1,0
1,470,470,39,39,0,1,0
15,473,473,47,47,0,1,0
8,498,498,69,69,0,1,0

10,171,171,9,1,8,3,2
9,175,175,4,4,0,1,0
13,193,193,4,4,0,1,0
14,193,193,70,30,40,3,2
8,199,199,14,5,9,2,1
1,207,207,4,4,0,1,0
12,243,243,19,19,0,1,0
7,262,262,13,4,9,2,1
0,288,288,30,1,29,2,1
3,297,297,25,25,0,1,0
5,324,324,60,19,41,2,1
11,332,332,36,36,0,1,0
6,347,347,33,24,9,4,3
4,376,376,31,31,0,1,0
2,450,450,36,36,0,1,0

11,153,153,12,12,0,1,0
1,154,154,9,9,0,1,0
9,161,161,28,28,0,1,0
12,204,204,31,16,15,2,1
0,227,227,77,77,0,1,0
6,259,259,12,5,7,2,1
8,327,327,45,9,36,2,1
4,421,421,7,3,4,2,1
5,449,449,32,13,19,2,1
2,463,463,10,4,6,3,2
3,472,472,92,92,0,1,0
10,489,489,20,17,3,2,1
7,497,497,38,38,0,1,0

18,125,125,10,6,4,2,1
2,133,133,1,1,0,1,0
1,141,141,9,9,0,1,0
9,147,147,20,20,0,1,0
13,188,188,18,18,0,1,0
0,191,191,6,3,3,2,1
3,235,235,1,1,0,1,0
17,237,237,2,2,0,1,0
11,262,262,3,3,0,1,0
10,271,271,31,4,27,2,1
12,271,271,15,15,0,1,0
16,283,283,97,97,0,1,0
4,370,370,21,7,14,2,1
14,397,397,34,12,22,2,1
6,423,423,42,42,0,1,0
7,444,444,56,56,0,1,0
15,493,493,26,5,21,4,3
8,495,495,22,22,0,1,0
5,496,496,3,3,0,1,0

7,112,112,3,3,0,1,0
11,136,136,9,9,0,1,0
5,162,162,12,8,4,2,1
16,166,166,20,20,0,1,0
6,174,174,25,25,0,1,0
3,203,203,1,1,0,1,0
4,238,238,53,53,0,1,0
0,249,249,11,11,0,1,0
15,309,309,73,37,36,2,1
9,325,325,13,1,12,2,1
10,397,397,55,5,50,3,2
8,398,398,47,47,0,1,0
12,426,426,28,28,0,1,0
2,460,460,7,7,0,1,0
14,468,468,1,1,0,1,0
1,479,479,5,5,0,1,0
13,498,498,41,14,27,2,1

4,127,127,1,1,0,1,0
2,135,135,4,4,0,1,0
10,155,155,56,2,54,4,3
6,223,223,15,15,0,1,0
9,252,252,1,1,0,1,0
13,257,257,22,22,0,1,0
11,315,315,31,31,0,1,0
3,318,318,43,43,0,1,0
0,362,362,6,6,0,1,0
5,366,366,87,87,0,1,0
14,404,404,12,4,8,3,2
12,428,428,49,16,33,4,3
1,448,448,33,33,0,1,0
7,474,474,63,63,0,1,0
8,487,487,11,6,5,2,1

13,101,101,5,5,0,1,0
1,150,150,1,1,0,1,0
2,160,160,39,39,0,1,0
5,162,162,26,9,17,2,1
15,188,188,3,3,0,1,0
10,222,222,26,1,25,2,1
7,270,270,9,9,0,1,0
3,272,272,11,11,0,1,0
0,300,300,41,19,22,3,2
4,316,316,22,22,0,1,0
8,352,352,1,1,0,1,0
11,359,359,53,17,36,4,3
14,373,373,45,14,31,2,1
9,389,389,103,103,0,1,0
12,394,394,2,2,0,1,0
6,456,456,3,3,0,1,0

3,106,106,9,4,5,2,1
4,117,117,2,2,0,1,0
7,128,128,1,1,0,1,0
6,173,173,4,4,0,1,0
16,179,179,7,7,0,1,0
17,183,183,9,9,0,1,0
15,209,209,34,34,0,1,0
12,224,224,52,28,24,4,3
2,242,242,15,3,12,3,2
5,253,253,12,12,0,1,0
13,265,265,22,22,0,1,0
8,321,321,31,9,22,3,2
14,335,335,35,35,0,1,0
1,343,343,67,33,34,2,1
11,345,345,16,4,12,3,2
10,402,402,43,32,11,2,1
0,490,490,7,7,0,1,0
9,497,497,23,23,0,1,0

8,109,109,18,8,10,2,1
10,131,131,10,5,5,2,1
12,194,194,84,75,9,2,1
7,198,198,2,2,0,1,0
9,230,230,1,1,0,1,0
1,316,316,14,9,5,2,1
0,327,327,86,86,0,1,0
5,340,340,77,77,0,1,0
3,353,353,17,17,0,1,0
6,375,375,5,5,0,1,0
11,377,377,7,3,4,2,1
4,407,407,41,14,27,2,1
2,418,418,8,8,0,1,0

14,103,103,12,12,0,1,0
6,111,111,1,1,0,1,0
5,126,126,5,5,0,1,0
13,126,126,33,33,0,1,0
0,135,135,2,2,0,1,0
9,154,154,27,27,0,1,0
2,176,176,3,3,0,1,0
3,181,181,28,5,23,2,1
4,189,189,4,4,0,1,0
7,204,204,37,24,13,2,1
12,221,221,9,9,0,1,0
8,238,238,18,5,13,2,1
1,318,318,60,60,0,1,0
11,430,430,9,9,0,1,0
15,452,452,12,6,6,3,2
10,483,483,36,36,0,1,0

3,111,111,16,3,13,2,1
8,126,126,8,8,0,1,0
10,175,175,17,17,0,1,0
9,188,188,48,20,28,2,1
5,200,200,27,27,0,1,0
11,204,204,44,20,24,4,3
6,335,335,47,34,13,2,1
1,414,414,29,11,18,2,1
7,450,450,10,2,8,3,2
2,453,453,8,8,0,1,0
13,462,462,24,3,21,4,3
4,479,479,43,15,28,2,1
12,486,486,3,3,0,1,0
0,491,491,52,52,0,1,0

6,113,113,4,1,3,2,1
9,142,142,4,4,0,1,0
11,159,159,17,12,5,2,1
1,268,268,4,1,3,2,1
3,290,290,19,19,0,1,0
15,310,310,12,12,0,1,0
0,312,312,4,4,0,1,0
8,341,341,118,118,0,1,0
14,367,367,19,19,0,1,0
2,394,394,10,5,5,2,1
13,403,403,28,16,12,2,1
12,417,417,150,150,0,1,0
10,421,421,24,24,0,1,0
7,447,447,1,1,0,1,0
4,465,465,7,1,6,3,2
5,498,498,91,67,24,2,1

13,104,104,17,17,0,1,0
4,137,137,15,7,8,2,1
3,167,167,43,10,33,2,1
2,215,215,37,37,0,1,0
9,227,227,28,6,22,3,2
6,255,255,4,4,0,1,0
8,275,275,7,7,0,1,0
5,334,334,1,1,0,1,0
7,379,379,4,4,0,1,0
1,388,388,6,3,3,2,1
10,394,394,10,10,0,1,0
0,448,448,57,57,0,1,0
12,460,460,3,3,0,1,0
11,484,484,174,63,111,4,3

8,107,107,5,5,0,1,0
10,121,121,23,23,0,1,0
7,161,161,46,32,14,2,1
5,175,175,39,27,12,4,3
0,223,223,28,28,0,1,0
13,232,232,24,24,0,1,0
4,265,265,14,8,6,2,1
12,347,347,12,6,6,3,2
2,359,359,12,12,0,1,0
1,377,377,5,5,0,1,0
3,397,397,69,41,28,2,1
11,426,426,26,2,24,4,3
9,444,444,1,1,0,1,0
6,446,446,35,25,10,3,2

7,140,140,2,2,0,1,0
9,155,155,12,8,4,2,1
15,155,155,24,24,0,1,0
4,165,165,34,34,0,1,0
3,260,260,23,7,16,3,2
5,275,275,7,7,0,1,0
8,286,286,1,1,0,1,0
12,322,322,73,73,0,1,0
11,349,349,37,21,16,4,3
14,370,370,44,44,0,1,0
6,384,384,37,23,14,2,1
1,415,415,7,7,0,1,0
16,453,453,14,6,8,3,2
13,453,453,23,20,3,2,1
2,467,467,5,5,0,1,0
0,489,489,15,3,12,2,1
17,494,494,11,1,10,3,2
10,498,498,65,25,40,3,2

11,153,153,1,1,0,1,0
0,159,159,11,6,5,2,1
7,160,160,2,2,0,1,0
9,188,188,1,1,0,1,0
5,189,189,10,2,8,3,2
8,194,194,2,2,0,1,0
10,294,294,22,12,10,2,1
16,391,391,10,4,6,3,2
6,414,414,99,99,0,1,0
1,431,431,12,12,0,1,0
17,434,434,41,14,27,4,3
3,456,456,51,51,0,1,0
14,457,457,8,4,4,2,1
2,484,484,11,11,0,1,0
4,486,486,36,36,0,1,0
12,496,496,2,2,0,1,0
13,500,500,206,143,63,4,3
15,500,500,75,25,50,2,1

8,114,114,1,1,0,1,0
13,132,132,3,3,0,1,0
18,149,149,11,3,8,2,1
17,155,155,15,12,3,2,1
21,162,162,23,3,20,2,1
6,179,179,1,1,0,1,0
20,194,194,10,5,5,2,1
12,212,212,8,3,5,2,1
4,216,216,27,27,0,1,0
3,219,219,6,1,5,2,1
9,222,222,18,9,9,4,3
0,231,231,6,6,0,1,0
2,240,240,1,1,0,1,0
11,277,277,5,5,0,1,0
1,279,279,17,17,0,1,0
14,332,332,35,1,34,4,3
19,350,350,28,28,0,1,0
16,369,369,15,15,0,1,0
15,402,402,93,27,66,4,3
5,431,431,23,9,14,2,1
7,436,436,37,37,0,1,0
10,439,439,18,18,0,1,0

4,160,160,61,61,0,1,0
1,187,187,4,4,0,1,0
12,240,240,23,4,19,2,1
8,251,251,33,6,27,2,1
2,259,259,5,5,0,1,0
13,260,260,14,14,0,1,0
9,282,282,3,3,0,1,0
11,323,323,83,51,32,2,1
10,360,360,25,25,0,1,0
14,363,363,71,71,0,1,0
15,374,374,12,12,0,1,0
7,383,383,37,37,0,1,0
0,399,399,4,4,0,1,0
6,404,404,6,6,0,1,0
3,428,428,3,3,0,1,0
5,429,429,4,4,0,1,0
16,482,482,4,4,0,1,0

2,100,100,1,1,0,1,0
6,137,137,29,23,6,3,2
4,143,143,2,2,0,1,0
7,186,186,10,10,0,1,0
0,210,210,4,4,0,1,0
8,213,213,32,4,28,2,1
15,229,229,7,7,0,1,0
11,287,287,29,29,0,1,0
9,296,296,24,24,0,1,0
3,296,296,1,1,0,1,0
18,338,338,48,40,8,3,2
10,361,361,13,13,0,1,0
5,377,377,7,7,0,1,0
12,395,395,36,6,30,4,3
17,410,410,41,35,6,2,1
13,422,422,15,6,9,4,3
14,431,431,37,10,27,4,3
1,451,451,1,1,0,1,0
16,482,482,108,43,65,4,3

12,123,123,22,9,13,2,1
6,188,188,9,6,3,2,1
11,190,190,50,5,45,2,1
8,193,193,1,1,0,1,0
15,208,208,3,3,0,1,0
2,264,264,42,42,0,1,0
4,288,288,16,16,0,1,0
0,332,332,10,2,8,2,1
13,332,332,16,16,0,1,0
10,357,357,46,28,18,4,3
14,357,357,18,2,16,2,1
3,366,366,31,21,10,2,1
7,417,417,57,7,50,3,2
9,434,434,13,1,12,4,3
1,480,480,77,77,0,1,0
5,497,497,12,12,0,1,0

6,102,102,3,3,0,1,0
19,103,103,7,7,0,1,0
4,125,125,3,3,0,1,0
0,130,130,12,12,0,1,0
1,149,149,2,2,0,1,0
8,171,171,21,21,0,1,0
20,184,184,3,3,0,1,0
3,190,190,9,2,7,2,1
2,203,203,8,8,0,1,0
10,216,216,9,4,5,2,1
16,245,245,67,21,46,2,1
11,271,271,1,1,0,1,0
9,281,281,8,8,0,1,0
5,326,326,21,10,11,2,1
14,336,336,34,34,0,1,0
12,363,363,27,27,0,1,0
7,398,398,34,21,13,2,1
15,402,402,29,10,19,2,1
17,402,402,41,41,0,1,0
18,442,442,35,19,16,2,1
13,464,464,16,10,6,2,1

0,100,100,2,2,0,1,0
12,131,131,9,2,7,2,1
6,235,235,5,5,0,1,0
1,240,240,9,9,0,1,0
8,306,306,32,8,24,4,3
5,315,315,68,39,29,2,1
13,319,319,27,5,22,3,2
11,325,325,19,8,11,3,2
4,356,356,100,62,38,4,3
9,384,384,80,38,42,2,1
14,396,396,34,30,4,2,1
2,398,398,4,4,0,1,0
3,420,420,41,41,0,1,0
10,445,445,45,45,0,1,0
7,454,454,8,8,0,1,0

1,134,134,18,10,8,3,2
6,223,223,24,24,0,1,0
9,234,234,5,5,0,1,0
11,258,258,49,1,48,2,1
13,320,320,15,8,7,2,1
5,321,321,62,62,0,1,0
0,353,353,43,43,0,1,0
2,355,355,37,37,0,1,0
8,373,373,42,27,15,2,1
4,398,398,12,12,0,1,0
7,402,402,13,13,0,1,0
10,436,436,29,2,27,4,3
12,489,489,117,117,0,1,0
3,494,494,5,1,4,2,1

11,107,107,7,7,0,1,0
9,121,121,7,7,0,1,0
10,126,126,16,16,0,1,0
0,144,144,2,2,0,1,0
3,165,165,54,9,45,4,3
12,216,216,32,32,0,1,0
8,225,225,6,3,3,2,1
6,240,240,6,6,0,1,0
5,267,267,26,17,9,4,3
14,312,312,44,44,0,1,0
2,321,321,2,2,0,1,0
1,356,356,36,6,30,3,2
7,373,373,21,9,12,4,3
4,386,386,29,29,0,1,0
13,480,480,72,16,56,4,3

6,107,107,6,6,0,1,0
5,109,109,19,7,12,3,2
12,190,190,36,36,0,1,0
7,204,204,23,23,0,1,0
10,211,211,24,24,0,1,0
0,300,300,9,1,8,3,2
8,336,336,13,4,9,4,3
3,338,338,83,39,44,3,2
1,369,369,6,6,0,1,0
11,425,425,55,37,18,2,1
4,435,435,67,67,0,1,0
2,454,454,38,38,0,1,0
9,471,471,33,21,12,3,2

4,106,106,1,1,0,1,0
0,108,108,2,2,0,1,0
8,147,147,13,13,0,1,0
14,170,170,10,10,0,1,0
12,183,183,6,6,0,1,0
2,253,253,8,2,6,2,1
11,261,261,92,50,42,2,1
5,278,278,28,1,27,4,3
13,324,324,21,13,8,2,1
7,326,326,10,6,4,2,1
9,397,397,21,3,18,3,2
15,410,410,14,10,4,2,1
3,418,418,45,45,0,1,0
6,429,429,49,29,20,3,2
1,442,442,89,89,0,1,0
10,491,491,56,19,37,2,1

8,115,115,15,15,0,1,0
10,124,124,7,7,0,1,0
2,178,178,3,3,0,1,0
3,186,186,13,10,3,2,1
12,256,256,27,13,14,2,1
4,272,272,8,2,6,2,1
6,301,301,5,5,0,1,0
11,318,318,54,7,47,2,1
1,329,329,80,58,22,2,1
0,340,340,63,20,43,2,1
7,373,373,14,14,0,1,0
14,375,375,59,59,0,1,0
13,391,391,22,1,21,2,1
9,404,404,14,14,0,1,0
5,435,435,45,45,0,1,0

9,140,140,2,2,0,1,0
4,161,161,15,2,13,2,1
3,164,164,18,18,0,1,0
10,178,178,6,6,0,1,0
7,226,226,83,66,17,2,1
5,241,241,6,6,0,1,0
6,319,319,8,8,0,1,0
2,331,331,75,75,0,1,0
11,363,363,7,7,0,1,0
8,387,387,85,85,0,1,0
0,424,424,24,19,5,2,1
1,489,489,107,21,86,3,2

9,136,136,4,4,0,1,0
8,140,140,11,11,0,1,0
10,176,176,8,8,0,1,0
12,177,177,1,1,0,1,0
1,278,278,16,16,0,1,0
11,320,320,1,1,0,1,0
2,329,329,33,33,0,1,0
3,364,364,23,23,0,1,0
5,398,398,73,73,0,1,0
0,405,405,37,37,0,1,0
7,411,411,130,72,58,3,2
6,476,476,112,112,0,1,0
4,482,482,99,7,92,3,2

15,105,105,12,12,0,1,0
4,130,130,1,1,0,1,0
5,190,190,22,22,0,1,0
11,205,205,5,5,0,1,0
3,250,250,18,2,16,2,1
1,256,256,8,8,0,1,0
6,283,283,73,73,0,1,0
13,283,283,20,14,6,2,1
8,308,308,14,7,7,2,1
7,338,338,22,11,11,2,1
14,386,386,32,11,21,4,3
2,391,391,23,12,11,4,3
10,408,408,44,3,41,2,1
12,411,411,64,35,29,2,1
9,424,424,67,19,48,4,3
0,438,438,21,21,0,1,0

0,125,125,8,8,0,1,0
3,142,142,13,13,0,1,0
9,144,144,7,1,6,3,2
1,166,166,36,36,0,1,0
8,235,235,49,49,0,1,0
6,247,247,55,55,0,1,0
2,265,265,12,1,11,2,1
7,265,265,16,16,0,1,0
11,272,272,57,34,23,2,1
10,382,382,35,11,24,3,2
12,382,382,6,6,0,1,0
4,461,461,25,25,0,1,0
5,483,483,4,4,0,1,0
13,489,489,37,31,6,3,2

0,100,100,2,2,0,1,0
8,106,106,2,2,0,1,0
10,142,142,7,7,0,1,0
3,160,160,24,4,20,3,2
7,180,180,31,31,0,1,0
6,197,197,65,65,0,1,0
11,268,268,5,5,0,1,0
1,305,305,56,7,49,2,1
4,343,343,81,56,25,2,1
5,447,447,38,38,0,1,0
2,451,451,12,12,0,1,0
12,475,475,29,29,0,1,0
9,477,477,34,20,14,3,2

5,120,120,18,18,0,1,0
9,123,123,17,17,0,1,0
12,124,124,6,3,3,2,1
2,130,130,1,1,0,1,0
10,135,135,14,10,4,2,1
16,148,148,3,3,0,1,0
6,194,194,9,9,0,1,0
15,197,197,5,5,0,1,0
8,197,197,30,30,0,1,0
3,235,235,8,2,6,3,2
4,238,238,1,1,0,1,0
7,265,265,1,1,0,1,0
13,277,277,15,15,0,1,0
14,347,347,127,35,92,4,3
1,414,414,62,20,42,3,2
11,426,426,46,34,12,4,3
0,474,474,10,10,0,1,0

2,114,114,1,1,0,1,0
10,125,125,12,12,0,1,0
7,180,180,5,5,0,1,0
8,228,228,27,27,0,1,0
5,263,263,45,45,0,1,0
6,273,273,2,2,0,1,0
1,333,333,192,126,66,3,2
4,347,347,44,11,33,3,2
9,407,407,71,59,12,3,2
3,425,425,18,18,0,1,0
0,497,497,37,37,0,1,0

4,128,128,30,30,0,1,0
1,153,153,23,23,0,1,0
11,198,198,8,1,7,2,1
2,227,227,37,37,0,1,0
6,232,232,5,2,3,2,1
8,238,238,4,1,3,2,1
10,307,307,20,4,16,3,2
5,369,369,46,46,0,1,0
3,410,410,34,34,0,1,0
7,443,443,91,64,27,2,1
9,444,444,106,68,38,2,1
0,488,488,37,37,0,1,0

8,167,167,4,4,0,1,0
11,225,225,9,3,6,3,2
10,244,244,15,15,0,1,0
5,251,251,19,10,9,4,3
4,256,256,36,15,21,4,3
6,274,274,23,23,0,1,0
14,298,298,24,4,20,3,2
13,321,321,98,98,0,1,0
2,334,334,39,9,30,4,3
9,352,352,64,2,62,3,2
7,366,366,12,12,0,1,0
12,399,399,16,6,10,2,1
0,464,464,10,10,0,1,0
15,466,466,3,3,0,1,0
3,481,481,76,76,0,1,0
1,500,500,26,17,9,2,1

6,247,247,64,44,20,3,2
0,264,264,52,42,10,2,1
2,286,286,41,41,0,1,0
8,342,342,33,2,31,4,3
7,347,347,7,7,0,1,0
3,406,406,12,12,0,1,0
1,427,427,215,139,76,3,2
4,467,467,65,57,8,3,2
5,474,474,11,11,0,1,0

5,179,179,22,22,0,1,0
1,202,202,31,31,0,1,0
11,247,247,55,29,26,3,2
12,259,259,37,37,0,1,0
6,261,261,6,6,0,1,0
3,324,324,10,10,0,1,0
8,334,334,20,20,0,1,0
10,386,386,18,18,0,1,0
7,387,387,67,45,22,2,1
2,390,390,42,42,0,1,0
9,474,474,20,20,0,1,0
4,491,491,36,21,15,2,1
0,495,495,105,105,0,1,0

4,107,107,29,4,25,2,1
1,108,108,2,2,0,1,0
2,136,136,4,4,0,1,0
5,167,167,17,5,12,3,2
6,178,178,9,9,0,1,0
7,284,284,30,3,27,2,1
12,298,298,47,47,0,1,0
13,298,298,6,3,3,2,1
10,330,330,4,4,0,1,0
14,371,371,32,32,0,1,0
9,385,385,5,5,0,1,0
8,401,401,94,66,28,2,1
0,429,429,15,11,4,2,1
11,440,440,84,38,46,3,2
3,499,499,44,5,39,4,3

7,150,150,5,1,4,2,1
3,191,191,1,1,0,1,0
9,191,191,2,2,0,1,0
1,211,211,41,12,29,2,1
11,294,294,54,14,40,2,1
2,324,324,46,28,18,2,1
6,326,326,6,6,0,1,0
5,382,382,87,48,39,4,3
10,442,442,27,27,0,1,0
4,471,471,152,109,43,4,3
8,488,488,85,25,60,3,2
0,493,493,18,18,0,1,0

10,132,132,11,11,0,1,0
0,150,150,2,2,0,1,0
4,182,182,49,49,0,1,0
2,188,188,22,22,0,1,0
5,301,301,12,12,0,1,0
1,315,315,1,1,0,1,0
12,340,340,103,7,96,3,2
3,396,396,103,103,0,1,0
8,403,403,5,5,0,1,0
9,404,404,36,36,0,1,0
6,432,432,26,26,0,1,0
7,475,475,55,55,0,1,0
11,492,492,25,1,24,3,2

15,113,113,15,15,0,1,0
0,118,118,10,10,0,1,0
14,139,139,10,3,7,2,1
8,188,188,11,11,0,1,0
1,193,193,3,3,0,1,0
12,223,223,32,4,28,3,2
2,250,250,38,22,16,3,2
10,295,295,14,14,0,1,0
6,300,300,29,10,19,2,1
13,301,301,10,10,0,1,0
5,345,345,12,2,10,2,1
16,358,358,4,4,0,1,0
11,361,361,107,56,51,4,3
4,452,452,8,8,0,1,0
7,453,453,30,30,0,1,0
3,460,460,48,48,0,1,0
9,473,473,11,11,0,1,0
17,475,475,11,7,4,2,1

5,113,113,9,9,0,1,0
0,117,117,21,21,0,1,0
12,126,126,17,17,0,1,0
14,207,207,18,18,0,1,0
2,219,219,20,3,17,2,1
4,263,263,24,24,0,1,0
13,269,269,30,20,10,2,1
11,272,272,23,11,12,2,1
3,274,274,31,31,0,1,0
1,297,297,4,4,0,1,0
10,325,325,43,11,32,3,2
6,368,368,27,27,0,1,0
9,414,414,67,19,48,4,3
7,416,416,25,12,13,2,1
8,479,479,2,2,0,1,0

12,109,109,6,6,0,1,0
3,118,118,2,2,0,1,0
2,173,173,54,46,8,3,2
4,174,174,1,1,0,1,0
10,202,202,11,4,7,2,1
7,233,233,9,9,0,1,0
9,325,325,28,3,25,2,1
13,340,340,136,136,0,1,0
6,344,344,42,42,0,1,0
11,383,383,23,2,21,3,2
0,406,406,17,17,0,1,0
5,441,441,83,32,51,4,3
1,454,454,7,7,0,1,0
8,456,456,11,11,0,1,0

3,147,147,1,1,0,1,0
8,150,150,8,8,0,1,0
6,162,162,22,4,18,3,2
5,222,222,4,4,0,1,0
18,239,239,23,23,0,1,0
4,254,254,2,2,0,1,0
2,255,255,15,7,8,3,2
10,262,262,28,20,8,3,2
13,265,265,31,11,20,3,2
17,270,270,7,7,0,1,0
7,277,277,3,3,0,1,0
16,342,342,8,8,0,1,0
14,346,346,14,14,0,1,0
1,372,372,27,27,0,1,0
12,384,384,52,52,0,1,0
15,386,386,105,33,72,4,3
11,411,411,56,56,0,1,0
0,466,466,1,1,0,1,0
9,469,469,43,43,0,1,0

2,112,112,4,4,0,1,0
7,178,178,4,4,0,1,0
11,182,182,2,2,0,1,0
8,195,195,81,51,30,4,3
0,235,235,62,62,0,1,0
5,238,238,6,1,5,2,1
10,265,265,27,27,0,1,0
9,289,289,14,6,8,2,1
4,317,317,47,33,14,2,1
3,348,348,38,38,0,1,0
1,392,392,57,57,0,1,0
6,477,477,45,45,0,1,0

9,106,106,14,5,9,4,3
6,110,110,1,1,0,1,0
13,122,122,6,6,0,1,0
2,165,165,10,10,0,1,0
8,175,175,21,21,0,1,0
12,213,213,27,27,0,1,0
14,266,266,73,73,0,1,0
0,365,365,17,1,16,3,2
10,384,384,12,12,0,1,0
3,387,387,85,85,0,1,0
5,401,401,36,11,25,2,1
4,436,436,23,23,0,1,0
1,450,450,12,12,0,1,0
7,464,464,36,18,18,3,2
15,475,475,37,7,30,4,3
11,495,495,10,10,0,1,0

9,133,133,6,2,4,2,1
7,152,152,13,7,6,2,1
5,177,177,23,5,18,3,2
8,188,188,5,1,4,2,1
0,196,196,12,12,0,1,0
4,205,205,69,60,9,2,1
1,216,216,20,7,13,4,3
10,266,266,18,18,0,1,0
2,273,273,47,35,12,4,3
6,295,295,74,74,0,1,0
11,436,436,49,49,0,1,0
3,490,490,19,19,0,1,0

9,120,120,31,31,0,1,0
8,196,196,13,13,0,1,0
3,216,216,16,1,15,4,3
10,222,222,19,19,0,1,0
4,241,241,124,110,14,3,2
11,284,284,12,4,8,2,1
5,296,296,23,23,0,1,0
1,343,343,23,23,0,1,0
0,415,415,1,1,0,1,0
6,440,440,54,54,0,1,0
2,449,449,19,19,0,1,0
7,495,495,31,16,15,2,1

1,103,103,9,9,0,1,0
9,120,120,30,9,21,3,2
6,188,188,6,1,5,2,1
10,210,210,10,10,0,1,0
8,213,213,26,26,0,1,0
5,235,235,26,2,24,3,2
2,291,291,19,19,0,1,0
7,352,352,53,53,0,1,0
11,368,368,25,25,0,1,0
0,373,373,50,50,0,1,0
3,458,458,69,69,0,1,0
12,478,478,22,22,0,1,0
4,487,487,75,48,27,4,3

4,153,153,12,2,10,2,1
1,166,166,4,4,0,1,0
6,183,183,21,21,0,1,0
11,197,197,6,6,0,1,0
13,230,230,46,46,0,1,0
2,251,251,5,5,0,1,0
9,264,264,23,23,0,1,0
10,316,316,22,22,0,1,0
14,336,336,18,18,0,1,0
7,358,358,13,13,0,1,0
3,368,368,56,21,35,3,2
5,371,371,49,14,35,2,1
12,374,374,22,22,0,1,0
0,425,425,61,24,37,3,2
8,428,428,92,56,36,4,3

2,101,101,33,25,8,2,1
1,105,105,2,2,0,1,0
8,117,117,9,3,6,3,2
10,134,134,7,7,0,1,0
12,276,276,82,82,0,1,0
3,279,279,53,53,0,1,0
4,282,282,1,1,0,1,0
11,363,363,19,19,0,1,0
9,365,365,34,17,17,2,1
7,437,437,53,8,45,4,3
5,454,454,6,2,4,2,1
6,482,482,9,9,0,1,0
0,494,494,73,48,25,2,1

12,158,158,8,8,0,1,0
0,261,261,29,14,15,4,3
7,274,274,6,6,0,1,0
10,278,278,13,6,7,2,1
5,291,291,1,1,0,1,0
4,312,312,54,54,0,1,0
14,326,326,63,63,0,1,0
3,373,373,8,3,5,2,1
6,379,379,37,37,0,1,0
1,401,401,43,43,0,1,0
8,401,401,31,31,0,1,0
9,407,407,16,16,0,1,0
2,414,414,20,3,17,4,3
13,420,420,17,2,15,4,3
16,449,449,30,30,0,1,0
11,475,475,20,20,0,1,0
15,492,492,134,134,0,1,0

5,139,139,24,24,0,1,0
8,149,149,8,8,0,1,0
3,175,175,14,14,0,1,0
4,182,182,5,1,4,2,1
1,233,233,24,4,20,2,1
15,246,246,29,29,0,1,0
12,261,261,30,30,0,1,0
13,274,274,34,4,30,3,2
0,290,290,7,4,3,2,1
2,291,291,8,3,5,2,1
9,371,371,2,2,0,1,0
6,396,396,33,33,0,1,0
10,421,421,26,1,25,2,1
7,422,422,55,55,0,1,0
14,463,463,97,97,0,1,0
11,497,497,40,28,12,3,2

15,137,137,2,2,0,1,0
7,150,150,15,3,12,4,3
0,174,174,1,1,0,1,0
2,197,197,21,18,3,2,1
3,240,240,5,5,0,1,0
1,251,251,37,1,36,4,3
13,316,316,54,17,37,2,1
14,362,362,8,4,4,2,1
10,364,364,97,75,22,3,2
12,382,382,46,19,27,4,3
11,408,408,11,11,0,1,0
6,430,430,42,42,0,1,0
8,440,440,5,5,0,1,0
5,458,458,84,84,0,1,0
9,483,483,43,16,27,2,1
4,490,490,14,14,0,1,0

3,138,138,10,3,7,2,1
4,154,154,7,7,0,1,0
6,192,192,13,4,9,4,3
7,218,218,26,19,7,2,1
0,220,220,12,12,0,1,0
2,330,330,5,5,0,1,0
1,331,331,186,156,30,3,2
9,384,384,54,34,20,2,1
8,455,455,13,6,7,2,1
5,496,496,137,53,84,4,3
10,500,500,17,17,0,1,0

7,132,132,7,1,6,2,1
1,216,216,13,2,11,2,1
12,251,251,12,4,8,2,1
5,280,280,25,21,4,2,1
3,309,309,40,40,0,1,0
8,340,340,55,55,0,1,0
9,377,377,35,23,12,3,2
6,382,382,123,95,28,3,2
11,383,383,13,13,0,1,0
0,385,385,50,41,9,4,3
4,424,424,68,62,6,2,1
2,431,431,57,57,0,1,0
10,476,476,4,1,3,2,1

7,168,168,4,4,0,1,0
0,244,244,71,23,48,3,2
8,266,266,18,18,0,1,0
3,282,282,24,12,12,4,3
6,287,287,54,54,0,1,0
2,357,357,5,5,0,1,0
4,441,441,20,20,0,1,0
1,464,464,145,139,6,3,2
9,477,477,50,12,38,3,2
10,492,492,22,22,0,1,0
5,498,498,116,101,15,4,3

2,122,122,4,1,3,2,1
11,126,126,29,29,0,1,0
14,135,135,5,5,0,1,0
1,146,146,10,10,0,1,0
15,153,153,27,27,0,1,0
13,209,209,14,14,0,1,0
3,215,215,20,4,16,2,1
16,226,226,26,12,14,2,1
12,277,277,22,22,0,1,0
17,307,307,5,5,0,1,0
4,312,312,21,5,16,2,1
0,312,312,6,6,0,1,0
9,349,349,1,1,0,1,0
8,352,352,9,9,0,1,0
6,382,382,18,18,0,1,0
7,434,434,32,32,0,1,0
10,469,469,21,3,18,2,1
5,477,477,108,108,0,1,0

3,129,129,10,10,0,1,0
0,145,145,24,24,0,1,0
5,153,153,16,16,0,1,0
10,191,191,16,16,0,1,0
4,208,208,11,11,0,1,0
9,210,210,23,10,13,2,1
2,214,214,33,19,14,2,1
6,313,313,44,44,0,1,0
7,329,329,35,29,6,2,1
1,370,370,54,54,0,1,0
12,372,372,54,54,0,1,0
8,426,426,52,52,0,1,0
11,441,441,2,2,0,1,0

13,130,130,6,6,0,1,0
12,182,182,59,59,0,1,0
1,261,261,7,7,0,1,0
0,272,272,8,8,0,1,0
5,273,273,2,2,0,1,0
2,276,276,40,2,38,3,2
9,295,295,42,42,0,1,0
14,305,305,9,9,0,1,0
17,328,328,4,4,0,1,0
11,342,342,16,1,15,2,1
10,397,397,31,10,21,4,3
4,406,406,5,5,0,1,0
16,418,418,96,62,34,3,2
8,433,433,32,32,0,1,0
3,466,466,10,10,0,1,0
15,469,469,11,11,0,1,0
7,476,476,29,29,0,1,0
6,486,486,50,50,0,1,0

17,111,111,3,3,0,1,0
0,136,136,2,2,0,1,0
14,149,149,2,2,0,1,0
3,154,154,19,19,0,1,0
10,185,185,9,9,0,1,0
7,194,194,15,15,0,1,0
12,201,201,20,20,0,1,0
15,210,210,59,59,0,1,0
4,233,233,27,27,0,1,0
8,238,238,8,2,6,2,1
13,252,252,60,15,45,3,2
1,310,310,12,4,8,3,2
16,332,332,10,10,0,1,0
18,372,372,13,3,10,3,2
6,397,397,28,12,16,4,3
11,416,416,7,7,0,1,0
2,424,424,10,1,9,3,2
5,434,434,46,27,19,2,1
9,488,488,16,4,12,3,2

5,107,107,40,40,0,1,0
6,179,179,17,17,0,1,0
12,199,199,11,11,0,1,0
11,204,204,10,4,6,2,1
4,284,284,2,2,0,1,0
2,297,297,23,23,0,1,0
9,299,299,89,25,64,4,3
3,313,313,11,1,10,3,2
0,325,325,46,31,15,2,1
7,346,346,36,14,22,3,2
1,390,390,27,11,16,3,2
10,432,432,16,7,9,4,3
8,464,464,35,35,0,1,0

11,122,122,11,11,0,1,0
7,142,142,11,5,6,3,2
10,161,161,19,19,0,1,0
9,165,165,15,15,0,1,0
2,202,202,15,15,0,1,0
12,228,228,24,24,0,1,0
1,236,236,16,5,11,2,1
3,308,308,15,10,5,2,1
5,336,336,62,16,46,2,1
8,348,348,52,52,0,1,0
6,387,387,35,3,32,3,2
4,403,403,14,14,0,1,0
0,463,463,135,135,0,1,0

1,136,136,5,2,3,2,1
9,179,179,40,40,0,1,0
10,264,264,5,5,0,1,0
5,285,285,19,5,14,3,2
2,291,291,19,19,0,1,0
6,299,299,18,6,12,3,2
3,336,336,29,5,24,2,1
12,344,344,85,85,0,1,0
7,438,438,3,3,0,1,0
0,462,462,158,139,19,2,1
4,464,464,48,48,0,1,0
8,466,466,4,4,0,1,0
11,474,474,68,56,12,2,1

13,104,104,6,6,0,1,0
8,133,133,15,7,8,2,1
4,141,141,4,4,0,1,0
5,215,215,1,1,0,1,0
10,301,301,54,38,16,3,2
2,317,317,26,26,0,1,0
0,341,341,70,20,50,3,2
12,345,345,38,17,21,2,1
11,388,388,45,45,0,1,0
9,394,394,21,3,18,2,1
3,435,435,1,1,0,1,0
6,450,450,133,65,68,4,3
7,457,457,39,25,14,2,1
1,465,465,39,39,0,1,0

9,141,141,4,4,0,1,0
10,152,152,14,14,0,1,0
5,178,178,1,1,0,1,0
13,222,222,31,1,30,4,3
2,261,261,3,3,0,1,0
11,261,261,1,1,0,1,0
15,281,281,19,3,16,2,1
3,289,289,43,43,0,1,0
7,289,289,11,11,0,1,0
12,298,298,9,9,0,1,0
16,301,301,29,29,0,1,0
6,352,352,67,67,0,1,0
4,370,370,6,6,0,1,0
17,381,381,70,21,49,3,2
14,409,409,35,7,28,3,2
18,411,411,26,10,16,3,2
0,418,418,24,24,0,1,0
1,448,448,13,10,3,2,1
8,469,469,24,24,0,1,0
19,470,470,33,13,20,3,2

5,144,144,3,3,0,1,0
3,187,187,12,9,3,2,1
0,212,212,6,6,0,1,0
4,240,240,9,9,0,1,0
6,320,320,1,1,0,1,0
7,340,340,2,2,0,1,0
2,396,396,39,15,24,2,1
10,406,406,6,6,0,1,0
1,447,447,212,212,0,1,0
11,453,453,101,43,58,3,2
9,464,464,163,72,91,4,3
8,500,500,45,45,0,1,0

13,108,108,14,14,0,1,0
4,109,109,3,3,0,1,0
7,115,115,1,1,0,1,0
16,137,137,13,6,7,2,1
5,187,187,31,11,20,2,1
14,233,233,34,7,27,3,2
10,246,246,28,28,0,1,0
2,254,254,14,2,12,3,2
12,339,339,20,12,8,2,1
0,379,379,1,1,0,1,0
8,391,391,9,9,0,1,0
1,425,425,20,5,15,2,1
11,442,442,6,6,0,1,0
15,459,459,106,26,80,3,2
3,470,470,41,41,0,1,0
17,475,475,20,12,8,3,2
6,488,488,43,43,0,1,0
9,492,492,41,26,15,2,1

11,103,103,5,5,0,1,0
8,109,109,23,20,3,2,1
12,110,110,16,4,12,4,3
0,167,167,3,3,0,1,0
2,171,171,53,53,0,1,0
4,243,243,7,3,4,2,1
13,269,269,2,2,0,1,0
3,270,270,34,34,0,1,0
7,281,281,22,16,6,2,1
6,349,349,21,10,11,2,1
10,392,392,51,5,46,3,2
1,411,411,63,26,37,2,1
9,485,485,52,45,7,2,1
5,494,494,3,3,0,1,0

12,100,100,13,13,0,1,0
10,102,102,4,4,0,1,0
14,133,133,5,1,4,2,1
13,151,151,21,21,0,1,0
4,229,229,15,8,7,2,1
8,229,229,20,20,0,1,0
9,269,269,22,2,20,3,2
2,313,313,19,4,15,3,2
0,349,349,12,12,0,1,0
1,396,396,32,15,17,2,1
15,415,415,38,13,25,2,1
3,435,435,53,31,22,2,1
6,441,441,27,27,0,1,0
5,466,466,62,62,0,1,0
11,474,474,94,44,50,2,1
7,500,500,28,28,0,1,0

6,132,132,8,8,0,1,0
7,223,223,25,1,24,4,3
1,272,272,4,1,3,2,1
9,341,341,103,63,40,3,2
4,346,346,80,31,49,2,1
5,346,346,43,43,0,1,0
0,355,355,93,93,0,1,0
10,361,361,27,17,10,3,2
8,369,369,1,1,0,1,0
11,370,370,14,6,8,3,2
2,373,373,47,47,0,1,0
3,481,481,33,33,0,1,0

13,110,110,6,6,0,1,0
5,114,114,1,1,0,1,0
9,123,123,4,4,0,1,0
7,145,145,15,15,0,1,0
16,160,160,18,3,15,4,3
11,165,165,7,2,5,2,1
2,207,207,32,5,27,3,2
15,212,212,47,47,0,1,0
0,236,236,30,30,0,1,0
12,312,312,13,13,0,1,0
10,323,323,5,1,4,2,1
3,334,334,16,4,12,2,1
4,404,404,11,11,0,1,0
8,437,437,9,9,0,1,0
6,453,453,51,51,0,1,0
14,475,475,109,97,12,4,3
1,480,480,33,33,0,1,0

1,125,125,2,2,0,1,0
5,129,129,14,14,0,1,0
4,160,160,1,1,0,1,0
10,178,178,21,5,16,4,3
17,191,191,1,1,0,1,0
13,201,201,25,25,0,1,0
14,249,249,78,66,12,4,3
2,254,254,18,18,0,1,0
12,261,261,9,9,0,1,0
8,261,261,32,18,14,2,1
3,279,279,13,8,5,2,1
9,331,331,1,1,0,1,0
11,342,342,18,13,5,2,1
15,345,345,40,27,13,2,1
7,364,364,36,24,12,4,3
0,380,380,39,39,0,1,0
16,412,412,29,19,10,2,1
6,422,422,5,5,0,1,0

7,135,135,20,20,0,1,0
6,138,138,40,40,0,1,0
0,140,140,11,11,0,1,0
2,170,170,74,74,0,1,0
4,227,227,15,6,9,4,3
9,263,263,5,5,0,1,0
5,282,282,3,3,0,1,0
10,287,287,1,1,0,1,0
3,320,320,21,14,7,2,1
1,374,374,22,12,10,3,2
11,400,400,46,46,0,1,0
8,500,500,64,19,45,4,3

6,120,120,2,2,0,1,0
10,130,130,5,5,0,1,0
13,132,132,19,19,0,1,0
12,147,147,7,2,5,2,1
11,156,156,2,2,0,1,0
8,183,183,11,11,0,1,0
0,186,186,6,6,0,1,0
16,186,186,18,6,12,4,3
19,194,194,29,29,0,1,0
9,223,223,3,3,0,1,0
2,256,256,6,6,0,1,0
21,266,266,2,2,0,1,0
5,270,270,8,8,0,1,0
3,270,270,31,15,16,2,1
1,297,297,42,42,0,1,0
4,298,298,4,1,3,2,1
17,337,337,95,33,62,3,2
14,367,367,4,4,0,1,0
7,372,372,1,1,0,1,0
18,429,429,57,15,42,3,2
15,434,434,15,7,8,2,1
20,456,456,4,4,0,1,0

9,112,112,26,26,0,1,0
14,140,140,23,19,4,2,1
4,141,141,1,1,0,1,0
12,148,148,13,13,0,1,0
2,166,166,35,35,0,1,0
8,180,180,16,16,0,1,0
11,215,215,10,10,0,1,0
15,246,246,37,24,13,2,1
5,273,273,24,24,0,1,0
13,282,282,10,3,7,2,1
0,293,293,52,19,33,4,3
1,325,325,1,1,0,1,0
10,347,347,1,1,0,1,0
7,421,421,1,1,0,1,0
6,488,488,60,19,41,3,2
3,489,489,1,1,0,1,0

4,114,114,8,8,0,1,0
2,115,115,1,1,0,1,0
11,205,205,14,14,0,1,0
13,229,229,63,3,60,3,2
10,232,232,26,26,0,1,0
14,234,234,10,4,6,3,2
9,237,237,8,8,0,1,0
1,287,287,65,35,30,3,2
8,387,387,26,26,0,1,0
7,395,395,18,12,6,3,2
6,401,401,31,8,23,2,1
5,443,443,30,30,0,1,0
12,450,450,52,52,0,1,0
3,452,452,85,59,26,2,1
0,457,457,8,8,0,1,0

1,111,111,2,2,0,1,0
2,154,154,1,1,0,1,0
0,188,188,63,58,5,2,1
9,191,191,61,61,0,1,0
3,201,201,15,15,0,1,0
7,207,207,32,32,0,1,0
8,273,273,6,1,5,2,1
5,320,320,5,2,3,2,1
4,343,343,92,92,0,1,0
10,369,369,67,67,0,1,0
11,376,376,4,4,0,1,0
6,487,487,4,1,3,2,1

13,150,150,5,5,0,1,0
10,152,152,13,13,0,1,0
5,164,164,27,1,26,2,1
7,254,254,86,30,56,4,3
2,275,275,45,45,0,1,0
0,283,283,1,1,0,1,0
3,322,322,52,1,51,3,2
1,324,324,36,14,22,2,1
4,350,350,21,5,16,2,1
12,354,354,5,5,0,1,0
8,390,390,69,69,0,1,0
9,392,392,20,20,0,1,0
6,465,465,17,1,16,2,1
11,488,488,6,1,5,2,1

10,141,141,4,1,3,2,1
15,148,148,12,12,0,1,0
5,165,165,12,9,3,2,1
14,189,189,39,24,15,4,3
0,192,192,17,17,0,1,0
6,192,192,6,2,4,2,1
8,226,226,1,1,0,1,0
7,232,232,1,1,0,1,0
12,234,234,28,13,15,4,3
4,278,278,7,2,5,2,1
16,387,387,81,81,0,1,0
2,395,395,69,35,34,3,2
1,411,411,11,11,0,1,0
18,425,425,17,17,0,1,0
11,430,430,78,4,74,3,2
9,463,463,21,16,5,2,1
17,474,474,15,1,14,3,2
13,480,480,10,10,0,1,0
3,485,485,9,9,0,1,0

6,106,106,8,8,0,1,0
1,154,154,74,32,42,4,3
5,162,162,7,4,3,2,1
4,349,349,26,17,9,2,1
3,386,386,113,113,0,1,0
2,389,389,10,10,0,1,0
9,431,431,76,76,0,1,0
8,457,457,20,20,0,1,0
7,474,474,2,2,0,1,0
0,484,484,94,67,27,2,1

16,121,121,9,9,0,1,0
13,128,128,1,1,0,1,0
10,156,156,18,18,0,1,0
4,157,157,3,3,0,1,0
7,176,176,11,11,0,1,0
5,214,214,1,1,0,1,0
6,218,218,6,2,4,2,1
0,231,231,4,4,0,1,0
3,235,235,47,23,24,2,1
2,249,249,1,1,0,1,0
15,256,256,40,40,0,1,0
9,271,271,20,20,0,1,0
12,275,275,10,6,4,2,1
11,280,280,74,59,15,2,1
8,301,301,29,9,20,2,1
14,405,405,26,20,6,2,1
1,426,426,84,39,45,4,3

12,118,118,10,2,8,3,2
5,184,184,26,2,24,4,3
7,188,188,19,14,5,2,1
11,225,225,1,1,0,1,0
8,235,235,19,5,14,4,3
0,267,267,65,65,0,1,0
6,359,359,54,54,0,1,0
4,376,376,33,33,0,1,0
3,394,394,14,8,6,2,1
10,412,412,64,40,24,3,2
9,445,445,62,50,12,2,1
2,481,481,81,81,0,1,0
1,498,498,13,1,12,2,1

13,121,121,19,13,6,2,1
4,140,140,2,2,0,1,0
0,143,143,1,1,0,1,0
12,145,145,14,8,6,3,2
7,179,179,70,34,36,4,3
1,232,232,1,1,0,1,0
8,239,239,13,3,10,3,2
17,266,266,23,11,12,4,3
2,281,281,44,10,34,4,3
16,349,349,8,8,0,1,0
3,350,350,5,5,0,1,0
10,364,364,12,5,7,2,1
11,367,367,87,62,25,2,1
6,371,371,1,1,0,1,0
15,411,411,30,5,25,2,1
5,423,423,9,9,0,1,0
14,472,472,16,16,0,1,0
9,485,485,1,1,0,1,0

0,155,155,9,9,0,1,0
7,177,177,43,43,0,1,0
4,182,182,3,3,0,1,0
10,194,194,8,5,3,2,1
6,199,199,17,17,0,1,0
8,219,219,12,12,0,1,0
13,233,233,15,15,0,1,0
11,256,256,14,8,6,2,1
12,279,279,74,74,0,1,0
2,288,288,28,28,0,1,0
1,289,289,3,3,0,1,0
3,345,345,46,46,0,1,0
5,365,365,1,1,0,1,0
14,475,475,80,23,57,3,2
15,487,487,20,20,0,1,0
9,493,493,37,25,12,3,2

15,142,142,6,6,0,1,0
7,148,148,38,2,36,3,2
0,156,156,1,1,0,1,0
3,162,162,25,25,0,1,0
5,173,173,2,2,0,1,0
17,205,205,5,1,4,2,1
9,225,225,1,1,0,1,0
4,294,294,13,13,0,1,0
13,305,305,16,16,0,1,0
8,329,329,21,13,8,2,1
16,343,343,7,7,0,1,0
12,355,355,97,59,38,3,2
11,369,369,91,83,8,2,1
6,380,380,15,15,0,1,0
14,460,460,24,24,0,1,0
1,472,472,19,3,16,2,1
10,479,479,30,30,0,1,0
2,496,496,9,9,0,1,0

2,106,106,20,11,9,2,1
8,115,115,5,2,3,2,1
12,128,128,20,20,0,1,0
11,130,130,5,5,0,1,0
13,161,161,16,1,15,4,3
3,240,240,2,2,0,1,0
5,247,247,12,3,9,2,1
9,319,319,9,1,8,2,1
4,355,355,2,2,0,1,0
6,361,361,69,69,0,1,0
7,362,362,113,113,0,1,0
1,442,442,21,21,0,1,0
0,446,446,94,34,60,4,3
10,460,460,19,19,0,1,0

14,137,137,31,31,0,1,0
6,142,142,2,2,0,1,0
10,188,188,22,10,12,4,3
2,190,190,1,1,0,1,0
13,214,214,17,1,16,2,1
7,262,262,22,22,0,1,0
3,266,266,53,53,0,1,0
0,284,284,67,17,50,3,2
8,328,328,13,4,9,2,1
1,360,360,16,16,0,1,0
12,381,381,11,4,7,2,1
15,395,395,26,26,0,1,0
9,408,408,39,39,0,1,0
11,427,427,42,39,3,2,1
5,470,470,31,4,27,4,3
4,490,490,7,2,5,2,1

2,101,101,5,5,0,1,0
10,129,129,3,3,0,1,0
6,149,149,6,6,0,1,0
13,170,170,20,20,0,1,0
5,197,197,20,20,0,1,0
11,207,207,3,3,0,1,0
7,216,216,6,6,0,1,0
9,251,251,44,44,0,1,0
3,373,373,32,23,9,4,3
1,396,396,76,76,0,1,0
14,405,405,3,3,0,1,0
8,416,416,1,1,0,1,0
16,437,437,18,18,0,1,0
4,440,440,9,9,0,1,0
12,443,443,127,113,14,2,1
0,460,460,3,3,0,1,0
15,490,490,107,77,30,4,3

9,103,103,1,1,0,1,0
13,109,109,4,4,0,1,0
3,153,153,1,1,0,1,0
6,222,222,15,6,9,2,1
14,242,242,40,40,0,1,0
4,245,245,6,6,0,1,0
11,248,248,5,2,3,2,1
10,364,364,84,77,7,2,1
8,377,377,102,72,30,4,3
0,391,391,12,12,0,1,0
5,391,391,21,16,5,2,1
15,407,407,86,86,0,1,0
2,432,432,19,19,0,1,0
1,434,434,77,77,0,1,0
12,473,473,18,7,11,2,1
7,477,477,12,12,0,1,0

13,167,167,13,13,0,1,0
7,174,174,4,4,0,1,0
0,245,245,14,14,0,1,0
9,328,328,8,8,0,1,0
14,334,334,55,10,45,2,1
3,343,343,8,2,6,3,2
1,347,347,61,13,48,4,3
4,348,348,56,33,23,4,3
10,367,367,10,2,8,3,2
5,372,372,23,23,0,1,0
6,385,385,10,10,0,1,0
2,432,432,76,76,0,1,0
12,460,460,61,61,0,1,0
11,476,476,102,69,33,2,1
8,497,497,34,7,27,4,3

5,129,129,7,7,0,1,0
9,211,211,62,62,0,1,0
2,222,222,14,8,6,2,1
6,269,269,44,12,32,2,1
3,297,297,120,53,67,3,2
11,314,314,17,14,3,2,1
1,342,342,47,35,12,2,1
10,345,345,35,35,0,1,0
8,369,369,3,3,0,1,0
4,437,437,30,21,9,4,3
7,460,460,18,9,9,2,1
0,499,499,14,14,0,1,0

1,102,102,22,22,0,1,0
0,134,134,10,3,7,2,1
10,147,147,24,24,0,1,0
12,228,228,17,17,0,1,0
6,239,239,11,11,0,1,0
9,265,265,26,26,0,1,0
8,343,343,14,14,0,1,0
13,353,353,21,21,0,1,0
5,375,375,13,13,0,1,0
11,383,383,4,4,0,1,0
4,426,426,63,39,24,2,1
3,451,451,8,8,0,1,0
7,452,452,123,123,0,1,0
2,465,465,77,33,44,4,3

0,118,118,1,1,0,1,0
9,177,177,4,4,0,1,0
5,191,191,2,2,0,1,0
7,218,218,2,2,0,1,0
16,240,240,15,5,10,2,1
12,242,242,10,10,0,1,0
14,256,256,20,2,18,3,2
8,304,304,60,33,27,4,3
13,323,323,10,10,0,1,0
1,325,325,7,1,6,2,1
15,350,350,144,66,78,4,3
3,367,367,3,3,0,1,0
2,373,373,25,1,24,3,2
11,429,429,12,12,0,1,0
6,454,454,99,80,19,2,1
18,478,478,4,4,0,1,0
17,493,493,38,38,0,1,0
10,496,496,48,30,18,4,3
4,497,497,7,7,0,1,0

10,103,103,3,3,0,1,0
6,120,120,6,6,0,1,0
5,166,166,9,3,6,3,2
0,177,177,6,6,0,1,0
8,229,229,1,1,0,1,0
1,252,252,38,17,21,2,1
9,262,262,119,103,16,3,2
4,373,373,8,1,7,2,1
2,415,415,96,82,14,2,1
3,417,417,119,119,0,1,0
7,420,420,45,45,0,1,0

11,118,118,10,3,7,2,1
5,125,125,6,6,0,1,0
8,163,163,1,1,0,1,0
3,165,165,34,34,0,1,0
0,183,183,24,8,16,3,2
9,193,193,7,4,3,2,1
15,207,207,4,1,3,2,1
2,228,228,6,6,0,1,0
7,229,229,15,7,8,3,2
10,241,241,30,17,13,2,1
13,398,398,46,17,29,2,1
16,403,403,53,9,44,2,1
6,411,411,56,18,38,2,1
12,431,431,42,18,24,3,2
4,456,456,1,1,0,1,0
1,466,466,20,20,0,1,0
14,500,500,67,67,0,1,0

3,148,148,4,4,0,1,0
7,163,163,51,41,10,2,1
0,247,247,81,81,0,1,0
8,258,258,6,6,0,1,0
4,259,259,36,3,33,4,3
2,281,281,74,74,0,1,0
1,298,298,33,18,15,4,3
5,334,334,47,47,0,1,0
6,420,420,8,8,0,1,0
9,448,448,22,12,10,3,2

11,142,142,3,3,0,1,0
2,151,151,9,1,8,2,1
13,163,163,3,3,0,1,0
6,177,177,67,67,0,1,0
1,228,228,17,17,0,1,0
8,264,264,6,6,0,1,0
0,306,306,40,40,0,1,0
12,307,307,2,2,0,1,0
3,314,314,7,7,0,1,0
4,332,332,4,1,3,2,1
5,333,333,8,8,0,1,0
9,419,419,6,6,0,1,0
7,445,445,259,259,0,1,0
10,448,448,22,8,14,3,2

0,110,110,3,3,0,1,0
14,117,117,12,12,0,1,0
3,122,122,1,1,0,1,0
9,145,145,10,4,6,2,1
12,189,189,12,9,3,2,1
13,204,204,4,4,0,1,0
2,207,207,2,2,0,1,0
11,211,211,1,1,0,1,0
1,224,224,41,41,0,1,0
10,240,240,1,1,0,1,0
5,364,364,19,19,0,1,0
19,387,387,19,19,0,1,0
17,408,408,137,8,129,4,3
8,411,411,3,3,0,1,0
16,415,415,20,20,0,1,0
7,441,441,51,51,0,1,0
15,442,442,54,28,26,2,1
4,491,491,44,44,0,1,0
6,492,492,33,7,26,2,1
18,493,493,19,6,13,2,1

0,114,114,4,1,3,2,1
8,117,117,3,3,0,1,0
7,196,196,14,14,0,1,0
10,237,237,30,3,27,4,3
11,238,238,87,3,84,3,2
2,245,245,5,5,0,1,0
9,295,295,10,2,8,3,2
1,332,332,35,35,0,1,0
3,418,418,43,43,0,1,0
5,471,471,41,11,30,3,2
4,486,486,212,98,114,4,3
6,490,490,2,2,0,1,0

9,167,167,3,3,0,1,0
6,180,180,62,46,16,3,2
13,187,187,1,1,0,1,0
1,194,194,3,3,0,1,0
14,211,211,35,15,20,2,1
5,259,259,2,2,0,1,0
8,270,270,51,24,27,4,3
3,275,275,31,31,0,1,0
2,307,307,5,5,0,1,0
7,333,333,24,15,9,2,1
11,338,338,69,29,40,2,1
10,425,425,35,35,0,1,0
12,452,452,23,6,17,3,2
0,460,460,45,10,35,2,1
4,463,463,16,1,15,2,1

0,113,113,13,4,9,2,1
5,169,169,42,42,0,1,0
4,242,242,30,16,14,2,1
6,315,315,13,1,12,3,2
1,364,364,111,111,0,1,0
2,410,410,115,104,11,2,1
8,413,413,12,12,0,1,0
3,463,463,29,29,0,1,0
7,488,488,8,2,6,2,1
9,499,499,94,52,42,4,3

7,102,102,7,7,0,1,0
1,121,121,5,5,0,1,0
10,242,242,47,12,35,2,1
3,265,265,1,1,0,1,0
11,280,280,2,2,0,1,0
4,327,327,86,68,18,3,2
6,371,371,38,23,15,3,2
8,397,397,26,10,16,3,2
0,410,410,69,60,9,2,1
5,446,446,36,6,30,4,3
9,463,463,62,56,6,3,2
12,478,478,68,17,51,4,3
2,489,489,70,70,0,1,0

5,150,150,30,23,7,2,1
12,229,229,34,4,30,4,3
7,266,266,1,1,0,1,0
11,268,268,5,5,0,1,0
1,272,272,10,10,0,1,0
10,283,283,12,12,0,1,0
9,343,343,81,18,63,3,2
3,402,402,64,2,62,3,2
6,412,412,2,2,0,1,0
0,414,414,38,28,10,3,2
4,445,445,91,42,49,4,3
8,476,476,28,28,0,1,0
13,486,486,99,99,0,1,0
2,498,498,2,2,0,1,0

9,148,148,18,18,0,1,0
1,244,244,61,31,30,3,2
5,244,244,1,1,0,1,0
3,282,282,42,42,0,1,0
8,287,287,13,13,0,1,0
6,346,346,41,29,12,4,3
7,415,415,54,54,0,1,0
0,464,464,27,7,20,2,1
2,471,471,185,151,34,3,2
4,479,479,69,69,0,1,0

10,100,100,6,6,0,1,0
1,108,108,11,11,0,1,0
11,134,134,11,11,0,1,0
9,246,246,44,24,20,3,2
6,260,260,3,3,0,1,0
12,275,275,12,12,0,1,0
0,292,292,6,6,0,1,0
7,317,317,44,44,0,1,0
4,406,406,64,19,45,4,3
8,449,449,91,91,0,1,0
5,474,474,22,4,18,4,3
2,478,478,71,35,36,2,1
3,480,480,109,77,32,2,1

10,160,160,2,2,0,1,0
8,163,163,7,7,0,1,0
1,164,164,29,26,3,2,1
7,178,178,19,9,10,2,1
5,283,283,43,23,20,3,2
6,339,339,16,8,8,2,1
4,383,383,54,42,12,2,1
3,427,427,104,5,99,4,3
0,429,429,110,110,0,1,0
2,435,435,11,2,9,4,3
9,477,477,101,101,0,1,0

13,139,139,8,8,0,1,0
0,201,201,1,1,0,1,0
5,217,217,13,13,0,1,0
1,218,218,10,3,7,2,1
10,276,276,6,6,0,1,0
2,279,279,22,10,12,4,3
4,293,293,69,69,0,1,0
9,306,306,79,25,54,4,3
12,307,307,73,52,21,2,1
7,320,320,70,45,25,2,1
6,335,335,3,3,0,1,0
3,429,429,21,21,0,1,0
14,433,433,19,19,0,1,0
8,439,439,26,26,0,1,0
11,482,482,15,15,0,1,0

8,148,148,11,4,7,2,1
2,276,276,20,2,18,3,2
3,288,288,30,30,0,1,0
6,290,290,65,26,39,2,1
0,343,343,154,94,60,4,3
5,370,370,39,39,0,1,0
1,397,397,100,58,42,4,3
4,433,433,9,9,0,1,0
7,476,476,52,16,36,3,2

10,103,103,4,1,3,2,1
13,139,139,27,27,0,1,0
9,149,149,8,2,6,3,2
19,178,178,20,8,12,3,2
1,183,183,3,3,0,1,0
12,206,206,6,1,5,2,1
14,214,214,27,27,0,1,0
4,235,235,1,1,0,1,0
2,236,236,4,4,0,1,0
3,249,249,31,1,30,2,1
18,264,264,17,17,0,1,0
6,303,303,1,1,0,1,0
11,310,310,31,5,26,3,2
15,311,311,40,24,16,2,1
8,333,333,2,2,0,1,0
17,352,352,7,7,0,1,0
16,398,398,26,26,0,1,0
5,400,400,60,60,0,1,0
0,425,425,4,4,0,1,0
7,443,443,67,33,34,3,2

5,103,103,1,1,0,1,0
4,181,181,6,6,0,1,0
11,200,200,9,9,0,1,0
12,216,216,1,1,0,1,0
0,225,225,56,44,12,3,2
1,295,295,24,6,18,2,1
13,322,322,119,119,0,1,0
8,347,347,62,14,48,4,3
3,394,394,8,8,0,1,0
2,400,400,19,3,16,3,2
6,401,401,104,4,100,3,2
7,415,415,11,11,0,1,0
9,422,422,33,33,0,1,0
10,490,490,6,6,0,1,0

8,127,127,8,8,0,1,0
11,154,154,1,1,0,1,0
3,214,214,11,11,0,1,0
2,268,268,6,6,0,1,0
9,273,273,1,1,0,1,0
5,281,281,7,1,6,2,1
12,313,313,15,15,0,1,0
1,350,350,27,5,22,3,2
15,365,365,50,10,40,3,2
0,375,375,23,23,0,1,0
17,416,416,42,42,0,1,0
7,419,419,33,15,18,3,2
4,421,421,90,54,36,4,3
13,428,428,69,69,0,1,0
19,432,432,21,11,10,2,1
6,437,437,1,1,0,1,0
18,448,448,23,15,8,3,2
10,455,455,22,22,0,1,0
16,478,478,59,59,0,1,0
14,495,495,43,31,12,4,3

1,115,115,43,43,0,1,0
5,125,125,14,14,0,1,0
10,163,163,3,3,0,1,0
9,184,184,10,7,3,2,1
6,192,192,16,16,0,1,0
4,243,243,3,3,0,1,0
11,266,266,31,31,0,1,0
8,283,283,89,89,0,1,0
7,304,304,25,25,0,1,0
0,379,379,6,2,4,2,1
12,397,397,19,1,18,4,3
3,437,437,82,82,0,1,0
2,440,440,1,1,0,1,0

9,102,102,22,22,0,1,0
0,177,177,29,29,0,1,0
1,188,188,11,5,6,3,2
4,205,205,58,45,13,2,1
6,210,210,9,9,0,1,0
10,212,212,5,5,0,1,0
11,213,213,28,15,13,2,1
2,224,224,2,2,0,1,0
5,281,281,33,7,26,2,1
3,335,335,23,23,0,1,0
8,448,448,70,7,63,4,3
7,458,458,30,30,0,1,0
12,492,492,42,12,30,4,3

3,157,157,2,2,0,1,0
2,158,158,18,4,14,3,2
0,162,162,9,9,0,1,0
18,163,163,15,15,0,1,0
8,166,166,12,12,0,1,0
5,192,192,5,5,0,1,0
1,212,212,2,2,0,1,0
6,219,219,2,2,0,1,0
4,243,243,4,4,0,1,0
11,275,275,6,6,0,1,0
14,278,278,38,15,23,2,1
16,296,296,37,37,0,1,0
9,313,313,54,3,51,4,3
13,346,346,44,37,7,2,1
10,398,398,60,60,0,1,0
12,399,399,81,33,48,2,1
17,402,402,2,2,0,1,0
7,410,410,17,17,0,1,0
15,499,499,13,13,0,1,0

14,100,100,8,8,0,1,0
8,104,104,3,3,0,1,0
0,117,117,3,3,0,1,0
3,139,139,13,13,0,1,0
1,165,165,26,7,19,2,1
17,166,166,21,21,0,1,0
13,174,174,9,9,0,1,0
7,176,176,8,8,0,1,0
4,204,204,6,1,5,2,1
9,217,217,27,3,24,2,1
5,229,229,6,6,0,1,0
6,245,245,3,3,0,1,0
10,273,273,17,17,0,1,0
11,299,299,16,16,0,1,0
15,325,325,13,13,0,1,0
16,332,332,6,6,0,1,0
12,383,383,112,98,14,2,1
2,404,404,17,17,0,1,0
18,454,454,49,10,39,4,3

6,106,106,9,6,3,2,1
10,127,127,3,3,0,1,0
2,142,142,15,1,14,2,1
9,144,144,11,1,10,3,2
7,149,149,9,3,6,3,2
5,169,169,33,33,0,1,0
1,257,257,31,31,0,1,0
0,322,322,47,5,42,3,2
4,378,378,8,4,4,2,1
3,387,387,127,31,96,3,2
8,458,458,121,7,114,4,3

14,147,147,7,7,0,1,0
18,158,158,14,14,0,1,0
8,168,168,9,9,0,1,0
21,199,199,19,3,16,3,2
3,244,244,16,1,15,2,1
17,256,256,1,1,0,1,0
19,261,261,18,18,0,1,0
15,290,290,8,2,6,2,1
6,312,312,27,27,0,1,0
16,314,314,1,1,0,1,0
20,318,318,55,37,18,3,2
23,330,330,36,36,0,1,0
0,331,331,11,11,0,1,0
4,331,331,3,3,0,1,0
5,332,332,1,1,0,1,0
7,375,375,56,56,0,1,0
2,376,376,15,15,0,1,0
13,389,389,5,5,0,1,0
10,409,409,35,35,0,1,0
22,415,415,75,42,33,2,1
9,418,418,17,17,0,1,0
1,424,424,1,1,0,1,0
11,468,468,15,15,0,1,0
12,494,494,4,4,0,1,0

10,131,131,11,11,0,1,0
11,144,144,27,27,0,1,0
3,155,155,10,2,8,2,1
13,216,216,1,1,0,1,0
6,217,217,10,10,0,1,0
1,225,225,25,25,0,1,0
15,273,273,68,5,63,4,3
14,303,303,12,7,5,2,1
7,315,315,31,21,10,2,1
12,321,321,8,8,0,1,0
2,341,341,24,15,9,2,1
4,344,344,39,39,0,1,0
5,363,363,13,5,8,2,1
0,371,371,51,13,38,3,2
9,474,474,61,1,60,4,3
8,489,489,12,12,0,1,0

3,154,154,28,28,0,1,0
11,169,169,14,14,0,1,0
7,188,188,12,4,8,3,2
10,247,247,2,2,0,1,0
6,303,303,42,42,0,1,0
0,335,335,73,73,0,1,0
2,380,380,69,2,67,3,2
4,380,380,39,7,32,3,2
1,414,414,7,7,0,1,0
8,415,415,57,57,0,1,0
9,432,432,6,3,3,2,1
5,495,495,132,75,57,3,2

1,204,204,26,26,0,1,0
5,205,205,1,1,0,1,0
0,209,209,4,4,0,1,0
11,283,283,6,6,0,1,0
7,318,318,2,2,0,1,0
4,326,326,14,14,0,1,0
6,335,335,57,57,0,1,0
3,341,341,57,39,18,4,3
13,352,352,32,5,27,4,3
12,420,420,7,7,0,1,0
9,436,436,79,79,0,1,0
8,437,437,32,32,0,1,0
10,453,453,121,121,0,1,0
14,458,458,28,28,0,1,0
2,478,478,78,62,16,2,1

4,165,165,5,5,0,1,0
7,218,218,32,15,17,2,1
9,285,285,60,60,0,1,0
6,291,291,4,4,0,1,0
3,294,294,17,7,10,2,1
0,305,305,38,15,23,3,2
2,317,317,46,1,45,4,3
8,324,324,8,1,7,3,2
11,397,397,37,22,15,2,1
1,407,407,141,89,52,3,2
10,411,411,36,31,5,2,1
5,451,451,60,60,0,1,0

13,121,121,5,5,0,1,0
7,139,139,20,20,0,1,0
2,141,141,1,1,0,1,0
10,148,148,39,39,0,1,0
6,210,210,1,1,0,1,0
11,225,225,5,5,0,1,0
14,227,227,37,37,0,1,0
8,256,256,65,65,0,1,0
16,268,268,7,7,0,1,0
12,294,294,21,11,10,2,1
9,314,314,10,10,0,1,0
5,362,362,34,20,14,3,2
15,379,379,50,18,32,2,1
4,397,397,13,13,0,1,0
1,470,470,43,3,40,2,1
3,493,493,10,10,0,1,0
0,496,496,11,1,10,3,2

10,101,101,9,9,0,1,0
2,103,103,12,12,0,1,0
14,120,120,17,6,11,2,1
13,150,150,7,7,0,1,0
1,206,206,18,18,0,1,0
5,218,218,15,15,0,1,0
6,220,220,3,3,0,1,0
9,220,220,31,3,28,2,1
15,244,244,69,27,42,4,3
12,270,270,9,5,4,2,1
0,272,272,2,2,0,1,0
17,275,275,25,1,24,2,1
16,276,276,23,23,0,1,0
11,365,365,21,15,6,2,1
4,368,368,4,4,0,1,0
18,390,390,14,14,0,1,0
8,454,454,36,36,0,1,0
7,476,476,11,11,0,1,0
3,496,496,3,3,0,1,0

9,108,108,30,30,0,1,0
15,111,111,20,20,0,1,0
14,120,120,13,13,0,1,0
6,274,274,32,24,8,2,1
3,296,296,39,17,22,3,2
10,308,308,23,1,22,2,1
11,327,327,4,4,0,1,0
12,345,345,16,16,0,1,0
1,351,351,12,8,4,2,1
7,355,355,76,76,0,1,0
4,393,393,27,9,18,2,1
2,404,404,2,2,0,1,0
13,405,405,10,10,0,1,0
5,418,418,42,42,0,1,0
8,452,452,12,12,0,1,0
0,494,494,2,2,0,1,0

8,114,114,1,1,0,1,0
9,118,118,10,10,0,1,0
7,166,166,2,2,0,1,0
16,224,224,18,18,0,1,0
18,245,245,35,35,0,1,0
0,265,265,4,4,0,1,0
6,286,286,54,54,0,1,0
17,299,299,24,24,0,1,0
10,315,315,4,4,0,1,0
15,323,323,44,44,0,1,0
13,329,329,37,1,36,4,3
12,382,382,25,25,0,1,0
4,387,387,8,2,6,2,1
11,421,421,48,48,0,1,0
14,424,424,42,7,35,4,3
5,427,427,1,1,0,1,0
2,434,434,8,2,6,3,2
3,443,443,43,43,0,1,0
1,455,455,58,40,18,4,3

12,106,106,3,3,0,1,0
1,135,135,12,12,0,1,0
5,155,155,27,5,22,3,2
9,155,155,6,1,5,2,1
8,172,172,67,31,36,3,2
6,209,209,4,4,0,1,0
7,227,227,9,4,5,2,1
10,346,346,60,46,14,3,2
0,362,362,142,42,100,3,2
11,403,403,11,11,0,1,0
3,407,407,10,10,0,1,0
4,421,421,9,9,0,1,0
2,496,496,1,1,0,1,0

10,101,101,15,3,12,3,2
8,200,200,17,17,0,1,0
12,259,259,5,5,0,1,0
4,265,265,19,12,7,2,1
5,270,270,49,10,39,4,3
9,272,272,15,15,0,1,0
1,279,279,24,24,0,1,0
2,302,302,7,7,0,1,0
11,307,307,12,6,6,2,1
3,370,370,69,69,0,1,0
6,402,402,18,6,12,2,1
0,427,427,65,47,18,2,1
7,467,467,148,148,0,1,0

3,103,103,5,1,4,2,1
2,138,138,10,10,0,1,0
0,141,141,16,16,0,1,0
12,188,188,26,7,19,2,1
10,191,191,16,4,12,4,3
4,199,199,16,7,9,2,1
8,238,238,34,34,0,1,0
6,246,246,23,3,20,3,2
7,246,246,18,18,0,1,0
5,254,254,40,30,10,3,2
1,320,320,43,43,0,1,0
11,404,404,34,34,0,1,0
13,471,471,12,12,0,1,0
9,473,473,79,75,4,2,1

9,165,165,17,17,0,1,0
6,192,192,1,1,0,1,0
11,231,231,11,11,0,1,0
0,247,247,24,6,18,4,3
7,274,274,31,31,0,1,0
2,282,282,15,7,8,3,2
3,370,370,17,17,0,1,0
4,409,409,76,34,42,4,3
1,440,440,140,140,0,1,0
10,469,469,102,77,25,2,1
5,474,474,100,10,90,3,2
8,482,482,8,8,0,1,0

4,110,110,2,2,0,1,0
15,126,126,3,3,0,1,0
1,133,133,3,3,0,1,0
11,152,152,20,15,5,2,1
10,195,195,19,19,0,1,0
6,264,264,7,7,0,1,0
8,271,271,2,2,0,1,0
0,302,302,59,59,0,1,0
14,313,313,13,6,7,2,1
9,383,383,8,2,6,3,2
13,386,386,73,73,0,1,0
17,390,390,4,4,0,1,0
16,392,392,67,13,54,3,2
12,408,408,60,23,37,4,3
3,434,434,12,3,9,2,1
5,450,450,66,52,14,3,2
2,470,470,3,3,0,1,0
7,485,485,66,36,30,4,3

11,110,110,22,10,12,3,2
3,150,150,9,5,4,2,1
10,181,181,30,30,0,1,0
8,266,266,12,12,0,1,0
9,287,287,23,16,7,2,1
1,319,319,124,124,0,1,0
2,334,334,1,1,0,1,0
4,399,399,8,8,0,1,0
7,417,417,47,10,37,2,1
6,460,460,30,30,0,1,0
0,468,468,107,107,0,1,0
5,470,470,22,22,0,1,0

3,106,106,3,3,0,1,0
1,164,164,5,5,0,1,0
4,199,199,20,20,0,1,0
10,200,200,42,18,24,3,2
7,206,206,32,32,0,1,0
6,208,208,2,2,0,1,0
11,229,229,25,25,0,1,0
14,274,274,43,31,12,4,3
16,284,284,39,39,0,1,0
5,291,291,10,10,0,1,0
12,345,345,1,1,0,1,0
0,353,353,2,2,0,1,0
2,465,465,76,6,70,3,2
13,474,474,31,21,10,3,2
15,485,485,17,17,0,1,0
8,492,492,69,31,38,3,2
9,497,497,16,8,8,2,1

11,136,136,16,16,0,1,0
15,150,150,4,4,0,1,0
8,178,178,27,9,18,3,2
6,194,194,6,6,0,1,0
12,207,207,6,6,0,1,0
14,208,208,26,2,24,3,2
4,237,237,46,10,36,3,2
1,254,254,21,21,0,1,0
0,256,256,2,2,0,1,0
10,303,303,99,99,0,1,0
5,361,361,33,19,14,3,2
3,372,372,7,7,0,1,0
2,414,414,32,2,30,4,3
13,435,435,28,28,0,1,0
9,450,450,13,13,0,1,0
7,455,455,23,23,0,1,0

11,187,187,11,11,0,1,0
15,199,199,21,21,0,1,0
8,257,257,5,2,3,2,1
5,275,275,34,34,0,1,0
2,286,286,4,4,0,1,0
1,291,291,4,1,3,2,1
12,323,323,18,18,0,1,0
14,367,367,11,6,5,2,1
6,406,406,22,13,9,4,3
10,414,414,57,19,38,3,2
9,427,427,11,1,10,2,1
16,443,443,34,8,26,3,2
3,463,463,78,78,0,1,0
7,464,464,60,50,10,4,3
0,476,476,48,16,32,3,2
4,492,492,26,10,16,4,3
13,495,495,122,74,48,4,3

3,120,120,10,5,5,2,1
6,126,126,13,5,8,2,1
17,146,146,1,1,0,1,0
16,158,158,14,8,6,2,1
7,174,174,2,2,0,1,0
13,191,191,5,5,0,1,0
2,204,204,27,27,0,1,0
0,224,224,16,16,0,1,0
9,226,226,1,1,0,1,0
8,263,263,1,1,0,1,0
11,310,310,10,6,4,2,1
12,321,321,50,50,0,1,0
4,331,331,46,30,16,2,1
10,373,373,34,34,0,1,0
5,389,389,2,2,0,1,0
15,402,402,55,14,41,2,1
14,466,466,124,84,40,4,3
1,473,473,27,4,23,2,1

4,113,113,1,1,0,1,0
10,197,197,39,17,22,2,1
7,203,203,26,26,0,1,0
0,215,215,2,2,0,1,0
9,215,215,15,4,11,3,2
15,216,216,38,38,0,1,0
14,233,233,25,25,0,1,0
13,235,235,12,12,0,1,0
6,292,292,1,1,0,1,0
16,317,317,23,23,0,1,0
1,344,344,2,2,0,1,0
11,368,368,3,3,0,1,0
12,376,376,39,3,36,3,2
2,381,381,67,67,0,1,0
3,427,427,103,67,36,2,1
5,481,481,7,7,0,1,0
8,487,487,22,6,16,2,1

14,130,130,23,3,20,2,1
10,144,144,24,12,12,2,1
15,144,144,13,13,0,1,0
9,152,152,2,2,0,1,0
5,176,176,16,16,0,1,0
11,211,211,1,1,0,1,0
12,245,245,32,12,20,3,2
7,263,263,1,1,0,1,0
3,288,288,9,9,0,1,0
6,307,307,4,1,3,2,1
16,318,318,1,1,0,1,0
0,329,329,14,6,8,2,1
13,345,345,36,27,9,2,1
2,352,352,27,18,9,2,1
1,367,367,11,11,0,1,0
8,370,370,27,5,22,4,3
4,379,379,10,4,6,3,2
18,415,415,3,3,0,1,0
19,430,430,87,69,18,2,1
17,464,464,58,58,0,1,0

3,114,114,15,15,0,1,0
10,184,184,15,1,14,2,1
11,269,269,6,6,0,1,0
0,279,279,30,10,20,3,2
12,289,289,75,75,0,1,0
5,294,294,3,3,0,1,0
8,338,338,30,30,0,1,0
13,352,352,3,3,0,1,0
7,353,353,22,22,0,1,0
2,379,379,26,26,0,1,0
9,443,443,65,50,15,4,3
4,446,446,32,32,0,1,0
1,464,464,81,11,70,3,2
14,477,477,51,51,0,1,0
6,499,499,38,4,34,3,2

8,102,102,17,11,6,3,2
9,180,180,12,12,0,1,0
1,226,226,21,21,0,1,0
5,238,238,5,2,3,2,1
0,301,301,21,21,0,1,0
2,316,316,39,39,0,1,0
4,371,371,81,81,0,1,0
7,396,396,43,1,42,4,3
11,411,411,94,14,80,3,2
10,415,415,39,39,0,1,0
6,420,420,8,8,0,1,0
3,433,433,85,85,0,1,0

10,125,125,1,1,0,1,0
14,207,207,8,8,0,1,0
0,209,209,5,1,4,2,1
5,231,231,7,7,0,1,0
1,234,234,1,1,0,1,0
12,258,258,13,13,0,1,0
6,270,270,51,6,45,2,1
8,270,270,6,2,4,2,1
13,320,320,58,58,0,1,0
9,324,324,70,70,0,1,0
3,352,352,38,38,0,1,0
15,361,361,15,12,3,2,1
2,364,364,8,8,0,1,0
16,374,374,73,53,20,3,2
7,410,410,1,1,0,1,0
4,412,412,35,35,0,1,0
11,449,449,92,92,0,1,0

1,128,128,25,19,6,3,2
0,136,136,18,5,13,2,1
3,187,187,30,9,21,2,1
9,196,196,48,1,47,4,3
10,215,215,1,1,0,1,0
2,218,218,18,18,0,1,0
8,251,251,46,16,30,4,3
4,277,277,22,7,15,2,1
5,313,313,16,16,0,1,0
11,363,363,28,28,0,1,0
6,374,374,4,4,0,1,0
12,422,422,50,24,26,3,2
7,435,435,31,4,27,2,1

11,149,149,3,3,0,1,0
4,218,218,8,8,0,1,0
9,231,231,7,7,0,1,0
12,246,246,9,9,0,1,0
3,272,272,43,3,40,2,1
1,326,326,48,48,0,1,0
10,352,352,8,8,0,1,0
5,395,395,33,33,0,1,0
8,397,397,79,79,0,1,0
0,438,438,16,16,0,1,0
6,454,454,14,3,11,4,3
13,470,470,164,96,68,3,2
7,476,476,25,19,6,2,1
2,494,494,103,4,99,4,3

10,120,120,1,1,0,1,0
7,132,132,27,5,22,2,1
11,142,142,10,10,0,1,0
18,156,156,18,18,0,1,0
6,187,187,13,4,9,4,3
5,218,218,34,1,33,3,2
12,226,226,2,2,0,1,0
9,231,231,4,4,0,1,0
20,239,239,37,37,0,1,0
3,278,278,8,2,6,3,2
1,296,296,9,9,0,1,0
8,315,315,1,1,0,1,0
15,341,341,47,11,36,4,3
14,355,355,16,16,0,1,0
2,368,368,10,10,0,1,0
4,408,408,11,11,0,1,0
16,430,430,20,15,5,2,1
19,445,445,1,1,0,1,0
13,455,455,17,17,0,1,0
0,462,462,6,6,0,1,0
17,481,481,100,41,59,4,3

12,139,139,6,6,0,1,0
2,144,144,30,30,0,1,0
9,155,155,52,1,51,3,2
3,173,173,23,15,8,3,2
6,228,228,9,9,0,1,0
11,235,235,7,2,5,2,1
0,236,236,16,16,0,1,0
8,269,269,31,6,25,4,3
4,283,283,7,7,0,1,0
7,325,325,35,20,15,2,1
5,336,336,44,25,19,2,1
1,349,349,34,12,22,2,1
13,395,395,8,8,0,1,0
10,416,416,27,19,8,3,2

18,134,134,9,9,0,1,0
11,163,163,13,13,0,1,0
2,192,192,23,2,21,4,3
17,208,208,9,9,0,1,0
4,222,222,22,7,15,4,3
9,256,256,29,23,6,3,2
16,260,260,66,24,42,4,3
14,268,268,19,19,0,1,0
12,273,273,36,36,0,1,0
3,274,274,18,9,9,2,1
5,290,290,8,8,0,1,0
10,299,299,1,1,0,1,0
13,328,328,9,1,8,3,2
6,346,346,5,5,0,1,0
8,376,376,9,9,0,1,0
7,409,409,3,3,0,1,0
0,433,433,9,9,0,1,0
1,449,449,57,22,35,2,1
15,492,492,59,17,42,4,3

2,126,126,7,7,0,1,0
12,136,136,7,7,0,1,0
7,140,140,10,10,0,1,0
8,182,182,1,1,0,1,0
1,215,215,3,3,0,1,0
10,228,228,13,13,0,1,0
11,246,246,88,69,19,2,1
3,286,286,88,27,61,4,3
0,330,330,5,5,0,1,0
14,375,375,11,11,0,1,0
6,423,423,29,29,0,1,0
9,445,445,80,37,43,4,3
15,452,452,5,5,0,1,0
13,478,478,15,4,11,3,2
4,482,482,53,53,0,1,0
5,499,499,28,7,21,4,3

2,110,110,1,1,0,1,0
7,142,142,21,10,11,2,1
1,226,226,22,22,0,1,0
11,252,252,14,6,8,2,1
0,258,258,37,37,0,1,0
6,294,294,6,2,4,2,1
9,308,308,15,3,12,3,2
12,324,324,19,19,0,1,0
13,351,351,16,16,0,1,0
8,382,382,10,10,0,1,0
3,392,392,55,55,0,1,0
14,443,443,108,46,62,3,2
4,451,451,52,37,15,2,1
5,483,483,16,10,6,3,2
10,489,489,112,91,21,4,3

8,225,225,16,2,14,3,2
5,244,244,60,60,0,1,0
0,277,277,10,10,0,1,0
4,282,282,77,28,49,2,1
11,305,305,48,48,0,1,0
7,329,329,41,41,0,1,0
1,337,337,5,5,0,1,0
9,360,360,39,39,0,1,0
6,382,382,17,8,9,4,3
10,410,410,19,19,0,1,0
3,418,418,5,5,0,1,0
12,421,421,66,32,34,2,1
2,459,459,56,31,25,2,1

19,129,129,8,8,0,1,0
2,149,149,8,8,0,1,0
6,150,150,29,29,0,1,0
0,157,157,5,1,4,2,1
4,181,181,23,9,14,3,2
14,198,198,25,9,16,2,1
7,199,199,10,10,0,1,0
11,236,236,1,1,0,1,0
13,273,273,32,8,24,2,1
5,298,298,5,1,4,2,1
17,306,306,3,3,0,1,0
9,324,324,21,21,0,1,0
3,335,335,10,10,0,1,0
18,363,363,110,12,98,4,3
1,383,383,12,8,4,2,1
10,442,442,1,1,0,1,0
8,446,446,1,1,0,1,0
15,455,455,26,26,0,1,0
16,488,488,16,13,3,2,1
12,498,498,46,46,0,1,0

13,110,110,16,16,0,1,0
10,129,129,13,13,0,1,0
12,170,170,8,8,0,1,0
2,171,171,28,15,13,2,1
7,232,232,1,1,0,1,0
14,249,249,11,11,0,1,0
1,263,263,31,3,28,2,1
6,270,270,22,22,0,1,0
8,316,316,21,12,9,2,1
11,317,317,47,39,8,3,2
0,330,330,38,38,0,1,0
9,345,345,11,2,9,4,3
4,352,352,45,33,12,4,3
5,393,393,2,2,0,1,0
3,486,486,9,9,0,1,0
15,499,499,102,102,0,1,0

0,105,105,11,5,6,2,1
15,123,123,4,4,0,1,0
7,193,193,8,8,0,1,0
8,193,193,38,20,18,4,3
6,205,205,6,6,0,1,0
3,210,210,12,6,6,3,2
11,247,247,1,1,0,1,0
4,279,279,18,18,0,1,0
14,311,311,10,10,0,1,0
10,333,333,87,87,0,1,0
5,350,350,41,41,0,1,0
12,362,362,83,75,8,3,2
9,373,373,4,4,0,1,0
2,452,452,22,22,0,1,0
1,460,460,19,19,0,1,0
13,487,487,69,69,0,1,0

18,139,139,13,3,10,3,2
17,170,170,25,25,0,1,0
7,174,174,1,1,0,1,0
8,177,177,5,1,4,2,1
4,187,187,16,12,4,2,1
10,200,200,7,7,0,1,0
12,230,230,9,1,8,3,2
0,249,249,14,2,12,4,3
11,265,265,1,1,0,1,0
14,280,280,10,6,4,2,1
3,291,291,9,9,0,1,0
6,292,292,7,2,5,2,1
5,297,297,13,13,0,1,0
15,302,302,10,10,0,1,0
16,304,304,77,53,24,4,3
20,326,326,18,1,17,3,2
19,351,351,33,33,0,1,0
9,406,406,11,11,0,1,0
2,453,453,46,13,33,2,1
1,471,471,90,90,0,1,0
13,474,474,14,14,0,1,0

11,165,165,11,11,0,1,0
6,183,183,10,10,0,1,0
10,186,186,8,8,0,1,0
4,232,232,2,2,0,1,0
9,275,275,78,78,0,1,0
5,324,324,2,2,0,1,0
1,330,330,3,3,0,1,0
7,360,360,2,2,0,1,0
0,374,374,79,16,63,4,3
8,392,392,100,43,57,4,3
3,415,415,94,94,0,1,0
2,486,486,120,120,0,1,0

5,121,121,7,7,0,1,0
7,181,181,11,11,0,1,0
10,188,188,29,29,0,1,0
1,202,202,4,4,0,1,0
12,242,242,61,13,48,3,2
8,255,255,33,33,0,1,0
11,259,259,60,2,58,3,2
2,261,261,27,15,12,3,2
3,286,286,11,8,3,2,1
15,304,304,9,9,0,1,0
6,314,314,25,11,14,4,3
13,391,391,4,4,0,1,0
4,397,397,1,1,0,1,0
14,449,449,14,2,12,2,1
0,469,469,98,27,71,4,3
9,480,480,3,3,0,1,0

7,143,143,31,31,0,1,0
5,238,238,16,16,0,1,0
9,245,245,3,3,0,1,0
2,271,271,11,3,8,3,2
0,281,281,158,72,86,3,2
1,315,315,12,6,6,2,1
3,334,334,20,20,0,1,0
6,371,371,96,6,90,3,2
8,409,409,36,36,0,1,0
4,441,441,21,21,0,1,0
10,495,495,9,6,3,2,1

4,134,134,15,15,0,1,0
7,192,192,34,34,0,1,0
9,243,243,14,14,0,1,0
11,265,265,7,2,5,2,1
5,282,282,34,34,0,1,0
0,333,333,32,13,19,2,1
1,378,378,72,72,0,1,0
8,392,392,15,10,5,2,1
12,394,394,74,41,33,4,3
6,431,431,89,15,74,3,2
2,460,460,61,25,36,4,3
3,477,477,24,18,6,3,2
10,488,488,10,10,0,1,0

3,109,109,2,2,0,1,0
7,153,153,32,32,0,1,0
4,183,183,5,5,0,1,0
10,200,200,20,20,0,1,0
17,209,209,1,1,0,1,0
11,213,213,3,3,0,1,0
14,225,225,30,30,0,1,0
0,242,242,19,19,0,1,0
8,249,249,1,1,0,1,0
9,265,265,1,1,0,1,0
16,288,288,27,5,22,4,3
13,322,322,100,54,46,2,1
1,334,334,6,6,0,1,0
2,400,400,36,36,0,1,0
6,420,420,44,44,0,1,0
5,443,443,21,21,0,1,0
12,459,459,62,62,0,1,0
15,462,462,8,8,0,1,0

1,141,141,5,5,0,1,0
0,151,151,3,3,0,1,0
6,195,195,9,3,6,2,1
13,240,240,28,9,19,3,2
7,271,271,87,15,72,4,3
4,274,274,46,46,0,1,0
5,299,299,13,13,0,1,0
9,315,315,35,1,34,2,1
8,335,335,32,29,3,2,1
3,371,371,14,5,9,2,1
10,431,431,9,1,8,3,2
11,457,457,12,12,0,1,0
12,460,460,10,7,3,2,1
2,483,483,170,143,27,4,3

18,131,131,12,4,8,2,1
10,172,172,6,6,0,1,0
11,204,204,16,16,0,1,0
16,206,206,4,4,0,1,0
3,266,266,23,23,0,1,0
15,285,285,70,4,66,3,2
9,294,294,47,47,0,1,0
8,315,315,34,34,0,1,0
6,337,337,25,25,0,1,0
0,348,348,1,1,0,1,0
1,348,348,3,3,0,1,0
2,379,379,11,11,0,1,0
5,382,382,21,4,17,2,1
14,385,385,20,20,0,1,0
12,394,394,86,86,0,1,0
17,408,408,26,26,0,1,0
7,411,411,11,7,4,2,1
4,426,426,16,16,0,1,0
13,433,433,10,4,6,2,1

5,102,102,8,8,0,1,0
0,136,136,20,20,0,1,0
4,150,150,11,1,10,3,2
2,212,212,34,34,0,1,0
7,224,224,34,4,30,3,2
6,236,236,2,2,0,1,0
3,264,264,48,6,42,3,2
9,308,308,28,16,12,2,1
8,322,322,6,2,4,2,1
10,406,406,64,44,20,3,2
11,430,430,89,39,50,4,3
1,488,488,68,53,15,2,1

12,124,124,13,5,8,2,1
14,142,142,34,34,0,1,0
7,175,175,22,13,9,2,1
13,181,181,2,2,0,1,0
2,205,205,1,1,0,1,0
10,213,213,11,11,0,1,0
16,240,240,69,20,49,2,1
3,263,263,10,7,3,2,1
6,331,331,31,25,6,3,2
15,336,336,7,1,6,3,2
4,342,342,31,31,0,1,0
5,371,371,1,1,0,1,0
11,375,375,2,2,0,1,0
0,454,454,21,21,0,1,0
9,463,463,73,49,24,3,2
8,481,481,30,30,0,1,0
1,492,492,39,12,27,3,2

5,123,123,4,4,0,1,0
7,124,124,6,6,0,1,0
8,137,137,57,22,35,4,3
14,178,178,8,5,3,2,1
4,210,210,3,3,0,1,0
12,240,240,11,11,0,1,0
2,252,252,48,48,0,1,0
9,275,275,7,7,0,1,0
0,279,279,3,3,0,1,0
6,291,291,39,39,0,1,0
1,295,295,74,74,0,1,0
3,303,303,8,8,0,1,0
13,339,339,16,7,9,2,1
10,367,367,8,2,6,2,1
11,492,492,56,9,47,4,3

3,116,116,3,3,0,1,0
4,154,154,5,5,0,1,0
10,170,170,4,4,0,1,0
0,215,215,51,51,0,1,0
13,216,216,18,3,15,4,3
12,268,268,8,2,6,3,2
5,298,298,7,7,0,1,0
6,337,337,7,7,0,1,0
11,372,372,135,135,0,1,0
8,376,376,2,2,0,1,0
2,410,410,14,14,0,1,0
9,416,416,9,3,6,2,1
7,458,458,85,85,0,1,0
1,486,486,159,101,58,4,3

7,163,163,18,12,6,3,2
12,198,198,32,32,0,1,0
1,246,246,11,11,0,1,0
14,248,248,23,23,0,1,0
3,292,292,30,30,0,1,0
11,296,296,63,63,0,1,0
6,315,315,34,8,26,3,2
10,323,323,24,3,21,2,1
13,362,362,38,38,0,1,0
8,378,378,8,8,0,1,0
5,405,405,14,14,0,1,0
9,449,449,18,18,0,1,0
2,460,460,1,1,0,1,0
0,475,475,23,23,0,1,0
4,489,489,122,122,0,1,0

4,119,119,36,36,0,1,0
2,138,138,7,7,0,1,0
6,139,139,30,14,16,2,1
5,168,168,2,2,0,1,0
7,225,225,55,55,0,1,0
1,244,244,56,56,0,1,0
0,265,265,11,4,7,2,1
8,349,349,4,1,3,2,1
9,434,434,7,7,0,1,0
12,437,437,24,24,0,1,0
3,459,459,32,2,30,4,3
11,462,462,76,31,45,4,3
10,465,465,3,3,0,1,0

11,110,110,1,1,0,1,0
8,119,119,10,10,0,1,0
5,135,135,6,6,0,1,0
1,142,142,6,6,0,1,0
17,166,166,35,3,32,3,2
9,182,182,37,37,0,1,0
4,182,182,18,6,12,3,2
13,184,184,8,8,0,1,0
3,213,213,1,1,0,1,0
15,217,217,30,30,0,1,0
2,248,248,3,3,0,1,0
14,306,306,34,13,21,2,1
12,333,333,21,11,10,3,2
6,355,355,8,8,0,1,0
16,399,399,59,59,0,1,0
10,424,424,63,43,20,3,2
7,483,483,7,7,0,1,0
0,489,489,13,10,3,2,1

10,118,118,13,13,0,1,0
4,142,142,3,3,0,1,0
1,214,214,49,11,38,4,3
7,247,247,15,15,0,1,0
11,338,338,7,2,5,2,1
9,366,366,77,31,46,3,2
3,408,408,69,27,42,2,1
6,437,437,85,85,0,1,0
8,447,447,43,43,0,1,0
12,476,476,8,8,0,1,0
5,479,479,26,5,21,3,2
2,491,491,13,13,0,1,0
0,500,500,101,89,12,4,3

5,121,121,17,13,4,2,1
12,162,162,1,1,0,1,0
14,231,231,2,2,0,1,0
11,257,257,5,5,0,1,0
2,283,283,16,4,12,4,3
7,294,294,6,6,0,1,0
6,319,319,20,12,8,3,2
9,367,367,26,14,12,3,2
16,396,396,22,17,5,2,1
10,401,401,183,93,90,4,3
3,412,412,1,1,0,1,0
8,425,425,13,8,5,2,1
4,426,426,34,19,15,2,1
1,429,429,70,70,0,1,0
13,439,439,15,2,13,4,3
15,449,449,61,25,36,3,2
0,476,476,36,27,9,2,1

0,104,104,10,10,0,1,0
12,132,132,1,1,0,1,0
4,158,158,3,3,0,1,0
14,204,204,21,15,6,2,1
6,234,234,17,7,10,2,1
2,245,245,8,4,4,2,1
5,284,284,19,19,0,1,0
11,301,301,112,65,47,3,2
10,326,326,51,23,28,2,1
8,388,388,9,9,0,1,0
9,396,396,14,14,0,1,0
7,415,415,60,17,43,2,1
13,415,415,7,1,6,3,2
3,443,443,70,70,0,1,0
1,499,499,56,30,26,4,3

3,110,110,1,1,0,1,0
10,150,150,1,1,0,1,0
13,181,181,2,2,0,1,0
6,203,203,5,2,3,2,1
9,217,217,14,1,13,2,1
1,254,254,40,40,0,1,0
11,265,265,19,1,18,3,2
7,273,273,80,35,45,2,1
12,340,340,62,50,12,4,3
5,363,363,44,44,0,1,0
8,419,419,37,37,0,1,0
2,450,450,64,64,0,1,0
4,459,459,93,25,68,4,3
0,482,482,22,22,0,1,0

15,107,107,3,3,0,1,0
5,115,115,3,3,0,1,0
6,121,121,12,3,9,2,1
9,122,122,18,12,6,2,1
7,128,128,7,1,6,3,2
3,141,141,6,1,5,2,1
0,216,216,62,62,0,1,0
11,235,235,1,1,0,1,0
8,238,238,1,1,0,1,0
16,289,289,42,4,38,2,1
10,301,301,17,9,8,3,2
14,310,310,94,22,72,4,3
2,354,354,11,11,0,1,0
13,376,376,28,28,0,1,0
4,376,376,2,2,0,1,0
12,399,399,39,1,38,3,2
1,403,403,2,2,0,1,0

6,123,123,24,2,22,3,2
3,129,129,4,4,0,1,0
2,161,161,20,11,9,4,3
8,200,200,10,4,6,2,1
4,239,239,31,7,24,3,2
11,243,243,24,13,11,3,2
1,255,255,30,30,0,1,0
5,296,296,24,24,0,1,0
0,306,306,6,3,3,2,1
14,333,333,128,128,0,1,0
12,353,353,27,27,0,1,0
9,389,389,7,3,4,2,1
13,447,447,1,1,0,1,0
10,463,463,36,33,3,2,1
7,464,464,1,1,0,1,0

4,102,102,6,6,0,1,0
15,114,114,6,3,3,2,1
14,168,168,2,2,0,1,0
6,197,197,9,9,0,1,0
8,209,209,1,1,0,1,0
12,213,213,61,14,47,3,2
7,290,290,27,27,0,1,0
11,361,361,21,21,0,1,0
10,366,366,14,14,0,1,0
2,367,367,41,9,32,3,2
3,377,377,33,25,8,3,2
1,390,390,40,40,0,1,0
0,402,402,54,35,19,2,1
9,438,438,48,48,0,1,0
5,468,468,29,29,0,1,0
13,473,473,77,3,74,4,3

11,105,105,3,3,0,1,0
6,113,113,11,11,0,1,0
10,113,113,28,17,11,3,2
9,204,204,33,18,15,2,1
5,217,217,12,5,7,2,1
3,245,245,6,6,0,1,0
1,271,271,24,24,0,1,0
2,321,321,93,93,0,1,0
8,326,326,16,10,6,3,2
7,332,332,26,2,24,3,2
0,379,379,109,83,26,2,1
4,453,453,5,5,0,1,0

14,111,111,28,22,6,3,2
11,124,124,1,1,0,1,0
7,131,131,2,2,0,1,0
9,151,151,6,6,0,1,0
8,159,159,8,8,0,1,0
10,222,222,3,3,0,1,0
3,228,228,67,67,0,1,0
6,240,240,7,3,4,2,1
4,271,271,36,36,0,1,0
13,279,279,12,12,0,1,0
0,287,287,2,2,0,1,0
5,338,338,22,22,0,1,0
17,341,341,28,28,0,1,0
2,346,346,8,8,0,1,0
12,366,366,19,5,14,2,1
16,386,386,70,70,0,1,0
1,418,418,10,10,0,1,0
18,424,424,9,9,0,1,0
15,460,460,37,37,0,1,0

7,133,133,29,29,0,1,0
8,183,183,29,12,17,2,1
9,199,199,14,7,7,2,1
12,288,288,15,6,9,2,1
4,309,309,138,125,13,2,1
11,345,345,16,8,8,2,1
2,362,362,46,46,0,1,0
0,366,366,8,8,0,1,0
13,430,430,38,8,30,2,1
5,434,434,23,23,0,1,0
6,436,436,5,5,0,1,0
1,454,454,8,8,0,1,0
3,457,457,11,11,0,1,0
10,489,489,41,32,9,4,3

3,158,158,1,1,0,1,0
7,161,161,13,13,0,1,0
6,169,169,7,7,0,1,0
0,217,217,120,100,20,4,3
2,218,218,8,3,5,2,1
8,219,219,14,6,8,2,1
1,261,261,29,29,0,1,0
4,346,346,33,17,16,2,1
9,417,417,28,28,0,1,0
5,433,433,156,156,0,1,0

13,101,101,8,2,6,3,2
8,155,155,17,17,0,1,0
12,238,238,3,3,0,1,0
7,248,248,56,56,0,1,0
3,249,249,66,42,24,4,3
6,302,302,14,9,5,2,1
11,302,302,76,36,40,2,1
4,319,319,8,8,0,1,0
10,365,365,2,2,0,1,0
0,378,378,50,50,0,1,0
2,426,426,47,37,10,2,1
9,446,446,14,14,0,1,0
1,447,447,32,10,22,4,3
5,447,447,23,17,6,2,1

2,104,104,4,1,3,2,1
12,114,114,4,1,3,2,1
8,115,115,7,7,0,1,0
19,161,161,29,29,0,1,0
17,166,166,41,41,0,1,0
15,195,195,14,14,0,1,0
16,219,219,10,10,0,1,0
6,227,227,9,4,5,2,1
3,239,239,8,3,5,2,1
18,298,298,5,5,0,1,0
10,343,343,32,32,0,1,0
11,360,360,10,10,0,1,0
7,363,363,29,5,24,3,2
4,385,385,1,1,0,1,0
0,397,397,65,29,36,3,2
1,399,399,2,2,0,1,0
9,415,415,25,10,15,2,1
14,425,425,24,24,0,1,0
5,460,460,31,7,24,2,1
13,484,484,43,43,0,1,0

5,190,190,5,5,0,1,0
11,210,210,1,1,0,1,0
4,227,227,39,22,17,2,1
0,233,233,1,1,0,1,0
3,235,235,23,2,21,4,3
10,280,280,8,1,7,3,2
2,293,293,41,35,6,3,2
1,331,331,9,9,0,1,0
7,413,413,36,36,0,1,0
9,432,432,48,48,0,1,0
8,437,437,40,25,15,2,1
6,440,440,103,27,76,4,3
13,440,440,80,30,50,3,2
12,489,489,100,78,22,2,1

13,115,115,2,2,0,1,0
16,139,139,34,34,0,1,0
1,172,172,17,5,12,2,1
4,182,182,22,22,0,1,0
6,190,190,56,56,0,1,0
5,195,195,3,3,0,1,0
7,212,212,2,2,0,1,0
14,267,267,12,3,9,4,3
15,294,294,4,4,0,1,0
2,315,315,26,26,0,1,0
0,322,322,9,9,0,1,0
9,355,355,17,17,0,1,0
8,372,372,1,1,0,1,0
11,372,372,103,103,0,1,0
3,424,424,1,1,0,1,0
10,434,434,48,7,41,2,1
12,456,456,3,3,0,1,0

4,144,144,17,8,9,4,3
11,161,161,44,44,0,1,0
15,161,161,9,9,0,1,0
0,177,177,5,5,0,1,0
6,230,230,33,33,0,1,0
14,248,248,35,35,0,1,0
7,300,300,17,11,6,2,1
8,353,353,8,1,7,2,1
2,379,379,6,3,3,2,1
5,396,396,45,14,31,2,1
13,416,416,26,26,0,1,0
1,446,446,47,35,12,4,3
10,483,483,24,24,0,1,0
9,494,494,31,31,0,1,0
12,498,498,34,22,12,3,2
3,499,499,48,48,0,1,0

4,100,100,1,1,0,1,0
2,110,110,5,5,0,1,0
5,185,185,18,18,0,1,0
11,194,194,66,43,23,2,1
3,242,242,47,3,44,3,2
9,256,256,18,18,0,1,0
7,291,291,11,11,0,1,0
10,297,297,40,2,38,2,1
0,303,303,106,4,102,4,3
6,349,349,23,5,18,2,1
12,408,408,13,9,4,2,1
1,417,417,2,2,0,1,0
8,450,450,14,14,0,1,0

13,178,178,6,6,0,1,0
12,196,196,30,21,9,2,1
2,218,218,41,22,19,3,2
10,260,260,15,4,11,2,1
9,275,275,44,4,40,3,2
8,359,359,37,14,23,2,1
1,363,363,35,35,0,1,0
0,370,370,52,37,15,4,3
3,386,386,38,38,0,1,0
4,408,408,15,15,0,1,0
14,425,425,62,62,0,1,0
11,456,456,26,26,0,1,0
5,462,462,39,26,13,2,1
7,484,484,5,1,4,2,1
6,498,498,23,20,3,2,1

3,106,106,24,24,0,1,0
8,128,128,13,9,4,2,1
11,132,132,11,2,9,2,1
4,234,234,21,9,12,4,3
7,258,258,13,13,0,1,0
10,288,288,40,40,0,1,0
0,315,315,43,43,0,1,0
1,316,316,26,10,16,3,2
2,317,317,53,4,49,2,1
9,341,341,10,6,4,2,1
6,405,405,48,32,16,3,2
5,474,474,93,36,57,4,3

1,105,105,6,3,3,2,1
12,114,114,19,19,0,1,0
6,133,133,20,14,6,3,2
15,135,135,3,3,0,1,0
8,146,146,1,1,0,1,0
4,163,163,7,1,6,3,2
9,212,212,11,11,0,1,0
13,243,243,26,18,8,3,2
11,252,252,12,12,0,1,0
16,272,272,35,35,0,1,0
3,292,292,57,9,48,4,3
0,338,338,11,11,0,1,0
10,347,347,30,30,0,1,0
7,398,398,22,10,12,2,1
2,462,462,15,15,0,1,0
5,466,466,37,37,0,1,0
14,477,477,77,69,8,3,2

3,118,118,10,3,7,2,1
0,167,167,32,4,28,3,2
10,174,174,13,3,10,2,1
11,222,222,23,23,0,1,0
7,240,240,25,3,22,2,1
4,242,242,51,9,42,4,3
5,272,272,7,1,6,2,1
9,346,346,114,114,0,1,0
6,390,390,24,19,5,2,1
2,417,417,53,53,0,1,0
1,429,429,37,37,0,1,0
8,479,479,6,6,0,1,0

8,113,113,20,20,0,1,0
16,122,122,20,20,0,1,0
4,133,133,8,8,0,1,0
17,152,152,6,6,0,1,0
5,159,159,1,1,0,1,0
6,213,213,3,3,0,1,0
13,222,222,9,1,8,2,1
9,234,234,6,6,0,1,0
15,253,253,9,2,7,2,1
3,317,317,24,12,12,3,2
19,326,326,20,8,12,4,3
11,336,336,24,24,0,1,0
14,340,340,38,38,0,1,0
0,346,346,22,10,12,2,1
20,420,420,123,68,55,3,2
2,425,425,1,1,0,1,0
12,430,430,32,18,14,2,1
10,433,433,1,1,0,1,0
18,473,473,4,4,0,1,0
7,479,479,25,25,0,1,0
1,495,495,17,9,8,2,1

5,141,141,10,10,0,1,0
0,152,152,11,11,0,1,0
7,207,207,4,4,0,1,0
1,248,248,97,97,0,1,0
12,291,291,8,8,0,1,0
4,343,343,1,1,0,1,0
2,355,355,5,5,0,1,0
11,412,412,160,160,0,1,0
10,419,419,55,47,8,2,1
13,424,424,19,19,0,1,0
9,427,427,13,4,9,4,3
14,442,442,6,3,3,2,1
8,446,446,1,1,0,1,0
3,468,468,5,5,0,1,0
15,469,469,46,46,0,1,0
6,475,475,41,41,0,1,0
16,483,483,3,3,0,1,0

3,136,136,1,1,0,1,0
13,156,156,26,26,0,1,0
0,170,170,18,9,9,4,3
10,236,236,1,1,0,1,0
11,276,276,8,8,0,1,0
1,305,305,58,58,0,1,0
9,314,314,7,1,6,2,1
2,317,317,5,5,0,1,0
7,367,367,68,19,49,4,3
4,394,394,68,68,0,1,0
12,424,424,64,38,26,3,2
8,432,432,66,66,0,1,0
5,457,457,86,86,0,1,0
6,488,488,10,10,0,1,0

10,113,113,21,2,19,4,3
4,128,128,5,1,4,2,1
9,164,164,3,3,0,1,0
12,261,261,7,7,0,1,0
11,266,266,62,40,22,3,2
3,301,301,66,66,0,1,0
2,309,309,41,17,24,3,2
6,347,347,12,3,9,4,3
13,356,356,30,18,12,4,3
8,426,426,39,39,0,1,0
5,433,433,24,3,21,2,1
0,477,477,33,19,14,3,2
1,494,494,74,43,31,4,3
7,494,494,38,16,22,3,2

7,133,133,1,1,0,1,0
8,163,163,1,1,0,1,0
3,170,170,2,2,0,1,0
5,203,203,95,95,0,1,0
2,216,216,52,52,0,1,0
6,312,312,8,8,0,1,0
4,319,319,68,32,36,4,3
10,324,324,10,10,0,1,0
11,359,359,19,19,0,1,0
9,469,469,56,56,0,1,0
0,477,477,42,18,24,4,3
1,477,477,70,30,40,2,1

18,147,147,1,1,0,1,0
9,157,157,11,11,0,1,0
12,161,161,39,39,0,1,0
11,193,193,17,17,0,1,0
15,206,206,39,39,0,1,0
6,282,282,13,5,8,3,2
13,324,324,5,2,3,2,1
0,338,338,16,16,0,1,0
10,372,372,1,1,0,1,0
14,373,373,6,6,0,1,0
3,384,384,1,1,0,1,0
2,385,385,117,45,72,3,2
7,387,387,7,7,0,1,0
5,401,401,4,4,0,1,0
16,401,401,14,7,7,2,1
4,402,402,4,4,0,1,0
1,467,467,35,35,0,1,0
8,492,492,13,13,0,1,0
17,492,492,105,105,0,1,0

3,100,100,5,5,0,1,0
8,154,154,3,3,0,1,0
0,184,184,4,4,0,1,0
4,261,261,1,1,0,1,0
5,293,293,35,35,0,1,0
2,312,312,121,1,120,4,3
13,370,370,13,13,0,1,0
11,388,388,115,115,0,1,0
6,390,390,45,45,0,1,0
12,390,390,126,96,30,3,2
10,407,407,10,10,0,1,0
9,414,414,2,2,0,1,0
7,452,452,3,3,0,1,0
1,488,488,1,1,0,1,0

1,107,107,29,14,15,2,1
11,134,134,32,32,0,1,0
4,167,167,1,1,0,1,0
7,187,187,9,9,0,1,0
6,192,192,14,14,0,1,0
0,197,197,15,3,12,2,1
2,226,226,62,62,0,1,0
12,235,235,14,8,6,3,2
9,236,236,35,35,0,1,0
3,248,248,17,12,5,2,1
10,277,277,1,1,0,1,0
8,283,283,43,22,21,4,3
5,422,422,2,2,0,1,0

9,123,123,21,21,0,1,0
11,140,140,23,9,14,3,2
4,170,170,1,1,0,1,0
3,200,200,16,16,0,1,0
8,215,215,19,19,0,1,0
6,266,266,4,4,0,1,0
2,277,277,5,5,0,1,0
0,299,299,78,3,75,4,3
5,299,299,28,28,0,1,0
12,306,306,12,12,0,1,0
14,323,323,4,4,0,1,0
13,353,353,73,60,13,3,2
7,417,417,48,31,17,2,1
10,476,476,16,4,12,2,1
1,491,491,55,55,0,1,0

0,119,119,8,8,0,1,0
7,146,146,13,13,0,1,0
5,153,153,5,5,0,1,0
6,174,174,43,5,38,3,2
11,211,211,10,10,0,1,0
1,228,228,58,58,0,1,0
3,261,261,57,23,34,4,3
8,288,288,64,47,17,2,1
2,296,296,24,2,22,3,2
4,333,333,27,27,0,1,0
10,377,377,4,4,0,1,0
9,420,420,30,30,0,1,0

8,116,116,22,22,0,1,0
0,117,117,1,1,0,1,0
1,149,149,1,1,0,1,0
2,202,202,11,11,0,1,0
11,214,214,29,29,0,1,0
7,220,220,4,4,0,1,0
5,227,227,20,20,0,1,0
9,238,238,33,33,0,1,0
6,277,277,19,5,14,2,1
4,313,313,65,5,60,4,3
3,332,332,141,119,22,3,2
10,439,439,32,14,18,4,3

11,170,170,37,5,32,3,2
7,171,171,3,3,0,1,0
0,176,176,6,6,0,1,0
5,189,189,6,6,0,1,0
12,215,215,43,43,0,1,0
10,305,305,8,8,0,1,0
1,323,323,26,26,0,1,0
3,325,325,87,57,30,2,1
2,358,358,1,1,0,1,0
6,379,379,13,13,0,1,0
9,455,455,62,13,49,2,1
8,472,472,41,20,21,4,3
4,482,482,139,50,89,4,3

9,146,146,9,2,7,2,1
11,196,196,28,22,6,2,1
5,210,210,33,33,0,1,0
2,233,233,36,36,0,1,0
1,240,240,17,17,0,1,0
8,245,245,47,47,0,1,0
0,277,277,50,23,27,2,1
10,308,308,30,15,15,2,1
3,341,341,55,55,0,1,0
4,348,348,47,4,43,4,3
7,355,355,22,22,0,1,0
6,444,444,3,3,0,1,0

10,121,121,6,6,0,1,0
4,167,167,5,5,0,1,0
5,169,169,8,8,0,1,0
1,174,174,79,24,55,3,2
6,174,174,11,5,6,3,2
0,255,255,16,16,0,1,0
8,347,347,21,21,0,1,0
2,360,360,61,61,0,1,0
7,423,423,76,76,0,1,0
9,430,430,122,95,27,4,3
3,465,465,7,7,0,1,0

0,111,111,7,7,0,1,0
12,118,118,45,45,0,1,0
10,121,121,1,1,0,1,0
13,135,135,10,10,0,1,0
14,209,209,5,5,0,1,0
15,226,226,2,2,0,1,0
18,248,248,29,14,15,2,1
3,275,275,7,7,0,1,0
11,293,293,37,22,15,4,3
7,298,298,1,1,0,1,0
9,310,310,2,2,0,1,0
5,315,315,28,2,26,3,2
6,319,319,38,38,0,1,0
8,365,365,3,3,0,1,0
4,379,379,18,18,0,1,0
17,382,382,21,21,0,1,0
2,413,413,24,14,10,4,3
1,424,424,62,62,0,1,0
16,495,495,30,12,18,2,1

19,101,101,5,5,0,1,0
7,132,132,13,9,4,2,1
11,161,161,12,12,0,1,0
9,166,166,2,2,0,1,0
6,226,226,60,21,39,4,3
3,229,229,1,1,0,1,0
13,254,254,47,47,0,1,0
16,266,266,7,7,0,1,0
12,294,294,3,3,0,1,0
0,296,296,1,1,0,1,0
1,308,308,12,12,0,1,0
14,329,329,32,18,14,3,2
18,361,361,96,48,48,3,2
15,381,381,24,12,12,3,2
10,414,414,40,20,20,3,2
17,441,441,10,10,0,1,0
2,472,472,14,14,0,1,0
8,486,486,7,4,3,2,1
5,493,493,25,25,0,1,0
4,500,500,1,1,0,1,0

7,100,100,17,17,0,1,0
8,159,159,5,5,0,1,0
4,160,160,28,17,11,2,1
9,197,197,5,2,3,2,1
5,277,277,16,16,0,1,0
11,322,322,99,66,33,2,1
12,333,333,19,19,0,1,0
13,389,389,25,10,15,2,1
10,390,390,23,1,22,2,1
2,411,411,2,2,0,1,0
1,442,442,18,5,13,2,1
6,445,445,65,65,0,1,0
0,478,478,7,7,0,1,0
3,488,488,128,62,66,4,3

8,119,119,13,4,9,4,3
1,121,121,10,2,8,3,2
0,162,162,5,5,0,1,0
2,178,178,30,30,0,1,0
11,197,197,10,2,8,2,1
5,245,245,5,5,0,1,0
13,268,268,58,42,16,2,1
3,270,270,48,48,0,1,0
7,297,297,39,39,0,1,0
6,360,360,46,16,30,4,3
4,440,440,41,41,0,1,0
10,453,453,19,19,0,1,0
9,455,455,30,30,0,1,0
12,457,457,44,44,0,1,0

3,132,132,7,7,0,1,0
6,152,152,21,21,0,1,0
9,161,161,1,1,0,1,0
10,216,216,7,4,3,2,1
1,289,289,9,9,0,1,0
12,294,294,21,15,6,3,2
5,298,298,31,31,0,1,0
2,326,326,43,37,6,2,1
8,375,375,43,14,29,2,1
11,385,385,62,62,0,1,0
0,414,414,19,19,0,1,0
4,470,470,94,26,68,3,2
7,486,486,59,29,30,3,2
13,488,488,99,99,0,1,0

1,142,142,6,6,0,1,0
14,151,151,50,50,0,1,0
0,249,249,18,18,0,1,0
13,249,249,35,35,0,1,0
3,275,275,6,6,0,1,0
9,287,287,7,7,0,1,0
2,294,294,6,6,0,1,0
4,300,300,1,1,0,1,0
16,314,314,5,5,0,1,0
10,355,355,26,26,0,1,0
5,379,379,54,16,38,3,2
11,396,396,6,6,0,1,0
6,426,426,21,21,0,1,0
15,447,447,30,30,0,1,0
12,458,458,31,31,0,1,0
8,461,461,10,10,0,1,0
7,473,473,143,55,88,3,2

8,109,109,1,1,0,1,0
12,139,139,9,9,0,1,0
13,162,162,2,2,0,1,0
2,175,175,9,9,0,1,0
10,205,205,23,3,20,3,2
15,243,243,9,1,8,3,2
6,267,267,31,4,27,4,3
3,310,310,9,9,0,1,0
5,333,333,49,49,0,1,0
14,336,336,67,67,0,1,0
1,360,360,73,5,68,3,2
9,378,378,26,26,0,1,0
0,410,410,2,2,0,1,0
11,454,454,12,12,0,1,0
16,461,461,119,80,39,2,1
4,478,478,3,3,0,1,0
7,491,491,32,20,12,2,1

16,117,117,6,6,0,1,0
3,119,119,1,1,0,1,0
0,123,123,10,10,0,1,0
11,148,148,8,8,0,1,0
14,167,167,32,32,0,1,0
12,177,177,10,10,0,1,0
6,196,196,12,7,5,2,1
5,216,216,42,42,0,1,0
8,250,250,11,11,0,1,0
7,253,253,31,31,0,1,0
15,260,260,5,5,0,1,0
2,331,331,35,32,3,2,1
9,367,367,24,24,0,1,0
10,433,433,130,34,96,3,2
4,448,448,6,6,0,1,0
1,476,476,2,2,0,1,0
13,488,488,24,24,0,1,0

2,144,144,8,1,7,2,1
3,204,204,32,7,25,2,1
7,234,234,4,4,0,1,0
1,255,255,49,49,0,1,0
11,305,305,51,37,14,3,2
9,365,365,80,62,18,3,2
10,367,367,35,35,0,1,0
5,378,378,47,47,0,1,0
6,398,398,38,38,0,1,0
0,428,428,17,17,0,1,0
4,440,440,58,53,5,2,1
12,445,445,6,6,0,1,0
8,487,487,51,11,40,2,1

5,116,116,8,8,0,1,0
4,150,150,1,1,0,1,0
16,163,163,30,8,22,2,1
1,183,183,1,1,0,1,0
6,190,190,28,28,0,1,0
9,195,195,6,6,0,1,0
13,202,202,3,3,0,1,0
8,205,205,1,1,0,1,0
15,282,282,30,9,21,4,3
14,295,295,42,37,5,2,1
10,300,300,1,1,0,1,0
12,325,325,1,1,0,1,0
18,346,346,61,61,0,1,0
7,388,388,14,14,0,1,0
2,392,392,100,100,0,1,0
0,407,407,14,14,0,1,0
20,443,443,4,4,0,1,0
17,454,454,11,4,7,2,1
11,482,482,40,2,38,2,1
3,486,486,5,5,0,1,0
19,490,490,34,15,19,2,1

2,107,107,18,18,0,1,0
4,120,120,1,1,0,1,0
14,132,132,5,5,0,1,0
3,149,149,11,11,0,1,0
1,152,152,23,6,17,2,1
15,184,184,47,47,0,1,0
12,205,205,13,7,6,3,2
11,237,237,16,16,0,1,0
0,272,272,5,5,0,1,0
5,282,282,29,8,21,4,3
10,305,305,24,7,17,2,1
6,310,310,29,17,12,3,2
13,367,367,16,16,0,1,0
9,373,373,9,2,7,2,1
7,419,419,21,21,0,1,0
16,421,421,69,43,26,3,2
8,495,495,5,5,0,1,0

2,122,122,7,2,5,2,1
4,137,137,4,4,0,1,0
11,172,172,27,18,9,2,1
0,258,258,29,29,0,1,0
13,283,283,8,8,0,1,0
9,352,352,37,37,0,1,0
12,354,354,27,21,6,2,1
1,378,378,28,15,13,2,1
8,379,379,32,32,0,1,0
10,397,397,66,19,47,2,1
6,398,398,39,39,0,1,0
14,401,401,35,35,0,1,0
7,444,444,54,38,16,2,1
3,448,448,76,76,0,1,0
5,449,449,17,3,14,2,1

4,128,128,16,16,0,1,0
2,166,166,49,5,44,2,1
0,168,168,3,3,0,1,0
1,217,217,8,8,0,1,0
12,245,245,42,42,0,1,0
11,247,247,23,23,0,1,0
7,262,262,24,17,7,2,1
6,282,282,54,54,0,1,0
8,300,300,2,2,0,1,0
9,342,342,46,30,16,2,1
3,353,353,12,12,0,1,0
10,363,363,8,3,5,2,1
5,499,499,96,51,45,4,3

12,130,130,26,26,0,1,0
9,142,142,11,11,0,1,0
3,157,157,2,2,0,1,0
6,198,198,19,11,8,3,2
13,198,198,7,7,0,1,0
4,296,296,3,3,0,1,0
10,299,299,4,1,3,2,1
5,319,319,48,48,0,1,0
0,323,323,56,56,0,1,0
14,372,372,12,6,6,3,2
8,385,385,4,1,3,2,1
15,385,385,66,25,41,2,1
7,447,447,18,4,14,3,2
1,476,476,70,4,66,4,3
11,478,478,87,25,62,3,2
2,485,485,30,3,27,2,1

9,103,103,24,18,6,2,1
13,103,103,11,5,6,3,2
7,172,172,28,1,27,2,1
4,177,177,8,8,0,1,0
6,194,194,13,13,0,1,0
11,206,206,24,24,0,1,0
10,228,228,3,3,0,1,0
0,234,234,2,2,0,1,0
3,268,268,14,14,0,1,0
8,353,353,8,8,0,1,0
1,356,356,87,51,36,4,3
12,384,384,25,13,12,4,3
5,422,422,120,87,33,4,3
2,431,431,1,1,0,1,0

4,114,114,18,2,16,2,1
12,140,140,49,49,0,1,0
0,159,159,28,7,21,4,3
11,202,202,4,4,0,1,0
2,209,209,19,4,15,4,3
3,211,211,35,19,16,3,2
6,255,255,10,10,0,1,0
10,263,263,33,12,21,2,1
13,303,303,6,6,0,1,0
7,353,353,3,3,0,1,0
5,363,363,15,15,0,1,0
8,366,366,20,20,0,1,0
9,374,374,52,52,0,1,0
14,400,400,1,1,0,1,0
1,414,414,9,9,0,1,0

16,101,101,18,3,15,4,3
8,132,132,2,2,0,1,0
12,135,135,23,23,0,1,0
10,155,155,6,6,0,1,0
5,224,224,25,25,0,1,0
3,237,237,9,1,8,3,2
17,239,239,1,1,0,1,0
6,247,247,11,6,5,2,1
11,263,263,20,1,19,2,1
13,263,263,33,33,0,1,0
18,308,308,97,25,72,4,3
2,332,332,14,14,0,1,0
19,360,360,8,8,0,1,0
7,377,377,48,24,24,4,3
14,392,392,13,5,8,3,2
15,396,396,14,11,3,2,1
1,402,402,2,2,0,1,0
9,427,427,7,7,0,1,0
4,446,446,8,8,0,1,0
0,487,487,2,2,0,1,0

10,122,122,9,9,0,1,0
2,188,188,11,5,6,2,1
12,190,190,9,9,0,1,0
7,220,220,28,8,20,2,1
5,226,226,44,6,38,3,2
8,284,284,62,62,0,1,0
3,306,306,72,18,54,4,3
11,316,316,33,33,0,1,0
0,334,334,5,5,0,1,0
1,358,358,25,25,0,1,0
6,368,368,1,1,0,1,0
4,392,392,50,50,0,1,0
9,465,465,65,44,21,4,3

2,134,134,7,1,6,3,2
0,137,137,7,3,4,2,1
8,274,274,12,6,6,2,1
6,280,280,16,7,9,2,1
1,318,318,127,127,0,1,0
11,338,338,7,7,0,1,0
9,341,341,80,40,40,2,1
3,346,346,45,45,0,1,0
10,350,350,55,4,51,3,2
5,374,374,25,4,21,2,1
4,434,434,30,6,24,4,3
7,470,470,61,61,0,1,0

3,128,128,31,11,20,3,2
5,135,135,13,13,0,1,0
10,162,162,18,18,0,1,0
8,192,192,11,11,0,1,0
11,244,244,19,19,0,1,0
0,296,296,31,31,0,1,0
4,369,369,25,25,0,1,0
1,381,381,35,25,10,2,1
6,386,386,61,61,0,1,0
9,448,448,34,22,12,2,1
2,483,483,94,94,0,1,0
7,496,496,66,6,60,4,3

1,101,101,42,13,29,2,1
9,105,105,17,3,14,2,1
6,221,221,26,20,6,2,1
4,244,244,41,27,14,3,2
8,281,281,5,5,0,1,0
3,288,288,47,13,34,3,2
5,383,383,13,13,0,1,0
0,429,429,14,14,0,1,0
10,435,435,19,19,0,1,0
2,447,447,41,13,28,3,2
7,454,454,79,49,30,3,2

4,125,125,15,15,0,1,0
8,141,141,36,36,0,1,0
14,170,170,2,2,0,1,0
2,196,196,10,10,0,1,0
9,237,237,58,58,0,1,0
1,238,238,33,6,27,4,3
5,275,275,6,6,0,1,0
11,290,290,51,51,0,1,0
13,290,290,11,5,6,2,1
7,313,313,16,9,7,2,1
12,396,396,38,38,0,1,0
3,425,425,3,3,0,1,0
0,426,426,20,12,8,2,1
15,460,460,48,10,38,2,1
10,469,469,19,6,13,2,1
6,478,478,6,6,0,1,0

5,113,113,10,10,0,1,0
0,132,132,12,5,7,2,1
1,147,147,13,13,0,1,0
8,191,191,5,5,0,1,0
9,238,238,2,2,0,1,0
12,265,265,31,19,12,3,2
10,298,298,65,47,18,3,2
11,327,327,35,35,0,1,0
7,342,342,73,73,0,1,0
13,365,365,9,4,5,2,1
4,436,436,1,1,0,1,0
2,464,464,14,14,0,1,0
6,481,481,162,87,75,4,3
3,499,499,32,32,0,1,0

2,130,130,2,2,0,1,0
6,242,242,23,23,0,1,0
4,267,267,35,35,0,1,0
5,280,280,24,24,0,1,0
3,336,336,15,15,0,1,0
7,367,367,42,7,35,2,1
0,403,403,100,73,27,2,1
9,445,445,73,60,13,3,2
8,468,468,35,3,32,2,1
1,474,474,208,58,150,4,3

16,109,109,7,4,3,2,1
8,116,116,6,1,5,2,1
19,145,145,6,6,0,1,0
6,162,162,4,4,0,1,0
14,203,203,10,10,0,1,0
11,225,225,3,3,0,1,0
15,225,225,65,65,0,1,0
7,227,227,9,9,0,1,0
9,228,228,1,1,0,1,0
5,284,284,1,1,0,1,0
12,348,348,3,3,0,1,0
4,350,350,2,2,0,1,0
3,365,365,14,2,12,4,3
10,396,396,59,31,28,2,1
18,405,405,2,2,0,1,0
2,437,437,70,21,49,2,1
1,475,475,11,11,0,1,0
20,477,477,14,14,0,1,0
13,488,488,32,2,30,4,3
0,488,488,55,10,45,4,3
17,496,496,123,123,0,1,0

7,106,106,2,2,0,1,0
2,110,110,3,3,0,1,0
11,129,129,2,2,0,1,0
10,135,135,16,16,0,1,0
8,156,156,1,1,0,1,0
5,165,165,2,2,0,1,0
17,167,167,22,22,0,1,0
16,233,233,7,7,0,1,0
0,239,239,9,9,0,1,0
3,244,244,7,1,6,3,2
14,251,251,25,1,24,4,3
12,272,272,21,21,0,1,0
15,276,276,50,50,0,1,0
13,388,388,26,11,15,2,1
19,405,405,29,24,5,2,1
6,450,450,76,76,0,1,0
4,474,474,43,8,35,2,1
1,477,477,46,1,45,4,3
18,484,484,63,56,7,2,1
9,492,492,1,1,0,1,0

15,102,102,5,5,0,1,0
1,108,108,4,4,0,1,0
9,153,153,13,8,5,2,1
7,160,160,22,9,13,2,1
13,231,231,17,17,0,1,0
6,282,282,6,6,0,1,0
10,284,284,11,11,0,1,0
11,295,295,45,39,6,2,1
5,313,313,1,1,0,1,0
0,335,335,17,17,0,1,0
4,352,352,27,27,0,1,0
3,355,355,1,1,0,1,0
8,377,377,115,115,0,1,0
12,447,447,51,51,0,1,0
14,455,455,96,8,88,3,2
2,484,484,33,17,16,3,2

16,102,102,22,8,14,2,1
9,111,111,11,11,0,1,0
1,120,120,5,5,0,1,0
10,146,146,4,4,0,1,0
12,205,205,8,8,0,1,0
14,213,213,6,2,4,2,1
5,222,222,21,21,0,1,0
15,230,230,17,9,8,2,1
8,255,255,29,29,0,1,0
13,259,259,1,1,0,1,0
0,354,354,10,6,4,2,1
11,361,361,118,26,92,4,3
3,392,392,13,13,0,1,0
6,416,416,74,2,72,3,2
4,429,429,17,2,15,4,3
7,447,447,20,2,18,2,1
2,476,476,16,6,10,2,1

15,107,107,20,5,15,2,1
9,122,122,2,2,0,1,0
14,163,163,5,5,0,1,0
6,170,170,15,6,9,2,1
5,194,194,1,1,0,1,0
17,205,205,47,38,9,4,3
7,207,207,8,8,0,1,0
3,210,210,3,3,0,1,0
10,220,220,34,2,32,2,1
18,226,226,1,1,0,1,0
8,265,265,1,1,0,1,0
2,276,276,40,40,0,1,0
12,294,294,18,3,15,4,3
20,323,323,14,14,0,1,0
16,375,375,79,79,0,1,0
11,399,399,15,11,4,2,1
0,414,414,40,40,0,1,0
1,417,417,8,8,0,1,0
4,418,418,8,8,0,1,0
13,431,431,1,1,0,1,0
19,480,480,7,3,4,2,1

1,103,103,6,6,0,1,0
15,112,112,2,2,0,1,0
3,176,176,1,1,0,1,0
13,178,178,40,40,0,1,0
7,201,201,2,2,0,1,0
9,220,220,41,21,20,2,1
4,246,246,70,70,0,1,0
2,264,264,6,2,4,2,1
10,276,276,32,1,31,2,1
11,281,281,10,2,8,2,1
6,295,295,25,25,0,1,0
5,303,303,22,22,0,1,0
14,358,358,9,6,3,2,1
12,366,366,39,39,0,1,0
8,427,427,34,34,0,1,0
0,437,437,36,14,22,2,1

11,113,113,7,7,0,1,0
8,163,163,50,50,0,1,0
13,181,181,8,8,0,1,0
12,187,187,13,7,6,3,2
3,246,246,15,15,0,1,0
2,286,286,28,28,0,1,0
1,329,329,3,3,0,1,0
4,355,355,22,22,0,1,0
9,361,361,37,37,0,1,0
7,367,367,11,6,5,2,1
5,383,383,108,67,41,2,1
10,452,452,47,7,40,3,2
0,467,467,66,66,0,1,0
6,478,478,23,20,3,2,1

18,119,119,26,26,0,1,0
13,158,158,19,7,12,4,3
0,194,194,6,6,0,1,0
5,206,206,58,4,54,4,3
17,258,258,19,10,9,2,1
15,264,264,32,3,29,2,1
8,264,264,6,6,0,1,0
3,296,296,8,8,0,1,0
14,316,316,47,47,0,1,0
11,316,316,41,41,0,1,0
1,324,324,27,11,16,3,2
10,329,329,13,13,0,1,0
2,355,355,1,1,0,1,0
12,367,367,2,2,0,1,0
6,376,376,5,1,4,2,1
7,400,400,1,1,0,1,0
9,420,420,26,26,0,1,0
16,457,457,11,11,0,1,0
4,472,472,3,3,0,1,0

12,126,126,3,3,0,1,0
13,133,133,18,18,0,1,0
6,151,151,3,3,0,1,0
7,183,183,30,14,16,3,2
10,218,218,51,10,41,4,3
2,257,257,7,1,6,2,1
0,311,311,12,12,0,1,0
9,376,376,36,36,0,1,0
4,425,425,69,33,36,3,2
11,432,432,7,7,0,1,0
5,472,472,64,35,29,2,1
3,478,478,48,48,0,1,0
1,499,499,108,42,66,4,3
8,499,499,24,8,16,2,1

10,106,106,8,3,5,2,1
4,134,134,18,18,0,1,0
0,153,153,15,15,0,1,0
15,225,225,11,11,0,1,0
12,249,249,57,1,56,3,2
14,288,288,29,29,0,1,0
2,296,296,19,9,10,3,2
3,299,299,16,16,0,1,0
9,317,317,37,18,19,4,3
11,329,329,12,7,5,2,1
13,343,343,7,7,0,1,0
7,360,360,18,6,12,4,3
16,367,367,74,40,34,4,3
8,376,376,4,4,0,1,0
5,412,412,15,15,0,1,0
1,437,437,47,26,21,4,3
6,444,444,13,3,10,3,2

1,113,113,16,5,11,2,1
11,117,117,6,6,0,1,0
6,184,184,3,3,0,1,0
7,255,255,33,19,14,3,2
8,298,298,40,18,22,2,1
3,335,335,63,6,57,4,3
2,376,376,41,2,39,2,1
9,376,376,87,43,44,2,1
4,381,381,86,26,60,3,2
0,448,448,16,7,9,4,3
10,475,475,22,18,4,2,1
5,479,479,50,50,0,1,0

13,111,111,3,3,0,1,0
12,131,131,34,10,24,4,3
3,132,132,1,1,0,1,0
5,144,144,27,8,19,3,2
16,156,156,33,33,0,1,0
4,180,180,6,6,0,1,0
6,204,204,1,1,0,1,0
8,242,242,30,3,27,3,2
14,257,257,4,4,0,1,0
11,319,319,15,15,0,1,0
10,365,365,11,11,0,1,0
0,381,381,1,1,0,1,0
2,397,397,96,48,48,2,1
15,410,410,37,22,15,4,3
9,421,421,12,12,0,1,0
17,438,438,29,5,24,4,3
7,438,438,1,1,0,1,0
1,497,497,19,19,0,1,0

8,140,140,19,8,11,3,2
9,166,166,12,12,0,1,0
2,194,194,1,1,0,1,0
3,316,316,92,59,33,4,3
7,345,345,96,96,0,1,0
10,356,356,18,5,13,2,1
4,367,367,45,41,4,2,1
11,387,387,9,9,0,1,0
1,410,410,42,1,41,2,1
0,434,434,61,39,22,2,1
12,437,437,47,47,0,1,0
6,460,460,22,7,15,4,3
5,471,471,18,9,9,4,3

1,133,133,1,1,0,1,0
10,168,168,26,22,4,2,1
12,170,170,25,25,0,1,0
11,248,248,21,8,13,2,1
6,300,300,59,40,19,2,1
8,318,318,26,10,16,2,1
2,324,324,45,3,42,4,3
0,367,367,56,56,0,1,0
4,404,404,13,13,0,1,0
13,411,411,38,38,0,1,0
7,431,431,60,60,0,1,0
9,489,489,7,7,0,1,0
3,491,491,6,1,5,2,1
5,499,499,80,38,42,3,2

3,237,237,37,15,22,2,1
4,261,261,33,33,0,1,0
2,268,268,24,24,0,1,0
5,309,309,18,18,0,1,0
1,323,323,89,83,6,3,2
9,327,327,23,1,22,2,1
6,341,341,76,7,69,4,3
10,355,355,31,31,0,1,0
0,428,428,23,23,0,1,0
7,446,446,5,2,3,2,1
8,468,468,59,59,0,1,0
11,496,496,65,65,0,1,0

11,115,115,18,15,3,2,1
1,125,125,2,2,0,1,0
8,162,162,2,2,0,1,0
13,180,180,34,34,0,1,0
7,183,183,13,13,0,1,0
9,190,190,8,1,7,2,1
5,225,225,46,46,0,1,0
10,236,236,11,11,0,1,0
4,253,253,52,52,0,1,0
12,304,304,64,21,43,2,1
6,358,358,27,27,0,1,0
3,376,376,67,51,16,3,2
0,381,381,6,6,0,1,0
2,480,480,3,3,0,1,0

14,102,102,1,1,0,1,0
18,163,163,3,3,0,1,0
10,167,167,8,8,0,1,0
0,174,174,16,16,0,1,0
19,185,185,26,26,0,1,0
7,189,189,10,1,9,2,1
9,201,201,12,12,0,1,0
2,224,224,1,1,0,1,0
11,239,239,1,1,0,1,0
3,251,251,36,18,18,3,2
1,277,277,26,26,0,1,0
16,285,285,96,42,54,4,3
15,289,289,46,30,16,2,1
8,296,296,1,1,0,1,0
20,303,303,7,7,0,1,0
5,320,320,9,1,8,3,2
4,358,358,7,3,4,2,1
17,365,365,11,5,6,3,2
6,437,437,35,35,0,1,0
13,445,445,20,4,16,3,2
12,469,469,12,12,0,1,0

8,156,156,18,6,12,3,2
2,182,182,2,2,0,1,0
3,182,182,22,4,18,2,1
5,260,260,56,2,54,4,3
4,320,320,43,31,12,4,3
0,439,439,14,14,0,1,0
7,448,448,24,24,0,1,0
6,458,458,27,27,0,1,0
1,468,468,313,187,126,4,3

11,106,106,16,16,0,1,0
7,123,123,8,8,0,1,0
9,127,127,16,4,12,2,1
4,132,132,6,6,0,1,0
1,161,161,11,2,9,2,1
12,169,169,8,5,3,2,1
2,201,201,5,5,0,1,0
10,248,248,10,2,8,2,1
0,344,344,56,6,50,2,1
8,375,375,26,11,15,2,1
6,380,380,68,68,0,1,0
14,412,412,19,4,15,4,3
3,470,470,23,23,0,1,0
13,477,477,113,113,0,1,0
5,495,495,53,53,0,1,0

3,125,125,28,28,0,1,0
2,133,133,24,16,8,3,2
4,144,144,1,1,0,1,0
7,153,153,8,8,0,1,0
5,158,158,5,5,0,1,0
6,164,164,23,16,7,2,1
1,167,167,39,39,0,1,0
11,200,200,3,3,0,1,0
10,361,361,24,24,0,1,0
12,361,361,19,11,8,3,2
0,471,471,14,14,0,1,0
9,489,489,115,14,101,4,3
8,497,497,73,73,0,1,0

1,113,113,21,6,15,2,1
6,117,117,1,1,0,1,0
11,142,142,5,5,0,1,0
0,159,159,23,23,0,1,0
5,188,188,28,6,22,4,3
9,194,194,4,4,0,1,0
2,200,200,1,1,0,1,0
8,279,279,19,5,14,3,2
10,282,282,42,42,0,1,0
7,375,375,46,4,42,2,1
13,402,402,41,41,0,1,0
3,426,426,6,6,0,1,0
14,433,433,42,34,8,2,1
12,440,440,108,86,22,4,3
4,454,454,32,18,14,3,2

10,131,131,14,2,12,4,3
0,182,182,1,1,0,1,0
15,187,187,3,3,0,1,0
2,203,203,1,1,0,1,0
14,212,212,44,35,9,4,3
3,253,253,7,7,0,1,0
11,298,298,33,22,11,2,1
8,307,307,67,67,0,1,0
7,317,317,11,11,0,1,0
6,343,343,30,23,7,2,1
1,344,344,3,3,0,1,0
4,364,364,1,1,0,1,0
13,371,371,67,67,0,1,0
9,373,373,9,3,6,2,1
16,393,393,26,26,0,1,0
12,427,427,9,1,8,2,1
5,470,470,135,102,33,4,3

8,101,101,6,6,0,1,0
7,150,150,10,2,8,3,2
4,173,173,7,1,6,3,2
10,249,249,62,26,36,3,2
1,250,250,7,7,0,1,0
9,284,284,24,6,18,2,1
2,286,286,22,8,14,3,2
0,335,335,88,47,41,2,1
6,335,335,26,2,24,2,1
5,340,340,83,4,79,4,3
11,399,399,27,27,0,1,0
12,405,405,46,10,36,4,3
3,494,494,24,24,0,1,0

1,157,157,27,11,16,2,1
2,237,237,9,9,0,1,0
7,252,252,52,30,22,3,2
0,281,281,20,20,0,1,0
4,285,285,45,19,26,3,2
3,327,327,86,26,60,3,2
10,338,338,58,23,35,2,1
11,380,380,2,2,0,1,0
5,384,384,29,29,0,1,0
9,404,404,17,2,15,4,3
8,449,449,26,2,24,4,3
6,459,459,70,40,30,4,3

7,110,110,8,8,0,1,0
8,144,144,8,8,0,1,0
10,184,184,8,8,0,1,0
0,193,193,9,4,5,2,1
2,264,264,96,56,40,3,2
5,277,277,43,43,0,1,0
11,291,291,35,35,0,1,0
3,329,329,13,13,0,1,0
1,377,377,70,46,24,4,3
4,390,390,26,5,21,3,2
9,458,458,121,121,0,1,0
6,489,489,2,2,0,1,0

9,169,169,11,11,0,1,0
4,240,240,32,20,12,4,3
3,250,250,33,27,6,3,2
11,263,263,8,8,0,1,0
13,272,272,29,8,21,4,3
0,313,313,25,25,0,1,0
7,341,341,90,90,0,1,0
10,345,345,18,18,0,1,0
1,349,349,3,3,0,1,0
2,363,363,27,7,20,2,1
12,383,383,54,54,0,1,0
5,464,464,19,3,16,3,2
8,469,469,25,25,0,1,0
6,489,489,113,8,105,4,3

15,103,103,3,3,0,1,0
10,114,114,4,4,0,1,0
14,175,175,37,30,7,2,1
1,242,242,90,78,12,2,1
11,249,249,18,18,0,1,0
12,250,250,11,11,0,1,0
2,309,309,4,4,0,1,0
4,323,323,10,2,8,2,1
6,334,334,1,1,0,1,0
3,347,347,4,4,0,1,0
7,373,373,60,60,0,1,0
8,445,445,6,2,4,2,1
5,448,448,22,22,0,1,0
0,454,454,22,4,18,3,2
9,461,461,29,29,0,1,0
13,485,485,128,128,0,1,0

11,107,107,2,2,0,1,0
2,155,155,12,12,0,1,0
6,194,194,35,8,27,4,3
14,200,200,32,32,0,1,0
9,210,210,38,26,12,3,2
10,219,219,16,4,12,3,2
8,228,228,2,2,0,1,0
5,247,247,65,65,0,1,0
4,338,338,15,15,0,1,0
7,394,394,23,23,0,1,0
3,395,395,4,4,0,1,0
12,412,412,64,64,0,1,0
1,439,439,1,1,0,1,0
13,465,465,54,12,42,4,3
0,497,497,32,32,0,1,0

9,100,100,16,16,0,1,0
8,136,136,15,15,0,1,0
11,142,142,24,24,0,1,0
4,166,166,25,13,12,2,1
10,244,244,9,9,0,1,0
3,245,245,24,7,17,2,1
13,247,247,13,1,12,2,1
6,258,258,1,1,0,1,0
0,265,265,45,45,0,1,0
1,311,311,12,2,10,2,1
2,398,398,23,23,0,1,0
7,403,403,42,23,19,2,1
5,450,450,83,50,33,3,2
12,457,457,42,42,0,1,0

9,111,111,11,1,10,3,2
15,122,122,10,10,0,1,0
0,124,124,1,1,0,1,0
8,144,144,27,27,0,1,0
10,248,248,16,16,0,1,0
14,320,320,62,53,9,4,3
5,340,340,6,6,0,1,0
4,379,379,45,25,20,2,1
1,384,384,21,21,0,1,0
12,393,393,24,24,0,1,0
6,397,397,19,19,0,1,0
3,402,402,21,8,13,2,1
11,408,408,38,38,0,1,0
16,429,429,28,28,0,1,0
13,448,448,68,34,34,3,2
7,459,459,13,13,0,1,0
2,499,499,43,29,14,3,2

2,100,100,2,2,0,1,0
20,111,111,10,4,6,3,2
5,118,118,8,8,0,1,0
16,124,124,40,40,0,1,0
3,132,132,9,9,0,1,0
10,145,145,4,4,0,1,0
19,189,189,42,32,10,3,2
14,191,191,3,3,0,1,0
13,198,198,4,4,0,1,0
18,231,231,10,1,9,4,3
15,245,245,5,5,0,1,0
1,257,257,1,1,0,1,0
21,267,267,3,3,0,1,0
11,270,270,26,26,0,1,0
8,279,279,3,3,0,1,0
0,302,302,12,7,5,2,1
4,360,360,8,4,4,2,1
9,388,388,16,16,0,1,0
12,397,397,21,9,12,4,3
6,427,427,70,23,47,4,3
7,464,464,23,23,0,1,0
17,480,480,4,4,0,1,0

9,119,119,24,24,0,1,0
4,143,143,10,1,9,2,1
1,150,150,38,2,36,4,3
0,203,203,25,25,0,1,0
10,287,287,57,3,54,4,3
5,313,313,32,2,30,4,3
6,354,354,4,4,0,1,0
3,359,359,73,73,0,1,0
2,402,402,22,22,0,1,0
11,418,418,18,18,0,1,0
8,487,487,54,48,6,3,2
7,500,500,24,2,22,3,2

1,117,117,1,1,0,1,0
8,122,122,4,4,0,1,0
6,130,130,12,12,0,1,0
0,144,144,11,11,0,1,0
14,163,163,19,3,16,2,1
12,172,172,24,24,0,1,0
3,201,201,49,49,0,1,0
11,241,241,47,47,0,1,0
13,280,280,1,1,0,1,0
4,281,281,29,29,0,1,0
9,294,294,43,19,24,4,3
2,403,403,2,2,0,1,0
15,428,428,40,40,0,1,0
7,437,437,24,7,17,2,1
5,495,495,43,43,0,1,0
10,495,495,9,2,7,2,1

5,147,147,15,12,3,2,1
7,150,150,14,14,0,1,0
6,166,166,1,1,0,1,0
10,166,166,8,8,0,1,0
13,178,178,1,1,0,1,0
9,182,182,1,1,0,1,0
3,185,185,1,1,0,1,0
12,205,205,23,23,0,1,0
17,249,249,6,6,0,1,0
1,329,329,43,23,20,2,1
11,343,343,48,30,18,4,3
2,393,393,20,1,19,4,3
16,447,447,105,98,7,2,1
4,453,453,2,2,0,1,0
0,456,456,22,22,0,1,0
15,490,490,58,58,0,1,0
14,498,498,38,12,26,2,1
8,499,499,104,82,22,3,2

1,100,100,1,1,0,1,0
5,114,114,10,10,0,1,0
7,185,185,5,5,0,1,0
18,223,223,1,1,0,1,0
6,233,233,16,13,3,2,1
15,243,243,17,17,0,1,0
2,245,245,17,9,8,2,1
14,248,248,52,52,0,1,0
3,278,278,1,1,0,1,0
12,291,291,37,37,0,1,0
11,321,321,7,1,6,2,1
8,379,379,6,6,0,1,0
13,386,386,4,4,0,1,0
9,395,395,13,13,0,1,0
0,408,408,6,6,0,1,0
10,412,412,63,63,0,1,0
17,432,432,33,11,22,3,2
4,464,464,92,92,0,1,0
16,497,497,106,106,0,1,0

16,150,150,1,1,0,1,0
5,163,163,18,18,0,1,0
10,167,167,15,10,5,2,1
14,191,191,19,19,0,1,0
0,198,198,16,7,9,2,1
3,207,207,1,1,0,1,0
7,274,274,7,7,0,1,0
12,280,280,24,24,0,1,0
4,288,288,5,5,0,1,0
2,304,304,11,5,6,3,2
17,308,308,42,4,38,2,1
13,321,321,69,49,20,2,1
8,327,327,24,24,0,1,0
1,382,382,71,1,70,3,2
15,410,410,28,18,10,3,2
6,445,445,2,2,0,1,0
9,456,456,35,9,26,2,1
11,475,475,50,50,0,1,0

11,105,105,1,1,0,1,0
3,109,109,1,1,0,1,0
10,123,123,23,3,20,2,1
12,125,125,6,3,3,2,1
13,145,145,4,4,0,1,0
20,155,155,26,8,18,3,2
9,157,157,9,6,3,2,1
22,159,159,6,6,0,1,0
4,165,165,1,1,0,1,0
15,187,187,6,3,3,2,1
2,193,193,1,1,0,1,0
1,196,196,13,13,0,1,0
21,207,207,57,2,55,4,3
19,211,211,1,1,0,1,0
14,229,229,2,2,0,1,0
6,262,262,13,13,0,1,0
18,271,271,17,17,0,1,0
16,318,318,23,23,0,1,0
17,337,337,34,34,0,1,0
0,418,418,45,45,0,1,0
5,444,444,12,12,0,1,0
8,461,461,8,2,6,2,1
7,476,476,22,22,0,1,0

4,136,136,4,4,0,1,0
9,179,179,14,4,10,2,1
2,197,197,48,24,24,3,2
6,220,220,56,6,50,2,1
1,235,235,51,51,0,1,0
5,262,262,38,17,21,3,2
0,292,292,49,49,0,1,0
8,293,293,26,26,0,1,0
7,302,302,28,3,25,4,3
3,304,304,22,11,11,2,1
10,381,381,9,1,8,3,2

0,100,100,8,2,6,3,2
2,113,113,1,1,0,1,0
9,155,155,6,6,0,1,0
1,159,159,21,21,0,1,0
7,184,184,5,5,0,1,0
3,186,186,48,48,0,1,0
5,201,201,32,32,0,1,0
11,231,231,51,7,44,3,2
4,243,243,54,54,0,1,0
10,253,253,1,1,0,1,0
6,265,265,51,33,18,4,3
8,366,366,27,18,9,4,3

6,122,122,12,2,10,3,2
2,127,127,2,2,0,1,0
0,129,129,15,15,0,1,0
8,159,159,5,2,3,2,1
10,181,181,46,4,42,4,3
3,189,189,5,5,0,1,0
14,211,211,7,7,0,1,0
13,251,251,28,16,12,4,3
11,261,261,18,2,16,2,1
4,315,315,64,64,0,1,0
12,319,319,21,9,12,4,3
1,341,341,2,2,0,1,0
5,378,378,2,2,0,1,0
9,390,390,58,58,0,1,0
7,398,398,92,48,44,2,1

10,112,112,6,6,0,1,0
9,162,162,12,12,0,1,0
14,174,174,21,2,19,2,1
1,217,217,1,1,0,1,0
6,266,266,18,14,4,2,1
15,274,274,72,46,26,3,2
7,357,357,11,11,0,1,0
2,367,367,16,4,12,2,1
12,372,372,8,8,0,1,0
11,378,378,62,14,48,3,2
17,381,381,2,2,0,1,0
5,386,386,45,45,0,1,0
0,407,407,16,10,6,3,2
3,408,408,56,56,0,1,0
16,409,409,55,7,48,3,2
8,454,454,42,9,33,3,2
13,459,459,1,1,0,1,0
4,499,499,22,13,9,2,1

14,115,115,9,9,0,1,0
4,118,118,3,3,0,1,0
5,123,123,4,1,3,2,1
1,131,131,20,20,0,1,0
13,196,196,6,6,0,1,0
9,216,216,6,1,5,2,1
3,217,217,25,17,8,2,1
11,225,225,1,1,0,1,0
2,231,231,40,40,0,1,0
0,262,262,27,13,14,4,3
8,281,281,8,8,0,1,0
12,327,327,11,5,6,3,2
16,378,378,64,49,15,2,1
15,384,384,104,92,12,4,3
10,394,394,49,49,0,1,0
6,417,417,1,1,0,1,0
7,485,485,21,21,0,1,0

8,102,102,10,10,0,1,0
10,106,106,16,16,0,1,0
3,131,131,25,25,0,1,0
1,187,187,6,3,3,2,1
9,205,205,3,3,0,1,0
11,221,221,31,31,0,1,0
5,230,230,9,4,5,2,1
16,239,239,38,6,32,4,3
14,273,273,28,28,0,1,0
15,288,288,22,22,0,1,0
7,319,319,4,4,0,1,0
2,328,328,49,49,0,1,0
6,415,415,1,1,0,1,0
13,444,444,22,22,0,1,0
12,447,447,18,18,0,1,0
4,464,464,3,3,0,1,0
0,469,469,5,5,0,1,0
17,483,483,68,68,0,1,0

7,104,104,1,1,0,1,0
8,162,162,1,1,0,1,0
1,178,178,18,8,10,2,1
0,208,208,1,1,0,1,0
9,211,211,35,35,0,1,0
17,248,248,4,1,3,2,1
15,251,251,13,1,12,2,1
2,254,254,20,20,0,1,0
4,283,283,28,28,0,1,0
14,320,320,23,23,0,1,0
6,323,323,34,6,28,2,1
10,329,329,2,2,0,1,0
12,337,337,2,2,0,1,0
13,369,369,19,19,0,1,0
5,409,409,29,11,18,3,2
16,424,424,27,27,0,1,0
3,474,474,25,4,21,4,3
11,480,480,216,126,90,4,3

1,116,116,14,5,9,4,3
3,127,127,1,1,0,1,0
0,132,132,3,3,0,1,0
6,134,134,8,2,6,2,1
8,189,189,24,24,0,1,0
13,213,213,6,3,3,2,1
4,228,228,48,8,40,3,2
12,252,252,23,23,0,1,0
7,293,293,41,41,0,1,0
10,297,297,54,54,0,1,0
9,309,309,21,9,12,4,3
2,391,391,98,98,0,1,0
11,398,398,29,29,0,1,0
5,439,439,14,14,0,1,0

0,102,102,1,1,0,1,0
8,117,117,21,3,18,4,3
10,118,118,12,12,0,1,0
1,143,143,9,9,0,1,0
13,165,165,16,11,5,2,1
2,175,175,1,1,0,1,0
5,191,191,36,32,4,2,1
11,193,193,24,24,0,1,0
4,211,211,43,43,0,1,0
9,324,324,13,13,0,1,0
12,376,376,38,7,31,2,1
6,394,394,24,1,23,2,1
7,405,405,39,39,0,1,0
3,460,460,34,15,19,2,1
14,494,494,35,12,23,4,3

8,144,144,48,48,0,1,0
3,165,165,1,1,0,1,0
10,178,178,16,8,8,2,1
16,231,231,78,78,0,1,0
0,237,237,17,5,12,2,1
7,237,237,7,2,5,2,1
18,239,239,5,5,0,1,0
5,265,265,2,2,0,1,0
9,289,289,1,1,0,1,0
12,367,367,18,4,14,2,1
4,394,394,20,20,0,1,0
2,396,396,15,9,6,3,2
11,399,399,10,10,0,1,0
14,405,405,34,8,26,4,3
13,433,433,34,34,0,1,0
15,456,456,28,20,8,2,1
6,461,461,5,1,4,2,1
1,466,466,16,16,0,1,0
17,467,467,37,27,10,2,1

2,109,109,3,3,0,1,0
11,141,141,12,12,0,1,0
12,160,160,23,23,0,1,0
0,185,185,1,1,0,1,0
9,196,196,21,6,15,4,3
8,256,256,45,45,0,1,0
6,291,291,21,21,0,1,0
4,302,302,21,21,0,1,0
7,310,310,25,25,0,1,0
1,319,319,24,24,0,1,0
13,330,330,12,12,0,1,0
10,343,343,56,56,0,1,0
5,350,350,6,6,0,1,0
14,388,388,3,3,0,1,0
3,391,391,139,80,59,4,3

1,110,110,3,3,0,1,0
7,117,117,7,1,6,2,1
0,159,159,4,4,0,1,0
15,172,172,26,26,0,1,0
14,222,222,31,12,19,2,1
3,232,232,24,16,8,3,2
2,243,243,1,1,0,1,0
5,247,247,3,3,0,1,0
20,296,296,18,18,0,1,0
6,302,302,10,2,8,2,1
4,308,308,8,8,0,1,0
17,309,309,40,40,0,1,0
12,314,314,81,81,0,1,0
19,325,325,13,6,7,2,1
9,335,335,1,1,0,1,0
8,356,356,1,1,0,1,0
11,362,362,26,26,0,1,0
16,364,364,19,6,13,2,1
10,389,389,22,22,0,1,0
18,463,463,63,63,0,1,0
13,480,480,9,9,0,1,0

2,125,125,4,4,0,1,0
1,158,158,17,11,6,2,1
6,195,195,12,4,8,3,2
4,217,217,16,10,6,2,1
3,228,228,74,4,70,3,2
5,236,236,14,14,0,1,0
0,330,330,54,40,14,3,2
8,341,341,90,34,56,3,2
7,367,367,42,27,15,4,3
11,383,383,4,4,0,1,0
9,454,454,40,40,0,1,0
10,500,500,58,51,7,2,1

1,133,133,1,1,0,1,0
3,152,152,1,1,0,1,0
7,184,184,11,1,10,3,2
0,265,265,8,8,0,1,0
5,274,274,19,1,18,4,3
12,279,279,45,15,30,3,2
4,299,299,28,7,21,4,3
14,307,307,29,7,22,2,1
9,326,326,45,29,16,2,1
8,330,330,14,14,0,1,0
6,377,377,16,12,4,2,1
16,394,394,27,27,0,1,0
13,411,411,17,17,0,1,0
2,423,423,89,1,88,3,2
15,474,474,63,63,0,1,0
10,477,477,5,5,0,1,0
11,487,487,96,14,82,4,3

2,122,122,5,5,0,1,0
9,146,146,31,16,15,2,1
6,166,166,9,3,6,2,1
3,287,287,80,11,69,4,3
5,317,317,7,7,0,1,0
10,320,320,41,19,22,3,2
0,353,353,60,4,56,4,3
8,399,399,7,7,0,1,0
7,410,410,42,42,0,1,0
1,435,435,92,43,49,2,1
4,467,467,84,84,0,1,0

12,142,142,10,1,9,2,1
6,180,180,2,2,0,1,0
15,185,185,7,4,3,2,1
1,189,189,55,25,30,2,1
14,300,300,8,8,0,1,0
4,302,302,12,6,6,3,2
0,305,305,11,1,10,3,2
3,307,307,66,49,17,2,1
10,310,310,36,36,0,1,0
11,353,353,12,12,0,1,0
13,358,358,15,15,0,1,0
7,391,391,15,15,0,1,0
8,419,419,12,5,7,2,1
5,421,421,14,14,0,1,0
2,483,483,4,4,0,1,0
9,483,483,189,120,69,4,3

2,113,113,8,1,7,3,2
0,117,117,8,2,6,2,1
11,133,133,9,9,0,1,0
12,150,150,9,9,0,1,0
8,190,190,13,3,10,2,1
3,207,207,6,1,5,2,1
9,236,236,15,1,14,2,1
1,266,266,46,12,34,3,2
13,365,365,85,21,64,3,2
10,383,383,3,3,0,1,0
5,391,391,14,14,0,1,0
4,393,393,85,69,16,4,3
14,433,433,97,46,51,3,2
7,475,475,42,15,27,2,1
6,479,479,9,9,0,1,0

7,115,115,22,22,0,1,0
9,139,139,1,1,0,1,0
0,141,141,7,7,0,1,0
11,193,193,19,5,14,3,2
4,211,211,40,23,17,2,1
1,234,234,50,50,0,1,0
6,234,234,28,28,0,1,0
10,308,308,18,18,0,1,0
5,339,339,27,3,24,4,3
8,367,367,61,61,0,1,0
2,440,440,71,33,38,4,3
3,500,500,43,43,0,1,0

12,103,103,1,1,0,1,0
8,138,138,2,2,0,1,0
2,170,170,24,5,19,2,1
5,208,208,32,32,0,1,0
6,238,238,4,4,0,1,0
13,247,247,7,3,4,2,1
14,265,265,19,11,8,2,1
9,313,313,79,79,0,1,0
4,355,355,22,22,0,1,0
15,416,416,87,54,33,2,1
3,426,426,73,2,71,4,3
1,461,461,25,25,0,1,0
10,462,462,9,9,0,1,0
0,472,472,20,3,17,3,2
7,477,477,21,21,0,1,0
11,495,495,59,59,0,1,0

14,164,164,27,6,21,2,1
0,195,195,65,65,0,1,0
13,214,214,12,4,8,2,1
12,252,252,26,26,0,1,0
8,269,269,3,3,0,1,0
9,270,270,48,48,0,1,0
10,278,278,11,2,9,4,3
6,323,323,1,1,0,1,0
11,366,366,59,7,52,3,2
1,369,369,6,6,0,1,0
2,389,389,78,33,45,4,3
7,390,390,28,20,8,3,2
3,450,450,25,1,24,2,1
5,458,458,1,1,0,1,0
4,488,488,9,3,6,2,1

12,100,100,1,1,0,1,0
2,168,168,2,2,0,1,0
7,192,192,13,1,12,4,3
0,215,215,18,18,0,1,0
11,217,217,51,51,0,1,0
6,227,227,28,14,14,2,1
15,233,233,1,1,0,1,0
10,252,252,41,15,26,3,2
13,270,270,3,3,0,1,0
1,298,298,2,2,0,1,0
3,353,353,14,5,9,2,1
5,417,417,94,94,0,1,0
8,459,459,17,17,0,1,0
9,464,464,67,34,33,4,3
14,464,464,70,18,52,3,2
4,485,485,51,51,0,1,0

0,109,109,1,1,0,1,0
10,138,138,1,1,0,1,0
15,140,140,4,4,0,1,0
11,201,201,11,11,0,1,0
9,202,202,30,24,6,2,1
13,205,205,47,10,37,2,1
3,215,215,26,26,0,1,0
4,242,242,9,9,0,1,0
6,255,255,20,16,4,2,1
14,268,268,6,6,0,1,0
7,288,288,6,6,0,1,0
1,302,302,3,3,0,1,0
2,363,363,53,53,0,1,0
17,367,367,35,35,0,1,0
5,370,370,18,18,0,1,0
8,378,378,30,10,20,3,2
12,386,386,43,20,23,4,3
16,432,432,74,74,0,1,0

12,108,108,24,6,18,3,2
4,132,132,9,1,8,2,1
3,143,143,7,7,0,1,0
0,150,150,40,13,27,4,3
6,151,151,7,3,4,2,1
2,293,293,2,2,0,1,0
11,319,319,51,21,30,4,3
7,323,323,19,13,6,2,1
5,359,359,48,43,5,2,1
9,388,388,41,19,22,2,1
8,440,440,51,51,0,1,0
10,464,464,5,5,0,1,0
1,489,489,86,86,0,1,0

11,104,104,1,1,0,1,0
14,143,143,9,9,0,1,0
3,155,155,3,3,0,1,0
12,166,166,1,1,0,1,0
10,171,171,16,16,0,1,0
7,192,192,22,19,3,2,1
9,201,201,21,21,0,1,0
4,231,231,23,23,0,1,0
2,248,248,19,11,8,3,2
8,303,303,10,10,0,1,0
1,312,312,15,10,5,2,1
13,348,348,26,12,14,2,1
6,365,365,7,7,0,1,0
18,390,390,68,25,43,3,2
5,395,395,23,5,18,2,1
0,430,430,12,1,11,2,1
16,434,434,64,3,61,4,3
17,435,435,83,74,9,4,3
15,449,449,27,27,0,1,0

8,113,113,3,3,0,1,0
6,132,132,5,5,0,1,0
0,251,251,10,4,6,2,1
5,389,389,86,86,0,1,0
7,405,405,56,56,0,1,0
9,422,422,43,7,36,3,2
4,441,441,3,3,0,1,0
3,465,465,84,84,0,1,0
1,482,482,248,194,54,3,2
2,483,483,71,29,42,3,2

1,107,107,2,2,0,1,0
0,163,163,2,2,0,1,0
11,212,212,2,2,0,1,0
2,228,228,1,1,0,1,0
14,242,242,56,7,49,2,1
5,252,252,1,1,0,1,0
10,257,257,42,10,32,2,1
4,266,266,19,9,10,2,1
7,357,357,78,78,0,1,0
12,367,367,27,27,0,1,0
8,385,385,10,4,6,3,2
9,392,392,53,53,0,1,0
3,444,444,122,122,0,1,0
13,448,448,33,33,0,1,0
15,476,476,12,12,0,1,0
6,480,480,34,24,10,2,1

10,145,145,19,6,13,2,1
1,180,180,3,3,0,1,0
14,197,197,3,3,0,1,0
4,198,198,42,12,30,2,1
9,212,212,11,11,0,1,0
0,257,257,33,33,0,1,0
3,335,335,19,16,3,2,1
8,338,338,6,6,0,1,0
11,348,348,6,6,0,1,0
13,353,353,38,14,24,2,1
7,375,375,35,35,0,1,0
5,378,378,10,6,4,2,1
12,383,383,143,107,36,3,2
2,384,384,51,24,27,4,3
6,386,386,13,9,4,2,1

0,167,167,18,5,13,3,2
9,183,183,33,33,0,1,0
11,201,201,22,22,0,1,0
14,212,212,3,3,0,1,0
6,242,242,1,1,0,1,0
5,302,302,6,6,0,1,0
8,325,325,32,2,30,3,2
1,330,330,13,13,0,1,0
10,363,363,26,9,17,2,1
12,436,436,15,15,0,1,0
3,442,442,16,4,12,4,3
13,486,486,99,13,86,3,2
7,493,493,53,53,0,1,0
2,496,496,147,59,88,3,2
4,499,499,45,27,18,3,2

5,134,134,24,24,0,1,0
8,218,218,27,27,0,1,0
6,236,236,43,9,34,3,2
1,260,260,15,15,0,1,0
7,279,279,26,26,0,1,0
3,293,293,1,1,0,1,0
9,344,344,38,17,21,4,3
2,349,349,97,3,94,4,3
4,351,351,15,5,10,2,1
11,402,402,4,4,0,1,0
10,425,425,6,6,0,1,0
0,482,482,154,129,25,3,2

2,107,107,1,1,0,1,0
5,176,176,4,4,0,1,0
15,199,199,1,1,0,1,0
6,221,221,10,10,0,1,0
16,233,233,31,20,11,2,1
14,237,237,13,13,0,1,0
1,245,245,3,3,0,1,0
13,263,263,20,20,0,1,0
4,285,285,49,49,0,1,0
8,294,294,1,1,0,1,0
3,324,324,74,36,38,3,2
12,365,365,79,49,30,2,1
7,370,370,7,7,0,1,0
10,372,372,62,62,0,1,0
9,422,422,7,7,0,1,0
11,432,432,83,51,32,4,3
0,466,466,3,3,0,1,0
17,468,468,18,2,16,3,2

14,115,115,15,15,0,1,0
5,139,139,36,36,0,1,0
0,156,156,3,3,0,1,0
13,180,180,28,16,12,2,1
17,193,193,5,5,0,1,0
6,223,223,4,4,0,1,0
11,225,225,43,43,0,1,0
12,244,244,12,1,11,2,1
9,246,246,10,10,0,1,0
8,247,247,8,8,0,1,0
15,254,254,32,32,0,1,0
10,261,261,13,13,0,1,0
1,264,264,6,2,4,2,1
7,298,298,39,17,22,2,1
4,374,374,8,8,0,1,0
3,386,386,23,23,0,1,0
2,421,421,20,20,0,1,0
16,456,456,17,17,0,1,0

9,104,104,17,3,14,2,1
1,146,146,15,15,0,1,0
5,158,158,18,18,0,1,0
11,168,168,32,5,27,2,1
7,191,191,36,22,14,2,1
8,209,209,4,4,0,1,0
12,212,212,7,4,3,2,1
6,266,266,28,28,0,1,0
0,276,276,35,35,0,1,0
3,390,390,42,42,0,1,0
2,414,414,26,10,16,3,2
4,453,453,87,57,30,3,2
10,463,463,5,5,0,1,0

15,138,138,13,13,0,1,0
5,152,152,6,2,4,2,1
6,161,161,9,9,0,1,0
10,184,184,14,14,0,1,0
9,284,284,34,34,0,1,0
14,322,322,25,18,7,2,1
3,335,335,14,14,0,1,0
1,337,337,22,22,0,1,0
7,365,365,29,20,9,4,3
16,378,378,7,7,0,1,0
11,391,391,123,53,70,3,2
13,399,399,35,13,22,3,2
17,434,434,36,10,26,3,2
12,436,436,16,16,0,1,0
4,441,441,9,9,0,1,0
2,470,470,19,3,16,2,1
8,474,474,8,3,5,2,1
0,482,482,72,60,12,3,2

12,110,110,5,2,3,2,1
1,128,128,26,26,0,1,0
8,153,153,16,4,12,3,2
14,235,235,40,40,0,1,0
11,237,237,19,19,0,1,0
3,303,303,53,53,0,1,0
5,305,305,6,6,0,1,0
4,307,307,25,9,16,3,2
6,314,314,15,11,4,2,1
15,349,349,42,42,0,1,0
7,352,352,13,13,0,1,0
10,392,392,48,15,33,2,1
0,411,411,8,8,0,1,0
9,452,452,53,53,0,1,0
2,491,491,6,6,0,1,0
13,500,500,27,17,10,2,1

6,115,115,25,25,0,1,0
1,138,138,13,13,0,1,0
11,148,148,23,18,5,2,1
0,169,169,26,14,12,3,2
4,204,204,71,17,54,3,2
2,225,225,21,11,10,3,2
3,254,254,3,3,0,1,0
8,275,275,5,1,4,2,1
10,397,397,47,47,0,1,0
9,424,424,30,30,0,1,0
7,431,431,4,4,0,1,0
5,472,472,59,59,0,1,0

8,100,100,8,8,0,1,0
11,129,129,16,6,10,3,2
7,149,149,1,1,0,1,0
5,205,205,53,19,34,2,1
0,222,222,43,43,0,1,0
10,224,224,28,28,0,1,0
1,276,276,2,2,0,1,0
13,281,281,46,5,41,2,1
12,314,314,38,30,8,2,1
14,314,314,31,31,0,1,0
3,341,341,19,11,8,3,2
4,387,387,9,9,0,1,0
15,439,439,24,24,0,1,0
6,466,466,22,22,0,1,0
2,483,483,16,2,14,2,1
9,497,497,16,16,0,1,0

14,112,112,8,8,0,1,0
5,185,185,16,16,0,1,0
10,202,202,4,4,0,1,0
0,205,205,46,29,17,2,1
6,250,250,1,1,0,1,0
12,264,264,6,3,3,2,1
3,280,280,31,22,9,4,3
8,284,284,102,3,99,4,3
1,290,290,11,8,3,2,1
4,291,291,2,2,0,1,0
7,332,332,16,16,0,1,0
13,339,339,36,13,23,2,1
2,350,350,64,64,0,1,0
11,358,358,39,39,0,1,0
9,497,497,14,2,12,2,1

14,182,182,14,14,0,1,0
16,182,182,20,2,18,3,2
8,186,186,6,6,0,1,0
0,189,189,25,7,18,3,2
7,220,220,2,2,0,1,0
4,228,228,11,11,0,1,0
17,238,238,15,15,0,1,0
15,244,244,48,48,0,1,0
1,245,245,14,5,9,4,3
9,286,286,7,7,0,1,0
2,300,300,21,21,0,1,0
13,309,309,27,27,0,1,0
6,340,340,7,4,3,2,1
12,353,353,36,23,13,2,1
10,383,383,56,56,0,1,0
5,434,434,54,33,21,2,1
11,478,478,39,18,21,4,3
3,498,498,18,6,12,2,1

6,109,109,1,1,0,1,0
1,175,175,2,2,0,1,0
17,209,209,38,38,0,1,0
11,241,241,10,4,6,2,1
15,245,245,12,6,6,2,1
12,273,273,4,1,3,2,1
18,317,317,12,2,10,3,2
14,328,328,28,28,0,1,0
10,331,331,17,1,16,2,1
0,344,344,8,4,4,2,1
16,349,349,110,110,0,1,0
3,355,355,16,16,0,1,0
5,362,362,2,2,0,1,0
8,372,372,8,8,0,1,0
9,410,410,88,88,0,1,0
2,431,431,8,5,3,2,1
4,439,439,95,50,45,4,3
7,447,447,19,19,0,1,0
13,459,459,13,13,0,1,0

2,128,128,19,6,13,4,3
15,155,155,4,4,0,1,0
0,164,164,4,4,0,1,0
18,165,165,11,1,10,2,1
9,178,178,7,7,0,1,0
11,219,219,18,18,0,1,0
4,219,219,21,4,17,2,1
3,220,220,8,1,7,2,1
16,228,228,4,1,3,2,1
8,246,246,2,2,0,1,0
17,276,276,23,5,18,3,2
5,277,277,4,4,0,1,0
7,306,306,26,18,8,3,2
12,320,320,44,44,0,1,0
14,342,342,40,19,21,4,3
10,363,363,38,18,20,3,2
6,364,364,1,1,0,1,0
1,372,372,23,23,0,1,0
13,498,498,132,45,87,4,3

4,114,114,7,7,0,1,0
10,126,126,16,16,0,1,0
5,201,201,30,10,20,2,1
9,228,228,5,5,0,1,0
6,246,246,63,25,38,3,2
12,247,247,94,94,0,1,0
11,259,259,11,11,0,1,0
8,287,287,18,2,16,3,2
7,324,324,5,5,0,1,0
1,351,351,23,3,20,2,1
13,352,352,23,23,0,1,0
3,399,399,10,10,0,1,0
0,460,460,26,26,0,1,0
2,468,468,42,42,0,1,0

4,125,125,14,14,0,1,0
8,179,179,1,1,0,1,0
10,179,179,7,7,0,1,0
14,190,190,4,1,3,2,1
15,209,209,21,21,0,1,0
11,252,252,16,7,9,2,1
13,268,268,24,24,0,1,0
0,306,306,20,8,12,3,2
1,326,326,13,13,0,1,0
5,334,334,64,31,33,4,3
2,350,350,23,23,0,1,0
3,397,397,4,1,3,2,1
12,411,411,154,49,105,4,3
7,421,421,63,63,0,1,0
9,468,468,11,11,0,1,0
6,478,478,30,30,0,1,0

5,106,106,1,1,0,1,0
10,109,109,4,4,0,1,0
9,152,152,12,12,0,1,0
2,209,209,26,7,19,4,3
11,220,220,3,3,0,1,0
4,254,254,4,4,0,1,0
0,275,275,3,3,0,1,0
12,296,296,54,54,0,1,0
6,328,328,40,21,19,2,1
13,337,337,34,34,0,1,0
3,338,338,21,21,0,1,0
14,371,371,109,109,0,1,0
8,452,452,112,112,0,1,0
1,455,455,5,5,0,1,0
15,464,464,5,5,0,1,0
7,498,498,49,13,36,3,2

0,169,169,24,6,18,2,1
6,190,190,7,7,0,1,0
4,196,196,23,23,0,1,0
7,197,197,16,8,8,3,2
9,289,289,9,9,0,1,0
3,372,372,113,48,65,4,3
8,388,388,82,7,75,4,3
10,410,410,39,39,0,1,0
11,417,417,45,30,15,4,3
5,473,473,71,17,54,4,3
1,476,476,56,56,0,1,0
2,483,483,11,3,8,3,2

1,116,116,34,2,32,3,2
9,139,139,6,6,0,1,0
3,176,176,8,8,0,1,0
2,177,177,4,1,3,2,1
8,206,206,16,6,10,3,2
13,320,320,52,52,0,1,0
4,330,330,5,5,0,1,0
5,333,333,22,19,3,2,1
14,338,338,5,5,0,1,0
7,342,342,7,7,0,1,0
6,360,360,6,6,0,1,0
11,367,367,87,87,0,1,0
15,380,380,3,3,0,1,0
0,394,394,40,7,33,3,2
16,473,473,19,19,0,1,0
12,485,485,6,2,4,2,1
10,488,488,115,103,12,4,3

8,109,109,18,18,0,1,0
2,152,152,15,1,14,2,1
4,199,199,29,11,18,2,1
3,221,221,19,1,18,2,1
11,271,271,17,17,0,1,0
5,278,278,23,23,0,1,0
10,324,324,21,21,0,1,0
1,382,382,10,7,3,2,1
7,386,386,67,67,0,1,0
0,416,416,144,144,0,1,0
9,435,435,31,12,19,2,1
6,494,494,47,4,43,4,3

15,116,116,16,16,0,1,0
12,133,133,5,1,4,2,1
4,134,134,3,3,0,1,0
7,136,136,30,1,29,4,3
11,168,168,13,1,12,4,3
2,170,170,2,2,0,1,0
0,186,186,3,3,0,1,0
10,192,192,40,18,22,2,1
13,212,212,41,19,22,3,2
14,212,212,11,11,0,1,0
9,277,277,4,1,3,2,1
1,338,338,42,22,20,3,2
3,413,413,6,6,0,1,0
8,417,417,1,1,0,1,0
5,447,447,86,86,0,1,0
6,500,500,48,17,31,2,1

5,113,113,6,6,0,1,0
4,156,156,29,29,0,1,0
0,177,177,92,78,14,2,1
1,199,199,12,6,6,2,1
9,218,218,28,22,6,3,2
3,236,236,26,17,9,2,1
2,300,300,4,4,0,1,0
8,344,344,67,28,39,4,3
7,372,372,19,4,15,4,3
10,405,405,6,6,0,1,0
6,489,489,43,43,0,1,0

4,151,151,37,37,0,1,0
6,172,172,13,8,5,2,1
5,204,204,17,17,0,1,0
9,211,211,20,2,18,3,2
1,221,221,17,17,0,1,0
3,291,291,46,7,39,2,1
10,400,400,84,84,0,1,0
2,409,409,48,45,3,2,1
12,409,409,71,42,29,2,1
7,421,421,2,2,0,1,0
11,432,432,41,41,0,1,0
0,437,437,9,9,0,1,0
8,473,473,26,26,0,1,0

6,103,103,1,1,0,1,0
2,122,122,1,1,0,1,0
14,123,123,19,19,0,1,0
3,169,169,8,4,4,2,1
9,173,173,3,3,0,1,0
12,182,182,8,2,6,3,2
4,198,198,31,16,15,2,1
16,239,239,3,3,0,1,0
1,265,265,2,2,0,1,0
5,279,279,19,3,16,3,2
7,298,298,23,1,22,2,1
8,318,318,22,1,21,4,3
17,324,324,14,4,10,2,1
15,400,400,81,81,0,1,0
13,401,401,39,2,37,2,1
10,412,412,75,17,58,3,2
0,429,429,25,5,20,2,1
11,499,499,78,78,0,1,0

11,146,146,24,24,0,1,0
5,158,158,27,27,0,1,0
10,173,173,37,1,36,4,3
2,175,175,1,1,0,1,0
7,205,205,22,12,10,3,2
1,219,219,8,8,0,1,0
3,226,226,50,16,34,2,1
6,244,244,14,8,6,2,1
9,268,268,4,4,0,1,0
13,303,303,22,7,15,2,1
4,338,338,24,9,15,4,3
15,347,347,7,1,6,3,2
14,399,399,71,21,50,3,2
8,418,418,8,8,0,1,0
12,474,474,26,26,0,1,0
0,483,483,6,3,3,2,1

10,111,111,2,2,0,1,0
2,140,140,1,1,0,1,0
14,166,166,37,37,0,1,0
11,170,170,11,3,8,2,1
3,207,207,3,3,0,1,0
8,248,248,12,12,0,1,0
13,360,360,60,48,12,4,3
5,427,427,20,2,18,4,3
12,437,437,41,41,0,1,0
6,440,440,23,8,15,3,2
9,444,444,46,22,24,2,1
1,452,452,37,7,30,3,2
7,461,461,118,7,111,4,3
0,476,476,71,42,29,4,3
4,483,483,45,27,18,4,3

0,183,183,19,19,0,1,0
7,212,212,97,43,54,3,2
6,231,231,10,5,5,2,1
11,239,239,6,6,0,1,0
9,245,245,3,3,0,1,0
8,326,326,13,10,3,2,1
2,336,336,91,9,82,4,3
1,375,375,22,12,10,2,1
5,404,404,42,42,0,1,0
10,434,434,14,2,12,4,3
4,465,465,48,48,0,1,0
3,489,489,80,40,40,2,1

13,135,135,13,9,4,2,1
6,148,148,16,16,0,1,0
14,189,189,45,45,0,1,0
3,203,203,27,27,0,1,0
15,216,216,3,3,0,1,0
2,222,222,16,6,10,2,1
9,224,224,3,3,0,1,0
8,231,231,6,2,4,2,1
1,239,239,15,15,0,1,0
0,254,254,17,17,0,1,0
5,312,312,15,2,13,2,1
7,312,312,9,9,0,1,0
10,362,362,6,6,0,1,0
4,367,367,57,5,52,3,2
12,372,372,21,21,0,1,0
11,391,391,109,48,61,4,3

7,136,136,8,8,0,1,0
1,199,199,19,13,6,3,2
4,230,230,29,29,0,1,0
2,263,263,64,64,0,1,0
5,268,268,14,2,12,3,2
0,303,303,8,8,0,1,0
10,344,344,9,9,0,1,0
3,347,347,73,49,24,4,3
9,356,356,59,34,25,2,1
8,403,403,25,25,0,1,0
6,430,430,22,10,12,2,1
11,500,500,150,51,99,4,3

8,103,103,4,4,0,1,0
11,140,140,3,3,0,1,0
4,219,219,84,84,0,1,0
9,309,309,10,10,0,1,0
5,310,310,9,3,6,3,2
3,312,312,52,52,0,1,0
7,329,329,27,17,10,3,2
0,339,339,14,14,0,1,0
1,415,415,13,13,0,1,0
2,436,436,35,35,0,1,0
10,456,456,187,107,80,3,2
6,466,466,47,47,0,1,0

15,128,128,2,2,0,1,0
5,149,149,17,17,0,1,0
12,160,160,3,3,0,1,0
16,189,189,23,23,0,1,0
13,196,196,4,4,0,1,0
3,205,205,18,18,0,1,0
19,208,208,13,3,10,2,1
10,216,216,16,8,8,2,1
4,225,225,25,17,8,3,2
7,226,226,13,1,12,4,3
20,233,233,54,49,5,2,1
14,238,238,16,16,0,1,0
0,242,242,16,16,0,1,0
8,377,377,1,1,0,1,0
2,384,384,7,7,0,1,0
6,389,389,6,6,0,1,0
1,400,400,6,1,5,2,1
18,413,413,52,10,42,4,3
9,449,449,5,2,3,2,1
11,457,457,42,21,21,2,1
17,488,488,45,12,33,4,3

9,105,105,15,15,0,1,0
7,119,119,19,19,0,1,0
1,194,194,8,8,0,1,0
14,215,215,9,6,3,2,1
13,241,241,26,26,0,1,0
12,262,262,54,7,47,2,1
2,270,270,81,81,0,1,0
5,270,270,7,3,4,2,1
3,278,278,19,16,3,2,1
11,344,344,7,4,3,2,1
4,352,352,20,20,0,1,0
0,360,360,2,2,0,1,0
6,468,468,20,4,16,3,2
10,468,468,30,18,12,2,1
8,498,498,65,39,26,2,1

2,163,163,82,15,67,3,2
6,267,267,83,41,42,4,3
9,292,292,6,6,0,1,0
3,338,338,22,22,0,1,0
8,339,339,9,6,3,2,1
1,381,381,1,1,0,1,0
7,409,409,57,57,0,1,0
10,430,430,29,1,28,2,1
4,447,447,37,37,0,1,0
5,454,454,28,16,12,4,3
0,475,475,62,62,0,1,0

12,125,125,12,12,0,1,0
10,245,245,33,9,24,2,1
5,250,250,25,25,0,1,0
1,256,256,64,64,0,1,0
3,277,277,16,16,0,1,0
8,278,278,51,51,0,1,0
11,295,295,30,30,0,1,0
2,315,315,8,8,0,1,0
4,332,332,13,13,0,1,0
6,351,351,41,41,0,1,0
14,354,354,42,42,0,1,0
7,355,355,23,23,0,1,0
13,368,368,16,3,13,4,3
0,475,475,23,4,19,2,1
9,477,477,16,16,0,1,0

1,202,202,65,65,0,1,0
8,207,207,24,6,18,4,3
5,223,223,74,68,6,3,2
9,295,295,11,1,10,2,1
4,328,328,27,27,0,1,0
7,364,364,3,3,0,1,0
3,395,395,31,7,24,4,3
0,440,440,44,2,42,4,3
6,442,442,25,25,0,1,0
2,456,456,127,127,0,1,0

4,115,115,2,2,0,1,0
5,116,116,7,7,0,1,0
9,140,140,2,2,0,1,0
0,164,164,4,4,0,1,0
3,166,166,23,23,0,1,0
10,229,229,46,46,0,1,0
11,283,283,24,24,0,1,0
1,286,286,69,49,20,3,2
2,291,291,64,64,0,1,0
7,305,305,44,14,30,3,2
12,313,313,20,11,9,4,3
8,321,321,65,46,19,4,3
6,446,446,4,4,0,1,0

4,127,127,3,3,0,1,0
2,132,132,33,33,0,1,0
3,215,215,10,10,0,1,0
7,225,225,34,5,29,2,1
10,235,235,53,53,0,1,0
6,246,246,5,5,0,1,0
8,321,321,35,20,15,4,3
0,352,352,35,26,9,2,1
12,365,365,3,3,0,1,0
1,391,391,56,53,3,2,1
9,411,411,2,2,0,1,0
5,443,443,53,37,16,2,1
13,471,471,74,74,0,1,0
11,472,472,24,10,14,3,2

1,118,118,29,22,7,2,1
12,185,185,46,28,18,4,3
6,251,251,1,1,0,1,0
3,278,278,57,57,0,1,0
7,333,333,36,36,0,1,0
8,339,339,2,2,0,1,0
13,341,341,1,1,0,1,0
0,365,365,9,1,8,3,2
5,374,374,10,10,0,1,0
2,388,388,29,29,0,1,0
9,397,397,6,6,0,1,0
11,417,417,27,1,26,2,1
10,495,495,131,131,0,1,0
4,497,497,60,53,7,2,1

13,109,109,1,1,0,1,0
5,136,136,2,2,0,1,0
4,144,144,2,2,0,1,0
9,208,208,4,4,0,1,0
10,210,210,26,26,0,1,0
6,261,261,7,1,6,3,2
0,278,278,1,1,0,1,0
11,306,306,81,69,12,4,3
17,315,315,53,53,0,1,0
8,323,323,23,23,0,1,0
14,375,375,2,2,0,1,0
3,380,380,27,3,24,2,1
12,397,397,15,6,9,4,3
16,413,413,57,57,0,1,0
15,430,430,41,41,0,1,0
7,437,437,55,42,13,2,1
2,440,440,80,41,39,2,1
1,475,475,24,6,18,2,1

0,100,100,1,1,0,1,0
2,108,108,13,3,10,3,2
1,119,119,2,2,0,1,0
10,162,162,4,4,0,1,0
6,164,164,3,3,0,1,0
8,173,173,30,21,9,4,3
12,212,212,3,3,0,1,0
15,218,218,31,31,0,1,0
13,254,254,75,71,4,2,1
4,265,265,31,31,0,1,0
9,274,274,29,14,15,4,3
7,279,279,37,37,0,1,0
3,322,322,9,9,0,1,0
14,371,371,11,7,4,2,1
5,404,404,34,34,0,1,0
11,468,468,46,4,42,3,2

11,155,155,2,2,0,1,0
7,187,187,22,22,0,1,0
3,208,208,18,18,0,1,0
12,260,260,40,40,0,1,0
9,268,268,14,14,0,1,0
4,272,272,1,1,0,1,0
1,322,322,31,31,0,1,0
10,333,333,35,35,0,1,0
6,348,348,23,23,0,1,0
0,401,401,48,37,11,2,1
5,410,410,153,27,126,4,3
8,418,418,85,9,76,3,2
2,444,444,10,10,0,1,0

8,156,156,20,8,12,4,3
2,170,170,31,6,25,2,1
3,220,220,47,11,36,3,2
4,247,247,11,7,4,2,1
5,371,371,34,6,28,2,1
1,379,379,84,49,35,2,1
6,418,418,45,35,10,2,1
7,426,426,5,2,3,2,1
9,453,453,54,14,40,3,2
0,455,455,136,92,44,2,1

5,116,116,8,2,6,2,1
15,168,168,56,8,48,2,1
0,169,169,30,30,0,1,0
8,215,215,5,5,0,1,0
12,233,233,28,10,18,2,1
6,280,280,26,26,0,1,0
7,312,312,10,2,8,2,1
13,337,337,36,36,0,1,0
3,364,364,27,11,16,3,2
10,443,443,7,7,0,1,0
14,451,451,22,22,0,1,0
4,457,457,19,19,0,1,0
1,463,463,65,47,18,2,1
9,469,469,2,2,0,1,0
2,475,475,25,15,10,3,2
11,494,494,40,40,0,1,0

17,109,109,25,15,10,3,2
16,146,146,12,12,0,1,0
0,147,147,10,2,8,2,1
9,187,187,15,6,9,4,3
13,210,210,7,2,5,2,1
10,241,241,11,11,0,1,0
2,253,253,8,4,4,2,1
6,286,286,6,6,0,1,0
8,304,304,40,14,26,3,2
5,314,314,3,3,0,1,0
1,336,336,13,1,12,4,3
3,365,365,20,2,18,3,2
4,376,376,8,8,0,1,0
12,415,415,24,12,12,3,2
15,453,453,96,39,57,4,3
14,472,472,41,25,16,3,2
11,482,482,7,7,0,1,0
7,490,490,97,82,15,4,3

4,109,109,18,13,5,2,1
11,120,120,12,12,0,1,0
8,143,143,20,20,0,1,0
0,145,145,7,7,0,1,0
6,169,169,23,16,7,2,1
7,175,175,7,3,4,2,1
14,190,190,24,4,20,2,1
13,210,210,6,6,0,1,0
9,261,261,30,17,13,2,1
2,293,293,46,14,32,3,2
3,314,314,31,31,0,1,0
10,377,377,40,40,0,1,0
1,430,430,3,3,0,1,0
5,475,475,25,25,0,1,0
12,487,487,50,20,30,4,3

8,119,119,19,19,0,1,0
15,125,125,4,4,0,1,0
3,133,133,10,4,6,3,2
4,157,157,6,3,3,2,1
12,170,170,9,9,0,1,0
10,232,232,3,3,0,1,0
9,294,294,109,75,34,3,2
0,340,340,8,8,0,1,0
14,363,363,3,3,0,1,0
13,384,384,82,40,42,3,2
5,391,391,2,2,0,1,0
2,418,418,15,15,0,1,0
1,420,420,2,2,0,1,0
11,457,457,14,3,11,3,2
7,471,471,98,98,0,1,0
6,475,475,72,18,54,4,3

7,144,144,2,2,0,1,0
8,157,157,10,3,7,2,1
10,173,173,14,2,12,4,3
11,188,188,15,15,0,1,0
1,246,246,9,3,6,2,1
12,310,310,96,34,62,3,2
3,313,313,80,80,0,1,0
6,371,371,49,19,30,4,3
9,402,402,13,13,0,1,0
0,416,416,46,46,0,1,0
5,436,436,18,18,0,1,0
4,438,438,65,20,45,4,3
2,480,480,52,34,18,4,3

4,109,109,16,16,0,1,0
2,122,122,34,24,10,2,1
5,133,133,4,4,0,1,0
7,183,183,31,4,27,4,3
10,267,267,12,3,9,4,3
3,275,275,57,45,12,4,3
8,302,302,37,14,23,2,1
9,315,315,26,16,10,2,1
6,374,374,44,44,0,1,0
1,390,390,57,57,0,1,0
0,417,417,29,15,14,2,1

14,103,103,9,9,0,1,0
13,104,104,3,3,0,1,0
8,112,112,4,4,0,1,0
3,179,179,13,1,12,3,2
6,181,181,19,4,15,2,1
5,186,186,15,3,12,4,3
2,197,197,16,11,5,2,1
1,230,230,14,5,9,4,3
11,260,260,31,13,18,3,2
4,275,275,34,34,0,1,0
12,321,321,52,52,0,1,0
7,329,329,33,33,0,1,0
0,345,345,14,14,0,1,0
10,366,366,2,2,0,1,0
15,373,373,21,21,0,1,0
9,478,478,128,128,0,1,0

6,135,135,14,6,8,2,1
1,142,142,18,11,7,2,1
3,172,172,21,14,7,2,1
12,200,200,8,8,0,1,0
4,297,297,3,3,0,1,0
11,327,327,30,2,28,3,2
7,387,387,74,52,22,2,1
0,395,395,18,14,4,2,1
8,399,399,28,28,0,1,0
13,420,420,19,3,16,2,1
2,422,422,11,5,6,2,1
9,458,458,62,15,47,2,1
5,475,475,129,129,0,1,0
10,476,476,64,1,63,4,3

0,107,107,5,5,0,1,0
5,118,118,6,6,0,1,0
12,135,135,17,14,3,2,1
13,140,140,7,1,6,3,2
6,144,144,19,6,13,3,2
7,189,189,58,43,15,2,1
8,228,228,22,22,0,1,0
4,278,278,31,4,27,3,2
11,289,289,35,2,33,2,1
1,340,340,4,4,0,1,0
2,348,348,1,1,0,1,0
3,358,358,15,15,0,1,0
10,369,369,2,2,0,1,0
9,400,400,35,35,0,1,0
14,487,487,113,9,104,4,3

10,111,111,21,21,0,1,0
16,128,128,5,2,3,2,1
6,134,134,15,15,0,1,0
7,161,161,1,1,0,1,0
17,169,169,49,49,0,1,0
1,173,173,7,3,4,2,1
5,200,200,4,4,0,1,0
14,212,212,1,1,0,1,0
8,231,231,15,9,6,3,2
9,247,247,4,4,0,1,0
15,281,281,36,11,25,2,1
18,285,285,12,12,0,1,0
2,291,291,26,26,0,1,0
4,292,292,3,3,0,1,0
3,377,377,39,39,0,1,0
11,408,408,14,14,0,1,0
0,416,416,6,6,0,1,0
13,446,446,70,58,12,2,1
12,483,483,26,3,23,2,1

6,144,144,5,2,3,2,1
11,230,230,53,9,44,2,1
10,244,244,52,7,45,3,2
7,291,291,15,15,0,1,0
4,299,299,96,96,0,1,0
3,306,306,41,41,0,1,0
5,330,330,36,36,0,1,0
0,371,371,17,17,0,1,0
2,383,383,11,11,0,1,0
9,394,394,19,19,0,1,0
13,415,415,39,21,18,4,3
8,434,434,19,8,11,2,1
12,458,458,14,8,6,3,2
1,486,486,15,15,0,1,0

4,117,117,2,2,0,1,0
14,139,139,13,1,12,2,1
9,142,142,38,38,0,1,0
10,158,158,17,14,3,2,1
8,197,197,3,3,0,1,0
3,224,224,1,1,0,1,0
0,225,225,54,13,41,2,1
11,247,247,32,16,16,2,1
5,298,298,12,4,8,3,2
6,314,314,38,38,0,1,0
12,323,323,32,16,16,2,1
13,353,353,2,2,0,1,0
1,463,463,38,38,0,1,0
7,465,465,53,53,0,1,0
2,498,498,41,11,30,4,3

6,119,119,28,28,0,1,0
3,125,125,7,2,5,2,1
2,140,140,37,37,0,1,0
5,167,167,21,16,5,2,1
11,168,168,8,8,0,1,0
9,196,196,20,2,18,2,1
10,203,203,7,7,0,1,0
1,214,214,9,9,0,1,0
8,336,336,27,27,0,1,0
7,337,337,32,2,30,4,3
0,400,400,14,1,13,2,1
4,406,406,123,123,0,1,0

17,108,108,12,12,0,1,0
16,117,117,7,7,0,1,0
11,144,144,10,3,7,2,1
2,145,145,13,5,8,2,1
12,159,159,11,11,0,1,0
1,175,175,1,1,0,1,0
6,184,184,1,1,0,1,0
9,186,186,17,7,10,3,2
7,201,201,1,1,0,1,0
4,215,215,5,1,4,2,1
5,247,247,7,7,0,1,0
13,279,279,33,33,0,1,0
18,349,349,1,1,0,1,0
15,357,357,81,38,43,2,1
3,418,418,8,8,0,1,0
8,463,463,30,6,24,2,1
0,472,472,108,67,41,2,1
14,494,494,61,26,35,2,1
10,499,499,37,15,22,3,2

12,128,128,9,5,4,2,1
5,130,130,5,5,0,1,0
8,143,143,10,4,6,2,1
1,157,157,7,7,0,1,0
4,194,194,20,3,17,4,3
11,213,213,23,5,18,4,3
7,265,265,88,88,0,1,0
14,306,306,51,21,30,4,3
2,406,406,4,4,0,1,0
3,415,415,6,6,0,1,0
9,419,419,11,11,0,1,0
0,452,452,6,6,0,1,0
10,453,453,55,11,44,3,2
6,472,472,69,47,22,2,1
13,479,479,74,30,44,4,3

5,103,103,16,10,6,3,2
4,108,108,4,4,0,1,0
8,169,169,42,42,0,1,0
2,206,206,22,13,9,2,1
12,220,220,30,22,8,2,1
9,236,236,45,14,31,4,3
11,256,256,5,5,0,1,0
0,286,286,77,28,49,4,3
7,320,320,2,2,0,1,0
13,320,320,29,5,24,4,3
3,377,377,21,21,0,1,0
6,455,455,11,3,8,2,1
1,459,459,24,7,17,2,1
10,464,464,11,11,0,1,0

3,151,151,8,2,6,3,2
12,152,152,15,15,0,1,0
5,169,169,13,13,0,1,0
8,189,189,16,4,12,3,2
0,223,223,50,16,34,2,1
9,224,224,8,2,6,3,2
7,337,337,38,6,32,3,2
2,373,373,35,35,0,1,0
4,391,391,44,44,0,1,0
11,397,397,54,54,0,1,0
10,402,402,8,8,0,1,0
1,406,406,57,30,27,2,1
6,416,416,94,94,0,1,0

6,100,100,7,1,6,3,2
9,117,117,9,9,0,1,0
3,135,135,20,20,0,1,0
4,164,164,4,4,0,1,0
5,205,205,11,2,9,4,3
8,217,217,41,10,31,2,1
7,219,219,57,43,14,2,1
2,244,244,19,3,16,2,1
11,246,246,5,5,0,1,0
14,262,262,31,21,10,3,2
12,348,348,6,6,0,1,0
1,366,366,9,9,0,1,0
0,397,397,17,1,16,2,1
13,462,462,86,53,33,2,1
10,466,466,52,52,0,1,0

8,126,126,3,3,0,1,0
6,150,150,23,4,19,2,1
1,181,181,26,26,0,1,0
13,211,211,38,38,0,1,0
10,240,240,3,3,0,1,0
9,289,289,33,33,0,1,0
2,318,318,23,23,0,1,0
11,341,341,60,60,0,1,0
5,362,362,20,20,0,1,0
15,375,375,12,12,0,1,0
4,390,390,10,10,0,1,0
14,398,398,18,6,12,4,3
3,421,421,1,1,0,1,0
0,426,426,57,14,43,2,1
7,435,435,42,2,40,2,1
12,438,438,65,17,48,2,1

2,114,114,10,10,0,1,0
7,116,116,31,7,24,4,3
0,151,151,1,1,0,1,0
9,240,240,32,32,0,1,0
8,261,261,12,6,6,3,2
6,295,295,40,40,0,1,0
3,299,299,112,71,41,2,1
10,387,387,4,4,0,1,0
4,439,439,35,35,0,1,0
5,460,460,19,19,0,1,0
1,465,465,109,103,6,2,1

5,127,127,3,3,0,1,0
7,158,158,22,22,0,1,0
10,205,205,19,9,10,3,2
2,262,262,33,20,13,2,1
11,286,286,35,6,29,4,3
12,287,287,74,55,19,2,1
0,311,311,20,20,0,1,0
1,320,320,140,68,72,4,3
9,359,359,15,5,10,3,2
6,362,362,15,12,3,2,1
8,392,392,9,2,7,2,1
3,420,420,18,18,0,1,0
4,429,429,5,5,0,1,0

6,138,138,29,29,0,1,0
11,164,164,1,1,0,1,0
3,182,182,25,25,0,1,0
12,211,211,9,9,0,1,0
8,232,232,60,18,42,3,2
1,249,249,4,4,0,1,0
2,263,263,34,34,0,1,0
13,282,282,28,20,8,2,1
9,299,299,53,53,0,1,0
0,323,323,10,10,0,1,0
5,375,375,60,11,49,2,1
10,444,444,37,37,0,1,0
4,476,476,8,2,6,2,1
7,500,500,22,11,11,2,1

5,139,139,17,17,0,1,0
8,150,150,8,8,0,1,0
10,163,163,8,1,7,2,1
6,203,203,6,3,3,2,1
3,262,262,15,1,14,2,1
0,265,265,109,109,0,1,0
11,290,290,85,77,8,2,1
13,371,371,15,4,11,4,3
2,409,409,11,11,0,1,0
9,418,418,63,51,12,2,1
4,439,439,6,1,5,2,1
1,444,444,18,18,0,1,0
7,469,469,41,7,34,2,1
12,482,482,21,5,16,3,2

4,187,187,12,1,11,2,1
7,205,205,1,1,0,1,0
6,208,208,11,11,0,1,0
0,261,261,85,80,5,2,1
2,289,289,24,24,0,1,0
12,315,315,18,6,12,2,1
10,330,330,8,8,0,1,0
11,358,358,71,71,0,1,0
1,377,377,11,7,4,2,1
8,414,414,24,24,0,1,0
5,481,481,46,16,30,4,3
3,485,485,50,8,42,4,3
9,499,499,158,138,20,3,2

5,114,114,8,3,5,2,1
4,120,120,9,9,0,1,0
10,152,152,10,10,0,1,0
0,161,161,2,2,0,1,0
7,219,219,25,13,12,2,1
13,234,234,27,24,3,2,1
12,266,266,21,21,0,1,0
9,302,302,24,21,3,2,1
8,343,343,12,12,0,1,0
2,364,364,55,13,42,3,2
11,429,429,143,134,9,2,1
6,452,452,35,35,0,1,0
14,454,454,1,1,0,1,0
3,475,475,44,28,16,3,2
1,479,479,52,24,28,2,1

13,149,149,7,7,0,1,0
1,198,198,17,17,0,1,0
10,208,208,7,7,0,1,0
7,213,213,12,12,0,1,0
12,277,277,32,16,16,3,2
5,285,285,5,2,3,2,1
6,287,287,17,17,0,1,0
0,289,289,65,65,0,1,0
4,315,315,17,17,0,1,0
14,337,337,64,64,0,1,0
11,389,389,42,30,12,3,2
9,406,406,25,5,20,2,1
2,412,412,57,21,36,3,2
3,436,436,29,19,10,2,1
8,499,499,78,78,0,1,0

5,121,121,6,6,0,1,0
14,127,127,8,2,6,3,2
0,132,132,3,3,0,1,0
3,149,149,5,1,4,2,1
15,153,153,1,1,0,1,0
11,194,194,67,21,46,3,2
7,214,214,17,1,16,3,2
6,286,286,27,3,24,2,1
12,303,303,23,3,20,4,3
2,334,334,15,4,11,2,1
13,358,358,24,2,22,3,2
1,394,394,26,6,20,2,1
9,395,395,45,11,34,3,2
4,425,425,80,80,0,1,0
10,468,468,19,13,6,3,2
8,480,480,59,46,13,2,1

13,103,103,9,3,6,2,1
9,110,110,19,10,9,2,1
8,115,115,9,3,6,3,2
7,152,152,1,1,0,1,0
6,178,178,1,1,0,1,0
1,214,214,19,5,14,2,1
12,227,227,2,2,0,1,0
10,230,230,28,23,5,2,1
15,282,282,5,5,0,1,0
14,306,306,80,74,6,2,1
2,307,307,8,8,0,1,0
11,316,316,15,5,10,3,2
5,321,321,36,15,21,4,3
3,334,334,11,11,0,1,0
0,408,408,82,82,0,1,0
4,490,490,75,42,33,4,3

11,154,154,12,9,3,2,1
17,164,164,27,12,15,4,3
1,169,169,13,13,0,1,0
18,233,233,16,16,0,1,0
4,246,246,1,1,0,1,0
10,272,272,8,8,0,1,0
15,274,274,1,1,0,1,0
3,278,278,43,35,8,3,2
2,288,288,12,12,0,1,0
13,303,303,27,27,0,1,0
14,309,309,81,81,0,1,0
19,324,324,36,31,5,2,1
0,332,332,12,12,0,1,0
16,352,352,4,1,3,2,1
6,360,360,18,18,0,1,0
8,370,370,8,8,0,1,0
5,373,373,17,5,12,4,3
9,412,412,13,13,0,1,0
7,462,462,17,17,0,1,0
12,482,482,46,12,34,3,2

4,106,106,2,2,0,1,0
11,106,106,9,9,0,1,0
6,109,109,32,8,24,2,1
3,128,128,3,3,0,1,0
7,136,136,18,18,0,1,0
12,196,196,14,5,9,4,3
5,267,267,2,2,0,1,0
1,286,286,49,49,0,1,0
13,310,310,41,29,12,4,3
2,386,386,23,23,0,1,0
0,396,396,51,51,0,1,0
8,481,481,93,93,0,1,0
10,481,481,22,22,0,1,0
9,496,496,25,25,0,1,0

1,139,139,1,1,0,1,0
0,165,165,32,32,0,1,0
3,185,185,5,5,0,1,0
5,189,189,23,6,17,3,2
7,190,190,3,3,0,1,0
8,261,261,52,10,42,3,2
9,293,293,2,2,0,1,0
4,306,306,87,12,75,4,3
10,354,354,17,2,15,4,3
2,357,357,2,2,0,1,0
14,374,374,44,44,0,1,0
13,419,419,31,31,0,1,0
6,437,437,20,6,14,3,2
11,467,467,114,114,0,1,0
12,500,500,9,9,0,1,0

2,122,122,14,6,8,2,1
10,124,124,4,4,0,1,0
1,166,166,9,9,0,1,0
4,236,236,61,23,38,4,3
12,244,244,36,36,0,1,0
8,303,303,39,39,0,1,0
6,403,403,27,17,10,3,2
0,432,432,67,28,39,4,3
11,448,448,6,1,5,2,1
9,465,465,143,143,0,1,0
3,489,489,34,34,0,1,0
5,494,494,24,24,0,1,0
7,494,494,8,8,0,1,0

12,108,108,14,2,12,2,1
17,136,136,5,2,3,2,1
7,142,142,23,5,18,3,2
15,150,150,7,7,0,1,0
11,163,163,40,40,0,1,0
9,165,165,4,1,3,2,1
13,174,174,15,5,10,3,2
6,191,191,1,1,0,1,0
2,195,195,6,6,0,1,0
4,204,204,6,1,5,2,1
0,215,215,15,5,10,2,1
8,341,341,3,3,0,1,0
3,344,344,9,6,3,2,1
14,376,376,11,2,9,2,1
5,395,395,1,1,0,1,0
10,416,416,22,8,14,3,2
1,499,499,144,144,0,1,0
16,500,500,70,70,0,1,0

12,122,122,5,5,0,1,0
8,143,143,14,7,7,2,1
7,156,156,7,7,0,1,0
9,173,173,11,1,10,3,2
6,177,177,20,20,0,1,0
13,184,184,35,32,3,2,1
4,221,221,46,46,0,1,0
1,248,248,6,2,4,2,1
11,299,299,15,8,7,2,1
3,391,391,41,41,0,1,0
10,449,449,105,73,32,3,2
0,467,467,110,86,24,4,3
5,475,475,8,8,0,1,0
2,480,480,1,1,0,1,0

3,142,142,51,51,0,1,0
1,192,192,34,34,0,1,0
10,226,226,15,15,0,1,0
2,244,244,17,17,0,1,0
9,289,289,27,16,11,2,1
0,299,299,6,1,5,2,1
5,312,312,22,22,0,1,0
6,419,419,53,53,0,1,0
8,435,435,29,29,0,1,0
4,446,446,34,34,0,1,0
7,471,471,18,18,0,1,0
11,478,478,119,119,0,1,0

6,113,113,10,10,0,1,0
12,131,131,29,29,0,1,0
7,141,141,14,14,0,1,0
3,156,156,5,1,4,2,1
5,156,156,5,5,0,1,0
13,157,157,10,10,0,1,0
1,185,185,14,10,4,2,1
15,206,206,9,6,3,2,1
11,208,208,3,3,0,1,0
16,222,222,37,37,0,1,0
10,447,447,87,65,22,3,2
4,460,460,53,20,33,3,2
8,468,468,27,27,0,1,0
14,469,469,5,5,0,1,0
9,477,477,57,57,0,1,0
0,482,482,1,1,0,1,0
2,497,497,39,6,33,3,2

11,119,119,1,1,0,1,0
5,128,128,1,1,0,1,0
13,134,134,16,16,0,1,0
9,139,139,1,1,0,1,0
7,141,141,10,10,0,1,0
6,145,145,12,9,3,2,1
3,147,147,16,1,15,2,1
2,184,184,22,10,12,3,2
8,229,229,44,44,0,1,0
10,234,234,12,12,0,1,0
1,258,258,28,12,16,3,2
12,266,266,72,59,13,2,1
0,440,440,122,89,33,4,3
4,497,497,1,1,0,1,0

6,101,101,4,4,0,1,0
7,105,105,26,26,0,1,0
4,117,117,22,22,0,1,0
2,145,145,3,3,0,1,0
11,273,273,2,2,0,1,0
0,285,285,45,8,37,2,1
8,337,337,64,1,63,4,3
12,402,402,41,29,12,2,1
13,406,406,4,4,0,1,0
10,419,419,4,4,0,1,0
5,424,424,14,14,0,1,0
3,432,432,92,92,0,1,0
1,465,465,24,2,22,3,2
9,475,475,68,68,0,1,0

1,120,120,34,34,0,1,0
3,121,121,10,10,0,1,0
11,210,210,24,9,15,4,3
12,232,232,61,61,0,1,0
6,258,258,4,4,0,1,0
7,280,280,18,18,0,1,0
5,283,283,17,7,10,3,2
0,284,284,10,10,0,1,0
9,324,324,43,43,0,1,0
13,346,346,25,25,0,1,0
10,389,389,2,2,0,1,0
2,397,397,63,29,34,2,1
8,423,423,21,21,0,1,0
4,429,429,1,1,0,1,0
14,486,486,37,37,0,1,0

2,107,107,7,7,0,1,0
5,112,112,14,14,0,1,0
10,268,268,28,28,0,1,0
11,282,282,3,3,0,1,0
12,313,313,25,25,0,1,0
4,329,329,68,8,60,3,2
1,333,333,7,7,0,1,0
3,338,338,17,1,16,3,2
7,339,339,41,41,0,1,0
6,346,346,10,10,0,1,0
0,422,422,101,54,47,2,1
9,432,432,108,37,71,4,3
8,464,464,52,52,0,1,0

9,121,121,13,5,8,3,2
4,162,162,2,2,0,1,0
14,185,185,24,6,18,3,2
5,241,241,52,40,12,4,3
1,257,257,14,4,10,2,1
12,268,268,23,1,22,3,2
15,310,310,37,37,0,1,0
3,313,313,63,63,0,1,0
10,319,319,17,17,0,1,0
2,321,321,8,3,5,2,1
8,328,328,10,3,7,2,1
7,350,350,24,24,0,1,0
11,360,360,25,6,19,4,3
6,388,388,29,24,5,2,1
13,434,434,64,58,6,3,2
0,497,497,10,6,4,2,1

3,103,103,10,10,0,1,0
2,148,148,14,6,8,2,1
13,156,156,9,9,0,1,0
17,158,158,18,3,15,2,1
1,165,165,13,4,9,4,3
6,181,181,1,1,0,1,0
5,191,191,9,9,0,1,0
9,201,201,2,2,0,1,0
14,205,205,25,5,20,4,3
16,247,247,1,1,0,1,0
0,259,259,3,3,0,1,0
15,268,268,41,41,0,1,0
8,288,288,2,2,0,1,0
4,329,329,5,5,0,1,0
11,390,390,36,36,0,1,0
7,398,398,34,24,10,3,2
12,476,476,58,58,0,1,0
10,483,483,76,31,45,4,3
18,497,497,70,32,38,3,2

7,108,108,3,3,0,1,0
5,127,127,8,1,7,2,1
3,296,296,10,3,7,2,1
12,327,327,17,17,0,1,0
4,346,346,62,62,0,1,0
6,350,350,8,8,0,1,0
2,364,364,72,72,0,1,0
0,374,374,35,14,21,4,3
8,375,375,2,2,0,1,0
1,393,393,44,44,0,1,0
10,422,422,66,24,42,2,1
11,455,455,8,8,0,1,0
13,466,466,196,196,0,1,0
9,496,496,17,17,0,1,0

7,216,216,15,15,0,1,0
1,237,237,13,3,10,4,3
0,243,243,50,50,0,1,0
2,266,266,28,28,0,1,0
8,292,292,19,15,4,2,1
3,302,302,22,22,0,1,0
4,320,320,17,2,15,4,3
5,332,332,17,8,9,4,3
14,416,416,23,5,18,3,2
13,423,423,49,49,0,1,0
12,450,450,7,2,5,2,1
10,452,452,39,39,0,1,0
6,469,469,12,3,9,2,1
9,475,475,87,61,26,3,2
15,478,478,30,1,29,2,1
11,489,489,94,94,0,1,0

7,103,103,11,5,6,3,2
9,116,116,22,22,0,1,0
14,145,145,8,1,7,2,1
3,168,168,53,53,0,1,0
11,180,180,14,14,0,1,0
0,250,250,9,9,0,1,0
5,274,274,8,8,0,1,0
4,277,277,22,9,13,4,3
8,304,304,4,4,0,1,0
10,307,307,19,5,14,2,1
15,315,315,9,9,0,1,0
2,372,372,24,16,8,3,2
6,415,415,18,5,13,2,1
13,463,463,130,130,0,1,0
1,467,467,6,2,4,2,1
12,495,495,10,10,0,1,0

11,103,103,1,1,0,1,0
5,147,147,4,1,3,2,1
0,193,193,58,58,0,1,0
2,210,210,2,2,0,1,0
3,213,213,16,16,0,1,0
8,295,295,16,2,14,2,1
9,327,327,122,106,16,2,1
14,330,330,28,6,22,3,2
13,360,360,38,38,0,1,0
4,380,380,39,3,36,4,3
12,422,422,5,2,3,2,1
6,447,447,35,24,11,4,3
10,448,448,31,20,11,3,2
1,453,453,5,5,0,1,0
7,455,455,44,44,0,1,0

5,141,141,69,46,23,2,1
4,229,229,7,7,0,1,0
7,260,260,16,1,15,2,1
8,278,278,18,5,13,2,1
9,348,348,4,4,0,1,0
3,364,364,98,68,30,4,3
2,410,410,80,80,0,1,0
1,420,420,53,53,0,1,0
0,442,442,49,49,0,1,0
6,451,451,16,13,3,2,1
10,463,463,10,10,0,1,0

8,114,114,10,10,0,1,0
1,131,131,26,26,0,1,0
2,147,147,19,6,13,2,1
5,160,160,1,1,0,1,0
4,308,308,26,16,10,2,1
9,333,333,6,6,0,1,0
7,347,347,6,2,4,2,1
6,350,350,100,100,0,1,0
11,389,389,6,3,3,2,1
0,402,402,37,37,0,1,0
12,427,427,31,31,0,1,0
3,467,467,90,84,6,2,1
10,498,498,109,40,69,4,3

7,121,121,11,5,6,2,1
0,153,153,1,1,0,1,0
4,182,182,25,1,24,2,1
9,185,185,38,23,15,4,3
6,213,213,1,1,0,1,0
11,298,298,60,60,0,1,0
8,324,324,7,7,0,1,0
10,337,337,48,10,38,2,1
12,351,351,19,6,13,2,1
2,377,377,40,34,6,3,2
5,413,413,14,4,10,2,1
1,415,415,162,103,59,4,3
3,467,467,13,13,0,1,0

9,124,124,13,2,11,4,3
8,134,134,7,2,5,2,1
0,148,148,38,16,22,3,2
12,217,217,2,2,0,1,0
4,218,218,13,1,12,2,1
13,300,300,129,115,14,2,1
14,334,334,36,36,0,1,0
10,378,378,1,1,0,1,0
15,406,406,7,7,0,1,0
7,422,422,62,38,24,3,2
3,446,446,15,9,6,2,1
2,457,457,54,5,49,2,1
11,467,467,19,13,6,3,2
1,474,474,13,13,0,1,0
5,474,474,2,2,0,1,0
6,488,488,2,2,0,1,0

6,142,142,27,12,15,2,1
0,185,185,7,7,0,1,0
1,197,197,73,16,57,4,3
3,203,203,11,3,8,2,1
7,245,245,5,5,0,1,0
11,249,249,55,1,54,3,2
5,265,265,13,1,12,3,2
4,334,334,31,31,0,1,0
2,379,379,55,7,48,2,1
9,413,413,9,9,0,1,0
10,415,415,38,29,9,2,1
8,483,483,60,11,49,2,1

10,102,102,14,14,0,1,0
13,119,119,4,4,0,1,0
14,195,195,6,2,4,2,1
5,250,250,13,3,10,3,2
4,281,281,43,31,12,4,3
8,299,299,13,3,10,3,2
9,307,307,30,12,18,3,2
2,337,337,60,16,44,3,2
11,352,352,98,79,19,2,1
0,354,354,26,26,0,1,0
12,374,374,37,14,23,2,1
1,470,470,9,3,6,3,2
3,474,474,7,1,6,2,1
7,477,477,21,12,9,2,1
6,481,481,80,80,0,1,0

3,166,166,19,13,6,3,2
14,200,200,14,11,3,2,1
0,252,252,24,3,21,2,1
2,272,272,18,18,0,1,0
6,272,272,5,5,0,1,0
5,280,280,13,13,0,1,0
1,286,286,6,2,4,2,1
4,286,286,34,4,30,2,1
11,297,297,12,12,0,1,0
9,354,354,27,27,0,1,0
8,372,372,59,39,20,3,2
7,380,380,84,84,0,1,0
12,394,394,7,7,0,1,0
13,444,444,57,26,31,2,1
10,480,480,106,80,26,2,1

7,103,103,1,1,0,1,0
10,106,106,11,11,0,1,0
5,141,141,16,16,0,1,0
0,157,157,8,8,0,1,0
9,221,221,24,24,0,1,0
11,254,254,23,11,12,4,3
2,273,273,3,3,0,1,0
13,317,317,22,22,0,1,0
1,320,320,90,90,0,1,0
12,387,387,109,97,12,4,3
4,401,401,57,42,15,2,1
8,418,418,22,2,20,2,1
6,419,419,26,26,0,1,0
3,466,466,19,16,3,2,1

6,140,140,13,6,7,2,1
12,157,157,6,3,3,2,1
3,175,175,10,3,7,2,1
11,240,240,1,1,0,1,0
4,260,260,8,8,0,1,0
0,264,264,114,102,12,3,2
9,283,283,26,16,10,2,1
10,310,310,97,67,30,3,2
1,330,330,19,19,0,1,0
2,336,336,6,6,0,1,0
8,353,353,29,29,0,1,0
5,357,357,6,1,5,2,1
7,365,365,49,15,34,3,2
13,369,369,18,11,7,3,2

3,132,132,14,5,9,4,3
17,210,210,22,1,21,4,3
12,230,230,8,8,0,1,0
11,231,231,3,3,0,1,0
5,232,232,1,1,0,1,0
16,282,282,67,11,56,3,2
2,283,283,6,6,0,1,0
10,323,323,1,1,0,1,0
14,349,349,15,5,10,3,2
8,353,353,32,32,0,1,0
0,361,361,14,7,7,2,1
15,361,361,13,3,10,2,1
1,377,377,26,26,0,1,0
7,394,394,71,28,43,2,1
6,397,397,13,13,0,1,0
9,420,420,35,35,0,1,0
4,423,423,30,6,24,3,2
13,461,461,110,110,0,1,0

6,128,128,3,3,0,1,0
13,154,154,13,3,10,3,2
2,202,202,1,1,0,1,0
3,227,227,76,22,54,4,3
8,246,246,7,7,0,1,0
4,252,252,10,3,7,2,1
11,318,318,59,48,11,2,1
10,325,325,89,62,27,4,3
5,330,330,35,35,0,1,0
1,378,378,24,2,22,2,1
9,400,400,26,26,0,1,0
7,464,464,30,16,14,2,1
12,465,465,6,6,0,1,0
0,474,474,62,22,40,4,3

8,102,102,5,5,0,1,0
6,127,127,6,6,0,1,0
2,155,155,6,6,0,1,0
11,167,167,34,34,0,1,0
12,193,193,3,3,0,1,0
4,210,210,44,44,0,1,0
7,221,221,8,8,0,1,0
0,274,274,21,6,15,2,1
9,278,278,8,8,0,1,0
13,292,292,23,23,0,1,0
1,364,364,16,16,0,1,0
3,404,404,19,1,18,3,2
14,410,410,52,46,6,3,2
10,420,420,92,92,0,1,0
5,456,456,93,3,90,3,2

18,128,128,22,10,12,3,2
12,130,130,12,12,0,1,0
14,134,134,5,2,3,2,1
17,139,139,41,11,30,4,3
20,151,151,2,2,0,1,0
4,160,160,12,8,4,2,1
16,194,194,2,2,0,1,0
7,200,200,4,4,0,1,0
1,201,201,6,6,0,1,0
13,218,218,11,11,0,1,0
11,223,223,5,5,0,1,0
3,241,241,9,9,0,1,0
6,289,289,14,3,11,2,1
19,297,297,42,42,0,1,0
9,301,301,1,1,0,1,0
10,307,307,13,13,0,1,0
15,337,337,14,2,12,3,2
5,370,370,11,1,10,2,1
2,376,376,15,12,3,2,1
8,381,381,22,22,0,1,0
0,388,388,60,12,48,4,3

12,147,147,10,5,5,2,1
14,159,159,30,3,27,4,3
2,176,176,10,10,0,1,0
6,245,245,16,7,9,4,3
8,251,251,22,7,15,2,1
10,290,290,34,15,19,2,1
15,292,292,66,66,0,1,0
4,297,297,7,1,6,3,2
9,298,298,19,19,0,1,0
11,323,323,12,12,0,1,0
5,359,359,4,1,3,2,1
13,368,368,6,2,4,2,1
7,386,386,44,9,35,2,1
3,448,448,102,77,25,2,1
1,455,455,14,6,8,3,2
0,484,484,41,26,15,4,3

16,125,125,1,1,0,1,0
11,183,183,21,21,0,1,0
1,195,195,22,15,7,2,1
0,196,196,5,5,0,1,0
3,202,202,12,5,7,2,1
6,203,203,4,4,0,1,0
12,241,241,39,19,20,4,3
14,272,272,30,30,0,1,0
10,273,273,15,1,14,4,3
15,292,292,4,4,0,1,0
17,312,312,72,14,58,3,2
9,338,338,15,9,6,2,1
5,339,339,39,1,38,3,2
4,390,390,3,3,0,1,0
13,403,403,31,31,0,1,0
8,421,421,89,30,59,4,3
7,455,455,17,1,16,2,1
2,470,470,7,2,5,2,1

0,103,103,8,3,5,2,1
3,121,121,47,23,24,3,2
2,136,136,19,19,0,1,0
1,156,156,4,4,0,1,0
7,184,184,62,22,40,3,2
6,188,188,15,9,6,2,1
9,210,210,16,16,0,1,0
10,250,250,4,1,3,2,1
5,283,283,17,17,0,1,0
4,335,335,3,3,0,1,0
12,341,341,14,14,0,1,0
11,347,347,30,30,0,1,0
8,495,495,37,25,12,3,2

16,117,117,19,10,9,2,1
9,119,119,5,5,0,1,0
13,132,132,32,32,0,1,0
3,197,197,11,11,0,1,0
5,227,227,13,8,5,2,1
0,230,230,1,1,0,1,0
14,317,317,11,11,0,1,0
8,381,381,57,57,0,1,0
6,392,392,37,7,30,2,1
4,395,395,34,1,33,4,3
10,402,402,13,4,9,4,3
11,436,436,56,56,0,1,0
15,440,440,51,11,40,3,2
12,461,461,1,1,0,1,0
7,474,474,26,7,19,2,1
1,491,491,74,20,54,4,3
2,500,500,6,1,5,2,1

1,102,102,42,42,0,1,0
8,114,114,2,2,0,1,0
0,122,122,2,2,0,1,0
9,152,152,7,7,0,1,0
2,153,153,16,16,0,1,0
3,198,198,34,34,0,1,0
7,244,244,30,6,24,2,1
4,245,245,16,16,0,1,0
10,312,312,20,3,17,2,1
5,378,378,7,2,5,2,1
6,490,490,188,74,114,4,3

11,104,104,22,14,8,3,2
4,179,179,4,4,0,1,0
6,185,185,39,19,20,3,2
13,224,224,8,1,7,2,1
7,249,249,6,6,0,1,0
12,258,258,35,35,0,1,0
0,260,260,56,1,55,3,2
10,265,265,43,43,0,1,0
2,277,277,14,14,0,1,0
9,316,316,4,4,0,1,0
3,338,338,28,5,23,2,1
8,340,340,46,38,8,2,1
1,355,355,21,21,0,1,0
5,371,371,23,9,14,4,3

11,115,115,3,3,0,1,0
10,143,143,18,18,0,1,0
16,204,204,6,6,0,1,0
12,211,211,3,3,0,1,0
3,214,214,9,9,0,1,0
0,224,224,2,2,0,1,0
17,278,278,73,34,39,3,2
2,291,291,24,24,0,1,0
6,315,315,3,3,0,1,0
14,327,327,76,63,13,2,1
4,350,350,55,10,45,4,3
13,360,360,40,9,31,4,3
7,382,382,11,11,0,1,0
1,416,416,21,21,0,1,0
5,453,453,20,20,0,1,0
9,454,454,3,3,0,1,0
15,461,461,19,4,15,2,1
8,484,484,73,43,30,3,2

9,113,113,14,3,11,4,3
5,170,170,1,1,0,1,0
0,174,174,5,5,0,1,0
3,222,222,24,20,4,2,1
7,234,234,4,4,0,1,0
12,252,252,10,3,7,2,1
13,256,256,18,4,14,2,1
8,272,272,10,10,0,1,0
6,299,299,99,6,93,4,3
10,320,320,30,30,0,1,0
11,338,338,112,112,0,1,0
2,360,360,36,6,30,4,3
1,374,374,14,14,0,1,0
4,382,382,35,21,14,4,3

11,126,126,2,2,0,1,0
4,141,141,1,1,0,1,0
8,157,157,5,1,4,2,1
7,173,173,4,4,0,1,0
14,223,223,39,39,0,1,0
5,228,228,15,15,0,1,0
2,242,242,92,92,0,1,0
13,247,247,14,14,0,1,0
15,254,254,86,86,0,1,0
1,290,290,15,3,12,3,2
3,292,292,4,1,3,2,1
6,296,296,18,8,10,3,2
10,339,339,23,20,3,2,1
12,375,375,11,1,10,3,2
9,390,390,13,13,0,1,0
0,443,443,31,31,0,1,0

6,104,104,13,3,10,3,2
5,110,110,2,2,0,1,0
13,111,111,16,16,0,1,0
2,122,122,5,1,4,2,1
0,132,132,4,4,0,1,0
3,135,135,25,8,17,2,1
8,169,169,8,2,6,2,1
15,253,253,2,2,0,1,0
18,254,254,39,31,8,3,2
1,273,273,5,5,0,1,0
4,274,274,4,4,0,1,0
16,274,274,64,58,6,2,1
12,295,295,4,4,0,1,0
14,332,332,23,23,0,1,0
9,333,333,9,5,4,2,1
7,334,334,38,38,0,1,0
19,350,350,34,16,18,4,3
17,460,460,1,1,0,1,0
10,472,472,15,15,0,1,0
11,485,485,17,5,12,4,3

7,140,140,23,23,0,1,0
3,162,162,1,1,0,1,0
13,210,210,19,11,8,2,1
1,230,230,2,2,0,1,0
2,301,301,4,1,3,2,1
8,302,302,48,48,0,1,0
9,322,322,1,1,0,1,0
6,325,325,68,40,28,4,3
11,338,338,70,70,0,1,0
0,375,375,107,67,40,3,2
4,450,450,71,71,0,1,0
5,478,478,10,10,0,1,0
12,487,487,17,17,0,1,0
10,495,495,25,25,0,1,0

1,216,216,29,29,0,1,0
8,223,223,6,6,0,1,0
3,224,224,6,6,0,1,0
7,250,250,16,16,0,1,0
6,269,269,8,8,0,1,0
4,285,285,47,4,43,2,1
0,366,366,101,44,57,4,3
2,384,384,38,11,27,2,1
9,403,403,53,53,0,1,0
11,471,471,46,46,0,1,0
10,484,484,85,51,34,3,2
5,487,487,90,90,0,1,0

6,115,115,4,4,0,1,0
9,123,123,6,1,5,2,1
14,158,158,33,33,0,1,0
1,185,185,9,9,0,1,0
7,212,212,28,14,14,3,2
4,220,220,19,6,13,2,1
11,244,244,9,2,7,2,1
2,260,260,31,1,30,3,2
10,286,286,23,12,11,2,1
3,318,318,57,27,30,4,3
5,341,341,24,2,22,2,1
12,354,354,23,23,0,1,0
0,407,407,1,1,0,1,0
8,420,420,12,12,0,1,0
15,479,479,53,3,50,2,1
13,489,489,79,11,68,3,2

6,114,114,1,1,0,1,0
7,167,167,7,7,0,1,0
8,208,208,5,5,0,1,0
4,211,211,24,24,0,1,0
5,215,215,6,6,0,1,0
9,263,263,84,63,21,2,1
11,272,272,31,24,7,2,1
2,307,307,99,88,11,2,1
1,328,328,55,10,45,4,3
0,428,428,38,18,20,3,2
10,453,453,81,81,0,1,0
3,486,486,4,4,0,1,0

0,127,127,6,2,4,2,1
1,155,155,14,14,0,1,0
11,156,156,3,3,0,1,0
4,170,170,1,1,0,1,0
14,172,172,5,5,0,1,0
15,215,215,3,3,0,1,0
7,252,252,11,11,0,1,0
6,321,321,3,3,0,1,0
5,326,326,34,10,24,3,2
10,348,348,42,3,39,4,3
2,368,368,18,18,0,1,0
12,384,384,157,157,0,1,0
3,395,395,82,8,74,3,2
16,397,397,39,1,38,4,3
8,447,447,36,36,0,1,0
13,448,448,10,10,0,1,0
9,473,473,30,20,10,3,2

9,100,100,1,1,0,1,0
3,117,117,3,3,0,1,0
0,150,150,7,2,5,2,1
11,166,166,10,10,0,1,0
19,170,170,23,23,0,1,0
6,182,182,13,13,0,1,0
14,212,212,19,3,16,3,2
4,300,300,7,7,0,1,0
17,340,340,26,26,0,1,0
1,350,350,3,3,0,1,0
12,351,351,8,4,4,2,1
15,364,364,5,5,0,1,0
16,375,375,29,29,0,1,0
5,386,386,38,38,0,1,0
8,390,390,49,36,13,2,1
18,403,403,121,71,50,2,1
7,404,404,25,25,0,1,0
10,406,406,8,8,0,1,0
13,433,433,14,14,0,1,0
2,433,433,41,7,34,3,2
20,485,485,11,11,0,1,0

10,128,128,13,13,0,1,0
14,177,177,4,1,3,2,1
9,221,221,2,2,0,1,0
5,224,224,7,7,0,1,0
7,240,240,11,11,0,1,0
1,243,243,51,51,0,1,0
4,257,257,24,24,0,1,0
0,275,275,5,5,0,1,0
11,305,305,28,1,27,2,1
16,317,317,54,6,48,3,2
12,353,353,39,18,21,2,1
17,397,397,59,7,52,3,2
15,444,444,37,37,0,1,0
3,458,458,16,1,15,2,1
6,471,471,5,5,0,1,0
2,478,478,2,2,0,1,0
8,493,493,71,71,0,1,0
13,497,497,42,42,0,1,0

2,180,180,8,8,0,1,0
9,191,191,12,12,0,1,0
4,246,246,1,1,0,1,0
3,250,250,5,5,0,1,0
0,273,273,19,19,0,1,0
10,289,289,37,21,16,2,1
5,290,290,26,26,0,1,0
13,342,342,1,1,0,1,0
1,371,371,46,46,0,1,0
12,390,390,37,11,26,3,2
11,400,400,52,52,0,1,0
6,422,422,147,66,81,4,3
8,467,467,55,22,33,4,3
7,486,486,85,52,33,4,3

10,117,117,5,5,0,1,0
13,121,121,3,3,0,1,0
3,139,139,2,2,0,1,0
7,213,213,11,3,8,2,1
0,227,227,41,5,36,4,3
15,252,252,91,91,0,1,0
6,257,257,57,57,0,1,0
9,278,278,38,24,14,2,1
2,288,288,7,1,6,3,2
4,311,311,16,16,0,1,0
11,350,350,38,12,26,3,2
12,384,384,4,4,0,1,0
8,395,395,15,15,0,1,0
14,432,432,15,5,10,3,2
1,435,435,27,3,24,3,2
5,447,447,25,25,0,1,0

3,123,123,9,9,0,1,0
10,133,133,2,2,0,1,0
11,171,171,12,12,0,1,0
0,208,208,3,3,0,1,0
2,221,221,25,1,24,4,3
14,229,229,41,41,0,1,0
8,255,255,26,26,0,1,0
13,280,280,46,46,0,1,0
1,292,292,12,12,0,1,0
7,320,320,66,12,54,4,3
12,369,369,13,13,0,1,0
6,389,389,66,66,0,1,0
5,397,397,13,13,0,1,0
9,447,447,65,65,0,1,0
4,457,457,23,23,0,1,0

15,110,110,20,20,0,1,0
6,113,113,6,2,4,2,1
4,118,118,1,1,0,1,0
10,168,168,15,3,12,2,1
5,182,182,11,11,0,1,0
12,216,216,15,2,13,2,1
8,249,249,19,16,3,2,1
2,262,262,61,61,0,1,0
3,264,264,14,5,9,2,1
11,273,273,32,12,20,3,2
13,294,294,10,2,8,3,2
16,327,327,10,10,0,1,0
7,388,388,6,1,5,2,1
9,459,459,15,15,0,1,0
0,472,472,77,56,21,4,3
14,483,483,97,19,78,4,3
1,484,484,3,3,0,1,0

6,103,103,3,3,0,1,0
4,127,127,11,3,8,3,2
3,133,133,5,1,4,2,1
1,191,191,17,5,12,4,3
13,256,256,11,11,0,1,0
12,276,276,37,37,0,1,0
0,306,306,29,11,18,4,3
7,320,320,52,49,3,2,1
11,360,360,21,5,16,2,1
8,401,401,73,55,18,3,2
10,419,419,15,5,10,2,1
9,425,425,40,6,34,3,2
2,444,444,58,36,22,3,2
5,471,471,113,37,76,3,2

9,126,126,4,4,0,1,0
5,145,145,1,1,0,1,0
16,151,151,25,25,0,1,0
15,161,161,17,17,0,1,0
4,211,211,1,1,0,1,0
11,213,213,6,6,0,1,0
0,221,221,68,68,0,1,0
6,264,264,21,2,19,2,1
10,272,272,15,12,3,2,1
8,280,280,14,5,9,2,1
13,288,288,15,15,0,1,0
12,362,362,69,60,9,2,1
2,398,398,42,42,0,1,0
3,400,400,28,3,25,2,1
14,418,418,49,46,3,2,1
7,435,435,20,20,0,1,0
1,497,497,1,1,0,1,0

7,115,115,2,2,0,1,0
13,129,129,42,13,29,2,1
5,133,133,44,16,28,2,1
4,135,135,1,1,0,1,0
9,142,142,3,3,0,1,0
2,165,165,1,1,0,1,0
14,194,194,13,13,0,1,0
6,199,199,10,10,0,1,0
3,224,224,3,3,0,1,0
8,253,253,25,25,0,1,0
10,274,274,18,9,9,4,3
11,284,284,9,6,3,2,1
1,360,360,30,30,0,1,0
12,366,366,39,39,0,1,0
0,469,469,90,2,88,3,2

8,139,139,29,18,11,2,1
3,227,227,7,7,0,1,0
12,296,296,7,7,0,1,0
11,331,331,21,21,0,1,0
14,368,368,13,13,0,1,0
5,390,390,20,20,0,1,0
9,395,395,31,7,24,4,3
1,398,398,19,19,0,1,0
6,421,421,9,2,7,2,1
7,440,440,35,11,24,2,1
4,452,452,55,23,32,3,2
10,459,459,71,9,62,3,2
15,470,470,53,7,46,4,3
2,481,481,66,36,30,4,3
0,487,487,3,3,0,1,0
13,488,488,118,10,108,4,3

12,124,124,3,3,0,1,0
3,146,146,8,8,0,1,0
1,173,173,15,15,0,1,0
2,177,177,15,15,0,1,0
6,181,181,27,27,0,1,0
9,205,205,30,30,0,1,0
10,205,205,5,5,0,1,0
5,268,268,17,17,0,1,0
4,328,328,59,59,0,1,0
11,370,370,89,89,0,1,0
13,378,378,88,37,51,4,3
8,393,393,14,14,0,1,0
7,400,400,3,3,0,1,0
0,420,420,36,7,29,2,1

7,103,103,2,2,0,1,0
9,108,108,4,4,0,1,0
8,244,244,73,73,0,1,0
6,272,272,30,15,15,2,1
2,311,311,9,9,0,1,0
0,320,320,81,3,78,4,3
3,344,344,18,2,16,2,1
1,357,357,131,103,28,3,2
4,408,408,53,53,0,1,0
5,493,493,31,22,9,4,3
10,493,493,26,26,0,1,0

8,110,110,11,11,0,1,0
1,136,136,20,8,12,2,1
11,155,155,47,47,0,1,0
7,231,231,33,11,22,3,2
3,261,261,18,10,8,3,2
0,292,292,48,9,39,4,3
6,317,317,5,5,0,1,0
10,330,330,1,1,0,1,0
4,345,345,15,15,0,1,0
9,351,351,27,27,0,1,0
5,387,387,28,13,15,4,3
2,403,403,83,83,0,1,0
12,434,434,32,2,30,4,3

3,128,128,26,14,12,2,1
5,131,131,1,1,0,1,0
12,167,167,4,4,0,1,0
11,267,267,11,11,0,1,0
0,294,294,19,10,9,4,3
13,329,329,5,5,0,1,0
4,374,374,27,11,16,3,2
9,376,376,37,18,19,2,1
10,376,376,30,30,0,1,0
8,395,395,75,75,0,1,0
6,405,405,19,19,0,1,0
1,410,410,61,61,0,1,0
7,488,488,130,59,71,4,3
2,490,490,77,77,0,1,0

17,104,104,1,1,0,1,0
14,105,105,42,30,12,3,2
9,168,168,10,4,6,3,2
8,194,194,32,32,0,1,0
13,207,207,20,20,0,1,0
2,241,241,18,6,12,3,2
3,265,265,3,3,0,1,0
16,303,303,13,1,12,4,3
6,316,316,7,7,0,1,0
10,346,346,20,12,8,3,2
18,348,348,17,9,8,3,2
12,364,364,32,10,22,3,2
0,377,377,21,6,15,2,1
4,396,396,18,5,13,2,1
7,408,408,64,64,0,1,0
11,409,409,12,2,10,3,2
1,411,411,5,5,0,1,0
5,487,487,5,5,0,1,0
15,491,491,17,17,0,1,0

13,109,109,16,4,12,4,3
2,122,122,6,6,0,1,0
10,147,147,13,5,8,2,1
7,196,196,73,67,6,3,2
8,213,213,9,6,3,2,1
9,223,223,7,7,0,1,0
5,290,290,17,17,0,1,0
11,292,292,17,17,0,1,0
1,298,298,19,19,0,1,0
12,307,307,59,16,43,3,2
3,427,427,3,3,0,1,0
14,473,473,72,57,15,4,3
0,486,486,8,8,0,1,0
6,492,492,1,1,0,1,0
4,495,495,65,21,44,3,2

3,115,115,18,6,12,4,3
8,126,126,21,3,18,3,2
4,131,131,3,3,0,1,0
0,141,141,8,8,0,1,0
2,145,145,1,1,0,1,0
10,146,146,1,1,0,1,0
5,147,147,1,1,0,1,0
12,180,180,9,2,7,2,1
16,199,199,69,69,0,1,0
15,203,203,7,7,0,1,0
7,219,219,8,8,0,1,0
6,288,288,9,1,8,3,2
1,351,351,2,2,0,1,0
14,366,366,7,7,0,1,0
11,384,384,45,3,42,4,3
13,397,397,58,55,3,2,1
9,430,430,91,13,78,3,2

9,116,116,11,11,0,1,0
4,190,190,9,9,0,1,0
10,191,191,9,1,8,3,2
8,232,232,14,14,0,1,0
1,252,252,13,1,12,2,1
0,304,304,12,12,0,1,0
3,348,348,123,123,0,1,0
2,359,359,92,92,0,1,0
5,369,369,43,43,0,1,0
7,380,380,102,21,81,4,3
6,475,475,40,34,6,3,2

3,115,115,12,12,0,1,0
15,121,121,24,24,0,1,0
12,178,178,24,4,20,2,1
2,204,204,12,3,9,4,3
6,248,248,32,12,20,2,1
8,249,249,2,2,0,1,0
5,257,257,20,10,10,3,2
10,300,300,32,32,0,1,0
13,308,308,20,20,0,1,0
7,356,356,5,5,0,1,0
17,359,359,43,15,28,3,2
11,367,367,2,2,0,1,0
18,376,376,30,6,24,3,2
9,385,385,23,23,0,1,0
4,404,404,6,3,3,2,1
14,420,420,42,42,0,1,0
0,461,461,36,15,21,2,1
16,473,473,5,5,0,1,0
1,492,492,22,22,0,1,0

15,105,105,14,14,0,1,0
4,118,118,1,1,0,1,0
2,124,124,1,1,0,1,0
14,147,147,22,22,0,1,0
13,154,154,16,2,14,4,3
6,171,171,63,42,21,4,3
5,185,185,3,3,0,1,0
12,197,197,16,10,6,2,1
10,305,305,42,6,36,3,2
1,351,351,5,2,3,2,1
16,370,370,21,21,0,1,0
9,377,377,35,5,30,4,3
11,383,383,21,21,0,1,0
3,427,427,31,31,0,1,0
7,447,447,17,8,9,4,3
0,461,461,2,2,0,1,0
8,474,474,37,37,0,1,0

12,133,133,25,25,0,1,0
8,227,227,13,1,12,3,2
3,315,315,28,10,18,3,2
9,327,327,58,58,0,1,0
2,338,338,60,60,0,1,0
0,345,345,10,10,0,1,0
13,365,365,11,11,0,1,0
4,392,392,53,36,17,2,1
10,395,395,3,3,0,1,0
11,401,401,62,62,0,1,0
5,441,441,17,17,0,1,0
1,451,451,2,2,0,1,0
7,458,458,42,12,30,3,2
6,481,481,109,109,0,1,0

0,176,176,11,11,0,1,0
12,179,179,11,11,0,1,0
8,210,210,17,17,0,1,0
11,211,211,31,19,12,3,2
2,246,246,8,8,0,1,0
13,269,269,65,29,36,4,3
10,327,327,59,59,0,1,0
1,343,343,4,4,0,1,0
15,344,344,17,8,9,2,1
4,357,357,58,19,39,4,3
5,360,360,16,13,3,2,1
6,394,394,68,52,16,3,2
9,407,407,4,1,3,2,1
3,423,423,33,20,13,2,1
7,437,437,26,21,5,2,1
14,478,478,11,11,0,1,0

9,138,138,12,6,6,3,2
11,181,181,10,4,6,2,1
7,203,203,12,2,10,2,1
6,273,273,31,31,0,1,0
5,321,321,5,5,0,1,0
3,357,357,55,23,32,2,1
2,366,366,88,88,0,1,0
13,368,368,58,46,12,3,2
0,371,371,24,24,0,1,0
8,385,385,27,9,18,3,2
12,392,392,107,107,0,1,0
4,394,394,19,4,15,2,1
1,443,443,29,18,11,2,1
10,463,463,6,6,0,1,0

6,165,165,12,12,0,1,0
2,166,166,10,3,7,3,2
0,220,220,3,3,0,1,0
7,236,236,15,3,12,2,1
8,237,237,6,6,0,1,0
4,271,271,46,25,21,4,3
3,320,320,67,42,25,2,1
5,360,360,33,17,16,3,2
9,384,384,32,32,0,1,0
1,492,492,310,224,86,3,2

5,100,100,5,5,0,1,0
4,131,131,19,10,9,2,1
12,142,142,14,3,11,2,1
9,143,143,12,12,0,1,0
13,148,148,23,23,0,1,0
7,201,201,16,16,0,1,0
3,239,239,49,10,39,3,2
6,239,239,1,1,0,1,0
14,280,280,36,36,0,1,0
2,310,310,54,32,22,2,1
0,311,311,13,4,9,2,1
8,327,327,44,28,16,2,1
1,446,446,2,2,0,1,0
11,477,477,39,28,11,2,1
10,486,486,16,16,0,1,0

5,104,104,4,4,0,1,0
1,161,161,32,32,0,1,0
6,213,213,5,5,0,1,0
7,232,232,3,3,0,1,0
9,232,232,52,45,7,2,1
4,265,265,6,1,5,2,1
3,275,275,25,11,14,3,2
12,332,332,87,43,44,2,1
11,350,350,28,12,16,2,1
2,353,353,61,21,40,3,2
8,362,362,8,8,0,1,0
0,395,395,70,19,51,3,2
10,487,487,42,33,9,4,3

9,107,107,10,10,0,1,0
8,142,142,39,39,0,1,0
0,170,170,37,30,7,2,1
4,191,191,44,7,37,2,1
12,224,224,15,1,14,2,1
3,227,227,7,7,0,1,0
6,241,241,38,9,29,2,1
11,375,375,3,3,0,1,0
1,387,387,22,10,12,3,2
7,424,424,41,41,0,1,0
2,464,464,40,4,36,3,2
10,490,490,9,6,3,2,1
5,495,495,39,6,33,2,1

9,148,148,23,15,8,2,1
10,175,175,21,16,5,2,1
5,193,193,20,10,10,2,1
8,221,221,4,4,0,1,0
14,252,252,6,1,5,2,1
1,253,253,6,6,0,1,0
0,269,269,21,21,0,1,0
2,289,289,3,3,0,1,0
4,297,297,33,33,0,1,0
7,302,302,81,49,32,3,2
13,353,353,57,31,26,2,1
3,408,408,12,9,3,2,1
11,419,419,97,59,38,2,1
15,427,427,3,3,0,1,0
6,428,428,25,9,16,2,1
12,496,496,7,7,0,1,0

11,147,147,45,13,32,3,2
10,163,163,5,5,0,1,0
3,279,279,7,7,0,1,0
13,279,279,3,3,0,1,0
1,308,308,24,24,0,1,0
8,339,339,26,5,21,3,2
7,378,378,41,41,0,1,0
4,381,381,3,3,0,1,0
12,381,381,25,16,9,2,1
9,388,388,44,34,10,3,2
0,392,392,25,10,15,4,3
5,396,396,83,79,4,2,1
2,436,436,18,18,0,1,0
6,492,492,136,127,9,2,1

7,129,129,7,7,0,1,0
14,157,157,39,27,12,4,3
13,194,194,5,5,0,1,0
12,196,196,37,37,0,1,0
5,230,230,13,2,11,2,1
4,306,306,2,2,0,1,0
0,317,317,10,10,0,1,0
8,317,317,38,8,30,3,2
10,342,342,22,4,18,4,3
1,351,351,76,65,11,2,1
9,366,366,61,15,46,2,1
11,397,397,4,4,0,1,0
6,411,411,15,15,0,1,0
15,418,418,5,5,0,1,0
2,458,458,22,1,21,4,3
3,475,475,63,63,0,1,0

7,124,124,5,5,0,1,0
10,130,130,1,1,0,1,0
5,171,171,4,4,0,1,0
14,183,183,21,21,0,1,0
13,274,274,29,29,0,1,0
9,332,332,15,15,0,1,0
15,335,335,29,17,12,2,1
0,347,347,61,61,0,1,0
12,347,347,74,46,28,2,1
2,381,381,23,23,0,1,0
4,383,383,82,4,78,4,3
1,415,415,13,4,9,2,1
11,420,420,59,40,19,2,1
8,421,421,16,16,0,1,0
6,427,427,8,2,6,2,1
3,436,436,43,43,0,1,0

1,113,113,1,1,0,1,0
0,121,121,51,51,0,1,0
2,207,207,4,4,0,1,0
9,209,209,16,16,0,1,0
3,235,235,23,23,0,1,0
7,247,247,2,2,0,1,0
10,270,270,12,12,0,1,0
11,354,354,42,39,3,2,1
8,372,372,78,58,20,3,2
13,397,397,61,52,9,4,3
12,400,400,42,2,40,2,1
6,448,448,7,7,0,1,0
5,478,478,35,35,0,1,0
4,495,495,32,11,21,2,1

6,100,100,1,1,0,1,0
13,127,127,3,3,0,1,0
9,138,138,26,26,0,1,0
8,153,153,8,8,0,1,0
5,217,217,19,19,0,1,0
10,219,219,19,2,17,2,1
14,247,247,21,7,14,3,2
1,390,390,7,1,6,3,2
12,407,407,106,99,7,2,1
7,422,422,23,4,19,2,1
11,435,435,13,13,0,1,0
3,449,449,71,31,40,3,2
4,453,453,32,14,18,3,2
2,489,489,125,125,0,1,0
0,494,494,23,18,5,2,1

4,157,157,13,13,0,1,0
6,160,160,1,1,0,1,0
13,181,181,3,3,0,1,0
2,195,195,37,20,17,2,1
9,226,226,66,66,0,1,0
10,249,249,7,7,0,1,0
3,261,261,3,3,0,1,0
12,359,359,30,30,0,1,0
5,362,362,24,24,0,1,0
11,367,367,11,2,9,3,2
14,379,379,97,97,0,1,0
8,385,385,17,9,8,3,2
0,388,388,101,101,0,1,0
15,451,451,2,2,0,1,0
1,454,454,1,1,0,1,0
7,492,492,19,19,0,1,0

10,134,134,15,15,0,1,0
5,168,168,5,5,0,1,0
6,171,171,18,1,17,4,3
11,198,198,17,17,0,1,0
8,208,208,14,9,5,2,1
2,214,214,3,3,0,1,0
0,251,251,18,18,0,1,0
3,292,292,109,109,0,1,0
4,324,324,75,38,37,2,1
9,390,390,66,66,0,1,0
1,408,408,5,2,3,2,1
7,425,425,62,2,60,4,3

11,123,123,42,42,0,1,0
9,182,182,1,1,0,1,0
4,186,186,35,35,0,1,0
10,221,221,18,3,15,4,3
8,231,231,3,3,0,1,0
12,270,270,45,27,18,2,1
3,311,311,2,2,0,1,0
13,345,345,27,27,0,1,0
15,372,372,10,10,0,1,0
14,385,385,8,8,0,1,0
0,410,410,3,3,0,1,0
5,411,411,7,1,6,3,2
1,414,414,31,9,22,2,1
7,441,441,144,96,48,3,2
6,472,472,27,21,6,3,2
2,476,476,6,6,0,1,0

9,124,124,3,3,0,1,0
12,147,147,7,2,5,2,1
15,164,164,29,29,0,1,0
5,204,204,4,4,0,1,0
8,337,337,27,4,23,4,3
2,347,347,28,28,0,1,0
7,370,370,13,13,0,1,0
3,376,376,152,54,98,4,3
0,396,396,13,7,6,2,1
6,398,398,4,4,0,1,0
14,407,407,53,53,0,1,0
13,407,407,21,21,0,1,0
4,413,413,2,2,0,1,0
10,426,426,114,33,81,4,3
16,426,426,6,2,4,2,1
1,441,441,5,5,0,1,0
11,484,484,13,13,0,1,0

12,111,111,1,1,0,1,0
2,121,121,1,1,0,1,0
13,121,121,36,17,19,3,2
10,129,129,3,3,0,1,0
7,144,144,19,19,0,1,0
1,183,183,88,49,39,4,3
6,207,207,5,5,0,1,0
0,267,267,4,4,0,1,0
8,310,310,45,45,0,1,0
3,352,352,3,3,0,1,0
5,376,376,25,25,0,1,0
4,401,401,39,39,0,1,0
11,426,426,48,2,46,3,2
9,460,460,1,1,0,1,0

8,105,105,27,23,4,2,1
1,118,118,4,4,0,1,0
16,161,161,14,14,0,1,0
3,182,182,1,1,0,1,0
11,190,190,1,1,0,1,0
6,197,197,24,16,8,3,2
10,220,220,71,39,32,3,2
13,238,238,17,4,13,2,1
15,293,293,10,6,4,2,1
12,302,302,28,19,9,4,3
7,331,331,3,3,0,1,0
14,348,348,36,36,0,1,0
5,367,367,31,31,0,1,0
0,368,368,19,19,0,1,0
2,417,417,10,2,8,2,1
9,428,428,36,36,0,1,0
4,441,441,13,5,8,3,2

10,102,102,19,7,12,2,1
1,102,102,7,1,6,2,1
16,108,108,5,1,4,2,1
3,133,133,3,3,0,1,0
14,141,141,7,7,0,1,0
8,151,151,19,19,0,1,0
11,217,217,6,6,0,1,0
5,238,238,27,6,21,2,1
0,250,250,2,2,0,1,0
9,279,279,53,53,0,1,0
12,300,300,103,7,96,4,3
6,302,302,18,18,0,1,0
4,361,361,4,4,0,1,0
13,367,367,15,7,8,3,2
7,379,379,36,36,0,1,0
2,390,390,3,3,0,1,0
15,491,491,13,13,0,1,0

2,115,115,21,6,15,3,2
5,135,135,1,1,0,1,0
15,137,137,10,10,0,1,0
12,162,162,5,5,0,1,0
17,171,171,36,36,0,1,0
9,242,242,10,10,0,1,0
11,251,251,21,4,17,2,1
6,282,282,12,12,0,1,0
20,284,284,43,13,30,2,1
16,286,286,8,1,7,2,1
7,333,333,3,3,0,1,0
18,337,337,12,12,0,1,0
0,338,338,1,1,0,1,0
10,370,370,7,7,0,1,0
3,370,370,12,4,8,2,1
1,375,375,71,71,0,1,0
19,375,375,7,7,0,1,0
14,405,405,78,11,67,4,3
13,457,457,4,1,3,2,1
4,460,460,20,20,0,1,0
8,479,479,4,4,0,1,0

4,131,131,4,1,3,2,1
3,133,133,24,24,0,1,0
11,186,186,45,45,0,1,0
1,187,187,32,32,0,1,0
9,192,192,3,3,0,1,0
10,214,214,43,43,0,1,0
0,217,217,1,1,0,1,0
2,224,224,13,13,0,1,0
13,304,304,1,1,0,1,0
12,351,351,47,47,0,1,0
7,404,404,63,63,0,1,0
14,405,405,36,36,0,1,0
6,438,438,43,6,37,2,1
5,442,442,1,1,0,1,0
8,462,462,12,12,0,1,0

6,164,164,2,2,0,1,0
2,219,219,68,50,18,4,3
9,227,227,9,2,7,2,1
3,237,237,37,12,25,2,1
8,247,247,19,19,0,1,0
1,303,303,19,11,8,2,1
5,326,326,21,21,0,1,0
10,328,328,40,35,5,2,1
4,389,389,85,25,60,4,3
7,389,389,72,72,0,1,0
0,487,487,85,72,13,2,1

5,102,102,34,34,0,1,0
12,110,110,11,11,0,1,0
10,151,151,7,7,0,1,0
2,163,163,13,13,0,1,0
8,164,164,2,2,0,1,0
0,173,173,1,1,0,1,0
3,228,228,10,10,0,1,0
13,229,229,59,54,5,2,1
1,285,285,10,10,0,1,0
15,298,298,31,11,20,3,2
9,335,335,23,23,0,1,0
7,356,356,11,11,0,1,0
11,388,388,29,8,21,4,3
6,406,406,17,5,12,4,3
4,426,426,52,52,0,1,0
14,476,476,31,2,29,2,1

12,102,102,8,8,0,1,0
10,143,143,20,3,17,2,1
11,184,184,18,18,0,1,0
5,191,191,9,9,0,1,0
9,234,234,2,2,0,1,0
2,266,266,13,4,9,2,1
3,267,267,12,6,6,3,2
8,269,269,6,6,0,1,0
7,313,313,45,45,0,1,0
4,314,314,166,128,38,3,2
1,357,357,1,1,0,1,0
0,381,381,12,3,9,4,3
6,490,490,108,62,46,2,1

9,116,116,21,21,0,1,0
4,135,135,2,2,0,1,0
8,235,235,65,65,0,1,0
7,251,251,1,1,0,1,0
11,261,261,8,8,0,1,0
5,279,279,33,24,9,4,3
2,310,310,61,8,53,4,3
0,318,318,25,3,22,3,2
6,318,318,13,13,0,1,0
10,326,326,21,5,16,3,2
1,353,353,117,93,24,4,3
3,367,367,31,5,26,4,3

9,140,140,4,4,0,1,0
8,160,160,27,6,21,4,3
1,165,165,24,24,0,1,0
6,179,179,10,3,7,2,1
5,230,230,6,1,5,2,1
4,300,300,9,9,0,1,0
10,343,343,13,4,9,4,3
2,360,360,23,23,0,1,0
11,379,379,13,13,0,1,0
7,410,410,148,148,0,1,0
0,445,445,132,94,38,2,1
3,454,454,75,9,66,4,3

7,107,107,9,9,0,1,0
10,110,110,2,2,0,1,0
5,145,145,6,1,5,2,1
12,153,153,53,5,48,3,2
4,192,192,17,5,12,4,3
11,204,204,18,18,0,1,0
3,238,238,26,26,0,1,0
13,319,319,47,17,30,3,2
14,319,319,25,25,0,1,0
2,356,356,64,40,24,3,2
8,369,369,1,1,0,1,0
0,385,385,33,27,6,3,2
9,405,405,14,2,12,3,2
6,417,417,39,5,34,4,3
1,493,493,9,3,6,2,1

1,154,154,17,5,12,4,3
10,155,155,48,48,0,1,0
4,177,177,9,9,0,1,0
3,178,178,10,3,7,2,1
2,189,189,22,22,0,1,0
13,190,190,11,11,0,1,0
11,299,299,5,1,4,2,1
7,321,321,18,18,0,1,0
8,357,357,35,23,12,4,3
15,374,374,38,38,0,1,0
14,401,401,38,9,29,3,2
0,412,412,30,19,11,2,1
6,430,430,18,18,0,1,0
5,486,486,48,22,26,3,2
9,488,488,19,7,12,3,2
12,496,496,44,5,39,4,3

9,125,125,16,10,6,2,1
6,263,263,24,12,12,4,3
8,272,272,2,2,0,1,0
1,274,274,70,70,0,1,0
0,288,288,6,6,0,1,0
4,311,311,15,15,0,1,0
11,345,345,22,4,18,2,1
5,376,376,98,98,0,1,0
7,386,386,35,21,14,3,2
10,414,414,27,24,3,2,1
3,439,439,60,60,0,1,0
2,493,493,118,40,78,4,3

2,186,186,1,1,0,1,0
11,232,232,33,33,0,1,0
12,319,319,72,72,0,1,0
4,340,340,11,6,5,2,1
7,346,346,26,20,6,2,1
9,351,351,54,54,0,1,0
8,364,364,3,3,0,1,0
3,435,435,33,28,5,2,1
10,443,443,16,16,0,1,0
6,457,457,9,9,0,1,0
1,459,459,28,19,9,3,2
5,471,471,143,143,0,1,0
13,471,471,35,24,11,2,1
0,481,481,98,16,82,3,2

10,103,103,11,2,9,4,3
14,106,106,20,2,18,3,2
6,122,122,10,2,8,2,1
8,149,149,16,4,12,2,1
12,189,189,6,2,4,2,1
18,202,202,23,23,0,1,0
17,202,202,24,24,0,1,0
2,217,217,5,5,0,1,0
4,227,227,1,1,0,1,0
9,233,233,7,7,0,1,0
3,259,259,1,1,0,1,0
1,274,274,40,19,21,2,1
0,286,286,6,2,4,2,1
15,288,288,34,34,0,1,0
5,372,372,2,2,0,1,0
16,375,375,1,1,0,1,0
7,407,407,46,6,40,3,2
19,416,416,21,21,0,1,0
11,437,437,12,6,6,2,1
13,493,493,58,32,26,2,1

17,102,102,8,8,0,1,0
1,110,110,29,20,9,4,3
0,156,156,1,1,0,1,0
9,164,164,9,9,0,1,0
5,179,179,1,1,0,1,0
4,202,202,5,2,3,2,1
2,243,243,11,11,0,1,0
14,258,258,15,15,0,1,0
15,259,259,7,7,0,1,0
13,267,267,54,29,25,4,3
12,298,298,5,5,0,1,0
7,303,303,8,8,0,1,0
18,331,331,55,19,36,4,3
11,357,357,1,1,0,1,0
3,402,402,23,15,8,2,1
10,408,408,33,33,0,1,0
8,424,424,26,26,0,1,0
16,455,455,49,39,10,2,1
19,460,460,37,37,0,1,0
6,494,494,28,1,27,2,1

0,117,117,1,1,0,1,0
7,135,135,3,3,0,1,0
1,235,235,40,16,24,3,2
6,283,283,30,30,0,1,0
9,287,287,38,38,0,1,0
10,311,311,33,33,0,1,0
5,347,347,31,12,19,4,3
3,348,348,65,11,54,3,2
2,377,377,19,13,6,3,2
13,377,377,7,7,0,1,0
8,388,388,25,9,16,2,1
4,394,394,35,8,27,4,3
12,447,447,48,2,46,3,2
11,496,496,131,62,69,3,2

13,120,120,21,9,12,4,3
8,181,181,10,10,0,1,0
2,221,221,21,1,20,2,1
0,227,227,2,2,0,1,0
1,259,259,52,52,0,1,0
3,269,269,39,39,0,1,0
6,276,276,13,13,0,1,0
4,361,361,48,48,0,1,0
9,369,369,62,62,0,1,0
5,370,370,27,27,0,1,0
7,391,391,101,101,0,1,0
12,393,393,8,8,0,1,0
11,399,399,7,1,6,3,2
10,429,429,6,6,0,1,0

7,109,109,16,1,15,4,3
12,149,149,28,28,0,1,0
3,184,184,7,7,0,1,0
11,241,241,3,3,0,1,0
10,249,249,2,2,0,1,0
8,255,255,39,39,0,1,0
0,308,308,84,48,36,4,3
5,319,319,6,6,0,1,0
1,327,327,46,26,20,3,2
9,341,341,44,44,0,1,0
6,425,425,32,32,0,1,0
2,459,459,54,54,0,1,0
4,485,485,55,7,48,3,2

4,101,101,9,5,4,2,1
8,101,101,2,2,0,1,0
7,140,140,3,3,0,1,0
16,150,150,9,3,6,3,2
17,152,152,21,5,16,3,2
6,188,188,2,2,0,1,0
19,194,194,22,12,10,3,2
18,216,216,30,30,0,1,0
10,240,240,2,2,0,1,0
2,272,272,30,10,20,3,2
1,321,321,1,1,0,1,0
0,367,367,20,10,10,2,1
11,372,372,15,4,11,2,1
9,393,393,41,41,0,1,0
15,471,471,26,19,7,2,1
3,473,473,25,25,0,1,0
14,474,474,26,26,0,1,0
5,481,481,53,32,21,4,3
12,482,482,37,23,14,2,1
13,500,500,77,77,0,1,0

4,144,144,53,45,8,2,1
6,178,178,7,7,0,1,0
12,242,242,10,10,0,1,0
5,256,256,14,3,11,2,1
7,277,277,19,19,0,1,0
9,327,327,92,44,48,4,3
13,335,335,36,25,11,2,1
11,339,339,17,17,0,1,0
2,427,427,20,20,0,1,0
1,447,447,55,33,22,3,2
8,449,449,48,48,0,1,0
10,456,456,26,26,0,1,0
0,475,475,21,2,19,2,1
3,491,491,12,8,4,2,1

10,101,101,6,2,4,2,1
11,127,127,22,12,10,3,2
3,142,142,26,26,0,1,0
7,155,155,4,4,0,1,0
0,164,164,11,11,0,1,0
2,252,252,9,1,8,2,1
12,321,321,57,51,6,3,2
6,348,348,8,8,0,1,0
8,365,365,89,19,70,3,2
4,370,370,72,72,0,1,0
1,384,384,47,47,0,1,0
5,401,401,39,39,0,1,0
9,435,435,8,8,0,1,0

3,140,140,20,20,0,1,0
13,171,171,13,13,0,1,0
2,178,178,13,4,9,2,1
11,186,186,13,4,9,2,1
12,271,271,27,16,11,3,2
0,305,305,75,11,64,3,2
4,358,358,25,25,0,1,0
5,366,366,4,4,0,1,0
1,375,375,11,6,5,2,1
7,377,377,11,3,8,3,2
6,418,418,54,27,27,4,3
8,486,486,28,14,14,2,1
10,491,491,61,61,0,1,0
9,493,493,127,97,30,2,1

11,140,140,3,3,0,1,0
9,158,158,17,3,14,2,1
10,158,158,18,18,0,1,0
0,168,168,25,4,21,4,3
3,177,177,25,25,0,1,0
7,225,225,46,46,0,1,0
13,251,251,61,61,0,1,0
8,284,284,9,9,0,1,0
14,346,346,63,58,5,2,1
12,418,418,15,15,0,1,0
5,421,421,9,2,7,2,1
2,427,427,10,10,0,1,0
6,448,448,17,3,14,2,1
4,457,457,37,37,0,1,0
1,461,461,5,5,0,1,0
15,463,463,4,4,0,1,0

15,145,145,6,1,5,2,1
8,181,181,16,16,0,1,0
12,186,186,43,43,0,1,0
2,188,188,29,29,0,1,0
9,249,249,17,17,0,1,0
13,256,256,11,2,9,2,1
11,307,307,28,28,0,1,0
1,325,325,35,35,0,1,0
4,363,363,17,17,0,1,0
6,429,429,79,65,14,3,2
0,438,438,14,7,7,2,1
5,444,444,29,29,0,1,0
14,455,455,84,26,58,4,3
3,464,464,4,4,0,1,0
7,479,479,8,8,0,1,0
10,479,479,27,27,0,1,0

6,105,105,19,19,0,1,0
3,150,150,5,5,0,1,0
11,167,167,7,1,6,3,2
9,188,188,28,25,3,2,1
5,211,211,32,21,11,3,2
4,240,240,24,24,0,1,0
13,271,271,24,24,0,1,0
10,311,311,59,38,21,2,1
1,322,322,27,27,0,1,0
7,360,360,7,7,0,1,0
8,366,366,48,48,0,1,0
0,389,389,3,3,0,1,0
12,448,448,43,1,42,3,2
2,488,488,74,74,0,1,0

9,103,103,1,1,0,1,0
8,107,107,9,3,6,2,1
19,126,126,24,24,0,1,0
11,136,136,5,5,0,1,0
10,168,168,4,4,0,1,0
7,179,179,9,9,0,1,0
17,220,220,48,36,12,2,1
0,220,220,13,13,0,1,0
3,222,222,2,2,0,1,0
4,246,246,19,14,5,2,1
15,251,251,19,19,0,1,0
5,265,265,4,4,0,1,0
2,291,291,15,15,0,1,0
14,322,322,20,20,0,1,0
16,345,345,10,10,0,1,0
12,359,359,3,3,0,1,0
6,405,405,80,42,38,4,3
13,405,405,39,39,0,1,0
1,426,426,33,13,20,3,2
18,443,443,19,19,0,1,0

6,119,119,2,2,0,1,0
9,144,144,5,5,0,1,0
14,190,190,12,4,8,2,1
7,198,198,3,3,0,1,0
13,228,228,3,3,0,1,0
2,230,230,88,88,0,1,0
3,230,230,3,3,0,1,0
1,263,263,3,3,0,1,0
17,293,293,47,47,0,1,0
11,322,322,39,32,7,2,1
16,356,356,65,65,0,1,0
12,374,374,47,47,0,1,0
0,379,379,29,7,22,4,3
8,416,416,16,16,0,1,0
4,419,419,12,12,0,1,0
10,457,457,14,14,0,1,0
5,463,463,25,21,4,2,1
15,474,474,19,1,18,4,3

1,119,119,4,4,0,1,0
0,161,161,8,5,3,2,1
16,174,174,4,4,0,1,0
2,174,174,19,7,12,4,3
6,182,182,15,15,0,1,0
4,213,213,4,4,0,1,0
3,216,216,11,2,9,4,3
8,235,235,21,21,0,1,0
9,267,267,11,3,8,2,1
12,282,282,12,12,0,1,0
5,288,288,65,21,44,3,2
14,332,332,68,34,34,2,1
10,336,336,11,11,0,1,0
15,368,368,25,16,9,4,3
13,395,395,109,109,0,1,0
11,417,417,27,16,11,2,1
7,470,470,1,1,0,1,0

3,106,106,35,4,31,4,3
2,108,108,4,4,0,1,0
5,117,117,6,6,0,1,0
10,127,127,16,16,0,1,0
7,149,149,2,2,0,1,0
8,218,218,11,3,8,2,1
9,221,221,9,9,0,1,0
6,226,226,13,13,0,1,0
4,280,280,40,28,12,2,1
0,328,328,2,2,0,1,0
12,358,358,44,44,0,1,0
11,373,373,89,89,0,1,0
13,382,382,47,47,0,1,0
14,400,400,22,8,14,2,1
1,460,460,6,3,3,2,1
15,485,485,1,1,0,1,0

11,131,131,1,1,0,1,0
0,146,146,2,2,0,1,0
12,185,185,34,16,18,3,2
13,198,198,38,9,29,2,1
7,206,206,9,4,5,2,1
2,230,230,8,5,3,2,1
10,267,267,2,2,0,1,0
5,301,301,14,14,0,1,0
4,335,335,59,37,22,4,3
9,344,344,5,5,0,1,0
6,419,419,69,69,0,1,0
14,460,460,58,24,34,2,1
3,469,469,95,53,42,4,3
8,482,482,90,90,0,1,0
1,486,486,10,10,0,1,0

7,136,136,9,9,0,1,0
10,145,145,9,9,0,1,0
0,147,147,6,6,0,1,0
14,165,165,32,16,16,2,1
4,170,170,6,6,0,1,0
15,175,175,4,4,0,1,0
2,185,185,1,1,0,1,0
12,209,209,2,2,0,1,0
9,214,214,28,13,15,4,3
8,288,288,5,1,4,2,1
1,303,303,48,48,0,1,0
6,314,314,49,28,21,4,3
13,333,333,95,49,46,3,2
5,355,355,10,4,6,3,2
16,401,401,48,31,17,4,3
3,411,411,27,27,0,1,0
11,457,457,11,11,0,1,0

1,153,153,16,16,0,1,0
3,189,189,6,6,0,1,0
9,198,198,5,5,0,1,0
6,201,201,16,9,7,2,1
0,318,318,40,2,38,3,2
8,383,383,24,24,0,1,0
7,394,394,74,54,20,2,1
4,441,441,6,6,0,1,0
5,463,463,144,17,127,4,3
2,486,486,229,229,0,1,0

7,157,157,2,2,0,1,0
3,167,167,48,48,0,1,0
2,182,182,8,8,0,1,0
9,221,221,40,26,14,2,1
0,277,277,66,66,0,1,0
10,304,304,3,3,0,1,0
8,341,341,6,6,0,1,0
5,344,344,61,61,0,1,0
4,365,365,15,15,0,1,0
6,495,495,136,29,107,4,3
1,498,498,66,52,14,3,2

8,161,161,1,1,0,1,0
2,180,180,15,4,11,2,1
12,228,228,6,3,3,2,1
10,233,233,9,9,0,1,0
4,282,282,5,5,0,1,0
0,284,284,2,2,0,1,0
13,300,300,53,50,3,2,1
16,302,302,78,54,24,2,1
6,335,335,1,1,0,1,0
5,343,343,12,12,0,1,0
11,343,343,6,3,3,2,1
9,352,352,82,6,76,3,2
17,355,355,38,38,0,1,0
3,356,356,13,13,0,1,0
15,391,391,4,4,0,1,0
7,428,428,23,23,0,1,0
1,486,486,91,91,0,1,0
14,490,490,55,55,0,1,0

7,109,109,10,10,0,1,0
3,153,153,17,17,0,1,0
11,154,154,7,1,6,2,1
4,187,187,1,1,0,1,0
12,187,187,30,30,0,1,0
6,188,188,41,13,28,3,2
9,194,194,19,19,0,1,0
1,221,221,19,19,0,1,0
5,233,233,12,2,10,2,1
0,276,276,4,4,0,1,0
2,312,312,68,28,40,4,3
13,344,344,12,12,0,1,0
10,422,422,67,22,45,4,3
8,425,425,56,56,0,1,0

8,107,107,10,3,7,2,1
2,180,180,11,11,0,1,0
12,226,226,24,14,10,2,1
3,286,286,70,70,0,1,0
9,294,294,52,34,18,2,1
0,295,295,25,6,19,2,1
4,357,357,11,11,0,1,0
11,368,368,60,6,54,3,2
1,387,387,67,67,0,1,0
7,388,388,9,9,0,1,0
13,402,402,43,43,0,1,0
10,414,414,19,13,6,2,1
5,418,418,19,6,13,2,1
6,474,474,29,29,0,1,0

4,178,178,1,1,0,1,0
6,187,187,24,5,19,3,2
3,217,217,3,3,0,1,0
16,217,217,7,7,0,1,0
7,261,261,39,39,0,1,0
15,262,262,75,45,30,2,1
12,265,265,2,2,0,1,0
2,268,268,10,10,0,1,0
11,273,273,3,3,0,1,0
8,284,284,26,13,13,2,1
10,296,296,4,4,0,1,0
14,308,308,104,86,18,2,1
17,317,317,7,7,0,1,0
5,333,333,21,21,0,1,0
13,334,334,6,3,3,2,1
9,345,345,39,26,13,3,2
1,437,437,6,6,0,1,0
0,467,467,34,34,0,1,0

11,136,136,15,3,12,4,3
5,162,162,43,43,0,1,0
9,172,172,30,6,24,4,3
1,178,178,40,2,38,3,2
3,184,184,10,10,0,1,0
6,303,303,10,1,9,4,3
10,342,342,87,65,22,3,2
8,357,357,17,10,7,2,1
4,365,365,40,40,0,1,0
12,424,424,19,19,0,1,0
2,451,451,2,2,0,1,0
7,461,461,23,23,0,1,0
0,483,483,21,8,13,4,3

6,101,101,15,9,6,3,2
1,114,114,1,1,0,1,0
4,167,167,19,19,0,1,0
2,294,294,24,24,0,1,0
7,386,386,47,47,0,1,0
3,416,416,17,17,0,1,0
0,434,434,303,287,16,3,2
5,454,454,2,2,0,1,0
8,490,490,102,102,0,1,0

1,114,114,19,4,15,2,1
0,139,139,18,1,17,3,2
12,172,172,1,1,0,1,0
6,174,174,26,26,0,1,0
7,205,205,57,23,34,2,1
9,221,221,22,22,0,1,0
11,273,273,8,8,0,1,0
10,308,308,3,3,0,1,0
2,317,317,22,22,0,1,0
8,371,371,33,33,0,1,0
3,440,440,5,5,0,1,0
13,457,457,93,93,0,1,0
4,458,458,21,6,15,2,1
5,473,473,61,61,0,1,0

4,102,102,9,1,8,2,1
0,108,108,4,4,0,1,0
18,125,125,32,32,0,1,0
16,131,131,16,4,12,2,1
15,136,136,12,3,9,2,1
1,140,140,9,9,0,1,0
6,156,156,3,3,0,1,0
11,208,208,13,3,10,2,1
7,271,271,42,42,0,1,0
3,289,289,3,3,0,1,0
8,312,312,35,35,0,1,0
10,331,331,7,2,5,2,1
13,378,378,33,33,0,1,0
9,396,396,8,8,0,1,0
2,408,408,23,2,21,2,1
14,453,453,21,21,0,1,0
17,457,457,29,5,24,4,3
12,479,479,28,18,10,3,2
5,484,484,26,26,0,1,0

6,147,147,9,9,0,1,0
12,172,172,18,18,0,1,0
5,217,217,9,9,0,1,0
11,217,217,8,5,3,2,1
9,224,224,24,24,0,1,0
8,238,238,31,31,0,1,0
1,250,250,27,1,26,3,2
3,326,326,66,4,62,4,3
10,365,365,72,72,0,1,0
7,370,370,31,19,12,4,3
4,418,418,10,10,0,1,0
2,438,438,76,3,73,4,3
13,445,445,17,9,8,3,2
0,452,452,3,3,0,1,0
14,464,464,42,42,0,1,0

9,101,101,1,1,0,1,0
1,110,110,8,8,0,1,0
5,110,110,1,1,0,1,0
17,154,154,26,20,6,2,1
0,160,160,1,1,0,1,0
13,249,249,39,39,0,1,0
8,279,279,10,4,6,2,1
15,310,310,1,1,0,1,0
3,312,312,23,23,0,1,0
6,332,332,38,38,0,1,0
11,347,347,24,3,21,4,3
4,363,363,17,4,13,2,1
7,389,389,42,42,0,1,0
10,421,421,46,19,27,4,3
2,424,424,19,7,12,4,3
18,443,443,67,67,0,1,0
12,447,447,25,25,0,1,0
16,462,462,37,4,33,4,3
14,499,499,45,45,0,1,0

16,112,112,8,2,6,3,2
7,120,120,5,2,3,2,1
21,121,121,26,26,0,1,0
14,173,173,32,32,0,1,0
9,175,175,34,34,0,1,0
19,183,183,40,26,14,2,1
8,258,258,4,4,0,1,0
6,298,298,7,7,0,1,0
18,301,301,19,4,15,4,3
10,322,322,8,8,0,1,0
15,322,322,37,25,12,4,3
0,329,329,10,10,0,1,0
1,338,338,1,1,0,1,0
2,360,360,10,10,0,1,0
20,409,409,10,10,0,1,0
4,417,417,4,4,0,1,0
12,418,418,13,3,10,3,2
17,438,438,3,3,0,1,0
11,449,449,4,4,0,1,0
3,458,458,23,23,0,1,0
5,475,475,10,2,8,2,1
13,500,500,18,1,17,3,2

11,124,124,15,6,9,2,1
7,152,152,7,7,0,1,0
3,190,190,29,29,0,1,0
1,205,205,4,1,3,2,1
13,221,221,16,16,0,1,0
5,241,241,8,8,0,1,0
10,255,255,27,5,22,2,1
8,267,267,6,6,0,1,0
4,274,274,6,6,0,1,0
12,297,297,35,7,28,3,2
9,347,347,14,14,0,1,0
2,364,364,30,30,0,1,0
14,466,466,108,108,0,1,0
0,471,471,162,162,0,1,0
6,492,492,1,1,0,1,0

4,125,125,13,13,0,1,0
7,130,130,1,1,0,1,0
12,131,131,12,12,0,1,0
8,163,163,16,2,14,3,2
1,189,189,4,4,0,1,0
0,215,215,87,87,0,1,0
11,225,225,56,56,0,1,0
10,255,255,11,4,7,2,1
2,303,303,5,2,3,2,1
14,303,303,16,16,0,1,0
5,332,332,14,6,8,3,2
9,356,356,6,6,0,1,0
6,373,373,36,36,0,1,0
3,408,408,3,3,0,1,0
13,479,479,78,47,31,2,1

1,117,117,1,1,0,1,0
9,144,144,1,1,0,1,0
6,182,182,17,17,0,1,0
13,213,213,9,9,0,1,0
7,240,240,36,36,0,1,0
0,299,299,6,6,0,1,0
2,336,336,82,70,12,3,2
4,347,347,11,6,5,2,1
11,351,351,26,26,0,1,0
5,386,386,97,13,84,4,3
8,414,414,97,55,42,4,3
10,473,473,68,68,0,1,0
3,484,484,25,25,0,1,0
12,488,488,29,29,0,1,0

3,111,111,3,3,0,1,0
7,118,118,14,14,0,1,0
6,142,142,39,9,30,2,1
1,272,272,10,1,9,4,3
10,273,273,40,17,23,3,2
2,339,339,147,106,41,2,1
0,360,360,51,36,15,4,3
11,381,381,6,6,0,1,0
8,457,457,30,30,0,1,0
9,472,472,13,13,0,1,0
4,491,491,30,30,0,1,0
5,492,492,31,31,0,1,0

1,175,175,9,9,0,1,0
4,191,191,25,25,0,1,0
10,213,213,82,82,0,1,0
13,227,227,12,7,5,2,1
11,237,237,2,2,0,1,0
7,240,240,1,1,0,1,0
3,249,249,3,3,0,1,0
6,270,270,21,1,20,2,1
2,278,278,52,3,49,4,3
9,283,283,21,21,0,1,0
8,288,288,12,12,0,1,0
0,314,314,45,13,32,2,1
5,326,326,31,20,11,2,1
14,370,370,55,16,39,2,1
12,378,378,2,2,0,1,0

8,136,136,1,1,0,1,0
0,139,139,24,6,18,2,1
3,173,173,6,6,0,1,0
11,173,173,4,1,3,2,1
4,219,219,74,49,25,2,1
12,254,254,5,2,3,2,1
1,293,293,10,10,0,1,0
9,349,349,43,43,0,1,0
7,419,419,54,54,0,1,0
6,452,452,27,1,26,2,1
10,460,460,90,46,44,2,1
5,462,462,7,7,0,1,0
13,466,466,101,77,24,4,3
2,478,478,22,22,0,1,0

8,102,102,2,2,0,1,0
3,184,184,27,15,12,3,2
6,190,190,46,46,0,1,0
0,311,311,24,14,10,3,2
4,314,314,19,3,16,2,1
7,401,401,37,37,0,1,0
9,411,411,75,75,0,1,0
2,451,451,46,46,0,1,0
5,455,455,62,53,9,4,3
10,462,462,1,1,0,1,0
11,482,482,19,5,14,2,1
1,486,486,153,131,22,3,2

10,116,116,3,3,0,1,0
8,182,182,20,20,0,1,0
7,183,183,12,12,0,1,0
12,192,192,3,3,0,1,0
0,200,200,8,5,3,2,1
6,214,214,11,8,3,2,1
18,214,214,55,55,0,1,0
11,218,218,13,5,8,2,1
2,228,228,2,2,0,1,0
15,276,276,21,21,0,1,0
13,279,279,39,39,0,1,0
4,321,321,6,2,4,2,1
16,382,382,56,8,48,2,1
1,415,415,15,6,9,4,3
17,416,416,14,14,0,1,0
14,433,433,14,14,0,1,0
3,464,464,12,12,0,1,0
19,472,472,11,7,4,2,1
9,489,489,95,92,3,2,1
5,499,499,26,26,0,1,0

2,127,127,8,8,0,1,0
1,170,170,70,70,0,1,0
4,170,170,8,8,0,1,0
7,187,187,9,9,0,1,0
3,234,234,19,3,16,2,1
9,261,261,27,27,0,1,0
0,318,318,46,46,0,1,0
6,330,330,25,9,16,4,3
5,334,334,7,7,0,1,0
10,345,345,39,1,38,3,2
8,374,374,115,87,28,2,1

3,159,159,18,14,4,2,1
0,171,171,5,5,0,1,0
8,172,172,8,8,0,1,0
7,176,176,3,3,0,1,0
10,198,198,71,11,60,3,2
12,235,235,16,6,10,3,2
2,299,299,68,57,11,2,1
9,313,313,19,12,7,3,2
4,331,331,8,8,0,1,0
5,405,405,89,38,51,4,3
6,427,427,49,49,0,1,0
1,430,430,38,2,36,4,3
11,461,461,23,8,15,4,3

3,175,175,11,2,9,2,1
7,178,178,23,23,0,1,0
9,227,227,53,53,0,1,0
13,233,233,23,5,18,4,3
8,236,236,24,24,0,1,0
6,277,277,1,1,0,1,0
5,290,290,18,10,8,3,2
10,379,379,20,4,16,2,1
11,417,417,8,5,3,2,1
0,426,426,90,60,30,4,3
1,435,435,59,59,0,1,0
12,452,452,55,55,0,1,0
14,457,457,39,14,25,4,3
4,464,464,8,1,7,2,1
2,481,481,39,39,0,1,0

4,181,181,7,7,0,1,0
1,182,182,58,58,0,1,0
7,195,195,56,14,42,2,1
0,215,215,50,2,48,4,3
10,225,225,8,2,6,3,2
2,264,264,1,1,0,1,0
6,276,276,10,10,0,1,0
5,316,316,31,31,0,1,0
8,435,435,17,17,0,1,0
3,447,447,49,49,0,1,0
11,459,459,99,99,0,1,0
9,500,500,2,2,0,1,0

11,126,126,5,2,3,2,1
12,141,141,2,2,0,1,0
3,152,152,30,21,9,4,3
0,211,211,38,38,0,1,0
8,218,218,91,61,30,4,3
9,254,254,3,3,0,1,0
10,302,302,19,10,9,4,3
13,318,318,49,49,0,1,0
4,329,329,16,8,8,2,1
6,373,373,55,55,0,1,0
1,405,405,13,6,7,2,1
2,432,432,13,2,11,2,1
5,456,456,1,1,0,1,0
7,464,464,29,29,0,1,0
14,477,477,6,1,5,2,1

13,108,108,4,4,0,1,0
14,168,168,1,1,0,1,0
2,176,176,13,13,0,1,0
10,208,208,60,8,52,4,3
12,208,208,8,2,6,2,1
0,210,210,41,41,0,1,0
3,232,232,14,14,0,1,0
4,313,313,26,26,0,1,0
5,321,321,47,47,0,1,0
8,330,330,33,33,0,1,0
9,416,416,42,6,36,4,3
1,436,436,27,27,0,1,0
11,443,443,64,26,38,3,2
6,493,493,14,4,10,2,1
7,495,495,26,12,14,3,2

11,105,105,19,9,10,2,1
9,152,152,19,19,0,1,0
5,157,157,1,1,0,1,0
8,198,198,6,3,3,2,1
4,226,226,18,3,15,4,3
12,256,256,32,4,28,3,2
16,297,297,20,20,0,1,0
3,303,303,26,26,0,1,0
1,310,310,10,4,6,2,1
10,321,321,12,12,0,1,0
2,366,366,1,1,0,1,0
0,403,403,22,22,0,1,0
15,419,419,13,2,11,2,1
6,449,449,8,8,0,1,0
13,449,449,98,3,95,4,3
14,472,472,26,26,0,1,0
7,481,481,128,128,0,1,0

5,162,162,25,25,0,1,0
11,186,186,2,2,0,1,0
0,255,255,57,57,0,1,0
9,278,278,106,106,0,1,0
1,283,283,4,4,0,1,0
3,301,301,28,4,24,2,1
4,316,316,41,41,0,1,0
6,320,320,17,7,10,3,2
10,359,359,41,24,17,2,1
7,387,387,5,5,0,1,0
8,423,423,45,3,42,2,1
2,443,443,40,40,0,1,0
12,482,482,13,13,0,1,0

3,116,116,4,4,0,1,0
8,138,138,19,1,18,4,3
6,164,164,20,20,0,1,0
2,173,173,1,1,0,1,0
12,238,238,23,14,9,4,3
7,253,253,7,1,6,2,1
13,301,301,23,3,20,3,2
5,315,315,19,7,12,4,3
10,318,318,60,60,0,1,0
0,326,326,91,79,12,2,1
1,331,331,10,10,0,1,0
14,342,342,62,53,9,4,3
15,392,392,18,8,10,3,2
9,396,396,3,3,0,1,0
4,434,434,2,2,0,1,0
11,456,456,52,8,44,2,1

6,127,127,16,2,14,3,2
4,131,131,24,24,0,1,0
10,133,133,10,1,9,4,3
5,134,134,13,13,0,1,0
14,142,142,12,4,8,2,1
3,147,147,2,2,0,1,0
1,163,163,27,18,9,2,1
12,167,167,16,16,0,1,0
2,201,201,4,4,0,1,0
7,232,232,12,5,7,2,1
8,337,337,36,36,0,1,0
0,351,351,16,12,4,2,1
11,375,375,8,8,0,1,0
9,378,378,101,28,73,4,3
13,455,455,29,29,0,1,0

11,137,137,5,5,0,1,0
5,175,175,5,5,0,1,0
13,177,177,28,8,20,2,1
9,182,182,4,4,0,1,0
10,184,184,8,3,5,2,1
3,203,203,1,1,0,1,0
8,203,203,12,12,0,1,0
7,287,287,31,17,14,3,2
16,312,312,31,7,24,3,2
12,315,315,73,55,18,3,2
2,333,333,11,11,0,1,0
6,337,337,55,55,0,1,0
14,376,376,4,4,0,1,0
0,381,381,12,12,0,1,0
4,398,398,28,13,15,4,3
15,415,415,56,35,21,4,3
1,485,485,89,41,48,4,3

2,125,125,32,7,25,3,2
7,148,148,8,8,0,1,0
16,164,164,17,17,0,1,0
15,177,177,2,2,0,1,0
10,192,192,14,9,5,2,1
9,194,194,3,3,0,1,0
12,202,202,7,7,0,1,0
8,222,222,2,2,0,1,0
3,224,224,24,18,6,2,1
5,237,237,7,3,4,2,1
0,246,246,5,5,0,1,0
13,252,252,21,21,0,1,0
6,266,266,5,5,0,1,0
11,302,302,68,47,21,4,3
1,333,333,23,23,0,1,0
4,421,421,52,25,27,2,1
14,434,434,80,80,0,1,0

9,103,103,18,6,12,2,1
8,149,149,4,4,0,1,0
1,154,154,8,8,0,1,0
17,161,161,5,5,0,1,0
5,166,166,1,1,0,1,0
11,175,175,53,53,0,1,0
6,183,183,10,4,6,2,1
4,198,198,6,6,0,1,0
3,231,231,4,1,3,2,1
10,247,247,7,7,0,1,0
12,260,260,7,7,0,1,0
16,296,296,4,1,3,2,1
13,309,309,19,6,13,2,1
7,384,384,100,100,0,1,0
15,399,399,11,11,0,1,0
2,427,427,10,10,0,1,0
14,452,452,113,33,80,3,2
0,471,471,13,4,9,4,3

13,118,118,3,3,0,1,0
0,124,124,11,11,0,1,0
3,125,125,6,6,0,1,0
5,151,151,36,12,24,4,3
2,236,236,15,15,0,1,0
6,263,263,3,3,0,1,0
7,311,311,10,10,0,1,0
12,358,358,9,5,4,2,1
8,377,377,126,34,92,3,2
4,378,378,69,7,62,3,2
1,399,399,27,27,0,1,0
10,412,412,1,1,0,1,0
11,422,422,92,9,83,4,3
9,455,455,32,4,28,3,2

14,111,111,6,6,0,1,0
8,174,174,28,8,20,3,2
7,209,209,1,1,0,1,0
4,246,246,13,1,12,3,2
9,260,260,33,33,0,1,0
1,276,276,35,35,0,1,0
2,302,302,6,6,0,1,0
13,310,310,16,16,0,1,0
12,337,337,22,22,0,1,0
15,342,342,6,6,0,1,0
6,354,354,74,38,36,3,2
11,381,381,46,46,0,1,0
5,388,388,17,9,8,2,1
3,421,421,5,5,0,1,0
10,433,433,118,98,20,3,2
0,476,476,34,30,4,2,1

11,126,126,2,2,0,1,0
0,154,154,47,18,29,2,1
14,175,175,57,57,0,1,0
9,188,188,34,34,0,1,0
3,212,212,4,4,0,1,0
13,228,228,3,3,0,1,0
1,250,250,5,5,0,1,0
8,314,314,33,29,4,2,1
10,315,315,18,8,10,3,2
2,348,348,86,86,0,1,0
6,351,351,13,13,0,1,0
7,376,376,8,5,3,2,1
5,446,446,17,17,0,1,0
12,456,456,9,5,4,2,1
4,466,466,7,7,0,1,0

12,104,104,2,2,0,1,0
11,165,165,24,12,12,4,3
7,196,196,37,5,32,2,1
4,258,258,7,7,0,1,0
0,266,266,38,38,0,1,0
3,276,276,29,29,0,1,0
2,305,305,5,5,0,1,0
9,320,320,8,4,4,2,1
1,432,432,29,29,0,1,0
8,434,434,49,11,38,2,1
5,452,452,2,2,0,1,0
6,479,479,72,25,47,2,1
13,481,481,37,37,0,1,0
10,497,497,126,21,105,4,3
14,497,497,39,12,27,4,3

16,141,141,20,20,0,1,0
11,153,153,11,5,6,3,2
14,154,154,1,1,0,1,0
9,168,168,1,1,0,1,0
6,173,173,6,6,0,1,0
3,180,180,6,6,0,1,0
7,209,209,5,5,0,1,0
0,210,210,23,7,16,2,1
13,216,216,9,2,7,2,1
5,254,254,11,11,0,1,0
1,282,282,55,12,43,2,1
12,318,318,11,11,0,1,0
17,329,329,29,19,10,2,1
4,359,359,51,27,24,2,1
8,376,376,12,12,0,1,0
10,459,459,34,34,0,1,0
2,467,467,3,3,0,1,0
15,481,481,159,159,0,1,0

7,102,102,5,5,0,1,0
9,128,128,10,1,9,4,3
8,135,135,3,3,0,1,0
6,136,136,37,13,24,4,3
2,296,296,15,15,0,1,0
0,322,322,72,72,0,1,0
1,332,332,1,1,0,1,0
3,345,345,62,62,0,1,0
10,346,346,5,2,3,2,1
5,356,356,23,23,0,1,0
11,436,436,97,97,0,1,0
4,493,493,120,96,24,3,2

11,116,116,21,21,0,1,0
7,204,204,41,27,14,2,1
6,237,237,18,18,0,1,0
1,244,244,36,2,34,2,1
9,247,247,19,13,6,3,2
0,284,284,58,58,0,1,0
10,300,300,11,11,0,1,0
3,309,309,33,33,0,1,0
12,359,359,25,13,12,2,1
8,417,417,46,2,44,3,2
2,438,438,27,9,18,2,1
5,477,477,8,8,0,1,0
4,492,492,43,43,0,1,0
13,498,498,16,1,15,3,2

11,142,142,37,22,15,4,3
0,191,191,36,6,30,2,1
10,193,193,36,36,0,1,0
13,197,197,5,5,0,1,0
1,216,216,52,52,0,1,0
4,249,249,4,1,3,2,1
2,253,253,28,22,6,3,2
14,348,348,2,2,0,1,0
7,359,359,2,2,0,1,0
12,414,414,50,50,0,1,0
9,419,419,19,19,0,1,0
8,452,452,33,2,31,3,2
5,454,454,12,12,0,1,0
3,458,458,46,46,0,1,0
6,468,468,6,6,0,1,0

5,123,123,9,4,5,2,1
6,148,148,10,10,0,1,0
2,168,168,2,2,0,1,0
1,286,286,52,52,0,1,0
8,302,302,12,12,0,1,0
9,304,304,38,38,0,1,0
11,319,319,70,17,53,3,2
12,380,380,90,33,57,4,3
13,390,390,21,21,0,1,0
4,407,407,95,92,3,2,1
14,407,407,2,2,0,1,0
10,421,421,14,14,0,1,0
3,443,443,17,5,12,3,2
7,465,465,27,27,0,1,0
0,487,487,18,18,0,1,0

2,125,125,7,7,0,1,0
16,195,195,3,3,0,1,0
5,275,275,1,1,0,1,0
9,288,288,16,4,12,4,3
4,312,312,17,17,0,1,0
8,315,315,14,4,10,3,2
3,342,342,23,23,0,1,0
6,379,379,65,24,41,2,1
10,397,397,6,6,0,1,0
15,402,402,11,4,7,2,1
7,435,435,67,56,11,2,1
14,438,438,55,23,32,2,1
0,444,444,20,2,18,4,3
13,453,453,159,159,0,1,0
1,456,456,23,13,10,3,2
11,480,480,9,9,0,1,0
12,487,487,77,77,0,1,0

18,113,113,1,1,0,1,0
13,201,201,7,7,0,1,0
0,227,227,13,13,0,1,0
16,243,243,10,10,0,1,0
2,251,251,6,6,0,1,0
12,259,259,5,5,0,1,0
4,272,272,43,43,0,1,0
11,280,280,16,4,12,4,3
19,296,296,21,21,0,1,0
17,352,352,59,6,53,4,3
7,352,352,26,8,18,3,2
10,363,363,14,14,0,1,0
8,375,375,23,9,14,3,2
3,382,382,6,2,4,2,1
6,391,391,17,5,12,3,2
15,414,414,12,1,11,2,1
14,431,431,93,31,62,3,2
9,431,431,31,13,18,3,2
5,461,461,20,20,0,1,0
20,472,472,86,49,37,2,1
1,492,492,1,1,0,1,0

7,105,105,2,2,0,1,0
1,111,111,46,20,26,2,1
0,191,191,6,6,0,1,0
13,198,198,19,19,0,1,0
6,208,208,5,5,0,1,0
3,243,243,16,16,0,1,0
10,317,317,36,2,34,2,1
8,353,353,34,15,19,2,1
12,363,363,15,2,13,2,1
5,374,374,2,2,0,1,0
4,402,402,9,1,8,3,2
9,405,405,130,130,0,1,0
2,421,421,59,55,4,2,1
11,427,427,11,3,8,3,2

1,103,103,2,2,0,1,0
7,186,186,29,19,10,2,1
10,200,200,28,28,0,1,0
2,246,246,29,5,24,2,1
6,259,259,4,1,3,2,1
5,281,281,86,30,56,3,2
8,378,378,3,3,0,1,0
0,423,423,190,190,0,1,0
4,425,425,19,11,8,3,2
9,428,428,18,18,0,1,0
3,450,450,52,52,0,1,0

11,154,154,31,31,0,1,0
3,156,156,8,8,0,1,0
5,163,163,8,8,0,1,0
12,235,235,2,2,0,1,0
6,246,246,20,13,7,2,1
1,261,261,32,32,0,1,0
7,317,317,63,48,15,4,3
0,357,357,67,15,52,3,2
13,362,362,6,2,4,2,1
10,403,403,62,42,20,3,2
9,423,423,15,15,0,1,0
2,428,428,42,10,32,3,2
4,439,439,50,22,28,2,1
8,488,488,48,48,0,1,0

6,136,136,32,7,25,3,2
5,153,153,17,17,0,1,0
11,157,157,1,1,0,1,0
12,178,178,8,8,0,1,0
4,229,229,3,3,0,1,0
3,262,262,10,10,0,1,0
14,267,267,14,1,13,2,1
1,272,272,25,25,0,1,0
13,289,289,60,14,46,2,1
15,331,331,39,39,0,1,0
2,386,386,1,1,0,1,0
8,428,428,3,3,0,1,0
16,435,435,100,6,94,4,3
9,439,439,7,7,0,1,0
10,443,443,25,4,21,2,1
0,475,475,48,16,32,3,2
7,497,497,42,5,37,2,1

9,121,121,9,3,6,2,1
16,138,138,23,23,0,1,0
1,168,168,1,1,0,1,0
15,192,192,9,9,0,1,0
5,207,207,6,6,0,1,0
14,216,216,58,14,44,3,2
0,218,218,1,1,0,1,0
2,229,229,1,1,0,1,0
7,233,233,20,2,18,3,2
4,298,298,130,37,93,4,3
10,306,306,29,29,0,1,0
6,307,307,6,6,0,1,0
3,333,333,1,1,0,1,0
12,341,341,40,6,34,2,1
11,386,386,4,4,0,1,0
13,409,409,3,3,0,1,0
8,424,424,17,17,0,1,0

9,109,109,1,1,0,1,0
16,137,137,22,1,21,2,1
2,138,138,9,9,0,1,0
13,141,141,3,3,0,1,0
18,142,142,14,5,9,2,1
1,149,149,5,2,3,2,1
20,194,194,4,4,0,1,0
3,206,206,7,1,6,2,1
4,233,233,2,2,0,1,0
6,251,251,3,3,0,1,0
11,289,289,15,2,13,2,1
15,318,318,38,19,19,2,1
10,349,349,32,11,21,4,3
12,398,398,61,61,0,1,0
14,402,402,26,10,16,2,1
17,405,405,26,26,0,1,0
19,422,422,80,80,0,1,0
7,437,437,53,53,0,1,0
8,475,475,7,7,0,1,0
5,478,478,12,12,0,1,0
0,488,488,30,24,6,2,1

4,103,103,2,2,0,1,0
3,113,113,23,1,22,3,2
6,145,145,15,7,8,3,2
9,161,161,18,6,12,2,1
2,289,289,5,1,4,2,1
0,303,303,116,116,0,1,0
1,348,348,36,36,0,1,0
8,355,355,23,23,0,1,0
10,387,387,103,70,33,4,3
5,399,399,19,3,16,3,2
7,435,435,43,21,22,4,3

11,143,143,47,37,10,2,1
8,168,168,5,5,0,1,0
1,175,175,7,4,3,2,1
10,298,298,41,9,32,2,1
2,307,307,77,28,49,2,1
4,356,356,143,143,0,1,0
0,403,403,1,1,0,1,0
6,410,410,5,5,0,1,0
3,415,415,3,3,0,1,0
7,460,460,49,49,0,1,0
9,496,496,33,3,30,3,2
5,499,499,14,14,0,1,0

4,111,111,12,4,8,3,2
6,182,182,1,1,0,1,0
10,183,183,8,2,6,3,2
14,186,186,41,41,0,1,0
1,191,191,10,5,5,2,1
0,223,223,19,13,6,2,1
17,248,248,1,1,0,1,0
13,254,254,43,21,22,2,1
9,257,257,20,8,12,4,3
11,257,257,19,19,0,1,0
15,284,284,19,9,10,3,2
7,288,288,10,10,0,1,0
3,292,292,30,25,5,2,1
16,319,319,31,31,0,1,0
8,387,387,2,2,0,1,0
2,404,404,1,1,0,1,0
12,482,482,37,6,31,2,1
5,492,492,90,78,12,3,2

2,105,105,7,7,0,1,0
6,105,105,3,3,0,1,0
8,131,131,12,5,7,2,1
10,131,131,34,34,0,1,0
0,189,189,37,37,0,1,0
11,194,194,16,9,7,2,1
7,217,217,28,16,12,2,1
12,222,222,17,3,14,2,1
3,285,285,68,68,0,1,0
5,347,347,58,58,0,1,0
9,424,424,21,21,0,1,0
1,438,438,13,8,5,2,1
4,490,490,2,2,0,1,0

9,100,100,10,10,0,1,0
10,101,101,23,23,0,1,0
11,103,103,1,1,0,1,0
0,123,123,1,1,0,1,0
4,188,188,17,13,4,2,1
2,217,217,11,4,7,2,1
1,266,266,59,55,4,2,1
5,329,329,19,9,10,2,1
6,335,335,47,17,30,2,1
7,362,362,78,11,67,4,3
8,389,389,6,2,4,2,1
12,392,392,45,9,36,3,2
3,488,488,64,64,0,1,0
13,497,497,22,4,18,4,3

4,102,102,6,6,0,1,0
12,126,126,2,2,0,1,0
2,181,181,31,31,0,1,0
10,195,195,37,37,0,1,0
8,278,278,24,20,4,2,1
5,318,318,25,25,0,1,0
0,328,328,17,9,8,2,1
6,340,340,23,8,15,3,2
13,342,342,102,7,95,4,3
9,383,383,1,1,0,1,0
11,408,408,15,1,14,2,1
1,459,459,34,2,32,3,2
14,473,473,38,38,0,1,0
3,482,482,19,19,0,1,0
7,493,493,79,17,62,3,2

13,103,103,6,6,0,1,0
15,109,109,13,5,8,2,1
5,125,125,2,2,0,1,0
3,154,154,14,4,10,2,1
12,161,161,10,10,0,1,0
11,255,255,29,29,0,1,0
1,262,262,32,12,20,3,2
8,269,269,6,1,5,2,1
9,278,278,16,16,0,1,0
2,285,285,46,37,9,4,3
0,296,296,56,1,55,4,3
16,307,307,25,19,6,2,1
7,355,355,8,8,0,1,0
14,374,374,54,54,0,1,0
4,378,378,1,1,0,1,0
10,454,454,61,46,15,2,1
6,454,454,8,8,0,1,0

11,111,111,3,3,0,1,0
3,136,136,3,3,0,1,0
5,151,151,1,1,0,1,0
1,164,164,3,3,0,1,0
7,176,176,4,4,0,1,0
15,203,203,9,9,0,1,0
14,226,226,12,12,0,1,0
6,276,276,26,20,6,3,2
0,323,323,15,15,0,1,0
2,328,328,1,1,0,1,0
17,356,356,28,9,19,4,3
13,380,380,63,49,14,2,1
8,394,394,12,12,0,1,0
4,396,396,16,7,9,2,1
10,401,401,12,3,9,2,1
12,427,427,124,62,62,3,2
16,462,462,30,30,0,1,0
18,462,462,5,5,0,1,0
9,495,495,181,181,0,1,0

2,100,100,5,5,0,1,0
6,177,177,16,16,0,1,0
12,182,182,41,32,9,4,3
1,207,207,2,2,0,1,0
0,225,225,31,31,0,1,0
3,232,232,6,1,5,2,1
13,237,237,3,3,0,1,0
7,359,359,55,55,0,1,0
9,372,372,42,42,0,1,0
8,385,385,13,5,8,2,1
11,394,394,67,67,0,1,0
4,401,401,50,4,46,3,2
10,404,404,2,2,0,1,0
5,426,426,112,112,0,1,0

7,133,133,16,16,0,1,0
12,136,136,8,5,3,2,1
1,152,152,3,3,0,1,0
2,158,158,1,1,0,1,0
0,243,243,64,23,41,2,1
4,275,275,24,24,0,1,0
9,277,277,10,7,3,2,1
6,282,282,4,1,3,2,1
11,349,349,41,41,0,1,0
8,356,356,122,122,0,1,0
3,460,460,8,5,3,2,1
10,484,484,15,15,0,1,0
5,495,495,152,100,52,3,2

12,169,169,11,3,8,3,2
7,173,173,2,2,0,1,0
16,182,182,13,3,10,3,2
14,224,224,31,31,0,1,0
8,237,237,17,1,16,2,1
3,309,309,12,12,0,1,0
2,343,343,37,37,0,1,0
5,356,356,1,1,0,1,0
13,388,388,7,7,0,1,0
9,389,389,42,30,12,4,3
0,390,390,27,18,9,4,3
6,412,412,28,24,4,2,1
15,438,438,1,1,0,1,0
4,439,439,97,81,16,2,1
10,443,443,59,10,49,3,2
11,449,449,129,50,79,3,2
1,482,482,1,1,0,1,0

8,120,120,2,2,0,1,0
14,132,132,9,9,0,1,0
1,135,135,14,4,10,2,1
11,160,160,33,22,11,2,1
10,186,186,26,6,20,3,2
13,205,205,22,9,13,2,1
12,218,218,7,7,0,1,0
6,220,220,8,8,0,1,0
9,220,220,32,2,30,4,3
4,294,294,41,35,6,2,1
0,378,378,14,5,9,2,1
2,421,421,47,47,0,1,0
3,421,421,28,28,0,1,0
5,450,450,52,52,0,1,0
7,470,470,43,19,24,3,2

9,171,171,53,3,50,3,2
1,208,208,10,10,0,1,0
8,217,217,18,1,17,2,1
13,243,243,14,14,0,1,0
6,248,248,3,3,0,1,0
14,304,304,4,4,0,1,0
2,326,326,95,69,26,2,1
12,331,331,14,6,8,2,1
10,337,337,22,22,0,1,0
0,380,380,27,3,24,4,3
4,393,393,12,12,0,1,0
11,425,425,61,43,18,2,1
3,443,443,35,35,0,1,0
7,460,460,18,18,0,1,0
5,499,499,65,56,9,2,1

8,111,111,7,1,6,3,2
6,136,136,11,11,0,1,0
12,150,150,17,17,0,1,0
13,158,158,2,2,0,1,0
1,169,169,12,3,9,4,3
0,171,171,31,31,0,1,0
2,207,207,1,1,0,1,0
3,284,284,37,13,24,2,1
11,346,346,61,22,39,4,3
7,364,364,39,1,38,3,2
5,405,405,3,3,0,1,0
4,454,454,103,70,33,2,1
9,461,461,65,35,30,2,1
10,467,467,46,46,0,1,0

11,118,118,18,18,0,1,0
2,157,157,7,2,5,2,1
1,204,204,12,12,0,1,0
4,226,226,13,13,0,1,0
3,230,230,69,9,60,3,2
9,250,250,83,21,62,3,2
12,266,266,23,23,0,1,0
8,315,315,6,6,0,1,0
5,330,330,1,1,0,1,0
7,375,375,36,12,24,3,2
0,393,393,19,13,6,3,2
14,399,399,24,8,16,2,1
10,408,408,22,22,0,1,0
13,420,420,2,2,0,1,0
6,461,461,43,43,0,1,0

0,166,166,68,34,34,3,2
6,180,180,15,3,12,2,1
8,190,190,38,2,36,2,1
10,226,226,2,2,0,1,0
2,235,235,7,1,6,2,1
3,266,266,3,3,0,1,0
9,274,274,42,42,0,1,0
1,309,309,78,12,66,4,3
5,342,342,4,4,0,1,0
7,422,422,20,20,0,1,0
4,490,490,102,102,0,1,0

9,163,163,11,11,0,1,0
6,203,203,4,4,0,1,0
13,213,213,38,31,7,2,1
5,214,214,1,1,0,1,0
1,254,254,41,1,40,3,2
14,271,271,24,24,0,1,0
7,290,290,1,1,0,1,0
15,298,298,34,4,30,4,3
4,311,311,3,3,0,1,0
2,332,332,43,43,0,1,0
0,399,399,9,9,0,1,0
12,417,417,53,53,0,1,0
3,433,433,142,38,104,4,3
10,449,449,40,31,9,4,3
11,487,487,22,22,0,1,0
8,500,500,11,11,0,1,0

9,104,104,23,5,18,4,3
2,122,122,3,3,0,1,0
0,125,125,66,17,49,2,1
7,206,206,4,4,0,1,0
10,273,273,10,10,0,1,0
4,329,329,9,9,0,1,0
1,350,350,51,4,47,2,1
6,350,350,94,76,18,3,2
5,405,405,30,10,20,3,2
3,428,428,1,1,0,1,0
8,475,475,34,4,30,2,1

4,121,121,11,11,0,1,0
7,134,134,16,4,12,3,2
8,171,171,24,12,12,3,2
6,212,212,14,10,4,2,1
5,230,230,19,19,0,1,0
11,251,251,16,16,0,1,0
12,265,265,14,7,7,2,1
9,312,312,23,23,0,1,0
15,314,314,9,9,0,1,0
10,322,322,19,19,0,1,0
2,421,421,2,2,0,1,0
0,442,442,5,5,0,1,0
3,456,456,81,40,41,3,2
14,460,460,57,51,6,2,1
13,473,473,147,117,30,4,3
1,477,477,6,6,0,1,0

8,133,133,32,2,30,3,2
9,190,190,12,8,4,2,1
2,247,247,25,5,20,3,2
6,269,269,1,1,0,1,0
11,291,291,30,12,18,2,1
1,302,302,55,9,46,2,1
13,325,325,14,10,4,2,1
0,339,339,57,57,0,1,0
4,396,396,14,10,4,2,1
7,412,412,1,1,0,1,0
12,431,431,31,31,0,1,0
10,439,439,85,85,0,1,0
3,441,441,85,85,0,1,0
5,466,466,7,7,0,1,0
14,496,496,1,1,0,1,0

11,171,171,4,4,0,1,0
3,181,181,25,4,21,4,3
2,185,185,18,18,0,1,0
7,226,226,7,7,0,1,0
8,282,282,53,53,0,1,0
6,345,345,22,22,0,1,0
1,351,351,92,92,0,1,0
14,379,379,22,22,0,1,0
13,437,437,55,47,8,2,1
12,453,453,50,23,27,4,3
10,473,473,4,4,0,1,0
5,478,478,24,6,18,3,2
9,478,478,95,95,0,1,0
0,484,484,28,4,24,2,1
4,492,492,1,1,0,1,0

6,169,169,28,9,19,2,1
7,197,197,34,25,9,4,3
1,214,214,26,26,0,1,0
5,226,226,18,18,0,1,0
2,247,247,55,4,51,4,3
11,312,312,20,10,10,3,2
0,323,323,13,13,0,1,0
8,376,376,36,6,30,3,2
3,408,408,106,30,76,3,2
10,410,410,7,7,0,1,0
9,432,432,51,2,49,4,3
4,446,446,25,1,24,3,2

13,151,151,9,1,8,3,2
0,154,154,2,2,0,1,0
2,160,160,29,29,0,1,0
3,194,194,1,1,0,1,0
17,258,258,2,2,0,1,0
8,303,303,6,2,4,2,1
12,316,316,71,63,8,2,1
10,330,330,4,4,0,1,0
5,358,358,9,9,0,1,0
11,380,380,4,4,0,1,0
15,381,381,25,25,0,1,0
7,408,408,6,6,0,1,0
16,426,426,103,72,31,2,1
9,433,433,28,8,20,3,2
6,440,440,122,122,0,1,0
18,450,450,1,1,0,1,0
4,464,464,30,2,28,3,2
14,472,472,51,15,36,3,2
1,478,478,6,6,0,1,0

4,111,111,24,9,15,2,1
12,124,124,6,6,0,1,0
10,164,164,19,7,12,4,3
5,193,193,19,19,0,1,0
2,283,283,61,14,47,2,1
7,317,317,17,12,5,2,1
11,338,338,67,27,40,2,1
6,353,353,96,26,70,3,2
3,357,357,24,19,5,2,1
0,401,401,20,20,0,1,0
8,419,419,11,1,10,3,2
9,427,427,2,2,0,1,0
1,461,461,25,25,0,1,0

0,149,149,17,17,0,1,0
5,182,182,17,12,5,2,1
6,192,192,11,7,4,2,1
2,246,246,9,3,6,3,2
3,248,248,63,63,0,1,0
7,257,257,4,4,0,1,0
8,258,258,12,12,0,1,0
4,331,331,24,24,0,1,0
9,347,347,62,14,48,4,3
1,476,476,263,146,117,4,3

7,116,116,5,5,0,1,0
4,132,132,4,4,0,1,0
10,134,134,3,3,0,1,0
3,136,136,19,19,0,1,0
1,181,181,19,19,0,1,0
8,186,186,13,13,0,1,0
0,199,199,16,9,7,2,1
12,263,263,9,9,0,1,0
9,305,305,53,53,0,1,0
5,327,327,60,60,0,1,0
14,327,327,30,30,0,1,0
2,329,329,39,6,33,4,3
11,368,368,52,4,48,4,3
13,424,424,74,26,48,3,2
6,431,431,2,2,0,1,0

9,112,112,37,37,0,1,0
1,148,148,5,5,0,1,0
3,199,199,37,37,0,1,0
10,205,205,4,4,0,1,0
2,229,229,51,48,3,2,1
8,270,270,33,23,10,2,1
11,297,297,19,4,15,4,3
4,322,322,5,5,0,1,0
5,329,329,8,8,0,1,0
0,331,331,81,51,30,3,2
7,426,426,22,22,0,1,0
6,496,496,52,5,47,2,1

4,125,125,13,13,0,1,0
10,157,157,12,6,6,3,2
0,168,168,34,1,33,2,1
11,210,210,12,12,0,1,0
9,307,307,15,5,10,3,2
1,328,328,8,8,0,1,0
6,342,342,49,34,15,4,3
5,416,416,11,3,8,3,2
3,434,434,45,12,33,4,3
13,437,437,4,1,3,2,1
2,441,441,43,14,29,2,1
7,452,452,117,93,24,4,3
12,456,456,50,50,0,1,0
8,468,468,70,70,0,1,0

7,147,147,27,17,10,3,2
9,174,174,19,12,7,2,1
8,181,181,14,6,8,3,2
3,196,196,2,2,0,1,0
12,207,207,17,17,0,1,0
2,252,252,3,3,0,1,0
5,280,280,13,13,0,1,0
6,320,320,21,21,0,1,0
10,325,325,11,11,0,1,0
4,343,343,1,1,0,1,0
0,358,358,137,123,14,2,1
11,477,477,76,76,0,1,0
1,479,479,119,119,0,1,0

12,120,120,1,1,0,1,0
8,136,136,5,2,3,2,1
0,159,159,12,7,5,2,1
5,159,159,11,11,0,1,0
13,181,181,31,31,0,1,0
11,200,200,11,6,5,2,1
2,233,233,6,6,0,1,0
9,237,237,54,26,28,3,2
15,244,244,24,24,0,1,0
10,255,255,27,27,0,1,0
1,270,270,5,5,0,1,0
7,288,288,34,24,10,2,1
3,357,357,32,23,9,4,3
6,358,358,2,2,0,1,0
4,435,435,15,15,0,1,0
14,462,462,115,115,0,1,0
16,491,491,11,2,9,2,1

1,145,145,7,1,6,3,2
9,191,191,12,6,6,3,2
13,205,205,16,16,0,1,0
11,214,214,13,1,12,3,2
5,283,283,69,46,23,4,3
2,288,288,19,19,0,1,0
6,295,295,1,1,0,1,0
3,396,396,62,38,24,2,1
8,398,398,116,11,105,4,3
0,411,411,37,37,0,1,0
14,425,425,42,30,12,4,3
7,439,439,34,34,0,1,0
12,480,480,39,20,19,4,3
4,481,481,7,7,0,1,0
10,485,485,17,1,16,2,1

15,108,108,8,8,0,1,0
13,111,111,13,13,0,1,0
7,125,125,21,21,0,1,0
8,144,144,4,1,3,2,1
9,172,172,2,2,0,1,0
12,198,198,14,14,0,1,0
6,205,205,2,2,0,1,0
11,211,211,26,12,14,2,1
14,211,211,21,21,0,1,0
0,233,233,31,31,0,1,0
4,234,234,2,2,0,1,0
16,246,246,5,1,4,2,1
5,266,266,39,19,20,2,1
3,307,307,50,22,28,2,1
1,363,363,11,1,10,2,1
10,433,433,93,93,0,1,0
2,481,481,2,2,0,1,0

2,115,115,1,1,0,1,0
13,145,145,8,8,0,1,0
8,167,167,8,4,4,2,1
6,203,203,13,13,0,1,0
0,250,250,8,8,0,1,0
4,296,296,12,3,9,4,3
1,317,317,3,3,0,1,0
3,320,320,53,38,15,2,1
14,325,325,21,21,0,1,0
11,334,334,32,32,0,1,0
12,347,347,4,4,0,1,0
9,357,357,152,152,0,1,0
5,369,369,117,35,82,3,2
10,435,435,4,4,0,1,0
7,445,445,28,1,27,2,1

0,188,188,21,13,8,2,1
1,224,224,84,84,0,1,0
10,253,253,7,1,6,2,1
3,289,289,24,3,21,2,1
5,295,295,9,9,0,1,0
8,299,299,43,25,18,2,1
9,334,334,40,40,0,1,0
12,355,355,53,38,15,4,3
6,356,356,4,4,0,1,0
2,398,398,2,2,0,1,0
4,406,406,34,34,0,1,0
13,451,451,72,72,0,1,0
7,471,471,30,21,9,4,3
11,482,482,23,10,13,4,3

13,101,101,3,3,0,1,0
14,103,103,33,33,0,1,0
2,128,128,7,7,0,1,0
10,152,152,19,1,18,3,2
5,175,175,39,39,0,1,0
7,222,222,2,2,0,1,0
8,279,279,10,10,0,1,0
0,281,281,7,7,0,1,0
11,312,312,5,5,0,1,0
12,331,331,43,28,15,4,3
1,340,340,2,2,0,1,0
4,354,354,51,51,0,1,0
9,388,388,21,15,6,3,2
15,398,398,16,16,0,1,0
6,453,453,53,53,0,1,0
3,488,488,43,43,0,1,0

5,109,109,4,4,0,1,0
1,147,147,2,2,0,1,0
9,206,206,18,18,0,1,0
8,235,235,1,1,0,1,0
7,250,250,98,98,0,1,0
2,318,318,193,193,0,1,0
4,393,393,26,26,0,1,0
6,478,478,3,3,0,1,0
0,486,486,39,25,14,3,2
3,494,494,62,52,10,3,2

0,129,129,20,20,0,1,0
5,130,130,5,5,0,1,0
10,189,189,39,4,35,3,2
11,189,189,31,31,0,1,0
9,202,202,5,5,0,1,0
1,236,236,3,3,0,1,0
12,279,279,30,11,19,4,3
8,283,283,7,3,4,2,1
16,301,301,44,13,31,2,1
15,302,302,30,11,19,3,2
2,345,345,13,13,0,1,0
13,364,364,23,11,12,4,3
3,395,395,1,1,0,1,0
14,450,450,11,5,6,3,2
7,463,463,50,15,35,2,1
6,471,471,43,43,0,1,0
17,474,474,50,9,41,4,3
4,475,475,1,1,0,1,0

2,141,141,17,8,9,4,3
11,141,141,38,12,26,3,2
5,152,152,22,22,0,1,0
12,200,200,17,17,0,1,0
9,220,220,8,5,3,2,1
6,233,233,31,31,0,1,0
3,249,249,17,17,0,1,0
10,267,267,1,1,0,1,0
13,269,269,8,8,0,1,0
4,279,279,11,11,0,1,0
7,287,287,32,32,0,1,0
8,299,299,52,28,24,2,1
1,394,394,61,61,0,1,0
0,422,422,17,8,9,4,3

12,115,115,22,2,20,2,1
10,178,178,21,21,0,1,0
3,190,190,3,3,0,1,0
6,201,201,13,7,6,2,1
0,222,222,10,10,0,1,0
7,315,315,7,1,6,2,1
2,319,319,1,1,0,1,0
8,328,328,71,35,36,4,3
14,362,362,20,20,0,1,0
13,381,381,50,9,41,3,2
11,396,396,50,31,19,2,1
4,416,416,57,44,13,2,1
16,421,421,35,27,8,2,1
9,424,424,10,10,0,1,0
1,438,438,75,75,0,1,0
15,447,447,3,3,0,1,0
5,465,465,1,1,0,1,0

17,128,128,14,4,10,2,1
1,151,151,5,5,0,1,0
10,167,167,6,6,0,1,0
0,276,276,28,9,19,4,3
15,299,299,22,22,0,1,0
11,301,301,33,9,24,4,3
2,305,305,11,1,10,3,2
12,324,324,2,2,0,1,0
13,335,335,23,5,18,4,3
9,360,360,8,8,0,1,0
4,366,366,14,14,0,1,0
5,383,383,1,1,0,1,0
6,388,388,17,2,15,2,1
16,396,396,60,44,16,4,3
8,444,444,35,35,0,1,0
3,462,462,126,96,30,4,3
7,469,469,18,18,0,1,0
14,473,473,92,70,22,3,2

0,124,124,7,1,6,3,2
16,146,146,7,7,0,1,0
14,169,169,34,2,32,2,1
15,229,229,9,9,0,1,0
11,239,239,11,11,0,1,0
9,244,244,24,24,0,1,0
3,250,250,5,1,4,2,1
13,258,258,57,21,36,3,2
1,268,268,1,1,0,1,0
10,270,270,18,18,0,1,0
12,347,347,34,34,0,1,0
2,370,370,56,35,21,4,3
6,421,421,24,17,7,2,1
8,428,428,4,4,0,1,0
7,429,429,2,2,0,1,0
4,460,460,55,25,30,4,3
5,464,464,85,45,40,4,3

0,102,102,2,2,0,1,0
6,142,142,8,3,5,2,1
13,161,161,18,1,17,2,1
3,183,183,6,6,0,1,0
4,186,186,73,73,0,1,0
5,189,189,2,2,0,1,0
14,194,194,32,9,23,2,1
10,242,242,33,26,7,2,1
9,427,427,3,3,0,1,0
2,432,432,30,30,0,1,0
12,435,435,72,39,33,2,1
1,453,453,6,3,3,2,1
11,473,473,22,22,0,1,0
7,487,487,52,52,0,1,0
8,488,488,39,39,0,1,0

12,131,131,20,5,15,4,3
16,140,140,6,6,0,1,0
15,146,146,16,2,14,3,2
11,147,147,31,22,9,4,3
0,167,167,2,2,0,1,0
1,199,199,25,2,23,2,1
9,298,298,1,1,0,1,0
4,304,304,23,15,8,2,1
5,356,356,35,12,23,2,1
8,358,358,25,12,13,2,1
17,400,400,15,3,12,3,2
7,412,412,9,9,0,1,0
10,418,418,11,5,6,3,2
2,433,433,60,60,0,1,0
13,437,437,46,46,0,1,0
14,438,438,27,18,9,4,3
3,445,445,14,8,6,3,2
6,483,483,47,9,38,4,3

1,134,134,13,13,0,1,0
9,165,165,18,6,12,3,2
7,263,263,22,7,15,2,1
4,356,356,26,16,10,3,2
5,408,408,39,39,0,1,0
10,410,410,10,10,0,1,0
3,414,414,136,127,9,4,3
8,430,430,139,109,30,2,1
0,446,446,47,25,22,2,1
2,488,488,83,74,9,2,1
6,489,489,1,1,0,1,0

10,130,130,3,3,0,1,0
11,134,134,7,7,0,1,0
3,162,162,1,1,0,1,0
12,197,197,35,19,16,2,1
5,213,213,10,2,8,3,2
8,248,248,19,11,8,3,2
1,250,250,20,20,0,1,0
2,273,273,40,13,27,4,3
14,288,288,8,8,0,1,0
4,299,299,17,17,0,1,0
6,344,344,23,8,15,4,3
7,404,404,1,1,0,1,0
13,486,486,58,58,0,1,0
0,494,494,146,146,0,1,0
9,497,497,119,119,0,1,0

6,104,104,7,3,4,2,1
5,268,268,27,27,0,1,0
7,314,314,3,3,0,1,0
11,317,317,19,19,0,1,0
8,336,336,80,15,65,4,3
3,352,352,62,30,32,3,2
0,360,360,24,24,0,1,0
2,434,434,55,27,28,3,2
10,437,437,31,15,16,3,2
1,458,458,91,52,39,4,3
4,462,462,61,61,0,1,0
9,497,497,83,42,41,2,1

5,115,115,13,4,9,4,3
4,116,116,2,2,0,1,0
16,131,131,14,14,0,1,0
13,134,134,14,8,6,3,2
3,136,136,2,2,0,1,0
10,141,141,5,2,3,2,1
15,205,205,6,2,4,2,1
0,220,220,16,16,0,1,0
11,221,221,13,13,0,1,0
2,263,263,10,7,3,2,1
12,271,271,15,5,10,2,1
6,300,300,49,49,0,1,0
8,337,337,1,1,0,1,0
1,369,369,3,3,0,1,0
9,373,373,12,12,0,1,0
7,400,400,96,47,49,2,1
14,498,498,164,62,102,4,3

7,140,140,10,2,8,3,2
15,144,144,39,39,0,1,0
10,173,173,23,18,5,2,1
8,200,200,43,5,38,2,1
2,224,224,4,4,0,1,0
1,240,240,9,9,0,1,0
13,265,265,12,12,0,1,0
11,287,287,35,3,32,2,1
9,290,290,17,5,12,3,2
3,325,325,8,8,0,1,0
0,335,335,40,31,9,4,3
6,340,340,18,10,8,3,2
4,343,343,47,42,5,2,1
5,408,408,11,11,0,1,0
12,427,427,16,16,0,1,0
14,432,432,21,7,14,2,1

1,115,115,1,1,0,1,0
5,127,127,16,16,0,1,0
16,150,150,10,1,9,2,1
3,190,190,1,1,0,1,0
7,215,215,1,1,0,1,0
11,218,218,51,13,38,4,3
9,234,234,33,18,15,2,1
14,234,234,1,1,0,1,0
4,240,240,20,20,0,1,0
0,263,263,25,16,9,2,1
8,272,272,18,18,0,1,0
12,321,321,95,95,0,1,0
15,322,322,12,12,0,1,0
10,421,421,25,18,7,2,1
6,422,422,47,47,0,1,0
13,473,473,9,3,6,2,1
2,476,476,28,5,23,2,1

10,111,111,1,1,0,1,0
5,191,191,38,38,0,1,0
11,193,193,20,20,0,1,0
6,194,194,7,7,0,1,0
14,209,209,7,7,0,1,0
0,237,237,12,12,0,1,0
1,269,269,29,14,15,4,3
3,273,273,12,3,9,4,3
7,293,293,17,10,7,2,1
2,299,299,20,12,8,2,1
4,302,302,42,14,28,3,2
13,319,319,59,59,0,1,0
8,401,401,53,53,0,1,0
9,417,417,19,5,14,4,3
12,462,462,97,58,39,2,1

8,128,128,6,6,0,1,0
12,147,147,24,12,12,4,3
14,229,229,51,6,45,4,3
10,264,264,7,7,0,1,0
2,278,278,2,2,0,1,0
7,427,427,30,30,0,1,0
3,434,434,23,23,0,1,0
5,442,442,1,1,0,1,0
6,448,448,117,33,84,3,2
4,454,454,46,46,0,1,0
13,459,459,77,46,31,4,3
9,469,469,27,20,7,2,1
11,472,472,11,3,8,2,1
1,481,481,39,17,22,3,2
0,486,486,61,9,52,3,2

14,118,118,2,2,0,1,0
5,154,154,2,2,0,1,0
0,157,157,5,5,0,1,0
7,170,170,8,8,0,1,0
6,174,174,3,3,0,1,0
12,187,187,23,18,5,2,1
9,190,190,65,38,27,2,1
2,198,198,37,37,0,1,0
15,243,243,3,3,0,1,0
13,244,244,20,8,12,2,1
3,325,325,17,1,16,2,1
4,368,368,23,23,0,1,0
10,392,392,30,20,10,3,2
11,405,405,23,1,22,2,1
1,416,416,62,62,0,1,0
8,478,478,67,67,0,1,0

10,139,139,30,30,0,1,0
2,144,144,1,1,0,1,0
5,151,151,1,1,0,1,0
7,199,199,19,1,18,2,1
11,226,226,9,2,7,3,2
12,258,258,11,4,7,2,1
9,262,262,76,6,70,3,2
8,347,347,10,5,5,2,1
4,373,373,43,43,0,1,0
1,393,393,141,51,90,4,3
3,437,437,54,54,0,1,0
0,443,443,40,28,12,3,2
6,469,469,3,3,0,1,0

12,123,123,4,1,3,2,1
5,126,126,31,5,26,3,2
1,200,200,2,2,0,1,0
10,216,216,1,1,0,1,0
4,227,227,2,2,0,1,0
2,232,232,15,15,0,1,0
9,257,257,5,2,3,2,1
11,267,267,38,38,0,1,0
8,306,306,88,19,69,3,2
6,411,411,21,21,0,1,0
0,450,450,106,16,90,4,3
3,469,469,64,16,48,3,2
7,471,471,83,83,0,1,0

5,155,155,7,7,0,1,0
1,158,158,1,1,0,1,0
10,159,159,5,1,4,2,1
11,167,167,51,12,39,2,1
7,232,232,5,5,0,1,0
3,254,254,97,97,0,1,0
8,258,258,3,3,0,1,0
4,297,297,27,18,9,2,1
12,298,298,39,39,0,1,0
2,303,303,19,5,14,3,2
6,348,348,10,10,0,1,0
0,354,354,30,30,0,1,0
13,364,364,31,13,18,3,2
9,369,369,48,48,0,1,0

4,120,120,11,11,0,1,0
11,135,135,22,22,0,1,0
3,139,139,31,31,0,1,0
14,139,139,2,2,0,1,0
8,150,150,8,8,0,1,0
2,153,153,12,6,6,3,2
0,156,156,8,2,6,2,1
1,156,156,9,6,3,2,1
10,161,161,6,6,0,1,0
15,204,204,18,3,15,4,3
13,244,244,12,4,8,2,1
5,248,248,18,10,8,2,1
12,359,359,17,1,16,3,2
6,363,363,1,1,0,1,0
9,430,430,139,139,0,1,0
7,470,470,33,1,32,3,2

6,100,100,6,6,0,1,0
11,129,129,4,4,0,1,0
5,157,157,10,10,0,1,0
8,199,199,31,9,22,4,3
2,212,212,3,3,0,1,0
1,222,222,56,56,0,1,0
3,237,237,69,49,20,3,2
4,244,244,6,6,0,1,0
10,327,327,7,7,0,1,0
9,375,375,7,7,0,1,0
13,412,412,78,78,0,1,0
0,420,420,1,1,0,1,0
12,439,439,41,41,0,1,0
7,459,459,92,70,22,2,1

6,147,147,3,3,0,1,0
9,152,152,15,5,10,3,2
4,167,167,39,39,0,1,0
8,185,185,14,14,0,1,0
11,226,226,5,5,0,1,0
13,226,226,24,24,0,1,0
12,237,237,51,7,44,2,1
2,269,269,31,23,8,2,1
10,287,287,36,28,8,2,1
1,314,314,25,16,9,2,1
5,327,327,14,14,0,1,0
14,332,332,23,11,12,2,1
3,414,414,50,50,0,1,0
0,432,432,13,13,0,1,0
7,434,434,25,25,0,1,0

3,102,102,16,8,8,3,2
4,102,102,7,7,0,1,0
13,158,158,3,3,0,1,0
14,163,163,23,2,21,2,1
7,194,194,9,2,7,2,1
11,195,195,2,2,0,1,0
12,240,240,37,37,0,1,0
9,291,291,12,3,9,4,3
1,309,309,1,1,0,1,0
2,319,319,6,2,4,2,1
8,323,323,45,21,24,2,1
6,325,325,20,9,11,4,3
5,345,345,5,5,0,1,0
10,371,371,79,79,0,1,0
0,433,433,144,122,22,2,1

2,171,171,14,14,0,1,0
7,174,174,11,11,0,1,0
8,265,265,51,44,7,2,1
6,280,280,39,11,28,2,1
3,314,314,144,139,5,2,1
1,407,407,37,26,11,2,1
5,427,427,38,38,0,1,0
9,465,465,1,1,0,1,0
4,466,466,3,3,0,1,0
10,486,486,106,30,76,3,2
0,488,488,35,9,26,3,2

5,105,105,5,5,0,1,0
4,131,131,3,3,0,1,0
0,262,262,21,18,3,2,1
2,352,352,33,33,0,1,0
12,364,364,42,6,36,4,3
1,365,365,129,54,75,4,3
9,370,370,28,16,12,4,3
10,372,372,21,13,8,2,1
7,398,398,11,5,6,3,2
3,414,414,43,43,0,1,0
11,421,421,47,47,0,1,0
8,433,433,128,104,24,2,1
6,449,449,13,5,8,2,1

4,130,130,9,2,7,2,1
13,138,138,33,33,0,1,0
11,140,140,8,8,0,1,0
17,145,145,32,32,0,1,0
16,173,173,2,2,0,1,0
3,195,195,20,17,3,2,1
8,233,233,11,2,9,4,3
15,236,236,2,2,0,1,0
7,243,243,26,4,22,4,3
12,253,253,33,9,24,2,1
14,262,262,14,14,0,1,0
0,279,279,4,4,0,1,0
5,337,337,7,7,0,1,0
1,352,352,65,53,12,4,3
2,352,352,8,8,0,1,0
6,352,352,1,1,0,1,0
10,471,471,11,6,5,2,1
9,477,477,51,19,32,2,1

4,120,120,39,24,15,4,3
11,129,129,9,9,0,1,0
8,172,172,17,3,14,4,3
1,239,239,39,28,11,2,1
2,283,283,9,3,6,2,1
12,297,297,46,22,24,3,2
0,303,303,24,24,0,1,0
7,309,309,34,34,0,1,0
3,376,376,18,18,0,1,0
13,380,380,85,57,28,3,2
9,396,396,8,8,0,1,0
10,397,397,15,15,0,1,0
6,403,403,2,2,0,1,0
5,424,424,21,21,0,1,0

15,106,106,27,14,13,2,1
10,216,216,27,27,0,1,0
4,219,219,1,1,0,1,0
1,259,259,12,2,10,3,2
12,267,267,38,16,22,2,1
11,271,271,13,13,0,1,0
2,272,272,17,17,0,1,0
3,273,273,27,27,0,1,0
7,279,279,19,8,11,2,1
9,286,286,9,1,8,2,1
13,299,299,2,2,0,1,0
6,319,319,85,85,0,1,0
8,320,320,24,16,8,3,2
5,346,346,15,15,0,1,0
0,400,400,15,15,0,1,0
14,471,471,52,7,45,4,3

0,180,180,73,73,0,1,0
4,202,202,1,1,0,1,0
8,209,209,1,1,0,1,0
5,323,323,3,3,0,1,0
1,326,326,59,47,12,3,2
2,333,333,33,12,21,4,3
7,378,378,99,53,46,2,1
9,423,423,74,50,24,3,2
3,425,425,7,7,0,1,0
10,458,458,66,52,14,2,1
6,471,471,52,52,0,1,0

5,129,129,14,4,10,2,1
9,133,133,6,6,0,1,0
10,165,165,5,5,0,1,0
7,196,196,12,12,0,1,0
6,210,210,1,1,0,1,0
1,232,232,1,1,0,1,0
4,268,268,16,12,4,2,1
11,311,311,27,27,0,1,0
13,325,325,68,68,0,1,0
2,351,351,1,1,0,1,0
15,358,358,31,31,0,1,0
3,419,419,171,163,8,3,2
12,435,435,34,34,0,1,0
14,473,473,86,70,16,3,2
0,481,481,1,1,0,1,0
8,487,487,24,7,17,2,1

5,151,151,6,6,0,1,0
7,156,156,10,1,9,2,1
2,172,172,13,13,0,1,0
3,229,229,14,14,0,1,0
1,264,264,53,15,38,3,2
0,312,312,48,48,0,1,0
11,346,346,11,7,4,2,1
9,378,378,14,11,3,2,1
12,381,381,144,104,40,3,2
10,422,422,22,22,0,1,0
4,434,434,76,40,36,4,3
8,467,467,66,66,0,1,0
6,496,496,3,3,0,1,0

12,103,103,12,12,0,1,0
6,104,104,15,15,0,1,0
10,108,108,16,7,9,2,1
2,125,125,4,4,0,1,0
8,159,159,15,7,8,2,1
13,190,190,2,2,0,1,0
0,273,273,5,1,4,2,1
1,311,311,16,16,0,1,0
3,333,333,63,26,37,2,1
5,336,336,27,27,0,1,0
9,353,353,9,9,0,1,0
14,362,362,103,65,38,2,1
11,390,390,14,5,9,2,1
4,436,436,18,2,16,3,2
7,445,445,64,40,24,2,1

5,120,120,1,1,0,1,0
13,137,137,10,10,0,1,0
10,149,149,1,1,0,1,0
2,168,168,14,14,0,1,0
8,234,234,50,34,16,3,2
4,238,238,2,2,0,1,0
12,247,247,31,3,28,3,2
6,260,260,94,43,51,4,3
1,269,269,29,29,0,1,0
7,279,279,22,22,0,1,0
9,334,334,67,37,30,4,3
0,432,432,48,48,0,1,0
11,446,446,8,4,4,2,1
3,465,465,10,10,0,1,0

11,163,163,9,3,6,2,1
14,195,195,23,12,11,2,1
3,246,246,38,5,33,4,3
12,247,247,25,2,23,2,1
13,252,252,3,3,0,1,0
10,261,261,20,20,0,1,0
0,277,277,14,3,11,2,1
1,312,312,7,7,0,1,0
7,319,319,38,38,0,1,0
6,337,337,36,36,0,1,0
2,402,402,50,7,43,3,2
15,412,412,28,28,0,1,0
8,454,454,15,9,6,2,1
5,459,459,9,9,0,1,0
4,481,481,34,27,7,2,1
9,485,485,138,54,84,4,3

19,118,118,4,4,0,1,0
5,119,119,10,5,5,2,1
4,125,125,6,6,0,1,0
9,151,151,3,3,0,1,0
8,195,195,8,8,0,1,0
20,205,205,5,5,0,1,0
16,221,221,73,34,39,4,3
13,228,228,16,4,12,4,3
14,236,236,11,11,0,1,0
7,237,237,47,42,5,2,1
15,258,258,9,9,0,1,0
1,312,312,10,3,7,2,1
12,378,378,14,2,12,3,2
11,388,388,39,39,0,1,0
0,414,414,7,7,0,1,0
6,425,425,3,3,0,1,0
17,430,430,77,44,33,2,1
10,433,433,6,1,5,2,1
18,434,434,28,24,4,2,1
2,450,450,12,3,9,4,3
3,485,485,3,3,0,1,0

6,101,101,1,1,0,1,0
11,102,102,6,6,0,1,0
14,144,144,14,4,10,2,1
10,146,146,16,8,8,2,1
13,148,148,6,6,0,1,0
3,152,152,4,4,0,1,0
8,238,238,24,24,0,1,0
4,279,279,1,1,0,1,0
2,290,290,37,37,0,1,0
1,330,330,11,11,0,1,0
0,367,367,13,5,8,3,2
5,369,369,78,78,0,1,0
7,387,387,60,20,40,3,2
15,392,392,15,15,0,1,0
12,406,406,42,42,0,1,0
9,478,478,130,130,0,1,0

11,128,128,13,13,0,1,0
3,136,136,1,1,0,1,0
9,139,139,9,3,6,3,2
6,141,141,1,1,0,1,0
1,143,143,26,26,0,1,0
16,166,166,16,16,0,1,0
2,219,219,10,10,0,1,0
14,228,228,19,4,15,2,1
17,299,299,51,51,0,1,0
12,327,327,20,20,0,1,0
4,333,333,45,45,0,1,0
5,381,381,9,3,6,3,2
0,384,384,60,60,0,1,0
15,444,444,13,13,0,1,0
10,448,448,7,7,0,1,0
7,465,465,1,1,0,1,0
8,485,485,30,30,0,1,0
13,491,491,86,39,47,2,1

13,127,127,22,22,0,1,0
12,135,135,11,11,0,1,0
7,149,149,1,1,0,1,0
1,154,154,8,1,7,2,1
8,196,196,41,41,0,1,0
11,197,197,29,18,11,2,1
5,200,200,5,5,0,1,0
4,204,204,4,4,0,1,0
3,211,211,44,9,35,2,1
15,233,233,15,15,0,1,0
16,240,240,13,4,9,4,3
2,262,262,3,3,0,1,0
6,292,292,14,14,0,1,0
0,323,323,33,33,0,1,0
10,447,447,74,74,0,1,0
14,473,473,14,14,0,1,0
9,483,483,9,1,8,2,1

6,135,135,11,11,0,1,0
11,145,145,19,11,8,3,2
12,249,249,7,7,0,1,0
13,288,288,42,42,0,1,0
0,309,309,27,27,0,1,0
7,316,316,3,3,0,1,0
17,332,332,54,15,39,2,1
14,336,336,19,19,0,1,0
1,336,336,9,3,6,3,2
2,344,344,21,21,0,1,0
9,352,352,14,2,12,2,1
4,367,367,8,8,0,1,0
10,373,373,28,2,26,2,1
15,373,373,7,7,0,1,0
3,374,374,56,23,33,2,1
8,406,406,20,20,0,1,0
5,486,486,49,46,3,2,1
16,490,490,81,1,80,4,3

7,101,101,2,2,0,1,0
10,184,184,28,19,9,4,3
1,228,228,81,81,0,1,0
9,290,290,7,7,0,1,0
2,300,300,7,1,6,2,1
6,363,363,36,12,24,4,3
3,379,379,100,63,37,2,1
0,405,405,24,24,0,1,0
8,414,414,42,42,0,1,0
5,428,428,101,101,0,1,0
4,495,495,41,4,37,2,1

9,127,127,38,7,31,4,3
7,173,173,11,11,0,1,0
8,180,180,12,12,0,1,0
12,181,181,2,2,0,1,0
3,202,202,8,2,6,3,2
2,212,212,40,40,0,1,0
5,215,215,19,19,0,1,0
0,231,231,8,2,6,2,1
1,234,234,1,1,0,1,0
13,268,268,10,10,0,1,0
10,296,296,6,6,0,1,0
6,315,315,11,1,10,3,2
14,377,377,84,84,0,1,0
4,419,419,104,61,43,4,3
11,497,497,30,30,0,1,0

4,100,100,1,1,0,1,0
12,110,110,2,2,0,1,0
8,119,119,3,3,0,1,0
21,130,130,11,2,9,4,3
7,151,151,2,2,0,1,0
0,158,158,21,4,17,4,3
9,168,168,1,1,0,1,0
13,184,184,2,2,0,1,0
3,228,228,6,6,0,1,0
15,228,228,16,16,0,1,0
1,229,229,13,13,0,1,0
22,241,241,11,6,5,2,1
18,247,247,7,7,0,1,0
19,252,252,1,1,0,1,0
2,289,289,21,21,0,1,0
6,315,315,2,2,0,1,0
14,316,316,15,15,0,1,0
20,319,319,12,12,0,1,0
17,341,341,143,143,0,1,0
5,360,360,43,43,0,1,0
16,453,453,41,41,0,1,0
11,457,457,11,11,0,1,0
10,481,481,30,2,28,3,2

5,128,128,4,1,3,2,1
3,132,132,16,4,12,2,1
13,195,195,33,8,25,2,1
11,197,197,1,1,0,1,0
8,205,205,7,7,0,1,0
6,309,309,60,22,38,2,1
7,332,332,26,26,0,1,0
0,338,338,2,2,0,1,0
2,355,355,17,2,15,4,3
15,414,414,39,39,0,1,0
9,426,426,98,98,0,1,0
1,447,447,4,4,0,1,0
4,453,453,82,46,36,4,3
14,474,474,74,74,0,1,0
10,489,489,20,20,0,1,0
12,500,500,8,8,0,1,0

16,120,120,17,17,0,1,0
17,129,129,23,1,22,4,3
12,139,139,3,3,0,1,0
8,159,159,1,1,0,1,0
3,159,159,27,27,0,1,0
13,176,176,13,13,0,1,0
15,192,192,44,16,28,2,1
9,209,209,41,18,23,2,1
10,231,231,3,3,0,1,0
11,263,263,13,5,8,2,1
14,274,274,6,6,0,1,0
1,290,290,2,2,0,1,0
6,300,300,14,7,7,2,1
5,384,384,63,33,30,2,1
4,445,445,4,4,0,1,0
2,455,455,4,1,3,2,1
7,459,459,11,11,0,1,0
0,470,470,28,13,15,4,3

5,104,104,14,14,0,1,0
4,178,178,5,5,0,1,0
0,203,203,11,11,0,1,0
13,230,230,39,39,0,1,0
6,237,237,11,5,6,3,2
8,255,255,9,9,0,1,0
9,272,272,16,9,7,2,1
3,281,281,36,22,14,3,2
7,340,340,90,24,66,4,3
1,364,364,91,29,62,3,2
10,366,366,45,45,0,1,0
11,433,433,11,1,10,2,1
2,475,475,29,29,0,1,0
12,486,486,18,18,0,1,0

10,158,158,6,6,0,1,0
0,193,193,12,12,0,1,0
1,227,227,16,4,12,2,1
2,253,253,44,18,26,3,2
6,255,255,3,3,0,1,0
7,287,287,5,5,0,1,0
8,321,321,136,56,80,3,2
12,369,369,56,56,0,1,0
3,386,386,41,1,40,3,2
5,462,462,118,118,0,1,0
11,476,476,17,5,12,3,2
9,489,489,16,2,14,4,3
4,498,498,16,16,0,1,0

4,120,120,7,7,0,1,0
10,135,135,13,13,0,1,0
12,151,151,23,23,0,1,0
3,172,172,27,27,0,1,0
14,246,246,7,2,5,2,1
1,252,252,5,5,0,1,0
0,291,291,1,1,0,1,0
6,291,291,1,1,0,1,0
11,379,379,28,3,25,2,1
9,400,400,71,64,7,2,1
5,413,413,65,65,0,1,0
2,426,426,71,55,16,2,1
13,443,443,59,20,39,4,3
8,455,455,33,1,32,3,2
7,460,460,29,20,9,4,3
15,498,498,24,24,0,1,0

3,134,134,43,16,27,2,1
6,178,178,3,3,0,1,0
4,255,255,27,4,23,2,1
8,256,256,17,17,0,1,0
2,285,285,3,3,0,1,0
10,297,297,54,54,0,1,0
11,318,318,83,83,0,1,0
7,330,330,1,1,0,1,0
12,405,405,35,15,20,3,2
9,435,435,41,1,40,2,1
5,439,439,57,57,0,1,0
0,442,442,44,32,12,2,1
1,447,447,15,15,0,1,0

12,113,113,9,9,0,1,0
7,141,141,48,18,30,3,2
0,200,200,59,15,44,3,2
6,203,203,2,2,0,1,0
3,286,286,14,14,0,1,0
2,294,294,1,1,0,1,0
1,337,337,67,17,50,2,1
11,373,373,26,26,0,1,0
13,376,376,10,1,9,4,3
5,403,403,21,1,20,3,2
9,409,409,4,4,0,1,0
4,414,414,39,39,0,1,0
10,446,446,54,30,24,2,1
8,491,491,32,22,10,2,1

12,168,168,5,5,0,1,0
8,181,181,8,2,6,3,2
0,191,191,37,5,32,2,1
3,198,198,18,18,0,1,0
18,201,201,31,31,0,1,0
6,221,221,3,3,0,1,0
11,253,253,1,1,0,1,0
5,253,253,18,18,0,1,0
16,303,303,47,25,22,3,2
17,309,309,24,24,0,1,0
4,323,323,25,7,18,3,2
7,329,329,5,1,4,2,1
13,366,366,43,16,27,2,1
9,378,378,12,3,9,4,3
1,391,391,1,1,0,1,0
10,393,393,17,12,5,2,1
2,416,416,47,9,38,2,1
15,424,424,39,39,0,1,0
14,477,477,41,41,0,1,0

11,103,103,3,3,0,1,0
6,114,114,3,3,0,1,0
1,131,131,10,2,8,2,1
2,148,148,15,15,0,1,0
10,188,188,3,3,0,1,0
13,243,243,79,79,0,1,0
15,248,248,2,2,0,1,0
7,295,295,35,32,3,2,1
0,298,298,6,6,0,1,0
12,314,314,42,23,19,2,1
8,420,420,42,42,0,1,0
9,429,429,80,80,0,1,0
14,431,431,8,8,0,1,0
3,471,471,23,5,18,2,1
5,471,471,70,70,0,1,0
4,475,475,29,29,0,1,0

5,125,125,12,7,5,2,1
14,126,126,19,6,13,2,1
1,146,146,12,9,3,2,1
2,148,148,6,6,0,1,0
11,153,153,1,1,0,1,0
0,217,217,44,44,0,1,0
8,226,226,6,1,5,2,1
16,255,255,31,31,0,1,0
6,273,273,1,1,0,1,0
12,275,275,24,17,7,2,1
9,280,280,22,14,8,2,1
10,287,287,21,21,0,1,0
7,310,310,26,26,0,1,0
15,327,327,41,41,0,1,0
13,359,359,57,13,44,3,2
3,362,362,13,13,0,1,0
4,414,414,22,22,0,1,0

10,101,101,13,13,0,1,0
6,107,107,27,27,0,1,0
11,133,133,1,1,0,1,0
7,151,151,48,33,15,4,3
12,233,233,8,2,6,3,2
13,301,301,7,7,0,1,0
8,340,340,11,3,8,2,1
2,381,381,62,25,37,2,1
5,385,385,16,16,0,1,0
9,402,402,70,25,45,2,1
3,403,403,11,4,7,2,1
1,415,415,56,45,11,3,2
0,450,450,24,16,8,3,2
4,486,486,14,14,0,1,0

2,102,102,12,2,10,2,1
4,162,162,1,1,0,1,0
6,173,173,14,14,0,1,0
10,271,271,7,1,6,3,2
1,288,288,56,56,0,1,0
5,299,299,35,5,30,3,2
7,321,321,24,6,18,2,1
3,366,366,23,1,22,3,2
9,376,376,61,40,21,4,3
12,409,409,17,1,16,3,2
11,446,446,125,70,55,3,2
8,470,470,24,9,15,2,1
0,474,474,96,86,10,2,1

1,101,101,14,14,0,1,0
9,138,138,29,3,26,3,2
5,160,160,2,2,0,1,0
13,192,192,17,7,10,2,1
3,206,206,22,4,18,4,3
8,230,230,16,16,0,1,0
12,252,252,39,23,16,3,2
10,260,260,6,6,0,1,0
0,341,341,6,2,4,2,1
11,407,407,59,59,0,1,0
2,434,434,107,74,33,2,1
4,445,445,19,19,0,1,0
7,458,458,10,10,0,1,0
6,477,477,65,65,0,1,0

0,196,196,26,26,0,1,0
1,211,211,17,17,0,1,0
2,245,245,7,7,0,1,0
3,249,249,37,16,21,4,3
4,287,287,44,9,35,2,1
10,298,298,4,4,0,1,0
6,305,305,42,42,0,1,0
5,311,311,49,49,0,1,0
7,318,318,87,68,19,2,1
8,352,352,54,6,48,3,2
9,382,382,40,32,8,2,1
11,427,427,1,1,0,1,0
12,454,454,11,11,0,1,0

2,106,106,11,7,4,2,1
10,107,107,13,13,0,1,0
3,111,111,3,3,0,1,0
14,112,112,15,15,0,1,0
9,192,192,3,3,0,1,0
7,196,196,8,8,0,1,0
8,196,196,60,12,48,2,1
5,227,227,2,2,0,1,0
11,249,249,6,6,0,1,0
0,277,277,60,47,13,2,1
4,295,295,36,15,21,4,3
6,320,320,5,5,0,1,0
13,372,372,9,9,0,1,0
1,378,378,63,47,16,3,2
12,476,476,48,33,15,4,3

17,103,103,14,3,11,2,1
14,107,107,1,1,0,1,0
15,144,144,12,12,0,1,0
8,188,188,3,3,0,1,0
13,198,198,1,1,0,1,0
7,203,203,3,3,0,1,0
9,222,222,16,16,0,1,0
0,272,272,1,1,0,1,0
1,283,283,39,20,19,2,1
11,294,294,59,13,46,4,3
12,304,304,10,10,0,1,0
16,304,304,77,36,41,2,1
4,352,352,17,3,14,3,2
6,375,375,35,9,26,2,1
10,410,410,11,11,0,1,0
2,437,437,35,9,26,2,1
5,486,486,94,37,57,4,3
3,489,489,7,7,0,1,0

7,116,116,7,7,0,1,0
12,135,135,9,5,4,2,1
1,144,144,24,4,20,4,3
4,155,155,16,8,8,2,1
10,164,164,5,5,0,1,0
9,167,167,4,4,0,1,0
5,229,229,35,20,15,4,3
3,242,242,13,13,0,1,0
13,271,271,29,2,27,4,3
0,354,354,20,9,11,2,1
2,397,397,21,21,0,1,0
6,422,422,25,25,0,1,0
11,433,433,59,59,0,1,0
8,470,470,108,36,72,4,3
14,496,496,58,4,54,4,3

4,122,122,13,1,12,2,1
14,197,197,16,16,0,1,0
13,202,202,1,1,0,1,0
9,279,279,35,3,32,3,2
17,315,315,19,19,0,1,0
15,316,316,17,17,0,1,0
0,319,319,4,4,0,1,0
21,335,335,86,22,64,3,2
10,337,337,5,5,0,1,0
8,351,351,18,18,0,1,0
12,356,356,19,19,0,1,0
11,365,365,11,11,0,1,0
20,370,370,7,7,0,1,0
7,380,380,6,3,3,2,1
1,386,386,27,27,0,1,0
3,389,389,1,1,0,1,0
19,397,397,5,1,4,2,1
16,411,411,20,11,9,4,3
5,426,426,2,2,0,1,0
18,433,433,112,74,38,3,2
2,464,464,48,39,9,2,1
6,466,466,11,11,0,1,0

8,119,119,4,4,0,1,0
11,165,165,11,2,9,2,1
0,177,177,13,13,0,1,0
6,184,184,15,15,0,1,0
4,217,217,4,4,0,1,0
1,257,257,42,42,0,1,0
9,303,303,6,6,0,1,0
12,388,388,39,39,0,1,0
10,400,400,162,135,27,2,1
2,401,401,66,28,38,2,1
7,403,403,4,4,0,1,0
3,478,478,123,59,64,3,2
5,490,490,12,5,7,2,1

5,113,113,24,24,0,1,0
13,174,174,7,2,5,2,1
12,218,218,22,22,0,1,0
6,227,227,24,24,0,1,0
0,248,248,3,3,0,1,0
2,260,260,23,23,0,1,0
4,260,260,17,17,0,1,0
3,274,274,4,4,0,1,0
15,328,328,10,10,0,1,0
9,389,389,60,38,22,2,1
10,415,415,3,3,0,1,0
1,421,421,1,1,0,1,0
8,426,426,63,52,11,2,1
11,474,474,14,14,0,1,0
14,484,484,168,147,21,4,3
7,496,496,26,11,15,4,3

9,115,115,13,2,11,2,1
4,129,129,9,9,0,1,0
8,131,131,42,4,38,3,2
6,135,135,33,33,0,1,0
0,139,139,4,4,0,1,0
1,199,199,7,7,0,1,0
5,222,222,6,1,5,2,1
12,223,223,2,2,0,1,0
3,256,256,21,15,6,2,1
10,320,320,6,3,3,2,1
11,413,413,48,48,0,1,0
7,423,423,47,47,0,1,0
13,463,463,14,14,0,1,0
2,491,491,107,71,36,2,1

15,146,146,6,6,0,1,0
2,183,183,1,1,0,1,0
16,185,185,53,31,22,2,1
3,207,207,16,16,0,1,0
4,240,240,11,11,0,1,0
9,241,241,2,2,0,1,0
14,243,243,20,20,0,1,0
11,284,284,11,11,0,1,0
5,288,288,8,8,0,1,0
6,291,291,3,3,0,1,0
0,361,361,25,15,10,2,1
12,368,368,32,32,0,1,0
10,401,401,38,38,0,1,0
13,405,405,34,34,0,1,0
8,410,410,24,6,18,2,1
1,420,420,51,51,0,1,0
7,465,465,129,96,33,4,3

2,141,141,8,8,0,1,0
7,185,185,4,4,0,1,0
0,204,204,89,41,48,2,1
8,230,230,16,10,6,2,1
9,241,241,36,5,31,2,1
13,293,293,43,34,9,2,1
6,309,309,2,2,0,1,0
10,314,314,55,55,0,1,0
11,329,329,27,9,18,4,3
3,355,355,9,2,7,2,1
5,392,392,5,5,0,1,0
1,402,402,13,13,0,1,0
4,421,421,56,56,0,1,0
12,472,472,33,18,15,2,1

8,113,113,5,5,0,1,0
2,158,158,12,8,4,2,1
1,212,212,92,92,0,1,0
5,295,295,11,11,0,1,0
7,312,312,28,14,14,3,2
4,336,336,68,22,46,2,1
6,445,445,41,41,0,1,0
0,452,452,86,86,0,1,0
3,471,471,74,4,70,3,2
9,489,489,42,20,22,3,2

5,103,103,15,6,9,2,1
0,133,133,5,5,0,1,0
17,147,147,6,6,0,1,0
12,181,181,1,1,0,1,0
9,196,196,6,2,4,2,1
16,229,229,54,54,0,1,0
4,250,250,3,3,0,1,0
8,286,286,48,16,32,3,2
14,294,294,7,7,0,1,0
1,300,300,51,23,28,3,2
6,353,353,13,6,7,2,1
2,357,357,20,14,6,3,2
7,388,388,9,9,0,1,0
11,405,405,13,3,10,2,1
10,479,479,9,6,3,2,1
3,486,486,1,1,0,1,0
15,486,486,50,11,39,3,2
13,487,487,135,127,8,2,1

7,102,102,1,1,0,1,0
14,115,115,15,9,6,2,1
2,172,172,5,5,0,1,0
9,177,177,6,6,0,1,0
6,207,207,9,9,0,1,0
3,233,233,53,53,0,1,0
10,257,257,25,25,0,1,0
8,265,265,6,3,3,2,1
4,305,305,18,8,10,2,1
5,309,309,23,23,0,1,0
13,357,357,72,48,24,2,1
1,378,378,82,25,57,4,3
12,435,435,75,15,60,4,3
11,448,448,27,27,0,1,0
0,490,490,24,4,20,4,3

7,122,122,6,6,0,1,0
4,135,135,8,4,4,2,1
5,164,164,22,22,0,1,0
11,165,165,22,22,0,1,0
10,247,247,60,44,16,3,2
9,330,330,13,8,5,2,1
0,348,348,121,112,9,4,3
3,390,390,11,11,0,1,0
1,423,423,29,19,10,2,1
13,457,457,24,24,0,1,0
6,462,462,1,1,0,1,0
2,471,471,29,29,0,1,0
8,493,493,41,41,0,1,0
12,497,497,56,46,10,2,1

9,115,115,3,3,0,1,0
10,202,202,16,16,0,1,0
7,205,205,28,28,0,1,0
1,214,214,13,13,0,1,0
0,217,217,11,11,0,1,0
12,264,264,13,13,0,1,0
2,265,265,39,3,36,2,1
4,301,301,40,21,19,2,1
3,321,321,86,86,0,1,0
5,331,331,14,14,0,1,0
11,358,358,102,54,48,2,1
8,411,411,52,44,8,3,2
6,480,480,6,3,3,2,1

8,105,105,11,11,0,1,0
0,108,108,1,1,0,1,0
3,131,131,7,7,0,1,0
10,154,154,9,9,0,1,0
7,264,264,7,7,0,1,0
11,268,268,14,14,0,1,0
9,322,322,21,8,13,2,1
4,325,325,47,37,10,2,1
1,370,370,55,19,36,2,1
5,370,370,49,8,41,4,3
12,384,384,89,49,40,2,1
6,395,395,17,17,0,1,0
14,398,398,4,1,3,2,1
13,408,408,80,80,0,1,0
2,441,441,64,22,42,3,2

5,103,103,3,3,0,1,0
12,109,109,11,4,7,2,1
6,158,158,62,33,29,2,1
11,199,199,5,5,0,1,0
0,252,252,6,2,4,2,1
7,331,331,17,17,0,1,0
10,387,387,6,6,0,1,0
8,393,393,12,1,11,2,1
3,395,395,49,22,27,4,3
4,400,400,97,34,63,4,3
2,414,414,24,24,0,1,0
1,448,448,101,6,95,4,3
9,462,462,44,17,27,4,3

9,112,112,5,5,0,1,0
3,153,153,29,29,0,1,0
2,179,179,9,9,0,1,0
7,183,183,4,1,3,2,1
11,189,189,56,18,38,3,2
1,210,210,20,6,14,3,2
0,220,220,24,24,0,1,0
6,254,254,13,6,7,2,1
12,267,267,7,4,3,2,1
13,359,359,5,2,3,2,1
8,388,388,35,19,16,2,1
4,402,402,33,33,0,1,0
10,405,405,90,90,0,1,0
5,418,418,52,24,28,3,2

13,148,148,5,5,0,1,0
14,150,150,3,3,0,1,0
11,199,199,34,16,18,4,3
8,237,237,41,41,0,1,0
12,242,242,64,64,0,1,0
10,249,249,2,2,0,1,0
7,299,299,7,7,0,1,0
9,310,310,45,9,36,3,2
4,313,313,13,13,0,1,0
6,315,315,22,19,3,2,1
0,317,317,29,17,12,4,3
5,349,349,7,7,0,1,0
15,397,397,29,29,0,1,0
2,432,432,89,12,77,4,3
3,464,464,33,33,0,1,0
1,473,473,3,3,0,1,0

0,124,124,11,11,0,1,0
11,132,132,4,4,0,1,0
12,174,174,5,5,0,1,0
8,177,177,10,10,0,1,0
10,262,262,8,8,0,1,0
1,267,267,12,2,10,2,1
2,268,268,2,2,0,1,0
7,342,342,64,6,58,4,3
3,351,351,13,5,8,3,2
9,355,355,58,38,20,3,2
5,402,402,46,46,0,1,0
4,427,427,115,115,0,1,0
6,497,497,69,3,66,3,2
13,497,497,105,9,96,4,3

6,118,118,12,6,6,3,2
5,142,142,14,10,4,2,1
13,175,175,8,8,0,1,0
11,177,177,17,6,11,2,1
4,205,205,4,4,0,1,0
10,219,219,4,4,0,1,0
7,245,245,10,10,0,1,0
16,272,272,68,31,37,2,1
2,283,283,42,42,0,1,0
3,333,333,19,3,16,4,3
15,333,333,7,7,0,1,0
8,361,361,37,37,0,1,0
12,387,387,103,103,0,1,0
9,390,390,5,5,0,1,0
14,451,451,7,7,0,1,0
0,457,457,28,23,5,2,1
1,471,471,28,28,0,1,0

7,122,122,12,12,0,1,0
9,230,230,11,11,0,1,0
3,264,264,73,22,51,4,3
6,280,280,6,6,0,1,0
5,291,291,11,1,10,3,2
2,296,296,6,6,0,1,0
0,301,301,100,28,72,4,3
8,311,311,70,54,16,3,2
11,379,379,23,15,8,2,1
10,395,395,86,77,9,4,3
1,406,406,11,11,0,1,0
12,410,410,18,2,16,3,2
4,500,500,4,4,0,1,0

6,137,137,4,4,0,1,0
12,169,169,6,1,5,2,1
3,170,170,18,11,7,2,1
0,210,210,63,12,51,4,3
8,233,233,9,9,0,1,0
9,242,242,14,14,0,1,0
10,245,245,15,15,0,1,0
4,255,255,14,14,0,1,0
1,256,256,25,25,0,1,0
11,260,260,112,48,64,4,3
5,276,276,38,24,14,2,1
7,371,371,25,5,20,3,2
2,453,453,2,2,0,1,0

11,114,114,21,15,6,2,1
0,155,155,24,9,15,2,1
9,158,158,38,2,36,2,1
6,172,172,13,13,0,1,0
10,250,250,8,8,0,1,0
3,267,267,21,9,12,4,3
8,319,319,23,4,19,2,1
13,332,332,24,24,0,1,0
4,390,390,40,32,8,2,1
2,399,399,93,93,0,1,0
12,417,417,19,19,0,1,0
1,468,468,6,6,0,1,0
5,477,477,22,2,20,3,2
7,485,485,36,24,12,4,3

10,209,209,11,11,0,1,0
1,215,215,8,1,7,2,1
7,230,230,1,1,0,1,0
12,231,231,18,18,0,1,0
15,255,255,5,5,0,1,0
2,256,256,7,7,0,1,0
18,268,268,25,25,0,1,0
11,290,290,4,4,0,1,0
8,314,314,5,5,0,1,0
13,314,314,106,106,0,1,0
6,326,326,3,3,0,1,0
17,376,376,38,20,18,4,3
5,427,427,14,14,0,1,0
9,427,427,59,23,36,4,3
0,431,431,75,75,0,1,0
14,435,435,23,23,0,1,0
4,444,444,86,86,0,1,0
16,445,445,15,7,8,3,2
3,456,456,1,1,0,1,0

10,158,158,6,2,4,2,1
9,171,171,27,9,18,2,1
0,182,182,23,23,0,1,0
7,236,236,8,5,3,2,1
3,308,308,28,28,0,1,0
8,326,326,75,39,36,4,3
4,328,328,55,24,31,3,2
6,384,384,12,3,9,4,3
2,436,436,105,24,81,4,3
1,483,483,117,96,21,4,3
5,491,491,27,5,22,4,3

7,103,103,1,1,0,1,0
16,133,133,3,3,0,1,0
10,137,137,5,5,0,1,0
9,149,149,19,19,0,1,0
11,167,167,34,13,21,4,3
1,204,204,9,1,8,2,1
12,233,233,9,9,0,1,0
0,255,255,14,2,12,2,1
8,267,267,13,7,6,3,2
2,340,340,32,19,13,2,1
6,359,359,7,7,0,1,0
17,390,390,6,6,0,1,0
3,409,409,80,80,0,1,0
4,412,412,21,7,14,4,3
13,424,424,123,9,114,4,3
5,437,437,9,9,0,1,0
14,453,453,44,44,0,1,0
15,479,479,22,13,9,4,3

1,101,101,2,2,0,1,0
7,127,127,1,1,0,1,0
11,127,127,13,13,0,1,0
10,161,161,18,18,0,1,0
8,232,232,32,32,0,1,0
15,237,237,3,3,0,1,0
12,271,271,27,27,0,1,0
13,274,274,10,10,0,1,0
5,343,343,59,1,58,3,2
2,413,413,95,87,8,3,2
4,435,435,33,23,10,2,1
3,436,436,1,1,0,1,0
6,454,454,1,1,0,1,0
14,459,459,86,86,0,1,0
9,475,475,80,80,0,1,0
0,483,483,27,27,0,1,0

6,139,139,13,9,4,2,1
13,157,157,20,20,0,1,0
5,161,161,20,6,14,2,1
10,172,172,10,4,6,3,2
8,179,179,12,1,11,2,1
17,201,201,4,1,3,2,1
2,208,208,36,16,20,2,1
16,227,227,65,32,33,4,3
12,345,345,5,5,0,1,0
9,355,355,15,12,3,2,1
0,364,364,7,4,3,2,1
11,369,369,5,5,0,1,0
14,400,400,9,9,0,1,0
1,406,406,8,8,0,1,0
15,416,416,94,51,43,2,1
4,428,428,6,3,3,2,1
3,474,474,31,31,0,1,0
7,487,487,12,3,9,2,1

6,114,114,1,1,0,1,0
14,124,124,5,1,4,2,1
11,181,181,12,12,0,1,0
8,197,197,6,6,0,1,0
0,233,233,1,1,0,1,0
13,239,239,43,8,35,4,3
10,291,291,26,8,18,3,2
12,297,297,5,1,4,2,1
9,303,303,23,5,18,2,1
7,303,303,1,1,0,1,0
16,334,334,2,2,0,1,0
4,341,341,62,30,32,2,1
17,343,343,94,43,51,4,3
15,349,349,45,45,0,1,0
5,404,404,22,3,19,4,3
2,431,431,4,1,3,2,1
1,481,481,54,9,45,2,1
3,490,490,65,38,27,2,1

9,130,130,2,2,0,1,0
13,130,130,1,1,0,1,0
3,150,150,6,6,0,1,0
10,159,159,5,1,4,2,1
2,182,182,15,2,13,4,3
4,350,350,80,50,30,4,3
1,355,355,77,77,0,1,0
12,358,358,139,96,43,2,1
5,400,400,18,18,0,1,0
8,406,406,60,60,0,1,0
11,421,421,26,26,0,1,0
14,432,432,28,18,10,2,1
0,440,440,15,15,0,1,0
7,448,448,8,8,0,1,0
6,450,450,16,1,15,2,1

1,100,100,5,5,0,1,0
5,111,111,7,7,0,1,0
4,131,131,2,2,0,1,0
11,202,202,8,8,0,1,0
9,250,250,8,1,7,2,1
10,268,268,60,60,0,1,0
6,274,274,43,8,35,2,1
2,331,331,52,52,0,1,0
3,368,368,118,34,84,3,2
7,415,415,7,7,0,1,0
0,437,437,70,28,42,4,3
8,477,477,87,33,54,3,2

7,139,139,8,8,0,1,0
10,157,157,15,5,10,2,1
0,205,205,28,11,17,2,1
6,232,232,32,20,12,3,2
11,232,232,41,17,24,3,2
8,242,242,4,4,0,1,0
1,251,251,19,3,16,3,2
2,328,328,1,1,0,1,0
4,341,341,31,20,11,2,1
3,365,365,37,27,10,2,1
9,437,437,98,98,0,1,0
13,466,466,24,24,0,1,0
14,479,479,8,1,7,2,1
5,492,492,50,2,48,3,2
12,500,500,66,66,0,1,0

0,132,132,20,20,0,1,0
9,173,173,7,7,0,1,0
2,185,185,17,9,8,2,1
3,228,228,33,33,0,1,0
4,252,252,1,1,0,1,0
11,254,254,3,3,0,1,0
10,265,265,19,19,0,1,0
6,296,296,64,50,14,2,1
7,328,328,22,16,6,3,2
8,336,336,13,6,7,2,1
5,387,387,25,25,0,1,0
12,389,389,79,79,0,1,0
1,434,434,12,2,10,2,1
13,479,479,132,116,16,3,2

12,134,134,11,7,4,2,1
1,157,157,11,3,8,3,2
9,160,160,25,25,0,1,0
6,214,214,1,1,0,1,0
3,254,254,14,14,0,1,0
11,270,270,25,25,0,1,0
14,385,385,60,60,0,1,0
7,391,391,9,9,0,1,0
0,402,402,135,135,0,1,0
4,418,418,30,18,12,4,3
5,437,437,50,28,22,3,2
10,437,437,41,41,0,1,0
8,452,452,47,47,0,1,0
13,455,455,15,15,0,1,0
2,480,480,13,6,7,2,1

11,138,138,51,51,0,1,0
6,140,140,15,15,0,1,0
12,141,141,3,3,0,1,0
5,182,182,1,1,0,1,0
2,235,235,6,6,0,1,0
1,240,240,4,4,0,1,0
3,259,259,9,4,5,2,1
17,269,269,11,11,0,1,0
16,275,275,7,4,3,2,1
0,297,297,50,50,0,1,0
15,300,300,41,41,0,1,0
4,381,381,4,4,0,1,0
14,386,386,29,4,25,2,1
10,400,400,21,21,0,1,0
9,421,421,4,4,0,1,0
7,446,446,1,1,0,1,0
13,487,487,22,22,0,1,0
8,497,497,133,126,7,2,1

1,127,127,2,2,0,1,0
6,133,133,29,29,0,1,0
7,183,183,23,23,0,1,0
5,237,237,10,10,0,1,0
11,321,321,69,69,0,1,0
3,363,363,42,32,10,2,1
9,397,397,13,13,0,1,0
8,401,401,11,5,6,2,1
10,405,405,21,21,0,1,0
2,410,410,11,11,0,1,0
0,443,443,131,131,0,1,0
4,482,482,119,71,48,4,3

6,126,126,16,16,0,1,0
3,165,165,12,12,0,1,0
10,169,169,22,22,0,1,0
8,220,220,93,93,0,1,0
9,252,252,4,4,0,1,0
2,319,319,84,48,36,4,3
5,354,354,3,3,0,1,0
0,371,371,65,65,0,1,0
4,372,372,14,8,6,2,1
7,460,460,2,2,0,1,0
11,463,463,3,3,0,1,0
1,498,498,76,76,0,1,0

15,144,144,1,1,0,1,0
11,163,163,23,23,0,1,0
16,169,169,70,24,46,3,2
6,182,182,2,2,0,1,0
9,191,191,9,6,3,2,1
8,198,198,13,13,0,1,0
12,230,230,11,11,0,1,0
0,231,231,15,15,0,1,0
17,248,248,13,8,5,2,1
10,251,251,17,17,0,1,0
4,344,344,17,17,0,1,0
14,350,350,2,2,0,1,0
7,388,388,23,23,0,1,0
3,404,404,71,71,0,1,0
1,415,415,1,1,0,1,0
13,418,418,21,11,10,4,3
5,431,431,66,4,62,3,2
2,457,457,3,3,0,1,0

13,148,148,22,22,0,1,0
4,156,156,13,13,0,1,0
0,232,232,1,1,0,1,0
15,238,238,28,28,0,1,0
9,242,242,3,3,0,1,0
10,245,245,5,5,0,1,0
3,246,246,20,11,9,4,3
7,308,308,58,40,18,2,1
5,312,312,62,62,0,1,0
12,353,353,42,27,15,4,3
8,373,373,2,2,0,1,0
6,382,382,10,10,0,1,0
11,386,386,55,36,19,2,1
1,399,399,14,7,7,2,1
16,409,409,20,20,0,1,0
14,428,428,48,48,0,1,0
2,461,461,30,30,0,1,0

2,110,110,31,31,0,1,0
5,117,117,2,2,0,1,0
4,160,160,7,1,6,3,2
10,166,166,63,27,36,2,1
0,176,176,22,7,15,2,1
7,183,183,34,34,0,1,0
11,209,209,2,2,0,1,0
6,291,291,17,2,15,4,3
9,310,310,17,2,15,4,3
3,425,425,1,1,0,1,0
8,457,457,4,4,0,1,0
1,500,500,124,106,18,3,2

6,125,125,30,30,0,1,0
11,136,136,6,6,0,1,0
8,184,184,29,1,28,4,3
0,188,188,3,3,0,1,0
12,255,255,12,2,10,3,2
3,270,270,57,22,35,2,1
7,291,291,11,11,0,1,0
9,314,314,42,42,0,1,0
10,319,319,15,15,0,1,0
4,340,340,74,65,9,2,1
5,443,443,58,58,0,1,0
1,446,446,33,33,0,1,0
2,476,476,25,17,8,2,1

10,119,119,2,2,0,1,0
12,166,166,30,6,24,4,3
8,243,243,38,6,32,3,2
5,278,278,7,7,0,1,0
9,287,287,4,4,0,1,0
1,300,300,141,113,28,3,2
13,313,313,26,26,0,1,0
4,337,337,29,19,10,2,1
6,342,342,1,1,0,1,0
11,372,372,10,10,0,1,0
7,421,421,102,102,0,1,0
2,426,426,5,2,3,2,1
3,462,462,3,3,0,1,0
0,470,470,47,47,0,1,0

4,117,117,23,23,0,1,0
10,150,150,13,4,9,2,1
7,151,151,4,4,0,1,0
3,157,157,16,16,0,1,0
2,323,323,44,44,0,1,0
1,334,334,3,3,0,1,0
0,338,338,6,6,0,1,0
13,380,380,25,13,12,4,3
12,405,405,48,48,0,1,0
9,416,416,51,37,14,3,2
6,424,424,22,22,0,1,0
11,451,451,71,13,58,4,3
5,458,458,86,53,33,2,1
8,492,492,68,68,0,1,0

16,109,109,5,5,0,1,0
8,174,174,1,1,0,1,0
1,185,185,6,6,0,1,0
10,227,227,24,10,14,3,2
6,245,245,19,7,12,4,3
12,261,261,37,37,0,1,0
13,262,262,12,12,0,1,0
7,265,265,28,11,17,2,1
4,318,318,52,13,39,4,3
2,326,326,5,1,4,2,1
11,352,352,9,3,6,2,1
15,369,369,62,28,34,2,1
9,392,392,19,19,0,1,0
14,446,446,83,83,0,1,0
0,459,459,59,21,38,2,1
5,466,466,42,42,0,1,0
3,485,485,17,17,0,1,0

10,112,112,15,6,9,2,1
14,125,125,16,16,0,1,0
17,147,147,5,5,0,1,0
2,149,149,1,1,0,1,0
3,151,151,27,27,0,1,0
9,161,161,5,2,3,2,1
4,191,191,3,3,0,1,0
5,197,197,31,31,0,1,0
11,210,210,5,5,0,1,0
16,255,255,4,4,0,1,0
15,258,258,69,18,51,4,3
6,298,298,5,5,0,1,0
8,300,300,6,6,0,1,0
0,312,312,1,1,0,1,0
13,419,419,70,70,0,1,0
12,465,465,30,30,0,1,0
18,484,484,18,18,0,1,0
1,494,494,47,17,30,3,2
7,496,496,9,1,8,3,2

0,215,215,93,51,42,2,1
5,219,219,14,14,0,1,0
3,278,278,14,14,0,1,0
2,296,296,4,4,0,1,0
1,297,297,8,8,0,1,0
12,313,313,31,31,0,1,0
11,335,335,79,79,0,1,0
6,353,353,11,11,0,1,0
4,424,424,48,3,45,4,3
10,430,430,34,15,19,2,1
9,459,459,7,4,3,2,1
7,464,464,53,1,52,4,3
8,485,485,66,8,58,3,2

6,137,137,2,2,0,1,0
8,168,168,3,3,0,1,0
2,268,268,62,6,56,3,2
1,277,277,46,46,0,1,0
10,294,294,33,33,0,1,0
0,341,341,21,8,13,2,1
3,353,353,69,21,48,3,2
9,360,360,104,76,28,2,1
5,376,376,45,45,0,1,0
11,380,380,47,8,39,4,3
7,400,400,12,12,0,1,0
4,498,498,23,23,0,1,0

1,102,102,6,6,0,1,0
5,110,110,31,31,0,1,0
2,140,140,3,3,0,1,0
13,168,168,22,6,16,2,1
4,247,247,11,2,9,4,3
0,252,252,2,2,0,1,0
10,277,277,6,6,0,1,0
3,333,333,34,19,15,4,3
14,380,380,13,4,9,2,1
7,398,398,12,12,0,1,0
8,404,404,64,52,12,4,3
12,457,457,41,6,35,2,1
11,459,459,59,15,44,2,1
9,476,476,68,13,55,4,3
6,479,479,74,7,67,4,3

4,103,103,18,18,0,1,0
13,107,107,8,1,7,2,1
16,123,123,6,6,0,1,0
11,140,140,26,2,24,3,2
7,142,142,3,3,0,1,0
1,156,156,1,1,0,1,0
14,225,225,29,29,0,1,0
15,271,271,51,35,16,2,1
6,288,288,2,2,0,1,0
9,299,299,106,35,71,4,3
8,326,326,4,4,0,1,0
2,402,402,1,1,0,1,0
12,412,412,25,22,3,2,1
3,418,418,20,20,0,1,0
0,448,448,1,1,0,1,0
10,491,491,17,17,0,1,0
5,492,492,36,36,0,1,0

0,127,127,20,20,0,1,0
7,155,155,5,5,0,1,0
17,178,178,14,4,10,3,2
3,186,186,13,5,8,3,2
5,220,220,8,8,0,1,0
11,237,237,17,13,4,2,1
8,252,252,21,21,0,1,0
10,258,258,5,5,0,1,0
9,276,276,29,15,14,3,2
6,280,280,3,3,0,1,0
14,292,292,85,71,14,3,2
12,297,297,3,3,0,1,0
13,329,329,11,11,0,1,0
15,440,440,73,3,70,3,2
2,451,451,65,43,22,3,2
16,451,451,30,30,0,1,0
1,466,466,8,2,6,2,1
4,494,494,12,12,0,1,0

13,108,108,6,2,4,2,1
14,135,135,15,6,9,2,1
12,303,303,1,1,0,1,0
9,304,304,8,8,0,1,0
2,304,304,20,20,0,1,0
4,332,332,10,10,0,1,0
1,343,343,6,6,0,1,0
7,346,346,14,14,0,1,0
6,352,352,49,49,0,1,0
10,358,358,119,119,0,1,0
11,358,358,19,16,3,2,1
0,377,377,38,38,0,1,0
8,414,414,21,5,16,3,2
3,437,437,8,8,0,1,0
5,471,471,100,100,0,1,0
15,484,484,47,43,4,2,1
16,499,499,33,33,0,1,0

14,103,103,2,2,0,1,0
9,129,129,13,13,0,1,0
11,141,141,7,7,0,1,0
4,148,148,7,7,0,1,0
17,153,153,62,62,0,1,0
13,198,198,4,4,0,1,0
2,216,216,1,1,0,1,0
15,226,226,30,30,0,1,0
0,227,227,10,10,0,1,0
8,247,247,13,6,7,2,1
5,271,271,27,3,24,3,2
1,278,278,28,13,15,4,3
3,290,290,38,14,24,2,1
6,356,356,21,1,20,3,2
16,380,380,13,13,0,1,0
12,415,415,23,23,0,1,0
10,430,430,15,3,12,4,3
7,448,448,12,3,9,4,3

5,111,111,12,12,0,1,0
2,120,120,3,3,0,1,0
9,128,128,2,2,0,1,0
12,142,142,4,4,0,1,0
6,171,171,54,2,52,3,2
3,185,185,35,35,0,1,0
8,205,205,16,1,15,2,1
1,260,260,12,3,9,4,3
11,297,297,58,32,26,3,2
0,329,329,29,29,0,1,0
7,334,334,12,6,6,2,1
10,369,369,16,16,0,1,0
4,389,389,97,97,0,1,0

5,104,104,7,3,4,2,1
6,122,122,62,62,0,1,0
7,167,167,3,3,0,1,0
11,186,186,2,2,0,1,0
0,195,195,15,15,0,1,0
3,246,246,52,52,0,1,0
8,265,265,19,19,0,1,0
10,275,275,6,6,0,1,0
1,294,294,68,19,49,2,1
2,323,323,15,4,11,2,1
9,443,443,8,8,0,1,0
4,450,450,61,22,39,4,3

8,125,125,4,1,3,2,1
4,132,132,27,27,0,1,0
10,156,156,7,1,6,3,2
5,197,197,2,2,0,1,0
6,274,274,50,50,0,1,0
2,279,279,31,31,0,1,0
3,294,294,101,101,0,1,0
7,299,299,13,7,6,3,2
0,300,300,60,60,0,1,0
9,359,359,72,12,60,4,3
1,463,463,22,4,18,4,3

8,112,112,5,5,0,1,0
1,115,115,12,12,0,1,0
9,126,126,5,5,0,1,0
4,197,197,27,27,0,1,0
6,237,237,3,3,0,1,0
10,305,305,44,44,0,1,0
13,340,340,30,10,20,2,1
2,360,360,2,2,0,1,0
5,377,377,107,107,0,1,0
3,413,413,42,10,32,2,1
12,458,458,36,9,27,4,3
11,462,462,56,56,0,1,0
0,466,466,27,27,0,1,0
7,493,493,98,98,0,1,0

3,104,104,20,1,19,2,1
8,123,123,2,2,0,1,0
6,134,134,7,7,0,1,0
5,158,158,14,14,0,1,0
10,189,189,10,10,0,1,0
7,243,243,24,24,0,1,0
11,270,270,73,55,18,2,1
12,297,297,65,65,0,1,0
9,435,435,4,4,0,1,0
4,441,441,53,53,0,1,0
2,450,450,58,58,0,1,0
1,451,451,5,5,0,1,0
0,473,473,78,78,0,1,0

8,104,104,8,8,0,1,0
5,192,192,2,2,0,1,0
11,208,208,6,6,0,1,0
0,213,213,3,3,0,1,0
12,256,256,17,17,0,1,0
7,283,283,18,11,7,2,1
6,290,290,18,18,0,1,0
10,309,309,84,84,0,1,0
2,333,333,58,58,0,1,0
3,365,365,96,3,93,4,3
1,374,374,5,2,3,2,1
4,422,422,69,69,0,1,0
9,426,426,72,39,33,4,3
13,466,466,17,17,0,1,0

3,124,124,42,42,0,1,0
10,133,133,37,17,20,3,2
7,147,147,4,4,0,1,0
2,200,200,25,1,24,4,3
1,241,241,1,1,0,1,0
4,358,358,59,47,12,3,2
9,359,359,31,20,11,2,1
11,375,375,79,79,0,1,0
5,400,400,18,15,3,2,1
0,408,408,28,12,16,2,1
8,457,457,10,1,9,2,1
6,470,470,19,9,10,3,2

3,110,110,36,36,0,1,0
7,129,129,18,18,0,1,0
0,143,143,11,3,8,3,2
11,217,217,48,30,18,2,1
8,263,263,15,15,0,1,0
12,286,286,3,3,0,1,0
4,304,304,54,4,50,3,2
5,336,336,12,6,6,3,2
9,353,353,40,40,0,1,0
1,394,394,25,16,9,2,1
10,444,444,17,1,16,2,1
6,454,454,61,27,34,4,3
2,499,499,10,10,0,1,0

13,143,143,12,2,10,3,2
7,194,194,4,4,0,1,0
5,233,233,5,5,0,1,0
1,256,256,22,22,0,1,0
2,292,292,3,3,0,1,0
3,343,343,21,1,20,2,1
9,361,361,48,27,21,4,3
6,365,365,50,13,37,2,1
12,371,371,107,59,48,3,2
11,381,381,25,25,0,1,0
0,407,407,43,25,18,3,2
4,416,416,116,36,80,3,2
8,472,472,32,16,16,2,1
10,494,494,27,22,5,2,1

10,128,128,10,3,7,2,1
13,130,130,9,9,0,1,0
0,134,134,1,1,0,1,0
12,150,150,2,2,0,1,0
5,161,161,14,14,0,1,0
9,183,183,52,2,50,2,1
3,185,185,43,43,0,1,0
2,249,249,1,1,0,1,0
7,252,252,35,1,34,2,1
11,283,283,12,12,0,1,0
8,298,298,14,3,11,2,1
1,344,344,68,31,37,2,1
14,375,375,69,24,45,4,3
4,401,401,11,11,0,1,0
6,477,477,3,3,0,1,0

7,100,100,6,1,5,2,1
8,110,110,4,1,3,2,1
4,111,111,28,12,16,2,1
12,118,118,9,5,4,2,1
11,180,180,28,10,18,2,1
0,185,185,10,10,0,1,0
5,204,204,7,1,6,3,2
9,208,208,30,12,18,4,3
10,274,274,8,8,0,1,0
16,280,280,23,11,12,4,3
6,328,328,1,1,0,1,0
14,376,376,22,12,10,3,2
2,385,385,3,3,0,1,0
15,408,408,13,13,0,1,0
17,415,415,115,90,25,4,3
3,425,425,23,23,0,1,0
1,436,436,11,2,9,4,3
13,487,487,14,14,0,1,0

0,124,124,10,10,0,1,0
2,251,251,75,75,0,1,0
8,260,260,8,8,0,1,0
5,330,330,21,12,9,2,1
12,336,336,13,7,6,2,1
7,347,347,94,85,9,4,3
6,393,393,34,34,0,1,0
1,401,401,67,7,60,3,2
10,401,401,102,92,10,2,1
11,412,412,1,1,0,1,0
4,417,417,1,1,0,1,0
9,439,439,11,1,10,3,2
3,446,446,40,40,0,1,0

4,135,135,4,4,0,1,0
0,182,182,29,29,0,1,0
8,236,236,19,19,0,1,0
10,237,237,42,5,37,4,3
9,268,268,8,8,0,1,0
3,269,269,53,25,28,2,1
11,336,336,59,45,14,3,2
1,347,347,10,4,6,3,2
6,370,370,48,48,0,1,0
2,386,386,47,12,35,2,1
12,419,419,9,9,0,1,0
7,459,459,44,12,32,3,2
5,471,471,77,26,51,4,3

0,207,207,36,5,31,3,2
9,211,211,22,8,14,2,1
10,218,218,58,58,0,1,0
5,266,266,7,7,0,1,0
3,304,304,16,16,0,1,0
6,364,364,6,6,0,1,0
2,392,392,21,1,20,2,1
8,426,426,2,2,0,1,0
11,436,436,6,6,0,1,0
1,440,440,111,81,30,2,1
4,466,466,79,79,0,1,0
7,469,469,130,125,5,2,1

11,134,134,10,1,9,2,1
1,157,157,4,4,0,1,0
10,157,157,2,2,0,1,0
7,280,280,48,30,18,3,2
9,288,288,25,25,0,1,0
3,300,300,76,48,28,2,1
0,304,304,2,2,0,1,0
4,355,355,4,1,3,2,1
13,358,358,3,3,0,1,0
8,402,402,89,69,20,2,1
6,409,409,101,101,0,1,0
2,441,441,64,2,62,3,2
12,444,444,64,64,0,1,0
5,454,454,6,6,0,1,0

12,102,102,4,4,0,1,0
0,137,137,3,3,0,1,0
15,162,162,21,15,6,2,1
13,164,164,37,37,0,1,0
2,175,175,12,9,3,2,1
16,193,193,20,20,0,1,0
6,196,196,15,10,5,2,1
3,223,223,33,33,0,1,0
11,252,252,15,2,13,2,1
17,271,271,19,11,8,3,2
1,325,325,5,5,0,1,0
18,352,352,15,15,0,1,0
9,376,376,2,2,0,1,0
14,381,381,42,30,12,2,1
8,436,436,3,3,0,1,0
4,437,437,26,26,0,1,0
7,440,440,12,3,9,4,3
5,460,460,9,9,0,1,0
10,495,495,96,96,0,1,0

6,110,110,30,30,0,1,0
11,171,171,22,7,15,2,1
14,174,174,15,15,0,1,0
7,195,195,3,3,0,1,0
15,216,216,21,6,15,2,1
5,226,226,6,6,0,1,0
0,259,259,36,16,20,2,1
2,266,266,11,11,0,1,0
3,266,266,24,24,0,1,0
1,274,274,11,11,0,1,0
13,281,281,4,4,0,1,0
8,308,308,9,1,8,3,2
12,321,321,42,42,0,1,0
4,346,346,16,16,0,1,0
9,370,370,44,26,18,3,2
10,413,413,58,20,38,3,2

13,102,102,10,10,0,1,0
9,102,102,7,7,0,1,0
2,109,109,8,8,0,1,0
14,111,111,19,19,0,1,0
10,116,116,10,4,6,2,1
7,146,146,1,1,0,1,0
16,155,155,22,22,0,1,0
8,184,184,1,1,0,1,0
0,186,186,29,11,18,4,3
11,187,187,6,6,0,1,0
15,196,196,4,4,0,1,0
1,273,273,31,31,0,1,0
12,303,303,57,22,35,2,1
3,381,381,4,4,0,1,0
4,483,483,120,120,0,1,0
5,483,483,4,1,3,2,1
6,486,486,5,2,3,2,1

4,102,102,1,1,0,1,0
6,129,129,5,5,0,1,0
7,178,178,16,1,15,4,3
9,178,178,8,8,0,1,0
0,186,186,73,5,68,3,2
10,186,186,14,14,0,1,0
8,197,197,47,34,13,2,1
1,249,249,23,5,18,4,3
2,321,321,47,47,0,1,0
11,422,422,7,7,0,1,0
5,435,435,93,13,80,3,2
3,475,475,31,31,0,1,0

10,133,133,13,4,9,4,3
2,155,155,23,23,0,1,0
3,168,168,22,22,0,1,0
4,201,201,2,2,0,1,0
7,287,287,15,15,0,1,0
1,288,288,78,18,60,4,3
6,382,382,52,52,0,1,0
5,404,404,145,135,10,3,2
9,407,407,22,22,0,1,0
8,457,457,2,2,0,1,0
0,467,467,72,57,15,4,3

0,100,100,1,1,0,1,0
14,135,135,18,18,0,1,0
13,167,167,36,24,12,4,3
6,209,209,1,1,0,1,0
15,220,220,7,7,0,1,0
1,273,273,20,4,16,2,1
16,287,287,29,29,0,1,0
2,324,324,30,9,21,4,3
8,334,334,22,11,11,4,3
4,344,344,34,34,0,1,0
7,377,377,8,8,0,1,0
10,398,398,20,20,0,1,0
11,399,399,37,37,0,1,0
9,437,437,56,43,13,2,1
5,450,450,23,23,0,1,0
3,482,482,75,6,69,4,3
12,484,484,45,2,43,2,1

4,128,128,30,6,24,3,2
0,130,130,19,1,18,4,3
5,197,197,4,4,0,1,0
9,226,226,52,52,0,1,0
3,313,313,1,1,0,1,0
10,347,347,4,4,0,1,0
2,412,412,60,9,51,4,3
8,445,445,25,6,19,3,2
6,467,467,11,11,0,1,0
1,472,472,83,41,42,3,2
11,492,492,80,1,79,4,3
7,497,497,102,94,8,3,2

10,118,118,3,3,0,1,0
5,160,160,14,4,10,3,2
0,186,186,10,10,0,1,0
12,193,193,15,15,0,1,0
11,226,226,8,2,6,3,2
13,290,290,91,91,0,1,0
2,326,326,23,23,0,1,0
1,332,332,74,74,0,1,0
3,402,402,15,9,6,3,2
9,404,404,86,86,0,1,0
7,412,412,20,20,0,1,0
4,429,429,80,80,0,1,0
8,438,438,1,1,0,1,0
6,492,492,21,21,0,1,0

5,204,204,14,14,0,1,0
9,221,221,1,1,0,1,0
13,225,225,50,50,0,1,0
14,229,229,1,1,0,1,0
0,259,259,22,11,11,2,1
6,277,277,33,5,28,3,2
7,285,285,21,5,16,4,3
4,309,309,30,25,5,2,1
3,310,310,10,2,8,2,1
10,329,329,7,7,0,1,0
2,372,372,1,1,0,1,0
1,382,382,1,1,0,1,0
16,429,429,34,17,17,2,1
8,449,449,97,97,0,1,0
15,482,482,17,17,0,1,0
12,485,485,68,22,46,2,1
11,494,494,103,75,28,3,2

3,114,114,19,1,18,3,2
12,160,160,24,18,6,2,1
0,201,201,8,2,6,3,2
5,211,211,9,4,5,2,1
13,214,214,37,37,0,1,0
9,232,232,10,10,0,1,0
4,244,244,32,8,24,2,1
6,253,253,24,24,0,1,0
7,341,341,63,1,62,3,2
2,393,393,85,29,56,3,2
1,414,414,5,5,0,1,0
8,416,416,41,17,24,4,3
10,422,422,23,11,12,3,2
11,466,466,5,5,0,1,0

6,133,133,23,10,13,2,1
3,213,213,26,2,24,4,3
9,218,218,4,4,0,1,0
5,246,246,23,14,9,4,3
2,253,253,33,33,0,1,0
0,279,279,103,103,0,1,0
4,279,279,15,15,0,1,0
7,299,299,2,2,0,1,0
10,355,355,56,29,27,2,1
1,394,394,31,31,0,1,0
8,488,488,103,55,48,2,1

2,104,104,12,4,8,2,1
8,175,175,21,21,0,1,0
12,180,180,7,7,0,1,0
11,189,189,24,5,19,4,3
3,206,206,20,20,0,1,0
1,239,239,1,1,0,1,0
7,265,265,23,23,0,1,0
4,281,281,14,6,8,3,2
5,321,321,77,77,0,1,0
13,334,334,66,66,0,1,0
14,398,398,6,3,3,2,1
10,412,412,64,15,49,2,1
9,479,479,27,5,22,3,2
6,481,481,13,13,0,1,0
0,498,498,41,41,0,1,0

12,151,151,7,4,3,2,1
7,170,170,3,3,0,1,0
4,186,186,17,17,0,1,0
9,190,190,22,11,11,2,1
10,202,202,2,2,0,1,0
1,215,215,8,3,5,2,1
6,280,280,32,21,11,2,1
0,312,312,41,1,40,3,2
2,322,322,76,76,0,1,0
5,328,328,3,3,0,1,0
11,380,380,36,14,22,2,1
3,417,417,82,16,66,3,2
8,421,421,133,94,39,2,1

1,115,115,20,7,13,2,1
3,134,134,13,13,0,1,0
14,219,219,10,10,0,1,0
5,254,254,15,15,0,1,0
12,254,254,37,29,8,2,1
0,272,272,4,4,0,1,0
13,278,278,29,15,14,3,2
8,296,296,17,13,4,2,1
7,309,309,57,5,52,3,2
6,353,353,2,2,0,1,0
10,374,374,49,20,29,2,1
4,387,387,37,37,0,1,0
9,401,401,53,22,31,2,1
2,467,467,34,34,0,1,0
11,483,483,46,46,0,1,0

10,128,128,2,2,0,1,0
14,180,180,21,12,9,4,3
9,188,188,51,51,0,1,0
7,227,227,16,13,3,2,1
5,228,228,2,2,0,1,0
8,246,246,9,2,7,2,1
1,266,266,12,1,11,2,1
0,292,292,27,27,0,1,0
13,320,320,61,61,0,1,0
3,331,331,38,38,0,1,0
15,355,355,29,29,0,1,0
12,392,392,1,1,0,1,0
6,395,395,103,63,40,2,1
2,413,413,25,25,0,1,0
4,460,460,6,1,5,2,1
11,469,469,17,17,0,1,0

14,107,107,9,9,0,1,0
6,147,147,13,4,9,2,1
2,213,213,20,2,18,2,1
12,228,228,59,59,0,1,0
15,269,269,18,18,0,1,0
4,270,270,1,1,0,1,0
9,321,321,24,24,0,1,0
1,350,350,4,4,0,1,0
3,410,410,15,15,0,1,0
8,430,430,98,42,56,3,2
0,436,436,40,40,0,1,0
13,447,447,79,41,38,4,3
11,454,454,20,13,7,2,1
5,475,475,30,2,28,3,2
10,483,483,2,2,0,1,0
7,492,492,42,22,20,3,2

4,107,107,23,23,0,1,0
8,116,116,1,1,0,1,0
17,119,119,12,12,0,1,0
9,121,121,21,21,0,1,0
3,142,142,1,1,0,1,0
11,163,163,1,1,0,1,0
0,172,172,2,2,0,1,0
14,198,198,39,39,0,1,0
6,218,218,8,8,0,1,0
12,299,299,2,2,0,1,0
13,322,322,15,6,9,2,1
1,328,328,34,34,0,1,0
10,394,394,2,2,0,1,0
2,395,395,2,2,0,1,0
5,406,406,47,47,0,1,0
15,424,424,34,12,22,2,1
16,431,431,78,78,0,1,0
7,438,438,6,1,5,2,1
18,493,493,50,50,0,1,0

8,107,107,2,2,0,1,0
6,114,114,20,11,9,4,3
1,249,249,28,28,0,1,0
12,264,264,11,11,0,1,0
4,268,268,22,4,18,2,1
2,314,314,16,4,12,2,1
14,319,319,98,98,0,1,0
11,342,342,12,12,0,1,0
10,366,366,6,1,5,2,1
3,374,374,41,20,21,4,3
7,400,400,38,35,3,2,1
9,436,436,28,16,12,4,3
13,453,453,108,96,12,4,3
5,466,466,12,5,7,2,1
0,467,467,16,2,14,3,2
15,490,490,4,1,3,2,1

10,184,184,20,20,0,1,0
4,195,195,32,32,0,1,0
3,209,209,9,2,7,2,1
12,233,233,20,4,16,3,2
8,267,267,87,87,0,1,0
1,268,268,25,25,0,1,0
5,307,307,26,11,15,2,1
0,316,316,62,62,0,1,0
11,339,339,36,6,30,4,3
7,344,344,1,1,0,1,0
6,410,410,24,24,0,1,0
9,432,432,10,2,8,2,1
2,450,450,54,54,0,1,0

7,117,117,9,9,0,1,0
2,218,218,10,10,0,1,0
0,220,220,25,25,0,1,0
3,287,287,59,59,0,1,0
6,314,314,40,40,0,1,0
10,334,334,23,23,0,1,0
8,368,368,15,2,13,4,3
1,372,372,112,38,74,4,3
5,449,449,96,81,15,4,3
4,459,459,16,4,12,2,1
9,469,469,86,47,39,2,1
11,472,472,1,1,0,1,0

7,108,108,13,9,4,2,1
12,108,108,4,1,3,2,1
3,129,129,1,1,0,1,0
14,138,138,27,27,0,1,0
9,163,163,21,13,8,2,1
10,212,212,1,1,0,1,0
4,214,214,32,7,25,2,1
1,263,263,11,5,6,2,1
11,288,288,37,37,0,1,0
8,299,299,67,54,13,2,1
0,347,347,13,4,9,2,1
15,368,368,77,77,0,1,0
13,446,446,9,6,3,2,1
2,471,471,53,39,14,2,1
5,473,473,1,1,0,1,0
6,482,482,3,3,0,1,0

10,115,115,31,7,24,3,2
14,121,121,7,7,0,1,0
8,129,129,4,4,0,1,0
3,146,146,19,19,0,1,0
6,233,233,35,26,9,4,3
7,260,260,13,7,6,2,1
2,300,300,2,2,0,1,0
9,315,315,31,31,0,1,0
0,332,332,33,33,0,1,0
5,337,337,19,15,4,2,1
12,407,407,37,6,31,2,1
1,428,428,30,30,0,1,0
13,464,464,41,41,0,1,0
4,476,476,66,61,5,2,1
11,487,487,38,38,0,1,0

2,102,102,2,2,0,1,0
3,109,109,2,2,0,1,0
0,122,122,1,1,0,1,0
5,129,129,6,1,5,2,1
11,132,132,8,1,7,2,1
8,198,198,25,8,17,2,1
4,227,227,7,1,6,2,1
6,239,239,14,8,6,2,1
12,265,265,31,13,18,2,1
7,271,271,85,85,0,1,0
13,390,390,17,7,10,2,1
10,395,395,46,46,0,1,0
14,396,396,97,7,90,4,3
9,483,483,1,1,0,1,0
1,500,500,103,64,39,2,1

4,112,112,1,1,0,1,0
14,136,136,17,17,0,1,0
11,145,145,10,4,6,2,1
7,148,148,22,6,16,3,2
9,150,150,5,5,0,1,0
3,172,172,1,1,0,1,0
0,201,201,51,33,18,3,2
2,242,242,1,1,0,1,0
1,269,269,3,3,0,1,0
6,304,304,8,8,0,1,0
12,309,309,78,57,21,2,1
5,341,341,24,24,0,1,0
13,362,362,8,4,4,2,1
8,409,409,57,57,0,1,0
16,416,416,15,15,0,1,0
15,469,469,33,15,18,3,2
10,482,482,66,6,60,4,3

2,133,133,6,6,0,1,0
1,224,224,42,7,35,2,1
4,225,225,4,4,0,1,0
8,315,315,44,44,0,1,0
7,320,320,102,102,0,1,0
9,332,332,21,21,0,1,0
0,340,340,160,125,35,2,1
5,347,347,10,10,0,1,0
3,370,370,13,3,10,2,1
6,415,415,44,44,0,1,0

12,130,130,8,1,7,2,1
5,138,138,8,8,0,1,0
1,147,147,6,6,0,1,0
11,149,149,14,14,0,1,0
0,160,160,41,27,14,3,2
8,167,167,34,34,0,1,0
13,202,202,12,7,5,2,1
4,229,229,4,4,0,1,0
9,235,235,11,2,9,3,2
2,312,312,9,2,7,2,1
7,342,342,17,3,14,3,2
6,378,378,54,54,0,1,0
10,411,411,84,84,0,1,0
3,487,487,76,76,0,1,0

1,172,172,33,12,21,4,3
14,176,176,80,4,76,4,3
13,216,216,14,5,9,2,1
7,221,221,10,1,9,4,3
8,223,223,57,7,50,3,2
15,231,231,29,22,7,2,1
10,233,233,5,1,4,2,1
5,300,300,20,20,0,1,0
6,368,368,8,8,0,1,0
11,424,424,5,5,0,1,0
0,449,449,21,21,0,1,0
2,450,450,7,7,0,1,0
4,460,460,3,3,0,1,0
3,461,461,24,24,0,1,0
12,462,462,1,1,0,1,0
9,478,478,15,15,0,1,0

11,100,100,6,6,0,1,0
2,130,130,19,14,5,2,1
9,148,148,22,22,0,1,0
1,252,252,28,28,0,1,0
0,275,275,9,9,0,1,0
12,287,287,8,8,0,1,0
8,293,293,38,11,27,2,1
4,329,329,98,98,0,1,0
3,333,333,26,8,18,3,2
5,336,336,12,1,11,2,1
6,390,390,54,54,0,1,0
10,463,463,87,45,42,2,1
7,482,482,7,4,3,2,1

4,118,118,9,3,6,3,2
2,154,154,17,17,0,1,0
5,186,186,22,22,0,1,0
0,189,189,3,3,0,1,0
13,194,194,33,33,0,1,0
8,199,199,4,4,0,1,0
10,219,219,7,7,0,1,0
15,273,273,36,20,16,3,2
3,306,306,49,3,46,2,1
6,328,328,23,23,0,1,0
7,391,391,19,13,6,3,2
11,419,419,29,29,0,1,0
1,439,439,23,23,0,1,0
12,467,467,13,13,0,1,0
16,485,485,100,70,30,3,2
14,494,494,38,38,0,1,0
9,500,500,14,14,0,1,0

8,109,109,11,2,9,4,3
12,127,127,58,58,0,1,0
9,142,142,2,2,0,1,0
3,161,161,16,5,11,2,1
11,176,176,6,3,3,2,1
10,181,181,6,3,3,2,1
16,209,209,3,3,0,1,0
5,221,221,15,15,0,1,0
15,280,280,2,2,0,1,0
2,299,299,3,3,0,1,0
13,326,326,53,53,0,1,0
0,337,337,34,28,6,2,1
4,374,374,23,23,0,1,0
1,433,433,45,45,0,1,0
7,439,439,55,55,0,1,0
6,484,484,9,9,0,1,0
14,496,496,4,4,0,1,0

9,128,128,1,1,0,1,0
17,165,165,8,8,0,1,0
3,189,189,29,29,0,1,0
12,193,193,6,6,0,1,0
14,223,223,31,31,0,1,0
10,234,234,39,39,0,1,0
0,266,266,27,27,0,1,0
1,277,277,21,21,0,1,0
15,282,282,66,34,32,3,2
13,296,296,35,18,17,2,1
2,303,303,24,3,21,2,1
18,313,313,23,23,0,1,0
5,332,332,14,6,8,3,2
4,423,423,14,14,0,1,0
8,429,429,5,5,0,1,0
7,431,431,4,1,3,2,1
11,465,465,9,5,4,2,1
16,485,485,33,33,0,1,0
6,490,490,1,1,0,1,0

0,100,100,5,1,4,2,1
1,108,108,4,4,0,1,0
11,118,118,2,2,0,1,0
9,127,127,25,25,0,1,0
3,132,132,31,31,0,1,0
13,167,167,5,5,0,1,0
5,215,215,10,6,4,2,1
12,222,222,36,36,0,1,0
7,272,272,4,4,0,1,0
6,426,426,46,46,0,1,0
4,437,437,53,25,28,2,1
2,461,461,48,37,11,2,1
8,474,474,14,2,12,4,3
10,498,498,134,134,0,1,0

0,171,171,29,29,0,1,0
5,184,184,21,21,0,1,0
9,202,202,6,6,0,1,0
1,293,293,6,1,5,2,1
4,311,311,75,75,0,1,0
12,359,359,59,29,30,4,3
10,368,368,103,103,0,1,0
3,380,380,24,3,21,4,3
6,383,383,11,3,8,2,1
2,445,445,42,42,0,1,0
11,455,455,12,2,10,3,2
8,456,456,55,40,15,4,3
7,490,490,30,30,0,1,0

8,111,111,1,1,0,1,0
3,113,113,1,1,0,1,0
6,135,135,6,6,0,1,0
19,164,164,11,11,0,1,0
18,164,164,4,4,0,1,0
16,178,178,25,19,6,2,1
5,184,184,24,24,0,1,0
0,259,259,7,2,5,2,1
14,268,268,8,8,0,1,0
2,271,271,11,3,8,3,2
17,278,278,10,1,9,4,3
9,306,306,45,7,38,3,2
12,370,370,40,14,26,3,2
15,390,390,89,55,34,3,2
13,395,395,73,5,68,3,2
7,440,440,1,1,0,1,0
10,473,473,20,20,0,1,0
4,477,477,13,13,0,1,0
1,494,494,42,33,9,2,1
11,496,496,14,2,12,3,2

8,130,130,10,1,9,2,1
5,217,217,5,5,0,1,0
7,241,241,6,6,0,1,0
2,248,248,95,77,18,4,3
1,276,276,26,8,18,4,3
0,282,282,13,1,12,4,3
9,354,354,33,33,0,1,0
6,427,427,72,18,54,4,3
10,436,436,123,123,0,1,0
3,441,441,78,31,47,3,2
4,474,474,19,11,8,2,1

9,133,133,29,17,12,4,3
7,192,192,8,8,0,1,0
8,216,216,3,3,0,1,0
13,229,229,7,7,0,1,0
14,261,261,29,1,28,3,2
10,273,273,9,3,6,3,2
6,278,278,28,28,0,1,0
5,296,296,5,5,0,1,0
2,353,353,3,3,0,1,0
3,377,377,72,35,37,2,1
11,395,395,61,61,0,1,0
1,409,409,6,6,0,1,0
0,439,439,25,17,8,2,1
4,457,457,125,105,20,3,2
12,498,498,76,58,18,4,3

0,102,102,6,6,0,1,0
14,129,129,9,5,4,2,1
4,182,182,12,12,0,1,0
13,203,203,31,11,20,2,1
12,218,218,9,9,0,1,0
15,240,240,6,6,0,1,0
8,241,241,15,15,0,1,0
11,271,271,5,5,0,1,0
3,321,321,25,25,0,1,0
10,356,356,141,129,12,3,2
2,378,378,23,14,9,4,3
6,453,453,1,1,0,1,0
1,462,462,92,92,0,1,0
5,476,476,80,59,21,4,3
9,497,497,6,6,0,1,0
7,500,500,3,3,0,1,0

14,108,108,23,23,0,1,0
8,131,131,10,10,0,1,0
9,136,136,4,4,0,1,0
2,137,137,13,1,12,4,3
7,180,180,8,8,0,1,0
15,215,215,14,7,7,2,1
1,290,290,54,46,8,2,1
5,298,298,35,7,28,2,1
12,308,308,2,2,0,1,0
10,320,320,6,6,0,1,0
0,383,383,10,10,0,1,0
3,410,410,41,27,14,3,2
11,416,416,116,79,37,4,3
6,429,429,19,19,0,1,0
13,459,459,49,49,0,1,0
4,490,490,7,1,6,3,2

4,204,204,5,5,0,1,0
6,226,226,52,28,24,3,2
9,248,248,8,8,0,1,0
5,286,286,60,33,27,2,1
10,296,296,14,14,0,1,0
1,363,363,4,4,0,1,0
3,368,368,9,9,0,1,0
8,369,369,55,55,0,1,0
2,370,370,26,26,0,1,0
13,375,375,14,7,7,2,1
11,432,432,10,10,0,1,0
7,439,439,136,136,0,1,0
0,474,474,63,33,30,2,1
12,483,483,55,55,0,1,0

2,123,123,6,6,0,1,0
9,165,165,29,29,0,1,0
3,208,208,17,10,7,2,1
5,223,223,36,13,23,4,3
8,268,268,5,5,0,1,0
0,285,285,87,11,76,3,2
6,318,318,39,8,31,2,1
10,339,339,24,11,13,2,1
1,356,356,95,45,50,2,1
7,445,445,22,22,0,1,0
4,448,448,51,6,45,2,1

4,125,125,1,1,0,1,0
9,167,167,8,8,0,1,0
14,173,173,15,12,3,2,1
12,198,198,7,7,0,1,0
6,222,222,1,1,0,1,0
13,250,250,5,5,0,1,0
3,258,258,35,35,0,1,0
0,276,276,5,5,0,1,0
7,324,324,33,33,0,1,0
1,325,325,22,22,0,1,0
2,332,332,42,42,0,1,0
11,334,334,10,6,4,2,1
5,403,403,96,26,70,3,2
8,439,439,160,62,98,3,2
10,456,456,58,20,38,3,2

15,116,116,11,11,0,1,0
0,118,118,4,4,0,1,0
17,131,131,17,2,15,2,1
6,137,137,2,2,0,1,0
8,162,162,1,1,0,1,0
10,199,199,4,4,0,1,0
12,206,206,39,39,0,1,0
1,213,213,20,20,0,1,0
4,221,221,42,42,0,1,0
2,236,236,2,2,0,1,0
11,243,243,5,5,0,1,0
5,281,281,40,40,0,1,0
9,300,300,17,17,0,1,0
3,327,327,29,2,27,2,1
14,335,335,27,27,0,1,0
7,383,383,10,10,0,1,0
18,401,401,57,57,0,1,0
13,413,413,14,14,0,1,0
16,475,475,20,2,18,4,3

3,143,143,50,14,36,4,3
13,208,208,37,7,30,2,1
2,222,222,5,5,0,1,0
5,228,228,10,10,0,1,0
9,245,245,22,22,0,1,0
12,262,262,16,16,0,1,0
6,266,266,30,30,0,1,0
0,269,269,5,5,0,1,0
1,272,272,14,14,0,1,0
15,300,300,10,10,0,1,0
11,345,345,18,18,0,1,0
4,362,362,3,3,0,1,0
8,411,411,25,1,24,3,2
14,449,449,39,39,0,1,0
10,458,458,97,89,8,2,1
7,490,490,16,7,9,2,1

8,146,146,1,1,0,1,0
15,147,147,6,3,3,2,1
18,160,160,11,11,0,1,0
7,161,161,3,3,0,1,0
20,231,231,53,53,0,1,0
4,233,233,11,7,4,2,1
6,244,244,26,26,0,1,0
11,246,246,7,7,0,1,0
12,283,283,98,74,24,3,2
19,286,286,23,3,20,3,2
9,296,296,6,6,0,1,0
13,300,300,5,1,4,2,1
0,339,339,13,3,10,2,1
2,351,351,1,1,0,1,0
14,362,362,21,21,0,1,0
10,366,366,5,5,0,1,0
1,382,382,8,8,0,1,0
3,383,383,8,8,0,1,0
16,423,423,93,37,56,3,2
17,455,455,7,1,6,3,2
5,482,482,7,1,6,3,2

17,128,128,4,4,0,1,0
16,142,142,17,17,0,1,0
0,147,147,28,16,12,4,3
18,152,152,18,6,12,4,3
14,154,154,2,2,0,1,0
9,170,170,1,1,0,1,0
10,183,183,1,1,0,1,0
12,190,190,6,3,3,2,1
19,196,196,10,6,4,2,1
7,208,208,14,1,13,4,3
5,247,247,11,11,0,1,0
3,247,247,6,6,0,1,0
8,273,273,8,4,4,2,1
2,283,283,1,1,0,1,0
4,327,327,1,1,0,1,0
6,343,343,8,8,0,1,0
20,346,346,13,13,0,1,0
15,367,367,14,14,0,1,0
11,405,405,64,28,36,4,3
22,410,410,127,111,16,3,2
13,420,420,18,18,0,1,0
21,470,470,23,23,0,1,0
1,478,478,10,10,0,1,0

11,109,109,11,11,0,1,0
3,111,111,7,7,0,1,0
16,113,113,15,15,0,1,0
9,200,200,14,14,0,1,0
14,213,213,52,52,0,1,0
10,267,267,11,3,8,3,2
1,306,306,13,13,0,1,0
7,334,334,1,1,0,1,0
13,339,339,14,10,4,2,1
2,344,344,20,20,0,1,0
4,350,350,53,53,0,1,0
5,392,392,65,65,0,1,0
8,395,395,23,23,0,1,0
0,420,420,25,25,0,1,0
12,434,434,63,38,25,2,1
6,449,449,13,1,12,3,2
15,491,491,6,6,0,1,0

2,104,104,23,11,12,3,2
12,132,132,5,5,0,1,0
5,140,140,33,33,0,1,0
11,208,208,24,24,0,1,0
13,211,211,32,32,0,1,0
7,239,239,4,4,0,1,0
15,249,249,56,44,12,2,1
1,252,252,11,11,0,1,0
3,252,252,1,1,0,1,0
8,361,361,27,9,18,3,2
6,366,366,30,30,0,1,0
14,396,396,27,3,24,3,2
0,440,440,9,9,0,1,0
10,471,471,27,27,0,1,0
4,494,494,1,1,0,1,0
9,499,499,31,31,0,1,0

3,105,105,10,7,3,2,1
12,113,113,19,19,0,1,0
6,156,156,1,1,0,1,0
13,176,176,12,12,0,1,0
0,180,180,21,21,0,1,0
10,183,183,10,10,0,1,0
4,225,225,10,10,0,1,0
9,249,249,39,27,12,3,2
8,257,257,11,2,9,4,3
1,344,344,59,35,24,2,1
7,344,344,15,15,0,1,0
5,356,356,27,27,0,1,0
11,359,359,13,13,0,1,0
14,444,444,17,17,0,1,0
2,477,477,50,50,0,1,0
15,491,491,94,94,0,1,0

12,112,112,28,28,0,1,0
8,126,126,2,2,0,1,0
3,171,171,22,22,0,1,0
15,172,172,2,2,0,1,0
13,201,201,10,10,0,1,0
2,212,212,47,35,12,2,1
7,256,256,1,1,0,1,0
10,286,286,2,2,0,1,0
14,301,301,2,2,0,1,0
6,320,320,2,2,0,1,0
9,329,329,73,56,17,2,1
0,330,330,22,8,14,3,2
11,347,347,58,22,36,2,1
4,360,360,24,24,0,1,0
5,365,365,55,45,10,2,1
1,423,423,20,20,0,1,0

3,104,104,2,2,0,1,0
12,111,111,7,7,0,1,0
14,148,148,8,8,0,1,0
10,154,154,35,1,34,3,2
0,180,180,18,18,0,1,0
4,185,185,10,10,0,1,0
9,208,208,18,2,16,3,2
16,245,245,8,2,6,3,2
13,250,250,31,31,0,1,0
1,266,266,15,15,0,1,0
5,336,336,55,55,0,1,0
7,353,353,43,19,24,2,1
2,408,408,19,19,0,1,0
11,421,421,62,18,44,2,1
15,425,425,29,19,10,2,1
8,455,455,18,18,0,1,0
6,492,492,8,8,0,1,0

0,125,125,12,4,8,2,1
2,148,148,1,1,0,1,0
10,165,165,3,3,0,1,0
13,186,186,21,21,0,1,0
1,190,190,23,7,16,2,1
4,198,198,49,7,42,3,2
9,234,234,21,9,12,4,3
7,255,255,3,3,0,1,0
14,262,262,55,47,8,3,2
5,329,329,9,9,0,1,0
6,341,341,4,4,0,1,0
3,384,384,35,5,30,3,2
11,402,402,30,3,27,4,3
8,428,428,38,13,25,4,3
15,460,460,47,47,0,1,0
12,480,480,51,21,30,3,2

1,190,190,9,4,5,2,1
2,202,202,15,15,0,1,0
9,202,202,34,15,19,2,1
5,205,205,7,3,4,2,1
3,227,227,9,9,0,1,0
4,255,255,76,76,0,1,0
11,263,263,29,9,20,3,2
6,276,276,46,46,0,1,0
13,387,387,19,6,13,2,1
8,419,419,12,12,0,1,0
10,445,445,34,4,30,3,2
0,449,449,18,4,14,2,1
7,465,465,71,5,66,4,3
12,472,472,58,46,12,3,2

2,110,110,56,56,0,1,0
6,293,293,48,48,0,1,0
8,311,311,38,17,21,2,1
11,316,316,11,6,5,2,1
3,324,324,13,9,4,2,1
1,367,367,5,5,0,1,0
4,377,377,6,6,0,1,0
9,381,381,40,40,0,1,0
5,421,421,44,29,15,4,3
7,443,443,60,12,48,4,3
10,451,451,19,19,0,1,0
0,478,478,59,20,39,4,3

6,103,103,1,1,0,1,0
2,149,149,19,19,0,1,0
7,152,152,10,1,9,4,3
13,191,191,2,2,0,1,0
3,209,209,10,10,0,1,0
15,210,210,58,46,12,3,2
4,217,217,41,29,12,2,1
5,283,283,8,8,0,1,0
11,283,283,44,44,0,1,0
9,294,294,5,5,0,1,0
1,317,317,35,20,15,4,3
12,339,339,17,6,11,2,1
14,347,347,54,18,36,3,2
0,401,401,17,17,0,1,0
8,405,405,33,25,8,2,1
10,432,432,18,18,0,1,0

12,103,103,9,9,0,1,0
8,108,108,11,11,0,1,0
15,126,126,11,11,0,1,0
2,159,159,8,3,5,2,1
4,202,202,17,17,0,1,0
1,236,236,27,27,0,1,0
3,265,265,5,2,3,2,1
14,331,331,66,44,22,3,2
0,367,367,40,34,6,2,1
7,381,381,53,5,48,4,3
13,426,426,37,37,0,1,0
10,433,433,26,26,0,1,0
9,438,438,73,10,63,4,3
5,453,453,34,34,0,1,0
11,459,459,14,14,0,1,0
6,486,486,4,4,0,1,0

5,121,121,12,12,0,1,0
6,135,135,6,1,5,2,1
7,138,138,11,2,9,2,1
0,166,166,8,5,3,2,1
2,183,183,32,32,0,1,0
13,191,191,55,4,51,4,3
12,232,232,6,6,0,1,0
9,263,263,24,14,10,3,2
10,277,277,32,1,31,2,1
3,301,301,1,1,0,1,0
1,348,348,109,7,102,4,3
11,413,413,9,9,0,1,0
4,414,414,9,9,0,1,0
8,425,425,40,1,39,3,2

3,119,119,2,2,0,1,0
11,155,155,5,2,3,2,1
4,235,235,17,12,5,2,1
8,239,239,8,8,0,1,0
7,241,241,51,51,0,1,0
10,250,250,12,12,0,1,0
9,311,311,9,9,0,1,0
12,316,316,28,8,20,3,2
6,331,331,35,35,0,1,0
5,333,333,9,9,0,1,0
13,347,347,95,17,78,4,3
2,375,375,86,86,0,1,0
0,425,425,16,16,0,1,0
1,437,437,93,93,0,1,0

7,118,118,10,10,0,1,0
5,133,133,9,9,0,1,0
11,161,161,10,10,0,1,0
2,169,169,22,13,9,4,3
3,170,170,4,4,0,1,0
9,179,179,29,11,18,3,2
0,261,261,1,1,0,1,0
1,321,321,11,11,0,1,0
6,339,339,31,31,0,1,0
13,391,391,5,1,4,2,1
8,395,395,30,30,0,1,0
12,402,402,17,3,14,3,2
4,426,426,149,104,45,2,1
10,448,448,124,104,20,3,2

12,105,105,3,3,0,1,0
6,145,145,16,9,7,2,1
8,152,152,7,7,0,1,0
3,162,162,7,7,0,1,0
9,202,202,5,5,0,1,0
7,277,277,38,4,34,2,1
5,333,333,6,6,0,1,0
10,344,344,50,50,0,1,0
4,420,420,112,34,78,3,2
1,425,425,4,4,0,1,0
11,438,438,100,100,0,1,0
0,486,486,104,104,0,1,0
2,486,486,73,37,36,4,3

8,112,112,6,6,0,1,0
7,115,115,6,2,4,2,1
9,141,141,24,24,0,1,0
3,158,158,5,5,0,1,0
1,174,174,46,38,8,3,2
10,190,190,39,39,0,1,0
2,191,191,40,40,0,1,0
4,216,216,3,3,0,1,0
6,251,251,47,5,42,3,2
5,292,292,12,12,0,1,0
0,377,377,74,74,0,1,0

2,101,101,1,1,0,1,0
5,181,181,9,4,5,2,1
1,198,198,75,37,38,2,1
11,236,236,40,40,0,1,0
9,337,337,22,22,0,1,0
8,349,349,50,50,0,1,0
10,352,352,25,10,15,3,2
4,358,358,50,6,44,3,2
6,392,392,13,13,0,1,0
3,409,409,3,3,0,1,0
7,423,423,42,42,0,1,0
13,426,426,25,25,0,1,0
0,438,438,36,36,0,1,0
12,478,478,47,4,43,2,1

3,128,128,15,6,9,4,3
8,173,173,39,39,0,1,0
9,237,237,10,10,0,1,0
13,264,264,21,21,0,1,0
5,269,269,77,77,0,1,0
6,290,290,4,4,0,1,0
7,329,329,2,2,0,1,0
2,335,335,57,15,42,4,3
11,413,413,126,62,64,4,3
10,416,416,3,3,0,1,0
4,421,421,22,13,9,4,3
0,442,442,22,22,0,1,0
1,475,475,6,6,0,1,0
12,495,495,20,8,12,2,1

10,138,138,14,14,0,1,0
5,142,142,18,13,5,2,1
3,155,155,26,16,10,2,1
8,166,166,14,2,12,4,3
12,200,200,9,6,3,2,1
11,219,219,8,2,6,2,1
1,261,261,50,18,32,3,2
7,294,294,17,17,0,1,0
0,299,299,9,2,7,2,1
2,306,306,5,5,0,1,0
13,324,324,17,17,0,1,0
14,337,337,50,50,0,1,0
6,348,348,27,27,0,1,0
4,373,373,12,7,5,2,1
9,463,463,115,115,0,1,0

6,111,111,1,1,0,1,0
5,163,163,65,26,39,3,2
9,183,183,2,2,0,1,0
0,215,215,34,16,18,4,3
8,221,221,31,31,0,1,0
10,253,253,10,10,0,1,0
1,321,321,61,36,25,4,3
7,335,335,13,2,11,4,3
4,364,364,29,23,6,2,1
3,384,384,92,48,44,4,3
2,408,408,46,2,44,3,2

11,154,154,6,1,5,2,1
6,178,178,36,18,18,4,3
0,184,184,2,2,0,1,0
2,215,215,94,79,15,2,1
8,219,219,39,39,0,1,0
1,238,238,18,18,0,1,0
7,322,322,1,1,0,1,0
12,351,351,35,11,24,2,1
4,354,354,1,1,0,1,0
10,377,377,14,14,0,1,0
5,401,401,33,3,30,2,1
3,423,423,39,39,0,1,0
9,488,488,76,76,0,1,0

7,212,212,53,7,46,3,2
6,230,230,31,31,0,1,0
5,262,262,19,16,3,2,1
2,294,294,99,99,0,1,0
9,296,296,6,6,0,1,0
11,300,300,1,1,0,1,0
3,302,302,6,2,4,2,1
10,379,379,37,25,12,3,2
8,427,427,58,58,0,1,0
1,455,455,34,2,32,2,1
0,464,464,104,104,0,1,0
4,485,485,22,22,0,1,0

13,103,103,16,16,0,1,0
8,110,110,10,10,0,1,0
12,110,110,18,9,9,2,1
5,134,134,3,3,0,1,0
14,143,143,7,3,4,2,1
3,150,150,23,23,0,1,0
0,153,153,22,22,0,1,0
4,160,160,4,4,0,1,0
1,279,279,28,28,0,1,0
7,301,301,32,32,0,1,0
6,327,327,34,34,0,1,0
10,409,409,12,8,4,2,1
9,418,418,15,15,0,1,0
11,443,443,86,86,0,1,0
2,462,462,21,21,0,1,0

7,116,116,2,2,0,1,0
9,228,228,21,9,12,4,3
8,231,231,39,39,0,1,0
0,264,264,80,80,0,1,0
5,270,270,15,15,0,1,0
11,297,297,10,2,8,3,2
10,316,316,44,1,43,2,1
4,321,321,58,58,0,1,0
6,324,324,67,36,31,2,1
1,347,347,21,6,15,4,3
3,383,383,39,4,35,2,1
2,386,386,21,1,20,3,2

3,126,126,8,5,3,2,1
0,132,132,26,11,15,4,3
4,134,134,8,8,0,1,0
1,143,143,1,1,0,1,0
7,185,185,7,7,0,1,0
2,321,321,139,139,0,1,0
6,328,328,78,59,19,2,1
10,420,420,16,8,8,2,1
9,441,441,139,127,12,4,3
5,457,457,8,8,0,1,0
8,469,469,3,3,0,1,0

20,116,116,7,7,0,1,0
6,116,116,2,2,0,1,0
8,129,129,14,2,12,3,2
2,159,159,1,1,0,1,0
17,159,159,12,3,9,4,3
7,191,191,22,22,0,1,0
1,208,208,13,1,12,3,2
21,209,209,54,54,0,1,0
13,219,219,6,1,5,2,1
23,230,230,5,5,0,1,0
15,231,231,3,3,0,1,0
4,238,238,5,5,0,1,0
19,261,261,7,7,0,1,0
5,286,286,11,3,8,2,1
3,329,329,3,3,0,1,0
10,343,343,2,2,0,1,0
12,363,363,8,8,0,1,0
11,370,370,17,17,0,1,0
22,375,375,28,28,0,1,0
14,376,376,1,1,0,1,0
0,395,395,9,2,7,2,1
18,399,399,81,81,0,1,0
16,414,414,27,27,0,1,0
9,499,499,59,59,0,1,0

0,107,107,22,22,0,1,0
8,148,148,14,5,9,4,3
13,202,202,10,2,8,2,1
1,238,238,8,2,6,3,2
5,273,273,6,6,0,1,0
4,290,290,21,5,16,3,2
10,290,290,45,45,0,1,0
11,318,318,69,69,0,1,0
9,320,320,24,24,0,1,0
7,327,327,21,21,0,1,0
2,387,387,76,30,46,3,2
3,412,412,50,50,0,1,0
12,416,416,27,27,0,1,0
6,478,478,24,2,22,2,1

0,108,108,1,1,0,1,0
6,130,130,23,23,0,1,0
13,178,178,17,9,8,3,2
9,197,197,5,5,0,1,0
11,215,215,15,5,10,2,1
10,230,230,21,21,0,1,0
7,260,260,32,32,0,1,0
1,299,299,21,21,0,1,0
2,316,316,8,8,0,1,0
5,371,371,81,56,25,4,3
12,423,423,99,99,0,1,0
3,428,428,48,36,12,4,3
8,476,476,36,10,26,2,1
4,487,487,46,5,41,4,3

4,115,115,13,1,12,2,1
6,159,159,17,17,0,1,0
3,226,226,22,22,0,1,0
5,247,247,41,4,37,2,1
16,265,265,1,1,0,1,0
1,288,288,30,30,0,1,0
14,299,299,2,2,0,1,0
8,301,301,5,5,0,1,0
7,301,301,3,3,0,1,0
13,321,321,21,16,5,2,1
15,327,327,24,24,0,1,0
10,341,341,96,30,66,4,3
11,358,358,74,70,4,2,1
9,380,380,8,1,7,2,1
2,397,397,14,14,0,1,0
12,448,448,32,32,0,1,0
0,491,491,15,15,0,1,0

5,142,142,39,39,0,1,0
1,163,163,4,1,3,2,1
7,186,186,6,6,0,1,0
13,189,189,3,3,0,1,0
12,195,195,26,14,12,4,3
0,205,205,2,2,0,1,0
14,208,208,25,3,22,3,2
15,210,210,16,2,14,3,2
4,224,224,20,1,19,2,1
3,228,228,14,2,12,4,3
10,261,261,77,50,27,4,3
9,284,284,11,1,10,3,2
11,284,284,9,3,6,2,1
2,357,357,5,5,0,1,0
8,442,442,17,17,0,1,0
6,457,457,72,32,40,2,1

10,130,130,29,29,0,1,0
2,207,207,27,1,26,2,1
6,252,252,14,10,4,2,1
9,264,264,13,13,0,1,0
5,304,304,10,2,8,2,1
8,327,327,63,63,0,1,0
4,336,336,27,27,0,1,0
3,375,375,3,3,0,1,0
7,407,407,33,10,23,2,1
0,453,453,126,86,40,4,3
1,465,465,132,132,0,1,0

0,104,104,5,5,0,1,0
6,129,129,3,3,0,1,0
10,134,134,2,2,0,1,0
11,158,158,26,26,0,1,0
9,193,193,34,16,18,4,3
3,235,235,40,40,0,1,0
7,264,264,6,6,0,1,0
14,275,275,11,11,0,1,0
12,338,338,10,3,7,2,1
2,363,363,24,10,14,2,1
1,366,366,59,27,32,2,1
13,408,408,70,70,0,1,0
5,436,436,29,23,6,3,2
15,445,445,53,2,51,4,3
4,468,468,45,45,0,1,0
8,488,488,23,23,0,1,0

10,128,128,5,5,0,1,0
16,146,146,19,19,0,1,0
2,172,172,21,21,0,1,0
14,192,192,11,2,9,2,1
8,206,206,18,2,16,3,2
0,217,217,5,1,4,2,1
13,226,226,16,4,12,4,3
11,237,237,58,46,12,4,3
12,300,300,3,3,0,1,0
1,316,316,2,2,0,1,0
9,354,354,20,2,18,2,1
17,376,376,70,26,44,3,2
5,377,377,23,23,0,1,0
6,383,383,55,55,0,1,0
15,398,398,6,1,5,2,1
3,401,401,53,3,50,2,1
4,407,407,1,1,0,1,0
7,432,432,12,12,0,1,0

5,170,170,1,1,0,1,0
4,178,178,49,24,25,4,3
3,201,201,30,8,22,3,2
13,233,233,11,11,0,1,0
11,286,286,26,22,4,2,1
2,315,315,1,1,0,1,0
6,330,330,39,20,19,2,1
8,364,364,9,2,7,2,1
9,373,373,67,20,47,2,1
12,398,398,9,6,3,2,1
0,432,432,41,41,0,1,0
7,441,441,87,87,0,1,0
1,444,444,25,25,0,1,0
10,477,477,72,72,0,1,0

7,118,118,20,4,16,3,2
13,125,125,2,2,0,1,0
12,154,154,62,8,54,3,2
16,163,163,8,8,0,1,0
9,169,169,1,1,0,1,0
5,184,184,7,7,0,1,0
15,240,240,28,1,27,4,3
17,252,252,4,4,0,1,0
8,262,262,6,6,0,1,0
3,276,276,11,8,3,2,1
2,307,307,2,2,0,1,0
4,310,310,18,10,8,3,2
11,351,351,39,33,6,3,2
1,359,359,15,15,0,1,0
0,395,395,15,10,5,2,1
14,438,438,2,2,0,1,0
6,455,455,125,38,87,4,3
10,498,498,3,3,0,1,0

1,102,102,11,11,0,1,0
18,179,179,18,11,7,2,1
7,202,202,2,2,0,1,0
2,203,203,5,5,0,1,0
5,207,207,3,3,0,1,0
16,215,215,45,35,10,3,2
19,222,222,3,3,0,1,0
14,224,224,39,15,24,2,1
0,265,265,12,2,10,2,1
9,268,268,16,16,0,1,0
12,284,284,7,3,4,2,1
6,284,284,15,11,4,2,1
8,357,357,18,18,0,1,0
11,373,373,8,8,0,1,0
13,383,383,2,2,0,1,0
4,386,386,45,22,23,2,1
10,438,438,41,41,0,1,0
17,441,441,57,57,0,1,0
3,489,489,40,30,10,3,2
15,500,500,38,38,0,1,0

1,180,180,7,7,0,1,0
2,196,196,23,12,11,2,1
8,201,201,3,3,0,1,0
4,212,212,55,55,0,1,0
6,251,251,38,38,0,1,0
9,294,294,21,21,0,1,0
12,319,319,42,42,0,1,0
5,321,321,12,6,6,3,2
3,381,381,75,75,0,1,0
11,409,409,68,41,27,3,2
7,439,439,37,21,16,3,2
0,452,452,24,8,16,2,1
10,495,495,47,47,0,1,0

7,100,100,1,1,0,1,0
17,104,104,17,17,0,1,0
2,177,177,30,4,26,2,1
15,204,204,23,9,14,3,2
0,211,211,13,13,0,1,0
10,211,211,20,14,6,2,1
9,233,233,9,9,0,1,0
4,291,291,36,6,30,4,3
13,323,323,18,7,11,3,2
3,344,344,4,4,0,1,0
1,357,357,4,4,0,1,0
5,369,369,14,3,11,4,3
8,375,375,18,18,0,1,0
11,380,380,10,2,8,2,1
6,404,404,28,28,0,1,0
18,421,421,105,51,54,4,3
14,441,441,2,2,0,1,0
12,462,462,9,1,8,3,2
16,500,500,53,45,8,2,1

3,115,115,14,5,9,4,3
4,243,243,9,4,5,2,1
9,260,260,10,1,9,4,3
7,271,271,17,11,6,3,2
2,285,285,4,1,3,2,1
0,290,290,8,8,0,1,0
6,291,291,12,3,9,2,1
10,340,340,1,1,0,1,0
8,367,367,19,7,12,2,1
11,387,387,32,5,27,2,1
1,414,414,116,96,20,2,1
5,439,439,97,97,0,1,0
12,441,441,189,177,12,3,2

8,108,108,9,9,0,1,0
1,117,117,1,1,0,1,0
7,153,153,12,2,10,3,2
4,173,173,9,3,6,2,1
5,181,181,27,8,19,4,3
2,192,192,2,2,0,1,0
9,239,239,5,5,0,1,0
10,291,291,123,9,114,4,3
11,303,303,3,3,0,1,0
3,317,317,68,56,12,2,1
6,403,403,60,23,37,2,1
12,409,409,32,11,21,4,3
13,428,428,23,23,0,1,0
14,444,444,19,8,11,2,1
0,476,476,21,21,0,1,0

5,114,114,6,6,0,1,0
0,148,148,1,1,0,1,0
10,154,154,3,3,0,1,0
11,166,166,30,24,6,2,1
8,284,284,16,6,10,2,1
3,316,316,25,9,16,3,2
2,355,355,74,54,20,2,1
1,373,373,18,18,0,1,0
9,376,376,59,59,0,1,0
7,399,399,94,5,89,4,3
6,429,429,7,3,4,2,1
4,493,493,177,93,84,3,2

11,121,121,15,15,0,1,0
6,132,132,11,8,3,2,1
4,134,134,10,10,0,1,0
9,135,135,13,6,7,2,1
14,152,152,1,1,0,1,0
1,157,157,13,8,5,2,1
10,234,234,4,4,0,1,0
0,315,315,6,3,3,2,1
3,338,338,22,9,13,2,1
7,341,341,57,57,0,1,0
12,441,441,153,131,22,2,1
13,442,442,47,32,15,4,3
5,462,462,11,11,0,1,0
8,470,470,13,13,0,1,0
2,482,482,89,89,0,1,0

2,101,101,36,22,14,2,1
7,105,105,8,8,0,1,0
10,116,116,6,6,0,1,0
5,126,126,21,21,0,1,0
4,148,148,1,1,0,1,0
3,149,149,19,19,0,1,0
0,200,200,4,4,0,1,0
9,309,309,29,29,0,1,0
6,346,346,37,16,21,4,3
11,395,395,105,78,27,2,1
12,422,422,35,22,13,2,1
1,461,461,13,8,5,2,1
8,495,495,17,5,12,3,2

1,151,151,20,20,0,1,0
5,160,160,5,5,0,1,0
7,176,176,10,10,0,1,0
10,211,211,5,5,0,1,0
9,219,219,5,1,4,2,1
3,225,225,4,4,0,1,0
11,334,334,62,62,0,1,0
13,398,398,44,44,0,1,0
0,414,414,1,1,0,1,0
4,415,415,152,2,150,4,3
12,451,451,63,63,0,1,0
6,486,486,30,30,0,1,0
8,493,493,84,54,30,2,1
2,497,497,44,44,0,1,0

6,117,117,3,3,0,1,0
13,140,140,5,5,0,1,0
16,161,161,16,16,0,1,0
11,165,165,24,24,0,1,0
10,185,185,2,2,0,1,0
8,190,190,2,2,0,1,0
2,237,237,2,2,0,1,0
0,311,311,30,26,4,2,1
7,312,312,116,116,0,1,0
3,323,323,17,17,0,1,0
4,344,344,1,1,0,1,0
5,347,347,11,11,0,1,0
14,378,378,7,1,6,3,2
17,383,383,123,18,105,4,3
15,388,388,30,8,22,2,1
1,401,401,28,1,27,4,3
9,448,448,11,3,8,3,2
12,467,467,11,2,9,2,1

12,119,119,15,3,12,3,2
11,236,236,19,15,4,2,1
6,255,255,20,4,16,3,2
3,263,263,16,16,0,1,0
0,300,300,15,15,0,1,0
7,346,346,53,22,31,2,1
10,371,371,22,22,0,1,0
1,387,387,117,71,46,2,1
13,388,388,35,35,0,1,0
2,434,434,29,29,0,1,0
8,434,434,38,38,0,1,0
9,449,449,54,24,30,4,3
4,476,476,49,49,0,1,0
5,500,500,21,21,0,1,0

11,101,101,9,1,8,2,1
10,149,149,17,1,16,3,2
6,152,152,13,13,0,1,0
1,159,159,7,7,0,1,0
0,194,194,10,10,0,1,0
3,270,270,2,2,0,1,0
12,282,282,6,6,0,1,0
8,300,300,55,33,22,2,1
2,325,325,132,54,78,3,2
9,385,385,79,79,0,1,0
7,389,389,8,8,0,1,0
5,462,462,82,32,50,2,1
4,474,474,7,7,0,1,0

8,110,110,1,1,0,1,0
21,122,122,1,1,0,1,0
12,129,129,20,4,16,3,2
16,176,176,22,22,0,1,0
7,203,203,7,7,0,1,0
15,223,223,4,4,0,1,0
20,231,231,1,1,0,1,0
18,241,241,19,19,0,1,0
6,253,253,7,7,0,1,0
22,285,285,48,48,0,1,0
3,311,311,16,16,0,1,0
17,318,318,17,17,0,1,0
1,323,323,6,1,5,2,1
11,330,330,7,4,3,2,1
13,345,345,1,1,0,1,0
2,351,351,4,1,3,2,1
10,374,374,9,9,0,1,0
5,395,395,8,5,3,2,1
19,413,413,112,35,77,4,3
14,425,425,49,36,13,2,1
0,441,441,20,20,0,1,0
9,455,455,10,10,0,1,0
4,478,478,60,35,25,2,1

8,127,127,1,1,0,1,0
5,130,130,10,10,0,1,0
1,132,132,14,6,8,3,2
2,138,138,14,14,0,1,0
9,159,159,9,1,8,3,2
12,220,220,35,35,0,1,0
0,257,257,100,77,23,2,1
10,370,370,62,38,24,2,1
4,406,406,2,2,0,1,0
11,441,441,96,41,55,3,2
3,488,488,13,7,6,3,2
7,490,490,10,10,0,1,0
6,493,493,40,7,33,2,1

12,100,100,3,3,0,1,0
0,101,101,12,12,0,1,0
15,105,105,11,11,0,1,0
10,138,138,14,14,0,1,0
1,141,141,6,6,0,1,0
9,178,178,18,18,0,1,0
5,210,210,15,6,9,4,3
3,243,243,11,11,0,1,0
7,298,298,15,10,5,2,1
4,346,346,29,29,0,1,0
11,351,351,6,6,0,1,0
6,392,392,50,50,0,1,0
2,419,419,38,15,23,2,1
13,421,421,23,23,0,1,0
8,437,437,31,11,20,3,2
14,479,479,148,87,61,4,3

10,175,175,10,1,9,2,1
0,181,181,6,6,0,1,0
8,211,211,36,36,0,1,0
4,217,217,91,88,3,2,1
3,218,218,11,2,9,2,1
6,230,230,16,16,0,1,0
11,278,278,7,7,0,1,0
2,368,368,50,30,20,3,2
7,411,411,23,23,0,1,0
9,426,426,30,24,6,2,1
12,428,428,110,21,89,4,3
1,471,471,24,24,0,1,0
5,475,475,5,5,0,1,0

12,162,162,9,3,6,3,2
0,272,272,25,25,0,1,0
2,274,274,83,83,0,1,0
6,285,285,8,8,0,1,0
1,288,288,5,5,0,1,0
4,318,318,11,11,0,1,0
5,411,411,64,16,48,2,1
9,415,415,7,7,0,1,0
11,441,441,115,57,58,4,3
7,447,447,24,2,22,2,1
10,460,460,132,99,33,4,3
3,484,484,48,6,42,4,3
8,496,496,4,4,0,1,0

9,106,106,12,9,3,2,1
11,109,109,6,3,3,2,1
8,170,170,15,3,12,4,3
2,173,173,10,10,0,1,0
6,226,226,2,2,0,1,0
1,238,238,29,6,23,2,1
7,287,287,37,2,35,2,1
14,292,292,74,20,54,4,3
4,375,375,41,41,0,1,0
12,375,375,6,3,3,2,1
13,406,406,71,71,0,1,0
3,414,414,76,76,0,1,0
10,445,445,9,1,8,3,2
5,457,457,5,5,0,1,0
0,492,492,39,39,0,1,0

6,102,102,1,1,0,1,0
10,114,114,2,2,0,1,0
7,145,145,12,12,0,1,0
9,155,155,13,13,0,1,0
2,188,188,10,4,6,3,2
1,320,320,25,25,0,1,0
15,326,326,80,44,36,3,2
16,337,337,36,36,0,1,0
12,351,351,37,29,8,2,1
3,380,380,47,47,0,1,0
11,406,406,4,4,0,1,0
8,422,422,36,36,0,1,0
0,432,432,57,7,50,3,2
17,444,444,9,9,0,1,0
14,452,452,85,55,30,4,3
13,478,478,15,5,10,3,2
5,494,494,4,4,0,1,0
4,497,497,16,16,0,1,0

13,115,115,4,4,0,1,0
10,118,118,17,7,10,3,2
3,150,150,19,5,14,2,1
2,192,192,18,18,0,1,0
6,258,258,54,54,0,1,0
11,297,297,15,15,0,1,0
0,301,301,9,9,0,1,0
9,331,331,33,21,12,4,3
7,389,389,29,23,6,3,2
8,401,401,100,30,70,3,2
4,448,448,60,44,16,2,1
12,449,449,25,17,8,3,2
5,487,487,6,6,0,1,0
1,499,499,47,17,30,4,3

2,106,106,37,3,34,3,2
9,117,117,19,3,16,2,1
0,161,161,16,7,9,4,3
6,203,203,47,16,31,4,3
1,220,220,54,54,0,1,0
8,374,374,33,33,0,1,0
4,387,387,23,23,0,1,0
7,406,406,31,3,28,2,1
5,411,411,38,38,0,1,0
10,417,417,1,1,0,1,0
3,424,424,3,3,0,1,0

6,112,112,5,1,4,2,1
4,147,147,26,16,10,2,1
10,241,241,29,14,15,2,1
7,258,258,1,1,0,1,0
9,259,259,5,2,3,2,1
11,265,265,82,82,0,1,0
5,298,298,29,29,0,1,0
13,339,339,46,46,0,1,0
12,356,356,27,27,0,1,0
3,361,361,53,35,18,2,1
2,424,424,12,12,0,1,0
1,429,429,2,2,0,1,0
0,442,442,90,28,62,4,3
8,488,488,24,24,0,1,0

11,118,118,11,5,6,3,2
13,118,118,5,5,0,1,0
5,133,133,7,7,0,1,0
12,157,157,23,23,0,1,0
15,159,159,5,5,0,1,0
9,185,185,7,7,0,1,0
14,190,190,36,2,34,3,2
3,207,207,14,9,5,2,1
10,208,208,37,23,14,3,2
0,246,246,50,34,16,3,2
7,297,297,15,1,14,3,2
8,325,325,6,6,0,1,0
1,347,347,26,22,4,2,1
6,353,353,35,35,0,1,0
2,393,393,3,3,0,1,0
4,482,482,62,21,41,2,1

6,117,117,5,5,0,1,0
10,158,158,30,30,0,1,0
1,249,249,9,9,0,1,0
7,271,271,85,85,0,1,0
14,280,280,9,2,7,2,1
2,281,281,14,11,3,2,1
4,281,281,15,9,6,3,2
9,341,341,3,3,0,1,0
8,345,345,37,3,34,3,2
15,381,381,74,74,0,1,0
3,387,387,29,29,0,1,0
5,387,387,5,5,0,1,0
0,410,410,4,4,0,1,0
13,434,434,24,4,20,2,1
11,441,441,92,2,90,4,3
12,442,442,11,11,0,1,0

7,105,105,6,6,0,1,0
3,157,157,4,4,0,1,0
10,230,230,18,18,0,1,0
11,263,263,4,4,0,1,0
1,273,273,58,58,0,1,0
14,298,298,9,1,8,2,1
12,345,345,6,6,0,1,0
8,347,347,14,11,3,2,1
5,358,358,60,60,0,1,0
6,404,404,5,1,4,2,1
4,444,444,17,17,0,1,0
0,456,456,85,28,57,4,3
2,466,466,1,1,0,1,0
9,481,481,237,179,58,3,2
13,486,486,15,15,0,1,0

1,109,109,24,24,0,1,0
4,119,119,9,2,7,2,1
13,175,175,17,3,14,2,1
10,206,206,7,7,0,1,0
3,231,231,4,4,0,1,0
7,245,245,56,56,0,1,0
5,383,383,73,61,12,4,3
2,386,386,2,2,0,1,0
11,393,393,23,23,0,1,0
9,403,403,79,79,0,1,0
8,422,422,12,12,0,1,0
0,464,464,54,54,0,1,0
6,469,469,36,15,21,4,3
12,494,494,35,35,0,1,0

10,107,107,14,14,0,1,0
2,125,125,1,1,0,1,0
12,199,199,12,12,0,1,0
7,208,208,3,3,0,1,0
4,244,244,35,35,0,1,0
1,248,248,12,12,0,1,0
9,250,250,25,25,0,1,0
13,262,262,98,68,30,4,3
0,339,339,16,16,0,1,0
8,381,381,12,8,4,2,1
5,396,396,125,35,90,3,2
11,438,438,2,2,0,1,0
3,440,440,24,4,20,4,3
6,448,448,38,38,0,1,0

2,115,115,24,24,0,1,0
4,140,140,6,6,0,1,0
1,146,146,5,5,0,1,0
10,278,278,21,21,0,1,0
3,283,283,59,59,0,1,0
8,285,285,50,50,0,1,0
9,304,304,64,64,0,1,0
5,339,339,9,1,8,3,2
11,378,378,70,70,0,1,0
6,443,443,1,1,0,1,0
0,470,470,98,98,0,1,0
7,476,476,17,6,11,2,1

10,103,103,41,41,0,1,0
8,149,149,11,11,0,1,0
3,189,189,8,5,3,2,1
0,214,214,11,11,0,1,0
7,224,224,20,2,18,2,1
4,231,231,11,11,0,1,0
11,234,234,15,1,14,2,1
9,279,279,21,5,16,2,1
13,316,316,24,24,0,1,0
15,329,329,16,16,0,1,0
1,343,343,1,1,0,1,0
5,352,352,110,110,0,1,0
6,372,372,4,4,0,1,0
14,375,375,2,2,0,1,0
2,399,399,30,11,19,2,1
12,455,455,21,9,12,2,1

10,105,105,6,6,0,1,0
1,117,117,24,24,0,1,0
3,154,154,1,1,0,1,0
12,286,286,2,2,0,1,0
9,298,298,71,39,32,2,1
7,302,302,26,7,19,2,1
0,305,305,84,54,30,4,3
5,310,310,9,9,0,1,0
2,315,315,8,8,0,1,0
11,323,323,25,25,0,1,0
8,439,439,66,66,0,1,0
4,459,459,73,1,72,4,3
6,472,472,45,23,22,2,1

4,101,101,1,1,0,1,0
6,140,140,11,11,0,1,0
0,159,159,7,7,0,1,0
14,169,169,8,8,0,1,0
11,208,208,60,60,0,1,0
3,237,237,11,11,0,1,0
1,242,242,43,28,15,4,3
10,247,247,6,3,3,2,1
7,260,260,51,36,15,4,3
2,282,282,39,24,15,2,1
9,291,291,51,51,0,1,0
5,326,326,3,3,0,1,0
13,362,362,5,1,4,2,1
12,406,406,50,42,8,3,2
8,409,409,16,10,6,3,2

15,107,107,8,8,0,1,0
2,141,141,14,14,0,1,0
4,200,200,8,8,0,1,0
9,214,214,24,24,0,1,0
0,234,234,5,5,0,1,0
8,236,236,12,6,6,3,2
6,270,270,3,3,0,1,0
7,271,271,15,6,9,2,1
1,306,306,53,53,0,1,0
11,306,306,11,11,0,1,0
10,320,320,23,8,15,2,1
16,340,340,100,52,48,2,1
5,343,343,43,22,21,2,1
12,356,356,12,12,0,1,0
13,379,379,52,42,10,3,2
3,401,401,5,5,0,1,0
14,477,477,32,2,30,4,3

6,106,106,6,6,0,1,0
10,184,184,7,7,0,1,0
7,236,236,48,48,0,1,0
1,245,245,11,11,0,1,0
2,265,265,15,15,0,1,0
12,280,280,5,5,0,1,0
4,384,384,125,125,0,1,0
0,389,389,57,40,17,2,1
3,414,414,12,3,9,2,1
5,456,456,45,30,15,4,3
9,470,470,112,112,0,1,0
11,474,474,37,14,23,3,2
8,481,481,40,40,0,1,0

0,109,109,20,2,18,4,3
11,127,127,22,22,0,1,0
10,128,128,1,1,0,1,0
8,131,131,1,1,0,1,0
7,132,132,37,37,0,1,0
2,135,135,6,6,0,1,0
9,141,141,13,13,0,1,0
3,254,254,16,1,15,4,3
5,266,266,13,8,5,2,1
6,358,358,76,66,10,3,2
4,371,371,16,12,4,2,1
1,414,414,44,23,21,4,3
12,417,417,3,3,0,1,0
13,440,440,68,68,0,1,0

4,106,106,1,1,0,1,0
12,113,113,35,35,0,1,0
14,154,154,2,2,0,1,0
7,172,172,2,2,0,1,0
0,176,176,3,3,0,1,0
1,193,193,19,19,0,1,0
6,222,222,45,9,36,2,1
16,241,241,14,3,11,2,1
3,267,267,29,29,0,1,0
2,271,271,17,17,0,1,0
15,332,332,2,2,0,1,0
5,335,335,45,33,12,4,3
13,425,425,18,18,0,1,0
10,443,443,35,35,0,1,0
8,450,450,15,1,14,2,1
11,471,471,97,76,21,2,1
9,491,491,11,6,5,2,1

2,107,107,9,9,0,1,0
11,139,139,4,4,0,1,0
4,199,199,6,1,5,2,1
5,212,212,7,2,5,2,1
3,266,266,65,65,0,1,0
8,296,296,48,12,36,3,2
1,297,297,29,1,28,3,2
10,340,340,43,1,42,3,2
6,341,341,50,50,0,1,0
9,377,377,74,74,0,1,0
7,416,416,10,10,0,1,0
0,430,430,105,92,13,2,1

13,114,114,2,2,0,1,0
8,116,116,6,6,0,1,0
4,130,130,3,3,0,1,0
9,138,138,16,16,0,1,0
5,188,188,5,5,0,1,0
14,225,225,23,3,20,2,1
1,246,246,7,7,0,1,0
12,255,255,36,6,30,4,3
7,271,271,23,23,0,1,0
10,330,330,10,1,9,4,3
15,354,354,85,25,60,3,2
3,386,386,18,7,11,2,1
6,439,439,86,86,0,1,0
11,448,448,30,4,26,2,1
2,466,466,103,64,39,2,1
0,496,496,14,14,0,1,0

6,114,114,8,8,0,1,0
8,121,121,10,10,0,1,0
2,175,175,55,41,14,2,1
3,209,209,36,36,0,1,0
0,211,211,43,43,0,1,0
7,245,245,5,5,0,1,0
4,273,273,6,3,3,2,1
9,414,414,60,60,0,1,0
1,471,471,87,54,33,4,3
5,491,491,100,100,0,1,0

12,101,101,17,17,0,1,0
0,187,187,5,5,0,1,0
4,235,235,14,14,0,1,0
3,238,238,3,3,0,1,0
9,267,267,69,25,44,4,3
8,276,276,4,1,3,2,1
6,325,325,12,12,0,1,0
16,327,327,24,24,0,1,0
10,335,335,11,3,8,2,1
2,344,344,38,38,0,1,0
1,382,382,16,9,7,2,1
18,403,403,14,5,9,2,1
5,435,435,41,25,16,2,1
14,452,452,9,3,6,2,1
13,459,459,38,14,24,3,2
17,462,462,55,1,54,4,3
11,475,475,3,3,0,1,0
15,476,476,100,16,84,4,3
7,495,495,3,3,0,1,0

15,112,112,3,3,0,1,0
5,140,140,14,14,0,1,0
8,144,144,5,2,3,2,1
3,198,198,28,25,3,2,1
7,221,221,13,2,11,2,1
10,265,265,10,10,0,1,0
13,281,281,4,4,0,1,0
11,325,325,32,32,0,1,0
1,325,325,10,10,0,1,0
0,327,327,20,9,11,2,1
4,330,330,47,37,10,2,1
2,341,341,29,29,0,1,0
9,353,353,8,2,6,2,1
12,355,355,15,11,4,2,1
14,387,387,81,72,9,4,3
6,390,390,10,10,0,1,0
16,490,490,137,117,20,2,1

16,111,111,8,2,6,2,1
0,120,120,1,1,0,1,0
6,160,160,7,7,0,1,0
7,181,181,31,5,26,2,1
9,186,186,14,6,8,3,2
4,193,193,14,5,9,4,3
2,230,230,33,9,24,3,2
13,274,274,19,19,0,1,0
11,303,303,46,14,32,2,1
5,336,336,11,11,0,1,0
15,363,363,72,72,0,1,0
12,366,366,53,7,46,2,1
10,372,372,16,12,4,2,1
14,385,385,12,5,7,2,1
3,389,389,4,4,0,1,0
1,449,449,25,11,14,3,2
8,474,474,42,42,0,1,0

11,103,103,1,1,0,1,0
8,145,145,28,28,0,1,0
4,169,169,6,1,5,2,1
2,171,171,8,2,6,2,1
9,173,173,5,5,0,1,0
12,198,198,11,3,8,3,2
1,254,254,24,24,0,1,0
7,299,299,7,7,0,1,0
14,320,320,16,16,0,1,0
15,352,352,36,20,16,3,2
5,368,368,74,74,0,1,0
3,381,381,19,4,15,4,3
6,405,405,13,13,0,1,0
10,429,429,127,73,54,4,3
0,495,495,15,15,0,1,0
13,500,500,87,87,0,1,0

6,113,113,3,3,0,1,0
7,134,134,1,1,0,1,0
2,153,153,3,3,0,1,0
18,163,163,14,6,8,3,2
17,213,213,51,51,0,1,0
4,226,226,13,13,0,1,0
9,270,270,30,30,0,1,0
3,294,294,34,34,0,1,0
8,300,300,35,19,16,3,2
5,318,318,1,1,0,1,0
1,325,325,35,25,10,2,1
10,361,361,26,26,0,1,0
14,373,373,14,2,12,4,3
11,397,397,15,7,8,2,1
15,404,404,2,2,0,1,0
12,443,443,130,130,0,1,0
0,454,454,12,4,8,3,2
16,475,475,23,1,22,3,2
13,499,499,2,2,0,1,0

10,110,110,9,6,3,2,1
12,118,118,4,1,3,2,1
3,141,141,12,12,0,1,0
7,146,146,21,9,12,2,1
4,147,147,4,4,0,1,0
0,157,157,14,2,12,4,3
13,196,196,4,1,3,2,1
15,244,244,10,10,0,1,0
6,256,256,55,40,15,2,1
8,270,270,28,28,0,1,0
1,359,359,9,9,0,1,0
9,360,360,60,60,0,1,0
5,371,371,2,2,0,1,0
14,411,411,98,98,0,1,0
11,430,430,55,55,0,1,0
2,475,475,3,3,0,1,0

0,124,124,39,39,0,1,0
10,140,140,6,6,0,1,0
4,180,180,4,1,3,2,1
2,207,207,46,16,30,3,2
6,235,235,31,31,0,1,0
8,261,261,46,33,13,2,1
7,315,315,42,42,0,1,0
9,376,376,37,37,0,1,0
3,398,398,41,41,0,1,0
5,419,419,44,44,0,1,0
1,463,463,29,29,0,1,0

3,166,166,51,7,44,4,3
1,197,197,2,2,0,1,0
6,222,222,35,35,0,1,0
8,337,337,24,19,5,2,1
10,378,378,82,47,35,4,3
4,379,379,9,9,0,1,0
2,387,387,16,4,12,2,1
9,398,398,13,13,0,1,0
5,406,406,48,9,39,2,1
7,436,436,38,38,0,1,0
0,439,439,151,97,54,4,3

1,125,125,9,9,0,1,0
10,162,162,2,2,0,1,0
11,198,198,8,8,0,1,0
2,242,242,5,5,0,1,0
0,332,332,3,3,0,1,0
12,402,402,4,4,0,1,0
3,422,422,37,1,36,3,2
9,450,450,18,10,8,3,2
6,453,453,138,123,15,4,3
4,489,489,72,72,0,1,0
7,498,498,17,17,0,1,0
5,499,499,182,146,36,3,2
8,500,500,136,61,75,4,3

15,108,108,7,7,0,1,0
1,131,131,25,7,18,3,2
9,132,132,19,19,0,1,0
8,204,204,5,5,0,1,0
11,235,235,32,32,0,1,0
14,279,279,16,6,10,3,2
4,303,303,34,3,31,2,1
2,348,348,42,42,0,1,0
13,361,361,42,42,0,1,0
0,366,366,14,14,0,1,0
6,380,380,8,1,7,2,1
5,415,415,60,60,0,1,0
10,423,423,41,4,37,3,2
3,456,456,17,17,0,1,0
12,467,467,45,21,24,2,1
7,489,489,7,7,0,1,0

10,106,106,12,12,0,1,0
11,138,138,10,10,0,1,0
14,175,175,6,6,0,1,0
7,190,190,5,5,0,1,0
0,227,227,32,18,14,3,2
5,266,266,7,7,0,1,0
4,273,273,12,12,0,1,0
8,277,277,2,2,0,1,0
1,295,295,16,10,6,3,2
3,329,329,18,6,12,3,2
13,358,358,15,8,7,2,1
12,386,386,46,16,30,4,3
9,431,431,142,142,0,1,0
6,434,434,32,32,0,1,0
2,438,438,123,57,66,3,2

3,115,115,13,4,9,2,1
13,117,117,5,5,0,1,0
11,138,138,7,7,0,1,0
12,141,141,20,13,7,2,1
7,175,175,30,30,0,1,0
6,201,201,10,4,6,2,1
1,215,215,4,4,0,1,0
9,267,267,23,23,0,1,0
10,305,305,9,9,0,1,0
5,330,330,65,32,33,4,3
2,384,384,36,36,0,1,0
4,406,406,23,17,6,3,2
0,448,448,2,2,0,1,0
14,483,483,29,17,12,4,3
8,490,490,146,11,135,4,3

4,154,154,8,8,0,1,0
2,203,203,32,14,18,3,2
8,251,251,31,15,16,3,2
1,268,268,43,43,0,1,0
3,292,292,28,21,7,2,1
9,352,352,28,28,0,1,0
6,358,358,34,34,0,1,0
7,379,379,59,31,28,2,1
0,396,396,95,59,36,4,3
10,410,410,15,15,0,1,0
11,429,429,66,24,42,2,1
5,480,480,32,1,31,2,1

15,100,100,13,13,0,1,0
7,119,119,1,1,0,1,0
9,175,175,39,21,18,2,1
0,202,202,20,5,15,4,3
12,216,216,38,23,15,2,1
14,229,229,1,1,0,1,0
13,240,240,13,13,0,1,0
8,252,252,18,6,12,4,3
2,293,293,40,22,18,4,3
10,326,326,27,2,25,4,3
4,329,329,9,9,0,1,0
1,340,340,42,42,0,1,0
11,344,344,16,16,0,1,0
6,356,356,80,80,0,1,0
3,390,390,4,4,0,1,0
5,403,403,1,1,0,1,0

8,183,183,21,1,20,3,2
11,262,262,53,5,48,3,2
0,269,269,58,11,47,4,3
1,269,269,29,11,18,4,3
2,269,269,89,89,0,1,0
4,295,295,5,5,0,1,0
5,330,330,9,9,0,1,0
3,374,374,11,5,6,2,1
9,386,386,2,2,0,1,0
7,392,392,19,19,0,1,0
6,402,402,8,8,0,1,0
10,494,494,147,90,57,4,3

7,115,115,6,6,0,1,0
13,144,144,29,2,27,2,1
10,190,190,11,8,3,2,1
11,236,236,1,1,0,1,0
0,285,285,2,2,0,1,0
1,322,322,76,76,0,1,0
8,331,331,27,27,0,1,0
5,336,336,43,43,0,1,0
9,376,376,90,48,42,3,2
4,377,377,116,116,0,1,0
3,399,399,3,3,0,1,0
2,400,400,1,1,0,1,0
12,432,432,36,16,20,2,1
6,478,478,6,6,0,1,0

1,131,131,29,29,0,1,0
4,219,219,30,12,18,2,1
7,242,242,13,1,12,3,2
6,287,287,16,16,0,1,0
9,303,303,39,18,21,4,3
0,351,351,1,1,0,1,0
2,355,355,120,21,99,4,3
8,374,374,110,110,0,1,0
3,380,380,1,1,0,1,0
10,407,407,29,10,19,2,1
11,445,445,11,11,0,1,0
5,493,493,40,40,0,1,0

11,102,102,1,1,0,1,0
8,151,151,16,16,0,1,0
18,160,160,13,13,0,1,0
1,171,171,6,6,0,1,0
15,236,236,8,1,7,2,1
10,248,248,12,12,0,1,0
5,255,255,10,10,0,1,0
6,262,262,60,17,43,2,1
16,287,287,13,2,11,3,2
9,311,311,29,29,0,1,0
12,319,319,27,27,0,1,0
2,321,321,18,18,0,1,0
14,326,326,31,5,26,3,2
7,334,334,5,5,0,1,0
0,337,337,17,17,0,1,0
4,382,382,4,4,0,1,0
17,402,402,87,3,84,3,2
3,430,430,6,6,0,1,0
13,439,439,70,30,40,3,2

5,106,106,12,12,0,1,0
3,112,112,3,3,0,1,0
9,124,124,1,1,0,1,0
11,138,138,7,7,0,1,0
0,147,147,2,2,0,1,0
4,172,172,7,2,5,2,1
17,189,189,55,55,0,1,0
12,202,202,1,1,0,1,0
6,237,237,25,15,10,3,2
7,247,247,33,33,0,1,0
2,256,256,31,31,0,1,0
13,291,291,17,4,13,2,1
10,355,355,38,38,0,1,0
8,358,358,6,6,0,1,0
16,450,450,48,34,14,3,2
1,466,466,7,7,0,1,0
15,473,473,56,38,18,4,3
14,479,479,43,43,0,1,0

3,130,130,30,30,0,1,0
7,142,142,8,2,6,2,1
4,286,286,19,19,0,1,0
5,287,287,26,26,0,1,0
1,291,291,18,18,0,1,0
2,300,300,100,100,0,1,0
10,313,313,104,80,24,2,1
8,329,329,41,11,30,3,2
6,451,451,13,13,0,1,0
11,461,461,28,28,0,1,0
0,467,467,4,4,0,1,0
9,479,479,10,1,9,4,3

11,114,114,1,1,0,1,0
9,123,123,4,1,3,2,1
17,149,149,24,7,17,2,1
5,160,160,1,1,0,1,0
15,161,161,9,9,0,1,0
12,177,177,33,33,0,1,0
6,186,186,3,3,0,1,0
8,190,190,5,1,4,2,1
16,193,193,12,2,10,3,2
7,212,212,15,15,0,1,0
0,226,226,1,1,0,1,0
4,251,251,51,51,0,1,0
10,253,253,12,1,11,2,1
3,304,304,7,1,6,2,1
2,318,318,28,28,0,1,0
13,398,398,15,15,0,1,0
14,402,402,84,10,74,4,3
1,406,406,74,53,21,2,1

3,181,181,12,5,7,2,1
4,223,223,49,49,0,1,0
2,232,232,36,36,0,1,0
8,259,259,38,38,0,1,0
5,372,372,27,1,26,2,1
7,435,435,16,16,0,1,0
6,450,450,10,10,0,1,0
0,470,470,163,79,84,4,3
1,496,496,176,98,78,3,2

10,162,162,33,33,0,1,0
7,177,177,8,8,0,1,0
2,197,197,39,27,12,4,3
1,226,226,87,35,52,3,2
9,227,227,17,1,16,2,1
0,257,257,6,1,5,2,1
11,291,291,4,4,0,1,0
4,324,324,7,7,0,1,0
6,356,356,40,16,24,4,3
3,398,398,11,11,0,1,0
8,449,449,2,2,0,1,0
12,478,478,125,86,39,4,3
5,479,479,22,2,20,3,2

12,134,134,9,9,0,1,0
2,138,138,22,22,0,1,0
13,144,144,48,3,45,2,1
14,168,168,29,11,18,4,3
15,224,224,3,3,0,1,0
9,230,230,9,9,0,1,0
5,252,252,3,3,0,1,0
10,260,260,7,1,6,2,1
7,286,286,2,2,0,1,0
1,312,312,32,32,0,1,0
11,315,315,3,3,0,1,0
16,345,345,32,32,0,1,0
3,367,367,10,10,0,1,0
6,419,419,7,7,0,1,0
4,445,445,7,1,6,2,1
0,448,448,133,75,58,4,3
8,480,480,12,12,0,1,0

1,108,108,8,8,0,1,0
10,125,125,25,25,0,1,0
3,132,132,10,10,0,1,0
12,190,190,4,4,0,1,0
5,200,200,15,3,12,3,2
13,266,266,32,32,0,1,0
7,285,285,1,1,0,1,0
4,322,322,41,5,36,2,1
8,330,330,15,1,14,3,2
9,337,337,5,5,0,1,0
2,346,346,68,25,43,2,1
0,390,390,29,29,0,1,0
6,414,414,12,12,0,1,0
15,421,421,14,14,0,1,0
14,481,481,89,82,7,2,1
11,485,485,69,69,0,1,0

1,139,139,32,32,0,1,0
15,185,185,2,2,0,1,0
4,219,219,9,1,8,3,2
16,242,242,2,2,0,1,0
7,267,267,17,1,16,2,1
12,274,274,49,4,45,4,3
11,285,285,33,5,28,4,3
8,348,348,1,1,0,1,0
3,350,350,5,5,0,1,0
5,368,368,23,23,0,1,0
13,383,383,26,26,0,1,0
0,392,392,3,3,0,1,0
14,410,410,82,82,0,1,0
10,413,413,61,22,39,4,3
6,445,445,2,2,0,1,0
17,455,455,61,19,42,4,3
2,481,481,14,14,0,1,0
9,485,485,47,47,0,1,0

5,102,102,2,2,0,1,0
9,102,102,7,3,4,2,1
7,160,160,14,8,6,3,2
12,163,163,47,47,0,1,0
10,176,176,20,20,0,1,0
11,271,271,36,11,25,2,1
1,347,347,40,40,0,1,0
4,354,354,60,60,0,1,0
6,358,358,3,3,0,1,0
2,401,401,83,83,0,1,0
0,424,424,3,3,0,1,0
8,458,458,8,8,0,1,0
3,476,476,87,87,0,1,0

1,110,110,6,6,0,1,0
13,126,126,25,25,0,1,0
8,172,172,19,19,0,1,0
2,209,209,3,3,0,1,0
9,248,248,3,3,0,1,0
12,301,301,8,2,6,2,1
15,321,321,19,19,0,1,0
6,354,354,117,45,72,3,2
4,370,370,22,17,5,2,1
5,384,384,35,14,21,2,1
7,387,387,1,1,0,1,0
11,414,414,55,55,0,1,0
3,419,419,5,5,0,1,0
10,450,450,34,5,29,2,1
0,451,451,13,6,7,2,1
14,497,497,103,69,34,2,1

1,170,170,4,4,0,1,0
6,191,191,24,9,15,2,1
11,208,208,4,4,0,1,0
15,225,225,32,8,24,4,3
13,231,231,3,3,0,1,0
4,264,264,25,13,12,2,1
5,279,279,6,6,0,1,0
2,297,297,74,74,0,1,0
0,339,339,45,35,10,3,2
8,341,341,1,1,0,1,0
3,361,361,2,2,0,1,0
14,400,400,76,76,0,1,0
12,407,407,133,75,58,3,2
7,413,413,19,19,0,1,0
10,476,476,10,10,0,1,0
9,490,490,1,1,0,1,0

4,111,111,46,32,14,2,1
7,157,157,12,4,8,3,2
0,182,182,14,8,6,2,1
1,199,199,1,1,0,1,0
2,224,224,31,31,0,1,0
5,242,242,7,3,4,2,1
6,243,243,19,4,15,4,3
10,267,267,20,14,6,3,2
12,339,339,60,28,32,3,2
9,396,396,18,15,3,2,1
11,460,460,113,94,19,4,3
3,477,477,18,18,0,1,0
8,495,495,6,6,0,1,0

7,101,101,14,14,0,1,0
2,168,168,1,1,0,1,0
8,217,217,26,26,0,1,0
10,254,254,15,7,8,3,2
14,265,265,16,4,12,4,3
6,271,271,35,15,20,3,2
0,293,293,35,35,0,1,0
12,315,315,36,36,0,1,0
9,362,362,74,74,0,1,0
1,363,363,60,60,0,1,0
5,365,365,43,7,36,3,2
11,386,386,41,18,23,2,1
4,411,411,8,8,0,1,0
13,442,442,20,4,16,3,2
3,463,463,5,2,3,2,1

3,139,139,30,30,0,1,0
10,193,193,4,4,0,1,0
2,247,247,10,10,0,1,0
6,264,264,33,33,0,1,0
11,275,275,73,32,41,2,1
13,325,325,36,29,7,2,1
8,369,369,40,24,16,3,2
9,370,370,16,16,0,1,0
1,372,372,18,9,9,4,3
5,388,388,23,14,9,4,3
7,434,434,68,24,44,3,2
4,435,435,53,53,0,1,0
0,473,473,43,40,3,2,1
12,499,499,3,3,0,1,0

1,103,103,25,19,6,2,1
4,109,109,20,10,10,3,2
8,147,147,20,20,0,1,0
7,177,177,4,4,0,1,0
0,229,229,19,19,0,1,0
2,258,258,25,25,0,1,0
3,274,274,17,8,9,4,3
11,336,336,3,3,0,1,0
9,375,375,18,14,4,2,1
12,400,400,10,10,0,1,0
6,495,495,57,15,42,3,2
5,496,496,16,11,5,2,1
10,500,500,177,163,14,3,2

5,117,117,31,31,0,1,0
4,123,123,20,12,8,2,1
8,139,139,17,7,10,3,2
10,276,276,21,9,12,2,1
1,319,319,56,56,0,1,0
2,322,322,28,12,16,2,1
6,360,360,5,5,0,1,0
0,380,380,122,96,26,3,2
9,440,440,28,28,0,1,0
7,457,457,9,9,0,1,0
3,466,466,55,55,0,1,0

3,128,128,13,13,0,1,0
1,159,159,1,1,0,1,0
2,177,177,35,35,0,1,0
12,187,187,24,24,0,1,0
10,221,221,38,4,34,2,1
14,266,266,2,2,0,1,0
0,310,310,2,2,0,1,0
4,328,328,24,24,0,1,0
11,374,374,47,22,25,3,2
13,393,393,24,19,5,2,1
7,398,398,1,1,0,1,0
9,402,402,65,65,0,1,0
6,419,419,63,13,50,2,1
5,475,475,78,78,0,1,0
8,485,485,28,28,0,1,0

11,104,104,17,17,0,1,0
10,119,119,15,3,12,2,1
13,177,177,15,10,5,2,1
1,178,178,6,1,5,2,1
7,181,181,25,1,24,4,3
5,227,227,5,5,0,1,0
12,245,245,14,1,13,2,1
0,272,272,92,63,29,4,3
3,286,286,41,9,32,3,2
9,343,343,4,4,0,1,0
6,352,352,32,32,0,1,0
2,369,369,24,24,0,1,0
4,397,397,3,3,0,1,0
8,435,435,65,31,34,2,1

2,232,232,28,14,14,2,1
11,263,263,14,14,0,1,0
8,327,327,5,5,0,1,0
10,360,360,91,91,0,1,0
3,363,363,4,4,0,1,0
9,375,375,1,1,0,1,0
4,376,376,3,3,0,1,0
6,396,396,7,7,0,1,0
1,408,408,99,57,42,2,1
12,424,424,97,97,0,1,0
5,440,440,52,2,50,2,1
7,451,451,62,15,47,2,1
0,459,459,92,37,55,4,3

2,100,100,9,9,0,1,0
11,151,151,15,3,12,2,1
14,156,156,12,2,10,3,2
5,167,167,6,6,0,1,0
15,181,181,31,7,24,4,3
10,215,215,31,9,22,2,1
12,217,217,26,26,0,1,0
9,258,258,25,7,18,4,3
8,270,270,45,33,12,2,1
4,274,274,5,5,0,1,0
3,289,289,13,5,8,3,2
7,396,396,40,34,6,3,2
6,450,450,83,83,0,1,0
1,452,452,19,3,16,4,3
0,476,476,9,6,3,2,1
13,476,476,2,2,0,1,0

10,119,119,7,7,0,1,0
13,172,172,16,4,12,4,3
17,180,180,28,25,3,2,1
5,183,183,5,5,0,1,0
11,199,199,31,7,24,3,2
12,210,210,22,22,0,1,0
4,263,263,19,7,12,2,1
1,265,265,1,1,0,1,0
2,272,272,53,53,0,1,0
3,284,284,37,19,18,4,3
6,309,309,45,5,40,2,1
16,340,340,36,11,25,3,2
15,362,362,6,1,5,2,1
14,399,399,30,30,0,1,0
7,403,403,4,4,0,1,0
0,413,413,14,2,12,2,1
9,462,462,3,3,0,1,0
8,494,494,11,2,9,3,2

15,127,127,6,3,3,2,1
12,133,133,28,28,0,1,0
6,153,153,3,3,0,1,0
7,162,162,5,5,0,1,0
0,181,181,20,1,19,2,1
16,238,238,42,24,18,4,3
17,245,245,35,35,0,1,0
14,254,254,5,1,4,2,1
11,256,256,26,26,0,1,0
8,269,269,11,6,5,2,1
13,312,312,7,7,0,1,0
5,348,348,33,33,0,1,0
3,355,355,40,40,0,1,0
1,421,421,1,1,0,1,0
2,460,460,44,44,0,1,0
10,483,483,15,15,0,1,0
9,485,485,42,42,0,1,0
4,486,486,37,37,0,1,0

4,122,122,38,30,8,2,1
3,132,132,1,1,0,1,0
5,143,143,5,5,0,1,0
6,178,178,22,12,10,2,1
9,182,182,32,12,20,3,2
10,192,192,4,4,0,1,0
11,275,275,32,32,0,1,0
12,285,285,26,26,0,1,0
2,345,345,73,73,0,1,0
1,353,353,9,1,8,3,2
7,362,362,51,5,46,2,1
0,392,392,44,21,23,3,2
8,474,474,23,23,0,1,0

4,109,109,7,2,5,2,1
9,144,144,19,19,0,1,0
11,171,171,16,16,0,1,0
10,267,267,3,3,0,1,0
7,297,297,27,13,14,3,2
12,297,297,7,7,0,1,0
5,319,319,11,6,5,2,1
6,335,335,96,29,67,4,3
8,378,378,27,27,0,1,0
3,443,443,154,100,54,4,3
0,470,470,7,2,5,2,1
2,497,497,111,108,3,2,1
1,500,500,8,8,0,1,0

9,121,121,1,1,0,1,0
12,193,193,80,73,7,2,1
1,221,221,60,57,3,2,1
2,289,289,1,1,0,1,0
15,306,306,4,4,0,1,0
13,309,309,11,1,10,3,2
0,346,346,26,26,0,1,0
10,352,352,34,34,0,1,0
11,374,374,2,2,0,1,0
4,379,379,5,5,0,1,0
8,379,379,29,29,0,1,0
16,419,419,50,50,0,1,0
14,426,426,10,5,5,2,1
3,442,442,13,1,12,2,1
6,451,451,65,17,48,4,3
7,474,474,4,4,0,1,0
5,490,490,37,17,20,2,1

8,130,130,25,13,12,4,3
14,148,148,10,10,0,1,0
10,204,204,32,8,24,4,3
0,224,224,6,1,5,2,1
2,247,247,19,19,0,1,0
5,269,269,27,27,0,1,0
7,323,323,32,32,0,1,0
12,345,345,34,34,0,1,0
1,388,388,2,2,0,1,0
9,399,399,41,41,0,1,0
13,421,421,37,14,23,2,1
11,436,436,6,6,0,1,0
4,447,447,136,46,90,3,2
3,483,483,20,20,0,1,0
6,491,491,23,5,18,4,3

8,182,182,6,6,0,1,0
12,204,204,19,7,12,3,2
1,226,226,36,4,32,2,1
7,226,226,21,9,12,3,2
11,274,274,4,4,0,1,0
6,288,288,1,1,0,1,0
13,293,293,47,8,39,2,1
10,308,308,73,73,0,1,0
0,314,314,30,30,0,1,0
3,373,373,9,4,5,2,1
4,405,405,71,9,62,3,2
5,465,465,88,78,10,3,2
9,475,475,39,30,9,4,3
2,483,483,27,23,4,2,1

11,102,102,18,13,5,2,1
10,163,163,9,9,0,1,0
0,190,190,30,30,0,1,0
15,251,251,3,3,0,1,0
14,254,254,7,4,3,2,1
1,290,290,11,11,0,1,0
4,299,299,13,13,0,1,0
3,304,304,6,2,4,2,1
5,307,307,16,16,0,1,0
9,308,308,17,9,8,3,2
13,354,354,120,120,0,1,0
7,358,358,23,23,0,1,0
2,379,379,21,21,0,1,0
8,436,436,93,44,49,2,1
12,454,454,25,20,5,2,1
6,478,478,27,1,26,4,3

3,103,103,6,1,5,2,1
6,170,170,4,4,0,1,0
12,200,200,58,46,12,3,2
2,264,264,19,19,0,1,0
0,340,340,82,82,0,1,0
7,365,365,6,6,0,1,0
1,380,380,41,41,0,1,0
9,384,384,15,3,12,2,1
10,397,397,76,61,15,4,3
4,401,401,14,14,0,1,0
11,412,412,24,4,20,3,2
5,442,442,83,63,20,2,1
8,460,460,44,44,0,1,0

2,103,103,1,1,0,1,0
9,161,161,3,3,0,1,0
7,176,176,19,19,0,1,0
5,199,199,33,33,0,1,0
11,250,250,29,12,17,2,1
8,258,258,5,5,0,1,0
3,261,261,49,49,0,1,0
0,331,331,73,52,21,4,3
6,384,384,32,7,25,2,1
1,426,426,113,49,64,3,2
10,429,429,90,30,60,4,3
4,452,452,8,8,0,1,0

10,102,102,8,8,0,1,0
13,109,109,14,2,12,4,3
11,132,132,3,3,0,1,0
4,159,159,17,5,12,4,3
0,174,174,30,22,8,2,1
12,235,235,47,24,23,3,2
5,244,244,18,18,0,1,0
7,250,250,5,5,0,1,0
15,293,293,17,17,0,1,0
8,315,315,8,5,3,2,1
3,372,372,66,66,0,1,0
2,376,376,33,15,18,3,2
6,398,398,14,14,0,1,0
9,465,465,57,57,0,1,0
14,481,481,53,42,11,2,1
1,485,485,2,2,0,1,0

9,123,123,22,6,16,3,2
7,146,146,8,2,6,3,2
4,249,249,30,12,18,3,2
12,305,305,21,15,6,2,1
2,312,312,62,34,28,3,2
1,324,324,19,8,11,2,1
0,367,367,62,20,42,2,1
6,388,388,62,46,16,3,2
8,417,417,15,15,0,1,0
3,425,425,43,43,0,1,0
11,462,462,10,4,6,2,1
5,468,468,25,25,0,1,0
10,478,478,92,56,36,3,2

13,115,115,2,2,0,1,0
5,118,118,3,3,0,1,0
6,149,149,3,3,0,1,0
9,157,157,16,16,0,1,0
14,188,188,18,18,0,1,0
11,222,222,19,12,7,2,1
1,234,234,7,7,0,1,0
10,278,278,97,97,0,1,0
2,300,300,1,1,0,1,0
4,304,304,28,16,12,4,3
8,306,306,78,39,39,4,3
3,361,361,1,1,0,1,0
0,366,366,14,14,0,1,0
15,435,435,17,9,8,2,1
7,474,474,112,112,0,1,0
12,492,492,16,16,0,1,0

4,216,216,3,3,0,1,0
8,227,227,6,6,0,1,0
3,242,242,2,2,0,1,0
1,291,291,84,38,46,3,2
5,321,321,71,71,0,1,0
6,330,330,68,68,0,1,0
9,382,382,43,43,0,1,0
2,391,391,121,48,73,4,3
7,416,416,51,37,14,3,2
0,469,469,48,5,43,2,1

11,104,104,1,1,0,1,0
2,138,138,16,12,4,2,1
14,165,165,13,13,0,1,0
6,172,172,13,13,0,1,0
1,227,227,9,9,0,1,0
12,229,229,21,9,12,4,3
10,254,254,48,48,0,1,0
0,271,271,53,31,22,3,2
3,300,300,36,36,0,1,0
13,309,309,1,1,0,1,0
7,352,352,4,4,0,1,0
8,361,361,16,16,0,1,0
5,389,389,38,17,21,4,3
9,393,393,23,1,22,2,1
15,404,404,115,85,30,2,1
4,470,470,1,1,0,1,0

4,144,144,24,12,12,4,3
13,175,175,30,20,10,3,2
8,214,214,20,14,6,2,1
11,217,217,7,3,4,2,1
6,221,221,3,3,0,1,0
3,230,230,12,12,0,1,0
1,268,268,65,32,33,4,3
14,279,279,42,42,0,1,0
0,301,301,15,15,0,1,0
5,310,310,4,1,3,2,1
10,360,360,25,25,0,1,0
12,383,383,55,3,52,3,2
9,455,455,24,4,20,2,1
2,470,470,65,65,0,1,0
7,474,474,12,12,0,1,0

7,122,122,57,39,18,3,2
1,146,146,8,8,0,1,0
5,226,226,37,22,15,2,1
0,242,242,32,32,0,1,0
6,255,255,13,7,6,2,1
8,270,270,28,28,0,1,0
12,307,307,9,9,0,1,0
9,308,308,13,10,3,2,1
2,344,344,23,23,0,1,0
3,344,344,80,16,64,4,3
10,414,414,4,4,0,1,0
11,462,462,7,7,0,1,0
4,483,483,25,8,17,2,1

6,169,169,10,10,0,1,0
7,255,255,11,11,0,1,0
1,288,288,148,148,0,1,0
8,296,296,29,1,28,2,1
4,304,304,1,1,0,1,0
10,351,351,38,18,20,2,1
9,364,364,71,61,10,2,1
3,374,374,1,1,0,1,0
11,379,379,60,26,34,2,1
2,396,396,1,1,0,1,0
5,455,455,35,21,14,2,1
12,469,469,25,25,0,1,0
0,490,490,50,26,24,3,2

11,109,109,9,9,0,1,0
15,161,161,1,1,0,1,0
2,170,170,20,8,12,2,1
14,177,177,5,5,0,1,0
9,218,218,16,16,0,1,0
13,232,232,72,72,0,1,0
12,233,233,54,3,51,4,3
3,255,255,2,2,0,1,0
4,266,266,33,33,0,1,0
8,286,286,8,8,0,1,0
1,381,381,33,33,0,1,0
16,400,400,17,5,12,4,3
0,400,400,6,6,0,1,0
5,445,445,32,32,0,1,0
7,463,463,57,57,0,1,0
10,471,471,5,2,3,2,1
6,493,493,26,11,15,2,1

15,112,112,20,20,0,1,0
6,115,115,8,4,4,2,1
0,116,116,23,13,10,2,1
1,164,164,1,1,0,1,0
9,172,172,21,6,15,4,3
14,220,220,3,3,0,1,0
12,223,223,28,20,8,3,2
10,232,232,39,39,0,1,0
13,341,341,19,7,12,4,3
11,350,350,36,36,0,1,0
2,388,388,60,2,58,3,2
3,419,419,34,4,30,4,3
5,445,445,5,5,0,1,0
8,467,467,12,12,0,1,0
7,485,485,2,2,0,1,0
4,487,487,15,15,0,1,0
16,494,494,37,23,14,3,2

5,112,112,3,3,0,1,0
2,125,125,4,4,0,1,0
8,134,134,2,2,0,1,0
9,149,149,21,3,18,4,3
11,225,225,1,1,0,1,0
6,229,229,66,34,32,3,2
10,264,264,52,52,0,1,0
12,299,299,26,26,0,1,0
0,391,391,22,15,7,2,1
1,417,417,67,23,44,2,1
7,421,421,89,89,0,1,0
3,428,428,3,3,0,1,0
4,475,475,63,63,0,1,0
13,478,478,28,28,0,1,0

15,118,118,28,28,0,1,0
14,139,139,17,17,0,1,0
0,200,200,2,2,0,1,0
13,213,213,18,18,0,1,0
5,227,227,24,24,0,1,0
4,230,230,29,29,0,1,0
6,292,292,1,1,0,1,0
9,309,309,4,4,0,1,0
16,365,365,36,11,25,4,3
10,372,372,28,13,15,2,1
2,401,401,23,23,0,1,0
3,402,402,14,14,0,1,0
1,405,405,5,1,4,2,1
12,419,419,26,8,18,4,3
11,437,437,17,7,10,2,1
8,467,467,11,2,9,4,3
7,490,490,154,96,58,3,2

6,137,137,3,3,0,1,0
12,137,137,10,10,0,1,0
8,138,138,1,1,0,1,0
10,142,142,6,2,4,2,1
4,256,256,21,21,0,1,0
0,304,304,25,25,0,1,0
14,327,327,66,66,0,1,0
3,346,346,13,7,6,2,1
2,358,358,5,5,0,1,0
5,360,360,62,62,0,1,0
11,366,366,43,29,14,2,1
1,367,367,44,6,38,3,2
13,403,403,18,18,0,1,0
7,404,404,66,19,47,2,1
15,411,411,76,76,0,1,0
9,430,430,20,2,18,3,2

9,102,102,1,1,0,1,0
8,103,103,8,8,0,1,0
12,141,141,27,27,0,1,0
11,185,185,18,18,0,1,0
4,227,227,8,8,0,1,0
6,248,248,4,4,0,1,0
2,284,284,13,4,9,2,1
5,285,285,51,43,8,2,1
7,298,298,62,62,0,1,0
0,304,304,2,2,0,1,0
3,338,338,44,44,0,1,0
1,345,345,1,1,0,1,0
15,361,361,57,57,0,1,0
10,421,421,28,20,8,3,2
13,478,478,19,19,0,1,0
14,493,493,76,31,45,2,1

13,124,124,1,1,0,1,0
12,159,159,29,7,22,3,2
4,211,211,18,18,0,1,0
2,214,214,12,12,0,1,0
16,218,218,19,5,14,4,3
11,220,220,1,1,0,1,0
1,225,225,22,22,0,1,0
9,226,226,3,3,0,1,0
8,227,227,10,10,0,1,0
15,244,244,55,13,42,2,1
10,268,268,9,9,0,1,0
14,268,268,27,5,22,2,1
5,279,279,4,4,0,1,0
3,286,286,12,7,5,2,1
7,310,310,19,19,0,1,0
6,347,347,7,7,0,1,0
17,348,348,23,9,14,2,1
0,379,379,87,87,0,1,0
18,403,403,18,18,0,1,0

9,118,118,7,7,0,1,0
15,124,124,11,11,0,1,0
14,135,135,15,1,14,3,2
10,136,136,5,5,0,1,0
3,143,143,5,5,0,1,0
0,161,161,3,3,0,1,0
16,162,162,48,3,45,4,3
11,164,164,19,19,0,1,0
2,254,254,40,3,37,2,1
4,310,310,16,8,8,3,2
6,319,319,10,1,9,2,1
17,326,326,3,3,0,1,0
5,370,370,53,23,30,3,2
8,377,377,37,37,0,1,0
13,383,383,28,9,19,2,1
1,391,391,16,16,0,1,0
7,426,426,14,14,0,1,0
12,496,496,15,15,0,1,0

9,108,108,15,15,0,1,0
4,115,115,4,4,0,1,0
2,153,153,4,4,0,1,0
0,213,213,27,27,0,1,0
5,238,238,18,18,0,1,0
1,244,244,63,63,0,1,0
8,281,281,36,36,0,1,0
3,285,285,51,27,24,3,2
12,310,310,13,13,0,1,0
7,329,329,59,16,43,2,1
10,426,426,15,15,0,1,0
11,468,468,86,2,84,3,2
6,469,469,1,1,0,1,0

5,102,102,8,2,6,3,2
7,135,135,4,4,0,1,0
2,176,176,21,21,0,1,0
9,181,181,22,11,11,2,1
1,215,215,33,27,6,2,1
6,254,254,6,6,0,1,0
3,342,342,16,4,12,4,3
8,390,390,77,77,0,1,0
11,408,408,19,7,12,4,3
4,430,430,91,26,65,4,3
10,431,431,97,46,51,4,3
12,433,433,30,30,0,1,0
0,471,471,44,8,36,4,3

6,118,118,5,5,0,1,0
13,160,160,16,12,4,2,1
7,172,172,1,1,0,1,0
8,176,176,22,4,18,3,2
14,176,176,29,20,9,4,3
5,189,189,1,1,0,1,0
10,217,217,10,10,0,1,0
4,222,222,30,10,20,2,1
12,282,282,28,28,0,1,0
3,283,283,15,15,0,1,0
2,304,304,58,58,0,1,0
9,321,321,2,2,0,1,0
11,347,347,60,18,42,2,1
1,349,349,35,35,0,1,0
0,370,370,64,64,0,1,0

1,196,196,1,1,0,1,0
0,207,207,4,4,0,1,0
9,208,208,7,3,4,2,1
3,226,226,108,50,58,4,3
7,234,234,21,6,15,2,1
6,244,244,47,47,0,1,0
5,290,290,12,12,0,1,0
10,352,352,57,25,32,3,2
11,438,438,67,18,49,2,1
2,461,461,5,5,0,1,0
8,488,488,20,8,12,2,1
4,489,489,92,92,0,1,0

5,100,100,1,1,0,1,0
15,114,114,13,13,0,1,0
6,127,127,13,5,8,2,1
8,144,144,13,8,5,2,1
11,180,180,48,11,37,4,3
14,189,189,38,38,0,1,0
13,221,221,7,3,4,2,1
2,311,311,6,6,0,1,0
9,330,330,9,2,7,2,1
3,334,334,20,8,12,3,2
10,343,343,17,1,16,3,2
0,386,386,13,13,0,1,0
1,406,406,24,24,0,1,0
12,419,419,10,1,9,4,3
7,443,443,53,53,0,1,0
4,461,461,95,63,32,2,1

9,182,182,38,9,29,2,1
1,204,204,41,41,0,1,0
3,237,237,1,1,0,1,0
7,270,270,48,18,30,3,2
8,281,281,21,3,18,2,1
2,288,288,33,33,0,1,0
5,310,310,2,2,0,1,0
11,319,319,39,5,34,2,1
12,319,319,2,2,0,1,0
13,340,340,22,22,0,1,0
0,371,371,7,3,4,2,1
10,416,416,53,23,30,3,2
4,444,444,53,53,0,1,0
14,484,484,54,24,30,2,1
6,498,498,29,17,12,4,3

14,116,116,3,3,0,1,0
4,118,118,1,1,0,1,0
15,155,155,11,5,6,3,2
3,204,204,9,9,0,1,0
6,218,218,3,3,0,1,0
1,254,254,18,18,0,1,0
7,260,260,12,12,0,1,0
5,291,291,80,20,60,4,3
11,302,302,87,41,46,4,3
12,306,306,56,56,0,1,0
13,357,357,43,30,13,2,1
10,379,379,1,1,0,1,0
8,395,395,40,40,0,1,0
17,401,401,4,4,0,1,0
0,436,436,22,7,15,2,1
16,437,437,6,6,0,1,0
9,441,441,30,21,9,4,3
2,473,473,10,10,0,1,0

3,160,160,3,3,0,1,0
14,179,179,8,4,4,2,1
8,186,186,7,7,0,1,0
7,193,193,6,6,0,1,0
13,239,239,3,3,0,1,0
2,294,294,57,57,0,1,0
9,323,323,93,93,0,1,0
10,366,366,33,24,9,4,3
5,384,384,11,2,9,3,2
0,396,396,53,53,0,1,0
6,418,418,14,8,6,2,1
4,437,437,100,100,0,1,0
12,440,440,22,22,0,1,0
11,463,463,84,21,63,4,3
1,466,466,16,2,14,2,1

2,129,129,29,29,0,1,0
7,135,135,4,4,0,1,0
4,169,169,19,9,10,2,1
10,215,215,44,12,32,4,3
6,228,228,21,21,0,1,0
9,295,295,55,55,0,1,0
12,313,313,22,4,18,4,3
8,318,318,17,17,0,1,0
1,349,349,6,6,0,1,0
3,372,372,37,18,19,2,1
11,432,432,46,46,0,1,0
0,460,460,15,5,10,3,2
13,462,462,29,14,15,3,2
5,495,495,61,61,0,1,0

8,129,129,26,26,0,1,0
1,156,156,8,8,0,1,0
2,158,158,1,1,0,1,0
3,189,189,19,19,0,1,0
0,208,208,39,39,0,1,0
10,209,209,12,12,0,1,0
6,241,241,23,9,14,2,1
7,337,337,35,2,33,2,1
12,363,363,18,6,12,2,1
5,425,425,8,8,0,1,0
4,475,475,160,91,69,4,3
9,476,476,26,17,9,2,1
11,494,494,76,12,64,3,2

3,103,103,2,2,0,1,0
9,115,115,30,25,5,2,1
11,143,143,2,2,0,1,0
6,177,177,22,22,0,1,0
5,201,201,2,2,0,1,0
1,295,295,70,56,14,3,2
2,298,298,40,14,26,2,1
7,319,319,33,33,0,1,0
8,342,342,41,13,28,3,2
4,348,348,34,18,16,2,1
10,357,357,31,31,0,1,0
0,454,454,97,58,39,4,3

4,107,107,13,13,0,1,0
9,127,127,9,5,4,2,1
0,137,137,22,6,16,3,2
8,181,181,2,2,0,1,0
10,182,182,17,1,16,3,2
7,221,221,23,23,0,1,0
11,307,307,72,15,57,4,3
6,322,322,56,38,18,4,3
2,326,326,99,39,60,4,3
5,355,355,9,1,8,2,1
3,408,408,41,24,17,2,1
1,469,469,10,10,0,1,0

11,115,115,6,6,0,1,0
14,147,147,15,15,0,1,0
6,151,151,22,7,15,2,1
8,189,189,6,6,0,1,0
10,206,206,1,1,0,1,0
4,273,273,30,30,0,1,0
12,288,288,25,8,17,2,1
1,292,292,15,11,4,2,1
0,308,308,22,22,0,1,0
15,331,331,11,11,0,1,0
3,382,382,24,21,3,2,1
2,405,405,68,68,0,1,0
7,419,419,14,2,12,3,2
13,424,424,12,12,0,1,0
5,430,430,12,2,10,2,1
9,441,441,180,122,58,3,2

8,175,175,12,12,0,1,0
13,204,204,9,9,0,1,0
0,224,224,50,29,21,4,3
7,266,266,11,11,0,1,0
5,268,268,23,23,0,1,0
9,302,302,15,5,10,2,1
14,346,346,93,93,0,1,0
1,366,366,18,18,0,1,0
4,384,384,12,1,11,2,1
3,391,391,22,15,7,2,1
11,398,398,20,8,12,3,2
12,412,412,98,39,59,3,2
10,418,418,9,9,0,1,0
2,431,431,57,12,45,4,3
6,447,447,6,6,0,1,0
15,489,489,20,20,0,1,0

13,128,128,34,34,0,1,0
10,153,153,3,3,0,1,0
6,179,179,8,3,5,2,1
0,181,181,16,8,8,2,1
2,264,264,5,5,0,1,0
1,285,285,19,19,0,1,0
12,303,303,10,1,9,4,3
3,311,311,39,39,0,1,0
5,313,313,37,37,0,1,0
14,334,334,46,7,39,4,3
9,425,425,20,20,0,1,0
11,451,451,46,34,12,2,1
4,465,465,89,64,25,2,1
7,468,468,22,22,0,1,0
8,472,472,50,4,46,2,1

7,163,163,2,2,0,1,0
10,216,216,14,14,0,1,0
4,321,321,28,28,0,1,0
1,336,336,5,5,0,1,0
14,347,347,7,1,6,3,2
9,364,364,13,3,10,3,2
12,365,365,5,5,0,1,0
0,368,368,73,19,54,3,2
8,394,394,34,34,0,1,0
11,438,438,152,113,39,4,3
6,452,452,35,35,0,1,0
13,465,465,65,53,12,4,3
3,492,492,67,67,0,1,0
2,493,493,36,25,11,2,1
5,494,494,51,51,0,1,0

6,159,159,30,7,23,2,1
0,162,162,20,11,9,2,1
5,162,162,44,44,0,1,0
4,193,193,3,3,0,1,0
1,218,218,126,92,34,2,1
3,244,244,28,12,16,3,2
7,251,251,22,22,0,1,0
8,270,270,4,4,0,1,0
2,363,363,10,10,0,1,0

10,112,112,2,2,0,1,0
4,171,171,6,1,5,2,1
7,187,187,8,8,0,1,0
2,197,197,11,3,8,2,1
5,201,201,21,21,0,1,0
1,202,202,84,41,43,2,1
11,209,209,76,76,0,1,0
9,238,238,19,7,12,3,2
8,244,244,25,20,5,2,1
6,251,251,4,4,0,1,0
3,294,294,1,1,0,1,0
13,302,302,17,11,6,2,1
12,374,374,19,19,0,1,0
0,450,450,33,14,19,2,1

6,105,105,5,5,0,1,0
12,105,105,13,13,0,1,0
14,207,207,22,10,12,4,3
3,210,210,25,6,19,2,1
8,222,222,21,21,0,1,0
9,301,301,66,66,0,1,0
10,336,336,14,14,0,1,0
2,355,355,37,4,33,3,2
4,370,370,30,2,28,2,1
7,371,371,12,2,10,2,1
0,391,391,72,26,46,3,2
1,394,394,17,17,0,1,0
11,398,398,53,53,0,1,0
13,401,401,1,1,0,1,0
5,479,479,43,1,42,3,2

7,128,128,4,4,0,1,0
3,141,141,4,4,0,1,0
16,172,172,20,8,12,2,1
9,213,213,2,2,0,1,0
1,231,231,2,2,0,1,0
15,249,249,23,1,22,3,2
8,276,276,9,9,0,1,0
2,318,318,39,23,16,3,2
10,319,319,8,8,0,1,0
6,321,321,75,57,18,2,1
12,330,330,20,20,0,1,0
0,337,337,31,21,10,2,1
13,363,363,64,21,43,4,3
17,384,384,73,73,0,1,0
5,395,395,41,38,3,2,1
4,400,400,6,6,0,1,0
11,418,418,14,2,12,4,3
14,496,496,22,15,7,2,1

3,130,130,5,5,0,1,0
7,145,145,4,4,0,1,0
5,172,172,2,2,0,1,0
1,188,188,28,28,0,1,0
10,208,208,9,9,0,1,0
12,218,218,14,14,0,1,0
6,233,233,30,6,24,2,1
2,245,245,23,8,15,4,3
0,273,273,2,2,0,1,0
11,296,296,31,1,30,2,1
9,313,313,48,48,0,1,0
13,331,331,19,19,0,1,0
4,349,349,71,71,0,1,0
15,362,362,57,7,50,2,1
8,400,400,16,4,12,3,2
14,491,491,64,6,58,4,3

6,166,166,68,68,0,1,0
10,186,186,5,5,0,1,0
1,210,210,51,39,12,2,1
8,291,291,13,13,0,1,0
5,320,320,7,2,5,2,1
3,324,324,53,53,0,1,0
9,324,324,31,1,30,3,2
11,357,357,19,11,8,3,2
4,365,365,49,49,0,1,0
0,413,413,20,2,18,3,2
2,453,453,51,43,8,3,2
7,464,464,30,30,0,1,0

11,173,173,20,20,0,1,0
3,219,219,7,7,0,1,0
5,241,241,3,3,0,1,0
12,253,253,10,4,6,3,2
1,306,306,1,1,0,1,0
4,308,308,28,22,6,2,1
2,310,310,42,42,0,1,0
8,311,311,24,24,0,1,0
10,340,340,43,43,0,1,0
13,373,373,40,2,38,3,2
7,374,374,64,1,63,4,3
6,410,410,4,4,0,1,0
9,434,434,34,34,0,1,0
0,467,467,195,195,0,1,0

16,125,125,3,3,0,1,0
6,131,131,20,9,11,2,1
1,134,134,1,1,0,1,0
7,191,191,30,30,0,1,0
9,233,233,12,12,0,1,0
12,235,235,41,41,0,1,0
3,275,275,5,5,0,1,0
10,283,283,41,41,0,1,0
4,289,289,16,4,12,3,2
15,342,342,19,11,8,2,1
11,375,375,35,35,0,1,0
13,378,378,25,25,0,1,0
14,384,384,58,58,0,1,0
8,391,391,9,9,0,1,0
2,447,447,51,12,39,4,3
0,454,454,2,2,0,1,0
5,486,486,58,58,0,1,0

4,103,103,20,5,15,4,3
7,125,125,21,6,15,4,3
1,147,147,25,14,11,2,1
6,154,154,2,2,0,1,0
5,216,216,1,1,0,1,0
2,237,237,7,7,0,1,0
10,247,247,18,18,0,1,0
9,301,301,69,1,68,3,2
8,345,345,56,36,20,2,1
11,380,380,25,4,21,2,1
0,487,487,52,10,42,4,3
3,496,496,99,77,22,2,1

2,118,118,9,9,0,1,0
0,126,126,8,2,6,2,1
9,164,164,25,25,0,1,0
11,205,205,9,9,0,1,0
1,210,210,7,7,0,1,0
5,240,240,57,57,0,1,0
6,258,258,4,4,0,1,0
7,265,265,5,5,0,1,0
8,285,285,21,4,17,2,1
12,291,291,11,2,9,2,1
15,327,327,109,11,98,3,2
10,379,379,39,39,0,1,0
4,387,387,39,23,16,2,1
14,429,429,8,3,5,2,1
3,434,434,35,3,32,4,3
13,455,455,8,2,6,3,2

13,105,105,9,9,0,1,0
10,119,119,7,1,6,3,2
5,142,142,3,3,0,1,0
8,155,155,30,6,24,3,2
11,163,163,14,14,0,1,0
14,178,178,17,17,0,1,0
12,189,189,54,54,0,1,0
3,199,199,54,46,8,3,2
4,210,210,5,5,0,1,0
1,282,282,1,1,0,1,0
9,319,319,24,24,0,1,0
7,339,339,19,19,0,1,0
2,357,357,29,2,27,4,3
6,361,361,11,6,5,2,1
15,369,369,12,12,0,1,0
0,415,415,9,9,0,1,0

0,194,194,9,6,3,2,1
15,205,205,19,3,16,2,1
3,221,221,2,2,0,1,0
1,227,227,1,1,0,1,0
7,248,248,58,58,0,1,0
16,248,248,24,24,0,1,0
4,278,278,53,15,38,4,3
11,297,297,10,10,0,1,0
5,337,337,16,3,13,4,3
9,362,362,6,6,0,1,0
8,383,383,9,9,0,1,0
13,395,395,23,5,18,4,3
14,396,396,156,75,81,4,3
6,411,411,27,9,18,2,1
2,418,418,6,3,3,2,1
17,419,419,4,4,0,1,0
10,424,424,21,21,0,1,0
12,434,434,10,4,6,2,1

0,135,135,10,10,0,1,0
1,150,150,1,1,0,1,0
3,225,225,32,27,5,2,1
4,230,230,21,21,0,1,0
9,277,277,66,19,47,2,1
8,330,330,20,9,11,2,1
7,338,338,28,28,0,1,0
10,386,386,32,32,0,1,0
2,392,392,107,28,79,4,3
13,392,392,26,8,18,4,3
12,425,425,18,6,12,2,1
6,435,435,1,1,0,1,0
14,436,436,18,18,0,1,0
11,494,494,87,78,9,2,1
5,496,496,15,15,0,1,0

7,120,120,11,11,0,1,0
17,159,159,19,3,16,3,2
18,162,162,21,21,0,1,0
14,179,179,19,13,6,3,2
0,216,216,7,1,6,2,1
12,248,248,14,14,0,1,0
4,343,343,39,39,0,1,0
3,387,387,9,6,3,2,1
6,388,388,10,10,0,1,0
15,398,398,16,8,8,2,1
1,403,403,40,26,14,2,1
9,435,435,35,19,16,2,1
5,449,449,19,9,10,3,2
10,466,466,6,6,0,1,0
11,466,466,4,4,0,1,0
13,467,467,50,25,25,4,3
8,468,468,77,36,41,3,2
16,472,472,72,18,54,4,3
2,493,493,3,3,0,1,0

2,104,104,12,4,8,2,1
5,135,135,4,4,0,1,0
7,216,216,24,24,0,1,0
6,232,232,18,18,0,1,0
1,291,291,70,26,44,3,2
4,308,308,45,45,0,1,0
10,323,323,13,13,0,1,0
11,325,325,59,35,24,2,1
8,361,361,92,73,19,2,1
0,391,391,2,2,0,1,0
9,391,391,8,8,0,1,0
3,404,404,79,35,44,3,2

14,102,102,5,5,0,1,0
5,154,154,13,13,0,1,0
4,161,161,5,5,0,1,0
10,173,173,36,36,0,1,0
13,176,176,50,5,45,4,3
11,179,179,6,3,3,2,1
1,200,200,4,4,0,1,0
15,213,213,15,2,13,2,1
12,248,248,11,11,0,1,0
6,273,273,3,3,0,1,0
8,279,279,8,8,0,1,0
9,283,283,34,22,12,2,1
2,326,326,18,6,12,3,2
16,365,365,9,2,7,3,2
3,443,443,75,75,0,1,0
7,481,481,21,21,0,1,0
0,492,492,68,68,0,1,0

14,146,146,13,13,0,1,0
15,162,162,50,50,0,1,0
13,164,164,6,6,0,1,0
17,180,180,4,4,0,1,0
0,190,190,2,2,0,1,0
1,195,195,1,1,0,1,0
18,202,202,19,4,15,2,1
2,213,213,4,4,0,1,0
16,220,220,8,4,4,2,1
9,282,282,6,3,3,2,1
4,294,294,57,43,14,2,1
6,318,318,29,29,0,1,0
12,328,328,34,9,25,2,1
19,357,357,47,47,0,1,0
11,386,386,7,7,0,1,0
3,427,427,1,1,0,1,0
7,441,441,7,1,6,3,2
5,466,466,45,45,0,1,0
8,479,479,20,20,0,1,0
10,488,488,40,40,0,1,0

6,170,170,13,13,0,1,0
2,181,181,16,16,0,1,0
12,183,183,14,2,12,3,2
4,184,184,3,3,0,1,0
3,227,227,40,40,0,1,0
9,227,227,16,16,0,1,0
1,260,260,50,50,0,1,0
5,302,302,36,10,26,2,1
10,363,363,30,30,0,1,0
0,369,369,40,4,36,3,2
7,407,407,71,53,18,3,2
11,460,460,69,47,22,2,1
8,488,488,40,40,0,1,0

6,132,132,11,11,0,1,0
3,137,137,3,3,0,1,0
9,151,151,20,20,0,1,0
8,190,190,8,1,7,2,1
1,201,201,3,3,0,1,0
19,232,232,6,6,0,1,0
2,250,250,12,1,11,3,2
12,275,275,14,3,11,2,1
7,286,286,1,1,0,1,0
14,287,287,130,124,6,3,2
20,287,287,25,25,0,1,0
16,298,298,21,21,0,1,0
10,315,315,2,2,0,1,0
11,346,346,22,22,0,1,0
5,353,353,38,25,13,3,2
15,400,400,15,4,11,2,1
13,418,418,2,2,0,1,0
0,430,430,49,49,0,1,0
18,439,439,16,16,0,1,0
17,488,488,1,1,0,1,0
4,496,496,4,4,0,1,0

4,120,120,3,3,0,1,0
1,123,123,21,12,9,2,1
15,152,152,13,1,12,3,2
7,172,172,8,8,0,1,0
3,181,181,13,13,0,1,0
13,195,195,45,45,0,1,0
8,232,232,24,24,0,1,0
5,239,239,14,14,0,1,0
11,254,254,17,5,12,3,2
14,281,281,5,5,0,1,0
12,338,338,58,58,0,1,0
9,346,346,6,6,0,1,0
6,350,350,55,55,0,1,0
10,423,423,50,50,0,1,0
0,450,450,30,30,0,1,0
2,467,467,1,1,0,1,0

5,108,108,4,4,0,1,0
1,129,129,13,13,0,1,0
6,139,139,2,2,0,1,0
4,146,146,1,1,0,1,0
0,216,216,10,1,9,4,3
3,250,250,28,4,24,4,3
10,250,250,6,6,0,1,0
2,262,262,50,50,0,1,0
7,270,270,52,28,24,2,1
8,275,275,38,38,0,1,0
12,337,337,98,54,44,2,1
9,342,342,4,4,0,1,0
14,393,393,13,7,6,2,1
11,425,425,38,38,0,1,0
13,459,459,56,16,40,4,3

1,142,142,3,3,0,1,0
0,143,143,16,9,7,2,1
11,152,152,44,44,0,1,0
3,154,154,14,4,10,3,2
9,159,159,5,5,0,1,0
8,170,170,18,12,6,2,1
2,180,180,5,5,0,1,0
15,226,226,30,30,0,1,0
6,229,229,39,12,27,4,3
10,286,286,8,8,0,1,0
7,292,292,10,10,0,1,0
5,322,322,24,4,20,2,1
4,343,343,12,12,0,1,0
13,351,351,16,16,0,1,0
12,387,387,36,36,0,1,0
14,403,403,5,5,0,1,0
16,435,435,49,49,0,1,0

1,130,130,21,12,9,4,3
2,146,146,2,2,0,1,0
6,195,195,2,2,0,1,0
5,215,215,89,50,39,2,1
7,244,244,12,12,0,1,0
3,294,294,7,7,0,1,0
0,305,305,19,4,15,4,3
11,310,310,62,62,0,1,0
9,318,318,47,47,0,1,0
8,336,336,41,11,30,4,3
4,365,365,10,10,0,1,0
10,380,380,63,63,0,1,0
12,385,385,6,6,0,1,0

12,183,183,3,3,0,1,0
9,204,204,1,1,0,1,0
10,212,212,16,16,0,1,0
2,233,233,14,11,3,2,1
4,259,259,4,4,0,1,0
0,295,295,32,6,26,2,1
6,316,316,15,6,9,4,3
1,330,330,103,19,84,3,2
5,348,348,31,14,17,2,1
13,369,369,58,32,26,3,2
11,384,384,66,33,33,2,1
3,402,402,28,19,9,4,3
8,488,488,75,32,43,4,3
7,494,494,65,17,48,4,3

2,166,166,33,7,26,3,2
0,221,221,2,2,0,1,0
10,227,227,25,25,0,1,0
11,289,289,24,6,18,4,3
4,336,336,12,12,0,1,0
13,358,358,4,4,0,1,0
12,383,383,89,24,65,4,3
7,414,414,34,34,0,1,0
5,417,417,27,8,19,2,1
1,424,424,40,40,0,1,0
9,428,428,7,7,0,1,0
3,451,451,19,11,8,2,1
14,482,482,100,80,20,2,1
8,486,486,24,8,16,2,1
6,496,496,86,86,0,1,0

2,154,154,1,1,0,1,0
6,163,163,14,14,0,1,0
13,168,168,69,6,63,4,3
10,214,214,6,6,0,1,0
3,217,217,43,12,31,4,3
11,249,249,16,16,0,1,0
9,279,279,4,4,0,1,0
12,299,299,11,11,0,1,0
14,332,332,40,40,0,1,0
7,334,334,15,15,0,1,0
1,362,362,40,37,3,2,1
0,377,377,37,14,23,2,1
5,473,473,2,2,0,1,0
8,476,476,20,10,10,2,1
15,477,477,18,1,17,2,1
4,498,498,55,21,34,2,1

9,184,184,1,1,0,1,0
1,266,266,19,19,0,1,0
0,269,269,52,25,27,4,3
3,293,293,33,11,22,3,2
7,294,294,2,2,0,1,0
5,390,390,33,33,0,1,0
4,419,419,85,81,4,2,1
8,419,419,73,53,20,2,1
10,441,441,21,21,0,1,0
6,450,450,84,84,0,1,0
2,464,464,150,3,147,4,3

7,116,116,31,8,23,2,1
17,129,129,26,26,0,1,0
16,134,134,1,1,0,1,0
1,207,207,8,2,6,3,2
13,212,212,56,14,42,2,1
12,218,218,4,4,0,1,0
5,241,241,1,1,0,1,0
11,252,252,4,1,3,2,1
3,259,259,20,20,0,1,0
9,264,264,15,15,0,1,0
0,270,270,7,7,0,1,0
2,311,311,1,1,0,1,0
8,314,314,42,6,36,2,1
10,350,350,24,10,14,2,1
4,365,365,6,6,0,1,0
15,446,446,19,3,16,2,1
6,460,460,5,5,0,1,0
14,497,497,80,59,21,4,3

11,112,112,5,1,4,2,1
7,116,116,11,11,0,1,0
13,137,137,28,28,0,1,0
10,142,142,6,6,0,1,0
9,158,158,26,17,9,4,3
6,191,191,24,3,21,2,1
2,232,232,31,31,0,1,0
0,236,236,5,5,0,1,0
8,275,275,65,65,0,1,0
12,275,275,3,3,0,1,0
14,401,401,5,5,0,1,0
5,423,423,72,54,18,4,3
4,428,428,12,3,9,4,3
1,457,457,19,19,0,1,0
3,477,477,42,3,39,4,3

3,131,131,17,17,0,1,0
2,168,168,11,1,10,2,1
15,178,178,38,38,0,1,0
10,183,183,10,2,8,3,2
11,211,211,25,7,18,3,2
12,217,217,48,39,9,4,3
16,228,228,21,21,0,1,0
1,243,243,5,2,3,2,1
8,244,244,8,5,3,2,1
6,339,339,34,34,0,1,0
7,341,341,7,7,0,1,0
9,343,343,7,7,0,1,0
17,354,354,17,17,0,1,0
13,397,397,13,13,0,1,0
5,400,400,6,6,0,1,0
0,455,455,13,7,6,2,1
14,458,458,16,16,0,1,0
18,465,465,34,34,0,1,0
4,488,488,46,4,42,4,3

2,129,129,12,12,0,1,0
3,129,129,2,2,0,1,0
4,174,174,11,11,0,1,0
14,217,217,30,30,0,1,0
6,249,249,9,9,0,1,0
9,260,260,23,23,0,1,0
7,289,289,7,7,0,1,0
12,310,310,25,7,18,2,1
10,316,316,8,8,0,1,0
16,350,350,4,4,0,1,0
0,356,356,1,1,0,1,0
13,366,366,30,12,18,2,1
1,386,386,14,6,8,3,2
11,423,423,63,42,21,2,1
15,430,430,97,41,56,3,2
5,469,469,71,65,6,3,2
8,474,474,90,34,56,3,2

3,109,109,6,6,0,1,0
10,168,168,4,1,3,2,1
4,212,212,3,3,0,1,0
6,213,213,1,1,0,1,0
8,231,231,52,52,0,1,0
11,238,238,10,10,0,1,0
5,261,261,73,30,43,3,2
1,265,265,54,28,26,2,1
0,290,290,53,53,0,1,0
7,353,353,5,5,0,1,0
9,393,393,50,6,44,2,1
2,443,443,109,109,0,1,0

7,117,117,13,10,3,2,1
11,134,134,29,29,0,1,0
2,150,150,20,4,16,2,1
4,195,195,11,11,0,1,0
13,207,207,13,13,0,1,0
10,373,373,57,43,14,2,1
8,379,379,29,17,12,4,3
3,383,383,16,16,0,1,0
0,419,419,16,2,14,2,1
9,436,436,55,55,0,1,0
15,445,445,25,25,0,1,0
1,447,447,50,38,12,2,1
5,482,482,2,2,0,1,0
12,493,493,1,1,0,1,0
14,499,499,2,2,0,1,0
6,499,499,1,1,0,1,0
16,499,499,109,109,0,1,0

2,100,100,1,1,0,1,0
7,109,109,19,11,8,3,2
5,126,126,24,24,0,1,0
12,160,160,18,18,0,1,0
14,162,162,8,1,7,2,1
0,191,191,3,3,0,1,0
8,196,196,76,76,0,1,0
10,204,204,12,12,0,1,0
1,217,217,35,15,20,3,2
6,322,322,11,2,9,4,3
3,349,349,19,4,15,4,3
9,367,367,4,4,0,1,0
13,382,382,15,1,14,3,2
11,402,402,25,25,0,1,0
4,488,488,32,2,30,2,1

2,145,145,1,1,0,1,0
6,159,159,1,1,0,1,0
13,184,184,13,13,0,1,0
0,202,202,10,3,7,2,1
7,219,219,5,5,0,1,0
8,225,225,10,10,0,1,0
1,255,255,19,14,5,2,1
10,266,266,26,17,9,2,1
3,272,272,15,6,9,2,1
12,274,274,2,2,0,1,0
14,366,366,84,84,0,1,0
15,373,373,6,6,0,1,0
9,378,378,8,8,0,1,0
4,408,408,70,70,0,1,0
11,439,439,19,19,0,1,0
16,441,441,111,76,35,2,1
5,473,473,118,72,46,3,2

2,111,111,3,3,0,1,0
9,113,113,30,12,18,2,1
0,117,117,2,2,0,1,0
14,139,139,27,27,0,1,0
4,149,149,12,12,0,1,0
1,152,152,18,18,0,1,0
7,157,157,17,7,10,3,2
5,189,189,8,8,0,1,0
13,247,247,14,14,0,1,0
11,285,285,48,5,43,2,1
15,350,350,1,1,0,1,0
8,361,361,4,4,0,1,0
3,443,443,3,3,0,1,0
6,450,450,130,130,0,1,0
12,452,452,7,3,4,2,1
10,497,497,6,1,5,2,1

16,105,105,11,11,0,1,0
10,119,119,2,2,0,1,0
2,173,173,1,1,0,1,0
13,191,191,4,4,0,1,0
15,215,215,29,29,0,1,0
3,228,228,10,10,0,1,0
14,296,296,36,36,0,1,0
17,299,299,28,10,18,3,2
6,314,314,7,1,6,2,1
5,338,338,1,1,0,1,0
4,348,348,43,43,0,1,0
8,359,359,51,51,0,1,0
1,433,433,51,51,0,1,0
12,450,450,62,62,0,1,0
7,454,454,51,12,39,4,3
18,471,471,48,48,0,1,0
0,476,476,47,47,0,1,0
9,492,492,6,6,0,1,0
11,500,500,1,1,0,1,0

5,165,165,9,9,0,1,0
3,201,201,37,11,26,2,1
11,228,228,8,8,0,1,0
2,230,230,1,1,0,1,0
10,233,233,67,58,9,4,3
9,251,251,5,5,0,1,0
7,274,274,71,17,54,4,3
6,303,303,10,10,0,1,0
4,327,327,37,37,0,1,0
0,347,347,17,17,0,1,0
8,412,412,12,12,0,1,0
1,413,413,145,7,138,4,3

5,149,149,11,11,0,1,0
7,246,246,54,21,33,4,3
8,262,262,5,5,0,1,0
10,263,263,31,31,0,1,0
12,268,268,47,21,26,2,1
3,299,299,102,41,61,4,3
2,307,307,8,8,0,1,0
1,333,333,14,4,10,2,1
4,345,345,31,31,0,1,0
0,440,440,58,21,37,4,3
11,454,454,21,1,20,3,2
9,488,488,12,12,0,1,0
6,497,497,55,55,0,1,0

4,143,143,19,7,12,3,2
7,205,205,6,6,0,1,0
0,209,209,29,29,0,1,0
10,230,230,4,4,0,1,0
9,249,249,56,10,46,3,2
6,282,282,17,17,0,1,0
2,327,327,48,10,38,2,1
1,393,393,162,96,66,4,3
8,482,482,71,71,0,1,0
3,488,488,2,2,0,1,0
5,492,492,49,49,0,1,0

13,148,148,3,3,0,1,0
8,149,149,2,2,0,1,0
10,226,226,3,3,0,1,0
4,237,237,18,18,0,1,0
15,261,261,9,9,0,1,0
0,272,272,48,7,41,2,1
6,311,311,12,2,10,3,2
7,336,336,2,2,0,1,0
11,338,338,65,44,21,4,3
14,371,371,15,4,11,2,1
1,375,375,7,7,0,1,0
3,411,411,139,139,0,1,0
9,448,448,39,36,3,2,1
5,452,452,12,12,0,1,0
2,463,463,4,4,0,1,0
12,497,497,163,115,48,3,2

4,114,114,19,15,4,2,1
10,158,158,63,37,26,2,1
13,161,161,8,8,0,1,0
9,166,166,10,10,0,1,0
12,174,174,16,16,0,1,0
1,184,184,4,4,0,1,0
7,211,211,9,3,6,2,1
14,325,325,11,3,8,2,1
8,330,330,25,25,0,1,0
5,348,348,19,19,0,1,0
0,388,388,2,2,0,1,0
6,409,409,100,91,9,4,3
2,457,457,74,74,0,1,0
3,469,469,3,3,0,1,0
11,500,500,3,3,0,1,0

6,112,112,35,35,0,1,0
3,128,128,12,3,9,4,3
1,216,216,80,70,10,3,2
7,287,287,39,15,24,4,3
4,300,300,18,18,0,1,0
5,318,318,4,4,0,1,0
2,348,348,12,3,9,4,3
8,353,353,26,11,15,2,1
0,410,410,136,136,0,1,0

3,129,129,1,1,0,1,0
2,146,146,6,6,0,1,0
1,156,156,8,2,6,2,1
6,219,219,23,5,18,4,3
13,223,223,24,5,19,3,2
10,223,223,29,29,0,1,0
4,275,275,3,3,0,1,0
16,278,278,42,42,0,1,0
8,279,279,56,56,0,1,0
11,314,314,32,5,27,4,3
7,315,315,40,40,0,1,0
12,404,404,65,12,53,4,3
0,406,406,38,20,18,4,3
9,408,408,20,20,0,1,0
14,447,447,4,4,0,1,0
15,479,479,24,9,15,4,3
5,480,480,7,2,5,2,1

7,134,134,7,1,6,3,2
11,139,139,5,5,0,1,0
2,142,142,15,8,7,2,1
9,187,187,8,8,0,1,0
3,212,212,30,19,11,2,1
10,244,244,99,63,36,4,3
8,250,250,12,7,5,2,1
0,304,304,51,7,44,3,2
6,359,359,6,6,0,1,0
5,459,459,51,25,26,3,2
1,482,482,50,50,0,1,0
4,495,495,90,48,42,3,2

15,111,111,11,1,10,2,1
2,120,120,6,3,3,2,1
10,121,121,33,9,24,2,1
11,238,238,25,25,0,1,0
13,238,238,21,2,19,2,1
12,245,245,8,8,0,1,0
0,260,260,35,8,27,4,3
9,262,262,1,1,0,1,0
14,284,284,32,11,21,4,3
4,355,355,19,13,6,2,1
8,356,356,24,10,14,3,2
5,390,390,18,18,0,1,0
7,442,442,13,13,0,1,0
3,453,453,4,4,0,1,0
6,464,464,82,32,50,4,3
1,479,479,65,65,0,1,0

9,118,118,25,25,0,1,0
2,125,125,18,10,8,2,1
8,142,142,18,18,0,1,0
3,182,182,33,4,29,2,1
7,218,218,2,2,0,1,0
0,244,244,12,12,0,1,0
6,298,298,14,14,0,1,0
5,314,314,17,17,0,1,0
4,407,407,27,8,19,2,1
1,431,431,141,134,7,2,1
10,470,470,92,55,37,2,1

18,107,107,16,16,0,1,0
3,166,166,6,6,0,1,0
5,171,171,17,6,11,2,1
7,179,179,3,3,0,1,0
16,191,191,2,2,0,1,0
13,192,192,47,8,39,2,1
14,197,197,13,13,0,1,0
12,215,215,29,29,0,1,0
8,236,236,3,3,0,1,0
1,281,281,12,8,4,2,1
17,285,285,18,2,16,2,1
2,293,293,9,9,0,1,0
9,317,317,19,4,15,2,1
4,330,330,55,55,0,1,0
11,387,387,37,29,8,3,2
0,421,421,44,32,12,2,1
10,468,468,6,3,3,2,1
15,470,470,21,21,0,1,0
6,498,498,11,11,0,1,0

11,103,103,10,1,9,4,3
12,158,158,3,3,0,1,0
10,188,188,40,40,0,1,0
14,202,202,13,13,0,1,0
16,239,239,45,32,13,2,1
0,245,245,5,5,0,1,0
15,282,282,41,17,24,3,2
2,300,300,3,3,0,1,0
6,339,339,9,5,4,2,1
5,339,339,4,1,3,2,1
1,350,350,4,4,0,1,0
17,354,354,9,9,0,1,0
9,356,356,23,23,0,1,0
4,408,408,25,5,20,2,1
8,418,418,23,1,22,2,1
3,432,432,74,66,8,3,2
7,442,442,26,1,25,3,2
13,446,446,81,29,52,3,2

10,159,159,24,4,20,3,2
5,166,166,15,15,0,1,0
11,175,175,27,6,21,2,1
8,196,196,8,2,6,2,1
3,225,225,43,43,0,1,0
9,294,294,30,8,22,2,1
0,401,401,55,55,0,1,0
6,410,410,40,40,0,1,0
4,425,425,50,50,0,1,0
1,427,427,1,1,0,1,0
7,441,441,33,33,0,1,0
2,500,500,127,19,108,4,3

6,136,136,12,2,10,2,1
11,179,179,15,15,0,1,0
3,258,258,8,8,0,1,0
8,268,268,18,9,9,4,3
10,281,281,39,24,15,4,3
1,282,282,3,3,0,1,0
0,291,291,1,1,0,1,0
2,372,372,26,26,0,1,0
9,401,401,3,3,0,1,0
12,458,458,73,73,0,1,0
4,467,467,41,41,0,1,0
5,469,469,234,161,73,4,3
7,485,485,82,82,0,1,0

4,113,113,9,2,7,2,1
10,196,196,5,2,3,2,1
13,225,225,11,2,9,2,1
0,243,243,15,6,9,4,3
14,246,246,11,11,0,1,0
1,259,259,1,1,0,1,0
5,297,297,38,6,32,2,1
3,331,331,8,3,5,2,1
6,342,342,5,1,4,2,1
12,435,435,16,16,0,1,0
15,436,436,19,7,12,2,1
7,452,452,87,77,10,3,2
9,485,485,182,182,0,1,0
2,489,489,26,26,0,1,0
11,491,491,67,12,55,3,2
8,498,498,71,49,22,2,1

3,103,103,5,2,3,2,1
10,108,108,11,7,4,2,1
9,138,138,13,13,0,1,0
0,151,151,32,32,0,1,0
11,154,154,17,17,0,1,0
6,291,291,6,1,5,2,1
7,299,299,39,39,0,1,0
8,349,349,89,45,44,3,2
2,357,357,56,56,0,1,0
5,368,368,2,2,0,1,0
1,408,408,18,6,12,4,3
4,481,481,115,109,6,3,2

11,113,113,13,13,0,1,0
0,138,138,17,6,11,2,1
10,160,160,11,1,10,3,2
6,173,173,2,2,0,1,0
3,175,175,21,6,15,4,3
9,300,300,20,20,0,1,0
8,305,305,29,13,16,2,1
12,347,347,45,45,0,1,0
1,365,365,21,14,7,3,2
5,371,371,2,2,0,1,0
2,387,387,69,20,49,2,1
4,396,396,35,1,34,3,2
15,409,409,11,11,0,1,0
7,421,421,10,10,0,1,0
14,434,434,118,118,0,1,0
13,452,452,16,16,0,1,0

2,111,111,3,3,0,1,0
0,258,258,11,11,0,1,0
13,299,299,58,58,0,1,0
7,305,305,35,35,0,1,0
8,324,324,16,1,15,4,3
10,337,337,11,11,0,1,0
6,359,359,137,128,9,2,1
4,378,378,21,21,0,1,0
1,384,384,27,20,7,2,1
5,399,399,9,9,0,1,0
3,407,407,41,35,6,2,1
12,424,424,111,111,0,1,0
9,434,434,5,5,0,1,0
11,446,446,21,21,0,1,0

6,106,106,15,2,13,2,1
2,194,194,7,7,0,1,0
13,210,210,6,6,0,1,0
4,247,247,26,26,0,1,0
9,252,252,1,1,0,1,0
0,259,259,6,6,0,1,0
11,265,265,43,10,33,4,3
15,289,289,14,14,0,1,0
1,301,301,14,5,9,4,3
14,305,305,37,37,0,1,0
10,360,360,29,29,0,1,0
5,378,378,26,14,12,4,3
3,379,379,16,16,0,1,0
12,385,385,9,1,8,2,1
17,400,400,56,31,25,2,1
16,415,415,78,10,68,3,2
7,483,483,71,71,0,1,0
8,486,486,3,3,0,1,0

7,106,106,2,2,0,1,0
2,175,175,72,24,48,4,3
11,214,214,8,8,0,1,0
0,288,288,7,7,0,1,0
8,297,297,25,22,3,2,1
1,307,307,23,23,0,1,0
9,325,325,2,2,0,1,0
10,373,373,138,98,40,3,2
5,425,425,71,15,56,3,2
4,450,450,10,4,6,2,1
6,451,451,50,22,28,2,1
12,464,464,39,21,18,4,3
3,485,485,1,1,0,1,0

5,103,103,8,2,6,3,2
6,123,123,11,11,0,1,0
12,182,182,6,6,0,1,0
2,186,186,27,27,0,1,0
1,217,217,10,10,0,1,0
3,238,238,13,3,10,3,2
0,269,269,65,41,24,4,3
9,270,270,73,73,0,1,0
10,306,306,1,1,0,1,0
7,370,370,21,21,0,1,0
8,381,381,24,24,0,1,0
4,389,389,19,1,18,3,2
11,426,426,114,38,76,3,2
13,479,479,11,2,9,2,1

7,102,102,3,3,0,1,0
10,113,113,7,7,0,1,0
3,155,155,15,15,0,1,0
6,161,161,29,29,0,1,0
13,193,193,32,22,10,2,1
12,225,225,4,4,0,1,0
5,226,226,4,4,0,1,0
4,257,257,48,26,22,3,2
9,272,272,44,44,0,1,0
0,333,333,36,36,0,1,0
11,357,357,87,22,65,4,3
1,418,418,14,10,4,2,1
8,422,422,15,3,12,4,3
2,467,467,37,37,0,1,0

14,121,121,5,5,0,1,0
5,123,123,22,6,16,3,2
3,157,157,6,6,0,1,0
9,183,183,2,2,0,1,0
8,211,211,4,4,0,1,0
1,259,259,51,51,0,1,0
0,317,317,5,5,0,1,0
13,321,321,48,24,24,3,2
6,348,348,12,12,0,1,0
10,390,390,40,40,0,1,0
7,410,410,76,76,0,1,0
4,429,429,17,17,0,1,0
12,433,433,55,26,29,2,1
2,458,458,5,5,0,1,0
11,479,479,129,73,56,3,2

3,102,102,5,5,0,1,0
10,106,106,24,24,0,1,0
1,111,111,9,9,0,1,0
9,130,130,7,1,6,3,2
2,174,174,2,2,0,1,0
7,185,185,9,9,0,1,0
11,207,207,18,18,0,1,0
6,264,264,24,6,18,3,2
4,279,279,87,12,75,4,3
5,296,296,19,19,0,1,0
0,349,349,87,18,69,4,3
8,458,458,63,3,60,4,3

10,101,101,6,6,0,1,0
11,191,191,24,12,12,4,3
7,230,230,10,10,0,1,0
2,316,316,12,12,0,1,0
8,318,318,19,19,0,1,0
6,367,367,11,11,0,1,0
3,383,383,63,63,0,1,0
4,402,402,8,8,0,1,0
0,455,455,79,79,0,1,0
1,462,462,141,107,34,2,1
9,475,475,89,89,0,1,0
5,497,497,106,7,99,4,3

7,116,116,4,4,0,1,0
3,178,178,45,45,0,1,0
10,195,195,7,7,0,1,0
9,221,221,46,46,0,1,0
5,231,231,2,2,0,1,0
2,239,239,14,14,0,1,0
12,316,316,87,36,51,4,3
13,317,317,15,15,0,1,0
4,331,331,45,45,0,1,0
0,374,374,34,34,0,1,0
1,387,387,10,1,9,2,1
8,387,387,12,8,4,2,1
14,418,418,10,10,0,1,0
6,457,457,29,29,0,1,0
15,489,489,56,56,0,1,0
11,493,493,4,4,0,1,0

12,105,105,3,3,0,1,0
3,197,197,46,2,44,3,2
11,204,204,61,43,18,4,3
1,292,292,17,17,0,1,0
9,317,317,45,45,0,1,0
2,331,331,30,17,13,2,1
6,419,419,10,10,0,1,0
4,439,439,27,27,0,1,0
0,451,451,84,69,15,4,3
8,472,472,37,2,35,2,1
7,474,474,56,48,8,2,1
10,485,485,12,12,0,1,0
13,490,490,13,13,0,1,0
5,499,499,24,15,9,4,3

17,117,117,6,6,0,1,0
6,122,122,1,1,0,1,0
5,133,133,2,2,0,1,0
13,157,157,54,18,36,2,1
9,161,161,1,1,0,1,0
1,162,162,26,26,0,1,0
16,163,163,2,2,0,1,0
0,167,167,1,1,0,1,0
14,176,176,3,3,0,1,0
15,228,228,21,1,20,3,2
3,265,265,17,17,0,1,0
7,268,268,64,64,0,1,0
10,321,321,25,25,0,1,0
11,357,357,49,44,5,2,1
12,416,416,25,7,18,4,3
8,417,417,18,18,0,1,0
4,424,424,32,24,8,2,1
2,425,425,2,2,0,1,0

2,140,140,4,4,0,1,0
14,153,153,14,2,12,3,2
0,187,187,7,7,0,1,0
3,225,225,32,6,26,2,1
6,246,246,16,16,0,1,0
12,278,278,5,5,0,1,0
5,282,282,73,73,0,1,0
10,324,324,22,22,0,1,0
11,349,349,86,86,0,1,0
1,366,366,19,5,14,2,1
13,380,380,79,27,52,3,2
9,442,442,1,1,0,1,0
4,460,460,27,12,15,4,3
7,476,476,28,28,0,1,0
8,499,499,38,35,3,2,1

3,124,124,18,18,0,1,0
9,220,220,35,35,0,1,0
8,230,230,5,1,4,2,1
0,270,270,5,5,0,1,0
7,272,272,7,7,0,1,0
2,283,283,103,48,55,3,2
1,368,368,117,117,0,1,0
6,400,400,124,109,15,2,1
4,409,409,20,20,0,1,0
5,453,453,1,1,0,1,0

0,103,103,27,27,0,1,0
1,110,110,14,14,0,1,0
11,140,140,4,4,0,1,0
3,167,167,16,1,15,2,1
5,236,236,20,20,0,1,0
7,252,252,3,3,0,1,0
6,284,284,8,8,0,1,0
4,286,286,28,28,0,1,0
8,299,299,70,29,41,2,1
9,340,340,45,33,12,4,3
10,397,397,76,76,0,1,0
2,433,433,52,44,8,3,2

0,114,114,8,8,0,1,0
5,164,164,1,1,0,1,0
15,190,190,15,4,11,2,1
14,213,213,54,45,9,2,1
4,221,221,15,15,0,1,0
6,236,236,8,8,0,1,0
12,295,295,4,4,0,1,0
9,300,300,40,4,36,3,2
3,301,301,2,2,0,1,0
8,309,309,78,78,0,1,0
13,310,310,4,1,3,2,1
7,340,340,7,7,0,1,0
10,352,352,33,9,24,3,2
16,358,358,64,64,0,1,0
11,363,363,29,1,28,3,2
1,414,414,21,17,4,2,1
2,441,441,27,4,23,4,3

8,108,108,11,3,8,3,2
2,116,116,12,12,0,1,0
4,209,209,47,4,43,2,1
9,263,263,23,23,0,1,0
7,319,319,7,3,4,2,1
3,330,330,8,2,6,2,1
1,391,391,62,24,38,2,1
6,393,393,27,27,0,1,0
5,413,413,79,7,72,3,2
0,463,463,204,78,126,4,3

3,119,119,15,1,14,3,2
8,139,139,2,2,0,1,0
5,242,242,23,23,0,1,0
11,259,259,6,2,4,2,1
12,288,288,48,12,36,4,3
0,311,311,33,33,0,1,0
10,350,350,53,53,0,1,0
4,392,392,7,7,0,1,0
1,426,426,48,48,0,1,0
2,437,437,106,86,20,2,1
7,472,472,2,2,0,1,0
9,475,475,65,53,12,4,3
6,481,481,105,12,93,4,3

16,157,157,2,2,0,1,0
2,207,207,26,5,21,3,2
0,207,207,13,13,0,1,0
1,256,256,17,12,5,2,1
5,257,257,4,4,0,1,0
7,262,262,10,2,8,3,2
8,271,271,1,1,0,1,0
14,271,271,2,2,0,1,0
4,304,304,26,11,15,2,1
3,335,335,18,18,0,1,0
13,339,339,26,26,0,1,0
10,400,400,2,2,0,1,0
17,430,430,36,26,10,3,2
15,443,443,13,2,11,2,1
6,451,451,64,28,36,3,2
12,467,467,130,126,4,2,1
11,490,490,107,10,97,4,3
9,496,496,51,39,12,2,1

8,103,103,27,27,0,1,0
0,150,150,31,2,29,4,3
9,156,156,29,29,0,1,0
10,181,181,18,2,16,3,2
1,184,184,43,16,27,2,1
7,199,199,8,1,7,3,2
2,230,230,35,10,25,2,1
3,264,264,29,10,19,4,3
5,365,365,32,32,0,1,0
4,475,475,13,1,12,3,2
6,476,476,8,2,6,3,2

2,100,100,45,45,0,1,0
4,145,145,15,15,0,1,0
1,152,152,2,2,0,1,0
3,194,194,18,2,16,2,1
7,201,201,11,11,0,1,0
9,260,260,24,24,0,1,0
6,416,416,14,14,0,1,0
5,439,439,30,17,13,2,1
0,468,468,115,77,38,2,1
8,474,474,128,106,22,3,2

9,115,115,2,2,0,1,0
8,151,151,18,4,14,2,1
3,160,160,27,27,0,1,0
0,221,221,46,46,0,1,0
2,226,226,27,15,12,3,2
5,268,268,23,5,18,3,2
10,285,285,33,33,0,1,0
12,292,292,26,16,10,3,2
1,332,332,5,2,3,2,1
6,356,356,65,25,40,3,2
11,407,407,4,1,3,2,1
7,435,435,81,2,79,4,3
4,436,436,46,13,33,2,1

9,134,134,45,45,0,1,0
0,157,157,5,5,0,1,0
8,158,158,8,3,5,2,1
4,194,194,19,6,13,2,1
2,262,262,2,2,0,1,0
3,262,262,11,4,7,2,1
11,287,287,13,2,11,2,1
5,299,299,90,42,48,3,2
1,316,316,25,1,24,3,2
14,340,340,5,5,0,1,0
13,437,437,25,5,20,3,2
12,442,442,38,20,18,4,3
6,456,456,55,55,0,1,0
7,492,492,10,10,0,1,0
10,499,499,59,59,0,1,0

9,119,119,3,3,0,1,0
14,156,156,14,8,6,2,1
11,163,163,12,12,0,1,0
8,184,184,24,24,0,1,0
10,197,197,27,14,13,2,1
13,215,215,6,6,0,1,0
2,221,221,18,18,0,1,0
0,231,231,20,20,0,1,0
3,380,380,107,71,36,4,3
4,386,386,3,3,0,1,0
7,424,424,4,4,0,1,0
5,437,437,32,5,27,2,1
12,455,455,107,23,84,3,2
1,456,456,58,58,0,1,0
6,459,459,16,16,0,1,0

3,159,159,20,20,0,1,0
10,197,197,11,2,9,4,3
4,238,238,33,27,6,2,1
6,258,258,35,8,27,4,3
5,296,296,34,29,5,2,1
8,300,300,13,1,12,2,1
7,331,331,3,3,0,1,0
0,399,399,5,5,0,1,0
11,407,407,60,35,25,2,1
12,412,412,105,6,99,4,3
2,421,421,103,75,28,2,1
1,491,491,32,3,29,4,3
9,499,499,31,31,0,1,0

0,102,102,1,1,0,1,0
12,162,162,36,36,0,1,0
6,177,177,49,13,36,3,2
7,232,232,23,23,0,1,0
8,245,245,4,4,0,1,0
3,259,259,7,7,0,1,0
10,269,269,12,12,0,1,0
2,291,291,42,28,14,2,1
11,295,295,5,1,4,2,1
4,298,298,8,8,0,1,0
1,381,381,107,87,20,2,1
5,449,449,95,19,76,3,2
9,461,461,16,5,11,2,1

2,109,109,4,4,0,1,0
5,144,144,15,9,6,2,1
3,192,192,40,40,0,1,0
7,296,296,34,34,0,1,0
1,297,297,13,4,9,4,3
6,348,348,8,8,0,1,0
0,389,389,256,256,0,1,0
4,438,438,33,15,18,4,3
8,495,495,75,12,63,4,3

0,155,155,1,1,0,1,0
4,162,162,17,2,15,2,1
8,174,174,60,31,29,3,2
7,177,177,1,1,0,1,0
10,203,203,13,1,12,4,3
12,248,248,8,8,0,1,0
11,265,265,7,7,0,1,0
1,294,294,7,1,6,3,2
3,330,330,9,9,0,1,0
9,363,363,29,4,25,2,1
6,374,374,92,14,78,4,3
2,416,416,7,7,0,1,0
5,427,427,118,100,18,3,2
13,433,433,69,69,0,1,0

18,103,103,16,16,0,1,0
13,117,117,3,3,0,1,0
2,139,139,3,3,0,1,0
16,159,159,10,10,0,1,0
10,167,167,8,8,0,1,0
5,221,221,4,1,3,2,1
15,233,233,6,6,0,1,0
9,258,258,10,10,0,1,0
1,262,262,32,9,23,2,1
7,297,297,11,11,0,1,0
17,297,297,39,13,26,3,2
11,307,307,6,6,0,1,0
3,308,308,9,9,0,1,0
8,319,319,29,2,27,3,2
12,386,386,2,2,0,1,0
0,411,411,8,8,0,1,0
6,460,460,56,37,19,2,1
4,469,469,63,19,44,4,3
14,493,493,156,117,39,4,3

16,137,137,9,9,0,1,0
15,149,149,14,11,3,2,1
3,154,154,3,3,0,1,0
2,169,169,29,29,0,1,0
6,202,202,11,11,0,1,0
1,204,204,7,7,0,1,0
0,210,210,1,1,0,1,0
9,213,213,24,24,0,1,0
12,217,217,41,41,0,1,0
13,226,226,39,30,9,4,3
4,256,256,17,1,16,2,1
17,328,328,10,10,0,1,0
5,332,332,11,2,9,4,3
10,356,356,12,3,9,4,3
11,362,362,41,7,34,2,1
8,379,379,5,5,0,1,0
14,425,425,20,20,0,1,0
7,469,469,74,74,0,1,0

12,103,103,5,5,0,1,0
14,124,124,21,21,0,1,0
9,125,125,5,5,0,1,0
6,197,197,33,33,0,1,0
0,212,212,1,1,0,1,0
8,213,213,7,7,0,1,0
5,233,233,8,8,0,1,0
7,238,238,6,6,0,1,0
10,238,238,49,49,0,1,0
1,273,273,26,26,0,1,0
2,275,275,1,1,0,1,0
18,349,349,29,11,18,2,1
15,391,391,8,8,0,1,0
17,411,411,22,4,18,2,1
16,433,433,132,117,15,4,3
13,442,442,16,8,8,3,2
3,467,467,26,12,14,3,2
11,482,482,6,6,0,1,0
4,484,484,11,1,10,2,1

12,102,102,9,9,0,1,0
8,163,163,3,3,0,1,0
0,168,168,46,40,6,3,2
3,183,183,10,10,0,1,0
1,220,220,60,41,19,2,1
2,234,234,9,9,0,1,0
11,256,256,24,24,0,1,0
6,279,279,37,37,0,1,0
9,337,337,27,27,0,1,0
5,401,401,13,13,0,1,0
7,472,472,139,53,86,3,2
4,473,473,14,14,0,1,0
10,497,497,6,3,3,2,1

3,156,156,16,11,5,2,1
8,157,157,17,17,0,1,0
6,173,173,22,22,0,1,0
1,178,178,51,51,0,1,0
5,220,220,10,10,0,1,0
9,282,282,26,26,0,1,0
0,296,296,11,5,6,3,2
2,310,310,29,10,19,2,1
10,319,319,21,21,0,1,0
4,335,335,4,4,0,1,0
11,344,344,61,21,40,2,1
13,358,358,10,1,9,4,3
7,469,469,26,26,0,1,0
12,500,500,94,94,0,1,0

13,101,101,12,12,0,1,0
5,109,109,2,2,0,1,0
17,156,156,10,10,0,1,0
7,264,264,25,25,0,1,0
8,273,273,33,14,19,3,2
15,280,280,67,67,0,1,0
6,286,286,34,24,10,3,2
4,293,293,10,2,8,2,1
16,296,296,17,7,10,2,1
11,304,304,25,25,0,1,0
12,335,335,28,28,0,1,0
3,370,370,15,7,8,3,2
0,381,381,29,29,0,1,0
14,400,400,29,14,15,2,1
10,436,436,1,1,0,1,0
2,445,445,77,22,55,4,3
1,468,468,3,3,0,1,0
9,472,472,7,7,0,1,0

10,111,111,9,2,7,2,1
1,145,145,1,1,0,1,0
3,161,161,4,4,0,1,0
5,171,171,54,18,36,2,1
7,193,193,4,1,3,2,1
11,212,212,44,44,0,1,0
12,218,218,32,29,3,2,1
6,222,222,41,41,0,1,0
2,313,313,12,12,0,1,0
9,340,340,11,11,0,1,0
8,430,430,18,5,13,2,1
4,481,481,86,86,0,1,0
0,482,482,68,68,0,1,0

4,103,103,3,3,0,1,0
7,134,134,2,2,0,1,0
12,147,147,34,5,29,4,3
9,156,156,5,5,0,1,0
10,158,158,10,4,6,3,2
13,219,219,43,25,18,3,2
0,236,236,12,9,3,2,1
3,286,286,25,10,15,4,3
8,302,302,10,10,0,1,0
6,316,316,17,8,9,4,3
1,372,372,16,16,0,1,0
2,425,425,120,120,0,1,0
5,469,469,66,66,0,1,0
14,481,481,61,40,21,2,1
11,490,490,20,20,0,1,0

16,118,118,15,15,0,1,0
10,122,122,2,2,0,1,0
1,135,135,6,3,3,2,1
17,138,138,9,9,0,1,0
14,171,171,18,4,14,2,1
4,176,176,14,2,12,3,2
6,192,192,1,1,0,1,0
11,205,205,13,5,8,2,1
8,231,231,4,4,0,1,0
2,255,255,24,12,12,2,1
13,272,272,52,52,0,1,0
9,313,313,34,23,11,2,1
12,323,323,38,20,18,4,3
3,327,327,1,1,0,1,0
0,340,340,3,3,0,1,0
5,348,348,29,20,9,4,3
7,412,412,100,100,0,1,0
15,494,494,26,2,24,3,2

4,106,106,4,4,0,1,0
8,124,124,1,1,0,1,0
10,168,168,27,6,21,4,3
2,179,179,19,11,8,3,2
7,212,212,50,50,0,1,0
13,278,278,11,11,0,1,0
1,287,287,13,13,0,1,0
15,300,300,26,5,21,2,1
0,307,307,18,12,6,2,1
11,313,313,11,11,0,1,0
14,340,340,119,50,69,3,2
9,343,343,12,12,0,1,0
16,409,409,14,14,0,1,0
12,424,424,1,1,0,1,0
6,433,433,39,39,0,1,0
3,453,453,34,22,12,3,2
5,454,454,4,4,0,1,0

5,117,117,12,1,11,2,1
0,126,126,14,14,0,1,0
6,134,134,10,1,9,2,1
4,178,178,2,2,0,1,0
10,192,192,3,3,0,1,0
14,203,203,35,2,33,2,1
12,210,210,6,2,4,2,1
7,239,239,10,2,8,2,1
13,287,287,71,13,58,3,2
8,294,294,3,3,0,1,0
2,335,335,36,30,6,3,2
11,372,372,15,15,0,1,0
1,400,400,91,79,12,2,1
3,469,469,12,12,0,1,0
9,478,478,94,22,72,3,2

11,155,155,10,10,0,1,0
12,170,170,33,33,0,1,0
4,174,174,1,1,0,1,0
9,212,212,2,2,0,1,0
3,219,219,36,18,18,4,3
2,232,232,29,29,0,1,0
13,232,232,32,8,24,3,2
8,294,294,58,46,12,4,3
1,301,301,13,2,11,2,1
5,302,302,49,49,0,1,0
10,360,360,32,26,6,2,1
6,377,377,1,1,0,1,0
0,381,381,32,32,0,1,0
14,429,429,8,1,7,2,1
7,468,468,53,53,0,1,0

5,122,122,1,1,0,1,0
11,140,140,6,6,0,1,0
9,161,161,15,15,0,1,0
16,170,170,2,2,0,1,0
12,204,204,2,2,0,1,0
15,209,209,73,21,52,3,2
7,215,215,32,32,0,1,0
18,235,235,27,27,0,1,0
6,271,271,15,15,0,1,0
10,328,328,29,29,0,1,0
14,340,340,4,4,0,1,0
2,340,340,4,4,0,1,0
4,385,385,7,7,0,1,0
13,399,399,85,85,0,1,0
8,418,418,6,6,0,1,0
0,455,455,22,9,13,2,1
1,474,474,58,20,38,3,2
3,477,477,25,13,12,4,3
17,500,500,2,2,0,1,0

3,102,102,50,50,0,1,0
2,112,112,5,5,0,1,0
1,146,146,6,6,0,1,0
0,174,174,23,3,20,3,2
6,254,254,10,10,0,1,0
9,263,263,30,8,22,3,2
7,306,306,52,52,0,1,0
5,321,321,105,105,0,1,0
10,351,351,13,10,3,2,1
4,438,438,6,6,0,1,0
8,464,464,5,5,0,1,0

2,113,113,5,5,0,1,0
12,114,114,16,1,15,4,3
11,130,130,29,29,0,1,0
1,132,132,2,2,0,1,0
0,147,147,25,15,10,2,1
7,157,157,1,1,0,1,0
14,175,175,11,11,0,1,0
4,199,199,15,15,0,1,0
8,225,225,3,3,0,1,0
5,254,254,22,22,0,1,0
10,266,266,35,9,26,3,2
6,288,288,9,1,8,2,1
9,297,297,37,37,0,1,0
3,327,327,1,1,0,1,0
17,433,433,12,12,0,1,0
13,435,435,89,89,0,1,0
16,475,475,26,11,15,2,1
15,485,485,4,1,3,2,1

5,173,173,21,21,0,1,0
0,194,194,17,11,6,2,1
7,205,205,20,20,0,1,0
3,206,206,45,9,36,2,1
2,231,231,10,1,9,2,1
10,242,242,50,2,48,3,2
4,267,267,14,14,0,1,0
9,295,295,1,1,0,1,0
11,315,315,8,8,0,1,0
6,394,394,5,5,0,1,0
1,418,418,126,76,50,3,2
8,451,451,111,111,0,1,0

1,129,129,1,1,0,1,0
5,148,148,17,17,0,1,0
0,161,161,12,2,10,3,2
7,166,166,24,24,0,1,0
11,180,180,20,20,0,1,0
13,195,195,9,1,8,3,2
10,217,217,4,4,0,1,0
6,249,249,17,17,0,1,0
17,250,250,22,22,0,1,0
15,281,281,20,14,6,3,2
14,305,305,23,14,9,3,2
12,321,321,13,13,0,1,0
18,363,363,43,16,27,2,1
4,373,373,13,13,0,1,0
8,384,384,28,28,0,1,0
3,427,427,1,1,0,1,0
9,484,484,5,5,0,1,0
19,484,484,64,64,0,1,0
2,490,490,1,1,0,1,0
16,493,493,89,48,41,4,3

9,115,115,9,9,0,1,0
8,123,123,10,10,0,1,0
2,152,152,17,17,0,1,0
3,167,167,42,42,0,1,0
6,190,190,38,1,37,4,3
5,316,316,23,23,0,1,0
0,374,374,6,6,0,1,0
10,386,386,56,14,42,3,2
7,426,426,51,24,27,4,3
1,458,458,147,28,119,4,3
4,470,470,7,7,0,1,0

1,125,125,12,4,8,3,2
15,172,172,7,7,0,1,0
14,208,208,17,17,0,1,0
0,238,238,5,5,0,1,0
16,248,248,88,88,0,1,0
8,256,256,7,7,0,1,0
9,281,281,9,9,0,1,0
10,320,320,22,22,0,1,0
3,322,322,5,1,4,2,1
5,336,336,32,32,0,1,0
7,359,359,4,1,3,2,1
12,402,402,6,3,3,2,1
17,404,404,26,26,0,1,0
4,413,413,27,27,0,1,0
2,434,434,82,82,0,1,0
6,469,469,37,37,0,1,0
11,484,484,24,24,0,1,0
13,492,492,52,52,0,1,0

12,162,162,1,1,0,1,0
8,244,244,5,5,0,1,0
0,267,267,31,31,0,1,0
4,276,276,4,4,0,1,0
14,325,325,29,11,18,4,3
13,330,330,47,2,45,2,1
3,360,360,71,71,0,1,0
7,372,372,1,1,0,1,0
1,381,381,49,49,0,1,0
9,415,415,66,39,27,4,3
11,417,417,60,28,32,3,2
5,425,425,16,10,6,3,2
2,436,436,67,67,0,1,0
6,452,452,14,14,0,1,0
15,462,462,57,57,0,1,0
10,494,494,25,9,16,3,2

6,129,129,2,2,0,1,0
2,156,156,66,42,24,2,1
7,252,252,81,81,0,1,0
0,254,254,36,3,33,4,3
1,259,259,36,36,0,1,0
9,336,336,69,11,58,3,2
4,345,345,5,1,4,2,1
3,355,355,1,1,0,1,0
8,368,368,41,16,25,2,1
5,461,461,20,20,0,1,0

2,109,109,10,10,0,1,0
11,137,137,27,27,0,1,0
14,158,158,3,3,0,1,0
15,161,161,13,13,0,1,0
1,162,162,1,1,0,1,0
12,205,205,28,28,0,1,0
8,214,214,25,4,21,2,1
9,214,214,39,39,0,1,0
4,241,241,29,29,0,1,0
7,287,287,21,21,0,1,0
6,304,304,20,20,0,1,0
10,327,327,17,8,9,4,3
3,356,356,33,12,21,4,3
13,359,359,18,8,10,2,1
5,378,378,20,4,16,3,2
0,394,394,33,18,15,4,3

11,108,108,9,9,0,1,0
6,113,113,14,4,10,2,1
1,116,116,3,3,0,1,0
12,185,185,42,42,0,1,0
3,223,223,1,1,0,1,0
4,250,250,8,8,0,1,0
5,297,297,10,7,3,2,1
2,305,305,57,12,45,4,3
8,323,323,18,18,0,1,0
14,380,380,62,62,0,1,0
13,385,385,6,6,0,1,0
7,401,401,41,3,38,2,1
9,435,435,17,17,0,1,0
0,466,466,89,68,21,4,3
10,497,497,64,60,4,2,1

5,108,108,4,4,0,1,0
7,108,108,2,2,0,1,0
6,111,111,4,4,0,1,0
2,120,120,4,4,0,1,0
4,180,180,47,31,16,2,1
8,192,192,27,1,26,3,2
1,272,272,47,47,0,1,0
14,348,348,53,53,0,1,0
9,351,351,19,19,0,1,0
11,395,395,61,47,14,2,1
10,409,409,23,23,0,1,0
12,410,410,5,5,0,1,0
3,432,432,29,19,10,3,2
13,459,459,66,66,0,1,0
0,484,484,36,22,14,2,1

10,142,142,6,6,0,1,0
8,160,160,57,9,48,2,1
0,191,191,21,4,17,2,1
11,192,192,25,25,0,1,0
6,236,236,11,11,0,1,0
9,306,306,15,15,0,1,0
1,322,322,9,1,8,3,2
2,401,401,163,115,48,4,3
5,417,417,12,12,0,1,0
3,438,438,2,2,0,1,0
7,462,462,27,3,24,4,3
4,484,484,74,74,0,1,0

9,130,130,17,17,0,1,0
2,157,157,95,86,9,4,3
8,220,220,7,7,0,1,0
7,224,224,21,21,0,1,0
1,253,253,13,1,12,3,2
3,332,332,8,3,5,2,1
6,355,355,10,4,6,3,2
10,447,447,68,22,46,3,2
5,453,453,34,34,0,1,0
0,455,455,9,9,0,1,0
4,466,466,91,91,0,1,0

4,126,126,1,1,0,1,0
11,158,158,8,1,7,2,1
5,174,174,4,4,0,1,0
8,221,221,16,16,0,1,0
1,363,363,46,46,0,1,0
7,363,363,15,15,0,1,0
9,368,368,15,9,6,2,1
14,391,391,150,51,99,4,3
15,411,411,4,4,0,1,0
6,421,421,22,22,0,1,0
10,422,422,7,7,0,1,0
0,423,423,103,59,44,2,1
13,479,479,12,12,0,1,0
3,489,489,54,13,41,3,2
2,494,494,12,12,0,1,0
12,495,495,91,79,12,4,3

1,100,100,31,31,0,1,0
10,135,135,1,1,0,1,0
11,166,166,14,6,8,2,1
2,226,226,15,12,3,2,1
6,246,246,1,1,0,1,0
9,279,279,121,121,0,1,0
0,292,292,1,1,0,1,0
8,298,298,1,1,0,1,0
5,301,301,19,19,0,1,0
7,320,320,34,18,16,2,1
4,384,384,29,29,0,1,0
12,423,423,33,11,22,3,2
3,449,449,83,44,39,2,1

4,126,126,7,2,5,2,1
5,132,132,13,8,5,2,1
2,163,163,33,33,0,1,0
11,169,169,3,3,0,1,0
0,179,179,20,1,19,2,1
8,256,256,9,3,6,3,2
1,330,330,7,7,0,1,0
13,358,358,6,6,0,1,0
12,398,398,96,72,24,4,3
7,404,404,4,4,0,1,0
9,427,427,82,82,0,1,0
10,457,457,25,12,13,2,1
3,464,464,67,4,63,4,3
6,465,465,27,3,24,2,1
14,486,486,74,74,0,1,0

0,113,113,23,5,18,2,1
5,116,116,2,2,0,1,0
9,140,140,9,9,0,1,0
10,167,167,23,10,13,2,1
8,191,191,32,32,0,1,0
7,345,345,52,26,26,2,1
4,374,374,32,32,0,1,0
3,463,463,141,141,0,1,0
1,467,467,74,28,46,2,1
6,483,483,47,47,0,1,0
2,495,495,17,9,8,2,1

5,122,122,2,2,0,1,0
14,172,172,31,10,21,2,1
10,187,187,7,7,0,1,0
8,228,228,13,13,0,1,0
6,233,233,2,2,0,1,0
0,235,235,17,17,0,1,0
17,243,243,2,2,0,1,0
11,276,276,59,38,21,4,3
7,281,281,16,8,8,3,2
2,338,338,9,2,7,2,1
3,362,362,7,3,4,2,1
4,400,400,35,7,28,3,2
16,409,409,12,3,9,2,1
15,416,416,2,2,0,1,0
1,423,423,22,22,0,1,0
12,425,425,4,4,0,1,0
13,441,441,118,84,34,3,2
9,452,452,122,14,108,4,3

5,154,154,10,10,0,1,0
0,162,162,20,17,3,2,1
1,186,186,7,7,0,1,0
9,237,237,18,18,0,1,0
12,238,238,57,3,54,3,2
10,264,264,13,13,0,1,0
3,271,271,27,27,0,1,0
6,298,298,54,54,0,1,0
11,368,368,28,16,12,4,3
2,378,378,96,36,60,3,2
8,384,384,15,15,0,1,0
4,419,419,53,53,0,1,0
7,419,419,21,7,14,4,3

7,119,119,9,9,0,1,0
12,197,197,4,4,0,1,0
6,199,199,28,28,0,1,0
1,211,211,6,6,0,1,0
8,222,222,5,2,3,2,1
11,230,230,50,26,24,4,3
5,253,253,1,1,0,1,0
3,265,265,62,62,0,1,0
4,295,295,56,14,42,4,3
9,312,312,10,10,0,1,0
2,363,363,22,22,0,1,0
0,401,401,75,75,0,1,0
10,429,429,90,6,84,3,2

5,100,100,4,4,0,1,0
9,117,117,1,1,0,1,0
11,121,121,1,1,0,1,0
7,136,136,20,20,0,1,0
13,144,144,21,9,12,3,2
17,252,252,13,7,6,3,2
12,277,277,24,16,8,2,1
15,281,281,38,38,0,1,0
18,289,289,18,10,8,2,1
0,298,298,50,50,0,1,0
14,305,305,46,46,0,1,0
16,335,335,29,29,0,1,0
10,362,362,24,24,0,1,0
6,395,395,19,8,11,3,2
8,402,402,20,1,19,2,1
1,437,437,6,6,0,1,0
4,462,462,39,39,0,1,0
3,476,476,22,8,14,3,2
2,500,500,13,8,5,2,1

5,110,110,2,2,0,1,0
8,114,114,5,5,0,1,0
10,128,128,1,1,0,1,0
0,201,201,20,20,0,1,0
13,214,214,24,7,17,4,3
14,216,216,91,91,0,1,0
12,243,243,24,24,0,1,0
4,250,250,12,12,0,1,0
7,286,286,32,19,13,2,1
3,309,309,63,63,0,1,0
6,338,338,2,2,0,1,0
2,340,340,56,56,0,1,0
11,393,393,1,1,0,1,0
9,436,436,14,2,12,4,3
1,474,474,23,23,0,1,0

11,129,129,8,8,0,1,0
3,185,185,16,1,15,4,3
6,205,205,39,12,27,2,1
7,206,206,2,2,0,1,0
5,323,323,18,11,7,2,1
9,324,324,41,37,4,2,1
0,388,388,94,77,17,2,1
8,439,439,24,24,0,1,0
4,460,460,114,33,81,3,2
10,467,467,99,39,60,3,2
1,469,469,19,7,12,2,1
2,485,485,41,41,0,1,0

6,105,105,9,9,0,1,0
4,164,164,2,2,0,1,0
10,172,172,12,12,0,1,0
12,173,173,11,1,10,2,1
7,196,196,22,22,0,1,0
2,216,216,1,1,0,1,0
0,218,218,22,22,0,1,0
5,222,222,32,24,8,3,2
8,237,237,12,12,0,1,0
17,253,253,21,21,0,1,0
15,298,298,55,22,33,4,3
11,306,306,5,5,0,1,0
13,312,312,77,68,9,2,1
9,314,314,18,18,0,1,0
3,325,325,10,10,0,1,0
16,375,375,1,1,0,1,0
1,442,442,15,15,0,1,0
14,465,465,54,12,42,3,2

6,135,135,8,2,6,3,2
7,175,175,3,3,0,1,0
1,197,197,43,43,0,1,0
5,204,204,19,14,5,2,1
10,229,229,87,87,0,1,0
2,334,334,20,8,12,4,3
0,368,368,25,4,21,4,3
14,373,373,37,22,15,4,3
11,384,384,1,1,0,1,0
13,442,442,2,2,0,1,0
3,447,447,50,50,0,1,0
12,450,450,39,13,26,2,1
4,461,461,36,36,0,1,0
9,488,488,26,26,0,1,0
8,499,499,41,32,9,4,3

12,116,116,16,16,0,1,0
13,189,189,11,2,9,4,3
4,216,216,14,14,0,1,0
7,221,221,2,2,0,1,0
3,222,222,18,4,14,2,1
0,242,242,1,1,0,1,0
14,334,334,34,24,10,2,1
10,373,373,6,6,0,1,0
5,397,397,12,12,0,1,0
2,401,401,114,3,111,4,3
8,422,422,32,18,14,2,1
9,455,455,87,71,16,3,2
1,463,463,64,64,0,1,0
11,479,479,62,45,17,4,3
6,497,497,46,10,36,2,1

5,134,134,16,4,12,4,3
0,154,154,4,4,0,1,0
10,158,158,7,7,0,1,0
12,217,217,14,14,0,1,0
13,219,219,37,5,32,3,2
11,226,226,6,6,0,1,0
1,231,231,33,33,0,1,0
7,231,231,18,18,0,1,0
4,241,241,22,22,0,1,0
3,300,300,68,14,54,3,2
9,303,303,67,23,44,3,2
6,386,386,36,36,0,1,0
8,400,400,46,22,24,4,3
2,401,401,1,1,0,1,0

7,105,105,9,3,6,3,2
2,154,154,62,53,9,4,3
5,178,178,34,30,4,2,1
6,184,184,18,2,16,2,1
4,241,241,22,22,0,1,0
1,261,261,30,22,8,3,2
3,261,261,5,5,0,1,0
0,328,328,54,32,22,3,2
8,337,337,18,4,14,4,3
10,374,374,15,15,0,1,0
9,490,490,75,75,0,1,0

2,110,110,3,3,0,1,0
13,126,126,4,1,3,2,1
0,162,162,38,38,0,1,0
1,192,192,46,15,31,2,1
11,296,296,16,16,0,1,0
6,308,308,13,8,5,2,1
5,351,351,20,20,0,1,0
9,434,434,63,13,50,3,2
4,447,447,7,7,0,1,0
12,449,449,6,6,0,1,0
8,455,455,10,10,0,1,0
7,465,465,10,2,8,3,2
10,483,483,205,150,55,3,2
3,496,496,42,2,40,2,1

13,110,110,4,4,0,1,0
3,120,120,5,5,0,1,0
4,250,250,99,25,74,3,2
0,285,285,7,7,0,1,0
10,288,288,3,3,0,1,0
2,296,296,31,31,0,1,0
1,320,320,15,5,10,2,1
12,321,321,40,40,0,1,0
6,347,347,16,4,12,4,3
8,348,348,36,22,14,3,2
11,386,386,50,40,10,2,1
14,416,416,70,70,0,1,0
9,465,465,66,36,30,3,2
7,477,477,7,7,0,1,0
5,479,479,13,13,0,1,0

3,104,104,1,1,0,1,0
9,105,105,9,3,6,2,1
6,143,143,21,21,0,1,0
2,162,162,2,2,0,1,0
0,163,163,12,12,0,1,0
1,186,186,19,19,0,1,0
5,256,256,14,14,0,1,0
7,304,304,33,33,0,1,0
16,340,340,1,1,0,1,0
14,354,354,5,5,0,1,0
4,369,369,20,16,4,2,1
10,387,387,123,41,82,3,2
8,408,408,23,23,0,1,0
15,418,418,68,68,0,1,0
13,458,458,39,18,21,2,1
11,483,483,22,9,13,2,1
12,488,488,40,7,33,2,1

1,113,113,2,2,0,1,0
3,121,121,42,28,14,2,1
5,124,124,2,2,0,1,0
11,160,160,10,10,0,1,0
10,161,161,36,13,23,2,1
0,162,162,2,2,0,1,0
6,189,189,36,24,12,2,1
7,252,252,4,1,3,2,1
8,262,262,48,48,0,1,0
2,303,303,61,61,0,1,0
4,313,313,39,39,0,1,0
9,412,412,9,9,0,1,0

10,112,112,52,52,0,1,0
11,154,154,3,3,0,1,0
4,157,157,10,1,9,4,3
12,181,181,4,4,0,1,0
13,187,187,4,4,0,1,0
1,246,246,4,4,0,1,0
8,247,247,8,8,0,1,0
5,291,291,29,29,0,1,0
6,311,311,16,7,9,2,1
14,337,337,9,3,6,3,2
2,365,365,53,53,0,1,0
0,389,389,88,77,11,2,1
9,390,390,54,54,0,1,0
3,443,443,35,35,0,1,0
7,473,473,9,9,0,1,0

9,175,175,23,23,0,1,0
3,217,217,58,58,0,1,0
13,254,254,2,2,0,1,0
12,282,282,73,21,52,3,2
6,293,293,15,15,0,1,0
4,314,314,8,8,0,1,0
0,322,322,6,6,0,1,0
7,340,340,23,3,20,4,3
10,356,356,3,3,0,1,0
8,377,377,13,2,11,3,2
11,414,414,83,78,5,2,1
1,446,446,26,26,0,1,0
5,451,451,40,40,0,1,0
2,464,464,89,89,0,1,0

13,120,120,1,1,0,1,0
7,159,159,8,2,6,3,2
9,164,164,1,1,0,1,0
8,174,174,13,13,0,1,0
10,175,175,10,5,5,2,1
6,179,179,23,14,9,4,3
11,201,201,26,16,10,2,1
14,258,258,11,3,8,3,2
5,270,270,11,5,6,3,2
12,282,282,14,14,0,1,0
0,307,307,24,24,0,1,0
1,352,352,22,22,0,1,0
17,390,390,157,157,0,1,0
3,411,411,12,2,10,2,1
4,419,419,19,19,0,1,0
15,426,426,6,6,0,1,0
2,430,430,57,16,41,2,1
16,436,436,31,23,8,2,1

1,104,104,15,15,0,1,0
5,107,107,3,3,0,1,0
4,131,131,14,14,0,1,0
11,196,196,75,3,72,4,3
8,230,230,6,6,0,1,0
13,243,243,18,18,0,1,0
3,246,246,52,7,45,2,1
12,290,290,14,14,0,1,0
7,301,301,12,12,0,1,0
14,333,333,43,2,41,3,2
6,397,397,19,10,9,4,3
9,414,414,8,8,0,1,0
10,420,420,14,14,0,1,0
2,475,475,30,30,0,1,0
0,477,477,29,29,0,1,0

3,106,106,24,24,0,1,0
7,106,106,5,5,0,1,0
10,110,110,11,3,8,2,1
4,111,111,21,21,0,1,0
9,146,146,8,8,0,1,0
5,183,183,37,32,5,2,1
0,275,275,58,58,0,1,0
1,329,329,13,13,0,1,0
8,403,403,1,1,0,1,0
6,425,425,52,52,0,1,0
2,499,499,112,112,0,1,0

10,119,119,2,2,0,1,0
16,137,137,49,34,15,4,3
3,156,156,5,5,0,1,0
5,165,165,11,4,7,2,1
2,187,187,1,1,0,1,0
6,222,222,1,1,0,1,0
0,236,236,63,13,50,4,3
4,243,243,19,19,0,1,0
12,249,249,20,4,16,3,2
15,259,259,17,14,3,2,1
1,266,266,37,37,0,1,0
14,288,288,33,33,0,1,0
13,360,360,13,13,0,1,0
11,363,363,8,8,0,1,0
7,368,368,6,1,5,2,1
9,405,405,13,13,0,1,0
8,438,438,21,7,14,3,2
17,490,490,21,7,14,3,2

5,131,131,4,4,0,1,0
7,151,151,1,1,0,1,0
11,180,180,14,14,0,1,0
13,189,189,36,14,22,3,2
16,195,195,7,4,3,2,1
9,200,200,9,4,5,2,1
4,210,210,1,1,0,1,0
10,274,274,45,33,12,4,3
2,315,315,48,48,0,1,0
3,326,326,8,8,0,1,0
6,365,365,4,1,3,2,1
0,372,372,21,21,0,1,0
18,375,375,9,2,7,2,1
1,404,404,15,15,0,1,0
15,409,409,41,41,0,1,0
12,451,451,14,14,0,1,0
17,469,469,57,13,44,2,1
8,488,488,46,22,24,4,3
14,496,496,104,22,82,3,2

9,108,108,13,13,0,1,0
7,137,137,13,1,12,4,3
6,152,152,19,19,0,1,0
3,198,198,2,2,0,1,0
4,237,237,11,1,10,2,1
1,269,269,40,40,0,1,0
15,276,276,6,1,5,2,1
14,297,297,35,8,27,2,1
12,348,348,24,24,0,1,0
2,382,382,53,53,0,1,0
11,385,385,38,20,18,3,2
0,409,409,37,11,26,2,1
10,442,442,41,14,27,4,3
13,447,447,87,35,52,4,3
5,469,469,2,2,0,1,0
8,477,477,20,12,8,3,2

0,154,154,41,8,33,2,1
4,245,245,7,7,0,1,0
5,256,256,40,16,24,4,3
2,261,261,1,1,0,1,0
10,290,290,21,12,9,4,3
7,325,325,32,2,30,4,3
8,360,360,18,8,10,2,1
3,403,403,48,28,20,4,3
11,427,427,110,29,81,4,3
1,440,440,56,20,36,4,3
6,480,480,2,2,0,1,0
9,490,490,71,71,0,1,0
12,496,496,43,21,22,3,2

8,162,162,12,12,0,1,0
7,217,217,35,35,0,1,0
5,307,307,6,6,0,1,0
3,314,314,119,119,0,1,0
0,316,316,26,26,0,1,0
11,358,358,6,1,5,2,1
9,411,411,97,31,66,4,3
10,418,418,71,55,16,2,1
2,426,426,1,1,0,1,0
6,463,463,16,16,0,1,0
1,479,479,70,34,36,3,2
4,487,487,44,44,0,1,0

4,110,110,8,8,0,1,0
6,133,133,43,4,39,4,3
0,167,167,5,2,3,2,1
8,188,188,5,1,4,2,1
11,205,205,1,1,0,1,0
7,272,272,6,6,0,1,0
10,295,295,9,4,5,2,1
2,330,330,11,1,10,2,1
1,347,347,21,21,0,1,0
3,365,365,34,34,0,1,0
9,378,378,125,53,72,3,2
12,380,380,93,3,90,4,3
13,435,435,24,24,0,1,0
5,475,475,44,5,39,2,1

13,105,105,32,2,30,3,2
9,114,114,7,7,0,1,0
4,117,117,4,4,0,1,0
11,132,132,4,1,3,2,1
10,149,149,5,5,0,1,0
14,155,155,14,6,8,3,2
1,258,258,7,7,0,1,0
2,295,295,22,22,0,1,0
6,329,329,23,17,6,3,2
3,362,362,17,10,7,2,1
5,362,362,11,11,0,1,0
7,378,378,129,129,0,1,0
8,435,435,16,1,15,4,3
0,441,441,34,7,27,4,3
12,493,493,81,81,0,1,0

7,113,113,11,6,5,2,1
8,131,131,3,3,0,1,0
1,138,138,2,2,0,1,0
5,138,138,5,2,3,2,1
4,139,139,1,1,0,1,0
6,151,151,40,12,28,3,2
10,176,176,2,2,0,1,0
0,193,193,8,8,0,1,0
15,197,197,1,1,0,1,0
12,206,206,28,28,0,1,0
3,228,228,5,5,0,1,0
9,248,248,64,16,48,3,2
11,284,284,57,45,12,2,1
13,290,290,4,4,0,1,0
14,291,291,27,15,12,3,2
2,339,339,67,1,66,4,3

14,109,109,10,6,4,2,1
15,132,132,2,2,0,1,0
2,147,147,19,10,9,4,3
10,152,152,4,4,0,1,0
13,162,162,75,53,22,3,2
1,171,171,40,10,30,3,2
5,176,176,5,5,0,1,0
3,189,189,11,1,10,2,1
0,212,212,13,4,9,4,3
12,270,270,12,12,0,1,0
8,325,325,16,7,9,4,3
6,328,328,5,5,0,1,0
11,344,344,11,11,0,1,0
7,349,349,7,7,0,1,0
4,468,468,50,24,26,3,2
9,494,494,20,15,5,2,1

4,159,159,11,11,0,1,0
8,171,171,16,16,0,1,0
1,178,178,9,3,6,3,2
3,235,235,33,33,0,1,0
9,240,240,27,27,0,1,0
0,244,244,105,102,3,2,1
5,266,266,3,3,0,1,0
10,397,397,53,3,50,2,1
2,398,398,32,17,15,4,3
6,404,404,105,37,68,3,2
7,471,471,17,17,0,1,0

6,108,108,8,5,3,2,1
13,120,120,35,35,0,1,0
11,123,123,13,4,9,3,2
10,132,132,8,1,7,2,1
12,139,139,12,12,0,1,0
18,185,185,22,3,19,2,1
8,191,191,4,1,3,2,1
5,194,194,5,5,0,1,0
0,197,197,2,2,0,1,0
3,219,219,6,6,0,1,0
7,229,229,20,11,9,2,1
15,315,315,24,8,16,2,1
1,349,349,10,7,3,2,1
16,354,354,28,28,0,1,0
4,422,422,73,3,70,3,2
14,484,484,19,6,13,4,3
9,485,485,25,5,20,2,1
17,485,485,14,4,10,2,1
2,490,490,19,19,0,1,0

12,108,108,2,2,0,1,0
15,120,120,19,19,0,1,0
5,124,124,7,7,0,1,0
0,129,129,1,1,0,1,0
7,151,151,1,1,0,1,0
1,170,170,7,7,0,1,0
9,172,172,22,22,0,1,0
8,204,204,20,2,18,2,1
13,208,208,33,33,0,1,0
10,247,247,38,32,6,2,1
4,333,333,10,10,0,1,0
16,351,351,2,2,0,1,0
11,378,378,6,6,0,1,0
2,396,396,46,46,0,1,0
14,439,439,93,33,60,3,2
3,466,466,57,20,37,2,1
6,494,494,49,13,36,4,3

11,117,117,5,1,4,2,1
7,130,130,1,1,0,1,0
3,143,143,4,4,0,1,0
10,159,159,6,6,0,1,0
6,182,182,9,1,8,3,2
2,269,269,5,5,0,1,0
1,272,272,60,46,14,2,1
14,279,279,11,11,0,1,0
8,284,284,4,4,0,1,0
15,311,311,78,78,0,1,0
0,315,315,2,2,0,1,0
12,331,331,31,11,20,3,2
16,359,359,25,25,0,1,0
9,365,365,41,41,0,1,0
5,441,441,88,88,0,1,0
13,447,447,81,40,41,2,1
4,455,455,20,12,8,2,1

10,162,162,14,14,0,1,0
12,172,172,69,69,0,1,0
9,208,208,11,1,10,3,2
4,210,210,78,78,0,1,0
1,231,231,8,8,0,1,0
11,247,247,5,5,0,1,0
7,291,291,1,1,0,1,0
2,327,327,36,36,0,1,0
3,353,353,22,16,6,2,1
8,424,424,24,7,17,2,1
6,462,462,1,1,0,1,0
0,463,463,55,55,0,1,0
13,477,477,42,42,0,1,0
5,482,482,1,1,0,1,0

8,117,117,13,13,0,1,0
15,118,118,10,10,0,1,0
10,132,132,12,2,10,3,2
5,158,158,7,7,0,1,0
13,171,171,2,2,0,1,0
4,176,176,1,1,0,1,0
1,181,181,21,17,4,2,1
6,215,215,7,3,4,2,1
17,250,250,38,24,14,2,1
3,254,254,2,2,0,1,0
9,276,276,4,4,0,1,0
2,301,301,21,13,8,2,1
7,314,314,1,1,0,1,0
14,316,316,19,19,0,1,0
16,328,328,37,1,36,2,1
0,338,338,10,10,0,1,0
11,342,342,60,60,0,1,0
12,398,398,45,45,0,1,0
18,454,454,79,43,36,4,3

10,119,119,36,8,28,3,2
12,131,131,17,17,0,1,0
3,154,154,45,7,38,3,2
5,157,157,5,5,0,1,0
9,186,186,13,2,11,2,1
11,232,232,7,7,0,1,0
4,269,269,3,3,0,1,0
0,270,270,51,22,29,2,1
2,300,300,5,1,4,2,1
7,329,329,29,2,27,2,1
8,350,350,1,1,0,1,0
6,375,375,37,37,0,1,0
1,500,500,80,22,58,3,2

19,100,100,3,3,0,1,0
5,106,106,21,5,16,2,1
17,165,165,1,1,0,1,0
6,184,184,2,2,0,1,0
16,184,184,19,19,0,1,0
12,223,223,12,12,0,1,0
7,228,228,6,6,0,1,0
8,230,230,21,7,14,2,1
14,256,256,11,1,10,4,3
1,270,270,4,1,3,2,1
13,273,273,17,5,12,3,2
9,346,346,37,37,0,1,0
18,386,386,49,49,0,1,0
3,387,387,1,1,0,1,0
4,432,432,42,6,36,3,2
15,463,463,158,158,0,1,0
2,467,467,1,1,0,1,0
0,479,479,19,19,0,1,0
10,489,489,16,8,8,2,1
11,494,494,13,13,0,1,0

0,135,135,21,2,19,4,3
4,171,171,6,3,3,2,1
3,225,225,34,34,0,1,0
7,251,251,3,3,0,1,0
9,273,273,19,10,9,4,3
10,273,273,89,89,0,1,0
8,278,278,27,27,0,1,0
1,384,384,124,67,57,4,3
2,432,432,31,31,0,1,0
5,435,435,37,37,0,1,0
6,449,449,39,18,21,2,1

3,102,102,9,9,0,1,0
2,177,177,46,11,35,4,3
1,192,192,28,7,21,4,3
9,198,198,8,8,0,1,0
0,202,202,12,2,10,3,2
6,206,206,14,10,4,2,1
7,282,282,45,9,36,4,3
11,301,301,34,34,0,1,0
4,334,334,49,49,0,1,0
5,416,416,116,34,82,3,2
10,449,449,8,8,0,1,0
8,492,492,16,16,0,1,0

7,109,109,15,15,0,1,0
9,123,123,1,1,0,1,0
13,158,158,28,28,0,1,0
15,171,171,2,2,0,1,0
12,183,183,5,5,0,1,0
2,202,202,10,10,0,1,0
8,207,207,7,7,0,1,0
4,243,243,7,7,0,1,0
3,289,289,23,8,15,2,1
1,297,297,11,11,0,1,0
11,318,318,3,3,0,1,0
16,344,344,101,11,90,4,3
0,366,366,22,22,0,1,0
18,371,371,34,8,26,3,2
17,380,380,36,24,12,3,2
6,387,387,53,17,36,4,3
14,418,418,8,8,0,1,0
5,443,443,6,6,0,1,0
10,480,480,52,40,12,3,2

9,110,110,1,1,0,1,0
3,203,203,1,1,0,1,0
11,211,211,42,21,21,2,1
12,218,218,2,2,0,1,0
5,232,232,22,22,0,1,0
7,251,251,26,2,24,4,3
4,255,255,45,45,0,1,0
8,259,259,29,29,0,1,0
10,303,303,84,41,43,4,3
0,327,327,117,117,0,1,0
2,383,383,4,1,3,2,1
1,440,440,26,8,18,2,1
6,492,492,1,1,0,1,0

11,120,120,6,6,0,1,0
10,124,124,4,1,3,2,1
2,125,125,7,1,6,3,2
8,135,135,4,4,0,1,0
6,142,142,15,15,0,1,0
17,150,150,17,17,0,1,0
1,178,178,28,28,0,1,0
12,197,197,1,1,0,1,0
3,239,239,8,8,0,1,0
4,245,245,5,5,0,1,0
15,255,255,11,11,0,1,0
18,277,277,15,15,0,1,0
7,297,297,12,12,0,1,0
20,322,322,91,78,13,2,1
0,394,394,10,3,7,2,1
14,404,404,37,37,0,1,0
5,411,411,37,17,20,3,2
9,413,413,6,6,0,1,0
16,422,422,32,10,22,4,3
13,471,471,19,15,4,2,1
19,476,476,25,25,0,1,0

8,182,182,13,13,0,1,0
12,213,213,49,49,0,1,0
10,286,286,5,2,3,2,1
7,330,330,27,3,24,4,3
11,330,330,61,61,0,1,0
1,333,333,39,24,15,2,1
0,388,388,88,16,72,3,2
6,389,389,48,4,44,2,1
9,421,421,2,2,0,1,0
2,428,428,66,45,21,4,3
5,458,458,86,86,0,1,0
4,488,488,6,6,0,1,0
3,497,497,1,1,0,1,0

13,183,183,1,1,0,1,0
9,194,194,2,2,0,1,0
15,244,244,29,10,19,2,1
16,279,279,35,2,33,3,2
1,280,280,25,25,0,1,0
14,300,300,14,8,6,2,1
2,324,324,1,1,0,1,0
11,330,330,45,5,40,2,1
4,335,335,1,1,0,1,0
6,348,348,1,1,0,1,0
5,374,374,41,41,0,1,0
12,397,397,2,2,0,1,0
7,446,446,24,24,0,1,0
0,458,458,4,1,3,2,1
8,465,465,192,121,71,4,3
10,497,497,137,13,124,4,3
3,499,499,5,5,0,1,0

4,110,110,1,1,0,1,0
7,112,112,8,8,0,1,0
16,118,118,12,4,8,3,2
0,124,124,1,1,0,1,0
15,171,171,28,22,6,2,1
2,174,174,12,12,0,1,0
3,201,201,6,6,0,1,0
10,222,222,57,11,46,2,1
9,332,332,1,1,0,1,0
5,338,338,3,3,0,1,0
11,386,386,2,2,0,1,0
8,388,388,57,57,0,1,0
1,393,393,14,14,0,1,0
17,397,397,48,48,0,1,0
12,400,400,46,46,0,1,0
18,436,436,7,7,0,1,0
14,475,475,89,89,0,1,0
13,492,492,5,2,3,2,1
6,498,498,29,29,0,1,0

13,138,138,1,1,0,1,0
6,140,140,3,3,0,1,0
5,148,148,6,6,0,1,0
0,162,162,20,8,12,3,2
2,201,201,10,10,0,1,0
9,225,225,20,20,0,1,0
4,252,252,5,5,0,1,0
12,257,257,3,3,0,1,0
3,302,302,9,5,4,2,1
16,311,311,1,1,0,1,0
7,349,349,7,1,6,3,2
17,367,367,59,59,0,1,0
14,372,372,31,31,0,1,0
1,376,376,41,29,12,4,3
8,424,424,74,19,55,4,3
11,445,445,78,5,73,4,3
15,468,468,124,109,15,4,3
10,472,472,11,11,0,1,0

1,119,119,21,21,0,1,0
9,138,138,1,1,0,1,0
14,150,150,2,2,0,1,0
12,167,167,1,1,0,1,0
2,192,192,4,4,0,1,0
3,204,204,26,26,0,1,0
7,233,233,1,1,0,1,0
17,237,237,73,73,0,1,0
11,251,251,32,10,22,3,2
10,280,280,4,4,0,1,0
6,306,306,13,5,8,3,2
8,340,340,15,15,0,1,0
15,350,350,25,25,0,1,0
16,384,384,14,2,12,2,1
0,386,386,28,1,27,4,3
4,425,425,24,10,14,2,1
13,474,474,71,64,7,2,1
5,500,500,68,12,56,3,2

8,133,133,21,21,0,1,0
1,146,146,11,5,6,2,1
4,166,166,5,5,0,1,0
7,181,181,10,2,8,2,1
9,198,198,1,1,0,1,0
2,228,228,8,8,0,1,0
11,251,251,18,7,11,2,1
14,284,284,44,44,0,1,0
12,301,301,9,9,0,1,0
6,326,326,18,18,0,1,0
5,340,340,39,10,29,2,1
3,343,343,37,37,0,1,0
15,453,453,40,40,0,1,0
10,464,464,64,37,27,4,3
0,471,471,34,34,0,1,0
13,489,489,111,25,86,4,3

2,177,177,15,12,3,2,1
1,200,200,30,30,0,1,0
0,252,252,1,1,0,1,0
9,269,269,46,46,0,1,0
3,270,270,11,11,0,1,0
11,271,271,27,15,12,4,3
5,328,328,51,12,39,4,3
13,382,382,38,38,0,1,0
4,414,414,64,19,45,4,3
10,419,419,33,13,20,3,2
8,420,420,18,18,0,1,0
15,424,424,2,2,0,1,0
12,446,446,105,39,66,4,3
14,446,446,9,2,7,2,1
6,459,459,24,16,8,3,2
7,463,463,8,8,0,1,0

10,138,138,5,5,0,1,0
5,166,166,26,10,16,3,2
9,248,248,1,1,0,1,0
2,268,268,74,74,0,1,0
12,281,281,36,36,0,1,0
6,311,311,59,59,0,1,0
3,332,332,12,9,3,2,1
0,356,356,30,30,0,1,0
7,381,381,2,2,0,1,0
8,383,383,106,106,0,1,0
4,385,385,28,28,0,1,0
11,429,429,31,8,23,2,1
1,469,469,35,35,0,1,0

4,123,123,7,7,0,1,0
15,130,130,2,2,0,1,0
1,138,138,1,1,0,1,0
14,150,150,26,8,18,4,3
17,162,162,5,2,3,2,1
12,194,194,14,14,0,1,0
6,282,282,3,3,0,1,0
10,284,284,17,17,0,1,0
9,318,318,1,1,0,1,0
13,330,330,20,20,0,1,0
16,331,331,39,12,27,4,3
2,333,333,44,4,40,4,3
11,366,366,91,91,0,1,0
8,367,367,16,16,0,1,0
0,420,420,34,7,27,4,3
7,474,474,9,3,6,2,1
5,475,475,81,81,0,1,0
3,489,489,57,7,50,3,2

1,121,121,5,1,4,2,1
2,128,128,1,1,0,1,0
3,139,139,1,1,0,1,0
6,160,160,2,2,0,1,0
4,247,247,26,26,0,1,0
10,256,256,48,48,0,1,0
11,332,332,37,37,0,1,0
9,355,355,26,7,19,2,1
0,377,377,18,18,0,1,0
7,386,386,108,26,82,3,2
14,416,416,23,12,11,2,1
13,429,429,58,52,6,3,2
12,455,455,12,12,0,1,0
8,477,477,57,57,0,1,0
5,486,486,97,97,0,1,0

14,125,125,1,1,0,1,0
6,134,134,18,18,0,1,0
3,164,164,4,4,0,1,0
11,194,194,35,3,32,2,1
1,206,206,15,6,9,2,1
9,249,249,35,6,29,2,1
15,259,259,31,31,0,1,0
16,347,347,37,3,34,2,1
5,363,363,34,34,0,1,0
12,375,375,28,28,0,1,0
4,401,401,49,49,0,1,0
10,427,427,51,8,43,2,1
0,441,441,1,1,0,1,0
13,450,450,48,48,0,1,0
7,455,455,21,3,18,3,2
2,479,479,13,7,6,3,2
8,499,499,19,19,0,1,0

9,100,100,3,3,0,1,0
7,108,108,1,1,0,1,0
5,132,132,2,2,0,1,0
10,135,135,8,5,3,2,1
6,141,141,8,2,6,3,2
11,158,158,4,4,0,1,0
14,159,159,6,6,0,1,0
16,200,200,16,16,0,1,0
1,206,206,6,6,0,1,0
8,213,213,21,21,0,1,0
15,217,217,14,2,12,4,3
13,218,218,35,3,32,2,1
4,305,305,58,1,57,4,3
2,350,350,11,2,9,4,3
12,412,412,120,120,0,1,0
0,435,435,1,1,0,1,0
3,488,488,119,119,0,1,0

9,127,127,5,5,0,1,0
0,163,163,18,9,9,4,3
13,228,228,45,37,8,3,2
1,301,301,21,21,0,1,0
14,315,315,25,6,19,2,1
5,337,337,1,1,0,1,0
10,346,346,14,2,12,4,3
3,376,376,8,8,0,1,0
15,386,386,85,76,9,2,1
4,401,401,20,13,7,2,1
7,410,410,52,52,0,1,0
2,429,429,112,13,99,4,3
8,442,442,19,11,8,2,1
6,447,447,7,7,0,1,0
12,451,451,46,46,0,1,0
11,500,500,16,16,0,1,0

11,124,124,4,4,0,1,0
10,130,130,16,16,0,1,0
13,174,174,17,17,0,1,0
1,198,198,5,5,0,1,0
5,225,225,41,41,0,1,0
4,240,240,4,4,0,1,0
8,280,280,7,7,0,1,0
7,285,285,78,26,52,3,2
9,288,288,75,37,38,2,1
2,298,298,3,3,0,1,0
3,301,301,11,4,7,2,1
0,313,313,27,27,0,1,0
6,352,352,25,25,0,1,0
14,361,361,12,2,10,4,3
12,376,376,53,53,0,1,0

4,116,116,33,33,0,1,0
2,146,146,8,5,3,2,1
1,216,216,2,2,0,1,0
8,216,216,26,26,0,1,0
9,225,225,1,1,0,1,0
0,255,255,13,13,0,1,0
12,256,256,22,3,19,2,1
6,262,262,33,33,0,1,0
11,275,275,17,3,14,2,1
15,317,317,125,53,72,4,3
10,335,335,41,11,30,4,3
7,336,336,17,17,0,1,0
5,372,372,1,1,0,1,0
13,423,423,6,6,0,1,0
14,426,426,12,1,11,3,2
3,499,499,1,1,0,1,0

3,137,137,52,10,42,4,3
2,230,230,4,4,0,1,0
5,250,250,15,3,12,2,1
6,253,253,29,14,15,2,1
0,268,268,75,75,0,1,0
10,294,294,6,6,0,1,0
4,336,336,23,23,0,1,0
9,391,391,15,15,0,1,0
1,426,426,10,3,7,2,1
7,439,439,35,7,28,3,2
8,477,477,157,129,28,3,2

8,102,102,2,2,0,1,0
9,126,126,22,7,15,4,3
5,171,171,41,41,0,1,0
3,196,196,42,42,0,1,0
0,210,210,34,34,0,1,0
11,249,249,21,21,0,1,0
1,280,280,10,10,0,1,0
4,340,340,65,65,0,1,0
2,373,373,37,37,0,1,0
7,381,381,56,56,0,1,0
10,461,461,7,7,0,1,0
6,495,495,13,4,9,2,1

6,137,137,25,25,0,1,0
4,172,172,4,4,0,1,0
5,189,189,1,1,0,1,0
9,264,264,9,3,6,2,1
3,292,292,98,59,39,4,3
0,301,301,4,4,0,1,0
2,324,324,127,109,18,3,2
1,349,349,103,36,67,4,3
8,396,396,39,39,0,1,0
7,402,402,15,15,0,1,0

5,110,110,17,2,15,2,1
2,132,132,11,7,4,2,1
11,156,156,10,10,0,1,0
15,184,184,13,13,0,1,0
1,193,193,9,6,3,2,1
0,220,220,9,9,0,1,0
9,234,234,38,38,0,1,0
8,248,248,22,22,0,1,0
6,265,265,1,1,0,1,0
12,307,307,38,38,0,1,0
10,314,314,30,21,9,4,3
4,345,345,11,11,0,1,0
14,361,361,46,4,42,4,3
7,402,402,37,1,36,3,2
13,464,464,33,33,0,1,0
3,500,500,81,33,48,4,3

1,116,116,1,1,0,1,0
9,202,202,11,2,9,4,3
4,249,249,60,39,21,2,1
7,271,271,20,3,17,2,1
0,342,342,90,78,12,3,2
10,350,350,19,19,0,1,0
8,363,363,3,3,0,1,0
6,439,439,1,1,0,1,0
2,454,454,138,114,24,2,1
5,486,486,135,72,63,4,3
3,496,496,62,4,58,3,2

14,100,100,17,17,0,1,0
0,112,112,12,8,4,2,1
15,164,164,28,28,0,1,0
9,168,168,6,6,0,1,0
3,186,186,1,1,0,1,0
4,197,197,17,2,15,4,3
7,201,201,15,15,0,1,0
11,235,235,1,1,0,1,0
10,268,268,14,14,0,1,0
13,299,299,19,19,0,1,0
1,301,301,12,4,8,2,1
8,323,323,27,27,0,1,0
5,372,372,16,11,5,2,1
2,389,389,34,26,8,2,1
12,415,415,74,74,0,1,0
6,454,454,63,47,16,3,2
16,478,478,35,21,14,3,2

3,138,138,33,18,15,4,3
6,150,150,2,2,0,1,0
14,180,180,29,29,0,1,0
4,209,209,33,33,0,1,0
2,224,224,1,1,0,1,0
9,226,226,14,14,0,1,0
5,228,228,6,6,0,1,0
11,260,260,17,7,10,2,1
1,268,268,32,9,23,2,1
12,314,314,43,43,0,1,0
13,324,324,34,34,0,1,0
15,389,389,45,45,0,1,0
7,392,392,28,14,14,3,2
10,398,398,27,18,9,4,3
0,418,418,20,17,3,2,1
8,474,474,10,10,0,1,0

11,140,140,13,1,12,3,2
3,151,151,12,7,5,2,1
2,208,208,12,12,0,1,0
5,251,251,3,3,0,1,0
10,289,289,1,1,0,1,0
0,298,298,105,105,0,1,0
1,317,317,41,41,0,1,0
7,337,337,103,93,10,2,1
9,355,355,41,9,32,3,2
6,367,367,45,13,32,3,2
8,416,416,24,4,20,3,2
4,447,447,37,21,16,3,2

11,156,156,1,1,0,1,0
8,178,178,35,24,11,2,1
15,203,203,85,85,0,1,0
9,219,219,16,16,0,1,0
0,231,231,7,7,0,1,0
1,269,269,5,5,0,1,0
2,334,334,4,4,0,1,0
7,357,357,65,65,0,1,0
3,376,376,30,3,27,3,2
13,404,404,40,40,0,1,0
14,423,423,10,10,0,1,0
4,433,433,5,5,0,1,0
10,437,437,10,10,0,1,0
12,438,438,28,1,27,2,1
5,473,473,42,11,31,4,3
6,500,500,41,5,36,2,1

17,171,171,26,26,0,1,0
9,174,174,1,1,0,1,0
6,185,185,11,5,6,2,1
14,193,193,14,8,6,2,1
15,219,219,4,4,0,1,0
1,275,275,1,1,0,1,0
10,280,280,37,19,18,3,2
5,297,297,49,49,0,1,0
12,306,306,32,32,0,1,0
11,319,319,33,6,27,2,1
13,368,368,6,3,3,2,1
8,376,376,12,12,0,1,0
16,413,413,104,104,0,1,0
2,414,414,32,13,19,2,1
3,461,461,47,29,18,2,1
0,469,469,1,1,0,1,0
7,473,473,1,1,0,1,0
4,489,489,59,59,0,1,0

12,114,114,7,7,0,1,0
14,128,128,36,14,22,3,2
3,211,211,6,6,0,1,0
10,228,228,1,1,0,1,0
13,236,236,44,44,0,1,0
0,243,243,23,3,20,4,3
8,280,280,1,1,0,1,0
6,284,284,31,1,30,3,2
9,292,292,49,49,0,1,0
5,307,307,44,44,0,1,0
7,318,318,16,8,8,2,1
1,319,319,1,1,0,1,0
2,355,355,70,70,0,1,0
4,432,432,32,32,0,1,0
11,447,447,5,5,0,1,0

9,108,108,25,16,9,4,3
8,125,125,9,9,0,1,0
0,135,135,10,10,0,1,0
7,137,137,13,7,6,3,2
3,181,181,46,7,39,4,3
10,250,250,32,32,0,1,0
2,267,267,11,11,0,1,0
5,299,299,2,2,0,1,0
1,436,436,8,2,6,2,1
4,473,473,148,106,42,2,1
6,475,475,31,31,0,1,0
11,480,480,57,40,17,2,1

5,112,112,6,6,0,1,0
8,114,114,2,2,0,1,0
4,141,141,1,1,0,1,0
3,154,154,4,4,0,1,0
2,164,164,16,7,9,2,1
7,193,193,1,1,0,1,0
0,194,194,14,14,0,1,0
19,203,203,30,22,8,3,2
12,209,209,14,5,9,2,1
1,237,237,16,16,0,1,0
10,264,264,22,13,9,3,2
13,282,282,74,47,27,4,3
6,289,289,45,45,0,1,0
15,289,289,12,12,0,1,0
11,326,326,9,9,0,1,0
16,375,375,17,17,0,1,0
14,377,377,13,3,10,4,3
17,384,384,15,7,8,3,2
9,438,438,10,3,7,2,1
18,462,462,65,65,0,1,0

0,129,129,3,3,0,1,0
16,157,157,22,22,0,1,0
5,176,176,3,3,0,1,0
10,180,180,12,12,0,1,0
14,183,183,19,19,0,1,0
3,200,200,22,7,15,4,3
11,206,206,27,15,12,2,1
6,236,236,1,1,0,1,0
2,245,245,11,11,0,1,0
12,279,279,29,29,0,1,0
13,293,293,10,10,0,1,0
1,319,319,10,6,4,2,1
4,372,372,1,1,0,1,0
9,378,378,90,56,34,2,1
15,381,381,47,47,0,1,0
17,422,422,33,15,18,2,1
8,470,470,48,6,42,3,2
7,476,476,30,9,21,4,3

2,171,171,64,21,43,4,3
11,171,171,28,19,9,4,3
3,257,257,39,23,16,3,2
8,278,278,34,15,19,2,1
6,282,282,44,6,38,3,2
7,304,304,49,49,0,1,0
4,328,328,2,2,0,1,0
0,388,388,18,18,0,1,0
1,407,407,2,2,0,1,0
12,424,424,16,6,10,3,2
9,442,442,16,5,11,2,1
10,468,468,16,16,0,1,0
5,472,472,56,7,49,4,3

8,148,148,4,4,0,1,0
4,149,149,12,12,0,1,0
1,179,179,9,9,0,1,0
0,185,185,18,18,0,1,0
13,230,230,3,3,0,1,0
10,248,248,20,8,12,4,3
12,298,298,19,19,0,1,0
11,328,328,54,54,0,1,0
14,328,328,14,10,4,2,1
2,401,401,4,4,0,1,0
5,412,412,23,23,0,1,0
15,416,416,131,131,0,1,0
6,419,419,79,79,0,1,0
7,431,431,38,13,25,2,1
3,439,439,45,45,0,1,0
9,485,485,15,2,13,2,1

11,186,186,46,30,16,3,2
3,195,195,4,1,3,2,1
8,216,216,7,7,0,1,0
1,230,230,9,9,0,1,0
10,249,249,21,14,7,2,1
13,252,252,13,13,0,1,0
15,264,264,17,17,0,1,0
14,277,277,15,5,10,2,1
0,317,317,32,14,18,4,3
2,322,322,54,54,0,1,0
12,329,329,64,64,0,1,0
9,346,346,15,15,0,1,0
4,384,384,40,40,0,1,0
7,394,394,33,33,0,1,0
16,424,424,6,1,5,2,1
6,492,492,6,6,0,1,0
5,497,497,49,31,18,4,3

3,114,114,1,1,0,1,0
9,117,117,3,3,0,1,0
13,153,153,13,13,0,1,0
14,216,216,13,8,5,2,1
0,250,250,3,3,0,1,0
16,296,296,32,14,18,3,2
4,302,302,33,33,0,1,0
1,303,303,19,13,6,2,1
17,313,313,54,54,0,1,0
7,336,336,40,40,0,1,0
8,344,344,36,25,11,2,1
5,362,362,61,61,0,1,0
15,364,364,8,8,0,1,0
2,381,381,8,1,7,2,1
12,386,386,37,2,35,2,1
10,442,442,15,6,9,4,3
6,459,459,16,16,0,1,0
11,482,482,80,80,0,1,0

4,124,124,21,3,18,2,1
10,133,133,17,4,13,2,1
7,141,141,14,6,8,2,1
9,146,146,35,8,27,4,3
1,186,186,7,7,0,1,0
3,237,237,23,23,0,1,0
5,245,245,46,46,0,1,0
0,328,328,37,29,8,3,2
2,375,375,36,36,0,1,0
11,394,394,42,42,0,1,0
12,442,442,5,5,0,1,0
6,448,448,47,47,0,1,0
8,467,467,12,2,10,3,2

4,118,118,12,12,0,1,0
3,158,158,44,44,0,1,0
6,181,181,5,5,0,1,0
2,187,187,2,2,0,1,0
16,220,220,15,2,13,2,1
9,227,227,4,1,3,2,1
12,241,241,25,4,21,2,1
13,263,263,40,40,0,1,0
7,270,270,1,1,0,1,0
5,291,291,17,8,9,4,3
0,332,332,11,3,8,3,2
10,353,353,8,8,0,1,0
14,373,373,38,29,9,4,3
15,427,427,16,7,9,4,3
11,429,429,96,96,0,1,0
8,446,446,38,23,15,3,2
1,489,489,42,42,0,1,0

4,116,116,1,1,0,1,0
15,159,159,4,4,0,1,0
6,174,174,8,2,6,2,1
5,184,184,1,1,0,1,0
14,190,190,19,19,0,1,0
17,209,209,20,20,0,1,0
7,227,227,3,3,0,1,0
16,288,288,33,33,0,1,0
0,309,309,90,43,47,2,1
10,350,350,21,3,18,4,3
12,353,353,42,10,32,2,1
2,395,395,14,6,8,2,1
13,395,395,85,6,79,3,2
3,411,411,23,6,17,2,1
1,419,419,2,2,0,1,0
8,446,446,52,52,0,1,0
11,477,477,22,22,0,1,0
9,500,500,32,32,0,1,0

5,128,128,1,1,0,1,0
8,133,133,25,11,14,2,1
11,155,155,11,11,0,1,0
7,191,191,14,1,13,2,1
10,214,214,11,1,10,3,2
4,216,216,5,5,0,1,0
6,276,276,13,13,0,1,0
2,281,281,81,67,14,2,1
0,326,326,27,27,0,1,0
1,336,336,54,2,52,3,2
12,393,393,13,13,0,1,0
9,395,395,22,22,0,1,0
13,413,413,91,54,37,4,3
3,422,422,9,6,3,2,1
14,481,481,43,32,11,2,1

6,131,131,1,1,0,1,0
0,149,149,22,22,0,1,0
4,179,179,1,1,0,1,0
10,224,224,2,2,0,1,0
5,246,246,34,34,0,1,0
7,267,267,81,81,0,1,0
1,269,269,6,6,0,1,0
3,277,277,1,1,0,1,0
8,277,277,6,6,0,1,0
13,360,360,28,28,0,1,0
12,378,378,33,6,27,4,3
11,422,422,19,4,15,4,3
15,439,439,45,45,0,1,0
9,469,469,71,71,0,1,0
2,479,479,25,17,8,2,1
14,495,495,115,103,12,4,3

5,120,120,15,6,9,2,1
3,122,122,33,33,0,1,0
7,140,140,31,22,9,4,3
4,177,177,43,43,0,1,0
2,197,197,40,1,39,2,1
6,205,205,3,3,0,1,0
1,357,357,80,30,50,2,1
9,365,365,22,14,8,3,2
8,372,372,3,3,0,1,0
0,422,422,4,4,0,1,0
10,433,433,19,19,0,1,0

4,112,112,12,4,8,2,1
3,131,131,4,1,3,2,1
6,140,140,3,3,0,1,0
9,146,146,13,3,10,3,2
0,149,149,32,32,0,1,0
1,157,157,6,1,5,2,1
2,192,192,19,10,9,4,3
5,235,235,19,13,6,3,2
12,237,237,8,5,3,2,1
14,260,260,83,29,54,4,3
7,289,289,32,32,0,1,0
10,345,345,11,11,0,1,0
13,348,348,7,2,5,2,1
8,352,352,72,61,11,2,1
11,366,366,4,4,0,1,0

9,137,137,8,8,0,1,0
11,159,159,34,16,18,4,3
8,206,206,48,41,7,2,1
6,235,235,21,21,0,1,0
4,240,240,20,20,0,1,0
10,262,262,1,1,0,1,0
2,273,273,5,5,0,1,0
3,301,301,71,53,18,3,2
1,347,347,72,11,61,4,3
7,428,428,35,15,20,3,2
12,462,462,11,1,10,2,1
0,466,466,13,4,9,4,3
13,477,477,48,48,0,1,0
5,491,491,20,20,0,1,0

7,173,173,58,58,0,1,0
4,175,175,6,6,0,1,0
1,199,199,3,3,0,1,0
12,299,299,50,50,0,1,0
0,308,308,24,5,19,2,1
10,313,313,50,50,0,1,0
2,330,330,2,2,0,1,0
6,331,331,5,2,3,2,1
13,358,358,20,2,18,3,2
14,375,375,6,6,0,1,0
8,376,376,56,56,0,1,0
3,409,409,16,16,0,1,0
11,451,451,10,10,0,1,0
9,476,476,67,67,0,1,0
5,483,483,88,6,82,3,2

1,129,129,16,16,0,1,0
11,140,140,1,1,0,1,0
15,141,141,36,17,19,2,1
8,172,172,2,2,0,1,0
7,180,180,10,10,0,1,0
0,185,185,9,9,0,1,0
4,196,196,42,42,0,1,0
12,286,286,29,29,0,1,0
6,334,334,4,4,0,1,0
5,375,375,49,49,0,1,0
3,385,385,39,9,30,4,3
14,385,385,5,5,0,1,0
2,427,427,3,3,0,1,0
13,451,451,73,63,10,2,1
9,461,461,31,24,7,2,1
10,496,496,52,6,46,2,1

4,132,132,15,15,0,1,0
2,171,171,24,24,0,1,0
6,195,195,26,8,18,2,1
10,196,196,17,1,16,3,2
0,201,201,18,5,13,2,1
7,206,206,13,13,0,1,0
5,209,209,16,16,0,1,0
9,312,312,11,1,10,2,1
1,423,423,157,7,150,4,3
3,436,436,44,44,0,1,0
8,487,487,104,32,72,4,3

9,137,137,2,2,0,1,0
14,143,143,34,34,0,1,0
17,158,158,25,5,20,2,1
2,159,159,1,1,0,1,0
6,165,165,5,5,0,1,0
12,212,212,15,1,14,3,2
3,241,241,69,35,34,2,1
1,244,244,1,1,0,1,0
18,260,260,21,6,15,4,3
16,304,304,22,4,18,2,1
4,332,332,5,1,4,2,1
13,349,349,18,18,0,1,0
10,373,373,58,4,54,3,2
0,392,392,20,20,0,1,0
8,459,459,1,1,0,1,0
5,460,460,16,16,0,1,0
11,477,477,45,45,0,1,0
7,488,488,3,3,0,1,0
15,498,498,21,21,0,1,0

11,117,117,7,7,0,1,0
16,243,243,81,81,0,1,0
1,245,245,64,64,0,1,0
3,282,282,15,5,10,2,1
10,282,282,2,2,0,1,0
15,304,304,35,35,0,1,0
14,319,319,32,22,10,2,1
9,352,352,22,22,0,1,0
4,358,358,44,12,32,2,1
7,360,360,1,1,0,1,0
5,410,410,15,15,0,1,0
0,418,418,12,12,0,1,0
8,420,420,3,3,0,1,0
12,430,430,16,16,0,1,0
2,437,437,24,8,16,3,2
13,456,456,30,15,15,4,3
6,490,490,35,35,0,1,0

10,100,100,1,1,0,1,0
4,113,113,25,1,24,4,3
7,119,119,6,1,5,2,1
6,135,135,28,28,0,1,0
2,266,266,35,13,22,3,2
8,269,269,13,5,8,3,2
5,300,300,28,28,0,1,0
3,335,335,69,69,0,1,0
11,358,358,3,3,0,1,0
1,399,399,18,18,0,1,0
0,448,448,47,29,18,3,2
9,465,465,143,57,86,3,2

5,125,125,28,10,18,2,1
10,167,167,15,15,0,1,0
7,210,210,1,1,0,1,0
6,215,215,1,1,0,1,0
1,223,223,5,5,0,1,0
3,247,247,9,6,3,2,1
13,319,319,10,10,0,1,0
11,321,321,14,14,0,1,0
4,322,322,73,26,47,2,1
0,325,325,10,7,3,2,1
14,372,372,52,52,0,1,0
12,377,377,75,66,9,2,1
9,413,413,35,29,6,2,1
8,466,466,70,70,0,1,0
2,467,467,1,1,0,1,0
15,485,485,58,58,0,1,0

10,190,190,2,2,0,1,0
8,283,283,64,34,30,4,3
5,356,356,21,15,6,2,1
1,359,359,26,26,0,1,0
11,372,372,56,56,0,1,0
0,381,381,21,21,0,1,0
9,417,417,54,44,10,3,2
7,426,426,29,5,24,3,2
3,433,433,64,8,56,3,2
4,462,462,51,17,34,2,1
2,479,479,151,103,48,3,2
6,488,488,34,34,0,1,0

6,263,263,1,1,0,1,0
14,265,265,29,29,0,1,0
12,268,268,8,8,0,1,0
7,269,269,25,25,0,1,0
18,293,293,42,14,28,2,1
11,299,299,35,35,0,1,0
5,319,319,12,3,9,2,1
13,363,363,67,52,15,2,1
1,365,365,1,1,0,1,0
16,383,383,14,14,0,1,0
4,384,384,5,5,0,1,0
9,391,391,33,33,0,1,0
10,422,422,1,1,0,1,0
3,446,446,71,71,0,1,0
2,452,452,58,34,24,4,3
8,463,463,14,2,12,3,2
17,474,474,39,39,0,1,0
15,484,484,60,60,0,1,0
0,496,496,15,5,10,3,2

13,109,109,1,1,0,1,0
5,121,121,1,1,0,1,0
10,127,127,9,6,3,2,1
4,166,166,21,21,0,1,0
11,179,179,7,2,5,2,1
1,214,214,9,9,0,1,0
6,219,219,33,33,0,1,0
9,261,261,54,24,30,2,1
0,285,285,61,61,0,1,0
2,368,368,4,4,0,1,0
3,382,382,58,34,24,4,3
7,396,396,133,67,66,4,3
8,435,435,4,1,3,2,1
12,455,455,20,8,12,4,3

1,178,178,34,2,32,2,1
13,184,184,1,1,0,1,0
6,186,186,17,5,12,2,1
8,220,220,25,3,22,2,1
3,311,311,12,12,0,1,0
12,316,316,113,56,57,4,3
0,340,340,25,25,0,1,0
9,356,356,34,22,12,3,2
11,377,377,22,22,0,1,0
10,400,400,21,21,0,1,0
2,416,416,79,61,18,2,1
4,427,427,37,3,34,2,1
14,491,491,13,13,0,1,0
5,499,499,9,9,0,1,0
7,500,500,6,6,0,1,0

3,109,109,12,12,0,1,0
11,134,134,9,3,6,2,1
2,171,171,25,13,12,2,1
10,222,222,32,32,0,1,0
9,232,232,35,15,20,3,2
12,249,249,34,34,0,1,0
5,260,260,31,19,12,3,2
8,282,282,30,3,27,4,3
7,290,290,23,3,20,3,2
1,308,308,48,48,0,1,0
0,335,335,50,50,0,1,0
4,439,439,10,1,9,2,1
6,462,462,14,14,0,1,0

14,149,149,22,18,4,2,1
13,172,172,31,31,0,1,0
5,188,188,27,12,15,2,1
11,224,224,11,1,10,3,2
2,300,300,19,13,6,2,1
12,321,321,50,50,0,1,0
0,369,369,38,24,14,3,2
9,372,372,34,31,3,2,1
1,375,375,7,1,6,2,1
4,409,409,52,11,41,4,3
10,427,427,8,8,0,1,0
8,436,436,40,40,0,1,0
6,442,442,30,10,20,2,1
15,452,452,31,10,21,4,3
7,464,464,23,23,0,1,0
3,467,467,17,5,12,2,1

1,101,101,12,12,0,1,0
14,141,141,14,3,11,3,2
0,154,154,26,12,14,2,1
11,181,181,3,3,0,1,0
9,206,206,5,5,0,1,0
12,241,241,36,13,23,2,1
3,253,253,2,2,0,1,0
5,315,315,27,27,0,1,0
2,323,323,34,22,12,4,3
16,376,376,72,46,26,3,2
7,385,385,1,1,0,1,0
6,414,414,13,8,5,2,1
15,415,415,16,16,0,1,0
8,432,432,48,48,0,1,0
4,435,435,21,3,18,4,3
13,483,483,51,26,25,2,1
10,486,486,55,55,0,1,0

0,102,102,1,1,0,1,0
2,102,102,5,5,0,1,0
3,118,118,1,1,0,1,0
7,119,119,5,2,3,2,1
8,132,132,34,25,9,4,3
11,139,139,1,1,0,1,0
4,152,152,19,1,18,4,3
13,165,165,24,6,18,2,1
15,225,225,15,7,8,2,1
5,237,237,14,1,13,2,1
9,284,284,30,30,0,1,0
14,351,351,109,9,100,3,2
1,373,373,16,16,0,1,0
12,376,376,26,8,18,4,3
10,433,433,6,6,0,1,0
6,436,436,49,49,0,1,0

3,115,115,20,20,0,1,0
4,145,145,10,10,0,1,0
5,192,192,70,4,66,4,3
13,225,225,6,1,5,2,1
11,227,227,4,4,0,1,0
1,242,242,5,2,3,2,1
0,267,267,10,10,0,1,0
14,278,278,19,16,3,2,1
15,329,329,49,49,0,1,0
12,371,371,116,2,114,4,3
10,375,375,21,3,18,3,2
2,392,392,1,1,0,1,0
8,396,396,10,2,8,2,1
7,413,413,1,1,0,1,0
6,415,415,2,2,0,1,0
9,465,465,39,39,0,1,0

14,146,146,5,5,0,1,0
1,174,174,5,5,0,1,0
15,179,179,52,12,40,2,1
4,206,206,9,9,0,1,0
6,207,207,5,2,3,2,1
12,227,227,21,3,18,2,1
7,257,257,11,11,0,1,0
2,277,277,17,17,0,1,0
8,292,292,139,77,62,3,2
0,315,315,3,3,0,1,0
9,431,431,4,1,3,2,1
11,436,436,38,38,0,1,0
13,447,447,29,29,0,1,0
3,467,467,4,4,0,1,0
10,480,480,62,28,34,3,2
5,490,490,3,3,0,1,0

9,130,130,3,3,0,1,0
5,138,138,18,18,0,1,0
4,151,151,17,17,0,1,0
6,171,171,8,3,5,2,1
7,254,254,58,58,0,1,0
8,254,254,14,14,0,1,0
1,281,281,1,1,0,1,0
3,283,283,3,3,0,1,0
12,351,351,4,4,0,1,0
10,424,424,94,64,30,3,2
11,426,426,53,1,52,3,2
0,442,442,99,73,26,4,3
2,483,483,108,42,66,4,3

10,126,126,20,20,0,1,0
8,133,133,16,16,0,1,0
1,171,171,6,6,0,1,0
9,178,178,21,3,18,3,2
5,192,192,8,8,0,1,0
3,250,250,41,41,0,1,0
7,279,279,38,38,0,1,0
6,312,312,4,4,0,1,0
0,315,315,81,23,58,3,2
4,436,436,96,96,0,1,0
11,473,473,63,42,21,2,1
2,490,490,12,12,0,1,0

11,104,104,8,8,0,1,0
2,115,115,1,1,0,1,0
14,120,120,2,2,0,1,0
13,196,196,2,2,0,1,0
0,284,284,11,1,10,2,1
8,298,298,34,34,0,1,0
5,301,301,5,2,3,2,1
6,309,309,46,46,0,1,0
15,327,327,3,3,0,1,0
4,345,345,94,65,29,2,1
7,348,348,23,1,22,2,1
12,372,372,11,4,7,2,1
1,409,409,14,2,12,4,3
10,423,423,204,93,111,4,3
9,444,444,42,42,0,1,0
3,500,500,1,1,0,1,0

11,166,166,5,2,3,2,1
2,171,171,2,2,0,1,0
3,173,173,38,38,0,1,0
8,174,174,5,5,0,1,0
6,211,211,1,1,0,1,0
15,225,225,96,28,68,4,3
7,251,251,9,4,5,2,1
16,268,268,16,6,10,3,2
14,305,305,13,1,12,3,2
1,308,308,6,2,4,2,1
0,330,330,14,4,10,2,1
13,354,354,26,8,18,4,3
9,403,403,20,2,18,4,3
4,405,405,25,25,0,1,0
10,424,424,5,5,0,1,0
5,428,428,97,97,0,1,0
12,467,467,31,31,0,1,0

8,100,100,15,11,4,2,1
2,107,107,2,2,0,1,0
4,107,107,2,2,0,1,0
7,162,162,30,30,0,1,0
13,181,181,18,18,0,1,0
12,191,191,12,12,0,1,0
0,192,192,1,1,0,1,0
5,264,264,1,1,0,1,0
15,271,271,44,44,0,1,0
1,291,291,31,6,25,2,1
6,326,326,5,5,0,1,0
11,351,351,44,44,0,1,0
9,379,379,55,19,36,4,3
3,381,381,77,33,44,2,1
10,432,432,25,25,0,1,0
14,498,498,28,4,24,2,1

17,104,104,22,22,0,1,0
8,133,133,10,10,0,1,0
5,146,146,8,8,0,1,0
15,188,188,8,4,4,2,1
4,189,189,6,6,0,1,0
0,234,234,2,2,0,1,0
10,283,283,14,5,9,4,3
13,316,316,15,5,10,3,2
9,317,317,15,5,10,2,1
14,328,328,35,35,0,1,0
6,334,334,35,35,0,1,0
3,339,339,27,23,4,2,1
2,350,350,6,2,4,2,1
12,362,362,28,6,22,3,2
7,365,365,78,47,31,2,1
1,389,389,7,7,0,1,0
11,399,399,66,18,48,2,1
16,471,471,31,6,25,2,1

9,122,122,1,1,0,1,0
7,246,246,3,3,0,1,0
8,327,327,22,22,0,1,0
0,330,330,77,8,69,4,3
3,336,336,9,9,0,1,0
12,358,358,18,6,12,2,1
2,374,374,38,38,0,1,0
4,376,376,17,17,0,1,0
1,395,395,83,9,74,3,2
5,403,403,34,11,23,3,2
6,443,443,47,44,3,2,1
11,469,469,200,102,98,3,2
10,480,480,20,20,0,1,0

5,103,103,1,1,0,1,0
0,138,138,1,1,0,1,0
9,225,225,75,30,45,2,1
11,253,253,27,27,0,1,0
3,270,270,13,13,0,1,0
6,287,287,56,47,9,2,1
8,289,289,7,7,0,1,0
14,295,295,5,5,0,1,0
1,301,301,80,48,32,3,2
7,306,306,2,2,0,1,0
10,312,312,14,5,9,4,3
2,326,326,22,1,21,2,1
12,376,376,6,3,3,2,1
13,404,404,32,9,23,2,1
4,409,409,32,13,19,2,1
15,458,458,54,54,0,1,0

22,128,128,17,1,16,2,1
3,140,140,3,3,0,1,0
21,148,148,28,28,0,1,0
14,152,152,9,9,0,1,0
13,169,169,6,1,5,2,1
6,198,198,17,2,15,2,1
4,201,201,1,1,0,1,0
15,218,218,1,1,0,1,0
19,250,250,11,8,3,2,1
20,266,266,28,14,14,2,1
7,279,279,24,24,0,1,0
9,280,280,8,3,5,2,1
10,290,290,1,1,0,1,0
8,297,297,9,9,0,1,0
17,304,304,10,10,0,1,0
5,351,351,4,4,0,1,0
2,356,356,13,6,7,2,1
11,362,362,56,48,8,2,1
1,364,364,21,21,0,1,0
12,374,374,4,4,0,1,0
18,374,374,61,3,58,4,3
0,403,403,29,29,0,1,0
16,471,471,24,24,0,1,0

10,106,106,22,22,0,1,0
6,139,139,7,7,0,1,0
1,179,179,10,3,7,2,1
0,217,217,11,11,0,1,0
14,234,234,3,3,0,1,0
9,242,242,54,15,39,4,3
2,253,253,54,42,12,4,3
3,253,253,28,28,0,1,0
4,256,256,28,4,24,2,1
8,272,272,24,2,22,3,2
11,285,285,25,25,0,1,0
13,295,295,19,19,0,1,0
5,371,371,3,3,0,1,0
12,411,411,13,4,9,2,1
7,426,426,44,19,25,2,1

14,108,108,2,2,0,1,0
6,131,131,8,3,5,2,1
0,178,178,15,10,5,2,1
7,219,219,2,2,0,1,0
12,230,230,8,2,6,3,2
8,237,237,27,13,14,3,2
3,265,265,16,16,0,1,0
15,267,267,9,9,0,1,0
13,306,306,36,8,28,2,1
1,327,327,5,1,4,2,1
4,338,338,16,8,8,3,2
5,391,391,26,26,0,1,0
10,407,407,136,136,0,1,0
11,425,425,32,23,9,4,3
2,429,429,104,104,0,1,0
9,452,452,47,47,0,1,0

13,122,122,2,2,0,1,0
3,224,224,8,8,0,1,0
8,231,231,12,8,4,2,1
9,272,272,9,6,3,2,1
14,276,276,20,2,18,4,3
5,306,306,21,5,16,3,2
0,327,327,12,12,0,1,0
11,330,330,32,32,0,1,0
2,339,339,48,48,0,1,0
1,348,348,22,22,0,1,0
12,349,349,89,77,12,4,3
15,382,382,50,50,0,1,0
6,404,404,53,38,15,4,3
7,434,434,57,57,0,1,0
4,442,442,18,9,9,4,3
10,477,477,53,29,24,3,2

10,101,101,5,5,0,1,0
13,115,115,12,12,0,1,0
4,232,232,20,20,0,1,0
14,287,287,2,2,0,1,0
7,291,291,4,1,3,2,1
0,292,292,24,24,0,1,0
12,313,313,36,2,34,2,1
1,337,337,13,13,0,1,0
3,342,342,90,90,0,1,0
11,342,342,68,32,36,2,1
15,416,416,17,17,0,1,0
5,420,420,39,39,0,1,0
2,445,445,19,19,0,1,0
9,457,457,90,32,58,3,2
6,474,474,22,11,11,2,1
8,478,478,17,11,6,2,1

9,105,105,25,10,15,4,3
14,150,150,26,26,0,1,0
11,195,195,12,12,0,1,0
2,227,227,3,3,0,1,0
12,236,236,13,4,9,3,2
6,240,240,11,11,0,1,0
13,247,247,17,17,0,1,0
10,296,296,25,13,12,2,1
7,299,299,25,14,11,2,1
3,318,318,66,24,42,4,3
1,337,337,21,21,0,1,0
0,339,339,58,13,45,2,1
8,353,353,12,2,10,2,1
4,395,395,11,11,0,1,0
5,421,421,38,38,0,1,0

14,106,106,8,1,7,2,1
6,108,108,5,2,3,2,1
19,135,135,1,1,0,1,0
8,151,151,5,1,4,2,1
3,160,160,25,4,21,2,1
5,175,175,6,2,4,2,1
18,234,234,3,3,0,1,0
9,251,251,29,13,16,3,2
16,269,269,63,18,45,4,3
4,272,272,7,2,5,2,1
7,283,283,2,2,0,1,0
1,306,306,35,35,0,1,0
10,309,309,6,6,0,1,0
13,326,326,56,56,0,1,0
0,327,327,11,5,6,2,1
15,391,391,60,32,28,2,1
2,427,427,4,1,3,2,1
12,439,439,9,9,0,1,0
17,461,461,30,30,0,1,0
11,492,492,42,22,20,2,1

8,108,108,20,8,12,3,2
15,169,169,7,2,5,2,1
12,170,170,60,60,0,1,0
10,180,180,21,7,14,3,2
7,196,196,21,21,0,1,0
2,207,207,2,2,0,1,0
3,298,298,3,3,0,1,0
11,309,309,23,5,18,4,3
14,313,313,20,20,0,1,0
5,319,319,3,3,0,1,0
9,321,321,8,8,0,1,0
4,406,406,104,104,0,1,0
6,421,421,19,19,0,1,0
13,440,440,19,10,9,2,1
0,455,455,15,9,6,3,2
1,469,469,22,22,0,1,0

9,103,103,11,1,10,3,2
5,152,152,15,15,0,1,0
6,153,153,10,10,0,1,0
11,155,155,6,6,0,1,0
3,156,156,9,9,0,1,0
7,192,192,48,24,24,3,2
8,195,195,1,1,0,1,0
12,260,260,54,16,38,2,1
4,341,341,8,8,0,1,0
1,349,349,25,25,0,1,0
10,442,442,20,8,12,4,3
0,444,444,45,1,44,4,3
2,462,462,162,162,0,1,0

4,103,103,4,1,3,2,1
0,122,122,22,2,20,3,2
7,137,137,13,2,11,2,1
1,144,144,15,15,0,1,0
11,173,173,13,13,0,1,0
12,254,254,19,19,0,1,0
10,278,278,33,33,0,1,0
2,300,300,32,32,0,1,0
5,313,313,77,77,0,1,0
3,332,332,9,9,0,1,0
6,389,389,6,3,3,2,1
8,438,438,41,41,0,1,0
9,464,464,114,95,19,4,3

1,144,144,3,3,0,1,0
11,154,154,22,22,0,1,0
16,246,246,9,3,6,3,2
0,252,252,1,1,0,1,0
5,255,255,6,6,0,1,0
6,287,287,14,5,9,2,1
15,305,305,55,55,0,1,0
9,344,344,49,49,0,1,0
8,356,356,43,5,38,4,3
7,375,375,52,52,0,1,0
14,387,387,75,37,38,3,2
17,394,394,11,11,0,1,0
13,394,394,34,7,27,4,3
12,413,413,18,1,17,2,1
4,445,445,17,17,0,1,0
2,473,473,35,35,0,1,0
10,490,490,31,4,27,2,1
3,498,498,13,1,12,4,3

12,159,159,35,35,0,1,0
8,230,230,6,6,0,1,0
1,280,280,16,16,0,1,0
10,283,283,3,3,0,1,0
14,283,283,52,9,43,2,1
6,317,317,3,3,0,1,0
2,319,319,74,74,0,1,0
7,321,321,2,2,0,1,0
0,326,326,1,1,0,1,0
5,329,329,53,53,0,1,0
4,340,340,14,6,8,3,2
15,348,348,3,3,0,1,0
9,425,425,43,39,4,2,1
3,444,444,73,45,28,3,2
13,446,446,34,34,0,1,0
11,448,448,52,52,0,1,0

10,138,138,65,18,47,2,1
6,152,152,6,6,0,1,0
4,166,166,10,1,9,3,2
0,204,204,4,1,3,2,1
5,272,272,6,6,0,1,0
8,359,359,9,9,0,1,0
3,366,366,36,27,9,4,3
2,427,427,188,188,0,1,0
7,430,430,3,3,0,1,0
1,444,444,64,10,54,3,2
9,466,466,42,3,39,2,1

15,100,100,9,1,8,2,1
3,196,196,1,1,0,1,0
5,202,202,12,3,9,4,3
11,262,262,67,55,12,4,3
9,316,316,7,7,0,1,0
2,326,326,37,19,18,4,3
14,367,367,39,23,16,3,2
8,368,368,30,30,0,1,0
4,378,378,61,61,0,1,0
1,391,391,18,18,0,1,0
7,391,391,42,42,0,1,0
0,403,403,16,4,12,3,2
12,404,404,20,4,16,2,1
13,427,427,11,11,0,1,0
10,494,494,78,78,0,1,0
6,497,497,43,2,41,2,1

5,113,113,16,16,0,1,0
0,134,134,33,23,10,2,1
7,155,155,6,2,4,2,1
1,170,170,26,8,18,2,1
11,176,176,30,10,20,2,1
4,217,217,18,18,0,1,0
8,316,316,62,16,46,2,1
2,318,318,62,62,0,1,0
6,333,333,17,17,0,1,0
10,345,345,19,19,0,1,0
3,378,378,10,10,0,1,0
9,429,429,27,2,25,2,1

0,102,102,6,1,5,2,1
6,117,117,1,1,0,1,0
10,163,163,5,2,3,2,1
9,197,197,41,41,0,1,0
11,251,251,2,2,0,1,0
5,274,274,58,58,0,1,0
2,278,278,69,3,66,3,2
7,279,279,19,10,9,2,1
1,284,284,42,42,0,1,0
4,370,370,68,68,0,1,0
8,377,377,66,50,16,3,2
3,482,482,30,30,0,1,0

1,115,115,10,10,0,1,0
11,129,129,17,17,0,1,0
2,160,160,19,16,3,2,1
7,173,173,1,1,0,1,0
0,187,187,5,5,0,1,0
13,297,297,5,5,0,1,0
3,306,306,46,11,35,2,1
12,311,311,88,15,73,4,3
5,345,345,47,14,33,2,1
10,372,372,8,3,5,2,1
6,412,412,74,6,68,3,2
4,468,468,1,1,0,1,0
9,480,480,6,1,5,2,1
8,483,483,118,113,5,2,1

12,161,161,14,14,0,1,0
13,177,177,9,9,0,1,0
11,182,182,48,4,44,2,1
8,317,317,30,30,0,1,0
5,319,319,69,13,56,4,3
3,363,363,10,2,8,2,1
0,372,372,13,13,0,1,0
9,385,385,70,7,63,3,2
10,400,400,4,1,3,2,1
14,406,406,14,4,10,2,1
7,420,420,2,2,0,1,0
2,424,424,48,36,12,2,1
1,451,451,82,56,26,2,1
4,488,488,30,30,0,1,0
6,494,494,30,15,15,2,1

4,132,132,25,1,24,3,2
11,250,250,8,8,0,1,0
5,271,271,21,21,0,1,0
13,289,289,3,3,0,1,0
9,313,313,45,19,26,2,1
0,334,334,65,57,8,2,1
3,357,357,9,9,0,1,0
2,363,363,64,64,0,1,0
12,396,396,19,19,0,1,0
6,421,421,7,7,0,1,0
10,424,424,47,47,0,1,0
8,434,434,49,12,37,2,1
7,462,462,118,10,108,4,3
1,485,485,10,10,0,1,0

11,109,109,2,2,0,1,0
9,118,118,3,3,0,1,0
7,178,178,27,27,0,1,0
3,190,190,27,19,8,2,1
4,190,190,78,6,72,4,3
10,258,258,6,1,5,2,1
8,275,275,103,76,27,2,1
2,285,285,23,23,0,1,0
6,322,322,3,3,0,1,0
5,352,352,38,4,34,3,2
1,369,369,1,1,0,1,0
0,492,492,33,33,0,1,0

13,102,102,5,5,0,1,0
9,116,116,13,13,0,1,0
0,124,124,1,1,0,1,0
10,139,139,5,5,0,1,0
6,165,165,15,15,0,1,0
1,192,192,1,1,0,1,0
15,209,209,12,2,10,2,1
7,230,230,14,8,6,2,1
5,253,253,6,6,0,1,0
11,289,289,9,3,6,3,2
2,358,358,18,18,0,1,0
16,372,372,102,72,30,4,3
8,375,375,4,4,0,1,0
4,437,437,148,25,123,4,3
14,439,439,39,39,0,1,0
3,445,445,1,1,0,1,0
12,448,448,82,82,0,1,0

6,100,100,7,1,6,2,1
10,107,107,31,3,28,2,1
7,221,221,6,2,4,2,1
4,227,227,24,24,0,1,0
13,234,234,3,3,0,1,0
1,246,246,9,9,0,1,0
3,273,273,24,4,20,4,3
9,302,302,5,5,0,1,0
5,307,307,8,8,0,1,0
11,341,341,55,55,0,1,0
0,383,383,107,107,0,1,0
2,389,389,38,10,28,2,1
12,431,431,48,48,0,1,0
8,489,489,46,46,0,1,0

6,105,105,11,11,0,1,0
4,114,114,30,7,23,3,2
11,125,125,8,2,6,3,2
12,135,135,7,7,0,1,0
0,141,141,30,30,0,1,0
1,210,210,14,11,3,2,1
3,211,211,5,5,0,1,0
2,395,395,26,26,0,1,0
8,397,397,59,59,0,1,0
5,423,423,29,8,21,3,2
9,469,469,96,86,10,3,2
10,495,495,72,72,0,1,0
7,500,500,1,1,0,1,0

5,134,134,23,18,5,2,1
11,191,191,11,3,8,3,2
7,234,234,29,20,9,2,1
4,238,238,12,1,11,2,1
6,280,280,18,18,0,1,0
3,312,312,14,5,9,4,3
9,326,326,78,51,27,4,3
1,391,391,46,46,0,1,0
2,426,426,83,83,0,1,0
8,442,442,19,19,0,1,0
10,451,451,6,6,0,1,0
0,471,471,138,97,41,2,1

8,103,103,2,2,0,1,0
13,146,146,59,42,17,2,1
4,160,160,13,1,12,4,3
14,232,232,3,3,0,1,0
6,239,239,38,17,21,4,3
2,242,242,3,3,0,1,0
5,244,244,21,21,0,1,0
1,284,284,13,13,0,1,0
3,284,284,13,13,0,1,0
9,304,304,27,12,15,2,1
7,308,308,57,13,44,3,2
11,340,340,22,22,0,1,0
12,351,351,11,8,3,2,1
0,363,363,31,28,3,2,1
10,407,407,39,15,24,2,1

1,133,133,12,12,0,1,0
7,160,160,8,3,5,2,1
5,171,171,12,12,0,1,0
9,256,256,67,13,54,4,3
8,291,291,10,3,7,2,1
0,311,311,49,32,17,2,1
4,327,327,72,39,33,2,1
2,328,328,101,19,82,3,2
10,482,482,34,3,31,2,1
3,483,483,70,60,10,3,2
6,495,495,4,4,0,1,0

15,110,110,2,2,0,1,0
6,144,144,11,11,0,1,0
2,146,146,21,21,0,1,0
5,167,167,7,7,0,1,0
1,186,186,3,3,0,1,0
4,214,214,20,5,15,4,3
13,251,251,18,4,14,2,1
12,269,269,31,17,14,3,2
10,296,296,11,11,0,1,0
8,318,318,26,22,4,2,1
14,340,340,16,2,14,2,1
7,348,348,31,6,25,4,3
11,381,381,59,59,0,1,0
9,399,399,109,89,20,2,1
3,403,403,1,1,0,1,0
0,431,431,67,67,0,1,0

7,119,119,15,6,9,4,3
3,149,149,7,4,3,2,1
9,152,152,4,4,0,1,0
10,173,173,7,1,6,3,2
2,194,194,55,34,21,4,3
12,229,229,9,9,0,1,0
8,237,237,24,24,0,1,0
6,257,257,29,29,0,1,0
13,293,293,49,3,46,3,2
0,319,319,16,6,10,4,3
4,339,339,1,1,0,1,0
11,365,365,116,116,0,1,0
1,379,379,16,3,13,4,3
5,387,387,14,14,0,1,0
14,462,462,8,8,0,1,0

10,124,124,30,18,12,4,3
7,137,137,1,1,0,1,0
5,201,201,11,11,0,1,0
3,220,220,73,32,41,2,1
4,224,224,52,52,0,1,0
0,260,260,41,20,21,3,2
8,287,287,13,6,7,2,1
9,290,290,35,1,34,2,1
2,358,358,44,44,0,1,0
6,384,384,5,5,0,1,0
1,404,404,37,37,0,1,0

4,134,134,25,11,14,3,2
3,232,232,14,14,0,1,0
6,242,242,2,2,0,1,0
5,248,248,33,33,0,1,0
7,298,298,2,2,0,1,0
8,307,307,67,50,17,2,1
0,337,337,28,20,8,3,2
10,372,372,39,19,20,3,2
12,372,372,18,18,0,1,0
11,378,378,70,70,0,1,0
9,380,380,55,55,0,1,0
1,408,408,78,78,0,1,0
2,414,414,19,19,0,1,0

7,109,109,13,4,9,2,1
10,111,111,7,7,0,1,0
2,132,132,10,10,0,1,0
1,201,201,10,1,9,2,1
9,203,203,53,53,0,1,0
0,224,224,2,2,0,1,0
14,237,237,7,1,6,2,1
8,253,253,17,9,8,3,2
3,268,268,44,38,6,2,1
6,293,293,9,9,0,1,0
12,341,341,28,7,21,2,1
13,410,410,12,12,0,1,0
5,430,430,92,40,52,3,2
11,468,468,85,39,46,4,3
4,476,476,18,18,0,1,0

10,115,115,9,1,8,3,2
14,129,129,13,13,0,1,0
11,168,168,4,4,0,1,0
3,182,182,6,6,0,1,0
8,198,198,65,65,0,1,0
5,234,234,58,24,34,2,1
12,241,241,17,17,0,1,0
7,268,268,29,20,9,4,3
9,332,332,25,25,0,1,0
4,380,380,25,7,18,4,3
6,407,407,30,30,0,1,0
2,425,425,24,2,22,4,3
0,443,443,23,6,17,4,3
1,482,482,32,32,0,1,0
13,487,487,19,6,13,4,3

11,124,124,3,3,0,1,0
0,151,151,8,8,0,1,0
6,170,170,69,69,0,1,0
9,173,173,5,5,0,1,0
1,182,182,56,56,0,1,0
3,192,192,42,42,0,1,0
2,265,265,26,6,20,3,2
8,302,302,2,2,0,1,0
10,342,342,49,49,0,1,0
4,350,350,8,4,4,2,1
5,396,396,17,17,0,1,0
7,457,457,29,29,0,1,0

7,109,109,5,5,0,1,0
8,130,130,1,1,0,1,0
9,148,148,20,20,0,1,0
11,151,151,26,26,0,1,0
1,193,193,1,1,0,1,0
14,212,212,27,27,0,1,0
0,250,250,14,2,12,3,2
13,277,277,10,7,3,2,1
6,285,285,29,29,0,1,0
10,312,312,43,25,18,2,1
5,326,326,27,27,0,1,0
12,375,375,40,4,36,3,2
2,412,412,119,53,66,4,3
3,413,413,49,46,3,2,1
4,471,471,1,1,0,1,0

9,143,143,4,4,0,1,0
14,145,145,43,43,0,1,0
13,153,153,3,3,0,1,0
11,153,153,11,11,0,1,0
8,176,176,2,2,0,1,0
5,186,186,9,2,7,2,1
2,210,210,28,28,0,1,0
10,252,252,13,13,0,1,0
7,305,305,19,7,12,2,1
4,340,340,19,1,18,3,2
3,357,357,53,3,50,4,3
16,384,384,13,13,0,1,0
15,393,393,85,85,0,1,0
6,420,420,27,23,4,2,1
12,433,433,13,4,9,4,3
0,441,441,13,13,0,1,0
1,486,486,60,50,10,3,2

8,116,116,24,24,0,1,0
10,159,159,1,1,0,1,0
11,179,179,35,35,0,1,0
4,186,186,49,22,27,4,3
5,220,220,29,29,0,1,0
3,242,242,6,6,0,1,0
0,326,326,55,29,26,2,1
12,342,342,74,74,0,1,0
7,367,367,7,2,5,2,1
6,386,386,9,9,0,1,0
2,407,407,38,38,0,1,0
1,466,466,9,6,3,2,1
9,493,493,23,23,0,1,0

10,100,100,1,1,0,1,0
1,120,120,50,50,0,1,0
6,156,156,1,1,0,1,0
4,168,168,4,1,3,2,1
14,179,179,36,24,12,4,3
7,210,210,18,8,10,2,1
13,227,227,13,13,0,1,0
12,275,275,9,4,5,2,1
2,298,298,1,1,0,1,0
9,316,316,1,1,0,1,0
11,331,331,32,32,0,1,0
16,359,359,99,99,0,1,0
3,388,388,10,10,0,1,0
0,390,390,2,2,0,1,0
5,411,411,39,5,34,3,2
15,464,464,21,1,20,2,1
8,478,478,17,17,0,1,0

0,111,111,1,1,0,1,0
2,128,128,26,14,12,2,1
6,136,136,11,11,0,1,0
4,182,182,33,4,29,4,3
5,188,188,3,3,0,1,0
14,210,210,80,55,25,2,1
1,239,239,8,8,0,1,0
10,250,250,28,28,0,1,0
11,265,265,5,5,0,1,0
3,267,267,13,7,6,2,1
9,408,408,28,28,0,1,0
7,417,417,22,22,0,1,0
13,419,419,42,9,33,3,2
12,466,466,12,6,6,2,1
15,476,476,3,3,0,1,0
8,479,479,36,36,0,1,0

11,116,116,2,2,0,1,0
7,136,136,2,2,0,1,0
0,141,141,8,8,0,1,0
5,158,158,43,43,0,1,0
10,242,242,2,2,0,1,0
8,264,264,74,74,0,1,0
2,280,280,12,12,0,1,0
3,307,307,49,49,0,1,0
12,311,311,26,3,23,2,1
4,365,365,17,17,0,1,0
6,379,379,24,24,0,1,0
9,433,433,108,13,95,3,2
1,445,445,56,24,32,2,1

8,126,126,1,1,0,1,0
5,139,139,13,13,0,1,0
9,185,185,8,8,0,1,0
4,197,197,35,35,0,1,0
3,200,200,13,4,9,4,3
6,220,220,38,38,0,1,0
11,237,237,26,14,12,4,3
10,251,251,38,38,0,1,0
2,336,336,3,3,0,1,0
0,415,415,11,6,5,2,1
13,425,425,80,71,9,4,3
7,429,429,14,10,4,2,1
14,432,432,32,32,0,1,0
1,440,440,55,55,0,1,0
12,447,447,61,37,24,4,3

4,130,130,2,2,0,1,0
10,130,130,4,4,0,1,0
5,131,131,14,6,8,3,2
11,134,134,10,2,8,3,2
2,165,165,9,9,0,1,0
8,178,178,38,5,33,2,1
0,192,192,14,14,0,1,0
3,198,198,6,1,5,2,1
6,236,236,57,15,42,4,3
13,257,257,17,7,10,3,2
7,298,298,42,21,21,4,3
1,345,345,13,2,11,3,2
14,434,434,2,2,0,1,0
9,457,457,25,25,0,1,0
12,484,484,128,90,38,2,1

11,138,138,19,19,0,1,0
6,172,172,5,5,0,1,0
8,174,174,28,28,0,1,0
7,183,183,9,9,0,1,0
1,195,195,4,4,0,1,0
2,202,202,34,16,18,4,3
4,228,228,63,35,28,2,1
10,259,259,8,2,6,2,1
3,298,298,14,14,0,1,0
12,356,356,61,48,13,2,1
9,435,435,60,13,47,2,1
5,439,439,2,2,0,1,0
0,448,448,83,83,0,1,0

1,117,117,13,1,12,2,1
4,117,117,1,1,0,1,0
2,125,125,13,13,0,1,0
14,145,145,23,23,0,1,0
3,158,158,29,1,28,4,3
6,168,168,18,10,8,2,1
13,217,217,5,5,0,1,0
9,324,324,47,47,0,1,0
12,353,353,3,3,0,1,0
10,367,367,16,16,0,1,0
0,375,375,4,1,3,2,1
5,422,422,51,51,0,1,0
11,426,426,97,84,13,2,1
8,431,431,44,44,0,1,0
7,459,459,25,16,9,4,3

5,112,112,5,5,0,1,0
2,117,117,2,2,0,1,0
13,123,123,12,2,10,3,2
9,158,158,1,1,0,1,0
17,207,207,7,7,0,1,0
14,235,235,36,36,0,1,0
7,247,247,35,35,0,1,0
3,251,251,8,3,5,2,1
12,276,276,15,15,0,1,0
11,327,327,64,8,56,3,2
10,347,347,16,16,0,1,0
6,348,348,7,7,0,1,0
0,395,395,5,5,0,1,0
1,444,444,13,13,0,1,0
4,455,455,34,29,5,2,1
16,460,460,25,25,0,1,0
8,464,464,129,129,0,1,0
15,486,486,60,60,0,1,0

10,111,111,8,8,0,1,0
1,114,114,4,1,3,2,1
9,180,180,3,3,0,1,0
8,242,242,8,8,0,1,0
3,274,274,29,21,8,3,2
7,370,370,21,14,7,2,1
13,401,401,34,26,8,2,1
11,409,409,164,164,0,1,0
5,422,422,56,42,14,2,1
6,444,444,31,15,16,3,2
2,446,446,48,8,40,2,1
12,461,461,34,34,0,1,0
4,465,465,23,7,16,4,3
0,476,476,68,29,39,4,3
14,500,500,18,18,0,1,0

5,161,161,10,10,0,1,0
2,166,166,16,16,0,1,0
8,172,172,20,20,0,1,0
3,175,175,31,31,0,1,0
0,197,197,31,31,0,1,0
6,309,309,24,5,19,3,2
10,326,326,62,62,0,1,0
7,377,377,91,11,80,4,3
4,433,433,6,6,0,1,0
9,451,451,3,3,0,1,0
1,463,463,126,126,0,1,0

0,113,113,12,12,0,1,0
8,138,138,23,23,0,1,0
6,165,165,29,3,26,4,3
4,192,192,54,54,0,1,0
10,198,198,14,8,6,2,1
7,230,230,14,4,10,2,1
1,281,281,46,46,0,1,0
9,352,352,16,3,13,2,1
5,364,364,51,2,49,2,1
2,389,389,20,20,0,1,0
11,435,435,25,1,24,2,1
3,464,464,46,46,0,1,0

7,135,135,11,11,0,1,0
9,144,144,28,12,16,3,2
1,147,147,7,1,6,2,1
2,150,150,13,4,9,3,2
10,164,164,41,41,0,1,0
12,215,215,5,5,0,1,0
8,227,227,6,6,0,1,0
6,317,317,26,26,0,1,0
3,342,342,54,4,50,2,1
4,367,367,61,19,42,4,3
0,394,394,58,30,28,2,1
5,430,430,41,20,21,2,1
11,481,481,30,30,0,1,0

4,160,160,5,5,0,1,0
5,228,228,10,2,8,3,2
2,232,232,23,23,0,1,0
13,233,233,17,17,0,1,0
8,236,236,11,11,0,1,0
3,277,277,27,27,0,1,0
0,299,299,41,34,7,2,1
11,299,299,50,40,10,2,1
6,327,327,28,2,26,4,3
12,331,331,7,2,5,2,1
1,350,350,72,24,48,4,3
7,351,351,64,39,25,2,1
9,435,435,38,19,19,2,1
10,482,482,65,21,44,3,2

0,111,111,1,1,0,1,0
2,146,146,14,11,3,2,1
9,249,249,6,2,4,2,1
6,296,296,11,2,9,2,1
4,322,322,84,30,54,4,3
5,327,327,47,9,38,2,1
11,342,342,23,23,0,1,0
12,364,364,108,90,18,3,2
1,375,375,47,47,0,1,0
13,399,399,41,31,10,3,2
8,405,405,4,4,0,1,0
10,472,472,32,16,16,3,2
7,478,478,68,52,16,2,1
3,497,497,14,6,8,3,2

13,109,109,14,14,0,1,0
15,132,132,18,12,6,3,2
9,154,154,1,1,0,1,0
10,181,181,18,18,0,1,0
1,187,187,34,19,15,2,1
3,223,223,19,10,9,4,3
12,246,246,47,47,0,1,0
6,268,268,20,20,0,1,0
7,271,271,45,45,0,1,0
4,373,373,30,30,0,1,0
11,383,383,56,2,54,4,3
8,409,409,8,2,6,3,2
14,435,435,1,1,0,1,0
2,473,473,6,6,0,1,0
5,486,486,8,4,4,2,1
0,489,489,31,31,0,1,0

5,203,203,12,1,11,2,1
8,212,212,10,10,0,1,0
2,236,236,1,1,0,1,0
3,251,251,98,98,0,1,0
9,251,251,11,5,6,2,1
7,252,252,91,37,54,4,3
12,280,280,50,6,44,2,1
4,303,303,34,34,0,1,0
0,343,343,37,37,0,1,0
11,371,371,3,3,0,1,0
1,387,387,11,2,9,2,1
6,464,464,13,4,9,2,1
10,489,489,24,19,5,2,1

2,139,139,12,9,3,2,1
3,205,205,21,10,11,2,1
12,210,210,53,9,44,3,2
17,227,227,28,15,13,2,1
11,235,235,21,21,0,1,0
9,271,271,28,28,0,1,0
1,317,317,4,4,0,1,0
16,317,317,22,22,0,1,0
6,352,352,23,23,0,1,0
15,370,370,12,12,0,1,0
4,371,371,10,1,9,4,3
13,381,381,22,22,0,1,0
5,388,388,6,6,0,1,0
8,392,392,4,4,0,1,0
7,422,422,15,15,0,1,0
10,422,422,76,47,29,2,1
0,440,440,28,9,19,2,1
14,464,464,39,39,0,1,0

2,115,115,9,9,0,1,0
0,181,181,12,12,0,1,0
7,238,238,5,5,0,1,0
10,248,248,31,16,15,2,1
12,253,253,3,3,0,1,0
9,326,326,44,44,0,1,0
11,344,344,36,15,21,2,1
8,355,355,63,13,50,3,2
3,357,357,75,43,32,3,2
6,360,360,49,21,28,2,1
4,382,382,23,23,0,1,0
5,470,470,125,125,0,1,0
1,493,493,10,4,6,2,1

9,123,123,16,13,3,2,1
3,129,129,48,11,37,2,1
10,164,164,6,3,3,2,1
5,180,180,2,2,0,1,0
4,227,227,13,13,0,1,0
7,242,242,49,49,0,1,0
1,274,274,11,11,0,1,0
2,388,388,29,29,0,1,0
0,397,397,85,85,0,1,0
8,399,399,5,5,0,1,0
6,463,463,118,8,110,4,3

0,112,112,18,18,0,1,0
4,124,124,3,3,0,1,0
2,197,197,1,1,0,1,0
5,219,219,1,1,0,1,0
9,258,258,26,26,0,1,0
3,265,265,63,63,0,1,0
7,271,271,36,3,33,2,1
1,305,305,11,4,7,2,1
11,306,306,103,103,0,1,0
10,326,326,18,6,12,3,2
12,380,380,27,27,0,1,0
13,410,410,9,9,0,1,0
6,420,420,42,42,0,1,0
8,481,481,48,24,24,2,1
14,500,500,13,13,0,1,0

11,104,104,3,3,0,1,0
0,137,137,19,10,9,4,3
5,137,137,6,6,0,1,0
10,176,176,9,9,0,1,0
1,178,178,6,6,0,1,0
4,194,194,1,1,0,1,0
9,205,205,9,9,0,1,0
16,242,242,2,2,0,1,0
19,254,254,3,3,0,1,0
2,269,269,25,17,8,3,2
6,271,271,1,1,0,1,0
15,283,283,22,3,19,2,1
17,284,284,34,12,22,2,1
3,301,301,4,4,0,1,0
18,323,323,122,122,0,1,0
12,325,325,28,16,12,2,1
13,349,349,37,37,0,1,0
8,400,400,1,1,0,1,0
7,473,473,75,34,41,2,1
14,490,490,5,5,0,1,0

4,119,119,19,11,8,3,2
6,128,128,11,2,9,4,3
0,139,139,13,13,0,1,0
2,149,149,1,1,0,1,0
3,186,186,7,7,0,1,0
7,220,220,14,14,0,1,0
17,251,251,2,2,0,1,0
9,287,287,42,7,35,4,3
1,312,312,1,1,0,1,0
12,314,314,5,1,4,2,1
11,314,314,2,2,0,1,0
16,356,356,16,3,13,3,2
5,357,357,15,15,0,1,0
13,395,395,46,46,0,1,0
15,409,409,14,14,0,1,0
18,435,435,183,133,50,3,2
14,455,455,37,37,0,1,0
10,473,473,3,3,0,1,0
19,485,485,2,2,0,1,0
8,493,493,17,13,4,2,1

5,147,147,6,6,0,1,0
10,169,169,30,30,0,1,0
8,316,316,16,16,0,1,0
1,338,338,38,7,31,2,1
2,356,356,32,32,0,1,0
9,387,387,58,30,28,3,2
4,409,409,27,27,0,1,0
11,409,409,61,29,32,2,1
3,431,431,186,108,78,4,3
7,442,442,56,16,40,2,1
0,456,456,1,1,0,1,0
6,462,462,5,5,0,1,0

1,113,113,11,11,0,1,0
4,122,122,3,3,0,1,0
16,139,139,9,1,8,3,2
15,171,171,24,9,15,4,3
8,190,190,1,1,0,1,0
6,209,209,29,29,0,1,0
2,234,234,34,34,0,1,0
3,255,255,8,8,0,1,0
14,281,281,54,5,49,2,1
10,292,292,38,38,0,1,0
12,302,302,30,6,24,4,3
9,344,344,1,1,0,1,0
7,396,396,44,44,0,1,0
5,402,402,51,15,36,3,2
0,412,412,7,7,0,1,0
11,450,450,17,8,9,4,3
13,468,468,21,17,4,2,1

4,112,112,4,4,0,1,0
13,139,139,5,5,0,1,0
5,144,144,5,2,3,2,1
10,164,164,10,10,0,1,0
1,188,188,2,2,0,1,0
3,198,198,3,3,0,1,0
12,261,261,21,21,0,1,0
6,264,264,9,1,8,3,2
2,294,294,34,11,23,2,1
0,309,309,6,3,3,2,1
8,345,345,15,7,8,3,2
14,386,386,90,90,0,1,0
9,431,431,74,32,42,4,3
7,435,435,71,48,23,2,1
17,453,453,43,6,37,2,1
11,474,474,54,4,50,2,1
15,496,496,14,14,0,1,0
16,500,500,61,61,0,1,0

5,102,102,34,4,30,2,1
11,164,164,5,5,0,1,0
8,191,191,11,11,0,1,0
4,200,200,110,39,71,3,2
7,210,210,19,19,0,1,0
0,314,314,8,8,0,1,0
3,335,335,31,31,0,1,0
10,340,340,18,8,10,2,1
1,355,355,5,5,0,1,0
6,458,458,2,2,0,1,0
9,468,468,69,52,17,2,1
2,472,472,10,10,0,1,0

9,137,137,22,22,0,1,0
6,194,194,5,5,0,1,0
12,207,207,7,7,0,1,0
10,222,222,34,34,0,1,0
7,241,241,26,8,18,2,1
1,243,243,20,20,0,1,0
2,244,244,9,4,5,2,1
8,260,260,11,11,0,1,0
3,294,294,56,14,42,2,1
15,295,295,82,82,0,1,0
4,297,297,12,6,6,2,1
0,299,299,29,29,0,1,0
11,311,311,12,12,0,1,0
5,387,387,30,16,14,4,3
14,428,428,14,14,0,1,0
13,433,433,5,5,0,1,0

13,100,100,1,1,0,1,0
6,122,122,1,1,0,1,0
4,126,126,10,10,0,1,0
12,134,134,4,4,0,1,0
14,138,138,17,17,0,1,0
9,143,143,12,12,0,1,0
8,173,173,3,3,0,1,0
5,184,184,34,34,0,1,0
2,186,186,2,2,0,1,0
0,238,238,25,25,0,1,0
1,253,253,32,32,0,1,0
3,342,342,26,18,8,2,1
15,354,354,137,137,0,1,0
7,417,417,6,6,0,1,0
16,463,463,2,2,0,1,0
10,494,494,70,70,0,1,0
11,498,498,11,11,0,1,0

5,120,120,2,2,0,1,0
8,121,121,9,9,0,1,0
7,127,127,12,2,10,3,2
12,180,180,5,5,0,1,0
9,186,186,16,2,14,3,2
0,197,197,37,20,17,4,3
3,222,222,2,2,0,1,0
1,277,277,127,22,105,4,3
2,354,354,1,1,0,1,0
10,369,369,30,10,20,3,2
11,453,453,45,3,42,2,1
4,457,457,13,2,11,2,1
6,477,477,121,63,58,3,2

14,112,112,2,2,0,1,0
9,155,155,2,2,0,1,0
10,178,178,15,9,6,2,1
13,178,178,51,51,0,1,0
16,220,220,2,2,0,1,0
0,234,234,5,5,0,1,0
8,243,243,3,3,0,1,0
12,246,246,16,16,0,1,0
5,259,259,37,2,35,2,1
15,297,297,15,5,10,3,2
11,297,297,20,20,0,1,0
4,302,302,34,2,32,3,2
7,305,305,33,13,20,3,2
17,311,311,69,69,0,1,0
6,335,335,2,2,0,1,0
3,343,343,29,18,11,2,1
2,453,453,11,11,0,1,0
1,500,500,46,38,8,3,2

6,110,110,7,7,0,1,0
3,125,125,4,4,0,1,0
14,136,136,4,4,0,1,0
7,140,140,8,2,6,2,1
5,155,155,13,13,0,1,0
4,157,157,1,1,0,1,0
13,170,170,45,31,14,3,2
8,186,186,4,4,0,1,0
0,201,201,32,32,0,1,0
1,223,223,9,9,0,1,0
9,235,235,5,2,3,2,1
10,314,314,3,3,0,1,0
2,343,343,74,27,47,4,3
15,352,352,60,48,12,3,2
12,363,363,18,18,0,1,0
16,462,462,79,46,33,2,1
11,500,500,8,3,5,2,1

9,105,105,20,20,0,1,0
4,109,109,14,8,6,2,1
10,115,115,1,1,0,1,0
0,199,199,20,10,10,2,1
5,205,205,21,21,0,1,0
1,229,229,42,30,12,2,1
12,276,276,43,6,37,3,2
3,317,317,43,43,0,1,0
6,339,339,49,37,12,3,2
11,371,371,57,30,27,3,2
2,381,381,19,9,10,3,2
8,386,386,3,3,0,1,0
7,444,444,26,21,5,2,1

13,101,101,2,2,0,1,0
6,135,135,22,6,16,3,2
8,149,149,12,5,7,2,1
15,191,191,4,4,0,1,0
2,242,242,34,10,24,4,3
17,251,251,22,3,19,2,1
0,310,310,2,2,0,1,0
11,316,316,159,117,42,3,2
9,370,370,19,9,10,3,2
7,373,373,22,2,20,2,1
3,381,381,24,24,0,1,0
1,385,385,18,12,6,3,2
16,411,411,22,22,0,1,0
12,417,417,10,1,9,4,3
4,435,435,13,4,9,2,1
14,470,470,6,6,0,1,0
10,472,472,13,13,0,1,0
5,497,497,16,16,0,1,0

1,168,168,5,5,0,1,0
8,205,205,6,6,0,1,0
3,234,234,5,5,0,1,0
13,284,284,50,50,0,1,0
7,297,297,16,16,0,1,0
12,338,338,29,29,0,1,0
5,354,354,52,52,0,1,0
10,366,366,65,23,42,2,1
2,375,375,14,14,0,1,0
0,404,404,99,42,57,3,2
4,415,415,15,7,8,2,1
6,435,435,80,80,0,1,0
11,465,465,23,3,20,2,1
9,472,472,64,64,0,1,0

5,104,104,1,1,0,1,0
14,125,125,10,7,3,2,1
13,127,127,37,37,0,1,0
10,141,141,11,7,4,2,1
11,193,193,27,27,0,1,0
3,200,200,21,9,12,3,2
6,263,263,5,5,0,1,0
0,276,276,51,51,0,1,0
8,308,308,12,12,0,1,0
12,326,326,10,5,5,2,1
4,357,357,45,30,15,4,3
7,389,389,8,8,0,1,0
9,426,426,25,5,20,3,2
1,431,431,8,4,4,2,1
2,457,457,99,25,74,3,2

9,107,107,12,1,11,2,1
3,194,194,1,1,0,1,0
4,225,225,52,18,34,2,1
6,228,228,2,2,0,1,0
2,251,251,65,17,48,3,2
1,356,356,132,132,0,1,0
5,425,425,78,78,0,1,0
8,449,449,59,59,0,1,0
0,464,464,33,33,0,1,0
7,490,490,22,12,10,3,2

13,115,115,3,3,0,1,0
1,130,130,6,3,3,2,1
5,137,137,42,42,0,1,0
12,156,156,2,2,0,1,0
10,186,186,1,1,0,1,0
2,219,219,1,1,0,1,0
9,223,223,11,5,6,2,1
7,238,238,27,27,0,1,0
4,248,248,10,10,0,1,0
6,333,333,14,14,0,1,0
0,406,406,19,9,10,3,2
3,420,420,90,64,26,3,2
11,465,465,84,56,28,3,2
8,490,490,158,158,0,1,0

10,103,103,1,1,0,1,0
13,126,126,3,3,0,1,0
6,137,137,5,5,0,1,0
5,216,216,6,6,0,1,0
7,240,240,5,5,0,1,0
9,259,259,65,65,0,1,0
4,298,298,21,15,6,2,1
3,323,323,80,74,6,2,1
11,324,324,51,51,0,1,0
8,372,372,43,43,0,1,0
2,377,377,37,33,4,2,1
1,409,409,22,18,4,2,1
12,409,409,56,4,52,3,2
0,437,437,74,12,62,3,2

8,123,123,2,2,0,1,0
3,163,163,7,7,0,1,0
6,187,187,59,32,27,4,3
11,209,209,20,20,0,1,0
7,229,229,2,2,0,1,0
12,260,260,25,25,0,1,0
1,279,279,15,6,9,2,1
10,286,286,33,33,0,1,0
4,301,301,14,2,12,3,2
5,328,328,44,23,21,2,1
2,398,398,83,68,15,2,1
9,450,450,30,30,0,1,0
0,467,467,100,100,0,1,0

12,108,108,15,3,12,2,1
7,135,135,14,5,9,2,1
1,158,158,26,26,0,1,0
10,160,160,7,7,0,1,0
5,175,175,17,11,6,2,1
16,181,181,16,6,10,2,1
0,187,187,1,1,0,1,0
11,198,198,45,45,0,1,0
3,297,297,4,4,0,1,0
2,340,340,19,9,10,2,1
13,345,345,17,17,0,1,0
15,354,354,29,29,0,1,0
8,404,404,81,10,71,4,3
4,479,479,15,15,0,1,0
9,479,479,12,12,0,1,0
6,490,490,2,2,0,1,0
14,490,490,46,34,12,4,3

0,132,132,34,34,0,1,0
8,143,143,14,11,3,2,1
4,158,158,7,7,0,1,0
5,162,162,3,3,0,1,0
9,193,193,20,20,0,1,0
11,202,202,17,17,0,1,0
3,245,245,53,39,14,2,1
2,256,256,16,16,0,1,0
1,301,301,31,16,15,4,3
10,301,301,10,6,4,2,1
12,341,341,84,84,0,1,0
6,385,385,37,25,12,2,1
7,465,465,25,25,0,1,0

7,107,107,8,3,5,2,1
2,138,138,32,11,21,4,3
11,185,185,62,8,54,3,2
12,186,186,3,3,0,1,0
6,219,219,13,4,9,4,3
13,226,226,13,4,9,2,1
8,272,272,21,7,14,2,1
10,301,301,41,3,38,3,2
1,310,310,5,5,0,1,0
5,324,324,3,3,0,1,0
9,329,329,7,1,6,3,2
0,417,417,100,76,24,2,1
3,469,469,3,3,0,1,0
4,496,496,70,70,0,1,0

7,111,111,9,9,0,1,0
0,142,142,1,1,0,1,0
8,193,193,5,5,0,1,0
13,224,224,42,24,18,2,1
12,277,277,26,26,0,1,0
9,284,284,67,67,0,1,0
4,333,333,59,51,8,2,1
5,344,344,25,25,0,1,0
11,437,437,11,11,0,1,0
10,440,440,30,30,0,1,0
1,446,446,13,5,8,3,2
2,458,458,34,23,11,2,1
6,470,470,148,109,39,2,1
3,479,479,12,8,4,2,1

8,111,111,6,1,5,2,1
7,141,141,28,28,0,1,0
6,180,180,15,15,0,1,0
2,206,206,10,2,8,2,1
3,216,216,51,31,20,2,1
11,263,263,16,7,9,4,3
4,284,284,2,2,0,1,0
10,312,312,6,2,4,2,1
0,348,348,36,27,9,4,3
5,398,398,67,7,60,3,2
13,412,412,135,89,46,2,1
1,454,454,26,14,12,4,3
9,463,463,12,4,8,3,2
12,496,496,15,5,10,3,2

11,100,100,17,17,0,1,0
16,112,112,10,10,0,1,0
3,114,114,1,1,0,1,0
1,117,117,12,12,0,1,0
4,126,126,2,2,0,1,0
12,134,134,11,11,0,1,0
8,179,179,21,3,18,2,1
15,192,192,4,4,0,1,0
9,234,234,34,22,12,3,2
13,292,292,69,59,10,3,2
0,348,348,33,1,32,2,1
14,379,379,20,20,0,1,0
7,382,382,34,34,0,1,0
10,413,413,33,33,0,1,0
2,432,432,41,41,0,1,0
6,448,448,10,10,0,1,0
5,489,489,5,5,0,1,0

7,107,107,13,4,9,4,3
1,178,178,25,16,9,4,3
0,190,190,23,17,6,2,1
9,193,193,1,1,0,1,0
12,203,203,25,11,14,3,2
4,227,227,6,6,0,1,0
16,261,261,2,2,0,1,0
5,290,290,12,2,10,3,2
15,296,296,43,43,0,1,0
2,348,348,4,4,0,1,0
6,370,370,60,60,0,1,0
8,384,384,11,11,0,1,0
3,400,400,18,18,0,1,0
13,409,409,39,1,38,3,2
14,416,416,32,32,0,1,0
10,462,462,47,32,15,4,3
11,488,488,79,14,65,4,3

4,104,104,5,1,4,2,1
14,111,111,5,5,0,1,0
9,135,135,39,39,0,1,0
5,156,156,21,21,0,1,0
16,218,218,23,4,19,4,3
13,231,231,8,8,0,1,0
6,239,239,1,1,0,1,0
7,247,247,7,4,3,2,1
2,296,296,15,2,13,2,1
1,297,297,1,1,0,1,0
0,337,337,14,2,12,2,1
10,403,403,139,62,77,4,3
3,415,415,16,2,14,3,2
12,432,432,5,5,0,1,0
11,437,437,51,51,0,1,0
15,439,439,22,22,0,1,0
8,496,496,31,31,0,1,0

4,124,124,4,4,0,1,0
12,134,134,1,1,0,1,0
8,169,169,14,14,0,1,0
2,173,173,3,3,0,1,0
7,196,196,19,19,0,1,0
10,238,238,6,6,0,1,0
3,254,254,24,24,0,1,0
5,281,281,72,54,18,2,1
1,302,302,60,55,5,2,1
11,374,374,18,18,0,1,0
9,408,408,40,23,17,2,1
6,446,446,158,91,67,3,2
0,497,497,51,51,0,1,0

13,101,101,4,4,0,1,0
17,225,225,1,1,0,1,0
16,235,235,30,2,28,2,1
8,241,241,12,12,0,1,0
11,244,244,1,1,0,1,0
1,265,265,11,11,0,1,0
4,279,279,31,15,16,3,2
14,301,301,3,3,0,1,0
9,302,302,5,1,4,2,1
5,305,305,10,10,0,1,0
15,307,307,31,31,0,1,0
3,321,321,28,28,0,1,0
10,326,326,27,24,3,2,1
19,333,333,25,8,17,2,1
2,369,369,71,71,0,1,0
12,381,381,5,5,0,1,0
18,400,400,141,141,0,1,0
7,414,414,1,1,0,1,0
6,439,439,12,2,10,3,2
0,446,446,18,18,0,1,0

3,122,122,2,2,0,1,0
4,126,126,19,19,0,1,0
8,139,139,5,5,0,1,0
10,157,157,4,4,0,1,0
15,157,157,14,1,13,2,1
17,184,184,9,1,8,3,2
13,207,207,19,19,0,1,0
0,225,225,12,12,0,1,0
12,232,232,14,11,3,2,1
1,263,263,7,7,0,1,0
11,272,272,82,73,9,2,1
14,273,273,19,19,0,1,0
16,287,287,15,12,3,2,1
5,334,334,14,2,12,4,3
7,361,361,8,1,7,3,2
6,405,405,13,2,11,2,1
2,437,437,57,57,0,1,0
9,447,447,75,75,0,1,0

13,117,117,1,1,0,1,0
1,126,126,40,40,0,1,0
3,139,139,2,2,0,1,0
7,164,164,12,4,8,2,1
0,188,188,32,32,0,1,0
2,189,189,5,2,3,2,1
4,204,204,11,11,0,1,0
6,286,286,30,30,0,1,0
11,344,344,97,55,42,3,2
9,349,349,45,45,0,1,0
10,359,359,8,2,6,2,1
5,410,410,6,1,5,2,1
8,465,465,37,37,0,1,0
12,485,485,60,22,38,2,1

5,125,125,2,2,0,1,0
9,147,147,49,49,0,1,0
10,222,222,11,11,0,1,0
2,252,252,98,89,9,4,3
13,270,270,25,17,8,2,1
12,279,279,12,4,8,2,1
11,342,342,51,45,6,3,2
1,350,350,11,11,0,1,0
7,353,353,3,3,0,1,0
4,355,355,64,19,45,4,3
3,362,362,1,1,0,1,0
8,457,457,20,17,3,2,1
6,474,474,38,38,0,1,0
0,481,481,1,1,0,1,0

2,110,110,4,4,0,1,0
10,121,121,3,3,0,1,0
16,124,124,9,1,8,2,1
14,132,132,51,51,0,1,0
8,158,158,1,1,0,1,0
0,163,163,31,17,14,3,2
15,259,259,31,31,0,1,0
9,297,297,8,2,6,3,2
5,309,309,19,2,17,2,1
3,327,327,31,31,0,1,0
12,331,331,18,3,15,4,3
17,379,379,19,19,0,1,0
1,385,385,51,33,18,2,1
7,435,435,19,19,0,1,0
13,439,439,13,13,0,1,0
6,442,442,11,4,7,2,1
11,454,454,3,3,0,1,0
4,458,458,29,29,0,1,0

15,143,143,12,12,0,1,0
11,163,163,29,29,0,1,0
7,173,173,19,7,12,4,3
0,175,175,18,18,0,1,0
9,220,220,3,3,0,1,0
6,264,264,4,4,0,1,0
1,283,283,2,2,0,1,0
4,353,353,17,6,11,2,1
8,354,354,17,17,0,1,0
13,358,358,6,2,4,2,1
2,406,406,35,16,19,2,1
12,413,413,45,2,43,2,1
14,427,427,31,27,4,2,1
3,452,452,48,32,16,2,1
5,453,453,74,74,0,1,0
10,483,483,48,48,0,1,0
16,496,496,74,62,12,3,2

1,101,101,1,1,0,1,0
15,107,107,3,3,0,1,0
10,117,117,1,1,0,1,0
5,128,128,1,1,0,1,0
11,161,161,15,6,9,4,3
0,212,212,14,14,0,1,0
9,256,256,24,24,0,1,0
3,269,269,8,3,5,2,1
12,277,277,45,45,0,1,0
14,314,314,28,28,0,1,0
8,351,351,27,27,0,1,0
16,390,390,21,21,0,1,0
7,414,414,103,22,81,4,3
13,417,417,118,26,92,3,2
4,425,425,22,22,0,1,0
2,458,458,3,3,0,1,0
6,493,493,55,14,41,2,1

10,167,167,1,1,0,1,0
0,170,170,20,10,10,3,2
3,196,196,6,2,4,2,1
6,201,201,18,18,0,1,0
4,243,243,7,2,5,2,1
14,266,266,68,22,46,3,2
5,295,295,122,122,0,1,0
9,312,312,1,1,0,1,0
8,367,367,5,5,0,1,0
7,393,393,3,3,0,1,0
11,395,395,101,97,4,2,1
1,410,410,2,2,0,1,0
2,478,478,4,4,0,1,0
12,488,488,77,77,0,1,0
13,491,491,9,9,0,1,0

15,149,149,15,15,0,1,0
10,197,197,1,1,0,1,0
0,223,223,5,5,0,1,0
13,331,331,88,88,0,1,0
11,333,333,17,17,0,1,0
14,350,350,15,15,0,1,0
16,352,352,15,15,0,1,0
1,355,355,4,4,0,1,0
5,363,363,35,35,0,1,0
9,367,367,17,17,0,1,0
3,416,416,7,2,5,2,1
6,419,419,90,6,84,3,2
12,427,427,89,23,66,3,2
4,433,433,28,13,15,2,1
2,436,436,69,69,0,1,0
7,466,466,13,13,0,1,0
8,468,468,20,20,0,1,0

10,118,118,14,14,0,1,0
12,177,177,16,16,0,1,0
2,208,208,1,1,0,1,0
7,223,223,12,12,0,1,0
6,227,227,23,23,0,1,0
9,231,231,9,1,8,3,2
0,272,272,4,4,0,1,0
11,331,331,21,5,16,4,3
3,335,335,82,8,74,4,3
13,352,352,90,5,85,4,3
5,399,399,34,15,19,2,1
8,403,403,38,38,0,1,0
4,411,411,65,65,0,1,0
1,416,416,38,17,21,2,1

13,114,114,18,10,8,3,2
1,129,129,5,5,0,1,0
0,152,152,61,61,0,1,0
2,187,187,14,8,6,3,2
6,194,194,3,3,0,1,0
5,236,236,2,2,0,1,0
7,273,273,32,32,0,1,0
4,278,278,4,4,0,1,0
3,328,328,49,49,0,1,0
12,397,397,99,99,0,1,0
10,403,403,19,19,0,1,0
11,431,431,14,9,5,2,1
9,444,444,7,7,0,1,0
8,452,452,43,3,40,3,2

10,107,107,8,1,7,2,1
3,138,138,28,25,3,2,1
9,153,153,9,3,6,3,2
1,192,192,47,47,0,1,0
0,195,195,8,1,7,2,1
5,222,222,10,10,0,1,0
8,259,259,77,8,69,4,3
11,301,301,18,11,7,2,1
2,358,358,53,38,15,4,3
7,386,386,61,57,4,2,1
6,434,434,10,6,4,2,1
4,488,488,31,31,0,1,0

11,111,111,9,9,0,1,0
18,141,141,6,6,0,1,0
5,183,183,2,2,0,1,0
9,202,202,35,6,29,3,2
10,202,202,1,1,0,1,0
13,249,249,9,9,0,1,0
16,260,260,11,11,0,1,0
20,279,279,26,11,15,3,2
2,301,301,10,10,0,1,0
8,339,339,1,1,0,1,0
14,355,355,15,15,0,1,0
0,361,361,4,1,3,2,1
6,412,412,37,37,0,1,0
4,416,416,20,20,0,1,0
1,452,452,29,18,11,2,1
7,457,457,1,1,0,1,0
19,462,462,32,29,3,2,1
21,466,466,76,76,0,1,0
3,481,481,33,24,9,4,3
15,489,489,96,53,43,4,3
12,492,492,16,2,14,2,1
17,494,494,52,23,29,2,1

0,132,132,12,12,0,1,0
6,166,166,42,42,0,1,0
8,175,175,12,1,11,2,1
4,179,179,2,2,0,1,0
11,209,209,20,2,18,3,2
12,217,217,48,48,0,1,0
15,225,225,48,31,17,2,1
10,305,305,3,3,0,1,0
5,312,312,6,6,0,1,0
13,349,349,19,12,7,2,1
1,365,365,18,18,0,1,0
2,381,381,25,1,24,3,2
14,381,381,2,2,0,1,0
9,441,441,50,50,0,1,0
7,450,450,31,23,8,3,2
3,483,483,36,8,28,4,3

4,122,122,2,2,0,1,0
0,130,130,27,4,23,2,1
13,146,146,2,2,0,1,0
9,178,178,17,17,0,1,0
8,188,188,34,8,26,4,3
1,207,207,21,7,14,3,2
7,239,239,7,7,0,1,0
11,248,248,44,44,0,1,0
3,265,265,2,2,0,1,0
12,269,269,39,19,20,3,2
2,307,307,30,30,0,1,0
10,309,309,23,23,0,1,0
6,472,472,111,27,84,3,2
5,485,485,17,5,12,3,2

8,110,110,10,5,5,2,1
19,111,111,20,10,10,3,2
12,122,122,10,1,9,4,3
2,140,140,13,1,12,2,1
7,156,156,10,10,0,1,0
14,166,166,29,29,0,1,0
9,168,168,1,1,0,1,0
6,203,203,7,7,0,1,0
4,212,212,18,10,8,3,2
10,231,231,3,3,0,1,0
17,239,239,21,13,8,2,1
20,265,265,9,9,0,1,0
16,286,286,8,8,0,1,0
11,337,337,28,1,27,3,2
3,361,361,1,1,0,1,0
13,414,414,4,4,0,1,0
18,419,419,62,62,0,1,0
15,430,430,29,29,0,1,0
5,440,440,6,1,5,2,1
0,461,461,25,13,12,4,3
1,471,471,33,33,0,1,0

7,111,111,29,29,0,1,0
0,117,117,1,1,0,1,0
10,152,152,5,5,0,1,0
8,170,170,19,1,18,4,3
6,213,213,7,7,0,1,0
4,258,258,46,16,30,2,1
1,290,290,52,52,0,1,0
11,290,290,3,3,0,1,0
3,300,300,45,41,4,2,1
2,335,335,38,22,16,3,2
12,366,366,23,9,14,2,1
13,401,401,87,87,0,1,0
9,442,442,9,9,0,1,0
5,475,475,20,20,0,1,0

4,116,116,3,3,0,1,0
7,130,130,1,1,0,1,0
14,142,142,19,19,0,1,0
3,156,156,16,12,4,2,1
10,161,161,1,1,0,1,0
5,168,168,5,5,0,1,0
13,195,195,13,10,3,2,1
15,200,200,1,1,0,1,0
17,214,214,4,4,0,1,0
16,229,229,20,6,14,3,2
18,280,280,109,97,12,4,3
1,343,343,19,19,0,1,0
0,361,361,13,13,0,1,0
6,370,370,36,36,0,1,0
2,395,395,64,64,0,1,0
8,426,426,28,28,0,1,0
11,434,434,22,8,14,3,2
12,450,450,6,3,3,2,1
9,475,475,29,29,0,1,0

5,123,123,10,10,0,1,0
7,153,153,4,4,0,1,0
6,159,159,1,1,0,1,0
10,161,161,25,5,20,2,1
14,164,164,2,2,0,1,0
3,187,187,43,43,0,1,0
2,202,202,1,1,0,1,0
16,215,215,42,42,0,1,0
4,237,237,9,9,0,1,0
13,327,327,6,6,0,1,0
15,377,377,87,63,24,4,3
12,392,392,17,17,0,1,0
0,414,414,18,18,0,1,0
11,443,443,27,27,0,1,0
9,476,476,9,9,0,1,0
1,495,495,38,13,25,4,3
8,497,497,87,2,85,4,3

8,128,128,12,6,6,3,2
3,141,141,1,1,0,1,0
14,147,147,12,12,0,1,0
0,224,224,4,4,0,1,0
16,287,287,76,76,0,1,0
10,296,296,4,4,0,1,0
4,307,307,14,14,0,1,0
7,319,319,23,5,18,4,3
5,336,336,31,11,20,2,1
2,367,367,5,5,0,1,0
1,371,371,5,1,4,2,1
9,406,406,60,18,42,3,2
6,419,419,83,83,0,1,0
12,439,439,21,21,0,1,0
13,439,439,2,2,0,1,0
15,484,484,68,46,22,2,1
11,496,496,80,80,0,1,0

3,169,169,13,2,11,2,1
1,187,187,47,47,0,1,0
0,237,237,80,73,7,2,1
5,245,245,48,48,0,1,0
6,261,261,46,46,0,1,0
7,332,332,32,2,30,2,1
8,334,334,26,26,0,1,0
4,367,367,11,11,0,1,0
9,369,369,21,21,0,1,0
2,424,424,48,4,44,2,1

11,140,140,6,6,0,1,0
7,154,154,32,23,9,4,3
5,192,192,39,21,18,4,3
8,195,195,17,3,14,4,3
0,224,224,2,2,0,1,0
6,234,234,62,22,40,3,2
10,244,244,20,6,14,2,1
1,253,253,25,13,12,2,1
2,258,258,24,6,18,4,3
3,275,275,11,11,0,1,0
12,333,333,2,2,0,1,0
4,358,358,92,2,90,3,2
9,492,492,11,3,8,3,2

8,116,116,1,1,0,1,0
1,142,142,1,1,0,1,0
7,169,169,23,23,0,1,0
6,180,180,4,1,3,2,1
9,216,216,30,18,12,2,1
2,218,218,68,37,31,2,1
0,272,272,104,104,0,1,0
4,362,362,83,36,47,4,3
3,461,461,20,20,0,1,0
5,495,495,68,68,0,1,0

12,173,173,51,9,42,4,3
9,178,178,5,5,0,1,0
3,185,185,11,11,0,1,0
7,194,194,2,2,0,1,0
0,244,244,120,120,0,1,0
5,245,245,3,3,0,1,0
11,298,298,41,21,20,3,2
8,329,329,30,6,24,4,3
4,338,338,37,3,34,4,3
10,353,353,45,28,17,2,1
2,373,373,6,6,0,1,0
1,377,377,5,5,0,1,0
6,405,405,10,10,0,1,0

8,117,117,1,1,0,1,0
2,123,123,19,3,16,2,1
1,145,145,7,4,3,2,1
12,199,199,27,27,0,1,0
5,203,203,6,2,4,2,1
4,229,229,25,25,0,1,0
18,239,239,26,26,0,1,0
0,265,265,4,4,0,1,0
6,275,275,36,36,0,1,0
13,279,279,41,11,30,4,3
7,332,332,6,6,0,1,0
16,360,360,49,42,7,2,1
9,370,370,2,2,0,1,0
10,420,420,52,52,0,1,0
11,420,420,16,2,14,3,2
17,441,441,37,33,4,2,1
15,466,466,13,10,3,2,1
3,476,476,9,9,0,1,0
14,484,484,34,8,26,3,2

13,108,108,7,4,3,2,1
17,124,124,24,17,7,2,1
9,136,136,34,1,33,2,1
14,209,209,32,32,0,1,0
1,268,268,10,3,7,2,1
11,284,284,4,4,0,1,0
12,304,304,13,13,0,1,0
8,317,317,27,21,6,2,1
10,343,343,3,3,0,1,0
6,356,356,30,30,0,1,0
4,370,370,7,4,3,2,1
2,400,400,7,7,0,1,0
16,400,400,76,14,62,3,2
7,414,414,23,11,12,2,1
0,415,415,24,5,19,2,1
15,415,415,22,6,16,2,1
3,450,450,1,1,0,1,0
5,498,498,42,15,27,2,1

14,101,101,1,1,0,1,0
0,105,105,12,12,0,1,0
11,106,106,8,5,3,2,1
18,127,127,20,20,0,1,0
13,149,149,4,1,3,2,1
9,186,186,9,9,0,1,0
17,186,186,61,1,60,4,3
1,206,206,5,5,0,1,0
4,215,215,29,29,0,1,0
16,230,230,19,15,4,2,1
5,257,257,6,6,0,1,0
2,260,260,11,3,8,3,2
8,276,276,4,4,0,1,0
20,279,279,28,4,24,2,1
7,291,291,21,21,0,1,0
19,296,296,8,1,7,2,1
15,324,324,4,4,0,1,0
3,336,336,3,3,0,1,0
6,438,438,3,3,0,1,0
12,453,453,35,35,0,1,0
10,465,465,16,16,0,1,0

13,129,129,6,6,0,1,0
1,140,140,7,7,0,1,0
12,146,146,40,40,0,1,0
3,203,203,1,1,0,1,0
4,203,203,9,9,0,1,0
17,222,222,3,3,0,1,0
15,233,233,34,34,0,1,0
16,242,242,38,38,0,1,0
8,265,265,19,19,0,1,0
10,297,297,23,11,12,4,3
18,321,321,19,5,14,2,1
5,321,321,3,3,0,1,0
14,327,327,6,6,0,1,0
7,334,334,9,9,0,1,0
11,354,354,51,51,0,1,0
2,371,371,6,6,0,1,0
0,374,374,13,13,0,1,0
6,420,420,3,3,0,1,0
9,478,478,102,102,0,1,0

8,129,129,17,8,9,2,1
11,140,140,64,34,30,2,1
5,171,171,13,13,0,1,0
12,220,220,3,3,0,1,0
9,239,239,14,7,7,2,1
0,263,263,3,3,0,1,0
6,287,287,1,1,0,1,0
1,304,304,8,4,4,2,1
7,344,344,6,6,0,1,0
10,382,382,13,13,0,1,0
4,386,386,4,4,0,1,0
3,461,461,58,16,42,3,2
2,476,476,217,199,18,2,1

1,103,103,39,31,8,3,2
11,167,167,12,2,10,3,2
7,177,177,12,12,0,1,0
13,177,177,30,10,20,2,1
0,216,216,13,13,0,1,0
9,252,252,12,12,0,1,0
5,273,273,7,7,0,1,0
3,279,279,10,2,8,3,2
10,304,304,36,36,0,1,0
8,319,319,16,16,0,1,0
2,326,326,2,2,0,1,0
12,352,352,33,9,24,3,2
4,405,405,18,6,12,4,3
15,406,406,49,49,0,1,0
6,410,410,14,14,0,1,0
14,446,446,41,41,0,1,0

2,133,133,28,28,0,1,0
11,137,137,21,21,0,1,0
5,155,155,2,2,0,1,0
12,158,158,12,12,0,1,0
1,203,203,35,35,0,1,0
0,209,209,8,3,5,2,1
7,232,232,64,64,0,1,0
10,269,269,9,5,4,2,1
3,385,385,23,5,18,2,1
9,425,425,21,15,6,3,2
6,454,454,90,90,0,1,0
4,470,470,4,4,0,1,0
13,479,479,30,30,0,1,0
8,487,487,29,2,27,4,3

13,109,109,2,2,0,1,0
3,110,110,4,4,0,1,0
9,180,180,23,11,12,3,2
8,208,208,4,4,0,1,0
10,214,214,3,3,0,1,0
14,224,224,1,1,0,1,0
15,229,229,30,15,15,4,3
1,262,262,26,26,0,1,0
0,277,277,1,1,0,1,0
7,297,297,7,7,0,1,0
2,350,350,35,35,0,1,0
11,408,408,5,5,0,1,0
6,428,428,60,12,48,3,2
4,458,458,84,84,0,1,0
5,459,459,45,45,0,1,0
12,462,462,190,115,75,4,3

6,116,116,1,1,0,1,0
0,120,120,46,13,33,2,1
1,124,124,9,9,0,1,0
7,153,153,10,10,0,1,0
11,161,161,50,15,35,2,1
2,165,165,2,2,0,1,0
8,301,301,31,7,24,3,2
5,310,310,25,25,0,1,0
10,319,319,31,10,21,2,1
12,360,360,34,20,14,2,1
4,406,406,16,2,14,3,2
3,452,452,52,28,24,3,2
9,475,475,19,5,14,2,1

9,105,105,13,1,12,3,2
0,132,132,1,1,0,1,0
3,156,156,1,1,0,1,0
12,163,163,4,4,0,1,0
6,176,176,40,40,0,1,0
4,182,182,3,3,0,1,0
1,191,191,5,5,0,1,0
13,255,255,5,1,4,2,1
2,284,284,17,2,15,2,1
8,284,284,39,39,0,1,0
5,358,358,35,35,0,1,0
10,362,362,3,3,0,1,0
15,374,374,81,81,0,1,0
11,379,379,7,7,0,1,0
7,400,400,49,49,0,1,0
14,457,457,139,139,0,1,0

1,103,103,6,2,4,2,1
8,203,203,11,4,7,2,1
5,213,213,11,11,0,1,0
10,219,219,1,1,0,1,0
4,260,260,30,1,29,4,3
6,300,300,22,2,20,2,1
0,308,308,59,30,29,2,1
11,346,346,2,2,0,1,0
9,389,389,8,8,0,1,0
2,405,405,6,6,0,1,0
12,405,405,133,83,50,3,2
3,449,449,89,21,68,4,3
13,484,484,116,76,40,2,1
7,500,500,27,27,0,1,0

13,104,104,3,3,0,1,0
1,108,108,4,4,0,1,0
5,118,118,20,20,0,1,0
12,126,126,6,2,4,2,1
3,136,136,1,1,0,1,0
15,138,138,11,5,6,2,1
11,268,268,102,102,0,1,0
4,272,272,3,3,0,1,0
7,300,300,11,11,0,1,0
6,314,314,9,9,0,1,0
8,324,324,39,5,34,3,2
0,338,338,13,3,10,2,1
2,352,352,13,7,6,2,1
10,357,357,72,63,9,2,1
9,370,370,5,5,0,1,0
14,392,392,34,25,9,2,1
16,393,393,7,7,0,1,0
17,465,465,38,18,20,3,2

1,130,130,4,1,3,2,1
6,134,134,18,18,0,1,0
2,180,180,4,4,0,1,0
5,193,193,4,4,0,1,0
12,197,197,64,64,0,1,0
11,211,211,2,2,0,1,0
17,237,237,3,3,0,1,0
8,258,258,6,6,0,1,0
14,259,259,28,28,0,1,0
4,269,269,17,6,11,2,1
10,332,332,5,5,0,1,0
15,367,367,42,42,0,1,0
9,378,378,16,13,3,2,1
3,425,425,63,48,15,2,1
13,443,443,20,15,5,2,1
7,449,449,73,73,0,1,0
18,474,474,31,18,13,2,1
16,490,490,19,1,18,4,3
0,500,500,15,15,0,1,0

6,111,111,1,1,0,1,0
3,113,113,16,11,5,2,1
10,132,132,8,3,5,2,1
8,181,181,31,15,16,3,2
2,269,269,30,24,6,2,1
4,273,273,41,41,0,1,0
9,322,322,17,17,0,1,0
7,337,337,75,75,0,1,0
1,359,359,56,49,7,2,1
5,360,360,44,44,0,1,0
11,397,397,79,68,11,2,1
12,463,463,1,1,0,1,0
0,498,498,10,10,0,1,0

3,106,106,6,6,0,1,0
7,126,126,8,3,5,2,1
1,143,143,3,3,0,1,0
10,160,160,22,10,12,4,3
6,170,170,17,17,0,1,0
9,206,206,1,1,0,1,0
14,210,210,1,1,0,1,0
2,224,224,9,1,8,2,1
15,234,234,7,7,0,1,0
5,345,345,60,29,31,2,1
12,349,349,51,13,38,3,2
0,379,379,53,6,47,4,3
13,381,381,102,84,18,4,3
11,411,411,51,9,42,2,1
4,415,415,40,40,0,1,0
8,471,471,5,5,0,1,0

1,102,102,2,2,0,1,0
14,103,103,25,25,0,1,0
9,155,155,27,27,0,1,0
5,157,157,21,3,18,4,3
11,158,158,2,2,0,1,0
0,223,223,18,6,12,3,2
12,258,258,10,10,0,1,0
2,261,261,7,7,0,1,0
16,302,302,77,77,0,1,0
8,341,341,45,3,42,3,2
10,344,344,21,21,0,1,0
15,416,416,38,38,0,1,0
3,427,427,3,3,0,1,0
7,433,433,1,1,0,1,0
13,450,450,5,5,0,1,0
4,461,461,54,54,0,1,0
6,478,478,4,4,0,1,0

11,159,159,1,1,0,1,0
6,167,167,7,4,3,2,1
8,169,169,20,10,10,2,1
14,193,193,72,18,54,3,2
4,209,209,11,11,0,1,0
13,211,211,15,15,0,1,0
3,212,212,14,14,0,1,0
10,222,222,26,26,0,1,0
12,242,242,24,5,19,2,1
5,344,344,24,24,0,1,0
2,353,353,8,8,0,1,0
7,363,363,80,45,35,3,2
15,378,378,9,3,6,3,2
1,400,400,36,36,0,1,0
0,432,432,8,8,0,1,0
9,494,494,12,3,9,2,1

7,149,149,9,9,0,1,0
4,169,169,8,2,6,2,1
10,239,239,25,25,0,1,0
6,295,295,41,3,38,3,2
5,343,343,24,1,23,4,3
8,370,370,8,8,0,1,0
11,382,382,39,5,34,2,1
0,406,406,2,2,0,1,0
1,419,419,146,100,46,2,1
2,423,423,93,93,0,1,0
3,471,471,40,40,0,1,0
9,483,483,104,95,9,2,1

13,100,100,1,1,0,1,0
14,113,113,1,1,0,1,0
9,133,133,11,11,0,1,0
0,154,154,18,18,0,1,0
7,160,160,7,7,0,1,0
4,167,167,8,8,0,1,0
8,245,245,33,33,0,1,0
6,273,273,4,4,0,1,0
12,277,277,78,78,0,1,0
5,281,281,45,45,0,1,0
1,375,375,34,23,11,2,1
2,381,381,11,11,0,1,0
3,390,390,79,9,70,3,2
10,407,407,4,4,0,1,0
11,438,438,83,39,44,2,1

10,112,112,30,30,0,1,0
12,115,115,1,1,0,1,0
0,170,170,17,3,14,3,2
7,170,170,22,5,17,2,1
6,187,187,15,1,14,3,2
9,201,201,22,22,0,1,0
3,244,244,31,3,28,2,1
11,355,355,8,3,5,2,1
2,388,388,12,12,0,1,0
8,410,410,44,44,0,1,0
5,431,431,2,2,0,1,0
1,452,452,166,109,57,4,3
4,484,484,35,35,0,1,0

12,206,206,55,21,34,3,2
11,216,216,3,3,0,1,0
4,225,225,3,3,0,1,0
14,257,257,38,38,0,1,0
13,286,286,1,1,0,1,0
6,299,299,1,1,0,1,0
8,351,351,34,30,4,2,1
7,361,361,8,8,0,1,0
10,368,368,44,34,10,2,1
1,382,382,60,23,37,2,1
9,392,392,27,27,0,1,0
0,425,425,33,24,9,4,3
5,427,427,33,3,30,4,3
2,484,484,45,7,38,3,2
3,497,497,128,80,48,4,3

9,131,131,3,3,0,1,0
11,166,166,16,16,0,1,0
4,175,175,55,37,18,4,3
7,178,178,7,7,0,1,0
1,185,185,5,2,3,2,1
2,187,187,39,6,33,4,3
10,231,231,14,5,9,2,1
13,268,268,42,24,18,2,1
8,284,284,78,18,60,3,2
5,367,367,28,28,0,1,0
3,402,402,10,10,0,1,0
12,414,414,28,28,0,1,0
6,467,467,22,15,7,2,1
0,479,479,1,1,0,1,0

6,162,162,12,4,8,2,1
5,165,165,2,2,0,1,0
0,174,174,25,25,0,1,0
11,179,179,1,1,0,1,0
3,209,209,6,6,0,1,0
4,291,291,121,121,0,1,0
7,298,298,8,8,0,1,0
12,315,315,35,35,0,1,0
2,346,346,32,32,0,1,0
10,349,349,27,27,0,1,0
8,375,375,19,19,0,1,0
1,389,389,4,4,0,1,0
9,465,465,170,62,108,4,3

0,159,159,74,26,48,4,3
6,189,189,2,2,0,1,0
9,189,189,14,14,0,1,0
3,296,296,3,3,0,1,0
8,325,325,15,15,0,1,0
7,340,340,36,5,31,2,1
4,346,346,42,42,0,1,0
5,351,351,121,76,45,4,3
2,365,365,29,19,10,2,1
1,457,457,71,71,0,1,0

8,105,105,8,8,0,1,0
12,107,107,4,1,3,2,1
10,144,144,28,28,0,1,0
7,234,234,27,1,26,2,1
5,250,250,13,13,0,1,0
2,268,268,7,7,0,1,0
9,297,297,14,1,13,2,1
11,306,306,51,10,41,2,1
1,307,307,35,19,16,3,2
0,336,336,1,1,0,1,0
3,391,391,68,68,0,1,0
6,400,400,78,78,0,1,0
4,439,439,60,25,35,2,1
13,498,498,41,41,0,1,0

10,146,146,9,3,6,2,1
3,160,160,1,1,0,1,0
6,191,191,19,19,0,1,0
11,193,193,9,9,0,1,0
5,229,229,22,22,0,1,0
8,231,231,15,8,7,2,1
1,256,256,90,57,33,4,3
4,262,262,10,4,6,2,1
9,281,281,95,95,0,1,0
0,288,288,21,21,0,1,0
7,289,289,7,7,0,1,0
13,303,303,14,14,0,1,0
12,334,334,15,15,0,1,0
14,439,439,49,49,0,1,0
2,492,492,7,7,0,1,0

10,158,158,4,4,0,1,0
6,170,170,1,1,0,1,0
4,171,171,20,2,18,2,1
2,181,181,5,5,0,1,0
14,232,232,50,12,38,2,1
8,239,239,25,20,5,2,1
11,263,263,1,1,0,1,0
9,286,286,9,9,0,1,0
12,302,302,28,28,0,1,0
13,387,387,93,1,92,3,2
3,399,399,54,54,0,1,0
0,404,404,23,16,7,2,1
5,427,427,40,40,0,1,0
7,461,461,7,3,4,2,1
1,463,463,116,116,0,1,0

4,101,101,8,5,3,2,1
2,148,148,27,27,0,1,0
10,217,217,2,2,0,1,0
7,223,223,28,24,4,2,1
9,224,224,38,20,18,4,3
3,232,232,43,43,0,1,0
1,250,250,58,54,4,2,1
11,254,254,48,48,0,1,0
5,257,257,4,4,0,1,0
8,387,387,26,12,14,3,2
0,410,410,11,11,0,1,0
6,423,423,57,13,44,3,2

3,109,109,17,8,9,4,3
10,116,116,1,1,0,1,0
7,125,125,3,3,0,1,0
0,200,200,21,21,0,1,0
5,208,208,27,15,12,3,2
8,295,295,43,10,33,2,1
1,397,397,30,6,24,3,2
9,401,401,41,41,0,1,0
11,424,424,27,27,0,1,0
4,446,446,69,5,64,3,2
6,446,446,110,61,49,2,1
2,452,452,95,95,0,1,0

4,115,115,11,11,0,1,0
10,128,128,11,11,0,1,0
15,135,135,4,4,0,1,0
6,136,136,29,29,0,1,0
14,176,176,41,41,0,1,0
1,187,187,5,5,0,1,0
5,196,196,33,3,30,3,2
12,197,197,42,7,35,2,1
2,206,206,6,6,0,1,0
0,275,275,17,7,10,2,1
13,278,278,22,9,13,2,1
11,287,287,24,24,0,1,0
8,299,299,24,8,16,2,1
7,304,304,2,2,0,1,0
9,410,410,1,1,0,1,0
3,437,437,8,8,0,1,0

10,148,148,6,6,0,1,0
14,171,171,33,1,32,2,1
11,178,178,2,2,0,1,0
12,186,186,24,24,0,1,0
1,230,230,10,10,0,1,0
4,251,251,38,2,36,2,1
8,255,255,13,13,0,1,0
2,302,302,26,26,0,1,0
6,311,311,81,81,0,1,0
16,373,373,29,29,0,1,0
13,373,373,45,3,42,3,2
17,375,375,29,17,12,4,3
0,382,382,6,3,3,2,1
9,386,386,1,1,0,1,0
5,450,450,18,18,0,1,0
3,455,455,2,2,0,1,0
7,465,465,4,4,0,1,0
15,471,471,48,13,35,2,1

6,192,192,27,21,6,3,2
1,195,195,1,1,0,1,0
3,196,196,8,8,0,1,0
4,201,201,4,4,0,1,0
16,213,213,10,10,0,1,0
11,218,218,18,13,5,2,1
9,341,341,9,9,0,1,0
5,353,353,7,7,0,1,0
13,354,354,48,48,0,1,0
15,358,358,77,77,0,1,0
17,375,375,10,10,0,1,0
7,376,376,26,14,12,2,1
2,382,382,62,2,60,4,3
10,401,401,23,7,16,4,3
0,434,434,13,13,0,1,0
14,436,436,72,43,29,2,1
8,458,458,59,59,0,1,0
12,460,460,19,4,15,4,3

8,102,102,9,5,4,2,1
11,112,112,21,10,11,2,1
13,120,120,8,8,0,1,0
7,170,170,42,42,0,1,0
14,210,210,4,4,0,1,0
2,219,219,22,22,0,1,0
0,245,245,27,9,18,3,2
1,263,263,11,7,4,2,1
9,296,296,16,16,0,1,0
12,369,369,30,30,0,1,0
4,395,395,25,25,0,1,0
3,454,454,12,12,0,1,0
6,459,459,1,1,0,1,0
10,471,471,102,93,9,4,3
5,478,478,52,10,42,2,1

16,135,135,22,12,10,2,1
15,159,159,26,15,11,2,1
9,166,166,39,39,0,1,0
14,191,191,13,10,3,2,1
8,200,200,23,15,8,3,2
12,210,210,14,6,8,2,1
3,230,230,12,12,0,1,0
5,256,256,12,12,0,1,0
13,258,258,8,2,6,2,1
17,308,308,39,12,27,4,3
11,309,309,32,15,17,2,1
0,324,324,9,9,0,1,0
1,369,369,3,3,0,1,0
6,381,381,10,10,0,1,0
7,395,395,26,26,0,1,0
2,398,398,23,3,20,4,3
4,405,405,23,23,0,1,0
10,470,470,4,4,0,1,0

13,129,129,9,3,6,3,2
17,151,151,10,4,6,3,2
9,228,228,30,30,0,1,0
10,245,245,1,1,0,1,0
14,247,247,17,3,14,3,2
8,282,282,8,5,3,2,1
2,284,284,7,7,0,1,0
6,292,292,26,26,0,1,0
7,346,346,31,31,0,1,0
11,361,361,38,38,0,1,0
15,387,387,6,6,0,1,0
0,388,388,21,21,0,1,0
5,405,405,5,2,3,2,1
16,405,405,52,7,45,2,1
1,408,408,12,12,0,1,0
12,440,440,147,139,8,2,1
4,467,467,31,31,0,1,0
3,491,491,33,33,0,1,0
18,491,491,16,8,8,2,1

1,130,130,14,14,0,1,0
2,149,149,10,10,0,1,0
4,164,164,33,12,21,4,3
11,199,199,37,19,18,3,2
5,210,210,4,4,0,1,0
7,215,215,21,21,0,1,0
13,278,278,11,11,0,1,0
0,301,301,12,9,3,2,1
6,307,307,81,9,72,4,3
8,381,381,5,5,0,1,0
3,390,390,1,1,0,1,0
10,444,444,146,116,30,3,2
12,472,472,15,15,0,1,0
9,493,493,4,4,0,1,0

8,128,128,1,1,0,1,0
4,151,151,51,51,0,1,0
1,187,187,26,14,12,3,2
5,204,204,20,20,0,1,0
7,245,245,17,17,0,1,0
9,317,317,23,23,0,1,0
3,415,415,9,9,0,1,0
2,420,420,224,124,100,4,3
6,422,422,48,48,0,1,0
10,423,423,6,6,0,1,0
0,432,432,3,3,0,1,0

9,103,103,13,13,0,1,0
6,181,181,5,1,4,2,1
7,208,208,15,15,0,1,0
0,209,209,47,47,0,1,0
1,251,251,33,3,30,4,3
3,299,299,35,26,9,2,1
5,356,356,9,1,8,3,2
11,407,407,6,6,0,1,0
2,408,408,21,21,0,1,0
14,408,408,8,8,0,1,0
8,411,411,13,1,12,4,3
10,424,424,60,41,19,4,3
4,448,448,23,14,9,2,1
12,448,448,68,36,32,3,2
13,495,495,111,78,33,4,3

11,103,103,16,4,12,3,2
12,108,108,3,3,0,1,0
18,121,121,12,12,0,1,0
10,159,159,3,3,0,1,0
13,181,181,49,49,0,1,0
4,216,216,6,6,0,1,0
17,238,238,20,11,9,4,3
1,274,274,2,2,0,1,0
14,297,297,22,2,20,4,3
7,347,347,17,17,0,1,0
2,379,379,14,2,12,3,2
6,436,436,39,15,24,4,3
3,461,461,40,40,0,1,0
16,463,463,19,19,0,1,0
5,471,471,12,12,0,1,0
15,475,475,59,17,42,3,2
0,479,479,70,40,30,3,2
9,490,490,15,15,0,1,0
8,492,492,14,3,11,2,1

4,112,112,3,3,0,1,0
9,152,152,4,4,0,1,0
1,177,177,1,1,0,1,0
6,183,183,8,8,0,1,0
12,190,190,3,3,0,1,0
8,200,200,46,46,0,1,0
5,309,309,14,14,0,1,0
2,311,311,16,16,0,1,0
3,328,328,170,119,51,4,3
13,342,342,12,4,8,3,2
11,345,345,17,17,0,1,0
10,361,361,119,2,117,4,3
7,449,449,1,1,0,1,0
14,471,471,15,15,0,1,0
0,500,500,4,4,0,1,0

8,104,104,16,10,6,3,2
9,104,104,35,5,30,3,2
0,155,155,16,16,0,1,0
2,168,168,1,1,0,1,0
10,195,195,19,9,10,3,2
6,235,235,1,1,0,1,0
11,309,309,8,2,6,2,1
5,337,337,71,40,31,2,1
12,339,339,21,21,0,1,0
3,371,371,27,12,15,4,3
7,414,414,16,16,0,1,0
1,423,423,90,90,0,1,0
4,453,453,43,43,0,1,0

4,109,109,4,4,0,1,0
9,124,124,6,6,0,1,0
12,153,153,3,3,0,1,0
11,165,165,20,20,0,1,0
13,201,201,18,2,16,3,2
8,206,206,63,63,0,1,0
10,232,232,26,26,0,1,0
0,266,266,11,3,8,3,2
6,286,286,71,71,0,1,0
3,326,326,30,15,15,2,1
7,380,380,9,9,0,1,0
5,396,396,20,3,17,4,3
2,451,451,23,16,7,2,1
1,458,458,84,84,0,1,0

3,113,113,3,3,0,1,0
12,166,166,5,5,0,1,0
14,191,191,53,50,3,2,1
16,198,198,3,3,0,1,0
4,205,205,22,22,0,1,0
7,226,226,17,17,0,1,0
6,278,278,71,37,34,3,2
1,283,283,35,26,9,2,1
5,288,288,14,14,0,1,0
10,297,297,48,48,0,1,0
8,335,335,1,1,0,1,0
0,366,366,3,3,0,1,0
13,389,389,37,37,0,1,0
15,416,416,48,48,0,1,0
11,429,429,9,3,6,2,1
2,462,462,13,13,0,1,0
9,500,500,12,3,9,4,3

0,182,182,2,2,0,1,0
2,192,192,32,2,30,2,1
11,244,244,9,9,0,1,0
7,267,267,4,4,0,1,0
14,314,314,12,12,0,1,0
1,323,323,55,55,0,1,0
8,335,335,9,9,0,1,0
4,380,380,13,13,0,1,0
6,392,392,23,23,0,1,0
10,393,393,11,1,10,3,2
3,414,414,70,45,25,2,1
13,416,416,9,9,0,1,0
9,424,424,121,31,90,4,3
15,460,460,41,7,34,3,2
12,488,488,102,76,26,2,1
5,500,500,25,25,0,1,0

3,110,110,13,13,0,1,0
12,139,139,10,7,3,2,1
2,167,167,46,3,43,2,1
5,255,255,31,31,0,1,0
6,265,265,7,1,6,3,2
7,307,307,44,31,13,2,1
0,318,318,10,10,0,1,0
11,336,336,76,37,39,2,1
4,337,337,7,7,0,1,0
8,347,347,24,3,21,4,3
9,347,347,22,22,0,1,0
1,362,362,48,48,0,1,0
10,456,456,53,53,0,1,0

2,103,103,1,1,0,1,0
7,110,110,6,6,0,1,0
10,111,111,5,2,3,2,1
13,128,128,6,6,0,1,0
12,178,178,23,13,10,3,2
14,209,209,1,1,0,1,0
16,241,241,14,6,8,3,2
4,244,244,6,6,0,1,0
17,263,263,10,2,8,3,2
11,289,289,8,8,0,1,0
0,298,298,16,16,0,1,0
3,325,325,24,24,0,1,0
18,341,341,58,15,43,2,1
5,343,343,14,14,0,1,0
9,349,349,43,23,20,2,1
15,379,379,102,102,0,1,0
1,426,426,29,29,0,1,0
8,478,478,30,30,0,1,0
6,481,481,57,29,28,4,3

11,108,108,12,12,0,1,0
4,122,122,6,6,0,1,0
9,124,124,5,2,3,2,1
1,136,136,16,16,0,1,0
3,255,255,40,26,14,3,2
2,291,291,12,12,0,1,0
12,367,367,5,5,0,1,0
5,377,377,66,66,0,1,0
7,394,394,54,54,0,1,0
8,454,454,22,22,0,1,0
6,457,457,87,45,42,3,2
10,459,459,80,80,0,1,0
0,475,475,77,77,0,1,0

12,104,104,29,29,0,1,0
3,153,153,17,17,0,1,0
15,170,170,6,1,5,2,1
8,193,193,13,4,9,3,2
9,206,206,6,1,5,2,1
5,225,225,23,23,0,1,0
10,231,231,6,2,4,2,1
0,247,247,27,27,0,1,0
2,277,277,1,1,0,1,0
1,329,329,2,2,0,1,0
14,347,347,90,90,0,1,0
7,352,352,7,7,0,1,0
4,376,376,94,36,58,4,3
13,408,408,40,17,23,2,1
6,432,432,1,1,0,1,0
11,466,466,6,3,3,2,1
16,492,492,2,2,0,1,0

13,136,136,7,1,6,3,2
2,177,177,1,1,0,1,0
6,213,213,19,19,0,1,0
1,233,233,32,32,0,1,0
5,239,239,54,38,16,3,2
10,260,260,72,3,69,4,3
3,272,272,21,12,9,2,1
0,335,335,22,22,0,1,0
8,393,393,10,4,6,2,1
11,395,395,74,74,0,1,0
9,409,409,46,4,42,3,2
14,414,414,13,4,9,2,1
12,432,432,11,5,6,3,2
4,465,465,40,19,21,4,3
7,490,490,7,7,0,1,0

0,104,104,1,1,0,1,0
13,104,104,8,8,0,1,0
8,111,111,6,3,3,2,1
5,124,124,1,1,0,1,0
11,125,125,27,27,0,1,0
4,220,220,52,10,42,2,1
10,241,241,1,1,0,1,0
14,302,302,45,45,0,1,0
12,344,344,63,63,0,1,0
6,377,377,23,23,0,1,0
2,395,395,21,6,15,4,3
3,413,413,85,46,39,2,1
1,414,414,1,1,0,1,0
7,456,456,57,39,18,3,2
9,488,488,16,16,0,1,0

1,140,140,18,18,0,1,0
2,205,205,68,68,0,1,0
5,253,253,9,9,0,1,0
6,267,267,61,61,0,1,0
9,316,316,42,18,24,4,3
10,334,334,63,63,0,1,0
7,349,349,38,38,0,1,0
3,356,356,37,37,0,1,0
0,365,365,50,3,47,2,1
8,375,375,3,3,0,1,0
4,382,382,3,3,0,1,0

13,108,108,11,11,0,1,0
8,129,129,2,2,0,1,0
10,161,161,8,3,5,2,1
1,178,178,28,19,9,2,1
3,246,246,7,7,0,1,0
4,294,294,55,5,50,4,3
11,294,294,28,28,0,1,0
9,333,333,4,4,0,1,0
7,367,367,151,151,0,1,0
0,368,368,62,62,0,1,0
12,427,427,14,8,6,3,2
6,428,428,29,19,10,2,1
5,458,458,38,29,9,4,3
2,489,489,5,5,0,1,0

1,121,121,7,1,6,2,1
10,142,142,53,53,0,1,0
2,157,157,17,17,0,1,0
12,162,162,1,1,0,1,0
4,163,163,1,1,0,1,0
6,165,165,14,14,0,1,0
0,250,250,13,2,11,2,1
8,332,332,10,4,6,3,2
9,419,419,9,9,0,1,0
11,420,420,6,6,0,1,0
7,440,440,83,6,77,4,3
5,466,466,209,177,32,3,2
3,489,489,14,14,0,1,0

0,103,103,46,1,45,4,3
8,122,122,16,16,0,1,0
9,198,198,28,28,0,1,0
4,240,240,70,70,0,1,0
3,253,253,12,8,4,2,1
1,294,294,36,36,0,1,0
6,357,357,3,3,0,1,0
7,383,383,7,7,0,1,0
10,403,403,30,26,4,2,1
2,415,415,36,8,28,2,1
5,435,435,21,14,7,2,1

0,108,108,2,2,0,1,0
3,136,136,4,1,3,2,1
2,189,189,44,33,11,2,1
1,202,202,3,3,0,1,0
10,210,210,19,19,0,1,0
4,253,253,103,46,57,4,3
11,310,310,13,13,0,1,0
5,325,325,20,12,8,3,2
8,403,403,86,86,0,1,0
6,452,452,101,77,24,4,3
9,454,454,10,2,8,2,1
7,495,495,28,28,0,1,0

11,165,165,4,4,0,1,0
6,179,179,18,18,0,1,0
0,185,185,29,20,9,2,1
13,237,237,39,23,16,3,2
4,264,264,48,14,34,4,3
5,308,308,14,2,12,2,1
9,335,335,7,7,0,1,0
1,339,339,11,4,7,2,1
14,368,368,20,2,18,4,3
2,375,375,10,10,0,1,0
8,391,391,19,19,0,1,0
3,394,394,8,2,6,3,2
15,439,439,147,99,48,3,2
12,441,441,5,5,0,1,0
10,444,444,44,8,36,4,3
7,486,486,43,43,0,1,0

14,122,122,11,11,0,1,0
6,143,143,8,8,0,1,0
2,152,152,3,3,0,1,0
11,184,184,1,1,0,1,0
1,186,186,8,2,6,3,2
0,228,228,5,2,3,2,1
3,249,249,44,16,28,4,3
5,261,261,4,4,0,1,0
17,266,266,27,21,6,2,1
7,287,287,49,49,0,1,0
4,336,336,4,4,0,1,0
8,382,382,27,7,20,2,1
16,386,386,180,116,64,4,3
10,392,392,5,5,0,1,0
13,405,405,3,3,0,1,0
9,413,413,42,9,33,2,1
12,446,446,10,10,0,1,0
15,466,466,12,12,0,1,0

6,111,111,4,4,0,1,0
11,135,135,18,6,12,2,1
4,136,136,16,10,6,3,2
9,206,206,6,3,3,2,1
3,309,309,17,11,6,3,2
2,330,330,64,64,0,1,0
10,349,349,144,111,33,4,3
1,370,370,42,8,34,3,2
8,376,376,2,2,0,1,0
7,411,411,23,23,0,1,0
5,424,424,69,35,34,4,3
0,451,451,26,26,0,1,0
12,490,490,22,22,0,1,0

