8,119,119,40,28,12,2,1
22,126,126,1,1,0,1,0
4,165,165,11,11,0,1,0
0,173,173,60,60,0,1,0
15,185,185,37,37,0,1,0
17,247,247,8,8,0,1,0
21,264,264,37,16,21,2,1
20,302,302,30,8,22,3,2
9,307,307,7,1,6,2,1
14,315,315,12,12,0,1,0
5,336,336,19,19,0,1,0
2,398,398,30,30,0,1,0
16,402,402,38,34,4,2,1
7,413,413,65,65,0,1,0
12,418,418,30,30,0,1,0
13,435,435,185,115,70,3,2
18,461,461,18,1,17,2,1
3,468,468,23,23,0,1,0
11,474,474,15,7,8,3,2
6,478,478,11,11,0,1,0
1,494,494,26,23,3,2,1
19,499,499,22,22,0,1,0
10,500,500,7,1,6,3,2

18,109,109,10,4,6,3,2
11,120,120,16,16,0,1,0
21,128,128,1,1,0,1,0
20,128,128,9,5,4,2,1
1,177,177,40,40,0,1,0
16,184,184,9,9,0,1,0
6,201,201,22,22,0,1,0
9,206,206,32,10,22,2,1
15,218,218,46,13,33,2,1
12,219,219,19,19,0,1,0
10,262,262,36,36,0,1,0
5,267,267,18,12,6,3,2
14,278,278,35,35,0,1,0
19,302,302,29,14,15,4,3
8,322,322,3,3,0,1,0
3,350,350,1,1,0,1,0
4,387,387,131,50,81,4,3
2,400,400,51,19,32,4,3
17,421,421,70,40,30,3,2
13,438,438,21,15,6,2,1
0,450,450,30,21,9,4,3
7,459,459,46,46,0,1,0

17,114,114,34,10,24,4,3
20,126,126,5,1,4,2,1
22,136,136,1,1,0,1,0
0,136,136,14,14,0,1,0
9,152,152,14,3,11,2,1
5,153,153,2,2,0,1,0
2,153,153,51,51,0,1,0
15,241,241,9,9,0,1,0
16,248,248,6,3,3,2,1
13,278,278,21,21,0,1,0
23,279,279,48,48,0,1,0
19,309,309,41,9,32,3,2
6,312,312,47,20,27,2,1
8,318,318,31,14,17,2,1
24,325,325,24,24,0,1,0
10,328,328,40,30,10,3,2
14,333,333,29,29,0,1,0
3,384,384,2,2,0,1,0
4,397,397,11,2,9,4,3
1,402,402,4,1,3,2,1
25,425,425,39,39,0,1,0
12,431,431,10,10,0,1,0
18,437,437,19,11,8,2,1
21,441,441,95,52,43,2,1
11,468,468,56,14,42,3,2
7,477,477,13,5,8,3,2

6,104,104,2,2,0,1,0
4,115,115,15,15,0,1,0
28,127,127,10,10,0,1,0
26,155,155,25,25,0,1,0
5,164,164,10,10,0,1,0
1,171,171,38,38,0,1,0
23,198,198,18,18,0,1,0
19,198,198,5,5,0,1,0
8,208,208,13,13,0,1,0
2,212,212,7,7,0,1,0
25,220,220,125,125,0,1,0
24,227,227,16,16,0,1,0
13,292,292,10,10,0,1,0
9,310,310,41,1,40,2,1
11,325,325,67,67,0,1,0
15,330,330,1,1,0,1,0
18,348,348,4,4,0,1,0
21,381,381,13,13,0,1,0
20,389,389,23,23,0,1,0
0,391,391,27,27,0,1,0
27,392,392,18,8,10,3,2
3,412,412,1,1,0,1,0
10,415,415,10,10,0,1,0
12,424,424,13,13,0,1,0
16,430,430,59,21,38,2,1
14,434,434,1,1,0,1,0
17,450,450,2,2,0,1,0
7,451,451,14,14,0,1,0
22,489,489,36,22,14,3,2

20,118,118,40,6,34,3,2
18,139,139,6,6,0,1,0
14,143,143,3,3,0,1,0
9,162,162,18,3,15,4,3
10,173,173,29,29,0,1,0
6,202,202,51,22,29,2,1
0,226,226,2,2,0,1,0
8,230,230,28,28,0,1,0
7,296,296,7,1,6,2,1
15,312,312,31,19,12,3,2
22,323,323,48,48,0,1,0
3,346,346,7,7,0,1,0
21,352,352,55,55,0,1,0
2,388,388,52,52,0,1,0
11,390,390,3,3,0,1,0
13,402,402,2,2,0,1,0
12,418,418,21,21,0,1,0
5,423,423,116,116,0,1,0
1,441,441,37,28,9,4,3
16,451,451,114,104,10,2,1
4,455,455,1,1,0,1,0
17,484,484,31,8,23,2,1
19,492,492,15,12,3,2,1

9,105,105,2,2,0,1,0
21,116,116,4,4,0,1,0
6,155,155,15,5,10,3,2
18,184,184,28,28,0,1,0
8,188,188,1,1,0,1,0
15,196,196,43,11,32,3,2
12,196,196,18,18,0,1,0
25,208,208,5,5,0,1,0
19,209,209,49,49,0,1,0
16,224,224,35,35,0,1,0
10,228,228,43,43,0,1,0
2,248,248,1,1,0,1,0
26,282,282,35,7,28,3,2
3,303,303,4,1,3,2,1
20,310,310,26,26,0,1,0
24,330,330,23,1,22,3,2
13,334,334,47,47,0,1,0
17,336,336,9,9,0,1,0
4,337,337,19,19,0,1,0
11,346,346,35,35,0,1,0
1,368,368,27,27,0,1,0
27,419,419,40,14,26,3,2
5,466,466,20,2,18,4,3
0,473,473,17,17,0,1,0
22,484,484,5,5,0,1,0
23,484,484,102,46,56,3,2
7,484,484,2,2,0,1,0
14,499,499,55,55,0,1,0

27,101,101,27,10,17,4,3
12,121,121,22,1,21,3,2
8,138,138,1,1,0,1,0
9,169,169,19,19,0,1,0
25,174,174,2,2,0,1,0
10,181,181,4,4,0,1,0
18,190,190,36,26,10,2,1
13,219,219,39,39,0,1,0
3,220,220,13,13,0,1,0
15,224,224,15,5,10,3,2
14,231,231,1,1,0,1,0
7,232,232,30,30,0,1,0
1,248,248,3,3,0,1,0
4,278,278,32,2,30,2,1
2,300,300,18,18,0,1,0
26,319,319,11,11,0,1,0
21,364,364,3,3,0,1,0
22,400,400,103,67,36,4,3
23,407,407,12,4,8,3,2
11,410,410,25,7,18,4,3
0,417,417,59,59,0,1,0
19,418,418,47,47,0,1,0
24,452,452,8,8,0,1,0
6,462,462,20,16,4,2,1
20,471,471,59,22,37,4,3
5,483,483,3,3,0,1,0
17,488,488,68,6,62,3,2
16,495,495,14,14,0,1,0

5,112,112,11,11,0,1,0
15,132,132,15,4,11,2,1
14,172,172,3,3,0,1,0
2,181,181,23,23,0,1,0
17,204,204,27,9,18,4,3
19,208,208,30,30,0,1,0
13,262,262,3,3,0,1,0
4,290,290,148,58,90,4,3
10,310,310,16,4,12,2,1
8,333,333,29,29,0,1,0
11,352,352,68,57,11,2,1
1,358,358,3,3,0,1,0
18,371,371,11,11,0,1,0
16,375,375,89,77,12,4,3
3,377,377,6,6,0,1,0
0,421,421,12,12,0,1,0
7,425,425,111,94,17,2,1
6,452,452,69,21,48,4,3
9,480,480,25,25,0,1,0
12,498,498,80,54,26,3,2

22,116,116,10,10,0,1,0
17,152,152,22,22,0,1,0
10,165,165,8,8,0,1,0
18,169,169,72,46,26,4,3
2,227,227,29,6,23,3,2
20,244,244,11,11,0,1,0
5,255,255,21,21,0,1,0
19,263,263,40,40,0,1,0
8,290,290,12,4,8,2,1
13,294,294,15,15,0,1,0
23,299,299,42,5,37,3,2
26,305,305,27,27,0,1,0
16,307,307,4,4,0,1,0
1,320,320,1,1,0,1,0
6,354,354,18,18,0,1,0
4,357,357,25,1,24,3,2
25,380,380,9,9,0,1,0
0,397,397,12,12,0,1,0
24,406,406,20,20,0,1,0
11,409,409,40,40,0,1,0
9,410,410,60,60,0,1,0
7,425,425,17,4,13,2,1
12,446,446,37,8,29,2,1
14,458,458,104,57,47,2,1
15,481,481,8,8,0,1,0
21,488,488,18,6,12,2,1
3,494,494,50,4,46,3,2

10,159,159,19,19,0,1,0
7,168,168,11,11,0,1,0
1,169,169,17,17,0,1,0
9,171,171,10,10,0,1,0
13,176,176,17,9,8,3,2
12,203,203,6,6,0,1,0
5,208,208,36,6,30,2,1
17,223,223,21,2,19,2,1
3,235,235,35,17,18,2,1
19,238,238,10,1,9,2,1
2,243,243,33,3,30,3,2
21,251,251,13,13,0,1,0
0,257,257,8,8,0,1,0
4,285,285,40,40,0,1,0
14,307,307,8,2,6,3,2
18,327,327,26,20,6,2,1
11,328,328,14,5,9,2,1
25,358,358,14,5,9,2,1
24,359,359,18,18,0,1,0
22,373,373,17,17,0,1,0
20,441,441,102,102,0,1,0
23,451,451,191,165,26,3,2
16,465,465,26,26,0,1,0
6,482,482,7,7,0,1,0
15,493,493,38,2,36,4,3
8,497,497,24,24,0,1,0

21,122,122,16,16,0,1,0
8,133,133,14,14,0,1,0
9,134,134,8,1,7,2,1
12,159,159,14,3,11,2,1
11,166,166,10,10,0,1,0
3,172,172,1,1,0,1,0
2,201,201,12,4,8,3,2
4,201,201,15,3,12,2,1
13,203,203,47,40,7,2,1
7,245,245,39,39,0,1,0
1,247,247,1,1,0,1,0
16,256,256,14,4,10,2,1
10,261,261,18,6,12,2,1
0,285,285,34,34,0,1,0
18,311,311,33,33,0,1,0
6,341,341,42,42,0,1,0
24,344,344,114,90,24,3,2
22,363,363,8,8,0,1,0
17,416,416,4,1,3,2,1
15,442,442,6,6,0,1,0
5,443,443,18,6,12,4,3
19,452,452,47,47,0,1,0
20,480,480,27,11,16,3,2
14,481,481,106,10,96,4,3
25,481,481,70,42,28,2,1
23,498,498,8,5,3,2,1

19,130,130,9,9,0,1,0
23,145,145,33,33,0,1,0
17,164,164,16,7,9,4,3
13,165,165,12,12,0,1,0
16,200,200,1,1,0,1,0
7,222,222,4,1,3,2,1
12,269,269,23,23,0,1,0
15,288,288,38,13,25,4,3
8,290,290,60,60,0,1,0
21,311,311,5,5,0,1,0
1,313,313,29,16,13,2,1
20,329,329,75,35,40,2,1
9,334,334,38,38,0,1,0
0,373,373,118,64,54,3,2
3,376,376,24,4,20,3,2
24,377,377,14,5,9,2,1
10,379,379,38,31,7,2,1
14,403,403,32,20,12,2,1
18,416,416,42,42,0,1,0
6,424,424,60,60,0,1,0
11,438,438,1,1,0,1,0
2,463,463,5,5,0,1,0
5,471,471,1,1,0,1,0
22,471,471,74,50,24,4,3
4,472,472,23,23,0,1,0

13,107,107,9,3,6,3,2
20,134,134,5,5,0,1,0
14,160,160,28,4,24,4,3
16,170,170,19,19,0,1,0
4,177,177,11,8,3,2,1
11,185,185,57,43,14,2,1
18,189,189,4,1,3,2,1
6,199,199,3,3,0,1,0
8,225,225,25,17,8,3,2
10,227,227,2,2,0,1,0
21,252,252,4,4,0,1,0
7,267,267,17,2,15,4,3
12,268,268,37,6,31,2,1
3,273,273,84,42,42,4,3
19,310,310,23,5,18,4,3
5,328,328,72,12,60,4,3
9,331,331,36,6,30,2,1
1,350,350,8,8,0,1,0
15,360,360,63,9,54,3,2
2,369,369,66,55,11,2,1
17,389,389,29,19,10,2,1
22,486,486,8,5,3,2,1
0,499,499,52,52,0,1,0

21,101,101,4,4,0,1,0
15,102,102,5,5,0,1,0
17,112,112,5,5,0,1,0
20,117,117,10,2,8,2,1
0,122,122,6,2,4,2,1
22,131,131,14,14,0,1,0
23,141,141,6,6,0,1,0
7,149,149,10,10,0,1,0
6,153,153,2,2,0,1,0
10,167,167,2,2,0,1,0
8,204,204,2,2,0,1,0
3,243,243,15,15,0,1,0
25,276,276,52,52,0,1,0
24,295,295,23,23,0,1,0
16,305,305,47,5,42,3,2
5,308,308,8,3,5,2,1
9,326,326,79,79,0,1,0
12,337,337,3,3,0,1,0
2,367,367,42,42,0,1,0
13,389,389,109,79,30,4,3
11,441,441,94,60,34,2,1
14,446,446,4,4,0,1,0
26,452,452,193,193,0,1,0
4,458,458,21,12,9,3,2
1,469,469,23,23,0,1,0
19,491,491,3,3,0,1,0
18,493,493,12,12,0,1,0

6,122,122,6,6,0,1,0
11,133,133,19,13,6,3,2
15,133,133,5,5,0,1,0
1,156,156,9,1,8,3,2
19,156,156,39,39,0,1,0
17,164,164,23,12,11,3,2
8,169,169,2,2,0,1,0
10,171,171,6,6,0,1,0
12,180,180,18,4,14,2,1
3,226,226,22,22,0,1,0
20,241,241,2,2,0,1,0
2,245,245,4,4,0,1,0
22,268,268,14,14,0,1,0
24,275,275,31,1,30,4,3
7,288,288,12,12,0,1,0
9,297,297,66,48,18,3,2
0,317,317,8,8,0,1,0
5,328,328,40,40,0,1,0
4,338,338,95,49,46,3,2
16,375,375,7,7,0,1,0
23,376,376,6,6,0,1,0
14,388,388,88,88,0,1,0
21,418,418,19,19,0,1,0
18,429,429,74,74,0,1,0
13,437,437,63,26,37,3,2

5,130,130,18,6,12,3,2
21,141,141,14,10,4,2,1
19,160,160,2,2,0,1,0
1,166,166,7,7,0,1,0
28,184,184,1,1,0,1,0
4,190,190,3,3,0,1,0
3,222,222,1,1,0,1,0
24,225,225,34,16,18,3,2
7,258,258,22,12,10,2,1
25,261,261,5,5,0,1,0
11,263,263,38,38,0,1,0
10,272,272,44,29,15,4,3
14,285,285,19,19,0,1,0
23,290,290,3,3,0,1,0
6,290,290,19,19,0,1,0
26,302,302,75,7,68,3,2
20,370,370,119,67,52,3,2
0,376,376,67,28,39,2,1
16,378,378,19,19,0,1,0
13,386,386,5,5,0,1,0
9,397,397,34,7,27,2,1
15,421,421,5,5,0,1,0
12,424,424,6,6,0,1,0
2,435,435,23,3,20,2,1
18,442,442,36,36,0,1,0
17,447,447,28,28,0,1,0
22,455,455,24,24,0,1,0
29,475,475,98,8,90,4,3
27,476,476,7,1,6,2,1
8,492,492,4,4,0,1,0

23,123,123,1,1,0,1,0
16,139,139,17,1,16,3,2
4,151,151,25,25,0,1,0
0,179,179,11,11,0,1,0
5,179,179,14,2,12,2,1
3,186,186,25,7,18,4,3
2,206,206,8,2,6,2,1
24,217,217,5,2,3,2,1
8,222,222,18,18,0,1,0
15,227,227,129,87,42,4,3
1,234,234,13,2,11,2,1
9,253,253,6,6,0,1,0
19,262,262,22,5,17,2,1
7,291,291,8,1,7,2,1
14,316,316,1,1,0,1,0
13,345,345,102,92,10,3,2
22,347,347,7,7,0,1,0
21,395,395,59,59,0,1,0
10,414,414,12,5,7,2,1
25,435,435,41,18,23,4,3
6,442,442,72,3,69,3,2
20,444,444,9,9,0,1,0
12,446,446,6,6,0,1,0
18,451,451,14,14,0,1,0
17,453,453,45,9,36,4,3
11,454,454,16,1,15,2,1

12,105,105,27,13,14,2,1
6,106,106,10,6,4,2,1
9,117,117,13,6,7,2,1
14,118,118,18,18,0,1,0
18,135,135,13,1,12,2,1
4,141,141,3,3,0,1,0
11,147,147,6,1,5,2,1
21,156,156,24,24,0,1,0
0,166,166,7,4,3,2,1
16,169,169,33,33,0,1,0
24,188,188,3,3,0,1,0
1,199,199,23,17,6,2,1
8,250,250,5,2,3,2,1
15,295,295,1,1,0,1,0
3,299,299,35,25,10,2,1
26,299,299,83,45,38,4,3
19,319,319,5,5,0,1,0
20,374,374,49,12,37,2,1
22,378,378,79,79,0,1,0
27,382,382,13,13,0,1,0
17,385,385,19,7,12,2,1
23,394,394,14,14,0,1,0
25,407,407,5,5,0,1,0
13,419,419,3,3,0,1,0
10,444,444,56,13,43,2,1
2,463,463,28,28,0,1,0
5,488,488,15,15,0,1,0
7,500,500,1,1,0,1,0

0,166,166,12,12,0,1,0
1,182,182,22,22,0,1,0
2,188,188,9,9,0,1,0
7,197,197,9,4,5,2,1
13,218,218,1,1,0,1,0
20,259,259,36,15,21,2,1
19,263,263,10,1,9,2,1
3,268,268,87,37,50,4,3
11,279,279,33,33,0,1,0
4,281,281,12,12,0,1,0
14,282,282,42,36,6,2,1
15,307,307,12,6,6,2,1
10,317,317,23,23,0,1,0
9,354,354,5,5,0,1,0
17,359,359,24,13,11,3,2
6,396,396,52,4,48,2,1
16,401,401,88,88,0,1,0
18,403,403,10,1,9,2,1
8,428,428,158,140,18,4,3
12,435,435,148,19,129,4,3
5,481,481,22,1,21,4,3

20,100,100,12,6,6,2,1
12,108,108,9,3,6,3,2
10,113,113,3,3,0,1,0
1,125,125,3,3,0,1,0
17,132,132,1,1,0,1,0
18,148,148,3,3,0,1,0
13,171,171,32,5,27,4,3
7,176,176,18,8,10,4,3
9,194,194,18,18,0,1,0
2,216,216,30,21,9,2,1
19,228,228,9,9,0,1,0
23,233,233,22,7,15,4,3
15,241,241,9,9,0,1,0
16,252,252,83,36,47,2,1
6,268,268,12,12,0,1,0
22,332,332,55,33,22,2,1
3,359,359,59,53,6,3,2
8,366,366,17,17,0,1,0
4,381,381,23,14,9,2,1
11,400,400,8,8,0,1,0
14,418,418,19,19,0,1,0
0,433,433,152,91,61,4,3
21,483,483,51,51,0,1,0
5,487,487,63,63,0,1,0

22,108,108,3,3,0,1,0
16,132,132,8,5,3,2,1
20,141,141,1,1,0,1,0
0,149,149,1,1,0,1,0
7,159,159,13,1,12,3,2
14,193,193,27,27,0,1,0
4,238,238,7,3,4,2,1
6,244,244,82,34,48,4,3
11,245,245,11,11,0,1,0
2,248,248,20,20,0,1,0
18,256,256,18,13,5,2,1
21,308,308,36,19,17,3,2
12,314,314,9,9,0,1,0
24,320,320,34,34,0,1,0
25,340,340,70,31,39,4,3
1,348,348,43,24,19,2,1
23,361,361,30,25,5,2,1
10,363,363,54,7,47,2,1
9,368,368,3,3,0,1,0
8,371,371,1,1,0,1,0
13,381,381,6,6,0,1,0
5,389,389,21,21,0,1,0
17,436,436,113,16,97,3,2
19,440,440,15,15,0,1,0
15,496,496,54,23,31,2,1
3,496,496,119,45,74,3,2

17,140,140,22,22,0,1,0
2,147,147,5,5,0,1,0
16,181,181,29,29,0,1,0
15,190,190,6,6,0,1,0
22,214,214,16,16,0,1,0
9,223,223,25,17,8,3,2
13,227,227,41,13,28,4,3
8,261,261,27,27,0,1,0
5,286,286,12,4,8,2,1
1,296,296,87,7,80,3,2
6,298,298,87,9,78,4,3
0,316,316,6,1,5,2,1
12,316,316,22,22,0,1,0
18,347,347,43,43,0,1,0
3,350,350,24,6,18,4,3
7,371,371,19,10,9,4,3
10,432,432,45,45,0,1,0
21,440,440,4,4,0,1,0
11,445,445,6,3,3,2,1
19,449,449,54,45,9,4,3
14,478,478,28,28,0,1,0
20,491,491,110,92,18,2,1
4,496,496,40,40,0,1,0

10,106,106,31,24,7,2,1
2,174,174,9,1,8,3,2
19,232,232,9,9,0,1,0
6,247,247,17,8,9,4,3
3,271,271,38,38,0,1,0
11,289,289,14,6,8,3,2
13,290,290,3,3,0,1,0
15,294,294,60,60,0,1,0
18,313,313,16,4,12,2,1
0,384,384,29,17,12,3,2
12,389,389,59,59,0,1,0
1,416,416,94,56,38,2,1
5,422,422,68,35,33,4,3
4,423,423,24,24,0,1,0
20,440,440,31,31,0,1,0
8,441,441,159,159,0,1,0
9,442,442,50,50,0,1,0
7,447,447,27,2,25,2,1
14,471,471,45,19,26,2,1
17,491,491,9,2,7,2,1
16,499,499,64,18,46,3,2

11,128,128,2,2,0,1,0
13,137,137,46,46,0,1,0
6,138,138,11,11,0,1,0
14,171,171,1,1,0,1,0
19,179,179,10,10,0,1,0
20,188,188,67,67,0,1,0
15,188,188,1,1,0,1,0
7,198,198,40,40,0,1,0
2,204,204,6,6,0,1,0
5,228,228,74,26,48,3,2
4,233,233,13,4,9,2,1
10,239,239,33,12,21,4,3
12,248,248,31,8,23,2,1
0,333,333,36,22,14,3,2
17,335,335,41,41,0,1,0
3,374,374,99,99,0,1,0
16,375,375,2,2,0,1,0
9,380,380,18,18,0,1,0
8,394,394,15,15,0,1,0
18,408,408,6,3,3,2,1
1,420,420,42,9,33,2,1

14,131,131,16,16,0,1,0
16,169,169,7,7,0,1,0
17,195,195,40,40,0,1,0
11,219,219,4,4,0,1,0
7,234,234,64,64,0,1,0
12,250,250,13,1,12,4,3
22,271,271,19,3,16,3,2
10,274,274,10,3,7,2,1
8,370,370,85,69,16,3,2
3,378,378,77,77,0,1,0
15,397,397,20,20,0,1,0
1,408,408,77,77,0,1,0
20,408,408,66,20,46,2,1
6,415,415,2,2,0,1,0
0,417,417,19,6,13,3,2
13,418,418,10,1,9,2,1
5,422,422,51,51,0,1,0
21,448,448,16,16,0,1,0
18,456,456,7,7,0,1,0
19,481,481,196,127,69,4,3
23,488,488,21,11,10,2,1
2,492,492,1,1,0,1,0
9,493,493,2,2,0,1,0
4,499,499,37,37,0,1,0

1,102,102,9,6,3,2,1
22,104,104,12,8,4,2,1
18,113,113,5,2,3,2,1
5,144,144,1,1,0,1,0
7,148,148,1,1,0,1,0
8,158,158,28,4,24,3,2
4,173,173,28,28,0,1,0
20,183,183,66,42,24,2,1
9,186,186,75,75,0,1,0
3,196,196,8,1,7,2,1
19,203,203,4,4,0,1,0
21,225,225,51,43,8,3,2
10,351,351,23,23,0,1,0
17,352,352,5,5,0,1,0
0,366,366,20,20,0,1,0
12,367,367,14,14,0,1,0
15,378,378,8,8,0,1,0
16,382,382,46,46,0,1,0
11,386,386,13,13,0,1,0
6,442,442,23,19,4,2,1
13,448,448,21,21,0,1,0
14,470,470,88,67,21,4,3
2,475,475,68,18,50,3,2

0,130,130,19,19,0,1,0
5,141,141,5,2,3,2,1
2,144,144,32,18,14,2,1
11,146,146,5,5,0,1,0
16,159,159,23,23,0,1,0
12,184,184,11,11,0,1,0
7,200,200,17,17,0,1,0
23,202,202,68,4,64,4,3
15,218,218,18,3,15,2,1
21,220,220,14,14,0,1,0
9,229,229,3,3,0,1,0
17,243,243,16,5,11,3,2
14,282,282,36,36,0,1,0
13,299,299,30,12,18,2,1
8,308,308,76,76,0,1,0
6,319,319,43,34,9,4,3
19,338,338,5,5,0,1,0
22,357,357,3,3,0,1,0
18,378,378,25,3,22,3,2
3,393,393,78,78,0,1,0
4,407,407,24,16,8,2,1
20,410,410,60,18,42,2,1
1,435,435,7,2,5,2,1
10,439,439,5,5,0,1,0

22,121,121,4,4,0,1,0
0,121,121,8,8,0,1,0
29,130,130,11,11,0,1,0
21,136,136,9,6,3,2,1
31,143,143,21,21,0,1,0
8,160,160,2,2,0,1,0
12,173,173,9,5,4,2,1
16,185,185,13,2,11,2,1
9,185,185,1,1,0,1,0
30,203,203,15,15,0,1,0
1,211,211,51,51,0,1,0
5,223,223,11,11,0,1,0
7,232,232,19,11,8,2,1
10,234,234,34,5,29,2,1
14,235,235,5,5,0,1,0
20,241,241,12,2,10,4,3
18,241,241,2,2,0,1,0
15,275,275,23,23,0,1,0
3,307,307,4,4,0,1,0
6,309,309,14,14,0,1,0
11,309,309,34,34,0,1,0
4,309,309,10,10,0,1,0
25,316,316,41,41,0,1,0
26,346,346,93,17,76,3,2
13,351,351,10,10,0,1,0
28,359,359,13,13,0,1,0
23,386,386,85,5,80,3,2
24,409,409,30,30,0,1,0
2,444,444,10,10,0,1,0
27,465,465,17,17,0,1,0
17,480,480,33,21,12,4,3
19,495,495,21,21,0,1,0

15,107,107,19,5,14,2,1
13,112,112,6,6,0,1,0
18,123,123,2,2,0,1,0
23,127,127,27,27,0,1,0
28,175,175,16,16,0,1,0
22,196,196,50,6,44,3,2
21,210,210,30,20,10,3,2
26,224,224,11,11,0,1,0
8,231,231,5,2,3,2,1
6,256,256,41,7,34,3,2
29,259,259,20,1,19,3,2
12,286,286,16,5,11,2,1
16,294,294,19,19,0,1,0
0,294,294,5,1,4,2,1
17,297,297,6,6,0,1,0
20,305,305,39,8,31,2,1
2,316,316,5,5,0,1,0
19,330,330,8,4,4,2,1
27,334,334,45,45,0,1,0
9,345,345,24,24,0,1,0
14,351,351,2,2,0,1,0
11,359,359,31,4,27,2,1
10,369,369,10,2,8,3,2
25,373,373,27,5,22,2,1
3,380,380,14,9,5,2,1
5,386,386,94,64,30,2,1
1,414,414,30,30,0,1,0
4,448,448,26,26,0,1,0
24,448,448,9,9,0,1,0
7,452,452,7,7,0,1,0

1,118,118,8,2,6,3,2
13,146,146,2,2,0,1,0
2,168,168,17,17,0,1,0
9,182,182,12,4,8,2,1
10,184,184,17,17,0,1,0
15,200,200,4,4,0,1,0
0,207,207,164,71,93,4,3
4,248,248,29,29,0,1,0
12,288,288,91,91,0,1,0
7,295,295,26,26,0,1,0
11,329,329,49,49,0,1,0
3,348,348,43,7,36,3,2
5,379,379,111,23,88,4,3
14,422,422,32,28,4,2,1
16,450,450,9,9,0,1,0
8,493,493,24,24,0,1,0
6,495,495,18,18,0,1,0

12,106,106,17,8,9,2,1
21,109,109,1,1,0,1,0
16,152,152,18,9,9,4,3
19,160,160,23,12,11,2,1
22,166,166,21,5,16,3,2
8,184,184,7,7,0,1,0
15,192,192,22,22,0,1,0
17,270,270,24,24,0,1,0
10,295,295,25,25,0,1,0
7,317,317,5,2,3,2,1
3,344,344,3,3,0,1,0
1,356,356,85,14,71,4,3
6,366,366,4,1,3,2,1
2,377,377,1,1,0,1,0
18,402,402,69,49,20,3,2
4,403,403,33,30,3,2,1
9,404,404,141,51,90,4,3
20,404,404,6,6,0,1,0
13,405,405,29,29,0,1,0
23,410,410,82,68,14,3,2
0,428,428,52,52,0,1,0
5,442,442,91,91,0,1,0
11,450,450,19,1,18,2,1
14,453,453,5,5,0,1,0

3,102,102,11,2,9,4,3
0,129,129,2,2,0,1,0
8,141,141,3,3,0,1,0
25,149,149,5,5,0,1,0
6,182,182,10,6,4,2,1
10,190,190,13,1,12,3,2
1,222,222,67,34,33,4,3
11,229,229,8,8,0,1,0
23,295,295,28,28,0,1,0
7,307,307,15,15,0,1,0
9,311,311,22,22,0,1,0
15,316,316,12,12,0,1,0
14,325,325,90,90,0,1,0
17,347,347,7,3,4,2,1
20,359,359,16,16,0,1,0
12,361,361,19,19,0,1,0
19,362,362,22,22,0,1,0
22,369,369,12,12,0,1,0
18,373,373,70,32,38,3,2
5,387,387,14,8,6,3,2
13,428,428,2,2,0,1,0
21,430,430,15,15,0,1,0
2,433,433,39,39,0,1,0
4,447,447,131,90,41,2,1
24,458,458,130,47,83,4,3
16,492,492,54,7,47,4,3

23,114,114,19,19,0,1,0
7,116,116,6,6,0,1,0
1,116,116,23,17,6,2,1
10,121,121,3,3,0,1,0
22,159,159,9,1,8,2,1
20,166,166,18,3,15,4,3
5,188,188,26,26,0,1,0
21,203,203,76,1,75,4,3
16,226,226,8,8,0,1,0
13,234,234,15,7,8,3,2
8,246,246,16,16,0,1,0
2,336,336,16,10,6,2,1
14,345,345,43,2,41,2,1
4,378,378,23,23,0,1,0
15,407,407,7,7,0,1,0
12,410,410,38,26,12,3,2
6,414,414,82,22,60,3,2
18,417,417,3,3,0,1,0
19,444,444,32,4,28,3,2
3,449,449,1,1,0,1,0
0,460,460,74,74,0,1,0
9,468,468,3,3,0,1,0
11,473,473,117,92,25,4,3
17,475,475,50,50,0,1,0

10,100,100,1,1,0,1,0
20,132,132,46,46,0,1,0
3,143,143,48,22,26,2,1
15,158,158,7,7,0,1,0
4,174,174,24,24,0,1,0
13,187,187,4,4,0,1,0
5,197,197,13,13,0,1,0
0,210,210,74,62,12,2,1
1,212,212,26,26,0,1,0
12,243,243,54,54,0,1,0
19,251,251,7,1,6,3,2
18,260,260,58,29,29,2,1
16,272,272,2,2,0,1,0
9,282,282,58,58,0,1,0
7,301,301,13,13,0,1,0
17,307,307,9,9,0,1,0
8,312,312,19,19,0,1,0
14,362,362,24,24,0,1,0
2,403,403,24,17,7,2,1
11,417,417,12,3,9,4,3
6,485,485,12,12,0,1,0

3,100,100,1,1,0,1,0
8,100,100,10,2,8,3,2
21,102,102,14,1,13,2,1
27,110,110,3,3,0,1,0
25,118,118,15,15,0,1,0
23,122,122,12,12,0,1,0
4,124,124,4,4,0,1,0
35,170,170,45,45,0,1,0
6,190,190,1,1,0,1,0
17,206,206,1,1,0,1,0
10,208,208,1,1,0,1,0
30,210,210,11,1,10,3,2
7,216,216,25,15,10,3,2
36,223,223,23,23,0,1,0
16,227,227,1,1,0,1,0
9,239,239,5,5,0,1,0
26,241,241,16,10,6,3,2
33,253,253,36,15,21,2,1
13,259,259,4,1,3,2,1
32,267,267,6,6,0,1,0
18,339,339,16,16,0,1,0
29,347,347,61,61,0,1,0
34,349,349,40,40,0,1,0
31,352,352,32,16,16,3,2
28,353,353,23,4,19,2,1
20,383,383,26,26,0,1,0
19,397,397,4,4,0,1,0
22,401,401,21,21,0,1,0
37,423,423,38,34,4,2,1
0,426,426,45,45,0,1,0
5,430,430,17,17,0,1,0
11,437,437,6,3,3,2,1
24,441,441,6,6,0,1,0
38,453,453,34,34,0,1,0
1,464,464,28,11,17,2,1
2,466,466,1,1,0,1,0
12,469,469,4,4,0,1,0
15,482,482,16,10,6,3,2
14,499,499,2,2,0,1,0

7,106,106,1,1,0,1,0
10,108,108,24,2,22,4,3
3,122,122,29,29,0,1,0
1,151,151,11,1,10,3,2
2,161,161,1,1,0,1,0
14,168,168,28,28,0,1,0
20,170,170,11,11,0,1,0
6,181,181,10,10,0,1,0
0,215,215,35,16,19,2,1
5,215,215,14,14,0,1,0
17,217,217,34,26,8,3,2
21,220,220,4,4,0,1,0
25,227,227,4,4,0,1,0
13,228,228,6,6,0,1,0
24,238,238,7,7,0,1,0
16,262,262,7,7,0,1,0
9,295,295,16,16,0,1,0
4,305,305,63,63,0,1,0
19,373,373,115,115,0,1,0
12,377,377,5,5,0,1,0
23,393,393,79,73,6,2,1
18,401,401,21,21,0,1,0
11,419,419,7,7,0,1,0
8,419,419,22,2,20,3,2
15,423,423,22,22,0,1,0
22,430,430,57,57,0,1,0

22,108,108,7,4,3,2,1
10,113,113,13,7,6,2,1
9,127,127,28,11,17,2,1
6,131,131,3,3,0,1,0
17,131,131,42,42,0,1,0
18,135,135,4,4,0,1,0
11,158,158,3,3,0,1,0
7,162,162,9,9,0,1,0
14,168,168,2,2,0,1,0
13,189,189,3,3,0,1,0
19,191,191,36,12,24,2,1
21,228,228,68,29,39,2,1
8,231,231,7,7,0,1,0
24,247,247,7,7,0,1,0
2,251,251,47,11,36,4,3
12,271,271,5,5,0,1,0
3,290,290,52,52,0,1,0
5,342,342,10,7,3,2,1
4,355,355,1,1,0,1,0
0,358,358,14,2,12,3,2
20,361,361,35,11,24,2,1
1,367,367,104,99,5,2,1
16,475,475,29,29,0,1,0
15,490,490,36,23,13,2,1
23,491,491,21,21,0,1,0

20,134,134,25,25,0,1,0
4,194,194,22,22,0,1,0
22,202,202,27,17,10,3,2
12,221,221,21,21,0,1,0
11,245,245,4,4,0,1,0
15,246,246,28,28,0,1,0
19,274,274,1,1,0,1,0
7,279,279,12,4,8,3,2
0,303,303,5,5,0,1,0
1,312,312,46,46,0,1,0
2,356,356,7,1,6,2,1
6,360,360,58,22,36,2,1
23,363,363,54,54,0,1,0
13,374,374,5,5,0,1,0
14,385,385,29,29,0,1,0
24,398,398,13,13,0,1,0
18,415,415,93,52,41,2,1
16,423,423,3,3,0,1,0
17,437,437,78,62,16,2,1
9,447,447,89,71,18,4,3
5,453,453,24,24,0,1,0
8,459,459,35,35,0,1,0
10,486,486,1,1,0,1,0
21,486,486,49,29,20,3,2
3,487,487,126,72,54,3,2

13,127,127,5,2,3,2,1
0,135,135,9,3,6,3,2
8,139,139,4,4,0,1,0
20,139,139,10,7,3,2,1
1,172,172,24,24,0,1,0
4,182,182,42,26,16,3,2
17,193,193,30,2,28,3,2
21,219,219,8,8,0,1,0
18,236,236,100,92,8,2,1
2,249,249,35,35,0,1,0
7,266,266,1,1,0,1,0
14,277,277,23,1,22,2,1
22,279,279,20,8,12,4,3
6,291,291,33,33,0,1,0
16,350,350,12,12,0,1,0
19,380,380,26,10,16,2,1
5,384,384,59,59,0,1,0
10,396,396,73,73,0,1,0
3,402,402,31,31,0,1,0
9,438,438,28,6,22,2,1
15,448,448,27,27,0,1,0
11,452,452,34,34,0,1,0
12,487,487,54,54,0,1,0

20,126,126,1,1,0,1,0
22,153,153,14,10,4,2,1
21,175,175,16,12,4,2,1
6,184,184,10,10,0,1,0
12,206,206,15,4,11,2,1
8,217,217,17,3,14,3,2
7,226,226,11,11,0,1,0
3,242,242,14,14,0,1,0
10,258,258,1,1,0,1,0
26,261,261,8,3,5,2,1
19,264,264,33,16,17,4,3
1,272,272,6,2,4,2,1
23,313,313,27,4,23,2,1
9,319,319,2,2,0,1,0
2,340,340,18,18,0,1,0
0,342,342,21,3,18,3,2
15,347,347,3,3,0,1,0
18,347,347,50,43,7,2,1
27,353,353,171,101,70,4,3
17,373,373,10,10,0,1,0
25,408,408,7,7,0,1,0
24,411,411,42,42,0,1,0
5,442,442,48,48,0,1,0
11,444,444,57,11,46,3,2
14,446,446,60,9,51,4,3
13,446,446,152,146,6,2,1
16,449,449,7,1,6,2,1
4,462,462,10,10,0,1,0

13,102,102,9,9,0,1,0
17,173,173,41,41,0,1,0
18,203,203,34,34,0,1,0
12,207,207,12,3,9,4,3
9,211,211,1,1,0,1,0
7,229,229,7,4,3,2,1
5,246,246,6,6,0,1,0
16,260,260,6,6,0,1,0
4,288,288,78,3,75,4,3
2,308,308,36,18,18,2,1
20,319,319,28,16,12,3,2
19,326,326,4,4,0,1,0
11,337,337,27,21,6,3,2
6,356,356,49,49,0,1,0
8,362,362,23,11,12,4,3
10,446,446,35,24,11,2,1
0,452,452,21,10,11,2,1
15,453,453,73,1,72,4,3
3,456,456,108,69,39,4,3
14,474,474,106,106,0,1,0
1,500,500,137,137,0,1,0

10,130,130,6,6,0,1,0
6,159,159,2,2,0,1,0
23,184,184,7,7,0,1,0
11,187,187,17,17,0,1,0
3,190,190,4,4,0,1,0
16,209,209,4,4,0,1,0
21,212,212,12,12,0,1,0
1,224,224,18,6,12,4,3
7,237,237,8,8,0,1,0
18,238,238,53,15,38,3,2
24,267,267,29,29,0,1,0
20,317,317,38,38,0,1,0
17,317,317,16,7,9,4,3
13,340,340,3,3,0,1,0
5,351,351,86,86,0,1,0
0,375,375,7,4,3,2,1
2,378,378,6,6,0,1,0
15,391,391,36,18,18,3,2
19,433,433,141,51,90,4,3
12,435,435,56,34,22,2,1
4,466,466,179,129,50,3,2
22,479,479,70,19,51,4,3
8,483,483,35,29,6,3,2
14,484,484,14,14,0,1,0
9,499,499,26,16,10,3,2

22,140,140,21,13,8,2,1
6,149,149,7,7,0,1,0
5,151,151,7,2,5,2,1
1,162,162,10,2,8,2,1
23,188,188,18,18,0,1,0
14,189,189,10,10,0,1,0
17,192,192,5,2,3,2,1
16,196,196,2,2,0,1,0
12,196,196,16,16,0,1,0
11,199,199,18,18,0,1,0
10,224,224,2,2,0,1,0
26,253,253,6,2,4,2,1
8,268,268,20,12,8,3,2
13,271,271,25,3,22,2,1
18,284,284,111,87,24,4,3
24,313,313,2,2,0,1,0
25,318,318,1,1,0,1,0
21,318,318,20,8,12,2,1
7,342,342,43,11,32,4,3
20,344,344,46,7,39,4,3
27,410,410,6,6,0,1,0
9,415,415,88,88,0,1,0
2,420,420,50,13,37,4,3
29,425,425,44,44,0,1,0
3,427,427,8,8,0,1,0
0,442,442,9,9,0,1,0
28,449,449,61,61,0,1,0
19,462,462,44,44,0,1,0
15,466,466,16,16,0,1,0
4,482,482,39,18,21,4,3

12,131,131,8,4,4,2,1
5,138,138,33,33,0,1,0
20,145,145,22,22,0,1,0
11,169,169,10,2,8,2,1
16,171,171,1,1,0,1,0
23,181,181,9,1,8,3,2
3,206,206,5,5,0,1,0
17,210,210,58,5,53,3,2
27,250,250,17,10,7,2,1
1,271,271,6,6,0,1,0
19,281,281,25,21,4,2,1
13,301,301,15,15,0,1,0
22,328,328,83,26,57,4,3
9,329,329,20,6,14,2,1
10,338,338,9,9,0,1,0
21,354,354,28,2,26,4,3
6,367,367,42,42,0,1,0
7,412,412,10,10,0,1,0
2,423,423,63,3,60,3,2
24,423,423,27,27,0,1,0
14,440,440,10,10,0,1,0
26,445,445,41,23,18,3,2
15,448,448,62,42,20,3,2
4,448,448,39,16,23,2,1
8,461,461,55,41,14,3,2
18,487,487,22,14,8,2,1
0,492,492,1,1,0,1,0
25,493,493,23,1,22,2,1

11,106,106,1,1,0,1,0
28,117,117,15,15,0,1,0
15,122,122,2,2,0,1,0
6,137,137,24,13,11,2,1
27,152,152,6,6,0,1,0
14,155,155,1,1,0,1,0
18,158,158,38,38,0,1,0
0,167,167,3,3,0,1,0
17,203,203,2,2,0,1,0
1,223,223,13,8,5,2,1
26,224,224,17,17,0,1,0
2,244,244,28,28,0,1,0
3,264,264,18,18,0,1,0
13,266,266,4,4,0,1,0
24,281,281,13,4,9,2,1
22,293,293,5,2,3,2,1
4,324,324,45,45,0,1,0
10,356,356,13,13,0,1,0
20,380,380,37,37,0,1,0
7,380,380,23,23,0,1,0
9,386,386,42,42,0,1,0
25,391,391,106,58,48,4,3
19,402,402,82,27,55,4,3
16,429,429,66,66,0,1,0
12,439,439,24,12,12,3,2
5,445,445,35,2,33,2,1
23,457,457,27,27,0,1,0
21,481,481,22,22,0,1,0
8,498,498,44,44,0,1,0

13,108,108,7,7,0,1,0
15,113,113,1,1,0,1,0
1,118,118,18,9,9,2,1
5,139,139,28,28,0,1,0
21,157,157,21,4,17,3,2
20,179,179,3,3,0,1,0
22,206,206,10,10,0,1,0
24,226,226,25,25,0,1,0
7,260,260,10,10,0,1,0
9,260,260,27,21,6,2,1
19,282,282,43,43,0,1,0
25,305,305,26,2,24,2,1
6,321,321,3,3,0,1,0
18,321,321,38,38,0,1,0
4,331,331,7,7,0,1,0
17,361,361,65,25,40,2,1
23,363,363,98,98,0,1,0
14,378,378,5,5,0,1,0
3,395,395,38,38,0,1,0
10,415,415,15,1,14,3,2
12,450,450,29,29,0,1,0
16,467,467,41,41,0,1,0
2,467,467,26,26,0,1,0
0,478,478,110,32,78,4,3
11,486,486,15,15,0,1,0
8,494,494,50,50,0,1,0

17,142,142,11,11,0,1,0
8,180,180,7,7,0,1,0
22,193,193,37,31,6,3,2
9,203,203,10,4,6,2,1
5,204,204,20,20,0,1,0
12,227,227,18,12,6,3,2
0,235,235,78,13,65,4,3
19,238,238,75,37,38,3,2
10,241,241,3,3,0,1,0
23,251,251,6,1,5,2,1
18,257,257,17,3,14,2,1
4,287,287,40,9,31,2,1
15,291,291,52,52,0,1,0
13,306,306,28,3,25,2,1
14,308,308,26,16,10,3,2
24,342,342,47,16,31,2,1
7,350,350,19,19,0,1,0
6,356,356,58,24,34,3,2
16,383,383,3,3,0,1,0
21,383,383,10,10,0,1,0
1,468,468,11,3,8,2,1
11,478,478,20,5,15,2,1
2,481,481,9,3,6,2,1
20,485,485,9,9,0,1,0
3,491,491,75,35,40,3,2

3,120,120,11,11,0,1,0
7,120,120,1,1,0,1,0
10,125,125,2,2,0,1,0
21,130,130,42,42,0,1,0
12,143,143,6,6,0,1,0
8,164,164,3,3,0,1,0
16,213,213,21,3,18,4,3
9,214,214,6,6,0,1,0
26,237,237,32,32,0,1,0
18,238,238,19,11,8,2,1
2,240,240,19,19,0,1,0
17,253,253,11,2,9,4,3
13,258,258,9,9,0,1,0
0,306,306,41,2,39,4,3
23,321,321,10,4,6,2,1
1,323,323,39,39,0,1,0
24,329,329,21,13,8,2,1
19,329,329,25,25,0,1,0
11,331,331,32,32,0,1,0
20,351,351,18,1,17,2,1
28,369,369,25,25,0,1,0
29,372,372,17,17,0,1,0
6,399,399,36,30,6,2,1
25,401,401,33,28,5,2,1
5,413,413,22,16,6,3,2
15,421,421,54,54,0,1,0
27,421,421,56,11,45,3,2
4,445,445,17,3,14,2,1
22,494,494,65,65,0,1,0
14,496,496,40,3,37,3,2

17,117,117,1,1,0,1,0
15,135,135,7,7,0,1,0
7,149,149,2,2,0,1,0
11,164,164,14,8,6,2,1
0,182,182,10,10,0,1,0
10,228,228,51,31,20,2,1
21,243,243,24,4,20,3,2
3,245,245,16,4,12,4,3
22,253,253,85,25,60,4,3
13,266,266,9,5,4,2,1
4,290,290,36,17,19,2,1
12,325,325,16,16,0,1,0
16,331,331,14,14,0,1,0
19,339,339,6,6,0,1,0
14,363,363,42,3,39,2,1
8,389,389,52,52,0,1,0
9,397,397,39,27,12,2,1
6,411,411,15,15,0,1,0
18,413,413,155,125,30,2,1
20,442,442,6,6,0,1,0
2,450,450,100,100,0,1,0
1,469,469,4,4,0,1,0
5,495,495,109,19,90,3,2

2,144,144,19,19,0,1,0
19,152,152,10,7,3,2,1
14,182,182,6,6,0,1,0
18,214,214,38,5,33,4,3
17,232,232,21,21,0,1,0
10,241,241,38,8,30,4,3
8,271,271,38,38,0,1,0
16,291,291,26,26,0,1,0
12,313,313,27,15,12,4,3
20,317,317,5,5,0,1,0
21,320,320,45,45,0,1,0
7,321,321,3,3,0,1,0
13,352,352,19,15,4,2,1
3,361,361,32,32,0,1,0
6,371,371,27,7,20,3,2
0,392,392,32,32,0,1,0
15,403,403,38,22,16,3,2
11,429,429,95,95,0,1,0
5,431,431,109,7,102,4,3
1,467,467,120,120,0,1,0
4,481,481,44,44,0,1,0
9,485,485,36,6,30,4,3

7,116,116,13,8,5,2,1
20,120,120,1,1,0,1,0
4,141,141,12,3,9,4,3
9,158,158,1,1,0,1,0
15,207,207,22,22,0,1,0
11,212,212,3,3,0,1,0
6,214,214,30,14,16,4,3
18,225,225,24,4,20,2,1
21,243,243,30,30,0,1,0
8,306,306,33,21,12,4,3
3,319,319,43,10,33,4,3
22,355,355,51,51,0,1,0
10,365,365,10,4,6,2,1
17,366,366,152,107,45,2,1
12,387,387,30,30,0,1,0
16,411,411,26,10,16,2,1
14,418,418,22,22,0,1,0
2,446,446,56,25,31,2,1
19,453,453,30,11,19,2,1
13,461,461,22,3,19,2,1
5,488,488,165,165,0,1,0
1,495,495,2,2,0,1,0
0,498,498,60,60,0,1,0

0,102,102,18,18,0,1,0
20,143,143,16,10,6,2,1
14,199,199,40,25,15,4,3
8,241,241,19,2,17,2,1
21,241,241,27,5,22,2,1
7,265,265,1,1,0,1,0
1,278,278,27,27,0,1,0
3,312,312,1,1,0,1,0
12,343,343,23,8,15,2,1
6,347,347,25,2,23,2,1
10,356,356,9,1,8,3,2
11,375,375,70,32,38,2,1
18,388,388,21,8,13,2,1
2,405,405,38,23,15,2,1
4,406,406,177,125,52,3,2
19,424,424,46,46,0,1,0
5,441,441,18,14,4,2,1
13,443,443,14,14,0,1,0
9,451,451,79,79,0,1,0
22,452,452,13,7,6,3,2
17,464,464,8,4,4,2,1
15,466,466,10,2,8,3,2
16,499,499,140,50,90,3,2

18,123,123,3,3,0,1,0
4,133,133,1,1,0,1,0
14,139,139,13,13,0,1,0
9,146,146,19,19,0,1,0
23,160,160,3,3,0,1,0
10,162,162,14,1,13,2,1
20,163,163,3,3,0,1,0
19,193,193,63,63,0,1,0
6,209,209,4,4,0,1,0
2,219,219,13,7,6,3,2
16,233,233,21,16,5,2,1
17,255,255,9,9,0,1,0
12,277,277,11,11,0,1,0
21,299,299,107,107,0,1,0
22,320,320,24,3,21,2,1
0,334,334,43,43,0,1,0
3,344,344,47,47,0,1,0
11,361,361,32,32,0,1,0
1,373,373,80,14,66,4,3
15,381,381,9,3,6,3,2
24,411,411,9,3,6,3,2
13,420,420,60,39,21,2,1
7,474,474,56,16,40,3,2
5,478,478,46,46,0,1,0
8,480,480,36,21,15,4,3

3,101,101,13,4,9,4,3
0,111,111,5,5,0,1,0
12,123,123,19,8,11,2,1
4,170,170,18,18,0,1,0
1,180,180,38,25,13,2,1
5,187,187,3,3,0,1,0
24,215,215,22,9,13,2,1
14,242,242,48,24,24,3,2
10,257,257,8,8,0,1,0
13,259,259,3,3,0,1,0
23,262,262,18,18,0,1,0
7,287,287,1,1,0,1,0
22,296,296,53,53,0,1,0
17,332,332,98,98,0,1,0
20,357,357,42,9,33,2,1
19,360,360,6,6,0,1,0
8,365,365,53,53,0,1,0
18,368,368,1,1,0,1,0
6,419,419,14,14,0,1,0
11,422,422,42,21,21,4,3
16,423,423,14,10,4,2,1
2,426,426,70,1,69,4,3
9,431,431,28,25,3,2,1
21,439,439,51,16,35,2,1
15,453,453,35,8,27,2,1

6,141,141,26,6,20,2,1
13,141,141,7,2,5,2,1
0,148,148,41,41,0,1,0
10,204,204,24,24,0,1,0
2,257,257,160,160,0,1,0
8,278,278,40,40,0,1,0
14,307,307,21,21,0,1,0
11,336,336,35,27,8,3,2
1,360,360,109,15,94,3,2
7,368,368,35,35,0,1,0
3,422,422,19,4,15,2,1
5,430,430,25,25,0,1,0
12,431,431,4,4,0,1,0
4,449,449,60,54,6,2,1
9,459,459,97,9,88,3,2

6,101,101,6,6,0,1,0
24,101,101,10,10,0,1,0
15,116,116,22,8,14,3,2
16,175,175,1,1,0,1,0
14,201,201,15,15,0,1,0
21,265,265,19,10,9,4,3
19,274,274,65,65,0,1,0
22,285,285,6,6,0,1,0
5,288,288,2,2,0,1,0
0,291,291,38,23,15,4,3
11,292,292,3,3,0,1,0
8,294,294,6,6,0,1,0
7,298,298,1,1,0,1,0
18,314,314,43,43,0,1,0
10,316,316,82,82,0,1,0
3,326,326,121,71,50,3,2
17,352,352,13,1,12,4,3
25,379,379,51,17,34,2,1
12,413,413,7,7,0,1,0
2,421,421,4,1,3,2,1
1,442,442,18,11,7,2,1
23,462,462,72,49,23,2,1
4,481,481,23,8,15,4,3
13,490,490,20,20,0,1,0
9,494,494,91,19,72,3,2
20,494,494,28,4,24,2,1

17,114,114,11,11,0,1,0
0,124,124,1,1,0,1,0
8,128,128,5,5,0,1,0
16,130,130,15,15,0,1,0
21,132,132,10,10,0,1,0
22,188,188,4,4,0,1,0
14,220,220,8,1,7,3,2
24,221,221,3,3,0,1,0
3,226,226,4,4,0,1,0
23,228,228,10,10,0,1,0
9,289,289,17,17,0,1,0
15,311,311,92,92,0,1,0
6,324,324,39,1,38,2,1
4,329,329,63,63,0,1,0
5,334,334,11,8,3,2,1
12,346,346,28,21,7,2,1
7,368,368,126,126,0,1,0
11,384,384,1,1,0,1,0
13,400,400,51,51,0,1,0
20,402,402,5,2,3,2,1
1,420,420,8,8,0,1,0
2,440,440,16,7,9,4,3
18,446,446,151,71,80,3,2
19,446,446,22,22,0,1,0
10,485,485,122,122,0,1,0

20,113,113,13,7,6,2,1
15,141,141,3,3,0,1,0
16,158,158,20,20,0,1,0
0,162,162,25,9,16,3,2
14,182,182,4,1,3,2,1
19,190,190,9,4,5,2,1
8,192,192,6,6,0,1,0
24,220,220,22,22,0,1,0
25,225,225,3,3,0,1,0
4,290,290,14,14,0,1,0
10,291,291,15,15,0,1,0
7,294,294,5,5,0,1,0
12,315,315,23,23,0,1,0
2,317,317,3,3,0,1,0
11,327,327,52,52,0,1,0
6,338,338,78,68,10,3,2
21,374,374,55,38,17,2,1
23,399,399,74,26,48,4,3
3,400,400,33,33,0,1,0
9,444,444,16,16,0,1,0
17,448,448,12,12,0,1,0
22,452,452,159,143,16,2,1
18,464,464,32,24,8,3,2
13,469,469,97,97,0,1,0
1,469,469,7,3,4,2,1
5,481,481,41,41,0,1,0

6,133,133,7,2,5,2,1
2,145,145,3,3,0,1,0
4,170,170,89,20,69,4,3
15,204,204,8,8,0,1,0
0,240,240,61,48,13,2,1
12,259,259,5,5,0,1,0
16,261,261,2,2,0,1,0
9,271,271,28,28,0,1,0
17,304,304,46,46,0,1,0
10,325,325,57,57,0,1,0
3,350,350,32,23,9,2,1
19,356,356,6,6,0,1,0
11,361,361,39,3,36,4,3
5,385,385,35,35,0,1,0
7,394,394,52,26,26,3,2
8,405,405,38,2,36,4,3
13,417,417,9,9,0,1,0
1,423,423,15,3,12,3,2
18,497,497,48,48,0,1,0
14,499,499,192,192,0,1,0

11,119,119,9,3,6,2,1
30,168,168,8,3,5,2,1
6,183,183,10,7,3,2,1
4,200,200,8,5,3,2,1
18,209,209,16,2,14,2,1
2,213,213,6,6,0,1,0
5,216,216,1,1,0,1,0
15,220,220,15,15,0,1,0
24,268,268,51,9,42,3,2
3,275,275,77,55,22,3,2
27,277,277,33,33,0,1,0
16,282,282,79,50,29,2,1
28,297,297,13,7,6,2,1
9,297,297,26,2,24,2,1
29,309,309,95,52,43,2,1
8,316,316,15,5,10,2,1
26,320,320,52,22,30,2,1
0,324,324,4,1,3,2,1
20,327,327,18,5,13,2,1
7,333,333,4,4,0,1,0
23,334,334,37,5,32,2,1
12,362,362,2,2,0,1,0
1,381,381,3,3,0,1,0
13,410,410,23,1,22,3,2
10,421,421,1,1,0,1,0
17,425,425,21,21,0,1,0
25,438,438,65,35,30,4,3
19,441,441,1,1,0,1,0
14,442,442,7,7,0,1,0
22,487,487,4,4,0,1,0
21,500,500,11,3,8,2,1

5,124,124,19,19,0,1,0
17,142,142,25,25,0,1,0
6,171,171,12,12,0,1,0
14,175,175,1,1,0,1,0
19,194,194,10,10,0,1,0
15,245,245,18,18,0,1,0
1,247,247,89,44,45,2,1
9,248,248,117,43,74,3,2
18,275,275,17,10,7,2,1
10,297,297,8,8,0,1,0
4,306,306,57,33,24,3,2
11,320,320,3,3,0,1,0
8,394,394,31,31,0,1,0
7,410,410,4,4,0,1,0
2,419,419,42,42,0,1,0
12,428,428,68,68,0,1,0
0,429,429,7,3,4,2,1
3,468,468,143,143,0,1,0
13,475,475,46,26,20,2,1
16,491,491,4,4,0,1,0

9,113,113,8,8,0,1,0
17,117,117,1,1,0,1,0
4,120,120,13,13,0,1,0
5,126,126,17,9,8,2,1
13,150,150,7,4,3,2,1
1,154,154,11,11,0,1,0
12,163,163,5,1,4,2,1
7,183,183,16,16,0,1,0
3,203,203,1,1,0,1,0
21,210,210,2,2,0,1,0
8,233,233,6,2,4,2,1
0,245,245,19,2,17,2,1
6,256,256,130,130,0,1,0
19,310,310,22,22,0,1,0
14,325,325,20,20,0,1,0
16,333,333,46,46,0,1,0
10,338,338,24,12,12,2,1
11,358,358,44,35,9,2,1
2,358,358,41,41,0,1,0
20,363,363,42,3,39,2,1
15,426,426,114,64,50,3,2
18,478,478,132,58,74,4,3

16,111,111,1,1,0,1,0
7,143,143,2,2,0,1,0
3,156,156,16,12,4,2,1
0,170,170,11,11,0,1,0
6,187,187,1,1,0,1,0
11,210,210,12,2,10,3,2
20,211,211,29,15,14,3,2
17,214,214,8,8,0,1,0
1,219,219,21,2,19,2,1
15,232,232,4,4,0,1,0
10,261,261,64,64,0,1,0
5,267,267,12,12,0,1,0
9,274,274,24,24,0,1,0
13,282,282,2,2,0,1,0
21,367,367,51,51,0,1,0
8,373,373,73,73,0,1,0
18,373,373,61,61,0,1,0
22,422,422,1,1,0,1,0
4,430,430,110,98,12,2,1
2,430,430,39,39,0,1,0
12,454,454,19,19,0,1,0
14,455,455,84,14,70,4,3
19,466,466,197,103,94,3,2

22,104,104,16,16,0,1,0
8,107,107,26,26,0,1,0
15,110,110,3,3,0,1,0
11,112,112,3,3,0,1,0
3,113,113,12,8,4,2,1
24,141,141,6,6,0,1,0
23,156,156,3,3,0,1,0
5,158,158,7,7,0,1,0
1,180,180,38,18,20,2,1
26,185,185,7,7,0,1,0
6,202,202,19,13,6,3,2
21,210,210,19,19,0,1,0
2,246,246,19,19,0,1,0
25,258,258,84,3,81,4,3
17,273,273,18,18,0,1,0
13,300,300,23,10,13,2,1
4,315,315,1,1,0,1,0
19,334,334,17,3,14,3,2
18,348,348,3,3,0,1,0
16,391,391,150,123,27,4,3
9,405,405,2,2,0,1,0
14,423,423,5,2,3,2,1
12,449,449,97,60,37,4,3
7,451,451,1,1,0,1,0
20,461,461,11,11,0,1,0
10,462,462,30,7,23,3,2
0,484,484,9,6,3,2,1

3,121,121,4,4,0,1,0
0,122,122,4,4,0,1,0
18,147,147,7,7,0,1,0
19,197,197,23,19,4,2,1
12,240,240,9,2,7,2,1
15,287,287,55,7,48,2,1
21,298,298,9,3,6,3,2
13,302,302,105,105,0,1,0
9,303,303,1,1,0,1,0
10,308,308,8,8,0,1,0
14,325,325,18,18,0,1,0
6,332,332,45,45,0,1,0
25,344,344,73,25,48,4,3
1,349,349,70,4,66,3,2
2,384,384,18,1,17,4,3
5,392,392,5,5,0,1,0
17,407,407,102,102,0,1,0
24,420,420,12,12,0,1,0
22,421,421,1,1,0,1,0
20,423,423,75,63,12,4,3
23,423,423,27,5,22,3,2
11,438,438,76,76,0,1,0
4,453,453,62,45,17,2,1
16,455,455,19,4,15,4,3
8,456,456,6,6,0,1,0
7,488,488,1,1,0,1,0

14,113,113,2,2,0,1,0
6,120,120,38,4,34,2,1
1,121,121,6,6,0,1,0
2,147,147,95,45,50,3,2
8,212,212,24,24,0,1,0
0,218,218,39,35,4,2,1
15,233,233,10,10,0,1,0
7,258,258,2,2,0,1,0
10,283,283,3,3,0,1,0
3,310,310,53,40,13,2,1
17,325,325,13,5,8,3,2
12,334,334,57,9,48,4,3
9,344,344,55,25,30,4,3
5,369,369,11,1,10,2,1
11,379,379,9,1,8,2,1
16,379,379,70,16,54,4,3
13,417,417,55,33,22,3,2
4,426,426,54,32,22,4,3

17,105,105,1,1,0,1,0
7,108,108,1,1,0,1,0
2,152,152,7,7,0,1,0
20,157,157,2,2,0,1,0
24,184,184,2,2,0,1,0
27,206,206,14,14,0,1,0
15,210,210,8,8,0,1,0
25,214,214,34,34,0,1,0
16,250,250,16,6,10,2,1
22,276,276,4,4,0,1,0
5,279,279,84,27,57,4,3
10,292,292,9,9,0,1,0
13,310,310,47,47,0,1,0
12,332,332,18,6,12,4,3
21,347,347,188,144,44,2,1
28,354,354,2,2,0,1,0
9,365,365,41,41,0,1,0
3,373,373,14,14,0,1,0
14,382,382,22,22,0,1,0
8,382,382,7,7,0,1,0
4,386,386,30,21,9,4,3
26,386,386,46,46,0,1,0
18,397,397,79,29,50,4,3
0,417,417,30,22,8,2,1
19,480,480,5,1,4,2,1
6,486,486,9,9,0,1,0
11,498,498,56,56,0,1,0
23,499,499,37,28,9,4,3
1,500,500,1,1,0,1,0

0,100,100,10,5,5,2,1
16,119,119,3,3,0,1,0
19,210,210,83,34,49,2,1
20,248,248,32,32,0,1,0
8,261,261,6,6,0,1,0
10,261,261,21,21,0,1,0
15,332,332,5,5,0,1,0
1,349,349,69,17,52,3,2
3,359,359,75,9,66,4,3
12,360,360,40,8,32,3,2
22,360,360,39,39,0,1,0
9,361,361,39,1,38,3,2
5,386,386,23,3,20,4,3
7,395,395,50,50,0,1,0
14,403,403,27,9,18,4,3
4,420,420,19,19,0,1,0
17,422,422,64,16,48,4,3
23,463,463,23,1,22,3,2
2,464,464,42,20,22,2,1
18,488,488,11,3,8,3,2
13,489,489,2,2,0,1,0
6,497,497,19,3,16,2,1
21,498,498,73,7,66,4,3
11,499,499,61,1,60,4,3

11,106,106,7,1,6,3,2
21,116,116,15,15,0,1,0
14,123,123,5,5,0,1,0
1,139,139,41,41,0,1,0
0,162,162,23,23,0,1,0
5,175,175,4,4,0,1,0
15,180,180,4,4,0,1,0
13,200,200,33,5,28,4,3
20,230,230,5,5,0,1,0
16,230,230,27,27,0,1,0
18,274,274,12,12,0,1,0
12,275,275,52,52,0,1,0
2,303,303,11,11,0,1,0
4,320,320,8,8,0,1,0
8,336,336,25,5,20,3,2
9,351,351,17,17,0,1,0
7,425,425,49,5,44,3,2
19,450,450,38,38,0,1,0
10,463,463,81,81,0,1,0
17,476,476,20,20,0,1,0
22,483,483,148,101,47,2,1
3,486,486,71,20,51,4,3
6,494,494,60,60,0,1,0

26,136,136,21,3,18,4,3
8,141,141,6,6,0,1,0
3,142,142,4,4,0,1,0
4,159,159,20,20,0,1,0
15,178,178,25,25,0,1,0
5,191,191,11,11,0,1,0
19,197,197,10,4,6,3,2
7,209,209,4,4,0,1,0
17,211,211,1,1,0,1,0
14,220,220,1,1,0,1,0
20,252,252,4,4,0,1,0
9,255,255,18,13,5,2,1
0,265,265,29,29,0,1,0
16,267,267,23,17,6,3,2
10,294,294,26,2,24,4,3
1,301,301,75,75,0,1,0
25,301,301,20,15,5,2,1
13,364,364,1,1,0,1,0
23,366,366,12,3,9,4,3
22,396,396,27,27,0,1,0
2,397,397,41,19,22,2,1
21,399,399,160,76,84,4,3
12,430,430,19,4,15,4,3
6,439,439,1,1,0,1,0
27,463,463,91,48,43,3,2
18,475,475,47,47,0,1,0
24,487,487,24,9,15,4,3
11,497,497,57,57,0,1,0

12,107,107,34,34,0,1,0
13,121,121,7,7,0,1,0
2,150,150,1,1,0,1,0
19,171,171,17,17,0,1,0
10,181,181,52,52,0,1,0
23,185,185,23,15,8,3,2
16,193,193,25,1,24,3,2
18,206,206,16,16,0,1,0
4,241,241,23,23,0,1,0
9,247,247,30,23,7,2,1
3,278,278,35,17,18,2,1
22,307,307,2,2,0,1,0
7,308,308,1,1,0,1,0
15,329,329,3,3,0,1,0
5,352,352,25,7,18,3,2
6,364,364,84,28,56,3,2
8,372,372,10,10,0,1,0
11,379,379,20,20,0,1,0
14,382,382,31,31,0,1,0
17,399,399,110,80,30,2,1
1,424,424,33,1,32,2,1
21,438,438,16,6,10,3,2
0,460,460,47,7,40,2,1
20,478,478,7,7,0,1,0

11,141,141,2,2,0,1,0
12,144,144,23,9,14,2,1
5,156,156,49,34,15,4,3
25,176,176,39,39,0,1,0
16,187,187,4,4,0,1,0
13,244,244,4,4,0,1,0
6,245,245,17,13,4,2,1
9,258,258,15,15,0,1,0
17,268,268,9,9,0,1,0
2,270,270,6,6,0,1,0
7,304,304,2,2,0,1,0
19,306,306,70,6,64,4,3
1,347,347,12,12,0,1,0
23,348,348,10,10,0,1,0
21,363,363,46,46,0,1,0
22,378,378,31,19,12,4,3
14,395,395,49,6,43,2,1
20,397,397,26,26,0,1,0
4,403,403,23,23,0,1,0
10,423,423,118,118,0,1,0
24,423,423,36,36,0,1,0
15,431,431,28,28,0,1,0
3,432,432,7,7,0,1,0
18,434,434,60,60,0,1,0
0,442,442,34,34,0,1,0
8,474,474,36,5,31,4,3

2,139,139,1,1,0,1,0
27,154,154,16,13,3,2,1
8,168,168,18,18,0,1,0
4,183,183,11,1,10,2,1
15,202,202,9,9,0,1,0
23,207,207,87,66,21,4,3
17,215,215,12,12,0,1,0
18,233,233,16,10,6,3,2
28,235,235,28,6,22,2,1
20,251,251,33,10,23,2,1
12,253,253,53,53,0,1,0
0,280,280,2,2,0,1,0
5,290,290,37,37,0,1,0
3,293,293,33,12,21,4,3
24,313,313,12,12,0,1,0
25,331,331,17,3,14,3,2
19,336,336,28,28,0,1,0
1,345,345,35,35,0,1,0
6,348,348,12,12,0,1,0
10,355,355,4,4,0,1,0
26,369,369,36,2,34,2,1
30,378,378,14,14,0,1,0
29,378,378,3,3,0,1,0
22,401,401,18,18,0,1,0
21,415,415,38,38,0,1,0
16,424,424,5,5,0,1,0
9,440,440,21,14,7,2,1
14,440,440,23,23,0,1,0
11,443,443,29,2,27,2,1
7,444,444,9,9,0,1,0
13,494,494,28,6,22,2,1

4,120,120,11,3,8,3,2
3,131,131,13,8,5,2,1
0,142,142,7,7,0,1,0
16,143,143,6,6,0,1,0
17,170,170,8,3,5,2,1
11,204,204,2,2,0,1,0
7,208,208,11,11,0,1,0
12,231,231,1,1,0,1,0
10,232,232,5,5,0,1,0
6,238,238,40,40,0,1,0
8,309,309,21,21,0,1,0
2,319,319,37,37,0,1,0
1,332,332,177,140,37,4,3
15,358,358,66,66,0,1,0
13,360,360,16,16,0,1,0
14,371,371,85,85,0,1,0
9,434,434,38,24,14,2,1
5,450,450,66,66,0,1,0
18,478,478,207,116,91,4,3

26,115,115,5,2,3,2,1
15,120,120,27,27,0,1,0
14,146,146,17,17,0,1,0
13,156,156,25,10,15,2,1
23,199,199,18,18,0,1,0
24,209,209,9,9,0,1,0
18,230,230,29,29,0,1,0
2,252,252,9,9,0,1,0
17,269,269,4,4,0,1,0
21,286,286,71,71,0,1,0
22,302,302,6,6,0,1,0
11,330,330,57,57,0,1,0
1,351,351,11,11,0,1,0
19,379,379,34,22,12,4,3
25,390,390,29,22,7,2,1
8,393,393,1,1,0,1,0
12,401,401,24,24,0,1,0
9,418,418,31,22,9,4,3
16,424,424,25,13,12,3,2
6,443,443,53,37,16,3,2
0,446,446,45,3,42,4,3
10,451,451,1,1,0,1,0
4,454,454,22,22,0,1,0
20,462,462,88,4,84,3,2
5,475,475,41,41,0,1,0
7,481,481,9,3,6,2,1
3,492,492,86,86,0,1,0

7,114,114,14,7,7,2,1
5,153,153,6,6,0,1,0
23,154,154,7,7,0,1,0
14,166,166,24,8,16,3,2
1,176,176,65,17,48,4,3
2,195,195,20,20,0,1,0
16,195,195,42,42,0,1,0
21,226,226,19,19,0,1,0
12,237,237,35,5,30,2,1
8,254,254,25,25,0,1,0
6,260,260,19,19,0,1,0
18,264,264,7,7,0,1,0
22,288,288,8,2,6,2,1
3,299,299,34,34,0,1,0
20,315,315,27,2,25,4,3
13,317,317,23,12,11,2,1
10,317,317,9,4,5,2,1
11,334,334,4,4,0,1,0
0,374,374,7,3,4,2,1
19,394,394,60,60,0,1,0
17,425,425,45,45,0,1,0
15,454,454,53,53,0,1,0
4,468,468,1,1,0,1,0
9,472,472,105,93,12,3,2

20,127,127,1,1,0,1,0
3,142,142,9,6,3,2,1
19,155,155,3,3,0,1,0
11,180,180,20,20,0,1,0
10,193,193,16,16,0,1,0
5,207,207,9,9,0,1,0
9,231,231,80,60,20,3,2
21,253,253,6,6,0,1,0
12,255,255,20,20,0,1,0
22,257,257,6,6,0,1,0
24,274,274,32,8,24,3,2
13,298,298,37,37,0,1,0
4,304,304,4,4,0,1,0
15,332,332,67,4,63,3,2
16,332,332,18,18,0,1,0
2,356,356,30,30,0,1,0
14,385,385,49,35,14,3,2
7,413,413,53,3,50,2,1
0,416,416,42,12,30,3,2
18,420,420,111,90,21,2,1
17,432,432,100,85,15,4,3
8,435,435,29,17,12,4,3
6,457,457,25,25,0,1,0
23,475,475,10,10,0,1,0
1,478,478,13,7,6,2,1

6,102,102,8,3,5,2,1
12,105,105,2,2,0,1,0
2,119,119,2,2,0,1,0
19,125,125,4,4,0,1,0
22,141,141,15,15,0,1,0
0,159,159,16,6,10,3,2
5,197,197,14,2,12,4,3
20,202,202,20,10,10,3,2
8,207,207,41,24,17,2,1
1,218,218,17,5,12,2,1
16,243,243,19,9,10,3,2
10,253,253,58,58,0,1,0
14,254,254,7,1,6,2,1
9,314,314,20,20,0,1,0
23,362,362,24,24,0,1,0
4,365,365,5,5,0,1,0
11,376,376,65,65,0,1,0
3,392,392,19,4,15,2,1
7,410,410,53,53,0,1,0
15,423,423,1,1,0,1,0
13,448,448,79,67,12,2,1
21,492,492,96,57,39,2,1
17,497,497,58,6,52,3,2
18,499,499,154,52,102,4,3

23,153,153,20,11,9,2,1
10,160,160,4,4,0,1,0
24,181,181,8,1,7,2,1
27,182,182,7,1,6,3,2
25,213,213,1,1,0,1,0
22,214,214,19,19,0,1,0
4,225,225,13,6,7,3,2
9,236,236,7,2,5,2,1
3,241,241,12,5,7,2,1
15,259,259,42,5,37,4,3
13,277,277,21,21,0,1,0
12,279,279,6,6,0,1,0
18,285,285,99,99,0,1,0
29,293,293,16,2,14,3,2
7,308,308,22,22,0,1,0
14,352,352,51,51,0,1,0
26,387,387,9,2,7,2,1
21,402,402,51,51,0,1,0
28,403,403,8,8,0,1,0
16,411,411,46,30,16,3,2
20,419,419,139,127,12,4,3
5,426,426,14,2,12,3,2
2,437,437,1,1,0,1,0
1,440,440,5,5,0,1,0
19,459,459,2,2,0,1,0
11,481,481,66,66,0,1,0
8,483,483,56,56,0,1,0
6,490,490,20,12,8,2,1
17,494,494,28,28,0,1,0
0,497,497,27,11,16,2,1

13,143,143,35,35,0,1,0
23,146,146,40,40,0,1,0
8,167,167,2,2,0,1,0
21,172,172,11,3,8,3,2
1,178,178,1,1,0,1,0
5,181,181,21,21,0,1,0
2,186,186,5,5,0,1,0
26,194,194,4,4,0,1,0
25,212,212,4,4,0,1,0
18,243,243,7,2,5,2,1
24,248,248,14,1,13,2,1
15,267,267,13,13,0,1,0
20,290,290,28,14,14,2,1
0,307,307,3,3,0,1,0
6,319,319,51,4,47,4,3
11,320,320,9,9,0,1,0
22,325,325,13,1,12,4,3
3,328,328,7,7,0,1,0
14,355,355,10,10,0,1,0
16,368,368,31,31,0,1,0
7,397,397,63,18,45,2,1
4,408,408,60,6,54,3,2
9,420,420,23,15,8,3,2
12,427,427,1,1,0,1,0
19,444,444,93,93,0,1,0
10,487,487,90,62,28,3,2
17,490,490,139,77,62,4,3

14,106,106,5,5,0,1,0
0,118,118,3,3,0,1,0
2,127,127,7,3,4,2,1
16,140,140,1,1,0,1,0
9,152,152,4,4,0,1,0
6,167,167,75,75,0,1,0
4,182,182,16,16,0,1,0
15,193,193,9,9,0,1,0
7,197,197,4,1,3,2,1
17,198,198,5,5,0,1,0
3,230,230,8,8,0,1,0
11,244,244,23,9,14,2,1
8,252,252,37,28,9,4,3
1,254,254,19,2,17,4,3
12,261,261,94,56,38,2,1
5,307,307,86,86,0,1,0
20,321,321,2,2,0,1,0
19,358,358,63,46,17,2,1
21,382,382,106,106,0,1,0
13,409,409,14,1,13,2,1
18,468,468,55,55,0,1,0
10,500,500,17,17,0,1,0

20,110,110,26,5,21,4,3
19,127,127,15,15,0,1,0
9,129,129,13,13,0,1,0
13,162,162,7,1,6,3,2
22,164,164,3,3,0,1,0
18,189,189,5,5,0,1,0
17,189,189,39,21,18,4,3
7,193,193,23,13,10,2,1
4,194,194,10,10,0,1,0
11,207,207,48,48,0,1,0
15,213,213,30,12,18,4,3
0,219,219,23,23,0,1,0
23,247,247,60,27,33,4,3
21,269,269,3,3,0,1,0
2,336,336,14,6,8,2,1
16,369,369,8,5,3,2,1
3,373,373,34,22,12,4,3
14,373,373,36,36,0,1,0
25,377,377,20,20,0,1,0
5,377,377,15,12,3,2,1
12,395,395,11,1,10,3,2
10,402,402,35,35,0,1,0
8,413,413,30,4,26,3,2
24,424,424,25,18,7,2,1
6,446,446,8,8,0,1,0
1,487,487,85,85,0,1,0

5,114,114,2,2,0,1,0
22,115,115,1,1,0,1,0
23,118,118,7,4,3,2,1
3,137,137,34,12,22,2,1
0,143,143,10,10,0,1,0
19,144,144,12,12,0,1,0
25,146,146,9,9,0,1,0
7,147,147,6,6,0,1,0
4,160,160,7,1,6,2,1
18,188,188,11,11,0,1,0
20,201,201,41,17,24,2,1
8,203,203,19,19,0,1,0
12,203,203,50,30,20,3,2
24,211,211,72,72,0,1,0
6,234,234,6,6,0,1,0
17,241,241,1,1,0,1,0
2,265,265,1,1,0,1,0
14,309,309,67,64,3,2,1
9,317,317,30,2,28,3,2
21,321,321,49,33,16,3,2
1,323,323,40,40,0,1,0
16,374,374,10,1,9,2,1
10,380,380,51,51,0,1,0
15,390,390,9,9,0,1,0
13,416,416,24,6,18,3,2
11,444,444,1,1,0,1,0

19,100,100,14,2,12,2,1
5,108,108,29,13,16,2,1
0,156,156,1,1,0,1,0
17,163,163,28,1,27,4,3
14,174,174,11,5,6,2,1
11,180,180,4,4,0,1,0
13,209,209,8,3,5,2,1
16,211,211,38,29,9,4,3
20,212,212,59,59,0,1,0
22,215,215,13,13,0,1,0
15,240,240,15,2,13,2,1
2,258,258,8,8,0,1,0
3,266,266,3,3,0,1,0
12,281,281,6,6,0,1,0
8,307,307,66,14,52,4,3
7,319,319,50,16,34,3,2
21,327,327,18,18,0,1,0
9,361,361,9,9,0,1,0
4,393,393,16,1,15,2,1
23,402,402,32,19,13,2,1
10,412,412,19,19,0,1,0
1,420,420,154,154,0,1,0
6,473,473,5,5,0,1,0
18,476,476,40,40,0,1,0

1,102,102,22,2,20,3,2
14,118,118,1,1,0,1,0
12,144,144,31,31,0,1,0
0,151,151,16,16,0,1,0
7,180,180,16,12,4,2,1
6,184,184,76,39,37,2,1
18,192,192,73,73,0,1,0
11,207,207,20,20,0,1,0
13,218,218,4,4,0,1,0
16,226,226,32,32,0,1,0
4,230,230,64,46,18,3,2
9,248,248,4,1,3,2,1
8,252,252,4,1,3,2,1
3,300,300,38,38,0,1,0
5,326,326,2,2,0,1,0
17,330,330,21,3,18,4,3
10,382,382,7,2,5,2,1
2,413,413,23,9,14,3,2
15,500,500,82,82,0,1,0

9,102,102,7,7,0,1,0
2,127,127,1,1,0,1,0
4,132,132,3,3,0,1,0
17,148,148,52,24,28,2,1
14,148,148,9,9,0,1,0
11,153,153,42,42,0,1,0
5,169,169,1,1,0,1,0
0,197,197,3,3,0,1,0
8,212,212,19,11,8,3,2
10,228,228,20,20,0,1,0
12,266,266,4,4,0,1,0
3,280,280,150,150,0,1,0
19,376,376,2,2,0,1,0
18,389,389,9,6,3,2,1
1,403,403,1,1,0,1,0
7,406,406,175,126,49,4,3
6,413,413,74,14,60,4,3
16,415,415,17,11,6,2,1
15,430,430,81,45,36,3,2
13,499,499,6,3,3,2,1

21,104,104,9,9,0,1,0
18,114,114,20,20,0,1,0
12,114,114,4,4,0,1,0
14,117,117,10,4,6,2,1
24,159,159,44,20,24,4,3
3,166,166,12,12,0,1,0
8,172,172,1,1,0,1,0
19,193,193,20,20,0,1,0
9,214,214,21,21,0,1,0
4,215,215,2,2,0,1,0
10,218,218,27,11,16,3,2
22,237,237,18,10,8,3,2
20,261,261,16,4,12,4,3
17,275,275,32,32,0,1,0
1,287,287,15,15,0,1,0
6,290,290,10,1,9,2,1
16,308,308,45,45,0,1,0
0,309,309,36,36,0,1,0
13,345,345,75,61,14,2,1
11,349,349,28,28,0,1,0
2,367,367,12,12,0,1,0
7,368,368,40,23,17,3,2
23,369,369,13,4,9,2,1
15,420,420,57,57,0,1,0
26,432,432,5,5,0,1,0
25,467,467,2,2,0,1,0
5,487,487,65,8,57,4,3

10,106,106,5,2,3,2,1
5,106,106,38,38,0,1,0
9,186,186,21,21,0,1,0
8,230,230,12,3,9,2,1
16,241,241,51,35,16,2,1
6,251,251,68,54,14,2,1
14,263,263,81,69,12,4,3
1,279,279,44,44,0,1,0
17,341,341,6,2,4,2,1
3,367,367,37,37,0,1,0
11,368,368,46,5,41,2,1
13,368,368,2,2,0,1,0
2,425,425,2,2,0,1,0
0,445,445,55,8,47,2,1
4,463,463,86,23,63,3,2
15,491,491,44,44,0,1,0
18,492,492,27,27,0,1,0
7,493,493,11,2,9,2,1
12,496,496,89,84,5,2,1

15,123,123,1,1,0,1,0
6,129,129,1,1,0,1,0
12,142,142,4,4,0,1,0
26,143,143,12,12,0,1,0
7,155,155,2,2,0,1,0
4,180,180,9,9,0,1,0
14,196,196,43,43,0,1,0
22,204,204,8,4,4,2,1
21,214,214,24,16,8,2,1
19,264,264,8,2,6,2,1
1,269,269,30,30,0,1,0
3,275,275,2,2,0,1,0
30,277,277,13,1,12,2,1
0,292,292,1,1,0,1,0
17,311,311,7,7,0,1,0
23,348,348,7,7,0,1,0
13,403,403,8,8,0,1,0
10,410,410,37,37,0,1,0
8,413,413,36,36,0,1,0
27,418,418,31,5,26,2,1
28,421,421,102,26,76,3,2
24,429,429,19,12,7,2,1
18,431,431,25,10,15,4,3
2,436,436,29,29,0,1,0
9,441,441,109,31,78,4,3
29,444,444,44,44,0,1,0
20,469,469,178,74,104,4,3
11,482,482,51,51,0,1,0
5,488,488,4,4,0,1,0
25,491,491,25,7,18,2,1
16,500,500,24,24,0,1,0

8,129,129,30,30,0,1,0
2,133,133,25,11,14,2,1
5,143,143,6,3,3,2,1
14,143,143,21,9,12,4,3
20,166,166,2,2,0,1,0
11,177,177,5,2,3,2,1
7,180,180,3,3,0,1,0
6,235,235,7,3,4,2,1
16,235,235,1,1,0,1,0
23,244,244,13,13,0,1,0
17,248,248,6,6,0,1,0
12,283,283,79,12,67,3,2
22,306,306,86,17,69,4,3
1,377,377,11,3,8,3,2
4,384,384,34,3,31,2,1
10,398,398,5,5,0,1,0
0,441,441,182,38,144,4,3
3,443,443,43,43,0,1,0
13,467,467,62,31,31,2,1
19,473,473,101,61,40,2,1
18,476,476,12,12,0,1,0
9,481,481,13,5,8,2,1
21,481,481,10,7,3,2,1
15,489,489,15,15,0,1,0

19,109,109,10,4,6,2,1
22,125,125,1,1,0,1,0
26,127,127,9,9,0,1,0
2,153,153,5,5,0,1,0
23,167,167,17,17,0,1,0
20,204,204,9,9,0,1,0
7,206,206,33,33,0,1,0
15,239,239,32,32,0,1,0
9,243,243,32,16,16,2,1
18,247,247,1,1,0,1,0
14,279,279,10,7,3,2,1
10,289,289,13,4,9,4,3
24,292,292,117,117,0,1,0
16,293,293,56,56,0,1,0
13,308,308,9,1,8,2,1
3,347,347,20,14,6,2,1
8,373,373,1,1,0,1,0
21,388,388,34,4,30,3,2
4,397,397,1,1,0,1,0
25,406,406,23,23,0,1,0
12,433,433,21,12,9,4,3
17,445,445,13,13,0,1,0
1,448,448,38,5,33,4,3
6,461,461,127,95,32,3,2
5,474,474,4,1,3,2,1
11,485,485,44,44,0,1,0
0,499,499,98,65,33,3,2

16,107,107,5,5,0,1,0
7,112,112,15,7,8,2,1
11,193,193,10,10,0,1,0
13,196,196,102,102,0,1,0
21,219,219,16,2,14,3,2
22,226,226,19,19,0,1,0
2,256,256,45,21,24,3,2
3,261,261,50,50,0,1,0
1,283,283,12,6,6,2,1
6,285,285,1,1,0,1,0
10,288,288,21,21,0,1,0
19,365,365,13,13,0,1,0
5,366,366,65,44,21,4,3
18,371,371,4,4,0,1,0
17,421,421,49,7,42,3,2
15,431,431,38,38,0,1,0
9,440,440,14,14,0,1,0
20,442,442,47,40,7,2,1
8,449,449,65,24,41,2,1
0,458,458,60,60,0,1,0
12,468,468,34,34,0,1,0
4,488,488,47,47,0,1,0
14,495,495,5,5,0,1,0

14,157,157,26,2,24,4,3
11,166,166,36,14,22,3,2
9,188,188,30,24,6,3,2
17,198,198,2,2,0,1,0
3,215,215,10,10,0,1,0
15,219,219,25,25,0,1,0
16,221,221,21,21,0,1,0
19,231,231,13,13,0,1,0
20,236,236,6,6,0,1,0
8,241,241,46,10,36,3,2
10,245,245,46,46,0,1,0
2,292,292,46,28,18,2,1
12,304,304,36,20,16,3,2
18,320,320,11,11,0,1,0
13,336,336,7,7,0,1,0
6,342,342,21,21,0,1,0
21,347,347,64,10,54,3,2
5,367,367,8,8,0,1,0
1,409,409,34,34,0,1,0
4,472,472,121,55,66,3,2
7,482,482,60,13,47,4,3
0,494,494,49,1,48,3,2

3,101,101,15,3,12,2,1
21,137,137,4,4,0,1,0
16,140,140,17,17,0,1,0
8,146,146,1,1,0,1,0
0,182,182,1,1,0,1,0
6,197,197,1,1,0,1,0
11,218,218,32,32,0,1,0
4,221,221,4,4,0,1,0
19,242,242,18,18,0,1,0
23,256,256,9,3,6,2,1
24,261,261,24,15,9,2,1
10,273,273,34,4,30,2,1
7,276,276,6,6,0,1,0
1,293,293,22,22,0,1,0
2,305,305,34,1,33,4,3
20,306,306,31,8,23,3,2
14,317,317,24,3,21,4,3
12,323,323,16,4,12,3,2
18,344,344,97,97,0,1,0
22,346,346,45,23,22,3,2
27,353,353,33,13,20,4,3
5,356,356,83,45,38,3,2
15,371,371,8,5,3,2,1
17,372,372,58,58,0,1,0
13,413,413,17,17,0,1,0
9,425,425,50,50,0,1,0
26,437,437,13,5,8,2,1
25,496,496,38,35,3,2,1

16,112,112,1,1,0,1,0
5,123,123,4,1,3,2,1
19,158,158,12,12,0,1,0
13,168,168,9,9,0,1,0
2,179,179,7,7,0,1,0
21,181,181,3,3,0,1,0
7,200,200,14,2,12,3,2
24,203,203,113,71,42,4,3
3,208,208,4,1,3,2,1
9,211,211,22,22,0,1,0
8,228,228,10,10,0,1,0
18,231,231,8,8,0,1,0
12,240,240,15,15,0,1,0
20,249,249,25,25,0,1,0
28,262,262,21,7,14,3,2
14,305,305,26,26,0,1,0
25,326,326,2,2,0,1,0
10,333,333,20,8,12,3,2
6,358,358,1,1,0,1,0
23,358,358,29,5,24,3,2
11,371,371,1,1,0,1,0
29,413,413,10,1,9,4,3
22,417,417,50,50,0,1,0
27,449,449,25,16,9,2,1
15,460,460,79,52,27,4,3
0,463,463,12,12,0,1,0
1,463,463,17,12,5,2,1
17,469,469,122,33,89,4,3
26,470,470,33,33,0,1,0
4,472,472,57,57,0,1,0

23,109,109,11,2,9,4,3
25,109,109,18,1,17,2,1
21,110,110,3,3,0,1,0
32,120,120,18,12,6,2,1
11,125,125,3,3,0,1,0
20,126,126,15,7,8,2,1
4,142,142,4,4,0,1,0
3,148,148,8,2,6,2,1
14,166,166,2,2,0,1,0
31,178,178,7,3,4,2,1
13,183,183,9,6,3,2,1
26,213,213,9,9,0,1,0
5,235,235,6,6,0,1,0
12,247,247,14,14,0,1,0
28,265,265,5,5,0,1,0
2,276,276,8,8,0,1,0
30,287,287,1,1,0,1,0
15,290,290,12,5,7,2,1
29,290,290,30,20,10,2,1
24,307,307,9,9,0,1,0
18,360,360,14,14,0,1,0
19,372,372,1,1,0,1,0
27,375,375,166,40,126,4,3
10,390,390,85,18,67,3,2
7,409,409,18,7,11,2,1
0,409,409,6,6,0,1,0
1,428,428,35,35,0,1,0
22,430,430,46,46,0,1,0
17,433,433,10,10,0,1,0
6,439,439,88,27,61,4,3
9,452,452,1,1,0,1,0
16,463,463,19,19,0,1,0
8,481,481,49,49,0,1,0

23,112,112,20,20,0,1,0
24,113,113,4,4,0,1,0
19,134,134,11,8,3,2,1
16,155,155,1,1,0,1,0
13,165,165,9,3,6,2,1
29,224,224,3,3,0,1,0
17,240,240,38,38,0,1,0
18,258,258,1,1,0,1,0
5,259,259,24,4,20,3,2
10,262,262,16,16,0,1,0
26,279,279,98,92,6,2,1
2,285,285,8,3,5,2,1
15,288,288,14,14,0,1,0
0,288,288,15,15,0,1,0
21,291,291,5,5,0,1,0
6,299,299,22,1,21,4,3
28,301,301,48,21,27,4,3
25,317,317,1,1,0,1,0
3,327,327,15,15,0,1,0
1,334,334,86,9,77,4,3
7,337,337,3,3,0,1,0
9,337,337,34,5,29,2,1
11,342,342,7,7,0,1,0
20,346,346,114,56,58,4,3
27,367,367,14,14,0,1,0
22,400,400,6,6,0,1,0
4,417,417,13,3,10,2,1
12,439,439,15,15,0,1,0
8,446,446,54,14,40,2,1
14,476,476,3,3,0,1,0

7,114,114,14,5,9,2,1
16,147,147,4,4,0,1,0
2,164,164,55,55,0,1,0
9,186,186,19,10,9,2,1
13,221,221,24,24,0,1,0
6,238,238,53,53,0,1,0
11,251,251,60,60,0,1,0
17,275,275,30,22,8,3,2
18,309,309,20,20,0,1,0
10,316,316,67,67,0,1,0
14,336,336,2,2,0,1,0
15,359,359,76,76,0,1,0
8,360,360,27,27,0,1,0
1,380,380,7,1,6,2,1
21,393,393,2,2,0,1,0
5,416,416,5,5,0,1,0
20,419,419,31,16,15,2,1
19,429,429,47,13,34,2,1
0,453,453,9,9,0,1,0
12,475,475,26,26,0,1,0
3,477,477,31,1,30,2,1
4,478,478,109,51,58,3,2

4,176,176,2,2,0,1,0
0,181,181,1,1,0,1,0
28,183,183,11,2,9,2,1
24,189,189,54,17,37,2,1
32,190,190,34,16,18,4,3
19,194,194,2,2,0,1,0
3,209,209,33,33,0,1,0
6,216,216,11,11,0,1,0
17,231,231,1,1,0,1,0
25,239,239,43,43,0,1,0
10,253,253,7,7,0,1,0
13,289,289,12,5,7,2,1
14,292,292,5,5,0,1,0
23,303,303,37,37,0,1,0
9,308,308,2,2,0,1,0
27,311,311,14,6,8,3,2
30,328,328,41,41,0,1,0
26,329,329,18,18,0,1,0
31,337,337,37,11,26,4,3
15,344,344,11,7,4,2,1
16,353,353,44,39,5,2,1
2,369,369,86,62,24,3,2
8,378,378,5,2,3,2,1
21,381,381,2,2,0,1,0
29,386,386,11,3,8,3,2
12,401,401,22,22,0,1,0
7,423,423,26,16,10,2,1
22,440,440,12,12,0,1,0
18,447,447,41,35,6,3,2
11,466,466,71,21,50,3,2
20,484,484,5,5,0,1,0
1,488,488,4,4,0,1,0
5,490,490,42,42,0,1,0

12,142,142,27,9,18,2,1
28,152,152,6,6,0,1,0
21,182,182,7,7,0,1,0
7,196,196,1,1,0,1,0
8,200,200,1,1,0,1,0
16,243,243,7,7,0,1,0
4,246,246,53,12,41,4,3
5,248,248,25,15,10,3,2
9,260,260,36,36,0,1,0
11,264,264,36,24,12,3,2
25,277,277,33,33,0,1,0
27,292,292,54,28,26,2,1
20,293,293,17,7,10,2,1
14,334,334,3,3,0,1,0
3,339,339,1,1,0,1,0
13,350,350,13,13,0,1,0
2,355,355,44,44,0,1,0
24,356,356,70,70,0,1,0
6,377,377,1,1,0,1,0
22,378,378,81,43,38,3,2
10,385,385,52,52,0,1,0
17,389,389,7,7,0,1,0
15,434,434,4,4,0,1,0
26,440,440,32,17,15,2,1
1,444,444,26,4,22,3,2
18,462,462,39,39,0,1,0
19,491,491,39,39,0,1,0
0,492,492,2,2,0,1,0
23,493,493,55,11,44,3,2

22,105,105,3,3,0,1,0
4,156,156,15,15,0,1,0
13,186,186,26,1,25,2,1
5,203,203,10,10,0,1,0
7,220,220,17,7,10,3,2
10,236,236,49,49,0,1,0
14,236,236,45,10,35,3,2
0,237,237,32,32,0,1,0
1,247,247,87,61,26,4,3
21,270,270,18,18,0,1,0
15,297,297,14,8,6,2,1
3,311,311,31,27,4,2,1
8,341,341,2,2,0,1,0
2,347,347,1,1,0,1,0
18,350,350,63,43,20,2,1
17,356,356,32,23,9,2,1
9,408,408,1,1,0,1,0
6,417,417,73,55,18,4,3
16,437,437,48,48,0,1,0
19,449,449,33,33,0,1,0
11,462,462,27,27,0,1,0
20,468,468,99,99,0,1,0
12,480,480,14,1,13,2,1

2,112,112,12,3,9,2,1
10,115,115,11,3,8,3,2
14,138,138,20,20,0,1,0
17,181,181,11,6,5,2,1
21,196,196,12,12,0,1,0
7,200,200,40,36,4,2,1
13,216,216,1,1,0,1,0
4,217,217,20,20,0,1,0
11,249,249,42,42,0,1,0
18,288,288,6,6,0,1,0
0,322,322,30,21,9,2,1
16,326,326,5,5,0,1,0
1,333,333,10,10,0,1,0
3,369,369,56,6,50,2,1
12,386,386,102,48,54,3,2
22,408,408,18,18,0,1,0
20,410,410,106,30,76,3,2
8,431,431,22,9,13,4,3
5,433,433,105,15,90,3,2
9,443,443,35,22,13,3,2
19,463,463,31,2,29,2,1
15,488,488,55,30,25,2,1
6,494,494,30,30,0,1,0

18,132,132,1,1,0,1,0
0,205,205,66,21,45,2,1
3,232,232,3,3,0,1,0
16,248,248,25,25,0,1,0
11,260,260,2,2,0,1,0
15,277,277,14,5,9,2,1
17,279,279,47,47,0,1,0
10,334,334,105,36,69,3,2
9,350,350,81,12,69,4,3
2,359,359,176,176,0,1,0
14,365,365,2,2,0,1,0
19,387,387,8,1,7,2,1
13,394,394,68,46,22,3,2
7,400,400,20,20,0,1,0
1,400,400,15,15,0,1,0
6,444,444,17,11,6,2,1
5,455,455,96,63,33,4,3
8,478,478,12,8,4,2,1
12,484,484,54,54,0,1,0
4,489,489,19,19,0,1,0

25,101,101,11,11,0,1,0
6,103,103,2,2,0,1,0
22,106,106,2,2,0,1,0
16,146,146,2,2,0,1,0
1,158,158,2,2,0,1,0
29,166,166,3,3,0,1,0
30,179,179,59,56,3,2,1
7,216,216,20,8,12,2,1
3,223,223,25,19,6,2,1
12,224,224,55,55,0,1,0
11,263,263,23,23,0,1,0
24,266,266,15,15,0,1,0
17,307,307,3,3,0,1,0
5,321,321,5,5,0,1,0
10,335,335,61,34,27,4,3
19,350,350,95,33,62,3,2
2,359,359,1,1,0,1,0
15,384,384,6,3,3,2,1
20,403,403,18,18,0,1,0
23,406,406,11,4,7,2,1
26,415,415,13,5,8,2,1
27,416,416,83,19,64,3,2
18,423,423,59,3,56,3,2
9,449,449,29,4,25,2,1
4,450,450,1,1,0,1,0
14,456,456,29,14,15,2,1
13,458,458,3,3,0,1,0
21,471,471,26,8,18,3,2
8,476,476,52,25,27,4,3
28,476,476,31,31,0,1,0
0,489,489,3,3,0,1,0

20,111,111,5,5,0,1,0
8,160,160,26,26,0,1,0
7,173,173,4,4,0,1,0
12,174,174,60,18,42,3,2
4,187,187,5,2,3,2,1
14,210,210,14,8,6,2,1
9,217,217,21,21,0,1,0
1,231,231,37,17,20,2,1
6,232,232,11,3,8,2,1
10,307,307,18,18,0,1,0
13,312,312,34,34,0,1,0
19,313,313,33,33,0,1,0
3,322,322,101,26,75,3,2
5,368,368,23,23,0,1,0
17,389,389,3,3,0,1,0
11,410,410,42,20,22,3,2
2,413,413,123,46,77,4,3
0,439,439,6,6,0,1,0
21,448,448,6,1,5,2,1
15,451,451,46,46,0,1,0
18,452,452,79,79,0,1,0
16,465,465,41,41,0,1,0

31,141,141,19,19,0,1,0
17,145,145,1,1,0,1,0
3,162,162,20,10,10,2,1
26,173,173,3,3,0,1,0
16,179,179,40,29,11,2,1
13,184,184,14,14,0,1,0
20,192,192,16,9,7,2,1
22,201,201,24,24,0,1,0
11,237,237,44,8,36,2,1
15,239,239,8,8,0,1,0
10,243,243,6,6,0,1,0
21,263,263,5,5,0,1,0
8,291,291,27,16,11,2,1
2,303,303,9,9,0,1,0
5,311,311,3,3,0,1,0
4,340,340,9,6,3,2,1
23,343,343,70,38,32,3,2
1,347,347,5,5,0,1,0
30,355,355,71,27,44,3,2
0,370,370,34,34,0,1,0
29,386,386,7,7,0,1,0
25,406,406,39,39,0,1,0
14,424,424,3,3,0,1,0
28,435,435,23,12,11,2,1
12,440,440,31,31,0,1,0
24,443,443,27,27,0,1,0
18,450,450,11,11,0,1,0
19,453,453,15,15,0,1,0
6,456,456,3,3,0,1,0
9,466,466,42,42,0,1,0
7,472,472,14,14,0,1,0
27,500,500,112,76,36,3,2

1,101,101,1,1,0,1,0
7,131,131,2,2,0,1,0
6,175,175,69,69,0,1,0
0,190,190,6,2,4,2,1
14,215,215,5,1,4,2,1
8,225,225,54,24,30,4,3
12,264,264,38,4,34,4,3
3,270,270,106,106,0,1,0
16,282,282,47,21,26,3,2
17,282,282,6,6,0,1,0
15,296,296,17,17,0,1,0
11,309,309,62,62,0,1,0
13,353,353,42,32,10,2,1
5,359,359,5,5,0,1,0
4,370,370,22,1,21,4,3
9,425,425,69,9,60,3,2
10,440,440,1,1,0,1,0
2,441,441,132,60,72,4,3
18,463,463,28,5,23,2,1

11,124,124,3,3,0,1,0
3,158,158,6,6,0,1,0
6,170,170,38,31,7,2,1
10,189,189,4,4,0,1,0
0,192,192,13,3,10,3,2
15,192,192,40,7,33,2,1
8,206,206,2,2,0,1,0
24,225,225,11,3,8,2,1
22,234,234,22,1,21,4,3
19,240,240,11,11,0,1,0
12,248,248,13,6,7,2,1
16,253,253,5,1,4,2,1
2,266,266,1,1,0,1,0
9,270,270,71,38,33,2,1
17,273,273,22,22,0,1,0
4,290,290,20,5,15,4,3
21,303,303,17,8,9,2,1
25,325,325,121,97,24,2,1
7,333,333,63,63,0,1,0
1,350,350,29,29,0,1,0
18,371,371,59,38,21,2,1
14,396,396,17,7,10,3,2
5,444,444,31,8,23,4,3
23,449,449,28,28,0,1,0
20,461,461,12,12,0,1,0
13,496,496,43,19,24,2,1

10,142,142,6,3,3,2,1
25,161,161,4,4,0,1,0
6,200,200,7,1,6,3,2
19,204,204,1,1,0,1,0
27,214,214,30,30,0,1,0
1,232,232,20,20,0,1,0
9,236,236,6,6,0,1,0
8,239,239,19,19,0,1,0
28,239,239,4,1,3,2,1
22,240,240,41,20,21,2,1
16,257,257,6,6,0,1,0
30,277,277,24,24,0,1,0
11,282,282,4,1,3,2,1
4,283,283,25,25,0,1,0
31,284,284,46,11,35,3,2
24,295,295,43,43,0,1,0
32,306,306,90,62,28,2,1
13,306,306,40,40,0,1,0
23,306,306,2,2,0,1,0
17,317,317,19,19,0,1,0
7,319,319,6,6,0,1,0
20,330,330,16,16,0,1,0
21,335,335,10,10,0,1,0
2,346,346,14,10,4,2,1
15,350,350,5,5,0,1,0
0,376,376,12,3,9,2,1
29,409,409,34,34,0,1,0
18,423,423,57,24,33,3,2
26,443,443,28,11,17,2,1
3,447,447,92,1,91,4,3
5,447,447,31,31,0,1,0
12,453,453,14,8,6,2,1
14,478,478,8,8,0,1,0

16,106,106,10,2,8,3,2
30,117,117,1,1,0,1,0
20,117,117,5,5,0,1,0
10,124,124,7,7,0,1,0
1,148,148,1,1,0,1,0
14,190,190,10,2,8,3,2
11,190,190,44,2,42,2,1
26,193,193,51,51,0,1,0
3,244,244,3,3,0,1,0
15,246,246,1,1,0,1,0
31,253,253,16,16,0,1,0
7,265,265,6,6,0,1,0
18,313,313,1,1,0,1,0
5,322,322,29,29,0,1,0
22,339,339,47,20,27,2,1
19,355,355,69,3,66,4,3
4,357,357,30,30,0,1,0
9,364,364,7,7,0,1,0
27,368,368,59,29,30,2,1
25,374,374,49,25,24,4,3
6,389,389,4,4,0,1,0
17,404,404,17,17,0,1,0
29,412,412,39,39,0,1,0
28,432,432,13,13,0,1,0
24,436,436,35,4,31,3,2
2,438,438,5,5,0,1,0
0,444,444,20,7,13,2,1
13,446,446,5,5,0,1,0
23,450,450,11,4,7,2,1
21,458,458,85,85,0,1,0
8,484,484,84,84,0,1,0
12,500,500,18,18,0,1,0

6,126,126,20,20,0,1,0
13,132,132,2,2,0,1,0
10,158,158,13,13,0,1,0
17,164,164,12,3,9,4,3
8,180,180,32,23,9,4,3
0,182,182,49,49,0,1,0
14,196,196,15,11,4,2,1
11,203,203,46,46,0,1,0
3,209,209,1,1,0,1,0
16,241,241,32,8,24,4,3
5,281,281,9,9,0,1,0
9,341,341,53,53,0,1,0
4,386,386,195,195,0,1,0
1,402,402,60,10,50,2,1
2,403,403,33,15,18,2,1
15,405,405,68,27,41,2,1
18,427,427,22,6,16,3,2
7,431,431,10,1,9,3,2
12,480,480,20,20,0,1,0

1,101,101,9,9,0,1,0
11,106,106,17,8,9,4,3
18,113,113,32,25,7,2,1
4,189,189,13,8,5,2,1
10,227,227,5,5,0,1,0
15,234,234,46,27,19,2,1
13,242,242,2,2,0,1,0
0,279,279,49,9,40,3,2
7,281,281,20,14,6,3,2
19,290,290,32,32,0,1,0
12,291,291,38,38,0,1,0
16,340,340,25,14,11,2,1
21,345,345,18,12,6,2,1
9,358,358,12,12,0,1,0
14,365,365,37,28,9,2,1
22,376,376,11,8,3,2,1
2,382,382,72,24,48,3,2
3,398,398,28,28,0,1,0
20,416,416,21,21,0,1,0
8,449,449,127,127,0,1,0
5,454,454,44,44,0,1,0
6,476,476,50,20,30,2,1
17,498,498,18,18,0,1,0

22,114,114,10,2,8,2,1
19,139,139,40,30,10,2,1
6,160,160,15,8,7,2,1
10,164,164,9,2,7,2,1
15,169,169,3,3,0,1,0
21,200,200,7,7,0,1,0
18,205,205,17,5,12,3,2
12,260,260,2,2,0,1,0
0,267,267,38,38,0,1,0
4,271,271,1,1,0,1,0
23,276,276,23,11,12,2,1
20,294,294,24,1,23,2,1
11,304,304,39,23,16,3,2
16,305,305,23,23,0,1,0
7,306,306,8,8,0,1,0
26,306,306,11,11,0,1,0
24,309,309,34,14,20,3,2
13,330,330,9,4,5,2,1
8,364,364,75,63,12,4,3
14,378,378,33,15,18,3,2
27,389,389,3,3,0,1,0
28,409,409,93,66,27,4,3
17,424,424,40,12,28,3,2
9,438,438,5,5,0,1,0
2,450,450,59,49,10,3,2
1,451,451,43,34,9,4,3
3,454,454,39,23,16,2,1
5,462,462,4,4,0,1,0
25,479,479,42,15,27,4,3

18,102,102,4,4,0,1,0
12,118,118,8,2,6,2,1
5,125,125,16,16,0,1,0
0,150,150,51,12,39,4,3
8,168,168,10,10,0,1,0
2,179,179,9,1,8,3,2
14,191,191,1,1,0,1,0
16,242,242,12,1,11,2,1
17,250,250,38,15,23,2,1
1,253,253,38,38,0,1,0
4,266,266,21,6,15,2,1
9,301,301,75,40,35,2,1
10,333,333,133,86,47,2,1
11,420,420,5,5,0,1,0
13,443,443,45,45,0,1,0
3,451,451,160,96,64,3,2
7,467,467,11,4,7,2,1
6,485,485,48,48,0,1,0
15,500,500,32,32,0,1,0

5,138,138,1,1,0,1,0
0,152,152,1,1,0,1,0
11,162,162,4,1,3,2,1
10,164,164,2,2,0,1,0
17,165,165,17,11,6,3,2
2,190,190,14,14,0,1,0
21,254,254,5,5,0,1,0
22,261,261,14,14,0,1,0
18,281,281,3,3,0,1,0
12,312,312,7,7,0,1,0
24,327,327,51,51,0,1,0
19,357,357,98,98,0,1,0
3,365,365,104,4,100,4,3
26,380,380,45,45,0,1,0
9,398,398,35,24,11,2,1
14,405,405,20,4,16,2,1
25,409,409,97,47,50,3,2
1,428,428,91,2,89,4,3
6,462,462,13,13,0,1,0
13,464,464,64,33,31,2,1
27,465,465,48,48,0,1,0
15,468,468,40,40,0,1,0
4,468,468,51,34,17,2,1
23,473,473,52,38,14,2,1
20,475,475,2,2,0,1,0
16,492,492,15,15,0,1,0
8,499,499,3,3,0,1,0
7,499,499,26,23,3,2,1

4,157,157,9,3,6,2,1
22,158,158,38,38,0,1,0
24,183,183,22,10,12,3,2
13,192,192,2,2,0,1,0
19,194,194,1,1,0,1,0
20,210,210,24,6,18,3,2
7,219,219,12,12,0,1,0
5,222,222,14,9,5,2,1
16,225,225,10,4,6,3,2
3,226,226,28,28,0,1,0
12,232,232,14,10,4,2,1
27,245,245,13,13,0,1,0
23,283,283,14,14,0,1,0
32,324,324,9,3,6,2,1
6,334,334,12,5,7,3,2
10,342,342,24,24,0,1,0
14,355,355,51,9,42,3,2
2,357,357,27,27,0,1,0
17,363,363,18,9,9,2,1
28,367,367,66,66,0,1,0
15,368,368,39,20,19,3,2
18,371,371,12,12,0,1,0
11,381,381,17,17,0,1,0
1,385,385,23,23,0,1,0
0,401,401,16,16,0,1,0
29,427,427,126,45,81,4,3
25,428,428,24,14,10,3,2
9,443,443,2,2,0,1,0
21,454,454,39,21,18,4,3
30,454,454,40,13,27,2,1
8,463,463,2,2,0,1,0
31,470,470,9,1,8,3,2
26,498,498,2,2,0,1,0

20,117,117,25,25,0,1,0
10,130,130,3,3,0,1,0
7,145,145,11,11,0,1,0
15,145,145,40,11,29,2,1
14,148,148,7,1,6,2,1
17,153,153,4,4,0,1,0
0,176,176,10,10,0,1,0
18,195,195,3,3,0,1,0
8,199,199,50,4,46,3,2
21,210,210,7,7,0,1,0
13,234,234,8,2,6,3,2
11,264,264,17,6,11,2,1
19,268,268,3,3,0,1,0
1,279,279,5,5,0,1,0
12,317,317,107,107,0,1,0
5,354,354,71,71,0,1,0
22,359,359,9,3,6,2,1
9,364,364,43,14,29,2,1
4,429,429,49,25,24,4,3
16,430,430,30,21,9,2,1
3,442,442,84,30,54,4,3
23,446,446,60,16,44,2,1
6,494,494,16,16,0,1,0
2,498,498,28,28,0,1,0

4,121,121,31,31,0,1,0
9,136,136,12,7,5,2,1
5,143,143,3,3,0,1,0
7,158,158,1,1,0,1,0
20,167,167,34,34,0,1,0
18,181,181,12,12,0,1,0
0,211,211,7,2,5,2,1
24,212,212,48,48,0,1,0
19,225,225,49,2,47,2,1
3,252,252,2,2,0,1,0
21,254,254,24,24,0,1,0
14,267,267,15,10,5,2,1
16,288,288,7,1,6,2,1
13,299,299,18,18,0,1,0
17,300,300,21,21,0,1,0
2,304,304,2,2,0,1,0
10,314,314,48,48,0,1,0
25,362,362,63,3,60,4,3
8,397,397,20,12,8,2,1
1,403,403,14,14,0,1,0
12,439,439,6,6,0,1,0
6,447,447,18,4,14,3,2
15,469,469,22,8,14,3,2
22,475,475,1,1,0,1,0
23,487,487,24,24,0,1,0
11,497,497,213,189,24,4,3

3,101,101,5,5,0,1,0
9,113,113,21,12,9,4,3
11,150,150,19,7,12,4,3
1,160,160,19,1,18,3,2
0,167,167,51,48,3,2,1
18,191,191,10,10,0,1,0
5,198,198,6,2,4,2,1
4,218,218,1,1,0,1,0
22,284,284,16,9,7,2,1
16,302,302,6,6,0,1,0
2,336,336,16,16,0,1,0
14,339,339,3,3,0,1,0
13,343,343,100,100,0,1,0
17,360,360,17,17,0,1,0
15,370,370,41,19,22,3,2
20,378,378,50,41,9,2,1
8,380,380,15,15,0,1,0
19,401,401,60,60,0,1,0
6,416,416,55,55,0,1,0
21,428,428,6,3,3,2,1
7,433,433,59,59,0,1,0
10,435,435,66,66,0,1,0
12,460,460,95,80,15,4,3

19,118,118,20,6,14,2,1
18,130,130,16,8,8,3,2
2,147,147,7,7,0,1,0
26,162,162,40,40,0,1,0
1,187,187,39,39,0,1,0
22,190,190,31,13,18,3,2
25,191,191,8,5,3,2,1
8,193,193,4,4,0,1,0
5,224,224,21,21,0,1,0
24,224,224,23,23,0,1,0
28,305,305,12,12,0,1,0
14,312,312,6,6,0,1,0
11,317,317,8,8,0,1,0
17,334,334,9,1,8,2,1
23,353,353,69,56,13,2,1
21,361,361,17,7,10,2,1
6,368,368,35,25,10,2,1
7,369,369,7,7,0,1,0
0,382,382,69,36,33,3,2
27,401,401,22,8,14,3,2
13,412,412,9,9,0,1,0
9,430,430,15,9,6,2,1
3,431,431,81,58,23,2,1
20,439,439,6,6,0,1,0
10,463,463,20,4,16,4,3
15,467,467,13,1,12,4,3
16,468,468,44,44,0,1,0
12,475,475,12,9,3,2,1
4,489,489,28,19,9,4,3

13,105,105,3,3,0,1,0
21,109,109,4,4,0,1,0
6,117,117,12,6,6,3,2
17,145,145,14,11,3,2,1
0,146,146,2,2,0,1,0
2,168,168,17,17,0,1,0
24,169,169,15,11,4,2,1
5,231,231,71,58,13,2,1
26,234,234,21,6,15,2,1
4,254,254,14,5,9,4,3
14,255,255,4,4,0,1,0
20,257,257,1,1,0,1,0
3,259,259,13,6,7,2,1
23,273,273,6,6,0,1,0
10,275,275,18,3,15,2,1
16,296,296,58,58,0,1,0
19,316,316,61,61,0,1,0
15,318,318,23,23,0,1,0
18,320,320,63,41,22,2,1
11,349,349,6,6,0,1,0
25,352,352,38,3,35,3,2
1,419,419,6,6,0,1,0
8,425,425,53,17,36,3,2
7,464,464,33,18,15,4,3
22,471,471,55,38,17,2,1
9,472,472,55,21,34,4,3
12,500,500,59,13,46,2,1

23,106,106,7,7,0,1,0
10,117,117,13,13,0,1,0
12,130,130,7,2,5,2,1
27,141,141,21,3,18,3,2
18,168,168,29,29,0,1,0
16,176,176,12,12,0,1,0
11,180,180,7,3,4,2,1
5,194,194,6,6,0,1,0
8,208,208,8,8,0,1,0
21,248,248,4,4,0,1,0
7,285,285,18,12,6,2,1
9,296,296,21,21,0,1,0
6,308,308,13,5,8,2,1
13,313,313,9,9,0,1,0
3,341,341,12,12,0,1,0
26,347,347,28,28,0,1,0
4,348,348,4,4,0,1,0
25,351,351,70,70,0,1,0
17,354,354,10,10,0,1,0
0,357,357,44,35,9,4,3
20,393,393,15,8,7,2,1
14,403,403,40,18,22,2,1
15,411,411,68,38,30,3,2
24,426,426,31,4,27,2,1
1,452,452,34,34,0,1,0
22,465,465,18,9,9,2,1
2,474,474,101,101,0,1,0
19,482,482,139,139,0,1,0

8,119,119,6,6,0,1,0
26,142,142,19,19,0,1,0
3,143,143,4,4,0,1,0
16,144,144,1,1,0,1,0
24,160,160,5,5,0,1,0
18,161,161,1,1,0,1,0
30,162,162,3,3,0,1,0
2,163,163,1,1,0,1,0
29,199,199,12,6,6,3,2
22,221,221,23,20,3,2,1
11,230,230,9,9,0,1,0
27,238,238,32,20,12,2,1
14,287,287,18,18,0,1,0
9,299,299,17,17,0,1,0
31,319,319,37,24,13,2,1
25,355,355,4,4,0,1,0
15,366,366,7,7,0,1,0
13,395,395,2,2,0,1,0
0,396,396,22,22,0,1,0
20,408,408,91,40,51,4,3
19,429,429,11,11,0,1,0
6,444,444,43,43,0,1,0
10,445,445,36,24,12,2,1
28,447,447,40,13,27,4,3
17,450,450,54,54,0,1,0
4,453,453,9,9,0,1,0
23,468,468,135,135,0,1,0
1,468,468,120,120,0,1,0
5,471,471,11,3,8,3,2
21,482,482,2,2,0,1,0
7,485,485,19,11,8,3,2
12,490,490,99,89,10,3,2

9,123,123,4,4,0,1,0
14,174,174,15,3,12,4,3
11,185,185,4,1,3,2,1
17,188,188,21,21,0,1,0
15,194,194,10,10,0,1,0
19,203,203,41,31,10,2,1
16,229,229,10,10,0,1,0
7,237,237,16,16,0,1,0
4,273,273,43,43,0,1,0
0,276,276,26,26,0,1,0
1,336,336,46,46,0,1,0
3,362,362,67,34,33,4,3
13,377,377,31,31,0,1,0
10,402,402,26,20,6,3,2
2,424,424,44,44,0,1,0
18,434,434,16,16,0,1,0
6,439,439,30,30,0,1,0
8,460,460,111,105,6,2,1
20,460,460,124,60,64,4,3
12,464,464,101,34,67,4,3
5,490,490,72,72,0,1,0

1,100,100,11,11,0,1,0
15,106,106,23,23,0,1,0
11,129,129,10,10,0,1,0
19,133,133,9,9,0,1,0
9,173,173,1,1,0,1,0
5,181,181,36,36,0,1,0
8,185,185,31,31,0,1,0
13,209,209,41,41,0,1,0
16,260,260,12,12,0,1,0
4,336,336,9,9,0,1,0
0,349,349,16,16,0,1,0
2,349,349,26,26,0,1,0
12,376,376,37,37,0,1,0
17,383,383,81,81,0,1,0
7,385,385,140,101,39,4,3
3,396,396,15,15,0,1,0
10,397,397,12,12,0,1,0
6,417,417,71,51,20,3,2
21,419,419,3,3,0,1,0
14,441,441,30,24,6,3,2
20,454,454,84,18,66,4,3
18,498,498,8,8,0,1,0

16,109,109,11,6,5,2,1
12,117,117,8,8,0,1,0
22,120,120,4,4,0,1,0
21,159,159,23,23,0,1,0
4,177,177,41,15,26,3,2
2,222,222,7,7,0,1,0
18,223,223,7,2,5,2,1
23,247,247,14,14,0,1,0
15,252,252,37,37,0,1,0
20,252,252,8,8,0,1,0
13,285,285,69,69,0,1,0
11,343,343,30,1,29,4,3
9,350,350,16,16,0,1,0
5,362,362,25,25,0,1,0
1,363,363,100,100,0,1,0
8,370,370,32,5,27,4,3
0,377,377,78,30,48,2,1
19,384,384,84,24,60,3,2
7,390,390,4,4,0,1,0
3,396,396,30,16,14,2,1
6,450,450,17,17,0,1,0
17,459,459,33,33,0,1,0
14,464,464,42,9,33,2,1
10,468,468,20,14,6,2,1

24,122,122,6,6,0,1,0
1,132,132,13,5,8,2,1
19,155,155,4,4,0,1,0
15,165,165,4,4,0,1,0
3,174,174,1,1,0,1,0
4,179,179,50,50,0,1,0
23,183,183,18,12,6,3,2
18,201,201,25,1,24,4,3
0,218,218,4,4,0,1,0
26,230,230,32,32,0,1,0
21,264,264,84,84,0,1,0
17,269,269,19,19,0,1,0
5,278,278,4,4,0,1,0
25,284,284,3,3,0,1,0
10,289,289,7,7,0,1,0
2,293,293,35,18,17,4,3
22,305,305,74,74,0,1,0
8,316,316,1,1,0,1,0
12,325,325,50,29,21,4,3
13,330,330,7,7,0,1,0
28,343,343,14,3,11,2,1
6,350,350,4,4,0,1,0
16,364,364,21,16,5,2,1
27,376,376,13,13,0,1,0
11,414,414,31,16,15,2,1
20,440,440,27,7,20,3,2
14,461,461,29,29,0,1,0
7,475,475,52,52,0,1,0
9,477,477,59,23,36,3,2

17,100,100,8,4,4,2,1
26,101,101,8,5,3,2,1
11,107,107,9,5,4,2,1
24,124,124,10,10,0,1,0
21,150,150,6,6,0,1,0
18,151,151,3,3,0,1,0
6,162,162,6,2,4,2,1
4,168,168,1,1,0,1,0
27,191,191,41,5,36,2,1
0,202,202,9,9,0,1,0
14,202,202,3,3,0,1,0
10,216,216,10,5,5,2,1
19,216,216,31,23,8,2,1
13,224,224,2,2,0,1,0
3,234,234,7,7,0,1,0
22,273,273,16,4,12,2,1
1,274,274,111,64,47,2,1
8,308,308,6,6,0,1,0
9,318,318,26,20,6,3,2
12,323,323,19,19,0,1,0
28,412,412,139,55,84,4,3
15,414,414,32,14,18,4,3
20,420,420,18,1,17,2,1
25,422,422,46,15,31,4,3
5,424,424,8,2,6,3,2
2,442,442,102,72,30,4,3
7,478,478,13,13,0,1,0
16,493,493,5,5,0,1,0
23,500,500,12,12,0,1,0

19,109,109,8,8,0,1,0
3,150,150,23,23,0,1,0
2,153,153,9,9,0,1,0
20,166,166,61,61,0,1,0
18,178,178,4,4,0,1,0
8,206,206,4,4,0,1,0
15,220,220,11,2,9,2,1
9,229,229,1,1,0,1,0
4,240,240,54,54,0,1,0
1,253,253,44,44,0,1,0
11,256,256,1,1,0,1,0
13,278,278,17,11,6,2,1
16,286,286,2,2,0,1,0
6,296,296,57,14,43,4,3
21,318,318,23,3,20,2,1
22,333,333,45,45,0,1,0
12,351,351,103,77,26,2,1
5,370,370,75,75,0,1,0
14,374,374,46,27,19,2,1
0,431,431,9,9,0,1,0
7,460,460,24,24,0,1,0
17,465,465,8,8,0,1,0
10,498,498,49,49,0,1,0

2,130,130,5,5,0,1,0
15,135,135,12,12,0,1,0
6,157,157,8,5,3,2,1
5,160,160,22,4,18,3,2
0,162,162,3,3,0,1,0
1,193,193,33,26,7,2,1
14,213,213,51,51,0,1,0
11,232,232,7,7,0,1,0
4,233,233,35,35,0,1,0
8,239,239,24,7,17,2,1
16,242,242,18,7,11,4,3
18,243,243,27,18,9,2,1
9,243,243,2,2,0,1,0
10,278,278,64,47,17,2,1
3,305,305,125,47,78,4,3
7,322,322,72,72,0,1,0
19,335,335,37,37,0,1,0
13,387,387,20,20,0,1,0
12,405,405,46,1,45,4,3
17,480,480,30,30,0,1,0

5,109,109,4,4,0,1,0
12,128,128,6,1,5,2,1
17,150,150,3,3,0,1,0
3,170,170,17,17,0,1,0
22,174,174,18,15,3,2,1
6,195,195,32,20,12,3,2
20,211,211,16,16,0,1,0
9,212,212,49,49,0,1,0
13,234,234,4,4,0,1,0
14,250,250,75,52,23,2,1
10,268,268,19,9,10,2,1
23,269,269,15,15,0,1,0
25,289,289,11,6,5,2,1
8,313,313,25,6,19,2,1
21,320,320,40,40,0,1,0
19,326,326,20,20,0,1,0
0,337,337,22,22,0,1,0
15,340,340,6,2,4,2,1
11,391,391,54,49,5,2,1
7,404,404,1,1,0,1,0
16,417,417,55,55,0,1,0
2,448,448,63,63,0,1,0
1,461,461,45,21,24,4,3
18,472,472,30,9,21,4,3
24,489,489,112,4,108,4,3
4,496,496,5,5,0,1,0

1,108,108,3,3,0,1,0
12,109,109,17,17,0,1,0
9,121,121,21,21,0,1,0
20,122,122,12,12,0,1,0
0,125,125,16,1,15,4,3
6,131,131,42,6,36,4,3
2,173,173,57,39,18,4,3
17,189,189,12,12,0,1,0
10,242,242,14,14,0,1,0
15,244,244,39,9,30,3,2
22,266,266,20,6,14,4,3
21,267,267,49,23,26,2,1
4,330,330,2,2,0,1,0
11,345,345,3,3,0,1,0
19,388,388,34,34,0,1,0
16,393,393,15,15,0,1,0
8,413,413,37,37,0,1,0
18,417,417,26,18,8,2,1
7,433,433,1,1,0,1,0
5,454,454,18,18,0,1,0
14,473,473,3,3,0,1,0
3,476,476,12,1,11,4,3
13,490,490,136,65,71,3,2

9,106,106,19,14,5,2,1
12,115,115,13,13,0,1,0
20,117,117,6,6,0,1,0
2,201,201,90,90,0,1,0
10,214,214,12,12,0,1,0
18,223,223,2,2,0,1,0
0,232,232,5,5,0,1,0
8,234,234,25,7,18,4,3
11,235,235,25,1,24,4,3
5,291,291,2,2,0,1,0
15,318,318,124,98,26,2,1
16,331,331,14,14,0,1,0
17,357,357,49,2,47,4,3
4,361,361,46,3,43,2,1
7,364,364,23,10,13,2,1
14,385,385,31,31,0,1,0
6,400,400,42,42,0,1,0
13,430,430,3,3,0,1,0
19,431,431,21,2,19,2,1
3,464,464,141,141,0,1,0
1,491,491,9,9,0,1,0

9,110,110,33,1,32,2,1
6,146,146,9,9,0,1,0
0,166,166,8,8,0,1,0
8,176,176,2,2,0,1,0
17,177,177,14,3,11,2,1
23,188,188,2,2,0,1,0
3,230,230,3,3,0,1,0
21,249,249,4,4,0,1,0
15,255,255,75,75,0,1,0
7,260,260,49,49,0,1,0
12,278,278,28,15,13,2,1
18,312,312,11,3,8,2,1
10,329,329,11,11,0,1,0
19,332,332,9,9,0,1,0
4,333,333,47,47,0,1,0
22,356,356,51,29,22,2,1
20,393,393,52,52,0,1,0
16,399,399,67,67,0,1,0
2,403,403,45,45,0,1,0
14,406,406,57,45,12,2,1
5,444,444,14,14,0,1,0
11,464,464,51,31,20,2,1
13,476,476,71,41,30,3,2
24,482,482,15,15,0,1,0
1,500,500,26,26,0,1,0

5,116,116,1,1,0,1,0
27,132,132,2,2,0,1,0
4,133,133,3,3,0,1,0
1,141,141,9,9,0,1,0
12,144,144,4,4,0,1,0
25,153,153,6,1,5,2,1
3,158,158,24,11,13,2,1
22,161,161,10,3,7,2,1
9,162,162,2,2,0,1,0
28,175,175,5,5,0,1,0
13,176,176,11,3,8,3,2
16,183,183,43,35,8,2,1
19,191,191,15,5,10,2,1
2,203,203,10,10,0,1,0
7,231,231,7,7,0,1,0
17,237,237,64,23,41,4,3
0,260,260,15,15,0,1,0
10,287,287,37,24,13,2,1
14,300,300,25,25,0,1,0
20,325,325,2,2,0,1,0
6,327,327,11,5,6,3,2
26,337,337,107,84,23,2,1
11,356,356,60,31,29,4,3
23,386,386,11,11,0,1,0
18,392,392,74,22,52,3,2
8,399,399,1,1,0,1,0
15,406,406,27,27,0,1,0
24,462,462,6,6,0,1,0
21,492,492,87,87,0,1,0

23,102,102,6,6,0,1,0
18,115,115,10,6,4,2,1
24,126,126,20,20,0,1,0
2,129,129,12,12,0,1,0
8,138,138,2,2,0,1,0
1,145,145,12,12,0,1,0
16,157,157,47,14,33,2,1
4,165,165,14,14,0,1,0
11,169,169,68,44,24,3,2
17,181,181,1,1,0,1,0
20,199,199,10,6,4,2,1
21,204,204,41,41,0,1,0
0,211,211,10,10,0,1,0
7,214,214,25,5,20,3,2
6,219,219,18,8,10,2,1
22,312,312,11,8,3,2,1
15,338,338,34,34,0,1,0
13,392,392,20,20,0,1,0
19,397,397,56,56,0,1,0
12,404,404,4,4,0,1,0
9,430,430,31,9,22,4,3
14,471,471,22,10,12,3,2
10,481,481,44,16,28,3,2
3,483,483,36,36,0,1,0
5,495,495,15,4,11,2,1

6,102,102,1,1,0,1,0
3,105,105,16,12,4,2,1
28,111,111,1,1,0,1,0
13,135,135,22,22,0,1,0
26,157,157,92,56,36,3,2
7,160,160,1,1,0,1,0
22,163,163,3,3,0,1,0
16,164,164,11,11,0,1,0
4,198,198,21,21,0,1,0
14,201,201,9,1,8,3,2
23,223,223,29,29,0,1,0
8,238,238,2,2,0,1,0
11,242,242,15,11,4,2,1
15,244,244,1,1,0,1,0
10,253,253,5,5,0,1,0
5,262,262,26,9,17,2,1
21,321,321,32,6,26,4,3
2,330,330,19,11,8,2,1
20,338,338,11,3,8,3,2
25,359,359,42,4,38,2,1
27,360,360,16,16,0,1,0
1,368,368,52,25,27,4,3
19,373,373,7,7,0,1,0
24,385,385,10,3,7,2,1
0,391,391,5,5,0,1,0
9,391,391,89,89,0,1,0
12,411,411,1,1,0,1,0
18,413,413,19,19,0,1,0
17,429,429,7,7,0,1,0
29,499,499,50,50,0,1,0

19,120,120,4,4,0,1,0
2,128,128,1,1,0,1,0
22,191,191,5,5,0,1,0
3,194,194,9,6,3,2,1
15,200,200,27,27,0,1,0
4,211,211,5,5,0,1,0
9,234,234,14,4,10,3,2
16,248,248,4,4,0,1,0
13,254,254,85,14,71,4,3
6,272,272,17,17,0,1,0
17,278,278,63,63,0,1,0
14,304,304,4,4,0,1,0
0,304,304,34,34,0,1,0
1,316,316,5,5,0,1,0
21,319,319,21,21,0,1,0
18,329,329,14,6,8,2,1
23,335,335,16,16,0,1,0
5,340,340,25,25,0,1,0
12,348,348,11,3,8,3,2
11,351,351,141,141,0,1,0
7,368,368,74,34,40,4,3
20,394,394,100,37,63,4,3
10,468,468,4,4,0,1,0
8,478,478,90,57,33,4,3

21,101,101,5,5,0,1,0
2,103,103,1,1,0,1,0
27,130,130,25,25,0,1,0
8,138,138,1,1,0,1,0
9,164,164,1,1,0,1,0
22,183,183,10,7,3,2,1
28,188,188,17,17,0,1,0
24,226,226,48,22,26,4,3
6,243,243,30,30,0,1,0
16,245,245,21,1,20,3,2
0,252,252,20,20,0,1,0
26,268,268,36,36,0,1,0
5,278,278,7,4,3,2,1
25,288,288,3,3,0,1,0
13,293,293,2,2,0,1,0
15,336,336,7,7,0,1,0
10,373,373,46,46,0,1,0
17,384,384,44,44,0,1,0
7,407,407,8,8,0,1,0
11,408,408,60,24,36,4,3
14,419,419,51,23,28,2,1
20,436,436,45,45,0,1,0
23,442,442,3,3,0,1,0
18,446,446,94,57,37,2,1
3,449,449,77,36,41,3,2
12,453,453,29,29,0,1,0
19,463,463,20,17,3,2,1
1,475,475,69,69,0,1,0
4,487,487,22,22,0,1,0

11,116,116,1,1,0,1,0
4,142,142,15,15,0,1,0
12,173,173,2,2,0,1,0
0,206,206,13,4,9,4,3
20,207,207,40,19,21,2,1
25,253,253,11,11,0,1,0
19,261,261,36,24,12,4,3
9,270,270,19,2,17,4,3
6,323,323,6,2,4,2,1
3,339,339,69,36,33,3,2
10,345,345,6,6,0,1,0
8,346,346,28,16,12,2,1
23,349,349,29,29,0,1,0
18,352,352,43,9,34,2,1
16,380,380,26,10,16,2,1
2,393,393,69,22,47,4,3
14,398,398,24,6,18,3,2
13,408,408,63,9,54,3,2
21,429,429,104,104,0,1,0
17,431,431,26,6,20,4,3
5,434,434,35,35,0,1,0
24,435,435,19,19,0,1,0
1,446,446,42,6,36,3,2
7,477,477,56,56,0,1,0
22,480,480,58,10,48,4,3
15,493,493,20,10,10,2,1

12,114,114,14,2,12,2,1
3,116,116,5,1,4,2,1
2,119,119,8,1,7,2,1
24,140,140,5,2,3,2,1
6,141,141,22,22,0,1,0
1,142,142,3,3,0,1,0
27,148,148,6,6,0,1,0
13,186,186,6,6,0,1,0
10,200,200,4,1,3,2,1
18,215,215,15,3,12,4,3
23,225,225,25,3,22,4,3
9,230,230,6,6,0,1,0
26,235,235,5,5,0,1,0
19,266,266,45,41,4,2,1
20,285,285,45,23,22,3,2
22,299,299,1,1,0,1,0
16,317,317,15,15,0,1,0
8,320,320,5,5,0,1,0
25,337,337,92,71,21,4,3
7,342,342,2,2,0,1,0
5,349,349,33,9,24,3,2
21,360,360,75,25,50,2,1
17,419,419,35,9,26,3,2
11,432,432,4,1,3,2,1
4,487,487,58,58,0,1,0
15,488,488,90,64,26,2,1
0,491,491,15,4,11,4,3
14,496,496,125,11,114,4,3

3,115,115,18,18,0,1,0
18,115,115,9,3,6,3,2
7,132,132,8,2,6,3,2
2,147,147,13,1,12,3,2
12,155,155,2,2,0,1,0
10,163,163,13,6,7,2,1
14,214,214,7,4,3,2,1
17,235,235,8,2,6,3,2
13,250,250,13,2,11,2,1
19,306,306,12,12,0,1,0
11,329,329,30,30,0,1,0
5,377,377,135,135,0,1,0
16,381,381,163,148,15,4,3
21,390,390,109,100,9,4,3
15,411,411,36,8,28,3,2
0,423,423,109,34,75,4,3
4,436,436,42,42,0,1,0
9,443,443,14,5,9,4,3
1,461,461,26,26,0,1,0
6,471,471,25,25,0,1,0
8,481,481,20,20,0,1,0
20,489,489,7,7,0,1,0

13,111,111,25,25,0,1,0
23,136,136,1,1,0,1,0
20,154,154,3,3,0,1,0
15,159,159,6,6,0,1,0
16,178,178,3,3,0,1,0
11,207,207,15,15,0,1,0
12,222,222,23,15,8,2,1
1,246,246,56,56,0,1,0
4,257,257,36,36,0,1,0
10,261,261,23,9,14,3,2
22,283,283,7,1,6,2,1
14,302,302,9,9,0,1,0
19,328,328,53,9,44,2,1
9,334,334,20,20,0,1,0
3,363,363,15,9,6,3,2
0,364,364,88,73,15,2,1
18,374,374,136,136,0,1,0
2,390,390,20,20,0,1,0
8,395,395,5,5,0,1,0
6,403,403,23,23,0,1,0
24,439,439,20,6,14,2,1
17,441,441,115,38,77,4,3
7,451,451,16,16,0,1,0
5,479,479,34,15,19,2,1
21,487,487,12,2,10,3,2

12,112,112,1,1,0,1,0
14,139,139,13,3,10,3,2
17,183,183,14,2,12,4,3
2,186,186,1,1,0,1,0
15,186,186,28,18,10,2,1
6,202,202,10,5,5,2,1
13,211,211,39,9,30,2,1
0,235,235,81,13,68,3,2
1,250,250,2,2,0,1,0
10,258,258,9,9,0,1,0
7,267,267,1,1,0,1,0
5,275,275,37,37,0,1,0
19,276,276,22,7,15,2,1
23,313,313,24,24,0,1,0
11,319,319,1,1,0,1,0
9,322,322,30,30,0,1,0
21,328,328,31,24,7,2,1
18,336,336,95,21,74,4,3
8,337,337,53,9,44,4,3
20,424,424,30,12,18,2,1
22,462,462,6,1,5,2,1
16,479,479,43,43,0,1,0
4,480,480,34,34,0,1,0
3,488,488,144,144,0,1,0

3,142,142,7,7,0,1,0
19,165,165,13,8,5,2,1
1,166,166,30,30,0,1,0
10,190,190,12,5,7,2,1
14,195,195,82,82,0,1,0
9,229,229,41,20,21,4,3
12,232,232,15,6,9,4,3
6,262,262,15,15,0,1,0
13,309,309,16,4,12,2,1
20,344,344,25,7,18,4,3
21,348,348,9,9,0,1,0
7,348,348,59,59,0,1,0
2,361,361,18,18,0,1,0
4,366,366,45,8,37,2,1
22,367,367,8,1,7,2,1
18,395,395,64,32,32,3,2
15,416,416,23,17,6,2,1
5,427,427,1,1,0,1,0
8,438,438,90,21,69,4,3
0,481,481,60,2,58,4,3
11,492,492,41,3,38,3,2
16,497,497,31,13,18,4,3
17,500,500,61,61,0,1,0

3,115,115,28,28,0,1,0
11,123,123,48,48,0,1,0
2,171,171,16,16,0,1,0
19,195,195,41,41,0,1,0
1,202,202,15,15,0,1,0
7,208,208,34,34,0,1,0
5,223,223,15,1,14,2,1
17,239,239,15,15,0,1,0
20,260,260,12,9,3,2,1
4,264,264,76,76,0,1,0
0,272,272,14,14,0,1,0
15,350,350,22,10,12,3,2
8,365,365,23,1,22,3,2
10,377,377,35,35,0,1,0
9,381,381,17,8,9,2,1
12,385,385,25,11,14,3,2
18,450,450,12,7,5,2,1
14,460,460,74,47,27,4,3
13,470,470,21,21,0,1,0
16,472,472,3,3,0,1,0
21,483,483,22,22,0,1,0
6,495,495,56,23,33,4,3

19,136,136,6,6,0,1,0
13,164,164,1,1,0,1,0
22,192,192,5,5,0,1,0
18,207,207,14,14,0,1,0
10,222,222,4,4,0,1,0
9,223,223,25,25,0,1,0
5,227,227,11,11,0,1,0
0,267,267,18,3,15,2,1
25,274,274,7,7,0,1,0
17,284,284,87,13,74,3,2
6,296,296,48,48,0,1,0
26,307,307,1,1,0,1,0
15,333,333,22,22,0,1,0
24,335,335,30,8,22,3,2
23,363,363,145,16,129,4,3
14,423,423,23,23,0,1,0
8,426,426,24,24,0,1,0
4,430,430,14,14,0,1,0
12,437,437,19,19,0,1,0
21,440,440,6,6,0,1,0
7,443,443,72,72,0,1,0
1,447,447,5,5,0,1,0
2,461,461,31,31,0,1,0
16,486,486,67,5,62,3,2
20,489,489,21,4,17,2,1
11,492,492,126,92,34,2,1
3,494,494,51,51,0,1,0

20,100,100,12,12,0,1,0
4,104,104,3,3,0,1,0
23,113,113,23,11,12,2,1
13,154,154,19,19,0,1,0
10,165,165,4,4,0,1,0
6,176,176,32,32,0,1,0
2,186,186,18,18,0,1,0
14,190,190,32,4,28,2,1
5,194,194,36,36,0,1,0
0,260,260,57,53,4,2,1
22,286,286,5,5,0,1,0
21,290,290,17,17,0,1,0
25,303,303,43,43,0,1,0
11,331,331,55,55,0,1,0
24,335,335,5,5,0,1,0
17,368,368,60,60,0,1,0
16,370,370,39,31,8,2,1
12,379,379,1,1,0,1,0
3,403,403,21,3,18,4,3
18,412,412,59,40,19,2,1
1,418,418,3,3,0,1,0
15,443,443,11,11,0,1,0
9,484,484,7,7,0,1,0
7,498,498,22,2,20,3,2
8,499,499,27,27,0,1,0
19,499,499,32,32,0,1,0

26,106,106,14,5,9,2,1
9,115,115,14,4,10,3,2
7,130,130,18,18,0,1,0
12,169,169,15,1,14,3,2
23,208,208,15,6,9,4,3
11,212,212,12,12,0,1,0
10,220,220,10,2,8,2,1
0,265,265,43,1,42,3,2
8,273,273,8,1,7,2,1
2,281,281,1,1,0,1,0
14,306,306,11,5,6,3,2
5,334,334,23,9,14,2,1
20,341,341,19,19,0,1,0
1,362,362,6,6,0,1,0
28,367,367,52,11,41,3,2
18,369,369,12,12,0,1,0
6,378,378,89,89,0,1,0
27,391,391,19,1,18,3,2
3,396,396,22,12,10,4,3
13,404,404,3,3,0,1,0
17,407,407,63,3,60,3,2
16,434,434,10,10,0,1,0
21,469,469,153,9,144,4,3
25,482,482,2,2,0,1,0
19,483,483,29,2,27,2,1
22,484,484,52,3,49,4,3
24,486,486,43,43,0,1,0
15,493,493,4,4,0,1,0
4,496,496,52,52,0,1,0

25,101,101,2,2,0,1,0
0,105,105,7,2,5,2,1
13,119,119,2,2,0,1,0
22,141,141,17,17,0,1,0
6,168,168,1,1,0,1,0
29,168,168,20,20,0,1,0
18,172,172,1,1,0,1,0
28,180,180,12,12,0,1,0
12,183,183,13,13,0,1,0
20,200,200,20,20,0,1,0
10,219,219,1,1,0,1,0
30,224,224,23,5,18,2,1
15,243,243,7,7,0,1,0
1,255,255,1,1,0,1,0
8,273,273,16,16,0,1,0
2,291,291,20,6,14,3,2
9,303,303,25,10,15,4,3
24,311,311,53,53,0,1,0
5,318,318,19,9,10,3,2
14,325,325,103,56,47,2,1
31,348,348,49,49,0,1,0
27,357,357,29,29,0,1,0
7,357,357,10,4,6,3,2
26,359,359,45,7,38,3,2
17,384,384,40,40,0,1,0
4,401,401,43,43,0,1,0
21,406,406,13,1,12,3,2
23,420,420,67,22,45,4,3
19,452,452,2,2,0,1,0
16,453,453,39,39,0,1,0
3,486,486,2,2,0,1,0
11,491,491,38,10,28,3,2

5,113,113,13,13,0,1,0
25,131,131,24,24,0,1,0
12,177,177,12,12,0,1,0
19,182,182,24,12,12,3,2
22,188,188,10,10,0,1,0
3,196,196,2,2,0,1,0
24,202,202,7,7,0,1,0
14,212,212,41,4,37,2,1
6,255,255,20,20,0,1,0
20,264,264,84,84,0,1,0
4,272,272,23,23,0,1,0
21,286,286,37,11,26,3,2
23,297,297,21,21,0,1,0
26,324,324,3,3,0,1,0
10,330,330,70,70,0,1,0
16,351,351,57,19,38,3,2
8,354,354,7,7,0,1,0
2,359,359,42,42,0,1,0
15,361,361,47,23,24,2,1
27,373,373,3,3,0,1,0
11,413,413,6,6,0,1,0
1,415,415,6,2,4,2,1
13,418,418,13,13,0,1,0
9,428,428,23,6,17,2,1
0,452,452,18,18,0,1,0
17,468,468,9,4,5,2,1
18,491,491,49,1,48,4,3
7,493,493,10,6,4,2,1

7,113,113,8,8,0,1,0
14,127,127,3,3,0,1,0
4,133,133,9,1,8,3,2
18,136,136,14,14,0,1,0
22,139,139,11,11,0,1,0
16,141,141,3,3,0,1,0
20,146,146,21,21,0,1,0
25,155,155,33,33,0,1,0
3,176,176,24,3,21,4,3
9,198,198,6,2,4,2,1
15,210,210,42,24,18,4,3
5,216,216,9,3,6,2,1
23,232,232,2,2,0,1,0
13,267,267,34,5,29,2,1
11,271,271,18,18,0,1,0
19,284,284,6,2,4,2,1
2,287,287,67,11,56,3,2
17,300,300,53,24,29,2,1
12,309,309,12,2,10,2,1
6,336,336,50,33,17,2,1
24,365,365,7,7,0,1,0
10,415,415,17,17,0,1,0
1,423,423,16,5,11,2,1
0,442,442,62,11,51,4,3
21,482,482,106,106,0,1,0
8,489,489,11,6,5,2,1

11,142,142,33,33,0,1,0
3,154,154,5,5,0,1,0
17,155,155,5,5,0,1,0
5,156,156,4,4,0,1,0
13,161,161,38,20,18,4,3
12,169,169,4,4,0,1,0
8,192,192,1,1,0,1,0
2,199,199,25,3,22,3,2
10,243,243,42,21,21,3,2
24,244,244,86,14,72,4,3
7,250,250,11,11,0,1,0
20,277,277,65,65,0,1,0
27,281,281,39,39,0,1,0
9,296,296,15,15,0,1,0
16,299,299,13,13,0,1,0
0,306,306,23,1,22,2,1
28,316,316,17,17,0,1,0
22,323,323,2,2,0,1,0
14,348,348,5,5,0,1,0
6,369,369,26,3,23,2,1
18,372,372,7,7,0,1,0
1,405,405,14,1,13,2,1
4,435,435,5,5,0,1,0
19,438,438,11,11,0,1,0
25,448,448,62,20,42,4,3
26,462,462,56,53,3,2,1
21,464,464,27,27,0,1,0
15,470,470,2,2,0,1,0
23,493,493,20,16,4,2,1

25,144,144,11,1,10,3,2
3,151,151,3,3,0,1,0
7,161,161,5,5,0,1,0
13,182,182,1,1,0,1,0
14,191,191,3,3,0,1,0
20,193,193,20,2,18,2,1
2,215,215,49,49,0,1,0
17,223,223,11,8,3,2,1
21,229,229,35,35,0,1,0
12,261,261,15,11,4,2,1
8,263,263,1,1,0,1,0
11,292,292,11,11,0,1,0
19,305,305,1,1,0,1,0
24,310,310,44,4,40,2,1
22,334,334,60,60,0,1,0
15,359,359,2,2,0,1,0
16,361,361,25,4,21,2,1
18,362,362,79,3,76,3,2
27,363,363,42,22,20,3,2
26,371,371,17,17,0,1,0
23,387,387,26,26,0,1,0
0,387,387,19,2,17,2,1
1,395,395,37,37,0,1,0
6,435,435,76,12,64,3,2
10,460,460,2,2,0,1,0
9,471,471,25,17,8,3,2
4,486,486,159,9,150,4,3
5,491,491,47,47,0,1,0

11,103,103,4,4,0,1,0
8,110,110,11,11,0,1,0
12,113,113,9,9,0,1,0
2,114,114,44,44,0,1,0
14,125,125,5,5,0,1,0
0,132,132,27,27,0,1,0
9,139,139,20,20,0,1,0
18,141,141,10,10,0,1,0
22,144,144,7,7,0,1,0
19,175,175,22,22,0,1,0
13,177,177,13,8,5,2,1
7,188,188,8,3,5,2,1
20,198,198,17,2,15,4,3
15,211,211,39,21,18,2,1
21,212,212,8,8,0,1,0
16,266,266,10,10,0,1,0
6,273,273,40,40,0,1,0
17,316,316,133,49,84,4,3
4,362,362,16,16,0,1,0
10,376,376,2,2,0,1,0
5,400,400,5,5,0,1,0
1,440,440,3,3,0,1,0
3,454,454,50,50,0,1,0

1,100,100,4,4,0,1,0
17,106,106,3,3,0,1,0
20,143,143,22,22,0,1,0
16,162,162,16,2,14,2,1
6,164,164,6,6,0,1,0
3,165,165,3,3,0,1,0
4,208,208,9,9,0,1,0
24,228,228,39,29,10,2,1
12,231,231,3,3,0,1,0
9,234,234,10,2,8,3,2
23,260,260,1,1,0,1,0
7,285,285,22,22,0,1,0
26,302,302,17,17,0,1,0
18,306,306,13,1,12,4,3
11,307,307,27,11,16,3,2
22,315,315,25,25,0,1,0
13,331,331,40,40,0,1,0
10,344,344,22,5,17,2,1
8,347,347,15,15,0,1,0
25,350,350,21,21,0,1,0
2,350,350,9,9,0,1,0
5,361,361,55,34,21,4,3
19,403,403,19,19,0,1,0
0,416,416,25,1,24,3,2
21,421,421,102,102,0,1,0
15,461,461,135,135,0,1,0
27,488,488,115,33,82,4,3
14,489,489,41,41,0,1,0

16,124,124,1,1,0,1,0
2,126,126,36,36,0,1,0
23,143,143,45,45,0,1,0
19,147,147,25,25,0,1,0
27,170,170,18,3,15,4,3
9,180,180,1,1,0,1,0
22,216,216,36,20,16,2,1
10,224,224,9,9,0,1,0
24,232,232,4,4,0,1,0
11,243,243,2,2,0,1,0
0,297,297,4,4,0,1,0
6,303,303,18,18,0,1,0
15,333,333,86,44,42,3,2
8,339,339,26,26,0,1,0
26,369,369,66,66,0,1,0
5,376,376,34,10,24,3,2
1,378,378,47,35,12,4,3
14,384,384,3,3,0,1,0
7,405,405,13,13,0,1,0
21,413,413,6,6,0,1,0
25,414,414,12,12,0,1,0
13,426,426,38,15,23,2,1
17,432,432,66,66,0,1,0
12,435,435,10,6,4,2,1
18,444,444,26,11,15,2,1
20,469,469,3,3,0,1,0
3,479,479,29,29,0,1,0
4,482,482,13,13,0,1,0

22,101,101,1,1,0,1,0
17,115,115,22,22,0,1,0
16,135,135,23,23,0,1,0
11,163,163,18,18,0,1,0
10,177,177,27,19,8,2,1
2,182,182,20,4,16,2,1
8,192,192,35,35,0,1,0
5,231,231,11,11,0,1,0
21,267,267,2,2,0,1,0
4,315,315,54,20,34,2,1
9,330,330,38,38,0,1,0
14,344,344,5,5,0,1,0
1,349,349,66,66,0,1,0
0,358,358,2,2,0,1,0
18,406,406,36,36,0,1,0
20,406,406,19,11,8,2,1
19,409,409,18,6,12,3,2
7,411,411,30,7,23,2,1
13,440,440,33,11,22,3,2
15,454,454,209,191,18,2,1
3,459,459,43,14,29,3,2
6,460,460,30,30,0,1,0
12,466,466,7,7,0,1,0

5,108,108,1,1,0,1,0
7,128,128,23,23,0,1,0
21,154,154,5,5,0,1,0
8,159,159,8,8,0,1,0
0,167,167,17,9,8,3,2
9,187,187,1,1,0,1,0
6,191,191,5,5,0,1,0
4,213,213,30,30,0,1,0
17,233,233,46,11,35,2,1
15,261,261,15,15,0,1,0
22,262,262,77,68,9,4,3
20,290,290,40,31,9,2,1
23,292,292,42,42,0,1,0
14,292,292,9,9,0,1,0
18,298,298,3,3,0,1,0
13,300,300,31,31,0,1,0
3,308,308,85,85,0,1,0
2,352,352,40,12,28,3,2
1,358,358,1,1,0,1,0
10,367,367,29,21,8,2,1
12,433,433,4,4,0,1,0
16,443,443,1,1,0,1,0
19,481,481,98,68,30,3,2
11,491,491,106,106,0,1,0

8,113,113,1,1,0,1,0
11,124,124,7,4,3,2,1
0,137,137,6,1,5,2,1
15,138,138,27,27,0,1,0
19,142,142,5,2,3,2,1
13,169,169,36,36,0,1,0
22,197,197,20,20,0,1,0
14,204,204,5,1,4,2,1
16,204,204,13,1,12,2,1
21,229,229,3,3,0,1,0
12,264,264,21,21,0,1,0
20,277,277,81,42,39,4,3
6,294,294,1,1,0,1,0
3,296,296,1,1,0,1,0
10,300,300,15,3,12,3,2
4,302,302,1,1,0,1,0
1,315,315,35,35,0,1,0
18,331,331,10,10,0,1,0
2,382,382,13,13,0,1,0
17,429,429,58,22,36,2,1
7,466,466,275,185,90,3,2
5,498,498,22,22,0,1,0
9,499,499,154,118,36,3,2

9,138,138,25,25,0,1,0
5,145,145,7,7,0,1,0
14,163,163,12,3,9,2,1
25,176,176,14,14,0,1,0
4,178,178,38,18,20,3,2
3,179,179,5,5,0,1,0
13,214,214,10,10,0,1,0
23,218,218,17,8,9,4,3
17,231,231,2,2,0,1,0
11,282,282,9,9,0,1,0
20,282,282,42,42,0,1,0
0,288,288,2,2,0,1,0
12,297,297,38,27,11,2,1
18,297,297,4,4,0,1,0
16,298,298,28,23,5,2,1
10,298,298,13,13,0,1,0
19,305,305,49,25,24,3,2
7,323,323,3,3,0,1,0
1,344,344,17,17,0,1,0
2,352,352,46,46,0,1,0
15,378,378,45,9,36,3,2
24,402,402,32,5,27,4,3
8,423,423,66,22,44,2,1
6,435,435,57,5,52,3,2
22,457,457,124,108,16,3,2
21,494,494,49,22,27,4,3

17,110,110,17,3,14,2,1
14,151,151,2,2,0,1,0
15,167,167,9,9,0,1,0
21,187,187,6,6,0,1,0
18,222,222,3,3,0,1,0
12,230,230,33,5,28,2,1
10,247,247,21,21,0,1,0
8,265,265,4,4,0,1,0
0,271,271,65,56,9,4,3
13,299,299,92,92,0,1,0
11,301,301,20,20,0,1,0
20,302,302,15,3,12,2,1
4,316,316,91,45,46,2,1
6,326,326,40,40,0,1,0
5,370,370,33,33,0,1,0
2,370,370,14,14,0,1,0
9,372,372,14,14,0,1,0
3,392,392,45,45,0,1,0
16,431,431,13,13,0,1,0
7,465,465,36,36,0,1,0
19,480,480,137,137,0,1,0
1,490,490,87,13,74,3,2

20,100,100,6,6,0,1,0
8,113,113,3,3,0,1,0
3,125,125,6,2,4,2,1
2,126,126,1,1,0,1,0
1,134,134,2,2,0,1,0
14,209,209,15,15,0,1,0
18,212,212,31,12,19,2,1
12,236,236,20,20,0,1,0
10,241,241,87,80,7,2,1
5,268,268,8,8,0,1,0
16,279,279,22,22,0,1,0
9,288,288,5,2,3,2,1
15,288,288,39,39,0,1,0
24,348,348,83,83,0,1,0
17,350,350,66,66,0,1,0
23,365,365,11,11,0,1,0
13,371,371,21,9,12,4,3
7,372,372,108,108,0,1,0
26,385,385,24,24,0,1,0
6,385,385,1,1,0,1,0
19,400,400,16,1,15,4,3
11,405,405,10,10,0,1,0
4,413,413,3,3,0,1,0
22,439,439,58,58,0,1,0
21,440,440,18,18,0,1,0
0,484,484,78,52,26,2,1
25,484,484,32,32,0,1,0

7,106,106,1,1,0,1,0
21,115,115,18,4,14,2,1
11,143,143,10,10,0,1,0
18,155,155,6,6,0,1,0
14,163,163,7,7,0,1,0
13,163,163,10,10,0,1,0
4,192,192,73,73,0,1,0
19,214,214,5,5,0,1,0
10,231,231,22,19,3,2,1
5,234,234,3,3,0,1,0
3,274,274,32,32,0,1,0
20,279,279,49,14,35,2,1
12,284,284,40,8,32,3,2
1,305,305,26,26,0,1,0
15,306,306,34,2,32,2,1
0,312,312,10,2,8,2,1
9,315,315,76,66,10,3,2
22,318,318,57,21,36,3,2
6,340,340,45,23,22,3,2
8,354,354,32,32,0,1,0
2,362,362,2,2,0,1,0
17,428,428,7,2,5,2,1
16,443,443,99,45,54,4,3

15,106,106,15,15,0,1,0
18,123,123,5,5,0,1,0
0,127,127,12,12,0,1,0
7,153,153,3,3,0,1,0
17,155,155,9,9,0,1,0
31,157,157,6,6,0,1,0
24,164,164,30,30,0,1,0
14,179,179,37,37,0,1,0
12,185,185,1,1,0,1,0
5,189,189,25,25,0,1,0
32,197,197,5,5,0,1,0
11,217,217,9,9,0,1,0
29,243,243,4,4,0,1,0
10,248,248,9,9,0,1,0
4,252,252,7,7,0,1,0
28,264,264,33,33,0,1,0
8,311,311,23,23,0,1,0
16,311,311,3,3,0,1,0
22,323,323,7,7,0,1,0
19,340,340,9,1,8,3,2
2,341,341,14,10,4,2,1
3,344,344,1,1,0,1,0
20,346,346,15,15,0,1,0
30,394,394,88,63,25,2,1
13,395,395,9,9,0,1,0
6,408,408,28,28,0,1,0
27,410,410,94,23,71,3,2
25,461,461,41,35,6,3,2
26,466,466,7,1,6,3,2
21,482,482,69,51,18,3,2
23,483,483,53,53,0,1,0
1,490,490,30,17,13,2,1
9,493,493,23,2,21,2,1

5,106,106,1,1,0,1,0
21,124,124,4,4,0,1,0
6,150,150,7,7,0,1,0
1,154,154,46,21,25,2,1
4,186,186,12,6,6,3,2
0,200,200,1,1,0,1,0
25,208,208,18,8,10,3,2
17,226,226,56,56,0,1,0
22,231,231,11,11,0,1,0
7,234,234,18,18,0,1,0
10,271,271,21,14,7,2,1
12,272,272,4,4,0,1,0
9,284,284,12,2,10,3,2
20,286,286,2,2,0,1,0
14,293,293,11,5,6,3,2
8,303,303,39,9,30,3,2
23,384,384,65,35,30,3,2
18,408,408,15,7,8,2,1
3,409,409,116,32,84,3,2
19,412,412,38,26,12,3,2
11,413,413,18,18,0,1,0
2,432,432,41,41,0,1,0
24,448,448,35,35,0,1,0
15,472,472,73,39,34,3,2
13,480,480,7,1,6,3,2
16,486,486,115,21,94,3,2

10,110,110,10,1,9,2,1
14,144,144,8,2,6,2,1
19,146,146,35,35,0,1,0
4,159,159,13,7,6,3,2
2,160,160,73,73,0,1,0
20,168,168,3,3,0,1,0
0,187,187,7,1,6,3,2
15,288,288,18,6,12,3,2
9,291,291,5,5,0,1,0
17,306,306,73,11,62,3,2
11,314,314,18,7,11,2,1
7,326,326,20,20,0,1,0
25,326,326,5,2,3,2,1
16,356,356,12,2,10,2,1
13,363,363,39,31,8,2,1
3,366,366,17,5,12,3,2
23,396,396,46,10,36,3,2
12,410,410,37,37,0,1,0
8,414,414,1,1,0,1,0
1,419,419,1,1,0,1,0
6,421,421,25,25,0,1,0
22,432,432,21,1,20,2,1
21,438,438,31,31,0,1,0
18,439,439,81,81,0,1,0
24,441,441,44,44,0,1,0
5,466,466,19,19,0,1,0
26,478,478,44,10,34,4,3

17,101,101,23,23,0,1,0
32,105,105,4,1,3,2,1
21,108,108,1,1,0,1,0
19,112,112,9,9,0,1,0
34,124,124,1,1,0,1,0
23,130,130,34,28,6,2,1
8,137,137,1,1,0,1,0
18,143,143,1,1,0,1,0
22,163,163,6,6,0,1,0
14,185,185,6,6,0,1,0
28,193,193,49,16,33,4,3
13,203,203,37,22,15,2,1
3,206,206,7,7,0,1,0
31,239,239,5,5,0,1,0
27,239,239,26,26,0,1,0
7,266,266,10,6,4,2,1
4,271,271,5,2,3,2,1
33,275,275,44,11,33,4,3
16,277,277,27,6,21,4,3
5,284,284,26,7,19,2,1
20,285,285,28,16,12,4,3
0,292,292,7,7,0,1,0
12,318,318,4,4,0,1,0
15,327,327,5,5,0,1,0
1,334,334,9,9,0,1,0
6,343,343,10,1,9,4,3
2,345,345,1,1,0,1,0
9,407,407,26,14,12,2,1
24,417,417,32,1,31,2,1
30,424,424,12,2,10,3,2
26,431,431,19,19,0,1,0
29,442,442,69,51,18,4,3
11,454,454,5,5,0,1,0
10,456,456,26,26,0,1,0
25,480,480,34,34,0,1,0

19,154,154,14,14,0,1,0
18,156,156,29,29,0,1,0
17,165,165,9,9,0,1,0
24,170,170,16,2,14,3,2
12,187,187,19,6,13,2,1
21,200,200,4,4,0,1,0
23,203,203,13,13,0,1,0
20,209,209,22,22,0,1,0
3,217,217,12,12,0,1,0
16,238,238,87,75,12,3,2
22,244,244,10,10,0,1,0
0,285,285,35,2,33,2,1
10,333,333,59,59,0,1,0
8,336,336,8,8,0,1,0
15,366,366,6,3,3,2,1
6,379,379,63,19,44,3,2
14,400,400,52,12,40,3,2
2,406,406,32,4,28,2,1
5,409,409,3,3,0,1,0
4,411,411,19,2,17,4,3
1,417,417,14,14,0,1,0
11,431,431,11,2,9,4,3
25,474,474,29,17,12,4,3
13,477,477,31,31,0,1,0
7,482,482,127,90,37,4,3
9,499,499,17,2,15,2,1

2,108,108,38,38,0,1,0
19,127,127,12,12,0,1,0
18,128,128,25,25,0,1,0
14,143,143,30,3,27,4,3
9,162,162,39,39,0,1,0
15,166,166,5,5,0,1,0
1,185,185,3,3,0,1,0
12,189,189,5,5,0,1,0
6,231,231,21,21,0,1,0
11,262,262,54,54,0,1,0
10,284,284,3,3,0,1,0
5,322,322,30,15,15,4,3
3,324,324,89,89,0,1,0
7,327,327,22,6,16,3,2
8,368,368,33,33,0,1,0
0,388,388,78,44,34,3,2
4,394,394,42,6,36,4,3
16,395,395,8,8,0,1,0
17,456,456,13,1,12,2,1
13,499,499,38,38,0,1,0

20,112,112,8,8,0,1,0
11,119,119,41,41,0,1,0
16,149,149,11,11,0,1,0
3,151,151,9,9,0,1,0
12,164,164,26,13,13,2,1
10,175,175,23,23,0,1,0
2,178,178,2,2,0,1,0
14,207,207,3,3,0,1,0
17,221,221,20,20,0,1,0
7,289,289,57,18,39,4,3
4,290,290,60,10,50,2,1
19,343,343,28,28,0,1,0
0,415,415,51,51,0,1,0
1,444,444,35,35,0,1,0
13,444,444,26,26,0,1,0
18,445,445,38,38,0,1,0
8,448,448,28,2,26,3,2
9,483,483,10,1,9,2,1
6,498,498,194,53,141,4,3
5,500,500,36,24,12,2,1
15,500,500,51,51,0,1,0

19,136,136,35,35,0,1,0
17,143,143,3,3,0,1,0
8,167,167,6,6,0,1,0
10,230,230,85,85,0,1,0
4,233,233,30,30,0,1,0
14,263,263,34,1,33,4,3
18,269,269,29,29,0,1,0
9,314,314,22,22,0,1,0
15,333,333,29,10,19,2,1
12,338,338,1,1,0,1,0
1,341,341,48,48,0,1,0
7,346,346,22,22,0,1,0
11,354,354,23,2,21,4,3
3,380,380,16,16,0,1,0
16,411,411,4,4,0,1,0
5,437,437,136,70,66,4,3
13,450,450,36,18,18,3,2
0,468,468,98,98,0,1,0
2,474,474,123,15,108,4,3
6,486,486,22,22,0,1,0

17,116,116,17,3,14,3,2
3,121,121,1,1,0,1,0
1,159,159,9,6,3,2,1
6,164,164,18,18,0,1,0
7,175,175,10,10,0,1,0
27,179,179,9,9,0,1,0
22,201,201,27,9,18,2,1
15,204,204,1,1,0,1,0
14,208,208,15,7,8,3,2
12,215,215,20,2,18,4,3
26,230,230,33,3,30,4,3
21,230,230,34,6,28,3,2
23,231,231,2,2,0,1,0
10,236,236,31,31,0,1,0
9,288,288,38,29,9,4,3
28,312,312,27,8,19,2,1
2,335,335,32,18,14,2,1
19,342,342,2,2,0,1,0
16,369,369,4,4,0,1,0
8,379,379,19,10,9,2,1
13,395,395,75,29,46,4,3
18,416,416,56,56,0,1,0
0,419,419,12,2,10,3,2
24,426,426,31,31,0,1,0
20,458,458,13,13,0,1,0
11,477,477,13,13,0,1,0
4,488,488,42,10,32,4,3
25,495,495,129,129,0,1,0
5,497,497,24,16,8,2,1

7,144,144,13,13,0,1,0
20,144,144,2,2,0,1,0
18,172,172,20,20,0,1,0
22,196,196,2,2,0,1,0
24,212,212,13,13,0,1,0
3,229,229,31,31,0,1,0
17,234,234,13,13,0,1,0
5,263,263,12,12,0,1,0
8,264,264,14,14,0,1,0
23,273,273,33,11,22,3,2
19,288,288,4,4,0,1,0
4,292,292,19,1,18,2,1
1,297,297,2,2,0,1,0
11,308,308,23,23,0,1,0
13,335,335,43,28,15,4,3
16,335,335,57,14,43,3,2
14,341,341,63,63,0,1,0
0,375,375,34,34,0,1,0
21,391,391,26,26,0,1,0
25,413,413,5,5,0,1,0
15,436,436,174,27,147,4,3
10,442,442,7,1,6,2,1
9,449,449,105,105,0,1,0
12,455,455,19,9,10,3,2
6,465,465,46,1,45,4,3
2,500,500,60,60,0,1,0

4,115,115,5,1,4,2,1
17,115,115,7,3,4,2,1
13,129,129,2,2,0,1,0
15,141,141,23,3,20,3,2
16,144,144,34,13,21,4,3
5,203,203,4,1,3,2,1
18,210,210,12,8,4,2,1
21,216,216,9,1,8,3,2
8,269,269,12,8,4,2,1
6,272,272,39,39,0,1,0
23,292,292,34,34,0,1,0
22,310,310,31,31,0,1,0
19,344,344,39,3,36,3,2
7,351,351,26,11,15,4,3
3,364,364,13,4,9,2,1
10,367,367,25,21,4,2,1
12,370,370,18,18,0,1,0
11,376,376,73,44,29,2,1
0,412,412,76,29,47,2,1
20,444,444,29,6,23,2,1
9,458,458,70,70,0,1,0
14,460,460,18,5,13,2,1
24,469,469,105,12,93,4,3
1,495,495,32,18,14,2,1
2,498,498,63,21,42,4,3

22,144,144,12,12,0,1,0
24,161,161,3,3,0,1,0
0,170,170,1,1,0,1,0
5,175,175,10,10,0,1,0
21,180,180,8,4,4,2,1
10,181,181,23,23,0,1,0
6,184,184,1,1,0,1,0
1,196,196,23,23,0,1,0
2,200,200,5,5,0,1,0
7,212,212,5,1,4,2,1
15,234,234,41,41,0,1,0
8,234,234,76,76,0,1,0
11,243,243,1,1,0,1,0
14,272,272,31,31,0,1,0
20,274,274,13,13,0,1,0
9,276,276,45,45,0,1,0
3,305,305,55,55,0,1,0
18,306,306,39,39,0,1,0
4,333,333,21,21,0,1,0
17,357,357,26,2,24,4,3
13,373,373,44,8,36,3,2
23,401,401,27,12,15,4,3
19,406,406,30,8,22,3,2
16,449,449,125,125,0,1,0
12,478,478,50,38,12,4,3

3,101,101,3,3,0,1,0
23,136,136,8,2,6,2,1
14,154,154,40,40,0,1,0
8,176,176,8,4,4,2,1
19,180,180,19,19,0,1,0
11,209,209,22,22,0,1,0
24,238,238,24,2,22,3,2
12,250,250,31,31,0,1,0
18,271,271,57,57,0,1,0
9,285,285,31,1,30,2,1
13,288,288,6,1,5,2,1
22,289,289,2,2,0,1,0
2,344,344,1,1,0,1,0
1,354,354,7,1,6,2,1
17,358,358,30,14,16,2,1
6,360,360,24,3,21,2,1
20,381,381,61,4,57,4,3
15,392,392,13,5,8,3,2
21,409,409,73,30,43,3,2
0,410,410,76,38,38,3,2
4,434,434,96,96,0,1,0
10,446,446,41,41,0,1,0
5,454,454,40,12,28,3,2
7,462,462,52,23,29,2,1
16,488,488,2,2,0,1,0

26,115,115,1,1,0,1,0
25,132,132,11,11,0,1,0
1,144,144,4,4,0,1,0
5,151,151,9,9,0,1,0
2,171,171,21,15,6,3,2
7,173,173,5,5,0,1,0
15,176,176,29,16,13,2,1
10,178,178,26,26,0,1,0
12,192,192,3,3,0,1,0
18,204,204,56,23,33,2,1
17,215,215,3,3,0,1,0
3,215,215,30,30,0,1,0
14,262,262,6,2,4,2,1
24,272,272,48,30,18,2,1
19,297,297,12,12,0,1,0
13,304,304,19,19,0,1,0
11,312,312,40,2,38,2,1
23,330,330,72,28,44,3,2
16,351,351,14,14,0,1,0
4,372,372,26,13,13,2,1
22,382,382,3,3,0,1,0
9,391,391,88,88,0,1,0
8,397,397,13,3,10,2,1
0,443,443,47,3,44,4,3
21,458,458,60,60,0,1,0
20,468,468,28,2,26,2,1
6,481,481,6,6,0,1,0

12,102,102,1,1,0,1,0
27,105,105,3,3,0,1,0
16,111,111,4,4,0,1,0
26,141,141,12,6,6,3,2
14,149,149,28,28,0,1,0
1,178,178,9,9,0,1,0
9,201,201,8,8,0,1,0
19,203,203,26,22,4,2,1
29,210,210,12,12,0,1,0
30,217,217,4,1,3,2,1
24,256,256,50,17,33,2,1
11,284,284,18,18,0,1,0
8,297,297,13,7,6,3,2
10,303,303,5,5,0,1,0
28,360,360,7,7,0,1,0
20,361,361,33,26,7,2,1
0,368,368,42,42,0,1,0
7,368,368,9,9,0,1,0
5,380,380,16,16,0,1,0
4,406,406,37,28,9,2,1
21,408,408,171,142,29,2,1
22,421,421,19,19,0,1,0
23,421,421,34,34,0,1,0
18,423,423,18,14,4,2,1
17,431,431,1,1,0,1,0
15,451,451,75,55,20,3,2
2,455,455,25,18,7,2,1
3,468,468,35,7,28,2,1
6,471,471,1,1,0,1,0
13,473,473,66,16,50,3,2
25,483,483,21,3,18,2,1

16,110,110,22,14,8,3,2
13,116,116,12,12,0,1,0
10,128,128,9,3,6,2,1
8,133,133,7,7,0,1,0
15,140,140,2,2,0,1,0
1,149,149,15,8,7,2,1
0,190,190,68,68,0,1,0
5,197,197,50,50,0,1,0
17,248,248,36,11,25,2,1
3,262,262,15,6,9,2,1
11,333,333,78,48,30,4,3
14,348,348,14,2,12,4,3
12,368,368,11,11,0,1,0
6,407,407,108,26,82,4,3
9,434,434,17,7,10,2,1
4,443,443,49,15,34,2,1
2,458,458,25,9,16,3,2
7,482,482,79,31,48,2,1
18,484,484,68,9,59,3,2

11,107,107,3,3,0,1,0
5,109,109,7,1,6,2,1
12,139,139,26,26,0,1,0
1,183,183,33,33,0,1,0
23,186,186,18,3,15,4,3
22,194,194,17,11,6,3,2
15,203,203,30,20,10,3,2
0,219,219,41,32,9,4,3
9,236,236,1,1,0,1,0
18,278,278,15,7,8,3,2
19,289,289,3,3,0,1,0
13,289,289,24,24,0,1,0
16,292,292,15,9,6,3,2
8,294,294,11,11,0,1,0
2,303,303,1,1,0,1,0
24,311,311,49,16,33,4,3
10,316,316,13,3,10,3,2
20,376,376,8,8,0,1,0
6,379,379,38,4,34,2,1
14,388,388,71,13,58,4,3
17,394,394,52,45,7,2,1
7,402,402,19,19,0,1,0
21,444,444,87,15,72,4,3
4,454,454,69,19,50,2,1
3,458,458,79,57,22,3,2

6,134,134,1,1,0,1,0
14,134,134,5,5,0,1,0
15,154,154,23,7,16,3,2
3,163,163,20,20,0,1,0
0,168,168,1,1,0,1,0
18,173,173,57,29,28,3,2
4,207,207,19,7,12,2,1
8,214,214,31,31,0,1,0
12,221,221,16,16,0,1,0
13,233,233,7,7,0,1,0
7,267,267,31,31,0,1,0
1,269,269,41,41,0,1,0
5,304,304,52,17,35,2,1
11,340,340,37,37,0,1,0
21,342,342,45,13,32,3,2
9,350,350,46,21,25,2,1
17,364,364,10,10,0,1,0
19,366,366,85,85,0,1,0
22,388,388,7,7,0,1,0
2,395,395,37,37,0,1,0
10,396,396,65,53,12,4,3
20,452,452,7,7,0,1,0
16,459,459,35,35,0,1,0

8,111,111,9,3,6,3,2
1,117,117,6,6,0,1,0
4,119,119,7,1,6,3,2
9,133,133,6,2,4,2,1
20,140,140,3,3,0,1,0
3,182,182,56,24,32,4,3
14,202,202,4,4,0,1,0
18,211,211,48,3,45,3,2
16,211,211,19,11,8,2,1
11,255,255,11,5,6,2,1
5,255,255,17,17,0,1,0
6,259,259,4,4,0,1,0
17,280,280,88,73,15,2,1
21,285,285,6,6,0,1,0
2,290,290,104,60,44,2,1
13,292,292,30,30,0,1,0
0,348,348,50,7,43,4,3
19,371,371,43,34,9,2,1
10,408,408,11,7,4,2,1
7,433,433,20,6,14,4,3
15,442,442,68,25,43,2,1
22,483,483,33,2,31,2,1
12,494,494,20,20,0,1,0

1,103,103,30,30,0,1,0
6,104,104,6,6,0,1,0
8,104,104,7,7,0,1,0
19,140,140,5,5,0,1,0
11,144,144,20,20,0,1,0
2,154,154,5,1,4,2,1
3,177,177,11,11,0,1,0
13,190,190,1,1,0,1,0
17,193,193,8,8,0,1,0
12,199,199,8,8,0,1,0
7,201,201,11,11,0,1,0
24,213,213,11,1,10,2,1
22,237,237,31,31,0,1,0
21,247,247,25,25,0,1,0
23,292,292,40,7,33,4,3
25,329,329,44,29,15,4,3
20,342,342,24,24,0,1,0
9,360,360,8,8,0,1,0
10,381,381,23,23,0,1,0
18,384,384,41,41,0,1,0
0,399,399,100,66,34,2,1
4,416,416,7,7,0,1,0
14,418,418,13,13,0,1,0
16,450,450,27,27,0,1,0
5,463,463,48,33,15,4,3
15,471,471,149,29,120,4,3

4,123,123,3,3,0,1,0
7,137,137,23,6,17,2,1
22,160,160,10,10,0,1,0
10,196,196,4,1,3,2,1
9,203,203,46,13,33,4,3
16,233,233,9,9,0,1,0
13,244,244,24,18,6,3,2
5,247,247,12,12,0,1,0
21,258,258,24,6,18,4,3
0,267,267,53,39,14,2,1
12,284,284,95,45,50,3,2
23,285,285,10,4,6,2,1
2,315,315,18,4,14,2,1
15,318,318,36,36,0,1,0
1,361,361,96,96,0,1,0
3,365,365,5,2,3,2,1
17,379,379,77,77,0,1,0
19,386,386,23,23,0,1,0
20,396,396,44,6,38,2,1
18,402,402,10,2,8,3,2
8,407,407,19,5,14,3,2
6,451,451,54,25,29,2,1
11,459,459,5,2,3,2,1
14,487,487,24,20,4,2,1

12,100,100,11,8,3,2,1
6,105,105,28,28,0,1,0
11,125,125,3,3,0,1,0
15,129,129,5,5,0,1,0
21,139,139,6,6,0,1,0
18,168,168,5,5,0,1,0
3,177,177,1,1,0,1,0
5,195,195,7,1,6,3,2
23,200,200,13,9,4,2,1
24,204,204,1,1,0,1,0
20,215,215,5,5,0,1,0
2,218,218,54,22,32,2,1
9,227,227,14,7,7,2,1
13,251,251,93,75,18,2,1
4,305,305,19,19,0,1,0
7,318,318,3,3,0,1,0
19,344,344,71,71,0,1,0
10,354,354,3,3,0,1,0
17,367,367,29,13,16,2,1
8,378,378,70,20,50,3,2
22,410,410,71,66,5,2,1
1,412,412,6,6,0,1,0
16,421,421,26,26,0,1,0
0,447,447,78,39,39,4,3
14,486,486,60,32,28,2,1

25,188,188,46,30,16,2,1
8,193,193,16,16,0,1,0
7,200,200,5,5,0,1,0
22,222,222,47,47,0,1,0
5,223,223,1,1,0,1,0
23,236,236,1,1,0,1,0
2,255,255,12,6,6,2,1
9,294,294,12,4,8,3,2
1,295,295,72,54,18,3,2
27,346,346,32,4,28,2,1
16,357,357,2,2,0,1,0
18,361,361,28,28,0,1,0
3,368,368,2,2,0,1,0
13,369,369,17,17,0,1,0
6,388,388,37,37,0,1,0
17,415,415,22,2,20,3,2
12,424,424,16,16,0,1,0
0,428,428,50,50,0,1,0
20,439,439,26,8,18,4,3
11,452,452,4,4,0,1,0
4,453,453,18,6,12,4,3
21,456,456,23,23,0,1,0
10,458,458,10,6,4,2,1
26,459,459,105,105,0,1,0
15,460,460,37,12,25,4,3
14,472,472,144,119,25,4,3
19,473,473,30,30,0,1,0
24,483,483,61,61,0,1,0

3,132,132,1,1,0,1,0
19,168,168,1,1,0,1,0
11,179,179,11,1,10,2,1
12,203,203,26,6,20,2,1
9,225,225,6,1,5,2,1
14,289,289,33,27,6,2,1
1,314,314,4,4,0,1,0
6,317,317,27,27,0,1,0
18,361,361,47,11,36,2,1
13,370,370,4,4,0,1,0
10,382,382,53,8,45,2,1
17,385,385,160,110,50,3,2
2,410,410,187,138,49,2,1
5,426,426,116,116,0,1,0
15,432,432,17,17,0,1,0
4,440,440,35,29,6,2,1
0,441,441,109,55,54,3,2
7,449,449,18,10,8,3,2
16,488,488,69,12,57,4,3
8,499,499,5,5,0,1,0

30,100,100,12,3,9,2,1
1,101,101,2,2,0,1,0
16,114,114,1,1,0,1,0
5,116,116,5,5,0,1,0
9,118,118,12,12,0,1,0
17,122,122,4,4,0,1,0
4,123,123,20,20,0,1,0
21,125,125,1,1,0,1,0
20,129,129,4,4,0,1,0
3,136,136,5,5,0,1,0
15,137,137,11,1,10,2,1
14,145,145,3,3,0,1,0
13,160,160,11,2,9,4,3
6,197,197,3,3,0,1,0
25,211,211,10,10,0,1,0
0,213,213,37,37,0,1,0
12,231,231,1,1,0,1,0
2,246,246,21,21,0,1,0
26,256,256,38,38,0,1,0
19,266,266,12,8,4,2,1
22,299,299,32,13,19,2,1
31,302,302,51,25,26,3,2
32,333,333,82,70,12,4,3
27,364,364,8,4,4,2,1
11,365,365,59,24,35,3,2
8,373,373,18,18,0,1,0
24,386,386,40,40,0,1,0
10,408,408,2,2,0,1,0
23,417,417,32,6,26,3,2
29,425,425,34,34,0,1,0
7,428,428,17,11,6,3,2
28,446,446,43,43,0,1,0
18,449,449,7,3,4,2,1

7,130,130,7,7,0,1,0
0,139,139,41,41,0,1,0
6,147,147,25,4,21,4,3
12,176,176,16,16,0,1,0
17,201,201,26,26,0,1,0
16,211,211,26,26,0,1,0
1,254,254,74,74,0,1,0
3,267,267,22,2,20,2,1
4,277,277,18,3,15,2,1
2,284,284,2,2,0,1,0
8,302,302,39,33,6,3,2
18,326,326,56,56,0,1,0
9,330,330,29,14,15,4,3
5,351,351,38,38,0,1,0
19,357,357,9,9,0,1,0
14,362,362,14,14,0,1,0
20,367,367,14,14,0,1,0
10,396,396,136,8,128,4,3
13,426,426,1,1,0,1,0
15,464,464,59,59,0,1,0
11,486,486,19,19,0,1,0

4,129,129,7,3,4,2,1
7,210,210,1,1,0,1,0
19,214,214,12,5,7,2,1
16,216,216,15,6,9,4,3
3,218,218,22,22,0,1,0
0,226,226,2,2,0,1,0
21,231,231,36,7,29,2,1
11,239,239,6,6,0,1,0
6,273,273,25,8,17,2,1
5,288,288,29,29,0,1,0
22,307,307,33,15,18,2,1
12,330,330,47,47,0,1,0
13,348,348,15,15,0,1,0
18,362,362,66,66,0,1,0
17,369,369,50,44,6,2,1
14,369,369,10,10,0,1,0
1,372,372,114,18,96,3,2
24,383,383,11,11,0,1,0
9,388,388,52,48,4,2,1
8,394,394,36,36,0,1,0
23,396,396,34,34,0,1,0
20,408,408,6,6,0,1,0
2,413,413,3,3,0,1,0
15,447,447,136,68,68,3,2
10,474,474,43,43,0,1,0
25,486,486,26,26,0,1,0

0,121,121,14,14,0,1,0
14,134,134,42,42,0,1,0
23,146,146,6,6,0,1,0
4,180,180,31,28,3,2,1
8,180,180,11,11,0,1,0
16,183,183,11,8,3,2,1
22,184,184,18,18,0,1,0
17,185,185,5,5,0,1,0
12,225,225,52,3,49,2,1
21,248,248,37,37,0,1,0
11,252,252,12,1,11,2,1
10,299,299,29,11,18,3,2
6,329,329,6,1,5,2,1
18,342,342,2,2,0,1,0
5,354,354,38,9,29,2,1
3,366,366,43,31,12,2,1
19,370,370,29,29,0,1,0
20,380,380,15,5,10,2,1
7,403,403,65,51,14,2,1
1,405,405,16,10,6,2,1
15,411,411,63,51,12,2,1
9,448,448,86,86,0,1,0
13,469,469,18,18,0,1,0
2,484,484,36,36,0,1,0

10,107,107,7,2,5,2,1
15,113,113,2,2,0,1,0
8,183,183,2,2,0,1,0
20,193,193,12,1,11,2,1
0,212,212,31,31,0,1,0
19,228,228,5,5,0,1,0
14,231,231,12,6,6,3,2
1,246,246,5,5,0,1,0
12,264,264,82,43,39,2,1
7,306,306,33,33,0,1,0
9,317,317,27,27,0,1,0
2,317,317,120,120,0,1,0
13,336,336,22,5,17,4,3
16,336,336,61,11,50,3,2
17,338,338,5,5,0,1,0
3,351,351,26,18,8,3,2
18,361,361,54,54,0,1,0
6,408,408,3,3,0,1,0
5,408,408,100,8,92,3,2
11,425,425,87,19,68,3,2
4,442,442,93,45,48,4,3

6,131,131,8,8,0,1,0
19,138,138,11,11,0,1,0
8,171,171,4,1,3,2,1
5,172,172,3,3,0,1,0
0,174,174,21,3,18,2,1
9,176,176,22,6,16,3,2
12,194,194,2,2,0,1,0
14,206,206,6,6,0,1,0
4,207,207,4,4,0,1,0
11,215,215,13,13,0,1,0
1,229,229,14,14,0,1,0
3,233,233,13,13,0,1,0
13,257,257,49,17,32,4,3
15,268,268,5,5,0,1,0
23,273,273,25,12,13,2,1
16,284,284,17,1,16,3,2
7,309,309,91,91,0,1,0
25,357,357,20,20,0,1,0
10,363,363,41,21,20,2,1
18,370,370,120,114,6,3,2
17,376,376,105,9,96,3,2
24,379,379,70,70,0,1,0
20,393,393,18,18,0,1,0
22,425,425,2,2,0,1,0
21,466,466,22,22,0,1,0
2,473,473,23,23,0,1,0

24,107,107,11,2,9,4,3
8,108,108,30,30,0,1,0
16,133,133,6,6,0,1,0
17,160,160,9,2,7,2,1
1,185,185,8,8,0,1,0
13,187,187,28,21,7,2,1
11,209,209,59,26,33,2,1
4,250,250,9,9,0,1,0
14,259,259,43,27,16,3,2
23,267,267,30,8,22,3,2
15,273,273,18,18,0,1,0
18,280,280,15,6,9,2,1
21,287,287,20,20,0,1,0
6,323,323,1,1,0,1,0
0,342,342,27,27,0,1,0
9,353,353,21,10,11,2,1
20,358,358,5,5,0,1,0
12,358,358,11,11,0,1,0
22,365,365,126,24,102,4,3
5,379,379,10,1,9,4,3
7,398,398,51,51,0,1,0
3,419,419,12,12,0,1,0
2,443,443,20,13,7,2,1
10,450,450,73,73,0,1,0
19,452,452,23,15,8,3,2

22,101,101,4,4,0,1,0
9,105,105,6,6,0,1,0
10,141,141,11,11,0,1,0
23,176,176,13,6,7,2,1
17,275,275,1,1,0,1,0
16,304,304,11,6,5,2,1
1,333,333,11,11,0,1,0
3,340,340,60,18,42,4,3
11,346,346,37,32,5,2,1
2,357,357,8,8,0,1,0
7,365,365,26,7,19,2,1
4,366,366,35,35,0,1,0
5,387,387,147,55,92,4,3
21,392,392,18,6,12,4,3
0,407,407,15,15,0,1,0
6,408,408,16,2,14,3,2
19,416,416,8,8,0,1,0
8,428,428,35,1,34,4,3
24,431,431,30,30,0,1,0
14,431,431,34,34,0,1,0
13,442,442,32,32,0,1,0
12,452,452,10,6,4,2,1
20,462,462,25,25,0,1,0
18,467,467,87,87,0,1,0
15,497,497,267,219,48,2,1

19,110,110,7,7,0,1,0
11,110,110,27,27,0,1,0
3,154,154,15,15,0,1,0
15,181,181,4,4,0,1,0
20,201,201,33,33,0,1,0
14,210,210,13,13,0,1,0
12,241,241,23,23,0,1,0
6,265,265,15,1,14,4,3
4,283,283,17,17,0,1,0
17,283,283,96,1,95,4,3
8,324,324,33,33,0,1,0
22,339,339,8,8,0,1,0
25,352,352,3,3,0,1,0
13,396,396,7,1,6,3,2
0,397,397,31,31,0,1,0
9,413,413,21,21,0,1,0
16,428,428,117,45,72,3,2
24,440,440,3,3,0,1,0
1,448,448,108,108,0,1,0
5,451,451,10,2,8,2,1
18,461,461,55,55,0,1,0
21,465,465,37,37,0,1,0
10,470,470,2,2,0,1,0
23,473,473,29,29,0,1,0
2,496,496,38,30,8,2,1
7,500,500,27,17,10,2,1

20,125,125,11,11,0,1,0
7,154,154,2,2,0,1,0
2,163,163,17,5,12,3,2
6,167,167,18,18,0,1,0
1,178,178,8,8,0,1,0
21,183,183,11,4,7,2,1
23,199,199,42,42,0,1,0
14,202,202,32,32,0,1,0
17,205,205,19,2,17,3,2
9,227,227,43,15,28,2,1
8,252,252,42,9,33,4,3
22,253,253,14,14,0,1,0
5,255,255,27,1,26,3,2
4,272,272,1,1,0,1,0
10,283,283,1,1,0,1,0
19,317,317,22,13,9,4,3
16,339,339,55,10,45,2,1
3,355,355,78,65,13,2,1
13,368,368,42,30,12,3,2
18,372,372,25,25,0,1,0
15,376,376,9,9,0,1,0
12,430,430,53,45,8,2,1
0,440,440,37,32,5,2,1
11,446,446,71,71,0,1,0

3,108,108,21,9,12,3,2
1,130,130,6,6,0,1,0
5,131,131,29,29,0,1,0
8,134,134,6,6,0,1,0
14,155,155,36,15,21,4,3
18,160,160,17,17,0,1,0
2,164,164,6,6,0,1,0
12,176,176,7,7,0,1,0
22,194,194,5,5,0,1,0
13,195,195,9,9,0,1,0
11,220,220,32,16,16,3,2
20,242,242,7,4,3,2,1
4,261,261,2,2,0,1,0
15,293,293,9,5,4,2,1
7,295,295,11,7,4,2,1
17,310,310,29,29,0,1,0
10,322,322,12,12,0,1,0
6,404,404,81,81,0,1,0
9,406,406,32,9,23,2,1
0,455,455,70,4,66,4,3
19,465,465,52,30,22,2,1
21,471,471,36,13,23,2,1
16,477,477,163,109,54,3,2
23,487,487,46,30,16,2,1

17,120,120,5,5,0,1,0
10,134,134,13,13,0,1,0
3,145,145,5,5,0,1,0
9,160,160,1,1,0,1,0
7,211,211,42,42,0,1,0
13,213,213,17,17,0,1,0
5,280,280,212,195,17,2,1
16,282,282,33,33,0,1,0
8,284,284,14,14,0,1,0
12,303,303,9,3,6,2,1
0,325,325,54,54,0,1,0
4,339,339,11,8,3,2,1
11,347,347,96,15,81,4,3
14,357,357,2,2,0,1,0
2,384,384,80,37,43,2,1
6,413,413,4,4,0,1,0
1,485,485,1,1,0,1,0
15,499,499,158,38,120,4,3

23,144,144,2,2,0,1,0
18,165,165,118,118,0,1,0
11,184,184,44,44,0,1,0
20,210,210,2,2,0,1,0
6,211,211,5,5,0,1,0
10,229,229,4,1,3,2,1
21,252,252,13,13,0,1,0
1,267,267,52,52,0,1,0
19,317,317,4,4,0,1,0
7,324,324,83,39,44,2,1
9,326,326,37,13,24,4,3
15,330,330,15,7,8,2,1
17,342,342,17,17,0,1,0
4,371,371,18,1,17,2,1
5,420,420,2,2,0,1,0
22,430,430,20,7,13,2,1
12,441,441,10,2,8,2,1
14,462,462,41,41,0,1,0
3,466,466,8,8,0,1,0
8,478,478,5,5,0,1,0
2,478,478,71,17,54,4,3
0,478,478,61,1,60,3,2
13,487,487,47,47,0,1,0
16,498,498,32,11,21,2,1

4,104,104,43,43,0,1,0
13,152,152,5,5,0,1,0
11,161,161,15,15,0,1,0
14,174,174,16,16,0,1,0
7,180,180,14,10,4,2,1
19,200,200,41,41,0,1,0
15,213,213,10,10,0,1,0
3,219,219,41,41,0,1,0
6,234,234,60,25,35,3,2
5,248,248,8,8,0,1,0
1,264,264,5,5,0,1,0
16,296,296,18,18,0,1,0
0,307,307,3,3,0,1,0
17,308,308,1,1,0,1,0
18,328,328,15,15,0,1,0
12,334,334,119,79,40,2,1
10,355,355,28,17,11,2,1
20,363,363,27,4,23,2,1
8,391,391,2,2,0,1,0
2,453,453,51,33,18,3,2
21,456,456,61,21,40,3,2
9,459,459,40,40,0,1,0

1,119,119,11,11,0,1,0
0,154,154,13,10,3,2,1
14,198,198,20,4,16,2,1
3,216,216,86,74,12,4,3
6,218,218,35,35,0,1,0
5,234,234,21,5,16,3,2
2,253,253,12,4,8,2,1
19,255,255,10,4,6,2,1
4,262,262,15,10,5,2,1
13,269,269,23,23,0,1,0
11,291,291,17,17,0,1,0
16,327,327,36,27,9,4,3
9,342,342,9,9,0,1,0
8,345,345,82,68,14,3,2
17,347,347,42,42,0,1,0
12,365,365,50,33,17,2,1
18,375,375,18,18,0,1,0
10,466,466,135,135,0,1,0
15,486,486,40,10,30,3,2
7,489,489,16,2,14,2,1
20,499,499,60,27,33,4,3

3,100,100,3,3,0,1,0
24,112,112,16,4,12,3,2
27,121,121,17,1,16,3,2
13,123,123,15,2,13,4,3
20,157,157,5,5,0,1,0
22,179,179,26,8,18,4,3
29,182,182,32,10,22,3,2
8,204,204,27,6,21,4,3
21,220,220,48,15,33,4,3
23,247,247,3,3,0,1,0
19,251,251,64,30,34,2,1
12,253,253,16,4,12,4,3
16,257,257,19,4,15,2,1
6,265,265,9,3,6,2,1
15,276,276,6,6,0,1,0
17,285,285,7,7,0,1,0
7,287,287,6,3,3,2,1
5,295,295,70,70,0,1,0
25,302,302,9,9,0,1,0
9,332,332,10,1,9,4,3
11,347,347,40,40,0,1,0
10,355,355,22,22,0,1,0
1,374,374,14,14,0,1,0
18,378,378,8,8,0,1,0
2,394,394,16,16,0,1,0
28,424,424,22,22,0,1,0
14,447,447,17,17,0,1,0
26,475,475,2,2,0,1,0
4,483,483,42,22,20,2,1
0,483,483,15,2,13,2,1

15,191,191,19,19,0,1,0
25,240,240,8,8,0,1,0
6,245,245,35,15,20,3,2
12,253,253,87,39,48,3,2
11,257,257,1,1,0,1,0
1,267,267,30,2,28,3,2
17,267,267,2,2,0,1,0
13,289,289,22,13,9,2,1
9,303,303,76,73,3,2,1
8,308,308,22,22,0,1,0
18,315,315,104,104,0,1,0
23,324,324,45,45,0,1,0
19,330,330,16,1,15,2,1
21,339,339,79,25,54,4,3
5,351,351,1,1,0,1,0
4,384,384,1,1,0,1,0
14,402,402,42,9,33,4,3
20,417,417,2,2,0,1,0
22,418,418,19,9,10,2,1
7,422,422,22,4,18,4,3
16,436,436,67,26,41,2,1
3,436,436,33,33,0,1,0
0,450,450,1,1,0,1,0
10,470,470,24,5,19,2,1
2,489,489,6,6,0,1,0
24,489,489,9,3,6,2,1

12,104,104,26,26,0,1,0
11,110,110,12,1,11,3,2
7,138,138,2,2,0,1,0
5,148,148,3,3,0,1,0
0,166,166,45,27,18,2,1
14,202,202,30,25,5,2,1
17,219,219,4,4,0,1,0
18,220,220,13,4,9,4,3
15,228,228,6,6,0,1,0
1,249,249,96,96,0,1,0
9,284,284,43,43,0,1,0
16,288,288,47,47,0,1,0
6,299,299,62,21,41,2,1
3,318,318,59,31,28,2,1
20,383,383,17,17,0,1,0
4,385,385,4,4,0,1,0
13,395,395,2,2,0,1,0
8,472,472,8,8,0,1,0
2,474,474,42,8,34,3,2
19,488,488,103,1,102,4,3
10,496,496,21,17,4,2,1

1,154,154,27,4,23,2,1
4,160,160,7,7,0,1,0
15,169,169,16,1,15,4,3
8,175,175,1,1,0,1,0
14,204,204,13,13,0,1,0
23,218,218,66,56,10,2,1
21,231,231,6,2,4,2,1
2,233,233,3,3,0,1,0
12,237,237,12,12,0,1,0
16,256,256,5,5,0,1,0
5,258,258,25,25,0,1,0
6,262,262,82,82,0,1,0
3,302,302,19,13,6,2,1
22,320,320,75,75,0,1,0
11,352,352,1,1,0,1,0
20,372,372,33,33,0,1,0
9,375,375,27,11,16,2,1
17,390,390,33,22,11,2,1
19,464,464,27,5,22,2,1
7,466,466,42,20,22,3,2
10,479,479,34,34,0,1,0
13,490,490,9,9,0,1,0
0,496,496,127,127,0,1,0
18,496,496,90,90,0,1,0

27,108,108,31,31,0,1,0
20,138,138,1,1,0,1,0
13,145,145,17,17,0,1,0
6,146,146,2,2,0,1,0
24,151,151,19,7,12,4,3
9,158,158,16,16,0,1,0
19,201,201,1,1,0,1,0
18,211,211,1,1,0,1,0
7,214,214,2,2,0,1,0
14,226,226,12,12,0,1,0
29,249,249,2,2,0,1,0
26,258,258,55,31,24,4,3
1,263,263,1,1,0,1,0
17,265,265,3,3,0,1,0
3,271,271,8,8,0,1,0
10,273,273,53,5,48,4,3
4,285,285,3,3,0,1,0
2,290,290,81,20,61,3,2
12,293,293,5,5,0,1,0
23,298,298,3,3,0,1,0
5,318,318,14,8,6,3,2
0,357,357,12,4,8,3,2
8,383,383,3,3,0,1,0
11,399,399,45,45,0,1,0
25,430,430,20,20,0,1,0
28,444,444,166,166,0,1,0
21,464,464,61,34,27,2,1
22,485,485,9,9,0,1,0
15,495,495,38,38,0,1,0
16,498,498,43,43,0,1,0

9,106,106,7,3,4,2,1
6,111,111,4,4,0,1,0
3,130,130,17,17,0,1,0
10,137,137,3,3,0,1,0
19,137,137,65,19,46,2,1
23,187,187,9,1,8,3,2
24,214,214,14,14,0,1,0
18,226,226,2,2,0,1,0
0,236,236,29,29,0,1,0
25,237,237,21,21,0,1,0
1,246,246,5,2,3,2,1
15,248,248,12,2,10,3,2
17,269,269,18,4,14,3,2
7,279,279,12,3,9,4,3
4,283,283,7,7,0,1,0
2,289,289,18,18,0,1,0
13,301,301,25,13,12,4,3
12,311,311,16,16,0,1,0
16,315,315,30,30,0,1,0
14,330,330,8,1,7,2,1
20,338,338,24,24,0,1,0
21,412,412,80,24,56,3,2
11,415,415,64,16,48,4,3
22,438,438,14,14,0,1,0
5,449,449,74,74,0,1,0
8,489,489,108,66,42,2,1

2,124,124,30,9,21,3,2
25,134,134,1,1,0,1,0
24,143,143,6,6,0,1,0
11,150,150,1,1,0,1,0
3,151,151,3,3,0,1,0
0,156,156,15,2,13,2,1
7,192,192,1,1,0,1,0
22,198,198,38,1,37,2,1
20,226,226,32,32,0,1,0
9,229,229,1,1,0,1,0
14,230,230,23,23,0,1,0
23,244,244,11,4,7,2,1
1,270,270,38,38,0,1,0
19,281,281,6,6,0,1,0
4,315,315,40,40,0,1,0
5,324,324,8,3,5,2,1
21,333,333,4,4,0,1,0
8,370,370,81,41,40,3,2
6,376,376,39,3,36,4,3
10,382,382,33,33,0,1,0
16,396,396,14,14,0,1,0
18,401,401,53,35,18,4,3
15,426,426,80,80,0,1,0
26,448,448,84,84,0,1,0
17,465,465,102,59,43,2,1
13,477,477,9,3,6,3,2
12,498,498,3,3,0,1,0

23,121,121,1,1,0,1,0
17,125,125,6,6,0,1,0
15,134,134,4,4,0,1,0
5,139,139,8,2,6,2,1
10,144,144,2,2,0,1,0
16,163,163,41,31,10,3,2
3,212,212,2,2,0,1,0
21,213,213,1,1,0,1,0
4,217,217,37,12,25,2,1
7,233,233,9,6,3,2,1
9,249,249,70,70,0,1,0
14,252,252,19,19,0,1,0
2,254,254,2,2,0,1,0
12,260,260,29,29,0,1,0
0,275,275,33,33,0,1,0
19,301,301,28,16,12,2,1
6,321,321,9,9,0,1,0
11,335,335,11,11,0,1,0
13,362,362,6,6,0,1,0
22,372,372,44,5,39,2,1
1,379,379,121,115,6,2,1
8,396,396,5,1,4,2,1
18,402,402,22,8,14,3,2
20,465,465,109,109,0,1,0
24,472,472,139,139,0,1,0

10,110,110,6,6,0,1,0
8,122,122,3,3,0,1,0
18,132,132,15,15,0,1,0
2,161,161,8,2,6,3,2
4,163,163,5,5,0,1,0
17,163,163,21,21,0,1,0
12,179,179,14,14,0,1,0
13,183,183,37,37,0,1,0
14,194,194,2,2,0,1,0
31,198,198,13,2,11,4,3
3,198,198,5,5,0,1,0
7,220,220,1,1,0,1,0
1,225,225,8,2,6,2,1
24,227,227,8,4,4,2,1
19,252,252,11,6,5,2,1
29,254,254,28,20,8,2,1
27,266,266,74,48,26,2,1
30,274,274,7,7,0,1,0
16,275,275,18,1,17,3,2
21,280,280,30,27,3,2,1
25,303,303,71,47,24,2,1
6,351,351,22,2,20,3,2
20,361,361,48,48,0,1,0
5,374,374,4,4,0,1,0
9,379,379,11,2,9,2,1
28,385,385,6,6,0,1,0
11,400,400,18,18,0,1,0
0,418,418,69,25,44,2,1
26,424,424,29,29,0,1,0
23,468,468,50,50,0,1,0
22,475,475,18,2,16,2,1
15,494,494,11,1,10,3,2

23,101,101,14,14,0,1,0
18,112,112,18,18,0,1,0
8,113,113,16,16,0,1,0
9,114,114,6,1,5,2,1
4,125,125,4,4,0,1,0
15,193,193,3,3,0,1,0
27,194,194,15,4,11,2,1
26,225,225,3,3,0,1,0
30,227,227,45,45,0,1,0
14,241,241,18,18,0,1,0
22,241,241,53,53,0,1,0
21,246,246,37,4,33,2,1
11,247,247,6,6,0,1,0
2,250,250,1,1,0,1,0
12,252,252,26,26,0,1,0
6,255,255,32,5,27,2,1
13,290,290,16,16,0,1,0
16,295,295,15,15,0,1,0
20,300,300,35,35,0,1,0
28,309,309,48,30,18,4,3
29,312,312,27,22,5,2,1
17,335,335,17,17,0,1,0
10,345,345,6,3,3,2,1
1,349,349,35,35,0,1,0
19,375,375,8,8,0,1,0
24,382,382,8,8,0,1,0
5,426,426,12,12,0,1,0
0,440,440,71,14,57,3,2
25,441,441,12,12,0,1,0
7,483,483,3,3,0,1,0
3,497,497,1,1,0,1,0

17,112,112,16,16,0,1,0
2,115,115,10,10,0,1,0
3,118,118,15,15,0,1,0
12,127,127,2,2,0,1,0
5,154,154,34,34,0,1,0
18,219,219,1,1,0,1,0
1,234,234,20,8,12,4,3
15,234,234,11,6,5,2,1
9,235,235,67,67,0,1,0
24,236,236,4,4,0,1,0
4,239,239,30,20,10,2,1
23,253,253,21,21,0,1,0
11,282,282,23,23,0,1,0
0,287,287,8,8,0,1,0
21,293,293,19,7,12,3,2
7,305,305,8,8,0,1,0
8,316,316,5,2,3,2,1
14,327,327,13,13,0,1,0
13,365,365,15,15,0,1,0
22,372,372,57,47,10,2,1
16,382,382,73,73,0,1,0
6,388,388,2,2,0,1,0
19,396,396,45,45,0,1,0
20,407,407,131,47,84,3,2
10,493,493,48,48,0,1,0

8,112,112,15,15,0,1,0
2,184,184,26,17,9,4,3
12,193,193,8,4,4,2,1
21,197,197,7,7,0,1,0
6,200,200,6,6,0,1,0
9,220,220,9,2,7,2,1
20,225,225,19,19,0,1,0
7,239,239,14,9,5,2,1
18,243,243,21,16,5,2,1
0,252,252,15,15,0,1,0
19,263,263,23,23,0,1,0
3,299,299,13,13,0,1,0
5,306,306,13,7,6,3,2
4,308,308,18,1,17,2,1
16,319,319,50,12,38,2,1
13,361,361,17,17,0,1,0
22,365,365,8,8,0,1,0
23,385,385,28,28,0,1,0
17,403,403,11,8,3,2,1
1,441,441,49,10,39,4,3
15,457,457,11,11,0,1,0
24,459,459,41,41,0,1,0
10,459,459,81,65,16,2,1
11,485,485,129,120,9,2,1
14,492,492,240,99,141,4,3

20,126,126,13,13,0,1,0
23,148,148,1,1,0,1,0
15,149,149,23,23,0,1,0
9,160,160,5,5,0,1,0
22,167,167,2,2,0,1,0
11,169,169,11,11,0,1,0
16,246,246,58,14,44,3,2
1,265,265,6,1,5,2,1
24,270,270,5,5,0,1,0
5,284,284,28,9,19,3,2
10,306,306,14,2,12,3,2
19,319,319,5,5,0,1,0
18,322,322,57,57,0,1,0
25,333,333,46,46,0,1,0
13,340,340,63,45,18,2,1
21,346,346,33,33,0,1,0
8,358,358,51,30,21,3,2
4,377,377,22,22,0,1,0
7,389,389,15,9,6,2,1
17,406,406,3,3,0,1,0
0,453,453,59,59,0,1,0
6,455,455,52,27,25,2,1
2,461,461,39,13,26,2,1
14,465,465,128,14,114,4,3
3,474,474,54,54,0,1,0
12,498,498,35,35,0,1,0

19,103,103,11,11,0,1,0
23,127,127,12,12,0,1,0
11,141,141,8,8,0,1,0
7,153,153,14,2,12,3,2
21,161,161,32,32,0,1,0
9,163,163,4,4,0,1,0
13,183,183,19,8,11,2,1
22,186,186,37,37,0,1,0
3,206,206,1,1,0,1,0
15,206,206,3,3,0,1,0
27,213,213,5,5,0,1,0
2,244,244,1,1,0,1,0
14,284,284,48,13,35,2,1
24,292,292,35,9,26,3,2
5,293,293,37,37,0,1,0
25,312,312,1,1,0,1,0
8,313,313,10,10,0,1,0
0,321,321,39,13,26,3,2
26,335,335,18,18,0,1,0
20,367,367,11,11,0,1,0
18,374,374,110,110,0,1,0
12,386,386,68,26,42,4,3
17,437,437,19,1,18,4,3
16,448,448,26,12,14,3,2
10,450,450,43,43,0,1,0
1,479,479,68,18,50,3,2
6,500,500,20,20,0,1,0
4,500,500,1,1,0,1,0

11,105,105,7,2,5,2,1
13,128,128,17,17,0,1,0
14,142,142,10,4,6,2,1
7,144,144,3,3,0,1,0
6,151,151,28,28,0,1,0
24,170,170,14,4,10,2,1
2,194,194,50,50,0,1,0
23,219,219,8,8,0,1,0
15,223,223,13,13,0,1,0
19,239,239,20,17,3,2,1
0,245,245,40,40,0,1,0
9,250,250,1,1,0,1,0
10,265,265,1,1,0,1,0
1,268,268,18,18,0,1,0
16,271,271,56,56,0,1,0
21,297,297,12,12,0,1,0
20,305,305,89,5,84,3,2
12,325,325,3,3,0,1,0
18,373,373,16,16,0,1,0
17,387,387,54,27,27,2,1
22,431,431,19,19,0,1,0
5,435,435,70,70,0,1,0
4,439,439,2,2,0,1,0
8,479,479,5,5,0,1,0
3,480,480,119,91,28,3,2

4,130,130,6,6,0,1,0
24,131,131,4,4,0,1,0
8,143,143,43,43,0,1,0
18,207,207,1,1,0,1,0
13,212,212,2,2,0,1,0
14,232,232,6,6,0,1,0
19,242,242,78,78,0,1,0
2,284,284,26,26,0,1,0
10,287,287,18,18,0,1,0
16,309,309,22,11,11,2,1
17,321,321,11,2,9,2,1
3,345,345,20,4,16,3,2
23,350,350,47,7,40,3,2
0,361,361,6,6,0,1,0
6,362,362,70,26,44,2,1
12,388,388,13,13,0,1,0
5,389,389,51,14,37,4,3
1,407,407,15,1,14,3,2
7,415,415,50,45,5,2,1
21,445,445,85,40,45,4,3
9,463,463,17,17,0,1,0
15,464,464,114,114,0,1,0
22,469,469,28,22,6,3,2
11,497,497,37,12,25,2,1
20,498,498,47,4,43,2,1

1,118,118,4,1,3,2,1
5,129,129,25,25,0,1,0
18,143,143,19,19,0,1,0
4,175,175,1,1,0,1,0
19,185,185,1,1,0,1,0
17,186,186,20,20,0,1,0
26,199,199,1,1,0,1,0
10,201,201,22,4,18,4,3
24,219,219,50,10,40,3,2
9,254,254,40,20,20,3,2
11,268,268,17,17,0,1,0
3,271,271,25,3,22,3,2
16,271,271,49,49,0,1,0
7,281,281,10,10,0,1,0
23,282,282,33,33,0,1,0
21,284,284,26,8,18,2,1
8,330,330,10,10,0,1,0
0,345,345,32,32,0,1,0
15,346,346,5,5,0,1,0
25,352,352,18,15,3,2,1
14,366,366,23,23,0,1,0
20,389,389,35,35,0,1,0
6,429,429,7,1,6,2,1
2,453,453,4,4,0,1,0
12,455,455,110,42,68,3,2
13,473,473,27,17,10,2,1
22,481,481,97,37,60,4,3

16,116,116,12,2,10,2,1
8,151,151,11,11,0,1,0
24,171,171,11,3,8,3,2
21,173,173,3,3,0,1,0
20,181,181,54,24,30,2,1
12,241,241,1,1,0,1,0
11,243,243,6,1,5,2,1
1,248,248,40,40,0,1,0
25,257,257,18,18,0,1,0
3,257,257,9,9,0,1,0
17,282,282,9,9,0,1,0
18,301,301,27,27,0,1,0
19,334,334,5,5,0,1,0
22,350,350,32,18,14,2,1
4,351,351,2,2,0,1,0
9,353,353,6,6,0,1,0
2,383,383,74,36,38,3,2
6,398,398,49,49,0,1,0
13,398,398,31,31,0,1,0
0,430,430,8,8,0,1,0
10,431,431,29,2,27,4,3
26,440,440,55,55,0,1,0
14,468,468,8,8,0,1,0
23,469,469,96,39,57,3,2
7,478,478,93,53,40,4,3
5,478,478,90,90,0,1,0
15,490,490,55,55,0,1,0

11,130,130,3,3,0,1,0
7,150,150,6,6,0,1,0
24,158,158,52,16,36,2,1
12,184,184,15,15,0,1,0
22,187,187,5,5,0,1,0
18,209,209,19,19,0,1,0
4,211,211,17,1,16,2,1
3,244,244,29,24,5,2,1
13,269,269,28,18,10,3,2
16,275,275,53,17,36,2,1
5,280,280,43,43,0,1,0
15,289,289,72,16,56,3,2
8,307,307,52,8,44,2,1
0,312,312,47,16,31,2,1
20,320,320,53,20,33,2,1
14,323,323,2,2,0,1,0
25,332,332,9,9,0,1,0
1,348,348,5,5,0,1,0
23,350,350,12,12,0,1,0
6,362,362,32,32,0,1,0
10,397,397,36,17,19,2,1
17,426,426,25,16,9,2,1
19,431,431,14,14,0,1,0
2,457,457,18,18,0,1,0
21,478,478,6,6,0,1,0
9,486,486,23,23,0,1,0

9,110,110,1,1,0,1,0
21,120,120,6,6,0,1,0
2,124,124,2,2,0,1,0
12,143,143,1,1,0,1,0
19,164,164,9,4,5,2,1
0,191,191,5,5,0,1,0
1,192,192,7,1,6,2,1
8,250,250,19,19,0,1,0
5,252,252,81,11,70,3,2
7,291,291,77,77,0,1,0
4,302,302,17,17,0,1,0
16,338,338,10,10,0,1,0
13,346,346,40,28,12,3,2
23,378,378,44,44,0,1,0
22,401,401,79,58,21,2,1
6,408,408,3,3,0,1,0
15,414,414,32,32,0,1,0
24,436,436,41,41,0,1,0
20,459,459,34,34,0,1,0
17,462,462,35,4,31,2,1
11,466,466,26,26,0,1,0
14,485,485,154,140,14,4,3
10,487,487,101,17,84,4,3
18,497,497,10,1,9,2,1
3,497,497,61,61,0,1,0

5,150,150,90,82,8,3,2
8,152,152,3,3,0,1,0
20,154,154,5,5,0,1,0
15,155,155,14,14,0,1,0
16,162,162,28,28,0,1,0
13,165,165,42,42,0,1,0
2,210,210,26,26,0,1,0
19,238,238,40,40,0,1,0
3,255,255,15,15,0,1,0
4,288,288,11,3,8,3,2
11,313,313,5,5,0,1,0
12,331,331,1,1,0,1,0
7,353,353,102,75,27,4,3
6,367,367,8,8,0,1,0
17,381,381,18,2,16,3,2
14,382,382,2,2,0,1,0
18,390,390,107,107,0,1,0
0,393,393,20,8,12,2,1
10,453,453,46,46,0,1,0
9,488,488,28,28,0,1,0
1,496,496,1,1,0,1,0

0,116,116,7,7,0,1,0
26,136,136,1,1,0,1,0
1,170,170,24,21,3,2,1
11,192,192,37,16,21,2,1
2,192,192,16,4,12,4,3
21,207,207,7,7,0,1,0
18,208,208,39,30,9,2,1
19,209,209,12,12,0,1,0
22,214,214,1,1,0,1,0
7,259,259,67,21,46,3,2
8,267,267,32,32,0,1,0
25,286,286,36,30,6,3,2
20,309,309,8,8,0,1,0
3,331,331,11,2,9,4,3
6,335,335,9,9,0,1,0
15,352,352,16,6,10,3,2
14,352,352,22,19,3,2,1
24,353,353,44,32,12,4,3
13,396,396,19,19,0,1,0
16,405,405,39,11,28,3,2
10,413,413,5,5,0,1,0
12,415,415,7,7,0,1,0
5,451,451,19,12,7,2,1
4,452,452,31,21,10,2,1
17,469,469,150,150,0,1,0
9,471,471,16,16,0,1,0
23,495,495,92,39,53,4,3

9,120,120,15,10,5,2,1
3,122,122,53,5,48,2,1
16,132,132,10,10,0,1,0
14,209,209,12,12,0,1,0
20,213,213,16,16,0,1,0
11,261,261,14,14,0,1,0
4,279,279,23,23,0,1,0
6,290,290,18,9,9,2,1
5,310,310,36,36,0,1,0
8,334,334,17,17,0,1,0
15,335,335,3,3,0,1,0
10,362,362,3,3,0,1,0
21,364,364,12,12,0,1,0
19,367,367,19,1,18,3,2
13,373,373,18,2,16,3,2
1,412,412,40,40,0,1,0
2,414,414,7,7,0,1,0
0,440,440,9,9,0,1,0
12,448,448,141,141,0,1,0
7,469,469,94,94,0,1,0
17,470,470,212,170,42,3,2
18,470,470,18,9,9,2,1

9,115,115,9,9,0,1,0
24,124,124,1,1,0,1,0
21,130,130,19,4,15,4,3
0,131,131,17,17,0,1,0
8,211,211,4,4,0,1,0
1,220,220,40,9,31,4,3
5,230,230,59,19,40,2,1
10,230,230,46,46,0,1,0
18,236,236,3,3,0,1,0
11,250,250,4,1,3,2,1
16,267,267,58,58,0,1,0
6,270,270,1,1,0,1,0
7,283,283,7,7,0,1,0
22,288,288,52,52,0,1,0
13,295,295,10,10,0,1,0
23,308,308,11,1,10,2,1
15,311,311,53,15,38,2,1
25,323,323,40,13,27,4,3
14,328,328,24,24,0,1,0
12,349,349,9,3,6,3,2
17,351,351,1,1,0,1,0
3,358,358,44,44,0,1,0
19,377,377,2,2,0,1,0
4,411,411,9,9,0,1,0
2,421,421,37,13,24,4,3
20,451,451,113,103,10,3,2

21,108,108,11,11,0,1,0
23,112,112,24,24,0,1,0
3,129,129,12,3,9,2,1
4,137,137,8,8,0,1,0
26,149,149,9,9,0,1,0
22,161,161,20,20,0,1,0
15,181,181,17,17,0,1,0
19,188,188,9,1,8,2,1
0,193,193,11,8,3,2,1
16,196,196,11,11,0,1,0
12,198,198,14,14,0,1,0
6,222,222,22,19,3,2,1
11,264,264,7,4,3,2,1
8,282,282,6,6,0,1,0
9,284,284,39,39,0,1,0
18,301,301,59,9,50,4,3
25,331,331,53,53,0,1,0
1,360,360,60,10,50,3,2
27,367,367,1,1,0,1,0
24,369,369,21,5,16,3,2
7,393,393,26,26,0,1,0
10,398,398,7,7,0,1,0
5,436,436,41,3,38,3,2
20,450,450,68,38,30,4,3
2,450,450,21,9,12,4,3
13,458,458,13,7,6,3,2
14,462,462,58,8,50,4,3
17,473,473,25,25,0,1,0

11,135,135,10,10,0,1,0
8,143,143,9,2,7,2,1
6,154,154,12,12,0,1,0
24,166,166,1,1,0,1,0
13,172,172,4,4,0,1,0
5,207,207,40,34,6,3,2
23,230,230,4,4,0,1,0
17,234,234,17,3,14,2,1
2,248,248,28,8,20,3,2
0,261,261,46,46,0,1,0
3,278,278,44,25,19,3,2
4,285,285,13,6,7,2,1
19,287,287,56,56,0,1,0
14,299,299,1,1,0,1,0
16,306,306,3,3,0,1,0
20,311,311,18,18,0,1,0
21,344,344,78,40,38,2,1
12,366,366,25,14,11,2,1
9,385,385,2,2,0,1,0
7,401,401,4,4,0,1,0
15,440,440,108,18,90,4,3
22,467,467,152,122,30,4,3
18,476,476,18,18,0,1,0
1,490,490,47,27,20,2,1
10,491,491,59,23,36,2,1

17,102,102,13,8,5,2,1
10,105,105,1,1,0,1,0
22,152,152,2,2,0,1,0
24,190,190,16,8,8,3,2
21,190,190,38,38,0,1,0
13,205,205,39,9,30,3,2
7,212,212,6,1,5,2,1
23,217,217,4,4,0,1,0
1,224,224,18,3,15,2,1
4,224,224,54,54,0,1,0
20,234,234,10,10,0,1,0
9,250,250,1,1,0,1,0
2,255,255,37,37,0,1,0
16,284,284,14,8,6,2,1
11,346,346,66,5,61,4,3
3,351,351,25,25,0,1,0
15,367,367,55,31,24,4,3
0,407,407,64,53,11,2,1
14,415,415,47,4,43,2,1
12,422,422,31,31,0,1,0
19,436,436,82,40,42,2,1
6,449,449,11,5,6,2,1
18,455,455,23,18,5,2,1
5,483,483,61,61,0,1,0
8,484,484,24,15,9,4,3

11,101,101,10,7,3,2,1
0,120,120,1,1,0,1,0
18,122,122,21,3,18,3,2
3,132,132,18,18,0,1,0
10,148,148,36,12,24,4,3
5,150,150,25,5,20,4,3
21,167,167,42,7,35,4,3
22,183,183,16,16,0,1,0
17,187,187,27,27,0,1,0
1,190,190,44,34,10,3,2
14,199,199,14,2,12,2,1
15,216,216,1,1,0,1,0
13,244,244,15,1,14,2,1
20,278,278,12,12,0,1,0
6,295,295,69,69,0,1,0
8,310,310,4,1,3,2,1
12,314,314,76,76,0,1,0
2,353,353,34,34,0,1,0
9,396,396,6,6,0,1,0
16,428,428,23,23,0,1,0
19,431,431,3,3,0,1,0
7,439,439,21,21,0,1,0
4,454,454,4,4,0,1,0

18,136,136,21,21,0,1,0
2,143,143,29,29,0,1,0
12,147,147,1,1,0,1,0
21,183,183,24,4,20,3,2
5,203,203,1,1,0,1,0
8,206,206,39,39,0,1,0
0,217,217,31,12,19,2,1
24,221,221,30,30,0,1,0
4,226,226,26,26,0,1,0
19,237,237,10,10,0,1,0
9,256,256,10,10,0,1,0
10,298,298,44,22,22,2,1
22,298,298,28,28,0,1,0
23,329,329,5,2,3,2,1
6,355,355,2,2,0,1,0
7,381,381,29,29,0,1,0
1,388,388,18,18,0,1,0
3,416,416,12,12,0,1,0
14,437,437,32,20,12,3,2
16,442,442,27,27,0,1,0
25,456,456,63,57,6,2,1
11,465,465,23,5,18,2,1
13,473,473,69,37,32,3,2
15,490,490,51,51,0,1,0
20,498,498,60,60,0,1,0
17,500,500,75,9,66,3,2

9,121,121,49,49,0,1,0
15,145,145,2,2,0,1,0
6,149,149,21,21,0,1,0
4,177,177,36,24,12,3,2
16,196,196,8,8,0,1,0
18,218,218,7,1,6,2,1
5,230,230,73,42,31,2,1
19,236,236,26,26,0,1,0
2,261,261,4,4,0,1,0
20,269,269,57,29,28,3,2
8,283,283,12,12,0,1,0
1,294,294,23,23,0,1,0
14,305,305,14,14,0,1,0
11,331,331,19,19,0,1,0
7,374,374,29,29,0,1,0
10,392,392,56,20,36,4,3
17,453,453,6,1,5,2,1
13,458,458,39,39,0,1,0
12,471,471,32,28,4,2,1
0,472,472,72,43,29,2,1
3,488,488,85,85,0,1,0

3,109,109,9,9,0,1,0
4,149,149,14,6,8,2,1
22,152,152,5,2,3,2,1
8,178,178,15,15,0,1,0
11,185,185,11,3,8,3,2
1,201,201,1,1,0,1,0
17,219,219,45,45,0,1,0
26,230,230,29,23,6,3,2
0,246,246,25,25,0,1,0
14,260,260,33,33,0,1,0
19,275,275,19,19,0,1,0
15,285,285,2,2,0,1,0
23,292,292,31,23,8,2,1
27,294,294,16,16,0,1,0
21,296,296,22,22,0,1,0
5,299,299,45,45,0,1,0
2,300,300,38,33,5,2,1
13,310,310,18,18,0,1,0
24,317,317,69,38,31,2,1
20,329,329,28,6,22,4,3
7,330,330,1,1,0,1,0
28,379,379,31,28,3,2,1
25,381,381,43,3,40,2,1
9,387,387,1,1,0,1,0
16,397,397,5,5,0,1,0
18,405,405,21,21,0,1,0
12,409,409,27,27,0,1,0
6,458,458,98,69,29,3,2
10,494,494,3,3,0,1,0

28,101,101,12,12,0,1,0
24,105,105,2,2,0,1,0
8,106,106,1,1,0,1,0
19,121,121,19,19,0,1,0
20,136,136,5,5,0,1,0
5,141,141,1,1,0,1,0
29,159,159,6,1,5,2,1
22,163,163,20,20,0,1,0
26,174,174,12,12,0,1,0
25,199,199,49,49,0,1,0
21,211,211,10,10,0,1,0
30,252,252,38,18,20,4,3
31,261,261,42,39,3,2,1
4,287,287,11,3,8,2,1
23,288,288,28,3,25,2,1
1,290,290,17,17,0,1,0
16,301,301,11,6,5,2,1
11,305,305,13,2,11,2,1
12,308,308,11,2,9,4,3
9,327,327,1,1,0,1,0
10,338,338,34,34,0,1,0
7,339,339,10,10,0,1,0
13,356,356,3,3,0,1,0
14,378,378,61,61,0,1,0
27,397,397,26,9,17,2,1
15,421,421,87,11,76,3,2
6,423,423,6,2,4,2,1
3,428,428,31,17,14,2,1
0,433,433,1,1,0,1,0
32,468,468,45,4,41,4,3
18,469,469,56,18,38,3,2
17,477,477,27,21,6,3,2
2,492,492,5,5,0,1,0

7,104,104,16,2,14,2,1
22,144,144,1,1,0,1,0
25,147,147,30,18,12,2,1
21,167,167,33,33,0,1,0
3,179,179,1,1,0,1,0
24,188,188,25,7,18,3,2
8,198,198,29,29,0,1,0
20,199,199,18,18,0,1,0
5,217,217,16,13,3,2,1
23,227,227,3,3,0,1,0
14,243,243,8,8,0,1,0
26,250,250,53,53,0,1,0
18,270,270,31,31,0,1,0
6,274,274,31,1,30,2,1
16,279,279,41,41,0,1,0
2,283,283,27,12,15,4,3
0,299,299,43,29,14,3,2
28,352,352,13,5,8,3,2
27,360,360,48,36,12,2,1
17,362,362,17,17,0,1,0
15,365,365,3,3,0,1,0
12,367,367,4,4,0,1,0
29,368,368,25,25,0,1,0
19,404,404,8,2,6,2,1
11,412,412,11,4,7,2,1
9,423,423,15,3,12,3,2
10,427,427,16,16,0,1,0
1,439,439,29,15,14,2,1
4,451,451,12,12,0,1,0
13,500,500,15,15,0,1,0

10,100,100,10,10,0,1,0
11,131,131,10,10,0,1,0
6,143,143,7,7,0,1,0
2,159,159,7,7,0,1,0
14,172,172,20,1,19,4,3
25,199,199,44,9,35,2,1
4,212,212,15,3,12,4,3
23,217,217,8,4,4,2,1
8,230,230,11,11,0,1,0
22,239,239,9,9,0,1,0
19,255,255,43,23,20,3,2
9,257,257,4,4,0,1,0
16,314,314,15,15,0,1,0
15,325,325,27,27,0,1,0
7,325,325,20,20,0,1,0
18,333,333,1,1,0,1,0
13,344,344,121,121,0,1,0
1,381,381,19,4,15,4,3
20,421,421,29,16,13,2,1
5,423,423,51,22,29,3,2
24,427,427,12,4,8,3,2
0,445,445,23,9,14,2,1
3,450,450,11,5,6,3,2
21,450,450,62,3,59,3,2
17,475,475,127,93,34,3,2
12,483,483,67,48,19,2,1

8,102,102,1,1,0,1,0
18,116,116,5,1,4,2,1
11,126,126,10,10,0,1,0
3,155,155,55,33,22,2,1
6,172,172,14,1,13,2,1
5,196,196,37,1,36,3,2
2,200,200,52,52,0,1,0
1,205,205,9,9,0,1,0
14,228,228,20,20,0,1,0
17,235,235,58,2,56,3,2
10,245,245,47,47,0,1,0
7,262,262,12,7,5,2,1
4,278,278,50,2,48,4,3
0,287,287,27,7,20,3,2
16,339,339,61,61,0,1,0
9,386,386,33,9,24,2,1
12,414,414,44,44,0,1,0
15,434,434,52,12,40,3,2
13,471,471,18,18,0,1,0

17,101,101,11,5,6,2,1
18,110,110,25,25,0,1,0
6,121,121,12,12,0,1,0
27,124,124,3,3,0,1,0
4,138,138,2,2,0,1,0
11,139,139,2,2,0,1,0
1,142,142,14,3,11,2,1
8,149,149,20,1,19,4,3
5,163,163,20,4,16,2,1
21,188,188,13,13,0,1,0
3,212,212,5,5,0,1,0
12,218,218,1,1,0,1,0
7,240,240,3,3,0,1,0
14,243,243,12,12,0,1,0
19,244,244,21,11,10,2,1
0,258,258,18,5,13,2,1
2,272,272,86,86,0,1,0
26,277,277,5,5,0,1,0
25,282,282,139,43,96,4,3
9,319,319,21,21,0,1,0
22,340,340,16,4,12,2,1
10,426,426,39,22,17,2,1
15,433,433,10,7,3,2,1
13,456,456,28,23,5,2,1
23,488,488,23,23,0,1,0
24,493,493,50,35,15,2,1
16,494,494,4,4,0,1,0
20,494,494,1,1,0,1,0

2,125,125,19,13,6,2,1
27,134,134,15,15,0,1,0
12,138,138,4,4,0,1,0
0,161,161,8,1,7,2,1
18,172,172,4,4,0,1,0
13,182,182,50,9,41,2,1
4,197,197,2,2,0,1,0
20,213,213,6,6,0,1,0
17,215,215,2,2,0,1,0
14,223,223,10,1,9,4,3
10,233,233,18,18,0,1,0
19,239,239,5,5,0,1,0
11,264,264,6,6,0,1,0
15,309,309,10,7,3,2,1
1,331,331,4,4,0,1,0
3,335,335,2,2,0,1,0
22,336,336,75,54,21,4,3
21,349,349,98,90,8,3,2
5,353,353,2,2,0,1,0
26,416,416,115,29,86,4,3
24,437,437,12,12,0,1,0
16,441,441,6,6,0,1,0
28,445,445,22,10,12,3,2
7,458,458,27,6,21,2,1
25,459,459,29,5,24,2,1
8,470,470,60,52,8,3,2
6,481,481,12,6,6,3,2
9,488,488,127,49,78,4,3
23,499,499,53,53,0,1,0

0,143,143,1,1,0,1,0
11,146,146,52,40,12,2,1
2,153,153,7,7,0,1,0
7,158,158,10,10,0,1,0
17,160,160,38,22,16,3,2
15,176,176,7,1,6,2,1
8,219,219,76,61,15,4,3
12,254,254,4,4,0,1,0
3,271,271,43,25,18,2,1
10,297,297,65,36,29,2,1
1,298,298,3,3,0,1,0
19,309,309,8,2,6,2,1
6,318,318,19,14,5,2,1
4,335,335,28,28,0,1,0
9,336,336,10,10,0,1,0
13,340,340,26,26,0,1,0
5,341,341,145,87,58,4,3
16,375,375,22,22,0,1,0
20,377,377,20,10,10,3,2
18,394,394,21,3,18,3,2
14,450,450,24,24,0,1,0

13,107,107,20,3,17,2,1
9,108,108,6,6,0,1,0
5,133,133,2,2,0,1,0
12,135,135,5,5,0,1,0
19,140,140,21,7,14,3,2
10,149,149,4,4,0,1,0
11,152,152,20,20,0,1,0
6,163,163,8,8,0,1,0
4,198,198,38,8,30,2,1
18,202,202,29,29,0,1,0
17,206,206,1,1,0,1,0
1,236,236,54,54,0,1,0
2,247,247,13,13,0,1,0
24,287,287,1,1,0,1,0
0,328,328,1,1,0,1,0
8,337,337,4,4,0,1,0
3,346,346,97,97,0,1,0
23,352,352,33,3,30,3,2
21,372,372,21,21,0,1,0
7,391,391,48,48,0,1,0
16,392,392,67,20,47,2,1
22,395,395,56,56,0,1,0
20,397,397,2,2,0,1,0
14,426,426,78,39,39,4,3
15,483,483,39,31,8,2,1

21,127,127,3,3,0,1,0
9,132,132,3,3,0,1,0
8,159,159,81,6,75,4,3
22,196,196,8,4,4,2,1
16,214,214,25,2,23,2,1
12,240,240,11,11,0,1,0
13,243,243,80,51,29,4,3
18,250,250,22,13,9,2,1
20,253,253,11,11,0,1,0
17,253,253,8,8,0,1,0
19,276,276,29,29,0,1,0
6,296,296,9,2,7,2,1
4,329,329,4,4,0,1,0
15,351,351,98,56,42,2,1
3,357,357,25,1,24,4,3
7,438,438,18,1,17,2,1
23,441,441,11,11,0,1,0
10,441,441,8,8,0,1,0
1,446,446,65,41,24,3,2
11,456,456,53,7,46,3,2
0,458,458,31,7,24,3,2
14,461,461,43,25,18,3,2
2,475,475,14,14,0,1,0
5,482,482,67,30,37,2,1

25,120,120,3,3,0,1,0
26,132,132,19,19,0,1,0
19,148,148,7,7,0,1,0
12,154,154,41,41,0,1,0
6,165,165,6,6,0,1,0
24,166,166,45,5,40,3,2
22,193,193,20,8,12,3,2
4,196,196,2,2,0,1,0
21,237,237,3,3,0,1,0
13,241,241,61,30,31,2,1
10,250,250,39,39,0,1,0
14,255,255,16,8,8,3,2
3,308,308,34,3,31,2,1
17,315,315,6,6,0,1,0
5,315,315,18,3,15,2,1
18,319,319,8,4,4,2,1
16,344,344,55,46,9,2,1
7,356,356,62,4,58,3,2
0,363,363,2,2,0,1,0
20,392,392,55,29,26,2,1
1,425,425,11,11,0,1,0
11,467,467,1,1,0,1,0
9,467,467,13,1,12,4,3
2,485,485,5,5,0,1,0
8,489,489,2,2,0,1,0
15,498,498,140,140,0,1,0
23,498,498,3,3,0,1,0

22,121,121,12,1,11,2,1
11,131,131,5,5,0,1,0
10,145,145,28,28,0,1,0
20,146,146,16,4,12,3,2
12,169,169,8,8,0,1,0
3,190,190,6,6,0,1,0
18,204,204,14,5,9,4,3
24,214,214,33,25,8,3,2
28,225,225,3,3,0,1,0
4,244,244,36,36,0,1,0
19,247,247,82,82,0,1,0
27,251,251,38,2,36,3,2
25,254,254,17,17,0,1,0
14,258,258,11,11,0,1,0
16,268,268,22,6,16,2,1
7,274,274,9,9,0,1,0
23,284,284,1,1,0,1,0
15,312,312,13,13,0,1,0
0,316,316,30,4,26,3,2
5,325,325,12,12,0,1,0
9,336,336,1,1,0,1,0
21,403,403,51,8,43,3,2
6,413,413,24,24,0,1,0
1,413,413,1,1,0,1,0
17,435,435,26,1,25,2,1
13,446,446,19,13,6,2,1
26,474,474,15,12,3,2,1
8,491,491,46,46,0,1,0
2,499,499,107,27,80,4,3

2,110,110,3,3,0,1,0
20,153,153,26,26,0,1,0
19,171,171,2,2,0,1,0
16,175,175,8,8,0,1,0
7,201,201,59,59,0,1,0
4,211,211,6,1,5,2,1
12,218,218,17,2,15,2,1
9,222,222,31,19,12,3,2
21,240,240,21,9,12,2,1
17,254,254,5,5,0,1,0
8,256,256,31,31,0,1,0
11,285,285,51,51,0,1,0
6,292,292,45,5,40,4,3
5,293,293,18,18,0,1,0
13,313,313,21,7,14,2,1
14,403,403,92,12,80,3,2
15,411,411,50,50,0,1,0
10,412,412,14,14,0,1,0
18,422,422,74,22,52,3,2
1,439,439,96,96,0,1,0
0,441,441,4,1,3,2,1
3,494,494,74,31,43,2,1

21,143,143,40,40,0,1,0
24,171,171,32,32,0,1,0
26,174,174,38,33,5,2,1
15,174,174,1,1,0,1,0
22,185,185,10,6,4,2,1
23,196,196,31,28,3,2,1
5,200,200,8,8,0,1,0
17,205,205,1,1,0,1,0
20,246,246,16,16,0,1,0
19,247,247,18,18,0,1,0
10,260,260,4,1,3,2,1
13,289,289,4,4,0,1,0
1,312,312,45,3,42,3,2
7,325,325,32,24,8,2,1
12,330,330,8,8,0,1,0
4,355,355,6,6,0,1,0
6,356,356,68,41,27,4,3
25,361,361,7,7,0,1,0
3,364,364,2,2,0,1,0
8,365,365,3,3,0,1,0
14,380,380,6,6,0,1,0
2,381,381,198,198,0,1,0
18,395,395,6,6,0,1,0
11,404,404,33,1,32,2,1
16,414,414,59,23,36,4,3
0,421,421,5,2,3,2,1
9,436,436,6,6,0,1,0

30,165,165,55,55,0,1,0
19,170,170,9,9,0,1,0
24,175,175,4,4,0,1,0
4,186,186,11,3,8,2,1
27,187,187,10,5,5,2,1
16,190,190,4,4,0,1,0
18,193,193,3,3,0,1,0
12,198,198,1,1,0,1,0
5,213,213,13,13,0,1,0
0,216,216,18,4,14,2,1
23,239,239,4,4,0,1,0
3,243,243,35,35,0,1,0
1,292,292,5,5,0,1,0
6,296,296,27,14,13,4,3
26,333,333,76,32,44,4,3
28,334,334,62,35,27,4,3
29,338,338,24,12,12,4,3
2,350,350,48,40,8,3,2
11,357,357,1,1,0,1,0
10,387,387,26,22,4,2,1
25,391,391,42,6,36,3,2
17,424,424,37,37,0,1,0
20,425,425,8,8,0,1,0
7,442,442,15,3,12,3,2
9,453,453,11,11,0,1,0
22,464,464,56,56,0,1,0
15,464,464,27,6,21,4,3
8,466,466,71,32,39,4,3
21,484,484,6,6,0,1,0
13,488,488,27,27,0,1,0
14,492,492,43,43,0,1,0

22,112,112,14,7,7,2,1
10,128,128,1,1,0,1,0
23,143,143,39,18,21,4,3
14,151,151,9,9,0,1,0
0,194,194,35,3,32,3,2
5,196,196,27,27,0,1,0
18,196,196,40,40,0,1,0
17,201,201,10,10,0,1,0
1,240,240,17,17,0,1,0
12,297,297,4,4,0,1,0
20,308,308,8,8,0,1,0
8,312,312,21,3,18,4,3
16,354,354,5,5,0,1,0
21,367,367,46,46,0,1,0
3,369,369,8,8,0,1,0
19,388,388,70,22,48,4,3
9,388,388,4,1,3,2,1
7,394,394,52,10,42,4,3
4,419,419,11,11,0,1,0
13,431,431,63,39,24,3,2
15,431,431,9,2,7,2,1
2,431,431,21,5,16,2,1
11,475,475,148,103,45,4,3
6,495,495,92,50,42,3,2

22,115,115,8,4,4,2,1
19,136,136,8,8,0,1,0
0,151,151,7,7,0,1,0
21,161,161,7,7,0,1,0
23,167,167,21,4,17,2,1
1,169,169,5,5,0,1,0
10,195,195,41,41,0,1,0
16,203,203,7,7,0,1,0
25,299,299,34,34,0,1,0
2,300,300,43,1,42,3,2
18,306,306,27,7,20,3,2
24,346,346,133,133,0,1,0
7,347,347,39,21,18,4,3
17,354,354,29,29,0,1,0
3,354,354,3,3,0,1,0
11,371,371,4,4,0,1,0
8,373,373,50,10,40,3,2
4,375,375,54,12,42,4,3
6,390,390,36,31,5,2,1
12,393,393,4,4,0,1,0
20,404,404,7,7,0,1,0
13,423,423,43,4,39,2,1
15,428,428,11,1,10,3,2
9,469,469,39,18,21,2,1
14,494,494,93,81,12,3,2
5,497,497,37,10,27,2,1

20,111,111,5,5,0,1,0
4,172,172,6,6,0,1,0
18,202,202,38,38,0,1,0
5,205,205,41,17,24,2,1
9,221,221,39,2,37,2,1
8,262,262,12,12,0,1,0
14,270,270,7,7,0,1,0
6,273,273,45,45,0,1,0
13,276,276,5,2,3,2,1
11,281,281,4,4,0,1,0
15,293,293,25,25,0,1,0
12,293,293,5,5,0,1,0
3,296,296,45,45,0,1,0
21,298,298,77,21,56,3,2
7,324,324,119,119,0,1,0
10,347,347,1,1,0,1,0
0,371,371,1,1,0,1,0
16,372,372,1,1,0,1,0
1,416,416,1,1,0,1,0
2,425,425,22,8,14,4,3
17,432,432,75,75,0,1,0
19,439,439,43,39,4,2,1
22,455,455,132,82,50,2,1

11,100,100,15,9,6,3,2
5,101,101,18,3,15,4,3
14,104,104,4,4,0,1,0
17,117,117,11,3,8,3,2
10,130,130,9,4,5,2,1
12,130,130,1,1,0,1,0
15,145,145,17,7,10,3,2
4,230,230,76,76,0,1,0
2,265,265,1,1,0,1,0
18,323,323,11,3,8,2,1
3,324,324,47,28,19,2,1
19,333,333,45,34,11,2,1
21,339,339,4,4,0,1,0
16,341,341,24,24,0,1,0
24,343,343,35,25,10,3,2
20,389,389,14,11,3,2,1
25,395,395,106,85,21,2,1
9,412,412,1,1,0,1,0
7,412,412,19,16,3,2,1
1,427,427,5,5,0,1,0
8,432,432,51,51,0,1,0
22,474,474,79,38,41,2,1
0,476,476,11,11,0,1,0
6,480,480,23,5,18,4,3
13,493,493,33,2,31,4,3
23,493,493,79,71,8,2,1

0,119,119,25,25,0,1,0
19,134,134,53,53,0,1,0
18,144,144,12,12,0,1,0
2,150,150,3,3,0,1,0
22,151,151,10,6,4,2,1
14,185,185,14,14,0,1,0
20,185,185,6,3,3,2,1
7,186,186,13,4,9,4,3
17,215,215,23,8,15,4,3
10,241,241,2,2,0,1,0
3,250,250,12,12,0,1,0
9,266,266,9,9,0,1,0
26,267,267,11,11,0,1,0
8,303,303,9,2,7,2,1
23,334,334,3,3,0,1,0
24,341,341,7,7,0,1,0
13,344,344,59,59,0,1,0
16,356,356,42,27,15,4,3
1,358,358,26,2,24,4,3
6,363,363,23,23,0,1,0
4,394,394,38,28,10,3,2
5,398,398,35,6,29,2,1
25,408,408,90,90,0,1,0
21,420,420,4,4,0,1,0
15,427,427,51,51,0,1,0
12,428,428,11,11,0,1,0
11,465,465,87,34,53,4,3

6,110,110,1,1,0,1,0
16,125,125,6,6,0,1,0
2,141,141,2,2,0,1,0
0,155,155,76,69,7,2,1
8,188,188,20,12,8,2,1
3,189,189,4,4,0,1,0
5,221,221,9,4,5,2,1
13,289,289,25,1,24,4,3
10,290,290,5,5,0,1,0
15,321,321,132,111,21,4,3
4,329,329,209,205,4,2,1
11,348,348,46,31,15,4,3
7,351,351,51,51,0,1,0
1,354,354,1,1,0,1,0
17,386,386,21,16,5,2,1
12,411,411,52,41,11,2,1
9,427,427,18,18,0,1,0
14,464,464,17,17,0,1,0

15,109,109,14,1,13,3,2
3,114,114,4,4,0,1,0
12,116,116,23,23,0,1,0
1,128,128,1,1,0,1,0
13,130,130,4,4,0,1,0
21,138,138,11,1,10,3,2
23,156,156,27,27,0,1,0
18,177,177,9,9,0,1,0
4,219,219,45,45,0,1,0
7,234,234,9,9,0,1,0
24,263,263,53,53,0,1,0
5,287,287,4,4,0,1,0
6,287,287,28,16,12,4,3
19,288,288,56,56,0,1,0
2,289,289,25,25,0,1,0
9,293,293,43,21,22,3,2
14,298,298,11,2,9,2,1
16,353,353,80,38,42,4,3
17,357,357,17,4,13,2,1
22,365,365,17,17,0,1,0
20,367,367,4,4,0,1,0
8,378,378,65,5,60,3,2
11,441,441,14,5,9,2,1
0,459,459,30,30,0,1,0
10,466,466,49,45,4,2,1

6,101,101,1,1,0,1,0
10,157,157,37,6,31,2,1
2,159,159,6,6,0,1,0
22,161,161,8,8,0,1,0
0,191,191,27,3,24,4,3
14,211,211,65,25,40,2,1
17,230,230,8,8,0,1,0
15,230,230,7,7,0,1,0
7,239,239,10,2,8,3,2
18,252,252,23,23,0,1,0
21,283,283,36,11,25,2,1
5,294,294,21,21,0,1,0
20,302,302,37,37,0,1,0
4,309,309,29,13,16,3,2
19,315,315,13,8,5,2,1
9,336,336,38,8,30,3,2
11,340,340,7,7,0,1,0
3,357,357,53,39,14,3,2
16,400,400,90,61,29,3,2
13,458,458,56,4,52,3,2
8,472,472,22,6,16,2,1
12,473,473,24,24,0,1,0
1,498,498,130,16,114,4,3

12,101,101,2,2,0,1,0
6,114,114,3,3,0,1,0
20,114,114,34,34,0,1,0
2,151,151,5,1,4,2,1
8,222,222,13,13,0,1,0
19,241,241,37,37,0,1,0
1,246,246,37,23,14,2,1
24,253,253,28,28,0,1,0
10,255,255,16,16,0,1,0
4,260,260,3,3,0,1,0
18,284,284,14,14,0,1,0
0,291,291,47,47,0,1,0
9,297,297,35,15,20,2,1
14,305,305,48,19,29,2,1
15,321,321,12,12,0,1,0
22,323,323,20,5,15,4,3
21,351,351,2,2,0,1,0
16,383,383,86,28,58,3,2
3,393,393,8,8,0,1,0
11,396,396,67,37,30,3,2
7,402,402,26,6,20,2,1
13,403,403,5,5,0,1,0
23,473,473,22,22,0,1,0
5,480,480,146,50,96,4,3
17,481,481,32,32,0,1,0

20,129,129,6,6,0,1,0
16,149,149,26,12,14,2,1
14,155,155,18,18,0,1,0
7,163,163,2,2,0,1,0
17,175,175,44,35,9,4,3
22,175,175,5,1,4,2,1
9,176,176,1,1,0,1,0
26,183,183,25,11,14,2,1
27,240,240,18,18,0,1,0
28,247,247,5,5,0,1,0
1,250,250,2,2,0,1,0
25,255,255,35,1,34,2,1
23,255,255,11,11,0,1,0
12,274,274,16,16,0,1,0
29,293,293,14,14,0,1,0
0,298,298,11,1,10,3,2
5,321,321,39,39,0,1,0
24,338,338,38,14,24,3,2
3,343,343,11,11,0,1,0
2,356,356,55,55,0,1,0
4,358,358,4,1,3,2,1
11,380,380,1,1,0,1,0
19,386,386,19,5,14,2,1
6,386,386,27,27,0,1,0
18,400,400,58,58,0,1,0
10,417,417,2,2,0,1,0
13,428,428,27,15,12,2,1
8,445,445,35,35,0,1,0
15,490,490,1,1,0,1,0
21,495,495,195,113,82,3,2

13,123,123,10,1,9,4,3
1,131,131,10,10,0,1,0
16,135,135,9,9,0,1,0
14,137,137,9,2,7,2,1
18,159,159,19,19,0,1,0
10,166,166,37,37,0,1,0
20,216,216,15,15,0,1,0
11,241,241,8,2,6,3,2
17,243,243,27,21,6,3,2
19,254,254,24,24,0,1,0
15,263,263,21,11,10,3,2
7,270,270,19,19,0,1,0
0,279,279,22,22,0,1,0
9,298,298,38,38,0,1,0
21,309,309,80,32,48,4,3
8,365,365,47,47,0,1,0
5,375,375,8,5,3,2,1
4,381,381,31,31,0,1,0
2,383,383,76,76,0,1,0
3,387,387,9,9,0,1,0
6,421,421,166,166,0,1,0
12,440,440,15,15,0,1,0

20,125,125,17,11,6,2,1
9,144,144,5,5,0,1,0
6,156,156,21,4,17,2,1
10,156,156,2,2,0,1,0
17,176,176,2,2,0,1,0
23,217,217,40,13,27,2,1
13,223,223,9,2,7,2,1
5,233,233,25,25,0,1,0
2,240,240,24,24,0,1,0
1,249,249,41,41,0,1,0
16,251,251,27,27,0,1,0
15,266,266,69,32,37,2,1
7,268,268,24,4,20,3,2
22,308,308,26,18,8,2,1
3,314,314,28,3,25,2,1
21,335,335,25,25,0,1,0
12,382,382,22,1,21,2,1
0,387,387,52,15,37,3,2
11,422,422,80,21,59,4,3
8,453,453,5,2,3,2,1
19,456,456,70,20,50,2,1
14,464,464,43,43,0,1,0
4,493,493,66,66,0,1,0
18,498,498,13,2,11,2,1

16,111,111,9,9,0,1,0
15,119,119,25,25,0,1,0
5,121,121,10,10,0,1,0
1,130,130,38,12,26,3,2
13,161,161,21,10,11,3,2
17,166,166,13,13,0,1,0
11,178,178,22,22,0,1,0
2,188,188,10,1,9,2,1
10,190,190,6,6,0,1,0
18,205,205,5,2,3,2,1
21,280,280,12,12,0,1,0
6,324,324,7,7,0,1,0
20,334,334,1,1,0,1,0
12,341,341,85,85,0,1,0
19,342,342,62,41,21,2,1
3,351,351,4,4,0,1,0
0,392,392,77,77,0,1,0
7,454,454,2,2,0,1,0
4,458,458,13,5,8,2,1
9,465,465,176,144,32,3,2
14,469,469,36,2,34,2,1
8,490,490,65,65,0,1,0

2,100,100,50,50,0,1,0
12,105,105,1,1,0,1,0
16,110,110,3,3,0,1,0
4,131,131,4,1,3,2,1
3,146,146,6,6,0,1,0
8,168,168,40,10,30,4,3
18,181,181,15,15,0,1,0
17,181,181,10,4,6,3,2
20,213,213,15,15,0,1,0
23,217,217,5,5,0,1,0
13,233,233,58,13,45,2,1
1,261,261,6,6,0,1,0
5,284,284,15,15,0,1,0
0,286,286,2,2,0,1,0
19,316,316,101,53,48,3,2
10,321,321,13,3,10,3,2
14,375,375,4,4,0,1,0
15,392,392,34,34,0,1,0
9,414,414,55,28,27,3,2
6,427,427,32,4,28,3,2
22,432,432,30,30,0,1,0
7,485,485,16,6,10,2,1
11,487,487,13,2,11,2,1
21,494,494,105,9,96,3,2

6,135,135,8,8,0,1,0
13,207,207,3,3,0,1,0
23,228,228,20,20,0,1,0
14,240,240,37,37,0,1,0
9,249,249,1,1,0,1,0
25,258,258,25,25,0,1,0
20,302,302,6,6,0,1,0
10,309,309,20,20,0,1,0
17,327,327,19,4,15,2,1
1,334,334,14,14,0,1,0
11,344,344,67,34,33,4,3
21,349,349,12,12,0,1,0
16,359,359,111,111,0,1,0
0,364,364,18,18,0,1,0
5,364,364,94,4,90,3,2
26,374,374,108,21,87,4,3
19,375,375,49,15,34,3,2
12,381,381,2,2,0,1,0
15,388,388,5,5,0,1,0
8,414,414,40,40,0,1,0
22,429,429,10,10,0,1,0
24,436,436,62,32,30,4,3
18,442,442,9,5,4,2,1
3,458,458,1,1,0,1,0
4,469,469,69,52,17,2,1
7,472,472,51,51,0,1,0
2,476,476,1,1,0,1,0

17,100,100,4,1,3,2,1
5,194,194,23,23,0,1,0
12,201,201,19,4,15,4,3
8,205,205,27,11,16,2,1
18,207,207,5,5,0,1,0
6,224,224,11,11,0,1,0
19,231,231,5,5,0,1,0
13,246,246,12,6,6,2,1
3,248,248,30,30,0,1,0
16,257,257,70,10,60,3,2
14,278,278,36,36,0,1,0
2,284,284,54,54,0,1,0
0,291,291,1,1,0,1,0
15,321,321,9,3,6,3,2
4,338,338,161,65,96,4,3
10,353,353,20,20,0,1,0
1,403,403,3,3,0,1,0
9,440,440,144,110,34,2,1
11,440,440,22,7,15,2,1
7,460,460,108,108,0,1,0

4,103,103,10,10,0,1,0
19,130,130,25,25,0,1,0
24,134,134,6,6,0,1,0
11,145,145,16,16,0,1,0
21,150,150,4,4,0,1,0
16,166,166,52,52,0,1,0
3,172,172,7,7,0,1,0
27,173,173,2,2,0,1,0
14,235,235,12,12,0,1,0
1,250,250,6,6,0,1,0
8,251,251,5,5,0,1,0
7,258,258,41,41,0,1,0
12,260,260,17,13,4,2,1
17,273,273,16,4,12,4,3
15,280,280,3,3,0,1,0
20,291,291,74,74,0,1,0
26,303,303,117,9,108,4,3
28,322,322,2,2,0,1,0
23,327,327,21,10,11,2,1
2,328,328,28,28,0,1,0
5,338,338,7,7,0,1,0
10,348,348,4,1,3,2,1
22,366,366,3,3,0,1,0
25,381,381,49,21,28,2,1
13,404,404,3,3,0,1,0
9,436,436,2,2,0,1,0
0,439,439,23,2,21,2,1
18,453,453,22,22,0,1,0
6,481,481,63,63,0,1,0

9,105,105,1,1,0,1,0
20,105,105,3,3,0,1,0
23,134,134,20,8,12,3,2
11,147,147,14,14,0,1,0
21,153,153,10,10,0,1,0
17,162,162,26,18,8,2,1
0,183,183,3,3,0,1,0
13,255,255,5,5,0,1,0
14,290,290,14,2,12,2,1
10,292,292,41,41,0,1,0
16,309,309,36,10,26,3,2
22,330,330,60,52,8,2,1
4,338,338,1,1,0,1,0
8,352,352,27,27,0,1,0
18,358,358,14,14,0,1,0
2,375,375,65,20,45,4,3
25,379,379,98,98,0,1,0
19,380,380,31,31,0,1,0
7,397,397,67,67,0,1,0
12,399,399,124,124,0,1,0
3,415,415,13,10,3,2,1
15,437,437,12,5,7,2,1
24,442,442,31,31,0,1,0
6,471,471,8,8,0,1,0
5,492,492,2,2,0,1,0
1,498,498,68,18,50,3,2

9,101,101,6,2,4,2,1
16,107,107,5,5,0,1,0
14,118,118,3,3,0,1,0
20,209,209,10,5,5,2,1
2,225,225,7,7,0,1,0
7,237,237,102,47,55,3,2
10,248,248,3,3,0,1,0
4,251,251,22,12,10,3,2
8,258,258,6,2,4,2,1
1,264,264,41,17,24,4,3
6,269,269,11,11,0,1,0
13,281,281,84,84,0,1,0
3,299,299,27,13,14,4,3
11,307,307,36,36,0,1,0
19,333,333,14,14,0,1,0
5,337,337,11,11,0,1,0
15,387,387,155,127,28,3,2
12,393,393,41,41,0,1,0
0,405,405,125,125,0,1,0
17,453,453,22,3,19,2,1
18,455,455,7,7,0,1,0

17,108,108,8,3,5,2,1
3,114,114,18,11,7,2,1
7,126,126,45,3,42,2,1
26,155,155,14,14,0,1,0
5,169,169,2,2,0,1,0
14,201,201,9,2,7,2,1
0,213,213,2,2,0,1,0
16,218,218,13,13,0,1,0
12,220,220,2,2,0,1,0
10,248,248,6,3,3,2,1
2,267,267,20,20,0,1,0
19,277,277,8,8,0,1,0
15,283,283,57,51,6,3,2
8,284,284,41,41,0,1,0
18,307,307,1,1,0,1,0
22,317,317,91,9,82,3,2
6,320,320,31,3,28,3,2
21,329,329,27,27,0,1,0
24,345,345,3,3,0,1,0
4,358,358,8,8,0,1,0
11,362,362,16,6,10,3,2
23,377,377,82,82,0,1,0
25,379,379,12,12,0,1,0
9,430,430,63,8,55,4,3
1,454,454,24,15,9,4,3
13,488,488,4,1,3,2,1
20,489,489,69,69,0,1,0

18,124,124,32,12,20,3,2
23,149,149,6,6,0,1,0
9,173,173,16,9,7,2,1
5,175,175,11,1,10,3,2
7,180,180,1,1,0,1,0
2,188,188,13,2,11,2,1
17,201,201,1,1,0,1,0
24,210,210,1,1,0,1,0
4,221,221,13,7,6,2,1
1,235,235,1,1,0,1,0
15,263,263,45,15,30,3,2
22,266,266,7,2,5,2,1
16,272,272,58,58,0,1,0
12,277,277,24,12,12,4,3
13,285,285,45,1,44,3,2
8,314,314,20,16,4,2,1
6,328,328,83,45,38,4,3
20,384,384,43,43,0,1,0
21,391,391,39,39,0,1,0
11,394,394,7,7,0,1,0
19,396,396,20,2,18,2,1
0,399,399,56,20,36,2,1
10,414,414,100,32,68,4,3
3,429,429,45,45,0,1,0
14,430,430,40,40,0,1,0

15,119,119,6,6,0,1,0
18,126,126,14,2,12,4,3
6,176,176,48,48,0,1,0
16,178,178,11,4,7,2,1
8,185,185,58,58,0,1,0
4,252,252,17,5,12,4,3
1,278,278,46,46,0,1,0
17,280,280,4,4,0,1,0
14,307,307,37,37,0,1,0
10,337,337,21,5,16,3,2
3,351,351,50,50,0,1,0
0,357,357,40,40,0,1,0
12,363,363,20,20,0,1,0
19,363,363,40,3,37,2,1
11,365,365,53,53,0,1,0
13,390,390,49,49,0,1,0
2,396,396,1,1,0,1,0
9,421,421,23,11,12,2,1
5,443,443,57,57,0,1,0
7,484,484,150,104,46,4,3

5,100,100,27,1,26,2,1
6,113,113,3,3,0,1,0
17,133,133,3,3,0,1,0
16,154,154,17,17,0,1,0
10,180,180,7,7,0,1,0
14,216,216,37,37,0,1,0
9,246,246,24,4,20,3,2
0,250,250,17,2,15,2,1
1,263,263,71,7,64,3,2
8,302,302,71,23,48,2,1
7,310,310,12,8,4,2,1
12,328,328,22,9,13,3,2
11,345,345,22,22,0,1,0
18,382,382,13,13,0,1,0
3,395,395,37,37,0,1,0
4,403,403,139,76,63,4,3
2,410,410,37,37,0,1,0
15,412,412,39,31,8,2,1
13,441,441,98,8,90,4,3
19,498,498,33,33,0,1,0

4,100,100,11,11,0,1,0
13,111,111,2,2,0,1,0
26,141,141,6,3,3,2,1
12,144,144,17,17,0,1,0
2,157,157,1,1,0,1,0
3,174,174,8,8,0,1,0
24,189,189,16,8,8,3,2
16,193,193,17,17,0,1,0
9,214,214,11,5,6,2,1
25,239,239,80,80,0,1,0
11,244,244,68,38,30,4,3
14,246,246,3,3,0,1,0
7,269,269,2,2,0,1,0
21,297,297,35,35,0,1,0
22,299,299,30,30,0,1,0
5,310,310,46,46,0,1,0
15,350,350,26,1,25,2,1
8,354,354,15,15,0,1,0
18,356,356,11,4,7,2,1
10,358,358,5,5,0,1,0
23,373,373,102,102,0,1,0
6,397,397,32,11,21,4,3
19,415,415,11,11,0,1,0
1,425,425,4,1,3,2,1
0,431,431,112,43,69,4,3
20,474,474,19,19,0,1,0
17,500,500,4,4,0,1,0

13,106,106,20,20,0,1,0
25,117,117,6,6,0,1,0
22,129,129,16,16,0,1,0
5,139,139,3,3,0,1,0
23,140,140,1,1,0,1,0
6,142,142,11,11,0,1,0
1,152,152,1,1,0,1,0
14,176,176,1,1,0,1,0
20,194,194,10,1,9,2,1
28,211,211,14,14,0,1,0
16,237,237,7,1,6,3,2
2,276,276,1,1,0,1,0
3,278,278,58,52,6,2,1
21,286,286,30,30,0,1,0
29,300,300,56,40,16,3,2
10,314,314,5,5,0,1,0
11,321,321,22,5,17,2,1
15,334,334,49,49,0,1,0
4,360,360,7,7,0,1,0
27,384,384,96,96,0,1,0
9,397,397,26,26,0,1,0
24,398,398,61,61,0,1,0
0,409,409,34,9,25,4,3
7,429,429,53,53,0,1,0
19,431,431,3,3,0,1,0
8,432,432,3,3,0,1,0
12,447,447,7,4,3,2,1
18,475,475,13,13,0,1,0
17,479,479,55,55,0,1,0
26,482,482,96,96,0,1,0

11,111,111,1,1,0,1,0
8,128,128,7,7,0,1,0
5,135,135,41,9,32,3,2
9,149,149,16,16,0,1,0
22,151,151,12,3,9,2,1
18,171,171,27,7,20,2,1
12,173,173,30,22,8,2,1
17,190,190,22,19,3,2,1
24,212,212,5,5,0,1,0
3,249,249,7,4,3,2,1
1,250,250,1,1,0,1,0
14,277,277,4,4,0,1,0
25,298,298,71,71,0,1,0
4,313,313,19,10,9,4,3
13,338,338,10,10,0,1,0
23,340,340,57,21,36,3,2
15,352,352,16,16,0,1,0
16,370,370,30,10,20,3,2
19,372,372,51,48,3,2,1
7,393,393,21,10,11,2,1
26,432,432,25,25,0,1,0
0,447,447,19,12,7,3,2
10,450,450,8,8,0,1,0
20,471,471,32,12,20,3,2
21,475,475,25,25,0,1,0
2,478,478,1,1,0,1,0
6,481,481,145,132,13,2,1

2,114,114,13,1,12,3,2
28,142,142,12,12,0,1,0
6,153,153,4,4,0,1,0
23,181,181,11,11,0,1,0
25,184,184,5,5,0,1,0
4,191,191,4,4,0,1,0
0,196,196,17,17,0,1,0
13,208,208,16,16,0,1,0
1,228,228,17,5,12,4,3
18,242,242,43,43,0,1,0
10,251,251,41,6,35,3,2
3,256,256,6,6,0,1,0
27,282,282,40,21,19,2,1
19,286,286,17,14,3,2,1
11,290,290,31,31,0,1,0
9,326,326,92,69,23,4,3
15,350,350,5,5,0,1,0
12,351,351,5,5,0,1,0
17,362,362,47,47,0,1,0
16,397,397,28,19,9,2,1
22,415,415,45,45,0,1,0
14,418,418,17,17,0,1,0
8,431,431,3,3,0,1,0
5,445,445,3,3,0,1,0
7,453,453,33,33,0,1,0
21,458,458,30,30,0,1,0
26,473,473,10,1,9,4,3
24,484,484,148,100,48,2,1
20,500,500,24,1,23,4,3

22,106,106,4,4,0,1,0
5,108,108,3,3,0,1,0
6,108,108,8,8,0,1,0
17,113,113,9,5,4,2,1
1,118,118,1,1,0,1,0
27,130,130,6,3,3,2,1
21,130,130,5,5,0,1,0
26,142,142,10,6,4,2,1
7,164,164,1,1,0,1,0
15,173,173,15,15,0,1,0
28,196,196,22,22,0,1,0
23,201,201,22,22,0,1,0
8,223,223,9,3,6,3,2
24,246,246,34,34,0,1,0
2,251,251,6,6,0,1,0
18,259,259,41,4,37,2,1
10,267,267,10,4,6,2,1
0,274,274,22,18,4,2,1
12,310,310,22,10,12,3,2
13,327,327,50,47,3,2,1
9,341,341,20,16,4,2,1
3,341,341,19,7,12,2,1
20,356,356,12,12,0,1,0
19,376,376,82,44,38,2,1
16,388,388,12,3,9,4,3
11,399,399,60,4,56,3,2
14,426,426,94,94,0,1,0
25,433,433,86,38,48,2,1
4,490,490,37,23,14,3,2

15,132,132,16,11,5,2,1
1,153,153,43,43,0,1,0
12,170,170,19,15,4,2,1
8,172,172,1,1,0,1,0
7,197,197,53,32,21,4,3
4,230,230,1,1,0,1,0
13,284,284,44,44,0,1,0
9,287,287,1,1,0,1,0
10,318,318,9,9,0,1,0
5,343,343,45,45,0,1,0
11,370,370,70,70,0,1,0
14,430,430,9,4,5,2,1
17,431,431,111,53,58,3,2
16,433,433,25,25,0,1,0
18,437,437,13,4,9,2,1
6,460,460,18,18,0,1,0
3,483,483,122,122,0,1,0
0,484,484,91,13,78,4,3
2,492,492,19,2,17,2,1
19,495,495,123,123,0,1,0

14,103,103,1,1,0,1,0
7,157,157,71,71,0,1,0
23,207,207,1,1,0,1,0
15,213,213,6,2,4,2,1
1,219,219,10,10,0,1,0
2,235,235,6,1,5,2,1
12,238,238,15,15,0,1,0
22,240,240,36,8,28,2,1
11,258,258,29,7,22,4,3
17,259,259,15,3,12,3,2
20,282,282,79,11,68,3,2
5,297,297,21,1,20,2,1
13,317,317,86,86,0,1,0
6,329,329,9,9,0,1,0
4,338,338,3,3,0,1,0
18,341,341,100,40,60,3,2
8,347,347,11,11,0,1,0
16,407,407,2,2,0,1,0
19,426,426,21,7,14,2,1
0,430,430,87,51,36,4,3
21,462,462,8,1,7,2,1
10,463,463,12,12,0,1,0
3,482,482,69,69,0,1,0
9,498,498,27,27,0,1,0

13,101,101,29,29,0,1,0
15,111,111,5,5,0,1,0
16,120,120,13,5,8,3,2
1,125,125,3,3,0,1,0
11,152,152,25,25,0,1,0
2,155,155,8,8,0,1,0
14,156,156,11,3,8,2,1
18,166,166,11,11,0,1,0
3,175,175,4,4,0,1,0
5,180,180,65,57,8,2,1
20,245,245,1,1,0,1,0
6,272,272,1,1,0,1,0
9,276,276,48,16,32,3,2
0,276,276,108,6,102,4,3
4,277,277,21,6,15,4,3
7,298,298,1,1,0,1,0
19,380,380,20,13,7,2,1
10,399,399,25,9,16,2,1
12,402,402,5,5,0,1,0
8,407,407,109,82,27,4,3
17,441,441,78,37,41,2,1

5,108,108,5,5,0,1,0
19,111,111,6,1,5,2,1
3,142,142,5,5,0,1,0
21,144,144,28,28,0,1,0
6,181,181,45,1,44,2,1
12,197,197,14,4,10,2,1
22,210,210,69,69,0,1,0
4,233,233,84,84,0,1,0
13,262,262,7,7,0,1,0
11,271,271,35,35,0,1,0
18,291,291,30,3,27,2,1
0,295,295,74,69,5,2,1
14,297,297,14,5,9,2,1
8,319,319,5,5,0,1,0
7,360,360,51,51,0,1,0
9,381,381,12,12,0,1,0
15,385,385,36,8,28,2,1
16,396,396,15,15,0,1,0
2,399,399,19,19,0,1,0
10,402,402,1,1,0,1,0
1,422,422,9,9,0,1,0
17,424,424,55,3,52,3,2
20,443,443,1,1,0,1,0

0,116,116,9,4,5,2,1
14,139,139,7,7,0,1,0
1,157,157,1,1,0,1,0
7,176,176,39,39,0,1,0
17,196,196,31,31,0,1,0
22,202,202,16,16,0,1,0
11,204,204,1,1,0,1,0
10,211,211,6,6,0,1,0
5,219,219,11,11,0,1,0
23,243,243,4,4,0,1,0
2,290,290,57,8,49,4,3
6,296,296,3,3,0,1,0
12,315,315,19,19,0,1,0
13,324,324,21,7,14,2,1
19,342,342,14,14,0,1,0
20,368,368,23,23,0,1,0
4,381,381,20,20,0,1,0
16,385,385,75,31,44,3,2
25,392,392,173,141,32,3,2
3,401,401,90,42,48,4,3
18,405,405,8,8,0,1,0
24,409,409,5,5,0,1,0
21,423,423,43,25,18,3,2
9,425,425,54,54,0,1,0
15,453,453,21,21,0,1,0
8,464,464,35,19,16,2,1

0,111,111,1,1,0,1,0
19,148,148,26,26,0,1,0
5,155,155,3,3,0,1,0
23,157,157,9,6,3,2,1
14,173,173,11,11,0,1,0
16,178,178,8,3,5,2,1
20,182,182,31,8,23,2,1
21,194,194,12,12,0,1,0
2,242,242,1,1,0,1,0
1,265,265,94,58,36,2,1
12,298,298,12,9,3,2,1
22,307,307,8,8,0,1,0
13,314,314,11,3,8,3,2
15,315,315,30,4,26,2,1
7,316,316,1,1,0,1,0
4,321,321,81,81,0,1,0
9,403,403,1,1,0,1,0
8,417,417,69,69,0,1,0
18,417,417,96,86,10,2,1
11,452,452,31,31,0,1,0
6,460,460,9,9,0,1,0
17,463,463,106,89,17,2,1
10,488,488,81,9,72,3,2
3,494,494,67,25,42,4,3

11,122,122,3,3,0,1,0
0,127,127,8,8,0,1,0
10,135,135,5,5,0,1,0
2,144,144,34,2,32,3,2
20,151,151,5,5,0,1,0
17,173,173,10,4,6,2,1
19,212,212,16,16,0,1,0
12,232,232,64,64,0,1,0
5,246,246,1,1,0,1,0
7,247,247,1,1,0,1,0
15,270,270,6,6,0,1,0
3,282,282,19,19,0,1,0
9,291,291,30,30,0,1,0
16,300,300,87,33,54,4,3
6,367,367,165,128,37,2,1
21,376,376,54,4,50,2,1
18,381,381,72,72,0,1,0
14,429,429,1,1,0,1,0
13,459,459,36,36,0,1,0
1,469,469,31,31,0,1,0
8,489,489,56,56,0,1,0
4,499,499,47,47,0,1,0

9,119,119,8,8,0,1,0
24,150,150,8,2,6,3,2
0,161,161,63,27,36,3,2
18,176,176,41,20,21,2,1
14,195,195,7,7,0,1,0
20,223,223,28,28,0,1,0
4,232,232,11,3,8,3,2
16,232,232,50,50,0,1,0
7,236,236,7,1,6,3,2
8,238,238,10,10,0,1,0
17,251,251,13,13,0,1,0
15,278,278,5,5,0,1,0
19,278,278,59,20,39,2,1
25,287,287,2,2,0,1,0
3,301,301,18,18,0,1,0
23,312,312,32,32,0,1,0
5,330,330,10,10,0,1,0
22,334,334,11,2,9,2,1
10,339,339,38,22,16,4,3
11,381,381,21,11,10,3,2
26,387,387,34,22,12,3,2
13,391,391,16,16,0,1,0
6,405,405,41,35,6,3,2
1,412,412,36,6,30,4,3
21,426,426,35,35,0,1,0
2,454,454,31,6,25,2,1
12,458,458,16,16,0,1,0

11,118,118,12,2,10,2,1
27,142,142,35,9,26,2,1
12,151,151,9,9,0,1,0
1,152,152,13,13,0,1,0
4,158,158,11,1,10,2,1
13,175,175,1,1,0,1,0
17,208,208,20,20,0,1,0
2,226,226,7,7,0,1,0
16,233,233,10,10,0,1,0
22,237,237,30,2,28,2,1
5,248,248,3,3,0,1,0
3,257,257,10,10,0,1,0
15,268,268,7,1,6,3,2
25,289,289,35,35,0,1,0
19,291,291,17,17,0,1,0
21,293,293,76,22,54,3,2
7,296,296,27,27,0,1,0
9,301,301,32,3,29,4,3
28,313,313,64,40,24,3,2
14,390,390,13,13,0,1,0
18,411,411,3,3,0,1,0
10,418,418,27,10,17,2,1
20,424,424,2,2,0,1,0
29,426,426,13,13,0,1,0
0,451,451,11,11,0,1,0
6,461,461,18,6,12,3,2
24,463,463,7,7,0,1,0
26,483,483,6,6,0,1,0
23,484,484,62,34,28,3,2
8,497,497,137,137,0,1,0

6,102,102,1,1,0,1,0
18,104,104,3,3,0,1,0
9,105,105,18,18,0,1,0
2,108,108,7,7,0,1,0
23,127,127,16,16,0,1,0
16,136,136,1,1,0,1,0
12,144,144,4,4,0,1,0
10,177,177,2,2,0,1,0
8,182,182,22,22,0,1,0
22,218,218,80,80,0,1,0
5,232,232,39,1,38,2,1
0,244,244,40,17,23,2,1
20,304,304,88,88,0,1,0
1,316,316,41,19,22,3,2
4,327,327,38,38,0,1,0
13,371,371,35,8,27,4,3
19,379,379,2,2,0,1,0
3,415,415,81,14,67,4,3
14,433,433,47,47,0,1,0
11,445,445,2,2,0,1,0
15,451,451,32,3,29,2,1
7,457,457,21,21,0,1,0
17,459,459,8,8,0,1,0
21,498,498,35,19,16,2,1

18,133,133,2,2,0,1,0
21,138,138,1,1,0,1,0
9,154,154,41,17,24,4,3
8,166,166,11,11,0,1,0
3,173,173,1,1,0,1,0
26,212,212,24,9,15,2,1
16,227,227,5,5,0,1,0
5,231,231,1,1,0,1,0
23,238,238,28,22,6,3,2
10,242,242,23,9,14,3,2
19,262,262,63,45,18,3,2
20,275,275,16,16,0,1,0
24,307,307,68,29,39,2,1
15,329,329,62,62,0,1,0
2,352,352,8,8,0,1,0
6,372,372,13,6,7,2,1
4,430,430,3,3,0,1,0
12,431,431,59,59,0,1,0
14,444,444,97,97,0,1,0
17,448,448,19,3,16,3,2
7,453,453,17,4,13,4,3
25,454,454,21,9,12,4,3
13,461,461,7,1,6,2,1
0,481,481,96,96,0,1,0
22,485,485,74,58,16,3,2
1,486,486,4,4,0,1,0
11,488,488,40,40,0,1,0

1,105,105,4,1,3,2,1
25,116,116,10,10,0,1,0
23,137,137,54,54,0,1,0
11,174,174,33,33,0,1,0
24,187,187,11,11,0,1,0
5,205,205,10,1,9,4,3
15,216,216,13,13,0,1,0
7,216,216,24,15,9,2,1
8,232,232,40,16,24,3,2
9,248,248,1,1,0,1,0
17,314,314,37,37,0,1,0
4,351,351,40,12,28,2,1
13,371,371,12,5,7,2,1
18,378,378,1,1,0,1,0
6,393,393,18,18,0,1,0
2,399,399,16,16,0,1,0
14,411,411,101,73,28,3,2
10,417,417,66,66,0,1,0
21,418,418,4,4,0,1,0
22,437,437,17,1,16,2,1
12,448,448,69,69,0,1,0
16,465,465,36,6,30,2,1
19,477,477,31,31,0,1,0
3,479,479,12,12,0,1,0
20,487,487,32,12,20,2,1
0,499,499,34,30,4,2,1

0,117,117,7,7,0,1,0
16,121,121,6,3,3,2,1
14,122,122,1,1,0,1,0
21,131,131,2,2,0,1,0
29,132,132,14,14,0,1,0
20,154,154,16,16,0,1,0
22,175,175,26,26,0,1,0
26,217,217,6,6,0,1,0
11,222,222,19,1,18,4,3
13,227,227,18,1,17,4,3
24,252,252,18,18,0,1,0
27,263,263,28,13,15,4,3
7,266,266,31,5,26,3,2
23,285,285,35,4,31,2,1
9,292,292,36,30,6,2,1
6,292,292,44,37,7,2,1
28,304,304,44,23,21,4,3
15,308,308,39,31,8,2,1
3,313,313,6,6,0,1,0
8,324,324,33,33,0,1,0
17,330,330,8,8,0,1,0
1,338,338,14,14,0,1,0
12,354,354,5,2,3,2,1
4,370,370,34,4,30,3,2
2,391,391,26,26,0,1,0
19,392,392,32,25,7,2,1
18,396,396,65,55,10,3,2
25,439,439,55,55,0,1,0
10,455,455,12,12,0,1,0
5,461,461,7,7,0,1,0

17,135,135,13,7,6,3,2
10,153,153,34,8,26,3,2
12,154,154,21,21,0,1,0
0,157,157,3,3,0,1,0
22,164,164,17,17,0,1,0
13,169,169,4,4,0,1,0
4,186,186,5,5,0,1,0
21,192,192,5,5,0,1,0
16,201,201,14,1,13,2,1
15,235,235,3,3,0,1,0
20,243,243,8,8,0,1,0
7,248,248,19,19,0,1,0
6,248,248,14,14,0,1,0
8,272,272,36,11,25,2,1
5,293,293,2,2,0,1,0
14,308,308,35,35,0,1,0
11,321,321,63,21,42,2,1
23,336,336,49,49,0,1,0
18,339,339,19,15,4,2,1
9,375,375,11,11,0,1,0
2,393,393,54,15,39,2,1
19,424,424,171,163,8,3,2
1,427,427,123,55,68,3,2
3,479,479,5,5,0,1,0

22,101,101,16,16,0,1,0
1,110,110,4,4,0,1,0
23,146,146,4,4,0,1,0
17,148,148,13,13,0,1,0
18,149,149,3,3,0,1,0
9,158,158,20,8,12,3,2
25,164,164,40,13,27,2,1
15,188,188,2,2,0,1,0
8,224,224,27,27,0,1,0
19,224,224,28,28,0,1,0
24,239,239,10,7,3,2,1
10,267,267,15,15,0,1,0
16,267,267,3,3,0,1,0
4,268,268,1,1,0,1,0
28,275,275,58,58,0,1,0
27,327,327,47,47,0,1,0
14,360,360,20,10,10,2,1
2,366,366,64,9,55,4,3
20,369,369,11,11,0,1,0
3,371,371,15,11,4,2,1
6,390,390,14,14,0,1,0
26,390,390,55,36,19,2,1
21,393,393,2,2,0,1,0
12,396,396,92,40,52,4,3
0,424,424,10,10,0,1,0
7,432,432,55,55,0,1,0
11,472,472,20,20,0,1,0
5,480,480,34,34,0,1,0
13,480,480,16,16,0,1,0

15,136,136,8,8,0,1,0
4,159,159,6,6,0,1,0
11,173,173,6,6,0,1,0
0,185,185,12,12,0,1,0
13,188,188,18,15,3,2,1
19,249,249,2,2,0,1,0
10,297,297,11,11,0,1,0
3,299,299,61,61,0,1,0
16,308,308,15,3,12,4,3
9,327,327,18,18,0,1,0
21,354,354,12,5,7,2,1
2,362,362,24,6,18,3,2
8,365,365,46,5,41,4,3
22,369,369,82,78,4,2,1
17,381,381,70,19,51,4,3
7,391,391,46,31,15,2,1
1,399,399,96,70,26,3,2
6,408,408,22,22,0,1,0
12,409,409,10,10,0,1,0
20,428,428,140,65,75,4,3
14,428,428,57,50,7,2,1
5,435,435,71,49,22,2,1
23,456,456,22,17,5,2,1
18,474,474,15,15,0,1,0

16,100,100,2,2,0,1,0
9,104,104,37,25,12,4,3
17,108,108,9,9,0,1,0
6,130,130,1,1,0,1,0
20,162,162,3,3,0,1,0
4,165,165,1,1,0,1,0
8,172,172,11,2,9,2,1
10,199,199,7,7,0,1,0
23,219,219,7,7,0,1,0
21,239,239,35,13,22,3,2
5,242,242,13,13,0,1,0
2,258,258,27,7,20,3,2
1,270,270,38,38,0,1,0
12,271,271,27,27,0,1,0
18,285,285,26,4,22,3,2
0,287,287,64,4,60,3,2
14,309,309,22,22,0,1,0
19,327,327,70,70,0,1,0
11,359,359,23,15,8,2,1
15,371,371,50,4,46,4,3
13,381,381,104,92,12,4,3
3,425,425,42,42,0,1,0
7,447,447,21,21,0,1,0
22,467,467,18,2,16,2,1

13,105,105,7,4,3,2,1
15,114,114,2,2,0,1,0
6,119,119,9,5,4,2,1
21,124,124,6,3,3,2,1
17,130,130,22,22,0,1,0
1,151,151,17,17,0,1,0
2,165,165,1,1,0,1,0
22,182,182,17,12,5,2,1
3,191,191,13,13,0,1,0
9,216,216,12,12,0,1,0
5,224,224,45,34,11,2,1
14,224,224,7,7,0,1,0
20,248,248,31,31,0,1,0
25,260,260,30,30,0,1,0
16,264,264,1,1,0,1,0
27,277,277,84,84,0,1,0
12,294,294,49,18,31,2,1
24,317,317,60,36,24,2,1
11,333,333,21,21,0,1,0
10,399,399,54,12,42,4,3
26,400,400,16,16,0,1,0
19,402,402,25,25,0,1,0
4,409,409,6,6,0,1,0
18,415,415,15,15,0,1,0
7,451,451,17,17,0,1,0
23,478,478,20,3,17,4,3
8,490,490,25,25,0,1,0
0,496,496,49,21,28,3,2

4,106,106,3,3,0,1,0
20,135,135,5,5,0,1,0
3,144,144,1,1,0,1,0
6,184,184,21,7,14,3,2
9,228,228,17,17,0,1,0
14,232,232,4,4,0,1,0
24,241,241,12,3,9,4,3
2,255,255,8,8,0,1,0
22,292,292,13,13,0,1,0
13,311,311,31,31,0,1,0
16,312,312,34,24,10,3,2
19,319,319,11,5,6,2,1
8,322,322,103,15,88,3,2
10,333,333,24,8,16,3,2
7,334,334,59,5,54,3,2
0,353,353,21,21,0,1,0
15,387,387,134,65,69,4,3
18,412,412,21,21,0,1,0
1,423,423,61,27,34,3,2
12,425,425,55,55,0,1,0
23,439,439,22,15,7,2,1
5,464,464,19,9,10,3,2
11,475,475,2,2,0,1,0
17,484,484,14,14,0,1,0
21,490,490,172,160,12,4,3

17,100,100,3,3,0,1,0
14,126,126,20,11,9,4,3
16,139,139,3,3,0,1,0
11,153,153,9,3,6,3,2
0,229,229,1,1,0,1,0
15,239,239,19,13,6,3,2
3,261,261,43,16,27,2,1
5,283,283,33,33,0,1,0
2,299,299,72,62,10,3,2
7,339,339,5,1,4,2,1
19,342,342,7,7,0,1,0
18,344,344,115,115,0,1,0
10,350,350,73,3,70,4,3
9,353,353,20,2,18,3,2
6,374,374,152,35,117,4,3
4,385,385,17,2,15,2,1
1,402,402,84,17,67,3,2
12,471,471,8,8,0,1,0
8,477,477,25,25,0,1,0
13,494,494,92,92,0,1,0

22,118,118,5,5,0,1,0
15,125,125,6,6,0,1,0
6,132,132,23,23,0,1,0
16,138,138,4,4,0,1,0
12,148,148,2,2,0,1,0
9,199,199,21,21,0,1,0
20,208,208,30,9,21,2,1
14,210,210,13,1,12,4,3
13,227,227,106,36,70,3,2
2,270,270,49,49,0,1,0
1,295,295,3,3,0,1,0
18,322,322,3,3,0,1,0
3,323,323,54,45,9,2,1
8,324,324,60,60,0,1,0
0,332,332,4,4,0,1,0
21,339,339,89,55,34,3,2
10,356,356,2,2,0,1,0
19,373,373,13,13,0,1,0
4,395,395,52,52,0,1,0
7,441,441,14,14,0,1,0
11,446,446,38,38,0,1,0
5,455,455,89,17,72,4,3
17,499,499,17,9,8,2,1

14,123,123,22,10,12,2,1
17,127,127,23,11,12,4,3
1,129,129,23,13,10,3,2
3,138,138,1,1,0,1,0
18,163,163,17,17,0,1,0
15,198,198,11,11,0,1,0
4,203,203,1,1,0,1,0
2,206,206,7,7,0,1,0
13,206,206,1,1,0,1,0
21,235,235,14,14,0,1,0
9,255,255,19,5,14,2,1
12,261,261,8,5,3,2,1
5,270,270,11,6,5,2,1
24,273,273,61,61,0,1,0
26,285,285,16,16,0,1,0
19,307,307,21,21,0,1,0
23,331,331,11,11,0,1,0
20,333,333,2,2,0,1,0
8,348,348,24,15,9,4,3
7,358,358,54,54,0,1,0
0,364,364,55,13,42,4,3
22,433,433,129,129,0,1,0
11,443,443,37,12,25,2,1
10,452,452,75,72,3,2,1
16,475,475,54,4,50,3,2
25,479,479,11,11,0,1,0
6,490,490,14,14,0,1,0

12,106,106,10,10,0,1,0
21,113,113,6,6,0,1,0
20,160,160,27,22,5,2,1
15,187,187,8,2,6,3,2
5,215,215,42,37,5,2,1
11,235,235,4,1,3,2,1
14,250,250,43,43,0,1,0
0,251,251,56,42,14,3,2
10,259,259,9,9,0,1,0
8,278,278,2,2,0,1,0
18,321,321,12,1,11,2,1
9,326,326,68,57,11,2,1
13,338,338,32,32,0,1,0
1,342,342,11,11,0,1,0
3,346,346,23,23,0,1,0
7,349,349,28,8,20,4,3
17,361,361,5,1,4,2,1
2,402,402,35,35,0,1,0
16,414,414,188,188,0,1,0
19,437,437,21,21,0,1,0
6,448,448,83,83,0,1,0
4,465,465,54,54,0,1,0

12,102,102,3,3,0,1,0
7,121,121,16,2,14,2,1
14,138,138,2,2,0,1,0
21,156,156,25,25,0,1,0
22,161,161,32,9,23,2,1
10,165,165,19,2,17,2,1
5,209,209,29,13,16,3,2
16,212,212,6,6,0,1,0
15,225,225,21,14,7,2,1
1,235,235,102,79,23,2,1
6,246,246,8,8,0,1,0
2,254,254,1,1,0,1,0
18,292,292,22,2,20,3,2
4,322,322,29,20,9,2,1
0,325,325,13,10,3,2,1
17,344,344,122,92,30,3,2
19,385,385,5,5,0,1,0
20,394,394,62,18,44,3,2
8,402,402,79,7,72,4,3
11,412,412,26,14,12,4,3
3,452,452,7,7,0,1,0
9,486,486,1,1,0,1,0
13,491,491,20,10,10,2,1

14,130,130,12,6,6,3,2
1,161,161,9,2,7,2,1
6,179,179,3,3,0,1,0
10,186,186,2,2,0,1,0
23,187,187,12,12,0,1,0
27,195,195,31,31,0,1,0
26,197,197,10,1,9,2,1
19,224,224,16,4,12,4,3
3,234,234,3,3,0,1,0
5,242,242,19,6,13,2,1
18,270,270,9,9,0,1,0
17,284,284,8,8,0,1,0
28,284,284,65,65,0,1,0
22,310,310,2,2,0,1,0
25,324,324,37,37,0,1,0
20,325,325,5,5,0,1,0
4,327,327,1,1,0,1,0
0,328,328,22,8,14,2,1
24,329,329,15,4,11,2,1
11,349,349,39,39,0,1,0
9,349,349,60,60,0,1,0
2,353,353,2,2,0,1,0
13,353,353,37,7,30,2,1
12,353,353,16,16,0,1,0
7,367,367,1,1,0,1,0
29,376,376,123,114,9,4,3
16,395,395,30,30,0,1,0
8,432,432,20,20,0,1,0
15,436,436,73,59,14,3,2
21,478,478,12,12,0,1,0
31,481,481,34,34,0,1,0
30,491,491,54,8,46,2,1

18,108,108,35,35,0,1,0
2,130,130,7,2,5,2,1
16,142,142,34,34,0,1,0
17,162,162,21,21,0,1,0
15,213,213,4,4,0,1,0
23,230,230,14,1,13,2,1
0,253,253,57,57,0,1,0
20,271,271,36,18,18,3,2
14,279,279,19,10,9,2,1
10,284,284,35,35,0,1,0
9,307,307,6,3,3,2,1
4,308,308,12,12,0,1,0
19,311,311,6,2,4,2,1
8,330,330,52,17,35,3,2
13,362,362,37,37,0,1,0
5,370,370,3,3,0,1,0
3,379,379,165,144,21,2,1
1,387,387,12,2,10,2,1
7,393,393,6,6,0,1,0
12,401,401,10,1,9,4,3
11,413,413,8,8,0,1,0
22,454,454,5,5,0,1,0
6,457,457,34,34,0,1,0
21,458,458,43,43,0,1,0

10,105,105,26,26,0,1,0
15,108,108,11,11,0,1,0
14,123,123,8,8,0,1,0
0,124,124,8,8,0,1,0
7,129,129,19,5,14,2,1
8,157,157,3,3,0,1,0
18,180,180,11,11,0,1,0
11,182,182,1,1,0,1,0
12,184,184,61,8,53,3,2
9,189,189,14,3,11,2,1
17,208,208,25,13,12,3,2
3,216,216,44,44,0,1,0
16,273,273,15,1,14,2,1
2,358,358,51,51,0,1,0
4,373,373,42,15,27,4,3
19,400,400,30,20,10,3,2
13,407,407,30,18,12,2,1
5,419,419,81,32,49,3,2
1,433,433,82,6,76,3,2
6,463,463,68,68,0,1,0

16,101,101,13,13,0,1,0
11,107,107,14,4,10,3,2
25,111,111,21,12,9,4,3
5,122,122,3,3,0,1,0
9,124,124,4,4,0,1,0
28,125,125,3,3,0,1,0
1,144,144,21,21,0,1,0
2,205,205,20,20,0,1,0
26,223,223,29,2,27,4,3
24,224,224,14,14,0,1,0
10,230,230,13,3,10,3,2
6,258,258,3,3,0,1,0
13,271,271,69,69,0,1,0
8,280,280,2,2,0,1,0
14,284,284,11,1,10,2,1
12,287,287,5,2,3,2,1
20,299,299,34,34,0,1,0
3,307,307,9,3,6,2,1
7,309,309,19,19,0,1,0
4,326,326,12,6,6,2,1
18,349,349,67,7,60,3,2
17,355,355,93,41,52,4,3
0,366,366,14,14,0,1,0
19,368,368,53,43,10,2,1
15,379,379,34,34,0,1,0
21,427,427,12,6,6,2,1
22,433,433,17,1,16,2,1
23,456,456,12,12,0,1,0
27,466,466,4,1,3,2,1

7,133,133,4,1,3,2,1
10,171,171,12,1,11,4,3
19,174,174,7,1,6,2,1
6,180,180,81,68,13,2,1
16,183,183,26,5,21,2,1
15,206,206,23,10,13,2,1
9,231,231,4,1,3,2,1
23,241,241,68,29,39,2,1
11,245,245,13,13,0,1,0
0,285,285,40,40,0,1,0
20,297,297,18,4,14,2,1
13,298,298,24,20,4,2,1
21,318,318,10,1,9,4,3
12,332,332,24,24,0,1,0
24,348,348,19,19,0,1,0
17,369,369,99,69,30,4,3
4,378,378,11,2,9,4,3
3,381,381,39,39,0,1,0
22,389,389,4,4,0,1,0
18,394,394,1,1,0,1,0
8,413,413,72,37,35,3,2
5,415,415,7,7,0,1,0
2,448,448,13,13,0,1,0
1,460,460,7,7,0,1,0
14,471,471,62,26,36,4,3

20,113,113,9,3,6,3,2
4,141,141,10,10,0,1,0
21,179,179,37,5,32,3,2
9,207,207,58,35,23,2,1
14,207,207,14,14,0,1,0
15,209,209,30,30,0,1,0
8,223,223,12,12,0,1,0
6,235,235,91,58,33,4,3
5,255,255,14,14,0,1,0
17,307,307,102,102,0,1,0
3,347,347,17,5,12,4,3
1,366,366,6,6,0,1,0
10,366,366,37,37,0,1,0
11,371,371,12,12,0,1,0
0,379,379,11,11,0,1,0
2,399,399,48,6,42,3,2
12,415,415,18,6,12,2,1
16,476,476,30,30,0,1,0
19,478,478,16,16,0,1,0
18,479,479,45,14,31,3,2
13,484,484,12,5,7,2,1
7,495,495,69,25,44,2,1

23,142,142,1,1,0,1,0
19,153,153,2,2,0,1,0
7,248,248,21,21,0,1,0
9,256,256,8,8,0,1,0
25,258,258,14,5,9,4,3
13,263,263,28,28,0,1,0
15,266,266,40,40,0,1,0
1,266,266,1,1,0,1,0
17,268,268,77,77,0,1,0
5,298,298,9,5,4,2,1
24,306,306,26,8,18,3,2
21,312,312,16,12,4,2,1
14,332,332,22,3,19,2,1
2,379,379,38,26,12,4,3
20,386,386,1,1,0,1,0
22,397,397,65,32,33,4,3
4,405,405,93,13,80,4,3
0,439,439,12,6,6,2,1
12,450,450,5,2,3,2,1
3,455,455,31,10,21,2,1
16,460,460,86,13,73,3,2
26,462,462,75,39,36,2,1
18,471,471,25,13,12,2,1
6,486,486,32,25,7,2,1
10,491,491,81,56,25,2,1
11,499,499,44,44,0,1,0
8,499,499,62,38,24,4,3

8,103,103,15,6,9,4,3
7,131,131,2,2,0,1,0
19,160,160,5,2,3,2,1
12,163,163,22,12,10,2,1
15,179,179,9,9,0,1,0
16,209,209,27,12,15,2,1
14,214,214,79,74,5,2,1
5,239,239,65,37,28,2,1
21,320,320,37,9,28,3,2
6,321,321,46,46,0,1,0
20,324,324,19,11,8,2,1
1,344,344,19,19,0,1,0
10,348,348,56,56,0,1,0
0,358,358,45,45,0,1,0
3,378,378,10,10,0,1,0
18,389,389,1,1,0,1,0
9,394,394,12,2,10,3,2
2,408,408,140,106,34,2,1
11,414,414,55,55,0,1,0
13,435,435,6,6,0,1,0
4,459,459,20,20,0,1,0
17,497,497,16,9,7,2,1

24,101,101,6,6,0,1,0
20,110,110,26,14,12,4,3
2,124,124,23,15,8,3,2
4,133,133,5,5,0,1,0
16,138,138,18,18,0,1,0
6,147,147,1,1,0,1,0
22,147,147,6,1,5,2,1
1,153,153,7,7,0,1,0
5,158,158,27,12,15,3,2
9,163,163,5,5,0,1,0
15,175,175,9,9,0,1,0
21,183,183,28,16,12,3,2
26,198,198,16,11,5,2,1
28,232,232,48,44,4,2,1
14,260,260,1,1,0,1,0
27,265,265,8,8,0,1,0
19,286,286,2,2,0,1,0
8,288,288,15,15,0,1,0
3,298,298,9,3,6,2,1
11,322,322,8,2,6,2,1
18,331,331,16,7,9,4,3
25,337,337,12,8,4,2,1
12,362,362,54,6,48,4,3
10,382,382,28,8,20,3,2
23,384,384,121,121,0,1,0
13,402,402,12,12,0,1,0
17,404,404,8,8,0,1,0
7,457,457,60,60,0,1,0
0,468,468,22,12,10,2,1

4,102,102,1,1,0,1,0
22,131,131,10,5,5,2,1
6,150,150,11,11,0,1,0
24,173,173,21,3,18,3,2
10,182,182,53,21,32,2,1
2,188,188,1,1,0,1,0
11,197,197,43,13,30,4,3
3,204,204,15,15,0,1,0
9,222,222,44,27,17,2,1
18,232,232,11,2,9,2,1
13,273,273,1,1,0,1,0
16,280,280,28,28,0,1,0
23,294,294,2,2,0,1,0
17,313,313,5,5,0,1,0
5,331,331,20,2,18,3,2
7,354,354,6,6,0,1,0
14,355,355,7,7,0,1,0
25,369,369,87,57,30,3,2
1,401,401,18,18,0,1,0
21,404,404,114,60,54,4,3
8,405,405,17,17,0,1,0
19,414,414,50,47,3,2,1
12,429,429,32,18,14,4,3
15,463,463,69,69,0,1,0
20,474,474,20,20,0,1,0
0,499,499,44,44,0,1,0

24,102,102,12,12,0,1,0
23,159,159,4,4,0,1,0
20,163,163,8,8,0,1,0
9,163,163,4,4,0,1,0
11,173,173,12,12,0,1,0
13,199,199,7,7,0,1,0
21,235,235,33,16,17,2,1
10,272,272,22,4,18,3,2
0,274,274,3,3,0,1,0
22,289,289,78,12,66,3,2
15,295,295,1,1,0,1,0
3,316,316,11,11,0,1,0
19,328,328,27,27,0,1,0
8,361,361,1,1,0,1,0
28,375,375,31,31,0,1,0
2,383,383,14,14,0,1,0
4,387,387,59,8,51,4,3
12,394,394,33,33,0,1,0
18,401,401,48,15,33,4,3
29,402,402,2,2,0,1,0
5,406,406,95,41,54,4,3
16,407,407,63,9,54,3,2
17,415,415,25,25,0,1,0
25,421,421,26,26,0,1,0
26,424,424,39,9,30,4,3
1,436,436,2,2,0,1,0
27,442,442,80,18,62,3,2
6,451,451,68,68,0,1,0
7,490,490,14,14,0,1,0
14,493,493,17,17,0,1,0

15,109,109,3,3,0,1,0
19,131,131,33,19,14,2,1
22,143,143,9,9,0,1,0
2,157,157,18,2,16,2,1
14,186,186,2,2,0,1,0
7,198,198,34,12,22,2,1
6,231,231,29,1,28,2,1
20,268,268,30,13,17,2,1
9,291,291,42,8,34,2,1
10,296,296,7,7,0,1,0
23,308,308,1,1,0,1,0
16,314,314,11,6,5,2,1
21,340,340,123,59,64,4,3
12,344,344,37,37,0,1,0
18,357,357,56,56,0,1,0
1,360,360,74,25,49,2,1
13,372,372,29,29,0,1,0
4,416,416,5,5,0,1,0
0,429,429,5,5,0,1,0
8,434,434,77,56,21,4,3
17,446,446,9,9,0,1,0
5,458,458,54,54,0,1,0
3,470,470,21,21,0,1,0
11,472,472,25,25,0,1,0

10,114,114,6,6,0,1,0
21,117,117,5,5,0,1,0
20,126,126,7,1,6,3,2
19,149,149,15,7,8,2,1
1,165,165,32,32,0,1,0
22,170,170,20,5,15,2,1
9,210,210,14,14,0,1,0
8,234,234,29,19,10,2,1
12,253,253,36,9,27,2,1
18,278,278,24,7,17,3,2
17,306,306,10,10,0,1,0
11,319,319,40,23,17,2,1
16,370,370,107,107,0,1,0
13,388,388,1,1,0,1,0
6,390,390,36,36,0,1,0
0,398,398,3,3,0,1,0
2,440,440,49,49,0,1,0
5,451,451,73,73,0,1,0
3,456,456,60,60,0,1,0
14,476,476,33,33,0,1,0
4,493,493,115,35,80,3,2
7,494,494,15,1,14,2,1
15,499,499,80,35,45,4,3

7,109,109,19,19,0,1,0
8,111,111,20,8,12,3,2
16,112,112,1,1,0,1,0
5,170,170,4,4,0,1,0
0,182,182,17,17,0,1,0
3,188,188,82,82,0,1,0
13,196,196,38,38,0,1,0
4,212,212,115,45,70,3,2
11,228,228,16,16,0,1,0
2,260,260,17,9,8,3,2
14,315,315,22,22,0,1,0
1,381,381,24,24,0,1,0
15,395,395,79,48,31,2,1
9,397,397,13,4,9,4,3
12,425,425,28,21,7,2,1
10,440,440,15,11,4,2,1
6,454,454,80,55,25,2,1

6,102,102,2,2,0,1,0
0,128,128,5,5,0,1,0
13,128,128,13,5,8,2,1
11,132,132,3,3,0,1,0
8,202,202,46,22,24,4,3
16,240,240,51,51,0,1,0
12,242,242,15,15,0,1,0
5,250,250,51,51,0,1,0
3,253,253,14,14,0,1,0
18,273,273,72,72,0,1,0
14,282,282,32,32,0,1,0
15,300,300,2,2,0,1,0
19,329,329,15,15,0,1,0
20,383,383,97,85,12,4,3
17,394,394,13,3,10,2,1
10,406,406,6,6,0,1,0
9,410,410,96,6,90,3,2
7,413,413,84,84,0,1,0
21,450,450,43,8,35,4,3
4,462,462,1,1,0,1,0
1,467,467,36,28,8,2,1
2,493,493,68,68,0,1,0

17,119,119,2,2,0,1,0
16,147,147,13,13,0,1,0
9,157,157,33,33,0,1,0
14,175,175,8,5,3,2,1
7,175,175,10,2,8,3,2
24,195,195,47,41,6,2,1
21,201,201,9,9,0,1,0
26,223,223,14,14,0,1,0
1,234,234,44,44,0,1,0
12,248,248,15,7,8,2,1
11,252,252,7,4,3,2,1
27,266,266,1,1,0,1,0
13,270,270,1,1,0,1,0
19,280,280,71,47,24,2,1
5,281,281,30,8,22,3,2
20,316,316,54,17,37,2,1
6,325,325,10,2,8,3,2
15,334,334,21,21,0,1,0
2,350,350,14,14,0,1,0
18,379,379,66,66,0,1,0
10,390,390,38,38,0,1,0
8,415,415,26,6,20,4,3
28,418,418,45,35,10,2,1
23,426,426,20,8,12,3,2
3,430,430,39,31,8,2,1
0,444,444,1,1,0,1,0
4,451,451,13,7,6,2,1
25,464,464,9,9,0,1,0
22,481,481,37,15,22,2,1

2,106,106,10,7,3,2,1
20,125,125,9,9,0,1,0
1,134,134,81,33,48,2,1
18,150,150,3,3,0,1,0
13,187,187,14,3,11,2,1
4,208,208,1,1,0,1,0
0,214,214,3,3,0,1,0
19,244,244,79,24,55,3,2
9,254,254,10,10,0,1,0
16,274,274,20,10,10,3,2
14,298,298,11,11,0,1,0
12,312,312,102,102,0,1,0
10,346,346,18,2,16,2,1
11,379,379,19,14,5,2,1
3,384,384,28,7,21,4,3
8,393,393,96,58,38,2,1
5,406,406,26,9,17,4,3
7,424,424,31,31,0,1,0
17,462,462,52,4,48,3,2
15,478,478,22,22,0,1,0
6,499,499,14,2,12,4,3

16,103,103,4,1,3,2,1
9,110,110,9,9,0,1,0
26,140,140,15,7,8,3,2
0,217,217,25,10,15,4,3
5,227,227,10,10,0,1,0
14,230,230,12,12,0,1,0
18,235,235,9,9,0,1,0
27,237,237,17,6,11,2,1
6,241,241,19,19,0,1,0
23,287,287,41,2,39,2,1
15,292,292,23,23,0,1,0
8,295,295,8,8,0,1,0
3,311,311,3,3,0,1,0
17,326,326,30,30,0,1,0
2,331,331,31,31,0,1,0
7,346,346,75,39,36,3,2
20,347,347,26,26,0,1,0
13,374,374,25,12,13,2,1
22,383,383,1,1,0,1,0
1,384,384,1,1,0,1,0
24,393,393,225,225,0,1,0
12,396,396,35,1,34,3,2
11,399,399,18,18,0,1,0
10,423,423,49,14,35,3,2
4,443,443,37,37,0,1,0
19,457,457,2,2,0,1,0
25,457,457,24,21,3,2,1
21,478,478,9,9,0,1,0

15,121,121,6,6,0,1,0
0,168,168,7,7,0,1,0
16,169,169,26,11,15,3,2
7,203,203,6,6,0,1,0
14,266,266,7,4,3,2,1
1,275,275,30,2,28,2,1
6,320,320,2,2,0,1,0
2,321,321,52,39,13,2,1
8,329,329,38,38,0,1,0
19,346,346,96,89,7,2,1
12,347,347,14,14,0,1,0
17,354,354,11,11,0,1,0
4,388,388,113,113,0,1,0
10,429,429,57,15,42,4,3
5,433,433,221,143,78,4,3
11,464,464,67,3,64,4,3
13,465,465,37,27,10,2,1
3,481,481,26,15,11,2,1
18,481,481,31,31,0,1,0
9,499,499,54,19,35,2,1

7,123,123,5,5,0,1,0
3,143,143,2,2,0,1,0
4,172,172,1,1,0,1,0
10,214,214,19,6,13,2,1
16,228,228,17,8,9,2,1
17,277,277,25,2,23,2,1
12,296,296,109,43,66,4,3
5,302,302,10,6,4,2,1
11,305,305,2,2,0,1,0
13,312,312,32,13,19,4,3
1,316,316,29,18,11,2,1
8,365,365,10,10,0,1,0
15,379,379,27,27,0,1,0
0,452,452,175,43,132,4,3
2,464,464,244,162,82,3,2
9,471,471,56,56,0,1,0
14,476,476,56,56,0,1,0
18,487,487,56,28,28,2,1
6,498,498,71,71,0,1,0

7,102,102,28,28,0,1,0
1,106,106,1,1,0,1,0
5,114,114,8,8,0,1,0
3,123,123,10,10,0,1,0
14,126,126,8,2,6,2,1
18,153,153,6,1,5,2,1
12,157,157,11,11,0,1,0
2,208,208,27,27,0,1,0
8,273,273,1,1,0,1,0
21,282,282,6,6,0,1,0
11,312,312,71,49,22,3,2
16,313,313,7,7,0,1,0
13,315,315,64,64,0,1,0
17,331,331,3,3,0,1,0
10,346,346,64,31,33,4,3
19,359,359,47,18,29,2,1
9,362,362,28,3,25,4,3
23,380,380,11,11,0,1,0
15,380,380,23,23,0,1,0
20,402,402,119,119,0,1,0
0,424,424,18,5,13,3,2
6,428,428,39,9,30,4,3
4,477,477,5,5,0,1,0
22,482,482,135,90,45,4,3

8,123,123,2,2,0,1,0
5,127,127,5,5,0,1,0
0,169,169,51,36,15,4,3
3,197,197,20,4,16,2,1
4,198,198,5,5,0,1,0
12,245,245,7,7,0,1,0
1,254,254,33,5,28,4,3
14,270,270,45,45,0,1,0
21,277,277,23,23,0,1,0
10,304,304,15,3,12,3,2
2,328,328,34,4,30,2,1
16,345,345,31,31,0,1,0
19,365,365,61,36,25,2,1
22,368,368,46,33,13,2,1
11,369,369,44,8,36,2,1
20,392,392,3,3,0,1,0
17,401,401,35,28,7,2,1
18,403,403,104,10,94,3,2
6,411,411,6,6,0,1,0
13,439,439,19,3,16,3,2
7,450,450,145,58,87,4,3
9,455,455,45,33,12,2,1
15,466,466,18,7,11,2,1

18,124,124,4,4,0,1,0
17,129,129,7,7,0,1,0
13,149,149,10,5,5,2,1
16,163,163,18,18,0,1,0
19,172,172,4,4,0,1,0
22,186,186,4,4,0,1,0
25,194,194,21,14,7,2,1
1,243,243,14,4,10,3,2
3,249,249,5,5,0,1,0
9,258,258,9,9,0,1,0
7,270,270,3,3,0,1,0
12,279,279,28,28,0,1,0
0,290,290,7,1,6,2,1
24,293,293,45,45,0,1,0
6,307,307,11,11,0,1,0
20,313,313,35,6,29,4,3
2,315,315,40,40,0,1,0
11,330,330,40,40,0,1,0
8,339,339,36,4,32,4,3
5,371,371,134,34,100,3,2
21,394,394,124,37,87,4,3
14,413,413,40,4,36,4,3
4,417,417,7,2,5,2,1
10,431,431,51,23,28,2,1
15,450,450,16,3,13,3,2
23,483,483,77,47,30,4,3

23,104,104,4,4,0,1,0
9,144,144,6,6,0,1,0
22,174,174,10,10,0,1,0
20,249,249,60,60,0,1,0
13,275,275,5,5,0,1,0
19,281,281,31,25,6,3,2
7,302,302,29,5,24,3,2
24,310,310,13,13,0,1,0
1,322,322,11,11,0,1,0
4,336,336,31,31,0,1,0
17,342,342,11,11,0,1,0
0,351,351,3,3,0,1,0
18,352,352,36,36,0,1,0
11,382,382,1,1,0,1,0
21,401,401,23,23,0,1,0
5,411,411,89,89,0,1,0
12,412,412,104,54,50,3,2
2,426,426,25,25,0,1,0
14,428,428,31,31,0,1,0
15,448,448,150,42,108,4,3
3,449,449,14,14,0,1,0
16,472,472,43,19,24,2,1
25,476,476,18,18,0,1,0
10,477,477,1,1,0,1,0
6,490,490,127,82,45,3,2
8,492,492,43,19,24,3,2

5,110,110,10,10,0,1,0
20,122,122,35,35,0,1,0
16,169,169,19,9,10,3,2
9,199,199,7,3,4,2,1
18,214,214,21,5,16,2,1
0,216,216,21,21,0,1,0
22,222,222,26,26,0,1,0
10,233,233,14,3,11,2,1
23,245,245,24,24,0,1,0
7,251,251,6,3,3,2,1
3,267,267,54,6,48,4,3
13,279,279,11,11,0,1,0
24,298,298,42,27,15,4,3
8,302,302,56,56,0,1,0
17,348,348,7,7,0,1,0
4,374,374,43,16,27,4,3
6,386,386,23,10,13,2,1
14,402,402,65,62,3,2,1
19,405,405,8,8,0,1,0
15,411,411,34,34,0,1,0
1,426,426,117,23,94,3,2
2,455,455,7,7,0,1,0
11,461,461,15,5,10,2,1
21,477,477,23,20,3,2,1
12,492,492,4,1,3,2,1

12,130,130,4,4,0,1,0
18,164,164,17,13,4,2,1
17,196,196,18,8,10,2,1
4,205,205,17,11,6,2,1
0,254,254,41,38,3,2,1
19,257,257,105,105,0,1,0
10,268,268,18,18,0,1,0
11,279,279,18,18,0,1,0
3,306,306,10,10,0,1,0
13,328,328,4,4,0,1,0
1,341,341,53,14,39,4,3
2,354,354,95,50,45,2,1
6,372,372,38,38,0,1,0
8,381,381,60,25,35,4,3
5,407,407,36,3,33,2,1
9,415,415,45,45,0,1,0
16,453,453,30,13,17,2,1
15,464,464,49,19,30,2,1
14,465,465,4,4,0,1,0
7,467,467,71,71,0,1,0
20,484,484,72,29,43,2,1

10,104,104,16,8,8,3,2
19,107,107,7,7,0,1,0
16,122,122,7,7,0,1,0
1,130,130,18,18,0,1,0
11,140,140,17,2,15,4,3
14,176,176,29,29,0,1,0
9,188,188,28,28,0,1,0
2,200,200,15,2,13,2,1
7,217,217,36,36,0,1,0
12,222,222,24,24,0,1,0
15,231,231,12,12,0,1,0
6,249,249,3,3,0,1,0
13,281,281,17,17,0,1,0
0,322,322,38,38,0,1,0
18,325,325,11,1,10,3,2
8,335,335,50,16,34,3,2
3,363,363,99,78,21,4,3
4,424,424,18,3,15,2,1
5,426,426,160,92,68,4,3
17,478,478,55,7,48,4,3

14,134,134,35,35,0,1,0
16,147,147,21,21,0,1,0
3,151,151,14,14,0,1,0
24,158,158,3,3,0,1,0
7,159,159,7,2,5,2,1
18,175,175,10,10,0,1,0
15,176,176,38,4,34,3,2
11,185,185,14,14,0,1,0
23,221,221,18,18,0,1,0
21,238,238,28,17,11,2,1
19,239,239,22,22,0,1,0
12,261,261,25,25,0,1,0
8,292,292,50,33,17,2,1
4,301,301,20,20,0,1,0
20,306,306,3,3,0,1,0
6,313,313,37,7,30,4,3
1,319,319,89,47,42,2,1
5,321,321,9,4,5,2,1
0,329,329,12,4,8,3,2
13,344,344,39,39,0,1,0
22,345,345,13,13,0,1,0
10,407,407,50,50,0,1,0
2,437,437,20,10,10,2,1
9,478,478,12,12,0,1,0
17,485,485,41,41,0,1,0

24,106,106,15,15,0,1,0
5,144,144,5,1,4,2,1
25,150,150,9,9,0,1,0
11,164,164,4,1,3,2,1
15,167,167,10,10,0,1,0
21,209,209,6,6,0,1,0
18,212,212,34,34,0,1,0
23,256,256,10,10,0,1,0
13,311,311,43,10,33,2,1
12,317,317,61,61,0,1,0
3,318,318,16,9,7,2,1
19,321,321,30,12,18,2,1
26,322,322,93,93,0,1,0
2,350,350,42,15,27,4,3
8,355,355,24,3,21,3,2
7,358,358,12,7,5,2,1
0,361,361,14,14,0,1,0
10,364,364,1,1,0,1,0
1,378,378,24,24,0,1,0
20,394,394,4,4,0,1,0
9,400,400,30,13,17,2,1
17,426,426,86,86,0,1,0
22,452,452,25,10,15,2,1
6,456,456,57,57,0,1,0
14,475,475,92,52,40,3,2
16,475,475,39,39,0,1,0
4,490,490,20,4,16,3,2

7,117,117,8,8,0,1,0
22,124,124,7,7,0,1,0
5,142,142,12,12,0,1,0
12,172,172,47,47,0,1,0
8,172,172,8,2,6,3,2
23,215,215,11,11,0,1,0
10,239,239,107,107,0,1,0
18,245,245,6,6,0,1,0
15,247,247,25,25,0,1,0
2,263,263,2,2,0,1,0
13,278,278,22,22,0,1,0
1,280,280,1,1,0,1,0
19,291,291,32,24,8,3,2
21,323,323,10,10,0,1,0
11,356,356,27,27,0,1,0
3,362,362,68,68,0,1,0
17,369,369,27,27,0,1,0
16,381,381,55,55,0,1,0
6,410,410,15,3,12,2,1
14,429,429,103,103,0,1,0
20,438,438,16,3,13,2,1
9,468,468,54,54,0,1,0
0,479,479,51,33,18,3,2
4,493,493,11,1,10,2,1

17,126,126,5,5,0,1,0
10,141,141,24,18,6,3,2
22,149,149,57,43,14,2,1
5,170,170,31,31,0,1,0
15,194,194,27,27,0,1,0
11,225,225,2,2,0,1,0
2,243,243,7,7,0,1,0
7,262,262,1,1,0,1,0
1,272,272,153,13,140,4,3
21,280,280,10,10,0,1,0
12,283,283,90,50,40,3,2
3,290,290,8,2,6,3,2
8,303,303,34,34,0,1,0
16,306,306,8,4,4,2,1
4,310,310,3,3,0,1,0
13,360,360,2,2,0,1,0
18,390,390,10,7,3,2,1
19,411,411,53,53,0,1,0
14,429,429,6,6,0,1,0
20,431,431,42,14,28,3,2
9,434,434,7,7,0,1,0
6,438,438,4,4,0,1,0
0,464,464,37,37,0,1,0

7,105,105,10,2,8,2,1
1,125,125,1,1,0,1,0
12,137,137,6,3,3,2,1
19,147,147,10,7,3,2,1
6,220,220,42,25,17,2,1
13,220,220,16,16,0,1,0
10,229,229,76,28,48,3,2
17,238,238,19,19,0,1,0
14,242,242,105,105,0,1,0
20,254,254,40,40,0,1,0
22,282,282,7,4,3,2,1
18,304,304,15,9,6,2,1
5,309,309,11,1,10,3,2
15,340,340,32,32,0,1,0
16,362,362,47,5,42,3,2
21,365,365,8,8,0,1,0
9,391,391,72,21,51,4,3
0,400,400,31,31,0,1,0
4,408,408,82,73,9,4,3
3,432,432,27,27,0,1,0
2,443,443,5,5,0,1,0
11,454,454,27,27,0,1,0
8,500,500,2,2,0,1,0

13,111,111,6,1,5,2,1
1,114,114,12,3,9,4,3
23,116,116,16,2,14,2,1
22,126,126,24,12,12,2,1
4,162,162,15,15,0,1,0
7,162,162,20,20,0,1,0
0,168,168,16,16,0,1,0
8,173,173,9,9,0,1,0
14,180,180,13,13,0,1,0
12,253,253,8,8,0,1,0
3,276,276,1,1,0,1,0
2,309,309,88,55,33,2,1
17,345,345,20,11,9,2,1
6,373,373,70,15,55,3,2
9,380,380,1,1,0,1,0
11,384,384,20,20,0,1,0
19,387,387,41,41,0,1,0
21,387,387,48,48,0,1,0
10,422,422,28,28,0,1,0
15,427,427,142,142,0,1,0
20,430,430,46,11,35,2,1
16,435,435,4,4,0,1,0
18,477,477,1,1,0,1,0
5,491,491,66,23,43,4,3

21,120,120,3,3,0,1,0
8,135,135,7,7,0,1,0
1,146,146,20,20,0,1,0
14,164,164,27,27,0,1,0
12,181,181,12,3,9,4,3
13,189,189,1,1,0,1,0
11,197,197,31,31,0,1,0
3,237,237,14,14,0,1,0
6,243,243,1,1,0,1,0
25,243,243,16,5,11,2,1
17,285,285,13,13,0,1,0
24,297,297,78,24,54,4,3
22,308,308,9,1,8,2,1
19,325,325,184,96,88,4,3
10,331,331,21,12,9,2,1
23,334,334,5,5,0,1,0
9,395,395,55,46,9,2,1
16,403,403,1,1,0,1,0
26,421,421,30,10,20,3,2
0,422,422,15,15,0,1,0
2,436,436,12,12,0,1,0
5,450,450,79,48,31,2,1
20,465,465,46,2,44,3,2
7,468,468,49,22,27,4,3
4,470,470,5,1,4,2,1
18,492,492,15,1,14,3,2
15,497,497,5,5,0,1,0

25,108,108,18,3,15,4,3
14,144,144,3,3,0,1,0
18,146,146,14,1,13,3,2
15,151,151,6,3,3,2,1
16,173,173,5,5,0,1,0
4,178,178,8,2,6,3,2
13,179,179,2,2,0,1,0
9,215,215,15,8,7,2,1
20,228,228,3,3,0,1,0
22,230,230,16,16,0,1,0
24,235,235,16,16,0,1,0
21,263,263,28,28,0,1,0
17,293,293,91,91,0,1,0
12,299,299,6,3,3,2,1
6,315,315,3,3,0,1,0
2,315,315,1,1,0,1,0
11,324,324,13,13,0,1,0
5,349,349,3,3,0,1,0
23,354,354,91,71,20,2,1
8,361,361,78,21,57,4,3
10,378,378,96,96,0,1,0
0,381,381,90,6,84,4,3
1,389,389,53,44,9,4,3
3,413,413,27,27,0,1,0
7,428,428,28,28,0,1,0
26,484,484,16,16,0,1,0
19,496,496,23,23,0,1,0

14,102,102,3,3,0,1,0
7,113,113,9,9,0,1,0
6,121,121,16,16,0,1,0
21,123,123,5,5,0,1,0
11,143,143,14,14,0,1,0
18,172,172,1,1,0,1,0
19,177,177,17,17,0,1,0
9,183,183,5,2,3,2,1
20,185,185,55,55,0,1,0
4,200,200,6,2,4,2,1
2,236,236,3,3,0,1,0
13,239,239,81,14,67,4,3
3,244,244,17,17,0,1,0
8,250,250,7,4,3,2,1
17,268,268,61,61,0,1,0
1,297,297,27,27,0,1,0
22,310,310,34,34,0,1,0
15,316,316,54,36,18,4,3
25,329,329,29,3,26,3,2
10,358,358,27,27,0,1,0
0,375,375,1,1,0,1,0
16,379,379,14,14,0,1,0
12,410,410,28,11,17,2,1
23,451,451,40,16,24,3,2
5,493,493,74,74,0,1,0
24,494,494,14,14,0,1,0

12,109,109,2,2,0,1,0
27,125,125,11,3,8,2,1
18,135,135,7,2,5,2,1
14,139,139,4,4,0,1,0
7,141,141,10,10,0,1,0
24,181,181,4,1,3,2,1
0,197,197,10,10,0,1,0
15,206,206,45,14,31,2,1
13,238,238,6,1,5,2,1
8,254,254,15,7,8,3,2
2,292,292,24,24,0,1,0
17,312,312,3,3,0,1,0
23,313,313,53,53,0,1,0
6,324,324,86,64,22,3,2
20,357,357,24,11,13,2,1
25,361,361,106,106,0,1,0
11,362,362,7,7,0,1,0
19,372,372,12,12,0,1,0
16,388,388,78,78,0,1,0
5,388,388,89,89,0,1,0
10,392,392,11,3,8,3,2
21,396,396,86,68,18,4,3
1,409,409,1,1,0,1,0
4,430,430,15,15,0,1,0
26,432,432,1,1,0,1,0
3,480,480,6,6,0,1,0
22,480,480,32,9,23,2,1
9,495,495,27,27,0,1,0

22,108,108,42,42,0,1,0
10,114,114,30,18,12,2,1
7,153,153,3,3,0,1,0
12,154,154,1,1,0,1,0
2,194,194,7,7,0,1,0
6,204,204,25,25,0,1,0
3,210,210,1,1,0,1,0
1,255,255,3,3,0,1,0
20,278,278,38,20,18,3,2
4,294,294,60,60,0,1,0
19,315,315,56,43,13,2,1
5,319,319,12,12,0,1,0
8,338,338,64,64,0,1,0
13,338,338,29,15,14,2,1
17,346,346,26,10,16,3,2
18,350,350,17,17,0,1,0
24,357,357,3,3,0,1,0
11,394,394,24,10,14,2,1
16,424,424,5,5,0,1,0
14,434,434,22,22,0,1,0
21,434,434,44,44,0,1,0
15,451,451,46,10,36,3,2
0,465,465,40,40,0,1,0
9,478,478,78,58,20,3,2
23,484,484,16,4,12,2,1

7,122,122,17,17,0,1,0
5,131,131,1,1,0,1,0
1,132,132,1,1,0,1,0
24,141,141,3,3,0,1,0
23,149,149,2,2,0,1,0
14,154,154,17,17,0,1,0
17,156,156,108,65,43,2,1
21,188,188,5,5,0,1,0
18,191,191,7,1,6,2,1
9,195,195,37,37,0,1,0
4,199,199,33,25,8,3,2
2,202,202,3,3,0,1,0
20,212,212,10,4,6,2,1
8,232,232,13,7,6,3,2
11,237,237,3,3,0,1,0
26,264,264,3,3,0,1,0
12,266,266,19,2,17,3,2
3,299,299,1,1,0,1,0
22,304,304,5,5,0,1,0
10,309,309,1,1,0,1,0
15,323,323,24,24,0,1,0
6,365,365,113,98,15,4,3
25,389,389,67,39,28,3,2
13,390,390,10,2,8,3,2
16,407,407,41,41,0,1,0
0,484,484,42,42,0,1,0
19,485,485,5,1,4,2,1

25,108,108,6,2,4,2,1
26,124,124,3,3,0,1,0
9,145,145,15,15,0,1,0
3,171,171,5,1,4,2,1
24,176,176,16,16,0,1,0
27,202,202,5,5,0,1,0
2,205,205,26,2,24,2,1
6,219,219,7,7,0,1,0
16,221,221,24,24,0,1,0
4,226,226,10,10,0,1,0
0,233,233,17,17,0,1,0
28,260,260,13,13,0,1,0
11,297,297,10,10,0,1,0
19,316,316,14,8,6,3,2
12,317,317,37,10,27,4,3
15,333,333,20,20,0,1,0
17,333,333,2,2,0,1,0
22,344,344,257,185,72,3,2
1,351,351,5,5,0,1,0
23,351,351,13,5,8,2,1
10,359,359,15,15,0,1,0
5,376,376,10,10,0,1,0
7,386,386,11,11,0,1,0
21,406,406,15,15,0,1,0
8,460,460,47,44,3,2,1
18,463,463,43,12,31,2,1
13,485,485,82,44,38,3,2
20,488,488,7,1,6,3,2
14,489,489,46,46,0,1,0

14,137,137,24,24,0,1,0
17,172,172,81,81,0,1,0
13,192,192,27,22,5,2,1
1,226,226,50,50,0,1,0
3,237,237,24,24,0,1,0
24,238,238,27,27,0,1,0
21,245,245,11,11,0,1,0
11,248,248,12,12,0,1,0
4,249,249,23,6,17,3,2
16,261,261,8,8,0,1,0
8,300,300,29,19,10,2,1
0,304,304,35,1,34,3,2
9,337,337,84,8,76,4,3
18,371,371,8,8,0,1,0
6,388,388,50,26,24,4,3
5,392,392,37,37,0,1,0
7,401,401,1,1,0,1,0
23,418,418,6,6,0,1,0
19,435,435,26,2,24,4,3
10,452,452,17,17,0,1,0
20,471,471,12,12,0,1,0
15,475,475,59,20,39,2,1
22,479,479,5,5,0,1,0
2,481,481,1,1,0,1,0
12,482,482,5,5,0,1,0

1,151,151,9,6,3,2,1
11,156,156,7,7,0,1,0
23,167,167,19,19,0,1,0
2,173,173,18,6,12,4,3
12,178,178,36,8,28,3,2
7,218,218,21,8,13,2,1
13,224,224,29,9,20,2,1
0,244,244,3,3,0,1,0
16,252,252,83,25,58,3,2
19,261,261,9,9,0,1,0
4,272,272,9,3,6,3,2
17,274,274,33,33,0,1,0
14,290,290,18,1,17,4,3
8,312,312,7,7,0,1,0
10,360,360,80,34,46,2,1
6,372,372,10,10,0,1,0
5,378,378,3,3,0,1,0
9,391,391,127,31,96,4,3
3,398,398,18,18,0,1,0
20,405,405,2,2,0,1,0
22,410,410,52,23,29,2,1
24,411,411,7,7,0,1,0
18,441,441,96,93,3,2,1
21,457,457,11,11,0,1,0
15,475,475,20,14,6,2,1

17,101,101,2,2,0,1,0
18,108,108,15,15,0,1,0
13,114,114,16,6,10,3,2
12,157,157,38,38,0,1,0
7,166,166,4,4,0,1,0
24,193,193,25,25,0,1,0
26,206,206,13,13,0,1,0
22,209,209,21,2,19,2,1
0,215,215,3,3,0,1,0
6,261,261,28,1,27,2,1
15,261,261,17,13,4,2,1
14,262,262,10,3,7,2,1
16,265,265,94,94,0,1,0
9,287,287,24,24,0,1,0
23,311,311,46,46,0,1,0
5,315,315,16,12,4,2,1
8,318,318,55,42,13,2,1
27,329,329,50,41,9,4,3
11,334,334,3,3,0,1,0
1,354,354,39,17,22,2,1
19,362,362,1,1,0,1,0
3,376,376,10,10,0,1,0
20,378,378,34,34,0,1,0
21,380,380,1,1,0,1,0
25,385,385,8,8,0,1,0
4,392,392,3,3,0,1,0
2,437,437,12,12,0,1,0
10,486,486,40,13,27,4,3

21,100,100,9,3,6,2,1
20,104,104,3,3,0,1,0
22,106,106,6,6,0,1,0
13,129,129,6,6,0,1,0
6,154,154,8,8,0,1,0
10,166,166,2,2,0,1,0
17,207,207,44,21,23,2,1
15,214,214,6,3,3,2,1
1,265,265,71,71,0,1,0
0,276,276,19,19,0,1,0
8,281,281,15,15,0,1,0
5,311,311,1,1,0,1,0
9,312,312,29,29,0,1,0
2,322,322,33,17,16,3,2
14,326,326,117,117,0,1,0
23,347,347,33,6,27,2,1
3,347,347,94,31,63,3,2
16,367,367,19,19,0,1,0
19,391,391,7,7,0,1,0
18,400,400,20,4,16,2,1
4,413,413,22,22,0,1,0
11,425,425,69,69,0,1,0
7,431,431,27,27,0,1,0
12,492,492,100,55,45,4,3

20,117,117,11,11,0,1,0
25,135,135,10,10,0,1,0
14,153,153,17,17,0,1,0
16,156,156,39,39,0,1,0
9,181,181,3,3,0,1,0
22,204,204,17,17,0,1,0
24,209,209,57,26,31,2,1
4,222,222,16,8,8,2,1
3,246,246,7,7,0,1,0
23,252,252,24,16,8,3,2
5,267,267,5,1,4,2,1
13,272,272,36,36,0,1,0
7,294,294,61,31,30,2,1
6,298,298,7,1,6,3,2
12,338,338,16,9,7,2,1
8,338,338,28,24,4,2,1
1,392,392,79,51,28,3,2
18,393,393,57,36,21,4,3
11,405,405,15,1,14,3,2
19,414,414,4,4,0,1,0
0,421,421,14,14,0,1,0
21,424,424,7,3,4,2,1
2,432,432,7,7,0,1,0
17,445,445,5,5,0,1,0
15,447,447,28,28,0,1,0
10,485,485,138,56,82,3,2

12,138,138,6,6,0,1,0
10,147,147,16,16,0,1,0
22,153,153,15,15,0,1,0
6,154,154,14,4,10,2,1
7,154,154,15,6,9,2,1
0,181,181,35,35,0,1,0
4,232,232,5,5,0,1,0
2,261,261,16,8,8,2,1
17,265,265,26,14,12,4,3
1,277,277,5,2,3,2,1
8,311,311,48,8,40,3,2
20,315,315,30,30,0,1,0
15,317,317,23,23,0,1,0
3,328,328,25,1,24,2,1
19,330,330,71,71,0,1,0
18,336,336,16,3,13,2,1
16,343,343,44,44,0,1,0
9,344,344,12,2,10,3,2
13,354,354,32,8,24,2,1
5,373,373,128,83,45,4,3
11,449,449,115,65,50,2,1
14,467,467,31,31,0,1,0
21,469,469,6,6,0,1,0

1,105,105,25,5,20,2,1
14,108,108,52,17,35,3,2
17,109,109,9,9,0,1,0
13,149,149,3,3,0,1,0
11,158,158,25,25,0,1,0
10,168,168,15,15,0,1,0
9,169,169,38,16,22,2,1
8,223,223,1,1,0,1,0
7,266,266,6,2,4,2,1
5,277,277,10,10,0,1,0
3,304,304,17,17,0,1,0
2,323,323,80,6,74,3,2
0,332,332,34,10,24,3,2
12,364,364,17,2,15,4,3
6,378,378,83,43,40,3,2
16,379,379,12,2,10,2,1
18,380,380,22,22,0,1,0
15,391,391,3,3,0,1,0
4,467,467,141,67,74,4,3

27,105,105,9,4,5,2,1
19,106,106,33,33,0,1,0
7,112,112,4,4,0,1,0
14,121,121,8,2,6,3,2
4,170,170,6,6,0,1,0
15,183,183,3,3,0,1,0
9,195,195,13,13,0,1,0
8,196,196,18,18,0,1,0
18,221,221,4,4,0,1,0
2,240,240,56,51,5,2,1
10,242,242,9,3,6,2,1
0,253,253,34,34,0,1,0
26,275,275,41,41,0,1,0
3,311,311,5,5,0,1,0
6,314,314,14,14,0,1,0
22,319,319,65,65,0,1,0
20,325,325,38,18,20,3,2
24,325,325,33,1,32,3,2
1,347,347,28,6,22,2,1
16,375,375,46,7,39,4,3
17,379,379,3,3,0,1,0
13,387,387,19,19,0,1,0
23,396,396,24,24,0,1,0
5,444,444,42,2,40,2,1
25,449,449,20,4,16,2,1
21,452,452,4,4,0,1,0
12,470,470,60,45,15,4,3
11,493,493,36,27,9,4,3

23,132,132,2,2,0,1,0
26,170,170,22,12,10,3,2
25,182,182,1,1,0,1,0
6,189,189,1,1,0,1,0
15,192,192,45,45,0,1,0
3,200,200,18,18,0,1,0
14,235,235,9,3,6,2,1
21,237,237,40,19,21,4,3
28,238,238,7,3,4,2,1
9,242,242,45,33,12,4,3
11,246,246,8,8,0,1,0
4,260,260,6,6,0,1,0
16,285,285,4,1,3,2,1
2,291,291,26,26,0,1,0
10,314,314,33,33,0,1,0
12,331,331,31,16,15,4,3
22,369,369,41,41,0,1,0
8,372,372,52,52,0,1,0
19,373,373,68,68,0,1,0
20,376,376,64,64,0,1,0
24,376,376,8,8,0,1,0
13,379,379,20,1,19,2,1
1,393,393,20,12,8,2,1
0,401,401,2,2,0,1,0
17,442,442,111,111,0,1,0
18,443,443,46,46,0,1,0
5,446,446,9,3,6,2,1
7,453,453,9,9,0,1,0
27,461,461,18,18,0,1,0

11,106,106,1,1,0,1,0
7,123,123,6,6,0,1,0
14,123,123,8,8,0,1,0
16,150,150,14,14,0,1,0
27,165,165,32,32,0,1,0
31,193,193,49,49,0,1,0
2,205,205,11,11,0,1,0
8,210,210,2,2,0,1,0
4,224,224,18,9,9,4,3
1,237,237,19,19,0,1,0
13,238,238,41,41,0,1,0
3,245,245,2,2,0,1,0
0,276,276,6,1,5,2,1
20,283,283,13,4,9,4,3
25,317,317,4,4,0,1,0
15,318,318,1,1,0,1,0
12,325,325,7,7,0,1,0
24,329,329,29,29,0,1,0
22,333,333,26,10,16,2,1
29,341,341,15,12,3,2,1
30,345,345,57,24,33,4,3
23,346,346,33,33,0,1,0
5,352,352,4,4,0,1,0
26,363,363,2,2,0,1,0
21,374,374,43,26,17,2,1
10,385,385,7,7,0,1,0
9,389,389,7,7,0,1,0
17,396,396,53,5,48,4,3
18,398,398,1,1,0,1,0
19,454,454,112,112,0,1,0
28,455,455,56,56,0,1,0
6,467,467,48,29,19,2,1

18,105,105,3,3,0,1,0
15,121,121,19,10,9,2,1
6,124,124,9,9,0,1,0
14,147,147,6,6,0,1,0
2,156,156,7,4,3,2,1
20,169,169,23,23,0,1,0
13,203,203,13,1,12,3,2
17,216,216,11,11,0,1,0
8,220,220,1,1,0,1,0
11,276,276,92,75,17,2,1
21,299,299,2,2,0,1,0
4,309,309,45,45,0,1,0
10,343,343,41,41,0,1,0
7,370,370,13,13,0,1,0
19,377,377,63,63,0,1,0
12,402,402,7,2,5,2,1
3,414,414,114,94,20,3,2
16,428,428,48,48,0,1,0
0,439,439,73,73,0,1,0
5,440,440,64,36,28,3,2
1,444,444,74,2,72,3,2
9,481,481,70,70,0,1,0

17,102,102,24,24,0,1,0
11,116,116,26,9,17,4,3
8,131,131,1,1,0,1,0
1,149,149,3,3,0,1,0
4,149,149,1,1,0,1,0
26,164,164,6,3,3,2,1
19,185,185,23,7,16,4,3
27,241,241,32,32,0,1,0
14,249,249,29,5,24,2,1
15,249,249,5,5,0,1,0
2,307,307,1,1,0,1,0
5,327,327,55,55,0,1,0
13,347,347,20,6,14,4,3
20,349,349,23,23,0,1,0
12,351,351,28,28,0,1,0
23,351,351,36,36,0,1,0
7,391,391,41,2,39,3,2
9,393,393,1,1,0,1,0
21,431,431,184,46,138,4,3
10,442,442,5,2,3,2,1
3,446,446,11,11,0,1,0
16,459,459,3,3,0,1,0
18,463,463,5,5,0,1,0
22,467,467,17,17,0,1,0
0,471,471,166,150,16,3,2
25,474,474,7,7,0,1,0
6,487,487,1,1,0,1,0
24,499,499,15,15,0,1,0

3,110,110,1,1,0,1,0
13,115,115,7,2,5,2,1
10,125,125,9,9,0,1,0
11,161,161,1,1,0,1,0
2,166,166,3,3,0,1,0
23,168,168,41,41,0,1,0
4,194,194,10,10,0,1,0
26,209,209,6,3,3,2,1
27,216,216,13,8,5,2,1
20,236,236,6,6,0,1,0
15,239,239,60,27,33,4,3
6,243,243,10,2,8,2,1
24,255,255,5,1,4,2,1
30,266,266,26,26,0,1,0
25,268,268,8,8,0,1,0
8,280,280,10,6,4,2,1
7,282,282,23,6,17,2,1
28,315,315,19,5,14,2,1
16,328,328,39,39,0,1,0
17,335,335,15,15,0,1,0
29,341,341,8,8,0,1,0
9,346,346,19,19,0,1,0
19,368,368,8,8,0,1,0
12,383,383,10,10,0,1,0
14,433,433,62,56,6,3,2
5,438,438,27,27,0,1,0
18,446,446,4,4,0,1,0
21,455,455,166,103,63,4,3
1,455,455,34,34,0,1,0
22,476,476,16,12,4,2,1
31,479,479,111,67,44,2,1
0,491,491,9,3,6,3,2

11,102,102,17,4,13,4,3
1,130,130,30,12,18,3,2
22,158,158,3,3,0,1,0
8,161,161,25,6,19,2,1
14,203,203,5,5,0,1,0
0,228,228,22,22,0,1,0
20,256,256,11,11,0,1,0
15,270,270,58,2,56,4,3
16,300,300,11,11,0,1,0
23,304,304,65,26,39,2,1
9,334,334,53,53,0,1,0
13,335,335,13,1,12,4,3
12,355,355,6,6,0,1,0
7,369,369,66,66,0,1,0
3,389,389,34,34,0,1,0
10,410,410,20,20,0,1,0
18,419,419,110,110,0,1,0
2,444,444,4,4,0,1,0
6,447,447,14,14,0,1,0
17,450,450,69,34,35,2,1
5,463,463,10,10,0,1,0
21,470,470,46,46,0,1,0
19,489,489,46,46,0,1,0
4,492,492,12,12,0,1,0

16,103,103,20,17,3,2,1
15,105,105,7,1,6,2,1
24,109,109,30,11,19,2,1
8,113,113,1,1,0,1,0
27,113,113,3,3,0,1,0
6,114,114,9,9,0,1,0
26,136,136,11,11,0,1,0
25,159,159,16,7,9,4,3
18,161,161,20,10,10,2,1
14,186,186,15,15,0,1,0
13,188,188,1,1,0,1,0
23,203,203,28,28,0,1,0
20,242,242,11,11,0,1,0
22,279,279,41,41,0,1,0
0,279,279,43,43,0,1,0
12,284,284,25,12,13,2,1
3,295,295,18,18,0,1,0
2,299,299,14,14,0,1,0
17,303,303,12,9,3,2,1
19,334,334,17,9,8,3,2
4,397,397,41,41,0,1,0
7,406,406,76,76,0,1,0
10,436,436,19,19,0,1,0
1,437,437,11,11,0,1,0
9,449,449,29,14,15,2,1
5,450,450,41,41,0,1,0
11,453,453,47,47,0,1,0
21,455,455,6,6,0,1,0

17,105,105,17,5,12,3,2
15,108,108,9,3,6,2,1
10,111,111,6,6,0,1,0
6,113,113,16,10,6,2,1
5,118,118,25,1,24,4,3
23,122,122,20,3,17,2,1
9,128,128,5,5,0,1,0
1,143,143,9,2,7,2,1
12,150,150,6,6,0,1,0
11,158,158,40,40,0,1,0
18,210,210,39,24,15,4,3
22,214,214,39,39,0,1,0
3,215,215,1,1,0,1,0
7,220,220,4,4,0,1,0
20,270,270,6,6,0,1,0
19,275,275,18,18,0,1,0
13,292,292,11,11,0,1,0
16,328,328,16,16,0,1,0
4,359,359,51,51,0,1,0
14,361,361,16,16,0,1,0
0,417,417,16,16,0,1,0
8,423,423,28,16,12,2,1
24,439,439,17,17,0,1,0
21,462,462,92,30,62,3,2
2,492,492,63,63,0,1,0

8,104,104,16,13,3,2,1
10,107,107,13,5,8,3,2
11,143,143,12,12,0,1,0
17,148,148,15,15,0,1,0
16,155,155,11,5,6,2,1
7,171,171,23,14,9,4,3
19,232,232,86,38,48,4,3
13,239,239,17,17,0,1,0
2,297,297,26,17,9,2,1
14,319,319,8,8,0,1,0
5,330,330,32,32,0,1,0
1,357,357,26,15,11,2,1
18,371,371,47,37,10,3,2
12,381,381,81,15,66,4,3
6,392,392,47,47,0,1,0
0,404,404,86,26,60,4,3
9,416,416,17,2,15,2,1
3,424,424,128,35,93,3,2
15,433,433,1,1,0,1,0
20,481,481,2,2,0,1,0
4,484,484,12,12,0,1,0

6,112,112,4,1,3,2,1
7,121,121,42,19,23,2,1
19,206,206,7,2,5,2,1
17,211,211,1,1,0,1,0
14,223,223,25,11,14,2,1
2,241,241,38,34,4,2,1
13,264,264,42,42,0,1,0
3,310,310,29,29,0,1,0
1,329,329,24,18,6,3,2
0,368,368,135,81,54,4,3
12,373,373,4,4,0,1,0
4,375,375,41,7,34,2,1
18,383,383,9,9,0,1,0
16,385,385,94,94,0,1,0
5,394,394,9,9,0,1,0
8,411,411,11,8,3,2,1
9,431,431,101,35,66,4,3
15,437,437,9,6,3,2,1
11,470,470,136,96,40,3,2
10,480,480,29,25,4,2,1

17,145,145,39,31,8,2,1
4,157,157,40,40,0,1,0
15,181,181,12,12,0,1,0
10,185,185,15,15,0,1,0
6,207,207,7,4,3,2,1
5,214,214,39,21,18,4,3
9,268,268,74,74,0,1,0
12,284,284,41,33,8,2,1
7,301,301,114,111,3,2,1
1,315,315,30,30,0,1,0
13,321,321,35,35,0,1,0
19,322,322,1,1,0,1,0
2,392,392,23,23,0,1,0
8,416,416,5,5,0,1,0
3,426,426,51,12,39,4,3
16,429,429,7,1,6,3,2
18,439,439,37,5,32,3,2
0,440,440,34,34,0,1,0
11,452,452,45,15,30,3,2
14,470,470,29,2,27,4,3

2,106,106,31,4,27,2,1
15,109,109,8,4,4,2,1
8,117,117,9,9,0,1,0
5,125,125,15,15,0,1,0
18,140,140,23,1,22,3,2
13,145,145,3,3,0,1,0
14,147,147,16,16,0,1,0
21,160,160,16,16,0,1,0
16,171,171,7,7,0,1,0
17,190,190,61,20,41,2,1
10,233,233,27,27,0,1,0
4,248,248,23,23,0,1,0
20,265,265,29,17,12,4,3
12,308,308,7,2,5,2,1
11,313,313,17,3,14,2,1
3,325,325,31,9,22,3,2
19,346,346,37,37,0,1,0
6,365,365,49,49,0,1,0
1,371,371,78,78,0,1,0
7,385,385,16,16,0,1,0
9,437,437,50,19,31,2,1
0,443,443,10,10,0,1,0

0,135,135,4,4,0,1,0
23,149,149,20,20,0,1,0
7,177,177,4,4,0,1,0
14,194,194,4,1,3,2,1
2,197,197,41,25,16,2,1
4,212,212,6,3,3,2,1
10,243,243,14,2,12,4,3
17,248,248,12,2,10,3,2
3,256,256,22,22,0,1,0
9,266,266,56,56,0,1,0
11,268,268,50,24,26,2,1
6,278,278,32,32,0,1,0
22,292,292,54,54,0,1,0
18,306,306,42,42,0,1,0
20,323,323,29,1,28,3,2
8,345,345,70,35,35,2,1
12,348,348,26,2,24,3,2
15,359,359,57,20,37,4,3
19,386,386,75,27,48,2,1
16,412,412,13,1,12,2,1
1,423,423,13,2,11,2,1
5,440,440,11,11,0,1,0
21,440,440,35,35,0,1,0
13,497,497,32,11,21,2,1

17,112,112,14,14,0,1,0
21,139,139,9,5,4,2,1
19,145,145,11,11,0,1,0
5,194,194,5,5,0,1,0
18,220,220,12,12,0,1,0
1,225,225,1,1,0,1,0
10,233,233,22,22,0,1,0
9,237,237,12,5,7,2,1
8,260,260,32,9,23,3,2
6,275,275,82,82,0,1,0
14,298,298,3,3,0,1,0
20,314,314,8,8,0,1,0
11,346,346,41,2,39,2,1
3,375,375,5,5,0,1,0
4,375,375,13,8,5,2,1
15,378,378,82,82,0,1,0
25,380,380,41,11,30,3,2
24,406,406,105,45,60,4,3
26,412,412,4,4,0,1,0
7,419,419,13,13,0,1,0
23,423,423,97,11,86,3,2
22,426,426,13,13,0,1,0
16,431,431,8,8,0,1,0
0,439,439,64,64,0,1,0
12,446,446,27,27,0,1,0
13,466,466,20,7,13,2,1
2,494,494,73,11,62,3,2

31,103,103,16,4,12,2,1
5,111,111,26,3,23,4,3
17,116,116,6,1,5,2,1
19,132,132,2,2,0,1,0
24,142,142,17,17,0,1,0
8,146,146,4,1,3,2,1
0,157,157,13,13,0,1,0
15,174,174,28,14,14,3,2
13,177,177,14,9,5,2,1
6,202,202,31,25,6,2,1
26,234,234,43,43,0,1,0
18,248,248,5,1,4,2,1
11,255,255,13,6,7,2,1
12,275,275,2,2,0,1,0
20,275,275,1,1,0,1,0
23,295,295,12,3,9,2,1
4,317,317,1,1,0,1,0
3,329,329,32,14,18,2,1
29,334,334,8,8,0,1,0
27,340,340,6,6,0,1,0
2,364,364,32,32,0,1,0
10,381,381,7,1,6,3,2
16,384,384,4,4,0,1,0
28,387,387,14,2,12,4,3
21,403,403,26,2,24,4,3
1,403,403,1,1,0,1,0
30,406,406,162,36,126,4,3
25,408,408,21,12,9,4,3
22,412,412,53,53,0,1,0
7,430,430,3,3,0,1,0
14,450,450,11,11,0,1,0
9,463,463,33,5,28,4,3

13,101,101,20,6,14,3,2
11,129,129,10,10,0,1,0
18,154,154,41,3,38,2,1
0,159,159,19,7,12,4,3
22,197,197,2,2,0,1,0
19,201,201,21,21,0,1,0
24,202,202,8,8,0,1,0
1,213,213,16,16,0,1,0
7,213,213,31,31,0,1,0
2,232,232,30,30,0,1,0
5,269,269,59,59,0,1,0
10,330,330,18,3,15,2,1
4,335,335,1,1,0,1,0
14,363,363,14,14,0,1,0
8,409,409,12,12,0,1,0
9,411,411,23,6,17,3,2
23,424,424,57,30,27,2,1
17,433,433,27,19,8,2,1
3,434,434,30,30,0,1,0
6,442,442,79,65,14,2,1
20,457,457,6,3,3,2,1
12,464,464,20,3,17,2,1
16,473,473,29,29,0,1,0
15,486,486,106,76,30,3,2
21,487,487,39,11,28,3,2

20,115,115,5,5,0,1,0
15,139,139,25,21,4,2,1
8,142,142,12,4,8,3,2
6,164,164,3,3,0,1,0
5,166,166,22,22,0,1,0
22,173,173,7,7,0,1,0
2,216,216,35,35,0,1,0
16,245,245,5,5,0,1,0
13,272,272,16,4,12,4,3
19,282,282,48,27,21,2,1
14,289,289,51,21,30,4,3
17,291,291,43,43,0,1,0
7,294,294,73,17,56,4,3
11,295,295,11,11,0,1,0
3,298,298,6,3,3,2,1
1,301,301,76,28,48,3,2
9,375,375,2,2,0,1,0
21,391,391,2,2,0,1,0
4,405,405,2,2,0,1,0
12,458,458,42,42,0,1,0
0,472,472,32,10,22,3,2
10,500,500,102,94,8,3,2
18,500,500,127,127,0,1,0

16,111,111,1,1,0,1,0
4,129,129,11,11,0,1,0
20,144,144,6,3,3,2,1
8,157,157,6,6,0,1,0
19,158,158,88,80,8,2,1
10,160,160,20,20,0,1,0
24,177,177,7,3,4,2,1
23,188,188,6,2,4,2,1
5,229,229,5,5,0,1,0
21,233,233,35,35,0,1,0
15,244,244,5,5,0,1,0
13,258,258,23,18,5,2,1
11,258,258,6,1,5,2,1
1,264,264,2,2,0,1,0
17,266,266,43,43,0,1,0
14,298,298,9,3,6,3,2
18,320,320,11,11,0,1,0
25,343,343,39,39,0,1,0
9,343,343,26,26,0,1,0
2,352,352,18,18,0,1,0
6,368,368,26,26,0,1,0
0,372,372,28,28,0,1,0
12,414,414,68,62,6,3,2
22,432,432,20,20,0,1,0
7,446,446,160,13,147,4,3
3,467,467,7,7,0,1,0

5,127,127,7,7,0,1,0
6,130,130,2,2,0,1,0
13,154,154,30,17,13,2,1
16,159,159,2,2,0,1,0
7,165,165,3,3,0,1,0
18,168,168,16,16,0,1,0
3,190,190,8,5,3,2,1
9,207,207,33,5,28,2,1
27,210,210,8,8,0,1,0
4,221,221,8,8,0,1,0
26,228,228,8,8,0,1,0
28,232,232,44,31,13,2,1
20,267,267,32,32,0,1,0
24,270,270,20,20,0,1,0
12,285,285,20,10,10,2,1
17,298,298,82,82,0,1,0
11,306,306,14,9,5,2,1
2,320,320,1,1,0,1,0
1,324,324,54,54,0,1,0
25,359,359,12,12,0,1,0
23,371,371,38,38,0,1,0
21,373,373,32,32,0,1,0
8,387,387,11,11,0,1,0
0,394,394,27,11,16,3,2
19,424,424,42,42,0,1,0
10,431,431,5,1,4,2,1
22,467,467,35,35,0,1,0
14,484,484,42,42,0,1,0
15,498,498,95,1,94,3,2

2,133,133,1,1,0,1,0
0,143,143,20,9,11,2,1
5,171,171,1,1,0,1,0
14,190,190,34,34,0,1,0
21,203,203,32,32,0,1,0
11,210,210,27,27,0,1,0
16,210,210,1,1,0,1,0
17,232,232,17,17,0,1,0
7,237,237,34,34,0,1,0
9,239,239,20,12,8,3,2
20,243,243,16,4,12,2,1
8,284,284,5,5,0,1,0
3,305,305,62,10,52,3,2
15,312,312,17,17,0,1,0
10,323,323,1,1,0,1,0
6,365,365,34,34,0,1,0
13,391,391,39,39,0,1,0
19,401,401,81,59,22,3,2
22,419,419,40,40,0,1,0
4,420,420,52,52,0,1,0
24,430,430,28,12,16,2,1
18,439,439,63,63,0,1,0
23,450,450,35,35,0,1,0
1,491,491,70,10,60,3,2
12,499,499,54,46,8,3,2

6,103,103,4,4,0,1,0
5,125,125,28,28,0,1,0
24,129,129,12,12,0,1,0
8,133,133,2,2,0,1,0
10,141,141,1,1,0,1,0
11,207,207,10,3,7,2,1
4,212,212,33,33,0,1,0
0,240,240,22,22,0,1,0
12,249,249,43,43,0,1,0
14,265,265,22,22,0,1,0
17,283,283,70,26,44,2,1
3,324,324,26,26,0,1,0
13,386,386,41,3,38,4,3
1,424,424,5,1,4,2,1
23,425,425,90,27,63,4,3
20,428,428,12,2,10,3,2
19,431,431,16,16,0,1,0
21,432,432,17,2,15,4,3
7,445,445,52,11,41,3,2
22,456,456,37,37,0,1,0
9,456,456,1,1,0,1,0
25,465,465,89,8,81,4,3
2,468,468,61,18,43,2,1
18,482,482,64,17,47,2,1
16,486,486,17,5,12,2,1
15,497,497,18,3,15,2,1

24,107,107,10,4,6,3,2
5,117,117,6,1,5,2,1
10,171,171,2,2,0,1,0
17,191,191,9,4,5,2,1
6,193,193,2,2,0,1,0
16,202,202,30,30,0,1,0
9,221,221,16,7,9,4,3
13,250,250,28,28,0,1,0
27,279,279,37,6,31,2,1
21,302,302,16,16,0,1,0
0,312,312,42,33,9,4,3
19,322,322,17,5,12,3,2
2,325,325,1,1,0,1,0
12,331,331,8,8,0,1,0
4,333,333,13,13,0,1,0
3,335,335,31,31,0,1,0
11,341,341,3,3,0,1,0
18,346,346,65,30,35,2,1
15,362,362,32,32,0,1,0
1,393,393,57,57,0,1,0
22,412,412,62,26,36,4,3
25,428,428,24,15,9,4,3
14,432,432,62,21,41,2,1
26,464,464,7,7,0,1,0
20,465,465,43,43,0,1,0
8,480,480,74,74,0,1,0
7,489,489,54,21,33,2,1
23,496,496,93,93,0,1,0

14,112,112,4,4,0,1,0
4,117,117,21,21,0,1,0
13,119,119,5,5,0,1,0
8,124,124,41,41,0,1,0
7,128,128,6,2,4,2,1
18,134,134,5,5,0,1,0
10,161,161,7,1,6,2,1
22,173,173,79,79,0,1,0
17,186,186,27,27,0,1,0
21,195,195,27,1,26,3,2
12,198,198,4,4,0,1,0
3,232,232,23,19,4,2,1
6,251,251,14,2,12,2,1
9,270,270,21,21,0,1,0
1,288,288,8,8,0,1,0
2,296,296,24,24,0,1,0
15,315,315,61,33,28,2,1
20,321,321,1,1,0,1,0
5,358,358,6,6,0,1,0
0,366,366,42,42,0,1,0
24,376,376,17,3,14,3,2
16,406,406,28,8,20,3,2
23,409,409,23,23,0,1,0
19,445,445,3,3,0,1,0
11,451,451,48,48,0,1,0

6,117,117,7,1,6,3,2
7,122,122,14,11,3,2,1
8,123,123,30,2,28,3,2
3,165,165,2,2,0,1,0
21,167,167,53,53,0,1,0
16,181,181,18,3,15,4,3
20,193,193,5,5,0,1,0
4,218,218,58,58,0,1,0
1,239,239,14,14,0,1,0
14,262,262,27,19,8,2,1
11,300,300,29,26,3,2,1
13,308,308,28,28,0,1,0
2,316,316,67,67,0,1,0
22,335,335,50,50,0,1,0
15,371,371,41,41,0,1,0
17,376,376,41,41,0,1,0
18,389,389,10,10,0,1,0
12,400,400,25,13,12,4,3
9,423,423,17,1,16,4,3
10,459,459,20,16,4,2,1
19,459,459,14,14,0,1,0
5,466,466,19,19,0,1,0
0,500,500,55,37,18,3,2

8,109,109,6,6,0,1,0
6,115,115,47,47,0,1,0
19,120,120,7,7,0,1,0
3,144,144,32,29,3,2,1
17,147,147,2,2,0,1,0
13,169,169,1,1,0,1,0
5,175,175,12,3,9,4,3
12,200,200,5,5,0,1,0
15,260,260,32,11,21,4,3
9,268,268,31,21,10,4,3
1,276,276,54,12,42,2,1
18,331,331,119,67,52,3,2
7,380,380,46,46,0,1,0
4,423,423,3,3,0,1,0
10,427,427,47,47,0,1,0
16,452,452,21,21,0,1,0
2,454,454,10,10,0,1,0
0,459,459,46,46,0,1,0
14,474,474,79,79,0,1,0
20,482,482,26,14,12,4,3
11,497,497,74,10,64,3,2

8,155,155,9,9,0,1,0
13,163,163,6,1,5,2,1
11,163,163,62,32,30,3,2
9,219,219,11,11,0,1,0
12,257,257,2,2,0,1,0
16,273,273,63,63,0,1,0
4,291,291,166,93,73,4,3
0,350,350,25,25,0,1,0
3,369,369,16,12,4,2,1
10,385,385,15,9,6,2,1
15,398,398,25,2,23,4,3
18,413,413,34,9,25,3,2
5,447,447,19,10,9,4,3
14,454,454,82,37,45,4,3
6,457,457,124,124,0,1,0
2,458,458,80,32,48,4,3
17,478,478,16,5,11,2,1
1,481,481,13,13,0,1,0
7,498,498,29,5,24,2,1

5,110,110,19,5,14,2,1
13,124,124,14,7,7,2,1
4,128,128,24,24,0,1,0
23,138,138,4,4,0,1,0
14,162,162,4,4,0,1,0
10,166,166,17,7,10,2,1
19,170,170,5,5,0,1,0
6,173,173,1,1,0,1,0
8,208,208,34,16,18,4,3
1,210,210,19,4,15,3,2
12,231,231,84,84,0,1,0
11,232,232,10,10,0,1,0
16,258,258,17,17,0,1,0
3,259,259,58,26,32,2,1
17,259,259,2,2,0,1,0
18,316,316,7,7,0,1,0
21,321,321,19,19,0,1,0
20,341,341,83,83,0,1,0
15,392,392,55,8,47,2,1
0,406,406,23,23,0,1,0
7,415,415,5,5,0,1,0
22,425,425,57,53,4,2,1
9,442,442,11,11,0,1,0
2,457,457,54,54,0,1,0

24,112,112,4,1,3,2,1
10,135,135,15,1,14,3,2
6,154,154,11,3,8,2,1
8,155,155,1,1,0,1,0
7,180,180,16,3,13,2,1
13,201,201,28,28,0,1,0
22,201,201,54,54,0,1,0
28,224,224,15,1,14,2,1
17,256,256,46,11,35,2,1
25,259,259,14,14,0,1,0
20,273,273,17,17,0,1,0
18,280,280,14,2,12,2,1
19,294,294,3,3,0,1,0
27,301,301,7,7,0,1,0
23,307,307,21,21,0,1,0
12,326,326,1,1,0,1,0
21,334,334,7,7,0,1,0
30,346,346,23,11,12,2,1
11,347,347,15,7,8,2,1
4,372,372,12,12,0,1,0
29,377,377,3,3,0,1,0
26,383,383,10,10,0,1,0
16,397,397,4,4,0,1,0
14,402,402,4,4,0,1,0
1,410,410,1,1,0,1,0
9,420,420,21,1,20,2,1
0,427,427,17,17,0,1,0
5,431,431,1,1,0,1,0
15,447,447,101,77,24,3,2
31,449,449,49,49,0,1,0
2,462,462,13,6,7,2,1
3,473,473,17,17,0,1,0
32,486,486,229,229,0,1,0

17,119,119,19,19,0,1,0
6,147,147,5,5,0,1,0
9,153,153,41,18,23,2,1
19,171,171,3,3,0,1,0
1,172,172,20,14,6,2,1
23,179,179,14,14,0,1,0
12,200,200,48,48,0,1,0
21,201,201,9,2,7,2,1
7,215,215,14,14,0,1,0
13,255,255,1,1,0,1,0
16,315,315,94,65,29,2,1
8,321,321,2,2,0,1,0
10,338,338,46,46,0,1,0
20,373,373,6,6,0,1,0
11,391,391,34,34,0,1,0
5,395,395,1,1,0,1,0
14,409,409,52,14,38,3,2
4,409,409,85,15,70,3,2
2,430,430,62,41,21,4,3
0,443,443,23,23,0,1,0
22,457,457,44,44,0,1,0
3,468,468,39,39,0,1,0
18,469,469,58,30,28,3,2
15,485,485,7,7,0,1,0

13,116,116,8,4,4,2,1
21,117,117,28,28,0,1,0
17,181,181,5,2,3,2,1
16,199,199,29,29,0,1,0
7,203,203,1,1,0,1,0
19,235,235,25,25,0,1,0
5,237,237,8,8,0,1,0
12,237,237,13,13,0,1,0
22,254,254,10,10,0,1,0
23,276,276,24,14,10,2,1
6,291,291,28,22,6,2,1
4,305,305,2,2,0,1,0
10,307,307,4,4,0,1,0
8,337,337,31,19,12,4,3
18,379,379,11,11,0,1,0
9,391,391,18,8,10,3,2
2,399,399,108,42,66,4,3
0,399,399,39,2,37,2,1
1,417,417,124,97,27,4,3
20,420,420,22,22,0,1,0
3,433,433,24,24,0,1,0
15,444,444,90,90,0,1,0
14,450,450,75,21,54,4,3
11,483,483,90,90,0,1,0

6,104,104,14,14,0,1,0
16,113,113,29,5,24,3,2
7,125,125,8,8,0,1,0
10,150,150,18,1,17,2,1
5,203,203,8,8,0,1,0
20,214,214,31,9,22,3,2
23,238,238,9,5,4,2,1
19,247,247,13,7,6,3,2
9,273,273,26,26,0,1,0
17,284,284,35,26,9,4,3
4,299,299,2,2,0,1,0
12,311,311,49,30,19,4,3
1,314,314,40,5,35,4,3
13,353,353,7,7,0,1,0
22,411,411,78,10,68,3,2
15,418,418,9,6,3,2,1
0,419,419,39,39,0,1,0
3,433,433,4,4,0,1,0
14,434,434,76,46,30,4,3
2,452,452,65,65,0,1,0
8,467,467,75,75,0,1,0
21,468,468,30,20,10,2,1
11,472,472,23,23,0,1,0
18,477,477,8,8,0,1,0
24,479,479,56,56,0,1,0

7,109,109,18,18,0,1,0
1,119,119,14,6,8,3,2
0,123,123,18,18,0,1,0
13,134,134,5,5,0,1,0
8,141,141,34,34,0,1,0
6,181,181,19,2,17,2,1
3,198,198,36,6,30,3,2
11,205,205,18,6,12,3,2
16,227,227,18,14,4,2,1
19,251,251,47,17,30,3,2
2,270,270,21,12,9,4,3
12,281,281,35,35,0,1,0
20,297,297,9,1,8,3,2
4,303,303,9,1,8,3,2
21,353,353,42,16,26,3,2
18,368,368,37,37,0,1,0
15,405,405,30,21,9,4,3
10,412,412,83,20,63,4,3
14,419,419,9,3,6,3,2
5,427,427,2,2,0,1,0
9,433,433,57,33,24,3,2
17,476,476,76,28,48,4,3

15,131,131,1,1,0,1,0
19,141,141,26,4,22,3,2
3,154,154,25,5,20,3,2
6,166,166,12,4,8,3,2
2,168,168,1,1,0,1,0
5,169,169,1,1,0,1,0
8,194,194,6,6,0,1,0
25,198,198,10,1,9,4,3
22,205,205,1,1,0,1,0
21,227,227,40,1,39,3,2
13,252,252,1,1,0,1,0
11,254,254,73,73,0,1,0
14,255,255,13,1,12,4,3
18,259,259,67,67,0,1,0
23,260,260,12,2,10,2,1
17,288,288,9,9,0,1,0
4,306,306,18,18,0,1,0
16,332,332,10,10,0,1,0
1,350,350,2,2,0,1,0
24,369,369,108,108,0,1,0
7,399,399,54,14,40,3,2
10,409,409,20,20,0,1,0
9,424,424,72,36,36,3,2
12,428,428,51,5,46,3,2
20,455,455,42,15,27,4,3
0,494,494,47,47,0,1,0

22,113,113,2,2,0,1,0
18,124,124,14,14,0,1,0
21,152,152,38,38,0,1,0
5,188,188,9,9,0,1,0
24,236,236,7,7,0,1,0
15,272,272,19,10,9,4,3
4,305,305,6,6,0,1,0
7,308,308,23,5,18,3,2
13,319,319,15,15,0,1,0
3,323,323,67,52,15,4,3
8,331,331,1,1,0,1,0
23,338,338,33,3,30,4,3
12,344,344,58,58,0,1,0
14,365,365,138,130,8,3,2
2,383,383,18,18,0,1,0
6,391,391,43,19,24,2,1
1,396,396,15,2,13,3,2
17,414,414,43,43,0,1,0
16,419,419,5,5,0,1,0
0,419,419,21,6,15,2,1
9,444,444,46,46,0,1,0
10,457,457,100,100,0,1,0
20,458,458,15,5,10,3,2
19,464,464,34,3,31,2,1
11,489,489,55,4,51,4,3

17,125,125,8,8,0,1,0
22,159,159,12,1,11,2,1
11,169,169,3,3,0,1,0
15,175,175,59,59,0,1,0
8,176,176,29,8,21,4,3
13,177,177,10,10,0,1,0
23,233,233,15,3,12,3,2
2,261,261,23,5,18,4,3
21,264,264,35,5,30,4,3
7,273,273,1,1,0,1,0
3,325,325,25,7,18,3,2
16,329,329,3,3,0,1,0
9,368,368,89,23,66,4,3
12,381,381,62,62,0,1,0
5,394,394,37,11,26,4,3
20,397,397,50,50,0,1,0
0,403,403,5,5,0,1,0
14,404,404,71,71,0,1,0
1,416,416,15,3,12,3,2
4,423,423,33,6,27,3,2
24,430,430,13,13,0,1,0
10,435,435,11,3,8,3,2
6,467,467,93,52,41,2,1
18,472,472,3,3,0,1,0
19,497,497,73,73,0,1,0

10,105,105,11,5,6,2,1
13,107,107,5,5,0,1,0
22,130,130,15,3,12,3,2
2,151,151,10,10,0,1,0
18,157,157,9,9,0,1,0
16,158,158,11,3,8,2,1
19,163,163,3,3,0,1,0
6,171,171,1,1,0,1,0
20,190,190,3,3,0,1,0
17,229,229,26,4,22,4,3
23,246,246,2,2,0,1,0
11,263,263,58,37,21,4,3
9,273,273,24,24,0,1,0
7,282,282,36,36,0,1,0
4,289,289,69,27,42,2,1
15,291,291,70,37,33,2,1
21,296,296,12,2,10,3,2
0,320,320,31,1,30,2,1
8,368,368,11,11,0,1,0
24,377,377,99,3,96,3,2
1,397,397,29,23,6,2,1
5,419,419,10,10,0,1,0
12,472,472,55,24,31,2,1
3,485,485,4,4,0,1,0
14,495,495,119,59,60,4,3

5,108,108,30,27,3,2,1
8,113,113,9,9,0,1,0
22,116,116,12,12,0,1,0
1,154,154,11,1,10,2,1
13,157,157,12,12,0,1,0
11,163,163,29,21,8,3,2
4,164,164,12,12,0,1,0
0,166,166,11,11,0,1,0
27,175,175,6,6,0,1,0
7,203,203,2,2,0,1,0
10,234,234,12,12,0,1,0
23,270,270,23,11,12,3,2
3,284,284,3,3,0,1,0
14,288,288,8,8,0,1,0
15,299,299,1,1,0,1,0
26,303,303,12,12,0,1,0
28,304,304,2,2,0,1,0
18,317,317,9,9,0,1,0
2,321,321,22,22,0,1,0
6,372,372,33,33,0,1,0
19,395,395,9,3,6,2,1
20,395,395,165,134,31,2,1
16,406,406,18,18,0,1,0
9,421,421,30,30,0,1,0
17,425,425,26,16,10,2,1
25,443,443,81,81,0,1,0
21,456,456,109,95,14,3,2
12,466,466,1,1,0,1,0
24,475,475,1,1,0,1,0

21,105,105,8,8,0,1,0
14,109,109,15,15,0,1,0
22,113,113,7,7,0,1,0
7,121,121,12,4,8,2,1
6,148,148,56,33,23,2,1
16,148,148,3,3,0,1,0
12,149,149,13,13,0,1,0
5,181,181,6,1,5,2,1
17,198,198,22,22,0,1,0
8,202,202,1,1,0,1,0
18,206,206,19,19,0,1,0
9,243,243,35,19,16,3,2
15,280,280,79,17,62,3,2
11,284,284,14,8,6,2,1
19,290,290,5,5,0,1,0
1,332,332,33,7,26,3,2
20,332,332,73,73,0,1,0
3,349,349,19,19,0,1,0
4,379,379,22,22,0,1,0
0,408,408,48,25,23,2,1
2,410,410,63,27,36,3,2
13,419,419,34,3,31,2,1
10,452,452,26,26,0,1,0

17,107,107,3,3,0,1,0
15,159,159,35,35,0,1,0
3,186,186,13,13,0,1,0
1,190,190,8,5,3,2,1
5,237,237,59,59,0,1,0
8,238,238,1,1,0,1,0
11,263,263,11,8,3,2,1
18,273,273,16,1,15,2,1
21,290,290,25,25,0,1,0
12,295,295,1,1,0,1,0
19,330,330,6,1,5,2,1
20,333,333,34,7,27,4,3
16,352,352,133,73,60,3,2
10,358,358,12,2,10,2,1
0,371,371,2,2,0,1,0
2,401,401,106,30,76,3,2
9,408,408,90,69,21,2,1
6,408,408,43,11,32,3,2
4,449,449,63,63,0,1,0
13,449,449,66,42,24,4,3
7,488,488,49,9,40,2,1
14,499,499,52,4,48,3,2

21,101,101,10,2,8,3,2
4,105,105,11,1,10,3,2
22,110,110,4,4,0,1,0
5,129,129,3,3,0,1,0
13,158,158,4,4,0,1,0
15,171,171,9,9,0,1,0
29,214,214,11,11,0,1,0
3,239,239,16,16,0,1,0
7,244,244,8,8,0,1,0
0,277,277,10,10,0,1,0
26,283,283,10,10,0,1,0
2,296,296,97,55,42,3,2
6,302,302,36,36,0,1,0
16,322,322,4,4,0,1,0
9,333,333,1,1,0,1,0
31,334,334,37,37,0,1,0
10,345,345,6,6,0,1,0
23,353,353,34,25,9,4,3
24,377,377,4,1,3,2,1
14,395,395,8,8,0,1,0
8,400,400,19,19,0,1,0
11,405,405,1,1,0,1,0
25,417,417,17,17,0,1,0
18,425,425,16,16,0,1,0
27,445,445,150,83,67,4,3
1,446,446,49,27,22,2,1
12,446,446,3,3,0,1,0
19,449,449,53,53,0,1,0
20,452,452,118,72,46,2,1
28,460,460,1,1,0,1,0
30,489,489,69,11,58,3,2
17,491,491,18,18,0,1,0

23,104,104,16,16,0,1,0
10,118,118,12,12,0,1,0
18,149,149,2,2,0,1,0
1,167,167,5,5,0,1,0
22,180,180,7,7,0,1,0
21,218,218,6,6,0,1,0
19,240,240,16,16,0,1,0
8,245,245,11,11,0,1,0
20,249,249,14,5,9,2,1
24,253,253,31,2,29,2,1
2,261,261,1,1,0,1,0
16,265,265,34,28,6,3,2
12,291,291,19,19,0,1,0
17,310,310,4,4,0,1,0
14,320,320,40,24,16,3,2
4,320,320,13,13,0,1,0
7,372,372,10,2,8,2,1
6,392,392,11,2,9,2,1
9,397,397,52,52,0,1,0
3,402,402,75,57,18,2,1
0,456,456,113,113,0,1,0
13,467,467,206,191,15,4,3
15,484,484,19,1,18,4,3
5,495,495,109,89,20,2,1
11,495,495,37,27,10,2,1

14,100,100,3,3,0,1,0
21,102,102,5,5,0,1,0
13,105,105,12,12,0,1,0
20,107,107,3,3,0,1,0
15,121,121,1,1,0,1,0
19,129,129,13,7,6,3,2
1,164,164,1,1,0,1,0
12,174,174,2,2,0,1,0
2,183,183,19,6,13,2,1
4,183,183,3,3,0,1,0
10,233,233,1,1,0,1,0
22,263,263,39,23,16,2,1
24,268,268,8,8,0,1,0
26,277,277,31,31,0,1,0
16,296,296,13,13,0,1,0
29,298,298,11,1,10,2,1
27,303,303,82,64,18,3,2
23,304,304,100,81,19,2,1
7,308,308,37,9,28,2,1
5,311,311,13,13,0,1,0
3,313,313,1,1,0,1,0
18,330,330,5,5,0,1,0
6,339,339,133,55,78,4,3
25,342,342,19,19,0,1,0
0,355,355,26,2,24,4,3
9,368,368,3,3,0,1,0
11,387,387,1,1,0,1,0
28,433,433,23,23,0,1,0
8,437,437,51,51,0,1,0
17,468,468,49,44,5,2,1

13,108,108,14,2,12,4,3
15,116,116,9,9,0,1,0
19,131,131,20,10,10,3,2
14,200,200,17,17,0,1,0
18,236,236,8,8,0,1,0
5,278,278,2,2,0,1,0
8,291,291,2,2,0,1,0
20,294,294,4,4,0,1,0
16,295,295,39,15,24,4,3
17,296,296,62,50,12,4,3
3,307,307,3,3,0,1,0
10,321,321,4,4,0,1,0
12,338,338,15,6,9,4,3
11,346,346,28,11,17,2,1
0,359,359,220,166,54,4,3
1,363,363,8,8,0,1,0
7,371,371,36,26,10,3,2
4,423,423,57,23,34,4,3
9,438,438,110,39,71,3,2
2,444,444,11,8,3,2,1
6,494,494,141,141,0,1,0

21,101,101,59,5,54,3,2
6,109,109,52,52,0,1,0
4,109,109,7,7,0,1,0
0,116,116,7,7,0,1,0
7,152,152,9,9,0,1,0
13,177,177,8,8,0,1,0
18,185,185,2,2,0,1,0
2,192,192,1,1,0,1,0
17,197,197,1,1,0,1,0
3,205,205,10,10,0,1,0
1,228,228,33,33,0,1,0
10,241,241,9,2,7,2,1
9,241,241,2,2,0,1,0
5,293,293,18,6,12,4,3
19,322,322,9,9,0,1,0
12,325,325,37,37,0,1,0
11,332,332,34,34,0,1,0
15,339,339,81,47,34,3,2
8,373,373,102,102,0,1,0
20,396,396,12,12,0,1,0
16,398,398,11,11,0,1,0
14,456,456,5,5,0,1,0

3,104,104,21,1,20,2,1
7,110,110,17,17,0,1,0
13,117,117,2,2,0,1,0
14,128,128,10,5,5,2,1
11,160,160,2,2,0,1,0
19,186,186,15,15,0,1,0
2,205,205,20,20,0,1,0
5,247,247,22,7,15,3,2
10,257,257,31,15,16,3,2
9,262,262,6,6,0,1,0
17,269,269,3,3,0,1,0
16,342,342,50,20,30,3,2
20,365,365,111,19,92,3,2
15,388,388,91,7,84,4,3
0,423,423,82,82,0,1,0
4,427,427,8,8,0,1,0
12,432,432,10,10,0,1,0
6,442,442,81,81,0,1,0
21,450,450,45,45,0,1,0
1,452,452,67,67,0,1,0
18,468,468,46,26,20,3,2
8,475,475,44,44,0,1,0

0,131,131,5,2,3,2,1
1,147,147,23,11,12,2,1
15,147,147,31,31,0,1,0
5,154,154,2,2,0,1,0
23,166,166,9,9,0,1,0
18,207,207,54,54,0,1,0
24,209,209,3,3,0,1,0
9,223,223,5,5,0,1,0
20,224,224,22,22,0,1,0
11,236,236,66,66,0,1,0
10,258,258,1,1,0,1,0
14,265,265,19,11,8,3,2
8,267,267,11,11,0,1,0
16,308,308,23,23,0,1,0
13,325,325,42,33,9,4,3
4,333,333,39,20,19,2,1
17,366,366,10,10,0,1,0
3,368,368,76,76,0,1,0
21,400,400,32,15,17,2,1
19,405,405,34,12,22,3,2
6,421,421,90,42,48,3,2
22,464,464,58,58,0,1,0
12,470,470,39,21,18,3,2
7,489,489,6,6,0,1,0
2,500,500,7,7,0,1,0

6,111,111,4,4,0,1,0
23,163,163,10,10,0,1,0
22,166,166,19,7,12,4,3
9,175,175,2,2,0,1,0
15,230,230,72,72,0,1,0
11,234,234,56,7,49,2,1
10,248,248,3,3,0,1,0
20,249,249,2,2,0,1,0
12,262,262,62,31,31,2,1
7,271,271,52,14,38,3,2
13,273,273,11,11,0,1,0
21,287,287,41,5,36,4,3
16,288,288,29,29,0,1,0
0,334,334,18,18,0,1,0
24,340,340,100,100,0,1,0
4,383,383,30,30,0,1,0
3,396,396,52,52,0,1,0
5,401,401,38,20,18,3,2
8,404,404,6,1,5,2,1
19,406,406,4,4,0,1,0
18,428,428,43,43,0,1,0
17,441,441,4,4,0,1,0
2,468,468,1,1,0,1,0
14,477,477,18,8,10,2,1
1,488,488,48,25,23,2,1

9,116,116,4,4,0,1,0
10,145,145,17,17,0,1,0
21,149,149,5,1,4,2,1
17,167,167,21,16,5,2,1
16,183,183,75,24,51,4,3
11,224,224,9,9,0,1,0
13,237,237,10,10,0,1,0
6,259,259,19,19,0,1,0
2,268,268,16,16,0,1,0
12,285,285,76,40,36,3,2
0,301,301,13,13,0,1,0
23,321,321,4,4,0,1,0
22,321,321,16,16,0,1,0
25,344,344,47,19,28,3,2
15,347,347,4,4,0,1,0
7,352,352,11,11,0,1,0
5,358,358,2,2,0,1,0
24,362,362,73,65,8,3,2
20,370,370,27,1,26,2,1
14,408,408,59,1,58,3,2
19,414,414,7,7,0,1,0
8,434,434,10,5,5,2,1
4,437,437,6,6,0,1,0
18,438,438,3,3,0,1,0
3,471,471,4,4,0,1,0
1,498,498,221,179,42,3,2

7,103,103,1,1,0,1,0
9,118,118,23,23,0,1,0
16,122,122,13,13,0,1,0
11,142,142,6,6,0,1,0
17,160,160,1,1,0,1,0
15,185,185,27,27,0,1,0
26,196,196,24,5,19,2,1
8,238,238,1,1,0,1,0
10,243,243,28,28,0,1,0
22,260,260,88,88,0,1,0
18,270,270,12,6,6,3,2
12,273,273,38,14,24,4,3
1,290,290,24,24,0,1,0
5,299,299,8,8,0,1,0
24,320,320,12,12,0,1,0
6,321,321,37,15,22,2,1
21,334,334,42,17,25,3,2
25,358,358,75,75,0,1,0
14,373,373,33,33,0,1,0
3,379,379,1,1,0,1,0
0,395,395,27,27,0,1,0
23,403,403,13,4,9,2,1
4,408,408,107,25,82,3,2
19,410,410,15,5,10,2,1
2,459,459,16,16,0,1,0
20,459,459,9,9,0,1,0
13,486,486,7,4,3,2,1

10,102,102,1,1,0,1,0
9,121,121,5,2,3,2,1
23,135,135,22,22,0,1,0
8,148,148,1,1,0,1,0
16,160,160,10,4,6,3,2
14,213,213,4,4,0,1,0
13,225,225,3,3,0,1,0
15,250,250,6,6,0,1,0
1,258,258,42,42,0,1,0
12,294,294,44,44,0,1,0
6,324,324,19,10,9,2,1
5,340,340,17,8,9,4,3
7,346,346,22,22,0,1,0
19,354,354,62,57,5,2,1
2,384,384,107,102,5,2,1
4,386,386,28,28,0,1,0
20,388,388,34,19,15,4,3
11,392,392,61,61,0,1,0
17,409,409,21,21,0,1,0
21,414,414,26,5,21,4,3
3,428,428,92,80,12,2,1
22,442,442,1,1,0,1,0
18,450,450,182,104,78,4,3
0,456,456,39,39,0,1,0

4,102,102,15,15,0,1,0
2,113,113,6,6,0,1,0
12,113,113,4,1,3,2,1
10,122,122,13,7,6,2,1
1,185,185,38,38,0,1,0
3,196,196,7,7,0,1,0
23,202,202,27,27,0,1,0
19,209,209,3,3,0,1,0
11,231,231,7,3,4,2,1
17,239,239,19,19,0,1,0
9,307,307,8,8,0,1,0
14,314,314,18,7,11,2,1
21,335,335,14,5,9,4,3
18,338,338,14,14,0,1,0
5,351,351,1,1,0,1,0
8,392,392,12,2,10,3,2
13,393,393,9,9,0,1,0
22,407,407,45,30,15,4,3
20,421,421,66,29,37,2,1
0,423,423,41,12,29,4,3
6,424,424,22,7,15,4,3
16,428,428,106,78,28,2,1
7,436,436,182,97,85,3,2
15,489,489,138,138,0,1,0

26,112,112,5,2,3,2,1
24,141,141,4,4,0,1,0
22,146,146,10,10,0,1,0
15,150,150,11,11,0,1,0
12,155,155,34,34,0,1,0
2,185,185,28,28,0,1,0
21,196,196,16,4,12,3,2
16,198,198,69,7,62,3,2
0,200,200,1,1,0,1,0
8,207,207,9,9,0,1,0
13,214,214,2,2,0,1,0
5,239,239,4,4,0,1,0
1,247,247,17,17,0,1,0
14,267,267,16,6,10,4,3
7,285,285,12,12,0,1,0
18,286,286,21,21,0,1,0
19,305,305,43,34,9,4,3
9,306,306,13,13,0,1,0
10,345,345,34,34,0,1,0
6,410,410,7,7,0,1,0
20,427,427,21,21,0,1,0
23,434,434,4,4,0,1,0
11,435,435,72,39,33,4,3
17,441,441,42,42,0,1,0
25,444,444,69,69,0,1,0
3,447,447,44,21,23,4,3
27,451,451,56,10,46,4,3
4,494,494,44,27,17,2,1

11,100,100,5,5,0,1,0
13,112,112,5,5,0,1,0
19,149,149,27,6,21,2,1
21,170,170,3,3,0,1,0
18,196,196,31,4,27,2,1
17,217,217,33,33,0,1,0
24,231,231,6,6,0,1,0
7,238,238,18,8,10,3,2
2,265,265,62,11,51,4,3
10,267,267,2,2,0,1,0
26,270,270,8,1,7,2,1
22,274,274,6,6,0,1,0
16,280,280,64,38,26,3,2
0,297,297,93,1,92,3,2
23,310,310,70,46,24,4,3
5,339,339,34,34,0,1,0
20,341,341,4,4,0,1,0
8,365,365,1,1,0,1,0
4,370,370,7,7,0,1,0
15,404,404,35,6,29,2,1
14,417,417,2,2,0,1,0
9,417,417,14,10,4,2,1
1,447,447,81,7,74,3,2
25,447,447,38,30,8,3,2
3,457,457,49,22,27,4,3
6,471,471,7,7,0,1,0
12,490,490,6,3,3,2,1

17,102,102,4,4,0,1,0
4,107,107,1,1,0,1,0
11,119,119,2,2,0,1,0
1,132,132,1,1,0,1,0
13,139,139,35,17,18,4,3
0,157,157,6,6,0,1,0
9,158,158,26,6,20,3,2
24,231,231,10,10,0,1,0
21,248,248,56,36,20,3,2
18,275,275,13,3,10,2,1
6,295,295,20,1,19,2,1
20,299,299,31,31,0,1,0
8,303,303,5,5,0,1,0
19,304,304,20,16,4,2,1
3,326,326,23,5,18,2,1
2,328,328,27,1,26,4,3
10,333,333,46,42,4,2,1
7,363,363,30,30,0,1,0
15,387,387,61,40,21,4,3
16,394,394,83,17,66,3,2
22,400,400,47,30,17,2,1
5,403,403,28,7,21,4,3
12,411,411,78,66,12,2,1
23,442,442,69,69,0,1,0
25,459,459,22,8,14,2,1
14,461,461,6,1,5,2,1

27,104,104,19,13,6,2,1
9,114,114,17,17,0,1,0
12,118,118,8,8,0,1,0
4,120,120,1,1,0,1,0
19,133,133,3,3,0,1,0
23,140,140,2,2,0,1,0
20,150,150,6,6,0,1,0
0,180,180,8,8,0,1,0
22,183,183,2,2,0,1,0
6,196,196,32,2,30,3,2
13,208,208,11,11,0,1,0
7,234,234,13,13,0,1,0
10,261,261,6,6,0,1,0
1,265,265,58,45,13,2,1
25,293,293,30,30,0,1,0
18,327,327,56,56,0,1,0
24,329,329,23,23,0,1,0
17,334,334,10,10,0,1,0
14,357,357,10,6,4,2,1
16,377,377,194,83,111,4,3
26,395,395,14,6,8,3,2
2,404,404,31,3,28,4,3
15,408,408,12,5,7,2,1
11,409,409,21,6,15,4,3
3,445,445,87,74,13,2,1
8,449,449,10,10,0,1,0
5,455,455,7,4,3,2,1
21,484,484,13,13,0,1,0

1,134,134,2,2,0,1,0
16,162,162,31,8,23,2,1
2,169,169,13,13,0,1,0
22,186,186,92,29,63,4,3
10,201,201,41,41,0,1,0
4,204,204,21,21,0,1,0
12,207,207,28,11,17,2,1
8,255,255,7,7,0,1,0
20,265,265,8,8,0,1,0
0,277,277,81,54,27,3,2
13,284,284,6,2,4,2,1
19,306,306,7,7,0,1,0
5,321,321,7,7,0,1,0
14,338,338,1,1,0,1,0
18,340,340,79,79,0,1,0
6,343,343,68,68,0,1,0
21,356,356,12,12,0,1,0
11,392,392,3,3,0,1,0
3,397,397,53,31,22,3,2
15,403,403,10,10,0,1,0
7,434,434,33,33,0,1,0
17,446,446,12,12,0,1,0
9,449,449,24,1,23,2,1

5,110,110,1,1,0,1,0
7,130,130,6,6,0,1,0
18,130,130,19,11,8,3,2
17,131,131,4,1,3,2,1
20,143,143,2,2,0,1,0
19,156,156,17,13,4,2,1
12,193,193,24,24,0,1,0
13,225,225,1,1,0,1,0
9,231,231,67,48,19,2,1
22,233,233,8,5,3,2,1
6,278,278,4,1,3,2,1
3,279,279,5,5,0,1,0
0,288,288,18,4,14,2,1
1,295,295,19,19,0,1,0
14,298,298,103,34,69,4,3
8,314,314,31,31,0,1,0
21,315,315,50,50,0,1,0
2,327,327,28,4,24,3,2
16,337,337,27,19,8,2,1
10,412,412,89,34,55,3,2
4,434,434,129,117,12,4,3
11,449,449,72,57,15,4,3
15,491,491,12,4,8,3,2

4,100,100,4,4,0,1,0
15,105,105,4,4,0,1,0
12,119,119,9,3,6,2,1
2,124,124,16,16,0,1,0
14,127,127,53,53,0,1,0
10,133,133,29,29,0,1,0
5,159,159,1,1,0,1,0
19,161,161,1,1,0,1,0
7,163,163,16,16,0,1,0
1,165,165,58,4,54,4,3
16,167,167,5,5,0,1,0
6,167,167,20,20,0,1,0
3,175,175,13,1,12,4,3
18,297,297,37,37,0,1,0
8,316,316,87,87,0,1,0
11,338,338,5,5,0,1,0
17,339,339,33,23,10,2,1
21,341,341,14,6,8,3,2
20,380,380,16,16,0,1,0
9,381,381,26,26,0,1,0
0,413,413,16,13,3,2,1
13,463,463,61,38,23,3,2

24,116,116,17,6,11,2,1
5,121,121,1,1,0,1,0
25,133,133,43,43,0,1,0
15,147,147,2,2,0,1,0
27,160,160,22,6,16,2,1
2,162,162,20,20,0,1,0
20,183,183,8,8,0,1,0
8,191,191,1,1,0,1,0
9,193,193,46,31,15,4,3
1,206,206,1,1,0,1,0
17,259,259,15,15,0,1,0
21,262,262,12,2,10,2,1
16,267,267,3,3,0,1,0
3,274,274,19,3,16,2,1
13,276,276,97,45,52,4,3
10,292,292,5,5,0,1,0
19,339,339,17,11,6,2,1
26,378,378,7,7,0,1,0
18,387,387,83,46,37,2,1
22,403,403,15,11,4,2,1
23,403,403,29,3,26,3,2
11,431,431,13,13,0,1,0
14,466,466,33,33,0,1,0
28,468,468,38,38,0,1,0
12,471,471,34,12,22,2,1
7,474,474,49,37,12,3,2
0,478,478,24,24,0,1,0
4,489,489,6,6,0,1,0
6,489,489,10,5,5,2,1

8,100,100,19,13,6,3,2
9,125,125,6,6,0,1,0
18,157,157,1,1,0,1,0
1,168,168,36,36,0,1,0
16,239,239,23,7,16,2,1
17,241,241,16,16,0,1,0
10,249,249,16,16,0,1,0
19,280,280,29,20,9,2,1
20,307,307,31,31,0,1,0
3,318,318,140,65,75,4,3
15,325,325,6,1,5,2,1
14,337,337,70,24,46,3,2
5,359,359,3,3,0,1,0
6,387,387,38,6,32,3,2
2,414,414,7,2,5,2,1
4,415,415,45,1,44,2,1
11,422,422,6,3,3,2,1
12,431,431,9,5,4,2,1
7,444,444,19,4,15,4,3
13,451,451,213,162,51,4,3
0,464,464,40,16,24,3,2

21,109,109,1,1,0,1,0
6,110,110,21,12,9,4,3
14,132,132,6,3,3,2,1
4,142,142,37,2,35,4,3
1,220,220,24,7,17,2,1
18,228,228,2,2,0,1,0
13,269,269,12,12,0,1,0
7,272,272,1,1,0,1,0
10,291,291,33,23,10,4,3
16,296,296,15,15,0,1,0
19,311,311,21,3,18,3,2
2,347,347,6,6,0,1,0
15,369,369,27,27,0,1,0
5,377,377,74,56,18,2,1
3,397,397,64,14,50,3,2
8,400,400,12,12,0,1,0
0,408,408,26,10,16,4,3
20,423,423,57,57,0,1,0
9,430,430,19,9,10,2,1
11,431,431,5,5,0,1,0
17,458,458,119,21,98,4,3
12,461,461,30,9,21,3,2
22,467,467,39,36,3,2,1
23,470,470,178,139,39,4,3

6,100,100,14,14,0,1,0
9,128,128,15,15,0,1,0
25,130,130,6,6,0,1,0
15,151,151,24,19,5,2,1
3,175,175,25,17,8,2,1
11,187,187,10,10,0,1,0
1,191,191,29,1,28,3,2
0,217,217,7,7,0,1,0
5,218,218,19,19,0,1,0
16,249,249,13,13,0,1,0
2,277,277,43,3,40,3,2
20,301,301,15,7,8,3,2
18,304,304,119,85,34,3,2
24,317,317,30,30,0,1,0
12,329,329,8,8,0,1,0
4,329,329,3,3,0,1,0
22,330,330,25,25,0,1,0
17,353,353,32,24,8,2,1
19,393,393,21,10,11,2,1
7,406,406,85,85,0,1,0
10,406,406,8,2,6,3,2
8,431,431,22,22,0,1,0
13,445,445,3,3,0,1,0
14,496,496,36,36,0,1,0
23,498,498,43,19,24,4,3
21,499,499,24,24,0,1,0

9,135,135,4,1,3,2,1
18,139,139,3,3,0,1,0
11,152,152,35,35,0,1,0
17,161,161,31,9,22,2,1
12,173,173,10,10,0,1,0
10,177,177,63,14,49,2,1
1,206,206,15,15,0,1,0
14,246,246,9,3,6,2,1
5,253,253,87,9,78,3,2
7,262,262,7,7,0,1,0
8,307,307,39,39,0,1,0
0,330,330,60,6,54,3,2
2,341,341,17,5,12,3,2
4,357,357,44,20,24,4,3
13,362,362,45,42,3,2,1
16,381,381,9,1,8,3,2
3,435,435,170,128,42,2,1
15,447,447,1,1,0,1,0
6,448,448,17,17,0,1,0

1,116,116,6,6,0,1,0
15,122,122,16,4,12,2,1
13,149,149,33,24,9,4,3
0,151,151,40,2,38,3,2
19,238,238,15,7,8,2,1
5,246,246,24,1,23,2,1
9,246,246,31,31,0,1,0
2,265,265,31,15,16,3,2
17,290,290,45,45,0,1,0
21,331,331,23,17,6,2,1
14,331,331,73,9,64,3,2
18,343,343,66,26,40,4,3
16,352,352,19,19,0,1,0
3,359,359,55,24,31,3,2
8,384,384,89,22,67,4,3
4,412,412,5,5,0,1,0
20,428,428,18,2,16,3,2
12,455,455,18,2,16,2,1
10,458,458,2,2,0,1,0
6,474,474,53,53,0,1,0
7,494,494,18,18,0,1,0
11,497,497,16,16,0,1,0

9,113,113,33,3,30,3,2
18,132,132,32,32,0,1,0
19,142,142,18,18,0,1,0
4,145,145,7,1,6,3,2
10,195,195,27,19,8,3,2
3,207,207,19,19,0,1,0
15,208,208,7,7,0,1,0
17,251,251,10,4,6,3,2
0,283,283,9,1,8,3,2
1,289,289,8,2,6,2,1
14,307,307,46,6,40,3,2
13,322,322,7,7,0,1,0
12,325,325,6,6,0,1,0
6,330,330,1,1,0,1,0
20,342,342,25,7,18,3,2
11,348,348,12,12,0,1,0
5,350,350,36,8,28,3,2
2,378,378,62,62,0,1,0
16,380,380,23,5,18,2,1
8,418,418,69,32,37,2,1
7,459,459,260,252,8,3,2

30,106,106,7,7,0,1,0
29,149,149,20,3,17,2,1
25,151,151,3,3,0,1,0
23,160,160,22,2,20,3,2
18,161,161,50,38,12,4,3
22,166,166,7,1,6,3,2
5,186,186,8,8,0,1,0
15,187,187,12,9,3,2,1
16,262,262,48,48,0,1,0
31,264,264,10,1,9,4,3
27,283,283,12,12,0,1,0
26,313,313,51,51,0,1,0
4,314,314,1,1,0,1,0
6,333,333,1,1,0,1,0
21,343,343,48,24,24,2,1
2,345,345,7,7,0,1,0
24,358,358,38,30,8,2,1
14,361,361,13,13,0,1,0
8,365,365,26,26,0,1,0
13,371,371,32,2,30,3,2
1,378,378,1,1,0,1,0
11,382,382,23,9,14,2,1
32,388,388,1,1,0,1,0
3,403,403,11,11,0,1,0
10,412,412,16,16,0,1,0
28,423,423,143,117,26,2,1
19,423,423,3,3,0,1,0
9,448,448,1,1,0,1,0
12,454,454,28,9,19,3,2
17,469,469,8,8,0,1,0
7,470,470,15,15,0,1,0
20,483,483,23,23,0,1,0
0,491,491,41,9,32,2,1

14,113,113,14,14,0,1,0
4,116,116,3,3,0,1,0
25,119,119,23,2,21,4,3
7,141,141,8,8,0,1,0
16,144,144,1,1,0,1,0
12,171,171,3,3,0,1,0
24,171,171,8,8,0,1,0
2,177,177,1,1,0,1,0
9,197,197,16,2,14,4,3
20,214,214,2,2,0,1,0
3,222,222,6,2,4,2,1
13,228,228,4,1,3,2,1
11,243,243,5,5,0,1,0
1,243,243,35,11,24,3,2
17,250,250,18,18,0,1,0
21,266,266,36,36,0,1,0
15,281,281,67,49,18,3,2
5,286,286,32,1,31,2,1
26,295,295,87,46,41,4,3
10,310,310,25,25,0,1,0
29,319,319,45,45,0,1,0
8,337,337,25,25,0,1,0
28,377,377,15,15,0,1,0
19,378,378,10,10,0,1,0
18,392,392,55,27,28,2,1
0,431,431,14,6,8,2,1
23,433,433,11,11,0,1,0
6,448,448,30,30,0,1,0
27,464,464,23,23,0,1,0
22,487,487,57,15,42,4,3

1,147,147,8,2,6,3,2
22,150,150,5,1,4,2,1
7,158,158,16,16,0,1,0
16,160,160,7,7,0,1,0
2,175,175,90,21,69,4,3
10,182,182,11,11,0,1,0
18,205,205,4,4,0,1,0
17,207,207,47,47,0,1,0
15,213,213,89,1,88,3,2
8,236,236,1,1,0,1,0
14,254,254,36,36,0,1,0
5,257,257,56,56,0,1,0
0,272,272,1,1,0,1,0
9,289,289,8,8,0,1,0
11,322,322,16,6,10,3,2
6,326,326,9,2,7,2,1
20,385,385,5,5,0,1,0
19,416,416,53,53,0,1,0
21,423,423,19,19,0,1,0
13,427,427,22,2,20,3,2
3,436,436,2,2,0,1,0
12,443,443,24,24,0,1,0
4,482,482,89,75,14,2,1

14,102,102,18,4,14,2,1
9,137,137,2,2,0,1,0
20,141,141,12,2,10,2,1
6,157,157,41,41,0,1,0
4,158,158,1,1,0,1,0
16,185,185,4,4,0,1,0
11,205,205,9,2,7,2,1
12,221,221,67,43,24,4,3
3,240,240,13,4,9,4,3
13,266,266,22,2,20,3,2
0,298,298,96,64,32,2,1
10,376,376,19,19,0,1,0
1,387,387,17,5,12,4,3
2,388,388,37,4,33,2,1
7,396,396,94,94,0,1,0
15,401,401,51,51,0,1,0
5,428,428,37,37,0,1,0
17,439,439,46,26,20,2,1
8,478,478,45,22,23,4,3
18,480,480,60,35,25,2,1
19,496,496,43,17,26,3,2

13,120,120,1,1,0,1,0
17,126,126,7,7,0,1,0
8,127,127,15,1,14,4,3
16,141,141,12,3,9,4,3
9,164,164,19,14,5,2,1
6,192,192,7,7,0,1,0
2,213,213,15,15,0,1,0
3,229,229,13,13,0,1,0
7,242,242,30,30,0,1,0
12,304,304,12,12,0,1,0
14,347,347,97,46,51,4,3
11,350,350,12,5,7,2,1
1,353,353,177,123,54,4,3
4,368,368,89,72,17,2,1
10,370,370,75,75,0,1,0
0,430,430,106,13,93,4,3
5,434,434,37,37,0,1,0
15,462,462,63,63,0,1,0

2,106,106,8,8,0,1,0
26,115,115,3,3,0,1,0
24,117,117,11,11,0,1,0
15,122,122,6,6,0,1,0
11,136,136,1,1,0,1,0
13,167,167,14,8,6,3,2
19,182,182,72,34,38,3,2
6,184,184,8,8,0,1,0
17,196,196,8,8,0,1,0
10,202,202,26,26,0,1,0
12,204,204,11,11,0,1,0
9,219,219,14,1,13,2,1
8,238,238,31,31,0,1,0
25,260,260,60,12,48,2,1
1,297,297,2,2,0,1,0
20,326,326,25,20,5,2,1
22,334,334,31,25,6,2,1
23,359,359,5,5,0,1,0
21,361,361,38,38,0,1,0
0,369,369,3,3,0,1,0
5,370,370,94,80,14,2,1
14,376,376,19,10,9,2,1
3,376,376,1,1,0,1,0
18,423,423,17,6,11,2,1
7,459,459,130,64,66,4,3
16,460,460,29,29,0,1,0
4,466,466,4,4,0,1,0

10,109,109,11,3,8,2,1
19,109,109,26,4,22,3,2
17,117,117,15,15,0,1,0
5,120,120,3,3,0,1,0
0,121,121,19,19,0,1,0
15,121,121,18,18,0,1,0
13,147,147,14,2,12,2,1
20,173,173,3,3,0,1,0
7,186,186,69,13,56,3,2
18,195,195,51,6,45,4,3
8,239,239,9,1,8,2,1
11,257,257,7,7,0,1,0
4,264,264,12,4,8,2,1
9,281,281,21,21,0,1,0
2,286,286,10,10,0,1,0
3,326,326,19,19,0,1,0
14,353,353,20,20,0,1,0
6,365,365,15,15,0,1,0
1,416,416,149,131,18,4,3
12,453,453,4,4,0,1,0
21,493,493,55,55,0,1,0
16,496,496,25,12,13,2,1

11,107,107,2,2,0,1,0
1,136,136,14,6,8,3,2
23,151,151,17,6,11,2,1
14,153,153,19,7,12,3,2
18,154,154,19,19,0,1,0
7,215,215,51,51,0,1,0
0,240,240,15,3,12,4,3
20,245,245,28,28,0,1,0
16,253,253,20,20,0,1,0
4,258,258,7,2,5,2,1
2,277,277,61,3,58,3,2
12,290,290,16,16,0,1,0
9,298,298,38,24,14,2,1
13,337,337,10,2,8,3,2
15,372,372,85,67,18,3,2
22,399,399,3,3,0,1,0
6,429,429,9,9,0,1,0
17,442,442,48,28,20,2,1
8,458,458,18,10,8,2,1
21,465,465,84,76,8,2,1
3,467,467,5,5,0,1,0
10,478,478,134,134,0,1,0
5,492,492,29,19,10,2,1
19,495,495,30,3,27,2,1

13,109,109,2,2,0,1,0
0,116,116,7,1,6,3,2
9,177,177,26,6,20,3,2
1,179,179,1,1,0,1,0
18,194,194,9,1,8,3,2
16,195,195,2,2,0,1,0
20,220,220,36,18,18,3,2
12,241,241,31,31,0,1,0
21,268,268,89,66,23,4,3
4,319,319,9,6,3,2,1
5,322,322,108,38,70,4,3
15,331,331,4,1,3,2,1
6,337,337,83,59,24,3,2
17,340,340,15,15,0,1,0
2,341,341,1,1,0,1,0
11,350,350,10,7,3,2,1
22,353,353,46,4,42,2,1
7,380,380,4,4,0,1,0
10,417,417,33,33,0,1,0
8,450,450,20,7,13,2,1
23,450,450,4,4,0,1,0
19,453,453,40,28,12,4,3
14,475,475,113,15,98,4,3
3,489,489,104,101,3,2,1

15,103,103,19,16,3,2,1
10,107,107,1,1,0,1,0
21,118,118,15,15,0,1,0
16,137,137,7,1,6,2,1
19,140,140,5,2,3,2,1
20,159,159,11,3,8,3,2
22,235,235,28,8,20,3,2
4,239,239,12,1,11,4,3
18,254,254,33,33,0,1,0
5,281,281,17,7,10,2,1
23,319,319,56,29,27,4,3
24,322,322,45,29,16,3,2
2,348,348,24,19,5,2,1
12,364,364,52,8,44,3,2
6,368,368,6,6,0,1,0
9,370,370,25,25,0,1,0
7,390,390,50,19,31,4,3
0,392,392,90,75,15,4,3
1,404,404,8,8,0,1,0
17,407,407,38,17,21,4,3
11,418,418,49,8,41,2,1
13,424,424,7,3,4,2,1
8,455,455,29,29,0,1,0
14,467,467,38,38,0,1,0
3,475,475,108,87,21,2,1

7,108,108,3,3,0,1,0
22,109,109,6,6,0,1,0
17,109,109,21,21,0,1,0
19,152,152,24,24,0,1,0
8,176,176,5,2,3,2,1
14,190,190,4,1,3,2,1
2,253,253,42,42,0,1,0
15,279,279,22,7,15,4,3
12,281,281,4,4,0,1,0
3,284,284,4,4,0,1,0
16,288,288,25,15,10,2,1
20,314,314,53,35,18,4,3
21,324,324,33,33,0,1,0
11,334,334,86,86,0,1,0
18,345,345,1,1,0,1,0
6,353,353,97,71,26,2,1
9,354,354,12,12,0,1,0
4,376,376,55,33,22,3,2
10,385,385,41,41,0,1,0
1,408,408,30,2,28,2,1
13,434,434,37,37,0,1,0
5,457,457,117,96,21,2,1
0,480,480,35,23,12,4,3

1,107,107,6,2,4,2,1
18,117,117,10,2,8,3,2
12,122,122,3,3,0,1,0
0,124,124,10,1,9,4,3
16,167,167,7,7,0,1,0
20,172,172,6,3,3,2,1
5,199,199,14,14,0,1,0
7,216,216,10,5,5,2,1
27,237,237,116,35,81,4,3
3,239,239,20,13,7,2,1
15,250,250,2,2,0,1,0
26,269,269,47,20,27,4,3
19,272,272,17,17,0,1,0
21,274,274,9,9,0,1,0
24,282,282,7,4,3,2,1
8,293,293,29,5,24,2,1
14,335,335,33,33,0,1,0
23,369,369,49,34,15,4,3
4,370,370,14,14,0,1,0
13,376,376,1,1,0,1,0
9,378,378,22,22,0,1,0
17,386,386,34,6,28,2,1
11,392,392,36,11,25,4,3
6,394,394,27,27,0,1,0
10,434,434,79,43,36,4,3
25,459,459,28,28,0,1,0
22,461,461,18,18,0,1,0
28,481,481,2,2,0,1,0
2,490,490,74,74,0,1,0

11,174,174,1,1,0,1,0
19,176,176,9,9,0,1,0
7,183,183,1,1,0,1,0
17,218,218,29,5,24,3,2
22,233,233,8,8,0,1,0
6,253,253,54,54,0,1,0
12,254,254,28,2,26,3,2
14,271,271,10,10,0,1,0
18,281,281,69,54,15,4,3
4,287,287,1,1,0,1,0
3,297,297,66,37,29,2,1
0,305,305,1,1,0,1,0
10,386,386,23,5,18,2,1
21,398,398,79,79,0,1,0
15,400,400,23,7,16,3,2
13,447,447,3,3,0,1,0
8,452,452,7,7,0,1,0
1,456,456,92,92,0,1,0
16,457,457,59,59,0,1,0
9,477,477,17,17,0,1,0
20,480,480,106,71,35,3,2
5,485,485,42,1,41,4,3
2,494,494,175,164,11,4,3

20,113,113,6,6,0,1,0
21,123,123,11,11,0,1,0
25,187,187,11,11,0,1,0
11,205,205,47,40,7,2,1
19,229,229,47,26,21,4,3
9,262,262,18,18,0,1,0
6,263,263,7,7,0,1,0
15,287,287,44,27,17,4,3
5,292,292,13,13,0,1,0
24,304,304,89,89,0,1,0
18,304,304,18,10,8,2,1
17,332,332,22,22,0,1,0
16,341,341,52,52,0,1,0
12,344,344,14,14,0,1,0
3,348,348,76,68,8,2,1
4,362,362,5,5,0,1,0
2,367,367,3,3,0,1,0
22,377,377,22,17,5,2,1
23,412,412,10,10,0,1,0
7,424,424,1,1,0,1,0
1,430,430,81,81,0,1,0
13,433,433,47,10,37,2,1
0,436,436,21,21,0,1,0
10,441,441,80,40,40,2,1
8,464,464,10,10,0,1,0
14,465,465,10,2,8,3,2

16,101,101,23,23,0,1,0
3,130,130,5,2,3,2,1
20,157,157,1,1,0,1,0
8,183,183,1,1,0,1,0
6,188,188,29,29,0,1,0
11,195,195,2,2,0,1,0
7,216,216,71,43,28,2,1
1,237,237,6,6,0,1,0
2,245,245,38,38,0,1,0
17,254,254,73,73,0,1,0
18,273,273,47,21,26,2,1
19,313,313,13,13,0,1,0
5,321,321,86,44,42,3,2
10,330,330,18,18,0,1,0
13,395,395,42,42,0,1,0
4,399,399,33,18,15,2,1
15,448,448,51,4,47,3,2
14,452,452,29,15,14,2,1
12,461,461,13,5,8,2,1
21,466,466,44,44,0,1,0
0,481,481,20,20,0,1,0
9,486,486,23,23,0,1,0
22,495,495,33,9,24,4,3

0,144,144,12,5,7,2,1
4,149,149,12,12,0,1,0
17,149,149,12,12,0,1,0
5,177,177,24,24,0,1,0
13,179,179,18,18,0,1,0
20,204,204,20,20,0,1,0
7,240,240,1,1,0,1,0
22,242,242,23,23,0,1,0
12,253,253,46,46,0,1,0
3,262,262,10,4,6,2,1
14,301,301,5,5,0,1,0
2,308,308,44,6,38,3,2
6,321,321,2,2,0,1,0
15,348,348,6,1,5,2,1
1,352,352,28,10,18,4,3
23,359,359,29,22,7,2,1
10,406,406,82,82,0,1,0
16,408,408,48,28,20,2,1
11,425,425,48,3,45,2,1
19,433,433,27,23,4,2,1
9,475,475,38,13,25,4,3
18,479,479,34,34,0,1,0
21,493,493,144,98,46,4,3
8,498,498,117,98,19,2,1

26,102,102,12,3,9,2,1
15,120,120,10,5,5,2,1
11,132,132,9,9,0,1,0
22,144,144,4,4,0,1,0
21,167,167,3,3,0,1,0
4,182,182,2,2,0,1,0
14,193,193,1,1,0,1,0
10,216,216,6,2,4,2,1
23,218,218,18,1,17,4,3
3,228,228,5,5,0,1,0
12,246,246,17,17,0,1,0
7,276,276,95,19,76,4,3
17,312,312,2,2,0,1,0
27,324,324,39,39,0,1,0
5,358,358,21,1,20,2,1
24,371,371,2,2,0,1,0
19,371,371,30,16,14,2,1
0,376,376,1,1,0,1,0
1,377,377,5,1,4,2,1
18,385,385,31,31,0,1,0
13,395,395,80,80,0,1,0
25,403,403,138,45,93,4,3
29,413,413,83,39,44,3,2
16,439,439,1,1,0,1,0
9,442,442,54,54,0,1,0
2,444,444,23,23,0,1,0
20,465,465,57,36,21,4,3
6,475,475,15,3,12,3,2
8,479,479,38,38,0,1,0
28,480,480,13,5,8,3,2

15,114,114,8,8,0,1,0
27,116,116,10,10,0,1,0
26,145,145,53,19,34,3,2
16,169,169,25,13,12,3,2
20,172,172,6,6,0,1,0
23,172,172,3,3,0,1,0
7,181,181,12,12,0,1,0
25,198,198,19,4,15,4,3
12,200,200,4,4,0,1,0
8,250,250,2,2,0,1,0
14,254,254,16,16,0,1,0
10,272,272,54,54,0,1,0
2,283,283,30,11,19,2,1
21,292,292,15,3,12,4,3
1,329,329,26,2,24,3,2
3,330,330,2,2,0,1,0
18,333,333,21,11,10,2,1
13,350,350,21,6,15,2,1
4,380,380,33,33,0,1,0
28,387,387,50,40,10,2,1
11,387,387,50,50,0,1,0
9,391,391,25,1,24,2,1
17,405,405,61,36,25,2,1
5,410,410,33,33,0,1,0
0,412,412,5,5,0,1,0
6,412,412,2,2,0,1,0
24,424,424,31,31,0,1,0
22,452,452,36,36,0,1,0
19,464,464,37,7,30,4,3

5,117,117,11,11,0,1,0
0,118,118,12,12,0,1,0
18,122,122,9,1,8,3,2
25,183,183,36,36,0,1,0
16,188,188,4,4,0,1,0
17,211,211,18,18,0,1,0
12,227,227,3,3,0,1,0
6,229,229,22,22,0,1,0
2,234,234,45,45,0,1,0
11,240,240,26,26,0,1,0
3,241,241,13,13,0,1,0
1,242,242,7,7,0,1,0
8,247,247,47,13,34,2,1
19,248,248,26,10,16,2,1
7,297,297,3,3,0,1,0
13,298,298,18,18,0,1,0
28,302,302,60,60,0,1,0
15,305,305,1,1,0,1,0
10,312,312,26,14,12,3,2
4,319,319,2,2,0,1,0
23,343,343,31,31,0,1,0
21,359,359,9,1,8,3,2
27,364,364,16,10,6,3,2
22,377,377,4,4,0,1,0
14,382,382,48,48,0,1,0
24,451,451,91,40,51,4,3
9,467,467,7,7,0,1,0
26,485,485,17,17,0,1,0
20,494,494,77,9,68,3,2

1,114,114,8,4,4,2,1
8,126,126,34,26,8,2,1
18,138,138,6,1,5,2,1
11,191,191,31,31,0,1,0
3,200,200,31,31,0,1,0
2,211,211,1,1,0,1,0
4,213,213,87,63,24,3,2
12,222,222,25,9,16,3,2
6,231,231,17,17,0,1,0
16,235,235,6,1,5,2,1
19,271,271,14,14,0,1,0
17,279,279,46,28,18,2,1
7,300,300,9,9,0,1,0
5,322,322,84,14,70,3,2
0,410,410,82,82,0,1,0
10,417,417,13,13,0,1,0
14,423,423,3,3,0,1,0
13,426,426,66,28,38,3,2
15,471,471,23,8,15,2,1
9,487,487,74,74,0,1,0

18,107,107,14,14,0,1,0
7,112,112,10,10,0,1,0
26,130,130,25,25,0,1,0
17,130,130,3,3,0,1,0
14,151,151,2,2,0,1,0
22,169,169,31,1,30,4,3
28,171,171,3,3,0,1,0
10,219,219,6,6,0,1,0
20,230,230,36,36,0,1,0
11,233,233,9,9,0,1,0
23,241,241,30,14,16,2,1
5,245,245,3,3,0,1,0
2,257,257,11,11,0,1,0
3,262,262,13,13,0,1,0
16,268,268,10,4,6,2,1
24,289,289,35,5,30,3,2
9,302,302,11,3,8,3,2
21,310,310,11,2,9,4,3
8,320,320,89,38,51,4,3
0,367,367,43,18,25,2,1
12,383,383,10,10,0,1,0
27,405,405,26,19,7,2,1
15,418,418,48,28,20,2,1
1,443,443,50,12,38,3,2
19,475,475,38,31,7,2,1
6,484,484,13,4,9,4,3
4,493,493,46,46,0,1,0
13,499,499,43,13,30,2,1
25,499,499,47,10,37,2,1

5,114,114,11,1,10,2,1
8,158,158,9,1,8,3,2
9,166,166,13,1,12,4,3
27,175,175,13,13,0,1,0
31,193,193,3,3,0,1,0
7,207,207,9,9,0,1,0
18,220,220,13,13,0,1,0
10,241,241,19,13,6,3,2
22,255,255,58,58,0,1,0
2,277,277,28,28,0,1,0
23,305,305,19,5,14,3,2
20,330,330,23,13,10,3,2
0,345,345,28,28,0,1,0
24,350,350,69,45,24,2,1
11,351,351,7,7,0,1,0
26,359,359,16,16,0,1,0
12,366,366,7,4,3,2,1
16,377,377,10,2,8,3,2
28,383,383,13,13,0,1,0
17,387,387,47,47,0,1,0
4,388,388,29,29,0,1,0
13,395,395,3,3,0,1,0
3,396,396,3,3,0,1,0
30,421,421,28,14,14,4,3
14,422,422,1,1,0,1,0
29,457,457,6,6,0,1,0
21,459,459,132,132,0,1,0
15,460,460,44,2,42,4,3
25,467,467,58,10,48,4,3
19,482,482,35,17,18,4,3
6,489,489,57,57,0,1,0
1,490,490,20,20,0,1,0

16,113,113,17,17,0,1,0
0,168,168,28,18,10,4,3
8,203,203,35,14,21,4,3
9,210,210,51,5,46,4,3
19,219,219,22,12,10,2,1
21,220,220,86,20,66,4,3
17,255,255,7,1,6,3,2
11,275,275,30,21,9,4,3
20,287,287,49,49,0,1,0
2,316,316,16,16,0,1,0
3,333,333,21,21,0,1,0
6,334,334,1,1,0,1,0
5,334,334,37,7,30,2,1
10,360,360,51,9,42,3,2
13,360,360,10,10,0,1,0
14,383,383,1,1,0,1,0
7,409,409,102,59,43,2,1
1,413,413,47,37,10,4,3
18,431,431,26,26,0,1,0
4,450,450,14,1,13,2,1
12,480,480,22,22,0,1,0
15,492,492,1,1,0,1,0

11,103,103,11,6,5,2,1
12,141,141,2,2,0,1,0
10,152,152,9,9,0,1,0
0,154,154,5,5,0,1,0
19,174,174,6,6,0,1,0
14,174,174,15,9,6,3,2
8,202,202,52,40,12,3,2
13,203,203,14,14,0,1,0
2,218,218,1,1,0,1,0
9,230,230,39,7,32,3,2
3,235,235,21,5,16,3,2
7,296,296,56,28,28,3,2
16,297,297,54,38,16,4,3
4,341,341,23,23,0,1,0
18,341,341,5,5,0,1,0
1,372,372,38,38,0,1,0
6,376,376,8,8,0,1,0
21,378,378,75,75,0,1,0
22,412,412,19,19,0,1,0
20,419,419,150,136,14,2,1
15,427,427,55,16,39,2,1
17,436,436,32,32,0,1,0
23,484,484,9,9,0,1,0
5,485,485,49,49,0,1,0

21,119,119,1,1,0,1,0
18,140,140,33,28,5,2,1
1,142,142,2,2,0,1,0
7,161,161,3,3,0,1,0
2,169,169,16,16,0,1,0
13,173,173,23,6,17,2,1
19,185,185,7,7,0,1,0
6,210,210,1,1,0,1,0
22,217,217,16,16,0,1,0
15,232,232,44,44,0,1,0
0,262,262,99,54,45,4,3
20,289,289,60,4,56,3,2
12,311,311,19,15,4,2,1
14,315,315,7,3,4,2,1
16,316,316,18,18,0,1,0
17,325,325,53,53,0,1,0
10,355,355,13,13,0,1,0
24,377,377,33,7,26,3,2
9,396,396,4,4,0,1,0
11,397,397,47,7,40,3,2
23,397,397,1,1,0,1,0
5,435,435,27,27,0,1,0
4,443,443,26,9,17,4,3
3,455,455,113,101,12,3,2
8,484,484,46,31,15,4,3

7,101,101,3,3,0,1,0
17,104,104,11,2,9,2,1
13,150,150,15,8,7,2,1
12,151,151,16,16,0,1,0
15,156,156,12,12,0,1,0
19,185,185,21,21,0,1,0
20,222,222,10,1,9,4,3
1,225,225,12,12,0,1,0
0,253,253,71,3,68,3,2
8,274,274,43,28,15,4,3
14,285,285,6,6,0,1,0
21,286,286,9,9,0,1,0
11,289,289,21,21,0,1,0
18,300,300,35,17,18,3,2
16,309,309,3,3,0,1,0
6,318,318,21,21,0,1,0
9,375,375,25,25,0,1,0
2,404,404,87,27,60,4,3
3,418,418,61,61,0,1,0
4,426,426,34,25,9,4,3
10,443,443,190,97,93,4,3
5,482,482,52,52,0,1,0

23,107,107,3,3,0,1,0
12,107,107,22,22,0,1,0
8,113,113,3,3,0,1,0
24,125,125,9,9,0,1,0
20,153,153,1,1,0,1,0
11,222,222,1,1,0,1,0
15,267,267,31,17,14,2,1
14,274,274,14,4,10,3,2
9,299,299,11,8,3,2,1
1,306,306,51,51,0,1,0
19,306,306,17,7,10,3,2
21,309,309,29,29,0,1,0
17,329,329,63,45,18,4,3
7,332,332,31,31,0,1,0
10,366,366,29,29,0,1,0
6,371,371,9,1,8,3,2
3,390,390,1,1,0,1,0
4,398,398,51,51,0,1,0
13,404,404,48,36,12,2,1
5,404,404,66,41,25,2,1
2,419,419,14,14,0,1,0
0,433,433,102,102,0,1,0
18,448,448,87,63,24,4,3
16,464,464,34,17,17,2,1
22,472,472,106,106,0,1,0

18,109,109,8,8,0,1,0
26,122,122,15,15,0,1,0
13,139,139,26,26,0,1,0
27,152,152,33,19,14,2,1
14,155,155,30,30,0,1,0
6,165,165,7,3,4,2,1
7,172,172,13,13,0,1,0
9,177,177,15,4,11,2,1
16,178,178,25,25,0,1,0
15,197,197,6,3,3,2,1
24,207,207,14,14,0,1,0
21,210,210,41,21,20,2,1
1,221,221,6,6,0,1,0
3,234,234,8,8,0,1,0
4,246,246,9,9,0,1,0
11,256,256,3,3,0,1,0
17,258,258,3,3,0,1,0
25,269,269,29,5,24,2,1
2,283,283,16,4,12,3,2
8,314,314,46,28,18,4,3
5,328,328,4,4,0,1,0
23,330,330,3,3,0,1,0
12,341,341,7,7,0,1,0
19,356,356,25,2,23,2,1
0,357,357,29,19,10,3,2
22,375,375,19,13,6,3,2
10,417,417,8,2,6,3,2
20,422,422,18,18,0,1,0
28,498,498,131,83,48,3,2

19,121,121,14,3,11,2,1
8,166,166,12,3,9,2,1
22,216,216,6,3,3,2,1
23,256,256,38,38,0,1,0
16,261,261,39,24,15,2,1
10,263,263,43,19,24,3,2
2,273,273,71,51,20,2,1
6,293,293,13,13,0,1,0
14,296,296,25,25,0,1,0
9,303,303,26,10,16,4,3
12,305,305,56,50,6,2,1
13,335,335,2,2,0,1,0
4,365,365,79,17,62,3,2
21,403,403,24,24,0,1,0
15,404,404,25,25,0,1,0
5,423,423,16,8,8,3,2
11,428,428,42,42,0,1,0
7,428,428,13,13,0,1,0
18,459,459,42,42,0,1,0
3,468,468,11,8,3,2,1
17,469,469,124,89,35,2,1
20,480,480,14,9,5,2,1
0,483,483,48,7,41,2,1
1,488,488,34,34,0,1,0

1,107,107,2,2,0,1,0
25,150,150,15,3,12,4,3
18,152,152,4,4,0,1,0
9,159,159,17,1,16,3,2
33,160,160,3,3,0,1,0
26,166,166,29,29,0,1,0
21,171,171,12,6,6,2,1
22,179,179,7,7,0,1,0
10,204,204,9,2,7,3,2
32,218,218,2,2,0,1,0
29,220,220,34,4,30,3,2
3,247,247,1,1,0,1,0
23,266,266,10,2,8,3,2
5,269,269,11,5,6,2,1
30,277,277,124,124,0,1,0
6,298,298,5,2,3,2,1
11,300,300,7,2,5,2,1
4,302,302,11,5,6,3,2
13,307,307,3,3,0,1,0
8,342,342,16,16,0,1,0
7,354,354,7,7,0,1,0
31,369,369,29,29,0,1,0
2,370,370,12,12,0,1,0
24,414,414,19,19,0,1,0
15,415,415,15,7,8,2,1
20,418,418,3,3,0,1,0
16,428,428,38,8,30,3,2
27,437,437,14,14,0,1,0
14,439,439,53,16,37,2,1
12,456,456,83,83,0,1,0
0,465,465,80,67,13,2,1
19,488,488,40,40,0,1,0
17,494,494,10,10,0,1,0
28,500,500,45,45,0,1,0

17,111,111,22,10,12,4,3
2,111,111,55,55,0,1,0
12,113,113,1,1,0,1,0
6,126,126,11,11,0,1,0
21,195,195,34,34,0,1,0
13,217,217,12,12,0,1,0
1,225,225,50,50,0,1,0
7,235,235,5,5,0,1,0
20,247,247,12,6,6,3,2
10,302,302,13,13,0,1,0
4,307,307,14,4,10,3,2
19,392,392,93,1,92,3,2
0,402,402,2,2,0,1,0
22,406,406,25,10,15,4,3
8,407,407,14,1,13,2,1
14,423,423,102,34,68,3,2
3,431,431,64,64,0,1,0
5,463,463,9,1,8,3,2
15,482,482,9,9,0,1,0
11,485,485,14,1,13,3,2
16,487,487,70,70,0,1,0
9,491,491,39,15,24,2,1
18,493,493,2,2,0,1,0

15,111,111,1,1,0,1,0
1,169,169,88,42,46,4,3
10,199,199,8,8,0,1,0
6,205,205,36,2,34,2,1
7,241,241,50,50,0,1,0
2,250,250,61,61,0,1,0
0,309,309,96,20,76,3,2
5,313,313,8,4,4,2,1
14,317,317,34,34,0,1,0
13,349,349,11,7,4,2,1
12,365,365,8,8,0,1,0
8,394,394,23,23,0,1,0
3,402,402,51,24,27,4,3
4,431,431,83,26,57,4,3
9,454,454,43,43,0,1,0
11,482,482,124,124,0,1,0

14,100,100,5,5,0,1,0
21,116,116,1,1,0,1,0
10,120,120,29,9,20,4,3
20,122,122,16,16,0,1,0
13,149,149,31,6,25,2,1
1,188,188,50,44,6,2,1
3,209,209,1,1,0,1,0
6,264,264,17,17,0,1,0
17,280,280,16,16,0,1,0
22,293,293,9,9,0,1,0
7,304,304,49,49,0,1,0
0,317,317,69,6,63,4,3
16,327,327,5,1,4,2,1
15,347,347,19,8,11,4,3
2,357,357,42,42,0,1,0
23,361,361,68,44,24,4,3
11,391,391,28,3,25,2,1
19,414,414,65,47,18,4,3
9,441,441,3,3,0,1,0
12,449,449,58,50,8,2,1
18,459,459,89,89,0,1,0
8,463,463,14,14,0,1,0
5,478,478,1,1,0,1,0
4,496,496,8,2,6,2,1

4,100,100,11,5,6,2,1
2,122,122,10,10,0,1,0
12,122,122,4,4,0,1,0
9,189,189,68,68,0,1,0
1,201,201,1,1,0,1,0
20,211,211,1,1,0,1,0
22,218,218,16,16,0,1,0
8,235,235,8,3,5,2,1
14,279,279,50,3,47,2,1
16,295,295,20,20,0,1,0
5,326,326,18,18,0,1,0
11,336,336,57,57,0,1,0
21,369,369,14,14,0,1,0
17,381,381,120,120,0,1,0
0,384,384,40,40,0,1,0
10,423,423,72,40,32,2,1
18,431,431,2,2,0,1,0
6,471,471,6,6,0,1,0
15,472,472,3,3,0,1,0
19,482,482,72,72,0,1,0
3,487,487,65,65,0,1,0
13,488,488,88,2,86,3,2
7,494,494,66,33,33,2,1

18,132,132,30,30,0,1,0
7,142,142,37,19,18,4,3
1,149,149,7,7,0,1,0
19,171,171,29,5,24,4,3
15,179,179,9,9,0,1,0
10,186,186,1,1,0,1,0
16,197,197,4,4,0,1,0
6,200,200,28,28,0,1,0
12,289,289,25,5,20,4,3
11,361,361,48,48,0,1,0
3,380,380,46,46,0,1,0
14,389,389,53,19,34,3,2
0,389,389,25,16,9,2,1
17,390,390,35,27,8,2,1
2,395,395,90,90,0,1,0
20,397,397,96,96,0,1,0
9,415,415,3,3,0,1,0
13,427,427,22,4,18,4,3
4,428,428,7,7,0,1,0
8,467,467,51,51,0,1,0
5,491,491,105,63,42,4,3

16,117,117,2,2,0,1,0
9,117,117,14,14,0,1,0
30,123,123,8,8,0,1,0
13,138,138,10,10,0,1,0
20,157,157,10,2,8,3,2
19,171,171,8,8,0,1,0
7,175,175,4,4,0,1,0
15,193,193,12,4,8,2,1
8,199,199,54,10,44,2,1
31,212,212,33,11,22,4,3
3,219,219,33,33,0,1,0
25,226,226,51,18,33,2,1
26,246,246,36,12,24,4,3
22,253,253,40,13,27,4,3
2,254,254,5,5,0,1,0
24,276,276,47,47,0,1,0
27,328,328,14,14,0,1,0
0,330,330,3,3,0,1,0
21,343,343,2,2,0,1,0
5,352,352,9,9,0,1,0
18,361,361,29,29,0,1,0
10,365,365,2,2,0,1,0
11,366,366,56,20,36,3,2
1,368,368,8,8,0,1,0
14,387,387,5,5,0,1,0
29,393,393,43,43,0,1,0
17,419,419,1,1,0,1,0
4,462,462,22,22,0,1,0
23,473,473,25,25,0,1,0
28,475,475,13,13,0,1,0
6,481,481,13,13,0,1,0
12,488,488,18,9,9,4,3

6,127,127,3,3,0,1,0
22,131,131,12,12,0,1,0
13,161,161,1,1,0,1,0
1,163,163,52,22,30,2,1
7,165,165,1,1,0,1,0
5,201,201,4,4,0,1,0
15,218,218,5,1,4,2,1
18,248,248,35,6,29,3,2
4,250,250,35,11,24,2,1
2,255,255,13,5,8,3,2
9,258,258,7,7,0,1,0
3,270,270,59,59,0,1,0
17,271,271,6,6,0,1,0
21,273,273,6,6,0,1,0
0,277,277,8,2,6,3,2
11,297,297,22,19,3,2,1
16,318,318,66,66,0,1,0
8,332,332,58,10,48,4,3
24,347,347,21,3,18,4,3
26,378,378,37,37,0,1,0
20,397,397,74,29,45,4,3
14,412,412,7,7,0,1,0
12,425,425,18,18,0,1,0
19,441,441,36,36,0,1,0
10,450,450,14,14,0,1,0
25,477,477,101,101,0,1,0
23,478,478,20,20,0,1,0
27,495,495,28,28,0,1,0

23,107,107,4,4,0,1,0
17,108,108,3,3,0,1,0
10,113,113,20,20,0,1,0
12,144,144,1,1,0,1,0
22,147,147,60,45,15,2,1
0,175,175,9,9,0,1,0
3,187,187,23,23,0,1,0
2,197,197,1,1,0,1,0
1,255,255,28,14,14,2,1
25,265,265,22,4,18,4,3
11,272,272,7,7,0,1,0
18,274,274,17,2,15,2,1
4,278,278,13,13,0,1,0
20,295,295,18,6,12,3,2
8,297,297,54,54,0,1,0
9,329,329,79,29,50,3,2
19,331,331,3,3,0,1,0
24,347,347,30,20,10,2,1
14,410,410,5,5,0,1,0
5,423,423,24,11,13,2,1
7,436,436,8,8,0,1,0
13,440,440,50,18,32,2,1
15,441,441,50,4,46,3,2
6,447,447,20,20,0,1,0
16,448,448,116,80,36,4,3
21,458,458,32,32,0,1,0

7,103,103,4,4,0,1,0
8,105,105,3,3,0,1,0
12,133,133,16,4,12,4,3
20,144,144,32,32,0,1,0
19,176,176,23,14,9,4,3
3,185,185,1,1,0,1,0
9,226,226,27,27,0,1,0
10,252,252,28,2,26,4,3
4,261,261,30,30,0,1,0
25,285,285,26,26,0,1,0
24,292,292,66,6,60,3,2
22,304,304,5,2,3,2,1
2,304,304,52,20,32,4,3
17,309,309,13,6,7,2,1
0,319,319,31,5,26,3,2
13,339,339,52,8,44,4,3
5,347,347,52,15,37,2,1
21,361,361,25,21,4,2,1
1,369,369,7,4,3,2,1
18,376,376,97,85,12,4,3
6,400,400,20,20,0,1,0
15,448,448,20,8,12,3,2
16,463,463,2,2,0,1,0
14,470,470,19,19,0,1,0
11,471,471,10,10,0,1,0
23,477,477,35,9,26,2,1

16,100,100,22,6,16,3,2
17,106,106,3,3,0,1,0
20,135,135,32,32,0,1,0
13,165,165,7,7,0,1,0
18,189,189,1,1,0,1,0
15,223,223,3,3,0,1,0
7,224,224,1,1,0,1,0
6,229,229,3,3,0,1,0
8,242,242,40,10,30,3,2
3,255,255,3,3,0,1,0
21,271,271,73,7,66,3,2
10,276,276,29,29,0,1,0
12,290,290,43,43,0,1,0
19,291,291,5,5,0,1,0
9,361,361,52,19,33,2,1
22,366,366,70,54,16,3,2
1,414,414,52,20,32,2,1
0,419,419,68,44,24,3,2
5,424,424,106,106,0,1,0
2,437,437,95,63,32,3,2
4,450,450,1,1,0,1,0
11,459,459,2,2,0,1,0
14,492,492,23,23,0,1,0

7,129,129,14,14,0,1,0
9,141,141,11,11,0,1,0
18,144,144,20,14,6,3,2
2,149,149,39,27,12,3,2
10,197,197,32,18,14,2,1
8,265,265,22,22,0,1,0
5,273,273,3,3,0,1,0
15,295,295,56,44,12,3,2
16,313,313,16,13,3,2,1
3,370,370,58,28,30,4,3
21,381,381,31,13,18,4,3
20,386,386,16,16,0,1,0
0,388,388,26,6,20,4,3
11,395,395,7,2,5,2,1
1,413,413,162,116,46,3,2
4,430,430,18,15,3,2,1
13,470,470,39,15,24,2,1
17,471,471,29,11,18,4,3
12,474,474,44,44,0,1,0
19,475,475,93,24,69,4,3
6,485,485,3,3,0,1,0
14,493,493,48,24,24,4,3

17,112,112,16,5,11,2,1
2,120,120,21,21,0,1,0
20,123,123,3,3,0,1,0
12,132,132,14,10,4,2,1
16,138,138,2,2,0,1,0
3,150,150,29,29,0,1,0
11,158,158,51,1,50,2,1
10,208,208,5,1,4,2,1
1,218,218,11,1,10,3,2
14,229,229,7,7,0,1,0
13,232,232,13,2,11,2,1
0,283,283,37,28,9,2,1
8,287,287,4,4,0,1,0
19,288,288,11,1,10,2,1
18,299,299,54,54,0,1,0
15,363,363,17,17,0,1,0
6,369,369,95,56,39,4,3
7,372,372,35,35,0,1,0
5,398,398,5,1,4,2,1
9,419,419,45,2,43,3,2
4,436,436,72,72,0,1,0
21,473,473,117,35,82,3,2

16,104,104,29,29,0,1,0
4,124,124,5,5,0,1,0
11,129,129,14,11,3,2,1
0,131,131,2,2,0,1,0
15,138,138,5,5,0,1,0
2,158,158,16,16,0,1,0
12,162,162,30,30,0,1,0
1,178,178,14,14,0,1,0
17,193,193,2,2,0,1,0
18,227,227,46,16,30,2,1
6,247,247,150,114,36,4,3
13,284,284,3,3,0,1,0
9,285,285,67,67,0,1,0
14,317,317,3,3,0,1,0
3,366,366,59,59,0,1,0
7,394,394,15,15,0,1,0
10,414,414,29,8,21,2,1
5,420,420,83,83,0,1,0
8,480,480,26,26,0,1,0

5,111,111,5,5,0,1,0
7,116,116,21,21,0,1,0
3,147,147,7,2,5,2,1
6,154,154,4,1,3,2,1
8,180,180,14,14,0,1,0
13,184,184,2,2,0,1,0
2,196,196,13,5,8,2,1
0,255,255,13,3,10,3,2
15,260,260,7,7,0,1,0
14,260,260,27,27,0,1,0
16,266,266,51,44,7,2,1
10,288,288,148,4,144,4,3
18,290,290,125,125,0,1,0
19,309,309,16,6,10,3,2
17,314,314,20,5,15,2,1
12,321,321,25,22,3,2,1
22,323,323,15,3,12,3,2
1,324,324,15,5,10,2,1
11,359,359,1,1,0,1,0
24,368,368,16,3,13,2,1
23,422,422,1,1,0,1,0
4,426,426,6,6,0,1,0
21,447,447,5,2,3,2,1
20,448,448,105,51,54,4,3
9,457,457,24,24,0,1,0

13,100,100,6,6,0,1,0
11,101,101,6,6,0,1,0
12,161,161,10,10,0,1,0
7,171,171,9,9,0,1,0
3,189,189,7,7,0,1,0
9,192,192,10,7,3,2,1
20,196,196,3,3,0,1,0
22,209,209,31,21,10,2,1
23,210,210,35,8,27,2,1
14,211,211,18,18,0,1,0
4,241,241,38,38,0,1,0
6,264,264,45,45,0,1,0
15,275,275,17,17,0,1,0
18,276,276,51,51,0,1,0
5,337,337,14,14,0,1,0
16,344,344,5,2,3,2,1
0,348,348,32,32,0,1,0
17,384,384,128,78,50,3,2
24,388,388,4,4,0,1,0
10,391,391,44,19,25,2,1
2,431,431,36,36,0,1,0
21,445,445,43,43,0,1,0
8,460,460,58,12,46,4,3
19,462,462,24,3,21,4,3
1,466,466,74,10,64,3,2

25,130,130,10,2,8,2,1
0,147,147,1,1,0,1,0
27,149,149,22,22,0,1,0
24,205,205,51,22,29,2,1
17,211,211,11,3,8,3,2
19,214,214,43,43,0,1,0
28,218,218,1,1,0,1,0
8,221,221,6,6,0,1,0
3,235,235,26,13,13,2,1
5,274,274,44,44,0,1,0
23,298,298,83,57,26,3,2
12,308,308,48,7,41,4,3
26,311,311,5,5,0,1,0
15,313,313,25,17,8,3,2
29,318,318,30,11,19,2,1
16,326,326,2,2,0,1,0
20,327,327,3,3,0,1,0
11,352,352,1,1,0,1,0
21,355,355,22,1,21,2,1
13,362,362,18,14,4,2,1
9,384,384,74,56,18,2,1
22,397,397,7,7,0,1,0
18,401,401,13,13,0,1,0
14,422,422,1,1,0,1,0
30,442,442,29,29,0,1,0
1,443,443,31,7,24,3,2
6,453,453,63,63,0,1,0
7,471,471,2,2,0,1,0
4,484,484,12,12,0,1,0
10,485,485,2,2,0,1,0
2,494,494,39,39,0,1,0

27,129,129,16,7,9,2,1
13,154,154,24,24,0,1,0
21,165,165,5,5,0,1,0
19,170,170,5,5,0,1,0
24,236,236,11,11,0,1,0
15,263,263,1,1,0,1,0
6,287,287,10,3,7,2,1
25,292,292,9,9,0,1,0
16,293,293,34,24,10,3,2
7,295,295,7,3,4,2,1
14,344,344,47,38,9,4,3
12,362,362,35,17,18,3,2
22,387,387,8,8,0,1,0
18,402,402,103,65,38,4,3
3,409,409,15,15,0,1,0
10,413,413,113,50,63,4,3
4,416,416,14,14,0,1,0
17,421,421,102,53,49,2,1
23,427,427,24,6,18,2,1
11,435,435,1,1,0,1,0
1,440,440,17,5,12,3,2
8,442,442,5,5,0,1,0
20,469,469,111,75,36,2,1
0,470,470,87,87,0,1,0
5,477,477,32,6,26,3,2
9,486,486,2,2,0,1,0
26,493,493,17,14,3,2,1
2,500,500,49,49,0,1,0

19,101,101,13,13,0,1,0
4,154,154,26,26,0,1,0
17,161,161,22,22,0,1,0
10,166,166,11,11,0,1,0
24,166,166,52,7,45,4,3
5,186,186,19,14,5,2,1
16,186,186,1,1,0,1,0
15,192,192,17,17,0,1,0
25,202,202,8,2,6,3,2
23,244,244,4,4,0,1,0
26,257,257,1,1,0,1,0
0,293,293,3,3,0,1,0
7,303,303,4,4,0,1,0
11,315,315,6,6,0,1,0
18,336,336,7,1,6,2,1
9,344,344,79,1,78,4,3
14,364,364,83,63,20,3,2
6,368,368,9,9,0,1,0
2,371,371,32,7,25,4,3
3,383,383,11,11,0,1,0
22,394,394,34,34,0,1,0
1,411,411,2,2,0,1,0
20,432,432,106,59,47,4,3
8,436,436,24,1,23,2,1
21,442,442,65,46,19,2,1
12,445,445,25,7,18,4,3
13,448,448,49,15,34,3,2

6,109,109,2,2,0,1,0
1,122,122,7,7,0,1,0
9,126,126,5,5,0,1,0
10,126,126,1,1,0,1,0
22,136,136,2,2,0,1,0
18,138,138,1,1,0,1,0
19,151,151,14,8,6,2,1
21,158,158,11,6,5,2,1
20,174,174,23,2,21,2,1
23,200,200,6,6,0,1,0
13,264,264,36,36,0,1,0
16,271,271,4,1,3,2,1
4,312,312,29,9,20,3,2
11,322,322,23,23,0,1,0
2,355,355,82,66,16,2,1
7,357,357,44,44,0,1,0
17,372,372,16,3,13,2,1
5,406,406,62,36,26,3,2
14,407,407,1,1,0,1,0
12,423,423,89,86,3,2,1
15,425,425,205,195,10,3,2
0,439,439,23,23,0,1,0
8,462,462,45,45,0,1,0
3,491,491,126,126,0,1,0

11,131,131,7,7,0,1,0
7,139,139,45,13,32,2,1
18,140,140,38,7,31,2,1
2,175,175,26,26,0,1,0
9,199,199,5,5,0,1,0
5,203,203,24,13,11,4,3
6,207,207,6,3,3,2,1
16,238,238,7,7,0,1,0
14,246,246,50,20,30,2,1
8,250,250,27,2,25,4,3
12,266,266,11,2,9,2,1
20,298,298,7,1,6,2,1
3,302,302,10,4,6,2,1
1,322,322,36,36,0,1,0
10,327,327,23,11,12,3,2
23,327,327,51,51,0,1,0
24,339,339,26,6,20,3,2
15,339,339,14,1,13,2,1
13,364,364,16,8,8,3,2
4,413,413,42,42,0,1,0
17,430,430,77,77,0,1,0
0,442,442,16,16,0,1,0
21,453,453,56,56,0,1,0
22,464,464,3,3,0,1,0
19,487,487,28,28,0,1,0

22,112,112,2,2,0,1,0
15,145,145,26,26,0,1,0
20,174,174,9,9,0,1,0
10,191,191,4,1,3,2,1
0,194,194,30,30,0,1,0
14,203,203,43,19,24,3,2
1,229,229,33,9,24,4,3
11,240,240,5,5,0,1,0
26,270,270,112,112,0,1,0
16,297,297,51,51,0,1,0
3,307,307,50,50,0,1,0
6,311,311,3,3,0,1,0
13,319,319,35,18,17,2,1
7,335,335,54,4,50,2,1
9,339,339,8,8,0,1,0
25,353,353,26,18,8,2,1
23,366,366,2,2,0,1,0
5,385,385,3,3,0,1,0
4,394,394,18,11,7,2,1
2,396,396,9,9,0,1,0
12,442,442,45,10,35,2,1
18,450,450,2,2,0,1,0
24,455,455,21,7,14,3,2
19,474,474,48,48,0,1,0
17,475,475,23,23,0,1,0
8,481,481,3,3,0,1,0
21,490,490,55,55,0,1,0

5,111,111,3,3,0,1,0
13,116,116,1,1,0,1,0
1,128,128,16,16,0,1,0
17,159,159,55,55,0,1,0
12,165,165,2,2,0,1,0
19,170,170,19,19,0,1,0
0,176,176,21,21,0,1,0
6,229,229,114,30,84,4,3
15,242,242,5,5,0,1,0
11,264,264,11,11,0,1,0
7,279,279,30,8,22,4,3
3,284,284,38,11,27,4,3
2,309,309,3,3,0,1,0
14,315,315,25,6,19,2,1
10,339,339,7,7,0,1,0
18,376,376,62,62,0,1,0
21,379,379,27,27,0,1,0
16,428,428,136,56,80,3,2
20,459,459,12,6,6,3,2
4,464,464,6,6,0,1,0
9,474,474,67,31,36,3,2
8,489,489,13,1,12,4,3

16,113,113,2,2,0,1,0
8,125,125,14,9,5,2,1
1,135,135,10,10,0,1,0
15,146,146,41,41,0,1,0
5,147,147,5,5,0,1,0
6,158,158,1,1,0,1,0
11,229,229,2,2,0,1,0
0,241,241,21,3,18,2,1
14,260,260,54,54,0,1,0
20,263,263,1,1,0,1,0
10,270,270,3,3,0,1,0
7,277,277,95,66,29,4,3
23,308,308,44,44,0,1,0
13,333,333,43,43,0,1,0
18,339,339,15,1,14,3,2
3,365,365,37,37,0,1,0
4,395,395,34,34,0,1,0
22,395,395,45,12,33,4,3
19,416,416,13,3,10,3,2
21,429,429,31,20,11,2,1
12,431,431,51,51,0,1,0
17,433,433,23,23,0,1,0
9,459,459,109,76,33,4,3
2,471,471,47,47,0,1,0

7,106,106,17,14,3,2,1
2,121,121,6,3,3,2,1
6,163,163,17,17,0,1,0
22,179,179,18,18,0,1,0
25,184,184,28,10,18,4,3
26,218,218,20,11,9,4,3
12,219,219,13,5,8,2,1
8,224,224,2,2,0,1,0
28,224,224,34,17,17,2,1
13,239,239,30,30,0,1,0
17,259,259,8,8,0,1,0
11,262,262,1,1,0,1,0
3,280,280,18,18,0,1,0
19,283,283,25,25,0,1,0
10,293,293,2,2,0,1,0
29,303,303,12,12,0,1,0
23,312,312,28,19,9,4,3
14,312,312,43,7,36,4,3
1,322,322,40,40,0,1,0
9,337,337,19,13,6,3,2
18,340,340,58,23,35,4,3
15,341,341,10,10,0,1,0
5,343,343,8,8,0,1,0
4,366,366,45,20,25,2,1
20,368,368,17,17,0,1,0
27,372,372,31,31,0,1,0
16,378,378,1,1,0,1,0
21,381,381,15,9,6,3,2
0,409,409,37,37,0,1,0
24,488,488,82,82,0,1,0

24,108,108,11,11,0,1,0
13,134,134,11,11,0,1,0
18,162,162,7,7,0,1,0
4,172,172,39,16,23,3,2
20,191,191,3,3,0,1,0
9,204,204,8,5,3,2,1
14,211,211,1,1,0,1,0
1,246,246,3,3,0,1,0
2,250,250,22,22,0,1,0
12,264,264,2,2,0,1,0
5,280,280,65,65,0,1,0
17,293,293,14,14,0,1,0
25,303,303,22,22,0,1,0
7,340,340,5,5,0,1,0
16,354,354,36,36,0,1,0
0,372,372,10,10,0,1,0
10,387,387,6,6,0,1,0
8,390,390,18,18,0,1,0
6,415,415,122,90,32,3,2
22,428,428,9,9,0,1,0
19,438,438,142,142,0,1,0
15,454,454,94,18,76,3,2
3,458,458,21,5,16,3,2
21,481,481,117,6,111,4,3
11,486,486,35,13,22,3,2
23,496,496,21,21,0,1,0

0,129,129,7,7,0,1,0
8,146,146,1,1,0,1,0
29,147,147,17,4,13,2,1
10,157,157,14,14,0,1,0
28,157,157,13,1,12,3,2
17,175,175,6,6,0,1,0
14,175,175,5,5,0,1,0
7,203,203,3,3,0,1,0
1,234,234,1,1,0,1,0
15,252,252,8,8,0,1,0
21,294,294,20,20,0,1,0
6,299,299,43,43,0,1,0
23,316,316,34,12,22,3,2
9,320,320,6,6,0,1,0
27,333,333,16,7,9,4,3
24,340,340,58,58,0,1,0
22,345,345,30,30,0,1,0
20,346,346,77,38,39,4,3
4,354,354,77,29,48,4,3
2,367,367,29,16,13,2,1
26,388,388,18,18,0,1,0
25,397,397,39,39,0,1,0
12,433,433,1,1,0,1,0
11,444,444,22,3,19,2,1
18,454,454,1,1,0,1,0
5,456,456,46,16,30,4,3
3,459,459,39,6,33,2,1
19,468,468,25,25,0,1,0
13,485,485,82,49,33,4,3
16,489,489,34,34,0,1,0
30,496,496,57,57,0,1,0

1,105,105,3,3,0,1,0
15,119,119,1,1,0,1,0
18,163,163,20,20,0,1,0
21,194,194,8,8,0,1,0
7,215,215,2,2,0,1,0
17,218,218,79,63,16,2,1
10,226,226,18,18,0,1,0
16,226,226,49,49,0,1,0
0,250,250,26,20,6,3,2
4,272,272,3,3,0,1,0
3,273,273,3,3,0,1,0
6,273,273,141,111,30,2,1
8,291,291,112,112,0,1,0
13,326,326,14,14,0,1,0
12,378,378,28,5,23,3,2
2,400,400,24,24,0,1,0
11,420,420,61,37,24,3,2
19,423,423,40,8,32,3,2
14,441,441,15,15,0,1,0
5,474,474,10,7,3,2,1
9,497,497,27,13,14,4,3
20,498,498,2,2,0,1,0

1,111,111,4,4,0,1,0
15,124,124,4,4,0,1,0
8,134,134,6,6,0,1,0
12,135,135,21,5,16,2,1
11,141,141,6,6,0,1,0
13,142,142,26,26,0,1,0
14,151,151,8,8,0,1,0
4,163,163,6,6,0,1,0
20,221,221,4,1,3,2,1
18,246,246,21,3,18,2,1
5,268,268,28,28,0,1,0
6,294,294,18,18,0,1,0
9,321,321,17,1,16,2,1
3,324,324,18,9,9,4,3
0,334,334,160,35,125,4,3
17,352,352,47,31,16,2,1
10,357,357,96,12,84,4,3
7,362,362,94,58,36,2,1
19,401,401,5,5,0,1,0
2,407,407,51,45,6,2,1
16,479,479,90,8,82,4,3

19,117,117,15,15,0,1,0
13,125,125,27,10,17,3,2
8,140,140,16,1,15,2,1
10,153,153,23,3,20,3,2
22,159,159,6,6,0,1,0
18,178,178,51,51,0,1,0
6,233,233,21,1,20,2,1
2,248,248,3,3,0,1,0
24,271,271,31,31,0,1,0
5,274,274,52,52,0,1,0
0,319,319,1,1,0,1,0
23,328,328,28,9,19,2,1
3,354,354,30,30,0,1,0
21,356,356,3,3,0,1,0
16,357,357,35,35,0,1,0
15,380,380,23,6,17,2,1
9,380,380,70,70,0,1,0
14,396,396,6,6,0,1,0
17,399,399,52,14,38,4,3
4,416,416,48,11,37,2,1
11,428,428,31,31,0,1,0
7,434,434,21,6,15,4,3
20,455,455,19,16,3,2,1
12,463,463,44,44,0,1,0
1,478,478,20,20,0,1,0

5,120,120,2,2,0,1,0
6,136,136,9,9,0,1,0
3,156,156,6,6,0,1,0
14,156,156,15,15,0,1,0
18,160,160,16,4,12,4,3
28,173,173,19,9,10,2,1
13,204,204,15,10,5,2,1
4,221,221,11,3,8,2,1
23,227,227,37,2,35,2,1
15,236,236,19,19,0,1,0
2,236,236,75,75,0,1,0
24,246,246,36,36,0,1,0
22,254,254,12,12,0,1,0
17,268,268,12,12,0,1,0
16,270,270,13,4,9,4,3
12,272,272,15,15,0,1,0
11,281,281,27,27,0,1,0
25,301,301,46,7,39,4,3
9,303,303,16,11,5,2,1
26,343,343,1,1,0,1,0
0,352,352,42,14,28,3,2
1,389,389,10,10,0,1,0
10,398,398,1,1,0,1,0
19,403,403,22,22,0,1,0
21,405,405,48,15,33,2,1
8,435,435,2,2,0,1,0
20,476,476,88,88,0,1,0
7,484,484,28,28,0,1,0
27,494,494,50,50,0,1,0

3,100,100,2,2,0,1,0
0,101,101,11,11,0,1,0
10,121,121,6,6,0,1,0
5,131,131,25,25,0,1,0
18,150,150,2,2,0,1,0
11,158,158,1,1,0,1,0
1,162,162,8,8,0,1,0
22,173,173,20,6,14,3,2
9,188,188,37,37,0,1,0
4,217,217,15,7,8,3,2
17,227,227,25,3,22,3,2
19,234,234,47,25,22,2,1
16,281,281,57,9,48,3,2
15,281,281,38,38,0,1,0
8,291,291,5,2,3,2,1
7,312,312,31,31,0,1,0
6,320,320,27,15,12,3,2
20,339,339,22,6,16,2,1
14,385,385,60,21,39,2,1
12,397,397,121,1,120,4,3
2,409,409,2,2,0,1,0
13,412,412,2,2,0,1,0
23,435,435,8,2,6,3,2
21,452,452,46,46,0,1,0
24,463,463,46,36,10,2,1

21,101,101,2,2,0,1,0
18,119,119,51,51,0,1,0
4,150,150,2,2,0,1,0
13,165,165,24,9,15,2,1
2,172,172,6,6,0,1,0
14,180,180,1,1,0,1,0
16,196,196,17,5,12,4,3
7,224,224,10,10,0,1,0
5,230,230,35,8,27,2,1
24,247,247,24,24,0,1,0
23,247,247,13,5,8,3,2
20,249,249,38,38,0,1,0
3,258,258,69,42,27,2,1
0,263,263,38,16,22,2,1
8,290,290,1,1,0,1,0
9,345,345,1,1,0,1,0
17,392,392,42,42,0,1,0
11,406,406,37,16,21,4,3
1,412,412,83,62,21,4,3
15,428,428,2,2,0,1,0
12,432,432,18,6,12,4,3
22,444,444,42,42,0,1,0
10,446,446,58,44,14,3,2
6,448,448,33,17,16,2,1
19,477,477,16,16,0,1,0

7,106,106,8,8,0,1,0
6,109,109,24,6,18,3,2
16,110,110,5,1,4,2,1
18,114,114,12,6,6,3,2
24,118,118,4,4,0,1,0
14,144,144,15,12,3,2,1
19,159,159,10,6,4,2,1
11,170,170,25,25,0,1,0
8,170,170,4,4,0,1,0
0,203,203,57,57,0,1,0
23,204,204,3,3,0,1,0
20,233,233,4,4,0,1,0
10,258,258,6,2,4,2,1
15,261,261,75,75,0,1,0
3,264,264,8,8,0,1,0
4,292,292,18,18,0,1,0
13,294,294,6,6,0,1,0
21,296,296,146,92,54,4,3
17,320,320,24,3,21,4,3
22,327,327,19,15,4,2,1
25,364,364,9,9,0,1,0
26,364,364,8,8,0,1,0
9,404,404,38,24,14,3,2
1,404,404,9,9,0,1,0
5,408,408,5,5,0,1,0
12,416,416,8,1,7,2,1
2,426,426,28,28,0,1,0

12,109,109,11,5,6,3,2
19,119,119,21,17,4,2,1
11,153,153,9,4,5,2,1
14,155,155,1,1,0,1,0
16,173,173,11,11,0,1,0
2,186,186,88,59,29,2,1
18,188,188,12,12,0,1,0
0,193,193,12,12,0,1,0
10,201,201,13,13,0,1,0
6,285,285,34,13,21,4,3
9,285,285,20,20,0,1,0
5,327,327,75,75,0,1,0
7,330,330,3,3,0,1,0
13,396,396,31,16,15,3,2
4,417,417,16,7,9,4,3
20,433,433,99,66,33,4,3
1,440,440,4,4,0,1,0
17,454,454,19,19,0,1,0
8,466,466,77,23,54,3,2
15,471,471,134,88,46,2,1
3,497,497,47,47,0,1,0

3,108,108,1,1,0,1,0
24,141,141,8,8,0,1,0
0,168,168,3,3,0,1,0
5,171,171,2,2,0,1,0
16,181,181,24,24,0,1,0
21,222,222,19,19,0,1,0
8,288,288,6,6,0,1,0
14,309,309,73,73,0,1,0
23,317,317,51,37,14,3,2
17,318,318,8,8,0,1,0
7,373,373,74,74,0,1,0
20,376,376,42,37,5,2,1
18,379,379,19,15,4,2,1
15,384,384,22,4,18,3,2
11,391,391,34,11,23,2,1
4,391,391,47,14,33,4,3
12,405,405,11,11,0,1,0
2,408,408,57,25,32,3,2
6,409,409,69,69,0,1,0
19,419,419,110,14,96,4,3
10,457,457,36,36,0,1,0
13,464,464,3,3,0,1,0
9,491,491,42,42,0,1,0
22,495,495,16,8,8,2,1
1,496,496,117,42,75,4,3

10,143,143,7,7,0,1,0
2,200,200,38,35,3,2,1
5,225,225,10,1,9,4,3
4,231,231,103,4,99,4,3
0,238,238,28,28,0,1,0
9,279,279,12,12,0,1,0
11,283,283,27,27,0,1,0
1,304,304,53,47,6,3,2
17,330,330,3,3,0,1,0
18,351,351,82,22,60,4,3
16,392,392,6,6,0,1,0
15,402,402,61,61,0,1,0
3,413,413,29,6,23,4,3
8,416,416,63,41,22,3,2
13,432,432,6,6,0,1,0
12,436,436,33,33,0,1,0
14,437,437,93,56,37,2,1
7,487,487,82,52,30,4,3
6,494,494,78,50,28,2,1

2,109,109,2,2,0,1,0
1,122,122,1,1,0,1,0
12,169,169,4,1,3,2,1
10,170,170,42,42,0,1,0
18,176,176,12,12,0,1,0
8,214,214,32,25,7,2,1
5,229,229,1,1,0,1,0
22,244,244,31,31,0,1,0
14,256,256,61,28,33,4,3
20,262,262,8,8,0,1,0
24,282,282,67,67,0,1,0
3,286,286,3,3,0,1,0
9,299,299,19,19,0,1,0
6,303,303,29,29,0,1,0
19,311,311,22,22,0,1,0
17,331,331,20,20,0,1,0
0,355,355,27,16,11,2,1
7,358,358,57,48,9,2,1
4,418,418,83,25,58,4,3
15,422,422,9,6,3,2,1
23,432,432,5,5,0,1,0
13,438,438,15,11,4,2,1
16,440,440,16,16,0,1,0
21,440,440,124,80,44,3,2
11,498,498,75,19,56,3,2

2,104,104,1,1,0,1,0
16,111,111,25,18,7,2,1
1,118,118,1,1,0,1,0
8,136,136,7,7,0,1,0
20,137,137,10,10,0,1,0
14,143,143,9,9,0,1,0
24,176,176,6,1,5,2,1
6,250,250,51,1,50,3,2
0,296,296,22,9,13,2,1
3,298,298,13,13,0,1,0
5,312,312,7,7,0,1,0
10,329,329,58,37,21,2,1
13,330,330,20,20,0,1,0
11,342,342,43,26,17,2,1
22,352,352,30,30,0,1,0
9,373,373,99,12,87,4,3
7,380,380,33,33,0,1,0
25,394,394,4,4,0,1,0
21,397,397,180,180,0,1,0
23,406,406,17,1,16,3,2
19,421,421,2,2,0,1,0
15,422,422,30,30,0,1,0
12,425,425,4,4,0,1,0
17,458,458,12,12,0,1,0
18,478,478,68,68,0,1,0
4,497,497,31,10,21,2,1

20,103,103,11,11,0,1,0
28,121,121,3,3,0,1,0
18,136,136,10,10,0,1,0
11,151,151,1,1,0,1,0
17,161,161,15,2,13,2,1
22,171,171,24,1,23,2,1
5,177,177,1,1,0,1,0
26,178,178,5,2,3,2,1
16,229,229,2,2,0,1,0
25,240,240,17,17,0,1,0
2,246,246,2,2,0,1,0
9,249,249,26,26,0,1,0
12,256,256,9,6,3,2,1
24,291,291,14,2,12,2,1
4,295,295,52,40,12,3,2
0,297,297,34,23,11,2,1
1,310,310,16,13,3,2,1
7,312,312,14,14,0,1,0
6,313,313,7,7,0,1,0
13,324,324,45,21,24,4,3
10,331,331,15,1,14,3,2
3,363,363,14,14,0,1,0
30,370,370,39,39,0,1,0
27,373,373,19,3,16,3,2
23,391,391,19,6,13,2,1
31,405,405,74,74,0,1,0
14,417,417,6,6,0,1,0
8,438,438,28,28,0,1,0
21,449,449,97,68,29,2,1
15,458,458,21,21,0,1,0
32,487,487,42,42,0,1,0
19,494,494,5,5,0,1,0
29,500,500,110,81,29,4,3

21,113,113,3,3,0,1,0
18,116,116,13,13,0,1,0
12,141,141,14,14,0,1,0
14,154,154,9,9,0,1,0
17,176,176,29,29,0,1,0
25,177,177,35,13,22,3,2
10,205,205,8,8,0,1,0
5,207,207,1,1,0,1,0
7,260,260,9,9,0,1,0
22,266,266,36,29,7,2,1
4,277,277,28,4,24,4,3
16,284,284,2,2,0,1,0
15,320,320,9,9,0,1,0
13,334,334,9,9,0,1,0
23,340,340,47,47,0,1,0
8,385,385,5,5,0,1,0
24,387,387,51,51,0,1,0
9,388,388,33,33,0,1,0
3,421,421,125,49,76,3,2
6,427,427,79,37,42,4,3
2,441,441,70,70,0,1,0
1,459,459,2,2,0,1,0
20,476,476,76,76,0,1,0
11,480,480,52,46,6,3,2
0,484,484,22,22,0,1,0
19,497,497,31,3,28,3,2

15,136,136,21,21,0,1,0
20,144,144,67,67,0,1,0
9,194,194,29,14,15,4,3
12,209,209,5,1,4,2,1
8,218,218,40,7,33,4,3
11,232,232,1,1,0,1,0
22,242,242,2,2,0,1,0
23,271,271,24,18,6,3,2
0,277,277,30,30,0,1,0
3,287,287,3,3,0,1,0
13,307,307,8,8,0,1,0
10,326,326,19,19,0,1,0
2,343,343,6,2,4,2,1
25,347,347,13,13,0,1,0
1,364,364,15,15,0,1,0
16,372,372,15,15,0,1,0
7,387,387,92,21,71,4,3
4,390,390,75,75,0,1,0
19,398,398,19,14,5,2,1
14,399,399,7,7,0,1,0
18,424,424,16,4,12,3,2
17,438,438,36,36,0,1,0
24,441,441,33,33,0,1,0
6,449,449,66,26,40,3,2
21,456,456,75,11,64,3,2
5,478,478,1,1,0,1,0

7,130,130,20,8,12,4,3
14,143,143,2,2,0,1,0
18,149,149,3,3,0,1,0
0,169,169,31,20,11,2,1
8,185,185,17,4,13,2,1
6,189,189,28,6,22,3,2
19,246,246,37,37,0,1,0
1,259,259,13,4,9,2,1
15,261,261,11,11,0,1,0
4,262,262,18,2,16,2,1
11,302,302,7,3,4,2,1
20,319,319,43,26,17,2,1
13,327,327,71,15,56,3,2
10,327,327,73,25,48,3,2
22,416,416,178,178,0,1,0
3,437,437,27,27,0,1,0
17,438,438,19,5,14,2,1
16,451,451,12,1,11,4,3
9,482,482,3,3,0,1,0
21,483,483,44,44,0,1,0
2,485,485,50,50,0,1,0
12,498,498,13,13,0,1,0
5,500,500,55,55,0,1,0

16,122,122,4,4,0,1,0
2,130,130,3,3,0,1,0
20,167,167,26,17,9,4,3
3,203,203,13,1,12,4,3
1,256,256,23,23,0,1,0
7,271,271,118,109,9,4,3
14,271,271,15,15,0,1,0
9,288,288,25,25,0,1,0
13,312,312,8,8,0,1,0
15,313,313,29,12,17,2,1
0,352,352,2,2,0,1,0
19,386,386,166,109,57,4,3
10,392,392,5,5,0,1,0
4,399,399,70,70,0,1,0
11,408,408,28,28,0,1,0
12,422,422,57,5,52,3,2
6,445,445,38,38,0,1,0
8,452,452,14,7,7,2,1
18,457,457,14,14,0,1,0
17,459,459,45,26,19,2,1
5,474,474,138,99,39,4,3

28,102,102,10,10,0,1,0
20,103,103,1,1,0,1,0
26,120,120,22,22,0,1,0
13,137,137,22,22,0,1,0
1,140,140,11,11,0,1,0
19,157,157,11,1,10,3,2
24,169,169,13,13,0,1,0
14,199,199,1,1,0,1,0
29,200,200,16,16,0,1,0
16,216,216,1,1,0,1,0
2,226,226,19,8,11,2,1
22,239,239,50,13,37,2,1
7,245,245,4,4,0,1,0
23,256,256,32,32,0,1,0
15,274,274,18,18,0,1,0
5,275,275,6,6,0,1,0
8,284,284,2,2,0,1,0
30,307,307,46,46,0,1,0
9,317,317,43,43,0,1,0
18,331,331,24,2,22,3,2
11,332,332,23,15,8,3,2
12,335,335,32,32,0,1,0
6,349,349,66,66,0,1,0
4,352,352,1,1,0,1,0
10,388,388,8,8,0,1,0
27,401,401,38,5,33,2,1
3,406,406,49,9,40,3,2
17,420,420,10,10,0,1,0
21,444,444,25,25,0,1,0
25,468,468,33,10,23,2,1
0,472,472,13,3,10,3,2

20,106,106,1,1,0,1,0
12,116,116,2,2,0,1,0
22,124,124,9,3,6,2,1
5,132,132,14,14,0,1,0
11,148,148,9,9,0,1,0
26,155,155,4,1,3,2,1
2,159,159,1,1,0,1,0
3,160,160,21,2,19,3,2
10,183,183,19,4,15,2,1
23,216,216,38,8,30,2,1
1,261,261,32,3,29,2,1
19,261,261,7,7,0,1,0
4,265,265,2,2,0,1,0
14,286,286,7,7,0,1,0
27,318,318,17,17,0,1,0
15,329,329,53,53,0,1,0
13,337,337,6,6,0,1,0
25,339,339,26,26,0,1,0
21,349,349,17,17,0,1,0
0,350,350,50,50,0,1,0
17,355,355,94,94,0,1,0
6,365,365,36,36,0,1,0
24,405,405,77,6,71,4,3
16,439,439,4,4,0,1,0
7,448,448,17,7,10,2,1
9,454,454,41,4,37,2,1
18,462,462,125,38,87,4,3
8,479,479,35,20,15,4,3

16,149,149,4,1,3,2,1
0,151,151,5,5,0,1,0
10,156,156,7,7,0,1,0
5,170,170,21,21,0,1,0
19,188,188,94,46,48,4,3
7,193,193,16,16,0,1,0
20,194,194,8,3,5,2,1
18,200,200,5,5,0,1,0
27,202,202,9,9,0,1,0
29,206,206,6,6,0,1,0
30,226,226,6,6,0,1,0
23,248,248,48,48,0,1,0
4,262,262,20,20,0,1,0
3,272,272,47,41,6,3,2
26,276,276,30,15,15,4,3
1,309,309,26,26,0,1,0
17,309,309,68,5,63,4,3
15,309,309,7,7,0,1,0
24,309,309,33,15,18,2,1
6,316,316,47,1,46,3,2
28,320,320,20,20,0,1,0
14,321,321,1,1,0,1,0
2,335,335,1,1,0,1,0
9,352,352,3,3,0,1,0
21,354,354,16,4,12,2,1
8,402,402,4,4,0,1,0
22,441,441,26,14,12,4,3
25,457,457,2,2,0,1,0
11,464,464,31,25,6,2,1
13,470,470,5,5,0,1,0
12,477,477,18,18,0,1,0

1,149,149,19,19,0,1,0
4,150,150,37,10,27,2,1
14,150,150,38,12,26,3,2
18,207,207,38,19,19,2,1
5,281,281,14,8,6,2,1
10,281,281,44,3,41,3,2
13,281,281,22,14,8,2,1
0,301,301,37,19,18,2,1
15,314,314,29,13,16,2,1
9,319,319,15,15,0,1,0
19,326,326,13,5,8,2,1
8,332,332,9,9,0,1,0
21,335,335,5,5,0,1,0
22,345,345,5,2,3,2,1
17,362,362,48,48,0,1,0
12,381,381,20,14,6,3,2
3,386,386,91,54,37,2,1
11,399,399,14,7,7,2,1
7,441,441,16,16,0,1,0
16,449,449,91,69,22,3,2
6,482,482,52,38,14,2,1
23,487,487,20,20,0,1,0
20,492,492,54,54,0,1,0
2,496,496,4,4,0,1,0

5,116,116,1,1,0,1,0
0,136,136,22,22,0,1,0
10,147,147,19,19,0,1,0
15,167,167,3,3,0,1,0
4,172,172,3,3,0,1,0
18,186,186,51,7,44,2,1
8,250,250,17,11,6,2,1
19,260,260,3,3,0,1,0
13,280,280,17,4,13,2,1
21,282,282,15,15,0,1,0
20,282,282,20,20,0,1,0
12,316,316,56,56,0,1,0
3,320,320,7,7,0,1,0
11,325,325,41,17,24,2,1
16,351,351,4,4,0,1,0
6,356,356,19,19,0,1,0
7,357,357,99,26,73,4,3
17,367,367,25,7,18,2,1
1,377,377,86,17,69,4,3
14,401,401,86,86,0,1,0
9,415,415,70,20,50,4,3
2,421,421,83,83,0,1,0

2,110,110,38,15,23,2,1
17,162,162,10,10,0,1,0
4,179,179,20,20,0,1,0
15,194,194,19,19,0,1,0
1,208,208,36,10,26,2,1
7,224,224,1,1,0,1,0
19,236,236,5,2,3,2,1
10,263,263,13,8,5,2,1
13,269,269,26,26,0,1,0
16,290,290,7,3,4,2,1
18,294,294,36,36,0,1,0
6,320,320,35,14,21,2,1
14,325,325,1,1,0,1,0
12,387,387,88,44,44,2,1
5,419,419,80,20,60,3,2
11,423,423,33,15,18,4,3
8,442,442,49,49,0,1,0
0,472,472,18,9,9,2,1
9,479,479,92,66,26,3,2
20,479,479,117,55,62,3,2
3,487,487,57,57,0,1,0

16,131,131,20,4,16,2,1
13,174,174,21,7,14,2,1
3,188,188,14,1,13,2,1
0,197,197,82,82,0,1,0
2,216,216,103,71,32,3,2
15,235,235,7,7,0,1,0
1,290,290,46,12,34,3,2
8,353,353,30,23,7,2,1
7,362,362,35,35,0,1,0
4,376,376,28,1,27,4,3
10,386,386,57,57,0,1,0
11,387,387,45,31,14,3,2
9,456,456,74,65,9,4,3
6,477,477,14,1,13,3,2
12,479,479,60,27,33,4,3
14,495,495,34,7,27,2,1
5,497,497,45,45,0,1,0

17,131,131,33,33,0,1,0
22,158,158,7,7,0,1,0
4,179,179,5,5,0,1,0
8,195,195,5,5,0,1,0
13,198,198,4,4,0,1,0
7,200,200,16,16,0,1,0
16,207,207,11,1,10,3,2
26,215,215,20,20,0,1,0
12,229,229,11,5,6,2,1
15,232,232,20,20,0,1,0
5,234,234,1,1,0,1,0
19,254,254,20,20,0,1,0
24,258,258,1,1,0,1,0
23,311,311,28,16,12,3,2
25,322,322,85,39,46,3,2
0,331,331,8,8,0,1,0
2,356,356,141,141,0,1,0
21,358,358,76,17,59,3,2
3,365,365,5,5,0,1,0
6,374,374,77,23,54,4,3
18,376,376,5,5,0,1,0
10,383,383,27,27,0,1,0
20,391,391,12,6,6,3,2
9,393,393,1,1,0,1,0
11,430,430,16,16,0,1,0
14,467,467,10,10,0,1,0
1,471,471,105,51,54,3,2

7,138,138,15,15,0,1,0
1,141,141,38,38,0,1,0
5,152,152,10,10,0,1,0
3,157,157,13,13,0,1,0
14,161,161,9,3,6,2,1
12,173,173,11,11,0,1,0
4,175,175,54,21,33,4,3
6,176,176,31,5,26,2,1
13,201,201,10,1,9,4,3
9,248,248,46,46,0,1,0
2,360,360,129,129,0,1,0
10,381,381,12,12,0,1,0
8,402,402,9,9,0,1,0
15,410,410,118,87,31,2,1
16,422,422,37,37,0,1,0
17,432,432,66,66,0,1,0
11,475,475,3,3,0,1,0
0,479,479,57,21,36,3,2

2,119,119,8,8,0,1,0
20,120,120,17,17,0,1,0
21,165,165,47,17,30,2,1
17,203,203,1,1,0,1,0
18,208,208,37,15,22,3,2
16,213,213,15,12,3,2,1
9,214,214,49,19,30,2,1
5,223,223,31,9,22,2,1
19,224,224,11,1,10,2,1
13,268,268,22,22,0,1,0
10,275,275,44,44,0,1,0
3,302,302,1,1,0,1,0
0,318,318,15,8,7,2,1
22,326,326,25,13,12,3,2
24,327,327,31,11,20,3,2
14,327,327,21,9,12,3,2
6,343,343,3,3,0,1,0
1,361,361,45,26,19,2,1
23,404,404,56,56,0,1,0
11,421,421,34,10,24,4,3
8,425,425,12,5,7,2,1
15,446,446,18,8,10,2,1
12,468,468,50,25,25,2,1
4,471,471,53,45,8,3,2
7,483,483,45,2,43,4,3

14,131,131,1,1,0,1,0
2,131,131,6,6,0,1,0
12,152,152,6,6,0,1,0
4,161,161,82,33,49,2,1
13,161,161,18,6,12,2,1
9,240,240,18,3,15,2,1
0,241,241,17,5,12,2,1
3,257,257,53,53,0,1,0
6,258,258,27,27,0,1,0
19,309,309,6,2,4,2,1
20,345,345,20,14,6,3,2
21,352,352,50,50,0,1,0
16,352,352,10,10,0,1,0
17,367,367,18,6,12,4,3
1,367,367,7,4,3,2,1
10,400,400,14,4,10,3,2
11,401,401,168,113,55,4,3
15,462,462,27,9,18,4,3
7,464,464,2,2,0,1,0
18,473,473,121,72,49,2,1
5,494,494,30,12,18,4,3
8,497,497,53,38,15,2,1

12,117,117,9,4,5,2,1
21,118,118,7,7,0,1,0
10,124,124,6,6,0,1,0
15,138,138,17,17,0,1,0
17,161,161,18,18,0,1,0
24,170,170,18,6,12,4,3
3,187,187,1,1,0,1,0
14,193,193,24,8,16,2,1
20,194,194,53,53,0,1,0
6,203,203,29,9,20,2,1
4,206,206,15,15,0,1,0
2,228,228,4,4,0,1,0
22,239,239,2,2,0,1,0
27,240,240,7,7,0,1,0
16,247,247,14,14,0,1,0
26,251,251,39,9,30,2,1
7,265,265,3,3,0,1,0
23,296,296,13,7,6,2,1
5,302,302,4,4,0,1,0
1,322,322,14,14,0,1,0
9,342,342,17,7,10,3,2
0,350,350,73,7,66,4,3
25,357,357,27,27,0,1,0
18,408,408,10,7,3,2,1
13,429,429,64,12,52,3,2
11,433,433,27,27,0,1,0
19,480,480,139,89,50,3,2
8,489,489,27,3,24,2,1

2,105,105,1,1,0,1,0
5,123,123,4,4,0,1,0
16,124,124,13,13,0,1,0
21,131,131,4,4,0,1,0
25,139,139,20,20,0,1,0
10,151,151,11,6,5,2,1
24,163,163,15,15,0,1,0
15,165,165,37,7,30,2,1
17,177,177,34,6,28,2,1
23,179,179,5,5,0,1,0
7,186,186,6,6,0,1,0
1,224,224,34,4,30,2,1
12,247,247,5,5,0,1,0
19,263,263,8,8,0,1,0
11,278,278,50,50,0,1,0
13,278,278,2,2,0,1,0
26,348,348,21,13,8,2,1
20,364,364,30,11,19,2,1
18,365,365,10,10,0,1,0
3,370,370,35,2,33,2,1
9,402,402,85,47,38,3,2
22,404,404,89,59,30,4,3
8,421,421,6,6,0,1,0
0,456,456,36,36,0,1,0
6,473,473,70,44,26,2,1
4,489,489,66,2,64,3,2
14,500,500,6,6,0,1,0

16,127,127,11,11,0,1,0
9,139,139,13,13,0,1,0
8,174,174,13,13,0,1,0
11,241,241,7,7,0,1,0
18,267,267,12,12,0,1,0
6,273,273,40,40,0,1,0
4,324,324,85,85,0,1,0
7,340,340,65,65,0,1,0
13,346,346,1,1,0,1,0
10,369,369,27,27,0,1,0
20,369,369,45,28,17,2,1
12,383,383,21,13,8,3,2
1,404,404,3,3,0,1,0
3,410,410,97,97,0,1,0
14,435,435,81,81,0,1,0
15,441,441,65,8,57,4,3
5,454,454,44,14,30,3,2
19,456,456,13,1,12,4,3
0,470,470,52,14,38,3,2
17,478,478,172,119,53,3,2
2,494,494,38,17,21,4,3

9,115,115,8,2,6,2,1
0,168,168,6,6,0,1,0
17,175,175,8,8,0,1,0
11,210,210,32,32,0,1,0
5,228,228,1,1,0,1,0
14,254,254,4,1,3,2,1
7,294,294,29,19,10,2,1
2,348,348,95,26,69,3,2
15,358,358,14,2,12,3,2
8,364,364,97,55,42,4,3
1,376,376,53,53,0,1,0
10,378,378,42,27,15,2,1
6,379,379,75,28,47,3,2
13,407,407,25,11,14,3,2
4,448,448,170,59,111,4,3
12,461,461,71,56,15,2,1
16,477,477,30,12,18,2,1
18,478,478,63,63,0,1,0
3,479,479,34,22,12,2,1
19,480,480,53,53,0,1,0

17,101,101,10,6,4,2,1
3,107,107,9,1,8,3,2
1,112,112,16,7,9,4,3
10,134,134,6,6,0,1,0
11,153,153,12,12,0,1,0
6,157,157,31,31,0,1,0
9,186,186,25,3,22,2,1
14,187,187,66,66,0,1,0
16,191,191,1,1,0,1,0
12,196,196,1,1,0,1,0
20,229,229,58,10,48,4,3
8,262,262,51,51,0,1,0
7,263,263,6,1,5,2,1
18,269,269,13,13,0,1,0
2,343,343,55,31,24,3,2
19,355,355,40,13,27,4,3
4,383,383,58,14,44,3,2
5,393,393,67,67,0,1,0
15,402,402,20,5,15,2,1
0,413,413,32,32,0,1,0
13,471,471,21,12,9,4,3

3,105,105,1,1,0,1,0
1,131,131,1,1,0,1,0
9,140,140,9,9,0,1,0
19,155,155,1,1,0,1,0
5,155,155,55,55,0,1,0
24,181,181,1,1,0,1,0
8,190,190,23,2,21,2,1
0,211,211,1,1,0,1,0
11,219,219,27,27,0,1,0
21,248,248,38,14,24,4,3
31,261,261,19,19,0,1,0
23,262,262,6,6,0,1,0
16,270,270,5,5,0,1,0
7,272,272,1,1,0,1,0
32,273,273,9,9,0,1,0
10,287,287,9,5,4,2,1
29,311,311,153,13,140,4,3
30,316,316,11,11,0,1,0
27,338,338,14,8,6,2,1
26,338,338,44,44,0,1,0
18,340,340,17,17,0,1,0
22,342,342,28,7,21,4,3
14,375,375,26,26,0,1,0
28,379,379,49,49,0,1,0
2,383,383,45,12,33,4,3
25,385,385,11,6,5,2,1
13,427,427,3,3,0,1,0
12,430,430,14,10,4,2,1
15,438,438,13,7,6,2,1
20,469,469,28,8,20,3,2
4,477,477,1,1,0,1,0
17,479,479,23,23,0,1,0
6,492,492,20,20,0,1,0

11,101,101,7,3,4,2,1
1,115,115,67,26,41,4,3
8,115,115,13,7,6,2,1
7,127,127,9,1,8,2,1
17,128,128,18,2,16,2,1
0,186,186,5,5,0,1,0
5,201,201,50,50,0,1,0
10,207,207,62,62,0,1,0
12,312,312,32,32,0,1,0
2,363,363,93,66,27,4,3
15,367,367,8,4,4,2,1
9,388,388,9,9,0,1,0
16,408,408,63,48,15,4,3
14,413,413,74,74,0,1,0
3,440,440,29,29,0,1,0
13,489,489,17,2,15,4,3
6,491,491,9,9,0,1,0
4,498,498,11,11,0,1,0

1,134,134,20,20,0,1,0
0,136,136,21,21,0,1,0
11,142,142,5,1,4,2,1
19,147,147,50,38,12,3,2
2,147,147,11,11,0,1,0
8,159,159,22,22,0,1,0
9,169,169,26,11,15,3,2
12,170,170,53,8,45,4,3
6,171,171,25,25,0,1,0
7,176,176,15,15,0,1,0
15,202,202,1,1,0,1,0
20,219,219,33,20,13,2,1
16,283,283,19,7,12,4,3
13,286,286,24,24,0,1,0
14,305,305,19,5,14,2,1
18,370,370,17,2,15,2,1
4,388,388,51,51,0,1,0
21,431,431,22,4,18,3,2
3,432,432,45,32,13,2,1
17,440,440,10,6,4,2,1
5,465,465,31,1,30,2,1
10,496,496,23,23,0,1,0

16,114,114,45,25,20,3,2
4,167,167,2,2,0,1,0
7,183,183,21,21,0,1,0
12,187,187,10,6,4,2,1
1,188,188,32,3,29,2,1
2,231,231,37,10,27,4,3
14,243,243,2,2,0,1,0
10,247,247,17,17,0,1,0
3,248,248,26,3,23,2,1
20,277,277,13,4,9,4,3
11,322,322,6,6,0,1,0
15,380,380,5,5,0,1,0
6,409,409,1,1,0,1,0
8,416,416,37,37,0,1,0
13,431,431,81,21,60,4,3
9,439,439,43,43,0,1,0
5,447,447,45,12,33,2,1
17,448,448,7,7,0,1,0
19,451,451,139,112,27,2,1
18,454,454,3,3,0,1,0
0,500,500,223,207,16,2,1

8,106,106,1,1,0,1,0
21,108,108,9,9,0,1,0
7,124,124,3,3,0,1,0
27,164,164,6,6,0,1,0
17,165,165,8,8,0,1,0
24,182,182,1,1,0,1,0
30,189,189,2,2,0,1,0
29,191,191,7,7,0,1,0
13,193,193,9,2,7,2,1
6,220,220,18,18,0,1,0
3,225,225,26,26,0,1,0
16,242,242,2,2,0,1,0
23,251,251,7,1,6,2,1
2,260,260,4,4,0,1,0
10,272,272,7,7,0,1,0
25,307,307,2,2,0,1,0
19,321,321,72,72,0,1,0
5,340,340,5,5,0,1,0
11,343,343,147,41,106,4,3
12,350,350,38,28,10,2,1
26,364,364,72,65,7,2,1
0,377,377,13,13,0,1,0
20,386,386,102,102,0,1,0
9,390,390,2,2,0,1,0
18,416,416,51,1,50,2,1
4,418,418,5,5,0,1,0
22,436,436,140,124,16,3,2
14,439,439,13,13,0,1,0
1,440,440,11,5,6,2,1
28,466,466,4,4,0,1,0
15,468,468,21,8,13,2,1

22,100,100,14,14,0,1,0
12,106,106,12,12,0,1,0
25,109,109,7,3,4,2,1
0,130,130,14,14,0,1,0
9,149,149,4,4,0,1,0
10,150,150,11,4,7,2,1
13,153,153,18,6,12,3,2
8,158,158,5,1,4,2,1
24,178,178,48,48,0,1,0
29,179,179,3,3,0,1,0
16,182,182,8,2,6,2,1
6,183,183,9,3,6,2,1
14,217,217,1,1,0,1,0
1,243,243,18,5,13,2,1
15,247,247,5,5,0,1,0
27,254,254,55,23,32,3,2
26,254,254,9,3,6,2,1
4,260,260,22,4,18,2,1
7,274,274,32,32,0,1,0
17,282,282,82,33,49,2,1
11,303,303,2,2,0,1,0
3,382,382,2,2,0,1,0
2,383,383,8,5,3,2,1
23,410,410,21,21,0,1,0
5,416,416,6,3,3,2,1
21,422,422,5,5,0,1,0
19,453,453,72,72,0,1,0
18,457,457,40,27,13,4,3
28,463,463,53,53,0,1,0
20,468,468,27,18,9,2,1

14,121,121,6,1,5,2,1
15,123,123,12,3,9,4,3
13,141,141,7,7,0,1,0
23,143,143,28,10,18,2,1
1,151,151,12,12,0,1,0
0,151,151,45,27,18,2,1
3,157,157,12,12,0,1,0
16,206,206,11,11,0,1,0
19,225,225,8,4,4,2,1
18,246,246,22,22,0,1,0
4,286,286,6,6,0,1,0
7,315,315,9,9,0,1,0
17,345,345,20,2,18,2,1
24,347,347,70,70,0,1,0
8,369,369,4,4,0,1,0
12,383,383,33,27,6,2,1
9,434,434,6,6,0,1,0
5,443,443,105,59,46,3,2
10,448,448,35,35,0,1,0
20,448,448,132,25,107,4,3
11,449,449,63,6,57,4,3
2,457,457,43,33,10,2,1
21,466,466,19,3,16,2,1
6,469,469,18,18,0,1,0
22,489,489,35,35,0,1,0

17,143,143,5,5,0,1,0
21,150,150,6,6,0,1,0
6,154,154,1,1,0,1,0
0,158,158,37,37,0,1,0
5,170,170,9,9,0,1,0
12,188,188,24,24,0,1,0
7,194,194,8,8,0,1,0
9,207,207,26,1,25,4,3
26,220,220,12,12,0,1,0
8,230,230,5,5,0,1,0
10,232,232,2,2,0,1,0
11,257,257,11,11,0,1,0
13,293,293,35,4,31,2,1
15,300,300,66,66,0,1,0
22,359,359,44,18,26,3,2
4,380,380,24,24,0,1,0
3,382,382,25,7,18,4,3
24,401,401,4,1,3,2,1
2,413,413,1,1,0,1,0
20,432,432,38,38,0,1,0
18,440,440,44,8,36,2,1
23,440,440,33,33,0,1,0
14,457,457,73,31,42,3,2
16,460,460,76,18,58,3,2
25,460,460,74,74,0,1,0
19,469,469,69,69,0,1,0
1,483,483,63,63,0,1,0

16,114,114,1,1,0,1,0
14,122,122,6,1,5,2,1
17,128,128,14,2,12,3,2
8,144,144,47,47,0,1,0
19,164,164,1,1,0,1,0
7,181,181,6,3,3,2,1
3,219,219,3,3,0,1,0
4,233,233,26,26,0,1,0
12,275,275,20,20,0,1,0
0,282,282,30,3,27,2,1
18,321,321,72,72,0,1,0
13,330,330,53,53,0,1,0
5,336,336,94,24,70,4,3
15,384,384,1,1,0,1,0
9,408,408,80,64,16,3,2
20,421,421,157,120,37,4,3
6,422,422,32,32,0,1,0
2,444,444,109,60,49,2,1
10,450,450,8,3,5,2,1
1,459,459,4,4,0,1,0
11,489,489,3,3,0,1,0

16,107,107,8,8,0,1,0
7,147,147,10,10,0,1,0
14,148,148,41,26,15,4,3
3,185,185,7,7,0,1,0
15,192,192,21,21,0,1,0
6,224,224,3,3,0,1,0
11,235,235,15,3,12,3,2
5,236,236,78,70,8,3,2
17,243,243,48,18,30,2,1
13,263,263,9,2,7,2,1
2,276,276,14,14,0,1,0
10,374,374,62,4,58,4,3
0,375,375,130,110,20,4,3
9,429,429,59,22,37,2,1
1,455,455,197,159,38,2,1
12,462,462,2,2,0,1,0
4,482,482,2,2,0,1,0
8,500,500,44,44,0,1,0

28,122,122,20,20,0,1,0
16,122,122,1,1,0,1,0
13,126,126,3,3,0,1,0
5,139,139,7,7,0,1,0
8,142,142,11,4,7,2,1
10,143,143,5,5,0,1,0
2,155,155,15,15,0,1,0
21,173,173,41,15,26,3,2
25,192,192,41,6,35,4,3
17,195,195,12,12,0,1,0
6,195,195,12,12,0,1,0
11,204,204,1,1,0,1,0
26,224,224,22,22,0,1,0
15,245,245,10,10,0,1,0
7,247,247,1,1,0,1,0
27,257,257,15,15,0,1,0
19,273,273,27,27,0,1,0
4,281,281,1,1,0,1,0
22,302,302,5,5,0,1,0
0,318,318,48,48,0,1,0
3,327,327,8,8,0,1,0
9,327,327,62,24,38,3,2
1,378,378,115,22,93,4,3
20,395,395,5,2,3,2,1
18,396,396,71,71,0,1,0
23,420,420,15,15,0,1,0
12,449,449,10,10,0,1,0
24,464,464,19,19,0,1,0
14,475,475,51,7,44,4,3

11,102,102,5,5,0,1,0
23,109,109,1,1,0,1,0
30,119,119,18,6,12,2,1
16,127,127,1,1,0,1,0
2,133,133,2,2,0,1,0
14,141,141,5,5,0,1,0
15,154,154,1,1,0,1,0
7,162,162,1,1,0,1,0
19,164,164,3,3,0,1,0
24,170,170,9,4,5,2,1
31,178,178,5,5,0,1,0
10,180,180,55,55,0,1,0
9,181,181,2,2,0,1,0
5,185,185,12,6,6,2,1
27,185,185,40,40,0,1,0
21,194,194,15,6,9,2,1
32,220,220,61,13,48,2,1
12,224,224,19,19,0,1,0
28,238,238,51,51,0,1,0
1,249,249,13,13,0,1,0
26,257,257,2,2,0,1,0
25,258,258,26,26,0,1,0
8,276,276,8,5,3,2,1
4,282,282,42,42,0,1,0
13,300,300,5,5,0,1,0
0,339,339,7,7,0,1,0
17,380,380,1,1,0,1,0
36,382,382,1,1,0,1,0
20,383,383,2,2,0,1,0
6,440,440,19,19,0,1,0
33,445,445,65,65,0,1,0
29,459,459,19,11,8,3,2
18,465,465,1,1,0,1,0
34,470,470,2,2,0,1,0
22,472,472,10,10,0,1,0
37,477,477,47,12,35,2,1
35,480,480,20,20,0,1,0
3,487,487,7,4,3,2,1

13,102,102,3,3,0,1,0
10,112,112,4,4,0,1,0
19,115,115,8,8,0,1,0
14,120,120,8,8,0,1,0
18,131,131,7,7,0,1,0
4,154,154,3,3,0,1,0
22,202,202,9,6,3,2,1
12,224,224,30,11,19,2,1
17,252,252,37,37,0,1,0
16,258,258,2,2,0,1,0
1,292,292,23,18,5,2,1
0,305,305,23,23,0,1,0
15,309,309,16,7,9,2,1
23,319,319,40,40,0,1,0
26,324,324,20,20,0,1,0
7,365,365,46,46,0,1,0
25,367,367,1,1,0,1,0
8,379,379,13,7,6,3,2
24,388,388,98,48,50,4,3
20,404,404,144,71,73,4,3
3,405,405,46,28,18,4,3
21,410,410,36,36,0,1,0
2,413,413,49,49,0,1,0
9,444,444,42,42,0,1,0
6,450,450,9,9,0,1,0
27,471,471,8,4,4,2,1
11,477,477,3,3,0,1,0
5,489,489,97,43,54,3,2

30,114,114,16,16,0,1,0
25,118,118,32,32,0,1,0
0,159,159,7,1,6,3,2
20,203,203,3,3,0,1,0
7,215,215,48,41,7,2,1
26,233,233,1,1,0,1,0
8,235,235,1,1,0,1,0
4,241,241,3,3,0,1,0
1,251,251,6,6,0,1,0
12,260,260,6,6,0,1,0
16,265,265,28,1,27,2,1
10,272,272,10,10,0,1,0
18,284,284,4,4,0,1,0
14,295,295,46,46,0,1,0
27,303,303,8,5,3,2,1
17,315,315,1,1,0,1,0
2,318,318,46,46,0,1,0
19,323,323,1,1,0,1,0
22,337,337,52,52,0,1,0
3,370,370,31,24,7,2,1
29,377,377,96,13,83,4,3
24,396,396,78,18,60,4,3
5,422,422,2,2,0,1,0
28,428,428,13,13,0,1,0
23,437,437,1,1,0,1,0
21,447,447,55,55,0,1,0
9,452,452,46,39,7,2,1
6,470,470,1,1,0,1,0
15,481,481,44,44,0,1,0
13,484,484,9,9,0,1,0
11,493,493,53,36,17,2,1

13,112,112,1,1,0,1,0
3,113,113,6,6,0,1,0
10,127,127,32,12,20,4,3
21,142,142,32,32,0,1,0
15,148,148,6,6,0,1,0
0,154,154,3,3,0,1,0
17,159,159,9,9,0,1,0
9,162,162,9,9,0,1,0
19,164,164,21,12,9,4,3
11,188,188,4,4,0,1,0
6,215,215,1,1,0,1,0
7,218,218,24,8,16,2,1
8,231,231,57,57,0,1,0
16,238,238,13,13,0,1,0
4,240,240,43,4,39,4,3
14,247,247,38,38,0,1,0
23,256,256,20,20,0,1,0
12,290,290,27,3,24,3,2
5,307,307,9,9,0,1,0
22,326,326,39,21,18,4,3
2,330,330,26,26,0,1,0
20,337,337,62,62,0,1,0
24,370,370,13,13,0,1,0
25,371,371,48,10,38,4,3
18,419,419,10,10,0,1,0
1,454,454,22,22,0,1,0

19,103,103,10,2,8,3,2
7,130,130,16,8,8,3,2
14,141,141,18,18,0,1,0
4,149,149,7,7,0,1,0
0,187,187,25,15,10,2,1
10,188,188,5,5,0,1,0
17,196,196,6,6,0,1,0
9,204,204,5,5,0,1,0
1,218,218,32,32,0,1,0
12,238,238,19,19,0,1,0
18,243,243,3,3,0,1,0
16,244,244,28,8,20,2,1
6,270,270,85,40,45,2,1
2,274,274,70,57,13,2,1
8,333,333,17,3,14,3,2
15,354,354,2,2,0,1,0
13,368,368,38,3,35,3,2
11,404,404,127,107,20,3,2
5,426,426,51,51,0,1,0
3,446,446,5,5,0,1,0
20,475,475,139,8,131,4,3

24,104,104,13,13,0,1,0
2,105,105,5,5,0,1,0
28,109,109,6,3,3,2,1
18,132,132,1,1,0,1,0
10,157,157,3,3,0,1,0
20,185,185,8,8,0,1,0
3,239,239,9,9,0,1,0
8,242,242,27,27,0,1,0
1,243,243,2,2,0,1,0
22,253,253,38,38,0,1,0
7,260,260,8,8,0,1,0
17,276,276,54,14,40,3,2
5,285,285,22,22,0,1,0
27,302,302,24,4,20,3,2
4,309,309,16,16,0,1,0
26,312,312,37,37,0,1,0
25,320,320,16,16,0,1,0
19,342,342,24,24,0,1,0
15,357,357,45,45,0,1,0
21,405,405,115,16,99,4,3
16,438,438,43,43,0,1,0
11,442,442,64,64,0,1,0
9,449,449,1,1,0,1,0
6,471,471,11,11,0,1,0
0,474,474,66,63,3,2,1
23,482,482,22,22,0,1,0
13,487,487,8,3,5,2,1
14,492,492,37,1,36,3,2
12,499,499,96,33,63,4,3

21,100,100,3,3,0,1,0
13,104,104,3,3,0,1,0
0,163,163,14,14,0,1,0
12,173,173,4,4,0,1,0
16,210,210,59,59,0,1,0
15,219,219,12,9,3,2,1
5,223,223,17,11,6,2,1
7,227,227,62,33,29,2,1
1,228,228,17,1,16,2,1
8,232,232,70,40,30,2,1
4,233,233,37,12,25,2,1
17,237,237,45,21,24,4,3
19,270,270,7,7,0,1,0
9,280,280,1,1,0,1,0
3,289,289,25,25,0,1,0
20,297,297,34,13,21,2,1
6,332,332,21,21,0,1,0
10,343,343,12,2,10,2,1
22,393,393,20,20,0,1,0
14,401,401,17,2,15,4,3
18,403,403,8,3,5,2,1
11,416,416,154,90,64,4,3
2,465,465,20,11,9,4,3

3,146,146,14,4,10,2,1
7,164,164,12,3,9,2,1
8,171,171,2,2,0,1,0
10,203,203,47,39,8,3,2
13,205,205,68,68,0,1,0
9,211,211,5,5,0,1,0
4,236,236,7,1,6,2,1
1,279,279,156,6,150,4,3
15,287,287,18,18,0,1,0
14,291,291,11,11,0,1,0
6,300,300,3,3,0,1,0
17,359,359,17,17,0,1,0
5,378,378,31,4,27,2,1
0,389,389,17,17,0,1,0
16,400,400,9,1,8,3,2
11,428,428,21,21,0,1,0
18,428,428,132,125,7,2,1
12,431,431,9,9,0,1,0
2,462,462,176,146,30,2,1

12,163,163,1,1,0,1,0
5,183,183,18,2,16,2,1
18,183,183,20,1,19,2,1
10,194,194,1,1,0,1,0
7,208,208,33,28,5,2,1
20,218,218,23,23,0,1,0
9,247,247,89,89,0,1,0
24,264,264,29,29,0,1,0
2,274,274,4,4,0,1,0
16,277,277,44,8,36,2,1
6,291,291,27,19,8,2,1
14,370,370,56,51,5,2,1
22,377,377,13,13,0,1,0
3,380,380,8,8,0,1,0
23,382,382,9,4,5,2,1
19,414,414,11,4,7,2,1
4,417,417,50,29,21,2,1
11,419,419,74,56,18,4,3
17,424,424,12,4,8,2,1
21,435,435,58,12,46,3,2
1,453,453,7,7,0,1,0
13,455,455,63,55,8,3,2
0,469,469,28,11,17,2,1
8,476,476,34,12,22,3,2
15,494,494,95,95,0,1,0

15,104,104,2,2,0,1,0
21,107,107,9,9,0,1,0
5,149,149,23,13,10,3,2
8,154,154,35,2,33,2,1
14,165,165,40,40,0,1,0
1,186,186,2,2,0,1,0
27,197,197,13,4,9,4,3
25,203,203,27,27,0,1,0
18,216,216,6,6,0,1,0
16,243,243,12,12,0,1,0
0,251,251,24,2,22,3,2
10,255,255,3,3,0,1,0
24,278,278,30,30,0,1,0
23,282,282,43,19,24,2,1
13,317,317,18,18,0,1,0
4,326,326,1,1,0,1,0
2,413,413,60,55,5,2,1
11,422,422,11,11,0,1,0
26,424,424,88,41,47,2,1
12,428,428,53,9,44,2,1
22,453,453,45,2,43,3,2
9,458,458,12,2,10,2,1
7,465,465,3,3,0,1,0
19,467,467,96,96,0,1,0
17,479,479,3,3,0,1,0
3,482,482,14,14,0,1,0
6,484,484,14,14,0,1,0
20,488,488,43,10,33,2,1

9,116,116,13,1,12,4,3
13,130,130,11,1,10,2,1
3,138,138,2,2,0,1,0
6,161,161,5,5,0,1,0
7,161,161,20,20,0,1,0
0,173,173,27,27,0,1,0
10,177,177,33,26,7,2,1
14,179,179,10,4,6,2,1
18,229,229,28,28,0,1,0
12,262,262,20,1,19,2,1
20,309,309,4,4,0,1,0
11,324,324,45,45,0,1,0
8,385,385,16,16,0,1,0
5,417,417,104,104,0,1,0
2,439,439,196,196,0,1,0
17,440,440,50,50,0,1,0
15,456,456,21,13,8,3,2
4,468,468,30,30,0,1,0
19,481,481,42,42,0,1,0
1,498,498,37,17,20,2,1
16,499,499,91,81,10,2,1

5,100,100,6,1,5,2,1
20,122,122,28,28,0,1,0
2,131,131,2,2,0,1,0
13,132,132,8,8,0,1,0
22,139,139,38,38,0,1,0
7,143,143,13,13,0,1,0
0,156,156,5,5,0,1,0
19,156,156,6,2,4,2,1
11,164,164,56,5,51,4,3
24,187,187,10,2,8,3,2
18,284,284,3,3,0,1,0
3,317,317,3,3,0,1,0
15,326,326,27,27,0,1,0
9,327,327,34,14,20,2,1
16,334,334,20,20,0,1,0
21,338,338,88,6,82,3,2
17,342,342,17,1,16,2,1
1,353,353,53,9,44,2,1
4,372,372,51,11,40,2,1
6,396,396,14,14,0,1,0
14,418,418,12,6,6,3,2
23,427,427,35,35,0,1,0
12,467,467,34,34,0,1,0
8,481,481,34,7,27,4,3
10,483,483,40,1,39,4,3

9,106,106,1,1,0,1,0
7,107,107,11,11,0,1,0
17,118,118,8,8,0,1,0
16,125,125,10,10,0,1,0
14,131,131,18,18,0,1,0
12,147,147,29,29,0,1,0
13,180,180,38,11,27,2,1
4,250,250,34,34,0,1,0
18,284,284,36,36,0,1,0
6,318,318,32,32,0,1,0
0,325,325,4,1,3,2,1
22,329,329,2,2,0,1,0
19,334,334,15,10,5,2,1
3,361,361,50,50,0,1,0
23,371,371,41,41,0,1,0
5,374,374,4,4,0,1,0
20,407,407,55,36,19,2,1
11,414,414,27,27,0,1,0
1,424,424,166,145,21,4,3
8,426,426,58,58,0,1,0
21,433,433,10,10,0,1,0
15,442,442,40,40,0,1,0
2,459,459,25,10,15,4,3
10,488,488,21,21,0,1,0

16,142,142,17,17,0,1,0
12,148,148,11,11,0,1,0
1,149,149,8,3,5,2,1
0,157,157,16,2,14,2,1
6,171,171,16,2,14,3,2
2,179,179,6,6,0,1,0
18,222,222,64,48,16,3,2
14,260,260,5,5,0,1,0
8,265,265,36,36,0,1,0
15,274,274,24,1,23,4,3
7,276,276,18,18,0,1,0
9,312,312,62,16,46,2,1
23,329,329,26,26,0,1,0
22,338,338,6,3,3,2,1
10,371,371,54,42,12,3,2
17,398,398,45,5,40,2,1
13,409,409,30,2,28,3,2
4,420,420,37,16,21,2,1
11,429,429,23,5,18,4,3
3,441,441,53,5,48,4,3
20,443,443,9,4,5,2,1
5,453,453,50,1,49,4,3
21,485,485,110,92,18,3,2
19,494,494,50,34,16,2,1

25,101,101,14,14,0,1,0
24,109,109,4,4,0,1,0
8,128,128,1,1,0,1,0
10,129,129,6,6,0,1,0
5,142,142,8,8,0,1,0
15,154,154,1,1,0,1,0
19,154,154,5,5,0,1,0
18,160,160,20,9,11,2,1
9,211,211,9,1,8,3,2
21,215,215,7,7,0,1,0
14,246,246,119,119,0,1,0
16,254,254,21,21,0,1,0
6,256,256,82,44,38,3,2
3,258,258,1,1,0,1,0
7,261,261,2,2,0,1,0
2,284,284,7,7,0,1,0
12,298,298,14,5,9,4,3
0,329,329,154,154,0,1,0
1,350,350,29,29,0,1,0
4,371,371,2,2,0,1,0
17,406,406,15,15,0,1,0
11,419,419,2,2,0,1,0
22,438,438,58,58,0,1,0
13,446,446,37,4,33,4,3
23,484,484,28,7,21,2,1
20,494,494,33,33,0,1,0

10,105,105,14,2,12,2,1
19,111,111,5,1,4,2,1
28,127,127,46,46,0,1,0
2,144,144,2,2,0,1,0
12,158,158,14,14,0,1,0
24,173,173,25,1,24,4,3
8,184,184,1,1,0,1,0
27,187,187,12,12,0,1,0
5,204,204,13,13,0,1,0
13,237,237,31,13,18,2,1
20,244,244,32,32,0,1,0
18,257,257,44,3,41,3,2
0,259,259,55,16,39,2,1
25,261,261,15,11,4,2,1
26,262,262,3,3,0,1,0
16,281,281,14,14,0,1,0
11,282,282,3,3,0,1,0
22,288,288,26,3,23,2,1
9,317,317,13,13,0,1,0
29,330,330,14,2,12,3,2
3,358,358,3,3,0,1,0
23,386,386,31,31,0,1,0
7,395,395,6,6,0,1,0
17,411,411,9,9,0,1,0
6,424,424,5,5,0,1,0
21,429,429,13,3,10,2,1
15,438,438,25,4,21,4,3
1,447,447,80,77,3,2,1
14,460,460,64,64,0,1,0
4,467,467,9,9,0,1,0

11,102,102,7,7,0,1,0
6,106,106,43,43,0,1,0
7,113,113,13,13,0,1,0
17,129,129,11,11,0,1,0
18,138,138,1,1,0,1,0
8,142,142,8,8,0,1,0
1,184,184,11,2,9,2,1
0,196,196,45,45,0,1,0
3,255,255,17,3,14,3,2
16,273,273,11,8,3,2,1
19,274,274,73,1,72,4,3
2,327,327,33,33,0,1,0
15,339,339,3,3,0,1,0
4,358,358,71,15,56,3,2
9,400,400,25,22,3,2,1
10,406,406,100,85,15,3,2
5,412,412,12,8,4,2,1
14,428,428,122,22,100,3,2
12,430,430,30,9,21,2,1
13,440,440,17,1,16,2,1

16,124,124,5,5,0,1,0
5,172,172,9,5,4,2,1
19,188,188,26,26,0,1,0
24,189,189,9,4,5,2,1
23,195,195,32,5,27,4,3
11,203,203,9,9,0,1,0
29,249,249,93,76,17,2,1
17,253,253,2,2,0,1,0
27,263,263,15,15,0,1,0
14,300,300,47,47,0,1,0
33,309,309,35,35,0,1,0
25,312,312,28,28,0,1,0
18,316,316,72,58,14,4,3
26,325,325,3,3,0,1,0
8,340,340,38,13,25,2,1
7,351,351,7,7,0,1,0
32,359,359,40,5,35,2,1
4,362,362,1,1,0,1,0
6,371,371,21,21,0,1,0
10,383,383,8,4,4,2,1
9,407,407,1,1,0,1,0
22,410,410,25,25,0,1,0
21,423,423,3,3,0,1,0
13,437,437,31,7,24,4,3
15,438,438,49,40,9,4,3
30,442,442,30,30,0,1,0
1,464,464,19,19,0,1,0
3,467,467,23,23,0,1,0
20,470,470,6,6,0,1,0
0,471,471,2,2,0,1,0
12,480,480,5,5,0,1,0
28,493,493,14,14,0,1,0
31,493,493,48,48,0,1,0
2,499,499,6,6,0,1,0

13,121,121,15,6,9,2,1
1,157,157,8,8,0,1,0
7,158,158,10,10,0,1,0
2,181,181,7,7,0,1,0
3,227,227,13,13,0,1,0
5,243,243,18,18,0,1,0
12,274,274,15,15,0,1,0
6,290,290,22,2,20,3,2
15,308,308,38,38,0,1,0
4,310,310,24,6,18,4,3
21,317,317,5,5,0,1,0
11,325,325,51,5,46,3,2
8,326,326,14,6,8,3,2
16,342,342,12,6,6,3,2
18,363,363,10,3,7,2,1
22,369,369,58,58,0,1,0
9,387,387,29,4,25,2,1
17,392,392,47,47,0,1,0
0,395,395,48,48,0,1,0
10,416,416,153,31,122,4,3
20,418,418,3,3,0,1,0
14,438,438,4,4,0,1,0
19,452,452,35,35,0,1,0
23,458,458,214,121,93,4,3

11,119,119,24,24,0,1,0
18,144,144,27,3,24,2,1
21,157,157,6,6,0,1,0
10,186,186,9,9,0,1,0
15,187,187,13,13,0,1,0
14,202,202,4,4,0,1,0
3,219,219,53,34,19,4,3
17,223,223,7,1,6,2,1
20,254,254,28,28,0,1,0
0,288,288,26,26,0,1,0
1,296,296,2,2,0,1,0
2,325,325,55,51,4,2,1
12,334,334,77,41,36,3,2
6,342,342,42,42,0,1,0
13,356,356,43,43,0,1,0
9,362,362,25,2,23,2,1
19,383,383,25,25,0,1,0
7,389,389,107,101,6,3,2
8,391,391,11,8,3,2,1
4,392,392,37,37,0,1,0
5,406,406,42,5,37,2,1
16,466,466,45,31,14,3,2

19,111,111,14,14,0,1,0
22,112,112,3,3,0,1,0
11,134,134,4,4,0,1,0
4,162,162,1,1,0,1,0
1,168,168,9,4,5,2,1
12,168,168,11,11,0,1,0
0,206,206,6,6,0,1,0
9,217,217,3,3,0,1,0
27,217,217,51,38,13,2,1
28,221,221,10,10,0,1,0
7,224,224,26,26,0,1,0
13,240,240,18,18,0,1,0
2,242,242,29,29,0,1,0
14,243,243,1,1,0,1,0
8,272,272,4,4,0,1,0
25,275,275,26,26,0,1,0
21,297,297,5,5,0,1,0
15,303,303,39,7,32,3,2
26,339,339,39,39,0,1,0
6,348,348,1,1,0,1,0
16,364,364,65,29,36,3,2
5,367,367,6,6,0,1,0
3,388,388,83,42,41,2,1
23,392,392,9,1,8,2,1
17,418,418,109,109,0,1,0
10,444,444,59,59,0,1,0
20,449,449,77,77,0,1,0
24,474,474,23,18,5,2,1
18,480,480,26,12,14,2,1

15,108,108,11,3,8,2,1
6,108,108,28,19,9,2,1
21,112,112,42,1,41,2,1
18,114,114,1,1,0,1,0
17,160,160,5,5,0,1,0
22,165,165,12,12,0,1,0
2,188,188,9,9,0,1,0
7,189,189,35,23,12,4,3
1,197,197,40,40,0,1,0
5,200,200,3,3,0,1,0
19,216,216,15,15,0,1,0
10,229,229,14,3,11,4,3
16,233,233,10,10,0,1,0
14,286,286,5,1,4,2,1
3,365,365,24,15,9,4,3
12,375,375,6,6,0,1,0
9,383,383,13,13,0,1,0
11,398,398,186,186,0,1,0
20,402,402,7,7,0,1,0
8,440,440,49,16,33,2,1
13,451,451,10,2,8,3,2
0,479,479,97,97,0,1,0
4,493,493,8,2,6,3,2

9,128,128,15,15,0,1,0
14,129,129,14,6,8,2,1
23,133,133,13,3,10,3,2
4,138,138,14,14,0,1,0
6,148,148,6,6,0,1,0
16,175,175,79,7,72,3,2
24,177,177,5,5,0,1,0
18,264,264,40,25,15,4,3
10,270,270,13,4,9,2,1
3,273,273,41,21,20,2,1
12,285,285,30,30,0,1,0
5,301,301,44,44,0,1,0
0,303,303,12,12,0,1,0
11,304,304,26,19,7,2,1
19,322,322,10,10,0,1,0
8,364,364,89,74,15,2,1
22,388,388,3,3,0,1,0
21,414,414,7,3,4,2,1
20,430,430,26,10,16,3,2
7,451,451,8,8,0,1,0
2,460,460,18,18,0,1,0
15,468,468,49,9,40,3,2
13,484,484,6,2,4,2,1
1,489,489,33,8,25,2,1
17,497,497,74,74,0,1,0

10,130,130,7,3,4,2,1
5,132,132,8,8,0,1,0
18,195,195,7,7,0,1,0
13,234,234,6,6,0,1,0
19,253,253,63,10,53,4,3
11,271,271,25,25,0,1,0
8,286,286,72,72,0,1,0
16,313,313,81,55,26,2,1
4,329,329,41,41,0,1,0
1,342,342,62,62,0,1,0
0,342,342,1,1,0,1,0
6,343,343,46,10,36,2,1
2,358,358,62,19,43,3,2
9,373,373,81,81,0,1,0
14,386,386,6,6,0,1,0
15,415,415,93,36,57,4,3
20,436,436,10,10,0,1,0
17,450,450,11,11,0,1,0
7,458,458,9,1,8,3,2
12,459,459,76,52,24,2,1
21,491,491,24,10,14,2,1
3,493,493,18,11,7,2,1

12,102,102,14,14,0,1,0
29,115,115,29,11,18,2,1
19,124,124,1,1,0,1,0
23,125,125,10,7,3,2,1
35,143,143,5,5,0,1,0
16,146,146,1,1,0,1,0
3,147,147,4,4,0,1,0
11,155,155,3,3,0,1,0
30,161,161,1,1,0,1,0
5,163,163,21,4,17,2,1
31,187,187,28,1,27,3,2
10,212,212,4,4,0,1,0
9,223,223,19,19,0,1,0
22,224,224,8,8,0,1,0
1,225,225,4,4,0,1,0
6,227,227,7,1,6,2,1
18,227,227,2,2,0,1,0
36,235,235,16,16,0,1,0
13,245,245,27,20,7,2,1
0,268,268,6,1,5,2,1
20,289,289,13,13,0,1,0
25,303,303,9,9,0,1,0
15,337,337,1,1,0,1,0
34,338,338,12,3,9,2,1
21,340,340,40,17,23,2,1
2,348,348,11,11,0,1,0
28,350,350,30,14,16,2,1
26,365,365,130,25,105,4,3
7,368,368,16,11,5,2,1
4,399,399,49,49,0,1,0
33,426,426,26,26,0,1,0
17,448,448,18,5,13,2,1
27,452,452,43,37,6,2,1
14,456,456,3,3,0,1,0
24,461,461,11,11,0,1,0
8,462,462,14,11,3,2,1
32,488,488,29,2,27,4,3

16,111,111,20,17,3,2,1
17,140,140,2,2,0,1,0
2,145,145,36,10,26,2,1
14,184,184,7,7,0,1,0
13,200,200,43,43,0,1,0
11,240,240,4,4,0,1,0
9,276,276,47,39,8,2,1
7,299,299,90,2,88,4,3
0,344,344,14,1,13,4,3
8,378,378,31,31,0,1,0
6,379,379,30,4,26,2,1
15,395,395,26,26,0,1,0
3,405,405,18,7,11,2,1
18,424,424,27,5,22,2,1
12,425,425,29,29,0,1,0
5,459,459,12,12,0,1,0
10,465,465,49,34,15,4,3
19,494,494,101,4,97,4,3
4,495,495,34,34,0,1,0
1,496,496,195,78,117,4,3

4,112,112,2,2,0,1,0
17,121,121,7,7,0,1,0
16,140,140,15,15,0,1,0
13,154,154,1,1,0,1,0
15,170,170,37,17,20,2,1
11,176,176,7,1,6,3,2
0,217,217,15,15,0,1,0
9,241,241,26,26,0,1,0
19,246,246,10,10,0,1,0
21,256,256,9,9,0,1,0
5,271,271,18,18,0,1,0
24,273,273,10,10,0,1,0
20,277,277,13,2,11,2,1
8,298,298,29,14,15,4,3
10,299,299,34,8,26,2,1
18,321,321,127,127,0,1,0
3,338,338,86,32,54,3,2
2,406,406,6,6,0,1,0
7,408,408,63,63,0,1,0
22,416,416,55,28,27,4,3
14,446,446,22,7,15,4,3
6,447,447,10,10,0,1,0
23,471,471,45,45,0,1,0
25,473,473,5,5,0,1,0
1,475,475,91,10,81,3,2
12,500,500,22,22,0,1,0

4,118,118,24,24,0,1,0
19,149,149,12,3,9,4,3
24,156,156,17,3,14,3,2
9,165,165,2,2,0,1,0
6,173,173,10,7,3,2,1
13,181,181,12,5,7,3,2
2,208,208,32,4,28,3,2
12,216,216,37,37,0,1,0
14,241,241,83,50,33,4,3
21,244,244,23,23,0,1,0
23,249,249,47,16,31,4,3
1,260,260,5,5,0,1,0
18,279,279,2,2,0,1,0
3,289,289,5,5,0,1,0
20,307,307,17,7,10,2,1
22,319,319,3,3,0,1,0
7,339,339,21,21,0,1,0
8,348,348,35,6,29,3,2
15,349,349,38,6,32,2,1
17,357,357,41,41,0,1,0
10,377,377,65,40,25,2,1
16,381,381,16,16,0,1,0
5,395,395,31,31,0,1,0
11,451,451,47,35,12,2,1
0,498,498,25,4,21,2,1

2,132,132,11,3,8,3,2
18,135,135,28,28,0,1,0
12,136,136,4,4,0,1,0
14,137,137,28,28,0,1,0
7,217,217,1,1,0,1,0
13,218,218,11,11,0,1,0
8,246,246,91,91,0,1,0
1,270,270,42,42,0,1,0
15,271,271,7,7,0,1,0
17,281,281,2,2,0,1,0
19,300,300,37,29,8,3,2
10,303,303,2,2,0,1,0
3,318,318,96,75,21,4,3
11,323,323,49,43,6,3,2
4,324,324,14,14,0,1,0
21,356,356,76,76,0,1,0
6,372,372,19,19,0,1,0
16,376,376,46,13,33,2,1
20,409,409,1,1,0,1,0
9,419,419,14,14,0,1,0
22,463,463,39,34,5,2,1
0,479,479,50,38,12,2,1
5,497,497,23,23,0,1,0

13,134,134,1,1,0,1,0
8,144,144,9,3,6,3,2
12,161,161,20,20,0,1,0
4,215,215,41,41,0,1,0
0,243,243,30,3,27,4,3
5,257,257,4,4,0,1,0
11,267,267,37,37,0,1,0
3,284,284,1,1,0,1,0
2,285,285,71,8,63,4,3
21,289,289,27,4,23,4,3
19,292,292,27,27,0,1,0
14,315,315,47,47,0,1,0
10,318,318,25,25,0,1,0
9,358,358,81,39,42,3,2
16,402,402,105,43,62,3,2
17,404,404,5,5,0,1,0
20,419,419,35,35,0,1,0
15,437,437,39,39,0,1,0
1,442,442,10,10,0,1,0
18,469,469,67,67,0,1,0
6,489,489,36,2,34,2,1
22,490,490,13,4,9,2,1
7,492,492,77,77,0,1,0

16,130,130,9,9,0,1,0
11,145,145,4,4,0,1,0
7,162,162,10,3,7,2,1
21,193,193,11,11,0,1,0
3,194,194,1,1,0,1,0
1,209,209,32,9,23,2,1
20,225,225,3,3,0,1,0
23,254,254,32,32,0,1,0
14,258,258,18,18,0,1,0
2,292,292,24,2,22,2,1
0,295,295,47,25,22,3,2
6,296,296,13,6,7,2,1
10,324,324,72,12,60,4,3
13,338,338,1,1,0,1,0
15,357,357,45,45,0,1,0
8,388,388,13,1,12,4,3
9,394,394,19,1,18,2,1
17,426,426,103,61,42,2,1
22,439,439,28,28,0,1,0
18,447,447,32,32,0,1,0
4,452,452,6,6,0,1,0
5,454,454,80,80,0,1,0
19,474,474,153,126,27,4,3
24,487,487,29,2,27,3,2
12,492,492,86,61,25,2,1

20,109,109,15,6,9,4,3
21,154,154,15,1,14,2,1
8,169,169,2,2,0,1,0
15,207,207,1,1,0,1,0
22,216,216,46,46,0,1,0
19,233,233,18,6,12,3,2
18,236,236,31,31,0,1,0
7,275,275,7,7,0,1,0
16,283,283,68,16,52,4,3
11,304,304,4,4,0,1,0
13,318,318,4,4,0,1,0
23,326,326,1,1,0,1,0
2,331,331,6,3,3,2,1
6,362,362,44,35,9,4,3
24,373,373,54,54,0,1,0
14,381,381,61,19,42,3,2
10,415,415,132,96,36,2,1
0,415,415,103,37,66,4,3
1,417,417,5,1,4,2,1
4,427,427,13,10,3,2,1
17,439,439,1,1,0,1,0
9,447,447,98,28,70,3,2
5,473,473,52,30,22,3,2
12,477,477,10,1,9,4,3
3,487,487,19,19,0,1,0
25,489,489,6,6,0,1,0

23,100,100,6,6,0,1,0
27,100,100,8,8,0,1,0
14,103,103,13,13,0,1,0
0,113,113,2,2,0,1,0
29,162,162,39,31,8,2,1
7,206,206,29,11,18,3,2
16,215,215,9,9,0,1,0
8,220,220,14,1,13,2,1
18,223,223,12,5,7,2,1
3,226,226,52,52,0,1,0
2,250,250,1,1,0,1,0
15,276,276,7,7,0,1,0
9,284,284,7,7,0,1,0
17,312,312,4,4,0,1,0
22,325,325,20,20,0,1,0
4,335,335,8,1,7,3,2
13,342,342,21,21,0,1,0
1,374,374,21,21,0,1,0
26,390,390,44,44,0,1,0
5,405,405,91,76,15,4,3
10,422,422,9,6,3,2,1
25,429,429,21,21,0,1,0
11,433,433,34,14,20,3,2
21,434,434,24,24,0,1,0
6,435,435,17,17,0,1,0
24,435,435,98,98,0,1,0
20,455,455,55,33,22,2,1
28,473,473,4,4,0,1,0
12,485,485,4,1,3,2,1
19,493,493,80,45,35,2,1

15,108,108,4,4,0,1,0
7,160,160,26,26,0,1,0
18,166,166,15,15,0,1,0
27,168,168,6,6,0,1,0
8,169,169,1,1,0,1,0
24,178,178,2,2,0,1,0
10,206,206,13,13,0,1,0
21,231,231,20,20,0,1,0
11,235,235,1,1,0,1,0
3,238,238,6,6,0,1,0
6,242,242,4,4,0,1,0
17,255,255,16,6,10,2,1
12,266,266,11,11,0,1,0
0,271,271,17,17,0,1,0
13,309,309,20,4,16,2,1
4,325,325,37,37,0,1,0
5,338,338,18,18,0,1,0
14,338,338,69,62,7,2,1
9,339,339,82,73,9,4,3
26,375,375,49,49,0,1,0
16,398,398,21,7,14,2,1
25,435,435,105,105,0,1,0
20,443,443,22,7,15,4,3
19,448,448,35,35,0,1,0
2,452,452,33,33,0,1,0
23,463,463,30,1,29,2,1
1,486,486,18,9,9,4,3
22,488,488,156,105,51,4,3

22,124,124,36,18,18,2,1
21,145,145,32,18,14,3,2
14,174,174,22,10,12,3,2
11,178,178,19,1,18,4,3
24,187,187,1,1,0,1,0
5,188,188,2,2,0,1,0
25,244,244,14,6,8,2,1
15,248,248,10,10,0,1,0
17,275,275,55,42,13,2,1
19,279,279,33,33,0,1,0
12,285,285,41,41,0,1,0
20,286,286,20,8,12,2,1
8,290,290,2,2,0,1,0
9,295,295,62,62,0,1,0
3,324,324,31,31,0,1,0
16,368,368,12,12,0,1,0
13,372,372,10,10,0,1,0
4,374,374,1,1,0,1,0
18,394,394,22,22,0,1,0
23,399,399,2,2,0,1,0
10,400,400,42,42,0,1,0
1,414,414,22,22,0,1,0
6,449,449,18,3,15,4,3
0,451,451,54,45,9,4,3
7,458,458,103,82,21,4,3
2,458,458,25,25,0,1,0

12,110,110,3,3,0,1,0
2,117,117,9,9,0,1,0
25,120,120,13,13,0,1,0
15,146,146,31,31,0,1,0
1,151,151,9,6,3,2,1
3,152,152,1,1,0,1,0
13,171,171,1,1,0,1,0
17,178,178,14,5,9,4,3
23,183,183,35,35,0,1,0
27,220,220,7,1,6,2,1
16,228,228,25,1,24,4,3
10,254,254,2,2,0,1,0
20,261,261,4,1,3,2,1
9,345,345,5,1,4,2,1
14,387,387,29,29,0,1,0
11,394,394,16,16,0,1,0
8,398,398,67,20,47,2,1
0,413,413,30,30,0,1,0
21,414,414,70,40,30,4,3
19,419,419,61,16,45,2,1
7,424,424,121,121,0,1,0
5,431,431,13,13,0,1,0
26,436,436,77,77,0,1,0
18,437,437,17,17,0,1,0
6,477,477,38,30,8,2,1
24,480,480,35,9,26,2,1
4,482,482,20,3,17,2,1
22,488,488,42,4,38,3,2

21,101,101,45,11,34,3,2
9,119,119,27,27,0,1,0
20,120,120,5,5,0,1,0
3,125,125,45,45,0,1,0
0,136,136,1,1,0,1,0
16,162,162,7,2,5,2,1
12,180,180,3,3,0,1,0
14,193,193,2,2,0,1,0
11,261,261,2,2,0,1,0
19,281,281,5,5,0,1,0
15,292,292,15,12,3,2,1
4,306,306,3,3,0,1,0
18,327,327,86,35,51,3,2
1,329,329,36,7,29,4,3
7,329,329,2,2,0,1,0
6,339,339,19,7,12,4,3
5,354,354,38,38,0,1,0
13,362,362,3,3,0,1,0
22,380,380,69,29,40,2,1
24,384,384,15,15,0,1,0
25,419,419,9,9,0,1,0
2,428,428,7,2,5,2,1
17,430,430,11,3,8,3,2
23,452,452,37,22,15,4,3
10,455,455,18,18,0,1,0
8,498,498,115,4,111,4,3

6,122,122,1,1,0,1,0
1,142,142,7,7,0,1,0
16,142,142,8,8,0,1,0
0,147,147,26,26,0,1,0
3,153,153,1,1,0,1,0
13,168,168,5,5,0,1,0
14,169,169,36,36,0,1,0
19,176,176,8,8,0,1,0
18,183,183,21,21,0,1,0
11,222,222,37,37,0,1,0
10,224,224,39,39,0,1,0
7,226,226,33,33,0,1,0
21,243,243,35,35,0,1,0
23,287,287,100,12,88,3,2
2,297,297,30,30,0,1,0
5,315,315,23,1,22,3,2
22,322,322,6,6,0,1,0
12,348,348,5,5,0,1,0
9,362,362,14,2,12,3,2
8,370,370,33,33,0,1,0
20,409,409,59,59,0,1,0
15,415,415,8,8,0,1,0
17,438,438,32,32,0,1,0
4,462,462,79,33,46,2,1

0,121,121,1,1,0,1,0
1,125,125,26,26,0,1,0
16,145,145,34,34,0,1,0
5,149,149,42,10,32,3,2
23,168,168,2,2,0,1,0
14,181,181,58,58,0,1,0
9,190,190,27,15,12,2,1
10,191,191,31,31,0,1,0
7,233,233,4,4,0,1,0
15,246,246,25,25,0,1,0
11,254,254,26,16,10,3,2
19,265,265,13,2,11,2,1
3,282,282,19,4,15,3,2
12,283,283,13,3,10,2,1
21,284,284,75,45,30,4,3
22,352,352,28,24,4,2,1
20,383,383,17,17,0,1,0
13,397,397,8,1,7,2,1
6,410,410,6,3,3,2,1
4,420,420,35,35,0,1,0
17,422,422,11,11,0,1,0
18,435,435,10,10,0,1,0
2,470,470,24,24,0,1,0
8,499,499,32,32,0,1,0

10,144,144,10,10,0,1,0
23,155,155,8,8,0,1,0
15,171,171,5,5,0,1,0
1,185,185,15,1,14,2,1
5,190,190,16,6,10,2,1
9,205,205,25,25,0,1,0
24,218,218,43,43,0,1,0
13,244,244,4,4,0,1,0
12,317,317,3,3,0,1,0
8,322,322,2,2,0,1,0
19,323,323,18,6,12,2,1
4,326,326,13,13,0,1,0
7,339,339,72,72,0,1,0
0,339,339,53,38,15,2,1
14,349,349,2,2,0,1,0
6,373,373,18,9,9,4,3
11,386,386,53,41,12,2,1
21,393,393,30,30,0,1,0
16,451,451,89,45,44,2,1
20,454,454,58,26,32,4,3
18,456,456,25,2,23,2,1
3,465,465,1,1,0,1,0
2,465,465,109,69,40,3,2
17,485,485,195,57,138,4,3
22,497,497,5,5,0,1,0

16,112,112,16,4,12,2,1
10,121,121,9,9,0,1,0
7,130,130,25,9,16,2,1
13,169,169,8,8,0,1,0
8,179,179,6,6,0,1,0
12,210,210,15,7,8,2,1
1,218,218,59,59,0,1,0
20,238,238,26,26,0,1,0
14,260,260,8,8,0,1,0
3,278,278,19,1,18,2,1
5,306,306,33,33,0,1,0
0,315,315,70,66,4,2,1
15,327,327,52,52,0,1,0
11,335,335,64,12,52,4,3
19,407,407,8,2,6,2,1
17,416,416,26,8,18,2,1
4,430,430,19,13,6,3,2
9,435,435,29,13,16,3,2
2,448,448,54,42,12,3,2
6,453,453,65,65,0,1,0
18,471,471,121,111,10,2,1

22,102,102,10,10,0,1,0
13,114,114,12,12,0,1,0
23,150,150,5,1,4,2,1
8,162,162,14,1,13,4,3
19,163,163,13,6,7,2,1
6,179,179,58,58,0,1,0
4,197,197,6,6,0,1,0
9,204,204,38,38,0,1,0
11,268,268,25,25,0,1,0
21,282,282,15,15,0,1,0
16,314,314,24,14,10,3,2
14,315,315,17,8,9,2,1
3,319,319,31,14,17,2,1
18,322,322,28,15,13,2,1
12,333,333,8,3,5,2,1
1,371,371,61,61,0,1,0
15,429,429,94,94,0,1,0
10,443,443,1,1,0,1,0
17,453,453,27,11,16,3,2
2,467,467,14,14,0,1,0
20,480,480,161,134,27,2,1
5,489,489,44,12,32,4,3
7,491,491,9,9,0,1,0
0,500,500,40,25,15,2,1

8,109,109,7,1,6,2,1
16,111,111,19,1,18,2,1
3,116,116,20,2,18,4,3
7,117,117,19,19,0,1,0
9,126,126,1,1,0,1,0
21,134,134,24,24,0,1,0
18,210,210,29,29,0,1,0
17,211,211,28,28,0,1,0
14,231,231,1,1,0,1,0
1,239,239,4,4,0,1,0
13,248,248,7,7,0,1,0
15,322,322,49,37,12,2,1
20,328,328,18,18,0,1,0
6,332,332,1,1,0,1,0
12,332,332,30,11,19,3,2
0,358,358,36,24,12,4,3
5,360,360,102,102,0,1,0
2,390,390,1,1,0,1,0
11,417,417,43,10,33,4,3
19,421,421,67,59,8,3,2
22,427,427,5,5,0,1,0
10,473,473,140,140,0,1,0
4,474,474,44,44,0,1,0

14,104,104,3,3,0,1,0
15,116,116,1,1,0,1,0
13,137,137,14,14,0,1,0
3,143,143,45,19,26,2,1
9,147,147,11,11,0,1,0
6,148,148,10,4,6,3,2
19,166,166,2,2,0,1,0
10,171,171,10,10,0,1,0
18,194,194,6,6,0,1,0
8,211,211,36,8,28,3,2
5,262,262,10,4,6,2,1
11,263,263,103,103,0,1,0
20,331,331,66,66,0,1,0
12,340,340,9,1,8,2,1
2,344,344,29,21,8,2,1
1,384,384,48,18,30,4,3
0,401,401,49,32,17,2,1
21,451,451,53,12,41,2,1
17,453,453,12,2,10,3,2
16,482,482,109,109,0,1,0
7,484,484,65,65,0,1,0
4,500,500,35,6,29,2,1

9,145,145,24,2,22,2,1
10,146,146,3,3,0,1,0
8,203,203,12,12,0,1,0
15,208,208,5,5,0,1,0
11,223,223,31,31,0,1,0
13,279,279,38,15,23,2,1
12,282,282,3,3,0,1,0
5,286,286,53,53,0,1,0
14,301,301,4,4,0,1,0
19,314,314,17,17,0,1,0
4,342,342,69,69,0,1,0
7,368,368,51,7,44,3,2
2,371,371,40,18,22,2,1
6,377,377,86,86,0,1,0
3,382,382,50,50,0,1,0
16,391,391,105,47,58,3,2
1,430,430,40,37,3,2,1
17,440,440,84,19,65,4,3
0,449,449,26,9,17,2,1
20,457,457,53,53,0,1,0
18,499,499,43,3,40,3,2

13,109,109,5,5,0,1,0
3,128,128,2,2,0,1,0
17,132,132,3,3,0,1,0
22,143,143,42,42,0,1,0
18,172,172,17,8,9,2,1
6,189,189,6,6,0,1,0
12,193,193,22,4,18,4,3
4,195,195,39,39,0,1,0
16,195,195,34,16,18,3,2
24,199,199,6,6,0,1,0
9,250,250,27,27,0,1,0
5,269,269,38,38,0,1,0
0,271,271,5,5,0,1,0
2,304,304,41,23,18,4,3
11,307,307,8,4,4,2,1
23,336,336,9,6,3,2,1
19,372,372,1,1,0,1,0
21,386,386,13,5,8,3,2
15,409,409,47,47,0,1,0
20,410,410,96,63,33,4,3
1,431,431,1,1,0,1,0
14,485,485,78,11,67,4,3
7,492,492,104,104,0,1,0
8,498,498,20,13,7,2,1
10,499,499,79,60,19,4,3

2,108,108,3,3,0,1,0
8,121,121,9,9,0,1,0
1,123,123,14,14,0,1,0
7,129,129,5,1,4,2,1
14,143,143,13,13,0,1,0
24,234,234,60,60,0,1,0
16,237,237,70,70,0,1,0
25,247,247,9,9,0,1,0
4,248,248,9,9,0,1,0
21,250,250,21,21,0,1,0
15,264,264,12,12,0,1,0
12,273,273,47,3,44,4,3
17,275,275,19,5,14,2,1
22,279,279,8,8,0,1,0
5,286,286,9,9,0,1,0
3,287,287,24,3,21,2,1
0,299,299,11,11,0,1,0
19,305,305,28,28,0,1,0
11,351,351,12,3,9,4,3
23,371,371,56,56,0,1,0
9,387,387,38,38,0,1,0
6,397,397,122,122,0,1,0
13,430,430,52,52,0,1,0
10,440,440,11,11,0,1,0
20,457,457,16,16,0,1,0
18,473,473,17,8,9,4,3

18,122,122,22,12,10,3,2
23,123,123,4,4,0,1,0
21,125,125,1,1,0,1,0
13,133,133,2,2,0,1,0
7,141,141,1,1,0,1,0
1,143,143,20,20,0,1,0
12,145,145,30,5,25,2,1
8,149,149,8,5,3,2,1
22,181,181,27,27,0,1,0
9,194,194,3,3,0,1,0
15,214,214,36,18,18,4,3
19,237,237,25,1,24,4,3
11,237,237,24,4,20,3,2
16,248,248,39,19,20,4,3
17,334,334,56,28,28,2,1
0,363,363,5,5,0,1,0
6,375,375,50,50,0,1,0
4,377,377,6,6,0,1,0
14,386,386,9,4,5,2,1
10,437,437,85,71,14,3,2
2,451,451,160,129,31,2,1
5,462,462,75,75,0,1,0
20,491,491,6,2,4,2,1
3,500,500,6,6,0,1,0

16,116,116,31,17,14,2,1
17,121,121,7,7,0,1,0
20,137,137,27,22,5,2,1
24,140,140,4,4,0,1,0
11,156,156,4,4,0,1,0
12,161,161,9,9,0,1,0
3,164,164,14,4,10,3,2
7,183,183,8,2,6,2,1
19,196,196,15,15,0,1,0
23,203,203,52,52,0,1,0
0,239,239,1,1,0,1,0
21,287,287,21,13,8,3,2
15,291,291,38,29,9,2,1
18,304,304,3,3,0,1,0
22,307,307,6,6,0,1,0
13,337,337,28,28,0,1,0
5,353,353,14,5,9,4,3
2,355,355,39,33,6,3,2
9,355,355,24,24,0,1,0
14,375,375,10,4,6,3,2
1,398,398,96,64,32,3,2
6,458,458,22,17,5,2,1
4,471,471,93,44,49,2,1
8,472,472,22,2,20,2,1
10,481,481,114,3,111,4,3

17,104,104,5,5,0,1,0
22,112,112,12,12,0,1,0
8,116,116,1,1,0,1,0
18,126,126,4,1,3,2,1
16,133,133,5,5,0,1,0
5,142,142,1,1,0,1,0
25,147,147,10,7,3,2,1
23,193,193,2,2,0,1,0
0,211,211,9,3,6,2,1
11,222,222,11,3,8,3,2
1,287,287,16,3,13,2,1
6,297,297,32,32,0,1,0
20,308,308,33,21,12,4,3
21,310,310,11,11,0,1,0
15,311,311,80,80,0,1,0
7,314,314,22,22,0,1,0
26,319,319,13,7,6,3,2
2,322,322,19,7,12,2,1
19,324,324,12,12,0,1,0
13,338,338,35,35,0,1,0
27,341,341,18,18,0,1,0
24,351,351,232,232,0,1,0
12,356,356,66,66,0,1,0
4,425,425,41,41,0,1,0
10,436,436,5,1,4,2,1
14,457,457,40,17,23,4,3
3,477,477,4,4,0,1,0
9,480,480,24,6,18,3,2

1,114,114,29,7,22,2,1
19,116,116,14,2,12,3,2
12,123,123,19,19,0,1,0
13,145,145,4,4,0,1,0
3,159,159,7,1,6,2,1
0,171,171,33,1,32,3,2
14,175,175,11,3,8,2,1
17,183,183,88,64,24,4,3
15,190,190,10,10,0,1,0
20,227,227,6,1,5,2,1
16,230,230,11,1,10,2,1
2,238,238,31,2,29,2,1
9,256,256,68,38,30,4,3
10,381,381,29,16,13,2,1
4,384,384,28,28,0,1,0
7,384,384,13,10,3,2,1
18,425,425,1,1,0,1,0
11,442,442,32,9,23,2,1
8,442,442,3,3,0,1,0
6,443,443,1,1,0,1,0
21,452,452,49,49,0,1,0
5,479,479,59,59,0,1,0
22,499,499,34,34,0,1,0

9,110,110,1,1,0,1,0
28,138,138,4,1,3,2,1
16,152,152,4,4,0,1,0
13,159,159,8,8,0,1,0
1,166,166,1,1,0,1,0
2,198,198,5,5,0,1,0
25,214,214,26,19,7,2,1
10,226,226,23,13,10,2,1
17,241,241,2,2,0,1,0
7,249,249,47,47,0,1,0
5,265,265,55,55,0,1,0
19,268,268,58,19,39,4,3
15,295,295,14,8,6,2,1
18,300,300,6,6,0,1,0
26,300,300,3,3,0,1,0
3,317,317,8,8,0,1,0
11,351,351,4,4,0,1,0
27,355,355,14,14,0,1,0
6,361,361,4,4,0,1,0
0,388,388,1,1,0,1,0
4,391,391,46,46,0,1,0
12,392,392,7,1,6,3,2
32,405,405,60,54,6,2,1
29,419,419,38,6,32,3,2
8,420,420,3,3,0,1,0
24,432,432,74,28,46,2,1
30,440,440,57,57,0,1,0
31,440,440,122,122,0,1,0
14,445,445,12,12,0,1,0
33,457,457,19,19,0,1,0
23,462,462,43,19,24,4,3
21,464,464,17,6,11,2,1
20,492,492,18,5,13,2,1
22,493,493,31,7,24,2,1

6,109,109,2,2,0,1,0
5,118,118,7,3,4,2,1
22,131,131,2,2,0,1,0
2,152,152,25,25,0,1,0
8,158,158,1,1,0,1,0
17,175,175,40,40,0,1,0
10,200,200,19,15,4,2,1
14,202,202,18,18,0,1,0
25,206,206,13,13,0,1,0
7,211,211,17,17,0,1,0
21,214,214,53,20,33,2,1
0,233,233,1,1,0,1,0
12,260,260,111,40,71,4,3
11,282,282,5,5,0,1,0
16,282,282,34,34,0,1,0
3,299,299,9,9,0,1,0
24,322,322,12,12,0,1,0
18,376,376,1,1,0,1,0
13,385,385,11,2,9,4,3
15,425,425,32,32,0,1,0
9,429,429,93,93,0,1,0
19,445,445,45,19,26,3,2
20,452,452,100,32,68,4,3
1,478,478,19,19,0,1,0
4,488,488,6,6,0,1,0
23,499,499,13,6,7,2,1

29,106,106,12,12,0,1,0
7,138,138,6,6,0,1,0
11,145,145,11,7,4,2,1
27,167,167,22,22,0,1,0
3,174,174,2,2,0,1,0
24,180,180,46,16,30,3,2
25,184,184,13,13,0,1,0
17,193,193,25,25,0,1,0
4,204,204,8,1,7,2,1
14,224,224,17,7,10,3,2
13,242,242,1,1,0,1,0
23,254,254,6,6,0,1,0
9,266,266,37,18,19,2,1
26,281,281,88,35,53,4,3
6,292,292,45,22,23,2,1
10,314,314,14,14,0,1,0
30,320,320,13,13,0,1,0
12,328,328,21,11,10,2,1
20,331,331,7,7,0,1,0
15,354,354,27,27,0,1,0
16,386,386,1,1,0,1,0
1,419,419,37,21,16,2,1
21,431,431,21,21,0,1,0
22,435,435,8,4,4,2,1
0,438,438,1,1,0,1,0
19,448,448,83,38,45,4,3
2,450,450,51,12,39,2,1
8,450,450,37,19,18,4,3
5,464,464,16,3,13,2,1
18,474,474,10,10,0,1,0
28,491,491,2,2,0,1,0

18,116,116,33,20,13,2,1
16,140,140,5,5,0,1,0
20,142,142,40,40,0,1,0
1,143,143,3,3,0,1,0
10,144,144,14,14,0,1,0
21,151,151,9,1,8,2,1
2,189,189,7,7,0,1,0
26,193,193,18,8,10,2,1
4,210,210,14,8,6,3,2
22,212,212,23,23,0,1,0
5,216,216,4,4,0,1,0
9,218,218,13,13,0,1,0
15,233,233,12,12,0,1,0
13,234,234,8,5,3,2,1
25,243,243,17,10,7,2,1
0,261,261,7,7,0,1,0
23,295,295,7,1,6,3,2
24,315,315,34,8,26,2,1
11,332,332,13,9,4,2,1
7,333,333,45,8,37,2,1
19,347,347,32,20,12,3,2
12,387,387,51,51,0,1,0
3,389,389,63,5,58,3,2
17,401,401,11,6,5,2,1
8,429,429,60,18,42,4,3
6,431,431,2,2,0,1,0
14,494,494,112,82,30,3,2

18,111,111,8,2,6,2,1
23,112,112,9,9,0,1,0
17,113,113,21,21,0,1,0
10,120,120,1,1,0,1,0
20,123,123,9,3,6,2,1
14,202,202,5,5,0,1,0
15,220,220,83,5,78,4,3
16,230,230,19,9,10,2,1
7,253,253,37,13,24,4,3
11,254,254,43,37,6,3,2
2,262,262,3,3,0,1,0
25,267,267,5,5,0,1,0
4,268,268,11,1,10,2,1
3,272,272,4,1,3,2,1
0,275,275,3,3,0,1,0
24,288,288,45,15,30,4,3
22,335,335,9,9,0,1,0
12,346,346,23,23,0,1,0
1,370,370,12,12,0,1,0
6,375,375,24,24,0,1,0
27,390,390,92,44,48,3,2
21,405,405,107,107,0,1,0
26,410,410,11,11,0,1,0
8,437,437,22,1,21,2,1
5,453,453,41,8,33,4,3
9,470,470,4,4,0,1,0
19,480,480,1,1,0,1,0
13,481,481,42,2,40,2,1

29,107,107,33,33,0,1,0
6,124,124,14,14,0,1,0
2,137,137,19,19,0,1,0
5,139,139,1,1,0,1,0
26,167,167,21,3,18,3,2
25,193,193,7,7,0,1,0
7,205,205,4,4,0,1,0
23,207,207,18,7,11,3,2
14,207,207,10,10,0,1,0
1,220,220,1,1,0,1,0
3,230,230,2,2,0,1,0
21,230,230,1,1,0,1,0
11,231,231,6,6,0,1,0
15,255,255,2,2,0,1,0
10,257,257,16,16,0,1,0
27,257,257,42,15,27,2,1
31,300,300,15,15,0,1,0
28,308,308,42,42,0,1,0
24,319,319,7,1,6,3,2
4,320,320,38,38,0,1,0
16,327,327,29,6,23,2,1
13,336,336,19,19,0,1,0
32,345,345,45,6,39,2,1
17,350,350,6,6,0,1,0
12,362,362,9,9,0,1,0
20,376,376,50,50,0,1,0
22,397,397,7,2,5,2,1
9,418,418,3,3,0,1,0
8,423,423,1,1,0,1,0
0,424,424,54,54,0,1,0
19,433,433,33,33,0,1,0
30,444,444,62,8,54,4,3
18,465,465,53,6,47,2,1

10,103,103,5,5,0,1,0
24,135,135,37,17,20,3,2
23,143,143,30,12,18,4,3
21,144,144,14,14,0,1,0
6,159,159,11,5,6,2,1
18,159,159,11,1,10,2,1
5,163,163,21,11,10,3,2
19,165,165,16,16,0,1,0
3,172,172,16,1,15,4,3
2,202,202,23,23,0,1,0
0,229,229,39,39,0,1,0
1,271,271,72,72,0,1,0
9,330,330,15,15,0,1,0
15,347,347,11,11,0,1,0
4,410,410,28,7,21,4,3
13,413,413,94,36,58,3,2
16,424,424,30,12,18,3,2
17,471,471,47,47,0,1,0
22,471,471,11,5,6,2,1
12,475,475,7,3,4,2,1
7,478,478,29,29,0,1,0
20,486,486,6,3,3,2,1
14,489,489,7,7,0,1,0
11,490,490,50,50,0,1,0
8,495,495,10,10,0,1,0

3,101,101,3,3,0,1,0
15,104,104,14,14,0,1,0
10,140,140,12,9,3,2,1
0,144,144,2,2,0,1,0
14,164,164,5,2,3,2,1
7,192,192,67,67,0,1,0
1,247,247,109,66,43,4,3
12,284,284,27,12,15,2,1
6,285,285,11,11,0,1,0
13,305,305,50,14,36,2,1
2,323,323,11,11,0,1,0
17,323,323,21,21,0,1,0
5,332,332,12,12,0,1,0
4,335,335,31,31,0,1,0
20,375,375,3,3,0,1,0
19,376,376,92,65,27,2,1
8,428,428,71,49,22,3,2
16,456,456,24,19,5,2,1
18,469,469,3,3,0,1,0
9,474,474,135,74,61,4,3
11,478,478,26,26,0,1,0

9,133,133,41,15,26,3,2
14,136,136,1,1,0,1,0
17,158,158,14,10,4,2,1
1,182,182,11,11,0,1,0
22,200,200,5,5,0,1,0
27,217,217,21,6,15,4,3
5,231,231,10,10,0,1,0
16,234,234,36,14,22,3,2
28,245,245,9,9,0,1,0
7,251,251,8,8,0,1,0
8,268,268,5,5,0,1,0
12,272,272,18,2,16,3,2
11,277,277,27,17,10,3,2
23,279,279,69,69,0,1,0
4,289,289,4,1,3,2,1
3,291,291,38,38,0,1,0
2,298,298,16,4,12,3,2
15,322,322,9,9,0,1,0
20,361,361,49,49,0,1,0
6,369,369,13,13,0,1,0
13,374,374,26,4,22,3,2
26,375,375,94,20,74,4,3
10,378,378,15,5,10,2,1
21,407,407,2,2,0,1,0
18,438,438,20,10,10,2,1
24,449,449,8,8,0,1,0
19,462,462,67,67,0,1,0
0,464,464,21,21,0,1,0
25,481,481,63,63,0,1,0

12,153,153,10,10,0,1,0
4,156,156,53,53,0,1,0
2,246,246,65,1,64,4,3
7,248,248,2,2,0,1,0
16,269,269,8,8,0,1,0
6,277,277,84,7,77,4,3
14,297,297,29,29,0,1,0
5,306,306,4,4,0,1,0
11,335,335,11,3,8,3,2
15,352,352,149,62,87,4,3
8,415,415,10,5,5,2,1
10,460,460,9,9,0,1,0
1,461,461,126,72,54,4,3
0,464,464,29,29,0,1,0
13,488,488,38,38,0,1,0
3,495,495,130,52,78,3,2
9,496,496,61,33,28,2,1

4,103,103,23,12,11,2,1
1,131,131,1,1,0,1,0
15,160,160,27,27,0,1,0
19,171,171,27,27,0,1,0
3,184,184,21,21,0,1,0
5,218,218,1,1,0,1,0
8,221,221,61,27,34,3,2
16,230,230,26,18,8,3,2
9,242,242,4,4,0,1,0
7,263,263,85,11,74,3,2
11,283,283,30,30,0,1,0
2,293,293,51,51,0,1,0
6,305,305,21,1,20,2,1
20,369,369,20,9,11,2,1
10,370,370,10,10,0,1,0
0,475,475,4,4,0,1,0
14,476,476,105,57,48,2,1
12,488,488,13,1,12,4,3
13,496,496,78,36,42,2,1
17,497,497,72,36,36,4,3
18,499,499,16,6,10,2,1

22,129,129,12,2,10,2,1
11,142,142,19,19,0,1,0
1,146,146,46,46,0,1,0
6,180,180,6,6,0,1,0
15,195,195,11,2,9,2,1
26,206,206,42,42,0,1,0
17,246,246,6,6,0,1,0
18,282,282,6,6,0,1,0
25,287,287,9,4,5,2,1
0,288,288,4,4,0,1,0
10,292,292,38,38,0,1,0
3,299,299,3,3,0,1,0
19,311,311,20,2,18,2,1
5,332,332,15,15,0,1,0
23,336,336,54,54,0,1,0
14,338,338,7,1,6,3,2
4,355,355,44,44,0,1,0
12,383,383,2,2,0,1,0
7,383,383,20,20,0,1,0
8,384,384,58,58,0,1,0
21,388,388,122,34,88,3,2
13,389,389,4,4,0,1,0
20,390,390,27,27,0,1,0
24,416,416,25,25,0,1,0
2,433,433,65,17,48,4,3
9,484,484,3,3,0,1,0
16,494,494,57,32,25,2,1

27,116,116,17,1,16,3,2
6,116,116,5,5,0,1,0
0,120,120,6,6,0,1,0
24,137,137,3,3,0,1,0
10,138,138,17,17,0,1,0
9,161,161,28,14,14,2,1
26,171,171,9,5,4,2,1
8,186,186,5,5,0,1,0
7,195,195,7,7,0,1,0
20,201,201,62,36,26,3,2
5,225,225,4,4,0,1,0
21,257,257,41,41,0,1,0
2,296,296,2,2,0,1,0
11,318,318,76,54,22,2,1
28,331,331,8,8,0,1,0
17,331,331,15,15,0,1,0
12,333,333,6,1,5,2,1
16,348,348,2,2,0,1,0
13,390,390,18,18,0,1,0
22,401,401,9,9,0,1,0
4,406,406,1,1,0,1,0
15,412,412,37,10,27,4,3
14,429,429,17,17,0,1,0
19,436,436,19,3,16,3,2
1,452,452,1,1,0,1,0
3,453,453,127,75,52,3,2
18,466,466,64,34,30,4,3
25,481,481,113,40,73,4,3
23,498,498,10,10,0,1,0

30,113,113,3,3,0,1,0
19,119,119,6,1,5,2,1
13,120,120,5,5,0,1,0
0,130,130,13,4,9,4,3
2,138,138,13,13,0,1,0
24,142,142,25,1,24,3,2
22,151,151,7,7,0,1,0
3,158,158,9,9,0,1,0
25,162,162,17,7,10,2,1
9,177,177,10,10,0,1,0
21,200,200,35,35,0,1,0
23,208,208,5,5,0,1,0
14,216,216,6,6,0,1,0
16,218,218,17,6,11,2,1
18,225,225,1,1,0,1,0
28,240,240,10,10,0,1,0
17,281,281,10,10,0,1,0
10,283,283,5,5,0,1,0
11,312,312,2,2,0,1,0
29,323,323,46,3,43,2,1
1,343,343,99,99,0,1,0
7,354,354,8,1,7,2,1
31,369,369,116,29,87,4,3
20,401,401,21,21,0,1,0
15,407,407,24,12,12,4,3
6,418,418,7,4,3,2,1
12,430,430,35,2,33,3,2
5,439,439,59,59,0,1,0
8,440,440,6,6,0,1,0
4,453,453,8,8,0,1,0
26,457,457,29,29,0,1,0
27,486,486,34,34,0,1,0

5,111,111,12,4,8,2,1
16,142,142,15,11,4,2,1
22,151,151,32,32,0,1,0
3,213,213,14,2,12,2,1
8,225,225,91,67,24,3,2
9,237,237,29,3,26,3,2
13,262,262,5,5,0,1,0
0,272,272,14,14,0,1,0
12,273,273,43,23,20,3,2
21,278,278,31,1,30,3,2
23,290,290,6,1,5,2,1
6,297,297,40,40,0,1,0
17,324,324,4,4,0,1,0
2,335,335,30,30,0,1,0
19,339,339,8,8,0,1,0
11,343,343,46,32,14,3,2
20,343,343,94,94,0,1,0
14,355,355,23,8,15,4,3
1,430,430,9,1,8,3,2
10,433,433,15,6,9,2,1
15,435,435,61,31,30,4,3
4,437,437,7,2,5,2,1
7,456,456,9,9,0,1,0
18,456,456,36,26,10,2,1

6,125,125,45,25,20,2,1
4,198,198,10,10,0,1,0
0,227,227,41,22,19,2,1
19,234,234,31,31,0,1,0
9,235,235,18,18,0,1,0
8,243,243,22,22,0,1,0
17,263,263,69,20,49,4,3
2,271,271,1,1,0,1,0
12,274,274,32,12,20,2,1
11,279,279,11,11,0,1,0
16,304,304,2,2,0,1,0
3,319,319,17,17,0,1,0
20,344,344,43,43,0,1,0
14,358,358,56,56,0,1,0
5,373,373,16,1,15,4,3
1,373,373,25,25,0,1,0
13,375,375,61,61,0,1,0
18,379,379,28,11,17,2,1
7,422,422,149,92,57,4,3
15,435,435,8,8,0,1,0
10,500,500,22,15,7,2,1

13,114,114,7,7,0,1,0
12,126,126,10,10,0,1,0
8,178,178,1,1,0,1,0
4,187,187,28,24,4,2,1
0,203,203,32,23,9,4,3
2,232,232,5,5,0,1,0
18,247,247,7,7,0,1,0
7,301,301,12,12,0,1,0
11,319,319,1,1,0,1,0
16,338,338,26,26,0,1,0
17,359,359,43,13,30,2,1
5,377,377,77,17,60,4,3
6,390,390,39,35,4,2,1
14,430,430,26,26,0,1,0
15,453,453,57,57,0,1,0
19,459,459,89,21,68,4,3
1,487,487,85,85,0,1,0
3,492,492,174,84,90,3,2
10,495,495,135,63,72,4,3
9,498,498,96,78,18,4,3

14,146,146,6,1,5,2,1
10,193,193,7,1,6,3,2
8,205,205,6,6,0,1,0
12,233,233,50,50,0,1,0
16,245,245,11,11,0,1,0
9,248,248,10,6,4,2,1
4,256,256,12,12,0,1,0
7,257,257,9,5,4,2,1
0,273,273,34,6,28,2,1
3,280,280,29,29,0,1,0
2,300,300,19,19,0,1,0
19,312,312,60,12,48,2,1
11,316,316,51,3,48,4,3
17,316,316,50,50,0,1,0
18,347,347,7,7,0,1,0
1,356,356,66,66,0,1,0
15,369,369,91,70,21,4,3
20,410,410,21,21,0,1,0
5,433,433,125,79,46,2,1
6,439,439,143,132,11,2,1
13,486,486,10,1,9,4,3

13,101,101,18,18,0,1,0
7,117,117,23,23,0,1,0
8,122,122,1,1,0,1,0
16,147,147,1,1,0,1,0
0,185,185,13,13,0,1,0
10,197,197,11,7,4,2,1
19,222,222,11,11,0,1,0
14,225,225,24,10,14,3,2
3,226,226,16,2,14,3,2
23,240,240,4,4,0,1,0
1,331,331,25,25,0,1,0
20,359,359,92,92,0,1,0
15,360,360,6,6,0,1,0
4,365,365,41,25,16,3,2
9,379,379,47,23,24,2,1
6,406,406,12,12,0,1,0
17,406,406,28,12,16,2,1
22,447,447,62,62,0,1,0
2,449,449,112,34,78,3,2
24,453,453,36,36,0,1,0
18,456,456,80,72,8,2,1
21,475,475,65,25,40,2,1
12,476,476,29,9,20,3,2
5,484,484,34,34,0,1,0
11,498,498,39,39,0,1,0

10,102,102,3,3,0,1,0
24,173,173,16,13,3,2,1
13,181,181,7,3,4,2,1
9,188,188,15,15,0,1,0
0,199,199,55,55,0,1,0
3,215,215,16,9,7,2,1
12,230,230,8,8,0,1,0
19,261,261,1,1,0,1,0
17,267,267,10,10,0,1,0
4,277,277,22,22,0,1,0
27,286,286,68,33,35,2,1
15,292,292,12,12,0,1,0
26,293,293,116,116,0,1,0
1,296,296,7,1,6,3,2
25,298,298,1,1,0,1,0
2,311,311,3,3,0,1,0
20,313,313,14,9,5,2,1
5,330,330,12,12,0,1,0
29,337,337,66,38,28,3,2
21,350,350,1,1,0,1,0
11,364,364,23,23,0,1,0
14,370,370,18,4,14,2,1
28,389,389,7,7,0,1,0
16,397,397,75,65,10,2,1
7,422,422,23,23,0,1,0
8,423,423,6,6,0,1,0
6,425,425,31,10,21,4,3
23,441,441,40,40,0,1,0
18,466,466,5,1,4,2,1
22,474,474,59,28,31,2,1

20,100,100,6,6,0,1,0
10,119,119,1,1,0,1,0
14,122,122,16,16,0,1,0
2,164,164,5,5,0,1,0
3,166,166,10,10,0,1,0
15,167,167,20,11,9,4,3
17,189,189,7,7,0,1,0
7,197,197,1,1,0,1,0
13,210,210,17,7,10,3,2
26,219,219,23,23,0,1,0
1,278,278,4,4,0,1,0
5,285,285,8,5,3,2,1
21,292,292,47,47,0,1,0
11,300,300,49,13,36,3,2
29,309,309,13,3,10,3,2
25,355,355,95,95,0,1,0
28,360,360,19,19,0,1,0
4,366,366,1,1,0,1,0
22,383,383,31,31,0,1,0
23,392,392,9,3,6,2,1
18,394,394,85,29,56,3,2
27,394,394,37,21,16,3,2
12,406,406,5,5,0,1,0
24,415,415,45,45,0,1,0
9,442,442,82,61,21,4,3
19,448,448,5,2,3,2,1
0,455,455,97,1,96,4,3
8,472,472,48,10,38,2,1
16,487,487,2,2,0,1,0
6,490,490,1,1,0,1,0

13,116,116,50,16,34,2,1
4,130,130,16,10,6,2,1
11,137,137,12,12,0,1,0
12,156,156,2,2,0,1,0
20,183,183,19,19,0,1,0
2,186,186,11,5,6,3,2
10,191,191,32,6,26,3,2
0,216,216,29,29,0,1,0
21,228,228,2,2,0,1,0
22,250,250,31,31,0,1,0
9,257,257,73,73,0,1,0
19,287,287,42,27,15,2,1
15,293,293,32,32,0,1,0
8,355,355,44,30,14,3,2
1,362,362,33,3,30,3,2
5,397,397,21,21,0,1,0
16,447,447,6,6,0,1,0
7,450,450,16,4,12,4,3
14,466,466,55,13,42,3,2
6,470,470,10,10,0,1,0
3,476,476,52,7,45,2,1
18,481,481,2,2,0,1,0
17,499,499,30,30,0,1,0

1,103,103,30,30,0,1,0
18,121,121,15,15,0,1,0
15,149,149,33,33,0,1,0
5,168,168,20,6,14,3,2
7,175,175,12,6,6,2,1
10,193,193,4,4,0,1,0
0,194,194,30,8,22,2,1
16,216,216,5,5,0,1,0
9,231,231,36,36,0,1,0
2,235,235,40,40,0,1,0
17,254,254,23,3,20,4,3
19,283,283,63,63,0,1,0
6,285,285,24,24,0,1,0
12,293,293,24,2,22,3,2
8,350,350,40,40,0,1,0
20,356,356,22,22,0,1,0
4,419,419,53,53,0,1,0
3,434,434,32,21,11,2,1
11,473,473,8,2,6,3,2
14,476,476,87,87,0,1,0
13,486,486,13,13,0,1,0

3,100,100,6,6,0,1,0
4,105,105,1,1,0,1,0
13,106,106,2,2,0,1,0
12,106,106,32,32,0,1,0
5,123,123,8,8,0,1,0
22,139,139,43,43,0,1,0
14,147,147,4,4,0,1,0
8,153,153,4,4,0,1,0
11,154,154,18,18,0,1,0
21,165,165,17,17,0,1,0
0,203,203,42,42,0,1,0
20,221,221,16,6,10,3,2
6,278,278,10,7,3,2,1
1,351,351,27,27,0,1,0
19,388,388,13,6,7,2,1
15,399,399,7,7,0,1,0
10,413,413,44,25,19,2,1
9,430,430,161,137,24,4,3
18,433,433,12,4,8,3,2
2,477,477,58,47,11,2,1
7,483,483,57,31,26,2,1
17,497,497,40,40,0,1,0
16,500,500,59,59,0,1,0

7,106,106,12,5,7,2,1
6,175,175,70,70,0,1,0
12,183,183,67,23,44,3,2
11,196,196,7,7,0,1,0
4,209,209,48,35,13,2,1
15,224,224,1,1,0,1,0
20,242,242,1,1,0,1,0
10,248,248,8,5,3,2,1
18,273,273,33,18,15,3,2
5,280,280,27,15,12,4,3
9,291,291,26,26,0,1,0
21,321,321,9,4,5,2,1
0,350,350,46,46,0,1,0
13,358,358,22,19,3,2,1
8,375,375,7,1,6,3,2
3,395,395,38,7,31,2,1
16,402,402,60,45,15,4,3
1,412,412,8,8,0,1,0
17,430,430,45,45,0,1,0
19,438,438,113,1,112,4,3
14,461,461,26,26,0,1,0
2,469,469,3,3,0,1,0

4,117,117,10,10,0,1,0
0,125,125,7,7,0,1,0
11,142,142,3,3,0,1,0
9,176,176,31,31,0,1,0
1,193,193,45,14,31,2,1
15,212,212,6,6,0,1,0
2,214,214,24,24,0,1,0
3,221,221,18,10,8,2,1
6,236,236,6,6,0,1,0
16,281,281,15,15,0,1,0
20,288,288,32,3,29,2,1
12,320,320,15,15,0,1,0
18,323,323,27,27,0,1,0
8,358,358,44,44,0,1,0
14,378,378,72,29,43,2,1
19,404,404,89,23,66,4,3
10,408,408,96,80,16,3,2
17,412,412,19,19,0,1,0
5,430,430,168,168,0,1,0
7,473,473,45,18,27,2,1
13,489,489,3,3,0,1,0

2,112,112,2,2,0,1,0
12,124,124,26,26,0,1,0
4,147,147,15,15,0,1,0
22,152,152,3,3,0,1,0
3,161,161,13,6,7,2,1
7,171,171,3,3,0,1,0
13,213,213,1,1,0,1,0
1,215,215,5,5,0,1,0
20,234,234,76,22,54,4,3
10,235,235,39,31,8,3,2
23,255,255,54,54,0,1,0
21,259,259,15,15,0,1,0
14,267,267,1,1,0,1,0
0,270,270,63,63,0,1,0
19,280,280,4,4,0,1,0
16,289,289,12,12,0,1,0
6,303,303,14,14,0,1,0
5,349,349,88,29,59,3,2
18,376,376,56,17,39,2,1
11,412,412,26,26,0,1,0
8,415,415,1,1,0,1,0
17,424,424,49,3,46,4,3
9,440,440,86,25,61,4,3
15,466,466,30,30,0,1,0

7,108,108,2,2,0,1,0
5,128,128,6,2,4,2,1
16,165,165,18,4,14,3,2
6,195,195,140,90,50,3,2
18,213,213,35,35,0,1,0
15,219,219,2,2,0,1,0
10,244,244,30,12,18,4,3
8,249,249,57,6,51,4,3
0,295,295,22,22,0,1,0
13,319,319,3,3,0,1,0
4,366,366,97,71,26,2,1
3,367,367,21,21,0,1,0
11,394,394,74,2,72,4,3
12,417,417,17,2,15,4,3
14,423,423,80,44,36,2,1
17,426,426,3,3,0,1,0
2,431,431,13,13,0,1,0
1,469,469,6,2,4,2,1
9,475,475,65,20,45,4,3

7,124,124,16,4,12,4,3
16,143,143,5,5,0,1,0
6,146,146,8,8,0,1,0
29,156,156,5,5,0,1,0
3,190,190,17,17,0,1,0
20,214,214,10,10,0,1,0
14,216,216,8,8,0,1,0
26,222,222,35,35,0,1,0
18,222,222,10,10,0,1,0
15,230,230,22,11,11,2,1
21,243,243,7,4,3,2,1
27,248,248,34,22,12,4,3
11,271,271,2,2,0,1,0
19,283,283,1,1,0,1,0
25,303,303,52,52,0,1,0
5,313,313,15,5,10,3,2
9,315,315,46,46,0,1,0
2,329,329,6,6,0,1,0
1,335,335,5,5,0,1,0
0,340,340,84,84,0,1,0
22,345,345,10,2,8,3,2
4,379,379,24,24,0,1,0
13,384,384,10,10,0,1,0
23,385,385,58,44,14,2,1
8,403,403,6,6,0,1,0
28,428,428,139,91,48,4,3
10,438,438,29,14,15,4,3
17,443,443,4,4,0,1,0
12,469,469,46,19,27,4,3
24,488,488,49,6,43,2,1

4,102,102,17,17,0,1,0
7,103,103,29,17,12,3,2
19,121,121,1,1,0,1,0
5,127,127,3,3,0,1,0
2,150,150,16,16,0,1,0
6,154,154,1,1,0,1,0
1,173,173,57,57,0,1,0
0,197,197,31,18,13,2,1
9,224,224,36,36,0,1,0
15,262,262,14,14,0,1,0
10,286,286,1,1,0,1,0
16,287,287,47,47,0,1,0
13,292,292,22,5,17,2,1
14,305,305,13,1,12,4,3
12,314,314,7,7,0,1,0
17,319,319,13,5,8,3,2
3,344,344,46,46,0,1,0
11,348,348,186,186,0,1,0
18,358,358,41,41,0,1,0
8,453,453,2,2,0,1,0

13,151,151,11,2,9,4,3
9,173,173,11,11,0,1,0
20,177,177,17,5,12,3,2
5,185,185,9,4,5,2,1
18,220,220,35,10,25,2,1
14,264,264,21,21,0,1,0
11,312,312,66,20,46,2,1
3,322,322,96,42,54,3,2
1,339,339,18,18,0,1,0
6,357,357,89,89,0,1,0
10,366,366,9,1,8,3,2
12,382,382,44,23,21,3,2
2,393,393,56,18,38,2,1
21,401,401,4,4,0,1,0
4,409,409,3,3,0,1,0
0,421,421,24,24,0,1,0
16,427,427,59,37,22,3,2
19,444,444,7,3,4,2,1
17,474,474,64,46,18,4,3
7,476,476,38,14,24,4,3
8,483,483,97,97,0,1,0
15,495,495,78,4,74,3,2

5,136,136,5,5,0,1,0
11,143,143,33,33,0,1,0
13,158,158,11,11,0,1,0
0,165,165,2,2,0,1,0
8,169,169,8,4,4,2,1
18,179,179,28,7,21,4,3
2,186,186,30,26,4,2,1
10,213,213,1,1,0,1,0
4,218,218,22,4,18,2,1
6,229,229,7,7,0,1,0
9,235,235,6,6,0,1,0
7,269,269,68,68,0,1,0
21,280,280,37,13,24,2,1
12,293,293,20,15,5,2,1
20,303,303,69,28,41,3,2
22,330,330,27,27,0,1,0
23,383,383,44,44,0,1,0
1,391,391,110,41,69,4,3
17,409,409,23,23,0,1,0
16,430,430,22,22,0,1,0
15,454,454,17,17,0,1,0
3,481,481,11,2,9,4,3
14,497,497,16,2,14,3,2
19,499,499,97,75,22,3,2

13,100,100,14,14,0,1,0
18,131,131,33,33,0,1,0
2,163,163,2,2,0,1,0
11,181,181,52,52,0,1,0
15,194,194,14,14,0,1,0
7,205,205,13,7,6,2,1
9,207,207,3,3,0,1,0
4,214,214,52,23,29,2,1
3,219,219,23,15,8,3,2
10,236,236,1,1,0,1,0
16,276,276,24,12,12,3,2
6,287,287,90,42,48,3,2
0,316,316,23,6,17,2,1
17,384,384,37,22,15,4,3
12,436,436,57,45,12,4,3
1,437,437,133,133,0,1,0
5,465,465,70,70,0,1,0
8,468,468,28,9,19,3,2
14,479,479,15,4,11,3,2

25,113,113,22,10,12,4,3
29,119,119,27,20,7,2,1
27,139,139,11,5,6,2,1
0,149,149,20,20,0,1,0
17,153,153,3,3,0,1,0
23,158,158,4,4,0,1,0
19,161,161,13,13,0,1,0
22,163,163,45,45,0,1,0
13,188,188,4,4,0,1,0
18,193,193,10,3,7,2,1
12,259,259,48,26,22,3,2
3,288,288,5,5,0,1,0
21,288,288,23,3,20,2,1
15,294,294,17,17,0,1,0
10,303,303,4,4,0,1,0
30,346,346,1,1,0,1,0
14,347,347,12,12,0,1,0
24,355,355,15,3,12,4,3
6,362,362,24,8,16,2,1
4,368,368,41,19,22,3,2
7,382,382,30,30,0,1,0
5,393,393,21,21,0,1,0
26,399,399,10,1,9,2,1
2,405,405,15,15,0,1,0
1,424,424,10,6,4,2,1
9,449,449,10,10,0,1,0
28,453,453,72,62,10,3,2
11,464,464,4,4,0,1,0
8,480,480,105,6,99,4,3
16,485,485,23,23,0,1,0
20,496,496,22,16,6,2,1

22,102,102,3,3,0,1,0
2,131,131,11,11,0,1,0
17,136,136,4,1,3,2,1
21,142,142,23,23,0,1,0
11,170,170,8,8,0,1,0
13,172,172,18,18,0,1,0
5,179,179,1,1,0,1,0
24,220,220,48,12,36,2,1
15,254,254,16,13,3,2,1
0,271,271,25,25,0,1,0
3,301,301,18,18,0,1,0
9,307,307,18,18,0,1,0
12,343,343,12,2,10,2,1
6,353,353,77,41,36,3,2
1,360,360,24,24,0,1,0
25,370,370,68,11,57,4,3
18,383,383,17,7,10,2,1
19,390,390,70,70,0,1,0
4,400,400,83,83,0,1,0
20,404,404,19,19,0,1,0
7,411,411,23,23,0,1,0
8,415,415,20,20,0,1,0
14,419,419,49,49,0,1,0
16,477,477,63,25,38,2,1
10,479,479,57,12,45,4,3
23,479,479,10,10,0,1,0

13,116,116,16,16,0,1,0
9,138,138,1,1,0,1,0
16,149,149,16,4,12,3,2
15,193,193,9,9,0,1,0
14,215,215,23,23,0,1,0
19,221,221,1,1,0,1,0
8,235,235,38,38,0,1,0
20,236,236,7,7,0,1,0
1,239,239,56,56,0,1,0
2,247,247,65,65,0,1,0
4,281,281,15,7,8,3,2
10,283,283,6,1,5,2,1
7,286,286,32,32,0,1,0
0,287,287,21,7,14,2,1
11,296,296,6,6,0,1,0
5,338,338,49,49,0,1,0
17,347,347,62,51,11,2,1
3,355,355,27,27,0,1,0
18,370,370,21,9,12,4,3
12,391,391,200,200,0,1,0
6,408,408,34,2,32,3,2

18,105,105,3,3,0,1,0
22,138,138,34,10,24,4,3
11,179,179,10,6,4,2,1
1,200,200,10,5,5,2,1
14,200,200,17,17,0,1,0
9,204,204,34,34,0,1,0
20,204,204,17,9,8,3,2
5,209,209,11,4,7,2,1
19,211,211,3,3,0,1,0
21,213,213,12,12,0,1,0
6,234,234,9,2,7,2,1
12,241,241,39,39,0,1,0
15,288,288,33,12,21,2,1
10,315,315,65,65,0,1,0
7,317,317,22,22,0,1,0
17,337,337,7,4,3,2,1
4,350,350,122,85,37,2,1
8,356,356,45,11,34,2,1
13,385,385,1,1,0,1,0
23,386,386,82,6,76,3,2
3,391,391,9,9,0,1,0
16,416,416,81,81,0,1,0
0,470,470,1,1,0,1,0
2,478,478,29,29,0,1,0

19,118,118,21,10,11,2,1
1,131,131,2,2,0,1,0
11,137,137,26,8,18,4,3
4,145,145,15,10,5,2,1
0,150,150,12,3,9,2,1
16,159,159,18,5,13,2,1
5,185,185,5,5,0,1,0
15,193,193,27,27,0,1,0
21,205,205,1,1,0,1,0
7,230,230,27,24,3,2,1
23,248,248,9,9,0,1,0
20,278,278,29,11,18,3,2
24,288,288,1,1,0,1,0
12,300,300,7,7,0,1,0
25,329,329,3,3,0,1,0
6,335,335,1,1,0,1,0
3,338,338,8,3,5,2,1
18,351,351,99,11,88,3,2
2,365,365,51,2,49,2,1
13,378,378,77,77,0,1,0
22,412,412,104,61,43,2,1
10,435,435,61,61,0,1,0
9,435,435,40,20,20,2,1
17,444,444,3,3,0,1,0
14,474,474,42,42,0,1,0
8,496,496,21,12,9,2,1

8,112,112,1,1,0,1,0
7,124,124,6,6,0,1,0
4,189,189,22,22,0,1,0
16,190,190,16,5,11,2,1
18,207,207,55,55,0,1,0
12,218,218,37,37,0,1,0
17,233,233,24,24,0,1,0
0,249,249,5,5,0,1,0
14,264,264,13,3,10,2,1
20,268,268,1,1,0,1,0
6,284,284,26,26,0,1,0
15,287,287,40,40,0,1,0
5,301,301,26,16,10,2,1
24,304,304,2,2,0,1,0
19,311,311,39,39,0,1,0
10,321,321,21,10,11,2,1
9,346,346,3,3,0,1,0
11,358,358,42,42,0,1,0
13,380,380,14,14,0,1,0
22,406,406,48,26,22,3,2
23,452,452,110,38,72,4,3
21,466,466,22,1,21,4,3
3,484,484,14,14,0,1,0
2,489,489,16,16,0,1,0
1,489,489,199,91,108,4,3

21,123,123,4,1,3,2,1
14,150,150,1,1,0,1,0
23,184,184,42,42,0,1,0
18,214,214,35,15,20,2,1
13,232,232,1,1,0,1,0
16,247,247,15,15,0,1,0
0,252,252,22,22,0,1,0
20,269,269,31,3,28,3,2
10,270,270,49,37,12,3,2
8,280,280,4,1,3,2,1
4,293,293,2,2,0,1,0
17,294,294,39,39,0,1,0
3,325,325,26,16,10,2,1
19,331,331,4,4,0,1,0
1,337,337,37,16,21,2,1
22,353,353,13,13,0,1,0
15,356,356,40,40,0,1,0
12,405,405,129,34,95,4,3
11,434,434,35,3,32,2,1
5,434,434,12,12,0,1,0
9,455,455,41,41,0,1,0
6,462,462,7,7,0,1,0
7,466,466,205,91,114,4,3
2,473,473,32,32,0,1,0

15,106,106,4,4,0,1,0
23,119,119,1,1,0,1,0
3,124,124,6,6,0,1,0
13,128,128,35,15,20,2,1
8,130,130,6,6,0,1,0
16,161,161,3,3,0,1,0
27,180,180,47,47,0,1,0
26,200,200,32,32,0,1,0
6,203,203,1,1,0,1,0
22,213,213,16,16,0,1,0
19,240,240,7,7,0,1,0
18,245,245,1,1,0,1,0
28,253,253,23,7,16,2,1
12,261,261,3,3,0,1,0
21,277,277,37,28,9,4,3
20,278,278,17,17,0,1,0
14,285,285,16,3,13,2,1
4,312,312,14,14,0,1,0
1,328,328,40,40,0,1,0
17,333,333,78,78,0,1,0
9,335,335,2,2,0,1,0
0,341,341,36,6,30,4,3
25,348,348,6,6,0,1,0
10,353,353,28,18,10,2,1
24,386,386,57,12,45,2,1
7,396,396,47,47,0,1,0
5,447,447,25,4,21,4,3
11,454,454,5,5,0,1,0
2,454,454,74,36,38,4,3

15,137,137,3,3,0,1,0
24,137,137,4,4,0,1,0
10,163,163,38,24,14,3,2
14,189,189,12,1,11,2,1
12,210,210,11,11,0,1,0
3,219,219,5,5,0,1,0
21,221,221,12,12,0,1,0
20,231,231,25,1,24,3,2
17,288,288,10,10,0,1,0
16,325,325,94,94,0,1,0
8,327,327,101,101,0,1,0
9,327,327,6,2,4,2,1
7,328,328,62,15,47,2,1
1,335,335,3,3,0,1,0
6,343,343,12,3,9,2,1
13,357,357,9,9,0,1,0
2,358,358,33,1,32,3,2
18,360,360,26,26,0,1,0
11,388,388,13,1,12,3,2
19,400,400,33,33,0,1,0
4,409,409,16,16,0,1,0
23,416,416,169,40,129,4,3
5,429,429,15,15,0,1,0
22,437,437,10,10,0,1,0
0,447,447,48,48,0,1,0
25,457,457,15,1,14,2,1

25,101,101,20,8,12,2,1
23,106,106,9,9,0,1,0
14,115,115,3,3,0,1,0
21,115,115,3,3,0,1,0
10,125,125,2,2,0,1,0
22,133,133,33,4,29,2,1
19,136,136,9,4,5,2,1
5,166,166,1,1,0,1,0
2,178,178,1,1,0,1,0
15,219,219,16,16,0,1,0
17,226,226,3,3,0,1,0
26,317,317,42,6,36,4,3
0,328,328,11,8,3,2,1
13,357,357,7,4,3,2,1
16,365,365,74,52,22,2,1
1,377,377,48,17,31,4,3
24,399,399,20,20,0,1,0
6,404,404,92,17,75,4,3
4,414,414,130,92,38,3,2
9,421,421,46,23,23,2,1
20,422,422,7,4,3,2,1
3,425,425,57,51,6,2,1
18,426,426,53,53,0,1,0
12,438,438,55,4,51,4,3
7,454,454,1,1,0,1,0
8,472,472,13,3,10,3,2
11,482,482,16,1,15,2,1

14,124,124,1,1,0,1,0
4,126,126,35,22,13,2,1
13,189,189,23,23,0,1,0
8,195,195,23,5,18,2,1
0,201,201,79,79,0,1,0
9,217,217,6,6,0,1,0
15,248,248,17,17,0,1,0
17,274,274,5,1,4,2,1
20,280,280,63,48,15,4,3
2,287,287,10,10,0,1,0
12,346,346,20,11,9,4,3
6,346,346,20,20,0,1,0
1,357,357,14,14,0,1,0
19,369,369,59,5,54,3,2
5,372,372,18,18,0,1,0
11,386,386,60,60,0,1,0
7,402,402,61,8,53,3,2
18,416,416,12,6,6,3,2
10,452,452,147,66,81,4,3
3,453,453,37,10,27,2,1
16,487,487,8,2,6,3,2

5,107,107,53,49,4,2,1
2,108,108,3,3,0,1,0
1,125,125,1,1,0,1,0
18,130,130,7,1,6,3,2
17,137,137,11,11,0,1,0
12,140,140,4,4,0,1,0
4,157,157,24,1,23,2,1
7,162,162,7,7,0,1,0
0,176,176,8,5,3,2,1
8,183,183,19,19,0,1,0
6,189,189,7,4,3,2,1
13,190,190,5,5,0,1,0
14,235,235,35,1,34,2,1
24,243,243,31,31,0,1,0
23,277,277,91,19,72,4,3
16,280,280,13,13,0,1,0
3,302,302,22,22,0,1,0
21,303,303,11,11,0,1,0
10,307,307,3,3,0,1,0
20,342,342,6,1,5,2,1
15,352,352,38,14,24,4,3
22,367,367,16,4,12,3,2
11,428,428,59,10,49,2,1
9,459,459,19,19,0,1,0
19,471,471,96,72,24,2,1

1,103,103,8,5,3,2,1
18,116,116,29,6,23,2,1
20,119,119,7,7,0,1,0
22,149,149,2,2,0,1,0
14,186,186,1,1,0,1,0
2,254,254,62,35,27,4,3
25,256,256,59,48,11,2,1
23,269,269,23,9,14,2,1
13,299,299,2,2,0,1,0
5,309,309,5,5,0,1,0
9,317,317,1,1,0,1,0
19,320,320,2,2,0,1,0
24,324,324,5,5,0,1,0
0,328,328,20,20,0,1,0
11,338,338,29,13,16,2,1
16,368,368,29,11,18,4,3
6,369,369,14,4,10,3,2
21,383,383,3,3,0,1,0
17,411,411,106,67,39,4,3
12,425,425,10,2,8,2,1
7,438,438,64,17,47,2,1
10,453,453,80,28,52,3,2
4,455,455,109,61,48,2,1
15,458,458,26,14,12,3,2
8,463,463,32,3,29,2,1
3,493,493,4,4,0,1,0
26,500,500,78,15,63,4,3

12,114,114,1,1,0,1,0
0,116,116,12,2,10,3,2
6,118,118,1,1,0,1,0
30,120,120,4,4,0,1,0
18,165,165,28,3,25,3,2
17,204,204,1,1,0,1,0
11,214,214,17,17,0,1,0
4,221,221,6,6,0,1,0
19,238,238,24,2,22,2,1
5,258,258,5,5,0,1,0
22,267,267,55,28,27,2,1
2,270,270,12,4,8,2,1
1,276,276,2,2,0,1,0
29,296,296,33,33,0,1,0
23,304,304,42,27,15,2,1
15,305,305,20,20,0,1,0
7,314,314,39,39,0,1,0
24,334,334,35,3,32,2,1
26,337,337,79,62,17,2,1
14,348,348,18,7,11,2,1
27,361,361,36,36,0,1,0
10,373,373,24,18,6,2,1
28,380,380,1,1,0,1,0
25,397,397,7,7,0,1,0
20,417,417,13,3,10,3,2
31,420,420,97,83,14,3,2
9,450,450,14,14,0,1,0
3,473,473,17,7,10,2,1
8,477,477,17,3,14,3,2
13,498,498,17,17,0,1,0
21,499,499,4,4,0,1,0
16,500,500,93,60,33,2,1

8,102,102,1,1,0,1,0
18,111,111,13,13,0,1,0
2,149,149,4,4,0,1,0
17,183,183,30,23,7,2,1
7,190,190,1,1,0,1,0
6,193,193,16,7,9,2,1
20,207,207,3,3,0,1,0
0,228,228,128,80,48,3,2
15,235,235,81,41,40,4,3
11,237,237,21,21,0,1,0
14,265,265,10,6,4,2,1
16,297,297,3,3,0,1,0
13,332,332,10,10,0,1,0
9,349,349,37,37,0,1,0
4,371,371,23,7,16,2,1
5,372,372,57,14,43,4,3
1,393,393,24,17,7,2,1
10,402,402,74,74,0,1,0
19,411,411,46,46,0,1,0
3,425,425,56,56,0,1,0
12,455,455,17,17,0,1,0
21,478,478,43,25,18,2,1

19,132,132,2,2,0,1,0
22,139,139,58,8,50,3,2
24,146,146,9,4,5,2,1
18,147,147,25,17,8,2,1
5,147,147,17,6,11,4,3
13,163,163,10,10,0,1,0
1,166,166,10,10,0,1,0
20,240,240,27,2,25,2,1
23,244,244,54,9,45,2,1
6,245,245,25,25,0,1,0
21,274,274,11,3,8,3,2
14,277,277,4,4,0,1,0
28,281,281,12,12,0,1,0
2,286,286,5,5,0,1,0
4,290,290,9,9,0,1,0
8,313,313,17,9,8,2,1
0,328,328,1,1,0,1,0
16,341,341,109,58,51,4,3
10,343,343,5,2,3,2,1
17,347,347,8,2,6,3,2
29,357,357,9,9,0,1,0
15,359,359,26,26,0,1,0
25,376,376,2,2,0,1,0
3,436,436,6,1,5,2,1
27,437,437,15,7,8,2,1
9,439,439,39,9,30,4,3
11,449,449,37,37,0,1,0
12,457,457,52,44,8,2,1
7,473,473,6,6,0,1,0
26,492,492,39,39,0,1,0

12,102,102,2,2,0,1,0
11,109,109,8,8,0,1,0
4,111,111,1,1,0,1,0
17,122,122,10,10,0,1,0
21,123,123,2,2,0,1,0
23,131,131,13,8,5,2,1
19,162,162,31,1,30,4,3
8,198,198,8,8,0,1,0
16,210,210,20,8,12,4,3
24,215,215,6,6,0,1,0
22,261,261,55,55,0,1,0
20,272,272,30,30,0,1,0
25,289,289,18,18,0,1,0
18,293,293,5,5,0,1,0
9,315,315,8,8,0,1,0
0,322,322,11,11,0,1,0
14,324,324,40,40,0,1,0
10,325,325,27,27,0,1,0
3,339,339,59,49,10,2,1
2,360,360,1,1,0,1,0
6,362,362,96,96,0,1,0
26,370,370,14,4,10,3,2
13,392,392,17,17,0,1,0
5,394,394,30,2,28,3,2
7,415,415,23,11,12,3,2
1,416,416,73,25,48,2,1
15,456,456,133,133,0,1,0

17,151,151,18,2,16,2,1
5,163,163,45,45,0,1,0
8,188,188,19,19,0,1,0
10,195,195,1,1,0,1,0
20,199,199,6,6,0,1,0
4,218,218,11,11,0,1,0
21,246,246,4,4,0,1,0
9,265,265,11,3,8,3,2
13,271,271,76,40,36,4,3
11,283,283,68,8,60,4,3
14,340,340,3,3,0,1,0
18,351,351,1,1,0,1,0
1,360,360,13,13,0,1,0
19,386,386,15,15,0,1,0
6,424,424,34,34,0,1,0
2,427,427,30,30,0,1,0
12,439,439,34,26,8,3,2
16,454,454,131,98,33,4,3
3,458,458,130,40,90,4,3
7,467,467,83,83,0,1,0
0,472,472,40,40,0,1,0
15,493,493,55,55,0,1,0

20,155,155,3,3,0,1,0
6,172,172,13,13,0,1,0
13,172,172,8,8,0,1,0
11,197,197,8,8,0,1,0
28,200,200,35,20,15,4,3
4,242,242,15,5,10,2,1
25,261,261,9,5,4,2,1
18,265,265,20,6,14,2,1
19,302,302,55,15,40,2,1
1,305,305,71,35,36,2,1
0,316,316,5,5,0,1,0
26,325,325,80,32,48,4,3
27,332,332,65,52,13,2,1
2,341,341,10,7,3,2,1
16,356,356,5,5,0,1,0
9,373,373,41,41,0,1,0
8,374,374,64,48,16,3,2
5,381,381,3,3,0,1,0
7,385,385,24,14,10,3,2
23,385,385,53,35,18,3,2
14,399,399,11,11,0,1,0
3,421,421,93,25,68,3,2
24,425,425,6,1,5,2,1
12,430,430,17,2,15,4,3
15,436,436,1,1,0,1,0
21,457,457,17,17,0,1,0
22,471,471,34,13,21,4,3
17,475,475,16,16,0,1,0
10,500,500,22,4,18,2,1

17,104,104,3,3,0,1,0
9,118,118,8,8,0,1,0
4,138,138,10,6,4,2,1
7,149,149,8,8,0,1,0
21,160,160,14,14,0,1,0
20,270,270,6,6,0,1,0
19,279,279,31,31,0,1,0
2,290,290,15,6,9,4,3
15,293,293,16,16,0,1,0
11,331,331,37,37,0,1,0
12,350,350,13,3,10,2,1
13,380,380,62,62,0,1,0
23,385,385,131,83,48,3,2
5,390,390,17,17,0,1,0
24,400,400,78,18,60,3,2
0,402,402,30,6,24,4,3
6,407,407,62,18,44,2,1
10,409,409,19,9,10,2,1
14,409,409,3,3,0,1,0
25,416,416,24,24,0,1,0
18,428,428,58,49,9,4,3
8,451,451,68,2,66,4,3
16,467,467,34,24,10,3,2
22,477,477,49,4,45,2,1
3,483,483,23,23,0,1,0
1,494,494,63,36,27,4,3

0,147,147,17,17,0,1,0
5,166,166,3,3,0,1,0
7,173,173,34,20,14,2,1
4,181,181,7,7,0,1,0
6,181,181,6,6,0,1,0
11,194,194,24,24,0,1,0
18,226,226,6,6,0,1,0
8,249,249,21,9,12,3,2
13,281,281,4,4,0,1,0
23,288,288,16,16,0,1,0
19,305,305,3,3,0,1,0
2,317,317,2,2,0,1,0
20,336,336,54,6,48,2,1
17,350,350,77,29,48,2,1
1,355,355,101,101,0,1,0
22,362,362,40,40,0,1,0
10,368,368,3,3,0,1,0
21,389,389,65,8,57,4,3
12,411,411,35,22,13,4,3
16,414,414,46,46,0,1,0
25,428,428,87,87,0,1,0
15,430,430,19,19,0,1,0
24,433,433,45,45,0,1,0
3,441,441,27,13,14,3,2
9,462,462,61,10,51,4,3
14,481,481,2,2,0,1,0

13,115,115,4,4,0,1,0
9,123,123,29,29,0,1,0
17,124,124,13,13,0,1,0
3,151,151,6,6,0,1,0
15,209,209,29,11,18,4,3
1,216,216,15,12,3,2,1
0,259,259,6,6,0,1,0
26,260,260,26,14,12,3,2
11,280,280,34,34,0,1,0
14,292,292,17,1,16,3,2
23,292,292,121,121,0,1,0
10,295,295,1,1,0,1,0
8,299,299,40,40,0,1,0
5,312,312,23,23,0,1,0
16,314,314,61,61,0,1,0
4,333,333,29,20,9,2,1
22,367,367,12,12,0,1,0
21,391,391,5,1,4,2,1
18,393,393,12,12,0,1,0
2,394,394,25,13,12,3,2
12,411,411,20,20,0,1,0
6,424,424,86,38,48,2,1
19,449,449,24,24,0,1,0
20,462,462,46,46,0,1,0
7,463,463,3,3,0,1,0
25,468,468,14,2,12,4,3
24,491,491,4,4,0,1,0

23,101,101,2,2,0,1,0
18,113,113,5,5,0,1,0
22,134,134,9,9,0,1,0
1,136,136,11,7,4,2,1
13,172,172,4,1,3,2,1
9,184,184,4,4,0,1,0
5,195,195,9,1,8,3,2
19,209,209,51,13,38,2,1
4,223,223,28,28,0,1,0
2,227,227,6,3,3,2,1
11,262,262,18,18,0,1,0
7,284,284,34,25,9,2,1
24,291,291,83,41,42,2,1
10,308,308,20,12,8,3,2
20,308,308,5,5,0,1,0
21,342,342,29,2,27,4,3
8,355,355,38,11,27,2,1
12,384,384,27,27,0,1,0
25,409,409,3,3,0,1,0
6,414,414,12,12,0,1,0
17,425,425,13,13,0,1,0
14,433,433,161,104,57,4,3
3,438,438,36,36,0,1,0
0,440,440,149,93,56,3,2
16,478,478,8,8,0,1,0
15,489,489,18,18,0,1,0

9,105,105,1,1,0,1,0
7,126,126,1,1,0,1,0
4,128,128,2,2,0,1,0
19,129,129,20,1,19,2,1
20,130,130,4,1,3,2,1
24,132,132,16,16,0,1,0
15,173,173,8,8,0,1,0
17,201,201,16,6,10,3,2
18,227,227,30,30,0,1,0
13,240,240,7,4,3,2,1
23,258,258,95,51,44,3,2
22,263,263,34,34,0,1,0
11,302,302,19,19,0,1,0
1,316,316,26,26,0,1,0
14,318,318,12,6,6,2,1
2,329,329,62,10,52,3,2
16,334,334,4,4,0,1,0
0,376,376,19,7,12,4,3
21,407,407,40,36,4,2,1
12,427,427,69,21,48,3,2
6,445,445,13,13,0,1,0
5,457,457,40,40,0,1,0
8,468,468,69,69,0,1,0
3,494,494,29,13,16,2,1
10,499,499,150,120,30,2,1

13,137,137,9,9,0,1,0
20,138,138,23,23,0,1,0
0,141,141,10,1,9,4,3
21,141,141,23,14,9,4,3
4,153,153,19,19,0,1,0
1,165,165,11,2,9,2,1
16,165,165,7,7,0,1,0
18,176,176,20,1,19,3,2
12,192,192,22,22,0,1,0
14,209,209,27,27,0,1,0
17,213,213,53,10,43,2,1
2,217,217,23,23,0,1,0
8,274,274,86,44,42,2,1
10,291,291,49,39,10,2,1
6,297,297,13,13,0,1,0
3,316,316,10,2,8,3,2
9,349,349,5,1,4,2,1
7,360,360,23,23,0,1,0
19,392,392,6,6,0,1,0
15,398,398,31,31,0,1,0
23,433,433,35,9,26,3,2
5,442,442,15,10,5,2,1
24,458,458,40,40,0,1,0
11,461,461,24,24,0,1,0
22,463,463,15,15,0,1,0

6,118,118,5,5,0,1,0
17,122,122,18,18,0,1,0
10,145,145,5,2,3,2,1
11,148,148,16,5,11,3,2
23,174,174,12,2,10,3,2
14,177,177,1,1,0,1,0
25,213,213,7,4,3,2,1
9,214,214,6,6,0,1,0
3,228,228,103,89,14,2,1
4,228,228,31,31,0,1,0
2,233,233,11,11,0,1,0
8,264,264,9,1,8,3,2
1,301,301,55,7,48,2,1
21,313,313,11,6,5,2,1
22,319,319,18,18,0,1,0
13,326,326,1,1,0,1,0
15,327,327,80,80,0,1,0
0,352,352,10,7,3,2,1
7,392,392,6,2,4,2,1
16,399,399,97,37,60,4,3
5,419,419,18,18,0,1,0
12,453,453,22,22,0,1,0
18,458,458,65,65,0,1,0
24,476,476,40,9,31,4,3
19,477,477,14,14,0,1,0
20,489,489,62,62,0,1,0

14,120,120,37,37,0,1,0
1,131,131,3,3,0,1,0
22,141,141,16,16,0,1,0
25,164,164,11,11,0,1,0
11,204,204,4,1,3,2,1
4,215,215,10,10,0,1,0
8,218,218,54,29,25,2,1
6,223,223,18,1,17,4,3
16,226,226,2,2,0,1,0
12,226,226,3,3,0,1,0
24,245,245,56,20,36,4,3
17,247,247,15,1,14,4,3
15,261,261,15,15,0,1,0
10,298,298,7,7,0,1,0
2,298,298,54,23,31,2,1
5,298,298,10,10,0,1,0
18,312,312,3,3,0,1,0
13,336,336,95,82,13,2,1
23,349,349,22,6,16,2,1
21,364,364,35,35,0,1,0
7,373,373,1,1,0,1,0
19,417,417,49,49,0,1,0
0,442,442,36,3,33,2,1
3,462,462,33,3,30,3,2
20,469,469,46,46,0,1,0
9,471,471,44,26,18,4,3

6,106,106,27,27,0,1,0
17,116,116,4,4,0,1,0
7,119,119,12,5,7,2,1
2,142,142,5,5,0,1,0
13,146,146,20,20,0,1,0
0,147,147,38,38,0,1,0
16,177,177,2,2,0,1,0
15,180,180,16,1,15,4,3
10,186,186,4,4,0,1,0
3,230,230,1,1,0,1,0
14,241,241,35,10,25,2,1
11,275,275,22,22,0,1,0
1,280,280,39,39,0,1,0
5,289,289,12,12,0,1,0
4,302,302,7,7,0,1,0
21,312,312,65,65,0,1,0
8,328,328,1,1,0,1,0
9,360,360,74,37,37,2,1
12,376,376,13,13,0,1,0
19,391,391,48,48,0,1,0
24,430,430,81,39,42,4,3
20,442,442,3,3,0,1,0
18,452,452,63,63,0,1,0
23,475,475,44,18,26,3,2
22,478,478,23,23,0,1,0

17,132,132,3,3,0,1,0
24,134,134,33,7,26,3,2
0,163,163,21,21,0,1,0
10,186,186,13,10,3,2,1
7,188,188,7,7,0,1,0
4,189,189,5,5,0,1,0
22,198,198,5,5,0,1,0
19,227,227,11,11,0,1,0
25,235,235,46,46,0,1,0
8,235,235,57,29,28,2,1
13,258,258,36,19,17,2,1
6,290,290,42,21,21,4,3
16,311,311,67,27,40,3,2
11,315,315,15,15,0,1,0
23,316,316,8,8,0,1,0
1,331,331,14,14,0,1,0
18,351,351,81,45,36,2,1
2,359,359,5,5,0,1,0
12,365,365,2,2,0,1,0
5,395,395,18,13,5,2,1
15,405,405,16,5,11,2,1
9,443,443,70,41,29,2,1
3,448,448,45,45,0,1,0
20,449,449,16,4,12,2,1
21,449,449,41,1,40,4,3
14,468,468,24,24,0,1,0

15,106,106,2,2,0,1,0
4,110,110,11,2,9,4,3
17,140,140,6,6,0,1,0
18,151,151,20,8,12,4,3
7,156,156,25,25,0,1,0
6,227,227,5,5,0,1,0
10,235,235,12,12,0,1,0
20,264,264,42,42,0,1,0
2,271,271,10,4,6,2,1
1,300,300,12,12,0,1,0
0,314,314,96,96,0,1,0
19,330,330,26,26,0,1,0
13,343,343,42,42,0,1,0
8,346,346,59,59,0,1,0
11,367,367,36,27,9,2,1
12,377,377,31,5,26,3,2
14,402,402,28,23,5,2,1
16,410,410,62,11,51,4,3
3,434,434,3,3,0,1,0
9,456,456,102,10,92,3,2
5,475,475,171,107,64,3,2

19,113,113,7,7,0,1,0
17,129,129,1,1,0,1,0
21,143,143,11,11,0,1,0
2,150,150,4,4,0,1,0
16,156,156,22,12,10,2,1
12,160,160,14,3,11,2,1
3,185,185,18,18,0,1,0
6,231,231,9,3,6,2,1
11,250,250,19,1,18,4,3
13,272,272,10,10,0,1,0
15,295,295,11,2,9,3,2
10,308,308,3,3,0,1,0
8,315,315,17,17,0,1,0
1,323,323,8,8,0,1,0
9,340,340,72,61,11,2,1
20,344,344,9,1,8,2,1
14,351,351,95,47,48,4,3
5,356,356,28,28,0,1,0
7,360,360,55,22,33,2,1
22,371,371,86,86,0,1,0
4,386,386,12,12,0,1,0
0,409,409,195,195,0,1,0
18,490,490,83,83,0,1,0

4,146,146,1,1,0,1,0
11,146,146,6,6,0,1,0
17,157,157,21,21,0,1,0
0,191,191,7,7,0,1,0
13,201,201,7,1,6,3,2
18,215,215,1,1,0,1,0
27,227,227,8,8,0,1,0
16,231,231,15,5,10,2,1
29,237,237,32,32,0,1,0
15,245,245,55,55,0,1,0
31,247,247,9,9,0,1,0
25,269,269,109,79,30,2,1
9,283,283,10,10,0,1,0
23,289,289,14,8,6,2,1
8,302,302,4,4,0,1,0
20,302,302,21,14,7,2,1
28,302,302,24,3,21,3,2
3,354,354,47,20,27,2,1
33,377,377,16,8,8,2,1
5,403,403,1,1,0,1,0
21,407,407,22,4,18,3,2
32,408,408,2,2,0,1,0
10,419,419,9,9,0,1,0
22,422,422,15,7,8,2,1
1,426,426,18,14,4,2,1
2,429,429,30,30,0,1,0
14,430,430,18,18,0,1,0
26,442,442,122,14,108,4,3
34,457,457,36,36,0,1,0
12,458,458,25,25,0,1,0
6,459,459,16,2,14,2,1
19,459,459,19,19,0,1,0
30,462,462,17,6,11,2,1
24,480,480,21,21,0,1,0
7,491,491,2,2,0,1,0

13,122,122,9,9,0,1,0
27,140,140,22,22,0,1,0
2,166,166,7,7,0,1,0
8,176,176,41,41,0,1,0
20,187,187,24,6,18,4,3
21,189,189,1,1,0,1,0
4,196,196,12,5,7,2,1
18,196,196,8,8,0,1,0
7,221,221,3,3,0,1,0
9,253,253,23,17,6,2,1
23,257,257,3,3,0,1,0
15,284,284,1,1,0,1,0
19,295,295,3,3,0,1,0
12,301,301,1,1,0,1,0
25,325,325,19,7,12,3,2
24,325,325,19,9,10,3,2
10,329,329,37,28,9,2,1
11,337,337,33,33,0,1,0
22,340,340,53,53,0,1,0
16,349,349,20,11,9,4,3
28,350,350,49,29,20,2,1
17,355,355,91,5,86,3,2
26,356,356,73,10,63,3,2
3,360,360,17,6,11,2,1
14,413,413,51,14,37,2,1
5,421,421,17,8,9,4,3
0,459,459,33,15,18,2,1
1,469,469,57,43,14,3,2
6,471,471,4,4,0,1,0

13,106,106,5,5,0,1,0
9,107,107,6,1,5,2,1
0,113,113,2,2,0,1,0
21,118,118,4,4,0,1,0
22,152,152,41,41,0,1,0
15,173,173,11,11,0,1,0
3,185,185,18,6,12,2,1
6,219,219,10,10,0,1,0
16,230,230,6,6,0,1,0
14,232,232,47,47,0,1,0
18,232,232,19,13,6,2,1
4,243,243,17,9,8,2,1
2,267,267,9,9,0,1,0
5,275,275,106,96,10,3,2
8,293,293,44,36,8,2,1
7,326,326,23,23,0,1,0
19,326,326,6,6,0,1,0
1,336,336,42,17,25,2,1
11,348,348,25,5,20,2,1
17,368,368,24,10,14,2,1
12,396,396,101,25,76,3,2
10,435,435,65,65,0,1,0
20,471,471,42,2,40,3,2

16,123,123,24,3,21,4,3
5,140,140,38,38,0,1,0
15,149,149,1,1,0,1,0
13,155,155,48,18,30,3,2
4,158,158,8,8,0,1,0
14,161,161,11,3,8,3,2
2,190,190,18,15,3,2,1
6,192,192,11,11,0,1,0
0,234,234,37,10,27,2,1
12,245,245,8,8,0,1,0
18,250,250,23,23,0,1,0
7,287,287,6,6,0,1,0
19,297,297,42,42,0,1,0
22,350,350,13,13,0,1,0
21,356,356,10,4,6,2,1
17,362,362,2,2,0,1,0
11,366,366,15,8,7,2,1
3,414,414,115,69,46,4,3
8,419,419,15,1,14,2,1
10,426,426,64,21,43,2,1
9,433,433,13,1,12,4,3
1,490,490,26,17,9,2,1
20,494,494,135,135,0,1,0

20,101,101,30,30,0,1,0
4,109,109,14,2,12,4,3
19,118,118,10,10,0,1,0
3,166,166,3,3,0,1,0
14,175,175,25,7,18,2,1
11,183,183,2,2,0,1,0
9,201,201,21,21,0,1,0
7,229,229,4,1,3,2,1
25,251,251,16,16,0,1,0
23,254,254,20,20,0,1,0
6,264,264,34,34,0,1,0
17,266,266,14,14,0,1,0
22,268,268,5,5,0,1,0
24,280,280,27,13,14,3,2
13,289,289,22,22,0,1,0
0,315,315,30,30,0,1,0
1,327,327,75,30,45,4,3
2,351,351,4,4,0,1,0
21,369,369,38,3,35,4,3
18,389,389,16,16,0,1,0
10,404,404,106,102,4,2,1
5,447,447,35,11,24,2,1
12,461,461,18,18,0,1,0
15,466,466,20,20,0,1,0
16,472,472,90,90,0,1,0
8,490,490,1,1,0,1,0

8,108,108,10,10,0,1,0
9,110,110,3,3,0,1,0
17,110,110,4,1,3,2,1
18,134,134,2,2,0,1,0
26,154,154,2,2,0,1,0
12,163,163,1,1,0,1,0
5,180,180,17,17,0,1,0
24,204,204,6,6,0,1,0
7,238,238,11,4,7,2,1
13,240,240,14,14,0,1,0
25,242,242,6,1,5,2,1
21,249,249,27,22,5,2,1
3,266,266,16,2,14,2,1
2,309,309,50,50,0,1,0
4,328,328,56,34,22,2,1
0,330,330,20,20,0,1,0
19,334,334,63,63,0,1,0
6,338,338,22,12,10,3,2
22,343,343,11,2,9,4,3
1,345,345,19,19,0,1,0
11,384,384,31,3,28,3,2
23,421,421,38,4,34,2,1
15,423,423,52,46,6,2,1
10,441,441,23,23,0,1,0
16,480,480,186,138,48,4,3
14,496,496,84,76,8,2,1
20,500,500,88,88,0,1,0

19,106,106,7,7,0,1,0
8,112,112,10,1,9,4,3
2,137,137,1,1,0,1,0
12,157,157,11,11,0,1,0
0,160,160,9,9,0,1,0
13,169,169,13,4,9,2,1
5,188,188,14,2,12,4,3
3,213,213,14,14,0,1,0
22,213,213,14,5,9,2,1
14,272,272,18,18,0,1,0
27,275,275,3,3,0,1,0
1,282,282,13,8,5,2,1
6,290,290,3,3,0,1,0
18,293,293,15,15,0,1,0
25,297,297,46,8,38,3,2
15,341,341,36,5,31,2,1
23,341,341,4,4,0,1,0
20,351,351,41,8,33,4,3
11,391,391,8,2,6,2,1
9,400,400,110,85,25,2,1
10,415,415,14,2,12,2,1
21,425,425,33,33,0,1,0
17,440,440,200,200,0,1,0
16,488,488,4,4,0,1,0
26,497,497,80,35,45,2,1
7,498,498,74,74,0,1,0
4,499,499,28,28,0,1,0
24,500,500,19,19,0,1,0

4,112,112,3,3,0,1,0
14,146,146,29,13,16,2,1
19,181,181,24,24,0,1,0
21,211,211,65,16,49,2,1
20,270,270,34,28,6,3,2
8,297,297,22,22,0,1,0
10,338,338,55,8,47,4,3
6,342,342,92,40,52,3,2
12,343,343,5,5,0,1,0
9,345,345,10,10,0,1,0
11,347,347,35,7,28,3,2
16,353,353,10,10,0,1,0
5,356,356,32,23,9,2,1
15,398,398,15,3,12,4,3
7,400,400,27,5,22,3,2
3,408,408,125,93,32,3,2
13,411,411,32,8,24,4,3
17,416,416,4,1,3,2,1
2,427,427,2,2,0,1,0
18,432,432,10,10,0,1,0
1,441,441,18,9,9,4,3
0,460,460,135,33,102,4,3

7,149,149,12,3,9,4,3
0,170,170,31,31,0,1,0
5,182,182,15,15,0,1,0
12,213,213,105,80,25,4,3
10,219,219,4,4,0,1,0
11,220,220,23,23,0,1,0
13,285,285,7,7,0,1,0
14,304,304,4,1,3,2,1
1,311,311,26,1,25,2,1
19,319,319,21,9,12,3,2
16,334,334,14,14,0,1,0
18,345,345,9,9,0,1,0
15,353,353,7,7,0,1,0
3,368,368,13,13,0,1,0
2,374,374,67,5,62,3,2
6,417,417,82,17,65,4,3
20,433,433,68,50,18,4,3
4,440,440,12,3,9,2,1
9,465,465,70,70,0,1,0
17,471,471,52,52,0,1,0
8,490,490,164,48,116,4,3

3,105,105,1,1,0,1,0
0,118,118,23,23,0,1,0
21,172,172,23,3,20,3,2
5,183,183,30,30,0,1,0
4,208,208,11,7,4,2,1
11,208,208,11,11,0,1,0
18,213,213,16,6,10,3,2
10,214,214,1,1,0,1,0
6,235,235,18,18,0,1,0
8,273,273,5,5,0,1,0
13,283,283,3,3,0,1,0
23,284,284,30,27,3,2,1
15,285,285,78,29,49,4,3
16,313,313,69,69,0,1,0
1,354,354,8,8,0,1,0
20,388,388,8,8,0,1,0
17,391,391,67,67,0,1,0
14,407,407,14,7,7,2,1
22,427,427,35,35,0,1,0
9,447,447,24,24,0,1,0
7,456,456,145,145,0,1,0
19,465,465,2,2,0,1,0
2,498,498,116,113,3,2,1
12,500,500,42,39,3,2,1

11,112,112,10,2,8,2,1
18,127,127,10,2,8,3,2
5,137,137,42,42,0,1,0
17,156,156,46,38,8,3,2
14,173,173,21,21,0,1,0
19,182,182,17,17,0,1,0
3,196,196,20,11,9,4,3
8,199,199,9,9,0,1,0
6,205,205,33,33,0,1,0
20,211,211,1,1,0,1,0
0,226,226,35,25,10,3,2
13,282,282,19,5,14,2,1
4,314,314,26,10,16,2,1
16,340,340,98,38,60,4,3
15,341,341,18,18,0,1,0
1,353,353,33,33,0,1,0
2,373,373,55,19,36,2,1
9,457,457,17,17,0,1,0
7,465,465,50,4,46,3,2
10,488,488,40,40,0,1,0
12,490,490,8,4,4,2,1

10,111,111,9,4,5,2,1
7,123,123,29,29,0,1,0
13,125,125,5,5,0,1,0
19,128,128,21,7,14,4,3
8,150,150,30,16,14,3,2
5,159,159,12,5,7,2,1
18,185,185,10,10,0,1,0
0,187,187,100,29,71,4,3
2,198,198,46,17,29,2,1
15,234,234,32,20,12,4,3
16,254,254,73,73,0,1,0
12,281,281,32,32,0,1,0
1,285,285,12,12,0,1,0
6,340,340,12,4,8,2,1
14,342,342,3,3,0,1,0
9,372,372,2,2,0,1,0
11,378,378,3,3,0,1,0
17,395,395,50,35,15,4,3
3,488,488,19,19,0,1,0
4,495,495,4,4,0,1,0

15,104,104,26,26,0,1,0
23,119,119,1,1,0,1,0
13,148,148,1,1,0,1,0
8,153,153,10,1,9,4,3
12,172,172,8,3,5,2,1
16,177,177,8,5,3,2,1
1,184,184,18,3,15,3,2
9,187,187,71,71,0,1,0
20,212,212,28,13,15,2,1
17,237,237,50,50,0,1,0
5,260,260,7,7,0,1,0
7,277,277,3,3,0,1,0
21,281,281,60,22,38,2,1
2,285,285,88,25,63,4,3
22,301,301,8,1,7,3,2
11,308,308,30,30,0,1,0
19,310,310,18,18,0,1,0
0,315,315,15,15,0,1,0
6,316,316,5,5,0,1,0
3,329,329,7,7,0,1,0
10,365,365,27,27,0,1,0
14,391,391,29,13,16,3,2
18,445,445,71,71,0,1,0
4,492,492,27,27,0,1,0

26,103,103,6,6,0,1,0
10,121,121,8,8,0,1,0
13,133,133,12,12,0,1,0
9,165,165,4,4,0,1,0
6,175,175,1,1,0,1,0
19,198,198,6,6,0,1,0
4,210,210,1,1,0,1,0
21,239,239,2,2,0,1,0
7,252,252,8,2,6,3,2
22,255,255,33,33,0,1,0
5,270,270,1,1,0,1,0
3,295,295,3,3,0,1,0
15,296,296,34,28,6,2,1
14,304,304,11,6,5,2,1
2,321,321,34,4,30,3,2
17,324,324,7,7,0,1,0
25,344,344,79,2,77,4,3
18,349,349,3,3,0,1,0
23,369,369,82,82,0,1,0
1,373,373,111,60,51,4,3
20,378,378,62,62,0,1,0
8,388,388,57,57,0,1,0
11,412,412,95,57,38,3,2
0,459,459,3,3,0,1,0
24,459,459,91,91,0,1,0
16,475,475,17,17,0,1,0
12,479,479,68,68,0,1,0

19,127,127,29,29,0,1,0
26,127,127,2,2,0,1,0
20,141,141,26,7,19,2,1
15,152,152,18,18,0,1,0
21,159,159,18,3,15,4,3
17,164,164,5,5,0,1,0
23,165,165,1,1,0,1,0
25,184,184,23,23,0,1,0
4,186,186,10,10,0,1,0
10,244,244,1,1,0,1,0
5,257,257,48,48,0,1,0
0,313,313,12,12,0,1,0
3,315,315,9,4,5,2,1
9,325,325,2,2,0,1,0
11,357,357,39,39,0,1,0
14,358,358,8,8,0,1,0
6,360,360,6,3,3,2,1
13,363,363,7,7,0,1,0
24,371,371,25,25,0,1,0
1,385,385,58,10,48,4,3
2,405,405,114,114,0,1,0
12,417,417,1,1,0,1,0
16,420,420,51,5,46,3,2
18,427,427,2,2,0,1,0
22,440,440,90,90,0,1,0
7,456,456,7,7,0,1,0
8,467,467,124,124,0,1,0

23,158,158,1,1,0,1,0
24,165,165,11,1,10,3,2
16,173,173,26,26,0,1,0
7,178,178,44,7,37,2,1
1,183,183,8,5,3,2,1
8,189,189,14,14,0,1,0
25,211,211,2,2,0,1,0
10,246,246,22,22,0,1,0
9,247,247,35,35,0,1,0
22,251,251,55,55,0,1,0
17,264,264,30,30,0,1,0
12,281,281,16,16,0,1,0
0,299,299,36,36,0,1,0
2,337,337,32,32,0,1,0
6,348,348,1,1,0,1,0
13,359,359,19,5,14,4,3
15,393,393,27,27,0,1,0
14,395,395,101,14,87,4,3
19,409,409,12,12,0,1,0
4,410,410,3,3,0,1,0
5,430,430,58,8,50,3,2
11,432,432,31,31,0,1,0
21,440,440,14,14,0,1,0
20,464,464,121,37,84,4,3
18,481,481,7,7,0,1,0
3,484,484,30,30,0,1,0

13,112,112,16,4,12,3,2
5,123,123,2,2,0,1,0
21,132,132,16,16,0,1,0
15,144,144,19,14,5,2,1
10,171,171,12,5,7,2,1
17,173,173,2,2,0,1,0
11,176,176,9,1,8,3,2
3,194,194,12,12,0,1,0
25,197,197,11,11,0,1,0
24,210,210,17,17,0,1,0
26,232,232,20,2,18,3,2
22,254,254,22,5,17,2,1
28,260,260,32,32,0,1,0
19,281,281,5,5,0,1,0
27,321,321,4,1,3,2,1
4,338,338,15,7,8,3,2
8,339,339,11,11,0,1,0
2,361,361,33,33,0,1,0
20,370,370,102,24,78,4,3
6,400,400,62,62,0,1,0
7,410,410,17,5,12,4,3
1,421,421,10,10,0,1,0
23,426,426,93,93,0,1,0
16,431,431,10,5,5,2,1
12,449,449,69,69,0,1,0
0,472,472,18,9,9,2,1
9,475,475,29,29,0,1,0
14,475,475,30,30,0,1,0
18,493,493,63,63,0,1,0

13,101,101,18,12,6,2,1
3,108,108,1,1,0,1,0
5,111,111,1,1,0,1,0
7,132,132,7,7,0,1,0
10,176,176,29,11,18,4,3
14,180,180,7,2,5,2,1
6,232,232,8,8,0,1,0
0,249,249,36,36,0,1,0
1,296,296,4,4,0,1,0
20,322,322,68,29,39,4,3
12,324,324,52,7,45,2,1
19,352,352,28,28,0,1,0
23,353,353,24,4,20,3,2
16,368,368,34,1,33,4,3
11,379,379,18,18,0,1,0
9,381,381,30,30,0,1,0
8,399,399,72,72,0,1,0
22,410,410,12,12,0,1,0
17,430,430,20,20,0,1,0
21,431,431,77,41,36,2,1
15,433,433,56,27,29,2,1
24,451,451,54,54,0,1,0
18,484,484,87,50,37,2,1
4,487,487,28,3,25,2,1
2,487,487,34,34,0,1,0
25,489,489,21,21,0,1,0

24,138,138,9,3,6,2,1
20,142,142,7,1,6,3,2
12,144,144,9,9,0,1,0
4,149,149,13,3,10,4,3
28,173,173,31,31,0,1,0
16,179,179,35,35,0,1,0
8,200,200,26,26,0,1,0
14,208,208,9,3,6,2,1
5,213,213,2,2,0,1,0
23,225,225,4,4,0,1,0
10,271,271,34,19,15,2,1
6,275,275,1,1,0,1,0
19,275,275,64,14,50,3,2
7,279,279,51,22,29,2,1
18,285,285,30,20,10,2,1
11,318,318,21,21,0,1,0
9,336,336,33,12,21,2,1
13,344,344,3,3,0,1,0
17,383,383,3,3,0,1,0
15,394,394,2,2,0,1,0
21,411,411,38,17,21,4,3
22,414,414,37,37,0,1,0
3,421,421,12,9,3,2,1
26,469,469,49,14,35,2,1
0,479,479,22,22,0,1,0
25,482,482,86,86,0,1,0
2,493,493,32,32,0,1,0
27,493,493,47,21,26,2,1
1,494,494,22,22,0,1,0

15,103,103,14,10,4,2,1
21,113,113,9,9,0,1,0
8,123,123,21,21,0,1,0
10,148,148,8,5,3,2,1
17,153,153,3,3,0,1,0
20,156,156,37,37,0,1,0
7,162,162,8,8,0,1,0
5,170,170,1,1,0,1,0
14,218,218,20,8,12,4,3
22,229,229,20,20,0,1,0
1,237,237,4,1,3,2,1
19,249,249,14,14,0,1,0
6,262,262,3,3,0,1,0
16,358,358,52,29,23,2,1
3,371,371,14,6,8,2,1
18,378,378,25,6,19,2,1
0,392,392,28,28,0,1,0
2,395,395,151,143,8,3,2
9,442,442,98,98,0,1,0
4,443,443,8,8,0,1,0
11,456,456,74,15,59,4,3
23,465,465,85,43,42,2,1
12,469,469,1,1,0,1,0
13,473,473,54,54,0,1,0

2,109,109,2,2,0,1,0
15,121,121,7,1,6,2,1
14,141,141,1,1,0,1,0
21,149,149,12,12,0,1,0
19,166,166,5,5,0,1,0
25,169,169,6,2,4,2,1
7,188,188,7,7,0,1,0
3,205,205,5,2,3,2,1
22,235,235,8,8,0,1,0
9,238,238,10,2,8,2,1
13,240,240,13,4,9,4,3
16,244,244,72,72,0,1,0
10,248,248,39,39,0,1,0
11,248,248,9,6,3,2,1
0,272,272,1,1,0,1,0
6,289,289,32,5,27,4,3
1,295,295,57,57,0,1,0
23,317,317,77,62,15,4,3
12,321,321,25,5,20,2,1
17,380,380,66,66,0,1,0
8,390,390,72,63,9,4,3
4,397,397,59,59,0,1,0
5,434,434,49,49,0,1,0
18,454,454,32,32,0,1,0
20,454,454,60,47,13,2,1
24,465,465,34,34,0,1,0

10,102,102,5,1,4,2,1
4,132,132,22,4,18,3,2
2,138,138,8,8,0,1,0
13,144,144,5,5,0,1,0
21,160,160,82,40,42,3,2
15,175,175,22,1,21,3,2
16,231,231,30,30,0,1,0
5,235,235,12,5,7,2,1
8,251,251,37,37,0,1,0
6,254,254,20,20,0,1,0
1,291,291,44,44,0,1,0
22,304,304,31,31,0,1,0
19,316,316,51,51,0,1,0
26,337,337,5,1,4,2,1
14,372,372,2,2,0,1,0
11,382,382,13,2,11,2,1
20,383,383,9,9,0,1,0
23,394,394,18,6,12,3,2
9,397,397,108,16,92,4,3
18,399,399,2,2,0,1,0
25,412,412,3,3,0,1,0
7,413,413,49,49,0,1,0
12,421,421,1,1,0,1,0
3,461,461,13,1,12,4,3
24,464,464,17,10,7,2,1
0,469,469,2,2,0,1,0
17,493,493,29,14,15,2,1

11,130,130,28,22,6,3,2
22,141,141,17,13,4,2,1
12,156,156,2,2,0,1,0
9,170,170,34,34,0,1,0
2,197,197,2,2,0,1,0
21,253,253,8,5,3,2,1
0,259,259,47,38,9,4,3
18,280,280,66,31,35,2,1
17,321,321,29,1,28,3,2
16,351,351,13,3,10,3,2
5,355,355,8,2,6,3,2
1,370,370,17,17,0,1,0
6,396,396,2,2,0,1,0
20,402,402,99,2,97,4,3
14,407,407,27,17,10,2,1
13,410,410,65,47,18,3,2
19,428,428,70,70,0,1,0
23,438,438,20,20,0,1,0
10,439,439,4,4,0,1,0
7,441,441,168,124,44,3,2
15,446,446,4,4,0,1,0
3,459,459,8,8,0,1,0
8,488,488,44,44,0,1,0
4,493,493,11,11,0,1,0

18,103,103,7,7,0,1,0
14,109,109,48,48,0,1,0
3,123,123,39,39,0,1,0
17,126,126,8,8,0,1,0
7,146,146,11,7,4,2,1
4,180,180,17,2,15,4,3
15,181,181,1,1,0,1,0
11,202,202,9,9,0,1,0
8,228,228,32,14,18,2,1
6,235,235,1,1,0,1,0
16,314,314,28,16,12,2,1
20,320,320,19,15,4,2,1
10,336,336,6,6,0,1,0
19,343,343,1,1,0,1,0
0,348,348,73,32,41,4,3
1,352,352,2,2,0,1,0
13,359,359,14,10,4,2,1
12,384,384,117,77,40,2,1
2,385,385,13,9,4,2,1
9,411,411,88,88,0,1,0
5,488,488,52,52,0,1,0
21,494,494,42,42,0,1,0

1,106,106,2,2,0,1,0
7,109,109,4,4,0,1,0
18,122,122,7,7,0,1,0
14,155,155,38,2,36,2,1
11,174,174,9,9,0,1,0
15,190,190,20,6,14,3,2
22,204,204,7,7,0,1,0
12,206,206,6,6,0,1,0
4,261,261,16,16,0,1,0
20,276,276,53,53,0,1,0
21,292,292,25,25,0,1,0
0,298,298,29,29,0,1,0
5,307,307,41,20,21,4,3
13,328,328,17,17,0,1,0
8,349,349,15,15,0,1,0
2,356,356,101,83,18,4,3
23,359,359,49,49,0,1,0
10,366,366,91,77,14,3,2
17,387,387,38,15,23,2,1
24,400,400,3,3,0,1,0
3,402,402,22,7,15,4,3
19,435,435,1,1,0,1,0
16,441,441,90,90,0,1,0
6,468,468,25,25,0,1,0
9,488,488,44,9,35,4,3

2,107,107,1,1,0,1,0
3,143,143,1,1,0,1,0
6,166,166,37,37,0,1,0
22,184,184,24,10,14,2,1
23,190,190,10,10,0,1,0
4,190,190,45,35,10,2,1
13,196,196,38,38,0,1,0
20,197,197,3,3,0,1,0
10,205,205,18,18,0,1,0
17,215,215,3,3,0,1,0
14,231,231,49,1,48,4,3
11,245,245,16,4,12,4,3
12,259,259,3,3,0,1,0
16,261,261,63,7,56,3,2
18,262,262,28,6,22,2,1
19,379,379,35,14,21,2,1
0,383,383,71,64,7,2,1
8,389,389,28,10,18,3,2
15,425,425,24,15,9,4,3
21,447,447,44,29,15,4,3
9,453,453,27,27,0,1,0
5,454,454,7,7,0,1,0
7,473,473,5,5,0,1,0
1,490,490,112,112,0,1,0

16,120,120,1,1,0,1,0
14,120,120,1,1,0,1,0
6,202,202,29,10,19,2,1
19,202,202,73,4,69,4,3
9,211,211,8,8,0,1,0
17,228,228,1,1,0,1,0
12,240,240,39,39,0,1,0
26,240,240,1,1,0,1,0
23,265,265,16,3,13,2,1
8,269,269,1,1,0,1,0
27,282,282,9,4,5,2,1
5,290,290,19,19,0,1,0
25,310,310,49,49,0,1,0
18,321,321,3,3,0,1,0
13,323,323,28,22,6,3,2
21,326,326,125,56,69,4,3
11,334,334,45,45,0,1,0
0,390,390,24,24,0,1,0
3,392,392,14,2,12,3,2
4,395,395,9,2,7,2,1
10,426,426,41,41,0,1,0
20,465,465,52,22,30,4,3
24,472,472,28,22,6,3,2
2,474,474,16,7,9,4,3
15,477,477,86,44,42,4,3
1,482,482,15,15,0,1,0
7,497,497,48,48,0,1,0
22,499,499,15,6,9,4,3

2,119,119,9,9,0,1,0
10,168,168,4,1,3,2,1
13,169,169,32,32,0,1,0
12,169,169,6,6,0,1,0
6,188,188,22,22,0,1,0
22,194,194,8,8,0,1,0
20,245,245,33,33,0,1,0
8,271,271,7,4,3,2,1
14,285,285,7,4,3,2,1
19,321,321,19,5,14,3,2
0,328,328,26,7,19,2,1
15,361,361,24,6,18,4,3
3,381,381,24,24,0,1,0
9,392,392,19,19,0,1,0
21,394,394,3,3,0,1,0
1,411,411,85,17,68,3,2
11,414,414,57,57,0,1,0
5,431,431,133,95,38,4,3
16,442,442,20,9,11,2,1
17,449,449,43,20,23,2,1
7,465,465,64,60,4,2,1
18,480,480,186,141,45,2,1
4,488,488,56,56,0,1,0

11,104,104,16,2,14,3,2
18,126,126,36,4,32,3,2
0,134,134,14,14,0,1,0
26,138,138,17,9,8,3,2
5,145,145,8,8,0,1,0
20,185,185,23,8,15,2,1
8,187,187,25,7,18,4,3
21,195,195,47,5,42,2,1
3,212,212,23,12,11,2,1
27,240,240,29,29,0,1,0
23,262,262,23,6,17,2,1
16,289,289,11,11,0,1,0
29,320,320,26,26,0,1,0
4,326,326,4,4,0,1,0
17,328,328,7,3,4,2,1
19,338,338,18,18,0,1,0
25,354,354,16,10,6,3,2
24,365,365,10,6,4,2,1
6,383,383,4,4,0,1,0
7,389,389,1,1,0,1,0
1,397,397,58,58,0,1,0
2,402,402,49,49,0,1,0
10,410,410,5,5,0,1,0
13,412,412,6,6,0,1,0
12,414,414,29,1,28,3,2
14,417,417,55,13,42,3,2
9,430,430,2,2,0,1,0
22,436,436,4,4,0,1,0
28,439,439,9,9,0,1,0
15,497,497,29,11,18,4,3

17,103,103,2,2,0,1,0
12,124,124,4,4,0,1,0
4,152,152,29,29,0,1,0
1,153,153,10,10,0,1,0
18,154,154,30,30,0,1,0
21,188,188,11,4,7,2,1
0,238,238,7,7,0,1,0
15,242,242,27,24,3,2,1
11,246,246,5,5,0,1,0
23,289,289,17,17,0,1,0
9,291,291,29,29,0,1,0
10,300,300,34,4,30,4,3
22,329,329,122,119,3,2,1
13,335,335,90,54,36,4,3
2,341,341,22,22,0,1,0
20,354,354,6,6,0,1,0
14,369,369,3,3,0,1,0
19,389,389,4,4,0,1,0
7,409,409,84,84,0,1,0
3,412,412,99,39,60,4,3
8,443,443,18,18,0,1,0
5,477,477,58,58,0,1,0
6,479,479,6,2,4,2,1
16,489,489,40,40,0,1,0

8,100,100,3,3,0,1,0
10,186,186,11,4,7,2,1
13,201,201,21,21,0,1,0
12,203,203,27,27,0,1,0
0,215,215,1,1,0,1,0
1,234,234,7,4,3,2,1
4,237,237,13,1,12,2,1
9,254,254,16,16,0,1,0
14,282,282,23,23,0,1,0
19,302,302,78,78,0,1,0
3,307,307,97,68,29,2,1
7,329,329,43,43,0,1,0
5,342,342,43,43,0,1,0
16,344,344,68,59,9,4,3
15,350,350,3,3,0,1,0
6,389,389,75,75,0,1,0
11,448,448,12,12,0,1,0
2,452,452,157,151,6,3,2
18,493,493,66,14,52,3,2
17,495,495,62,36,26,2,1

8,106,106,9,6,3,2,1
12,147,147,4,4,0,1,0
13,175,175,40,40,0,1,0
3,176,176,36,2,34,2,1
20,183,183,39,39,0,1,0
4,210,210,2,2,0,1,0
17,229,229,18,14,4,2,1
14,245,245,7,7,0,1,0
21,250,250,1,1,0,1,0
16,270,270,23,23,0,1,0
23,292,292,13,13,0,1,0
5,307,307,1,1,0,1,0
10,315,315,24,3,21,4,3
0,351,351,18,7,11,4,3
15,371,371,3,3,0,1,0
7,371,371,25,25,0,1,0
1,379,379,37,37,0,1,0
18,386,386,39,39,0,1,0
2,390,390,50,50,0,1,0
19,415,415,26,2,24,4,3
22,435,435,149,144,5,2,1
9,449,449,54,6,48,3,2
11,470,470,91,46,45,2,1
6,473,473,78,72,6,2,1

0,122,122,16,16,0,1,0
2,122,122,2,2,0,1,0
14,130,130,8,2,6,3,2
21,130,130,22,4,18,2,1
3,131,131,7,2,5,2,1
17,132,132,11,11,0,1,0
5,149,149,3,3,0,1,0
8,182,182,5,5,0,1,0
22,200,200,14,4,10,4,3
6,200,200,43,15,28,3,2
19,204,204,7,1,6,3,2
23,214,214,69,69,0,1,0
25,225,225,12,12,0,1,0
11,233,233,77,77,0,1,0
12,289,289,22,22,0,1,0
7,296,296,9,9,0,1,0
24,302,302,14,2,12,3,2
16,313,313,16,16,0,1,0
1,323,323,3,3,0,1,0
15,327,327,47,47,0,1,0
4,404,404,40,4,36,2,1
9,424,424,12,12,0,1,0
13,459,459,12,12,0,1,0
18,469,469,34,16,18,2,1
10,495,495,39,39,0,1,0
20,499,499,74,60,14,2,1
26,499,499,13,13,0,1,0

22,104,104,6,6,0,1,0
11,124,124,1,1,0,1,0
18,132,132,13,7,6,3,2
17,137,137,49,25,24,2,1
7,148,148,5,5,0,1,0
27,155,155,13,13,0,1,0
20,173,173,10,10,0,1,0
21,177,177,5,5,0,1,0
8,200,200,1,1,0,1,0
28,207,207,6,6,0,1,0
9,252,252,16,16,0,1,0
26,258,258,24,9,15,4,3
16,264,264,1,1,0,1,0
24,272,272,1,1,0,1,0
15,279,279,56,56,0,1,0
0,283,283,13,1,12,4,3
6,284,284,16,16,0,1,0
19,295,295,6,6,0,1,0
23,303,303,103,48,55,4,3
29,317,317,67,67,0,1,0
12,325,325,15,7,8,3,2
14,331,331,20,20,0,1,0
10,333,333,33,33,0,1,0
13,346,346,7,4,3,2,1
5,360,360,6,6,0,1,0
2,362,362,3,3,0,1,0
3,375,375,10,1,9,2,1
1,440,440,59,35,24,3,2
25,458,458,94,84,10,3,2
4,490,490,7,7,0,1,0

3,107,107,30,30,0,1,0
12,127,127,9,9,0,1,0
20,164,164,31,19,12,4,3
18,178,178,4,4,0,1,0
0,189,189,17,7,10,2,1
15,193,193,11,11,0,1,0
21,196,196,45,45,0,1,0
19,198,198,16,16,0,1,0
2,232,232,46,46,0,1,0
14,234,234,16,16,0,1,0
16,250,250,78,66,12,2,1
11,260,260,21,21,0,1,0
4,265,265,32,2,30,4,3
6,269,269,2,2,0,1,0
24,296,296,26,4,22,2,1
10,340,340,56,18,38,3,2
22,364,364,25,13,12,2,1
17,383,383,12,12,0,1,0
7,400,400,30,3,27,4,3
23,407,407,14,9,5,2,1
9,416,416,7,7,0,1,0
8,417,417,13,13,0,1,0
13,420,420,16,16,0,1,0
5,430,430,19,2,17,2,1
1,446,446,11,11,0,1,0

10,112,112,1,1,0,1,0
2,125,125,24,3,21,4,3
5,127,127,1,1,0,1,0
17,195,195,34,34,0,1,0
4,223,223,37,37,0,1,0
16,241,241,3,3,0,1,0
14,253,253,4,4,0,1,0
19,303,303,41,20,21,4,3
0,317,317,1,1,0,1,0
6,329,329,52,45,7,2,1
8,365,365,106,77,29,2,1
13,368,368,12,12,0,1,0
23,387,387,191,82,109,4,3
9,391,391,101,89,12,2,1
3,428,428,35,11,24,2,1
22,440,440,15,2,13,2,1
15,446,446,33,27,6,3,2
11,454,454,11,8,3,2,1
1,458,458,3,3,0,1,0
18,463,463,11,3,8,2,1
12,482,482,6,6,0,1,0
20,485,485,65,65,0,1,0
21,487,487,36,36,0,1,0
7,500,500,2,2,0,1,0

16,112,112,19,19,0,1,0
5,130,130,1,1,0,1,0
0,136,136,5,5,0,1,0
24,138,138,8,5,3,2,1
27,139,139,20,3,17,3,2
10,185,185,2,2,0,1,0
14,212,212,68,68,0,1,0
7,214,214,3,3,0,1,0
2,225,225,1,1,0,1,0
17,237,237,5,2,3,2,1
6,238,238,12,12,0,1,0
4,239,239,14,14,0,1,0
18,240,240,9,9,0,1,0
21,266,266,44,3,41,2,1
22,266,266,13,4,9,4,3
29,271,271,1,1,0,1,0
3,300,300,25,9,16,3,2
8,312,312,8,8,0,1,0
13,327,327,3,3,0,1,0
19,336,336,2,2,0,1,0
28,340,340,26,26,0,1,0
31,359,359,6,6,0,1,0
23,369,369,32,8,24,4,3
26,415,415,54,14,40,3,2
12,423,423,9,9,0,1,0
20,436,436,148,26,122,4,3
9,436,436,4,4,0,1,0
25,456,456,45,45,0,1,0
1,467,467,16,10,6,2,1
30,472,472,28,28,0,1,0
11,492,492,38,38,0,1,0
15,498,498,102,9,93,4,3

20,105,105,1,1,0,1,0
22,106,106,12,12,0,1,0
7,111,111,3,3,0,1,0
10,125,125,11,2,9,2,1
12,128,128,5,5,0,1,0
19,135,135,12,1,11,2,1
5,143,143,33,33,0,1,0
11,158,158,14,8,6,3,2
2,164,164,30,10,20,2,1
3,206,206,4,4,0,1,0
9,215,215,35,35,0,1,0
1,262,262,1,1,0,1,0
8,282,282,7,7,0,1,0
14,293,293,4,4,0,1,0
13,298,298,11,11,0,1,0
6,323,323,30,30,0,1,0
18,336,336,20,1,19,3,2
24,342,342,21,3,18,4,3
0,347,347,3,3,0,1,0
25,354,354,134,119,15,2,1
4,362,362,2,2,0,1,0
26,404,404,20,14,6,3,2
17,405,405,22,10,12,3,2
15,408,408,23,23,0,1,0
27,409,409,38,38,0,1,0
28,446,446,79,46,33,2,1
16,474,474,57,50,7,2,1
21,482,482,23,23,0,1,0
23,493,493,41,41,0,1,0

12,152,152,3,3,0,1,0
1,186,186,41,41,0,1,0
9,250,250,21,16,5,2,1
11,256,256,20,1,19,4,3
0,260,260,190,79,111,4,3
13,262,262,67,67,0,1,0
2,307,307,77,3,74,3,2
10,319,319,16,3,13,2,1
7,328,328,79,35,44,4,3
3,344,344,9,9,0,1,0
6,387,387,4,4,0,1,0
4,408,408,47,38,9,2,1
5,437,437,76,34,42,2,1
14,480,480,64,25,39,2,1
8,490,490,16,7,9,2,1

13,114,114,8,2,6,2,1
21,124,124,18,18,0,1,0
22,125,125,16,16,0,1,0
25,132,132,3,3,0,1,0
19,143,143,9,9,0,1,0
0,201,201,17,9,8,3,2
1,203,203,31,31,0,1,0
15,215,215,1,1,0,1,0
8,248,248,55,7,48,3,2
14,248,248,1,1,0,1,0
24,301,301,26,14,12,3,2
18,309,309,35,1,34,2,1
27,316,316,39,39,0,1,0
17,354,354,18,18,0,1,0
23,360,360,83,15,68,4,3
7,371,371,18,6,12,2,1
12,377,377,51,51,0,1,0
5,380,380,15,15,0,1,0
9,383,383,32,14,18,4,3
2,392,392,4,1,3,2,1
6,402,402,55,23,32,2,1
11,403,403,1,1,0,1,0
4,418,418,32,32,0,1,0
26,424,424,10,10,0,1,0
3,469,469,60,22,38,3,2
10,485,485,1,1,0,1,0
20,485,485,22,22,0,1,0
16,491,491,95,95,0,1,0

7,102,102,10,10,0,1,0
8,106,106,11,7,4,2,1
11,122,122,5,1,4,2,1
12,131,131,5,5,0,1,0
10,134,134,1,1,0,1,0
17,143,143,13,3,10,3,2
9,150,150,10,10,0,1,0
0,173,173,4,4,0,1,0
1,182,182,3,3,0,1,0
5,230,230,11,1,10,3,2
21,231,231,25,3,22,3,2
22,253,253,35,6,29,2,1
4,260,260,80,80,0,1,0
23,264,264,6,6,0,1,0
19,274,274,17,6,11,2,1
20,321,321,10,10,0,1,0
24,335,335,69,6,63,4,3
2,342,342,64,64,0,1,0
15,347,347,31,31,0,1,0
14,436,436,14,9,5,2,1
18,452,452,30,26,4,2,1
3,452,452,105,58,47,2,1
13,472,472,62,10,52,3,2
16,479,479,117,114,3,2,1
6,487,487,16,2,14,3,2

18,135,135,5,5,0,1,0
22,165,165,4,4,0,1,0
10,228,228,20,4,16,2,1
3,232,232,6,3,3,2,1
5,249,249,1,1,0,1,0
12,253,253,16,2,14,3,2
20,253,253,12,12,0,1,0
14,270,270,131,131,0,1,0
9,274,274,2,2,0,1,0
4,275,275,4,4,0,1,0
16,284,284,25,10,15,4,3
21,293,293,11,5,6,2,1
19,331,331,6,6,0,1,0
25,333,333,9,9,0,1,0
6,334,334,26,12,14,3,2
1,338,338,12,3,9,2,1
13,346,346,38,2,36,2,1
0,371,371,97,48,49,4,3
23,373,373,73,37,36,4,3
7,381,381,40,32,8,2,1
17,399,399,89,17,72,4,3
15,422,422,1,1,0,1,0
24,435,435,18,18,0,1,0
11,450,450,90,80,10,2,1
8,463,463,54,24,30,3,2
2,479,479,44,44,0,1,0

19,121,121,5,1,4,2,1
4,141,141,24,3,21,4,3
6,142,142,1,1,0,1,0
10,167,167,13,9,4,2,1
22,176,176,87,60,27,2,1
1,186,186,23,23,0,1,0
3,203,203,62,26,36,3,2
13,204,204,3,3,0,1,0
16,216,216,19,10,9,4,3
17,236,236,6,6,0,1,0
11,239,239,34,14,20,2,1
7,245,245,36,18,18,3,2
23,274,274,20,2,18,4,3
2,294,294,7,7,0,1,0
18,331,331,78,57,21,4,3
9,363,363,19,1,18,4,3
12,377,377,6,2,4,2,1
8,383,383,1,1,0,1,0
21,444,444,20,20,0,1,0
14,449,449,7,7,0,1,0
5,490,490,51,51,0,1,0
20,492,492,35,15,20,2,1
0,494,494,22,19,3,2,1
15,500,500,48,7,41,2,1

7,121,121,39,39,0,1,0
4,123,123,15,1,14,3,2
9,157,157,15,15,0,1,0
11,206,206,49,33,16,3,2
0,240,240,35,35,0,1,0
18,250,250,12,2,10,2,1
12,271,271,59,59,0,1,0
2,273,273,22,2,20,4,3
13,282,282,23,23,0,1,0
1,283,283,1,1,0,1,0
6,312,312,16,16,0,1,0
17,345,345,60,30,30,2,1
16,347,347,16,16,0,1,0
14,348,348,56,41,15,2,1
3,353,353,59,14,45,4,3
19,354,354,17,11,6,2,1
15,368,368,9,2,7,3,2
8,455,455,129,6,123,4,3
5,471,471,12,12,0,1,0
20,490,490,9,1,8,3,2
10,491,491,33,6,27,4,3

19,113,113,2,2,0,1,0
2,126,126,7,3,4,2,1
3,140,140,14,14,0,1,0
16,156,156,13,9,4,2,1
22,168,168,9,4,5,2,1
15,192,192,20,8,12,4,3
12,196,196,25,7,18,4,3
13,241,241,4,4,0,1,0
4,259,259,74,74,0,1,0
6,276,276,1,1,0,1,0
14,292,292,38,38,0,1,0
7,299,299,32,32,0,1,0
10,310,310,16,16,0,1,0
21,330,330,7,7,0,1,0
8,353,353,41,41,0,1,0
17,354,354,83,65,18,4,3
1,366,366,67,34,33,2,1
11,406,406,33,33,0,1,0
5,451,451,30,4,26,2,1
20,476,476,4,4,0,1,0
9,480,480,26,26,0,1,0
0,498,498,89,65,24,4,3
18,500,500,173,131,42,3,2

5,103,103,7,7,0,1,0
13,106,106,17,14,3,2,1
17,128,128,5,5,0,1,0
22,137,137,12,4,8,3,2
16,151,151,9,6,3,2,1
14,152,152,24,24,0,1,0
19,152,152,27,27,0,1,0
12,190,190,2,2,0,1,0
2,199,199,16,16,0,1,0
25,213,213,12,8,4,2,1
15,247,247,21,21,0,1,0
0,267,267,1,1,0,1,0
18,267,267,41,2,39,2,1
26,285,285,36,36,0,1,0
7,291,291,27,15,12,2,1
23,315,315,62,41,21,4,3
10,339,339,23,7,16,2,1
6,339,339,2,2,0,1,0
4,342,342,29,29,0,1,0
20,352,352,57,10,47,4,3
21,354,354,29,15,14,2,1
8,362,362,4,4,0,1,0
11,383,383,39,39,0,1,0
28,389,389,13,13,0,1,0
3,397,397,20,20,0,1,0
1,421,421,34,25,9,2,1
27,444,444,36,10,26,3,2
9,471,471,39,39,0,1,0
24,478,478,12,12,0,1,0

14,170,170,6,1,5,2,1
20,194,194,5,5,0,1,0
15,199,199,5,5,0,1,0
17,217,217,42,4,38,2,1
22,227,227,74,74,0,1,0
11,243,243,43,40,3,2,1
9,292,292,35,35,0,1,0
8,301,301,1,1,0,1,0
1,326,326,36,6,30,4,3
2,331,331,103,77,26,2,1
0,350,350,50,50,0,1,0
7,350,350,42,12,30,4,3
12,354,354,20,5,15,4,3
10,388,388,6,6,0,1,0
6,398,398,68,61,7,2,1
5,403,403,8,8,0,1,0
3,425,425,1,1,0,1,0
21,444,444,25,25,0,1,0
13,448,448,27,27,0,1,0
16,450,450,7,7,0,1,0
4,454,454,4,4,0,1,0
19,456,456,86,5,81,4,3
23,472,472,100,100,0,1,0
18,485,485,14,14,0,1,0

24,120,120,17,1,16,3,2
5,154,154,11,11,0,1,0
22,171,171,7,7,0,1,0
7,188,188,9,3,6,3,2
14,201,201,26,26,0,1,0
19,216,216,38,38,0,1,0
0,232,232,1,1,0,1,0
11,252,252,9,3,6,2,1
17,261,261,32,12,20,3,2
18,262,262,7,7,0,1,0
21,273,273,14,4,10,2,1
1,280,280,16,16,0,1,0
23,283,283,24,24,0,1,0
20,283,283,44,32,12,2,1
6,312,312,35,19,16,2,1
15,317,317,71,71,0,1,0
10,325,325,8,8,0,1,0
2,369,369,40,40,0,1,0
12,393,393,183,183,0,1,0
13,393,393,3,3,0,1,0
3,398,398,29,14,15,4,3
8,414,414,6,6,0,1,0
16,423,423,27,12,15,2,1
4,428,428,42,42,0,1,0
9,469,469,42,22,20,3,2

0,113,113,9,9,0,1,0
14,124,124,2,2,0,1,0
7,147,147,1,1,0,1,0
13,156,156,37,37,0,1,0
10,158,158,21,21,0,1,0
18,177,177,20,12,8,2,1
12,178,178,20,20,0,1,0
5,182,182,15,1,14,3,2
23,183,183,46,1,45,2,1
19,213,213,52,52,0,1,0
2,214,214,34,3,31,3,2
17,229,229,1,1,0,1,0
21,232,232,15,15,0,1,0
11,280,280,15,15,0,1,0
15,304,304,6,6,0,1,0
22,313,313,31,31,0,1,0
24,324,324,1,1,0,1,0
6,338,338,8,4,4,2,1
1,345,345,1,1,0,1,0
9,378,378,18,18,0,1,0
8,401,401,115,40,75,4,3
3,406,406,18,18,0,1,0
4,430,430,74,49,25,3,2
20,471,471,30,30,0,1,0
16,487,487,54,54,0,1,0

8,109,109,6,6,0,1,0
21,115,115,8,3,5,2,1
19,132,132,21,8,13,2,1
7,157,157,5,5,0,1,0
9,160,160,45,45,0,1,0
11,173,173,13,1,12,4,3
4,175,175,13,4,9,3,2
13,238,238,15,4,11,2,1
12,261,261,7,7,0,1,0
6,284,284,4,4,0,1,0
0,291,291,11,11,0,1,0
15,306,306,18,10,8,2,1
17,321,321,20,20,0,1,0
1,329,329,90,16,74,3,2
22,342,342,3,3,0,1,0
18,349,349,10,1,9,2,1
20,356,356,84,84,0,1,0
23,374,374,111,36,75,4,3
16,393,393,5,5,0,1,0
10,404,404,2,2,0,1,0
5,431,431,87,25,62,3,2
2,435,435,33,1,32,2,1
14,460,460,92,74,18,2,1
3,499,499,38,2,36,4,3

12,104,104,7,7,0,1,0
20,118,118,28,28,0,1,0
2,123,123,10,3,7,2,1
17,128,128,23,14,9,2,1
10,156,156,68,68,0,1,0
8,204,204,32,32,0,1,0
19,230,230,24,14,10,2,1
6,232,232,19,19,0,1,0
3,237,237,35,35,0,1,0
16,249,249,1,1,0,1,0
22,266,266,5,2,3,2,1
4,273,273,11,3,8,3,2
21,279,279,35,35,0,1,0
11,336,336,85,53,32,2,1
9,349,349,5,1,4,2,1
0,368,368,11,11,0,1,0
15,374,374,24,24,0,1,0
1,439,439,23,2,21,2,1
5,459,459,70,25,45,4,3
7,466,466,6,6,0,1,0
14,475,475,3,3,0,1,0
18,486,486,51,51,0,1,0
13,489,489,28,28,0,1,0

12,101,101,12,12,0,1,0
4,105,105,11,11,0,1,0
20,129,129,23,5,18,2,1
8,130,130,9,4,5,2,1
18,137,137,3,3,0,1,0
16,137,137,13,5,8,3,2
10,148,148,23,14,9,4,3
14,151,151,13,13,0,1,0
3,152,152,39,39,0,1,0
7,192,192,1,1,0,1,0
0,192,192,11,11,0,1,0
15,211,211,24,9,15,2,1
11,243,243,15,15,0,1,0
9,302,302,19,19,0,1,0
2,342,342,79,68,11,2,1
19,367,367,58,58,0,1,0
13,381,381,30,30,0,1,0
6,385,385,62,5,57,3,2
1,411,411,79,55,24,3,2
5,424,424,53,34,19,2,1
17,425,425,43,43,0,1,0

4,105,105,1,1,0,1,0
19,136,136,3,3,0,1,0
1,138,138,2,2,0,1,0
25,145,145,27,17,10,3,2
23,145,145,13,3,10,3,2
26,154,154,31,31,0,1,0
21,159,159,20,20,0,1,0
6,171,171,1,1,0,1,0
2,189,189,19,2,17,4,3
12,219,219,6,1,5,2,1
10,236,236,60,57,3,2,1
18,246,246,7,7,0,1,0
28,251,251,14,6,8,3,2
27,251,251,27,21,6,3,2
20,254,254,1,1,0,1,0
9,261,261,19,1,18,3,2
5,270,270,28,8,20,3,2
24,282,282,72,20,52,4,3
8,301,301,38,38,0,1,0
22,302,302,20,20,0,1,0
14,339,339,14,14,0,1,0
15,350,350,63,63,0,1,0
16,424,424,55,55,0,1,0
3,431,431,7,7,0,1,0
17,454,454,41,32,9,4,3
11,474,474,12,3,9,2,1
7,480,480,1,1,0,1,0
13,496,496,11,4,7,2,1
0,499,499,35,11,24,2,1

13,108,108,25,25,0,1,0
14,126,126,2,2,0,1,0
20,142,142,11,1,10,2,1
5,149,149,25,25,0,1,0
16,151,151,15,15,0,1,0
19,152,152,14,2,12,4,3
7,196,196,18,10,8,3,2
1,222,222,3,3,0,1,0
4,235,235,15,15,0,1,0
22,251,251,28,18,10,3,2
8,264,264,26,26,0,1,0
21,308,308,3,3,0,1,0
15,321,321,26,6,20,4,3
12,377,377,54,22,32,3,2
24,398,398,52,52,0,1,0
2,404,404,49,29,20,3,2
0,411,411,45,6,39,2,1
3,413,413,79,79,0,1,0
18,428,428,45,45,0,1,0
23,446,446,91,91,0,1,0
9,483,483,20,20,0,1,0
6,484,484,22,15,7,2,1
11,494,494,2,2,0,1,0
10,498,498,54,31,23,2,1
17,498,498,36,4,32,3,2

18,166,166,4,1,3,2,1
10,167,167,2,2,0,1,0
5,183,183,86,20,66,4,3
16,192,192,14,14,0,1,0
2,198,198,6,6,0,1,0
12,232,232,76,76,0,1,0
17,243,243,15,15,0,1,0
21,326,326,47,12,35,2,1
8,328,328,6,6,0,1,0
19,333,333,7,7,0,1,0
13,338,338,28,28,0,1,0
7,345,345,22,22,0,1,0
11,368,368,64,64,0,1,0
0,382,382,13,13,0,1,0
20,403,403,27,27,0,1,0
9,408,408,48,23,25,2,1
6,436,436,94,94,0,1,0
4,454,454,68,41,27,4,3
1,461,461,32,32,0,1,0
3,474,474,15,15,0,1,0
14,489,489,67,24,43,2,1
15,497,497,46,38,8,3,2

5,109,109,3,3,0,1,0
10,109,109,2,2,0,1,0
14,115,115,9,9,0,1,0
3,133,133,12,6,6,2,1
13,156,156,32,8,24,3,2
0,170,170,15,15,0,1,0
11,205,205,11,11,0,1,0
12,209,209,85,27,58,3,2
2,236,236,49,49,0,1,0
7,275,275,6,6,0,1,0
22,296,296,36,36,0,1,0
21,321,321,21,9,12,4,3
17,357,357,16,1,15,2,1
15,373,373,7,1,6,3,2
9,386,386,11,11,0,1,0
1,397,397,33,33,0,1,0
18,435,435,41,41,0,1,0
20,456,456,53,38,15,4,3
19,463,463,1,1,0,1,0
8,469,469,29,29,0,1,0
4,487,487,206,182,24,4,3
6,488,488,75,75,0,1,0
16,488,488,5,2,3,2,1

20,114,114,13,13,0,1,0
12,156,156,3,3,0,1,0
21,173,173,7,1,6,3,2
17,191,191,18,18,0,1,0
3,196,196,11,5,6,2,1
6,206,206,38,4,34,3,2
15,207,207,5,5,0,1,0
19,234,234,4,1,3,2,1
8,258,258,22,4,18,3,2
2,265,265,29,24,5,2,1
1,269,269,42,42,0,1,0
23,311,311,36,10,26,2,1
4,317,317,3,3,0,1,0
18,319,319,66,18,48,3,2
11,349,349,22,13,9,2,1
5,353,353,65,2,63,3,2
9,392,392,2,2,0,1,0
10,407,407,121,27,94,3,2
7,421,421,14,14,0,1,0
16,428,428,18,18,0,1,0
22,448,448,117,117,0,1,0
0,481,481,8,8,0,1,0
13,493,493,128,84,44,4,3
14,498,498,15,9,6,3,2

15,103,103,13,13,0,1,0
12,116,116,1,1,0,1,0
7,124,124,5,5,0,1,0
9,175,175,32,32,0,1,0
6,230,230,79,19,60,4,3
3,231,231,32,6,26,3,2
1,233,233,47,35,12,4,3
18,252,252,4,1,3,2,1
13,279,279,33,6,27,2,1
10,298,298,45,15,30,3,2
0,300,300,27,2,25,4,3
5,305,305,7,7,0,1,0
8,337,337,1,1,0,1,0
16,356,356,113,113,0,1,0
2,370,370,37,37,0,1,0
4,379,379,115,53,62,3,2
17,406,406,54,54,0,1,0
14,426,426,53,38,15,2,1
11,434,434,5,2,3,2,1

14,120,120,9,9,0,1,0
1,125,125,78,6,72,3,2
0,131,131,4,4,0,1,0
8,149,149,4,4,0,1,0
12,153,153,14,4,10,2,1
3,171,171,40,40,0,1,0
18,189,189,15,3,12,3,2
2,205,205,10,10,0,1,0
11,224,224,4,4,0,1,0
6,248,248,12,12,0,1,0
15,256,256,9,6,3,2,1
13,296,296,37,32,5,2,1
9,350,350,9,9,0,1,0
5,371,371,37,37,0,1,0
7,374,374,96,60,36,4,3
16,382,382,56,56,0,1,0
17,412,412,86,86,0,1,0
4,430,430,51,45,6,2,1
10,485,485,68,20,48,4,3

19,100,100,1,1,0,1,0
20,110,110,14,6,8,3,2
1,114,114,4,4,0,1,0
14,152,152,4,4,0,1,0
12,152,152,5,5,0,1,0
22,172,172,9,9,0,1,0
8,175,175,1,1,0,1,0
9,176,176,5,5,0,1,0
29,227,227,75,75,0,1,0
32,231,231,11,11,0,1,0
5,250,250,1,1,0,1,0
11,259,259,9,9,0,1,0
10,262,262,3,3,0,1,0
13,268,268,34,34,0,1,0
6,300,300,84,84,0,1,0
21,338,338,19,1,18,2,1
4,359,359,21,3,18,3,2
24,364,364,6,6,0,1,0
28,365,365,32,11,21,2,1
7,366,366,7,7,0,1,0
17,368,368,1,1,0,1,0
26,377,377,19,19,0,1,0
31,380,380,85,47,38,2,1
0,416,416,28,28,0,1,0
16,417,417,16,16,0,1,0
23,428,428,14,7,7,2,1
3,435,435,54,54,0,1,0
27,437,437,65,65,0,1,0
25,448,448,31,31,0,1,0
30,486,486,50,50,0,1,0
15,497,497,6,3,3,2,1
18,497,497,45,45,0,1,0
2,497,497,36,30,6,2,1

1,101,101,4,4,0,1,0
2,113,113,5,5,0,1,0
25,118,118,8,8,0,1,0
23,140,140,21,21,0,1,0
14,187,187,4,4,0,1,0
13,192,192,24,24,0,1,0
6,197,197,51,12,39,4,3
26,200,200,8,8,0,1,0
22,209,209,28,8,20,3,2
21,212,212,4,4,0,1,0
15,228,228,32,32,0,1,0
7,234,234,2,2,0,1,0
9,264,264,2,2,0,1,0
12,266,266,32,7,25,2,1
4,279,279,3,3,0,1,0
24,290,290,16,10,6,2,1
11,291,291,28,18,10,3,2
0,300,300,1,1,0,1,0
17,393,393,25,13,12,3,2
28,398,398,87,87,0,1,0
18,400,400,47,7,40,3,2
3,400,400,56,12,44,3,2
20,404,404,98,56,42,4,3
19,415,415,17,6,11,4,3
27,439,439,30,12,18,4,3
8,447,447,27,27,0,1,0
16,485,485,31,31,0,1,0
10,488,488,19,1,18,4,3
5,495,495,11,11,0,1,0

6,125,125,11,11,0,1,0
5,145,145,10,10,0,1,0
16,163,163,9,9,0,1,0
10,168,168,31,9,22,3,2
0,178,178,38,38,0,1,0
11,200,200,6,6,0,1,0
17,201,201,3,3,0,1,0
7,214,214,2,2,0,1,0
21,240,240,47,3,44,2,1
3,259,259,60,32,28,2,1
4,285,285,3,3,0,1,0
13,294,294,21,12,9,4,3
9,326,326,10,10,0,1,0
8,334,334,43,10,33,4,3
12,368,368,131,119,12,2,1
15,369,369,62,56,6,3,2
2,369,369,21,21,0,1,0
20,376,376,57,57,0,1,0
14,397,397,18,18,0,1,0
18,416,416,29,15,14,2,1
1,429,429,64,22,42,3,2
22,438,438,13,13,0,1,0
19,449,449,6,6,0,1,0
23,482,482,22,13,9,4,3

27,132,132,30,9,21,4,3
20,134,134,3,3,0,1,0
9,166,166,2,2,0,1,0
24,180,180,15,15,0,1,0
5,181,181,2,2,0,1,0
25,187,187,4,4,0,1,0
1,207,207,36,15,21,4,3
26,214,214,26,26,0,1,0
12,233,233,4,4,0,1,0
14,240,240,40,19,21,4,3
19,244,244,8,8,0,1,0
11,259,259,15,15,0,1,0
15,260,260,1,1,0,1,0
0,263,263,12,12,0,1,0
28,306,306,81,60,21,4,3
21,312,312,23,3,20,2,1
10,318,318,19,5,14,2,1
16,341,341,28,6,22,2,1
18,360,360,73,46,27,2,1
23,372,372,22,5,17,2,1
17,379,379,1,1,0,1,0
3,400,400,49,49,0,1,0
2,447,447,61,61,0,1,0
7,460,460,31,10,21,4,3
13,472,472,8,8,0,1,0
4,475,475,22,22,0,1,0
8,481,481,80,35,45,4,3
6,485,485,7,4,3,2,1
22,497,497,57,13,44,2,1

18,134,134,21,21,0,1,0
14,150,150,8,8,0,1,0
23,165,165,9,9,0,1,0
13,174,174,33,13,20,2,1
7,182,182,1,1,0,1,0
6,208,208,20,20,0,1,0
20,238,238,37,37,0,1,0
19,247,247,8,8,0,1,0
21,273,273,3,3,0,1,0
25,299,299,53,3,50,2,1
5,305,305,30,26,4,2,1
0,308,308,1,1,0,1,0
15,312,312,73,4,69,4,3
26,336,336,13,4,9,4,3
24,339,339,18,18,0,1,0
2,352,352,2,2,0,1,0
9,353,353,4,4,0,1,0
8,364,364,8,8,0,1,0
17,369,369,13,2,11,2,1
10,399,399,3,3,0,1,0
16,404,404,56,56,0,1,0
12,413,413,112,19,93,4,3
4,430,430,1,1,0,1,0
3,456,456,48,4,44,2,1
11,458,458,97,63,34,3,2
22,458,458,65,29,36,2,1
1,495,495,59,59,0,1,0

4,110,110,34,34,0,1,0
6,122,122,61,27,34,3,2
17,124,124,1,1,0,1,0
15,162,162,24,24,0,1,0
18,169,169,8,8,0,1,0
0,172,172,24,6,18,2,1
16,185,185,23,23,0,1,0
11,188,188,3,3,0,1,0
10,224,224,59,10,49,2,1
2,257,257,11,11,0,1,0
14,279,279,14,14,0,1,0
3,284,284,14,3,11,2,1
7,297,297,81,81,0,1,0
12,306,306,12,12,0,1,0
1,371,371,7,7,0,1,0
13,376,376,28,6,22,3,2
9,390,390,53,53,0,1,0
8,419,419,20,5,15,3,2
5,455,455,67,60,7,2,1

24,106,106,4,4,0,1,0
26,114,114,19,9,10,2,1
1,127,127,2,2,0,1,0
21,127,127,5,2,3,2,1
20,135,135,63,51,12,2,1
5,165,165,6,6,0,1,0
12,180,180,6,6,0,1,0
11,202,202,35,26,9,4,3
19,228,228,9,9,0,1,0
16,242,242,2,2,0,1,0
0,254,254,41,41,0,1,0
23,257,257,16,4,12,2,1
4,283,283,9,9,0,1,0
15,287,287,7,7,0,1,0
7,301,301,20,20,0,1,0
14,315,315,65,65,0,1,0
25,324,324,50,50,0,1,0
3,325,325,2,2,0,1,0
6,326,326,58,41,17,2,1
17,370,370,40,3,37,2,1
2,417,417,12,3,9,2,1
22,426,426,45,21,24,2,1
8,450,450,17,9,8,3,2
9,482,482,10,10,0,1,0
13,483,483,72,12,60,3,2
10,485,485,28,3,25,2,1
18,488,488,10,1,9,2,1

5,102,102,6,6,0,1,0
13,107,107,8,1,7,2,1
20,125,125,3,3,0,1,0
6,130,130,12,12,0,1,0
19,131,131,19,6,13,2,1
16,143,143,6,6,0,1,0
28,147,147,28,19,9,4,3
9,165,165,7,7,0,1,0
0,168,168,28,10,18,2,1
10,214,214,8,8,0,1,0
15,255,255,7,7,0,1,0
25,263,263,10,10,0,1,0
17,265,265,22,8,14,3,2
7,278,278,5,2,3,2,1
3,278,278,4,1,3,2,1
18,281,281,68,23,45,2,1
12,300,300,30,10,20,2,1
27,314,314,37,37,0,1,0
23,322,322,93,19,74,3,2
26,328,328,8,8,0,1,0
4,344,344,9,9,0,1,0
1,369,369,34,7,27,2,1
22,373,373,16,16,0,1,0
2,407,407,20,20,0,1,0
11,416,416,105,74,31,3,2
24,455,455,9,1,8,3,2
8,459,459,43,31,12,3,2
14,471,471,6,6,0,1,0
21,471,471,2,2,0,1,0

13,108,108,10,10,0,1,0
2,121,121,5,5,0,1,0
6,139,139,36,36,0,1,0
9,174,174,1,1,0,1,0
10,220,220,5,2,3,2,1
16,245,245,1,1,0,1,0
17,256,256,30,30,0,1,0
15,256,256,17,13,4,2,1
21,259,259,89,89,0,1,0
19,263,263,15,8,7,2,1
5,267,267,2,2,0,1,0
22,286,286,31,3,28,3,2
3,291,291,36,6,30,2,1
12,314,314,57,21,36,3,2
7,316,316,64,8,56,3,2
4,363,363,106,8,98,3,2
11,368,368,22,22,0,1,0
0,386,386,23,16,7,2,1
18,430,430,4,4,0,1,0
8,431,431,79,71,8,3,2
20,441,441,37,12,25,2,1
1,447,447,2,2,0,1,0
14,457,457,44,44,0,1,0

14,100,100,6,6,0,1,0
2,110,110,1,1,0,1,0
20,122,122,16,16,0,1,0
10,165,165,37,16,21,4,3
3,190,190,43,43,0,1,0
13,207,207,14,14,0,1,0
1,208,208,25,10,15,4,3
11,226,226,3,3,0,1,0
6,236,236,33,3,30,3,2
19,237,237,59,59,0,1,0
0,238,238,10,10,0,1,0
9,249,249,70,70,0,1,0
4,324,324,20,14,6,2,1
12,335,335,22,12,10,2,1
17,337,337,41,41,0,1,0
5,340,340,45,39,6,3,2
16,443,443,18,3,15,3,2
15,449,449,33,33,0,1,0
7,455,455,78,58,20,2,1
21,487,487,47,8,39,4,3
8,488,488,9,9,0,1,0
18,489,489,38,18,20,3,2

14,105,105,17,17,0,1,0
26,116,116,2,2,0,1,0
4,118,118,4,4,0,1,0
18,119,119,8,2,6,2,1
11,148,148,1,1,0,1,0
10,149,149,9,9,0,1,0
8,240,240,57,29,28,3,2
3,242,242,26,9,17,2,1
23,245,245,21,18,3,2,1
6,249,249,18,18,0,1,0
13,251,251,46,46,0,1,0
21,294,294,69,69,0,1,0
17,299,299,10,10,0,1,0
5,314,314,8,8,0,1,0
12,316,316,7,7,0,1,0
20,339,339,81,15,66,3,2
1,354,354,33,33,0,1,0
27,361,361,41,41,0,1,0
2,389,389,19,19,0,1,0
22,395,395,8,8,0,1,0
16,408,408,43,13,30,4,3
9,428,428,21,12,9,2,1
0,431,431,34,34,0,1,0
15,458,458,2,2,0,1,0
19,460,460,122,122,0,1,0
7,481,481,8,2,6,3,2
24,486,486,12,6,6,3,2
25,493,493,12,3,9,4,3

3,102,102,7,7,0,1,0
16,103,103,15,3,12,3,2
18,105,105,20,20,0,1,0
27,117,117,4,4,0,1,0
12,118,118,5,5,0,1,0
14,145,145,2,2,0,1,0
15,148,148,10,5,5,2,1
9,158,158,8,1,7,2,1
23,171,171,12,12,0,1,0
11,214,214,12,12,0,1,0
6,223,223,10,10,0,1,0
25,223,223,2,2,0,1,0
19,252,252,6,6,0,1,0
5,270,270,5,5,0,1,0
20,273,273,73,73,0,1,0
22,292,292,33,25,8,2,1
2,293,293,8,8,0,1,0
29,310,310,5,5,0,1,0
13,312,312,13,13,0,1,0
28,326,326,7,1,6,2,1
10,334,334,2,2,0,1,0
7,342,342,65,15,50,2,1
4,353,353,73,73,0,1,0
24,354,354,17,5,12,3,2
8,379,379,37,14,23,2,1
1,396,396,8,8,0,1,0
0,418,418,21,7,14,2,1
26,466,466,31,26,5,2,1
21,489,489,178,40,138,4,3
17,494,494,26,8,18,4,3

8,101,101,16,16,0,1,0
17,142,142,27,27,0,1,0
13,169,169,1,1,0,1,0
1,172,172,35,19,16,4,3
21,177,177,58,40,18,2,1
14,230,230,5,2,3,2,1
20,232,232,40,40,0,1,0
11,300,300,2,2,0,1,0
9,309,309,10,1,9,2,1
3,321,321,4,1,3,2,1
7,335,335,5,2,3,2,1
19,357,357,1,1,0,1,0
15,363,363,34,30,4,2,1
2,406,406,61,31,30,4,3
22,406,406,5,5,0,1,0
4,408,408,113,55,58,4,3
24,427,427,11,11,0,1,0
6,443,443,24,24,0,1,0
12,449,449,5,1,4,2,1
18,451,451,6,6,0,1,0
0,461,461,70,32,38,3,2
16,463,463,119,97,22,2,1
10,470,470,12,1,11,2,1
5,471,471,48,48,0,1,0
23,487,487,46,4,42,3,2

4,123,123,17,17,0,1,0
7,148,148,25,25,0,1,0
0,164,164,17,17,0,1,0
8,189,189,40,16,24,3,2
18,190,190,6,2,4,2,1
13,225,225,35,10,25,4,3
9,276,276,134,50,84,4,3
17,278,278,1,1,0,1,0
6,294,294,13,13,0,1,0
19,297,297,27,22,5,2,1
20,323,323,32,32,0,1,0
11,330,330,17,17,0,1,0
5,364,364,35,35,0,1,0
15,375,375,8,8,0,1,0
2,390,390,17,11,6,3,2
16,400,400,11,11,0,1,0
1,402,402,60,23,37,4,3
3,441,441,108,66,42,4,3
12,491,491,36,28,8,3,2
14,496,496,49,19,30,4,3
10,498,498,41,41,0,1,0

7,108,108,34,7,27,4,3
6,123,123,40,11,29,2,1
1,132,132,2,2,0,1,0
3,145,145,4,4,0,1,0
14,172,172,3,3,0,1,0
11,183,183,12,2,10,2,1
10,199,199,13,13,0,1,0
20,211,211,27,27,0,1,0
13,214,214,9,4,5,2,1
23,245,245,56,56,0,1,0
12,250,250,27,27,0,1,0
15,270,270,49,11,38,2,1
8,273,273,8,8,0,1,0
2,295,295,15,7,8,2,1
18,296,296,2,2,0,1,0
22,321,321,19,10,9,2,1
16,328,328,5,5,0,1,0
21,353,353,29,14,15,2,1
5,354,354,19,14,5,2,1
19,365,365,84,35,49,2,1
0,390,390,29,1,28,2,1
9,409,409,4,1,3,2,1
17,417,417,52,52,0,1,0
4,463,463,79,9,70,4,3

22,103,103,3,3,0,1,0
10,115,115,11,5,6,2,1
4,129,129,5,2,3,2,1
11,148,148,4,1,3,2,1
26,160,160,9,5,4,2,1
17,194,194,19,19,0,1,0
14,220,220,10,10,0,1,0
3,224,224,27,27,0,1,0
12,237,237,23,4,19,2,1
29,281,281,137,98,39,3,2
20,291,291,2,2,0,1,0
23,299,299,81,1,80,3,2
19,309,309,38,38,0,1,0
8,310,310,12,12,0,1,0
0,317,317,17,17,0,1,0
27,323,323,4,4,0,1,0
2,335,335,2,2,0,1,0
7,351,351,25,25,0,1,0
28,360,360,24,18,6,2,1
5,372,372,54,6,48,2,1
25,391,391,3,3,0,1,0
6,417,417,58,58,0,1,0
16,419,419,44,24,20,2,1
15,444,444,1,1,0,1,0
24,445,445,33,33,0,1,0
13,449,449,11,8,3,2,1
21,471,471,34,34,0,1,0
9,487,487,4,4,0,1,0
1,497,497,42,8,34,3,2
18,498,498,7,3,4,2,1

1,109,109,1,1,0,1,0
21,110,110,6,6,0,1,0
7,118,118,5,5,0,1,0
17,126,126,13,13,0,1,0
10,129,129,1,1,0,1,0
31,141,141,31,31,0,1,0
0,153,153,11,11,0,1,0
20,155,155,18,18,0,1,0
8,168,168,6,3,3,2,1
24,173,173,15,15,0,1,0
4,175,175,2,2,0,1,0
12,185,185,14,7,7,2,1
6,248,248,5,5,0,1,0
5,249,249,1,1,0,1,0
28,257,257,14,14,0,1,0
11,259,259,1,1,0,1,0
18,286,286,8,5,3,2,1
26,287,287,97,97,0,1,0
22,297,297,2,2,0,1,0
16,302,302,18,18,0,1,0
14,307,307,12,12,0,1,0
2,328,328,51,39,12,3,2
23,367,367,38,38,0,1,0
15,387,387,1,1,0,1,0
25,400,400,11,11,0,1,0
13,401,401,129,83,46,2,1
19,404,404,41,5,36,3,2
27,423,423,26,26,0,1,0
29,433,433,39,39,0,1,0
9,457,457,33,33,0,1,0
3,468,468,17,3,14,3,2
30,478,478,31,31,0,1,0

16,102,102,3,3,0,1,0
3,105,105,1,1,0,1,0
10,133,133,37,37,0,1,0
13,135,135,15,15,0,1,0
11,146,146,16,16,0,1,0
8,152,152,27,17,10,3,2
14,159,159,4,4,0,1,0
7,211,211,17,10,7,2,1
9,223,223,11,8,3,2,1
15,231,231,5,5,0,1,0
0,241,241,16,10,6,2,1
6,269,269,6,6,0,1,0
22,296,296,2,2,0,1,0
12,304,304,4,4,0,1,0
1,311,311,29,29,0,1,0
21,314,314,181,103,78,3,2
19,342,342,36,36,0,1,0
2,366,366,62,41,21,2,1
18,367,367,31,31,0,1,0
5,368,368,25,25,0,1,0
20,404,404,56,24,32,2,1
4,419,419,78,66,12,2,1
17,455,455,4,4,0,1,0

22,102,102,12,12,0,1,0
16,110,110,2,2,0,1,0
10,111,111,1,1,0,1,0
4,125,125,10,10,0,1,0
27,145,145,5,1,4,2,1
18,161,161,24,24,0,1,0
3,189,189,3,3,0,1,0
26,197,197,5,5,0,1,0
24,202,202,1,1,0,1,0
17,231,231,31,31,0,1,0
11,235,235,6,2,4,2,1
6,276,276,12,12,0,1,0
0,281,281,19,4,15,4,3
9,301,301,22,1,21,2,1
15,302,302,43,43,0,1,0
28,308,308,40,24,16,3,2
20,310,310,4,4,0,1,0
7,323,323,61,43,18,4,3
14,345,345,23,13,10,3,2
2,376,376,101,101,0,1,0
25,383,383,48,5,43,3,2
8,390,390,3,3,0,1,0
1,394,394,19,19,0,1,0
12,410,410,33,33,0,1,0
5,423,423,5,5,0,1,0
21,454,454,175,145,30,3,2
13,470,470,26,10,16,3,2
19,498,498,46,3,43,2,1
23,500,500,8,8,0,1,0

12,107,107,15,9,6,2,1
22,130,130,24,17,7,2,1
18,202,202,18,18,0,1,0
9,207,207,3,3,0,1,0
5,216,216,25,25,0,1,0
20,225,225,24,24,0,1,0
11,233,233,34,20,14,3,2
10,292,292,13,13,0,1,0
21,294,294,21,21,0,1,0
24,316,316,3,3,0,1,0
14,353,353,40,16,24,4,3
19,382,382,73,33,40,4,3
3,389,389,129,78,51,4,3
0,395,395,2,2,0,1,0
4,408,408,96,96,0,1,0
2,427,427,27,3,24,3,2
13,429,429,80,14,66,4,3
7,444,444,8,1,7,2,1
1,447,447,2,2,0,1,0
17,458,458,7,7,0,1,0
16,465,465,81,1,80,3,2
15,474,474,11,11,0,1,0
6,475,475,6,6,0,1,0
8,500,500,37,37,0,1,0
23,500,500,29,29,0,1,0

19,108,108,4,4,0,1,0
11,112,112,36,36,0,1,0
10,113,113,1,1,0,1,0
0,119,119,7,1,6,2,1
21,122,122,25,4,21,3,2
5,166,166,14,14,0,1,0
26,171,171,8,8,0,1,0
29,192,192,18,10,8,3,2
4,209,209,8,4,4,2,1
24,216,216,1,1,0,1,0
3,238,238,4,4,0,1,0
25,242,242,7,4,3,2,1
13,244,244,7,7,0,1,0
7,246,246,24,24,0,1,0
12,256,256,1,1,0,1,0
20,259,259,7,7,0,1,0
1,265,265,1,1,0,1,0
6,271,271,48,15,33,4,3
28,276,276,66,62,4,2,1
14,292,292,11,7,4,2,1
27,292,292,37,37,0,1,0
9,320,320,8,8,0,1,0
30,343,343,74,24,50,2,1
8,351,351,3,3,0,1,0
16,367,367,10,10,0,1,0
2,376,376,16,16,0,1,0
31,377,377,20,2,18,2,1
18,432,432,9,3,6,2,1
22,439,439,59,59,0,1,0
23,476,476,21,21,0,1,0
15,479,479,4,4,0,1,0
17,495,495,80,39,41,2,1

13,102,102,6,6,0,1,0
14,105,105,9,9,0,1,0
19,143,143,2,2,0,1,0
2,153,153,24,24,0,1,0
0,205,205,10,10,0,1,0
8,210,210,11,8,3,2,1
5,221,221,34,34,0,1,0
18,239,239,20,20,0,1,0
3,258,258,4,4,0,1,0
15,263,263,15,15,0,1,0
26,275,275,1,1,0,1,0
22,285,285,34,34,0,1,0
24,291,291,12,12,0,1,0
11,317,317,3,3,0,1,0
20,335,335,134,80,54,3,2
9,364,364,35,35,0,1,0
6,373,373,9,3,6,2,1
16,376,376,13,7,6,2,1
25,377,377,2,2,0,1,0
7,384,384,4,4,0,1,0
10,389,389,58,31,27,2,1
17,392,392,57,57,0,1,0
12,397,397,28,28,0,1,0
1,401,401,37,37,0,1,0
4,427,427,52,18,34,2,1
21,446,446,99,88,11,2,1
27,453,453,9,9,0,1,0
23,478,478,60,30,30,3,2

6,100,100,6,6,0,1,0
0,109,109,8,8,0,1,0
10,126,126,11,4,7,2,1
3,131,131,9,9,0,1,0
5,142,142,35,35,0,1,0
1,145,145,3,3,0,1,0
19,155,155,1,1,0,1,0
26,158,158,14,14,0,1,0
14,172,172,12,12,0,1,0
16,191,191,1,1,0,1,0
9,194,194,40,11,29,2,1
2,208,208,9,3,6,2,1
15,216,216,9,9,0,1,0
7,258,258,1,1,0,1,0
25,298,298,61,53,8,2,1
12,300,300,47,27,20,3,2
18,312,312,67,10,57,3,2
22,372,372,5,1,4,2,1
13,373,373,43,1,42,2,1
24,386,386,148,61,87,4,3
23,423,423,39,39,0,1,0
8,429,429,2,2,0,1,0
4,435,435,12,12,0,1,0
20,446,446,2,2,0,1,0
11,460,460,9,9,0,1,0
21,467,467,36,36,0,1,0
17,471,471,43,15,28,2,1

9,123,123,5,2,3,2,1
6,128,128,1,1,0,1,0
3,144,144,2,2,0,1,0
20,170,170,37,37,0,1,0
14,202,202,8,8,0,1,0
24,215,215,19,19,0,1,0
7,220,220,14,7,7,2,1
11,221,221,17,2,15,4,3
1,235,235,11,11,0,1,0
0,238,238,20,20,0,1,0
22,259,259,86,11,75,3,2
17,320,320,2,2,0,1,0
21,324,324,14,2,12,2,1
16,348,348,2,2,0,1,0
8,348,348,30,30,0,1,0
23,403,403,11,7,4,2,1
12,426,426,1,1,0,1,0
4,427,427,20,12,8,3,2
2,432,432,67,67,0,1,0
18,436,436,6,6,0,1,0
13,445,445,154,55,99,4,3
19,445,445,166,43,123,4,3
15,448,448,23,2,21,2,1
10,451,451,45,45,0,1,0
25,462,462,11,11,0,1,0
5,494,494,65,36,29,3,2

9,118,118,3,3,0,1,0
23,120,120,5,5,0,1,0
12,123,123,1,1,0,1,0
17,128,128,1,1,0,1,0
16,168,168,50,17,33,4,3
15,176,176,2,2,0,1,0
20,179,179,32,2,30,2,1
21,233,233,14,14,0,1,0
1,242,242,13,13,0,1,0
24,243,243,7,7,0,1,0
19,251,251,20,20,0,1,0
5,262,262,21,5,16,3,2
25,276,276,32,1,31,2,1
11,282,282,1,1,0,1,0
27,335,335,20,10,10,3,2
10,350,350,8,8,0,1,0
18,352,352,108,9,99,4,3
3,354,354,43,43,0,1,0
14,358,358,75,12,63,4,3
8,363,363,39,39,0,1,0
6,381,381,41,41,0,1,0
13,383,383,21,21,0,1,0
4,386,386,99,96,3,2,1
0,448,448,32,32,0,1,0
7,469,469,4,4,0,1,0
22,475,475,9,9,0,1,0
2,482,482,28,14,14,2,1
26,489,489,16,16,0,1,0

24,103,103,3,3,0,1,0
10,116,116,9,3,6,2,1
2,125,125,3,3,0,1,0
9,148,148,12,3,9,2,1
3,167,167,17,17,0,1,0
21,188,188,1,1,0,1,0
6,217,217,12,4,8,2,1
13,218,218,41,15,26,4,3
0,223,223,11,7,4,2,1
20,227,227,27,3,24,4,3
28,254,254,75,75,0,1,0
8,264,264,3,3,0,1,0
15,306,306,47,11,36,4,3
22,307,307,132,64,68,3,2
7,308,308,17,9,8,2,1
26,357,357,8,3,5,2,1
4,358,358,28,28,0,1,0
14,358,358,42,42,0,1,0
23,359,359,24,9,15,2,1
16,403,403,28,12,16,2,1
18,404,404,4,4,0,1,0
11,414,414,20,6,14,3,2
1,426,426,4,4,0,1,0
17,445,445,57,35,22,3,2
25,464,464,3,3,0,1,0
5,476,476,4,4,0,1,0
12,484,484,35,11,24,4,3
19,490,490,32,23,9,2,1
27,494,494,21,12,9,2,1

2,114,114,12,4,8,3,2
6,177,177,3,3,0,1,0
20,215,215,19,1,18,2,1
21,234,234,63,63,0,1,0
16,252,252,12,12,0,1,0
11,267,267,26,20,6,2,1
8,289,289,18,18,0,1,0
17,289,289,8,8,0,1,0
15,299,299,16,16,0,1,0
4,301,301,152,152,0,1,0
0,309,309,59,59,0,1,0
13,312,312,9,6,3,2,1
5,320,320,45,45,0,1,0
12,323,323,19,15,4,2,1
3,333,333,26,1,25,2,1
10,341,341,140,101,39,4,3
9,414,414,21,11,10,3,2
19,439,439,9,9,0,1,0
1,455,455,2,2,0,1,0
7,470,470,22,22,0,1,0
14,491,491,57,7,50,2,1
18,492,492,2,2,0,1,0

30,109,109,1,1,0,1,0
25,118,118,11,3,8,3,2
34,127,127,25,10,15,4,3
13,151,151,12,12,0,1,0
5,154,154,1,1,0,1,0
24,154,154,25,20,5,2,1
8,162,162,3,3,0,1,0
20,175,175,3,3,0,1,0
2,177,177,11,11,0,1,0
1,179,179,29,3,26,2,1
14,199,199,10,10,0,1,0
26,199,199,36,9,27,2,1
16,206,206,9,2,7,2,1
31,209,209,56,30,26,3,2
17,218,218,7,3,4,2,1
27,219,219,18,18,0,1,0
10,254,254,9,9,0,1,0
12,265,265,5,5,0,1,0
15,284,284,13,13,0,1,0
21,300,300,12,5,7,2,1
19,309,309,29,29,0,1,0
32,353,353,28,28,0,1,0
7,355,355,2,2,0,1,0
23,364,364,16,11,5,2,1
0,365,365,32,11,21,2,1
9,365,365,14,8,6,3,2
11,367,367,22,12,10,3,2
18,392,392,41,6,35,2,1
3,413,413,1,1,0,1,0
22,445,445,39,39,0,1,0
28,451,451,7,1,6,2,1
33,472,472,4,4,0,1,0
6,477,477,13,1,12,4,3
4,485,485,40,22,18,4,3
29,491,491,45,23,22,2,1

24,129,129,10,10,0,1,0
10,130,130,10,10,0,1,0
15,141,141,36,36,0,1,0
4,142,142,3,3,0,1,0
5,163,163,14,5,9,2,1
26,231,231,66,26,40,2,1
2,238,238,46,8,38,3,2
21,250,250,1,1,0,1,0
11,281,281,27,18,9,2,1
6,283,283,1,1,0,1,0
18,306,306,20,10,10,3,2
22,312,312,40,35,5,2,1
0,335,335,4,4,0,1,0
14,349,349,2,2,0,1,0
12,361,361,34,34,0,1,0
3,367,367,52,5,47,3,2
17,371,371,28,6,22,3,2
23,383,383,1,1,0,1,0
25,397,397,63,32,31,4,3
7,400,400,52,24,28,3,2
13,428,428,75,32,43,3,2
20,458,458,2,2,0,1,0
9,467,467,2,2,0,1,0
8,470,470,69,69,0,1,0
16,471,471,8,8,0,1,0
1,478,478,7,1,6,2,1
19,479,479,72,58,14,3,2

10,111,111,14,3,11,2,1
2,139,139,2,2,0,1,0
18,153,153,10,10,0,1,0
11,179,179,51,21,30,3,2
1,183,183,4,4,0,1,0
3,185,185,10,10,0,1,0
16,203,203,1,1,0,1,0
12,215,215,3,3,0,1,0
19,232,232,13,3,10,3,2
13,239,239,50,50,0,1,0
6,276,276,18,18,0,1,0
14,313,313,49,37,12,2,1
15,339,339,29,29,0,1,0
9,350,350,6,6,0,1,0
4,351,351,229,120,109,4,3
0,360,360,77,69,8,3,2
8,379,379,8,8,0,1,0
20,397,397,28,1,27,2,1
17,398,398,53,17,36,3,2
7,449,449,54,54,0,1,0
5,483,483,18,18,0,1,0

19,105,105,8,8,0,1,0
10,112,112,11,1,10,2,1
4,121,121,6,6,0,1,0
7,142,142,2,2,0,1,0
24,146,146,4,4,0,1,0
3,154,154,1,1,0,1,0
18,182,182,2,2,0,1,0
5,188,188,7,4,3,2,1
21,189,189,22,22,0,1,0
1,212,212,1,1,0,1,0
20,234,234,68,8,60,3,2
11,235,235,43,43,0,1,0
13,267,267,9,9,0,1,0
27,269,269,3,3,0,1,0
25,272,272,5,2,3,2,1
6,309,309,34,34,0,1,0
12,312,312,8,8,0,1,0
16,314,314,23,7,16,2,1
8,322,322,25,25,0,1,0
14,333,333,82,82,0,1,0
23,343,343,20,20,0,1,0
29,345,345,32,2,30,4,3
22,346,346,27,9,18,4,3
17,360,360,9,9,0,1,0
28,365,365,32,1,31,2,1
15,377,377,2,2,0,1,0
2,390,390,27,2,25,2,1
0,401,401,35,35,0,1,0
26,458,458,164,70,94,4,3
9,466,466,25,25,0,1,0

18,139,139,34,28,6,3,2
5,139,139,29,4,25,4,3
13,166,166,14,5,9,4,3
2,176,176,14,14,0,1,0
15,183,183,23,9,14,2,1
16,183,183,34,34,0,1,0
8,189,189,15,15,0,1,0
14,207,207,2,2,0,1,0
11,235,235,13,13,0,1,0
12,296,296,14,14,0,1,0
10,307,307,59,51,8,2,1
7,424,424,28,1,27,4,3
17,462,462,36,36,0,1,0
1,466,466,30,7,23,2,1
0,466,466,60,18,42,4,3
9,471,471,29,20,9,2,1
3,479,479,284,284,0,1,0
4,491,491,35,35,0,1,0
6,493,493,27,27,0,1,0

7,106,106,10,3,7,2,1
5,108,108,3,3,0,1,0
9,134,134,16,8,8,3,2
18,134,134,8,8,0,1,0
19,170,170,2,2,0,1,0
24,173,173,10,1,9,2,1
15,175,175,44,13,31,2,1
2,224,224,8,8,0,1,0
0,248,248,26,15,11,2,1
21,270,270,43,14,29,4,3
22,278,278,5,2,3,2,1
20,283,283,57,6,51,4,3
10,287,287,22,22,0,1,0
23,302,302,49,21,28,3,2
4,305,305,49,4,45,4,3
12,326,326,29,15,14,3,2
8,339,339,115,96,19,2,1
1,341,341,4,4,0,1,0
16,342,342,33,23,10,3,2
14,385,385,51,30,21,2,1
17,387,387,10,10,0,1,0
3,395,395,9,9,0,1,0
11,445,445,43,43,0,1,0
6,456,456,10,7,3,2,1
13,460,460,22,11,11,2,1

14,134,134,14,6,8,2,1
11,142,142,25,25,0,1,0
3,149,149,1,1,0,1,0
23,154,154,36,36,0,1,0
4,174,174,3,3,0,1,0
1,174,174,14,1,13,3,2
6,181,181,8,8,0,1,0
0,193,193,3,3,0,1,0
20,219,219,37,37,0,1,0
12,240,240,16,1,15,2,1
18,299,299,26,12,14,2,1
13,322,322,21,21,0,1,0
7,327,327,10,2,8,2,1
22,329,329,9,9,0,1,0
15,348,348,10,10,0,1,0
21,361,361,38,38,0,1,0
9,381,381,1,1,0,1,0
24,388,388,33,33,0,1,0
8,415,415,1,1,0,1,0
2,415,415,94,94,0,1,0
10,420,420,172,52,120,4,3
17,437,437,1,1,0,1,0
16,489,489,152,152,0,1,0
5,493,493,61,23,38,2,1
19,499,499,3,3,0,1,0

9,111,111,9,9,0,1,0
8,117,117,5,5,0,1,0
5,126,126,7,7,0,1,0
0,133,133,1,1,0,1,0
11,139,139,6,6,0,1,0
6,143,143,21,21,0,1,0
16,169,169,13,13,0,1,0
14,217,217,17,11,6,3,2
19,285,285,2,2,0,1,0
3,310,310,55,43,12,3,2
1,329,329,29,29,0,1,0
13,336,336,78,78,0,1,0
18,336,336,36,36,0,1,0
21,358,358,100,4,96,4,3
10,363,363,37,8,29,2,1
17,367,367,35,35,0,1,0
7,397,397,2,2,0,1,0
4,408,408,82,66,16,4,3
12,433,433,52,46,6,3,2
15,447,447,4,4,0,1,0
2,462,462,184,110,74,3,2
20,476,476,33,33,0,1,0

8,101,101,15,15,0,1,0
15,113,113,22,5,17,2,1
20,194,194,31,31,0,1,0
2,231,231,2,2,0,1,0
17,249,249,8,8,0,1,0
10,257,257,20,8,12,4,3
0,265,265,14,14,0,1,0
7,270,270,24,24,0,1,0
11,285,285,7,1,6,2,1
19,287,287,9,9,0,1,0
14,315,315,98,98,0,1,0
18,329,329,6,6,0,1,0
5,338,338,2,2,0,1,0
13,355,355,66,39,27,2,1
9,373,373,4,4,0,1,0
21,395,395,38,38,0,1,0
6,435,435,228,228,0,1,0
3,448,448,34,34,0,1,0
4,453,453,73,40,33,2,1
22,456,456,65,7,58,3,2
12,458,458,6,6,0,1,0
16,477,477,4,1,3,2,1
1,498,498,23,15,8,2,1

28,101,101,2,2,0,1,0
8,104,104,1,1,0,1,0
17,135,135,5,5,0,1,0
1,149,149,4,4,0,1,0
24,151,151,2,2,0,1,0
4,186,186,6,3,3,2,1
12,192,192,6,6,0,1,0
16,206,206,8,8,0,1,0
11,222,222,17,17,0,1,0
26,239,239,6,6,0,1,0
25,241,241,13,13,0,1,0
18,247,247,40,40,0,1,0
15,265,265,57,11,46,2,1
14,304,304,32,5,27,3,2
5,323,323,66,27,39,4,3
23,335,335,56,56,0,1,0
7,384,384,32,32,0,1,0
21,386,386,30,11,19,2,1
3,388,388,31,31,0,1,0
9,390,390,4,4,0,1,0
22,394,394,89,55,34,3,2
20,401,401,124,34,90,4,3
13,410,410,42,42,0,1,0
2,414,414,9,5,4,2,1
6,435,435,49,49,0,1,0
0,452,452,23,23,0,1,0
27,470,470,15,15,0,1,0
19,493,493,52,52,0,1,0
10,496,496,1,1,0,1,0

9,162,162,1,1,0,1,0
13,183,183,13,13,0,1,0
4,211,211,13,13,0,1,0
22,211,211,1,1,0,1,0
3,217,217,63,53,10,2,1
14,231,231,72,62,10,3,2
7,248,248,2,2,0,1,0
12,259,259,47,31,16,3,2
5,280,280,73,67,6,3,2
0,283,283,16,16,0,1,0
8,298,298,53,53,0,1,0
2,300,300,1,1,0,1,0
1,301,301,10,10,0,1,0
19,311,311,28,28,0,1,0
20,346,346,5,1,4,2,1
15,369,369,7,7,0,1,0
17,370,370,25,11,14,3,2
11,393,393,94,10,84,4,3
10,406,406,24,10,14,3,2
21,412,412,6,6,0,1,0
23,422,422,86,30,56,3,2
16,427,427,56,41,15,4,3
18,427,427,47,47,0,1,0
6,492,492,2,2,0,1,0

3,114,114,4,4,0,1,0
5,153,153,2,2,0,1,0
8,164,164,8,4,4,2,1
21,167,167,5,5,0,1,0
14,172,172,6,6,0,1,0
7,192,192,4,4,0,1,0
4,202,202,15,7,8,3,2
0,234,234,14,9,5,2,1
16,251,251,48,22,26,2,1
6,281,281,99,99,0,1,0
2,300,300,1,1,0,1,0
10,309,309,59,47,12,3,2
13,325,325,80,44,36,3,2
15,329,329,21,3,18,4,3
12,348,348,6,6,0,1,0
22,397,397,40,2,38,2,1
19,430,430,60,60,0,1,0
1,433,433,7,7,0,1,0
20,465,465,90,75,15,4,3
18,466,466,66,18,48,4,3
9,474,474,183,150,33,4,3
11,498,498,3,3,0,1,0
17,500,500,26,26,0,1,0

5,129,129,2,2,0,1,0
14,131,131,12,1,11,2,1
24,136,136,1,1,0,1,0
20,143,143,20,20,0,1,0
15,150,150,16,3,13,2,1
21,170,170,1,1,0,1,0
23,173,173,64,64,0,1,0
10,223,223,2,2,0,1,0
3,226,226,7,7,0,1,0
1,253,253,46,7,39,2,1
18,261,261,4,4,0,1,0
11,265,265,11,11,0,1,0
16,302,302,27,27,0,1,0
12,313,313,14,2,12,3,2
6,337,337,31,31,0,1,0
17,346,346,45,45,0,1,0
9,347,347,102,102,0,1,0
7,373,373,5,1,4,2,1
22,374,374,15,3,12,3,2
26,388,388,42,42,0,1,0
4,401,401,6,6,0,1,0
27,413,413,6,6,0,1,0
25,416,416,3,3,0,1,0
13,437,437,43,43,0,1,0
19,449,449,131,45,86,3,2
8,449,449,16,16,0,1,0
0,468,468,21,10,11,3,2
2,487,487,43,21,22,2,1

31,110,110,11,11,0,1,0
13,113,113,2,2,0,1,0
9,133,133,19,11,8,2,1
14,145,145,7,1,6,2,1
0,157,157,4,1,3,2,1
23,169,169,34,4,30,4,3
6,172,172,2,2,0,1,0
28,203,203,9,9,0,1,0
17,204,204,17,2,15,4,3
22,206,206,49,49,0,1,0
27,222,222,6,6,0,1,0
8,238,238,10,2,8,3,2
18,273,273,4,4,0,1,0
29,273,273,55,55,0,1,0
26,277,277,1,1,0,1,0
24,293,293,20,12,8,2,1
19,335,335,11,11,0,1,0
25,337,337,50,29,21,4,3
11,341,341,14,14,0,1,0
21,349,349,49,27,22,3,2
20,352,352,20,20,0,1,0
4,363,363,42,26,16,2,1
12,379,379,7,3,4,2,1
15,384,384,3,3,0,1,0
5,393,393,9,9,0,1,0
7,395,395,82,63,19,2,1
10,413,413,32,32,0,1,0
30,430,430,4,4,0,1,0
32,441,441,21,9,12,3,2
3,471,471,55,55,0,1,0
2,480,480,55,22,33,2,1
1,487,487,1,1,0,1,0
16,487,487,1,1,0,1,0

0,111,111,22,5,17,2,1
1,128,128,5,5,0,1,0
8,129,129,7,7,0,1,0
19,148,148,1,1,0,1,0
20,207,207,7,7,0,1,0
3,213,213,23,23,0,1,0
14,228,228,20,20,0,1,0
15,257,257,29,11,18,3,2
18,262,262,56,56,0,1,0
4,268,268,6,6,0,1,0
7,270,270,61,13,48,2,1
24,284,284,40,31,9,4,3
16,296,296,26,26,0,1,0
2,308,308,12,2,10,2,1
6,314,314,17,5,12,4,3
9,328,328,6,6,0,1,0
13,343,343,84,71,13,2,1
12,405,405,16,16,0,1,0
21,407,407,198,189,9,2,1
23,422,422,2,2,0,1,0
25,435,435,13,7,6,3,2
17,444,444,4,4,0,1,0
10,461,461,28,6,22,2,1
22,479,479,4,1,3,2,1
5,479,479,8,2,6,2,1
11,499,499,40,40,0,1,0

18,116,116,3,3,0,1,0
19,133,133,3,3,0,1,0
0,202,202,28,10,18,2,1
1,216,216,61,61,0,1,0
8,244,244,11,11,0,1,0
4,249,249,7,7,0,1,0
11,311,311,42,25,17,2,1
5,333,333,33,13,20,2,1
3,337,337,70,70,0,1,0
7,349,349,82,35,47,2,1
9,359,359,26,15,11,2,1
10,366,366,18,1,17,2,1
17,377,377,209,143,66,4,3
13,399,399,7,7,0,1,0
6,400,400,31,17,14,3,2
2,407,407,54,54,0,1,0
16,412,412,40,40,0,1,0
14,434,434,17,17,0,1,0
12,435,435,37,28,9,4,3
15,461,461,37,5,32,3,2

20,112,112,8,2,6,2,1
17,121,121,11,11,0,1,0
2,130,130,8,2,6,3,2
18,183,183,32,3,29,2,1
4,184,184,1,1,0,1,0
19,190,190,27,27,0,1,0
3,193,193,12,5,7,2,1
6,202,202,13,13,0,1,0
5,224,224,23,4,19,2,1
15,240,240,15,7,8,2,1
1,254,254,62,62,0,1,0
0,258,258,3,3,0,1,0
10,273,273,31,31,0,1,0
14,279,279,25,25,0,1,0
7,288,288,15,15,0,1,0
16,299,299,15,15,0,1,0
9,312,312,153,153,0,1,0
12,406,406,106,106,0,1,0
8,422,422,45,45,0,1,0
21,466,466,14,2,12,2,1
13,476,476,42,42,0,1,0
11,488,488,24,24,0,1,0

5,102,102,10,10,0,1,0
16,106,106,12,12,0,1,0
0,124,124,34,9,25,2,1
3,125,125,1,1,0,1,0
15,125,125,2,2,0,1,0
6,133,133,22,22,0,1,0
7,189,189,5,1,4,2,1
4,199,199,2,2,0,1,0
23,217,217,25,9,16,2,1
20,231,231,5,1,4,2,1
11,242,242,58,18,40,3,2
17,260,260,47,29,18,2,1
1,312,312,41,41,0,1,0
10,330,330,10,10,0,1,0
12,344,344,15,3,12,2,1
22,372,372,33,33,0,1,0
21,384,384,7,7,0,1,0
19,390,390,100,86,14,3,2
2,393,393,29,29,0,1,0
13,445,445,2,2,0,1,0
14,452,452,45,45,0,1,0
9,463,463,41,19,22,3,2
18,486,486,132,22,110,4,3
8,497,497,28,16,12,4,3

10,107,107,3,3,0,1,0
0,145,145,12,4,8,2,1
20,153,153,16,16,0,1,0
2,158,158,1,1,0,1,0
24,165,165,4,4,0,1,0
25,168,168,84,71,13,2,1
26,175,175,1,1,0,1,0
19,181,181,5,2,3,2,1
18,189,189,6,6,0,1,0
7,205,205,11,11,0,1,0
17,240,240,48,26,22,2,1
3,242,242,4,4,0,1,0
23,249,249,40,40,0,1,0
16,270,270,25,25,0,1,0
8,281,281,35,12,23,3,2
4,291,291,1,1,0,1,0
12,346,346,28,28,0,1,0
11,351,351,14,14,0,1,0
21,381,381,7,1,6,3,2
6,402,402,72,72,0,1,0
5,403,403,4,4,0,1,0
14,427,427,114,87,27,4,3
13,431,431,11,11,0,1,0
9,462,462,11,11,0,1,0
15,464,464,14,5,9,2,1
22,495,495,15,15,0,1,0
1,497,497,129,33,96,3,2

13,130,130,12,12,0,1,0
8,158,158,30,15,15,4,3
23,172,172,13,13,0,1,0
4,178,178,5,5,0,1,0
12,178,178,8,8,0,1,0
24,195,195,15,15,0,1,0
22,198,198,19,19,0,1,0
2,207,207,39,36,3,2,1
20,207,207,37,37,0,1,0
14,210,210,42,42,0,1,0
16,240,240,48,28,20,3,2
25,281,281,29,29,0,1,0
1,292,292,20,9,11,2,1
6,295,295,19,5,14,2,1
10,320,320,1,1,0,1,0
18,363,363,2,2,0,1,0
3,375,375,34,28,6,3,2
9,383,383,10,2,8,3,2
5,405,405,73,25,48,4,3
19,409,409,25,25,0,1,0
11,430,430,36,36,0,1,0
17,439,439,39,39,0,1,0
21,444,444,14,14,0,1,0
15,481,481,50,28,22,2,1
7,485,485,50,50,0,1,0
0,496,496,21,21,0,1,0

4,119,119,3,3,0,1,0
22,128,128,13,1,12,2,1
20,144,144,9,9,0,1,0
2,152,152,4,4,0,1,0
6,180,180,86,86,0,1,0
1,187,187,3,3,0,1,0
14,221,221,29,29,0,1,0
7,235,235,36,15,21,2,1
21,238,238,53,53,0,1,0
16,246,246,2,2,0,1,0
19,338,338,51,51,0,1,0
17,348,348,8,5,3,2,1
15,358,358,64,14,50,2,1
10,369,369,58,46,12,2,1
12,370,370,12,12,0,1,0
8,381,381,27,27,0,1,0
3,425,425,21,17,4,2,1
9,439,439,45,45,0,1,0
5,441,441,3,3,0,1,0
11,446,446,39,5,34,2,1
0,471,471,55,12,43,3,2
13,480,480,15,2,13,2,1
18,483,483,91,91,0,1,0

22,119,119,4,4,0,1,0
2,140,140,12,5,7,2,1
14,152,152,1,1,0,1,0
8,153,153,14,14,0,1,0
23,160,160,7,1,6,2,1
3,185,185,16,16,0,1,0
12,192,192,10,4,6,2,1
6,206,206,38,6,32,3,2
19,231,231,33,33,0,1,0
5,266,266,1,1,0,1,0
9,286,286,16,16,0,1,0
20,286,286,24,24,0,1,0
0,296,296,12,9,3,2,1
17,311,311,4,4,0,1,0
11,322,322,18,18,0,1,0
13,352,352,6,6,0,1,0
1,367,367,31,31,0,1,0
16,370,370,213,137,76,4,3
18,402,402,47,47,0,1,0
4,403,403,63,63,0,1,0
10,462,462,82,82,0,1,0
7,466,466,83,3,80,4,3
21,484,484,4,4,0,1,0
15,486,486,63,39,24,3,2

8,126,126,4,4,0,1,0
25,132,132,3,3,0,1,0
21,148,148,11,11,0,1,0
14,182,182,6,6,0,1,0
22,186,186,63,63,0,1,0
2,216,216,5,5,0,1,0
23,216,216,23,23,0,1,0
17,216,216,3,3,0,1,0
18,222,222,19,4,15,4,3
24,225,225,25,25,0,1,0
11,227,227,7,4,3,2,1
6,247,247,41,14,27,2,1
4,258,258,13,13,0,1,0
1,294,294,27,1,26,3,2
19,297,297,100,53,47,2,1
20,301,301,1,1,0,1,0
0,316,316,67,46,21,4,3
5,343,343,33,33,0,1,0
12,389,389,23,11,12,2,1
9,402,402,50,19,31,4,3
15,414,414,5,5,0,1,0
16,427,427,41,4,37,2,1
13,447,447,17,4,13,2,1
7,462,462,20,8,12,3,2
10,469,469,4,4,0,1,0
3,476,476,107,7,100,3,2

16,104,104,14,14,0,1,0
7,105,105,1,1,0,1,0
23,115,115,7,7,0,1,0
20,115,115,29,3,26,3,2
25,140,140,59,9,50,3,2
5,170,170,8,2,6,3,2
15,191,191,2,2,0,1,0
9,193,193,43,36,7,2,1
29,193,193,31,22,9,4,3
12,206,206,2,2,0,1,0
26,206,206,13,13,0,1,0
4,207,207,1,1,0,1,0
22,219,219,2,2,0,1,0
19,253,253,37,37,0,1,0
6,269,269,28,2,26,3,2
24,296,296,1,1,0,1,0
28,299,299,14,4,10,3,2
11,318,318,39,9,30,3,2
17,352,352,21,9,12,3,2
1,352,352,1,1,0,1,0
27,365,365,22,22,0,1,0
21,375,375,17,17,0,1,0
13,382,382,26,7,19,2,1
31,388,388,6,6,0,1,0
8,399,399,11,11,0,1,0
18,404,404,1,1,0,1,0
3,407,407,9,9,0,1,0
30,411,411,40,16,24,4,3
2,417,417,6,6,0,1,0
0,432,432,3,3,0,1,0
14,476,476,44,44,0,1,0
10,500,500,46,46,0,1,0

0,108,108,16,6,10,2,1
12,114,114,14,14,0,1,0
15,140,140,4,4,0,1,0
18,146,146,1,1,0,1,0
11,160,160,20,5,15,4,3
17,168,168,14,1,13,2,1
14,176,176,77,3,74,3,2
5,211,211,3,3,0,1,0
9,224,224,26,26,0,1,0
24,227,227,10,10,0,1,0
23,227,227,5,1,4,2,1
7,228,228,4,4,0,1,0
3,259,259,8,8,0,1,0
19,285,285,28,28,0,1,0
21,298,298,7,7,0,1,0
1,302,302,13,1,12,3,2
25,307,307,18,18,0,1,0
22,328,328,28,11,17,2,1
10,371,371,45,15,30,3,2
6,415,415,18,18,0,1,0
8,419,419,86,64,22,3,2
20,421,421,19,19,0,1,0
16,429,429,124,67,57,4,3
13,432,432,19,3,16,3,2
2,470,470,47,47,0,1,0
4,480,480,33,10,23,2,1

4,110,110,9,9,0,1,0
21,128,128,25,25,0,1,0
27,129,129,15,15,0,1,0
8,146,146,5,5,0,1,0
1,184,184,6,6,0,1,0
29,201,201,7,7,0,1,0
5,213,213,10,10,0,1,0
24,217,217,17,5,12,2,1
10,219,219,12,12,0,1,0
19,289,289,9,9,0,1,0
6,298,298,28,7,21,4,3
16,300,300,14,6,8,2,1
13,328,328,9,3,6,3,2
2,349,349,4,4,0,1,0
25,357,357,96,6,90,3,2
11,358,358,38,38,0,1,0
26,377,377,23,2,21,2,1
17,380,380,58,34,24,2,1
15,384,384,40,10,30,4,3
23,408,408,25,13,12,3,2
9,414,414,13,1,12,2,1
18,424,424,58,41,17,4,3
22,430,430,13,13,0,1,0
20,434,434,23,7,16,2,1
0,447,447,33,12,21,4,3
3,460,460,11,4,7,2,1
7,483,483,106,96,10,3,2
12,489,489,21,10,11,2,1
28,491,491,75,75,0,1,0
14,500,500,9,9,0,1,0

18,106,106,3,3,0,1,0
6,134,134,9,9,0,1,0
14,156,156,14,14,0,1,0
0,160,160,1,1,0,1,0
4,167,167,31,1,30,3,2
8,184,184,31,19,12,3,2
15,200,200,7,7,0,1,0
16,204,204,13,13,0,1,0
7,226,226,27,1,26,3,2
1,229,229,29,14,15,2,1
9,243,243,6,6,0,1,0
5,253,253,59,59,0,1,0
3,262,262,5,5,0,1,0
2,264,264,35,35,0,1,0
20,271,271,1,1,0,1,0
23,297,297,18,18,0,1,0
12,321,321,70,38,32,3,2
21,325,325,8,1,7,2,1
11,342,342,19,19,0,1,0
22,343,343,59,23,36,4,3
17,393,393,22,13,9,2,1
19,393,393,67,67,0,1,0
10,394,394,25,11,14,2,1
13,484,484,148,48,100,3,2

12,131,131,22,22,0,1,0
18,144,144,11,2,9,2,1
6,174,174,19,19,0,1,0
17,199,199,40,40,0,1,0
4,231,231,30,30,0,1,0
11,257,257,20,6,14,3,2
9,276,276,1,1,0,1,0
19,280,280,2,2,0,1,0
16,345,345,7,7,0,1,0
5,383,383,17,17,0,1,0
13,395,395,77,1,76,3,2
3,400,400,35,29,6,2,1
2,424,424,159,106,53,3,2
1,424,424,32,32,0,1,0
10,427,427,5,2,3,2,1
21,441,441,32,32,0,1,0
8,442,442,26,26,0,1,0
20,450,450,103,67,36,4,3
14,461,461,24,24,0,1,0
15,475,475,53,21,32,3,2
7,479,479,5,5,0,1,0
0,482,482,149,113,36,4,3

25,109,109,20,20,0,1,0
21,134,134,12,12,0,1,0
6,156,156,3,3,0,1,0
5,157,157,19,2,17,4,3
20,164,164,8,8,0,1,0
22,197,197,36,36,0,1,0
8,207,207,3,3,0,1,0
11,221,221,1,1,0,1,0
29,235,235,6,6,0,1,0
3,245,245,20,20,0,1,0
1,249,249,10,10,0,1,0
7,249,249,67,67,0,1,0
16,261,261,1,1,0,1,0
17,269,269,24,24,0,1,0
4,271,271,18,10,8,3,2
23,289,289,13,13,0,1,0
19,291,291,2,2,0,1,0
28,310,310,85,58,27,4,3
2,312,312,19,19,0,1,0
0,327,327,29,13,16,2,1
14,353,353,9,9,0,1,0
18,367,367,84,42,42,4,3
24,393,393,2,2,0,1,0
13,422,422,7,1,6,3,2
12,432,432,9,9,0,1,0
15,441,441,1,1,0,1,0
26,449,449,21,2,19,2,1
27,481,481,44,6,38,2,1
10,483,483,26,2,24,4,3
9,486,486,108,75,33,4,3

1,102,102,17,17,0,1,0
2,104,104,10,10,0,1,0
18,127,127,25,25,0,1,0
9,147,147,14,11,3,2,1
13,164,164,11,11,0,1,0
6,167,167,8,8,0,1,0
16,185,185,3,3,0,1,0
17,214,214,5,5,0,1,0
4,281,281,121,87,34,3,2
21,293,293,15,4,11,2,1
19,300,300,126,126,0,1,0
20,324,324,28,28,0,1,0
22,358,358,58,6,52,3,2
8,385,385,4,4,0,1,0
7,412,412,1,1,0,1,0
14,422,422,17,9,8,2,1
0,424,424,70,70,0,1,0
3,432,432,7,2,5,2,1
5,451,451,25,25,0,1,0
12,453,453,12,12,0,1,0
11,459,459,25,25,0,1,0
15,495,495,40,40,0,1,0
10,499,499,57,15,42,4,3

4,122,122,8,2,6,3,2
8,135,135,2,2,0,1,0
11,140,140,8,1,7,3,2
0,149,149,15,15,0,1,0
23,168,168,2,2,0,1,0
13,172,172,15,10,5,2,1
24,198,198,29,29,0,1,0
27,211,211,25,13,12,4,3
25,226,226,2,2,0,1,0
16,235,235,11,11,0,1,0
3,243,243,2,2,0,1,0
21,265,265,27,27,0,1,0
14,287,287,33,21,12,4,3
5,302,302,24,10,14,3,2
1,312,312,23,16,7,2,1
6,314,314,24,24,0,1,0
2,323,323,62,12,50,3,2
22,340,340,19,19,0,1,0
12,401,401,3,3,0,1,0
20,402,402,164,134,30,4,3
17,424,424,44,44,0,1,0
15,434,434,36,36,0,1,0
7,462,462,5,5,0,1,0
10,466,466,89,29,60,4,3
19,486,486,43,13,30,4,3
26,487,487,24,24,0,1,0
9,496,496,19,19,0,1,0
18,499,499,39,39,0,1,0

7,107,107,1,1,0,1,0
0,109,109,22,22,0,1,0
8,111,111,11,11,0,1,0
15,127,127,3,3,0,1,0
1,130,130,2,2,0,1,0
10,148,148,6,3,3,2,1
20,154,154,6,6,0,1,0
18,168,168,67,62,5,2,1
6,176,176,21,18,3,2,1
13,206,206,3,3,0,1,0
3,245,245,63,24,39,4,3
2,249,249,22,4,18,4,3
4,296,296,83,50,33,4,3
9,307,307,7,7,0,1,0
22,337,337,40,16,24,2,1
12,342,342,17,14,3,2,1
17,346,346,29,19,10,2,1
19,348,348,73,21,52,4,3
23,406,406,97,97,0,1,0
21,431,431,9,9,0,1,0
14,473,473,7,7,0,1,0
11,481,481,31,31,0,1,0
16,487,487,5,5,0,1,0
5,487,487,1,1,0,1,0

8,131,131,52,52,0,1,0
15,146,146,6,3,3,2,1
23,160,160,22,4,18,2,1
4,162,162,6,6,0,1,0
21,163,163,10,4,6,2,1
20,172,172,5,5,0,1,0
18,187,187,25,16,9,2,1
3,214,214,6,3,3,2,1
5,226,226,12,12,0,1,0
2,265,265,5,5,0,1,0
22,267,267,102,53,49,2,1
19,283,283,4,4,0,1,0
14,300,300,33,18,15,4,3
17,321,321,26,8,18,2,1
7,333,333,11,2,9,2,1
12,333,333,28,11,17,2,1
6,342,342,2,2,0,1,0
24,354,354,7,7,0,1,0
16,361,361,21,3,18,3,2
25,373,373,60,60,0,1,0
13,377,377,16,16,0,1,0
10,385,385,120,102,18,4,3
0,386,386,31,22,9,2,1
1,468,468,27,8,19,2,1
9,495,495,7,7,0,1,0
11,499,499,19,2,17,2,1

12,134,134,1,1,0,1,0
21,140,140,15,15,0,1,0
8,159,159,2,2,0,1,0
17,161,161,3,3,0,1,0
3,181,181,2,2,0,1,0
13,202,202,14,14,0,1,0
18,229,229,43,43,0,1,0
1,298,298,16,7,9,2,1
9,312,312,27,27,0,1,0
11,365,365,39,9,30,4,3
15,365,365,24,6,18,4,3
7,374,374,20,20,0,1,0
19,386,386,157,157,0,1,0
2,388,388,50,30,20,3,2
4,391,391,142,142,0,1,0
14,395,395,49,49,0,1,0
16,401,401,12,3,9,4,3
20,414,414,9,3,6,3,2
10,418,418,31,31,0,1,0
5,463,463,111,104,7,2,1
6,469,469,76,76,0,1,0
0,492,492,44,20,24,2,1

7,135,135,3,3,0,1,0
14,136,136,6,1,5,2,1
3,159,159,2,2,0,1,0
11,222,222,8,8,0,1,0
12,233,233,17,7,10,2,1
2,236,236,64,21,43,3,2
9,262,262,38,38,0,1,0
5,273,273,61,61,0,1,0
8,322,322,15,15,0,1,0
1,356,356,4,4,0,1,0
16,390,390,27,27,0,1,0
10,392,392,43,14,29,2,1
13,411,411,20,3,17,2,1
18,415,415,2,2,0,1,0
19,428,428,59,12,47,4,3
6,436,436,191,50,141,4,3
17,439,439,122,22,100,4,3
0,447,447,12,12,0,1,0
15,475,475,49,49,0,1,0
20,480,480,79,49,30,3,2
4,499,499,74,2,72,3,2

19,113,113,6,6,0,1,0
20,116,116,8,2,6,2,1
15,124,124,22,6,16,2,1
12,133,133,6,6,0,1,0
6,135,135,1,1,0,1,0
9,226,226,8,8,0,1,0
8,228,228,10,4,6,3,2
0,247,247,23,11,12,4,3
2,299,299,55,55,0,1,0
7,300,300,20,8,12,2,1
5,302,302,34,25,9,2,1
21,315,315,172,119,53,3,2
13,316,316,2,2,0,1,0
14,332,332,12,8,4,2,1
25,335,335,37,37,0,1,0
11,350,350,20,6,14,3,2
3,352,352,85,62,23,2,1
16,354,354,19,10,9,2,1
1,373,373,47,21,26,2,1
17,384,384,11,11,0,1,0
4,411,411,32,32,0,1,0
24,412,412,12,12,0,1,0
23,415,415,23,12,11,4,3
22,437,437,19,19,0,1,0
10,454,454,48,18,30,2,1
18,492,492,12,12,0,1,0

15,103,103,6,1,5,2,1
1,129,129,22,22,0,1,0
5,160,160,8,8,0,1,0
24,169,169,41,41,0,1,0
13,178,178,13,13,0,1,0
8,220,220,9,9,0,1,0
17,235,235,22,10,12,3,2
2,255,255,12,4,8,3,2
21,257,257,1,1,0,1,0
20,269,269,7,7,0,1,0
11,273,273,25,17,8,2,1
10,273,273,82,28,54,4,3
22,278,278,7,7,0,1,0
7,295,295,26,1,25,2,1
0,298,298,38,38,0,1,0
16,299,299,36,17,19,4,3
25,321,321,16,16,0,1,0
12,322,322,2,2,0,1,0
18,344,344,26,26,0,1,0
4,392,392,28,28,0,1,0
26,441,441,128,22,106,4,3
9,464,464,11,11,0,1,0
14,478,478,10,10,0,1,0
23,480,480,74,74,0,1,0
19,483,483,40,25,15,2,1
6,492,492,2,2,0,1,0
3,499,499,43,43,0,1,0

7,127,127,3,3,0,1,0
21,138,138,11,11,0,1,0
2,144,144,2,2,0,1,0
1,151,151,1,1,0,1,0
0,203,203,42,42,0,1,0
8,205,205,6,2,4,2,1
22,254,254,69,69,0,1,0
10,293,293,97,97,0,1,0
23,299,299,34,34,0,1,0
16,300,300,15,3,12,3,2
9,306,306,33,33,0,1,0
4,319,319,1,1,0,1,0
17,330,330,43,9,34,2,1
19,348,348,12,12,0,1,0
13,361,361,12,12,0,1,0
3,369,369,38,23,15,2,1
18,421,421,23,23,0,1,0
15,442,442,3,3,0,1,0
14,451,451,5,5,0,1,0
12,456,456,131,125,6,3,2
5,459,459,4,4,0,1,0
11,470,470,165,165,0,1,0
6,477,477,8,5,3,2,1
20,492,492,74,37,37,2,1

12,112,112,14,14,0,1,0
16,113,113,17,2,15,4,3
20,115,115,4,4,0,1,0
22,118,118,25,1,24,4,3
19,150,150,1,1,0,1,0
8,152,152,21,21,0,1,0
7,153,153,24,4,20,3,2
11,165,165,5,5,0,1,0
13,169,169,17,6,11,2,1
10,178,178,19,11,8,2,1
4,237,237,74,4,70,4,3
18,261,261,68,55,13,2,1
0,328,328,4,4,0,1,0
9,330,330,3,3,0,1,0
15,335,335,13,13,0,1,0
1,353,353,11,11,0,1,0
23,357,357,45,45,0,1,0
17,370,370,38,23,15,2,1
6,431,431,65,65,0,1,0
2,451,451,26,26,0,1,0
3,454,454,41,5,36,2,1
21,470,470,2,2,0,1,0
14,484,484,35,35,0,1,0
5,496,496,52,24,28,3,2

12,107,107,2,2,0,1,0
23,108,108,34,2,32,3,2
5,166,166,18,9,9,2,1
0,167,167,40,12,28,4,3
4,193,193,6,6,0,1,0
3,211,211,4,4,0,1,0
14,212,212,25,25,0,1,0
13,226,226,36,36,0,1,0
21,227,227,23,23,0,1,0
17,231,231,13,13,0,1,0
20,266,266,29,17,12,2,1
25,279,279,4,4,0,1,0
22,279,279,8,8,0,1,0
11,291,291,2,2,0,1,0
19,295,295,10,10,0,1,0
15,308,308,67,11,56,3,2
1,314,314,5,5,0,1,0
8,322,322,38,11,27,4,3
2,326,326,46,46,0,1,0
24,334,334,49,39,10,3,2
9,340,340,79,79,0,1,0
6,380,380,18,18,0,1,0
16,383,383,5,2,3,2,1
10,435,435,25,6,19,2,1
18,453,453,35,10,25,4,3
7,457,457,3,3,0,1,0

11,104,104,14,5,9,2,1
22,120,120,5,5,0,1,0
16,121,121,27,27,0,1,0
20,142,142,10,2,8,3,2
14,163,163,12,9,3,2,1
1,182,182,2,2,0,1,0
2,185,185,6,6,0,1,0
15,198,198,75,75,0,1,0
3,208,208,3,3,0,1,0
4,226,226,34,34,0,1,0
19,227,227,6,1,5,2,1
9,236,236,60,21,39,4,3
0,252,252,56,5,51,4,3
13,259,259,25,25,0,1,0
21,275,275,14,4,10,3,2
17,290,290,11,11,0,1,0
5,333,333,22,10,12,3,2
7,385,385,88,34,54,4,3
18,387,387,3,3,0,1,0
6,388,388,43,43,0,1,0
12,477,477,47,47,0,1,0
8,488,488,10,10,0,1,0
10,496,496,45,27,18,4,3

15,111,111,5,5,0,1,0
22,135,135,13,4,9,4,3
3,141,141,11,7,4,2,1
12,142,142,19,19,0,1,0
7,155,155,25,25,0,1,0
4,170,170,33,33,0,1,0
5,222,222,13,2,11,4,3
1,224,224,27,27,0,1,0
19,230,230,48,8,40,2,1
9,236,236,9,9,0,1,0
13,244,244,40,7,33,4,3
14,258,258,58,58,0,1,0
2,260,260,47,10,37,2,1
10,293,293,74,74,0,1,0
8,313,313,1,1,0,1,0
6,330,330,1,1,0,1,0
18,341,341,7,7,0,1,0
17,364,364,41,19,22,3,2
23,374,374,34,22,12,2,1
0,377,377,2,2,0,1,0
11,399,399,42,8,34,3,2
21,434,434,23,4,19,3,2
20,496,496,7,7,0,1,0
16,499,499,28,5,23,3,2

1,121,121,2,2,0,1,0
11,128,128,19,5,14,3,2
8,129,129,26,26,0,1,0
26,129,129,7,7,0,1,0
9,171,171,13,5,8,2,1
22,203,203,2,2,0,1,0
7,246,246,1,1,0,1,0
17,297,297,6,3,3,2,1
0,298,298,9,9,0,1,0
23,301,301,68,60,8,2,1
3,302,302,26,26,0,1,0
20,352,352,48,48,0,1,0
12,361,361,24,24,0,1,0
14,372,372,7,7,0,1,0
16,373,373,39,24,15,4,3
19,379,379,114,114,0,1,0
4,389,389,122,116,6,3,2
18,434,434,64,64,0,1,0
21,446,446,8,8,0,1,0
27,447,447,40,11,29,2,1
2,453,453,2,2,0,1,0
24,456,456,12,12,0,1,0
13,463,463,18,10,8,2,1
5,473,473,13,13,0,1,0
10,481,481,30,10,20,3,2
25,487,487,41,23,18,2,1
15,494,494,3,3,0,1,0
6,495,495,49,49,0,1,0

14,102,102,2,2,0,1,0
2,112,112,9,4,5,2,1
6,116,116,20,20,0,1,0
25,141,141,50,41,9,4,3
0,145,145,9,9,0,1,0
15,146,146,12,7,5,2,1
19,205,205,9,9,0,1,0
4,215,215,34,34,0,1,0
23,220,220,15,15,0,1,0
18,247,247,10,2,8,3,2
1,288,288,25,25,0,1,0
13,288,288,30,30,0,1,0
24,294,294,51,6,45,3,2
17,336,336,47,47,0,1,0
26,337,337,14,14,0,1,0
7,338,338,53,14,39,4,3
10,359,359,13,13,0,1,0
9,389,389,20,20,0,1,0
8,404,404,14,14,0,1,0
11,406,406,30,30,0,1,0
20,408,408,7,3,4,2,1
16,420,420,10,10,0,1,0
21,442,442,34,4,30,3,2
12,449,449,4,4,0,1,0
3,452,452,3,3,0,1,0
22,473,473,77,47,30,3,2
5,496,496,77,38,39,2,1

20,100,100,9,2,7,2,1
19,129,129,51,26,25,3,2
13,147,147,9,9,0,1,0
9,157,157,34,19,15,4,3
12,158,158,3,3,0,1,0
15,210,210,3,3,0,1,0
17,235,235,26,7,19,2,1
22,239,239,32,5,27,2,1
3,248,248,18,12,6,2,1
6,259,259,68,42,26,3,2
23,284,284,22,22,0,1,0
1,319,319,43,43,0,1,0
0,336,336,1,1,0,1,0
8,348,348,24,24,0,1,0
18,348,348,13,7,6,2,1
14,365,365,15,9,6,2,1
10,378,378,42,15,27,2,1
4,410,410,8,2,6,2,1
16,432,432,26,26,0,1,0
7,436,436,1,1,0,1,0
11,455,455,29,26,3,2,1
5,460,460,81,81,0,1,0
21,477,477,92,4,88,3,2
2,482,482,34,18,16,3,2

4,129,129,29,1,28,3,2
14,138,138,29,24,5,2,1
16,138,138,6,6,0,1,0
18,141,141,22,22,0,1,0
19,143,143,2,2,0,1,0
15,144,144,15,5,10,3,2
9,174,174,3,3,0,1,0
17,179,179,10,10,0,1,0
3,200,200,21,8,13,2,1
20,217,217,21,8,13,2,1
24,236,236,27,27,0,1,0
5,278,278,6,3,3,2,1
7,284,284,25,25,0,1,0
23,296,296,29,8,21,2,1
13,297,297,6,6,0,1,0
25,298,298,2,2,0,1,0
11,306,306,11,11,0,1,0
6,334,334,5,5,0,1,0
21,337,337,38,38,0,1,0
26,351,351,98,98,0,1,0
2,376,376,39,39,0,1,0
0,380,380,18,18,0,1,0
1,381,381,1,1,0,1,0
8,393,393,62,62,0,1,0
12,403,403,28,18,10,3,2
22,404,404,59,59,0,1,0
10,452,452,38,38,0,1,0

12,103,103,5,1,4,2,1
3,138,138,11,11,0,1,0
7,140,140,14,4,10,2,1
9,171,171,6,3,3,2,1
16,182,182,22,12,10,2,1
0,269,269,60,10,50,3,2
22,270,270,12,4,8,3,2
13,274,274,15,15,0,1,0
19,304,304,13,13,0,1,0
4,337,337,25,19,6,2,1
11,351,351,18,1,17,2,1
20,354,354,25,25,0,1,0
14,355,355,88,34,54,3,2
1,371,371,32,32,0,1,0
8,373,373,106,64,42,4,3
17,388,388,93,9,84,4,3
10,431,431,22,22,0,1,0
5,440,440,27,27,0,1,0
6,441,441,85,37,48,3,2
2,443,443,6,2,4,2,1
15,469,469,10,2,8,3,2
21,480,480,93,21,72,4,3
18,492,492,42,42,0,1,0

15,152,152,19,19,0,1,0
5,162,162,16,13,3,2,1
7,184,184,14,5,9,4,3
26,185,185,7,2,5,2,1
4,193,193,9,9,0,1,0
13,207,207,26,4,22,2,1
25,218,218,29,26,3,2,1
11,222,222,1,1,0,1,0
16,251,251,43,33,10,2,1
6,254,254,6,1,5,2,1
17,266,266,13,1,12,2,1
8,321,321,68,25,43,2,1
19,332,332,37,23,14,2,1
2,332,332,9,1,8,2,1
12,333,333,43,43,0,1,0
22,348,348,18,4,14,3,2
10,363,363,19,19,0,1,0
0,375,375,34,26,8,3,2
20,402,402,124,112,12,4,3
1,408,408,1,1,0,1,0
24,410,410,9,9,0,1,0
3,419,419,103,103,0,1,0
18,422,422,48,5,43,2,1
14,462,462,19,19,0,1,0
9,473,473,12,12,0,1,0
23,480,480,23,23,0,1,0
21,494,494,23,5,18,3,2

2,129,129,25,1,24,2,1
15,161,161,9,9,0,1,0
14,161,161,8,8,0,1,0
20,168,168,2,2,0,1,0
18,183,183,1,1,0,1,0
22,190,190,2,2,0,1,0
0,218,218,45,23,22,3,2
13,221,221,26,26,0,1,0
7,231,231,1,1,0,1,0
9,243,243,10,10,0,1,0
5,282,282,44,14,30,4,3
17,285,285,27,27,0,1,0
19,287,287,91,46,45,4,3
23,312,312,28,10,18,2,1
8,318,318,51,33,18,3,2
4,322,322,21,2,19,2,1
1,362,362,46,28,18,4,3
6,369,369,6,6,0,1,0
12,374,374,53,53,0,1,0
11,380,380,22,22,0,1,0
3,383,383,16,13,3,2,1
21,449,449,91,42,49,4,3
16,456,456,56,56,0,1,0
10,480,480,63,59,4,2,1

19,139,139,1,1,0,1,0
11,170,170,2,2,0,1,0
3,170,170,6,6,0,1,0
7,182,182,54,54,0,1,0
16,214,214,106,99,7,2,1
22,219,219,18,10,8,3,2
0,237,237,18,18,0,1,0
6,258,258,24,1,23,4,3
15,264,264,24,24,0,1,0
23,309,309,24,6,18,3,2
2,314,314,43,14,29,2,1
21,317,317,3,3,0,1,0
24,336,336,42,9,33,2,1
26,349,349,12,12,0,1,0
25,352,352,29,21,8,3,2
12,374,374,21,7,14,3,2
4,392,392,13,13,0,1,0
9,419,419,13,13,0,1,0
5,440,440,5,5,0,1,0
1,445,445,73,3,70,3,2
20,455,455,17,17,0,1,0
18,457,457,46,12,34,2,1
14,461,461,43,12,31,2,1
17,471,471,36,36,0,1,0
8,487,487,29,29,0,1,0
13,493,493,27,27,0,1,0
10,495,495,24,20,4,2,1

13,109,109,21,9,12,3,2
17,111,111,31,6,25,3,2
26,116,116,41,41,0,1,0
10,118,118,14,14,0,1,0
23,124,124,9,9,0,1,0
20,131,131,8,8,0,1,0
25,133,133,11,11,0,1,0
4,141,141,20,20,0,1,0
18,144,144,17,9,8,2,1
5,147,147,2,2,0,1,0
6,157,157,1,1,0,1,0
12,161,161,7,7,0,1,0
14,183,183,21,21,0,1,0
16,192,192,15,15,0,1,0
3,196,196,13,13,0,1,0
27,220,220,15,15,0,1,0
2,238,238,33,9,24,3,2
11,251,251,9,3,6,2,1
0,258,258,30,23,7,2,1
9,326,326,4,4,0,1,0
15,361,361,20,6,14,2,1
22,376,376,3,3,0,1,0
24,411,411,15,15,0,1,0
7,416,416,13,1,12,3,2
19,453,453,9,9,0,1,0
8,466,466,31,17,14,3,2
1,487,487,23,9,14,3,2
21,493,493,31,11,20,2,1

6,104,104,3,3,0,1,0
17,117,117,7,3,4,2,1
2,122,122,17,17,0,1,0
16,134,134,26,1,25,2,1
0,155,155,1,1,0,1,0
15,157,157,12,12,0,1,0
5,168,168,11,11,0,1,0
1,199,199,1,1,0,1,0
10,237,237,11,11,0,1,0
24,241,241,48,40,8,2,1
4,247,247,1,1,0,1,0
3,262,262,49,8,41,2,1
21,284,284,33,33,0,1,0
14,291,291,24,24,0,1,0
22,293,293,27,24,3,2,1
20,335,335,22,7,15,2,1
7,346,346,9,5,4,2,1
12,350,350,1,1,0,1,0
18,354,354,30,6,24,2,1
11,364,364,14,3,11,3,2
9,365,365,31,31,0,1,0
8,372,372,38,35,3,2,1
19,376,376,44,44,0,1,0
25,428,428,58,53,5,2,1
23,443,443,3,3,0,1,0
13,452,452,210,66,144,4,3

7,132,132,35,11,24,4,3
16,134,134,5,5,0,1,0
9,152,152,20,4,16,2,1
15,153,153,3,3,0,1,0
1,159,159,4,1,3,2,1
8,169,169,25,25,0,1,0
21,175,175,13,13,0,1,0
20,188,188,42,42,0,1,0
3,206,206,20,20,0,1,0
4,214,214,6,3,3,2,1
23,255,255,58,4,54,3,2
2,255,255,2,2,0,1,0
12,263,263,4,4,0,1,0
26,275,275,22,22,0,1,0
18,285,285,105,105,0,1,0
14,292,292,8,8,0,1,0
22,296,296,1,1,0,1,0
6,311,311,52,16,36,2,1
24,335,335,23,13,10,3,2
13,336,336,19,10,9,4,3
25,350,350,27,27,0,1,0
11,371,371,11,3,8,3,2
5,385,385,17,11,6,2,1
17,396,396,15,15,0,1,0
19,440,440,9,9,0,1,0
10,458,458,13,13,0,1,0
27,491,491,4,4,0,1,0
0,497,497,56,14,42,4,3

3,127,127,11,2,9,4,3
18,139,139,30,30,0,1,0
4,140,140,5,5,0,1,0
2,154,154,1,1,0,1,0
8,154,154,58,58,0,1,0
17,168,168,16,4,12,3,2
16,169,169,2,2,0,1,0
6,185,185,4,1,3,2,1
7,217,217,31,31,0,1,0
13,326,326,17,17,0,1,0
10,351,351,40,40,0,1,0
9,351,351,93,93,0,1,0
14,395,395,60,20,40,2,1
11,403,403,35,35,0,1,0
15,405,405,22,5,17,2,1
19,420,420,1,1,0,1,0
20,424,424,68,68,0,1,0
5,439,439,21,1,20,3,2
0,440,440,36,36,0,1,0
22,452,452,4,1,3,2,1
1,472,472,11,5,6,2,1
21,482,482,89,79,10,3,2
12,499,499,101,4,97,4,3

37,106,106,10,10,0,1,0
31,137,137,6,2,4,2,1
22,148,148,16,16,0,1,0
21,151,151,2,2,0,1,0
3,154,154,1,1,0,1,0
29,156,156,9,9,0,1,0
4,158,158,9,9,0,1,0
7,170,170,14,10,4,2,1
32,208,208,20,5,15,4,3
5,233,233,12,12,0,1,0
14,235,235,19,19,0,1,0
15,251,251,3,3,0,1,0
33,252,252,78,28,50,3,2
36,254,254,45,40,5,2,1
20,265,265,2,2,0,1,0
12,267,267,6,6,0,1,0
18,271,271,9,9,0,1,0
25,289,289,7,7,0,1,0
23,301,301,22,16,6,3,2
0,335,335,9,3,6,2,1
26,336,336,13,3,10,2,1
24,347,347,1,1,0,1,0
8,350,350,49,49,0,1,0
19,362,362,18,18,0,1,0
1,368,368,16,16,0,1,0
6,382,382,34,6,28,3,2
27,385,385,2,2,0,1,0
30,397,397,62,62,0,1,0
28,402,402,1,1,0,1,0
9,415,415,37,22,15,4,3
2,417,417,30,30,0,1,0
11,422,422,15,15,0,1,0
13,424,424,3,3,0,1,0
10,429,429,21,21,0,1,0
17,466,466,4,4,0,1,0
35,491,491,47,8,39,2,1
16,498,498,9,9,0,1,0
34,500,500,77,3,74,4,3

19,114,114,5,5,0,1,0
21,159,159,4,4,0,1,0
11,188,188,1,1,0,1,0
7,220,220,41,1,40,2,1
1,241,241,28,16,12,2,1
13,253,253,82,38,44,2,1
15,263,263,32,32,0,1,0
3,264,264,20,20,0,1,0
12,265,265,55,28,27,4,3
6,295,295,4,1,3,2,1
9,296,296,38,38,0,1,0
0,298,298,62,59,3,2,1
14,314,314,11,2,9,4,3
10,331,331,37,4,33,4,3
18,338,338,22,22,0,1,0
16,421,421,11,5,6,2,1
20,429,429,69,52,17,2,1
8,448,448,61,14,47,2,1
4,460,460,47,26,21,4,3
17,462,462,45,45,0,1,0
2,491,491,67,18,49,3,2
5,493,493,49,22,27,4,3

4,100,100,17,17,0,1,0
3,102,102,4,4,0,1,0
14,110,110,10,10,0,1,0
8,128,128,13,13,0,1,0
12,155,155,13,13,0,1,0
5,163,163,15,15,0,1,0
22,186,186,78,78,0,1,0
15,197,197,6,6,0,1,0
17,217,217,7,1,6,3,2
10,223,223,43,14,29,2,1
7,229,229,15,6,9,2,1
11,238,238,24,24,0,1,0
16,259,259,13,13,0,1,0
21,272,272,76,64,12,3,2
18,310,310,3,3,0,1,0
19,343,343,36,36,0,1,0
0,374,374,67,15,52,4,3
6,390,390,8,8,0,1,0
2,393,393,32,32,0,1,0
9,399,399,57,57,0,1,0
1,408,408,48,9,39,4,3
20,413,413,1,1,0,1,0
13,430,430,10,10,0,1,0

14,142,142,11,7,4,2,1
5,143,143,1,1,0,1,0
15,151,151,21,21,0,1,0
16,177,177,15,15,0,1,0
7,185,185,1,1,0,1,0
13,197,197,10,10,0,1,0
9,223,223,11,11,0,1,0
2,266,266,52,29,23,3,2
20,266,266,14,14,0,1,0
21,279,279,5,5,0,1,0
19,282,282,1,1,0,1,0
4,297,297,10,10,0,1,0
6,314,314,11,11,0,1,0
17,339,339,12,12,0,1,0
10,361,361,46,46,0,1,0
0,372,372,74,74,0,1,0
8,374,374,12,12,0,1,0
11,415,415,18,18,0,1,0
1,455,455,250,234,16,3,2
12,465,465,136,136,0,1,0
3,475,475,46,38,8,2,1
18,498,498,148,148,0,1,0

17,132,132,9,9,0,1,0
0,134,134,2,2,0,1,0
18,157,157,9,6,3,2,1
12,162,162,10,1,9,2,1
5,167,167,42,42,0,1,0
22,168,168,30,30,0,1,0
23,219,219,35,9,26,2,1
1,224,224,1,1,0,1,0
3,231,231,9,9,0,1,0
14,243,243,39,39,0,1,0
29,250,250,19,6,13,3,2
15,257,257,10,4,6,3,2
16,277,277,22,22,0,1,0
24,294,294,41,8,33,2,1
28,313,313,52,2,50,4,3
20,320,320,4,4,0,1,0
2,327,327,33,33,0,1,0
26,327,327,37,9,28,2,1
9,349,349,15,15,0,1,0
6,369,369,36,36,0,1,0
27,377,377,22,22,0,1,0
21,377,377,4,4,0,1,0
30,390,390,95,88,7,2,1
25,402,402,16,16,0,1,0
19,409,409,9,5,4,2,1
11,414,414,11,11,0,1,0
7,432,432,28,28,0,1,0
8,443,443,21,4,17,2,1
10,471,471,4,4,0,1,0
13,479,479,12,12,0,1,0
4,484,484,5,1,4,2,1

1,106,106,38,38,0,1,0
20,108,108,7,2,5,2,1
16,118,118,12,12,0,1,0
9,162,162,35,35,0,1,0
10,177,177,1,1,0,1,0
0,188,188,26,26,0,1,0
14,189,189,22,22,0,1,0
2,266,266,16,16,0,1,0
8,268,268,45,45,0,1,0
15,314,314,16,16,0,1,0
19,322,322,43,43,0,1,0
5,346,346,18,3,15,4,3
11,354,354,86,38,48,3,2
3,356,356,1,1,0,1,0
17,358,358,1,1,0,1,0
4,422,422,60,60,0,1,0
12,434,434,5,2,3,2,1
18,442,442,7,1,6,2,1
6,474,474,15,1,14,2,1
21,478,478,110,110,0,1,0
7,485,485,16,16,0,1,0
13,493,493,124,38,86,4,3

21,144,144,21,21,0,1,0
17,145,145,1,1,0,1,0
1,166,166,3,3,0,1,0
22,167,167,13,13,0,1,0
9,182,182,16,16,0,1,0
20,213,213,25,11,14,2,1
19,214,214,12,12,0,1,0
12,230,230,2,2,0,1,0
10,246,246,1,1,0,1,0
23,251,251,2,2,0,1,0
7,257,257,11,6,5,2,1
16,261,261,85,4,81,4,3
5,262,262,1,1,0,1,0
6,312,312,91,47,44,3,2
3,314,314,166,102,64,4,3
4,330,330,27,27,0,1,0
2,364,364,7,7,0,1,0
0,372,372,23,5,18,4,3
15,394,394,83,75,8,2,1
18,402,402,1,1,0,1,0
14,423,423,23,5,18,3,2
8,428,428,5,5,0,1,0
11,472,472,23,4,19,2,1
13,487,487,102,102,0,1,0

33,104,104,26,26,0,1,0
25,106,106,4,4,0,1,0
17,111,111,13,5,8,2,1
26,123,123,5,5,0,1,0
24,123,123,38,1,37,2,1
18,128,128,5,5,0,1,0
19,135,135,9,9,0,1,0
32,147,147,19,1,18,2,1
23,149,149,11,11,0,1,0
5,170,170,2,2,0,1,0
35,173,173,6,6,0,1,0
2,194,194,16,5,11,2,1
14,194,194,4,4,0,1,0
28,213,213,38,4,34,3,2
10,220,220,4,4,0,1,0
22,225,225,12,2,10,3,2
7,240,240,2,2,0,1,0
8,256,256,1,1,0,1,0
4,263,263,18,18,0,1,0
15,271,271,1,1,0,1,0
20,272,272,27,27,0,1,0
27,281,281,4,4,0,1,0
29,313,313,27,27,0,1,0
16,318,318,14,14,0,1,0
21,327,327,50,7,43,2,1
13,331,331,3,3,0,1,0
6,359,359,11,3,8,2,1
9,363,363,11,4,7,2,1
11,377,377,25,11,14,3,2
12,406,406,8,8,0,1,0
31,407,407,37,24,13,2,1
3,432,432,28,28,0,1,0
34,438,438,16,10,6,3,2
1,463,463,51,51,0,1,0
0,465,465,5,5,0,1,0
30,496,496,9,9,0,1,0

19,103,103,1,1,0,1,0
1,104,104,1,1,0,1,0
6,112,112,17,3,14,2,1
9,114,114,18,9,9,4,3
23,118,118,18,13,5,2,1
25,119,119,34,19,15,2,1
21,124,124,4,4,0,1,0
12,138,138,3,3,0,1,0
2,163,163,2,2,0,1,0
11,164,164,14,7,7,2,1
5,195,195,24,24,0,1,0
7,224,224,14,14,0,1,0
13,227,227,19,3,16,2,1
14,229,229,77,35,42,2,1
10,231,231,23,23,0,1,0
18,239,239,2,2,0,1,0
17,256,256,13,13,0,1,0
15,264,264,12,3,9,4,3
22,299,299,13,5,8,2,1
20,331,331,57,50,7,2,1
3,331,331,3,3,0,1,0
24,351,351,22,22,0,1,0
8,376,376,129,93,36,4,3
16,422,422,14,14,0,1,0
0,460,460,16,16,0,1,0
4,478,478,3,3,0,1,0

15,106,106,3,3,0,1,0
7,110,110,11,1,10,3,2
3,111,111,10,10,0,1,0
0,128,128,24,8,16,2,1
24,134,134,3,3,0,1,0
6,142,142,5,5,0,1,0
26,156,156,1,1,0,1,0
9,162,162,6,6,0,1,0
16,194,194,3,3,0,1,0
21,208,208,25,25,0,1,0
12,234,234,3,3,0,1,0
8,242,242,29,18,11,2,1
2,277,277,16,16,0,1,0
19,278,278,6,6,0,1,0
22,278,278,1,1,0,1,0
27,293,293,25,25,0,1,0
20,364,364,18,8,10,3,2
18,402,402,14,14,0,1,0
10,406,406,2,2,0,1,0
4,418,418,40,1,39,2,1
25,423,423,315,295,20,2,1
13,436,436,26,26,0,1,0
11,442,442,46,46,0,1,0
23,459,459,17,17,0,1,0
1,462,462,50,24,26,2,1
14,468,468,65,8,57,3,2
5,479,479,11,11,0,1,0
17,489,489,38,18,20,2,1

24,114,114,22,22,0,1,0
6,121,121,4,4,0,1,0
15,122,122,7,7,0,1,0
25,143,143,9,9,0,1,0
4,188,188,13,7,6,3,2
8,200,200,6,6,0,1,0
28,220,220,9,3,6,2,1
17,227,227,5,5,0,1,0
16,233,233,13,13,0,1,0
19,235,235,10,3,7,3,2
0,242,242,1,1,0,1,0
5,277,277,11,4,7,2,1
9,303,303,5,5,0,1,0
20,325,325,24,24,0,1,0
23,337,337,35,35,0,1,0
2,342,342,74,32,42,2,1
12,357,357,34,34,0,1,0
29,362,362,3,3,0,1,0
13,369,369,109,74,35,2,1
10,374,374,18,18,0,1,0
22,375,375,22,11,11,2,1
26,394,394,104,88,16,3,2
14,400,400,1,1,0,1,0
3,402,402,27,27,0,1,0
11,419,419,54,54,0,1,0
18,432,432,10,10,0,1,0
21,472,472,126,108,18,2,1
7,476,476,1,1,0,1,0
1,484,484,10,10,0,1,0
27,497,497,44,14,30,4,3

4,107,107,32,18,14,2,1
17,111,111,5,5,0,1,0
15,131,131,4,1,3,2,1
21,154,154,22,13,9,2,1
9,155,155,16,8,8,2,1
14,158,158,5,5,0,1,0
11,171,171,25,25,0,1,0
3,178,178,23,23,0,1,0
13,206,206,11,2,9,4,3
16,226,226,38,18,20,2,1
2,230,230,9,9,0,1,0
18,254,254,15,15,0,1,0
8,284,284,24,12,12,3,2
1,296,296,4,4,0,1,0
6,319,319,16,11,5,2,1
0,349,349,10,10,0,1,0
7,424,424,139,79,60,4,3
20,454,454,62,47,15,3,2
10,465,465,14,14,0,1,0
5,469,469,61,49,12,4,3
19,492,492,21,21,0,1,0
12,500,500,172,129,43,2,1

15,118,118,6,6,0,1,0
2,145,145,17,17,0,1,0
22,159,159,1,1,0,1,0
5,179,179,78,78,0,1,0
18,179,179,40,40,0,1,0
23,201,201,9,9,0,1,0
12,206,206,11,11,0,1,0
17,215,215,5,5,0,1,0
4,227,227,32,32,0,1,0
9,231,231,1,1,0,1,0
13,233,233,38,11,27,2,1
19,245,245,29,29,0,1,0
20,273,273,13,1,12,2,1
14,283,283,43,5,38,3,2
21,302,302,41,41,0,1,0
1,348,348,48,28,20,4,3
0,364,364,35,1,34,2,1
8,386,386,18,18,0,1,0
11,429,429,4,4,0,1,0
10,478,478,17,2,15,4,3
3,487,487,3,3,0,1,0
16,495,495,103,6,97,4,3
7,495,495,38,38,0,1,0
6,497,497,47,2,45,4,3

10,125,125,1,1,0,1,0
7,130,130,18,7,11,4,3
14,147,147,8,8,0,1,0
3,157,157,2,2,0,1,0
22,164,164,3,3,0,1,0
4,178,178,6,3,3,2,1
5,193,193,4,4,0,1,0
9,199,199,10,1,9,2,1
17,210,210,34,25,9,4,3
0,214,214,7,7,0,1,0
24,229,229,7,7,0,1,0
25,264,264,30,6,24,3,2
28,269,269,61,43,18,3,2
18,283,283,6,3,3,2,1
6,317,317,11,2,9,2,1
16,330,330,2,2,0,1,0
8,332,332,7,7,0,1,0
1,337,337,19,19,0,1,0
27,353,353,2,2,0,1,0
26,364,364,146,85,61,3,2
19,372,372,25,5,20,3,2
12,395,395,112,112,0,1,0
20,417,417,66,66,0,1,0
13,427,427,56,8,48,3,2
23,439,439,3,3,0,1,0
15,444,444,108,108,0,1,0
2,447,447,12,12,0,1,0
11,471,471,22,22,0,1,0
21,489,489,3,3,0,1,0

12,102,102,12,12,0,1,0
6,106,106,23,14,9,4,3
18,122,122,9,6,3,2,1
13,140,140,33,20,13,2,1
19,144,144,5,5,0,1,0
2,196,196,21,21,0,1,0
20,202,202,10,10,0,1,0
17,215,215,40,40,0,1,0
14,232,232,4,4,0,1,0
15,250,250,29,29,0,1,0
1,260,260,25,25,0,1,0
16,275,275,26,26,0,1,0
7,328,328,157,101,56,4,3
21,343,343,54,54,0,1,0
8,346,346,19,19,0,1,0
4,366,366,23,23,0,1,0
10,382,382,33,33,0,1,0
5,420,420,1,1,0,1,0
3,434,434,4,4,0,1,0
0,443,443,27,27,0,1,0
11,457,457,28,28,0,1,0
9,483,483,54,19,35,2,1

0,134,134,1,1,0,1,0
5,134,134,2,2,0,1,0
15,159,159,16,16,0,1,0
11,181,181,2,2,0,1,0
13,193,193,35,35,0,1,0
1,217,217,15,6,9,2,1
19,219,219,77,35,42,3,2
17,237,237,43,43,0,1,0
10,267,267,19,19,0,1,0
14,281,281,33,33,0,1,0
8,292,292,49,1,48,3,2
20,323,323,1,1,0,1,0
18,326,326,9,9,0,1,0
12,343,343,51,51,0,1,0
9,345,345,31,26,5,2,1
2,357,357,1,1,0,1,0
4,371,371,157,157,0,1,0
7,391,391,115,115,0,1,0
16,417,417,7,7,0,1,0
3,422,422,15,11,4,2,1
21,463,463,7,7,0,1,0
6,487,487,47,47,0,1,0

16,114,114,6,6,0,1,0
6,120,120,18,18,0,1,0
12,166,166,12,12,0,1,0
11,170,170,3,3,0,1,0
23,195,195,13,7,6,3,2
20,207,207,8,8,0,1,0
21,207,207,90,45,45,4,3
13,213,213,42,27,15,2,1
1,217,217,1,1,0,1,0
10,220,220,57,3,54,4,3
17,227,227,4,4,0,1,0
9,244,244,1,1,0,1,0
14,258,258,3,3,0,1,0
19,301,301,7,7,0,1,0
15,304,304,43,43,0,1,0
22,317,317,14,14,0,1,0
0,332,332,19,14,5,2,1
25,350,350,29,29,0,1,0
5,365,365,92,29,63,4,3
4,367,367,10,1,9,2,1
26,390,390,4,1,3,2,1
8,393,393,22,22,0,1,0
7,400,400,14,14,0,1,0
24,418,418,52,4,48,3,2
3,434,434,2,2,0,1,0
2,480,480,26,6,20,3,2
18,500,500,91,91,0,1,0

11,122,122,6,1,5,2,1
3,132,132,27,3,24,4,3
1,144,144,3,3,0,1,0
2,145,145,22,11,11,2,1
8,145,145,10,10,0,1,0
10,190,190,24,2,22,3,2
18,195,195,25,4,21,4,3
4,203,203,7,7,0,1,0
19,207,207,4,4,0,1,0
21,231,231,12,8,4,2,1
23,233,233,51,51,0,1,0
0,238,238,11,3,8,2,1
14,258,258,14,14,0,1,0
9,267,267,48,30,18,2,1
6,326,326,100,100,0,1,0
12,344,344,76,20,56,3,2
15,353,353,6,6,0,1,0
5,387,387,4,1,3,2,1
17,392,392,10,10,0,1,0
16,396,396,41,32,9,4,3
20,449,449,7,2,5,2,1
13,470,470,70,62,8,3,2
22,481,481,105,37,68,4,3
7,490,490,3,3,0,1,0

5,102,102,5,5,0,1,0
9,108,108,13,7,6,3,2
10,126,126,14,1,13,3,2
7,148,148,50,50,0,1,0
16,154,154,2,2,0,1,0
13,185,185,62,62,0,1,0
1,193,193,48,10,38,3,2
12,214,214,13,13,0,1,0
15,229,229,10,10,0,1,0
2,235,235,1,1,0,1,0
20,242,242,3,3,0,1,0
8,245,245,3,3,0,1,0
17,281,281,41,41,0,1,0
4,312,312,21,5,16,3,2
11,321,321,12,12,0,1,0
14,336,336,11,11,0,1,0
6,373,373,89,79,10,3,2
0,386,386,45,45,0,1,0
18,407,407,3,3,0,1,0
19,410,410,164,133,31,2,1
3,456,456,3,3,0,1,0
21,482,482,11,1,10,3,2

13,109,109,17,17,0,1,0
24,121,121,8,5,3,2,1
20,142,142,26,26,0,1,0
8,143,143,9,9,0,1,0
15,150,150,5,5,0,1,0
10,174,174,15,7,8,3,2
6,188,188,6,6,0,1,0
16,196,196,38,38,0,1,0
0,214,214,14,2,12,2,1
25,247,247,29,3,26,2,1
1,248,248,54,54,0,1,0
17,257,257,18,18,0,1,0
7,273,273,8,3,5,2,1
19,274,274,6,6,0,1,0
21,313,313,37,37,0,1,0
18,324,324,12,7,5,2,1
4,370,370,117,77,40,3,2
9,415,415,24,24,0,1,0
14,416,416,30,30,0,1,0
5,417,417,15,15,0,1,0
23,429,429,120,50,70,4,3
2,442,442,4,4,0,1,0
11,464,464,35,35,0,1,0
22,475,475,12,6,6,3,2
3,480,480,27,27,0,1,0
12,487,487,3,3,0,1,0

12,124,124,15,15,0,1,0
20,165,165,10,10,0,1,0
14,173,173,13,1,12,3,2
8,180,180,1,1,0,1,0
11,196,196,20,8,12,4,3
5,234,234,48,33,15,2,1
18,285,285,23,5,18,3,2
22,291,291,5,5,0,1,0
23,306,306,24,10,14,2,1
10,310,310,1,1,0,1,0
3,324,324,42,42,0,1,0
0,364,364,37,37,0,1,0
2,365,365,13,4,9,4,3
4,371,371,54,54,0,1,0
17,381,381,5,5,0,1,0
16,381,381,8,8,0,1,0
7,393,393,90,51,39,4,3
24,415,415,40,19,21,4,3
6,432,432,6,6,0,1,0
21,465,465,172,76,96,3,2
9,472,472,32,8,24,4,3
13,478,478,33,33,0,1,0
15,479,479,75,75,0,1,0
19,484,484,90,54,36,3,2
1,500,500,22,22,0,1,0

10,104,104,3,3,0,1,0
16,112,112,6,6,0,1,0
20,151,151,12,12,0,1,0
7,151,151,7,7,0,1,0
18,198,198,54,32,22,3,2
0,200,200,72,72,0,1,0
12,205,205,16,16,0,1,0
13,243,243,16,16,0,1,0
3,258,258,21,21,0,1,0
9,269,269,24,19,5,2,1
15,360,360,48,48,0,1,0
14,387,387,9,3,6,2,1
4,402,402,60,22,38,3,2
17,415,415,35,14,21,2,1
19,425,425,8,8,0,1,0
11,428,428,125,80,45,2,1
6,442,442,5,2,3,2,1
5,445,445,58,58,0,1,0
1,449,449,49,1,48,2,1
2,453,453,38,11,27,2,1
8,485,485,111,111,0,1,0

18,119,119,11,1,10,2,1
0,127,127,33,15,18,3,2
25,142,142,37,37,0,1,0
22,168,168,24,24,0,1,0
9,177,177,2,2,0,1,0
15,240,240,21,4,17,2,1
19,261,261,12,12,0,1,0
6,264,264,26,17,9,4,3
16,292,292,55,45,10,3,2
7,296,296,60,60,0,1,0
23,322,322,26,26,0,1,0
13,325,325,2,2,0,1,0
11,327,327,2,2,0,1,0
5,346,346,10,4,6,3,2
2,370,370,12,12,0,1,0
14,391,391,3,3,0,1,0
12,393,393,11,11,0,1,0
21,393,393,40,40,0,1,0
4,397,397,85,58,27,2,1
24,414,414,15,3,12,2,1
10,435,435,6,2,4,2,1
1,435,435,18,18,0,1,0
20,447,447,41,13,28,4,3
8,454,454,117,31,86,3,2
3,476,476,1,1,0,1,0
17,490,490,39,5,34,3,2

12,102,102,3,3,0,1,0
15,114,114,2,2,0,1,0
28,124,124,22,22,0,1,0
0,131,131,18,3,15,4,3
6,138,138,11,11,0,1,0
17,145,145,19,5,14,2,1
22,150,150,1,1,0,1,0
27,153,153,22,22,0,1,0
25,187,187,3,3,0,1,0
23,190,190,3,3,0,1,0
20,209,209,55,55,0,1,0
24,210,210,3,3,0,1,0
30,212,212,12,12,0,1,0
3,237,237,3,3,0,1,0
2,244,244,1,1,0,1,0
7,268,268,2,2,0,1,0
8,292,292,3,3,0,1,0
11,308,308,11,6,5,2,1
5,310,310,1,1,0,1,0
18,323,323,6,6,0,1,0
14,323,323,62,53,9,2,1
1,342,342,5,5,0,1,0
19,354,354,45,15,30,4,3
21,391,391,2,2,0,1,0
13,415,415,90,90,0,1,0
10,425,425,106,97,9,4,3
4,442,442,11,4,7,2,1
26,450,450,58,27,31,4,3
29,480,480,131,131,0,1,0
9,492,492,6,6,0,1,0
16,498,498,2,2,0,1,0

15,116,116,9,9,0,1,0
9,145,145,2,2,0,1,0
12,198,198,4,4,0,1,0
6,199,199,21,11,10,3,2
11,231,231,8,1,7,2,1
3,248,248,10,10,0,1,0
2,281,281,38,18,20,3,2
10,294,294,42,42,0,1,0
0,308,308,70,34,36,2,1
5,323,323,88,48,40,2,1
8,367,367,126,126,0,1,0
14,371,371,10,10,0,1,0
7,401,401,23,9,14,2,1
17,402,402,46,46,0,1,0
4,418,418,179,176,3,2,1
13,427,427,62,62,0,1,0
16,427,427,58,58,0,1,0
1,432,432,42,42,0,1,0

9,102,102,9,9,0,1,0
20,126,126,22,22,0,1,0
12,132,132,2,2,0,1,0
3,136,136,18,18,0,1,0
5,158,158,37,3,34,3,2
19,165,165,41,10,31,2,1
2,169,169,43,43,0,1,0
8,176,176,44,16,28,2,1
14,178,178,28,28,0,1,0
10,222,222,18,18,0,1,0
11,267,267,28,28,0,1,0
6,276,276,12,7,5,2,1
15,281,281,16,2,14,3,2
18,375,375,5,5,0,1,0
13,381,381,18,18,0,1,0
16,411,411,20,6,14,2,1
1,417,417,14,14,0,1,0
7,420,420,26,26,0,1,0
4,460,460,27,27,0,1,0
17,464,464,86,77,9,4,3
0,488,488,66,66,0,1,0

8,118,118,14,14,0,1,0
9,118,118,10,10,0,1,0
17,130,130,4,4,0,1,0
28,134,134,41,41,0,1,0
3,154,154,9,9,0,1,0
10,155,155,5,5,0,1,0
29,177,177,2,2,0,1,0
11,180,180,3,3,0,1,0
27,186,186,3,3,0,1,0
5,213,213,9,3,6,2,1
13,225,225,48,33,15,2,1
24,261,261,2,2,0,1,0
26,271,271,42,33,9,4,3
20,278,278,19,13,6,3,2
7,287,287,6,6,0,1,0
12,293,293,4,4,0,1,0
30,307,307,13,7,6,3,2
1,312,312,12,12,0,1,0
16,325,325,2,2,0,1,0
14,332,332,27,27,0,1,0
6,336,336,53,53,0,1,0
19,346,346,17,11,6,3,2
21,360,360,99,9,90,3,2
15,361,361,2,2,0,1,0
18,366,366,14,14,0,1,0
23,368,368,13,13,0,1,0
25,375,375,24,24,0,1,0
2,415,415,36,36,0,1,0
31,425,425,42,42,0,1,0
4,439,439,7,7,0,1,0
0,479,479,43,21,22,2,1
22,494,494,69,41,28,2,1

21,147,147,34,14,20,3,2
20,177,177,22,22,0,1,0
18,186,186,39,39,0,1,0
4,231,231,35,23,12,3,2
8,237,237,2,2,0,1,0
23,237,237,53,34,19,2,1
16,288,288,25,5,20,3,2
12,327,327,13,4,9,2,1
17,329,329,19,19,0,1,0
5,333,333,16,16,0,1,0
13,338,338,7,7,0,1,0
14,350,350,14,10,4,2,1
11,359,359,76,38,38,3,2
22,362,362,24,24,0,1,0
15,369,369,22,22,0,1,0
7,416,416,106,36,70,3,2
3,423,423,99,68,31,2,1
19,435,435,28,4,24,4,3
6,448,448,24,24,0,1,0
9,454,454,21,21,0,1,0
2,475,475,2,2,0,1,0
0,477,477,66,66,0,1,0
1,485,485,17,5,12,3,2
10,498,498,7,7,0,1,0

19,109,109,6,2,4,2,1
22,170,170,9,9,0,1,0
10,170,170,4,4,0,1,0
9,189,189,5,5,0,1,0
21,190,190,18,18,0,1,0
6,199,199,30,30,0,1,0
0,223,223,31,31,0,1,0
17,224,224,2,2,0,1,0
11,244,244,10,10,0,1,0
1,269,269,50,43,7,2,1
8,270,270,7,1,6,3,2
18,270,270,5,5,0,1,0
3,289,289,13,5,8,3,2
5,290,290,58,13,45,4,3
16,335,335,18,8,10,2,1
15,337,337,83,50,33,4,3
4,340,340,5,5,0,1,0
23,349,349,41,41,0,1,0
20,360,360,19,19,0,1,0
7,373,373,47,34,13,2,1
12,381,381,57,57,0,1,0
14,383,383,46,5,41,2,1
13,408,408,105,105,0,1,0
2,475,475,106,58,48,3,2

2,127,127,3,3,0,1,0
10,144,144,5,5,0,1,0
19,179,179,15,6,9,4,3
8,186,186,6,6,0,1,0
11,187,187,22,13,9,4,3
14,201,201,4,4,0,1,0
1,211,211,5,5,0,1,0
6,242,242,2,2,0,1,0
26,247,247,26,26,0,1,0
4,251,251,6,1,5,2,1
18,269,269,22,14,8,2,1
15,282,282,31,31,0,1,0
3,285,285,14,10,4,2,1
13,312,312,3,3,0,1,0
31,326,326,28,28,0,1,0
33,332,332,72,72,0,1,0
22,333,333,10,10,0,1,0
30,335,335,47,47,0,1,0
17,341,341,2,2,0,1,0
0,348,348,5,5,0,1,0
25,356,356,22,4,18,3,2
27,371,371,61,45,16,3,2
21,373,373,15,15,0,1,0
20,373,373,39,18,21,2,1
28,400,400,12,12,0,1,0
23,412,412,2,2,0,1,0
12,424,424,2,2,0,1,0
9,424,424,21,5,16,2,1
29,437,437,20,20,0,1,0
5,456,456,63,63,0,1,0
24,492,492,85,22,63,4,3
16,498,498,67,7,60,4,3
7,498,498,46,46,0,1,0
32,499,499,80,15,65,4,3

9,103,103,12,12,0,1,0
17,116,116,9,5,4,2,1
14,118,118,4,4,0,1,0
4,134,134,15,2,13,2,1
12,221,221,51,51,0,1,0
6,236,236,11,11,0,1,0
2,243,243,98,78,20,3,2
7,270,270,7,7,0,1,0
5,277,277,1,1,0,1,0
15,287,287,15,9,6,3,2
16,301,301,32,20,12,4,3
13,376,376,45,45,0,1,0
18,391,391,5,1,4,2,1
8,399,399,30,30,0,1,0
1,431,431,78,44,34,3,2
10,458,458,110,10,100,3,2
11,474,474,69,40,29,4,3
0,493,493,17,17,0,1,0
3,495,495,209,209,0,1,0

4,121,121,1,1,0,1,0
15,124,124,5,5,0,1,0
26,125,125,7,7,0,1,0
0,158,158,11,1,10,3,2
25,160,160,45,24,21,2,1
9,182,182,1,1,0,1,0
5,187,187,29,7,22,2,1
3,190,190,1,1,0,1,0
19,203,203,4,4,0,1,0
8,220,220,29,6,23,4,3
24,242,242,2,2,0,1,0
7,244,244,11,11,0,1,0
1,249,249,8,8,0,1,0
6,254,254,12,12,0,1,0
13,255,255,27,27,0,1,0
21,280,280,111,45,66,4,3
10,291,291,41,31,10,3,2
14,326,326,58,58,0,1,0
16,337,337,20,20,0,1,0
12,352,352,37,37,0,1,0
2,358,358,20,20,0,1,0
23,378,378,24,8,16,2,1
17,393,393,13,13,0,1,0
22,393,393,24,3,21,3,2
20,413,413,37,37,0,1,0
11,436,436,50,5,45,3,2
18,500,500,58,49,9,4,3

0,121,121,21,21,0,1,0
9,127,127,3,3,0,1,0
5,128,128,8,2,6,2,1
20,135,135,34,14,20,3,2
10,202,202,13,13,0,1,0
4,204,204,6,6,0,1,0
13,207,207,47,13,34,3,2
21,244,244,34,34,0,1,0
19,248,248,13,13,0,1,0
1,258,258,15,1,14,3,2
18,263,263,7,7,0,1,0
6,284,284,117,81,36,4,3
16,323,323,30,27,3,2,1
7,329,329,20,5,15,4,3
12,350,350,20,13,7,2,1
14,356,356,51,18,33,4,3
17,387,387,1,1,0,1,0
3,390,390,89,14,75,4,3
8,393,393,32,20,12,4,3
15,416,416,18,3,15,3,2
2,442,442,33,7,26,2,1
11,488,488,56,56,0,1,0

11,111,111,1,1,0,1,0
13,129,129,1,1,0,1,0
6,145,145,8,8,0,1,0
17,145,145,36,15,21,4,3
8,186,186,1,1,0,1,0
18,217,217,20,20,0,1,0
1,220,220,2,2,0,1,0
2,223,223,140,53,87,4,3
16,232,232,43,36,7,2,1
21,245,245,17,17,0,1,0
4,260,260,10,10,0,1,0
20,265,265,16,8,8,2,1
10,276,276,48,48,0,1,0
23,354,354,26,26,0,1,0
24,371,371,71,3,68,3,2
7,403,403,13,13,0,1,0
0,419,419,1,1,0,1,0
22,424,424,53,27,26,3,2
12,429,429,2,2,0,1,0
15,449,449,18,18,0,1,0
5,457,457,63,18,45,4,3
9,466,466,23,23,0,1,0
19,473,473,4,4,0,1,0
3,488,488,27,27,0,1,0
14,497,497,59,20,39,4,3

19,129,129,15,15,0,1,0
17,158,158,4,4,0,1,0
4,186,186,9,9,0,1,0
15,243,243,43,1,42,4,3
16,259,259,40,25,15,4,3
18,263,263,37,37,0,1,0
21,311,311,1,1,0,1,0
12,319,319,21,21,0,1,0
8,332,332,146,131,15,4,3
3,352,352,20,20,0,1,0
11,356,356,59,29,30,4,3
2,359,359,67,67,0,1,0
20,384,384,10,10,0,1,0
0,386,386,8,8,0,1,0
10,396,396,47,5,42,4,3
6,411,411,6,6,0,1,0
9,422,422,109,109,0,1,0
7,429,429,2,2,0,1,0
14,437,437,78,40,38,2,1
1,449,449,22,4,18,4,3
13,462,462,23,23,0,1,0
5,487,487,60,17,43,2,1

7,125,125,7,7,0,1,0
11,126,126,4,1,3,2,1
19,144,144,9,1,8,2,1
24,150,150,17,17,0,1,0
4,152,152,8,1,7,2,1
21,153,153,34,34,0,1,0
15,172,172,50,50,0,1,0
5,189,189,22,7,15,3,2
18,199,199,17,17,0,1,0
1,214,214,3,3,0,1,0
22,246,246,11,11,0,1,0
12,262,262,20,20,0,1,0
6,264,264,1,1,0,1,0
20,271,271,15,15,0,1,0
8,294,294,2,2,0,1,0
23,322,322,34,5,29,2,1
14,336,336,28,28,0,1,0
17,351,351,9,9,0,1,0
10,389,389,158,118,40,4,3
2,411,411,73,73,0,1,0
3,414,414,1,1,0,1,0
0,426,426,25,25,0,1,0
13,439,439,56,56,0,1,0
9,442,442,31,19,12,3,2
16,486,486,49,38,11,2,1
25,493,493,20,20,0,1,0

16,104,104,21,15,6,3,2
10,128,128,13,9,4,2,1
20,160,160,18,18,0,1,0
24,207,207,25,25,0,1,0
3,230,230,1,1,0,1,0
6,239,239,37,10,27,2,1
26,240,240,11,11,0,1,0
22,242,242,17,1,16,2,1
18,251,251,38,11,27,4,3
14,269,269,3,3,0,1,0
12,275,275,9,9,0,1,0
27,278,278,42,16,26,2,1
21,282,282,36,22,14,3,2
17,306,306,15,15,0,1,0
1,307,307,22,22,0,1,0
15,317,317,88,68,20,2,1
13,338,338,35,26,9,2,1
11,341,341,25,25,0,1,0
4,354,354,6,6,0,1,0
8,366,366,20,7,13,3,2
7,404,404,10,1,9,4,3
0,420,420,61,61,0,1,0
23,426,426,61,61,0,1,0
5,433,433,3,3,0,1,0
2,439,439,47,47,0,1,0
19,481,481,1,1,0,1,0
25,481,481,24,24,0,1,0
9,486,486,7,2,5,2,1

22,114,114,53,53,0,1,0
11,144,144,2,2,0,1,0
21,158,158,13,2,11,2,1
4,171,171,5,5,0,1,0
5,186,186,9,3,6,2,1
9,206,206,96,96,0,1,0
18,208,208,19,19,0,1,0
17,243,243,8,8,0,1,0
19,255,255,22,22,0,1,0
1,260,260,4,4,0,1,0
6,267,267,4,4,0,1,0
12,268,268,12,3,9,4,3
2,292,292,1,1,0,1,0
16,328,328,10,10,0,1,0
26,355,355,24,6,18,4,3
10,387,387,14,14,0,1,0
8,388,388,34,4,30,4,3
13,396,396,10,10,0,1,0
25,408,408,59,22,37,2,1
23,421,421,3,3,0,1,0
14,455,455,15,6,9,2,1
7,473,473,72,45,27,4,3
15,475,475,33,33,0,1,0
24,475,475,21,21,0,1,0
0,476,476,76,12,64,4,3
20,477,477,49,7,42,2,1
3,480,480,34,34,0,1,0

15,149,149,13,13,0,1,0
12,163,163,1,1,0,1,0
16,173,173,28,28,0,1,0
13,181,181,17,17,0,1,0
25,183,183,47,29,18,4,3
0,213,213,9,5,4,2,1
3,225,225,5,5,0,1,0
18,228,228,54,16,38,3,2
9,241,241,30,15,15,2,1
24,290,290,1,1,0,1,0
19,290,290,27,15,12,3,2
20,304,304,4,4,0,1,0
17,332,332,18,18,0,1,0
10,339,339,15,7,8,3,2
7,350,350,21,21,0,1,0
6,359,359,46,6,40,3,2
14,363,363,23,1,22,3,2
5,368,368,15,1,14,2,1
1,370,370,38,38,0,1,0
23,381,381,32,32,0,1,0
22,440,440,41,41,0,1,0
2,440,440,37,21,16,3,2
21,442,442,33,33,0,1,0
8,461,461,71,19,52,3,2
11,464,464,115,73,42,3,2
4,474,474,24,24,0,1,0

10,112,112,27,2,25,2,1
15,113,113,5,5,0,1,0
20,166,166,6,3,3,2,1
17,180,180,8,8,0,1,0
3,212,212,21,21,0,1,0
19,213,213,81,81,0,1,0
16,227,227,7,7,0,1,0
13,248,248,14,14,0,1,0
0,258,258,22,22,0,1,0
12,293,293,66,52,14,3,2
18,308,308,6,3,3,2,1
2,328,328,11,3,8,3,2
11,338,338,41,7,34,3,2
9,353,353,33,21,12,4,3
6,402,402,37,5,32,2,1
21,412,412,7,7,0,1,0
8,414,414,146,128,18,4,3
7,414,414,1,1,0,1,0
5,416,416,144,126,18,4,3
1,451,451,43,13,30,3,2
4,470,470,1,1,0,1,0
14,473,473,5,5,0,1,0

18,124,124,12,12,0,1,0
16,145,145,12,12,0,1,0
26,169,169,4,4,0,1,0
22,178,178,12,12,0,1,0
10,191,191,6,6,0,1,0
15,197,197,1,1,0,1,0
0,197,197,15,1,14,3,2
32,225,225,7,7,0,1,0
31,232,232,26,14,12,2,1
17,236,236,8,8,0,1,0
33,237,237,27,16,11,2,1
19,253,253,12,12,0,1,0
29,254,254,7,7,0,1,0
23,254,254,36,36,0,1,0
30,259,259,41,41,0,1,0
5,278,278,23,23,0,1,0
3,324,324,1,1,0,1,0
24,326,326,38,8,30,2,1
25,330,330,27,3,24,4,3
28,331,331,35,4,31,2,1
13,353,353,20,2,18,4,3
12,366,366,26,1,25,2,1
2,410,410,22,22,0,1,0
27,410,410,98,20,78,4,3
4,414,414,6,1,5,2,1
14,422,422,18,4,14,3,2
20,437,437,27,2,25,2,1
1,438,438,92,78,14,3,2
21,440,440,36,36,0,1,0
7,443,443,9,3,6,2,1
9,443,443,20,20,0,1,0
6,454,454,18,18,0,1,0
8,459,459,20,3,17,2,1
11,498,498,1,1,0,1,0

13,125,125,3,3,0,1,0
27,126,126,15,6,9,2,1
20,132,132,2,2,0,1,0
18,150,150,5,2,3,2,1
8,154,154,23,1,22,3,2
16,155,155,23,23,0,1,0
23,200,200,20,20,0,1,0
26,202,202,12,12,0,1,0
19,229,229,54,7,47,2,1
7,258,258,1,1,0,1,0
0,273,273,32,27,5,2,1
14,276,276,7,7,0,1,0
12,283,283,5,5,0,1,0
2,292,292,20,20,0,1,0
25,311,311,42,42,0,1,0
15,312,312,20,8,12,4,3
1,336,336,6,6,0,1,0
24,349,349,20,20,0,1,0
5,370,370,78,16,62,3,2
11,388,388,7,1,6,2,1
6,405,405,63,29,34,3,2
10,407,407,21,14,7,2,1
3,415,415,17,9,8,2,1
21,446,446,12,12,0,1,0
4,452,452,25,25,0,1,0
17,469,469,130,130,0,1,0
9,482,482,87,87,0,1,0
22,484,484,6,6,0,1,0

25,111,111,2,2,0,1,0
6,115,115,1,1,0,1,0
31,134,134,6,6,0,1,0
24,144,144,16,16,0,1,0
10,158,158,13,4,9,4,3
32,202,202,36,36,0,1,0
8,203,203,26,26,0,1,0
29,203,203,62,62,0,1,0
26,204,204,15,6,9,2,1
14,229,229,10,2,8,3,2
27,230,230,21,21,0,1,0
9,230,230,6,3,3,2,1
28,232,232,4,4,0,1,0
15,235,235,45,45,0,1,0
19,257,257,3,3,0,1,0
4,281,281,40,40,0,1,0
13,289,289,7,7,0,1,0
12,289,289,6,6,0,1,0
18,313,313,26,26,0,1,0
11,321,321,1,1,0,1,0
1,324,324,24,24,0,1,0
3,337,337,5,1,4,2,1
21,361,361,30,24,6,2,1
5,396,396,31,31,0,1,0
17,398,398,7,3,4,2,1
30,406,406,116,116,0,1,0
16,422,422,20,2,18,3,2
0,439,439,25,11,14,3,2
2,444,444,16,16,0,1,0
22,449,449,2,2,0,1,0
23,477,477,5,5,0,1,0
20,484,484,21,21,0,1,0
7,489,489,33,3,30,2,1

18,105,105,3,3,0,1,0
0,150,150,18,11,7,2,1
10,179,179,34,34,0,1,0
1,186,186,14,8,6,3,2
2,195,195,62,22,40,2,1
5,201,201,4,1,3,2,1
20,203,203,19,3,16,3,2
6,222,222,31,11,20,3,2
3,234,234,40,2,38,2,1
8,237,237,23,1,22,3,2
11,264,264,9,9,0,1,0
9,269,269,3,3,0,1,0
13,279,279,38,35,3,2,1
7,280,280,68,68,0,1,0
17,299,299,58,12,46,3,2
21,312,312,26,26,0,1,0
15,317,317,47,42,5,2,1
12,331,331,2,2,0,1,0
16,351,351,50,8,42,3,2
19,400,400,23,19,4,2,1
4,461,461,4,4,0,1,0
14,480,480,52,7,45,4,3

11,100,100,11,3,8,2,1
4,108,108,3,3,0,1,0
16,130,130,1,1,0,1,0
1,131,131,1,1,0,1,0
13,140,140,30,30,0,1,0
2,166,166,41,41,0,1,0
9,180,180,20,1,19,4,3
20,202,202,7,7,0,1,0
22,205,205,8,8,0,1,0
18,206,206,2,2,0,1,0
5,216,216,14,8,6,2,1
21,235,235,28,24,4,2,1
14,247,247,15,12,3,2,1
8,263,263,44,44,0,1,0
15,279,279,51,3,48,2,1
3,288,288,8,8,0,1,0
6,291,291,45,27,18,4,3
0,299,299,48,18,30,4,3
12,326,326,30,18,12,4,3
17,392,392,76,55,21,2,1
10,396,396,32,32,0,1,0
23,426,426,27,27,0,1,0
7,467,467,19,19,0,1,0
19,479,479,97,97,0,1,0

21,132,132,10,10,0,1,0
5,146,146,24,9,15,4,3
10,149,149,4,4,0,1,0
7,150,150,8,2,6,3,2
8,150,150,38,11,27,4,3
18,168,168,30,30,0,1,0
14,176,176,35,35,0,1,0
17,193,193,16,16,0,1,0
19,210,210,19,19,0,1,0
16,243,243,27,27,0,1,0
2,278,278,10,10,0,1,0
15,295,295,3,3,0,1,0
6,313,313,33,33,0,1,0
20,315,315,6,6,0,1,0
13,329,329,96,42,54,3,2
9,334,334,5,5,0,1,0
4,351,351,16,8,8,2,1
11,354,354,11,11,0,1,0
0,425,425,132,132,0,1,0
1,439,439,33,33,0,1,0
3,449,449,64,28,36,3,2
12,499,499,57,49,8,2,1

1,104,104,6,6,0,1,0
11,133,133,7,7,0,1,0
23,138,138,2,2,0,1,0
30,151,151,1,1,0,1,0
15,152,152,4,4,0,1,0
13,162,162,3,3,0,1,0
8,169,169,12,12,0,1,0
2,178,178,32,28,4,2,1
9,195,195,23,11,12,3,2
29,204,204,38,38,0,1,0
6,205,205,1,1,0,1,0
28,217,217,15,15,0,1,0
24,218,218,15,15,0,1,0
22,224,224,19,6,13,3,2
17,239,239,4,4,0,1,0
3,252,252,37,31,6,3,2
21,256,256,57,57,0,1,0
0,264,264,33,12,21,4,3
5,280,280,2,2,0,1,0
12,285,285,28,28,0,1,0
25,294,294,6,6,0,1,0
27,306,306,18,8,10,2,1
7,340,340,18,18,0,1,0
16,348,348,3,3,0,1,0
19,368,368,5,5,0,1,0
31,402,402,136,97,39,4,3
14,439,439,9,9,0,1,0
26,440,440,38,38,0,1,0
10,450,450,45,45,0,1,0
20,474,474,32,32,0,1,0
18,485,485,21,21,0,1,0
4,495,495,19,4,15,2,1

7,158,158,2,2,0,1,0
20,164,164,1,1,0,1,0
21,189,189,6,6,0,1,0
9,193,193,3,3,0,1,0
8,206,206,18,2,16,2,1
10,222,222,32,18,14,2,1
2,283,283,5,5,0,1,0
19,285,285,45,45,0,1,0
15,288,288,55,8,47,4,3
16,331,331,16,1,15,4,3
1,336,336,77,58,19,2,1
17,344,344,24,24,0,1,0
12,351,351,13,13,0,1,0
4,381,381,57,57,0,1,0
5,384,384,133,88,45,4,3
18,408,408,31,31,0,1,0
6,428,428,15,3,12,3,2
13,452,452,31,3,28,2,1
0,475,475,124,124,0,1,0
3,479,479,22,1,21,2,1
14,495,495,192,192,0,1,0
11,500,500,4,4,0,1,0

24,113,113,37,37,0,1,0
8,115,115,1,1,0,1,0
26,151,151,30,30,0,1,0
5,169,169,24,24,0,1,0
21,169,169,9,5,4,2,1
19,179,179,9,9,0,1,0
12,226,226,1,1,0,1,0
17,233,233,15,6,9,4,3
25,246,246,24,6,18,2,1
6,256,256,45,31,14,3,2
10,256,256,8,8,0,1,0
7,269,269,65,65,0,1,0
16,270,270,29,15,14,3,2
11,281,281,1,1,0,1,0
27,302,302,35,35,0,1,0
18,321,321,22,7,15,3,2
13,329,329,39,30,9,4,3
4,333,333,7,7,0,1,0
3,347,347,25,17,8,2,1
1,363,363,25,11,14,2,1
2,364,364,8,8,0,1,0
22,369,369,2,2,0,1,0
0,384,384,36,36,0,1,0
23,405,405,48,48,0,1,0
9,407,407,7,1,6,2,1
20,461,461,9,9,0,1,0
15,479,479,64,40,24,2,1
14,481,481,22,22,0,1,0

25,137,137,4,4,0,1,0
3,148,148,11,1,10,3,2
7,180,180,43,38,5,2,1
0,196,196,7,7,0,1,0
10,225,225,5,1,4,2,1
15,235,235,6,6,0,1,0
4,238,238,12,5,7,2,1
18,241,241,10,10,0,1,0
16,289,289,11,1,10,2,1
12,305,305,34,34,0,1,0
5,306,306,26,26,0,1,0
14,356,356,45,45,0,1,0
2,360,360,32,8,24,4,3
13,365,365,38,38,0,1,0
11,381,381,27,27,0,1,0
19,413,413,7,7,0,1,0
23,435,435,21,21,0,1,0
1,440,440,11,11,0,1,0
6,440,440,36,36,0,1,0
20,449,449,12,12,0,1,0
21,454,454,272,260,12,2,1
9,458,458,82,82,0,1,0
22,473,473,41,41,0,1,0
24,478,478,56,56,0,1,0
8,482,482,16,3,13,2,1
17,482,482,28,28,0,1,0

14,119,119,19,19,0,1,0
6,126,126,27,27,0,1,0
5,137,137,3,3,0,1,0
18,145,145,4,4,0,1,0
12,178,178,18,18,0,1,0
2,179,179,7,7,0,1,0
8,181,181,50,50,0,1,0
3,216,216,21,11,10,2,1
9,234,234,21,5,16,3,2
17,236,236,2,2,0,1,0
4,261,261,33,33,0,1,0
15,283,283,1,1,0,1,0
20,299,299,8,4,4,2,1
13,303,303,4,1,3,2,1
10,313,313,56,56,0,1,0
19,321,321,61,61,0,1,0
11,366,366,73,28,45,2,1
0,387,387,62,26,36,4,3
7,409,409,22,22,0,1,0
16,419,419,54,17,37,2,1
1,445,445,54,54,0,1,0
21,488,488,90,20,70,4,3

19,113,113,8,8,0,1,0
10,143,143,25,25,0,1,0
15,152,152,31,9,22,3,2
16,178,178,20,20,0,1,0
20,195,195,41,11,30,4,3
6,277,277,30,17,13,3,2
0,288,288,12,12,0,1,0
7,305,305,21,21,0,1,0
8,313,313,1,1,0,1,0
11,318,318,10,10,0,1,0
17,319,319,64,18,46,3,2
2,336,336,63,10,53,4,3
21,338,338,57,57,0,1,0
5,358,358,147,123,24,4,3
14,414,414,30,3,27,2,1
4,451,451,22,22,0,1,0
22,452,452,7,7,0,1,0
13,458,458,40,40,0,1,0
9,462,462,2,2,0,1,0
23,471,471,5,1,4,2,1
3,473,473,25,25,0,1,0
18,483,483,11,11,0,1,0
12,491,491,21,9,12,4,3
1,495,495,35,27,8,2,1

18,130,130,4,4,0,1,0
17,148,148,16,12,4,2,1
21,152,152,51,9,42,3,2
7,160,160,6,6,0,1,0
15,164,164,12,4,8,3,2
23,210,210,15,15,0,1,0
10,233,233,25,9,16,3,2
12,244,244,34,34,0,1,0
2,276,276,24,6,18,2,1
22,278,278,55,12,43,2,1
1,281,281,25,25,0,1,0
6,285,285,9,9,0,1,0
14,302,302,22,22,0,1,0
24,305,305,30,25,5,2,1
8,315,315,21,18,3,2,1
0,336,336,85,85,0,1,0
20,353,353,2,2,0,1,0
3,361,361,60,57,3,2,1
4,370,370,1,1,0,1,0
16,372,372,19,19,0,1,0
5,372,372,12,12,0,1,0
11,381,381,15,3,12,3,2
19,416,416,48,3,45,4,3
13,421,421,29,29,0,1,0
9,484,484,72,33,39,2,1

17,110,110,2,2,0,1,0
26,126,126,10,10,0,1,0
6,192,192,25,25,0,1,0
0,206,206,5,1,4,2,1
8,227,227,47,47,0,1,0
20,239,239,13,13,0,1,0
22,250,250,15,15,0,1,0
10,275,275,15,5,10,3,2
14,284,284,68,14,54,3,2
3,292,292,26,20,6,3,2
4,299,299,15,9,6,3,2
11,306,306,1,1,0,1,0
15,312,312,21,5,16,2,1
7,323,323,19,10,9,4,3
23,329,329,7,7,0,1,0
2,332,332,43,15,28,2,1
28,371,371,182,86,96,4,3
27,379,379,1,1,0,1,0
18,396,396,107,107,0,1,0
21,396,396,23,23,0,1,0
5,410,410,2,2,0,1,0
1,414,414,6,6,0,1,0
19,433,433,1,1,0,1,0
12,444,444,10,1,9,4,3
13,458,458,29,21,8,2,1
25,458,458,21,3,18,3,2
16,472,472,4,4,0,1,0
9,481,481,16,16,0,1,0
24,485,485,56,56,0,1,0

6,109,109,25,16,9,2,1
20,111,111,9,9,0,1,0
14,156,156,2,2,0,1,0
10,162,162,5,1,4,2,1
4,197,197,11,8,3,2,1
19,232,232,13,13,0,1,0
0,241,241,9,9,0,1,0
8,252,252,1,1,0,1,0
11,273,273,112,112,0,1,0
5,276,276,7,7,0,1,0
15,285,285,47,47,0,1,0
17,292,292,23,9,14,2,1
9,330,330,8,8,0,1,0
1,337,337,90,6,84,4,3
7,349,349,89,39,50,3,2
16,361,361,20,20,0,1,0
2,407,407,7,7,0,1,0
21,415,415,71,55,16,4,3
18,419,419,22,22,0,1,0
3,458,458,131,131,0,1,0
13,467,467,37,33,4,2,1
12,468,468,16,16,0,1,0

20,116,116,15,15,0,1,0
16,142,142,9,9,0,1,0
21,160,160,33,33,0,1,0
6,180,180,13,13,0,1,0
3,196,196,35,35,0,1,0
24,221,221,55,55,0,1,0
5,232,232,20,20,0,1,0
15,233,233,17,11,6,3,2
13,238,238,16,2,14,3,2
4,243,243,10,5,5,2,1
10,258,258,17,11,6,3,2
12,267,267,11,11,0,1,0
18,275,275,6,6,0,1,0
14,279,279,39,39,0,1,0
8,310,310,1,1,0,1,0
2,341,341,62,62,0,1,0
0,352,352,45,3,42,2,1
25,376,376,62,20,42,2,1
1,389,389,3,3,0,1,0
11,395,395,25,17,8,2,1
23,397,397,23,23,0,1,0
9,431,431,100,61,39,4,3
19,442,442,10,10,0,1,0
22,449,449,25,25,0,1,0
7,454,454,15,15,0,1,0
17,487,487,19,19,0,1,0

7,103,103,3,3,0,1,0
18,110,110,4,4,0,1,0
8,133,133,36,30,6,3,2
10,217,217,15,15,0,1,0
12,220,220,34,34,0,1,0
17,247,247,1,1,0,1,0
6,253,253,25,16,9,2,1
2,259,259,36,9,27,4,3
0,260,260,10,4,6,3,2
4,298,298,45,12,33,3,2
20,298,298,16,8,8,3,2
5,338,338,90,32,58,3,2
9,342,342,44,21,23,2,1
13,343,343,12,12,0,1,0
15,368,368,8,8,0,1,0
11,420,420,12,12,0,1,0
14,427,427,135,135,0,1,0
19,454,454,2,2,0,1,0
1,468,468,43,8,35,2,1
3,481,481,56,2,54,4,3
16,494,494,184,184,0,1,0

20,149,149,5,2,3,2,1
0,153,153,16,16,0,1,0
16,159,159,35,3,32,4,3
13,177,177,1,1,0,1,0
1,214,214,18,3,15,4,3
17,242,242,7,3,4,2,1
23,251,251,3,3,0,1,0
8,260,260,1,1,0,1,0
10,284,284,63,63,0,1,0
12,304,304,72,36,36,3,2
5,309,309,17,13,4,2,1
7,371,371,1,1,0,1,0
19,373,373,45,17,28,3,2
14,385,385,49,49,0,1,0
22,394,394,81,81,0,1,0
2,422,422,58,13,45,2,1
18,428,428,21,21,0,1,0
4,443,443,39,39,0,1,0
11,458,458,29,23,6,3,2
3,459,459,65,8,57,4,3
9,464,464,35,11,24,4,3
15,482,482,37,37,0,1,0
6,489,489,109,109,0,1,0
21,496,496,52,25,27,2,1

16,109,109,18,2,16,3,2
17,128,128,36,27,9,2,1
19,134,134,19,14,5,2,1
12,160,160,4,4,0,1,0
18,180,180,2,2,0,1,0
10,181,181,2,2,0,1,0
5,213,213,51,6,45,2,1
22,249,249,5,5,0,1,0
15,263,263,31,10,21,4,3
13,272,272,5,2,3,2,1
3,272,272,43,43,0,1,0
8,293,293,16,16,0,1,0
1,309,309,62,62,0,1,0
14,318,318,16,16,0,1,0
7,362,362,12,12,0,1,0
4,370,370,3,3,0,1,0
20,373,373,51,19,32,2,1
21,391,391,88,64,24,3,2
24,395,395,14,2,12,3,2
23,434,434,8,1,7,2,1
6,459,459,39,39,0,1,0
0,460,460,54,41,13,2,1
2,472,472,37,37,0,1,0
11,478,478,18,18,0,1,0
9,486,486,76,62,14,2,1

25,108,108,12,12,0,1,0
1,113,113,1,1,0,1,0
21,116,116,17,5,12,4,3
11,128,128,2,2,0,1,0
26,135,135,19,19,0,1,0
23,139,139,20,20,0,1,0
2,200,200,11,5,6,3,2
17,202,202,3,3,0,1,0
14,207,207,34,4,30,4,3
19,235,235,32,32,0,1,0
18,302,302,21,21,0,1,0
12,309,309,3,3,0,1,0
3,320,320,11,1,10,2,1
4,320,320,4,4,0,1,0
5,322,322,2,2,0,1,0
13,344,344,2,2,0,1,0
9,373,373,15,15,0,1,0
0,384,384,51,51,0,1,0
24,396,396,72,60,12,3,2
8,399,399,132,132,0,1,0
6,404,404,101,14,87,4,3
7,418,418,3,3,0,1,0
16,420,420,1,1,0,1,0
20,449,449,26,26,0,1,0
15,451,451,60,11,49,2,1
10,461,461,60,60,0,1,0
22,474,474,42,27,15,4,3

3,105,105,6,6,0,1,0
19,145,145,20,5,15,2,1
25,155,155,1,1,0,1,0
0,203,203,2,2,0,1,0
9,209,209,5,5,0,1,0
14,215,215,8,8,0,1,0
12,218,218,56,56,0,1,0
11,231,231,17,17,0,1,0
15,232,232,15,9,6,3,2
20,242,242,9,9,0,1,0
1,246,246,18,10,8,3,2
13,265,265,38,38,0,1,0
5,304,304,9,5,4,2,1
24,313,313,100,100,0,1,0
8,321,321,11,11,0,1,0
22,332,332,119,87,32,4,3
7,340,340,48,5,43,2,1
28,343,343,1,1,0,1,0
17,358,358,72,66,6,2,1
6,364,364,19,11,8,2,1
4,372,372,58,58,0,1,0
21,376,376,22,3,19,4,3
2,377,377,1,1,0,1,0
23,430,430,5,1,4,2,1
26,439,439,24,2,22,3,2
16,442,442,10,10,0,1,0
27,467,467,12,4,8,2,1
10,476,476,11,4,7,2,1
18,488,488,6,6,0,1,0

26,100,100,4,4,0,1,0
5,111,111,4,1,3,2,1
18,112,112,4,4,0,1,0
11,126,126,26,19,7,2,1
7,129,129,8,8,0,1,0
2,139,139,26,26,0,1,0
24,139,139,3,3,0,1,0
12,144,144,2,2,0,1,0
14,173,173,1,1,0,1,0
21,173,173,14,14,0,1,0
25,175,175,1,1,0,1,0
16,207,207,1,1,0,1,0
0,207,207,2,2,0,1,0
17,227,227,15,15,0,1,0
8,245,245,2,2,0,1,0
20,256,256,97,53,44,2,1
22,263,263,7,1,6,2,1
6,271,271,30,8,22,3,2
1,339,339,56,56,0,1,0
19,342,342,122,70,52,3,2
28,370,370,45,11,34,4,3
13,371,371,20,14,6,2,1
4,391,391,12,12,0,1,0
27,442,442,12,4,8,3,2
15,447,447,29,15,14,3,2
3,448,448,55,18,37,2,1
9,476,476,18,4,14,3,2
23,478,478,34,21,13,2,1
10,497,497,41,8,33,4,3

15,118,118,8,8,0,1,0
19,166,166,14,4,10,2,1
17,212,212,29,1,28,2,1
11,237,237,43,28,15,2,1
8,238,238,78,22,56,3,2
4,246,246,57,57,0,1,0
10,264,264,6,6,0,1,0
7,268,268,53,14,39,4,3
5,290,290,12,6,6,3,2
16,334,334,23,9,14,3,2
1,350,350,33,21,12,4,3
20,351,351,21,21,0,1,0
6,360,360,43,43,0,1,0
14,366,366,9,9,0,1,0
0,398,398,45,14,31,2,1
13,409,409,8,8,0,1,0
9,411,411,62,26,36,2,1
3,416,416,21,3,18,4,3
18,424,424,34,34,0,1,0
2,444,444,11,11,0,1,0
12,465,465,151,109,42,4,3

14,125,125,17,17,0,1,0
0,132,132,7,7,0,1,0
2,137,137,3,3,0,1,0
24,139,139,4,4,0,1,0
23,140,140,36,36,0,1,0
4,141,141,1,1,0,1,0
22,145,145,9,6,3,2,1
18,154,154,45,31,14,2,1
21,160,160,2,2,0,1,0
9,167,167,63,63,0,1,0
20,201,201,1,1,0,1,0
16,205,205,9,3,6,3,2
8,282,282,15,1,14,4,3
12,289,289,70,23,47,2,1
15,293,293,1,1,0,1,0
10,298,298,9,9,0,1,0
13,313,313,8,8,0,1,0
25,320,320,45,17,28,3,2
6,322,322,36,31,5,2,1
5,361,361,26,9,17,2,1
7,392,392,1,1,0,1,0
11,411,411,73,73,0,1,0
17,444,444,30,1,29,2,1
1,457,457,10,10,0,1,0
3,482,482,2,2,0,1,0
19,486,486,89,89,0,1,0

27,109,109,13,13,0,1,0
6,114,114,16,16,0,1,0
17,120,120,39,39,0,1,0
21,140,140,35,35,0,1,0
23,146,146,18,11,7,2,1
18,153,153,2,2,0,1,0
26,158,158,18,18,0,1,0
16,183,183,4,4,0,1,0
0,196,196,6,6,0,1,0
8,234,234,1,1,0,1,0
22,243,243,3,3,0,1,0
9,245,245,2,2,0,1,0
25,249,249,21,21,0,1,0
4,265,265,3,3,0,1,0
15,324,324,6,6,0,1,0
12,359,359,15,12,3,2,1
24,365,365,32,6,26,4,3
10,373,373,54,36,18,3,2
1,385,385,49,28,21,4,3
14,418,418,1,1,0,1,0
2,441,441,22,2,20,3,2
3,449,449,74,46,28,2,1
19,456,456,18,2,16,3,2
5,470,470,73,55,18,2,1
11,478,478,65,23,42,4,3
20,484,484,19,1,18,2,1
7,489,489,59,3,56,3,2
13,498,498,23,2,21,4,3

6,138,138,3,3,0,1,0
1,176,176,38,32,6,2,1
2,237,237,62,34,28,3,2
4,260,260,22,18,4,2,1
5,269,269,14,6,8,3,2
0,293,293,95,60,35,2,1
8,301,301,58,58,0,1,0
14,323,323,3,3,0,1,0
15,344,344,29,4,25,4,3
11,349,349,5,5,0,1,0
9,352,352,76,45,31,4,3
3,369,369,147,147,0,1,0
13,394,394,81,5,76,3,2
7,400,400,72,72,0,1,0
10,468,468,52,52,0,1,0
12,484,484,21,9,12,2,1

1,141,141,25,19,6,3,2
23,162,162,21,21,0,1,0
27,187,187,12,3,9,3,2
16,196,196,36,36,0,1,0
3,198,198,1,1,0,1,0
20,211,211,15,1,14,4,3
17,244,244,19,11,8,3,2
13,271,271,7,7,0,1,0
21,318,318,21,21,0,1,0
4,320,320,7,7,0,1,0
12,340,340,29,13,16,2,1
10,356,356,52,20,32,3,2
14,377,377,25,11,14,3,2
11,382,382,10,10,0,1,0
15,411,411,15,15,0,1,0
8,422,422,154,34,120,4,3
19,437,437,2,2,0,1,0
2,442,442,39,39,0,1,0
9,442,442,4,4,0,1,0
24,454,454,5,1,4,2,1
22,455,455,125,2,123,4,3
5,460,460,2,2,0,1,0
6,474,474,55,6,49,2,1
18,477,477,26,8,18,4,3
0,477,477,13,13,0,1,0
7,484,484,1,1,0,1,0
26,495,495,44,44,0,1,0
25,499,499,96,96,0,1,0

18,117,117,3,3,0,1,0
26,148,148,9,9,0,1,0
24,180,180,19,9,10,3,2
17,190,190,8,8,0,1,0
19,194,194,13,2,11,2,1
12,214,214,15,4,11,2,1
6,233,233,40,40,0,1,0
8,233,233,9,9,0,1,0
14,265,265,6,6,0,1,0
1,269,269,18,18,0,1,0
11,272,272,1,1,0,1,0
13,295,295,15,15,0,1,0
15,305,305,22,22,0,1,0
9,312,312,8,8,0,1,0
25,326,326,43,43,0,1,0
10,327,327,7,7,0,1,0
21,328,328,27,17,10,3,2
7,338,338,2,2,0,1,0
23,342,342,142,142,0,1,0
0,348,348,97,7,90,4,3
5,353,353,20,17,3,2,1
4,434,434,54,32,22,2,1
3,439,439,89,89,0,1,0
16,444,444,58,58,0,1,0
20,456,456,13,13,0,1,0
2,463,463,28,14,14,3,2
22,483,483,32,9,23,3,2

11,107,107,2,2,0,1,0
7,145,145,1,1,0,1,0
21,155,155,1,1,0,1,0
16,158,158,30,30,0,1,0
0,161,161,13,13,0,1,0
6,180,180,45,45,0,1,0
4,212,212,45,11,34,2,1
1,233,233,28,28,0,1,0
18,233,233,38,38,0,1,0
12,250,250,43,21,22,2,1
10,252,252,3,3,0,1,0
19,289,289,7,7,0,1,0
2,315,315,4,4,0,1,0
8,319,319,63,63,0,1,0
13,350,350,36,4,32,3,2
15,362,362,46,19,27,4,3
9,406,406,48,48,0,1,0
17,410,410,6,6,0,1,0
20,411,411,106,106,0,1,0
3,430,430,12,12,0,1,0
5,445,445,78,4,74,3,2
14,487,487,68,35,33,2,1

3,102,102,4,1,3,2,1
14,126,126,13,13,0,1,0
2,128,128,10,10,0,1,0
12,142,142,3,3,0,1,0
28,145,145,16,16,0,1,0
17,146,146,3,3,0,1,0
11,160,160,7,7,0,1,0
6,166,166,13,13,0,1,0
10,178,178,16,16,0,1,0
15,193,193,19,7,12,4,3
7,217,217,1,1,0,1,0
20,237,237,58,8,50,2,1
27,252,252,32,27,5,2,1
19,252,252,11,1,10,3,2
25,262,262,28,4,24,3,2
26,318,318,8,3,5,2,1
22,322,322,33,12,21,2,1
18,323,323,7,3,4,2,1
0,324,324,72,72,0,1,0
5,332,332,1,1,0,1,0
4,343,343,16,3,13,2,1
24,344,344,97,44,53,3,2
1,348,348,1,1,0,1,0
9,399,399,84,84,0,1,0
16,409,409,7,7,0,1,0
21,443,443,56,56,0,1,0
8,444,444,2,2,0,1,0
13,483,483,66,8,58,3,2
23,493,493,4,4,0,1,0

14,124,124,10,10,0,1,0
12,200,200,5,5,0,1,0
4,202,202,3,3,0,1,0
8,211,211,98,20,78,3,2
15,214,214,11,4,7,2,1
2,224,224,76,36,40,3,2
18,225,225,29,17,12,4,3
10,257,257,32,32,0,1,0
5,257,257,35,14,21,2,1
1,260,260,1,1,0,1,0
3,262,262,72,72,0,1,0
9,269,269,1,1,0,1,0
6,269,269,32,23,9,4,3
0,279,279,38,38,0,1,0
17,337,337,5,5,0,1,0
16,390,390,71,56,15,2,1
19,398,398,21,21,0,1,0
13,410,410,20,12,8,3,2
11,448,448,19,2,17,2,1
7,454,454,80,80,0,1,0

21,116,116,10,2,8,3,2
4,133,133,14,14,0,1,0
16,152,152,39,39,0,1,0
20,154,154,28,4,24,2,1
9,155,155,7,7,0,1,0
13,171,171,18,12,6,2,1
18,182,182,14,5,9,4,3
6,201,201,18,18,0,1,0
12,216,216,10,10,0,1,0
7,227,227,39,39,0,1,0
17,235,235,28,15,13,3,2
0,264,264,8,1,7,2,1
5,267,267,10,2,8,2,1
23,274,274,14,4,10,4,3
2,279,279,50,25,25,2,1
3,296,296,6,6,0,1,0
19,327,327,2,2,0,1,0
10,346,346,5,5,0,1,0
15,347,347,13,3,10,3,2
22,371,371,16,16,0,1,0
8,374,374,1,1,0,1,0
11,438,438,27,10,17,2,1
1,440,440,195,153,42,2,1
14,445,445,97,97,0,1,0

12,141,141,54,54,0,1,0
8,143,143,9,9,0,1,0
9,155,155,2,2,0,1,0
0,158,158,19,19,0,1,0
1,160,160,4,4,0,1,0
13,175,175,17,17,0,1,0
6,189,189,26,26,0,1,0
7,189,189,36,18,18,3,2
19,247,247,9,6,3,2,1
20,255,255,20,20,0,1,0
10,284,284,13,6,7,2,1
14,294,294,20,20,0,1,0
4,315,315,100,100,0,1,0
17,355,355,3,3,0,1,0
15,380,380,74,65,9,2,1
11,395,395,96,64,32,2,1
2,399,399,98,49,49,2,1
18,403,403,14,14,0,1,0
5,432,432,3,3,0,1,0
3,433,433,41,41,0,1,0
16,456,456,6,1,5,2,1

12,100,100,22,22,0,1,0
2,121,121,1,1,0,1,0
13,138,138,1,1,0,1,0
23,162,162,32,32,0,1,0
24,172,172,41,5,36,4,3
6,194,194,14,14,0,1,0
14,227,227,23,23,0,1,0
9,229,229,24,12,12,4,3
1,239,239,2,2,0,1,0
3,270,270,1,1,0,1,0
0,285,285,22,10,12,4,3
7,292,292,21,9,12,4,3
16,328,328,49,49,0,1,0
8,328,328,42,7,35,2,1
19,332,332,55,19,36,4,3
20,346,346,25,7,18,4,3
22,368,368,13,13,0,1,0
18,390,390,2,2,0,1,0
10,418,418,51,51,0,1,0
4,421,421,50,50,0,1,0
15,434,434,42,25,17,3,2
11,455,455,80,80,0,1,0
5,478,478,47,47,0,1,0
17,478,478,1,1,0,1,0
21,487,487,71,71,0,1,0

15,118,118,8,8,0,1,0
7,126,126,5,5,0,1,0
4,130,130,10,1,9,2,1
5,145,145,1,1,0,1,0
3,166,166,9,9,0,1,0
19,182,182,68,25,43,2,1
0,188,188,2,2,0,1,0
10,188,188,30,20,10,2,1
18,197,197,21,21,0,1,0
8,207,207,24,24,0,1,0
11,209,209,16,16,0,1,0
14,280,280,53,53,0,1,0
21,285,285,5,5,0,1,0
2,343,343,33,33,0,1,0
23,369,369,41,14,27,2,1
1,379,379,86,15,71,3,2
6,405,405,98,47,51,4,3
22,418,418,6,2,4,2,1
16,461,461,7,7,0,1,0
12,483,483,74,74,0,1,0
9,485,485,47,21,26,2,1
13,488,488,32,28,4,2,1
17,497,497,38,10,28,2,1
20,499,499,13,3,10,3,2

17,152,152,7,7,0,1,0
24,179,179,7,7,0,1,0
21,215,215,11,3,8,3,2
3,215,215,8,2,6,3,2
19,227,227,62,28,34,3,2
11,234,234,9,9,0,1,0
22,241,241,3,3,0,1,0
8,252,252,10,10,0,1,0
13,257,257,24,7,17,2,1
4,261,261,9,3,6,3,2
16,278,278,85,79,6,2,1
15,280,280,16,16,0,1,0
14,285,285,26,22,4,2,1
0,298,298,17,17,0,1,0
23,316,316,3,3,0,1,0
10,325,325,164,59,105,4,3
2,337,337,24,24,0,1,0
5,346,346,28,28,0,1,0
12,376,376,17,12,5,2,1
7,400,400,23,14,9,2,1
9,439,439,7,7,0,1,0
25,446,446,16,16,0,1,0
18,457,457,78,67,11,2,1
6,473,473,54,14,40,2,1
1,484,484,6,6,0,1,0
20,487,487,61,61,0,1,0

14,113,113,8,2,6,2,1
17,114,114,4,4,0,1,0
12,116,116,3,3,0,1,0
3,134,134,2,2,0,1,0
18,155,155,24,24,0,1,0
9,162,162,25,25,0,1,0
11,171,171,3,3,0,1,0
1,175,175,20,20,0,1,0
29,187,187,14,14,0,1,0
20,192,192,12,12,0,1,0
6,207,207,2,2,0,1,0
21,219,219,3,3,0,1,0
23,228,228,25,25,0,1,0
2,228,228,41,41,0,1,0
15,267,267,29,29,0,1,0
16,268,268,40,40,0,1,0
24,289,289,35,9,26,3,2
26,293,293,10,10,0,1,0
8,297,297,2,2,0,1,0
7,307,307,20,4,16,3,2
13,317,317,19,19,0,1,0
0,332,332,15,15,0,1,0
5,341,341,16,16,0,1,0
10,355,355,29,16,13,2,1
19,414,414,126,64,62,3,2
25,454,454,58,58,0,1,0
22,460,460,25,25,0,1,0
28,477,477,75,75,0,1,0
4,479,479,10,2,8,2,1
27,498,498,1,1,0,1,0

2,111,111,16,16,0,1,0
5,146,146,1,1,0,1,0
17,149,149,4,4,0,1,0
9,181,181,14,7,7,2,1
16,188,188,46,30,16,4,3
6,219,219,15,15,0,1,0
13,225,225,6,2,4,2,1
23,243,243,15,9,6,2,1
21,257,257,40,15,25,2,1
19,264,264,9,9,0,1,0
10,267,267,8,8,0,1,0
0,271,271,72,72,0,1,0
15,283,283,60,60,0,1,0
7,289,289,1,1,0,1,0
14,323,323,42,42,0,1,0
24,333,333,24,6,18,2,1
12,334,334,7,7,0,1,0
3,375,375,33,33,0,1,0
4,403,403,96,96,0,1,0
1,425,425,54,54,0,1,0
11,442,442,16,16,0,1,0
18,463,463,82,31,51,4,3
8,472,472,45,24,21,4,3
22,480,480,2,2,0,1,0
20,485,485,37,17,20,3,2

29,127,127,3,3,0,1,0
26,127,127,1,1,0,1,0
5,127,127,7,4,3,2,1
16,129,129,9,9,0,1,0
24,137,137,10,10,0,1,0
15,153,153,1,1,0,1,0
9,153,153,5,1,4,2,1
18,155,155,4,4,0,1,0
6,228,228,4,4,0,1,0
20,231,231,10,10,0,1,0
0,238,238,3,3,0,1,0
23,250,250,25,25,0,1,0
11,259,259,4,1,3,2,1
13,261,261,3,3,0,1,0
21,271,271,34,20,14,3,2
3,306,306,9,9,0,1,0
17,310,310,47,21,26,2,1
10,336,336,1,1,0,1,0
4,349,349,10,10,0,1,0
8,379,379,81,35,46,2,1
25,392,392,71,41,30,2,1
12,395,395,32,32,0,1,0
27,397,397,6,6,0,1,0
7,434,434,76,71,5,2,1
2,443,443,35,35,0,1,0
19,455,455,72,54,18,2,1
22,457,457,95,95,0,1,0
1,463,463,19,9,10,2,1
28,465,465,125,125,0,1,0
14,485,485,86,64,22,3,2

23,103,103,5,5,0,1,0
5,112,112,5,2,3,2,1
13,131,131,6,6,0,1,0
7,155,155,14,7,7,2,1
11,162,162,7,1,6,2,1
4,165,165,19,3,16,3,2
27,167,167,34,34,0,1,0
10,168,168,22,1,21,4,3
22,190,190,3,3,0,1,0
24,193,193,52,30,22,3,2
6,197,197,37,15,22,3,2
20,226,226,7,4,3,2,1
21,235,235,21,21,0,1,0
9,238,238,18,6,12,4,3
8,308,308,66,27,39,2,1
17,308,308,3,3,0,1,0
16,317,317,3,3,0,1,0
1,337,337,3,3,0,1,0
28,356,356,95,46,49,2,1
19,367,367,20,20,0,1,0
26,367,367,11,8,3,2,1
15,368,368,8,8,0,1,0
0,382,382,30,12,18,3,2
12,411,411,11,1,10,2,1
18,414,414,59,11,48,3,2
25,445,445,26,12,14,3,2
14,447,447,5,5,0,1,0
2,461,461,22,10,12,2,1
3,495,495,24,7,17,2,1

4,124,124,16,16,0,1,0
7,175,175,30,2,28,2,1
19,185,185,13,1,12,4,3
11,197,197,4,4,0,1,0
6,198,198,1,1,0,1,0
14,213,213,14,3,11,2,1
3,242,242,37,17,20,2,1
5,247,247,99,6,93,4,3
12,263,263,78,78,0,1,0
8,272,272,12,2,10,2,1
10,309,309,11,1,10,3,2
16,319,319,29,5,24,3,2
18,319,319,79,79,0,1,0
9,350,350,27,27,0,1,0
13,365,365,39,39,0,1,0
0,381,381,62,53,9,4,3
17,435,435,21,21,0,1,0
2,438,438,27,7,20,3,2
1,467,467,55,12,43,3,2
15,497,497,60,24,36,4,3

11,113,113,13,7,6,2,1
19,128,128,2,2,0,1,0
5,160,160,1,1,0,1,0
3,167,167,23,23,0,1,0
21,195,195,37,37,0,1,0
1,228,228,77,46,31,2,1
6,237,237,1,1,0,1,0
18,273,273,23,2,21,2,1
17,275,275,14,14,0,1,0
4,277,277,15,15,0,1,0
0,310,310,56,29,27,2,1
22,372,372,69,39,30,2,1
7,377,377,5,1,4,2,1
13,380,380,32,16,16,3,2
15,399,399,7,7,0,1,0
14,404,404,152,104,48,2,1
12,406,406,19,19,0,1,0
2,437,437,28,28,0,1,0
20,448,448,16,16,0,1,0
10,462,462,12,12,0,1,0
8,464,464,39,39,0,1,0
9,465,465,136,34,102,4,3
16,479,479,10,10,0,1,0

10,120,120,51,5,46,2,1
3,132,132,21,21,0,1,0
6,148,148,12,9,3,2,1
0,166,166,1,1,0,1,0
15,213,213,1,1,0,1,0
1,230,230,39,39,0,1,0
11,268,268,3,3,0,1,0
8,292,292,1,1,0,1,0
4,302,302,66,30,36,3,2
13,356,356,9,9,0,1,0
19,367,367,39,39,0,1,0
2,382,382,41,17,24,4,3
14,392,392,58,58,0,1,0
18,418,418,3,3,0,1,0
5,421,421,106,106,0,1,0
17,424,424,113,83,30,2,1
7,443,443,92,53,39,2,1
16,457,457,69,58,11,2,1
12,459,459,19,19,0,1,0
9,464,464,15,15,0,1,0

5,109,109,7,2,5,2,1
17,124,124,10,10,0,1,0
23,127,127,43,43,0,1,0
24,129,129,18,18,0,1,0
6,134,134,12,3,9,4,3
25,150,150,4,4,0,1,0
10,159,159,18,8,10,3,2
13,164,164,1,1,0,1,0
9,166,166,22,22,0,1,0
20,167,167,10,2,8,2,1
15,175,175,9,9,0,1,0
18,193,193,22,10,12,2,1
3,200,200,4,4,0,1,0
21,236,236,7,7,0,1,0
16,244,244,2,2,0,1,0
26,259,259,13,4,9,4,3
22,285,285,47,4,43,2,1
8,290,290,11,11,0,1,0
14,336,336,93,65,28,3,2
12,345,345,22,22,0,1,0
2,350,350,3,3,0,1,0
7,352,352,20,20,0,1,0
4,359,359,27,27,0,1,0
19,369,369,61,61,0,1,0
0,387,387,12,12,0,1,0
1,406,406,8,8,0,1,0
11,463,463,95,47,48,3,2

11,134,134,11,3,8,2,1
8,135,135,2,2,0,1,0
3,143,143,35,35,0,1,0
28,144,144,16,16,0,1,0
18,144,144,9,5,4,2,1
27,151,151,8,8,0,1,0
15,153,153,2,2,0,1,0
21,164,164,21,21,0,1,0
9,194,194,1,1,0,1,0
23,197,197,9,3,6,2,1
26,232,232,39,36,3,2,1
7,248,248,8,8,0,1,0
6,250,250,10,10,0,1,0
12,250,250,24,24,0,1,0
14,251,251,3,3,0,1,0
13,252,252,55,12,43,4,3
4,263,263,20,1,19,2,1
24,288,288,18,5,13,3,2
10,316,316,56,56,0,1,0
17,329,329,36,31,5,2,1
25,362,362,2,2,0,1,0
2,363,363,13,4,9,2,1
22,369,369,21,5,16,3,2
16,392,392,16,16,0,1,0
20,403,403,104,60,44,3,2
19,408,408,69,6,63,4,3
1,416,416,22,22,0,1,0
5,430,430,23,12,11,2,1
0,451,451,3,3,0,1,0

22,121,121,3,3,0,1,0
3,138,138,4,1,3,2,1
12,153,153,1,1,0,1,0
4,166,166,2,2,0,1,0
13,171,171,4,4,0,1,0
23,189,189,49,1,48,2,1
5,253,253,1,1,0,1,0
25,263,263,15,15,0,1,0
6,274,274,23,3,20,3,2
7,291,291,6,6,0,1,0
20,297,297,11,1,10,3,2
11,304,304,69,40,29,2,1
8,344,344,65,55,10,2,1
15,347,347,7,1,6,2,1
17,350,350,35,6,29,2,1
21,356,356,38,38,0,1,0
1,387,387,90,90,0,1,0
14,391,391,82,20,62,4,3
18,408,408,13,4,9,2,1
16,425,425,74,54,20,2,1
0,427,427,31,23,8,3,2
24,427,427,74,6,68,3,2
10,457,457,90,90,0,1,0
19,470,470,14,6,8,3,2
2,478,478,45,45,0,1,0
9,498,498,6,6,0,1,0

2,108,108,38,38,0,1,0
5,151,151,13,1,12,2,1
4,170,170,1,1,0,1,0
15,176,176,11,11,0,1,0
20,227,227,15,15,0,1,0
21,249,249,21,9,12,3,2
6,250,250,2,2,0,1,0
1,272,272,34,12,22,2,1
12,275,275,16,5,11,2,1
19,280,280,44,44,0,1,0
14,309,309,6,6,0,1,0
9,321,321,79,49,30,3,2
13,322,322,129,129,0,1,0
8,331,331,14,5,9,2,1
10,363,363,54,8,46,2,1
16,370,370,44,44,0,1,0
7,371,371,2,2,0,1,0
0,377,377,3,3,0,1,0
23,377,377,7,7,0,1,0
17,389,389,36,1,35,2,1
11,400,400,60,30,30,3,2
18,414,414,35,35,0,1,0
3,457,457,11,11,0,1,0
22,461,461,26,10,16,2,1

3,169,169,16,10,6,3,2
6,186,186,24,24,0,1,0
7,198,198,24,24,0,1,0
4,217,217,9,6,3,2,1
8,237,237,19,1,18,3,2
12,242,242,8,3,5,2,1
15,251,251,25,11,14,2,1
0,255,255,88,88,0,1,0
9,265,265,13,13,0,1,0
1,286,286,31,6,25,2,1
13,287,287,51,9,42,3,2
11,303,303,21,21,0,1,0
5,311,311,28,28,0,1,0
18,406,406,26,26,0,1,0
2,415,415,80,70,10,2,1
17,436,436,76,56,20,3,2
16,457,457,29,13,16,3,2
20,479,479,6,3,3,2,1
19,480,480,85,28,57,4,3
14,494,494,101,77,24,4,3
10,498,498,49,49,0,1,0

14,109,109,4,4,0,1,0
1,122,122,1,1,0,1,0
3,138,138,3,3,0,1,0
12,155,155,11,11,0,1,0
19,161,161,5,2,3,2,1
24,167,167,39,39,0,1,0
25,172,172,40,40,0,1,0
6,186,186,10,1,9,4,3
20,186,186,45,45,0,1,0
27,192,192,2,2,0,1,0
26,211,211,20,20,0,1,0
15,213,213,2,2,0,1,0
16,253,253,33,22,11,2,1
11,255,255,3,3,0,1,0
22,266,266,18,18,0,1,0
9,281,281,57,57,0,1,0
0,291,291,19,19,0,1,0
5,308,308,13,4,9,2,1
7,321,321,15,3,12,4,3
10,327,327,16,7,9,2,1
2,329,329,1,1,0,1,0
23,358,358,8,2,6,2,1
8,414,414,31,31,0,1,0
17,415,415,33,20,13,4,3
13,428,428,9,2,7,2,1
18,447,447,31,4,27,2,1
21,451,451,3,3,0,1,0
4,497,497,241,231,10,2,1

2,109,109,6,6,0,1,0
22,119,119,29,4,25,2,1
20,124,124,11,11,0,1,0
11,132,132,7,7,0,1,0
12,159,159,33,33,0,1,0
15,240,240,8,8,0,1,0
14,259,259,31,17,14,3,2
21,321,321,4,4,0,1,0
0,333,333,33,10,23,2,1
9,340,340,11,3,8,3,2
7,343,343,98,51,47,2,1
19,343,343,20,9,11,2,1
3,349,349,21,21,0,1,0
8,352,352,3,3,0,1,0
10,380,380,21,12,9,2,1
17,387,387,38,38,0,1,0
1,392,392,139,121,18,3,2
6,404,404,10,10,0,1,0
18,405,405,7,7,0,1,0
16,441,441,11,5,6,2,1
5,447,447,41,41,0,1,0
4,460,460,62,62,0,1,0
13,494,494,128,128,0,1,0

16,103,103,21,18,3,2,1
9,108,108,20,20,0,1,0
14,122,122,10,2,8,3,2
6,130,130,10,10,0,1,0
11,132,132,35,35,0,1,0
15,181,181,1,1,0,1,0
21,192,192,4,4,0,1,0
20,197,197,1,1,0,1,0
18,220,220,36,26,10,3,2
7,271,271,10,10,0,1,0
23,288,288,2,2,0,1,0
5,300,300,4,4,0,1,0
13,322,322,79,4,75,4,3
12,323,323,30,30,0,1,0
2,326,326,14,3,11,4,3
1,341,341,50,50,0,1,0
19,341,341,69,69,0,1,0
17,363,363,20,20,0,1,0
24,373,373,84,84,0,1,0
8,381,381,23,23,0,1,0
3,409,409,57,57,0,1,0
10,422,422,44,44,0,1,0
4,438,438,1,1,0,1,0
0,445,445,16,16,0,1,0
22,469,469,6,6,0,1,0

17,102,102,1,1,0,1,0
8,106,106,2,2,0,1,0
28,106,106,6,6,0,1,0
12,122,122,1,1,0,1,0
15,138,138,12,1,11,3,2
23,159,159,5,5,0,1,0
14,166,166,10,2,8,3,2
21,170,170,5,5,0,1,0
1,177,177,13,4,9,2,1
31,185,185,61,37,24,2,1
30,202,202,15,15,0,1,0
29,204,204,6,3,3,2,1
10,212,212,1,1,0,1,0
24,219,219,3,3,0,1,0
11,227,227,16,3,13,2,1
13,241,241,19,19,0,1,0
4,253,253,26,11,15,4,3
16,255,255,28,19,9,4,3
7,269,269,14,5,9,2,1
25,293,293,68,68,0,1,0
3,302,302,2,2,0,1,0
2,304,304,10,7,3,2,1
0,307,307,1,1,0,1,0
18,313,313,9,4,5,2,1
22,321,321,29,29,0,1,0
5,322,322,12,2,10,3,2
20,342,342,30,12,18,2,1
9,356,356,39,39,0,1,0
19,427,427,92,32,60,3,2
26,440,440,106,106,0,1,0
6,461,461,42,42,0,1,0
27,493,493,3,3,0,1,0

2,107,107,15,8,7,2,1
15,110,110,29,12,17,2,1
19,115,115,12,12,0,1,0
21,153,153,15,15,0,1,0
3,163,163,1,1,0,1,0
18,184,184,11,11,0,1,0
6,208,208,1,1,0,1,0
17,231,231,2,2,0,1,0
20,241,241,4,4,0,1,0
8,243,243,1,1,0,1,0
10,246,246,15,15,0,1,0
5,254,254,44,17,27,4,3
4,261,261,85,31,54,4,3
14,267,267,137,34,103,4,3
16,274,274,14,8,6,2,1
9,322,322,67,67,0,1,0
11,331,331,1,1,0,1,0
13,349,349,7,1,6,3,2
12,362,362,12,12,0,1,0
1,376,376,93,93,0,1,0
7,380,380,14,14,0,1,0
0,446,446,24,6,18,4,3

21,140,140,13,13,0,1,0
18,164,164,2,2,0,1,0
17,170,170,2,2,0,1,0
13,189,189,47,47,0,1,0
20,196,196,8,8,0,1,0
22,201,201,3,3,0,1,0
4,254,254,13,13,0,1,0
15,259,259,22,13,9,2,1
1,266,266,19,19,0,1,0
14,296,296,34,34,0,1,0
7,298,298,28,10,18,2,1
19,300,300,134,27,107,4,3
9,304,304,29,29,0,1,0
10,352,352,50,29,21,4,3
0,359,359,49,34,15,4,3
12,374,374,1,1,0,1,0
3,383,383,89,89,0,1,0
5,424,424,22,13,9,2,1
6,436,436,28,10,18,2,1
2,437,437,59,33,26,2,1
23,446,446,52,44,8,2,1
11,450,450,14,14,0,1,0
8,479,479,46,7,39,4,3
16,481,481,23,23,0,1,0

3,101,101,6,6,0,1,0
12,120,120,3,3,0,1,0
19,134,134,30,30,0,1,0
6,141,141,5,5,0,1,0
1,172,172,29,17,12,4,3
11,198,198,30,30,0,1,0
18,210,210,33,24,9,4,3
10,214,214,18,18,0,1,0
9,218,218,12,6,6,2,1
4,284,284,10,5,5,2,1
2,294,294,82,82,0,1,0
13,301,301,34,34,0,1,0
5,307,307,41,17,24,2,1
16,319,319,2,2,0,1,0
7,324,324,22,22,0,1,0
0,347,347,70,49,21,2,1
14,370,370,20,20,0,1,0
20,371,371,23,23,0,1,0
17,384,384,13,13,0,1,0
8,407,407,68,7,61,3,2
15,439,439,135,42,93,4,3
21,461,461,1,1,0,1,0

18,105,105,4,4,0,1,0
16,119,119,7,7,0,1,0
11,120,120,1,1,0,1,0
19,132,132,23,23,0,1,0
20,145,145,9,9,0,1,0
23,158,158,23,7,16,3,2
0,168,168,11,1,10,3,2
4,168,168,51,15,36,2,1
2,177,177,3,3,0,1,0
24,180,180,16,2,14,3,2
13,203,203,42,42,0,1,0
12,218,218,41,17,24,4,3
17,221,221,35,1,34,4,3
14,232,232,14,2,12,2,1
3,252,252,27,27,0,1,0
9,291,291,56,56,0,1,0
1,293,293,7,7,0,1,0
22,294,294,17,1,16,3,2
6,312,312,2,2,0,1,0
7,316,316,1,1,0,1,0
5,324,324,16,6,10,2,1
25,327,327,68,68,0,1,0
21,428,428,44,18,26,3,2
15,443,443,38,38,0,1,0
10,486,486,1,1,0,1,0
8,496,496,14,14,0,1,0

6,100,100,1,1,0,1,0
5,126,126,5,2,3,2,1
24,133,133,21,21,0,1,0
12,142,142,22,13,9,2,1
16,171,171,2,2,0,1,0
15,191,191,15,7,8,3,2
21,192,192,20,20,0,1,0
17,193,193,5,5,0,1,0
22,196,196,22,2,20,3,2
9,222,222,18,18,0,1,0
3,242,242,5,1,4,2,1
8,258,258,25,25,0,1,0
0,262,262,31,31,0,1,0
7,266,266,18,1,17,2,1
1,271,271,25,25,0,1,0
11,280,280,26,26,0,1,0
18,289,289,16,4,12,3,2
25,361,361,65,65,0,1,0
2,383,383,26,26,0,1,0
19,384,384,31,1,30,4,3
20,396,396,144,45,99,4,3
13,419,419,63,3,60,3,2
23,445,445,1,1,0,1,0
26,467,467,24,10,14,2,1
14,494,494,37,37,0,1,0
10,496,496,39,39,0,1,0
4,499,499,27,24,3,2,1

13,103,103,6,6,0,1,0
11,104,104,15,7,8,2,1
12,128,128,12,12,0,1,0
18,131,131,32,16,16,2,1
8,158,158,13,7,6,2,1
0,160,160,11,1,10,2,1
10,185,185,3,3,0,1,0
22,197,197,4,1,3,2,1
9,228,228,65,25,40,3,2
4,294,294,4,4,0,1,0
14,312,312,15,15,0,1,0
15,315,315,19,19,0,1,0
16,319,319,42,25,17,2,1
21,326,326,81,48,33,4,3
3,346,346,16,16,0,1,0
2,400,400,6,1,5,2,1
20,402,402,15,15,0,1,0
6,451,451,2,2,0,1,0
1,460,460,131,67,64,4,3
17,463,463,62,18,44,3,2
7,467,467,92,83,9,2,1
19,478,478,2,2,0,1,0
5,481,481,90,90,0,1,0

4,120,120,16,1,15,2,1
14,124,124,1,1,0,1,0
12,176,176,23,23,0,1,0
19,204,204,10,10,0,1,0
7,248,248,47,47,0,1,0
21,251,251,119,119,0,1,0
8,254,254,38,11,27,2,1
15,255,255,5,5,0,1,0
5,286,286,38,18,20,3,2
18,299,299,3,3,0,1,0
1,305,305,3,3,0,1,0
11,319,319,3,3,0,1,0
22,327,327,23,3,20,3,2
13,352,352,36,17,19,4,3
17,360,360,7,7,0,1,0
10,364,364,25,25,0,1,0
2,385,385,17,2,15,2,1
9,401,401,40,40,0,1,0
20,417,417,69,69,0,1,0
3,420,420,30,30,0,1,0
0,422,422,94,94,0,1,0
23,424,424,62,15,47,2,1
6,429,429,30,30,0,1,0
16,486,486,16,4,12,4,3

11,100,100,46,46,0,1,0
4,106,106,29,29,0,1,0
18,121,121,9,9,0,1,0
17,145,145,7,7,0,1,0
5,166,166,21,21,0,1,0
15,189,189,22,14,8,2,1
0,198,198,4,4,0,1,0
6,219,219,8,8,0,1,0
8,225,225,32,32,0,1,0
20,247,247,40,40,0,1,0
19,248,248,1,1,0,1,0
7,253,253,111,90,21,4,3
13,274,274,41,41,0,1,0
22,287,287,28,28,0,1,0
1,293,293,18,18,0,1,0
14,309,309,5,5,0,1,0
2,344,344,25,25,0,1,0
21,351,351,1,1,0,1,0
3,362,362,1,1,0,1,0
16,384,384,24,24,0,1,0
12,452,452,14,5,9,4,3
10,464,464,9,9,0,1,0
9,477,477,3,3,0,1,0

13,102,102,11,3,8,3,2
22,164,164,6,6,0,1,0
2,165,165,1,1,0,1,0
23,181,181,28,16,12,3,2
19,211,211,12,12,0,1,0
10,212,212,28,1,27,2,1
17,216,216,19,19,0,1,0
1,254,254,49,37,12,3,2
21,266,266,16,10,6,3,2
8,276,276,3,3,0,1,0
16,284,284,4,4,0,1,0
0,287,287,39,39,0,1,0
20,302,302,8,3,5,2,1
14,312,312,40,17,23,2,1
5,313,313,9,1,8,3,2
11,334,334,16,1,15,4,3
7,374,374,29,13,16,3,2
3,384,384,77,77,0,1,0
4,401,401,31,14,17,3,2
15,406,406,59,59,0,1,0
18,420,420,100,55,45,4,3
9,445,445,67,49,18,2,1
12,489,489,82,82,0,1,0
6,493,493,70,66,4,2,1

22,113,113,21,12,9,4,3
4,160,160,71,39,32,2,1
5,163,163,3,3,0,1,0
19,179,179,31,31,0,1,0
10,201,201,7,4,3,2,1
23,232,232,6,3,3,2,1
14,233,233,4,4,0,1,0
24,234,234,4,4,0,1,0
15,247,247,2,2,0,1,0
17,268,268,41,41,0,1,0
11,292,292,20,10,10,4,3
8,303,303,5,5,0,1,0
9,331,331,10,2,8,3,2
6,335,335,15,15,0,1,0
0,350,350,27,11,16,3,2
7,365,365,43,43,0,1,0
13,373,373,54,24,30,4,3
12,393,393,107,68,39,4,3
16,440,440,64,22,42,4,3
3,469,469,7,7,0,1,0
2,476,476,9,4,5,2,1
20,479,479,3,3,0,1,0
21,484,484,166,133,33,2,1
18,497,497,3,3,0,1,0
1,499,499,21,21,0,1,0

2,101,101,2,2,0,1,0
9,104,104,8,8,0,1,0
14,207,207,12,12,0,1,0
20,236,236,14,6,8,3,2
10,261,261,42,30,12,3,2
7,264,264,19,3,16,3,2
6,306,306,13,5,8,3,2
13,325,325,66,12,54,4,3
18,338,338,20,4,16,3,2
4,370,370,57,41,16,3,2
1,378,378,75,63,12,3,2
19,392,392,133,4,129,4,3
0,397,397,85,44,41,2,1
22,418,418,35,35,0,1,0
12,420,420,3,3,0,1,0
17,425,425,141,61,80,3,2
11,436,436,7,2,5,2,1
15,453,453,12,9,3,2,1
16,466,466,9,9,0,1,0
5,473,473,26,14,12,2,1
8,474,474,97,83,14,2,1
21,480,480,6,3,3,2,1
3,486,486,1,1,0,1,0

21,182,182,26,26,0,1,0
0,198,198,12,12,0,1,0
18,201,201,13,13,0,1,0
12,215,215,2,2,0,1,0
22,216,216,13,13,0,1,0
15,248,248,56,15,41,2,1
17,260,260,7,7,0,1,0
23,278,278,13,7,6,2,1
8,281,281,1,1,0,1,0
1,306,306,44,3,41,4,3
7,316,316,3,3,0,1,0
10,329,329,22,17,5,2,1
13,335,335,51,13,38,2,1
3,339,339,36,36,0,1,0
20,352,352,42,9,33,4,3
16,354,354,4,4,0,1,0
11,379,379,46,26,20,3,2
6,395,395,3,3,0,1,0
5,397,397,67,25,42,3,2
4,398,398,32,32,0,1,0
19,408,408,56,56,0,1,0
2,412,412,172,107,65,4,3
14,490,490,111,19,92,3,2
9,500,500,8,8,0,1,0

10,142,142,9,9,0,1,0
11,151,151,3,3,0,1,0
20,154,154,33,17,16,3,2
17,160,160,26,6,20,3,2
15,164,164,10,10,0,1,0
1,169,169,5,5,0,1,0
14,185,185,36,24,12,3,2
8,190,190,13,6,7,2,1
6,208,208,30,30,0,1,0
12,226,226,25,25,0,1,0
2,265,265,3,3,0,1,0
19,296,296,30,30,0,1,0
13,299,299,1,1,0,1,0
16,331,331,74,74,0,1,0
21,370,370,3,3,0,1,0
9,391,391,6,1,5,2,1
0,418,418,168,144,24,4,3
4,451,451,130,130,0,1,0
5,459,459,74,74,0,1,0
7,479,479,29,29,0,1,0
18,482,482,31,31,0,1,0
3,493,493,10,6,4,2,1

13,114,114,2,2,0,1,0
15,145,145,3,3,0,1,0
6,147,147,2,2,0,1,0
21,215,215,36,36,0,1,0
14,222,222,16,16,0,1,0
1,231,231,46,25,21,2,1
24,256,256,25,6,19,2,1
18,279,279,4,4,0,1,0
25,297,297,92,92,0,1,0
10,310,310,41,1,40,3,2
22,310,310,6,6,0,1,0
17,335,335,42,42,0,1,0
7,336,336,22,22,0,1,0
2,350,350,45,45,0,1,0
11,367,367,18,18,0,1,0
8,373,373,10,10,0,1,0
0,374,374,2,2,0,1,0
20,386,386,19,19,0,1,0
26,387,387,14,14,0,1,0
27,395,395,109,36,73,4,3
23,417,417,41,41,0,1,0
5,429,429,50,39,11,2,1
12,429,429,33,33,0,1,0
19,440,440,4,4,0,1,0
16,443,443,46,46,0,1,0
3,459,459,50,50,0,1,0
4,463,463,24,24,0,1,0
28,464,464,10,1,9,4,3
9,469,469,6,6,0,1,0

4,101,101,4,4,0,1,0
7,114,114,1,1,0,1,0
1,115,115,8,8,0,1,0
0,124,124,5,5,0,1,0
14,132,132,18,13,5,2,1
10,145,145,12,12,0,1,0
17,154,154,2,2,0,1,0
15,175,175,11,8,3,2,1
20,187,187,33,5,28,2,1
8,205,205,10,10,0,1,0
3,244,244,7,7,0,1,0
2,266,266,11,6,5,2,1
24,273,273,13,1,12,3,2
5,287,287,105,55,50,2,1
23,296,296,10,7,3,2,1
18,331,331,23,6,17,2,1
19,332,332,20,5,15,4,3
22,348,348,17,8,9,4,3
16,400,400,53,53,0,1,0
21,405,405,138,138,0,1,0
9,415,415,36,3,33,4,3
6,443,443,23,23,0,1,0
12,449,449,44,20,24,4,3
11,460,460,110,110,0,1,0
13,497,497,54,54,0,1,0

10,102,102,1,1,0,1,0
23,105,105,1,1,0,1,0
17,121,121,43,43,0,1,0
6,132,132,15,15,0,1,0
9,153,153,1,1,0,1,0
15,154,154,1,1,0,1,0
13,160,160,7,4,3,2,1
2,168,168,39,18,21,2,1
19,189,189,6,6,0,1,0
24,201,201,7,7,0,1,0
26,208,208,8,8,0,1,0
21,227,227,18,4,14,2,1
11,305,305,5,5,0,1,0
16,318,318,19,19,0,1,0
3,346,346,30,7,23,4,3
25,360,360,125,125,0,1,0
8,363,363,35,35,0,1,0
18,378,378,49,6,43,4,3
4,417,417,12,12,0,1,0
12,421,421,10,4,6,2,1
7,427,427,23,5,18,4,3
14,450,450,7,7,0,1,0
22,461,461,36,32,4,2,1
5,480,480,47,17,30,2,1
0,483,483,36,36,0,1,0
1,487,487,147,93,54,4,3
20,495,495,30,30,0,1,0

2,100,100,6,6,0,1,0
20,133,133,1,1,0,1,0
3,162,162,13,7,6,3,2
24,181,181,12,12,0,1,0
26,195,195,32,27,5,2,1
14,216,216,9,9,0,1,0
27,221,221,86,86,0,1,0
18,227,227,28,28,0,1,0
11,234,234,43,43,0,1,0
8,264,264,20,9,11,2,1
9,282,282,4,4,0,1,0
5,286,286,3,3,0,1,0
21,290,290,1,1,0,1,0
10,312,312,35,35,0,1,0
1,313,313,1,1,0,1,0
23,321,321,54,54,0,1,0
7,325,325,7,7,0,1,0
17,329,329,10,5,5,2,1
4,340,340,54,30,24,4,3
6,345,345,2,2,0,1,0
19,361,361,1,1,0,1,0
12,431,431,20,20,0,1,0
22,449,449,66,66,0,1,0
25,450,450,27,27,0,1,0
0,465,465,66,12,54,3,2
13,466,466,45,39,6,2,1
16,489,489,28,16,12,2,1
15,496,496,74,55,19,2,1

7,112,112,5,2,3,2,1
10,138,138,6,6,0,1,0
12,153,153,7,7,0,1,0
6,209,209,7,7,0,1,0
18,219,219,2,2,0,1,0
23,233,233,39,5,34,2,1
9,245,245,42,42,0,1,0
16,253,253,50,33,17,2,1
8,262,262,12,12,0,1,0
21,263,263,54,54,0,1,0
3,287,287,66,9,57,4,3
26,298,298,2,2,0,1,0
4,320,320,58,58,0,1,0
5,322,322,11,11,0,1,0
15,327,327,26,26,0,1,0
19,332,332,58,13,45,4,3
2,333,333,11,11,0,1,0
11,385,385,33,33,0,1,0
25,389,389,17,1,16,2,1
27,389,389,13,13,0,1,0
20,406,406,31,31,0,1,0
22,411,411,92,92,0,1,0
13,415,415,1,1,0,1,0
0,423,423,10,10,0,1,0
24,431,431,12,12,0,1,0
17,433,433,24,24,0,1,0
1,436,436,47,39,8,2,1
14,459,459,18,7,11,2,1

13,124,124,1,1,0,1,0
21,131,131,3,3,0,1,0
9,194,194,19,1,18,4,3
6,208,208,11,11,0,1,0
19,240,240,10,10,0,1,0
18,241,241,27,27,0,1,0
8,249,249,53,53,0,1,0
15,260,260,94,84,10,3,2
11,265,265,16,13,3,2,1
7,269,269,79,23,56,3,2
14,283,283,10,10,0,1,0
0,301,301,16,4,12,3,2
12,312,312,76,76,0,1,0
5,318,318,84,54,30,4,3
17,362,362,27,8,19,4,3
1,371,371,78,66,12,3,2
4,400,400,1,1,0,1,0
2,412,412,1,1,0,1,0
16,436,436,70,22,48,2,1
20,444,444,27,3,24,4,3
10,446,446,18,18,0,1,0
3,497,497,6,6,0,1,0

13,100,100,15,8,7,2,1
23,153,153,20,20,0,1,0
10,157,157,18,2,16,2,1
8,161,161,3,3,0,1,0
11,161,161,30,30,0,1,0
14,167,167,6,6,0,1,0
26,168,168,18,18,0,1,0
27,173,173,22,22,0,1,0
18,175,175,38,38,0,1,0
2,197,197,4,1,3,2,1
5,228,228,3,3,0,1,0
21,238,238,7,1,6,3,2
22,241,241,13,13,0,1,0
15,266,266,1,1,0,1,0
28,266,266,47,47,0,1,0
25,288,288,21,7,14,3,2
0,308,308,45,45,0,1,0
17,320,320,21,21,0,1,0
3,347,347,2,2,0,1,0
16,356,356,3,3,0,1,0
19,373,373,8,2,6,3,2
12,376,376,13,13,0,1,0
9,392,392,33,5,28,2,1
6,413,413,46,46,0,1,0
24,439,439,56,56,0,1,0
20,465,465,47,17,30,2,1
1,474,474,1,1,0,1,0
7,477,477,66,58,8,2,1
4,488,488,63,63,0,1,0

12,110,110,1,1,0,1,0
2,124,124,1,1,0,1,0
21,144,144,3,3,0,1,0
6,148,148,1,1,0,1,0
15,158,158,7,7,0,1,0
14,177,177,36,14,22,2,1
20,201,201,11,11,0,1,0
0,214,214,48,16,32,3,2
11,235,235,11,2,9,2,1
19,245,245,3,3,0,1,0
18,245,245,8,2,6,3,2
7,287,287,22,5,17,3,2
17,298,298,98,14,84,4,3
5,319,319,1,1,0,1,0
9,331,331,37,25,12,4,3
1,357,357,53,17,36,3,2
16,360,360,12,12,0,1,0
8,361,361,201,105,96,4,3
13,392,392,113,83,30,4,3
10,405,405,62,62,0,1,0
3,405,405,17,17,0,1,0
4,448,448,11,11,0,1,0

1,103,103,2,2,0,1,0
2,115,115,7,7,0,1,0
15,115,115,13,13,0,1,0
4,116,116,7,7,0,1,0
14,118,118,4,4,0,1,0
7,121,121,17,17,0,1,0
13,131,131,11,1,10,3,2
20,144,144,22,22,0,1,0
0,167,167,41,20,21,4,3
16,190,190,32,32,0,1,0
18,207,207,3,3,0,1,0
23,229,229,10,10,0,1,0
24,231,231,34,34,0,1,0
17,234,234,37,25,12,4,3
9,247,247,15,15,0,1,0
10,254,254,11,7,4,2,1
21,274,274,42,24,18,2,1
11,288,288,18,18,0,1,0
6,289,289,7,1,6,3,2
3,306,306,26,16,10,2,1
8,323,323,27,18,9,4,3
22,323,323,31,31,0,1,0
19,362,362,26,12,14,2,1
12,404,404,5,5,0,1,0
5,429,429,130,14,116,4,3

19,140,140,18,10,8,2,1
25,151,151,50,50,0,1,0
13,159,159,9,9,0,1,0
27,166,166,6,3,3,2,1
29,168,168,16,6,10,3,2
8,172,172,4,4,0,1,0
28,176,176,27,12,15,2,1
20,191,191,22,22,0,1,0
10,214,214,10,2,8,3,2
5,226,226,6,6,0,1,0
0,241,241,13,4,9,4,3
23,266,266,13,1,12,2,1
4,275,275,5,2,3,2,1
7,292,292,18,2,16,3,2
18,317,317,23,23,0,1,0
21,324,324,56,56,0,1,0
2,342,342,11,11,0,1,0
22,342,342,12,5,7,2,1
12,359,359,1,1,0,1,0
30,364,364,7,4,3,2,1
6,371,371,31,31,0,1,0
26,393,393,13,13,0,1,0
1,407,407,3,3,0,1,0
3,413,413,29,29,0,1,0
24,414,414,23,6,17,2,1
9,438,438,99,15,84,3,2
17,453,453,77,77,0,1,0
16,460,460,21,21,0,1,0
14,467,467,19,19,0,1,0
11,472,472,29,2,27,3,2
15,481,481,49,49,0,1,0

0,123,123,9,9,0,1,0
1,126,126,4,4,0,1,0
16,132,132,21,6,15,2,1
6,161,161,1,1,0,1,0
12,184,184,9,9,0,1,0
14,194,194,24,24,0,1,0
7,214,214,2,2,0,1,0
8,267,267,1,1,0,1,0
13,282,282,4,1,3,2,1
4,295,295,115,115,0,1,0
10,311,311,5,5,0,1,0
21,314,314,93,93,0,1,0
5,321,321,56,2,54,4,3
20,321,321,16,6,10,3,2
11,328,328,50,36,14,3,2
22,335,335,72,26,46,3,2
18,352,352,11,3,8,3,2
9,371,371,64,64,0,1,0
3,393,393,58,26,32,2,1
19,412,412,20,5,15,2,1
2,429,429,11,11,0,1,0
23,451,451,94,64,30,2,1
15,496,496,8,3,5,2,1
17,499,499,8,5,3,2,1

21,157,157,9,9,0,1,0
3,176,176,22,4,18,4,3
0,179,179,6,6,0,1,0
2,184,184,1,1,0,1,0
8,191,191,102,84,18,4,3
13,194,194,28,28,0,1,0
12,197,197,18,18,0,1,0
4,220,220,3,3,0,1,0
10,246,246,26,3,23,2,1
20,282,282,36,2,34,2,1
1,295,295,55,55,0,1,0
5,299,299,2,2,0,1,0
16,305,305,56,2,54,4,3
18,307,307,40,4,36,4,3
14,359,359,6,2,4,2,1
22,384,384,49,1,48,4,3
15,391,391,20,20,0,1,0
7,404,404,5,1,4,2,1
11,449,449,12,7,5,2,1
17,459,459,45,41,4,2,1
19,477,477,76,64,12,3,2
9,483,483,2,2,0,1,0
6,485,485,85,70,15,2,1

6,101,101,1,1,0,1,0
8,114,114,2,2,0,1,0
0,130,130,11,11,0,1,0
18,134,134,1,1,0,1,0
10,138,138,20,15,5,2,1
16,154,154,12,12,0,1,0
4,178,178,1,1,0,1,0
21,182,182,86,54,32,3,2
19,210,210,37,18,19,2,1
7,218,218,28,3,25,2,1
9,226,226,5,1,4,2,1
24,242,242,8,8,0,1,0
3,244,244,22,22,0,1,0
20,271,271,1,1,0,1,0
23,274,274,12,5,7,2,1
22,289,289,8,8,0,1,0
2,303,303,17,17,0,1,0
14,314,314,9,9,0,1,0
12,329,329,1,1,0,1,0
15,342,342,12,12,0,1,0
1,348,348,100,37,63,4,3
13,366,366,21,1,20,2,1
26,412,412,35,22,13,2,1
25,434,434,34,5,29,4,3
11,467,467,15,2,13,2,1
17,481,481,89,49,40,4,3
5,489,489,115,7,108,4,3

22,128,128,15,15,0,1,0
13,149,149,9,1,8,2,1
1,157,157,24,14,10,2,1
10,208,208,40,16,24,2,1
23,237,237,11,11,0,1,0
11,251,251,36,36,0,1,0
3,277,277,46,30,16,2,1
7,277,277,5,5,0,1,0
17,283,283,11,3,8,2,1
24,285,285,82,70,12,3,2
12,293,293,10,10,0,1,0
4,324,324,47,47,0,1,0
20,325,325,1,1,0,1,0
2,326,326,47,41,6,3,2
6,330,330,39,39,0,1,0
5,343,343,3,3,0,1,0
14,352,352,52,36,16,3,2
18,377,377,83,56,27,2,1
0,379,379,1,1,0,1,0
16,407,407,12,3,9,4,3
15,410,410,44,44,0,1,0
8,413,413,25,25,0,1,0
19,421,421,52,32,20,2,1
9,425,425,6,6,0,1,0
21,478,478,20,16,4,2,1

25,113,113,20,8,12,3,2
13,128,128,1,1,0,1,0
23,143,143,16,13,3,2,1
18,146,146,5,5,0,1,0
1,158,158,34,12,22,3,2
6,163,163,17,17,0,1,0
20,196,196,6,6,0,1,0
24,231,231,46,46,0,1,0
3,246,246,30,30,0,1,0
12,263,263,11,11,0,1,0
2,264,264,8,8,0,1,0
11,273,273,10,10,0,1,0
4,281,281,61,31,30,3,2
7,299,299,7,7,0,1,0
21,303,303,4,4,0,1,0
15,319,319,23,17,6,2,1
22,324,324,11,11,0,1,0
10,324,324,16,16,0,1,0
8,326,326,15,15,0,1,0
0,394,394,33,11,22,2,1
9,407,407,9,2,7,2,1
16,414,414,84,56,28,3,2
5,429,429,87,87,0,1,0
19,446,446,96,84,12,3,2
14,467,467,9,9,0,1,0
17,489,489,56,8,48,3,2

3,105,105,15,6,9,2,1
13,125,125,3,3,0,1,0
0,128,128,1,1,0,1,0
8,132,132,8,8,0,1,0
16,160,160,10,10,0,1,0
1,165,165,12,3,9,4,3
17,184,184,12,6,6,3,2
24,193,193,9,9,0,1,0
19,207,207,56,56,0,1,0
11,229,229,45,14,31,2,1
6,248,248,11,11,0,1,0
9,251,251,13,13,0,1,0
20,256,256,31,31,0,1,0
10,261,261,74,10,64,4,3
5,271,271,10,10,0,1,0
22,283,283,41,41,0,1,0
4,302,302,20,2,18,4,3
18,330,330,28,4,24,2,1
15,348,348,7,7,0,1,0
12,388,388,39,27,12,4,3
23,422,422,12,12,0,1,0
7,454,454,56,56,0,1,0
14,462,462,4,4,0,1,0
2,468,468,7,7,0,1,0
21,500,500,176,164,12,4,3

26,105,105,22,15,7,2,1
15,120,120,3,3,0,1,0
8,127,127,28,28,0,1,0
14,131,131,5,2,3,2,1
12,178,178,1,1,0,1,0
17,201,201,39,23,16,3,2
13,214,214,12,9,3,2,1
7,216,216,3,3,0,1,0
21,221,221,10,2,8,2,1
16,224,224,9,9,0,1,0
5,234,234,32,12,20,2,1
25,246,246,54,54,0,1,0
4,254,254,36,24,12,2,1
9,263,263,17,17,0,1,0
0,275,275,2,2,0,1,0
1,302,302,35,15,20,3,2
6,330,330,19,19,0,1,0
11,339,339,49,49,0,1,0
3,356,356,14,14,0,1,0
23,406,406,4,4,0,1,0
10,417,417,38,38,0,1,0
20,424,424,18,8,10,3,2
18,429,429,103,103,0,1,0
22,441,441,48,48,0,1,0
19,443,443,17,17,0,1,0
24,457,457,22,13,9,2,1
2,488,488,34,34,0,1,0

14,109,109,18,6,12,3,2
12,110,110,2,2,0,1,0
13,113,113,5,5,0,1,0
2,131,131,34,34,0,1,0
20,145,145,42,39,3,2,1
21,147,147,9,9,0,1,0
6,157,157,25,12,13,2,1
7,181,181,6,2,4,2,1
24,205,205,19,19,0,1,0
0,205,205,10,10,0,1,0
5,206,206,62,62,0,1,0
3,214,214,1,1,0,1,0
23,224,224,17,17,0,1,0
10,235,235,15,15,0,1,0
18,237,237,4,1,3,2,1
16,252,252,12,1,11,4,3
15,266,266,40,40,0,1,0
17,353,353,3,3,0,1,0
8,385,385,70,40,30,4,3
4,385,385,12,12,0,1,0
1,392,392,4,4,0,1,0
19,393,393,45,3,42,3,2
22,434,434,69,45,24,4,3
11,458,458,43,43,0,1,0
9,496,496,1,1,0,1,0

8,110,110,14,14,0,1,0
21,125,125,13,7,6,3,2
2,134,134,1,1,0,1,0
17,137,137,10,6,4,2,1
15,153,153,18,6,12,4,3
18,164,164,6,6,0,1,0
3,174,174,64,56,8,3,2
4,190,190,26,26,0,1,0
11,205,205,51,3,48,2,1
20,210,210,2,2,0,1,0
7,223,223,5,5,0,1,0
5,227,227,56,56,0,1,0
13,228,228,13,7,6,3,2
16,231,231,17,17,0,1,0
14,278,278,33,33,0,1,0
6,339,339,10,10,0,1,0
19,396,396,67,67,0,1,0
12,402,402,71,38,33,4,3
1,402,402,70,46,24,4,3
0,447,447,34,34,0,1,0
10,469,469,18,13,5,2,1
9,470,470,6,6,0,1,0

1,148,148,18,18,0,1,0
9,157,157,6,2,4,2,1
0,157,157,14,8,6,2,1
19,171,171,32,32,0,1,0
21,174,174,16,16,0,1,0
29,217,217,12,5,7,2,1
10,217,217,11,3,8,3,2
27,248,248,18,18,0,1,0
3,257,257,18,18,0,1,0
14,257,257,36,4,32,4,3
4,269,269,1,1,0,1,0
13,274,274,18,6,12,2,1
26,279,279,23,23,0,1,0
16,283,283,11,7,4,2,1
22,305,305,1,1,0,1,0
15,313,313,20,20,0,1,0
8,330,330,41,25,16,2,1
24,348,348,38,6,32,2,1
28,349,349,78,37,41,2,1
18,352,352,126,76,50,2,1
12,356,356,51,51,0,1,0
20,372,372,2,2,0,1,0
11,387,387,1,1,0,1,0
5,389,389,16,16,0,1,0
6,401,401,7,3,4,2,1
2,416,416,23,23,0,1,0
25,449,449,15,15,0,1,0
7,454,454,58,58,0,1,0
23,455,455,1,1,0,1,0
17,481,481,4,4,0,1,0

8,108,108,1,1,0,1,0
15,115,115,14,8,6,2,1
18,120,120,13,5,8,3,2
17,150,150,19,4,15,4,3
1,161,161,28,19,9,4,3
4,185,185,47,47,0,1,0
16,187,187,9,4,5,2,1
19,212,212,51,51,0,1,0
5,224,224,10,3,7,2,1
14,224,224,13,3,10,2,1
21,260,260,7,7,0,1,0
20,270,270,44,44,0,1,0
3,277,277,51,3,48,4,3
24,302,302,44,44,0,1,0
6,318,318,46,4,42,4,3
23,325,325,18,8,10,2,1
12,330,330,36,36,0,1,0
7,340,340,27,9,18,3,2
11,350,350,3,3,0,1,0
13,355,355,18,18,0,1,0
2,356,356,22,22,0,1,0
10,372,372,13,13,0,1,0
9,403,403,29,29,0,1,0
0,413,413,10,10,0,1,0
22,465,465,36,36,0,1,0

23,113,113,23,23,0,1,0
9,128,128,3,3,0,1,0
18,157,157,43,13,30,4,3
14,168,168,30,30,0,1,0
11,168,168,1,1,0,1,0
25,220,220,20,20,0,1,0
13,273,273,43,43,0,1,0
4,278,278,16,16,0,1,0
15,298,298,36,10,26,2,1
7,312,312,10,10,0,1,0
22,322,322,2,2,0,1,0
6,332,332,34,34,0,1,0
12,353,353,13,2,11,2,1
24,366,366,24,24,0,1,0
21,367,367,89,89,0,1,0
19,375,375,2,2,0,1,0
26,390,390,14,9,5,2,1
1,397,397,12,12,0,1,0
17,402,402,20,10,10,3,2
16,413,413,50,50,0,1,0
8,422,422,106,76,30,3,2
0,447,447,36,36,0,1,0
20,459,459,1,1,0,1,0
10,468,468,16,1,15,2,1
3,469,469,60,60,0,1,0
2,476,476,34,34,0,1,0
5,480,480,7,7,0,1,0

1,102,102,4,4,0,1,0
17,104,104,7,3,4,2,1
15,109,109,3,3,0,1,0
10,115,115,1,1,0,1,0
2,122,122,39,12,27,3,2
23,126,126,24,12,12,3,2
18,136,136,23,3,20,2,1
24,183,183,6,6,0,1,0
16,184,184,17,9,8,3,2
3,194,194,14,6,8,2,1
21,211,211,16,8,8,3,2
22,211,211,6,6,0,1,0
20,226,226,19,4,15,2,1
19,238,238,11,11,0,1,0
6,243,243,8,8,0,1,0
12,251,251,50,50,0,1,0
14,295,295,41,21,20,2,1
7,341,341,10,10,0,1,0
5,345,345,37,37,0,1,0
13,364,364,100,100,0,1,0
11,384,384,65,23,42,3,2
4,426,426,38,8,30,2,1
9,443,443,13,5,8,3,2
0,463,463,15,15,0,1,0
8,472,472,34,20,14,3,2

21,111,111,10,10,0,1,0
0,118,118,16,6,10,3,2
1,127,127,2,2,0,1,0
19,173,173,1,1,0,1,0
22,179,179,1,1,0,1,0
9,183,183,71,25,46,3,2
14,184,184,10,4,6,3,2
10,194,194,20,20,0,1,0
20,201,201,19,19,0,1,0
8,226,226,5,5,0,1,0
23,247,247,7,7,0,1,0
11,248,248,21,1,20,2,1
5,280,280,37,37,0,1,0
17,288,288,151,151,0,1,0
18,302,302,13,3,10,2,1
12,344,344,34,34,0,1,0
4,344,344,5,5,0,1,0
16,353,353,12,4,8,3,2
3,384,384,2,2,0,1,0
15,389,389,88,10,78,3,2
6,419,419,71,47,24,3,2
13,456,456,9,9,0,1,0
7,458,458,6,6,0,1,0
2,490,490,58,58,0,1,0

4,106,106,2,2,0,1,0
0,107,107,32,32,0,1,0
22,107,107,10,10,0,1,0
16,118,118,14,5,9,4,3
3,123,123,17,17,0,1,0
12,124,124,19,9,10,3,2
20,128,128,15,15,0,1,0
15,130,130,14,7,7,3,2
23,173,173,6,6,0,1,0
13,174,174,1,1,0,1,0
21,222,222,4,4,0,1,0
9,225,225,2,2,0,1,0
17,228,228,13,13,0,1,0
10,231,231,10,3,7,2,1
7,257,257,37,37,0,1,0
24,261,261,7,7,0,1,0
5,269,269,42,42,0,1,0
25,287,287,14,14,0,1,0
11,289,289,7,7,0,1,0
2,307,307,27,8,19,2,1
1,315,315,22,17,5,2,1
8,325,325,7,7,0,1,0
6,332,332,3,3,0,1,0
18,360,360,78,72,6,2,1
14,387,387,8,2,6,3,2
26,413,413,150,138,12,2,1
19,432,432,19,1,18,4,3

12,106,106,20,13,7,2,1
22,121,121,17,17,0,1,0
11,126,126,2,2,0,1,0
16,138,138,1,1,0,1,0
0,155,155,14,4,10,2,1
8,164,164,12,12,0,1,0
17,183,183,8,2,6,2,1
20,223,223,4,1,3,2,1
7,268,268,20,5,15,2,1
9,272,272,18,18,0,1,0
18,279,279,15,15,0,1,0
1,330,330,20,20,0,1,0
4,333,333,59,7,52,3,2
13,337,337,11,11,0,1,0
10,357,357,23,19,4,2,1
14,360,360,45,45,0,1,0
21,361,361,10,4,6,3,2
15,369,369,135,6,129,4,3
23,372,372,16,8,8,2,1
6,373,373,20,20,0,1,0
19,389,389,70,46,24,2,1
3,466,466,69,48,21,4,3
2,467,467,144,38,106,4,3
5,479,479,33,23,10,3,2

14,100,100,8,1,7,2,1
16,111,111,4,4,0,1,0
1,114,114,1,1,0,1,0
6,118,118,2,2,0,1,0
0,122,122,2,2,0,1,0
30,145,145,17,2,15,4,3
22,158,158,18,8,10,3,2
20,167,167,17,11,6,2,1
2,170,170,8,8,0,1,0
12,172,172,12,12,0,1,0
23,182,182,1,1,0,1,0
31,194,194,2,2,0,1,0
7,231,231,20,15,5,2,1
8,238,238,10,10,0,1,0
21,247,247,58,58,0,1,0
25,256,256,38,35,3,2,1
18,288,288,22,7,15,4,3
26,294,294,6,3,3,2,1
4,306,306,5,5,0,1,0
13,314,314,12,12,0,1,0
27,363,363,26,4,22,3,2
11,372,372,43,1,42,4,3
17,381,381,4,1,3,2,1
5,403,403,34,34,0,1,0
15,422,422,16,10,6,3,2
3,441,441,4,4,0,1,0
10,456,456,29,29,0,1,0
19,462,462,27,23,4,2,1
24,465,465,78,44,34,3,2
29,466,466,95,6,89,3,2
9,469,469,135,125,10,2,1
28,480,480,17,17,0,1,0

14,107,107,1,1,0,1,0
19,122,122,8,8,0,1,0
4,130,130,6,6,0,1,0
12,135,135,1,1,0,1,0
8,141,141,10,4,6,2,1
0,151,151,2,2,0,1,0
9,185,185,3,3,0,1,0
1,197,197,57,57,0,1,0
25,211,211,14,2,12,3,2
13,224,224,25,15,10,3,2
10,248,248,13,13,0,1,0
11,256,256,12,12,0,1,0
18,265,265,33,19,14,3,2
17,271,271,40,40,0,1,0
27,284,284,42,6,36,4,3
22,300,300,23,23,0,1,0
26,306,306,17,17,0,1,0
23,307,307,5,1,4,2,1
24,328,328,54,20,34,3,2
16,337,337,34,1,33,4,3
2,341,341,119,119,0,1,0
15,364,364,10,10,0,1,0
21,367,367,81,72,9,4,3
5,377,377,36,16,20,2,1
7,402,402,12,12,0,1,0
20,407,407,15,3,12,2,1
3,408,408,1,1,0,1,0
6,446,446,15,4,11,2,1

4,132,132,13,13,0,1,0
8,139,139,24,4,20,2,1
1,154,154,21,18,3,2,1
5,178,178,5,5,0,1,0
22,180,180,9,9,0,1,0
18,204,204,21,21,0,1,0
7,209,209,7,7,0,1,0
9,215,215,11,7,4,2,1
6,229,229,4,1,3,2,1
2,257,257,12,12,0,1,0
3,263,263,23,2,21,2,1
14,276,276,86,59,27,3,2
0,281,281,23,9,14,2,1
10,292,292,18,14,4,2,1
12,300,300,52,52,0,1,0
16,326,326,36,5,31,2,1
23,329,329,1,1,0,1,0
15,333,333,1,1,0,1,0
25,337,337,18,4,14,3,2
17,360,360,13,13,0,1,0
21,376,376,38,32,6,3,2
13,406,406,42,42,0,1,0
19,462,462,11,1,10,2,1
24,464,464,95,83,12,3,2
11,471,471,51,51,0,1,0
20,481,481,109,64,45,4,3

22,119,119,8,8,0,1,0
4,127,127,1,1,0,1,0
17,132,132,1,1,0,1,0
23,136,136,4,4,0,1,0
14,178,178,11,11,0,1,0
3,185,185,29,29,0,1,0
9,193,193,23,18,5,2,1
20,205,205,15,3,12,4,3
16,209,209,18,3,15,2,1
13,275,275,9,9,0,1,0
0,276,276,63,63,0,1,0
7,296,296,4,4,0,1,0
11,302,302,41,41,0,1,0
5,303,303,16,16,0,1,0
6,306,306,8,8,0,1,0
27,321,321,38,34,4,2,1
25,347,347,15,3,12,2,1
19,350,350,37,18,19,2,1
12,358,358,1,1,0,1,0
24,366,366,36,6,30,2,1
8,381,381,66,51,15,4,3
10,388,388,1,1,0,1,0
2,452,452,24,12,12,4,3
1,457,457,33,13,20,3,2
18,458,458,68,68,0,1,0
15,477,477,30,30,0,1,0
26,485,485,26,11,15,2,1
21,500,500,200,168,32,4,3

20,106,106,30,30,0,1,0
4,114,114,17,17,0,1,0
12,116,116,5,5,0,1,0
14,122,122,18,18,0,1,0
16,134,134,7,7,0,1,0
0,139,139,1,1,0,1,0
11,214,214,20,20,0,1,0
21,221,221,34,34,0,1,0
18,236,236,9,9,0,1,0
15,273,273,11,11,0,1,0
10,313,313,62,12,50,3,2
7,315,315,52,52,0,1,0
5,317,317,11,11,0,1,0
22,330,330,9,9,0,1,0
13,336,336,89,89,0,1,0
17,336,336,14,2,12,4,3
3,345,345,37,19,18,3,2
9,359,359,22,22,0,1,0
2,375,375,25,25,0,1,0
24,411,411,6,6,0,1,0
1,420,420,25,25,0,1,0
6,421,421,86,13,73,4,3
23,427,427,8,2,6,2,1
19,458,458,64,32,32,3,2
8,485,485,9,5,4,2,1

28,137,137,1,1,0,1,0
22,139,139,2,2,0,1,0
15,163,163,3,3,0,1,0
7,189,189,15,10,5,2,1
29,192,192,9,9,0,1,0
9,238,238,14,14,0,1,0
12,245,245,6,6,0,1,0
20,249,249,34,9,25,2,1
3,267,267,25,25,0,1,0
8,269,269,12,12,0,1,0
26,272,272,6,6,0,1,0
5,273,273,33,13,20,2,1
24,318,318,14,14,0,1,0
23,322,322,17,17,0,1,0
13,325,325,73,73,0,1,0
0,370,370,1,1,0,1,0
6,373,373,11,11,0,1,0
18,414,414,48,48,0,1,0
27,423,423,220,186,34,3,2
11,430,430,68,49,19,4,3
10,430,430,3,3,0,1,0
19,438,438,63,63,0,1,0
25,452,452,37,30,7,2,1
21,461,461,17,11,6,3,2
2,467,467,87,71,16,3,2
17,470,470,7,1,6,2,1
1,477,477,3,3,0,1,0
16,480,480,24,24,0,1,0
4,488,488,1,1,0,1,0
14,496,496,39,13,26,2,1

9,118,118,1,1,0,1,0
18,130,130,36,36,0,1,0
16,158,158,20,9,11,2,1
10,178,178,10,1,9,4,3
15,188,188,1,1,0,1,0
0,204,204,5,5,0,1,0
13,248,248,9,9,0,1,0
1,266,266,11,11,0,1,0
12,322,322,12,12,0,1,0
8,341,341,45,45,0,1,0
7,343,343,79,39,40,2,1
19,361,361,20,20,0,1,0
20,418,418,145,135,10,2,1
11,435,435,28,20,8,2,1
14,448,448,19,19,0,1,0
3,464,464,2,2,0,1,0
6,465,465,99,46,53,4,3
2,479,479,240,136,104,4,3
5,483,483,23,5,18,4,3
4,491,491,3,3,0,1,0
17,498,498,83,54,29,2,1

6,135,135,8,3,5,2,1
1,146,146,6,6,0,1,0
14,168,168,13,2,11,2,1
2,173,173,7,4,3,2,1
12,174,174,33,26,7,2,1
16,205,205,11,3,8,2,1
8,215,215,3,3,0,1,0
7,219,219,17,17,0,1,0
3,343,343,4,4,0,1,0
11,368,368,95,36,59,3,2
17,393,393,56,56,0,1,0
10,394,394,106,81,25,2,1
15,430,430,13,5,8,3,2
9,436,436,12,1,11,2,1
0,440,440,34,25,9,4,3
13,448,448,11,11,0,1,0
5,462,462,440,372,68,4,3
4,472,472,37,37,0,1,0

24,102,102,9,6,3,2,1
28,116,116,26,26,0,1,0
6,122,122,2,2,0,1,0
2,149,149,19,6,13,2,1
23,162,162,26,26,0,1,0
9,181,181,3,3,0,1,0
21,196,196,5,5,0,1,0
20,202,202,25,12,13,2,1
25,222,222,6,3,3,2,1
26,225,225,17,17,0,1,0
5,246,246,7,7,0,1,0
16,253,253,3,3,0,1,0
3,255,255,6,6,0,1,0
18,263,263,13,13,0,1,0
17,268,268,82,82,0,1,0
8,280,280,70,70,0,1,0
11,288,288,28,11,17,2,1
4,319,319,56,56,0,1,0
27,322,322,13,5,8,3,2
15,334,334,1,1,0,1,0
13,363,363,10,10,0,1,0
0,426,426,12,12,0,1,0
1,429,429,11,5,6,2,1
14,464,464,6,6,0,1,0
10,476,476,85,85,0,1,0
7,478,478,77,77,0,1,0
12,483,483,8,5,3,2,1
22,484,484,23,23,0,1,0
19,496,496,31,31,0,1,0

10,101,101,5,1,4,2,1
7,125,125,2,2,0,1,0
16,126,126,29,29,0,1,0
14,131,131,42,26,16,2,1
12,140,140,14,14,0,1,0
25,141,141,16,16,0,1,0
18,171,171,12,2,10,3,2
9,200,200,36,23,13,2,1
6,217,217,6,6,0,1,0
23,224,224,12,9,3,2,1
17,228,228,41,23,18,4,3
21,239,239,2,2,0,1,0
8,290,290,14,2,12,3,2
15,317,317,2,2,0,1,0
22,339,339,16,1,15,4,3
11,339,339,41,41,0,1,0
2,341,341,4,4,0,1,0
3,371,371,28,2,26,3,2
13,375,375,22,15,7,2,1
19,403,403,32,32,0,1,0
0,441,441,86,23,63,3,2
5,447,447,64,64,0,1,0
24,447,447,42,26,16,3,2
4,486,486,54,54,0,1,0
20,489,489,11,11,0,1,0
1,496,496,31,31,0,1,0

15,156,156,31,7,24,3,2
23,156,156,5,5,0,1,0
11,165,165,12,12,0,1,0
22,181,181,11,11,0,1,0
18,198,198,10,1,9,4,3
9,214,214,17,17,0,1,0
0,224,224,36,20,16,3,2
25,247,247,9,3,6,3,2
17,255,255,14,6,8,3,2
8,284,284,90,90,0,1,0
20,295,295,30,30,0,1,0
19,304,304,54,54,0,1,0
3,328,328,57,9,48,4,3
12,347,347,3,3,0,1,0
10,347,347,2,2,0,1,0
4,358,358,1,1,0,1,0
13,363,363,23,23,0,1,0
7,367,367,29,29,0,1,0
24,369,369,49,49,0,1,0
1,381,381,13,13,0,1,0
16,388,388,8,8,0,1,0
5,426,426,83,43,40,3,2
6,438,438,3,3,0,1,0
14,470,470,152,152,0,1,0
2,479,479,1,1,0,1,0
21,483,483,20,15,5,2,1

12,131,131,13,1,12,2,1
13,132,132,35,35,0,1,0
5,135,135,10,6,4,2,1
0,135,135,44,44,0,1,0
19,158,158,12,4,8,3,2
1,167,167,25,25,0,1,0
6,212,212,38,12,26,2,1
14,291,291,32,18,14,3,2
10,317,317,72,39,33,4,3
7,338,338,140,58,82,3,2
17,345,345,4,1,3,2,1
8,350,350,26,8,18,2,1
18,371,371,1,1,0,1,0
16,378,378,29,19,10,3,2
4,409,409,4,4,0,1,0
11,418,418,109,81,28,2,1
9,441,441,9,9,0,1,0
15,459,459,1,1,0,1,0
2,484,484,1,1,0,1,0
3,486,486,22,18,4,2,1

20,112,112,34,6,28,3,2
3,112,112,5,2,3,2,1
4,146,146,1,1,0,1,0
23,148,148,17,17,0,1,0
5,171,171,17,6,11,2,1
8,179,179,4,4,0,1,0
16,179,179,8,8,0,1,0
15,185,185,55,14,41,2,1
12,189,189,1,1,0,1,0
10,199,199,35,35,0,1,0
24,209,209,8,8,0,1,0
14,242,242,51,1,50,3,2
6,267,267,1,1,0,1,0
27,279,279,7,7,0,1,0
11,293,293,6,6,0,1,0
18,298,298,19,12,7,2,1
7,313,313,28,28,0,1,0
19,315,315,35,9,26,2,1
13,327,327,3,3,0,1,0
25,351,351,2,2,0,1,0
0,366,366,9,9,0,1,0
26,385,385,22,22,0,1,0
17,416,416,145,130,15,2,1
21,425,425,36,36,0,1,0
9,431,431,30,30,0,1,0
1,479,479,58,43,15,4,3
22,485,485,13,1,12,4,3
2,495,495,2,2,0,1,0

11,108,108,27,27,0,1,0
10,108,108,38,38,0,1,0
2,130,130,1,1,0,1,0
15,135,135,6,2,4,2,1
12,159,159,8,8,0,1,0
8,179,179,11,11,0,1,0
5,210,210,1,1,0,1,0
4,222,222,4,4,0,1,0
3,239,239,127,114,13,2,1
13,319,319,2,2,0,1,0
0,322,322,49,49,0,1,0
6,329,329,102,102,0,1,0
1,359,359,64,40,24,3,2
17,369,369,10,10,0,1,0
14,374,374,44,34,10,2,1
18,415,415,30,25,5,2,1
16,423,423,20,12,8,3,2
9,447,447,37,21,16,3,2
7,457,457,50,50,0,1,0

11,116,116,9,9,0,1,0
1,124,124,1,1,0,1,0
15,145,145,22,3,19,2,1
0,153,153,17,2,15,4,3
12,166,166,11,8,3,2,1
22,172,172,29,15,14,2,1
16,174,174,10,10,0,1,0
3,182,182,52,32,20,3,2
18,213,213,12,12,0,1,0
25,224,224,11,11,0,1,0
20,241,241,26,17,9,2,1
2,279,279,6,6,0,1,0
26,294,294,4,4,0,1,0
21,318,318,26,26,0,1,0
5,335,335,19,2,17,2,1
7,338,338,5,5,0,1,0
6,365,365,11,3,8,2,1
17,381,381,89,78,11,2,1
9,382,382,18,18,0,1,0
13,394,394,32,27,5,2,1
4,401,401,84,84,0,1,0
23,405,405,32,32,0,1,0
14,407,407,44,26,18,2,1
24,409,409,46,22,24,3,2
8,424,424,6,3,3,2,1
10,435,435,30,6,24,2,1
19,438,438,51,51,0,1,0

5,101,101,2,2,0,1,0
3,108,108,5,5,0,1,0
19,125,125,7,7,0,1,0
6,201,201,38,24,14,3,2
12,204,204,14,14,0,1,0
20,205,205,10,10,0,1,0
0,223,223,80,80,0,1,0
2,223,223,14,6,8,2,1
22,243,243,33,3,30,2,1
15,247,247,8,8,0,1,0
14,252,252,5,2,3,2,1
1,264,264,42,2,40,2,1
17,345,345,4,4,0,1,0
18,346,346,8,8,0,1,0
13,357,357,1,1,0,1,0
4,395,395,1,1,0,1,0
9,401,401,66,66,0,1,0
10,422,422,41,1,40,3,2
7,427,427,22,22,0,1,0
16,466,466,25,25,0,1,0
21,471,471,357,279,78,3,2
23,474,474,5,5,0,1,0
11,483,483,10,10,0,1,0
8,499,499,14,7,7,2,1

4,114,114,2,2,0,1,0
27,138,138,7,3,4,2,1
18,139,139,42,42,0,1,0
26,148,148,14,2,12,4,3
21,187,187,2,2,0,1,0
22,191,191,57,47,10,3,2
5,194,194,16,3,13,3,2
1,217,217,11,1,10,2,1
24,247,247,2,2,0,1,0
12,250,250,3,3,0,1,0
13,259,259,6,6,0,1,0
14,275,275,68,44,24,3,2
16,306,306,13,13,0,1,0
9,320,320,10,10,0,1,0
19,327,327,76,47,29,2,1
10,337,337,36,36,0,1,0
20,344,344,3,3,0,1,0
6,364,364,1,1,0,1,0
23,375,375,9,9,0,1,0
2,382,382,21,21,0,1,0
0,422,422,32,32,0,1,0
15,429,429,24,24,0,1,0
11,441,441,9,9,0,1,0
3,447,447,42,39,3,2,1
7,459,459,26,9,17,2,1
25,477,477,12,2,10,3,2
8,489,489,132,52,80,4,3
17,494,494,61,41,20,2,1

17,118,118,4,4,0,1,0
2,134,134,15,15,0,1,0
0,168,168,54,54,0,1,0
19,169,169,22,4,18,2,1
7,179,179,5,1,4,2,1
6,188,188,52,52,0,1,0
15,197,197,37,37,0,1,0
9,227,227,34,5,29,3,2
22,228,228,19,1,18,2,1
12,228,228,35,35,0,1,0
20,271,271,15,15,0,1,0
18,281,281,70,24,46,2,1
4,296,296,22,22,0,1,0
10,301,301,6,2,4,2,1
5,339,339,5,5,0,1,0
11,360,360,4,4,0,1,0
21,404,404,54,34,20,2,1
16,446,446,47,26,21,4,3
8,461,461,22,22,0,1,0
14,467,467,1,1,0,1,0
1,468,468,17,12,5,2,1
13,470,470,39,18,21,3,2
3,500,500,60,28,32,3,2

2,145,145,21,21,0,1,0
10,148,148,2,2,0,1,0
23,153,153,9,9,0,1,0
7,160,160,33,33,0,1,0
13,164,164,42,33,9,4,3
16,184,184,7,7,0,1,0
9,189,189,17,8,9,2,1
0,215,215,5,5,0,1,0
5,278,278,49,29,20,4,3
3,292,292,11,11,0,1,0
15,294,294,11,11,0,1,0
8,317,317,55,38,17,2,1
22,321,321,2,2,0,1,0
21,331,331,43,43,0,1,0
19,337,337,66,6,60,3,2
20,337,337,48,48,0,1,0
11,352,352,7,7,0,1,0
18,372,372,5,5,0,1,0
17,379,379,21,21,0,1,0
1,407,407,69,24,45,4,3
12,408,408,77,19,58,4,3
14,451,451,45,45,0,1,0
4,471,471,17,10,7,2,1
6,484,484,54,54,0,1,0

16,122,122,14,9,5,2,1
5,139,139,5,5,0,1,0
11,142,142,5,5,0,1,0
8,168,168,3,3,0,1,0
7,171,171,16,16,0,1,0
12,200,200,18,18,0,1,0
0,217,217,79,72,7,2,1
23,248,248,30,20,10,2,1
19,256,256,13,13,0,1,0
18,278,278,41,26,15,2,1
24,291,291,46,42,4,2,1
1,292,292,5,5,0,1,0
4,295,295,15,15,0,1,0
17,305,305,37,10,27,2,1
20,322,322,12,9,3,2,1
15,337,337,39,39,0,1,0
22,356,356,35,12,23,2,1
9,383,383,43,37,6,2,1
13,387,387,9,1,8,2,1
21,421,421,82,28,54,3,2
6,439,439,31,14,17,3,2
10,458,458,11,11,0,1,0
2,465,465,30,19,11,2,1
3,466,466,105,29,76,4,3
14,473,473,19,4,15,4,3

3,149,149,1,1,0,1,0
2,168,168,61,61,0,1,0
21,192,192,28,11,17,2,1
8,203,203,19,19,0,1,0
7,231,231,19,8,11,2,1
10,234,234,26,4,22,3,2
16,235,235,103,14,89,4,3
17,253,253,17,3,14,3,2
19,255,255,24,12,12,3,2
12,258,258,18,18,0,1,0
18,262,262,20,4,16,2,1
14,288,288,4,4,0,1,0
0,299,299,49,49,0,1,0
5,305,305,51,32,19,2,1
15,312,312,9,2,7,2,1
20,329,329,10,3,7,2,1
4,360,360,13,13,0,1,0
6,373,373,29,29,0,1,0
1,385,385,67,42,25,2,1
13,399,399,3,3,0,1,0
9,406,406,15,15,0,1,0
11,468,468,68,22,46,3,2

26,100,100,18,18,0,1,0
21,115,115,13,5,8,3,2
10,125,125,1,1,0,1,0
27,172,172,24,6,18,2,1
8,184,184,13,4,9,2,1
4,190,190,1,1,0,1,0
24,199,199,49,49,0,1,0
3,221,221,4,4,0,1,0
9,238,238,14,14,0,1,0
12,244,244,9,1,8,3,2
23,272,272,7,2,5,2,1
17,279,279,7,3,4,2,1
20,293,293,28,28,0,1,0
16,294,294,5,5,0,1,0
22,305,305,68,14,54,4,3
5,307,307,30,5,25,4,3
2,334,334,3,3,0,1,0
14,355,355,9,1,8,3,2
15,371,371,48,23,25,2,1
19,380,380,2,2,0,1,0
7,380,380,42,34,8,3,2
1,384,384,2,2,0,1,0
25,389,389,60,60,0,1,0
6,439,439,5,5,0,1,0
11,462,462,63,14,49,2,1
18,464,464,7,7,0,1,0
13,475,475,19,15,4,2,1
0,500,500,220,179,41,3,2

16,127,127,8,8,0,1,0
6,130,130,7,7,0,1,0
25,140,140,4,1,3,2,1
11,175,175,7,7,0,1,0
7,182,182,16,12,4,2,1
3,184,184,24,24,0,1,0
20,188,188,19,4,15,2,1
22,189,189,10,2,8,2,1
2,204,204,24,11,13,2,1
0,258,258,11,11,0,1,0
9,263,263,27,27,0,1,0
19,269,269,39,23,16,2,1
5,271,271,88,82,6,2,1
15,272,272,5,5,0,1,0
1,280,280,22,22,0,1,0
21,318,318,122,47,75,4,3
10,324,324,31,21,10,2,1
4,348,348,3,3,0,1,0
14,390,390,8,8,0,1,0
8,401,401,11,11,0,1,0
23,436,436,9,1,8,3,2
17,438,438,18,4,14,2,1
13,439,439,33,33,0,1,0
18,461,461,67,4,63,3,2
12,476,476,8,8,0,1,0
24,480,480,97,42,55,3,2

20,100,100,6,1,5,2,1
23,113,113,13,7,6,2,1
4,121,121,2,2,0,1,0
6,130,130,8,8,0,1,0
3,134,134,28,16,12,2,1
12,162,162,7,1,6,2,1
0,218,218,35,14,21,2,1
13,231,231,4,4,0,1,0
17,246,246,29,29,0,1,0
7,273,273,21,3,18,2,1
25,293,293,10,10,0,1,0
22,300,300,26,18,8,2,1
15,314,314,32,12,20,3,2
24,315,315,68,51,17,2,1
14,334,334,56,36,20,2,1
10,356,356,106,30,76,3,2
9,383,383,53,53,0,1,0
5,387,387,6,6,0,1,0
21,390,390,5,2,3,2,1
8,394,394,2,2,0,1,0
1,402,402,14,6,8,2,1
19,407,407,91,91,0,1,0
16,470,470,2,2,0,1,0
2,471,471,3,3,0,1,0
11,471,471,56,18,38,2,1
18,499,499,40,1,39,3,2

23,106,106,2,2,0,1,0
2,134,134,10,1,9,2,1
22,141,141,14,5,9,2,1
29,144,144,20,20,0,1,0
15,145,145,5,5,0,1,0
3,160,160,6,6,0,1,0
27,167,167,10,10,0,1,0
21,168,168,2,2,0,1,0
20,168,168,27,27,0,1,0
30,207,207,24,8,16,3,2
26,244,244,1,1,0,1,0
18,263,263,2,2,0,1,0
11,264,264,7,3,4,2,1
5,293,293,35,18,17,4,3
0,298,298,17,3,14,3,2
16,316,316,1,1,0,1,0
13,322,322,1,1,0,1,0
10,325,325,7,7,0,1,0
12,341,341,76,76,0,1,0
9,359,359,78,22,56,3,2
1,367,367,31,9,22,3,2
28,391,391,137,137,0,1,0
19,398,398,47,27,20,4,3
14,421,421,4,4,0,1,0
7,422,422,10,10,0,1,0
6,439,439,8,8,0,1,0
24,457,457,41,10,31,3,2
8,471,471,97,87,10,2,1
17,475,475,10,1,9,2,1
25,476,476,28,28,0,1,0
4,489,489,6,6,0,1,0

4,130,130,3,3,0,1,0
19,137,137,2,2,0,1,0
18,146,146,2,2,0,1,0
15,148,148,16,2,14,3,2
9,169,169,3,3,0,1,0
7,186,186,29,11,18,3,2
5,197,197,2,2,0,1,0
16,232,232,14,14,0,1,0
1,264,264,93,26,67,4,3
0,269,269,18,7,11,2,1
2,270,270,36,36,0,1,0
10,333,333,68,61,7,2,1
14,351,351,19,4,15,2,1
11,381,381,12,4,8,2,1
6,393,393,4,1,3,2,1
17,393,393,28,5,23,3,2
12,399,399,53,37,16,2,1
8,417,417,77,55,22,2,1
13,431,431,145,112,33,4,3
3,485,485,218,105,113,4,3

8,100,100,3,3,0,1,0
22,116,116,11,11,0,1,0
11,169,169,8,8,0,1,0
18,175,175,2,2,0,1,0
9,212,212,3,3,0,1,0
21,224,224,9,2,7,3,2
14,269,269,26,11,15,2,1
10,293,293,31,16,15,2,1
23,330,330,68,35,33,4,3
1,357,357,16,16,0,1,0
0,366,366,34,34,0,1,0
20,382,382,86,68,18,4,3
6,383,383,48,33,15,4,3
3,390,390,127,93,34,3,2
13,397,397,21,1,20,2,1
15,401,401,46,31,15,4,3
16,406,406,24,15,9,2,1
4,411,411,24,18,6,3,2
25,431,431,62,5,57,4,3
19,431,431,39,39,0,1,0
12,438,438,16,16,0,1,0
17,441,441,36,36,0,1,0
7,448,448,35,5,30,2,1
2,451,451,29,18,11,2,1
24,475,475,38,11,27,4,3
26,496,496,39,12,27,4,3
5,500,500,15,15,0,1,0

0,101,101,11,11,0,1,0
9,108,108,19,19,0,1,0
5,123,123,2,2,0,1,0
3,131,131,7,7,0,1,0
2,144,144,35,35,0,1,0
4,180,180,37,3,34,3,2
18,207,207,5,5,0,1,0
13,254,254,18,18,0,1,0
19,268,268,14,14,0,1,0
7,279,279,28,1,27,2,1
1,284,284,30,18,12,3,2
14,286,286,11,11,0,1,0
11,302,302,38,38,0,1,0
12,340,340,7,1,6,3,2
8,353,353,27,27,0,1,0
21,391,391,13,13,0,1,0
16,426,426,40,40,0,1,0
10,429,429,46,14,32,2,1
20,449,449,185,125,60,4,3
17,465,465,25,25,0,1,0
6,498,498,59,53,6,3,2
15,499,499,96,50,46,2,1

3,109,109,6,6,0,1,0
10,112,112,16,6,10,3,2
8,177,177,2,2,0,1,0
14,183,183,3,3,0,1,0
7,185,185,31,18,13,2,1
19,198,198,83,47,36,3,2
21,206,206,6,6,0,1,0
11,257,257,15,5,10,2,1
17,285,285,4,4,0,1,0
23,298,298,8,8,0,1,0
6,315,315,34,34,0,1,0
2,336,336,34,34,0,1,0
5,345,345,61,61,0,1,0
13,349,349,58,30,28,3,2
12,357,357,14,14,0,1,0
22,361,361,81,81,0,1,0
15,393,393,8,2,6,2,1
0,395,395,17,17,0,1,0
4,419,419,50,50,0,1,0
9,429,429,16,16,0,1,0
16,435,435,6,6,0,1,0
1,460,460,83,18,65,4,3
20,460,460,98,14,84,4,3
18,482,482,19,9,10,3,2

21,102,102,20,11,9,4,3
3,103,103,2,2,0,1,0
10,123,123,41,15,26,2,1
5,134,134,2,2,0,1,0
14,138,138,13,9,4,2,1
8,148,148,3,3,0,1,0
26,173,173,5,5,0,1,0
1,184,184,3,3,0,1,0
2,192,192,9,9,0,1,0
19,201,201,10,2,8,2,1
15,242,242,49,49,0,1,0
11,243,243,40,40,0,1,0
0,246,246,4,4,0,1,0
24,269,269,1,1,0,1,0
7,317,317,34,34,0,1,0
13,332,332,28,11,17,2,1
16,333,333,15,10,5,2,1
20,341,341,40,35,5,2,1
22,371,371,40,2,38,2,1
23,404,404,30,30,0,1,0
4,419,419,16,12,4,2,1
25,430,430,92,28,64,3,2
9,452,452,45,45,0,1,0
18,460,460,18,18,0,1,0
6,461,461,48,29,19,2,1
17,469,469,68,46,22,3,2
12,485,485,23,17,6,2,1

2,119,119,22,22,0,1,0
6,134,134,14,1,13,4,3
4,138,138,4,1,3,2,1
22,144,144,32,32,0,1,0
14,148,148,10,4,6,2,1
17,156,156,29,23,6,3,2
19,160,160,6,6,0,1,0
11,164,164,4,4,0,1,0
16,181,181,14,14,0,1,0
21,188,188,8,8,0,1,0
7,218,218,9,9,0,1,0
10,222,222,4,4,0,1,0
23,259,259,72,72,0,1,0
15,276,276,3,3,0,1,0
5,313,313,5,5,0,1,0
8,322,322,1,1,0,1,0
13,343,343,24,14,10,2,1
3,382,382,22,22,0,1,0
0,384,384,254,251,3,2,1
18,405,405,80,24,56,4,3
12,429,429,8,8,0,1,0
20,468,468,8,8,0,1,0
9,484,484,9,9,0,1,0
1,491,491,21,11,10,3,2

4,138,138,14,14,0,1,0
3,147,147,20,20,0,1,0
1,198,198,36,36,0,1,0
9,209,209,48,48,0,1,0
2,209,209,10,10,0,1,0
12,211,211,44,11,33,4,3
14,211,211,16,2,14,2,1
18,213,213,37,9,28,3,2
5,225,225,67,30,37,2,1
10,230,230,22,22,0,1,0
0,287,287,60,60,0,1,0
15,358,358,6,6,0,1,0
17,389,389,7,7,0,1,0
7,409,409,5,5,0,1,0
16,425,425,16,8,8,3,2
8,458,458,78,12,66,4,3
11,483,483,83,67,16,3,2
6,484,484,110,29,81,4,3
13,486,486,6,6,0,1,0

24,102,102,13,13,0,1,0
23,116,116,4,4,0,1,0
4,136,136,5,5,0,1,0
13,148,148,20,8,12,3,2
14,160,160,2,2,0,1,0
11,160,160,15,2,13,2,1
26,170,170,7,7,0,1,0
8,182,182,49,37,12,2,1
12,188,188,11,11,0,1,0
2,203,203,5,5,0,1,0
19,232,232,23,23,0,1,0
17,272,272,16,16,0,1,0
16,296,296,107,68,39,2,1
10,299,299,29,19,10,2,1
22,300,300,27,27,0,1,0
0,312,312,61,51,10,3,2
25,318,318,49,49,0,1,0
27,328,328,32,32,0,1,0
20,353,353,25,25,0,1,0
21,357,357,7,7,0,1,0
5,379,379,7,7,0,1,0
15,383,383,38,38,0,1,0
7,384,384,5,5,0,1,0
18,396,396,26,14,12,4,3
3,439,439,22,22,0,1,0
1,440,440,5,2,3,2,1
9,444,444,35,35,0,1,0
6,491,491,3,3,0,1,0

14,111,111,40,40,0,1,0
22,114,114,9,3,6,2,1
17,124,124,6,6,0,1,0
3,128,128,14,14,0,1,0
15,149,149,12,12,0,1,0
18,157,157,13,13,0,1,0
2,160,160,6,6,0,1,0
1,180,180,3,3,0,1,0
20,223,223,32,12,20,2,1
4,223,223,1,1,0,1,0
19,236,236,1,1,0,1,0
9,252,252,64,38,26,2,1
5,259,259,93,12,81,4,3
23,261,261,34,34,0,1,0
10,281,281,25,7,18,4,3
7,288,288,38,12,26,2,1
11,289,289,33,9,24,2,1
21,311,311,63,63,0,1,0
24,331,331,21,5,16,3,2
0,337,337,16,6,10,2,1
12,403,403,7,4,3,2,1
6,413,413,1,1,0,1,0
13,417,417,5,5,0,1,0
8,427,427,8,2,6,2,1
16,438,438,8,8,0,1,0

21,105,105,22,22,0,1,0
0,110,110,1,1,0,1,0
23,126,126,8,1,7,3,2
8,194,194,53,17,36,3,2
22,200,200,4,4,0,1,0
1,222,222,4,4,0,1,0
16,227,227,51,36,15,2,1
12,239,239,6,6,0,1,0
9,247,247,10,10,0,1,0
19,253,253,32,32,0,1,0
13,269,269,34,34,0,1,0
5,280,280,36,36,0,1,0
4,317,317,31,5,26,3,2
20,355,355,8,8,0,1,0
24,364,364,11,11,0,1,0
7,373,373,9,9,0,1,0
14,393,393,32,32,0,1,0
11,393,393,13,13,0,1,0
2,407,407,1,1,0,1,0
10,420,420,150,74,76,4,3
18,436,436,106,106,0,1,0
15,447,447,34,34,0,1,0
17,453,453,9,9,0,1,0
6,453,453,13,13,0,1,0
3,493,493,18,18,0,1,0
25,499,499,53,47,6,2,1

15,129,129,1,1,0,1,0
28,141,141,15,15,0,1,0
0,149,149,1,1,0,1,0
21,157,157,19,19,0,1,0
19,160,160,15,5,10,2,1
17,197,197,4,4,0,1,0
7,242,242,24,6,18,4,3
3,252,252,49,12,37,2,1
10,266,266,26,6,20,2,1
2,281,281,1,1,0,1,0
9,281,281,4,1,3,2,1
25,301,301,26,4,22,2,1
12,305,305,33,10,23,2,1
5,306,306,8,4,4,2,1
26,340,340,142,121,21,2,1
16,350,350,71,11,60,3,2
11,352,352,40,40,0,1,0
27,359,359,7,3,4,2,1
23,365,365,36,36,0,1,0
22,368,368,37,37,0,1,0
8,400,400,13,3,10,2,1
13,437,437,1,1,0,1,0
1,441,441,20,2,18,3,2
4,455,455,82,82,0,1,0
6,473,473,15,1,14,3,2
20,477,477,13,1,12,2,1
18,478,478,45,45,0,1,0
14,485,485,17,17,0,1,0
24,494,494,19,13,6,2,1

10,147,147,4,1,3,2,1
16,170,170,52,34,18,2,1
15,189,189,7,1,6,2,1
0,194,194,1,1,0,1,0
7,195,195,57,12,45,2,1
17,221,221,12,12,0,1,0
2,242,242,1,1,0,1,0
4,266,266,53,53,0,1,0
22,267,267,28,28,0,1,0
11,278,278,19,1,18,4,3
3,281,281,59,59,0,1,0
14,316,316,15,15,0,1,0
12,328,328,7,3,4,2,1
21,358,358,25,25,0,1,0
9,423,423,22,22,0,1,0
5,428,428,30,9,21,2,1
19,431,431,24,2,22,3,2
13,436,436,59,59,0,1,0
20,451,451,141,111,30,4,3
18,452,452,3,3,0,1,0
1,484,484,30,30,0,1,0
6,488,488,4,1,3,2,1
8,500,500,136,44,92,4,3

7,105,105,26,26,0,1,0
20,107,107,32,32,0,1,0
2,182,182,21,21,0,1,0
12,244,244,17,13,4,2,1
3,256,256,7,1,6,3,2
21,296,296,30,2,28,4,3
17,317,317,18,18,0,1,0
11,321,321,4,4,0,1,0
0,365,365,38,38,0,1,0
6,394,394,57,27,30,2,1
13,399,399,26,26,0,1,0
10,400,400,6,1,5,2,1
19,407,407,48,4,44,2,1
15,413,413,6,6,0,1,0
5,416,416,64,26,38,4,3
8,421,421,7,7,0,1,0
16,422,422,85,85,0,1,0
14,435,435,10,10,0,1,0
4,436,436,78,78,0,1,0
18,443,443,108,10,98,3,2
9,447,447,75,75,0,1,0
1,474,474,21,21,0,1,0

17,112,112,7,3,4,2,1
24,124,124,3,3,0,1,0
20,133,133,18,2,16,3,2
6,145,145,1,1,0,1,0
12,158,158,29,5,24,2,1
22,178,178,83,75,8,2,1
21,189,189,4,4,0,1,0
8,194,194,17,1,16,3,2
3,203,203,26,26,0,1,0
23,223,223,8,8,0,1,0
10,269,269,1,1,0,1,0
18,271,271,5,5,0,1,0
9,283,283,3,3,0,1,0
0,284,284,23,23,0,1,0
13,297,297,24,3,21,4,3
11,299,299,7,2,5,2,1
4,344,344,96,12,84,3,2
15,380,380,74,74,0,1,0
14,383,383,21,11,10,4,3
2,411,411,60,22,38,2,1
7,434,434,60,30,30,4,3
5,452,452,29,29,0,1,0
1,453,453,24,24,0,1,0
19,454,454,7,7,0,1,0
16,483,483,55,55,0,1,0

13,104,104,24,24,0,1,0
19,144,144,5,5,0,1,0
9,149,149,14,14,0,1,0
20,155,155,7,3,4,2,1
10,168,168,40,40,0,1,0
18,190,190,15,15,0,1,0
6,197,197,7,7,0,1,0
1,213,213,27,19,8,2,1
0,223,223,1,1,0,1,0
7,249,249,11,11,0,1,0
8,280,280,1,1,0,1,0
2,281,281,85,85,0,1,0
17,290,290,29,20,9,4,3
12,292,292,19,19,0,1,0
14,300,300,3,3,0,1,0
5,308,308,64,16,48,3,2
3,339,339,125,35,90,4,3
16,358,358,23,1,22,2,1
15,443,443,11,11,0,1,0
11,448,448,106,66,40,4,3
4,478,478,52,42,10,2,1

13,178,178,3,3,0,1,0
17,188,188,20,8,12,3,2
18,194,194,10,10,0,1,0
10,203,203,48,48,0,1,0
11,210,210,26,1,25,2,1
9,218,218,6,6,0,1,0
20,223,223,14,2,12,4,3
0,241,241,17,4,13,2,1
4,261,261,53,53,0,1,0
2,285,285,126,117,9,4,3
12,292,292,9,4,5,2,1
3,312,312,52,18,34,2,1
1,327,327,5,5,0,1,0
5,355,355,53,24,29,2,1
16,362,362,20,20,0,1,0
19,377,377,7,7,0,1,0
8,397,397,13,1,12,4,3
7,412,412,10,5,5,2,1
14,431,431,101,58,43,4,3
21,435,435,43,43,0,1,0
15,454,454,85,59,26,2,1
6,496,496,36,18,18,3,2

23,136,136,17,4,13,2,1
24,144,144,22,2,20,3,2
15,163,163,31,31,0,1,0
17,164,164,7,7,0,1,0
21,181,181,4,4,0,1,0
20,187,187,44,37,7,2,1
4,215,215,65,29,36,4,3
12,219,219,28,2,26,3,2
14,248,248,34,34,0,1,0
11,251,251,8,4,4,2,1
7,256,256,9,9,0,1,0
6,280,280,32,32,0,1,0
8,282,282,10,10,0,1,0
3,284,284,30,6,24,4,3
2,313,313,30,30,0,1,0
9,335,335,9,2,7,2,1
10,341,341,84,21,63,4,3
18,345,345,22,22,0,1,0
0,355,355,1,1,0,1,0
1,356,356,27,18,9,3,2
22,377,377,24,6,18,3,2
13,407,407,20,9,11,2,1
16,416,416,49,10,39,3,2
19,423,423,7,4,3,2,1
5,454,454,1,1,0,1,0

17,100,100,23,13,10,2,1
14,113,113,1,1,0,1,0
21,126,126,3,3,0,1,0
7,143,143,17,7,10,2,1
9,145,145,8,5,3,2,1
3,169,169,13,1,12,3,2
24,235,235,33,33,0,1,0
11,257,257,30,24,6,3,2
16,280,280,57,52,5,2,1
20,286,286,9,3,6,3,2
2,312,312,23,9,14,2,1
10,316,316,24,24,0,1,0
12,326,326,20,20,0,1,0
8,334,334,2,2,0,1,0
6,336,336,27,27,0,1,0
13,339,339,16,3,13,2,1
23,388,388,75,39,36,4,3
19,388,388,30,30,0,1,0
25,408,408,61,47,14,2,1
15,411,411,16,16,0,1,0
4,425,425,114,114,0,1,0
1,441,441,37,37,0,1,0
0,455,455,19,19,0,1,0
18,458,458,34,34,0,1,0
5,487,487,47,47,0,1,0
22,488,488,23,17,6,3,2

21,122,122,7,7,0,1,0
13,123,123,5,1,4,2,1
9,131,131,2,2,0,1,0
24,138,138,17,17,0,1,0
18,150,150,10,10,0,1,0
12,152,152,5,5,0,1,0
0,156,156,1,1,0,1,0
27,163,163,12,12,0,1,0
22,172,172,12,12,0,1,0
20,188,188,57,57,0,1,0
19,215,215,6,6,0,1,0
25,226,226,24,1,23,3,2
8,250,250,27,27,0,1,0
5,257,257,12,12,0,1,0
26,278,278,18,18,0,1,0
14,292,292,9,9,0,1,0
2,314,314,31,21,10,3,2
28,329,329,9,5,4,2,1
15,333,333,20,3,17,2,1
1,346,346,101,54,47,2,1
7,390,390,2,2,0,1,0
23,391,391,3,3,0,1,0
17,403,403,55,51,4,2,1
10,408,408,5,5,0,1,0
29,442,442,135,66,69,4,3
6,460,460,1,1,0,1,0
11,462,462,7,1,6,2,1
16,472,472,12,12,0,1,0
4,483,483,21,1,20,3,2
3,488,488,112,25,87,4,3

28,106,106,4,4,0,1,0
12,111,111,5,2,3,2,1
15,112,112,1,1,0,1,0
10,124,124,11,11,0,1,0
1,129,129,11,3,8,3,2
16,139,139,1,1,0,1,0
5,200,200,10,3,7,2,1
8,223,223,42,42,0,1,0
25,229,229,34,10,24,3,2
19,234,234,19,3,16,2,1
17,249,249,11,11,0,1,0
9,265,265,39,5,34,3,2
29,267,267,5,5,0,1,0
13,275,275,11,11,0,1,0
6,278,278,2,2,0,1,0
21,282,282,8,2,6,3,2
22,292,292,18,18,0,1,0
18,298,298,85,85,0,1,0
23,305,305,55,19,36,3,2
11,319,319,54,54,0,1,0
2,333,333,10,1,9,4,3
26,343,343,8,1,7,2,1
14,373,373,3,3,0,1,0
7,379,379,75,42,33,4,3
0,385,385,7,7,0,1,0
3,412,412,15,15,0,1,0
24,414,414,71,71,0,1,0
27,469,469,37,13,24,3,2
4,473,473,15,3,12,4,3
20,500,500,53,10,43,2,1

18,102,102,5,5,0,1,0
15,161,161,31,31,0,1,0
2,184,184,42,42,0,1,0
9,198,198,12,12,0,1,0
8,302,302,63,63,0,1,0
10,310,310,33,29,4,2,1
1,317,317,19,15,4,2,1
7,320,320,30,1,29,4,3
5,327,327,8,8,0,1,0
13,328,328,8,4,4,2,1
20,336,336,2,2,0,1,0
14,358,358,47,23,24,4,3
6,387,387,113,50,63,4,3
3,388,388,24,24,0,1,0
11,389,389,4,4,0,1,0
4,390,390,20,15,5,2,1
12,419,419,36,8,28,2,1
21,434,434,68,68,0,1,0
16,443,443,31,31,0,1,0
17,468,468,48,41,7,2,1
0,476,476,59,59,0,1,0
19,496,496,143,129,14,3,2

2,104,104,17,17,0,1,0
5,124,124,26,23,3,2,1
3,131,131,26,16,10,3,2
14,136,136,4,4,0,1,0
16,146,146,7,7,0,1,0
6,152,152,8,3,5,2,1
13,153,153,24,24,0,1,0
17,178,178,9,2,7,2,1
9,269,269,23,23,0,1,0
4,273,273,73,17,56,3,2
1,384,384,56,2,54,4,3
8,395,395,96,96,0,1,0
11,412,412,32,12,20,3,2
0,413,413,90,65,25,2,1
12,419,419,35,35,0,1,0
10,436,436,18,12,6,2,1
7,437,437,84,51,33,4,3
15,485,485,79,55,24,3,2

10,110,110,4,4,0,1,0
18,152,152,6,3,3,2,1
14,172,172,9,9,0,1,0
4,185,185,19,10,9,2,1
0,220,220,18,18,0,1,0
15,241,241,6,1,5,2,1
2,244,244,36,2,34,2,1
11,254,254,28,28,0,1,0
19,255,255,1,1,0,1,0
1,283,283,48,33,15,2,1
8,297,297,29,29,0,1,0
22,303,303,93,52,41,3,2
9,313,313,27,27,0,1,0
5,326,326,32,2,30,4,3
23,339,339,59,59,0,1,0
6,349,349,3,3,0,1,0
20,372,372,7,7,0,1,0
16,393,393,42,1,41,2,1
13,413,413,61,61,0,1,0
3,442,442,86,86,0,1,0
21,463,463,5,5,0,1,0
12,465,465,118,118,0,1,0
17,471,471,39,39,0,1,0
7,496,496,33,5,28,2,1

23,126,126,26,26,0,1,0
19,166,166,1,1,0,1,0
18,168,168,15,15,0,1,0
15,169,169,6,1,5,2,1
16,172,172,3,3,0,1,0
1,177,177,16,16,0,1,0
20,180,180,4,4,0,1,0
25,186,186,17,12,5,2,1
3,214,214,28,11,17,2,1
4,216,216,54,54,0,1,0
14,220,220,14,1,13,2,1
8,229,229,23,23,0,1,0
2,248,248,12,12,0,1,0
12,255,255,5,5,0,1,0
9,297,297,40,40,0,1,0
10,303,303,27,4,23,2,1
21,313,313,18,2,16,3,2
7,314,314,11,7,4,2,1
17,328,328,3,3,0,1,0
6,332,332,5,5,0,1,0
24,337,337,58,28,30,4,3
22,366,366,126,126,0,1,0
26,390,390,69,69,0,1,0
5,405,405,16,16,0,1,0
11,425,425,3,3,0,1,0
13,493,493,59,45,14,2,1
0,498,498,30,30,0,1,0

17,104,104,1,1,0,1,0
0,106,106,9,6,3,2,1
7,136,136,3,3,0,1,0
21,138,138,21,21,0,1,0
20,142,142,9,9,0,1,0
4,167,167,57,57,0,1,0
11,173,173,5,5,0,1,0
1,197,197,2,2,0,1,0
14,203,203,34,21,13,2,1
15,253,253,8,8,0,1,0
10,288,288,11,11,0,1,0
12,302,302,11,2,9,2,1
2,303,303,10,10,0,1,0
9,366,366,146,33,113,4,3
18,374,374,65,48,17,2,1
5,376,376,27,27,0,1,0
6,409,409,13,3,10,2,1
8,414,414,45,25,20,2,1
19,432,432,68,68,0,1,0
3,447,447,44,33,11,3,2
16,475,475,15,15,0,1,0
13,499,499,169,169,0,1,0

19,102,102,17,11,6,2,1
16,127,127,11,7,4,2,1
25,147,147,20,20,0,1,0
9,168,168,13,2,11,2,1
17,187,187,29,29,0,1,0
3,189,189,1,1,0,1,0
12,192,192,8,4,4,2,1
5,203,203,20,11,9,4,3
14,215,215,2,2,0,1,0
20,257,257,21,3,18,4,3
22,291,291,64,64,0,1,0
11,300,300,74,74,0,1,0
24,312,312,3,3,0,1,0
0,316,316,46,35,11,2,1
10,317,317,44,34,10,2,1
26,339,339,33,8,25,4,3
27,350,350,26,26,0,1,0
4,359,359,2,2,0,1,0
13,362,362,7,4,3,2,1
15,365,365,9,9,0,1,0
1,365,365,11,11,0,1,0
21,398,398,2,2,0,1,0
18,418,418,33,1,32,2,1
8,429,429,44,28,16,3,2
6,436,436,41,41,0,1,0
2,436,436,53,17,36,3,2
23,442,442,49,43,6,3,2
7,468,468,19,19,0,1,0

11,100,100,3,3,0,1,0
7,104,104,2,2,0,1,0
15,112,112,2,2,0,1,0
29,114,114,7,7,0,1,0
13,121,121,4,4,0,1,0
23,126,126,2,2,0,1,0
5,146,146,2,2,0,1,0
16,170,170,15,4,11,2,1
0,174,174,19,19,0,1,0
2,181,181,18,6,12,4,3
25,182,182,4,1,3,2,1
19,212,212,29,29,0,1,0
4,228,228,23,7,16,3,2
8,234,234,45,15,30,2,1
6,258,258,21,21,0,1,0
18,263,263,1,1,0,1,0
20,290,290,6,6,0,1,0
9,305,305,24,24,0,1,0
10,313,313,9,9,0,1,0
30,342,342,12,12,0,1,0
28,376,376,29,29,0,1,0
22,388,388,5,5,0,1,0
12,410,410,40,33,7,2,1
21,414,414,155,135,20,2,1
14,418,418,17,17,0,1,0
26,424,424,36,6,30,4,3
17,447,447,42,42,0,1,0
27,473,473,98,98,0,1,0
3,474,474,25,16,9,2,1
1,492,492,10,10,0,1,0
24,492,492,87,87,0,1,0

12,101,101,1,1,0,1,0
4,117,117,1,1,0,1,0
15,130,130,1,1,0,1,0
9,140,140,1,1,0,1,0
7,154,154,30,30,0,1,0
24,161,161,10,4,6,3,2
29,170,170,1,1,0,1,0
11,174,174,1,1,0,1,0
3,196,196,6,6,0,1,0
16,208,208,15,8,7,2,1
6,217,217,19,19,0,1,0
23,217,217,12,9,3,2,1
13,238,238,11,1,10,2,1
1,248,248,18,18,0,1,0
17,258,258,1,1,0,1,0
0,282,282,8,8,0,1,0
31,282,282,62,44,18,4,3
19,294,294,5,5,0,1,0
21,299,299,66,66,0,1,0
5,302,302,19,9,10,2,1
27,315,315,12,12,0,1,0
8,316,316,41,41,0,1,0
25,321,321,34,25,9,2,1
28,321,321,22,12,10,3,2
2,343,343,14,14,0,1,0
22,362,362,9,9,0,1,0
10,365,365,50,22,28,3,2
14,416,416,98,86,12,4,3
26,424,424,95,95,0,1,0
18,437,437,1,1,0,1,0
30,449,449,6,6,0,1,0
20,467,467,84,59,25,4,3

17,131,131,5,5,0,1,0
3,147,147,35,5,30,2,1
13,158,158,62,62,0,1,0
18,181,181,25,21,4,2,1
10,183,183,60,29,31,3,2
0,220,220,34,34,0,1,0
9,220,220,70,70,0,1,0
11,236,236,7,7,0,1,0
12,236,236,4,4,0,1,0
4,238,238,3,3,0,1,0
20,251,251,21,21,0,1,0
15,269,269,3,3,0,1,0
16,287,287,5,5,0,1,0
14,330,330,12,12,0,1,0
5,360,360,28,28,0,1,0
8,386,386,23,16,7,2,1
7,402,402,32,32,0,1,0
21,438,438,12,12,0,1,0
19,451,451,52,52,0,1,0
2,456,456,39,39,0,1,0
1,461,461,77,26,51,3,2
6,492,492,5,5,0,1,0

5,107,107,6,6,0,1,0
18,110,110,36,36,0,1,0
12,128,128,1,1,0,1,0
3,142,142,16,6,10,3,2
24,156,156,46,46,0,1,0
21,170,170,31,21,10,3,2
0,184,184,2,2,0,1,0
1,192,192,17,8,9,4,3
26,203,203,17,17,0,1,0
22,215,215,5,5,0,1,0
2,221,221,10,1,9,4,3
9,228,228,22,22,0,1,0
19,251,251,9,2,7,2,1
23,253,253,39,39,0,1,0
20,274,274,3,3,0,1,0
25,290,290,21,21,0,1,0
8,290,290,22,22,0,1,0
10,306,306,8,8,0,1,0
13,337,337,1,1,0,1,0
6,354,354,94,94,0,1,0
11,377,377,36,18,18,3,2
15,382,382,3,3,0,1,0
14,389,389,74,8,66,3,2
4,397,397,42,9,33,4,3
16,442,442,18,18,0,1,0
17,446,446,2,2,0,1,0
7,459,459,10,10,0,1,0

15,109,109,10,2,8,3,2
17,122,122,45,14,31,4,3
21,134,134,13,13,0,1,0
19,153,153,13,13,0,1,0
25,175,175,20,9,11,2,1
7,183,183,2,2,0,1,0
11,186,186,22,22,0,1,0
12,189,189,9,1,8,3,2
8,197,197,24,16,8,2,1
9,202,202,8,8,0,1,0
10,215,215,37,37,0,1,0
20,222,222,18,18,0,1,0
0,229,229,24,24,0,1,0
24,245,245,20,20,0,1,0
13,275,275,11,11,0,1,0
3,286,286,8,8,0,1,0
14,289,289,41,8,33,4,3
2,302,302,29,5,24,3,2
6,305,305,10,4,6,3,2
18,327,327,6,6,0,1,0
16,377,377,11,1,10,3,2
4,394,394,16,2,14,3,2
5,437,437,42,42,0,1,0
22,451,451,43,43,0,1,0
1,460,460,116,98,18,4,3
23,482,482,12,7,5,2,1

13,108,108,26,17,9,2,1
2,124,124,28,10,18,4,3
18,130,130,10,10,0,1,0
12,132,132,5,5,0,1,0
23,170,170,16,16,0,1,0
14,172,172,6,1,5,2,1
4,175,175,16,6,10,2,1
17,205,205,5,5,0,1,0
1,210,210,5,5,0,1,0
22,222,222,10,10,0,1,0
5,259,259,1,1,0,1,0
8,268,268,13,13,0,1,0
16,271,271,16,10,6,2,1
3,320,320,28,28,0,1,0
20,339,339,33,5,28,3,2
19,354,354,51,51,0,1,0
9,354,354,28,6,22,4,3
15,362,362,34,3,31,2,1
6,396,396,7,1,6,2,1
7,409,409,102,36,66,4,3
21,413,413,118,118,0,1,0
11,421,421,86,78,8,2,1
10,495,495,1,1,0,1,0
0,500,500,84,57,27,4,3

4,106,106,14,2,12,2,1
10,108,108,17,17,0,1,0
14,119,119,25,25,0,1,0
16,132,132,5,1,4,2,1
12,148,148,6,6,0,1,0
2,172,172,75,75,0,1,0
1,208,208,35,35,0,1,0
17,217,217,26,26,0,1,0
6,221,221,4,4,0,1,0
11,230,230,12,12,0,1,0
15,232,232,6,1,5,2,1
13,305,305,6,3,3,2,1
19,362,362,16,16,0,1,0
18,382,382,171,127,44,3,2
20,388,388,20,20,0,1,0
3,393,393,5,1,4,2,1
7,400,400,4,4,0,1,0
9,405,405,8,8,0,1,0
0,406,406,84,84,0,1,0
8,449,449,72,72,0,1,0
5,459,459,26,19,7,2,1

5,115,115,1,1,0,1,0
18,137,137,4,4,0,1,0
10,163,163,28,13,15,2,1
14,184,184,20,20,0,1,0
15,211,211,57,42,15,2,1
11,235,235,17,17,0,1,0
19,244,244,8,8,0,1,0
3,253,253,16,16,0,1,0
17,301,301,15,15,0,1,0
0,313,313,42,42,0,1,0
2,377,377,16,8,8,3,2
4,380,380,100,79,21,4,3
6,384,384,98,98,0,1,0
12,388,388,24,7,17,4,3
8,466,466,48,24,24,4,3
7,468,468,35,35,0,1,0
13,468,468,21,3,18,4,3
9,471,471,43,43,0,1,0
1,478,478,172,153,19,4,3
16,496,496,91,54,37,4,3

6,131,131,8,8,0,1,0
11,138,138,30,11,19,3,2
0,139,139,56,56,0,1,0
4,144,144,51,51,0,1,0
2,147,147,4,4,0,1,0
5,182,182,24,24,0,1,0
9,228,228,18,3,15,2,1
10,250,250,3,3,0,1,0
18,259,259,5,5,0,1,0
17,281,281,5,1,4,2,1
13,302,302,109,13,96,3,2
1,305,305,1,1,0,1,0
3,306,306,64,26,38,3,2
7,364,364,4,4,0,1,0
14,366,366,29,29,0,1,0
15,380,380,12,2,10,3,2
12,397,397,42,30,12,4,3
19,397,397,92,32,60,3,2
8,435,435,22,22,0,1,0
16,469,469,8,8,0,1,0

2,108,108,9,9,0,1,0
19,113,113,4,4,0,1,0
3,121,121,23,1,22,2,1
21,151,151,1,1,0,1,0
23,152,152,5,5,0,1,0
12,166,166,22,22,0,1,0
14,171,171,36,36,0,1,0
1,173,173,11,3,8,3,2
24,191,191,12,12,0,1,0
9,218,218,9,9,0,1,0
20,220,220,49,49,0,1,0
18,259,259,47,47,0,1,0
10,275,275,4,4,0,1,0
0,275,275,25,25,0,1,0
7,285,285,26,11,15,2,1
16,322,322,25,5,20,3,2
17,341,341,24,24,0,1,0
8,357,357,31,31,0,1,0
25,361,361,34,34,0,1,0
22,387,387,28,28,0,1,0
4,397,397,75,75,0,1,0
5,441,441,49,49,0,1,0
13,457,457,41,26,15,4,3
11,472,472,6,6,0,1,0
15,473,473,79,76,3,2,1
6,473,473,2,2,0,1,0

1,114,114,12,4,8,3,2
13,143,143,16,16,0,1,0
3,159,159,14,5,9,2,1
20,216,216,26,18,8,2,1
2,227,227,18,18,0,1,0
8,259,259,36,8,28,3,2
18,266,266,12,12,0,1,0
19,285,285,6,6,0,1,0
11,287,287,69,23,46,2,1
5,287,287,126,84,42,4,3
9,296,296,51,51,0,1,0
17,307,307,35,35,0,1,0
15,327,327,3,3,0,1,0
21,328,328,35,14,21,4,3
14,353,353,35,13,22,2,1
10,377,377,51,51,0,1,0
16,459,459,2,2,0,1,0
6,470,470,22,4,18,2,1
0,471,471,42,6,36,2,1
7,477,477,1,1,0,1,0
4,487,487,20,3,17,2,1
12,494,494,108,99,9,4,3

13,141,141,24,13,11,2,1
8,155,155,12,2,10,2,1
1,157,157,2,2,0,1,0
3,167,167,22,1,21,4,3
18,210,210,6,6,0,1,0
6,246,246,34,8,26,2,1
7,262,262,13,10,3,2,1
16,270,270,68,68,0,1,0
9,272,272,33,1,32,3,2
15,275,275,49,49,0,1,0
17,297,297,4,4,0,1,0
20,300,300,21,21,0,1,0
4,307,307,12,12,0,1,0
10,317,317,8,8,0,1,0
5,331,331,39,26,13,2,1
0,344,344,98,98,0,1,0
23,372,372,11,8,3,2,1
22,400,400,1,1,0,1,0
2,426,426,12,4,8,3,2
19,433,433,101,9,92,3,2
11,436,436,76,76,0,1,0
21,443,443,38,24,14,3,2
12,459,459,37,3,34,3,2
14,463,463,34,20,14,3,2

8,116,116,3,3,0,1,0
14,152,152,3,3,0,1,0
15,165,165,18,18,0,1,0
17,167,167,12,12,0,1,0
7,172,172,4,4,0,1,0
13,227,227,14,2,12,2,1
4,229,229,74,28,46,4,3
10,232,232,18,18,0,1,0
21,243,243,28,28,0,1,0
0,255,255,59,18,41,2,1
2,259,259,1,1,0,1,0
9,281,281,27,8,19,2,1
12,299,299,4,4,0,1,0
3,302,302,11,11,0,1,0
1,315,315,33,33,0,1,0
25,325,325,9,9,0,1,0
20,328,328,98,98,0,1,0
11,368,368,27,5,22,3,2
5,388,388,7,7,0,1,0
23,394,394,105,19,86,3,2
6,404,404,45,45,0,1,0
24,420,420,27,27,0,1,0
16,440,440,52,52,0,1,0
18,471,471,7,7,0,1,0
19,483,483,27,27,0,1,0
22,497,497,30,13,17,2,1

17,122,122,2,2,0,1,0
11,133,133,27,17,10,2,1
22,134,134,11,11,0,1,0
7,149,149,20,12,8,3,2
16,153,153,28,24,4,2,1
21,157,157,4,4,0,1,0
10,172,172,25,10,15,2,1
18,183,183,27,19,8,2,1
12,193,193,6,6,0,1,0
3,222,222,5,5,0,1,0
9,224,224,9,1,8,2,1
23,288,288,4,4,0,1,0
8,292,292,13,13,0,1,0
15,293,293,1,1,0,1,0
2,301,301,7,3,4,2,1
1,310,310,43,31,12,4,3
5,338,338,51,37,14,2,1
20,358,358,58,30,28,2,1
4,370,370,44,44,0,1,0
19,439,439,185,185,0,1,0
14,460,460,40,11,29,2,1
0,466,466,44,29,15,4,3
6,477,477,42,42,0,1,0
13,493,493,26,26,0,1,0

2,105,105,6,6,0,1,0
23,120,120,3,3,0,1,0
25,129,129,8,8,0,1,0
19,147,147,47,47,0,1,0
26,155,155,3,3,0,1,0
10,164,164,6,6,0,1,0
4,191,191,8,8,0,1,0
17,195,195,18,18,0,1,0
0,201,201,23,23,0,1,0
9,250,250,18,4,14,2,1
8,294,294,7,2,5,2,1
5,296,296,13,13,0,1,0
12,299,299,11,11,0,1,0
20,311,311,3,3,0,1,0
21,316,316,3,3,0,1,0
7,319,319,2,2,0,1,0
3,350,350,81,81,0,1,0
11,359,359,40,23,17,4,3
6,362,362,1,1,0,1,0
22,369,369,110,110,0,1,0
14,399,399,39,25,14,3,2
16,399,399,2,2,0,1,0
18,443,443,67,67,0,1,0
15,446,446,57,57,0,1,0
13,446,446,25,13,12,3,2
1,458,458,65,65,0,1,0
24,464,464,76,35,41,4,3
27,498,498,36,36,0,1,0

19,101,101,1,1,0,1,0
25,102,102,14,7,7,2,1
3,173,173,24,24,0,1,0
8,189,189,1,1,0,1,0
22,202,202,18,18,0,1,0
6,227,227,4,4,0,1,0
10,239,239,9,9,0,1,0
20,245,245,4,4,0,1,0
5,247,247,34,4,30,4,3
23,250,250,59,59,0,1,0
7,258,258,6,2,4,2,1
12,281,281,14,14,0,1,0
15,282,282,3,3,0,1,0
11,301,301,36,36,0,1,0
13,310,310,13,3,10,3,2
4,319,319,10,10,0,1,0
16,322,322,52,35,17,2,1
21,359,359,42,42,0,1,0
9,377,377,34,34,0,1,0
2,383,383,10,10,0,1,0
0,386,386,44,44,0,1,0
26,395,395,6,6,0,1,0
17,431,431,7,2,5,2,1
1,432,432,28,16,12,4,3
18,444,444,150,124,26,3,2
14,445,445,135,41,94,3,2
24,472,472,39,39,0,1,0

19,106,106,3,3,0,1,0
9,108,108,10,4,6,2,1
6,138,138,5,1,4,2,1
16,171,171,8,4,4,2,1
12,180,180,22,4,18,4,3
13,213,213,32,32,0,1,0
18,220,220,42,4,38,4,3
22,258,258,24,9,15,4,3
2,262,262,7,2,5,2,1
0,271,271,9,9,0,1,0
15,289,289,26,26,0,1,0
1,302,302,5,5,0,1,0
10,312,312,112,112,0,1,0
14,332,332,21,15,6,2,1
4,356,356,37,37,0,1,0
8,361,361,8,8,0,1,0
21,403,403,116,7,109,4,3
17,421,421,10,10,0,1,0
7,434,434,159,79,80,4,3
11,441,441,49,1,48,2,1
3,466,466,65,16,49,2,1
20,477,477,9,9,0,1,0
5,494,494,3,3,0,1,0

24,121,121,1,1,0,1,0
11,127,127,48,18,30,3,2
18,130,130,2,2,0,1,0
8,148,148,9,1,8,2,1
4,150,150,1,1,0,1,0
23,161,161,9,9,0,1,0
6,172,172,1,1,0,1,0
1,196,196,11,11,0,1,0
5,220,220,1,1,0,1,0
17,225,225,33,21,12,2,1
10,275,275,12,12,0,1,0
14,275,275,61,10,51,4,3
9,309,309,28,28,0,1,0
16,310,310,103,53,50,3,2
19,313,313,4,4,0,1,0
15,328,328,10,6,4,2,1
3,367,367,37,31,6,3,2
12,390,390,29,29,0,1,0
0,397,397,50,26,24,3,2
22,404,404,39,27,12,3,2
2,430,430,10,10,0,1,0
7,437,437,3,3,0,1,0
25,447,447,90,45,45,4,3
20,449,449,47,14,33,4,3
13,487,487,109,109,0,1,0
21,490,490,3,3,0,1,0

1,100,100,2,2,0,1,0
18,141,141,1,1,0,1,0
12,154,154,29,2,27,2,1
25,175,175,1,1,0,1,0
3,186,186,7,7,0,1,0
16,210,210,29,29,0,1,0
6,224,224,1,1,0,1,0
21,246,246,4,1,3,2,1
0,252,252,23,13,10,3,2
15,256,256,1,1,0,1,0
28,262,262,20,20,0,1,0
20,265,265,15,2,13,2,1
2,268,268,33,33,0,1,0
26,296,296,57,1,56,3,2
27,304,304,66,51,15,2,1
10,305,305,4,4,0,1,0
13,307,307,13,4,9,2,1
11,326,326,76,26,50,4,3
4,375,375,1,1,0,1,0
7,391,391,48,33,15,4,3
22,412,412,69,35,34,2,1
29,427,427,39,39,0,1,0
23,446,446,66,66,0,1,0
19,452,452,75,35,40,4,3
14,464,464,44,15,29,2,1
9,465,465,20,10,10,4,3
5,469,469,4,4,0,1,0
8,470,470,1,1,0,1,0
24,471,471,39,39,0,1,0
17,491,491,16,7,9,4,3

18,104,104,6,6,0,1,0
22,119,119,3,3,0,1,0
10,125,125,22,14,8,3,2
0,128,128,24,10,14,3,2
8,133,133,22,15,7,2,1
16,133,133,8,8,0,1,0
4,151,151,17,6,11,2,1
15,155,155,18,2,16,3,2
23,183,183,21,21,0,1,0
5,186,186,5,2,3,2,1
14,210,210,33,33,0,1,0
20,218,218,73,73,0,1,0
11,256,256,11,1,10,2,1
2,265,265,27,4,23,2,1
7,267,267,29,29,0,1,0
21,289,289,15,3,12,2,1
1,332,332,3,3,0,1,0
12,392,392,49,49,0,1,0
9,426,426,18,18,0,1,0
17,437,437,24,8,16,3,2
19,454,454,25,10,15,2,1
6,480,480,91,4,87,4,3
3,482,482,19,1,18,2,1
13,482,482,40,28,12,3,2

5,118,118,1,1,0,1,0
19,119,119,7,4,3,2,1
4,143,143,3,3,0,1,0
10,158,158,2,2,0,1,0
2,166,166,46,46,0,1,0
9,172,172,9,9,0,1,0
12,187,187,11,11,0,1,0
6,203,203,19,5,14,2,1
17,248,248,29,29,0,1,0
20,259,259,3,3,0,1,0
8,260,260,23,2,21,4,3
0,263,263,85,73,12,4,3
21,273,273,3,3,0,1,0
15,288,288,6,6,0,1,0
18,357,357,50,50,0,1,0
13,367,367,24,16,8,3,2
3,397,397,1,1,0,1,0
14,398,398,4,4,0,1,0
1,402,402,3,3,0,1,0
16,410,410,142,38,104,4,3
7,414,414,131,41,90,4,3
11,476,476,38,38,0,1,0
22,499,499,154,154,0,1,0

19,111,111,6,3,3,2,1
1,119,119,34,3,31,2,1
15,163,163,9,9,0,1,0
14,227,227,12,4,8,3,2
7,277,277,1,1,0,1,0
6,278,278,33,33,0,1,0
12,286,286,15,15,0,1,0
11,291,291,1,1,0,1,0
3,292,292,63,63,0,1,0
21,297,297,17,5,12,3,2
2,354,354,53,48,5,2,1
16,358,358,36,36,0,1,0
17,360,360,60,60,0,1,0
20,381,381,29,9,20,2,1
10,385,385,49,49,0,1,0
0,394,394,1,1,0,1,0
13,414,414,20,15,5,2,1
18,417,417,178,178,0,1,0
8,421,421,59,11,48,4,3
4,455,455,7,7,0,1,0
5,460,460,42,42,0,1,0
9,472,472,84,42,42,4,3

9,114,114,3,3,0,1,0
7,120,120,17,7,10,3,2
12,145,145,7,7,0,1,0
27,174,174,20,2,18,2,1
4,180,180,4,4,0,1,0
13,208,208,30,30,0,1,0
20,244,244,33,33,0,1,0
22,245,245,38,29,9,4,3
3,250,250,6,6,0,1,0
21,252,252,54,54,0,1,0
11,271,271,3,3,0,1,0
14,276,276,19,6,13,2,1
26,278,278,48,33,15,4,3
1,285,285,21,21,0,1,0
23,290,290,14,14,0,1,0
16,299,299,22,16,6,2,1
8,307,307,84,26,58,3,2
15,323,323,27,13,14,2,1
19,363,363,18,3,15,3,2
25,363,363,27,11,16,3,2
24,385,385,14,14,0,1,0
5,386,386,15,15,0,1,0
18,408,408,14,6,8,2,1
6,408,408,2,2,0,1,0
2,423,423,1,1,0,1,0
10,435,435,16,16,0,1,0
17,456,456,53,34,19,4,3
0,487,487,98,98,0,1,0

19,121,121,17,17,0,1,0
2,133,133,1,1,0,1,0
27,146,146,23,23,0,1,0
14,150,150,1,1,0,1,0
13,154,154,7,7,0,1,0
7,168,168,1,1,0,1,0
17,186,186,20,1,19,2,1
20,187,187,30,30,0,1,0
8,195,195,2,2,0,1,0
11,200,200,12,2,10,3,2
29,214,214,11,5,6,3,2
24,218,218,27,27,0,1,0
3,221,221,12,5,7,2,1
25,279,279,8,8,0,1,0
23,287,287,26,4,22,2,1
18,289,289,4,4,0,1,0
4,303,303,1,1,0,1,0
0,352,352,14,14,0,1,0
6,367,367,61,10,51,4,3
15,382,382,76,76,0,1,0
31,393,393,55,40,15,4,3
26,405,405,29,5,24,3,2
1,408,408,7,1,6,3,2
30,421,421,8,8,0,1,0
5,424,424,17,17,0,1,0
21,431,431,5,5,0,1,0
16,440,440,25,4,21,2,1
12,445,445,44,17,27,3,2
28,451,451,128,94,34,2,1
22,465,465,40,40,0,1,0
9,478,478,33,12,21,2,1
10,497,497,31,24,7,2,1

2,136,136,8,8,0,1,0
19,174,174,26,11,15,4,3
9,178,178,13,13,0,1,0
12,184,184,24,9,15,4,3
14,208,208,47,5,42,4,3
8,255,255,37,34,3,2,1
10,266,266,40,30,10,2,1
1,274,274,11,11,0,1,0
15,280,280,19,7,12,2,1
18,286,286,23,13,10,3,2
0,318,318,16,16,0,1,0
22,318,318,21,21,0,1,0
4,321,321,1,1,0,1,0
21,322,322,2,2,0,1,0
3,342,342,1,1,0,1,0
24,348,348,78,18,60,4,3
7,358,358,24,9,15,4,3
5,369,369,95,38,57,4,3
23,407,407,7,7,0,1,0
16,418,418,57,26,31,2,1
20,421,421,86,35,51,4,3
13,449,449,9,9,0,1,0
17,480,480,9,6,3,2,1
6,489,489,88,78,10,2,1
11,493,493,21,21,0,1,0

21,112,112,6,1,5,2,1
9,113,113,1,1,0,1,0
15,122,122,12,12,0,1,0
13,153,153,13,7,6,3,2
7,173,173,18,18,0,1,0
18,204,204,5,5,0,1,0
16,207,207,3,3,0,1,0
17,210,210,41,41,0,1,0
14,217,217,17,17,0,1,0
10,228,228,12,12,0,1,0
3,243,243,3,3,0,1,0
5,247,247,41,33,8,2,1
12,264,264,115,115,0,1,0
4,292,292,42,42,0,1,0
0,295,295,120,88,32,3,2
1,302,302,2,2,0,1,0
19,317,317,17,17,0,1,0
8,358,358,51,30,21,4,3
20,362,362,59,11,48,2,1
6,437,437,28,28,0,1,0
22,461,461,6,2,4,2,1
2,479,479,45,45,0,1,0
11,498,498,9,9,0,1,0

16,101,101,38,38,0,1,0
13,128,128,3,3,0,1,0
9,161,161,19,9,10,2,1
2,166,166,1,1,0,1,0
5,185,185,7,1,6,3,2
4,228,228,95,83,12,2,1
1,237,237,35,25,10,3,2
20,264,264,12,12,0,1,0
10,265,265,4,4,0,1,0
8,284,284,7,7,0,1,0
18,285,285,10,7,3,2,1
19,303,303,22,22,0,1,0
15,304,304,125,125,0,1,0
3,312,312,33,33,0,1,0
14,326,326,1,1,0,1,0
7,337,337,43,18,25,2,1
0,349,349,1,1,0,1,0
11,374,374,23,23,0,1,0
6,415,415,138,114,24,2,1
17,467,467,14,14,0,1,0
12,468,468,13,9,4,2,1

3,140,140,10,1,9,2,1
20,141,141,22,1,21,3,2
2,147,147,31,13,18,4,3
17,158,158,2,2,0,1,0
10,192,192,1,1,0,1,0
12,198,198,20,20,0,1,0
22,217,217,14,14,0,1,0
24,225,225,6,6,0,1,0
13,250,250,8,8,0,1,0
14,259,259,36,15,21,4,3
25,265,265,14,14,0,1,0
0,273,273,59,32,27,4,3
16,294,294,22,11,11,2,1
6,297,297,5,5,0,1,0
11,336,336,76,76,0,1,0
21,360,360,105,94,11,4,3
1,365,365,26,17,9,4,3
15,366,366,93,66,27,2,1
9,370,370,5,2,3,2,1
8,377,377,4,1,3,2,1
5,389,389,75,75,0,1,0
23,395,395,4,1,3,2,1
19,418,418,11,11,0,1,0
7,424,424,1,1,0,1,0
4,435,435,13,5,8,3,2
18,484,484,53,47,6,3,2

17,107,107,3,3,0,1,0
3,140,140,40,40,0,1,0
20,141,141,13,13,0,1,0
19,145,145,6,6,0,1,0
21,150,150,12,3,9,2,1
2,160,160,1,1,0,1,0
22,225,225,27,5,22,2,1
10,231,231,10,10,0,1,0
23,252,252,38,33,5,2,1
16,253,253,17,17,0,1,0
24,271,271,50,50,0,1,0
9,303,303,16,10,6,3,2
18,304,304,52,5,47,2,1
6,311,311,67,36,31,2,1
7,313,313,1,1,0,1,0
13,326,326,14,2,12,3,2
1,328,328,17,17,0,1,0
4,349,349,1,1,0,1,0
5,373,373,46,40,6,3,2
14,416,416,100,100,0,1,0
12,426,426,55,55,0,1,0
8,432,432,2,2,0,1,0
0,464,464,101,97,4,2,1
11,492,492,32,32,0,1,0
15,498,498,5,5,0,1,0

13,121,121,18,4,14,2,1
12,121,121,17,4,13,4,3
19,125,125,5,5,0,1,0
3,136,136,15,15,0,1,0
15,147,147,20,20,0,1,0
5,150,150,25,3,22,3,2
21,152,152,1,1,0,1,0
1,182,182,14,9,5,2,1
20,209,209,4,4,0,1,0
18,304,304,7,7,0,1,0
7,306,306,5,5,0,1,0
2,314,314,9,3,6,2,1
9,347,347,49,11,38,3,2
16,355,355,69,39,30,2,1
22,356,356,13,13,0,1,0
14,372,372,24,11,13,2,1
4,381,381,52,23,29,2,1
0,384,384,1,1,0,1,0
8,415,415,124,124,0,1,0
6,418,418,88,53,35,2,1
17,434,434,72,33,39,2,1
11,451,451,117,97,20,2,1
10,452,452,6,6,0,1,0

16,110,110,28,28,0,1,0
13,115,115,10,10,0,1,0
17,138,138,27,18,9,4,3
25,176,176,5,5,0,1,0
3,181,181,37,20,17,2,1
19,194,194,9,9,0,1,0
12,199,199,27,27,0,1,0
15,200,200,3,3,0,1,0
11,202,202,1,1,0,1,0
7,205,205,5,5,0,1,0
27,214,214,10,10,0,1,0
21,246,246,3,3,0,1,0
9,291,291,78,35,43,4,3
20,300,300,3,3,0,1,0
14,300,300,22,8,14,3,2
22,334,334,83,83,0,1,0
5,342,342,8,3,5,2,1
2,350,350,1,1,0,1,0
24,362,362,6,6,0,1,0
23,363,363,18,18,0,1,0
1,377,377,15,6,9,4,3
26,400,400,80,80,0,1,0
8,423,423,31,21,10,3,2
0,431,431,35,32,3,2,1
6,444,444,67,67,0,1,0
18,449,449,53,53,0,1,0
10,457,457,8,3,5,2,1
4,467,467,1,1,0,1,0

20,119,119,7,7,0,1,0
4,124,124,15,15,0,1,0
13,125,125,5,5,0,1,0
3,140,140,2,2,0,1,0
0,147,147,42,12,30,3,2
21,148,148,11,1,10,2,1
2,169,169,2,2,0,1,0
15,232,232,46,31,15,4,3
5,243,243,32,14,18,3,2
10,252,252,6,6,0,1,0
1,281,281,3,3,0,1,0
19,283,283,34,23,11,2,1
17,285,285,8,8,0,1,0
6,293,293,78,53,25,4,3
11,298,298,19,19,0,1,0
14,313,313,43,4,39,2,1
18,378,378,10,1,9,4,3
9,380,380,6,6,0,1,0
7,408,408,100,2,98,3,2
8,422,422,5,2,3,2,1
16,461,461,104,56,48,4,3
23,463,463,20,20,0,1,0
12,470,470,40,30,10,3,2
22,498,498,93,83,10,2,1

20,111,111,47,47,0,1,0
8,186,186,43,5,38,3,2
5,186,186,7,7,0,1,0
18,230,230,4,4,0,1,0
12,240,240,33,33,0,1,0
15,246,246,10,2,8,3,2
14,252,252,31,28,3,2,1
19,253,253,15,1,14,3,2
4,278,278,22,22,0,1,0
9,303,303,60,42,18,2,1
3,303,303,30,30,0,1,0
7,307,307,111,15,96,4,3
1,327,327,86,86,0,1,0
2,353,353,14,14,0,1,0
10,402,402,10,6,4,2,1
6,434,434,8,8,0,1,0
0,454,454,32,32,0,1,0
16,463,463,42,42,0,1,0
13,488,488,8,8,0,1,0
17,490,490,2,2,0,1,0
11,495,495,43,34,9,2,1

14,118,118,4,4,0,1,0
1,138,138,1,1,0,1,0
0,159,159,21,21,0,1,0
16,160,160,30,30,0,1,0
19,187,187,36,36,0,1,0
8,192,192,33,33,0,1,0
3,225,225,14,6,8,3,2
5,230,230,31,25,6,2,1
12,240,240,28,28,0,1,0
17,257,257,6,2,4,2,1
2,261,261,29,29,0,1,0
13,292,292,3,3,0,1,0
10,297,297,31,3,28,4,3
4,300,300,36,36,0,1,0
15,310,310,31,31,0,1,0
11,328,328,16,4,12,2,1
9,360,360,34,16,18,4,3
6,361,361,227,227,0,1,0
18,416,416,59,38,21,4,3
7,433,433,2,2,0,1,0

15,128,128,1,1,0,1,0
20,129,129,7,3,4,2,1
19,135,135,6,6,0,1,0
21,135,135,21,6,15,4,3
12,143,143,13,2,11,2,1
17,151,151,10,10,0,1,0
5,163,163,1,1,0,1,0
24,186,186,4,4,0,1,0
22,189,189,6,6,0,1,0
6,204,204,6,6,0,1,0
2,226,226,23,10,13,2,1
23,227,227,13,13,0,1,0
1,262,262,53,48,5,2,1
10,270,270,8,8,0,1,0
18,312,312,65,21,44,2,1
13,316,316,17,17,0,1,0
3,320,320,21,2,19,4,3
28,359,359,20,5,15,2,1
9,364,364,1,1,0,1,0
26,371,371,86,47,39,2,1
8,374,374,1,1,0,1,0
7,380,380,35,12,23,4,3
16,394,394,31,3,28,2,1
27,402,402,84,35,49,2,1
4,411,411,5,5,0,1,0
0,446,446,76,16,60,4,3
11,465,465,44,29,15,2,1
14,466,466,75,75,0,1,0
25,479,479,43,43,0,1,0

9,126,126,34,13,21,4,3
18,141,141,42,15,27,4,3
5,144,144,5,5,0,1,0
6,147,147,114,90,24,4,3
10,156,156,5,5,0,1,0
3,171,171,11,11,0,1,0
15,278,278,40,4,36,3,2
12,287,287,6,2,4,2,1
11,288,288,11,2,9,4,3
4,301,301,16,16,0,1,0
1,329,329,4,4,0,1,0
8,332,332,17,2,15,2,1
0,365,365,55,8,47,2,1
2,370,370,32,32,0,1,0
7,372,372,9,9,0,1,0
14,379,379,28,22,6,2,1
19,380,380,39,20,19,4,3
16,402,402,5,1,4,2,1
13,443,443,52,52,0,1,0
17,461,461,31,17,14,2,1

10,111,111,23,8,15,4,3
12,112,112,38,38,0,1,0
3,124,124,2,2,0,1,0
13,129,129,18,18,0,1,0
8,149,149,30,18,12,2,1
9,150,150,3,3,0,1,0
7,173,173,7,2,5,2,1
16,218,218,10,10,0,1,0
20,238,238,13,13,0,1,0
4,246,246,4,4,0,1,0
17,296,296,16,7,9,2,1
15,317,317,26,26,0,1,0
18,329,329,30,30,0,1,0
2,341,341,96,96,0,1,0
21,347,347,19,19,0,1,0
14,348,348,13,5,8,3,2
19,362,362,24,24,0,1,0
5,428,428,198,180,18,4,3
0,441,441,13,13,0,1,0
11,465,465,27,6,21,2,1
6,485,485,52,2,50,3,2
1,485,485,15,15,0,1,0

13,122,122,11,11,0,1,0
15,193,193,11,4,7,2,1
1,210,210,30,9,21,4,3
14,218,218,37,7,30,3,2
8,223,223,45,1,44,2,1
10,247,247,4,1,3,2,1
17,251,251,41,41,0,1,0
22,266,266,41,41,0,1,0
19,266,266,27,27,0,1,0
21,319,319,19,10,9,2,1
3,339,339,2,2,0,1,0
6,352,352,13,1,12,2,1
2,368,368,5,5,0,1,0
7,378,378,6,6,0,1,0
16,393,393,13,5,8,3,2
4,407,407,12,6,6,2,1
9,418,418,67,25,42,3,2
11,423,423,64,4,60,4,3
18,439,439,17,17,0,1,0
5,456,456,81,44,37,2,1
0,461,461,76,76,0,1,0
24,467,467,48,28,20,3,2
23,489,489,99,67,32,3,2
12,493,493,42,42,0,1,0
20,494,494,24,16,8,3,2

5,141,141,34,34,0,1,0
16,187,187,28,28,0,1,0
15,196,196,7,7,0,1,0
10,214,214,31,31,0,1,0
13,230,230,7,4,3,2,1
2,246,246,80,74,6,2,1
7,275,275,81,81,0,1,0
1,280,280,1,1,0,1,0
8,315,315,1,1,0,1,0
14,315,315,33,33,0,1,0
0,330,330,153,122,31,2,1
11,331,331,31,11,20,2,1
4,335,335,62,32,30,2,1
6,396,396,1,1,0,1,0
12,410,410,23,8,15,4,3
3,469,469,105,83,22,2,1
9,492,492,33,33,0,1,0

14,126,126,6,6,0,1,0
4,136,136,26,26,0,1,0
9,138,138,20,20,0,1,0
12,160,160,6,3,3,2,1
0,184,184,13,13,0,1,0
6,190,190,45,37,8,3,2
20,205,205,23,23,0,1,0
18,222,222,33,33,0,1,0
7,244,244,79,13,66,4,3
3,253,253,3,3,0,1,0
17,267,267,16,8,8,2,1
15,300,300,2,2,0,1,0
5,311,311,43,43,0,1,0
1,324,324,45,45,0,1,0
16,329,329,62,41,21,2,1
2,360,360,13,1,12,2,1
11,379,379,9,9,0,1,0
13,414,414,145,83,62,4,3
10,436,436,37,37,0,1,0
19,473,473,10,10,0,1,0
8,475,475,25,25,0,1,0

17,108,108,7,7,0,1,0
13,124,124,19,5,14,2,1
16,135,135,15,15,0,1,0
10,147,147,15,4,11,3,2
12,170,170,32,6,26,2,1
5,230,230,10,4,6,3,2
14,244,244,56,56,0,1,0
8,248,248,4,4,0,1,0
15,253,253,2,2,0,1,0
0,318,318,35,18,17,2,1
6,356,356,29,29,0,1,0
4,358,358,17,17,0,1,0
9,360,360,66,40,26,2,1
3,370,370,120,120,0,1,0
19,371,371,23,4,19,2,1
7,378,378,10,6,4,2,1
2,392,392,156,110,46,4,3
18,410,410,9,9,0,1,0
1,446,446,76,76,0,1,0
11,456,456,41,16,25,2,1

11,165,165,19,19,0,1,0
5,169,169,1,1,0,1,0
3,181,181,5,2,3,2,1
16,237,237,1,1,0,1,0
13,240,240,17,14,3,2,1
12,243,243,59,28,31,2,1
7,245,245,22,13,9,2,1
0,281,281,35,35,0,1,0
2,281,281,10,10,0,1,0
9,288,288,23,23,0,1,0
17,341,341,53,49,4,2,1
18,365,365,7,3,4,2,1
14,370,370,100,100,0,1,0
1,387,387,64,16,48,3,2
10,426,426,24,24,0,1,0
8,431,431,4,4,0,1,0
4,465,465,22,6,16,3,2
6,484,484,385,385,0,1,0
15,494,494,53,20,33,2,1

3,130,130,14,1,13,2,1
16,145,145,13,13,0,1,0
22,168,168,25,22,3,2,1
13,175,175,16,16,0,1,0
9,209,209,8,4,4,2,1
4,251,251,39,39,0,1,0
20,257,257,11,1,10,2,1
1,259,259,21,8,13,2,1
14,271,271,28,12,16,2,1
5,284,284,29,29,0,1,0
17,286,286,4,4,0,1,0
8,304,304,4,4,0,1,0
23,306,306,20,2,18,2,1
21,323,323,80,32,48,2,1
18,348,348,10,10,0,1,0
2,374,374,15,15,0,1,0
19,440,440,104,26,78,4,3
11,442,442,85,43,42,3,2
10,447,447,54,34,20,3,2
12,452,452,64,64,0,1,0
6,463,463,72,72,0,1,0
7,481,481,40,34,6,2,1
0,483,483,54,54,0,1,0
15,487,487,6,6,0,1,0

4,114,114,19,19,0,1,0
0,115,115,8,8,0,1,0
18,116,116,13,9,4,2,1
5,117,117,4,4,0,1,0
1,124,124,2,2,0,1,0
7,127,127,1,1,0,1,0
22,147,147,4,1,3,2,1
21,163,163,28,28,0,1,0
9,195,195,4,4,0,1,0
19,228,228,39,39,0,1,0
8,234,234,23,23,0,1,0
24,239,239,44,30,14,3,2
12,251,251,20,20,0,1,0
6,252,252,74,74,0,1,0
14,264,264,27,6,21,4,3
23,265,265,4,4,0,1,0
13,292,292,7,7,0,1,0
11,302,302,34,16,18,3,2
15,328,328,22,22,0,1,0
16,380,380,2,2,0,1,0
20,389,389,76,76,0,1,0
3,407,407,82,60,22,3,2
2,430,430,19,12,7,2,1
17,450,450,29,29,0,1,0
25,469,469,51,12,39,2,1
10,473,473,15,15,0,1,0

4,114,114,8,8,0,1,0
22,133,133,9,9,0,1,0
27,146,146,36,36,0,1,0
12,151,151,1,1,0,1,0
24,155,155,14,14,0,1,0
19,159,159,2,2,0,1,0
25,160,160,2,2,0,1,0
14,168,168,1,1,0,1,0
21,192,192,25,12,13,2,1
10,236,236,39,39,0,1,0
28,267,267,24,24,0,1,0
16,271,271,14,10,4,2,1
3,281,281,2,2,0,1,0
15,293,293,25,25,0,1,0
32,294,294,4,4,0,1,0
29,304,304,5,5,0,1,0
18,313,313,18,1,17,2,1
7,322,322,10,10,0,1,0
23,339,339,19,19,0,1,0
31,399,399,69,54,15,4,3
26,409,409,53,27,26,3,2
33,415,415,95,20,75,4,3
8,417,417,18,13,5,2,1
9,424,424,24,24,0,1,0
6,441,441,29,29,0,1,0
11,459,459,60,60,0,1,0
0,464,464,7,2,5,2,1
30,465,465,48,48,0,1,0
17,467,467,26,26,0,1,0
13,484,484,22,22,0,1,0
5,492,492,11,3,8,2,1
20,496,496,30,19,11,2,1
1,500,500,29,29,0,1,0
2,500,500,14,14,0,1,0

3,143,143,7,4,3,2,1
15,160,160,29,23,6,3,2
17,191,191,37,29,8,2,1
13,219,219,41,33,8,3,2
19,235,235,26,26,0,1,0
14,240,240,28,5,23,2,1
12,240,240,6,6,0,1,0
7,252,252,72,72,0,1,0
2,271,271,85,85,0,1,0
10,286,286,71,71,0,1,0
6,289,289,54,54,0,1,0
5,289,289,23,23,0,1,0
1,327,327,6,6,0,1,0
8,345,345,9,3,6,3,2
4,366,366,25,9,16,2,1
16,370,370,18,13,5,2,1
18,404,404,1,1,0,1,0
9,424,424,14,14,0,1,0
11,431,431,21,21,0,1,0
0,460,460,93,51,42,2,1

5,112,112,3,3,0,1,0
3,115,115,1,1,0,1,0
10,158,158,2,2,0,1,0
19,170,170,8,8,0,1,0
8,186,186,1,1,0,1,0
24,189,189,12,12,0,1,0
23,195,195,7,7,0,1,0
4,280,280,16,12,4,2,1
0,300,300,19,1,18,4,3
2,300,300,26,15,11,3,2
9,310,310,95,95,0,1,0
20,329,329,20,8,12,3,2
7,339,339,102,102,0,1,0
25,350,350,157,34,123,4,3
1,357,357,28,28,0,1,0
13,377,377,54,48,6,2,1
16,381,381,14,14,0,1,0
21,419,419,92,8,84,3,2
15,422,422,30,30,0,1,0
14,431,431,47,47,0,1,0
18,460,460,3,3,0,1,0
17,462,462,5,5,0,1,0
22,467,467,49,49,0,1,0
11,469,469,11,7,4,2,1
12,491,491,22,22,0,1,0
6,495,495,21,21,0,1,0

2,110,110,9,9,0,1,0
15,118,118,3,3,0,1,0
11,137,137,8,8,0,1,0
23,151,151,25,16,9,3,2
22,206,206,9,5,4,2,1
16,209,209,14,14,0,1,0
12,245,245,24,9,15,4,3
10,246,246,18,14,4,2,1
0,259,259,3,3,0,1,0
3,280,280,4,4,0,1,0
5,343,343,36,18,18,4,3
19,355,355,76,15,61,3,2
8,357,357,95,67,28,2,1
4,359,359,69,48,21,2,1
6,376,376,12,5,7,2,1
17,393,393,17,12,5,2,1
21,398,398,13,7,6,3,2
1,437,437,23,23,0,1,0
7,458,458,84,42,42,3,2
9,478,478,17,3,14,2,1
13,479,479,36,4,32,2,1
24,486,486,24,24,0,1,0
14,488,488,45,45,0,1,0
18,495,495,88,88,0,1,0
20,497,497,115,115,0,1,0

10,103,103,5,5,0,1,0
14,118,118,1,1,0,1,0
2,140,140,12,12,0,1,0
18,162,162,14,14,0,1,0
16,182,182,10,10,0,1,0
29,208,208,4,4,0,1,0
15,211,211,1,1,0,1,0
9,221,221,2,2,0,1,0
13,257,257,17,17,0,1,0
24,259,259,19,19,0,1,0
26,266,266,38,38,0,1,0
22,272,272,4,4,0,1,0
25,287,287,101,91,10,3,2
11,297,297,41,23,18,3,2
0,307,307,119,75,44,4,3
20,314,314,19,19,0,1,0
6,323,323,11,11,0,1,0
4,336,336,44,7,37,4,3
5,348,348,11,11,0,1,0
21,392,392,59,59,0,1,0
23,406,406,40,40,0,1,0
27,428,428,31,31,0,1,0
12,440,440,44,44,0,1,0
8,448,448,24,24,0,1,0
1,454,454,1,1,0,1,0
17,460,460,3,3,0,1,0
7,461,461,6,2,4,2,1
19,470,470,59,26,33,4,3
3,486,486,13,13,0,1,0
28,499,499,11,11,0,1,0

5,102,102,13,5,8,3,2
22,123,123,1,1,0,1,0
21,133,133,3,3,0,1,0
10,142,142,25,25,0,1,0
16,157,157,1,1,0,1,0
14,176,176,28,28,0,1,0
8,184,184,4,1,3,2,1
19,191,191,2,2,0,1,0
4,221,221,7,7,0,1,0
3,263,263,15,15,0,1,0
25,265,265,1,1,0,1,0
17,278,278,19,19,0,1,0
18,296,296,34,34,0,1,0
15,305,305,70,34,36,4,3
24,307,307,69,69,0,1,0
6,313,313,30,18,12,3,2
0,341,341,48,19,29,3,2
13,349,349,27,10,17,4,3
12,379,379,11,7,4,2,1
7,400,400,13,13,0,1,0
11,405,405,50,4,46,4,3
1,410,410,67,67,0,1,0
2,422,422,42,42,0,1,0
20,426,426,103,28,75,4,3
9,428,428,11,11,0,1,0
23,482,482,67,67,0,1,0

20,119,119,6,6,0,1,0
22,126,126,12,12,0,1,0
30,134,134,35,21,14,2,1
8,135,135,3,3,0,1,0
16,180,180,1,1,0,1,0
24,189,189,9,3,6,3,2
10,191,191,23,23,0,1,0
12,193,193,3,3,0,1,0
21,205,205,21,2,19,4,3
11,221,221,1,1,0,1,0
5,239,239,1,1,0,1,0
1,242,242,101,101,0,1,0
26,257,257,7,7,0,1,0
3,274,274,1,1,0,1,0
6,276,276,1,1,0,1,0
29,287,287,24,24,0,1,0
14,298,298,31,31,0,1,0
23,310,310,61,51,10,2,1
25,314,314,4,4,0,1,0
2,328,328,18,8,10,2,1
32,369,369,21,6,15,2,1
18,370,370,18,18,0,1,0
4,372,372,38,38,0,1,0
31,376,376,61,17,44,2,1
13,414,414,14,14,0,1,0
9,426,426,24,24,0,1,0
17,428,428,1,1,0,1,0
28,432,432,46,46,0,1,0
19,446,446,27,27,0,1,0
0,447,447,4,4,0,1,0
27,449,449,34,14,20,2,1
15,452,452,33,21,12,3,2
7,469,469,7,2,5,2,1

29,127,127,16,1,15,2,1
25,139,139,2,2,0,1,0
14,154,154,1,1,0,1,0
18,174,174,9,4,5,2,1
20,175,175,3,3,0,1,0
11,204,204,6,6,0,1,0
1,209,209,3,3,0,1,0
8,226,226,21,21,0,1,0
26,230,230,11,11,0,1,0
4,253,253,16,16,0,1,0
28,276,276,18,18,0,1,0
10,281,281,7,7,0,1,0
17,322,322,35,35,0,1,0
2,323,323,48,48,0,1,0
16,337,337,34,13,21,3,2
23,358,358,39,21,18,4,3
7,366,366,25,25,0,1,0
3,370,370,5,5,0,1,0
24,380,380,123,99,24,3,2
6,380,380,7,7,0,1,0
21,389,389,25,25,0,1,0
12,407,407,80,80,0,1,0
9,413,413,15,15,0,1,0
19,420,420,39,27,12,3,2
5,420,420,35,3,32,2,1
15,435,435,38,38,0,1,0
27,440,440,55,40,15,4,3
22,455,455,83,27,56,3,2
13,460,460,23,23,0,1,0
0,490,490,28,4,24,3,2

16,105,105,11,11,0,1,0
9,116,116,6,6,0,1,0
22,124,124,15,5,10,3,2
14,124,124,11,8,3,2,1
20,154,154,12,12,0,1,0
8,187,187,12,6,6,2,1
10,188,188,2,2,0,1,0
1,209,209,27,27,0,1,0
15,226,226,22,22,0,1,0
4,241,241,23,11,12,2,1
3,292,292,4,4,0,1,0
17,316,316,78,66,12,4,3
24,328,328,14,14,0,1,0
12,333,333,28,18,10,3,2
18,345,345,21,8,13,2,1
2,357,357,46,2,44,2,1
0,365,365,29,29,0,1,0
13,387,387,67,67,0,1,0
6,399,399,16,16,0,1,0
7,412,412,21,13,8,2,1
21,420,420,23,23,0,1,0
5,422,422,99,80,19,2,1
11,425,425,19,12,7,2,1
25,437,437,31,31,0,1,0
19,461,461,88,79,9,4,3
23,464,464,33,33,0,1,0

20,121,121,4,4,0,1,0
21,131,131,47,47,0,1,0
16,168,168,24,24,0,1,0
19,172,172,27,27,0,1,0
24,196,196,1,1,0,1,0
7,214,214,1,1,0,1,0
26,251,251,52,42,10,2,1
2,261,261,12,7,5,2,1
3,270,270,1,1,0,1,0
15,276,276,50,19,31,2,1
23,289,289,17,10,7,2,1
22,296,296,28,28,0,1,0
13,298,298,46,46,0,1,0
11,298,298,19,19,0,1,0
10,304,304,9,9,0,1,0
25,305,305,17,17,0,1,0
29,316,316,35,7,28,3,2
8,323,323,11,7,4,2,1
0,336,336,17,17,0,1,0
1,340,340,82,82,0,1,0
18,347,347,28,11,17,3,2
12,351,351,2,2,0,1,0
27,358,358,20,20,0,1,0
28,381,381,4,1,3,2,1
17,396,396,16,16,0,1,0
4,400,400,23,23,0,1,0
6,419,419,1,1,0,1,0
5,463,463,40,16,24,3,2
9,465,465,16,16,0,1,0
14,495,495,11,11,0,1,0

23,106,106,15,4,11,2,1
11,130,130,14,14,0,1,0
12,132,132,1,1,0,1,0
20,132,132,1,1,0,1,0
24,149,149,25,25,0,1,0
15,150,150,13,1,12,3,2
4,153,153,11,4,7,3,2
8,163,163,9,9,0,1,0
17,208,208,9,9,0,1,0
9,259,259,4,4,0,1,0
19,262,262,12,12,0,1,0
7,278,278,12,12,0,1,0
6,283,283,2,2,0,1,0
21,304,304,34,10,24,2,1
2,311,311,2,2,0,1,0
10,321,321,13,13,0,1,0
22,339,339,161,68,93,4,3
3,349,349,11,11,0,1,0
27,354,354,10,3,7,2,1
14,361,361,96,9,87,4,3
26,370,370,24,24,0,1,0
1,381,381,56,11,45,2,1
13,421,421,35,35,0,1,0
16,435,435,21,21,0,1,0
18,436,436,5,5,0,1,0
5,436,436,98,49,49,2,1
25,454,454,40,10,30,4,3
0,458,458,3,3,0,1,0

15,106,106,32,32,0,1,0
13,170,170,27,27,0,1,0
2,180,180,2,2,0,1,0
0,181,181,15,9,6,3,2
9,182,182,7,7,0,1,0
17,185,185,15,15,0,1,0
8,225,225,17,17,0,1,0
7,263,263,56,8,48,4,3
12,264,264,39,39,0,1,0
20,291,291,6,6,0,1,0
10,296,296,11,11,0,1,0
18,316,316,56,56,0,1,0
21,333,333,29,29,0,1,0
16,368,368,3,3,0,1,0
1,386,386,79,16,63,4,3
6,406,406,82,27,55,4,3
14,416,416,59,35,24,4,3
19,418,418,13,13,0,1,0
3,428,428,66,16,50,2,1
11,467,467,4,4,0,1,0
22,473,473,29,29,0,1,0
4,479,479,84,38,46,3,2
5,486,486,3,3,0,1,0

7,103,103,3,3,0,1,0
10,116,116,17,17,0,1,0
16,138,138,18,11,7,2,1
11,141,141,20,4,16,3,2
5,148,148,36,36,0,1,0
4,156,156,5,5,0,1,0
22,201,201,19,19,0,1,0
26,211,211,24,24,0,1,0
13,213,213,18,18,0,1,0
23,231,231,25,25,0,1,0
6,233,233,23,2,21,4,3
0,246,246,2,2,0,1,0
24,259,259,52,19,33,2,1
17,259,259,49,13,36,4,3
20,278,278,52,52,0,1,0
15,292,292,17,17,0,1,0
12,299,299,4,4,0,1,0
18,329,329,7,7,0,1,0
21,332,332,16,16,0,1,0
8,332,332,45,12,33,4,3
14,336,336,9,9,0,1,0
1,338,338,12,12,0,1,0
2,350,350,9,3,6,2,1
19,377,377,18,18,0,1,0
3,439,439,26,14,12,3,2
25,479,479,10,3,7,2,1
9,481,481,58,58,0,1,0

11,117,117,3,3,0,1,0
24,136,136,38,38,0,1,0
16,136,136,12,12,0,1,0
13,153,153,17,4,13,2,1
17,155,155,18,5,13,2,1
15,165,165,21,21,0,1,0
19,167,167,23,2,21,4,3
25,183,183,14,2,12,3,2
22,185,185,17,17,0,1,0
27,190,190,16,16,0,1,0
0,329,329,40,40,0,1,0
9,329,329,2,2,0,1,0
23,341,341,2,2,0,1,0
20,343,343,33,33,0,1,0
1,400,400,49,3,46,4,3
8,404,404,15,7,8,3,2
7,407,407,12,5,7,2,1
26,416,416,40,40,0,1,0
21,432,432,8,8,0,1,0
14,450,450,16,1,15,2,1
18,450,450,61,22,39,4,3
6,454,454,112,98,14,2,1
12,463,463,28,28,0,1,0
3,469,469,25,1,24,4,3
5,472,472,34,34,0,1,0
4,476,476,23,8,15,4,3
2,492,492,31,31,0,1,0
10,497,497,21,21,0,1,0

4,109,109,1,1,0,1,0
18,111,111,8,1,7,3,2
5,116,116,1,1,0,1,0
6,135,135,18,3,15,4,3
11,136,136,23,11,12,2,1
16,144,144,31,7,24,3,2
3,165,165,44,36,8,3,2
9,174,174,21,13,8,2,1
2,189,189,9,5,4,2,1
17,191,191,8,8,0,1,0
7,205,205,1,1,0,1,0
8,254,254,10,1,9,4,3
20,284,284,73,24,49,2,1
25,309,309,10,10,0,1,0
19,318,318,1,1,0,1,0
13,335,335,22,13,9,2,1
23,354,354,53,53,0,1,0
1,382,382,48,48,0,1,0
21,386,386,23,1,22,3,2
15,410,410,48,48,0,1,0
22,441,441,63,12,51,4,3
0,453,453,62,38,24,4,3
12,454,454,2,2,0,1,0
14,463,463,54,4,50,4,3
24,465,465,4,4,0,1,0
10,485,485,33,17,16,2,1

3,107,107,2,2,0,1,0
18,117,117,50,50,0,1,0
22,155,155,8,8,0,1,0
16,167,167,66,24,42,3,2
21,175,175,7,1,6,3,2
12,183,183,20,20,0,1,0
1,192,192,7,7,0,1,0
25,215,215,2,2,0,1,0
0,227,227,38,18,20,3,2
20,228,228,8,8,0,1,0
5,248,248,8,8,0,1,0
15,278,278,17,17,0,1,0
2,286,286,44,13,31,2,1
8,289,289,36,20,16,3,2
10,311,311,5,5,0,1,0
6,317,317,9,2,7,2,1
11,327,327,55,17,38,2,1
17,331,331,5,5,0,1,0
24,357,357,37,37,0,1,0
19,381,381,3,3,0,1,0
13,386,386,7,7,0,1,0
23,388,388,15,7,8,2,1
9,405,405,10,10,0,1,0
14,457,457,17,5,12,4,3
4,475,475,55,6,49,2,1
7,498,498,93,18,75,4,3

18,112,112,3,3,0,1,0
20,134,134,8,8,0,1,0
25,136,136,8,8,0,1,0
7,147,147,5,5,0,1,0
8,171,171,12,12,0,1,0
21,184,184,45,18,27,2,1
10,189,189,5,1,4,2,1
15,261,261,9,2,7,2,1
24,278,278,53,1,52,3,2
14,284,284,22,10,12,4,3
16,294,294,66,66,0,1,0
23,353,353,32,7,25,2,1
6,361,361,20,10,10,4,3
13,365,365,28,1,27,4,3
22,370,370,30,19,11,2,1
0,374,374,1,1,0,1,0
5,377,377,100,56,44,2,1
9,379,379,1,1,0,1,0
1,380,380,1,1,0,1,0
2,420,420,34,34,0,1,0
17,426,426,32,32,0,1,0
3,454,454,33,33,0,1,0
19,457,457,29,29,0,1,0
4,467,467,17,17,0,1,0
11,470,470,51,51,0,1,0
12,472,472,173,164,9,4,3

10,136,136,7,1,6,2,1
12,138,138,5,5,0,1,0
18,163,163,14,14,0,1,0
21,177,177,21,7,14,2,1
0,189,189,32,32,0,1,0
20,198,198,21,10,11,2,1
13,205,205,16,16,0,1,0
9,211,211,1,1,0,1,0
22,215,215,16,16,0,1,0
14,264,264,6,6,0,1,0
7,278,278,11,5,6,3,2
2,287,287,16,1,15,3,2
15,296,296,6,6,0,1,0
1,304,304,45,9,36,4,3
11,327,327,5,5,0,1,0
5,391,391,69,69,0,1,0
3,397,397,60,60,0,1,0
23,400,400,111,111,0,1,0
19,436,436,94,19,75,4,3
24,443,443,44,16,28,4,3
8,467,467,23,23,0,1,0
4,478,478,20,3,17,2,1
17,482,482,43,11,32,2,1
16,494,494,16,13,3,2,1
6,497,497,130,94,36,4,3

5,105,105,8,8,0,1,0
11,119,119,8,3,5,2,1
3,135,135,9,9,0,1,0
14,141,141,74,74,0,1,0
12,154,154,12,12,0,1,0
21,168,168,32,32,0,1,0
1,176,176,8,3,5,2,1
22,199,199,3,3,0,1,0
6,209,209,39,39,0,1,0
7,210,210,3,3,0,1,0
9,241,241,1,1,0,1,0
17,243,243,3,3,0,1,0
18,259,259,3,3,0,1,0
24,283,283,28,28,0,1,0
10,304,304,59,17,42,4,3
20,332,332,52,8,44,4,3
13,365,365,10,10,0,1,0
25,372,372,1,1,0,1,0
0,387,387,91,91,0,1,0
2,406,406,25,25,0,1,0
15,410,410,11,6,5,2,1
4,418,418,41,41,0,1,0
16,421,421,75,75,0,1,0
23,472,472,2,2,0,1,0
8,480,480,22,8,14,3,2
19,485,485,3,3,0,1,0

10,109,109,20,20,0,1,0
22,111,111,15,15,0,1,0
15,118,118,8,8,0,1,0
7,162,162,12,12,0,1,0
8,170,170,6,6,0,1,0
20,193,193,20,20,0,1,0
9,209,209,31,23,8,2,1
19,234,234,40,12,28,4,3
2,272,272,53,17,36,2,1
4,286,286,1,1,0,1,0
0,320,320,75,7,68,3,2
16,320,320,20,6,14,2,1
14,324,324,22,22,0,1,0
13,358,358,8,8,0,1,0
6,383,383,73,73,0,1,0
18,390,390,63,63,0,1,0
1,416,416,3,3,0,1,0
17,424,424,33,33,0,1,0
12,464,464,2,2,0,1,0
5,485,485,46,46,0,1,0
21,488,488,50,50,0,1,0
3,499,499,20,16,4,2,1
11,499,499,122,58,64,4,3

9,100,100,2,2,0,1,0
20,104,104,7,2,5,2,1
5,172,172,1,1,0,1,0
14,189,189,11,11,0,1,0
17,200,200,11,5,6,2,1
25,218,218,23,23,0,1,0
0,234,234,19,19,0,1,0
22,262,262,15,1,14,2,1
1,294,294,66,66,0,1,0
8,298,298,19,4,15,2,1
15,301,301,2,2,0,1,0
10,325,325,15,10,5,2,1
23,327,327,4,4,0,1,0
16,359,359,26,26,0,1,0
2,363,363,58,40,18,4,3
18,371,371,47,47,0,1,0
26,384,384,26,26,0,1,0
19,384,384,92,4,88,4,3
24,386,386,63,6,57,4,3
12,416,416,33,33,0,1,0
11,426,426,32,32,0,1,0
13,433,433,11,8,3,2,1
27,435,435,60,22,38,3,2
21,457,457,51,35,16,2,1
6,459,459,47,47,0,1,0
4,480,480,97,4,93,4,3
7,492,492,11,11,0,1,0
3,492,492,15,15,0,1,0

0,117,117,10,10,0,1,0
14,157,157,2,2,0,1,0
1,224,224,42,42,0,1,0
6,226,226,49,4,45,2,1
3,236,236,7,1,6,3,2
18,255,255,20,2,18,4,3
21,291,291,2,2,0,1,0
13,292,292,22,22,0,1,0
4,313,313,22,22,0,1,0
11,321,321,1,1,0,1,0
16,323,323,77,71,6,2,1
15,327,327,33,33,0,1,0
2,327,327,15,3,12,4,3
5,329,329,109,109,0,1,0
8,355,355,14,14,0,1,0
7,381,381,1,1,0,1,0
9,382,382,49,49,0,1,0
10,383,383,10,10,0,1,0
22,405,405,29,4,25,2,1
20,406,406,133,97,36,4,3
19,425,425,59,27,32,4,3
23,428,428,16,6,10,2,1
12,431,431,15,15,0,1,0
17,464,464,6,2,4,2,1
24,464,464,55,41,14,3,2

22,131,131,12,6,6,3,2
1,132,132,5,1,4,2,1
3,160,160,27,12,15,4,3
12,164,164,1,1,0,1,0
19,167,167,2,2,0,1,0
11,184,184,12,2,10,2,1
2,185,185,29,9,20,4,3
17,212,212,16,4,12,2,1
23,219,219,5,5,0,1,0
13,247,247,13,13,0,1,0
21,267,267,25,19,6,3,2
26,286,286,58,58,0,1,0
27,290,290,55,55,0,1,0
28,291,291,34,34,0,1,0
18,292,292,79,79,0,1,0
6,301,301,20,10,10,2,1
25,322,322,31,31,0,1,0
20,361,361,11,1,10,3,2
16,364,364,40,40,0,1,0
4,377,377,60,18,42,4,3
5,416,416,10,10,0,1,0
0,438,438,29,17,12,2,1
7,452,452,16,13,3,2,1
9,478,478,59,19,40,2,1
15,481,481,1,1,0,1,0
10,487,487,34,15,19,2,1
24,491,491,13,13,0,1,0
14,496,496,21,6,15,4,3
8,500,500,7,7,0,1,0

23,104,104,20,20,0,1,0
2,182,182,31,31,0,1,0
19,189,189,2,2,0,1,0
20,202,202,19,7,12,4,3
8,204,204,6,6,0,1,0
0,241,241,7,7,0,1,0
1,250,250,13,3,10,3,2
3,256,256,7,7,0,1,0
17,261,261,22,22,0,1,0
22,279,279,13,2,11,2,1
10,294,294,1,1,0,1,0
6,302,302,72,38,34,2,1
16,324,324,21,5,16,3,2
21,326,326,31,31,0,1,0
9,328,328,4,4,0,1,0
18,328,328,49,37,12,4,3
13,373,373,30,16,14,2,1
12,408,408,109,109,0,1,0
15,408,408,25,10,15,2,1
4,423,423,1,1,0,1,0
24,440,440,114,57,57,4,3
14,446,446,36,36,0,1,0
11,450,450,54,54,0,1,0
7,465,465,65,35,30,4,3
5,481,481,53,53,0,1,0

8,115,115,3,3,0,1,0
9,129,129,23,2,21,4,3
4,160,160,17,17,0,1,0
3,164,164,10,10,0,1,0
16,180,180,12,1,11,2,1
18,182,182,8,8,0,1,0
14,182,182,12,12,0,1,0
20,192,192,24,3,21,4,3
0,215,215,26,26,0,1,0
11,215,215,16,7,9,4,3
21,258,258,26,26,0,1,0
2,262,262,16,8,8,2,1
12,266,266,96,47,49,3,2
1,277,277,67,23,44,3,2
15,298,298,54,30,24,2,1
23,310,310,6,6,0,1,0
19,315,315,8,8,0,1,0
5,345,345,5,5,0,1,0
22,352,352,29,10,19,2,1
13,390,390,7,1,6,3,2
17,422,422,54,54,0,1,0
7,444,444,55,55,0,1,0
10,447,447,57,24,33,2,1
6,475,475,31,31,0,1,0

4,106,106,1,1,0,1,0
15,119,119,27,1,26,4,3
27,119,119,11,7,4,2,1
16,136,136,8,8,0,1,0
31,169,169,32,17,15,4,3
12,184,184,22,22,0,1,0
28,185,185,22,7,15,4,3
11,212,212,8,8,0,1,0
30,213,213,23,23,0,1,0
10,218,218,1,1,0,1,0
0,221,221,24,12,12,3,2
7,232,232,6,6,0,1,0
25,249,249,2,2,0,1,0
17,268,268,24,24,0,1,0
2,281,281,6,6,0,1,0
20,283,283,8,8,0,1,0
9,292,292,1,1,0,1,0
24,298,298,6,6,0,1,0
18,306,306,23,23,0,1,0
29,308,308,37,13,24,3,2
5,316,316,22,22,0,1,0
26,316,316,35,35,0,1,0
6,362,362,17,17,0,1,0
19,371,371,41,41,0,1,0
14,384,384,19,6,13,2,1
1,397,397,18,18,0,1,0
8,398,398,15,5,10,3,2
22,399,399,36,36,0,1,0
21,417,417,138,135,3,2,1
3,430,430,15,15,0,1,0
13,435,435,11,1,10,2,1
23,468,468,7,7,0,1,0

14,117,117,11,1,10,4,3
8,119,119,4,4,0,1,0
0,121,121,16,16,0,1,0
21,130,130,21,3,18,2,1
18,147,147,14,1,13,2,1
5,194,194,1,1,0,1,0
1,223,223,11,2,9,2,1
19,240,240,15,11,4,2,1
7,279,279,41,1,40,3,2
11,291,291,29,19,10,3,2
3,351,351,38,38,0,1,0
17,364,364,26,14,12,4,3
10,369,369,10,10,0,1,0
6,380,380,35,1,34,2,1
13,381,381,27,15,12,3,2
9,383,383,9,6,3,2,1
22,404,404,28,10,18,4,3
23,422,422,68,24,44,3,2
20,426,426,27,24,3,2,1
15,433,433,7,7,0,1,0
4,450,450,64,64,0,1,0
2,463,463,158,158,0,1,0
12,464,464,70,4,66,3,2
16,478,478,101,16,85,4,3

4,128,128,11,11,0,1,0
14,146,146,31,2,29,2,1
0,159,159,36,14,22,2,1
19,160,160,17,7,10,3,2
9,173,173,9,9,0,1,0
3,177,177,8,8,0,1,0
15,264,264,1,1,0,1,0
7,298,298,21,3,18,2,1
1,336,336,40,27,13,2,1
11,363,363,26,26,0,1,0
5,402,402,18,18,0,1,0
8,412,412,52,6,46,3,2
10,438,438,6,1,5,2,1
2,439,439,181,119,62,3,2
12,444,444,72,72,0,1,0
16,452,452,90,90,0,1,0
13,456,456,42,30,12,3,2
18,457,457,21,12,9,4,3
17,482,482,63,63,0,1,0
6,497,497,99,78,21,4,3

16,112,112,17,11,6,2,1
17,112,112,18,18,0,1,0
18,178,178,12,12,0,1,0
9,215,215,5,5,0,1,0
4,219,219,30,6,24,4,3
15,232,232,19,19,0,1,0
11,258,258,27,27,0,1,0
10,259,259,12,4,8,3,2
0,308,308,35,13,22,2,1
3,318,318,13,7,6,3,2
14,319,319,25,12,13,2,1
7,322,322,1,1,0,1,0
1,322,322,52,52,0,1,0
8,363,363,113,64,49,2,1
13,408,408,80,69,11,2,1
12,424,424,1,1,0,1,0
2,451,451,164,146,18,4,3
5,464,464,53,53,0,1,0
6,488,488,132,24,108,4,3

24,120,120,24,2,22,2,1
14,142,142,1,1,0,1,0
17,143,143,6,3,3,2,1
23,145,145,2,2,0,1,0
20,147,147,11,4,7,2,1
26,152,152,14,8,6,2,1
2,178,178,29,26,3,2,1
5,195,195,15,9,6,3,2
4,234,234,44,44,0,1,0
7,250,250,8,8,0,1,0
15,275,275,39,10,29,2,1
19,299,299,53,5,48,2,1
3,300,300,51,30,21,4,3
22,343,343,34,6,28,3,2
16,344,344,25,25,0,1,0
10,368,368,15,1,14,3,2
0,386,386,9,4,5,2,1
11,388,388,7,1,6,2,1
13,411,411,7,1,6,3,2
25,423,423,14,14,0,1,0
9,434,434,37,1,36,4,3
6,445,445,35,15,20,2,1
1,457,457,9,2,7,2,1
12,469,469,104,63,41,2,1
21,490,490,21,21,0,1,0
18,496,496,118,62,56,3,2
8,500,500,31,31,0,1,0

17,102,102,20,13,7,2,1
6,123,123,17,17,0,1,0
18,124,124,30,30,0,1,0
8,202,202,69,23,46,4,3
5,219,219,26,13,13,2,1
2,256,256,27,27,0,1,0
13,259,259,1,1,0,1,0
12,262,262,7,2,5,2,1
4,264,264,17,17,0,1,0
3,282,282,9,9,0,1,0
19,289,289,135,29,106,4,3
10,290,290,7,2,5,2,1
14,324,324,2,2,0,1,0
7,350,350,32,18,14,3,2
20,366,366,5,5,0,1,0
15,368,368,9,9,0,1,0
9,383,383,9,9,0,1,0
16,386,386,27,2,25,2,1
1,426,426,7,1,6,3,2
11,428,428,51,51,0,1,0
0,492,492,146,137,9,2,1

10,125,125,5,5,0,1,0
23,128,128,14,6,8,2,1
3,144,144,4,4,0,1,0
21,151,151,15,9,6,3,2
17,153,153,19,19,0,1,0
24,169,169,13,13,0,1,0
2,189,189,1,1,0,1,0
19,189,189,12,4,8,3,2
20,263,263,6,6,0,1,0
22,290,290,31,31,0,1,0
12,310,310,14,14,0,1,0
9,336,336,119,59,60,4,3
11,357,357,38,38,0,1,0
7,366,366,32,4,28,2,1
6,372,372,10,5,5,2,1
16,386,386,35,9,26,3,2
8,391,391,30,5,25,2,1
15,391,391,44,30,14,2,1
25,394,394,85,48,37,2,1
1,419,419,53,11,42,3,2
0,423,423,6,6,0,1,0
14,424,424,55,50,5,2,1
13,451,451,96,96,0,1,0
4,452,452,6,6,0,1,0
5,460,460,30,30,0,1,0
18,473,473,37,37,0,1,0

3,109,109,5,1,4,2,1
6,119,119,33,14,19,2,1
0,155,155,41,41,0,1,0
19,166,166,49,17,32,4,3
14,178,178,17,17,0,1,0
9,188,188,10,10,0,1,0
20,244,244,29,29,0,1,0
2,282,282,73,73,0,1,0
12,303,303,7,7,0,1,0
1,312,312,12,12,0,1,0
13,315,315,38,9,29,2,1
5,322,322,39,39,0,1,0
4,369,369,9,9,0,1,0
10,383,383,52,18,34,4,3
8,410,410,36,36,0,1,0
18,410,410,67,20,47,4,3
7,430,430,36,2,34,2,1
17,434,434,48,48,0,1,0
15,456,456,8,8,0,1,0
16,466,466,7,7,0,1,0
11,489,489,35,35,0,1,0

21,109,109,1,1,0,1,0
13,117,117,24,24,0,1,0
8,118,118,3,3,0,1,0
3,121,121,9,9,0,1,0
4,155,155,3,3,0,1,0
16,162,162,21,21,0,1,0
7,166,166,5,5,0,1,0
14,205,205,8,8,0,1,0
15,215,215,29,29,0,1,0
9,233,233,22,1,21,2,1
10,273,273,20,9,11,3,2
24,280,280,12,12,0,1,0
22,284,284,53,18,35,3,2
19,292,292,31,13,18,4,3
2,296,296,124,99,25,2,1
12,328,328,29,2,27,2,1
18,339,339,42,42,0,1,0
20,358,358,59,27,32,3,2
6,362,362,5,5,0,1,0
17,391,391,6,6,0,1,0
0,392,392,19,19,0,1,0
1,395,395,28,16,12,4,3
5,419,419,72,72,0,1,0
11,436,436,31,31,0,1,0
23,436,436,31,9,22,3,2

8,113,113,20,2,18,3,2
15,141,141,1,1,0,1,0
2,156,156,1,1,0,1,0
20,186,186,5,1,4,2,1
12,189,189,24,24,0,1,0
10,197,197,14,11,3,2,1
5,207,207,13,13,0,1,0
17,208,208,98,29,69,4,3
6,230,230,3,3,0,1,0
23,239,239,18,6,12,4,3
22,267,267,4,4,0,1,0
19,271,271,8,8,0,1,0
3,275,275,17,17,0,1,0
18,278,278,23,23,0,1,0
1,299,299,71,71,0,1,0
13,327,327,44,23,21,4,3
21,332,332,48,48,0,1,0
11,357,357,18,18,0,1,0
9,378,378,64,19,45,4,3
16,416,416,49,49,0,1,0
4,444,444,70,70,0,1,0
7,458,458,31,7,24,3,2
14,470,470,44,44,0,1,0
0,472,472,1,1,0,1,0
24,491,491,14,11,3,2,1

1,121,121,1,1,0,1,0
23,122,122,9,9,0,1,0
13,125,125,1,1,0,1,0
20,129,129,25,12,13,2,1
16,179,179,20,16,4,2,1
4,189,189,4,4,0,1,0
22,220,220,60,56,4,2,1
3,234,234,5,1,4,2,1
14,241,241,68,32,36,3,2
7,242,242,2,2,0,1,0
15,326,326,1,1,0,1,0
17,329,329,88,20,68,4,3
10,344,344,8,8,0,1,0
5,379,379,45,36,9,4,3
9,383,383,95,95,0,1,0
26,385,385,5,5,0,1,0
11,386,386,94,94,0,1,0
18,387,387,28,28,0,1,0
19,390,390,10,5,5,2,1
2,395,395,53,53,0,1,0
21,396,396,26,1,25,2,1
6,407,407,4,4,0,1,0
25,409,409,25,9,16,2,1
12,425,425,5,5,0,1,0
0,427,427,21,3,18,2,1
24,431,431,29,29,0,1,0
8,466,466,7,7,0,1,0

15,111,111,2,2,0,1,0
17,111,111,2,2,0,1,0
9,146,146,5,5,0,1,0
4,170,170,22,22,0,1,0
8,207,207,46,46,0,1,0
11,212,212,7,7,0,1,0
20,218,218,25,25,0,1,0
18,237,237,60,24,36,2,1
22,243,243,38,30,8,2,1
5,309,309,109,42,67,4,3
7,323,323,15,15,0,1,0
3,329,329,3,3,0,1,0
13,335,335,6,1,5,2,1
10,348,348,11,11,0,1,0
1,351,351,26,26,0,1,0
6,359,359,31,31,0,1,0
2,380,380,38,26,12,4,3
12,399,399,8,8,0,1,0
14,425,425,72,57,15,4,3
21,452,452,16,16,0,1,0
16,470,470,146,126,20,2,1
0,489,489,57,9,48,2,1
19,496,496,38,38,0,1,0

22,138,138,24,4,20,3,2
21,145,145,8,2,6,3,2
15,221,221,1,1,0,1,0
0,238,238,1,1,0,1,0
7,260,260,9,9,0,1,0
24,265,265,2,2,0,1,0
8,266,266,12,3,9,4,3
6,282,282,113,113,0,1,0
18,291,291,4,4,0,1,0
11,293,293,38,38,0,1,0
14,313,313,59,59,0,1,0
16,316,316,48,48,0,1,0
10,339,339,5,5,0,1,0
1,359,359,18,8,10,3,2
19,378,378,45,45,0,1,0
13,382,382,95,17,78,4,3
23,409,409,38,18,20,2,1
2,446,446,31,31,0,1,0
20,449,449,62,13,49,4,3
5,449,449,10,1,9,3,2
4,449,449,12,12,0,1,0
12,450,450,115,115,0,1,0
17,471,471,15,10,5,2,1
3,473,473,47,19,28,2,1
9,487,487,24,24,0,1,0

6,100,100,1,1,0,1,0
32,115,115,10,10,0,1,0
16,133,133,16,4,12,2,1
28,143,143,6,6,0,1,0
26,149,149,8,8,0,1,0
14,162,162,15,3,12,4,3
23,187,187,2,2,0,1,0
27,209,209,20,20,0,1,0
7,215,215,11,3,8,3,2
20,241,241,31,10,21,2,1
5,262,262,16,16,0,1,0
19,281,281,3,3,0,1,0
9,282,282,9,9,0,1,0
11,292,292,1,1,0,1,0
25,295,295,19,19,0,1,0
31,305,305,4,4,0,1,0
8,309,309,28,21,7,2,1
4,311,311,4,1,3,2,1
2,312,312,12,12,0,1,0
0,314,314,13,13,0,1,0
18,316,316,20,14,6,3,2
21,324,324,12,9,3,2,1
10,352,352,9,9,0,1,0
3,402,402,1,1,0,1,0
29,404,404,53,18,35,3,2
22,406,406,8,1,7,2,1
30,422,422,5,5,0,1,0
33,427,427,290,247,43,3,2
1,433,433,1,1,0,1,0
12,459,459,79,79,0,1,0
17,464,464,46,1,45,4,3
13,466,466,18,18,0,1,0
24,481,481,7,7,0,1,0
15,491,491,33,33,0,1,0

20,101,101,9,9,0,1,0
15,105,105,3,3,0,1,0
7,105,105,19,19,0,1,0
13,140,140,7,7,0,1,0
0,141,141,5,5,0,1,0
10,143,143,65,44,21,4,3
9,154,154,17,9,8,3,2
6,160,160,10,2,8,2,1
11,172,172,10,10,0,1,0
12,194,194,8,8,0,1,0
14,210,210,56,32,24,4,3
1,217,217,1,1,0,1,0
21,220,220,14,4,10,3,2
18,227,227,3,3,0,1,0
2,241,241,32,5,27,2,1
4,264,264,52,19,33,4,3
19,336,336,16,7,9,4,3
5,360,360,6,6,0,1,0
16,396,396,29,23,6,3,2
8,412,412,36,36,0,1,0
3,433,433,162,114,48,2,1
17,440,440,23,23,0,1,0

22,116,116,1,1,0,1,0
10,121,121,8,3,5,2,1
26,128,128,33,5,28,3,2
8,139,139,10,10,0,1,0
16,161,161,2,2,0,1,0
27,205,205,16,10,6,2,1
13,206,206,5,5,0,1,0
6,208,208,9,9,0,1,0
19,214,214,12,4,8,2,1
20,233,233,12,12,0,1,0
28,242,242,25,25,0,1,0
12,245,245,5,5,0,1,0
25,280,280,4,1,3,2,1
5,281,281,22,14,8,3,2
1,286,286,8,1,7,2,1
4,311,311,38,21,17,3,2
0,314,314,25,25,0,1,0
24,316,316,16,16,0,1,0
23,329,329,15,15,0,1,0
7,349,349,42,42,0,1,0
21,356,356,40,40,0,1,0
30,376,376,22,7,15,4,3
17,388,388,28,13,15,4,3
29,398,398,150,114,36,4,3
14,412,412,25,25,0,1,0
2,422,422,16,16,0,1,0
3,431,431,11,11,0,1,0
15,436,436,76,72,4,2,1
18,438,438,1,1,0,1,0
9,448,448,30,14,16,3,2
11,453,453,18,10,8,2,1
31,468,468,27,27,0,1,0

4,105,105,3,3,0,1,0
19,151,151,41,41,0,1,0
6,228,228,31,31,0,1,0
0,232,232,18,18,0,1,0
12,235,235,2,2,0,1,0
22,251,251,23,23,0,1,0
1,260,260,94,54,40,4,3
21,273,273,15,6,9,4,3
20,288,288,33,23,10,2,1
15,313,313,77,77,0,1,0
16,313,313,9,9,0,1,0
18,319,319,14,14,0,1,0
5,322,322,8,8,0,1,0
13,326,326,41,33,8,2,1
11,349,349,42,42,0,1,0
3,354,354,85,39,46,3,2
17,369,369,25,25,0,1,0
14,374,374,18,18,0,1,0
8,399,399,12,12,0,1,0
2,407,407,16,16,0,1,0
7,453,453,44,34,10,2,1
10,461,461,23,5,18,2,1
9,481,481,56,24,32,3,2

5,106,106,9,9,0,1,0
25,114,114,8,8,0,1,0
24,120,120,11,11,0,1,0
17,121,121,2,2,0,1,0
4,161,161,8,2,6,3,2
13,185,185,9,9,0,1,0
0,207,207,1,1,0,1,0
9,224,224,12,6,6,3,2
7,237,237,32,14,18,4,3
18,248,248,72,65,7,2,1
22,253,253,46,46,0,1,0
2,263,263,27,20,7,2,1
19,286,286,25,1,24,3,2
10,290,290,57,9,48,3,2
3,295,295,6,6,0,1,0
1,298,298,39,39,0,1,0
26,301,301,69,15,54,4,3
27,347,347,32,32,0,1,0
16,347,347,7,1,6,3,2
6,348,348,6,6,0,1,0
14,378,378,73,3,70,3,2
15,383,383,39,11,28,3,2
21,407,407,8,8,0,1,0
12,415,415,14,14,0,1,0
11,425,425,9,9,0,1,0
23,448,448,10,10,0,1,0
8,453,453,3,3,0,1,0
20,472,472,49,49,0,1,0

1,132,132,10,5,5,2,1
16,137,137,2,2,0,1,0
5,153,153,40,40,0,1,0
11,156,156,4,4,0,1,0
22,160,160,22,22,0,1,0
6,161,161,34,13,21,4,3
23,182,182,17,7,10,2,1
4,195,195,7,7,0,1,0
2,225,225,17,7,10,3,2
24,238,238,19,19,0,1,0
7,241,241,25,5,20,3,2
8,250,250,3,3,0,1,0
13,285,285,78,78,0,1,0
18,298,298,61,61,0,1,0
15,312,312,39,39,0,1,0
10,319,319,43,1,42,2,1
12,336,336,26,26,0,1,0
20,339,339,13,13,0,1,0
17,342,342,25,25,0,1,0
0,362,362,12,12,0,1,0
19,388,388,15,8,7,2,1
9,403,403,3,3,0,1,0
21,475,475,35,15,20,3,2
3,497,497,74,8,66,4,3
14,497,497,37,37,0,1,0

9,130,130,10,10,0,1,0
20,132,132,5,5,0,1,0
14,139,139,27,27,0,1,0
3,163,163,35,17,18,4,3
23,168,168,12,1,11,2,1
17,182,182,1,1,0,1,0
6,192,192,1,1,0,1,0
5,251,251,40,40,0,1,0
19,251,251,11,1,10,3,2
1,261,261,8,5,3,2,1
22,263,263,7,7,0,1,0
15,266,266,1,1,0,1,0
12,282,282,14,1,13,2,1
4,308,308,5,5,0,1,0
18,331,331,80,76,4,2,1
10,341,341,91,11,80,3,2
13,383,383,24,3,21,4,3
7,407,407,25,16,9,4,3
8,444,444,23,23,0,1,0
16,462,462,156,141,15,4,3
2,480,480,11,2,9,4,3
0,498,498,70,70,0,1,0
21,498,498,75,75,0,1,0
11,499,499,77,43,34,2,1

6,107,107,4,1,3,2,1
7,112,112,13,1,12,4,3
19,136,136,5,5,0,1,0
2,169,169,17,17,0,1,0
5,200,200,39,15,24,2,1
21,217,217,6,1,5,2,1
14,226,226,19,9,10,3,2
8,234,234,47,41,6,2,1
9,240,240,21,21,0,1,0
22,246,246,50,50,0,1,0
0,248,248,17,17,0,1,0
13,269,269,18,6,12,3,2
11,294,294,10,10,0,1,0
18,302,302,67,51,16,3,2
4,314,314,48,21,27,4,3
23,317,317,16,2,14,3,2
16,326,326,44,18,26,3,2
17,337,337,40,40,0,1,0
15,359,359,42,42,0,1,0
3,376,376,17,12,5,2,1
20,406,406,9,1,8,2,1
10,420,420,24,8,16,3,2
12,422,422,56,14,42,2,1
1,471,471,50,26,24,4,3

4,112,112,6,2,4,2,1
3,119,119,8,8,0,1,0
5,176,176,16,16,0,1,0
14,204,204,79,40,39,4,3
2,207,207,174,84,90,4,3
0,212,212,12,12,0,1,0
8,258,258,11,7,4,2,1
10,265,265,6,6,0,1,0
9,278,278,3,3,0,1,0
1,298,298,28,22,6,3,2
17,339,339,3,3,0,1,0
6,378,378,30,30,0,1,0
16,397,397,18,9,9,4,3
12,402,402,66,26,40,2,1
7,425,425,110,66,44,4,3
15,427,427,2,2,0,1,0
13,456,456,31,31,0,1,0
11,477,477,60,60,0,1,0

11,111,111,15,10,5,2,1
23,131,131,6,2,4,2,1
14,143,143,1,1,0,1,0
2,148,148,15,9,6,3,2
20,154,154,20,20,0,1,0
8,162,162,20,20,0,1,0
9,192,192,1,1,0,1,0
18,206,206,58,58,0,1,0
15,207,207,52,52,0,1,0
5,235,235,16,16,0,1,0
7,243,243,21,21,0,1,0
12,252,252,2,2,0,1,0
6,268,268,18,6,12,4,3
4,270,270,33,33,0,1,0
10,273,273,73,73,0,1,0
3,297,297,27,10,17,2,1
22,297,297,31,31,0,1,0
16,302,302,14,14,0,1,0
21,316,316,20,16,4,2,1
13,348,348,38,38,0,1,0
0,375,375,28,18,10,3,2
1,379,379,22,5,17,2,1
17,381,381,52,52,0,1,0
19,460,460,23,8,15,4,3

9,101,101,9,9,0,1,0
15,130,130,16,1,15,2,1
3,185,185,75,39,36,4,3
11,201,201,43,3,40,2,1
6,213,213,5,5,0,1,0
8,224,224,16,4,12,3,2
4,309,309,36,36,0,1,0
5,311,311,14,14,0,1,0
10,345,345,104,24,80,3,2
16,375,375,22,22,0,1,0
0,398,398,87,42,45,2,1
14,399,399,2,2,0,1,0
7,455,455,22,22,0,1,0
12,463,463,2,2,0,1,0
1,486,486,92,14,78,4,3
13,495,495,116,24,92,3,2
2,498,498,135,89,46,2,1

6,183,183,5,5,0,1,0
17,197,197,3,3,0,1,0
7,220,220,66,66,0,1,0
18,220,220,7,3,4,2,1
3,228,228,15,5,10,2,1
0,258,258,7,1,6,3,2
10,265,265,9,3,6,3,2
16,276,276,11,11,0,1,0
5,305,305,6,6,0,1,0
11,314,314,98,38,60,4,3
14,315,315,19,16,3,2,1
9,317,317,49,49,0,1,0
1,352,352,31,31,0,1,0
13,354,354,2,2,0,1,0
19,358,358,32,32,0,1,0
15,366,366,84,17,67,4,3
12,392,392,55,55,0,1,0
8,411,411,44,4,40,3,2
4,466,466,268,227,41,4,3
2,484,484,47,47,0,1,0

32,101,101,9,9,0,1,0
13,121,121,1,1,0,1,0
30,126,126,20,13,7,2,1
23,128,128,14,14,0,1,0
1,140,140,1,1,0,1,0
7,147,147,3,3,0,1,0
18,165,165,1,1,0,1,0
6,171,171,4,4,0,1,0
28,173,173,20,17,3,2,1
29,184,184,17,17,0,1,0
5,208,208,2,2,0,1,0
16,215,215,6,6,0,1,0
19,247,247,27,5,22,2,1
4,269,269,20,20,0,1,0
12,270,270,15,15,0,1,0
10,276,276,31,31,0,1,0
3,278,278,3,3,0,1,0
20,292,292,1,1,0,1,0
33,298,298,8,8,0,1,0
0,314,314,28,28,0,1,0
24,340,340,35,13,22,2,1
8,348,348,31,22,9,4,3
11,357,357,13,5,8,2,1
26,361,361,21,15,6,3,2
31,368,368,23,14,9,2,1
14,380,380,19,5,14,4,3
25,408,408,82,61,21,3,2
17,439,439,11,1,10,3,2
9,443,443,20,20,0,1,0
2,448,448,3,3,0,1,0
21,459,459,84,63,21,4,3
27,478,478,86,35,51,4,3
15,482,482,100,56,44,3,2
22,483,483,17,17,0,1,0

20,100,100,5,5,0,1,0
16,115,115,1,1,0,1,0
15,124,124,3,3,0,1,0
18,162,162,10,10,0,1,0
3,165,165,2,2,0,1,0
22,176,176,5,5,0,1,0
11,178,178,5,5,0,1,0
12,206,206,39,32,7,2,1
9,218,218,50,47,3,2,1
4,226,226,18,18,0,1,0
5,240,240,35,7,28,2,1
19,280,280,23,1,22,2,1
0,286,286,16,1,15,2,1
17,291,291,44,44,0,1,0
8,316,316,8,8,0,1,0
21,360,360,10,10,0,1,0
13,369,369,92,92,0,1,0
14,372,372,121,64,57,4,3
2,400,400,88,88,0,1,0
6,426,426,41,41,0,1,0
1,437,437,89,68,21,2,1
10,441,441,44,44,0,1,0
7,483,483,16,11,5,2,1

16,122,122,6,6,0,1,0
22,153,153,1,1,0,1,0
13,156,156,58,28,30,4,3
14,172,172,10,10,0,1,0
7,193,193,5,5,0,1,0
2,199,199,27,24,3,2,1
12,215,215,10,10,0,1,0
21,216,216,12,12,0,1,0
4,228,228,70,52,18,4,3
3,237,237,7,7,0,1,0
8,248,248,77,15,62,3,2
23,272,272,5,5,0,1,0
19,274,274,23,14,9,2,1
9,287,287,9,9,0,1,0
1,318,318,51,2,49,2,1
24,320,320,18,18,0,1,0
6,320,320,23,6,17,2,1
10,336,336,5,5,0,1,0
11,369,369,6,6,0,1,0
15,401,401,72,72,0,1,0
0,401,401,21,5,16,3,2
18,404,404,78,78,0,1,0
20,432,432,13,13,0,1,0
5,456,456,1,1,0,1,0
17,464,464,57,37,20,2,1

17,106,106,30,8,22,3,2
16,108,108,4,4,0,1,0
8,117,117,9,3,6,2,1
7,122,122,7,7,0,1,0
3,138,138,1,1,0,1,0
20,154,154,6,2,4,2,1
6,162,162,10,10,0,1,0
5,166,166,7,1,6,3,2
12,217,217,1,1,0,1,0
4,257,257,7,7,0,1,0
2,259,259,124,108,16,3,2
11,259,259,63,63,0,1,0
1,386,386,1,1,0,1,0
9,416,416,56,56,0,1,0
10,420,420,6,6,0,1,0
18,427,427,50,33,17,2,1
14,433,433,21,21,0,1,0
19,447,447,18,18,0,1,0
13,453,453,54,45,9,4,3
0,459,459,206,80,126,4,3
15,486,486,70,19,51,4,3

2,110,110,10,4,6,2,1
0,119,119,8,8,0,1,0
18,157,157,21,13,8,2,1
6,159,159,43,43,0,1,0
14,186,186,16,16,0,1,0
17,192,192,1,1,0,1,0
10,205,205,4,1,3,2,1
22,230,230,11,11,0,1,0
7,232,232,33,18,15,4,3
4,240,240,8,3,5,2,1
8,246,246,20,4,16,4,3
12,250,250,17,3,14,3,2
3,271,271,33,33,0,1,0
5,291,291,1,1,0,1,0
1,302,302,36,36,0,1,0
9,347,347,37,19,18,4,3
16,366,366,105,19,86,4,3
13,433,433,28,5,23,2,1
15,435,435,13,3,10,3,2
23,435,435,42,11,31,2,1
11,441,441,64,64,0,1,0
19,461,461,96,30,66,4,3
21,477,477,81,40,41,2,1
20,497,497,11,11,0,1,0

15,101,101,4,4,0,1,0
20,107,107,16,4,12,3,2
27,132,132,4,4,0,1,0
18,155,155,19,2,17,3,2
11,158,158,5,5,0,1,0
1,161,161,5,5,0,1,0
13,166,166,12,2,10,3,2
19,168,168,4,4,0,1,0
23,174,174,14,5,9,2,1
22,254,254,116,116,0,1,0
0,258,258,13,4,9,2,1
9,272,272,2,2,0,1,0
8,284,284,69,31,38,3,2
17,289,289,13,13,0,1,0
3,293,293,4,4,0,1,0
2,314,314,61,7,54,4,3
24,315,315,19,7,12,3,2
25,318,318,6,6,0,1,0
5,321,321,7,2,5,2,1
28,321,321,7,2,5,2,1
26,354,354,4,4,0,1,0
4,361,361,59,59,0,1,0
14,376,376,36,12,24,3,2
7,381,381,7,1,6,2,1
21,393,393,91,91,0,1,0
12,430,430,1,1,0,1,0
29,470,470,14,14,0,1,0
16,474,474,10,7,3,2,1
10,485,485,12,12,0,1,0
6,489,489,61,9,52,3,2

10,128,128,15,15,0,1,0
11,141,141,38,38,0,1,0
12,214,214,1,1,0,1,0
14,219,219,1,1,0,1,0
3,278,278,64,20,44,2,1
13,290,290,17,17,0,1,0
6,315,315,16,1,15,2,1
4,323,323,10,1,9,2,1
7,352,352,123,84,39,4,3
2,364,364,215,181,34,3,2
1,421,421,79,61,18,4,3
5,426,426,60,60,0,1,0
15,426,426,6,6,0,1,0
0,427,427,83,38,45,2,1
8,490,490,23,23,0,1,0
9,491,491,63,63,0,1,0

9,100,100,10,1,9,2,1
13,104,104,2,2,0,1,0
14,117,117,12,7,5,2,1
8,158,158,17,17,0,1,0
7,163,163,4,4,0,1,0
15,163,163,2,2,0,1,0
12,173,173,78,57,21,4,3
0,213,213,28,6,22,3,2
3,264,264,23,15,8,3,2
4,266,266,7,3,4,2,1
23,281,281,29,10,19,2,1
19,312,312,20,20,0,1,0
5,316,316,64,40,24,4,3
11,350,350,59,14,45,3,2
18,355,355,45,15,30,3,2
2,358,358,64,64,0,1,0
21,444,444,70,70,0,1,0
10,450,450,11,11,0,1,0
20,451,451,1,1,0,1,0
1,456,456,35,35,0,1,0
6,468,468,34,14,20,3,2
22,468,468,13,1,12,4,3
16,472,472,32,10,22,3,2
17,498,498,50,50,0,1,0

16,107,107,1,1,0,1,0
9,113,113,26,26,0,1,0
13,186,186,23,8,15,2,1
2,188,188,74,74,0,1,0
1,188,188,4,4,0,1,0
4,200,200,14,14,0,1,0
10,227,227,8,8,0,1,0
19,242,242,24,10,14,3,2
8,244,244,45,9,36,4,3
17,259,259,14,8,6,2,1
3,293,293,75,75,0,1,0
11,332,332,20,20,0,1,0
7,334,334,37,37,0,1,0
12,340,340,40,21,19,2,1
14,350,350,15,15,0,1,0
6,357,357,8,3,5,2,1
5,369,369,9,9,0,1,0
15,385,385,2,2,0,1,0
18,388,388,102,74,28,2,1
0,477,477,144,104,40,3,2

0,102,102,12,1,11,2,1
5,113,113,14,14,0,1,0
10,128,128,27,5,22,4,3
19,152,152,32,32,0,1,0
11,188,188,6,6,0,1,0
15,219,219,6,6,0,1,0
14,223,223,13,2,11,2,1
1,226,226,29,8,21,2,1
7,241,241,3,3,0,1,0
2,242,242,23,8,15,2,1
13,243,243,28,16,12,4,3
6,253,253,29,29,0,1,0
4,259,259,39,39,0,1,0
8,261,261,37,37,0,1,0
18,272,272,42,13,29,2,1
21,307,307,30,30,0,1,0
12,375,375,2,2,0,1,0
16,377,377,41,41,0,1,0
9,403,403,122,122,0,1,0
3,433,433,6,6,0,1,0
20,449,449,54,26,28,3,2
17,457,457,35,4,31,2,1

12,112,112,24,24,0,1,0
22,125,125,9,9,0,1,0
11,139,139,8,3,5,2,1
1,145,145,3,3,0,1,0
9,212,212,13,13,0,1,0
17,254,254,19,8,11,2,1
2,264,264,28,17,11,2,1
7,268,268,17,11,6,3,2
13,280,280,17,17,0,1,0
19,284,284,75,23,52,3,2
24,286,286,8,8,0,1,0
6,303,303,16,16,0,1,0
23,328,328,23,23,0,1,0
0,340,340,15,3,12,3,2
20,341,341,24,24,0,1,0
14,351,351,26,2,24,4,3
21,351,351,56,56,0,1,0
4,379,379,34,27,7,2,1
15,394,394,37,30,7,2,1
5,450,450,20,12,8,2,1
10,451,451,59,19,40,3,2
16,452,452,53,29,24,4,3
3,470,470,23,2,21,4,3
18,472,472,64,46,18,4,3
8,494,494,133,133,0,1,0

2,141,141,17,17,0,1,0
4,161,161,19,12,7,2,1
16,169,169,1,1,0,1,0
12,174,174,21,21,0,1,0
15,201,201,28,9,19,2,1
7,217,217,91,91,0,1,0
10,256,256,41,41,0,1,0
17,275,275,25,25,0,1,0
9,289,289,24,24,0,1,0
6,291,291,9,9,0,1,0
5,329,329,147,142,5,2,1
0,343,343,113,79,34,2,1
3,347,347,56,32,24,2,1
1,348,348,9,2,7,2,1
13,398,398,7,7,0,1,0
11,406,406,11,11,0,1,0
8,439,439,41,33,8,2,1
14,455,455,17,5,12,3,2

6,103,103,14,14,0,1,0
2,156,156,20,10,10,2,1
3,160,160,9,9,0,1,0
5,165,165,11,11,0,1,0
0,171,171,45,5,40,2,1
22,172,172,16,10,6,2,1
18,228,228,36,36,0,1,0
4,266,266,24,24,0,1,0
20,268,268,46,46,0,1,0
1,273,273,19,1,18,4,3
17,282,282,52,52,0,1,0
12,292,292,13,2,11,2,1
21,296,296,1,1,0,1,0
14,307,307,2,2,0,1,0
19,318,318,3,3,0,1,0
15,354,354,34,12,22,3,2
13,357,357,30,3,27,2,1
11,367,367,105,100,5,2,1
10,416,416,73,17,56,4,3
8,430,430,15,9,6,3,2
16,467,467,40,3,37,2,1
7,472,472,24,6,18,3,2
9,473,473,62,62,0,1,0

1,145,145,37,25,12,2,1
16,158,158,27,8,19,2,1
14,162,162,36,36,0,1,0
2,187,187,8,2,6,3,2
5,236,236,16,10,6,2,1
22,248,248,26,26,0,1,0
20,254,254,19,19,0,1,0
12,267,267,26,2,24,2,1
21,274,274,5,5,0,1,0
4,276,276,6,6,0,1,0
13,279,279,9,3,6,3,2
7,281,281,13,13,0,1,0
19,296,296,12,5,7,2,1
8,298,298,1,1,0,1,0
9,316,316,7,4,3,2,1
15,357,357,37,37,0,1,0
6,386,386,12,1,11,2,1
11,391,391,44,44,0,1,0
10,418,418,142,89,53,4,3
18,456,456,12,12,0,1,0
17,462,462,100,81,19,2,1
3,490,490,168,88,80,4,3
0,495,495,14,14,0,1,0

21,100,100,18,18,0,1,0
11,104,104,7,7,0,1,0
10,105,105,1,1,0,1,0
16,121,121,16,16,0,1,0
24,125,125,14,14,0,1,0
25,143,143,1,1,0,1,0
22,203,203,83,22,61,4,3
3,237,237,15,7,8,3,2
6,277,277,1,1,0,1,0
4,283,283,36,6,30,2,1
26,295,295,37,37,0,1,0
0,299,299,20,2,18,3,2
19,318,318,5,5,0,1,0
14,319,319,11,11,0,1,0
8,336,336,13,4,9,4,3
5,351,351,111,19,92,3,2
12,381,381,26,26,0,1,0
13,407,407,63,63,0,1,0
20,432,432,35,26,9,2,1
7,433,433,53,53,0,1,0
2,438,438,27,12,15,2,1
17,444,444,9,3,6,3,2
9,452,452,5,5,0,1,0
15,453,453,35,35,0,1,0
23,459,459,6,1,5,2,1
18,477,477,31,31,0,1,0
1,484,484,27,17,10,2,1

20,100,100,10,1,9,2,1
24,102,102,4,4,0,1,0
10,138,138,43,35,8,3,2
14,139,139,3,3,0,1,0
7,143,143,3,3,0,1,0
9,145,145,1,1,0,1,0
4,175,175,15,15,0,1,0
16,199,199,9,4,5,2,1
23,202,202,7,7,0,1,0
2,216,216,8,8,0,1,0
5,230,230,25,1,24,4,3
26,238,238,26,16,10,3,2
0,268,268,15,15,0,1,0
19,287,287,34,21,13,2,1
18,290,290,34,11,23,4,3
15,343,343,85,11,74,4,3
21,380,380,29,29,0,1,0
13,385,385,65,65,0,1,0
25,396,396,26,11,15,4,3
3,409,409,10,10,0,1,0
12,413,413,15,15,0,1,0
8,436,436,92,67,25,2,1
11,439,439,24,12,12,3,2
17,450,450,99,33,66,4,3
6,468,468,7,4,3,2,1
22,474,474,24,2,22,3,2
1,481,481,20,20,0,1,0

20,102,102,10,7,3,2,1
15,107,107,3,3,0,1,0
23,110,110,1,1,0,1,0
8,123,123,25,14,11,2,1
13,153,153,16,6,10,2,1
10,159,159,1,1,0,1,0
4,172,172,1,1,0,1,0
7,175,175,4,4,0,1,0
9,217,217,2,2,0,1,0
2,218,218,21,21,0,1,0
22,220,220,39,2,37,2,1
5,233,233,7,7,0,1,0
16,236,236,12,2,10,2,1
1,292,292,1,1,0,1,0
27,303,303,36,30,6,2,1
21,306,306,26,16,10,3,2
0,312,312,34,34,0,1,0
17,338,338,124,34,90,4,3
12,345,345,34,25,9,2,1
14,355,355,37,23,14,3,2
26,371,371,52,52,0,1,0
19,373,373,3,3,0,1,0
11,378,378,59,59,0,1,0
3,378,378,68,68,0,1,0
6,394,394,17,17,0,1,0
18,439,439,10,10,0,1,0
24,453,453,38,38,0,1,0
25,464,464,33,14,19,3,2

19,114,114,10,10,0,1,0
0,118,118,4,4,0,1,0
12,120,120,44,17,27,2,1
16,154,154,8,2,6,2,1
15,176,176,41,28,13,3,2
13,177,177,9,3,6,2,1
22,209,209,1,1,0,1,0
21,235,235,45,6,39,4,3
1,289,289,93,72,21,4,3
18,295,295,24,24,0,1,0
14,332,332,13,13,0,1,0
11,335,335,6,6,0,1,0
10,337,337,10,3,7,2,1
6,352,352,3,3,0,1,0
17,386,386,38,38,0,1,0
7,409,409,8,1,7,2,1
9,424,424,51,9,42,4,3
8,440,440,19,19,0,1,0
20,448,448,1,1,0,1,0
4,449,449,70,1,69,4,3
3,452,452,31,4,27,2,1
2,459,459,143,143,0,1,0
5,497,497,44,10,34,2,1

10,101,101,5,5,0,1,0
23,103,103,1,1,0,1,0
20,121,121,10,10,0,1,0
18,124,124,27,27,0,1,0
26,131,131,9,9,0,1,0
14,167,167,23,11,12,3,2
0,182,182,7,7,0,1,0
25,199,199,24,8,16,2,1
7,204,204,15,7,8,2,1
21,226,226,17,17,0,1,0
11,231,231,19,19,0,1,0
2,243,243,7,7,0,1,0
4,273,273,12,3,9,4,3
6,319,319,25,25,0,1,0
9,334,334,12,9,3,2,1
24,342,342,39,20,19,4,3
12,347,347,40,11,29,2,1
22,402,402,70,20,50,2,1
5,414,414,5,5,0,1,0
1,418,418,29,5,24,4,3
16,422,422,3,3,0,1,0
8,428,428,81,6,75,4,3
17,433,433,104,72,32,3,2
3,441,441,92,31,61,4,3
13,464,464,5,2,3,2,1
19,469,469,32,14,18,2,1
27,473,473,23,23,0,1,0
15,498,498,13,1,12,4,3

1,119,119,7,2,5,2,1
18,133,133,21,21,0,1,0
0,168,168,39,39,0,1,0
17,175,175,13,13,0,1,0
3,221,221,3,3,0,1,0
12,252,252,42,42,0,1,0
11,265,265,47,47,0,1,0
2,272,272,19,4,15,4,3
19,297,297,122,27,95,4,3
26,302,302,2,2,0,1,0
8,347,347,1,1,0,1,0
7,349,349,35,20,15,4,3
14,374,374,4,4,0,1,0
22,378,378,5,5,0,1,0
4,379,379,16,16,0,1,0
24,394,394,15,15,0,1,0
13,396,396,35,5,30,3,2
5,405,405,35,35,0,1,0
20,415,415,4,4,0,1,0
6,417,417,36,36,0,1,0
10,428,428,26,17,9,2,1
25,455,455,75,38,37,2,1
15,474,474,73,24,49,2,1
23,485,485,6,6,0,1,0
9,495,495,3,3,0,1,0
16,499,499,21,21,0,1,0
21,500,500,66,51,15,4,3

11,106,106,7,7,0,1,0
17,131,131,5,2,3,2,1
21,145,145,11,11,0,1,0
10,173,173,14,10,4,2,1
25,229,229,3,3,0,1,0
1,244,244,1,1,0,1,0
4,248,248,45,45,0,1,0
0,253,253,1,1,0,1,0
22,279,279,1,1,0,1,0
13,287,287,52,52,0,1,0
27,294,294,65,50,15,4,3
19,301,301,121,12,109,4,3
7,320,320,2,2,0,1,0
16,320,320,15,15,0,1,0
8,322,322,15,15,0,1,0
12,343,343,68,22,46,2,1
15,349,349,3,3,0,1,0
23,360,360,50,11,39,4,3
20,377,377,2,2,0,1,0
18,387,387,46,46,0,1,0
14,388,388,21,15,6,3,2
28,390,390,53,53,0,1,0
3,438,438,18,3,15,4,3
9,438,438,5,1,4,2,1
6,439,439,37,37,0,1,0
24,440,440,19,19,0,1,0
5,445,445,11,11,0,1,0
26,462,462,11,2,9,4,3
2,472,472,77,47,30,2,1

19,103,103,10,4,6,2,1
25,115,115,9,6,3,2,1
0,117,117,1,1,0,1,0
3,143,143,15,15,0,1,0
26,166,166,8,8,0,1,0
2,212,212,1,1,0,1,0
4,214,214,3,3,0,1,0
5,214,214,5,1,4,2,1
23,217,217,36,36,0,1,0
18,220,220,40,14,26,2,1
7,231,231,6,6,0,1,0
22,233,233,10,10,0,1,0
15,237,237,15,15,0,1,0
29,254,254,42,42,0,1,0
10,291,291,9,9,0,1,0
21,309,309,66,12,54,4,3
9,312,312,76,27,49,2,1
1,313,313,10,10,0,1,0
12,325,325,2,2,0,1,0
8,331,331,28,28,0,1,0
11,369,369,101,7,94,3,2
13,380,380,56,45,11,2,1
17,403,403,2,2,0,1,0
28,456,456,1,1,0,1,0
20,467,467,1,1,0,1,0
6,469,469,33,33,0,1,0
27,477,477,96,10,86,3,2
16,484,484,1,1,0,1,0
14,490,490,30,30,0,1,0
24,500,500,16,4,12,3,2

15,120,120,13,13,0,1,0
21,128,128,32,1,31,3,2
5,133,133,17,9,8,3,2
12,137,137,8,8,0,1,0
2,140,140,8,2,6,2,1
4,175,175,10,4,6,3,2
10,181,181,29,23,6,2,1
0,201,201,7,3,4,2,1
8,247,247,23,16,7,2,1
18,250,250,11,11,0,1,0
23,257,257,40,4,36,2,1
1,274,274,50,27,23,4,3
7,308,308,15,6,9,2,1
20,313,313,8,8,0,1,0
11,325,325,1,1,0,1,0
6,336,336,11,3,8,3,2
13,350,350,23,11,12,2,1
19,356,356,23,7,16,3,2
22,368,368,60,20,40,3,2
17,378,378,3,3,0,1,0
9,392,392,30,17,13,2,1
16,419,419,8,8,0,1,0
24,420,420,80,24,56,4,3
14,499,499,63,19,44,3,2
3,500,500,137,71,66,3,2

9,105,105,8,1,7,2,1
4,119,119,5,1,4,2,1
0,166,166,27,19,8,2,1
17,166,166,57,57,0,1,0
8,193,193,24,9,15,3,2
2,197,197,84,84,0,1,0
11,209,209,11,11,0,1,0
15,226,226,5,2,3,2,1
13,263,263,16,1,15,4,3
19,298,298,28,4,24,3,2
20,300,300,80,65,15,4,3
1,336,336,51,23,28,3,2
5,368,368,38,31,7,2,1
14,380,380,51,51,0,1,0
7,398,398,26,23,3,2,1
12,399,399,11,11,0,1,0
6,422,422,8,8,0,1,0
3,483,483,52,13,39,4,3
18,483,483,25,1,24,3,2
10,484,484,38,15,23,2,1
16,500,500,9,9,0,1,0

19,111,111,44,6,38,2,1
4,128,128,2,2,0,1,0
10,151,151,6,6,0,1,0
21,157,157,7,3,4,2,1
20,158,158,12,5,7,2,1
22,175,175,4,4,0,1,0
9,180,180,19,13,6,2,1
17,201,201,8,8,0,1,0
11,217,217,38,38,0,1,0
6,219,219,26,26,0,1,0
18,246,246,13,3,10,3,2
5,290,290,13,1,12,2,1
13,290,290,4,1,3,2,1
0,320,320,46,46,0,1,0
12,348,348,27,27,0,1,0
2,369,369,45,45,0,1,0
7,388,388,24,3,21,2,1
14,404,404,68,68,0,1,0
3,427,427,38,2,36,4,3
16,432,432,66,29,37,2,1
15,445,445,5,1,4,2,1
24,457,457,104,12,92,4,3
1,458,458,16,16,0,1,0
8,461,461,79,35,44,2,1
23,479,479,8,8,0,1,0

9,107,107,6,6,0,1,0
5,116,116,13,13,0,1,0
1,125,125,10,10,0,1,0
15,192,192,16,4,12,3,2
2,201,201,57,13,44,3,2
12,233,233,40,26,14,3,2
0,261,261,21,3,18,4,3
14,266,266,9,9,0,1,0
13,292,292,49,11,38,2,1
8,319,319,52,20,32,3,2
6,329,329,77,61,16,2,1
4,350,350,94,94,0,1,0
11,363,363,30,25,5,2,1
18,375,375,103,62,41,2,1
16,407,407,2,2,0,1,0
7,419,419,29,29,0,1,0
3,422,422,60,23,37,2,1
10,467,467,39,39,0,1,0
17,487,487,11,8,3,2,1

1,102,102,1,1,0,1,0
23,103,103,10,10,0,1,0
13,107,107,2,2,0,1,0
14,150,150,20,13,7,2,1
6,184,184,3,3,0,1,0
21,202,202,18,8,10,3,2
15,234,234,5,5,0,1,0
26,255,255,12,6,6,2,1
28,260,260,55,17,38,2,1
9,260,260,29,29,0,1,0
16,262,262,44,44,0,1,0
17,288,288,9,2,7,2,1
4,306,306,22,22,0,1,0
7,317,317,20,20,0,1,0
8,317,317,34,6,28,3,2
11,327,327,5,5,0,1,0
5,328,328,50,32,18,3,2
27,376,376,15,5,10,2,1
20,388,388,61,35,26,3,2
19,419,419,8,5,3,2,1
10,419,419,24,24,0,1,0
22,432,432,106,106,0,1,0
2,456,456,19,19,0,1,0
25,457,457,64,7,57,4,3
24,469,469,21,12,9,4,3
0,477,477,70,61,9,4,3
18,479,479,49,49,0,1,0
3,484,484,15,10,5,2,1
12,491,491,17,4,13,2,1

3,100,100,6,6,0,1,0
5,137,137,35,20,15,4,3
10,146,146,29,29,0,1,0
15,181,181,10,10,0,1,0
11,211,211,7,7,0,1,0
18,237,237,50,20,30,2,1
17,239,239,7,1,6,2,1
16,248,248,38,38,0,1,0
4,252,252,96,70,26,3,2
2,283,283,52,49,3,2,1
8,307,307,11,11,0,1,0
9,340,340,7,7,0,1,0
19,353,353,103,78,25,2,1
7,380,380,45,45,0,1,0
0,382,382,11,3,8,2,1
1,407,407,37,37,0,1,0
14,421,421,27,27,0,1,0
13,445,445,21,21,0,1,0
12,451,451,36,4,32,3,2
6,495,495,41,15,26,2,1

1,114,114,11,4,7,2,1
4,157,157,16,16,0,1,0
7,165,165,40,40,0,1,0
3,173,173,73,73,0,1,0
10,188,188,6,1,5,2,1
19,190,190,48,10,38,3,2
17,205,205,20,4,16,2,1
11,233,233,23,3,20,2,1
8,242,242,18,18,0,1,0
9,253,253,25,25,0,1,0
0,265,265,51,36,15,2,1
15,272,272,8,8,0,1,0
2,324,324,15,4,11,4,3
14,345,345,16,16,0,1,0
6,354,354,6,6,0,1,0
12,423,423,10,10,0,1,0
16,439,439,33,33,0,1,0
18,440,440,50,50,0,1,0
13,442,442,122,74,48,4,3
5,469,469,40,40,0,1,0

20,126,126,13,1,12,3,2
6,127,127,17,17,0,1,0
2,151,151,6,6,0,1,0
15,159,159,3,3,0,1,0
11,162,162,27,27,0,1,0
10,166,166,1,1,0,1,0
17,175,175,26,7,19,2,1
26,178,178,2,2,0,1,0
4,190,190,17,17,0,1,0
9,204,204,1,1,0,1,0
28,213,213,28,28,0,1,0
21,233,233,54,54,0,1,0
13,234,234,1,1,0,1,0
27,256,256,35,7,28,3,2
14,282,282,18,18,0,1,0
19,282,282,12,12,0,1,0
22,304,304,49,33,16,3,2
0,308,308,79,62,17,2,1
1,313,313,15,15,0,1,0
12,340,340,29,29,0,1,0
3,359,359,4,4,0,1,0
8,372,372,23,5,18,3,2
7,373,373,16,11,5,2,1
23,379,379,9,1,8,3,2
5,391,391,29,19,10,2,1
24,433,433,24,24,0,1,0
25,451,451,49,25,24,3,2
18,465,465,33,18,15,2,1
16,477,477,45,29,16,3,2

15,127,127,11,2,9,2,1
2,134,134,15,3,12,4,3
13,143,143,12,12,0,1,0
4,198,198,14,7,7,2,1
8,201,201,41,29,12,2,1
17,229,229,16,16,0,1,0
11,248,248,52,26,26,4,3
10,256,256,20,20,0,1,0
9,257,257,13,13,0,1,0
1,333,333,31,1,30,4,3
5,341,341,62,62,0,1,0
14,346,346,6,6,0,1,0
12,363,363,12,7,5,2,1
0,378,378,8,8,0,1,0
3,381,381,3,3,0,1,0
18,427,427,115,103,12,2,1
7,432,432,45,11,34,3,2
19,434,434,116,116,0,1,0
16,445,445,19,10,9,2,1
20,486,486,7,1,6,3,2
6,490,490,200,53,147,4,3

13,101,101,3,3,0,1,0
3,121,121,26,26,0,1,0
14,138,138,20,20,0,1,0
7,149,149,6,2,4,2,1
16,166,166,24,24,0,1,0
17,179,179,6,6,0,1,0
11,184,184,34,34,0,1,0
21,184,184,38,26,12,4,3
18,207,207,24,24,0,1,0
12,225,225,10,10,0,1,0
1,236,236,3,3,0,1,0
10,268,268,48,48,0,1,0
0,283,283,1,1,0,1,0
15,298,298,12,2,10,2,1
20,301,301,25,22,3,2,1
23,343,343,12,12,0,1,0
22,363,363,101,54,47,3,2
8,411,411,87,87,0,1,0
5,411,411,1,1,0,1,0
4,412,412,37,10,27,4,3
19,436,436,32,6,26,2,1
9,437,437,27,3,24,2,1
2,444,444,50,25,25,2,1
6,447,447,39,39,0,1,0

11,104,104,4,4,0,1,0
7,113,113,1,1,0,1,0
16,159,159,2,2,0,1,0
4,160,160,12,9,3,2,1
10,168,168,10,10,0,1,0
15,171,171,26,26,0,1,0
6,227,227,6,1,5,2,1
20,250,250,19,4,15,2,1
24,277,277,41,18,23,2,1
13,277,277,22,6,16,3,2
12,302,302,45,45,0,1,0
1,315,315,30,30,0,1,0
8,320,320,40,40,0,1,0
2,347,347,121,39,82,3,2
17,351,351,26,26,0,1,0
3,370,370,3,3,0,1,0
9,405,405,75,75,0,1,0
0,414,414,33,33,0,1,0
18,427,427,55,19,36,3,2
5,429,429,1,1,0,1,0
14,442,442,11,11,0,1,0
19,462,462,120,52,68,3,2
23,463,463,17,17,0,1,0
22,473,473,13,6,7,2,1
21,488,488,100,51,49,4,3

21,113,113,11,11,0,1,0
14,118,118,8,8,0,1,0
0,150,150,25,16,9,4,3
4,160,160,9,3,6,2,1
19,206,206,77,77,0,1,0
6,210,210,1,1,0,1,0
2,219,219,9,9,0,1,0
10,243,243,75,68,7,2,1
22,255,255,1,1,0,1,0
12,265,265,13,5,8,3,2
20,272,272,15,15,0,1,0
1,282,282,35,2,33,4,3
7,298,298,13,13,0,1,0
17,302,302,22,14,8,2,1
8,314,314,67,34,33,4,3
9,327,327,43,43,0,1,0
11,328,328,4,4,0,1,0
18,364,364,91,83,8,3,2
13,382,382,4,4,0,1,0
5,398,398,20,20,0,1,0
15,473,473,97,63,34,2,1
3,475,475,29,5,24,4,3
16,500,500,18,18,0,1,0

3,102,102,26,26,0,1,0
18,113,113,9,9,0,1,0
4,166,166,18,6,12,4,3
17,195,195,9,9,0,1,0
9,213,213,6,6,0,1,0
14,233,233,57,57,0,1,0
7,248,248,9,9,0,1,0
8,264,264,27,27,0,1,0
5,283,283,110,5,105,4,3
0,308,308,2,2,0,1,0
1,316,316,5,5,0,1,0
2,317,317,68,10,58,3,2
19,363,363,98,98,0,1,0
15,392,392,30,30,0,1,0
10,400,400,44,7,37,2,1
20,409,409,19,1,18,3,2
13,420,420,10,10,0,1,0
6,441,441,21,13,8,3,2
11,462,462,37,37,0,1,0
12,472,472,70,65,5,2,1
21,488,488,14,1,13,2,1
16,489,489,31,10,21,2,1

15,130,130,38,38,0,1,0
20,158,158,35,35,0,1,0
16,181,181,8,8,0,1,0
2,193,193,39,12,27,2,1
9,204,204,8,8,0,1,0
12,218,218,6,6,0,1,0
18,219,219,12,12,0,1,0
3,252,252,1,1,0,1,0
5,274,274,14,14,0,1,0
0,294,294,1,1,0,1,0
19,295,295,60,60,0,1,0
7,316,316,32,32,0,1,0
1,318,318,29,4,25,4,3
21,318,318,19,19,0,1,0
14,334,334,57,1,56,3,2
11,341,341,18,18,0,1,0
6,360,360,100,16,84,4,3
10,363,363,13,7,6,2,1
8,414,414,159,83,76,4,3
4,463,463,5,5,0,1,0
22,473,473,7,7,0,1,0
17,477,477,4,4,0,1,0
13,492,492,34,25,9,4,3

7,108,108,11,11,0,1,0
14,149,149,22,22,0,1,0
4,152,152,20,20,0,1,0
8,160,160,11,11,0,1,0
18,161,161,2,2,0,1,0
25,166,166,15,15,0,1,0
5,194,194,4,4,0,1,0
16,210,210,40,40,0,1,0
20,222,222,1,1,0,1,0
2,228,228,5,5,0,1,0
1,229,229,16,16,0,1,0
19,236,236,52,28,24,3,2
15,241,241,9,9,0,1,0
22,254,254,43,43,0,1,0
24,255,255,5,5,0,1,0
21,272,272,5,2,3,2,1
13,287,287,25,25,0,1,0
23,307,307,172,172,0,1,0
9,360,360,15,15,0,1,0
6,367,367,14,14,0,1,0
12,373,373,56,56,0,1,0
28,399,399,18,18,0,1,0
26,419,419,17,2,15,2,1
11,429,429,2,2,0,1,0
10,434,434,1,1,0,1,0
0,447,447,38,38,0,1,0
17,477,477,13,13,0,1,0
27,478,478,7,7,0,1,0
3,498,498,1,1,0,1,0

20,148,148,20,8,12,4,3
16,168,168,2,2,0,1,0
2,176,176,65,44,21,4,3
10,196,196,3,3,0,1,0
19,229,229,20,5,15,4,3
15,238,238,8,5,3,2,1
6,244,244,31,31,0,1,0
18,287,287,51,51,0,1,0
4,305,305,18,18,0,1,0
0,377,377,51,39,12,4,3
12,412,412,49,15,34,2,1
7,430,430,41,12,29,2,1
1,444,444,62,29,33,3,2
9,459,459,8,4,4,2,1
5,466,466,104,44,60,3,2
13,467,467,15,15,0,1,0
14,467,467,55,27,28,2,1
3,470,470,5,1,4,2,1
11,482,482,105,100,5,2,1
17,485,485,125,5,120,4,3
8,488,488,20,20,0,1,0

16,101,101,2,2,0,1,0
7,113,113,25,25,0,1,0
13,152,152,1,1,0,1,0
9,156,156,49,49,0,1,0
10,163,163,10,10,0,1,0
3,173,173,22,22,0,1,0
6,192,192,10,10,0,1,0
12,195,195,9,9,0,1,0
18,209,209,5,5,0,1,0
19,210,210,9,9,0,1,0
21,217,217,20,20,0,1,0
15,230,230,67,67,0,1,0
2,268,268,57,57,0,1,0
4,274,274,14,14,0,1,0
0,280,280,8,8,0,1,0
17,286,286,6,6,0,1,0
23,325,325,12,12,0,1,0
22,335,335,80,69,11,2,1
1,370,370,12,12,0,1,0
20,379,379,70,26,44,2,1
8,428,428,3,3,0,1,0
11,452,452,8,2,6,3,2
14,482,482,103,67,36,2,1
5,497,497,38,16,22,3,2

24,102,102,5,5,0,1,0
12,112,112,12,8,4,2,1
8,117,117,7,7,0,1,0
7,127,127,21,21,0,1,0
13,150,150,13,13,0,1,0
10,172,172,1,1,0,1,0
5,174,174,38,38,0,1,0
20,175,175,10,10,0,1,0
16,178,178,17,12,5,2,1
14,213,213,61,61,0,1,0
4,248,248,6,3,3,2,1
9,259,259,3,3,0,1,0
22,318,318,18,18,0,1,0
25,345,345,60,51,9,4,3
21,352,352,5,1,4,2,1
17,360,360,10,1,9,2,1
18,376,376,16,6,10,3,2
19,399,399,6,6,0,1,0
3,416,416,17,17,0,1,0
15,459,459,139,31,108,4,3
2,460,460,75,56,19,2,1
1,474,474,52,2,50,2,1
0,483,483,36,20,16,3,2
23,484,484,51,7,44,2,1
6,487,487,33,33,0,1,0
11,493,493,35,11,24,4,3

12,119,119,38,25,13,2,1
20,124,124,26,26,0,1,0
4,184,184,9,9,0,1,0
16,188,188,57,26,31,2,1
5,197,197,82,16,66,3,2
3,207,207,1,1,0,1,0
9,213,213,7,7,0,1,0
18,249,249,9,3,6,2,1
23,254,254,6,6,0,1,0
8,257,257,68,60,8,3,2
7,260,260,6,6,0,1,0
21,282,282,10,10,0,1,0
6,292,292,54,8,46,3,2
11,295,295,18,9,9,2,1
1,300,300,5,5,0,1,0
22,309,309,19,19,0,1,0
19,319,319,45,19,26,2,1
13,321,321,6,6,0,1,0
17,347,347,11,11,0,1,0
14,365,365,10,10,0,1,0
15,378,378,6,6,0,1,0
0,384,384,45,45,0,1,0
10,424,424,6,1,5,2,1
2,480,480,9,1,8,3,2

2,146,146,70,70,0,1,0
12,199,199,38,32,6,2,1
5,218,218,27,27,0,1,0
10,273,273,53,33,20,3,2
3,276,276,38,10,28,3,2
7,323,323,12,12,0,1,0
1,330,330,54,54,0,1,0
4,330,330,23,5,18,2,1
11,341,341,21,5,16,3,2
15,351,351,57,21,36,2,1
9,367,367,1,1,0,1,0
6,378,378,37,37,0,1,0
18,393,393,101,80,21,2,1
14,402,402,3,3,0,1,0
8,406,406,10,3,7,2,1
13,435,435,33,33,0,1,0
17,436,436,20,12,8,2,1
16,439,439,70,61,9,2,1
0,460,460,59,47,12,2,1

1,127,127,2,2,0,1,0
9,134,134,9,9,0,1,0
22,135,135,3,3,0,1,0
13,148,148,23,1,22,3,2
12,169,169,35,35,0,1,0
14,204,204,7,2,5,2,1
4,212,212,7,7,0,1,0
23,255,255,11,1,10,2,1
6,286,286,23,3,20,2,1
10,287,287,16,4,12,4,3
17,288,288,4,4,0,1,0
8,307,307,4,4,0,1,0
16,325,325,77,77,0,1,0
18,340,340,28,22,6,3,2
19,343,343,60,60,0,1,0
15,364,364,9,5,4,2,1
5,401,401,135,135,0,1,0
3,403,403,3,3,0,1,0
0,415,415,114,101,13,2,1
11,423,423,29,29,0,1,0
21,447,447,100,4,96,4,3
7,449,449,1,1,0,1,0
2,460,460,113,80,33,4,3
20,472,472,4,1,3,2,1

6,107,107,26,3,23,2,1
14,119,119,13,1,12,4,3
16,120,120,3,3,0,1,0
12,124,124,10,10,0,1,0
23,157,157,54,20,34,2,1
7,198,198,7,3,4,2,1
8,217,217,10,2,8,3,2
11,224,224,13,13,0,1,0
15,227,227,40,8,32,2,1
20,234,234,7,2,5,2,1
13,236,236,14,5,9,4,3
17,239,239,6,6,0,1,0
10,271,271,1,1,0,1,0
1,288,288,63,30,33,2,1
5,300,300,32,7,25,2,1
3,401,401,93,42,51,4,3
19,406,406,29,29,0,1,0
18,411,411,59,47,12,4,3
21,411,411,18,18,0,1,0
4,414,414,1,1,0,1,0
22,426,426,51,17,34,2,1
9,429,429,90,42,48,2,1
2,454,454,16,16,0,1,0
0,459,459,5,5,0,1,0

22,123,123,8,8,0,1,0
21,129,129,23,6,17,2,1
6,132,132,26,11,15,2,1
12,155,155,28,28,0,1,0
1,172,172,2,2,0,1,0
25,177,177,29,29,0,1,0
20,187,187,19,3,16,3,2
9,188,188,16,16,0,1,0
11,209,209,30,30,0,1,0
0,215,215,16,16,0,1,0
14,230,230,18,18,0,1,0
17,241,241,36,36,0,1,0
3,246,246,18,2,16,2,1
7,256,256,30,30,0,1,0
26,279,279,22,6,16,2,1
10,280,280,24,15,9,2,1
27,288,288,8,8,0,1,0
23,327,327,12,12,0,1,0
19,328,328,93,66,27,4,3
16,338,338,11,11,0,1,0
13,340,340,24,24,0,1,0
4,348,348,11,1,10,2,1
24,376,376,36,6,30,3,2
8,381,381,1,1,0,1,0
5,382,382,13,13,0,1,0
2,402,402,5,5,0,1,0
15,436,436,1,1,0,1,0
18,491,491,8,8,0,1,0

22,109,109,10,10,0,1,0
26,109,109,8,8,0,1,0
15,119,119,3,3,0,1,0
9,122,122,13,2,11,2,1
2,122,122,32,32,0,1,0
7,142,142,12,3,9,4,3
24,149,149,5,5,0,1,0
25,174,174,20,20,0,1,0
17,199,199,54,54,0,1,0
16,215,215,49,49,0,1,0
5,226,226,2,2,0,1,0
10,226,226,1,1,0,1,0
23,252,252,22,22,0,1,0
3,273,273,18,18,0,1,0
12,275,275,8,5,3,2,1
21,292,292,21,21,0,1,0
0,292,292,52,52,0,1,0
19,311,311,7,7,0,1,0
1,346,346,15,15,0,1,0
18,352,352,44,40,4,2,1
11,358,358,17,2,15,2,1
13,398,398,28,4,24,3,2
8,422,422,11,3,8,3,2
4,426,426,21,3,18,2,1
6,432,432,84,84,0,1,0
14,476,476,14,5,9,4,3
20,478,478,39,11,28,2,1

15,103,103,2,2,0,1,0
16,114,114,4,4,0,1,0
5,133,133,1,1,0,1,0
19,136,136,7,1,6,3,2
22,152,152,3,3,0,1,0
14,157,157,19,19,0,1,0
18,184,184,21,6,15,2,1
0,219,219,22,10,12,4,3
3,237,237,67,13,54,3,2
7,240,240,28,28,0,1,0
23,273,273,6,6,0,1,0
9,337,337,54,7,47,2,1
8,340,340,4,4,0,1,0
13,344,344,3,3,0,1,0
6,345,345,16,7,9,4,3
4,350,350,27,27,0,1,0
12,366,366,52,52,0,1,0
11,367,367,24,16,8,3,2
17,370,370,44,24,20,2,1
10,379,379,51,51,0,1,0
1,412,412,19,10,9,4,3
21,414,414,27,13,14,3,2
24,433,433,33,11,22,3,2
2,442,442,5,5,0,1,0
20,453,453,262,183,79,4,3

1,112,112,5,5,0,1,0
21,114,114,4,4,0,1,0
7,120,120,14,14,0,1,0
9,123,123,3,3,0,1,0
17,135,135,1,1,0,1,0
5,143,143,6,6,0,1,0
12,196,196,3,3,0,1,0
6,207,207,20,20,0,1,0
3,254,254,17,2,15,4,3
0,271,271,6,3,3,2,1
2,290,290,61,18,43,2,1
16,295,295,9,9,0,1,0
8,310,310,120,19,101,4,3
19,322,322,32,32,0,1,0
22,370,370,109,23,86,3,2
11,370,370,6,6,0,1,0
14,405,405,97,31,66,4,3
4,438,438,77,14,63,4,3
13,446,446,75,75,0,1,0
15,454,454,66,66,0,1,0
10,462,462,7,7,0,1,0
18,497,497,20,20,0,1,0
20,500,500,67,67,0,1,0

22,137,137,7,7,0,1,0
8,148,148,47,27,20,3,2
18,156,156,1,1,0,1,0
21,166,166,22,22,0,1,0
2,196,196,1,1,0,1,0
19,214,214,7,7,0,1,0
24,215,215,9,9,0,1,0
15,229,229,11,3,8,3,2
23,243,243,73,73,0,1,0
16,250,250,16,16,0,1,0
26,251,251,1,1,0,1,0
11,258,258,12,12,0,1,0
17,266,266,62,49,13,2,1
13,270,270,31,31,0,1,0
4,286,286,10,10,0,1,0
3,312,312,4,1,3,2,1
20,337,337,68,43,25,2,1
0,355,355,30,30,0,1,0
1,357,357,5,5,0,1,0
10,361,361,17,11,6,3,2
25,382,382,43,43,0,1,0
14,398,398,86,10,76,3,2
12,399,399,14,14,0,1,0
6,435,435,27,27,0,1,0
9,444,444,19,7,12,2,1
5,456,456,6,3,3,2,1
7,490,490,76,43,33,4,3

1,105,105,11,2,9,2,1
13,113,113,31,31,0,1,0
20,126,126,33,33,0,1,0
22,140,140,5,5,0,1,0
17,146,146,19,19,0,1,0
23,151,151,24,10,14,3,2
5,155,155,5,2,3,2,1
21,167,167,6,6,0,1,0
11,203,203,4,4,0,1,0
25,234,234,38,8,30,4,3
26,245,245,3,3,0,1,0
6,247,247,6,3,3,2,1
0,248,248,35,35,0,1,0
19,254,254,14,6,8,3,2
4,264,264,4,4,0,1,0
14,279,279,19,19,0,1,0
3,307,307,15,15,0,1,0
15,349,349,35,17,18,2,1
2,354,354,18,18,0,1,0
7,370,370,8,8,0,1,0
18,375,375,42,10,32,4,3
10,381,381,3,3,0,1,0
27,388,388,49,49,0,1,0
24,390,390,10,6,4,2,1
8,440,440,27,27,0,1,0
9,466,466,2,2,0,1,0
12,491,491,111,102,9,4,3
16,498,498,55,33,22,2,1

6,120,120,4,4,0,1,0
4,161,161,1,1,0,1,0
13,176,176,16,10,6,2,1
0,210,210,178,178,0,1,0
17,210,210,5,5,0,1,0
10,215,215,59,23,36,4,3
15,225,225,5,5,0,1,0
3,255,255,12,6,6,2,1
2,255,255,16,6,10,2,1
5,258,258,10,1,9,4,3
1,280,280,56,40,16,3,2
14,315,315,23,3,20,2,1
11,316,316,71,71,0,1,0
8,325,325,27,13,14,3,2
7,379,379,54,24,30,3,2
16,396,396,79,25,54,3,2
9,428,428,16,16,0,1,0
12,453,453,8,3,5,2,1

1,107,107,7,1,6,2,1
18,130,130,1,1,0,1,0
13,135,135,43,16,27,2,1
20,138,138,35,20,15,4,3
23,157,157,6,6,0,1,0
4,185,185,12,12,0,1,0
2,234,234,17,17,0,1,0
11,244,244,38,5,33,2,1
16,266,266,12,12,0,1,0
9,284,284,27,27,0,1,0
7,298,298,16,16,0,1,0
0,314,314,24,13,11,2,1
22,339,339,22,11,11,2,1
5,366,366,40,11,29,2,1
21,410,410,12,12,0,1,0
19,410,410,26,26,0,1,0
24,411,411,34,19,15,4,3
8,417,417,32,32,0,1,0
14,433,433,27,27,0,1,0
6,438,438,76,40,36,3,2
17,453,453,34,34,0,1,0
15,456,456,85,85,0,1,0
3,470,470,26,16,10,3,2
10,477,477,55,1,54,3,2
12,484,484,42,3,39,4,3

4,126,126,3,3,0,1,0
15,126,126,29,29,0,1,0
2,139,139,7,7,0,1,0
18,153,153,2,2,0,1,0
9,192,192,14,8,6,3,2
16,204,204,10,10,0,1,0
12,219,219,6,6,0,1,0
0,224,224,3,3,0,1,0
8,230,230,4,4,0,1,0
13,262,262,19,19,0,1,0
23,284,284,63,5,58,3,2
14,289,289,23,15,8,3,2
20,292,292,16,4,12,4,3
5,293,293,20,20,0,1,0
7,309,309,22,22,0,1,0
1,335,335,87,36,51,4,3
24,383,383,40,10,30,4,3
21,398,398,21,21,0,1,0
22,409,409,116,85,31,2,1
3,422,422,165,120,45,2,1
6,433,433,25,25,0,1,0
17,434,434,17,5,12,2,1
10,455,455,42,42,0,1,0
11,473,473,26,26,0,1,0
19,500,500,12,12,0,1,0

19,109,109,19,13,6,3,2
0,122,122,17,17,0,1,0
23,125,125,18,4,14,2,1
10,147,147,42,42,0,1,0
22,161,161,8,8,0,1,0
2,166,166,1,1,0,1,0
21,170,170,10,4,6,3,2
15,184,184,31,31,0,1,0
8,197,197,10,10,0,1,0
13,217,217,9,9,0,1,0
17,220,220,5,5,0,1,0
18,232,232,17,17,0,1,0
9,234,234,8,8,0,1,0
6,249,249,1,1,0,1,0
3,273,273,47,47,0,1,0
12,292,292,61,27,34,3,2
14,297,297,44,44,0,1,0
16,311,311,19,19,0,1,0
1,314,314,4,1,3,2,1
11,321,321,22,22,0,1,0
4,387,387,71,38,33,4,3
5,432,432,26,26,0,1,0
7,495,495,91,91,0,1,0
20,498,498,38,38,0,1,0

13,104,104,19,7,12,3,2
0,113,113,1,1,0,1,0
3,179,179,50,11,39,3,2
5,186,186,3,3,0,1,0
1,190,190,29,29,0,1,0
10,200,200,21,21,0,1,0
8,201,201,42,12,30,4,3
6,205,205,53,53,0,1,0
16,226,226,12,12,0,1,0
18,277,277,43,43,0,1,0
11,289,289,29,29,0,1,0
4,291,291,5,5,0,1,0
7,306,306,142,73,69,4,3
12,323,323,6,2,4,2,1
9,369,369,30,10,20,4,3
2,374,374,2,2,0,1,0
19,433,433,17,11,6,2,1
14,438,438,67,67,0,1,0
15,441,441,42,36,6,3,2
17,463,463,16,6,10,4,3

27,119,119,7,1,6,2,1
5,142,142,8,8,0,1,0
20,146,146,5,5,0,1,0
13,151,151,10,10,0,1,0
17,195,195,60,60,0,1,0
0,196,196,12,9,3,2,1
4,217,217,4,4,0,1,0
12,242,242,15,5,10,2,1
10,247,247,6,6,0,1,0
2,251,251,31,31,0,1,0
25,253,253,8,8,0,1,0
28,268,268,34,28,6,2,1
14,268,268,10,10,0,1,0
18,272,272,24,11,13,2,1
22,296,296,1,1,0,1,0
19,298,298,44,44,0,1,0
3,305,305,47,2,45,2,1
26,319,319,1,1,0,1,0
7,351,351,23,23,0,1,0
23,371,371,68,46,22,3,2
9,375,375,34,34,0,1,0
16,388,388,26,26,0,1,0
11,407,407,55,7,48,4,3
6,422,422,4,4,0,1,0
8,474,474,40,40,0,1,0
15,480,480,60,20,40,2,1
1,487,487,10,4,6,2,1
24,490,490,111,57,54,4,3
21,495,495,11,2,9,2,1

19,110,110,1,1,0,1,0
8,113,113,1,1,0,1,0
5,117,117,39,21,18,3,2
15,120,120,11,5,6,3,2
13,135,135,7,7,0,1,0
6,162,162,34,29,5,2,1
0,191,191,34,26,8,2,1
1,195,195,31,10,21,2,1
9,211,211,19,19,0,1,0
10,214,214,14,5,9,2,1
11,239,239,5,5,0,1,0
16,303,303,26,8,18,4,3
14,321,321,20,10,10,3,2
4,376,376,21,21,0,1,0
18,389,389,226,226,0,1,0
12,429,429,64,64,0,1,0
2,430,430,43,43,0,1,0
3,435,435,61,61,0,1,0
7,450,450,11,11,0,1,0
17,465,465,6,6,0,1,0

4,121,121,1,1,0,1,0
11,130,130,5,2,3,2,1
14,142,142,1,1,0,1,0
22,161,161,18,18,0,1,0
8,178,178,7,4,3,2,1
2,183,183,7,7,0,1,0
25,246,246,52,28,24,2,1
10,254,254,26,26,0,1,0
23,307,307,53,53,0,1,0
21,308,308,9,9,0,1,0
5,314,314,56,20,36,4,3
12,316,316,7,4,3,2,1
20,331,331,17,17,0,1,0
0,369,369,10,10,0,1,0
18,372,372,2,2,0,1,0
3,386,386,30,5,25,3,2
9,434,434,59,38,21,2,1
15,448,448,122,114,8,3,2
16,464,464,196,150,46,3,2
6,467,467,18,18,0,1,0
13,473,473,83,31,52,3,2
7,477,477,12,12,0,1,0
17,481,481,10,2,8,3,2
27,481,481,17,17,0,1,0
24,487,487,30,9,21,4,3
1,488,488,7,1,6,3,2
19,496,496,27,3,24,2,1
26,497,497,22,22,0,1,0

1,110,110,27,9,18,2,1
20,136,136,12,12,0,1,0
0,147,147,31,16,15,4,3
22,158,158,11,4,7,2,1
24,160,160,15,10,5,2,1
14,175,175,20,20,0,1,0
12,183,183,1,1,0,1,0
18,221,221,31,19,12,2,1
13,228,228,16,6,10,2,1
10,248,248,3,3,0,1,0
8,260,260,2,2,0,1,0
25,289,289,16,16,0,1,0
15,300,300,26,26,0,1,0
2,301,301,4,4,0,1,0
6,301,301,9,3,6,2,1
17,303,303,83,83,0,1,0
19,320,320,48,48,0,1,0
23,321,321,14,14,0,1,0
4,335,335,2,2,0,1,0
26,364,364,10,7,3,2,1
27,372,372,54,3,51,4,3
5,375,375,26,4,22,3,2
7,422,422,11,11,0,1,0
11,451,451,63,63,0,1,0
16,460,460,4,1,3,2,1
3,461,461,73,36,37,2,1
21,485,485,59,56,3,2,1
9,499,499,3,3,0,1,0

22,107,107,2,2,0,1,0
15,148,148,17,17,0,1,0
18,171,171,25,3,22,3,2
12,205,205,9,9,0,1,0
8,210,210,1,1,0,1,0
13,211,211,33,9,24,2,1
1,214,214,7,7,0,1,0
21,220,220,8,8,0,1,0
4,221,221,4,4,0,1,0
16,233,233,63,51,12,4,3
5,274,274,11,2,9,4,3
9,283,283,2,2,0,1,0
11,301,301,54,24,30,4,3
2,344,344,138,138,0,1,0
10,345,345,70,70,0,1,0
3,357,357,65,17,48,3,2
7,360,360,6,6,0,1,0
23,366,366,16,1,15,2,1
14,373,373,96,96,0,1,0
19,392,392,15,15,0,1,0
20,430,430,16,16,0,1,0
0,444,444,31,21,10,2,1
6,475,475,23,13,10,2,1
17,480,480,31,23,8,3,2

9,134,134,24,24,0,1,0
20,178,178,23,9,14,2,1
7,184,184,16,16,0,1,0
14,192,192,4,1,3,2,1
21,207,207,28,18,10,2,1
4,225,225,29,29,0,1,0
18,229,229,61,30,31,2,1
15,231,231,25,25,0,1,0
16,236,236,66,66,0,1,0
2,257,257,1,1,0,1,0
11,287,287,7,7,0,1,0
3,311,311,51,39,12,3,2
5,342,342,59,59,0,1,0
17,348,348,10,10,0,1,0
19,355,355,15,9,6,3,2
10,361,361,54,54,0,1,0
0,369,369,82,82,0,1,0
1,394,394,22,1,21,4,3
6,419,419,3,3,0,1,0
8,461,461,15,4,11,2,1
12,473,473,43,3,40,2,1
22,497,497,35,35,0,1,0
13,499,499,13,2,11,4,3

3,115,115,10,4,6,3,2
12,123,123,17,9,8,2,1
22,127,127,24,4,20,3,2
24,136,136,11,2,9,2,1
9,140,140,5,5,0,1,0
20,142,142,2,2,0,1,0
23,151,151,12,6,6,2,1
0,151,151,5,5,0,1,0
8,166,166,23,23,0,1,0
11,177,177,11,1,10,2,1
6,188,188,16,6,10,3,2
17,206,206,41,17,24,2,1
2,207,207,4,4,0,1,0
21,222,222,42,7,35,2,1
13,237,237,15,7,8,2,1
14,246,246,16,2,14,2,1
10,260,260,14,7,7,2,1
16,302,302,15,15,0,1,0
25,307,307,2,2,0,1,0
15,313,313,10,4,6,2,1
18,387,387,61,61,0,1,0
1,397,397,34,34,0,1,0
19,407,407,70,70,0,1,0
7,419,419,20,8,12,3,2
5,422,422,72,72,0,1,0
4,438,438,80,80,0,1,0

2,107,107,11,3,8,3,2
4,138,138,15,1,14,3,2
17,141,141,5,5,0,1,0
8,151,151,10,10,0,1,0
1,187,187,7,7,0,1,0
10,196,196,9,9,0,1,0
14,201,201,28,17,11,3,2
12,222,222,4,4,0,1,0
7,244,244,3,3,0,1,0
9,299,299,35,35,0,1,0
18,319,319,34,27,7,2,1
21,336,336,29,29,0,1,0
20,343,343,46,39,7,2,1
11,359,359,21,18,3,2,1
15,371,371,83,79,4,2,1
23,381,381,23,23,0,1,0
13,399,399,120,104,16,2,1
24,408,408,17,17,0,1,0
6,410,410,24,4,20,3,2
25,412,412,78,12,66,4,3
19,413,413,14,4,10,2,1
22,416,416,27,27,0,1,0
0,428,428,61,13,48,2,1
16,442,442,45,18,27,2,1
3,451,451,37,21,16,4,3
5,484,484,24,15,9,4,3

7,134,134,16,16,0,1,0
0,180,180,1,1,0,1,0
15,193,193,28,28,0,1,0
12,198,198,15,15,0,1,0
2,205,205,22,22,0,1,0
6,219,219,80,20,60,4,3
16,220,220,7,7,0,1,0
4,241,241,32,23,9,4,3
18,268,268,40,23,17,2,1
1,282,282,46,10,36,4,3
8,295,295,1,1,0,1,0
10,313,313,27,27,0,1,0
9,326,326,81,36,45,2,1
3,337,337,117,23,94,3,2
14,340,340,11,11,0,1,0
13,358,358,47,47,0,1,0
17,364,364,31,31,0,1,0
5,403,403,32,14,18,4,3
11,464,464,52,18,34,3,2

2,115,115,9,9,0,1,0
18,137,137,2,2,0,1,0
24,140,140,1,1,0,1,0
8,158,158,12,12,0,1,0
9,168,168,1,1,0,1,0
23,189,189,28,5,23,3,2
0,210,210,19,19,0,1,0
5,213,213,49,49,0,1,0
20,216,216,29,21,8,3,2
7,226,226,7,7,0,1,0
21,268,268,21,21,0,1,0
15,283,283,44,44,0,1,0
10,289,289,3,3,0,1,0
22,294,294,7,1,6,2,1
16,345,345,143,118,25,4,3
11,358,358,1,1,0,1,0
12,369,369,41,25,16,2,1
6,373,373,83,8,75,4,3
13,378,378,25,25,0,1,0
19,407,407,25,25,0,1,0
17,413,413,18,9,9,4,3
4,465,465,55,31,24,2,1
1,468,468,79,79,0,1,0
14,470,470,36,36,0,1,0
3,479,479,27,27,0,1,0

24,100,100,1,1,0,1,0
2,108,108,8,8,0,1,0
22,117,117,6,6,0,1,0
11,178,178,29,29,0,1,0
21,181,181,10,10,0,1,0
18,204,204,36,22,14,3,2
15,208,208,21,9,12,3,2
10,249,249,9,9,0,1,0
13,264,264,1,1,0,1,0
16,292,292,2,2,0,1,0
8,297,297,28,10,18,3,2
3,310,310,11,11,0,1,0
6,312,312,15,6,9,4,3
17,328,328,35,35,0,1,0
23,329,329,101,36,65,4,3
1,343,343,60,28,32,3,2
0,359,359,1,1,0,1,0
5,360,360,77,77,0,1,0
4,381,381,3,3,0,1,0
20,409,409,92,25,67,3,2
7,417,417,40,9,31,2,1
12,422,422,30,30,0,1,0
19,454,454,30,30,0,1,0
25,469,469,10,10,0,1,0
9,473,473,54,54,0,1,0
14,486,486,32,32,0,1,0
26,490,490,50,41,9,2,1

2,104,104,6,3,3,2,1
6,106,106,13,13,0,1,0
15,123,123,14,5,9,2,1
4,134,134,6,6,0,1,0
14,141,141,21,21,0,1,0
22,162,162,24,5,19,2,1
17,163,163,7,2,5,2,1
0,197,197,22,7,15,4,3
8,218,218,49,49,0,1,0
10,230,230,12,12,0,1,0
5,268,268,33,33,0,1,0
16,281,281,1,1,0,1,0
1,319,319,13,5,8,3,2
20,325,325,67,45,22,2,1
3,337,337,106,61,45,2,1
13,355,355,10,10,0,1,0
12,365,365,64,40,24,3,2
9,387,387,6,6,0,1,0
7,407,407,38,38,0,1,0
18,415,415,20,5,15,4,3
21,446,446,80,44,36,3,2
11,452,452,20,20,0,1,0
19,460,460,41,2,39,2,1

16,140,140,7,2,5,2,1
8,187,187,24,24,0,1,0
14,190,190,2,2,0,1,0
22,219,219,1,1,0,1,0
11,240,240,5,2,3,2,1
23,256,256,3,3,0,1,0
10,292,292,13,1,12,2,1
2,301,301,5,5,0,1,0
17,303,303,38,38,0,1,0
1,307,307,81,81,0,1,0
13,308,308,38,6,32,3,2
0,309,309,25,12,13,3,2
5,314,314,1,1,0,1,0
3,329,329,18,8,10,3,2
4,393,393,112,112,0,1,0
24,394,394,39,12,27,4,3
20,401,401,6,6,0,1,0
6,407,407,6,6,0,1,0
9,419,419,53,29,24,3,2
18,421,421,36,2,34,2,1
12,423,423,63,20,43,2,1
15,434,434,199,139,60,4,3
19,447,447,43,31,12,3,2
21,462,462,63,63,0,1,0
7,466,466,6,6,0,1,0

2,116,116,13,4,9,2,1
4,127,127,81,33,48,2,1
11,197,197,48,48,0,1,0
12,235,235,8,3,5,2,1
18,268,268,24,20,4,2,1
14,277,277,10,10,0,1,0
19,280,280,41,38,3,2,1
3,303,303,32,2,30,3,2
0,308,308,1,1,0,1,0
9,309,309,11,11,0,1,0
6,318,318,27,27,0,1,0
13,333,333,9,9,0,1,0
20,334,334,13,1,12,2,1
1,359,359,9,9,0,1,0
15,364,364,11,5,6,3,2
7,420,420,40,33,7,2,1
17,424,424,14,14,0,1,0
8,427,427,17,5,12,3,2
5,444,444,43,40,3,2,1
10,468,468,232,109,123,4,3
16,478,478,5,1,4,2,1

13,101,101,4,4,0,1,0
26,108,108,19,19,0,1,0
24,114,114,12,6,6,3,2
10,121,121,6,6,0,1,0
5,122,122,19,1,18,3,2
7,158,158,2,2,0,1,0
2,164,164,13,5,8,2,1
12,173,173,2,2,0,1,0
15,189,189,20,2,18,3,2
21,194,194,17,8,9,2,1
17,198,198,11,11,0,1,0
25,198,198,28,4,24,2,1
11,204,204,14,14,0,1,0
19,245,245,34,34,0,1,0
27,265,265,2,2,0,1,0
22,271,271,43,43,0,1,0
16,274,274,41,5,36,4,3
6,275,275,2,2,0,1,0
9,311,311,54,9,45,4,3
8,324,324,33,33,0,1,0
4,324,324,32,32,0,1,0
14,360,360,1,1,0,1,0
23,369,369,10,10,0,1,0
3,405,405,5,2,3,2,1
1,409,409,22,22,0,1,0
29,418,418,13,13,0,1,0
18,443,443,5,5,0,1,0
28,468,468,140,119,21,4,3
20,479,479,18,2,16,3,2
0,495,495,11,11,0,1,0

6,113,113,25,4,21,4,3
18,115,115,15,15,0,1,0
0,146,146,39,39,0,1,0
11,152,152,6,3,3,2,1
20,156,156,12,12,0,1,0
15,159,159,4,4,0,1,0
23,168,168,3,3,0,1,0
2,172,172,24,7,17,2,1
21,175,175,10,10,0,1,0
3,209,209,15,15,0,1,0
22,214,214,1,1,0,1,0
12,227,227,13,9,4,2,1
8,229,229,8,8,0,1,0
4,257,257,6,6,0,1,0
14,326,326,61,25,36,4,3
10,356,356,53,53,0,1,0
13,366,366,25,25,0,1,0
7,394,394,27,6,21,4,3
19,417,417,138,94,44,2,1
1,419,419,46,46,0,1,0
5,435,435,31,21,10,3,2
17,453,453,27,27,0,1,0
16,466,466,102,14,88,3,2
9,475,475,3,3,0,1,0

25,107,107,1,1,0,1,0
20,138,138,11,2,9,2,1
16,196,196,65,53,12,4,3
0,198,198,10,10,0,1,0
10,204,204,9,9,0,1,0
9,218,218,12,2,10,3,2
24,235,235,22,22,0,1,0
3,236,236,9,5,4,2,1
1,242,242,73,73,0,1,0
11,255,255,1,1,0,1,0
12,267,267,30,30,0,1,0
18,271,271,19,19,0,1,0
15,280,280,24,24,0,1,0
19,285,285,102,53,49,4,3
14,290,290,2,2,0,1,0
2,334,334,12,5,7,2,1
5,340,340,4,4,0,1,0
8,356,356,37,37,0,1,0
22,369,369,29,29,0,1,0
23,396,396,25,19,6,2,1
6,435,435,22,22,0,1,0
21,436,436,5,1,4,2,1
13,448,448,116,72,44,3,2
4,465,465,25,25,0,1,0
7,485,485,39,13,26,3,2
17,489,489,20,5,15,4,3

19,119,119,1,1,0,1,0
23,144,144,15,15,0,1,0
10,171,171,21,21,0,1,0
12,172,172,18,18,0,1,0
5,173,173,4,4,0,1,0
9,192,192,17,17,0,1,0
16,193,193,10,10,0,1,0
18,216,216,22,8,14,2,1
3,230,230,3,3,0,1,0
14,234,234,11,11,0,1,0
21,238,238,106,30,76,3,2
4,241,241,1,1,0,1,0
2,242,242,24,24,0,1,0
22,246,246,2,2,0,1,0
20,251,251,27,1,26,3,2
13,309,309,23,9,14,2,1
15,309,309,23,17,6,2,1
0,314,314,4,4,0,1,0
8,344,344,68,6,62,3,2
17,393,393,57,57,0,1,0
24,398,398,23,2,21,2,1
11,400,400,76,70,6,2,1
7,406,406,39,25,14,2,1
6,427,427,34,34,0,1,0
1,464,464,79,79,0,1,0

17,114,114,1,1,0,1,0
30,118,118,2,2,0,1,0
9,124,124,7,4,3,2,1
25,125,125,6,3,3,2,1
19,136,136,51,30,21,4,3
22,153,153,21,7,14,4,3
18,165,165,3,3,0,1,0
3,171,171,4,4,0,1,0
11,209,209,14,14,0,1,0
4,211,211,14,14,0,1,0
27,211,211,22,15,7,2,1
29,238,238,15,15,0,1,0
26,249,249,17,2,15,4,3
10,249,249,7,7,0,1,0
23,257,257,36,36,0,1,0
14,265,265,20,20,0,1,0
1,267,267,28,22,6,3,2
24,270,270,3,3,0,1,0
0,282,282,19,19,0,1,0
12,283,283,27,4,23,2,1
28,290,290,70,45,25,2,1
7,291,291,34,16,18,4,3
20,319,319,6,6,0,1,0
2,323,323,1,1,0,1,0
13,351,351,86,26,60,4,3
21,405,405,6,6,0,1,0
8,426,426,7,7,0,1,0
6,426,426,69,45,24,4,3
16,436,436,3,3,0,1,0
15,460,460,1,1,0,1,0
5,492,492,19,19,0,1,0

29,126,126,15,4,11,2,1
1,141,141,1,1,0,1,0
4,155,155,1,1,0,1,0
24,155,155,7,7,0,1,0
7,170,170,49,18,31,2,1
6,171,171,2,2,0,1,0
31,178,178,24,9,15,4,3
12,197,197,17,5,12,2,1
2,203,203,3,3,0,1,0
0,203,203,32,32,0,1,0
22,205,205,14,14,0,1,0
10,218,218,1,1,0,1,0
5,235,235,16,16,0,1,0
15,243,243,17,17,0,1,0
25,256,256,20,20,0,1,0
9,257,257,49,4,45,2,1
28,265,265,97,97,0,1,0
20,280,280,23,23,0,1,0
11,290,290,4,4,0,1,0
13,314,314,16,16,0,1,0
30,336,336,21,14,7,2,1
14,366,366,14,1,13,2,1
23,373,373,8,4,4,2,1
21,397,397,52,40,12,4,3
19,418,418,21,21,0,1,0
26,428,428,45,6,39,2,1
18,439,439,1,1,0,1,0
3,439,439,12,12,0,1,0
8,445,445,1,1,0,1,0
16,469,469,2,2,0,1,0
27,484,484,7,7,0,1,0
17,499,499,53,53,0,1,0

11,233,233,22,22,0,1,0
19,235,235,1,1,0,1,0
10,239,239,3,3,0,1,0
6,241,241,2,2,0,1,0
2,248,248,8,8,0,1,0
24,279,279,6,2,4,2,1
21,290,290,31,8,23,2,1
14,296,296,16,16,0,1,0
5,301,301,49,25,24,4,3
4,306,306,12,12,0,1,0
9,309,309,9,9,0,1,0
20,309,309,30,30,0,1,0
15,319,319,37,37,0,1,0
0,339,339,68,24,44,3,2
7,339,339,14,14,0,1,0
16,367,367,95,37,58,3,2
17,367,367,10,3,7,2,1
1,378,378,10,5,5,2,1
12,392,392,31,31,0,1,0
18,438,438,8,8,0,1,0
8,448,448,60,6,54,4,3
22,454,454,110,2,108,4,3
3,456,456,15,15,0,1,0
23,464,464,55,55,0,1,0
25,475,475,72,16,56,3,2
13,492,492,152,133,19,2,1

16,108,108,6,6,0,1,0
1,108,108,8,8,0,1,0
2,111,111,6,6,0,1,0
5,111,111,4,4,0,1,0
9,115,115,5,5,0,1,0
0,119,119,1,1,0,1,0
23,123,123,33,33,0,1,0
19,124,124,17,3,14,2,1
12,201,201,16,7,9,4,3
10,222,222,38,38,0,1,0
18,222,222,17,17,0,1,0
13,245,245,1,1,0,1,0
6,287,287,11,8,3,2,1
20,299,299,9,9,0,1,0
11,314,314,37,13,24,2,1
15,324,324,94,28,66,3,2
7,419,419,75,75,0,1,0
21,422,422,42,42,0,1,0
3,423,423,55,1,54,4,3
4,429,429,121,73,48,2,1
14,430,430,33,9,24,4,3
22,435,435,4,4,0,1,0
8,455,455,31,31,0,1,0
17,479,479,51,51,0,1,0

7,108,108,2,2,0,1,0
2,128,128,7,7,0,1,0
16,157,157,2,2,0,1,0
0,195,195,6,6,0,1,0
14,208,208,3,3,0,1,0
26,212,212,11,1,10,2,1
30,215,215,3,3,0,1,0
19,240,240,8,8,0,1,0
28,240,240,6,6,0,1,0
13,249,249,3,3,0,1,0
1,263,263,75,36,39,3,2
9,263,263,5,5,0,1,0
8,267,267,12,7,5,2,1
29,282,282,6,6,0,1,0
15,285,285,37,37,0,1,0
17,299,299,2,2,0,1,0
4,299,299,1,1,0,1,0
10,300,300,4,4,0,1,0
21,310,310,30,30,0,1,0
22,321,321,15,12,3,2,1
11,336,336,3,3,0,1,0
31,396,396,105,37,68,3,2
12,418,418,73,52,21,4,3
18,428,428,6,6,0,1,0
3,433,433,10,4,6,2,1
6,443,443,109,85,24,3,2
5,445,445,26,20,6,2,1
24,449,449,14,4,10,3,2
25,467,467,92,77,15,2,1
27,484,484,95,95,0,1,0
20,486,486,5,5,0,1,0
23,489,489,129,81,48,4,3

16,114,114,3,3,0,1,0
2,120,120,7,7,0,1,0
20,121,121,18,18,0,1,0
21,134,134,3,3,0,1,0
15,160,160,34,27,7,2,1
5,163,163,34,7,27,4,3
10,179,179,6,6,0,1,0
11,213,213,19,19,0,1,0
7,228,228,1,1,0,1,0
14,231,231,3,3,0,1,0
18,232,232,34,10,24,3,2
9,259,259,7,7,0,1,0
19,264,264,11,11,0,1,0
3,267,267,20,20,0,1,0
0,274,274,37,37,0,1,0
1,281,281,7,7,0,1,0
24,304,304,4,4,0,1,0
13,304,304,15,15,0,1,0
25,323,323,53,29,24,3,2
6,324,324,61,61,0,1,0
22,406,406,53,26,27,2,1
12,458,458,84,77,7,2,1
23,464,464,95,95,0,1,0
17,466,466,49,49,0,1,0
8,468,468,53,53,0,1,0
4,482,482,6,6,0,1,0

0,103,103,6,6,0,1,0
2,131,131,75,61,14,3,2
12,141,141,1,1,0,1,0
3,169,169,6,6,0,1,0
9,180,180,2,2,0,1,0
18,185,185,16,2,14,2,1
25,219,219,61,61,0,1,0
16,221,221,3,3,0,1,0
6,237,237,44,33,11,3,2
24,245,245,23,2,21,4,3
10,246,246,7,7,0,1,0
15,254,254,33,11,22,4,3
1,269,269,4,4,0,1,0
14,308,308,32,32,0,1,0
4,344,344,19,16,3,2,1
22,358,358,48,48,0,1,0
11,360,360,1,1,0,1,0
5,360,360,9,9,0,1,0
21,382,382,1,1,0,1,0
20,394,394,8,2,6,2,1
23,395,395,68,33,35,4,3
7,398,398,59,17,42,3,2
13,406,406,7,1,6,3,2
19,416,416,52,8,44,3,2
17,477,477,28,12,16,2,1
8,479,479,19,11,8,2,1

3,103,103,24,24,0,1,0
4,106,106,18,1,17,2,1
12,128,128,9,9,0,1,0
2,145,145,20,4,16,3,2
1,146,146,1,1,0,1,0
17,150,150,20,20,0,1,0
9,162,162,14,2,12,4,3
20,163,163,45,22,23,2,1
19,196,196,56,34,22,3,2
11,197,197,10,6,4,2,1
16,218,218,1,1,0,1,0
23,219,219,18,18,0,1,0
22,221,221,23,23,0,1,0
15,228,228,13,13,0,1,0
7,231,231,5,2,3,2,1
18,254,254,13,13,0,1,0
10,256,256,4,4,0,1,0
5,304,304,5,5,0,1,0
21,336,336,14,6,8,2,1
8,351,351,24,4,20,3,2
13,365,365,16,16,0,1,0
6,445,445,67,67,0,1,0
0,485,485,85,38,47,4,3
14,489,489,47,47,0,1,0
24,490,490,25,25,0,1,0

0,123,123,16,16,0,1,0
4,129,129,6,6,0,1,0
11,139,139,12,12,0,1,0
22,148,148,18,18,0,1,0
21,155,155,1,1,0,1,0
18,156,156,7,7,0,1,0
2,159,159,6,1,5,2,1
20,170,170,7,1,6,3,2
14,175,175,1,1,0,1,0
3,190,190,3,3,0,1,0
31,192,192,7,7,0,1,0
15,193,193,3,3,0,1,0
28,196,196,31,31,0,1,0
16,264,264,27,11,16,3,2
8,265,265,4,1,3,2,1
30,282,282,41,5,36,4,3
5,292,292,3,3,0,1,0
12,293,293,13,13,0,1,0
26,303,303,13,13,0,1,0
32,324,324,34,1,33,4,3
24,342,342,21,21,0,1,0
27,342,342,49,43,6,2,1
7,371,371,23,4,19,2,1
6,373,373,28,28,0,1,0
29,399,399,85,85,0,1,0
13,399,399,2,2,0,1,0
17,402,402,38,8,30,2,1
9,409,409,41,20,21,4,3
10,421,421,60,9,51,4,3
25,432,432,61,61,0,1,0
19,452,452,58,58,0,1,0
23,478,478,22,22,0,1,0
1,488,488,1,1,0,1,0

7,109,109,5,5,0,1,0
9,119,119,23,23,0,1,0
22,140,140,28,13,15,2,1
3,144,144,21,21,0,1,0
5,163,163,35,35,0,1,0
12,169,169,12,3,9,2,1
8,170,170,16,16,0,1,0
17,193,193,27,18,9,2,1
1,231,231,1,1,0,1,0
10,238,238,10,6,4,2,1
11,272,272,10,2,8,2,1
19,308,308,10,10,0,1,0
6,367,367,29,19,10,2,1
20,370,370,28,4,24,4,3
2,377,377,80,30,50,3,2
4,394,394,65,65,0,1,0
21,396,396,48,48,0,1,0
16,397,397,41,41,0,1,0
0,403,403,2,2,0,1,0
15,416,416,14,5,9,2,1
13,428,428,70,70,0,1,0
18,463,463,105,81,24,2,1
14,464,464,9,9,0,1,0

16,108,108,7,7,0,1,0
3,111,111,4,4,0,1,0
10,140,140,10,4,6,3,2
4,148,148,4,1,3,2,1
17,170,170,16,16,0,1,0
7,170,170,15,4,11,2,1
20,180,180,82,39,43,4,3
1,218,218,91,1,90,3,2
0,239,239,55,47,8,3,2
18,247,247,8,3,5,2,1
13,249,249,11,11,0,1,0
15,265,265,7,1,6,3,2
11,290,290,66,30,36,4,3
19,308,308,19,19,0,1,0
6,315,315,20,20,0,1,0
2,355,355,11,1,10,2,1
5,365,365,74,37,37,4,3
12,384,384,5,5,0,1,0
8,434,434,46,34,12,4,3
14,478,478,18,6,12,4,3
9,495,495,55,55,0,1,0

3,106,106,7,4,3,2,1
1,109,109,13,13,0,1,0
13,138,138,32,26,6,3,2
22,154,154,16,16,0,1,0
5,184,184,28,28,0,1,0
11,207,207,2,2,0,1,0
19,207,207,16,16,0,1,0
10,260,260,15,6,9,2,1
8,261,261,36,36,0,1,0
20,265,265,33,33,0,1,0
2,306,306,1,1,0,1,0
18,350,350,17,11,6,3,2
14,359,359,44,44,0,1,0
16,376,376,49,17,32,3,2
17,382,382,45,1,44,4,3
6,402,402,2,2,0,1,0
9,419,419,75,75,0,1,0
0,423,423,96,33,63,4,3
23,435,435,2,2,0,1,0
15,437,437,11,2,9,2,1
12,438,438,88,3,85,3,2
24,440,440,96,96,0,1,0
7,463,463,1,1,0,1,0
4,473,473,19,19,0,1,0
21,498,498,8,2,6,2,1

24,101,101,10,1,9,4,3
2,106,106,3,3,0,1,0
14,129,129,1,1,0,1,0
21,132,132,19,19,0,1,0
9,137,137,20,6,14,2,1
4,151,151,3,3,0,1,0
5,198,198,17,2,15,4,3
27,204,204,14,3,11,2,1
1,204,204,34,17,17,2,1
18,222,222,14,14,0,1,0
22,238,238,7,7,0,1,0
23,251,251,16,16,0,1,0
11,260,260,32,22,10,2,1
26,263,263,19,9,10,3,2
16,274,274,69,32,37,2,1
0,285,285,7,1,6,2,1
19,298,298,35,2,33,4,3
3,313,313,5,5,0,1,0
25,345,345,65,37,28,2,1
8,348,348,21,21,0,1,0
10,405,405,15,15,0,1,0
7,407,407,21,21,0,1,0
13,431,431,72,48,24,3,2
15,449,449,111,108,3,2,1
12,458,458,1,1,0,1,0
17,478,478,4,4,0,1,0
6,478,478,8,5,3,2,1
20,496,496,62,10,52,3,2

11,108,108,5,5,0,1,0
0,124,124,46,20,26,3,2
16,140,140,33,5,28,2,1
5,216,216,44,44,0,1,0
7,279,279,15,3,12,2,1
10,281,281,32,32,0,1,0
17,284,284,55,7,48,3,2
18,327,327,2,2,0,1,0
14,329,329,47,47,0,1,0
4,343,343,11,7,4,2,1
9,361,361,5,5,0,1,0
8,378,378,4,4,0,1,0
15,382,382,52,52,0,1,0
1,384,384,36,8,28,4,3
2,392,392,69,69,0,1,0
3,405,405,99,99,0,1,0
19,409,409,15,4,11,2,1
13,413,413,83,83,0,1,0
12,456,456,40,28,12,2,1
6,464,464,13,4,9,2,1

10,111,111,10,2,8,3,2
15,116,116,7,4,3,2,1
12,179,179,3,3,0,1,0
14,184,184,32,32,0,1,0
20,195,195,18,15,3,2,1
5,200,200,56,18,38,3,2
9,206,206,4,4,0,1,0
1,232,232,25,2,23,2,1
22,242,242,2,2,0,1,0
7,252,252,25,2,23,2,1
17,280,280,2,2,0,1,0
13,285,285,2,2,0,1,0
24,291,291,26,26,0,1,0
25,296,296,28,20,8,3,2
18,312,312,20,9,11,2,1
0,315,315,9,9,0,1,0
4,320,320,19,7,12,4,3
6,340,340,29,2,27,4,3
8,354,354,4,4,0,1,0
3,376,376,44,29,15,4,3
21,385,385,45,13,32,2,1
23,407,407,7,3,4,2,1
11,416,416,41,16,25,2,1
16,433,433,116,104,12,4,3
2,459,459,4,4,0,1,0
19,475,475,8,3,5,2,1
26,494,494,188,44,144,4,3

4,132,132,23,23,0,1,0
12,157,157,1,1,0,1,0
1,181,181,34,34,0,1,0
21,195,195,4,4,0,1,0
19,209,209,1,1,0,1,0
9,262,262,7,7,0,1,0
16,283,283,17,17,0,1,0
2,316,316,17,17,0,1,0
11,328,328,10,2,8,2,1
0,353,353,104,104,0,1,0
22,353,353,22,3,19,3,2
23,371,371,16,10,6,2,1
3,375,375,3,3,0,1,0
15,404,404,91,91,0,1,0
10,414,414,67,9,58,3,2
25,417,417,2,2,0,1,0
14,420,420,45,4,41,2,1
18,423,423,125,83,42,2,1
20,423,423,38,8,30,4,3
24,427,427,137,112,25,4,3
5,447,447,14,3,11,2,1
7,451,451,1,1,0,1,0
6,463,463,15,1,14,2,1
26,466,466,4,4,0,1,0
8,467,467,8,2,6,2,1
17,471,471,40,40,0,1,0
13,489,489,33,33,0,1,0

1,115,115,16,2,14,3,2
14,139,139,23,8,15,2,1
6,146,146,36,36,0,1,0
21,148,148,37,10,27,4,3
7,199,199,13,3,10,2,1
8,230,230,19,7,12,2,1
2,298,298,140,122,18,4,3
11,314,314,26,26,0,1,0
3,315,315,29,29,0,1,0
18,328,328,33,33,0,1,0
15,337,337,4,4,0,1,0
12,347,347,1,1,0,1,0
9,367,367,15,11,4,2,1
20,368,368,41,28,13,2,1
5,381,381,8,8,0,1,0
13,396,396,33,18,15,2,1
19,399,399,75,75,0,1,0
4,423,423,14,14,0,1,0
17,436,436,50,50,0,1,0
16,466,466,51,51,0,1,0
0,495,495,6,6,0,1,0
10,497,497,2,2,0,1,0

2,100,100,5,5,0,1,0
24,111,111,28,28,0,1,0
21,124,124,10,10,0,1,0
4,184,184,15,15,0,1,0
20,186,186,6,6,0,1,0
0,215,215,47,47,0,1,0
5,223,223,4,1,3,2,1
11,257,257,14,14,0,1,0
3,270,270,4,4,0,1,0
12,270,270,49,28,21,2,1
8,280,280,45,45,0,1,0
13,302,302,23,23,0,1,0
19,340,340,57,57,0,1,0
9,342,342,9,1,8,3,2
6,345,345,31,10,21,4,3
7,363,363,2,2,0,1,0
16,376,376,8,8,0,1,0
22,398,398,43,34,9,4,3
10,400,400,71,59,12,3,2
14,410,410,61,46,15,4,3
18,437,437,15,15,0,1,0
15,463,463,57,57,0,1,0
23,486,486,13,7,6,3,2
1,488,488,60,33,27,4,3
17,493,493,77,77,0,1,0

17,100,100,20,2,18,4,3
12,110,110,2,2,0,1,0
20,136,136,4,4,0,1,0
10,142,142,23,15,8,3,2
13,149,149,36,17,19,2,1
21,176,176,15,4,11,2,1
19,176,176,3,3,0,1,0
3,177,177,8,8,0,1,0
16,217,217,25,15,10,3,2
5,274,274,22,13,9,4,3
15,290,290,91,58,33,4,3
23,324,324,4,4,0,1,0
18,335,335,4,4,0,1,0
0,339,339,15,6,9,2,1
1,352,352,17,17,0,1,0
11,358,358,7,7,0,1,0
6,360,360,57,53,4,2,1
22,370,370,13,1,12,2,1
24,376,376,16,1,15,4,3
4,384,384,31,21,10,2,1
2,395,395,5,5,0,1,0
8,402,402,50,40,10,3,2
25,413,413,42,10,32,2,1
7,441,441,27,23,4,2,1
9,452,452,49,1,48,3,2
14,461,461,122,114,8,2,1

12,120,120,39,39,0,1,0
6,123,123,14,14,0,1,0
21,139,139,19,19,0,1,0
15,178,178,8,5,3,2,1
16,202,202,5,5,0,1,0
0,243,243,6,6,0,1,0
22,252,252,111,33,78,3,2
14,285,285,12,8,4,2,1
27,300,300,19,1,18,2,1
2,326,326,19,13,6,3,2
13,329,329,2,2,0,1,0
20,334,334,8,8,0,1,0
19,337,337,5,5,0,1,0
10,347,347,52,16,36,3,2
25,359,359,47,47,0,1,0
5,360,360,7,1,6,2,1
11,373,373,7,7,0,1,0
9,385,385,27,27,0,1,0
1,387,387,1,1,0,1,0
17,404,404,17,1,16,3,2
18,418,418,54,33,21,4,3
3,424,424,3,3,0,1,0
26,431,431,20,20,0,1,0
24,436,436,35,35,0,1,0
7,445,445,99,54,45,2,1
8,460,460,30,30,0,1,0
28,460,460,44,40,4,2,1
4,472,472,3,3,0,1,0
23,480,480,7,4,3,2,1

4,149,149,42,25,17,2,1
2,189,189,23,23,0,1,0
5,208,208,12,12,0,1,0
21,222,222,25,25,0,1,0
0,222,222,1,1,0,1,0
20,232,232,2,2,0,1,0
18,250,250,6,3,3,2,1
3,256,256,28,28,0,1,0
10,262,262,1,1,0,1,0
8,272,272,29,7,22,3,2
16,286,286,61,61,0,1,0
12,322,322,4,4,0,1,0
9,322,322,124,124,0,1,0
6,330,330,19,19,0,1,0
14,370,370,63,15,48,3,2
7,374,374,14,2,12,4,3
13,390,390,71,71,0,1,0
17,413,413,42,21,21,2,1
15,432,432,34,16,18,3,2
11,462,462,76,8,68,4,3
19,464,464,69,1,68,3,2
1,487,487,20,20,0,1,0

21,113,113,6,3,3,2,1
9,131,131,18,18,0,1,0
3,141,141,9,9,0,1,0
16,154,154,5,5,0,1,0
20,215,215,11,1,10,3,2
27,225,225,5,5,0,1,0
25,225,225,2,2,0,1,0
17,229,229,51,24,27,4,3
23,233,233,7,7,0,1,0
4,253,253,39,8,31,4,3
1,256,256,10,10,0,1,0
13,258,258,2,2,0,1,0
15,271,271,12,12,0,1,0
6,271,271,24,24,0,1,0
22,292,292,13,2,11,4,3
26,293,293,80,44,36,4,3
7,294,294,28,2,26,2,1
2,297,297,42,22,20,3,2
0,312,312,6,6,0,1,0
19,315,315,17,9,8,2,1
12,360,360,21,18,3,2,1
14,400,400,51,5,46,3,2
24,417,417,1,1,0,1,0
5,442,442,15,15,0,1,0
10,452,452,32,2,30,4,3
8,453,453,51,29,22,2,1
18,468,468,198,105,93,4,3
11,480,480,4,4,0,1,0

1,127,127,16,16,0,1,0
16,132,132,6,1,5,2,1
10,133,133,52,31,21,4,3
14,145,145,13,13,0,1,0
22,147,147,1,1,0,1,0
6,178,178,7,1,6,3,2
0,189,189,6,3,3,2,1
20,209,209,17,3,14,3,2
23,230,230,26,2,24,4,3
3,234,234,7,7,0,1,0
2,257,257,6,6,0,1,0
4,302,302,12,2,10,3,2
17,302,302,2,2,0,1,0
19,303,303,3,3,0,1,0
8,311,311,3,3,0,1,0
18,343,343,42,26,16,2,1
9,411,411,22,22,0,1,0
13,421,421,43,7,36,4,3
15,425,425,243,213,30,4,3
21,437,437,20,15,5,2,1
12,438,438,34,11,23,2,1
7,443,443,86,86,0,1,0
11,449,449,62,62,0,1,0
24,478,478,17,2,15,3,2
5,500,500,24,6,18,4,3

0,102,102,12,7,5,2,1
17,104,104,27,4,23,2,1
20,119,119,10,10,0,1,0
16,119,119,23,19,4,2,1
11,120,120,31,31,0,1,0
2,124,124,1,1,0,1,0
4,137,137,12,12,0,1,0
1,147,147,3,3,0,1,0
22,149,149,2,2,0,1,0
14,206,206,22,14,8,3,2
23,214,214,13,13,0,1,0
21,221,221,12,12,0,1,0
3,223,223,20,20,0,1,0
24,237,237,8,8,0,1,0
18,262,262,8,8,0,1,0
15,263,263,5,5,0,1,0
9,313,313,47,20,27,4,3
10,331,331,18,18,0,1,0
7,378,378,2,2,0,1,0
13,385,385,134,122,12,2,1
8,388,388,47,40,7,2,1
12,394,394,21,6,15,2,1
19,404,404,12,12,0,1,0
5,410,410,41,22,19,2,1
6,492,492,67,67,0,1,0

12,101,101,14,14,0,1,0
17,143,143,38,14,24,3,2
0,157,157,8,2,6,3,2
3,205,205,51,51,0,1,0
8,208,208,10,6,4,2,1
1,243,243,100,86,14,3,2
10,246,246,18,18,0,1,0
15,250,250,62,62,0,1,0
5,282,282,13,13,0,1,0
18,329,329,13,6,7,2,1
2,371,371,36,17,19,2,1
6,374,374,84,30,54,3,2
11,394,394,24,24,0,1,0
13,396,396,13,3,10,2,1
4,415,415,51,35,16,3,2
9,423,423,4,4,0,1,0
14,455,455,16,10,6,3,2
16,481,481,74,26,48,3,2
7,498,498,62,62,0,1,0

1,105,105,14,14,0,1,0
4,133,133,5,2,3,2,1
17,157,157,26,7,19,4,3
19,159,159,3,3,0,1,0
3,160,160,15,15,0,1,0
18,172,172,10,10,0,1,0
7,188,188,4,4,0,1,0
0,189,189,48,48,0,1,0
21,194,194,8,8,0,1,0
14,200,200,27,27,0,1,0
11,208,208,49,49,0,1,0
12,250,250,62,22,40,2,1
10,277,277,3,3,0,1,0
20,279,279,6,2,4,2,1
8,307,307,48,48,0,1,0
15,308,308,57,28,29,2,1
2,333,333,4,4,0,1,0
13,353,353,23,23,0,1,0
5,369,369,75,22,53,4,3
16,379,379,16,8,8,3,2
6,425,425,1,1,0,1,0
9,442,442,127,87,40,3,2

18,119,119,57,17,40,3,2
5,126,126,9,9,0,1,0
12,148,148,19,12,7,2,1
4,152,152,21,21,0,1,0
17,157,157,5,2,3,2,1
2,158,158,1,1,0,1,0
21,161,161,13,1,12,4,3
19,219,219,19,19,0,1,0
3,235,235,101,91,10,3,2
13,247,247,5,5,0,1,0
1,266,266,29,29,0,1,0
22,270,270,47,47,0,1,0
8,287,287,38,26,12,3,2
23,289,289,22,22,0,1,0
10,301,301,1,1,0,1,0
6,302,302,16,16,0,1,0
20,321,321,7,7,0,1,0
7,356,356,66,12,54,3,2
11,366,366,5,5,0,1,0
0,399,399,18,18,0,1,0
15,449,449,24,6,18,3,2
14,457,457,30,10,20,3,2
16,465,465,9,9,0,1,0
9,468,468,7,1,6,2,1

0,105,105,2,2,0,1,0
16,131,131,8,8,0,1,0
24,139,139,10,10,0,1,0
14,166,166,18,12,6,2,1
9,173,173,31,5,26,2,1
13,191,191,22,22,0,1,0
1,207,207,18,14,4,2,1
21,222,222,8,5,3,2,1
12,241,241,7,7,0,1,0
17,261,261,90,90,0,1,0
4,283,283,34,34,0,1,0
2,289,289,14,3,11,2,1
15,295,295,41,41,0,1,0
20,314,314,19,19,0,1,0
19,320,320,1,1,0,1,0
8,324,324,24,18,6,3,2
5,332,332,58,2,56,3,2
22,370,370,40,40,0,1,0
18,384,384,6,6,0,1,0
23,384,384,66,66,0,1,0
3,400,400,7,4,3,2,1
11,406,406,51,51,0,1,0
6,429,429,54,6,48,4,3
10,469,469,71,52,19,2,1
7,478,478,23,23,0,1,0

25,103,103,14,14,0,1,0
27,111,111,2,2,0,1,0
16,128,128,21,21,0,1,0
2,129,129,14,14,0,1,0
6,140,140,8,2,6,2,1
22,176,176,38,6,32,2,1
17,182,182,36,4,32,2,1
21,184,184,17,11,6,3,2
20,192,192,3,3,0,1,0
7,243,243,9,1,8,3,2
5,254,254,12,3,9,2,1
10,260,260,1,1,0,1,0
15,297,297,1,1,0,1,0
12,331,331,25,12,13,2,1
1,336,336,10,7,3,2,1
0,347,347,1,1,0,1,0
11,349,349,11,5,6,2,1
26,351,351,67,23,44,3,2
24,360,360,55,55,0,1,0
13,365,365,18,18,0,1,0
14,375,375,101,63,38,2,1
9,375,375,2,2,0,1,0
4,424,424,93,16,77,4,3
19,452,452,7,7,0,1,0
18,452,452,48,48,0,1,0
28,474,474,3,3,0,1,0
23,478,478,39,39,0,1,0
3,479,479,9,9,0,1,0
8,491,491,40,34,6,3,2

18,115,115,10,7,3,2,1
9,133,133,47,47,0,1,0
17,135,135,4,4,0,1,0
12,147,147,2,2,0,1,0
2,156,156,16,16,0,1,0
7,162,162,9,3,6,2,1
5,164,164,43,43,0,1,0
20,205,205,6,2,4,2,1
6,209,209,38,38,0,1,0
1,219,219,100,4,96,4,3
0,222,222,11,1,10,2,1
13,228,228,3,3,0,1,0
16,233,233,46,46,0,1,0
8,249,249,9,9,0,1,0
19,321,321,98,31,67,4,3
11,363,363,6,6,0,1,0
14,363,363,43,43,0,1,0
10,449,449,6,6,0,1,0
3,459,459,10,5,5,2,1
15,473,473,24,4,20,4,3
4,498,498,17,8,9,4,3

11,131,131,3,3,0,1,0
24,156,156,21,15,6,2,1
2,160,160,11,6,5,2,1
20,176,176,8,8,0,1,0
16,183,183,2,2,0,1,0
8,184,184,7,3,4,2,1
7,219,219,10,4,6,3,2
17,229,229,12,12,0,1,0
3,250,250,11,11,0,1,0
6,253,253,3,3,0,1,0
23,280,280,60,60,0,1,0
18,285,285,29,6,23,3,2
5,286,286,12,2,10,3,2
13,333,333,10,10,0,1,0
19,349,349,5,5,0,1,0
25,363,363,27,18,9,2,1
1,383,383,84,69,15,2,1
12,410,410,39,10,29,2,1
10,418,418,88,88,0,1,0
15,440,440,117,48,69,4,3
22,462,462,91,71,20,3,2
0,464,464,12,8,4,2,1
14,471,471,44,44,0,1,0
21,484,484,7,7,0,1,0
4,493,493,92,29,63,4,3
9,500,500,81,49,32,4,3

5,151,151,45,45,0,1,0
20,167,167,2,2,0,1,0
23,167,167,18,18,0,1,0
13,170,170,68,68,0,1,0
0,179,179,33,33,0,1,0
2,202,202,5,5,0,1,0
3,218,218,9,9,0,1,0
19,219,219,3,3,0,1,0
11,234,234,2,2,0,1,0
15,245,245,28,8,20,2,1
10,257,257,21,21,0,1,0
17,272,272,21,9,12,2,1
8,289,289,34,28,6,2,1
4,290,290,22,22,0,1,0
14,307,307,2,2,0,1,0
22,325,325,25,11,14,2,1
18,350,350,52,36,16,3,2
6,352,352,6,3,3,2,1
21,378,378,36,21,15,4,3
9,394,394,11,11,0,1,0
7,401,401,54,31,23,2,1
1,466,466,13,4,9,4,3
24,474,474,45,45,0,1,0
16,482,482,36,27,9,2,1
12,482,482,78,73,5,2,1

10,110,110,5,2,3,2,1
15,111,111,5,5,0,1,0
11,111,111,2,2,0,1,0
9,221,221,9,4,5,2,1
3,228,228,16,12,4,2,1
17,232,232,60,60,0,1,0
16,240,240,46,46,0,1,0
4,254,254,29,29,0,1,0
2,258,258,16,2,14,2,1
5,276,276,29,2,27,4,3
1,314,314,176,89,87,4,3
14,339,339,10,4,6,2,1
13,368,368,16,16,0,1,0
12,410,410,29,29,0,1,0
8,423,423,112,106,6,2,1
7,429,429,20,20,0,1,0
6,432,432,73,73,0,1,0
0,465,465,134,74,60,4,3

2,107,107,35,35,0,1,0
11,110,110,25,25,0,1,0
8,153,153,1,1,0,1,0
13,195,195,6,6,0,1,0
0,203,203,18,5,13,2,1
16,209,209,4,4,0,1,0
15,222,222,16,16,0,1,0
12,272,272,7,7,0,1,0
10,288,288,25,25,0,1,0
19,297,297,106,17,89,4,3
14,299,299,17,17,0,1,0
7,368,368,44,44,0,1,0
18,368,368,54,2,52,3,2
5,384,384,7,7,0,1,0
6,386,386,159,49,110,4,3
4,418,418,42,9,33,2,1
1,424,424,38,20,18,3,2
17,453,453,64,64,0,1,0
3,456,456,21,21,0,1,0
9,480,480,26,6,20,2,1

20,100,100,4,4,0,1,0
0,150,150,52,36,16,3,2
22,192,192,2,2,0,1,0
9,194,194,11,5,6,2,1
21,195,195,6,6,0,1,0
5,209,209,3,3,0,1,0
13,216,216,2,2,0,1,0
6,217,217,31,3,28,3,2
15,228,228,67,67,0,1,0
18,229,229,26,22,4,2,1
19,248,248,113,107,6,3,2
14,260,260,7,2,5,2,1
23,271,271,3,3,0,1,0
7,273,273,3,3,0,1,0
3,330,330,29,29,0,1,0
2,335,335,34,6,28,3,2
17,337,337,35,35,0,1,0
12,368,368,4,4,0,1,0
11,377,377,50,50,0,1,0
8,395,395,1,1,0,1,0
10,401,401,41,41,0,1,0
1,413,413,21,12,9,2,1
4,419,419,59,9,50,3,2
16,424,424,33,33,0,1,0
24,434,434,24,21,3,2,1

1,109,109,7,7,0,1,0
27,115,115,17,17,0,1,0
19,124,124,2,2,0,1,0
6,126,126,1,1,0,1,0
14,135,135,1,1,0,1,0
11,157,157,1,1,0,1,0
0,177,177,44,44,0,1,0
20,267,267,19,19,0,1,0
21,279,279,81,29,52,3,2
22,282,282,56,22,34,3,2
7,290,290,23,5,18,2,1
24,299,299,21,21,0,1,0
2,327,327,3,3,0,1,0
10,331,331,19,19,0,1,0
18,339,339,22,22,0,1,0
17,352,352,21,21,0,1,0
3,354,354,12,12,0,1,0
8,373,373,43,43,0,1,0
23,377,377,12,9,3,2,1
9,387,387,56,28,28,3,2
15,404,404,55,55,0,1,0
25,456,456,76,76,0,1,0
5,457,457,42,35,7,2,1
12,458,458,9,9,0,1,0
13,481,481,25,19,6,2,1
16,483,483,44,44,0,1,0
4,492,492,63,63,0,1,0
26,496,496,9,9,0,1,0

5,117,117,29,1,28,2,1
18,138,138,15,15,0,1,0
3,164,164,25,19,6,3,2
6,178,178,18,18,0,1,0
21,178,178,3,3,0,1,0
1,191,191,22,5,17,2,1
19,193,193,19,19,0,1,0
12,210,210,8,8,0,1,0
4,235,235,14,7,7,2,1
10,252,252,40,40,0,1,0
22,256,256,6,2,4,2,1
7,281,281,22,22,0,1,0
15,286,286,10,5,5,2,1
0,286,286,11,11,0,1,0
13,296,296,54,24,30,2,1
20,331,331,14,14,0,1,0
2,337,337,7,7,0,1,0
9,382,382,33,19,14,2,1
16,416,416,94,79,15,2,1
8,418,418,60,60,0,1,0
11,420,420,43,27,16,3,2
17,427,427,116,116,0,1,0
14,492,492,38,11,27,4,3

24,126,126,2,2,0,1,0
17,130,130,26,26,0,1,0
11,153,153,3,3,0,1,0
23,165,165,3,3,0,1,0
6,190,190,6,6,0,1,0
0,198,198,2,2,0,1,0
3,201,201,10,10,0,1,0
15,203,203,16,16,0,1,0
13,203,203,7,1,6,3,2
25,270,270,83,61,22,3,2
8,287,287,7,7,0,1,0
20,302,302,11,11,0,1,0
12,328,328,5,5,0,1,0
22,334,334,3,3,0,1,0
28,340,340,80,2,78,4,3
7,345,345,15,15,0,1,0
29,386,386,24,24,0,1,0
5,403,403,49,10,39,4,3
18,407,407,65,38,27,4,3
27,410,410,86,54,32,2,1
1,410,410,81,81,0,1,0
14,416,416,68,68,0,1,0
26,425,425,38,11,27,2,1
21,433,433,11,2,9,4,3
19,446,446,22,22,0,1,0
4,453,453,24,6,18,4,3
10,458,458,24,19,5,2,1
2,466,466,20,20,0,1,0
16,489,489,20,20,0,1,0
9,499,499,14,14,0,1,0

16,101,101,4,1,3,2,1
23,107,107,17,17,0,1,0
26,141,141,3,3,0,1,0
21,164,164,20,20,0,1,0
29,180,180,79,58,21,4,3
12,198,198,8,8,0,1,0
30,206,206,6,6,0,1,0
18,207,207,22,22,0,1,0
5,229,229,6,1,5,2,1
6,243,243,14,14,0,1,0
1,244,244,9,1,8,2,1
4,255,255,6,1,5,2,1
0,261,261,11,11,0,1,0
15,298,298,6,6,0,1,0
19,298,298,30,19,11,2,1
2,299,299,10,10,0,1,0
8,332,332,10,10,0,1,0
27,350,350,3,3,0,1,0
14,352,352,56,56,0,1,0
28,370,370,8,8,0,1,0
22,372,372,18,18,0,1,0
25,383,383,100,35,65,4,3
3,398,398,1,1,0,1,0
7,398,398,82,82,0,1,0
31,417,417,34,34,0,1,0
17,433,433,18,18,0,1,0
13,433,433,7,7,0,1,0
24,444,444,5,5,0,1,0
11,448,448,92,70,22,4,3
20,460,460,8,5,3,2,1
9,462,462,1,1,0,1,0
10,477,477,5,5,0,1,0

20,121,121,21,4,17,3,2
18,127,127,5,1,4,2,1
5,133,133,3,3,0,1,0
11,146,146,14,4,10,2,1
22,166,166,4,4,0,1,0
23,218,218,6,6,0,1,0
14,239,239,23,6,17,2,1
1,269,269,10,6,4,2,1
12,279,279,81,9,72,3,2
17,288,288,36,36,0,1,0
16,301,301,21,21,0,1,0
15,312,312,7,1,6,2,1
8,320,320,11,11,0,1,0
3,340,340,12,12,0,1,0
13,350,350,21,9,12,3,2
7,350,350,92,6,86,4,3
19,387,387,58,18,40,4,3
2,396,396,52,5,47,2,1
21,406,406,60,60,0,1,0
10,421,421,37,22,15,2,1
9,434,434,75,75,0,1,0
4,435,435,34,16,18,3,2
6,465,465,101,59,42,4,3
0,478,478,13,3,10,2,1

0,104,104,5,5,0,1,0
8,141,141,28,1,27,4,3
7,152,152,30,30,0,1,0
6,185,185,19,1,18,2,1
1,187,187,9,9,0,1,0
15,222,222,14,1,13,2,1
16,253,253,10,10,0,1,0
17,287,287,15,12,3,2,1
18,292,292,45,33,12,3,2
2,298,298,51,32,19,2,1
4,335,335,49,49,0,1,0
5,356,356,1,1,0,1,0
3,357,357,103,103,0,1,0
9,378,378,67,30,37,2,1
11,452,452,148,148,0,1,0
19,454,454,3,3,0,1,0
14,465,465,32,32,0,1,0
20,469,469,4,1,3,2,1
12,477,477,36,36,0,1,0
13,480,480,91,35,56,3,2
10,491,491,26,26,0,1,0

2,104,104,11,5,6,3,2
4,108,108,6,3,3,2,1
11,112,112,30,14,16,3,2
3,120,120,3,3,0,1,0
21,134,134,1,1,0,1,0
15,149,149,35,28,7,2,1
20,188,188,17,17,0,1,0
18,195,195,12,9,3,2,1
8,227,227,58,36,22,2,1
13,240,240,7,2,5,2,1
16,248,248,35,35,0,1,0
22,280,280,48,26,22,2,1
6,294,294,29,29,0,1,0
19,314,314,61,25,36,4,3
9,316,316,37,21,16,2,1
10,335,335,15,15,0,1,0
0,342,342,84,84,0,1,0
7,400,400,30,21,9,4,3
12,434,434,4,1,3,2,1
5,453,453,61,61,0,1,0
1,469,469,20,20,0,1,0
14,470,470,3,3,0,1,0
17,473,473,5,5,0,1,0

17,121,121,19,1,18,4,3
3,137,137,10,5,5,2,1
23,139,139,1,1,0,1,0
14,173,173,14,14,0,1,0
15,174,174,4,4,0,1,0
19,213,213,10,4,6,2,1
4,217,217,27,27,0,1,0
18,224,224,58,17,41,2,1
10,228,228,1,1,0,1,0
11,240,240,5,5,0,1,0
0,244,244,28,10,18,4,3
24,259,259,12,2,10,3,2
9,263,263,18,15,3,2,1
16,272,272,19,6,13,4,3
8,282,282,16,16,0,1,0
7,283,283,7,3,4,2,1
22,289,289,10,10,0,1,0
1,309,309,8,8,0,1,0
6,331,331,115,115,0,1,0
2,341,341,2,2,0,1,0
26,363,363,58,58,0,1,0
12,375,375,29,7,22,2,1
20,375,375,58,58,0,1,0
5,384,384,10,10,0,1,0
25,400,400,40,40,0,1,0
13,441,441,57,3,54,3,2
27,474,474,39,39,0,1,0
21,495,495,52,52,0,1,0

0,135,135,4,4,0,1,0
21,145,145,11,3,8,3,2
16,152,152,4,1,3,2,1
5,192,192,5,1,4,2,1
3,194,194,40,40,0,1,0
2,196,196,11,11,0,1,0
20,203,203,12,3,9,2,1
14,216,216,15,10,5,2,1
17,223,223,59,3,56,3,2
15,229,229,1,1,0,1,0
13,289,289,27,2,25,2,1
19,298,298,19,19,0,1,0
6,359,359,42,42,0,1,0
1,363,363,84,41,43,4,3
18,418,418,27,27,0,1,0
11,424,424,56,31,25,2,1
9,425,425,89,41,48,3,2
4,437,437,108,108,0,1,0
12,467,467,81,19,62,3,2
10,469,469,95,95,0,1,0
8,471,471,1,1,0,1,0
7,497,497,38,26,12,4,3

3,100,100,8,8,0,1,0
17,102,102,2,2,0,1,0
13,111,111,2,2,0,1,0
20,161,161,38,10,28,3,2
6,182,182,29,20,9,2,1
7,186,186,7,7,0,1,0
14,192,192,37,37,0,1,0
21,195,195,23,23,0,1,0
2,200,200,46,30,16,2,1
1,201,201,4,1,3,2,1
11,211,211,49,10,39,3,2
4,238,238,22,22,0,1,0
5,279,279,5,2,3,2,1
19,296,296,31,25,6,3,2
10,298,298,59,59,0,1,0
22,316,316,10,1,9,4,3
8,323,323,13,13,0,1,0
12,392,392,1,1,0,1,0
9,412,412,28,7,21,2,1
23,440,440,1,1,0,1,0
16,441,441,65,24,41,2,1
18,443,443,88,26,62,3,2
0,449,449,13,13,0,1,0
15,457,457,70,59,11,2,1

20,100,100,19,6,13,2,1
10,119,119,1,1,0,1,0
6,124,124,8,2,6,2,1
7,147,147,1,1,0,1,0
16,156,156,18,10,8,2,1
1,168,168,8,8,0,1,0
19,215,215,23,23,0,1,0
21,228,228,2,2,0,1,0
12,255,255,73,61,12,4,3
2,262,262,22,14,8,3,2
15,264,264,37,37,0,1,0
9,287,287,10,1,9,2,1
11,345,345,22,22,0,1,0
3,347,347,58,58,0,1,0
22,350,350,32,32,0,1,0
17,362,362,13,13,0,1,0
8,378,378,60,50,10,2,1
5,390,390,26,12,14,3,2
4,396,396,3,3,0,1,0
0,407,407,25,25,0,1,0
24,411,411,12,12,0,1,0
25,413,413,131,131,0,1,0
18,427,427,33,33,0,1,0
23,429,429,38,38,0,1,0
14,430,430,57,29,28,3,2
13,456,456,5,5,0,1,0
26,480,480,9,9,0,1,0

24,138,138,34,3,31,3,2
0,142,142,5,5,0,1,0
12,153,153,1,1,0,1,0
1,161,161,1,1,0,1,0
23,203,203,21,21,0,1,0
18,205,205,18,5,13,4,3
3,240,240,11,4,7,2,1
14,276,276,39,39,0,1,0
8,278,278,5,1,4,2,1
7,279,279,31,31,0,1,0
11,310,310,64,64,0,1,0
27,322,322,24,5,19,3,2
13,333,333,14,14,0,1,0
6,335,335,43,26,17,2,1
25,337,337,15,5,10,3,2
9,339,339,14,14,0,1,0
20,364,364,19,19,0,1,0
15,371,371,5,5,0,1,0
26,388,388,36,36,0,1,0
4,400,400,110,58,52,4,3
19,417,417,32,5,27,2,1
21,421,421,2,2,0,1,0
2,432,432,20,20,0,1,0
22,455,455,31,25,6,3,2
5,456,456,36,36,0,1,0
10,468,468,2,2,0,1,0
16,484,484,104,83,21,4,3
17,494,494,74,74,0,1,0

16,131,131,3,3,0,1,0
19,133,133,3,3,0,1,0
1,134,134,22,22,0,1,0
10,137,137,58,29,29,2,1
15,150,150,17,17,0,1,0
21,161,161,13,3,10,2,1
5,165,165,31,2,29,3,2
18,190,190,16,10,6,2,1
6,220,220,1,1,0,1,0
12,235,235,2,2,0,1,0
14,246,246,9,9,0,1,0
20,280,280,73,4,69,4,3
2,301,301,25,3,22,3,2
22,322,322,52,48,4,2,1
8,344,344,16,16,0,1,0
3,389,389,71,1,70,3,2
7,391,391,9,9,0,1,0
4,397,397,9,9,0,1,0
0,406,406,23,3,20,2,1
17,452,452,12,12,0,1,0
9,467,467,3,3,0,1,0
11,471,471,102,14,88,4,3
13,498,498,98,86,12,4,3

14,106,106,4,4,0,1,0
0,108,108,2,2,0,1,0
12,117,117,19,7,12,4,3
24,146,146,5,5,0,1,0
7,152,152,27,13,14,2,1
15,155,155,20,20,0,1,0
22,168,168,30,9,21,4,3
25,174,174,47,21,26,2,1
11,185,185,14,14,0,1,0
8,201,201,33,5,28,3,2
3,204,204,1,1,0,1,0
20,207,207,6,6,0,1,0
2,237,237,1,1,0,1,0
4,265,265,26,20,6,2,1
17,270,270,1,1,0,1,0
18,299,299,50,50,0,1,0
6,305,305,19,6,13,2,1
23,336,336,65,65,0,1,0
10,404,404,16,16,0,1,0
13,422,422,43,11,32,2,1
1,429,429,43,7,36,2,1
16,433,433,14,14,0,1,0
19,461,461,55,22,33,2,1
21,482,482,19,16,3,2,1
5,485,485,71,26,45,4,3
9,499,499,23,15,8,3,2

10,112,112,5,5,0,1,0
19,120,120,8,8,0,1,0
4,125,125,2,2,0,1,0
24,133,133,1,1,0,1,0
0,137,137,8,8,0,1,0
21,156,156,29,29,0,1,0
1,188,188,5,5,0,1,0
17,197,197,18,18,0,1,0
25,199,199,14,14,0,1,0
23,205,205,18,1,17,3,2
18,208,208,4,4,0,1,0
13,210,210,16,2,14,2,1
12,222,222,1,1,0,1,0
15,236,236,7,7,0,1,0
22,255,255,21,21,0,1,0
8,285,285,147,3,144,4,3
5,293,293,12,12,0,1,0
20,321,321,70,35,35,2,1
7,331,331,50,22,28,3,2
11,345,345,11,8,3,2,1
2,366,366,25,25,0,1,0
3,373,373,7,4,3,2,1
26,376,376,109,109,0,1,0
14,385,385,20,20,0,1,0
27,391,391,21,10,11,2,1
9,393,393,6,6,0,1,0
16,398,398,18,18,0,1,0
6,499,499,25,1,24,3,2

11,104,104,14,11,3,2,1
17,153,153,12,2,10,2,1
20,172,172,17,5,12,4,3
21,187,187,14,14,0,1,0
9,190,190,17,12,5,2,1
15,208,208,21,11,10,2,1
12,225,225,8,8,0,1,0
1,233,233,18,6,12,2,1
0,235,235,34,17,17,2,1
19,248,248,5,2,3,2,1
22,250,250,3,3,0,1,0
16,286,286,109,51,58,3,2
2,289,289,3,3,0,1,0
4,291,291,51,37,14,3,2
8,307,307,7,7,0,1,0
13,358,358,5,1,4,2,1
6,360,360,15,15,0,1,0
23,364,364,122,77,45,4,3
18,380,380,17,5,12,3,2
7,392,392,20,10,10,2,1
14,408,408,17,17,0,1,0
5,421,421,93,58,35,2,1
10,463,463,27,5,22,2,1
3,488,488,87,87,0,1,0

22,124,124,1,1,0,1,0
19,130,130,22,22,0,1,0
0,135,135,7,7,0,1,0
18,143,143,24,3,21,2,1
1,153,153,1,1,0,1,0
4,182,182,13,13,0,1,0
2,184,184,5,5,0,1,0
25,190,190,8,8,0,1,0
12,229,229,13,13,0,1,0
9,243,243,12,12,0,1,0
8,248,248,16,4,12,2,1
6,255,255,8,2,6,3,2
10,258,258,49,49,0,1,0
3,297,297,11,11,0,1,0
17,325,325,15,3,12,3,2
21,357,357,33,33,0,1,0
14,361,361,79,67,12,4,3
7,365,365,83,83,0,1,0
11,371,371,14,14,0,1,0
23,379,379,63,1,62,3,2
5,406,406,51,51,0,1,0
26,418,418,30,4,26,2,1
24,430,430,81,73,8,3,2
16,457,457,21,12,9,4,3
20,474,474,1,1,0,1,0
13,475,475,3,3,0,1,0
15,485,485,107,107,0,1,0

15,177,177,8,8,0,1,0
5,187,187,43,43,0,1,0
11,206,206,46,18,28,2,1
22,237,237,35,12,23,2,1
21,239,239,28,2,26,3,2
10,244,244,48,8,40,2,1
18,245,245,101,20,81,4,3
1,246,246,3,3,0,1,0
3,254,254,3,3,0,1,0
16,264,264,85,85,0,1,0
9,268,268,16,16,0,1,0
2,278,278,1,1,0,1,0
6,302,302,4,4,0,1,0
8,379,379,116,45,71,4,3
12,384,384,2,2,0,1,0
13,393,393,4,1,3,2,1
0,400,400,28,28,0,1,0
17,403,403,12,2,10,3,2
23,403,403,43,16,27,4,3
19,438,438,7,7,0,1,0
20,474,474,2,2,0,1,0
14,475,475,3,3,0,1,0
4,475,475,16,13,3,2,1
7,493,493,20,14,6,3,2

14,100,100,11,11,0,1,0
3,109,109,13,3,10,3,2
21,110,110,5,2,3,2,1
16,122,122,11,11,0,1,0
15,141,141,11,11,0,1,0
0,160,160,8,8,0,1,0
8,180,180,2,2,0,1,0
17,200,200,40,40,0,1,0
10,210,210,12,12,0,1,0
5,212,212,15,2,13,2,1
13,221,221,15,15,0,1,0
7,240,240,6,1,5,2,1
9,251,251,28,13,15,4,3
1,318,318,179,137,42,4,3
6,318,318,43,43,0,1,0
11,332,332,163,51,112,4,3
12,385,385,20,20,0,1,0
4,406,406,39,39,0,1,0
19,419,419,5,1,4,2,1
2,472,472,9,9,0,1,0
20,474,474,7,7,0,1,0
18,485,485,4,4,0,1,0

29,113,113,23,23,0,1,0
27,115,115,4,1,3,2,1
1,131,131,2,2,0,1,0
20,142,142,22,22,0,1,0
18,146,146,35,35,0,1,0
9,151,151,15,15,0,1,0
13,152,152,3,3,0,1,0
25,152,152,4,4,0,1,0
28,169,169,9,3,6,2,1
6,185,185,17,14,3,2,1
24,207,207,3,3,0,1,0
14,214,214,2,2,0,1,0
26,223,223,1,1,0,1,0
22,234,234,30,1,29,4,3
17,261,261,13,3,10,3,2
12,296,296,21,21,0,1,0
7,298,298,5,5,0,1,0
2,313,313,9,9,0,1,0
21,330,330,7,7,0,1,0
19,337,337,4,4,0,1,0
3,373,373,38,38,0,1,0
4,383,383,24,24,0,1,0
16,388,388,17,9,8,2,1
0,388,388,31,10,21,4,3
15,395,395,26,26,0,1,0
23,405,405,138,138,0,1,0
10,409,409,25,25,0,1,0
11,442,442,52,42,10,2,1
5,473,473,16,16,0,1,0
8,491,491,114,73,41,3,2

15,104,104,15,15,0,1,0
26,107,107,3,3,0,1,0
14,109,109,1,1,0,1,0
9,124,124,3,3,0,1,0
0,152,152,64,46,18,2,1
22,160,160,15,15,0,1,0
13,174,174,7,7,0,1,0
17,214,214,14,5,9,2,1
11,229,229,22,22,0,1,0
16,230,230,73,73,0,1,0
20,248,248,27,5,22,2,1
7,265,265,3,3,0,1,0
6,266,266,5,2,3,2,1
4,332,332,18,1,17,2,1
12,343,343,32,11,21,4,3
23,344,344,30,3,27,2,1
5,345,345,1,1,0,1,0
21,353,353,40,22,18,3,2
24,353,353,8,2,6,2,1
18,384,384,17,3,14,2,1
3,389,389,28,8,20,2,1
1,397,397,61,49,12,4,3
8,412,412,18,6,12,3,2
19,424,424,51,4,47,2,1
25,426,426,35,17,18,4,3
10,453,453,23,9,14,3,2
2,455,455,53,11,42,4,3

18,111,111,26,20,6,2,1
3,122,122,30,22,8,2,1
17,123,123,4,1,3,2,1
10,125,125,11,8,3,2,1
8,126,126,6,6,0,1,0
0,135,135,7,7,0,1,0
9,156,156,15,1,14,3,2
15,171,171,44,44,0,1,0
19,180,180,4,4,0,1,0
14,182,182,30,9,21,2,1
4,193,193,10,1,9,4,3
7,205,205,28,28,0,1,0
6,236,236,39,1,38,2,1
12,238,238,23,4,19,2,1
11,281,281,9,9,0,1,0
22,288,288,49,6,43,3,2
13,300,300,1,1,0,1,0
26,311,311,9,3,6,2,1
25,325,325,28,20,8,3,2
2,325,325,1,1,0,1,0
24,374,374,46,8,38,2,1
1,395,395,7,1,6,2,1
20,411,411,3,3,0,1,0
21,439,439,10,5,5,2,1
23,463,463,102,102,0,1,0
5,481,481,2,2,0,1,0
16,485,485,11,2,9,2,1

11,144,144,14,14,0,1,0
12,159,159,3,3,0,1,0
3,192,192,2,2,0,1,0
13,204,204,10,10,0,1,0
16,207,207,7,1,6,3,2
2,223,223,50,46,4,2,1
15,243,243,68,68,0,1,0
7,345,345,17,5,12,4,3
8,380,380,44,44,0,1,0
0,380,380,10,10,0,1,0
10,408,408,44,22,22,3,2
1,447,447,59,59,0,1,0
9,456,456,2,2,0,1,0
6,459,459,129,129,0,1,0
5,469,469,72,51,21,2,1
4,472,472,381,381,0,1,0
14,478,478,14,4,10,2,1

14,101,101,7,7,0,1,0
13,104,104,2,2,0,1,0
29,120,120,1,1,0,1,0
5,133,133,9,6,3,2,1
7,142,142,4,4,0,1,0
15,164,164,1,1,0,1,0
25,177,177,21,21,0,1,0
2,188,188,6,6,0,1,0
30,198,198,24,24,0,1,0
23,199,199,6,6,0,1,0
21,231,231,18,18,0,1,0
26,245,245,26,26,0,1,0
19,248,248,28,28,0,1,0
24,267,267,25,11,14,3,2
10,284,284,29,2,27,4,3
1,311,311,14,14,0,1,0
22,312,312,33,10,23,3,2
12,313,313,18,2,16,2,1
16,315,315,78,50,28,2,1
28,359,359,34,34,0,1,0
9,363,363,26,26,0,1,0
11,374,374,2,2,0,1,0
8,386,386,25,12,13,2,1
3,400,400,15,15,0,1,0
18,439,439,58,58,0,1,0
27,453,453,63,19,44,3,2
4,456,456,24,24,0,1,0
0,467,467,10,10,0,1,0
17,470,470,4,4,0,1,0
6,481,481,64,64,0,1,0
20,499,499,107,107,0,1,0

3,122,122,18,18,0,1,0
8,132,132,15,12,3,2,1
1,142,142,20,9,11,3,2
11,187,187,5,5,0,1,0
13,197,197,32,6,26,3,2
18,207,207,23,23,0,1,0
0,220,220,56,56,0,1,0
9,298,298,1,1,0,1,0
12,324,324,40,15,25,4,3
22,325,325,41,6,35,4,3
16,332,332,64,64,0,1,0
21,337,337,17,17,0,1,0
14,338,338,9,9,0,1,0
20,341,341,88,61,27,4,3
10,357,357,29,7,22,2,1
7,370,370,30,8,22,3,2
2,370,370,11,11,0,1,0
6,371,371,83,83,0,1,0
15,377,377,21,7,14,2,1
4,391,391,29,29,0,1,0
19,442,442,27,27,0,1,0
5,450,450,12,6,6,3,2
17,458,458,7,1,6,3,2
23,466,466,19,5,14,2,1

7,122,122,9,9,0,1,0
6,134,134,1,1,0,1,0
23,140,140,2,2,0,1,0
9,152,152,1,1,0,1,0
0,178,178,20,20,0,1,0
18,178,178,36,36,0,1,0
25,183,183,11,1,10,3,2
21,189,189,28,28,0,1,0
4,221,221,15,15,0,1,0
3,249,249,18,18,0,1,0
22,303,303,5,5,0,1,0
2,317,317,13,13,0,1,0
13,336,336,126,126,0,1,0
11,338,338,27,5,22,2,1
8,344,344,10,10,0,1,0
16,359,359,10,10,0,1,0
15,382,382,34,34,0,1,0
24,395,395,85,21,64,4,3
1,396,396,7,7,0,1,0
10,400,400,4,4,0,1,0
14,421,421,23,15,8,3,2
19,422,422,13,13,0,1,0
5,465,465,142,53,89,4,3
17,467,467,79,79,0,1,0
20,496,496,96,55,41,2,1
12,498,498,1,1,0,1,0

6,106,106,30,30,0,1,0
18,108,108,15,2,13,2,1
3,115,115,18,9,9,2,1
22,115,115,14,4,10,3,2
9,127,127,1,1,0,1,0
16,163,163,60,60,0,1,0
2,216,216,16,1,15,2,1
20,229,229,19,19,0,1,0
1,245,245,38,8,30,4,3
11,282,282,26,26,0,1,0
21,301,301,10,10,0,1,0
15,347,347,27,27,0,1,0
13,357,357,67,67,0,1,0
7,367,367,17,17,0,1,0
0,386,386,8,5,3,2,1
12,392,392,6,6,0,1,0
4,421,421,59,59,0,1,0
8,422,422,40,31,9,4,3
10,444,444,10,10,0,1,0
14,461,461,6,1,5,2,1
17,480,480,15,15,0,1,0
5,482,482,96,96,0,1,0
19,490,490,29,29,0,1,0

1,105,105,1,1,0,1,0
5,149,149,1,1,0,1,0
24,159,159,1,1,0,1,0
23,168,168,1,1,0,1,0
19,179,179,18,18,0,1,0
12,186,186,28,25,3,2,1
26,187,187,25,25,0,1,0
29,198,198,52,12,40,4,3
22,229,229,31,31,0,1,0
15,247,247,32,8,24,4,3
9,251,251,20,20,0,1,0
6,258,258,10,5,5,2,1
30,268,268,2,2,0,1,0
17,270,270,12,12,0,1,0
3,276,276,25,19,6,3,2
18,278,278,43,13,30,2,1
2,287,287,23,11,12,3,2
8,304,304,47,47,0,1,0
4,308,308,5,5,0,1,0
25,318,318,41,41,0,1,0
11,353,353,35,11,24,4,3
13,366,366,5,5,0,1,0
28,367,367,6,3,3,2,1
21,387,387,84,15,69,3,2
7,430,430,6,3,3,2,1
20,456,456,63,23,40,2,1
14,458,458,1,1,0,1,0
27,468,468,33,33,0,1,0
10,477,477,2,2,0,1,0
16,478,478,49,12,37,2,1
0,487,487,6,6,0,1,0

9,125,125,7,7,0,1,0
0,141,141,51,7,44,2,1
11,206,206,3,3,0,1,0
7,227,227,25,15,10,3,2
8,257,257,14,4,10,3,2
3,287,287,24,9,15,4,3
15,290,290,43,1,42,3,2
20,297,297,108,43,65,4,3
6,316,316,10,10,0,1,0
16,376,376,6,6,0,1,0
5,385,385,49,49,0,1,0
17,391,391,11,11,0,1,0
4,395,395,94,54,40,4,3
13,398,398,44,4,40,2,1
2,403,403,61,61,0,1,0
1,405,405,17,17,0,1,0
12,405,405,3,3,0,1,0
19,408,408,2,2,0,1,0
18,422,422,42,4,38,2,1
14,472,472,88,12,76,3,2
10,499,499,90,14,76,4,3

21,157,157,17,17,0,1,0
7,158,158,26,12,14,3,2
14,165,165,12,3,9,2,1
26,185,185,19,10,9,2,1
24,189,189,3,3,0,1,0
11,199,199,19,19,0,1,0
25,206,206,15,10,5,2,1
13,211,211,2,2,0,1,0
12,235,235,36,36,0,1,0
15,261,261,2,2,0,1,0
23,300,300,33,2,31,2,1
5,322,322,7,2,5,2,1
18,324,324,70,70,0,1,0
22,334,334,100,100,0,1,0
0,339,339,36,36,0,1,0
8,343,343,2,2,0,1,0
2,358,358,94,72,22,2,1
4,364,364,15,1,14,2,1
16,365,365,31,31,0,1,0
20,367,367,43,2,41,2,1
6,380,380,19,3,16,4,3
19,396,396,23,2,21,4,3
9,414,414,53,53,0,1,0
1,437,437,10,10,0,1,0
27,440,440,6,1,5,2,1
10,441,441,8,2,6,2,1
17,444,444,13,9,4,2,1
3,489,489,21,21,0,1,0

5,102,102,1,1,0,1,0
3,113,113,6,6,0,1,0
1,130,130,7,7,0,1,0
15,146,146,26,26,0,1,0
17,151,151,28,18,10,3,2
8,156,156,7,2,5,2,1
10,173,173,16,16,0,1,0
14,177,177,5,5,0,1,0
18,178,178,1,1,0,1,0
29,187,187,31,19,12,4,3
9,194,194,1,1,0,1,0
27,207,207,8,2,6,2,1
6,208,208,2,2,0,1,0
28,228,228,13,13,0,1,0
31,228,228,66,22,44,3,2
23,231,231,20,20,0,1,0
30,234,234,45,24,21,4,3
12,240,240,3,3,0,1,0
4,253,253,7,7,0,1,0
26,260,260,28,28,0,1,0
20,267,267,1,1,0,1,0
16,280,280,3,3,0,1,0
24,281,281,19,5,14,2,1
0,306,306,46,31,15,2,1
2,402,402,39,39,0,1,0
21,409,409,27,27,0,1,0
32,418,418,21,21,0,1,0
25,423,423,17,3,14,2,1
22,449,449,26,4,22,2,1
13,453,453,7,1,6,2,1
19,464,464,42,14,28,3,2
7,468,468,30,30,0,1,0
11,477,477,30,27,3,2,1

0,107,107,9,6,3,2,1
16,118,118,14,14,0,1,0
22,130,130,1,1,0,1,0
7,146,146,3,3,0,1,0
15,168,168,7,7,0,1,0
18,176,176,16,16,0,1,0
4,188,188,1,1,0,1,0
13,214,214,38,26,12,2,1
8,221,221,1,1,0,1,0
14,223,223,8,8,0,1,0
21,225,225,24,24,0,1,0
11,255,255,57,44,13,2,1
6,259,259,5,1,4,2,1
2,272,272,4,4,0,1,0
1,284,284,1,1,0,1,0
12,310,310,25,25,0,1,0
10,325,325,1,1,0,1,0
19,361,361,33,9,24,4,3
23,388,388,65,57,8,2,1
17,397,397,73,46,27,4,3
24,400,400,46,46,0,1,0
5,406,406,161,33,128,4,3
9,410,410,34,34,0,1,0
3,428,428,112,112,0,1,0
20,477,477,41,8,33,4,3

11,107,107,3,3,0,1,0
22,122,122,42,42,0,1,0
7,173,173,3,3,0,1,0
28,213,213,4,4,0,1,0
17,232,232,22,8,14,2,1
6,237,237,28,6,22,2,1
25,241,241,56,10,46,3,2
19,263,263,3,3,0,1,0
26,282,282,3,3,0,1,0
1,282,282,1,1,0,1,0
14,295,295,13,3,10,2,1
23,299,299,10,1,9,2,1
3,302,302,16,8,8,3,2
0,322,322,22,22,0,1,0
16,336,336,31,31,0,1,0
4,339,339,17,10,7,2,1
15,353,353,69,65,4,2,1
24,365,365,5,5,0,1,0
2,366,366,27,27,0,1,0
18,368,368,52,52,0,1,0
9,425,425,108,24,84,3,2
5,431,431,10,10,0,1,0
10,449,449,34,16,18,2,1
8,453,453,9,9,0,1,0
13,454,454,15,4,11,2,1
27,454,454,81,41,40,3,2
12,455,455,23,23,0,1,0
20,480,480,54,54,0,1,0
21,500,500,14,4,10,3,2

5,110,110,3,3,0,1,0
22,119,119,3,3,0,1,0
12,129,129,1,1,0,1,0
6,157,157,18,13,5,2,1
14,167,167,10,10,0,1,0
16,167,167,2,2,0,1,0
17,181,181,11,1,10,3,2
21,184,184,18,9,9,3,2
25,190,190,25,1,24,3,2
18,206,206,47,47,0,1,0
0,235,235,4,4,0,1,0
8,243,243,128,128,0,1,0
26,245,245,11,11,0,1,0
15,256,256,33,12,21,4,3
13,259,259,3,3,0,1,0
3,293,293,3,3,0,1,0
4,294,294,6,6,0,1,0
23,304,304,61,61,0,1,0
2,320,320,24,15,9,2,1
9,349,349,30,25,5,2,1
10,369,369,27,6,21,4,3
20,372,372,6,3,3,2,1
7,388,388,7,7,0,1,0
24,418,418,34,20,14,3,2
11,443,443,60,60,0,1,0
1,472,472,8,8,0,1,0
19,480,480,92,23,69,4,3

18,103,103,5,5,0,1,0
22,143,143,11,5,6,2,1
3,148,148,3,3,0,1,0
8,158,158,10,10,0,1,0
6,160,160,8,5,3,2,1
20,217,217,2,2,0,1,0
15,230,230,10,1,9,4,3
0,233,233,17,17,0,1,0
11,248,248,6,3,3,2,1
7,287,287,17,17,0,1,0
4,293,293,98,58,40,3,2
10,333,333,7,7,0,1,0
9,354,354,94,94,0,1,0
21,365,365,21,21,0,1,0
13,369,369,49,49,0,1,0
14,378,378,227,227,0,1,0
2,379,379,62,62,0,1,0
5,459,459,56,53,3,2,1
1,464,464,14,6,8,2,1
17,465,465,5,1,4,2,1
16,468,468,20,7,13,2,1
19,468,468,10,10,0,1,0
12,498,498,77,18,59,4,3

11,141,141,15,3,12,2,1
15,148,148,2,2,0,1,0
1,154,154,2,2,0,1,0
12,182,182,7,4,3,2,1
10,207,207,2,2,0,1,0
6,221,221,70,34,36,4,3
0,294,294,53,53,0,1,0
9,369,369,13,13,0,1,0
5,393,393,93,93,0,1,0
7,429,429,90,60,30,3,2
8,431,431,40,40,0,1,0
2,434,434,206,116,90,3,2
14,438,438,21,21,0,1,0
4,485,485,13,13,0,1,0
13,492,492,44,44,0,1,0
3,496,496,264,184,80,4,3

29,116,116,5,5,0,1,0
3,124,124,1,1,0,1,0
6,129,129,2,2,0,1,0
18,146,146,1,1,0,1,0
24,154,154,14,6,8,3,2
5,160,160,9,9,0,1,0
25,162,162,5,5,0,1,0
20,186,186,10,10,0,1,0
28,209,209,2,2,0,1,0
21,214,214,39,30,9,4,3
1,221,221,25,25,0,1,0
2,223,223,43,33,10,2,1
7,228,228,11,2,9,2,1
14,248,248,4,4,0,1,0
23,260,260,44,44,0,1,0
17,272,272,46,33,13,2,1
9,274,274,32,4,28,2,1
15,275,275,6,6,0,1,0
4,289,289,19,10,9,4,3
10,298,298,1,1,0,1,0
31,311,311,56,56,0,1,0
32,354,354,33,33,0,1,0
19,354,354,4,1,3,2,1
12,366,366,16,1,15,4,3
30,370,370,30,30,0,1,0
27,373,373,59,23,36,2,1
16,377,377,2,2,0,1,0
26,428,428,77,53,24,2,1
22,449,449,2,2,0,1,0
0,454,454,22,22,0,1,0
13,456,456,52,52,0,1,0
11,456,456,31,31,0,1,0
8,490,490,13,13,0,1,0

13,110,110,10,10,0,1,0
7,113,113,1,1,0,1,0
8,131,131,7,4,3,2,1
1,138,138,16,16,0,1,0
15,145,145,35,32,3,2,1
14,184,184,1,1,0,1,0
16,205,205,6,6,0,1,0
24,207,207,58,58,0,1,0
18,208,208,32,32,0,1,0
25,219,219,13,13,0,1,0
22,229,229,41,21,20,3,2
4,230,230,12,7,5,2,1
21,233,233,4,1,3,2,1
17,252,252,9,3,6,2,1
12,252,252,17,17,0,1,0
11,303,303,3,3,0,1,0
10,319,319,16,7,9,2,1
3,325,325,51,51,0,1,0
23,328,328,3,3,0,1,0
20,353,353,3,3,0,1,0
5,364,364,7,7,0,1,0
9,376,376,1,1,0,1,0
6,434,434,13,13,0,1,0
27,456,456,45,15,30,2,1
0,468,468,134,99,35,2,1
19,481,481,65,55,10,4,3
2,492,492,5,2,3,2,1
26,495,495,104,88,16,2,1

15,113,113,4,4,0,1,0
1,116,116,27,18,9,2,1
23,124,124,13,13,0,1,0
3,143,143,2,2,0,1,0
19,146,146,6,6,0,1,0
12,147,147,45,13,32,2,1
9,160,160,40,1,39,2,1
20,238,238,39,5,34,2,1
21,249,249,11,11,0,1,0
11,263,263,4,4,0,1,0
18,271,271,2,2,0,1,0
17,277,277,43,33,10,2,1
7,306,306,15,15,0,1,0
4,316,316,14,14,0,1,0
5,344,344,59,59,0,1,0
8,346,346,20,20,0,1,0
10,354,354,10,10,0,1,0
6,381,381,30,6,24,2,1
22,401,401,84,27,57,4,3
2,437,437,40,21,19,2,1
13,441,441,14,14,0,1,0
0,472,472,80,80,0,1,0
14,481,481,14,5,9,2,1
16,491,491,53,53,0,1,0

14,109,109,15,15,0,1,0
8,114,114,5,5,0,1,0
13,120,120,1,1,0,1,0
9,123,123,17,17,0,1,0
22,125,125,15,10,5,2,1
25,136,136,17,17,0,1,0
11,144,144,17,17,0,1,0
19,159,159,3,3,0,1,0
7,168,168,1,1,0,1,0
12,206,206,41,20,21,4,3
16,208,208,16,16,0,1,0
26,227,227,16,16,0,1,0
5,266,266,7,7,0,1,0
2,267,267,16,8,8,2,1
27,281,281,41,41,0,1,0
0,305,305,5,1,4,2,1
3,368,368,24,24,0,1,0
10,394,394,39,24,15,4,3
21,404,404,3,3,0,1,0
17,426,426,32,8,24,3,2
1,426,426,81,12,69,4,3
18,441,441,22,22,0,1,0
23,452,452,42,42,0,1,0
15,464,464,35,35,0,1,0
4,476,476,6,6,0,1,0
20,478,478,84,84,0,1,0
24,488,488,129,129,0,1,0
6,489,489,2,2,0,1,0

19,119,119,9,9,0,1,0
16,178,178,16,8,8,2,1
2,203,203,34,34,0,1,0
25,204,204,27,4,23,2,1
8,235,235,11,11,0,1,0
21,237,237,16,16,0,1,0
0,270,270,24,24,0,1,0
3,286,286,13,1,12,4,3
24,301,301,33,15,18,2,1
6,345,345,13,8,5,2,1
9,348,348,15,3,12,4,3
20,352,352,21,21,0,1,0
7,362,362,34,34,0,1,0
17,364,364,120,120,0,1,0
11,400,400,6,3,3,2,1
13,404,404,97,76,21,4,3
12,404,404,19,19,0,1,0
10,413,413,72,46,26,3,2
5,425,425,52,28,24,4,3
22,444,444,16,16,0,1,0
15,465,465,17,2,15,2,1
4,470,470,9,9,0,1,0
1,489,489,29,29,0,1,0
23,489,489,58,37,21,4,3
14,491,491,62,51,11,2,1
18,500,500,21,5,16,2,1

26,105,105,8,2,6,2,1
12,131,131,29,29,0,1,0
22,137,137,54,18,36,4,3
21,148,148,1,1,0,1,0
20,157,157,9,3,6,3,2
14,166,166,7,2,5,2,1
2,169,169,12,8,4,2,1
7,171,171,9,9,0,1,0
28,177,177,42,24,18,3,2
11,203,203,2,2,0,1,0
4,215,215,4,4,0,1,0
1,231,231,9,5,4,2,1
17,240,240,7,7,0,1,0
19,255,255,12,5,7,2,1
3,263,263,8,8,0,1,0
10,267,267,26,6,20,3,2
13,277,277,17,17,0,1,0
0,299,299,3,3,0,1,0
18,321,321,21,14,7,2,1
9,330,330,43,11,32,2,1
6,362,362,2,2,0,1,0
5,374,374,95,13,82,4,3
25,404,404,40,40,0,1,0
24,407,407,40,13,27,2,1
8,449,449,57,57,0,1,0
16,460,460,3,3,0,1,0
23,478,478,42,42,0,1,0
27,480,480,13,10,3,2,1
15,497,497,12,12,0,1,0

10,113,113,20,5,15,2,1
16,116,116,21,7,14,3,2
18,128,128,29,29,0,1,0
14,135,135,7,7,0,1,0
5,137,137,1,1,0,1,0
6,155,155,51,51,0,1,0
17,180,180,10,5,5,2,1
11,225,225,15,1,14,4,3
0,245,245,25,16,9,2,1
9,302,302,11,11,0,1,0
4,304,304,24,24,0,1,0
1,351,351,76,40,36,4,3
15,355,355,37,31,6,3,2
12,357,357,24,24,0,1,0
8,371,371,25,20,5,2,1
13,394,394,69,23,46,3,2
3,424,424,165,165,0,1,0
2,441,441,34,34,0,1,0
7,475,475,12,12,0,1,0

11,112,112,4,4,0,1,0
14,124,124,3,3,0,1,0
17,144,144,10,10,0,1,0
13,153,153,8,8,0,1,0
5,155,155,5,5,0,1,0
22,192,192,1,1,0,1,0
1,194,194,29,29,0,1,0
6,225,225,26,26,0,1,0
24,228,228,20,11,9,4,3
12,234,234,1,1,0,1,0
4,245,245,4,4,0,1,0
3,248,248,100,65,35,2,1
10,280,280,16,16,0,1,0
9,294,294,41,23,18,3,2
16,323,323,4,4,0,1,0
2,338,338,16,4,12,4,3
0,339,339,24,6,18,2,1
21,347,347,27,15,12,4,3
18,349,349,32,6,26,2,1
23,357,357,25,7,18,3,2
19,359,359,18,11,7,2,1
7,385,385,23,23,0,1,0
25,393,393,223,204,19,2,1
20,399,399,21,21,0,1,0
15,449,449,49,49,0,1,0
8,474,474,8,5,3,2,1

13,110,110,3,3,0,1,0
24,110,110,8,4,4,2,1
19,127,127,7,3,4,2,1
0,131,131,3,3,0,1,0
11,135,135,40,35,5,2,1
5,148,148,11,11,0,1,0
20,152,152,9,3,6,2,1
21,163,163,2,2,0,1,0
8,181,181,3,3,0,1,0
6,195,195,16,16,0,1,0
23,198,198,67,67,0,1,0
9,240,240,57,57,0,1,0
22,241,241,10,10,0,1,0
1,246,246,6,6,0,1,0
4,270,270,1,1,0,1,0
18,272,272,15,3,12,3,2
16,275,275,51,51,0,1,0
25,278,278,1,1,0,1,0
3,308,308,23,17,6,3,2
7,354,354,4,4,0,1,0
17,386,386,22,2,20,3,2
15,412,412,30,20,10,3,2
2,453,453,26,26,0,1,0
12,454,454,57,35,22,3,2
10,467,467,69,60,9,2,1
14,470,470,130,130,0,1,0

23,100,100,20,13,7,2,1
0,100,100,1,1,0,1,0
13,107,107,6,6,0,1,0
15,118,118,1,1,0,1,0
4,133,133,1,1,0,1,0
16,146,146,24,8,16,3,2
17,184,184,48,31,17,2,1
19,235,235,28,28,0,1,0
22,238,238,8,8,0,1,0
21,294,294,14,14,0,1,0
11,296,296,5,5,0,1,0
7,303,303,23,23,0,1,0
6,326,326,37,3,34,2,1
9,334,334,93,93,0,1,0
8,334,334,78,30,48,4,3
12,349,349,5,5,0,1,0
18,349,349,17,17,0,1,0
14,393,393,30,6,24,2,1
3,394,394,9,9,0,1,0
5,396,396,16,12,4,2,1
2,403,403,142,100,42,3,2
1,406,406,9,5,4,2,1
10,433,433,12,12,0,1,0
20,495,495,98,62,36,4,3

4,113,113,12,6,6,3,2
8,114,114,7,7,0,1,0
2,152,152,28,1,27,4,3
3,157,157,15,15,0,1,0
20,166,166,24,24,0,1,0
0,169,169,25,25,0,1,0
5,170,170,15,1,14,3,2
17,174,174,22,11,11,4,3
11,189,189,10,4,6,3,2
14,196,196,1,1,0,1,0
22,220,220,12,12,0,1,0
10,235,235,6,3,3,2,1
7,276,276,3,3,0,1,0
1,282,282,7,7,0,1,0
12,286,286,30,30,0,1,0
13,333,333,38,38,0,1,0
15,334,334,43,27,16,3,2
18,334,334,35,35,0,1,0
6,376,376,120,63,57,4,3
19,432,432,95,95,0,1,0
16,438,438,7,7,0,1,0
9,439,439,60,16,44,2,1
21,454,454,69,33,36,3,2

11,103,103,37,9,28,3,2
2,139,139,9,9,0,1,0
10,164,164,9,4,5,2,1
18,171,171,7,4,3,2,1
4,178,178,56,56,0,1,0
16,191,191,39,39,0,1,0
13,212,212,11,3,8,3,2
0,234,234,95,5,90,4,3
8,239,239,12,12,0,1,0
7,248,248,18,9,9,4,3
17,251,251,2,2,0,1,0
6,296,296,19,19,0,1,0
1,303,303,16,10,6,3,2
21,313,313,40,2,38,4,3
14,326,326,45,15,30,3,2
5,343,343,44,22,22,2,1
12,345,345,22,6,16,2,1
15,380,380,1,1,0,1,0
20,410,410,22,13,9,4,3
19,439,439,53,53,0,1,0
9,477,477,18,18,0,1,0
3,488,488,5,5,0,1,0

4,106,106,4,4,0,1,0
9,113,113,23,23,0,1,0
8,125,125,4,4,0,1,0
13,127,127,18,12,6,2,1
6,173,173,1,1,0,1,0
1,183,183,3,3,0,1,0
12,190,190,19,3,16,3,2
20,203,203,8,1,7,2,1
14,210,210,35,35,0,1,0
11,212,212,14,14,0,1,0
21,250,250,26,18,8,3,2
17,301,301,57,23,34,4,3
2,304,304,8,8,0,1,0
19,311,311,12,4,8,3,2
0,321,321,46,46,0,1,0
5,328,328,33,24,9,2,1
23,330,330,3,3,0,1,0
16,369,369,96,91,5,2,1
18,393,393,49,49,0,1,0
10,396,396,56,35,21,2,1
24,423,423,12,4,8,3,2
22,438,438,5,5,0,1,0
7,458,458,9,9,0,1,0
3,460,460,77,77,0,1,0
25,489,489,110,28,82,3,2
15,493,493,13,13,0,1,0

20,101,101,5,5,0,1,0
7,101,101,4,4,0,1,0
13,103,103,4,4,0,1,0
4,112,112,17,1,16,3,2
19,123,123,7,4,3,2,1
9,129,129,9,9,0,1,0
25,157,157,39,39,0,1,0
3,158,158,7,1,6,2,1
16,165,165,22,22,0,1,0
17,186,186,13,7,6,3,2
6,191,191,24,6,18,2,1
0,216,216,32,24,8,3,2
8,267,267,75,39,36,2,1
11,270,270,12,7,5,2,1
24,304,304,92,44,48,4,3
21,331,331,14,14,0,1,0
10,336,336,2,2,0,1,0
15,371,371,37,18,19,2,1
23,375,375,6,2,4,2,1
18,419,419,20,20,0,1,0
1,420,420,33,18,15,2,1
12,434,434,7,7,0,1,0
5,468,468,75,75,0,1,0
14,475,475,43,12,31,2,1
22,480,480,35,1,34,4,3
2,498,498,1,1,0,1,0

7,110,110,10,10,0,1,0
9,118,118,3,3,0,1,0
5,129,129,1,1,0,1,0
13,142,142,9,9,0,1,0
4,142,142,1,1,0,1,0
11,143,143,8,8,0,1,0
12,152,152,4,4,0,1,0
25,154,154,9,3,6,2,1
8,171,171,5,5,0,1,0
27,185,185,5,5,0,1,0
31,209,209,11,3,8,2,1
22,210,210,12,12,0,1,0
14,217,217,21,21,0,1,0
1,232,232,7,7,0,1,0
2,243,243,12,4,8,3,2
16,249,249,17,17,0,1,0
6,278,278,1,1,0,1,0
28,279,279,44,44,0,1,0
30,327,327,33,33,0,1,0
3,367,367,43,1,42,4,3
18,371,371,95,95,0,1,0
0,373,373,19,19,0,1,0
23,388,388,92,92,0,1,0
20,394,394,19,19,0,1,0
21,399,399,33,33,0,1,0
15,399,399,9,9,0,1,0
24,400,400,58,40,18,4,3
17,443,443,58,39,19,2,1
19,451,451,25,15,10,2,1
10,456,456,6,3,3,2,1
29,472,472,98,84,14,3,2
26,498,498,24,24,0,1,0

15,101,101,30,30,0,1,0
5,157,157,5,5,0,1,0
8,181,181,14,10,4,2,1
20,189,189,6,2,4,2,1
13,192,192,42,2,40,3,2
16,214,214,19,19,0,1,0
7,222,222,18,18,0,1,0
14,222,222,15,15,0,1,0
9,229,229,24,6,18,2,1
6,240,240,9,9,0,1,0
11,259,259,35,35,0,1,0
12,286,286,4,4,0,1,0
3,295,295,29,6,23,2,1
17,312,312,6,6,0,1,0
18,313,313,18,4,14,2,1
2,338,338,59,59,0,1,0
4,412,412,84,72,12,4,3
0,437,437,188,149,39,4,3
10,455,455,63,43,20,2,1
19,473,473,26,5,21,2,1
1,500,500,33,3,30,2,1

13,105,105,1,1,0,1,0
12,108,108,1,1,0,1,0
5,114,114,12,12,0,1,0
8,115,115,3,3,0,1,0
14,166,166,9,9,0,1,0
17,200,200,41,41,0,1,0
2,234,234,1,1,0,1,0
3,242,242,85,52,33,2,1
4,249,249,1,1,0,1,0
16,254,254,31,31,0,1,0
9,269,269,49,27,22,2,1
22,308,308,13,13,0,1,0
7,310,310,2,2,0,1,0
18,329,329,48,48,0,1,0
11,398,398,1,1,0,1,0
21,404,404,2,2,0,1,0
15,413,413,85,85,0,1,0
6,436,436,10,10,0,1,0
20,437,437,129,120,9,4,3
19,463,463,62,62,0,1,0
1,469,469,80,80,0,1,0
0,480,480,86,6,80,4,3
10,483,483,72,72,0,1,0

29,100,100,3,3,0,1,0
25,123,123,3,3,0,1,0
23,128,128,1,1,0,1,0
31,137,137,12,2,10,3,2
6,155,155,1,1,0,1,0
15,174,174,2,2,0,1,0
1,187,187,4,1,3,2,1
22,188,188,2,2,0,1,0
7,190,190,2,2,0,1,0
9,198,198,2,2,0,1,0
10,214,214,1,1,0,1,0
17,222,222,5,2,3,2,1
2,245,245,16,2,14,2,1
34,255,255,40,40,0,1,0
33,267,267,90,90,0,1,0
14,282,282,20,2,18,3,2
0,284,284,1,1,0,1,0
27,288,288,5,5,0,1,0
16,293,293,64,64,0,1,0
3,316,316,13,13,0,1,0
30,331,331,33,33,0,1,0
5,341,341,58,58,0,1,0
8,342,342,24,24,0,1,0
28,344,344,74,74,0,1,0
11,362,362,9,3,6,2,1
18,366,366,37,3,34,3,2
13,391,391,29,11,18,3,2
19,408,408,3,3,0,1,0
12,433,433,28,14,14,3,2
26,452,452,43,43,0,1,0
4,483,483,1,1,0,1,0
32,487,487,44,35,9,4,3
20,491,491,64,64,0,1,0
21,493,493,29,29,0,1,0
24,496,496,36,36,0,1,0

30,133,133,1,1,0,1,0
14,156,156,3,3,0,1,0
17,160,160,5,5,0,1,0
20,186,186,35,35,0,1,0
19,212,212,25,10,15,2,1
23,213,213,5,5,0,1,0
21,236,236,13,4,9,2,1
4,242,242,14,5,9,2,1
29,249,249,4,4,0,1,0
18,265,265,1,1,0,1,0
22,270,270,58,12,46,2,1
0,272,272,12,12,0,1,0
28,288,288,23,23,0,1,0
5,293,293,14,14,0,1,0
6,322,322,4,1,3,2,1
8,327,327,1,1,0,1,0
1,357,357,17,10,7,2,1
26,370,370,10,4,6,2,1
16,377,377,10,10,0,1,0
15,377,377,23,11,12,3,2
27,380,380,31,7,24,3,2
25,389,389,32,32,0,1,0
13,401,401,5,5,0,1,0
12,401,401,45,45,0,1,0
24,431,431,23,23,0,1,0
11,445,445,7,7,0,1,0
10,452,452,2,2,0,1,0
2,459,459,14,8,6,2,1
31,465,465,183,141,42,4,3
9,471,471,86,86,0,1,0
3,476,476,151,95,56,4,3
7,491,491,27,15,12,3,2

14,112,112,43,17,26,3,2
12,131,131,7,7,0,1,0
2,135,135,6,6,0,1,0
13,160,160,1,1,0,1,0
20,174,174,16,16,0,1,0
8,184,184,27,20,7,2,1
9,189,189,5,5,0,1,0
16,325,325,38,31,7,2,1
6,327,327,1,1,0,1,0
3,329,329,8,8,0,1,0
19,373,373,11,5,6,2,1
23,399,399,40,40,0,1,0
15,399,399,27,17,10,2,1
7,400,400,9,9,0,1,0
5,408,408,24,12,12,2,1
22,415,415,19,19,0,1,0
1,415,415,145,93,52,4,3
11,427,427,117,117,0,1,0
10,428,428,97,4,93,4,3
4,433,433,10,10,0,1,0
18,440,440,115,85,30,3,2
21,451,451,11,11,0,1,0
0,471,471,1,1,0,1,0
17,478,478,18,14,4,2,1

5,101,101,1,1,0,1,0
14,106,106,29,29,0,1,0
2,108,108,5,5,0,1,0
1,114,114,7,7,0,1,0
15,120,120,10,2,8,2,1
21,132,132,9,4,5,2,1
10,139,139,11,11,0,1,0
23,141,141,1,1,0,1,0
16,157,157,42,17,25,2,1
25,164,164,19,19,0,1,0
11,170,170,11,5,6,2,1
22,213,213,12,12,0,1,0
24,229,229,21,21,0,1,0
17,229,229,24,4,20,2,1
7,251,251,5,5,0,1,0
19,295,295,29,1,28,4,3
26,298,298,27,27,0,1,0
4,309,309,19,16,3,2,1
18,312,312,78,78,0,1,0
3,328,328,4,4,0,1,0
6,341,341,68,68,0,1,0
8,345,345,8,8,0,1,0
12,350,350,45,42,3,2,1
9,350,350,39,1,38,3,2
27,379,379,26,26,0,1,0
20,390,390,4,4,0,1,0
13,457,457,6,6,0,1,0
0,491,491,7,7,0,1,0

11,107,107,17,17,0,1,0
15,112,112,2,2,0,1,0
22,114,114,9,9,0,1,0
23,119,119,5,5,0,1,0
12,148,148,11,11,0,1,0
10,195,195,6,6,0,1,0
6,209,209,21,21,0,1,0
24,301,301,31,31,0,1,0
2,303,303,23,23,0,1,0
1,315,315,9,2,7,2,1
13,316,316,9,4,5,2,1
18,326,326,96,96,0,1,0
8,335,335,27,27,0,1,0
17,344,344,8,8,0,1,0
19,354,354,8,8,0,1,0
7,360,360,4,4,0,1,0
25,366,366,34,34,0,1,0
5,374,374,88,72,16,3,2
21,386,386,54,54,0,1,0
4,392,392,2,2,0,1,0
14,403,403,88,60,28,3,2
9,415,415,19,19,0,1,0
16,431,431,66,66,0,1,0
20,439,439,18,4,14,2,1
0,464,464,6,3,3,2,1
3,466,466,146,110,36,4,3

25,107,107,25,20,5,2,1
24,124,124,1,1,0,1,0
22,142,142,1,1,0,1,0
12,155,155,5,5,0,1,0
16,173,173,16,12,4,2,1
5,225,225,42,42,0,1,0
8,247,247,1,1,0,1,0
2,255,255,17,17,0,1,0
13,255,255,68,1,67,3,2
7,263,263,50,35,15,2,1
4,269,269,1,1,0,1,0
6,303,303,45,29,16,2,1
0,313,313,2,2,0,1,0
17,315,315,73,45,28,3,2
23,336,336,55,55,0,1,0
19,339,339,4,4,0,1,0
11,373,373,35,35,0,1,0
18,390,390,1,1,0,1,0
9,405,405,45,45,0,1,0
21,423,423,105,24,81,4,3
1,452,452,20,2,18,3,2
10,462,462,14,14,0,1,0
3,464,464,8,8,0,1,0
15,465,465,6,6,0,1,0
14,499,499,98,89,9,4,3
20,499,499,11,3,8,2,1

17,108,108,28,19,9,4,3
7,126,126,38,18,20,2,1
16,128,128,19,19,0,1,0
13,130,130,21,21,0,1,0
9,142,142,3,3,0,1,0
5,155,155,20,20,0,1,0
12,155,155,1,1,0,1,0
18,192,192,20,20,0,1,0
15,199,199,17,17,0,1,0
14,203,203,4,4,0,1,0
21,204,204,4,4,0,1,0
20,213,213,21,21,0,1,0
4,216,216,52,26,26,2,1
1,251,251,10,10,0,1,0
0,318,318,15,15,0,1,0
6,353,353,73,8,65,4,3
2,361,361,8,2,6,2,1
11,411,411,16,16,0,1,0
10,413,413,52,52,0,1,0
8,431,431,7,7,0,1,0
19,448,448,73,47,26,4,3
3,480,480,86,20,66,4,3

5,100,100,2,2,0,1,0
15,162,162,11,1,10,2,1
19,183,183,23,23,0,1,0
4,200,200,62,30,32,2,1
7,229,229,13,13,0,1,0
17,240,240,59,20,39,2,1
2,247,247,8,8,0,1,0
9,251,251,15,15,0,1,0
14,283,283,13,3,10,3,2
21,285,285,36,36,0,1,0
1,296,296,56,56,0,1,0
3,316,316,5,5,0,1,0
8,334,334,123,69,54,4,3
20,365,365,41,25,16,2,1
0,375,375,20,20,0,1,0
11,386,386,56,22,34,4,3
18,391,391,15,15,0,1,0
10,413,413,21,21,0,1,0
13,429,429,67,67,0,1,0
12,432,432,37,24,13,2,1
16,465,465,8,8,0,1,0
6,484,484,47,21,26,2,1

12,108,108,2,2,0,1,0
2,147,147,36,21,15,2,1
5,155,155,2,2,0,1,0
18,180,180,10,10,0,1,0
14,202,202,39,9,30,4,3
8,224,224,1,1,0,1,0
16,244,244,6,2,4,2,1
10,255,255,22,7,15,4,3
9,257,257,14,14,0,1,0
4,258,258,92,12,80,3,2
15,279,279,127,87,40,3,2
1,360,360,43,43,0,1,0
21,373,373,3,3,0,1,0
13,375,375,24,18,6,3,2
19,392,392,51,51,0,1,0
0,392,392,1,1,0,1,0
6,435,435,98,98,0,1,0
7,452,452,11,11,0,1,0
3,454,454,33,22,11,4,3
11,458,458,40,40,0,1,0
17,472,472,16,16,0,1,0
20,479,479,7,7,0,1,0
22,499,499,68,14,54,4,3

19,100,100,5,5,0,1,0
4,104,104,7,7,0,1,0
12,124,124,19,10,9,4,3
5,170,170,10,10,0,1,0
0,173,173,17,17,0,1,0
22,178,178,33,33,0,1,0
15,189,189,12,7,5,2,1
11,195,195,70,70,0,1,0
18,210,210,22,1,21,4,3
2,211,211,26,21,5,2,1
9,221,221,4,1,3,2,1
20,230,230,13,13,0,1,0
7,314,314,6,6,0,1,0
14,356,356,101,101,0,1,0
13,376,376,12,9,3,2,1
10,379,379,10,10,0,1,0
8,402,402,25,25,0,1,0
17,413,413,46,28,18,4,3
1,428,428,54,54,0,1,0
21,428,428,7,2,5,2,1
23,438,438,41,8,33,3,2
6,445,445,30,6,24,2,1
16,450,450,35,3,32,4,3
3,496,496,87,19,68,4,3

12,105,105,1,1,0,1,0
6,110,110,27,27,0,1,0
20,110,110,18,13,5,2,1
21,124,124,18,8,10,2,1
0,193,193,6,6,0,1,0
5,200,200,37,37,0,1,0
2,206,206,18,12,6,2,1
18,226,226,2,2,0,1,0
11,227,227,60,15,45,4,3
13,240,240,8,4,4,2,1
16,260,260,31,21,10,3,2
7,299,299,27,27,0,1,0
3,302,302,88,88,0,1,0
10,331,331,45,34,11,2,1
17,394,394,9,9,0,1,0
1,413,413,46,46,0,1,0
4,425,425,53,53,0,1,0
8,428,428,11,11,0,1,0
19,442,442,64,40,24,3,2
15,444,444,56,24,32,3,2
9,474,474,4,4,0,1,0
14,482,482,27,27,0,1,0

1,101,101,35,35,0,1,0
17,106,106,4,4,0,1,0
8,117,117,14,14,0,1,0
15,125,125,17,11,6,2,1
2,167,167,17,7,10,3,2
19,174,174,24,10,14,2,1
14,193,193,28,28,0,1,0
3,195,195,22,22,0,1,0
6,210,210,17,13,4,2,1
18,231,231,22,1,21,4,3
4,250,250,10,10,0,1,0
5,268,268,21,6,15,2,1
12,316,316,12,12,0,1,0
22,329,329,33,33,0,1,0
11,345,345,41,41,0,1,0
0,373,373,25,2,23,3,2
13,375,375,25,25,0,1,0
21,385,385,61,61,0,1,0
9,408,408,22,22,0,1,0
10,412,412,19,19,0,1,0
7,413,413,64,31,33,4,3
16,432,432,48,48,0,1,0
20,483,483,36,36,0,1,0

9,100,100,1,1,0,1,0
19,115,115,2,2,0,1,0
15,131,131,54,42,12,2,1
24,149,149,1,1,0,1,0
0,153,153,1,1,0,1,0
22,168,168,3,3,0,1,0
26,177,177,12,12,0,1,0
12,177,177,14,5,9,2,1
4,182,182,26,26,0,1,0
11,185,185,32,32,0,1,0
16,186,186,6,6,0,1,0
21,193,193,12,12,0,1,0
8,199,199,3,3,0,1,0
1,205,205,11,1,10,2,1
2,211,211,32,32,0,1,0
20,226,226,26,26,0,1,0
6,246,246,25,15,10,3,2
13,277,277,2,2,0,1,0
14,282,282,54,54,0,1,0
17,294,294,60,60,0,1,0
5,313,313,23,7,16,3,2
10,322,322,15,5,10,2,1
7,367,367,29,23,6,2,1
23,435,435,8,8,0,1,0
3,445,445,32,26,6,2,1
18,482,482,38,27,11,2,1
25,487,487,98,10,88,3,2

8,154,154,52,8,44,2,1
13,157,157,19,3,16,3,2
7,159,159,1,1,0,1,0
14,166,166,32,11,21,4,3
6,177,177,36,36,0,1,0
5,199,199,11,11,0,1,0
22,204,204,3,3,0,1,0
20,219,219,27,27,0,1,0
9,235,235,38,24,14,2,1
1,272,272,1,1,0,1,0
3,287,287,4,4,0,1,0
19,312,312,7,7,0,1,0
4,317,317,33,33,0,1,0
18,329,329,29,11,18,4,3
24,330,330,75,2,73,4,3
0,366,366,32,2,30,4,3
23,413,413,67,37,30,2,1
17,424,424,26,8,18,3,2
12,432,432,33,6,27,2,1
15,436,436,38,38,0,1,0
2,451,451,2,2,0,1,0
16,455,455,46,46,0,1,0
21,470,470,9,9,0,1,0
11,475,475,68,68,0,1,0
10,495,495,2,2,0,1,0

8,107,107,7,7,0,1,0
14,118,118,2,2,0,1,0
12,180,180,24,2,22,2,1
4,191,191,25,25,0,1,0
11,236,236,25,5,20,3,2
21,256,256,19,3,16,2,1
0,282,282,20,2,18,2,1
9,315,315,14,14,0,1,0
23,341,341,6,6,0,1,0
17,357,357,9,3,6,2,1
7,357,357,113,37,76,4,3
3,378,378,1,1,0,1,0
13,397,397,36,18,18,2,1
10,404,404,39,3,36,3,2
19,404,404,79,79,0,1,0
22,412,412,111,52,59,4,3
1,416,416,117,69,48,3,2
15,425,425,6,6,0,1,0
20,431,431,45,45,0,1,0
5,445,445,9,9,0,1,0
18,447,447,57,57,0,1,0
2,452,452,3,3,0,1,0
6,475,475,29,17,12,2,1
16,498,498,75,75,0,1,0

12,139,139,11,11,0,1,0
17,147,147,7,3,4,2,1
6,155,155,8,8,0,1,0
16,158,158,47,41,6,2,1
15,164,164,3,3,0,1,0
14,170,170,7,1,6,3,2
2,195,195,10,10,0,1,0
7,202,202,6,6,0,1,0
3,255,255,1,1,0,1,0
11,259,259,40,40,0,1,0
5,277,277,75,4,71,4,3
9,279,279,26,7,19,4,3
18,290,290,34,34,0,1,0
23,327,327,7,7,0,1,0
8,331,331,75,60,15,4,3
21,335,335,70,70,0,1,0
0,360,360,28,28,0,1,0
13,381,381,50,35,15,2,1
24,385,385,48,5,43,2,1
1,408,408,19,19,0,1,0
22,445,445,53,53,0,1,0
4,445,445,26,14,12,3,2
19,484,484,7,7,0,1,0
10,486,486,29,29,0,1,0
20,491,491,44,23,21,4,3

3,149,149,13,13,0,1,0
20,150,150,5,2,3,2,1
0,167,167,26,26,0,1,0
15,189,189,16,2,14,3,2
13,209,209,18,2,16,3,2
7,214,214,25,16,9,4,3
10,215,215,5,1,4,2,1
8,237,237,30,17,13,3,2
16,255,255,11,11,0,1,0
9,256,256,75,69,6,2,1
21,294,294,63,63,0,1,0
12,307,307,36,36,0,1,0
5,329,329,10,2,8,2,1
14,340,340,76,45,31,2,1
2,353,353,2,2,0,1,0
11,356,356,33,33,0,1,0
18,357,357,49,49,0,1,0
1,398,398,60,46,14,2,1
17,402,402,45,45,0,1,0
6,418,418,72,33,39,4,3
19,449,449,24,8,16,2,1
4,454,454,28,28,0,1,0

11,103,103,5,2,3,2,1
15,138,138,45,45,0,1,0
2,142,142,1,1,0,1,0
9,156,156,1,1,0,1,0
19,166,166,66,66,0,1,0
3,168,168,30,15,15,2,1
4,170,170,9,9,0,1,0
21,198,198,7,7,0,1,0
8,210,210,18,18,0,1,0
16,234,234,6,6,0,1,0
14,245,245,5,1,4,2,1
5,267,267,82,66,16,2,1
7,290,290,3,3,0,1,0
13,299,299,5,2,3,2,1
22,330,330,3,3,0,1,0
17,397,397,38,22,16,2,1
18,404,404,45,45,0,1,0
23,406,406,52,52,0,1,0
0,415,415,63,33,30,3,2
10,440,440,7,7,0,1,0
1,446,446,15,15,0,1,0
6,468,468,144,95,49,4,3
12,470,470,21,12,9,2,1
20,500,500,4,4,0,1,0

19,118,118,1,1,0,1,0
0,147,147,22,22,0,1,0
13,151,151,29,29,0,1,0
22,155,155,24,24,0,1,0
18,213,213,16,4,12,2,1
5,221,221,4,4,0,1,0
9,222,222,50,24,26,3,2
8,259,259,6,6,0,1,0
15,291,291,71,57,14,2,1
12,295,295,14,14,0,1,0
17,315,315,12,3,9,2,1
6,317,317,79,19,60,4,3
10,321,321,5,1,4,2,1
2,321,321,38,38,0,1,0
14,343,343,33,33,0,1,0
16,349,349,5,5,0,1,0
3,370,370,53,3,50,2,1
1,410,410,24,20,4,2,1
11,416,416,67,22,45,4,3
23,447,447,30,15,15,2,1
20,467,467,23,11,12,3,2
21,479,479,117,107,10,3,2
7,483,483,1,1,0,1,0
4,499,499,18,18,0,1,0

0,124,124,5,5,0,1,0
29,127,127,25,25,0,1,0
10,134,134,4,1,3,2,1
32,137,137,7,7,0,1,0
28,143,143,5,2,3,2,1
15,147,147,1,1,0,1,0
6,160,160,7,3,4,2,1
9,162,162,1,1,0,1,0
5,198,198,1,1,0,1,0
30,218,218,26,26,0,1,0
24,224,224,8,2,6,3,2
17,245,245,12,12,0,1,0
26,270,270,50,44,6,3,2
22,276,276,46,46,0,1,0
4,281,281,6,3,3,2,1
25,286,286,21,3,18,3,2
20,288,288,41,41,0,1,0
2,293,293,17,5,12,4,3
23,352,352,35,29,6,3,2
21,374,374,44,44,0,1,0
18,382,382,12,7,5,2,1
7,384,384,41,32,9,2,1
8,384,384,20,20,0,1,0
14,423,423,41,41,0,1,0
11,428,428,34,4,30,4,3
1,440,440,47,47,0,1,0
13,442,442,1,1,0,1,0
3,444,444,27,7,20,2,1
12,453,453,71,71,0,1,0
19,457,457,45,41,4,2,1
16,480,480,4,4,0,1,0
31,488,488,21,13,8,3,2
27,499,499,51,51,0,1,0

22,117,117,35,2,33,2,1
23,119,119,6,6,0,1,0
24,126,126,1,1,0,1,0
19,135,135,7,7,0,1,0
13,152,152,7,7,0,1,0
27,155,155,41,41,0,1,0
10,168,168,2,2,0,1,0
2,185,185,14,14,0,1,0
21,190,190,9,1,8,2,1
12,191,191,1,1,0,1,0
26,194,194,1,1,0,1,0
0,196,196,32,32,0,1,0
7,213,213,1,1,0,1,0
8,219,219,1,1,0,1,0
29,245,245,24,4,20,3,2
16,301,301,46,46,0,1,0
28,304,304,18,18,0,1,0
3,311,311,22,22,0,1,0
15,322,322,30,4,26,3,2
6,322,322,33,7,26,3,2
1,325,325,40,23,17,2,1
5,365,365,4,4,0,1,0
30,368,368,24,24,0,1,0
9,374,374,9,4,5,2,1
20,414,414,1,1,0,1,0
31,437,437,35,7,28,4,3
11,441,441,1,1,0,1,0
17,453,453,22,22,0,1,0
18,460,460,55,40,15,2,1
4,473,473,30,24,6,3,2
14,475,475,15,15,0,1,0
25,482,482,122,104,18,3,2

24,111,111,12,12,0,1,0
23,140,140,24,24,0,1,0
22,152,152,1,1,0,1,0
17,164,164,7,7,0,1,0
15,173,173,11,3,8,2,1
3,180,180,10,1,9,4,3
26,180,180,16,5,11,2,1
10,186,186,21,2,19,2,1
11,193,193,40,40,0,1,0
18,212,212,22,8,14,3,2
16,232,232,31,8,23,2,1
27,233,233,27,27,0,1,0
2,236,236,4,4,0,1,0
0,241,241,51,51,0,1,0
7,253,253,4,4,0,1,0
1,263,263,3,3,0,1,0
19,278,278,58,58,0,1,0
5,295,295,2,2,0,1,0
9,337,337,5,5,0,1,0
8,364,364,32,6,26,3,2
25,385,385,8,8,0,1,0
12,420,420,31,3,28,2,1
13,429,429,11,11,0,1,0
14,430,430,84,40,44,4,3
20,437,437,69,41,28,2,1
6,476,476,21,9,12,2,1
21,484,484,31,3,28,3,2
4,490,490,28,28,0,1,0

10,106,106,3,3,0,1,0
2,121,121,5,5,0,1,0
17,130,130,5,5,0,1,0
0,141,141,26,26,0,1,0
18,162,162,30,25,5,2,1
4,164,164,31,16,15,2,1
13,169,169,2,2,0,1,0
15,174,174,56,51,5,2,1
20,209,209,15,15,0,1,0
3,217,217,105,105,0,1,0
6,237,237,8,2,6,3,2
16,265,265,13,7,6,3,2
22,296,296,14,14,0,1,0
5,332,332,29,21,8,3,2
19,339,339,53,53,0,1,0
9,358,358,14,3,11,2,1
7,361,361,12,12,0,1,0
8,369,369,21,21,0,1,0
1,374,374,10,10,0,1,0
12,393,393,21,21,0,1,0
21,395,395,21,14,7,2,1
11,430,430,35,23,12,4,3
14,435,435,67,30,37,2,1

0,111,111,3,3,0,1,0
7,118,118,19,19,0,1,0
18,121,121,13,8,5,2,1
6,123,123,31,31,0,1,0
4,161,161,9,3,6,2,1
13,169,169,23,2,21,2,1
20,175,175,4,4,0,1,0
12,185,185,12,9,3,2,1
19,201,201,16,16,0,1,0
1,209,209,25,1,24,4,3
21,235,235,103,64,39,2,1
16,236,236,41,19,22,2,1
15,238,238,27,27,0,1,0
8,243,243,1,1,0,1,0
10,246,246,14,4,10,2,1
14,257,257,1,1,0,1,0
3,271,271,4,4,0,1,0
17,313,313,8,8,0,1,0
11,364,364,4,4,0,1,0
9,377,377,67,59,8,3,2
2,417,417,122,122,0,1,0
5,436,436,42,42,0,1,0

16,112,112,4,4,0,1,0
10,115,115,1,1,0,1,0
23,122,122,22,7,15,4,3
7,136,136,5,5,0,1,0
3,195,195,17,17,0,1,0
18,218,218,28,24,4,2,1
20,232,232,11,11,0,1,0
21,266,266,63,39,24,4,3
22,270,270,76,76,0,1,0
15,304,304,3,3,0,1,0
14,316,316,10,4,6,3,2
2,351,351,7,7,0,1,0
0,359,359,88,39,49,2,1
19,391,391,62,3,59,3,2
1,402,402,3,3,0,1,0
13,404,404,17,17,0,1,0
9,414,414,53,39,14,2,1
4,417,417,47,23,24,4,3
17,424,424,24,24,0,1,0
8,426,426,151,151,0,1,0
12,443,443,21,21,0,1,0
6,456,456,43,4,39,4,3
11,457,457,17,7,10,2,1
5,493,493,11,2,9,2,1
24,498,498,10,10,0,1,0

34,100,100,23,14,9,2,1
15,111,111,2,2,0,1,0
0,131,131,9,1,8,3,2
26,138,138,18,3,15,4,3
11,153,153,5,5,0,1,0
4,159,159,10,10,0,1,0
20,210,210,9,1,8,3,2
9,217,217,2,2,0,1,0
16,225,225,21,21,0,1,0
10,253,253,1,1,0,1,0
2,262,262,7,1,6,3,2
8,266,266,12,12,0,1,0
30,266,266,21,3,18,4,3
1,278,278,25,25,0,1,0
28,291,291,68,61,7,2,1
22,306,306,45,45,0,1,0
13,312,312,26,26,0,1,0
31,326,326,58,58,0,1,0
5,343,343,22,22,0,1,0
24,356,356,2,2,0,1,0
3,358,358,1,1,0,1,0
36,359,359,18,18,0,1,0
27,361,361,8,1,7,2,1
18,361,361,34,34,0,1,0
7,381,381,2,2,0,1,0
6,387,387,1,1,0,1,0
17,388,388,1,1,0,1,0
21,408,408,10,10,0,1,0
23,422,422,32,24,8,3,2
19,422,422,37,13,24,4,3
12,432,432,8,1,7,2,1
14,437,437,41,41,0,1,0
32,440,440,31,31,0,1,0
33,459,459,9,9,0,1,0
35,484,484,40,2,38,2,1
29,491,491,31,31,0,1,0
25,500,500,33,33,0,1,0

13,104,104,3,3,0,1,0
10,117,117,33,9,24,2,1
15,123,123,10,10,0,1,0
23,192,192,12,6,6,2,1
0,235,235,4,4,0,1,0
12,237,237,20,4,16,3,2
20,245,245,10,10,0,1,0
1,257,257,3,3,0,1,0
8,269,269,17,5,12,2,1
14,289,289,34,34,0,1,0
5,298,298,111,111,0,1,0
17,305,305,10,5,5,2,1
16,308,308,17,5,12,2,1
7,314,314,9,3,6,2,1
11,364,364,47,47,0,1,0
21,366,366,26,26,0,1,0
2,367,367,22,22,0,1,0
25,394,394,125,27,98,3,2
6,395,395,27,6,21,4,3
9,401,401,1,1,0,1,0
24,423,423,13,13,0,1,0
19,425,425,15,3,12,2,1
4,464,464,2,2,0,1,0
3,486,486,25,25,0,1,0
18,491,491,55,55,0,1,0
22,491,491,129,78,51,4,3

24,101,101,6,2,4,2,1
26,140,140,18,4,14,2,1
10,156,156,1,1,0,1,0
16,197,197,23,23,0,1,0
7,201,201,9,1,8,2,1
6,209,209,4,4,0,1,0
11,221,221,3,3,0,1,0
31,223,223,2,2,0,1,0
2,242,242,35,26,9,4,3
29,243,243,103,54,49,2,1
22,259,259,50,32,18,4,3
30,269,269,18,18,0,1,0
20,281,281,24,24,0,1,0
1,294,294,3,3,0,1,0
12,305,305,10,1,9,2,1
4,308,308,15,3,12,2,1
21,315,315,9,6,3,2,1
27,316,316,25,21,4,2,1
17,319,319,18,18,0,1,0
15,325,325,13,13,0,1,0
23,370,370,1,1,0,1,0
28,371,371,45,40,5,2,1
3,410,410,44,8,36,2,1
0,416,416,35,35,0,1,0
13,432,432,13,1,12,2,1
14,441,441,103,67,36,4,3
18,457,457,21,21,0,1,0
5,462,462,21,21,0,1,0
9,469,469,22,22,0,1,0
25,472,472,12,1,11,2,1
19,495,495,36,15,21,2,1
8,495,495,1,1,0,1,0

2,113,113,1,1,0,1,0
23,127,127,5,5,0,1,0
3,139,139,3,3,0,1,0
19,150,150,11,2,9,4,3
13,176,176,21,15,6,2,1
4,182,182,14,14,0,1,0
8,186,186,11,1,10,2,1
10,186,186,10,7,3,2,1
9,237,237,1,1,0,1,0
11,276,276,97,93,4,2,1
17,294,294,42,19,23,2,1
0,309,309,6,6,0,1,0
14,315,315,27,27,0,1,0
16,320,320,81,50,31,3,2
18,361,361,70,22,48,2,1
7,369,369,29,15,14,3,2
22,391,391,20,2,18,2,1
6,396,396,55,26,29,2,1
20,396,396,2,2,0,1,0
1,401,401,44,44,0,1,0
21,406,406,4,4,0,1,0
5,450,450,126,78,48,4,3
15,459,459,57,42,15,2,1
12,465,465,54,54,0,1,0

5,108,108,3,3,0,1,0
18,121,121,1,1,0,1,0
23,123,123,14,5,9,2,1
20,135,135,6,6,0,1,0
6,152,152,30,30,0,1,0
4,183,183,45,7,38,3,2
0,214,214,2,2,0,1,0
7,224,224,38,2,36,4,3
8,228,228,5,1,4,2,1
17,251,251,25,25,0,1,0
21,272,272,46,11,35,2,1
1,280,280,33,27,6,2,1
13,295,295,41,21,20,2,1
11,343,343,42,32,10,3,2
16,344,344,5,1,4,2,1
9,344,344,13,1,12,2,1
14,354,354,35,6,29,3,2
19,368,368,21,21,0,1,0
22,403,403,94,34,60,4,3
10,455,455,71,71,0,1,0
3,479,479,17,3,14,2,1
12,484,484,12,12,0,1,0
2,486,486,29,29,0,1,0
15,498,498,109,109,0,1,0

18,126,126,9,3,6,2,1
1,131,131,41,32,9,2,1
8,140,140,16,16,0,1,0
16,140,140,15,11,4,2,1
5,143,143,3,3,0,1,0
11,198,198,11,1,10,2,1
12,244,244,17,6,11,3,2
15,269,269,83,51,32,3,2
4,274,274,52,10,42,3,2
0,285,285,51,4,47,2,1
6,287,287,39,11,28,2,1
19,316,316,40,40,0,1,0
3,324,324,53,53,0,1,0
20,337,337,40,40,0,1,0
17,369,369,21,21,0,1,0
9,371,371,4,1,3,2,1
7,401,401,23,6,17,2,1
2,436,436,13,13,0,1,0
13,437,437,27,3,24,2,1
10,479,479,108,58,50,2,1
14,489,489,5,5,0,1,0

13,100,100,19,19,0,1,0
16,102,102,16,6,10,2,1
10,147,147,21,21,0,1,0
8,148,148,4,4,0,1,0
11,174,174,23,14,9,2,1
4,194,194,12,12,0,1,0
5,218,218,11,11,0,1,0
6,220,220,36,4,32,2,1
0,228,228,7,7,0,1,0
9,275,275,29,10,19,2,1
15,309,309,19,3,16,2,1
3,329,329,131,110,21,4,3
7,334,334,7,2,5,2,1
2,346,346,18,13,5,2,1
14,352,352,23,23,0,1,0
1,366,366,145,71,74,3,2
20,373,373,26,26,0,1,0
12,396,396,17,17,0,1,0
19,426,426,66,62,4,2,1
17,432,432,37,21,16,2,1
18,486,486,7,7,0,1,0

2,104,104,47,47,0,1,0
5,111,111,28,1,27,4,3
0,128,128,1,1,0,1,0
14,133,133,17,7,10,2,1
9,142,142,13,13,0,1,0
1,153,153,1,1,0,1,0
12,169,169,11,8,3,2,1
11,227,227,9,9,0,1,0
7,267,267,106,79,27,4,3
4,334,334,104,18,86,3,2
6,376,376,45,45,0,1,0
13,396,396,10,10,0,1,0
17,398,398,20,4,16,2,1
8,405,405,24,4,20,3,2
10,436,436,7,4,3,2,1
3,449,449,80,52,28,4,3
16,449,449,73,3,70,4,3
15,477,477,31,31,0,1,0

3,128,128,21,4,17,2,1
5,138,138,6,6,0,1,0
19,151,151,3,3,0,1,0
11,155,155,11,11,0,1,0
6,163,163,4,4,0,1,0
20,189,189,8,5,3,2,1
15,194,194,25,7,18,3,2
2,194,194,28,1,27,4,3
4,235,235,3,3,0,1,0
22,284,284,74,62,12,3,2
7,295,295,38,38,0,1,0
21,323,323,71,32,39,4,3
0,332,332,72,15,57,4,3
16,375,375,14,5,9,2,1
1,383,383,123,37,86,4,3
8,384,384,25,25,0,1,0
13,403,403,24,24,0,1,0
10,416,416,27,27,0,1,0
17,446,446,8,1,7,2,1
18,476,476,5,5,0,1,0
9,482,482,7,2,5,2,1
14,489,489,43,43,0,1,0
12,496,496,134,95,39,2,1

0,111,111,4,4,0,1,0
13,114,114,35,35,0,1,0
16,122,122,2,2,0,1,0
19,125,125,9,9,0,1,0
2,138,138,13,7,6,3,2
4,161,161,57,14,43,2,1
12,173,173,27,27,0,1,0
3,187,187,4,4,0,1,0
17,215,215,6,6,0,1,0
21,222,222,7,1,6,3,2
22,237,237,9,9,0,1,0
1,256,256,12,3,9,4,3
15,258,258,6,6,0,1,0
6,269,269,88,88,0,1,0
8,303,303,11,3,8,3,2
10,314,314,10,2,8,2,1
7,317,317,5,5,0,1,0
9,337,337,69,19,50,3,2
14,356,356,4,4,0,1,0
18,357,357,49,49,0,1,0
5,369,369,12,12,0,1,0
20,386,386,83,83,0,1,0
11,454,454,82,82,0,1,0

5,117,117,29,29,0,1,0
0,129,129,9,9,0,1,0
9,149,149,18,4,14,3,2
21,170,170,33,12,21,4,3
14,175,175,21,21,0,1,0
7,177,177,17,17,0,1,0
16,189,189,29,23,6,3,2
11,221,221,16,16,0,1,0
23,272,272,15,6,9,2,1
8,310,310,25,25,0,1,0
18,329,329,28,28,0,1,0
4,353,353,12,12,0,1,0
2,356,356,47,14,33,4,3
12,377,377,2,2,0,1,0
17,393,393,81,81,0,1,0
20,421,421,25,7,18,2,1
6,427,427,2,2,0,1,0
10,429,429,67,43,24,2,1
3,438,438,77,77,0,1,0
19,441,441,9,9,0,1,0
1,442,442,5,5,0,1,0
22,465,465,5,5,0,1,0
13,487,487,123,103,20,2,1
15,488,488,27,17,10,2,1

17,135,135,12,7,5,2,1
2,168,168,10,10,0,1,0
16,177,177,33,15,18,3,2
15,177,177,6,6,0,1,0
4,209,209,34,12,22,3,2
5,250,250,38,29,9,3,2
10,261,261,34,34,0,1,0
11,262,262,28,18,10,2,1
0,274,274,55,55,0,1,0
7,293,293,10,3,7,2,1
18,302,302,71,33,38,2,1
8,314,314,32,3,29,2,1
12,329,329,39,39,0,1,0
13,378,378,14,3,11,2,1
9,391,391,13,13,0,1,0
14,465,465,49,49,0,1,0
6,485,485,141,141,0,1,0
3,494,494,34,18,16,3,2
1,494,494,132,90,42,4,3

0,102,102,2,2,0,1,0
14,108,108,5,5,0,1,0
6,118,118,3,3,0,1,0
15,124,124,3,3,0,1,0
11,149,149,3,3,0,1,0
19,168,168,11,11,0,1,0
7,184,184,24,9,15,4,3
1,195,195,19,19,0,1,0
18,204,204,14,11,3,2,1
8,214,214,91,1,90,4,3
21,224,224,15,15,0,1,0
20,232,232,20,2,18,2,1
12,240,240,58,8,50,2,1
13,245,245,5,5,0,1,0
16,292,292,90,61,29,3,2
3,319,319,31,31,0,1,0
10,326,326,17,9,8,3,2
17,413,413,96,44,52,3,2
2,451,451,32,21,11,2,1
9,454,454,10,10,0,1,0
4,459,459,98,57,41,2,1
5,463,463,46,46,0,1,0

1,118,118,1,1,0,1,0
14,142,142,18,4,14,3,2
16,163,163,8,8,0,1,0
17,179,179,24,6,18,3,2
10,191,191,21,13,8,3,2
0,226,226,15,15,0,1,0
19,257,257,13,5,8,2,1
2,268,268,59,59,0,1,0
5,347,347,26,11,15,4,3
3,366,366,12,2,10,3,2
8,391,391,44,44,0,1,0
9,394,394,6,2,4,2,1
21,396,396,3,3,0,1,0
12,401,401,55,12,43,2,1
18,405,405,19,9,10,3,2
15,411,411,46,46,0,1,0
20,413,413,95,52,43,2,1
4,413,413,9,9,0,1,0
7,425,425,29,11,18,4,3
11,452,452,48,48,0,1,0
13,463,463,52,28,24,3,2
6,477,477,277,277,0,1,0

11,102,102,15,15,0,1,0
1,113,113,1,1,0,1,0
17,129,129,32,26,6,2,1
6,133,133,22,22,0,1,0
23,136,136,38,38,0,1,0
15,146,146,18,7,11,2,1
0,150,150,22,13,9,4,3
16,185,185,14,14,0,1,0
20,210,210,1,1,0,1,0
5,239,239,36,9,27,4,3
10,258,258,1,1,0,1,0
2,312,312,89,5,84,4,3
4,330,330,18,14,4,2,1
9,340,340,23,23,0,1,0
8,342,342,22,22,0,1,0
19,350,350,28,28,0,1,0
21,361,361,12,12,0,1,0
22,363,363,31,8,23,2,1
14,374,374,61,49,12,2,1
3,392,392,14,2,12,3,2
12,441,441,3,3,0,1,0
7,458,458,34,10,24,4,3
18,483,483,10,10,0,1,0
13,500,500,53,53,0,1,0

6,102,102,2,2,0,1,0
21,105,105,1,1,0,1,0
8,106,106,14,3,11,2,1
22,110,110,9,2,7,2,1
0,110,110,6,6,0,1,0
2,126,126,13,6,7,2,1
13,133,133,2,2,0,1,0
5,136,136,56,51,5,2,1
16,136,136,3,3,0,1,0
7,209,209,18,9,9,2,1
20,220,220,23,20,3,2,1
23,222,222,11,1,10,2,1
24,234,234,21,21,0,1,0
15,236,236,17,6,11,2,1
9,257,257,31,31,0,1,0
12,261,261,8,8,0,1,0
10,270,270,21,21,0,1,0
4,283,283,13,13,0,1,0
11,306,306,18,18,0,1,0
14,324,324,26,26,0,1,0
3,346,346,7,7,0,1,0
1,392,392,10,10,0,1,0
18,392,392,32,28,4,2,1
25,428,428,75,42,33,4,3
19,457,457,131,131,0,1,0
17,493,493,86,5,81,4,3

25,100,100,15,6,9,4,3
17,109,109,12,12,0,1,0
9,146,146,10,10,0,1,0
6,152,152,35,35,0,1,0
28,229,229,22,1,21,4,3
10,231,231,1,1,0,1,0
21,239,239,12,12,0,1,0
11,305,305,8,8,0,1,0
27,309,309,46,46,0,1,0
24,309,309,34,16,18,2,1
2,310,310,34,34,0,1,0
22,339,339,51,45,6,2,1
1,356,356,57,13,44,2,1
5,357,357,18,18,0,1,0
19,371,371,30,30,0,1,0
13,392,392,18,18,0,1,0
0,393,393,2,2,0,1,0
18,394,394,41,41,0,1,0
26,402,402,49,19,30,3,2
8,415,415,8,4,4,2,1
7,436,436,5,2,3,2,1
20,437,437,16,10,6,3,2
3,437,437,7,7,0,1,0
23,451,451,27,19,8,2,1
4,458,458,33,33,0,1,0
12,478,478,33,3,30,3,2
14,484,484,112,8,104,4,3
16,495,495,14,14,0,1,0
15,499,499,26,14,12,3,2

2,103,103,2,2,0,1,0
13,105,105,15,15,0,1,0
26,112,112,4,1,3,2,1
17,124,124,39,39,0,1,0
10,145,145,13,13,0,1,0
25,162,162,9,9,0,1,0
18,172,172,20,4,16,2,1
1,186,186,14,14,0,1,0
3,200,200,7,7,0,1,0
12,202,202,38,8,30,2,1
5,211,211,1,1,0,1,0
27,212,212,19,10,9,4,3
15,240,240,13,13,0,1,0
7,249,249,27,27,0,1,0
23,292,292,20,7,13,2,1
8,294,294,1,1,0,1,0
11,325,325,8,8,0,1,0
21,341,341,3,3,0,1,0
22,359,359,44,11,33,2,1
14,368,368,50,44,6,2,1
20,371,371,13,13,0,1,0
24,379,379,63,63,0,1,0
6,401,401,37,37,0,1,0
16,414,414,67,67,0,1,0
4,432,432,11,6,5,2,1
9,438,438,4,4,0,1,0
19,446,446,27,27,0,1,0
0,491,491,95,55,40,3,2

12,131,131,10,10,0,1,0
26,133,133,17,9,8,2,1
2,145,145,1,1,0,1,0
11,145,145,1,1,0,1,0
13,153,153,12,12,0,1,0
24,171,171,15,5,10,2,1
0,200,200,9,9,0,1,0
21,203,203,34,34,0,1,0
14,232,232,49,49,0,1,0
20,242,242,84,2,82,3,2
8,251,251,11,7,4,2,1
10,297,297,17,17,0,1,0
3,309,309,59,59,0,1,0
18,322,322,13,13,0,1,0
19,333,333,21,21,0,1,0
4,333,333,43,3,40,2,1
7,334,334,16,16,0,1,0
16,335,335,14,14,0,1,0
9,336,336,7,2,5,2,1
22,342,342,19,1,18,3,2
6,348,348,12,4,8,3,2
15,450,450,58,43,15,2,1
23,464,464,53,53,0,1,0
1,468,468,2,2,0,1,0
17,482,482,1,1,0,1,0
25,495,495,23,23,0,1,0
5,499,499,125,105,20,3,2

21,108,108,9,9,0,1,0
2,123,123,14,2,12,2,1
11,139,139,16,4,12,4,3
13,151,151,1,1,0,1,0
8,152,152,1,1,0,1,0
1,157,157,34,17,17,2,1
5,171,171,17,17,0,1,0
7,206,206,21,17,4,2,1
25,212,212,24,6,18,3,2
9,213,213,14,14,0,1,0
24,216,216,8,8,0,1,0
19,233,233,35,35,0,1,0
22,236,236,68,29,39,2,1
12,263,263,6,6,0,1,0
16,263,263,12,5,7,2,1
6,271,271,12,12,0,1,0
3,312,312,1,1,0,1,0
26,323,323,42,42,0,1,0
20,346,346,38,14,24,3,2
0,419,419,67,67,0,1,0
4,436,436,31,31,0,1,0
23,440,440,18,18,0,1,0
17,443,443,5,5,0,1,0
15,451,451,55,28,27,4,3
14,454,454,69,69,0,1,0
10,487,487,11,1,10,3,2
18,494,494,45,45,0,1,0

13,104,104,2,2,0,1,0
1,106,106,36,36,0,1,0
4,144,144,14,14,0,1,0
16,147,147,6,6,0,1,0
5,161,161,3,3,0,1,0
8,162,162,17,17,0,1,0
0,164,164,20,4,16,2,1
3,182,182,14,14,0,1,0
9,218,218,41,41,0,1,0
11,230,230,14,14,0,1,0
14,256,256,31,31,0,1,0
17,264,264,4,4,0,1,0
20,312,312,20,8,12,3,2
6,316,316,57,34,23,3,2
15,321,321,7,7,0,1,0
7,337,337,12,12,0,1,0
21,381,381,52,49,3,2,1
19,391,391,129,87,42,2,1
10,409,409,14,14,0,1,0
12,451,451,50,9,41,2,1
18,452,452,121,57,64,4,3
2,462,462,18,18,0,1,0

10,103,103,20,20,0,1,0
16,126,126,17,9,8,3,2
2,138,138,20,6,14,3,2
12,150,150,8,8,0,1,0
14,154,154,8,2,6,2,1
9,176,176,16,16,0,1,0
0,181,181,45,30,15,4,3
4,209,209,21,4,17,2,1
13,258,258,49,31,18,4,3
5,261,261,62,24,38,3,2
18,277,277,30,22,8,3,2
6,339,339,59,59,0,1,0
1,349,349,20,6,14,2,1
15,368,368,46,46,0,1,0
3,384,384,92,75,17,2,1
8,422,422,85,24,61,4,3
11,442,442,20,7,13,2,1
7,452,452,7,7,0,1,0
17,496,496,10,10,0,1,0

6,105,105,5,5,0,1,0
16,120,120,2,2,0,1,0
1,139,139,5,5,0,1,0
12,155,155,11,3,8,2,1
19,164,164,22,17,5,2,1
10,177,177,33,33,0,1,0
18,198,198,21,21,0,1,0
7,211,211,4,4,0,1,0
15,226,226,49,49,0,1,0
24,235,235,27,8,19,2,1
11,259,259,8,4,4,2,1
4,279,279,3,3,0,1,0
20,286,286,6,6,0,1,0
2,301,301,23,3,20,2,1
8,304,304,27,27,0,1,0
22,348,348,44,30,14,3,2
23,349,349,11,11,0,1,0
21,384,384,94,94,0,1,0
13,394,394,13,1,12,4,3
14,396,396,22,3,19,2,1
17,404,404,54,54,0,1,0
3,421,421,31,31,0,1,0
5,434,434,12,12,0,1,0
0,464,464,248,242,6,3,2
9,494,494,1,1,0,1,0

21,108,108,35,1,34,3,2
24,113,113,9,9,0,1,0
6,149,149,12,12,0,1,0
23,157,157,5,5,0,1,0
14,178,178,1,1,0,1,0
17,189,189,1,1,0,1,0
25,192,192,30,10,20,3,2
7,227,227,1,1,0,1,0
12,246,246,12,12,0,1,0
22,249,249,1,1,0,1,0
0,322,322,97,77,20,2,1
13,326,326,5,5,0,1,0
19,342,342,39,30,9,4,3
3,363,363,58,58,0,1,0
8,370,370,78,28,50,3,2
9,374,374,2,2,0,1,0
11,414,414,13,5,8,3,2
26,416,416,167,130,37,2,1
18,424,424,27,14,13,2,1
16,441,441,5,2,3,2,1
15,448,448,7,7,0,1,0
2,448,448,73,41,32,2,1
10,485,485,30,9,21,2,1
5,492,492,33,7,26,3,2
20,495,495,8,8,0,1,0
4,495,495,21,13,8,2,1
1,499,499,4,4,0,1,0

4,111,111,27,27,0,1,0
16,129,129,22,6,16,2,1
5,168,168,36,3,33,4,3
17,169,169,28,13,15,4,3
15,169,169,13,1,12,2,1
11,201,201,55,55,0,1,0
14,215,215,5,5,0,1,0
6,247,247,40,7,33,2,1
20,302,302,11,11,0,1,0
21,310,310,23,23,0,1,0
7,328,328,41,41,0,1,0
2,364,364,11,2,9,4,3
18,382,382,53,26,27,4,3
9,406,406,30,30,0,1,0
13,416,416,12,12,0,1,0
10,417,417,54,54,0,1,0
1,421,421,34,34,0,1,0
8,425,425,94,85,9,2,1
19,431,431,40,21,19,2,1
0,477,477,23,23,0,1,0
12,484,484,8,2,6,3,2
3,498,498,1,1,0,1,0

1,103,103,1,1,0,1,0
20,110,110,6,6,0,1,0
2,124,124,33,33,0,1,0
0,126,126,11,11,0,1,0
22,127,127,16,2,14,3,2
10,136,136,1,1,0,1,0
4,142,142,27,27,0,1,0
3,249,249,22,11,11,2,1
21,264,264,1,1,0,1,0
13,278,278,49,49,0,1,0
14,283,283,46,20,26,3,2
5,310,310,28,16,12,2,1
18,336,336,43,21,22,4,3
15,345,345,5,5,0,1,0
8,380,380,90,90,0,1,0
11,384,384,39,39,0,1,0
7,390,390,21,6,15,2,1
17,391,391,6,6,0,1,0
9,403,403,35,35,0,1,0
19,434,434,116,84,32,2,1
12,451,451,4,4,0,1,0
16,459,459,76,7,69,4,3
6,487,487,43,43,0,1,0

26,107,107,6,6,0,1,0
13,123,123,3,3,0,1,0
24,129,129,2,2,0,1,0
1,141,141,20,13,7,2,1
27,145,145,1,1,0,1,0
2,150,150,7,7,0,1,0
16,163,163,8,8,0,1,0
22,169,169,9,2,7,2,1
3,170,170,19,8,11,4,3
18,182,182,1,1,0,1,0
10,195,195,16,10,6,2,1
20,195,195,4,4,0,1,0
15,198,198,29,16,13,2,1
6,206,206,18,6,12,4,3
7,214,214,7,7,0,1,0
28,232,232,30,4,26,4,3
11,271,271,29,29,0,1,0
21,276,276,51,51,0,1,0
14,288,288,28,9,19,2,1
0,305,305,20,20,0,1,0
5,345,345,1,1,0,1,0
19,350,350,70,12,58,3,2
8,353,353,28,28,0,1,0
23,354,354,172,172,0,1,0
25,395,395,2,2,0,1,0
9,419,419,5,5,0,1,0
12,421,421,40,22,18,3,2
17,478,478,33,33,0,1,0
4,481,481,11,7,4,2,1

11,100,100,13,2,11,2,1
0,134,134,2,2,0,1,0
14,160,160,12,12,0,1,0
16,284,284,25,16,9,2,1
18,306,306,10,10,0,1,0
2,332,332,33,33,0,1,0
17,339,339,40,40,0,1,0
21,344,344,22,22,0,1,0
9,358,358,19,19,0,1,0
1,359,359,3,3,0,1,0
22,374,374,18,12,6,3,2
25,376,376,15,15,0,1,0
20,376,376,4,4,0,1,0
10,377,377,67,19,48,2,1
7,388,388,51,23,28,3,2
24,388,388,64,34,30,4,3
12,394,394,34,34,0,1,0
15,399,399,46,6,40,3,2
5,400,400,42,33,9,2,1
19,404,404,115,81,34,2,1
4,455,455,30,30,0,1,0
6,459,459,49,10,39,2,1
8,461,461,87,64,23,2,1
13,470,470,15,5,10,2,1
23,478,478,87,87,0,1,0
3,485,485,1,1,0,1,0

26,104,104,2,2,0,1,0
21,113,113,19,19,0,1,0
27,153,153,3,3,0,1,0
1,162,162,1,1,0,1,0
3,180,180,8,8,0,1,0
24,204,204,49,49,0,1,0
29,227,227,2,2,0,1,0
11,236,236,11,5,6,2,1
10,237,237,4,1,3,2,1
18,238,238,41,41,0,1,0
25,260,260,32,23,9,2,1
5,262,262,45,22,23,2,1
13,267,267,25,19,6,2,1
22,273,273,3,3,0,1,0
12,283,283,17,12,5,2,1
7,286,286,40,26,14,4,3
6,304,304,82,6,76,3,2
2,310,310,2,2,0,1,0
14,328,328,23,23,0,1,0
9,359,359,26,13,13,3,2
16,372,372,37,37,0,1,0
20,402,402,9,9,0,1,0
28,403,403,122,122,0,1,0
4,411,411,1,1,0,1,0
19,423,423,54,54,0,1,0
0,436,436,12,12,0,1,0
17,440,440,14,14,0,1,0
8,444,444,12,6,6,3,2
23,460,460,9,9,0,1,0
15,485,485,7,7,0,1,0

18,108,108,2,2,0,1,0
7,112,112,10,10,0,1,0
32,121,121,18,18,0,1,0
33,139,139,5,2,3,2,1
29,145,145,6,6,0,1,0
15,163,163,4,4,0,1,0
12,188,188,11,11,0,1,0
16,191,191,6,6,0,1,0
8,197,197,1,1,0,1,0
23,212,212,17,7,10,4,3
20,228,228,11,11,0,1,0
10,240,240,3,3,0,1,0
2,243,243,14,14,0,1,0
22,249,249,6,6,0,1,0
9,252,252,10,10,0,1,0
6,257,257,3,3,0,1,0
19,257,257,11,2,9,2,1
14,264,264,14,14,0,1,0
11,279,279,1,1,0,1,0
25,283,283,39,21,18,3,2
27,286,286,4,1,3,2,1
34,315,315,47,47,0,1,0
17,317,317,18,18,0,1,0
0,363,363,11,11,0,1,0
4,367,367,26,9,17,2,1
28,382,382,81,32,49,2,1
31,394,394,22,4,18,4,3
35,398,398,97,97,0,1,0
13,415,415,101,53,48,4,3
21,416,416,9,9,0,1,0
26,431,431,19,8,11,2,1
3,441,441,1,1,0,1,0
5,443,443,59,39,20,2,1
30,464,464,45,13,32,3,2
24,491,491,19,19,0,1,0
1,494,494,22,3,19,2,1

21,115,115,3,3,0,1,0
16,120,120,21,21,0,1,0
9,123,123,7,1,6,3,2
2,138,138,23,23,0,1,0
15,150,150,31,10,21,4,3
19,154,154,17,17,0,1,0
17,163,163,26,3,23,2,1
4,166,166,19,1,18,4,3
20,186,186,5,2,3,2,1
7,227,227,19,19,0,1,0
0,240,240,14,14,0,1,0
5,256,256,18,11,7,2,1
10,293,293,22,22,0,1,0
25,310,310,3,3,0,1,0
3,328,328,13,13,0,1,0
12,410,410,61,61,0,1,0
24,435,435,149,129,20,2,1
23,436,436,10,10,0,1,0
14,448,448,3,3,0,1,0
1,448,448,10,10,0,1,0
18,468,468,55,55,0,1,0
6,470,470,5,5,0,1,0
13,480,480,72,72,0,1,0
8,482,482,1,1,0,1,0
22,491,491,16,3,13,2,1
11,497,497,100,61,39,4,3

6,103,103,1,1,0,1,0
18,113,113,7,1,6,3,2
2,122,122,4,4,0,1,0
19,135,135,17,17,0,1,0
11,198,198,3,3,0,1,0
14,200,200,17,1,16,2,1
0,217,217,17,17,0,1,0
7,226,226,98,65,33,2,1
9,234,234,6,6,0,1,0
10,261,261,16,16,0,1,0
1,266,266,41,41,0,1,0
8,269,269,7,7,0,1,0
5,269,269,68,68,0,1,0
13,272,272,11,7,4,2,1
12,280,280,33,33,0,1,0
4,297,297,5,5,0,1,0
22,338,338,28,8,20,2,1
15,378,378,3,3,0,1,0
21,387,387,132,132,0,1,0
16,401,401,38,21,17,2,1
17,439,439,47,6,41,2,1
3,456,456,50,44,6,2,1
20,461,461,69,41,28,3,2

6,109,109,8,8,0,1,0
18,127,127,5,2,3,2,1
1,128,128,18,14,4,2,1
22,149,149,1,1,0,1,0
10,161,161,1,1,0,1,0
0,164,164,7,7,0,1,0
15,171,171,12,12,0,1,0
19,180,180,1,1,0,1,0
25,192,192,23,10,13,2,1
24,193,193,16,16,0,1,0
5,203,203,37,37,0,1,0
7,214,214,1,1,0,1,0
2,252,252,13,5,8,2,1
8,258,258,5,2,3,2,1
21,277,277,5,5,0,1,0
3,282,282,49,49,0,1,0
9,291,291,7,2,5,2,1
11,316,316,66,18,48,2,1
20,328,328,16,16,0,1,0
14,332,332,39,39,0,1,0
13,371,371,5,1,4,2,1
26,381,381,2,2,0,1,0
12,394,394,25,4,21,2,1
4,396,396,32,6,26,3,2
16,432,432,173,147,26,3,2
17,438,438,156,88,68,3,2
23,459,459,33,1,32,2,1

9,134,134,9,6,3,2,1
4,140,140,18,18,0,1,0
22,146,146,1,1,0,1,0
24,158,158,12,7,5,2,1
12,170,170,7,1,6,2,1
21,182,182,20,20,0,1,0
18,191,191,11,2,9,4,3
20,228,228,13,5,8,3,2
7,254,254,24,24,0,1,0
14,280,280,27,4,23,2,1
2,332,332,45,2,43,4,3
10,350,350,12,3,9,2,1
1,350,350,7,7,0,1,0
0,369,369,19,19,0,1,0
6,374,374,31,4,27,2,1
13,378,378,3,3,0,1,0
23,400,400,16,16,0,1,0
15,420,420,143,54,89,4,3
3,425,425,117,117,0,1,0
11,434,434,53,23,30,3,2
19,437,437,67,67,0,1,0
16,445,445,26,26,0,1,0
25,458,458,46,46,0,1,0
5,462,462,22,2,20,3,2
17,469,469,59,25,34,2,1
8,478,478,44,44,0,1,0

21,118,118,14,14,0,1,0
19,128,128,9,5,4,2,1
1,185,185,33,33,0,1,0
18,191,191,41,12,29,2,1
5,192,192,20,5,15,2,1
25,207,207,10,10,0,1,0
20,208,208,3,3,0,1,0
10,250,250,22,22,0,1,0
17,265,265,57,18,39,3,2
22,303,303,28,28,0,1,0
11,312,312,31,2,29,3,2
13,312,312,11,11,0,1,0
16,322,322,2,2,0,1,0
6,325,325,10,5,5,2,1
12,340,340,39,39,0,1,0
9,351,351,27,27,0,1,0
14,366,366,12,12,0,1,0
23,379,379,64,24,40,3,2
15,391,391,11,4,7,2,1
2,403,403,55,55,0,1,0
8,419,419,33,33,0,1,0
24,425,425,11,11,0,1,0
7,447,447,7,7,0,1,0
0,463,463,84,80,4,2,1
26,471,471,105,65,40,2,1
3,486,486,13,1,12,4,3
4,488,488,1,1,0,1,0

4,123,123,1,1,0,1,0
9,156,156,2,2,0,1,0
12,164,164,7,4,3,2,1
21,190,190,5,5,0,1,0
14,199,199,13,2,11,2,1
1,202,202,12,12,0,1,0
5,214,214,16,16,0,1,0
20,237,237,2,2,0,1,0
28,239,239,2,2,0,1,0
23,252,252,6,6,0,1,0
15,276,276,61,39,22,3,2
27,282,282,28,1,27,4,3
16,282,282,3,3,0,1,0
24,306,306,64,64,0,1,0
7,340,340,2,2,0,1,0
0,342,342,69,32,37,2,1
10,344,344,43,28,15,2,1
26,366,366,60,60,0,1,0
11,371,371,7,1,6,3,2
8,379,379,57,37,20,3,2
22,391,391,22,13,9,4,3
18,416,416,17,17,0,1,0
25,420,420,129,71,58,3,2
19,434,434,63,63,0,1,0
2,459,459,29,29,0,1,0
3,464,464,12,12,0,1,0
6,471,471,46,46,0,1,0
13,498,498,10,1,9,2,1
17,500,500,67,67,0,1,0

4,118,118,1,1,0,1,0
19,156,156,33,33,0,1,0
5,164,164,4,4,0,1,0
10,182,182,5,5,0,1,0
17,196,196,20,4,16,3,2
9,199,199,22,1,21,2,1
1,202,202,20,20,0,1,0
18,221,221,18,14,4,2,1
15,230,230,6,6,0,1,0
7,239,239,35,8,27,2,1
13,300,300,9,1,8,2,1
8,306,306,116,58,58,3,2
11,307,307,69,69,0,1,0
16,309,309,8,8,0,1,0
20,324,324,31,31,0,1,0
3,326,326,9,6,3,2,1
0,355,355,39,7,32,3,2
6,388,388,96,18,78,4,3
21,391,391,40,40,0,1,0
22,391,391,23,23,0,1,0
2,422,422,10,1,9,2,1
12,469,469,74,20,54,4,3
14,470,470,52,3,49,3,2

5,173,173,28,28,0,1,0
12,183,183,8,1,7,2,1
15,185,185,8,2,6,3,2
1,229,229,35,27,8,2,1
8,256,256,38,38,0,1,0
14,287,287,6,6,0,1,0
19,293,293,14,7,7,2,1
10,325,325,20,2,18,2,1
2,349,349,99,87,12,2,1
16,377,377,4,4,0,1,0
13,381,381,28,28,0,1,0
17,389,389,46,27,19,2,1
18,405,405,246,150,96,4,3
6,410,410,10,1,9,4,3
4,418,418,8,8,0,1,0
7,427,427,3,3,0,1,0
11,470,470,1,1,0,1,0
0,473,473,85,85,0,1,0
9,479,479,21,21,0,1,0
3,485,485,181,161,20,2,1

14,134,134,10,10,0,1,0
13,134,134,3,3,0,1,0
20,134,134,1,1,0,1,0
5,139,139,12,9,3,2,1
2,142,142,8,8,0,1,0
16,157,157,8,3,5,2,1
4,170,170,1,1,0,1,0
12,172,172,47,47,0,1,0
3,178,178,7,7,0,1,0
8,207,207,19,3,16,2,1
0,211,211,30,20,10,2,1
11,229,229,9,9,0,1,0
18,252,252,74,29,45,4,3
17,269,269,69,31,38,3,2
19,274,274,18,5,13,2,1
15,290,290,36,6,30,3,2
6,295,295,45,15,30,3,2
21,330,330,5,5,0,1,0
10,359,359,25,25,0,1,0
1,369,369,42,22,20,2,1
7,401,401,107,59,48,4,3
23,425,425,11,5,6,3,2
9,434,434,60,39,21,2,1
22,436,436,8,4,4,2,1

24,104,104,19,19,0,1,0
15,144,144,4,1,3,2,1
20,149,149,10,10,0,1,0
23,152,152,8,8,0,1,0
7,184,184,7,7,0,1,0
13,187,187,12,12,0,1,0
22,221,221,11,3,8,2,1
5,238,238,1,1,0,1,0
6,260,260,82,16,66,3,2
10,281,281,8,4,4,2,1
0,288,288,87,12,75,4,3
25,330,330,5,5,0,1,0
2,350,350,5,1,4,2,1
14,361,361,26,8,18,3,2
16,362,362,12,5,7,2,1
4,364,364,1,1,0,1,0
8,370,370,39,39,0,1,0
12,386,386,1,1,0,1,0
9,394,394,1,1,0,1,0
1,426,426,56,14,42,4,3
17,450,450,178,82,96,3,2
18,472,472,7,7,0,1,0
26,478,478,124,124,0,1,0
21,481,481,30,30,0,1,0
19,483,483,35,15,20,3,2
11,496,496,42,42,0,1,0
3,496,496,17,4,13,2,1

22,161,161,26,8,18,2,1
24,181,181,2,2,0,1,0
13,198,198,2,2,0,1,0
20,215,215,20,4,16,2,1
8,230,230,29,29,0,1,0
5,252,252,1,1,0,1,0
9,256,256,15,15,0,1,0
26,266,266,8,8,0,1,0
28,290,290,121,45,76,3,2
12,300,300,27,27,0,1,0
0,329,329,4,4,0,1,0
19,341,341,4,1,3,2,1
4,348,348,8,8,0,1,0
7,352,352,1,1,0,1,0
1,375,375,28,10,18,4,3
18,376,376,23,6,17,2,1
16,395,395,35,9,26,3,2
14,396,396,39,5,34,3,2
17,397,397,16,11,5,2,1
23,419,419,37,31,6,3,2
11,427,427,136,136,0,1,0
6,429,429,55,55,0,1,0
10,432,432,22,22,0,1,0
25,445,445,4,1,3,2,1
2,446,446,7,7,0,1,0
27,450,450,125,17,108,4,3
3,451,451,10,2,8,3,2
15,464,464,36,36,0,1,0
21,482,482,8,8,0,1,0

21,105,105,14,8,6,3,2
0,136,136,41,5,36,3,2
22,143,143,3,3,0,1,0
19,145,145,8,2,6,3,2
20,161,161,19,19,0,1,0
11,169,169,15,3,12,2,1
6,179,179,3,3,0,1,0
14,192,192,20,20,0,1,0
16,196,196,5,1,4,2,1
23,212,212,19,11,8,3,2
12,223,223,6,6,0,1,0
13,234,234,22,3,19,2,1
10,260,260,55,55,0,1,0
18,322,322,7,7,0,1,0
7,330,330,18,11,7,2,1
4,345,345,60,60,0,1,0
9,381,381,1,1,0,1,0
8,381,381,44,12,32,2,1
5,394,394,5,5,0,1,0
3,401,401,24,24,0,1,0
2,421,421,17,17,0,1,0
1,462,462,59,53,6,2,1
17,462,462,191,158,33,4,3
15,497,497,62,12,50,3,2

13,117,117,7,7,0,1,0
1,124,124,5,5,0,1,0
8,125,125,6,6,0,1,0
5,136,136,19,1,18,3,2
17,153,153,13,13,0,1,0
24,162,162,4,4,0,1,0
3,198,198,5,5,0,1,0
20,204,204,4,4,0,1,0
0,214,214,81,1,80,3,2
10,258,258,1,1,0,1,0
7,279,279,38,38,0,1,0
15,283,283,62,23,39,4,3
12,291,291,7,7,0,1,0
25,302,302,22,7,15,4,3
14,303,303,18,18,0,1,0
2,331,331,33,33,0,1,0
22,346,346,40,40,0,1,0
26,369,369,97,52,45,2,1
21,380,380,4,4,0,1,0
9,384,384,11,8,3,2,1
18,433,433,20,20,0,1,0
6,449,449,27,27,0,1,0
19,473,473,3,3,0,1,0
23,475,475,130,52,78,4,3
4,486,486,29,5,24,3,2
16,494,494,40,35,5,2,1
11,495,495,19,19,0,1,0

2,138,138,1,1,0,1,0
8,138,138,6,1,5,2,1
4,157,157,11,2,9,4,3
15,177,177,7,1,6,3,2
0,178,178,3,3,0,1,0
25,182,182,24,3,21,2,1
1,194,194,48,48,0,1,0
14,206,206,9,1,8,2,1
5,209,209,6,1,5,2,1
16,232,232,30,30,0,1,0
12,253,253,9,2,7,2,1
13,265,265,61,28,33,2,1
9,274,274,42,22,20,3,2
23,328,328,21,3,18,3,2
21,335,335,56,56,0,1,0
19,359,359,52,52,0,1,0
18,384,384,4,4,0,1,0
7,404,404,1,1,0,1,0
17,414,414,97,97,0,1,0
20,415,415,39,25,14,2,1
24,418,418,23,23,0,1,0
10,435,435,75,63,12,4,3
6,439,439,20,20,0,1,0
3,445,445,12,6,6,2,1
22,452,452,62,35,27,4,3
26,487,487,7,7,0,1,0
11,500,500,39,39,0,1,0

3,107,107,7,1,6,3,2
7,137,137,4,4,0,1,0
6,182,182,10,10,0,1,0
2,187,187,1,1,0,1,0
19,212,212,8,8,0,1,0
10,235,235,15,15,0,1,0
8,265,265,151,151,0,1,0
12,276,276,7,7,0,1,0
18,299,299,8,2,6,3,2
15,326,326,25,14,11,3,2
4,369,369,67,67,0,1,0
16,392,392,2,2,0,1,0
11,399,399,116,91,25,2,1
13,406,406,31,1,30,4,3
14,417,417,15,15,0,1,0
5,429,429,73,39,34,3,2
20,440,440,62,62,0,1,0
17,443,443,65,65,0,1,0
0,455,455,26,9,17,4,3
1,484,484,33,33,0,1,0
9,488,488,142,48,94,4,3

3,101,101,7,1,6,3,2
2,132,132,14,2,12,4,3
1,142,142,17,17,0,1,0
17,143,143,2,2,0,1,0
22,173,173,5,5,0,1,0
5,211,211,22,22,0,1,0
4,229,229,57,57,0,1,0
6,233,233,16,16,0,1,0
8,270,270,59,59,0,1,0
7,294,294,6,6,0,1,0
12,307,307,3,3,0,1,0
18,349,349,10,10,0,1,0
20,356,356,69,15,54,3,2
13,362,362,20,4,16,2,1
16,362,362,104,89,15,2,1
14,380,380,20,2,18,3,2
0,413,413,93,47,46,4,3
9,450,450,8,8,0,1,0
11,480,480,8,8,0,1,0
21,488,488,44,9,35,2,1
10,489,489,1,1,0,1,0
19,492,492,101,20,81,4,3
15,500,500,118,40,78,4,3

20,108,108,10,3,7,2,1
10,116,116,3,3,0,1,0
12,184,184,5,5,0,1,0
13,192,192,1,1,0,1,0
0,196,196,15,7,8,2,1
17,208,208,3,3,0,1,0
26,210,210,97,85,12,2,1
1,215,215,7,7,0,1,0
14,242,242,38,23,15,4,3
19,264,264,1,1,0,1,0
5,272,272,9,2,7,2,1
23,276,276,6,2,4,2,1
9,315,315,20,20,0,1,0
6,323,323,71,71,0,1,0
11,324,324,11,11,0,1,0
7,340,340,87,5,82,4,3
22,348,348,25,25,0,1,0
8,351,351,27,21,6,2,1
15,377,377,37,37,0,1,0
21,416,416,31,31,0,1,0
3,425,425,46,46,0,1,0
18,434,434,48,48,0,1,0
4,454,454,24,24,0,1,0
16,465,465,81,33,48,2,1
2,476,476,15,8,7,3,2
25,478,478,32,32,0,1,0
24,486,486,18,3,15,2,1

21,113,113,2,2,0,1,0
12,155,155,14,14,0,1,0
22,225,225,1,1,0,1,0
11,231,231,1,1,0,1,0
4,231,231,2,2,0,1,0
15,244,244,2,2,0,1,0
8,247,247,55,9,46,2,1
16,268,268,23,10,13,2,1
18,300,300,36,36,0,1,0
0,325,325,54,9,45,4,3
13,338,338,148,26,122,4,3
1,389,389,30,30,0,1,0
5,408,408,7,7,0,1,0
9,411,411,20,8,12,2,1
2,415,415,9,9,0,1,0
6,417,417,24,19,5,2,1
14,429,429,57,18,39,4,3
20,430,430,120,114,6,3,2
19,432,432,7,1,6,2,1
7,434,434,67,1,66,4,3
17,441,441,9,9,0,1,0
10,443,443,17,17,0,1,0
3,443,443,172,172,0,1,0

16,102,102,3,3,0,1,0
14,114,114,14,4,10,3,2
17,124,124,17,5,12,4,3
19,129,129,10,4,6,2,1
2,154,154,31,31,0,1,0
24,178,178,6,6,0,1,0
7,186,186,24,24,0,1,0
22,198,198,27,9,18,2,1
1,217,217,8,8,0,1,0
20,255,255,9,9,0,1,0
6,272,272,3,3,0,1,0
10,274,274,3,3,0,1,0
4,283,283,5,5,0,1,0
5,308,308,9,9,0,1,0
15,323,323,92,92,0,1,0
11,329,329,18,1,17,2,1
8,334,334,32,20,12,4,3
9,356,356,110,65,45,4,3
12,388,388,63,63,0,1,0
3,403,403,45,24,21,4,3
21,415,415,4,4,0,1,0
0,421,421,13,13,0,1,0
23,444,444,74,58,16,2,1
13,445,445,28,28,0,1,0
18,468,468,67,9,58,4,3

4,135,135,2,2,0,1,0
3,137,137,1,1,0,1,0
8,156,156,4,4,0,1,0
14,159,159,29,10,19,2,1
16,199,199,89,53,36,2,1
9,200,200,57,43,14,2,1
21,201,201,12,12,0,1,0
20,248,248,35,13,22,2,1
15,253,253,1,1,0,1,0
23,259,259,12,12,0,1,0
5,264,264,9,5,4,2,1
24,279,279,4,1,3,2,1
18,327,327,4,4,0,1,0
0,341,341,13,4,9,4,3
11,357,357,14,14,0,1,0
22,366,366,44,4,40,2,1
7,379,379,23,12,11,2,1
1,385,385,31,2,29,4,3
17,387,387,14,6,8,3,2
10,421,421,196,133,63,4,3
19,434,434,62,31,31,4,3
12,463,463,41,41,0,1,0
2,465,465,7,7,0,1,0
13,476,476,8,8,0,1,0
6,500,500,23,17,6,3,2

4,106,106,2,2,0,1,0
15,124,124,7,1,6,2,1
17,133,133,23,23,0,1,0
13,139,139,6,6,0,1,0
14,173,173,30,1,29,2,1
2,176,176,15,10,5,2,1
18,191,191,11,7,4,2,1
12,216,216,1,1,0,1,0
8,226,226,26,20,6,3,2
1,237,237,4,4,0,1,0
0,243,243,34,34,0,1,0
19,255,255,18,6,12,3,2
16,266,266,62,62,0,1,0
20,282,282,27,27,0,1,0
22,306,306,4,4,0,1,0
24,312,312,5,2,3,2,1
7,314,314,45,26,19,4,3
23,324,324,55,1,54,3,2
6,352,352,74,25,49,2,1
11,378,378,2,2,0,1,0
21,399,399,51,27,24,2,1
10,419,419,53,53,0,1,0
9,419,419,45,15,30,3,2
3,454,454,50,50,0,1,0
5,471,471,57,12,45,4,3

22,103,103,15,15,0,1,0
15,104,104,4,4,0,1,0
17,120,120,3,3,0,1,0
7,140,140,43,43,0,1,0
3,148,148,6,6,0,1,0
6,172,172,1,1,0,1,0
0,199,199,3,3,0,1,0
10,210,210,28,14,14,2,1
1,215,215,5,5,0,1,0
20,219,219,51,51,0,1,0
5,238,238,24,9,15,4,3
23,282,282,27,6,21,2,1
19,287,287,20,20,0,1,0
9,299,299,111,111,0,1,0
8,349,349,5,5,0,1,0
4,373,373,3,3,0,1,0
14,381,381,43,33,10,3,2
18,392,392,54,32,22,2,1
21,414,414,62,13,49,2,1
2,447,447,18,6,12,2,1
13,477,477,21,21,0,1,0
12,486,486,81,19,62,3,2
11,490,490,69,69,0,1,0
16,496,496,5,5,0,1,0

11,118,118,15,3,12,4,3
1,138,138,19,19,0,1,0
21,146,146,3,3,0,1,0
20,171,171,4,4,0,1,0
13,183,183,8,8,0,1,0
6,187,187,35,16,19,2,1
0,191,191,2,2,0,1,0
7,220,220,22,22,0,1,0
5,222,222,11,11,0,1,0
23,243,243,1,1,0,1,0
16,244,244,14,14,0,1,0
3,259,259,14,14,0,1,0
24,276,276,169,169,0,1,0
12,288,288,1,1,0,1,0
8,302,302,31,31,0,1,0
2,329,329,7,2,5,2,1
10,365,365,34,2,32,3,2
17,374,374,14,11,3,2,1
18,381,381,38,38,0,1,0
9,410,410,64,64,0,1,0
14,421,421,29,29,0,1,0
4,451,451,71,71,0,1,0
15,472,472,74,74,0,1,0
22,482,482,23,8,15,2,1
19,489,489,24,24,0,1,0

16,101,101,5,1,4,2,1
5,141,141,6,2,4,2,1
18,167,167,15,6,9,4,3
8,173,173,9,9,0,1,0
14,200,200,27,9,18,3,2
12,226,226,28,28,0,1,0
10,235,235,10,1,9,2,1
7,236,236,34,34,0,1,0
13,247,247,35,9,26,4,3
6,323,323,30,3,27,2,1
15,356,356,5,1,4,2,1
2,377,377,200,200,0,1,0
3,385,385,54,25,29,2,1
11,386,386,42,17,25,2,1
0,396,396,16,6,10,3,2
17,398,398,29,15,14,3,2
4,412,412,53,19,34,3,2
1,427,427,97,70,27,4,3
9,442,442,113,31,82,3,2

16,108,108,24,15,9,2,1
12,121,121,8,1,7,2,1
2,127,127,3,3,0,1,0
25,139,139,15,15,0,1,0
15,149,149,1,1,0,1,0
19,154,154,29,12,17,2,1
26,156,156,8,8,0,1,0
20,157,157,22,1,21,3,2
13,164,164,9,9,0,1,0
21,176,176,3,3,0,1,0
6,178,178,9,9,0,1,0
22,199,199,13,13,0,1,0
29,200,200,47,15,32,2,1
27,223,223,42,42,0,1,0
17,237,237,16,16,0,1,0
5,250,250,13,13,0,1,0
23,290,290,22,22,0,1,0
28,294,294,6,6,0,1,0
18,312,312,40,12,28,3,2
14,353,353,52,22,30,4,3
7,366,366,34,6,28,2,1
24,367,367,5,5,0,1,0
8,379,379,5,1,4,2,1
4,433,433,56,39,17,2,1
3,457,457,5,5,0,1,0
0,466,466,15,8,7,2,1
1,470,470,6,6,0,1,0
11,472,472,37,37,0,1,0
9,481,481,34,18,16,3,2
10,495,495,35,16,19,3,2

1,137,137,11,6,5,2,1
8,143,143,12,12,0,1,0
0,193,193,28,28,0,1,0
11,205,205,4,4,0,1,0
5,215,215,4,1,3,2,1
14,224,224,1,1,0,1,0
13,228,228,10,10,0,1,0
19,250,250,6,6,0,1,0
7,260,260,49,49,0,1,0
21,312,312,33,33,0,1,0
3,314,314,3,3,0,1,0
25,330,330,65,65,0,1,0
15,336,336,10,1,9,2,1
23,340,340,11,2,9,4,3
17,358,358,26,26,0,1,0
22,375,375,109,63,46,4,3
18,383,383,66,66,0,1,0
6,388,388,88,11,77,4,3
9,403,403,2,2,0,1,0
2,404,404,8,8,0,1,0
10,410,410,102,102,0,1,0
12,420,420,7,1,6,2,1
24,423,423,39,32,7,2,1
20,433,433,84,57,27,2,1
16,468,468,1,1,0,1,0
4,476,476,46,46,0,1,0

5,114,114,25,10,15,2,1
19,129,129,36,36,0,1,0
18,130,130,5,5,0,1,0
6,132,132,19,11,8,2,1
3,136,136,19,19,0,1,0
15,141,141,6,6,0,1,0
22,160,160,4,4,0,1,0
2,163,163,2,2,0,1,0
14,173,173,25,25,0,1,0
17,174,174,15,3,12,2,1
4,175,175,44,44,0,1,0
11,182,182,1,1,0,1,0
7,214,214,1,1,0,1,0
12,221,221,4,4,0,1,0
25,251,251,43,43,0,1,0
1,259,259,6,6,0,1,0
24,264,264,15,15,0,1,0
10,281,281,28,7,21,2,1
0,299,299,24,24,0,1,0
23,302,302,21,9,12,4,3
20,304,304,21,1,20,2,1
13,314,314,6,6,0,1,0
16,334,334,78,46,32,2,1
9,346,346,48,34,14,3,2
8,384,384,17,1,16,4,3
21,418,418,9,9,0,1,0

20,100,100,16,16,0,1,0
25,112,112,4,4,0,1,0
3,119,119,17,3,14,3,2
6,173,173,7,7,0,1,0
5,180,180,22,10,12,4,3
19,207,207,10,6,4,2,1
12,229,229,3,3,0,1,0
7,243,243,4,1,3,2,1
9,283,283,18,18,0,1,0
23,284,284,21,14,7,2,1
16,304,304,65,65,0,1,0
17,322,322,22,7,15,4,3
18,335,335,132,69,63,4,3
11,358,358,9,9,0,1,0
22,365,365,16,4,12,3,2
14,376,376,11,11,0,1,0
0,391,391,143,143,0,1,0
8,425,425,13,5,8,2,1
4,429,429,5,5,0,1,0
10,434,434,12,3,9,4,3
24,461,461,7,7,0,1,0
21,472,472,18,18,0,1,0
1,479,479,7,7,0,1,0
13,480,480,103,103,0,1,0
15,487,487,51,8,43,2,1
2,490,490,55,55,0,1,0

14,105,105,21,21,0,1,0
5,166,166,32,32,0,1,0
17,181,181,37,32,5,2,1
3,192,192,8,8,0,1,0
15,196,196,13,13,0,1,0
4,224,224,15,1,14,2,1
12,232,232,52,52,0,1,0
11,265,265,12,12,0,1,0
8,267,267,12,12,0,1,0
10,319,319,30,30,0,1,0
2,336,336,10,10,0,1,0
0,340,340,177,119,58,3,2
9,342,342,9,9,0,1,0
7,363,363,16,16,0,1,0
13,365,365,46,10,36,2,1
6,436,436,103,63,40,2,1
1,442,442,50,9,41,2,1
18,463,463,59,17,42,2,1
16,499,499,11,11,0,1,0

8,103,103,15,15,0,1,0
0,111,111,1,1,0,1,0
4,139,139,21,21,0,1,0
3,140,140,17,10,7,2,1
18,151,151,4,4,0,1,0
1,186,186,2,2,0,1,0
20,200,200,3,3,0,1,0
17,222,222,19,13,6,2,1
9,246,246,10,10,0,1,0
21,272,272,21,8,13,2,1
22,278,278,14,8,6,2,1
2,284,284,21,21,0,1,0
5,298,298,1,1,0,1,0
11,329,329,28,3,25,3,2
13,360,360,19,19,0,1,0
19,372,372,163,37,126,4,3
15,381,381,6,6,0,1,0
12,387,387,5,1,4,2,1
7,394,394,13,13,0,1,0
6,407,407,48,48,0,1,0
16,431,431,68,26,42,4,3
10,450,450,222,214,8,2,1
14,492,492,100,88,12,2,1

2,105,105,3,3,0,1,0
7,117,117,1,1,0,1,0
22,131,131,7,7,0,1,0
4,138,138,7,3,4,2,1
10,143,143,30,30,0,1,0
16,154,154,3,3,0,1,0
26,177,177,11,2,9,4,3
28,182,182,25,25,0,1,0
3,186,186,4,4,0,1,0
19,196,196,4,4,0,1,0
5,212,212,17,17,0,1,0
18,212,212,59,38,21,3,2
27,222,222,45,29,16,3,2
0,222,222,28,1,27,2,1
6,237,237,49,49,0,1,0
8,279,279,5,1,4,2,1
15,284,284,8,3,5,2,1
25,300,300,1,1,0,1,0
14,309,309,9,9,0,1,0
1,329,329,1,1,0,1,0
9,353,353,6,2,4,2,1
24,353,353,11,11,0,1,0
17,364,364,10,10,0,1,0
20,373,373,25,9,16,2,1
21,377,377,30,21,9,4,3
12,410,410,94,19,75,4,3
23,438,438,57,6,51,4,3
29,438,438,67,55,12,4,3
13,473,473,42,42,0,1,0
11,497,497,4,4,0,1,0

19,106,106,7,2,5,2,1
23,122,122,13,13,0,1,0
22,132,132,11,11,0,1,0
27,139,139,2,2,0,1,0
5,190,190,14,14,0,1,0
24,192,192,5,5,0,1,0
14,228,228,14,14,0,1,0
13,248,248,33,11,22,2,1
17,255,255,82,82,0,1,0
26,318,318,72,72,0,1,0
3,321,321,16,5,11,3,2
6,324,324,7,2,5,2,1
18,324,324,23,23,0,1,0
1,326,326,13,4,9,4,3
12,334,334,83,26,57,4,3
20,360,360,11,7,4,2,1
25,371,371,31,6,25,4,3
9,380,380,5,5,0,1,0
2,382,382,66,27,39,4,3
0,384,384,25,25,0,1,0
10,392,392,42,42,0,1,0
11,396,396,12,12,0,1,0
7,405,405,1,1,0,1,0
21,406,406,9,2,7,2,1
8,417,417,1,1,0,1,0
4,432,432,23,5,18,2,1
16,434,434,72,46,26,4,3
15,491,491,62,20,42,4,3

21,108,108,13,10,3,2,1
18,120,120,5,5,0,1,0
15,123,123,19,6,13,2,1
4,126,126,6,6,0,1,0
20,135,135,25,1,24,2,1
6,144,144,37,15,22,2,1
2,174,174,10,10,0,1,0
9,218,218,3,3,0,1,0
3,224,224,20,10,10,3,2
12,240,240,10,10,0,1,0
8,249,249,5,5,0,1,0
5,254,254,69,69,0,1,0
0,296,296,22,3,19,2,1
16,307,307,34,34,0,1,0
11,331,331,21,21,0,1,0
1,347,347,6,2,4,2,1
19,347,347,1,1,0,1,0
7,369,369,130,130,0,1,0
10,392,392,17,17,0,1,0
17,408,408,91,34,57,4,3
13,463,463,39,39,0,1,0
14,487,487,79,79,0,1,0

6,113,113,2,2,0,1,0
16,114,114,4,4,0,1,0
18,120,120,11,5,6,3,2
0,126,126,10,4,6,2,1
14,130,130,12,12,0,1,0
24,153,153,9,9,0,1,0
21,157,157,10,10,0,1,0
23,162,162,7,7,0,1,0
10,221,221,7,7,0,1,0
2,229,229,18,9,9,4,3
1,231,231,7,7,0,1,0
15,267,267,22,22,0,1,0
5,287,287,27,27,0,1,0
8,312,312,35,8,27,2,1
13,317,317,34,34,0,1,0
12,325,325,16,16,0,1,0
20,329,329,83,23,60,3,2
9,363,363,71,25,46,3,2
19,373,373,45,24,21,2,1
4,380,380,5,5,0,1,0
26,406,406,1,1,0,1,0
7,423,423,2,2,0,1,0
3,436,436,114,22,92,4,3
22,465,465,91,9,82,4,3
25,473,473,32,23,9,2,1
11,498,498,19,19,0,1,0
17,499,499,102,82,20,3,2

19,101,101,3,3,0,1,0
18,131,131,2,2,0,1,0
10,143,143,2,2,0,1,0
12,210,210,27,6,21,4,3
9,228,228,56,5,51,4,3
4,234,234,4,4,0,1,0
7,250,250,28,4,24,4,3
3,258,258,63,45,18,3,2
17,261,261,44,32,12,2,1
8,269,269,8,8,0,1,0
15,285,285,53,39,14,3,2
2,293,293,25,25,0,1,0
11,305,305,16,16,0,1,0
6,328,328,49,33,16,2,1
5,378,378,18,6,12,3,2
21,388,388,133,59,74,3,2
0,404,404,79,43,36,4,3
14,427,427,53,25,28,2,1
20,429,429,52,13,39,4,3
16,448,448,9,9,0,1,0
1,450,450,35,15,20,3,2
13,474,474,12,12,0,1,0

14,105,105,4,4,0,1,0
7,136,136,10,6,4,2,1
20,201,201,22,7,15,2,1
11,202,202,28,19,9,4,3
22,207,207,20,11,9,2,1
15,210,210,65,65,0,1,0
5,211,211,6,6,0,1,0
2,214,214,18,18,0,1,0
0,222,222,19,1,18,2,1
16,250,250,21,1,20,4,3
13,261,261,19,19,0,1,0
9,263,263,62,19,43,2,1
6,376,376,14,14,0,1,0
1,378,378,1,1,0,1,0
18,396,396,18,2,16,3,2
10,402,402,5,5,0,1,0
8,412,412,33,33,0,1,0
21,434,434,39,39,0,1,0
23,448,448,84,45,39,3,2
3,450,450,186,108,78,3,2
12,453,453,6,6,0,1,0
4,466,466,6,6,0,1,0
17,467,467,4,4,0,1,0
19,486,486,81,46,35,2,1

10,126,126,10,10,0,1,0
16,132,132,10,10,0,1,0
4,168,168,8,8,0,1,0
1,172,172,18,18,0,1,0
20,203,203,17,17,0,1,0
15,209,209,6,6,0,1,0
14,209,209,3,3,0,1,0
17,255,255,74,40,34,3,2
5,263,263,6,6,0,1,0
2,284,284,1,1,0,1,0
18,326,326,39,7,32,2,1
6,333,333,51,51,0,1,0
13,367,367,21,21,0,1,0
7,378,378,77,15,62,3,2
0,390,390,82,82,0,1,0
8,398,398,145,145,0,1,0
11,407,407,17,4,13,4,3
9,417,417,49,49,0,1,0
19,437,437,68,68,0,1,0
12,465,465,77,68,9,4,3
3,466,466,42,42,0,1,0

4,115,115,6,6,0,1,0
15,118,118,21,21,0,1,0
11,151,151,1,1,0,1,0
7,165,165,11,11,0,1,0
18,184,184,2,2,0,1,0
5,243,243,92,36,56,4,3
6,311,311,9,9,0,1,0
12,313,313,32,32,0,1,0
17,320,320,24,24,0,1,0
9,334,334,47,47,0,1,0
10,351,351,20,20,0,1,0
2,352,352,8,8,0,1,0
19,406,406,30,30,0,1,0
13,416,416,24,24,0,1,0
16,416,416,27,27,0,1,0
8,424,424,30,22,8,3,2
20,432,432,14,6,8,2,1
0,434,434,112,29,83,4,3
3,442,442,28,4,24,2,1
14,497,497,210,210,0,1,0
1,500,500,130,94,36,4,3

6,120,120,1,1,0,1,0
7,146,146,58,58,0,1,0
22,156,156,11,2,9,2,1
12,169,169,1,1,0,1,0
11,178,178,47,21,26,4,3
4,189,189,3,3,0,1,0
16,197,197,14,4,10,3,2
0,198,198,5,2,3,2,1
18,207,207,9,9,0,1,0
14,283,283,9,9,0,1,0
9,288,288,1,1,0,1,0
20,289,289,38,38,0,1,0
15,291,291,98,20,78,4,3
5,312,312,22,22,0,1,0
2,339,339,11,11,0,1,0
21,357,357,100,58,42,3,2
19,371,371,3,3,0,1,0
10,383,383,21,12,9,2,1
17,390,390,60,60,0,1,0
13,404,404,17,17,0,1,0
23,424,424,15,1,14,2,1
1,462,462,32,32,0,1,0
25,465,465,26,26,0,1,0
3,467,467,71,19,52,3,2
8,492,492,30,30,0,1,0
24,497,497,1,1,0,1,0

8,143,143,2,2,0,1,0
14,146,146,1,1,0,1,0
2,163,163,1,1,0,1,0
21,169,169,5,5,0,1,0
3,177,177,7,2,5,2,1
22,187,187,37,37,0,1,0
15,205,205,22,18,4,2,1
5,261,261,8,8,0,1,0
12,264,264,34,2,32,3,2
17,264,264,39,39,0,1,0
19,273,273,20,20,0,1,0
1,289,289,10,10,0,1,0
6,301,301,55,55,0,1,0
20,340,340,15,15,0,1,0
9,354,354,67,17,50,4,3
7,371,371,10,3,7,2,1
4,387,387,63,63,0,1,0
0,387,387,98,5,93,4,3
18,389,389,4,4,0,1,0
16,395,395,109,10,99,4,3
10,418,418,52,4,48,2,1
11,446,446,61,61,0,1,0
13,451,451,47,47,0,1,0
23,472,472,47,47,0,1,0

15,105,105,7,7,0,1,0
17,115,115,3,3,0,1,0
10,116,116,12,1,11,2,1
18,125,125,4,4,0,1,0
23,150,150,44,5,39,2,1
7,166,166,34,23,11,2,1
6,166,166,12,8,4,2,1
12,178,178,4,4,0,1,0
20,187,187,39,39,0,1,0
9,191,191,18,18,0,1,0
24,214,214,13,13,0,1,0
21,243,243,46,46,0,1,0
2,252,252,3,3,0,1,0
14,295,295,21,21,0,1,0
22,339,339,9,9,0,1,0
19,339,339,66,66,0,1,0
25,352,352,18,18,0,1,0
1,353,353,13,13,0,1,0
0,356,356,15,15,0,1,0
16,365,365,3,3,0,1,0
8,372,372,32,16,16,3,2
13,388,388,22,22,0,1,0
4,402,402,9,9,0,1,0
3,424,424,34,34,0,1,0
11,457,457,126,66,60,4,3
5,497,497,46,22,24,4,3

11,107,107,15,11,4,2,1
10,115,115,7,7,0,1,0
7,147,147,2,2,0,1,0
16,167,167,6,6,0,1,0
6,172,172,35,35,0,1,0
4,189,189,75,75,0,1,0
2,203,203,20,5,15,4,3
13,207,207,10,3,7,2,1
17,214,214,73,46,27,2,1
18,231,231,22,22,0,1,0
1,246,246,19,19,0,1,0
15,263,263,29,29,0,1,0
5,272,272,48,48,0,1,0
14,280,280,26,26,0,1,0
12,294,294,30,13,17,2,1
3,339,339,24,24,0,1,0
0,367,367,66,18,48,4,3
8,386,386,23,13,10,3,2
9,491,491,63,63,0,1,0

1,117,117,1,1,0,1,0
16,141,141,17,9,8,2,1
3,142,142,42,21,21,3,2
12,175,175,3,3,0,1,0
18,190,190,9,9,0,1,0
13,204,204,45,27,18,3,2
0,231,231,42,15,27,2,1
10,247,247,19,3,16,4,3
14,252,252,4,4,0,1,0
8,254,254,5,5,0,1,0
19,304,304,50,47,3,2,1
9,315,315,43,43,0,1,0
17,319,319,55,8,47,4,3
15,322,322,49,49,0,1,0
11,354,354,29,29,0,1,0
4,359,359,1,1,0,1,0
5,377,377,96,14,82,4,3
6,391,391,92,58,34,3,2
7,447,447,42,19,23,2,1
2,476,476,61,61,0,1,0

24,109,109,7,3,4,2,1
11,109,109,21,21,0,1,0
22,112,112,4,4,0,1,0
19,132,132,3,3,0,1,0
15,166,166,5,5,0,1,0
6,176,176,8,8,0,1,0
0,212,212,5,5,0,1,0
17,214,214,29,29,0,1,0
8,226,226,21,4,17,2,1
5,234,234,3,3,0,1,0
13,241,241,9,9,0,1,0
26,249,249,42,42,0,1,0
3,253,253,6,2,4,2,1
16,265,265,25,20,5,2,1
14,268,268,6,6,0,1,0
10,272,272,13,1,12,2,1
23,298,298,11,4,7,2,1
7,309,309,33,21,12,2,1
2,356,356,13,6,7,2,1
20,359,359,36,21,15,2,1
4,370,370,37,19,18,4,3
9,404,404,76,12,64,3,2
18,425,425,41,41,0,1,0
12,447,447,96,96,0,1,0
1,463,463,26,6,20,3,2
21,465,465,133,133,0,1,0
25,489,489,77,18,59,3,2

26,113,113,33,3,30,4,3
5,133,133,14,1,13,3,2
23,140,140,3,3,0,1,0
27,143,143,15,15,0,1,0
10,145,145,12,12,0,1,0
9,165,165,8,4,4,2,1
17,170,170,41,5,36,2,1
24,198,198,3,3,0,1,0
21,233,233,15,1,14,3,2
0,234,234,9,3,6,3,2
7,248,248,6,6,0,1,0
3,251,251,17,3,14,2,1
12,254,254,52,38,14,3,2
6,276,276,35,35,0,1,0
18,301,301,42,42,0,1,0
15,322,322,1,1,0,1,0
22,342,342,5,5,0,1,0
1,366,366,1,1,0,1,0
11,385,385,19,19,0,1,0
4,404,404,7,7,0,1,0
13,409,409,1,1,0,1,0
16,436,436,99,27,72,3,2
14,440,440,93,93,0,1,0
20,447,447,18,12,6,2,1
19,453,453,26,4,22,3,2
2,460,460,16,16,0,1,0
25,468,468,3,3,0,1,0
8,499,499,91,91,0,1,0

31,125,125,1,1,0,1,0
29,126,126,24,15,9,4,3
12,153,153,21,21,0,1,0
19,164,164,1,1,0,1,0
15,169,169,4,4,0,1,0
7,177,177,12,12,0,1,0
33,179,179,9,3,6,2,1
22,193,193,3,3,0,1,0
25,193,193,8,8,0,1,0
23,203,203,20,20,0,1,0
8,219,219,7,2,5,2,1
20,257,257,20,8,12,2,1
6,268,268,22,16,6,2,1
32,269,269,3,3,0,1,0
17,270,270,35,35,0,1,0
11,282,282,9,3,6,2,1
1,298,298,1,1,0,1,0
28,299,299,116,40,76,3,2
10,311,311,1,1,0,1,0
18,314,314,1,1,0,1,0
14,325,325,14,14,0,1,0
16,348,348,21,15,6,2,1
9,362,362,9,9,0,1,0
34,377,377,27,6,21,2,1
30,381,381,7,7,0,1,0
21,391,391,36,36,0,1,0
2,400,400,5,5,0,1,0
3,403,403,31,31,0,1,0
0,408,408,61,61,0,1,0
26,426,426,17,4,13,4,3
13,458,458,40,40,0,1,0
24,472,472,108,30,78,4,3
27,481,481,42,13,29,2,1
5,481,481,5,5,0,1,0
4,486,486,16,16,0,1,0

8,121,121,10,10,0,1,0
16,142,142,8,8,0,1,0
11,167,167,16,12,4,2,1
20,175,175,17,17,0,1,0
15,186,186,6,6,0,1,0
10,201,201,6,6,0,1,0
23,250,250,2,2,0,1,0
14,266,266,34,22,12,3,2
22,268,268,32,32,0,1,0
13,276,276,63,33,30,2,1
9,278,278,14,14,0,1,0
6,295,295,3,3,0,1,0
2,295,295,33,11,22,4,3
18,314,314,88,4,84,4,3
17,331,331,9,9,0,1,0
1,371,371,32,32,0,1,0
19,388,388,7,7,0,1,0
3,397,397,115,55,60,3,2
12,404,404,30,14,16,2,1
7,430,430,102,86,16,3,2
21,436,436,68,56,12,3,2
5,439,439,1,1,0,1,0
4,450,450,63,63,0,1,0
0,461,461,31,10,21,4,3

17,102,102,7,7,0,1,0
8,120,120,48,20,28,4,3
15,120,120,1,1,0,1,0
11,126,126,7,1,6,2,1
16,178,178,4,4,0,1,0
7,205,205,4,4,0,1,0
13,293,293,54,30,24,3,2
0,309,309,22,22,0,1,0
12,311,311,45,45,0,1,0
22,315,315,16,16,0,1,0
14,325,325,33,33,0,1,0
6,353,353,79,7,72,3,2
3,371,371,32,32,0,1,0
9,390,390,35,31,4,2,1
21,390,390,89,19,70,4,3
19,391,391,14,14,0,1,0
18,398,398,17,11,6,3,2
4,401,401,1,1,0,1,0
5,437,437,17,11,6,2,1
1,452,452,38,4,34,4,3
2,456,456,75,75,0,1,0
10,481,481,10,10,0,1,0
20,498,498,137,137,0,1,0

13,120,120,5,5,0,1,0
5,136,136,8,8,0,1,0
17,157,157,1,1,0,1,0
2,171,171,28,6,22,3,2
18,179,179,11,11,0,1,0
1,181,181,71,71,0,1,0
3,199,199,2,2,0,1,0
19,253,253,61,11,50,3,2
10,265,265,8,8,0,1,0
14,318,318,16,16,0,1,0
8,328,328,1,1,0,1,0
7,343,343,65,48,17,2,1
15,346,346,13,2,11,4,3
11,347,347,13,2,11,4,3
16,369,369,79,79,0,1,0
9,387,387,106,25,81,4,3
0,392,392,110,92,18,2,1
12,422,422,97,13,84,3,2
4,442,442,41,41,0,1,0
6,447,447,6,6,0,1,0

10,101,101,1,1,0,1,0
16,120,120,4,4,0,1,0
11,122,122,6,1,5,2,1
14,126,126,1,1,0,1,0
21,137,137,17,10,7,2,1
4,159,159,4,1,3,2,1
2,161,161,35,5,30,4,3
0,164,164,1,1,0,1,0
5,174,174,11,4,7,2,1
1,189,189,11,6,5,2,1
9,192,192,52,52,0,1,0
15,199,199,37,9,28,3,2
13,203,203,27,7,20,3,2
19,211,211,19,19,0,1,0
12,215,215,31,6,25,2,1
23,218,218,14,9,5,2,1
22,234,234,1,1,0,1,0
3,249,249,84,84,0,1,0
17,340,340,53,2,51,3,2
20,377,377,37,37,0,1,0
18,397,397,73,16,57,4,3
8,430,430,1,1,0,1,0
6,449,449,13,7,6,2,1
7,484,484,65,65,0,1,0

3,116,116,6,6,0,1,0
17,117,117,3,3,0,1,0
0,148,148,8,8,0,1,0
1,148,148,24,24,0,1,0
16,161,161,5,1,4,2,1
15,184,184,27,4,23,2,1
12,212,212,16,13,3,2,1
22,214,214,44,44,0,1,0
20,228,228,25,5,20,4,3
21,250,250,2,2,0,1,0
6,275,275,13,7,6,2,1
10,313,313,13,10,3,2,1
2,385,385,64,64,0,1,0
8,393,393,24,24,0,1,0
9,394,394,36,1,35,3,2
11,398,398,24,24,0,1,0
7,401,401,90,14,76,3,2
13,403,403,5,5,0,1,0
19,410,410,87,87,0,1,0
14,432,432,117,87,30,3,2
18,452,452,31,11,20,3,2
4,473,473,126,112,14,3,2
5,485,485,17,17,0,1,0

5,106,106,3,3,0,1,0
19,122,122,13,13,0,1,0
4,134,134,8,5,3,2,1
7,159,159,61,61,0,1,0
0,179,179,2,2,0,1,0
15,243,243,4,1,3,2,1
1,265,265,7,3,4,2,1
11,286,286,44,11,33,4,3
13,308,308,20,20,0,1,0
17,323,323,38,8,30,3,2
16,354,354,45,18,27,2,1
18,366,366,39,12,27,4,3
3,385,385,11,11,0,1,0
12,391,391,17,17,0,1,0
9,395,395,56,56,0,1,0
6,396,396,130,73,57,4,3
10,448,448,104,83,21,4,3
14,454,454,31,13,18,4,3
2,458,458,153,83,70,3,2
8,499,499,18,18,0,1,0

0,102,102,5,5,0,1,0
21,106,106,1,1,0,1,0
10,110,110,6,6,0,1,0
6,116,116,8,8,0,1,0
8,140,140,6,6,0,1,0
16,143,143,49,49,0,1,0
13,155,155,8,8,0,1,0
15,161,161,1,1,0,1,0
3,204,204,15,4,11,2,1
2,240,240,20,20,0,1,0
20,250,250,7,2,5,2,1
1,255,255,3,3,0,1,0
25,266,266,4,1,3,2,1
23,294,294,8,4,4,2,1
4,309,309,67,67,0,1,0
27,315,315,33,6,27,2,1
26,327,327,73,40,33,4,3
12,332,332,34,34,0,1,0
18,352,352,2,2,0,1,0
14,361,361,47,35,12,4,3
17,390,390,4,4,0,1,0
11,416,416,7,7,0,1,0
5,417,417,62,16,46,4,3
19,425,425,103,60,43,4,3
7,440,440,13,13,0,1,0
24,444,444,38,20,18,3,2
22,482,482,62,58,4,2,1
9,490,490,57,57,0,1,0

8,121,121,3,3,0,1,0
17,130,130,27,7,20,3,2
3,131,131,16,1,15,4,3
13,135,135,7,7,0,1,0
4,145,145,1,1,0,1,0
5,153,153,12,12,0,1,0
15,182,182,11,11,0,1,0
0,194,194,1,1,0,1,0
1,231,231,6,6,0,1,0
11,233,233,43,43,0,1,0
23,233,233,10,10,0,1,0
6,250,250,12,4,8,2,1
10,259,259,17,1,16,3,2
9,273,273,4,4,0,1,0
29,280,280,44,44,0,1,0
7,286,286,41,41,0,1,0
12,293,293,20,20,0,1,0
28,298,298,13,13,0,1,0
16,315,315,16,16,0,1,0
24,316,316,88,88,0,1,0
21,324,324,65,65,0,1,0
18,347,347,9,9,0,1,0
27,348,348,40,40,0,1,0
19,354,354,15,5,10,3,2
22,358,358,45,24,21,2,1
26,374,374,40,6,34,2,1
14,384,384,5,1,4,2,1
20,391,391,13,13,0,1,0
2,425,425,15,15,0,1,0
25,491,491,24,24,0,1,0

6,107,107,8,8,0,1,0
16,111,111,7,1,6,2,1
11,122,122,21,13,8,3,2
24,160,160,11,4,7,2,1
8,162,162,5,5,0,1,0
9,163,163,4,1,3,2,1
12,180,180,27,27,0,1,0
7,265,265,33,33,0,1,0
5,273,273,51,20,31,2,1
3,305,305,11,7,4,2,1
14,321,321,61,43,18,4,3
0,331,331,27,27,0,1,0
2,364,364,15,9,6,2,1
25,365,365,29,15,14,2,1
13,367,367,29,6,23,2,1
10,384,384,48,48,0,1,0
21,407,407,5,5,0,1,0
18,420,420,21,21,0,1,0
20,428,428,24,24,0,1,0
15,437,437,8,8,0,1,0
22,439,439,15,15,0,1,0
19,440,440,38,20,18,2,1
1,441,441,27,9,18,4,3
23,441,441,120,86,34,2,1
17,472,472,137,137,0,1,0
4,476,476,7,7,0,1,0

20,104,104,20,1,19,4,3
24,170,170,34,4,30,4,3
6,178,178,32,32,0,1,0
7,180,180,9,5,4,2,1
5,214,214,23,9,14,3,2
1,249,249,7,7,0,1,0
25,256,256,19,1,18,4,3
2,266,266,44,16,28,2,1
27,284,284,4,4,0,1,0
16,304,304,9,9,0,1,0
14,327,327,91,91,0,1,0
4,331,331,18,18,0,1,0
0,332,332,10,6,4,2,1
12,335,335,4,4,0,1,0
26,359,359,45,45,0,1,0
15,366,366,9,2,7,2,1
21,370,370,101,50,51,4,3
10,383,383,12,2,10,2,1
22,384,384,24,10,14,4,3
3,392,392,16,3,13,2,1
17,408,408,2,2,0,1,0
13,418,418,11,11,0,1,0
23,420,420,37,16,21,2,1
11,445,445,24,9,15,2,1
19,448,448,53,53,0,1,0
8,482,482,5,5,0,1,0
18,486,486,19,19,0,1,0
9,497,497,54,54,0,1,0

10,109,109,20,20,0,1,0
19,118,118,17,17,0,1,0
14,125,125,5,1,4,2,1
13,128,128,5,5,0,1,0
24,143,143,1,1,0,1,0
8,189,189,25,13,12,2,1
16,194,194,23,23,0,1,0
9,195,195,5,5,0,1,0
17,210,210,24,24,0,1,0
20,215,215,13,13,0,1,0
12,247,247,3,3,0,1,0
0,260,260,14,10,4,2,1
5,270,270,51,51,0,1,0
15,276,276,27,9,18,4,3
1,301,301,25,3,22,2,1
6,302,302,30,22,8,3,2
18,332,332,10,3,7,2,1
4,355,355,1,1,0,1,0
2,394,394,3,3,0,1,0
11,401,401,34,34,0,1,0
7,409,409,102,39,63,4,3
21,427,427,96,42,54,4,3
25,447,447,54,54,0,1,0
22,457,457,85,61,24,4,3
3,474,474,20,20,0,1,0
23,487,487,40,40,0,1,0

21,112,112,15,1,14,3,2
10,122,122,1,1,0,1,0
2,127,127,21,21,0,1,0
9,129,129,10,10,0,1,0
23,133,133,1,1,0,1,0
19,136,136,30,30,0,1,0
15,188,188,19,7,12,4,3
0,204,204,8,8,0,1,0
25,213,213,16,7,9,3,2
14,216,216,11,11,0,1,0
4,225,225,6,2,4,2,1
17,225,225,48,32,16,3,2
16,248,248,20,8,12,2,1
27,249,249,55,55,0,1,0
24,256,256,13,1,12,3,2
18,291,291,8,8,0,1,0
8,294,294,95,79,16,3,2
6,295,295,52,24,28,4,3
22,299,299,25,7,18,4,3
13,306,306,7,7,0,1,0
3,312,312,4,4,0,1,0
5,368,368,49,27,22,3,2
7,379,379,3,3,0,1,0
1,429,429,5,5,0,1,0
11,436,436,20,20,0,1,0
26,450,450,17,17,0,1,0
12,467,467,1,1,0,1,0
20,473,473,39,25,14,2,1

2,128,128,24,24,0,1,0
14,148,148,11,11,0,1,0
3,179,179,7,4,3,2,1
17,187,187,23,23,0,1,0
13,187,187,2,2,0,1,0
11,202,202,8,5,3,2,1
9,207,207,91,1,90,4,3
0,220,220,82,10,72,3,2
10,226,226,12,12,0,1,0
20,233,233,6,6,0,1,0
15,254,254,9,9,0,1,0
8,264,264,16,16,0,1,0
16,286,286,53,53,0,1,0
18,337,337,46,22,24,4,3
19,371,371,14,14,0,1,0
12,379,379,26,21,5,2,1
4,405,405,138,44,94,4,3
5,416,416,1,1,0,1,0
6,425,425,6,6,0,1,0
1,458,458,71,33,38,3,2
7,492,492,14,14,0,1,0

10,102,102,18,18,0,1,0
24,103,103,50,50,0,1,0
22,108,108,3,3,0,1,0
3,115,115,16,6,10,3,2
12,122,122,14,14,0,1,0
26,147,147,11,11,0,1,0
19,161,161,4,1,3,2,1
9,176,176,28,28,0,1,0
25,196,196,24,15,9,2,1
11,213,213,16,16,0,1,0
14,248,248,3,3,0,1,0
13,249,249,3,3,0,1,0
2,277,277,13,13,0,1,0
16,306,306,50,50,0,1,0
0,311,311,12,4,8,2,1
4,316,316,57,10,47,2,1
23,324,324,30,30,0,1,0
21,329,329,33,33,0,1,0
17,331,331,26,11,15,2,1
8,347,347,13,13,0,1,0
18,362,362,2,2,0,1,0
15,366,366,9,9,0,1,0
6,410,410,52,52,0,1,0
20,414,414,10,2,8,2,1
7,434,434,31,31,0,1,0
1,446,446,5,5,0,1,0
5,451,451,1,1,0,1,0

12,116,116,4,4,0,1,0
20,143,143,6,6,0,1,0
2,154,154,22,10,12,2,1
16,165,165,5,2,3,2,1
8,170,170,21,1,20,2,1
13,185,185,27,27,0,1,0
14,235,235,71,54,17,2,1
0,238,238,60,20,40,2,1
5,238,238,1,1,0,1,0
4,254,254,10,10,0,1,0
6,275,275,8,8,0,1,0
21,353,353,9,9,0,1,0
18,362,362,46,46,0,1,0
11,438,438,7,2,5,2,1
9,444,444,71,71,0,1,0
3,449,449,164,86,78,4,3
19,453,453,1,1,0,1,0
15,454,454,56,32,24,3,2
1,484,484,9,9,0,1,0
7,489,489,32,32,0,1,0
17,493,493,95,95,0,1,0
10,496,496,89,47,42,4,3

13,101,101,3,3,0,1,0
0,127,127,10,2,8,3,2
20,137,137,23,23,0,1,0
16,156,156,11,1,10,3,2
14,167,167,8,8,0,1,0
8,207,207,3,3,0,1,0
5,216,216,82,82,0,1,0
7,231,231,10,1,9,4,3
9,242,242,52,25,27,4,3
17,253,253,39,36,3,2,1
3,260,260,10,10,0,1,0
1,286,286,6,6,0,1,0
2,293,293,7,7,0,1,0
21,297,297,20,1,19,4,3
10,334,334,35,35,0,1,0
15,354,354,133,133,0,1,0
12,357,357,22,1,21,4,3
18,360,360,5,5,0,1,0
22,373,373,37,37,0,1,0
6,386,386,12,12,0,1,0
4,388,388,98,98,0,1,0
19,408,408,15,15,0,1,0
11,490,490,47,26,21,4,3

14,100,100,2,2,0,1,0
1,110,110,10,1,9,4,3
10,130,130,11,11,0,1,0
22,136,136,9,9,0,1,0
7,198,198,2,2,0,1,0
13,226,226,4,4,0,1,0
12,261,261,7,7,0,1,0
15,280,280,96,72,24,4,3
9,321,321,18,15,3,2,1
17,345,345,30,3,27,4,3
19,366,366,11,11,0,1,0
5,373,373,48,24,24,4,3
20,375,375,95,41,54,4,3
18,381,381,36,36,0,1,0
3,399,399,15,15,0,1,0
0,404,404,85,37,48,3,2
21,406,406,61,30,31,2,1
11,410,410,23,23,0,1,0
23,411,411,8,2,6,2,1
6,442,442,119,67,52,3,2
16,448,448,49,49,0,1,0
8,474,474,29,11,18,3,2
4,480,480,26,10,16,3,2
2,492,492,70,70,0,1,0

6,115,115,43,25,18,3,2
13,120,120,13,13,0,1,0
4,140,140,12,6,6,2,1
2,141,141,15,4,11,2,1
22,147,147,26,4,22,3,2
10,155,155,13,3,10,2,1
11,176,176,43,7,36,4,3
17,178,178,7,2,5,2,1
15,203,203,21,5,16,3,2
7,230,230,34,34,0,1,0
0,231,231,15,15,0,1,0
19,237,237,12,3,9,4,3
12,268,268,58,14,44,2,1
16,274,274,4,4,0,1,0
9,290,290,27,16,11,2,1
18,298,298,47,20,27,2,1
14,313,313,21,3,18,3,2
1,381,381,28,4,24,2,1
8,404,404,37,37,0,1,0
20,409,409,19,19,0,1,0
3,420,420,23,2,21,4,3
5,469,469,14,14,0,1,0
21,483,483,3,3,0,1,0

17,101,101,6,6,0,1,0
14,114,114,6,6,0,1,0
18,138,138,3,3,0,1,0
21,141,141,4,4,0,1,0
24,142,142,6,6,0,1,0
0,144,144,2,2,0,1,0
9,161,161,27,16,11,2,1
23,175,175,36,1,35,2,1
11,203,203,2,2,0,1,0
15,217,217,8,8,0,1,0
27,226,226,28,23,5,2,1
8,257,257,3,3,0,1,0
4,268,268,24,2,22,3,2
16,314,314,14,14,0,1,0
25,323,323,47,47,0,1,0
19,326,326,4,4,0,1,0
12,336,336,27,3,24,3,2
3,338,338,61,61,0,1,0
26,373,373,46,12,34,2,1
7,389,389,48,1,47,2,1
20,403,403,10,10,0,1,0
22,405,405,160,76,84,4,3
13,420,420,107,77,30,4,3
10,439,439,24,24,0,1,0
2,449,449,4,4,0,1,0
1,462,462,27,27,0,1,0
6,477,477,13,1,12,3,2
5,494,494,15,6,9,4,3

30,103,103,20,2,18,4,3
9,105,105,3,3,0,1,0
29,177,177,3,3,0,1,0
23,178,178,13,13,0,1,0
27,190,190,57,22,35,2,1
12,200,200,20,20,0,1,0
16,208,208,2,2,0,1,0
6,213,213,11,11,0,1,0
7,238,238,71,51,20,2,1
15,240,240,1,1,0,1,0
8,258,258,13,1,12,3,2
28,287,287,10,10,0,1,0
13,291,291,11,11,0,1,0
5,309,309,1,1,0,1,0
4,313,313,9,1,8,3,2
22,324,324,32,2,30,4,3
14,324,324,41,41,0,1,0
1,324,324,13,8,5,2,1
10,331,331,19,19,0,1,0
3,380,380,15,15,0,1,0
11,387,387,13,1,12,2,1
19,396,396,10,10,0,1,0
0,407,407,35,35,0,1,0
24,458,458,61,13,48,2,1
26,459,459,10,10,0,1,0
20,468,468,80,33,47,2,1
25,486,486,10,7,3,2,1
17,489,489,4,4,0,1,0
21,490,490,69,4,65,4,3
18,492,492,20,8,12,3,2
2,497,497,78,78,0,1,0

19,121,121,10,10,0,1,0
0,121,121,9,9,0,1,0
18,122,122,13,13,0,1,0
11,125,125,5,5,0,1,0
10,137,137,4,4,0,1,0
2,150,150,7,3,4,2,1
4,184,184,19,1,18,2,1
6,185,185,19,10,9,2,1
3,185,185,1,1,0,1,0
9,187,187,4,4,0,1,0
20,268,268,23,3,20,3,2
1,285,285,163,151,12,3,2
14,317,317,14,6,8,3,2
12,344,344,4,4,0,1,0
8,352,352,30,7,23,2,1
16,354,354,106,22,84,3,2
7,400,400,23,3,20,2,1
5,433,433,67,59,8,2,1
17,472,472,145,45,100,3,2
13,474,474,56,33,23,2,1
15,498,498,44,44,0,1,0

2,103,103,5,5,0,1,0
19,119,119,26,26,0,1,0
0,125,125,9,9,0,1,0
11,127,127,30,30,0,1,0
26,163,163,21,21,0,1,0
1,204,204,29,19,10,3,2
25,215,215,24,2,22,3,2
12,229,229,1,1,0,1,0
16,268,268,35,1,34,2,1
4,279,279,40,4,36,4,3
7,293,293,9,9,0,1,0
18,305,305,20,15,5,2,1
10,320,320,4,1,3,2,1
17,324,324,27,7,20,2,1
27,361,361,94,94,0,1,0
13,369,369,73,23,50,4,3
8,373,373,12,12,0,1,0
24,377,377,14,6,8,3,2
15,384,384,7,7,0,1,0
23,388,388,25,17,8,2,1
22,390,390,20,8,12,3,2
6,408,408,47,5,42,4,3
21,420,420,24,24,0,1,0
3,427,427,4,4,0,1,0
20,428,428,8,8,0,1,0
5,464,464,3,3,0,1,0
9,465,465,8,8,0,1,0
14,467,467,54,18,36,4,3

9,111,111,27,27,0,1,0
18,125,125,9,2,7,2,1
0,135,135,34,24,10,3,2
20,169,169,9,3,6,3,2
2,174,174,17,4,13,3,2
16,178,178,6,6,0,1,0
4,189,189,4,4,0,1,0
7,218,218,16,16,0,1,0
11,241,241,6,6,0,1,0
1,257,257,9,9,0,1,0
8,264,264,38,2,36,4,3
13,269,269,5,5,0,1,0
21,306,306,52,6,46,2,1
6,321,321,25,10,15,4,3
10,327,327,94,1,93,4,3
12,349,349,94,49,45,4,3
17,349,349,26,2,24,3,2
14,351,351,4,4,0,1,0
3,438,438,68,8,60,4,3
5,455,455,46,46,0,1,0
15,472,472,38,38,0,1,0
19,490,490,65,65,0,1,0

17,118,118,22,22,0,1,0
18,131,131,10,10,0,1,0
6,149,149,9,5,4,2,1
12,164,164,13,13,0,1,0
5,179,179,3,3,0,1,0
11,181,181,2,2,0,1,0
15,236,236,26,26,0,1,0
2,249,249,45,42,3,2,1
10,276,276,3,3,0,1,0
7,290,290,25,25,0,1,0
3,295,295,68,68,0,1,0
1,296,296,73,21,52,4,3
4,313,313,15,1,14,3,2
0,328,328,50,50,0,1,0
13,356,356,27,27,0,1,0
16,377,377,11,11,0,1,0
9,383,383,31,5,26,3,2
20,403,403,115,71,44,3,2
21,423,423,28,1,27,4,3
14,457,457,56,16,40,3,2
8,459,459,40,8,32,2,1
22,477,477,62,38,24,4,3
19,488,488,29,29,0,1,0

23,113,113,2,2,0,1,0
17,114,114,15,15,0,1,0
19,125,125,11,3,8,3,2
5,154,154,1,1,0,1,0
12,174,174,52,52,0,1,0
22,190,190,22,22,0,1,0
15,212,212,17,17,0,1,0
3,235,235,8,8,0,1,0
2,260,260,19,19,0,1,0
24,276,276,46,17,29,2,1
7,276,276,31,31,0,1,0
6,277,277,2,2,0,1,0
13,281,281,12,12,0,1,0
16,339,339,25,6,19,2,1
0,343,343,38,35,3,2,1
1,350,350,64,64,0,1,0
4,371,371,41,41,0,1,0
10,400,400,6,6,0,1,0
14,416,416,151,55,96,3,2
18,429,429,26,26,0,1,0
8,460,460,11,7,4,2,1
11,466,466,103,103,0,1,0
9,469,469,4,4,0,1,0
21,484,484,32,32,0,1,0
20,491,491,8,8,0,1,0

22,110,110,11,3,8,2,1
26,133,133,27,1,26,2,1
19,134,134,31,23,8,3,2
2,138,138,1,1,0,1,0
1,148,148,14,8,6,2,1
24,150,150,17,3,14,3,2
3,151,151,16,16,0,1,0
6,171,171,1,1,0,1,0
28,192,192,8,8,0,1,0
18,192,192,2,2,0,1,0
13,206,206,5,5,0,1,0
8,226,226,26,26,0,1,0
12,230,230,20,4,16,2,1
15,268,268,31,31,0,1,0
11,283,283,46,4,42,2,1
25,284,284,83,18,65,4,3
27,290,290,9,1,8,3,2
23,298,298,6,3,3,2,1
9,307,307,9,9,0,1,0
14,324,324,10,1,9,4,3
10,328,328,8,1,7,2,1
0,383,383,57,57,0,1,0
16,397,397,56,38,18,4,3
21,399,399,18,9,9,2,1
7,442,442,1,1,0,1,0
5,452,452,15,15,0,1,0
20,458,458,4,1,3,2,1
17,489,489,60,26,34,3,2
4,498,498,37,37,0,1,0

15,134,134,6,6,0,1,0
3,161,161,14,3,11,2,1
16,183,183,11,8,3,2,1
2,211,211,6,6,0,1,0
13,217,217,40,2,38,3,2
19,219,219,12,12,0,1,0
10,235,235,31,31,0,1,0
1,236,236,176,176,0,1,0
5,237,237,1,1,0,1,0
18,257,257,20,10,10,2,1
6,300,300,11,7,4,2,1
17,338,338,30,2,28,2,1
8,341,341,19,7,12,3,2
7,349,349,9,9,0,1,0
12,369,369,31,31,0,1,0
9,399,399,47,1,46,3,2
0,447,447,64,31,33,2,1
11,457,457,114,102,12,3,2
14,462,462,33,25,8,3,2
4,468,468,61,24,37,2,1

20,107,107,4,4,0,1,0
15,108,108,3,3,0,1,0
18,159,159,38,38,0,1,0
23,164,164,6,6,0,1,0
2,175,175,19,19,0,1,0
6,179,179,3,3,0,1,0
13,227,227,27,5,22,2,1
14,233,233,96,96,0,1,0
4,267,267,4,4,0,1,0
7,267,267,30,30,0,1,0
5,290,290,6,1,5,2,1
24,306,306,13,13,0,1,0
17,310,310,42,6,36,3,2
19,352,352,15,15,0,1,0
3,368,368,28,28,0,1,0
8,388,388,28,28,0,1,0
9,397,397,109,89,20,3,2
16,421,421,22,22,0,1,0
1,438,438,28,14,14,2,1
12,450,450,116,32,84,3,2
11,454,454,11,11,0,1,0
22,460,460,17,1,16,2,1
10,481,481,48,2,46,2,1
21,484,484,20,20,0,1,0
0,499,499,30,15,15,2,1

3,127,127,9,2,7,3,2
1,129,129,12,12,0,1,0
21,129,129,10,3,7,3,2
5,131,131,20,16,4,2,1
26,133,133,16,16,0,1,0
18,142,142,20,10,10,2,1
22,166,166,3,3,0,1,0
23,171,171,4,1,3,2,1
24,173,173,14,2,12,3,2
4,247,247,59,33,26,3,2
6,251,251,31,5,26,2,1
9,281,281,11,11,0,1,0
15,302,302,18,10,8,3,2
25,314,314,88,2,86,3,2
7,318,318,20,20,0,1,0
19,318,318,44,44,0,1,0
11,319,319,14,4,10,2,1
12,321,321,11,6,5,2,1
0,364,364,14,14,0,1,0
8,404,404,13,13,0,1,0
17,406,406,45,13,32,3,2
16,414,414,5,5,0,1,0
20,461,461,74,1,73,4,3
14,461,461,36,6,30,3,2
13,466,466,4,4,0,1,0
2,475,475,53,53,0,1,0
10,489,489,36,8,28,3,2

20,116,116,15,3,12,2,1
4,150,150,18,4,14,2,1
0,169,169,9,1,8,2,1
13,176,176,14,14,0,1,0
15,199,199,12,2,10,3,2
8,210,210,16,9,7,2,1
7,225,225,5,1,4,2,1
10,250,250,5,5,0,1,0
5,261,261,33,8,25,3,2
12,346,346,18,6,12,3,2
3,352,352,10,2,8,3,2
19,385,385,33,1,32,4,3
14,396,396,28,28,0,1,0
9,397,397,14,14,0,1,0
18,404,404,78,51,27,2,1
16,412,412,122,117,5,2,1
2,416,416,92,54,38,3,2
21,434,434,30,30,0,1,0
6,447,447,85,15,70,4,3
1,452,452,148,95,53,4,3
17,460,460,7,7,0,1,0
11,489,489,71,28,43,2,1

16,109,109,1,1,0,1,0
3,133,133,1,1,0,1,0
31,143,143,3,3,0,1,0
6,153,153,2,2,0,1,0
4,170,170,5,5,0,1,0
21,179,179,37,37,0,1,0
5,199,199,12,12,0,1,0
7,203,203,6,2,4,2,1
29,224,224,6,6,0,1,0
2,230,230,18,10,8,3,2
11,230,230,1,1,0,1,0
13,236,236,1,1,0,1,0
1,268,268,17,1,16,2,1
20,274,274,65,23,42,4,3
22,274,274,20,5,15,3,2
12,275,275,14,14,0,1,0
9,282,282,11,11,0,1,0
27,329,329,12,12,0,1,0
24,334,334,21,21,0,1,0
25,396,396,14,14,0,1,0
23,397,397,33,33,0,1,0
8,410,410,18,4,14,3,2
14,411,411,13,13,0,1,0
19,414,414,7,7,0,1,0
28,415,415,123,123,0,1,0
30,428,428,104,21,83,3,2
32,429,429,10,10,0,1,0
18,435,435,53,7,46,2,1
0,439,439,29,9,20,2,1
15,454,454,30,10,20,3,2
17,457,457,25,21,4,2,1
26,471,471,52,13,39,4,3
10,491,491,86,86,0,1,0

14,105,105,2,2,0,1,0
16,121,121,16,11,5,2,1
5,128,128,34,34,0,1,0
2,143,143,7,7,0,1,0
12,182,182,9,9,0,1,0
22,194,194,2,2,0,1,0
17,223,223,16,5,11,2,1
3,247,247,12,8,4,2,1
19,269,269,20,7,13,2,1
9,269,269,14,14,0,1,0
10,294,294,22,22,0,1,0
13,328,328,37,37,0,1,0
15,329,329,38,38,0,1,0
7,341,341,43,28,15,4,3
1,343,343,97,97,0,1,0
6,356,356,80,80,0,1,0
20,358,358,54,54,0,1,0
8,361,361,3,3,0,1,0
11,375,375,39,10,29,4,3
21,390,390,119,119,0,1,0
18,409,409,34,11,23,4,3
0,447,447,1,1,0,1,0
4,494,494,34,14,20,3,2

3,112,112,33,7,26,2,1
6,136,136,7,7,0,1,0
13,140,140,21,3,18,3,2
23,154,154,25,25,0,1,0
7,156,156,16,16,0,1,0
2,191,191,11,7,4,2,1
22,193,193,19,19,0,1,0
12,208,208,18,18,0,1,0
9,228,228,3,3,0,1,0
11,289,289,8,8,0,1,0
5,300,300,2,2,0,1,0
21,300,300,8,8,0,1,0
15,304,304,64,64,0,1,0
18,306,306,110,80,30,4,3
17,308,308,10,10,0,1,0
8,311,311,23,12,11,2,1
10,324,324,67,20,47,2,1
16,340,340,16,16,0,1,0
24,342,342,4,4,0,1,0
14,386,386,29,11,18,4,3
4,436,436,104,10,94,4,3
20,472,472,14,8,6,3,2
0,476,476,18,18,0,1,0
1,485,485,3,3,0,1,0
19,494,494,7,7,0,1,0

9,142,142,25,25,0,1,0
18,157,157,46,21,25,4,3
5,159,159,39,7,32,3,2
20,228,228,43,43,0,1,0
3,238,238,38,7,31,2,1
12,245,245,13,13,0,1,0
15,253,253,22,22,0,1,0
7,259,259,1,1,0,1,0
11,271,271,2,2,0,1,0
2,362,362,19,19,0,1,0
13,363,363,69,46,23,2,1
14,369,369,64,23,41,4,3
6,376,376,1,1,0,1,0
0,390,390,96,74,22,2,1
16,397,397,11,2,9,2,1
10,404,404,45,21,24,3,2
21,418,418,5,2,3,2,1
1,462,462,15,15,0,1,0
19,469,469,17,10,7,2,1
8,474,474,109,109,0,1,0
17,477,477,17,17,0,1,0
4,478,478,27,9,18,2,1

0,106,106,21,17,4,2,1
2,176,176,5,5,0,1,0
9,192,192,39,6,33,3,2
3,205,205,16,4,12,2,1
1,206,206,2,2,0,1,0
10,220,220,14,3,11,2,1
6,232,232,60,60,0,1,0
19,241,241,52,46,6,2,1
21,246,246,36,36,0,1,0
8,279,279,83,21,62,3,2
16,314,314,48,6,42,4,3
12,317,317,47,11,36,3,2
4,339,339,1,1,0,1,0
18,373,373,2,2,0,1,0
11,375,375,39,39,0,1,0
7,384,384,8,3,5,2,1
17,384,384,9,9,0,1,0
13,390,390,10,10,0,1,0
5,393,393,41,1,40,3,2
14,395,395,39,3,36,3,2
20,459,459,3,3,0,1,0
15,481,481,108,3,105,4,3

2,132,132,1,1,0,1,0
3,147,147,15,7,8,2,1
1,156,156,27,27,0,1,0
17,170,170,6,6,0,1,0
4,184,184,10,7,3,2,1
20,206,206,47,2,45,4,3
12,222,222,23,5,18,2,1
9,227,227,9,9,0,1,0
5,276,276,30,14,16,2,1
18,306,306,49,40,9,4,3
15,309,309,25,25,0,1,0
6,328,328,6,6,0,1,0
19,331,331,64,64,0,1,0
8,342,342,103,88,15,3,2
14,373,373,7,7,0,1,0
13,389,389,10,10,0,1,0
7,390,390,132,120,12,2,1
11,421,421,62,62,0,1,0
0,427,427,26,4,22,3,2
16,462,462,39,39,0,1,0
21,491,491,36,36,0,1,0
10,492,492,35,7,28,3,2

17,118,118,6,6,0,1,0
13,130,130,24,24,0,1,0
11,151,151,8,8,0,1,0
7,151,151,7,7,0,1,0
2,160,160,65,14,51,4,3
0,239,239,38,38,0,1,0
15,260,260,48,48,0,1,0
14,272,272,69,19,50,2,1
3,291,291,41,9,32,3,2
5,296,296,86,86,0,1,0
9,362,362,85,23,62,4,3
8,384,384,16,2,14,3,2
4,404,404,67,16,51,4,3
6,441,441,52,39,13,2,1
16,465,465,12,12,0,1,0
10,467,467,3,3,0,1,0
12,472,472,9,9,0,1,0
1,485,485,19,19,0,1,0

18,106,106,16,16,0,1,0
8,134,134,4,4,0,1,0
12,158,158,70,70,0,1,0
7,194,194,1,1,0,1,0
5,206,206,57,57,0,1,0
13,213,213,66,33,33,4,3
19,227,227,3,3,0,1,0
14,227,227,1,1,0,1,0
21,234,234,6,6,0,1,0
1,248,248,7,7,0,1,0
0,282,282,22,5,17,2,1
10,285,285,6,6,0,1,0
4,290,290,20,1,19,4,3
9,370,370,38,15,23,4,3
11,395,395,13,13,0,1,0
20,396,396,10,10,0,1,0
16,465,465,43,43,0,1,0
2,470,470,221,212,9,2,1
15,472,472,17,14,3,2,1
17,475,475,30,20,10,3,2
6,490,490,38,38,0,1,0
3,496,496,32,32,0,1,0

18,109,109,7,7,0,1,0
30,136,136,24,12,12,4,3
15,141,141,11,2,9,4,3
22,156,156,5,1,4,2,1
17,158,158,4,4,0,1,0
4,159,159,2,2,0,1,0
9,186,186,17,9,8,3,2
26,204,204,18,18,0,1,0
21,230,230,35,11,24,2,1
7,241,241,4,1,3,2,1
24,242,242,32,32,0,1,0
11,243,243,1,1,0,1,0
29,245,245,2,2,0,1,0
14,266,266,8,2,6,3,2
27,272,272,42,26,16,2,1
13,273,273,16,16,0,1,0
19,286,286,49,26,23,2,1
10,301,301,49,21,28,2,1
6,315,315,5,1,4,2,1
1,327,327,59,9,50,2,1
0,335,335,5,5,0,1,0
28,362,362,25,25,0,1,0
16,382,382,15,15,0,1,0
8,388,388,30,8,22,3,2
23,418,418,16,5,11,4,3
25,424,424,67,10,57,3,2
20,433,433,20,20,0,1,0
12,433,433,45,31,14,3,2
3,469,469,38,38,0,1,0
2,474,474,43,43,0,1,0
5,479,479,27,8,19,2,1

2,137,137,8,1,7,2,1
3,153,153,98,42,56,3,2
14,170,170,25,7,18,4,3
7,189,189,21,21,0,1,0
0,192,192,51,51,0,1,0
1,205,205,2,2,0,1,0
16,209,209,2,2,0,1,0
8,209,209,1,1,0,1,0
10,209,209,22,3,19,3,2
13,238,238,5,5,0,1,0
15,248,248,43,43,0,1,0
18,295,295,74,31,43,4,3
17,319,319,61,19,42,3,2
6,368,368,12,12,0,1,0
9,389,389,2,2,0,1,0
5,401,401,62,2,60,4,3
12,464,464,38,32,6,2,1
4,469,469,19,13,6,3,2
11,478,478,56,56,0,1,0

10,143,143,9,3,6,3,2
23,157,157,2,2,0,1,0
4,168,168,20,8,12,3,2
17,169,169,1,1,0,1,0
6,192,192,3,3,0,1,0
1,219,219,29,7,22,2,1
16,224,224,6,6,0,1,0
15,288,288,13,1,12,4,3
19,293,293,20,12,8,2,1
2,294,294,2,2,0,1,0
0,308,308,112,70,42,3,2
8,317,317,50,35,15,2,1
12,333,333,7,4,3,2,1
20,351,351,8,8,0,1,0
5,354,354,15,15,0,1,0
11,357,357,1,1,0,1,0
3,367,367,54,28,26,3,2
18,368,368,171,81,90,3,2
7,377,377,34,34,0,1,0
9,378,378,23,23,0,1,0
21,407,407,92,52,40,3,2
22,445,445,21,11,10,3,2
14,446,446,59,44,15,2,1
13,477,477,68,68,0,1,0

18,109,109,4,4,0,1,0
28,125,125,3,3,0,1,0
6,145,145,1,1,0,1,0
0,183,183,5,2,3,2,1
12,183,183,50,50,0,1,0
27,204,204,10,2,8,3,2
4,210,210,17,17,0,1,0
3,217,217,10,1,9,2,1
10,218,218,3,3,0,1,0
11,230,230,1,1,0,1,0
17,239,239,81,15,66,4,3
9,254,254,5,2,3,2,1
21,257,257,19,5,14,3,2
15,257,257,1,1,0,1,0
13,258,258,14,14,0,1,0
24,259,259,45,21,24,4,3
16,262,262,2,2,0,1,0
1,308,308,27,27,0,1,0
22,311,311,25,25,0,1,0
5,314,314,44,21,23,4,3
14,317,317,86,48,38,4,3
7,324,324,8,8,0,1,0
23,345,345,5,5,0,1,0
2,351,351,9,9,0,1,0
8,364,364,41,28,13,2,1
20,392,392,46,9,37,3,2
19,405,405,45,9,36,3,2
25,406,406,61,23,38,3,2
26,466,466,26,20,6,2,1

12,102,102,9,6,3,2,1
2,115,115,7,7,0,1,0
18,135,135,20,1,19,2,1
4,150,150,32,32,0,1,0
17,160,160,7,7,0,1,0
5,161,161,41,41,0,1,0
20,182,182,32,32,0,1,0
9,204,204,34,34,0,1,0
6,232,232,76,1,75,4,3
0,246,246,10,10,0,1,0
15,259,259,18,2,16,2,1
10,273,273,31,1,30,3,2
13,302,302,39,5,34,3,2
11,320,320,4,4,0,1,0
14,328,328,21,21,0,1,0
8,330,330,5,5,0,1,0
19,334,334,42,39,3,2,1
16,346,346,33,3,30,2,1
3,436,436,4,4,0,1,0
7,472,472,121,65,56,3,2
1,488,488,12,12,0,1,0

30,102,102,10,10,0,1,0
16,119,119,4,4,0,1,0
2,125,125,4,4,0,1,0
28,130,130,2,2,0,1,0
7,137,137,7,7,0,1,0
25,171,171,7,7,0,1,0
24,178,178,42,42,0,1,0
20,200,200,17,17,0,1,0
8,218,218,33,33,0,1,0
11,222,222,2,2,0,1,0
22,237,237,18,12,6,2,1
29,247,247,19,2,17,3,2
21,249,249,37,37,0,1,0
23,259,259,65,35,30,3,2
0,262,262,5,5,0,1,0
4,269,269,29,12,17,2,1
27,269,269,17,17,0,1,0
5,275,275,1,1,0,1,0
12,302,302,54,54,0,1,0
26,306,306,2,2,0,1,0
6,310,310,6,6,0,1,0
19,354,354,51,48,3,2,1
14,386,386,39,39,0,1,0
1,395,395,21,21,0,1,0
15,433,433,50,50,0,1,0
3,436,436,21,21,0,1,0
9,451,451,13,13,0,1,0
17,460,460,8,8,0,1,0
13,485,485,35,23,12,4,3
18,490,490,16,8,8,2,1
10,499,499,63,30,33,4,3

13,161,161,23,23,0,1,0
14,162,162,4,4,0,1,0
11,198,198,22,6,16,2,1
19,201,201,2,2,0,1,0
2,217,217,1,1,0,1,0
15,229,229,4,4,0,1,0
0,237,237,93,76,17,4,3
4,237,237,56,56,0,1,0
12,272,272,28,28,0,1,0
8,273,273,14,11,3,2,1
20,294,294,61,61,0,1,0
22,311,311,85,85,0,1,0
1,336,336,12,12,0,1,0
9,360,360,2,2,0,1,0
10,371,371,13,13,0,1,0
21,376,376,6,6,0,1,0
6,386,386,98,98,0,1,0
7,420,420,14,14,0,1,0
3,434,434,16,7,9,4,3
17,468,468,50,2,48,3,2
16,481,481,87,53,34,2,1
5,485,485,56,56,0,1,0
18,496,496,14,14,0,1,0

9,101,101,7,1,6,3,2
1,115,115,4,1,3,2,1
11,130,130,7,7,0,1,0
2,153,153,1,1,0,1,0
8,155,155,34,2,32,3,2
10,190,190,6,6,0,1,0
12,235,235,37,7,30,3,2
16,240,240,17,1,16,2,1
14,273,273,16,16,0,1,0
15,277,277,65,45,20,3,2
0,289,289,20,7,13,2,1
19,302,302,92,10,82,3,2
21,321,321,13,5,8,2,1
6,339,339,19,19,0,1,0
3,343,343,161,138,23,2,1
5,364,364,57,57,0,1,0
13,386,386,16,5,11,2,1
7,398,398,19,7,12,2,1
17,414,414,3,3,0,1,0
20,423,423,82,82,0,1,0
4,461,461,34,34,0,1,0
18,467,467,10,3,7,2,1

3,111,111,36,36,0,1,0
14,132,132,1,1,0,1,0
15,134,134,10,2,8,3,2
12,174,174,11,1,10,2,1
25,183,183,12,3,9,2,1
17,188,188,53,53,0,1,0
16,233,233,15,15,0,1,0
7,240,240,3,3,0,1,0
18,240,240,11,3,8,3,2
23,245,245,72,45,27,4,3
1,269,269,2,2,0,1,0
9,290,290,25,25,0,1,0
20,291,291,2,2,0,1,0
24,320,320,38,38,0,1,0
22,334,334,8,8,0,1,0
6,337,337,39,1,38,2,1
0,343,343,16,5,11,4,3
5,357,357,11,8,3,2,1
26,376,376,39,29,10,2,1
19,382,382,24,24,0,1,0
2,389,389,16,4,12,3,2
8,392,392,63,1,62,3,2
13,443,443,15,15,0,1,0
11,456,456,40,40,0,1,0
10,459,459,40,9,31,2,1
21,471,471,42,3,39,4,3
4,491,491,13,13,0,1,0
27,500,500,30,30,0,1,0

2,137,137,16,16,0,1,0
8,145,145,10,1,9,2,1
0,155,155,78,35,43,2,1
7,168,168,42,42,0,1,0
14,195,195,21,11,10,3,2
11,225,225,20,20,0,1,0
3,244,244,18,18,0,1,0
13,307,307,38,38,0,1,0
16,309,309,20,11,9,2,1
10,330,330,46,25,21,4,3
6,341,341,12,12,0,1,0
9,345,345,24,2,22,2,1
5,375,375,51,27,24,4,3
15,375,375,14,14,0,1,0
4,394,394,180,180,0,1,0
1,427,427,22,4,18,3,2
12,438,438,47,47,0,1,0

15,108,108,4,4,0,1,0
2,118,118,9,4,5,2,1
8,153,153,11,4,7,2,1
5,164,164,10,2,8,2,1
12,188,188,1,1,0,1,0
21,210,210,29,29,0,1,0
13,211,211,11,2,9,2,1
10,217,217,27,27,0,1,0
14,250,250,20,20,0,1,0
6,255,255,47,39,8,3,2
4,263,263,13,13,0,1,0
23,320,320,98,52,46,4,3
11,323,323,16,16,0,1,0
9,326,326,30,5,25,2,1
22,358,358,104,104,0,1,0
3,363,363,13,3,10,2,1
17,385,385,8,8,0,1,0
0,388,388,51,51,0,1,0
19,392,392,42,42,0,1,0
18,403,403,7,7,0,1,0
24,465,465,29,5,24,3,2
1,466,466,20,2,18,4,3
16,471,471,12,12,0,1,0
20,474,474,37,37,0,1,0
7,484,484,135,98,37,4,3

22,100,100,2,2,0,1,0
23,109,109,3,3,0,1,0
26,144,144,13,13,0,1,0
6,149,149,16,4,12,4,3
25,243,243,30,14,16,4,3
11,247,247,2,2,0,1,0
12,248,248,7,3,4,2,1
4,263,263,7,7,0,1,0
0,263,263,9,9,0,1,0
10,286,286,26,22,4,2,1
9,295,295,9,6,3,2,1
20,327,327,22,22,0,1,0
19,351,351,95,29,66,4,3
13,354,354,91,91,0,1,0
24,364,364,53,26,27,4,3
21,368,368,14,14,0,1,0
17,374,374,44,4,40,3,2
7,407,407,33,33,0,1,0
1,408,408,4,4,0,1,0
16,414,414,5,5,0,1,0
18,417,417,51,45,6,3,2
28,428,428,21,21,0,1,0
2,428,428,6,1,5,2,1
15,456,456,45,45,0,1,0
14,460,460,87,87,0,1,0
8,477,477,51,13,38,3,2
5,489,489,38,28,10,2,1
27,491,491,78,47,31,2,1
3,499,499,14,14,0,1,0

7,105,105,2,2,0,1,0
20,112,112,4,4,0,1,0
3,116,116,11,3,8,3,2
1,157,157,22,22,0,1,0
24,195,195,3,3,0,1,0
25,206,206,3,3,0,1,0
9,213,213,12,2,10,2,1
5,239,239,39,9,30,2,1
15,241,241,73,73,0,1,0
18,243,243,56,24,32,3,2
8,246,246,36,16,20,3,2
10,261,261,25,25,0,1,0
19,275,275,40,10,30,3,2
16,289,289,8,8,0,1,0
2,289,289,14,14,0,1,0
13,295,295,24,14,10,3,2
22,327,327,31,19,12,4,3
12,332,332,20,20,0,1,0
4,355,355,41,5,36,2,1
21,386,386,11,11,0,1,0
0,398,398,33,12,21,4,3
11,402,402,1,1,0,1,0
23,413,413,117,117,0,1,0
14,452,452,14,10,4,2,1
17,467,467,1,1,0,1,0
6,476,476,30,12,18,3,2
26,494,494,18,18,0,1,0

6,108,108,25,4,21,4,3
15,116,116,37,25,12,2,1
1,126,126,16,16,0,1,0
23,140,140,8,4,4,2,1
10,194,194,28,24,4,2,1
14,238,238,13,13,0,1,0
7,247,247,14,14,0,1,0
17,269,269,33,28,5,2,1
13,284,284,6,6,0,1,0
22,285,285,22,22,0,1,0
4,288,288,5,5,0,1,0
21,292,292,30,30,0,1,0
19,338,338,16,8,8,2,1
2,349,349,42,1,41,4,3
11,352,352,27,21,6,2,1
20,361,361,66,59,7,2,1
3,378,378,12,12,0,1,0
8,387,387,34,25,9,2,1
18,420,420,15,15,0,1,0
16,439,439,68,68,0,1,0
9,440,440,72,72,0,1,0
12,459,459,22,1,21,4,3
5,461,461,28,7,21,2,1
0,495,495,41,41,0,1,0

7,104,104,1,1,0,1,0
26,108,108,9,2,7,2,1
11,123,123,19,4,15,4,3
25,143,143,54,20,34,2,1
14,165,165,27,27,0,1,0
13,178,178,14,14,0,1,0
23,196,196,17,13,4,2,1
15,200,200,4,1,3,2,1
21,207,207,3,3,0,1,0
6,209,209,21,3,18,3,2
28,225,225,34,34,0,1,0
29,245,245,5,5,0,1,0
12,277,277,1,1,0,1,0
27,313,313,8,8,0,1,0
0,314,314,2,2,0,1,0
8,329,329,6,6,0,1,0
17,337,337,53,41,12,4,3
19,339,339,8,8,0,1,0
9,345,345,24,24,0,1,0
3,358,358,8,2,6,3,2
16,380,380,61,61,0,1,0
24,380,380,2,2,0,1,0
20,393,393,28,7,21,4,3
22,421,421,58,35,23,2,1
10,460,460,1,1,0,1,0
4,463,463,35,28,7,2,1
1,466,466,49,16,33,2,1
5,470,470,4,4,0,1,0
2,492,492,22,5,17,3,2
18,494,494,115,83,32,3,2

4,105,105,11,11,0,1,0
5,129,129,23,23,0,1,0
10,139,139,1,1,0,1,0
3,156,156,4,1,3,2,1
16,159,159,3,3,0,1,0
1,176,176,35,26,9,2,1
0,178,178,5,5,0,1,0
26,182,182,5,1,4,2,1
21,224,224,20,5,15,4,3
15,246,246,29,29,0,1,0
25,271,271,42,4,38,2,1
8,278,278,3,3,0,1,0
22,286,286,19,19,0,1,0
2,313,313,28,28,0,1,0
13,351,351,49,25,24,2,1
14,370,370,26,7,19,3,2
7,371,371,14,14,0,1,0
12,377,377,37,16,21,2,1
11,377,377,1,1,0,1,0
6,395,395,9,9,0,1,0
23,412,412,2,2,0,1,0
20,421,421,139,16,123,4,3
19,423,423,48,48,0,1,0
9,424,424,23,23,0,1,0
27,427,427,2,2,0,1,0
18,436,436,57,49,8,3,2
24,443,443,46,9,37,2,1
28,449,449,80,31,49,2,1
17,483,483,7,2,5,2,1

2,108,108,58,6,52,3,2
11,109,109,26,2,24,3,2
10,134,134,9,9,0,1,0
21,161,161,12,3,9,4,3
6,176,176,10,10,0,1,0
18,193,193,3,3,0,1,0
14,244,244,20,20,0,1,0
7,248,248,9,5,4,2,1
12,269,269,24,2,22,2,1
15,295,295,48,48,0,1,0
20,303,303,24,24,0,1,0
4,308,308,2,2,0,1,0
13,341,341,33,33,0,1,0
19,347,347,14,14,0,1,0
8,356,356,54,32,22,2,1
3,375,375,16,16,0,1,0
1,389,389,9,3,6,3,2
0,393,393,83,83,0,1,0
17,443,443,100,52,48,4,3
5,453,453,9,9,0,1,0
9,483,483,56,26,30,2,1
16,497,497,30,30,0,1,0

1,108,108,16,16,0,1,0
9,108,108,3,3,0,1,0
25,113,113,3,3,0,1,0
23,135,135,50,2,48,3,2
6,137,137,19,19,0,1,0
2,143,143,31,15,16,4,3
14,175,175,4,4,0,1,0
13,181,181,23,2,21,2,1
16,198,198,15,15,0,1,0
22,199,199,65,65,0,1,0
11,233,233,15,15,0,1,0
3,263,263,11,11,0,1,0
0,276,276,12,7,5,2,1
10,333,333,27,11,16,3,2
20,335,335,15,5,10,3,2
24,336,336,15,15,0,1,0
18,382,382,47,33,14,2,1
5,383,383,10,1,9,2,1
12,389,389,1,1,0,1,0
4,416,416,43,31,12,4,3
15,421,421,18,3,15,2,1
17,442,442,33,16,17,2,1
19,457,457,30,30,0,1,0
21,464,464,4,4,0,1,0
7,465,465,80,64,16,2,1
8,487,487,4,4,0,1,0

9,134,134,1,1,0,1,0
6,172,172,31,31,0,1,0
0,181,181,19,19,0,1,0
13,199,199,13,2,11,2,1
1,233,233,12,8,4,2,1
15,234,234,43,43,0,1,0
12,237,237,29,29,0,1,0
2,242,242,22,22,0,1,0
7,244,244,57,28,29,2,1
8,282,282,1,1,0,1,0
14,299,299,55,12,43,2,1
11,305,305,4,4,0,1,0
3,331,331,40,40,0,1,0
4,346,346,86,86,0,1,0
5,363,363,62,29,33,4,3
19,368,368,72,72,0,1,0
17,372,372,34,6,28,3,2
18,381,381,91,91,0,1,0
16,398,398,9,9,0,1,0
10,466,466,43,2,41,2,1

7,123,123,17,17,0,1,0
19,141,141,11,3,8,3,2
18,141,141,35,35,0,1,0
26,157,157,3,3,0,1,0
25,170,170,6,6,0,1,0
24,178,178,24,24,0,1,0
23,193,193,14,5,9,2,1
5,226,226,23,23,0,1,0
2,250,250,5,5,0,1,0
9,273,273,6,6,0,1,0
16,301,301,11,11,0,1,0
11,317,317,46,46,0,1,0
22,319,319,25,11,14,2,1
12,329,329,17,17,0,1,0
17,346,346,53,53,0,1,0
28,358,358,48,18,30,4,3
4,369,369,78,24,54,4,3
13,394,394,24,7,17,2,1
20,413,413,64,64,0,1,0
15,415,415,37,37,0,1,0
8,418,418,43,11,32,3,2
21,419,419,30,30,0,1,0
6,425,425,2,2,0,1,0
14,428,428,38,10,28,2,1
3,432,432,2,2,0,1,0
27,456,456,20,20,0,1,0
1,465,465,33,3,30,3,2
10,475,475,1,1,0,1,0
0,486,486,24,24,0,1,0

15,105,105,12,12,0,1,0
8,126,126,10,10,0,1,0
0,140,140,8,8,0,1,0
3,155,155,27,9,18,3,2
11,162,162,35,3,32,4,3
1,180,180,1,1,0,1,0
9,199,199,13,13,0,1,0
18,239,239,2,2,0,1,0
2,248,248,69,69,0,1,0
7,266,266,19,19,0,1,0
17,279,279,95,57,38,3,2
10,282,282,46,19,27,4,3
14,310,310,4,4,0,1,0
13,310,310,8,8,0,1,0
16,315,315,92,58,34,2,1
4,341,341,3,3,0,1,0
19,357,357,3,3,0,1,0
12,376,376,9,9,0,1,0
20,382,382,6,6,0,1,0
21,407,407,71,40,31,2,1
6,411,411,12,5,7,2,1
5,420,420,1,1,0,1,0
22,423,423,43,43,0,1,0
23,431,431,30,30,0,1,0
24,438,438,16,6,10,3,2
25,477,477,20,7,13,2,1

13,101,101,3,3,0,1,0
14,141,141,4,4,0,1,0
5,185,185,59,59,0,1,0
12,204,204,54,54,0,1,0
0,209,209,16,6,10,3,2
16,233,233,3,3,0,1,0
11,236,236,40,40,0,1,0
1,269,269,9,9,0,1,0
4,272,272,38,38,0,1,0
19,286,286,25,9,16,2,1
8,293,293,54,19,35,2,1
10,309,309,90,69,21,2,1
6,328,328,6,3,3,2,1
17,329,329,41,41,0,1,0
20,346,346,5,5,0,1,0
3,363,363,49,49,0,1,0
7,367,367,10,4,6,2,1
2,383,383,19,19,0,1,0
18,404,404,13,13,0,1,0
9,444,444,97,28,69,4,3
21,444,444,74,62,12,4,3
15,477,477,3,3,0,1,0

22,108,108,4,1,3,2,1
19,120,120,8,2,6,2,1
5,142,142,27,27,0,1,0
18,171,171,39,39,0,1,0
8,181,181,17,17,0,1,0
16,199,199,12,12,0,1,0
9,228,228,3,3,0,1,0
14,232,232,10,10,0,1,0
1,244,244,1,1,0,1,0
2,246,246,16,16,0,1,0
4,254,254,13,13,0,1,0
7,336,336,56,56,0,1,0
0,350,350,1,1,0,1,0
6,359,359,42,34,8,2,1
17,366,366,38,13,25,2,1
20,368,368,18,9,9,2,1
21,377,377,10,6,4,2,1
11,411,411,10,10,0,1,0
23,421,421,9,3,6,3,2
15,452,452,15,15,0,1,0
10,463,463,121,97,24,4,3
3,463,463,98,98,0,1,0
12,495,495,216,166,50,4,3
13,498,498,62,62,0,1,0

2,118,118,6,6,0,1,0
22,124,124,20,20,0,1,0
6,135,135,27,9,18,4,3
23,151,151,21,21,0,1,0
0,154,154,2,2,0,1,0
25,160,160,2,2,0,1,0
24,175,175,23,23,0,1,0
15,185,185,2,2,0,1,0
17,186,186,21,21,0,1,0
21,191,191,21,21,0,1,0
14,197,197,28,28,0,1,0
7,234,234,6,1,5,2,1
10,241,241,28,22,6,2,1
11,246,246,1,1,0,1,0
12,270,270,41,33,8,3,2
8,275,275,25,7,18,4,3
3,329,329,7,1,6,2,1
4,332,332,41,25,16,3,2
9,339,339,32,6,26,3,2
5,348,348,12,12,0,1,0
1,353,353,10,10,0,1,0
16,407,407,13,4,9,4,3
26,424,424,103,7,96,4,3
13,435,435,42,3,39,2,1
18,438,438,13,13,0,1,0
27,439,439,14,9,5,2,1
20,477,477,28,1,27,4,3
19,488,488,81,7,74,3,2

11,104,104,18,2,16,2,1
23,120,120,41,31,10,2,1
7,123,123,4,1,3,2,1
21,129,129,13,5,8,2,1
20,131,131,13,13,0,1,0
2,137,137,3,3,0,1,0
18,138,138,1,1,0,1,0
17,214,214,12,12,0,1,0
13,220,220,6,6,0,1,0
16,224,224,34,27,7,2,1
19,270,270,21,3,18,4,3
15,292,292,40,22,18,3,2
0,296,296,87,87,0,1,0
1,303,303,11,11,0,1,0
10,405,405,28,28,0,1,0
4,408,408,5,5,0,1,0
22,417,417,20,20,0,1,0
9,427,427,73,46,27,4,3
6,430,430,15,15,0,1,0
12,449,449,77,77,0,1,0
3,472,472,42,19,23,2,1
5,478,478,56,56,0,1,0
8,483,483,73,31,42,4,3
14,492,492,4,1,3,2,1

13,103,103,8,1,7,2,1
10,110,110,14,14,0,1,0
24,118,118,6,6,0,1,0
14,154,154,33,33,0,1,0
0,161,161,16,7,9,4,3
25,172,172,12,12,0,1,0
5,181,181,34,21,13,2,1
18,194,194,15,9,6,2,1
21,205,205,38,38,0,1,0
22,208,208,14,14,0,1,0
12,230,230,7,2,5,2,1
1,261,261,31,19,12,4,3
20,313,313,5,5,0,1,0
19,318,318,41,41,0,1,0
16,340,340,73,73,0,1,0
4,353,353,23,23,0,1,0
15,358,358,37,4,33,2,1
17,392,392,12,7,5,2,1
3,404,404,33,33,0,1,0
2,415,415,5,5,0,1,0
11,418,418,64,31,33,4,3
6,422,422,11,11,0,1,0
23,446,446,32,3,29,4,3
8,449,449,69,9,60,4,3
9,484,484,27,4,23,2,1
7,487,487,10,3,7,2,1

18,102,102,8,1,7,2,1
8,103,103,9,9,0,1,0
9,113,113,15,15,0,1,0
19,153,153,2,2,0,1,0
13,155,155,25,25,0,1,0
15,165,165,12,12,0,1,0
11,188,188,6,6,0,1,0
16,220,220,75,18,57,4,3
14,238,238,11,11,0,1,0
0,246,246,6,6,0,1,0
4,251,251,2,2,0,1,0
3,266,266,10,10,0,1,0
10,275,275,1,1,0,1,0
6,284,284,5,5,0,1,0
7,303,303,6,6,0,1,0
2,319,319,108,30,78,4,3
5,348,348,40,32,8,3,2
17,376,376,44,44,0,1,0
12,378,378,88,58,30,3,2
1,421,421,179,144,35,2,1
21,443,443,10,10,0,1,0
20,467,467,48,48,0,1,0

4,106,106,5,1,4,2,1
6,135,135,14,14,0,1,0
7,138,138,19,19,0,1,0
0,142,142,13,1,12,3,2
2,165,165,20,16,4,2,1
14,169,169,13,13,0,1,0
17,171,171,4,4,0,1,0
1,198,198,14,14,0,1,0
15,247,247,65,31,34,2,1
21,278,278,29,17,12,4,3
11,313,313,16,6,10,2,1
19,340,340,65,65,0,1,0
3,346,346,29,19,10,2,1
18,370,370,31,31,0,1,0
10,382,382,90,78,12,4,3
13,403,403,5,5,0,1,0
9,404,404,36,36,0,1,0
12,430,430,41,41,0,1,0
8,441,441,55,55,0,1,0
22,461,461,35,35,0,1,0
16,468,468,16,16,0,1,0
5,478,478,46,46,0,1,0
20,493,493,101,41,60,3,2

19,104,104,6,6,0,1,0
7,115,115,7,1,6,2,1
1,130,130,4,1,3,2,1
9,156,156,1,1,0,1,0
5,221,221,62,62,0,1,0
12,233,233,15,10,5,2,1
2,246,246,55,25,30,4,3
21,247,247,103,103,0,1,0
15,254,254,6,2,4,2,1
8,270,270,25,25,0,1,0
23,275,275,13,2,11,2,1
17,278,278,6,6,0,1,0
20,301,301,29,5,24,4,3
11,339,339,99,47,52,3,2
6,378,378,20,20,0,1,0
16,436,436,6,3,3,2,1
10,446,446,18,18,0,1,0
0,446,446,18,18,0,1,0
14,462,462,121,34,87,4,3
3,463,463,2,2,0,1,0
4,469,469,36,36,0,1,0
22,469,469,4,4,0,1,0
18,476,476,10,10,0,1,0
13,485,485,94,79,15,4,3

14,107,107,12,8,4,2,1
17,151,151,12,4,8,3,2
1,163,163,8,5,3,2,1
25,189,189,9,1,8,3,2
18,195,195,39,39,0,1,0
20,198,198,17,4,13,2,1
4,200,200,1,1,0,1,0
7,226,226,8,8,0,1,0
19,238,238,42,12,30,2,1
12,282,282,1,1,0,1,0
22,283,283,5,5,0,1,0
10,298,298,22,3,19,2,1
27,312,312,30,30,0,1,0
24,325,325,86,50,36,4,3
15,332,332,86,16,70,3,2
2,357,357,8,8,0,1,0
9,368,368,54,16,38,3,2
6,370,370,37,37,0,1,0
23,378,378,32,32,0,1,0
8,400,400,16,6,10,2,1
11,434,434,18,9,9,4,3
13,440,440,45,19,26,2,1
16,458,458,13,13,0,1,0
26,463,463,63,42,21,4,3
0,467,467,49,49,0,1,0
21,470,470,1,1,0,1,0
5,484,484,35,35,0,1,0
3,496,496,17,17,0,1,0

8,104,104,4,4,0,1,0
24,115,115,3,3,0,1,0
23,120,120,30,30,0,1,0
19,125,125,5,5,0,1,0
22,131,131,20,20,0,1,0
11,143,143,8,1,7,2,1
18,159,159,20,6,14,3,2
13,170,170,4,4,0,1,0
9,198,198,20,14,6,3,2
12,214,214,8,8,0,1,0
14,217,217,7,2,5,2,1
10,220,220,16,16,0,1,0
21,265,265,9,1,8,3,2
5,268,268,77,66,11,4,3
7,323,323,12,9,3,2,1
2,332,332,11,11,0,1,0
4,372,372,9,9,0,1,0
15,376,376,128,128,0,1,0
16,404,404,19,19,0,1,0
1,457,457,47,23,24,4,3
20,483,483,24,4,20,3,2
0,483,483,18,18,0,1,0
17,484,484,53,53,0,1,0
6,487,487,94,58,36,4,3
3,499,499,91,51,40,3,2

6,104,104,1,1,0,1,0
7,114,114,5,5,0,1,0
14,133,133,11,11,0,1,0
19,145,145,17,17,0,1,0
0,192,192,4,4,0,1,0
25,199,199,13,13,0,1,0
4,205,205,10,1,9,4,3
23,246,246,64,64,0,1,0
8,257,257,6,3,3,2,1
18,271,271,29,18,11,2,1
12,276,276,24,14,10,2,1
1,276,276,50,50,0,1,0
13,285,285,68,32,36,2,1
20,287,287,35,19,16,2,1
2,295,295,7,1,6,3,2
17,303,303,10,1,9,4,3
3,306,306,5,5,0,1,0
11,335,335,54,24,30,4,3
26,354,354,1,1,0,1,0
10,374,374,1,1,0,1,0
9,383,383,19,19,0,1,0
16,388,388,44,4,40,2,1
15,392,392,99,90,9,2,1
21,397,397,42,42,0,1,0
24,406,406,6,6,0,1,0
22,428,428,8,8,0,1,0
5,459,459,100,85,15,2,1

7,112,112,1,1,0,1,0
15,123,123,2,2,0,1,0
19,137,137,4,1,3,2,1
6,177,177,13,10,3,2,1
16,204,204,17,17,0,1,0
12,204,204,11,11,0,1,0
4,209,209,22,22,0,1,0
25,209,209,22,6,16,2,1
0,238,238,24,2,22,3,2
21,243,243,2,2,0,1,0
2,247,247,44,7,37,2,1
18,252,252,85,85,0,1,0
28,259,259,14,14,0,1,0
13,266,266,4,4,0,1,0
5,281,281,49,17,32,3,2
8,297,297,31,3,28,3,2
11,304,304,11,11,0,1,0
22,319,319,22,22,0,1,0
20,327,327,9,3,6,3,2
24,351,351,11,11,0,1,0
1,358,358,11,5,6,3,2
3,418,418,46,27,19,3,2
26,425,425,68,17,51,4,3
10,430,430,1,1,0,1,0
9,441,441,28,1,27,2,1
17,443,443,120,60,60,3,2
27,451,451,11,5,6,3,2
23,460,460,50,50,0,1,0
14,483,483,22,22,0,1,0

12,119,119,11,1,10,3,2
8,139,139,3,3,0,1,0
17,148,148,2,2,0,1,0
14,185,185,54,21,33,2,1
0,196,196,6,6,0,1,0
20,207,207,54,54,0,1,0
22,212,212,83,74,9,2,1
1,213,213,9,2,7,2,1
15,226,226,12,12,0,1,0
6,228,228,32,17,15,4,3
24,239,239,2,2,0,1,0
3,249,249,1,1,0,1,0
25,285,285,13,8,5,2,1
9,290,290,8,8,0,1,0
2,295,295,58,58,0,1,0
7,310,310,17,5,12,4,3
21,315,315,54,40,14,2,1
19,320,320,24,24,0,1,0
13,379,379,15,15,0,1,0
18,400,400,52,52,0,1,0
10,414,414,1,1,0,1,0
4,429,429,54,54,0,1,0
26,431,431,16,6,10,2,1
27,435,435,10,2,8,2,1
23,443,443,13,13,0,1,0
16,451,451,14,14,0,1,0
5,478,478,19,19,0,1,0
11,496,496,20,20,0,1,0

27,118,118,13,1,12,3,2
25,132,132,4,4,0,1,0
19,143,143,17,5,12,4,3
21,146,146,5,5,0,1,0
1,160,160,48,48,0,1,0
13,164,164,1,1,0,1,0
22,171,171,2,2,0,1,0
28,189,189,42,42,0,1,0
16,190,190,6,6,0,1,0
11,269,269,14,4,10,3,2
0,269,269,29,15,14,2,1
4,277,277,12,4,8,2,1
15,287,287,12,12,0,1,0
10,293,293,36,36,0,1,0
7,294,294,5,5,0,1,0
18,297,297,39,11,28,3,2
2,308,308,18,18,0,1,0
20,320,320,59,4,55,4,3
14,333,333,7,7,0,1,0
23,358,358,1,1,0,1,0
26,370,370,20,20,0,1,0
8,389,389,33,33,0,1,0
17,413,413,53,8,45,2,1
12,434,434,19,10,9,2,1
6,441,441,67,67,0,1,0
5,447,447,10,1,9,4,3
3,465,465,16,2,14,2,1
9,477,477,31,2,29,3,2
24,477,477,95,26,69,4,3

13,104,104,1,1,0,1,0
6,106,106,1,1,0,1,0
2,110,110,37,1,36,3,2
11,126,126,3,3,0,1,0
3,133,133,1,1,0,1,0
10,152,152,50,50,0,1,0
20,177,177,12,12,0,1,0
5,182,182,4,4,0,1,0
12,188,188,16,1,15,4,3
15,189,189,3,3,0,1,0
19,205,205,5,5,0,1,0
9,243,243,52,26,26,2,1
8,262,262,28,10,18,3,2
14,283,283,74,74,0,1,0
16,284,284,16,16,0,1,0
18,296,296,15,15,0,1,0
1,367,367,27,27,0,1,0
7,430,430,56,44,12,3,2
4,431,431,145,139,6,3,2
0,449,449,80,80,0,1,0
17,468,468,48,48,0,1,0

20,129,129,19,19,0,1,0
6,143,143,3,3,0,1,0
12,149,149,8,8,0,1,0
14,156,156,16,16,0,1,0
3,161,161,44,44,0,1,0
16,170,170,2,2,0,1,0
18,178,178,10,10,0,1,0
0,191,191,18,18,0,1,0
15,201,201,4,4,0,1,0
17,205,205,37,37,0,1,0
5,246,246,50,50,0,1,0
11,254,254,34,19,15,2,1
21,271,271,9,9,0,1,0
19,320,320,23,23,0,1,0
13,354,354,76,4,72,4,3
1,357,357,29,29,0,1,0
8,379,379,64,64,0,1,0
2,387,387,27,13,14,2,1
7,420,420,43,43,0,1,0
9,431,431,22,4,18,2,1
10,444,444,88,74,14,2,1
4,465,465,63,19,44,2,1

13,102,102,1,1,0,1,0
28,125,125,35,35,0,1,0
9,152,152,11,3,8,2,1
17,167,167,1,1,0,1,0
23,174,174,20,5,15,4,3
18,181,181,20,3,17,2,1
22,181,181,28,18,10,2,1
1,187,187,1,1,0,1,0
7,188,188,14,6,8,2,1
4,207,207,31,31,0,1,0
25,207,207,37,13,24,4,3
6,213,213,9,9,0,1,0
24,215,215,39,39,0,1,0
16,222,222,5,5,0,1,0
21,237,237,25,3,22,3,2
20,240,240,3,3,0,1,0
30,245,245,14,14,0,1,0
2,299,299,8,3,5,2,1
15,329,329,21,3,18,3,2
8,330,330,17,3,14,3,2
10,338,338,9,5,4,2,1
27,338,338,25,25,0,1,0
26,348,348,4,4,0,1,0
29,355,355,13,5,8,2,1
0,356,356,34,7,27,4,3
19,411,411,7,7,0,1,0
12,419,419,51,23,28,2,1
5,456,456,12,1,11,4,3
14,461,461,35,35,0,1,0
3,492,492,31,15,16,3,2
11,494,494,79,79,0,1,0

4,133,133,27,27,0,1,0
15,141,141,10,10,0,1,0
13,148,148,10,6,4,2,1
7,151,151,15,15,0,1,0
14,156,156,7,7,0,1,0
8,181,181,45,45,0,1,0
3,192,192,31,20,11,2,1
10,207,207,34,23,11,2,1
20,262,262,11,1,10,3,2
11,274,274,2,2,0,1,0
5,286,286,12,12,0,1,0
2,303,303,3,3,0,1,0
9,322,322,34,34,0,1,0
0,331,331,24,24,0,1,0
19,335,335,3,3,0,1,0
1,340,340,3,3,0,1,0
22,381,381,41,41,0,1,0
21,395,395,114,114,0,1,0
12,427,427,66,66,0,1,0
16,450,450,129,7,122,4,3
6,454,454,40,40,0,1,0
17,457,457,63,21,42,4,3
18,474,474,3,3,0,1,0

20,115,115,32,32,0,1,0
1,129,129,33,33,0,1,0
6,130,130,20,12,8,2,1
0,167,167,24,16,8,3,2
8,236,236,6,6,0,1,0
9,237,237,2,2,0,1,0
13,249,249,4,4,0,1,0
18,276,276,10,10,0,1,0
5,305,305,39,39,0,1,0
17,312,312,23,5,18,3,2
19,323,323,64,64,0,1,0
22,331,331,4,4,0,1,0
16,349,349,57,42,15,4,3
14,365,365,14,14,0,1,0
21,371,371,12,6,6,2,1
10,394,394,16,2,14,3,2
7,424,424,5,5,0,1,0
15,451,451,50,21,29,2,1
12,475,475,106,106,0,1,0
3,477,477,34,34,0,1,0
2,487,487,117,76,41,4,3
11,489,489,17,17,0,1,0
4,496,496,61,26,35,3,2

22,108,108,17,3,14,2,1
9,111,111,6,6,0,1,0
19,148,148,4,4,0,1,0
0,160,160,36,36,0,1,0
5,172,172,2,2,0,1,0
4,179,179,6,6,0,1,0
11,182,182,3,3,0,1,0
21,183,183,16,16,0,1,0
14,183,183,1,1,0,1,0
1,211,211,3,3,0,1,0
20,260,260,18,18,0,1,0
25,294,294,33,33,0,1,0
26,309,309,12,12,0,1,0
6,310,310,51,9,42,3,2
23,329,329,76,76,0,1,0
12,338,338,36,36,0,1,0
18,362,362,31,21,10,3,2
3,375,375,40,40,0,1,0
7,387,387,28,16,12,3,2
16,391,391,33,30,3,2,1
13,395,395,105,64,41,2,1
27,398,398,47,47,0,1,0
24,400,400,34,24,10,2,1
10,427,427,1,1,0,1,0
2,437,437,35,35,0,1,0
17,455,455,60,29,31,2,1
8,490,490,15,8,7,2,1
15,493,493,6,6,0,1,0

18,125,125,15,15,0,1,0
16,129,129,14,14,0,1,0
7,142,142,1,1,0,1,0
20,162,162,8,8,0,1,0
5,172,172,9,9,0,1,0
6,177,177,19,19,0,1,0
3,198,198,33,24,9,2,1
21,203,203,53,53,0,1,0
19,214,214,23,23,0,1,0
8,236,236,2,2,0,1,0
9,255,255,23,10,13,2,1
0,264,264,46,46,0,1,0
10,271,271,16,4,12,3,2
4,317,317,80,80,0,1,0
15,318,318,28,28,0,1,0
14,348,348,28,6,22,3,2
2,364,364,15,3,12,2,1
13,386,386,37,37,0,1,0
12,418,418,34,34,0,1,0
1,431,431,130,130,0,1,0
17,434,434,46,34,12,2,1
11,482,482,29,29,0,1,0

12,100,100,2,2,0,1,0
3,123,123,2,2,0,1,0
7,134,134,17,17,0,1,0
4,139,139,5,1,4,2,1
9,168,168,10,10,0,1,0
8,170,170,19,19,0,1,0
28,170,170,23,15,8,2,1
5,205,205,7,7,0,1,0
15,214,214,37,37,0,1,0
24,221,221,12,5,7,2,1
13,236,236,9,9,0,1,0
23,245,245,45,45,0,1,0
27,256,256,30,30,0,1,0
18,283,283,86,86,0,1,0
17,304,304,37,16,21,2,1
26,314,314,32,4,28,2,1
25,321,321,31,9,22,2,1
20,328,328,15,1,14,2,1
6,348,348,20,11,9,2,1
22,352,352,7,3,4,2,1
11,358,358,1,1,0,1,0
19,377,377,32,16,16,2,1
16,388,388,69,69,0,1,0
29,414,414,9,9,0,1,0
21,432,432,24,10,14,2,1
14,451,451,36,36,0,1,0
0,475,475,8,8,0,1,0
10,475,475,44,44,0,1,0
1,481,481,14,14,0,1,0
2,485,485,4,4,0,1,0

17,103,103,20,2,18,3,2
0,130,130,47,17,30,3,2
8,170,170,3,3,0,1,0
15,186,186,2,2,0,1,0
5,221,221,1,1,0,1,0
4,227,227,3,3,0,1,0
12,260,260,31,9,22,2,1
3,280,280,44,26,18,3,2
1,284,284,24,16,8,3,2
18,300,300,30,30,0,1,0
6,326,326,2,2,0,1,0
2,349,349,111,103,8,3,2
19,354,354,73,23,50,2,1
10,377,377,5,5,0,1,0
13,388,388,15,15,0,1,0
23,399,399,15,7,8,2,1
20,437,437,26,26,0,1,0
14,451,451,38,16,22,2,1
21,464,464,93,93,0,1,0
22,477,477,50,14,36,2,1
7,480,480,36,36,0,1,0
11,494,494,39,39,0,1,0
16,496,496,33,33,0,1,0
9,497,497,35,30,5,2,1

4,100,100,7,3,4,2,1
12,118,118,1,1,0,1,0
23,164,164,1,1,0,1,0
25,187,187,14,1,13,3,2
11,188,188,8,1,7,2,1
19,223,223,44,19,25,2,1
22,226,226,13,13,0,1,0
8,229,229,18,18,0,1,0
18,230,230,8,8,0,1,0
10,246,246,30,30,0,1,0
6,262,262,30,30,0,1,0
2,282,282,47,2,45,2,1
16,304,304,29,1,28,3,2
15,318,318,6,6,0,1,0
21,342,342,7,7,0,1,0
7,342,342,87,57,30,3,2
3,343,343,1,1,0,1,0
5,358,358,4,4,0,1,0
13,393,393,48,48,0,1,0
0,427,427,19,2,17,3,2
20,435,435,96,39,57,4,3
24,472,472,63,63,0,1,0
14,474,474,10,5,5,2,1
17,488,488,166,127,39,4,3
9,495,495,43,43,0,1,0
1,497,497,38,38,0,1,0

2,100,100,7,7,0,1,0
13,102,102,3,3,0,1,0
3,126,126,18,6,12,4,3
5,141,141,24,24,0,1,0
18,164,164,11,2,9,4,3
11,180,180,33,14,19,2,1
0,190,190,25,14,11,2,1
8,216,216,16,16,0,1,0
21,253,253,19,2,17,2,1
22,270,270,12,12,0,1,0
7,278,278,2,2,0,1,0
9,282,282,35,35,0,1,0
19,310,310,68,68,0,1,0
16,340,340,25,25,0,1,0
1,364,364,25,25,0,1,0
4,370,370,22,22,0,1,0
15,383,383,127,104,23,2,1
12,424,424,9,5,4,2,1
14,446,446,31,31,0,1,0
17,461,461,23,18,5,2,1
10,483,483,146,84,62,4,3
6,483,483,24,5,19,2,1
20,485,485,28,8,20,2,1

22,105,105,51,21,30,4,3
6,146,146,7,4,3,2,1
17,178,178,16,16,0,1,0
16,185,185,15,2,13,3,2
12,197,197,8,8,0,1,0
4,202,202,17,2,15,2,1
11,222,222,27,3,24,4,3
14,225,225,17,17,0,1,0
15,227,227,33,33,0,1,0
10,264,264,2,2,0,1,0
2,269,269,8,8,0,1,0
21,278,278,16,16,0,1,0
23,292,292,21,21,0,1,0
8,298,298,11,11,0,1,0
19,307,307,5,5,0,1,0
20,347,347,13,1,12,4,3
9,385,385,6,1,5,2,1
24,409,409,14,5,9,2,1
0,415,415,117,117,0,1,0
5,419,419,80,80,0,1,0
18,428,428,12,1,11,3,2
25,430,430,42,21,21,4,3
7,430,430,19,10,9,4,3
13,472,472,58,58,0,1,0
3,486,486,1,1,0,1,0
1,496,496,87,87,0,1,0

19,107,107,10,4,6,3,2
10,123,123,1,1,0,1,0
21,132,132,8,3,5,2,1
17,145,145,4,4,0,1,0
6,171,171,10,10,0,1,0
11,180,180,6,6,0,1,0
26,193,193,4,4,0,1,0
15,195,195,7,7,0,1,0
2,204,204,10,3,7,2,1
7,214,214,79,66,13,2,1
24,227,227,5,5,0,1,0
25,235,235,11,11,0,1,0
1,245,245,3,3,0,1,0
14,248,248,5,5,0,1,0
18,267,267,118,59,59,4,3
16,283,283,13,8,5,2,1
5,286,286,30,30,0,1,0
28,287,287,32,9,23,3,2
20,294,294,8,8,0,1,0
12,303,303,17,11,6,2,1
8,322,322,57,57,0,1,0
3,324,324,2,2,0,1,0
27,344,344,24,24,0,1,0
13,355,355,15,15,0,1,0
9,360,360,2,2,0,1,0
4,367,367,19,19,0,1,0
0,470,470,59,47,12,2,1
23,479,479,27,27,0,1,0
22,496,496,123,91,32,3,2

0,112,112,5,5,0,1,0
14,139,139,4,1,3,2,1
5,151,151,10,10,0,1,0
2,162,162,11,11,0,1,0
17,182,182,7,3,4,2,1
13,207,207,8,8,0,1,0
23,222,222,24,10,14,3,2
6,233,233,21,21,0,1,0
10,234,234,13,1,12,3,2
7,237,237,3,3,0,1,0
11,272,272,52,52,0,1,0
1,272,272,48,26,22,2,1
12,277,277,9,9,0,1,0
22,277,277,69,31,38,2,1
16,296,296,8,2,6,3,2
19,333,333,71,71,0,1,0
4,346,346,52,52,0,1,0
20,353,353,12,4,8,3,2
15,357,357,51,51,0,1,0
9,371,371,10,10,0,1,0
21,390,390,62,38,24,4,3
3,397,397,15,15,0,1,0
18,407,407,1,1,0,1,0
24,422,422,75,75,0,1,0
8,454,454,114,15,99,4,3

14,107,107,6,6,0,1,0
5,127,127,24,18,6,2,1
21,132,132,2,2,0,1,0
9,159,159,24,18,6,2,1
4,181,181,9,9,0,1,0
11,184,184,4,4,0,1,0
19,198,198,20,7,13,2,1
0,199,199,6,6,0,1,0
2,222,222,15,15,0,1,0
25,225,225,68,38,30,4,3
18,242,242,45,45,0,1,0
1,242,242,24,24,0,1,0
17,271,271,38,38,0,1,0
22,275,275,27,22,5,2,1
15,278,278,13,13,0,1,0
12,292,292,6,6,0,1,0
7,316,316,111,67,44,4,3
3,321,321,5,1,4,2,1
10,328,328,7,7,0,1,0
6,330,330,6,3,3,2,1
24,337,337,4,4,0,1,0
8,345,345,30,30,0,1,0
13,399,399,32,26,6,2,1
16,430,430,12,12,0,1,0
23,445,445,3,3,0,1,0
20,472,472,110,92,18,2,1

17,119,119,11,11,0,1,0
1,138,138,2,2,0,1,0
3,149,149,43,10,33,4,3
23,152,152,25,25,0,1,0
10,160,160,11,11,0,1,0
19,199,199,68,68,0,1,0
28,208,208,11,6,5,2,1
21,209,209,16,16,0,1,0
16,212,212,4,4,0,1,0
5,221,221,8,5,3,2,1
14,222,222,2,2,0,1,0
13,223,223,2,2,0,1,0
4,247,247,30,30,0,1,0
20,293,293,1,1,0,1,0
0,303,303,26,20,6,3,2
24,309,309,4,4,0,1,0
9,310,310,4,4,0,1,0
27,330,330,50,19,31,2,1
12,337,337,42,42,0,1,0
25,346,346,24,24,0,1,0
8,380,380,70,45,25,2,1
26,408,408,1,1,0,1,0
6,413,413,37,7,30,4,3
7,428,428,7,7,0,1,0
11,437,437,13,13,0,1,0
18,452,452,8,8,0,1,0
22,470,470,112,88,24,2,1
15,480,480,22,22,0,1,0
2,483,483,22,10,12,4,3

7,104,104,4,4,0,1,0
8,112,112,1,1,0,1,0
16,135,135,6,6,0,1,0
29,145,145,21,5,16,3,2
18,147,147,1,1,0,1,0
23,150,150,4,1,3,2,1
0,204,204,19,10,9,4,3
5,211,211,3,3,0,1,0
21,246,246,54,18,36,3,2
24,249,249,21,13,8,3,2
12,253,253,29,29,0,1,0
10,268,268,7,7,0,1,0
11,288,288,17,17,0,1,0
30,302,302,4,4,0,1,0
17,305,305,73,73,0,1,0
1,324,324,3,3,0,1,0
4,332,332,5,5,0,1,0
27,335,335,76,4,72,4,3
20,343,343,9,9,0,1,0
15,365,365,5,5,0,1,0
26,368,368,37,37,0,1,0
28,403,403,28,7,21,2,1
25,420,420,48,48,0,1,0
14,432,432,21,21,0,1,0
6,432,432,45,36,9,4,3
3,433,433,85,1,84,3,2
31,441,441,68,2,66,4,3
13,442,442,33,28,5,2,1
19,447,447,1,1,0,1,0
9,475,475,15,15,0,1,0
2,480,480,29,29,0,1,0
22,492,492,22,7,15,2,1

17,126,126,1,1,0,1,0
3,130,130,1,1,0,1,0
18,130,130,8,8,0,1,0
16,149,149,7,7,0,1,0
21,194,194,44,44,0,1,0
13,214,214,9,6,3,2,1
11,217,217,50,30,20,2,1
4,236,236,8,8,0,1,0
15,272,272,47,47,0,1,0
10,294,294,25,19,6,3,2
12,301,301,7,1,6,3,2
9,302,302,93,9,84,4,3
7,325,325,70,70,0,1,0
22,358,358,10,3,7,2,1
20,359,359,32,8,24,2,1
5,387,387,32,16,16,3,2
8,393,393,1,1,0,1,0
19,415,415,49,24,25,4,3
14,453,453,80,80,0,1,0
6,462,462,89,8,81,4,3
0,473,473,2,2,0,1,0
1,477,477,58,26,32,2,1
2,481,481,72,32,40,4,3

16,118,118,9,9,0,1,0
3,121,121,2,2,0,1,0
10,139,139,40,40,0,1,0
8,146,146,16,2,14,3,2
12,188,188,16,16,0,1,0
6,197,197,17,17,0,1,0
13,209,209,22,22,0,1,0
17,226,226,26,17,9,4,3
18,227,227,8,8,0,1,0
9,235,235,2,2,0,1,0
0,241,241,16,7,9,2,1
14,250,250,6,6,0,1,0
7,290,290,38,1,37,2,1
5,321,321,121,103,18,3,2
15,323,323,9,9,0,1,0
2,333,333,8,8,0,1,0
4,374,374,234,234,0,1,0
1,415,415,3,3,0,1,0
11,445,445,102,102,0,1,0

9,116,116,4,4,0,1,0
20,134,134,8,8,0,1,0
3,139,139,4,4,0,1,0
23,156,156,1,1,0,1,0
16,161,161,14,3,11,2,1
22,192,192,3,3,0,1,0
11,241,241,12,12,0,1,0
2,258,258,14,14,0,1,0
26,283,283,114,38,76,3,2
6,286,286,91,53,38,2,1
17,289,289,3,3,0,1,0
27,293,293,3,3,0,1,0
19,315,315,5,5,0,1,0
14,378,378,10,10,0,1,0
25,382,382,41,41,0,1,0
10,387,387,4,4,0,1,0
24,394,394,34,1,33,2,1
28,398,398,36,36,0,1,0
21,402,402,139,63,76,3,2
0,409,409,49,13,36,3,2
7,417,417,12,12,0,1,0
13,431,431,42,42,0,1,0
15,434,434,6,6,0,1,0
5,452,452,17,17,0,1,0
4,452,452,22,13,9,2,1
18,459,459,31,31,0,1,0
1,477,477,39,6,33,4,3
8,487,487,11,4,7,2,1
12,499,499,72,61,11,2,1

14,138,138,32,11,21,4,3
22,157,157,5,2,3,2,1
9,209,209,5,1,4,2,1
13,223,223,2,2,0,1,0
10,249,249,19,19,0,1,0
5,250,250,56,56,0,1,0
8,263,263,23,3,20,2,1
18,269,269,63,63,0,1,0
15,278,278,38,2,36,3,2
11,283,283,15,15,0,1,0
20,310,310,19,8,11,2,1
16,313,313,16,16,0,1,0
17,321,321,6,6,0,1,0
2,335,335,21,21,0,1,0
19,345,345,1,1,0,1,0
6,349,349,15,15,0,1,0
21,441,441,121,63,58,4,3
0,450,450,79,79,0,1,0
1,461,461,53,53,0,1,0
7,472,472,53,53,0,1,0
4,473,473,60,50,10,3,2
12,482,482,56,56,0,1,0
3,485,485,49,39,10,3,2
23,497,497,28,18,10,2,1

13,102,102,8,8,0,1,0
14,128,128,1,1,0,1,0
18,135,135,15,15,0,1,0
8,143,143,47,20,27,4,3
22,144,144,7,7,0,1,0
16,194,194,70,64,6,2,1
17,238,238,93,33,60,4,3
4,258,258,83,5,78,4,3
11,297,297,16,16,0,1,0
2,316,316,3,3,0,1,0
20,338,338,9,9,0,1,0
7,338,338,10,5,5,2,1
5,353,353,15,9,6,2,1
21,371,371,29,29,0,1,0
0,376,376,1,1,0,1,0
3,405,405,36,9,27,2,1
19,407,407,7,7,0,1,0
1,414,414,56,56,0,1,0
15,424,424,3,3,0,1,0
6,427,427,42,6,36,2,1
10,441,441,12,12,0,1,0
12,454,454,15,15,0,1,0
9,484,484,57,57,0,1,0

18,101,101,4,4,0,1,0
7,130,130,5,5,0,1,0
5,158,158,16,10,6,3,2
0,170,170,16,16,0,1,0
11,180,180,37,3,34,3,2
6,188,188,12,2,10,3,2
20,194,194,23,23,0,1,0
23,211,211,46,24,22,2,1
10,212,212,21,21,0,1,0
22,234,234,17,17,0,1,0
4,240,240,16,4,12,3,2
8,245,245,7,1,6,2,1
14,249,249,9,9,0,1,0
1,251,251,10,10,0,1,0
17,278,278,6,6,0,1,0
15,296,296,4,1,3,2,1
9,302,302,12,12,0,1,0
21,312,312,58,58,0,1,0
19,346,346,10,6,4,2,1
13,352,352,54,54,0,1,0
3,374,374,28,1,27,4,3
12,384,384,19,19,0,1,0
2,436,436,131,44,87,4,3
16,439,439,44,44,0,1,0
24,470,470,108,30,78,4,3

23,116,116,9,9,0,1,0
11,132,132,8,8,0,1,0
1,161,161,2,2,0,1,0
17,183,183,4,4,0,1,0
9,190,190,1,1,0,1,0
20,198,198,31,15,16,2,1
19,210,210,37,37,0,1,0
10,215,215,13,13,0,1,0
3,227,227,4,4,0,1,0
21,254,254,53,20,33,4,3
13,254,254,13,7,6,3,2
5,265,265,41,27,14,3,2
2,269,269,19,19,0,1,0
18,272,272,8,8,0,1,0
7,292,292,30,30,0,1,0
14,309,309,39,39,0,1,0
16,320,320,8,2,6,3,2
15,330,330,89,26,63,4,3
4,335,335,61,27,34,4,3
22,379,379,11,11,0,1,0
0,402,402,92,12,80,3,2
12,421,421,9,9,0,1,0
6,441,441,34,34,0,1,0
24,448,448,31,31,0,1,0
25,450,450,14,7,7,2,1
8,461,461,72,26,46,3,2

21,138,138,1,1,0,1,0
5,155,155,13,1,12,2,1
14,173,173,2,2,0,1,0
23,185,185,33,7,26,2,1
4,213,213,4,4,0,1,0
3,221,221,35,35,0,1,0
11,221,221,27,27,0,1,0
0,227,227,8,8,0,1,0
10,242,242,7,7,0,1,0
18,251,251,6,6,0,1,0
22,252,252,29,11,18,2,1
16,283,283,147,99,48,2,1
8,303,303,50,17,33,4,3
19,308,308,3,3,0,1,0
13,322,322,17,17,0,1,0
17,356,356,44,20,24,3,2
2,377,377,12,12,0,1,0
6,382,382,6,1,5,2,1
12,385,385,23,23,0,1,0
9,390,390,40,30,10,2,1
7,433,433,73,73,0,1,0
20,465,465,2,2,0,1,0
15,474,474,53,11,42,2,1
1,480,480,130,49,81,4,3

19,105,105,11,11,0,1,0
2,115,115,5,5,0,1,0
5,129,129,15,9,6,2,1
12,217,217,9,4,5,2,1
8,226,226,17,17,0,1,0
14,230,230,58,14,44,3,2
6,264,264,2,2,0,1,0
4,270,270,54,16,38,2,1
15,284,284,3,3,0,1,0
20,306,306,81,19,62,3,2
0,309,309,36,13,23,2,1
10,317,317,42,42,0,1,0
17,337,337,42,42,0,1,0
16,344,344,1,1,0,1,0
18,359,359,17,3,14,2,1
3,378,378,79,39,40,3,2
13,412,412,66,66,0,1,0
11,414,414,32,32,0,1,0
7,426,426,24,24,0,1,0
21,437,437,26,2,24,4,3
9,452,452,76,76,0,1,0
1,452,452,35,21,14,2,1
22,496,496,37,1,36,2,1

5,143,143,19,4,15,2,1
20,160,160,11,3,8,3,2
6,172,172,7,7,0,1,0
22,172,172,9,5,4,2,1
13,177,177,38,38,0,1,0
14,183,183,15,15,0,1,0
19,185,185,13,10,3,2,1
8,205,205,6,3,3,2,1
18,221,221,40,40,0,1,0
0,235,235,65,6,59,4,3
12,262,262,7,7,0,1,0
15,279,279,3,3,0,1,0
9,301,301,36,36,0,1,0
4,316,316,15,1,14,3,2
3,376,376,34,34,0,1,0
11,403,403,13,6,7,2,1
17,406,406,52,8,44,2,1
16,418,418,58,58,0,1,0
10,419,419,48,48,0,1,0
21,434,434,93,59,34,2,1
7,438,438,41,41,0,1,0
1,449,449,82,82,0,1,0
2,484,484,36,6,30,4,3

6,101,101,28,28,0,1,0
18,107,107,5,5,0,1,0
16,133,133,42,42,0,1,0
17,161,161,21,2,19,2,1
14,161,161,12,12,0,1,0
9,165,165,11,8,3,2,1
4,189,189,1,1,0,1,0
22,190,190,4,4,0,1,0
12,213,213,31,25,6,2,1
8,224,224,13,13,0,1,0
23,255,255,13,8,5,2,1
11,292,292,12,3,9,2,1
7,302,302,34,6,28,2,1
21,313,313,4,4,0,1,0
20,318,318,19,7,12,4,3
0,367,367,11,5,6,2,1
24,381,381,23,23,0,1,0
19,387,387,48,48,0,1,0
1,423,423,5,5,0,1,0
5,427,427,12,8,4,2,1
2,430,430,82,44,38,2,1
25,445,445,23,23,0,1,0
10,467,467,27,5,22,3,2
13,477,477,26,7,19,2,1
3,489,489,59,16,43,2,1
15,492,492,138,113,25,3,2

23,106,106,4,4,0,1,0
24,106,106,11,1,10,3,2
15,114,114,2,2,0,1,0
12,116,116,1,1,0,1,0
7,120,120,5,1,4,2,1
8,127,127,6,6,0,1,0
22,137,137,14,14,0,1,0
28,143,143,32,32,0,1,0
20,156,156,10,2,8,2,1
25,157,157,15,7,8,2,1
27,189,189,7,7,0,1,0
0,189,189,33,33,0,1,0
29,195,195,18,18,0,1,0
13,204,204,17,8,9,2,1
30,209,209,4,4,0,1,0
6,284,284,13,9,4,2,1
17,288,288,1,1,0,1,0
1,316,316,25,16,9,2,1
2,325,325,1,1,0,1,0
10,326,326,5,5,0,1,0
5,330,330,10,2,8,2,1
18,355,355,6,6,0,1,0
4,361,361,28,28,0,1,0
14,365,365,124,124,0,1,0
19,392,392,44,2,42,2,1
11,395,395,2,2,0,1,0
26,396,396,13,2,11,2,1
16,401,401,13,13,0,1,0
21,447,447,92,92,0,1,0
31,477,477,104,104,0,1,0
9,480,480,2,2,0,1,0
3,483,483,31,31,0,1,0

5,121,121,3,3,0,1,0
6,150,150,1,1,0,1,0
13,156,156,10,4,6,3,2
12,187,187,29,13,16,2,1
21,188,188,20,11,9,2,1
20,204,204,7,7,0,1,0
0,205,205,2,2,0,1,0
25,214,214,26,17,9,4,3
22,219,219,8,8,0,1,0
11,234,234,18,10,8,3,2
16,239,239,8,1,7,2,1
8,248,248,17,17,0,1,0
18,267,267,33,33,0,1,0
10,271,271,2,2,0,1,0
26,291,291,101,68,33,2,1
24,293,293,82,82,0,1,0
4,334,334,25,18,7,2,1
23,363,363,34,16,18,2,1
9,363,363,13,13,0,1,0
2,388,388,36,15,21,2,1
7,392,392,11,7,4,2,1
19,395,395,10,5,5,2,1
1,396,396,112,112,0,1,0
14,398,398,76,37,39,4,3
17,449,449,7,7,0,1,0
3,450,450,37,29,8,3,2
15,461,461,4,4,0,1,0

4,100,100,7,7,0,1,0
21,105,105,13,4,9,4,3
19,129,129,10,10,0,1,0
20,131,131,11,2,9,2,1
5,138,138,24,10,14,2,1
27,161,161,6,6,0,1,0
3,222,222,2,2,0,1,0
7,230,230,1,1,0,1,0
16,235,235,11,1,10,3,2
2,266,266,46,46,0,1,0
1,292,292,6,6,0,1,0
13,300,300,43,25,18,3,2
25,313,313,8,8,0,1,0
23,320,320,64,52,12,4,3
9,336,336,8,1,7,2,1
18,356,356,5,5,0,1,0
8,359,359,44,44,0,1,0
14,364,364,5,5,0,1,0
15,378,378,34,28,6,2,1
12,391,391,28,8,20,3,2
17,394,394,70,25,45,4,3
24,411,411,23,7,16,2,1
22,421,421,116,68,48,2,1
11,427,427,39,39,0,1,0
6,433,433,35,2,33,2,1
26,437,437,48,48,0,1,0
0,444,444,1,1,0,1,0
10,498,498,55,55,0,1,0

1,131,131,5,5,0,1,0
0,137,137,6,6,0,1,0
4,142,142,3,3,0,1,0
22,142,142,15,5,10,2,1
24,146,146,51,51,0,1,0
10,179,179,9,9,0,1,0
18,259,259,7,3,4,2,1
5,266,266,7,7,0,1,0
21,273,273,76,10,66,4,3
20,281,281,12,12,0,1,0
25,304,304,2,2,0,1,0
7,317,317,53,53,0,1,0
17,319,319,3,3,0,1,0
11,327,327,45,19,26,2,1
13,342,342,27,27,0,1,0
23,344,344,20,20,0,1,0
3,364,364,28,28,0,1,0
19,398,398,32,32,0,1,0
2,398,398,51,23,28,2,1
6,400,400,57,39,18,3,2
14,406,406,21,21,0,1,0
16,422,422,26,26,0,1,0
9,423,423,18,3,15,2,1
12,435,435,71,14,57,4,3
8,442,442,37,37,0,1,0
15,472,472,74,74,0,1,0

19,109,109,9,4,5,2,1
21,127,127,9,9,0,1,0
20,130,130,34,7,27,2,1
11,162,162,7,7,0,1,0
7,162,162,45,45,0,1,0
6,165,165,59,10,49,2,1
8,183,183,1,1,0,1,0
18,190,190,2,2,0,1,0
3,203,203,9,1,8,2,1
16,207,207,26,26,0,1,0
4,235,235,21,21,0,1,0
5,284,284,25,25,0,1,0
1,297,297,44,44,0,1,0
2,309,309,4,4,0,1,0
13,330,330,94,50,44,2,1
15,381,381,25,1,24,2,1
17,393,393,6,6,0,1,0
0,406,406,50,50,0,1,0
14,420,420,59,59,0,1,0
12,425,425,5,5,0,1,0
9,467,467,25,5,20,2,1
10,493,493,60,60,0,1,0

12,112,112,35,35,0,1,0
4,113,113,17,17,0,1,0
8,169,169,32,32,0,1,0
21,171,171,9,9,0,1,0
2,175,175,27,27,0,1,0
9,175,175,31,19,12,2,1
13,186,186,2,2,0,1,0
20,189,189,2,2,0,1,0
11,228,228,9,1,8,2,1
7,246,246,5,2,3,2,1
5,262,262,3,3,0,1,0
6,266,266,5,5,0,1,0
17,272,272,10,1,9,4,3
0,303,303,95,43,52,3,2
10,306,306,9,6,3,2,1
18,368,368,24,24,0,1,0
16,376,376,27,27,0,1,0
1,392,392,31,31,0,1,0
19,408,408,75,75,0,1,0
15,426,426,145,96,49,2,1
3,465,465,42,42,0,1,0
14,476,476,37,37,0,1,0

2,100,100,21,9,12,2,1
8,109,109,15,7,8,2,1
13,135,135,1,1,0,1,0
14,166,166,13,13,0,1,0
15,200,200,2,2,0,1,0
10,224,224,4,4,0,1,0
9,225,225,42,42,0,1,0
7,241,241,59,59,0,1,0
0,282,282,27,27,0,1,0
4,304,304,57,47,10,3,2
12,324,324,53,53,0,1,0
3,338,338,65,65,0,1,0
6,365,365,71,71,0,1,0
17,365,365,11,11,0,1,0
18,403,403,69,59,10,3,2
16,410,410,69,9,60,4,3
11,466,466,37,37,0,1,0
1,481,481,20,16,4,2,1
19,488,488,85,19,66,4,3
5,489,489,18,18,0,1,0

18,103,103,5,5,0,1,0
22,108,108,31,16,15,2,1
7,137,137,7,7,0,1,0
24,151,151,7,7,0,1,0
12,161,161,6,6,0,1,0
6,173,173,14,14,0,1,0
11,198,198,2,2,0,1,0
1,202,202,3,3,0,1,0
0,210,210,2,2,0,1,0
8,227,227,61,61,0,1,0
15,233,233,1,1,0,1,0
28,277,277,10,10,0,1,0
14,281,281,11,11,0,1,0
23,294,294,8,2,6,2,1
2,300,300,76,63,13,2,1
16,316,316,59,27,32,4,3
9,337,337,2,2,0,1,0
26,351,351,2,2,0,1,0
10,353,353,10,1,9,4,3
20,372,372,62,18,44,2,1
21,399,399,72,16,56,3,2
4,399,399,42,2,40,3,2
5,411,411,7,7,0,1,0
3,430,430,34,34,0,1,0
17,441,441,2,2,0,1,0
25,441,441,124,124,0,1,0
19,473,473,61,54,7,2,1
13,475,475,5,5,0,1,0
27,479,479,6,1,5,2,1

12,101,101,33,22,11,2,1
0,103,103,15,2,13,4,3
7,127,127,45,25,20,2,1
1,138,138,7,1,6,3,2
22,156,156,16,4,12,2,1
15,170,170,12,12,0,1,0
21,208,208,43,22,21,4,3
3,213,213,1,1,0,1,0
18,225,225,18,10,8,3,2
10,228,228,2,2,0,1,0
13,241,241,8,8,0,1,0
8,288,288,9,2,7,2,1
19,305,305,36,18,18,2,1
11,307,307,1,1,0,1,0
4,318,318,37,37,0,1,0
6,322,322,93,54,39,4,3
17,331,331,35,4,31,2,1
9,357,357,20,20,0,1,0
20,365,365,12,1,11,4,3
5,376,376,7,7,0,1,0
14,414,414,6,1,5,2,1
23,417,417,42,42,0,1,0
2,445,445,55,55,0,1,0
16,446,446,16,16,0,1,0

1,115,115,25,1,24,3,2
4,120,120,10,1,9,2,1
0,139,139,7,7,0,1,0
2,150,150,14,2,12,3,2
11,153,153,13,13,0,1,0
8,169,169,7,7,0,1,0
9,185,185,5,5,0,1,0
6,208,208,11,11,0,1,0
23,213,213,29,29,0,1,0
25,220,220,20,5,15,4,3
24,244,244,11,5,6,3,2
14,258,258,28,6,22,3,2
26,259,259,46,28,18,2,1
7,262,262,12,12,0,1,0
10,278,278,55,55,0,1,0
18,326,326,16,2,14,3,2
3,375,375,7,7,0,1,0
22,380,380,7,7,0,1,0
17,408,408,72,30,42,4,3
16,422,422,17,11,6,2,1
19,428,428,55,40,15,4,3
21,432,432,55,55,0,1,0
5,461,461,17,17,0,1,0
15,464,464,33,33,0,1,0
12,467,467,1,1,0,1,0
20,481,481,75,75,0,1,0
13,485,485,68,47,21,4,3

10,130,130,9,6,3,2,1
14,152,152,10,10,0,1,0
13,157,157,6,6,0,1,0
20,194,194,35,3,32,2,1
1,197,197,15,7,8,2,1
18,231,231,5,5,0,1,0
3,232,232,7,4,3,2,1
25,234,234,37,15,22,2,1
4,243,243,10,10,0,1,0
7,247,247,16,3,13,2,1
5,251,251,14,4,10,2,1
29,269,269,11,11,0,1,0
27,274,274,19,19,0,1,0
8,277,277,2,2,0,1,0
15,288,288,2,2,0,1,0
30,307,307,1,1,0,1,0
23,308,308,21,2,19,2,1
19,320,320,13,13,0,1,0
9,362,362,16,16,0,1,0
0,367,367,104,104,0,1,0
26,368,368,1,1,0,1,0
6,374,374,60,39,21,4,3
31,377,377,32,32,0,1,0
11,381,381,3,3,0,1,0
21,399,399,155,77,78,4,3
12,445,445,27,27,0,1,0
24,457,457,61,7,54,3,2
22,467,467,5,5,0,1,0
28,472,472,35,35,0,1,0
17,481,481,1,1,0,1,0
2,482,482,31,31,0,1,0
16,499,499,30,4,26,3,2

11,115,115,5,5,0,1,0
21,133,133,10,1,9,4,3
3,153,153,9,9,0,1,0
1,155,155,26,5,21,4,3
18,177,177,43,43,0,1,0
12,191,191,22,2,20,4,3
19,225,225,1,1,0,1,0
17,228,228,26,26,0,1,0
20,246,246,6,6,0,1,0
22,251,251,36,2,34,3,2
4,266,266,22,13,9,4,3
8,283,283,3,3,0,1,0
24,302,302,24,24,0,1,0
5,309,309,1,1,0,1,0
0,335,335,24,24,0,1,0
6,338,338,10,10,0,1,0
2,342,342,42,18,24,2,1
15,348,348,20,20,0,1,0
14,376,376,20,20,0,1,0
7,385,385,61,6,55,4,3
13,404,404,23,23,0,1,0
10,452,452,35,25,10,2,1
23,454,454,152,130,22,2,1
9,462,462,121,85,36,4,3
16,471,471,19,19,0,1,0

0,101,101,20,9,11,2,1
21,109,109,5,5,0,1,0
16,132,132,10,2,8,3,2
20,134,134,4,4,0,1,0
5,146,146,2,2,0,1,0
18,153,153,66,56,10,3,2
4,156,156,6,1,5,2,1
13,166,166,5,5,0,1,0
3,182,182,27,27,0,1,0
17,196,196,2,2,0,1,0
8,204,204,4,4,0,1,0
10,242,242,15,15,0,1,0
1,297,297,85,2,83,3,2
19,312,312,63,63,0,1,0
15,319,319,36,36,0,1,0
2,332,332,4,4,0,1,0
14,355,355,14,14,0,1,0
6,380,380,143,101,42,2,1
7,408,408,30,4,26,2,1
9,421,421,15,7,8,3,2
12,479,479,59,59,0,1,0
11,484,484,34,34,0,1,0

12,144,144,12,12,0,1,0
0,159,159,40,40,0,1,0
14,159,159,2,2,0,1,0
26,177,177,5,5,0,1,0
15,187,187,14,2,12,3,2
5,192,192,3,3,0,1,0
20,201,201,55,55,0,1,0
25,209,209,20,4,16,2,1
3,242,242,5,5,0,1,0
24,256,256,6,6,0,1,0
13,267,267,29,29,0,1,0
4,290,290,18,4,14,2,1
18,300,300,23,23,0,1,0
21,300,300,9,3,6,2,1
16,308,308,11,1,10,3,2
22,314,314,27,27,0,1,0
23,319,319,41,28,13,2,1
19,334,334,105,72,33,4,3
7,341,341,12,12,0,1,0
17,347,347,21,6,15,4,3
11,352,352,71,71,0,1,0
1,396,396,39,4,35,3,2
9,399,399,21,15,6,2,1
6,433,433,1,1,0,1,0
10,462,462,1,1,0,1,0
2,471,471,35,16,19,2,1
8,492,492,90,90,0,1,0

30,100,100,19,19,0,1,0
19,101,101,10,10,0,1,0
13,103,103,4,1,3,2,1
4,113,113,3,3,0,1,0
11,142,142,17,5,12,4,3
23,143,143,17,17,0,1,0
21,143,143,2,2,0,1,0
25,165,165,37,15,22,3,2
29,169,169,19,19,0,1,0
28,171,171,14,2,12,3,2
6,197,197,3,3,0,1,0
22,211,211,21,9,12,3,2
27,220,220,9,6,3,2,1
20,225,225,29,29,0,1,0
15,229,229,7,7,0,1,0
14,237,237,27,27,0,1,0
12,255,255,21,21,0,1,0
0,263,263,16,16,0,1,0
10,266,266,35,35,0,1,0
1,295,295,55,28,27,2,1
7,317,317,7,7,0,1,0
18,320,320,17,17,0,1,0
9,336,336,46,46,0,1,0
3,340,340,17,17,0,1,0
8,367,367,7,7,0,1,0
5,376,376,17,17,0,1,0
2,381,381,13,13,0,1,0
26,399,399,11,5,6,2,1
24,432,432,40,40,0,1,0
16,466,466,8,8,0,1,0
17,477,477,8,8,0,1,0

7,109,109,32,32,0,1,0
20,135,135,14,14,0,1,0
4,190,190,16,4,12,3,2
11,193,193,11,11,0,1,0
16,195,195,13,13,0,1,0
9,196,196,5,5,0,1,0
21,201,201,1,1,0,1,0
6,209,209,53,53,0,1,0
1,236,236,13,13,0,1,0
15,239,239,8,8,0,1,0
19,263,263,40,40,0,1,0
10,270,270,101,83,18,3,2
3,275,275,3,3,0,1,0
18,280,280,40,27,13,2,1
0,325,325,57,35,22,3,2
12,403,403,6,3,3,2,1
13,408,408,43,13,30,4,3
17,451,451,11,11,0,1,0
8,460,460,27,27,0,1,0
14,465,465,68,62,6,2,1
2,483,483,58,12,46,2,1
5,486,486,60,60,0,1,0

18,133,133,1,1,0,1,0
26,133,133,12,4,8,2,1
6,143,143,24,24,0,1,0
5,146,146,14,14,0,1,0
11,153,153,1,1,0,1,0
3,158,158,19,19,0,1,0
23,160,160,24,20,4,2,1
25,173,173,47,47,0,1,0
2,196,196,4,4,0,1,0
13,200,200,1,1,0,1,0
21,203,203,25,18,7,2,1
16,208,208,30,30,0,1,0
27,217,217,6,3,3,2,1
0,230,230,10,10,0,1,0
4,241,241,22,22,0,1,0
8,246,246,5,5,0,1,0
1,248,248,69,66,3,2,1
14,263,263,4,4,0,1,0
17,282,282,15,15,0,1,0
19,292,292,7,7,0,1,0
24,327,327,50,50,0,1,0
22,337,337,40,40,0,1,0
10,363,363,13,6,7,2,1
20,389,389,26,26,0,1,0
15,405,405,66,66,0,1,0
9,445,445,3,3,0,1,0
7,482,482,54,54,0,1,0
12,499,499,9,2,7,2,1

23,112,112,12,2,10,2,1
18,121,121,7,1,6,3,2
13,135,135,37,37,0,1,0
20,175,175,2,2,0,1,0
7,206,206,1,1,0,1,0
4,259,259,4,4,0,1,0
5,260,260,34,34,0,1,0
9,280,280,5,2,3,2,1
3,302,302,136,104,32,4,3
17,313,313,67,35,32,2,1
10,318,318,27,27,0,1,0
12,322,322,1,1,0,1,0
11,339,339,85,85,0,1,0
1,344,344,47,47,0,1,0
14,354,354,49,23,26,2,1
2,399,399,2,2,0,1,0
16,404,404,103,103,0,1,0
19,413,413,9,2,7,2,1
8,444,444,2,2,0,1,0
15,455,455,5,2,3,2,1
21,455,455,5,5,0,1,0
6,457,457,15,7,8,3,2
0,465,465,31,21,10,2,1
22,498,498,63,63,0,1,0

10,102,102,11,2,9,2,1
15,106,106,2,2,0,1,0
9,147,147,1,1,0,1,0
24,182,182,61,2,59,4,3
0,191,191,4,4,0,1,0
20,201,201,29,22,7,2,1
21,235,235,10,1,9,4,3
4,239,239,6,6,0,1,0
13,239,239,9,9,0,1,0
12,248,248,11,1,10,3,2
23,257,257,89,89,0,1,0
7,269,269,20,20,0,1,0
5,285,285,40,14,26,3,2
18,294,294,27,3,24,4,3
11,303,303,82,82,0,1,0
6,320,320,31,15,16,2,1
19,330,330,46,22,24,2,1
14,337,337,56,10,46,2,1
22,338,338,4,4,0,1,0
8,341,341,21,1,20,3,2
17,387,387,4,4,0,1,0
1,395,395,21,21,0,1,0
26,439,439,13,4,9,2,1
2,477,477,38,38,0,1,0
16,479,479,25,25,0,1,0
25,481,481,1,1,0,1,0
3,492,492,8,8,0,1,0

23,104,104,4,4,0,1,0
1,114,114,32,6,26,2,1
19,140,140,15,1,14,3,2
12,170,170,24,12,12,3,2
0,170,170,17,7,10,3,2
7,213,213,28,4,24,4,3
2,218,218,45,29,16,2,1
3,229,229,18,6,12,3,2
15,238,238,10,10,0,1,0
5,243,243,44,44,0,1,0
11,278,278,4,4,0,1,0
8,298,298,1,1,0,1,0
9,326,326,29,23,6,2,1
18,353,353,77,77,0,1,0
16,362,362,12,3,9,4,3
4,366,366,10,1,9,4,3
10,391,391,19,19,0,1,0
21,401,401,18,18,0,1,0
13,423,423,96,96,0,1,0
6,432,432,18,9,9,3,2
20,437,437,15,15,0,1,0
22,468,468,106,91,15,3,2
17,480,480,16,16,0,1,0
14,481,481,37,24,13,2,1

17,106,106,10,4,6,2,1
2,113,113,2,2,0,1,0
23,120,120,2,2,0,1,0
8,132,132,6,6,0,1,0
7,132,132,14,14,0,1,0
25,136,136,21,9,12,2,1
0,137,137,11,11,0,1,0
16,144,144,4,4,0,1,0
10,145,145,12,12,0,1,0
1,156,156,20,9,11,2,1
24,188,188,31,31,0,1,0
20,196,196,41,41,0,1,0
11,258,258,5,5,0,1,0
21,266,266,52,52,0,1,0
6,277,277,1,1,0,1,0
13,306,306,34,34,0,1,0
29,357,357,33,33,0,1,0
18,364,364,14,14,0,1,0
4,396,396,34,34,0,1,0
22,401,401,20,20,0,1,0
14,410,410,47,13,34,2,1
26,413,413,39,39,0,1,0
9,435,435,27,27,0,1,0
15,453,453,20,5,15,2,1
12,455,455,37,16,21,2,1
27,470,470,35,9,26,2,1
19,479,479,8,8,0,1,0
5,483,483,45,8,37,2,1
3,497,497,5,5,0,1,0
28,499,499,59,59,0,1,0

20,126,126,7,7,0,1,0
9,132,132,6,6,0,1,0
7,136,136,8,2,6,2,1
5,137,137,3,3,0,1,0
22,138,138,1,1,0,1,0
0,139,139,13,3,10,2,1
18,193,193,31,17,14,3,2
21,199,199,12,12,0,1,0
10,217,217,48,42,6,3,2
15,232,232,7,7,0,1,0
8,246,246,81,44,37,2,1
19,284,284,4,4,0,1,0
16,290,290,162,162,0,1,0
17,333,333,22,22,0,1,0
3,351,351,14,14,0,1,0
6,373,373,70,70,0,1,0
13,385,385,39,25,14,3,2
11,412,412,25,1,24,2,1
12,426,426,39,39,0,1,0
14,439,439,6,6,0,1,0
4,450,450,59,33,26,2,1
2,461,461,19,19,0,1,0
1,475,475,15,15,0,1,0

18,157,157,14,14,0,1,0
19,173,173,9,1,8,2,1
16,181,181,5,5,0,1,0
3,184,184,20,2,18,3,2
1,192,192,8,1,7,2,1
10,223,223,6,3,3,2,1
0,235,235,64,64,0,1,0
12,268,268,132,121,11,2,1
15,268,268,10,10,0,1,0
11,282,282,49,49,0,1,0
8,283,283,9,9,0,1,0
14,285,285,14,14,0,1,0
17,307,307,15,15,0,1,0
20,318,318,2,2,0,1,0
2,342,342,57,35,22,3,2
6,347,347,150,40,110,4,3
13,387,387,54,54,0,1,0
7,404,404,26,5,21,4,3
5,416,416,9,3,6,3,2
4,428,428,27,27,0,1,0
9,494,494,41,14,27,4,3

13,150,150,2,2,0,1,0
7,160,160,8,2,6,3,2
14,179,179,11,11,0,1,0
2,193,193,53,53,0,1,0
6,195,195,17,17,0,1,0
4,196,196,43,33,10,3,2
16,199,199,17,17,0,1,0
9,203,203,8,8,0,1,0
15,213,213,7,7,0,1,0
0,237,237,9,3,6,3,2
21,249,249,5,5,0,1,0
20,259,259,50,24,26,4,3
10,263,263,5,5,0,1,0
8,274,274,1,1,0,1,0
5,304,304,13,13,0,1,0
12,348,348,111,13,98,4,3
19,356,356,45,45,0,1,0
11,366,366,77,77,0,1,0
17,371,371,10,1,9,2,1
22,384,384,49,49,0,1,0
1,394,394,37,37,0,1,0
18,405,405,37,37,0,1,0
23,413,413,51,3,48,4,3
3,468,468,57,39,18,3,2

16,120,120,3,3,0,1,0
7,147,147,36,36,0,1,0
11,153,153,14,14,0,1,0
9,173,173,4,4,0,1,0
1,198,198,31,31,0,1,0
0,205,205,58,58,0,1,0
10,259,259,76,48,28,2,1
12,277,277,70,21,49,4,3
15,295,295,12,12,0,1,0
8,315,315,10,5,5,2,1
3,322,322,80,40,40,2,1
13,332,332,11,5,6,2,1
14,342,342,41,41,0,1,0
4,350,350,11,11,0,1,0
2,393,393,97,97,0,1,0
18,434,434,21,2,19,3,2
5,443,443,19,19,0,1,0
6,446,446,86,10,76,3,2
17,497,497,7,7,0,1,0

8,125,125,19,13,6,2,1
18,132,132,19,19,0,1,0
2,134,134,2,2,0,1,0
15,148,148,6,3,3,2,1
16,152,152,9,9,0,1,0
10,173,173,7,7,0,1,0
12,183,183,3,3,0,1,0
22,194,194,51,51,0,1,0
21,197,197,17,5,12,2,1
23,232,232,21,9,12,2,1
17,242,242,7,1,6,3,2
25,247,247,15,3,12,4,3
9,251,251,20,20,0,1,0
20,257,257,8,8,0,1,0
3,258,258,7,7,0,1,0
11,263,263,71,55,16,2,1
6,285,285,4,4,0,1,0
4,292,292,23,23,0,1,0
7,295,295,41,41,0,1,0
24,311,311,61,61,0,1,0
26,316,316,22,8,14,2,1
1,326,326,6,6,0,1,0
19,333,333,55,13,42,2,1
13,378,378,12,12,0,1,0
14,406,406,61,49,12,4,3
5,436,436,35,35,0,1,0
0,456,456,40,11,29,2,1

5,102,102,8,4,4,2,1
10,105,105,8,2,6,3,2
29,123,123,3,3,0,1,0
26,125,125,1,1,0,1,0
2,141,141,8,8,0,1,0
14,144,144,2,2,0,1,0
23,144,144,5,5,0,1,0
15,230,230,28,9,19,2,1
22,231,231,1,1,0,1,0
27,234,234,8,8,0,1,0
3,242,242,2,2,0,1,0
12,247,247,20,20,0,1,0
30,252,252,32,7,25,2,1
6,258,258,14,4,10,3,2
4,266,266,6,6,0,1,0
24,268,268,58,30,28,2,1
0,270,270,8,8,0,1,0
20,297,297,6,6,0,1,0
16,308,308,8,1,7,2,1
13,323,323,9,1,8,3,2
19,341,341,57,57,0,1,0
9,362,362,30,14,16,2,1
11,415,415,27,27,0,1,0
18,418,418,27,7,20,3,2
28,420,420,21,3,18,4,3
8,446,446,31,31,0,1,0
17,455,455,32,32,0,1,0
7,468,468,52,14,38,3,2
1,473,473,67,67,0,1,0
21,477,477,113,4,109,4,3
25,477,477,145,145,0,1,0

11,110,110,3,3,0,1,0
15,130,130,20,20,0,1,0
9,144,144,1,1,0,1,0
12,154,154,35,6,29,2,1
19,192,192,9,3,6,3,2
16,201,201,11,11,0,1,0
10,264,264,28,16,12,4,3
5,279,279,39,39,0,1,0
2,287,287,90,64,26,3,2
0,293,293,78,58,20,2,1
1,296,296,5,5,0,1,0
3,312,312,88,16,72,4,3
13,320,320,57,57,0,1,0
17,341,341,10,2,8,3,2
18,360,360,21,21,0,1,0
4,394,394,2,2,0,1,0
8,404,404,1,1,0,1,0
7,409,409,19,2,17,2,1
6,451,451,59,59,0,1,0
14,483,483,163,160,3,2,1

13,121,121,10,10,0,1,0
24,169,169,27,27,0,1,0
3,172,172,62,62,0,1,0
9,178,178,39,39,0,1,0
0,196,196,7,1,6,3,2
4,199,199,9,9,0,1,0
20,209,209,14,7,7,2,1
7,213,213,11,11,0,1,0
8,215,215,7,7,0,1,0
10,219,219,6,6,0,1,0
22,258,258,41,5,36,2,1
11,261,261,30,6,24,3,2
12,269,269,10,10,0,1,0
23,270,270,13,13,0,1,0
14,272,272,55,5,50,4,3
6,273,273,3,3,0,1,0
1,282,282,18,8,10,3,2
16,336,336,43,6,37,4,3
15,379,379,29,29,0,1,0
17,398,398,21,12,9,2,1
18,408,408,8,8,0,1,0
19,437,437,65,31,34,2,1
2,462,462,21,21,0,1,0
5,475,475,75,75,0,1,0
21,480,480,35,23,12,4,3

21,103,103,3,3,0,1,0
0,105,105,13,2,11,2,1
24,113,113,4,4,0,1,0
13,123,123,22,22,0,1,0
1,124,124,14,6,8,3,2
5,131,131,4,4,0,1,0
17,153,153,34,1,33,4,3
15,169,169,19,19,0,1,0
12,174,174,6,6,0,1,0
20,189,189,6,6,0,1,0
6,237,237,24,24,0,1,0
19,258,258,51,51,0,1,0
18,259,259,23,6,17,2,1
2,261,261,1,1,0,1,0
25,284,284,97,93,4,2,1
7,290,290,75,75,0,1,0
22,312,312,6,2,4,2,1
4,322,322,13,5,8,2,1
9,337,337,5,1,4,2,1
14,394,394,51,51,0,1,0
8,415,415,25,13,12,4,3
23,419,419,3,3,0,1,0
10,448,448,41,41,0,1,0
3,453,453,25,25,0,1,0
16,457,457,8,8,0,1,0
11,464,464,47,47,0,1,0

11,100,100,7,7,0,1,0
2,122,122,4,1,3,2,1
0,128,128,10,10,0,1,0
21,140,140,9,1,8,3,2
20,144,144,9,9,0,1,0
18,147,147,21,3,18,4,3
8,160,160,1,1,0,1,0
15,171,171,4,1,3,2,1
3,187,187,1,1,0,1,0
12,187,187,27,7,20,4,3
31,195,195,2,2,0,1,0
9,196,196,18,3,15,4,3
14,208,208,1,1,0,1,0
28,209,209,13,3,10,3,2
5,220,220,10,10,0,1,0
17,237,237,23,23,0,1,0
7,270,270,19,19,0,1,0
1,273,273,1,1,0,1,0
25,305,305,17,17,0,1,0
24,320,320,40,25,15,2,1
6,332,332,46,46,0,1,0
30,335,335,64,18,46,2,1
23,357,357,87,51,36,4,3
4,364,364,1,1,0,1,0
26,378,378,62,62,0,1,0
29,407,407,1,1,0,1,0
16,427,427,1,1,0,1,0
27,437,437,81,46,35,2,1
13,438,438,36,36,0,1,0
32,449,449,41,25,16,2,1
22,458,458,15,10,5,2,1
10,459,459,9,9,0,1,0
19,461,461,37,37,0,1,0

8,106,106,2,2,0,1,0
2,119,119,11,5,6,3,2
22,125,125,52,52,0,1,0
1,128,128,1,1,0,1,0
24,128,128,5,5,0,1,0
21,129,129,8,8,0,1,0
17,180,180,12,12,0,1,0
12,186,186,1,1,0,1,0
26,205,205,20,20,0,1,0
6,209,209,38,6,32,3,2
23,265,265,43,43,0,1,0
25,272,272,2,2,0,1,0
7,277,277,16,4,12,3,2
14,281,281,52,39,13,2,1
15,296,296,4,1,3,2,1
9,302,302,71,19,52,4,3
16,321,321,24,24,0,1,0
19,349,349,20,20,0,1,0
20,370,370,2,2,0,1,0
5,379,379,12,5,7,2,1
13,386,386,52,15,37,2,1
27,421,421,28,18,10,3,2
4,431,431,14,9,5,2,1
0,431,431,42,13,29,4,3
3,457,457,5,2,3,2,1
11,461,461,1,1,0,1,0
10,468,468,45,45,0,1,0
18,495,495,88,22,66,4,3

26,105,105,12,12,0,1,0
7,117,117,8,4,4,2,1
23,129,129,1,1,0,1,0
21,157,157,65,65,0,1,0
1,175,175,38,38,0,1,0
28,183,183,8,8,0,1,0
19,205,205,10,10,0,1,0
3,211,211,1,1,0,1,0
0,245,245,35,1,34,3,2
13,250,250,1,1,0,1,0
2,295,295,7,4,3,2,1
6,310,310,11,11,0,1,0
24,322,322,22,22,0,1,0
27,324,324,23,23,0,1,0
11,337,337,10,6,4,2,1
16,348,348,74,74,0,1,0
9,373,373,99,19,80,4,3
8,394,394,24,18,6,2,1
12,400,400,16,16,0,1,0
4,414,414,18,2,16,2,1
25,424,424,11,7,4,2,1
5,427,427,12,12,0,1,0
18,436,436,18,18,0,1,0
17,443,443,32,12,20,2,1
22,452,452,48,15,33,4,3
15,458,458,4,4,0,1,0
10,467,467,1,1,0,1,0
14,467,467,7,7,0,1,0
20,486,486,105,9,96,4,3

14,122,122,8,8,0,1,0
24,128,128,26,17,9,4,3
12,138,138,8,8,0,1,0
26,146,146,8,8,0,1,0
27,152,152,7,4,3,2,1
20,152,152,3,3,0,1,0
16,191,191,15,15,0,1,0
5,198,198,27,15,12,2,1
29,232,232,17,17,0,1,0
3,242,242,9,1,8,2,1
18,272,272,26,26,0,1,0
13,274,274,9,9,0,1,0
8,281,281,4,4,0,1,0
11,287,287,13,13,0,1,0
23,296,296,48,48,0,1,0
9,322,322,1,1,0,1,0
28,330,330,24,24,0,1,0
10,355,355,17,17,0,1,0
17,357,357,12,12,0,1,0
4,364,364,12,8,4,2,1
22,368,368,29,29,0,1,0
15,370,370,22,22,0,1,0
21,376,376,12,12,0,1,0
0,380,380,52,24,28,3,2
7,392,392,41,4,37,2,1
25,393,393,127,98,29,2,1
2,411,411,108,81,27,2,1
6,426,426,1,1,0,1,0
19,466,466,30,30,0,1,0
1,496,496,25,13,12,3,2

17,107,107,3,3,0,1,0
24,146,146,23,23,0,1,0
21,152,152,5,5,0,1,0
13,173,173,37,25,12,3,2
1,197,197,10,2,8,2,1
23,203,203,5,5,0,1,0
18,215,215,1,1,0,1,0
0,222,222,13,13,0,1,0
19,224,224,6,1,5,2,1
6,261,261,80,80,0,1,0
3,272,272,25,25,0,1,0
2,274,274,4,4,0,1,0
15,312,312,42,22,20,2,1
20,332,332,23,23,0,1,0
16,351,351,42,37,5,2,1
12,364,364,59,59,0,1,0
9,370,370,35,7,28,3,2
7,417,417,36,2,34,4,3
4,426,426,7,1,6,2,1
22,453,453,46,2,44,2,1
10,463,463,36,36,0,1,0
14,465,465,143,116,27,4,3
11,473,473,70,70,0,1,0
5,474,474,36,36,0,1,0
8,478,478,9,2,7,2,1

1,119,119,8,1,7,2,1
11,123,123,2,2,0,1,0
17,131,131,41,31,10,3,2
13,141,141,11,11,0,1,0
8,163,163,72,51,21,4,3
3,176,176,18,10,8,3,2
10,177,177,25,25,0,1,0
23,183,183,56,56,0,1,0
15,205,205,17,17,0,1,0
7,235,235,11,5,6,3,2
2,245,245,17,13,4,2,1
20,263,263,5,5,0,1,0
24,270,270,4,4,0,1,0
5,284,284,1,1,0,1,0
14,288,288,23,23,0,1,0
9,291,291,18,18,0,1,0
22,298,298,6,1,5,2,1
0,320,320,22,22,0,1,0
16,383,383,29,29,0,1,0
4,399,399,38,30,8,3,2
19,426,426,22,22,0,1,0
12,437,437,34,4,30,4,3
18,465,465,19,19,0,1,0
6,466,466,4,4,0,1,0
21,469,469,70,70,0,1,0

10,119,119,15,15,0,1,0
21,136,136,9,2,7,2,1
3,140,140,9,9,0,1,0
14,158,158,18,18,0,1,0
5,163,163,1,1,0,1,0
1,178,178,51,51,0,1,0
4,193,193,11,11,0,1,0
18,200,200,40,22,18,4,3
15,227,227,3,3,0,1,0
20,234,234,56,45,11,2,1
0,247,247,23,5,18,4,3
9,265,265,55,41,14,2,1
7,315,315,16,8,8,3,2
6,320,320,44,44,0,1,0
16,341,341,51,6,45,2,1
17,359,359,6,6,0,1,0
22,362,362,57,53,4,2,1
2,371,371,59,23,36,3,2
11,424,424,29,29,0,1,0
12,444,444,19,5,14,3,2
13,479,479,49,15,34,2,1
19,492,492,27,27,0,1,0
8,493,493,10,2,8,2,1

6,106,106,5,5,0,1,0
8,113,113,13,13,0,1,0
15,170,170,10,10,0,1,0
3,241,241,28,28,0,1,0
4,255,255,20,20,0,1,0
9,268,268,12,12,0,1,0
17,277,277,57,57,0,1,0
13,278,278,16,16,0,1,0
10,314,314,17,5,12,3,2
7,319,319,8,8,0,1,0
18,352,352,2,2,0,1,0
11,364,364,130,30,100,4,3
19,390,390,13,13,0,1,0
0,393,393,209,209,0,1,0
14,413,413,5,2,3,2,1
12,444,444,34,34,0,1,0
2,445,445,1,1,0,1,0
1,456,456,104,57,47,3,2
16,461,461,96,96,0,1,0
5,495,495,85,36,49,2,1

0,113,113,1,1,0,1,0
14,114,114,2,2,0,1,0
2,119,119,11,2,9,2,1
11,144,144,1,1,0,1,0
22,145,145,4,4,0,1,0
23,162,162,11,11,0,1,0
28,170,170,11,11,0,1,0
1,183,183,34,34,0,1,0
17,186,186,1,1,0,1,0
9,198,198,38,5,33,4,3
18,217,217,27,21,6,3,2
8,234,234,39,1,38,2,1
7,261,261,7,1,6,2,1
31,293,293,24,1,23,2,1
3,295,295,1,1,0,1,0
24,306,306,4,4,0,1,0
27,322,322,103,53,50,3,2
12,323,323,13,2,11,4,3
5,325,325,41,25,16,2,1
4,336,336,11,5,6,2,1
26,340,340,61,38,23,3,2
16,402,402,13,3,10,3,2
15,410,410,10,1,9,4,3
13,411,411,26,14,12,4,3
21,427,427,46,46,0,1,0
25,447,447,68,38,30,3,2
30,451,451,33,7,26,2,1
29,455,455,51,1,50,2,1
10,460,460,4,4,0,1,0
6,465,465,1,1,0,1,0
20,476,476,12,2,10,2,1
19,492,492,20,20,0,1,0

6,118,118,1,1,0,1,0
29,143,143,4,1,3,2,1
3,148,148,3,3,0,1,0
19,161,161,15,6,9,4,3
13,163,163,30,30,0,1,0
12,166,166,5,5,0,1,0
25,166,166,10,10,0,1,0
14,193,193,6,6,0,1,0
23,198,198,12,12,0,1,0
17,205,205,8,5,3,2,1
24,250,250,84,6,78,3,2
20,292,292,32,20,12,3,2
22,307,307,1,1,0,1,0
26,309,309,47,2,45,4,3
18,313,313,5,1,4,2,1
27,318,318,27,27,0,1,0
10,319,319,9,9,0,1,0
7,327,327,4,4,0,1,0
15,336,336,10,10,0,1,0
9,340,340,30,2,28,3,2
4,364,364,8,8,0,1,0
11,366,366,2,2,0,1,0
1,388,388,36,36,0,1,0
5,389,389,13,4,9,2,1
28,407,407,80,80,0,1,0
0,438,438,55,55,0,1,0
16,449,449,41,41,0,1,0
21,465,465,37,7,30,3,2
8,466,466,67,37,30,3,2
2,481,481,105,105,0,1,0

18,139,139,8,2,6,3,2
22,140,140,10,10,0,1,0
1,192,192,31,31,0,1,0
4,227,227,6,2,4,2,1
11,258,258,5,5,0,1,0
3,260,260,25,7,18,3,2
13,264,264,44,44,0,1,0
2,276,276,18,2,16,2,1
21,293,293,62,62,0,1,0
0,314,314,1,1,0,1,0
12,339,339,17,7,10,2,1
5,346,346,42,6,36,4,3
20,350,350,26,15,11,2,1
15,351,351,80,20,60,3,2
19,351,351,10,3,7,2,1
9,361,361,135,135,0,1,0
6,393,393,42,42,0,1,0
8,397,397,73,5,68,3,2
14,421,421,30,27,3,2,1
7,461,461,2,2,0,1,0
17,479,479,22,22,0,1,0
10,481,481,28,28,0,1,0
16,499,499,100,16,84,3,2

3,165,165,4,4,0,1,0
21,167,167,8,8,0,1,0
1,205,205,26,19,7,2,1
6,227,227,20,16,4,2,1
2,234,234,1,1,0,1,0
17,255,255,12,4,8,3,2
8,261,261,61,61,0,1,0
25,270,270,8,8,0,1,0
14,276,276,5,5,0,1,0
0,282,282,16,11,5,2,1
5,289,289,55,46,9,4,3
9,315,315,15,15,0,1,0
7,342,342,1,1,0,1,0
4,345,345,14,8,6,2,1
24,346,346,31,25,6,2,1
13,385,385,13,7,6,3,2
11,407,407,52,52,0,1,0
23,410,410,25,9,16,3,2
10,414,414,62,62,0,1,0
16,423,423,58,58,0,1,0
12,427,427,32,16,16,2,1
19,444,444,114,37,77,4,3
18,454,454,56,36,20,2,1
20,456,456,86,28,58,3,2
15,493,493,11,11,0,1,0
22,500,500,102,65,37,2,1

18,114,114,19,10,9,4,3
2,127,127,19,13,6,2,1
5,158,158,23,17,6,2,1
8,179,179,11,11,0,1,0
16,192,192,12,12,0,1,0
1,195,195,26,26,0,1,0
13,213,213,32,11,21,4,3
0,229,229,59,14,45,2,1
17,256,256,90,90,0,1,0
15,275,275,10,4,6,3,2
4,307,307,6,6,0,1,0
14,307,307,46,42,4,2,1
19,367,367,2,2,0,1,0
10,385,385,19,9,10,2,1
7,387,387,27,27,0,1,0
6,423,423,146,77,69,4,3
12,460,460,63,21,42,4,3
9,464,464,6,1,5,2,1
20,464,464,3,3,0,1,0
11,473,473,42,9,33,2,1
3,486,486,9,3,6,2,1

25,101,101,8,8,0,1,0
16,102,102,22,22,0,1,0
7,107,107,12,12,0,1,0
10,163,163,1,1,0,1,0
9,173,173,9,3,6,2,1
6,179,179,3,3,0,1,0
1,193,193,14,8,6,3,2
2,207,207,35,7,28,3,2
21,214,214,6,6,0,1,0
8,241,241,5,5,0,1,0
12,285,285,5,5,0,1,0
3,323,323,3,3,0,1,0
11,330,330,36,36,0,1,0
27,350,350,29,4,25,3,2
4,351,351,45,10,35,2,1
26,357,357,45,7,38,3,2
24,371,371,2,2,0,1,0
15,399,399,26,26,0,1,0
18,409,409,37,37,0,1,0
19,419,419,8,8,0,1,0
5,429,429,65,65,0,1,0
22,433,433,9,9,0,1,0
20,435,435,20,20,0,1,0
13,441,441,26,5,21,4,3
17,465,465,194,158,36,4,3
0,483,483,38,38,0,1,0
14,484,484,64,64,0,1,0
23,500,500,50,17,33,2,1

0,104,104,4,4,0,1,0
14,143,143,13,13,0,1,0
19,151,151,16,16,0,1,0
16,167,167,10,1,9,4,3
15,178,178,27,27,0,1,0
3,192,192,41,41,0,1,0
7,192,192,32,32,0,1,0
21,201,201,58,36,22,2,1
24,212,212,7,7,0,1,0
18,214,214,57,57,0,1,0
1,218,218,1,1,0,1,0
23,232,232,15,1,14,3,2
17,248,248,27,9,18,2,1
4,261,261,2,2,0,1,0
6,270,270,26,26,0,1,0
13,317,317,33,33,0,1,0
5,320,320,63,28,35,2,1
25,332,332,7,7,0,1,0
12,364,364,6,6,0,1,0
10,367,367,10,10,0,1,0
2,393,393,80,80,0,1,0
8,399,399,14,14,0,1,0
9,404,404,23,9,14,2,1
22,404,404,5,5,0,1,0
20,458,458,13,13,0,1,0
11,495,495,17,17,0,1,0

21,106,106,23,12,11,2,1
1,121,121,3,3,0,1,0
15,143,143,3,3,0,1,0
3,145,145,14,10,4,2,1
13,181,181,6,6,0,1,0
17,188,188,18,4,14,3,2
5,214,214,1,1,0,1,0
14,236,236,22,22,0,1,0
7,244,244,12,12,0,1,0
9,272,272,1,1,0,1,0
6,307,307,19,19,0,1,0
20,309,309,33,25,8,3,2
22,316,316,74,12,62,4,3
8,325,325,1,1,0,1,0
16,408,408,76,76,0,1,0
18,431,431,27,1,26,3,2
23,458,458,8,2,6,3,2
11,463,463,142,142,0,1,0
19,464,464,54,54,0,1,0
4,474,474,49,4,45,2,1
12,475,475,171,171,0,1,0
24,487,487,18,18,0,1,0
2,491,491,7,7,0,1,0
0,495,495,7,7,0,1,0
10,497,497,79,79,0,1,0

16,157,157,1,1,0,1,0
15,185,185,19,8,11,2,1
3,196,196,58,58,0,1,0
12,211,211,4,1,3,2,1
7,252,252,25,25,0,1,0
5,260,260,15,7,8,3,2
4,303,303,6,6,0,1,0
2,305,305,22,14,8,2,1
0,317,317,112,112,0,1,0
6,339,339,101,101,0,1,0
11,366,366,20,20,0,1,0
17,369,369,4,4,0,1,0
8,375,375,73,21,52,4,3
9,408,408,12,12,0,1,0
14,420,420,127,127,0,1,0
10,447,447,36,32,4,2,1
18,487,487,6,6,0,1,0
1,491,491,51,29,22,2,1
13,497,497,152,94,58,4,3

14,117,117,13,13,0,1,0
17,138,138,2,2,0,1,0
2,139,139,48,48,0,1,0
11,153,153,2,2,0,1,0
16,155,155,37,13,24,2,1
7,181,181,12,7,5,2,1
12,239,239,1,1,0,1,0
10,247,247,39,15,24,3,2
22,256,256,27,27,0,1,0
8,272,272,4,4,0,1,0
19,287,287,32,32,0,1,0
0,288,288,54,54,0,1,0
3,288,288,1,1,0,1,0
13,316,316,9,6,3,2,1
9,319,319,26,14,12,4,3
18,352,352,22,22,0,1,0
15,361,361,18,9,9,4,3
6,366,366,22,22,0,1,0
1,368,368,5,5,0,1,0
21,391,391,40,40,0,1,0
5,396,396,47,31,16,3,2
24,428,428,15,3,12,2,1
4,458,458,63,19,44,2,1
23,483,483,107,71,36,3,2
20,487,487,68,68,0,1,0

20,100,100,19,19,0,1,0
3,109,109,2,2,0,1,0
10,128,128,12,12,0,1,0
8,143,143,1,1,0,1,0
22,158,158,9,9,0,1,0
16,161,161,2,2,0,1,0
17,181,181,20,20,0,1,0
12,199,199,1,1,0,1,0
24,208,208,39,19,20,3,2
18,225,225,14,2,12,3,2
25,232,232,4,4,0,1,0
19,240,240,80,80,0,1,0
2,257,257,12,12,0,1,0
21,264,264,13,8,5,2,1
0,280,280,37,37,0,1,0
13,285,285,135,114,21,4,3
6,300,300,14,2,12,3,2
7,339,339,41,41,0,1,0
5,411,411,34,34,0,1,0
15,420,420,13,13,0,1,0
9,422,422,7,7,0,1,0
1,423,423,17,17,0,1,0
26,426,426,32,2,30,2,1
14,462,462,16,12,4,2,1
23,479,479,49,5,44,3,2
4,482,482,9,9,0,1,0
11,488,488,31,13,18,3,2

10,103,103,4,4,0,1,0
6,106,106,7,7,0,1,0
21,109,109,2,2,0,1,0
5,110,110,11,11,0,1,0
22,134,134,2,2,0,1,0
9,147,147,2,2,0,1,0
7,150,150,1,1,0,1,0
2,151,151,3,3,0,1,0
17,154,154,8,2,6,2,1
25,169,169,18,5,13,2,1
0,171,171,4,4,0,1,0
26,173,173,20,20,0,1,0
14,185,185,5,5,0,1,0
12,223,223,127,69,58,4,3
3,277,277,10,10,0,1,0
13,307,307,14,14,0,1,0
23,342,342,34,25,9,2,1
20,347,347,18,6,12,3,2
1,351,351,14,14,0,1,0
24,368,368,87,65,22,3,2
18,404,404,71,71,0,1,0
11,433,433,20,20,0,1,0
16,454,454,18,3,15,4,3
19,465,465,64,64,0,1,0
4,467,467,42,42,0,1,0
15,475,475,85,85,0,1,0
8,483,483,38,38,0,1,0

15,123,123,3,3,0,1,0
26,129,129,3,3,0,1,0
9,130,130,4,1,3,2,1
11,157,157,44,3,41,2,1
2,185,185,8,3,5,2,1
19,207,207,23,19,4,2,1
27,223,223,22,12,10,3,2
29,224,224,24,11,13,2,1
22,251,251,27,27,0,1,0
23,259,259,62,10,52,3,2
10,263,263,1,1,0,1,0
3,272,272,6,1,5,2,1
30,275,275,28,28,0,1,0
21,276,276,48,48,0,1,0
5,302,302,1,1,0,1,0
16,314,314,10,1,9,2,1
0,320,320,48,12,36,4,3
6,327,327,4,4,0,1,0
13,339,339,21,5,16,2,1
14,342,342,5,5,0,1,0
8,359,359,14,14,0,1,0
17,381,381,10,10,0,1,0
7,386,386,6,6,0,1,0
1,415,415,12,9,3,2,1
28,438,438,1,1,0,1,0
20,440,440,28,28,0,1,0
12,452,452,48,48,0,1,0
4,470,470,129,129,0,1,0
25,495,495,60,27,33,2,1
24,496,496,36,2,34,3,2
18,498,498,16,9,7,2,1

28,120,120,12,2,10,2,1
8,125,125,11,11,0,1,0
26,138,138,6,6,0,1,0
11,151,151,7,7,0,1,0
24,152,152,29,9,20,3,2
12,155,155,11,11,0,1,0
21,166,166,27,27,0,1,0
6,167,167,6,6,0,1,0
5,214,214,24,13,11,2,1
13,229,229,7,7,0,1,0
0,235,235,21,9,12,3,2
2,269,269,16,11,5,2,1
20,286,286,2,2,0,1,0
27,291,291,9,9,0,1,0
25,308,308,12,12,0,1,0
7,361,361,84,84,0,1,0
19,385,385,59,59,0,1,0
22,396,396,82,10,72,4,3
23,403,403,11,11,0,1,0
17,408,408,79,79,0,1,0
4,409,409,33,33,0,1,0
10,417,417,4,4,0,1,0
9,419,419,48,48,0,1,0
16,443,443,18,18,0,1,0
18,462,462,37,28,9,4,3
15,463,463,37,37,0,1,0
3,475,475,19,13,6,2,1
14,482,482,29,7,22,3,2
1,498,498,5,5,0,1,0

12,114,114,22,13,9,4,3
25,115,115,18,4,14,3,2
13,141,141,3,3,0,1,0
19,172,172,2,2,0,1,0
14,199,199,20,20,0,1,0
15,201,201,5,1,4,2,1
11,207,207,38,1,37,2,1
16,209,209,42,9,33,4,3
2,234,234,2,2,0,1,0
1,240,240,19,11,8,3,2
17,258,258,1,1,0,1,0
0,266,266,12,2,10,2,1
10,281,281,5,5,0,1,0
26,286,286,11,3,8,2,1
5,351,351,8,1,7,2,1
8,375,375,16,2,14,2,1
20,410,410,104,35,69,4,3
7,417,417,7,2,5,2,1
22,439,439,61,47,14,2,1
18,443,443,20,3,17,2,1
9,446,446,139,25,114,4,3
27,450,450,8,8,0,1,0
4,454,454,47,47,0,1,0
23,464,464,147,24,123,4,3
21,468,468,7,7,0,1,0
3,476,476,7,7,0,1,0
24,477,477,12,12,0,1,0
6,495,495,9,1,8,3,2

28,112,112,18,7,11,2,1
19,120,120,21,21,0,1,0
13,165,165,6,3,3,2,1
29,175,175,19,6,13,2,1
16,181,181,13,2,11,2,1
21,196,196,26,26,0,1,0
27,210,210,38,16,22,3,2
24,226,226,46,46,0,1,0
9,249,249,1,1,0,1,0
23,256,256,4,1,3,2,1
22,262,262,7,7,0,1,0
4,291,291,13,13,0,1,0
15,302,302,25,25,0,1,0
26,331,331,9,9,0,1,0
2,349,349,7,7,0,1,0
10,363,363,2,2,0,1,0
0,372,372,19,15,4,2,1
6,379,379,7,7,0,1,0
14,388,388,2,2,0,1,0
17,389,389,34,34,0,1,0
12,402,402,19,19,0,1,0
8,410,410,64,64,0,1,0
5,433,433,26,26,0,1,0
30,435,435,10,5,5,2,1
31,445,445,45,45,0,1,0
20,457,457,63,12,51,4,3
11,459,459,39,11,28,2,1
25,469,469,50,28,22,3,2
18,471,471,17,17,0,1,0
7,476,476,31,31,0,1,0
1,489,489,40,40,0,1,0
3,497,497,37,37,0,1,0

17,107,107,21,12,9,4,3
11,123,123,10,1,9,2,1
5,145,145,2,2,0,1,0
2,163,163,34,24,10,2,1
10,176,176,4,4,0,1,0
3,177,177,48,48,0,1,0
6,212,212,9,9,0,1,0
4,216,216,41,9,32,3,2
7,300,300,38,14,24,4,3
14,301,301,36,24,12,2,1
13,317,317,42,42,0,1,0
8,338,338,24,24,0,1,0
15,345,345,13,2,11,2,1
9,350,350,7,4,3,2,1
16,364,364,100,49,51,4,3
12,371,371,15,1,14,2,1
0,377,377,179,137,42,4,3
1,412,412,1,1,0,1,0
18,475,475,47,8,39,4,3

20,114,114,3,3,0,1,0
14,125,125,28,28,0,1,0
22,129,129,10,2,8,3,2
18,140,140,30,6,24,2,1
2,142,142,22,22,0,1,0
24,142,142,3,3,0,1,0
8,149,149,20,4,16,3,2
6,159,159,23,9,14,3,2
9,187,187,38,10,28,3,2
11,193,193,33,7,26,2,1
1,206,206,4,4,0,1,0
17,249,249,2,2,0,1,0
10,256,256,11,5,6,3,2
23,284,284,8,8,0,1,0
12,293,293,13,8,5,2,1
19,321,321,14,7,7,2,1
21,328,328,30,2,28,3,2
4,331,331,22,13,9,4,3
15,334,334,60,46,14,3,2
3,342,342,13,13,0,1,0
5,354,354,13,13,0,1,0
0,430,430,37,37,0,1,0
13,460,460,91,91,0,1,0
7,474,474,29,29,0,1,0
16,499,499,60,53,7,2,1

21,108,108,5,1,4,2,1
11,122,122,1,1,0,1,0
25,152,152,19,15,4,2,1
9,167,167,26,26,0,1,0
19,176,176,29,29,0,1,0
6,186,186,26,26,0,1,0
2,197,197,2,2,0,1,0
8,240,240,15,4,11,2,1
23,245,245,55,55,0,1,0
7,256,256,29,10,19,2,1
20,260,260,25,25,0,1,0
18,260,260,2,2,0,1,0
0,267,267,1,1,0,1,0
4,276,276,1,1,0,1,0
16,292,292,17,11,6,3,2
10,292,292,43,43,0,1,0
12,324,324,9,1,8,3,2
22,329,329,80,41,39,2,1
1,331,331,56,56,0,1,0
13,341,341,21,21,0,1,0
3,370,370,43,25,18,2,1
17,370,370,7,7,0,1,0
24,388,388,18,1,17,2,1
15,402,402,15,15,0,1,0
14,420,420,29,29,0,1,0
26,445,445,69,55,14,3,2
5,497,497,56,40,16,2,1

25,102,102,9,9,0,1,0
11,122,122,32,4,28,2,1
10,132,132,9,9,0,1,0
7,140,140,1,1,0,1,0
3,149,149,19,19,0,1,0
23,166,166,14,14,0,1,0
1,203,203,10,1,9,4,3
17,225,225,22,22,0,1,0
22,227,227,13,13,0,1,0
18,245,245,5,1,4,2,1
6,251,251,5,5,0,1,0
19,253,253,17,17,0,1,0
8,261,261,38,38,0,1,0
12,276,276,15,3,12,4,3
4,294,294,24,12,12,4,3
24,301,301,1,1,0,1,0
15,342,342,29,21,8,2,1
9,370,370,7,4,3,2,1
0,407,407,7,7,0,1,0
5,415,415,71,71,0,1,0
26,420,420,60,60,0,1,0
20,425,425,26,23,3,2,1
16,439,439,84,18,66,4,3
14,447,447,12,3,9,2,1
21,461,461,148,132,16,2,1
2,461,461,29,3,26,3,2
13,493,493,43,17,26,3,2

0,105,105,3,3,0,1,0
4,106,106,4,4,0,1,0
2,123,123,28,25,3,2,1
8,149,149,3,3,0,1,0
15,153,153,11,11,0,1,0
26,160,160,34,34,0,1,0
18,164,164,24,6,18,2,1
7,186,186,1,1,0,1,0
13,189,189,15,11,4,2,1
10,200,200,16,16,0,1,0
1,201,201,30,6,24,4,3
16,215,215,5,5,0,1,0
17,237,237,45,45,0,1,0
25,237,237,7,3,4,2,1
12,237,237,3,3,0,1,0
11,239,239,11,11,0,1,0
3,257,257,33,11,22,3,2
20,267,267,40,40,0,1,0
27,280,280,3,3,0,1,0
21,290,290,13,13,0,1,0
23,306,306,75,67,8,3,2
24,345,345,9,3,6,3,2
14,406,406,62,62,0,1,0
19,443,443,66,66,0,1,0
22,460,460,1,1,0,1,0
6,465,465,13,13,0,1,0
5,474,474,30,30,0,1,0
9,480,480,34,25,9,2,1

10,120,120,8,8,0,1,0
3,144,144,2,2,0,1,0
9,167,167,1,1,0,1,0
14,205,205,7,7,0,1,0
18,207,207,30,30,0,1,0
19,213,213,32,32,0,1,0
5,225,225,90,90,0,1,0
2,238,238,15,3,12,4,3
13,256,256,22,22,0,1,0
16,260,260,10,4,6,2,1
12,263,263,12,12,0,1,0
20,285,285,6,6,0,1,0
4,294,294,8,2,6,3,2
21,312,312,39,39,0,1,0
0,324,324,3,3,0,1,0
7,380,380,13,13,0,1,0
15,393,393,67,37,30,3,2
1,417,417,8,1,7,2,1
8,419,419,103,94,9,4,3
17,437,437,57,57,0,1,0
23,453,453,25,13,12,2,1
11,456,456,124,124,0,1,0
22,464,464,103,79,24,4,3
6,476,476,21,21,0,1,0

22,114,114,5,5,0,1,0
9,126,126,13,8,5,2,1
13,129,129,1,1,0,1,0
18,145,145,27,3,24,3,2
25,153,153,28,28,0,1,0
5,158,158,15,9,6,2,1
26,160,160,1,1,0,1,0
6,211,211,69,69,0,1,0
4,223,223,10,4,6,2,1
14,224,224,14,8,6,3,2
15,228,228,32,32,0,1,0
11,239,239,8,8,0,1,0
24,247,247,12,12,0,1,0
3,247,247,32,1,31,2,1
2,253,253,66,27,39,4,3
21,261,261,35,35,0,1,0
17,269,269,20,20,0,1,0
8,293,293,13,1,12,2,1
20,294,294,60,60,0,1,0
23,319,319,40,2,38,2,1
1,325,325,14,14,0,1,0
16,345,345,25,2,23,2,1
0,358,358,2,2,0,1,0
7,478,478,2,2,0,1,0
12,481,481,9,9,0,1,0
10,490,490,11,11,0,1,0
19,500,500,3,3,0,1,0

21,118,118,8,8,0,1,0
0,138,138,6,6,0,1,0
1,153,153,15,4,11,2,1
20,231,231,14,7,7,2,1
7,264,264,72,72,0,1,0
3,272,272,42,42,0,1,0
4,273,273,6,6,0,1,0
8,282,282,1,1,0,1,0
14,301,301,25,18,7,2,1
10,304,304,21,6,15,4,3
22,318,318,5,5,0,1,0
11,320,320,14,14,0,1,0
15,345,345,7,3,4,2,1
9,350,350,65,37,28,2,1
19,374,374,19,19,0,1,0
13,375,375,21,5,16,3,2
12,410,410,30,30,0,1,0
17,426,426,51,51,0,1,0
16,435,435,102,102,0,1,0
2,441,441,19,19,0,1,0
6,456,456,47,47,0,1,0
5,464,464,41,41,0,1,0
23,480,480,216,216,0,1,0
18,492,492,20,20,0,1,0
24,499,499,12,2,10,3,2

16,116,116,1,1,0,1,0
9,124,124,18,18,0,1,0
14,134,134,9,9,0,1,0
13,145,145,2,2,0,1,0
11,159,159,18,18,0,1,0
0,165,165,11,1,10,3,2
10,165,165,5,5,0,1,0
17,211,211,71,7,64,4,3
6,253,253,8,3,5,2,1
22,264,264,45,41,4,2,1
18,268,268,12,12,0,1,0
23,270,270,14,7,7,2,1
12,285,285,15,11,4,2,1
3,297,297,24,24,0,1,0
24,316,316,16,16,0,1,0
21,350,350,24,1,23,2,1
7,364,364,2,2,0,1,0
15,365,365,38,38,0,1,0
20,371,371,48,33,15,2,1
4,383,383,10,10,0,1,0
26,392,392,10,6,4,2,1
25,407,407,9,9,0,1,0
2,407,407,65,18,47,3,2
19,417,417,83,45,38,2,1
27,438,438,49,49,0,1,0
5,471,471,1,1,0,1,0
1,475,475,107,89,18,3,2
8,483,483,37,34,3,2,1

13,100,100,19,11,8,3,2
5,112,112,20,8,12,2,1
15,113,113,2,2,0,1,0
17,131,131,10,2,8,2,1
26,136,136,8,1,7,2,1
12,157,157,23,23,0,1,0
4,177,177,6,6,0,1,0
9,178,178,1,1,0,1,0
11,185,185,2,2,0,1,0
18,204,204,55,55,0,1,0
21,223,223,2,2,0,1,0
25,223,223,12,7,5,2,1
22,229,229,55,55,0,1,0
8,266,266,54,54,0,1,0
2,279,279,2,2,0,1,0
10,280,280,3,3,0,1,0
23,290,290,31,9,22,3,2
14,299,299,10,10,0,1,0
24,355,355,1,1,0,1,0
28,364,364,28,28,0,1,0
0,388,388,17,17,0,1,0
3,398,398,40,6,34,4,3
27,412,412,8,1,7,2,1
7,419,419,16,16,0,1,0
20,422,422,62,49,13,2,1
16,429,429,13,1,12,3,2
6,435,435,54,36,18,3,2
19,479,479,78,2,76,3,2
1,493,493,13,1,12,2,1

17,109,109,3,3,0,1,0
3,133,133,82,82,0,1,0
15,176,176,23,23,0,1,0
5,209,209,2,2,0,1,0
0,213,213,39,39,0,1,0
2,224,224,9,9,0,1,0
1,237,237,1,1,0,1,0
16,255,255,85,85,0,1,0
4,260,260,29,29,0,1,0
10,273,273,36,4,32,3,2
18,280,280,66,28,38,2,1
12,315,315,46,10,36,2,1
9,324,324,3,3,0,1,0
6,346,346,82,66,16,2,1
8,393,393,10,10,0,1,0
14,411,411,34,6,28,2,1
13,414,414,22,5,17,2,1
7,478,478,17,9,8,2,1
11,495,495,9,9,0,1,0

2,154,154,2,2,0,1,0
23,156,156,80,60,20,3,2
6,178,178,4,4,0,1,0
21,184,184,13,13,0,1,0
5,186,186,7,3,4,2,1
22,186,186,1,1,0,1,0
28,187,187,2,2,0,1,0
4,190,190,8,8,0,1,0
11,216,216,1,1,0,1,0
10,219,219,38,38,0,1,0
26,222,222,2,2,0,1,0
24,233,233,9,1,8,2,1
25,245,245,7,7,0,1,0
8,266,266,1,1,0,1,0
14,267,267,19,19,0,1,0
17,277,277,13,5,8,2,1
20,283,283,10,4,6,2,1
3,292,292,1,1,0,1,0
7,295,295,12,2,10,2,1
16,304,304,15,3,12,3,2
18,306,306,64,64,0,1,0
0,408,408,7,7,0,1,0
1,408,408,110,110,0,1,0
12,408,408,21,21,0,1,0
15,416,416,80,80,0,1,0
9,427,427,52,52,0,1,0
27,429,429,62,49,13,2,1
13,462,462,40,4,36,3,2
19,476,476,56,42,14,3,2

4,112,112,17,4,13,2,1
6,119,119,1,1,0,1,0
13,123,123,1,1,0,1,0
14,135,135,3,3,0,1,0
23,136,136,37,37,0,1,0
19,195,195,13,9,4,2,1
22,201,201,6,6,0,1,0
9,211,211,6,6,0,1,0
27,220,220,24,10,14,3,2
7,236,236,16,16,0,1,0
0,247,247,20,8,12,2,1
16,250,250,10,10,0,1,0
20,266,266,1,1,0,1,0
18,270,270,46,6,40,3,2
17,310,310,7,7,0,1,0
26,313,313,9,3,6,3,2
15,351,351,53,53,0,1,0
8,368,368,13,1,12,4,3
5,376,376,43,43,0,1,0
10,382,382,9,9,0,1,0
2,395,395,61,61,0,1,0
1,399,399,22,22,0,1,0
11,418,418,77,42,35,4,3
3,418,418,22,22,0,1,0
21,429,429,140,132,8,3,2
25,438,438,14,14,0,1,0
28,443,443,63,51,12,3,2
12,452,452,11,6,5,2,1
24,476,476,7,7,0,1,0

1,133,133,1,1,0,1,0
11,155,155,5,1,4,2,1
21,169,169,3,3,0,1,0
20,198,198,44,20,24,2,1
3,216,216,13,13,0,1,0
2,289,289,61,53,8,3,2
4,305,305,21,21,0,1,0
15,308,308,13,13,0,1,0
0,319,319,21,21,0,1,0
17,331,331,11,3,8,3,2
14,350,350,20,20,0,1,0
22,351,351,60,60,0,1,0
8,354,354,14,1,13,2,1
13,387,387,24,24,0,1,0
10,398,398,52,52,0,1,0
24,402,402,62,24,38,2,1
23,409,409,57,34,23,2,1
18,420,420,26,26,0,1,0
9,424,424,1,1,0,1,0
16,425,425,40,7,33,4,3
7,435,435,161,161,0,1,0
5,453,453,34,34,0,1,0
12,456,456,39,23,16,3,2
6,462,462,24,24,0,1,0
19,474,474,78,39,39,4,3

12,111,111,15,15,0,1,0
17,121,121,6,2,4,2,1
13,126,126,6,1,5,2,1
23,141,141,11,2,9,2,1
11,147,147,3,3,0,1,0
22,148,148,24,10,14,3,2
18,159,159,7,7,0,1,0
6,178,178,3,3,0,1,0
10,228,228,4,4,0,1,0
4,264,264,29,29,0,1,0
1,309,309,3,3,0,1,0
20,310,310,2,2,0,1,0
9,319,319,129,129,0,1,0
7,320,320,16,16,0,1,0
16,324,324,39,23,16,3,2
14,344,344,58,49,9,4,3
21,348,348,49,26,23,3,2
19,370,370,82,72,10,3,2
2,380,380,44,12,32,2,1
3,381,381,62,46,16,3,2
5,385,385,75,75,0,1,0
8,414,414,12,4,8,3,2
15,438,438,24,8,16,2,1
0,459,459,34,34,0,1,0

11,113,113,5,5,0,1,0
2,151,151,21,21,0,1,0
6,174,174,2,2,0,1,0
16,184,184,24,24,0,1,0
13,186,186,8,8,0,1,0
0,194,194,28,10,18,3,2
4,200,200,72,52,20,2,1
17,231,231,3,3,0,1,0
10,234,234,8,8,0,1,0
9,260,260,19,19,0,1,0
3,321,321,6,2,4,2,1
12,322,322,133,133,0,1,0
5,378,378,48,21,27,4,3
15,417,417,41,41,0,1,0
1,433,433,179,98,81,4,3
14,433,433,104,30,74,4,3
8,473,473,42,27,15,4,3
7,498,498,18,2,16,3,2

11,129,129,10,10,0,1,0
1,144,144,1,1,0,1,0
18,144,144,3,3,0,1,0
2,165,165,1,1,0,1,0
3,166,166,4,4,0,1,0
21,178,178,14,14,0,1,0
6,191,191,6,6,0,1,0
8,206,206,51,51,0,1,0
12,215,215,3,3,0,1,0
4,219,219,1,1,0,1,0
0,224,224,8,5,3,2,1
23,290,290,25,25,0,1,0
9,322,322,19,15,4,2,1
5,351,351,99,99,0,1,0
13,352,352,4,4,0,1,0
17,397,397,10,10,0,1,0
19,403,403,30,6,24,2,1
22,405,405,23,7,16,3,2
14,407,407,67,24,43,2,1
20,423,423,101,67,34,2,1
10,425,425,30,30,0,1,0
15,454,454,35,7,28,2,1
24,466,466,99,41,58,3,2
7,485,485,161,32,129,4,3
16,492,492,57,51,6,3,2
25,498,498,34,16,18,3,2

9,155,155,38,34,4,2,1
6,169,169,6,6,0,1,0
14,178,178,4,4,0,1,0
0,185,185,23,4,19,2,1
18,186,186,11,1,10,2,1
5,209,209,29,17,12,4,3
10,209,209,19,7,12,3,2
12,217,217,19,19,0,1,0
19,236,236,7,7,0,1,0
15,252,252,15,3,12,3,2
11,265,265,40,25,15,2,1
3,310,310,13,5,8,2,1
7,312,312,43,5,38,3,2
13,316,316,90,90,0,1,0
16,329,329,84,39,45,4,3
20,341,341,2,2,0,1,0
4,364,364,91,91,0,1,0
1,385,385,13,13,0,1,0
2,389,389,6,2,4,2,1
17,405,405,56,35,21,4,3
8,447,447,80,80,0,1,0
21,460,460,20,8,12,2,1

7,130,130,23,23,0,1,0
12,135,135,4,4,0,1,0
18,147,147,17,17,0,1,0
24,164,164,12,5,7,2,1
2,172,172,12,12,0,1,0
5,186,186,66,9,57,4,3
16,204,204,11,5,6,3,2
10,215,215,17,11,6,2,1
4,223,223,13,13,0,1,0
8,253,253,1,1,0,1,0
22,262,262,8,8,0,1,0
14,276,276,1,1,0,1,0
20,282,282,86,42,44,2,1
9,289,289,18,6,12,2,1
15,331,331,58,58,0,1,0
17,349,349,47,39,8,3,2
23,360,360,62,13,49,2,1
0,392,392,51,26,25,2,1
1,414,414,1,1,0,1,0
19,426,426,1,1,0,1,0
11,450,450,10,10,0,1,0
3,482,482,60,25,35,2,1
21,482,482,63,10,53,4,3
6,483,483,45,45,0,1,0
13,496,496,10,4,6,2,1

22,115,115,9,3,6,3,2
10,133,133,10,3,7,3,2
9,156,156,4,4,0,1,0
11,158,158,5,2,3,2,1
6,162,162,18,18,0,1,0
15,174,174,26,26,0,1,0
17,177,177,26,26,0,1,0
14,188,188,7,1,6,2,1
7,203,203,5,5,0,1,0
4,206,206,14,14,0,1,0
25,240,240,38,38,0,1,0
0,241,241,15,2,13,3,2
12,243,243,1,1,0,1,0
16,258,258,13,13,0,1,0
3,290,290,18,11,7,2,1
5,330,330,105,105,0,1,0
23,333,333,27,27,0,1,0
18,352,352,3,3,0,1,0
24,355,355,27,27,0,1,0
8,364,364,9,3,6,2,1
13,392,392,128,128,0,1,0
1,412,412,6,6,0,1,0
19,424,424,79,13,66,3,2
21,430,430,109,109,0,1,0
2,465,465,25,5,20,2,1
20,493,493,2,2,0,1,0

28,116,116,30,17,13,2,1
9,149,149,9,9,0,1,0
26,156,156,51,19,32,3,2
22,156,156,15,5,10,3,2
14,173,173,5,5,0,1,0
2,176,176,14,14,0,1,0
23,211,211,13,13,0,1,0
17,213,213,13,13,0,1,0
8,219,219,1,1,0,1,0
12,223,223,12,12,0,1,0
1,237,237,17,7,10,2,1
21,283,283,4,1,3,2,1
16,286,286,10,10,0,1,0
4,289,289,12,8,4,2,1
0,338,338,39,39,0,1,0
20,360,360,60,37,23,2,1
25,370,370,9,1,8,3,2
18,372,372,25,25,0,1,0
7,389,389,7,1,6,3,2
6,396,396,15,15,0,1,0
13,419,419,42,4,38,2,1
3,425,425,61,61,0,1,0
10,441,441,32,2,30,4,3
15,456,456,35,35,0,1,0
24,478,478,1,1,0,1,0
19,481,481,14,14,0,1,0
27,483,483,58,58,0,1,0
11,485,485,38,38,0,1,0
5,498,498,91,91,0,1,0

11,113,113,6,6,0,1,0
19,141,141,34,34,0,1,0
12,148,148,3,3,0,1,0
3,174,174,4,4,0,1,0
21,198,198,3,3,0,1,0
15,221,221,27,27,0,1,0
0,243,243,13,13,0,1,0
23,249,249,9,9,0,1,0
10,255,255,36,36,0,1,0
2,255,255,15,6,9,2,1
9,298,298,81,69,12,4,3
8,302,302,15,15,0,1,0
7,316,316,70,70,0,1,0
6,328,328,1,1,0,1,0
17,331,331,4,4,0,1,0
22,331,331,43,36,7,2,1
4,336,336,36,36,0,1,0
5,355,355,7,4,3,2,1
16,376,376,2,2,0,1,0
18,432,432,13,5,8,2,1
1,444,444,91,28,63,4,3
14,477,477,97,4,93,4,3
13,482,482,59,59,0,1,0
20,487,487,138,89,49,4,3

21,124,124,28,28,0,1,0
22,124,124,12,12,0,1,0
11,129,129,1,1,0,1,0
10,134,134,20,10,10,2,1
14,135,135,6,3,3,2,1
3,139,139,1,1,0,1,0
0,145,145,18,18,0,1,0
9,158,158,1,1,0,1,0
7,180,180,24,24,0,1,0
13,184,184,70,24,46,2,1
5,205,205,10,5,5,2,1
25,207,207,12,2,10,3,2
20,207,207,19,4,15,3,2
6,219,219,1,1,0,1,0
27,234,234,25,21,4,2,1
8,243,243,36,36,0,1,0
18,254,254,3,3,0,1,0
24,255,255,38,38,0,1,0
16,304,304,4,4,0,1,0
17,317,317,57,25,32,3,2
4,350,350,12,6,6,2,1
12,383,383,1,1,0,1,0
26,402,402,94,94,0,1,0
2,403,403,20,20,0,1,0
19,421,421,21,14,7,2,1
1,451,451,3,3,0,1,0
23,463,463,5,5,0,1,0
15,484,484,26,26,0,1,0

6,141,141,19,2,17,2,1
16,141,141,8,8,0,1,0
21,154,154,26,26,0,1,0
7,168,168,11,11,0,1,0
1,177,177,30,6,24,4,3
15,193,193,33,23,10,3,2
13,219,219,6,3,3,2,1
20,240,240,17,17,0,1,0
3,242,242,25,10,15,4,3
9,267,267,1,1,0,1,0
14,304,304,9,3,6,3,2
23,309,309,25,11,14,3,2
18,311,311,17,1,16,2,1
12,313,313,54,9,45,3,2
19,318,318,84,84,0,1,0
4,351,351,22,10,12,3,2
11,371,371,29,11,18,3,2
10,386,386,30,20,10,2,1
0,392,392,28,28,0,1,0
22,437,437,39,39,0,1,0
5,456,456,2,2,0,1,0
8,458,458,64,64,0,1,0
24,470,470,41,29,12,2,1
17,500,500,62,30,32,2,1
2,500,500,59,59,0,1,0

18,141,141,4,1,3,2,1
8,146,146,16,6,10,2,1
2,149,149,56,22,34,3,2
23,150,150,5,2,3,2,1
15,157,157,12,7,5,2,1
12,228,228,44,4,40,3,2
14,259,259,27,14,13,2,1
6,272,272,9,9,0,1,0
7,304,304,24,10,14,3,2
5,307,307,5,5,0,1,0
20,319,319,89,21,68,3,2
3,329,329,4,4,0,1,0
19,366,366,14,1,13,2,1
9,368,368,7,3,4,2,1
17,371,371,50,45,5,2,1
22,378,378,2,2,0,1,0
13,388,388,3,3,0,1,0
4,389,389,17,17,0,1,0
0,397,397,41,41,0,1,0
1,421,421,55,55,0,1,0
10,431,431,61,43,18,3,2
21,446,446,10,10,0,1,0
16,461,461,137,137,0,1,0
11,479,479,66,26,40,3,2

16,212,212,60,51,9,4,3
20,212,212,12,3,9,4,3
21,223,223,20,2,18,3,2
6,225,225,20,16,4,2,1
19,268,268,6,6,0,1,0
14,274,274,1,1,0,1,0
0,277,277,26,14,12,3,2
17,295,295,17,14,3,2,1
11,297,297,71,71,0,1,0
1,300,300,1,1,0,1,0
18,314,314,1,1,0,1,0
4,315,315,69,69,0,1,0
10,329,329,7,7,0,1,0
8,330,330,36,36,0,1,0
5,340,340,70,70,0,1,0
12,389,389,15,15,0,1,0
15,392,392,118,84,34,3,2
2,430,430,75,10,65,3,2
3,439,439,65,55,10,3,2
13,449,449,28,10,18,3,2
22,478,478,29,29,0,1,0
9,482,482,60,60,0,1,0
7,486,486,7,1,6,3,2

10,105,105,6,6,0,1,0
14,115,115,28,10,18,2,1
12,146,146,15,15,0,1,0
5,152,152,4,4,0,1,0
9,161,161,3,3,0,1,0
0,196,196,16,4,12,4,3
18,227,227,5,5,0,1,0
7,254,254,42,13,29,2,1
17,260,260,41,11,30,3,2
4,283,283,5,5,0,1,0
1,290,290,59,44,15,2,1
3,293,293,188,134,54,4,3
19,322,322,22,4,18,2,1
11,324,324,25,25,0,1,0
16,327,327,5,5,0,1,0
6,350,350,13,13,0,1,0
8,370,370,34,7,27,2,1
2,400,400,12,6,6,2,1
15,443,443,18,18,0,1,0
13,483,483,163,100,63,4,3

11,107,107,7,7,0,1,0
2,141,141,3,3,0,1,0
22,165,165,32,3,29,2,1
3,171,171,10,10,0,1,0
15,173,173,31,31,0,1,0
17,191,191,15,15,0,1,0
18,195,195,9,9,0,1,0
0,239,239,5,5,0,1,0
7,245,245,14,14,0,1,0
13,266,266,3,3,0,1,0
21,277,277,1,1,0,1,0
12,288,288,18,18,0,1,0
1,303,303,46,46,0,1,0
20,317,317,14,14,0,1,0
5,349,349,59,2,57,4,3
4,352,352,15,15,0,1,0
8,358,358,13,13,0,1,0
23,362,362,50,50,0,1,0
9,379,379,42,42,0,1,0
14,416,416,21,21,0,1,0
16,449,449,34,34,0,1,0
10,461,461,170,74,96,4,3
6,476,476,49,49,0,1,0
19,493,493,169,169,0,1,0

9,102,102,2,2,0,1,0
7,184,184,15,5,10,3,2
24,219,219,11,3,8,2,1
3,230,230,13,13,0,1,0
12,265,265,22,22,0,1,0
5,271,271,18,2,16,2,1
4,282,282,42,20,22,3,2
2,284,284,36,13,23,4,3
17,287,287,32,32,0,1,0
8,299,299,3,3,0,1,0
11,318,318,27,27,0,1,0
18,324,324,4,4,0,1,0
23,330,330,10,4,6,2,1
13,345,345,28,16,12,2,1
10,353,353,7,7,0,1,0
16,355,355,34,34,0,1,0
19,360,360,127,127,0,1,0
21,375,375,36,36,0,1,0
15,385,385,73,73,0,1,0
22,421,421,26,26,0,1,0
0,446,446,44,40,4,2,1
6,455,455,68,14,54,4,3
20,469,469,17,3,14,2,1
14,489,489,52,52,0,1,0
1,499,499,128,128,0,1,0

5,156,156,4,1,3,2,1
8,158,158,1,1,0,1,0
1,180,180,47,19,28,3,2
22,186,186,7,7,0,1,0
20,205,205,40,40,0,1,0
0,216,216,27,27,0,1,0
16,218,218,5,5,0,1,0
12,234,234,53,2,51,4,3
4,270,270,26,26,0,1,0
10,287,287,26,26,0,1,0
6,313,313,16,1,15,4,3
15,338,338,14,14,0,1,0
9,427,427,103,4,99,4,3
17,438,438,25,1,24,4,3
3,447,447,15,3,12,3,2
18,447,447,78,78,0,1,0
11,455,455,46,46,0,1,0
7,456,456,66,66,0,1,0
23,456,456,63,58,5,2,1
2,471,471,11,11,0,1,0
14,471,471,65,15,50,2,1
21,471,471,20,20,0,1,0
19,499,499,9,9,0,1,0
13,500,500,63,21,42,3,2

22,101,101,2,2,0,1,0
12,114,114,5,5,0,1,0
2,129,129,15,15,0,1,0
14,205,205,74,37,37,2,1
3,208,208,5,5,0,1,0
15,217,217,52,52,0,1,0
11,236,236,15,12,3,2,1
13,241,241,16,16,0,1,0
19,260,260,10,10,0,1,0
5,280,280,20,20,0,1,0
23,312,312,18,6,12,2,1
17,332,332,29,29,0,1,0
8,342,342,32,17,15,4,3
4,350,350,64,64,0,1,0
10,367,367,12,4,8,3,2
16,368,368,6,6,0,1,0
1,379,379,12,2,10,3,2
20,384,384,45,45,0,1,0
9,387,387,50,30,20,2,1
0,388,388,54,54,0,1,0
25,402,402,25,25,0,1,0
6,416,416,86,32,54,3,2
7,419,419,1,1,0,1,0
24,426,426,18,18,0,1,0
18,450,450,26,8,18,2,1
21,474,474,59,7,52,3,2

22,121,121,8,8,0,1,0
20,128,128,1,1,0,1,0
10,131,131,1,1,0,1,0
2,131,131,34,34,0,1,0
6,148,148,4,4,0,1,0
26,193,193,27,12,15,2,1
8,194,194,9,9,0,1,0
3,228,228,18,18,0,1,0
27,249,249,15,15,0,1,0
13,250,250,22,22,0,1,0
18,258,258,13,13,0,1,0
16,262,262,1,1,0,1,0
7,268,268,12,2,10,2,1
9,290,290,22,22,0,1,0
21,295,295,2,2,0,1,0
12,305,305,7,7,0,1,0
17,324,324,19,19,0,1,0
11,327,327,11,8,3,2,1
15,331,331,5,5,0,1,0
23,382,382,6,6,0,1,0
4,390,390,18,18,0,1,0
0,392,392,37,37,0,1,0
19,410,410,44,44,0,1,0
28,415,415,58,4,54,3,2
25,444,444,163,115,48,4,3
24,446,446,93,24,69,4,3
14,466,466,10,10,0,1,0
1,468,468,19,15,4,2,1
5,473,473,140,86,54,3,2

14,100,100,25,25,0,1,0
17,123,123,35,35,0,1,0
16,127,127,5,5,0,1,0
1,139,139,7,7,0,1,0
9,151,151,6,6,0,1,0
7,152,152,40,40,0,1,0
6,156,156,10,10,0,1,0
4,176,176,22,22,0,1,0
18,257,257,20,20,0,1,0
19,267,267,20,11,9,4,3
13,315,315,15,12,3,2,1
5,358,358,77,33,44,3,2
15,373,373,21,12,9,4,3
3,378,378,110,41,69,4,3
2,412,412,78,78,0,1,0
12,418,418,20,20,0,1,0
10,433,433,8,8,0,1,0
8,479,479,44,24,20,2,1
11,485,485,99,99,0,1,0
0,497,497,1,1,0,1,0

11,108,108,7,7,0,1,0
18,110,110,6,6,0,1,0
17,123,123,11,11,0,1,0
19,158,158,1,1,0,1,0
2,166,166,6,6,0,1,0
0,167,167,2,2,0,1,0
15,227,227,1,1,0,1,0
1,239,239,1,1,0,1,0
12,247,247,8,8,0,1,0
13,289,289,95,95,0,1,0
9,297,297,6,6,0,1,0
4,300,300,39,39,0,1,0
3,355,355,1,1,0,1,0
14,380,380,47,47,0,1,0
8,403,403,9,9,0,1,0
5,404,404,273,199,74,4,3
6,416,416,94,37,57,4,3
10,457,457,1,1,0,1,0
7,460,460,53,53,0,1,0
16,486,486,229,155,74,4,3

17,117,117,29,10,19,2,1
9,121,121,4,4,0,1,0
6,152,152,92,25,67,3,2
10,167,167,23,23,0,1,0
20,170,170,19,19,0,1,0
0,239,239,12,12,0,1,0
11,251,251,8,2,6,3,2
14,271,271,34,34,0,1,0
19,289,289,15,15,0,1,0
2,341,341,57,57,0,1,0
1,360,360,20,8,12,4,3
12,363,363,5,5,0,1,0
7,367,367,22,14,8,2,1
15,372,372,28,5,23,2,1
21,395,395,28,28,0,1,0
16,412,412,19,16,3,2,1
8,430,430,20,16,4,2,1
5,448,448,57,13,44,3,2
4,449,449,10,1,9,4,3
13,461,461,23,23,0,1,0
18,461,461,121,121,0,1,0
3,473,473,18,3,15,3,2

6,102,102,2,2,0,1,0
13,118,118,4,1,3,2,1
24,121,121,21,2,19,2,1
10,122,122,1,1,0,1,0
3,130,130,11,7,4,2,1
26,142,142,6,2,4,2,1
8,149,149,12,4,8,2,1
27,194,194,16,16,0,1,0
4,199,199,1,1,0,1,0
25,227,227,28,21,7,2,1
23,247,247,1,1,0,1,0
22,262,262,9,6,3,2,1
2,303,303,11,11,0,1,0
7,304,304,52,17,35,2,1
19,332,332,43,14,29,2,1
1,341,341,8,8,0,1,0
0,343,343,33,33,0,1,0
18,351,351,20,20,0,1,0
14,375,375,52,52,0,1,0
12,413,413,20,15,5,2,1
5,414,414,19,9,10,3,2
15,416,416,18,6,12,2,1
16,429,429,4,4,0,1,0
11,444,444,51,33,18,4,3
17,450,450,229,215,14,3,2
20,455,455,4,4,0,1,0
9,465,465,117,31,86,3,2
21,478,478,22,4,18,3,2

12,114,114,4,4,0,1,0
16,115,115,14,14,0,1,0
19,131,131,12,12,0,1,0
21,149,149,41,29,12,2,1
10,151,151,12,1,11,2,1
0,170,170,1,1,0,1,0
24,178,178,12,12,0,1,0
11,178,178,9,9,0,1,0
1,194,194,10,10,0,1,0
7,207,207,1,1,0,1,0
13,223,223,6,6,0,1,0
23,241,241,30,30,0,1,0
5,247,247,37,37,0,1,0
18,258,258,100,10,90,4,3
17,259,259,5,5,0,1,0
8,278,278,50,50,0,1,0
20,290,290,1,1,0,1,0
2,315,315,40,40,0,1,0
3,316,316,1,1,0,1,0
6,330,330,123,33,90,4,3
14,390,390,8,8,0,1,0
15,397,397,28,4,24,4,3
9,445,445,15,1,14,4,3
4,449,449,51,51,0,1,0
22,470,470,12,4,8,2,1

20,137,137,6,6,0,1,0
5,147,147,15,15,0,1,0
6,151,151,35,18,17,2,1
12,155,155,36,9,27,2,1
21,155,155,44,44,0,1,0
14,161,161,17,1,16,2,1
9,179,179,20,12,8,3,2
19,246,246,26,23,3,2,1
2,259,259,10,10,0,1,0
13,303,303,45,5,40,3,2
10,310,310,10,10,0,1,0
7,313,313,6,6,0,1,0
1,333,333,5,5,0,1,0
4,358,358,103,43,60,3,2
8,377,377,63,63,0,1,0
22,388,388,16,16,0,1,0
18,395,395,18,4,14,3,2
23,416,416,3,3,0,1,0
16,419,419,3,3,0,1,0
11,427,427,25,25,0,1,0
17,433,433,18,18,0,1,0
0,434,434,12,12,0,1,0
15,440,440,71,20,51,4,3
3,498,498,54,54,0,1,0

10,102,102,1,1,0,1,0
23,122,122,3,3,0,1,0
8,135,135,7,3,4,2,1
14,138,138,1,1,0,1,0
20,144,144,2,2,0,1,0
26,177,177,68,68,0,1,0
2,205,205,4,4,0,1,0
25,225,225,18,3,15,4,3
0,247,247,74,74,0,1,0
4,266,266,44,44,0,1,0
6,279,279,11,11,0,1,0
15,309,309,6,2,4,2,1
24,326,326,13,2,11,4,3
21,332,332,30,19,11,2,1
22,332,332,82,82,0,1,0
27,336,336,9,3,6,2,1
11,340,340,34,34,0,1,0
16,380,380,34,34,0,1,0
5,381,381,31,31,0,1,0
19,415,415,19,5,14,3,2
1,445,445,1,1,0,1,0
12,459,459,9,9,0,1,0
3,473,473,86,37,49,2,1
7,482,482,54,54,0,1,0
13,488,488,22,1,21,4,3
18,489,489,65,17,48,3,2
9,490,490,23,18,5,2,1
17,498,498,26,8,18,2,1

